name,relative_counts,ct,ct_0,barcode,ct_1,barcode_ind
galEp3,0.3325942350332594,1200,901,CGCCCGAAATTCTACTGTGA,299,1559365
galEp3,0.3300970873786408,409,308,GTCTATGGGATACTAAGTGT,101,1546586
galEp3,0.030120481927710843,169,165,CGCCGGCACAGCCGTAAAGA,4,1552719
galEp3,0.8802816901408451,265,141,GACATGTAGATCGAGACCGT,124,1548420
galEp3,0.8235294117647058,184,101,TTGTCAGGTTTTTCAAACGA,83,1547294
galEp3,0.7227722772277227,172,100,AAGCATGGCCAAACACCTCT,72,1550009
galEp3,0.020202020202020204,99,98,TAGACCCCACGCGTAGTAAA,1,1570872
galEp3,0.020202020202020204,99,98,AAGGCACTGTGTCGGATGGC,1,1546543
galEp3,0.5510204081632653,150,97,CCCGTCAAGAATGTCTGGTT,53,1550331
galEp3,2.082474226804124,297,96,ATTTGATATCACGTCTGTAT,201,1548084
galEp3,0.053763440860215055,96,92,TGGGGACACTGAGTTCAAAA,4,1550490
galEp3,0.034482758620689655,88,86,CAGCGTCCTAGTGTTGTGTT,2,1555500
galEp3,0.5232558139534884,129,85,GTGAGTTGGTAGTTTATCTA,44,1560908
galEp3,0.023255813953488372,86,85,GAAAAGAAATGCCCCATCGG,1,1564364
galEp3,0.8888888888888888,151,80,TCAAGTCGAATTTTATGGCT,71,1549002
galEp3,1.3125,183,79,GAAGACCTAACTACAACGGT,104,1569847
galEp3,0.948051948051948,148,76,GTCGGACGGTTTACCTGCTA,72,1560033
galEp3,0.02631578947368421,76,75,TGTTCTCCTTGGACTGTGTT,1,1573520
galEp3,0.039473684210526314,77,75,GAACGTCGCTACGTCATTAA,2,1550519
galEp3,1.6533333333333333,197,74,TAGCTTCGTTAATGCATATA,123,1547182
galEp3,3.22972972972973,311,73,CGCCGATGTTCCGATGTCCG,238,1549085
galEp3,1.5753424657534247,186,72,CCTAACGCCCCCATTTGATA,114,1591131
galEp3,0.75,124,71,TTCGCCCCGTGAGGGCCTTT,53,1567906
galEp3,0.041666666666666664,73,71,CACATGCGTTGGGCAGGAAC,2,1578627
galEp3,0.2916666666666667,91,71,AAGACGTCTACATCCCAACG,20,1547020
galEp3,1.1,145,69,TGGCATCGTGGCCTTAATCT,76,1568087
galEp3,0.04285714285714286,71,69,AGACTCAGTACAGACCGCTG,2,1549904
galEp3,0.7058823529411765,114,67,TCCAGAAGCCGCTATCCATG,47,1582982
galEp3,1.492537313432836,165,66,TCGCAACGCGGGGGAACTCT,99,1564847
galEp3,0.029850746268656716,67,66,AGGCTGCCGTCTGATTTTCG,1,1551629
galEp3,0.22727272727272727,79,65,GTCGATAATACCCGGCCACC,14,1557250
galEp3,1.4393939393939394,159,65,CCGAAGTTGTATTGGGGCAT,94,1568480
galEp3,0.030303030303030304,66,65,CAGCCACCCTAATTACTCGT,1,1562195
galEp3,1.4696969696969697,161,65,ACAACAACACTTATATAGGC,96,1590187
galEp3,0.03076923076923077,65,64,GCCGTTCTACGCATCCGCCA,1,1549307
galEp3,0.38461538461538464,88,64,GAAGGCTTCTCACCTAGGTG,24,1549322
galEp3,0.03076923076923077,65,64,CCTTTCGTAGCACCGACTCG,1,1563704
galEp3,1.6923076923076923,173,64,CAAGTAAGTGAGCCAAGATT,109,1560021
galEp3,0.375,86,63,TGCGTTCGATGCTTAGGATT,23,1547023
galEp3,0.031746031746031744,63,62,GTCGAGGGAATGGCACATAA,1,1550386
galEp3,2.888888888888889,243,62,AGGTGTAACCGGCATAAAGT,181,1547406
galEp3,1.3968253968253967,149,62,ACACACTCGGAATCCCTACG,87,1549757
galEp3,0.5806451612903226,96,61,ATCTCAGACAGGCTCGGTCG,35,1567246
galEp3,0.03225806451612903,62,61,ACGGTCGAGGTTCAGTTATT,1,1553106
galEp3,1.5737704918032787,155,60,GGGTTGTGCTCAGCGAAAAG,95,1574157
galEp3,0.36065573770491804,81,60,AGCAGGGTATCCCATACGAT,21,1574342
galEp3,1.459016393442623,148,60,AACGTCAGTTCGCCCGGCAT,88,1585807
galEp3,0.03333333333333333,60,59,GTTCCGTTAGACATTGGCAT,1,1551555
galEp3,1.6666666666666667,158,59,GTAATCGCGGCGTTTAGGAA,99,1547479
galEp3,1.45,145,59,AGTAGAGGCGCACGTCATAC,86,1548111
galEp3,0.03333333333333333,60,59,AGAGAGATGTGCAGATCACT,1,1549146
galEp3,0.03333333333333333,60,59,ACCCTTTCAATCGACAACGT,1,1551105
galEp3,0.711864406779661,99,58,TGGCCCAGCGATCCGACCGA,41,1582139
galEp3,0.5084745762711864,87,58,TCCGTCGCCGGTGCGCGACC,29,1546820
galEp3,1.8983050847457628,169,58,GGTCGCGGGTGAGGTAATCT,111,1580005
galEp3,0.03389830508474576,59,58,CACCACAAATCTAAAGTCTA,1,1570518
galEp3,1.8793103448275863,165,57,GTCTGGGCACCGTTGGAGTA,108,1557256
galEp3,1.396551724137931,137,57,GTCAGTCACGCTATAGATGA,80,1561421
galEp3,2.2413793103448274,186,57,GTACATTCTCTGGCCAATGT,129,1576016
galEp3,3.2241379310344827,243,57,GCCTAACAGGCTGCCTTTTG,186,1549116
galEp3,1.293103448275862,131,57,GAGATTCGCGTATAAAGGCA,74,1565541
galEp3,1.293103448275862,131,57,CCGCAGAACTAATGCTGCGC,74,1580096
galEp3,1.3103448275862069,132,57,CATCCCCATGAGGCCAAATA,75,1571988
galEp3,1.8596491228070176,161,56,TCGTGCCACTGGGCTTGGTA,105,1547240
galEp3,0.17543859649122806,65,56,TCGCCCGGTTACGGGTATGC,9,1547937
galEp3,2.1052631578947367,175,56,GCACCCCTTTCCGACCGAAT,119,1546631
galEp3,0.03508771929824561,57,56,CACGCAAATTTGCAACGGAA,1,1548469
galEp3,0.2807017543859649,71,56,AATAGGCAACAGATTGCATA,15,1576317
galEp3,0.125,61,55,TGATATGCCTCTGCCCTTCG,6,1546701
galEp3,0.05357142857142857,57,55,GTACTTTGGGGCCGGGCGTT,2,1554733
galEp3,2.1607142857142856,175,55,GCGGGTCGGGCGCCCGGGCT,120,1557887
galEp3,0.44642857142857145,79,55,CTCTGCATCTTTACGAGTCT,24,1551484
galEp3,0.03571428571428571,56,55,CGGCGTTCTAATTAATTCGA,1,1559249
galEp3,0.05357142857142857,57,55,CCATTAGTCATTTTGTACGA,2,1590715
galEp3,1.709090909090909,147,54,GTTACCCCCTGCATACCGTG,93,1558848
galEp3,0.03636363636363636,55,54,CTTGCTTAGGTGACCAGTAT,1,1572247
galEp3,0.32727272727272727,71,54,CTATTGGTTTAGGACCGCAA,17,1553379
galEp3,0.05454545454545454,56,54,CGAGACAAGGTAGGTTTGTA,2,1547029
galEp3,0.03636363636363636,55,54,CACGCCGAGTCCCTCGGCCA,1,1575271
galEp3,1.9444444444444444,157,53,TTATAGACACTATGCTCCTT,104,1559886
galEp3,1.537037037037037,135,53,TTACGTGCGAACCCCATCCT,82,1551594
galEp3,1.8518518518518519,152,53,CACAGTCCGAAGTACAATTG,99,1551971
galEp3,0.037037037037037035,54,53,AGCACGTCAGATTCTAGATA,1,1567429
galEp3,3.1666666666666665,223,53,ACCACTCTTGCAAAATGGAT,170,1560852
galEp3,0.4074074074074074,74,53,AACGAAATACCATGAGTCTG,21,1549660
galEp3,2.358490566037736,176,52,TGGTCTTCTGCCGATACTGA,124,1549199
galEp3,1.7884615384615385,143,51,TCGAGTCGAGAACCCGAAAA,92,1549202
galEp3,0.057692307692307696,53,51,AGTATGCGTGGAGCCTGGGG,2,1593092
galEp3,0.038461538461538464,52,51,ACGCGTCCAATCGTACCTAA,1,1547448
galEp3,0.0392156862745098,51,50,TTCTTGGTGTTGCAGTTCCA,1,1549872
galEp3,1.1176470588235294,106,50,TGTCTGGGATCTGGCCCACG,56,1546470
galEp3,1.9019607843137254,146,50,TCCTAAAAAAGTCCGCCACA,96,1547372
galEp3,2.019607843137255,152,50,GCGAACCCATAGCGCAATGG,102,1548553
galEp3,1.6470588235294117,133,50,GACCAAGACCTTCGCAGCGG,83,1558599
galEp3,0.7058823529411765,85,50,GAAGAGCTTGAAGGGATTGT,35,1574900
galEp3,2.176470588235294,160,50,CTCGTGCGAGGGCACGCCAA,110,1580202
galEp3,1.1176470588235294,106,50,CCATTACCCTCCAAAAACGT,56,1593012
galEp3,0.0392156862745098,51,50,CATCGGTACAAGACCCGGCT,1,1564947
galEp3,1.803921568627451,141,50,AGGATATAGGGTATAGCGCT,91,1570745
galEp3,1.98,147,49,GGAGCCTGGTAACTGTTGTC,98,1551729
galEp3,0.04,50,49,GCATCAGTTATCGCAAGCCA,1,1558943
galEp3,0.92,94,49,CCCCGTTTCGGATACGTTCG,45,1566880
galEp3,0.04,50,49,CACTTGCTTATGAACAGGTA,1,1570535
galEp3,1.8,138,49,ACCCTCGTGGGTTCACCCAT,89,1548299
galEp3,0.86,91,49,ACACCTGGTAAACCCATCGT,42,1568495
galEp3,0.04081632653061224,49,48,TGCTACGAAATTCGCGGACC,1,1577569
galEp3,0.04081632653061224,49,48,TAGAGATCATCAGCAGGGCT,1,1555832
galEp3,1.9795918367346939,144,48,GTCGTGGTTACATGAGGCCT,96,1560166
galEp3,1.7551020408163265,133,48,GGGTGCGGAATTGATTGCAG,85,1588724
galEp3,1.3673469387755102,114,48,GGGTACTTTGCTCCTTCATA,66,1555429
galEp3,2.163265306122449,153,48,CGTTTGACGGTTACTATACC,105,1562433
galEp3,0.7959183673469388,86,48,CGCATCGACGTGCGTCACTA,38,1565269
galEp3,0.2857142857142857,61,48,CCAAAAACCCAGCGTACTGT,13,1568507
galEp3,0.04081632653061224,49,48,ATGGTTGGGTCCGTCCGAAA,1,1550758
galEp3,3.204081632653061,204,48,ATCACAATCACTTCTGGGTT,156,1577845
galEp3,1.0408163265306123,98,48,AAGGCGAGGTACCATGACTG,50,1577854
galEp3,0.4166666666666667,66,47,TTCAATCCGCTTATAGATCT,19,1569145
galEp3,0.041666666666666664,48,47,TGCCCATCCGACTTTCACCT,1,1551314
galEp3,2.5416666666666665,168,47,TGAACAGACGTAGCGGGATT,121,1558245
galEp3,0.10416666666666667,51,47,TCAATTCCATGTCCCGTTGT,4,1554968
galEp3,1.1875,103,47,CCGGTGCCGGCCAGCATAGT,56,1588370
galEp3,0.041666666666666664,48,47,ACGCCCATGGTACGCCATTA,1,1553869
galEp3,0.0425531914893617,47,46,TTTAAACAGTTTTCAACACA,1,1547786
galEp3,1.574468085106383,119,46,GTGGAACACGAAAAGCGGTT,73,1580382
galEp3,4.787234042553192,270,46,GGGCAAACGGTTCCTCCTGA,224,1553668
galEp3,1.6382978723404256,122,46,GAACAACATTTCAAATAGCA,76,1552259
galEp3,0.3829787234042553,63,46,GAAACCCAGTTGATTCCTCG,17,1554171
galEp3,1.7872340425531914,129,46,CGTCTCGTTGAGCGTTAGGT,83,1566224
galEp3,2.234042553191489,150,46,CGCTTTATAGAACTTGATAG,104,1550725
galEp3,2.4893617021276597,162,46,CACAAGACCTTCCGTGGGAA,116,1565205
galEp3,1.8297872340425532,131,46,AGCCTCGTGCATAGAGACCA,85,1560022
galEp3,0.0425531914893617,47,46,ACGTGTGAAATATCCCCAGT,1,1550847
galEp3,0.5217391304347826,68,45,TAGGTGCTCGAACCCGAAAT,23,1551403
galEp3,0.8478260869565217,83,45,GGCACCTCGTAAAAAACTCA,38,1564316
galEp3,1.565217391304348,116,45,GACATGGGTACTAATCCTGT,71,1563162
galEp3,2.0869565217391304,140,45,CTTCAACATTACTCGCCGGA,95,1549086
galEp3,0.043478260869565216,46,45,CTTAGGAGTTATATGCGTGA,1,1572232
galEp3,3.3260869565217392,197,45,CTACGTGGCTGTGCTCGGCT,152,1560479
galEp3,0.043478260869565216,46,45,CCCCGAGGACTTGCGATTTT,1,1578360
galEp3,0.043478260869565216,46,45,AACTCGCCCTAAACTTTGGG,1,1587941
galEp3,0.044444444444444446,45,44,TTCACGTGTACACGCCAGGC,1,1579504
galEp3,0.8666666666666667,82,44,TACTCTCATTCGGTTATTGC,38,1566741
galEp3,0.7333333333333333,76,44,GTTCAGTGGCTAACGGTATA,32,1548525
galEp3,0.044444444444444446,45,44,GTGGCTGTGTGGCTCCTTAA,1,1589806
galEp3,0.6,70,44,GGTGATGCTCCGGTTCGTTG,26,1589639
galEp3,2.7333333333333334,166,44,CCCCTTTGAACATGGCGCCC,122,1577604
galEp3,1.8,124,44,CAGACGAGCGCAATGCTATG,80,1547624
galEp3,2.533333333333333,157,44,ATTAGGCGCTAGTCCCTGCG,113,1554038
galEp3,0.044444444444444446,45,44,AGTGGGGCACCAATGTACTA,1,1559156
galEp3,0.044444444444444446,45,44,AATGATGCGGTACATGGAGA,1,1549078
galEp3,0.045454545454545456,44,43,TGACGCGATATCTCTGGATC,1,1557567
galEp3,2.340909090909091,145,43,TCTTGCGCGGTTTCCCTCTT,102,1556983
galEp3,1.5,108,43,GTCCCATTATGTCCCATTTA,65,1550069
galEp3,0.045454545454545456,44,43,GAGCCTCTGAGGATTGTAGT,1,1550135
galEp3,0.045454545454545456,44,43,GACATTGTGGAGCAGCGCAA,1,1555131
galEp3,1.3636363636363635,102,43,CGAGCACATAGTTCCCGGGG,59,1573601
galEp3,0.045454545454545456,44,43,CCCTAATGGTTTGGGGAGTC,1,1547507
galEp3,1.5909090909090908,112,43,AGGGCGATCGCTGCCTACCT,69,1591142
galEp3,2.022727272727273,131,43,ACTGGCCAGTTTCAAACGGA,88,1587243
galEp3,3.5348837209302326,193,42,TTGCGGTTTTGCCGGGCGAC,151,1579208
galEp3,1.3488372093023255,99,42,GCCCGGTAACTTTTCTCTAC,57,1549608
galEp3,0.046511627906976744,43,42,CGGGTAGCGTACTTGGTCCA,1,1549871
galEp3,1.2790697674418605,96,42,CCGTCCCGAAATTTGAGTTA,54,1566495
galEp3,4.372093023255814,229,42,CCCCGGCCTAGCGTGCACCT,187,1566461
galEp3,1.2093023255813953,93,42,CAGGCGCAAGGGGTGTTGGT,51,1558486
galEp3,0.046511627906976744,43,42,AGTGGTCAGACCTGGCATCA,1,1574563
galEp3,0.23255813953488372,51,42,ACTCTCTCCGCACGCGACTC,9,1562674
galEp3,2.7857142857142856,157,41,TTCATATCGTTGAGGGCAAT,116,1546440
galEp3,2.0238095238095237,125,41,TCGGTTCTGACTGGCGCCAT,84,1548541
galEp3,0.047619047619047616,42,41,TCAGCCCACTGCCACCTCTA,1,1579984
galEp3,1.8571428571428572,118,41,TCACAAGACACTTATTGGGT,77,1547476
galEp3,1.619047619047619,108,41,GTGCTTTACTCAGGGTGTAT,67,1551517
galEp3,2.2857142857142856,136,41,GATTTCTCACCCTCGCAGCT,95,1576802
galEp3,0.047619047619047616,42,41,ATCAACATAAATGGACTTCG,1,1547429
galEp3,2.642857142857143,151,41,AGTGTCTTTCCATATATCGT,110,1552205
galEp3,2.642857142857143,151,41,AGTAGACATAATAGGAAGGT,110,1556505
galEp3,0.047619047619047616,42,41,AGAGGTACACCATGGTAAGT,1,1557213
galEp3,2.341463414634146,135,40,TTGCAGAGAGGCTTAGCATA,95,1547708
galEp3,0.04878048780487805,41,40,TTCCACTGACTCATAGTCCC,1,1583124
galEp3,1.5609756097560976,103,40,TGTCATCCGTTATCAAACGT,63,1579741
galEp3,0.6585365853658537,66,40,TCCGTAAAAGATTGGACCTC,26,1549967
galEp3,0.04878048780487805,41,40,TCACTGCTGATCTGGCCGCA,1,1577218
galEp3,0.04878048780487805,41,40,TAACCTATACCGAGGCTTAT,1,1574971
galEp3,0.04878048780487805,41,40,GGCTCCGGCAAGGTCAGGAT,1,1562276
galEp3,0.3902439024390244,55,40,GGCCTTACAGTACCATACGT,15,1572439
galEp3,0.04878048780487805,41,40,GCCGGATTCACAGACCAAAT,1,1556757
galEp3,1.4390243902439024,98,40,GATTCCACACGGGCGTCCGT,58,1570931
galEp3,2.731707317073171,151,40,GATCACAAGTCGCACGACTT,111,1548377
galEp3,2.4634146341463414,140,40,AGGAGTTGGTAGAAAAGAAC,100,1556598
galEp3,0.04878048780487805,41,40,ACCCTACCAAAGGCTCTTGC,1,1560589
galEp3,0.05,40,39,TGGGGTGAATCCACTGTAAA,1,1575092
galEp3,2.2,126,39,TGACTCTCGGCAACTCTTAC,87,1555665
galEp3,2.2,126,39,TAGTAAGCCACACGTCAGTC,87,1584913
galEp3,0.075,41,39,TACTGCACCCTGTGGATGCA,2,1581840
galEp3,0.05,40,39,GGACTATGATCGACAGATAA,1,1554416
galEp3,3.5,178,39,GATATTGAGTTTGATCGTTT,139,1561350
galEp3,2.225,127,39,CCGGCTAGGATCGCATGACA,88,1577851
galEp3,2.55,140,39,CAAGAGCAACGATCATGCCG,101,1556175
galEp3,2.1,122,39,ACCATCACAAATAGCCAGGA,83,1557026
galEp3,1.125,83,39,ACAGGGTAAGCGCCGTGTCT,44,1580666
galEp3,0.075,41,39,AATAAAACCCATTTCAAAAT,2,1594841
galEp3,2.076923076923077,118,38,TTAGACTGCGAAAGTGTAGT,80,1574162
galEp3,0.41025641025641024,53,38,TCGTGACGCTACGGACATTC,15,1551592
galEp3,2.871794871794872,149,38,GTGGGACCGTCGCGCTGCAT,111,1583008
galEp3,0.23076923076923078,46,38,GGAGCAGGACCCACGTCTCT,8,1555294
galEp3,1.8974358974358974,111,38,CTTTAGGTTCCTAAGTCTCT,73,1558756
galEp3,1.3076923076923077,88,38,CCAGGTTCCTTCTACCGCTA,50,1586427
galEp3,6.076923076923077,274,38,CCAATGCTCCCAAGATCTTT,236,1584237
galEp3,3.0,154,38,ATGTCTATGTCTATCTCGAG,116,1563879
galEp3,0.07692307692307693,40,38,ATCCAGCCAATCGGCTCGGG,2,1566740
galEp3,4.384615384615385,208,38,ACGTCCCGTGCGTCTGTCTA,170,1564022
galEp3,2.3846153846153846,130,38,AAGCTATAAGAAGTAGATTA,92,1580700
galEp3,1.1842105263157894,81,37,TGGGCCAGAGAGGGGTATAC,44,1562132
galEp3,4.394736842105263,203,37,TGATTCACGCGCCCGCGGAA,166,1547106
galEp3,0.05263157894736842,38,37,TATAAGCATGGATCACGTTT,1,1559228
galEp3,0.3684210526315789,50,37,TACCACCGTGTATGCCAAAT,13,1568332
galEp3,0.05263157894736842,38,37,GTGAATGGTTAGTCGGTTCC,1,1548664
galEp3,1.0263157894736843,75,37,GGGGTGCTCCACACAGAGGT,38,1553010
galEp3,1.0526315789473684,76,37,GCGCCGCCCACGGCAGCACA,39,1551494
galEp3,2.6052631578947367,135,37,GACCTAGCCCCGCTTGGAAT,98,1580610
galEp3,0.05263157894736842,38,37,CGGCCATGTTTAAAAAGACA,1,1547450
galEp3,3.4473684210526314,167,37,CCGGGGCTGCAACGAAGTGT,130,1567490
galEp3,0.05263157894736842,38,37,CAGTCAGCGTCCTTTGTCGT,1,1570707
galEp3,0.15789473684210525,42,37,ATCTGGCAGGACGACTTCTA,5,1555097
galEp3,2.710526315789474,139,37,ATACGCGCATGTACACGTAG,102,1557965
galEp3,2.736842105263158,140,37,ATAAGTTCCCGCGCACTAAG,103,1586581
galEp3,0.05263157894736842,38,37,AATGTAGTTCTTTTGGATCA,1,1582866
galEp3,0.7105263157894737,63,37,AAGGGCGCCCTTTCCCATGG,26,1557287
galEp3,2.3783783783783785,123,36,TGAGTGGCAGTTATTCAATC,87,1552263
galEp3,2.2162162162162162,117,36,TCTGATACCTTTTTTGTCGG,81,1558330
galEp3,1.7567567567567568,100,36,TATTGCCTATAAATTATCCA,64,1581041
galEp3,4.4324324324324325,199,36,TACACTGTGCATTCTCTAAT,163,1576072
galEp3,0.05405405405405406,37,36,GCGGTTTTCCCATCAATTGA,1,1560181
galEp3,2.918918918918919,143,36,CTGAGCCTATGAGGTCCACA,107,1575011
galEp3,0.35135135135135137,48,36,CGGCAGTTTGATCGGGATTC,12,1576381
galEp3,3.054054054054054,148,36,CATGGGGACGAACACGCTCA,112,1569359
galEp3,0.10810810810810811,39,36,CAGGGAGCCTCGAGTAATGG,3,1584153
galEp3,2.135135135135135,114,36,ATCGGTCGCGTTTGACCCGT,78,1562670
galEp3,1.2432432432432432,81,36,ACGTTGTACGTTATCACCTC,45,1574897
galEp3,2.972972972972973,145,36,ACCCACTGGATAGTTGCCAG,109,1555551
galEp3,0.5675675675675675,56,36,AAAGTATAGGGGTTCGGGTA,20,1578074
galEp3,2.611111111111111,128,35,TCGCTTAGGAGCTATCGCCG,93,1552215
galEp3,3.4444444444444446,158,35,TACATGTAGATCGAAATACC,123,1554469
galEp3,3.1944444444444446,149,35,GATTGCCTTTTAAGTTCATA,114,1561596
galEp3,0.05555555555555555,36,35,GATGGCTCCCGATAGAACCA,1,1576922
galEp3,2.888888888888889,138,35,CGGAACAGATGAGGGGTCGG,103,1563810
galEp3,3.138888888888889,147,35,CCCTACCCGGAGTGACTCGA,112,1563873
galEp3,0.05555555555555555,36,35,CCCCGATGTCCTCCCGGACC,1,1578376
galEp3,2.1666666666666665,112,35,CACAGTAGGTGTGGTGCAAA,77,1569876
galEp3,2.8333333333333335,136,35,CAACTGTAGCTGAATTGTAA,101,1565237
galEp3,0.05555555555555555,36,35,ATGGGGTCAGCGCGTGCAGG,1,1561807
galEp3,1.1944444444444444,77,35,AGTATACAGGACGGCCCTTC,42,1549803
galEp3,1.6666666666666667,94,35,AGGCACGTTACACACTTCAA,59,1576555
galEp3,0.05555555555555555,36,35,AGCTGATCGGTGGATGGGAG,1,1546757
galEp3,0.05555555555555555,36,35,AAGCCAGATAAGTCATGGCC,1,1587927
galEp3,5.171428571428572,214,34,TTTCCGTTCTTTCCTTACAA,180,1554062
galEp3,3.0,138,34,TGCAGTCTATAGGGGGCTCG,104,1583329
galEp3,0.05714285714285714,35,34,GTTGCCTCTGCACCACTAGA,1,1563482
galEp3,1.1428571428571428,73,34,GTTCGTTCCTAGATGCCATT,39,1558535
galEp3,0.05714285714285714,35,34,GTGTGTAAAAAAACTGATGC,1,1594633
galEp3,5.457142857142857,224,34,GGTCAGGGCTCTTGGTACGG,190,1558621
galEp3,2.5714285714285716,123,34,GGCGTAGGAAAAGTCGGCTG,89,1572199
galEp3,2.2285714285714286,111,34,GGCCGATCGCGTGGCGAACT,77,1566244
galEp3,2.257142857142857,112,34,GATAACCTGCTTTGGTGATG,78,1587733
galEp3,1.7428571428571429,94,34,GAGGGCGCGAATGATATGTA,60,1546712
galEp3,0.08571428571428572,36,34,GACCGCGACGAGGTCTAAGC,2,1556172
galEp3,0.05714285714285714,35,34,CTCTCAGCATTCTGTATTGT,1,1581123
galEp3,2.942857142857143,136,34,CGGCTCCTTTTAGGGTATTC,102,1548216
galEp3,1.2285714285714286,76,34,CGAGACTCGATTAAGGTCTT,42,1554554
galEp3,0.05714285714285714,35,34,CATCTTTTGGTAAGACCAAC,1,1551269
galEp3,0.05714285714285714,35,34,CAGGTCAACGCGGGTGATGT,1,1557125
galEp3,0.05714285714285714,35,34,CAAGAACACATCTTTCCCAG,1,1565487
galEp3,4.142857142857143,178,34,ATGGAGTAGCGCGAAGGAAC,144,1558454
galEp3,4.2,180,34,ATCGCTTTGTAGTGACCGAA,146,1548725
galEp3,0.05714285714285714,35,34,ACTCCACTAACAATCACTAG,1,1558367
galEp3,1.2058823529411764,73,33,TTTCGGTTAGACGGGCGGTT,40,1571842
galEp3,0.058823529411764705,34,33,TGCCTGCCTCGCTCCAGGCT,1,1571437
galEp3,1.6764705882352942,89,33,TCACAGGCCAAGTGCTAATA,56,1551445
galEp3,0.058823529411764705,34,33,GGTTGACACCGGCCCATCAG,1,1561218
galEp3,0.058823529411764705,34,33,GGCTCCAGCATGCCCGTGTT,1,1579246
galEp3,0.11764705882352941,36,33,GCGGCTGACCTTGTTTTCTC,3,1585007
galEp3,0.058823529411764705,34,33,GCCTTAGCTGACGAGTCTTG,1,1575093
galEp3,0.47058823529411764,48,33,GATCTGCACTGGACTCCAGG,15,1549700
galEp3,0.08823529411764706,35,33,GATAATTAGCCAATGTCCAT,2,1572146
galEp3,2.6470588235294117,122,33,GAGAGGCAACTATACACCAT,89,1570350
galEp3,0.11764705882352941,36,33,GAACCTACTGGTTACCCTTT,3,1576625
galEp3,0.058823529411764705,34,33,CTTTCCCCCGAAGCTGTATA,1,1583231
galEp3,0.8823529411764706,62,33,CGGGTCCGCCAATTGTAGAA,29,1594683
galEp3,1.3823529411764706,79,33,CGGCGTTGCCGATCTGAGCC,46,1579756
galEp3,0.058823529411764705,34,33,CGGCCTCTCACAGTGGAGAC,1,1552913
galEp3,0.058823529411764705,34,33,CCGTTCTGGGCGTTTTAGTA,1,1583453
galEp3,0.8529411764705882,61,33,CCGAATGTGAGGTTTCGATT,28,1547447
galEp3,0.058823529411764705,34,33,CAACACCTACTAAGCCCCGA,1,1578493
galEp3,1.2941176470588236,76,33,ATTGTAACGGATACCCAGGT,43,1551177
galEp3,0.8235294117647058,60,33,ATAGTCAGCCCAATCGCAAT,27,1551530
galEp3,2.5294117647058822,118,33,AGTGATTAATCTGCAGGTGC,85,1548769
galEp3,2.264705882352941,109,33,AGCCTTTTACGCAAGAACGT,76,1573412
galEp3,0.058823529411764705,34,33,ACGCTGGACTTAGACCGAGT,1,1551354
galEp3,0.058823529411764705,34,33,AAGTATTTCACTGAAGCGTG,1,1564402
galEp3,0.7272727272727273,55,32,TTATGGGTCAAATGTGGATG,23,1575266
galEp3,1.9696969696969697,96,32,TCTTTCCGCGGGACCCGATG,64,1557316
galEp3,0.15151515151515152,36,32,TAGCGTGAGGAGAACTCAAA,4,1555156
galEp3,0.7272727272727273,55,32,GTGTTGCCTGGTTCCCTGTG,23,1556320
galEp3,0.06060606060606061,33,32,CTAGGTTGACATTGCGGCAT,1,1556753
galEp3,0.09090909090909091,34,32,CGGTAGGGCCGTGACGCCAC,2,1582401
galEp3,1.303030303030303,74,32,CCTCGGCTATTGCTAAAGAT,42,1547970
galEp3,0.06060606060606061,33,32,CCGCGTGTAGATCTAAATTA,1,1575097
galEp3,2.757575757575758,122,32,CAGGGCTTTTGGGAGTGTGT,90,1582280
galEp3,0.5757575757575758,50,32,ATGCTAACACAAATTTGATA,18,1594523
galEp3,3.272727272727273,139,32,AGGGCGTACATAAGGATTTT,107,1546632
galEp3,1.4242424242424243,78,32,AACATTTTGACCTCACTACT,46,1551939
galEp3,2.53125,111,31,TTTCCCGCAAGCCGCCGTGG,80,1561061
galEp3,1.3125,72,31,TGGGAAGCGAATACTCAACA,41,1564625
galEp3,0.0625,32,31,TCTTTGACCGTGCCTACGAG,1,1589368
galEp3,0.0625,32,31,TCTCTGGATACGGTGACGAT,1,1572769
galEp3,0.0625,32,31,TATTCGACTCTTCACTTCAG,1,1579102
galEp3,2.15625,99,31,GGCCTAGGCCCTCGCAGTCC,68,1564545
galEp3,1.625,82,31,GCGTAACCACACATTGAGTT,51,1573259
galEp3,0.0625,32,31,GCGGCGATTCCCAGTTCGTT,1,1576863
galEp3,2.9375,124,31,GACCACCTGTCACACGGTAA,93,1595184
galEp3,0.0625,32,31,CTCATAAGTTCAATTTCTAC,1,1569618
galEp3,2.21875,101,31,CCGAGATCAGGGAAGAAAAT,70,1552054
galEp3,1.5625,80,31,CATAGTAGAGTCGGCTTAAA,49,1589552
galEp3,0.0625,32,31,CAACACCGGAGAGTTTCAAG,1,1565022
galEp3,2.46875,109,31,ATCCGTGCCGAGTCGCTCAT,78,1552294
galEp3,3.21875,133,31,AGAAAGTGCTCTCGGCAATT,102,1557482
galEp3,0.0625,32,31,ACTTCCGAGAGAATAAATTG,1,1564546
galEp3,2.6875,116,31,AAACTATCCTGCATTCATCC,85,1552485
galEp3,3.838709677419355,148,30,TTAACGCTGATGCGCGGTAT,118,1577632
galEp3,0.06451612903225806,31,30,TGTCGGAAAAGATGAAAGTA,1,1571874
galEp3,0.06451612903225806,31,30,TCTGGATTCAATCGGGGGTT,1,1552984
galEp3,0.06451612903225806,31,30,TCGAACGTTTAGATCACAAT,1,1562089
galEp3,2.5806451612903225,109,30,TCAGCTCGTCTTGGGCGTAT,79,1568736
galEp3,2.2580645161290325,99,30,TAAGAGTCATGGGTGCCGAT,69,1568684
galEp3,1.2580645161290323,68,30,GGCTCCCGGCAATACGCCGA,38,1552665
galEp3,0.06451612903225806,31,30,GCCCATACTGAGATCGGATC,1,1593082
galEp3,3.0,122,30,CTTCCGAGATATGGAGGATT,92,1547334
galEp3,0.06451612903225806,31,30,CGGCCGGGACGAGTACCTGT,1,1587581
galEp3,3.225806451612903,129,30,CGGCCCGACTAAAACGGGTG,99,1584937
galEp3,0.06451612903225806,31,30,CCTCGATTTATTGCCACCAC,1,1565249
galEp3,2.7096774193548385,113,30,CAACTTAGTCGCTTTGCCTG,83,1558822
galEp3,1.4516129032258065,74,30,ATCTGGCACTCCTGGGCCGA,44,1587034
galEp3,3.129032258064516,126,30,AGTCGCCCCGGTAACTAGCA,96,1559512
galEp3,0.967741935483871,59,30,AGGAGTCCAGAGGGTTATTA,29,1548182
galEp3,3.5806451612903225,140,30,AGCGTCATTTCAGCTGTATT,110,1562048
galEp3,0.06451612903225806,31,30,ACGGGTACATTTATTACTTA,1,1573745
galEp3,1.2903225806451613,69,30,ACGGGCTTCTTACGGACGTA,39,1576179
galEp3,1.4193548387096775,73,30,AATTGACGACTGCGCACTAT,43,1585349
galEp3,3.4193548387096775,135,30,AAGACTTCAAATGAAAGCGA,105,1567273
galEp3,0.8,52,29,TGACTCCCAAAGTACATTTC,23,1584910
galEp3,3.1,121,29,TCTCAGATGCAATAGACCAG,92,1579538
galEp3,7.066666666666666,240,29,TCTATGAAATCCATAACAAT,211,1563988
galEp3,2.5,103,29,TAACATACTCGGGATGAAGA,74,1559794
galEp3,1.0666666666666667,60,29,GCTCAAGCCAACCAACCCTG,31,1556196
galEp3,0.06666666666666667,30,29,GCCTATAATAAAACAATCGC,1,1551061
galEp3,5.566666666666666,195,29,GAACGATCATGGAGTTCAAT,166,1570958
galEp3,0.06666666666666667,30,29,CTGCGACGGATTTTGTCGCA,1,1558629
galEp3,3.566666666666667,135,29,CGTTCAGCTTCTGCGTACAT,106,1571654
galEp3,2.433333333333333,101,29,CGGGATTCCAAGTCGGAGAA,72,1587294
galEp3,1.2,64,29,CCGACCCTTGCAAAGATTCG,35,1567432
galEp3,1.1,61,29,CCAGGGGGTGGGGTCTCCAC,32,1553264
galEp3,4.366666666666666,159,29,CCAACACATGCGACTCGTTA,130,1569147
galEp3,0.8333333333333334,53,29,CATGGTGACGCCTGGAGATG,24,1577178
galEp3,3.433333333333333,131,29,CATGCGTGCTTAATACTTAT,102,1563169
galEp3,2.6333333333333333,107,29,CAAGTTGTCGGTTGTCGAGA,78,1570913
galEp3,0.06666666666666667,30,29,ATTCGTGGAGTGGCCGAAGT,1,1553593
galEp3,0.06666666666666667,30,29,ATAACATGTCCGGCAGAAAC,1,1572390
galEp3,2.2666666666666666,96,29,AGAGTATAGCATCAGGCTGT,67,1570812
galEp3,1.0666666666666667,60,29,ACGTCCTTTGCGTGGCTACA,31,1552781
galEp3,9.466666666666667,312,29,ACCCTACCACATTTCCACAC,283,1587092
galEp3,0.06666666666666667,30,29,AATGCAGGCCTGTAATTCAG,1,1546933
galEp3,0.06896551724137931,29,28,TTGGTACTGCTGCCATCTAA,1,1573360
galEp3,1.1724137931034482,61,28,TGGTCCCTTGCGGCTCGTGC,33,1571263
galEp3,0.06896551724137931,29,28,TGGAGATTACGGCCGTATTA,1,1581004
galEp3,0.13793103448275862,31,28,TGCAGCACGAAGATGACAGC,3,1573055
galEp3,4.0344827586206895,144,28,TCCTCACGCCGGGCTTAAGA,116,1554228
galEp3,0.06896551724137931,29,28,TCCCCGAGTCCCAGGTGAAG,1,1567018
galEp3,2.1379310344827585,89,28,TACCTTCTCGTTGGGTCCAC,61,1553913
galEp3,4.068965517241379,145,28,GTCTTCACTCAAAATCGATA,117,1570052
galEp3,1.1379310344827587,60,28,GGTGTACAAGGGTTACGGGC,32,1563456
galEp3,0.1724137931034483,32,28,GGCACATTCGTGAGTTACCA,4,1559793
galEp3,1.206896551724138,62,28,GCGTTCACAGACAAAGCTAT,34,1547971
galEp3,2.6551724137931036,104,28,GCCTTCCAAATATGACCTCC,76,1568708
galEp3,2.2413793103448274,92,28,GCCACTCTAATAGGTAGATT,64,1564021
galEp3,2.586206896551724,102,28,GAGTAACCAATCACAGTCAT,74,1587762
galEp3,3.8275862068965516,138,28,GAGAGTACGATGTCCAGCCC,110,1583646
galEp3,1.8620689655172413,81,28,CTCCAGTATCCCAGTGACGG,53,1552321
galEp3,13.793103448275861,427,28,CATATACTGTTCCCCGAGCC,399,1577774
galEp3,2.1724137931034484,90,28,CAGACACTCCCTTCGGCAAG,62,1581899
galEp3,0.06896551724137931,29,28,CAAGGTGGGAGACAGCCGGG,1,1571185
galEp3,2.413793103448276,97,28,AGCGGATCACATATCTCCGT,69,1588867
galEp3,0.6785714285714286,45,27,TTCAATGATTGGGCCTCCTA,18,1591912
galEp3,0.07142857142857142,28,27,TTACAGCCTAGAAGTTTCCC,1,1591689
galEp3,2.2142857142857144,88,27,TGTAGCCAAGATGCTACGTA,61,1551710
galEp3,0.75,47,27,TGTAAGGTTTCATACATGTG,20,1552939
galEp3,0.10714285714285714,29,27,TGGCGTAGAAACAAAGCTGT,2,1558292
galEp3,0.10714285714285714,29,27,TGCGGAACAATGGCTCGTTG,2,1578186
galEp3,5.892857142857143,191,27,TCTTGATAGCACAATATCGT,164,1568229
galEp3,3.9642857142857144,137,27,TCTGGAAGAGTCCACGGTAC,110,1592455
galEp3,0.07142857142857142,28,27,TCGGTGGGTTGCTGGGGGTA,1,1577938
galEp3,1.3214285714285714,63,27,TCACAAGCACCTTTAAAGGG,36,1594860
galEp3,3.107142857142857,113,27,TAGGCCGAGATACGTAGTCA,86,1572352
galEp3,2.607142857142857,99,27,TAATCCGTTTACAGGCAGGT,72,1566768
galEp3,0.07142857142857142,28,27,TAATAATCGCGTTATACTCT,1,1591732
galEp3,0.07142857142857142,28,27,GTTGGTCAGCGCTCGTCCGG,1,1582002
galEp3,0.07142857142857142,28,27,GTCCGCCCGCGGGCGAGTGC,1,1558808
galEp3,1.6071428571428572,71,27,GCGTCAGAAGCGGGTGCCAA,44,1563139
galEp3,0.10714285714285714,29,27,CTTGAGAATAACAATACACT,2,1563746
galEp3,0.07142857142857142,28,27,CGGTTCACGCAGCAGGCCGT,1,1570462
galEp3,0.07142857142857142,28,27,CGCCGCCCCTTTCTATCTGT,1,1578683
galEp3,0.07142857142857142,28,27,CCCGGCCCTAGGACCACAAA,1,1573117
galEp3,0.14285714285714285,30,27,CATGCCACTCAGCCAAGCAT,3,1592274
galEp3,1.0357142857142858,55,27,CAGAGCAGGGGGTCCTTATA,28,1578901
galEp3,0.07142857142857142,28,27,CACCACGGGTCGGATGGTCT,1,1558757
galEp3,3.5,124,27,CACAGGCCTTGGGCATAAGG,97,1547658
galEp3,4.678571428571429,157,27,ATCGCTGGGCTATTCTGCGT,130,1553912
galEp3,2.9285714285714284,108,27,AGTAAGTGACTTGTGTCCCT,81,1563311
galEp3,4.928571428571429,164,27,ACATCGACGTCGAGTTAGAA,137,1577652
galEp3,0.5185185185185185,39,26,TTCTGCCCGGAGAATCGGAG,13,1559971
galEp3,1.4814814814814814,65,26,TTATCCCGAAGAAATCAACT,39,1560874
galEp3,2.4814814814814814,92,26,TTATCATGCCGTCGGCCAAT,66,1562979
galEp3,0.07407407407407407,27,26,TCGTGCGCACAGAAAATCAA,1,1577492
galEp3,2.2222222222222223,85,26,TCCCCTCCCGTCTGCCGCGT,59,1558654
galEp3,1.4074074074074074,63,26,TCATATGGTGTGCTCGCATG,37,1581396
galEp3,1.0,52,26,GTTTACTGTCTGTTGGTTTT,26,1581171
galEp3,3.5185185185185186,120,26,GTGCATTCCAGCTGTAGGGG,94,1566503
galEp3,0.07407407407407407,27,26,GTCTCATCCCCATTACAATG,1,1578815
galEp3,3.2962962962962963,114,26,GGTTAATGCGCAGCGAAGCG,88,1586263
galEp3,0.2962962962962963,33,26,GGGGTCCGGCTTAAGAGCTC,7,1591735
galEp3,0.07407407407407407,27,26,GGATATCGCGTACGTTGGCT,1,1568255
galEp3,3.4074074074074074,117,26,GCCGTTTGGAATTTCTTAGT,91,1579064
galEp3,1.5185185185185186,66,26,GATCTATACTGGCTAAAATG,40,1579986
galEp3,19.14814814814815,542,26,GACTGGGTCTACACTATATT,516,1561991
galEp3,5.592592592592593,176,26,CTATCTCTGTTTTTGTCCCC,150,1580201
galEp3,0.1111111111111111,28,26,CGAGGACTAAAAATCAATGT,2,1580115
galEp3,5.111111111111111,163,26,CCGGGCGTCGCTGATAGTCG,137,1590501
galEp3,0.07407407407407407,27,26,CCGAAGTCGTATGCCCATCA,1,1550582
galEp3,0.07407407407407407,27,26,ATGCTACGAGCTATCATCAT,1,1592767
galEp3,0.1111111111111111,28,26,ATGAGCGGCCCACTCTAGTA,2,1573999
galEp3,0.9629629629629629,51,26,ATAGCCACATGCCGGCCAAA,25,1560141
galEp3,2.2222222222222223,85,26,AGTTGACGCCGTAGACCCCC,59,1561804
galEp3,0.07407407407407407,27,26,AGTCAGTAGTTCCCTTGTTG,1,1591747
galEp3,0.07407407407407407,27,26,AGGCCGAGCCTTAGGTTAAA,1,1552026
galEp3,2.4074074074074074,90,26,ACGATGCAGCATGATTCGAA,64,1556454
galEp3,9.62962962962963,285,26,AATGACTAAGGTACATAAGC,259,1579339
galEp3,0.07407407407407407,27,26,AAGTGGAAATTGTAGGGTGT,1,1579722
galEp3,0.07407407407407407,27,26,AAGGTCAGGTGGTATTACAA,1,1571212
galEp3,6.038461538461538,181,25,TTGCACGGACCCTTTAATTC,156,1562012
galEp3,0.07692307692307693,26,25,TGGATTGACCTGGCACGCAT,1,1549719
galEp3,0.5,37,25,TGCATTAGGCCAGTTCCTTT,12,1555170
galEp3,3.8461538461538463,124,25,TCGGACTAGATAACAAGTTG,99,1550340
galEp3,0.07692307692307693,26,25,TCATATTTACATCACAGTTA,1,1574454
galEp3,3.5384615384615383,116,25,TCACCGGACATCGGAGACAT,91,1582535
galEp3,4.538461538461538,142,25,GTGACTTCTCCAAGTAGTAA,117,1547206
galEp3,0.07692307692307693,26,25,GTCTCGCACAGGAGGCAGAA,1,1558289
galEp3,3.9615384615384617,127,25,GTACAACAGCCGTGAGCCCG,102,1564247
galEp3,0.07692307692307693,26,25,GCTAAAGTAAGTGAGGTCGA,1,1553807
galEp3,0.07692307692307693,26,25,GCGGGGCAATGCGGTACGGA,1,1560111
galEp3,0.23076923076923078,30,25,GACAAGCTTGGCGGCCAGAC,5,1559596
galEp3,1.8846153846153846,73,25,GAACATCTGTTCATGCTGCG,48,1552201
galEp3,0.07692307692307693,26,25,GAAAGGTGGCCGATATCCTT,1,1564459
galEp3,0.07692307692307693,26,25,CTCATCCTGGTGTTTCCCAC,1,1574643
galEp3,1.8846153846153846,73,25,CGGGGGACTGCAACTTGGGT,48,1548107
galEp3,0.07692307692307693,26,25,CGATCGAGCGGGCGACTCCA,1,1582278
galEp3,2.576923076923077,91,25,CCGACTTGAGGTGTTAATAA,66,1557886
galEp3,2.730769230769231,95,25,CCATTACTCGGCGGAAGAGC,70,1547623
galEp3,0.07692307692307693,26,25,ATCGTAGCTTGCATATAAAA,1,1559093
galEp3,0.07692307692307693,26,25,AGTACTGTCTGGTATAACTT,1,1546702
galEp3,4.846153846153846,150,25,ACTACGGTAGAGCATGTAGA,125,1549216
galEp3,0.11538461538461539,27,25,AAGAAGGCTGACCAGATCGG,2,1549004
galEp3,0.07692307692307693,26,25,AAATCTGGTTAGAGTCAGTT,1,1574657
galEp3,1.8,68,24,TTATGAACACAAACTTATAT,44,1559566
galEp3,2.76,92,24,TGCTGTGAGATCGCGCAATG,68,1575045
galEp3,3.44,109,24,TGCAGTGGCTGGAGTAGGGG,85,1548855
galEp3,0.84,44,24,TCCTGAGTCTCACCAGACCA,20,1578855
galEp3,3.72,116,24,TCATCGTTAGCAAAAAGCCC,92,1570709
galEp3,1.84,69,24,TCAGGGGAACGACTACTCTA,45,1561333
galEp3,1.36,57,24,TCAAAGAATGCTATCGATCA,33,1583904
galEp3,3.96,122,24,TACCAGCAGTCTCCGAGAGC,98,1551447
galEp3,0.12,26,24,GTTGGACGGCCTGCCAGACT,2,1585279
galEp3,2.04,74,24,GTCTTAGGCCGTGTCATGTA,50,1571753
galEp3,5.12,151,24,GTCGATCGGTTTTAGATAGA,127,1571150
galEp3,0.12,26,24,GTCAGTTAACCCGTTACATT,2,1585879
galEp3,1.96,72,24,GTAACAAGATTATAGAAAAC,48,1554139
galEp3,2.92,96,24,GGGTCATGTACGAGACTAAG,72,1569912
galEp3,3.24,104,24,GGGGAGACGCAAACGGATAC,80,1564465
galEp3,0.12,26,24,GCTGGCGAATCGTGGATATC,2,1559854
galEp3,0.8,43,24,GCCTCCCGCGGGTGGGTTGA,19,1551999
galEp3,0.08,25,24,GCCGAAATTGAGATAGATAA,1,1576185
galEp3,0.08,25,24,GACACGCCACGTCATGCCAA,1,1580398
galEp3,4.6,138,24,CTGGGCACATAAAAGAAAAC,114,1555123
galEp3,0.08,25,24,CTGATGGCGTCTGGAGTCCA,1,1552382
galEp3,0.08,25,24,CTCCATAAATTCTCGTAAGA,1,1546706
galEp3,14.6,388,24,CTAGCATTCGTCCTCCGCGT,364,1559874
galEp3,1.24,54,24,CGTTCCCTGTAGGGACAGGG,30,1550525
galEp3,4.68,140,24,CGTGCCTCCCGAGTTAAGTA,116,1576554
galEp3,0.08,25,24,CGTCGTCCCGAGATTTCTGA,1,1587735
galEp3,3.0,98,24,CGGCCTGTGAAGAGGTCCAT,74,1552550
galEp3,1.64,64,24,CCTACCGGAAGGGATACCTC,40,1548554
galEp3,0.08,25,24,CCGCAATTTCCGATCGAATC,1,1590723
galEp3,0.52,36,24,CAGATGGCGGCTGGTCAGTC,12,1549711
galEp3,4.48,135,24,CACCCTCGGCAAAGGATGAG,111,1575584
galEp3,0.12,26,24,ATTAGCAGTGGGATTATCCT,2,1577447
galEp3,1.48,60,24,ATGGCCCTCCGAGCCCGGCT,36,1574419
galEp3,2.04,74,24,ATCCGTGCGACAAAATGCCC,50,1566521
galEp3,4.24,129,24,AGTTCGGTTGGCCCCTCAAC,105,1547295
galEp3,0.08,25,24,AGTGCTGTCCTCGTACATTT,1,1549699
galEp3,2.36,82,24,AGGGCGACTACTATCTCGGT,58,1573611
galEp3,1.12,51,24,AGACGATCCAGAGGCACTCT,27,1554529
galEp3,0.84,44,24,ACGTTCTCCGCGAGAAAGCC,20,1566728
galEp3,0.08,25,24,ACCGGGTACGCGAGAGGATA,1,1581342
galEp3,0.08333333333333333,24,23,TGAGCAGGGGCTGAACGCAG,1,1558130
galEp3,18.5,466,23,TCGTAGAACCCTGCCCTCAT,443,1579322
galEp3,0.08333333333333333,24,23,TAGCTACATCGTTACGGTTG,1,1572738
galEp3,3.6666666666666665,110,23,TACATCGATGCAGAACTGTT,87,1562835
galEp3,0.08333333333333333,24,23,TAATTGCAAGTGTAATCGCA,1,1571989
galEp3,0.08333333333333333,24,23,GTGATCGGACCTACTCTCTA,1,1570871
galEp3,3.4166666666666665,104,23,GTGAGTTTCGCGTTGCTTCT,81,1587935
galEp3,0.08333333333333333,24,23,GTCTAATACCGAATCACGGT,1,1591887
galEp3,2.75,88,23,GTCGCTACACGCCCACGCGC,65,1549176
galEp3,4.291666666666667,125,23,GGGTACCGTTTAGCTAAGCG,102,1556989
galEp3,1.75,64,23,GCTTCTCAGGGGGTTAAGTA,41,1576140
galEp3,0.125,25,23,GCCGCCCCGGAGGCCAACCA,2,1559851
galEp3,1.5416666666666667,59,23,CTGCGTGATAAGGAAATCCC,36,1560184
galEp3,2.25,76,23,CTCTAAAATCCACCAGGCGA,53,1552089
galEp3,0.08333333333333333,24,23,CTAGCCTTTGTGCACGGGAA,1,1558287
galEp3,4.416666666666667,128,23,CGGGGCCTGCTATGTGGGAC,105,1593889
galEp3,7.083333333333333,192,23,CGGATGTTCGGCGGCTGGAT,169,1588462
galEp3,0.08333333333333333,24,23,CGAAGGTGCCCGTTAGGTAC,1,1561064
galEp3,0.08333333333333333,24,23,CCTCATGGCCCCTAGTGATA,1,1558331
galEp3,3.5833333333333335,108,23,CCGGGGTGTATTAAGGGGAA,85,1574397
galEp3,0.75,40,23,CAGCCAACGCCTCTTCTTTC,17,1551223
galEp3,1.6666666666666667,62,23,ATTCTATACGCGCTGAGTAT,39,1583772
galEp3,0.125,25,23,ATAATCTCTCCCGGTCACTT,2,1572698
galEp3,0.08333333333333333,24,23,AGCGTAATCGCCGCGTCCAC,1,1579403
galEp3,0.5416666666666666,35,23,ACCAAGATGGCATCTGGGAT,12,1551558
galEp3,0.08333333333333333,24,23,ACAGTCGTAGGCGTATTCGC,1,1589737
galEp3,4.708333333333333,135,23,AAGGTCCCGCAGGAATACTA,112,1553180
galEp3,2.5,82,23,AAATCGGGGCGAGACTATTC,59,1584995
galEp3,1.5217391304347827,56,22,TTTTATGTAGCTCTACTGGT,34,1562165
galEp3,2.6956521739130435,83,22,TTTGATCAGTAGAGGTCTAG,61,1556253
galEp3,3.130434782608696,93,22,TTGTTGTTCCCCTCATAGTT,71,1579961
galEp3,0.13043478260869565,24,22,TTCGCGAGCGTACCGATTAA,2,1582601
galEp3,0.08695652173913043,23,22,TTCGCAGCAAAGAGCACAGA,1,1582373
galEp3,3.652173913043478,105,22,TGGGTTGTCACCGATTGGCC,83,1548578
galEp3,3.5652173913043477,103,22,TGGCGCGGGTGTCTTGATTG,81,1558519
galEp3,0.17391304347826086,25,22,TCCGTGAATATCTCGCTCAC,3,1553022
galEp3,0.13043478260869565,24,22,TCAGGGTCTGATCGGACAAT,2,1556765
galEp3,4.391304347826087,122,22,TCACACACCCTATCACTGAT,100,1574197
galEp3,1.4782608695652173,55,22,TCACAATACACCGACTAGAT,33,1576183
galEp3,0.21739130434782608,26,22,TATGGACGTTCTGAGGCCTA,4,1586370
galEp3,1.7826086956521738,62,22,TATCCTAACATGGCACCTAC,40,1554893
galEp3,0.08695652173913043,23,22,TAGTCTTGAAGCAATTGGCC,1,1548344
galEp3,0.08695652173913043,23,22,TAACGTGTATGAATATCTGA,1,1565166
galEp3,0.08695652173913043,23,22,GGGTTTCTTAAGCTGCGCGA,1,1561314
galEp3,0.08695652173913043,23,22,GGCGTATTAGAGAAATGTGT,1,1571089
galEp3,2.9565217391304346,89,22,GGCGGGCGTTCGCCGAACAG,67,1555834
galEp3,0.08695652173913043,23,22,CTTGATGTCAGATGTGGTTC,1,1552325
galEp3,0.08695652173913043,23,22,CTTGAGGCTACGACAAAAAC,1,1551750
galEp3,4.956521739130435,135,22,CTTATTGGGCAAGGGGACAA,113,1557086
galEp3,3.391304347826087,99,22,CGTTGCATTTCTACGGGGAA,77,1585144
galEp3,0.08695652173913043,23,22,CGTTACTTGAGTCAGATATT,1,1577000
galEp3,0.08695652173913043,23,22,CCGAGGCGCTGACTTCGGCA,1,1551918
galEp3,4.6521739130434785,128,22,CCGAATCTTGTACATGCCAT,106,1549119
galEp3,0.08695652173913043,23,22,CCAAGATCATAAGGCGCCAG,1,1576750
galEp3,0.5652173913043478,34,22,CCAAAGTCCGATGCCGTGGT,12,1564476
galEp3,0.08695652173913043,23,22,CAATCTAAGTCGAGCCATAA,1,1563863
galEp3,0.08695652173913043,23,22,CAAGGCAAAAAGATCAAAAA,1,1567164
galEp3,0.08695652173913043,23,22,CAAAGATTGAGTGCATTCCT,1,1571188
galEp3,4.565217391304348,126,22,ATGTAACACAGTAGAGCCTA,104,1561651
galEp3,2.217391304347826,72,22,ATCTGTAAACGTTCGGGCCG,50,1559454
galEp3,0.9565217391304348,43,22,ATCACAAATAGGTAGGGGCT,21,1552381
galEp3,1.6956521739130435,60,22,ATAGGCATTTCGTCATTCTG,38,1548650
galEp3,0.08695652173913043,23,22,ATAGGAGTAGAGGTCGGAAC,1,1573845
galEp3,0.08695652173913043,23,22,AGGTCGATGCTGGTATTTGA,1,1554360
galEp3,3.391304347826087,99,22,ACGTCCCAAACTAGACTCTG,77,1564969
galEp3,0.6521739130434783,36,22,ACCCAAGCCAGACATTAGAT,14,1570999
galEp3,3.782608695652174,108,22,AAGTAGTACGGTTGATGACC,86,1561162
galEp3,2.0869565217391304,69,22,AAACAACGGTATAGAGATAA,47,1566250
galEp3,0.09090909090909091,22,21,TTCGCAGCAGGAGGACAACT,1,1551351
galEp3,1.5454545454545454,54,21,TTCGACGCAGGCCCAGGCCT,33,1584769
galEp3,2.6363636363636362,78,21,TGGGGAGGTGGTGCACTCTT,57,1549258
galEp3,0.18181818181818182,24,21,TGGATCAATTGATCCCATAG,3,1592235
galEp3,0.8181818181818182,38,21,TGCGAACAGTTAGGAACGTT,17,1559569
galEp3,0.09090909090909091,22,21,TCCGCTCTAAGAACTCTATG,1,1566460
galEp3,0.09090909090909091,22,21,TCCCGGTGCCACCGTGAACA,1,1581114
galEp3,1.0454545454545454,43,21,TCCCGATCGCATACACGCGC,22,1557677
galEp3,0.09090909090909091,22,21,TCATCTCGGTAGCCCTGCAG,1,1574968
galEp3,3.1363636363636362,89,21,TCACAAGTGGTGGCCGGGTA,68,1586832
galEp3,5.2727272727272725,136,21,TATTTTATGTAATTTGGTCA,115,1556981
galEp3,7.545454545454546,186,21,TAGAAAGCACAGTAGGCAAG,165,1560025
galEp3,4.7272727272727275,124,21,TAATAGGAAATTCTTGCTCC,103,1583982
galEp3,7.909090909090909,194,21,TAAAGTCATCTTGCAGAGTT,173,1574001
galEp3,4.0,108,21,GTGATCGTAAATGTATCGAG,87,1551173
galEp3,0.09090909090909091,22,21,GTAGGGCCGGATGTAAACAA,1,1580301
galEp3,5.045454545454546,131,21,GGCATTGACACCACGCTCTA,110,1561963
galEp3,2.090909090909091,66,21,GGATCACGATGTAGATTCTG,45,1552484
galEp3,0.09090909090909091,22,21,GGAAGAGGATGCCCATGGGT,1,1568942
galEp3,2.0454545454545454,65,21,GCGGAAAGCCGTTTGAGCTA,44,1583698
galEp3,4.181818181818182,112,21,GAGAATTTGAACAGGGGGAT,91,1581409
galEp3,2.227272727272727,69,21,GAACCTAACCCATCCAAGGT,48,1559662
galEp3,0.8181818181818182,38,21,CTTCTCTGGAGGGAATGTTT,17,1554852
galEp3,4.2727272727272725,114,21,CTGACTGCTTTTTGGCATTC,93,1580996
galEp3,2.6818181818181817,79,21,CGTCCCAGGGGTAGTCTCCT,58,1550107
galEp3,0.09090909090909091,22,21,CGAACTCTTTGTCCTGAAAT,1,1556216
galEp3,3.727272727272727,102,21,CCTGCTTGGAAGGATGCTAC,81,1593751
galEp3,0.09090909090909091,22,21,CCTCTAAGTCCCAGTCAGGT,1,1560143
galEp3,0.36363636363636365,28,21,CCGAAGCAGGCATTCATTGG,7,1554304
galEp3,0.09090909090909091,22,21,CCCCCATTTAAAGCATCGAA,1,1546822
galEp3,4.181818181818182,112,21,CCAGGGCCAAGGATGTGCCT,91,1567542
galEp3,5.045454545454546,131,21,CATGTAGGTGGGGTGCCGCG,110,1574049
galEp3,3.272727272727273,92,21,CATAAAACAGAACGCGGGGA,71,1558224
galEp3,1.5909090909090908,55,21,CAGGTTTTGGTGTATTCCGT,34,1549766
galEp3,6.545454545454546,164,21,CACTTCGATCCTTATGCCTG,143,1559952
galEp3,0.09090909090909091,22,21,CACTAAGAGCAGCTGGGCCG,1,1591004
galEp3,0.09090909090909091,22,21,ATGGGTGTCGTAATCTGGCT,1,1552490
galEp3,2.227272727272727,69,21,ATGATAATGCATCTCCGCTA,48,1572103
galEp3,2.0,64,21,ATCTGAGCAGGGACCTAGGT,43,1574969
galEp3,4.7272727272727275,124,21,AGTTCTTTACGTCGGTACTT,103,1579094
galEp3,3.909090909090909,106,21,AGGATCACACAAAGTCAAGG,85,1573955
galEp3,0.13636363636363635,23,21,AGCTGGGCAGGTACCTAAGT,2,1560438
galEp3,3.272727272727273,92,21,AGCACGTCCCATATGCGAGC,71,1575295
galEp3,0.45454545454545453,30,21,ACCTTTCATGGTATAGACTT,9,1571001
galEp3,0.13636363636363635,23,21,ACAGTTCTAGAGCCCTATTA,2,1564203
galEp3,3.272727272727273,92,21,AATCTCGCGACGTCTCGACT,71,1588137
galEp3,0.09090909090909091,22,21,AATAGTCATAGGTCCTGGAG,1,1561307
galEp3,0.13636363636363635,23,21,AATACCCTCTACGCGCACAG,2,1577434
galEp3,2.380952380952381,69,20,TTCCGTATTTTCCGCAACTG,49,1549683
galEp3,0.09523809523809523,21,20,TGTCACAAGGCCCATCCCTA,1,1569979
galEp3,2.5714285714285716,73,20,TGCCGGGATGGCTCGCTGTG,53,1556683
galEp3,4.428571428571429,112,20,TGAACGCATGTACCCCCAAG,92,1585668
galEp3,2.857142857142857,79,20,TGAAACTACTTCCACTACGG,59,1565483
galEp3,3.6666666666666665,96,20,TCTTGCTGTAAGATCTAGAT,76,1573346
galEp3,4.095238095238095,105,20,TCTTCACGCAGCTTCAGCGC,85,1565641
galEp3,0.09523809523809523,21,20,TCGTATGCCAAACCTTGTTA,1,1581302
galEp3,0.19047619047619047,23,20,TCAGCTATCATACGTAATGT,3,1557254
galEp3,4.238095238095238,108,20,TATTCATACATTCAAACATT,88,1587649
galEp3,0.09523809523809523,21,20,TACTAGGGTATGGTAGCTGC,1,1573554
galEp3,0.14285714285714285,22,20,GTAACTTTCACATGATGAGA,2,1582154
galEp3,0.09523809523809523,21,20,GGGCTCGGCATGAGGACGAT,1,1564681
galEp3,0.09523809523809523,21,20,GGCCAGAGGATGGAATCGGG,1,1562560
galEp3,0.09523809523809523,21,20,GGAAAAGATCAAGTCTGGTA,1,1562885
galEp3,4.9523809523809526,123,20,GCGCGCCTGGCCTGTTATTA,103,1585145
galEp3,3.0952380952380953,84,20,GCAGACTCACTTTGGTTAAC,64,1560205
galEp3,0.09523809523809523,21,20,GATTCAGGAGTTCGCAAATT,1,1559411
galEp3,5.476190476190476,134,20,GATCTCGGGGTCGAAATATT,114,1557478
galEp3,3.2857142857142856,88,20,GACACTATGGTCCTCCGTAC,68,1563140
galEp3,0.09523809523809523,21,20,GAATGGATTAAGCGTGTCGC,1,1566074
galEp3,2.2857142857142856,67,20,CTTTTACCACTCAACCTGTA,47,1561391
galEp3,4.9523809523809526,123,20,CTACTGTACCTATGACGTTG,103,1561747
galEp3,2.142857142857143,64,20,CTAACCTGCTGCTGAGGCAG,44,1585672
galEp3,2.2857142857142856,67,20,CGTACAAGTGGTGGCGAGGT,47,1583901
galEp3,0.09523809523809523,21,20,CGGCCACATGGTCGCCCAAT,1,1591878
galEp3,5.0,124,20,CGCAAGCTCTTATCCGCCCT,104,1567750
galEp3,5.333333333333333,131,20,CCTGATCCATTCCAGAAGTC,111,1560510
galEp3,0.09523809523809523,21,20,CCTCCTGAGCACAACCAAAA,1,1591916
galEp3,2.0,61,20,CCTCCCTGTTAAGAGCCGAC,41,1550723
galEp3,0.09523809523809523,21,20,CCTAGCATGATAAGGTCCAT,1,1591055
galEp3,3.761904761904762,98,20,CCGAATAGTTATCCAATAAT,78,1558301
galEp3,4.619047619047619,116,20,CCGAAAAGTCTTCCTTACCA,96,1592603
galEp3,0.09523809523809523,21,20,CCAACTGGCAAAGACGTCAC,1,1577495
galEp3,4.523809523809524,114,20,CATGTATAACCTTGGGCATT,94,1572079
galEp3,4.619047619047619,116,20,CAGACAACCATTAGAGTACA,96,1560282
galEp3,0.19047619047619047,23,20,CAAAACATCAAGAGAATTAT,3,1551014
galEp3,1.380952380952381,48,20,ATTTGCTGGAGACCAACTCG,28,1566769
galEp3,2.2857142857142856,67,20,AGTGGCGCAAGGAAAAAGTA,47,1579495
galEp3,0.09523809523809523,21,20,AGGCGGCGCTGACTGTGCCC,1,1553297
galEp3,0.09523809523809523,21,20,AGAGGGCGTAGCGAGGCAGG,1,1546431
galEp3,3.0476190476190474,83,20,ACTTCTCAATCCTGTGCGTC,63,1582157
galEp3,0.09523809523809523,21,20,ACGTTACACTTGCATAAGAG,1,1552093
galEp3,1.5714285714285714,52,20,ACAGTTTAAACGCGCGATTC,32,1593103
galEp3,0.09523809523809523,21,20,ACAACAGTGCGTTGTCGGCT,1,1591670
galEp3,0.09523809523809523,21,20,AAGTGTTATTTTCAATGAAC,1,1593585
galEp3,5.476190476190476,134,20,AACCTGGGCTTCTTGTAGTT,114,1561993
galEp3,2.619047619047619,74,20,AAATCCAACCCATGTTGGCA,54,1556814
galEp3,0.15,21,19,TTTAACTCCGGGTCTCACAC,2,1578411
galEp3,0.1,20,19,TTGTTTGGTAAGCTTCCCTA,1,1568408
galEp3,11.2,242,19,TTGAACCGGATGCGTTTAGG,223,1574116
galEp3,0.1,20,19,TGTTACGACCCCGGGCAGGG,1,1549935
galEp3,3.2,82,19,TGGCTCGGTCTCGGTGTGCA,63,1574915
galEp3,0.1,20,19,TGGAAATCGGAAGTCCATCG,1,1572743
galEp3,0.35,25,19,TCTTCTTGCACGCGAGTCTA,6,1550013
galEp3,0.1,20,19,TCTAGACGTCCAAGTGCTCG,1,1548146
galEp3,5.3,124,19,TCGAGTGTCAAACAGCCTTT,105,1587895
galEp3,3.3,84,19,TATAATCTACATTTATCTGA,65,1586934
galEp3,0.1,20,19,TAGTGGTTGGACCGGACTTG,1,1548906
galEp3,0.15,21,19,TAGTGGCCTCAGCACCGTTT,2,1590857
galEp3,4.6,110,19,TAAGCACAGTTTATGTATGA,91,1546831
galEp3,0.1,20,19,GTCGGCCCCATGCGTATGAG,1,1557253
galEp3,3.35,85,19,GGGTAGCTTCAAACTGCGCT,66,1564212
galEp3,1.85,55,19,GCTGAAAAATAGTCCACAAT,36,1554070
galEp3,4.55,109,19,GCTATTAGCTCAACCTGCAG,90,1564853
galEp3,0.1,20,19,CTTCTCAGTTGGAGCGTTGG,1,1573609
galEp3,4.45,107,19,CTGAGATGTGGAAGGGTACC,88,1563984
galEp3,0.1,20,19,CGCTCCCGGCTACATATCAG,1,1546939
galEp3,4.4,106,19,CCGCCTAGGACGTTGGTGAT,87,1571223
galEp3,3.25,83,19,CCCGGCCAAAGGGAGAAATA,64,1555948
galEp3,4.7,112,19,CAAGCGTCCGTAGGACAGCC,93,1575513
galEp3,3.9,96,19,CAAGCCTGCGCGCGTGTCCA,77,1567247
galEp3,0.1,20,19,ATGTGGCCGCCGGTCTGGAG,1,1557094
galEp3,5.55,129,19,AGTGGGCGCGGCCGGGTCAC,110,1564399
galEp3,3.45,87,19,AGGGGATGTTGGGAGTGCTA,68,1552437
galEp3,4.7,112,19,AGCGAATGGCCCTACGGCTT,93,1584871
galEp3,5.25,123,19,ACTGGGTGTGCTTCTCCGTT,104,1546850
galEp3,6.15,141,19,ACGAGGATCTTTGTTGTTCA,122,1576421
galEp3,1.7,52,19,ACCCTAGGATAGCAACCCGA,33,1552115
galEp3,1.4,46,19,ACACTATCAATCGTGCTGTG,27,1563174
galEp3,2.65,71,19,ACAATGCTCAACTCTACTCC,52,1554880
galEp3,2.2,62,19,AATTGGGCATCATGGTCGAT,43,1546556
galEp3,6.9,156,19,AAGCATGTGTGAAGTAAAAC,137,1558496
galEp3,0.1,20,19,AAGAGCGTGAAGCCTTTATT,1,1569773
galEp3,0.1,20,19,AACTAGACAAACGGAATATT,1,1563251
galEp3,4.9,116,19,AACCTTGTGAAACAAGACGA,97,1577974
galEp3,2.4,66,19,AACACTCTGTCCTTCGTCAC,47,1548179
galEp3,4.947368421052632,111,18,TTTTGCTTTTCCCTCGTCAT,93,1589163
galEp3,4.578947368421052,104,18,TTCTAATGTGCTAGTCACTG,86,1551218
galEp3,6.842105263157895,147,18,TTAGTATACGTATTATGTTA,129,1583427
galEp3,1.0526315789473684,37,18,TGTTTCGCCTGCCTCGGATG,19,1575377
galEp3,0.10526315789473684,19,18,TCCATCTAGAGCCTGTCCTA,1,1577040
galEp3,3.1578947368421053,77,18,TCATGTCATAACATGCAGAA,59,1556863
galEp3,1.5789473684210527,47,18,TCATCGATGGCTCCTTCCTT,29,1590795
galEp3,3.5789473684210527,85,18,TCAGCGTATATTCCATAGAG,67,1555434
galEp3,1.8421052631578947,52,18,TATTATGGCCCAGACGCGCG,34,1589490
galEp3,0.10526315789473684,19,18,GGCTACACACATCATCATCT,1,1558357
galEp3,8.105263157894736,171,18,GGCGAAATTAGTTAGTACCT,153,1556982
galEp3,3.5789473684210527,85,18,GCTGACGTGACACATGCAAT,67,1593888
galEp3,0.10526315789473684,19,18,GCGGCTAACCAGATGCCAAT,1,1588588
galEp3,1.9473684210526316,54,18,GCCTCGTAGGCCACCCATAT,36,1588165
galEp3,2.6842105263157894,68,18,GCAAGTAGTTTCCGGTCAAC,50,1548770
galEp3,6.0,131,18,GACTCCCATTAACCCTGGCT,113,1580228
galEp3,2.210526315789474,59,18,CTGCTGAGAGTGCAGCGTAC,41,1594859
galEp3,0.10526315789473684,19,18,CTCCTGGCGGCACGCTGAGC,1,1590705
galEp3,4.526315789473684,103,18,CGTGCGATAATGGTTACGAG,85,1586305
galEp3,9.105263157894736,190,18,CGTATTTACTTAGGCCGAGA,172,1579775
galEp3,6.526315789473684,141,18,CGATGTACACGCGTACAATA,123,1589339
galEp3,0.10526315789473684,19,18,CGATCGGTCTCATACCGCTG,1,1565658
galEp3,4.578947368421052,104,18,CCTCATTCGAGCACGTGCAG,86,1590690
galEp3,3.1052631578947367,76,18,CCGCGCATCTGTTGTCTACG,58,1591688
galEp3,3.5789473684210527,85,18,CCCTCGCCTCAGTTATTTTT,67,1564848
galEp3,2.1578947368421053,58,18,CCCCTGCCAACGGAACGAAA,40,1590439
galEp3,0.15789473684210525,20,18,CCCCAACGTTATAGCGTATT,2,1551890
galEp3,0.21052631578947367,21,18,CCCACACCCCTCTGGGTCTT,3,1558163
galEp3,0.10526315789473684,19,18,CACATCATGTATACCAGCGT,1,1578555
galEp3,3.6315789473684212,86,18,CACACCCGGGAAAAGGTGCG,68,1550868
galEp3,5.2631578947368425,117,18,CAAACTCCACCCATATCCGT,99,1584231
galEp3,7.2631578947368425,155,18,ATGCGGAGAGCGCCCTATCC,137,1576159
galEp3,0.3157894736842105,23,18,ATCTTATCCCTCTTTGGGCA,5,1554750
galEp3,0.10526315789473684,19,18,ATAGCATTGATGCACCCCTT,1,1575650
galEp3,2.3684210526315788,62,18,ATAACGAACAATGTGTAAGT,44,1546828
galEp3,0.10526315789473684,19,18,AGGAATTTTACAGAGAGTGT,1,1547035
galEp3,3.5789473684210527,85,18,AGCGACGTATGCGGGACTAA,67,1576992
galEp3,3.6842105263157894,87,18,AGAGATTACGCTCTATTTTC,69,1554386
galEp3,0.15789473684210525,20,18,ACAGGGGCAAGTGGGGTGAG,2,1550919
galEp3,3.8947368421052633,91,18,AATGTGCCGACCATCGAGAA,73,1565588
galEp3,0.10526315789473684,19,18,AAGCTCTATAACTGCGTTAA,1,1592702
galEp3,4.055555555555555,89,17,TGAAGTAGGTATCTCGGAGA,72,1561070
galEp3,0.1111111111111111,18,17,TGAAGCTAGACGCCGAGCCT,1,1575656
galEp3,0.7777777777777778,30,17,TCGGAAGAACGCGCAGAAAG,13,1584962
galEp3,0.16666666666666666,19,17,TAGTCTAAGGTCGAACACAG,2,1593669
galEp3,1.6111111111111112,45,17,TAGAGAAGATTAGCCATGTT,28,1554902
galEp3,0.1111111111111111,18,17,TAGACAAACCCACGCTCGGA,1,1577937
galEp3,3.388888888888889,77,17,TAATTCAAATCGCCGTGAAT,60,1563803
galEp3,5.333333333333333,112,17,GTTACCCCGTGCCCTGTCTG,95,1547460
galEp3,0.1111111111111111,18,17,GTGTTTCCAAGGATGCTGTA,1,1554029
galEp3,2.611111111111111,63,17,GTGAAAATGTAGAACGATGT,46,1571428
galEp3,0.1111111111111111,18,17,GTAGGGTTTGAAAGTTCCGT,1,1594323
galEp3,0.1111111111111111,18,17,GGTCAATCTACGACACTTGT,1,1594730
galEp3,3.9444444444444446,87,17,GGGTGGTCAGTTCCACACAG,70,1564090
galEp3,0.1111111111111111,18,17,GGGAAATGGCTTAGGGGGAA,1,1564929
galEp3,0.1111111111111111,18,17,GGCATAGTTCTGACTGTACG,1,1546492
galEp3,3.6666666666666665,82,17,GCTAAGCGGTCATTAGGACC,65,1581924
galEp3,4.944444444444445,105,17,GCGAGCGGTAAGATCGGCTC,88,1575754
galEp3,0.1111111111111111,18,17,GCCTCGAAGCTGTCATTGTG,1,1580372
galEp3,3.0555555555555554,71,17,GCCTAAAGACCCCTAACATT,54,1570814
galEp3,0.1111111111111111,18,17,GCAGGCGTTTAATTCCTGTG,1,1562898
galEp3,8.222222222222221,164,17,GAGCTTGTCTCGATAATAGC,147,1573364
galEp3,5.555555555555555,116,17,GACGTGGAAGTACACGCAGA,99,1575264
galEp3,3.9444444444444446,87,17,GAACACCCGGGGACAACACC,70,1583090
galEp3,0.8333333333333334,31,17,CTGCCTCCACAGTATTTTGT,14,1568780
galEp3,0.7777777777777778,30,17,CTGAGTTAAGGGCGTTTCGG,13,1548315
galEp3,0.6111111111111112,27,17,CTCGCAACGTGATCCGACTT,10,1561951
galEp3,3.888888888888889,86,17,CTATGGGTTAAGATGTGGGG,69,1564248
galEp3,3.6666666666666665,82,17,CTATATAGGCTGCATCGCGA,65,1570265
galEp3,5.944444444444445,123,17,CTACAAACGGGCCGGTTCAT,106,1578584
galEp3,1.3333333333333333,40,17,CGATTTTGTGCCTATCGAGT,23,1549150
galEp3,0.1111111111111111,18,17,CGATGACGAGAATGTTTACT,1,1584470
galEp3,0.1111111111111111,18,17,CGAGTGCGATTTTACGGTGA,1,1564161
galEp3,2.388888888888889,59,17,CGAGGGTCAGTCCACACTCT,42,1578594
galEp3,0.1111111111111111,18,17,CGACAGGATCAAATCGGCCT,1,1565720
galEp3,5.611111111111111,117,17,CCTTCTATACTGGCCTTCAG,100,1587737
galEp3,2.5555555555555554,62,17,CCGGGACGTCGGCGATATGT,45,1560742
galEp3,2.2222222222222223,56,17,CCGAACTTATGCACCGGAAA,39,1550737
galEp3,0.2222222222222222,20,17,CCCTAGAGTGAAGCCGCGGT,3,1557437
galEp3,5.722222222222222,119,17,CCCCAACGAAATAAGCGGTG,102,1554063
galEp3,3.4444444444444446,78,17,CATCGAAGCTAAAACTTAAA,61,1566167
galEp3,1.3333333333333333,40,17,CATCCGCATAGGGCGTCTTT,23,1579952
galEp3,6.166666666666667,127,17,CAGTTAACGATACCCAAAGT,110,1576049
galEp3,3.2222222222222223,74,17,CAGTCTAGAAATTCATTCTA,57,1562932
galEp3,4.222222222222222,92,17,CACAAGCATGAAATTCCAAT,75,1554492
galEp3,0.1111111111111111,18,17,CAAGCTAGGTTGCACGCGAG,1,1573257
galEp3,3.388888888888889,77,17,CAACCTTGGTATGGTAACCT,60,1554616
galEp3,0.1111111111111111,18,17,CAAAAGCGTTCGTAGGCAGT,1,1567322
galEp3,0.1111111111111111,18,17,ATTTCGGGTCGGATATGTGC,1,1558138
galEp3,3.9444444444444446,87,17,ATTCGAGGCTGTCCAAAATA,70,1567546
galEp3,0.16666666666666666,19,17,ATGTTTATTGCAAGGACCAG,2,1567388
galEp3,5.5,115,17,ATCATTGTTTTCACTGGTAC,98,1556134
galEp3,4.111111111111111,90,17,AGTTTCCCGCGCATTCTTGA,73,1562490
galEp3,1.8888888888888888,50,17,AGGACTGGTTCCTTAGTTGT,33,1575490
galEp3,0.1111111111111111,18,17,AGCCAAGGGGGTCGGGTGAT,1,1554178
galEp3,3.5,79,17,AGACGTATCAGTCAAATTTG,62,1559173
galEp3,6.0,124,17,ACTCGTCCCTTGCCCCGAAA,107,1585827
galEp3,2.6666666666666665,64,17,ACTCAGGTGGTCCGTGCTTT,47,1585948
galEp3,2.8333333333333335,67,17,ACTATTATGTGTCGTCCACG,50,1547251
galEp3,0.1111111111111111,18,17,ACGTGCTTAAGACGGAAATG,1,1558184
galEp3,0.1111111111111111,18,17,ACAAGTGGGGCTTAGTGACG,1,1593462
galEp3,8.588235294117647,161,16,TTTTATGAATGATCATCCTC,145,1562520
galEp3,3.4705882352941178,74,16,TTGTGTCTTTGCCCAGTTGT,58,1550495
galEp3,1.3529411764705883,38,16,TTGAACCAGCTAGAGTTCGT,22,1582839
galEp3,6.647058823529412,128,16,TTCTGCAATAGTACCATGGA,112,1568397
galEp3,10.294117647058824,190,16,TTCCCGGCCATTAGAAAAGG,174,1555138
galEp3,8.294117647058824,156,16,TTAAGGATATTCACTGAGCC,140,1561269
galEp3,3.176470588235294,69,16,TGTTGAGCACGACGGACGAG,53,1581805
galEp3,0.11764705882352941,17,16,TGGTGTGTCTATAGGGGCAT,1,1579328
galEp3,0.11764705882352941,17,16,TGAAGGGCTCTATTAACATG,1,1564866
galEp3,0.11764705882352941,17,16,TCTGTGCCCCATCGCTTTAC,1,1560849
galEp3,0.11764705882352941,17,16,TCTGAATCTATCACAAAGTC,1,1589446
galEp3,0.11764705882352941,17,16,TCGTCGTTCCTTACATTAGT,1,1581155
galEp3,0.6470588235294118,26,16,TCGGCCTCATTACATCCCAA,10,1555578
galEp3,0.17647058823529413,18,16,TCGCAGAAAGTTCGCTGGAA,2,1556110
galEp3,0.29411764705882354,20,16,TCCTCTGACCCTAGCGCGAT,4,1565376
galEp3,0.11764705882352941,17,16,TCAATCTGGTCTTCAAGGCC,1,1591238
galEp3,5.882352941176471,115,16,TAAGTCTAATTAACCGATTA,99,1578434
galEp3,2.1176470588235294,51,16,GTTTTAGACAACAAGCTGAG,35,1559440
galEp3,0.11764705882352941,17,16,GTTTCTATAACTTTTTGGGT,1,1561036
galEp3,5.529411764705882,109,16,GTTGCTTTGCCGGGGACGTA,93,1564590
galEp3,5.352941176470588,106,16,GTCACGGGTAGACTACGGGT,90,1549020
galEp3,1.1176470588235294,34,16,GTCAAATACTCCTTCTACGG,18,1592370
galEp3,2.2941176470588234,54,16,GTATCAACTTGCTCCACCCG,38,1562053
galEp3,4.411764705882353,90,16,GGGGAATCACGTTAGACTCT,74,1579335
galEp3,0.11764705882352941,17,16,GGGAAATATCTTTGGTACAG,1,1548892
galEp3,0.11764705882352941,17,16,GGAGGTGGTTTATCGGGACC,1,1563635
galEp3,2.176470588235294,52,16,GCTGAAGACACCTCTTCGGT,36,1555915
galEp3,6.647058823529412,128,16,GCGATGTAGCACAAAGCGGG,112,1547709
galEp3,1.2941176470588236,37,16,GCCGTGTCCATCACGTTTAG,21,1553973
galEp3,7.117647058823529,136,16,GACCTTTTGCAAGAATCCTC,120,1581108
galEp3,1.1176470588235294,34,16,GACAACTTCATAAGCCCAAT,18,1579463
galEp3,2.9411764705882355,65,16,CTTGAACAGTCCGGGTATCA,49,1555833
galEp3,2.3529411764705883,55,16,CTGCTGCCCCGTCCGGCTTT,39,1571260
galEp3,0.11764705882352941,17,16,CTAATATGGATCCTCTTTGA,1,1581803
galEp3,7.647058823529412,145,16,CGTCGTACGGCAGCCCACTT,129,1565494
galEp3,0.11764705882352941,17,16,CGCGTGTCATATTTACTCGT,1,1566852
galEp3,0.11764705882352941,17,16,CGCGTCTAACTCGGACATGC,1,1559817
galEp3,0.11764705882352941,17,16,CGCGGGGATCTATCTTGCCT,1,1579950
galEp3,0.11764705882352941,17,16,CCTGACACGCCATGTTGCTG,1,1583132
galEp3,1.6470588235294117,43,16,CCGTAACATCGGGTCAAGTC,27,1591107
galEp3,7.705882352941177,146,16,CCGAGTTTACTTAAGATAGA,130,1557969
galEp3,3.2941176470588234,71,16,CCCCGCCGAAGACACATATG,55,1588790
galEp3,4.117647058823529,85,16,CCAAAAGGCGGGATGTGGAG,69,1584936
galEp3,5.235294117647059,104,16,CAATTTATAAATGACCATAA,88,1560382
galEp3,0.4117647058823529,22,16,ATTCGTGCGCCGCATGCCGG,6,1554223
galEp3,5.705882352941177,112,16,ATCGTATGTGTTCTCAACAA,96,1570710
galEp3,4.529411764705882,92,16,AGTGCCGCTATTGTGGTCAC,76,1561995
galEp3,0.11764705882352941,17,16,AGCTAGGCAAACTGCATGTA,1,1554039
galEp3,0.11764705882352941,17,16,AGCCCTCACTTTAGTCATGA,1,1557500
galEp3,0.11764705882352941,17,16,ACTCTATTTCGCCAGCGTAT,1,1592475
galEp3,0.11764705882352941,17,16,ACGTCCTGCCCATCTGAAGT,1,1550440
galEp3,4.352941176470588,89,16,ACGGGTAGGAGCAGCAAACG,73,1576925
galEp3,0.11764705882352941,17,16,ACGCGCTTCAGCGCTTCTGC,1,1576223
galEp3,5.117647058823529,102,16,ACCCGTAATCATACCGCGTA,86,1557341
galEp3,0.11764705882352941,17,16,AAGGAGATTATGGTCCAGGT,1,1563817
galEp3,0.125,16,15,TTTGTAGGAGGCGTTGTTAT,1,1547239
galEp3,3.4375,69,15,TTCTCAGCAGCTCCAGCTTC,54,1556609
galEp3,0.875,28,15,TTCACACATACCTGGCTCCT,13,1584031
galEp3,0.125,16,15,TTAGGTGTGTCGAGACAGAA,1,1560508
galEp3,3.4375,69,15,TTACGGCACTATCTACCATA,54,1570058
galEp3,2.5,54,15,TGCGTCATCGGTAACTCACT,39,1551001
galEp3,19.125,320,15,TGAGCGTTCCAGTGCAGGTC,305,1561992
galEp3,4.4375,85,15,TCTAGTTGAGTTGGGACTAG,70,1581449
galEp3,0.1875,17,15,TCCGACACGCGGCCTCGAGT,2,1573031
galEp3,1.6875,41,15,TCCAATTGTCGCCTTACATG,26,1583943
galEp3,2.9375,61,15,TCAACTGTGTCTGTTGGGAA,46,1546761
galEp3,6.375,116,15,TCAACTGGTACACAATGGTA,101,1557797
galEp3,6.875,124,15,TAGAGCAGCACAAGCACAAA,109,1571179
galEp3,2.5625,55,15,TAGAAGAAAAAAAAGCCACA,40,1568247
galEp3,4.375,84,15,TACAGGTTCATCCAGGTTGG,69,1573671
galEp3,0.125,16,15,TAATACGTCCTTGGACACCA,1,1546896
galEp3,10.0625,175,15,TAATAACCAATGAGAATCTC,160,1583527
galEp3,8.1875,145,15,TAAAAGATAACGCCCGATCA,130,1583819
galEp3,3.125,64,15,TAAAAACTCCTATGGTCTCG,49,1556993
galEp3,5.3125,99,15,GTCGTTAGCTTCATTACTGA,84,1561736
galEp3,2.25,50,15,GGTGGTGCTATCGGCAATAT,35,1547794
galEp3,6.875,124,15,GGGACCCATGGCACTTAGGT,109,1571371
galEp3,0.125,16,15,GGCATCAAAAAACATTTCCT,1,1575272
galEp3,5.875,108,15,GGCATATAATCCAGGTTTAG,93,1548617
galEp3,0.125,16,15,GCGTACGGATGCTGAGGCCT,1,1587533
galEp3,0.125,16,15,GAGATTAGGCGTGAGAGAAA,1,1592105
galEp3,2.875,60,15,GAGATCACACCTGCGGCCGC,45,1581742
galEp3,20.0625,335,15,GACTGTATCTAAGGCGGGAT,320,1556770
galEp3,0.625,24,15,CTTTTCGTGTCATTGGACCT,9,1569599
galEp3,0.125,16,15,CTTGACGCCCGGTTCATTAT,1,1551188
galEp3,0.125,16,15,CTCTACAATTGGATCAGCGT,1,1571416
galEp3,3.1875,65,15,CTCCAGGTTAACCCCGAGGT,50,1555951
galEp3,5.875,108,15,CGTTCTATCTCTGCAGTCAA,93,1557018
galEp3,6.0,110,15,CGGTGCGCCCACTCCTGCAG,95,1574239
galEp3,0.125,16,15,CGCGAACCGACCATTTGCCT,1,1553519
galEp3,3.9375,77,15,CGACTTCCCCGCTTCTGATT,62,1578598
galEp3,0.375,20,15,CCTGGGGAGAGCTCGAATAG,5,1586130
galEp3,5.375,100,15,CATACGCTTGAATTTGATCC,85,1590461
galEp3,4.875,92,15,CAGTGGGGTCTGAGGAAGGT,77,1553677
galEp3,6.9375,125,15,CAGACTCCGTCGTCAGGGTC,110,1575563
galEp3,0.3125,19,15,CAGACTCCCGGTAATTTCTA,4,1591050
galEp3,4.25,82,15,CACTGTGGGGTGAACTGTGG,67,1562906
galEp3,0.25,18,15,CACACCGCATAGAACTGATA,3,1572073
galEp3,0.125,16,15,ATGCCCCACACTACCCTCAA,1,1574811
galEp3,0.125,16,15,AGGCGTCTCGTAGCTTTAAG,1,1580871
galEp3,6.3125,115,15,AGCCGTCTGGTCCACCACTG,100,1559807
galEp3,4.875,92,15,AGCAAAAGTTGCTGTGTACT,77,1574609
galEp3,0.125,16,15,AGATGTCCAGCCGGAGAGTT,1,1553497
galEp3,0.25,18,15,AGAAAGTTCGGGTCATCACC,3,1591692
galEp3,11.625,200,15,ACTTGAGCTTATCCCAGGCG,185,1563871
galEp3,0.125,16,15,ACATACGGAACCGACCGATC,1,1561066
galEp3,4.375,84,15,ACACTCCGATCAGTGAATTG,69,1593575
galEp3,0.125,16,15,AATTATCAGCGATACCTATT,1,1568546
galEp3,3.0,62,15,AACGCAGTTGCATCAACCAG,47,1550291
galEp3,9.9375,173,15,AACAGTCCCCGTCTTGTCGA,158,1585351
galEp3,1.3125,35,15,AAAGATTGTGCAGGTCCACT,20,1564812
galEp3,7.733333333333333,129,14,TTTAGCGCATGTCTAACTAT,115,1552721
galEp3,0.2,16,14,TTGCATCCTCCTGTGTCATC,2,1583401
galEp3,0.13333333333333333,15,14,TTCTTATCCACTTGTTGCAA,1,1556325
galEp3,1.2,31,14,TTATGTAAAGATCTACCCTC,17,1567156
galEp3,2.6,52,14,TGGTGCGGGGAAAACGGCTA,38,1571445
galEp3,0.13333333333333333,15,14,TGGTCGTGTCATGGACTAAA,1,1587056
galEp3,0.13333333333333333,15,14,TGCCGTAGGAGCAATAGCCC,1,1546859
galEp3,1.7333333333333334,39,14,TGATCCCGCCGGGCATTTCA,25,1590880
galEp3,6.2,106,14,TGATAGTTTAGCCCGATACA,92,1565745
galEp3,3.6666666666666665,68,14,TCCTCACAATAGCGTTCTCA,54,1580207
galEp3,0.13333333333333333,15,14,TCAGGCACCTAGGAGCTCTA,1,1555997
galEp3,4.066666666666666,74,14,TATTGTACACGGCCATGACC,60,1552055
galEp3,0.13333333333333333,15,14,GTTTCAGAAACGTGGGGCTC,1,1574416
galEp3,0.13333333333333333,15,14,GTGCGCGCGATTTGTCGAGA,1,1554129
galEp3,0.2,16,14,GTCCATCTGCATTGGGCTAG,2,1571276
galEp3,3.2,61,14,GGGTATACAACGCTCTGGGT,47,1557820
galEp3,8.866666666666667,146,14,GGCGTCTCAAGATACAGCGC,132,1583323
galEp3,0.13333333333333333,15,14,GGATCTCACCCGGGTTCCGT,1,1578973
galEp3,0.4,19,14,GGACTCGGGCAGCGGACTCT,5,1590337
galEp3,11.933333333333334,192,14,GCTAAGCATTCGTCACCAGT,178,1575689
galEp3,0.8,25,14,GCCATCAAACCGCCCTGCAG,11,1586959
galEp3,0.13333333333333333,15,14,GCAGCTGAGGTCTTCATATT,1,1562308
galEp3,0.13333333333333333,15,14,GACGGCTGGCCGGAGGCAAA,1,1579659
galEp3,2.8666666666666667,56,14,CTTGGTTCTTCTGCACTCCC,42,1558165
galEp3,6.933333333333334,117,14,CTGTGGTATGATTGTTATCT,103,1584703
galEp3,10.266666666666667,167,14,CTCGAGGGTGCTGACACGTA,153,1564585
galEp3,6.266666666666667,107,14,CTCCCTTTTGGCCAACACGG,93,1564504
galEp3,0.13333333333333333,15,14,CGGTTTCGCCCAAATGCATA,1,1591092
galEp3,5.666666666666667,98,14,CGGTGGTTTCTACCAGTGGG,84,1562034
galEp3,7.133333333333334,120,14,CGGCGTCCAACATTTACACT,106,1576440
galEp3,0.13333333333333333,15,14,CGGCCTGAGGTTAGGGTTAG,1,1553061
galEp3,0.13333333333333333,15,14,CGGAAAGAAGTGTTAATTTG,1,1592189
galEp3,0.5333333333333333,21,14,CGCTGTCTTTAACACCTGCT,7,1559225
galEp3,0.13333333333333333,15,14,CGCTCGCCGCCAATCGTAGC,1,1581975
galEp3,2.066666666666667,44,14,CGCCAACTCTATACAACGAC,30,1559800
galEp3,2.6,52,14,CCTGCTCTCCTAATCAGACC,38,1584407
galEp3,6.066666666666666,104,14,CCGTTAAGGTCTGACGTTTA,90,1572887
galEp3,6.6,112,14,CCACTGCTCATAAAGTTGAG,98,1580688
galEp3,10.2,166,14,CATGGATAATGCCAACTTGC,152,1547711
galEp3,4.533333333333333,81,14,CATCTTTAAACCGGAGCGTA,67,1548341
galEp3,5.4,94,14,CAGCTACCCTATGCGAGTTC,80,1568152
galEp3,5.066666666666666,89,14,CAAGCCATCTTAAGTCCTAC,75,1568773
galEp3,0.13333333333333333,15,14,ATTTGTAAGCCAGTTGCGTT,1,1568083
galEp3,0.13333333333333333,15,14,ATGTTGAGAATCTAGTGATT,1,1570269
galEp3,7.333333333333333,123,14,ATGGCGTGTCCTTGCTGAAG,109,1561031
galEp3,5.6,97,14,ATCTTGAGATTAGACATAGA,83,1571195
galEp3,5.6,97,14,ATACAGTCTAAGAACTAGGC,83,1550609
galEp3,1.2,31,14,AGTGGTCCCCTCACGGAATA,17,1563708
galEp3,0.13333333333333333,15,14,AGTCGCCAGGCTCAAGCGGC,1,1580640
galEp3,0.13333333333333333,15,14,AGGGGTGTCATACCCCGTGT,1,1549971
galEp3,3.4,64,14,AGCGGAGAGCTTGACCGTGC,50,1561492
galEp3,0.13333333333333333,15,14,AGAGATACCGAAGTAGGTAG,1,1576700
galEp3,0.13333333333333333,15,14,AGAGAGCACCACTTTAGAGA,1,1583643
galEp3,0.4,19,14,ACTTTGATCTTTCCGACCAC,5,1587354
galEp3,6.666666666666667,113,14,ACACACTAGCGATGGGATGC,99,1569502
galEp3,1.0666666666666667,29,14,AATTATCCCGTCTCTGGGAA,15,1573417
galEp3,0.13333333333333333,15,14,AAGCTTTAGGCAGAGTGTAG,1,1593893
galEp3,2.466666666666667,50,14,AACCCATTTTAGCTAACGCA,36,1550333
galEp3,0.14285714285714285,14,13,TTGTGGTCAATCGGCAACTG,1,1579367
galEp3,6.857142857142857,108,13,TTCGATAGGAGAGCATTTTT,95,1570010
galEp3,7.785714285714286,121,13,TTAGGGTCTGCACGTTAGCC,108,1547333
galEp3,0.14285714285714285,14,13,TTAGGCCAGCTAGCTGTCCC,1,1546661
galEp3,0.14285714285714285,14,13,TGTGGCGTGTGAATGACCAA,1,1578682
galEp3,0.14285714285714285,14,13,TGGAAGCGGGAACACTGATT,1,1560144
galEp3,8.714285714285714,134,13,TGCACCACCCGCTCTACTTC,121,1572011
galEp3,2.7857142857142856,51,13,TGAGTACACTCACCGTAGGT,38,1588688
galEp3,3.2142857142857144,57,13,TGACATGTGTTCGCAATAGG,44,1573041
galEp3,0.21428571428571427,15,13,TCGCCCTTCCTGTACCGGAA,2,1546677
galEp3,5.5,89,13,TCGCATTGCTATATCGCACT,76,1582938
galEp3,4.571428571428571,76,13,TCGATGACCTCTTCCACCAG,63,1553178
galEp3,0.14285714285714285,14,13,TCAGCTCATATAGATAGCTT,1,1553385
galEp3,1.1428571428571428,28,13,TCAGCAGGGGACGATCCTGA,15,1553011
galEp3,5.928571428571429,95,13,TCACGCATACGCTTCCTGGG,82,1575042
galEp3,6.285714285714286,100,13,TATTTGTAAACTCGTCAGAT,87,1565484
galEp3,6.0,96,13,GTTACGACGCCGAGATCAGA,83,1564278
galEp3,0.14285714285714285,14,13,GTGAGGTCCACGCATAATGT,1,1572965
galEp3,0.14285714285714285,14,13,GTGAAGGGCATGTGTTGAGG,1,1553827
galEp3,0.14285714285714285,14,13,GTCCAGACCTCCCGTGTAAA,1,1591531
galEp3,0.14285714285714285,14,13,GTCAGCGCAAAATGCGATCA,1,1575940
galEp3,0.14285714285714285,14,13,GGTCCCCCAACCACAGTCCT,1,1557225
galEp3,5.928571428571429,95,13,GGGGGGATCTTCTGGGGTTT,82,1564557
galEp3,2.642857142857143,49,13,GGGAAAAGTGACAGTGAGCC,36,1572556
galEp3,6.428571428571429,102,13,GGCGGGTTGAGTCAAGCAGG,89,1582449
galEp3,0.14285714285714285,14,13,GCTGTGCCTCTTGTGTCTTC,1,1563986
galEp3,5.714285714285714,92,13,GCGGGTCCGCTTAGCGGCCT,79,1548426
galEp3,0.14285714285714285,14,13,GCCTAATGGACTAACAGAGT,1,1563481
galEp3,0.7142857142857143,22,13,GCCGGGAATGGCTTTCTGCG,9,1557131
galEp3,0.14285714285714285,14,13,GCCCCGTTGTCCCTCAAGTC,1,1591529
galEp3,4.142857142857143,70,13,GATTGGTCTCCCTTGTTTTA,57,1582092
galEp3,5.5,89,13,GATCGAGGTAGGCCGAAGAA,76,1566847
galEp3,5.714285714285714,92,13,GAGCAAATTCAACTGATGTC,79,1551272
galEp3,0.14285714285714285,14,13,GAAAAGAATCGCCTTGTCGG,1,1564243
galEp3,6.714285714285714,106,13,CTGGCGCTATATCTTCTGGG,93,1565201
galEp3,6.571428571428571,104,13,CTGAGCGGAGCCATACGTGT,91,1554402
galEp3,3.5714285714285716,62,13,CTCCTGATCCTAGCGGACTT,49,1588086
galEp3,5.928571428571429,95,13,CGTTGGTATGGGCTATGGCA,82,1562514
galEp3,4.357142857142857,73,13,CGGTATTAGACTTCTGCCGG,60,1560076
galEp3,0.2857142857142857,16,13,CGGCCAATAATCGGGCTTGT,3,1552836
galEp3,1.4285714285714286,32,13,CGCGTCATTAGCTCTTAGAT,19,1565837
galEp3,0.14285714285714285,14,13,CGAGCTTCTCCAGTCTATAA,1,1556387
galEp3,2.5714285714285716,48,13,CCTGGTGCCCGACCTAACCC,35,1588464
galEp3,2.357142857142857,45,13,CCTCTATACGGTCATAGCCA,32,1589504
galEp3,0.14285714285714285,14,13,CCTCAGGCAAACTAATTGTG,1,1576358
galEp3,12.0,180,13,CCCGTACCTCAACATTTGCG,167,1588692
galEp3,7.285714285714286,114,13,CCCCATTAGCAACATACGCA,101,1594947
galEp3,5.285714285714286,86,13,CATACCGGCGCCTCATATGT,73,1564861
galEp3,4.571428571428571,76,13,CAGAAGCGCTGCTAGGGTGG,63,1563321
galEp3,7.571428571428571,118,13,CACGTCCCTTCCCGTCGGAT,105,1551806
galEp3,6.214285714285714,99,13,CAATGCCGCAGATCCGGTCA,86,1558195
galEp3,0.21428571428571427,15,13,CAATCGTGTCTGCGCAACAA,2,1563923
galEp3,6.0,96,13,CAAGTACTCCGTTAAACCGG,83,1591476
galEp3,3.0714285714285716,55,13,CAAACCGGCTCCAATCGACT,42,1579130
galEp3,0.14285714285714285,14,13,ATTGTGTATTCATAAAGGAG,1,1568777
galEp3,1.4285714285714286,32,13,ATGTTAAGTGATGGTCAGGA,19,1584117
galEp3,4.642857142857143,77,13,ATGGTCAACGTCTCACCATA,64,1568563
galEp3,3.5,61,13,ATGCCTATTCTAATATTCCT,48,1579025
galEp3,11.0,166,13,ATGCCGCGATTCAGATTGTT,153,1560352
galEp3,1.5,33,13,ATGAAGTGGGCACTAACGCA,20,1574375
galEp3,10.5,159,13,ATCTGCACTATCTCAGAAAG,146,1568848
galEp3,0.14285714285714285,14,13,ATCTGAGATGGCGCTATCTC,1,1574160
galEp3,1.9285714285714286,39,13,ATATTGACCGGTGAGGGGAC,26,1548903
galEp3,4.285714285714286,72,13,AGTCAGTTGGTCCATACATA,59,1583609
galEp3,2.2857142857142856,44,13,AGGTTTGTTGCGTAAGTTAG,31,1579321
galEp3,1.2857142857142858,30,13,AGGCCGTCGAGCCACATAAG,17,1553812
galEp3,0.14285714285714285,14,13,AGACCCAGTAAGGTGTACAC,1,1574332
galEp3,5.928571428571429,95,13,AGACCAGACCATGCCGCAAC,82,1559401
galEp3,0.35714285714285715,17,13,ACGTTGAATTGGCAAGGTCT,4,1575934
galEp3,0.42857142857142855,18,13,ACCTCCAGGATCCGGCGATA,5,1566811
galEp3,11.642857142857142,175,13,ACCGATGTGAGACAAACGCA,162,1585966
galEp3,3.0714285714285716,55,13,ACCGAAGTTAAGACCCAAAT,42,1546943
galEp3,3.0,54,13,ACCCCTTATATATCCCCATC,41,1564617
galEp3,4.785714285714286,79,13,AATCTACTATTGAACAAATG,66,1570892
galEp3,0.14285714285714285,14,13,AAGATATGTGTCGTTAGTGA,1,1553605
galEp3,0.14285714285714285,14,13,AAGACCACAGCGCACTGCTT,1,1565283
galEp3,1.5,33,13,AAAAGTTTACCCTCGACTGG,20,1549356
galEp3,0.23076923076923078,14,12,TTTGATAATGACGACCGAAT,2,1559861
galEp3,0.15384615384615385,13,12,TTCCGGCGCAACCACAGTCT,1,1557646
galEp3,0.15384615384615385,13,12,TGCCCTATCGTAGGCGGTGT,1,1547125
galEp3,1.6153846153846154,32,12,TGCATACAAAGATTATCGAC,20,1590833
galEp3,4.846153846153846,74,12,TGAGGGAGATGTACTTGACC,62,1561473
galEp3,2.4615384615384617,43,12,TCTGGGGAAGAGTATATGTA,31,1576868
galEp3,0.15384615384615385,13,12,TCGCATTGGTAAGCTGTGGA,1,1571184
galEp3,0.15384615384615385,13,12,TAGGGAAGCATACGCAGCGT,1,1590354
galEp3,1.8461538461538463,35,12,TAGCGGATGCCGCCGCGTGG,23,1587692
galEp3,1.6923076923076923,33,12,TACGGGCACAACCTTATGAT,21,1587306
galEp3,0.15384615384615385,13,12,TACACAATGGCGCCCGCGAT,1,1551702
galEp3,0.23076923076923078,14,12,GTTAGATGAACTCATAGTGA,2,1575800
galEp3,14.307692307692308,197,12,GTATGAGCACGTGTCAATGT,185,1555057
galEp3,3.769230769230769,60,12,GTAGCAACCGGAGTCGCCCC,48,1593281
galEp3,6.384615384615385,94,12,GTAAGTTCTGAACATCTCAC,82,1559598
galEp3,0.15384615384615385,13,12,GGCTTCTAATGCGTATCCAG,1,1581335
galEp3,4.384615384615385,68,12,GGCCGATGGGGATCAAGTAT,56,1590617
galEp3,0.15384615384615385,13,12,GCGGCAACCAGCTTTCACAA,1,1567619
galEp3,0.15384615384615385,13,12,GCGCCCGCCTCTAGTTTCTG,1,1552004
galEp3,8.307692307692308,119,12,GCATCCTCCTGATGAATTGG,107,1566988
galEp3,16.846153846153847,230,12,GACGGCATGGCGTCTCTGAC,218,1549697
galEp3,0.15384615384615385,13,12,GACGATATGGTTTCAGGATA,1,1570395
galEp3,6.461538461538462,95,12,GAAAAGATGATCCGTCGAAG,83,1557106
galEp3,3.6923076923076925,59,12,CTTTTACGGTCTATCATCGT,47,1579182
galEp3,8.384615384615385,120,12,CTTTCGGCTGCGACGTACGA,108,1585772
galEp3,0.15384615384615385,13,12,CTTTAGCGGTGGTATGTGAA,1,1555379
galEp3,0.15384615384615385,13,12,CTCTTTGCTATGAGCTCACC,1,1576658
galEp3,0.15384615384615385,13,12,CTCTCCAGATCCCTGTTAAA,1,1560707
galEp3,6.615384615384615,97,12,CGGTCGTGTTCACATTGTGC,85,1556839
galEp3,0.15384615384615385,13,12,CGGTACCCTGGCTCCGGGCA,1,1563410
galEp3,4.846153846153846,74,12,CGGGTAGTAACCGGAGTGGT,62,1562007
galEp3,2.4615384615384617,43,12,CGCCTCAGAGGATGTTAGCA,31,1555776
galEp3,2.3846153846153846,42,12,CGAAGAGCACTGATCACGGT,30,1549758
galEp3,2.3846153846153846,42,12,CCTCGGCCCTTGGTGGCCGT,30,1589555
galEp3,0.15384615384615385,13,12,CCTCATGCTCCTCATCTAAG,1,1589381
galEp3,4.615384615384615,71,12,CCGTTTTACTGACCCTTTGA,59,1567351
galEp3,0.15384615384615385,13,12,CCCGAGTACTGCGAATTTGC,1,1589399
galEp3,1.3846153846153846,29,12,CCCCCGGTGTTATTAATCTC,17,1576500
galEp3,5.384615384615385,81,12,CATGTTTAGGTTTTGTGACG,69,1554501
galEp3,5.538461538461538,83,12,CATGCGATCATCCCAGTGGC,71,1570183
galEp3,0.15384615384615385,13,12,CATCCATGGGATGGGGTTAT,1,1575135
galEp3,0.15384615384615385,13,12,CACGGGCGCCTAGACGCGCA,1,1563119
galEp3,0.23076923076923078,14,12,CAAGTCGATTCTCCTCGTTT,2,1559170
galEp3,0.23076923076923078,14,12,CAAGTAATAGTTCCGGTGGC,2,1564420
galEp3,0.15384615384615385,13,12,ATTTGGGGGATGCTGGTCTT,1,1587808
galEp3,6.6923076923076925,98,12,ATTCCGGAGTCGCTAAATCG,86,1548527
galEp3,4.153846153846154,65,12,ATCGTTTCCACGGCTTCCAT,53,1563487
galEp3,6.384615384615385,94,12,ATATACACCGCCCAAGTTTA,82,1559918
galEp3,0.15384615384615385,13,12,ATAGCTAGTTATCGTTCCGA,1,1578047
galEp3,1.0769230769230769,25,12,AGTATGTTTACCTTTTGCTA,13,1577566
galEp3,8.23076923076923,118,12,AGGGAGTAATCGAATTTCGA,106,1564160
galEp3,6.076923076923077,90,12,AGGCATGGTGTTCAGGGATA,78,1577959
galEp3,8.76923076923077,125,12,AGCTCTGGTTGTCTTTGCTG,113,1589137
galEp3,2.0,37,12,AGAGGAATTCTTTCGGCCGG,25,1564544
galEp3,0.15384615384615385,13,12,AGACACTTAAGGCAGACGCT,1,1546793
galEp3,0.3076923076923077,15,12,ACGCGAGAGGATGGGTGCAA,3,1575331
galEp3,0.15384615384615385,13,12,ACGAAATGGATCAGGGATGT,1,1550769
galEp3,7.3076923076923075,106,12,ACCTGGAAGGGCGGTACTAG,94,1552523
galEp3,0.15384615384615385,13,12,ACATTCGGCAATAACAGACT,1,1568695
galEp3,4.769230769230769,73,12,ACAGATACCGGAGTTTAATA,61,1583389
galEp3,4.384615384615385,68,12,ACACATGCAACCGAAAGAAA,56,1553212
galEp3,1.8461538461538463,35,12,AATGGTTTTTACTCATTCCC,23,1574642
galEp3,0.15384615384615385,13,12,AAGTCATCCTGTCAAAAGGT,1,1567347
galEp3,4.615384615384615,71,12,AAGGTGTTTTGCCTCACATT,59,1584824
galEp3,0.15384615384615385,13,12,AACGGGGCCTATTGATCTAT,1,1573377
galEp3,0.15384615384615385,13,12,AAAGGTGTCAGTGGCGCCGT,1,1548378
galEp3,0.16666666666666666,12,11,TTTGTAAATAATGAGATGAA,1,1548895
galEp3,5.583333333333333,77,11,TTCACGAGAGAAGATGAGTA,66,1590761
galEp3,9.333333333333334,122,11,TTATGGTTTACTAGATCTCT,111,1577039
galEp3,18.25,229,11,TTATCTCTAAATATCTTCAT,218,1589560
galEp3,0.16666666666666666,12,11,TTAAGAGTACGCTTCATAGA,1,1583274
galEp3,5.416666666666667,75,11,TGTTATGCTCGGTACGTGCA,64,1559643
galEp3,0.16666666666666666,12,11,TGTGTTGCTAAAGCTTAAAT,1,1554672
galEp3,6.916666666666667,93,11,TGTGTGGGTAAGACCTAGGG,82,1585503
galEp3,7.166666666666667,96,11,TGGGAGTCGTGGTTCAACTC,85,1567344
galEp3,0.75,19,11,TGGCGTGTTGGTGAGATCAT,8,1556996
galEp3,9.25,121,11,TCTAATCAAGGATGAGCATG,110,1584520
galEp3,0.9166666666666666,21,11,TCCGTCCCGTGCCTGGCAAT,10,1592061
galEp3,7.833333333333333,104,11,TCATAGACTAAGTCTACGTG,93,1582874
galEp3,7.0,94,11,TCACACATAGTTGTAGGTAG,83,1580735
galEp3,0.25,13,11,TATATTCGTTAGGATAGTTC,2,1562438
galEp3,4.75,67,11,TAGCCGCGATATTGGTCAGC,56,1592058
galEp3,5.583333333333333,77,11,TAGACCAGGAGTACTCGTGA,66,1567488
galEp3,7.916666666666667,105,11,TACCACCACCCAGCGTGCCC,94,1570689
galEp3,8.166666666666666,108,11,TAAGATGCAAAAAACCTGAC,97,1572921
galEp3,4.166666666666667,60,11,TAACATGATTCCTCGTGCAA,49,1574202
galEp3,2.25,37,11,GTGTGTGACGCGATTGCTCG,26,1550619
galEp3,0.16666666666666666,12,11,GTGTGGGGCTATATCAGATT,1,1552732
galEp3,9.583333333333334,125,11,GTGCAGGCATCCCGCTGTAG,114,1577333
galEp3,3.5833333333333335,53,11,GTCAACCCGCTCTTTACGTC,42,1586863
galEp3,2.75,43,11,GGTGCCGACTCGTCTTGGAT,32,1571166
galEp3,1.0,22,11,GGGCTGGCCCTTGCAGAGCC,11,1562015
galEp3,2.0833333333333335,35,11,GGGCCGGGTGTGCCGTGTAA,24,1559712
galEp3,0.4166666666666667,15,11,GGCGTCGATTGAGGTCGGAG,4,1572388
galEp3,4.166666666666667,60,11,GCTGCTCAGCTATAGAAACC,49,1585409
galEp3,0.16666666666666666,12,11,GCTAGCTCTAGTGAGTGAGA,1,1588084
galEp3,1.4166666666666667,27,11,GCGGATTACAAGCACAGGAG,16,1591433
galEp3,2.5833333333333335,41,11,GCGCTATAACAGCTGGTCTC,30,1566775
galEp3,8.083333333333334,107,11,GCGCGATGCATGTGATGTAG,96,1567195
galEp3,0.4166666666666667,15,11,GCCCATGGAGTAATGCGGAC,4,1563776
galEp3,8.25,109,11,GACGGGGTGTCATGCCGGCC,98,1587450
galEp3,10.25,133,11,GACATAATCGGTCTGGCAGT,122,1574235
galEp3,0.16666666666666666,12,11,CTTTCCCGAATTAGATTGCA,1,1562909
galEp3,0.16666666666666666,12,11,CTGTTTTGACGGTCGTGTTA,1,1568822
galEp3,0.16666666666666666,12,11,CTCTGAAACGCCAGCCTTGT,1,1583716
galEp3,6.166666666666667,84,11,CTCCACCTATGATATTCGCT,73,1548359
galEp3,5.25,73,11,CTCATCTCAACCTGTCTGAG,62,1573652
galEp3,9.916666666666666,129,11,CTAGTGAGACCGACTCCTCG,118,1590794
galEp3,5.916666666666667,81,11,CGGGCACGTGTAGTATCCCT,70,1557005
galEp3,7.416666666666667,99,11,CGCGCCGCTTAGGCAAAGAA,88,1550724
galEp3,10.083333333333334,131,11,CGCCTTCGAGACTTGCTGAA,120,1556174
galEp3,8.666666666666666,114,11,CCGGGGGACAGATAGCGGTG,103,1549054
galEp3,18.416666666666668,231,11,CCCGCATCTGCGGTTCTATG,220,1556510
galEp3,3.0833333333333335,47,11,CCCACACTAGGTGCTAGTTG,36,1563521
galEp3,10.083333333333334,131,11,CCCACAAAACTAGGCCTCTC,120,1558879
galEp3,0.9166666666666666,21,11,CCATGTGCACAGAGGACGTG,10,1554883
galEp3,0.16666666666666666,12,11,CCACGCTGTTGAGCAGATTA,1,1587244
galEp3,6.75,91,11,CCAAAGGATCTTTACCAGTC,80,1581083
galEp3,6.916666666666667,93,11,CACTCTTGGAGGAGCTCCGG,82,1579772
galEp3,1.75,31,11,CACGGTTCTCGGTTGACGTA,20,1576075
galEp3,5.583333333333333,77,11,CACATTTCCAGTCAGTAGCA,66,1575132
galEp3,4.416666666666667,63,11,ATTTTTGATAGGATCGGGGG,52,1590587
galEp3,5.25,73,11,ATTCTGGTTTGATTAGGATA,62,1554225
galEp3,0.16666666666666666,12,11,ATTCGACACTGGGAGTGAAG,1,1555835
galEp3,0.25,13,11,ATTATGACGTTTTATTAATA,2,1559837
galEp3,0.16666666666666666,12,11,ATGTTGTAGTTTCTGCCGTT,1,1592411
galEp3,3.4166666666666665,51,11,ATGTTAAAGAAGCCATCAGG,40,1565864
galEp3,7.833333333333333,104,11,ATGCAGGTCTAGTCGCATAA,93,1588349
galEp3,7.5,100,11,ATCTGCCGCTTTTCCGACGA,89,1583800
galEp3,3.0833333333333335,47,11,ATATTGCAAAAATGCCGGGT,36,1574443
galEp3,18.416666666666668,231,11,AGGCCGACGCCATATAAAGT,220,1561477
galEp3,0.16666666666666666,12,11,AGAGGGGCAACATTAACTGA,1,1567345
galEp3,4.75,67,11,ACGCGACCGTCAAGTTGATA,56,1561953
galEp3,0.16666666666666666,12,11,ACGATACTGTAGCTGCTTCG,1,1554241
galEp3,0.16666666666666666,12,11,ACCGTTATCTAAAGGCACAT,1,1549056
galEp3,3.8333333333333335,56,11,AACGAAACGAACTGTTTCAA,45,1573797
galEp3,20.75,259,11,AACCGGGCGTACACTTTGCG,248,1568911
galEp3,1.6666666666666667,30,11,AAATCATACAACTCCGAAAT,19,1560766
galEp3,0.16666666666666666,12,11,AAACCAGCTTACGGTGCGTA,1,1590091
galEp3,2.0,34,11,AAAATGCGTGTTCGCGTACG,23,1589161
galEp3,0.18181818181818182,11,10,TTGTATCTGCGCGACCCCCC,1,1559358
galEp3,0.18181818181818182,11,10,TTGGTGTTTAAGTGGACTGA,1,1579269
galEp3,4.7272727272727275,61,10,TTGGTGTAATCCACGAGCTT,51,1556722
galEp3,3.090909090909091,43,10,TTGGGGGTTATAACATCACT,33,1555176
galEp3,6.545454545454546,81,10,TTGATTGACTTGCCTCTACT,71,1569663
galEp3,2.909090909090909,41,10,TTCGCTGGCTGGTCTAGAGC,31,1563642
galEp3,6.090909090909091,76,10,TTCCCAGGAACCGAATTTGC,66,1562561
galEp3,6.909090909090909,85,10,TTCCAGTTAAGTACTCTGAA,75,1593619
galEp3,0.18181818181818182,11,10,TGTGTGGCTAGGGGCAACGC,1,1551522
galEp3,0.9090909090909091,19,10,TGCCTGCCGTGGCTATACCT,9,1569123
galEp3,7.454545454545454,91,10,TGATGGGAGCTGGCTAAGGT,81,1550492
galEp3,3.8181818181818183,51,10,TGATGACAGCAATCTTGTGA,41,1593436
galEp3,3.3636363636363638,46,10,TGATAATGTCACTCGCGAGC,36,1579325
galEp3,11.272727272727273,133,10,TCTCTTCCCTTGGGGATAAG,123,1585673
galEp3,1.9090909090909092,30,10,TCCAATACTCAGAATAATCT,20,1590154
galEp3,8.909090909090908,107,10,TCATTACGAGACTCACCAAC,97,1589611
galEp3,0.18181818181818182,11,10,TATTTGGTAAACCAAGGTGA,1,1594693
galEp3,0.18181818181818182,11,10,TAGCGATTAGGTACATTCCA,1,1552064
galEp3,0.36363636363636365,13,10,TACCTACAAGATTTTTCCCC,3,1553673
galEp3,4.363636363636363,57,10,TACAGTGTTTTCCCGCCGAA,47,1555901
galEp3,0.6363636363636364,16,10,TAACGGCTGATATCAACTGG,6,1588037
galEp3,0.18181818181818182,11,10,TAAATCAATCAGAACTTAAC,1,1579227
galEp3,0.18181818181818182,11,10,GTTCCATACCTATTCTGACT,1,1590259
galEp3,8.272727272727273,100,10,GTGTACAGTCTGTGCATGCA,90,1560244
galEp3,0.2727272727272727,12,10,GTGAGGCAAGATAGCCTATG,2,1551348
galEp3,0.18181818181818182,11,10,GTGAAATCATCGCAATTGGG,1,1593678
galEp3,9.909090909090908,118,10,GTCTGTACATAGCGGCTCGT,108,1577589
galEp3,3.6363636363636362,49,10,GGTGTAGAATGATAGTGTAA,39,1578459
galEp3,6.818181818181818,84,10,GGTATACTGCTATCGGTCCG,74,1563801
galEp3,3.5454545454545454,48,10,GGTAGCTCGTTTCTCGTTAG,38,1548695
galEp3,0.18181818181818182,11,10,GGCTACACCCATCAGTGTGG,1,1586797
galEp3,7.090909090909091,87,10,GGCCGCACACTTGAAGGTTG,77,1583638
galEp3,0.18181818181818182,11,10,GGACCTTGTATTTTAAGTAC,1,1577121
galEp3,3.5454545454545454,48,10,GCTGATTACCGATTCCCTCT,38,1556204
galEp3,7.454545454545454,91,10,GCGAATCAAGCTTATACGAA,81,1547599
galEp3,6.909090909090909,85,10,GCAGAGGCCAATCGGGTCGC,75,1553498
galEp3,2.090909090909091,32,10,GATTAATTTGGAGTGCCCCT,22,1547793
galEp3,1.7272727272727273,28,10,GATAACATTTACATCCCCGC,18,1551316
galEp3,8.818181818181818,106,10,GAGTTTTATTGTAATTGGAA,96,1570291
galEp3,0.5454545454545454,15,10,GAGGATTACGCTCCAGAAAT,5,1560522
galEp3,0.18181818181818182,11,10,GAGCTGGATAGGACCAACGA,1,1581929
galEp3,6.7272727272727275,83,10,GACTGTCTAGAGGTTCTGAC,73,1558561
galEp3,4.7272727272727275,61,10,GACCGTTTACGCAACAGGCA,51,1566021
galEp3,10.727272727272727,127,10,CTTTCTAAAATAAGCAGTAG,117,1585982
galEp3,31.0,350,10,CTTTATCAGGTCTCCGTTCG,340,1553864
galEp3,0.18181818181818182,11,10,CTTGGGAATCATCGCAACGG,1,1549312
galEp3,4.090909090909091,54,10,CTTCGGTTACGATAGGGATC,44,1580938
galEp3,7.7272727272727275,94,10,CTTATCGCTGTACGAAAGAA,84,1590874
galEp3,0.18181818181818182,11,10,CTCTACAACGGCGAAGGCTT,1,1550623
galEp3,0.2727272727272727,12,10,CTAACATAATGTAACGAGCC,2,1573865
galEp3,8.272727272727273,100,10,CGTCGGGTATGGCGAACGTG,90,1578664
galEp3,12.727272727272727,149,10,CGGTTATAGAGAATTTGGGA,139,1554876
galEp3,1.3636363636363635,24,10,CGGATTACCTTTGTGAAGGA,14,1556081
galEp3,0.18181818181818182,11,10,CGCGTAGGCCGGTATTTCTC,1,1547718
galEp3,2.090909090909091,32,10,CGCCGATCAGCGTTGGCCCT,22,1567816
galEp3,7.454545454545454,91,10,CGAAAAACCCGGAAACGCAA,81,1579278
galEp3,0.6363636363636364,16,10,CCTAACGGTGTAGTCATAAT,6,1590304
galEp3,0.18181818181818182,11,10,CCGGCGACTATCCTTCAAAA,1,1552383
galEp3,0.18181818181818182,11,10,CCGGCCGGTTAACCACACGA,1,1553669
galEp3,0.18181818181818182,11,10,CCGATACGACCGCATGCGTT,1,1574196
galEp3,4.454545454545454,58,10,CCCACAATTGGTCGAAAGAA,48,1552377
galEp3,10.545454545454545,125,10,CCAGTGGATCCCTTTTTTAT,115,1569518
galEp3,9.181818181818182,110,10,CCAGAAATTGATGCCCTAAT,100,1546837
galEp3,4.090909090909091,54,10,CATGCAAGGTTAGTCGCTAC,44,1569840
galEp3,5.909090909090909,74,10,CATCCATTATTCTGGGGAGG,64,1578559
galEp3,1.2727272727272727,23,10,CAGCCGTACGCCTCTTCATG,13,1587352
galEp3,5.090909090909091,65,10,CACTAAAGGCCTCGCTTTCG,55,1563324
galEp3,19.90909090909091,228,10,CAAGGCAGGCTTAGCTGCCT,218,1565596
galEp3,0.18181818181818182,11,10,ATTTTGCGTCAATAAGAGGA,1,1555400
galEp3,9.545454545454545,114,10,ATTCTTACGCAGCAACTCCT,104,1566291
galEp3,5.909090909090909,74,10,ATGTTTGCAGGGCACGGATA,64,1555380
galEp3,0.18181818181818182,11,10,ATGGGGGTGCCGCATACAAA,1,1567902
galEp3,9.272727272727273,111,10,ATCTTCTAGCGTTTGCATGT,101,1570819
galEp3,9.727272727272727,116,10,ATCGCTTGGGCGTCGGGCCC,106,1555045
galEp3,0.18181818181818182,11,10,AGGCTGCCACCACTGCCAGG,1,1592208
galEp3,7.909090909090909,96,10,AGCGAAAGAGCGACGTCACT,86,1569053
galEp3,9.818181818181818,117,10,AGCAGGCTGTGTTAGCTTTG,107,1573351
galEp3,9.727272727272727,116,10,AGAGTCCAAGTATTCCCAAA,106,1556601
galEp3,1.6363636363636365,27,10,AGACGAGCGTGCGCGAATAT,17,1588116
galEp3,9.363636363636363,112,10,ACTTGGCAAATACGTAGTGT,102,1570150
galEp3,17.363636363636363,200,10,ACTCACGCTATAAGAGACCA,190,1551632
galEp3,0.18181818181818182,11,10,ACTATTAGCGCCTGTCCGCG,1,1591342
galEp3,7.7272727272727275,94,10,ACGCTATGTCCAGCACTGGA,84,1583112
galEp3,0.2727272727272727,12,10,ACGCGTTCCTGGGACCCTAT,2,1574976
galEp3,0.18181818181818182,11,10,ACGCCACTGACATTTCAGGA,1,1569867
galEp3,9.727272727272727,116,10,ACCAGTTTGACATTTCATTT,106,1553733
galEp3,6.2727272727272725,78,10,AAGACACTCAATGAGGATTT,68,1569507
galEp3,7.909090909090909,96,10,AACGTCTAAAGATCACGCCG,86,1574364
galEp3,0.2,10,9,TTTCGTGTGTAATGGGATCA,1,1582702
galEp3,5.3,61,9,TTGGAGTTTAGAGAAACCGT,52,1568093
galEp3,0.3,11,9,TTCCACGATACGACGCTCGG,2,1563900
galEp3,9.3,101,9,TGTGCCTATGCGTGGACTTC,92,1593536
galEp3,6.8,76,9,TGTAATTCTAACAACCATGT,67,1560640
galEp3,0.2,10,9,TGGCCGTCTGGATGTCATAC,1,1563417
galEp3,0.2,10,9,TGGATTCCTCGGGTCGGTAC,1,1566045
galEp3,7.6,84,9,TGCGCCTAGGTACCCACCGC,75,1554916
galEp3,6.5,73,9,TCTGAACTATGCAATGAAGC,64,1555150
galEp3,0.2,10,9,TCGCTCCAGATGGGTGAGGG,1,1573196
galEp3,10.6,114,9,TCGCTACACGGGAATCTATA,105,1587750
galEp3,0.2,10,9,TCCTGGTCTCTCAAGGAAAA,1,1555650
galEp3,10.6,114,9,TCCGACCCGTTTTACTGAAT,105,1563713
galEp3,0.2,10,9,TCATTGTAATGGGGCGCTTC,1,1594039
galEp3,0.2,10,9,TCAAGCTAGGGATAGGTAGC,1,1549756
galEp3,0.2,10,9,TATACGTCGCTTCCTGCAAC,1,1570642
galEp3,8.7,95,9,TAGCGGCGTATTTCTCGCAT,86,1578468
galEp3,4.2,50,9,TACACGTTTACGGCGACCCA,41,1564659
galEp3,0.2,10,9,TAATACGGCCGTTTTGTGAT,1,1575091
galEp3,0.2,10,9,TAACTTCGTAGCAAGGAGCT,1,1557833
galEp3,4.8,56,9,GTTTGTGCTTAAAAGGGTTA,47,1570417
galEp3,8.8,96,9,GTGACTGCATCTCCTAACCA,87,1573495
galEp3,0.2,10,9,GTCTTGTTGAATAAACCCGG,1,1559224
galEp3,8.5,93,9,GTCCGATGACGGTGATACAT,84,1591371
galEp3,0.2,10,9,GTACTCTTCCCCGGGTACCT,1,1564370
galEp3,0.2,10,9,GGTTTCCGGACCACACCATT,1,1570123
galEp3,9.3,101,9,GGTTTCCCTGCGTCCTATGA,92,1564680
galEp3,4.5,53,9,GGTTCGCGCCATCCAACTAC,44,1564433
galEp3,1.2,20,9,GGTGTCTCACCTATGGGAAG,11,1556966
galEp3,0.4,12,9,GGGTTTAAGCACCTCACATC,3,1592663
galEp3,3.0,38,9,GGCTCGTCCGATTACCCCAC,29,1594787
galEp3,7.4,82,9,GGACTATCTACCGGGGGCAA,73,1561663
galEp3,0.2,10,9,GCTTCCCTCCACAGTATATA,1,1574380
galEp3,6.1,69,9,GCTTCAACTGGGCCACCTGT,60,1556832
galEp3,6.4,72,9,GCTATTTTGAGCTGCTCAGG,63,1551452
galEp3,6.5,73,9,GCCATCGGAGAGCTAAAGAT,64,1594973
galEp3,0.2,10,9,GATTTACCAGCCGAGCTCTT,1,1577322
galEp3,0.2,10,9,GATGCTTGCGGGCGCTTTAA,1,1558409
galEp3,0.2,10,9,GATCCGTGATTCCGGCACTT,1,1589343
galEp3,4.5,53,9,GACTGAGGGCAATAAGAAAG,44,1592818
galEp3,11.2,120,9,GACTAGGCGATTAAGGACTA,111,1571721
galEp3,8.0,88,9,GACAGCCGTTCCGTGCGATT,79,1547102
galEp3,8.6,94,9,GACACTCCCTAGGGGGCGAA,85,1594515
galEp3,0.2,10,9,GAATCATTACCGGAACCGCA,1,1560768
galEp3,0.2,10,9,CTTGTAGCAGACCTTTCGAA,1,1561235
galEp3,0.2,10,9,CTTACCATATTTTACAAGAT,1,1576209
galEp3,0.2,10,9,CTATTGCGTTCCCGATAGCA,1,1551321
galEp3,1.1,19,9,CTAAGTATGAACATTACCTA,10,1571118
galEp3,0.2,10,9,CTAAGCACTGGGATAGGGTG,1,1549352
galEp3,9.1,99,9,CGGTAACGTCATGATGCTAA,90,1558612
galEp3,3.3,41,9,CGGGCATAATCCTTCAGAGA,32,1583332
galEp3,0.2,10,9,CGGGATGGTGTCACATGAGA,1,1560364
galEp3,9.3,101,9,CCTGTGGACCAGTTTAACTT,92,1546956
galEp3,0.2,10,9,CCTGCCCTCGGAATCAATAA,1,1547452
galEp3,10.8,116,9,CCGTGGCGGAAAGCCATCCA,107,1574646
galEp3,2.4,32,9,CCGAAGAGAACGAAATCGAG,23,1563867
galEp3,4.4,52,9,CCAGGTTATTTCGTCTCTAA,43,1567192
galEp3,0.2,10,9,CCACACTGCCCTTTCTCTGC,1,1556867
galEp3,0.2,10,9,CATGCACAAGGCCTCGGGCG,1,1558957
galEp3,7.6,84,9,CAGGCCTGCCGCACGGGGTG,75,1556118
galEp3,1.4,22,9,CACCTTAGATGATTTGGCTG,13,1560526
galEp3,10.8,116,9,CAAGACATGGTCGAGGCCGT,107,1560703
galEp3,0.2,10,9,CAACTGTGTTTAGACCGGGT,1,1558857
galEp3,2.5,33,9,CAAAACCACTATCAGAGACC,24,1547615
galEp3,0.2,10,9,ATTATAAGGATAAAAACTCA,1,1548705
galEp3,1.3,21,9,ATGTAAACGTTCGAGTAATG,12,1572460
galEp3,0.2,10,9,ATGGGGTAATGGGCGCTGTA,1,1579923
galEp3,2.6,34,9,ATATCTAGTAGTAGTCTAAT,25,1587377
galEp3,1.4,22,9,ATAGCTTTGGAAACTTTAAA,13,1580383
galEp3,10.2,110,9,ATAACATTCTTGTCGGCTGG,101,1593492
galEp3,0.2,10,9,AGTGCCCGCTCGCGTAACAG,1,1568499
galEp3,0.2,10,9,AGGTCCCGCTTGTTCGGGTT,1,1568337
galEp3,13.7,145,9,AGGCAGTGTGTGTGCACGCT,136,1548050
galEp3,0.2,10,9,AGCGTTGCGAGGCGCGACAG,1,1573045
galEp3,4.0,48,9,ACTGAAGACCTCGCTATGTT,39,1574977
galEp3,9.6,104,9,ACGTGAATCATCTGTTGTTT,95,1559574
galEp3,9.4,102,9,ACGGAGGCACCACCCTAAAG,93,1581931
galEp3,0.8,16,9,ACCTAGCAAACGATGGGTCT,7,1581011
galEp3,9.7,105,9,ACCGGGGCATCGGTTAGCTA,96,1577583
galEp3,9.4,102,9,ACATGTGCTTGAGCACAGTC,93,1590663
galEp3,0.2,10,9,AATCCAGCTTAAGACCGTGC,1,1571265
galEp3,9.8,106,9,AAGTGCCAGTATCTCGCGTT,97,1555382
galEp3,6.1,69,9,AAGGTCTCTGTCTTTGGAAT,60,1574046
galEp3,0.2,10,9,AAGCTTTGCTAAGGGAATCT,1,1562568
galEp3,0.2,10,9,AAGCTAGCGCAACTCGTTGT,1,1582462
galEp3,5.4,62,9,AAGCACTGCGTACGCTGGAG,53,1573024
galEp3,0.2,10,9,AACCAGGTAATGAGCTTGCA,1,1593397
galEp3,2.9,37,9,AAATGGCCTCTTTCTTCATG,28,1583607
galEp3,10.88888888888889,105,8,TTTTGGCTTGCTGATGCATA,97,1559670
galEp3,6.333333333333333,64,8,TTTTGGACCCTTAATACCCT,56,1580556
galEp3,8.333333333333334,82,8,TTGTTGACTCAATCGGGTTC,74,1556394
galEp3,9.666666666666666,94,8,TTCTAGTAGATGTAAGTCTA,86,1553318
galEp3,0.2222222222222222,9,8,TTAATCTTAGCGGGGCACGT,1,1578974
galEp3,0.2222222222222222,9,8,TGTTGGCATTCTCGGGGCTT,1,1590155
galEp3,0.2222222222222222,9,8,TGGTAAGAGTGAATATGCCT,1,1551838
galEp3,0.2222222222222222,9,8,TGCTTTCACGATAGGAATAG,1,1572896
galEp3,0.2222222222222222,9,8,TGCATCCCATCAGTATCAGA,1,1560740
galEp3,0.2222222222222222,9,8,TGAGCTGGACACCTGGTGAT,1,1580947
galEp3,3.7777777777777777,41,8,TGAGCACGTTTTACAGGGAG,33,1570211
galEp3,2.2222222222222223,27,8,TCCTGACTTCTGGACGTCAC,19,1591605
galEp3,5.555555555555555,57,8,TCCTACATCCGATGGAACCC,49,1583484
galEp3,3.7777777777777777,41,8,TCCATAGGGGTGTTTATATG,33,1592034
galEp3,15.88888888888889,150,8,TCAACACATCGTCAGGTCCT,142,1563396
galEp3,0.2222222222222222,9,8,TACGGCATTCTAGGGACCTA,1,1569874
galEp3,3.111111111111111,35,8,GTTCTGTTTCTGATAGAGGT,27,1568220
galEp3,3.2222222222222223,36,8,GTCTCCGGCTTGACGACTCG,28,1587696
galEp3,17.666666666666668,166,8,GTCCGCCTAAGAGATTGTTA,158,1574115
galEp3,0.2222222222222222,9,8,GTAACTCTAGCATAACGTCA,1,1588455
galEp3,0.2222222222222222,9,8,GGTTTATCAAGCGAGTTTTA,1,1569152
galEp3,0.2222222222222222,9,8,GGTACTGGAGAGCTGTCCAA,1,1560595
galEp3,9.0,88,8,GGGGCTAGGACGTACAGCAT,80,1562500
galEp3,8.11111111111111,80,8,GGAGCGAGTACCGTCATACG,72,1563501
galEp3,12.333333333333334,118,8,GCTCGCCCGGTACATATAAG,110,1563648
galEp3,6.333333333333333,64,8,GCTCATAATCGGGTAAACAA,56,1592530
galEp3,0.2222222222222222,9,8,GCTCACCCGTCAAAGAGGAG,1,1580730
galEp3,5.444444444444445,56,8,GCGGGGGGTCTCATAATGCT,48,1559160
galEp3,0.2222222222222222,9,8,GCCTCATCGTGGCCGCATGA,1,1548100
galEp3,8.0,79,8,GCAAGTCAGTCCGATTTTGA,71,1585762
galEp3,11.444444444444445,110,8,GATGATGGTTCAACGACAAG,102,1587783
galEp3,0.2222222222222222,9,8,GAGCCAATAAAATCTTTATT,1,1575774
galEp3,0.2222222222222222,9,8,GAGAACTGAGCGCGGCACAT,1,1572746
galEp3,2.4444444444444446,29,8,GAACACCAAGCAAATTAATC,21,1551600
galEp3,12.777777777777779,122,8,CTGTAGAAGGACTATGTGTG,114,1566104
galEp3,9.555555555555555,93,8,CTCGTCGTTACTCGAACTAT,85,1552288
galEp3,9.222222222222221,90,8,CTCCAGCATGAGTCTTACGG,82,1583510
galEp3,6.555555555555555,66,8,CTACTCGGTAATCACACACA,58,1569206
galEp3,0.2222222222222222,9,8,CGGTCTACTGTCTGACATGG,1,1581957
galEp3,0.2222222222222222,9,8,CGGCCCTCGGCGTAACCAGA,1,1584581
galEp3,5.555555555555555,57,8,CGGCAAAATCGGGATGTCAA,49,1551902
galEp3,4.666666666666667,49,8,CGCGTACGGTGACCAACCCC,41,1574457
galEp3,11.666666666666666,112,8,CGAGTGTTGAATGGTTAATC,104,1546446
galEp3,5.444444444444445,56,8,CGAACCAAAATTGCGGTCGA,48,1564740
galEp3,0.2222222222222222,9,8,CGAACATAGCTCGTGTACTC,1,1576186
galEp3,6.555555555555555,66,8,CCTTTTATAAACATAGGTCG,58,1568998
galEp3,9.333333333333334,91,8,CCTACATATTTGTAATCCGT,83,1577981
galEp3,9.11111111111111,89,8,CCTAAGGGTACCAGGTCACG,81,1577424
galEp3,5.888888888888889,60,8,CCGCCCTACATCCTTGGCAT,52,1560151
galEp3,8.444444444444445,83,8,CCGCACTCACTGGATCAAGT,75,1586146
galEp3,3.6666666666666665,40,8,CCACCAGGAGTGTGGATCCT,32,1581372
galEp3,0.2222222222222222,9,8,CCAAGTGAGCGAGGGACTAC,1,1570182
galEp3,0.2222222222222222,9,8,CCAACAATGTCTGAACAACT,1,1553831
galEp3,0.2222222222222222,9,8,CATGGGGATTCGTGGATCAG,1,1568452
galEp3,0.2222222222222222,9,8,CATGCAACAGGGGCGCCCCA,1,1560529
galEp3,0.2222222222222222,9,8,CAGTCGCGTTATTTCGAACG,1,1573147
galEp3,0.2222222222222222,9,8,CACCTGTGTCGAAGACTGCT,1,1551667
galEp3,0.2222222222222222,9,8,ATTCGACAAGGTTCAAACGG,1,1575477
galEp3,0.2222222222222222,9,8,ATGTCGCCTCTAACGAAGTT,1,1554625
galEp3,11.0,106,8,ATCTTCAAGTTAGGCCGCTG,98,1576286
galEp3,7.222222222222222,72,8,ATCCGTGACCATTCGGCTTA,64,1568351
galEp3,0.2222222222222222,9,8,ATCCGCAGGTGTTAGTTGAC,1,1570786
galEp3,0.2222222222222222,9,8,ATCCCCGCCGGAAATACGAA,1,1557288
galEp3,6.111111111111111,62,8,ATCAGCCCAAGTTAGTCGGG,54,1567385
galEp3,10.88888888888889,105,8,ATATACACGAGCCCACGTAA,97,1547549
galEp3,8.88888888888889,87,8,ATATAATACGTTAGAACCCC,79,1578187
galEp3,5.222222222222222,54,8,AGTGTCAAACTGCGCGGTGG,46,1589608
galEp3,6.333333333333333,64,8,AGTATATAAGGACAGCGACC,56,1547352
galEp3,0.2222222222222222,9,8,AGCCGAAGCAAAGTTCTGAA,1,1589581
galEp3,10.555555555555555,102,8,AGATAATGCAGGTCAAGTCA,94,1580705
galEp3,8.555555555555555,84,8,ACGGGATTAAGGGACAGCTC,76,1580855
galEp3,0.2222222222222222,9,8,ACGATCCTGACATAGGAATG,1,1568062
galEp3,2.3333333333333335,28,8,ACCCTCTGCACTTGCGCGCT,20,1551563
galEp3,4.444444444444445,47,8,ACCATTGGATGGTAAGGCCT,39,1563564
galEp3,0.2222222222222222,9,8,AATGACTCAGCGGGAAAACT,1,1580909
galEp3,0.4444444444444444,11,8,AATAGGTGCATTTTGGTCCC,3,1584743
galEp3,0.2222222222222222,9,8,AACTGAGCCGGTGTTGCACT,1,1587942
galEp3,12.222222222222221,117,8,AACCATCGCGGGGACAGTCG,109,1580912
galEp3,0.2222222222222222,9,8,AAAAAGAGCCTCTTATTGCA,1,1588487
galEp3,2.625,27,7,TTTTCCTATGGCCACGTACT,20,1559339
galEp3,6.75,60,7,TTTGGTGTCATACATGAGAA,53,1565519
galEp3,15.25,128,7,TTTGCCGTCAATGTGACTTC,121,1569951
galEp3,0.25,8,7,TTTGCCGCTGGAAAAGACCT,1,1561073
galEp3,21.125,175,7,TTTAATATGCTAAATGGCCT,168,1568300
galEp3,3.0,30,7,TTGGTATGAACTTTTCCATA,23,1590237
galEp3,25.125,207,7,TTCGATGCAATGCTTTATTC,200,1564817
galEp3,11.375,97,7,TGTTGCATGGCGCTCGTGGG,90,1586241
galEp3,10.25,88,7,TGGGCGCGTGCAACCGCGGT,81,1579436
galEp3,14.625,123,7,TGCTCATATCCGGTGAGTTT,116,1562032
galEp3,8.375,73,7,TGCAGGGTTTAGTCCGAACG,66,1593409
galEp3,6.375,57,7,TCTTAGCCAATTTGTCGATC,50,1567060
galEp3,8.25,72,7,TCGGCCAGGGTATTGAGAAA,65,1553194
galEp3,0.25,8,7,TCGGATGCTGATGTTGTAAC,1,1572671
galEp3,0.25,8,7,TATAAGCACTATCTCTACTC,1,1577122
galEp3,15.25,128,7,TACAATGCATCCAAAGAATG,121,1587866
galEp3,0.25,8,7,GTTTAACGGGCTCCTGTCAC,1,1569341
galEp3,1.25,16,7,GTTGCATGGCTTCGGCAGGC,9,1573070
galEp3,13.25,112,7,GTCTTCGACGGCCTTAGCGT,105,1558959
galEp3,4.625,43,7,GTCTATGGAGCCCACCTTGC,36,1553590
galEp3,6.25,56,7,GGTAATATGGACATCCTCGT,49,1587508
galEp3,0.25,8,7,GGTAAAACGACGTCAGTCCC,1,1560115
galEp3,11.25,96,7,GGCAAAGTACATAGGAGCTG,89,1579327
galEp3,11.5,98,7,GGACGGCCCTGGTCACTATA,91,1593126
galEp3,0.25,8,7,GCTGTCATAGTTTTTACGTC,1,1556944
galEp3,0.25,8,7,GCGCCCGCAGCACGCATCCC,1,1561935
galEp3,0.25,8,7,GCCGATTTTGGATCCGGCTC,1,1571592
galEp3,0.5,10,7,GCCCAACACATGGACATACT,3,1549938
galEp3,0.375,9,7,GATGTCTTACAGTTTGCAAA,2,1583656
galEp3,0.25,8,7,GAGGGCCGCGAGACCCTCGG,1,1580793
galEp3,0.375,9,7,GAGGCGCACAACGCGTTTTT,2,1572860
galEp3,14.5,122,7,GAAAGGCACGCGAACCTAGA,115,1590500
galEp3,0.25,8,7,CTGCTACGTTTATGAAAGTC,1,1556627
galEp3,0.25,8,7,CTCTGCTTACGCATTCTGTA,1,1563458
galEp3,8.25,72,7,CTAGGCCGGGTATTATTACA,65,1563182
galEp3,0.25,8,7,CGTTAATTTTCTGATTTATA,1,1553238
galEp3,0.25,8,7,CGTGCATGTACATCTCGGTT,1,1549641
galEp3,8.0,70,7,CGGTGACACATTACGTTACA,63,1585138
galEp3,0.25,8,7,CCTTCATCGCATGTGCGTCA,1,1560910
galEp3,0.25,8,7,CCTCCGTCTATGCTAAGAGT,1,1568365
galEp3,2.25,24,7,CCTCCGAGCGCAGCGGTAAA,17,1585301
galEp3,15.875,133,7,CCTATACAATGCACTAGCAT,126,1565141
galEp3,2.5,26,7,CCGCACTGCCAATTTCAGAT,19,1587697
galEp3,5.375,49,7,CCACTATTCTCGAGGGCGCT,42,1593303
galEp3,8.125,71,7,CAGAAATGACAATAATGTAC,64,1570054
galEp3,0.25,8,7,CACTGAAATGAGTGGATGAT,1,1581416
galEp3,6.125,55,7,CACATTGAATCGCGGGATTT,48,1590675
galEp3,6.75,60,7,CAATTTCCCGTCCTCCTCCG,53,1561115
galEp3,0.25,8,7,ATCACCAAGGGTTGGCTTGC,1,1557804
galEp3,0.25,8,7,AGTGGAATTAAAAAAATTAA,1,1577564
galEp3,6.75,60,7,AGTCACGATCCTTGTCTATA,53,1550674
galEp3,6.125,55,7,AGTAGGTTGTTAACGGCAAA,48,1553240
galEp3,14.5,122,7,AGGTACCTTTTAATAAATAA,115,1555846
galEp3,0.25,8,7,AGAGTATTATATCCGCGAAT,1,1547197
galEp3,11.25,96,7,AGACTTGTGAACATCCGAAT,89,1582943
galEp3,10.75,92,7,AGACAAGCACTTTGAATGTA,85,1591382
galEp3,7.25,64,7,ACGTTATCTGTACGACCATG,57,1568264
galEp3,11.25,96,7,ACGGTACCTCAATGCGACTA,89,1562000
galEp3,12.125,103,7,ACGCGTATAGATTCAGTAGG,96,1554817
galEp3,12.75,108,7,ACCGTTGAACGAAGACAAGG,101,1566035
galEp3,14.0,118,7,AATTCACTTGACCAACGATG,111,1573556
galEp3,11.75,100,7,AATGTGACGATTCTGTTCTC,93,1571597
galEp3,0.25,8,7,AAGGAGCGATGTCCTCCGTG,1,1572574
galEp3,0.25,8,7,AACCCCCCACCTCGGAACTC,1,1594927
galEp3,0.25,8,7,AAAAGCACAATGGCATACAA,1,1557019
galEp3,4.428571428571429,36,6,TTTAGTCGTTCTATTCACCA,30,1570636
galEp3,23.571428571428573,170,6,TTGGCTTTCGAGTAATAACT,164,1564508
galEp3,0.2857142857142857,7,6,TTCAATCAGGTAATCCGCAT,1,1590124
galEp3,0.8571428571428571,11,6,TTATTTCTTCTGAGACGCAG,5,1546587
galEp3,6.571428571428571,51,6,TTATCAGCTTTCTTTTAGAT,45,1576930
galEp3,4.428571428571429,36,6,TTAAGCTTCGCACTTCTCTA,30,1577484
galEp3,8.285714285714286,63,6,TTAACGTTGAGCGGGCCAAC,57,1547543
galEp3,15.857142857142858,116,6,TGTTCATACACATTATGCAA,110,1564576
galEp3,9.285714285714286,70,6,TGGGCTCCTGAGTTTAAAGG,64,1592110
galEp3,2.0,19,6,TGCCGTATGATCATTCAACT,13,1558443
galEp3,0.2857142857142857,7,6,TCGCCTCAGCTCCGATGAAT,1,1583326
galEp3,0.2857142857142857,7,6,TCCGGGGTAGTCTCAGGTGA,1,1562654
galEp3,5.571428571428571,44,6,TCCCAACGTTTGGCATCTAC,38,1566599
galEp3,8.571428571428571,65,6,TCAATGCGACGGCAGACCTT,59,1594889
galEp3,11.285714285714286,84,6,TATTATATACACGGGTCTGA,78,1559601
galEp3,0.2857142857142857,7,6,TATGTTCGGTGAGCTTCAGG,1,1588071
galEp3,16.0,117,6,TATAGGTTCCCCACCAAGCT,111,1571013
galEp3,3.5714285714285716,30,6,TAGGGATGAGGTCGCTCAAT,24,1564372
galEp3,0.42857142857142855,8,6,TAAAAGAGATGCCAGCGCGG,2,1561555
galEp3,0.2857142857142857,7,6,GTTTGACACAATATCCATAT,1,1551072
galEp3,5.0,40,6,GTTTAGTCAGAGAGGGTGCT,34,1589721
galEp3,3.5714285714285716,30,6,GTTCTAGCGAGTCCGTTCCA,24,1581865
galEp3,0.2857142857142857,7,6,GTTCAAATTTCTTTTAATCA,1,1577666
galEp3,12.285714285714286,91,6,GTCTTCTAATCAAATGTCCA,85,1592346
galEp3,13.857142857142858,102,6,GGTATTGAACAATGCCGAAA,96,1562440
galEp3,8.428571428571429,64,6,GGTATGTCGCATGTCTGGGG,58,1556820
galEp3,5.428571428571429,43,6,GGGACCAGCGTGCTCTGCAG,37,1584687
galEp3,16.714285714285715,122,6,GGGACCAAAGGTGTTATGAA,116,1582010
galEp3,0.2857142857142857,7,6,GGAGCGTCATGCGGGGAGGT,1,1556194
galEp3,5.714285714285714,45,6,GCTGTTTCGCCGTATATACC,39,1574345
galEp3,0.2857142857142857,7,6,GCTCATACCAAGAGGCACCC,1,1584425
galEp3,11.428571428571429,85,6,GCGCCTGACACAACGATTTA,79,1583935
galEp3,0.2857142857142857,7,6,GATCTAATCTCTGCTGGGTA,1,1552886
galEp3,6.428571428571429,50,6,GAGTCCTCTAGTGAACCTAC,44,1572616
galEp3,9.428571428571429,71,6,GAGTACAGTTAGATCCCTCT,65,1580552
galEp3,5.571428571428571,44,6,GAGGCAACCGGACGTTAGTG,38,1579189
galEp3,6.857142857142857,53,6,GAGCTTGGGTATAGACCTTG,47,1582016
galEp3,11.285714285714286,84,6,GAGCAGACGCGCATGGTTGA,78,1552884
galEp3,7.571428571428571,58,6,GACTGTGGGACGCGTATTTC,52,1551215
galEp3,0.2857142857142857,7,6,GACGCACCTGTGGTTAGAAT,1,1579134
galEp3,3.857142857142857,32,6,GACCGGACCATCCCTCAAAT,26,1569972
galEp3,0.2857142857142857,7,6,GACCATTCAAGGGAGCCGAA,1,1571132
galEp3,9.857142857142858,74,6,GAAGCCGTCTTTGAGTAGAT,68,1581578
galEp3,0.2857142857142857,7,6,CTTCAGACCCCATCGATTTG,1,1579500
galEp3,0.42857142857142855,8,6,CTTATTACGCTTACCTCTTT,2,1575479
galEp3,6.142857142857143,48,6,CTTACCTAAGATATTCAGAG,42,1570491
galEp3,0.2857142857142857,7,6,CTGGAAGGTTCCTGTACTTC,1,1546472
galEp3,3.142857142857143,27,6,CTCTGGAAAGTGAACGAACG,21,1591606
galEp3,0.42857142857142855,8,6,CTCCCACATGCGGCAAGCAT,2,1589738
galEp3,8.0,61,6,CTAGGTCTTCCGGGTTGCCG,55,1582118
galEp3,0.2857142857142857,7,6,CTAACCATCCAGATTCTGGG,1,1557029
galEp3,0.42857142857142855,8,6,CGTTCGAGATAGACCGAGGA,2,1584883
galEp3,0.2857142857142857,7,6,CGTTAATTATGACCTCACAC,1,1561223
galEp3,2.4285714285714284,22,6,CGTGCGCCGGCCACTCAAAG,16,1553142
galEp3,14.285714285714286,105,6,CGTCACCGATGGCGACTGAG,99,1580535
galEp3,9.428571428571429,71,6,CGTCACAATTTCATCTATGT,65,1559486
galEp3,15.0,110,6,CGTATAGGGGGCACCAGGTA,104,1582509
galEp3,3.5714285714285716,30,6,CGGTAAAGTGTAGATTACTT,24,1547121
galEp3,6.714285714285714,52,6,CGATATCATAGTTGGGGACG,46,1572669
galEp3,0.2857142857142857,7,6,CGACGAAGTCTGGCCCCGGA,1,1577650
galEp3,12.142857142857142,90,6,CCGTGAAACCACCGGGCGGC,84,1577976
galEp3,16.714285714285715,122,6,CCGGCCTGGCATGGATCGCA,116,1587055
galEp3,0.2857142857142857,7,6,CCCTTCATCAGTGGGCAAAT,1,1581339
galEp3,0.2857142857142857,7,6,CCCGAGGATGAACGGTTGGA,1,1589509
galEp3,0.2857142857142857,7,6,CATTGGCCTGGGTGCCCTAG,1,1557461
galEp3,9.142857142857142,69,6,CATTGCTCGGTGGGTAGATT,63,1570737
galEp3,9.428571428571429,71,6,CATGTGTTCTGGCCTGCTGG,65,1587850
galEp3,0.2857142857142857,7,6,CATATCGGCGGGTTCCTCTC,1,1568283
galEp3,21.285714285714285,154,6,CAGTGGGTCCGCGTTCTTTG,148,1586296
galEp3,4.285714285714286,35,6,CAGCAACGAGACATAATCCG,29,1576051
galEp3,2.142857142857143,20,6,CAAGTATCTGCGAGCAATCC,14,1547546
galEp3,0.2857142857142857,7,6,CAACGGCGTCTTAAGTCCTG,1,1573524
galEp3,0.2857142857142857,7,6,ATTGTGTGCCAGTGGATGAC,1,1575236
galEp3,6.142857142857143,48,6,ATGGCAATGCATAAGTCGCT,42,1564811
galEp3,5.714285714285714,45,6,ATGGAGTATTTACATCGTAA,39,1569284
galEp3,0.2857142857142857,7,6,ATCTTCAGGGGTCTGAACGT,1,1565598
galEp3,0.2857142857142857,7,6,ATATCGACACATCACCGTGA,1,1557904
galEp3,16.428571428571427,120,6,ATAAGAAACTCGTCCAGAGG,114,1586754
galEp3,0.42857142857142855,8,6,AGGATCCGCGGCCCATTAGA,2,1551677
galEp3,10.142857142857142,76,6,AGCTTTATCTTACCAGCTTA,70,1581206
galEp3,0.2857142857142857,7,6,AGCCGGTCCCGCTTGGAACT,1,1552786
galEp3,11.142857142857142,83,6,AGAGTACTAAGCTTGTTAGC,77,1569717
galEp3,0.2857142857142857,7,6,ACGTATACTGCCTTTTGCAT,1,1574446
galEp3,1.8571428571428572,18,6,ACCTGGTTTCACGATCGCTT,12,1594043
galEp3,22.0,159,6,ACCCTGCTCATATGCGCTCG,153,1570956
galEp3,0.2857142857142857,7,6,ACAACGCTAGGTCAGCAAAA,1,1579767
galEp3,14.428571428571429,106,6,AATCGCCCTCGCAGAAGTGG,100,1579330
galEp3,12.428571428571429,92,6,AAGTGAAGTTGAGATTCCCA,86,1547729
galEp3,15.857142857142858,116,6,AAATCCATGGTGGGTCCGAA,110,1554008
galEp3,0.5,7,5,TTTCGTAAGTTACTGTAGAG,2,1556572
galEp3,0.3333333333333333,6,5,TTTCACCGACTACCAGTTTC,1,1551790
galEp3,0.3333333333333333,6,5,TTTATCCGGCAGAATAAGGA,1,1577489
galEp3,4.166666666666667,29,5,TTGGCCATAACCGGAGCCAA,24,1562311
galEp3,0.3333333333333333,6,5,TTGCTGGTGTATTGTGCCAT,1,1564379
galEp3,16.333333333333332,102,5,TTCGGCGGGACGTTCGCACC,97,1546719
galEp3,0.3333333333333333,6,5,TTCCAGGCATAAGAGAATCC,1,1566304
galEp3,0.3333333333333333,6,5,TTATGGTATGAAGTATGAAT,1,1582818
galEp3,17.833333333333332,111,5,TTAACAGATGAGTTACGAAG,106,1569400
galEp3,15.0,94,5,TGTCGCACGCATGTCCCCAT,89,1566718
galEp3,9.5,61,5,TGCGCATTATAGTTATGTAT,56,1567068
galEp3,0.3333333333333333,6,5,TGCCATACTCGGGAAACGGA,1,1555020
galEp3,12.666666666666666,80,5,TGAAGCGCCGTGCGCTTTGT,75,1564560
galEp3,9.333333333333334,60,5,TCTACCAGTTGGCAGTAATA,55,1572411
galEp3,0.6666666666666666,8,5,TCGTATAAACTGAAATTACG,3,1584746
galEp3,0.3333333333333333,6,5,TCACAATTAACGGCATTATC,1,1577427
galEp3,11.0,70,5,TCAAATACGCCCCTTTGCAT,65,1576386
galEp3,0.3333333333333333,6,5,TAGGGCATAATGCATGCGCA,1,1587261
galEp3,17.5,109,5,TACGCCCCATCGGGGGGAAT,104,1578478
galEp3,17.833333333333332,111,5,GTTGATACGTTCTGTGGCGT,106,1546638
galEp3,0.3333333333333333,6,5,GTTAGGGTAACAACGAAATT,1,1569782
galEp3,20.166666666666668,125,5,GTTACTGTATTTTCAAATAT,120,1554973
galEp3,0.3333333333333333,6,5,GTGTTATTTCTTCGTATTAA,1,1573062
galEp3,0.3333333333333333,6,5,GTGCTGCCAATAATTTCACC,1,1589038
galEp3,0.3333333333333333,6,5,GTATTCAATAGGTATGTCAA,1,1549978
galEp3,4.666666666666667,32,5,GTATCGATTATTTAAACTGA,27,1560519
galEp3,0.3333333333333333,6,5,GTATAGACGTCATCGGGGCT,1,1578252
galEp3,0.3333333333333333,6,5,GGTTTAAGTGGAGCGGCTTT,1,1586031
galEp3,5.333333333333333,36,5,GGCTAGGGTCCTAAATTCAT,31,1575030
galEp3,12.333333333333334,78,5,GGCGGTGATTCAGGGGGTGC,73,1569696
galEp3,0.3333333333333333,6,5,GGAAGTATACAGTGCGGTTT,1,1587509
galEp3,6.333333333333333,42,5,GCTCCAACGGTTTTGTTTTC,37,1550531
galEp3,0.3333333333333333,6,5,GCGTTAAAGTTAACGCCCGG,1,1569666
galEp3,0.3333333333333333,6,5,GCGTCAGGAACGGCGGGTCG,1,1586180
galEp3,4.5,31,5,GCGGCACCGGTCACATCAGC,26,1555098
galEp3,19.166666666666668,119,5,GCCTGTACGCCCGCGCCGAC,114,1562732
galEp3,0.6666666666666666,8,5,GCCTCGTTGTATCACAAGTC,3,1559541
galEp3,0.3333333333333333,6,5,GCCAGCCTGATGGACTTGTT,1,1554390
galEp3,6.833333333333333,45,5,GCAAAGGTAGGTGTTGCATT,40,1553505
galEp3,0.3333333333333333,6,5,GATGTACCGTCAGCCTTTAA,1,1562031
galEp3,2.8333333333333335,21,5,GATGCCGGCTCAGCAGTGGA,16,1569982
galEp3,0.3333333333333333,6,5,GAGAAGTCGGATGTACTGAA,1,1573561
galEp3,0.3333333333333333,6,5,GACGCAGGTATCAGTATTGC,1,1592205
galEp3,12.0,76,5,GAAACGATCAGGCTCAAGTA,71,1553382
galEp3,0.3333333333333333,6,5,CTTCTAGATGTCGTCAGGAA,1,1553477
galEp3,0.6666666666666666,8,5,CTGCGCGCGCCTGGACGTTA,3,1557697
galEp3,6.333333333333333,42,5,CTCTCTTCGACCATACACTT,37,1547919
galEp3,8.166666666666666,53,5,CTCTATCAGTACGTCACATA,48,1568504
galEp3,0.3333333333333333,6,5,CTCATCATTGTGCCGTTAGT,1,1587142
galEp3,13.0,82,5,CTCACCCCTGGCATAGCTTT,77,1594638
galEp3,16.0,100,5,CTATTACTCGTTCGCGCCCC,95,1576495
galEp3,0.5,7,5,CGTGCAAGCTTGGTCTAGGT,2,1553659
galEp3,0.3333333333333333,6,5,CGTCTAATTCTTTCTGAGAT,1,1579776
galEp3,18.5,115,5,CGGTAGAGCATCGATTCGTC,110,1582135
galEp3,0.3333333333333333,6,5,CGGGACTACAATGAATCCAG,1,1547118
galEp3,20.833333333333332,129,5,CGGATTCCAGATATTGGATA,124,1554016
galEp3,9.0,58,5,CGCTCCGTTACCGCGGAGAG,53,1551373
galEp3,0.3333333333333333,6,5,CGCTATACAGGAGTTGCAAG,1,1563258
galEp3,10.5,67,5,CGCCTAGAAGAAATCCTTAG,62,1555838
galEp3,0.3333333333333333,6,5,CGATCAAGCCGCACAGTTAC,1,1578610
galEp3,10.166666666666666,65,5,CCTGTTTGGGTCGATCATGG,60,1570538
galEp3,7.166666666666667,47,5,CCTCTCAGGATGTGTGTGAG,42,1549126
galEp3,4.0,28,5,CCTATTTAACTACGTAACAC,23,1584159
galEp3,0.3333333333333333,6,5,CCGGTATCATGAGCGGCGCA,1,1595004
galEp3,7.5,49,5,CCGGCTGAATCGTACATTGA,44,1550618
galEp3,1.0,10,5,CATCGGGCGTAAGGGAGCTG,5,1581238
galEp3,0.5,7,5,CAGTCTTTAGCAAAGTTGCA,2,1569221
galEp3,11.166666666666666,71,5,CAGTACCAATGGGGCGGTTG,66,1588448
galEp3,11.833333333333334,75,5,CAGGGAAATGAACACAAGAC,70,1559355
galEp3,0.3333333333333333,6,5,CACCGGAGCAATTCATGGAA,1,1592512
galEp3,5.333333333333333,36,5,CAAGCGTTGACAGTGCATCC,31,1584148
galEp3,0.3333333333333333,6,5,CAAAAGATGAGGGTTACTGT,1,1588874
galEp3,0.3333333333333333,6,5,ATGTGGACTTAGCACAACTT,1,1555311
galEp3,4.666666666666667,32,5,ATGTCCACCACTCCACTGGT,27,1593706
galEp3,11.5,73,5,ATGGACCTAAGCGCCCACAT,68,1555747
galEp3,0.3333333333333333,6,5,ATATGGTCAGTAGTAAGATA,1,1569881
galEp3,4.833333333333333,33,5,ATACACCACCGTCCATGGCG,28,1551024
galEp3,14.166666666666666,89,5,AGGTTAGGGGTTCCTTGCTT,84,1556541
galEp3,0.3333333333333333,6,5,AGGGCCGACGGACTCTAATA,1,1554898
galEp3,0.3333333333333333,6,5,AGGACAGAATATTAATAAGG,1,1579067
galEp3,13.5,85,5,AGCGAGGCTATTCTTTCGGA,80,1571272
galEp3,7.666666666666667,50,5,AGATGTATGGGCTGAGGATA,45,1569674
galEp3,15.333333333333334,96,5,AGATACGCATTTGGCCGGTA,91,1575808
galEp3,2.3333333333333335,18,5,AGAGCCTTAGGGGTCTTCGA,13,1572122
galEp3,0.3333333333333333,6,5,ACTTGGCCGTGTCCCCCCTG,1,1548422
galEp3,0.3333333333333333,6,5,ACTCGGGGAAAGAATAGGGT,1,1591567
galEp3,10.666666666666666,68,5,ACAGGAACTTCGCAGGCCAA,63,1561068
galEp3,26.666666666666668,164,5,ACAGATATTATTCTCGACAA,159,1572323
galEp3,14.833333333333334,93,5,AATTTAGGCCCTAGACCTGG,88,1571893
galEp3,0.3333333333333333,6,5,AAGTGTTACCAATACAGCTC,1,1551597
galEp3,0.5,7,5,AAGGAGCGTATCACACTGGT,2,1588436
galEp3,0.3333333333333333,6,5,AACAAAACATCAGAAAGCGT,1,1568018
galEp3,0.3333333333333333,6,5,AAAGGACTCTAGCATTTGAA,1,1581413
galEp3,0.3333333333333333,6,5,AAACTGCCGTGATGATTCAA,1,1550742
galEp3,0.6,6,4,TTTGAAGCCTAAAGAAAGCA,2,1559750
galEp3,0.4,5,4,TTTCTTCTTCTTTAACATAT,1,1571591
galEp3,0.4,5,4,TTTATCTCATCCCCCAGAAG,1,1585755
galEp3,23.6,121,4,TTGTCGTCCGGTCGTCTTGT,117,1552598
galEp3,0.4,5,4,TTGGGTTGCTAAAGTGCTTC,1,1558556
galEp3,0.6,6,4,TTCTGAAGCGCTCTAGGCCA,2,1593675
galEp3,11.8,62,4,TTCAATCGGGTTGAGCCACT,58,1578533
galEp3,25.0,128,4,TTAGGCATTACTCCTGACCT,124,1546667
galEp3,18.8,97,4,TGTCTAAGTAACTAAACACC,93,1570924
galEp3,0.4,5,4,TGTCGTTTATAGCTGACCGA,1,1574615
galEp3,10.6,56,4,TGCGTGGAAAGTCACGAGGT,52,1554512
galEp3,21.0,108,4,TGCGTAATCGAGACGGCTGT,104,1558129
galEp3,0.4,5,4,TCTTCTCCTTTAGACCATAC,1,1576503
galEp3,1.6,11,4,TCTTAAGACTTGTGGCACTG,7,1572470
galEp3,19.6,101,4,TCTGACTGACAGACACACTT,97,1581566
galEp3,0.4,5,4,TCTAATTGGAATAGCTTCCA,1,1576466
galEp3,0.4,5,4,TCGTCTCGTCCAACTTTGTG,1,1564511
galEp3,16.6,86,4,TCCTCGAACTTCCATTTGCA,82,1552558
galEp3,0.4,5,4,TCCACGAGACATCCCACCAG,1,1566774
galEp3,15.8,82,4,TAAGGACTAAAGCTTACTCT,78,1556462
galEp3,1.8,12,4,GTTTTCACATGTGGTTCATA,8,1571577
galEp3,0.4,5,4,GTTGTCTGTCATAGCTTTGA,1,1573824
galEp3,7.0,38,4,GTGTGCTGGCATGTGGTGTG,34,1572356
galEp3,9.4,50,4,GTGTCTAATCCTTCTCTGCT,46,1558871
galEp3,7.2,39,4,GTGTCGGGAATGCGACTTAG,35,1594531
galEp3,0.4,5,4,GTGATTACGCATTTAACTGA,1,1583458
galEp3,11.0,58,4,GTCGTCAGTCGCTCTATAGA,54,1573076
galEp3,0.4,5,4,GTCGCGCGTTAATAATTGTA,1,1587680
galEp3,9.8,52,4,GTCAGTGGCAACTTCCCCCA,48,1589539
galEp3,0.4,5,4,GTAGCTGAATTAGAACGAAT,1,1576633
galEp3,0.4,5,4,GGTCTTCATCCAGCGGGGAT,1,1559990
galEp3,10.2,54,4,GGTAGGGAGGGTTCTTAGAA,50,1575276
galEp3,0.4,5,4,GGTAATGATCTATGTAAATA,1,1552751
galEp3,11.0,58,4,GGGTTCCGCGGGATAGGGTC,54,1592696
galEp3,0.4,5,4,GGGAGGTCGGGGAACGGTCT,1,1563356
galEp3,7.8,42,4,GGCAGTGTTGCGTTCTGCTC,38,1592196
galEp3,16.2,84,4,GCGTACAAGTGCAATCATGG,80,1575936
galEp3,4.6,26,4,GCGCTAACGGGGGTCCTGCA,22,1589468
galEp3,0.6,6,4,GCCATCTGTCATGAGAACCC,2,1566016
galEp3,10.4,55,4,GCCACGGTTCAAACTATAAT,51,1562094
galEp3,20.4,105,4,GCACGAATCTGCGGTGTCAA,101,1594914
galEp3,11.6,61,4,GATTGCATATCCGTACGAAG,57,1587837
galEp3,18.0,93,4,GATGACTACCCGGCCAACCC,89,1562233
galEp3,4.4,25,4,GAGTTGTCGGAATAGGCACG,21,1561569
galEp3,24.2,124,4,GACACACTTGCGGCAGGTTA,120,1571633
galEp3,18.2,94,4,CTTCTAGTACGCCAATCCAG,90,1555564
galEp3,14.4,75,4,CTTCATAAATTCCCCTGTGG,71,1563634
galEp3,13.6,71,4,CTGGTGTCACAATGGGGGGT,67,1575686
galEp3,0.4,5,4,CTGGAGCAGGGGTGACGAGT,1,1553393
galEp3,13.4,70,4,CTCCGTCGGTGACTTGGGAA,66,1570861
galEp3,15.6,81,4,CGGCTACGCCTCTATGTTTT,77,1582255
galEp3,15.0,78,4,CGCGGGACTGGAAAGCGACG,74,1577657
galEp3,0.4,5,4,CGATAGATTTGCGAAGCGGG,1,1571000
galEp3,4.0,23,4,CCTCCTTCCCCGGGCAATAA,19,1551568
galEp3,0.4,5,4,CCCTTAGCTGGAGAAGGATG,1,1565425
galEp3,8.8,47,4,CCCCCGAATGTCATGTTCTT,43,1580980
galEp3,0.4,5,4,CCATAGTGCTAAATCAAGCT,1,1582377
galEp3,0.4,5,4,CCAGGGACAAAACGTCTATG,1,1587521
galEp3,8.0,43,4,CATCTAACTTTACAGGCCCA,39,1552809
galEp3,9.6,51,4,CATAGAAGGATCTGTTATAA,47,1593336
galEp3,3.2,19,4,CAGAGTCATTAAGTCCCTGG,15,1563142
galEp3,2.4,15,4,CACGGGGTCTTGGAGCACTT,11,1573877
galEp3,20.0,103,4,CAAGGAATAGTGGGGGCCGT,99,1582963
galEp3,0.4,5,4,CAACAAGTCTACCGACGTGG,1,1548552
galEp3,0.4,5,4,ATTTTCTTATGTTTGCGGCC,1,1574621
galEp3,3.2,19,4,ATGGAGTTCCACACCCTTAC,15,1558335
galEp3,0.4,5,4,ATGCCAGCCAAAAACGAGGC,1,1566942
galEp3,5.4,30,4,ATCCATAAATTGTTCCAGGT,26,1571506
galEp3,22.6,116,4,ATCAGGTCAGTCATGCCTCA,112,1579951
galEp3,12.0,63,4,ATACCCGCGCATTAGCGGCC,59,1566026
galEp3,16.6,86,4,AGGTCTAGCCCTGAGTGAAG,82,1548097
galEp3,11.0,58,4,AGGCCAATGTCTGCACGCTA,54,1579658
galEp3,0.4,5,4,AGGCAGAAGCGTGCGACCAA,1,1549206
galEp3,8.0,43,4,AGCGTCTAAACCGTGGGTCC,39,1594226
galEp3,28.0,143,4,AGAGTTAGACGCCTAGACAT,139,1593697
galEp3,15.8,82,4,ACTTTACTTTACATGGCCTA,78,1564639
galEp3,11.0,58,4,ACTGTACAAGTACTATCTGT,54,1587051
galEp3,14.0,73,4,ACTGCAATGTAATCGGCATA,69,1566937
galEp3,12.4,65,4,ACTCATCGCGCCGATAGGAA,61,1589045
galEp3,0.4,5,4,ACGTTGTGCCCACTTACAGT,1,1574618
galEp3,13.6,71,4,ACGGCCCCGGCTACCAGCTA,67,1564208
galEp3,14.2,74,4,ACGGATATTCAGAACAATGC,70,1568615
galEp3,7.8,42,4,ACCCGGAAATGCTCATCGTC,38,1586460
galEp3,17.0,88,4,ACCCCGAGAGGCACGCTAGC,84,1567124
galEp3,0.8,7,4,AATGGACTGCCAAGCCCAGA,3,1594222
galEp3,8.0,43,4,AAGGTTAATTGGGGTCATAG,39,1590527
galEp3,14.8,77,4,AAGGTATTAGGGGCCTGCCC,73,1571197
galEp3,22.8,117,4,AACTACGCGGGAGGGCCAAG,113,1560088
galEp3,24.75,101,3,TTGGGGAGCAACCCTGGTGG,98,1592752
galEp3,11.75,49,3,TTCTACCCAGGAGTGCCCTC,46,1564045
galEp3,0.75,5,3,TTATGAACACAACCTTATAT,2,1559592
galEp3,23.75,97,3,TGTTTATAAGGGGCACTCAC,94,1549761
galEp3,0.5,4,3,TGGGCGCGATAAACTCTGCA,1,1592870
galEp3,18.75,77,3,TGGCGACCCCGCCCGTGGCG,74,1578087
galEp3,19.25,79,3,TGACTCGTCCATCTGATATC,76,1575599
galEp3,0.5,4,3,TCTCAATGGCCATTATAGAC,1,1589696
galEp3,0.5,4,3,TCCTGCAGCCGCTTCGGGTT,1,1581455
galEp3,27.5,112,3,TACGTGCTTTCATGCGTTAA,109,1586490
galEp3,0.5,4,3,TAATACTAGCATGGAGCCGC,1,1575480
galEp3,7.5,32,3,GTCGTACGTTGAGTGAAGAT,29,1551407
galEp3,10.25,43,3,GTCCTTGCAAGAAATTTACA,40,1559799
galEp3,27.0,110,3,GTATGGCGGTTGTAACGAAC,107,1586298
galEp3,3.25,15,3,GGTTTTACGGTCACCCTCTG,12,1564491
galEp3,17.0,70,3,GGTTGGAAATTCTTTACATT,67,1558336
galEp3,26.5,108,3,GGTGGGAGTCTCCGGCGAGC,105,1576679
galEp3,0.5,4,3,GGTATAAGCATCTGTTTTAA,1,1590616
galEp3,0.5,4,3,GGCCCAATACTTCTCGAGAT,1,1592036
galEp3,30.0,122,3,GGACCTCTGCGAAATAAAAG,119,1577216
galEp3,3.0,14,3,GCTGTGTTGGACTCCCCTTC,11,1583799
galEp3,0.5,4,3,GCTGCCATTGTGTTAAAGCT,1,1565145
galEp3,13.0,54,3,GCTGATGCACCACCTTTTTT,51,1584235
galEp3,22.25,91,3,GCGTAGATTTACCACGGTCC,88,1574242
galEp3,12.75,53,3,GCGTAAAGCTATTGAAAGTA,50,1585072
galEp3,8.75,37,3,GCGAGTCGTGAGATTTCAGT,34,1561704
galEp3,6.0,26,3,GCGAATCCCCTACGGTTGCG,23,1589938
galEp3,0.5,4,3,GCCTCGGTCGAACACCGAAC,1,1594172
galEp3,0.5,4,3,GCCCGAAGGTAGTAACCTGC,1,1582187
galEp3,0.5,4,3,GCATGTTGTACTCTACCCCT,1,1574978
galEp3,0.5,4,3,GATTTTCAATCAGAATTCTG,1,1588651
galEp3,0.5,4,3,GATATGGGCAGTCTCGGTTA,1,1566087
galEp3,14.0,58,3,GATATCTTGGGAGCAGTTAA,55,1587164
galEp3,10.25,43,3,GAGTAGAGACATCTTTGGGA,40,1554511
galEp3,15.75,65,3,GAGCGCCCTGGGCTGTGGGG,62,1563759
galEp3,0.5,4,3,CTTGAGGATCCGGTGTACGA,1,1561606
galEp3,0.5,4,3,CTTACGTGGACGTGGGTGAC,1,1548936
galEp3,0.5,4,3,CTGTAGCCGGGCGCTCGGGT,1,1561633
galEp3,0.5,4,3,CTCTCGGCTAAGCAAGCAAC,1,1561119
galEp3,12.25,51,3,CTAACACACGAGCCAAGGTT,48,1581580
galEp3,0.5,4,3,CGTACTGTTCCCTATCTGAT,1,1568903
galEp3,0.5,4,3,CGTAATTTAAATCAACATCA,1,1573847
galEp3,0.5,4,3,CGGGTATAGTTGATGGGATA,1,1576437
galEp3,0.5,4,3,CGCCCTCGAGGGCCTATTAC,1,1555642
galEp3,0.5,4,3,CGCACTCTGTAACGCATACT,1,1577540
galEp3,0.5,4,3,CCTGGGAAAGTTAGAGATGT,1,1585006
galEp3,11.0,46,3,CCGACTCGTCTGGAGGCTTC,43,1584846
galEp3,0.5,4,3,CCAAGCACAACCTTCGGTCC,1,1567484
galEp3,0.75,5,3,CATTTGTCGTCTTCAAGTGC,2,1575033
galEp3,1.25,7,3,CATGCCCATTTACTCGGGAG,4,1591411
galEp3,8.5,36,3,CATCAGCCGATGTCGGCTAA,33,1585763
galEp3,22.25,91,3,CAGTAAAGTCCGTCCTGCGA,88,1547486
galEp3,0.5,4,3,CAGATCGACTGTAACCCATA,1,1570271
galEp3,22.5,92,3,CAACTATTAGAATTCTGGGT,89,1574707
galEp3,0.5,4,3,ATTATCACCATTAAAAGCCA,1,1582084
galEp3,8.75,37,3,ATGGTAGCTCCCGATGCACG,34,1581058
galEp3,21.25,87,3,ATCTCCACACTTGCTAGGTT,84,1571848
galEp3,0.5,4,3,ATCCATCGAGCCGTATGGAG,1,1593501
galEp3,28.75,117,3,ATCACCGTTAATGCCCACCT,114,1579080
galEp3,7.25,31,3,ATAGCGCCTGGGATCGATAC,28,1587898
galEp3,0.5,4,3,AGTTCCGGGCCGGGACCTGG,1,1593557
galEp3,14.25,59,3,AGTGTTCAAGACTCTAGGTC,56,1568404
galEp3,0.5,4,3,AGGCTCTCTTAGCGCAAAGC,1,1584856
galEp3,15.0,62,3,AGGCGTGGAGATTGCCAGTT,59,1589003
galEp3,29.75,121,3,AGCTTTTTTGCTCCCACTGG,118,1593461
galEp3,11.0,46,3,AGCTCAAAGGGGAAGCGATC,43,1582158
galEp3,0.75,5,3,AGACGCCAAATAGGGGCGGT,2,1582778
galEp3,5.75,25,3,ACTTGTAATTCTGGGCTCTA,22,1575318
galEp3,11.75,49,3,ACTTAACTTGCCGGCGTGGA,46,1578586
galEp3,30.0,122,3,ACTAGGTACGCAAATGAGCA,119,1562789
galEp3,0.5,4,3,ACTAACCGCATCCAGTCGAT,1,1585983
galEp3,21.75,89,3,ACGTAAGGTTTGAACTTCGC,86,1565994
galEp3,3.0,14,3,ACGGCCCAATCCCTTGCAGG,11,1550441
galEp3,6.5,28,3,ACGCCCGATCAATAGCGGTA,25,1562003
galEp3,0.5,4,3,ACCCGGAAAGATGGTCATAA,1,1547844
galEp3,21.5,88,3,AAGCATATTCTGCGCGCTCA,85,1562525
galEp3,15.5,64,3,AACTGGCTGACTTCCCGTGG,61,1551352
galEp3,0.5,4,3,AACCCAAGACCGGAGCATAA,1,1578423
galEp3,25.25,103,3,AACAACCACTACTAAGCAAT,100,1565068
galEp3,0.5,4,3,AAATCGCGACGTCTATAAGT,1,1565545
galEp3,3.75,17,3,AAACCGTGGCGCCTATAGCA,14,1593508
galEp3,14.666666666666666,45,2,TTTCACGGATATAAGAGCAT,43,1571216
galEp3,22.333333333333332,68,2,TTTATAATTCAAATGGCCAT,66,1564369
galEp3,3.0,10,2,TTGGCATATTACGTCGTGCG,8,1583674
galEp3,0.6666666666666666,3,2,TTCGAACTGGGGCCATGGCA,1,1575731
galEp3,17.666666666666668,54,2,TTCCACTGTCTACGTCAGTC,52,1585078
galEp3,16.0,49,2,TTATGGCGTATAGCTCGAAC,47,1555407
galEp3,38.333333333333336,116,2,TTACTCGGTAACAAGATCCT,114,1589377
galEp3,22.333333333333332,68,2,TGTTTCTGGAGTGGTTGGTC,66,1548385
galEp3,0.6666666666666666,3,2,TGTCGTAGCAAGATCGCGTA,1,1572270
galEp3,0.6666666666666666,3,2,TGGTCGTTAGACCCGTTTAA,1,1567457
galEp3,24.0,73,2,TGGTATCAAATAAATGTCGG,71,1582017
galEp3,0.6666666666666666,3,2,TGAGGGCGGGCGCCTGGTGA,1,1580797
galEp3,1.0,4,2,TGAAGTTGTCTGGTGTTCAT,2,1578587
galEp3,0.6666666666666666,3,2,TCTGGGCCGGATGGGTGTCA,1,1546744
galEp3,14.666666666666666,45,2,TCTACCTACGCGTGTACTCG,43,1560361
galEp3,7.333333333333333,23,2,TCCTATTTGGAGGACCCTTT,21,1581051
galEp3,20.0,61,2,TCAAATCTTTCTGGAGTCAG,59,1575675
galEp3,11.333333333333334,35,2,TATTGCACGGTCATCGCGCA,33,1587569
galEp3,25.333333333333332,77,2,GTTACCTAGTTACTTCTGTC,75,1581350
galEp3,0.6666666666666666,3,2,GTGGAATTCCCCCAATTCTT,1,1569421
galEp3,0.6666666666666666,3,2,GTGCATGAGATACATTACTC,1,1556188
galEp3,0.6666666666666666,3,2,GTCTCAGCCGTTTGAAGAAC,1,1562001
galEp3,14.0,43,2,GTATATACCACATTAATCCT,41,1546901
galEp3,30.333333333333332,92,2,GGTTTTCAAAACCCGAGTAT,90,1548581
galEp3,24.666666666666668,75,2,GGGCCGACTGCGTCTTGAGC,73,1585257
galEp3,1.6666666666666667,6,2,GGCTGCCGCCGTGTACCAGT,4,1546834
galEp3,0.6666666666666666,3,2,GGCATGGACATCTCAATCGC,1,1591266
galEp3,0.6666666666666666,3,2,GGAGCATCTGAGAACGACCT,1,1580283
galEp3,17.0,52,2,GCCTTGGTATGTATATCGAC,50,1562063
galEp3,0.6666666666666666,3,2,GCCATGTAAAACGGGAAGTC,1,1558278
galEp3,7.0,22,2,GCACGCTCGAGATTGTCTCT,20,1581575
galEp3,27.333333333333332,83,2,GATTCCTAGGCTCTGGGGCT,81,1559575
galEp3,16.666666666666668,51,2,CTTTCAGGTTTCGACCATTC,49,1561384
galEp3,25.0,76,2,CTTGGCGGAGCCATTATTGT,74,1546953
galEp3,0.6666666666666666,3,2,CTGAGAGGAACTACCTCAGG,1,1552944
galEp3,41.0,124,2,CTCTTTGTATTGCCTAGAAT,122,1580706
galEp3,3.0,10,2,CTCTAAGCGCCACCGTACTC,8,1551031
galEp3,3.6666666666666665,12,2,CTCGGATATGGGGCATAAGT,10,1569977
galEp3,0.6666666666666666,3,2,CGTTCGAACATAATCCGAAT,1,1552847
galEp3,0.6666666666666666,3,2,CGTTACTGCTTCGGACATTA,1,1552142
galEp3,0.6666666666666666,3,2,CGTACTCTGAGAGCATGCGG,1,1551872
galEp3,14.333333333333334,44,2,CGGCGGATGCCATCAGTTGC,42,1594742
galEp3,0.6666666666666666,3,2,CGGCATCCCTGTAGAAAGTG,1,1593562
galEp3,15.333333333333334,47,2,CGCGCTTCGCTAGGCGAACC,45,1590706
galEp3,30.666666666666668,93,2,CGCGCGCAGCTCGGGCAAAC,91,1592378
galEp3,19.333333333333332,59,2,CGCCCATATTAAGCCCGACT,57,1592447
galEp3,24.0,73,2,CGAGCCCCAATCTCTAAGTG,71,1583489
galEp3,0.6666666666666666,3,2,CGACCATCGAGTTGTCCTAT,1,1590825
galEp3,18.0,55,2,CCTTGGGAGCGTTACGGTTT,53,1591473
galEp3,0.6666666666666666,3,2,CCTTCTCCTAGGAAACTCGT,1,1557085
galEp3,0.6666666666666666,3,2,CCTCGTTTGGACAGCGGACT,1,1554642
galEp3,0.6666666666666666,3,2,CCTATACGAGAATTAGTCGG,1,1577188
galEp3,25.333333333333332,77,2,CCAGTAAAGCCGAGTCTAAA,75,1573660
galEp3,0.6666666666666666,3,2,CATTAGAGTTCCGGGCACAG,1,1547110
galEp3,30.666666666666668,93,2,CAGGCAGCATAAACACGTGC,91,1583820
galEp3,0.6666666666666666,3,2,CACGGAAGGAACAGACTCAC,1,1552752
galEp3,10.666666666666666,33,2,CACCTAAGAGATAAGAGCAA,31,1574201
galEp3,33.333333333333336,101,2,CAAGTGCGCCGTTGTTTGAT,99,1595193
galEp3,0.6666666666666666,3,2,CAAGCTGTGTCCGTATAATG,1,1579507
galEp3,0.6666666666666666,3,2,CAAGACGCCGGCTATCAAGT,1,1590686
galEp3,0.6666666666666666,3,2,CAAAATTGTGTTTCTAGGCC,1,1581202
galEp3,20.333333333333332,62,2,ATTGCAGACAGCAGACCCCG,60,1559284
galEp3,30.333333333333332,92,2,ATTCCGAGCCACTTTGTCTT,90,1577212
galEp3,0.6666666666666666,3,2,ATTATACATTTTTCATAAAC,1,1561484
galEp3,30.666666666666668,93,2,ATTAGGCGGGGGTTCAGTTA,91,1576054
galEp3,14.333333333333334,44,2,ATGGTATCTCAGTCAGACGT,42,1550901
galEp3,0.6666666666666666,3,2,ATGATTTCGGTATCTTTGAG,1,1588995
galEp3,0.6666666666666666,3,2,ATGAAATGTACCACTGAATA,1,1578881
galEp3,19.0,58,2,ATCCGGTTGAGTATAGAAAA,56,1571235
galEp3,0.6666666666666666,3,2,ATCACTGGGAACCTATCGTT,1,1588327
galEp3,0.6666666666666666,3,2,ATAAGCACTAACGACGCCAC,1,1549940
galEp3,0.6666666666666666,3,2,AGTCTCTCGCGAACAATCAG,1,1581700
galEp3,0.6666666666666666,3,2,AGGTATCTCACCGGTATACA,1,1573952
galEp3,1.0,4,2,AGGGTCATTTCAGCTGTATT,2,1562050
galEp3,31.0,94,2,AGGCGCCGAGCACAATAACT,92,1551889
galEp3,30.333333333333332,92,2,AGCATATATCTCAAGCCGTA,90,1549120
galEp3,20.0,61,2,AGACTAGGCTGGCCCCTCAT,59,1563620
galEp3,0.6666666666666666,3,2,AGAATAGGTCGGAGAGAGCC,1,1550034
galEp3,2.3333333333333335,8,2,ACTACATCTCACCGGACCAT,6,1554283
galEp3,28.333333333333332,86,2,ACGCCGACTTTTCACATAAT,84,1561809
galEp3,0.6666666666666666,3,2,ACGAAGGGAGGTTTGTGATG,1,1581425
galEp3,0.6666666666666666,3,2,ACCTAAGGGCTTTTACCTGT,1,1561080
galEp3,0.6666666666666666,3,2,ACCAGCTTACTCAATTGTGA,1,1575125
galEp3,0.6666666666666666,3,2,ACACGGACTGCAGAAAGGAT,1,1563175
galEp3,22.666666666666668,69,2,AAGGAGTGTAACAATATGAG,67,1561996
galEp3,0.6666666666666666,3,2,AACGGACTACAACGTCCCAC,1,1559567
galEp3,0.6666666666666666,3,2,AAAGGCATCTCAGTCGCCCT,1,1583338
galEp3,10.0,31,2,AAAGACACGTACGGGGGTTC,29,1552299
galEp3,44.5,89,1,TTTGTACTTTACAATCTGGC,88,1560083
galEp3,1.0,2,1,TTTGACAGTGGATTTTCGGT,1,1560036
galEp3,1.0,2,1,TTTATATGTGGTCATTTCCT,1,1567449
galEp3,24.5,49,1,TTGTAGGACTGGTCTATTTA,48,1575250
galEp3,1.0,2,1,TTGTAAAAGCAAACGACACA,1,1588335
galEp3,54.0,108,1,TTGATGCGGTAAGTCGCAAC,107,1583100
galEp3,50.5,101,1,TTGATACAACGCGGTGATCT,100,1565385
galEp3,1.5,3,1,TTGATAAAGGTCATCTGACA,2,1589514
galEp3,16.0,32,1,TTGAACTGGTTAGCTGTCGG,31,1564824
galEp3,36.5,73,1,TTACTGGTGCGATCAACGAT,72,1565884
galEp3,41.5,83,1,TGAGGGGATCTGCAAGAAAG,82,1570219
galEp3,58.0,116,1,TCTGACCGCGTGTGCGGAAC,115,1583071
galEp3,35.5,71,1,TCGTGCCCGAGCCACACAAA,70,1552084
galEp3,11.5,23,1,TCGGTTTAAACATAGATTTA,22,1560474
galEp3,1.0,2,1,TCCCAAGGTGCCCCGATGGA,1,1574204
galEp3,54.5,109,1,TATCTGGCGCGAAGTGTATA,108,1572713
galEp3,25.0,50,1,TATACTGTCGCCACCGATCT,49,1592038
galEp3,1.5,3,1,TACTCTGTCCGGCGTACATT,2,1559520
galEp3,1.0,2,1,TACCCCCGGTCCAAGAGTGA,1,1585840
galEp3,36.0,72,1,TACCCATGGTCTTCAAACAT,71,1549582
galEp3,63.5,127,1,TAACCTTAACCCTGGGATAA,126,1586940
galEp3,1.5,3,1,GTTGTCGTTTTTTCTTCTCT,2,1552459
galEp3,22.0,44,1,GTGTATAAGTTCGTACACGG,43,1589575
galEp3,54.0,108,1,GTGTAGCCCATTCACGAGAG,107,1556670
galEp3,1.0,2,1,GTCGATTTTAGCTCGGGAAA,1,1548689
galEp3,1.0,2,1,GTCGAAAACCTGGTCGAGCG,1,1553856
galEp3,1.0,2,1,GTCAGGTCAAGACATGGTAA,1,1580953
galEp3,45.0,90,1,GTAACACGGGGCGATCAGAA,89,1569412
galEp3,52.0,104,1,GGTAACATCAAATTTGATGA,103,1583006
galEp3,1.0,2,1,GGGAAATGTGGGTCATCGCG,1,1587058
galEp3,1.0,2,1,GGAGCGTTAATACTTTGGTA,1,1593326
galEp3,66.5,133,1,GGAATAACGGCACTGGTGCT,132,1561997
galEp3,1.0,2,1,GCTATCATAGGGCGATGGGT,1,1573836
galEp3,54.5,109,1,GCCTCCCCGGGGGTCTTGGA,108,1577586
galEp3,1.0,2,1,GCAAATACTATATCGTTCGA,1,1548537
galEp3,1.0,2,1,GATTATTGTTGTGGCCGTTT,1,1563718
galEp3,1.0,2,1,GATGGAGTTACAATTTTACT,1,1554504
galEp3,89.0,178,1,GAGTATCCCCTGTTGTAGTC,177,1564566
galEp3,1.0,2,1,GAACGATGAGAAATTTCAGA,1,1562564
galEp3,5.5,11,1,GAAAGTAGCCCCGCATCAGT,10,1555265
galEp3,1.0,2,1,GAAACTCCAGGTAGGAATGT,1,1566252
galEp3,24.5,49,1,CTGGAGAACGTTCGACGGAT,48,1550789
galEp3,19.0,38,1,CTCTACCCCAACTACATTCT,37,1569740
galEp3,34.0,68,1,CTCAAGCAGATCGATTCGTA,67,1562004
galEp3,30.0,60,1,CTATACTGAAACATTTGCGC,59,1585775
galEp3,1.0,2,1,CTAGAGATCAACGCTACCGA,1,1594357
galEp3,71.5,143,1,CGTTGTCACCGTGGACTTTA,142,1568056
galEp3,59.5,119,1,CGGTTGGTGTGGGACTGACA,118,1558587
galEp3,36.0,72,1,CGCAGGGGACGAATAAATGA,71,1557672
galEp3,21.5,43,1,CGAGGGGAGGTATCTACGCA,42,1567433
galEp3,25.5,51,1,CGACTAATTGATTACGTGCG,50,1565506
galEp3,41.5,83,1,CGAAGTGAACACAGCTAGAA,82,1580974
galEp3,1.0,2,1,CCTGAGCAGACCGTTACCTC,1,1560152
galEp3,63.0,126,1,CCTCAATTTAGCTAGGTAAT,125,1560052
galEp3,1.0,2,1,CCCCGCCAACTATTGTTAAC,1,1573394
galEp3,1.0,2,1,CCCAGACCTGGATGTTAAGG,1,1567671
galEp3,1.0,2,1,CCATAACACCCCAGGTTTGG,1,1560065
galEp3,43.5,87,1,CCAGGGCATATGATTGTCAC,86,1559246
galEp3,1.0,2,1,CCAAAATATATGTTCGGAAC,1,1570067
galEp3,1.0,2,1,CATTCTCTGGATACCGTATT,1,1574530
galEp3,5.5,11,1,CATTCGGACGATGGTATATT,10,1574953
galEp3,1.0,2,1,CATCGACTTTCGTCTCCCTG,1,1553691
galEp3,1.0,2,1,CATAGAAGTCCAGTGCTTTG,1,1580679
galEp3,17.0,34,1,CACTTGCTTCCAGGAAGGAA,33,1583783
galEp3,35.0,70,1,CAAAACATGTTGCTCACATA,69,1550390
galEp3,6.0,12,1,ATTTACGAAGTGTTCACAAG,11,1594521
galEp3,7.5,15,1,ATGCCGCAAACAGACGCCGC,14,1564913
galEp3,31.0,62,1,ATCTCGAGGACGCGGCCAAT,61,1584168
galEp3,37.5,75,1,AGGAATCTTAATGGGCCTTT,74,1550911
galEp3,10.5,21,1,AGCGCCCGCCCCCTGTGAGG,20,1578130
galEp3,3.5,7,1,AGACGGCCCTCTTTCACCCT,6,1546704
galEp3,25.0,50,1,ACTCATCGCTGTAATGCATA,49,1577251
galEp3,1.0,2,1,ACGGTCCGCATTGTACGTAA,1,1561860
galEp3,1.0,2,1,ACGCTACCAGCCAGTGATAC,1,1573674
galEp3,12.0,24,1,AACCGGATTTCGCGCTAGTT,23,1562299
galEp3,0.009345794392523364,106,106,AGGGTATCACCTGACCGCAG,0,1550867
galEp3,0.010526315789473684,94,94,GCCCTACAGTCTAGGCACTC,0,1552560
galEp3,0.010869565217391304,91,91,TATGAATCACGGTACAATGT,0,1570889
galEp3,0.011111111111111112,89,89,TTGATCGGTACGCCCGGATT,0,1559887
galEp3,0.011494252873563218,86,86,AAGGTTCTCGATTCTATCTT,0,1590454
galEp3,0.011627906976744186,85,85,AACGCATACGGTATGCGCAG,0,1553972
galEp3,0.012048192771084338,82,82,CCGACGCAGATTGTGACTCG,0,1553294
galEp3,0.012345679012345678,80,80,TCATCCTCCGCGTAGCCCCA,0,1553167
galEp3,0.0125,79,79,AAAGGAGCCGTCCCTCTGTA,0,1587259
galEp3,0.013157894736842105,75,75,TGGCCGGACACCTAACGTGT,0,1584597
galEp3,0.013333333333333334,74,74,TAGCATCCCGGTTGGGAGTT,0,1574812
galEp3,0.013333333333333334,74,74,GCTCAGCCCGCCGGGCAGCA,0,1547539
galEp3,0.013333333333333334,74,74,GCGGAGAGGGAGCCCCACCA,0,1546895
galEp3,0.0136986301369863,72,72,GATTCCAATAAGTTGGCCGT,0,1566491
galEp3,0.013888888888888888,71,71,TTGACCAATAAGACTCTAAG,0,1557920
galEp3,0.013888888888888888,71,71,ATGAACTTTGCGGCATAGTG,0,1586252
galEp3,0.014084507042253521,70,70,CCCATGACGACTGGCTTTTT,0,1560905
galEp3,0.014084507042253521,70,70,AGTTGATCAGGGGTCGAAGT,0,1575877
galEp3,0.014285714285714285,69,69,CCATCCCTGCTTTGACAACA,0,1549161
galEp3,0.014285714285714285,69,69,AGTCCTAGGCGGTCGTGCCT,0,1549570
galEp3,0.014285714285714285,69,69,AAACGTTTGACCTATGATCT,0,1563066
galEp3,0.014285714285714285,69,69,AAACACTTGCGAATCCGCCA,0,1589380
galEp3,0.014705882352941176,67,67,TTAACATCCCGCAAAACGGA,0,1558127
galEp3,0.014925373134328358,66,66,CCATTAGCACTGTCCGGGCT,0,1551993
galEp3,0.015384615384615385,64,64,GGGAAAGGGCATTGACAATG,0,1557575
galEp3,0.015625,63,63,GCTGAAGTTGGAAGAGGAAA,0,1550772
galEp3,0.015625,63,63,GCGTGTGGGCATTTGTACTT,0,1548241
galEp3,0.015625,63,63,CGCTTACATCGCTACGCTCT,0,1547462
galEp3,0.015873015873015872,62,62,TACCGTCATACGTGTTAAGT,0,1560889
galEp3,0.015873015873015872,62,62,GAGCCAGTGATCAGGCGCTA,0,1562286
galEp3,0.015873015873015872,62,62,CTGTCGTGTAGAGTTTCGGT,0,1548612
galEp3,0.016129032258064516,61,61,AGTATCCCATCCACCTACTT,0,1547622
galEp3,0.016666666666666666,59,59,GGAGCCCCGTGCGGAGCGAT,0,1547061
galEp3,0.016666666666666666,59,59,CTATGTTGCAAATTTTATTG,0,1554575
galEp3,0.016666666666666666,59,59,CGTCCTCGGAGCGGAAAGCT,0,1576870
galEp3,0.01694915254237288,58,58,TCCCTTCACTACTATTCTAA,0,1555130
galEp3,0.01694915254237288,58,58,TACCGGGTCACCTCCTGTAG,0,1551515
galEp3,0.01694915254237288,58,58,GTGATTGACTTTGACACTTC,0,1554841
galEp3,0.01694915254237288,58,58,GTAGTATACGTTCATCCAAA,0,1592228
galEp3,0.01694915254237288,58,58,CCTCTACCGTAACTACGGAT,0,1551870
galEp3,0.017241379310344827,57,57,TTTAAGGGCCTCTGTACCCA,0,1566984
galEp3,0.017543859649122806,56,56,TCGCGAAGGGCGGCGTTTCA,0,1562663
galEp3,0.017543859649122806,56,56,TCGAACCGCCTGCTATTTGT,0,1556750
galEp3,0.017543859649122806,56,56,TAGGAGTACTGGCCTCACGT,0,1588974
galEp3,0.017543859649122806,56,56,GTGCTATCGGGAATCCAAAT,0,1549041
galEp3,0.017543859649122806,56,56,CACCAGCGCTATTTAGATCT,0,1574972
galEp3,0.017857142857142856,55,55,TGCGCTGACGTCGCCGACGA,0,1568113
galEp3,0.017857142857142856,55,55,GTGGGCTCCTGAAAATGGTT,0,1556458
galEp3,0.017857142857142856,55,55,GTCTGCTAGCACTCAGTACA,0,1559597
galEp3,0.01818181818181818,54,54,GGAAGCTCCCTTGTGCGGGA,0,1564845
galEp3,0.01818181818181818,54,54,GAGCCTGGTTGCTGAGAGTG,0,1549259
galEp3,0.01818181818181818,54,54,CGTCGGACATTCCGCTACGT,0,1552186
galEp3,0.01818181818181818,54,54,CGTAATAGGTCTCTACAGTA,0,1571963
galEp3,0.01818181818181818,54,54,CCAACAGACATGCTCTACGC,0,1547785
galEp3,0.01818181818181818,54,54,CATTAGCCCATGCGTTCTGC,0,1589700
galEp3,0.01818181818181818,54,54,CACGTGCTTCGGAGACGACG,0,1549008
galEp3,0.01818181818181818,54,54,AAAACAATCGTTTGCTTGAT,0,1546861
galEp3,0.018518518518518517,53,53,TCGTGCTGGTGAAGAGCTTT,0,1580701
galEp3,0.018518518518518517,53,53,GGTCTAAGATTTCGCCATGA,0,1567229
galEp3,0.018518518518518517,53,53,CTTTCGGAGGTGGACTATAG,0,1571658
galEp3,0.018518518518518517,53,53,AACCCGAGCGTGATCACGTA,0,1552848
galEp3,0.018867924528301886,52,52,TTGAGACATAGGCAGCCCAA,0,1581648
galEp3,0.018867924528301886,52,52,TGAGCTGACTCTCTTAGCTC,0,1550608
galEp3,0.018867924528301886,52,52,TAAGGGCGAATACACTCCGC,0,1559677
galEp3,0.018867924528301886,52,52,GTACCGCTCAGCAGACGAAC,0,1558595
galEp3,0.018867924528301886,52,52,CTGTCTAACTATAATTGGGT,0,1565414
galEp3,0.018867924528301886,52,52,CCCACGTATTGTGTGGAACC,0,1551785
galEp3,0.018867924528301886,52,52,CACCGGTCCCTAACGACACA,0,1581474
galEp3,0.018867924528301886,52,52,AGTAAAGGACACGTAAAGTT,0,1549858
galEp3,0.018867924528301886,52,52,ACCACTCATTGGCGTCGGCA,0,1547412
galEp3,0.019230769230769232,51,51,GCCTAGCACCCGGTTCTATT,0,1588104
galEp3,0.019230769230769232,51,51,GCCCAATCATTGTCAGCATC,0,1564200
galEp3,0.019230769230769232,51,51,CATGTGTGGTGACATAGTGG,0,1547237
galEp3,0.0196078431372549,50,50,TCCACGCTGATCTCCCAGTA,0,1554275
galEp3,0.0196078431372549,50,50,GGTTGTATGCAGACAGACAG,0,1548818
galEp3,0.0196078431372549,50,50,GCGACAGGTCTTTGACTCAA,0,1550203
galEp3,0.0196078431372549,50,50,CTGTCTTCGTCGTCTGCATT,0,1574338
galEp3,0.0196078431372549,50,50,CACCTATGAATACGCAGCAT,0,1584230
galEp3,0.0196078431372549,50,50,ACTGCGTACAGTCCGTGTCA,0,1587839
galEp3,0.02,49,49,TATCGACCGCTCTGGGTATA,0,1566760
galEp3,0.02,49,49,CTTACCCTGTAACCTTGCAG,0,1571213
galEp3,0.02,49,49,CATAAGTTGATCCCATCCGA,0,1548776
galEp3,0.02,49,49,CAGCAATCTCCCCGAGTGAA,0,1558016
galEp3,0.02,49,49,AAGGGCATGGCGCACTTCTA,0,1566078
galEp3,0.02040816326530612,48,48,TCTGGGGTGATCCGTGTTAA,0,1553105
galEp3,0.02040816326530612,48,48,TACTCTCGGGCTCAGATTTG,0,1574660
galEp3,0.02040816326530612,48,48,CGAGGCATAGGACCCAAACA,0,1552970
galEp3,0.02040816326530612,48,48,AAGCAAGCTCTGCGTACACA,0,1571657
galEp3,0.02040816326530612,48,48,AAAGAGCAAAGCGCGGGAAA,0,1562131
galEp3,0.02040816326530612,48,48,AAACGGCCACTGCCCTAGGA,0,1570495
galEp3,0.020833333333333332,47,47,TGACGCCACGTTAACTGCCA,0,1583390
galEp3,0.020833333333333332,47,47,TGAAGCAAGTCTGCTCCAAG,0,1557121
galEp3,0.020833333333333332,47,47,TCTTCACGATGTCTTACGTA,0,1551213
galEp3,0.020833333333333332,47,47,GGAGTTTCATCGTCAAAAAA,0,1573694
galEp3,0.020833333333333332,47,47,GAGTAGATTCATTCCCGAAT,0,1574906
galEp3,0.020833333333333332,47,47,ATTGTGATGTTCTCGGATTA,0,1547758
galEp3,0.020833333333333332,47,47,ACATAGGAGTGCCCGATAAA,0,1573265
galEp3,0.02127659574468085,46,46,TCGCCTCTCGTAGGGACGAT,0,1552483
galEp3,0.02127659574468085,46,46,GTTGCGGTGCCATATATCGC,0,1549003
galEp3,0.02127659574468085,46,46,GCGGACCTGATGGCATCACA,0,1550841
galEp3,0.02127659574468085,46,46,GCGACCCCCCCACCTGGATT,0,1562834
galEp3,0.02127659574468085,46,46,GACTGGCACAGGACCGTCAT,0,1556430
galEp3,0.02127659574468085,46,46,CGGCATCTTCTCCTGATGAA,0,1561526
galEp3,0.02127659574468085,46,46,CCATCATCCGCACCCCCTGA,0,1576020
galEp3,0.02127659574468085,46,46,CACACGTTGTGGGACAGGAG,0,1577326
galEp3,0.02127659574468085,46,46,AGTTAACTGCATTGAGTGTT,0,1576890
galEp3,0.021739130434782608,45,45,GGTTAATTAGATGACATGGG,0,1568171
galEp3,0.021739130434782608,45,45,GATCAAACATTTTACCCACA,0,1551747
galEp3,0.021739130434782608,45,45,CCTGCGATCACCTGTAGGAT,0,1547185
galEp3,0.021739130434782608,45,45,ATTTCGCAGCCATACAGCTA,0,1577674
galEp3,0.022222222222222223,44,44,GTCGCGTCCATGTACCCAGG,0,1579949
galEp3,0.022222222222222223,44,44,GCGAGGCCGTACACAGCTCA,0,1548953
galEp3,0.022222222222222223,44,44,GATCATAAATAACAGCCTTG,0,1567795
galEp3,0.022222222222222223,44,44,CCGTTCCACCATTGATGCAT,0,1585410
galEp3,0.022222222222222223,44,44,CCGACCCATCTAGATCGTAT,0,1552963
galEp3,0.022222222222222223,44,44,CCACCCCGAATTCTGCGTGG,0,1556456
galEp3,0.022222222222222223,44,44,ATCGCGTCTGTCAGTTCGTG,0,1554532
galEp3,0.022222222222222223,44,44,ATCATTACGGTTGCGGTTGA,0,1565307
galEp3,0.022222222222222223,44,44,ACGAATACCGGGTATACAGA,0,1572945
galEp3,0.022222222222222223,44,44,AAGGAACCACATTCCGACGA,0,1559917
galEp3,0.022727272727272728,43,43,TGGAGACTAGCCCCTGAAGT,0,1580150
galEp3,0.022727272727272728,43,43,TGCTATCTATTATTTACCAA,0,1560808
galEp3,0.022727272727272728,43,43,TGCCGTGACCCATCGTTCAA,0,1576799
galEp3,0.022727272727272728,43,43,TAGGGTGGCTCAGCATGTTC,0,1580617
galEp3,0.022727272727272728,43,43,GGGGATACTATTTATGCCCT,0,1576552
galEp3,0.022727272727272728,43,43,GGCTCACACTGTGCTGCAAA,0,1549359
galEp3,0.022727272727272728,43,43,GGATAGTTTCTCGACTACCA,0,1548777
galEp3,0.022727272727272728,43,43,GGACTGAGGGTGTATAGTGC,0,1557643
galEp3,0.022727272727272728,43,43,GCGTCGATACTCGGTGCTTG,0,1572692
galEp3,0.022727272727272728,43,43,ATGAGCATCCGTTCATAAGA,0,1568957
galEp3,0.022727272727272728,43,43,AATGGCAGAATCTCAAGAGC,0,1554182
galEp3,0.023255813953488372,42,42,TGCGAGCTGTTAGAGAGCGG,0,1557892
galEp3,0.023255813953488372,42,42,TGCGAAGGCTATCGGGAGCC,0,1575399
galEp3,0.023255813953488372,42,42,TGATCCAAGAGACAACTGTG,0,1552681
galEp3,0.023255813953488372,42,42,TGAATGACTCGTTGTCTTGT,0,1588662
galEp3,0.023255813953488372,42,42,TAGGGATCTTTCTGCGACTG,0,1549162
galEp3,0.023255813953488372,42,42,GAGGCGTAGGGCATGGGCGA,0,1582867
galEp3,0.023255813953488372,42,42,GACCGCGTTCTAGGGATCTC,0,1552771
galEp3,0.023255813953488372,42,42,GAACATTGGGGTTTTCAGAC,0,1552912
galEp3,0.023255813953488372,42,42,CTCCGTGCTCTACGATCCAC,0,1581374
galEp3,0.023255813953488372,42,42,CCCAAATTTGCCTCTTCGAC,0,1559435
galEp3,0.023255813953488372,42,42,ATTGCGGTAGGCCCTCCCGC,0,1556322
galEp3,0.023255813953488372,42,42,ATGCGGATAGCGTTACCTGG,0,1550924
galEp3,0.023255813953488372,42,42,AGCTCGTTGTTATAACAATG,0,1580304
galEp3,0.023255813953488372,42,42,ACCGGATAGGGAATTGCGGT,0,1574557
galEp3,0.023255813953488372,42,42,AAGTGGGTAAATCATGCCTG,0,1555496
galEp3,0.023809523809523808,41,41,TGCTCTTATTACCAGGAGCA,0,1571959
galEp3,0.023809523809523808,41,41,TGAGCACCCCTGAGACATTA,0,1550350
galEp3,0.023809523809523808,41,41,TACGTCAGGTACCAGGTATA,0,1562539
galEp3,0.023809523809523808,41,41,GTGGCTCGTAGCTACTGTGA,0,1556771
galEp3,0.023809523809523808,41,41,CTCTTACAGTCATTAGTTTG,0,1570623
galEp3,0.023809523809523808,41,41,ATAGAGCATGAGACGGGGTT,0,1546940
galEp3,0.023809523809523808,41,41,AGTCCCGTGTAACATGAACG,0,1590070
galEp3,0.023809523809523808,41,41,AGGCAAGAAAGTCTGTCAAC,0,1552914
galEp3,0.023809523809523808,41,41,ACACGGGCACTCTCTGCTGT,0,1548080
galEp3,0.023809523809523808,41,41,AAGCCACCAGTCGTCTGGGG,0,1571078
galEp3,0.024390243902439025,40,40,TCGCCAATTTAAAACATTCT,0,1546558
galEp3,0.024390243902439025,40,40,TCCGAAGCCCAGTGGCACCT,0,1555044
galEp3,0.024390243902439025,40,40,TCCCGGTTCCGCTTGTCGCA,0,1589616
galEp3,0.024390243902439025,40,40,GTGCCCGGAGCACCTGAGTG,0,1557251
galEp3,0.024390243902439025,40,40,GGTTGCCCTAGGCGACCACA,0,1562557
galEp3,0.024390243902439025,40,40,GGTAAATCTGTACCCGTCGG,0,1554611
galEp3,0.024390243902439025,40,40,GCATATCCAGGGAGGTGGAA,0,1560019
galEp3,0.024390243902439025,40,40,GACGCTTTTACGACCTGGGA,0,1567434
galEp3,0.024390243902439025,40,40,CTTTCATGTCATGTGGGAAG,0,1555264
galEp3,0.024390243902439025,40,40,CTTGGCTAGATAGGCAGCAG,0,1571356
galEp3,0.024390243902439025,40,40,CCGCCAAGCGCTGCTGAAAT,0,1549219
galEp3,0.024390243902439025,40,40,CAGAAACAAGTTCAGTGTAT,0,1562231
galEp3,0.024390243902439025,40,40,CAATTCTGTCTTAATGCTGT,0,1555346
galEp3,0.024390243902439025,40,40,AGGCGCAGCAGACTCCGTCG,0,1565689
galEp3,0.024390243902439025,40,40,ACGTAGATGGTCGAAGCATT,0,1554800
galEp3,0.024390243902439025,40,40,ACGTAGAGGATCCAAGATAA,0,1583621
galEp3,0.024390243902439025,40,40,ACCACCCATAGGTCAAGCGT,0,1568294
galEp3,0.025,39,39,TCTGAGGCGGAGAATAACTA,0,1557602
galEp3,0.025,39,39,TCGTAAGTTCAGCCTGTCAA,0,1590303
galEp3,0.025,39,39,TCAGTTAACGGAGATTTTTA,0,1547022
galEp3,0.025,39,39,TCACCGGCCTGGTTTAGGTG,0,1547541
galEp3,0.025,39,39,TAGGCTGTAGGCCTTTTATA,0,1548252
galEp3,0.025,39,39,GTTTCCTTGGATCGATCACA,0,1555550
galEp3,0.025,39,39,GTCTATCGTCTACGGGATTA,0,1566761
galEp3,0.025,39,39,GGCAATATAATTCCGGAAGT,0,1555800
galEp3,0.025,39,39,GCCCCGTGACCTTTGATCGT,0,1574231
galEp3,0.025,39,39,CCGTCAGTGTGAACCGAGTA,0,1581701
galEp3,0.025,39,39,AAACTCACACTTAAAAGCTC,0,1584370
galEp3,0.02564102564102564,38,38,TTAGGTCAGTTAACGGGTTT,0,1585874
galEp3,0.02564102564102564,38,38,TCCGTGCCAGTACCGAACGC,0,1570726
galEp3,0.02564102564102564,38,38,TACCGGAGTTCGACCAGTAC,0,1574408
galEp3,0.02564102564102564,38,38,TAACGGTCCCCGAAAAGCAT,0,1586184
galEp3,0.02564102564102564,38,38,GTCAGTCGCGATGAACCCGA,0,1566986
galEp3,0.02564102564102564,38,38,GGTCCACCGAGGTTGTTTGC,0,1569969
galEp3,0.02564102564102564,38,38,GCCGCTCTTGGTTCCGAGGT,0,1568336
galEp3,0.02564102564102564,38,38,GCACGAACTTGTAGCGGCGT,0,1561475
galEp3,0.02564102564102564,38,38,GAAAGGGTCTTTCGGAGATC,0,1584982
galEp3,0.02564102564102564,38,38,CTGGCGCGACTCTGGTTGAA,0,1549934
galEp3,0.02564102564102564,38,38,CTCCACGGTTGAAGAACTCG,0,1551002
galEp3,0.02564102564102564,38,38,CCTGGCGACTATACGATTTC,0,1572679
galEp3,0.02564102564102564,38,38,CAAGTCGGCTGTGAGCCTAC,0,1576622
galEp3,0.02564102564102564,38,38,ATTCCTGAGCAAGGCCGGAT,0,1582124
galEp3,0.02564102564102564,38,38,ATTCAGTGATCCGTGACACT,0,1550134
galEp3,0.02564102564102564,38,38,AGCCCGGATGCGGTGAACGT,0,1554319
galEp3,0.02564102564102564,38,38,ACAGTCTAAGACACCGCAAA,0,1564758
galEp3,0.02564102564102564,38,38,AAGAGGTCACTCGGAGTTTA,0,1576586
galEp3,0.02631578947368421,37,37,TTTCTGCAATACTCAAGACT,0,1552730
galEp3,0.02631578947368421,37,37,TTCCACTAGGAGGTTGTTTG,0,1560701
galEp3,0.02631578947368421,37,37,TGTTGCCACGTTCCTTAAAG,0,1558450
galEp3,0.02631578947368421,37,37,TCCAGCACATCCCGATTCTT,0,1594788
galEp3,0.02631578947368421,37,37,TCAGCCGTATAGAGCATAGG,0,1591343
galEp3,0.02631578947368421,37,37,TAGATCTTGCCTACTTCGAC,0,1575914
galEp3,0.02631578947368421,37,37,GTACGTAGGAATGTATATCG,0,1561182
galEp3,0.02631578947368421,37,37,GGGACCTGGCTCGGTCCCAT,0,1587746
galEp3,0.02631578947368421,37,37,GCCGGCCCTCCCATGGGGAA,0,1552888
galEp3,0.02631578947368421,37,37,GCATTTCGGTCCTCGTCCTG,0,1575803
galEp3,0.02631578947368421,37,37,GACGCCAGAGGATCTGGTAC,0,1550467
galEp3,0.02631578947368421,37,37,CTTCGGATTGCGAGCAGCTT,0,1560113
galEp3,0.02631578947368421,37,37,CGGTCCGTAGACCGCACTTG,0,1548501
galEp3,0.02631578947368421,37,37,CGGGAGCCTACAGAGATTTA,0,1565980
galEp3,0.02631578947368421,37,37,CATATGCTCCCTGTAAGGCC,0,1549414
galEp3,0.02631578947368421,37,37,CAGTGACCGCTTACCGCATA,0,1569907
galEp3,0.02631578947368421,37,37,CAGGCTTGGGTATGTGGACT,0,1558765
galEp3,0.02631578947368421,37,37,AGTCGATCATGTGGTTGGTG,0,1546594
galEp3,0.02631578947368421,37,37,AGTCAGACTGTGCAGGCACA,0,1551654
galEp3,0.02631578947368421,37,37,AGATCCAGGTCTTTAAAACA,0,1581517
galEp3,0.02631578947368421,37,37,ACTGTACTTGGCCAGGTCCA,0,1553654
galEp3,0.02631578947368421,37,37,ACAGCTTGGTTTTCCTGAAC,0,1548470
galEp3,0.02631578947368421,37,37,ACAACAACCCGAGAGACCTA,0,1569592
galEp3,0.02631578947368421,37,37,AACACCCTGGTACATAGTGT,0,1575857
galEp3,0.02631578947368421,37,37,AAACGGCTCCATATCTCGTA,0,1590087
galEp3,0.02631578947368421,37,37,AAACCTAAGCGATGGACCCG,0,1577446
galEp3,0.02702702702702703,36,36,TTTAGGGGTGGGCCAATGGT,0,1585514
galEp3,0.02702702702702703,36,36,TGTTGCTAGTGCAGTCGTAA,0,1591681
galEp3,0.02702702702702703,36,36,TGGTGGCTACGGTGTTTTAG,0,1587337
galEp3,0.02702702702702703,36,36,TGCGCTTATTGACTACAGCG,0,1574258
galEp3,0.02702702702702703,36,36,TGCAGAGGTGAGCTCGTGTA,0,1548502
galEp3,0.02702702702702703,36,36,TCGGTAGCCGTAAAGATATG,0,1560397
galEp3,0.02702702702702703,36,36,TACCATAGGCTTTTGTAATC,0,1551946
galEp3,0.02702702702702703,36,36,GTATGGGTAATATGTCATTC,0,1556940
galEp3,0.02702702702702703,36,36,GGGTACTACTCCTTAGATGT,0,1548214
galEp3,0.02702702702702703,36,36,GGAGGGGGTCCCGGAGCAAA,0,1565879
galEp3,0.02702702702702703,36,36,CTATCCCAACAACACCTCAC,0,1560020
galEp3,0.02702702702702703,36,36,CGGGGTGCCCGGGCCGCGGA,0,1553630
galEp3,0.02702702702702703,36,36,CGCGAAGGAGGTACGGTTGA,0,1557016
galEp3,0.02702702702702703,36,36,CACAAGTGGCAAGAAGGAGG,0,1565373
galEp3,0.02702702702702703,36,36,ATCTCGCATACCCGTTCAAT,0,1568572
galEp3,0.02702702702702703,36,36,AGCTGAGTGATTCCCGCGTT,0,1571493
galEp3,0.02702702702702703,36,36,AGAGCATATGACGGAGCCAA,0,1593976
galEp3,0.02702702702702703,36,36,AGACCGCTCACCTTGCGTAG,0,1552880
galEp3,0.02702702702702703,36,36,ACGGGGGCGCGTACACCGGG,0,1563347
galEp3,0.02702702702702703,36,36,ACAAGGTGAAGTCGTCGTAG,0,1578233
galEp3,0.02702702702702703,36,36,AAGACCAGCAGACCGTAGGT,0,1547596
galEp3,0.027777777777777776,35,35,TGGAGCCGGCCGATTGCCTT,0,1574041
galEp3,0.027777777777777776,35,35,TGCGATGATCCCGCGTTATT,0,1577462
galEp3,0.027777777777777776,35,35,TGAGGGAACTCGGCGTGGGG,0,1549288
galEp3,0.027777777777777776,35,35,TGAGAGGCCGGACAGTGGTA,0,1566809
galEp3,0.027777777777777776,35,35,TCTTAGCTTCATCCGCGATA,0,1558286
galEp3,0.027777777777777776,35,35,TAAAGGATTTTTTGGAGACA,0,1563605
galEp3,0.027777777777777776,35,35,GTTACCGGACCGTTAGCGGT,0,1568037
galEp3,0.027777777777777776,35,35,GGCCAATCTGAGTCAGAATA,0,1562837
galEp3,0.027777777777777776,35,35,GGCACAACGATACGATACCA,0,1579708
galEp3,0.027777777777777776,35,35,GCTACTGCGCCTGCGCGCAA,0,1562235
galEp3,0.027777777777777776,35,35,CTGGGCTACGCTCGCGTCAA,0,1550630
galEp3,0.027777777777777776,35,35,CGCGCAAAAAAATTCTCACA,0,1572289
galEp3,0.027777777777777776,35,35,ATCTGAAGGTAGCATACGGC,0,1582915
galEp3,0.027777777777777776,35,35,AGGAACAGACAGGAACGGCT,0,1552838
galEp3,0.027777777777777776,35,35,ACTCAGTGGGCAAGCAGTTA,0,1569802
galEp3,0.027777777777777776,35,35,ACGGCCCAAGACCAAGAAAG,0,1575802
galEp3,0.027777777777777776,35,35,ACCTGTATGGTTATGGTACG,0,1551345
galEp3,0.02857142857142857,34,34,TGCCACCTCCCTACACAAAT,0,1567997
galEp3,0.02857142857142857,34,34,TCTGCAGCTAATACGCTAGA,0,1559909
galEp3,0.02857142857142857,34,34,TCAAATTTTGCTTTGTGATA,0,1566076
galEp3,0.02857142857142857,34,34,TAGGTTTTGTCTGGGGCCAA,0,1573284
galEp3,0.02857142857142857,34,34,GTTGGGGACGTGGTCACGCA,0,1577706
galEp3,0.02857142857142857,34,34,GTGGGGAGACATAATCGACT,0,1563912
galEp3,0.02857142857142857,34,34,GTCCGATCAACATGGCGTCA,0,1557582
galEp3,0.02857142857142857,34,34,GGTCCGGGTCCCACTCATTA,0,1547267
galEp3,0.02857142857142857,34,34,GGGTCCCTAGCGGAACCGCA,0,1583249
galEp3,0.02857142857142857,34,34,GGCCCGGTATTGTCTGGGGC,0,1564653
galEp3,0.02857142857142857,34,34,GCTGTCTCTGCGTTCAGGTA,0,1563775
galEp3,0.02857142857142857,34,34,GCTCACGGTTCGGGAATGCA,0,1565381
galEp3,0.02857142857142857,34,34,GCGGCAGCAAACGCGCTTCT,0,1571486
galEp3,0.02857142857142857,34,34,GCAATCAGTAGACGTTTTAT,0,1571754
galEp3,0.02857142857142857,34,34,GATGTGGAACGATAGGGAGA,0,1551166
galEp3,0.02857142857142857,34,34,GAGATAAAAAGGCTTGGCAG,0,1570845
galEp3,0.02857142857142857,34,34,CTGTTATGTAATTAAGCACC,0,1555401
galEp3,0.02857142857142857,34,34,CTGTAGGTAACATAAGGAAG,0,1562883
galEp3,0.02857142857142857,34,34,CTGGGGATTGAAGTCTCCCA,0,1566233
galEp3,0.02857142857142857,34,34,CTCCGAGGGACGATACGGGT,0,1590708
galEp3,0.02857142857142857,34,34,CTAGCGCGCGCCTGCAATAG,0,1566079
galEp3,0.02857142857142857,34,34,CTAGCAGTAAGGTGATAAAA,0,1584430
galEp3,0.02857142857142857,34,34,CGTGTTCGGGCCAGTACAGA,0,1566759
galEp3,0.02857142857142857,34,34,CCTGCCACAACGTGTGCAGA,0,1561448
galEp3,0.02857142857142857,34,34,ATGGTTGGGGGCTTTTAGGC,0,1580949
galEp3,0.02857142857142857,34,34,ATGCGCCAGGATGAGGCTAT,0,1554615
galEp3,0.02857142857142857,34,34,ATAGCCGACGCGGAAGCCGC,0,1593982
galEp3,0.02857142857142857,34,34,AGTGGCATAGTGCCTTCAGT,0,1594123
galEp3,0.02857142857142857,34,34,AGAGTGATGTAAGTTCACTT,0,1565996
galEp3,0.02857142857142857,34,34,ACACCCCTGATATAAATCAC,0,1560642
galEp3,0.02857142857142857,34,34,AAGCCTAGTGTCGATGATTT,0,1577562
galEp3,0.029411764705882353,33,33,TTGCTACAAGTATCGGCCCA,0,1551217
galEp3,0.029411764705882353,33,33,TTGACCTTGAAGTGCGTAGG,0,1579161
galEp3,0.029411764705882353,33,33,TCGCCGGATCTACGTCTCGA,0,1555749
galEp3,0.029411764705882353,33,33,TCATAGGCTCCTGCGCTGAA,0,1568496
galEp3,0.029411764705882353,33,33,TCAAGGCACATTCGGCGTGA,0,1564246
galEp3,0.029411764705882353,33,33,TAAAGCGTCCTTTGGGATCC,0,1550056
galEp3,0.029411764705882353,33,33,GTTGCCTGAATGCGATCCCA,0,1548247
galEp3,0.029411764705882353,33,33,GTCAGCGCGTGGTTACAAAA,0,1563138
galEp3,0.029411764705882353,33,33,GCCCGTGCCGAAAGGATGGG,0,1547918
galEp3,0.029411764705882353,33,33,GCAGGACAGCGAGGACAAGG,0,1551275
galEp3,0.029411764705882353,33,33,GAGATGATCGTGGAGTCAAC,0,1564587
galEp3,0.029411764705882353,33,33,GACAAGTCCATACTGGGATT,0,1562869
galEp3,0.029411764705882353,33,33,CGGGTTTAATATCTTCATGG,0,1563341
galEp3,0.029411764705882353,33,33,CGGGATCAATCAGCGACATA,0,1556835
galEp3,0.029411764705882353,33,33,CGCTACGTAGCAAGCTCAGT,0,1568234
galEp3,0.029411764705882353,33,33,CCAGATCGGATTACACATGT,0,1560343
galEp3,0.029411764705882353,33,33,CCACGTATAGTAGATAATGT,0,1572233
galEp3,0.029411764705882353,33,33,CACCACAGTTGTTCGATCCC,0,1550734
galEp3,0.029411764705882353,33,33,CAACCCTGAGCATTTAACGT,0,1572744
galEp3,0.029411764705882353,33,33,AGTTTAATGGAACTGCATAT,0,1549118
galEp3,0.029411764705882353,33,33,AGTCACGAGCCATCCGCCTG,0,1583703
galEp3,0.029411764705882353,33,33,AGCCACAACGAAACGAACCC,0,1572040
galEp3,0.029411764705882353,33,33,ACACTTACGTTCAGGCATCT,0,1582905
galEp3,0.029411764705882353,33,33,AATACCCGGCATCCGTCGGA,0,1550644
galEp3,0.029411764705882353,33,33,AAGAGTGTCGTATATTTTCA,0,1573039
galEp3,0.029411764705882353,33,33,AAGAGTCCTCATCAATACTA,0,1584707
galEp3,0.030303030303030304,32,32,TTGCATATCGCCAGGCAAAA,0,1589032
galEp3,0.030303030303030304,32,32,TTAACCGATTTCGTAGTGTT,0,1551027
galEp3,0.030303030303030304,32,32,TGGATGGCGACTCCTTGTTG,0,1563606
galEp3,0.030303030303030304,32,32,TGAGCATACCTTCTATGTCG,0,1573219
galEp3,0.030303030303030304,32,32,TGAGATAGTGGCTGCGATAC,0,1576674
galEp3,0.030303030303030304,32,32,TCGGTTTGTTTTCCATGCCA,0,1561281
galEp3,0.030303030303030304,32,32,TCCACGCTCAGCCTTCGAAA,0,1554422
galEp3,0.030303030303030304,32,32,TCAGTCGCCCGTAAAAATTG,0,1555464
galEp3,0.030303030303030304,32,32,TAGGATCGCATAGAACGGGT,0,1548101
galEp3,0.030303030303030304,32,32,TAGATGGGATTCCAAAGTAT,0,1548897
galEp3,0.030303030303030304,32,32,TAAGACATCAGCGGGGGTTG,0,1585869
galEp3,0.030303030303030304,32,32,GTAGTCGCTATAGTTACAAA,0,1554366
galEp3,0.030303030303030304,32,32,GGTTGTAAGTCTTGATAGGT,0,1587487
galEp3,0.030303030303030304,32,32,GGTGCGACCTTGGACCCGCA,0,1575648
galEp3,0.030303030303030304,32,32,GGCTATCCGAAGACACCCAT,0,1552001
galEp3,0.030303030303030304,32,32,GGAGCTGACTCGCCTTCGGA,0,1556262
galEp3,0.030303030303030304,32,32,GGAACTGATCTACTAGAGAC,0,1549937
galEp3,0.030303030303030304,32,32,GCGTGGGAGTAGTCGGCGGG,0,1570266
galEp3,0.030303030303030304,32,32,GCGTGGATGGCGACGACGTC,0,1547989
galEp3,0.030303030303030304,32,32,GCGTCTCTAATTACGCGAGG,0,1571834
galEp3,0.030303030303030304,32,32,GACCCGTGCCGTACGTTGAC,0,1548393
galEp3,0.030303030303030304,32,32,CTCGAGATGCTCCTATGTAC,0,1557315
galEp3,0.030303030303030304,32,32,CGGCTACCGACATGTCCTTG,0,1572778
galEp3,0.030303030303030304,32,32,CGAGTACTTATGATTTGCAG,0,1558475
galEp3,0.030303030303030304,32,32,CGACAATCGCTCTCATCCAA,0,1566308
galEp3,0.030303030303030304,32,32,CCGCAGAAAAATTTCCCTCA,0,1564925
galEp3,0.030303030303030304,32,32,CACTCATGCGATCGTGAAAA,0,1562742
galEp3,0.030303030303030304,32,32,ATATAACAGAGTGGTAGCGT,0,1573213
galEp3,0.030303030303030304,32,32,AGGTGAACGTTTCAAGAACT,0,1583774
galEp3,0.030303030303030304,32,32,AGGGACAAATGCTCGCCCAT,0,1546821
galEp3,0.030303030303030304,32,32,AGAGAGATTGACTGGACTCA,0,1550615
galEp3,0.030303030303030304,32,32,ACTGGAGTCCGTCTAAACGA,0,1568989
galEp3,0.030303030303030304,32,32,ACCTAGGTGCTGTTCCACTA,0,1587106
galEp3,0.030303030303030304,32,32,AACGTATTAGTTGCACAGTT,0,1556870
galEp3,0.030303030303030304,32,32,AACCCCAGGGCTTACGCCAA,0,1568806
galEp3,0.030303030303030304,32,32,AAACTATGGACCAGGCTTCT,0,1546864
galEp3,0.03125,31,31,TTGTATGATGGTAAGCTTTA,0,1588630
galEp3,0.03125,31,31,TTGGTTGGTCGCCAACAAGG,0,1546547
galEp3,0.03125,31,31,TTGGTTATCCTGCTAAGCCT,0,1565640
galEp3,0.03125,31,31,TTCAATGTCCTACCCTGGCA,0,1563952
galEp3,0.03125,31,31,TGGGCTGGAAATGGTAAGTG,0,1559219
galEp3,0.03125,31,31,TGGGACGCTCTAGCTCGATG,0,1555792
galEp3,0.03125,31,31,TGATCCTCGTAGCCTGTAAA,0,1549291
galEp3,0.03125,31,31,TCTCCAGCCACCGTTGAATA,0,1581780
galEp3,0.03125,31,31,TATTTCTGCAGATGCTGTGT,0,1570497
galEp3,0.03125,31,31,TACTTATAGGGTACACGCCC,0,1552419
galEp3,0.03125,31,31,GTGGGGGGTAGGACGGCTGA,0,1565165
galEp3,0.03125,31,31,GTAGAAAGTTTGTTCCCAAT,0,1554278
galEp3,0.03125,31,31,GGGGCTCGTTATCGAGAGAT,0,1585785
galEp3,0.03125,31,31,GCCTCTGTCCCGGATTTAAT,0,1567805
galEp3,0.03125,31,31,GCCACGAGACTTACAGCCCC,0,1559316
galEp3,0.03125,31,31,GAGTCTGGGAATCGGCTAAT,0,1581241
galEp3,0.03125,31,31,GAGACTTTTAACGACCGGCC,0,1577624
galEp3,0.03125,31,31,GAAGGTTATACCGAACGAGG,0,1574346
galEp3,0.03125,31,31,GAACTGACGTCCGCCCCTGG,0,1575932
galEp3,0.03125,31,31,CTTTCCTTCCTAGGACTTCA,0,1553628
galEp3,0.03125,31,31,CTTGCGCTACCATGGTTCGT,0,1555196
galEp3,0.03125,31,31,CTAGAGGACAACCATGACTT,0,1559931
galEp3,0.03125,31,31,CTAAGAGGCTACAATGCTTC,0,1546573
galEp3,0.03125,31,31,CGTGGGGAGGCCTAAGCAGA,0,1584287
galEp3,0.03125,31,31,CGGAAGATTTAGTTCGCCGT,0,1559333
galEp3,0.03125,31,31,CGCCGCCCCAAGTCATGATA,0,1571045
galEp3,0.03125,31,31,CGCACGTGCCGCAACATCCA,0,1548894
galEp3,0.03125,31,31,CCTCACTGATAGGAGAATAT,0,1556385
galEp3,0.03125,31,31,CCCGGATAGCCACAGCTCTC,0,1587713
galEp3,0.03125,31,31,CCAATTGGGACTTCCAGTCT,0,1552654
galEp3,0.03125,31,31,CAGAATATAGGTATAATCCA,0,1556156
galEp3,0.03125,31,31,ATTGGCAACCAGTGATCAGT,0,1572591
galEp3,0.03125,31,31,ATTCGAGCTCGATGTGACAA,0,1579690
galEp3,0.03125,31,31,ATGCACGCGATCATCTCTGG,0,1558295
galEp3,0.03125,31,31,AGGCCCCATGAAATCAGATG,0,1587561
galEp3,0.03125,31,31,AGCCCTATAGCGTTGCTTCC,0,1563769
galEp3,0.03125,31,31,ACCCGGACTCATACCCGGGT,0,1548588
galEp3,0.03125,31,31,ACCATGGAAAGCTCGCATCC,0,1567871
galEp3,0.03125,31,31,AATTGATTACCACAGGCATA,0,1564078
galEp3,0.03125,31,31,AAAGATGTGGCGACCTCTAT,0,1566060
galEp3,0.03225806451612903,30,30,TGATGACGGAATAGATCACA,0,1575540
galEp3,0.03225806451612903,30,30,TCCGAATCTAAGGCTCAAGC,0,1575096
galEp3,0.03225806451612903,30,30,TCCCAGGAATCCAATAGGCA,0,1558244
galEp3,0.03225806451612903,30,30,TCAGTTCAGCACAACGTAGA,0,1549226
galEp3,0.03225806451612903,30,30,TATAGGCTCAAGATGGTGAA,0,1575880
galEp3,0.03225806451612903,30,30,TACGATGCTGCGACGATACG,0,1557970
galEp3,0.03225806451612903,30,30,GTCTTTCACAAAAGATAGGT,0,1553232
galEp3,0.03225806451612903,30,30,GTATCTAGGCCTGACTGCGT,0,1559443
galEp3,0.03225806451612903,30,30,GTAGTCGGGACCGGAAATGC,0,1555124
galEp3,0.03225806451612903,30,30,GGTGTGCTCTATTGTAGTGG,0,1582354
galEp3,0.03225806451612903,30,30,GGTACCAGGATTAAGGATCA,0,1570136
galEp3,0.03225806451612903,30,30,GGGAATGCTTGATGTAAGGA,0,1566522
galEp3,0.03225806451612903,30,30,GGCGGGTAGTGAAGGGTTTC,0,1576967
galEp3,0.03225806451612903,30,30,GGCCTATTGCCTGGACGTAT,0,1547026
galEp3,0.03225806451612903,30,30,GGAGAGTGACACATCCGAGC,0,1573758
galEp3,0.03225806451612903,30,30,GGAACGGAGGTTACTTGTTG,0,1557651
galEp3,0.03225806451612903,30,30,GCTCGTGTGCGCTCGATTAG,0,1563107
galEp3,0.03225806451612903,30,30,GCGCAACCGCAGTGTCTCAA,0,1584112
galEp3,0.03225806451612903,30,30,GCCTCATGTTGTTTAAGAGA,0,1561525
galEp3,0.03225806451612903,30,30,GCAGACGCATCTAACCGTAG,0,1573717
galEp3,0.03225806451612903,30,30,GATGTATTGCGGTCTTTAGA,0,1572441
galEp3,0.03225806451612903,30,30,GAGATGTGCCTTCAGTGTAG,0,1568997
galEp3,0.03225806451612903,30,30,GACCGCGACACTCTCTAATG,0,1559980
galEp3,0.03225806451612903,30,30,GACAGGGAGATCGGGAACAG,0,1591418
galEp3,0.03225806451612903,30,30,GACAAGGGTCCTACCTGTAC,0,1565485
galEp3,0.03225806451612903,30,30,GAAGGTATGGCTCTGGTCTA,0,1569844
galEp3,0.03225806451612903,30,30,CTGCCAGGCTGGTGGGAGTT,0,1554607
galEp3,0.03225806451612903,30,30,CTGAGCCGCTACCCGGCGTC,0,1566502
galEp3,0.03225806451612903,30,30,CTGAATAGTCTACCGCTGAC,0,1557163
galEp3,0.03225806451612903,30,30,CTAAGATTTTAGCACTACAT,0,1560494
galEp3,0.03225806451612903,30,30,CGGTTCGGGACCTGATGTAG,0,1574082
galEp3,0.03225806451612903,30,30,CGGCCACTCATCGTCTTAGT,0,1557057
galEp3,0.03225806451612903,30,30,CGGATGACCCACATTCCACT,0,1594679
galEp3,0.03225806451612903,30,30,CGGACGTTCTTGCGAACCCA,0,1577315
galEp3,0.03225806451612903,30,30,CGATGGACCGTGACATGTTT,0,1555782
galEp3,0.03225806451612903,30,30,CGACCTTAGAGTGCGCCTAA,0,1587620
galEp3,0.03225806451612903,30,30,CGACAACTCGGACACGTTTT,0,1593034
galEp3,0.03225806451612903,30,30,CCGGCTCTGGCCAACCTCAG,0,1565905
galEp3,0.03225806451612903,30,30,CCGCTATTCCGCGTCTACCA,0,1551219
galEp3,0.03225806451612903,30,30,CATATTAGTTCGCACGAATG,0,1550382
galEp3,0.03225806451612903,30,30,CACGACTTTAACTAGGCCTT,0,1573908
galEp3,0.03225806451612903,30,30,CACATAGAAAGGTGCCCGTA,0,1582873
galEp3,0.03225806451612903,30,30,CACACTCTGTCGCGTGTCGC,0,1552347
galEp3,0.03225806451612903,30,30,ATTGGAGACTTCACTTTATT,0,1589601
galEp3,0.03225806451612903,30,30,ATGGCGGCTGCCCATCGGCT,0,1573356
galEp3,0.03225806451612903,30,30,AGTTTAATTTTCGGGCCGCT,0,1555463
galEp3,0.03225806451612903,30,30,AGTCAATGTATTCCAGTAGG,0,1594106
galEp3,0.03225806451612903,30,30,AGGCGATTACCAGTTCCGTC,0,1556049
galEp3,0.03225806451612903,30,30,AGGCCAAACCAGGACTTGGA,0,1556270
galEp3,0.03225806451612903,30,30,AGCCCCGCATCCTCAGAAGC,0,1556561
galEp3,0.03225806451612903,30,30,AGAGGAGGTCTCAGACGTGA,0,1551951
galEp3,0.03225806451612903,30,30,ACCACTGAAATGCAGTAGGC,0,1553854
galEp3,0.03225806451612903,30,30,ACAGGGACTTCCCGGATCGA,0,1585212
galEp3,0.03225806451612903,30,30,ACAGGAGAGGGTAGACCCGA,0,1574556
galEp3,0.03225806451612903,30,30,ACAGACCCCACGCCCCACAG,0,1554507
galEp3,0.03225806451612903,30,30,AACCCATTAAAATCTCATTT,0,1567832
galEp3,0.03225806451612903,30,30,AACATTACGTCAGCTGTCGC,0,1585546
galEp3,0.03333333333333333,29,29,TTTCCAAAATCTCTTACCAA,0,1561253
galEp3,0.03333333333333333,29,29,TGATGTGTCTGCAGGTCACA,0,1565586
galEp3,0.03333333333333333,29,29,TCTGCCTGAGATACAAGACA,0,1575371
galEp3,0.03333333333333333,29,29,GTGACGCTTCGCGGCGACAC,0,1559796
galEp3,0.03333333333333333,29,29,GTCCGCCCTGACCATTGGAA,0,1547552
galEp3,0.03333333333333333,29,29,GTAGTGTGCTCCAGCATCCA,0,1562741
galEp3,0.03333333333333333,29,29,GGCGCTGGGAAGTGCTTCGG,0,1588972
galEp3,0.03333333333333333,29,29,GGATTCACATACTCGCAGAA,0,1573491
galEp3,0.03333333333333333,29,29,GGAGGTTGCGACTACTATGG,0,1591767
galEp3,0.03333333333333333,29,29,GCATATTTCGTCCCACCCGC,0,1574589
galEp3,0.03333333333333333,29,29,GACCCGCTCTATGAGTAGTG,0,1552841
galEp3,0.03333333333333333,29,29,GAACGGTCCCATCAGCGGGA,0,1551935
galEp3,0.03333333333333333,29,29,CTTTATTAAGGGATCACTTT,0,1562882
galEp3,0.03333333333333333,29,29,CTGTAAAGCGCTGTGCTTTA,0,1559515
galEp3,0.03333333333333333,29,29,CGGAATCAGGATACACAATA,0,1551612
galEp3,0.03333333333333333,29,29,CGCGCAAGCCTACGGCGATG,0,1579095
galEp3,0.03333333333333333,29,29,CGATTTTGACGTCTAGTCGT,0,1554875
galEp3,0.03333333333333333,29,29,CGATAGTACGACCTGCTTTA,0,1581850
galEp3,0.03333333333333333,29,29,CCAAACAACGTTCCTAGTGA,0,1547243
galEp3,0.03333333333333333,29,29,CATGAAGAGTCACCGCGACT,0,1558369
galEp3,0.03333333333333333,29,29,CAGCAATCGGCGTGGCACGG,0,1576829
galEp3,0.03333333333333333,29,29,CAGAATGGCAAGCCCGCTAA,0,1550287
galEp3,0.03333333333333333,29,29,CACCAACGACACCATATCAT,0,1575543
galEp3,0.03333333333333333,29,29,CAACTCGCAATAGACGACTT,0,1558146
galEp3,0.03333333333333333,29,29,ATTATTTCAGCATCATTGTG,0,1554713
galEp3,0.03333333333333333,29,29,ATGCGGAGCGCGCTCCAGAA,0,1589463
galEp3,0.03333333333333333,29,29,ATGAACGAGGTTAACAGACC,0,1583360
galEp3,0.03333333333333333,29,29,ATAACGGGGAGGGCGGATAA,0,1574974
galEp3,0.03333333333333333,29,29,AGTTTGTTTTCTTGGTGTAT,0,1591316
galEp3,0.03333333333333333,29,29,AGTGTTAAAATTGTAACATT,0,1587968
galEp3,0.03333333333333333,29,29,AGGCCTCCGTGTACGTACTA,0,1574259
galEp3,0.03333333333333333,29,29,AGGATGTGGGGAACGAAAGT,0,1554533
galEp3,0.03333333333333333,29,29,AGCCTGGCTCAAGATGGCCT,0,1555609
galEp3,0.03333333333333333,29,29,AGAGGACAGGCAAGTTGAAG,0,1568285
galEp3,0.03333333333333333,29,29,ACGGTCCTAACGGGCTAGAA,0,1547540
galEp3,0.03333333333333333,29,29,ACGGAAATACGTTGGGCCGT,0,1551065
galEp3,0.03333333333333333,29,29,ACCACTGAGTACAACATATA,0,1581407
galEp3,0.03333333333333333,29,29,AAGTCTAAAACATGGTTAGT,0,1563710
galEp3,0.03333333333333333,29,29,AACGTACCGGCTCCATAAGC,0,1565760
galEp3,0.03333333333333333,29,29,AAACGGTGGGACATACTGAA,0,1581744
galEp3,0.034482758620689655,28,28,TTTAGAGTTCCGTGCAAGCT,0,1582775
galEp3,0.034482758620689655,28,28,TTAATTCTTACAGAGGGGAT,0,1547830
galEp3,0.034482758620689655,28,28,TTAAAAGGCGGGATGAAACT,0,1554581
galEp3,0.034482758620689655,28,28,TGAATAGATATCTGAGAATA,0,1546657
galEp3,0.034482758620689655,28,28,TCGGGTAGCCGTGTTGATCA,0,1570569
galEp3,0.034482758620689655,28,28,TCATGTCGTCAGGTCCCATT,0,1559392
galEp3,0.034482758620689655,28,28,TATGGTCGTTCGAGAAGGGT,0,1568227
galEp3,0.034482758620689655,28,28,GTTATCAGCGCATTAAGCAA,0,1577451
galEp3,0.034482758620689655,28,28,GTTAAGGTTTGCAGCGACCA,0,1562986
galEp3,0.034482758620689655,28,28,GTGGGGGCGGCTAGACTCTT,0,1570539
galEp3,0.034482758620689655,28,28,GTGCTTGACAGGGGCAGGTA,0,1570846
galEp3,0.034482758620689655,28,28,GTGACCAGATTAGGGCTATA,0,1590788
galEp3,0.034482758620689655,28,28,GGTTTAGAGAGGTATGGGTC,0,1563630
galEp3,0.034482758620689655,28,28,GCTAGTTTCGTCTCAAGTTT,0,1549060
galEp3,0.034482758620689655,28,28,GCGCGGATTACAGGGCCACT,0,1549629
galEp3,0.034482758620689655,28,28,GCACGAAGCCAAGCGTCAGG,0,1558444
galEp3,0.034482758620689655,28,28,GCACCACGCCCCACGCGCTG,0,1569205
galEp3,0.034482758620689655,28,28,GAGTTGACGTCTGTGGCCGT,0,1551589
galEp3,0.034482758620689655,28,28,GACCAGAATTCTGGTCTATC,0,1573146
galEp3,0.034482758620689655,28,28,GAAAAGTATAAACTATCCGT,0,1585277
galEp3,0.034482758620689655,28,28,CTTGGGGGCTTGAACGGGTC,0,1585440
galEp3,0.034482758620689655,28,28,CTGATAGTACATATGGGACT,0,1561587
galEp3,0.034482758620689655,28,28,CTCCCGGTGGACCCTTAGTA,0,1556535
galEp3,0.034482758620689655,28,28,CTCAAGGCTCCAGGTGGACG,0,1553516
galEp3,0.034482758620689655,28,28,CTAGGTGTCCTTGAGTACAG,0,1552354
galEp3,0.034482758620689655,28,28,CGGACGCCAAAACTCAGGTA,0,1574521
galEp3,0.034482758620689655,28,28,CGCTCAACCTCAACCCGTGT,0,1551479
galEp3,0.034482758620689655,28,28,CGAGTGAGGATCGCCATCGC,0,1571121
galEp3,0.034482758620689655,28,28,CCCAATACGGTGACGTTTCT,0,1550093
galEp3,0.034482758620689655,28,28,CATTACCGGGACTTGAATGC,0,1560365
galEp3,0.034482758620689655,28,28,CACTTTTAGACGCTCTCACG,0,1560644
galEp3,0.034482758620689655,28,28,CACCGTTCCCGCTTGCAGCC,0,1575248
galEp3,0.034482758620689655,28,28,CACCATGCTACTTACGTTGT,0,1562586
galEp3,0.034482758620689655,28,28,CAAAATGTACCGCCTCTGTT,0,1579996
galEp3,0.034482758620689655,28,28,ATTCACCTTGGATTTCTACC,0,1550572
galEp3,0.034482758620689655,28,28,ATGGCACAATGCTTTCCATA,0,1572138
galEp3,0.034482758620689655,28,28,ATGCGCTGAGCAAACGGGCA,0,1582904
galEp3,0.034482758620689655,28,28,ATCCAGGGTGACCGTAACCC,0,1576295
galEp3,0.034482758620689655,28,28,ATCACAGCGTGTGGGTACGG,0,1559412
galEp3,0.034482758620689655,28,28,AGCGTACGTACGATTGAAAT,0,1550894
galEp3,0.034482758620689655,28,28,AGATTTAAGAGGTGCGATAT,0,1552830
galEp3,0.034482758620689655,28,28,AGATAGTCTTGTTTAGCGGA,0,1581451
galEp3,0.034482758620689655,28,28,ACTTGGATTCGCGGGCCGTC,0,1587976
galEp3,0.034482758620689655,28,28,ACTGAGAGGCACTGATTAAC,0,1555656
galEp3,0.034482758620689655,28,28,ACGTTCTTCTATCCAGCCAG,0,1563257
galEp3,0.034482758620689655,28,28,ACAGGCAGTGATAAATCTTG,0,1552059
galEp3,0.034482758620689655,28,28,AACTTGTGTCACTGAACCTA,0,1573772
galEp3,0.034482758620689655,28,28,AACGCTCTTCAAGACGGTGA,0,1575008
galEp3,0.034482758620689655,28,28,AACCGCGGTCCTTACAAACA,0,1553114
galEp3,0.034482758620689655,28,28,AACCCGCATACGAAGTCAAT,0,1561858
galEp3,0.034482758620689655,28,28,AAAGAACTGAGCGAATACAC,0,1574006
galEp3,0.03571428571428571,27,27,TTCGATCAACGATCTCGCTC,0,1582410
galEp3,0.03571428571428571,27,27,TTATTTTTACCGCCATGAAT,0,1573971
galEp3,0.03571428571428571,27,27,TTACTGGCGGTCAGCGGTGT,0,1573754
galEp3,0.03571428571428571,27,27,TGTAGGAAATAGGGTAGTGT,0,1590835
galEp3,0.03571428571428571,27,27,TCAATGAGGGGTGCACGAGT,0,1571268
galEp3,0.03571428571428571,27,27,TCAACACCTGGCATTAACCA,0,1561025
galEp3,0.03571428571428571,27,27,TATGTAGACAGGCGGCCACC,0,1561620
galEp3,0.03571428571428571,27,27,TATGGCCTGGGACCGGCATT,0,1557122
galEp3,0.03571428571428571,27,27,TATCGGACGTCGGTACGTCT,0,1552966
galEp3,0.03571428571428571,27,27,TACTACCAGATAGACCCTAA,0,1587197
galEp3,0.03571428571428571,27,27,TACCCTTGAAGATACGAAGA,0,1567942
galEp3,0.03571428571428571,27,27,TAATAAACTAGAGCCCCGTT,0,1558438
galEp3,0.03571428571428571,27,27,GTCAGAATTAAAACCTACCT,0,1592322
galEp3,0.03571428571428571,27,27,GTATGCGCCCGTTGTGATTG,0,1552516
galEp3,0.03571428571428571,27,27,GGTGACCGAAAGGGCAACCA,0,1575898
galEp3,0.03571428571428571,27,27,GGTCGCTGCATACCAACCAG,0,1558018
galEp3,0.03571428571428571,27,27,GGAATTGTGGCGCTATGCTA,0,1554009
galEp3,0.03571428571428571,27,27,GCCTATAAACTCCGACCCAT,0,1588099
galEp3,0.03571428571428571,27,27,GCCGACATTAGGCATGTGTT,0,1553711
galEp3,0.03571428571428571,27,27,GAATAGGGTCGTGAGACTTA,0,1564683
galEp3,0.03571428571428571,27,27,CTTGCGGTACGAGGCGATCA,0,1568513
galEp3,0.03571428571428571,27,27,CTTGATACCATCCGTGAACC,0,1589351
galEp3,0.03571428571428571,27,27,CTTGACTGTTGCGGATGTTG,0,1555700
galEp3,0.03571428571428571,27,27,CTTCTTAACAGGACGTCGAA,0,1565458
galEp3,0.03571428571428571,27,27,CTTCCACAAACCCCTTGCAT,0,1574779
galEp3,0.03571428571428571,27,27,CTTATGGTTTCTCTCGGTTA,0,1549145
galEp3,0.03571428571428571,27,27,CTTAACGTGTGTGCAAGTTG,0,1580584
galEp3,0.03571428571428571,27,27,CTGAACAACATCTAACGCTA,0,1551146
galEp3,0.03571428571428571,27,27,CGCTATTGTCTGCAGTCGCT,0,1578185
galEp3,0.03571428571428571,27,27,CGCAAATTAGGGGAATACGG,0,1574292
galEp3,0.03571428571428571,27,27,CCTGGCAACGGGCGTGTAGA,0,1563584
galEp3,0.03571428571428571,27,27,CCGATCAGGAGATGTAGCTA,0,1561459
galEp3,0.03571428571428571,27,27,CCCAGCCAAGTTCGCTCTTC,0,1551585
galEp3,0.03571428571428571,27,27,CCCACATTAGAGTGTACGGG,0,1547784
galEp3,0.03571428571428571,27,27,CCAGACGCACACGTAGGATA,0,1552028
galEp3,0.03571428571428571,27,27,CATCCTTCTTTCGTAGGTCA,0,1557534
galEp3,0.03571428571428571,27,27,CATAGGTAAAATAGCGATGT,0,1550497
galEp3,0.03571428571428571,27,27,CAGCGTAGGCGGCTGGCACG,0,1588424
galEp3,0.03571428571428571,27,27,CACAGCGCAAGCGGAGTCCA,0,1557938
galEp3,0.03571428571428571,27,27,CAACCGTACTGCACGGTAAA,0,1589474
galEp3,0.03571428571428571,27,27,ATTCTGATCTAAAGGGCTTT,0,1557932
galEp3,0.03571428571428571,27,27,ATGATGGGCACGCATCAAAC,0,1555902
galEp3,0.03571428571428571,27,27,ATAGTCCGACTTTGCGATAC,0,1569201
galEp3,0.03571428571428571,27,27,ATACTAAATGCTAGATCAAG,0,1581624
galEp3,0.03571428571428571,27,27,AGTTGTGCCAATATGGCCTG,0,1551147
galEp3,0.03571428571428571,27,27,AGTAAGATCTCTGTCGGATC,0,1561501
galEp3,0.03571428571428571,27,27,AGGGATCTGTGCGGTCAACA,0,1584269
galEp3,0.03571428571428571,27,27,AGGCATTACGAATACGGCAG,0,1552195
galEp3,0.03571428571428571,27,27,AGCTCACCAATGTAAGATGT,0,1549494
galEp3,0.03571428571428571,27,27,AGCGCTGGACTGTTGCATGT,0,1554172
galEp3,0.03571428571428571,27,27,AGCCGTCGGGGCGGTATGAC,0,1576923
galEp3,0.03571428571428571,27,27,AGCCGCGGTGTGCGACTTTA,0,1589598
galEp3,0.03571428571428571,27,27,AGAATAAAGCGCCCAACAAA,0,1592682
galEp3,0.03571428571428571,27,27,ACGTCTACGGCTCGCGTTAT,0,1578848
galEp3,0.03571428571428571,27,27,ACAGGTCCTCGCCTTACGGT,0,1566462
galEp3,0.03571428571428571,27,27,ACACAGTACCTGCACCAAGG,0,1578844
galEp3,0.03571428571428571,27,27,AATGTGCGTATGTTCGGCTC,0,1550051
galEp3,0.03571428571428571,27,27,AATCAACATCTAACGGCGAC,0,1567348
galEp3,0.03571428571428571,27,27,AAAGACACTGGCACCCGGGA,0,1588740
galEp3,0.037037037037037035,26,26,TTGGGCGTCCTGTATGAGTC,0,1569515
galEp3,0.037037037037037035,26,26,TGTGGCGTCCCCTGTGAAGA,0,1575041
galEp3,0.037037037037037035,26,26,TGTGAGTTCAAGAACTATAA,0,1549217
galEp3,0.037037037037037035,26,26,TGTAAGGCGATCGTCTCCGA,0,1586912
galEp3,0.037037037037037035,26,26,TGGGCCAATACTATTCGTGT,0,1558024
galEp3,0.037037037037037035,26,26,TGGACGCTGCTTGGGCTAAT,0,1552331
galEp3,0.037037037037037035,26,26,TGAGGCTACCCTCATTCGCA,0,1553874
galEp3,0.037037037037037035,26,26,TCTGGTAAGAGTAATAGGCA,0,1578520
galEp3,0.037037037037037035,26,26,TCTGCAGACCGGAACGGTGT,0,1558755
galEp3,0.037037037037037035,26,26,TCAGCTAGTGTTGCCGCACT,0,1551973
galEp3,0.037037037037037035,26,26,TCACAAGTGGGCATTTTGGT,0,1554811
galEp3,0.037037037037037035,26,26,TATCTAGTGGATAGCTTATA,0,1547542
galEp3,0.037037037037037035,26,26,TATCAACAATCAGACCATAG,0,1585486
galEp3,0.037037037037037035,26,26,TACTATCAGTTCTTCCGTTT,0,1555643
galEp3,0.037037037037037035,26,26,TACAAGCTCCGCTTGGATAG,0,1576894
galEp3,0.037037037037037035,26,26,GTTGTCACCATATTGCAGAG,0,1548103
galEp3,0.037037037037037035,26,26,GTCTCTCCATCGTTTATTTA,0,1575597
galEp3,0.037037037037037035,26,26,GTAAAGCACGCAGCAAAATT,0,1561618
galEp3,0.037037037037037035,26,26,GGGCTAGCACGGAGACTCGG,0,1556052
galEp3,0.037037037037037035,26,26,GGCGGCCGGTCCGTGTCCAA,0,1558164
galEp3,0.037037037037037035,26,26,GCCAATAAAGATCTGGAGCA,0,1552772
galEp3,0.037037037037037035,26,26,GCATCAAACCAAAAGAGTGT,0,1571080
galEp3,0.037037037037037035,26,26,GATGTGCGGTTCCGACGCTA,0,1568987
galEp3,0.037037037037037035,26,26,GATCAAAAAGAATACAAATC,0,1575507
galEp3,0.037037037037037035,26,26,GACGAAAATGTCCGGTCGGT,0,1567954
galEp3,0.037037037037037035,26,26,GACCCGGCTTAGACGGGGAC,0,1551588
galEp3,0.037037037037037035,26,26,GACACCAGCCAGTCCCGCCA,0,1549723
galEp3,0.037037037037037035,26,26,GAACGACTATAACGCGATGG,0,1550095
galEp3,0.037037037037037035,26,26,GAACATCATACCGGAACCTC,0,1568637
galEp3,0.037037037037037035,26,26,CTGTTTCTGCAATTGAACGT,0,1552454
galEp3,0.037037037037037035,26,26,CTAGCCCCAGCTCAAGGAAT,0,1567831
galEp3,0.037037037037037035,26,26,CTACCCAGCGACCTTGCAAA,0,1577812
galEp3,0.037037037037037035,26,26,CGTTTAATGTAACCAGGCCA,0,1579497
galEp3,0.037037037037037035,26,26,CGTAATCGTCTGGTGTCACT,0,1568278
galEp3,0.037037037037037035,26,26,CGGTTGAGGGTAATGGACGT,0,1583385
galEp3,0.037037037037037035,26,26,CGGGCCTTCAAAGGTATCTC,0,1563423
galEp3,0.037037037037037035,26,26,CGCTCTGACTATTTCCAGGT,0,1565015
galEp3,0.037037037037037035,26,26,CGCGGGGGAGGTCGTGTCCA,0,1592709
galEp3,0.037037037037037035,26,26,CGCCCCGAAATTTGCGACAG,0,1564434
galEp3,0.037037037037037035,26,26,CGCATGACGACTTACGGAAA,0,1561166
galEp3,0.037037037037037035,26,26,CGAGTCTGATAAAATTGCGA,0,1585679
galEp3,0.037037037037037035,26,26,CGACAGCCAAGCCGTTTTTG,0,1560767
galEp3,0.037037037037037035,26,26,CCGTTCCTGGACCGGGACTC,0,1561109
galEp3,0.037037037037037035,26,26,CCGGTAAGAATCCTACGGAA,0,1577633
galEp3,0.037037037037037035,26,26,CCATTATCCTACCACTCCCC,0,1564214
galEp3,0.037037037037037035,26,26,CATTTCCAGAAGAAGGTTAC,0,1557285
galEp3,0.037037037037037035,26,26,CATTATGCTGCCATTTCGGA,0,1558084
galEp3,0.037037037037037035,26,26,CATCCATAGAGTCGGTAATA,0,1551104
galEp3,0.037037037037037035,26,26,CACTGTATCACTAATCGCGA,0,1561114
galEp3,0.037037037037037035,26,26,CAACCTAAGCCTCAAATCGG,0,1563815
galEp3,0.037037037037037035,26,26,CAAAGTGATACATCAGCCGA,0,1561422
galEp3,0.037037037037037035,26,26,ATGTCTGCCAGCTCCAACAC,0,1590899
galEp3,0.037037037037037035,26,26,ATGGGTAAGTCAGGCTCTTT,0,1573970
galEp3,0.037037037037037035,26,26,ATCTTTAGGTGTAATCAGGT,0,1564767
galEp3,0.037037037037037035,26,26,ATCCATAAGGGCATTTCGTA,0,1573355
galEp3,0.037037037037037035,26,26,ATAAATGCAGGTTGAATAGA,0,1587030
galEp3,0.037037037037037035,26,26,AGGTCGATCGACATTCCCGA,0,1574606
galEp3,0.037037037037037035,26,26,AGATCGGCACATAAACCTAC,0,1576747
galEp3,0.037037037037037035,26,26,AGAAGATCTATATACCGTGT,0,1552393
galEp3,0.037037037037037035,26,26,ACGTCAGGGGTACTGGTACA,0,1571270
galEp3,0.037037037037037035,26,26,ACCCGTCGTTGTTCTCACGT,0,1560741
galEp3,0.037037037037037035,26,26,ACATGCACCGGTTCGATTGT,0,1568978
galEp3,0.037037037037037035,26,26,AAGGCGAAGAGGCTGGGTAC,0,1551869
galEp3,0.037037037037037035,26,26,AAGACCCCTTGCCATTAACT,0,1566299
galEp3,0.037037037037037035,26,26,AACCAAGCGAAACAAAAGTC,0,1552881
galEp3,0.037037037037037035,26,26,AAATTTCTGAGGGGTTGAGT,0,1568571
galEp3,0.037037037037037035,26,26,AAAAGCCGCGATAAGAAAGC,0,1556833
galEp3,0.038461538461538464,25,25,TTCTGTGCTGGACGCCGATG,0,1579128
galEp3,0.038461538461538464,25,25,TTCCATTGCACTCGGGATAC,0,1582743
galEp3,0.038461538461538464,25,25,TTAACGGTAAGCCGATTTCT,0,1588562
galEp3,0.038461538461538464,25,25,TGTGGCCCCCAAGGGATTTT,0,1548043
galEp3,0.038461538461538464,25,25,TGGGTGCCACAGTCTCGCGT,0,1547347
galEp3,0.038461538461538464,25,25,TGGGGGAATGGGCGGTTTGT,0,1547632
galEp3,0.038461538461538464,25,25,TGGAGCGAAGGCTGAACTCA,0,1585980
galEp3,0.038461538461538464,25,25,TGACCTGATCACATTGTAAA,0,1555993
galEp3,0.038461538461538464,25,25,TCTCTTTCGATTTCTGGGAA,0,1546588
galEp3,0.038461538461538464,25,25,TCTACTGGACGAACAGGGAA,0,1569248
galEp3,0.038461538461538464,25,25,TCGGGGTGATACATACTTTC,0,1547019
galEp3,0.038461538461538464,25,25,TCGACTGTCCGGTGCAGAAT,0,1559982
galEp3,0.038461538461538464,25,25,TCGAAGCAGTTTTTAGCAGT,0,1592153
galEp3,0.038461538461538464,25,25,TCACAGTAAACTTGTGCTGA,0,1567946
galEp3,0.038461538461538464,25,25,TCAAGTAGTTCGAAGCTGAA,0,1558640
galEp3,0.038461538461538464,25,25,TATTCGCGATGGCTGTATTT,0,1592380
galEp3,0.038461538461538464,25,25,TATCAGAGCGACGGGTCAAG,0,1552101
galEp3,0.038461538461538464,25,25,GTTTAACGGTAATAAGTACG,0,1574042
galEp3,0.038461538461538464,25,25,GTGTTGAGGCTATCGGTCGT,0,1578516
galEp3,0.038461538461538464,25,25,GTGGGCGTAGTAAATTGCGA,0,1558211
galEp3,0.038461538461538464,25,25,GTGCTGGCGAGTCGCAAATA,0,1554716
galEp3,0.038461538461538464,25,25,GTCCCGTGTGCGACCACAGA,0,1570870
galEp3,0.038461538461538464,25,25,GTATTGCGCCAGCCTCGAGT,0,1573998
galEp3,0.038461538461538464,25,25,GTATACCCGTTTGACATTTT,0,1564080
galEp3,0.038461538461538464,25,25,GGTTGAACAGTGCTCGGCTG,0,1556406
galEp3,0.038461538461538464,25,25,GGTTACCCTTTTAGTCGCAT,0,1569155
galEp3,0.038461538461538464,25,25,GGTGCGTTCGGAGCTCACGG,0,1549698
galEp3,0.038461538461538464,25,25,GGGGAGTGTCAACCCGGTGG,0,1576328
galEp3,0.038461538461538464,25,25,GCGTCACAGGCTCGAAAGCA,0,1559572
galEp3,0.038461538461538464,25,25,GCCAACCATTATTATCAAAC,0,1581179
galEp3,0.038461538461538464,25,25,GCAAGAGCATTACTGTGGTG,0,1552513
galEp3,0.038461538461538464,25,25,GATCGGGATGATTTTACGAT,0,1575328
galEp3,0.038461538461538464,25,25,GACGCAGCTGTTGCGTTGCA,0,1583512
galEp3,0.038461538461538464,25,25,CTGGGGTGTCTCTTATCCTG,0,1584319
galEp3,0.038461538461538464,25,25,CTCCAACCTAGCCCCTAGGG,0,1576826
galEp3,0.038461538461538464,25,25,CTCATGCGGGCTCGCCGGTG,0,1586545
galEp3,0.038461538461538464,25,25,CTCATCACCGATAGAGACTG,0,1573135
galEp3,0.038461538461538464,25,25,CTAACAATTCTACACGCTAT,0,1578972
galEp3,0.038461538461538464,25,25,CGGTTTCCCATTTCTCAGGG,0,1553638
galEp3,0.038461538461538464,25,25,CGCACGCGACATGCCCGTGT,0,1590059
galEp3,0.038461538461538464,25,25,CGAAACTTCTCAACGTAATT,0,1546647
galEp3,0.038461538461538464,25,25,CCGTCAGCAAGAGCCCTGAG,0,1563858
galEp3,0.038461538461538464,25,25,CCGGCCAACAATCGGAGCGC,0,1581080
galEp3,0.038461538461538464,25,25,CCGGATCATTTAGCGCCATG,0,1588825
galEp3,0.038461538461538464,25,25,CCACACATCATACTCGATTA,0,1568517
galEp3,0.038461538461538464,25,25,CCAAGTAAGAAAAATAAGGA,0,1593733
galEp3,0.038461538461538464,25,25,CAATAGGGTTCCAGTCGGAA,0,1568756
galEp3,0.038461538461538464,25,25,ATTGGGGCGCGAACCATCAT,0,1555423
galEp3,0.038461538461538464,25,25,ATGGGAATTGTATTAGTCTT,0,1587624
galEp3,0.038461538461538464,25,25,ATGCGGCCCTAAGCTCCAAG,0,1552202
galEp3,0.038461538461538464,25,25,ATACCCCAGCAAATCAGGCT,0,1566835
galEp3,0.038461538461538464,25,25,AGTGGGAATCAACTACATCC,0,1585079
galEp3,0.038461538461538464,25,25,AGAATAAGTACACAGTGCGT,0,1546968
galEp3,0.038461538461538464,25,25,ACTTGTTCCAGTCCACATGA,0,1551519
galEp3,0.038461538461538464,25,25,ACTGCCTTCCCCAATCTAAT,0,1552749
galEp3,0.038461538461538464,25,25,ACTACAGCGGGCACTTGAAG,0,1563109
galEp3,0.038461538461538464,25,25,ACCGACGCTCGTCGGGATAG,0,1551226
galEp3,0.038461538461538464,25,25,AAGGGGCGTATGGGTAATGT,0,1570941
galEp3,0.038461538461538464,25,25,AACTTCATACCATTCAACGC,0,1581802
galEp3,0.038461538461538464,25,25,AACGTCCCATGCAGCATCTA,0,1560238
galEp3,0.038461538461538464,25,25,AAAGCCCCCGTCCTAACACA,0,1578841
galEp3,0.038461538461538464,25,25,AAAACCTGGGCGGTGAAGTC,0,1587340
galEp3,0.04,24,24,TTGGTGAACGATCTTAGAGC,0,1564206
galEp3,0.04,24,24,TTGGCGTCTACCTAATCGGT,0,1570270
galEp3,0.04,24,24,TTCTTTCGTCGCTCTACGTT,0,1557541
galEp3,0.04,24,24,TTCACGCCTGTATGCCACAA,0,1594868
galEp3,0.04,24,24,TTATTGTCTATTGATTAACG,0,1583362
galEp3,0.04,24,24,TGGTAGCCTCCAGCGCACTA,0,1561842
galEp3,0.04,24,24,TGCGCATCGAGTTGTAATTT,0,1560907
galEp3,0.04,24,24,TGAGAAGCTAGAACGTCGTC,0,1556965
galEp3,0.04,24,24,TCGGGCGTTGGTAATTTAAA,0,1566806
galEp3,0.04,24,24,TCCTGATAAACTATGCGGGG,0,1555010
galEp3,0.04,24,24,TCCGGAGGCTAAGTGGGTCA,0,1583902
galEp3,0.04,24,24,TCCGGACCACGAGGGTCGCA,0,1553727
galEp3,0.04,24,24,TCCCCGGTCCAAAGTCGCAG,0,1592992
galEp3,0.04,24,24,TAGCCGTTATGCCTATTTGG,0,1575966
galEp3,0.04,24,24,GTTCACGGAGTACTGTGTGA,0,1564498
galEp3,0.04,24,24,GTTAACGTCAACTTAGAGCG,0,1572198
galEp3,0.04,24,24,GTATGTGACTTGGGCGACGG,0,1582531
galEp3,0.04,24,24,GGTGTGAGACAGTTTGCACC,0,1577639
galEp3,0.04,24,24,GGTGAATCTAAGGTCTAAGA,0,1560587
galEp3,0.04,24,24,GGTATGTTGTTAGAGAAATC,0,1575204
galEp3,0.04,24,24,GGGATGGATTCTTCGGACAA,0,1589245
galEp3,0.04,24,24,GGGACTTCGAGTTGCGCCAT,0,1574680
galEp3,0.04,24,24,GGCACGGAAAGTGGAATACA,0,1588595
galEp3,0.04,24,24,GGACTGTATAGTAAAATTAT,0,1591370
galEp3,0.04,24,24,GGAACACGGCCGGAGGCTCA,0,1587969
galEp3,0.04,24,24,GCTAAACGGCAGCCGGAGCG,0,1563012
galEp3,0.04,24,24,GCGATCTTGCGGCAGGGTGA,0,1589241
galEp3,0.04,24,24,GCCGGAAGGTTATGGGGCTG,0,1566766
galEp3,0.04,24,24,GCCGCGCTCAGGGGCATGAC,0,1594708
galEp3,0.04,24,24,GCATCCGAGTCGGGCGCAAA,0,1567686
galEp3,0.04,24,24,GCAGGTTCGGATTGCAGATT,0,1556918
galEp3,0.04,24,24,GCAATTGGGATATTAGGTGC,0,1575680
galEp3,0.04,24,24,GATCCGTAGGAAGATTAGTA,0,1571662
galEp3,0.04,24,24,GAGTGCAACCATGAGGGAAC,0,1559798
galEp3,0.04,24,24,GAAGCAGTACGGTGGTTTTC,0,1566493
galEp3,0.04,24,24,GAAAGATGTCCCTGCCAGTA,0,1554588
galEp3,0.04,24,24,CTGTAGTCTCCGACGACAAA,0,1548245
galEp3,0.04,24,24,CTGGGGATTCGGATAAAGAT,0,1567535
galEp3,0.04,24,24,CTCTTGACTAAGCGAAGAGG,0,1566023
galEp3,0.04,24,24,CTCAGATGAGCTGACGCAAT,0,1569408
galEp3,0.04,24,24,CTAGGACGCTCTAGTTTGTT,0,1588381
galEp3,0.04,24,24,CTAACAAGCCGCATGCCATC,0,1587499
galEp3,0.04,24,24,CGGGCAATCTCGTCCACCAC,0,1558478
galEp3,0.04,24,24,CGGATGGTATTCCGAGTTAA,0,1568906
galEp3,0.04,24,24,CGCCTGGGCTACGTAGTGAG,0,1559259
galEp3,0.04,24,24,CGACGGCGCACGACCAAAAG,0,1585830
galEp3,0.04,24,24,CCTTGTGTTGCCTCCAATAA,0,1573006
galEp3,0.04,24,24,CCTTGGCGGTCAGGAGAGGT,0,1546545
galEp3,0.04,24,24,CCGGGCATGATTAAGCTTGG,0,1572500
galEp3,0.04,24,24,CCCCAACTAGCAAAATCCGT,0,1580875
galEp3,0.04,24,24,CCACTACACCCGTGATTCCT,0,1579131
galEp3,0.04,24,24,CATGCATATGCGGCAACATT,0,1579988
galEp3,0.04,24,24,CAGCACCACGTATATAACAT,0,1581448
galEp3,0.04,24,24,CACGCCGCGCTACTGATCTG,0,1586646
galEp3,0.04,24,24,CAAGGTCGTTTTCATCTGGT,0,1582109
galEp3,0.04,24,24,ATTTGAAGATCCTATAAAGG,0,1551231
galEp3,0.04,24,24,ATTTAAGCATCCTATGGAAA,0,1552852
galEp3,0.04,24,24,ATTGATCGCGATGGACCGTA,0,1582247
galEp3,0.04,24,24,ATGGTTTTGATTTCATGAAA,0,1557265
galEp3,0.04,24,24,ATGCCGTAACCCTGTAAACG,0,1575118
galEp3,0.04,24,24,ATCCGTAGTTGTTTTCGCTT,0,1558948
galEp3,0.04,24,24,ATCCCGACCTAGACTCTTCT,0,1562202
galEp3,0.04,24,24,AGTAGCATGGGGCAGTGATC,0,1550818
galEp3,0.04,24,24,AGGCTCATGCAAGGGACTGC,0,1581622
galEp3,0.04,24,24,AGCAAGAAATATCCGAGCCA,0,1557619
galEp3,0.04,24,24,AGATATAAATCTCATGTGCT,0,1565240
galEp3,0.04,24,24,AGAGTCGCCACCGACCGCAG,0,1577941
galEp3,0.04,24,24,ACTACCGGGCTCTCTTAAAT,0,1547037
galEp3,0.04,24,24,ACCCCACCCGGGCGCACGCG,0,1556751
galEp3,0.04,24,24,AATTCAATAATGGTCTTTTA,0,1578422
galEp3,0.04,24,24,AATGGCCTAAAGGAAGGAAA,0,1555973
galEp3,0.04,24,24,AAGCACCCCTAGCTTGGGCT,0,1556182
galEp3,0.04,24,24,AAATAATAAATACCGTTAGC,0,1552024
galEp3,0.04,24,24,AAACACAGAGCCCTCGTTTA,0,1556084
galEp3,0.041666666666666664,23,23,TTGTATAACGGTTAAAACTA,0,1554714
galEp3,0.041666666666666664,23,23,TTGAATGTCAAGCCAAGTTT,0,1551320
galEp3,0.041666666666666664,23,23,TTAGTGTATGCGGCGTGGAT,0,1555171
galEp3,0.041666666666666664,23,23,TTAAGTTTACACTGCATGAC,0,1567676
galEp3,0.041666666666666664,23,23,TTAACCCTGGTCCGATGGTT,0,1561857
galEp3,0.041666666666666664,23,23,TGTGCGGCATCGCTTTCACC,0,1571886
galEp3,0.041666666666666664,23,23,TGGTGGCTGTCTCTACGCTA,0,1557419
galEp3,0.041666666666666664,23,23,TGGACTGCATGGGAATTACA,0,1563459
galEp3,0.041666666666666664,23,23,TGCGAGTAAAGCAGTATAGA,0,1571718
galEp3,0.041666666666666664,23,23,TGCCAGTTAATAGGCCTCAA,0,1555127
galEp3,0.041666666666666664,23,23,TGATGTATCTCGCAACCGGT,0,1576222
galEp3,0.041666666666666664,23,23,TCTTTAACGGTGAGTCGTAC,0,1566764
galEp3,0.041666666666666664,23,23,TCTGGTCGTTCTAGTAAAGC,0,1570500
galEp3,0.041666666666666664,23,23,TCGTCGAGGCACATGCCCTA,0,1568947
galEp3,0.041666666666666664,23,23,TCGCAATTATGCTGATCGCT,0,1580720
galEp3,0.041666666666666664,23,23,TCCTTGGCATACTGCCTCAA,0,1589751
galEp3,0.041666666666666664,23,23,TATGAAACATCTGTGATTTT,0,1593561
galEp3,0.041666666666666664,23,23,TATATTTGTTAGGCTGCTAA,0,1564403
galEp3,0.041666666666666664,23,23,TAGATAAAAGCCTGTACACA,0,1582488
galEp3,0.041666666666666664,23,23,TACGTTGCGCCTCCGGATCC,0,1562055
galEp3,0.041666666666666664,23,23,TACGCGGTCCGGACGGTGAA,0,1577371
galEp3,0.041666666666666664,23,23,TAATGCTTTCAGCGTTTCTT,0,1549402
galEp3,0.041666666666666664,23,23,TAACTGTAGACAAACCCAAT,0,1547375
galEp3,0.041666666666666664,23,23,GTTATCATAAACGAGAGTTT,0,1559421
galEp3,0.041666666666666664,23,23,GTGTAAAAAAGGGGACCTAT,0,1566234
galEp3,0.041666666666666664,23,23,GTGGGGGCTTAACGGGGTAA,0,1554439
galEp3,0.041666666666666664,23,23,GTCTAAGAGAGTATAAAAAT,0,1586144
galEp3,0.041666666666666664,23,23,GTCCGCGTTTGTATGTGTAT,0,1583702
galEp3,0.041666666666666664,23,23,GTCCCAGAATTTTAGATGTG,0,1551631
galEp3,0.041666666666666664,23,23,GTAGTGAGCATAGTGCCGCA,0,1572771
galEp3,0.041666666666666664,23,23,GGTTTTGCATTAGATCGCAA,0,1576219
galEp3,0.041666666666666664,23,23,GGTTTCGTCCACTAAGGTTA,0,1586921
galEp3,0.041666666666666664,23,23,GGGGGTGCCTTAGCTCTAGA,0,1578235
galEp3,0.041666666666666664,23,23,GGGGATGTCAATTAAGGGAT,0,1584313
galEp3,0.041666666666666664,23,23,GGGACGTAGTCTTTCACTTG,0,1564520
galEp3,0.041666666666666664,23,23,GGCGGTCTCGTACGATGGTG,0,1587249
galEp3,0.041666666666666664,23,23,GGCGCGGATGAGAACTCAAG,0,1555789
galEp3,0.041666666666666664,23,23,GGAAAATGTATGCGGCGTTT,0,1591140
galEp3,0.041666666666666664,23,23,GCTACATGGCGCCACGAATG,0,1587134
galEp3,0.041666666666666664,23,23,GCCGAACACTCTACAACAGA,0,1567910
galEp3,0.041666666666666664,23,23,GCACGCGCTCACGGCATATA,0,1565203
galEp3,0.041666666666666664,23,23,GCAAAGCATCTATGATCGCT,0,1591534
galEp3,0.041666666666666664,23,23,GATTGCTGAAGAGTGATCGA,0,1553974
galEp3,0.041666666666666664,23,23,GATCACAGGAAGAAGGTTTT,0,1559088
galEp3,0.041666666666666664,23,23,GAGGTTCAGTCATCACAATG,0,1586479
galEp3,0.041666666666666664,23,23,GAGCGCACCGGTGGCTGGCT,0,1584442
galEp3,0.041666666666666664,23,23,GACTCGCAGTGTAGACATGA,0,1574167
galEp3,0.041666666666666664,23,23,GACGCAGGTCTGTGCCTACG,0,1563971
galEp3,0.041666666666666664,23,23,GACAGTGCGAAATCGACCAA,0,1569906
galEp3,0.041666666666666664,23,23,CTTGTGGAAATCCCCCCCTA,0,1591365
galEp3,0.041666666666666664,23,23,CTTCCGGAGAAAGCCCGTTA,0,1560516
galEp3,0.041666666666666664,23,23,CTGTTTTACCGTATATGAGT,0,1550669
galEp3,0.041666666666666664,23,23,CTGGTGTTATTGTCGCCCAC,0,1558493
galEp3,0.041666666666666664,23,23,CTGCTGCGTCAGCCTCCATA,0,1585917
galEp3,0.041666666666666664,23,23,CTGCGTGGGGCGTAGTGCTA,0,1561647
galEp3,0.041666666666666664,23,23,CTCTGATTAAGTCGAGCTTA,0,1576528
galEp3,0.041666666666666664,23,23,CTCTCGTTAGAAAGCTTGAC,0,1554548
galEp3,0.041666666666666664,23,23,CGGGGTACTCGCAGCCTCAA,0,1550288
galEp3,0.041666666666666664,23,23,CGGCCTGCGTAGTGATCCAA,0,1550949
galEp3,0.041666666666666664,23,23,CGACGTAAGGATGGAGCGAG,0,1562498
galEp3,0.041666666666666664,23,23,CGAAGCGTGCTCAATCCTCC,0,1553634
galEp3,0.041666666666666664,23,23,CCTAGTCAGCCGGGGTAACT,0,1557986
galEp3,0.041666666666666664,23,23,CCGAGACTCCCTAACCGTAC,0,1553461
galEp3,0.041666666666666664,23,23,CCCTTTTAATCGCCGGAAAT,0,1555077
galEp3,0.041666666666666664,23,23,CCCGAGTGCAAGCCAAAGTC,0,1554535
galEp3,0.041666666666666664,23,23,CCCCCAGCTCGGCGGGGAGT,0,1548555
galEp3,0.041666666666666664,23,23,CCAGCCTGCGGCATGTTCGA,0,1569700
galEp3,0.041666666666666664,23,23,CCACCCGTGTCGGCGTGAAC,0,1580359
galEp3,0.041666666666666664,23,23,CCAAGGCGCGATCTACGCCC,0,1556351
galEp3,0.041666666666666664,23,23,CATGCCTAATCCGCGGTTAT,0,1581310
galEp3,0.041666666666666664,23,23,CATACCCTAGGACACGACCA,0,1579921
galEp3,0.041666666666666664,23,23,CAGTATAGTTGGATGGTCTT,0,1551949
galEp3,0.041666666666666664,23,23,CAGCACATAAGCTTTCTAAA,0,1578407
galEp3,0.041666666666666664,23,23,CAGAGTCCCCACCAATATTC,0,1561939
galEp3,0.041666666666666664,23,23,CAGAATGAAACGGGTGAGAC,0,1566075
galEp3,0.041666666666666664,23,23,CACGAGGATTGTTCCGAACC,0,1585422
galEp3,0.041666666666666664,23,23,CAACGCAGGATGATATGTGT,0,1593836
galEp3,0.041666666666666664,23,23,CAAAGGCATATCGAACATCG,0,1566983
galEp3,0.041666666666666664,23,23,ATTGCCAGGGTTCTCCCTAC,0,1570855
galEp3,0.041666666666666664,23,23,ATGTTTAATGTCAATCGCGT,0,1579728
galEp3,0.041666666666666664,23,23,ATGGGGATTGGACTCGGACG,0,1556660
galEp3,0.041666666666666664,23,23,ATGGCTGCGCATCATAGGTT,0,1564016
galEp3,0.041666666666666664,23,23,ATGCGCTTCTTGGAAAACCA,0,1547511
galEp3,0.041666666666666664,23,23,ATGACACGAAGCATGGTCGG,0,1585095
galEp3,0.041666666666666664,23,23,ATATGTATAATCGTCCAACG,0,1552068
galEp3,0.041666666666666664,23,23,AGTGCAAAGTGACGGTCGTA,0,1583810
galEp3,0.041666666666666664,23,23,AGGGTCAATTCAAGACGAGC,0,1576529
galEp3,0.041666666666666664,23,23,AGGGGAAGTAATCCTAATGA,0,1554493
galEp3,0.041666666666666664,23,23,AGGGATGCAAGAGTCAACTA,0,1579997
galEp3,0.041666666666666664,23,23,AGGCGTTAGTCCCATCTACT,0,1580758
galEp3,0.041666666666666664,23,23,AGGCAGCACACTCCTCTTTT,0,1557413
galEp3,0.041666666666666664,23,23,AGCTCCTTAATGACCTTATT,0,1562775
galEp3,0.041666666666666664,23,23,AGCGAGTTAGGAGCACTGCA,0,1575510
galEp3,0.041666666666666664,23,23,AGCCACGCCTGGAACAACGT,0,1567609
galEp3,0.041666666666666664,23,23,AGCAGTCGCCCGTTTCGGCT,0,1568616
galEp3,0.041666666666666664,23,23,AGCACAAAGCTGGACTATCC,0,1578127
galEp3,0.041666666666666664,23,23,ACTTCCGGCGCCGGTCGAGT,0,1548220
galEp3,0.041666666666666664,23,23,ACGATGGGACGATTTTGATG,0,1581545
galEp3,0.041666666666666664,23,23,ACCCGAGTGATGAACTTCAG,0,1584356
galEp3,0.041666666666666664,23,23,ACCAAGTGCAACCATCCTTT,0,1580542
galEp3,0.041666666666666664,23,23,ACAGGTATATCAAATTTTAC,0,1565488
galEp3,0.041666666666666664,23,23,ACACGACTTTCGGTCCGGAT,0,1570049
galEp3,0.041666666666666664,23,23,ACAACAATAGATCGGGAACT,0,1564682
galEp3,0.041666666666666664,23,23,AATGGAAGGTGCCGTTGGGT,0,1584919
galEp3,0.041666666666666664,23,23,AATAGAGCGCCTCAATGGAC,0,1587006
galEp3,0.041666666666666664,23,23,AACGGATGGCCCTACGAAAA,0,1559984
galEp3,0.041666666666666664,23,23,AAATGCCTTGGTAGACGATA,0,1559974
galEp3,0.041666666666666664,23,23,AAATAAATAAGGCCTGCTGT,0,1591986
galEp3,0.041666666666666664,23,23,AAAAAGTCGCTAACACTCAT,0,1570951
galEp3,0.043478260869565216,22,22,TTTGGTGCCTCGGCTTAAAA,0,1586647
galEp3,0.043478260869565216,22,22,TTGTCTGGAGTCGGGGCGCA,0,1553339
galEp3,0.043478260869565216,22,22,TTGGTGTGGAGGGTAAGGCA,0,1559546
galEp3,0.043478260869565216,22,22,TTGCTTTCAGGAAGGATGCA,0,1585719
galEp3,0.043478260869565216,22,22,TTGAACAAACCAAGCCGGTG,0,1578625
galEp3,0.043478260869565216,22,22,TTCTACCGCGATGCAATGCG,0,1555891
galEp3,0.043478260869565216,22,22,TTCTAACAGTAGTGTACCGT,0,1553206
galEp3,0.043478260869565216,22,22,TTCCTTAACCATTGTTAGTG,0,1563781
galEp3,0.043478260869565216,22,22,TTATTACCCAGGTTTCGTCG,0,1551938
galEp3,0.043478260869565216,22,22,TGTTTCCAACTAGACATGCA,0,1575807
galEp3,0.043478260869565216,22,22,TGTTCTACCCACTATTAGGT,0,1553117
galEp3,0.043478260869565216,22,22,TGGCCGCGACATAATCACTT,0,1556455
galEp3,0.043478260869565216,22,22,TGGACTCCGGTCTCCTGGAA,0,1554025
galEp3,0.043478260869565216,22,22,TGCTGCGGGGCATGATGATG,0,1568399
galEp3,0.043478260869565216,22,22,TCTGCTGTGCTGCTTCTTCA,0,1558066
galEp3,0.043478260869565216,22,22,TCGCAGCGCTGCTAATTTGC,0,1593586
galEp3,0.043478260869565216,22,22,TCGAGTCGGTCCGAAACCGA,0,1562169
galEp3,0.043478260869565216,22,22,TCCTGCGCGGCGGGGTACAA,0,1576502
galEp3,0.043478260869565216,22,22,TCATTTCAATCGAATGTGCT,0,1573322
galEp3,0.043478260869565216,22,22,TCATGACCTATTCCGCGGGG,0,1549970
galEp3,0.043478260869565216,22,22,TCAGATCGTATTACCCGTAT,0,1590676
galEp3,0.043478260869565216,22,22,TCACTTTGGTGTGTTCACGA,0,1581398
galEp3,0.043478260869565216,22,22,TCACGCGTAGGCTCGGTTGT,0,1576864
galEp3,0.043478260869565216,22,22,TCAAGCACCTGATGGTCTGT,0,1594857
galEp3,0.043478260869565216,22,22,TATTGCTAACATCGTGTTTT,0,1560855
galEp3,0.043478260869565216,22,22,TATGGCATTTGGGGGAGTTA,0,1551442
galEp3,0.043478260869565216,22,22,TATGGAAGTTGGGCAACGAT,0,1577127
galEp3,0.043478260869565216,22,22,TAGCACAAGCTACGAGGTCG,0,1576268
galEp3,0.043478260869565216,22,22,TAGATTCCGGCCTCGGATAC,0,1590893
galEp3,0.043478260869565216,22,22,TACAGGAGATCGTCAGAGTC,0,1552114
galEp3,0.043478260869565216,22,22,TAAGGCGCCCCCTGTCGGGT,0,1550520
galEp3,0.043478260869565216,22,22,TAACCTGTGCAAACCATTGG,0,1584432
galEp3,0.043478260869565216,22,22,GTTTATAACGAACCAAGGAT,0,1565060
galEp3,0.043478260869565216,22,22,GTTACGACCAACCCAATTCT,0,1554508
galEp3,0.043478260869565216,22,22,GTCGGAATGGCTTGCTTGAT,0,1570137
galEp3,0.043478260869565216,22,22,GTCGCACTCCTGGATGAACC,0,1564259
galEp3,0.043478260869565216,22,22,GTCCTCCTTGACCATATACG,0,1576670
galEp3,0.043478260869565216,22,22,GTACTCCGGGCGATTAGCGG,0,1551900
galEp3,0.043478260869565216,22,22,GTACAGGCCTTAGTTTCAGG,0,1550616
galEp3,0.043478260869565216,22,22,GGGAGAGTAAGGGATCGAAT,0,1566018
galEp3,0.043478260869565216,22,22,GGGACAAGATTAATGGGGGA,0,1573695
galEp3,0.043478260869565216,22,22,GGCTCGTGGGCGTATCCTGA,0,1592173
galEp3,0.043478260869565216,22,22,GGCTAACATGGATTTATGGA,0,1552581
galEp3,0.043478260869565216,22,22,GGCGCTTTAATTACATAATA,0,1567922
galEp3,0.043478260869565216,22,22,GGCAGGCCATGGATCGCGAA,0,1558827
galEp3,0.043478260869565216,22,22,GGAGCCGTGAAGCGTTGGTT,0,1592659
galEp3,0.043478260869565216,22,22,GCTACGTTAGTTTCATTCCA,0,1584519
galEp3,0.043478260869565216,22,22,GCTAAGGACAGTGGACAGAT,0,1553058
galEp3,0.043478260869565216,22,22,GCGCATGTTATATAACAGTC,0,1566993
galEp3,0.043478260869565216,22,22,GCCTCGACCCTACAGGTCGT,0,1590884
galEp3,0.043478260869565216,22,22,GCCTCCTTGCGGAACTGGTG,0,1578732
galEp3,0.043478260869565216,22,22,GCCGTCGGGTAGAAACCCAC,0,1566081
galEp3,0.043478260869565216,22,22,GCAAGGTCGTGTAATACGGC,0,1592430
galEp3,0.043478260869565216,22,22,GATCGCGTCGGCCAAGTGTA,0,1588633
galEp3,0.043478260869565216,22,22,GATCAGGGCACGATAGCAGG,0,1567998
galEp3,0.043478260869565216,22,22,GACTCCACCGAATGCAACAA,0,1558253
galEp3,0.043478260869565216,22,22,GACTACCGTCCGGGGCGGCA,0,1592635
galEp3,0.043478260869565216,22,22,GACGGGCAGCTCAATTATTA,0,1551478
galEp3,0.043478260869565216,22,22,GACGCTTTTGCCTTCCCGGG,0,1571713
galEp3,0.043478260869565216,22,22,CTTCTCGTTGGGAAAAAATA,0,1548180
galEp3,0.043478260869565216,22,22,CTGGATCGAGAGGATTCTTC,0,1548381
galEp3,0.043478260869565216,22,22,CTGCCACATCAAAATGCGCA,0,1581997
galEp3,0.043478260869565216,22,22,CTCGCGCACAGTGCGAATTT,0,1571639
galEp3,0.043478260869565216,22,22,CTCCCCGTACTAGATGATGC,0,1554845
galEp3,0.043478260869565216,22,22,CTATACACTCTGTGGTTATG,0,1572208
galEp3,0.043478260869565216,22,22,CTACTCCATTGGGTCTCGAA,0,1573912
galEp3,0.043478260869565216,22,22,CGTATGTTAGGTATGGAACA,0,1556201
galEp3,0.043478260869565216,22,22,CGGTTCCCCTTGGTTTTTAG,0,1555892
galEp3,0.043478260869565216,22,22,CGGGCACCGTGGATTCAGGT,0,1548655
galEp3,0.043478260869565216,22,22,CGGCATGGACAACTAGCCGG,0,1577688
galEp3,0.043478260869565216,22,22,CGGCATCCTTATTAGCGTTG,0,1573294
galEp3,0.043478260869565216,22,22,CGGACCGGAACATGGTCGTT,0,1568432
galEp3,0.043478260869565216,22,22,CGCTCGTGCCTAACGAAATA,0,1584979
galEp3,0.043478260869565216,22,22,CGCTCCCATATAGGCAAAGG,0,1589975
galEp3,0.043478260869565216,22,22,CGCCGTCTTCTTCGGCCTCT,0,1556203
galEp3,0.043478260869565216,22,22,CGCCGCATATTTCAGAAGCA,0,1556027
galEp3,0.043478260869565216,22,22,CGCCGCAAGTTTTAACGGCT,0,1556799
galEp3,0.043478260869565216,22,22,CGCACATTGATCGCCTCCGT,0,1568355
galEp3,0.043478260869565216,22,22,CGAGACCATTTTAAAAGCGG,0,1565948
galEp3,0.043478260869565216,22,22,CCTGTTAGGGCTAAAATTGA,0,1588369
galEp3,0.043478260869565216,22,22,CCTAATCGAGACACGAAGGC,0,1562933
galEp3,0.043478260869565216,22,22,CCGCGCGCATGGATTGAGGT,0,1551826
galEp3,0.043478260869565216,22,22,CCGATGACATAAGAGATGAA,0,1562335
galEp3,0.043478260869565216,22,22,CCCTTGGACGACGTCGTGAC,0,1577377
galEp3,0.043478260869565216,22,22,CCCGTTCTTAAAGGGGGGGT,0,1573521
galEp3,0.043478260869565216,22,22,CCCGGGCCAAGTACAGGCGT,0,1562403
galEp3,0.043478260869565216,22,22,CCCCGGTACTGTGCATGAAA,0,1577033
galEp3,0.043478260869565216,22,22,CCCCGCATGCGCCGATAAAG,0,1569781
galEp3,0.043478260869565216,22,22,CCATGTGCCTACCGATCTGC,0,1592646
galEp3,0.043478260869565216,22,22,CATGCGCTCATTATTCAATT,0,1552916
galEp3,0.043478260869565216,22,22,CATCGACCTACATCATGCGA,0,1571593
galEp3,0.043478260869565216,22,22,CATATTGTGTCAACGGCGCG,0,1594150
galEp3,0.043478260869565216,22,22,CAGGTGCACCAATGCCCAGC,0,1552127
galEp3,0.043478260869565216,22,22,CAAGATCGGCGTACAACAGT,0,1584023
galEp3,0.043478260869565216,22,22,CAACTGTACGTGCCCGCTCT,0,1552264
galEp3,0.043478260869565216,22,22,CAACCGCGTCACGCCCAGGG,0,1574824
galEp3,0.043478260869565216,22,22,ATTGGGCCTGTACGACCTAC,0,1556151
galEp3,0.043478260869565216,22,22,ATTCATGCCGGGTTGCGCGA,0,1576320
galEp3,0.043478260869565216,22,22,ATTCAAGGGGGGTCCAACAC,0,1566317
galEp3,0.043478260869565216,22,22,ATGTTTTGCATTCGGTAAGA,0,1547655
galEp3,0.043478260869565216,22,22,ATGCCACAATGAAAAATTTT,0,1571353
galEp3,0.043478260869565216,22,22,ATCCCGTGTATGCGTGTAGC,0,1553462
galEp3,0.043478260869565216,22,22,ATAGAGCATCAGTGACCAAA,0,1561311
galEp3,0.043478260869565216,22,22,AGGAGATTTAAACCTGTTTT,0,1554276
galEp3,0.043478260869565216,22,22,AGCTCGTAAAATCCGGAACA,0,1563183
galEp3,0.043478260869565216,22,22,AGCTCCCACGCTCGGCTGGC,0,1567346
galEp3,0.043478260869565216,22,22,AGCGGCTTTTCTGGTGGGTC,0,1549296
galEp3,0.043478260869565216,22,22,AGCCCACGTGTTCCGTGACA,0,1571262
galEp3,0.043478260869565216,22,22,AGCACTTTTCTAGAGCGAAC,0,1575517
galEp3,0.043478260869565216,22,22,ACTTCGGCTTGGGTGCTGCG,0,1587293
galEp3,0.043478260869565216,22,22,ACTAATGCGGGATTTATTTA,0,1556507
galEp3,0.043478260869565216,22,22,ACGTTTCAAGCTCGCCTCTA,0,1553643
galEp3,0.043478260869565216,22,22,ACGCTCAATGGATAGCCTTT,0,1548212
galEp3,0.043478260869565216,22,22,ACGCCCGTGGGTATCCGACT,0,1590512
galEp3,0.043478260869565216,22,22,ACGATTGACATGCAGACCAA,0,1554843
galEp3,0.043478260869565216,22,22,ACGATGCTCACAGAGTGACA,0,1551140
galEp3,0.043478260869565216,22,22,ACCACATCGATCTGTTCCAA,0,1584772
galEp3,0.043478260869565216,22,22,ACAGATAGGTCACCTTCGGC,0,1567233
galEp3,0.043478260869565216,22,22,AATTGGTTTGTCTGAGGCTT,0,1571352
galEp3,0.043478260869565216,22,22,AATAAATGCGATTCGGAAAC,0,1574709
galEp3,0.043478260869565216,22,22,AACTCGTTGGCACCCCCAGA,0,1581071
galEp3,0.043478260869565216,22,22,AAACCATAACAACCGAATTG,0,1584859
galEp3,0.045454545454545456,21,21,TTTGTACACTGACCCATTTT,0,1581471
galEp3,0.045454545454545456,21,21,TTGTGGCAAGTTATGCATGA,0,1590430
galEp3,0.045454545454545456,21,21,TTGGGGCATTCTTTCGCCTG,0,1587364
galEp3,0.045454545454545456,21,21,TTGGATCGCTACCCGCGGCT,0,1573744
galEp3,0.045454545454545456,21,21,TTGCGTGCGGTCGTAACTCT,0,1550629
galEp3,0.045454545454545456,21,21,TTGCAGGGTTATGTAAGCTG,0,1557825
galEp3,0.045454545454545456,21,21,TTATGAATTAGGAGTACCCT,0,1564457
galEp3,0.045454545454545456,21,21,TGGTGGTAAGAGATATTCGG,0,1590177
galEp3,0.045454545454545456,21,21,TGGTAGATCTGTCGTCGTGT,0,1558365
galEp3,0.045454545454545456,21,21,TGGAACGGTAGCTGACACGT,0,1549709
galEp3,0.045454545454545456,21,21,TGCACATTGCATGTTCTACT,0,1583123
galEp3,0.045454545454545456,21,21,TGAACCGTTTCTTATCTGTG,0,1586537
galEp3,0.045454545454545456,21,21,TCTCCCTTAGGACTTTGTGT,0,1567495
galEp3,0.045454545454545456,21,21,TCTACGACTTGGGCTTCGGA,0,1570344
galEp3,0.045454545454545456,21,21,TCGTAGGGGGGCGTTAACCA,0,1551925
galEp3,0.045454545454545456,21,21,TCGGGTTCGCGGGAGAATGG,0,1568392
galEp3,0.045454545454545456,21,21,TCGGGGGGTATTAAATATGA,0,1594917
galEp3,0.045454545454545456,21,21,TCGCCGTACCCAGGAGATGC,0,1576648
galEp3,0.045454545454545456,21,21,TCGACCCAGTTCGCACCCGG,0,1575244
galEp3,0.045454545454545456,21,21,TCCTGGTTCCTGTTCCGTGA,0,1586073
galEp3,0.045454545454545456,21,21,TCCGACGTTGAATCTAACTA,0,1573713
galEp3,0.045454545454545456,21,21,TATGTATGGAGGCTATAAGC,0,1564743
galEp3,0.045454545454545456,21,21,TATAGCGGTTACGCGGCTGA,0,1566125
galEp3,0.045454545454545456,21,21,TAGCATCCCGATCAAGGGAA,0,1594777
galEp3,0.045454545454545456,21,21,TAGAGCACATGATTATCATA,0,1586014
galEp3,0.045454545454545456,21,21,TAGACTCGGATACGCCAATA,0,1560145
galEp3,0.045454545454545456,21,21,TACGTGTATATGTAATCTAG,0,1549262
galEp3,0.045454545454545456,21,21,TAATTCTTAGTAACGATGTT,0,1590142
galEp3,0.045454545454545456,21,21,TAACGCAGTATACTGATATA,0,1556060
galEp3,0.045454545454545456,21,21,GTTCCCACACTCCCGGGGTG,0,1594324
galEp3,0.045454545454545456,21,21,GTGTCTACGGACCCGTGCAA,0,1549592
galEp3,0.045454545454545456,21,21,GTGCCGTATTGCTGAAGGGT,0,1592774
galEp3,0.045454545454545456,21,21,GTGCCAGCGCTTTTAAATCT,0,1560160
galEp3,0.045454545454545456,21,21,GGTTGTTCTACTTCTGGGTG,0,1562884
galEp3,0.045454545454545456,21,21,GGTGGTTTGCCATTCGGGGT,0,1556382
galEp3,0.045454545454545456,21,21,GGTAAGCTGAAATTCAGGAG,0,1567964
galEp3,0.045454545454545456,21,21,GGGCGCGCCGGGTCCCTGGA,0,1570069
galEp3,0.045454545454545456,21,21,GGCTTCGGGCCGCAACACAC,0,1594443
galEp3,0.045454545454545456,21,21,GGCGTCTGAACGCTCGGTGA,0,1551343
galEp3,0.045454545454545456,21,21,GGCCGAATGTGTTAATGGTA,0,1569505
galEp3,0.045454545454545456,21,21,GGCCCCTCCGAAGCTGGCGG,0,1590759
galEp3,0.045454545454545456,21,21,GGATAAGATTTCCAGGTCGG,0,1566386
galEp3,0.045454545454545456,21,21,GCTGGCCCGTGGGATACAGG,0,1560513
galEp3,0.045454545454545456,21,21,GCTCAATAATCCTTTAGGAC,0,1585222
galEp3,0.045454545454545456,21,21,GCCCTCCGTAGAGACTCTGA,0,1581855
galEp3,0.045454545454545456,21,21,GCCCGCAGGTATACTACAGT,0,1590401
galEp3,0.045454545454545456,21,21,GCATGGGAAGGTCCTCTAGA,0,1583734
galEp3,0.045454545454545456,21,21,GCATGCGATTGTTCAGTCCA,0,1551451
galEp3,0.045454545454545456,21,21,GCACATTAAACGGGCGGAGT,0,1559189
galEp3,0.045454545454545456,21,21,GAGCCCTAGGATTAGTAAGC,0,1559360
galEp3,0.045454545454545456,21,21,GACATCTCGTACCGTGGATT,0,1564668
galEp3,0.045454545454545456,21,21,GAACCAGTTCTAGGTACCTA,0,1574555
galEp3,0.045454545454545456,21,21,CTTTCAAAATCAGCAGTGTG,0,1589386
galEp3,0.045454545454545456,21,21,CTGGTAATCGCTTTGGGTTA,0,1549589
galEp3,0.045454545454545456,21,21,CTGGGGTAACGCCTGTCCGT,0,1588177
galEp3,0.045454545454545456,21,21,CTGGATGTCATAAGAGTCAT,0,1555647
galEp3,0.045454545454545456,21,21,CTCGCTCCTACAGTGCCGCT,0,1570392
galEp3,0.045454545454545456,21,21,CGGAGTGTCTCAATTAGACG,0,1581894
galEp3,0.045454545454545456,21,21,CGCCACTCGCACTCCTTAAA,0,1588834
galEp3,0.045454545454545456,21,21,CGAGCCGGGGGATAGGCCTT,0,1584232
galEp3,0.045454545454545456,21,21,CGAATAACACACGCTCGCTC,0,1573008
galEp3,0.045454545454545456,21,21,CGAACGCTATTCCAGGGAAA,0,1556813
galEp3,0.045454545454545456,21,21,CCTGCTAATTCGATACGCAG,0,1567185
galEp3,0.045454545454545456,21,21,CCTCGCGTCCGCGAAACCTT,0,1578843
galEp3,0.045454545454545456,21,21,CCGTCTAGGAGAGTTGAGGA,0,1582438
galEp3,0.045454545454545456,21,21,CCGGCGACTCTCTACCGCTC,0,1575681
galEp3,0.045454545454545456,21,21,CCGCGTATGGTTGTTCATCA,0,1593779
galEp3,0.045454545454545456,21,21,CCGCCTACCCTGGACGGCGT,0,1560188
galEp3,0.045454545454545456,21,21,CCGATAAGTGTTGGCGGCAG,0,1585802
galEp3,0.045454545454545456,21,21,CCAGAGGAAACTTTGGACGC,0,1549408
galEp3,0.045454545454545456,21,21,CATGGAATATCACAAGAGGT,0,1550846
galEp3,0.045454545454545456,21,21,CATGCAGAATTGCTGCGAGA,0,1581678
galEp3,0.045454545454545456,21,21,CAGGGGTGCAGGGGTGATAG,0,1583452
galEp3,0.045454545454545456,21,21,CAGCGCCTCCGTCCGATGTA,0,1594850
galEp3,0.045454545454545456,21,21,CAGACAGTAGGGTTATAAGA,0,1575663
galEp3,0.045454545454545456,21,21,CACTTTCCCCGTCACGGGGC,0,1549603
galEp3,0.045454545454545456,21,21,CAACGGGTTGTAGCACCCCG,0,1555383
galEp3,0.045454545454545456,21,21,CAACGGGCGTACACCTATTC,0,1570498
galEp3,0.045454545454545456,21,21,ATTGATCGCGTCATGTGTCT,0,1558022
galEp3,0.045454545454545456,21,21,ATGCGGTGGCGCATCCTCAG,0,1593317
galEp3,0.045454545454545456,21,21,ATCGCGTGCTTGTTCAGAAC,0,1557379
galEp3,0.045454545454545456,21,21,ATCAGGTGAAAATCACAAGA,0,1576861
galEp3,0.045454545454545456,21,21,ATCAGGACTGTATCTCTAGG,0,1588390
galEp3,0.045454545454545456,21,21,ATATGTGCAAGCCGATGAGT,0,1567679
galEp3,0.045454545454545456,21,21,ATAATTGTAATGAGACGACA,0,1567828
galEp3,0.045454545454545456,21,21,AGGTCATTAGAGCCACATGG,0,1558459
galEp3,0.045454545454545456,21,21,AGGGCTCACACTATGTTAAG,0,1566762
galEp3,0.045454545454545456,21,21,AGCTTTATCCACGGCCCCGC,0,1559989
galEp3,0.045454545454545456,21,21,AGCGCTTTTACGGAACATGT,0,1590214
galEp3,0.045454545454545456,21,21,AGATGTGCGCGTTCTGGCGG,0,1563312
galEp3,0.045454545454545456,21,21,AGATGCGGGTAGGGTACGTA,0,1549807
galEp3,0.045454545454545456,21,21,AGAGCCGGGCGCCCGGTTAG,0,1594218
galEp3,0.045454545454545456,21,21,AGACAAGCCGCTCTATGCAG,0,1572705
galEp3,0.045454545454545456,21,21,ACTGACGTACTCTGAAGAAT,0,1547028
galEp3,0.045454545454545456,21,21,ACTCCGCACCTATGGCAGCG,0,1548471
galEp3,0.045454545454545456,21,21,ACGTAGTATTCGAACAGCAG,0,1550610
galEp3,0.045454545454545456,21,21,ACGGCGCTGGCGCTTAGGGT,0,1563571
galEp3,0.045454545454545456,21,21,ACGGATAAAGATTCAATGAG,0,1556329
galEp3,0.045454545454545456,21,21,ACCAGCCTATCTATTGCTAG,0,1568085
galEp3,0.045454545454545456,21,21,ACATAGTGCTCGATAGCCTT,0,1567516
galEp3,0.045454545454545456,21,21,ACATAGGCCGATCGCGGTTG,0,1571582
galEp3,0.045454545454545456,21,21,ACAGTATGGCTTACGCAAAA,0,1558820
galEp3,0.045454545454545456,21,21,ACAGTAGGCAAGATCCGATG,0,1574604
galEp3,0.045454545454545456,21,21,AATTCCAATGGTGTTAGTGC,0,1573832
galEp3,0.045454545454545456,21,21,AATCTATTATAAACTCTAAA,0,1587764
galEp3,0.045454545454545456,21,21,AAGGAACAAGAACTACTCAT,0,1554754
galEp3,0.045454545454545456,21,21,AACTGCCCAGATAGGAACCT,0,1553300
galEp3,0.045454545454545456,21,21,AACCTTGGTCCTCTCGTAGT,0,1554911
galEp3,0.045454545454545456,21,21,AAATTTAATACAGGTTATTG,0,1551216
galEp3,0.045454545454545456,21,21,AAACCGTTCCTTCGTAGCTA,0,1577779
galEp3,0.045454545454545456,21,21,AAACATAGCTGTCGGTTTAA,0,1573589
galEp3,0.047619047619047616,20,20,TTGTACACTGGAGGGGTGCA,0,1578966
galEp3,0.047619047619047616,20,20,TTGGTAAACGGGAAGTTTAA,0,1566955
galEp3,0.047619047619047616,20,20,TTGCGGACCGTCGGTTTACT,0,1553053
galEp3,0.047619047619047616,20,20,TTGCACTGCAGCGCTCCTGC,0,1570060
galEp3,0.047619047619047616,20,20,TTCCCTCCCTGTTAACCTCA,0,1575646
galEp3,0.047619047619047616,20,20,TTCATTTTCGCCTATCCCGT,0,1558805
galEp3,0.047619047619047616,20,20,TTATTCTATATTCTCACCGT,0,1574257
galEp3,0.047619047619047616,20,20,TTACACCGGGCAAGGATACT,0,1549057
galEp3,0.047619047619047616,20,20,TTAACACTGTATACGGGGCT,0,1565981
galEp3,0.047619047619047616,20,20,TGTTGGCAGATTGCGTATAG,0,1589787
galEp3,0.047619047619047616,20,20,TGTGGGTGTTCAAACAATAT,0,1574780
galEp3,0.047619047619047616,20,20,TGTGGAGTTCTCAGTTTGGT,0,1587019
galEp3,0.047619047619047616,20,20,TGTACTGTCCAACACCACCC,0,1563374
galEp3,0.047619047619047616,20,20,TGTAAGCTGGAAATAAATGA,0,1559745
galEp3,0.047619047619047616,20,20,TGTAACTTGCGGCGCTACTA,0,1577717
galEp3,0.047619047619047616,20,20,TGCGGAGGTAGCCGCCCCTG,0,1584773
galEp3,0.047619047619047616,20,20,TGCCAGAGGTGTTTCGTCCC,0,1562776
galEp3,0.047619047619047616,20,20,TGCCAAATCAGGCTACCTCA,0,1560515
galEp3,0.047619047619047616,20,20,TGATTCATTTGCTAATGGCT,0,1551229
galEp3,0.047619047619047616,20,20,TGATTACACATAAATAAGAC,0,1586794
galEp3,0.047619047619047616,20,20,TCTTGGTGGCCGCACCCGTG,0,1555515
galEp3,0.047619047619047616,20,20,TCTGCCTCCGCACAACTGTT,0,1581110
galEp3,0.047619047619047616,20,20,TCTCCCGGGACACCATGTAG,0,1563989
galEp3,0.047619047619047616,20,20,TCGGGGAACGACACCACTTG,0,1586238
galEp3,0.047619047619047616,20,20,TCGGAAAAAGCTGCAGCTGA,0,1576504
galEp3,0.047619047619047616,20,20,TCCACACGCTTTAGCAAGTC,0,1559436
galEp3,0.047619047619047616,20,20,TCAGTAAGATGCCGTGAGCT,0,1587020
galEp3,0.047619047619047616,20,20,TCACGTCACATGGGCGAATA,0,1548796
galEp3,0.047619047619047616,20,20,TCACAGGCAGGAGTCAATGT,0,1547407
galEp3,0.047619047619047616,20,20,TCAATGATTTCTTATGAAAA,0,1566837
galEp3,0.047619047619047616,20,20,TATTAGAAGTTGGGTTAATA,0,1568338
galEp3,0.047619047619047616,20,20,TATCCTTAACCCGATCTCGT,0,1550544
galEp3,0.047619047619047616,20,20,TAGGCGCCAACGCCATCACT,0,1576009
galEp3,0.047619047619047616,20,20,TAGAAGTGGTAGGTCACTAA,0,1564121
galEp3,0.047619047619047616,20,20,TACTCGTCGCATTTAGGTCA,0,1576628
galEp3,0.047619047619047616,20,20,TACGCGCAGGGGGCTCCAGC,0,1551237
galEp3,0.047619047619047616,20,20,TAACGTTCCGCAAATCTCTC,0,1572661
galEp3,0.047619047619047616,20,20,GTTGAGACGGTAGTAGTGAG,0,1584918
galEp3,0.047619047619047616,20,20,GTGATAAACCGATAGGGAGA,0,1584057
galEp3,0.047619047619047616,20,20,GTGAAGAAGTATCATACTAA,0,1588629
galEp3,0.047619047619047616,20,20,GTCTTAGCCTCCGGACCGTT,0,1549630
galEp3,0.047619047619047616,20,20,GTCGTAGTAGGATGATGAAA,0,1552063
galEp3,0.047619047619047616,20,20,GTCCAACCCGGGATTTTTGC,0,1582072
galEp3,0.047619047619047616,20,20,GGTTGGGGGTCACAGGGTAT,0,1565748
galEp3,0.047619047619047616,20,20,GGTCTTCCTCTATTGTGCGA,0,1593680
galEp3,0.047619047619047616,20,20,GGTCAGCGCCCCAAGTAATT,0,1576989
galEp3,0.047619047619047616,20,20,GGGTTTTTCTGACTCTGTCA,0,1549403
galEp3,0.047619047619047616,20,20,GGGTCCTGTCGATCGGTGAA,0,1546899
galEp3,0.047619047619047616,20,20,GGGGGGCTCTGCCCCGCACT,0,1573602
galEp3,0.047619047619047616,20,20,GGCTGCTTTAGCTCATAATA,0,1553475
galEp3,0.047619047619047616,20,20,GGCTCATTGCTGACTACTAT,0,1576464
galEp3,0.047619047619047616,20,20,GGATAAGCGCACATCGTAAT,0,1556026
galEp3,0.047619047619047616,20,20,GGACGTTCTACCGATATGGC,0,1574161
galEp3,0.047619047619047616,20,20,GCTGGATCGAGATACTCTTG,0,1568976
galEp3,0.047619047619047616,20,20,GCTCCATATACCACATAATA,0,1547579
galEp3,0.047619047619047616,20,20,GCGTTGGGACGATAGCATGT,0,1570844
galEp3,0.047619047619047616,20,20,GCGGGTTAGATAGAACGGCG,0,1548429
galEp3,0.047619047619047616,20,20,GCGGAGACATAAGCGGTCCT,0,1585629
galEp3,0.047619047619047616,20,20,GCGCAAGAGACCGCATTGAT,0,1586423
galEp3,0.047619047619047616,20,20,GCGAGTGATTGATCAGCGCT,0,1546910
galEp3,0.047619047619047616,20,20,GCCGGCACTAACTCGCTGTC,0,1556599
galEp3,0.047619047619047616,20,20,GCCGCGCCGCCCGGTCTACA,0,1561272
galEp3,0.047619047619047616,20,20,GCCGACCATATGACTTTTCC,0,1582594
galEp3,0.047619047619047616,20,20,GCCAATGTTCAAAAGCGTGA,0,1559159
galEp3,0.047619047619047616,20,20,GCACTGGGACTTACTTGTAA,0,1559908
galEp3,0.047619047619047616,20,20,GCAACCCCGTGTGATGTACA,0,1561970
galEp3,0.047619047619047616,20,20,GAGGTCGCTTGCGGCCTCTG,0,1568880
galEp3,0.047619047619047616,20,20,GAATGCGAACCAATTGCGTA,0,1571393
galEp3,0.047619047619047616,20,20,GAAAAACTCCGGAGCAGACA,0,1551013
galEp3,0.047619047619047616,20,20,CTGTGTACCCAAGGATACAG,0,1580276
galEp3,0.047619047619047616,20,20,CTGTATCGCCTCAAGTTACG,0,1592011
galEp3,0.047619047619047616,20,20,CTGGCAATAAGTGCGCATTT,0,1564375
galEp3,0.047619047619047616,20,20,CTGCAGCACGGAAGACAGGA,0,1558926
galEp3,0.047619047619047616,20,20,CTCGTTGTCTCGTTTTGAAA,0,1587208
galEp3,0.047619047619047616,20,20,CTCGTTCCTTAACCTGGAGA,0,1577003
galEp3,0.047619047619047616,20,20,CTAGTTATTTTTTTGTTGTG,0,1560511
galEp3,0.047619047619047616,20,20,CTAGTGTACCCTTAGGCTAC,0,1568043
galEp3,0.047619047619047616,20,20,CGTGGATGCGTGGACGCCCG,0,1562515
galEp3,0.047619047619047616,20,20,CGTCGGGGCTGCGGCAGCAT,0,1570339
galEp3,0.047619047619047616,20,20,CGTATGCGGCAGCAGCGAGC,0,1553353
galEp3,0.047619047619047616,20,20,CGTAGGGGTATGTACTTCGT,0,1579033
galEp3,0.047619047619047616,20,20,CGGGAGGGTCCTGCGGATAT,0,1563570
galEp3,0.047619047619047616,20,20,CGGATCCCAAAAACACTCAG,0,1558704
galEp3,0.047619047619047616,20,20,CGCTTCCATCATCCCGGCTT,0,1554740
galEp3,0.047619047619047616,20,20,CGCGTACCCAAAAGCAACCG,0,1565629
galEp3,0.047619047619047616,20,20,CGCGAGTCCTTCCTTGAGAC,0,1558291
galEp3,0.047619047619047616,20,20,CGAGGTGTACCGGAACTTTG,0,1562512
galEp3,0.047619047619047616,20,20,CCTCGGTCCTTTCCATTCGA,0,1552627
galEp3,0.047619047619047616,20,20,CCGTCCATAACCAGACAGAA,0,1591820
galEp3,0.047619047619047616,20,20,CCGAGATCTATCGGGGCCTA,0,1559260
galEp3,0.047619047619047616,20,20,CCCTCTTCGTGTCACATATG,0,1571450
galEp3,0.047619047619047616,20,20,CCCCACCTGTAACCCACGAT,0,1555306
galEp3,0.047619047619047616,20,20,CCACAGGTTGCGGGCTACTC,0,1548917
galEp3,0.047619047619047616,20,20,CATTGTTCCGGGTTATCGCG,0,1558029
galEp3,0.047619047619047616,20,20,CATTCAAAAACGGTGCCATG,0,1554380
galEp3,0.047619047619047616,20,20,CATGTGGTAAAAAAGAGAAA,0,1554877
galEp3,0.047619047619047616,20,20,CATACGTGCCTTGCCGCCAA,0,1586603
galEp3,0.047619047619047616,20,20,CAGGAGCATCTAATTGTCTG,0,1567251
galEp3,0.047619047619047616,20,20,CAGCTGGGCCGCGGCACGCG,0,1579029
galEp3,0.047619047619047616,20,20,CAGCACGGAATCAGATGTTA,0,1558481
galEp3,0.047619047619047616,20,20,CACGTAAGTACGCACAGTAT,0,1588103
galEp3,0.047619047619047616,20,20,CACCATCACGACCCTTCCAA,0,1546635
galEp3,0.047619047619047616,20,20,CACCACAGAGGTCTCATATT,0,1553813
galEp3,0.047619047619047616,20,20,CACCAACTCCCACTGGAGGC,0,1585903
galEp3,0.047619047619047616,20,20,CACATTCCGTCTCTCTTGAG,0,1556115
galEp3,0.047619047619047616,20,20,ATTTGGGCCTCGATACGTGG,0,1570996
galEp3,0.047619047619047616,20,20,ATTCTCAATTTAAACGTCAT,0,1580975
galEp3,0.047619047619047616,20,20,ATTAAAGGGCCTTGCTACAT,0,1592248
galEp3,0.047619047619047616,20,20,ATGTTTACTAATACTCATCG,0,1583833
galEp3,0.047619047619047616,20,20,ATGGTTGCTATCCGGCCATC,0,1550738
galEp3,0.047619047619047616,20,20,ATCTTTTGCGCGACAGTCAT,0,1580295
galEp3,0.047619047619047616,20,20,ATCGACACGAAGGTGAGATT,0,1577490
galEp3,0.047619047619047616,20,20,ATCCGTACAATTTGGTTTCC,0,1582172
galEp3,0.047619047619047616,20,20,AGTTATGGATGACAAGCACT,0,1550114
galEp3,0.047619047619047616,20,20,AGTGAGTGCGTCCGTTGACT,0,1561368
galEp3,0.047619047619047616,20,20,AGTATGCCGATTTTCACCTA,0,1589596
galEp3,0.047619047619047616,20,20,AGGTAGCGAACCAAGCGGAT,0,1594158
galEp3,0.047619047619047616,20,20,AGGGATCTATCGGTCGCTTA,0,1561067
galEp3,0.047619047619047616,20,20,AGGGATAGAAGGACCGCAGA,0,1563591
galEp3,0.047619047619047616,20,20,AGGCATGGGGTCCAATTAGG,0,1589970
galEp3,0.047619047619047616,20,20,AGCGAGACGGACCACGTCTA,0,1558804
galEp3,0.047619047619047616,20,20,AGAGTAAAAAGCACCATGCA,0,1578927
galEp3,0.047619047619047616,20,20,AGAACTTGGGGCTGCCTGGT,0,1579524
galEp3,0.047619047619047616,20,20,ACTCGGTGGTAACCAGCGAA,0,1577665
galEp3,0.047619047619047616,20,20,ACTACGGGGCTACCTTAATG,0,1578355
galEp3,0.047619047619047616,20,20,ACGGCAAAGGTGCGATCGAT,0,1557345
galEp3,0.047619047619047616,20,20,ACGCCCCCACCGGGAGAAGG,0,1549419
galEp3,0.047619047619047616,20,20,ACGAGCTTGAATGGTGGGCA,0,1564765
galEp3,0.047619047619047616,20,20,ACCGGTGGATGCAAGCCATG,0,1589242
galEp3,0.047619047619047616,20,20,ACCGGACAGAAGGACCTGAA,0,1565457
galEp3,0.047619047619047616,20,20,ACAACTCTAGATTGGGCCAG,0,1549353
galEp3,0.047619047619047616,20,20,AAGTAAAGCAATGTCCAAAT,0,1595000
galEp3,0.047619047619047616,20,20,AACTCCTGCTGCGATTCAAA,0,1565017
galEp3,0.047619047619047616,20,20,AACGATAGGTATGGTACTAC,0,1567528
galEp3,0.047619047619047616,20,20,AACCTCGTTAGGGCCTCGAC,0,1553977
galEp3,0.047619047619047616,20,20,AACCGAGCCGGGGGGGCTCC,0,1559133
galEp3,0.047619047619047616,20,20,AAAGGTAAAGGCTGACGTAT,0,1549009
galEp3,0.05,19,19,TTTGAGAACTTCGGTGGCAG,0,1562230
galEp3,0.05,19,19,TTGACCGAAGGCCCGAGGTT,0,1550207
galEp3,0.05,19,19,TTCCTAGCCCATCCTGTAGC,0,1591049
galEp3,0.05,19,19,TTCAAGCCCTGAGAAGGGTA,0,1589423
galEp3,0.05,19,19,TGTGTGAACTAAGGCGCCTG,0,1554173
galEp3,0.05,19,19,TGTACATAGGTTGCACACCA,0,1581212
galEp3,0.05,19,19,TGGTCGCCGAACTTGCCAAG,0,1592052
galEp3,0.05,19,19,TGGCGGGGTTTTATAATGGC,0,1568641
galEp3,0.05,19,19,TGGCATGGGATCTTATCACC,0,1586910
galEp3,0.05,19,19,TGGAGTACTTTTTGCGTCGT,0,1559313
galEp3,0.05,19,19,TGCTAGAGGAGTGCCAAGAT,0,1555088
galEp3,0.05,19,19,TGCGCTCGGTATGCAATGCG,0,1558729
galEp3,0.05,19,19,TGATTAGCCTGTGTGACGCG,0,1592516
galEp3,0.05,19,19,TGACAAAAAGTGCACTAATA,0,1580116
galEp3,0.05,19,19,TCTGACGTGATCGACTCAAG,0,1569437
galEp3,0.05,19,19,TCTCTAGCCATACGTCGGAA,0,1549666
galEp3,0.05,19,19,TCGTGGTTCAGGTCCCGTGA,0,1592494
galEp3,0.05,19,19,TCGTGATCGCAACTGGAGTC,0,1567134
galEp3,0.05,19,19,TCGTCTCCAAACTGAGGATG,0,1563561
galEp3,0.05,19,19,TCGCGTGTAGGTTATCAAGG,0,1581269
galEp3,0.05,19,19,TCGCATGGACGTTTGTTGTT,0,1556617
galEp3,0.05,19,19,TCCGCATAGCTGTGCTTTAC,0,1560875
galEp3,0.05,19,19,TCATAACTTTCGGCATCTAT,0,1557592
galEp3,0.05,19,19,TCAGTCGAACCAGATCACTT,0,1587928
galEp3,0.05,19,19,TATGGTGGCAGGGCGAGATA,0,1564076
galEp3,0.05,19,19,TATGCATATTGTGGTGGCAG,0,1548081
galEp3,0.05,19,19,TATACGGCCCGATAGTCGCA,0,1566929
galEp3,0.05,19,19,TACTTCGACGTTGGTCCGTT,0,1566419
galEp3,0.05,19,19,TACTGCGGATCAAGAGACGT,0,1592647
galEp3,0.05,19,19,GTTTCATTGTCCTTACCTAT,0,1588431
galEp3,0.05,19,19,GTTGAAGGAACTTCAACCGG,0,1587050
galEp3,0.05,19,19,GTTCTACCTCTTGGGATCCA,0,1546438
galEp3,0.05,19,19,GTTAGCTAGCCTCAACATTG,0,1590943
galEp3,0.05,19,19,GTGTGGACGTTACGTTGGCA,0,1546548
galEp3,0.05,19,19,GTGTACGGGCCGACCGGCGA,0,1572742
galEp3,0.05,19,19,GTGGGCGTTCATAGGCCTGC,0,1587564
galEp3,0.05,19,19,GTGCCGACACTAGAGGATGC,0,1573163
galEp3,0.05,19,19,GTGAGGTCGGTGACGGATGC,0,1575590
galEp3,0.05,19,19,GTGACGCGTGGTTCAAGGCT,0,1564801
galEp3,0.05,19,19,GTCTGGGTTCGGCCGCCGAG,0,1555221
galEp3,0.05,19,19,GTCAGCTTGAGAGCCGTGGT,0,1550055
galEp3,0.05,19,19,GTCAAGACAGCTGTGCCCAG,0,1550641
galEp3,0.05,19,19,GTACGTTAGCATCGCGATCA,0,1547344
galEp3,0.05,19,19,GTACCTGGGCACCTACTGAA,0,1552309
galEp3,0.05,19,19,GTAAAGGAGTCCTTTGCCAG,0,1547324
galEp3,0.05,19,19,GGTTAATTGATGCATGACGC,0,1554591
galEp3,0.05,19,19,GGTGCGCTTTTAGTGGTTCA,0,1585810
galEp3,0.05,19,19,GGTATCACGGCACCATCGAA,0,1574733
galEp3,0.05,19,19,GGGGGGGCCATTTAAGCACC,0,1572039
galEp3,0.05,19,19,GGGGAGTACGAAAATAGGGA,0,1593978
galEp3,0.05,19,19,GGGCCTCCCCATACTCTGCA,0,1555780
galEp3,0.05,19,19,GGGCAAGGACCATGATGATG,0,1584767
galEp3,0.05,19,19,GGGACTCACGAGTAATTTCA,0,1546722
galEp3,0.05,19,19,GGCATCGTTGGGAGAATCTT,0,1570955
galEp3,0.05,19,19,GGCAAGTTGGGTGTCGTTGG,0,1565171
galEp3,0.05,19,19,GGCAACGGTGGGGTCACGGT,0,1556293
galEp3,0.05,19,19,GCTAGAACTATGCGTGCTGT,0,1590437
galEp3,0.05,19,19,GCGTAGATAGTCATTGTATA,0,1571686
galEp3,0.05,19,19,GCCTTGGCCCGAGCCAGTAG,0,1582197
galEp3,0.05,19,19,GCCGAAACCGTTGAAATCAT,0,1585543
galEp3,0.05,19,19,GCCCCCCGGCTATCATGTAT,0,1558339
galEp3,0.05,19,19,GATCGACACCGGCCACGACC,0,1554222
galEp3,0.05,19,19,GATAGTCAGACATGATGTAC,0,1565172
galEp3,0.05,19,19,GAGGTTGCTGATTCAACGTA,0,1560563
galEp3,0.05,19,19,GACTACTGTATTTACGATTT,0,1563819
galEp3,0.05,19,19,GACGCATTTCCAATCAGGAC,0,1566211
galEp3,0.05,19,19,GACGATTACAAGATGCAACT,0,1556080
galEp3,0.05,19,19,GACAGTGTCCTGGATGGGAA,0,1579532
galEp3,0.05,19,19,GAACGTGCGCGAAGGCTCCG,0,1554904
galEp3,0.05,19,19,GAAAGCTCTTACGGTGTTCT,0,1585013
galEp3,0.05,19,19,CTTTTGCTCACAATCGGTCG,0,1551317
galEp3,0.05,19,19,CTTTCCTTTGTACTGTAGCA,0,1550092
galEp3,0.05,19,19,CTGTCACCACCAGCGTCCAA,0,1574960
galEp3,0.05,19,19,CTGCGAGTTCGTACTTAGCC,0,1583168
galEp3,0.05,19,19,CTGCCTCCGATCTGTCAGAG,0,1587012
galEp3,0.05,19,19,CTCTGAACTTTATTGTTCTT,0,1558630
galEp3,0.05,19,19,CTCGGTGTACGTTATTGTTC,0,1558342
galEp3,0.05,19,19,CTCGCGACCGCTCGAATAAA,0,1552420
galEp3,0.05,19,19,CTCAGAGAGACCCCACACGG,0,1567836
galEp3,0.05,19,19,CTAATGATGGCTATCCCTGA,0,1556017
galEp3,0.05,19,19,CGGGTTTTGAGTTTGTACAG,0,1582505
galEp3,0.05,19,19,CGGCGTAGCGATTTCGGAAT,0,1550398
galEp3,0.05,19,19,CGGATTCAATATTGCATAGA,0,1572362
galEp3,0.05,19,19,CGGACTCAGTCTGAAGCTAT,0,1555850
galEp3,0.05,19,19,CGCTGCCAAAAAAACTGCGT,0,1559322
galEp3,0.05,19,19,CGCTCGAAACTGACCAGCTA,0,1563715
galEp3,0.05,19,19,CGCGTATTTTCGTCAGATCT,0,1575245
galEp3,0.05,19,19,CGCGCCCACCGTTTTCTTCA,0,1569442
galEp3,0.05,19,19,CGCAAGAGTACCTGTAGCTA,0,1581005
galEp3,0.05,19,19,CGATTAATATAAGACTGGCT,0,1587397
galEp3,0.05,19,19,CGACTATACTGTTTATAGAT,0,1561126
galEp3,0.05,19,19,CGAAGGGCGTAGCTCCTACA,0,1591675
galEp3,0.05,19,19,CCTGAGGACGCTCCGATGCG,0,1553682
galEp3,0.05,19,19,CCTCACGTAAGGCGGTATCT,0,1546480
galEp3,0.05,19,19,CCGTTTGTGCGTTTTAAGGT,0,1552070
galEp3,0.05,19,19,CCGTCAATTGTAATGATTTT,0,1551106
galEp3,0.05,19,19,CCGACCAACCAGATTGTGTT,0,1547941
galEp3,0.05,19,19,CCCTACGTCCCTGGCATACT,0,1558247
galEp3,0.05,19,19,CCCGGCCGAACAATGTGCAA,0,1566824
galEp3,0.05,19,19,CATTGAATGTACTGTGAGAC,0,1546795
galEp3,0.05,19,19,CATTCAATGCGATCGTTCTA,0,1575148
galEp3,0.05,19,19,CATCCCCTCTTCTCCCAATA,0,1578115
galEp3,0.05,19,19,CATCCAGGGGAGTACTAACT,0,1550768
galEp3,0.05,19,19,CATCAATGACTTGACGCGCT,0,1548620
galEp3,0.05,19,19,CAGTTGAAGAACCATTTGGC,0,1569336
galEp3,0.05,19,19,CACTGTAGTAGTTCTCCCAA,0,1549705
galEp3,0.05,19,19,CACCGTACGCCGTTGATTCT,0,1558961
galEp3,0.05,19,19,CACAATTTCAAACCGCCCAG,0,1555177
galEp3,0.05,19,19,CACAATCGAGGGAAGCCGAT,0,1566865
galEp3,0.05,19,19,ATTTGGCTAGGAAAGGAGGT,0,1588794
galEp3,0.05,19,19,ATTTCAACGGAATGTAGCTG,0,1565504
galEp3,0.05,19,19,ATGGGGTACAGAGCCTAAAT,0,1581283
galEp3,0.05,19,19,ATGAATGACAAAAAGCCCAG,0,1557897
galEp3,0.05,19,19,ATCTCGATGACACGGGTAAT,0,1576318
galEp3,0.05,19,19,ATCATGAACGCGGGGGGCTC,0,1568287
galEp3,0.05,19,19,ATAACTATACACTACGTCAT,0,1558079
galEp3,0.05,19,19,ATAACGTTACAAATGTCGGT,0,1560805
galEp3,0.05,19,19,AGTGAGCTTGTTTTGTGGGT,0,1552580
galEp3,0.05,19,19,AGTCCCCCTTTCGCGGGCAA,0,1565202
galEp3,0.05,19,19,AGGGCGGCCCGTTGTATGGT,0,1570074
galEp3,0.05,19,19,AGGGAGCCTTTGAACCTTAG,0,1577174
galEp3,0.05,19,19,AGGCAGTGCTGGACCGAAAT,0,1561462
galEp3,0.05,19,19,AGCTACAGTATATTGCTTCC,0,1578648
galEp3,0.05,19,19,AGCGGTGACCAAGGACGTTG,0,1577939
galEp3,0.05,19,19,AGATGGCCAGTCAAGGAGAT,0,1546666
galEp3,0.05,19,19,AGAGTCAAGTCCATAATTCT,0,1591891
galEp3,0.05,19,19,AGAGATTGTAAATGCTTGAT,0,1567944
galEp3,0.05,19,19,AGACCGAGGCGGCCCTATCA,0,1550038
galEp3,0.05,19,19,AGACACCTCCAAAGGCAGTG,0,1561452
galEp3,0.05,19,19,ACTGAGAACCGGTATACGAT,0,1579151
galEp3,0.05,19,19,ACTAGCGCCGCAGTCTCAGT,0,1573426
galEp3,0.05,19,19,ACGTGTTAGTCCGCACCGGG,0,1570138
galEp3,0.05,19,19,ACGTCGTGCAATTGAAGATT,0,1584421
galEp3,0.05,19,19,ACGCCTACTCTCCGTGCCTT,0,1561645
galEp3,0.05,19,19,ACCGCTCGAAGGACAGAGTA,0,1555158
galEp3,0.05,19,19,ACCAGTGGCTCGTTAACTAA,0,1560163
galEp3,0.05,19,19,ACCACTGTACTCCGTGGCGA,0,1564932
galEp3,0.05,19,19,ACAAGATCAATTTAAAACGA,0,1592175
galEp3,0.05,19,19,AATGACTACGTCCTGAGGTG,0,1556053
galEp3,0.05,19,19,AATCGCATTGTGTCACGGTA,0,1565857
galEp3,0.05,19,19,AAGTCGGGTAAGCGCCGGGG,0,1577453
galEp3,0.05,19,19,AAGATGAGGTAAGGCCTCAG,0,1561591
galEp3,0.05,19,19,AACGGTGTTAAGCGCGCTGC,0,1569038
galEp3,0.05,19,19,AACGCGACACGCCATCGTCT,0,1562657
galEp3,0.05,19,19,AACGCATTTCTACATGCTAC,0,1551874
galEp3,0.05,19,19,AACAAGCTGGGGGTGCCGCA,0,1548051
galEp3,0.05,19,19,AAATAGATCTAACTCGCATC,0,1578499
galEp3,0.05,19,19,AAAACGAATGACCTGACTGA,0,1549355
galEp3,0.05263157894736842,18,18,TTTAAGGGACGTCGGGGAAA,0,1555554
galEp3,0.05263157894736842,18,18,TTTAAGAAGTGCGGTAATTT,0,1568503
galEp3,0.05263157894736842,18,18,TTGTCTAACGTGACGTACCT,0,1571809
galEp3,0.05263157894736842,18,18,TTGGTTGAGTACTTAGCTAA,0,1560379
galEp3,0.05263157894736842,18,18,TTGGATCTTGTGAACCAGGT,0,1576163
galEp3,0.05263157894736842,18,18,TTGCTCGTGAGTGACTCTTC,0,1567393
galEp3,0.05263157894736842,18,18,TTCTGTTTGGGTTAACCGGG,0,1581529
galEp3,0.05263157894736842,18,18,TTCTGGAATCGAATCCAACA,0,1553064
galEp3,0.05263157894736842,18,18,TTCGCGTCCGCTTCAAAGCG,0,1561460
galEp3,0.05263157894736842,18,18,TTCACGCATTCTCTTCTCCT,0,1563762
galEp3,0.05263157894736842,18,18,TTATGGCCTTCCTTTGGTGA,0,1564460
galEp3,0.05263157894736842,18,18,TTAGATGACTATGAACCAGT,0,1582075
galEp3,0.05263157894736842,18,18,TTAAAGAAAGCGCACCGAGG,0,1558030
galEp3,0.05263157894736842,18,18,TGTTTACCGACGAAAGAGAA,0,1556478
galEp3,0.05263157894736842,18,18,TGTGACAAACTGCGCATGGC,0,1559938
galEp3,0.05263157894736842,18,18,TGTCAGCGGGCTGAGAACTA,0,1574117
galEp3,0.05263157894736842,18,18,TGTAAGGTTTTATCACACAG,0,1549911
galEp3,0.05263157894736842,18,18,TGGTCTGTCTCCTGCACGAA,0,1584505
galEp3,0.05263157894736842,18,18,TGGCCATTATGGGGTAAAGG,0,1557925
galEp3,0.05263157894736842,18,18,TGCTGTGTATATTCGGTAGA,0,1570357
galEp3,0.05263157894736842,18,18,TGCTAGGTCCCGGTCTCGGT,0,1564117
galEp3,0.05263157894736842,18,18,TGCCTATCTAGTCATTGGAG,0,1566408
galEp3,0.05263157894736842,18,18,TGATTGTCTAGCACTGTGAC,0,1573815
galEp3,0.05263157894736842,18,18,TGACGTGCTCATGCAGCGAT,0,1589352
galEp3,0.05263157894736842,18,18,TGAACGCGACGGGCTTCCGG,0,1578117
galEp3,0.05263157894736842,18,18,TCTGATCAAAGCCACTGTGT,0,1553550
galEp3,0.05263157894736842,18,18,TCTCTTCACTGGCTTCGGTT,0,1561171
galEp3,0.05263157894736842,18,18,TCTAGAATCACTATTGAAGG,0,1570073
galEp3,0.05263157894736842,18,18,TCTACACTCGGGGAGACGGT,0,1570890
galEp3,0.05263157894736842,18,18,TCGTCCAGGACCGGGCATAA,0,1575863
galEp3,0.05263157894736842,18,18,TCGCCGCCAGGGCACTAGAC,0,1565018
galEp3,0.05263157894736842,18,18,TCGCAGAGGTGAGGCTTCGG,0,1576896
galEp3,0.05263157894736842,18,18,TCGACGAAAGCAACGCGCCA,0,1559618
galEp3,0.05263157894736842,18,18,TCCATTCTCGCAATGGATCA,0,1575394
galEp3,0.05263157894736842,18,18,TCCACCTCACTGGCTCTGGT,0,1553340
galEp3,0.05263157894736842,18,18,TCAGACTTTGAGAACGAGGA,0,1562399
galEp3,0.05263157894736842,18,18,TCACCACAGAATTAAAGTTT,0,1563909
galEp3,0.05263157894736842,18,18,TCAACGAGTAGGTTGGGTAA,0,1548458
galEp3,0.05263157894736842,18,18,TCAACAGCTCGTACACAGCT,0,1565232
galEp3,0.05263157894736842,18,18,TCAAATAGTCGTCCGCTGAA,0,1564463
galEp3,0.05263157894736842,18,18,TAGGTTTAAGTACTGTGTCG,0,1560590
galEp3,0.05263157894736842,18,18,TAGCCGTCATTGGAGCCGGA,0,1591886
galEp3,0.05263157894736842,18,18,TACTTCAACGCCAGTAGCAT,0,1555824
galEp3,0.05263157894736842,18,18,TACTGCCTGAAGGCCTGTGG,0,1589671
galEp3,0.05263157894736842,18,18,TACCATGTTGACCCTTGCCT,0,1551138
galEp3,0.05263157894736842,18,18,TAATTCAGTGACCGCCACTC,0,1555426
galEp3,0.05263157894736842,18,18,TAATCTTTATACCACTCCGA,0,1571866
galEp3,0.05263157894736842,18,18,TAATCTAGCGACAACCGTAA,0,1585915
galEp3,0.05263157894736842,18,18,TAACCCCCAACCATGTCGTT,0,1587372
galEp3,0.05263157894736842,18,18,TAAAGCTTACAGATTACTAA,0,1572046
galEp3,0.05263157894736842,18,18,TAAAAATGAGTTCGGACTCA,0,1566869
galEp3,0.05263157894736842,18,18,GTTCGTAAAATCTGATGGCT,0,1555050
galEp3,0.05263157894736842,18,18,GTTATTCGCGCGTTTCTTTC,0,1550208
galEp3,0.05263157894736842,18,18,GTGGTGTTTGTTATTTGACA,0,1582533
galEp3,0.05263157894736842,18,18,GTGAGGATAATAGCTCGTAG,0,1591981
galEp3,0.05263157894736842,18,18,GTGACAGTTATGCTACTTAG,0,1550144
galEp3,0.05263157894736842,18,18,GTCTAACTAGATATCCGGTT,0,1565133
galEp3,0.05263157894736842,18,18,GTCCGCCAGTCATTTTTCTG,0,1553808
galEp3,0.05263157894736842,18,18,GTCCATTTGTACTGTATTAA,0,1586731
galEp3,0.05263157894736842,18,18,GTCAATTGAGCATCACGGAT,0,1566391
galEp3,0.05263157894736842,18,18,GTATTGTCACCGCGCCTCTT,0,1580526
galEp3,0.05263157894736842,18,18,GTAGCAAACTTGCAGCATGG,0,1563369
galEp3,0.05263157894736842,18,18,GTACAAAGACATACGCCACA,0,1547247
galEp3,0.05263157894736842,18,18,GGTGGTTGCGAACTCTACAC,0,1554903
galEp3,0.05263157894736842,18,18,GGGTCGGCAGGAGGGGACTA,0,1556256
galEp3,0.05263157894736842,18,18,GGGAAACTTCTCGGGCACTC,0,1575503
galEp3,0.05263157894736842,18,18,GGCCAGGAAAACGATTATCA,0,1553057
galEp3,0.05263157894736842,18,18,GGATTGTCTACTTTGGACTG,0,1551008
galEp3,0.05263157894736842,18,18,GGACACATAGAGGAAGACCA,0,1575478
galEp3,0.05263157894736842,18,18,GGAAGAATTAACTCCCAGGA,0,1566585
galEp3,0.05263157894736842,18,18,GCTCACCTCGATCATAACGT,0,1559749
galEp3,0.05263157894736842,18,18,GCTATGAGCACAGCTCGTAT,0,1555522
galEp3,0.05263157894736842,18,18,GCGCTGATCGTGTCTTTGAC,0,1569305
galEp3,0.05263157894736842,18,18,GCGAGTCTATAAATTACGTG,0,1577723
galEp3,0.05263157894736842,18,18,GCGACGGACCGTCCGCGTTA,0,1554614
galEp3,0.05263157894736842,18,18,GCGAATCATTGCCTACGATA,0,1589251
galEp3,0.05263157894736842,18,18,GCCTCTGCGGGGCTTTTAAA,0,1566175
galEp3,0.05263157894736842,18,18,GCATGTACTATTATATTGGC,0,1555556
galEp3,0.05263157894736842,18,18,GCACTGGCTTCCCCGAAAAA,0,1577373
galEp3,0.05263157894736842,18,18,GCAAGAATTCGTTCGCTGTA,0,1583485
galEp3,0.05263157894736842,18,18,GCAAACAGAGTTCAGTACTT,0,1548970
galEp3,0.05263157894736842,18,18,GATTAACCACCTCTCGATTT,0,1574538
galEp3,0.05263157894736842,18,18,GATAGCAATACATGCGGAAC,0,1569846
galEp3,0.05263157894736842,18,18,GAGTTTCCCAGTTCCTGCAT,0,1554758
galEp3,0.05263157894736842,18,18,GAGTTAGGTCTACAATAGTA,0,1564549
galEp3,0.05263157894736842,18,18,GAGGGTGCGCGACGCCTGAC,0,1577969
galEp3,0.05263157894736842,18,18,GAGCTATAGTTGTGCAGGGA,0,1557022
galEp3,0.05263157894736842,18,18,GAGAGTTGCCTACAAGGCTA,0,1557427
galEp3,0.05263157894736842,18,18,GACTGCACTCGTGGTTTTTA,0,1576364
galEp3,0.05263157894736842,18,18,GACTCGCATCGGCCGGCAGG,0,1558014
galEp3,0.05263157894736842,18,18,GACCTCAGGGAGCTTGTAGA,0,1574706
galEp3,0.05263157894736842,18,18,GACCGGACCGAGGGACTTAC,0,1581602
galEp3,0.05263157894736842,18,18,GAATCCAGAAGGTCCTACTT,0,1585525
galEp3,0.05263157894736842,18,18,GAAGTTATCTGGTGCGTAAC,0,1551408
galEp3,0.05263157894736842,18,18,GAAAGGTTTTAACCTCTAAC,0,1589437
galEp3,0.05263157894736842,18,18,CTGGTTTTACACTCGATCTC,0,1591798
galEp3,0.05263157894736842,18,18,CTGGTCTTGACCGATATTGT,0,1585348
galEp3,0.05263157894736842,18,18,CTGGTCAGAGGTATCGGGCT,0,1580642
galEp3,0.05263157894736842,18,18,CTCTCCTGATTGGAGTAATC,0,1583548
galEp3,0.05263157894736842,18,18,CTCTAGCAGTTTCGTCTACG,0,1584742
galEp3,0.05263157894736842,18,18,CTCCGTAATGCCAACCATCT,0,1559387
galEp3,0.05263157894736842,18,18,CTAGTTCTCGTCCTTTTCGG,0,1560428
galEp3,0.05263157894736842,18,18,CGTTAAAATGTACGGGGATT,0,1546567
galEp3,0.05263157894736842,18,18,CGTGTAAAGTCACCACCTGA,0,1581314
galEp3,0.05263157894736842,18,18,CGTGGCTCAGCTGCATTAAA,0,1575588
galEp3,0.05263157894736842,18,18,CGTGGAGTCGCATACACGAT,0,1586403
galEp3,0.05263157894736842,18,18,CGTGCCCACCGCATTCGCTA,0,1589774
galEp3,0.05263157894736842,18,18,CGTGATTCATACAGTGTACT,0,1588233
galEp3,0.05263157894736842,18,18,CGTGACATAGTAACGATTTT,0,1584890
galEp3,0.05263157894736842,18,18,CGTAATCACGCTTAAAGTTA,0,1549091
galEp3,0.05263157894736842,18,18,CGTAACCGGCCGGTGAGGAA,0,1551887
galEp3,0.05263157894736842,18,18,CGGTCAGCTATAGGTTGGTC,0,1576892
galEp3,0.05263157894736842,18,18,CGGGGGCTATAACCTAATGC,0,1554332
galEp3,0.05263157894736842,18,18,CGGCTGAAGACTCAAAACAG,0,1556567
galEp3,0.05263157894736842,18,18,CGGCGGCTTTGTGTACACGC,0,1567325
galEp3,0.05263157894736842,18,18,CGCTCCGAATTGTTATCAGG,0,1560399
galEp3,0.05263157894736842,18,18,CGCTACACAGATATGGGGAA,0,1589211
galEp3,0.05263157894736842,18,18,CGCGCGAGGTCGGCATGGAT,0,1557174
galEp3,0.05263157894736842,18,18,CGATTATAATGAAGAGCCGC,0,1573051
galEp3,0.05263157894736842,18,18,CGAGACAAGTCTCATTGCTC,0,1579147
galEp3,0.05263157894736842,18,18,CCTCTAGATTCCCAGGTAGT,0,1568393
galEp3,0.05263157894736842,18,18,CCTATTCATATAGGTAACGT,0,1566527
galEp3,0.05263157894736842,18,18,CCGTCTACTTCGGCAGTCAT,0,1547627
galEp3,0.05263157894736842,18,18,CCGGAGGCCACATTTATCGA,0,1585738
galEp3,0.05263157894736842,18,18,CCCTGGCCCAATTAAGGCCC,0,1551350
galEp3,0.05263157894736842,18,18,CCCTGAGACTCTACTCATCA,0,1588599
galEp3,0.05263157894736842,18,18,CCCGTGAAGCTTAGTCTACT,0,1562336
galEp3,0.05263157894736842,18,18,CCCGAGGTCGCCAGGATTAC,0,1577179
galEp3,0.05263157894736842,18,18,CCCAAGGTAAGGTGAGACCA,0,1559911
galEp3,0.05263157894736842,18,18,CCATTTAGACCTCCTGCCGG,0,1586968
galEp3,0.05263157894736842,18,18,CCATTGTTTGCTTCGGTCGT,0,1552435
galEp3,0.05263157894736842,18,18,CCAAGTTCGCGTGTCGTCCA,0,1559691
galEp3,0.05263157894736842,18,18,CATTTGTGAACTTAGGGCGC,0,1588875
galEp3,0.05263157894736842,18,18,CATTCCAACGTCTGTCATAG,0,1546868
galEp3,0.05263157894736842,18,18,CATGGTACCAGGCTTTGTTC,0,1552657
galEp3,0.05263157894736842,18,18,CATCACTTCAGCCTGTTCAA,0,1561716
galEp3,0.05263157894736842,18,18,CATCACGAAGTTGAACGAAT,0,1565219
galEp3,0.05263157894736842,18,18,CATATATGCGAGGCAGTCCA,0,1559172
galEp3,0.05263157894736842,18,18,CAGTGGGGATATCGGGGTAG,0,1591052
galEp3,0.05263157894736842,18,18,CAGTCTGCCGGTAACTTCGA,0,1577527
galEp3,0.05263157894736842,18,18,CAGGCGTCACAACAACCGAG,0,1546799
galEp3,0.05263157894736842,18,18,CACTCGTACTATAGAGTCAT,0,1566072
galEp3,0.05263157894736842,18,18,CACTCACGGATCCGCCTAGC,0,1581472
galEp3,0.05263157894736842,18,18,CACGTCGGTTCCATCTGTTA,0,1561392
galEp3,0.05263157894736842,18,18,ATTGGGATGTGATTTTTTAT,0,1551740
galEp3,0.05263157894736842,18,18,ATGTACACTGCTTGCAAAAT,0,1548728
galEp3,0.05263157894736842,18,18,ATGGTCCTTAATGCTATACA,0,1570419
galEp3,0.05263157894736842,18,18,ATCGTAGTCTTTCCCGTACT,0,1575182
galEp3,0.05263157894736842,18,18,ATCCGAGTATGTGGGTGGGT,0,1549165
galEp3,0.05263157894736842,18,18,ATCAGTTGTTTTGCCATATC,0,1569319
galEp3,0.05263157894736842,18,18,ATATAGCAATCTGGATCGAT,0,1549781
galEp3,0.05263157894736842,18,18,ATAATCACGGGCAACTGCGT,0,1555397
galEp3,0.05263157894736842,18,18,ATAACTTCGCAACTCGAGCA,0,1561632
galEp3,0.05263157894736842,18,18,ATAAACCCCGCTGCGGTAAA,0,1573637
galEp3,0.05263157894736842,18,18,AGTGTTGGCGTGCCCTTCCA,0,1583072
galEp3,0.05263157894736842,18,18,AGTGCCTCTCGTCGCTGATC,0,1574760
galEp3,0.05263157894736842,18,18,AGTACGTGGGACCCACGTGG,0,1569438
galEp3,0.05263157894736842,18,18,AGGGTACACGATCCATCCTT,0,1553307
galEp3,0.05263157894736842,18,18,AGGGCACATTCGCCCTTCCA,0,1587665
galEp3,0.05263157894736842,18,18,AGGCAGATTTGATACGTCAG,0,1567184
galEp3,0.05263157894736842,18,18,AGCTGGAGAAAAGCGGGTGG,0,1552588
galEp3,0.05263157894736842,18,18,AGCACTCTTACAATAAATGT,0,1551406
galEp3,0.05263157894736842,18,18,AGAACGGACCGGCCCGGGAG,0,1582485
galEp3,0.05263157894736842,18,18,AGAAAATGCCATACTCTGGT,0,1546792
galEp3,0.05263157894736842,18,18,ACTTGAGTACACAGGTCACT,0,1579768
galEp3,0.05263157894736842,18,18,ACTACGAAAACCCGTTCAGC,0,1550223
galEp3,0.05263157894736842,18,18,ACGTGCTCGAGGCGGATTGC,0,1551590
galEp3,0.05263157894736842,18,18,ACGGAATGTGCGTAAGGTGC,0,1559340
galEp3,0.05263157894736842,18,18,ACGCGAGGCTTCGAGTCCTA,0,1566105
galEp3,0.05263157894736842,18,18,ACGCAAAATTGCTGTGGTTT,0,1583325
galEp3,0.05263157894736842,18,18,ACGAGACGTCGAAGCTAAGG,0,1553814
galEp3,0.05263157894736842,18,18,ACCTTCACGTAATAGATACA,0,1553384
galEp3,0.05263157894736842,18,18,ACCGTGGTCGAGGGCCGCTT,0,1570758
galEp3,0.05263157894736842,18,18,ACCGGGACAGGGGGCGAATA,0,1549499
galEp3,0.05263157894736842,18,18,ACCCACGTTGGACCCTCGAC,0,1589354
galEp3,0.05263157894736842,18,18,ACCAGTCCGGTTTCAGCGAA,0,1563838
galEp3,0.05263157894736842,18,18,ACATCGTGGAGTCCGCCGAC,0,1572859
galEp3,0.05263157894736842,18,18,ACAGCTGAACATGGCACAAG,0,1584195
galEp3,0.05263157894736842,18,18,AATGATATGAAGCAGGCTCA,0,1546932
galEp3,0.05263157894736842,18,18,AATGAGCATGGGATATCATG,0,1548543
galEp3,0.05263157894736842,18,18,AATCGGGGCTAACTGACCTT,0,1548261
galEp3,0.05263157894736842,18,18,AATAAGTGCCTCGGCTATTG,0,1552934
galEp3,0.05263157894736842,18,18,AAGTGCTTAAACAATGAATG,0,1576494
galEp3,0.05263157894736842,18,18,AAGGGAGACAGAGCATTCAA,0,1591755
galEp3,0.05263157894736842,18,18,AAGGCATTCCGAGAAGTGTA,0,1582007
galEp3,0.05263157894736842,18,18,AAGCGTTGACGGCTAAGCAA,0,1550388
galEp3,0.05263157894736842,18,18,AAGACATCGTATCTAGCCGC,0,1562867
galEp3,0.05263157894736842,18,18,AACCACGTCAAATGGGGCAT,0,1549670
galEp3,0.05263157894736842,18,18,AACCACCGTTGCTTCACCCC,0,1549364
galEp3,0.05263157894736842,18,18,AAAGTTGGAAAGCTCTGAAG,0,1588687
galEp3,0.05263157894736842,18,18,AAACCCTAGAATATATACAG,0,1572118
galEp3,0.05263157894736842,18,18,AAACCAGATGATTGGGTATA,0,1585944
galEp3,0.05263157894736842,18,18,AAACAAGGACGACGTTAATC,0,1563253
galEp3,0.05555555555555555,17,17,TTTTTTCAGTCTACATGTGA,0,1574080
galEp3,0.05555555555555555,17,17,TTTGTATAACTCGCTGAGTG,0,1580354
galEp3,0.05555555555555555,17,17,TTTCGAACGTCTATCAACCT,0,1573581
galEp3,0.05555555555555555,17,17,TTGTTCCCTGCGGGTGCGAT,0,1550433
galEp3,0.05555555555555555,17,17,TTGGCTTCTCTTCCCTTAAT,0,1567294
galEp3,0.05555555555555555,17,17,TTGCTACGATAGTGTGAATA,0,1548637
galEp3,0.05555555555555555,17,17,TTGCCCGACCCTGCTCAAGC,0,1557818
galEp3,0.05555555555555555,17,17,TTGACCGCTTGGAAGTCCAC,0,1579002
galEp3,0.05555555555555555,17,17,TTCTGTCCATCCTTACGAAT,0,1555895
galEp3,0.05555555555555555,17,17,TTCTATAGCCCGGTTATTAA,0,1568876
galEp3,0.05555555555555555,17,17,TTCGCCATACATCTGTGTAG,0,1554742
galEp3,0.05555555555555555,17,17,TGTTAACAAACCTTAAAAAG,0,1569435
galEp3,0.05555555555555555,17,17,TGGTAACGGCGCTCGGCCTG,0,1555193
galEp3,0.05555555555555555,17,17,TGGCTTTCTACAGAGCAGCG,0,1549084
galEp3,0.05555555555555555,17,17,TGACTAGGACCGGAAGCCGT,0,1575945
galEp3,0.05555555555555555,17,17,TGACCAGGCCACGATCGGTG,0,1582443
galEp3,0.05555555555555555,17,17,TCTACTCATGAATGTTCCCT,0,1556682
galEp3,0.05555555555555555,17,17,TCGGATGGGAATCTAATCTA,0,1575149
galEp3,0.05555555555555555,17,17,TCGCCAATATTACCAGGTCT,0,1574847
galEp3,0.05555555555555555,17,17,TCGAGCGTAAAAGTGACATT,0,1594154
galEp3,0.05555555555555555,17,17,TCCTTGTTTCATAAGCAATG,0,1572326
galEp3,0.05555555555555555,17,17,TCCGCGTCTAAAAGGAGTGA,0,1562170
galEp3,0.05555555555555555,17,17,TCCCGGAAAGGTCGGACACT,0,1559290
galEp3,0.05555555555555555,17,17,TCCCCAAGGCTCGCTGATTC,0,1566868
galEp3,0.05555555555555555,17,17,TCCCAGAAGGTTTCTATGTA,0,1550493
galEp3,0.05555555555555555,17,17,TCCAGGCTCAAAAAATCGAT,0,1559824
galEp3,0.05555555555555555,17,17,TCATGTTGGACCCAATGTAG,0,1576340
galEp3,0.05555555555555555,17,17,TCATCATACTAATTCTCGTA,0,1560253
galEp3,0.05555555555555555,17,17,TCACTAAGCATTGGTTTAGT,0,1583539
galEp3,0.05555555555555555,17,17,TCAATTTCGGATTGTAACTG,0,1577572
galEp3,0.05555555555555555,17,17,TCAACCCCTAACAGACCCTT,0,1555561
galEp3,0.05555555555555555,17,17,TCAACAAAACCCAGGGCAGC,0,1549661
galEp3,0.05555555555555555,17,17,TCAAAATTACGTTCTCCGGT,0,1585077
galEp3,0.05555555555555555,17,17,TATACTCTTTGACTCTTCTT,0,1565424
galEp3,0.05555555555555555,17,17,TAGGTGGCTAATGTATGAGA,0,1566385
galEp3,0.05555555555555555,17,17,TAGGTAGGCCCACACTGTAC,0,1552298
galEp3,0.05555555555555555,17,17,TAGGGACATCTGGGGCACAA,0,1550833
galEp3,0.05555555555555555,17,17,TAGCAGGGTGCGCGGTGAGT,0,1563852
galEp3,0.05555555555555555,17,17,TACGCAACGAGTATATTTTT,0,1578249
galEp3,0.05555555555555555,17,17,TACACGGTCTCCGCTCTGAT,0,1588726
galEp3,0.05555555555555555,17,17,TAATGCAGCGAAACTGCGGT,0,1574782
galEp3,0.05555555555555555,17,17,TAACGAGGTTGGCTAGTATT,0,1588356
galEp3,0.05555555555555555,17,17,TAACCGGGGCAGTGTCGTCA,0,1578646
galEp3,0.05555555555555555,17,17,GTTGCGAAAGGAGCGAACTC,0,1565212
galEp3,0.05555555555555555,17,17,GTTCGTACTCCAAATTGGTT,0,1578509
galEp3,0.05555555555555555,17,17,GTTAGGAAAATTAATGATGA,0,1586961
galEp3,0.05555555555555555,17,17,GTGAGCCGTGATCATACATT,0,1549220
galEp3,0.05555555555555555,17,17,GTCGTGCTTCGGTGACGAGT,0,1565218
galEp3,0.05555555555555555,17,17,GTCGATAAGTATGATAGTAC,0,1570157
galEp3,0.05555555555555555,17,17,GTCCGGTATCATGTCGTAGG,0,1584002
galEp3,0.05555555555555555,17,17,GTATGTGAGGTGCTGAACCT,0,1584828
galEp3,0.05555555555555555,17,17,GTACATCATAAGTGCAACAT,0,1558174
galEp3,0.05555555555555555,17,17,GTAATATGCTAAGAAGAGGA,0,1593939
galEp3,0.05555555555555555,17,17,GGTCTCCAGACGCTTGTTCC,0,1566294
galEp3,0.05555555555555555,17,17,GGTCGGACTGACGGCTATCT,0,1592893
galEp3,0.05555555555555555,17,17,GGTACCATGCCCAATACGTG,0,1552917
galEp3,0.05555555555555555,17,17,GGGTTTAACCTGGCGAAGCT,0,1562325
galEp3,0.05555555555555555,17,17,GGGGGATTAGATACCTGCCA,0,1582444
galEp3,0.05555555555555555,17,17,GGGCCGCGGGCGAGTCTTGC,0,1586953
galEp3,0.05555555555555555,17,17,GGGAGCATTTTTGTTCCAGC,0,1559970
galEp3,0.05555555555555555,17,17,GGGAAGGGGAGAAGTGTTGC,0,1556622
galEp3,0.05555555555555555,17,17,GGCTTACCCCTCAACCGACG,0,1549873
galEp3,0.05555555555555555,17,17,GGCTGTCTCATGCGCATCTA,0,1558379
galEp3,0.05555555555555555,17,17,GGCTAGGTTTTACTAATAAT,0,1555517
galEp3,0.05555555555555555,17,17,GGCTAAGCTCATAAGTGCCT,0,1576623
galEp3,0.05555555555555555,17,17,GGCAACCCGTCTTCGGTCAC,0,1582883
galEp3,0.05555555555555555,17,17,GGATGTTATCAAACAAACAT,0,1582817
galEp3,0.05555555555555555,17,17,GGAGCAGAAGCAAAGGACGA,0,1592186
galEp3,0.05555555555555555,17,17,GGACCCAGCAGTAGATACAT,0,1565246
galEp3,0.05555555555555555,17,17,GCTTGTATGCAAATTATCGC,0,1593996
galEp3,0.05555555555555555,17,17,GCTTGATACGCACGCAGCGC,0,1588901
galEp3,0.05555555555555555,17,17,GCTTCAATTGGTGAAAGGTG,0,1554363
galEp3,0.05555555555555555,17,17,GCGTCTATGCGGTGTCACCA,0,1571004
galEp3,0.05555555555555555,17,17,GCGGCTCGGCCACCTAGTAG,0,1579144
galEp3,0.05555555555555555,17,17,GCGACGGTAGAAGGATTTTG,0,1580581
galEp3,0.05555555555555555,17,17,GCCTTCCGGAAGGGACCAAG,0,1578353
galEp3,0.05555555555555555,17,17,GCCGGTACCCAGTCCCTAAA,0,1576695
galEp3,0.05555555555555555,17,17,GCCCTAAACACGTACGTGAA,0,1580417
galEp3,0.05555555555555555,17,17,GCCCGTCTGCATTAGACAGA,0,1561135
galEp3,0.05555555555555555,17,17,GCAGGCGTTTATCATTAGTT,0,1594325
galEp3,0.05555555555555555,17,17,GCAGCCATACATGGTGCTGA,0,1562059
galEp3,0.05555555555555555,17,17,GCACTCAGGAGGATCCATAT,0,1552522
galEp3,0.05555555555555555,17,17,GCACAAGTCCAAGGTTAAAG,0,1552203
galEp3,0.05555555555555555,17,17,GCAATATTGATGAGGCACGT,0,1566017
galEp3,0.05555555555555555,17,17,GCAAGATATCCTTGAGTCGC,0,1554478
galEp3,0.05555555555555555,17,17,GATCCATGATGCCCATACAA,0,1574230
galEp3,0.05555555555555555,17,17,GATAGGCACCCGTTACAAAT,0,1576253
galEp3,0.05555555555555555,17,17,GATAGGAGCTTTAGGGACAA,0,1546840
galEp3,0.05555555555555555,17,17,GATACAGTACGTGAAGCATG,0,1562017
galEp3,0.05555555555555555,17,17,GAGGTAACTCCCATGTCTGT,0,1590033
galEp3,0.05555555555555555,17,17,GAGGGTAGTTGCATAGTGGA,0,1548900
galEp3,0.05555555555555555,17,17,GACGGGACGAAAAGGCTGGC,0,1574791
galEp3,0.05555555555555555,17,17,GACACACTACGGAAATTCTA,0,1592371
galEp3,0.05555555555555555,17,17,GAATATTTGGCAACAGTGAA,0,1583421
galEp3,0.05555555555555555,17,17,GAAGTGTGGTTAGGGTATCA,0,1555813
galEp3,0.05555555555555555,17,17,GAAGGGTAAGAGCCGCTCCA,0,1566571
galEp3,0.05555555555555555,17,17,GAACGGCCGCACTAAGGATT,0,1571192
galEp3,0.05555555555555555,17,17,GAAATGCGGTACAAGTTGTT,0,1572154
galEp3,0.05555555555555555,17,17,GAAACACTGCGACCTGCGGA,0,1588049
galEp3,0.05555555555555555,17,17,GAAAACATTCAGTCGGCCAA,0,1578922
galEp3,0.05555555555555555,17,17,CTTGTTCGTCAGGCGCAGGG,0,1570212
galEp3,0.05555555555555555,17,17,CTTATTTCGGTCAGCTAAAT,0,1577628
galEp3,0.05555555555555555,17,17,CTTACATCACTCCATTGCGT,0,1556258
galEp3,0.05555555555555555,17,17,CTGGGTTAATCTCACGATAT,0,1569875
galEp3,0.05555555555555555,17,17,CTCCTCAGTGTGCACGCTCT,0,1565594
galEp3,0.05555555555555555,17,17,CTCAGTCTGTACTATTCTAC,0,1557796
galEp3,0.05555555555555555,17,17,CTATTCGCAAACCAGCCGGA,0,1550766
galEp3,0.05555555555555555,17,17,CTATCCCCTGGAGCGCTACT,0,1563670
galEp3,0.05555555555555555,17,17,CTAGCCGTGTACCTCTCGCA,0,1588210
galEp3,0.05555555555555555,17,17,CGTATGCGCCATAGCATTTA,0,1553694
galEp3,0.05555555555555555,17,17,CGTAATTAATGACCTGTTTT,0,1575226
galEp3,0.05555555555555555,17,17,CGTAATCATGATCTTATCGT,0,1586074
galEp3,0.05555555555555555,17,17,CGGTTTACAGCCCCGTTTGA,0,1568065
galEp3,0.05555555555555555,17,17,CGGTTGGGTACTCTGTAGTG,0,1580405
galEp3,0.05555555555555555,17,17,CGGTGCAAGCACTCATTCGA,0,1547982
galEp3,0.05555555555555555,17,17,CGGTAATGGTATGCGTACGC,0,1557084
galEp3,0.05555555555555555,17,17,CGGGATTGTTTTGTACCCGA,0,1580142
galEp3,0.05555555555555555,17,17,CGCTCCTTGGGACAGTTGAA,0,1582534
galEp3,0.05555555555555555,17,17,CGCTCCCGAGGTCCGTAGAG,0,1577390
galEp3,0.05555555555555555,17,17,CGCTAACTTTGGCTCACGTC,0,1586558
galEp3,0.05555555555555555,17,17,CGCGCTTACAGTGACGGGGC,0,1594934
galEp3,0.05555555555555555,17,17,CGCCGGGGGCCAGCAGCCAT,0,1550136
galEp3,0.05555555555555555,17,17,CGCCGCTGTTGTCGCAACAG,0,1552391
galEp3,0.05555555555555555,17,17,CGCCCAGTGTACTAGACATA,0,1547986
galEp3,0.05555555555555555,17,17,CGATTAGGCAACCACGTTGT,0,1559599
galEp3,0.05555555555555555,17,17,CGATGCACCAGTCCTGGGAT,0,1594062
galEp3,0.05555555555555555,17,17,CGATCTAACTCAGGCATAGC,0,1558927
galEp3,0.05555555555555555,17,17,CGAGACCACCGGGGAGTTCA,0,1593649
galEp3,0.05555555555555555,17,17,CGACGAATAAATCTTCTAAC,0,1557286
galEp3,0.05555555555555555,17,17,CGAAACCCCCCCATAGACTC,0,1568767
galEp3,0.05555555555555555,17,17,CCTTGGATCCAAGTGCGTGA,0,1565106
galEp3,0.05555555555555555,17,17,CCTAAAGCTTGTTCGGGAGC,0,1552583
galEp3,0.05555555555555555,17,17,CCGTGACTTCACGATTGAGC,0,1559692
galEp3,0.05555555555555555,17,17,CCGGCGCTAGGGCAATGCAA,0,1578649
galEp3,0.05555555555555555,17,17,CCCTGGGAGACCAAGTATTA,0,1593664
galEp3,0.05555555555555555,17,17,CCCTGGATGTGACTGAAAGG,0,1587222
galEp3,0.05555555555555555,17,17,CCCGAACGGCGTCTTCAGAC,0,1564924
galEp3,0.05555555555555555,17,17,CCATAACTCGTGCTACGTAC,0,1549497
galEp3,0.05555555555555555,17,17,CCACGACGTGTCATGCCTCA,0,1561331
galEp3,0.05555555555555555,17,17,CCAACTCTCGCCAGATCCAT,0,1591837
galEp3,0.05555555555555555,17,17,CCAACGAGCGTATGCAAGAC,0,1561220
galEp3,0.05555555555555555,17,17,CCAAACATGCAATATCTACA,0,1560492
galEp3,0.05555555555555555,17,17,CATATTTGTTTACACTCGAA,0,1576383
galEp3,0.05555555555555555,17,17,CAGTTGTCCTGCCCACTACC,0,1574448
galEp3,0.05555555555555555,17,17,CAGTACTGAGTATTGTCTAG,0,1567053
galEp3,0.05555555555555555,17,17,CAGGGACACACACCGTCCCG,0,1587301
galEp3,0.05555555555555555,17,17,CACCTGCGCGCAAGGACTAC,0,1590657
galEp3,0.05555555555555555,17,17,CACCGCCAAGCATGGTCCCA,0,1587972
galEp3,0.05555555555555555,17,17,CACCCCGAGCCCTTACAAAT,0,1546450
galEp3,0.05555555555555555,17,17,CAATGGGTTAAGACATGGCC,0,1561621
galEp3,0.05555555555555555,17,17,CAATCATCTTACCGCGTGAT,0,1595159
galEp3,0.05555555555555555,17,17,CAAGTCTGGGGTCACAGGGA,0,1584598
galEp3,0.05555555555555555,17,17,CAAGGTACCAGTAAAAATGC,0,1579859
galEp3,0.05555555555555555,17,17,CAACACGGGCTCTCCATTAA,0,1549563
galEp3,0.05555555555555555,17,17,CAACACGGAGGCGACAGGGA,0,1564742
galEp3,0.05555555555555555,17,17,ATTGAAAAGTCGGGACGAAG,0,1563048
galEp3,0.05555555555555555,17,17,ATTCGTGGCACTAGGCCGGG,0,1568896
galEp3,0.05555555555555555,17,17,ATGGTTACGCCTTTCGGCCT,0,1576260
galEp3,0.05555555555555555,17,17,ATGGGCGGCCGATCGTAGTA,0,1577287
galEp3,0.05555555555555555,17,17,ATGACTCTTGCATTACGGTA,0,1549281
galEp3,0.05555555555555555,17,17,ATCGCTGCTCCCGTTGTACG,0,1556985
galEp3,0.05555555555555555,17,17,ATCGCGGGCAGAGTTTCCTA,0,1586839
galEp3,0.05555555555555555,17,17,ATAGGTAGTCAAACTACTTT,0,1570240
galEp3,0.05555555555555555,17,17,ATAGACTCACCGATTCGGTC,0,1562841
galEp3,0.05555555555555555,17,17,AGTCTCCACACGGGCAATGG,0,1551534
galEp3,0.05555555555555555,17,17,AGGTCACCCTGTCGCGGTGG,0,1571824
galEp3,0.05555555555555555,17,17,AGGGTGCTATCGCACGTAGT,0,1586556
galEp3,0.05555555555555555,17,17,AGGGCAGCCTGGTTACCAAT,0,1577857
galEp3,0.05555555555555555,17,17,AGGCTCGCCCCTCGCCGTGT,0,1580396
galEp3,0.05555555555555555,17,17,AGCCAGCTTATTTTAGGGGT,0,1560239
galEp3,0.05555555555555555,17,17,AGCCACTAATTGAAAACCAG,0,1587580
galEp3,0.05555555555555555,17,17,AGCATAATCCCATCGGGACG,0,1566085
galEp3,0.05555555555555555,17,17,AGCACTGGTTAAAGCCTGCG,0,1586557
galEp3,0.05555555555555555,17,17,AGAGCTGGAAGCGTTTAATT,0,1561027
galEp3,0.05555555555555555,17,17,ACTTGCTACGCATCTTGGTC,0,1586092
galEp3,0.05555555555555555,17,17,ACTTATTCGGAAAAGTGTTA,0,1570169
galEp3,0.05555555555555555,17,17,ACTGCAATCCCTCGTGATCT,0,1562395
galEp3,0.05555555555555555,17,17,ACTCAGGGGGTCAAAGAGTT,0,1549993
galEp3,0.05555555555555555,17,17,ACTAGCTGGTGGTAATGTAA,0,1589195
galEp3,0.05555555555555555,17,17,ACTAGACCTTGGTTATATCA,0,1548682
galEp3,0.05555555555555555,17,17,ACGTGTTATGTGCGAGTCCA,0,1593002
galEp3,0.05555555555555555,17,17,ACGGATAGAAGGTGGGATTA,0,1558521
galEp3,0.05555555555555555,17,17,ACCTTCCAGTGCGGGTAACA,0,1554809
galEp3,0.05555555555555555,17,17,ACCTCTAGTACACGAAAGAC,0,1561734
galEp3,0.05555555555555555,17,17,ACCCATCTCGTTAGTATCTG,0,1560248
galEp3,0.05555555555555555,17,17,ACCCATAGCCAGATACCGTG,0,1575014
galEp3,0.05555555555555555,17,17,ACACGGGCCTATTTTTCATA,0,1572354
galEp3,0.05555555555555555,17,17,ACACGGAAAGAGCGCGATAC,0,1571029
galEp3,0.05555555555555555,17,17,ACACGCGGAAACCAACGCAA,0,1590532
galEp3,0.05555555555555555,17,17,AATATCACCTGAGGGCCATT,0,1586274
galEp3,0.05555555555555555,17,17,AAGTGCAAGTTGTGGTGGAC,0,1565944
galEp3,0.05555555555555555,17,17,AAGTCGCCGATCTACATAAG,0,1561447
galEp3,0.05555555555555555,17,17,AAGTAGATCATACCGTCCGT,0,1584500
galEp3,0.05555555555555555,17,17,AAGGTACTCTATGCCAGAAT,0,1572799
galEp3,0.05555555555555555,17,17,AAGGATCGGAGCTCATTCAC,0,1583894
galEp3,0.05555555555555555,17,17,AAGAAGATGCTCACTAACTA,0,1555384
galEp3,0.05555555555555555,17,17,AACTGGACATCATGCACCTG,0,1555388
galEp3,0.05555555555555555,17,17,AACGGATGCTTAGCCCCTTG,0,1574647
galEp3,0.05555555555555555,17,17,AACGATAGATTACCATCAAA,0,1572573
galEp3,0.05555555555555555,17,17,AACCGTGCCTCTTACAACAT,0,1567055
galEp3,0.05555555555555555,17,17,AACATATTCGAAGACTTGAA,0,1553012
galEp3,0.05555555555555555,17,17,AAAGATGTGAGTCAGGGCTG,0,1581510
galEp3,0.05555555555555555,17,17,AAACGCTAACCTTGTAAGTG,0,1558982
galEp3,0.05555555555555555,17,17,AAACGCAAATATGGTCTAGT,0,1557822
galEp3,0.05555555555555555,17,17,AAACCACGAGACAGGTCGCG,0,1589174
galEp3,0.05555555555555555,17,17,AAAATATGCTCCCTGGGCTG,0,1563633
galEp3,0.05555555555555555,17,17,AAAAGTAGTATTCTACGTGT,0,1565930
galEp3,0.058823529411764705,16,16,TTTGACAGAGTCAGTAGTTA,0,1558469
galEp3,0.058823529411764705,16,16,TTTCTAACGTTATTTGTAGA,0,1564768
galEp3,0.058823529411764705,16,16,TTGATGACCTATGATTGTGA,0,1588591
galEp3,0.058823529411764705,16,16,TTGACCGGTCCATCCGTAAA,0,1569699
galEp3,0.058823529411764705,16,16,TTGACATGTCAAGTGGCGGC,0,1551486
galEp3,0.058823529411764705,16,16,TTATGCGGATACCTGCACTG,0,1547878
galEp3,0.058823529411764705,16,16,TTATGAGCCTGGAATTTTTT,0,1563987
galEp3,0.058823529411764705,16,16,TGTTGTTCACTCGAATATCG,0,1560074
galEp3,0.058823529411764705,16,16,TGTGTACCGTATGTTCCCTA,0,1555278
galEp3,0.058823529411764705,16,16,TGGTCGTCAGAGCAACAGAA,0,1551698
galEp3,0.058823529411764705,16,16,TGGTATCACAACGATCAGAA,0,1576786
galEp3,0.058823529411764705,16,16,TGGTAAAATTGCAACTGTGC,0,1571152
galEp3,0.058823529411764705,16,16,TGGGTCGCCGGCGAAGGAGA,0,1562889
galEp3,0.058823529411764705,16,16,TGGGGACACGGGTAGTCGCT,0,1559896
galEp3,0.058823529411764705,16,16,TGGCGGGCTCCGTTCGATTG,0,1555521
galEp3,0.058823529411764705,16,16,TGGAACGGGCTATAACTAAG,0,1562518
galEp3,0.058823529411764705,16,16,TGGAAATGCCCCCGTTACCA,0,1589055
galEp3,0.058823529411764705,16,16,TGCGGTTGAGTTTTAATGAA,0,1560029
galEp3,0.058823529411764705,16,16,TGCAGATGGCAGAGCGTCAA,0,1582744
galEp3,0.058823529411764705,16,16,TGAGCATATTCAACAAATGC,0,1553821
galEp3,0.058823529411764705,16,16,TGAGCAGCAGGGTGTCGTAA,0,1563562
galEp3,0.058823529411764705,16,16,TGACGAACAGACCGGTTCCT,0,1570766
galEp3,0.058823529411764705,16,16,TGACATGTAAAAATGCACGG,0,1574754
galEp3,0.058823529411764705,16,16,TCTTCGGCGTGAAAAACATG,0,1548859
galEp3,0.058823529411764705,16,16,TCTGGTGGCAAGTTAAGGAA,0,1586933
galEp3,0.058823529411764705,16,16,TCTCTCGGGACCGGGGGTAC,0,1581579
galEp3,0.058823529411764705,16,16,TCTCCCGGATAGCGGGGACA,0,1594479
galEp3,0.058823529411764705,16,16,TCTCACCGACCACCTAGCTC,0,1561859
galEp3,0.058823529411764705,16,16,TCGTTTCCATTGTGTCACGC,0,1558850
galEp3,0.058823529411764705,16,16,TCGTATAGCCGACTGTGGTC,0,1567394
galEp3,0.058823529411764705,16,16,TCGGCGTCATAATGTTCAAC,0,1561627
galEp3,0.058823529411764705,16,16,TCGGAACTCGTACCAGGCAG,0,1561644
galEp3,0.058823529411764705,16,16,TCGCCAATGGAACGCATAGT,0,1566866
galEp3,0.058823529411764705,16,16,TCCGTGGTCTGAAGTAGGAG,0,1591278
galEp3,0.058823529411764705,16,16,TCCGAGATTTTATAACCAAG,0,1576728
galEp3,0.058823529411764705,16,16,TCCAAGGGATGCGGTTATCT,0,1570746
galEp3,0.058823529411764705,16,16,TCATCACGTCATTTTAGAGG,0,1563925
galEp3,0.058823529411764705,16,16,TATGTGACAGCTCGGAGCGA,0,1577852
galEp3,0.058823529411764705,16,16,TATGAGCGCTTTCTTCTGGA,0,1560509
galEp3,0.058823529411764705,16,16,TATCGGCCTAGATTATCCAA,0,1551561
galEp3,0.058823529411764705,16,16,TACTGGGGTGTGATCCTACA,0,1578062
galEp3,0.058823529411764705,16,16,TACGCGCGTAGGAACAACAT,0,1560804
galEp3,0.058823529411764705,16,16,TACCTTTGATTAAAACCAGG,0,1581078
galEp3,0.058823529411764705,16,16,TACCCATACTCTGTGGGAGG,0,1591830
galEp3,0.058823529411764705,16,16,TACCACGGGGTGGTTCCCTC,0,1574720
galEp3,0.058823529411764705,16,16,TACAAGATTAACGTACGGAC,0,1549815
galEp3,0.058823529411764705,16,16,TAAATATCTTCGTAATACTC,0,1580275
galEp3,0.058823529411764705,16,16,GTTTCGGCTACCTAGTTGAT,0,1564757
galEp3,0.058823529411764705,16,16,GTTCCGGCACGCCAATTAGG,0,1565978
galEp3,0.058823529411764705,16,16,GTTCAGTGGACTAGGTCGAG,0,1550341
galEp3,0.058823529411764705,16,16,GTGTTCCGGGTTGCATCTTA,0,1580977
galEp3,0.058823529411764705,16,16,GTGTGTGGAACTAAACGCGT,0,1560715
galEp3,0.058823529411764705,16,16,GTGATTTGCCTGTTGGTCGC,0,1550545
galEp3,0.058823529411764705,16,16,GTCCGAAATTTCGAGCTGGA,0,1578082
galEp3,0.058823529411764705,16,16,GTATGGGTCGGGGACAGCCA,0,1569756
galEp3,0.058823529411764705,16,16,GTATCCTGACGTCACTCTGC,0,1571585
galEp3,0.058823529411764705,16,16,GTAGTTCTCGACGGTCTACA,0,1573608
galEp3,0.058823529411764705,16,16,GTAGACGGCGAGTGTAGGTT,0,1565310
galEp3,0.058823529411764705,16,16,GTACGCGAGAAGAGTATCCA,0,1572788
galEp3,0.058823529411764705,16,16,GTAACGTAGTAGACCCGGAC,0,1556290
galEp3,0.058823529411764705,16,16,GGTTCCCTCGTATGTTAGCG,0,1583232
galEp3,0.058823529411764705,16,16,GGTCTCCCCACGGGACTCGG,0,1567624
galEp3,0.058823529411764705,16,16,GGGTCGGCCACAGTTCATGC,0,1551756
galEp3,0.058823529411764705,16,16,GGGGCCGCGTAATGGTTGGA,0,1573104
galEp3,0.058823529411764705,16,16,GGGCTTTGCGGGAACGTGCT,0,1561347
galEp3,0.058823529411764705,16,16,GGGCGCTCTTCGATTGACAT,0,1585932
galEp3,0.058823529411764705,16,16,GGGCGCTCACCGTATTTTGG,0,1549444
galEp3,0.058823529411764705,16,16,GGGCATGCGCACTTCCAGTA,0,1558607
galEp3,0.058823529411764705,16,16,GGGACTGGTATGCCCCGCCG,0,1554721
galEp3,0.058823529411764705,16,16,GGCTTTCAACGATCCTAGTA,0,1589811
galEp3,0.058823529411764705,16,16,GGCTATTGTTTTCTACCTGT,0,1553780
galEp3,0.058823529411764705,16,16,GGCGGTTCACCTCAAAACAC,0,1590443
galEp3,0.058823529411764705,16,16,GGCGGTCCGAAGCAAATCGG,0,1563749
galEp3,0.058823529411764705,16,16,GGCGCGAGGTTGCGTCAACT,0,1549916
galEp3,0.058823529411764705,16,16,GGATAGGTGACGCGCCCTGG,0,1580248
galEp3,0.058823529411764705,16,16,GGAGCTGGGACATCACGGCC,0,1588868
galEp3,0.058823529411764705,16,16,GGAGAATCTCGCGTACCTCA,0,1580878
galEp3,0.058823529411764705,16,16,GGAAGAAGCGGGACATACGA,0,1579887
galEp3,0.058823529411764705,16,16,GGAACCACGTCCTACTTTCG,0,1546945
galEp3,0.058823529411764705,16,16,GCTGGAGGGTACACCACGCT,0,1549662
galEp3,0.058823529411764705,16,16,GCTGCCAGCATACATGGCGG,0,1551784
galEp3,0.058823529411764705,16,16,GCTCTCGTGCAAGATCCGAA,0,1581338
galEp3,0.058823529411764705,16,16,GCGCCACAAAGAGTACTGGA,0,1570896
galEp3,0.058823529411764705,16,16,GCGACATGACCTCACGCGAC,0,1551082
galEp3,0.058823529411764705,16,16,GCCGGGTATACAGTCCGGAG,0,1577494
galEp3,0.058823529411764705,16,16,GCCGAAATCCAAGAACAAAG,0,1589633
galEp3,0.058823529411764705,16,16,GCATCTTGTAAGGTGGGAAT,0,1588121
galEp3,0.058823529411764705,16,16,GCATACTTAGGTTGCGGGAA,0,1576221
galEp3,0.058823529411764705,16,16,GCATAATTCCGTTCGCCCCC,0,1563904
galEp3,0.058823529411764705,16,16,GCAATGGTACGACTTAGGTA,0,1569060
galEp3,0.058823529411764705,16,16,GATTTGCCGGAACACTGGCT,0,1546460
galEp3,0.058823529411764705,16,16,GATGAGAGAGGAAGACAACG,0,1586838
galEp3,0.058823529411764705,16,16,GATCTTTGAAAATTGCTCGG,0,1561863
galEp3,0.058823529411764705,16,16,GATAGGCCTGAAGGTGCTTT,0,1568170
galEp3,0.058823529411764705,16,16,GAGGATGTCGGTGAATGGCA,0,1585541
galEp3,0.058823529411764705,16,16,GAGGAGACTCCCCTAGCAAA,0,1555175
galEp3,0.058823529411764705,16,16,GACTCTTCCATATCTGCTTA,0,1585465
galEp3,0.058823529411764705,16,16,GACGTCTCGAGGCCTAACGG,0,1561108
galEp3,0.058823529411764705,16,16,GACCCTAGACGGATCGCGCA,0,1564745
galEp3,0.058823529411764705,16,16,GACACTCCCGTGCAAGCCGA,0,1589764
galEp3,0.058823529411764705,16,16,CTGTTCCAAGGCCTAAGCAT,0,1575858
galEp3,0.058823529411764705,16,16,CTGTCGCTTGCCGGCAACTT,0,1579496
galEp3,0.058823529411764705,16,16,CTGTACTAACGAGGTTGCGT,0,1560023
galEp3,0.058823529411764705,16,16,CTGGCCGTGGATCTAATGAG,0,1547831
galEp3,0.058823529411764705,16,16,CTGGATATCGACGACCGTTG,0,1548224
galEp3,0.058823529411764705,16,16,CTGATTTGTACTGGCTCTTG,0,1567959
galEp3,0.058823529411764705,16,16,CTGAAGCCTCGGTCACCCCA,0,1585219
galEp3,0.058823529411764705,16,16,CTCAAGCGTTACACAACCGT,0,1552447
galEp3,0.058823529411764705,16,16,CTATGTCATCACGCACAAAC,0,1576694
galEp3,0.058823529411764705,16,16,CTAGTAGCAGACTGTCATTT,0,1547985
galEp3,0.058823529411764705,16,16,CTAGCTGCAAGACAGCGAAC,0,1568228
galEp3,0.058823529411764705,16,16,CTACGCTGGACGAGCGTATG,0,1577050
galEp3,0.058823529411764705,16,16,CTAAGTCGTTGTATTCCGGA,0,1550073
galEp3,0.058823529411764705,16,16,CGTGGCCATTCGTATCCTGT,0,1584739
galEp3,0.058823529411764705,16,16,CGTCGTACACATTTTTGTTT,0,1569272
galEp3,0.058823529411764705,16,16,CGTCCTCGCAACGGAATGGC,0,1559914
galEp3,0.058823529411764705,16,16,CGTAGTACATGCTTATCCGC,0,1547480
galEp3,0.058823529411764705,16,16,CGTACCTTTTACCACCCGGT,0,1577334
galEp3,0.058823529411764705,16,16,CGGTATTGTCTGCGGAGTTT,0,1546736
galEp3,0.058823529411764705,16,16,CGGGTTTCATGGACTCGTTT,0,1547410
galEp3,0.058823529411764705,16,16,CGGGGCGGGACCGCGCTGGT,0,1547628
galEp3,0.058823529411764705,16,16,CGGGCAATTCAAGAGGGTTA,0,1594299
galEp3,0.058823529411764705,16,16,CGGCGCATGAGTCTGACCGA,0,1562199
galEp3,0.058823529411764705,16,16,CGGACGAGGTGGGAGCCAAC,0,1573920
galEp3,0.058823529411764705,16,16,CGCGGGTGCGGCGTCAAGAA,0,1584055
galEp3,0.058823529411764705,16,16,CGCGCATACTCTCTGCACCT,0,1588567
galEp3,0.058823529411764705,16,16,CGCCTCTACCCGTGCCCCGT,0,1558288
galEp3,0.058823529411764705,16,16,CGCCACACCGGTGCTGGCCA,0,1584317
galEp3,0.058823529411764705,16,16,CGCATCCCTCGTCAGACAGT,0,1591108
galEp3,0.058823529411764705,16,16,CGATTCACCGACATACCCAT,0,1581756
galEp3,0.058823529411764705,16,16,CGAGTGTTTGCGACATAGGT,0,1588902
galEp3,0.058823529411764705,16,16,CGAGAGTAATTGGTCTCGCT,0,1559855
galEp3,0.058823529411764705,16,16,CGACTACGGAACGGTCAGTC,0,1554979
galEp3,0.058823529411764705,16,16,CGACTACGCGCGAAGAGTAA,0,1574303
galEp3,0.058823529411764705,16,16,CGACGTTTACGCGTATCTAA,0,1574114
galEp3,0.058823529411764705,16,16,CGAACGGTCGAAAAGTGATA,0,1567248
galEp3,0.058823529411764705,16,16,CCTTGGCCATCTCCGAAAAG,0,1578356
galEp3,0.058823529411764705,16,16,CCTGTCCCGCGGGTCGGCGA,0,1589497
galEp3,0.058823529411764705,16,16,CCTGCCATTCGCGCTCAGAT,0,1552025
galEp3,0.058823529411764705,16,16,CCTGACTAATACTAGGCTAT,0,1551758
galEp3,0.058823529411764705,16,16,CCTAGATTCATTGCCCTGTC,0,1572262
galEp3,0.058823529411764705,16,16,CCGTAGATCGTTCCGGTCCA,0,1556147
galEp3,0.058823529411764705,16,16,CCGCGTGCGGACATTTATAC,0,1564400
galEp3,0.058823529411764705,16,16,CCGCCCCCGCTGACGACCAC,0,1593520
galEp3,0.058823529411764705,16,16,CCGATTGAAGAACGCGTTTG,0,1571696
galEp3,0.058823529411764705,16,16,CCGACACGGCCCCTAGGGCG,0,1562229
galEp3,0.058823529411764705,16,16,CCGAAGACTTGTAAAATGTG,0,1586963
galEp3,0.058823529411764705,16,16,CCCTAGACTGTCTGCAGAAA,0,1585475
galEp3,0.058823529411764705,16,16,CCAGGTGCACCACGCCTTCA,0,1573492
galEp3,0.058823529411764705,16,16,CCAGGGGCAATTACCGAAGA,0,1570390
galEp3,0.058823529411764705,16,16,CATTCACAGAGCCGAGTGGT,0,1589272
galEp3,0.058823529411764705,16,16,CATTACTCTGGAAAGGAGTA,0,1552915
galEp3,0.058823529411764705,16,16,CATTAATGGGAGGGGATGTC,0,1555137
galEp3,0.058823529411764705,16,16,CATGTGAGGCAGATGTGCGA,0,1585632
galEp3,0.058823529411764705,16,16,CATAGTGTTGCAAGGGAGGA,0,1557515
galEp3,0.058823529411764705,16,16,CAGCCGGACGGTATACCGTG,0,1553236
galEp3,0.058823529411764705,16,16,CAGCCCGTATCTCGCAAATG,0,1588472
galEp3,0.058823529411764705,16,16,CAGAATCTTGCTCCTGCGGT,0,1586618
galEp3,0.058823529411764705,16,16,CAGAAAAAACTCACCACTGC,0,1588267
galEp3,0.058823529411764705,16,16,CACTTCGAGACACCGCTATA,0,1575594
galEp3,0.058823529411764705,16,16,CACTGGTGTCACTTTAGACA,0,1564480
galEp3,0.058823529411764705,16,16,CACGGGTCTCCAGGGCGTAT,0,1592715
galEp3,0.058823529411764705,16,16,CACACAATACAGGGCAGGGG,0,1558510
galEp3,0.058823529411764705,16,16,CAATAGGGGCGCGTAGAGGA,0,1561389
galEp3,0.058823529411764705,16,16,CAATACTAAAGATTTAAGTA,0,1547340
galEp3,0.058823529411764705,16,16,CAAGTTAGTTTCGCGCGATT,0,1594003
galEp3,0.058823529411764705,16,16,CAAGCTCGAGTAGCCTCCAT,0,1592028
galEp3,0.058823529411764705,16,16,CAACCGCAGAGTTTTAGTTA,0,1551640
galEp3,0.058823529411764705,16,16,ATTCCGGTCCTTACGCATAC,0,1593328
galEp3,0.058823529411764705,16,16,ATGTACAGTGGGCAGACGGT,0,1556684
galEp3,0.058823529411764705,16,16,ATGTAACACTCGGGGCAAAG,0,1570387
galEp3,0.058823529411764705,16,16,ATGGTTTCGCGTTGATTTCG,0,1567168
galEp3,0.058823529411764705,16,16,ATCGACCATGCTCTGTATGC,0,1573155
galEp3,0.058823529411764705,16,16,ATATCTAAAACGCACGCTGT,0,1563640
galEp3,0.058823529411764705,16,16,ATACGTCATCAGTCGAGCGG,0,1550215
galEp3,0.058823529411764705,16,16,ATACGGGTTTTATGAAAGAC,0,1582621
galEp3,0.058823529411764705,16,16,AGTTTTAGCGCACGCCCGGG,0,1581978
galEp3,0.058823529411764705,16,16,AGTCCGGGTCGGCTAATAGG,0,1556661
galEp3,0.058823529411764705,16,16,AGTCCGGATCGCAGGAGGAA,0,1582984
galEp3,0.058823529411764705,16,16,AGTCACCGCTTCCTTTACAC,0,1571157
galEp3,0.058823529411764705,16,16,AGGTATGTTGTATCCACCCT,0,1584490
galEp3,0.058823529411764705,16,16,AGGGATTGATGAACTGCCCG,0,1557607
galEp3,0.058823529411764705,16,16,AGGGAATAACGGTCACAACT,0,1555417
galEp3,0.058823529411764705,16,16,AGGCTCTCGACCCTTCATAG,0,1564849
galEp3,0.058823529411764705,16,16,AGGAAAACTGCATTCGATAA,0,1581778
galEp3,0.058823529411764705,16,16,AGCGGACATAACCGGTGAGA,0,1587207
galEp3,0.058823529411764705,16,16,AGCCTTGATATGAGCTTCCC,0,1569192
galEp3,0.058823529411764705,16,16,ACTTGAACTCCTCCAGCGCT,0,1554124
galEp3,0.058823529411764705,16,16,ACTATTTATACACTCGTCAG,0,1581386
galEp3,0.058823529411764705,16,16,ACTAGCCGGAGTTGAGACGC,0,1576122
galEp3,0.058823529411764705,16,16,ACGCTCTCTTGAGTTGGTCA,0,1563859
galEp3,0.058823529411764705,16,16,ACGCGGGTGTTTCGGTAGCT,0,1561838
galEp3,0.058823529411764705,16,16,ACGCAGTAAAATCATCGCGT,0,1563542
galEp3,0.058823529411764705,16,16,ACCGAAGGCCAGTGGCCACT,0,1590733
galEp3,0.058823529411764705,16,16,ACCCTAGCCGCACGCTCTCG,0,1568775
galEp3,0.058823529411764705,16,16,ACCCGTTTCGATTCATGGAT,0,1558072
galEp3,0.058823529411764705,16,16,ACCATGGGTGTTGAGAAAAC,0,1553107
galEp3,0.058823529411764705,16,16,ACAGTAAGTTTAGCATGCTG,0,1553235
galEp3,0.058823529411764705,16,16,ACAGGATAAAAATATGGATC,0,1589247
galEp3,0.058823529411764705,16,16,ACAGCACACTGTAACGGAAT,0,1582574
galEp3,0.058823529411764705,16,16,ACAGAATCAGTCACCATTTG,0,1560672
galEp3,0.058823529411764705,16,16,ACACGCGCAGTTCTTTGCTG,0,1578772
galEp3,0.058823529411764705,16,16,ACACCGGTCTAGGATTACGT,0,1552338
galEp3,0.058823529411764705,16,16,ACAAAGATTATCCTGTTTGT,0,1568174
galEp3,0.058823529411764705,16,16,AATCGTGGGTATGGGGGGAG,0,1546860
galEp3,0.058823529411764705,16,16,AATCCGTACCCAGGGAGATG,0,1549231
galEp3,0.058823529411764705,16,16,AATATACCAGGCGCTACAGC,0,1569706
galEp3,0.058823529411764705,16,16,AAGGATTTGTGGTCTTGCGA,0,1575911
galEp3,0.058823529411764705,16,16,AAGCTTCTAATACCGTTGAA,0,1586591
galEp3,0.058823529411764705,16,16,AAGCTCACGTGGCCTCATTC,0,1577370
galEp3,0.058823529411764705,16,16,AAGCCATAACCGGATCGTCA,0,1575805
galEp3,0.058823529411764705,16,16,AAGAATGGTGGCATCACTCT,0,1588979
galEp3,0.058823529411764705,16,16,AAGAACGGCGCTTGCCAGGG,0,1580612
galEp3,0.058823529411764705,16,16,AACCTATATGCATTATTGTT,0,1576469
galEp3,0.058823529411764705,16,16,AAATTCGGTTCGTCGTGGAC,0,1547007
galEp3,0.058823529411764705,16,16,AAATTCGCTTATTTAATCAG,0,1562573
galEp3,0.058823529411764705,16,16,AAATTAGGGTTAGGACAAAG,0,1564586
galEp3,0.058823529411764705,16,16,AAAGTCAACCAAGAACGAGG,0,1586470
galEp3,0.058823529411764705,16,16,AAAGGGCAGTGAAGGGACCT,0,1548189
galEp3,0.058823529411764705,16,16,AAACTCGATTTCACGCTCCA,0,1585008
galEp3,0.058823529411764705,16,16,AAACTCAGTGGCACTCACAT,0,1574941
galEp3,0.058823529411764705,16,16,AAAAGCGCGACTCATGAAGG,0,1572868
galEp3,0.058823529411764705,16,16,AAAAACCGACCCCCTACATA,0,1588989
galEp3,0.0625,15,15,TTTTGTGGAGCCCCTCTTGA,0,1559978
galEp3,0.0625,15,15,TTTTGCCACATCATTCACAC,0,1555080
galEp3,0.0625,15,15,TTTTGCAAGTGATCTAGAAT,0,1593922
galEp3,0.0625,15,15,TTTGTGGGGACTACATTTTT,0,1550206
galEp3,0.0625,15,15,TTTGTCACCTGGCGAGTAGT,0,1558642
galEp3,0.0625,15,15,TTTGACTGGGAGATCCCCTA,0,1579251
galEp3,0.0625,15,15,TTGTTCATTCTGCAACTTAG,0,1579300
galEp3,0.0625,15,15,TTGTTCAGACCAAGGCCAGT,0,1566616
galEp3,0.0625,15,15,TTGTGTAAAACGGCAGCTTG,0,1585070
galEp3,0.0625,15,15,TTGTGGGATAATAACCAGCA,0,1547238
galEp3,0.0625,15,15,TTGTCCAATTACGCGGTGTG,0,1574017
galEp3,0.0625,15,15,TTGGTGGAGACTCTACTTAT,0,1572360
galEp3,0.0625,15,15,TTGCGCGGTTCTGCGAGGAG,0,1546599
galEp3,0.0625,15,15,TTGCCCATTGATGTCAGGAT,0,1577946
galEp3,0.0625,15,15,TTCTACCCAAGCTGTTGGCA,0,1588088
galEp3,0.0625,15,15,TTCGCTCGGTCAATGGTAAG,0,1587123
galEp3,0.0625,15,15,TTCGACGTTGTGAGCAACGC,0,1589143
galEp3,0.0625,15,15,TTCGAAACCTTTCACGGCAT,0,1576391
galEp3,0.0625,15,15,TTCATCGAAGGAAGCACCTT,0,1570961
galEp3,0.0625,15,15,TTCAGTTCAGAGAGAAAAGA,0,1584553
galEp3,0.0625,15,15,TTACTGTAGTACGAAACTCC,0,1563761
galEp3,0.0625,15,15,TTACGTCAGCAACAAGTGTG,0,1554643
galEp3,0.0625,15,15,TGTTTACTGTCAGAAATGAA,0,1592039
galEp3,0.0625,15,15,TGTAGTTTGGTACAATCAAT,0,1558775
galEp3,0.0625,15,15,TGTAGCAGGCCCCCTAGAAT,0,1591475
galEp3,0.0625,15,15,TGGTACGATGGCCAGTTAAG,0,1562096
galEp3,0.0625,15,15,TGGGCAAGCGGGCTATGTGG,0,1547187
galEp3,0.0625,15,15,TGGCTGGAGAAGGCAGATTG,0,1559699
galEp3,0.0625,15,15,TGGCTCTTGGAATGCAGTCA,0,1561106
galEp3,0.0625,15,15,TGGCATACTCCTCAGAATAG,0,1584283
galEp3,0.0625,15,15,TGGATTCAGGAGGGGTATAA,0,1554224
galEp3,0.0625,15,15,TGCGCATTCCTCCAAGACGG,0,1562398
galEp3,0.0625,15,15,TGCCTCAGCTGGAACTAGGG,0,1551792
galEp3,0.0625,15,15,TGAGTTCTTCGACATGCAGC,0,1592711
galEp3,0.0625,15,15,TGAGTCTAGGGGCATAGAGG,0,1580253
galEp3,0.0625,15,15,TGAGTACCTGCGGTACTGGT,0,1569506
galEp3,0.0625,15,15,TGAGGGCGCAGATTGTTGAG,0,1577134
galEp3,0.0625,15,15,TCTGTGTTTGTCAGCTTGGA,0,1556769
galEp3,0.0625,15,15,TCTCCGCAGGGGAGACCGGC,0,1586503
galEp3,0.0625,15,15,TCTAGATCCGTGCGGCTAAG,0,1556540
galEp3,0.0625,15,15,TCGTGGTAAACCAGGGTTTT,0,1581559
galEp3,0.0625,15,15,TCGTCTGGTGTAGCTAGGAT,0,1567196
galEp3,0.0625,15,15,TCGTAGGGATTTGAGCCTAG,0,1571998
galEp3,0.0625,15,15,TCGCTGCGGTAGCCGCATGT,0,1559709
galEp3,0.0625,15,15,TCCGGCGATCGCCCGTCGCA,0,1572279
galEp3,0.0625,15,15,TCCCTACCGTGCAACGTTCT,0,1547478
galEp3,0.0625,15,15,TCCAACGATCTTGGATGCTA,0,1558835
galEp3,0.0625,15,15,TCAACCCATGACCACAAAGG,0,1567230
galEp3,0.0625,15,15,TATGCTGGTGTAAGGAGCCT,0,1592846
galEp3,0.0625,15,15,TATGCTAACCAGTCACGTCT,0,1590977
galEp3,0.0625,15,15,TATCGTCGCCCCGGGGGTAT,0,1546957
galEp3,0.0625,15,15,TATAGGTATACGTATAACAG,0,1560249
galEp3,0.0625,15,15,TAGGCTCCTCACAGTTCGCT,0,1560280
galEp3,0.0625,15,15,TAGCTCTGTGCGGTGAGGTC,0,1549880
galEp3,0.0625,15,15,TAGATCCCGTTTGGCTCGTC,0,1588694
galEp3,0.0625,15,15,TAGATAAGCATGTTTTGCTG,0,1562517
galEp3,0.0625,15,15,TACGTCCCAAGTTACGTTTC,0,1572971
galEp3,0.0625,15,15,TACAATCTCTCTGGTGGAAG,0,1572974
galEp3,0.0625,15,15,TAATGGGATTCGTGTGTTAC,0,1550432
galEp3,0.0625,15,15,GTTCGCGAGCATCACAAGAT,0,1546882
galEp3,0.0625,15,15,GTGTGGGGGGACTGTATGCG,0,1564002
galEp3,0.0625,15,15,GTGGTGGGCCGAGAGTGACA,0,1568846
galEp3,0.0625,15,15,GTGCTAAGGTGTTGACCTTT,0,1562656
galEp3,0.0625,15,15,GTGAGGCACTGCAAACTCGA,0,1568472
galEp3,0.0625,15,15,GTCGATTGGTCTCTGGGGCT,0,1563973
galEp3,0.0625,15,15,GTCCGGTCAGTATTGTGGAA,0,1558200
galEp3,0.0625,15,15,GTCAATCAATTGAGCAAAAC,0,1563368
galEp3,0.0625,15,15,GTATAATTGTCTATAAAGCT,0,1561654
galEp3,0.0625,15,15,GTAGCTTCTACATAAGGATT,0,1582611
galEp3,0.0625,15,15,GTACGATTGGATGATCGAGA,0,1570427
galEp3,0.0625,15,15,GGTTCAAAAGGGGAGTAGCT,0,1547835
galEp3,0.0625,15,15,GGTGTCATAAGGCCGTCGTT,0,1594622
galEp3,0.0625,15,15,GGGATCCGTACAGCAAACGC,0,1571655
galEp3,0.0625,15,15,GGGAATTCACGGTCGGGGGA,0,1570355
galEp3,0.0625,15,15,GGCTCTCCAACGGGAAACAA,0,1589093
galEp3,0.0625,15,15,GGCCGAGAACAACTCTTTTA,0,1577531
galEp3,0.0625,15,15,GGCCAGGACCCTGTTAAGCC,0,1564513
galEp3,0.0625,15,15,GGCATTTTTGTCTCCGATAT,0,1562562
galEp3,0.0625,15,15,GGCAGGGGTGCGCTCTCTAG,0,1594439
galEp3,0.0625,15,15,GGCAAGGATTGCCACTCTGA,0,1583244
galEp3,0.0625,15,15,GGACCCGTGCACGAGTCTAC,0,1557610
galEp3,0.0625,15,15,GGAATTCTGTAGGGACCCAT,0,1563673
galEp3,0.0625,15,15,GGAAGCTCTAACGGCCGACT,0,1577777
galEp3,0.0625,15,15,GGAAACGGCACAGGAAGTCA,0,1558071
galEp3,0.0625,15,15,GCTCTTGCCCCGAGCTTCAC,0,1550710
galEp3,0.0625,15,15,GCTCCCATCGGGGTTTCCGT,0,1547625
galEp3,0.0625,15,15,GCGGTAGGTTACTATCGTGG,0,1548613
galEp3,0.0625,15,15,GCGGCGCGCAGGGTGGACCC,0,1576713
galEp3,0.0625,15,15,GCGATGTAGGCCTTCCGACT,0,1563976
galEp3,0.0625,15,15,GCCCCGAGTGCGGCGTGCCG,0,1582646
galEp3,0.0625,15,15,GCCACGACCCAATAATTCAC,0,1571723
galEp3,0.0625,15,15,GCAGAAGGGATAATACATTG,0,1554850
galEp3,0.0625,15,15,GCACCTATGTTCTGATAATC,0,1577350
galEp3,0.0625,15,15,GCACCCTGAGCGCCCAGTGG,0,1547377
galEp3,0.0625,15,15,GATCTCGGCTGCCCAGTGCG,0,1572201
galEp3,0.0625,15,15,GATCGATACTGCTAGTATGT,0,1587211
galEp3,0.0625,15,15,GATCCTTATCTGTCGTTAAT,0,1558065
galEp3,0.0625,15,15,GATAATGATCTGACTCGCGC,0,1584422
galEp3,0.0625,15,15,GAGTGAAGTTACTTGAAGAA,0,1570687
galEp3,0.0625,15,15,GAGTCCAGACACTCCCGTAC,0,1568250
galEp3,0.0625,15,15,GAGCAGTCCTTCTGGTACAA,0,1578760
galEp3,0.0625,15,15,GAGAGCCTCAGAGTTCGATT,0,1563400
galEp3,0.0625,15,15,GACGGCGTTGCAGTTCGCCA,0,1554336
galEp3,0.0625,15,15,GAATTTACCGGCGCACCATG,0,1576361
galEp3,0.0625,15,15,GAAGATTAACGCCTAGCTGT,0,1592149
galEp3,0.0625,15,15,GAAGATGTTGTAAAAGGCGA,0,1554308
galEp3,0.0625,15,15,GAACCCAGAGCTGGTTGTAT,0,1581758
galEp3,0.0625,15,15,CTTTGCTGGTCTCATACACT,0,1572358
galEp3,0.0625,15,15,CTTGGTGAGGCTCTGGATCC,0,1588872
galEp3,0.0625,15,15,CTGGGACGAGCGCATGTGTA,0,1553233
galEp3,0.0625,15,15,CTGGCGTTCACGTGCCCTTG,0,1557568
galEp3,0.0625,15,15,CTGGCGATTGTACTTTAGCC,0,1551961
galEp3,0.0625,15,15,CTGGCGAATGTCGGCGCATG,0,1579765
galEp3,0.0625,15,15,CTGCAGAACCTATCCGCTGG,0,1549021
galEp3,0.0625,15,15,CTGCAAACCGGCGTCGCGCA,0,1551603
galEp3,0.0625,15,15,CTCGATGATATTGGCTACAT,0,1574845
galEp3,0.0625,15,15,CTCCGGGGGAGGTTCTGTAT,0,1573996
galEp3,0.0625,15,15,CTCATTGGCTGCTAATGTCT,0,1548817
galEp3,0.0625,15,15,CTCACTGTTCATGATCATTC,0,1567157
galEp3,0.0625,15,15,CTCACGTCATCCCGACTTAT,0,1570620
galEp3,0.0625,15,15,CTCAAGCCAGAGTAAGGTAT,0,1550670
galEp3,0.0625,15,15,CTATCGCGAGGCTATCTAAA,0,1549506
galEp3,0.0625,15,15,CTAGCATGCATCGGCTGCGA,0,1581703
galEp3,0.0625,15,15,CTAGAGATGGGTGCGAGAGG,0,1584861
galEp3,0.0625,15,15,CTACTTACATCTGGTCTGCA,0,1591503
galEp3,0.0625,15,15,CTACATTACTGCCCAGACCT,0,1576753
galEp3,0.0625,15,15,CTACAGTTGTTAGTATCCCT,0,1566416
galEp3,0.0625,15,15,CGTTTTTGCGGAAGGTTGTC,0,1553256
galEp3,0.0625,15,15,CGTTACTATAAAGGTTACCA,0,1577245
galEp3,0.0625,15,15,CGTGCTAATATTTATCCATA,0,1551940
galEp3,0.0625,15,15,CGTCTCTCCTATCCTGATCG,0,1592289
galEp3,0.0625,15,15,CGTCGCAGCTAAGGAAACTA,0,1568991
galEp3,0.0625,15,15,CGTCCGCGGTCGTCGTACTT,0,1580390
galEp3,0.0625,15,15,CGTCATCCAAAAAGGTTCTG,0,1581932
galEp3,0.0625,15,15,CGTATATACAACTCTGCTTT,0,1551769
galEp3,0.0625,15,15,CGGTCGGCTAGGGGCAAGGA,0,1581509
galEp3,0.0625,15,15,CGGCGTGTCAAAACACATAT,0,1579027
galEp3,0.0625,15,15,CGCTCTCTAATCACACAACA,0,1558870
galEp3,0.0625,15,15,CGCTCGGTCAGGAGCTTTCC,0,1570200
galEp3,0.0625,15,15,CGCTCCTGATGGCATCGTTT,0,1571250
galEp3,0.0625,15,15,CGCTACATTGGCTTTATCGT,0,1551564
galEp3,0.0625,15,15,CGCGGCTACTGGGTCGGAGG,0,1566771
galEp3,0.0625,15,15,CGCGGCGACTTACTGCATGC,0,1548054
galEp3,0.0625,15,15,CGCCGGCCCATGGCGCGGGG,0,1561862
galEp3,0.0625,15,15,CGCCGCCAAAGGTGCGGGAG,0,1565769
galEp3,0.0625,15,15,CGCCATCCTGATATGGTACA,0,1549966
galEp3,0.0625,15,15,CGCATAGCAACCGTCCGCAC,0,1577366
galEp3,0.0625,15,15,CGCACCGTTTAATGTAGTGA,0,1568696
galEp3,0.0625,15,15,CGCAAATAGCTCCTAGTTGC,0,1583450
galEp3,0.0625,15,15,CGATGAAGGAGTGAATTGGT,0,1593075
galEp3,0.0625,15,15,CGAGCGGCCGCCAGAAAAGG,0,1594727
galEp3,0.0625,15,15,CGAGCCGCACCACAGAATAT,0,1582012
galEp3,0.0625,15,15,CGAGCATCGAATTTCACCCC,0,1567187
galEp3,0.0625,15,15,CGAGCAAGGGGTCATATAGT,0,1577870
galEp3,0.0625,15,15,CGAATCACGTATGTAATCGC,0,1582175
galEp3,0.0625,15,15,CCTGTATGTCAGTCGTCATT,0,1587625
galEp3,0.0625,15,15,CCTGGCTACAGGGCCGACAC,0,1574866
galEp3,0.0625,15,15,CCTCCGGTACACCATGTATG,0,1590978
galEp3,0.0625,15,15,CCTATATTAGTTAACCCATA,0,1560565
galEp3,0.0625,15,15,CCGTTACAATGGGTTTTTAG,0,1580107
galEp3,0.0625,15,15,CCGCGTGCAACCTCCGCACA,0,1555126
galEp3,0.0625,15,15,CCCCAGGCTTTCCAACCCAA,0,1547456
galEp3,0.0625,15,15,CCCACGTATGCGTTCTGGAT,0,1580476
galEp3,0.0625,15,15,CCAGTCGCCGGCGTGAGGGT,0,1557031
galEp3,0.0625,15,15,CCAGGACACATACGAACACA,0,1593423
galEp3,0.0625,15,15,CCAGCCCGTCGAAGCTTGCT,0,1581327
galEp3,0.0625,15,15,CCAGCCACGGTTAGAGAAGT,0,1552683
galEp3,0.0625,15,15,CCACGGCCGACGCGACATGG,0,1562886
galEp3,0.0625,15,15,CCAACACGAAAAGCGAGTAA,0,1565455
galEp3,0.0625,15,15,CCAAAAGCATAATTATGCAA,0,1549169
galEp3,0.0625,15,15,CATTTAATGCTTGTGTAACG,0,1557632
galEp3,0.0625,15,15,CATCGCATGCTCCAAAGGTG,0,1587694
galEp3,0.0625,15,15,CATACGTTTAAGAGAGAGTA,0,1551405
galEp3,0.0625,15,15,CATAAATCAGAGTTAGCTCT,0,1569365
galEp3,0.0625,15,15,CAGTACACCGTTCGGACGTA,0,1573881
galEp3,0.0625,15,15,CAGGGTACTTAGGGGCTGGG,0,1585876
galEp3,0.0625,15,15,CAGGCTTGTTCAAAAGGACA,0,1565909
galEp3,0.0625,15,15,CAGAGTCCATTAGGGCGACA,0,1556602
galEp3,0.0625,15,15,CAGAGTAAGCATATAGATGC,0,1573599
galEp3,0.0625,15,15,CAGACCATTAAGACCTTGGG,0,1574120
galEp3,0.0625,15,15,CACTATTTACATACACCTAA,0,1583037
galEp3,0.0625,15,15,CACTATGTCAATAACATGCT,0,1583298
galEp3,0.0625,15,15,CACGGATTTGCATCCCGGGT,0,1551709
galEp3,0.0625,15,15,CAAGAACTACCGCACGGAAC,0,1566257
galEp3,0.0625,15,15,CAAAGATCTTTGTTGCAAGG,0,1572699
galEp3,0.0625,15,15,ATTGGTCGGTCAAGCATCAA,0,1557129
galEp3,0.0625,15,15,ATTGCTTCAACACGTAAGGC,0,1594844
galEp3,0.0625,15,15,ATTGCGGTTGAAAATAACTC,0,1584754
galEp3,0.0625,15,15,ATTGAATATCATCGCTAGTA,0,1559253
galEp3,0.0625,15,15,ATTCGCACATCAATCTACTT,0,1579283
galEp3,0.0625,15,15,ATGGTGTATAGGTCACGAGA,0,1551765
galEp3,0.0625,15,15,ATGCTCGAGTCACGATGTCC,0,1570480
galEp3,0.0625,15,15,ATGCCCCGGTAGTGTCGTAA,0,1564011
galEp3,0.0625,15,15,ATCTGAGAACCTAATTGTGA,0,1580122
galEp3,0.0625,15,15,ATCTCAAGGCATCATCCATT,0,1575102
galEp3,0.0625,15,15,ATCCATCTGCGCGAAATGGT,0,1566290
galEp3,0.0625,15,15,ATCAATCGATTTTTTTCTAG,0,1559191
galEp3,0.0625,15,15,ATATCTGCGGAACTAGATCT,0,1552190
galEp3,0.0625,15,15,ATACTACTCGATAATTATAT,0,1591255
galEp3,0.0625,15,15,ATACCACGCGGCCGGTTAGA,0,1552585
galEp3,0.0625,15,15,ATAACGTGCGATCGTCGATA,0,1557618
galEp3,0.0625,15,15,ATAAATAGTTTCTTATCCTA,0,1559285
galEp3,0.0625,15,15,AGTTTCTCTTTTGTTGTGCT,0,1572089
galEp3,0.0625,15,15,AGTTCGGGTCATAGGCTCGC,0,1548020
galEp3,0.0625,15,15,AGTCCCATTTAGTATTGGAA,0,1571514
galEp3,0.0625,15,15,AGTATCCTGGATACCCGTAG,0,1566389
galEp3,0.0625,15,15,AGGTGGCACTTCACAACTCG,0,1550571
galEp3,0.0625,15,15,AGGTAGTTTCCATAGATACT,0,1587628
galEp3,0.0625,15,15,AGGGTGAGGACATTTCTATT,0,1581251
galEp3,0.0625,15,15,AGGGCGAACCGCGCACAAAT,0,1567049
galEp3,0.0625,15,15,AGGCTCGTTTGTGGGCCTCT,0,1576732
galEp3,0.0625,15,15,AGGCAAGATGAGGCCACAGA,0,1547184
galEp3,0.0625,15,15,AGGCAACTGGCCCTCCCCTA,0,1588266
galEp3,0.0625,15,15,AGGATTTGGATTTTGAGGAC,0,1582138
galEp3,0.0625,15,15,AGCCAGGGCACGTTGATTTA,0,1587212
galEp3,0.0625,15,15,AGACCCAGTCTTCTTGAAAT,0,1562668
galEp3,0.0625,15,15,ACTTACCGTAGACACCATAA,0,1556378
galEp3,0.0625,15,15,ACTCTCTGCGTATATACACT,0,1589153
galEp3,0.0625,15,15,ACTCGTGCCGCGCCTTGTAT,0,1591015
galEp3,0.0625,15,15,ACTCGCCCACTATCCCATTT,0,1557093
galEp3,0.0625,15,15,ACTCATATAGCAGGGCGGAA,0,1590883
galEp3,0.0625,15,15,ACGTCCGAAGTATCATCCCT,0,1549759
galEp3,0.0625,15,15,ACCGTAGAGCGGTCATTGCA,0,1581900
galEp3,0.0625,15,15,ACCCTATATATTGGTACGAT,0,1563631
galEp3,0.0625,15,15,ACCATTACTAGGCAAGCAAT,0,1570135
galEp3,0.0625,15,15,ACCAACGAGAAGCGCGGTGT,0,1589896
galEp3,0.0625,15,15,ACATCAGCATGATGGCGTTA,0,1575243
galEp3,0.0625,15,15,ACAGCCGTAATGGGAACTGC,0,1565836
galEp3,0.0625,15,15,ACAGAGGTTAGATTATGCAT,0,1571976
galEp3,0.0625,15,15,ACAGAGCTACTATAGAGCAT,0,1582849
galEp3,0.0625,15,15,ACACAATCGCTCAAATCTAT,0,1576862
galEp3,0.0625,15,15,ACAAGAACACGCCAATCTTG,0,1559335
galEp3,0.0625,15,15,ACAAATGGAGCTCGATCTAC,0,1559445
galEp3,0.0625,15,15,AATTCGGCTTGTGCTATGGT,0,1584114
galEp3,0.0625,15,15,AATCGGAACGTGGCAATCTC,0,1581073
galEp3,0.0625,15,15,AAGTTGAATATCAGAAATTT,0,1588721
galEp3,0.0625,15,15,AAGGGTCGGTCCCGTCCAAC,0,1575141
galEp3,0.0625,15,15,AAGGGCTACGCGTAGGACGT,0,1558334
galEp3,0.0625,15,15,AAGGCTAGGAAAATGTACCG,0,1561121
galEp3,0.0625,15,15,AAGGAGATGTCCTATAATTT,0,1593153
galEp3,0.0625,15,15,AAGCTTATAAGTATCTGATT,0,1556377
galEp3,0.0625,15,15,AAGCGCTTCAGATCGAGTTA,0,1594332
galEp3,0.0625,15,15,AAGCCTCGTCAAATCAACTA,0,1560941
galEp3,0.0625,15,15,AACTAAGATAGCTCAAGTCC,0,1589606
galEp3,0.0625,15,15,AACATATATGCCAATAGTTA,0,1563176
galEp3,0.0625,15,15,AACAGTATCTTGATTGCGAC,0,1579424
galEp3,0.0625,15,15,AACAGAAGGTAAGTCCAAAC,0,1590691
galEp3,0.0625,15,15,AAATTTGGATGAGGATGCCA,0,1588375
galEp3,0.0625,15,15,AAAGCGGCCGTAACTCGGAG,0,1562626
galEp3,0.0625,15,15,AAACGTTGTTTGTCATCCCT,0,1566620
galEp3,0.06666666666666667,14,14,TTTTGTCCCCGGTCGTCTGT,0,1578202
galEp3,0.06666666666666667,14,14,TTTTGCTTTACTATATGATG,0,1580234
galEp3,0.06666666666666667,14,14,TTGTGTTTACAAACGACGCC,0,1562197
galEp3,0.06666666666666667,14,14,TTGTGGCTTCACGGTTATGA,0,1590251
galEp3,0.06666666666666667,14,14,TTGCCGACAACAACTGTCAG,0,1556020
galEp3,0.06666666666666667,14,14,TTGATGCGTAATCTATCATG,0,1563632
galEp3,0.06666666666666667,14,14,TTCTGTTATTTGGCCATCCC,0,1547186
galEp3,0.06666666666666667,14,14,TTCATTGTACCGGGGTTGAG,0,1554424
galEp3,0.06666666666666667,14,14,TTCAAACCTCTGGGTGACCC,0,1554150
galEp3,0.06666666666666667,14,14,TTATGTACCACGGTCAATAG,0,1580281
galEp3,0.06666666666666667,14,14,TTACTCAGAAAGACGACCCC,0,1565757
galEp3,0.06666666666666667,14,14,TTACGAATGCATGGATGGCA,0,1568611
galEp3,0.06666666666666667,14,14,TTACATACAGCCCGGTCCTA,0,1579173
galEp3,0.06666666666666667,14,14,TTAATCAACAGTGAACTCCG,0,1581397
galEp3,0.06666666666666667,14,14,TGTTCAGTGCCCCAGTCGAT,0,1582523
galEp3,0.06666666666666667,14,14,TGTGGCAGATACCGGCACCG,0,1561161
galEp3,0.06666666666666667,14,14,TGTAAGCGGATCGGTATGTC,0,1562786
galEp3,0.06666666666666667,14,14,TGGGGCGCCCAACATATGTG,0,1580944
galEp3,0.06666666666666667,14,14,TGGGATAATTACGTATACTG,0,1576551
galEp3,0.06666666666666667,14,14,TGGGAAGCTTTATGCGTGAT,0,1589642
galEp3,0.06666666666666667,14,14,TGGCCGAGGGATGGCAGGCA,0,1582484
galEp3,0.06666666666666667,14,14,TGGCAATAACTATAATAGGA,0,1567782
galEp3,0.06666666666666667,14,14,TGGAGCAGGCTGCCAACTTG,0,1568042
galEp3,0.06666666666666667,14,14,TGGAGCACCGTCCTACCTAG,0,1586691
galEp3,0.06666666666666667,14,14,TGGAAAGCCGCTACAACGAC,0,1548730
galEp3,0.06666666666666667,14,14,TGCTTTTGACGATCAGCCCC,0,1548678
galEp3,0.06666666666666667,14,14,TGCTACAACAAGCACCGCCA,0,1577944
galEp3,0.06666666666666667,14,14,TGCGCGAACCCAGTTTTTCT,0,1571114
galEp3,0.06666666666666667,14,14,TGCCTGCGTGATCCGGACGT,0,1558735
galEp3,0.06666666666666667,14,14,TGCCACCCGAGTTAAAATTG,0,1579352
galEp3,0.06666666666666667,14,14,TGATGCGGTGTTCCGCGGCC,0,1557412
galEp3,0.06666666666666667,14,14,TGATGCCCAAGTTCACATAC,0,1576496
galEp3,0.06666666666666667,14,14,TGAGTATTACACGCTACTTA,0,1558554
galEp3,0.06666666666666667,14,14,TGACTTATTACCGTACGTTG,0,1580641
galEp3,0.06666666666666667,14,14,TCTCTGCAATAAACCGTTAT,0,1569995
galEp3,0.06666666666666667,14,14,TCGGGCGTATATGTGAACAA,0,1570904
galEp3,0.06666666666666667,14,14,TCGCTATTGTTGGGTTTAGG,0,1570264
galEp3,0.06666666666666667,14,14,TCCTGCATCCTACCTAGATG,0,1561924
galEp3,0.06666666666666667,14,14,TCCGTTTACAGGAGCCACCT,0,1547388
galEp3,0.06666666666666667,14,14,TCCGGTCGAGTATACACCGT,0,1594438
galEp3,0.06666666666666667,14,14,TCCGGGGACACCACGGCTCA,0,1553195
galEp3,0.06666666666666667,14,14,TCCCACGCCAGGAATGAGAC,0,1583735
galEp3,0.06666666666666667,14,14,TCCACATTTGGCTTTTCCCA,0,1564974
galEp3,0.06666666666666667,14,14,TCATTTCTATGAACTTTAAG,0,1548779
galEp3,0.06666666666666667,14,14,TCATTACATGATATAGCTAT,0,1571839
galEp3,0.06666666666666667,14,14,TCATCCGTGGCAATCCAGGT,0,1589394
galEp3,0.06666666666666667,14,14,TCAGCTCTGATTATGCACCA,0,1546966
galEp3,0.06666666666666667,14,14,TCAGACGGTACTATAACGAT,0,1557611
galEp3,0.06666666666666667,14,14,TCACGGGACCTCCCGTAGCG,0,1553055
galEp3,0.06666666666666667,14,14,TATTGGCCACTGTGACCCAT,0,1553633
galEp3,0.06666666666666667,14,14,TATCCTCTGTAACCGTGTTC,0,1552879
galEp3,0.06666666666666667,14,14,TAGCCTGTCATCAACTCGTC,0,1593774
galEp3,0.06666666666666667,14,14,TAGAGGAGCCTCGGGTATAC,0,1553023
galEp3,0.06666666666666667,14,14,TAGAAAGGTCTTGCATTCTG,0,1558386
galEp3,0.06666666666666667,14,14,TACTCAAAAAGTAACGCTCA,0,1551955
galEp3,0.06666666666666667,14,14,TACCCGTTCCGCATAAACTT,0,1585255
galEp3,0.06666666666666667,14,14,TACCATCAGTCCTTCCCGAC,0,1546862
galEp3,0.06666666666666667,14,14,TAATTTGATATCCAAGAACA,0,1548161
galEp3,0.06666666666666667,14,14,TAATTGAATCGTCGTGAGGC,0,1559906
galEp3,0.06666666666666667,14,14,TAAGGCGGTACCATCTACCA,0,1577014
galEp3,0.06666666666666667,14,14,TAAATTGGCTCTATCTAATA,0,1575398
galEp3,0.06666666666666667,14,14,TAAACTATCGGGTACTCCTA,0,1584605
galEp3,0.06666666666666667,14,14,TAAAATCAAACAGAGATTTG,0,1590491
galEp3,0.06666666666666667,14,14,GTTTAAGCTATACCCAGAGT,0,1569149
galEp3,0.06666666666666667,14,14,GTTGACCCAAAGATCCCCAA,0,1561335
galEp3,0.06666666666666667,14,14,GTTCCTGTTCCGACGCTCTA,0,1586740
galEp3,0.06666666666666667,14,14,GTGTCATGAGGAGATATGCT,0,1576385
galEp3,0.06666666666666667,14,14,GTGGTATCCGCGTTTTCCCA,0,1560344
galEp3,0.06666666666666667,14,14,GTGGAAAGGCATCATAACCT,0,1588444
galEp3,0.06666666666666667,14,14,GTGCTGTAGGATGTGCCCCT,0,1581186
galEp3,0.06666666666666667,14,14,GTGCCATGCTCATCAGCGTA,0,1566301
galEp3,0.06666666666666667,14,14,GTGATAGGCTCTGTGAGTTT,0,1587405
galEp3,0.06666666666666667,14,14,GTGAGTCGAATAGATGAAGT,0,1553823
galEp3,0.06666666666666667,14,14,GTCTTACACTTTCTAACTGG,0,1579280
galEp3,0.06666666666666667,14,14,GTCTGATTGAACTCCATATG,0,1576526
galEp3,0.06666666666666667,14,14,GTCGCATGTGGATTCCATTT,0,1592858
galEp3,0.06666666666666667,14,14,GTCCAGTCCCCAACCCATTG,0,1547193
galEp3,0.06666666666666667,14,14,GTCATGGCGGGTACCCGCTG,0,1563067
galEp3,0.06666666666666667,14,14,GTCACGTCAAGCGACAGAGA,0,1594293
galEp3,0.06666666666666667,14,14,GTATTCTGGCAACCGGCTGT,0,1548826
galEp3,0.06666666666666667,14,14,GTATAATCAGGAAGAAACTC,0,1587652
galEp3,0.06666666666666667,14,14,GTACTTGGTAGTATCCTTTC,0,1593945
galEp3,0.06666666666666667,14,14,GGTGCCATTGCCTGCATCGA,0,1581187
galEp3,0.06666666666666667,14,14,GGTCCTTGTAAGTCGCCTGA,0,1581133
galEp3,0.06666666666666667,14,14,GGGTTAGAACTCCGGACGGA,0,1547839
galEp3,0.06666666666666667,14,14,GGGTGGTGAAGATCTGGCAA,0,1557865
galEp3,0.06666666666666667,14,14,GGGTGCGGCACGGACCACCT,0,1561705
galEp3,0.06666666666666667,14,14,GGGGTATGTCTTGCCTACTT,0,1566452
galEp3,0.06666666666666667,14,14,GGGGCGAGAGTTAATCAGGA,0,1546650
galEp3,0.06666666666666667,14,14,GGGCATCGAGATTCTTTGAA,0,1554969
galEp3,0.06666666666666667,14,14,GGGCATCCGCATGACCCGAG,0,1572166
galEp3,0.06666666666666667,14,14,GGGATTTGTAATGCAAAATC,0,1548562
galEp3,0.06666666666666667,14,14,GGGATACCTGGCTACCAGAA,0,1585548
galEp3,0.06666666666666667,14,14,GGCTTCATAGGTCCCGTACT,0,1575508
galEp3,0.06666666666666667,14,14,GGCTGGGGGAAGCAGAAAAC,0,1576321
galEp3,0.06666666666666667,14,14,GGCTCCTGTGAGACTGAGGT,0,1566873
galEp3,0.06666666666666667,14,14,GGCGTATGTGCAAAGAGTCC,0,1577364
galEp3,0.06666666666666667,14,14,GGCGATTTCTAGATGAGATT,0,1575405
galEp3,0.06666666666666667,14,14,GGCCCGCATCTTTGTCCTTA,0,1565417
galEp3,0.06666666666666667,14,14,GGATTTCCGGTGACACTGCA,0,1562326
galEp3,0.06666666666666667,14,14,GGAGTGTAACGAGAAGTGGA,0,1556376
galEp3,0.06666666666666667,14,14,GGACTCCGGTCAATTCATGA,0,1580041
galEp3,0.06666666666666667,14,14,GGACGCCCTCCGGTATATAC,0,1549992
galEp3,0.06666666666666667,14,14,GGAAGTAAGGTGGCTAGCGT,0,1570574
galEp3,0.06666666666666667,14,14,GCTCTATGGCCGAGCGGCCG,0,1594691
galEp3,0.06666666666666667,14,14,GCTCCATTTGCGATCATCGA,0,1556834
galEp3,0.06666666666666667,14,14,GCGGCTTAGAAGTAATACCG,0,1589041
galEp3,0.06666666666666667,14,14,GCGATACTACGGTATTTGCC,0,1571129
galEp3,0.06666666666666667,14,14,GCGACACCGAAACCAGAAGC,0,1589637
galEp3,0.06666666666666667,14,14,GCCTTAACATTGGGGTTCAA,0,1561745
galEp3,0.06666666666666667,14,14,GCCAGGGCACAGCGAGTTCA,0,1561289
galEp3,0.06666666666666667,14,14,GCACTGGCCGACGGCCATCG,0,1567581
galEp3,0.06666666666666667,14,14,GCAATTCATGGGATTCGCAT,0,1567999
galEp3,0.06666666666666667,14,14,GATTGAAGGAGTAAGGGACT,0,1566573
galEp3,0.06666666666666667,14,14,GATTAGCAGTCACTGCAGGC,0,1547850
galEp3,0.06666666666666667,14,14,GATGATTACAGAAAACCTCG,0,1568154
galEp3,0.06666666666666667,14,14,GATCATTAGCAAGGTCCCGT,0,1554339
galEp3,0.06666666666666667,14,14,GATAATTCGAATCTTGGTGG,0,1570635
galEp3,0.06666666666666667,14,14,GAGTATACCAAGACTCAACA,0,1586639
galEp3,0.06666666666666667,14,14,GAGCTATGGACTTTATGGCT,0,1566935
galEp3,0.06666666666666667,14,14,GAGAGGTTACATTTTACCGA,0,1588141
galEp3,0.06666666666666667,14,14,GACCAGAGCACGGCGAACTC,0,1589208
galEp3,0.06666666666666667,14,14,GACAAGTATGAGTAAAATGC,0,1591742
galEp3,0.06666666666666667,14,14,GAAGCACCCTGTTACGGCAT,0,1575311
galEp3,0.06666666666666667,14,14,GAACGTCCTGCGTATCAAAA,0,1590089
galEp3,0.06666666666666667,14,14,GAAAAACGAGCCTAACCTAA,0,1590176
galEp3,0.06666666666666667,14,14,CTTTTCTCTGGGAACCATAG,0,1574909
galEp3,0.06666666666666667,14,14,CTTTCTAAACTGTCGTTTTG,0,1576161
galEp3,0.06666666666666667,14,14,CTTGGTCACGACGAAGATAA,0,1577792
galEp3,0.06666666666666667,14,14,CTTCTTGAGACAACTGCTGC,0,1579654
galEp3,0.06666666666666667,14,14,CTTCCCCGGCAACATAATGC,0,1587729
galEp3,0.06666666666666667,14,14,CTGGTAATCTCGGGAGCGAA,0,1594918
galEp3,0.06666666666666667,14,14,CTGCATGCCCCACGTCACAG,0,1554981
galEp3,0.06666666666666667,14,14,CTCTGGATGAGAAATATTCC,0,1560315
galEp3,0.06666666666666667,14,14,CTCTGAAGTACTACACCGAC,0,1569371
galEp3,0.06666666666666667,14,14,CTCGGTACTATGCCACCCGG,0,1556714
galEp3,0.06666666666666667,14,14,CTCCTGCGAACCGCAACACA,0,1594216
galEp3,0.06666666666666667,14,14,CTCACCCAGGATACGCTGGA,0,1567006
galEp3,0.06666666666666667,14,14,CTATATAACGCGGTTGTTTT,0,1588426
galEp3,0.06666666666666667,14,14,CTATAAATGGTTAGTACGCT,0,1590108
galEp3,0.06666666666666667,14,14,CTAGGAACGAAATAGGCAAA,0,1566960
galEp3,0.06666666666666667,14,14,CTAGCCATGGATTACGCTCT,0,1567574
galEp3,0.06666666666666667,14,14,CTACTACAGCCAGCGATCAT,0,1553816
galEp3,0.06666666666666667,14,14,CTACATAAATTCTTACGGTA,0,1564408
galEp3,0.06666666666666667,14,14,CGTTCATTATAACTCCCAGG,0,1548338
galEp3,0.06666666666666667,14,14,CGTTCAGGCCGACGAGTAGG,0,1550491
galEp3,0.06666666666666667,14,14,CGTCCAGATCCCACCGAATG,0,1590270
galEp3,0.06666666666666667,14,14,CGGTATCCCCAATCCACCTG,0,1594765
galEp3,0.06666666666666667,14,14,CGGGTTAACCCCTACACTTC,0,1578526
galEp3,0.06666666666666667,14,14,CGGGGAACGGTATACACCAA,0,1563539
galEp3,0.06666666666666667,14,14,CGGGCTCGGAACAGACCCCT,0,1569590
galEp3,0.06666666666666667,14,14,CGGGCAGAATAACGGGGGAA,0,1573525
galEp3,0.06666666666666667,14,14,CGGCTTGGCGATCTCAAATA,0,1582955
galEp3,0.06666666666666667,14,14,CGGCTCTGAATCCGCGCAAA,0,1588594
galEp3,0.06666666666666667,14,14,CGGCGACCCATCTACGCTCT,0,1587319
galEp3,0.06666666666666667,14,14,CGGCACATCCTCTCCTAGGC,0,1586690
galEp3,0.06666666666666667,14,14,CGGAAAACCGGCCTTTCATC,0,1574322
galEp3,0.06666666666666667,14,14,CGCTGACATGAGCGCTTGGG,0,1577421
galEp3,0.06666666666666667,14,14,CGCTCAAAATTCATGCTCGA,0,1586089
galEp3,0.06666666666666667,14,14,CGCTACCCGACGCAGGGTTA,0,1558345
galEp3,0.06666666666666667,14,14,CGCGGACTTTAGGGGTGACT,0,1559689
galEp3,0.06666666666666667,14,14,CGCCGATGACTGTCTATCGG,0,1594010
galEp3,0.06666666666666667,14,14,CGCAGCTTTATACACACGTT,0,1575888
galEp3,0.06666666666666667,14,14,CGATGAACGTGCCGTTGCGC,0,1580676
galEp3,0.06666666666666667,14,14,CGAGTGCCCGTGGCTAGGGA,0,1554069
galEp3,0.06666666666666667,14,14,CGACGTATGCCAGGCAGCTA,0,1592974
galEp3,0.06666666666666667,14,14,CGACCGGATGGAAGTTAGGT,0,1592093
galEp3,0.06666666666666667,14,14,CCTTGTCACTCTACAGAGAA,0,1590240
galEp3,0.06666666666666667,14,14,CCTTAATTTGGTAAGTTTAA,0,1591232
galEp3,0.06666666666666667,14,14,CCTGTAAGGACTGGTCAATC,0,1555029
galEp3,0.06666666666666667,14,14,CCTGGACCGTGTTGAACATA,0,1551012
galEp3,0.06666666666666667,14,14,CCTGAGATTTGAACCCTCAT,0,1590468
galEp3,0.06666666666666667,14,14,CCGTCGTACAATCACACCAT,0,1587560
galEp3,0.06666666666666667,14,14,CCGGCGAAAAATGCACATGA,0,1562888
galEp3,0.06666666666666667,14,14,CCGATCTCCAATCCTTTAAA,0,1582445
galEp3,0.06666666666666667,14,14,CCGAGGATCATTAGAAGGCA,0,1565415
galEp3,0.06666666666666667,14,14,CCCTATGCGCGTAAAAGCAA,0,1571442
galEp3,0.06666666666666667,14,14,CCCCTCGTAGCTACTCTTCT,0,1590189
galEp3,0.06666666666666667,14,14,CCAGAAAACAGCTCTGGAGG,0,1570068
galEp3,0.06666666666666667,14,14,CCACTAGCTTCAGTTTAAAG,0,1561279
galEp3,0.06666666666666667,14,14,CCAAATGTATTGACCACCCC,0,1566042
galEp3,0.06666666666666667,14,14,CATGTATATGTAGTTAAGGT,0,1587103
galEp3,0.06666666666666667,14,14,CATCGACTCCGTTATCTTCG,0,1560890
galEp3,0.06666666666666667,14,14,CATAGATGTAGTTGCGAACT,0,1572695
galEp3,0.06666666666666667,14,14,CAGTGGGCGCGAAATTTTAA,0,1584911
galEp3,0.06666666666666667,14,14,CAGTCTTGGACGCGTGAGTT,0,1561163
galEp3,0.06666666666666667,14,14,CAGTCCGATAGCCAGTAGTC,0,1546465
galEp3,0.06666666666666667,14,14,CAGGATGTCCAAACTGTTGC,0,1591280
galEp3,0.06666666666666667,14,14,CAGGACAAACCTTAAGTTCC,0,1593565
galEp3,0.06666666666666667,14,14,CAGCATCAGGAAATGCAAAA,0,1562219
galEp3,0.06666666666666667,14,14,CACTCATACGCGTTGACCGC,0,1585441
galEp3,0.06666666666666667,14,14,CACCGTAGGCCCGCTGAAAT,0,1559190
galEp3,0.06666666666666667,14,14,CACATGTCTGGAGGGGCTCA,0,1558036
galEp3,0.06666666666666667,14,14,CACAGTTCAATAGAACCAAC,0,1551965
galEp3,0.06666666666666667,14,14,CACAGACTCGCGTCTAGGTG,0,1561563
galEp3,0.06666666666666667,14,14,CACAAATCGCGCGTTCACAG,0,1547787
galEp3,0.06666666666666667,14,14,CAATGGCAGTGCCAGAGGCA,0,1570158
galEp3,0.06666666666666667,14,14,CAAGTGGGTTTGAATATTAC,0,1557837
galEp3,0.06666666666666667,14,14,CAACGGGATGGTCCCGTACT,0,1568941
galEp3,0.06666666666666667,14,14,CAACGGCAGACGTACAACGG,0,1585112
galEp3,0.06666666666666667,14,14,CAACCAACGTAGTTCTCTGA,0,1559895
galEp3,0.06666666666666667,14,14,ATTTTTATGTACTTACGTAA,0,1569226
galEp3,0.06666666666666667,14,14,ATTTGAATTATCAAGCGTTG,0,1547807
galEp3,0.06666666666666667,14,14,ATTAAACTCTCGAGGTTCTA,0,1574677
galEp3,0.06666666666666667,14,14,ATGGGCAGTTTGAGCCGTGT,0,1562756
galEp3,0.06666666666666667,14,14,ATGCGGCCAACTTACTGTAC,0,1563314
galEp3,0.06666666666666667,14,14,ATGCGCCTGCGGAACTTGCG,0,1552677
galEp3,0.06666666666666667,14,14,ATGATGGGAGATTTGGAAAA,0,1554534
galEp3,0.06666666666666667,14,14,ATGAGCAACCTAGAATTAAT,0,1573262
galEp3,0.06666666666666667,14,14,ATCTTTCTAACCTTACGCTT,0,1587263
galEp3,0.06666666666666667,14,14,ATCTTGGATAGGTCCGTGCT,0,1556508
galEp3,0.06666666666666667,14,14,ATCGGTTTCTTATATCGAAA,0,1561925
galEp3,0.06666666666666667,14,14,ATCGCAGTATGCATGCTGCT,0,1553121
galEp3,0.06666666666666667,14,14,ATCCGGTGCTAGACCTGGCC,0,1581272
galEp3,0.06666666666666667,14,14,ATCAAGCATGCATACATACG,0,1550728
galEp3,0.06666666666666667,14,14,ATAGGTCTTAACGTTTCTCG,0,1591061
galEp3,0.06666666666666667,14,14,ATAGGGTTCACTGCTTCATT,0,1546944
galEp3,0.06666666666666667,14,14,ATAGCGGCGGACTTAATGCT,0,1580874
galEp3,0.06666666666666667,14,14,ATACTAGAGCACAGTTTGTA,0,1586793
galEp3,0.06666666666666667,14,14,ATACGTGAGGCCTGCCCGTG,0,1578051
galEp3,0.06666666666666667,14,14,ATAAGTATTTGCACTAACAG,0,1591256
galEp3,0.06666666666666667,14,14,ATAAACGCGGGGTTTCTTAG,0,1590280
galEp3,0.06666666666666667,14,14,AGTTTTCTCGTGTCACATTG,0,1568702
galEp3,0.06666666666666667,14,14,AGTTGTGTTGAAAAATTAGT,0,1550677
galEp3,0.06666666666666667,14,14,AGTTGTGGCACATACGATAG,0,1571492
galEp3,0.06666666666666667,14,14,AGTTGGCTTTGTTTCCCCCG,0,1574692
galEp3,0.06666666666666667,14,14,AGTTCGCGATTGAACTTGCG,0,1579499
galEp3,0.06666666666666667,14,14,AGTATTCGCACACTCAACAA,0,1570887
galEp3,0.06666666666666667,14,14,AGGTTTACCCGTAACATCTT,0,1590741
galEp3,0.06666666666666667,14,14,AGGTGGCGTAAGCCAAGATC,0,1552462
galEp3,0.06666666666666667,14,14,AGGTCCCTGGAAATTACGGT,0,1592651
galEp3,0.06666666666666667,14,14,AGGTATGCCCTCGAGTTGTA,0,1590286
galEp3,0.06666666666666667,14,14,AGGGTGGGCGCAAACACGCG,0,1565082
galEp3,0.06666666666666667,14,14,AGGGCGCAGGCAGGTGTTAG,0,1549936
galEp3,0.06666666666666667,14,14,AGGCTTGGTCCTCATACGGG,0,1592743
galEp3,0.06666666666666667,14,14,AGCTAGTCAGGTTCGGAACA,0,1555898
galEp3,0.06666666666666667,14,14,AGCGCCCTCGCCATTTAATC,0,1562627
galEp3,0.06666666666666667,14,14,AGCGCCCGTAGATGTGTTCC,0,1551139
galEp3,0.06666666666666667,14,14,AGCCTCCACAACACATCGAG,0,1576596
galEp3,0.06666666666666667,14,14,AGCATCAACCATTATGCGCG,0,1550952
galEp3,0.06666666666666667,14,14,AGATATTCGGATTCCTTTTC,0,1568919
galEp3,0.06666666666666667,14,14,AGACTAAGGATGAGCTGAGA,0,1585669
galEp3,0.06666666666666667,14,14,AGACCCGTGGACCTACGATT,0,1589979
galEp3,0.06666666666666667,14,14,AGAAGTGGATTAGGCCACTA,0,1593812
galEp3,0.06666666666666667,14,14,AGAAGAGGCGCAACAGTCAT,0,1559755
galEp3,0.06666666666666667,14,14,ACTGGGTTCGTCTTTTGTCT,0,1563581
galEp3,0.06666666666666667,14,14,ACTGGGTAAACGTACTGTGT,0,1556176
galEp3,0.06666666666666667,14,14,ACTGCTAGCGGGACTGTGCC,0,1594089
galEp3,0.06666666666666667,14,14,ACTGAAGTAATACAGTGCGG,0,1565429
galEp3,0.06666666666666667,14,14,ACTCTTTATCGGCACAGTAA,0,1583260
galEp3,0.06666666666666667,14,14,ACTCACTAAGAATAATTTGA,0,1588800
galEp3,0.06666666666666667,14,14,ACTACAAGTCCTATTTTGAG,0,1587507
galEp3,0.06666666666666667,14,14,ACGTTTGGCTCCCAGTTCCG,0,1573960
galEp3,0.06666666666666667,14,14,ACGTGCAATTGGCCCCAGCG,0,1570567
galEp3,0.06666666666666667,14,14,ACGTCTTCAAACCGAGAACA,0,1568516
galEp3,0.06666666666666667,14,14,ACGGATTTTTCTATCAGTAT,0,1583159
galEp3,0.06666666666666667,14,14,ACGAATCCTCGCCGAAGGAA,0,1557535
galEp3,0.06666666666666667,14,14,ACCGCTAGTATGTTATTGTT,0,1575389
galEp3,0.06666666666666667,14,14,ACCAGCACTGGTGAACTAAA,0,1582657
galEp3,0.06666666666666667,14,14,ACAGGGCGACTGCTACAGCG,0,1565190
galEp3,0.06666666666666667,14,14,ACAGATAGGCGCTCCTCGTA,0,1561122
galEp3,0.06666666666666667,14,14,ACAATGGTGGATTTTTGCCA,0,1571077
galEp3,0.06666666666666667,14,14,ACAACGGCGCGTTTAAATAT,0,1581511
galEp3,0.06666666666666667,14,14,ACAACAGCTACCGTAAGACT,0,1574674
galEp3,0.06666666666666667,14,14,AATCGAACTGACAATACTCT,0,1592253
galEp3,0.06666666666666667,14,14,AATAGGGTAGGCCCTCACAC,0,1556197
galEp3,0.06666666666666667,14,14,AATACCTGTGCGTTTCCGGC,0,1567020
galEp3,0.06666666666666667,14,14,AAGTAGTTATGATGACGGTT,0,1594840
galEp3,0.06666666666666667,14,14,AAGCGTGCGGACTTCAATAG,0,1548005
galEp3,0.06666666666666667,14,14,AAGATTTGTTGAGTGAAGAC,0,1552673
galEp3,0.06666666666666667,14,14,AAGAGATATACCTCATACAA,0,1576832
galEp3,0.06666666666666667,14,14,AACCGCACATGAGTAACAAG,0,1582055
galEp3,0.06666666666666667,14,14,AACATAGGTGTCTAAGGCAT,0,1592896
galEp3,0.06666666666666667,14,14,AACATAAAAGACTGCACGTT,0,1586796
galEp3,0.06666666666666667,14,14,AAATGTCATCATCACAGGGC,0,1560175
galEp3,0.06666666666666667,14,14,AAATGGCTGTGTTCGTACGA,0,1585919
galEp3,0.06666666666666667,14,14,AAATATCCAAGGCCATCCAA,0,1552334
galEp3,0.06666666666666667,14,14,AAAGGTTACTTCCAGGGTAC,0,1552979
galEp3,0.06666666666666667,14,14,AAAGGGTGTGTCCACGATCC,0,1570714
galEp3,0.06666666666666667,14,14,AAAAATAAGACTTCAGGCAA,0,1550896
galEp3,0.06666666666666667,14,14,AAAAACCTGGATCGAGGACC,0,1565375
galEp3,0.07142857142857142,13,13,TTTCGGCCGGATATTCTGGT,0,1577078
galEp3,0.07142857142857142,13,13,TTTCCAGGTATTTAAGGGAT,0,1559336
galEp3,0.07142857142857142,13,13,TTGTCTGGCCTGAGCGCTGT,0,1563491
galEp3,0.07142857142857142,13,13,TTGAGCACTCTCCGTCCTTC,0,1548421
galEp3,0.07142857142857142,13,13,TTCTGCGTAACGGCGGCCTT,0,1573846
galEp3,0.07142857142857142,13,13,TTCGACAGCTGCTTAGGAAG,0,1578495
galEp3,0.07142857142857142,13,13,TTCCAGTGCGCGCAACGTCA,0,1593983
galEp3,0.07142857142857142,13,13,TTATAGTCTTGCGGTCGGGA,0,1555059
galEp3,0.07142857142857142,13,13,TTAGTTCACAGTGGCGCTAA,0,1563342
galEp3,0.07142857142857142,13,13,TTACTGGTGCAGCACCAAGT,0,1569642
galEp3,0.07142857142857142,13,13,TTACGTTTCAATCACCGAGT,0,1570787
galEp3,0.07142857142857142,13,13,TTACAGCGGGTATCCCATCA,0,1582827
galEp3,0.07142857142857142,13,13,TTAATGAGCGGAAAAACTAT,0,1570609
galEp3,0.07142857142857142,13,13,TTAAGGGTAGGTGCTATTCA,0,1585882
galEp3,0.07142857142857142,13,13,TTAACACTCAATTAAAAGAG,0,1592446
galEp3,0.07142857142857142,13,13,TTAACACCTGTTTTTCTTCG,0,1583213
galEp3,0.07142857142857142,13,13,TGTTGTGACGTGAATAGGAC,0,1570148
galEp3,0.07142857142857142,13,13,TGTGGTATAAGTTTAACTTT,0,1565388
galEp3,0.07142857142857142,13,13,TGTGCTACGTTTATACTCTG,0,1557684
galEp3,0.07142857142857142,13,13,TGTCGCGAGATGAGGGAAGG,0,1579528
galEp3,0.07142857142857142,13,13,TGGGCGCGGACTGGTAGTGT,0,1580992
galEp3,0.07142857142857142,13,13,TGGGAGCCTCGCGTTAGTGG,0,1549327
galEp3,0.07142857142857142,13,13,TGGCGGTACTGAAAATGTAA,0,1592472
galEp3,0.07142857142857142,13,13,TGGCGGTAATGAGCCGTGTA,0,1591227
galEp3,0.07142857142857142,13,13,TGCGCTACCAAAAGGCTTGC,0,1589095
galEp3,0.07142857142857142,13,13,TGCGCGCGGCCGATGACTGC,0,1571266
galEp3,0.07142857142857142,13,13,TGCAATTGTCAATCCAAAGA,0,1591842
galEp3,0.07142857142857142,13,13,TGATATTATAATTCCTAAGT,0,1569310
galEp3,0.07142857142857142,13,13,TGACTTCCGTACACATTCTG,0,1579928
galEp3,0.07142857142857142,13,13,TGACCGTAGGCATATATTGA,0,1555364
galEp3,0.07142857142857142,13,13,TGACCGGCCGTATAGCGTTC,0,1581677
galEp3,0.07142857142857142,13,13,TGAATAGCGTTATTGGCCGT,0,1549509
galEp3,0.07142857142857142,13,13,TGAAGTGTTTCGATGGGTAA,0,1548935
galEp3,0.07142857142857142,13,13,TCTTTCGACTGAGGAATTCT,0,1590731
galEp3,0.07142857142857142,13,13,TCTGAAAACATGGGCGCACA,0,1568388
galEp3,0.07142857142857142,13,13,TCTCAGCCACAACATGGAAA,0,1569517
galEp3,0.07142857142857142,13,13,TCTAGCGGGGACCGTAGTAC,0,1592661
galEp3,0.07142857142857142,13,13,TCTAATTTTTAACCTCTCCG,0,1591497
galEp3,0.07142857142857142,13,13,TCCGTGGGTGTCGTGGATTT,0,1566526
galEp3,0.07142857142857142,13,13,TCCGCTCTACCTGAGCTCAT,0,1578882
galEp3,0.07142857142857142,13,13,TCCCTGTTATAAGGGACCTA,0,1552791
galEp3,0.07142857142857142,13,13,TCCCTAGGGGTTGCCTTCAT,0,1582014
galEp3,0.07142857142857142,13,13,TCCAGCGCTCTTTAGAACGA,0,1579963
galEp3,0.07142857142857142,13,13,TCCAAGCTAACATCAGGGTT,0,1549417
galEp3,0.07142857142857142,13,13,TCATTTGCACACGTATTCGT,0,1582599
galEp3,0.07142857142857142,13,13,TCATCTCTCTGTCAAGGTCT,0,1589285
galEp3,0.07142857142857142,13,13,TCAGCATATACCGGGCTCAT,0,1577718
galEp3,0.07142857142857142,13,13,TCAGCAGATTGGTGCGCCAC,0,1569377
galEp3,0.07142857142857142,13,13,TCAGAGGGAATCACCACGTT,0,1561556
galEp3,0.07142857142857142,13,13,TCACAGGGCGCCTAATTCGA,0,1566316
galEp3,0.07142857142857142,13,13,TATATGTGGACCATGGCGAA,0,1567311
galEp3,0.07142857142857142,13,13,TAGTGTGTATCAACATCGGA,0,1593028
galEp3,0.07142857142857142,13,13,TAGGTCGTCAGCACCTCTAC,0,1568646
galEp3,0.07142857142857142,13,13,TAGGACTAGGATTTACTTTG,0,1569125
galEp3,0.07142857142857142,13,13,TAGCAAACATCTTTCGAGCT,0,1568810
galEp3,0.07142857142857142,13,13,TACTGCATCAAAATGGGGTT,0,1565918
galEp3,0.07142857142857142,13,13,TACTAATAGGTGACCATGTA,0,1592115
galEp3,0.07142857142857142,13,13,TACCGACCCTTTAATGTTGT,0,1569911
galEp3,0.07142857142857142,13,13,TACATCCGGTAGAGGGAGCG,0,1573931
galEp3,0.07142857142857142,13,13,TAATTTTCCTACTCTAGATC,0,1582907
galEp3,0.07142857142857142,13,13,TAACGTACCCGGGCCAGTGC,0,1552067
galEp3,0.07142857142857142,13,13,TAAACCGAGTGCGTAGGCCT,0,1565860
galEp3,0.07142857142857142,13,13,GTTTCGGCAATCTCGCCTAC,0,1566107
galEp3,0.07142857142857142,13,13,GTTTACAGTGGACATAGTAT,0,1547512
galEp3,0.07142857142857142,13,13,GTTGTACATAAGTACCCTGC,0,1571232
galEp3,0.07142857142857142,13,13,GTTCTGATTACAATACGCTA,0,1582334
galEp3,0.07142857142857142,13,13,GTTCGATCACTCCCTTCTGG,0,1574374
galEp3,0.07142857142857142,13,13,GTTCATAGAAATCGGACTAG,0,1591421
galEp3,0.07142857142857142,13,13,GTGTGATGTTAACGCCATTT,0,1556620
galEp3,0.07142857142857142,13,13,GTGGTGCAACAGCATAGTTT,0,1573789
galEp3,0.07142857142857142,13,13,GTGGCCATGCTATCAGCGAG,0,1573638
galEp3,0.07142857142857142,13,13,GTGCCAACCCTAGCCATTAC,0,1556180
galEp3,0.07142857142857142,13,13,GTGAGTGGTGAGGACCGAGG,0,1565838
galEp3,0.07142857142857142,13,13,GTCTTTCAGACCGGCACGTT,0,1556098
galEp3,0.07142857142857142,13,13,GTCGTGGTTTACCCATCGGC,0,1569552
galEp3,0.07142857142857142,13,13,GTCCTCATTTTCTGTCGCAA,0,1582872
galEp3,0.07142857142857142,13,13,GTCCCGATGCATGCTGGTTA,0,1558368
galEp3,0.07142857142857142,13,13,GTCACTGCGACTTGGGCCAA,0,1560848
galEp3,0.07142857142857142,13,13,GTCACGGCAGCGTTGTATGT,0,1562190
galEp3,0.07142857142857142,13,13,GTCAAACAATGCGACAAGAG,0,1550657
galEp3,0.07142857142857142,13,13,GTATAAGGTTAAGGTAGTTC,0,1559323
galEp3,0.07142857142857142,13,13,GTATAACGAGCCTCTCTTTC,0,1565099
galEp3,0.07142857142857142,13,13,GTACTCTCAAGAGAGAATTC,0,1577700
galEp3,0.07142857142857142,13,13,GTAAGCCACTCTTATCAAAG,0,1563902
galEp3,0.07142857142857142,13,13,GGTGCTTAAGCCATGTAAAC,0,1552784
galEp3,0.07142857142857142,13,13,GGTCGGTTCAGCTGCCAGGG,0,1584435
galEp3,0.07142857142857142,13,13,GGGGCTCCTTATAGCATTCT,0,1560283
galEp3,0.07142857142857142,13,13,GGGGCGGGGCTCTTTAATAT,0,1593758
galEp3,0.07142857142857142,13,13,GGGCGACGGTTGTCCACTGT,0,1547731
galEp3,0.07142857142857142,13,13,GGGCAGCTGCGACCTGCGTG,0,1556154
galEp3,0.07142857142857142,13,13,GGGAATAGTAACAATTGTTA,0,1571153
galEp3,0.07142857142857142,13,13,GGCGATTACGGGGGGGTACG,0,1547915
galEp3,0.07142857142857142,13,13,GGCCTGCACGTTTAATATGC,0,1552885
galEp3,0.07142857142857142,13,13,GGCCATTCAAAGTAGGGATT,0,1563748
galEp3,0.07142857142857142,13,13,GGCATTAACGCTCGCATTAT,0,1568023
galEp3,0.07142857142857142,13,13,GGCAGGAATAATCAGTGATA,0,1551526
galEp3,0.07142857142857142,13,13,GGCACGAGCCTGAGTACCCC,0,1572690
galEp3,0.07142857142857142,13,13,GGCACCGATATGATCCTTTC,0,1577879
galEp3,0.07142857142857142,13,13,GGCAATCCGCCCCCTACTAT,0,1559349
galEp3,0.07142857142857142,13,13,GGATTCCTATGAGCGGTGTC,0,1557968
galEp3,0.07142857142857142,13,13,GGATACATTTAGTCTGTAGC,0,1547301
galEp3,0.07142857142857142,13,13,GGACCGTTTCTGTCGGAATT,0,1593174
galEp3,0.07142857142857142,13,13,GCTTGGGACTGACTTTGTTG,0,1554806
galEp3,0.07142857142857142,13,13,GCTGTCATCGCGAAATCAAG,0,1590901
galEp3,0.07142857142857142,13,13,GCTATCAGTGAGCTTCGATA,0,1574879
galEp3,0.07142857142857142,13,13,GCTACTGGTTATATTTAGAT,0,1590238
galEp3,0.07142857142857142,13,13,GCTACCCGCGGGACCTCTGG,0,1547283
galEp3,0.07142857142857142,13,13,GCTAAGGGAGTATCGCGGAA,0,1574818
galEp3,0.07142857142857142,13,13,GCGTTTAATATCGTGGGAAG,0,1593842
galEp3,0.07142857142857142,13,13,GCGTATAAAGAGCAGTGTGA,0,1546486
galEp3,0.07142857142857142,13,13,GCGACGCCTGTGCAGCTTTT,0,1568638
galEp3,0.07142857142857142,13,13,GCCGGAACCGGTTCCCAGTT,0,1575254
galEp3,0.07142857142857142,13,13,GCCGATCAGCCCTCATGCCT,0,1549795
galEp3,0.07142857142857142,13,13,GCCCGGTTGCCAGACAGGAT,0,1560299
galEp3,0.07142857142857142,13,13,GCCCGAGTACACGGGAGATT,0,1587539
galEp3,0.07142857142857142,13,13,GCCACAAGGAGAATCCGAGA,0,1578119
galEp3,0.07142857142857142,13,13,GCATGGCACTTCGTTACCCA,0,1591377
galEp3,0.07142857142857142,13,13,GCAGGGGCGACAAATTACTG,0,1557039
galEp3,0.07142857142857142,13,13,GCAGGCAGCTGTTTCTTCTT,0,1577498
galEp3,0.07142857142857142,13,13,GCACCGTGGGTTGTCCTAAT,0,1560932
galEp3,0.07142857142857142,13,13,GCACCATCCACGATGTCCAC,0,1586312
galEp3,0.07142857142857142,13,13,GATGGCAACGATACCCGGCC,0,1556797
galEp3,0.07142857142857142,13,13,GATGCGGGGAGACGGATTAA,0,1574214
galEp3,0.07142857142857142,13,13,GATGCCAGATTATGGTCAAA,0,1555301
galEp3,0.07142857142857142,13,13,GAGGAAAATCTCAAGGAGGG,0,1573138
galEp3,0.07142857142857142,13,13,GAGCTGCGTTGGGCGGGGCT,0,1574610
galEp3,0.07142857142857142,13,13,GAGCTGCCCTAGGCTCTGTT,0,1565462
galEp3,0.07142857142857142,13,13,GACTCTCCAGAGTTTCAGTT,0,1592390
galEp3,0.07142857142857142,13,13,GACGTATGCCTTGGTCCATT,0,1585501
galEp3,0.07142857142857142,13,13,GACGCGTGCAGAGTTATTTA,0,1589505
galEp3,0.07142857142857142,13,13,GACCTACCTCGCTACGCATA,0,1571928
galEp3,0.07142857142857142,13,13,GACCACACTGTCTAACCGTT,0,1551144
galEp3,0.07142857142857142,13,13,GACACAGACCTGGGTTTGTC,0,1548369
galEp3,0.07142857142857142,13,13,GAATGCCATATTAGGGATTG,0,1591057
galEp3,0.07142857142857142,13,13,GAATCATCCTTGGGGGATAC,0,1570413
galEp3,0.07142857142857142,13,13,GAATAGCGGAATGGACTTAT,0,1556741
galEp3,0.07142857142857142,13,13,GAAGTCAGTGACCGCTCACG,0,1578010
galEp3,0.07142857142857142,13,13,GAAGGATCTACATTCCTGGG,0,1591854
galEp3,0.07142857142857142,13,13,GAAGATGGTTGACGAAGAGA,0,1552835
galEp3,0.07142857142857142,13,13,GAAGATGGACGCGTTCTAAT,0,1556199
galEp3,0.07142857142857142,13,13,GAAGACCCGTATCCGGTCAT,0,1567037
galEp3,0.07142857142857142,13,13,CTTTCTGATACCGGCCCGAC,0,1572145
galEp3,0.07142857142857142,13,13,CTTGATGTTTCGTTTTCACT,0,1554874
galEp3,0.07142857142857142,13,13,CTTCGATAAATGACAGATAT,0,1563901
galEp3,0.07142857142857142,13,13,CTTCCTCAGTCCTTGGCCGT,0,1549061
galEp3,0.07142857142857142,13,13,CTTCATCACGGCTCGGTGCA,0,1575821
galEp3,0.07142857142857142,13,13,CTGTGATCTTTTACGTCGAT,0,1569304
galEp3,0.07142857142857142,13,13,CTGTCAGTCCTCTGTGTCAC,0,1582170
galEp3,0.07142857142857142,13,13,CTGTACAAGGCCAACATATG,0,1557415
galEp3,0.07142857142857142,13,13,CTGGAGCTTAGATCTTGCCC,0,1550671
galEp3,0.07142857142857142,13,13,CTGATTGTCTGCCACCAGGT,0,1563143
galEp3,0.07142857142857142,13,13,CTCTTGCAGTCCCGCTCCCG,0,1579072
galEp3,0.07142857142857142,13,13,CTCTCGGGTTGGGTTGCTAA,0,1570922
galEp3,0.07142857142857142,13,13,CTCGCTCGTGTGTGGTACGA,0,1575734
galEp3,0.07142857142857142,13,13,CTCGACTCACCTGTTGACGG,0,1568395
galEp3,0.07142857142857142,13,13,CTCCCGAAGCACCGGTAGTT,0,1580678
galEp3,0.07142857142857142,13,13,CTATAATCGTTTGTACGGCG,0,1571384
galEp3,0.07142857142857142,13,13,CTAGTCTTGCCTGATCGGCA,0,1558068
galEp3,0.07142857142857142,13,13,CTAGTAATCACTGAGGTAAT,0,1588460
galEp3,0.07142857142857142,13,13,CTACTATAGCGGTAAATACT,0,1573812
galEp3,0.07142857142857142,13,13,CGTTAACCAGCCCCCAATAA,0,1551324
galEp3,0.07142857142857142,13,13,CGTCGCGACTCACCTGGGTC,0,1579047
galEp3,0.07142857142857142,13,13,CGTACAGCCCCTGTTCGGGA,0,1556809
galEp3,0.07142857142857142,13,13,CGGGCATATAACAATTTTCT,0,1567180
galEp3,0.07142857142857142,13,13,CGGGCAATACAACCGAGTTA,0,1550957
galEp3,0.07142857142857142,13,13,CGGCTTTGGGTAGAAGGCTT,0,1558477
galEp3,0.07142857142857142,13,13,CGGATGCTGGTGTTATTGTC,0,1562109
galEp3,0.07142857142857142,13,13,CGCTGTCCCGCGACCTCGTT,0,1589556
galEp3,0.07142857142857142,13,13,CGCTCTAGTCTTGTCCTTTA,0,1547656
galEp3,0.07142857142857142,13,13,CGCGGTGCTTTAATCGTGTG,0,1553466
galEp3,0.07142857142857142,13,13,CGCCCGTCACACATTTCTAA,0,1556205
galEp3,0.07142857142857142,13,13,CGCAATTCCCGTCACAGATA,0,1552690
galEp3,0.07142857142857142,13,13,CGATGGGTGTGCCTCATATA,0,1564009
galEp3,0.07142857142857142,13,13,CGATACGATAGACACCTCAA,0,1572075
galEp3,0.07142857142857142,13,13,CGAGGAGACAGGAAGCATTT,0,1569923
galEp3,0.07142857142857142,13,13,CGACGCTTAGGTGATGCGGC,0,1550431
galEp3,0.07142857142857142,13,13,CGAACCGGGTAAGCATCACG,0,1587204
galEp3,0.07142857142857142,13,13,CCTTCACGATTACCGAGGCG,0,1587511
galEp3,0.07142857142857142,13,13,CCTCCGCTCGTCCAAGCGCA,0,1581477
galEp3,0.07142857142857142,13,13,CCTACGAATGCCTCGACTCG,0,1550384
galEp3,0.07142857142857142,13,13,CCGTAACTAACCTGTGGTTG,0,1556266
galEp3,0.07142857142857142,13,13,CCGGTGGCCTTTGAGTAAAA,0,1586409
galEp3,0.07142857142857142,13,13,CCGGTCACGCGTCCGGCATT,0,1555659
galEp3,0.07142857142857142,13,13,CCGGCGTACTAATTTTTGCA,0,1569266
galEp3,0.07142857142857142,13,13,CCGGAGATGACTTCATGCTC,0,1554367
galEp3,0.07142857142857142,13,13,CCGCTGGAAATCAGGCTCAT,0,1569318
galEp3,0.07142857142857142,13,13,CCGATCCTTTTAACAGCGGT,0,1561700
galEp3,0.07142857142857142,13,13,CCGACGCACTGCATTTCAGC,0,1561402
galEp3,0.07142857142857142,13,13,CCCTACCGAGGGTTGGCATC,0,1546564
galEp3,0.07142857142857142,13,13,CCCGCGCACGCGCCATACGT,0,1570869
galEp3,0.07142857142857142,13,13,CCCGCCGCAAACCGCTAGGA,0,1577120
galEp3,0.07142857142857142,13,13,CCCCCTTCCACCGCTGGGAA,0,1578126
galEp3,0.07142857142857142,13,13,CCCCCATGTCCCCGCATCTT,0,1574237
galEp3,0.07142857142857142,13,13,CCCAACTGGGATACGCGATG,0,1567839
galEp3,0.07142857142857142,13,13,CCAGAAACCAGCCCCGTGTG,0,1581240
galEp3,0.07142857142857142,13,13,CCAATTGCATATCGTACGTT,0,1591166
galEp3,0.07142857142857142,13,13,CCAAGGGTTCTAATGTTGCT,0,1547250
galEp3,0.07142857142857142,13,13,CATGGCACTATTACCCTTAC,0,1554234
galEp3,0.07142857142857142,13,13,CATGGACTAACTCTACGAAA,0,1577626
galEp3,0.07142857142857142,13,13,CATGATATATATGATGTGGT,0,1588955
galEp3,0.07142857142857142,13,13,CATCTGAAAACAGCAGTGGT,0,1574901
galEp3,0.07142857142857142,13,13,CATCCTACGAAATAATTAGT,0,1568545
galEp3,0.07142857142857142,13,13,CATATTGCGATAGTATTCGG,0,1575338
galEp3,0.07142857142857142,13,13,CAGTGGTTATTTGTCAATCC,0,1594483
galEp3,0.07142857142857142,13,13,CAGGCTTTGCAGTCCCCTAT,0,1572393
galEp3,0.07142857142857142,13,13,CAGGCTTGTGCGGGTGGGCT,0,1580240
galEp3,0.07142857142857142,13,13,CAGGCCCAAGGCTGTTGTTC,0,1582812
galEp3,0.07142857142857142,13,13,CAGAGCGTTTGCGGTTCGCG,0,1559570
galEp3,0.07142857142857142,13,13,CACTGGCGGCTAACGAGCCG,0,1592950
galEp3,0.07142857142857142,13,13,CACGGCCGGGCATCATGTAT,0,1588434
galEp3,0.07142857142857142,13,13,CACCTAGCGGGAATCGGGTT,0,1561283
galEp3,0.07142857142857142,13,13,CACCAGCGCACATTAGGAGT,0,1554365
galEp3,0.07142857142857142,13,13,CACAGGACTTCCAGCAGGTC,0,1590034
galEp3,0.07142857142857142,13,13,CACACAATTACAACCGGGGT,0,1570891
galEp3,0.07142857142857142,13,13,CACAAGTTAAATCCTTGGTT,0,1580265
galEp3,0.07142857142857142,13,13,CAATTATTACAGATTGTATA,0,1559383
galEp3,0.07142857142857142,13,13,CAATTAGACCGAGGATATCG,0,1589600
galEp3,0.07142857142857142,13,13,CAAGTAAGCGTGCCGCGCGA,0,1573559
galEp3,0.07142857142857142,13,13,CAAGCGATAATCGGAGGCTC,0,1568907
galEp3,0.07142857142857142,13,13,CAACGCTAATGGTGCCTCTC,0,1548053
galEp3,0.07142857142857142,13,13,CAAACTCGGGTACGTTTTAT,0,1591775
galEp3,0.07142857142857142,13,13,ATTTGGGGACATACCCCGTA,0,1575056
galEp3,0.07142857142857142,13,13,ATTGCCGTCCAGCGGTCAGG,0,1584474
galEp3,0.07142857142857142,13,13,ATTCGAATGCACGCCTACAC,0,1552405
galEp3,0.07142857142857142,13,13,ATTACTATCATAAACTGGCG,0,1580174
galEp3,0.07142857142857142,13,13,ATGTATTTCGATAAAAGACA,0,1558293
galEp3,0.07142857142857142,13,13,ATGTAGGTCAATTGCCGATA,0,1591835
galEp3,0.07142857142857142,13,13,ATGTAGGATTGTCAAGGCTG,0,1577460
galEp3,0.07142857142857142,13,13,ATGGGGGTTCGGGTCTGACT,0,1560541
galEp3,0.07142857142857142,13,13,ATGGCAGTTGGCAACCCATC,0,1568994
galEp3,0.07142857142857142,13,13,ATGCTGTACGCCTGAATCGG,0,1591920
galEp3,0.07142857142857142,13,13,ATGATGTTCACATCTGGTCA,0,1584024
galEp3,0.07142857142857142,13,13,ATGAATACGCGGCCTCGTTG,0,1572324
galEp3,0.07142857142857142,13,13,ATCTCAGATCCTGGTTCGCA,0,1572083
galEp3,0.07142857142857142,13,13,ATCTAGTAATGATTGGTCTA,0,1553667
galEp3,0.07142857142857142,13,13,ATCGCTCTGGCCGCCTATTC,0,1587016
galEp3,0.07142857142857142,13,13,ATCGCCCCTTCATTAAACCA,0,1562333
galEp3,0.07142857142857142,13,13,ATCATAGACCATATAACAAC,0,1554734
galEp3,0.07142857142857142,13,13,ATCAGCCGGACGAGAGTCCT,0,1580575
galEp3,0.07142857142857142,13,13,ATATGCATGTGTAGTGTGAT,0,1553463
galEp3,0.07142857142857142,13,13,ATATGATTGAAGGAAAATGG,0,1567182
galEp3,0.07142857142857142,13,13,ATATCAGTCTGCTTCCTTAC,0,1590275
galEp3,0.07142857142857142,13,13,ATACTCGGGGTATAGAAGAC,0,1587253
galEp3,0.07142857142857142,13,13,AGTTCTCAACTCTGAGTGTA,0,1584815
galEp3,0.07142857142857142,13,13,AGTGTGATCTACCCCGCGTA,0,1573872
galEp3,0.07142857142857142,13,13,AGTAATGGAATTGGCCTGCT,0,1570418
galEp3,0.07142857142857142,13,13,AGGTCTGTTGTCATGCTCTG,0,1586521
galEp3,0.07142857142857142,13,13,AGGTCCAAGTTGGGGTAGGT,0,1592066
galEp3,0.07142857142857142,13,13,AGGCTCCCGGGAGTGCTAAA,0,1593975
galEp3,0.07142857142857142,13,13,AGGCCACTGGGGGAAAATGC,0,1574735
galEp3,0.07142857142857142,13,13,AGCTAGTTACGAACCCGCTG,0,1571283
galEp3,0.07142857142857142,13,13,AGCGCTTCCCACTACAAGGA,0,1572246
galEp3,0.07142857142857142,13,13,AGCCTCATCCGGGACCCAAC,0,1556152
galEp3,0.07142857142857142,13,13,AGCCACTCCTTTACAGCTAG,0,1557332
galEp3,0.07142857142857142,13,13,AGCATTGTTACAGTGGACGA,0,1562526
galEp3,0.07142857142857142,13,13,AGCATAGTTAGCTTAAAAAT,0,1572452
galEp3,0.07142857142857142,13,13,AGATGGGGTTGACATAATTT,0,1561678
galEp3,0.07142857142857142,13,13,AGATATCGATAAGTCTTTTC,0,1558624
galEp3,0.07142857142857142,13,13,AGACGCTCGTGTACCGCTAG,0,1575361
galEp3,0.07142857142857142,13,13,ACTTGTCCCCGTGGCCAGAG,0,1579684
galEp3,0.07142857142857142,13,13,ACGGTGGGTAAGATAGCCCT,0,1592979
galEp3,0.07142857142857142,13,13,ACGGGCGGGGTATGGGATCG,0,1552204
galEp3,0.07142857142857142,13,13,ACGCTCCAAGCATATTATTT,0,1547087
galEp3,0.07142857142857142,13,13,ACGCCTATCGTACCGGCTTT,0,1577861
galEp3,0.07142857142857142,13,13,ACGATCTGGTGTGTTTTCAC,0,1566501
galEp3,0.07142857142857142,13,13,ACCTTGCTGGCACCACACCA,0,1568501
galEp3,0.07142857142857142,13,13,ACCGCTCCCGAACTGCATCC,0,1573885
galEp3,0.07142857142857142,13,13,ACCACGCGCCTATATAGCGG,0,1572123
galEp3,0.07142857142857142,13,13,ACCACCGGGGACTTCAAGAT,0,1564085
galEp3,0.07142857142857142,13,13,ACCAAAGTTACTCATCCTCT,0,1593560
galEp3,0.07142857142857142,13,13,ACATTGAGTGAGTGGCCCGC,0,1560598
galEp3,0.07142857142857142,13,13,ACAGGATGTCGGAACGTAGG,0,1556113
galEp3,0.07142857142857142,13,13,ACAGCGCCTAATTGTCTTAT,0,1580524
galEp3,0.07142857142857142,13,13,ACACCGGGCGCTGTCATAGT,0,1587140
galEp3,0.07142857142857142,13,13,ACACCCGTGATGCTTAACCA,0,1561286
galEp3,0.07142857142857142,13,13,ACAAACGTGATCTTCGTTTG,0,1558635
galEp3,0.07142857142857142,13,13,ACAAAATATCGATACGACAA,0,1577784
galEp3,0.07142857142857142,13,13,AATCATGGACTGCTTGAGCA,0,1582841
galEp3,0.07142857142857142,13,13,AATACTCACTGTTGTTCGTA,0,1575367
galEp3,0.07142857142857142,13,13,AATAAGCGCATCTCTTGATT,0,1575369
galEp3,0.07142857142857142,13,13,AAGTCTGTTGACATATCCGC,0,1583752
galEp3,0.07142857142857142,13,13,AAGTCAATCAGTACTCGGAG,0,1555777
galEp3,0.07142857142857142,13,13,AAGGGAGGGCAGTCCACGTG,0,1583388
galEp3,0.07142857142857142,13,13,AAGGCAGTCGCTCGCCGACG,0,1581307
galEp3,0.07142857142857142,13,13,AAGCTTAGAAAAATCAGAAG,0,1555351
galEp3,0.07142857142857142,13,13,AAGAGTCACGTTAGTGGGAT,0,1574536
galEp3,0.07142857142857142,13,13,AACTTTAAGATTGACCCATA,0,1594554
galEp3,0.07142857142857142,13,13,AACTTGTCACATGAGGCTCT,0,1547759
galEp3,0.07142857142857142,13,13,AACAGAAAACGTCCTTAGTC,0,1576119
galEp3,0.07142857142857142,13,13,AAATGGCGCTGTCTAAACCC,0,1572968
galEp3,0.07142857142857142,13,13,AAAATTCAGCTAGTCCCCGC,0,1571043
galEp3,0.07692307692307693,12,12,TTTTGGTACGGTTCTCACTG,0,1552831
galEp3,0.07692307692307693,12,12,TTTGCAATCGGGACAAGTTT,0,1568447
galEp3,0.07692307692307693,12,12,TTTCGAATTGGGTCATGTAT,0,1567605
galEp3,0.07692307692307693,12,12,TTTCATGGACCGACTGCTTC,0,1570627
galEp3,0.07692307692307693,12,12,TTTCAGACAGATTGCCAGTC,0,1559417
galEp3,0.07692307692307693,12,12,TTTAGAAACAGGACACTTAT,0,1578999
galEp3,0.07692307692307693,12,12,TTTACAACACGAGGATGCGT,0,1587896
galEp3,0.07692307692307693,12,12,TTTAACCCCAACGCATGTAT,0,1592817
galEp3,0.07692307692307693,12,12,TTGTAGAAGGTTCCCCGGGT,0,1575235
galEp3,0.07692307692307693,12,12,TTGGACTTACATCGAATAGA,0,1586375
galEp3,0.07692307692307693,12,12,TTCTGCGAATGGAAGCGCTA,0,1547307
galEp3,0.07692307692307693,12,12,TTCTCCCGAAAGGCAAATTC,0,1561856
galEp3,0.07692307692307693,12,12,TTCTCATCATAGCTTGAACA,0,1567408
galEp3,0.07692307692307693,12,12,TTCGTCCCATCAAAGAGTAC,0,1580603
galEp3,0.07692307692307693,12,12,TTCGGACATACTAATGGGCA,0,1563181
galEp3,0.07692307692307693,12,12,TTCGCGCGAGCAGAAACGCA,0,1576827
galEp3,0.07692307692307693,12,12,TTAGGGGGCCACTGGTAATG,0,1566697
galEp3,0.07692307692307693,12,12,TTACCCCAGCGCAACCTAGG,0,1565776
galEp3,0.07692307692307693,12,12,TTAACCAGTGCTGAACTATG,0,1574653
galEp3,0.07692307692307693,12,12,TGTCCGTAGGTTTCAAAATA,0,1573969
galEp3,0.07692307692307693,12,12,TGTATACGGATTGTCCTGTA,0,1583448
galEp3,0.07692307692307693,12,12,TGTAACTTGTTTCTAGATTG,0,1554279
galEp3,0.07692307692307693,12,12,TGGTTTCAGACACGTTCCAC,0,1584514
galEp3,0.07692307692307693,12,12,TGGTTGGCTGCCTGTACGTT,0,1560762
galEp3,0.07692307692307693,12,12,TGGTGTTACGCGTAGCGGAA,0,1572113
galEp3,0.07692307692307693,12,12,TGGTGGCCTGCGTACAACAA,0,1568020
galEp3,0.07692307692307693,12,12,TGGTAGGCGTGCCGTCTGGA,0,1586611
galEp3,0.07692307692307693,12,12,TGGGGCCGAGTATCAAGAGC,0,1588164
galEp3,0.07692307692307693,12,12,TGGCAAGTCCACTATAAATC,0,1580799
galEp3,0.07692307692307693,12,12,TGGAACGGGTGCATGCCTAG,0,1583762
galEp3,0.07692307692307693,12,12,TGCTTCACACGGTCACGAGA,0,1593833
galEp3,0.07692307692307693,12,12,TGCTACCGAGGTTTTGGCCG,0,1555696
galEp3,0.07692307692307693,12,12,TGCGCCTCTACAGGGGAAGA,0,1563412
galEp3,0.07692307692307693,12,12,TGCATACTTACAGCTGAAAT,0,1551684
galEp3,0.07692307692307693,12,12,TGCAGCACCGTACTTGGGTT,0,1550828
galEp3,0.07692307692307693,12,12,TGATGTCATATCGTTCTTCG,0,1557480
galEp3,0.07692307692307693,12,12,TGATACGACTCCGGGTACAG,0,1564043
galEp3,0.07692307692307693,12,12,TGAGGTCGTGATTAGCCAAT,0,1550933
galEp3,0.07692307692307693,12,12,TGAGCCGCTCATGGCCATAC,0,1586462
galEp3,0.07692307692307693,12,12,TGACTCGTCCGGTTTATCCA,0,1568828
galEp3,0.07692307692307693,12,12,TGACGGTGCACGTTGCGTGA,0,1553467
galEp3,0.07692307692307693,12,12,TGACCATCAATACCAAGGAG,0,1579423
galEp3,0.07692307692307693,12,12,TGAAGGGATCCCCCGAGAAC,0,1564851
galEp3,0.07692307692307693,12,12,TGAACTGACCAGTCCCAGCA,0,1550778
galEp3,0.07692307692307693,12,12,TCTTGGATGAGGGTGCAAAG,0,1593280
galEp3,0.07692307692307693,12,12,TCTCTAAGGGGGGCATGCGT,0,1562908
galEp3,0.07692307692307693,12,12,TCTCGTAACGGAGCCACACA,0,1594894
galEp3,0.07692307692307693,12,12,TCTCGCAACATCTTGTCAAG,0,1555109
galEp3,0.07692307692307693,12,12,TCTCACAGTTTTACCTCAAG,0,1564661
galEp3,0.07692307692307693,12,12,TCGTGGAACGACAGAATGTT,0,1585228
galEp3,0.07692307692307693,12,12,TCGGGTACACGTATTTGGTG,0,1570959
galEp3,0.07692307692307693,12,12,TCGGCTTAGAAAACCGTCTA,0,1565639
galEp3,0.07692307692307693,12,12,TCGCCGCCATACGCGGCATT,0,1574967
galEp3,0.07692307692307693,12,12,TCCTCCTACGTCAGTCAAGA,0,1568153
galEp3,0.07692307692307693,12,12,TCCTAGGTGGGTGTTTTATA,0,1588720
galEp3,0.07692307692307693,12,12,TCCTACGTGGTTCTACCCGG,0,1581651
galEp3,0.07692307692307693,12,12,TCCGTCTAGAGGCGCCCTGG,0,1584980
galEp3,0.07692307692307693,12,12,TCCGGTATAGGGCTGCAAAT,0,1594107
galEp3,0.07692307692307693,12,12,TCCGCCGCGGCCCAGGTTCT,0,1592714
galEp3,0.07692307692307693,12,12,TCCCCGGGGCTGTAGGCCGG,0,1594542
galEp3,0.07692307692307693,12,12,TCCCCCCAACTAAGAAATGT,0,1553109
galEp3,0.07692307692307693,12,12,TCCCCCACGGGTAGATCCAT,0,1588799
galEp3,0.07692307692307693,12,12,TCCCCAAGGTCGTTAAAGGG,0,1575581
galEp3,0.07692307692307693,12,12,TCCATTCGAGAGCATCTGTT,0,1589840
galEp3,0.07692307692307693,12,12,TCCATGTCATAAGCAAGTCT,0,1573373
galEp3,0.07692307692307693,12,12,TCATTTGCTGACGTGCCTTA,0,1585147
galEp3,0.07692307692307693,12,12,TCATTCCGCCTAAGTCTGTA,0,1578998
galEp3,0.07692307692307693,12,12,TCATACCTCCATCTAGCACA,0,1581859
galEp3,0.07692307692307693,12,12,TCAGGTTGCGCATGTCATGT,0,1590832
galEp3,0.07692307692307693,12,12,TCACGATCGAGACTTCTCGT,0,1578563
galEp3,0.07692307692307693,12,12,TCACCTGTGAGTATGGCGGT,0,1560867
galEp3,0.07692307692307693,12,12,TCAAGCCTGGAAAAGTAAAG,0,1566206
galEp3,0.07692307692307693,12,12,TCAACTGTCGAAGCTCCCGT,0,1582597
galEp3,0.07692307692307693,12,12,TCAACGATTGGGGGCGCCAT,0,1581219
galEp3,0.07692307692307693,12,12,TATTTTGGTAATGTCATTCA,0,1574195
galEp3,0.07692307692307693,12,12,TAGGGTACTCTCTAACCTGC,0,1578339
galEp3,0.07692307692307693,12,12,TAGGCAGATCGGGTGTTGCA,0,1557821
galEp3,0.07692307692307693,12,12,TAGGAGGGTTAAAAGTTTTA,0,1585776
galEp3,0.07692307692307693,12,12,TAGCACTACGACTGTACCCA,0,1587782
galEp3,0.07692307692307693,12,12,TAGCAAGTTTGGTAAGCTTA,0,1572269
galEp3,0.07692307692307693,12,12,TACTGCGCTTATTGCCCTCA,0,1548526
galEp3,0.07692307692307693,12,12,TACGATGTTCAACCAATTCG,0,1584615
galEp3,0.07692307692307693,12,12,TACACGGCGGTGCGAGCAAA,0,1561356
galEp3,0.07692307692307693,12,12,TAATGTCCTAAGACTTTGCA,0,1547924
galEp3,0.07692307692307693,12,12,TAATGCACACAACAGCGCCT,0,1561774
galEp3,0.07692307692307693,12,12,TAAGACACTTGTTAAAGTTT,0,1580384
galEp3,0.07692307692307693,12,12,TAACAGAAAGACCGTTAGGA,0,1581891
galEp3,0.07692307692307693,12,12,TAAAGATGCCTCAGGAGCCC,0,1590325
galEp3,0.07692307692307693,12,12,GTTTTGGCTGGCATCTCGAT,0,1592299
galEp3,0.07692307692307693,12,12,GTTTTATTCCAAGGTTATGC,0,1553115
galEp3,0.07692307692307693,12,12,GTTTGTACGGTGGCCAACGC,0,1565125
galEp3,0.07692307692307693,12,12,GTTCTAGGGTGCGACCTAAC,0,1573498
galEp3,0.07692307692307693,12,12,GTTCGTGGGGGTACACCGTT,0,1580802
galEp3,0.07692307692307693,12,12,GTTCGTGGGCTTGAGAACAG,0,1563954
galEp3,0.07692307692307693,12,12,GTTCCGGTCAAAATCTGAAC,0,1555945
galEp3,0.07692307692307693,12,12,GTTAGTGTGGTAGGGAACAC,0,1573139
galEp3,0.07692307692307693,12,12,GTTACGCCGGCGCTAATTCA,0,1568084
galEp3,0.07692307692307693,12,12,GTGTTTTTCCACGTACGGGT,0,1585692
galEp3,0.07692307692307693,12,12,GTGTGCATGGGCGAGACCGG,0,1556295
galEp3,0.07692307692307693,12,12,GTGTGATCAAAGCTTGATCC,0,1559353
galEp3,0.07692307692307693,12,12,GTGCAGCCCACTGATGCGAG,0,1568925
galEp3,0.07692307692307693,12,12,GTGAAAGTGGTTCTTTAGCA,0,1546983
galEp3,0.07692307692307693,12,12,GTCTTGCACGTTGTGACCGG,0,1549780
galEp3,0.07692307692307693,12,12,GTCTGTGTTCCATTGAAATT,0,1583036
galEp3,0.07692307692307693,12,12,GTCGTGCGATGTAGTTGCGG,0,1579885
galEp3,0.07692307692307693,12,12,GTCGCGTGAGTATCATCATT,0,1546717
galEp3,0.07692307692307693,12,12,GTCCCAATAGATACGGATAG,0,1550113
galEp3,0.07692307692307693,12,12,GTCACAACTTGATCTAAACC,0,1549006
galEp3,0.07692307692307693,12,12,GTCAAGAACGTCGCACTGTG,0,1562248
galEp3,0.07692307692307693,12,12,GTATTGGACAAGTGACCGCT,0,1589605
galEp3,0.07692307692307693,12,12,GTATCTATACGATCATCAGA,0,1551873
galEp3,0.07692307692307693,12,12,GTAGTGTGTACGCGGATCGA,0,1586475
galEp3,0.07692307692307693,12,12,GTAGGAGCAAACTTCAGGGT,0,1579908
galEp3,0.07692307692307693,12,12,GTAGGACTTTTTCTGTACCA,0,1554914
galEp3,0.07692307692307693,12,12,GTAATAGGGCTTCCGGTACC,0,1561480
galEp3,0.07692307692307693,12,12,GGTTTGTCTGTAGCACGATT,0,1564864
galEp3,0.07692307692307693,12,12,GGTTGCGTTCGTTGTATCCT,0,1547796
galEp3,0.07692307692307693,12,12,GGTTGACACTGCAAACAATC,0,1547032
galEp3,0.07692307692307693,12,12,GGTGCATCTGTGCGGTGTAC,0,1576902
galEp3,0.07692307692307693,12,12,GGTCAGGAAAGACACTGCAA,0,1593063
galEp3,0.07692307692307693,12,12,GGTAGACCTGACTTGAAGGC,0,1560961
galEp3,0.07692307692307693,12,12,GGGTTAAAATGGACGTATCG,0,1552123
galEp3,0.07692307692307693,12,12,GGGTAGGCAAAGAGCATCGT,0,1548861
galEp3,0.07692307692307693,12,12,GGGGTTATGCGCGAGCATTT,0,1578009
galEp3,0.07692307692307693,12,12,GGGGGTCGTCACAGGAGGGT,0,1561362
galEp3,0.07692307692307693,12,12,GGGGGCCAGCGAGTCCGCCC,0,1587994
galEp3,0.07692307692307693,12,12,GGGCTGAGTTGAGACGAGAA,0,1573526
galEp3,0.07692307692307693,12,12,GGGCATACGACCACTCCTGC,0,1557380
galEp3,0.07692307692307693,12,12,GGGATACTCGGACCTTTAGA,0,1573748
galEp3,0.07692307692307693,12,12,GGGATACTATAATGCGAAAA,0,1588234
galEp3,0.07692307692307693,12,12,GGGAGGGCTCCTCCCAGGAA,0,1571388
galEp3,0.07692307692307693,12,12,GGGAACTGATGTTCAGGGTT,0,1561455
galEp3,0.07692307692307693,12,12,GGCTGGCCGGCAAAACGGGG,0,1581344
galEp3,0.07692307692307693,12,12,GGCGGCCCGTAATGTGTAGC,0,1548181
galEp3,0.07692307692307693,12,12,GGCCGCGTCCGCGATGCCGG,0,1583611
galEp3,0.07692307692307693,12,12,GGCACCTAGCCGTGGGCCGT,0,1553063
galEp3,0.07692307692307693,12,12,GGCAACGTGGCCGCCTCGAT,0,1593971
galEp3,0.07692307692307693,12,12,GGATCAACGTCGCGCCTGTC,0,1582418
galEp3,0.07692307692307693,12,12,GGAGGACAGAAATCCGACTA,0,1565046
galEp3,0.07692307692307693,12,12,GGACGCCCAAATCGATTATT,0,1586652
galEp3,0.07692307692307693,12,12,GGACGACTACTAACTCTAGA,0,1564046
galEp3,0.07692307692307693,12,12,GGAACTACTCTTTTGAGGCA,0,1591857
galEp3,0.07692307692307693,12,12,GCTTTGTAGTTCGGCATGTA,0,1568687
galEp3,0.07692307692307693,12,12,GCTTATTAGCACCACGGGGG,0,1554663
galEp3,0.07692307692307693,12,12,GCTGTGTGAATCGGCAACAC,0,1554918
galEp3,0.07692307692307693,12,12,GCTCTCACTTGGCGCAGCAG,0,1579111
galEp3,0.07692307692307693,12,12,GCTACTTCACACGTACTCCA,0,1589883
galEp3,0.07692307692307693,12,12,GCGTATGGTAAGCGGGGGCA,0,1548062
galEp3,0.07692307692307693,12,12,GCGCTAGCAGTCCTCGGAGG,0,1593757
galEp3,0.07692307692307693,12,12,GCGCCCCGAGACGAAGTGGG,0,1569612
galEp3,0.07692307692307693,12,12,GCGAAAGTTCCATTCAGTTT,0,1571752
galEp3,0.07692307692307693,12,12,GCCTGGAGCCAAGCTACTGC,0,1548998
galEp3,0.07692307692307693,12,12,GCCTGCAAGAGGATTACGAT,0,1563262
galEp3,0.07692307692307693,12,12,GCCTAGTCTGTAGGTCCTCA,0,1563773
galEp3,0.07692307692307693,12,12,GCCGCAGCGACACGCGTGGC,0,1575913
galEp3,0.07692307692307693,12,12,GCCGACTCTCCGCGCAATAA,0,1570963
galEp3,0.07692307692307693,12,12,GCCCTGGTAACGTGCTATTG,0,1570962
galEp3,0.07692307692307693,12,12,GCCCGAGTCTACCCGGGGGG,0,1586533
galEp3,0.07692307692307693,12,12,GCCCGACGATTCGTCGTAAG,0,1556056
galEp3,0.07692307692307693,12,12,GCCCAATATGTTTATGTTCT,0,1562291
galEp3,0.07692307692307693,12,12,GCCATCAGGGGCACAGGAAT,0,1576965
galEp3,0.07692307692307693,12,12,GCCAGTCTCCGGAAGAACTT,0,1586081
galEp3,0.07692307692307693,12,12,GCATTGATGCTAGCCGACAT,0,1573532
galEp3,0.07692307692307693,12,12,GCATGCGATTTCGAAATATG,0,1586420
galEp3,0.07692307692307693,12,12,GCATGCCATGGCTTGCGGCG,0,1553750
galEp3,0.07692307692307693,12,12,GCATATCGGCATCATACTTA,0,1563888
galEp3,0.07692307692307693,12,12,GCAGGAATGCATCAATATTG,0,1587571
galEp3,0.07692307692307693,12,12,GCACTGAGAGTTGCATTCGC,0,1561746
galEp3,0.07692307692307693,12,12,GCACTCGGATTAGCGCCCTG,0,1563611
galEp3,0.07692307692307693,12,12,GCACAGGCCTGGAACGCTTA,0,1559258
galEp3,0.07692307692307693,12,12,GCAATCATGTATGAGTCTAA,0,1558873
galEp3,0.07692307692307693,12,12,GCAAACACGCGAACGAACGT,0,1555013
galEp3,0.07692307692307693,12,12,GATTTAGATGAGCATTTCCC,0,1590876
galEp3,0.07692307692307693,12,12,GATTCTAGGACGTCGGTAAT,0,1577985
galEp3,0.07692307692307693,12,12,GATTATTTGCTAGTGTGACG,0,1552929
galEp3,0.07692307692307693,12,12,GATATGTGACAAAAAGATGT,0,1571997
galEp3,0.07692307692307693,12,12,GATAGGTCTTATAATATTTC,0,1586584
galEp3,0.07692307692307693,12,12,GATACAAGTGTAGGCCTTCC,0,1583180
galEp3,0.07692307692307693,12,12,GATAAACGGATAGTTACTGG,0,1561701
galEp3,0.07692307692307693,12,12,GAGTGAGGGGCAGATGTTCG,0,1561250
galEp3,0.07692307692307693,12,12,GAGTAAGTAGGGCGATTGAA,0,1589212
galEp3,0.07692307692307693,12,12,GAGGGTGATAGGTAAATGTT,0,1554242
galEp3,0.07692307692307693,12,12,GAGGCCCCGTCTTTTCGGCA,0,1572612
galEp3,0.07692307692307693,12,12,GAGGAGTATTGTTCGCCTGT,0,1564385
galEp3,0.07692307692307693,12,12,GAGCTTTGAGGGAAATTAGG,0,1572610
galEp3,0.07692307692307693,12,12,GAGCCGTAGTGTATCCACTA,0,1559221
galEp3,0.07692307692307693,12,12,GACTCCGGCCGGTACACCTA,0,1576333
galEp3,0.07692307692307693,12,12,GACGGAGCCGTGATGCGAGA,0,1573501
galEp3,0.07692307692307693,12,12,GACGCTCGTATTCTCACCAT,0,1564588
galEp3,0.07692307692307693,12,12,GACGCTACAGCATCTCCCAG,0,1574248
galEp3,0.07692307692307693,12,12,GACCGGCATTGTTGCCTGCT,0,1575991
galEp3,0.07692307692307693,12,12,GACACGGTTCATCATGTCAC,0,1574911
galEp3,0.07692307692307693,12,12,GACACATGTTTCCGGACTCC,0,1581636
galEp3,0.07692307692307693,12,12,GAAGTACGTGGTGGCATTGA,0,1550981
galEp3,0.07692307692307693,12,12,GAAGCCGTCACAGTAATTCT,0,1571405
galEp3,0.07692307692307693,12,12,GAAGATGAGATTCAAAAAGT,0,1574293
galEp3,0.07692307692307693,12,12,GAAGAATGTTCAATCGCAAC,0,1593298
galEp3,0.07692307692307693,12,12,CTTGCATGCCCAATGGTCAC,0,1568345
galEp3,0.07692307692307693,12,12,CTTATCGGCACCAAGTGAAT,0,1581480
galEp3,0.07692307692307693,12,12,CTGGTGACTGAGCACATACA,0,1586643
galEp3,0.07692307692307693,12,12,CTGGCTACAGGATGGTGAAA,0,1567190
galEp3,0.07692307692307693,12,12,CTGCTCATTGCAAGAGCTGC,0,1586340
galEp3,0.07692307692307693,12,12,CTGCGTTCCCCCCAAGTAAG,0,1578624
galEp3,0.07692307692307693,12,12,CTGCGATTATTGCATTGCCA,0,1548586
galEp3,0.07692307692307693,12,12,CTGAAGCGTGAGGCATCCAG,0,1556844
galEp3,0.07692307692307693,12,12,CTCTTGCAGCCCCTGGTTCA,0,1558143
galEp3,0.07692307692307693,12,12,CTCTACCACATGACAGAGTT,0,1577506
galEp3,0.07692307692307693,12,12,CTCTACAGTGACCGCTTTAT,0,1574875
galEp3,0.07692307692307693,12,12,CTCGTGAAGTACATGCTTAA,0,1579043
galEp3,0.07692307692307693,12,12,CTCGGGTCTTAGGCGGCCTA,0,1550302
galEp3,0.07692307692307693,12,12,CTCCGTCTAAGAGAAGCTTT,0,1562559
galEp3,0.07692307692307693,12,12,CTCCAGACTCGTCCTACGGT,0,1565764
galEp3,0.07692307692307693,12,12,CTCACGCATCTCCATAGTGC,0,1563121
galEp3,0.07692307692307693,12,12,CTCAATCCTTGGGGCTGCTG,0,1549912
galEp3,0.07692307692307693,12,12,CTATGGAACGGCGAGAGCCA,0,1548785
galEp3,0.07692307692307693,12,12,CTATCGATGGATAAAGCAGC,0,1588907
galEp3,0.07692307692307693,12,12,CTAGTCCGGACCATTCTTGC,0,1576008
galEp3,0.07692307692307693,12,12,CTAGTAACGGGATGAATTCC,0,1569551
galEp3,0.07692307692307693,12,12,CTAGCCGGCTCATAAACAGA,0,1581707
galEp3,0.07692307692307693,12,12,CTAGAGTACTGTGTGGTGAG,0,1546856
galEp3,0.07692307692307693,12,12,CTAAGCGTTTCTCCTATTTG,0,1550611
galEp3,0.07692307692307693,12,12,CGTTTTATGTAACCTTCAAT,0,1557973
galEp3,0.07692307692307693,12,12,CGTTTCACCTCGGTCGGTGA,0,1566025
galEp3,0.07692307692307693,12,12,CGTACCATACATGTATATGT,0,1569209
galEp3,0.07692307692307693,12,12,CGGTGTTCAATAGCTCTAAG,0,1568685
galEp3,0.07692307692307693,12,12,CGGTGTCGGACTCTTCGTGT,0,1552592
galEp3,0.07692307692307693,12,12,CGGTGGGGGGGATCGAATAC,0,1572458
galEp3,0.07692307692307693,12,12,CGGTAGTGGTATGGACCGGT,0,1583152
galEp3,0.07692307692307693,12,12,CGGCGGCCAGGTTTTGGCAT,0,1575931
galEp3,0.07692307692307693,12,12,CGGACATAGGACTCGAGCAT,0,1570507
galEp3,0.07692307692307693,12,12,CGCTCCACGAGACACATGCT,0,1553269
galEp3,0.07692307692307693,12,12,CGCTAATGCGAGACTGGTCA,0,1557681
galEp3,0.07692307692307693,12,12,CGCTAACTCTTCTATGTTGC,0,1580424
galEp3,0.07692307692307693,12,12,CGCCGCTGTCATCCCATCCT,0,1569589
galEp3,0.07692307692307693,12,12,CGCCCACGCCAGACAACCGA,0,1594988
galEp3,0.07692307692307693,12,12,CGCATTACAACACACTGCGC,0,1553386
galEp3,0.07692307692307693,12,12,CGCAAGTAATCCGTCAACGG,0,1563036
galEp3,0.07692307692307693,12,12,CGAGTTTAATGCCTAATACA,0,1571760
galEp3,0.07692307692307693,12,12,CGAGTCGGAGCACAGTAGAC,0,1588739
galEp3,0.07692307692307693,12,12,CGAGGAATTCAAGCGTCGCG,0,1586009
galEp3,0.07692307692307693,12,12,CGAGCCTCAATGGTTCTCGG,0,1581246
galEp3,0.07692307692307693,12,12,CGAGCATTATAGGTAGTTAC,0,1581896
galEp3,0.07692307692307693,12,12,CGAGCAAGACGGTCGTTTCC,0,1587308
galEp3,0.07692307692307693,12,12,CGAATCACTTCGAACCAGCA,0,1567530
galEp3,0.07692307692307693,12,12,CGAAGAAGCACAATAAACTT,0,1572863
galEp3,0.07692307692307693,12,12,CCTTTTACCTCACTACTGGC,0,1547371
galEp3,0.07692307692307693,12,12,CCTTTCTTAGCCCCAATCGT,0,1583041
galEp3,0.07692307692307693,12,12,CCTTACCGATTAGGATCAGG,0,1548726
galEp3,0.07692307692307693,12,12,CCTGGATAAAATCGGCCGCG,0,1578753
galEp3,0.07692307692307693,12,12,CCTCTCATAGCGAGTAATTG,0,1559776
galEp3,0.07692307692307693,12,12,CCTATATCTAATTACGGGAC,0,1559696
galEp3,0.07692307692307693,12,12,CCTAATGCCTTCTCGGCTGC,0,1548528
galEp3,0.07692307692307693,12,12,CCGGTAGTCCTGCTCAGGTC,0,1572000
galEp3,0.07692307692307693,12,12,CCGCTCGTCATCGTGTGGCA,0,1552775
galEp3,0.07692307692307693,12,12,CCGCCGGATCGTGGGACCCC,0,1572179
galEp3,0.07692307692307693,12,12,CCGAAGAAGTACCGATTAAT,0,1577052
galEp3,0.07692307692307693,12,12,CCCTTCAGGTAAATCTTCCA,0,1578086
galEp3,0.07692307692307693,12,12,CCCTCCCGCGGTTTTTTGCC,0,1555125
galEp3,0.07692307692307693,12,12,CCCTAGCGAAGACGCGGTCA,0,1589100
galEp3,0.07692307692307693,12,12,CCCGCTCGACGATAATTTTA,0,1587797
galEp3,0.07692307692307693,12,12,CCCGCGGGAAGACCCCGACT,0,1588899
galEp3,0.07692307692307693,12,12,CCCCCTGCATGTGGATGATA,0,1566112
galEp3,0.07692307692307693,12,12,CCCAGTTAATAACTCAGTTC,0,1590143
galEp3,0.07692307692307693,12,12,CCATTGAGGGGATGTATTGG,0,1581767
galEp3,0.07692307692307693,12,12,CCACTATTGACGCGTCGCGA,0,1584048
galEp3,0.07692307692307693,12,12,CATTATGCGGCTGTCTCCTA,0,1563576
galEp3,0.07692307692307693,12,12,CATTACTTGCGTCATTGTAT,0,1565079
galEp3,0.07692307692307693,12,12,CATCAAATACACAGTGCTAT,0,1556291
galEp3,0.07692307692307693,12,12,CAGTTGAGTCGTGAAGCCCC,0,1564500
galEp3,0.07692307692307693,12,12,CAGTGCCGGTAATCGGGTCC,0,1575134
galEp3,0.07692307692307693,12,12,CAGTGAAATCCTTTAGTAAC,0,1575384
galEp3,0.07692307692307693,12,12,CAGTACGTTCGTCCGGAGGA,0,1552216
galEp3,0.07692307692307693,12,12,CAGGTCGCGGGGTTCAGTGA,0,1573496
galEp3,0.07692307692307693,12,12,CAGGATTAGTTCTAGAGATA,0,1573099
galEp3,0.07692307692307693,12,12,CAGCTAAGAGTGGACTGAGG,0,1566470
galEp3,0.07692307692307693,12,12,CAGCGTTGTTATCTACCAGC,0,1588526
galEp3,0.07692307692307693,12,12,CAGCCTGATAGCGTCGCCTG,0,1559186
galEp3,0.07692307692307693,12,12,CAGACGCGGAAACATAATCT,0,1591240
galEp3,0.07692307692307693,12,12,CACTTATATAAGGCCTTAAA,0,1569203
galEp3,0.07692307692307693,12,12,CACGGATGATCTTTCTTTGT,0,1572351
galEp3,0.07692307692307693,12,12,CACGGAGTCAGGCCGGTTTG,0,1555535
galEp3,0.07692307692307693,12,12,CACGAGAGCAAACTTCCTGG,0,1579691
galEp3,0.07692307692307693,12,12,CACAGCCTTCTCTAAGGAAT,0,1566058
galEp3,0.07692307692307693,12,12,CAATTTTAGTGCAGATAAAC,0,1564462
galEp3,0.07692307692307693,12,12,CAATGGAAACGTGTTTTGTA,0,1548954
galEp3,0.07692307692307693,12,12,CAATAAGATGTAACGTTGGT,0,1548183
galEp3,0.07692307692307693,12,12,CAAGCGATCATTGGGTGTAT,0,1549050
galEp3,0.07692307692307693,12,12,CAACCGAACTCGTCTGCACT,0,1571603
galEp3,0.07692307692307693,12,12,ATTTTTTGCAGGTCCAGCTT,0,1554970
galEp3,0.07692307692307693,12,12,ATTTGTTCCAGATGCCCAGG,0,1554497
galEp3,0.07692307692307693,12,12,ATTGCGGGTCGAAACATTAT,0,1551670
galEp3,0.07692307692307693,12,12,ATTCAGCTTATCGGCACAAT,0,1578590
galEp3,0.07692307692307693,12,12,ATTAGGGGCATGGGAGATCA,0,1548958
galEp3,0.07692307692307693,12,12,ATTAGCATCCTGGGTACCGT,0,1578234
galEp3,0.07692307692307693,12,12,ATGGTGCAATCTAAGTCTTA,0,1587477
galEp3,0.07692307692307693,12,12,ATGGGGCCGGTAGCGATACT,0,1593974
galEp3,0.07692307692307693,12,12,ATGGCAAAAGCCACCCGTTA,0,1565428
galEp3,0.07692307692307693,12,12,ATGGATATTGATTCTACAGT,0,1565767
galEp3,0.07692307692307693,12,12,ATGCACTCTATAAGGTCACG,0,1547912
galEp3,0.07692307692307693,12,12,ATGATTGATTTCAAAAGGAT,0,1555952
galEp3,0.07692307692307693,12,12,ATGATATTATGTGAAGGTCA,0,1568089
galEp3,0.07692307692307693,12,12,ATGAACGGTTGTAGACTCTA,0,1571525
galEp3,0.07692307692307693,12,12,ATCTGGGTTAATTTTCCGGC,0,1587727
galEp3,0.07692307692307693,12,12,ATCTGAGGCCTAGGGGTATA,0,1557126
galEp3,0.07692307692307693,12,12,ATCGTGTAGACGTTGCCCGT,0,1548619
galEp3,0.07692307692307693,12,12,ATCATGGTGTTGCAGTGTGG,0,1587600
galEp3,0.07692307692307693,12,12,ATCATGATAGGCACGGTAAT,0,1592372
galEp3,0.07692307692307693,12,12,ATCATAGGCTAAGAATCTAA,0,1550527
galEp3,0.07692307692307693,12,12,ATCAGGGCGGAAACGGTAAC,0,1559134
galEp3,0.07692307692307693,12,12,ATCACCACACTAGCGGTATA,0,1582514
galEp3,0.07692307692307693,12,12,ATCAACTCGTTATGACGGAT,0,1575026
galEp3,0.07692307692307693,12,12,ATATCTGGTCCCCTAACCGC,0,1576860
galEp3,0.07692307692307693,12,12,ATAGGGGCGTCTTGATGCGT,0,1560850
galEp3,0.07692307692307693,12,12,ATAATGGCCCGGTCCTGCAA,0,1550476
galEp3,0.07692307692307693,12,12,ATAACTAGCTGGAGCGCTTA,0,1577707
galEp3,0.07692307692307693,12,12,ATAAATTTTAACTGCTCTGA,0,1567443
galEp3,0.07692307692307693,12,12,ATAAAGGACGGTAAGTAGGT,0,1584111
galEp3,0.07692307692307693,12,12,ATAAAATGTACTCTCGGCCG,0,1577722
galEp3,0.07692307692307693,12,12,AGTTTTTCTCATGTGCGCGG,0,1577425
galEp3,0.07692307692307693,12,12,AGTTGTCCACTTCAGGGCTT,0,1557171
galEp3,0.07692307692307693,12,12,AGTTGCCTATAAGTCGGTGG,0,1579998
galEp3,0.07692307692307693,12,12,AGTGTGCACCCGGATCACGG,0,1570713
galEp3,0.07692307692307693,12,12,AGTCTAGGACTAATAAATCG,0,1569054
galEp3,0.07692307692307693,12,12,AGTCCTTGACTACGCACTCC,0,1557252
galEp3,0.07692307692307693,12,12,AGTAAGTCTGCCTATCAAGT,0,1551356
galEp3,0.07692307692307693,12,12,AGTAACCTAGACCCCCTAAA,0,1575541
galEp3,0.07692307692307693,12,12,AGGTATGCTTTCATCGATAC,0,1585737
galEp3,0.07692307692307693,12,12,AGGTAGGATAAATGCTAAAT,0,1555279
galEp3,0.07692307692307693,12,12,AGGTACCAGCTTGATCCGGA,0,1555933
galEp3,0.07692307692307693,12,12,AGGGGTAAGCGTCATGAACT,0,1549125
galEp3,0.07692307692307693,12,12,AGGGGCTCAGGTATGAACTC,0,1585310
galEp3,0.07692307692307693,12,12,AGGGGCAATCATCGGGAGTG,0,1553136
galEp3,0.07692307692307693,12,12,AGGGCTATCCACCAATACAC,0,1580166
galEp3,0.07692307692307693,12,12,AGGATCAGTTGACACCTATC,0,1576285
galEp3,0.07692307692307693,12,12,AGGAATTTGGAGGTCCCATT,0,1549001
galEp3,0.07692307692307693,12,12,AGCTAATAGAGACAGAGCCT,0,1555304
galEp3,0.07692307692307693,12,12,AGCGCTACCTCATCGCTCGC,0,1558265
galEp3,0.07692307692307693,12,12,AGCGACTATGATTTCGCTTT,0,1585102
galEp3,0.07692307692307693,12,12,AGCCGCGGATACGCACGCCC,0,1573182
galEp3,0.07692307692307693,12,12,AGCCCTGAGTCCTCTTTGCA,0,1553182
galEp3,0.07692307692307693,12,12,AGCCCGTGCTCGAAATATTG,0,1570536
galEp3,0.07692307692307693,12,12,AGCACACTTTTACGATCTTA,0,1579078
galEp3,0.07692307692307693,12,12,AGATTGCCGGCTATCGTGGT,0,1557443
galEp3,0.07692307692307693,12,12,AGATTCCTCAGGGCGTAAGC,0,1572050
galEp3,0.07692307692307693,12,12,AGATGTATGGTTGGTTAACG,0,1592091
galEp3,0.07692307692307693,12,12,AGATGGGTTGTAGAGATTAG,0,1555568
galEp3,0.07692307692307693,12,12,AGATGAGCGGCACGAAGTCA,0,1549384
galEp3,0.07692307692307693,12,12,AGAGAAGCAACCACGCAGTA,0,1550860
galEp3,0.07692307692307693,12,12,AGACTTCTCTAGTTCCCGTT,0,1551556
galEp3,0.07692307692307693,12,12,AGACGATAATCCCCACTGTA,0,1566352
galEp3,0.07692307692307693,12,12,AGACGAGGTCGGGAACGCTG,0,1579664
galEp3,0.07692307692307693,12,12,AGACCGGGCCTTTACTAGGC,0,1556340
galEp3,0.07692307692307693,12,12,AGAACTAACATGGGCGCCGT,0,1560641
galEp3,0.07692307692307693,12,12,AGAACGATAGCGCACCACAG,0,1589209
galEp3,0.07692307692307693,12,12,ACTGGAGTTCTAGACCCGAA,0,1570906
galEp3,0.07692307692307693,12,12,ACTGAACCCGGTAAAAATAC,0,1581118
galEp3,0.07692307692307693,12,12,ACTCCTGCAATTTGATGTAC,0,1557390
galEp3,0.07692307692307693,12,12,ACTCAGGGTTTCCCCTGAAA,0,1575322
galEp3,0.07692307692307693,12,12,ACTAGCCTAGTAGCGAGTGT,0,1553366
galEp3,0.07692307692307693,12,12,ACGGGACATCTACAGCGGAT,0,1567280
galEp3,0.07692307692307693,12,12,ACGCACGCAACGCACGCAGT,0,1561785
galEp3,0.07692307692307693,12,12,ACCTTGTTGCGGCGGGCATG,0,1569734
galEp3,0.07692307692307693,12,12,ACCGTCTCAGCTCTGCACTA,0,1592678
galEp3,0.07692307692307693,12,12,ACCGTCACGTCAATGTAACC,0,1572383
galEp3,0.07692307692307693,12,12,ACCGCCTTAGCATACGAAGG,0,1594597
galEp3,0.07692307692307693,12,12,ACCCTAGATTGTCTCAACTT,0,1571286
galEp3,0.07692307692307693,12,12,ACCCCTCCGAGCATCCAAAT,0,1561116
galEp3,0.07692307692307693,12,12,ACCAATGAGGCTGTTCTAAG,0,1577669
galEp3,0.07692307692307693,12,12,ACATTCGTGCCTCGCCAGAT,0,1584451
galEp3,0.07692307692307693,12,12,ACATGGTGAGTGAGTTAGAG,0,1553975
galEp3,0.07692307692307693,12,12,ACATACGGTTAATTTGGCGT,0,1591294
galEp3,0.07692307692307693,12,12,ACAGGTCACCCGGGATTAGC,0,1558806
galEp3,0.07692307692307693,12,12,ACAGCCGGCTTTAGCTTTAT,0,1558734
galEp3,0.07692307692307693,12,12,ACACAGTGTCCGGCAACAAC,0,1552883
galEp3,0.07692307692307693,12,12,ACACAACAATCGTAATAATC,0,1577810
galEp3,0.07692307692307693,12,12,ACAAAAGATGGCAGTTCTAT,0,1589893
galEp3,0.07692307692307693,12,12,AATTTCTCAACACAAAATTT,0,1592154
galEp3,0.07692307692307693,12,12,AATTTCGCTGCCGATTTAAA,0,1578120
galEp3,0.07692307692307693,12,12,AATGTGCGGTTTCCTTCCGG,0,1571715
galEp3,0.07692307692307693,12,12,AATGATGGGCGTTGACACTC,0,1548680
galEp3,0.07692307692307693,12,12,AATCGGGCAAACCGGGCATA,0,1591443
galEp3,0.07692307692307693,12,12,AAGGTAGGGATAGTCACACC,0,1581783
galEp3,0.07692307692307693,12,12,AAGGCGCACTTAATCAGTAA,0,1564297
galEp3,0.07692307692307693,12,12,AAGCTGGGGAAGATACAGGT,0,1554536
galEp3,0.07692307692307693,12,12,AAGCTCCTATTCTGGTGATG,0,1555303
galEp3,0.07692307692307693,12,12,AAGCGCTGGGTCCCCCCAAT,0,1571162
galEp3,0.07692307692307693,12,12,AAGACGGCGGATGGTCTATG,0,1557767
galEp3,0.07692307692307693,12,12,AACTTTGAAGTATGCTAAGT,0,1579957
galEp3,0.07692307692307693,12,12,AACTGGCTTATGTGCGTCAA,0,1562631
galEp3,0.07692307692307693,12,12,AACTCAGCAAATCTAACATT,0,1554127
galEp3,0.07692307692307693,12,12,AACGTCATTGCGGGTCCGGA,0,1550228
galEp3,0.07692307692307693,12,12,AACGTATCGCTTAGTGGTAT,0,1554584
galEp3,0.07692307692307693,12,12,AACCGGGGTGAGGCTTAACC,0,1576343
galEp3,0.07692307692307693,12,12,AACCATCCTGGATCTAATAT,0,1556570
galEp3,0.07692307692307693,12,12,AACACTCGTTACTACTGCTC,0,1564704
galEp3,0.07692307692307693,12,12,AACAACCCTGGAGTACCGAC,0,1561449
galEp3,0.07692307692307693,12,12,AAATTAACGTCTTAGTGTAA,0,1559434
galEp3,0.07692307692307693,12,12,AAATGCGGACCGTTAATTAC,0,1564772
galEp3,0.07692307692307693,12,12,AAACGTTTGTCTCTAGACCA,0,1572342
galEp3,0.07692307692307693,12,12,AAACATTCAAAATTAAAAAC,0,1566247
galEp3,0.08333333333333333,11,11,TTTTGCAGCGATCGTGTGTC,0,1546544
galEp3,0.08333333333333333,11,11,TTTTGAACGGTGCAGGGGGG,0,1588211
galEp3,0.08333333333333333,11,11,TTTTCTGGGCTAACTGTCAA,0,1552521
galEp3,0.08333333333333333,11,11,TTTTAACATCCTGCGTATCT,0,1574890
galEp3,0.08333333333333333,11,11,TTTCGATGTTAGTTCTGGTG,0,1568871
galEp3,0.08333333333333333,11,11,TTGTCGTAGCGCCATGTTTG,0,1581862
galEp3,0.08333333333333333,11,11,TTGGCGAGTGTTTGAACTAA,0,1554389
galEp3,0.08333333333333333,11,11,TTGCATCGGAGCCAACTAAC,0,1574227
galEp3,0.08333333333333333,11,11,TTGCAATTGGGGCCATTTGA,0,1592568
galEp3,0.08333333333333333,11,11,TTCTTGGCGATTCCGTGTAA,0,1547757
galEp3,0.08333333333333333,11,11,TTCTAGCCCGCGGGACGGGA,0,1570542
galEp3,0.08333333333333333,11,11,TTCCAAGATCTGTACTAAAG,0,1575233
galEp3,0.08333333333333333,11,11,TTCAGGAAACCTTCCATTAA,0,1559669
galEp3,0.08333333333333333,11,11,TTCAATCCTATCACCATTCA,0,1569244
galEp3,0.08333333333333333,11,11,TTATCAGGCATTGGTCGAAA,0,1553078
galEp3,0.08333333333333333,11,11,TTATAGACATGAATAGTTCG,0,1576926
galEp3,0.08333333333333333,11,11,TTAGTCCAATTGATGAAATC,0,1585675
galEp3,0.08333333333333333,11,11,TTAGGCATAGCGGTCTCTAT,0,1573949
galEp3,0.08333333333333333,11,11,TTAGCCAGACTAGAGTATTG,0,1577957
galEp3,0.08333333333333333,11,11,TTAGAGCGCCCTGGCTTTAC,0,1546938
galEp3,0.08333333333333333,11,11,TTAGACCCAAAAGCCCGATG,0,1562870
galEp3,0.08333333333333333,11,11,TTACCAAGCTGCAGAGTGCG,0,1563345
galEp3,0.08333333333333333,11,11,TTAACGGGTGTCCGTCGATA,0,1547380
galEp3,0.08333333333333333,11,11,TGTTTTTGTACCCGCTGAAG,0,1576463
galEp3,0.08333333333333333,11,11,TGTTATTCGGCAAGTATCAA,0,1593335
galEp3,0.08333333333333333,11,11,TGTTACAAGCATAGGGTAAT,0,1546551
galEp3,0.08333333333333333,11,11,TGTGCTAGGGAGCTCTGAAC,0,1556506
galEp3,0.08333333333333333,11,11,TGTGAATCTTTTGATTCTTG,0,1589387
galEp3,0.08333333333333333,11,11,TGTCGGTTTAATAGTTCCAT,0,1555348
galEp3,0.08333333333333333,11,11,TGTCGCTTGAATAAGCTCAA,0,1547183
galEp3,0.08333333333333333,11,11,TGTCGAGCAACGGCACTCTG,0,1547514
galEp3,0.08333333333333333,11,11,TGTAGGACTTTAAATCCCTC,0,1548456
galEp3,0.08333333333333333,11,11,TGTAATTCGGGCGAGTTATC,0,1551006
galEp3,0.08333333333333333,11,11,TGTAAGTTAGGTCAGGGTGA,0,1565765
galEp3,0.08333333333333333,11,11,TGGTCCCGCACCAAAGAGTA,0,1589765
galEp3,0.08333333333333333,11,11,TGGTACCCGGTCCGAAGATT,0,1580805
galEp3,0.08333333333333333,11,11,TGGGTAAGTGTCGTCCTGTT,0,1567548
galEp3,0.08333333333333333,11,11,TGGGCGCTTGCTTAGCGTGA,0,1568968
galEp3,0.08333333333333333,11,11,TGGCAGTTTTTTACGATTAA,0,1571498
galEp3,0.08333333333333333,11,11,TGCGTGGGGTATCCGCGAGT,0,1582906
galEp3,0.08333333333333333,11,11,TGCGGAAAGAACATTATCAC,0,1566218
galEp3,0.08333333333333333,11,11,TGCGATTCATCCTGCCCAGG,0,1548531
galEp3,0.08333333333333333,11,11,TGCATGGGCGGTGCGTGCAG,0,1590623
galEp3,0.08333333333333333,11,11,TGATGTGTGGTGGGTTGATC,0,1550707
galEp3,0.08333333333333333,11,11,TGAGTAAGCCTCCCTCAGGT,0,1583306
galEp3,0.08333333333333333,11,11,TGAGAAGATGTCAGCCAGCG,0,1561431
galEp3,0.08333333333333333,11,11,TGACCCCTTAACAAACGGAG,0,1591546
galEp3,0.08333333333333333,11,11,TGACAAGCGCCCTGGTTACA,0,1575144
galEp3,0.08333333333333333,11,11,TGAAATGATGCTTACCATTC,0,1560878
galEp3,0.08333333333333333,11,11,TCTTTTGGTGGAGATAAGTG,0,1580940
galEp3,0.08333333333333333,11,11,TCTGAAAACCAGGGGAGTGT,0,1567274
galEp3,0.08333333333333333,11,11,TCTCTGTTATAGCTACACTC,0,1559192
galEp3,0.08333333333333333,11,11,TCTCGAGTAGAAAGCGTCCG,0,1574376
galEp3,0.08333333333333333,11,11,TCTATGCGCGATGTACCCGT,0,1550344
galEp3,0.08333333333333333,11,11,TCGTTTGTTGACCGAGGATT,0,1593467
galEp3,0.08333333333333333,11,11,TCGTCCCGAATCAGAGCTCC,0,1566163
galEp3,0.08333333333333333,11,11,TCGCTAGCGCGACATCCCCA,0,1548450
galEp3,0.08333333333333333,11,11,TCGCTACATATATTTCCAAT,0,1556386
galEp3,0.08333333333333333,11,11,TCGCGATCGACTCGCGAGGC,0,1566155
galEp3,0.08333333333333333,11,11,TCGCATGCGGAGTTATCAGG,0,1589884
galEp3,0.08333333333333333,11,11,TCGATTGTTCATTCAGTATT,0,1557921
galEp3,0.08333333333333333,11,11,TCGAGAATCATTCTACCACG,0,1554045
galEp3,0.08333333333333333,11,11,TCCCTGTTATCCGATATCGT,0,1569910
galEp3,0.08333333333333333,11,11,TCCCAACATGGCCCTTAACC,0,1565191
galEp3,0.08333333333333333,11,11,TCCACAATGAGTCAAGGTTG,0,1591566
galEp3,0.08333333333333333,11,11,TCCAACTGCATACCGAGTAG,0,1582479
galEp3,0.08333333333333333,11,11,TCATCACGGTTGGCCTACCT,0,1552724
galEp3,0.08333333333333333,11,11,TCAGGATGTTTGGTCACACC,0,1550891
galEp3,0.08333333333333333,11,11,TCACGGGATGCTGCGCAGGG,0,1560495
galEp3,0.08333333333333333,11,11,TCACGAACTTTAAGGCGTGG,0,1556091
galEp3,0.08333333333333333,11,11,TATTGGGAGATCCTGATCAC,0,1547355
galEp3,0.08333333333333333,11,11,TATCTGATCGGACTGGTATG,0,1551591
galEp3,0.08333333333333333,11,11,TATCTGATATTGGAGACGAA,0,1589068
galEp3,0.08333333333333333,11,11,TATCATGCGATTAACTAAGA,0,1573105
galEp3,0.08333333333333333,11,11,TAGCGAACCTTGTATAGGGG,0,1568692
galEp3,0.08333333333333333,11,11,TAGCCAGCCATTCATTTCGG,0,1563705
galEp3,0.08333333333333333,11,11,TAGCAAATAGCCAGTCGCTA,0,1554041
galEp3,0.08333333333333333,11,11,TAGAGCCGAAGAACCCGGGG,0,1553209
galEp3,0.08333333333333333,11,11,TAGAGAGGAGTTGATCCCAG,0,1588660
galEp3,0.08333333333333333,11,11,TAGACCCAGCCGTCCTACAG,0,1576290
galEp3,0.08333333333333333,11,11,TACTGTTGCGCACAAGATCT,0,1587151
galEp3,0.08333333333333333,11,11,TACTGGGTTATAGTACTTGC,0,1573353
galEp3,0.08333333333333333,11,11,TACTCCCCCAGTAACGCGGT,0,1593570
galEp3,0.08333333333333333,11,11,TACGTGCCATACTCCCGGTG,0,1572918
galEp3,0.08333333333333333,11,11,TACGGGTGTTGTGCCCGGCT,0,1594991
galEp3,0.08333333333333333,11,11,TACCATGGCATAGGCCTGCT,0,1593637
galEp3,0.08333333333333333,11,11,TACAACGATGATCCATTTCA,0,1590940
galEp3,0.08333333333333333,11,11,TAATCCCCGACCCCTGAAAC,0,1576592
galEp3,0.08333333333333333,11,11,TAAGTCCAAGTTCAGTACAT,0,1572550
galEp3,0.08333333333333333,11,11,TAACGCGTCATAGCTAGAAG,0,1566711
galEp3,0.08333333333333333,11,11,TAACCGAACTTACATTAGAT,0,1577705
galEp3,0.08333333333333333,11,11,TAAATAATCTGTCTGGACCG,0,1588661
galEp3,0.08333333333333333,11,11,TAAAACGTTGTATTTTGATT,0,1585247
galEp3,0.08333333333333333,11,11,GTTTGGAGGTTGCTATCTGA,0,1581934
galEp3,0.08333333333333333,11,11,GTTTCATAGAAGTGGGAGCC,0,1589270
galEp3,0.08333333333333333,11,11,GTTGGCTAACAAGCGCGAGA,0,1567818
galEp3,0.08333333333333333,11,11,GTTCATTCTTGGTGTGACAA,0,1580777
galEp3,0.08333333333333333,11,11,GTTAAAAAGGTTTGGGTCGC,0,1582741
galEp3,0.08333333333333333,11,11,GTGTTTTCGTCCCCGGTCTT,0,1561820
galEp3,0.08333333333333333,11,11,GTGTGTTAATGATACCTTTA,0,1551635
galEp3,0.08333333333333333,11,11,GTGTGCGATTTTGGATCGTC,0,1553773
galEp3,0.08333333333333333,11,11,GTGTCAAAGATGTTGGGCTG,0,1564746
galEp3,0.08333333333333333,11,11,GTGGGTGATCTACACGAGAT,0,1560604
galEp3,0.08333333333333333,11,11,GTGGGGCATCCGGACAACAC,0,1568445
galEp3,0.08333333333333333,11,11,GTGGGATACCGGCATATAAT,0,1555435
galEp3,0.08333333333333333,11,11,GTGGATCCATTGGCGGCTCC,0,1547411
galEp3,0.08333333333333333,11,11,GTCTCCGTCACGAGAGAGTC,0,1581514
galEp3,0.08333333333333333,11,11,GTCCATTTTGGCCGATCGGT,0,1563872
galEp3,0.08333333333333333,11,11,GTATGCCTGTCAAATAGGCA,0,1586619
galEp3,0.08333333333333333,11,11,GTAGTCCTAACTCGATTCAA,0,1567957
galEp3,0.08333333333333333,11,11,GTAGAACATGATTTCCAATT,0,1590758
galEp3,0.08333333333333333,11,11,GTACGACAGCATGCGCTGTG,0,1568334
galEp3,0.08333333333333333,11,11,GGTTACACTAATTCAGTTTA,0,1556586
galEp3,0.08333333333333333,11,11,GGTTAACTCAGCTAATTGTG,0,1581045
galEp3,0.08333333333333333,11,11,GGTTAAATAATATGAAGGAG,0,1558771
galEp3,0.08333333333333333,11,11,GGGTCTTATGGGACGCGGTT,0,1584035
galEp3,0.08333333333333333,11,11,GGGTCAGTATATTAACTGTT,0,1555793
galEp3,0.08333333333333333,11,11,GGGGTGGCGAAGTTCGCCGG,0,1558928
galEp3,0.08333333333333333,11,11,GGGGTATAGATGGATGAGGC,0,1592980
galEp3,0.08333333333333333,11,11,GGGGGCTAGTTCTTGGGGTG,0,1550848
galEp3,0.08333333333333333,11,11,GGGGCGAGTCCGTCAGCAAA,0,1555788
galEp3,0.08333333333333333,11,11,GGGCAGCATCTCCGGCGACT,0,1549337
galEp3,0.08333333333333333,11,11,GGGCACCCTTACGTACCAGG,0,1572041
galEp3,0.08333333333333333,11,11,GGGACCCGATTTCGTACTAT,0,1587518
galEp3,0.08333333333333333,11,11,GGGAAGACCTGTTTTCCGTC,0,1586730
galEp3,0.08333333333333333,11,11,GGCTGGGTTTGCTACGCGCA,0,1574559
galEp3,0.08333333333333333,11,11,GGCTCGGAGATACAGGGCAG,0,1550471
galEp3,0.08333333333333333,11,11,GGCGCACATACGCTATACGT,0,1551344
galEp3,0.08333333333333333,11,11,GGCGAATAGTCTTCACAGGT,0,1585721
galEp3,0.08333333333333333,11,11,GGCATAGGCTCTCATGACTA,0,1585779
galEp3,0.08333333333333333,11,11,GGATTTTCGTATAGAAGATG,0,1581007
galEp3,0.08333333333333333,11,11,GGATTAGGTAAGGGTACATA,0,1592319
galEp3,0.08333333333333333,11,11,GGAGTTAACTGTGAATGGGG,0,1561816
galEp3,0.08333333333333333,11,11,GGACCTTCAGTTTAGCGATA,0,1576042
galEp3,0.08333333333333333,11,11,GGACATCTTTCGGTATGTCC,0,1564056
galEp3,0.08333333333333333,11,11,GGACAAAGTTTCAATATAGA,0,1583220
galEp3,0.08333333333333333,11,11,GGAACAAGAGATTCGTTGAG,0,1547299
galEp3,0.08333333333333333,11,11,GGAAATTCCAGGCCTTGTGT,0,1563002
galEp3,0.08333333333333333,11,11,GGAAAGGAGAACCTGGAGCC,0,1551062
galEp3,0.08333333333333333,11,11,GCTTTGGCAGTACCTAGATT,0,1561168
galEp3,0.08333333333333333,11,11,GCTGAAACCTCGGTGAGGGG,0,1553940
galEp3,0.08333333333333333,11,11,GCTCACCCGGGGAGCGGTAC,0,1568946
galEp3,0.08333333333333333,11,11,GCGTGAGAATTTTGCACTTC,0,1558090
galEp3,0.08333333333333333,11,11,GCGTCGGTTGGACCGGGGCT,0,1547506
galEp3,0.08333333333333333,11,11,GCGTCCGTAAAGTGCCATCA,0,1553529
galEp3,0.08333333333333333,11,11,GCGTCAGCTGCTGTATATAA,0,1576754
galEp3,0.08333333333333333,11,11,GCGTACAAGGTCGACCTCTA,0,1563898
galEp3,0.08333333333333333,11,11,GCGGTGGTCTCCATAGTAAG,0,1588564
galEp3,0.08333333333333333,11,11,GCGGGAGCTTGCGTGCCCAA,0,1547387
galEp3,0.08333333333333333,11,11,GCGCTCCACCGCAGCTATAC,0,1555427
galEp3,0.08333333333333333,11,11,GCGCCCAAGAGTCGTTTGAT,0,1558031
galEp3,0.08333333333333333,11,11,GCGCAAGAGGTTTAAGCGCG,0,1567537
galEp3,0.08333333333333333,11,11,GCGATAGTTGAAACGCTTAA,0,1549618
galEp3,0.08333333333333333,11,11,GCGAATGACCCGCACCATGA,0,1552392
galEp3,0.08333333333333333,11,11,GCCTTTCCCATGATGGCTTT,0,1581223
galEp3,0.08333333333333333,11,11,GCCTCAGACGCCGAGGTTCT,0,1562264
galEp3,0.08333333333333333,11,11,GCCCGCGATACACTAGCCTT,0,1570013
galEp3,0.08333333333333333,11,11,GCCATCGTGGGATGATGGAG,0,1565940
galEp3,0.08333333333333333,11,11,GCCAGGTCTACTCGGTCTTT,0,1582137
galEp3,0.08333333333333333,11,11,GCATGTTAAGCAACAGGCTC,0,1572203
galEp3,0.08333333333333333,11,11,GCATGCCGGCTGTAGTCAGG,0,1577357
galEp3,0.08333333333333333,11,11,GCATCTGGAAAGGTAATTTT,0,1574232
galEp3,0.08333333333333333,11,11,GCATAGGTACGTACAGAGGA,0,1549977
galEp3,0.08333333333333333,11,11,GCAGCCAGATCACGCCGTGA,0,1582936
galEp3,0.08333333333333333,11,11,GCACCCTCGTCTTTCATAAC,0,1594983
galEp3,0.08333333333333333,11,11,GCAATACTCTCAATGGTGAA,0,1557774
galEp3,0.08333333333333333,11,11,GCAACCCACACGGGCACATG,0,1585984
galEp3,0.08333333333333333,11,11,GCAAATGCGATCCGAAAATT,0,1557780
galEp3,0.08333333333333333,11,11,GATTGGCACCACTACCCGGT,0,1564862
galEp3,0.08333333333333333,11,11,GATTGAAAACTCAACCATGT,0,1588728
galEp3,0.08333333333333333,11,11,GATGGGTTAAACCCGTTATT,0,1585507
galEp3,0.08333333333333333,11,11,GATGAAAGTTGATTAAAGTA,0,1549297
galEp3,0.08333333333333333,11,11,GATCCAATCCGCGAGATATT,0,1585954
galEp3,0.08333333333333333,11,11,GATAAAGCGTATAAACCCGT,0,1550290
galEp3,0.08333333333333333,11,11,GAGTTCGTCGTTAATTGGCT,0,1553567
galEp3,0.08333333333333333,11,11,GAGTGTGTGGCCGACATCCA,0,1590308
galEp3,0.08333333333333333,11,11,GAGGTTGAGTTAAGGGGTAA,0,1562796
galEp3,0.08333333333333333,11,11,GAGGTAAGTCACTCATTTCT,0,1578869
galEp3,0.08333333333333333,11,11,GAGGCGGTTCCACGGAATTC,0,1558791
galEp3,0.08333333333333333,11,11,GAGGCGGGGCAGATGACATG,0,1566043
galEp3,0.08333333333333333,11,11,GAGCAGTGGTTATGGTGAGT,0,1593670
galEp3,0.08333333333333333,11,11,GAGCACAGCCTGACAAGTTG,0,1570893
galEp3,0.08333333333333333,11,11,GAGAGGCCTCTTAAGTGTCC,0,1593381
galEp3,0.08333333333333333,11,11,GAGACGTGGCTACCCGGGAA,0,1583111
galEp3,0.08333333333333333,11,11,GAGAATAAAAGGATTAGACC,0,1589534
galEp3,0.08333333333333333,11,11,GACTGTGAACTTGGGTACTA,0,1549363
galEp3,0.08333333333333333,11,11,GACTCAGCCGGTATTAGAAA,0,1554280
galEp3,0.08333333333333333,11,11,GACTACTCACCATGACTGTA,0,1585808
galEp3,0.08333333333333333,11,11,GACGTTTATTTACATCGCTT,0,1575278
galEp3,0.08333333333333333,11,11,GACGGGTTTCTGTGCTTAGG,0,1546689
galEp3,0.08333333333333333,11,11,GACGCAACGCATCGAATTTT,0,1577986
galEp3,0.08333333333333333,11,11,GACCATCGGGTCTGGGCAAG,0,1546942
galEp3,0.08333333333333333,11,11,GACATATCAGGGACGTCCAC,0,1589708
galEp3,0.08333333333333333,11,11,GACACAGAGTTATCCAGGGT,0,1558411
galEp3,0.08333333333333333,11,11,GAATTACTAAGCGAATTCTA,0,1570493
galEp3,0.08333333333333333,11,11,GAAGGCCACTAGATTTATGC,0,1574771
galEp3,0.08333333333333333,11,11,GAACGATCGGCGACCTTCTT,0,1566742
galEp3,0.08333333333333333,11,11,CTTTGCAAACGTTTAGGTTT,0,1563511
galEp3,0.08333333333333333,11,11,CTTGGTCCTCTAGATTCCTC,0,1562442
galEp3,0.08333333333333333,11,11,CTTGGGACGTAATAGTTATA,0,1564902
galEp3,0.08333333333333333,11,11,CTTGACGTGTAAAGACGGTA,0,1591713
galEp3,0.08333333333333333,11,11,CTTAGTCAACAATTAGGCAG,0,1587374
galEp3,0.08333333333333333,11,11,CTTACTCAACGGTGCCCGCA,0,1552930
galEp3,0.08333333333333333,11,11,CTGTTGTACTACGAGACGGT,0,1594335
galEp3,0.08333333333333333,11,11,CTGTGTATCGTAGCATTTAG,0,1548016
galEp3,0.08333333333333333,11,11,CTGTGGTCATATGGAAATTA,0,1556719
galEp3,0.08333333333333333,11,11,CTGTGGGGCCAGGTACTTTT,0,1594903
galEp3,0.08333333333333333,11,11,CTGTCGGTGCTGGGAGGCGA,0,1577834
galEp3,0.08333333333333333,11,11,CTGGTGATCAACGCAAGCAT,0,1577038
galEp3,0.08333333333333333,11,11,CTGGGAAAGATCTCAGACTG,0,1559663
galEp3,0.08333333333333333,11,11,CTGGATGTGCGAAAAGACAT,0,1569843
galEp3,0.08333333333333333,11,11,CTGGAGGGGGGAGTGTGGCA,0,1593617
galEp3,0.08333333333333333,11,11,CTGCCCCACTGCTAAACTGT,0,1551449
galEp3,0.08333333333333333,11,11,CTGAGCTAAATGCGCGGACT,0,1557291
galEp3,0.08333333333333333,11,11,CTCTCGATAAGGTCAGTACT,0,1564844
galEp3,0.08333333333333333,11,11,CTCGGCTTTTAGGATCAAAG,0,1550899
galEp3,0.08333333333333333,11,11,CTCGAGGGTTAGTGTGTGTT,0,1586426
galEp3,0.08333333333333333,11,11,CTCCAATACCTCTAGCGTAC,0,1570467
galEp3,0.08333333333333333,11,11,CTCAGGTGTTACTTGATCTA,0,1570274
galEp3,0.08333333333333333,11,11,CTATCCGACCGTTACGACGG,0,1580486
galEp3,0.08333333333333333,11,11,CTAGTCCCTTGTACCGGCCT,0,1576305
galEp3,0.08333333333333333,11,11,CTAGGGGGTTATAAAAGTTA,0,1559266
galEp3,0.08333333333333333,11,11,CTAGCAGCCAACCTTACTTC,0,1566240
galEp3,0.08333333333333333,11,11,CTAGACGCTACATGCTAAAT,0,1585189
galEp3,0.08333333333333333,11,11,CTACTATCTGTCTGGTGCGT,0,1591562
galEp3,0.08333333333333333,11,11,CTACATAAGATACTATTCTT,0,1557889
galEp3,0.08333333333333333,11,11,CTAATTCAGTTGGAATCCTA,0,1560107
galEp3,0.08333333333333333,11,11,CGTGGGTGCCATATGGGGTT,0,1560769
galEp3,0.08333333333333333,11,11,CGTGCCTCATTTACCGACCA,0,1582041
galEp3,0.08333333333333333,11,11,CGTGCAGGGTATTGTGGCTT,0,1589835
galEp3,0.08333333333333333,11,11,CGTGATAGCGGAAGCCTGCT,0,1571728
galEp3,0.08333333333333333,11,11,CGTGAACGTAACGGCAAGAT,0,1575753
galEp3,0.08333333333333333,11,11,CGTCGGTAAGACTCACTGCA,0,1551707
galEp3,0.08333333333333333,11,11,CGTCCTTACAACCTCGGACG,0,1569770
galEp3,0.08333333333333333,11,11,CGTAGACGAAAAACGCTTCG,0,1578494
galEp3,0.08333333333333333,11,11,CGGTGATGGCGTCTTCATTG,0,1591412
galEp3,0.08333333333333333,11,11,CGGGGATGACGTCCACTTAG,0,1546640
galEp3,0.08333333333333333,11,11,CGGAGTTTCACAGAGGCCTA,0,1581615
galEp3,0.08333333333333333,11,11,CGCTGTCCTTTGCAATGTTA,0,1578258
galEp3,0.08333333333333333,11,11,CGCTGCCTACGCGCCCCGCA,0,1570188
galEp3,0.08333333333333333,11,11,CGCTCCGGATCGCATTAAAC,0,1570125
galEp3,0.08333333333333333,11,11,CGCGTAGGTGTCAGAAGAAA,0,1587210
galEp3,0.08333333333333333,11,11,CGCGCGTTAAGCTAAAAGGA,0,1588389
galEp3,0.08333333333333333,11,11,CGCCGCCCGAAAGGGCAAAT,0,1567913
galEp3,0.08333333333333333,11,11,CGCACCAGAAGTCTACGATT,0,1570145
galEp3,0.08333333333333333,11,11,CGCACCACTTCAGATTGTTA,0,1568645
galEp3,0.08333333333333333,11,11,CGATACCGGAGGTTTATGAC,0,1560569
galEp3,0.08333333333333333,11,11,CGAGTGCCGTTCGCATATGA,0,1592332
galEp3,0.08333333333333333,11,11,CGAGGATCCATTCTGTACTC,0,1559580
galEp3,0.08333333333333333,11,11,CGAGCACTTAGTTGTAAGTG,0,1589693
galEp3,0.08333333333333333,11,11,CGACGTGGAACCCAGAAAAT,0,1551064
galEp3,0.08333333333333333,11,11,CGACGGGTTTTTTGATGCAT,0,1548857
galEp3,0.08333333333333333,11,11,CGACGCCCGTCGGTTCCAGG,0,1593296
galEp3,0.08333333333333333,11,11,CGACGATATGGTTGCCCTGG,0,1589557
galEp3,0.08333333333333333,11,11,CGAACGATGGGTTTTTTCGA,0,1577044
galEp3,0.08333333333333333,11,11,CCTTGAGCCAGTTCGTACCA,0,1560240
galEp3,0.08333333333333333,11,11,CCTGTAGCTTTTGGACGGCT,0,1566553
galEp3,0.08333333333333333,11,11,CCTGAATTTTACTCGACATA,0,1556949
galEp3,0.08333333333333333,11,11,CCTCTGCGGTATCTATAAAA,0,1553317
galEp3,0.08333333333333333,11,11,CCTCGGAGGCATCGGTGATC,0,1560868
galEp3,0.08333333333333333,11,11,CCTCAGGATATTCCATTGGT,0,1569608
galEp3,0.08333333333333333,11,11,CCTCACAGAACATCTTAAGG,0,1553380
galEp3,0.08333333333333333,11,11,CCTATTAGGCAATGGTGGAC,0,1594122
galEp3,0.08333333333333333,11,11,CCTAGCGGTTAGAGCAAGTG,0,1572097
galEp3,0.08333333333333333,11,11,CCTAGCCAATATCCCGACTG,0,1562479
galEp3,0.08333333333333333,11,11,CCGTCCGTGGCCCAGCCTTG,0,1591906
galEp3,0.08333333333333333,11,11,CCGTACCAATTCGGCACCAG,0,1593055
galEp3,0.08333333333333333,11,11,CCGGACCCTTTTGGATCGCG,0,1574873
galEp3,0.08333333333333333,11,11,CCGCCCGAATAGTCCGGCAA,0,1581646
galEp3,0.08333333333333333,11,11,CCGCCCACAGGTAACGTTGA,0,1546962
galEp3,0.08333333333333333,11,11,CCGAGAGGGGCGTCGGTTTT,0,1591772
galEp3,0.08333333333333333,11,11,CCCTCATGTAGGGACCGTGA,0,1566675
galEp3,0.08333333333333333,11,11,CCCGTTAGCATGGGAGGGAT,0,1569570
galEp3,0.08333333333333333,11,11,CCCGAGACTGTGAGCACTCC,0,1566169
galEp3,0.08333333333333333,11,11,CCCCGGCCATCACTTAATAT,0,1593703
galEp3,0.08333333333333333,11,11,CCCATTCGTTGCCGCGTGGG,0,1584471
galEp3,0.08333333333333333,11,11,CCATTCTGGGCGGTGCATAA,0,1565712
galEp3,0.08333333333333333,11,11,CCATAAGAGCGACAAAAGTT,0,1553845
galEp3,0.08333333333333333,11,11,CCACATCGAAACTTACAGGG,0,1562623
galEp3,0.08333333333333333,11,11,CCACACCACCTATTGGGGAC,0,1589073
galEp3,0.08333333333333333,11,11,CCAATCCGGTGTAAGGGGTA,0,1554985
galEp3,0.08333333333333333,11,11,CCAAACCATGGACAGGTCAA,0,1586164
galEp3,0.08333333333333333,11,11,CATTTCTTGGTTGGCCTTGG,0,1557772
galEp3,0.08333333333333333,11,11,CATTGAAAAGGCAGCACTCA,0,1569929
galEp3,0.08333333333333333,11,11,CATTACTAAGGTTTGCACGA,0,1557836
galEp3,0.08333333333333333,11,11,CATGTATTTTTAAGGTCGCC,0,1566262
galEp3,0.08333333333333333,11,11,CATGTACCCTGTGAAGTAAC,0,1570501
galEp3,0.08333333333333333,11,11,CATGCGTTATCCTAAAAAAA,0,1568358
galEp3,0.08333333333333333,11,11,CATGAAGTCTCCGAAGTCCC,0,1562871
galEp3,0.08333333333333333,11,11,CATCCGATCATACTGAGTTA,0,1588366
galEp3,0.08333333333333333,11,11,CAGTTGGTGGACATCCGGTA,0,1570718
galEp3,0.08333333333333333,11,11,CAGTGGCCGTCTCTGGCATC,0,1585231
galEp3,0.08333333333333333,11,11,CAGTACCTTTTGAGCGGGTT,0,1563831
galEp3,0.08333333333333333,11,11,CAGGTTACTGGCTCAACTTT,0,1576771
galEp3,0.08333333333333333,11,11,CAGGTGCGGCACGGGGTGAC,0,1548040
galEp3,0.08333333333333333,11,11,CAGGCGATGCAATCGAGACT,0,1593977
galEp3,0.08333333333333333,11,11,CAGGCAGTTTCCTGCCAAAG,0,1592231
galEp3,0.08333333333333333,11,11,CACGGCCAACCGGCCTATAA,0,1568446
galEp3,0.08333333333333333,11,11,CACCTTCGGATGCTCTGAAA,0,1576624
galEp3,0.08333333333333333,11,11,CACCGGTCTATGAGCAGGAA,0,1573137
galEp3,0.08333333333333333,11,11,CACAGATTCGGGCGGCCTGG,0,1567672
galEp3,0.08333333333333333,11,11,CAATCCATCGTATCGCCTCA,0,1572364
galEp3,0.08333333333333333,11,11,CAATAACTTAGGCGTTCCAT,0,1588093
galEp3,0.08333333333333333,11,11,CAAGCAGGTGTCGTCCATAT,0,1562093
galEp3,0.08333333333333333,11,11,CAACTTGCCTTACCACCAGA,0,1583614
galEp3,0.08333333333333333,11,11,CAACTAGACATGGATTAATT,0,1559252
galEp3,0.08333333333333333,11,11,CAACGGGGGTGAATCTGAGT,0,1567962
galEp3,0.08333333333333333,11,11,CAACGGGATTGTCCTCCACC,0,1590334
galEp3,0.08333333333333333,11,11,CAACATGTATATCTCCTTTC,0,1551441
galEp3,0.08333333333333333,11,11,CAACAAATCCACACACCTTC,0,1549518
galEp3,0.08333333333333333,11,11,CAAATGCGTACAAAAGGCAT,0,1558523
galEp3,0.08333333333333333,11,11,ATTTGTACGAAAATAGTGTA,0,1547490
galEp3,0.08333333333333333,11,11,ATTGGTACGATAATATAAAA,0,1581192
galEp3,0.08333333333333333,11,11,ATTGACCCTTCCTTAGCCTT,0,1590207
galEp3,0.08333333333333333,11,11,ATTGAAGTACTCTCAGACCC,0,1555713
galEp3,0.08333333333333333,11,11,ATTCAATGAGACTGTTATTC,0,1548720
galEp3,0.08333333333333333,11,11,ATTATTAGAAAACCGATTCC,0,1577450
galEp3,0.08333333333333333,11,11,ATGTGGATTCGTCACAAAGC,0,1576673
galEp3,0.08333333333333333,11,11,ATGTCGAGCAGCAGAGTGTC,0,1554230
galEp3,0.08333333333333333,11,11,ATGTCGAGAGTGACGCTGGC,0,1580102
galEp3,0.08333333333333333,11,11,ATGCGAAGCGGGTCAACAAC,0,1591422
galEp3,0.08333333333333333,11,11,ATGATCGGTCCCCGTCTTGT,0,1563707
galEp3,0.08333333333333333,11,11,ATCTTACCCCATACTGGGGC,0,1582994
galEp3,0.08333333333333333,11,11,ATCATTCGCAAAAATAGTTA,0,1573011
galEp3,0.08333333333333333,11,11,ATCACGGGTTGACGCCCAGT,0,1558911
galEp3,0.08333333333333333,11,11,ATCAAGGTCGCCAAGGAAGT,0,1569052
galEp3,0.08333333333333333,11,11,ATATGCGGGTATCCTCCAAT,0,1571116
galEp3,0.08333333333333333,11,11,ATATCGTGTTGAAAGTACCT,0,1572856
galEp3,0.08333333333333333,11,11,ATAGTTAGACTTGGCGGCCT,0,1548790
galEp3,0.08333333333333333,11,11,ATACTTCAGTCCGATGGTAA,0,1574168
galEp3,0.08333333333333333,11,11,ATACTCCCCAGGCACGCTTG,0,1592994
galEp3,0.08333333333333333,11,11,ATACGAATCCGAAGCCCCGG,0,1550286
galEp3,0.08333333333333333,11,11,ATACACAGCGTCTGGCAAAT,0,1562873
galEp3,0.08333333333333333,11,11,AGTTTCCACTCTATACCAAA,0,1553716
galEp3,0.08333333333333333,11,11,AGTTGTATGCAGTCTGCCGT,0,1566338
galEp3,0.08333333333333333,11,11,AGTGCGCCCGTTGAAGTTAT,0,1549404
galEp3,0.08333333333333333,11,11,AGTCGATCCCCATGCAACGT,0,1583230
galEp3,0.08333333333333333,11,11,AGTATACCCGGATGGATCTA,0,1546703
galEp3,0.08333333333333333,11,11,AGTAGCGATGGCCCGTGCGT,0,1566208
galEp3,0.08333333333333333,11,11,AGTAGATCTGTAACTTGGAT,0,1573440
galEp3,0.08333333333333333,11,11,AGTAAAGTGTTTGTGTCTTT,0,1565703
galEp3,0.08333333333333333,11,11,AGGTGGGATAGGACCTAGGC,0,1552720
galEp3,0.08333333333333333,11,11,AGGTGAACCAATGGCCGTGT,0,1576909
galEp3,0.08333333333333333,11,11,AGGTACAGGACTTAGGGAGC,0,1569055
galEp3,0.08333333333333333,11,11,AGGGCGGATTGTGGGTCGTG,0,1567907
galEp3,0.08333333333333333,11,11,AGGGACCCGACCTGCATGGT,0,1572318
galEp3,0.08333333333333333,11,11,AGGCTAGCATTGGATGTGGG,0,1576561
galEp3,0.08333333333333333,11,11,AGGCGCGCATACGGTTCAGG,0,1563747
galEp3,0.08333333333333333,11,11,AGCTGGCTGTACTACGCCCA,0,1548615
galEp3,0.08333333333333333,11,11,AGCTGCGACTGAAGCAGTGA,0,1559802
galEp3,0.08333333333333333,11,11,AGCTATTCGGAGGCGGCCAA,0,1593514
galEp3,0.08333333333333333,11,11,AGCGAGGCAGCACTGATGCG,0,1590126
galEp3,0.08333333333333333,11,11,AGCCGCTTCAGTATGTATCG,0,1566056
galEp3,0.08333333333333333,11,11,AGATTCAACTGCACGCTTTA,0,1555096
galEp3,0.08333333333333333,11,11,AGATCTTCCGGTGGTTTCTT,0,1565370
galEp3,0.08333333333333333,11,11,AGATCGATGTGGGAAATCTT,0,1568509
galEp3,0.08333333333333333,11,11,AGATCCTAAAACAACTATTA,0,1583731
galEp3,0.08333333333333333,11,11,AGAGGTAACGTGAAGACTTC,0,1552717
galEp3,0.08333333333333333,11,11,AGAGATGCAACATTCTTGAT,0,1587400
galEp3,0.08333333333333333,11,11,AGACGTTGTTAAGCCCTCGA,0,1573033
galEp3,0.08333333333333333,11,11,ACTCTGACCACGCCAATGAT,0,1563811
galEp3,0.08333333333333333,11,11,ACTCTCCTCCGGTAAGCTAC,0,1546980
galEp3,0.08333333333333333,11,11,ACTCCTCTGAGCTCGGCAGA,0,1550617
galEp3,0.08333333333333333,11,11,ACTCACCCAGGCCAGGTCGC,0,1573327
galEp3,0.08333333333333333,11,11,ACTATTTTTGCTTGAGCGCA,0,1553717
galEp3,0.08333333333333333,11,11,ACTACTCTTTCACCAGTTGC,0,1594935
galEp3,0.08333333333333333,11,11,ACGTGCAGAAGTGCCTCGGG,0,1588993
galEp3,0.08333333333333333,11,11,ACGGGATGCCGTGTATCTTT,0,1547828
galEp3,0.08333333333333333,11,11,ACGCAGTGCGCAATTTACCG,0,1575904
galEp3,0.08333333333333333,11,11,ACCTATTGAAGATAACAGCA,0,1592321
galEp3,0.08333333333333333,11,11,ACCGCTGTTCCAGCCCGTGT,0,1589559
galEp3,0.08333333333333333,11,11,ACCCCCGGTGCAAAAGGCCA,0,1563856
galEp3,0.08333333333333333,11,11,ACATCGCAGGTGAATACCGG,0,1556334
galEp3,0.08333333333333333,11,11,ACATACGCCCGCGAACAACA,0,1574752
galEp3,0.08333333333333333,11,11,ACATACATATGCTGGCAGCG,0,1556393
galEp3,0.08333333333333333,11,11,ACAGTGTCCGGCAATACAAA,0,1580536
galEp3,0.08333333333333333,11,11,ACACTACGCAGATTGAAGGC,0,1552307
galEp3,0.08333333333333333,11,11,ACACCTACTCAGGATTATAC,0,1555235
galEp3,0.08333333333333333,11,11,ACACCCAGAATGTCTGGAGG,0,1552790
galEp3,0.08333333333333333,11,11,ACACCAGCTCAGGAACGTAA,0,1549675
galEp3,0.08333333333333333,11,11,ACAAGTCTAAGGAACCTGGA,0,1580167
galEp3,0.08333333333333333,11,11,ACAAGGCCATTCGATCTGAT,0,1568697
galEp3,0.08333333333333333,11,11,ACAACTGTTGAATCGTCAAT,0,1590763
galEp3,0.08333333333333333,11,11,AATGCCATACACACAGCCTT,0,1588990
galEp3,0.08333333333333333,11,11,AATGATTTCCAATACCACTA,0,1573619
galEp3,0.08333333333333333,11,11,AATGAATTGTGGGATCAGAA,0,1558731
galEp3,0.08333333333333333,11,11,AATCCAGCGAGGGTATAGCT,0,1590751
galEp3,0.08333333333333333,11,11,AATACTGGCTAAGTTTTGAG,0,1572772
galEp3,0.08333333333333333,11,11,AATACCTTAATCGGCTCTCG,0,1580206
galEp3,0.08333333333333333,11,11,AAGTCGGATTGTAACATCTC,0,1586335
galEp3,0.08333333333333333,11,11,AAGAAGCTTTAGGTCCAGCA,0,1587452
galEp3,0.08333333333333333,11,11,AACTGATGGGGCCTACTGAC,0,1584060
galEp3,0.08333333333333333,11,11,AACTACGTGCGTAGGTTGTC,0,1578908
galEp3,0.08333333333333333,11,11,AACTAAGGGCGGCCTTCGTA,0,1557030
galEp3,0.08333333333333333,11,11,AACGGTTACCCATAAGTAGA,0,1569685
galEp3,0.08333333333333333,11,11,AACATGTTGTATGAGACGAA,0,1577214
galEp3,0.08333333333333333,11,11,AACACCTGGTGCTGCGGATC,0,1588701
galEp3,0.08333333333333333,11,11,AAATTGATGGTATGCGAGGA,0,1551137
galEp3,0.08333333333333333,11,11,AAAGAGAAGCATAACTAACA,0,1550435
galEp3,0.08333333333333333,11,11,AAAATTGCATCCACATGGTG,0,1577256
galEp3,0.08333333333333333,11,11,AAAAGAACGATGGCATACTT,0,1587495
galEp3,0.09090909090909091,10,10,TTTTGGAAGCTACCACGACA,0,1586301
galEp3,0.09090909090909091,10,10,TTTTGCCGGACAAGCTCTTC,0,1562838
galEp3,0.09090909090909091,10,10,TTTTCGAACGGGCTCTGTGG,0,1587296
galEp3,0.09090909090909091,10,10,TTTTAAAGTGGGAACGGAAA,0,1550402
galEp3,0.09090909090909091,10,10,TTTGTAAAGGGCCAGTCTAT,0,1552887
galEp3,0.09090909090909091,10,10,TTTGCTTACGGATGCTAATC,0,1574385
galEp3,0.09090909090909091,10,10,TTTCGCAGAAGGGGCTAACC,0,1551103
galEp3,0.09090909090909091,10,10,TTTCAGACGGGTCGCACATG,0,1580528
galEp3,0.09090909090909091,10,10,TTGTTGATATAATGCGGAGG,0,1570936
galEp3,0.09090909090909091,10,10,TTGTACATTAGTGGCCATCA,0,1571719
galEp3,0.09090909090909091,10,10,TTGGACGTCGCTGCCGGCGC,0,1592297
galEp3,0.09090909090909091,10,10,TTGATGGCAAGCTGCTATAT,0,1587548
galEp3,0.09090909090909091,10,10,TTGACGCGGGTGCCCTCGCA,0,1578585
galEp3,0.09090909090909091,10,10,TTGAACATCAACGAGGACCA,0,1582629
galEp3,0.09090909090909091,10,10,TTCTTTACTGCAACCCTTCT,0,1551995
galEp3,0.09090909090909091,10,10,TTCGCAGCTCGGTCCGTGAG,0,1573659
galEp3,0.09090909090909091,10,10,TTCCGGTACTGATTGTTGAA,0,1565551
galEp3,0.09090909090909091,10,10,TTCCAACTGGGTGTTTTGTA,0,1558953
galEp3,0.09090909090909091,10,10,TTCAAAGACGAGTTTCGTCA,0,1548423
galEp3,0.09090909090909091,10,10,TTATGAATTCGAAGTAGTGT,0,1577560
galEp3,0.09090909090909091,10,10,TTATCTGGAGATCTTTCCTA,0,1569251
galEp3,0.09090909090909091,10,10,TTAGGAGAGACCCGGTTAAC,0,1590882
galEp3,0.09090909090909091,10,10,TTAGCAGCATTGTGGTGGAA,0,1563771
galEp3,0.09090909090909091,10,10,TTACTTGGATGTGGCATGAA,0,1564512
galEp3,0.09090909090909091,10,10,TTAATCTCGAGGGGGTGGAG,0,1576627
galEp3,0.09090909090909091,10,10,TTAATAATGTAGAAAAACAC,0,1549005
galEp3,0.09090909090909091,10,10,TTAACCAATTTGAGGAAAGA,0,1586459
galEp3,0.09090909090909091,10,10,TTAAATGGTTTCTCTATCGA,0,1553880
galEp3,0.09090909090909091,10,10,TGTTGTCAAAGTTTGAGAGT,0,1566709
galEp3,0.09090909090909091,10,10,TGTGATGCCAACCCGGTGAG,0,1581711
galEp3,0.09090909090909091,10,10,TGTGAATCTAATAAATTTTT,0,1571189
galEp3,0.09090909090909091,10,10,TGTATCCGCAAACTGCATGA,0,1580558
galEp3,0.09090909090909091,10,10,TGGTGCCCTCCTGCGCCTAA,0,1585105
galEp3,0.09090909090909091,10,10,TGGTGAGGGCAGATGTCCGA,0,1573156
galEp3,0.09090909090909091,10,10,TGGTATGGCCCTAAAGGGGT,0,1594980
galEp3,0.09090909090909091,10,10,TGGCGGGTAGCGCACTCATG,0,1566682
galEp3,0.09090909090909091,10,10,TGGCGCCAGGGGACAGTGCG,0,1556886
galEp3,0.09090909090909091,10,10,TGGCCCCTCCAACAGTGCCT,0,1560796
galEp3,0.09090909090909091,10,10,TGCTTGGCCCTACATCTGAC,0,1576292
galEp3,0.09090909090909091,10,10,TGCTGAGCCCAGGCAAACTT,0,1588938
galEp3,0.09090909090909091,10,10,TGCTATTAGATGATGCAGAT,0,1560923
galEp3,0.09090909090909091,10,10,TGCTAGTCCCCCTACACGAG,0,1569474
galEp3,0.09090909090909091,10,10,TGCTAGCAAGTGGGTATGCA,0,1572710
galEp3,0.09090909090909091,10,10,TGCCGTGGTATGAGGCAACT,0,1573850
galEp3,0.09090909090909091,10,10,TGCCCGGCTGCACGCATGCT,0,1586532
galEp3,0.09090909090909091,10,10,TGCCCCGAATTCCCCTTAGA,0,1578904
galEp3,0.09090909090909091,10,10,TGCATATGGCCGGCCTTTAT,0,1555132
galEp3,0.09090909090909091,10,10,TGATTTGTGGTATGCTCCGT,0,1588457
galEp3,0.09090909090909091,10,10,TGATACAAAAAATACCCTGC,0,1573411
galEp3,0.09090909090909091,10,10,TGAGGAGTTACTAGTGTACA,0,1579994
galEp3,0.09090909090909091,10,10,TGAGCTGACCAGCATCTACG,0,1583250
galEp3,0.09090909090909091,10,10,TGAGCAGGACCGCGCCTGGG,0,1548015
galEp3,0.09090909090909091,10,10,TGAGACTATCAAGAAGTCAC,0,1547041
galEp3,0.09090909090909091,10,10,TGAGACCAGCTGGTCCCAAC,0,1593386
galEp3,0.09090909090909091,10,10,TGACTCTGTGACCTGCACCT,0,1568739
galEp3,0.09090909090909091,10,10,TGAACGCCCCGAAGATAATC,0,1559608
galEp3,0.09090909090909091,10,10,TCTTCTACTGGCGGTATGAC,0,1582085
galEp3,0.09090909090909091,10,10,TCTGAGACAACGGACAGGAT,0,1580608
galEp3,0.09090909090909091,10,10,TCTCAATGCACGGGGGGACT,0,1576692
galEp3,0.09090909090909091,10,10,TCTATCGTGGAAGTACACAG,0,1554711
galEp3,0.09090909090909091,10,10,TCTAGCTTGTAAGAATCGTC,0,1587800
galEp3,0.09090909090909091,10,10,TCTAAATTAGGCGCTACGGG,0,1591000
galEp3,0.09090909090909091,10,10,TCGTTTTGTTGAGGCGTAAG,0,1555225
galEp3,0.09090909090909091,10,10,TCGTCTTAGAGGCTTGTACA,0,1574939
galEp3,0.09090909090909091,10,10,TCGTATATGAGGCGCGCCCA,0,1590316
galEp3,0.09090909090909091,10,10,TCGGCTCCCTTTTTTACCAT,0,1546824
galEp3,0.09090909090909091,10,10,TCGCTTTTGCCCGCGGTAAC,0,1583053
galEp3,0.09090909090909091,10,10,TCGCGCCTGGTACGGAGTAC,0,1576382
galEp3,0.09090909090909091,10,10,TCGAAGAGAACGACCAATAC,0,1587153
galEp3,0.09090909090909091,10,10,TCCTCAGGCCAACATCACCT,0,1555909
galEp3,0.09090909090909091,10,10,TCCGGGAGTAAAAGAGTAAG,0,1558207
galEp3,0.09090909090909091,10,10,TCCGATACTTAATCATCGTC,0,1573418
galEp3,0.09090909090909091,10,10,TCCCTGCCACGCTGGATTAT,0,1553740
galEp3,0.09090909090909091,10,10,TCCCCCAGGACCCAATGGAT,0,1588038
galEp3,0.09090909090909091,10,10,TCCATTTATGCAGAAGGCGA,0,1568060
galEp3,0.09090909090909091,10,10,TCCATTGCAGGTTTAAAGAC,0,1556035
galEp3,0.09090909090909091,10,10,TCCAAAGCCTCCAGGCCTAC,0,1585751
galEp3,0.09090909090909091,10,10,TCATTTTCTTCGAATTGGAC,0,1590419
galEp3,0.09090909090909091,10,10,TCATCAAGTTATCAAAAAGT,0,1582153
galEp3,0.09090909090909091,10,10,TCACGTTGGTTGTTAAAGTT,0,1562700
galEp3,0.09090909090909091,10,10,TCACCTGGAATGTTTGCGAG,0,1575190
galEp3,0.09090909090909091,10,10,TCAATCGTCTCTCTAGCAAA,0,1588631
galEp3,0.09090909090909091,10,10,TCAAGCATGGTTAAACCTAG,0,1577257
galEp3,0.09090909090909091,10,10,TATTTCCGTGACGGGTGGAC,0,1550045
galEp3,0.09090909090909091,10,10,TATGGCCGGTAATCTTAATG,0,1584234
galEp3,0.09090909090909091,10,10,TATCCTATCACTTGGGTTCA,0,1589981
galEp3,0.09090909090909091,10,10,TATCATTTATATTGTTGATA,0,1573141
galEp3,0.09090909090909091,10,10,TATCAGGGGTCGCTAATGCA,0,1553824
galEp3,0.09090909090909091,10,10,TATATGTGTGAGGCTGTGAT,0,1584395
galEp3,0.09090909090909091,10,10,TATAGACAAGCGTTCGGGAT,0,1555587
galEp3,0.09090909090909091,10,10,TATACTCAGATAGGAGGCCT,0,1559849
galEp3,0.09090909090909091,10,10,TAGTCGATAAGCAAGTCTCT,0,1575732
galEp3,0.09090909090909091,10,10,TAGGTGACCCTTAGCTCGCA,0,1575184
galEp3,0.09090909090909091,10,10,TAGGTACGACAATAACATTA,0,1556298
galEp3,0.09090909090909091,10,10,TAGGGGACTATTTTTAAGCC,0,1552757
galEp3,0.09090909090909091,10,10,TAGAGGTGCCTGTTTAGTAT,0,1585100
galEp3,0.09090909090909091,10,10,TACTTTTAGACGATGATTTA,0,1555424
galEp3,0.09090909090909091,10,10,TACTTATCTCACCTAACCCT,0,1594685
galEp3,0.09090909090909091,10,10,TACTGGGACGACGCCACAGG,0,1574002
galEp3,0.09090909090909091,10,10,TACTGGCCCAGCCCGTCCGC,0,1564061
galEp3,0.09090909090909091,10,10,TACTAGGTTGGGCACAGAAG,0,1556209
galEp3,0.09090909090909091,10,10,TACGTCTCCCAAATCAGGTT,0,1546595
galEp3,0.09090909090909091,10,10,TACGATCGTGTTTTACGTTG,0,1569308
galEp3,0.09090909090909091,10,10,TACCATGTCTGCGGTAAACA,0,1573302
galEp3,0.09090909090909091,10,10,TAAGTGAAGGCATGTCTCCG,0,1548346
galEp3,0.09090909090909091,10,10,TAAGGTCTCGACAGTAGTGG,0,1564025
galEp3,0.09090909090909091,10,10,TAACGCGTCGGATGAGCGCA,0,1591674
galEp3,0.09090909090909091,10,10,TAACCTTCGTTCAAATGGCG,0,1586885
galEp3,0.09090909090909091,10,10,GTTTTCGGTATTCTCTAGAA,0,1558197
galEp3,0.09090909090909091,10,10,GTTTGTACTTAGGTCTGGGT,0,1566896
galEp3,0.09090909090909091,10,10,GTTTGAGGATCAAAATTGGG,0,1563860
galEp3,0.09090909090909091,10,10,GTTGAAATCGCCCTGGTCCT,0,1564941
galEp3,0.09090909090909091,10,10,GTTCGCTTATGGGTTGTGCG,0,1582199
galEp3,0.09090909090909091,10,10,GTTATTAACAATTCGTTGCA,0,1558877
galEp3,0.09090909090909091,10,10,GTGTTGGGCCTGGGCACCAT,0,1551067
galEp3,0.09090909090909091,10,10,GTGTGCTCCGCTGTCTATAT,0,1572745
galEp3,0.09090909090909091,10,10,GTGTAGCCTTGTAGAGTCTT,0,1564308
galEp3,0.09090909090909091,10,10,GTGGTTTACGGCAGGACTCA,0,1572923
galEp3,0.09090909090909091,10,10,GTGACCCTTGCAAACGATTT,0,1589924
galEp3,0.09090909090909091,10,10,GTCTCTTGGCTGAAACATTC,0,1562223
galEp3,0.09090909090909091,10,10,GTCGGAACGGTTGCCTCAGC,0,1552518
galEp3,0.09090909090909091,10,10,GTCGCTATGAGACGCCATCG,0,1566686
galEp3,0.09090909090909091,10,10,GTCGATAGTGCACGCAAGGG,0,1559915
galEp3,0.09090909090909091,10,10,GTCCTCGGCTTCAAGTAGCT,0,1554665
galEp3,0.09090909090909091,10,10,GTCAGACCGATAGGGGACCT,0,1549261
galEp3,0.09090909090909091,10,10,GTCAATAGACCAAAACCCTT,0,1574998
galEp3,0.09090909090909091,10,10,GTATAATGGGCGCAATAATC,0,1569500
galEp3,0.09090909090909091,10,10,GTAGGCCAGGTAGCGGGAGG,0,1569345
galEp3,0.09090909090909091,10,10,GTACTAGCGCTTTCACCCTT,0,1574783
galEp3,0.09090909090909091,10,10,GTACGTTGTAAAATTGGTTT,0,1554664
galEp3,0.09090909090909091,10,10,GGTGCATAGTTAAAGTATAC,0,1580794
galEp3,0.09090909090909091,10,10,GGTGAGAGCCGCAGAGATTA,0,1590903
galEp3,0.09090909090909091,10,10,GGTCTTATGCAAAAGCAGTT,0,1593373
galEp3,0.09090909090909091,10,10,GGTCCAAAAAGCGGATGACT,0,1551638
galEp3,0.09090909090909091,10,10,GGTCATTATCTTCAAACCGA,0,1563907
galEp3,0.09090909090909091,10,10,GGTATGATTCAAGAGGGATA,0,1581784
galEp3,0.09090909090909091,10,10,GGTATGATATCTGTTTGTGT,0,1553591
galEp3,0.09090909090909091,10,10,GGTATACCAACAAAGTCTGT,0,1584975
galEp3,0.09090909090909091,10,10,GGTACGGACATAGCTGTGTA,0,1555943
galEp3,0.09090909090909091,10,10,GGGTTAGATATTAGAATATC,0,1574471
galEp3,0.09090909090909091,10,10,GGGGTCACCGCTTATGTCCG,0,1555354
galEp3,0.09090909090909091,10,10,GGGGCTCAAATGAGACTACA,0,1589879
galEp3,0.09090909090909091,10,10,GGGGCCTCTAGGAGCTTCAC,0,1553853
galEp3,0.09090909090909091,10,10,GGGGCCAAGGGCAAGACAAG,0,1568741
galEp3,0.09090909090909091,10,10,GGGCGTGGTGGATAAAACAC,0,1555073
galEp3,0.09090909090909091,10,10,GGCTTGGGTTGCTGCCTTCA,0,1561198
galEp3,0.09090909090909091,10,10,GGCTTAGTTTATTCTGGCTG,0,1563383
galEp3,0.09090909090909091,10,10,GGCTGTTGCAGCTGCTAGAA,0,1571560
galEp3,0.09090909090909091,10,10,GGCGTCCCTTCCGCAGCACC,0,1567579
galEp3,0.09090909090909091,10,10,GGCGGGCAGCCGCGGGCCGG,0,1553772
galEp3,0.09090909090909091,10,10,GGCGCCGTCCGGACAGCTAC,0,1574447
galEp3,0.09090909090909091,10,10,GGCGCCAGGTTGGTGCCTTG,0,1573928
galEp3,0.09090909090909091,10,10,GGCCGTACGTGCGCCCTGAG,0,1569602
galEp3,0.09090909090909091,10,10,GGCCCCAAGAATATCGTGAG,0,1563295
galEp3,0.09090909090909091,10,10,GGCCCATAAGGCTTTGTCCG,0,1594749
galEp3,0.09090909090909091,10,10,GGCCCAGAGTTTTTGATCTC,0,1547626
galEp3,0.09090909090909091,10,10,GGCAATTTCCGTCAAAGGTT,0,1571385
galEp3,0.09090909090909091,10,10,GGATTCGGGAACCACAAATA,0,1556575
galEp3,0.09090909090909091,10,10,GGATTACTTTATTAGCCTGT,0,1588666
galEp3,0.09090909090909091,10,10,GGATGTACCGTAGCTTACAC,0,1576803
galEp3,0.09090909090909091,10,10,GGATCTCGTACGGATCGTGT,0,1551636
galEp3,0.09090909090909091,10,10,GGATCGAACTGCACCGGTCC,0,1549865
galEp3,0.09090909090909091,10,10,GGAGTTAAAGCATGGGGCTT,0,1551360
galEp3,0.09090909090909091,10,10,GGAGTGCTTACACTATCTAT,0,1564509
galEp3,0.09090909090909091,10,10,GGAGTCCTTTTGAATAATTA,0,1559444
galEp3,0.09090909090909091,10,10,GGAATGATAGTCCGAGGTCA,0,1558512
galEp3,0.09090909090909091,10,10,GGAACGGACAGACCTGCCCT,0,1567244
galEp3,0.09090909090909091,10,10,GGAAATGACATCCCGGTGGG,0,1566034
galEp3,0.09090909090909091,10,10,GCTTTATAGACGGACGGATG,0,1553884
galEp3,0.09090909090909091,10,10,GCTGGATCACAGCACAGTGA,0,1555959
galEp3,0.09090909090909091,10,10,GCTGCAAAGGTCACCACTTG,0,1585985
galEp3,0.09090909090909091,10,10,GCTCTAGTGCATGGGGTTAA,0,1560512
galEp3,0.09090909090909091,10,10,GCTCAGGAGGAAGGTTGGTT,0,1586955
galEp3,0.09090909090909091,10,10,GCTATCAAGATGACGTAGAG,0,1565546
galEp3,0.09090909090909091,10,10,GCGTGTGTCGGTAAGATACT,0,1582442
galEp3,0.09090909090909091,10,10,GCGTCCCAGGCCCACCTTTA,0,1569940
galEp3,0.09090909090909091,10,10,GCGGTTCATATTAACAAAGG,0,1553413
galEp3,0.09090909090909091,10,10,GCGCTTTGTGAGGTGAAGAG,0,1590969
galEp3,0.09090909090909091,10,10,GCCTTCTGAGGTATGTGTAA,0,1573281
galEp3,0.09090909090909091,10,10,GCCTTAGCCCAGGTGAACGT,0,1574022
galEp3,0.09090909090909091,10,10,GCCTTAAACTGCTCCGATAA,0,1558069
galEp3,0.09090909090909091,10,10,GCCTCGGCCCACGCCACAGG,0,1571501
galEp3,0.09090909090909091,10,10,GCCTCAAGTAGAATACGCTT,0,1550404
galEp3,0.09090909090909091,10,10,GCCTCAAATAGTGAAAGATT,0,1563172
galEp3,0.09090909090909091,10,10,GCCGATCCAAGATCCTATGT,0,1547885
galEp3,0.09090909090909091,10,10,GCCGAGGCCGGACGGCTCGA,0,1579725
galEp3,0.09090909090909091,10,10,GCCGAAAACTTCAACTGGTG,0,1548407
galEp3,0.09090909090909091,10,10,GCCCCTACCCATATCAAGGG,0,1591368
galEp3,0.09090909090909091,10,10,GCATTGTCGAGCTGGAAAGT,0,1558714
galEp3,0.09090909090909091,10,10,GCATTCAACATACGCAAGAT,0,1556380
galEp3,0.09090909090909091,10,10,GCATCCCCAAGAGTCGCAGA,0,1588792
galEp3,0.09090909090909091,10,10,GCATCAAGTGATGTTATGTT,0,1587945
galEp3,0.09090909090909091,10,10,GCATAAGTCCGTGCCACGCT,0,1554419
galEp3,0.09090909090909091,10,10,GCAGGATTACGAGCCAAAGC,0,1580645
galEp3,0.09090909090909091,10,10,GCACATCAAGCCCCCATACA,0,1577877
galEp3,0.09090909090909091,10,10,GCACACTGGTCGAGTGCACA,0,1548802
galEp3,0.09090909090909091,10,10,GATGAGTCAGGAGCACGGAA,0,1564333
galEp3,0.09090909090909091,10,10,GATGAGAGGACGTTCAAATA,0,1555198
galEp3,0.09090909090909091,10,10,GATCTGAAACGTATGGTCAT,0,1575938
galEp3,0.09090909090909091,10,10,GATCCAGCTTTGGACCGGTG,0,1568609
galEp3,0.09090909090909091,10,10,GATCAGGTACGGGAAAAGAG,0,1576738
galEp3,0.09090909090909091,10,10,GATATGCGAGCCATAGGCTG,0,1563362
galEp3,0.09090909090909091,10,10,GATACATAGCCAGCGCTTCG,0,1582070
galEp3,0.09090909090909091,10,10,GAGGTCAAGCTGCTTTTGGA,0,1584976
galEp3,0.09090909090909091,10,10,GAGGCTATATCAAATTTCTA,0,1571186
galEp3,0.09090909090909091,10,10,GAGGACGCCCTACTACACGA,0,1594892
galEp3,0.09090909090909091,10,10,GAGCGAGGGGGACTCAGGCA,0,1581544
galEp3,0.09090909090909091,10,10,GAGATCGTGCTATCGGAGTC,0,1588240
galEp3,0.09090909090909091,10,10,GAGACCCCTCTCGTTTTATA,0,1579139
galEp3,0.09090909090909091,10,10,GACTATTTGGGTCATCGCGA,0,1560270
galEp3,0.09090909090909091,10,10,GACTAATACTGTGTTCAACC,0,1572932
galEp3,0.09090909090909091,10,10,GACGAGCGCCACGTCATTAT,0,1566890
galEp3,0.09090909090909091,10,10,GACCGATAGCTGTTGGTAAA,0,1561864
galEp3,0.09090909090909091,10,10,GACAAATTTAGCGACGTGAC,0,1588405
galEp3,0.09090909090909091,10,10,GAAGGTCGTTGAGTGGGCGG,0,1580274
galEp3,0.09090909090909091,10,10,GAAGCGTACTGATAAGCTAC,0,1571594
galEp3,0.09090909090909091,10,10,GAAGACTAGCTACGCAGCGC,0,1562092
galEp3,0.09090909090909091,10,10,GAAGACGAAACTCCCGGGGA,0,1585608
galEp3,0.09090909090909091,10,10,GAACTCTTGGGAACTACTAC,0,1554043
galEp3,0.09090909090909091,10,10,GAACGCAAGAATCGTTATAT,0,1555079
galEp3,0.09090909090909091,10,10,GAACACTTTTAGGATGGTGT,0,1548213
galEp3,0.09090909090909091,10,10,GAAATGCAACGATGGTCATG,0,1567654
galEp3,0.09090909090909091,10,10,CTTTTCGGACCTTACGGCTC,0,1548624
galEp3,0.09090909090909091,10,10,CTTTTCCACCGATGGTGTCC,0,1586290
galEp3,0.09090909090909091,10,10,CTTTCGTTCATTTCCGATCA,0,1576337
galEp3,0.09090909090909091,10,10,CTTGTAGTACGAACTGGCCA,0,1549558
galEp3,0.09090909090909091,10,10,CTTGGGACACTGAGATGTTA,0,1548135
galEp3,0.09090909090909091,10,10,CTTGAGAGGCTCTATAAGTT,0,1550170
galEp3,0.09090909090909091,10,10,CTTATTAATTCGGCCACGTG,0,1564228
galEp3,0.09090909090909091,10,10,CTGTCTCAGCGATTGTCGTC,0,1578686
galEp3,0.09090909090909091,10,10,CTGTCCATCTTCGCAATCTC,0,1556206
galEp3,0.09090909090909091,10,10,CTGCTTAACACTGAATCTTA,0,1560183
galEp3,0.09090909090909091,10,10,CTGAGGCCTTGCTTAGACAA,0,1584298
galEp3,0.09090909090909091,10,10,CTGAATGCTGGGACTCTCCT,0,1566306
galEp3,0.09090909090909091,10,10,CTCTGCTGCCTACCTCTTCA,0,1548055
galEp3,0.09090909090909091,10,10,CTCTGAGGGGAACCCACAAT,0,1546596
galEp3,0.09090909090909091,10,10,CTCTACAAGGAGCGACGTAA,0,1557894
galEp3,0.09090909090909091,10,10,CTCCGTTATCAATCTGGTAA,0,1579229
galEp3,0.09090909090909091,10,10,CTCCGGTGCGTTCACCTGGA,0,1555430
galEp3,0.09090909090909091,10,10,CTCCAAAAGTTAACGGTCTT,0,1578681
galEp3,0.09090909090909091,10,10,CTCAGGGAGTTGTGCTGCAG,0,1571264
galEp3,0.09090909090909091,10,10,CTCAATGTCTTGCGAGGTAA,0,1560773
galEp3,0.09090909090909091,10,10,CTCAACTATCCTATACCCGT,0,1590565
galEp3,0.09090909090909091,10,10,CTATGCGAGCGTAGACCCTC,0,1565503
galEp3,0.09090909090909091,10,10,CTAGTCGTGTAGGTAAGCGT,0,1572311
galEp3,0.09090909090909091,10,10,CTAGGCTTAGTAGTAAATGC,0,1586085
galEp3,0.09090909090909091,10,10,CTACTTGGTAATATCGGTGT,0,1587833
galEp3,0.09090909090909091,10,10,CTACTCAGTCATGGCACTGC,0,1560928
galEp3,0.09090909090909091,10,10,CTACGCCTGAATTAAAAAGT,0,1547055
galEp3,0.09090909090909091,10,10,CTAATGGAATAAAGACAATC,0,1558242
galEp3,0.09090909090909091,10,10,CTAACATAGCCACTGATTGT,0,1569726
galEp3,0.09090909090909091,10,10,CTAAACGGTAATTGTGAGAT,0,1564608
galEp3,0.09090909090909091,10,10,CGTTCCTGAAGTTCTGTCCC,0,1564328
galEp3,0.09090909090909091,10,10,CGTGCGAGGAAGCATTACGT,0,1591716
galEp3,0.09090909090909091,10,10,CGTCGGTCCGGCATATCTGG,0,1553075
galEp3,0.09090909090909091,10,10,CGTCCTATATGCCTGCACGG,0,1554191
galEp3,0.09090909090909091,10,10,CGTCAGGGGTCATTGCGCCC,0,1587257
galEp3,0.09090909090909091,10,10,CGTACACTCATGTCAAATGT,0,1546723
galEp3,0.09090909090909091,10,10,CGGTTGGACCGAGCCCCGCG,0,1564435
galEp3,0.09090909090909091,10,10,CGGTCTCTTTCGACAACAGA,0,1585780
galEp3,0.09090909090909091,10,10,CGGTCTCCGCGGCAGCTCAA,0,1585804
galEp3,0.09090909090909091,10,10,CGGTCGGACCGTGCACATGG,0,1587838
galEp3,0.09090909090909091,10,10,CGGGTACAACGTAGGTGAAG,0,1580263
galEp3,0.09090909090909091,10,10,CGGGCTAGACCGACGTTCTG,0,1583009
galEp3,0.09090909090909091,10,10,CGGCTGCGGAAGGAGTCGCT,0,1593022
galEp3,0.09090909090909091,10,10,CGGCGTTGTCGGGTGGCAAC,0,1550984
galEp3,0.09090909090909091,10,10,CGGCCTTAATAGGACTCAGG,0,1569661
galEp3,0.09090909090909091,10,10,CGGATTTTGGGGGGAGCTCA,0,1578019
galEp3,0.09090909090909091,10,10,CGGACACACTGCGTAATTCG,0,1565158
galEp3,0.09090909090909091,10,10,CGGAAGGGTCCGGCTTCTCG,0,1578141
galEp3,0.09090909090909091,10,10,CGCTGACTTATAGCTTCAGT,0,1570105
galEp3,0.09090909090909091,10,10,CGCTGAACATCAAACCGTGA,0,1594139
galEp3,0.09090909090909091,10,10,CGCTAGTCAATGTTAATATG,0,1562779
galEp3,0.09090909090909091,10,10,CGCTAGCGGCGCATATTTAA,0,1552679
galEp3,0.09090909090909091,10,10,CGCGTATCCACATATTCCAT,0,1566619
galEp3,0.09090909090909091,10,10,CGCATCTATATAGTACTAAG,0,1560109
galEp3,0.09090909090909091,10,10,CGCAGAAGAAATGTGCTGAG,0,1548118
galEp3,0.09090909090909091,10,10,CGCACCTTTCGACGATCTCA,0,1593172
galEp3,0.09090909090909091,10,10,CGAGTCTAGCTTCGCGTCTC,0,1555559
galEp3,0.09090909090909091,10,10,CGACAGCCGTACGGCAGTCG,0,1564327
galEp3,0.09090909090909091,10,10,CGAATCCACGGTGCAGGTGT,0,1550028
galEp3,0.09090909090909091,10,10,CGAACTACTCCGAGAGGTAT,0,1573643
galEp3,0.09090909090909091,10,10,CGAAATACAAGGGCTATGTG,0,1571041
galEp3,0.09090909090909091,10,10,CGAAAAACCGAAGATACGGT,0,1548265
galEp3,0.09090909090909091,10,10,CCTTTCGAATTAGATAAGGA,0,1558303
galEp3,0.09090909090909091,10,10,CCTGGCGAACACATAGGCAA,0,1585284
galEp3,0.09090909090909091,10,10,CCTAGCCTGAAATATGGGTT,0,1562647
galEp3,0.09090909090909091,10,10,CCTAGCCGCAGCTGCTGCCA,0,1566309
galEp3,0.09090909090909091,10,10,CCGTTGAGACGTTGAGATCT,0,1555178
galEp3,0.09090909090909091,10,10,CCGTCTGGCATACGTTAACA,0,1558520
galEp3,0.09090909090909091,10,10,CCGTCCGTGCTGACTGGTCC,0,1561103
galEp3,0.09090909090909091,10,10,CCGGGGACTTCAAAGTGTGC,0,1565805
galEp3,0.09090909090909091,10,10,CCGGGAGTACTAAGGCCCGT,0,1551793
galEp3,0.09090909090909091,10,10,CCGGCGCCTGTAGCGAGGCT,0,1553712
galEp3,0.09090909090909091,10,10,CCGGATGGTGACCGTAGGTA,0,1592681
galEp3,0.09090909090909091,10,10,CCGCTTCCCCGACGGTGCCC,0,1553449
galEp3,0.09090909090909091,10,10,CCGCCCCTGACGGGTTTGAT,0,1560097
galEp3,0.09090909090909091,10,10,CCGAGCGCTCGCCCTGAGAC,0,1553314
galEp3,0.09090909090909091,10,10,CCGACAGACTTCCAGGAGTA,0,1561252
galEp3,0.09090909090909091,10,10,CCGAAGACGTGGAGTAGAGA,0,1585722
galEp3,0.09090909090909091,10,10,CCCTTTTTATGTATACCGAG,0,1569062
galEp3,0.09090909090909091,10,10,CCCTACACAGCAATGGCCTC,0,1568560
galEp3,0.09090909090909091,10,10,CCCGTGCATAAAGATTGTTA,0,1557227
galEp3,0.09090909090909091,10,10,CCCCGCGACCCTCAGACGCT,0,1553143
galEp3,0.09090909090909091,10,10,CCATTCCAGGGTGCCCAATA,0,1588178
galEp3,0.09090909090909091,10,10,CCATTACTAAATAAAGCCCA,0,1580252
galEp3,0.09090909090909091,10,10,CCAGGGTGGAATCCGCGATG,0,1590459
galEp3,0.09090909090909091,10,10,CCACAAAAAGGGTCCTGGTT,0,1573788
galEp3,0.09090909090909091,10,10,CATTAAAGTAGATGCGGGAT,0,1581019
galEp3,0.09090909090909091,10,10,CATGGTCCGAGGTCTTGGGA,0,1558034
galEp3,0.09090909090909091,10,10,CATGGAATGAACTATTTTAC,0,1548226
galEp3,0.09090909090909091,10,10,CATGCTAAATGACTGACACC,0,1567354
galEp3,0.09090909090909091,10,10,CAGTCCCATAGTGGGTCCGG,0,1566992
galEp3,0.09090909090909091,10,10,CAGGTTTGTTGGGGTGACGT,0,1547605
galEp3,0.09090909090909091,10,10,CAGCCCTCCACCAGAATTGT,0,1595020
galEp3,0.09090909090909091,10,10,CAGCAGCAGTTGAGCGCATT,0,1594427
galEp3,0.09090909090909091,10,10,CAGCAGCACACCGTTAGGAC,0,1587664
galEp3,0.09090909090909091,10,10,CAGAGATGATAGTTACCCGT,0,1575017
galEp3,0.09090909090909091,10,10,CAGACGCGTATTTAACGTTT,0,1590065
galEp3,0.09090909090909091,10,10,CAGACACTTCGCAATTGGCA,0,1586975
galEp3,0.09090909090909091,10,10,CAGAAGGTCGGGTTCTGTCA,0,1553681
galEp3,0.09090909090909091,10,10,CACTGAATCATTCCCACGCA,0,1575335
galEp3,0.09090909090909091,10,10,CACGGCATCAGGCTAGAACA,0,1548601
galEp3,0.09090909090909091,10,10,CACGGAAAAACACACCAATT,0,1595169
galEp3,0.09090909090909091,10,10,CACCTTTGCGCGACTTACAC,0,1577277
galEp3,0.09090909090909091,10,10,CACCAGTAAAAGAATCAATA,0,1563699
galEp3,0.09090909090909091,10,10,CACATTACAAGACGATCTAC,0,1590404
galEp3,0.09090909090909091,10,10,CAATTTCTGTTGGTACGGGG,0,1594097
galEp3,0.09090909090909091,10,10,CAAGGGATACCTTTTATCTT,0,1559089
galEp3,0.09090909090909091,10,10,CAAGCATGCTTGGGGAAGGC,0,1570820
galEp3,0.09090909090909091,10,10,CAAGAGATTGACACTTAATA,0,1559256
galEp3,0.09090909090909091,10,10,ATTTGCCAAAAATTGCGTAA,0,1563255
galEp3,0.09090909090909091,10,10,ATTTCCCTTGGCCAACGTCC,0,1558562
galEp3,0.09090909090909091,10,10,ATTGTTGTCCGGGCGACCAA,0,1547792
galEp3,0.09090909090909091,10,10,ATTGCTGTGAACCGGCCATT,0,1547841
galEp3,0.09090909090909091,10,10,ATTCCAGGTTGGCTTCTATT,0,1567025
galEp3,0.09090909090909091,10,10,ATTAGCACTCGGTTTAGCTA,0,1572120
galEp3,0.09090909090909091,10,10,ATGTTTCAGGGTCACACATA,0,1575641
galEp3,0.09090909090909091,10,10,ATGTTGGCCCCCGGTTCTTA,0,1584832
galEp3,0.09090909090909091,10,10,ATGTGGATTCTACGGCCCGT,0,1575104
galEp3,0.09090909090909091,10,10,ATGTCGCTTCCCGTTCAGGA,0,1563706
galEp3,0.09090909090909091,10,10,ATGGGCACTTGTCATAATAG,0,1562833
galEp3,0.09090909090909091,10,10,ATGCTCTCCCGCTATAGGGA,0,1567980
galEp3,0.09090909090909091,10,10,ATGAGGACGCTAATCGTGTA,0,1587611
galEp3,0.09090909090909091,10,10,ATGACTATTTCTTTAGTGTA,0,1547853
galEp3,0.09090909090909091,10,10,ATGACTACAAAGTATCATAA,0,1578230
galEp3,0.09090909090909091,10,10,ATGACGGTTAAGCATACTGA,0,1578736
galEp3,0.09090909090909091,10,10,ATGAAGAGGATACGCTAGCT,0,1553588
galEp3,0.09090909090909091,10,10,ATCTTGGCCGACCTGCCGCA,0,1547484
galEp3,0.09090909090909091,10,10,ATCTCTGTTCCGTCGGGAAG,0,1584496
galEp3,0.09090909090909091,10,10,ATCTCGGGAATGGCTGACCC,0,1555608
galEp3,0.09090909090909091,10,10,ATCGTCTGCAACGGGCGAAC,0,1560407
galEp3,0.09090909090909091,10,10,ATCGTATAAACGGGCTCGCC,0,1557479
galEp3,0.09090909090909091,10,10,ATCCGTTGTACTTTGCAACT,0,1559171
galEp3,0.09090909090909091,10,10,ATCCGATGGTTCCAAAGAAA,0,1560520
galEp3,0.09090909090909091,10,10,ATCCCATCTTTTGGGACAGA,0,1557477
galEp3,0.09090909090909091,10,10,ATCCATGAAGAGATTCTCTT,0,1547356
galEp3,0.09090909090909091,10,10,ATCACACACGCTTGAATGCG,0,1552990
galEp3,0.09090909090909091,10,10,ATATTCCAATACTTTCCCTT,0,1559176
galEp3,0.09090909090909091,10,10,ATATCTAACGATGCTTTCTG,0,1581981
galEp3,0.09090909090909091,10,10,ATAGCGGATATAATGCTCGA,0,1589278
galEp3,0.09090909090909091,10,10,ATAGAGCGCAGAGTGAGGTT,0,1588756
galEp3,0.09090909090909091,10,10,ATACCGAACTGGCGCCCACC,0,1564339
galEp3,0.09090909090909091,10,10,ATAATTGTGAAGAGAAGGTA,0,1549724
galEp3,0.09090909090909091,10,10,ATAACTACGATTGGAAAGGC,0,1570267
galEp3,0.09090909090909091,10,10,AGTTGGTTCCTTTTACGGGG,0,1579886
galEp3,0.09090909090909091,10,10,AGTGGATTAGGATGGACGGA,0,1559690
galEp3,0.09090909090909091,10,10,AGTCAGGCGTCTACTGCGCA,0,1552072
galEp3,0.09090909090909091,10,10,AGTATCTTGGTATTAGCAAA,0,1584222
galEp3,0.09090909090909091,10,10,AGTAGTTTTGTAAGAAACCA,0,1547336
galEp3,0.09090909090909091,10,10,AGTACCTCATTTACGTATCA,0,1549413
galEp3,0.09090909090909091,10,10,AGTAAAATATCTCAGGGCCG,0,1588643
galEp3,0.09090909090909091,10,10,AGGTGAGCACGCTATACCTA,0,1551587
galEp3,0.09090909090909091,10,10,AGGTGACAAAGGTCTGATAT,0,1550450
galEp3,0.09090909090909091,10,10,AGGTCTGCCACTATATAGGT,0,1572216
galEp3,0.09090909090909091,10,10,AGGGGCGGTATAGATTACTA,0,1560119
galEp3,0.09090909090909091,10,10,AGGCCTAATATCTGAGGGAA,0,1570853
galEp3,0.09090909090909091,10,10,AGGCACTTTAATGAGATTGC,0,1571634
galEp3,0.09090909090909091,10,10,AGGCACGTACGGAGTGTGGT,0,1568548
galEp3,0.09090909090909091,10,10,AGGATGCTTTACTTGCCACA,0,1570440
galEp3,0.09090909090909091,10,10,AGGAGTCCGTCTAGTCGAGA,0,1583211
galEp3,0.09090909090909091,10,10,AGGAGTACCAGTGGGAGATA,0,1580998
galEp3,0.09090909090909091,10,10,AGGAAAGAAAAATTGTACAA,0,1550454
galEp3,0.09090909090909091,10,10,AGCTTCACCCGGCTTCAAAT,0,1584967
galEp3,0.09090909090909091,10,10,AGCTTAGTCTCCACTGACAC,0,1572186
galEp3,0.09090909090909091,10,10,AGCTCAATGCGAACAAACGG,0,1556919
galEp3,0.09090909090909091,10,10,AGCGCGGATTTCGACCACGG,0,1583542
galEp3,0.09090909090909091,10,10,AGCCGCCGCGCTAAACGTCC,0,1559595
galEp3,0.09090909090909091,10,10,AGCCGAGGTTGAACACTATA,0,1556223
galEp3,0.09090909090909091,10,10,AGCCCTAAATCGGACTGATC,0,1548408
galEp3,0.09090909090909091,10,10,AGCACCATAGTGCCGGTAGA,0,1588372
galEp3,0.09090909090909091,10,10,AGATTCCCATTGGGAGACCT,0,1583297
galEp3,0.09090909090909091,10,10,AGATGCATGGGTCCCCGTAC,0,1574347
galEp3,0.09090909090909091,10,10,AGATAGCGGCTCTAGCGTAC,0,1594393
galEp3,0.09090909090909091,10,10,AGAGTCCTGGTCCTGGGCAT,0,1569446
galEp3,0.09090909090909091,10,10,AGAGGTCCATTGGCGCCAGT,0,1559758
galEp3,0.09090909090909091,10,10,AGAGCGCATGTCGTATGGGA,0,1549946
galEp3,0.09090909090909091,10,10,AGAGATCAGGGATGTAGGCT,0,1557533
galEp3,0.09090909090909091,10,10,AGACTAGCTCGCTTATTATG,0,1590981
galEp3,0.09090909090909091,10,10,AGACAATTGTCATAACTGTG,0,1571507
galEp3,0.09090909090909091,10,10,AGAAATAGTACATTTGAAAT,0,1580981
galEp3,0.09090909090909091,10,10,ACTTTACCTTGTGGACACAG,0,1590707
galEp3,0.09090909090909091,10,10,ACTCAGGAAGTTCTGGTACT,0,1555116
galEp3,0.09090909090909091,10,10,ACTAGGCCGAGCCTCAGGTC,0,1559804
galEp3,0.09090909090909091,10,10,ACTAGATAGGTGCCGGTGCA,0,1555128
galEp3,0.09090909090909091,10,10,ACTACACTAATCCGTTGGCC,0,1581819
galEp3,0.09090909090909091,10,10,ACGTTTCACATTCACGGAAC,0,1593113
galEp3,0.09090909090909091,10,10,ACGTCTCCAAACCATTCGTA,0,1576115
galEp3,0.09090909090909091,10,10,ACGTAGCTCAGACTAACCAC,0,1561222
galEp3,0.09090909090909091,10,10,ACGGTGTAGAACCGCAAGCA,0,1592384
galEp3,0.09090909090909091,10,10,ACGGCTTGGAAGGCATTCTC,0,1572027
galEp3,0.09090909090909091,10,10,ACGGCGGTAAAACCGTTCCT,0,1576746
galEp3,0.09090909090909091,10,10,ACGGAAAGAGTCTTGACCGT,0,1584522
galEp3,0.09090909090909091,10,10,ACGCGTCAGAGATAAAAGAG,0,1566061
galEp3,0.09090909090909091,10,10,ACGCGGATGACTCTCTTGGA,0,1569369
galEp3,0.09090909090909091,10,10,ACGATAAATCATCATGGCCA,0,1550314
galEp3,0.09090909090909091,10,10,ACCCCAGCCGGAAAGCGAAT,0,1554803
galEp3,0.09090909090909091,10,10,ACCATAATTCTATGCCTCGG,0,1569501
galEp3,0.09090909090909091,10,10,ACCACCTGTAACCGCTGACT,0,1567283
galEp3,0.09090909090909091,10,10,ACCACCCGCGAGCGACCCAT,0,1559667
galEp3,0.09090909090909091,10,10,ACACGCGACGCCCTCGACGA,0,1588065
galEp3,0.09090909090909091,10,10,ACACCGTGGTTCAGTTACTA,0,1586828
galEp3,0.09090909090909091,10,10,ACAAGGCCAAAGGCTGCCCC,0,1591672
galEp3,0.09090909090909091,10,10,ACAAGGACGAGAAGCTTAGA,0,1567054
galEp3,0.09090909090909091,10,10,ACAACCAATAATCTGTGGGG,0,1583791
galEp3,0.09090909090909091,10,10,AATCCTTCGCTGTACAGACC,0,1553557
galEp3,0.09090909090909091,10,10,AATAAATTTGAGCTCCAGCC,0,1563770
galEp3,0.09090909090909091,10,10,AAGTTGATCTGGTGAATCCG,0,1580361
galEp3,0.09090909090909091,10,10,AAGTGGTTTAGTGTTGCACA,0,1588432
galEp3,0.09090909090909091,10,10,AAGGGGTGGTGGTCAGAAAA,0,1594603
galEp3,0.09090909090909091,10,10,AAGGGACAGCGCTTTCTCGA,0,1581043
galEp3,0.09090909090909091,10,10,AAGGAGAATGAATCGGCACG,0,1571836
galEp3,0.09090909090909091,10,10,AAGCTTTTATCCATTTAAAG,0,1579858
galEp3,0.09090909090909091,10,10,AACTTGGGGACGTCGAACAT,0,1554281
galEp3,0.09090909090909091,10,10,AACGTCGATACCGTAGGACT,0,1577282
galEp3,0.09090909090909091,10,10,AACGATTTGGATACGTCATC,0,1548819
galEp3,0.09090909090909091,10,10,AACGATGTAGGACCGGCCGA,0,1585294
galEp3,0.09090909090909091,10,10,AACCTGATTTTAACTTTCGC,0,1563961
galEp3,0.09090909090909091,10,10,AACCTCTAGGAGAAGTTACA,0,1569317
galEp3,0.09090909090909091,10,10,AACCGAGCTTACATATCTGG,0,1569555
galEp3,0.09090909090909091,10,10,AACCCCTCAACTTGCCCGTT,0,1578143
galEp3,0.09090909090909091,10,10,AACCCCAATGCATGCGGAGA,0,1578048
galEp3,0.09090909090909091,10,10,AACATAGCCTCGTTAAGCCC,0,1548566
galEp3,0.09090909090909091,10,10,AACACGTGATCAATTGCGTC,0,1551136
galEp3,0.09090909090909091,10,10,AACAAGACCAGCGTTTTAGT,0,1575268
galEp3,0.09090909090909091,10,10,AAATGTTCTTTAAGTCGAGA,0,1565067
galEp3,0.09090909090909091,10,10,AAAGCTCGTTAAGAAATGTG,0,1568474
galEp3,0.09090909090909091,10,10,AAACCTACGTCACAAATCAT,0,1554236
galEp3,0.09090909090909091,10,10,AAAAGCAGGAGGGGTGTCGT,0,1567442
galEp3,0.09090909090909091,10,10,AAAACCGGAGTGGGCGGCAA,0,1569667
galEp3,0.09090909090909091,10,10,AAAACATCTTTTAGAGGTGT,0,1572038
galEp3,0.1,9,9,TTTGTCCCCGGTCGAGACAA,0,1559602
galEp3,0.1,9,9,TTTGTCACTTCTTCCAAACC,0,1557863
galEp3,0.1,9,9,TTTGGAACACCTGTGAATGT,0,1550977
galEp3,0.1,9,9,TTTCCTGGTAATAGCAACGT,0,1574617
galEp3,0.1,9,9,TTTCAGGGCGTGGCAGGAGC,0,1588999
galEp3,0.1,9,9,TTTATCACGTGTCCTAACCT,0,1553068
galEp3,0.1,9,9,TTTATAGACCCACACCTTCG,0,1557293
galEp3,0.1,9,9,TTTAGGGCTATGAACACCTA,0,1551114
galEp3,0.1,9,9,TTTACCGAGTCGTGGGGACC,0,1559157
galEp3,0.1,9,9,TTTAAAGCTGGTATCGGTTC,0,1550612
galEp3,0.1,9,9,TTGGGGGGTGCAGTGACCCA,0,1561179
galEp3,0.1,9,9,TTGCCTGAAGCTATATCGTG,0,1576473
galEp3,0.1,9,9,TTGCCAGTAGCAATCGGGAA,0,1592768
galEp3,0.1,9,9,TTGAGTTACTCAAGGACATT,0,1589589
galEp3,0.1,9,9,TTCTTGGAGTTATGCGGCGT,0,1571382
galEp3,0.1,9,9,TTCTGCCCATGTCCTTGTCG,0,1591786
galEp3,0.1,9,9,TTCTCCTCTGCGACGAGTAC,0,1575275
galEp3,0.1,9,9,TTCGCTATAATTGCATTCGG,0,1576288
galEp3,0.1,9,9,TTCGCGGACCACAGGCCACA,0,1547298
galEp3,0.1,9,9,TTCAGTTAGCTCTACAGGTA,0,1573626
galEp3,0.1,9,9,TTCAGCGCACGTGATACCTT,0,1590580
galEp3,0.1,9,9,TTATGAATTGGACGTTCGGG,0,1560717
galEp3,0.1,9,9,TTAGTGATACTAGCGCGAAT,0,1566492
galEp3,0.1,9,9,TTAGGGTTTCTTAAGCGTAG,0,1576189
galEp3,0.1,9,9,TTAGCGGAGTGTCCACACCT,0,1550732
galEp3,0.1,9,9,TTAGCGAAATGTGGATACAA,0,1593815
galEp3,0.1,9,9,TTACCTAATAGCCTAAATAT,0,1560719
galEp3,0.1,9,9,TTACAATTCACCCCTCTCAC,0,1570821
galEp3,0.1,9,9,TTAATGGATGTTTCTGGTCA,0,1550843
galEp3,0.1,9,9,TTAATACACTGTGAAAATCC,0,1555267
galEp3,0.1,9,9,TGTTAATATTACTTGACAGG,0,1567431
galEp3,0.1,9,9,TGTGATTCTAGCGATTTGGC,0,1564684
galEp3,0.1,9,9,TGTGATCGTGCATGAGCGGT,0,1556829
galEp3,0.1,9,9,TGTGACTTCAGAGATAAGGA,0,1557538
galEp3,0.1,9,9,TGTACCCTCTGTAGTTGGTT,0,1557488
galEp3,0.1,9,9,TGGTTCCGGGAAAGAAAAGT,0,1570731
galEp3,0.1,9,9,TGGTGCCGCTGGGGGTTAGA,0,1563567
galEp3,0.1,9,9,TGGTGACCACGTGTCACGCA,0,1558407
galEp3,0.1,9,9,TGGTACCGGATACTCCTTTT,0,1591176
galEp3,0.1,9,9,TGGGGCACCGCGTGACGAAA,0,1562793
galEp3,0.1,9,9,TGGGATGGCGCCGGGGGCTT,0,1576962
galEp3,0.1,9,9,TGGCAGACCGGGAGGCTCCT,0,1579987
galEp3,0.1,9,9,TGGCACACGCGATACATTGT,0,1550125
galEp3,0.1,9,9,TGGATAAGTATACACCCGCC,0,1549251
galEp3,0.1,9,9,TGCTTTTGAGGAAAGTCATC,0,1563071
galEp3,0.1,9,9,TGCTTTAGTGACAAATGGCA,0,1588214
galEp3,0.1,9,9,TGCTCAGGTGGCCGAATTTC,0,1570153
galEp3,0.1,9,9,TGCGTATATAGGCGTCCTAG,0,1589987
galEp3,0.1,9,9,TGCCTCACACTAGTCTCTCA,0,1582859
galEp3,0.1,9,9,TGCCCCGCCGCCGGCATCCA,0,1587562
galEp3,0.1,9,9,TGCCATTCGACGTTAACCAT,0,1573752
galEp3,0.1,9,9,TGATGCCCTCTAAAAGGTTT,0,1581144
galEp3,0.1,9,9,TGATCCCCCCTCACCTGTAC,0,1578200
galEp3,0.1,9,9,TGATCCAGTGGACGCGACAC,0,1553515
galEp3,0.1,9,9,TGAGGTGTCGCTGCAATATG,0,1577735
galEp3,0.1,9,9,TGAGGGTGGTTGGTATTATT,0,1586995
galEp3,0.1,9,9,TGACGACCCGGGGTGCGACT,0,1572168
galEp3,0.1,9,9,TGACAACAGACCCAGTTGCA,0,1564854
galEp3,0.1,9,9,TGAAGATTATCCACCATATG,0,1588384
galEp3,0.1,9,9,TCTTGCGTAGGCCTGGCTCA,0,1559450
galEp3,0.1,9,9,TCTTATACTTCGTGACGTCG,0,1574965
galEp3,0.1,9,9,TCTTAAGCACGCAAAGATCG,0,1564846
galEp3,0.1,9,9,TCTTAAAGTCTGCTGCTTTA,0,1590824
galEp3,0.1,9,9,TCTGGCTATCAGTCCAGACG,0,1556326
galEp3,0.1,9,9,TCTGGATTCACAAGTCGGGT,0,1562482
galEp3,0.1,9,9,TCTGCTTTATAGTCGGCTGG,0,1557179
galEp3,0.1,9,9,TCTGACTTTCTTCTGGTCGT,0,1571887
galEp3,0.1,9,9,TCTCTGGGTTTCAGGGACTA,0,1561264
galEp3,0.1,9,9,TCTAGTATGATTCACATGGA,0,1568982
galEp3,0.1,9,9,TCGGTCTCGCGTGTAGTCAC,0,1581739
galEp3,0.1,9,9,TCGCTTGAGCTTTCGGGCTG,0,1562018
galEp3,0.1,9,9,TCGAGTCACATGAGCATGAT,0,1584378
galEp3,0.1,9,9,TCCTTCCGTCTCGTTCCATC,0,1574045
galEp3,0.1,9,9,TCCTGTCTACACAGAGATGG,0,1569730
galEp3,0.1,9,9,TCCGTCTGGGCATTCGGGGT,0,1552843
galEp3,0.1,9,9,TCCGGTTCGAGTGCAGCTTG,0,1572673
galEp3,0.1,9,9,TCCGCTTATACGTGTCCTGA,0,1560502
galEp3,0.1,9,9,TCCCCGAACGCCACGTCCTC,0,1567083
galEp3,0.1,9,9,TCCATTGGTTACGGATCAAG,0,1561588
galEp3,0.1,9,9,TCCATAGACGAATCGGCGTC,0,1571005
galEp3,0.1,9,9,TCCAGTCTTGACACCCAGAG,0,1573697
galEp3,0.1,9,9,TCATTTAGTTGCCCAGTAGC,0,1594103
galEp3,0.1,9,9,TCATATCACTTGGACGAAGC,0,1589034
galEp3,0.1,9,9,TCAGGTTACGACCATCGCGT,0,1575968
galEp3,0.1,9,9,TCAGCAATGAATGATTATTG,0,1587667
galEp3,0.1,9,9,TCAGCAACGCGCCAGTTATG,0,1575891
galEp3,0.1,9,9,TCACTGATGGATAATGACTA,0,1563485
galEp3,0.1,9,9,TCACCAACACCAAGAGACTG,0,1571190
galEp3,0.1,9,9,TCACACGTTTGACATCTTAT,0,1586258
galEp3,0.1,9,9,TATTCTAAGAGCCTAAAGTT,0,1556184
galEp3,0.1,9,9,TATTCCAGGAGCTCACTAAC,0,1557812
galEp3,0.1,9,9,TATGTGCAGCCTCCGGAACT,0,1563018
galEp3,0.1,9,9,TATCTGCGGGCACAATTGTA,0,1585579
galEp3,0.1,9,9,TAGTCTGGCTCGTTACGCTA,0,1554971
galEp3,0.1,9,9,TAGTCTGGATATCGCCGCAT,0,1582214
galEp3,0.1,9,9,TAGGTGCATACGTTTACTCG,0,1559665
galEp3,0.1,9,9,TAGCTCCGGGGGGAGAACAA,0,1547764
galEp3,0.1,9,9,TAGCCCCGGGGCTCCCAATC,0,1565100
galEp3,0.1,9,9,TAGATAGTCCCCAGTGTTGA,0,1559687
galEp3,0.1,9,9,TAGATACACGTTCCAAACTC,0,1580332
galEp3,0.1,9,9,TAGAGCATAGGATTTATTCG,0,1550469
galEp3,0.1,9,9,TACGCACTCCCCACGCTGAT,0,1579926
galEp3,0.1,9,9,TACGAGAACCGTAATGGGAG,0,1587851
galEp3,0.1,9,9,TACCTTTAATAGGGGCACGA,0,1552119
galEp3,0.1,9,9,TACAGTATAGCCGCCAACTA,0,1566388
galEp3,0.1,9,9,TAATTGCCGTTGAGTATGTG,0,1548577
galEp3,0.1,9,9,TAAGGGTTTGGACCTCCGCA,0,1547516
galEp3,0.1,9,9,TAAGATCGTTAATTTACAGT,0,1556536
galEp3,0.1,9,9,TAACGACAGTGCGTTAGGAT,0,1575270
galEp3,0.1,9,9,TAAATGTAGAGAAAGGCGAG,0,1552509
galEp3,0.1,9,9,TAAATGAACCGTCAATTGGT,0,1593403
galEp3,0.1,9,9,TAAAGAATTGCACGCTACGT,0,1575095
galEp3,0.1,9,9,TAAAATCAGATGAGTGTAAC,0,1582777
galEp3,0.1,9,9,GTTTTATATACCAATTGGTG,0,1561457
galEp3,0.1,9,9,GTTTGTACCACGAATCATCC,0,1577803
galEp3,0.1,9,9,GTTTACCAATAGTTGGAGAA,0,1571542
galEp3,0.1,9,9,GTTGAGCAGGATCAATAGGA,0,1562872
galEp3,0.1,9,9,GTTCGGACCTCTTGCAGCGG,0,1566490
galEp3,0.1,9,9,GTTCCGTAGCGGCGCACTGA,0,1570816
galEp3,0.1,9,9,GTTATACAGATTTTTTTCAA,0,1587195
galEp3,0.1,9,9,GTTAGCGCGGAGTGAGTTCG,0,1582461
galEp3,0.1,9,9,GTTACTACTACAAGTAGATA,0,1585604
galEp3,0.1,9,9,GTGTACTCACACAATACCTA,0,1579972
galEp3,0.1,9,9,GTGGGGTCAGGCCTGTAGTC,0,1573747
galEp3,0.1,9,9,GTGCGCAAAGTGATCCATGC,0,1552208
galEp3,0.1,9,9,GTGCCACCCGGCCCCAGTTA,0,1588433
galEp3,0.1,9,9,GTGACGGGCGGCCCGTGTAT,0,1569232
galEp3,0.1,9,9,GTCTCCAGGTTTTCCTCAAA,0,1550434
galEp3,0.1,9,9,GTCTATGTGCGGTTCATCAA,0,1563385
galEp3,0.1,9,9,GTCTATGACTTATAGGACGA,0,1564484
galEp3,0.1,9,9,GTCGGTTCTAAGACCAAGTT,0,1582956
galEp3,0.1,9,9,GTCGCGGCCATTCTTAGGTA,0,1554083
galEp3,0.1,9,9,GTCGCCTCGCTGTGCCCGGC,0,1553245
galEp3,0.1,9,9,GTATTGCCAAAATCCCTCAG,0,1581278
galEp3,0.1,9,9,GTATTCAGTTCCCTAGGGCT,0,1562638
galEp3,0.1,9,9,GTATATCCGCGAAAATTAAT,0,1571755
galEp3,0.1,9,9,GTAGGGGCAGCTTCGGCTGA,0,1580601
galEp3,0.1,9,9,GTAGGCGTTAATTTGTCTTT,0,1566055
galEp3,0.1,9,9,GTACTCGGTCAAGTAAATAA,0,1576225
galEp3,0.1,9,9,GTAATTCGGCACCAACCATC,0,1561355
galEp3,0.1,9,9,GTAATGCTTAGCGGTTACGA,0,1571521
galEp3,0.1,9,9,GGTTTTGGAATCGCCCTCAA,0,1550940
galEp3,0.1,9,9,GGTTCAGCTGGCCGCGTATG,0,1564752
galEp3,0.1,9,9,GGTTATCCGCTTAATCGGGC,0,1546710
galEp3,0.1,9,9,GGTCCCTAGTGACTCAAAAT,0,1560702
galEp3,0.1,9,9,GGTCCCACGCCCTGTAGTAA,0,1569614
galEp3,0.1,9,9,GGTCAGATTATATAGCGTGT,0,1582578
galEp3,0.1,9,9,GGGTTCGTGGTTGAATTGTA,0,1587695
galEp3,0.1,9,9,GGGGTCTGCCCTCTGTCTGG,0,1580095
galEp3,0.1,9,9,GGGGGCGGTTGGGGACTTGT,0,1561605
galEp3,0.1,9,9,GGGGGCACTCGTGCGCCAGT,0,1548908
galEp3,0.1,9,9,GGGGAAGCAGATACTATGGG,0,1547335
galEp3,0.1,9,9,GGGCATGTCAATCGTGTGGC,0,1546898
galEp3,0.1,9,9,GGGCAGGTCGCATCGACTAA,0,1565806
galEp3,0.1,9,9,GGGAGGCCTCGTATCCGCCA,0,1568146
galEp3,0.1,9,9,GGCTTCGGGCAAGACGGACT,0,1556577
galEp3,0.1,9,9,GGCTTAAGCGGCCAAATAAG,0,1563440
galEp3,0.1,9,9,GGCTGAAGATGGCACAGTCT,0,1578692
galEp3,0.1,9,9,GGCTCCATCTATTGTATGGT,0,1565185
galEp3,0.1,9,9,GGCTATGTGGCAATCACAAG,0,1592816
galEp3,0.1,9,9,GGCGTACCGTCTAAGGATAG,0,1563638
galEp3,0.1,9,9,GGCGGCGCTATTCCATCGGT,0,1546917
galEp3,0.1,9,9,GGCGACGCTCAACGCCGCTA,0,1583988
galEp3,0.1,9,9,GGCCTCTTACGTAACCCTGG,0,1571860
galEp3,0.1,9,9,GGCCGGCGGTTTGTTGCCAG,0,1568389
galEp3,0.1,9,9,GGCATCTACGAGGCTAAAGG,0,1564188
galEp3,0.1,9,9,GGCAGGCCAGCTCAGATCTG,0,1582003
galEp3,0.1,9,9,GGCACGGATACGGCCAGGCC,0,1581317
galEp3,0.1,9,9,GGATTCCGGGCAATCTCGTC,0,1566842
galEp3,0.1,9,9,GGATGGTCACGTAAGGAGGT,0,1572701
galEp3,0.1,9,9,GGATCCATGCCGCAGAGGAG,0,1556324
galEp3,0.1,9,9,GGAGTGTACGCATACGCTTA,0,1590085
galEp3,0.1,9,9,GGAGGTGAGAGCGACTTGTC,0,1563375
galEp3,0.1,9,9,GGAGGCACTCAGGTGGCCTC,0,1578424
galEp3,0.1,9,9,GGAGCATCAAGCATTACACT,0,1580358
galEp3,0.1,9,9,GGAGATAATTACCGCAAGTG,0,1569482
galEp3,0.1,9,9,GGAGAGTTACACAAAGATCC,0,1575407
galEp3,0.1,9,9,GGACTCTCAGCAAGTATTGT,0,1564376
galEp3,0.1,9,9,GGACCCGATAGGCAGAGATC,0,1588428
galEp3,0.1,9,9,GGACACACCGTTTTTTGCAT,0,1587595
galEp3,0.1,9,9,GGAAGGGCCAGGATACCGCA,0,1568398
galEp3,0.1,9,9,GCTTGCGGTTATCAATATAG,0,1570485
galEp3,0.1,9,9,GCTTCAGCCTCGGTGATCAA,0,1558713
galEp3,0.1,9,9,GCTTAGTGTTGACTGTCCCG,0,1565168
galEp3,0.1,9,9,GCTCGGGCGTCGGGAGGATG,0,1576201
galEp3,0.1,9,9,GCTCACCATCGGGGCGGCGT,0,1549238
galEp3,0.1,9,9,GCGGTCAGGGATTAAGAGGT,0,1558759
galEp3,0.1,9,9,GCGGCCAGGGTGGCGTGAGA,0,1574245
galEp3,0.1,9,9,GCGCGCCAAGGTCATCGCGC,0,1571273
galEp3,0.1,9,9,GCGCAGGTAGGATGGTTAGC,0,1571151
galEp3,0.1,9,9,GCGAGACTAGGTTAGGGCTT,0,1577522
galEp3,0.1,9,9,GCGAATGGTAGTCATAACCT,0,1556566
galEp3,0.1,9,9,GCCTTCTTCCCGTAAATTAT,0,1549123
galEp3,0.1,9,9,GCCTCCGAGATGGGAGAAGG,0,1561159
galEp3,0.1,9,9,GCCGATCCAGATATGTCCTT,0,1575993
galEp3,0.1,9,9,GCCCGTGACATTCGGCCATG,0,1574808
galEp3,0.1,9,9,GCCCCCTTGTGTCTAGTTGT,0,1581478
galEp3,0.1,9,9,GCCATACCGCGAAGACCTCA,0,1580989
galEp3,0.1,9,9,GCCACGCCTAATTAGGATTC,0,1592063
galEp3,0.1,9,9,GCCAAAAAGGTCTATCGGGA,0,1553670
galEp3,0.1,9,9,GCATTTTTTACAGTGTATGG,0,1570142
galEp3,0.1,9,9,GCATTAAAGAATGAAAACAT,0,1590423
galEp3,0.1,9,9,GCATGAGCAGAAGATCATTT,0,1554879
galEp3,0.1,9,9,GCATCTGTGAGGTCGTATTG,0,1562718
galEp3,0.1,9,9,GCAGTTCTGCCATACCTTTT,0,1566989
galEp3,0.1,9,9,GCAGTTAGTACAGTGAAGAA,0,1581848
galEp3,0.1,9,9,GCAGTATATCGTGTATACAG,0,1570064
galEp3,0.1,9,9,GCAGATGTACCTAGTATGAA,0,1567958
galEp3,0.1,9,9,GCACGACAGGACCAGTCGGC,0,1590506
galEp3,0.1,9,9,GCAAGTGTCCATATGGGTAG,0,1584029
galEp3,0.1,9,9,GATTCCTTCCCCGTGTGAGA,0,1561962
galEp3,0.1,9,9,GATTAAGCACTTCGCTATGC,0,1564244
galEp3,0.1,9,9,GATCGCGACCCCTGTCCATG,0,1562237
galEp3,0.1,9,9,GAGCTCGGATCACCTACTAT,0,1569554
galEp3,0.1,9,9,GAGAATCTTGCTTGGTATCA,0,1572534
galEp3,0.1,9,9,GACTTTTCGCATGATGCCAA,0,1558558
galEp3,0.1,9,9,GACTATGTAACCATGGTAGA,0,1546937
galEp3,0.1,9,9,GACGGTGAGCGACAGAGTTA,0,1568769
galEp3,0.1,9,9,GACCTGGAAGGTTGGCCCAA,0,1559488
galEp3,0.1,9,9,GACCTAGCCCAGAGATCGTA,0,1556796
galEp3,0.1,9,9,GACCGCTAAACAGGCTAGCT,0,1546447
galEp3,0.1,9,9,GACAGACGGTGCAAGTATAA,0,1579899
galEp3,0.1,9,9,GACACGATTAGATTTCCTTC,0,1556292
galEp3,0.1,9,9,GACACATTTAGGGGGAGTTG,0,1580399
galEp3,0.1,9,9,GAATGCTGTTGAGTTTCTAC,0,1591097
galEp3,0.1,9,9,GAAATCGGCTCCGTCTCAGA,0,1589772
galEp3,0.1,9,9,GAAAGGGTTCCAGACTCGAA,0,1565007
galEp3,0.1,9,9,GAAACACCGACAACCTTTGG,0,1573666
galEp3,0.1,9,9,CTTTACAAGTGTAGGAAAAT,0,1571261
galEp3,0.1,9,9,CTTGTATGTTGAGCATTTTC,0,1547308
galEp3,0.1,9,9,CTTGGTCTTAGAGATTAAGT,0,1555268
galEp3,0.1,9,9,CTTGGAGAACTACGTATGAT,0,1588761
galEp3,0.1,9,9,CTTCTGTACGTCGAAGTTTT,0,1562935
galEp3,0.1,9,9,CTTCGCCCGAGCCCCTGGCC,0,1583010
galEp3,0.1,9,9,CTTCCTTGCTTACACTTTAA,0,1590766
galEp3,0.1,9,9,CTTCCGCCCTAAGATCAGGG,0,1550142
galEp3,0.1,9,9,CTTAATGGCCCTTCCGTCTA,0,1593623
galEp3,0.1,9,9,CTGTGTGATTCAAGGCAAGA,0,1565423
galEp3,0.1,9,9,CTGTGACCGTCCATAAGGCG,0,1594891
galEp3,0.1,9,9,CTGGGTCTACATTTGCATAA,0,1595091
galEp3,0.1,9,9,CTGGCCGGCAGGGTCGGTAG,0,1576842
galEp3,0.1,9,9,CTGGCCAGCGCTACGCGTGG,0,1556474
galEp3,0.1,9,9,CTGGAGTTCCTGGGCACACA,0,1564499
galEp3,0.1,9,9,CTGGAGATGCAGCAATGTAC,0,1591611
galEp3,0.1,9,9,CTGCTGTCTACGAACACAAG,0,1552342
galEp3,0.1,9,9,CTGATTTTCAACCACGCCAT,0,1587194
galEp3,0.1,9,9,CTGAGGGAAAGATGGAATCA,0,1578817
galEp3,0.1,9,9,CTGAGCTCCCCGTAGACCTG,0,1563315
galEp3,0.1,9,9,CTCTTATGGAGACGCAACGC,0,1575205
galEp3,0.1,9,9,CTCATGCATGTGAACGCAGT,0,1583635
galEp3,0.1,9,9,CTCATATTATCCGCGCACTA,0,1568734
galEp3,0.1,9,9,CTCAGGCGGGCTGTGCAATA,0,1579103
galEp3,0.1,9,9,CTATCGCACGATCAGTACCC,0,1577732
galEp3,0.1,9,9,CTATCGAAGCACATTACCCG,0,1562450
galEp3,0.1,9,9,CTAGTCCGCAATTGGTGCCA,0,1581576
galEp3,0.1,9,9,CTAGCCGTGGAATGCATTGT,0,1551444
galEp3,0.1,9,9,CTACTACCGGGCTATGAAAC,0,1554418
galEp3,0.1,9,9,CTACGAGTGAAGCTTCGGTG,0,1553493
galEp3,0.1,9,9,CTACATGGAAAACACGCACC,0,1558408
galEp3,0.1,9,9,CTACATCTAGCTCTCGATTA,0,1564367
galEp3,0.1,9,9,CGTTTACTGTGTAAGCAAAG,0,1593315
galEp3,0.1,9,9,CGTTGTGAGGGCTCGATCAA,0,1553162
galEp3,0.1,9,9,CGTTGGAGTCAGGACGCCAT,0,1549185
galEp3,0.1,9,9,CGTTCAAGCCGGTCCCTTCT,0,1568956
galEp3,0.1,9,9,CGTGATCGGGGCACAAGGAA,0,1549267
galEp3,0.1,9,9,CGTGAGCCTAGACGAGAGCA,0,1555310
galEp3,0.1,9,9,CGTGACCACAAGTGCACGGG,0,1574092
galEp3,0.1,9,9,CGTCTAGCACATCTGAATTA,0,1584270
galEp3,0.1,9,9,CGTCAGAGGTGCCGTTTGAA,0,1567166
galEp3,0.1,9,9,CGTCAACACCGAGGTGAATA,0,1585217
galEp3,0.1,9,9,CGTACGATAGTCTCACTGGA,0,1563930
galEp3,0.1,9,9,CGTAACTCGCACTTTACAGC,0,1585425
galEp3,0.1,9,9,CGGTGGGATTGCTCCGCCAC,0,1547862
galEp3,0.1,9,9,CGGTCACAGACAGCGCCCAA,0,1562653
galEp3,0.1,9,9,CGGGGGTAATTGACAACAAA,0,1587996
galEp3,0.1,9,9,CGGGGATTTCGTATTTGCAA,0,1560121
galEp3,0.1,9,9,CGGGCCGGTTCCGTTCACAA,0,1594460
galEp3,0.1,9,9,CGGGAACTAAGGAATTTGAC,0,1571495
galEp3,0.1,9,9,CGGGAAAAAACGAACTCTAT,0,1578997
galEp3,0.1,9,9,CGGCTCACTTCAATACGGTA,0,1563614
galEp3,0.1,9,9,CGGCGTCCCATCTCCTCCAA,0,1553603
galEp3,0.1,9,9,CGGAAAACGAGCCCGTAAAG,0,1581218
galEp3,0.1,9,9,CGCTGCCTGTGCTCGCACTC,0,1569436
galEp3,0.1,9,9,CGCGGTTAAGGCACTAGATG,0,1585099
galEp3,0.1,9,9,CGCGGCACCAGTTCCATCTA,0,1587832
galEp3,0.1,9,9,CGCCGCGTAGTCGCCCTTAC,0,1551232
galEp3,0.1,9,9,CGATTGGGTCAGATCGTCCG,0,1585747
galEp3,0.1,9,9,CGATTGGCGCGCGATGATGA,0,1584964
galEp3,0.1,9,9,CGATGTCATAAAACTGTCAT,0,1582276
galEp3,0.1,9,9,CGATGCGTTTTTGCACATCC,0,1591795
galEp3,0.1,9,9,CGATAGGTACCGACTTTAGC,0,1594887
galEp3,0.1,9,9,CGATACCGCTAGTGCCCCCA,0,1586956
galEp3,0.1,9,9,CGAGGGGTTATTCTTCGCCT,0,1559437
galEp3,0.1,9,9,CGACCACTTCGCTTCTAGTG,0,1577806
galEp3,0.1,9,9,CCTTTCATCGTCCACACCGA,0,1548305
galEp3,0.1,9,9,CCTTGTTTGGGTCTTATAGT,0,1582453
galEp3,0.1,9,9,CCTTCCGTGGTTACCTCACA,0,1580172
galEp3,0.1,9,9,CCTTAGGGCCACCGAGCTGA,0,1594837
galEp3,0.1,9,9,CCTTAGAACAGAGATGGCGT,0,1560925
galEp3,0.1,9,9,CCTGAGTATGAATTTGTTAA,0,1551419
galEp3,0.1,9,9,CCTGAGAAGGACAAGCCTGC,0,1592540
galEp3,0.1,9,9,CCTCTTTTGGAAGATGAGCT,0,1546947
galEp3,0.1,9,9,CCTATCGGATTGAAGGACGA,0,1588469
galEp3,0.1,9,9,CCGTGACACGTATACACTCA,0,1578657
galEp3,0.1,9,9,CCGTCGTACTGGCCTCTTAC,0,1550097
galEp3,0.1,9,9,CCGTCCCCAGGTCATCAGGT,0,1546782
galEp3,0.1,9,9,CCGGTTCCGCCAGGGCTACA,0,1556050
galEp3,0.1,9,9,CCGGGGGCGAGGTGCCTGAA,0,1579207
galEp3,0.1,9,9,CCGGGCTCCGTAGTATTGGA,0,1549784
galEp3,0.1,9,9,CCCGTAGCCATCCCCCATAA,0,1564306
galEp3,0.1,9,9,CCCGGAGCAGTTAGTATTAG,0,1550658
galEp3,0.1,9,9,CCCCAAGGCATACGCCAAAG,0,1581851
galEp3,0.1,9,9,CCCAAAGACCCGCCTTATGC,0,1562791
galEp3,0.1,9,9,CCATATTGTTGTACGCTCCT,0,1571620
galEp3,0.1,9,9,CCAGTGTCATAGGGGGCGTG,0,1573357
galEp3,0.1,9,9,CCAGTCCCGGACCGTGTTGT,0,1592869
galEp3,0.1,9,9,CCAGTAGGGAAGATGATAGC,0,1566510
galEp3,0.1,9,9,CCAGGCATGTCTGACGATAC,0,1585314
galEp3,0.1,9,9,CCAGCTTGTTTCAAAGAAAA,0,1582201
galEp3,0.1,9,9,CCACTTATTATCTCGTGTAG,0,1588525
galEp3,0.1,9,9,CCACAGGGTGGAAAGCGGCC,0,1578602
galEp3,0.1,9,9,CCACACTATAGCTATCGAAA,0,1547990
galEp3,0.1,9,9,CCAATGTTAACGCCGAAACT,0,1556085
galEp3,0.1,9,9,CCAAGAGTTTGCGATAGCCG,0,1557933
galEp3,0.1,9,9,CATTGGCCTTACATCACGCC,0,1553126
galEp3,0.1,9,9,CATTGATCATCGAGTTACTC,0,1583639
galEp3,0.1,9,9,CATGGTCTACCTGACCGCGC,0,1555043
galEp3,0.1,9,9,CATGCATCAGTTGTCCTAGT,0,1575431
galEp3,0.1,9,9,CATAGGGGTAGTCGGAACAT,0,1551087
galEp3,0.1,9,9,CAGTGGTGCCCTTGCCTAGC,0,1546570
galEp3,0.1,9,9,CAGGTTCCGACCTTCGGTTA,0,1549151
galEp3,0.1,9,9,CAGGGCTAACTTTATGTGTA,0,1554262
galEp3,0.1,9,9,CAGGCACCTCCCGTACGACC,0,1560542
galEp3,0.1,9,9,CAGCGATCCTAGGGGACCGA,0,1580647
galEp3,0.1,9,9,CAGCACATACAATCCTCATA,0,1551145
galEp3,0.1,9,9,CAGAGGATGATGGCCCTAAA,0,1565420
galEp3,0.1,9,9,CAGAGCACGGTCTCCCACTA,0,1566624
galEp3,0.1,9,9,CAGACACTCTACGGAGACGC,0,1585540
galEp3,0.1,9,9,CACTTGAATACCCTTTCGTT,0,1569946
galEp3,0.1,9,9,CACTACGTGTGCGTCGGGAG,0,1559497
galEp3,0.1,9,9,CACAAGTATGTGTTAAAAAC,0,1586627
galEp3,0.1,9,9,CACAAATGGGGCTAGTGAGG,0,1586982
galEp3,0.1,9,9,CAATTCTACAGCCATACGCT,0,1554612
galEp3,0.1,9,9,CAATGGTCTTAACACCTACT,0,1571355
galEp3,0.1,9,9,CAATACAAGGGCAGGGCGTA,0,1579221
galEp3,0.1,9,9,CAAGTTGACTCGACACCAGG,0,1584686
galEp3,0.1,9,9,CAAGGGAGGTATATGAGCCA,0,1558946
galEp3,0.1,9,9,CAAGCAGCGCTTAAACGAAT,0,1553196
galEp3,0.1,9,9,CAAGAACAGTATGGCGGGGG,0,1593749
galEp3,0.1,9,9,CAACGATTTGTCTGTCCCAG,0,1583618
galEp3,0.1,9,9,CAACCGCACGGAACTCAATA,0,1579302
galEp3,0.1,9,9,CAACCCTAAGCGTCTTTGAA,0,1553951
galEp3,0.1,9,9,CAACAGATCGAGCAGGAGTT,0,1589797
galEp3,0.1,9,9,CAAATTGCAAAGCTCGCCGA,0,1548399
galEp3,0.1,9,9,ATTTTTCGGCTGCGAGTCAA,0,1580533
galEp3,0.1,9,9,ATTGGTTAATCGTCCCATAC,0,1577417
galEp3,0.1,9,9,ATTGCCCACCCGTAGTCGAA,0,1561589
galEp3,0.1,9,9,ATTGCCACACGCGTTGTGTG,0,1547979
galEp3,0.1,9,9,ATTGAGGTACGAGGCGTTTG,0,1562538
galEp3,0.1,9,9,ATTCTTGCCCCGGCCAAATT,0,1561955
galEp3,0.1,9,9,ATTCGTGGCGCGGCGACATG,0,1593491
galEp3,0.1,9,9,ATTCCGTCTTACGCAGAAGC,0,1585186
galEp3,0.1,9,9,ATGTGTTAACCCTAGCCGTA,0,1579764
galEp3,0.1,9,9,ATGTACTGATATAATGACAC,0,1548114
galEp3,0.1,9,9,ATGGCTGAGTAGTGTGTATA,0,1559184
galEp3,0.1,9,9,ATGGCTCTAGATACATCCTT,0,1549994
galEp3,0.1,9,9,ATGGATAGCGTTAATGCGAG,0,1563259
galEp3,0.1,9,9,ATGGAACCGGGGTGCACAGC,0,1554392
galEp3,0.1,9,9,ATGATTCGATACCCAATTCT,0,1564249
galEp3,0.1,9,9,ATCTGTTAGTAACGATGCGC,0,1577210
galEp3,0.1,9,9,ATCTGGCAATGCTGGCGCGG,0,1587893
galEp3,0.1,9,9,ATCTAGTAGATGGCTCATCT,0,1558375
galEp3,0.1,9,9,ATCGGATGAGTCGATTGGAG,0,1558337
galEp3,0.1,9,9,ATCGCACCCGACGTAGGATA,0,1577630
galEp3,0.1,9,9,ATCGAATCGTAGCATATGAA,0,1559708
galEp3,0.1,9,9,ATCCTTTCTTAGCCTTGGGA,0,1553381
galEp3,0.1,9,9,ATCCGCTGATGTAGCCCCCT,0,1558371
galEp3,0.1,9,9,ATCCCCTAGTTTTCTTGTAT,0,1553675
galEp3,0.1,9,9,ATCCATTGCTCACGACCTTC,0,1558518
galEp3,0.1,9,9,ATCAAGACTATTGACGATAT,0,1592029
galEp3,0.1,9,9,ATATGGCATACCCGGGTGGA,0,1548596
galEp3,0.1,9,9,ATATCAGGTTTAGGTTTTTA,0,1576324
galEp3,0.1,9,9,ATAGCGAGTGAGAAGAGAGT,0,1555014
galEp3,0.1,9,9,ATAGATTATTGCCTCCTTTA,0,1565275
galEp3,0.1,9,9,ATACTAGCTGTACCGCGCTT,0,1583007
galEp3,0.1,9,9,ATACGTAAGGCCCTATTTCT,0,1560290
galEp3,0.1,9,9,ATACGCGGAGATACTCGGTC,0,1588374
galEp3,0.1,9,9,ATAACTTCGCTACACTTCGG,0,1551409
galEp3,0.1,9,9,ATAAATCTAGAGGCCCTTTG,0,1558366
galEp3,0.1,9,9,ATAAATACGCATGAACTTCC,0,1592610
galEp3,0.1,9,9,AGTTGTGTGTTTCGCGCCGT,0,1592688
galEp3,0.1,9,9,AGTGTGTGGACGTAGGACCC,0,1548630
galEp3,0.1,9,9,AGTGCGTGATGCCGAAGTCT,0,1592084
galEp3,0.1,9,9,AGTGCCACGGTCTTGGGCGG,0,1547849
galEp3,0.1,9,9,AGTCTCTGAGCCAGTTAGTT,0,1567756
galEp3,0.1,9,9,AGTCGAGGGGTAGCGTATGT,0,1573236
galEp3,0.1,9,9,AGTAATTTACGACGGCAGAT,0,1560711
galEp3,0.1,9,9,AGTAATCCGTTCACCCAGAT,0,1591507
galEp3,0.1,9,9,AGTAAGTCACGCTACTACCA,0,1555143
galEp3,0.1,9,9,AGGTTTGATGTTTCAAACAG,0,1549628
galEp3,0.1,9,9,AGGTTTCAGTGTTACTTGTC,0,1560780
galEp3,0.1,9,9,AGGTCTCCAGGTAGTCATTC,0,1577849
galEp3,0.1,9,9,AGGGTGTGTGTTCGGTGTCC,0,1560285
galEp3,0.1,9,9,AGGGCGGTTCACGAGCCAAG,0,1592617
galEp3,0.1,9,9,AGGGAGCCTCTGTGATGAGC,0,1578616
galEp3,0.1,9,9,AGGCCGACTCACCATCGTTA,0,1559404
galEp3,0.1,9,9,AGGCATGGGACCAAAATAGA,0,1557854
galEp3,0.1,9,9,AGGATTTTAGAAGAAGGATA,0,1561931
galEp3,0.1,9,9,AGGACGCGACCGCGAGCCTG,0,1589993
galEp3,0.1,9,9,AGGACAGGTAGCTAATCACT,0,1584193
galEp3,0.1,9,9,AGGAATGCAGAGCGGATAAT,0,1574417
galEp3,0.1,9,9,AGGAATCCCTAAAAAGCAGC,0,1565064
galEp3,0.1,9,9,AGCTTTTTGTTTTGCATTCA,0,1556339
galEp3,0.1,9,9,AGCTTGGCGCCGCTTTTTGA,0,1568390
galEp3,0.1,9,9,AGCGGTTTTCGAACGTTGAA,0,1588932
galEp3,0.1,9,9,AGCCTACCGACGAGCACGTC,0,1555932
galEp3,0.1,9,9,AGCACACAATTCAAAATATA,0,1587429
galEp3,0.1,9,9,AGAGTCAACTTGTAGTTAAT,0,1548197
galEp3,0.1,9,9,AGAGGTGACTAACAGGGCGG,0,1574444
galEp3,0.1,9,9,AGACCTTTAACGGGGCTTTA,0,1573429
galEp3,0.1,9,9,AGACAGCCGACGTGCTGCAT,0,1549358
galEp3,0.1,9,9,AGAAGCCAGGATAATGAGGT,0,1566350
galEp3,0.1,9,9,AGAACCTACGCGGACGCTCG,0,1565715
galEp3,0.1,9,9,ACTTTCTTGATAAACACCCT,0,1561165
galEp3,0.1,9,9,ACTTTCGCAATTGCCATCGC,0,1555037
galEp3,0.1,9,9,ACTTGTAGACGATGACGACT,0,1587570
galEp3,0.1,9,9,ACTGACGATGCCGATGAGTG,0,1552498
galEp3,0.1,9,9,ACTACGACTATATTTACGCT,0,1576833
galEp3,0.1,9,9,ACTAAGAGCCGTTGCCACAT,0,1560800
galEp3,0.1,9,9,ACGTTGACGAGTTGTAACCC,0,1572560
galEp3,0.1,9,9,ACGTGGGCTCGCTGTTTGGA,0,1571271
galEp3,0.1,9,9,ACGGGTAGGTAGGAAGAGAC,0,1578073
galEp3,0.1,9,9,ACGGATTGTTTAACAAGAGA,0,1570088
galEp3,0.1,9,9,ACGGAGAGGGATAGACGCGT,0,1553732
galEp3,0.1,9,9,ACGGAGACTCATAGAGGTTC,0,1563593
galEp3,0.1,9,9,ACGCTCGACACCACACCCGT,0,1591209
galEp3,0.1,9,9,ACGCAAACGCAATTGGTTAC,0,1584131
galEp3,0.1,9,9,ACGACGCCTCCCATGTTTAT,0,1565101
galEp3,0.1,9,9,ACGAAAACGGTTCACTCGCT,0,1582755
galEp3,0.1,9,9,ACCTGGGGTTACACCAAGTA,0,1559413
galEp3,0.1,9,9,ACCTCCTACTCCGGATCAAA,0,1586303
galEp3,0.1,9,9,ACCGATTCTTTGATATCTAT,0,1588085
galEp3,0.1,9,9,ACCGACAGAGGCGACGGGGA,0,1579143
galEp3,0.1,9,9,ACCCGTTTTGTTTGGCCGCA,0,1557322
galEp3,0.1,9,9,ACCCCCCTGCAGCAGACGGT,0,1587803
galEp3,0.1,9,9,ACCATGCGAGTCTCAAAAGC,0,1554906
galEp3,0.1,9,9,ACCATGAAGATGGCCATGTC,0,1581870
galEp3,0.1,9,9,ACCAGGATTGCTGCCCCGTC,0,1565751
galEp3,0.1,9,9,ACCACGAGGGGGTGCGCTTG,0,1547108
galEp3,0.1,9,9,ACCACCGGATCAGTACGCGT,0,1554557
galEp3,0.1,9,9,ACCAAGAAAGTGGCCTGTAT,0,1565181
galEp3,0.1,9,9,ACATTGGTGGGCCAATAACC,0,1593534
galEp3,0.1,9,9,ACATTCTATCCTTTAGAGCA,0,1571707
galEp3,0.1,9,9,ACAGGATCATATAGGAAGCT,0,1564118
galEp3,0.1,9,9,ACAGCAACCGTATTCGGTTA,0,1592323
galEp3,0.1,9,9,ACACTTGGCGGTTGCTCATT,0,1567648
galEp3,0.1,9,9,ACACACAATGGCATATGTCT,0,1565913
galEp3,0.1,9,9,AATTGCTTTAGCAAGAATAG,0,1591086
galEp3,0.1,9,9,AATTAAGGTGGACGCCCATG,0,1565597
galEp3,0.1,9,9,AATGGCCCTATTCCTTAAAT,0,1558540
galEp3,0.1,9,9,AATCCTTAGGCGGGCATAAG,0,1568913
galEp3,0.1,9,9,AATCCGACTTCCATCTACTC,0,1594452
galEp3,0.1,9,9,AAGTCGTACAGAAGTGACAC,0,1550054
galEp3,0.1,9,9,AAGTCAAGGTTCTATGTATG,0,1593398
galEp3,0.1,9,9,AAGTAACGTCTTATTACATA,0,1594424
galEp3,0.1,9,9,AAGGTGGCGGGCACGGGGGA,0,1552969
galEp3,0.1,9,9,AACGTTTCGATGGATAGCAA,0,1585278
galEp3,0.1,9,9,AACGCAAGCTAAAGGTCGTT,0,1562709
galEp3,0.1,9,9,AACCTAAATCTGATGACTTC,0,1558567
galEp3,0.1,9,9,AACCCCGGGAATCAGGGACA,0,1590431
galEp3,0.1,9,9,AAATGCCACTTTAGCAGGAT,0,1551977
galEp3,0.1,9,9,AAATGCAGCCGCTTTGCAGC,0,1571420
galEp3,0.1,9,9,AAATACCCAGGTGGAACGCG,0,1572678
galEp3,0.1,9,9,AAAGTTTAGCCGCAGTGAAT,0,1554519
galEp3,0.1,9,9,AAACGAGCCCGACGATTCTC,0,1550071
galEp3,0.1,9,9,AAAAGCGTTGATTCGGAGCG,0,1589273
galEp3,0.1111111111111111,8,8,TTTTTTATAGAGGCTGGATG,0,1563881
galEp3,0.1111111111111111,8,8,TTTTTAGAAAGTAAGCTTCT,0,1557819
galEp3,0.1111111111111111,8,8,TTTTACGGTTAAAAGTGTCC,0,1575757
galEp3,0.1111111111111111,8,8,TTTGTGGTGTGTCCTCAGCC,0,1572689
galEp3,0.1111111111111111,8,8,TTTGGGGGACATCCATTAGT,0,1560713
galEp3,0.1111111111111111,8,8,TTTGGCATCTGTCGGTTCCA,0,1589330
galEp3,0.1111111111111111,8,8,TTTGCATCATAGAGTCCAGC,0,1562052
galEp3,0.1111111111111111,8,8,TTTCATGTCTAGGATAGTTG,0,1575249
galEp3,0.1111111111111111,8,8,TTTCACTACCAAGGCTCTCC,0,1581926
galEp3,0.1111111111111111,8,8,TTTACCAAAAGCCGTTGCCT,0,1577699
galEp3,0.1111111111111111,8,8,TTTACACTGGTGGGACACGT,0,1572053
galEp3,0.1111111111111111,8,8,TTTAAAGCGCTGCGTGGTAG,0,1553507
galEp3,0.1111111111111111,8,8,TTGTGTCCGCACCGGTTCAA,0,1562570
galEp3,0.1111111111111111,8,8,TTGACTATTCCAGGTACACT,0,1586733
galEp3,0.1111111111111111,8,8,TTGACACCGACGCATCTTAG,0,1583166
galEp3,0.1111111111111111,8,8,TTCTTGGACCTTCATCTGAA,0,1550503
galEp3,0.1111111111111111,8,8,TTCTTCCTCTCAAACCGTCA,0,1556379
galEp3,0.1111111111111111,8,8,TTCTCTAGCCATGTGTTCAT,0,1585801
galEp3,0.1111111111111111,8,8,TTCAGCAAATGGCAACCTAC,0,1553203
galEp3,0.1111111111111111,8,8,TTCACGCGAGCGTTGTCTAA,0,1585605
galEp3,0.1111111111111111,8,8,TTATATTGTTGTGCGCCCAT,0,1554609
galEp3,0.1111111111111111,8,8,TTAGCGTATGATCAATGTCG,0,1549822
galEp3,0.1111111111111111,8,8,TTAGATTACAGACGCTTCCC,0,1564275
galEp3,0.1111111111111111,8,8,TTAGAGAGCCCATCGGTATA,0,1587271
galEp3,0.1111111111111111,8,8,TTACTGTCAAAATCTAACTT,0,1593447
galEp3,0.1111111111111111,8,8,TTACCATGCATCCGCCGTTT,0,1574159
galEp3,0.1111111111111111,8,8,TTACAGCGCATGGTAAGACA,0,1585555
galEp3,0.1111111111111111,8,8,TTAATTTTAAGAGTACCCGG,0,1568357
galEp3,0.1111111111111111,8,8,TTAAGCTGTTACTCACCGAA,0,1569503
galEp3,0.1111111111111111,8,8,TTAACCGCCTTCGGCTGGAC,0,1547910
galEp3,0.1111111111111111,8,8,TTAAAATAGGAGGTGAGAGA,0,1572907
galEp3,0.1111111111111111,8,8,TGTTGGACCCAAGACGTCAT,0,1591714
galEp3,0.1111111111111111,8,8,TGTTCTTATGGGTCCGATTG,0,1556384
galEp3,0.1111111111111111,8,8,TGTTCCGTCATTCAAGAAGC,0,1558530
galEp3,0.1111111111111111,8,8,TGTTAAACGCCCTCTCTGAC,0,1561938
galEp3,0.1111111111111111,8,8,TGTGGTTACCAAGGCATATA,0,1549917
galEp3,0.1111111111111111,8,8,TGTGGTGGGGCCGACGATGA,0,1572502
galEp3,0.1111111111111111,8,8,TGTCCACCCGATCAGACCGA,0,1581730
galEp3,0.1111111111111111,8,8,TGGTTCACACGGAACAGCGT,0,1561363
galEp3,0.1111111111111111,8,8,TGGTGAGCATATACTCACCC,0,1564555
galEp3,0.1111111111111111,8,8,TGGGGAGTACACTTCTCTTC,0,1566566
galEp3,0.1111111111111111,8,8,TGGGCAGAAAGGAAGTAGTC,0,1572133
galEp3,0.1111111111111111,8,8,TGGGAGACATGCCTGTGGTT,0,1566127
galEp3,0.1111111111111111,8,8,TGGCGTTTAGAATAGCTAGG,0,1550429
galEp3,0.1111111111111111,8,8,TGGCGTGTATAGTCTTGTCT,0,1572281
galEp3,0.1111111111111111,8,8,TGGCGCTTGTACGCACGTAT,0,1577524
galEp3,0.1111111111111111,8,8,TGGCCCGAAACCTCCATTAT,0,1580796
galEp3,0.1111111111111111,8,8,TGCTTTTCCATCGTCGTGTC,0,1550976
galEp3,0.1111111111111111,8,8,TGCTCCTCACCGATAGAGCC,0,1559999
galEp3,0.1111111111111111,8,8,TGCGTCTCATTCTGAATTAG,0,1574958
galEp3,0.1111111111111111,8,8,TGCGGGTCGTCTTCCCTGAG,0,1557149
galEp3,0.1111111111111111,8,8,TGCGGCGGCCCCGCGTCGAA,0,1566712
galEp3,0.1111111111111111,8,8,TGCGCCCTACGCGTCTGCTT,0,1562054
galEp3,0.1111111111111111,8,8,TGCATTGTCAGTGACAAGCA,0,1571503
galEp3,0.1111111111111111,8,8,TGCAGAGGGAGTGGGGGTAT,0,1581925
galEp3,0.1111111111111111,8,8,TGCAATACTTCGGTTTCGTC,0,1562110
galEp3,0.1111111111111111,8,8,TGATTCTCGGTCCAACGGTG,0,1553917
galEp3,0.1111111111111111,8,8,TGATGGGGGGAGTTTAGTTT,0,1582655
galEp3,0.1111111111111111,8,8,TGATCGAGTCTGTATTCTTA,0,1558194
galEp3,0.1111111111111111,8,8,TGATAGCGGTCTGTTCAGCC,0,1552514
galEp3,0.1111111111111111,8,8,TGATAATACTGGTAGGAAAT,0,1552981
galEp3,0.1111111111111111,8,8,TGAGGGTTCGATATAGCGTC,0,1576158
galEp3,0.1111111111111111,8,8,TGAGGAATATATGCGCACTT,0,1553649
galEp3,0.1111111111111111,8,8,TGAGCAGGACTTTTGGCAAT,0,1583179
galEp3,0.1111111111111111,8,8,TGAAAGTTGCAACACTGAAT,0,1586507
galEp3,0.1111111111111111,8,8,TCTTATTTGATGTTACGATG,0,1566200
galEp3,0.1111111111111111,8,8,TCTGTCTCGGTTCCCGAGAC,0,1589416
galEp3,0.1111111111111111,8,8,TCTGCGTATACCTACACCTG,0,1552722
galEp3,0.1111111111111111,8,8,TCTGCGCCAGGGAAGTACGG,0,1554799
galEp3,0.1111111111111111,8,8,TCTCTTCGGATGTTGATCCC,0,1571127
galEp3,0.1111111111111111,8,8,TCTAAGGATTTACGATTCGT,0,1562497
galEp3,0.1111111111111111,8,8,TCGTCTTCTTCACTTGAAGC,0,1566411
galEp3,0.1111111111111111,8,8,TCGTAGTCCGACTCGGGACG,0,1593788
galEp3,0.1111111111111111,8,8,TCGCGGTTCGAGGTAAGTAT,0,1563303
galEp3,0.1111111111111111,8,8,TCGCGACTACTGTTTGCCAG,0,1583730
galEp3,0.1111111111111111,8,8,TCCTCTTGGACAGGGAACCC,0,1554530
galEp3,0.1111111111111111,8,8,TCCTCCTCGAAACAGGGCCT,0,1571953
galEp3,0.1111111111111111,8,8,TCCGGCTGATCGGCCCACCA,0,1555944
galEp3,0.1111111111111111,8,8,TCCGATAGCCGTACGCCGTA,0,1586477
galEp3,0.1111111111111111,8,8,TCCAGGTCCCCGGATGCCGA,0,1572566
galEp3,0.1111111111111111,8,8,TCCACAATCGCCGGGAACCC,0,1548585
galEp3,0.1111111111111111,8,8,TCATAACTGTATAAGAGACC,0,1567674
galEp3,0.1111111111111111,8,8,TCAGTTCTAGGTCGATAAAG,0,1554907
galEp3,0.1111111111111111,8,8,TCAGCCATAAGCCATGGAGA,0,1566083
galEp3,0.1111111111111111,8,8,TCAGAAATCTAAGGATCCAC,0,1581177
galEp3,0.1111111111111111,8,8,TCACGGCTGGAATACACATA,0,1566746
galEp3,0.1111111111111111,8,8,TCACGATGGTACCGGGTCAT,0,1563608
galEp3,0.1111111111111111,8,8,TCACCTTTTCTCCAGGCGGT,0,1588745
galEp3,0.1111111111111111,8,8,TCACCATGCCGGCAAGGAAT,0,1592983
galEp3,0.1111111111111111,8,8,TCACCAGAGGTATGTATCCC,0,1546606
galEp3,0.1111111111111111,8,8,TCAAAGTTCTGTCCAGCTGT,0,1563318
galEp3,0.1111111111111111,8,8,TATTTGCGTCGCCCTGCGTA,0,1548221
galEp3,0.1111111111111111,8,8,TATTGACCGCTGTGAGCCCC,0,1557629
galEp3,0.1111111111111111,8,8,TATTCCCAGGTTTCCTAGGG,0,1570237
galEp3,0.1111111111111111,8,8,TATGTGGTTGAATTGGTGCT,0,1586095
galEp3,0.1111111111111111,8,8,TATGTATGTGGAATCAGATC,0,1551112
galEp3,0.1111111111111111,8,8,TATGGTGTACTCTTACAGGT,0,1548384
galEp3,0.1111111111111111,8,8,TATCTCACTGGACAGGACTC,0,1551759
galEp3,0.1111111111111111,8,8,TATCGGCTGGTCGGGTACTA,0,1566683
galEp3,0.1111111111111111,8,8,TATATTCCCACCATCTCAAA,0,1582792
galEp3,0.1111111111111111,8,8,TATATAGGGTCGCATGACAT,0,1562141
galEp3,0.1111111111111111,8,8,TATATAAACCCATTTGTGTG,0,1554450
galEp3,0.1111111111111111,8,8,TATAAAGACGTGCGTATAAG,0,1567614
galEp3,0.1111111111111111,8,8,TAGGTGGCCAGTTCCTGCAT,0,1553151
galEp3,0.1111111111111111,8,8,TAGGTACACTCAATATGTCG,0,1550624
galEp3,0.1111111111111111,8,8,TAGGGTCCTTAAATAAGTTA,0,1558087
galEp3,0.1111111111111111,8,8,TAGCTTCCGAGTCCGGTCAT,0,1574926
galEp3,0.1111111111111111,8,8,TAGCTGGGCAAGGCGTTCAA,0,1588250
galEp3,0.1111111111111111,8,8,TAGCCAAGCCGGGGTACGAT,0,1586831
galEp3,0.1111111111111111,8,8,TAGAGTACGCAGATCGGACA,0,1563962
galEp3,0.1111111111111111,8,8,TAGAGACAAGATAAAAGCTT,0,1592426
galEp3,0.1111111111111111,8,8,TAGAACCCATGAAAAAAAAC,0,1556840
galEp3,0.1111111111111111,8,8,TACTCAGCCGGTGCATGTAA,0,1594977
galEp3,0.1111111111111111,8,8,TACGGCTAGGGCTATAGTGT,0,1568953
galEp3,0.1111111111111111,8,8,TACCTGCGTGGATGTGAGGC,0,1547916
galEp3,0.1111111111111111,8,8,TACCATTCCTAAGAATCAAT,0,1546991
galEp3,0.1111111111111111,8,8,TACATTTTCATAGCGGCCCG,0,1564897
galEp3,0.1111111111111111,8,8,TACAGTATCCGACAGGAGGG,0,1592400
galEp3,0.1111111111111111,8,8,TACAGAGATGTCATCTCTAG,0,1557977
galEp3,0.1111111111111111,8,8,TAATGCCCGAGTGACTTATA,0,1590000
galEp3,0.1111111111111111,8,8,TAATCGTTAGTTCGGGACAC,0,1583245
galEp3,0.1111111111111111,8,8,TAAGTGGGTCGGTTGTTGGC,0,1568184
galEp3,0.1111111111111111,8,8,TAAGGTTTAATAGGGTTCTG,0,1575589
galEp3,0.1111111111111111,8,8,TAAGGACATGAGCTATTGGT,0,1565942
galEp3,0.1111111111111111,8,8,TAACTGCGAAGTCACGCGGT,0,1553898
galEp3,0.1111111111111111,8,8,TAACGCAACTCGGCCGCAAA,0,1592902
galEp3,0.1111111111111111,8,8,TAACATCCAGGGGCGGACTC,0,1585587
galEp3,0.1111111111111111,8,8,TAAATCCGAATTAGGTGCGC,0,1563348
galEp3,0.1111111111111111,8,8,TAAATAGAGCTCGTAGTGTA,0,1584554
galEp3,0.1111111111111111,8,8,TAAAGAGTTGAGGAGCAATA,0,1564739
galEp3,0.1111111111111111,8,8,TAAAGACAAGTAAGGGGACT,0,1556261
galEp3,0.1111111111111111,8,8,GTTTTTTGTCCTGTGTATTT,0,1577755
galEp3,0.1111111111111111,8,8,GTTTGGAATAAGCCTTGGGG,0,1592059
galEp3,0.1111111111111111,8,8,GTTTAAAACAACACCGTGAT,0,1549669
galEp3,0.1111111111111111,8,8,GTTGTATCACCGATCCTCAG,0,1594663
galEp3,0.1111111111111111,8,8,GTTGGTTATGCTTTCGGTGA,0,1576088
galEp3,0.1111111111111111,8,8,GTTGGTATGGGCATACCGAG,0,1587602
galEp3,0.1111111111111111,8,8,GTTGGATTAGAGGATTTCAC,0,1554735
galEp3,0.1111111111111111,8,8,GTTGACATTTAACTGCTAAG,0,1581910
galEp3,0.1111111111111111,8,8,GTTGAAGTGTCCGCCGTGCC,0,1558482
galEp3,0.1111111111111111,8,8,GTTCAGGGTTCGCGGTGACT,0,1588723
galEp3,0.1111111111111111,8,8,GTTATTTTCCAAAGCTTATT,0,1578621
galEp3,0.1111111111111111,8,8,GTTACGTCAGGCTCAGTCAG,0,1574229
galEp3,0.1111111111111111,8,8,GTTAAAAGGACGTTTGTAGC,0,1557644
galEp3,0.1111111111111111,8,8,GTGTTGAGCTTGTGTGATGG,0,1589931
galEp3,0.1111111111111111,8,8,GTGTGCCAATGTATATGCAA,0,1583178
galEp3,0.1111111111111111,8,8,GTGTCCTTAACACACGTCAC,0,1574956
galEp3,0.1111111111111111,8,8,GTGGTTCTAGTGTTAATTGG,0,1556912
galEp3,0.1111111111111111,8,8,GTGGTATCATCTCCGTGCAT,0,1588641
galEp3,0.1111111111111111,8,8,GTGGGGTTACATGAAGCTTC,0,1581516
galEp3,0.1111111111111111,8,8,GTGGCTGAACTCTTTAGTAA,0,1550326
galEp3,0.1111111111111111,8,8,GTGGCATTGATGGAACATCA,0,1591769
galEp3,0.1111111111111111,8,8,GTGGAACACCTAAATTTAGT,0,1559317
galEp3,0.1111111111111111,8,8,GTGCTCAGGGTGCTAGCAGA,0,1592923
galEp3,0.1111111111111111,8,8,GTGCGCCTAAGTCGTTTTGT,0,1581306
galEp3,0.1111111111111111,8,8,GTGCCATCCCGATACAGCGC,0,1561169
galEp3,0.1111111111111111,8,8,GTGATCGAAATCACACAAAC,0,1591869
galEp3,0.1111111111111111,8,8,GTCGAGTTATTTCCGCTGGC,0,1549361
galEp3,0.1111111111111111,8,8,GTCCTATGGCTTAATCCCGC,0,1547262
galEp3,0.1111111111111111,8,8,GTCCGTGTCCCATCTAACGC,0,1580778
galEp3,0.1111111111111111,8,8,GTCCATGCGCATTCGCTCCT,0,1563753
galEp3,0.1111111111111111,8,8,GTCATGAACTGTGGACCATC,0,1568423
galEp3,0.1111111111111111,8,8,GTCATCGGGGCTCGCGTCCG,0,1563865
galEp3,0.1111111111111111,8,8,GTCATAGTGTTCTAGACGGG,0,1569850
galEp3,0.1111111111111111,8,8,GTATGCAAGGTGATTAGTTC,0,1577768
galEp3,0.1111111111111111,8,8,GTATCACGTCGGTCTTGGTC,0,1585320
galEp3,0.1111111111111111,8,8,GTAGTTTTTACGCAGGCCAA,0,1559806
galEp3,0.1111111111111111,8,8,GTAGGAGCGGAAAGCCCCGT,0,1577428
galEp3,0.1111111111111111,8,8,GTACTGCTCCGGTTGTCCGA,0,1578123
galEp3,0.1111111111111111,8,8,GTACGAAATTATAGTAGCCT,0,1558652
galEp3,0.1111111111111111,8,8,GTACCTAAGTCGGAGCTTTC,0,1592143
galEp3,0.1111111111111111,8,8,GGTTTGATGCGGCGCGTTTT,0,1558969
galEp3,0.1111111111111111,8,8,GGTTGGCATCCAAAAGAGCC,0,1578946
galEp3,0.1111111111111111,8,8,GGTGTCGGGTTTGCACGTGT,0,1580936
galEp3,0.1111111111111111,8,8,GGTGTCATCAATAACAGTAG,0,1553600
galEp3,0.1111111111111111,8,8,GGTGGCGTTTGGAAATGCTG,0,1560746
galEp3,0.1111111111111111,8,8,GGTCTTCAAAGATACAGCCG,0,1547354
galEp3,0.1111111111111111,8,8,GGTCCCTTAGGACTGGGTAA,0,1587199
galEp3,0.1111111111111111,8,8,GGTCAAGTTAGTTGGGCTGA,0,1566057
galEp3,0.1111111111111111,8,8,GGTATCCGAATTATCGGTTT,0,1563191
galEp3,0.1111111111111111,8,8,GGGTCGGTTACGCCAACTGT,0,1561709
galEp3,0.1111111111111111,8,8,GGGTCCCATTGACGGCCCGA,0,1576079
galEp3,0.1111111111111111,8,8,GGGTAATTGCCTGTACATGC,0,1579888
galEp3,0.1111111111111111,8,8,GGGGGTGCGTCATCTAATCT,0,1556371
galEp3,0.1111111111111111,8,8,GGGGCGAGATGTAGTGAGAG,0,1559700
galEp3,0.1111111111111111,8,8,GGGATAAAGGAGGGAGCGCA,0,1565950
galEp3,0.1111111111111111,8,8,GGGACGGCTACTCCAGGGAG,0,1590729
galEp3,0.1111111111111111,8,8,GGGAAGTGTCAGTCGTTCAA,0,1573719
galEp3,0.1111111111111111,8,8,GGCTTGGACTGTCTGGGGAG,0,1565863
galEp3,0.1111111111111111,8,8,GGCGTGGGGGTATCTAATGA,0,1567503
galEp3,0.1111111111111111,8,8,GGCGTCTATTGTAGCGCGGT,0,1584984
galEp3,0.1111111111111111,8,8,GGCGGCCACGTGCGTTCCTT,0,1570965
galEp3,0.1111111111111111,8,8,GGCGCTATTGAAGTCAGCGC,0,1570852
galEp3,0.1111111111111111,8,8,GGCGCTACACACGGGTACAC,0,1588939
galEp3,0.1111111111111111,8,8,GGCCTCTGTAAGACGAGCCG,0,1593033
galEp3,0.1111111111111111,8,8,GGCCGGCACTTCAGGATCTT,0,1572280
galEp3,0.1111111111111111,8,8,GGCCCGGATCTAGCTACTGT,0,1546768
galEp3,0.1111111111111111,8,8,GGCAGTATTTGCACGATCTC,0,1591764
galEp3,0.1111111111111111,8,8,GGCAGGAGTCAAGTATATCA,0,1583806
galEp3,0.1111111111111111,8,8,GGCACAGCACGTCCTGTGAC,0,1553944
galEp3,0.1111111111111111,8,8,GGATTGTTATGTCTTTGCCT,0,1566392
galEp3,0.1111111111111111,8,8,GGATTGGCGTAGGCATAGTT,0,1584420
galEp3,0.1111111111111111,8,8,GGATTGCCGGGGGGCGTCAA,0,1569256
galEp3,0.1111111111111111,8,8,GGAGTGCACTGATTTTCGCA,0,1569218
galEp3,0.1111111111111111,8,8,GGAGTCTCAGCGGAGACCTA,0,1568155
galEp3,0.1111111111111111,8,8,GGACGACAGTTAGAAGTTTA,0,1582536
galEp3,0.1111111111111111,8,8,GGACAACGAGACCGTTGCTT,0,1565543
galEp3,0.1111111111111111,8,8,GGAAGTCACCAATTAGACAT,0,1559573
galEp3,0.1111111111111111,8,8,GGAAGACCGTGACTAGATAT,0,1555087
galEp3,0.1111111111111111,8,8,GGAACATCCATGAGATGAGT,0,1556800
galEp3,0.1111111111111111,8,8,GGAAAGAGACGAAAGCTCAT,0,1557827
galEp3,0.1111111111111111,8,8,GCTTTGGGCTTAAAAGTGGA,0,1561343
galEp3,0.1111111111111111,8,8,GCTTTCCTTTTCCTCAGTTC,0,1573325
galEp3,0.1111111111111111,8,8,GCTTTAAACAGAAAAAAATA,0,1564311
galEp3,0.1111111111111111,8,8,GCTTGACCGGTCGGGAGAGT,0,1562740
galEp3,0.1111111111111111,8,8,GCTGTGTCGGTTCCAACGCC,0,1585741
galEp3,0.1111111111111111,8,8,GCTGCTTTCTTCGGGGGAGT,0,1566337
galEp3,0.1111111111111111,8,8,GCTGCCACCGGCGGGACAGA,0,1570929
galEp3,0.1111111111111111,8,8,GCTCGACGGGTAGTGAGTCA,0,1555222
galEp3,0.1111111111111111,8,8,GCTCCGGCCGGCCCTTCGAG,0,1588110
galEp3,0.1111111111111111,8,8,GCTCCAAGAACTCCTCGTGT,0,1579046
galEp3,0.1111111111111111,8,8,GCTCAGACTATTCGATCTTC,0,1551830
galEp3,0.1111111111111111,8,8,GCTACTAGGGAGGAGAGACA,0,1550871
galEp3,0.1111111111111111,8,8,GCTACGATCTTTTATAAGGG,0,1548869
galEp3,0.1111111111111111,8,8,GCTAATTTGCTTTGTCCCTC,0,1594637
galEp3,0.1111111111111111,8,8,GCTAAAAGAGAATGCGCGCA,0,1592650
galEp3,0.1111111111111111,8,8,GCGCTCATAAAGCGGTAAGG,0,1551908
galEp3,0.1111111111111111,8,8,GCGCAACCCGTCGCGCGTCA,0,1572148
galEp3,0.1111111111111111,8,8,GCGAGGTGAGGCAATATCTA,0,1592184
galEp3,0.1111111111111111,8,8,GCGACAGGAGCAAACGCTGT,0,1558891
galEp3,0.1111111111111111,8,8,GCGACAGAGTGCATTCGAAA,0,1554662
galEp3,0.1111111111111111,8,8,GCGAAGGCGTTAGTATAAGA,0,1578840
galEp3,0.1111111111111111,8,8,GCCGGTTGCCAAGGGGGCGC,0,1556043
galEp3,0.1111111111111111,8,8,GCCGGGGAGAACGTACCGGG,0,1548896
galEp3,0.1111111111111111,8,8,GCCCGTTTATATAACATCTC,0,1581543
galEp3,0.1111111111111111,8,8,GCCCGCTATCGTGTAACAGA,0,1594682
galEp3,0.1111111111111111,8,8,GCCAAACTAGAAAGTACATT,0,1554828
galEp3,0.1111111111111111,8,8,GCATGCCGCAGCCTGCCCGT,0,1566958
galEp3,0.1111111111111111,8,8,GCATAGGTATGTGCTTGGGC,0,1580756
galEp3,0.1111111111111111,8,8,GCAGTGTCGTCTGATACAAT,0,1575234
galEp3,0.1111111111111111,8,8,GCAGTAGGATTAGTTTACGA,0,1572051
galEp3,0.1111111111111111,8,8,GCAGGAAAAAATGCGGGGAT,0,1562468
galEp3,0.1111111111111111,8,8,GCACGGCTCCGGGCTGCCAG,0,1554338
galEp3,0.1111111111111111,8,8,GCACCGATAGTTGGCGAGAA,0,1576523
galEp3,0.1111111111111111,8,8,GCACCCCCGAAGAGGCGGCT,0,1584223
galEp3,0.1111111111111111,8,8,GCACATGCGCCTACTAACTT,0,1571742
galEp3,0.1111111111111111,8,8,GCAAGTGAGGGAGCGCGGAA,0,1573125
galEp3,0.1111111111111111,8,8,GCAAGCGCGCCCTCTTTCGA,0,1586061
galEp3,0.1111111111111111,8,8,GCAAACGAAGCAGCACTCCT,0,1589570
galEp3,0.1111111111111111,8,8,GATTTGGATCTTGGACACAT,0,1573598
galEp3,0.1111111111111111,8,8,GATTAACGAGGTCGGAATTG,0,1558644
galEp3,0.1111111111111111,8,8,GATCGTCACATAGGCCGCGA,0,1553395
galEp3,0.1111111111111111,8,8,GATCACTCGTCGCAAGTATG,0,1575972
galEp3,0.1111111111111111,8,8,GATATCAGACTGAGCCGCCT,0,1559767
galEp3,0.1111111111111111,8,8,GATAGTGAAATAGTAAAATT,0,1547080
galEp3,0.1111111111111111,8,8,GAGTCGCCGTGCGCATGATC,0,1579678
galEp3,0.1111111111111111,8,8,GAGGTTGCGCGGAGGTTAAT,0,1575647
galEp3,0.1111111111111111,8,8,GAGGTGATGGGGGTGACCAG,0,1587769
galEp3,0.1111111111111111,8,8,GAGGTACCCTGCGTGGGTTT,0,1566876
galEp3,0.1111111111111111,8,8,GAGGGAGCATCAGTCCAAAG,0,1549265
galEp3,0.1111111111111111,8,8,GAGGCTGATTGTCTCGACGG,0,1591283
galEp3,0.1111111111111111,8,8,GAGCGGGTGTACGTGGGGTG,0,1589515
galEp3,0.1111111111111111,8,8,GAGCGGCCCAAGTGGCCCGT,0,1580480
galEp3,0.1111111111111111,8,8,GAGAGGCTGTACAGTGCATC,0,1551411
galEp3,0.1111111111111111,8,8,GAGACCTCGGCTGTAGAGGA,0,1567439
galEp3,0.1111111111111111,8,8,GAGAAAGAGAGGGTAACGTC,0,1574526
galEp3,0.1111111111111111,8,8,GACTTCCGGGTTGGATTGTC,0,1551115
galEp3,0.1111111111111111,8,8,GACTTACGAACGCTACCAGG,0,1556388
galEp3,0.1111111111111111,8,8,GACATTCTTCGATACACTTA,0,1551410
galEp3,0.1111111111111111,8,8,GACAGTTGTGTCTTCCCTGT,0,1593337
galEp3,0.1111111111111111,8,8,GAATAGACCCGGCTCGCTCG,0,1587274
galEp3,0.1111111111111111,8,8,GAATAAGTAGTGGTACGTAC,0,1576420
galEp3,0.1111111111111111,8,8,GAAGTGATCGTTAACCACCG,0,1585010
galEp3,0.1111111111111111,8,8,GAAGTGAGCATCCAAAGATC,0,1588752
galEp3,0.1111111111111111,8,8,GAAGGTCCGAATCCGTTTCT,0,1552306
galEp3,0.1111111111111111,8,8,GAACTGGCACCCAAGCCCAG,0,1585613
galEp3,0.1111111111111111,8,8,GAACGTCGATGGGTCCCTTA,0,1590534
galEp3,0.1111111111111111,8,8,GAACGCACCAGGATCGCCAT,0,1582412
galEp3,0.1111111111111111,8,8,GAACGATGCGTAAGGGCAGC,0,1591564
galEp3,0.1111111111111111,8,8,GAACGACCTAATTATATCCA,0,1569764
galEp3,0.1111111111111111,8,8,GAACACACTGTCATCAGACA,0,1559941
galEp3,0.1111111111111111,8,8,GAAAGTTTAGTACCATCTAT,0,1573618
galEp3,0.1111111111111111,8,8,GAAAGGCAATAAGAGAGTGC,0,1564931
galEp3,0.1111111111111111,8,8,GAAACAGGGGGGCTAGGGGG,0,1569202
galEp3,0.1111111111111111,8,8,CTTTTTTAGGACAATAGCGG,0,1579844
galEp3,0.1111111111111111,8,8,CTTTGAGGAGCTTAAATCTT,0,1586809
galEp3,0.1111111111111111,8,8,CTTGTGGCACTGCTAGAGGT,0,1576703
galEp3,0.1111111111111111,8,8,CTTGTCCTAGCTAAGCCTCT,0,1572117
galEp3,0.1111111111111111,8,8,CTTGGGTTGGTGGCTCCTTA,0,1574970
galEp3,0.1111111111111111,8,8,CTTGAGGGTACAATAACTTG,0,1551078
galEp3,0.1111111111111111,8,8,CTTCGCCTGGTACCGCCCAT,0,1594132
galEp3,0.1111111111111111,8,8,CTTAATATGCGTTCGATTGA,0,1574410
galEp3,0.1111111111111111,8,8,CTGTTCCGCGGTCACTTTGC,0,1590127
galEp3,0.1111111111111111,8,8,CTGTCAGGGACGCTCGTTCA,0,1566130
galEp3,0.1111111111111111,8,8,CTGTAAGCTGTGCGTCTGAG,0,1579498
galEp3,0.1111111111111111,8,8,CTGGTAGTTTTTCTCTGTGC,0,1555389
galEp3,0.1111111111111111,8,8,CTGGAGCATAGAGCGCAGAA,0,1575040
galEp3,0.1111111111111111,8,8,CTGCTCAAGAATTAGATAGC,0,1594789
galEp3,0.1111111111111111,8,8,CTGATGAAGCCGTAGCCCAA,0,1583133
galEp3,0.1111111111111111,8,8,CTGACTGTCCATCTTCGGTG,0,1547800
galEp3,0.1111111111111111,8,8,CTGACCACAACTGGCAATCC,0,1570022
galEp3,0.1111111111111111,8,8,CTGAATGTGCGGACGTGAGG,0,1559442
galEp3,0.1111111111111111,8,8,CTCTGTCTACCCGTACCAGG,0,1550760
galEp3,0.1111111111111111,8,8,CTCTCATTTGCTGCCCGATC,0,1568943
galEp3,0.1111111111111111,8,8,CTCGATGTCCATAGGACTTG,0,1571466
galEp3,0.1111111111111111,8,8,CTCGAGTCTAGCTGTGTATG,0,1584811
galEp3,0.1111111111111111,8,8,CTCCGGTTTGTCGGCACCTA,0,1584820
galEp3,0.1111111111111111,8,8,CTCCCAATACATATTCCTTT,0,1574739
galEp3,0.1111111111111111,8,8,CTCATGGTGTATCACAAGTG,0,1582365
galEp3,0.1111111111111111,8,8,CTCATCTCGAAGAACTGCGA,0,1557648
galEp3,0.1111111111111111,8,8,CTCACTTGGTCCGCATATTG,0,1586428
galEp3,0.1111111111111111,8,8,CTCAAATCCTGCCAGAGGGT,0,1583821
galEp3,0.1111111111111111,8,8,CTATTGTCTAATGTCACTTT,0,1592280
galEp3,0.1111111111111111,8,8,CTATTAGGCAGGTCTCAAAT,0,1585829
galEp3,0.1111111111111111,8,8,CTATGCAGAAGCTTCAAAGG,0,1551738
galEp3,0.1111111111111111,8,8,CTAGCCGCACTGGGCAGTGT,0,1561823
galEp3,0.1111111111111111,8,8,CTACTATTTTAGGTCTTGTG,0,1569738
galEp3,0.1111111111111111,8,8,CTAATCCGCGTGAATGAGAG,0,1547194
galEp3,0.1111111111111111,8,8,CGTTTTAGCTGGAAGTCTTA,0,1587138
galEp3,0.1111111111111111,8,8,CGTTTGATATGACATCTGCA,0,1552726
galEp3,0.1111111111111111,8,8,CGTTGTTCACTGGCAAGATT,0,1590624
galEp3,0.1111111111111111,8,8,CGTTCTTGGAGGCTCTAACT,0,1575159
galEp3,0.1111111111111111,8,8,CGTTAAGTAAATTCAGCTTG,0,1594778
galEp3,0.1111111111111111,8,8,CGTCGCGGGCGCGGCAAGAT,0,1550342
galEp3,0.1111111111111111,8,8,CGTCCGGCGGGAGCAGAGCG,0,1554890
galEp3,0.1111111111111111,8,8,CGTCCACAATCTCGACGCTA,0,1593643
galEp3,0.1111111111111111,8,8,CGTCATCATCATGCTGGTGG,0,1583528
galEp3,0.1111111111111111,8,8,CGTATTTGTGACAAGGAACT,0,1565540
galEp3,0.1111111111111111,8,8,CGTACATCCAACCCTTTCTA,0,1590891
galEp3,0.1111111111111111,8,8,CGTAATGGTAGTGTTATTGC,0,1594119
galEp3,0.1111111111111111,8,8,CGTAACATACGATCGGCGCC,0,1579004
galEp3,0.1111111111111111,8,8,CGGTCACTCCGTCAAAGGAT,0,1593683
galEp3,0.1111111111111111,8,8,CGGGTGAATATGCAGTTAAT,0,1581274
galEp3,0.1111111111111111,8,8,CGGGGTGAAGACTTTTACAG,0,1568881
galEp3,0.1111111111111111,8,8,CGGGCTGTCAAGGAGGAGAT,0,1560351
galEp3,0.1111111111111111,8,8,CGGGCGGGGATATCGAGGAT,0,1548431
galEp3,0.1111111111111111,8,8,CGGGACCCAGGAACAATTCG,0,1568414
galEp3,0.1111111111111111,8,8,CGGGAAGATGCGCAGTCGAA,0,1567189
galEp3,0.1111111111111111,8,8,CGGCGCCAGGCCAACACCGA,0,1569769
galEp3,0.1111111111111111,8,8,CGGCCTCAGTTGAAGCGGCC,0,1569932
galEp3,0.1111111111111111,8,8,CGGCAGGGTTCCGGGTAAAA,0,1576439
galEp3,0.1111111111111111,8,8,CGGCAAGAGTGGTGATGGAA,0,1585305
galEp3,0.1111111111111111,8,8,CGGAGGCGCTCGGTCAACTG,0,1569775
galEp3,0.1111111111111111,8,8,CGGACCGAGTCTCCCGATTA,0,1563263
galEp3,0.1111111111111111,8,8,CGCTTCCGAGTTGCACATGG,0,1560821
galEp3,0.1111111111111111,8,8,CGCTTACGTATGCAGGATAG,0,1552975
galEp3,0.1111111111111111,8,8,CGCTGTCAGTTTACTCGGGA,0,1566739
galEp3,0.1111111111111111,8,8,CGCGGCGATCTAGAGGAAAT,0,1554072
galEp3,0.1111111111111111,8,8,CGCGCGGGAGCCTCACAAAT,0,1586441
galEp3,0.1111111111111111,8,8,CGCCGACAGTGGTGGTGCTG,0,1547838
galEp3,0.1111111111111111,8,8,CGCCATGTAACGAGGGCCGT,0,1547103
galEp3,0.1111111111111111,8,8,CGCATTAGATTTGGCGCAGG,0,1590206
galEp3,0.1111111111111111,8,8,CGCAGTAACAGCACTTTCCC,0,1553252
galEp3,0.1111111111111111,8,8,CGCACTTGGTCGTGGTTTAG,0,1565505
galEp3,0.1111111111111111,8,8,CGATTGTCTACAGTCCCACC,0,1560371
galEp3,0.1111111111111111,8,8,CGATTGGAAGCGACCCGATT,0,1550620
galEp3,0.1111111111111111,8,8,CGAGTTTCAGTAAATAGTAT,0,1592060
galEp3,0.1111111111111111,8,8,CGAGTCCGTAAATGTACCCT,0,1582797
galEp3,0.1111111111111111,8,8,CGAGGTCCCGATTTGGTGTA,0,1575094
galEp3,0.1111111111111111,8,8,CGAGGCGTCCTTGATGATAA,0,1590682
galEp3,0.1111111111111111,8,8,CGAGCGTGATCGCCCTGCGT,0,1589952
galEp3,0.1111111111111111,8,8,CGAGACATACTCCAATATGC,0,1575035
galEp3,0.1111111111111111,8,8,CGAATCACACTTGACAAGTT,0,1581632
galEp3,0.1111111111111111,8,8,CGAATACCTTACTGGACCTT,0,1562587
galEp3,0.1111111111111111,8,8,CGAAAGGTACATGAGACCTG,0,1586202
galEp3,0.1111111111111111,8,8,CCTTTTACCAGGATTGCCTT,0,1558515
galEp3,0.1111111111111111,8,8,CCTTGGTTGGGACGGCTCTA,0,1575255
galEp3,0.1111111111111111,8,8,CCTTCTCACGCGGGAAACGT,0,1590362
galEp3,0.1111111111111111,8,8,CCTGGTCGGTCCGTGGAACA,0,1585307
galEp3,0.1111111111111111,8,8,CCTGCCTCAGGTGCGCGCAT,0,1566115
galEp3,0.1111111111111111,8,8,CCTGCCGGAGCAACGCATGA,0,1578014
galEp3,0.1111111111111111,8,8,CCTCTGCGTCAGGGAGGTAT,0,1594588
galEp3,0.1111111111111111,8,8,CCTCGATGTGGTTTTAGGTC,0,1568551
galEp3,0.1111111111111111,8,8,CCTCAGACAGCTGCTAGGGG,0,1576663
galEp3,0.1111111111111111,8,8,CCTATAACCGCCTCCCGATG,0,1550645
galEp3,0.1111111111111111,8,8,CCTACTCGTGGGTCATGCGA,0,1562198
galEp3,0.1111111111111111,8,8,CCTAATGCTAACTTGTTAAG,0,1575790
galEp3,0.1111111111111111,8,8,CCGGTTTGGCTCAGAGCGGT,0,1562918
galEp3,0.1111111111111111,8,8,CCGGGTACTTCGGATTCTTA,0,1587731
galEp3,0.1111111111111111,8,8,CCGGCTCTGAGATGTCCACA,0,1568555
galEp3,0.1111111111111111,8,8,CCGCGACCGCCCCTCCACGT,0,1595191
galEp3,0.1111111111111111,8,8,CCGAGATCGTGAGCATGGAG,0,1592925
galEp3,0.1111111111111111,8,8,CCCTTGCCATACCGTGTTTT,0,1571952
galEp3,0.1111111111111111,8,8,CCCTACAATGATTCGATAGT,0,1560028
galEp3,0.1111111111111111,8,8,CCCGGTCCTAAGAATAGCGC,0,1577697
galEp3,0.1111111111111111,8,8,CCCGGAAGGTCGAGACTCTC,0,1581016
galEp3,0.1111111111111111,8,8,CCCGACTCTTTCGGCATACA,0,1571694
galEp3,0.1111111111111111,8,8,CCCGAACCTGACGTCACCGA,0,1553154
galEp3,0.1111111111111111,8,8,CCCCGCAACTGTTACGGCTA,0,1577279
galEp3,0.1111111111111111,8,8,CCCATTGGTTGATAGAGTGA,0,1580156
galEp3,0.1111111111111111,8,8,CCCATAATCGCACATGCGAT,0,1565877
galEp3,0.1111111111111111,8,8,CCCAGGTTCCGTTTTGATCG,0,1583487
galEp3,0.1111111111111111,8,8,CCCAATGGGTGCACCCTCAC,0,1546791
galEp3,0.1111111111111111,8,8,CCCAAGCTTAGGGACTATAG,0,1558305
galEp3,0.1111111111111111,8,8,CCAGGATGTCACCCTGCTCT,0,1593612
galEp3,0.1111111111111111,8,8,CCAGACCAACATTTGCAGGA,0,1557053
galEp3,0.1111111111111111,8,8,CCAAGTTCATTACTTGGCAG,0,1567407
galEp3,0.1111111111111111,8,8,CATTGAGTCGGTACGGGCCG,0,1564281
galEp3,0.1111111111111111,8,8,CATGTGAAATCACACTCGCA,0,1569174
galEp3,0.1111111111111111,8,8,CATCTTCAGCCGGATGCTTG,0,1591794
galEp3,0.1111111111111111,8,8,CATCGAGGGTTCTATGTATA,0,1569839
galEp3,0.1111111111111111,8,8,CATCGACGCTTAGATCTTAA,0,1577625
galEp3,0.1111111111111111,8,8,CATCCTGTAGCTAATGACAC,0,1570601
galEp3,0.1111111111111111,8,8,CAGTGTGTAAAATATGTTAA,0,1571030
galEp3,0.1111111111111111,8,8,CAGTCTTCATGCGGGCAGTA,0,1573654
galEp3,0.1111111111111111,8,8,CAGTAGCGACGTCACTCATG,0,1554851
galEp3,0.1111111111111111,8,8,CAGGCGCCTAGTCGTCCCCA,0,1592053
galEp3,0.1111111111111111,8,8,CAGGAGGCCAACCCGACCGC,0,1589968
galEp3,0.1111111111111111,8,8,CAGCGTACCAGTACCTGGCT,0,1552993
galEp3,0.1111111111111111,8,8,CAGCCGGCGAAAATGGATTC,0,1581304
galEp3,0.1111111111111111,8,8,CAGCAGTCGAGATCTGCAGC,0,1556435
galEp3,0.1111111111111111,8,8,CAGAGTGATTCTATCCGGAA,0,1568758
galEp3,0.1111111111111111,8,8,CAGAACTCGGGTTGCGGTAT,0,1568511
galEp3,0.1111111111111111,8,8,CAGAACGGGTTTGGATCCGA,0,1584468
galEp3,0.1111111111111111,8,8,CAGAAACGCCAATCTTCGCC,0,1570434
galEp3,0.1111111111111111,8,8,CACTGTCTGAAAGACTACCT,0,1561365
galEp3,0.1111111111111111,8,8,CACTGGTTTAGCCTTCGGTT,0,1546826
galEp3,0.1111111111111111,8,8,CACTGGGTGACGAATGTGGA,0,1592413
galEp3,0.1111111111111111,8,8,CACTCGCGATCGTTATGAAC,0,1582896
galEp3,0.1111111111111111,8,8,CACTCCGCTCGTGAAGCTAT,0,1573175
galEp3,0.1111111111111111,8,8,CACTCATAGCGTAATAAATT,0,1571042
galEp3,0.1111111111111111,8,8,CACTATGTCGGGAATTTGTA,0,1568086
galEp3,0.1111111111111111,8,8,CACTATATCCAAAGATGCTA,0,1559270
galEp3,0.1111111111111111,8,8,CACGTAGATTTTAGGACGCT,0,1571810
galEp3,0.1111111111111111,8,8,CACGAACCTAGAAGTGGGGG,0,1578077
galEp3,0.1111111111111111,8,8,CACCGTAGGCCTCATCAGCG,0,1554842
galEp3,0.1111111111111111,8,8,CACCGATGGGCTGTCAATTG,0,1570473
galEp3,0.1111111111111111,8,8,CACCCGGCGATTTCTTTGTT,0,1552706
galEp3,0.1111111111111111,8,8,CACAACCTTCCATACATTTG,0,1576078
galEp3,0.1111111111111111,8,8,CAATGGCTTTGAATGGTACG,0,1584960
galEp3,0.1111111111111111,8,8,CAATCCTTCGCGTTCCAAGG,0,1592379
galEp3,0.1111111111111111,8,8,CAATAATGCTGGTTCAATCG,0,1547563
galEp3,0.1111111111111111,8,8,CAATAATCACAAATTTTTCT,0,1590886
galEp3,0.1111111111111111,8,8,CAAGCGACGAGATGAGCTGG,0,1578968
galEp3,0.1111111111111111,8,8,CAACGTCACGTATAGCCGAG,0,1562224
galEp3,0.1111111111111111,8,8,CAACAACGAGGGCTAATGGC,0,1576867
galEp3,0.1111111111111111,8,8,CAAAGCAGATGCTAAGTGGT,0,1563371
galEp3,0.1111111111111111,8,8,CAAACGGGTGTTCACGGCGA,0,1548692
galEp3,0.1111111111111111,8,8,CAAACGAAGTTGTTCAAGCC,0,1593615
galEp3,0.1111111111111111,8,8,CAAAACGCATAACGAAGTGT,0,1573907
galEp3,0.1111111111111111,8,8,ATTTTCATATTGCGGTTTAG,0,1573237
galEp3,0.1111111111111111,8,8,ATTTGACCCCTGGGCGCTTG,0,1591978
galEp3,0.1111111111111111,8,8,ATTTACCTGAATCAGGGACA,0,1564678
galEp3,0.1111111111111111,8,8,ATTGTCGCAACATAATAGAA,0,1566176
galEp3,0.1111111111111111,8,8,ATTGGTGATGCTCTCAAGTC,0,1594170
galEp3,0.1111111111111111,8,8,ATTGGCTGGTAGCAATTGTA,0,1559332
galEp3,0.1111111111111111,8,8,ATTCGATTCTTCAAGATGGG,0,1571587
galEp3,0.1111111111111111,8,8,ATTATAAGTTAATTCCGGCC,0,1577176
galEp3,0.1111111111111111,8,8,ATTACCTCACACGCCATGCA,0,1577979
galEp3,0.1111111111111111,8,8,ATTAAGCTAATGGCGGAACG,0,1555637
galEp3,0.1111111111111111,8,8,ATTAAAGTAAACGCGGCTTA,0,1566934
galEp3,0.1111111111111111,8,8,ATGTTGTAGCGCTTCTTTTG,0,1576248
galEp3,0.1111111111111111,8,8,ATGTCCGCCAGATCAGAGAA,0,1582123
galEp3,0.1111111111111111,8,8,ATGGTGGCCTCATGAGCAGA,0,1581930
galEp3,0.1111111111111111,8,8,ATGGTATACCCGCAAAAGAC,0,1587805
galEp3,0.1111111111111111,8,8,ATGGGGGTGAGACAATATAT,0,1576408
galEp3,0.1111111111111111,8,8,ATGGGCAGTATGGGCGAGGC,0,1558300
galEp3,0.1111111111111111,8,8,ATGGCTTCGGGGCATATTGC,0,1554613
galEp3,0.1111111111111111,8,8,ATGGCCGCAGCCCGCCCCGC,0,1585227
galEp3,0.1111111111111111,8,8,ATGGAAACCCGCATTATGAT,0,1590210
galEp3,0.1111111111111111,8,8,ATGCTGCTGGGGAACTCAGC,0,1586958
galEp3,0.1111111111111111,8,8,ATGCTCTACTGTAATCACAT,0,1563588
galEp3,0.1111111111111111,8,8,ATGCCGAATTTGTAAATATC,0,1576871
galEp3,0.1111111111111111,8,8,ATGAAATAGGATATCCGGCG,0,1591261
galEp3,0.1111111111111111,8,8,ATCTTACCGTTCCGGACAAT,0,1568689
galEp3,0.1111111111111111,8,8,ATCGATCCGGCAAGCCACTT,0,1586673
galEp3,0.1111111111111111,8,8,ATCCTAATAGTAACTCACAC,0,1555698
galEp3,0.1111111111111111,8,8,ATCCGCGCCTTGTACCGTAA,0,1562972
galEp3,0.1111111111111111,8,8,ATCCGATTGGAACGACGTGC,0,1556019
galEp3,0.1111111111111111,8,8,ATCCCTTGTTTACAATCGAA,0,1568116
galEp3,0.1111111111111111,8,8,ATCATGCTCAGCTAAAATTT,0,1590659
galEp3,0.1111111111111111,8,8,ATCATATCGAACTTACTCAC,0,1578924
galEp3,0.1111111111111111,8,8,ATATCTAGCTTACAAGCGTA,0,1561952
galEp3,0.1111111111111111,8,8,ATAGTGTATGGCGCCGCATC,0,1588791
galEp3,0.1111111111111111,8,8,ATAGTCGCTCGCCAGTACAG,0,1554368
galEp3,0.1111111111111111,8,8,ATAGGTCGCGACAGTTCGTT,0,1564313
galEp3,0.1111111111111111,8,8,ATACGTGCCGGCTTACCTGT,0,1551538
galEp3,0.1111111111111111,8,8,ATACGCATACCAGAAGCCAA,0,1586374
galEp3,0.1111111111111111,8,8,AGTTGCTATGAATTTCAGCT,0,1575545
galEp3,0.1111111111111111,8,8,AGTTGCGCTCTAGTTTATCA,0,1565866
galEp3,0.1111111111111111,8,8,AGTTAAAGAGCAGCCGTCTA,0,1554594
galEp3,0.1111111111111111,8,8,AGTGGTTGTTGTACCTCCGT,0,1556692
galEp3,0.1111111111111111,8,8,AGTGGCGTATCAGATCATGT,0,1594661
galEp3,0.1111111111111111,8,8,AGTGAGTAAGGGTCGCAAGG,0,1551708
galEp3,0.1111111111111111,8,8,AGTCGTCTAGGTGTGAAGTG,0,1589337
galEp3,0.1111111111111111,8,8,AGTCCGCGGTTTGTGGGGGT,0,1569776
galEp3,0.1111111111111111,8,8,AGTCAATATTGCCACGTCAA,0,1561788
galEp3,0.1111111111111111,8,8,AGTAGTATCCAGCGCATACG,0,1554128
galEp3,0.1111111111111111,8,8,AGGTTTCCCGCTGTATGCGT,0,1553026
galEp3,0.1111111111111111,8,8,AGGTAAAGGAGGAGACCAAG,0,1584431
galEp3,0.1111111111111111,8,8,AGGGTCTCGCCCACTGAGCA,0,1571044
galEp3,0.1111111111111111,8,8,AGGGGTACAGGATACTTTCC,0,1550786
galEp3,0.1111111111111111,8,8,AGGGATAAGTCTTTCGCAAC,0,1566310
galEp3,0.1111111111111111,8,8,AGGGAGTCTCAAGCAGTCCT,0,1585826
galEp3,0.1111111111111111,8,8,AGGCTATGTGCATTTAGTCC,0,1584893
galEp3,0.1111111111111111,8,8,AGGCCTTTAGCATTAGCGAC,0,1569146
galEp3,0.1111111111111111,8,8,AGGCACAAATGGCATTGGCA,0,1592419
galEp3,0.1111111111111111,8,8,AGGACATTGGGTAATGATTG,0,1585068
galEp3,0.1111111111111111,8,8,AGGACACGTAGGACCATACG,0,1548225
galEp3,0.1111111111111111,8,8,AGGAAGATCCTCGAACTTAA,0,1589779
galEp3,0.1111111111111111,8,8,AGCTGCTAGGCTGGTTAAAA,0,1573997
galEp3,0.1111111111111111,8,8,AGCTCTTGATGGTTATGAAG,0,1587192
galEp3,0.1111111111111111,8,8,AGCTCTCAGGGTATTGGAGT,0,1579349
galEp3,0.1111111111111111,8,8,AGCTAGTGTTGATGAAGGCG,0,1572507
galEp3,0.1111111111111111,8,8,AGCGGGTCTATCTAGGTGTC,0,1589495
galEp3,0.1111111111111111,8,8,AGCAAGGTATGCCCCTTTAC,0,1595155
galEp3,0.1111111111111111,8,8,AGCAAACCTCGCGAGCGGCG,0,1587157
galEp3,0.1111111111111111,8,8,AGATTTTGTTGATAGTAATA,0,1583079
galEp3,0.1111111111111111,8,8,AGATCACAGCGGGAGCATGT,0,1571926
galEp3,0.1111111111111111,8,8,AGATCAAATTGCTGTGTTGA,0,1556059
galEp3,0.1111111111111111,8,8,AGAGTGAGGAAGTGGCTTCT,0,1577231
galEp3,0.1111111111111111,8,8,AGAGGTCTTTCCTCCAGTGT,0,1554277
galEp3,0.1111111111111111,8,8,AGAGCCTCTTGAACACATTT,0,1569767
galEp3,0.1111111111111111,8,8,AGAGCCCGAATCCCGAGTGG,0,1591527
galEp3,0.1111111111111111,8,8,AGAGACGGCGGGGACATAAT,0,1556878
galEp3,0.1111111111111111,8,8,AGACTGTTTGCCAATCGTAT,0,1553558
galEp3,0.1111111111111111,8,8,AGAAGGTGCGTTAGAGGCCC,0,1548590
galEp3,0.1111111111111111,8,8,AGAAATTTCGGTACAACCAC,0,1569656
galEp3,0.1111111111111111,8,8,AGAAAATCGTGGAGCCACGA,0,1589002
galEp3,0.1111111111111111,8,8,ACTTCTCGTACGGTTCCTCC,0,1576368
galEp3,0.1111111111111111,8,8,ACTTATGCGCGCAGCTCGAT,0,1587834
galEp3,0.1111111111111111,8,8,ACTCTATTAATGCAGTGGGC,0,1558406
galEp3,0.1111111111111111,8,8,ACTCGTCCTAGATACAACGC,0,1549591
galEp3,0.1111111111111111,8,8,ACTAACATCTATAGGCCGAT,0,1589519
galEp3,0.1111111111111111,8,8,ACGTCTGTCAGTGCCTCTAG,0,1588917
galEp3,0.1111111111111111,8,8,ACGTCCTCGACCTGCACCGT,0,1574711
galEp3,0.1111111111111111,8,8,ACGTCACTGCAGCTCTCAAA,0,1556327
galEp3,0.1111111111111111,8,8,ACGTACGTAATAAGCGCATT,0,1583705
galEp3,0.1111111111111111,8,8,ACGTAATATATTGCGATAGC,0,1563568
galEp3,0.1111111111111111,8,8,ACGGCAAAGTCTTACTCAGT,0,1562799
galEp3,0.1111111111111111,8,8,ACGCTCAATTGCCGGAGCCG,0,1588238
galEp3,0.1111111111111111,8,8,ACGCATGCTGCTAATAGGGT,0,1571285
galEp3,0.1111111111111111,8,8,ACGCATGATGAACGGAATTA,0,1558262
galEp3,0.1111111111111111,8,8,ACCTGCGTCCACTTGCACGA,0,1572077
galEp3,0.1111111111111111,8,8,ACCTCCTTACGAGTACTATA,0,1584752
galEp3,0.1111111111111111,8,8,ACCGGGTGGGCTCTCTATTT,0,1585627
galEp3,0.1111111111111111,8,8,ACCGGCTCTCGAATTTGTCT,0,1558338
galEp3,0.1111111111111111,8,8,ACCGGACTCAATTTAGGCGA,0,1560187
galEp3,0.1111111111111111,8,8,ACCGCTGACTAGTATTCTGC,0,1553986
galEp3,0.1111111111111111,8,8,ACCATTGTTGACCTGCGAGT,0,1565522
galEp3,0.1111111111111111,8,8,ACCACCAAGGGTCATGAGAC,0,1580649
galEp3,0.1111111111111111,8,8,ACCACATTGATAATTACCTT,0,1587925
galEp3,0.1111111111111111,8,8,ACATTTATACGAAGTCACTT,0,1570008
galEp3,0.1111111111111111,8,8,ACATGGGAGAATTGCCGAAG,0,1546639
galEp3,0.1111111111111111,8,8,ACATGCTTTGACTGTTCATT,0,1558448
galEp3,0.1111111111111111,8,8,ACAGGCCACCACTGCATTCG,0,1573705
galEp3,0.1111111111111111,8,8,ACAGCGCCTAAAATTGCTGA,0,1579192
galEp3,0.1111111111111111,8,8,ACACCGGCTTCTCTGTTCAG,0,1565241
galEp3,0.1111111111111111,8,8,ACACACAGGAGTATCTTAGC,0,1576766
galEp3,0.1111111111111111,8,8,ACAAGAGAGTGTCCTTCGCA,0,1546803
galEp3,0.1111111111111111,8,8,ACAACAAGGCCTGCACGGGT,0,1571960
galEp3,0.1111111111111111,8,8,ACAAAGAAGCGGGAAAGTAA,0,1569255
galEp3,0.1111111111111111,8,8,ACAAACATGAATTAGGCCAG,0,1579685
galEp3,0.1111111111111111,8,8,AATTTCTCAGTAATGTCCAA,0,1567675
galEp3,0.1111111111111111,8,8,AATTTCGAAGCGAGGGCTCC,0,1593563
galEp3,0.1111111111111111,8,8,AATGGTGACAGCTTTATGTG,0,1569939
galEp3,0.1111111111111111,8,8,AATGCCCTGCAGACACGTTT,0,1574451
galEp3,0.1111111111111111,8,8,AATGAGTATATCTCGCAGTT,0,1577328
galEp3,0.1111111111111111,8,8,AATCTTGGCTCAAAGCCACT,0,1557088
galEp3,0.1111111111111111,8,8,AATCTGTAATTCCTTTTTTC,0,1574381
galEp3,0.1111111111111111,8,8,AATCTGCCTGGCTGGAATTA,0,1571995
galEp3,0.1111111111111111,8,8,AATCGAATGTTGATGAAGCT,0,1589141
galEp3,0.1111111111111111,8,8,AATCCCATGCTTGGATGCTC,0,1593663
galEp3,0.1111111111111111,8,8,AATCACCTCAACGTATGTTT,0,1581012
galEp3,0.1111111111111111,8,8,AATAGACATGGTGAGGAATA,0,1564127
galEp3,0.1111111111111111,8,8,AATAACGTGTGCTTACAGAA,0,1585805
galEp3,0.1111111111111111,8,8,AAGGTATAGGGTTCTCCATC,0,1559748
galEp3,0.1111111111111111,8,8,AAGGGTGAACTCTGAGCGTT,0,1567130
galEp3,0.1111111111111111,8,8,AAGGGACTGAATTGGTCTAC,0,1557046
galEp3,0.1111111111111111,8,8,AAGCGAGAGGTACTATCGGA,0,1586076
galEp3,0.1111111111111111,8,8,AAGCCCACATTCTGGAAACG,0,1590102
galEp3,0.1111111111111111,8,8,AAGCCAGCTTTCGAAGCCTT,0,1566629
galEp3,0.1111111111111111,8,8,AAGCAGAGAAAGCAATACTG,0,1552033
galEp3,0.1111111111111111,8,8,AAGCACGTCGAGAGTAAAGG,0,1552057
galEp3,0.1111111111111111,8,8,AAGATCGAGTTTGTGATTTG,0,1576516
galEp3,0.1111111111111111,8,8,AAGATAGGCCTATACATTTG,0,1568488
galEp3,0.1111111111111111,8,8,AACTGTGATCGGGCGTGCGC,0,1576435
galEp3,0.1111111111111111,8,8,AACTGTCACGCGAACGCCAA,0,1579184
galEp3,0.1111111111111111,8,8,AACTGGGTACCAGCCGTTGG,0,1559761
galEp3,0.1111111111111111,8,8,AACTCACGGGACGGTAGTCA,0,1577629
galEp3,0.1111111111111111,8,8,AACGATCGGGAGCCGTGTGG,0,1553978
galEp3,0.1111111111111111,8,8,AACCCTTTCAACAGGCTTCC,0,1570070
galEp3,0.1111111111111111,8,8,AACCCGTGGCCCCGAATTAC,0,1569742
galEp3,0.1111111111111111,8,8,AACAGCGCACCCCAGGTGAG,0,1575956
galEp3,0.1111111111111111,8,8,AACAACGATTGCAACCCTGT,0,1572735
galEp3,0.1111111111111111,8,8,AAATGGGTTACGGGGTACAG,0,1593105
galEp3,0.1111111111111111,8,8,AAAGGAAGCCTCACAGGTAG,0,1548614
galEp3,0.1111111111111111,8,8,AAAGCCATACACGAGGTTGG,0,1593142
galEp3,0.1111111111111111,8,8,AAACCCTGCCCTGATTGGAC,0,1560653
galEp3,0.1111111111111111,8,8,AAACATGTTATACCTTATTT,0,1572966
galEp3,0.125,7,7,TTTTTGGTCTAGGCATTGTT,0,1583322
galEp3,0.125,7,7,TTTTGCACGCTCGCTGGGAG,0,1587930
galEp3,0.125,7,7,TTTTCCATTCCTTACCTAGC,0,1565454
galEp3,0.125,7,7,TTTTCATCCGCTAATCCCGA,0,1553847
galEp3,0.125,7,7,TTTTAGGCCCATAGACCATT,0,1581948
galEp3,0.125,7,7,TTTGTGCCGTTCAATACGGT,0,1549906
galEp3,0.125,7,7,TTTGAGATACAGGGGGAGCA,0,1561423
galEp3,0.125,7,7,TTTCTGGTCTGGCCTAGATA,0,1578500
galEp3,0.125,7,7,TTTCGTTTCTTAATAATCTT,0,1577397
galEp3,0.125,7,7,TTTCGGTTTGCTGAAACAAA,0,1557035
galEp3,0.125,7,7,TTTCGGACTTATGAGGGCAA,0,1594938
galEp3,0.125,7,7,TTTAGAGTGGTAATTGGCCA,0,1552021
galEp3,0.125,7,7,TTTACTCGATTGAACTGGTA,0,1573362
galEp3,0.125,7,7,TTTAATCAGATACCGGACCC,0,1553644
galEp3,0.125,7,7,TTGTTCCTACCAAAGGAACT,0,1569334
galEp3,0.125,7,7,TTGTGTCGCGTTTGTGGTCC,0,1573042
galEp3,0.125,7,7,TTGTCTGATGTTCAGCACGT,0,1551882
galEp3,0.125,7,7,TTGTCCAGTTCTTTCCGCTA,0,1555695
galEp3,0.125,7,7,TTGGTTTACCGCATGTTTAA,0,1560725
galEp3,0.125,7,7,TTGGTAACCACTCCGTTTTT,0,1577643
galEp3,0.125,7,7,TTGGCTAGAGGCGAGCATAA,0,1549096
galEp3,0.125,7,7,TTGGCCGTCGTTTTTTGTTA,0,1569926
galEp3,0.125,7,7,TTGGAGATCCAAGTCATAAG,0,1560190
galEp3,0.125,7,7,TTGCTCTAGTAATAAAACAG,0,1589635
galEp3,0.125,7,7,TTGAGGCGGGGGCAGTCACG,0,1552339
galEp3,0.125,7,7,TTCTCCCTAATCTGGGTGAG,0,1591839
galEp3,0.125,7,7,TTCGGAGCCAACATTTCCGA,0,1566412
galEp3,0.125,7,7,TTCGCCCACTATCGAGCGAG,0,1575697
galEp3,0.125,7,7,TTCCCGGTAATATTGGGCGC,0,1567499
galEp3,0.125,7,7,TTCAGTAAGTGAGCAGCTAT,0,1584887
galEp3,0.125,7,7,TTCAGAGACACCCGGAAGTT,0,1578554
galEp3,0.125,7,7,TTCACCGGAGTAACGATGTG,0,1557546
galEp3,0.125,7,7,TTCACACTCTGAGTCATGCA,0,1578925
galEp3,0.125,7,7,TTCACACCACGACTCCACTG,0,1556664
galEp3,0.125,7,7,TTATCTCGTACTTATCATCT,0,1581221
galEp3,0.125,7,7,TTATCCGGATCCGTTTTTTG,0,1552750
galEp3,0.125,7,7,TTATATGGGCGGTAGCGTCA,0,1583183
galEp3,0.125,7,7,TTAGTGCGGTCCGGCGTTCA,0,1557108
galEp3,0.125,7,7,TTAGCCCTAACAGCGCAGAC,0,1574905
galEp3,0.125,7,7,TTACCCCATCCAGCGACATA,0,1552225
galEp3,0.125,7,7,TTAAGTAGTCACAACACGCC,0,1559939
galEp3,0.125,7,7,TGTTTTCGGTTGTATGCACT,0,1576838
galEp3,0.125,7,7,TGTTTAACGCAAGACATGGT,0,1584397
galEp3,0.125,7,7,TGTTGGAGAGTAATGCGCAC,0,1571280
galEp3,0.125,7,7,TGTTGCTGGATAGTGACCAT,0,1575332
galEp3,0.125,7,7,TGTTGATCAACTGACCATTT,0,1575390
galEp3,0.125,7,7,TGTTCCAGACGACTTGTAAG,0,1569133
galEp3,0.125,7,7,TGTTAGAAGCGCCCACCGTC,0,1564048
galEp3,0.125,7,7,TGTGTCTGCTGTCGCAGGAA,0,1563671
galEp3,0.125,7,7,TGTGTATAGCTACTCGGAAT,0,1575297
galEp3,0.125,7,7,TGTGGGGCAGTGTAAGCGTA,0,1592565
galEp3,0.125,7,7,TGTGCGCCGAAGGCGTCAGT,0,1582244
galEp3,0.125,7,7,TGTGCACTGGGGCAATTGCA,0,1584732
galEp3,0.125,7,7,TGTCCCGGATCGGTCCGTAA,0,1592444
galEp3,0.125,7,7,TGTCCAGCCCCTTCAGAACC,0,1593817
galEp3,0.125,7,7,TGTCACTTGTTGTACTGATG,0,1580403
galEp3,0.125,7,7,TGTCACCGGACCTCACCCGT,0,1566292
galEp3,0.125,7,7,TGTCACAAGGCATTCGTTGA,0,1580683
galEp3,0.125,7,7,TGGTTCGGCAACGTGAGAGA,0,1547353
galEp3,0.125,7,7,TGGTCAAGTTGTTGTGTTCT,0,1578824
galEp3,0.125,7,7,TGGGTTGTAAAAAGGGATCT,0,1559399
galEp3,0.125,7,7,TGGGTGATGGCCTGTGTGTA,0,1580489
galEp3,0.125,7,7,TGGGTAGACGTCTTGGAGAT,0,1558455
galEp3,0.125,7,7,TGGGTACTTTGATCAGGTTC,0,1554765
galEp3,0.125,7,7,TGGGGCACGGCCCGAGCATA,0,1573943
galEp3,0.125,7,7,TGGCTTGATTGTAATAATCC,0,1558768
galEp3,0.125,7,7,TGGCCGCCCGATTATTACAT,0,1588627
galEp3,0.125,7,7,TGGCATTATCGATCATTATA,0,1575725
galEp3,0.125,7,7,TGGCATCCGTCCGACCCTTG,0,1550632
galEp3,0.125,7,7,TGGATAAGGTTATCATCTGA,0,1561398
galEp3,0.125,7,7,TGGAGTCACGGGCTTGACGT,0,1565874
galEp3,0.125,7,7,TGGAGGGACGGCGCTCAAGC,0,1579730
galEp3,0.125,7,7,TGGAACCGCCACTTGTCCGT,0,1573808
galEp3,0.125,7,7,TGCTGCGCGAACGGGAGCTT,0,1592576
galEp3,0.125,7,7,TGCTCCATTTCGATACAGGA,0,1554042
galEp3,0.125,7,7,TGCTATTGCCTCGTGTTTTG,0,1551363
galEp3,0.125,7,7,TGCTAACACCCCGTGATGAT,0,1566395
galEp3,0.125,7,7,TGCCTCAGGACACCGTGGGT,0,1582217
galEp3,0.125,7,7,TGCCTCAGCCGGGTCCCACG,0,1576936
galEp3,0.125,7,7,TGCCGATTCGCGCTTCGGGG,0,1567026
galEp3,0.125,7,7,TGATTTAATGCTAGTTACGG,0,1587014
galEp3,0.125,7,7,TGATGGCACGTTCGCCCGTT,0,1565021
galEp3,0.125,7,7,TGATCGCACTGGTGATCCTA,0,1590509
galEp3,0.125,7,7,TGATATGGCGTGTGCGAATA,0,1587661
galEp3,0.125,7,7,TGATAGGCTTGCGGTCAGGT,0,1581087
galEp3,0.125,7,7,TGAGCCACTTGCCATGGTAC,0,1575935
galEp3,0.125,7,7,TGAGCACTTATGGTAGTCAG,0,1590760
galEp3,0.125,7,7,TGACGAAAGCCGATGGCTGT,0,1560123
galEp3,0.125,7,7,TGACCGAAAAAACAGTAAAC,0,1576360
galEp3,0.125,7,7,TGAACGTGGAGTTTCTTAAT,0,1577355
galEp3,0.125,7,7,TGAAAATGGCTGTGGTCGAT,0,1586466
galEp3,0.125,7,7,TGAAAACGCCGCGTTCTCTC,0,1553868
galEp3,0.125,7,7,TCTTCCCTGCAGCTTCACTC,0,1567606
galEp3,0.125,7,7,TCTGTTTTTGCAGGTCGCGT,0,1550953
galEp3,0.125,7,7,TCTGTAGGGCCAGGACCGCT,0,1567928
galEp3,0.125,7,7,TCTGCCCGAAGCTACCATTG,0,1589537
galEp3,0.125,7,7,TCTCCCTATCGATATAGAAA,0,1576259
galEp3,0.125,7,7,TCTAGACCTTATTTCTCGCT,0,1571055
galEp3,0.125,7,7,TCTACTCCAAATCGTTGTAG,0,1556680
galEp3,0.125,7,7,TCGGTGAACTCTCGCAGGAC,0,1565997
galEp3,0.125,7,7,TCGGATACTTTACCGTATTA,0,1584380
galEp3,0.125,7,7,TCGCTAGAAAAGTCTCTAAT,0,1572589
galEp3,0.125,7,7,TCGAGGAGAGTCGGATCGAC,0,1553586
galEp3,0.125,7,7,TCCTTGGTTACAGACTATGT,0,1567798
galEp3,0.125,7,7,TCCGATTAACCTGCTACCAG,0,1550017
galEp3,0.125,7,7,TCCGACTCTCTAAACCGGGT,0,1580259
galEp3,0.125,7,7,TCCCTTAGGGTAGTACTGTC,0,1588063
galEp3,0.125,7,7,TCCCGTTTTCCCGTTACAGG,0,1559092
galEp3,0.125,7,7,TCCAGTGGCTTCACTTCAGT,0,1547349
galEp3,0.125,7,7,TCATGTGCGTAAACAGGTGG,0,1549772
galEp3,0.125,7,7,TCATGTACACACGATAAAGA,0,1549703
galEp3,0.125,7,7,TCACGATACGAATTTGTGGG,0,1553942
galEp3,0.125,7,7,TCACATCCTCACAGATAAAC,0,1579878
galEp3,0.125,7,7,TCAATGCTCTAAAGGTGGCT,0,1577431
galEp3,0.125,7,7,TCAACGGGGGGGGGCATGGG,0,1578600
galEp3,0.125,7,7,TATGTTCTACACCACTCGTC,0,1581203
galEp3,0.125,7,7,TATGTGTTTCACACATCCGT,0,1574415
galEp3,0.125,7,7,TATGTATATGTTCCACAAGC,0,1571229
galEp3,0.125,7,7,TATGGGGGACGGGCGCAGGT,0,1548740
galEp3,0.125,7,7,TATCGATCGGATCCACTCGT,0,1568144
galEp3,0.125,7,7,TATCCGTGTAACTTAGTACC,0,1572770
galEp3,0.125,7,7,TATCCCTCGCGACGTGCTCA,0,1585280
galEp3,0.125,7,7,TAGGTAGCAACCTGGTGCAT,0,1578453
galEp3,0.125,7,7,TAGGGCTTTACTCATTGCCC,0,1556389
galEp3,0.125,7,7,TAGGGAGGTACTTTTACCTC,0,1573144
galEp3,0.125,7,7,TAGGATCTTTGTTCAGACCT,0,1559694
galEp3,0.125,7,7,TAGGAAAATGTAACGGATGC,0,1548250
galEp3,0.125,7,7,TAGCCCTCGCACAATAGCTA,0,1564380
galEp3,0.125,7,7,TAGCCCACGGTGCCATGCGC,0,1579132
galEp3,0.125,7,7,TAGCCAACGCGCCGAAACGT,0,1561949
galEp3,0.125,7,7,TAGCACAAACCTTCCTGGGT,0,1568233
galEp3,0.125,7,7,TAGATGTAACCTAGGTACAG,0,1550625
galEp3,0.125,7,7,TAGATAAGTGCATTTTCTTA,0,1550635
galEp3,0.125,7,7,TAGACCGTAATACTTCGGTT,0,1586500
galEp3,0.125,7,7,TACTTAGCCAAAAGGACAAA,0,1573707
galEp3,0.125,7,7,TACTGAAGCGTCGCATTATA,0,1570425
galEp3,0.125,7,7,TACTCGTAACAATCCGTAGA,0,1569348
galEp3,0.125,7,7,TACTCAGATCCCGCGAATCT,0,1591542
galEp3,0.125,7,7,TACTCACTGAAGGTTTCAGA,0,1590063
galEp3,0.125,7,7,TACGTGTCACATGCAAGTCA,0,1586843
galEp3,0.125,7,7,TACGGGGGACCGCACGATGA,0,1585647
galEp3,0.125,7,7,TACGGGCAGTTACACGGGTG,0,1570823
galEp3,0.125,7,7,TACGCAAATTCATATCCCAG,0,1572170
galEp3,0.125,7,7,TACGATGTGCGGGCCACCTG,0,1564867
galEp3,0.125,7,7,TACCGTCCTTCTGAATGAGT,0,1589088
galEp3,0.125,7,7,TACAATAAAGATGACAAGAG,0,1591686
galEp3,0.125,7,7,TACAAAGGACTCGCGTCAAA,0,1585359
galEp3,0.125,7,7,TAATAGTGCGTCTGGTGGTA,0,1569479
galEp3,0.125,7,7,TAAGTGGGGCGCGACTCCTT,0,1561229
galEp3,0.125,7,7,TAAGCGCAACTTTCATCCCG,0,1575990
galEp3,0.125,7,7,TAAGCGAAGCGTGCGTATGA,0,1570238
galEp3,0.125,7,7,TAAGCCGAACACCCCCCGGA,0,1569225
galEp3,0.125,7,7,TAAGCAACGCTGGGAATATT,0,1587170
galEp3,0.125,7,7,TAAGACTCGGTTAATTCCCT,0,1561071
galEp3,0.125,7,7,TAAGACTCCATCTGCACTCA,0,1551523
galEp3,0.125,7,7,TAAGACTCAACTAGACCAGC,0,1573547
galEp3,0.125,7,7,TAACCCGAAGCGTTAGATCT,0,1573909
galEp3,0.125,7,7,TAACAACGAATGAATGTATT,0,1574564
galEp3,0.125,7,7,TAAAGCCGACAGCAGGTCGT,0,1575756
galEp3,0.125,7,7,TAAACTGTCTGGTCACTCTG,0,1563283
galEp3,0.125,7,7,TAAACATGGTCGCGGTTTAT,0,1579432
galEp3,0.125,7,7,GTTTATGGTAGTACATGATA,0,1575816
galEp3,0.125,7,7,GTTGTCGCCAGTGACCGCCT,0,1564656
galEp3,0.125,7,7,GTTCTCTAAGCGCCCCACTT,0,1568412
galEp3,0.125,7,7,GTTCCGGCAGTTGTTAGAAC,0,1593995
galEp3,0.125,7,7,GTTCCGCGACGCGCTGTTTT,0,1555582
galEp3,0.125,7,7,GTTCAAATTACGTGTATCCA,0,1565694
galEp3,0.125,7,7,GTTATCGCCCTTTAGTTGCT,0,1560697
galEp3,0.125,7,7,GTTACTCTCCTCCGTCCAAT,0,1564774
galEp3,0.125,7,7,GTGTGCGGTGCTGCGTGGAA,0,1558142
galEp3,0.125,7,7,GTGTCGAGGTTTACATTGTA,0,1591110
galEp3,0.125,7,7,GTGGGTACGGGTCACAGCAT,0,1577587
galEp3,0.125,7,7,GTGGGGGCTAGGCATGCCTC,0,1561178
galEp3,0.125,7,7,GTGGCAACCGGCGTATGGCT,0,1579301
galEp3,0.125,7,7,GTGGATGGCATGTTCCTTGG,0,1562255
galEp3,0.125,7,7,GTGCTTTTCGTGGGAACCAA,0,1566320
galEp3,0.125,7,7,GTGCTTGCCGGGTGTACTAC,0,1557982
galEp3,0.125,7,7,GTGATGATTAATTTTTTCAA,0,1579935
galEp3,0.125,7,7,GTGATCTGATCAGCGAGGAT,0,1564627
galEp3,0.125,7,7,GTGACGTATGAGAACATACT,0,1563934
galEp3,0.125,7,7,GTGACCTCGCGGGTTGATAC,0,1565938
galEp3,0.125,7,7,GTGAAGGACATACTCCCTGG,0,1572919
galEp3,0.125,7,7,GTGAAGCGTCACTTGAAAAA,0,1567509
galEp3,0.125,7,7,GTCTTCTGGTACGCGCCCGC,0,1580722
galEp3,0.125,7,7,GTCTTAGACTAAGTCACTGT,0,1575582
galEp3,0.125,7,7,GTCTGTCTCTCTATGAGGAT,0,1547101
galEp3,0.125,7,7,GTCGATTGTCTTCACGCAGC,0,1561726
galEp3,0.125,7,7,GTCATTCAGGACGCATGAAC,0,1574685
galEp3,0.125,7,7,GTCACCCTGAGACGCAACCG,0,1548489
galEp3,0.125,7,7,GTATGGGTGCCCTCGGCCAA,0,1586299
galEp3,0.125,7,7,GTATGCTCGTAGTAACCGGT,0,1548652
galEp3,0.125,7,7,GTATCATCTTTTAACCATTT,0,1550900
galEp3,0.125,7,7,GTAGTTGGGAACCATTGGGC,0,1547202
galEp3,0.125,7,7,GTACTATGCTGGATCACATT,0,1558637
galEp3,0.125,7,7,GTACGTAATCGATCGCTAGA,0,1572706
galEp3,0.125,7,7,GTACCTTGGTCTCGTAAGGG,0,1582193
galEp3,0.125,7,7,GTACCCCTGAGAATAAGGGA,0,1586937
galEp3,0.125,7,7,GTACATTGTATAATATGGAT,0,1588918
galEp3,0.125,7,7,GTAAGGATACCTCACGGTGA,0,1550581
galEp3,0.125,7,7,GTAAGCTATAAAGGCAGCCG,0,1590239
galEp3,0.125,7,7,GGTTTATACCCGCGGGCTCA,0,1589244
galEp3,0.125,7,7,GGTTCACTTGTACCCATCCT,0,1589390
galEp3,0.125,7,7,GGTTACTTGCATTACCCTCT,0,1546490
galEp3,0.125,7,7,GGTGACGGACCTCGTGACCA,0,1577182
galEp3,0.125,7,7,GGTCGCCGGTTACCAGTACT,0,1556952
galEp3,0.125,7,7,GGTCATGGTCGTAAGAATTG,0,1571398
galEp3,0.125,7,7,GGTCAGTAATTGGACGCTGG,0,1550332
galEp3,0.125,7,7,GGTCAGATAGCAACGGAAGT,0,1568391
galEp3,0.125,7,7,GGTAGCCCTCCTAGAAGATC,0,1556087
galEp3,0.125,7,7,GGGTTGGTAACCCTTCGGTC,0,1590179
galEp3,0.125,7,7,GGGTTGATTGACCGCGGTGA,0,1578776
galEp3,0.125,7,7,GGGTTCGCGATCGTACCCTT,0,1589435
galEp3,0.125,7,7,GGGGTCAGTTTGTAAGCCAT,0,1581072
galEp3,0.125,7,7,GGGGATACTGATAATGTAGT,0,1576898
galEp3,0.125,7,7,GGGCTCGTGCTACTAGGGAA,0,1577294
galEp3,0.125,7,7,GGGCGATGGAGAGAGGAACG,0,1570342
galEp3,0.125,7,7,GGGCAGGTACCGGCGGGCTC,0,1553242
galEp3,0.125,7,7,GGGCAAACGTACAGGCAATG,0,1565749
galEp3,0.125,7,7,GGGATTTGGAGCTTACCCCC,0,1579431
galEp3,0.125,7,7,GGGATTGAGGAAGGGGTAAA,0,1570584
galEp3,0.125,7,7,GGGATCGAGTGGCGATCCGG,0,1574228
galEp3,0.125,7,7,GGGACTTTTGGGACCTCTTT,0,1572697
galEp3,0.125,7,7,GGGACGGGCGGAACTATAGA,0,1558382
galEp3,0.125,7,7,GGGACGGGAAAGCCCTCATC,0,1555785
galEp3,0.125,7,7,GGGACCGTCCGCGATGAGGG,0,1563774
galEp3,0.125,7,7,GGGAATCCTAGGTTCCTCAT,0,1557647
galEp3,0.125,7,7,GGCTTAGCGGACAGGAGCCG,0,1580083
galEp3,0.125,7,7,GGCTTAACCACATTTTCGCC,0,1572575
galEp3,0.125,7,7,GGCTGGATGAGATGCTAATT,0,1559983
galEp3,0.125,7,7,GGCTCCTTTGATTCGGGACA,0,1556716
galEp3,0.125,7,7,GGCGTGCTGGGCTGACATAT,0,1562410
galEp3,0.125,7,7,GGCGTCTTGTCAACTAAATC,0,1577578
galEp3,0.125,7,7,GGCGTCCTACGATGCCAACA,0,1585254
galEp3,0.125,7,7,GGCGTATTTCTTTCTTGTGT,0,1583271
galEp3,0.125,7,7,GGCGGACAGAGCAGTTAAGT,0,1574406
galEp3,0.125,7,7,GGCGCTGCGGCGAGGGTCCC,0,1578879
galEp3,0.125,7,7,GGCGCGGTTTACATCAACTC,0,1593380
galEp3,0.125,7,7,GGCGAGCAAAAGCAGGTAAA,0,1555971
galEp3,0.125,7,7,GGCGAAGGAGTTGGACTCTT,0,1551446
galEp3,0.125,7,7,GGCATGGACCGTTCGGAGCG,0,1566099
galEp3,0.125,7,7,GGCAGTTGACAAACGCCATA,0,1594843
galEp3,0.125,7,7,GGATCAAGCTCCTTTTAGCT,0,1560251
galEp3,0.125,7,7,GGAGTATAACTTCGATTCAG,0,1567875
galEp3,0.125,7,7,GGAGCACTCAACCTCACTCG,0,1582282
galEp3,0.125,7,7,GGACGCTGGGCAATATTGTA,0,1548380
galEp3,0.125,7,7,GGACACGCGGCCCTGCATAT,0,1567218
galEp3,0.125,7,7,GGAAGGCGGTGTCTTACTCG,0,1589881
galEp3,0.125,7,7,GGAAAACTGGTAATGCCACG,0,1569247
galEp3,0.125,7,7,GGAAAAAGCGACGCATCAAT,0,1589346
galEp3,0.125,7,7,GCTTTCCGAAACCTTGCGAC,0,1553906
galEp3,0.125,7,7,GCTTCGTCCAGATATATATA,0,1578444
galEp3,0.125,7,7,GCTGTTACGCAGGTGGAGAC,0,1582595
galEp3,0.125,7,7,GCTGGGCGCATTACAAGGTT,0,1564260
galEp3,0.125,7,7,GCTGGCGGGATTGACGTTAA,0,1558632
galEp3,0.125,7,7,GCTGGAATACCAGAGACCGG,0,1594283
galEp3,0.125,7,7,GCTGGAAATGACATTTCACT,0,1557255
galEp3,0.125,7,7,GCTCTCTAGAAGTAGCCCCG,0,1557893
galEp3,0.125,7,7,GCTCGTCCTGAACACAGGGT,0,1556939
galEp3,0.125,7,7,GCTCAGTGCTCTGTAGCGAC,0,1559426
galEp3,0.125,7,7,GCTCAAGGTTCGGACATTGT,0,1556086
galEp3,0.125,7,7,GCTCAAATTAATATAGGACC,0,1563864
galEp3,0.125,7,7,GCTATTAGAGGCCCTACAAA,0,1581178
galEp3,0.125,7,7,GCTAGAAGAAAAGGATTTGT,0,1592375
galEp3,0.125,7,7,GCTACTCTGGATCGCTCGGT,0,1549228
galEp3,0.125,7,7,GCGTGACCTGTTTTGGAAGA,0,1590416
galEp3,0.125,7,7,GCGTATGTCTTAGGGATAGA,0,1589713
galEp3,0.125,7,7,GCGGCTGTCACAATGGACGT,0,1582624
galEp3,0.125,7,7,GCGAGAGCGTGTGACGGGTT,0,1568686
galEp3,0.125,7,7,GCGACTCAATGATAGGGGAT,0,1553875
galEp3,0.125,7,7,GCGACGGAGGGTCTCAATCG,0,1550523
galEp3,0.125,7,7,GCGAAAAGACGCAGCCCTGA,0,1574814
galEp3,0.125,7,7,GCCTGGGACGGGTATATTTA,0,1589773
galEp3,0.125,7,7,GCCTCCGGCACCAAGTCGCG,0,1571596
galEp3,0.125,7,7,GCCTAGGTAGAAAGGCCGTC,0,1574344
galEp3,0.125,7,7,GCCTAAACGAACTGACAAGT,0,1562842
galEp3,0.125,7,7,GCCGTCTGTGCTACTTCAGT,0,1591228
galEp3,0.125,7,7,GCCGGTTGCAGATTAGGTAT,0,1574007
galEp3,0.125,7,7,GCCGGTAAGAATTTTGGATA,0,1562172
galEp3,0.125,7,7,GCCGGCCGCGGGCAGCAACT,0,1557339
galEp3,0.125,7,7,GCCGAGTACGTTAAATAGCT,0,1579660
galEp3,0.125,7,7,GCCCGCGGAAGCTCAAGGAT,0,1562330
galEp3,0.125,7,7,GCCATAGCACGAATCTGCCT,0,1584285
galEp3,0.125,7,7,GCCAGTCATTGGGTTTCTCC,0,1550407
galEp3,0.125,7,7,GCCAAAGTTCAAGCACATGT,0,1559474
galEp3,0.125,7,7,GCATTTGCTAACCCATAACG,0,1567430
galEp3,0.125,7,7,GCATTCCGCAGCGAGGTGGT,0,1552965
galEp3,0.125,7,7,GCATGGCTATGCACTCGACT,0,1575488
galEp3,0.125,7,7,GCAGGAAGGGTCGTAATGTC,0,1565142
galEp3,0.125,7,7,GCAACTGAAGGGCAAGGGGT,0,1552725
galEp3,0.125,7,7,GCAAAAGGATCGGTAACTAT,0,1585421
galEp3,0.125,7,7,GATTGCGCAAGTGTCGTAAT,0,1570268
galEp3,0.125,7,7,GATTCTTGCAAAGACCTATT,0,1567386
galEp3,0.125,7,7,GATTAGGTATGCCTTTTACG,0,1594193
galEp3,0.125,7,7,GATTAAAAAAAGTGCTGTCT,0,1570337
galEp3,0.125,7,7,GATCGGCACTTACGCCAACA,0,1560812
galEp3,0.125,7,7,GATATGAAACGTCGTTCATA,0,1548350
galEp3,0.125,7,7,GATATCAACGTGGCATGGCA,0,1569803
galEp3,0.125,7,7,GAGTTCGGCGCAATCTGGCA,0,1561041
galEp3,0.125,7,7,GAGTTCCGGTGACGTTGTTT,0,1564128
galEp3,0.125,7,7,GAGTATGAGCGTTGGCTTAT,0,1568874
galEp3,0.125,7,7,GAGGTACTTGGGTACTGCGA,0,1552149
galEp3,0.125,7,7,GAGGAGGTCAATGTGAGGTA,0,1578759
galEp3,0.125,7,7,GAGGAGCCTCTGTATATATG,0,1594975
galEp3,0.125,7,7,GAGGAGCCCCCAGCTCAGCA,0,1572446
galEp3,0.125,7,7,GAGCTGTGGTTTCTTTAAAA,0,1557573
galEp3,0.125,7,7,GAGCTGGCGCAAGATGAGAG,0,1559907
galEp3,0.125,7,7,GAGATCTACTGTCATCCTAG,0,1553179
galEp3,0.125,7,7,GAGATCGTAGGTACAGGACT,0,1548113
galEp3,0.125,7,7,GACTTCGCTGGTAAGTTTAG,0,1589454
galEp3,0.125,7,7,GACTCGTTTGTTCTCTGTTA,0,1557178
galEp3,0.125,7,7,GACTCCCTGTGCGTCACCTT,0,1553234
galEp3,0.125,7,7,GACTACTACTTTGTCTGCTA,0,1577037
galEp3,0.125,7,7,GACGTCTCTTCCCAATAGAT,0,1593402
galEp3,0.125,7,7,GACGCTGCAAATCTACAGAC,0,1551994
galEp3,0.125,7,7,GACGCAACAATAGTGGCCTC,0,1563711
galEp3,0.125,7,7,GACCGTTCATCCATATAGCC,0,1557414
galEp3,0.125,7,7,GACATTATACCTTTTCCCGG,0,1580315
galEp3,0.125,7,7,GACACCGTAAACACAGTTAA,0,1590178
galEp3,0.125,7,7,GACACCAGGACGTTAGACCC,0,1552549
galEp3,0.125,7,7,GAATCTTTCCCCACATCGAT,0,1575812
galEp3,0.125,7,7,GAAGGTTTACGTGGATACCT,0,1553892
galEp3,0.125,7,7,GAAGGGACTATTGAACATGT,0,1590582
galEp3,0.125,7,7,GAAGCATCTAGGGTCGCTAT,0,1560110
galEp3,0.125,7,7,GAAGAGAACTACGGCCATAT,0,1570960
galEp3,0.125,7,7,GAACCAGTGAAATAGGCTAC,0,1554175
galEp3,0.125,7,7,GAACAGAGACGTAGAGGAGA,0,1557769
galEp3,0.125,7,7,GAAACATGCTGATGACCTGA,0,1569707
galEp3,0.125,7,7,CTTTTACGGTTTGGACACTT,0,1587152
galEp3,0.125,7,7,CTTTAAAACGGATTTTTCTG,0,1591372
galEp3,0.125,7,7,CTTGTTCCTCTGGGAAAAAG,0,1584454
galEp3,0.125,7,7,CTTGTGCATCCCCCGTCCAA,0,1561927
galEp3,0.125,7,7,CTTGTAGTACTGAGATTTAG,0,1566891
galEp3,0.125,7,7,CTTGGCATAAACGATGTTAT,0,1553368
galEp3,0.125,7,7,CTTGAGTTCCGAAGTGTGCC,0,1584770
galEp3,0.125,7,7,CTTGACTATGTAGGGGACTC,0,1560913
galEp3,0.125,7,7,CTTCGAGCTCTCGACCAGCG,0,1563489
galEp3,0.125,7,7,CTTCATGGCTGAACGTTGAA,0,1586114
galEp3,0.125,7,7,CTTCAGCGGTCACGTATCAG,0,1559098
galEp3,0.125,7,7,CTTACACGCTTAATTCTCTC,0,1560462
galEp3,0.125,7,7,CTTAAGGTAATGCAGTAGAA,0,1569857
galEp3,0.125,7,7,CTGTTTCAACTAACCATTAC,0,1547553
galEp3,0.125,7,7,CTGTGGAATAAACACTCACT,0,1555858
galEp3,0.125,7,7,CTGTGATATTCGAGGTCGCT,0,1570080
galEp3,0.125,7,7,CTGTCCATAATAAATAGTGG,0,1547254
galEp3,0.125,7,7,CTGTACATAAAGAGCGTCTT,0,1556469
galEp3,0.125,7,7,CTGGTCTACAGTCCGTCGCA,0,1578777
galEp3,0.125,7,7,CTGGCTACTTCAAAGTAGAA,0,1555652
galEp3,0.125,7,7,CTGGCATGGCACGTATTCTG,0,1560918
galEp3,0.125,7,7,CTGGACTTAATTGGTTGAGC,0,1585258
galEp3,0.125,7,7,CTGCTAAAGATGACTTACCG,0,1595182
galEp3,0.125,7,7,CTGCCGGGAGCTACGCACCA,0,1557922
galEp3,0.125,7,7,CTGAGCGGATAGGCTCTAAG,0,1549637
galEp3,0.125,7,7,CTCTAGTTTGGAAGTTTGTA,0,1592735
galEp3,0.125,7,7,CTCGCATAACTAAGCTCCAT,0,1559456
galEp3,0.125,7,7,CTCGCAACCGTTCCCCGGCT,0,1593512
galEp3,0.125,7,7,CTCCTTAGATACATGTAAGC,0,1578080
galEp3,0.125,7,7,CTCCGTAGACGATGACAACA,0,1579430
galEp3,0.125,7,7,CTCCGCACGCTAGGCCTCGT,0,1573215
galEp3,0.125,7,7,CTCCCGGCTGTGAGTGTGTC,0,1571369
galEp3,0.125,7,7,CTCCATGGTATCCTGTGCGG,0,1556909
galEp3,0.125,7,7,CTCCATGCCGGGACCGTTCC,0,1589492
galEp3,0.125,7,7,CTCCATCCCAAGTCTAGGAC,0,1575606
galEp3,0.125,7,7,CTCCAAGCGTCGTATGTGAT,0,1557446
galEp3,0.125,7,7,CTCATTTTGCTTGCCCCGAA,0,1585927
galEp3,0.125,7,7,CTCAGTGAGAGAAGGAACGA,0,1555078
galEp3,0.125,7,7,CTCAGCAATTACTAGGTGTC,0,1561028
galEp3,0.125,7,7,CTCACTTAAAGTCGTTGCCT,0,1574614
galEp3,0.125,7,7,CTCACATTAGCCATGACGTG,0,1572209
galEp3,0.125,7,7,CTCACAGATGGGTTACTGAT,0,1546800
galEp3,0.125,7,7,CTCAAGGTCCTTTTTGCAGT,0,1573768
galEp3,0.125,7,7,CTATGCCCACGATGCACGAC,0,1567200
galEp3,0.125,7,7,CTATCTAAGATTTACGAGAA,0,1587933
galEp3,0.125,7,7,CTATAGTGAAGCTCTCCACA,0,1548569
galEp3,0.125,7,7,CTATAAGTTGAATGTCTTAC,0,1567892
galEp3,0.125,7,7,CTAGTCACCCTAGAATTGTA,0,1590964
galEp3,0.125,7,7,CTAGAACAGTTCGTGCCTGA,0,1589877
galEp3,0.125,7,7,CTAAGCATTTTTAAGTTCCA,0,1549972
galEp3,0.125,7,7,CTAAATCAATGAGGTCCCGG,0,1589795
galEp3,0.125,7,7,CTAAAGCTGAGGAGAAGAAC,0,1556024
galEp3,0.125,7,7,CGTTTGATACGTTTGCGGGT,0,1575489
galEp3,0.125,7,7,CGTTGGGACAGGACCATCTG,0,1593713
galEp3,0.125,7,7,CGTTGACCTTCCGGGCGGCA,0,1573367
galEp3,0.125,7,7,CGTTCGAACGTAAGCGGACC,0,1575115
galEp3,0.125,7,7,CGTTAAGTGTGTTTTTTGCG,0,1593543
galEp3,0.125,7,7,CGTGTATAACATATCTATCA,0,1570161
galEp3,0.125,7,7,CGTATTACCGTGTAAGGGCT,0,1557603
galEp3,0.125,7,7,CGTAAGCTTCGGGCTCGAAT,0,1564778
galEp3,0.125,7,7,CGGTTGACGGTCGGGGGGGC,0,1559282
galEp3,0.125,7,7,CGGTTAGGTAACTCATCCAG,0,1567576
galEp3,0.125,7,7,CGGTAAACTCGCCTTCTTCT,0,1589666
galEp3,0.125,7,7,CGGGTGGTACGCCGCATTAT,0,1564329
galEp3,0.125,7,7,CGGGGCTCATGCCAGTTTCC,0,1567158
galEp3,0.125,7,7,CGGGCTGCGGGGTAGAAAAT,0,1588078
galEp3,0.125,7,7,CGGGCCACGGGCTCGAACCT,0,1574003
galEp3,0.125,7,7,CGGGAGGGGCGTACTGAACT,0,1581966
galEp3,0.125,7,7,CGGCTTATTCAGGGTTTGAT,0,1556161
galEp3,0.125,7,7,CGGCGCCACTGTTGCTATTT,0,1587654
galEp3,0.125,7,7,CGGCGCACGTTCGTGACCAC,0,1589638
galEp3,0.125,7,7,CGGCACTGAAAGCACTGTTT,0,1590635
galEp3,0.125,7,7,CGGAGCCCCTGGACTCGGGC,0,1588836
galEp3,0.125,7,7,CGGAGAGGACGCCTGTCCAC,0,1577317
galEp3,0.125,7,7,CGGACCAGCGGGTAGATCCA,0,1583903
galEp3,0.125,7,7,CGCTGGGGCGGTTTGGAGGG,0,1594001
galEp3,0.125,7,7,CGCGTGAAGCTTGCGGTCGT,0,1571757
galEp3,0.125,7,7,CGCGGGTGTCGGCATTTCAG,0,1566210
galEp3,0.125,7,7,CGCGGCTATCCGGACGATTC,0,1570451
galEp3,0.125,7,7,CGCGGACGGATCTCGATAAA,0,1591864
galEp3,0.125,7,7,CGCGCATATTGGGTTCGCGG,0,1551947
galEp3,0.125,7,7,CGCGAGTGCACACGACCGTA,0,1579185
galEp3,0.125,7,7,CGCCTCGTTTGCTTTCAGCA,0,1556238
galEp3,0.125,7,7,CGCCCGTTCTCATTTGATTC,0,1591205
galEp3,0.125,7,7,CGCATTGGGTTTGACGAGAG,0,1565770
galEp3,0.125,7,7,CGCATTAACGAGGATGTAGG,0,1592740
galEp3,0.125,7,7,CGCATGATACGGGTTCTGAA,0,1587902
galEp3,0.125,7,7,CGATTATCCTTGACAAATGG,0,1585949
galEp3,0.125,7,7,CGATGATGAGCACAGCCTGA,0,1556296
galEp3,0.125,7,7,CGATCGATAAACCAGAGCCA,0,1588101
galEp3,0.125,7,7,CGAGGGTGGGCGAATTCCAA,0,1562011
galEp3,0.125,7,7,CGAGGGCGTATGCGCTGGGA,0,1576296
galEp3,0.125,7,7,CGAGCAGTCTCAGAGATTTT,0,1585698
galEp3,0.125,7,7,CGACGCAAGCGTTGCTCTGC,0,1588807
galEp3,0.125,7,7,CGACCACGCAGGCGTTATCT,0,1561176
galEp3,0.125,7,7,CGACATCTCGGAGGGTGTAC,0,1564410
galEp3,0.125,7,7,CGACATATAGACATTTTTGT,0,1569908
galEp3,0.125,7,7,CGAATCTAACCAGCCATACG,0,1549045
galEp3,0.125,7,7,CGAAGTGATTGCATTCCTTG,0,1569151
galEp3,0.125,7,7,CGAAGGGTTTAGAGGTATCT,0,1579627
galEp3,0.125,7,7,CGAACTGTCTAATAGCGCTA,0,1576866
galEp3,0.125,7,7,CGAAAACCGAGCGAGTCCCA,0,1571122
galEp3,0.125,7,7,CCTTTTGGCATAGTAGAATA,0,1556135
galEp3,0.125,7,7,CCTTTGGCGTTCATATCAAA,0,1565858
galEp3,0.125,7,7,CCTTATGTTGTAGAACCTCG,0,1562521
galEp3,0.125,7,7,CCTGTCCAAAGGAAAGTGAA,0,1586473
galEp3,0.125,7,7,CCTGGGTCTGACTTAAGTTA,0,1585018
galEp3,0.125,7,7,CCTGGGCTTTCACCCTTTGG,0,1553298
galEp3,0.125,7,7,CCTGATTTAATTCGTCCCTT,0,1572349
galEp3,0.125,7,7,CCTCTGGGATATAAGTAGTA,0,1594939
galEp3,0.125,7,7,CCTCTGCTGGCAGGAAGATA,0,1578449
galEp3,0.125,7,7,CCTCTCCGGGTACACCGCGA,0,1588357
galEp3,0.125,7,7,CCTCCGCCTAGAAGGCAGAA,0,1565530
galEp3,0.125,7,7,CCTATTGGAAATTTGCTCAA,0,1555425
galEp3,0.125,7,7,CCTAGCACACGATCCCCTTA,0,1555510
galEp3,0.125,7,7,CCTACCGGAAAATTTCGAGT,0,1571163
galEp3,0.125,7,7,CCGGTTAATGCATCTCGCAA,0,1549213
galEp3,0.125,7,7,CCGGGTGATCGCAGCCTAAA,0,1551071
galEp3,0.125,7,7,CCGGGGGCCATTGACCCGGA,0,1578193
galEp3,0.125,7,7,CCGGCTCGAAACTGACGATC,0,1573916
galEp3,0.125,7,7,CCGGAGGGACGGGAGACTCT,0,1570612
galEp3,0.125,7,7,CCGCCGATTCGCCGCGGCCG,0,1566369
galEp3,0.125,7,7,CCGCCATCCGACCCTTGATA,0,1591195
galEp3,0.125,7,7,CCGCACCCCGACGACCATTC,0,1578385
galEp3,0.125,7,7,CCGAATGTTTGCCTGGGTTA,0,1550878
galEp3,0.125,7,7,CCCTTTATAGCATGCCGTTG,0,1573765
galEp3,0.125,7,7,CCCGTGGTAGTCCAGTAGGT,0,1563698
galEp3,0.125,7,7,CCCGTCGCCCGCTGTGGAGC,0,1584768
galEp3,0.125,7,7,CCCGGGGTTCTCTGTCAGTT,0,1568651
galEp3,0.125,7,7,CCCGATGTAATCTTGAATAT,0,1579404
galEp3,0.125,7,7,CCCGAATTGGAGTAATAAGA,0,1578521
galEp3,0.125,7,7,CCCCCCGGCTGGTAAACGGT,0,1568873
galEp3,0.125,7,7,CCCACTCTCTACAACCTGTG,0,1593465
galEp3,0.125,7,7,CCCACGACTACAACTCATGT,0,1556515
galEp3,0.125,7,7,CCATGTCATCCGGCACTTTC,0,1554047
galEp3,0.125,7,7,CCATCCATGACGTGGTTACT,0,1552489
galEp3,0.125,7,7,CCATCAAACAGAATCTTGTC,0,1567272
galEp3,0.125,7,7,CCAGTGTTAGGGAAGGAGGG,0,1577229
galEp3,0.125,7,7,CCAGTCCCGACTTGAGAGCG,0,1580602
galEp3,0.125,7,7,CCAATAGATAGAGTTTGCTT,0,1546575
galEp3,0.125,7,7,CCAAGGGGGACCTGTAGGAT,0,1571082
galEp3,0.125,7,7,CCAACCGCGTATGTTAGGGG,0,1565810
galEp3,0.125,7,7,CCAAAGAGTCCCGTTGTATC,0,1579990
galEp3,0.125,7,7,CATTTGAGCGCATAGTAGCG,0,1572707
galEp3,0.125,7,7,CATGTGTTCGTTCGTCAAGG,0,1546448
galEp3,0.125,7,7,CATGCGAGCAAGCAATTCAC,0,1552407
galEp3,0.125,7,7,CATGCCCTAAATTGTTTTTA,0,1556600
galEp3,0.125,7,7,CATGATAATGCTCTCGATGA,0,1594017
galEp3,0.125,7,7,CATCTAGGTGCACGACCTCA,0,1561397
galEp3,0.125,7,7,CATCGAACTCTACTAAGCGG,0,1590278
galEp3,0.125,7,7,CAGTTAATTTGGCCCACGGG,0,1583368
galEp3,0.125,7,7,CAGTTAATGGCATGGGCATT,0,1546610
galEp3,0.125,7,7,CAGTAGCAAAACTGCGTTTA,0,1582452
galEp3,0.125,7,7,CAGTACGCTGAGCTTTACAG,0,1549892
galEp3,0.125,7,7,CAGGTCATATGGGCGTACGG,0,1586131
galEp3,0.125,7,7,CAGCTTAGCTGGTGCTATCG,0,1565624
galEp3,0.125,7,7,CAGCTGTTTGTCCTGTTAGG,0,1552104
galEp3,0.125,7,7,CAGCATTCACTGATAGAAGC,0,1564083
galEp3,0.125,7,7,CAGCATGCCAGATAGTACTG,0,1558182
galEp3,0.125,7,7,CACTATGCGCAGCGGCCAAT,0,1571967
galEp3,0.125,7,7,CACGTTGGTGAAGCCCAGTT,0,1561493
galEp3,0.125,7,7,CACGAGCGCCAAGTGGATGG,0,1553744
galEp3,0.125,7,7,CACCTTGGGCATGCTAGCTA,0,1582351
galEp3,0.125,7,7,CACCTCGCCACGCAGCAAGC,0,1573227
galEp3,0.125,7,7,CACCGGGTGAGTAGTGTACC,0,1569882
galEp3,0.125,7,7,CACATAGGTAGCTAAGCCGG,0,1587926
galEp3,0.125,7,7,CACAAATAATATAAGCTGGA,0,1582783
galEp3,0.125,7,7,CAATCCCTCACGGACCCCAT,0,1566367
galEp3,0.125,7,7,CAAGTTTGCATACATCGAGC,0,1555957
galEp3,0.125,7,7,CAAGTCGCACACTGGTGGCC,0,1549908
galEp3,0.125,7,7,CAAGGTCTGAGGACGCGAAG,0,1553866
galEp3,0.125,7,7,CAAGGCCCTGTGTGAGTGAG,0,1549515
galEp3,0.125,7,7,CAAGGACATAGGCCACGAAA,0,1577776
galEp3,0.125,7,7,CAAGACGTCCGTAAGAAGTA,0,1594005
galEp3,0.125,7,7,CAACGGCTCAGCTCAATGTG,0,1555272
galEp3,0.125,7,7,CAACAGCGTCGTTCCAAAGC,0,1573261
galEp3,0.125,7,7,CAACAAGTGTCCTCTTCTTT,0,1553304
galEp3,0.125,7,7,CAAATTTATAGGGGCAAAAA,0,1570843
galEp3,0.125,7,7,CAAATTGTGGTGACGATATG,0,1563534
galEp3,0.125,7,7,CAAATTGCAGCGAACGATTA,0,1583398
galEp3,0.125,7,7,CAAAATCCGATCTTGCCGCT,0,1593186
galEp3,0.125,7,7,ATTTAGGCACACAATCCCGA,0,1575799
galEp3,0.125,7,7,ATTGTGTCGAAAATCCCTCC,0,1572676
galEp3,0.125,7,7,ATTGCCACTAGGACGTTGCA,0,1564132
galEp3,0.125,7,7,ATTCGCGCGAATTAAGTTAC,0,1571275
galEp3,0.125,7,7,ATTCCTGGTACCGGATCACA,0,1590596
galEp3,0.125,7,7,ATTCACCCGGGTCACAGTAC,0,1590151
galEp3,0.125,7,7,ATTAAAAGATAAAATCATCT,0,1571386
galEp3,0.125,7,7,ATGTGATATTTATTCAGTCT,0,1577224
galEp3,0.125,7,7,ATGTCCGACCTCCTGATAAA,0,1546981
galEp3,0.125,7,7,ATGTATAAAGCCCAGCAGCA,0,1582332
galEp3,0.125,7,7,ATGGTCCAAGTCGTATAACT,0,1581000
galEp3,0.125,7,7,ATGGGTACCTGATTTGTCTT,0,1594586
galEp3,0.125,7,7,ATGGCGGATATCATAATTTT,0,1564088
galEp3,0.125,7,7,ATGGCATGGCCAAGAGAGGT,0,1548559
galEp3,0.125,7,7,ATGAGGCTGGGCTATCTGGC,0,1580580
galEp3,0.125,7,7,ATCTTACTAAACAACATTGT,0,1560807
galEp3,0.125,7,7,ATCGCTACTATAACCCAGTA,0,1572391
galEp3,0.125,7,7,ATCCTCTAAGGCGGCGGGTC,0,1577047
galEp3,0.125,7,7,ATCCGCCTCTAGCCACAATA,0,1586402
galEp3,0.125,7,7,ATCCATGTAGCGATCGGCGT,0,1570566
galEp3,0.125,7,7,ATCCACGCTCCGCTCGTTCG,0,1548923
galEp3,0.125,7,7,ATATCTTAGGACTCCATCAC,0,1560544
galEp3,0.125,7,7,ATAGGGAGGTGAATACTCAA,0,1546508
galEp3,0.125,7,7,ATAGGCGATTAGGTAACTAC,0,1549598
galEp3,0.125,7,7,ATAGGATGGTTTCCCGAAGT,0,1571632
galEp3,0.125,7,7,ATACTTAAACCGTTTCCGAT,0,1567749
galEp3,0.125,7,7,ATACGTAACACTACCGTCCT,0,1585045
galEp3,0.125,7,7,ATACGATTCTCTGGTTAAGC,0,1593035
galEp3,0.125,7,7,ATACCTCTAGCGACTGCCGT,0,1555422
galEp3,0.125,7,7,ATACAGTAACATTGGCTCGT,0,1551286
galEp3,0.125,7,7,ATACAGAGGAAGGGCTATTT,0,1554922
galEp3,0.125,7,7,ATACAGAGACACGAGCAAGG,0,1558950
galEp3,0.125,7,7,ATAATTGTGCTTAATATTGA,0,1561713
galEp3,0.125,7,7,ATAACTGTAATGTATGCATC,0,1581109
galEp3,0.125,7,7,AGTTGCTCGTCGGATTATCC,0,1563346
galEp3,0.125,7,7,AGTTCGGGGTCGAACTATGT,0,1591818
galEp3,0.125,7,7,AGTTAGGCGGCAATTGTGAA,0,1575296
galEp3,0.125,7,7,AGTTACGTCAGTCCGTCTCG,0,1559177
galEp3,0.125,7,7,AGTGTAGATCGTGTCCCAAT,0,1552143
galEp3,0.125,7,7,AGTCCCTTTCTACATCAAGG,0,1574781
galEp3,0.125,7,7,AGTATATTTGCGGCCATGCT,0,1569245
galEp3,0.125,7,7,AGTACCTATGCATTAGGAAG,0,1552305
galEp3,0.125,7,7,AGTAAGTAAACTTTCAGTAA,0,1581242
galEp3,0.125,7,7,AGGTTCCCGTGAATCCTGAA,0,1567575
galEp3,0.125,7,7,AGGTCAGCCGCCGGCATCAG,0,1572355
galEp3,0.125,7,7,AGGTATTGGAGCGTCACTAT,0,1589838
galEp3,0.125,7,7,AGGTAATTATAAAAGGATGT,0,1578408
galEp3,0.125,7,7,AGGGTCACATCCCCCCCGGC,0,1560237
galEp3,0.125,7,7,AGGGGGATTCTTAACGCATT,0,1577980
galEp3,0.125,7,7,AGGCACACAGCCGCATTGAA,0,1575653
galEp3,0.125,7,7,AGGCAAGAGTATCATCGCGG,0,1551837
galEp3,0.125,7,7,AGGAGTACCAACGGGCGCTC,0,1559117
galEp3,0.125,7,7,AGGACGCAGTAAGCTAAGCG,0,1546555
galEp3,0.125,7,7,AGGACAACCGTTCGCAAAGG,0,1590311
galEp3,0.125,7,7,AGGAACCCCCCAAGCAGGGT,0,1563960
galEp3,0.125,7,7,AGCTTGTGATAACTTCCTAC,0,1553144
galEp3,0.125,7,7,AGCGTTCCTAACGTTGCTAT,0,1587426
galEp3,0.125,7,7,AGCGTCAAGGAGCCGGTACA,0,1553076
galEp3,0.125,7,7,AGCGCGCGCGTGATAGGCGA,0,1548246
galEp3,0.125,7,7,AGCGCCCGGGATCATTTGCG,0,1589061
galEp3,0.125,7,7,AGCCTTAGCAAGTTTATAAC,0,1553589
galEp3,0.125,7,7,AGCCCAGAAGCGATTACTGG,0,1556460
galEp3,0.125,7,7,AGCCATCACCTCGGCGGACA,0,1575109
galEp3,0.125,7,7,AGCATGCCGATGGTGATGTG,0,1572930
galEp3,0.125,7,7,AGCACTCTTAGCTAATAAGA,0,1569880
galEp3,0.125,7,7,AGCACCTCTCTGCAATCCGG,0,1553161
galEp3,0.125,7,7,AGATTCACTACGGTAAGCTT,0,1565511
galEp3,0.125,7,7,AGACTACTCCCACTATCGGT,0,1577367
galEp3,0.125,7,7,AGACCGGCTAACAGGTACCA,0,1567534
galEp3,0.125,7,7,AGACAGAGCGCGTCCTAGGG,0,1555186
galEp3,0.125,7,7,AGAATGCCTCAAGGTGCGGA,0,1553980
galEp3,0.125,7,7,AGAATCCTGAATCGTAATGG,0,1580699
galEp3,0.125,7,7,AGAATAAAGTGCCGGAGGAA,0,1579053
galEp3,0.125,7,7,AGAAGTGATCGTAGGACTGT,0,1586616
galEp3,0.125,7,7,AGAAGGATATGAGTTTCTAG,0,1560770
galEp3,0.125,7,7,AGAACTTGAATCGGGAACAC,0,1558343
galEp3,0.125,7,7,AGAACTGACGGCTTGGGAGA,0,1579555
galEp3,0.125,7,7,ACTTGTCAACGAGCTATCTG,0,1550668
galEp3,0.125,7,7,ACTTCACAGTGGGAAACCCT,0,1566181
galEp3,0.125,7,7,ACTGCAGTGGGGTGTTGATG,0,1553631
galEp3,0.125,7,7,ACTCAAAATTTTTCGGATCA,0,1565460
galEp3,0.125,7,7,ACTATTGGACATGGCTAGGC,0,1568306
galEp3,0.125,7,7,ACTAGGTATTTCCCAGAAGA,0,1571123
galEp3,0.125,7,7,ACTAGAGCAAACGGTGCTAC,0,1587298
galEp3,0.125,7,7,ACTACCAGCTTTCCGAGGGT,0,1583109
galEp3,0.125,7,7,ACGTTACGGCCTCGGCACAG,0,1587678
galEp3,0.125,7,7,ACGTTAAGGTTTCATGAAAT,0,1567129
galEp3,0.125,7,7,ACGTACCTGGTACGTGATTT,0,1576319
galEp3,0.125,7,7,ACGGCGACGCAGCTGGTACG,0,1575763
galEp3,0.125,7,7,ACGGAGTGCTTCTGGAGGGA,0,1586313
galEp3,0.125,7,7,ACGGAATCATTAGCGTAGAT,0,1572529
galEp3,0.125,7,7,ACGCTTAGTAAGAAGAGTTC,0,1576224
galEp3,0.125,7,7,ACGCTATGAACCCCGGGGGG,0,1595014
galEp3,0.125,7,7,ACGCGACTCGTGATGACCGA,0,1567391
galEp3,0.125,7,7,ACGAGCTACACCCTATAGTA,0,1591296
galEp3,0.125,7,7,ACGAGAGGGAGGCTGCTGAT,0,1560564
galEp3,0.125,7,7,ACGACTTGGCTTTACGTACA,0,1581852
galEp3,0.125,7,7,ACGAATGCTCACATGTCTAC,0,1563170
galEp3,0.125,7,7,ACGAATAGAACGGACGCGAT,0,1590581
galEp3,0.125,7,7,ACGAAATTTGCCCGATTCAC,0,1562167
galEp3,0.125,7,7,ACCCGTGAGAGACGGAGATT,0,1562980
galEp3,0.125,7,7,ACCCCGAAATTGGCTCGTTG,0,1590793
galEp3,0.125,7,7,ACCCACTCGCTGTCAGGGCG,0,1587901
galEp3,0.125,7,7,ACCATTCCCATCAACGGAAA,0,1584424
galEp3,0.125,7,7,ACCATGAGCGCTCGATGCAT,0,1555757
galEp3,0.125,7,7,ACCATCGCCATCATCCTTAG,0,1560813
galEp3,0.125,7,7,ACCAACACGTAGGTTTTTGC,0,1574121
galEp3,0.125,7,7,ACCAAATAGGTTGATGCTAG,0,1565958
galEp3,0.125,7,7,ACATCTGCTCAACTTACGTG,0,1563582
galEp3,0.125,7,7,ACATCACACTATTATAACAA,0,1573874
galEp3,0.125,7,7,ACAGCTTCGCGCCACTAATG,0,1549088
galEp3,0.125,7,7,ACAGCCCGGTCTAGCTCTGG,0,1572456
galEp3,0.125,7,7,ACACTAGGTAACGAATCCGA,0,1577517
galEp3,0.125,7,7,ACACGTGTTCAACGTCGGTT,0,1553488
galEp3,0.125,7,7,ACACCCCATGGGCATCGATG,0,1571913
galEp3,0.125,7,7,ACAAGTGACTTCGTCAAAAC,0,1571844
galEp3,0.125,7,7,ACAAGTCGAAGCTCCTACCA,0,1548267
galEp3,0.125,7,7,AATTTCAAATTGAACGCGAC,0,1577978
galEp3,0.125,7,7,AATGTTACTCCCCTTCATGC,0,1592238
galEp3,0.125,7,7,AATGTATGAACTCTGAATAA,0,1576891
galEp3,0.125,7,7,AATCTTTTGAAAAAGTTTAT,0,1589243
galEp3,0.125,7,7,AATCTCGGTCGTCTCATTCC,0,1551962
galEp3,0.125,7,7,AATCGTCCCTCAGTCAGCCA,0,1567304
galEp3,0.125,7,7,AATCCTCATAGGCTGGTTCT,0,1560473
galEp3,0.125,7,7,AATCATCGGTTATTATCAAA,0,1581047
galEp3,0.125,7,7,AATATGTGTATGTGGTCCAA,0,1572523
galEp3,0.125,7,7,AATAGTTGAGGGAACGTAAT,0,1585916
galEp3,0.125,7,7,AATAGGCCGATCTATGCACG,0,1568021
galEp3,0.125,7,7,AATAACAGACGATAAACTGA,0,1578936
galEp3,0.125,7,7,AAGTGTGACGAGTATAAGGA,0,1575484
galEp3,0.125,7,7,AAGTGGTGGCTAGGTAGAGG,0,1568487
galEp3,0.125,7,7,AAGTGGTCGGCTTGACGTTA,0,1576972
galEp3,0.125,7,7,AAGTCACGCACGGTACTTAG,0,1580032
galEp3,0.125,7,7,AAGCTACGTCCACACAACTA,0,1577641
galEp3,0.125,7,7,AAGCGCGAGCTCGCACATTA,0,1573442
galEp3,0.125,7,7,AAGCCAGCAGTGGTAGGTAA,0,1570888
galEp3,0.125,7,7,AAGCACGTCGAACGTGGCTG,0,1585552
galEp3,0.125,7,7,AAGACGGGCGCTATTTGGTG,0,1567436
galEp3,0.125,7,7,AAGAATAGTTGCTAGTTCCT,0,1573097
galEp3,0.125,7,7,AACTGCTTCGTTCCAGACAG,0,1594181
galEp3,0.125,7,7,AACTGACTAAGCTCCGAGGC,0,1576969
galEp3,0.125,7,7,AACTCATGCCAACAGCCAGT,0,1551598
galEp3,0.125,7,7,AACTATATATGATGCTCCAT,0,1556613
galEp3,0.125,7,7,AACGGTTTGAGCCGGAATGG,0,1588845
galEp3,0.125,7,7,AACGGGGGGTGTCTAGGCTA,0,1556717
galEp3,0.125,7,7,AACGGGCGTGACAATTCGTT,0,1560829
galEp3,0.125,7,7,AACGATATCCCGGGCTTGTC,0,1554891
galEp3,0.125,7,7,AACCGTTTAAGTATTTCCAA,0,1560215
galEp3,0.125,7,7,AACAAACCGCACCGTAAGTA,0,1580021
galEp3,0.125,7,7,AAATTCGGGTAACGCAGGGT,0,1590601
galEp3,0.125,7,7,AAATCTAGTGTTAAACCAAT,0,1568115
galEp3,0.125,7,7,AAAGTTTGTTCTCAGGCTGC,0,1550922
galEp3,0.125,7,7,AAAGTACGGGTTGGGTACGG,0,1546935
galEp3,0.125,7,7,AAAGGCGATGTTTCGTTGAC,0,1571012
galEp3,0.125,7,7,AAAGCATTCAGGAGAAGCTG,0,1548230
galEp3,0.125,7,7,AAACTTGCAGAACAGGTAGG,0,1568017
galEp3,0.125,7,7,AAACTCTTCTCTTGAGAGTT,0,1555399
galEp3,0.125,7,7,AAACTCGCTTCCAAATTCAC,0,1592959
galEp3,0.125,7,7,AAACGTTTTGTTTTCCGTTT,0,1556894
galEp3,0.125,7,7,AAACGTAGTACACCATTTTC,0,1584455
galEp3,0.125,7,7,AAACGGCAGTCTAAAAGGAC,0,1548651
galEp3,0.125,7,7,AAACATTCATCGTCCGCTGG,0,1556874
galEp3,0.125,7,7,AAAATCCGGACGGTTCGACA,0,1554427
galEp3,0.14285714285714285,6,6,TTTTTGCTCTAACGCTAAAA,0,1559633
galEp3,0.14285714285714285,6,6,TTTTTAGAATTGCTCACCTA,0,1564245
galEp3,0.14285714285714285,6,6,TTTTCGGTATCTATCATTCC,0,1582652
galEp3,0.14285714285714285,6,6,TTTTCGCCGGTCCAGATGGA,0,1564456
galEp3,0.14285714285714285,6,6,TTTTAAGGACAGCACGGCGT,0,1574759
galEp3,0.14285714285714285,6,6,TTTGGGTTTACTTCAGCGAC,0,1595094
galEp3,0.14285714285714285,6,6,TTTGGGTAGGCAGCGCCCGT,0,1560288
galEp3,0.14285714285714285,6,6,TTTGGATCTCTATCTTAAAT,0,1552154
galEp3,0.14285714285714285,6,6,TTTCTGCCTGGCTGGGCGAG,0,1558131
galEp3,0.14285714285714285,6,6,TTTCGCGGACTGCATAACCC,0,1577042
galEp3,0.14285714285714285,6,6,TTTCAAAGTGACGTAATGAT,0,1582342
galEp3,0.14285714285714285,6,6,TTTAGTTAATTGAGTTTATT,0,1553291
galEp3,0.14285714285714285,6,6,TTTACGTGGTCCCCCAAATA,0,1572760
galEp3,0.14285714285714285,6,6,TTTACCCGTATCGGGGGGGA,0,1588727
galEp3,0.14285714285714285,6,6,TTGTTTGGTTACATAGCGGT,0,1584154
galEp3,0.14285714285714285,6,6,TTGTCTCATGGCATTGAACA,0,1574764
galEp3,0.14285714285714285,6,6,TTGTATGACATCCGTGAACT,0,1573114
galEp3,0.14285714285714285,6,6,TTGGTTACGCCTACATGCTT,0,1562287
galEp3,0.14285714285714285,6,6,TTGGGTCTTAGCACAACTAG,0,1559916
galEp3,0.14285714285714285,6,6,TTGGGGAACTGTCCTCATTT,0,1547009
galEp3,0.14285714285714285,6,6,TTGGCGGCGAATACTCGCCA,0,1566867
galEp3,0.14285714285714285,6,6,TTGCTTCGACACATTGACAG,0,1583406
galEp3,0.14285714285714285,6,6,TTGCGAGCCAACGGGAAAAA,0,1572624
galEp3,0.14285714285714285,6,6,TTGCATCCTGTGTACTTAGT,0,1584596
galEp3,0.14285714285714285,6,6,TTGAGTCATGTGCGAATGAA,0,1591803
galEp3,0.14285714285714285,6,6,TTGACAACGTAAGGGTACAA,0,1561665
galEp3,0.14285714285714285,6,6,TTCTTCAACGGCGGGCTGGG,0,1590473
galEp3,0.14285714285714285,6,6,TTCTATGTGAGTTTGGAATT,0,1592600
galEp3,0.14285714285714285,6,6,TTCGGCGTTCCCAACCCCGG,0,1557688
galEp3,0.14285714285714285,6,6,TTCGCCTTGGTGGACCAGCT,0,1581821
galEp3,0.14285714285714285,6,6,TTCGATGGCCGTTACCTCCT,0,1570568
galEp3,0.14285714285714285,6,6,TTCGAAATGTGGGCCAGCAT,0,1586083
galEp3,0.14285714285714285,6,6,TTCATGGCAGGAATAGATAC,0,1561107
galEp3,0.14285714285714285,6,6,TTCAGACCCGATCGAACCCC,0,1548827
galEp3,0.14285714285714285,6,6,TTCACTCGCCTTGTTAGGTA,0,1586172
galEp3,0.14285714285714285,6,6,TTCACAAAGTTCTCTCAGCT,0,1583193
galEp3,0.14285714285714285,6,6,TTCAATACTTCGTGCCGACT,0,1554807
galEp3,0.14285714285714285,6,6,TTCAAGACCAGGCTATTGGT,0,1548868
galEp3,0.14285714285714285,6,6,TTCAAAAGGACCCGTTATGT,0,1565124
galEp3,0.14285714285714285,6,6,TTATGTCGGCTTTTAAGTTA,0,1581770
galEp3,0.14285714285714285,6,6,TTAGTTCTCGTATGGTTCCT,0,1555378
galEp3,0.14285714285714285,6,6,TTAGGACGTGTCGTTCTCAG,0,1581608
galEp3,0.14285714285714285,6,6,TTAGCACACGACCCACTTAG,0,1560193
galEp3,0.14285714285714285,6,6,TTACCGTTGCAACTTAGTCA,0,1560728
galEp3,0.14285714285714285,6,6,TTACATTGGGCAGATTCTAC,0,1548616
galEp3,0.14285714285714285,6,6,TTAATACGCGATGTGGACAG,0,1570338
galEp3,0.14285714285714285,6,6,TTAACTGAGGAATGTAGCAC,0,1593068
galEp3,0.14285714285714285,6,6,TTAAAACATAGGGGGCTCGC,0,1572916
galEp3,0.14285714285714285,6,6,TGTTAACAATTACCGGCGGT,0,1567529
galEp3,0.14285714285714285,6,6,TGTGTAAGATGTGCATGGTA,0,1564688
galEp3,0.14285714285714285,6,6,TGTGGTTAGAGCCGTTGTTT,0,1567552
galEp3,0.14285714285714285,6,6,TGTCTCGTGATCGCCGCCTA,0,1555593
galEp3,0.14285714285714285,6,6,TGTCGTATAGGCATGCGAAT,0,1582056
galEp3,0.14285714285714285,6,6,TGTCGCGTTATTATATTGTG,0,1575247
galEp3,0.14285714285714285,6,6,TGTCGAGAATGAGAGGGTAC,0,1579701
galEp3,0.14285714285714285,6,6,TGTCAAGCCGAGTTCTCGCT,0,1581673
galEp3,0.14285714285714285,6,6,TGTATTCATCGGGACGGATA,0,1561479
galEp3,0.14285714285714285,6,6,TGTATCCCTGACAAGGGCTA,0,1560108
galEp3,0.14285714285714285,6,6,TGTAGTATGCGCAGGGAAGT,0,1550036
galEp3,0.14285714285714285,6,6,TGTACCGTCGGATGAGAAGG,0,1591453
galEp3,0.14285714285714285,6,6,TGGTTTAAGTCACGACTTGT,0,1552003
galEp3,0.14285714285714285,6,6,TGGTGTACCCTTTTTTGTTC,0,1581421
galEp3,0.14285714285714285,6,6,TGGTGAGTTCGAAGTGTTGT,0,1574985
galEp3,0.14285714285714285,6,6,TGGGTTTCGCAATGCACGCC,0,1574043
galEp3,0.14285714285714285,6,6,TGGGTGCTCACTGGGCGGCG,0,1558020
galEp3,0.14285714285714285,6,6,TGGGTCATGTAAAACGTACG,0,1548731
galEp3,0.14285714285714285,6,6,TGGGCTTCCATGTTTGCGTT,0,1593360
galEp3,0.14285714285714285,6,6,TGGGATTATCCGTTCCTCAT,0,1554543
galEp3,0.14285714285714285,6,6,TGGGACTCAGGACGATATCA,0,1568713
galEp3,0.14285714285714285,6,6,TGGGAAGGCAATGGCAAAGT,0,1593059
galEp3,0.14285714285714285,6,6,TGGGAAAACTTGTTGCTACA,0,1586664
galEp3,0.14285714285714285,6,6,TGGCGCCTCAACGGCAATGA,0,1575179
galEp3,0.14285714285714285,6,6,TGGCCGGTATTATTGAGCAT,0,1551974
galEp3,0.14285714285714285,6,6,TGGCCCCGGCTCCCCCTTTT,0,1549036
galEp3,0.14285714285714285,6,6,TGGCATAACAACAGGCTTGT,0,1556890
galEp3,0.14285714285714285,6,6,TGGATAGGCACTTACGGCAA,0,1547105
galEp3,0.14285714285714285,6,6,TGCTTACGCGTATAACTATA,0,1588850
galEp3,0.14285714285714285,6,6,TGCTCATACGAACCCTACAT,0,1564898
galEp3,0.14285714285714285,6,6,TGCTCAGAGGACATTAAGGA,0,1592085
galEp3,0.14285714285714285,6,6,TGCTACATACGTTCAGTACC,0,1590873
galEp3,0.14285714285714285,6,6,TGCGGGTGACACTTCGAGAT,0,1575555
galEp3,0.14285714285714285,6,6,TGCGCGAGGCGGTAGGCTTC,0,1593180
galEp3,0.14285714285714285,6,6,TGCGATATGGGAGACGCTGC,0,1554166
galEp3,0.14285714285714285,6,6,TGCCTCGATGATCCACTGCG,0,1577353
galEp3,0.14285714285714285,6,6,TGCCTACCCGCATCATTGTG,0,1594737
galEp3,0.14285714285714285,6,6,TGCCAGGATCAACTCTGGGT,0,1552839
galEp3,0.14285714285714285,6,6,TGCAAGAGTAGTCTCAAAAA,0,1548755
galEp3,0.14285714285714285,6,6,TGATCTTTCTGTGTCTAAGA,0,1591707
galEp3,0.14285714285714285,6,6,TGAGTGCACTCGTCCTACAC,0,1570712
galEp3,0.14285714285714285,6,6,TGACTTTGGCAGGATGGCCC,0,1571081
galEp3,0.14285714285714285,6,6,TGACGTCCCGGGCACGGTCG,0,1584201
galEp3,0.14285714285714285,6,6,TGACGTATTCTTTGAGGGTG,0,1557731
galEp3,0.14285714285714285,6,6,TGACCAACGGGTGTGAATTA,0,1549840
galEp3,0.14285714285714285,6,6,TGAATCCAACGTGCTGGCAT,0,1568920
galEp3,0.14285714285714285,6,6,TCTGATTAAGAAGCCAGAGT,0,1546969
galEp3,0.14285714285714285,6,6,TCTATCAAGACCTATGAAAA,0,1579245
galEp3,0.14285714285714285,6,6,TCTACGATTTTCCCGGACAT,0,1556604
galEp3,0.14285714285714285,6,6,TCTAAGCACATTTAGAGCTA,0,1585012
galEp3,0.14285714285714285,6,6,TCGTGTCACGTATTACAAGG,0,1577391
galEp3,0.14285714285714285,6,6,TCGTATTTCGCCGAGATGCC,0,1546552
galEp3,0.14285714285714285,6,6,TCGTATTCAGATCGACGATA,0,1567630
galEp3,0.14285714285714285,6,6,TCGTACAGCGCTCCGGCCTT,0,1560897
galEp3,0.14285714285714285,6,6,TCGGTGCGGGAAATTCCTTT,0,1589367
galEp3,0.14285714285714285,6,6,TCGGGAGTTCCTATTGCTGC,0,1558949
galEp3,0.14285714285714285,6,6,TCGGATAGGCTGTTGACACA,0,1576595
galEp3,0.14285714285714285,6,6,TCGGACTTGACCGCGCACCG,0,1573019
galEp3,0.14285714285714285,6,6,TCGCTTTGTAATCTCGTGGT,0,1594060
galEp3,0.14285714285714285,6,6,TCGCGTCGCCACCTGACACT,0,1556910
galEp3,0.14285714285714285,6,6,TCGCCGTATCGGATCGGAAC,0,1569888
galEp3,0.14285714285714285,6,6,TCGCCGCATGTATGTGCCGA,0,1560308
galEp3,0.14285714285714285,6,6,TCGCATCTGTCCGTACTGGA,0,1565714
galEp3,0.14285714285714285,6,6,TCGCAGCGTGTGTCGCACCA,0,1579567
galEp3,0.14285714285714285,6,6,TCGAGGGTTTACCCATTGTA,0,1569737
galEp3,0.14285714285714285,6,6,TCGACCAGAGACGGCTGAAT,0,1585114
galEp3,0.14285714285714285,6,6,TCGAAGACACTCGACGGCAA,0,1572598
galEp3,0.14285714285714285,6,6,TCGAAACATGGTCTCAGATC,0,1572498
galEp3,0.14285714285714285,6,6,TCGAAAAAGGTGAGAATTAA,0,1591509
galEp3,0.14285714285714285,6,6,TCCTTGGCAAACTCGAAATA,0,1583687
galEp3,0.14285714285714285,6,6,TCCTTCACTCACGGTCAGTG,0,1557881
galEp3,0.14285714285714285,6,6,TCCTGGGGGGGTTGGACTCG,0,1555174
galEp3,0.14285714285714285,6,6,TCCTATATCCGTTCCATGCA,0,1550535
galEp3,0.14285714285714285,6,6,TCCCTTCCAGGTCTGTACCT,0,1578720
galEp3,0.14285714285714285,6,6,TCCCGATCTGTACCGATGCT,0,1576024
galEp3,0.14285714285714285,6,6,TCCCACCGACCGGGAACCCT,0,1592242
galEp3,0.14285714285714285,6,6,TCCATTTCCGTGGCCGGTCA,0,1581324
galEp3,0.14285714285714285,6,6,TCCAGTAGCAGGCCCTTAGG,0,1570458
galEp3,0.14285714285714285,6,6,TCCAAATCCGGGTCCAAGGG,0,1593469
galEp3,0.14285714285714285,6,6,TCATTGTGGAACCTATATAG,0,1573770
galEp3,0.14285714285714285,6,6,TCATGGCAAGATGAGGAGTG,0,1550918
galEp3,0.14285714285714285,6,6,TCATGAAAGTATATAGTTAG,0,1565862
galEp3,0.14285714285714285,6,6,TCATCTGTCCCACTTGGATC,0,1589139
galEp3,0.14285714285714285,6,6,TCATCTGCCGTGCTCGAGAG,0,1589748
galEp3,0.14285714285714285,6,6,TCATCCTTTTAATGCGCTAA,0,1583185
galEp3,0.14285714285714285,6,6,TCAGATCAAGTTGCCTGTAC,0,1552394
galEp3,0.14285714285714285,6,6,TCACTCTTGCTGAATCACAC,0,1553713
galEp3,0.14285714285714285,6,6,TCACGTTGGAATCTCACCCT,0,1594990
galEp3,0.14285714285714285,6,6,TCACACCCCAAGAGTCGGTG,0,1570586
galEp3,0.14285714285714285,6,6,TCAATTAACTGATGCTACAC,0,1572925
galEp3,0.14285714285714285,6,6,TCAATGTGGGAGGTGTGTGT,0,1551490
galEp3,0.14285714285714285,6,6,TCAAGGCCGCGGAAAAAGTG,0,1552275
galEp3,0.14285714285714285,6,6,TCAAAGCTCTCCCAACAGTA,0,1594171
galEp3,0.14285714285714285,6,6,TATTGGTCTGGTTCTGTAAA,0,1573185
galEp3,0.14285714285714285,6,6,TATTGCCTACAACTGATGCT,0,1591279
galEp3,0.14285714285714285,6,6,TATTCTTAAACGTGGGTGAG,0,1563868
galEp3,0.14285714285714285,6,6,TATGTTAATTTACTGATTTG,0,1580616
galEp3,0.14285714285714285,6,6,TATGGGGAGAACCCCCCCAA,0,1569956
galEp3,0.14285714285714285,6,6,TATGGGAGGGGGTTCGATCG,0,1565713
galEp3,0.14285714285714285,6,6,TATGAGAAGGCTCTCGCTCA,0,1557170
galEp3,0.14285714285714285,6,6,TATCCCCATTTAGGCGTGAC,0,1578578
galEp3,0.14285714285714285,6,6,TATATTGAGAGATGGCAGTC,0,1560128
galEp3,0.14285714285714285,6,6,TATAGGGGGCTCGCTGTCTA,0,1592574
galEp3,0.14285714285714285,6,6,TATACTGAATTTATGACTTA,0,1563610
galEp3,0.14285714285714285,6,6,TATACTCTTCATGTTAGGCA,0,1548123
galEp3,0.14285714285714285,6,6,TATAAGAGTGCTCGCGGCTG,0,1568981
galEp3,0.14285714285714285,6,6,TAGGTTAATTGGAATCAACG,0,1590438
galEp3,0.14285714285714285,6,6,TAGGTGGATCCCAGGGTAGG,0,1567270
galEp3,0.14285714285714285,6,6,TAGGGTGTGACGAACCAGTC,0,1554975
galEp3,0.14285714285714285,6,6,TAGGCGGGGGAGCACCCCAT,0,1563993
galEp3,0.14285714285714285,6,6,TAGGAAACTTAGAGACGGTT,0,1552936
galEp3,0.14285714285714285,6,6,TAGCGGGTCAGATCTCAGTG,0,1570353
galEp3,0.14285714285714285,6,6,TAGCGAGCATCGCAGCGCGA,0,1591776
galEp3,0.14285714285714285,6,6,TAGCCCGCGGAATTTTACGT,0,1573820
galEp3,0.14285714285714285,6,6,TAGCATTGCCCTTCCACCAG,0,1581604
galEp3,0.14285714285714285,6,6,TAGAAGGCGTATACCCGACC,0,1564574
galEp3,0.14285714285714285,6,6,TAGAAGCAACGACTCATTCT,0,1583376
galEp3,0.14285714285714285,6,6,TAGAAAGCAGCAGGCTCAGG,0,1585232
galEp3,0.14285714285714285,6,6,TACTTCGATCGCAGCAGGTA,0,1552601
galEp3,0.14285714285714285,6,6,TACTGCCGGTCAATCCACAT,0,1571274
galEp3,0.14285714285714285,6,6,TACTACGTTCTTTGAACATA,0,1549804
galEp3,0.14285714285714285,6,6,TACTACACTTCAATGATATA,0,1583763
galEp3,0.14285714285714285,6,6,TACGTGCATGAAGCCACTGA,0,1570063
galEp3,0.14285714285714285,6,6,TACGGCTATCCTTGCAGGCC,0,1556472
galEp3,0.14285714285714285,6,6,TACGCCGGTTAATTCAAAAG,0,1593003
galEp3,0.14285714285714285,6,6,TACGCATATGCTATTGGTTT,0,1591631
galEp3,0.14285714285714285,6,6,TACCTTACCCCGAGACGATG,0,1558872
galEp3,0.14285714285714285,6,6,TACCAAGCTGGCTCATGAGA,0,1577081
galEp3,0.14285714285714285,6,6,TAATTAGGATGAACAAGCTT,0,1579648
galEp3,0.14285714285714285,6,6,TAATAGGTACGTTGGGCGAC,0,1561593
galEp3,0.14285714285714285,6,6,TAATACATGTGGCTATTCGC,0,1559441
galEp3,0.14285714285714285,6,6,TAAGGGGCAGCAATGTTATC,0,1573606
galEp3,0.14285714285714285,6,6,TAAGAAAGTTATTCATATAA,0,1553919
galEp3,0.14285714285714285,6,6,TAACGTAATACCCACACACA,0,1548255
galEp3,0.14285714285714285,6,6,TAACCATTCAGCAGTGCCTC,0,1561270
galEp3,0.14285714285714285,6,6,TAAATATCCTGCGTAGCGTA,0,1576704
galEp3,0.14285714285714285,6,6,TAAACGTGTTCTGACATCGC,0,1559491
galEp3,0.14285714285714285,6,6,GTTTGGGCGAGGCGTCATAG,0,1571843
galEp3,0.14285714285714285,6,6,GTTTGCTGAGACGACTAGAC,0,1563725
galEp3,0.14285714285714285,6,6,GTTTGCCGTCCGCCGTTAGC,0,1570463
galEp3,0.14285714285714285,6,6,GTTTACTCCAATGCAAATGG,0,1574012
galEp3,0.14285714285714285,6,6,GTTGCTCCTAATTCGAACAT,0,1589063
galEp3,0.14285714285714285,6,6,GTTGAGCGGTAACTAGACTC,0,1583541
galEp3,0.14285714285714285,6,6,GTTGACGGTCTCACAGTTCG,0,1581858
galEp3,0.14285714285714285,6,6,GTTCGTCTCTTCCACTTAGT,0,1568863
galEp3,0.14285714285714285,6,6,GTTCGGGGCTCATTAAGCAT,0,1569853
galEp3,0.14285714285714285,6,6,GTTCCCATATAAGAAGACGT,0,1580482
galEp3,0.14285714285714285,6,6,GTTCACTGCACACGCGAATG,0,1558945
galEp3,0.14285714285714285,6,6,GTTCAAGTCTATAGGGTGGC,0,1557890
galEp3,0.14285714285714285,6,6,GTTAGTGAGTCGAATTACGT,0,1569931
galEp3,0.14285714285714285,6,6,GTTACCGGATTGACAGAAAA,0,1579428
galEp3,0.14285714285714285,6,6,GTGTTTTGGCGGACAGTGTC,0,1566202
galEp3,0.14285714285714285,6,6,GTGTAACCCGCCGCACGCGT,0,1585467
galEp3,0.14285714285714285,6,6,GTGGTTTGAAAAGAAGCGCA,0,1573915
galEp3,0.14285714285714285,6,6,GTGGGGCGGCTGCTCAATCC,0,1572061
galEp3,0.14285714285714285,6,6,GTGGCGTTATACTAGACGCC,0,1563128
galEp3,0.14285714285714285,6,6,GTGCCATGCGGAGCAGCCGT,0,1563178
galEp3,0.14285714285714285,6,6,GTGCACGTGGATCGCTACGC,0,1572070
galEp3,0.14285714285714285,6,6,GTGATGTAAGGTGGTGGGAT,0,1564631
galEp3,0.14285714285714285,6,6,GTGAGCATCCAGGGACACTT,0,1561227
galEp3,0.14285714285714285,6,6,GTCTTAGTCCTCCTAGGTAC,0,1583786
galEp3,0.14285714285714285,6,6,GTCTGTTGCACCGAGCGGCT,0,1551108
galEp3,0.14285714285714285,6,6,GTCTGGCCAAGCCTGCTGCT,0,1592008
galEp3,0.14285714285714285,6,6,GTCTGCATGCCACGGTGTCC,0,1570520
galEp3,0.14285714285714285,6,6,GTCTGAACCGTAGTTATTGG,0,1575140
galEp3,0.14285714285714285,6,6,GTCTCTGTCCTTGTCAAAAT,0,1582253
galEp3,0.14285714285714285,6,6,GTCTCTCCCAATGCACGTTC,0,1577129
galEp3,0.14285714285714285,6,6,GTCGGGGGAGATCTCGCGTA,0,1571024
galEp3,0.14285714285714285,6,6,GTCGGCGATTGATCGCGGAC,0,1566429
galEp3,0.14285714285714285,6,6,GTCCTACAAGGGTAGGACTT,0,1594482
galEp3,0.14285714285714285,6,6,GTCCGCCAGGACGGTACTTC,0,1582279
galEp3,0.14285714285714285,6,6,GTCCCCTGCACGCGGTGGGA,0,1574912
galEp3,0.14285714285714285,6,6,GTCATGTTCAAACCGGGGCG,0,1557853
galEp3,0.14285714285714285,6,6,GTCAGCTCGGACTGTCATGA,0,1556758
galEp3,0.14285714285714285,6,6,GTCAGCGAGTGTAGGACGCG,0,1557385
galEp3,0.14285714285714285,6,6,GTCACTCCGGTACTCTTGGT,0,1566843
galEp3,0.14285714285714285,6,6,GTATTATTGGATTTGAGCTT,0,1594130
galEp3,0.14285714285714285,6,6,GTATGGGGTTCGCACTCGTA,0,1547710
galEp3,0.14285714285714285,6,6,GTATGGAGACCTGATCCATT,0,1575981
galEp3,0.14285714285714285,6,6,GTATCACCGAGTGTTCATAG,0,1556607
galEp3,0.14285714285714285,6,6,GTATAAGCTTTGCATGCACA,0,1590146
galEp3,0.14285714285714285,6,6,GTATAAAAATGACGTTCAGC,0,1562049
galEp3,0.14285714285714285,6,6,GTAGTTTCATTTGCCGTAGG,0,1591045
galEp3,0.14285714285714285,6,6,GTAGTTCAAAGGACTTAAAG,0,1556631
galEp3,0.14285714285714285,6,6,GTACGCAATACTTGCGTCCT,0,1588610
galEp3,0.14285714285714285,6,6,GTACGAGTTTCTTAGACGCA,0,1550439
galEp3,0.14285714285714285,6,6,GTAATACGCTGGGCTTGGTT,0,1581954
galEp3,0.14285714285714285,6,6,GTAACTTTGTCCGTTTAGTG,0,1587255
galEp3,0.14285714285714285,6,6,GGTTTACAGCCGACGGGGAC,0,1548893
galEp3,0.14285714285714285,6,6,GGTTGGCTTGCGATTTCGGG,0,1569935
galEp3,0.14285714285714285,6,6,GGTTGCACCAATAACCGTTC,0,1582562
galEp3,0.14285714285714285,6,6,GGTTCGATGGTTGAGCGTAG,0,1588108
galEp3,0.14285714285714285,6,6,GGTTAGCGTTACTCATGAAA,0,1570578
galEp3,0.14285714285714285,6,6,GGTTACATGTTAATTCGCCA,0,1572231
galEp3,0.14285714285714285,6,6,GGTGCTGTTATGAGAGGGTG,0,1569784
galEp3,0.14285714285714285,6,6,GGTCTAATCCCCCGGCTGGT,0,1583897
galEp3,0.14285714285714285,6,6,GGTCGAGAGGGATAACGAAA,0,1592997
galEp3,0.14285714285714285,6,6,GGTCCGTGCGCCTAATCTTT,0,1548256
galEp3,0.14285714285714285,6,6,GGTCCCTTTCCCTGGCAGCC,0,1580884
galEp3,0.14285714285714285,6,6,GGTCAGATCTACGTCGTGTG,0,1561635
galEp3,0.14285714285714285,6,6,GGTCAGACCGCATTGGCGGC,0,1594525
galEp3,0.14285714285714285,6,6,GGTACGACCCATGTCGTAAG,0,1568132
galEp3,0.14285714285714285,6,6,GGTAATATCTGCCCAATCCA,0,1579758
galEp3,0.14285714285714285,6,6,GGTAACGAACCAAATTAAAA,0,1577344
galEp3,0.14285714285714285,6,6,GGGTTCCAGGAACGGTTCTT,0,1584052
galEp3,0.14285714285714285,6,6,GGGTGGCCTGACACCCCACT,0,1574561
galEp3,0.14285714285714285,6,6,GGGTATGCCAGGCAGATGCA,0,1554257
galEp3,0.14285714285714285,6,6,GGGGGATGCGAGGAGACGGA,0,1568205
galEp3,0.14285714285714285,6,6,GGGGGATCAGCGGGTTACAT,0,1583511
galEp3,0.14285714285714285,6,6,GGGGCGGTAGCGGGGATGGG,0,1563466
galEp3,0.14285714285714285,6,6,GGGGCACAGGTCCTAGGAGT,0,1552214
galEp3,0.14285714285714285,6,6,GGGCTGAGGGGAGCTGCAGT,0,1568748
galEp3,0.14285714285714285,6,6,GGGCGTCGCCGGTGGCATAG,0,1551271
galEp3,0.14285714285714285,6,6,GGGCCTACTTTGTCGTGTAG,0,1559091
galEp3,0.14285714285714285,6,6,GGGATGGCTAAGGCCATAGC,0,1554977
galEp3,0.14285714285714285,6,6,GGGAGGGCCTGCGGTCCATT,0,1554141
galEp3,0.14285714285714285,6,6,GGGAACGTTCCCTTCGGCGT,0,1588274
galEp3,0.14285714285714285,6,6,GGCTTGCAGTGCGCATACAC,0,1576412
galEp3,0.14285714285714285,6,6,GGCTTCACACAGCGGCCTTG,0,1577964
galEp3,0.14285714285714285,6,6,GGCTTAGTGAGCATGACGCA,0,1581417
galEp3,0.14285714285714285,6,6,GGCTGCCTGGCTCGACTTCC,0,1559641
galEp3,0.14285714285714285,6,6,GGCTGCCCGGGATTTCTAAT,0,1563024
galEp3,0.14285714285714285,6,6,GGCGTCCGTGCTAGTTGTCT,0,1568535
galEp3,0.14285714285714285,6,6,GGCGTAAAATGTAGAAGAGG,0,1556265
galEp3,0.14285714285714285,6,6,GGCGGAGGTATGGATTGGAA,0,1567538
galEp3,0.14285714285714285,6,6,GGCGAGACATGATGCAACAG,0,1574119
galEp3,0.14285714285714285,6,6,GGCGACCTCCTCTCTATTGG,0,1558643
galEp3,0.14285714285714285,6,6,GGCCCGAGGGACGAGCACGG,0,1578850
galEp3,0.14285714285714285,6,6,GGCCAGGGGTACCGCGCCCC,0,1551764
galEp3,0.14285714285714285,6,6,GGCCACGTGCATGCGCTACT,0,1551037
galEp3,0.14285714285714285,6,6,GGCATGAAACGACTCAGAGG,0,1554153
galEp3,0.14285714285714285,6,6,GGCAGATTCAGCCTCCCAGT,0,1557483
galEp3,0.14285714285714285,6,6,GGAGTGAATTTAAGAGCCTG,0,1582983
galEp3,0.14285714285714285,6,6,GGAGCGAAATTGCTGGATGT,0,1556841
galEp3,0.14285714285714285,6,6,GGACGGAGCAAAAAGTGACG,0,1550929
galEp3,0.14285714285714285,6,6,GGAATAAGCGGAGGAACACA,0,1568286
galEp3,0.14285714285714285,6,6,GGAAACGCACAGTGGGCCCA,0,1558770
galEp3,0.14285714285714285,6,6,GGAAACCGCTTCGAATTGAG,0,1586867
galEp3,0.14285714285714285,6,6,GCTTTCCAAAACGAGGTCTC,0,1588236
galEp3,0.14285714285714285,6,6,GCTTATCAGTTGGGGTTGCC,0,1547914
galEp3,0.14285714285714285,6,6,GCTTAGATTTCACGCCGCTA,0,1560486
galEp3,0.14285714285714285,6,6,GCTGGTCCAAGCCCGTATAA,0,1571999
galEp3,0.14285714285714285,6,6,GCTGGTATAATACGCGGGAT,0,1560421
galEp3,0.14285714285714285,6,6,GCTGGATGTATCGTCTTCCC,0,1570062
galEp3,0.14285714285714285,6,6,GCTGCCATAGATAACTCTTA,0,1593086
galEp3,0.14285714285714285,6,6,GCTCGTCACTGCAATTACAA,0,1548082
galEp3,0.14285714285714285,6,6,GCTCGGAATGTGAGCAGTAC,0,1585865
galEp3,0.14285714285714285,6,6,GCTCATGGAATCAGATATTA,0,1568590
galEp3,0.14285714285714285,6,6,GCTCATATCAGGCTGCGGAA,0,1556538
galEp3,0.14285714285714285,6,6,GCTATAGAGCATCCCGGGGC,0,1565871
galEp3,0.14285714285714285,6,6,GCTAGAAGTCTCGACGCATC,0,1588804
galEp3,0.14285714285714285,6,6,GCTAAAATGCCGGAGAAGTC,0,1590106
galEp3,0.14285714285714285,6,6,GCGTTTCAGATCTAGCGTAC,0,1573218
galEp3,0.14285714285714285,6,6,GCGTTGGTTTTTTAAACGTT,0,1588036
galEp3,0.14285714285714285,6,6,GCGTGTGGCAGATGTGCTGT,0,1551357
galEp3,0.14285714285714285,6,6,GCGTGGTTTAGTGCTGAGGT,0,1586548
galEp3,0.14285714285714285,6,6,GCGTGCCGTCCTCGAGAGAC,0,1590309
galEp3,0.14285714285714285,6,6,GCGTCTGTATTAAGTGTCCT,0,1583446
galEp3,0.14285714285714285,6,6,GCGTCCGCCAGTAGTGTGAA,0,1573075
galEp3,0.14285714285714285,6,6,GCGTAGCGTTGCTGTGGGAG,0,1578428
galEp3,0.14285714285714285,6,6,GCGGTGTCTTGCTGTACAGT,0,1569806
galEp3,0.14285714285714285,6,6,GCGGTGACGGGGTCTCAACA,0,1575743
galEp3,0.14285714285714285,6,6,GCGGGCTGCTGACTTATTGT,0,1556574
galEp3,0.14285714285714285,6,6,GCGGGCACGGCCAACAATAC,0,1571840
galEp3,0.14285714285714285,6,6,GCGGCAGCGGGGAGGCGTGA,0,1562753
galEp3,0.14285714285714285,6,6,GCGCTGGGCGTAAGCGAAAA,0,1560196
galEp3,0.14285714285714285,6,6,GCGCGTCCACGTCTTAAGAT,0,1589254
galEp3,0.14285714285714285,6,6,GCGCCAATGTCACGCCGCGG,0,1555362
galEp3,0.14285714285714285,6,6,GCGCATTCTTGTGAGCCGAG,0,1580215
galEp3,0.14285714285714285,6,6,GCGCAAACCCCGAGCACAAC,0,1578429
galEp3,0.14285714285714285,6,6,GCGAGCGGCGTATGATCATT,0,1554972
galEp3,0.14285714285714285,6,6,GCGAGCAATTGCCAGGAGAT,0,1578839
galEp3,0.14285714285714285,6,6,GCGACTTAAATAAGGTAATC,0,1550892
galEp3,0.14285714285714285,6,6,GCGACTGGCTAAGGACTCAT,0,1555053
galEp3,0.14285714285714285,6,6,GCGACCGTTCAATCGGCCTT,0,1565562
galEp3,0.14285714285714285,6,6,GCCTTCCGTGTAAGAAAAAT,0,1564494
galEp3,0.14285714285714285,6,6,GCCTTAGGTACGCCCTATGA,0,1551150
galEp3,0.14285714285714285,6,6,GCCTGAACACCATGGTCGAA,0,1548126
galEp3,0.14285714285714285,6,6,GCCGTACTACTCAGGACTCG,0,1551455
galEp3,0.14285714285714285,6,6,GCCGCCTCCGAAATGGCCAC,0,1558853
galEp3,0.14285714285714285,6,6,GCCGCCCGTCTTCATCAGAT,0,1557660
galEp3,0.14285714285714285,6,6,GCCCTCCGACAGGGGGGCGC,0,1574819
galEp3,0.14285714285714285,6,6,GCCCCTTTGACCACAATTCG,0,1577793
galEp3,0.14285714285714285,6,6,GCCCCTCAGGGACGTCTCGG,0,1575293
galEp3,0.14285714285714285,6,6,GCCCATGCCATAGATACCTA,0,1581356
galEp3,0.14285714285714285,6,6,GCCCAATGCTCTGGTTAGGC,0,1574189
galEp3,0.14285714285714285,6,6,GCCACTGCAGATTACTTGTC,0,1557996
galEp3,0.14285714285714285,6,6,GCCACTCGGTTAGAGTTCAA,0,1590147
galEp3,0.14285714285714285,6,6,GCATTGCGTTAGCCAGAACT,0,1576118
galEp3,0.14285714285714285,6,6,GCATGAGGGAGGTAGCCATT,0,1553202
galEp3,0.14285714285714285,6,6,GCATACGTAGTACAATGCGA,0,1553736
galEp3,0.14285714285714285,6,6,GCAGGTTCTCTTCAGAACTC,0,1586993
galEp3,0.14285714285714285,6,6,GCAGCTTACTTCAGCATGGT,0,1551418
galEp3,0.14285714285714285,6,6,GCACGGCATTGTGCGCGGTG,0,1572475
galEp3,0.14285714285714285,6,6,GCACGATCCCAGTTCGTAGA,0,1580578
galEp3,0.14285714285714285,6,6,GCACCAAGAGTCAATGATCT,0,1562711
galEp3,0.14285714285714285,6,6,GCACAGGTCGTATTGAGCGT,0,1551196
galEp3,0.14285714285714285,6,6,GCACACCCGTCCGCGTGTCT,0,1577534
galEp3,0.14285714285714285,6,6,GCAACTCTGGCCGTCAATAA,0,1556381
galEp3,0.14285714285714285,6,6,GCAACGCGGGGTACCGTGTA,0,1567255
galEp3,0.14285714285714285,6,6,GCAACGCACTGCGCAGACAG,0,1570510
galEp3,0.14285714285714285,6,6,GATTCCCCCCAGACTCCTAA,0,1563956
galEp3,0.14285714285714285,6,6,GATTAGAAAGAACCAGCCCT,0,1590711
galEp3,0.14285714285714285,6,6,GATCTTTAGGTCACCAACAT,0,1577949
galEp3,0.14285714285714285,6,6,GATCCTGATAAACTCGGTCC,0,1593689
galEp3,0.14285714285714285,6,6,GATCAGGTGCCCGGTATAAA,0,1569259
galEp3,0.14285714285714285,6,6,GATCACCCTTTTCGTTCCCA,0,1572002
galEp3,0.14285714285714285,6,6,GATATGTTTCATGGCGCTAC,0,1557924
galEp3,0.14285714285714285,6,6,GATACTGGGCTTAGGAAAAC,0,1553027
galEp3,0.14285714285714285,6,6,GATACCGACGCGCGTACGCC,0,1557898
galEp3,0.14285714285714285,6,6,GATACAGAGCGATACGGGAG,0,1585792
galEp3,0.14285714285714285,6,6,GATAATTTTAGTCGCATGAT,0,1558552
galEp3,0.14285714285714285,6,6,GATAAGGTAGCCCTATCCCA,0,1571588
galEp3,0.14285714285714285,6,6,GAGTGAGGTCCCGAGTACGC,0,1593886
galEp3,0.14285714285714285,6,6,GAGGTCCTCCACTCGGCCTC,0,1582011
galEp3,0.14285714285714285,6,6,GAGGGCTGCCAGTGGATGCG,0,1566059
galEp3,0.14285714285714285,6,6,GAGCGCTTCATGGTCCGCTA,0,1554395
galEp3,0.14285714285714285,6,6,GAGATTTCCACATACCTATG,0,1562164
galEp3,0.14285714285714285,6,6,GAGATCGGTAAAGATGTCAA,0,1578498
galEp3,0.14285714285714285,6,6,GAGATCAGGTTCTAATACTG,0,1584040
galEp3,0.14285714285714285,6,6,GAGAGCAGCATCAGACAATT,0,1560078
galEp3,0.14285714285714285,6,6,GAGACCCGCCAGCTAGAAGG,0,1582376
galEp3,0.14285714285714285,6,6,GAGAAGGATCACCGGGGGAT,0,1593091
galEp3,0.14285714285714285,6,6,GACTGCTAATCACAGAGGGC,0,1558534
galEp3,0.14285714285714285,6,6,GACGTTGCTTGCTGAGAAGC,0,1590878
galEp3,0.14285714285714285,6,6,GACGTAGCCGTCGGGTGGAG,0,1592067
galEp3,0.14285714285714285,6,6,GACGCTCCAGTGTTGCAGAC,0,1579976
galEp3,0.14285714285714285,6,6,GACGCGATTGGTCCATCGGG,0,1591890
galEp3,0.14285714285714285,6,6,GACGCAGTCAACTTTAAATT,0,1547455
galEp3,0.14285714285714285,6,6,GACGCACATGGGGGCAATTA,0,1592072
galEp3,0.14285714285714285,6,6,GACATCCCAGGGTGCCCACG,0,1589673
galEp3,0.14285714285714285,6,6,GACAGTACCTGTATATCAAA,0,1567123
galEp3,0.14285714285714285,6,6,GACACGCTGGACTATGTAAT,0,1562143
galEp3,0.14285714285714285,6,6,GACACCTTACGATAATTGTA,0,1555841
galEp3,0.14285714285714285,6,6,GACAATTACGCGGTTATATG,0,1592563
galEp3,0.14285714285714285,6,6,GAATTGTACGGTGTATGTGG,0,1562905
galEp3,0.14285714285714285,6,6,GAATAGGCTCCACATTGTTA,0,1587835
galEp3,0.14285714285714285,6,6,GAAGTGCGCGTCGAGTTGAA,0,1549042
galEp3,0.14285714285714285,6,6,GAAGTGCACTGCGAAGCACA,0,1580566
galEp3,0.14285714285714285,6,6,GAAGGGTGTAAAGCGGACAG,0,1588329
galEp3,0.14285714285714285,6,6,GAAGGGCGGGCCGCTTTTAC,0,1549652
galEp3,0.14285714285714285,6,6,GAACGTTTTGACGCGTCGTG,0,1570764
galEp3,0.14285714285714285,6,6,GAACGTCTAGGTTTTCAAAT,0,1583299
galEp3,0.14285714285714285,6,6,GAACCGCGTCTGACAAATGG,0,1570649
galEp3,0.14285714285714285,6,6,GAACACTCTGCAATAGAGTA,0,1582008
galEp3,0.14285714285714285,6,6,GAAAGGTCCTGACCCGTCGG,0,1568918
galEp3,0.14285714285714285,6,6,GAAAGGACATGACGGCGCGG,0,1569544
galEp3,0.14285714285714285,6,6,GAAACTGCTACAGGTTCCAA,0,1576841
galEp3,0.14285714285714285,6,6,CTTTTATGTGCCCACATAGC,0,1572298
galEp3,0.14285714285714285,6,6,CTTTGTGGCGTTTAGACATC,0,1570937
galEp3,0.14285714285714285,6,6,CTTTGTAAATCCGTATTTCG,0,1571767
galEp3,0.14285714285714285,6,6,CTTTCACAAGAAACGAAGTC,0,1583426
galEp3,0.14285714285714285,6,6,CTTTAAGTTACCAAATGCGT,0,1573858
galEp3,0.14285714285714285,6,6,CTTCCTAGGCAGGTGACCGA,0,1557486
galEp3,0.14285714285714285,6,6,CTTCCAGGGCCGTTGGGGAT,0,1593127
galEp3,0.14285714285714285,6,6,CTTCAATACTTATTGTCATG,0,1584978
galEp3,0.14285714285714285,6,6,CTTATGCCTATTATTGAAAT,0,1590620
galEp3,0.14285714285714285,6,6,CTGTTAGACGCGTTCAAAGT,0,1549707
galEp3,0.14285714285714285,6,6,CTGTTACCTTAAATGGCCAG,0,1583475
galEp3,0.14285714285714285,6,6,CTGTCATAAGCGGCTCATTT,0,1570857
galEp3,0.14285714285714285,6,6,CTGTCAGGTAGTAGCTCAAT,0,1574738
galEp3,0.14285714285714285,6,6,CTGCTCTCATGCGGGGTATA,0,1560777
galEp3,0.14285714285714285,6,6,CTGCGTGGTTGTCCGAAGCA,0,1548943
galEp3,0.14285714285714285,6,6,CTGCATACGGTTACGACGTT,0,1551897
galEp3,0.14285714285714285,6,6,CTGATGTGGTTTCAAACAGT,0,1547680
galEp3,0.14285714285714285,6,6,CTGAGGGCCGACAGCTTGGA,0,1580599
galEp3,0.14285714285714285,6,6,CTGACTTTGGATCATGAACT,0,1562396
galEp3,0.14285714285714285,6,6,CTCTTGTACTTCGTCGTCGG,0,1556332
galEp3,0.14285714285714285,6,6,CTCTTAAGCGCTCGAGTAAA,0,1561648
galEp3,0.14285714285714285,6,6,CTCTGGAAAGACAGGCTATA,0,1590307
galEp3,0.14285714285714285,6,6,CTCTGCTGTCGAACTTCTCG,0,1576536
galEp3,0.14285714285714285,6,6,CTCTCCCCTGACGCACTCCC,0,1566313
galEp3,0.14285714285714285,6,6,CTCTCAGCGTTCGGTGCGTA,0,1557891
galEp3,0.14285714285714285,6,6,CTCTATTTCCTCTCCATAAC,0,1572057
galEp3,0.14285714285714285,6,6,CTCTACTGTATCATGTTACA,0,1550637
galEp3,0.14285714285714285,6,6,CTCGTGTTTTACTATTCTAT,0,1586373
galEp3,0.14285714285714285,6,6,CTCGCGATTGATAGACCCGA,0,1550785
galEp3,0.14285714285714285,6,6,CTCCTCAATCGCACACCGAT,0,1557164
galEp3,0.14285714285714285,6,6,CTCCAGGAAGGTCAAATGAA,0,1557542
galEp3,0.14285714285714285,6,6,CTCCACCCCCTTGGTAACTG,0,1568619
galEp3,0.14285714285714285,6,6,CTCACTCAGGATGATACCAA,0,1568549
galEp3,0.14285714285714285,6,6,CTCAATAGTGGACCTGCGAA,0,1589421
galEp3,0.14285714285714285,6,6,CTCAACGTTAGCCCAAGGCA,0,1548520
galEp3,0.14285714285714285,6,6,CTCAAAATGCAGTACGTACA,0,1555229
galEp3,0.14285714285714285,6,6,CTATGAGTAATACCATGGGC,0,1594126
galEp3,0.14285714285714285,6,6,CTATACCGTTGATCTTTGCG,0,1561221
galEp3,0.14285714285714285,6,6,CTAGTTGGGGCGTCGTACGG,0,1577365
galEp3,0.14285714285714285,6,6,CTAGTGGCTAATGCTGCGTA,0,1593478
galEp3,0.14285714285714285,6,6,CTAGGGAGGTCCTCCTCTCG,0,1555367
galEp3,0.14285714285714285,6,6,CTAGCTCACTGTTAGTAAAT,0,1572967
galEp3,0.14285714285714285,6,6,CTAGCGGGTTTTAGTAAGGT,0,1557234
galEp3,0.14285714285714285,6,6,CTACCATCACGGACAATTAC,0,1593066
galEp3,0.14285714285714285,6,6,CTACACATCACCGAGCGGTA,0,1592606
galEp3,0.14285714285714285,6,6,CTACAATTGAACCTTGTATC,0,1557319
galEp3,0.14285714285714285,6,6,CTACAAGGGTTTAGGCCCCA,0,1583789
galEp3,0.14285714285714285,6,6,CTAATCCCGTATGACGTATA,0,1555230
galEp3,0.14285714285714285,6,6,CTAAGGGTTTAGCTCAGTGA,0,1586249
galEp3,0.14285714285714285,6,6,CTAAGGGAACCGTCAACCCA,0,1563003
galEp3,0.14285714285714285,6,6,CGTTGTTAGTTCTGTGGCAC,0,1555031
galEp3,0.14285714285714285,6,6,CGTTGTCCTGTCTGTCGCTG,0,1591133
galEp3,0.14285714285714285,6,6,CGTTATGGGTCGCATTTTTG,0,1580563
galEp3,0.14285714285714285,6,6,CGTGTTCTTGAGCAAAATGA,0,1557937
galEp3,0.14285714285714285,6,6,CGTGTGGAGTGCTCGATCAC,0,1566303
galEp3,0.14285714285714285,6,6,CGTGGTTGTAGGGCACAGTA,0,1561271
galEp3,0.14285714285714285,6,6,CGTGGACCCCGGGCTCACGA,0,1563256
galEp3,0.14285714285714285,6,6,CGTGCCGGACGGCCTAAAGA,0,1583824
galEp3,0.14285714285714285,6,6,CGTGCCCTCTATTCAGAGTC,0,1578967
galEp3,0.14285714285714285,6,6,CGTGACCTCCGCATCGTAAG,0,1551186
galEp3,0.14285714285714285,6,6,CGTCTCGTCGTACCGTGACA,0,1560710
galEp3,0.14285714285714285,6,6,CGTCTATGACTAACATTCAT,0,1573983
galEp3,0.14285714285714285,6,6,CGTATAGGCAGTAGCTCTAT,0,1564887
galEp3,0.14285714285714285,6,6,CGTAAGTTGGCTGAATCATG,0,1584437
galEp3,0.14285714285714285,6,6,CGGTTTGCTGGCATGAATCT,0,1586924
galEp3,0.14285714285714285,6,6,CGGTCTTCTGGGTAGCAACC,0,1548337
galEp3,0.14285714285714285,6,6,CGGTCTCCCAAAAATTCATA,0,1580012
galEp3,0.14285714285714285,6,6,CGGTATGAAAGATCGGGTCC,0,1562868
galEp3,0.14285714285714285,6,6,CGGGCGGTATTTTTGGGATC,0,1549089
galEp3,0.14285714285714285,6,6,CGGGCCGGGGTTATTGATTA,0,1554526
galEp3,0.14285714285714285,6,6,CGGGATACTTGAGCCCGCTC,0,1571637
galEp3,0.14285714285714285,6,6,CGGGACCTATTACGCGAGCC,0,1550856
galEp3,0.14285714285714285,6,6,CGGGACCGCTCCATGTGGAG,0,1583696
galEp3,0.14285714285714285,6,6,CGGCGCGGATTGTATTCAGA,0,1561076
galEp3,0.14285714285714285,6,6,CGGCGAGAAGGATCCTAGTT,0,1579985
galEp3,0.14285714285714285,6,6,CGGCCCCTGCGCGCCAAGGA,0,1558526
galEp3,0.14285714285714285,6,6,CGGCCACAGGCTAGGATACG,0,1548260
galEp3,0.14285714285714285,6,6,CGGCACATACGTACAGAAGA,0,1570346
galEp3,0.14285714285714285,6,6,CGGATTCTGTCACTTAACAT,0,1570652
galEp3,0.14285714285714285,6,6,CGGATGAGGTTGAATACGCT,0,1549503
galEp3,0.14285714285714285,6,6,CGGACGGGGGTGCCTGGATC,0,1571389
galEp3,0.14285714285714285,6,6,CGGACCCTCTCCGCCTCTTC,0,1566253
galEp3,0.14285714285714285,6,6,CGCTTGGCAAGTGAAGTACA,0,1554440
galEp3,0.14285714285714285,6,6,CGCTGTCCCGCAGAGTCTCT,0,1573899
galEp3,0.14285714285714285,6,6,CGCTGGTGGCTGAGAACCCC,0,1585015
galEp3,0.14285714285714285,6,6,CGCTGCTGGGCTATCTGCTC,0,1583018
galEp3,0.14285714285714285,6,6,CGCTCGTCTGGGCAGGACAT,0,1584549
galEp3,0.14285714285714285,6,6,CGCGGTTCAGGCCAAGTCAA,0,1557386
galEp3,0.14285714285714285,6,6,CGCGGTAGATTAGGTTCCCA,0,1550204
galEp3,0.14285714285714285,6,6,CGCGGGGGTTACCGGGAAGA,0,1563816
galEp3,0.14285714285714285,6,6,CGCGGGGGTCCCCCGATCAA,0,1556276
galEp3,0.14285714285714285,6,6,CGCCTGTAGTACATGTCATG,0,1593604
galEp3,0.14285714285714285,6,6,CGCCTCGTGCTGGGAGTGGT,0,1567539
galEp3,0.14285714285714285,6,6,CGCCGGGCGTGATTGGGAAG,0,1580876
galEp3,0.14285714285714285,6,6,CGCCAAACATAGCCTTTAGA,0,1565747
galEp3,0.14285714285714285,6,6,CGCAGCCGGGCAGGACATCT,0,1570682
galEp3,0.14285714285714285,6,6,CGCAGAAGGATCAGCCCGCT,0,1594879
galEp3,0.14285714285714285,6,6,CGCACATAGTCCTTAGTCCA,0,1570977
galEp3,0.14285714285714285,6,6,CGCACACCGAAGTGTACTTA,0,1586883
galEp3,0.14285714285714285,6,6,CGATGCCGGAAACAAACTGA,0,1574594
galEp3,0.14285714285714285,6,6,CGATGCAGTACTCACCCGCA,0,1584946
galEp3,0.14285714285714285,6,6,CGATCGTAGAACGGTGAATA,0,1568088
galEp3,0.14285714285714285,6,6,CGATCAAATTAACTCTTTCA,0,1567784
galEp3,0.14285714285714285,6,6,CGATAGGGCGGCTAAAATCT,0,1557839
galEp3,0.14285714285714285,6,6,CGAGCCCTGGACCCGCGCTA,0,1572946
galEp3,0.14285714285714285,6,6,CGAGCAGAAATATCCGCGAT,0,1551250
galEp3,0.14285714285714285,6,6,CGAGACCGTAGTGCTCAAGT,0,1549548
galEp3,0.14285714285714285,6,6,CGACTGGGATTGTTATAGCT,0,1584595
galEp3,0.14285714285714285,6,6,CGACCACATACGGACTGGGT,0,1567390
galEp3,0.14285714285714285,6,6,CGAATGTAAGGAGGTAAAAG,0,1574341
galEp3,0.14285714285714285,6,6,CGAAGAGAGGATTCTCGGGA,0,1577342
galEp3,0.14285714285714285,6,6,CGAACTTTAGTGATCTGTTT,0,1556736
galEp3,0.14285714285714285,6,6,CGAACCCAAAGTGCCTCTTC,0,1591845
galEp3,0.14285714285714285,6,6,CGAAACGTGATATCAAGGAG,0,1569987
galEp3,0.14285714285714285,6,6,CCTTTCTTCCACTATGTCAG,0,1585603
galEp3,0.14285714285714285,6,6,CCTTCCTAAAGGTTACCGCA,0,1592521
galEp3,0.14285714285714285,6,6,CCTTCACCCTCGAGATCCTC,0,1559607
galEp3,0.14285714285714285,6,6,CCTGGGTGCCGTCGCCGTGC,0,1585444
galEp3,0.14285714285714285,6,6,CCTGGGGTCAAAACAGAACA,0,1554066
galEp3,0.14285714285714285,6,6,CCTCTCGCCATTCCAGTAAT,0,1547926
galEp3,0.14285714285714285,6,6,CCTCGGGTGGCGAAGGAGTA,0,1559448
galEp3,0.14285714285714285,6,6,CCTCACCTACCTTGTCCCTG,0,1576577
galEp3,0.14285714285714285,6,6,CCTCAACAATGAAGATTTTG,0,1586599
galEp3,0.14285714285714285,6,6,CCTATTTTGAAAACATAATC,0,1549519
galEp3,0.14285714285714285,6,6,CCTATTGAGGCTCCTTGGCT,0,1554078
galEp3,0.14285714285714285,6,6,CCGTTCCAGTGGCACATGGT,0,1546436
galEp3,0.14285714285714285,6,6,CCGTCCTATTGGAGGCGGTT,0,1573791
galEp3,0.14285714285714285,6,6,CCGGCGTTACGAAGGAAGCT,0,1585067
galEp3,0.14285714285714285,6,6,CCGATGCAACCATTACTCGG,0,1547440
galEp3,0.14285714285714285,6,6,CCGACGAGGAATCTGATCAT,0,1584600
galEp3,0.14285714285714285,6,6,CCGACACGTATGCGGGCGAT,0,1566007
galEp3,0.14285714285714285,6,6,CCCTTAAATGGATGTACCCC,0,1576048
galEp3,0.14285714285714285,6,6,CCCTCCCGCGTTAATACTTT,0,1575018
galEp3,0.14285714285714285,6,6,CCCGGATATATTCCGGACAC,0,1589771
galEp3,0.14285714285714285,6,6,CCCGGACACTGTCTGTCCAT,0,1562891
galEp3,0.14285714285714285,6,6,CCCCTAACATTGCGTATGTA,0,1548392
galEp3,0.14285714285714285,6,6,CCCCCAGAGCCCCTGTGACA,0,1593803
galEp3,0.14285714285714285,6,6,CCCATCGTGTGCAAGCATTG,0,1556068
galEp3,0.14285714285714285,6,6,CCCATAGAGCGGGTTCAGTA,0,1588039
galEp3,0.14285714285714285,6,6,CCCACGGCTATGAGTAGAGT,0,1547212
galEp3,0.14285714285714285,6,6,CCATGTTGAGTGCCCATGAG,0,1550392
galEp3,0.14285714285714285,6,6,CCATAGGTGTCGTAACGCTT,0,1590799
galEp3,0.14285714285714285,6,6,CCATAGACCTATCAGACTAT,0,1560802
galEp3,0.14285714285714285,6,6,CCAGGTGCAGCGTGGCTGAA,0,1585469
galEp3,0.14285714285714285,6,6,CCAGGGTCGGGGTACGACCG,0,1580611
galEp3,0.14285714285714285,6,6,CCAGGAAGAAAAAGTGCTCT,0,1552502
galEp3,0.14285714285714285,6,6,CCAGAGTGGATGTTACATAT,0,1557829
galEp3,0.14285714285714285,6,6,CCACCCTCGGCCGGCCAGTG,0,1551009
galEp3,0.14285714285714285,6,6,CCACATTTAGAAGCAAACTT,0,1578556
galEp3,0.14285714285714285,6,6,CCACACTTAGGGTGCGTCAC,0,1572693
galEp3,0.14285714285714285,6,6,CCAATTATCTATTTACATAG,0,1587094
galEp3,0.14285714285714285,6,6,CCAACGCCCTTGCAAGTTTA,0,1586277
galEp3,0.14285714285714285,6,6,CCAACCTCGTGTGTCAATGA,0,1560811
galEp3,0.14285714285714285,6,6,CCAAAATGCATATACATGAA,0,1558975
galEp3,0.14285714285714285,6,6,CATGCTGTTCCTTGTGGCAT,0,1573048
galEp3,0.14285714285714285,6,6,CATGAAAGGCCGCGCTTCTC,0,1562599
galEp3,0.14285714285714285,6,6,CATCTTAGGCACGTGTAGTA,0,1563545
galEp3,0.14285714285714285,6,6,CATCCATAACATACAATCAT,0,1572108
galEp3,0.14285714285714285,6,6,CATACTCATGAGACGGGGCA,0,1549324
galEp3,0.14285714285714285,6,6,CATAAGATACGTCTTTACTG,0,1593533
galEp3,0.14285714285714285,6,6,CATAACATATCATGCGATAT,0,1589950
galEp3,0.14285714285714285,6,6,CATAAAGTAATGCAATCGTG,0,1584212
galEp3,0.14285714285714285,6,6,CAGTTCAGTTCCAGTCCGTA,0,1584359
galEp3,0.14285714285714285,6,6,CAGTGAAGTCTTCGAGACTC,0,1565780
galEp3,0.14285714285714285,6,6,CAGTCATCGAGCTATTGCCA,0,1569849
galEp3,0.14285714285714285,6,6,CAGGTGTCGGGGGATGTTTC,0,1553495
galEp3,0.14285714285714285,6,6,CAGGTCCTAGTGAGCATGTC,0,1591841
galEp3,0.14285714285714285,6,6,CAGGTACGACTGGTTTATCT,0,1582749
galEp3,0.14285714285714285,6,6,CAGGCTGCGCTCGAGACCCC,0,1557317
galEp3,0.14285714285714285,6,6,CAGGCGGCACGTGGTTCAGT,0,1582108
galEp3,0.14285714285714285,6,6,CAGCTAATTTCCGAGGCCGC,0,1556202
galEp3,0.14285714285714285,6,6,CAGCGGGTAGGGATGTTGCT,0,1582908
galEp3,0.14285714285714285,6,6,CAGATTCGCGACGCAACTGG,0,1570625
galEp3,0.14285714285714285,6,6,CAGACTTTGTGCTCTCACTT,0,1583040
galEp3,0.14285714285714285,6,6,CAGACGTCCACCCTAGGCAA,0,1564744
galEp3,0.14285714285714285,6,6,CAGACAACTGTTAGTCGAAA,0,1591924
galEp3,0.14285714285714285,6,6,CACTTCACTTACTATGAGAA,0,1585758
galEp3,0.14285714285714285,6,6,CACTGGGTGGCGTGTATAAG,0,1570011
galEp3,0.14285714285714285,6,6,CACTACGATAATACGTTTAC,0,1548940
galEp3,0.14285714285714285,6,6,CACTAAGGCATCCCTTTGCT,0,1554982
galEp3,0.14285714285714285,6,6,CACGCACTGCCAAACGCGCA,0,1582822
galEp3,0.14285714285714285,6,6,CACGAGGGCGGCGACTCTAT,0,1591273
galEp3,0.14285714285714285,6,6,CACCTTCCCATTATGACTGT,0,1562632
galEp3,0.14285714285714285,6,6,CACCGTAGGCGGGTCCGATT,0,1558655
galEp3,0.14285714285714285,6,6,CACCGGCTACGCGGATCCTG,0,1564470
galEp3,0.14285714285714285,6,6,CACCGGACGAAACAATCTAG,0,1579371
galEp3,0.14285714285714285,6,6,CACCCGACGGGTCCGCAGTC,0,1547120
galEp3,0.14285714285714285,6,6,CACAGGACGGGCTGACATCA,0,1547886
galEp3,0.14285714285714285,6,6,CACAGCGTTGTTGCATCGTA,0,1579068
galEp3,0.14285714285714285,6,6,CAATATGGTGTCCCATTGAT,0,1583530
galEp3,0.14285714285714285,6,6,CAAGGTTCGGCACACCCTTA,0,1579696
galEp3,0.14285714285714285,6,6,CAAGCATAATCCCGGATAAT,0,1577726
galEp3,0.14285714285714285,6,6,CAAGACAGTCTATGCTCGCC,0,1559462
galEp3,0.14285714285714285,6,6,CAACACTGCTTTTCTCTGGC,0,1576443
galEp3,0.14285714285714285,6,6,CAACAATCTGGCCCAGCCAA,0,1577603
galEp3,0.14285714285714285,6,6,CAAATTGCAAACCATTAACA,0,1581581
galEp3,0.14285714285714285,6,6,CAAAGGGACATTTCATAGGC,0,1581886
galEp3,0.14285714285714285,6,6,CAAACTCAAACAGGCCTCTA,0,1576934
galEp3,0.14285714285714285,6,6,CAAACAACCGATCCCACGTG,0,1585191
galEp3,0.14285714285714285,6,6,ATTTTTCATGATGCCCGACA,0,1553072
galEp3,0.14285714285714285,6,6,ATTTTCTCGACAGAGCAACC,0,1546897
galEp3,0.14285714285714285,6,6,ATTTGAGCGCTTGCGAACGT,0,1590804
galEp3,0.14285714285714285,6,6,ATTTATTGTACAGTAAATGT,0,1577219
galEp3,0.14285714285714285,6,6,ATTGGGGCAGTTCTTCTCCT,0,1580273
galEp3,0.14285714285714285,6,6,ATTGGCCGAACCGTCAAGTA,0,1567920
galEp3,0.14285714285714285,6,6,ATTGCCCATATAATCATCTC,0,1575755
galEp3,0.14285714285714285,6,6,ATTCTGTATCGAATCTCGTA,0,1559857
galEp3,0.14285714285714285,6,6,ATTCGGCATCGAAGTTAAGT,0,1583277
galEp3,0.14285714285714285,6,6,ATTCGATTGGAGGCCCGACA,0,1587519
galEp3,0.14285714285714285,6,6,ATTAGGCGACCAGACGCCTC,0,1589494
galEp3,0.14285714285714285,6,6,ATTACGTATAAACACCGCCA,0,1571220
galEp3,0.14285714285714285,6,6,ATTAATGATACAGCTTCTTC,0,1550075
galEp3,0.14285714285714285,6,6,ATTAAGGCCGGTTAGGCGGG,0,1578655
galEp3,0.14285714285714285,6,6,ATGTTCCTATTAGCGGGTTC,0,1590939
galEp3,0.14285714285714285,6,6,ATGTCTGGGGTGTTGTGGAC,0,1558730
galEp3,0.14285714285714285,6,6,ATGGCGTGCGGTCTTACACG,0,1586117
galEp3,0.14285714285714285,6,6,ATGGCAAAATGGTGGAACTC,0,1548254
galEp3,0.14285714285714285,6,6,ATGGAGGGTAACATCAAAAA,0,1551184
galEp3,0.14285714285714285,6,6,ATGGAACTGTCAATCTTACC,0,1591265
galEp3,0.14285714285714285,6,6,ATGCTCTATTATCGGATGGC,0,1575720
galEp3,0.14285714285714285,6,6,ATGCTCAGGATCATTGCGGT,0,1581006
galEp3,0.14285714285714285,6,6,ATGCGGTAGATCTTGTATCC,0,1558178
galEp3,0.14285714285714285,6,6,ATGCCGCACCGCCCGTGAGC,0,1580755
galEp3,0.14285714285714285,6,6,ATGACTTCTTTGCAGGGTGG,0,1548242
galEp3,0.14285714285714285,6,6,ATCTTGGGTGACACGAGATT,0,1576958
galEp3,0.14285714285714285,6,6,ATCTTCCTACAGAATGGAAA,0,1573251
galEp3,0.14285714285714285,6,6,ATCTTAGAGTTAGTTGATGA,0,1577945
galEp3,0.14285714285714285,6,6,ATCTGTGGCGTGGATGGTTG,0,1587650
galEp3,0.14285714285714285,6,6,ATCTGATGGCCAACAGATTT,0,1584156
galEp3,0.14285714285714285,6,6,ATCTCTCCGCTCTAGTTAAA,0,1552441
galEp3,0.14285714285714285,6,6,ATCTCCTACGACTGACCAAC,0,1571358
galEp3,0.14285714285714285,6,6,ATCGTCTGTTCCGGCCGCAG,0,1559921
galEp3,0.14285714285714285,6,6,ATCGGTGGGTATAATTTTAT,0,1588113
galEp3,0.14285714285714285,6,6,ATCGCGCAGCAGCACTCGAA,0,1593887
galEp3,0.14285714285714285,6,6,ATCGCCAGTCTATTTACTAT,0,1557980
galEp3,0.14285714285714285,6,6,ATCGATCAGTAGTGAAGTTC,0,1548742
galEp3,0.14285714285714285,6,6,ATCCTTAGCTTAGATGAGAG,0,1592717
galEp3,0.14285714285714285,6,6,ATCCTCCCAGGCACGGCAAT,0,1551734
galEp3,0.14285714285714285,6,6,ATCCAAGCTGTCGGACATGT,0,1556273
galEp3,0.14285714285714285,6,6,ATATGTCAAGGAAGCACCCT,0,1572276
galEp3,0.14285714285714285,6,6,ATATCGTATCGAACATATCT,0,1563917
galEp3,0.14285714285714285,6,6,ATAGATGGGACGGGACCAGA,0,1562713
galEp3,0.14285714285714285,6,6,ATAGATGGCGCACAGCGGAT,0,1550104
galEp3,0.14285714285714285,6,6,ATACCTCGCAGCGGGTTGCA,0,1557456
galEp3,0.14285714285714285,6,6,ATAATAGTTACTGATGTATG,0,1584591
galEp3,0.14285714285714285,6,6,AGTTCTCGGGCAATGCGTTT,0,1572021
galEp3,0.14285714285714285,6,6,AGTTCCCCGTGCACTCCCCA,0,1590735
galEp3,0.14285714285714285,6,6,AGTGTGTGTAAGAGAGGAAA,0,1566191
galEp3,0.14285714285714285,6,6,AGTGTGTGGGCTCTCTTTAC,0,1584827
galEp3,0.14285714285714285,6,6,AGTGCACGCGGACAATTTTT,0,1575760
galEp3,0.14285714285714285,6,6,AGTGATAATGCGGTCTTCAT,0,1557806
galEp3,0.14285714285714285,6,6,AGTGACTTGGAGTTGCAAAA,0,1565883
galEp3,0.14285714285714285,6,6,AGTCTAGAGTACGGTCTTTT,0,1552315
galEp3,0.14285714285714285,6,6,AGTCCCGATCGAGCCGAAGC,0,1552546
galEp3,0.14285714285714285,6,6,AGTCCACTAAGCGCTCTCGG,0,1568466
galEp3,0.14285714285714285,6,6,AGTCATAAAACGAGTAGTAC,0,1590765
galEp3,0.14285714285714285,6,6,AGTATTCCTGAGCGTGATCA,0,1566957
galEp3,0.14285714285714285,6,6,AGTATGAACTGGGCACGGTA,0,1577775
galEp3,0.14285714285714285,6,6,AGTACTGAGTAGTGTGATCT,0,1561451
galEp3,0.14285714285714285,6,6,AGTAACTGTTGCTCTTAATT,0,1547771
galEp3,0.14285714285714285,6,6,AGTAAAGTACTTGATTTTGT,0,1584413
galEp3,0.14285714285714285,6,6,AGGTCCGCCGGTGATGGTAC,0,1583496
galEp3,0.14285714285714285,6,6,AGGTAGGACTGTATACGGGT,0,1575370
galEp3,0.14285714285714285,6,6,AGGGTACTCCTTGTAGGGGT,0,1549406
galEp3,0.14285714285714285,6,6,AGGGGCACAACTAACGGCCT,0,1553704
galEp3,0.14285714285714285,6,6,AGGGAGGGTCTCTTCCTATT,0,1578942
galEp3,0.14285714285714285,6,6,AGGCTCGCTGAGAAAAGGTT,0,1555110
galEp3,0.14285714285714285,6,6,AGGCCGCTCGAAAGGCAGCA,0,1567162
galEp3,0.14285714285714285,6,6,AGGCCGACGAACAGGTAGGT,0,1587804
galEp3,0.14285714285714285,6,6,AGGCAGTAATCTTGCTGAAG,0,1551000
galEp3,0.14285714285714285,6,6,AGGCAGACTCATCCGTTGCG,0,1547504
galEp3,0.14285714285714285,6,6,AGGCACTAACTCTGGAAGTA,0,1548663
galEp3,0.14285714285714285,6,6,AGGCAAGACCGCTTTGATCC,0,1547832
galEp3,0.14285714285714285,6,6,AGGCAACAGCTGGAAGCGGG,0,1567865
galEp3,0.14285714285714285,6,6,AGGACTTCGCAACGTTTCGC,0,1591186
galEp3,0.14285714285714285,6,6,AGGAACAGGGGAATAAAGGA,0,1592643
galEp3,0.14285714285714285,6,6,AGGAACAGATGTAGGGCGTT,0,1589808
galEp3,0.14285714285714285,6,6,AGGAAACGTCGTACAGGTTC,0,1581111
galEp3,0.14285714285714285,6,6,AGCTTTTTATCTATCCGGGA,0,1562594
galEp3,0.14285714285714285,6,6,AGCTTGACGTATTGCGGATT,0,1576736
galEp3,0.14285714285714285,6,6,AGCTTCTTAAGTTAGAAGTA,0,1553215
galEp3,0.14285714285714285,6,6,AGCTCTCTAGAATAAAAGCA,0,1570894
galEp3,0.14285714285714285,6,6,AGCTAGGAAATGCTCTGCGA,0,1585282
galEp3,0.14285714285714285,6,6,AGCGGGTCGTGTGATAATTG,0,1548306
galEp3,0.14285714285714285,6,6,AGCGGGCCTCACTAATGTCC,0,1553910
galEp3,0.14285714285714285,6,6,AGCGGCGACCGCGGACACTA,0,1564283
galEp3,0.14285714285714285,6,6,AGCGCGCTAGTCAGATTCCT,0,1590359
galEp3,0.14285714285714285,6,6,AGCGCACATTATAGCTTCTA,0,1561450
galEp3,0.14285714285714285,6,6,AGCGAACAGCGGCGTCAATA,0,1558092
galEp3,0.14285714285714285,6,6,AGCATTGGGTACCCCAGAAC,0,1592288
galEp3,0.14285714285714285,6,6,AGCAGTGTCCACAGGGCGAT,0,1583720
galEp3,0.14285714285714285,6,6,AGATTTGCAATTCTGACATC,0,1587714
galEp3,0.14285714285714285,6,6,AGATTAGAGTGGGACTCTAA,0,1565735
galEp3,0.14285714285714285,6,6,AGATGTTACATTGATTAACT,0,1556678
galEp3,0.14285714285714285,6,6,AGATCAGTAAGTCGGCTTAA,0,1550100
galEp3,0.14285714285714285,6,6,AGAGGCTGGGCGGCCCCAAT,0,1583078
galEp3,0.14285714285714285,6,6,AGAGGCGGCGCTAAGGATTG,0,1569771
galEp3,0.14285714285714285,6,6,AGAGATAACGGTGTGACTCC,0,1555917
galEp3,0.14285714285714285,6,6,AGAGACAAACATATTTGCGA,0,1590462
galEp3,0.14285714285714285,6,6,AGACTGGCGCGCGCGCCTAT,0,1565216
galEp3,0.14285714285714285,6,6,AGACATGTGCCCCTTGAGTC,0,1589487
galEp3,0.14285714285714285,6,6,AGAACTCTCCCATTCGTCCC,0,1582204
galEp3,0.14285714285714285,6,6,AGAACGTAATAGAGTATACA,0,1556025
galEp3,0.14285714285714285,6,6,AGAAAATCATGTCTGTACAT,0,1572525
galEp3,0.14285714285714285,6,6,ACTTTTATGGAAGCCCGCAT,0,1568851
galEp3,0.14285714285714285,6,6,ACTTCGTATTTGTCAATACA,0,1558633
galEp3,0.14285714285714285,6,6,ACTTCCGGTGACGGCCGCGA,0,1564903
galEp3,0.14285714285714285,6,6,ACTTCCCAAGGCAGTGACCC,0,1558201
galEp3,0.14285714285714285,6,6,ACTTCAGCAACGGGAGTCTG,0,1581974
galEp3,0.14285714285714285,6,6,ACTGCTATCCCTGGGTCCAG,0,1562234
galEp3,0.14285714285714285,6,6,ACTGCCGTGCATCTTGAGAA,0,1564268
galEp3,0.14285714285714285,6,6,ACTGACACACGCCGATGGGG,0,1591390
galEp3,0.14285714285714285,6,6,ACTCTCGGTCGGTATAGATT,0,1581476
galEp3,0.14285714285714285,6,6,ACTCGCGGTCGCTTGTAGTT,0,1551347
galEp3,0.14285714285714285,6,6,ACTCGAGGTAATCTCGGACG,0,1562901
galEp3,0.14285714285714285,6,6,ACTCAGGGTCATCCAATAGC,0,1559414
galEp3,0.14285714285714285,6,6,ACTCAACCTAAGTGGAGACT,0,1582240
galEp3,0.14285714285714285,6,6,ACTATATTATGGACTGAAGT,0,1568237
galEp3,0.14285714285714285,6,6,ACTACCACCCCCCGAATCTT,0,1579943
galEp3,0.14285714285714285,6,6,ACGTTATGGAAAACCGAAAC,0,1556082
galEp3,0.14285714285714285,6,6,ACGTTATCACCGGTACGACC,0,1584228
galEp3,0.14285714285714285,6,6,ACGTGCCCGGTTACTGCTAA,0,1567673
galEp3,0.14285714285714285,6,6,ACGTCCGCGTTAGTGGCGTC,0,1575806
galEp3,0.14285714285714285,6,6,ACGGTTTAGTCAATCATAAT,0,1577884
galEp3,0.14285714285714285,6,6,ACGGGAGATAGGAGAGCAGC,0,1552584
galEp3,0.14285714285714285,6,6,ACGGCTAACGGGCGGTCGGT,0,1588334
galEp3,0.14285714285714285,6,6,ACGGACCCGGTTGCTGCCAC,0,1549104
galEp3,0.14285714285714285,6,6,ACGCGAGGGCTGGCAGGGAA,0,1579152
galEp3,0.14285714285714285,6,6,ACGCCCAATCGATGCCGTGG,0,1556676
galEp3,0.14285714285714285,6,6,ACGCCCAATCGATGCACGTA,0,1556666
galEp3,0.14285714285714285,6,6,ACGATTTGTATTATAGACGT,0,1584229
galEp3,0.14285714285714285,6,6,ACGATAGCCGCCCCAAACAC,0,1546841
galEp3,0.14285714285714285,6,6,ACGAAGTTTTTATAAATTTC,0,1575613
galEp3,0.14285714285714285,6,6,ACGAAGTTCTTGTAGTACGT,0,1553266
galEp3,0.14285714285714285,6,6,ACCTTAGACACAGTATTCGT,0,1573945
galEp3,0.14285714285714285,6,6,ACCTCGAAGCCCTCTCCAGT,0,1560353
galEp3,0.14285714285714285,6,6,ACCGTTGAATTTTGATTGGG,0,1572369
galEp3,0.14285714285714285,6,6,ACCGTAGATCCTTACTATTG,0,1567960
galEp3,0.14285714285714285,6,6,ACCGTACTTGCGCTCTCTAG,0,1580073
galEp3,0.14285714285714285,6,6,ACCGGACCGACGCCGACCGG,0,1595128
galEp3,0.14285714285714285,6,6,ACCGCTGACACGTGCAGTGG,0,1554005
galEp3,0.14285714285714285,6,6,ACCGACATCGTCCGGGCAGT,0,1550358
galEp3,0.14285714285714285,6,6,ACCCTGTGTTAGACACCTTG,0,1553125
galEp3,0.14285714285714285,6,6,ACCCTCTTCGTCAAGCTTGG,0,1573181
galEp3,0.14285714285714285,6,6,ACCCGTATTAAGCTAGACGA,0,1581775
galEp3,0.14285714285714285,6,6,ACCCCTGCCGTAAACGTTGT,0,1575481
galEp3,0.14285714285714285,6,6,ACCATTTTGAAAAGAGATCG,0,1549498
galEp3,0.14285714285714285,6,6,ACCATCTGGCAAGCCTACCG,0,1572028
galEp3,0.14285714285714285,6,6,ACCAGCCACCAGACACCCGT,0,1583373
galEp3,0.14285714285714285,6,6,ACCAGAGTATTATCGCATGT,0,1569056
galEp3,0.14285714285714285,6,6,ACCAAAATTACACACCACGG,0,1566375
galEp3,0.14285714285714285,6,6,ACATGAAAACGCGTATGCTT,0,1573795
galEp3,0.14285714285714285,6,6,ACATAGTGGTCTGCGTTCGT,0,1556511
galEp3,0.14285714285714285,6,6,ACAGTAGTTGTGAACTTCTG,0,1553607
galEp3,0.14285714285714285,6,6,ACAGCGGGGCGGGAGGTTGT,0,1570621
galEp3,0.14285714285714285,6,6,ACAGCGCTGCGCCGATAGTC,0,1556801
galEp3,0.14285714285714285,6,6,ACACAAAACCCCCGTTATAC,0,1583761
galEp3,0.14285714285714285,6,6,ACAAGCGGGTTTGACCGCAT,0,1551542
galEp3,0.14285714285714285,6,6,ACAACTCTGAGGCAATCATG,0,1580790
galEp3,0.14285714285714285,6,6,AATTTTTGCCCGACCGACGA,0,1563679
galEp3,0.14285714285714285,6,6,AATTTGCAACAGAACTCTGT,0,1575552
galEp3,0.14285714285714285,6,6,AATTGCTATGTATCACTTTC,0,1591892
galEp3,0.14285714285714285,6,6,AATTCAGTTGCAAGAGGTGT,0,1592347
galEp3,0.14285714285714285,6,6,AATTATGTACCCCTCTTAAA,0,1562187
galEp3,0.14285714285714285,6,6,AATGTTTCCCGTGGTTTGGA,0,1591968
galEp3,0.14285714285714285,6,6,AATGGCAGTTGTCTGTTCAC,0,1560647
galEp3,0.14285714285714285,6,6,AATGCTGACATTCATGTCTC,0,1557418
galEp3,0.14285714285714285,6,6,AATGATAGTTATTGCCTGTT,0,1574944
galEp3,0.14285714285714285,6,6,AATCTGAGGCCCGACGTCAT,0,1555182
galEp3,0.14285714285714285,6,6,AATCTAGAAAGCCGATTAGT,0,1565072
galEp3,0.14285714285714285,6,6,AATCGGCACACTTCGGCCAG,0,1564331
galEp3,0.14285714285714285,6,6,AATCGGAGGACCCCAGACTA,0,1587691
galEp3,0.14285714285714285,6,6,AATCCTTCTGTAATAGCAGA,0,1589283
galEp3,0.14285714285714285,6,6,AATATTGTAATCCAGTGGTG,0,1562534
galEp3,0.14285714285714285,6,6,AATATTCACTCGGGAGGCAA,0,1553301
galEp3,0.14285714285714285,6,6,AATAGAGTCTCGGTAGCTTG,0,1568041
galEp3,0.14285714285714285,6,6,AATACTTTCGCCAAGTTTTG,0,1560831
galEp3,0.14285714285714285,6,6,AATACGGAACAACCCAGATA,0,1589007
galEp3,0.14285714285714285,6,6,AATAATCCTTCGTACAATCT,0,1572555
galEp3,0.14285714285714285,6,6,AAGTTGCGATGTTAGGTTTC,0,1580587
galEp3,0.14285714285714285,6,6,AAGTTCTCGCAAATTAAGGT,0,1553877
galEp3,0.14285714285714285,6,6,AAGTATGACCTAGATCTCGG,0,1594681
galEp3,0.14285714285714285,6,6,AAGGCCCGATGATACCGCAA,0,1550475
galEp3,0.14285714285714285,6,6,AAGGAGCCCATTTTTTGTAG,0,1570055
galEp3,0.14285714285714285,6,6,AAGCGATGTGATTTATGATA,0,1571508
galEp3,0.14285714285714285,6,6,AAGCCATTCTAACGGAACTC,0,1574813
galEp3,0.14285714285714285,6,6,AAGCACAGGTGGGCAATCCA,0,1554608
galEp3,0.14285714285714285,6,6,AAGCAAACAGATGGGACAAT,0,1567659
galEp3,0.14285714285714285,6,6,AAGATTTTAAACAACGACAC,0,1563724
galEp3,0.14285714285714285,6,6,AAGAACGGCCCGTGTAGGGA,0,1581263
galEp3,0.14285714285714285,6,6,AACTATGGGAAAACAACTCG,0,1593029
galEp3,0.14285714285714285,6,6,AACTATCGCCCTGGCGGAGC,0,1580734
galEp3,0.14285714285714285,6,6,AACTATAGCATCATCTGGCG,0,1575978
galEp3,0.14285714285714285,6,6,AACTAAACCAGAGTCCGGTG,0,1551414
galEp3,0.14285714285714285,6,6,AACGTGGCATGGTTTAGTGC,0,1562098
galEp3,0.14285714285714285,6,6,AACGAATGATTGATGGTCGC,0,1575722
galEp3,0.14285714285714285,6,6,AACCCTCTAGTCACATAGGG,0,1583038
galEp3,0.14285714285714285,6,6,AACCCCGGTTTCCAAAAACG,0,1558923
galEp3,0.14285714285714285,6,6,AACATTGGTCCGGGGGTTTA,0,1576505
galEp3,0.14285714285714285,6,6,AACATTCTGTTTTCTTCAAC,0,1561528
galEp3,0.14285714285714285,6,6,AACAGCGGGTTGTTGTACGG,0,1588569
galEp3,0.14285714285714285,6,6,AACACAGGGGGAATGCAGAA,0,1569471
galEp3,0.14285714285714285,6,6,AAATGCGTAGAGACCGATTC,0,1584823
galEp3,0.14285714285714285,6,6,AAATCTCCCGCTGCCTAACA,0,1582826
galEp3,0.14285714285714285,6,6,AAATACTGGCAATCAGTAGT,0,1571584
galEp3,0.14285714285714285,6,6,AAAGGCTCACGACCTACATC,0,1581323
galEp3,0.14285714285714285,6,6,AAAGCGGCAGATTTATTATC,0,1549674
galEp3,0.14285714285714285,6,6,AAAGCACAGCGCGTTCCCGT,0,1547065
galEp3,0.14285714285714285,6,6,AAAGAGGGCGTCAGCAGTCC,0,1593129
galEp3,0.14285714285714285,6,6,AAACGTCTCCGAAGAGCGGC,0,1555246
galEp3,0.14285714285714285,6,6,AAACGGACATAACACCGCCA,0,1547818
galEp3,0.14285714285714285,6,6,AAACCTCAGGTTAAGATGAG,0,1583626
galEp3,0.14285714285714285,6,6,AAACAATATGAAATCCCAGT,0,1566473
galEp3,0.14285714285714285,6,6,AAAATGGTTCTCGTCTCTAG,0,1584526
galEp3,0.14285714285714285,6,6,AAAATGCATTAATTCTCCAC,0,1591770
galEp3,0.14285714285714285,6,6,AAAAGGATATTCCTCCGGGC,0,1561294
galEp3,0.14285714285714285,6,6,AAAAACGCCTCAGATACGAC,0,1554391
galEp3,0.14285714285714285,6,6,AAAAAACTGGAGATCTTGTG,0,1585113
galEp3,0.16666666666666666,5,5,TTTTGGACCCTCGGGCGCCA,0,1588763
galEp3,0.16666666666666666,5,5,TTTTGGAAGTGTGAAGGCTC,0,1555694
galEp3,0.16666666666666666,5,5,TTTTGACCGACATGCTAGCC,0,1579363
galEp3,0.16666666666666666,5,5,TTTTGAAGACATTAAGCGTG,0,1570152
galEp3,0.16666666666666666,5,5,TTTTCTCGATATCCTGAATC,0,1570899
galEp3,0.16666666666666666,5,5,TTTTCAGTAAAGGGATGTCC,0,1563897
galEp3,0.16666666666666666,5,5,TTTTCAGGAGAACTAATGCA,0,1564336
galEp3,0.16666666666666666,5,5,TTTTAAATCTAGGGTAAGAA,0,1577577
galEp3,0.16666666666666666,5,5,TTTGCGGCCACATCCCCGGA,0,1583366
galEp3,0.16666666666666666,5,5,TTTGATTGTCCCTCGCGTTT,0,1578391
galEp3,0.16666666666666666,5,5,TTTCGTATAAAACGCAGCCG,0,1564210
galEp3,0.16666666666666666,5,5,TTTCCATGAGAGCTAAGGGA,0,1549139
galEp3,0.16666666666666666,5,5,TTTAGTCTGCGGACCGCAAG,0,1557983
galEp3,0.16666666666666666,5,5,TTTAGAGTACGTTTTCTTGC,0,1581804
galEp3,0.16666666666666666,5,5,TTTACGCAAGTTAAGTTCAC,0,1553262
galEp3,0.16666666666666666,5,5,TTTAATGTCTCAGCAGAGTG,0,1568834
galEp3,0.16666666666666666,5,5,TTTAACAGATATACGGACGG,0,1577289
galEp3,0.16666666666666666,5,5,TTGTGTTCCAGATAAACCCG,0,1587931
galEp3,0.16666666666666666,5,5,TTGTCTTAATCCTCTAACCA,0,1550822
galEp3,0.16666666666666666,5,5,TTGTCCCTGTATTTCCACCT,0,1574461
galEp3,0.16666666666666666,5,5,TTGTACGCGGCGATCCCGTA,0,1575215
galEp3,0.16666666666666666,5,5,TTGGTCCATCATGATCGGTC,0,1582501
galEp3,0.16666666666666666,5,5,TTGGGTAGTAGTGACGGGCG,0,1558307
galEp3,0.16666666666666666,5,5,TTGGGAGACGGTCTAAATAA,0,1571738
galEp3,0.16666666666666666,5,5,TTGGCACTTAGCGAAAAGGA,0,1556018
galEp3,0.16666666666666666,5,5,TTGGATGATATTCACCACAG,0,1565273
galEp3,0.16666666666666666,5,5,TTGGATAGATATTGATCATA,0,1559330
galEp3,0.16666666666666666,5,5,TTGCTGTACATCTTTAGTAA,0,1573673
galEp3,0.16666666666666666,5,5,TTGCTATTTTCTTGAACGAC,0,1549360
galEp3,0.16666666666666666,5,5,TTGCGGGTTGACTTTGGGTG,0,1576530
galEp3,0.16666666666666666,5,5,TTGCCAATGTCAATCGCGGA,0,1594718
galEp3,0.16666666666666666,5,5,TTGATTTTTGGGTTAGTAGC,0,1552864
galEp3,0.16666666666666666,5,5,TTGATTCTCACAAGTGACCT,0,1554333
galEp3,0.16666666666666666,5,5,TTGAGGCAGCTGATAAAGTT,0,1584822
galEp3,0.16666666666666666,5,5,TTGAGAACCATGTTAAGGAC,0,1583284
galEp3,0.16666666666666666,5,5,TTGAACTCGCGCTGCTGCTG,0,1552985
galEp3,0.16666666666666666,5,5,TTCTTTGCCCGTGGCTGGCG,0,1551903
galEp3,0.16666666666666666,5,5,TTCTCACTAAGTACTGTCGC,0,1587725
galEp3,0.16666666666666666,5,5,TTCTATTGATCAACCCGATT,0,1551615
galEp3,0.16666666666666666,5,5,TTCTATTCCAAAACTTAAAT,0,1594694
galEp3,0.16666666666666666,5,5,TTCTAGGACAATAAAAACTT,0,1589885
galEp3,0.16666666666666666,5,5,TTCGTCACGCCTGCGCGCCA,0,1585652
galEp3,0.16666666666666666,5,5,TTCGGGGTTTTGTCATGCAA,0,1573749
galEp3,0.16666666666666666,5,5,TTCGCCGGGGAAGACTTTAC,0,1576012
galEp3,0.16666666666666666,5,5,TTCGACAACTCTCGTGGAGC,0,1564713
galEp3,0.16666666666666666,5,5,TTCCGGGTCCCAGACCATCA,0,1577382
galEp3,0.16666666666666666,5,5,TTCCGCTCCAGGTCACCGAT,0,1577565
galEp3,0.16666666666666666,5,5,TTCCAGATAACCGGACACCG,0,1579484
galEp3,0.16666666666666666,5,5,TTCAGGCTCTGCGGCTCTGA,0,1568330
galEp3,0.16666666666666666,5,5,TTCACGCCGCTTCAGAGGTC,0,1555958
galEp3,0.16666666666666666,5,5,TTCAACGTCTCAAACACGAG,0,1547935
galEp3,0.16666666666666666,5,5,TTATTCACGCGTGACTTACG,0,1575889
galEp3,0.16666666666666666,5,5,TTATCCCTAATTGGAACTGT,0,1565547
galEp3,0.16666666666666666,5,5,TTATAATTATTGCAGTTGGA,0,1589340
galEp3,0.16666666666666666,5,5,TTAGGAGCTCCGCACTTTCA,0,1572611
galEp3,0.16666666666666666,5,5,TTAGCGGTCCACAGTAAGAT,0,1573721
galEp3,0.16666666666666666,5,5,TTAGATGGCGTCAGCTCTCT,0,1559564
galEp3,0.16666666666666666,5,5,TTAGATATTGTATTCATCTC,0,1582400
galEp3,0.16666666666666666,5,5,TTACAGCAGGGGTACCCTGC,0,1555644
galEp3,0.16666666666666666,5,5,TTACAACTCACCCCGCCACA,0,1586918
galEp3,0.16666666666666666,5,5,TTAAGTCGTTATAAAGTAGG,0,1563457
galEp3,0.16666666666666666,5,5,TGTTTACCGACGCACTTGAG,0,1578518
galEp3,0.16666666666666666,5,5,TGTTGCCTTCTGTCTAGGAC,0,1569752
galEp3,0.16666666666666666,5,5,TGTTGAGTGGATCAAACTCT,0,1580702
galEp3,0.16666666666666666,5,5,TGTTCCCTTTCATGGCACTT,0,1582529
galEp3,0.16666666666666666,5,5,TGTTATGGCTGTGTTGAATG,0,1572447
galEp3,0.16666666666666666,5,5,TGTGGCTGTACCCTGGTGAC,0,1579129
galEp3,0.16666666666666666,5,5,TGTGCTGAGGAGCAAGGGCT,0,1547728
galEp3,0.16666666666666666,5,5,TGTGCGAACGCCCAACGCCT,0,1552524
galEp3,0.16666666666666666,5,5,TGTGCGAAACTGTGAAAGAG,0,1588988
galEp3,0.16666666666666666,5,5,TGTCTTTATGATCCAATGAG,0,1555699
galEp3,0.16666666666666666,5,5,TGTCTTCTTTCGATTCCTCT,0,1552176
galEp3,0.16666666666666666,5,5,TGTCGGGCCGAGACGTCTAC,0,1555778
galEp3,0.16666666666666666,5,5,TGTCATACAAATCTCACACC,0,1559732
galEp3,0.16666666666666666,5,5,TGTCAAGAATCCGGTTTAGA,0,1582565
galEp3,0.16666666666666666,5,5,TGTACTACGATGTGCCAGAT,0,1592502
galEp3,0.16666666666666666,5,5,TGTACGTCGCCATTGAGCCC,0,1564037
galEp3,0.16666666666666666,5,5,TGGTTGGCTTCATATGCGTT,0,1577089
galEp3,0.16666666666666666,5,5,TGGTTCATGCGCGCGTCGAA,0,1556191
galEp3,0.16666666666666666,5,5,TGGTGCACCTTCTGCAGTCT,0,1566535
galEp3,0.16666666666666666,5,5,TGGTCCTCGCTTTTCAGCAT,0,1574940
galEp3,0.16666666666666666,5,5,TGGGGTAGTAATTGCGGTTT,0,1551800
galEp3,0.16666666666666666,5,5,TGGGGGTGAGTCACCATGTT,0,1565908
galEp3,0.16666666666666666,5,5,TGGGGGCATAAACAGTGATG,0,1575727
galEp3,0.16666666666666666,5,5,TGGGCTTCCTCCCACGTGAA,0,1582073
galEp3,0.16666666666666666,5,5,TGGGCCGATACGTGCGTCGC,0,1590305
galEp3,0.16666666666666666,5,5,TGGCGCGTGGTGGCTACCTC,0,1555900
galEp3,0.16666666666666666,5,5,TGGCGAGATTTCGTTAGGTA,0,1567332
galEp3,0.16666666666666666,5,5,TGGCATGATCGGGGACTGCA,0,1562928
galEp3,0.16666666666666666,5,5,TGGATTTGCCCGTATTATAG,0,1579399
galEp3,0.16666666666666666,5,5,TGGACACGAGAGTTACCAAC,0,1592229
galEp3,0.16666666666666666,5,5,TGCTTTTGAAGATCAGGGGT,0,1568737
galEp3,0.16666666666666666,5,5,TGCTGTTTGGCACACAAAGA,0,1562784
galEp3,0.16666666666666666,5,5,TGCTCCGAGTTCCCGCCGCA,0,1585748
galEp3,0.16666666666666666,5,5,TGCTAATGTGCGACGATTCG,0,1551948
galEp3,0.16666666666666666,5,5,TGCGGGCATAGTGTCTCAAG,0,1563116
galEp3,0.16666666666666666,5,5,TGCGAATGGCACTGATCTCC,0,1564072
galEp3,0.16666666666666666,5,5,TGCGAAGCCATTTCGAGACT,0,1555754
galEp3,0.16666666666666666,5,5,TGCCTGCAATTGAGACGCAT,0,1556803
galEp3,0.16666666666666666,5,5,TGCCTGAGGGTGCTGCAGAG,0,1566572
galEp3,0.16666666666666666,5,5,TGCCGTGTACGGGTGAGTAG,0,1583775
galEp3,0.16666666666666666,5,5,TGCCGACTAGCCTGACAAGT,0,1560939
galEp3,0.16666666666666666,5,5,TGCCCGCTACAAGTCATTTA,0,1558037
galEp3,0.16666666666666666,5,5,TGCAGAGTCAGGTGTCATTT,0,1567780
galEp3,0.16666666666666666,5,5,TGCAGAGGTCTTTATTCACA,0,1553722
galEp3,0.16666666666666666,5,5,TGCAGACGCCGATTCTCATT,0,1564596
galEp3,0.16666666666666666,5,5,TGCACCCTGTAGACTCGTTT,0,1561881
galEp3,0.16666666666666666,5,5,TGCAAGCTTCAACGGGCTGA,0,1582794
galEp3,0.16666666666666666,5,5,TGATGCCGGCCCCAAAGGTC,0,1562473
galEp3,0.16666666666666666,5,5,TGATGAGGGTGCTTAATGCA,0,1569009
galEp3,0.16666666666666666,5,5,TGATCAGACGTGCGGTGAGC,0,1577781
galEp3,0.16666666666666666,5,5,TGAGTTATGGAAGATGACTT,0,1562013
galEp3,0.16666666666666666,5,5,TGAGGGTCCAACATGGAGAA,0,1578147
galEp3,0.16666666666666666,5,5,TGAGCATACGCCTCGGGTTA,0,1586926
galEp3,0.16666666666666666,5,5,TGAGACCTTGGTAAGGATTC,0,1548491
galEp3,0.16666666666666666,5,5,TGACGCATTTCTAGCACAAG,0,1576411
galEp3,0.16666666666666666,5,5,TGACAGAAGCTACACTATGG,0,1593203
galEp3,0.16666666666666666,5,5,TGAACTAGGGGGCCGGAGTT,0,1578893
galEp3,0.16666666666666666,5,5,TCTTTCGGACATAGGCAGCT,0,1590449
galEp3,0.16666666666666666,5,5,TCTTTCGATATAACTAGGAC,0,1576988
galEp3,0.16666666666666666,5,5,TCTTGAAGTTGGACGTGATT,0,1583740
galEp3,0.16666666666666666,5,5,TCTTCGACATCTGGTCTGTA,0,1566589
galEp3,0.16666666666666666,5,5,TCTGTGTTAAGTCCATCACT,0,1550762
galEp3,0.16666666666666666,5,5,TCTGTCTCAAGCACGACCAT,0,1586181
galEp3,0.16666666666666666,5,5,TCTGGGTGCGCTTGAAAATG,0,1567482
galEp3,0.16666666666666666,5,5,TCTGCCCGACAACGGGGCGG,0,1593438
galEp3,0.16666666666666666,5,5,TCTGATCATAGGGTGTGACA,0,1586862
galEp3,0.16666666666666666,5,5,TCTCTTTCAGTAAATATGTG,0,1586929
galEp3,0.16666666666666666,5,5,TCTCTTATCCTGTAAACGCT,0,1581719
galEp3,0.16666666666666666,5,5,TCTCGCGGCTGCGAATAGGA,0,1552718
galEp3,0.16666666666666666,5,5,TCTCCGTACTGTCTTAATAT,0,1575878
galEp3,0.16666666666666666,5,5,TCTCCGCATGCAACCCTTAT,0,1576326
galEp3,0.16666666666666666,5,5,TCTATGGCCGGGTGGAGTGG,0,1582602
galEp3,0.16666666666666666,5,5,TCTATGAGTATTAAACAAAG,0,1562716
galEp3,0.16666666666666666,5,5,TCTAGGATCCAGATGGCTCT,0,1562238
galEp3,0.16666666666666666,5,5,TCTAGCAAAACTTCGAATAA,0,1555350
galEp3,0.16666666666666666,5,5,TCTAGAAGAGGTCTGACAAA,0,1557402
galEp3,0.16666666666666666,5,5,TCTACTCTAAGGTCATGGCC,0,1564338
galEp3,0.16666666666666666,5,5,TCTAACAAGTTCGGACTCGC,0,1578207
galEp3,0.16666666666666666,5,5,TCGTTGTCAAGGCATTATCA,0,1587360
galEp3,0.16666666666666666,5,5,TCGTGCGTGTGGGTCCAACT,0,1563277
galEp3,0.16666666666666666,5,5,TCGTCCTAGTCCTCTAACTA,0,1586458
galEp3,0.16666666666666666,5,5,TCGTCCAGGCACATCGGGGG,0,1581992
galEp3,0.16666666666666666,5,5,TCGTAAGCACATCCCTCGAG,0,1572254
galEp3,0.16666666666666666,5,5,TCGGTCGGATATCGGCTCTG,0,1547195
galEp3,0.16666666666666666,5,5,TCGGTATTTGGACAAGCCGG,0,1581633
galEp3,0.16666666666666666,5,5,TCGGGGTCGGGGGCTCGCTT,0,1591230
galEp3,0.16666666666666666,5,5,TCGGGGAATGGCCATCGCGG,0,1558952
galEp3,0.16666666666666666,5,5,TCGGGATGAGGCCACCCGTA,0,1564469
galEp3,0.16666666666666666,5,5,TCGGGACGACCTCCAATGTG,0,1586242
galEp3,0.16666666666666666,5,5,TCGGCTAAAAGTAATGCACG,0,1559821
galEp3,0.16666666666666666,5,5,TCGGATCCAGCCACTGCTCA,0,1580141
galEp3,0.16666666666666666,5,5,TCGGAACGGTAAAGAACCCT,0,1549722
galEp3,0.16666666666666666,5,5,TCGGAACCGCGACTTGTGTT,0,1583808
galEp3,0.16666666666666666,5,5,TCGCCGTTCAGGATTTAGTT,0,1593590
galEp3,0.16666666666666666,5,5,TCGAGCTTTAGTCCTTCCAA,0,1587745
galEp3,0.16666666666666666,5,5,TCGAAATTAACTTTTAAGTT,0,1549012
galEp3,0.16666666666666666,5,5,TCCTGCAACGCTTATCTAAT,0,1560049
galEp3,0.16666666666666666,5,5,TCCTCTAGGCCACGGTGTTT,0,1557393
galEp3,0.16666666666666666,5,5,TCCTCGTGAGTTGTATGTTA,0,1551673
galEp3,0.16666666666666666,5,5,TCCTACGTTTAACAACGCTA,0,1555226
galEp3,0.16666666666666666,5,5,TCCGGACGCGTCATCCGGGT,0,1578236
galEp3,0.16666666666666666,5,5,TCCGCTAAGGCAATTCGATA,0,1585084
galEp3,0.16666666666666666,5,5,TCCCCGATGGTTGCTATTCC,0,1591349
galEp3,0.16666666666666666,5,5,TCCCACTAAGCCGATGGCCA,0,1593282
galEp3,0.16666666666666666,5,5,TCCAGGATATCCGTGTTCTG,0,1571835
galEp3,0.16666666666666666,5,5,TCCAGAAGGCCATTGCTCCT,0,1562785
galEp3,0.16666666666666666,5,5,TCCACCGGTAGGACTGTAAC,0,1555598
galEp3,0.16666666666666666,5,5,TCCAACGGGCAGTGTCCTGG,0,1567947
galEp3,0.16666666666666666,5,5,TCCAACGCCTGTAAGGGGGT,0,1549100
galEp3,0.16666666666666666,5,5,TCATTCCGGAGCGTACGATG,0,1573323
galEp3,0.16666666666666666,5,5,TCATTCATGAATATAACTTT,0,1560500
galEp3,0.16666666666666666,5,5,TCATAGTCACATTAAAGACC,0,1548045
galEp3,0.16666666666666666,5,5,TCAGTTTGCGTTCTGCGAAC,0,1569665
galEp3,0.16666666666666666,5,5,TCAGGAGACGATCGAAAGCT,0,1574019
galEp3,0.16666666666666666,5,5,TCAGCCCCCCAAATTTGACG,0,1589827
galEp3,0.16666666666666666,5,5,TCAGATGGATGGCGGTCCCA,0,1546653
galEp3,0.16666666666666666,5,5,TCACTCCTGGGTAACTAGAC,0,1551353
galEp3,0.16666666666666666,5,5,TCACCTACTAGCGGGCGCTC,0,1563618
galEp3,0.16666666666666666,5,5,TCAACACGGGTCTGAACCGG,0,1583462
galEp3,0.16666666666666666,5,5,TCAAATCTGGTTTCTCATCT,0,1551199
galEp3,0.16666666666666666,5,5,TCAAAGGTCCGGCCCTTATC,0,1571751
galEp3,0.16666666666666666,5,5,TCAAAGACAACTTCAAGCGT,0,1555368
galEp3,0.16666666666666666,5,5,TCAAAAGTAGTTCCGCGGCC,0,1577493
galEp3,0.16666666666666666,5,5,TATTTTGGGAGAGCTTCCAC,0,1586405
galEp3,0.16666666666666666,5,5,TATTTCTGTTGGCGATCAAT,0,1588282
galEp3,0.16666666666666666,5,5,TATTCCATAGCACCAGGAGA,0,1567276
galEp3,0.16666666666666666,5,5,TATGCGCGAAGTTACATACA,0,1562232
galEp3,0.16666666666666666,5,5,TATGCCATGCGCAATCATAT,0,1555317
galEp3,0.16666666666666666,5,5,TATCTGGCACTCGTGCTGTT,0,1581271
galEp3,0.16666666666666666,5,5,TATCGGAGCGCTTATAGACG,0,1574389
galEp3,0.16666666666666666,5,5,TATCCTGCGGGTCTGTGACA,0,1591174
galEp3,0.16666666666666666,5,5,TATCCGTGGGATACTGAGGC,0,1551318
galEp3,0.16666666666666666,5,5,TATCCGATTTGATGCAATAA,0,1580443
galEp3,0.16666666666666666,5,5,TATCCGAATTAGAAGTAGGC,0,1585837
galEp3,0.16666666666666666,5,5,TATATTTTCGGCCGACCTGC,0,1550975
galEp3,0.16666666666666666,5,5,TATATCTCTTGGAGCGACTC,0,1576810
galEp3,0.16666666666666666,5,5,TATATATGTCCGTTTCTATT,0,1586050
galEp3,0.16666666666666666,5,5,TATAGGACGGGTAGGTCATG,0,1587535
galEp3,0.16666666666666666,5,5,TATACTAGCTGGCTCGTCTA,0,1546589
galEp3,0.16666666666666666,5,5,TATACCTAACCCAGTGGTAG,0,1548987
galEp3,0.16666666666666666,5,5,TAGGTAACACTGGCGTCCGC,0,1558758
galEp3,0.16666666666666666,5,5,TAGGCTAGAGTTAAGAATCT,0,1549673
galEp3,0.16666666666666666,5,5,TAGGCGATTGATGCAGAGTG,0,1581898
galEp3,0.16666666666666666,5,5,TAGCTCTCTGGATAGGTATC,0,1561026
galEp3,0.16666666666666666,5,5,TAGCAGTACGTTCGAGAAGG,0,1579286
galEp3,0.16666666666666666,5,5,TAGCAACAAAACGGTCTCGT,0,1581273
galEp3,0.16666666666666666,5,5,TAGATTTCCAGATTTAGCTT,0,1591780
galEp3,0.16666666666666666,5,5,TAGAGCTCAATAGAAGCTAT,0,1546908
galEp3,0.16666666666666666,5,5,TAGACTATGACCTATCAAAG,0,1579755
galEp3,0.16666666666666666,5,5,TAGACGATTACTCTAAACAA,0,1590797
galEp3,0.16666666666666666,5,5,TACTTGGGATGAGTTTTCGA,0,1551234
galEp3,0.16666666666666666,5,5,TACTTAGGTAAGTTACCTCG,0,1556882
galEp3,0.16666666666666666,5,5,TACTTAAGTTAGAGATGACC,0,1565164
galEp3,0.16666666666666666,5,5,TACTGCTAGATTCCAGGATT,0,1554844
galEp3,0.16666666666666666,5,5,TACTCTTATAGCAGGTATGA,0,1585952
galEp3,0.16666666666666666,5,5,TACTCTTAGTTGGGGGCTAG,0,1575072
galEp3,0.16666666666666666,5,5,TACGTTCCCGCCGCCTATTG,0,1550126
galEp3,0.16666666666666666,5,5,TACGATTTTCACAGATGGCC,0,1559095
galEp3,0.16666666666666666,5,5,TACCTCTTGTGTTTTCGTAG,0,1578387
galEp3,0.16666666666666666,5,5,TACCTATGCTTCAGCTCCGC,0,1561474
galEp3,0.16666666666666666,5,5,TACCGGCAGCGGCGGAGGGA,0,1549130
galEp3,0.16666666666666666,5,5,TACCGCGGCATGACGTCATC,0,1554547
galEp3,0.16666666666666666,5,5,TACCCATGCTGACATTACCT,0,1571085
galEp3,0.16666666666666666,5,5,TACCATAAATGCCCACGTTT,0,1547323
galEp3,0.16666666666666666,5,5,TACCAGAAGAAAAAGTAGAG,0,1571659
galEp3,0.16666666666666666,5,5,TACATTTCTGAGAGGTGCCG,0,1558193
galEp3,0.16666666666666666,5,5,TACATTGGCGATTAGTTGAG,0,1546755
galEp3,0.16666666666666666,5,5,TACACCCCGGCGCCAACCGG,0,1572957
galEp3,0.16666666666666666,5,5,TACAAAAAATAGTATGGAGT,0,1560008
galEp3,0.16666666666666666,5,5,TAATTAGTAAACTTTTGAAA,0,1581084
galEp3,0.16666666666666666,5,5,TAATCGGCCGGTAACAGCCC,0,1580097
galEp3,0.16666666666666666,5,5,TAATACGATATAGTTTGCGG,0,1557326
galEp3,0.16666666666666666,5,5,TAAGTTTCGTAGGGTGCTGT,0,1581634
galEp3,0.16666666666666666,5,5,TAAGGCCATATGGTTGTCGC,0,1589911
galEp3,0.16666666666666666,5,5,TAACTTCAGCGATGTATTAT,0,1558456
galEp3,0.16666666666666666,5,5,TAACTAATTTTATCTACCTC,0,1579382
galEp3,0.16666666666666666,5,5,TAACCGGCAAGGGCACATAG,0,1562863
galEp3,0.16666666666666666,5,5,GTTTCGTGCCTGCCGGGAAG,0,1577163
galEp3,0.16666666666666666,5,5,GTTTCCTTGGATCGGTTCCT,0,1555557
galEp3,0.16666666666666666,5,5,GTTGTGGCTATTCGTTCACT,0,1577017
galEp3,0.16666666666666666,5,5,GTTGGGACCTATACCTCAAG,0,1583301
galEp3,0.16666666666666666,5,5,GTTGCCTTACTGTAGTGATT,0,1552295
galEp3,0.16666666666666666,5,5,GTTCGGCCCACAAAGACCAA,0,1547031
galEp3,0.16666666666666666,5,5,GTTCGATATGTAAGAGCAAG,0,1560749
galEp3,0.16666666666666666,5,5,GTTCCGCGGGGATACGACGG,0,1564790
galEp3,0.16666666666666666,5,5,GTTCCGCCACCACGTAGTAA,0,1593674
galEp3,0.16666666666666666,5,5,GTTCCGAACAAGTACATTGT,0,1554812
galEp3,0.16666666666666666,5,5,GTTCACATAAATTTGAAATA,0,1575258
galEp3,0.16666666666666666,5,5,GTTATTGCCCTATGCCAAGG,0,1570728
galEp3,0.16666666666666666,5,5,GTTATATTGCTCCCCGAGCA,0,1552972
galEp3,0.16666666666666666,5,5,GTTATAATTCAGGTTCGCGC,0,1555719
galEp3,0.16666666666666666,5,5,GTGTTAAGCGAATTAAAAGA,0,1553946
galEp3,0.16666666666666666,5,5,GTGTGTGCGCTTCAGGTTAT,0,1557844
galEp3,0.16666666666666666,5,5,GTGTGCTCACAAATCCGAGG,0,1594380
galEp3,0.16666666666666666,5,5,GTGTCTTCAACACAGTTTTT,0,1586707
galEp3,0.16666666666666666,5,5,GTGTCGGCTTCACGTTGGAT,0,1592278
galEp3,0.16666666666666666,5,5,GTGTCATAGAGATACGCCTG,0,1558968
galEp3,0.16666666666666666,5,5,GTGTACAAGCAAAGGTTATG,0,1561987
galEp3,0.16666666666666666,5,5,GTGTAACACAGGACCGGCGT,0,1561164
galEp3,0.16666666666666666,5,5,GTGGTTCGGTAGCGTGTCCT,0,1559634
galEp3,0.16666666666666666,5,5,GTGGCATGTTCCGACAAAGT,0,1584192
galEp3,0.16666666666666666,5,5,GTGGCACTTGATCAAAGAAC,0,1594209
galEp3,0.16666666666666666,5,5,GTGGATTCCTTATATCGCCG,0,1560517
galEp3,0.16666666666666666,5,5,GTGGATTAATGGAGCCACGT,0,1565626
galEp3,0.16666666666666666,5,5,GTGGAGATAACCGCACCCTA,0,1549357
galEp3,0.16666666666666666,5,5,GTGGAACGTTAGAGTAAATA,0,1564119
galEp3,0.16666666666666666,5,5,GTGCTAAGACTCGCCGATGG,0,1579553
galEp3,0.16666666666666666,5,5,GTGCCGGAGGGCGGTTATAC,0,1582381
galEp3,0.16666666666666666,5,5,GTGCCAGGTTGCCCAATGTT,0,1578395
galEp3,0.16666666666666666,5,5,GTGCAAGGGCTCTGTCTTGA,0,1548105
galEp3,0.16666666666666666,5,5,GTGATGGCTAGATGTGAATG,0,1587534
galEp3,0.16666666666666666,5,5,GTGAGTCCATCGCGAGCCTA,0,1592744
galEp3,0.16666666666666666,5,5,GTGAACCGCGGATCGTGTAC,0,1573174
galEp3,0.16666666666666666,5,5,GTCTTGCTCCCTGACGCGCA,0,1550921
galEp3,0.16666666666666666,5,5,GTCTTGCCAGGTCGAGATGA,0,1577563
galEp3,0.16666666666666666,5,5,GTCTTATGAAAATTACTGAC,0,1553998
galEp3,0.16666666666666666,5,5,GTCTTAGGAATTAAAATTCT,0,1567754
galEp3,0.16666666666666666,5,5,GTCTGTTGGTGTCTAGTATC,0,1562454
galEp3,0.16666666666666666,5,5,GTCTCGCGAGTCCAGTTTGA,0,1550504
galEp3,0.16666666666666666,5,5,GTCGCGTGCGTATTGGCACC,0,1576167
galEp3,0.16666666666666666,5,5,GTCCTCAGACTGCGAGCGGC,0,1590728
galEp3,0.16666666666666666,5,5,GTCATTAAGTACATCCTCAG,0,1582256
galEp3,0.16666666666666666,5,5,GTCATACGTTCATTCTATTC,0,1550934
galEp3,0.16666666666666666,5,5,GTCAGACGCCTTACTGTTGA,0,1561436
galEp3,0.16666666666666666,5,5,GTCACATGGTAATAGCATAA,0,1547797
galEp3,0.16666666666666666,5,5,GTCAAGTCGGCAGAATACAG,0,1590798
galEp3,0.16666666666666666,5,5,GTCAAGGCATCGTTTGGTAG,0,1583383
galEp3,0.16666666666666666,5,5,GTATTCGTAGGGCCGTCACT,0,1592373
galEp3,0.16666666666666666,5,5,GTATTCGGTTATGTGCAAAG,0,1556173
galEp3,0.16666666666666666,5,5,GTATTATCGAAGTACTAAGC,0,1553935
galEp3,0.16666666666666666,5,5,GTATCGATATCTGCCATTGT,0,1567844
galEp3,0.16666666666666666,5,5,GTATCCTTTTGGCCAAACTT,0,1571714
galEp3,0.16666666666666666,5,5,GTATAACTGTGTCCCGGCTA,0,1589438
galEp3,0.16666666666666666,5,5,GTAGGTACCGCCAGGTGCAA,0,1589048
galEp3,0.16666666666666666,5,5,GTAGCATCAATTTTTGTGAA,0,1583505
galEp3,0.16666666666666666,5,5,GTAGACGGATGGGTTGTTAG,0,1559430
galEp3,0.16666666666666666,5,5,GTAGAATATGGTCAGGCGTT,0,1577646
galEp3,0.16666666666666666,5,5,GTACAGTGCATCTTACAGCT,0,1558516
galEp3,0.16666666666666666,5,5,GTAATAGTTATCTCGCGTTC,0,1569290
galEp3,0.16666666666666666,5,5,GTAAGGTCAACGAACCTCAT,0,1551942
galEp3,0.16666666666666666,5,5,GTAAGGCAAAATAGCGGCCG,0,1571769
galEp3,0.16666666666666666,5,5,GTAACACTCTACGCAACTAA,0,1567281
galEp3,0.16666666666666666,5,5,GTAAATCGGGCATTCTCGTT,0,1568847
galEp3,0.16666666666666666,5,5,GGTGTATAAAACCTCTGAAA,0,1571892
galEp3,0.16666666666666666,5,5,GGTGTACAGCGCGGTAGCAT,0,1578122
galEp3,0.16666666666666666,5,5,GGTCGGTCTAGCGCGGACGG,0,1578457
galEp3,0.16666666666666666,5,5,GGTCGAGTGAGATAACCGGT,0,1578940
galEp3,0.16666666666666666,5,5,GGTCCGTTTTAATGGAGTTA,0,1570193
galEp3,0.16666666666666666,5,5,GGTCACACGCTTCGAGGTCC,0,1568202
galEp3,0.16666666666666666,5,5,GGTAAGCGGGTTATACACGC,0,1586746
galEp3,0.16666666666666666,5,5,GGGTTGAGCAATCACGTAAC,0,1584504
galEp3,0.16666666666666666,5,5,GGGTTCGGAATTTTCAACAT,0,1548863
galEp3,0.16666666666666666,5,5,GGGTTAAGGCAAATGACAAA,0,1554804
galEp3,0.16666666666666666,5,5,GGGTGCAGGGTGGTGATTGA,0,1574810
galEp3,0.16666666666666666,5,5,GGGTAGGAACCTCGCCACTG,0,1551422
galEp3,0.16666666666666666,5,5,GGGGGAGTTTAGATAGCCAA,0,1571881
galEp3,0.16666666666666666,5,5,GGGGGACCCGAGTTGAGCTT,0,1565136
galEp3,0.16666666666666666,5,5,GGGGCACGGATATCGTATTT,0,1557696
galEp3,0.16666666666666666,5,5,GGGGACCACTCTCAGTGGGG,0,1566302
galEp3,0.16666666666666666,5,5,GGGCTTTGTGGTGATATCCT,0,1563714
galEp3,0.16666666666666666,5,5,GGGCGTCGAGAAGGAGTATT,0,1565868
galEp3,0.16666666666666666,5,5,GGGCGAGTTACGCACACGCA,0,1547559
galEp3,0.16666666666666666,5,5,GGGCCTATCAAGGGACCCTC,0,1559991
galEp3,0.16666666666666666,5,5,GGGATTGATTACGTTTTATA,0,1548302
galEp3,0.16666666666666666,5,5,GGGATGGATACTGAAGCGGT,0,1547555
galEp3,0.16666666666666666,5,5,GGGATATCTTTTAGTTACCA,0,1560806
galEp3,0.16666666666666666,5,5,GGGATACGCACACGGTACGT,0,1579476
galEp3,0.16666666666666666,5,5,GGGACTCATCTAATCTACCT,0,1577740
galEp3,0.16666666666666666,5,5,GGGACAGAGACCATCACCGT,0,1594059
galEp3,0.16666666666666666,5,5,GGGAATATAGGTTGCATTAT,0,1556309
galEp3,0.16666666666666666,5,5,GGGAAGGCCTGGCGCACGGA,0,1580314
galEp3,0.16666666666666666,5,5,GGCTTGTCTAGGGGTTACGT,0,1590196
galEp3,0.16666666666666666,5,5,GGCTTCCGTTGATGGGGAGT,0,1571606
galEp3,0.16666666666666666,5,5,GGCTGGAGGGTAGATCCTAA,0,1579035
galEp3,0.16666666666666666,5,5,GGCTGAATCGTATGGTGTTA,0,1546874
galEp3,0.16666666666666666,5,5,GGCGTGCGGCTGCGCGGCTA,0,1583616
galEp3,0.16666666666666666,5,5,GGCGTGCATGTGTATGGGTT,0,1548028
galEp3,0.16666666666666666,5,5,GGCGACGAGGGATCCGAACC,0,1567608
galEp3,0.16666666666666666,5,5,GGCCTAGTGTTTACCTAGCG,0,1563950
galEp3,0.16666666666666666,5,5,GGCCCTTCATTATGGATTAG,0,1584445
galEp3,0.16666666666666666,5,5,GGCCACTGGGCGCTGCCTTA,0,1588784
galEp3,0.16666666666666666,5,5,GGCACTGTTTTTGTAGGAGT,0,1568813
galEp3,0.16666666666666666,5,5,GGCACTAAGATCCTCCTGAC,0,1582502
galEp3,0.16666666666666666,5,5,GGCACCCATCATGCTTATCG,0,1582843
galEp3,0.16666666666666666,5,5,GGATTTGCGCTGCACATACT,0,1552586
galEp3,0.16666666666666666,5,5,GGATTCGAACCGAGTATTGT,0,1575600
galEp3,0.16666666666666666,5,5,GGAGTACTTCGAAGCTAGAT,0,1571804
galEp3,0.16666666666666666,5,5,GGAGGGCAGGCTCCAGTGGA,0,1558817
galEp3,0.16666666666666666,5,5,GGAGAGGTCGTGAGGGGAGC,0,1574445
galEp3,0.16666666666666666,5,5,GGACTTGGCCGGTGCGAGTA,0,1560793
galEp3,0.16666666666666666,5,5,GGACTGCTTATTTTCGAGGA,0,1573007
galEp3,0.16666666666666666,5,5,GGACGCGGTGCCAGATCGTA,0,1585559
galEp3,0.16666666666666666,5,5,GGACCCTCAGCTTAAGGAGG,0,1568542
galEp3,0.16666666666666666,5,5,GGACATTCCATTTAATGTCA,0,1549325
galEp3,0.16666666666666666,5,5,GGAAGGCAATGAATTATGGA,0,1591910
galEp3,0.16666666666666666,5,5,GGAAATCACGCTCAGGCTCG,0,1573220
galEp3,0.16666666666666666,5,5,GGAAAATCTATGCTAAGCCT,0,1569810
galEp3,0.16666666666666666,5,5,GGAAAAGGGTTATGTTCATA,0,1562061
galEp3,0.16666666666666666,5,5,GCTTCTTCGAAGACGGGCGT,0,1590058
galEp3,0.16666666666666666,5,5,GCTTCCTATGAGGTTTACTG,0,1593783
galEp3,0.16666666666666666,5,5,GCTTATGTATGGGCTTGCAG,0,1589615
galEp3,0.16666666666666666,5,5,GCTGGGTCGCATCCCCAGGA,0,1587473
galEp3,0.16666666666666666,5,5,GCTGGGCCGATAAGACCGTG,0,1585434
galEp3,0.16666666666666666,5,5,GCTCGGGCCGGATCTCGTTA,0,1562939
galEp3,0.16666666666666666,5,5,GCTCCGCAACGCACGTCAAG,0,1561277
galEp3,0.16666666666666666,5,5,GCTCAGATTCGGGTGGCTAG,0,1571113
galEp3,0.16666666666666666,5,5,GCTATGAGGTTTTGGCACCA,0,1550145
galEp3,0.16666666666666666,5,5,GCTACGAACGCGTGCTTGAG,0,1575598
galEp3,0.16666666666666666,5,5,GCGTTTGGTACGGGTGAAGC,0,1551878
galEp3,0.16666666666666666,5,5,GCGTCTTATTAATTAGTTGT,0,1574908
galEp3,0.16666666666666666,5,5,GCGTCTATCCGAATTTTACA,0,1583684
galEp3,0.16666666666666666,5,5,GCGTCAACGCGCACCTGGGC,0,1572623
galEp3,0.16666666666666666,5,5,GCGTATTCATAGGGGGGGGT,0,1564571
galEp3,0.16666666666666666,5,5,GCGGCCGACCGAACCCTTCA,0,1559664
galEp3,0.16666666666666666,5,5,GCGGACATGCATGCCCGTCT,0,1565602
galEp3,0.16666666666666666,5,5,GCGCTTATTAATCGGACGCT,0,1584602
galEp3,0.16666666666666666,5,5,GCGCTCAACATGCAAGGTAC,0,1553587
galEp3,0.16666666666666666,5,5,GCGCAGGTTCGTCCGCTTGT,0,1589151
galEp3,0.16666666666666666,5,5,GCGCAGCAACCACGGATCGG,0,1578588
galEp3,0.16666666666666666,5,5,GCGCAGACTCAGTAAAAGGC,0,1548503
galEp3,0.16666666666666666,5,5,GCGCACCTGAGAGTGACAGC,0,1582772
galEp3,0.16666666666666666,5,5,GCGATGGATGTTGCATGCCT,0,1559637
galEp3,0.16666666666666666,5,5,GCGAGCATCTGGCTGCTTAG,0,1567510
galEp3,0.16666666666666666,5,5,GCGAAAGCCCTACCTAACGA,0,1569704
galEp3,0.16666666666666666,5,5,GCCTTGTGCTTTTCCCCGGC,0,1577284
galEp3,0.16666666666666666,5,5,GCCTGCTTCGATTCAGGCAG,0,1556782
galEp3,0.16666666666666666,5,5,GCCTGAGTCTAGCCGCGTTA,0,1587852
galEp3,0.16666666666666666,5,5,GCCTCCAGTCGATTTTTTGT,0,1565645
galEp3,0.16666666666666666,5,5,GCCTAGATTACTGTCCGAAC,0,1556847
galEp3,0.16666666666666666,5,5,GCCTAACATGACCTTTTGGA,0,1572072
galEp3,0.16666666666666666,5,5,GCCGTAAGCAAAAAAAATAT,0,1546674
galEp3,0.16666666666666666,5,5,GCCGACATAACTCCGTGGCG,0,1592351
galEp3,0.16666666666666666,5,5,GCCGAATTATTTAAGTGATT,0,1590738
galEp3,0.16666666666666666,5,5,GCCCTCTCTCATGCCTGGAA,0,1579288
galEp3,0.16666666666666666,5,5,GCCCCCGATGCCCCTGTGTA,0,1555172
galEp3,0.16666666666666666,5,5,GCCATTTCGCGATCAAAGCA,0,1557599
galEp3,0.16666666666666666,5,5,GCCATCACGACTTGGCGTTG,0,1556198
galEp3,0.16666666666666666,5,5,GCCAGCCAACTAACTTTAAA,0,1577395
galEp3,0.16666666666666666,5,5,GCCAATGTCAGACCCCATAG,0,1566944
galEp3,0.16666666666666666,5,5,GCATTTACAGATCGGTGGAT,0,1547374
galEp3,0.16666666666666666,5,5,GCATTGCAGAAATCGAGTCA,0,1554485
galEp3,0.16666666666666666,5,5,GCATGAGCTACCTTAGTCTT,0,1552698
galEp3,0.16666666666666666,5,5,GCAGCTTATGGGTTTGATAC,0,1580081
galEp3,0.16666666666666666,5,5,GCAGCATTCCTGTATATAAG,0,1571084
galEp3,0.16666666666666666,5,5,GCACTTTGAACTAACATGTC,0,1578341
galEp3,0.16666666666666666,5,5,GCACTTGAATTCTCGTTTCT,0,1589913
galEp3,0.16666666666666666,5,5,GCACAGTCTACGTCCAGATG,0,1573919
galEp3,0.16666666666666666,5,5,GCACACAGTCTGTGTCTTTC,0,1571756
galEp3,0.16666666666666666,5,5,GATTTTTACCTCGACCCGGC,0,1566297
galEp3,0.16666666666666666,5,5,GATTTGTAAGGGCAAGCTCT,0,1569315
galEp3,0.16666666666666666,5,5,GATTTCCTGGTCAAGAAATG,0,1577701
galEp3,0.16666666666666666,5,5,GATTGTTAGCCTATTTGAGC,0,1554505
galEp3,0.16666666666666666,5,5,GATTGCACCCGGCGTCATAA,0,1566463
galEp3,0.16666666666666666,5,5,GATTCGGACTTAGCGTGTTG,0,1559195
galEp3,0.16666666666666666,5,5,GATTAGGGCCGCGGGTCCCA,0,1580539
galEp3,0.16666666666666666,5,5,GATTAAGTTGACAACCCGCA,0,1553465
galEp3,0.16666666666666666,5,5,GATGTTATCACTTGAATAGA,0,1548834
galEp3,0.16666666666666666,5,5,GATGTGGACCCTTGCGAGTC,0,1583776
galEp3,0.16666666666666666,5,5,GATGATATGCCTCACTGGTA,0,1568917
galEp3,0.16666666666666666,5,5,GATCTTCTGCACAGTCGTGA,0,1581368
galEp3,0.16666666666666666,5,5,GATCGTTATTTAAGTATCAA,0,1573026
galEp3,0.16666666666666666,5,5,GATCGCTTTTACACTTATGT,0,1547660
galEp3,0.16666666666666666,5,5,GATAGTCGGTATAGACTCAT,0,1547495
galEp3,0.16666666666666666,5,5,GATAGAACACTCGCCAGGGA,0,1580605
galEp3,0.16666666666666666,5,5,GATACTAAGATGCGCGAACG,0,1550736
galEp3,0.16666666666666666,5,5,GAGTGTTTCCTTAGTAAGCT,0,1560782
galEp3,0.16666666666666666,5,5,GAGTGTGATAGGGCATGCTA,0,1561172
galEp3,0.16666666666666666,5,5,GAGTAATGGCTAATCGTCGC,0,1568902
galEp3,0.16666666666666666,5,5,GAGGTTTACTGGAGTCGGTA,0,1570059
galEp3,0.16666666666666666,5,5,GAGGCCAAGCTGGTCTGGTT,0,1568547
galEp3,0.16666666666666666,5,5,GAGGATTAGGGTATCTAGGC,0,1573818
galEp3,0.16666666666666666,5,5,GAGGAGATTGCCTTTGACAT,0,1564237
galEp3,0.16666666666666666,5,5,GAGGAACTGGCGGATTTGCT,0,1548058
galEp3,0.16666666666666666,5,5,GAGCGCAATGATGCGCACCG,0,1564202
galEp3,0.16666666666666666,5,5,GAGATCAGGACGAGCCGCTC,0,1553953
galEp3,0.16666666666666666,5,5,GAGAGGAAGATGTGGGGCCG,0,1579466
galEp3,0.16666666666666666,5,5,GAGAGACTCGGGTAGGGCTT,0,1589294
galEp3,0.16666666666666666,5,5,GAGACTCTCCATCGTCGCGT,0,1592180
galEp3,0.16666666666666666,5,5,GAGACCAACCGCGACCCAAA,0,1568952
galEp3,0.16666666666666666,5,5,GACTCTGGTCTTGCGTTCAC,0,1584862
galEp3,0.16666666666666666,5,5,GACTCGCTCCCTTTCAATGA,0,1593699
galEp3,0.16666666666666666,5,5,GACTCGCATCCAATCGGCAT,0,1585733
galEp3,0.16666666666666666,5,5,GACTCGATGGAGCCTTAGCG,0,1581456
galEp3,0.16666666666666666,5,5,GACGCCTGCTTCGATCCGAT,0,1591821
galEp3,0.16666666666666666,5,5,GACCTGACTGCAATAGGTTC,0,1574163
galEp3,0.16666666666666666,5,5,GACCGACGTAAGATCTCTCC,0,1570478
galEp3,0.16666666666666666,5,5,GACCAGAGATATCTACTATG,0,1560080
galEp3,0.16666666666666666,5,5,GACATGTTCGGAGGCTCTCT,0,1546641
galEp3,0.16666666666666666,5,5,GACACCCCCGGCGAGACGAT,0,1574676
galEp3,0.16666666666666666,5,5,GACAACTAAGTTCTAGGAAT,0,1557635
galEp3,0.16666666666666666,5,5,GACAAAACGGGAGTATCAGG,0,1568898
galEp3,0.16666666666666666,5,5,GAATGTATGCTCCCAATGCT,0,1547002
galEp3,0.16666666666666666,5,5,GAATCGAGGTCTTTTGCGTA,0,1591366
galEp3,0.16666666666666666,5,5,GAATAATTGCGGGATCGCAT,0,1580043
galEp3,0.16666666666666666,5,5,GAAGTTAGTAAGAGTGCAAA,0,1579350
galEp3,0.16666666666666666,5,5,GAAGTGTGCAGTTAGAGTAT,0,1550928
galEp3,0.16666666666666666,5,5,GAACTCGGTACCTTGGCCAT,0,1556881
galEp3,0.16666666666666666,5,5,GAACCCGGGTACGATGCGTC,0,1579982
galEp3,0.16666666666666666,5,5,GAACAGGCCGCAGAAGCAGG,0,1565768
galEp3,0.16666666666666666,5,5,GAACACGGGCGTTAGCCCTC,0,1550974
galEp3,0.16666666666666666,5,5,GAAAGAATAACCAAATTTCC,0,1546877
galEp3,0.16666666666666666,5,5,GAAACGGTGACATTTGAGCA,0,1586411
galEp3,0.16666666666666666,5,5,GAAACCTTTATTACAAAACA,0,1586559
galEp3,0.16666666666666666,5,5,GAAACCTCGCTGCTAGTCGA,0,1560165
galEp3,0.16666666666666666,5,5,CTTTGGACTGTTCCATCTTC,0,1572385
galEp3,0.16666666666666666,5,5,CTTTCGGCCCTGAACCAGTT,0,1556752
galEp3,0.16666666666666666,5,5,CTTTCGCCAAGACGTGAGGA,0,1562146
galEp3,0.16666666666666666,5,5,CTTTCAAACGGTTTACACAA,0,1548727
galEp3,0.16666666666666666,5,5,CTTTAGCCCAATAGATAGCC,0,1582173
galEp3,0.16666666666666666,5,5,CTTGGTTATGTCCCGATATG,0,1568394
galEp3,0.16666666666666666,5,5,CTTGGGGGACGCCATGTTTA,0,1584447
galEp3,0.16666666666666666,5,5,CTTGCGCCGGATGGCTAGCA,0,1550573
galEp3,0.16666666666666666,5,5,CTTGAAGTTTGCGTTGGACT,0,1567389
galEp3,0.16666666666666666,5,5,CTTCGTCGTCAATGATACAG,0,1593024
galEp3,0.16666666666666666,5,5,CTTCGCAATTGATTTTTTAA,0,1586111
galEp3,0.16666666666666666,5,5,CTTCCCAGTCTGCGTACCCA,0,1557943
galEp3,0.16666666666666666,5,5,CTTCACTTCAGATGGCCGCA,0,1571831
galEp3,0.16666666666666666,5,5,CTTATTTTTATATGCGCGTT,0,1557606
galEp3,0.16666666666666666,5,5,CTTATAGTGTTTCGTATTCC,0,1550903
galEp3,0.16666666666666666,5,5,CTTACTCCACGTATTTGTTA,0,1584054
galEp3,0.16666666666666666,5,5,CTGTGTTTACAAGCATGCTC,0,1588489
galEp3,0.16666666666666666,5,5,CTGTCATCTGCCCGCTCAAT,0,1592496
galEp3,0.16666666666666666,5,5,CTGGGGGAGCAATGACCCCT,0,1566288
galEp3,0.16666666666666666,5,5,CTGGCTGATAGATGCGCCCC,0,1574834
galEp3,0.16666666666666666,5,5,CTGGCCAACGAAGGTCTTGG,0,1595122
galEp3,0.16666666666666666,5,5,CTGGAATAGGAGAACTTCAT,0,1576765
galEp3,0.16666666666666666,5,5,CTGCTCGCTCGACCTTCGCT,0,1584852
galEp3,0.16666666666666666,5,5,CTGCCCGCGCAGTGTGTGTT,0,1548382
galEp3,0.16666666666666666,5,5,CTGATTCACGTATGCTGGTC,0,1547575
galEp3,0.16666666666666666,5,5,CTGATCCTACACACAAGCGT,0,1592342
galEp3,0.16666666666666666,5,5,CTGAGCGTAAACGACCACGT,0,1584791
galEp3,0.16666666666666666,5,5,CTGACTTTGAAGTTTGCGGT,0,1555467
galEp3,0.16666666666666666,5,5,CTGAAGGAGATTCGGTGGGG,0,1560197
galEp3,0.16666666666666666,5,5,CTCTTCGGTCTGCTCCTCAC,0,1569569
galEp3,0.16666666666666666,5,5,CTCTTCCTGCCGAACGACTG,0,1563425
galEp3,0.16666666666666666,5,5,CTCTGTAGTGTCCTTCGGTC,0,1559107
galEp3,0.16666666666666666,5,5,CTCTCGCTAGAGTAGCGGCA,0,1573648
galEp3,0.16666666666666666,5,5,CTCTACTCGGACTTTCCGAA,0,1556409
galEp3,0.16666666666666666,5,5,CTCGTTCTTACAACTGTCTC,0,1581173
galEp3,0.16666666666666666,5,5,CTCGGCCCCCTTGTTCCACA,0,1547847
galEp3,0.16666666666666666,5,5,CTCGGATGTCGGGCAGCCTT,0,1546648
galEp3,0.16666666666666666,5,5,CTCGAATGTTGGCAATTATA,0,1551289
galEp3,0.16666666666666666,5,5,CTCGAAACACCATTAGCTTT,0,1551981
galEp3,0.16666666666666666,5,5,CTCCGTCTCTGACCTATCTA,0,1548807
galEp3,0.16666666666666666,5,5,CTCCCCAAGCCTACGCGATA,0,1553484
galEp3,0.16666666666666666,5,5,CTCCAAGTCTTTATTAACAG,0,1567764
galEp3,0.16666666666666666,5,5,CTCAGGGTTCTCACAAATTC,0,1547040
galEp3,0.16666666666666666,5,5,CTCACTGAAGATCAAGAGTG,0,1568914
galEp3,0.16666666666666666,5,5,CTCACCTGCATTGAGCTAGG,0,1585184
galEp3,0.16666666666666666,5,5,CTCACCGAGGATGAAGGCTG,0,1549236
galEp3,0.16666666666666666,5,5,CTATTGTGCGGGCCACTGGA,0,1558378
galEp3,0.16666666666666666,5,5,CTAGTATGCCAGAGGTCCTC,0,1547224
galEp3,0.16666666666666666,5,5,CTAGGTATTCGTGAGCCGCT,0,1550603
galEp3,0.16666666666666666,5,5,CTAGGCTGTTAGTGGCGTTT,0,1565459
galEp3,0.16666666666666666,5,5,CTAGATAGCGGGCTTAGAGT,0,1585930
galEp3,0.16666666666666666,5,5,CTACTGGCTTGGGTTATGTC,0,1586549
galEp3,0.16666666666666666,5,5,CTACAAGGACGGCAGAGACA,0,1561964
galEp3,0.16666666666666666,5,5,CTAATTTTTAATGTCATTGC,0,1569785
galEp3,0.16666666666666666,5,5,CTAAAAAGGGTGCGGGATAT,0,1592544
galEp3,0.16666666666666666,5,5,CGTTTTTTTGGATCCTCTCG,0,1564280
galEp3,0.16666666666666666,5,5,CGTTTAGGGCTTCAGTCCGA,0,1549727
galEp3,0.16666666666666666,5,5,CGTTGGAACTATAATATGTC,0,1582545
galEp3,0.16666666666666666,5,5,CGTTATTGTTGTGCACTCAT,0,1580900
galEp3,0.16666666666666666,5,5,CGTGTTATGTGTCTCAATTG,0,1573914
galEp3,0.16666666666666666,5,5,CGTGTCCCCTCGACCAGTGG,0,1557798
galEp3,0.16666666666666666,5,5,CGTGGGTCCCCTACTCGTTT,0,1567400
galEp3,0.16666666666666666,5,5,CGTGGCGCCCATCGGGGGGA,0,1577592
galEp3,0.16666666666666666,5,5,CGTGGAATGCAACATAAACT,0,1548235
galEp3,0.16666666666666666,5,5,CGTGCCATCCGCCTAGGGTC,0,1566417
galEp3,0.16666666666666666,5,5,CGTGCAGGGAGGGGTCTCTG,0,1559395
galEp3,0.16666666666666666,5,5,CGTGACAAGTTAATCATGAC,0,1568735
galEp3,0.16666666666666666,5,5,CGTGAATAGGCGAGTCCACA,0,1585476
galEp3,0.16666666666666666,5,5,CGTCTTACCACGCTTTGAAT,0,1594797
galEp3,0.16666666666666666,5,5,CGTCTGGGTGGTTTAGGATA,0,1561478
galEp3,0.16666666666666666,5,5,CGTCTCTGGGGTCGGTTATT,0,1565210
galEp3,0.16666666666666666,5,5,CGTCTCACCACTCTGGCGTG,0,1581334
galEp3,0.16666666666666666,5,5,CGTCGAAATTAAGAAAGGTT,0,1558849
galEp3,0.16666666666666666,5,5,CGTCCGCATCATTCGTTTAC,0,1589086
galEp3,0.16666666666666666,5,5,CGTCACCGAAGACCCGTATA,0,1567678
galEp3,0.16666666666666666,5,5,CGTATCCTCATGCTAACAAG,0,1547829
galEp3,0.16666666666666666,5,5,CGGTTAGGCTGTATCGGGAG,0,1590769
galEp3,0.16666666666666666,5,5,CGGTTAGCCATAAAAATTAG,0,1568147
galEp3,0.16666666666666666,5,5,CGGTGCGTAACTCGTCAGTA,0,1591739
galEp3,0.16666666666666666,5,5,CGGTAGGTTTCTTCTTCCTC,0,1573249
galEp3,0.16666666666666666,5,5,CGGGTGTTGAGAGGTAAGAC,0,1566715
galEp3,0.16666666666666666,5,5,CGGGTGTAGCATCACCGGTA,0,1547508
galEp3,0.16666666666666666,5,5,CGGGTGAGCCGCTGGTAATA,0,1561961
galEp3,0.16666666666666666,5,5,CGGGGGACGCGAAAAGCTTA,0,1592433
galEp3,0.16666666666666666,5,5,CGGGCAGTGTCGGTGCCGTA,0,1566427
galEp3,0.16666666666666666,5,5,CGGCTTGTCGTTGGTTGGTG,0,1593374
galEp3,0.16666666666666666,5,5,CGGCGGTTGACGGGTTCAAA,0,1581785
galEp3,0.16666666666666666,5,5,CGGCATGTCACCGGACGAGC,0,1554635
galEp3,0.16666666666666666,5,5,CGGCAATCCATTTACGTCGG,0,1562693
galEp3,0.16666666666666666,5,5,CGGCAAATCTCAATGCTCCC,0,1581508
galEp3,0.16666666666666666,5,5,CGGAGGTAATTAGCATGGTG,0,1574602
galEp3,0.16666666666666666,5,5,CGGAGCTCCAACCACCGACA,0,1560748
galEp3,0.16666666666666666,5,5,CGGAGAGAGGCAGAGATCAG,0,1558479
galEp3,0.16666666666666666,5,5,CGCTGTTTTTACGATATCGT,0,1591532
galEp3,0.16666666666666666,5,5,CGCTGTCTGAGCCCTTCTAT,0,1546745
galEp3,0.16666666666666666,5,5,CGCTATATGATCTGAAGCCA,0,1556120
galEp3,0.16666666666666666,5,5,CGCGCTTTGCCGCTCCGAAG,0,1587983
galEp3,0.16666666666666666,5,5,CGCGCGGGATATACCTAAGG,0,1555762
galEp3,0.16666666666666666,5,5,CGCCTCCCGATTGTTGATGC,0,1555968
galEp3,0.16666666666666666,5,5,CGCCGACGACGGTAGAGTAA,0,1570033
galEp3,0.16666666666666666,5,5,CGCCCTGGCGATTATGGGCG,0,1551749
galEp3,0.16666666666666666,5,5,CGCCCTGGCCAGCAATTATA,0,1549790
galEp3,0.16666666666666666,5,5,CGCCCCTAGATGCCGACTAT,0,1552060
galEp3,0.16666666666666666,5,5,CGCCCCGTTTGTCTGTCCGA,0,1551465
galEp3,0.16666666666666666,5,5,CGCCCATGTGAGGCTCCGCA,0,1577942
galEp3,0.16666666666666666,5,5,CGCATTTAGTGTGGTTAGAG,0,1550667
galEp3,0.16666666666666666,5,5,CGCACTCCCAAGCGGGTCAT,0,1563958
galEp3,0.16666666666666666,5,5,CGCACCTACCTCGTTAGGGA,0,1548557
galEp3,0.16666666666666666,5,5,CGCAAGAACCCGGACCGGCG,0,1585081
galEp3,0.16666666666666666,5,5,CGATTTTATTATAACTGAGA,0,1586563
galEp3,0.16666666666666666,5,5,CGATGTTATTCAGTGGGGGT,0,1554176
galEp3,0.16666666666666666,5,5,CGATGGGTAAGGACGATTGG,0,1578754
galEp3,0.16666666666666666,5,5,CGATATTGGGATAGGAGCTC,0,1594551
galEp3,0.16666666666666666,5,5,CGAGGACGCGCCCCATCTAA,0,1549576
galEp3,0.16666666666666666,5,5,CGAGATGTCCGGCTGCTGGG,0,1577635
galEp3,0.16666666666666666,5,5,CGACGGTGAATGCCACCGGT,0,1580247
galEp3,0.16666666666666666,5,5,CGAAGTTGTGTCGATAGATG,0,1573715
galEp3,0.16666666666666666,5,5,CGAACACTTGATGGCGTAAA,0,1593333
galEp3,0.16666666666666666,5,5,CGAAACTGGGGTAGTAGGAC,0,1550109
galEp3,0.16666666666666666,5,5,CCTTGTAGATACGGAGTTCT,0,1547044
galEp3,0.16666666666666666,5,5,CCTTGCCCCGGCCTGCTGGC,0,1567540
galEp3,0.16666666666666666,5,5,CCTTACCTGACGGGTGGGAT,0,1552898
galEp3,0.16666666666666666,5,5,CCTGTAGTCCTGAATTTCTG,0,1564314
galEp3,0.16666666666666666,5,5,CCTGGTTTGGCTACCGGGTA,0,1547242
galEp3,0.16666666666666666,5,5,CCTGGTACGCATACGCCATG,0,1573283
galEp3,0.16666666666666666,5,5,CCTGCGGATAACCGCCTGGG,0,1579041
galEp3,0.16666666666666666,5,5,CCTGACGCTCCTTGAGGGTT,0,1556532
galEp3,0.16666666666666666,5,5,CCTCACTTGCCAGGGGTGAC,0,1556485
galEp3,0.16666666666666666,5,5,CCTCAAGTAGAGCCCCTGCA,0,1564655
galEp3,0.16666666666666666,5,5,CCGTTTCGTATTTCCAGATA,0,1576806
galEp3,0.16666666666666666,5,5,CCGTTAGGATGTAGGGACGT,0,1557578
galEp3,0.16666666666666666,5,5,CCGTATCCGCTAGGATGGGA,0,1551970
galEp3,0.16666666666666666,5,5,CCGTAGGGCGTTCCCTTCGG,0,1563260
galEp3,0.16666666666666666,5,5,CCGTAATGCCGCCCCAGAGT,0,1552687
galEp3,0.16666666666666666,5,5,CCGGTGCGAGACCTTATCAG,0,1573277
galEp3,0.16666666666666666,5,5,CCGGTCTGTCGAGGCCTTAG,0,1582781
galEp3,0.16666666666666666,5,5,CCGGTCGCAGGACGGCCTCT,0,1581481
galEp3,0.16666666666666666,5,5,CCGGGTGAGAGAGTATTATC,0,1587730
galEp3,0.16666666666666666,5,5,CCGGGAGGCTTCCACCACAC,0,1575077
galEp3,0.16666666666666666,5,5,CCGGATTTTTTGTGTAGCTG,0,1574393
galEp3,0.16666666666666666,5,5,CCGGAATCGTCGTCCTCTGC,0,1566005
galEp3,0.16666666666666666,5,5,CCGCGGGAATTAGCCTATCA,0,1576752
galEp3,0.16666666666666666,5,5,CCGCCAGTGCGTGTAAACGT,0,1582013
galEp3,0.16666666666666666,5,5,CCGCCACTTGGACCGCACCG,0,1554610
galEp3,0.16666666666666666,5,5,CCGCACATTTCGGATCTCTG,0,1579761
galEp3,0.16666666666666666,5,5,CCGAGTAAATGGGAGCCAGG,0,1594208
galEp3,0.16666666666666666,5,5,CCGAGCCTCAAGAAGTCCCG,0,1586716
galEp3,0.16666666666666666,5,5,CCGACTATGGTCGAGTGGAA,0,1565591
galEp3,0.16666666666666666,5,5,CCGACTATCTCCGTACGTAT,0,1552893
galEp3,0.16666666666666666,5,5,CCGAAATGACATCCACTGAC,0,1563102
galEp3,0.16666666666666666,5,5,CCGAAAGAAGGACGGACTGG,0,1579733
galEp3,0.16666666666666666,5,5,CCCTGGTACTTCCGCCGTCC,0,1559910
galEp3,0.16666666666666666,5,5,CCCTGCGCGGAAAGAACTCA,0,1559671
galEp3,0.16666666666666666,5,5,CCCTGCGAGTGATGCGTAGA,0,1583483
galEp3,0.16666666666666666,5,5,CCCTCTGCGCTTCGGTAGGA,0,1554870
galEp3,0.16666666666666666,5,5,CCCTCCATGCGGAAACCTAG,0,1582753
galEp3,0.16666666666666666,5,5,CCCGCCCTACGCCGCTTTAT,0,1560959
galEp3,0.16666666666666666,5,5,CCCCGTTTTCCGAATTAAGT,0,1584116
galEp3,0.16666666666666666,5,5,CCCATCACAGCTGCCACAAA,0,1588981
galEp3,0.16666666666666666,5,5,CCCAATTCCCTTGAAACAAT,0,1551757
galEp3,0.16666666666666666,5,5,CCATGTGGATTAGAGTGGAC,0,1581714
galEp3,0.16666666666666666,5,5,CCATCTAGGGTTGAACAGGA,0,1550193
galEp3,0.16666666666666666,5,5,CCATCTAGGGACCAATGTAA,0,1564796
galEp3,0.16666666666666666,5,5,CCATATATGTCAACGATGAA,0,1552213
galEp3,0.16666666666666666,5,5,CCAGGCCCACACCAGCCAGT,0,1585950
galEp3,0.16666666666666666,5,5,CCAGCTGTTTTAACGCTCCA,0,1567147
galEp3,0.16666666666666666,5,5,CCAGCGGCCAATGTGGGACA,0,1551424
galEp3,0.16666666666666666,5,5,CCAGCCTGATCAGACTCGTT,0,1579233
galEp3,0.16666666666666666,5,5,CCAGATTCGTGCATGTTTCT,0,1554205
galEp3,0.16666666666666666,5,5,CCACGTACGCTATATGACTG,0,1592842
galEp3,0.16666666666666666,5,5,CCACGATCAACGGGGGTTTT,0,1568251
galEp3,0.16666666666666666,5,5,CCACCGGTCACAGCAGGTTC,0,1584426
galEp3,0.16666666666666666,5,5,CCACACTACCGTCTAAAGTG,0,1584215
galEp3,0.16666666666666666,5,5,CCACACCCTCCTTAGGAAAT,0,1546707
galEp3,0.16666666666666666,5,5,CCAATTGGGAGGGTAGCTCA,0,1591463
galEp3,0.16666666666666666,5,5,CCAATGGGTTAGGATCATGC,0,1585318
galEp3,0.16666666666666666,5,5,CCAAGCCATGGCACAGTGGC,0,1548042
galEp3,0.16666666666666666,5,5,CCAACGTTGAAGAAAGCTTG,0,1592771
galEp3,0.16666666666666666,5,5,CCAAACTTTCGAGGTCGGTG,0,1581394
galEp3,0.16666666666666666,5,5,CATTGTTTACTAAACGACAT,0,1562478
galEp3,0.16666666666666666,5,5,CATTCGTCACACGCCGGCTA,0,1581520
galEp3,0.16666666666666666,5,5,CATTCACCATAGACCGGTTA,0,1575652
galEp3,0.16666666666666666,5,5,CATGTATCGAATGGAGTGGG,0,1546848
galEp3,0.16666666666666666,5,5,CATGTAAGGGGATCCTTTGC,0,1572711
galEp3,0.16666666666666666,5,5,CATGGGCTAGACCAAGTACG,0,1581562
galEp3,0.16666666666666666,5,5,CATGCGCCAGTATTTAGCTT,0,1574450
galEp3,0.16666666666666666,5,5,CATGATTCTATATGCTTGAC,0,1563094
galEp3,0.16666666666666666,5,5,CATGAGTCCCCGAGTTCGTG,0,1568785
galEp3,0.16666666666666666,5,5,CATCTGCGTAAAATTTGTTA,0,1561069
galEp3,0.16666666666666666,5,5,CATCTCTCTACTACAGTACA,0,1558910
galEp3,0.16666666666666666,5,5,CATCCTCACTAGCTCCGATG,0,1584565
galEp3,0.16666666666666666,5,5,CATCAGATTAAATAAAGGCA,0,1550416
galEp3,0.16666666666666666,5,5,CATCACGCCTTATTGGAGCA,0,1587862
galEp3,0.16666666666666666,5,5,CATAAGCTTCAATGTAGACT,0,1567435
galEp3,0.16666666666666666,5,5,CATAACGCGTGTAAGGGCGA,0,1550359
galEp3,0.16666666666666666,5,5,CAGTTATCAGAGCCTACCCC,0,1550648
galEp3,0.16666666666666666,5,5,CAGTTACAGGACTTTCAACC,0,1590141
galEp3,0.16666666666666666,5,5,CAGTGTGACGCTGAAGTCCA,0,1561813
galEp3,0.16666666666666666,5,5,CAGTAAGCAATAGTGTATAT,0,1558517
galEp3,0.16666666666666666,5,5,CAGGTACCAGTGTCCAGCCT,0,1558563
galEp3,0.16666666666666666,5,5,CAGGGCAACTCGATGAAGGT,0,1564875
galEp3,0.16666666666666666,5,5,CAGGGACATGTTGGAGAATC,0,1551905
galEp3,0.16666666666666666,5,5,CAGGAGTAAAAAGCGAGACC,0,1565604
galEp3,0.16666666666666666,5,5,CAGACCATATACTCTTAAGG,0,1588582
galEp3,0.16666666666666666,5,5,CAGAACTTGTCTTGTAGCAA,0,1569921
galEp3,0.16666666666666666,5,5,CAGAACCTAATGGACTTCGT,0,1568448
galEp3,0.16666666666666666,5,5,CAGAACACTGTAGTCATAGA,0,1559862
galEp3,0.16666666666666666,5,5,CACTTATAACCCCAATTTTT,0,1560465
galEp3,0.16666666666666666,5,5,CACTAGCGAACTGCGAAAAA,0,1565742
galEp3,0.16666666666666666,5,5,CACTAAGTCTCAAGTTTAAG,0,1594919
galEp3,0.16666666666666666,5,5,CACGGAGTACTATTGCGTGC,0,1547264
galEp3,0.16666666666666666,5,5,CACGCGCTAGGACTTATGAT,0,1559300
galEp3,0.16666666666666666,5,5,CACGACAACGCAGCCATACG,0,1571202
galEp3,0.16666666666666666,5,5,CACATTGAGTATGGTGTTTT,0,1554542
galEp3,0.16666666666666666,5,5,CACATGTTCAGATAATGCGC,0,1577063
galEp3,0.16666666666666666,5,5,CACAGGCTTAGTTGGCGCGT,0,1553164
galEp3,0.16666666666666666,5,5,CACACCAGAACGATGCGCTT,0,1567502
galEp3,0.16666666666666666,5,5,CACACAGTGTTCCCAGGTGA,0,1573617
galEp3,0.16666666666666666,5,5,CACAAAATCATTACACGAGA,0,1572719
galEp3,0.16666666666666666,5,5,CAATTATGCTGTTTTACACG,0,1594472
galEp3,0.16666666666666666,5,5,CAATGCAGTGTTGGGTACTG,0,1579468
galEp3,0.16666666666666666,5,5,CAATCCCCCATTTATCTCTA,0,1555878
galEp3,0.16666666666666666,5,5,CAATAGAATTCCTACGTGAT,0,1566513
galEp3,0.16666666666666666,5,5,CAAGTTAGAGAAATGCGCCA,0,1580648
galEp3,0.16666666666666666,5,5,CAAGTGAAGAGGCTCGCAAT,0,1593622
galEp3,0.16666666666666666,5,5,CAAGTAGCGTACGATGTATA,0,1549875
galEp3,0.16666666666666666,5,5,CAAGTAATTGTGATAATCCG,0,1551483
galEp3,0.16666666666666666,5,5,CAAGGCTAAGAGATCCATCA,0,1582440
galEp3,0.16666666666666666,5,5,CAACTCATGGTCTATGCCGT,0,1565796
galEp3,0.16666666666666666,5,5,CAACTACGGTAGCGTGAATC,0,1567329
galEp3,0.16666666666666666,5,5,CAACGTAACTTCCGACCCCC,0,1577488
galEp3,0.16666666666666666,5,5,CAACCCAAACCGGATCTAAA,0,1558433
galEp3,0.16666666666666666,5,5,CAAATGTCCCGTATGGCGAC,0,1565510
galEp3,0.16666666666666666,5,5,CAAAGAATGATTCGTACTAA,0,1575181
galEp3,0.16666666666666666,5,5,CAAACCTGCGCACTATTGTC,0,1550522
galEp3,0.16666666666666666,5,5,CAAAAGGGCATGCACGCAAC,0,1553779
galEp3,0.16666666666666666,5,5,CAAAACGAGCAGTGTAACAG,0,1586032
galEp3,0.16666666666666666,5,5,ATTTTTCGGTGAGAACCCAT,0,1574675
galEp3,0.16666666666666666,5,5,ATTTTACAATTCGAGCCCGT,0,1551404
galEp3,0.16666666666666666,5,5,ATTTTAATGGAACCTTCCGC,0,1550343
galEp3,0.16666666666666666,5,5,ATTTTAAGAGCCCGAGCACA,0,1584866
galEp3,0.16666666666666666,5,5,ATTTGGTTGCAACACATGCT,0,1557292
galEp3,0.16666666666666666,5,5,ATTTGGCTGGAAAGGAGGCT,0,1585943
galEp3,0.16666666666666666,5,5,ATTTGCTAAAGAGGTCTTGT,0,1583039
galEp3,0.16666666666666666,5,5,ATTTCCAAAGCTCGCGAGGA,0,1558183
galEp3,0.16666666666666666,5,5,ATTGGCTCACCCAGCCCTCA,0,1551919
galEp3,0.16666666666666666,5,5,ATTGCCCCTCGGTGCTGTCA,0,1548104
galEp3,0.16666666666666666,5,5,ATTGAAACGGATCGTCTGTT,0,1561425
galEp3,0.16666666666666666,5,5,ATTCTTCTATCGCTCACCCT,0,1560161
galEp3,0.16666666666666666,5,5,ATTCGCTACTTCAGTATTTT,0,1574384
galEp3,0.16666666666666666,5,5,ATTCCTCGCTTTAATGCTAA,0,1573112
galEp3,0.16666666666666666,5,5,ATTCCGTTAAAAAACTGGAA,0,1562566
galEp3,0.16666666666666666,5,5,ATTCCGCCCCGGCGATCAAT,0,1569294
galEp3,0.16666666666666666,5,5,ATTCATGGCTGCGTGGGTGA,0,1590306
galEp3,0.16666666666666666,5,5,ATTAGCAGTGTGGGACTATA,0,1555946
galEp3,0.16666666666666666,5,5,ATTACATTGACCACTAAAGC,0,1578778
galEp3,0.16666666666666666,5,5,ATGTTTACAGGCCCACTTGC,0,1552926
galEp3,0.16666666666666666,5,5,ATGTGTGGTACCTTACCTTG,0,1586292
galEp3,0.16666666666666666,5,5,ATGTGGTGTCGTAGAAGGTA,0,1569745
galEp3,0.16666666666666666,5,5,ATGTCTGCTCGGATATATAG,0,1563717
galEp3,0.16666666666666666,5,5,ATGTCTAAATTTGACTGATT,0,1565587
galEp3,0.16666666666666666,5,5,ATGTAAGGACTGCCACGATC,0,1574829
galEp3,0.16666666666666666,5,5,ATGTAAGCTCCGAAATTAAC,0,1559356
galEp3,0.16666666666666666,5,5,ATGGCTGGATTCATTGCTCC,0,1547634
galEp3,0.16666666666666666,5,5,ATGGATATGATAGCTTTTGC,0,1572674
galEp3,0.16666666666666666,5,5,ATGGACGGTAGAATCTTCCA,0,1568026
galEp3,0.16666666666666666,5,5,ATGCCACGTAAACCGTCAGG,0,1564274
galEp3,0.16666666666666666,5,5,ATGCAGTTGTAATGAAGCGA,0,1591375
galEp3,0.16666666666666666,5,5,ATGAGCAAGCCAGCAGTTAT,0,1561177
galEp3,0.16666666666666666,5,5,ATGACGTGTCACGCCACGGT,0,1589695
galEp3,0.16666666666666666,5,5,ATCTTTATAGTCAAGTTATT,0,1580606
galEp3,0.16666666666666666,5,5,ATCTTGTTGTCAGGGGAATG,0,1562289
galEp3,0.16666666666666666,5,5,ATCTTATGGGACTGATCGAT,0,1573216
galEp3,0.16666666666666666,5,5,ATCTGGTCGATCTGCTAGCA,0,1590770
galEp3,0.16666666666666666,5,5,ATCTCTGCAATTCGCGAGCC,0,1561880
galEp3,0.16666666666666666,5,5,ATCTCCACGAAACACAAGGT,0,1578066
galEp3,0.16666666666666666,5,5,ATCTACAAGGAGCCTCTACA,0,1586987
galEp3,0.16666666666666666,5,5,ATCGTAGCTAGAGTTAGCTG,0,1584771
galEp3,0.16666666666666666,5,5,ATCGGGCTGCGGCCCCAGCG,0,1586365
galEp3,0.16666666666666666,5,5,ATCGCTGCCTAATTTTCGAA,0,1564895
galEp3,0.16666666666666666,5,5,ATCGATATTCCCCAATGCAT,0,1587379
galEp3,0.16666666666666666,5,5,ATCCGCGGAATTGCGCACAG,0,1553494
galEp3,0.16666666666666666,5,5,ATCATACCCGCTAATAAGCA,0,1589146
galEp3,0.16666666666666666,5,5,ATCAGAGCACATTAGACTCC,0,1564938
galEp3,0.16666666666666666,5,5,ATCACGTATGTTCTATGCGT,0,1581404
galEp3,0.16666666666666666,5,5,ATCAAGTGGACCATCATCAG,0,1549090
galEp3,0.16666666666666666,5,5,ATCAACTGAGACTATTTAAG,0,1584441
galEp3,0.16666666666666666,5,5,ATCAAAGTCGAAATCCAAGT,0,1590407
galEp3,0.16666666666666666,5,5,ATATGACCCGTTGTGTGGCG,0,1560673
galEp3,0.16666666666666666,5,5,ATATATGGCAAGACATGCCA,0,1576927
galEp3,0.16666666666666666,5,5,ATATAGGTCGTGAGAGGGCA,0,1554745
galEp3,0.16666666666666666,5,5,ATAGCAAAGCATACAGAGGG,0,1575187
galEp3,0.16666666666666666,5,5,ATACTTATATAACGGTGTAT,0,1588667
galEp3,0.16666666666666666,5,5,ATACGGCCAAACGTTAGATC,0,1589037
galEp3,0.16666666666666666,5,5,ATACCTCAACCCGCGGGTTC,0,1564634
galEp3,0.16666666666666666,5,5,ATACCGCTTTCGTCCAGTTG,0,1549634
galEp3,0.16666666666666666,5,5,ATACCCCGAGGCTAGCAGAA,0,1591100
galEp3,0.16666666666666666,5,5,ATACACAAAGTTTCCTGAGC,0,1576857
galEp3,0.16666666666666666,5,5,ATAAGTCACCATACTTTGGA,0,1576693
galEp3,0.16666666666666666,5,5,AGTTTCGAGATTCACGAGAC,0,1586008
galEp3,0.16666666666666666,5,5,AGTTATAGCCTGATAGCCCT,0,1574464
galEp3,0.16666666666666666,5,5,AGTTAGCGTACACTGGTTGG,0,1571009
galEp3,0.16666666666666666,5,5,AGTGTTGGACGGGAAGAGGA,0,1569914
galEp3,0.16666666666666666,5,5,AGTGTGGCTACCCCAGTAGT,0,1555658
galEp3,0.16666666666666666,5,5,AGTGGGTTGAGATTCAGGGG,0,1585568
galEp3,0.16666666666666666,5,5,AGTGCATCGAACTTAATAAC,0,1575773
galEp3,0.16666666666666666,5,5,AGTGCACACATGGTTCCGGA,0,1553992
galEp3,0.16666666666666666,5,5,AGTGAAATACATGGCAGTCG,0,1577864
galEp3,0.16666666666666666,5,5,AGTCCAAGGAATCGAAATTT,0,1583917
galEp3,0.16666666666666666,5,5,AGTCATAGTGTGTCCATAGG,0,1583074
galEp3,0.16666666666666666,5,5,AGTCAGGAAATTGCTTTGCA,0,1584985
galEp3,0.16666666666666666,5,5,AGTAGTCGGACGTACAGCGT,0,1575113
galEp3,0.16666666666666666,5,5,AGTACTAGCGATGAAGTATA,0,1577131
galEp3,0.16666666666666666,5,5,AGTAAGCAGTGGTAAAGCAG,0,1583790
galEp3,0.16666666666666666,5,5,AGTAAACTAGAGCCGCAGAA,0,1584477
galEp3,0.16666666666666666,5,5,AGGTGGCTGAGGCATCCACA,0,1582516
galEp3,0.16666666666666666,5,5,AGGTGCTTCCGCCACACGCA,0,1590973
galEp3,0.16666666666666666,5,5,AGGTCGGCGCTTTCGCCGCC,0,1579723
galEp3,0.16666666666666666,5,5,AGGTCCAAATATCACAAACC,0,1587023
galEp3,0.16666666666666666,5,5,AGGTAGGGAATCTCTTGTAA,0,1563444
galEp3,0.16666666666666666,5,5,AGGTACCGCCCACTATTTAG,0,1586334
galEp3,0.16666666666666666,5,5,AGGTAAGAAGTCGGTATCAA,0,1548049
galEp3,0.16666666666666666,5,5,AGGGTCCTACCTGTGAATTC,0,1546728
galEp3,0.16666666666666666,5,5,AGGGTAATCAACTGTTCTGC,0,1555355
galEp3,0.16666666666666666,5,5,AGGGTAACAGAATTGATAAC,0,1578029
galEp3,0.16666666666666666,5,5,AGGGCACAGGTCGTGGGGTG,0,1570739
galEp3,0.16666666666666666,5,5,AGGCTCATGACCAATCTGTG,0,1591204
galEp3,0.16666666666666666,5,5,AGGCGGTGATAGTTAATTCC,0,1575324
galEp3,0.16666666666666666,5,5,AGGCCTACAAACTGTAGGAC,0,1568766
galEp3,0.16666666666666666,5,5,AGGATCAGGTTTGCCCTACG,0,1561652
galEp3,0.16666666666666666,5,5,AGGAGTTGTGATCTGTAACG,0,1549049
galEp3,0.16666666666666666,5,5,AGGAGGGACTGCCGCTTGGA,0,1573256
galEp3,0.16666666666666666,5,5,AGCTGGTCCCCCTCGGTGGT,0,1583742
galEp3,0.16666666666666666,5,5,AGCTACTTCCGAATCATGCC,0,1558376
galEp3,0.16666666666666666,5,5,AGCTAATGTGGCTCTGAGGT,0,1546904
galEp3,0.16666666666666666,5,5,AGCGTGTCTACCAATCAATA,0,1587387
galEp3,0.16666666666666666,5,5,AGCGGCGGGTTACTTAGAAT,0,1561167
galEp3,0.16666666666666666,5,5,AGCGCCTTACTACGTACGCC,0,1563672
galEp3,0.16666666666666666,5,5,AGCGAGGATGCCTGCCGTCC,0,1555562
galEp3,0.16666666666666666,5,5,AGCGAAGGGGTCGATGAGCT,0,1555052
galEp3,0.16666666666666666,5,5,AGCCGGAGTAAAATTAAAAG,0,1551991
galEp3,0.16666666666666666,5,5,AGCCACCCTCACTGTCGGGG,0,1590066
galEp3,0.16666666666666666,5,5,AGCATCGACCTATTGTATGT,0,1582820
galEp3,0.16666666666666666,5,5,AGCAGGCTTGGGCTATTTAA,0,1552537
galEp3,0.16666666666666666,5,5,AGCAGCCAACCGCATACAGT,0,1589927
galEp3,0.16666666666666666,5,5,AGATCTGACGCGCATGATGC,0,1568045
galEp3,0.16666666666666666,5,5,AGAGTATGTAACCCCGCTCA,0,1552300
galEp3,0.16666666666666666,5,5,AGAGGTATAATCCGATAATC,0,1568659
galEp3,0.16666666666666666,5,5,AGAGGGATCGCGCAACAGAT,0,1571128
galEp3,0.16666666666666666,5,5,AGAGGCGTAGTACCTCCATG,0,1566985
galEp3,0.16666666666666666,5,5,AGAGGACTTTACCTTAGTCT,0,1553113
galEp3,0.16666666666666666,5,5,AGAGCTGACCCAAGCTGTTT,0,1589540
galEp3,0.16666666666666666,5,5,AGAGATCACCCGGCCCCATT,0,1556210
galEp3,0.16666666666666666,5,5,AGACCGTAGCTTCGTAAGTG,0,1555374
galEp3,0.16666666666666666,5,5,ACTTTTCAGCCCCCAACGAA,0,1551340
galEp3,0.16666666666666666,5,5,ACTTTGGTGTGACTCTAGAC,0,1586907
galEp3,0.16666666666666666,5,5,ACTTGTTAGAATAGTGCTTT,0,1550138
galEp3,0.16666666666666666,5,5,ACTTGTGAACGAATAAGGTG,0,1548401
galEp3,0.16666666666666666,5,5,ACTTCTCGTACAGGCGCCGT,0,1565781
galEp3,0.16666666666666666,5,5,ACTTCGTTAGCTGGATCGGG,0,1576280
galEp3,0.16666666666666666,5,5,ACTTCGGCAAATAGATCCCG,0,1588767
galEp3,0.16666666666666666,5,5,ACTTATCGAGTCGCGAAAAC,0,1550575
galEp3,0.16666666666666666,5,5,ACTGGCGCTTCCACTTAGTT,0,1567496
galEp3,0.16666666666666666,5,5,ACTGATTAACTGCGCAAGGC,0,1582104
galEp3,0.16666666666666666,5,5,ACTCATCACGAGGAGGTCTT,0,1589053
galEp3,0.16666666666666666,5,5,ACTCATAAAAACACCGTTCC,0,1570991
galEp3,0.16666666666666666,5,5,ACTCAGTGTTTTATACTATA,0,1569909
galEp3,0.16666666666666666,5,5,ACTATGGCCCTGGGCAGGAT,0,1592013
galEp3,0.16666666666666666,5,5,ACTAGACGGGGAGACGTCGT,0,1593634
galEp3,0.16666666666666666,5,5,ACTACGGGAGTTTGTTAGAT,0,1563953
galEp3,0.16666666666666666,5,5,ACTACGATTAATGATGTAGT,0,1571048
galEp3,0.16666666666666666,5,5,ACTACATCCAATCCAGGACT,0,1585639
galEp3,0.16666666666666666,5,5,ACTACAACGTTTTTAGCAAA,0,1580357
galEp3,0.16666666666666666,5,5,ACGTGGAAGTAATCGTTATT,0,1564159
galEp3,0.16666666666666666,5,5,ACGTCACGGTACGCACTTCT,0,1586487
galEp3,0.16666666666666666,5,5,ACGTCACACATTAGCCGACA,0,1558199
galEp3,0.16666666666666666,5,5,ACGGTTCTTGTTGTAAGAGA,0,1588742
galEp3,0.16666666666666666,5,5,ACGGTTCGGTGAAACGTGTG,0,1567885
galEp3,0.16666666666666666,5,5,ACGGTAGTCCAAACAGGATG,0,1573414
galEp3,0.16666666666666666,5,5,ACGGCCCGGTCTGCGATGGT,0,1584735
galEp3,0.16666666666666666,5,5,ACGCGTGCAAAGTTCATATA,0,1558128
galEp3,0.16666666666666666,5,5,ACGCGGTGGTGCTCATGGTT,0,1591626
galEp3,0.16666666666666666,5,5,ACGCGGTATGAGTTCTAATG,0,1585074
galEp3,0.16666666666666666,5,5,ACGCGACCTTGTTTGTCGTA,0,1582763
galEp3,0.16666666666666666,5,5,ACGCCGTTTTCGATTGTACA,0,1592641
galEp3,0.16666666666666666,5,5,ACGATCTCTACCCTAGCGGA,0,1589833
galEp3,0.16666666666666666,5,5,ACGAGATAGATCCCCTCCAT,0,1561195
galEp3,0.16666666666666666,5,5,ACCTGCCTATGGACGCCGCG,0,1548259
galEp3,0.16666666666666666,5,5,ACCTCAGCGGGGTGTTGATC,0,1578503
galEp3,0.16666666666666666,5,5,ACCGTCAGAGTTTGTCGTCC,0,1559638
galEp3,0.16666666666666666,5,5,ACCGTATATACCCCGGTTAC,0,1549405
galEp3,0.16666666666666666,5,5,ACCGAATGCAAGTAAGCCGG,0,1559757
galEp3,0.16666666666666666,5,5,ACCCGCTACCCGTGTGCAGA,0,1551120
galEp3,0.16666666666666666,5,5,ACCCCCCTAGGACGGCGTCC,0,1563498
galEp3,0.16666666666666666,5,5,ACCCCACGATTGACTCAGTC,0,1576021
galEp3,0.16666666666666666,5,5,ACCCATGGGTCAACTGGTTA,0,1568642
galEp3,0.16666666666666666,5,5,ACCCAGAGGAGACCAGGTCA,0,1562774
galEp3,0.16666666666666666,5,5,ACCAGATTTGTAGCCGACCC,0,1582549
galEp3,0.16666666666666666,5,5,ACCACGGTACGCGTCATATA,0,1568930
galEp3,0.16666666666666666,5,5,ACATTGTACAACAACTAATT,0,1587345
galEp3,0.16666666666666666,5,5,ACATGGGCCTGGACACGCAA,0,1585533
galEp3,0.16666666666666666,5,5,ACATATTGCTAAATTGTGCC,0,1550920
galEp3,0.16666666666666666,5,5,ACATAAGGTTTCAGTACCTA,0,1551828
galEp3,0.16666666666666666,5,5,ACAGTCCTACCGTGGGCTGG,0,1554093
galEp3,0.16666666666666666,5,5,ACAGCATCAGGTCAACGAGG,0,1557040
galEp3,0.16666666666666666,5,5,ACACTTCCAAATAGATATTA,0,1578219
galEp3,0.16666666666666666,5,5,ACACGACTGCTGTCTAACTC,0,1590490
galEp3,0.16666666666666666,5,5,ACAATTTTAAGATCGCCGTC,0,1571958
galEp3,0.16666666666666666,5,5,ACAATCAACCCATTCGGTGA,0,1575883
galEp3,0.16666666666666666,5,5,ACAAGCTGTTTCGCGGTGGG,0,1559986
galEp3,0.16666666666666666,5,5,ACAACAAGTTAGCTCTTAAG,0,1584353
galEp3,0.16666666666666666,5,5,ACAAATGGAACTGGCTGCTA,0,1565979
galEp3,0.16666666666666666,5,5,AATTTGGAGTGTTGCACCGA,0,1578790
galEp3,0.16666666666666666,5,5,AATTTCCGCATAGTCTGTTA,0,1565134
galEp3,0.16666666666666666,5,5,AATTGACGCTACTTACAACT,0,1563276
galEp3,0.16666666666666666,5,5,AATTAGAGGGCCAACGAAAT,0,1594650
galEp3,0.16666666666666666,5,5,AATTACACCCGTGCACAAAC,0,1564131
galEp3,0.16666666666666666,5,5,AATGTGAAGGACAGTCAGCC,0,1563106
galEp3,0.16666666666666666,5,5,AATGTACTTAGTATGGACGG,0,1564667
galEp3,0.16666666666666666,5,5,AATGCGACTAAGGAATCTCG,0,1564507
galEp3,0.16666666666666666,5,5,AATGACAGTCCTTCAGATAA,0,1589651
galEp3,0.16666666666666666,5,5,AATCGTCAGTTGCCATTCGC,0,1551614
galEp3,0.16666666666666666,5,5,AATCGAAGTTGATGACGGCA,0,1547629
galEp3,0.16666666666666666,5,5,AATCACTCAGTTGGTGGTTC,0,1558429
galEp3,0.16666666666666666,5,5,AATATCGAAGCGAGCTTTTG,0,1578763
galEp3,0.16666666666666666,5,5,AATATAGCGTTACTCACAAG,0,1551877
galEp3,0.16666666666666666,5,5,AATAGGTTCCGTTGCGATCG,0,1564254
galEp3,0.16666666666666666,5,5,AATAGCGCCATTGATCTCAA,0,1587277
galEp3,0.16666666666666666,5,5,AATACGGAACACAGGCGTTC,0,1550622
galEp3,0.16666666666666666,5,5,AATAATCTGAATTCGTGGCA,0,1550205
galEp3,0.16666666666666666,5,5,AATAATAGTCTGTATCGACA,0,1547054
galEp3,0.16666666666666666,5,5,AAGTGATCGCCACCACTTAG,0,1551431
galEp3,0.16666666666666666,5,5,AAGTCGGAGGGTGGTTAAAA,0,1548109
galEp3,0.16666666666666666,5,5,AAGGTGATATGGGGGTGAGC,0,1585671
galEp3,0.16666666666666666,5,5,AAGGTCGCGGTTGGGCTCAC,0,1593183
galEp3,0.16666666666666666,5,5,AAGGTCCACGGCAGTTCGTA,0,1585545
galEp3,0.16666666666666666,5,5,AAGGGGGTAGCCGCACTCAC,0,1589259
galEp3,0.16666666666666666,5,5,AAGGCCTTCCTGCGTTGGAG,0,1576055
galEp3,0.16666666666666666,5,5,AAGGAATTATATGAGGGTGG,0,1577211
galEp3,0.16666666666666666,5,5,AAGCTCGTCGCGCTTTCGTC,0,1574352
galEp3,0.16666666666666666,5,5,AAGCTATTGAATAGTACACT,0,1566114
galEp3,0.16666666666666666,5,5,AAGCTAGCAATTGGCCAGGA,0,1553120
galEp3,0.16666666666666666,5,5,AAGCGGTACCGTGACCGCGG,0,1586356
galEp3,0.16666666666666666,5,5,AAGCGATTATCAAAGGTAAG,0,1547712
galEp3,0.16666666666666666,5,5,AAGCAGGTAACCTCCCAAAT,0,1563016
galEp3,0.16666666666666666,5,5,AAGCACCATTGACCAAGGCT,0,1575958
galEp3,0.16666666666666666,5,5,AAGCAATTTAATATGGTGAA,0,1563824
galEp3,0.16666666666666666,5,5,AAGATGTTAAAGGAGATTAC,0,1557394
galEp3,0.16666666666666666,5,5,AAGACTACAGTCCTCGGGTA,0,1554140
galEp3,0.16666666666666666,5,5,AACTTGCAGAACGGGGCGAG,0,1569958
galEp3,0.16666666666666666,5,5,AACTGGTGGCCTTGCCACTT,0,1564374
galEp3,0.16666666666666666,5,5,AACTGGGCCTAGGCACCGTT,0,1582249
galEp3,0.16666666666666666,5,5,AACGTTCCAGCCCGAGCGAC,0,1585445
galEp3,0.16666666666666666,5,5,AACGTATTGCGGGGGCCGGC,0,1567833
galEp3,0.16666666666666666,5,5,AACGGGCTAGGTCCTTAGGA,0,1568275
galEp3,0.16666666666666666,5,5,AACGGCTGCGCGTATCGGGG,0,1594042
galEp3,0.16666666666666666,5,5,AACGGCAACTGGGAATGAAA,0,1591555
galEp3,0.16666666666666666,5,5,AACGAGGTACTTATCAGTCA,0,1567771
galEp3,0.16666666666666666,5,5,AACCGTCACTAACTATATTA,0,1587651
galEp3,0.16666666666666666,5,5,AACCGCAGAAAGCAACCAGG,0,1567132
galEp3,0.16666666666666666,5,5,AACCCTCGAACGTGCCTGTA,0,1575775
galEp3,0.16666666666666666,5,5,AACCCTCCTGTCAGCGTCCA,0,1551277
galEp3,0.16666666666666666,5,5,AACCCCTCAAGTAGATCGTT,0,1562944
galEp3,0.16666666666666666,5,5,AACCCCAGGGTCCACAGTGG,0,1557902
galEp3,0.16666666666666666,5,5,AACAAGTGCAGAGGCCTCAA,0,1556984
galEp3,0.16666666666666666,5,5,AAATCAGAACTTCGGGGCAA,0,1558110
galEp3,0.16666666666666666,5,5,AAATCAATGTCGCCGTACAC,0,1565690
galEp3,0.16666666666666666,5,5,AAATACTCCAGGACTGTTAG,0,1565140
galEp3,0.16666666666666666,5,5,AAAGTTTTGGGGGCTGTTCA,0,1589240
galEp3,0.16666666666666666,5,5,AAAGTAGCACCTGATCTGAC,0,1565108
galEp3,0.16666666666666666,5,5,AAAGGTGTAGGATGTCGCAG,0,1547057
galEp3,0.16666666666666666,5,5,AAAGGCACGCCATCCTTTGA,0,1589636
galEp3,0.16666666666666666,5,5,AAACTTCAATAATACCTTGC,0,1563103
galEp3,0.16666666666666666,5,5,AAACGGGTTGTACCAAATCT,0,1576880
galEp3,0.16666666666666666,5,5,AAACCGCTTCATGGGGAGTA,0,1578755
galEp3,0.16666666666666666,5,5,AAACCCATTTTTTAAAACCT,0,1586152
galEp3,0.16666666666666666,5,5,AAACCCAATACGTCAAGGGA,0,1560431
galEp3,0.16666666666666666,5,5,AAACCAACCGTAAGCCATAT,0,1580723
galEp3,0.16666666666666666,5,5,AAAAGCCCTAAAGGTTATAG,0,1560507
galEp3,0.2,4,4,TTTTTAGTTGATTTCAATGC,0,1579993
galEp3,0.2,4,4,TTTTGGTGTCGGTTCATTAT,0,1577384
galEp3,0.2,4,4,TTTTCCTTACGCATAGGAAG,0,1586039
galEp3,0.2,4,4,TTTGTGACAAACATAATATA,0,1554576
galEp3,0.2,4,4,TTTGGTACTTCGCTTGGAAG,0,1588994
galEp3,0.2,4,4,TTTGACTACGACGCGGACTT,0,1585616
galEp3,0.2,4,4,TTTGACGTTCCCTGTGACAT,0,1552778
galEp3,0.2,4,4,TTTCTTGAGCAGGGCACATC,0,1556465
galEp3,0.2,4,4,TTTCTCGTTTCGTAGGGCCT,0,1576335
galEp3,0.2,4,4,TTTCTAGGATTATGTATGCA,0,1552011
galEp3,0.2,4,4,TTTCTACGGTAAGATAAAAC,0,1564654
galEp3,0.2,4,4,TTTCGTTTAGTCTAGAAAGA,0,1590971
galEp3,0.2,4,4,TTTCGTTCCCGTTTGAGTCT,0,1567866
galEp3,0.2,4,4,TTTCGCTGTTCCAGGTTTAG,0,1567019
galEp3,0.2,4,4,TTTCGCTAGGTCTCCCGCAA,0,1569415
galEp3,0.2,4,4,TTTCGATTCAACGCCCATTC,0,1563163
galEp3,0.2,4,4,TTTCCAGTAGTATCCTCAAA,0,1585325
galEp3,0.2,4,4,TTTCCAAGACCTCTAGATGG,0,1594996
galEp3,0.2,4,4,TTTCATAATTTCAGGTTCGA,0,1548243
galEp3,0.2,4,4,TTTATGGCTAAACGGGCTAA,0,1548435
galEp3,0.2,4,4,TTTAATGCACTATTATGCGT,0,1547458
galEp3,0.2,4,4,TTTAAGTGGTAGTTGGGACC,0,1555649
galEp3,0.2,4,4,TTGTTGGGTCCACGATGTCC,0,1564079
galEp3,0.2,4,4,TTGTGTGTGTAGTCTACTTG,0,1568169
galEp3,0.2,4,4,TTGTGTCTGGCTGATATGAC,0,1582178
galEp3,0.2,4,4,TTGTGGCAAGCAGAATATCG,0,1567573
galEp3,0.2,4,4,TTGTAACACACTTCGTAAGG,0,1549665
galEp3,0.2,4,4,TTGGTGGGGGCTGTCCTAGT,0,1548102
galEp3,0.2,4,4,TTGGGAACAGCATCGCAGCT,0,1569016
galEp3,0.2,4,4,TTGGATCCGACGTTTTTCAG,0,1577719
galEp3,0.2,4,4,TTGGACTCGCGTTATCGGCC,0,1564697
galEp3,0.2,4,4,TTGGAATTCGTTCCGTGCTT,0,1573424
galEp3,0.2,4,4,TTGCGGTGAGATGCAGCCGA,0,1553175
galEp3,0.2,4,4,TTGAGGCAGCTCTATGCTGA,0,1584197
galEp3,0.2,4,4,TTGACTAGTTGCCGCGACGT,0,1581188
galEp3,0.2,4,4,TTGACGGGTTCTGGATCGCG,0,1568699
galEp3,0.2,4,4,TTGACCTAGGTCGGGGATTT,0,1563853
galEp3,0.2,4,4,TTGAACGGTGTGCACGCGTC,0,1571015
galEp3,0.2,4,4,TTCTTTACCCCGGAAATCTT,0,1565379
galEp3,0.2,4,4,TTCTTGCTGAGACCGAGTCA,0,1579894
galEp3,0.2,4,4,TTCTTAATACCATTTTGTAC,0,1591282
galEp3,0.2,4,4,TTCTGCTGTGGTCCATCCGC,0,1584551
galEp3,0.2,4,4,TTCTCGAAATTCGAGGGCGT,0,1584843
galEp3,0.2,4,4,TTCTATTCAGTAGACTGGCC,0,1547384
galEp3,0.2,4,4,TTCGTGTCTCGGTGAAGAAC,0,1556749
galEp3,0.2,4,4,TTCGCTGTTTTCGGAGGTAA,0,1586381
galEp3,0.2,4,4,TTCGCAAGATCAATCTTCCC,0,1574340
galEp3,0.2,4,4,TTCGAGGCATCAACCACTAT,0,1577170
galEp3,0.2,4,4,TTCGAGCGGGGGAAAATGTT,0,1554453
galEp3,0.2,4,4,TTCGAAGGCATCAAAGGGCT,0,1565876
galEp3,0.2,4,4,TTCGAAAAAAAGTATGAGCT,0,1583750
galEp3,0.2,4,4,TTCCTCGGTTGCTATAAGCT,0,1594291
galEp3,0.2,4,4,TTCCTAGCTATGGTATAACT,0,1586529
galEp3,0.2,4,4,TTCCGCTCCAGGACCCACAG,0,1568072
galEp3,0.2,4,4,TTCCGATCATCTGCCTTTAT,0,1572274
galEp3,0.2,4,4,TTCCCGCTCCTGGGGCGAGC,0,1559439
galEp3,0.2,4,4,TTCCCACTGATTATATCACC,0,1579426
galEp3,0.2,4,4,TTCATGACAGGCGCCTGGGC,0,1553217
galEp3,0.2,4,4,TTCAGAGAGTTACTTTTAAT,0,1552796
galEp3,0.2,4,4,TTCACTAATAGTTTAGACGT,0,1578801
galEp3,0.2,4,4,TTCACACTGCTGTCGGGTGA,0,1555712
galEp3,0.2,4,4,TTATGGCCTAAGGATCCAGA,0,1570423
galEp3,0.2,4,4,TTATGAACGTGGAGTTGTTC,0,1578524
galEp3,0.2,4,4,TTATCGTGTCGCATCCTGCA,0,1557226
galEp3,0.2,4,4,TTATCAAGGGCACATTGATG,0,1548400
galEp3,0.2,4,4,TTATATTCAATTCGAAGTTC,0,1553518
galEp3,0.2,4,4,TTATACTGTTCCCCATCATC,0,1573134
galEp3,0.2,4,4,TTAGGAGGTTGACACGTCTC,0,1581112
galEp3,0.2,4,4,TTAGATTTGGGTAAAAGGGA,0,1557645
galEp3,0.2,4,4,TTACTGCGTCTTCTGGCAAG,0,1561521
galEp3,0.2,4,4,TTACGCCGCGGACATTTCCT,0,1566849
galEp3,0.2,4,4,TTACCGGTTTCCTCGGAATA,0,1574070
galEp3,0.2,4,4,TTACCGGACCGGTAGCATGT,0,1549914
galEp3,0.2,4,4,TTAAGTTCTGGTCGCCTGCA,0,1562589
galEp3,0.2,4,4,TTAAGGTCGCTCTCTGTATA,0,1572753
galEp3,0.2,4,4,TTAAGGTAATTTTGCGAATG,0,1594651
galEp3,0.2,4,4,TTAAGGGAACGGTTCAAAGA,0,1555516
galEp3,0.2,4,4,TTAAGGCGTCCCGAGAGTGG,0,1565143
galEp3,0.2,4,4,TTAAGGAAAACGCTCCGCAC,0,1572258
galEp3,0.2,4,4,TTAAACTCTGCCAAGACGTT,0,1573263
galEp3,0.2,4,4,TGTTCAGGGTAGGTGGCCCG,0,1593350
galEp3,0.2,4,4,TGTTACGCGTGGTATTGCAG,0,1562401
galEp3,0.2,4,4,TGTGGGGAAGAGGTCTAACA,0,1573372
galEp3,0.2,4,4,TGTGGGAGTATTACTGTGGA,0,1584473
galEp3,0.2,4,4,TGTCGCTGAGCCACGCCATC,0,1550673
galEp3,0.2,4,4,TGTCCGAGATGGGTTATACG,0,1564759
galEp3,0.2,4,4,TGTCACATAACGGAAATCGT,0,1584753
galEp3,0.2,4,4,TGTAGGTCCGGGGTTAAAGG,0,1552920
galEp3,0.2,4,4,TGTACTGGAGTCCTCCGAGA,0,1576634
galEp3,0.2,4,4,TGTACGCGTAACGCTTCATG,0,1559744
galEp3,0.2,4,4,TGTACCGATTACGCCGGAAG,0,1566584
galEp3,0.2,4,4,TGTACATGTGGGCCATGCCT,0,1587612
galEp3,0.2,4,4,TGTAAGGTCCTGCTATCGCT,0,1566897
galEp3,0.2,4,4,TGTAACGCATGTATGATGAC,0,1583442
galEp3,0.2,4,4,TGGTTTTTCCGTAGTTAACG,0,1573807
galEp3,0.2,4,4,TGGTTGAGTATCGGAGTACA,0,1571524
galEp3,0.2,4,4,TGGTTCGGTGCTCGACGCTG,0,1549973
galEp3,0.2,4,4,TGGTTCGACACTGCGCGGAC,0,1594330
galEp3,0.2,4,4,TGGTGTGCGTGGACCGCGAT,0,1584779
galEp3,0.2,4,4,TGGTGTACGCATCTCCGCAG,0,1552980
galEp3,0.2,4,4,TGGTGCTAAAAACAGTGACT,0,1548022
galEp3,0.2,4,4,TGGTGAGGAATGTCGCGCCG,0,1581262
galEp3,0.2,4,4,TGGTCCTCCTCACAGGTCTT,0,1594517
galEp3,0.2,4,4,TGGTCCCGCTGAGGTAAGAT,0,1593950
galEp3,0.2,4,4,TGGTAGTACATCAGAATAGT,0,1583678
galEp3,0.2,4,4,TGGTAAAGGCCCCGAAGGTA,0,1550474
galEp3,0.2,4,4,TGGGTCAACCGAAATGAATT,0,1569409
galEp3,0.2,4,4,TGGCTTTGTAGAGTTGCATT,0,1553305
galEp3,0.2,4,4,TGGCTTCATTAATCAGTGTA,0,1571087
galEp3,0.2,4,4,TGGCCCGGAACTAGGCCTAC,0,1583279
galEp3,0.2,4,4,TGGCCCCGCAACGCAGGTCT,0,1563688
galEp3,0.2,4,4,TGGCCATAGTCGCCCTCTGC,0,1580574
galEp3,0.2,4,4,TGGCAGACACGACCATATTT,0,1567532
galEp3,0.2,4,4,TGGATTTCTTCTGAGACCCT,0,1571589
galEp3,0.2,4,4,TGGATTGCATCTAATATTGA,0,1588079
galEp3,0.2,4,4,TGGAATCCCGTCCGCTGACA,0,1559674
galEp3,0.2,4,4,TGCTTGAAGGCGCCATTGAC,0,1590388
galEp3,0.2,4,4,TGCTGGGAGGTTGCGAATTT,0,1580422
galEp3,0.2,4,4,TGCTCTACGTACAGGTGACA,0,1585585
galEp3,0.2,4,4,TGCGTGCGTAATTGGCTGTG,0,1586965
galEp3,0.2,4,4,TGCGTCGTTCGGTCTCGGTT,0,1591067
galEp3,0.2,4,4,TGCGGACTATAAATGCTACT,0,1550296
galEp3,0.2,4,4,TGCGCTGAGGAGGTGGTACG,0,1548564
galEp3,0.2,4,4,TGCCGGACACAATTGGCACT,0,1552889
galEp3,0.2,4,4,TGCCACAAGAAGGTTATGCC,0,1581343
galEp3,0.2,4,4,TGCAGATGCAAAGGTGCCAA,0,1567128
galEp3,0.2,4,4,TGCACTAAGGTATGAAATGT,0,1565580
galEp3,0.2,4,4,TGCACAGACGTTGGAGGGAA,0,1550307
galEp3,0.2,4,4,TGATTGTACGAATCCAACAC,0,1571517
galEp3,0.2,4,4,TGATTGGAGCATGGGAGAAT,0,1594744
galEp3,0.2,4,4,TGATTATTCGATTGTCCAAC,0,1565167
galEp3,0.2,4,4,TGATCCGCACGCGGGGTACC,0,1553937
galEp3,0.2,4,4,TGATACAAGTACGGATGAGT,0,1552728
galEp3,0.2,4,4,TGAGGCCCTGATGGATAGGG,0,1563271
galEp3,0.2,4,4,TGAGCAAAATGTTAGATCCC,0,1581512
galEp3,0.2,4,4,TGAGAGTTACGCAGTATGTG,0,1561485
galEp3,0.2,4,4,TGACTTAAGTTATGCAATGA,0,1550337
galEp3,0.2,4,4,TGACTAGGCATCGACTTAGC,0,1567448
galEp3,0.2,4,4,TGACCTCGAAACACACCACA,0,1593334
galEp3,0.2,4,4,TGACCAGTGGGCAAAGACCC,0,1556618
galEp3,0.2,4,4,TGACATTAGGAAACATGATA,0,1590558
galEp3,0.2,4,4,TGAACTCAACAAGCTACGAT,0,1580540
galEp3,0.2,4,4,TGAACTATTACATTGCGAGC,0,1591288
galEp3,0.2,4,4,TGAACGTTAGTATCATCTTA,0,1583391
galEp3,0.2,4,4,TGAACGCACAACACGAAAGA,0,1563563
galEp3,0.2,4,4,TGAACCTCACAGGGGTCGAG,0,1570396
galEp3,0.2,4,4,TGAACAGGGGGGAGGTCCAG,0,1546739
galEp3,0.2,4,4,TGAACAAACTTACTAAAACA,0,1553881
galEp3,0.2,4,4,TGAAAGAGATTTGGCTTCGA,0,1583760
galEp3,0.2,4,4,TCTTTTAATCTGGGCAATGT,0,1590134
galEp3,0.2,4,4,TCTTTACGGAAAGTGTCTTT,0,1592821
galEp3,0.2,4,4,TCTTGTGGACCTTAGTGGGG,0,1562056
galEp3,0.2,4,4,TCTTCACAGTGCTTTCAATC,0,1588830
galEp3,0.2,4,4,TCTTATACCACCTATACAAT,0,1551185
galEp3,0.2,4,4,TCTGAACAGGTGACTCCACG,0,1568333
galEp3,0.2,4,4,TCTCGAACAATATGGATAGT,0,1575223
galEp3,0.2,4,4,TCTCACTGATCGCTCACATA,0,1559223
galEp3,0.2,4,4,TCTATAGCCATAGGACCTAA,0,1577780
galEp3,0.2,4,4,TCTAGAACTTTTTCTAAAGT,0,1591766
galEp3,0.2,4,4,TCTACCTATAGGTACTCACC,0,1549411
galEp3,0.2,4,4,TCTACCAGAAACATACAATT,0,1553163
galEp3,0.2,4,4,TCGTTCAAATGAATCTCATG,0,1565464
galEp3,0.2,4,4,TCGTGGCATATGTTTTTGGG,0,1569980
galEp3,0.2,4,4,TCGTGGAATCTTCAAGTAGC,0,1557032
galEp3,0.2,4,4,TCGTGAGTCTCCCATGGACG,0,1548130
galEp3,0.2,4,4,TCGGTTAAATGAGTCTAGTA,0,1568928
galEp3,0.2,4,4,TCGGGTTCTGAAATGTCGAG,0,1551007
galEp3,0.2,4,4,TCGGGTGAACTTCGAAGCGG,0,1563144
galEp3,0.2,4,4,TCGGCCCACCACTTGAATTG,0,1565278
galEp3,0.2,4,4,TCGGATTCTTTTGGGACCGT,0,1551704
galEp3,0.2,4,4,TCGGACGTAGGTAGTCGGTA,0,1584896
galEp3,0.2,4,4,TCGGAAGGCGTTAGGAGTGA,0,1573937
galEp3,0.2,4,4,TCGCGTTTTTGATGCGTTTG,0,1557929
galEp3,0.2,4,4,TCGCGTACGAAACCTTGTCA,0,1588699
galEp3,0.2,4,4,TCGCATTACCTTCGCCGTCG,0,1577782
galEp3,0.2,4,4,TCCTGTACTGTTGGGCTCTA,0,1581250
galEp3,0.2,4,4,TCCTGACTACGGACGGTTAA,0,1548120
galEp3,0.2,4,4,TCCTACGTTGTTACGGCTGA,0,1555576
galEp3,0.2,4,4,TCCGGTCATATGGACAGCGA,0,1563104
galEp3,0.2,4,4,TCCGGTATGAGAGTGCCCGA,0,1584612
galEp3,0.2,4,4,TCCGGGACGGTCAGCTCGCG,0,1583092
galEp3,0.2,4,4,TCCGATAGTACTGGGGTTAT,0,1555503
galEp3,0.2,4,4,TCCCGCTGACCTCTACGGTC,0,1574572
galEp3,0.2,4,4,TCCCCTGACAGAGTGATCAA,0,1590496
galEp3,0.2,4,4,TCCATGACGAGCTAGAGTTA,0,1591771
galEp3,0.2,4,4,TCCACCAAGCGGCAGCTTTT,0,1553876
galEp3,0.2,4,4,TCCAATTATATTCCAATGGT,0,1557258
galEp3,0.2,4,4,TCATTAAGTTTGTAAATCTC,0,1559672
galEp3,0.2,4,4,TCATGGGAAAGGTGGAGATC,0,1548448
galEp3,0.2,4,4,TCATGGAAAATACTACCACT,0,1567125
galEp3,0.2,4,4,TCATGATTAGGGGGAGACCA,0,1576872
galEp3,0.2,4,4,TCATCAATGCATGAACGGGG,0,1568310
galEp3,0.2,4,4,TCATAATGCATTAAACTCTA,0,1563272
galEp3,0.2,4,4,TCAGTGAAACAGGACGCGGT,0,1580171
galEp3,0.2,4,4,TCAGTCGGTTTTCCCGCATA,0,1577497
galEp3,0.2,4,4,TCAGGTTTGAGAGGGCACGA,0,1550025
galEp3,0.2,4,4,TCAGGCGGAAGGATCACGGT,0,1575933
galEp3,0.2,4,4,TCAGCGGGCGGCGACGGCTT,0,1587781
galEp3,0.2,4,4,TCAGCATCGAGCCATATGTC,0,1554335
galEp3,0.2,4,4,TCAGCATAGGTAGTGATTGG,0,1579460
galEp3,0.2,4,4,TCAGAACGTTTGATGGCCGA,0,1554926
galEp3,0.2,4,4,TCACATGTCACGGTCAACTT,0,1571404
galEp3,0.2,4,4,TCAACTTGAGATGGGCGTCC,0,1562179
galEp3,0.2,4,4,TATTTACATCCCGTATAGAA,0,1586991
galEp3,0.2,4,4,TATTGTGCAAGATATAAAAT,0,1581586
galEp3,0.2,4,4,TATTCCAATTCCACCCGAGG,0,1574095
galEp3,0.2,4,4,TATTATAGGTATAATAGCCA,0,1589985
galEp3,0.2,4,4,TATGCACGGGCGGAACCCCA,0,1581044
galEp3,0.2,4,4,TATGACCTCGAAAGGGTGTT,0,1575651
galEp3,0.2,4,4,TATGACCCGGTTAGCAAGGT,0,1567777
galEp3,0.2,4,4,TATCTTGGGGATCCTTCGTG,0,1574298
galEp3,0.2,4,4,TATCGGGTGATACAAGCTAG,0,1559600
galEp3,0.2,4,4,TATCCCGATTCTTCTTTATA,0,1554524
galEp3,0.2,4,4,TATCCAACCGCATCAGCGTG,0,1556667
galEp3,0.2,4,4,TATATGGTATTAGAGAACGT,0,1585518
galEp3,0.2,4,4,TATACCGGGGCATGCGACGT,0,1556569
galEp3,0.2,4,4,TATACCGACACAATCCGCCA,0,1580887
galEp3,0.2,4,4,TATACCCGAGCCGTGGAAAC,0,1555849
galEp3,0.2,4,4,TATAAGCACGACTCTGCGAT,0,1577411
galEp3,0.2,4,4,TATAAAAAAACCCCACTTGT,0,1554179
galEp3,0.2,4,4,TAGTGACCCTAGGTATCTGC,0,1588138
galEp3,0.2,4,4,TAGGTTGTATCCCACGCACA,0,1577683
galEp3,0.2,4,4,TAGGTGGTAGTCACGTGTTA,0,1567758
galEp3,0.2,4,4,TAGGGAGCTCGTCCTAACGT,0,1554322
galEp3,0.2,4,4,TAGGCAGGCGGAACGGGAGA,0,1591908
galEp3,0.2,4,4,TAGGCACCCGTACGTAATCA,0,1547791
galEp3,0.2,4,4,TAGGCACACCTAGATCATCC,0,1550347
galEp3,0.2,4,4,TAGCTTTAATAGCTTAGGAC,0,1553599
galEp3,0.2,4,4,TAGCGGTCAACCCGGGTAGC,0,1584150
galEp3,0.2,4,4,TAGCGGACAACTGTTGCGTT,0,1566193
galEp3,0.2,4,4,TAGCATGTGCGGGAAAGGGA,0,1547887
galEp3,0.2,4,4,TAGATTAAGGAGTACGTTAG,0,1547804
galEp3,0.2,4,4,TAGATAGCCCCGAAATGCTG,0,1589620
galEp3,0.2,4,4,TAGATAGCATGCCGGAAAAT,0,1591754
galEp3,0.2,4,4,TAGAGGGGCTCTATGGCCCT,0,1571052
galEp3,0.2,4,4,TAGAATTTTGTAACGGATTG,0,1568231
galEp3,0.2,4,4,TACTTTATTTGTAGAGTTCT,0,1584928
galEp3,0.2,4,4,TACTCTTCTAAAAAAGTGCA,0,1549289
galEp3,0.2,4,4,TACTCACGTTAGGGGTTTAA,0,1579670
galEp3,0.2,4,4,TACGTTTGTCTATCTAATAA,0,1562969
galEp3,0.2,4,4,TACGTCCGCCCCTACTCTTT,0,1584155
galEp3,0.2,4,4,TACGTCAAGCAGCTGTTATA,0,1553500
galEp3,0.2,4,4,TACGACCAATAAAGTGAAAA,0,1558944
galEp3,0.2,4,4,TACCCGCTTTGGAATTGGAC,0,1586622
galEp3,0.2,4,4,TACCCGCATAATCTTTTTGT,0,1546562
galEp3,0.2,4,4,TACCCAGTGGACGGGAGCTT,0,1567452
galEp3,0.2,4,4,TACCATCAAGTACCCGACGT,0,1565374
galEp3,0.2,4,4,TACCAGTGCATTTTAGATTC,0,1572084
galEp3,0.2,4,4,TACATGGCTCCCACTACGCT,0,1566813
galEp3,0.2,4,4,TACAGAGATATCAGCTGTGT,0,1565508
galEp3,0.2,4,4,TACACCGCGCTCAGGTTGTG,0,1584559
galEp3,0.2,4,4,TACACCAGCGACAGTCGTAG,0,1547306
galEp3,0.2,4,4,TACAAAACGCACTCATAGGT,0,1567331
galEp3,0.2,4,4,TAATTGTTGTTTAGGTCTCA,0,1586143
galEp3,0.2,4,4,TAATTGTCGTCTACGGGAAG,0,1551273
galEp3,0.2,4,4,TAATCCTGTCGGGACAAAAA,0,1556873
galEp3,0.2,4,4,TAATCAGCAGCGAAACTCAA,0,1591430
galEp3,0.2,4,4,TAATAGGTCGTTTGTCCAGA,0,1586468
galEp3,0.2,4,4,TAAGTAAAGCGCGCGCCCAA,0,1587338
galEp3,0.2,4,4,TAAGGTGAGGAGTCCGGAGA,0,1589989
galEp3,0.2,4,4,TAAGGACGGCCGAGTCATTC,0,1573005
galEp3,0.2,4,4,TAAGCTATCGTTAAAGATTA,0,1553526
galEp3,0.2,4,4,TAAGAGACTGGACCCAGTAG,0,1556483
galEp3,0.2,4,4,TAAGACGTCCAAAGTTGTAT,0,1568232
galEp3,0.2,4,4,TAAGACCTTTAGCATTTGGT,0,1580781
galEp3,0.2,4,4,TAACTGTGGACTCCGCTCTT,0,1563565
galEp3,0.2,4,4,TAACGGAGTCTTTTTATGTT,0,1560185
galEp3,0.2,4,4,TAACCCCTGTATCACTTTGT,0,1557142
galEp3,0.2,4,4,TAACCCAAAATTGGACGCAA,0,1582953
galEp3,0.2,4,4,TAAATTAACGTATCGGAGGA,0,1575596
galEp3,0.2,4,4,TAAATATGTTAGTCGAACGT,0,1557551
galEp3,0.2,4,4,TAAAGGGGCGCCTGTGGCAT,0,1569464
galEp3,0.2,4,4,TAAACATCGACAGCAATTTA,0,1581150
galEp3,0.2,4,4,GTTTTTAAAGAAGGCCTTCA,0,1592474
galEp3,0.2,4,4,GTTTGTACGCCGACCCAATT,0,1575265
galEp3,0.2,4,4,GTTTCCGATGCTGACACTCT,0,1550368
galEp3,0.2,4,4,GTTTCATTGGGCTACGGTTA,0,1565529
galEp3,0.2,4,4,GTTTCATCGCACGACCGAAG,0,1595189
galEp3,0.2,4,4,GTTTACGGACAACTACTATG,0,1594838
galEp3,0.2,4,4,GTTTAAGGAAAGGTCCGTGT,0,1548927
galEp3,0.2,4,4,GTTGGCGGCGAACCCATGGT,0,1568331
galEp3,0.2,4,4,GTTGGCCAAATGGTCCTTCC,0,1558390
galEp3,0.2,4,4,GTTGGCATACGGAACGATAA,0,1591781
galEp3,0.2,4,4,GTTGGAGCCATGGTTTTGAA,0,1551016
galEp3,0.2,4,4,GTTGCGCTACCAGCCCGCAA,0,1547209
galEp3,0.2,4,4,GTTGATGATGGGAGTAACAC,0,1566529
galEp3,0.2,4,4,GTTGACTCACGCCCGGACGA,0,1579228
galEp3,0.2,4,4,GTTGACCGGCTTCGGCGTGG,0,1569905
galEp3,0.2,4,4,GTTCTGGGGGGTGTATATCT,0,1564406
galEp3,0.2,4,4,GTTCCGGACGCTGTGTAGGT,0,1548840
galEp3,0.2,4,4,GTTATTGATCGTTCGGCGTT,0,1563110
galEp3,0.2,4,4,GTTATGAATGGTGGACCCGG,0,1562549
galEp3,0.2,4,4,GTTAGTACCGAGAGCGACGT,0,1552217
galEp3,0.2,4,4,GTTAGGGGTATAATTGGGAG,0,1563637
galEp3,0.2,4,4,GTTAGCTGCTATGTACAATG,0,1559547
galEp3,0.2,4,4,GTTACGTACTGCGTGTGAAT,0,1574348
galEp3,0.2,4,4,GTGTTTTGTGGTCTTCCGCC,0,1573266
galEp3,0.2,4,4,GTGTTGTGGCGTTTCAGAAT,0,1548839
galEp3,0.2,4,4,GTGTTGCGAAAACAGCGAGC,0,1554660
galEp3,0.2,4,4,GTGTTACCGTCCGAATGGCA,0,1557547
galEp3,0.2,4,4,GTGTGGCAAGCGGTCCACAG,0,1555818
galEp3,0.2,4,4,GTGTCTGCTCTACGGTCTTC,0,1562290
galEp3,0.2,4,4,GTGTCTCGAGAGTCTGGTAC,0,1593225
galEp3,0.2,4,4,GTGTAGCGTTCGTAGATTAA,0,1562923
galEp3,0.2,4,4,GTGTAAGGAGCCGTAACTAC,0,1587254
galEp3,0.2,4,4,GTGGTGTACTCAAGTACGCG,0,1548277
galEp3,0.2,4,4,GTGGGTCGATTCTGAGAAAG,0,1575739
galEp3,0.2,4,4,GTGGCTGACCAAAGTACTAG,0,1575923
galEp3,0.2,4,4,GTGGATCTAGAGGAGAAAAC,0,1571956
galEp3,0.2,4,4,GTGCGTGATTCCGGCGAGTG,0,1581450
galEp3,0.2,4,4,GTGAGCGCTTTTCCGATAAA,0,1586429
galEp3,0.2,4,4,GTGAGATCGCCTACCACCAG,0,1562904
galEp3,0.2,4,4,GTCTTTTTACCCATGTGTAT,0,1578765
galEp3,0.2,4,4,GTCTTTAAGAGGAAGACCCT,0,1567876
galEp3,0.2,4,4,GTCGGTGGTCTACAGGCAGA,0,1553537
galEp3,0.2,4,4,GTCGGGTTGAACTGATTTTA,0,1557876
galEp3,0.2,4,4,GTCGGGTCGAGTGTGGAGCA,0,1588149
galEp3,0.2,4,4,GTCGCAATGTCCCAACTGAA,0,1570358
galEp3,0.2,4,4,GTCGAGGAGATATCAGTGCT,0,1558465
galEp3,0.2,4,4,GTCCTTCCCAGCCCACCATT,0,1563515
galEp3,0.2,4,4,GTCCTGGGTCCACTTACGCT,0,1573571
galEp3,0.2,4,4,GTCCTCGACAGAGGCCCCAA,0,1572975
galEp3,0.2,4,4,GTCCGTATCCCCCGGCCGAC,0,1559809
galEp3,0.2,4,4,GTCCGCGACTCTAGTGACTC,0,1567826
galEp3,0.2,4,4,GTCATGCGGTGGTGATCGCG,0,1557391
galEp3,0.2,4,4,GTCATCAAAGTAGAGGGTAC,0,1577321
galEp3,0.2,4,4,GTCAGTCCGAGAAATCAACC,0,1562552
galEp3,0.2,4,4,GTCAGAACTTCAGGGCGCGA,0,1569128
galEp3,0.2,4,4,GTCACGGGCGCCTACATTTC,0,1568960
galEp3,0.2,4,4,GTCAATGAATTCCGCGTACC,0,1570854
galEp3,0.2,4,4,GTCAAGGGAACCGACTTCTC,0,1563629
galEp3,0.2,4,4,GTATTTTATTCGAAAGGTAC,0,1547824
galEp3,0.2,4,4,GTATATCGTTTAGAGGTGAC,0,1569779
galEp3,0.2,4,4,GTATATCACTCTGCACAGAA,0,1569370
galEp3,0.2,4,4,GTAGCATCTGTCAGGTCTGT,0,1553724
galEp3,0.2,4,4,GTAGCAGCGACTAGCGCGGC,0,1557038
galEp3,0.2,4,4,GTAGATCTATAACACGACAT,0,1563129
galEp3,0.2,4,4,GTAGAATCGGTACAGCTCCC,0,1549298
galEp3,0.2,4,4,GTAGAACGTCTCGGGGTGCA,0,1585036
galEp3,0.2,4,4,GTACTAACATCGAAGTACGG,0,1569525
galEp3,0.2,4,4,GTACCATAAATGCGACTACA,0,1547100
galEp3,0.2,4,4,GTACACCCTGCATAGCCGTC,0,1574233
galEp3,0.2,4,4,GTAAGGTATGGAGCGCAAAC,0,1550579
galEp3,0.2,4,4,GTAAGCATCTACCAGTTAAA,0,1574984
galEp3,0.2,4,4,GTAACTGTGATTACGTTTCA,0,1569751
galEp3,0.2,4,4,GTAACACGTATCGGCGGGCA,0,1562642
galEp3,0.2,4,4,GGTTTTTCCTAGCAGTGGGA,0,1562690
galEp3,0.2,4,4,GGTTTTACACCATACATGTG,0,1564673
galEp3,0.2,4,4,GGTTCCAAGCGCCTCCTCAG,0,1582508
galEp3,0.2,4,4,GGTGTTCCGACTCACTAGGG,0,1565301
galEp3,0.2,4,4,GGTGTTATCGCTAGCTTTAA,0,1569349
galEp3,0.2,4,4,GGTGCTCTCATCCTACCTAC,0,1588100
galEp3,0.2,4,4,GGTGCTCCGCGTAAATCGTA,0,1556565
galEp3,0.2,4,4,GGTGCCGGGGGCGACTCTAT,0,1549205
galEp3,0.2,4,4,GGTCTTTTATAAGCGATACT,0,1583736
galEp3,0.2,4,4,GGTCTTCCGCTGGTCAGACA,0,1586790
galEp3,0.2,4,4,GGTCCTATATTGTATGTGGG,0,1592098
galEp3,0.2,4,4,GGTATGGTACGCGCGGGACT,0,1564879
galEp3,0.2,4,4,GGGTTCGGACGGGTTGGTGC,0,1572174
galEp3,0.2,4,4,GGGTTCCCTTAGAGTGCTCA,0,1575624
galEp3,0.2,4,4,GGGTAAAGGTCATTAACCAT,0,1549905
galEp3,0.2,4,4,GGGGTACCCCCCGTAAAGTC,0,1552056
galEp3,0.2,4,4,GGGGGTGAAACGGGATTGAT,0,1582974
galEp3,0.2,4,4,GGGGGCTGTGTTCGAACCGT,0,1573746
galEp3,0.2,4,4,GGGGGAAGCGTGAAGGGCGA,0,1574821
galEp3,0.2,4,4,GGGGAATTAGTGGATGCTCG,0,1555584
galEp3,0.2,4,4,GGGGAAATCAACGTACCGTG,0,1559289
galEp3,0.2,4,4,GGGCTGAACGGTGATTGGTA,0,1582144
galEp3,0.2,4,4,GGGCCTTATGGCGCCAGATA,0,1560120
galEp3,0.2,4,4,GGGCCAGCGCGCGATCCTGC,0,1561750
galEp3,0.2,4,4,GGGCAGTACATGGTGCCTTC,0,1564207
galEp3,0.2,4,4,GGGCAGGGTCAAAGTTAGAA,0,1584322
galEp3,0.2,4,4,GGGATTACAATATATAGTCC,0,1582988
galEp3,0.2,4,4,GGGATCAACTCAGGACTAGC,0,1586835
galEp3,0.2,4,4,GGGAGTCCGTGGTTCTCGGA,0,1592788
galEp3,0.2,4,4,GGGAGACGCTTCACTTGTGG,0,1578956
galEp3,0.2,4,4,GGGAGAAGCTCTACTCCAGC,0,1548904
galEp3,0.2,4,4,GGGACGGTGACAGCTATGGT,0,1586171
galEp3,0.2,4,4,GGGACAAACTCAGAGGCACC,0,1576796
galEp3,0.2,4,4,GGGAATGCTTAACACGGGTG,0,1560497
galEp3,0.2,4,4,GGGAATACACTTGGAGGCGT,0,1591127
galEp3,0.2,4,4,GGGAACGGATGTTCGACGTC,0,1574324
galEp3,0.2,4,4,GGGAAAATGGACCAGTGGAA,0,1572273
galEp3,0.2,4,4,GGCTTTACCCTTCCTGTAAC,0,1578628
galEp3,0.2,4,4,GGCTTGTAAGTACGGCGCGG,0,1547409
galEp3,0.2,4,4,GGCTGGTCGTCATTGCAATT,0,1593123
galEp3,0.2,4,4,GGCTCAATCTCGCAACCCTG,0,1592148
galEp3,0.2,4,4,GGCTACTCACCCTGTCAACA,0,1571957
galEp3,0.2,4,4,GGCTAATCTTCGACCTGTAT,0,1557236
galEp3,0.2,4,4,GGCGGCCACCGGATGCTCAT,0,1556330
galEp3,0.2,4,4,GGCGGATTAAGTGTGTCTAG,0,1587318
galEp3,0.2,4,4,GGCGCTCGCCTTTAAGAACA,0,1580254
galEp3,0.2,4,4,GGCGCTCGAAGTGTCTGGGA,0,1563675
galEp3,0.2,4,4,GGCGCGCGCAGCCGCGGCGA,0,1555894
galEp3,0.2,4,4,GGCGCCGGGTGCCCGTATTT,0,1558332
galEp3,0.2,4,4,GGCGCCACCGTCCTCGGGCG,0,1574238
galEp3,0.2,4,4,GGCGAAGGGCGCGCCGAACC,0,1552008
galEp3,0.2,4,4,GGCGAAAAGGTCCCCCTCCC,0,1594446
galEp3,0.2,4,4,GGCCTAAGTGGCCCACTGAA,0,1556685
galEp3,0.2,4,4,GGCCCGAGGGACACTTAAAA,0,1547749
galEp3,0.2,4,4,GGCCAGTACTCGAGTTCTCG,0,1553551
galEp3,0.2,4,4,GGCATTAAGAAATAAGCCTT,0,1568347
galEp3,0.2,4,4,GGCATCCAAAGAGACCGCGG,0,1581181
galEp3,0.2,4,4,GGCATAATGCGTGCGCTCAG,0,1581952
galEp3,0.2,4,4,GGATGCGGATGATATCGCGC,0,1567056
galEp3,0.2,4,4,GGATATCCTCCTTTGAGTCC,0,1547913
galEp3,0.2,4,4,GGAGTATAGATGGGCCGCTA,0,1560305
galEp3,0.2,4,4,GGAGGGGCACGATTGGGAAC,0,1567943
galEp3,0.2,4,4,GGAGATCCGGAGACGCGGCA,0,1571191
galEp3,0.2,4,4,GGAGATCAGTCAATAGTGAA,0,1593739
galEp3,0.2,4,4,GGACGTTAATGGTCCCGGGT,0,1584891
galEp3,0.2,4,4,GGACGGTGAGGAGTCAACAC,0,1557348
galEp3,0.2,4,4,GGACGCCCCGGCATAGAGCC,0,1554520
galEp3,0.2,4,4,GGACCTCAGCGTTATGGATA,0,1566374
galEp3,0.2,4,4,GGAATTGAACCCATCTAGGG,0,1579416
galEp3,0.2,4,4,GGAAGTTGAGGCTTTCGATA,0,1575583
galEp3,0.2,4,4,GGAAGCGTCGAACTGGGGGA,0,1559957
galEp3,0.2,4,4,GGAACTCCGCCCAGACGTCC,0,1593993
galEp3,0.2,4,4,GGAACGACCCTGTCCAAGGT,0,1586641
galEp3,0.2,4,4,GGAACCCGGGCTAGTATTCA,0,1571720
galEp3,0.2,4,4,GGAACAGAACTTCCTAGATT,0,1588870
galEp3,0.2,4,4,GGAAATCTGGAGCAGCAAAG,0,1560398
galEp3,0.2,4,4,GGAAACATAATGAACACTGG,0,1561228
galEp3,0.2,4,4,GCTTCGGTACAGGTGTATTA,0,1576986
galEp3,0.2,4,4,GCTGTTCGACACTGTGAGGT,0,1574607
galEp3,0.2,4,4,GCTGGAAGACTTTTGCCTCT,0,1557831
galEp3,0.2,4,4,GCTGAGGTCAGTAGTACGTG,0,1566564
galEp3,0.2,4,4,GCTCTCCCTCCCCCTGTGAA,0,1565392
galEp3,0.2,4,4,GCTCGTCCCTGTACGACGTT,0,1579694
galEp3,0.2,4,4,GCTCGCCGCGGTTCGTATAC,0,1556500
galEp3,0.2,4,4,GCTCGATGGCTGTTTTATCC,0,1564405
galEp3,0.2,4,4,GCTCATATTGCCTTTTACCA,0,1580006
galEp3,0.2,4,4,GCTCATAGCCGTTCAGGTAA,0,1556883
galEp3,0.2,4,4,GCTCAAAGTTGGGTCCTGTC,0,1571911
galEp3,0.2,4,4,GCGTTTTGACTAGAGAGATT,0,1589898
galEp3,0.2,4,4,GCGTGCTTTGCTTGTGTCGC,0,1568840
galEp3,0.2,4,4,GCGTCTTATACCGCAACACA,0,1573603
galEp3,0.2,4,4,GCGGCCTCGTGGACCTCGCA,0,1559465
galEp3,0.2,4,4,GCGGCAGGAAACTGACATTC,0,1552488
galEp3,0.2,4,4,GCGGAGGTCACAGCCCCCGG,0,1578849
galEp3,0.2,4,4,GCGCTAAGTGCCGTACGCCT,0,1582774
galEp3,0.2,4,4,GCGATTGCAGGGTCCGGTTC,0,1569701
galEp3,0.2,4,4,GCGAACGGCAGCACCACCCA,0,1557525
galEp3,0.2,4,4,GCCTGTCAAATTGGGAACTG,0,1587776
galEp3,0.2,4,4,GCCTGCGTTCCTTCGAGAGT,0,1592683
galEp3,0.2,4,4,GCCGTAAATCGTATTCGCTT,0,1556999
galEp3,0.2,4,4,GCCGCTAAGGACCCTGTCGC,0,1587623
galEp3,0.2,4,4,GCCGAATTAGCGCTTTCAGC,0,1546972
galEp3,0.2,4,4,GCCCTTGCACTCCAACGGTG,0,1569748
galEp3,0.2,4,4,GCCCTGTACCAGAGGGGACA,0,1586964
galEp3,0.2,4,4,GCCCGTATATAAGGCTACTC,0,1582218
galEp3,0.2,4,4,GCCCGCAAAGATCAGCTGGA,0,1559550
galEp3,0.2,4,4,GCCCCGGATTGCCAGTATCT,0,1592062
galEp3,0.2,4,4,GCCATCTTATTTCCGGTGGG,0,1556810
galEp3,0.2,4,4,GCCACCTGTTGGACAGTGTT,0,1576671
galEp3,0.2,4,4,GCCACACTACAATGATAAAC,0,1554739
galEp3,0.2,4,4,GCCAATAGGATCTACTGAGC,0,1577526
galEp3,0.2,4,4,GCCAAGCCTTCGGGAGCTAA,0,1556539
galEp3,0.2,4,4,GCATGTGCAGCTGTCCTACC,0,1581892
galEp3,0.2,4,4,GCATCGATTATGTAGAAAGT,0,1549704
galEp3,0.2,4,4,GCATCGACCCGGGTTAATGT,0,1566415
galEp3,0.2,4,4,GCATCACTCCTTATTACTCG,0,1558315
galEp3,0.2,4,4,GCATAACGTGTTGATTGGCA,0,1591568
galEp3,0.2,4,4,GCAGGTCTTTAACGGTGTCG,0,1569463
galEp3,0.2,4,4,GCAGCTAGTTCTAGTGTCTT,0,1594485
galEp3,0.2,4,4,GCAGCCTTCATTGAAGCGTA,0,1551516
galEp3,0.2,4,4,GCAGAAGCTGGCATAACTTT,0,1567074
galEp3,0.2,4,4,GCAATCAGAATTTGCAACTT,0,1570582
galEp3,0.2,4,4,GCAAGGTCAAACCAGTGTAC,0,1564305
galEp3,0.2,4,4,GCAAGGTAATCCGCTAAATC,0,1568850
galEp3,0.2,4,4,GATTCTGTGTGGTTTAATTA,0,1571395
galEp3,0.2,4,4,GATTCACTATACGCGCTACC,0,1554343
galEp3,0.2,4,4,GATTAGATACGAGAGAGCAA,0,1568048
galEp3,0.2,4,4,GATTACCTATGAGCTGGTTA,0,1568148
galEp3,0.2,4,4,GATGTTAAGAACCGATGTCT,0,1581627
galEp3,0.2,4,4,GATGGCCCCTAGATTAGCCC,0,1585773
galEp3,0.2,4,4,GATGCTGCACGGGTATTAAA,0,1555232
galEp3,0.2,4,4,GATGCGTGGTAACGGTCGTC,0,1575509
galEp3,0.2,4,4,GATGCCGTAATACTAAGGGA,0,1561174
galEp3,0.2,4,4,GATCCATATTCCGGCATAAT,0,1583918
galEp3,0.2,4,4,GATCAAAATTATTTCGCATT,0,1569279
galEp3,0.2,4,4,GATACTCTGATTCGAATGAA,0,1563015
galEp3,0.2,4,4,GATACGAAATCACGGACCAA,0,1572922
galEp3,0.2,4,4,GATACCAGTTGGGCAACCCA,0,1586153
galEp3,0.2,4,4,GATAAGTACAGTCTTTGTTG,0,1576053
galEp3,0.2,4,4,GATAAATTAGGCCGTTGGTA,0,1547891
galEp3,0.2,4,4,GATAAAAAAAAGAGACCTTT,0,1554699
galEp3,0.2,4,4,GAGTGTGGCCATCCCGACGC,0,1592031
galEp3,0.2,4,4,GAGTGCTTGCTAGTATACGA,0,1548733
galEp3,0.2,4,4,GAGTGCTGAAGGGCATCAAT,0,1553729
galEp3,0.2,4,4,GAGTGAGCATAACCTAACGC,0,1584487
galEp3,0.2,4,4,GAGTCCCTCGAGGGAGTTAT,0,1557137
galEp3,0.2,4,4,GAGTCCAAAATATGGTAAGT,0,1565576
galEp3,0.2,4,4,GAGGTGGGGTCCTCCCGTAA,0,1569777
galEp3,0.2,4,4,GAGGCCTTTTTCAAGGTGAG,0,1549646
galEp3,0.2,4,4,GAGGAAGCAATTTGTAGATC,0,1566540
galEp3,0.2,4,4,GAGCACTTTACGCTCGCTGC,0,1577847
galEp3,0.2,4,4,GAGCACACATCCATGCTGCT,0,1551532
galEp3,0.2,4,4,GAGATGGACAAGCCCACGCA,0,1594547
galEp3,0.2,4,4,GAGAGGTGTATGTTGACCTA,0,1591900
galEp3,0.2,4,4,GAGAGCACATGAATGCTCGC,0,1593696
galEp3,0.2,4,4,GAGAGAGCCTTGAAGGTCCC,0,1574767
galEp3,0.2,4,4,GAGAGAACCTATCAATTTAG,0,1550295
galEp3,0.2,4,4,GAGAATCGATTCGGCGCTTG,0,1592993
galEp3,0.2,4,4,GACTTAGCCTTTCACGTGTT,0,1581901
galEp3,0.2,4,4,GACGTGTGCGGTACGTCTTC,0,1567249
galEp3,0.2,4,4,GACGTCGATGCGGATGGGAA,0,1562040
galEp3,0.2,4,4,GACGCTGACTGTATGCGAAT,0,1572956
galEp3,0.2,4,4,GACCGTTACATGTGGAGTCG,0,1559400
galEp3,0.2,4,4,GACCGGGAATTCAAGAATGA,0,1581920
galEp3,0.2,4,4,GACCGCCTTGCCAGGTTTTT,0,1570057
galEp3,0.2,4,4,GACCCTCTTCTAACCACTGG,0,1548057
galEp3,0.2,4,4,GACATGGCCGGAACTATCCG,0,1565985
galEp3,0.2,4,4,GACAAACCGTGCGCTCTAAG,0,1570716
galEp3,0.2,4,4,GAATTTCCATCCCGGCGAGA,0,1555790
galEp3,0.2,4,4,GAATTGTGTCGGCCGTCTGC,0,1584503
galEp3,0.2,4,4,GAATTGCGACTTACGTTGTG,0,1588013
galEp3,0.2,4,4,GAATTCCTACCGGGGTAGAG,0,1566609
galEp3,0.2,4,4,GAATGAAGTGGTCCTGGAAC,0,1571656
galEp3,0.2,4,4,GAATGAAGGGAGCTAGTTGA,0,1575691
galEp3,0.2,4,4,GAATCTCGGTTGAATCATCT,0,1564523
galEp3,0.2,4,4,GAAGGGTTACAACACGAAGT,0,1551560
galEp3,0.2,4,4,GAAGGATCAACAGGGAAAGA,0,1573333
galEp3,0.2,4,4,GAAGCTTTTTACAGACTCCG,0,1561810
galEp3,0.2,4,4,GAACGCTTGGTCATGTGCAT,0,1566106
galEp3,0.2,4,4,GAACATGAAATATTAGCCAA,0,1588877
galEp3,0.2,4,4,GAACATACTTAGGTTCAAAG,0,1554282
galEp3,0.2,4,4,GAACAGAGCCGTATCGCGCT,0,1576959
galEp3,0.2,4,4,GAACAATTCAGACGCGGAGG,0,1570902
galEp3,0.2,4,4,GAAATGGTAGCTGAACGCTA,0,1590916
galEp3,0.2,4,4,GAAATAAGCAGCCCTTTGAC,0,1564419
galEp3,0.2,4,4,GAAAGGTGCCTCGGGGTGCT,0,1555489
galEp3,0.2,4,4,GAAAGGGTTTGGCGACAAGG,0,1586272
galEp3,0.2,4,4,GAAAGCCCCAGGAAATAACT,0,1593318
galEp3,0.2,4,4,CTTTTGATCTTGTCCGAGGG,0,1588144
galEp3,0.2,4,4,CTTTGTTGGGTTAAGTATTG,0,1577133
galEp3,0.2,4,4,CTTTCTCGTAGTGACACATA,0,1562845
galEp3,0.2,4,4,CTTTCTCGATTGGTATGGTG,0,1547389
galEp3,0.2,4,4,CTTTAGTCGCTGATGCAACA,0,1547776
galEp3,0.2,4,4,CTTTAACCCTGCACTCCTGC,0,1569606
galEp3,0.2,4,4,CTTGCGCAGGGACCAAAGCG,0,1570494
galEp3,0.2,4,4,CTTGCAACCTCGCTTCGGCC,0,1567446
galEp3,0.2,4,4,CTTGATTCTGCGCATATTAA,0,1564341
galEp3,0.2,4,4,CTTGAACGAATTTCCCCGAA,0,1551540
galEp3,0.2,4,4,CTTCTGCCCTATGGGTGTTT,0,1582374
galEp3,0.2,4,4,CTTCGTCTATTGGGACGCTT,0,1552030
galEp3,0.2,4,4,CTTCGGTTACGTAACATGGC,0,1584556
galEp3,0.2,4,4,CTTCGGGCTGTTGAACCATA,0,1574081
galEp3,0.2,4,4,CTTCGGCCCCGATGGTCCTC,0,1569854
galEp3,0.2,4,4,CTTCCATCTGTCATTGACTA,0,1568329
galEp3,0.2,4,4,CTTCCAAAGCATGCGCTAGC,0,1547151
galEp3,0.2,4,4,CTTCATACTGCGTCCTTGTC,0,1583447
galEp3,0.2,4,4,CTTCAGGATAGCCGATTGTA,0,1592203
galEp3,0.2,4,4,CTTATGGCGCATGCAAAGAC,0,1565929
galEp3,0.2,4,4,CTTATAGTCTGGGCCGCATA,0,1588563
galEp3,0.2,4,4,CTTAGGCACCATTCTTGGAC,0,1558169
galEp3,0.2,4,4,CTTAGCTTAAACCCGATGCG,0,1558106
galEp3,0.2,4,4,CTTAGCTCTCCTACGATACT,0,1585596
galEp3,0.2,4,4,CTTACCGGCGCTAGATATAT,0,1550033
galEp3,0.2,4,4,CTTACATCGCGAAAAAGGCA,0,1582254
galEp3,0.2,4,4,CTGTGTGGGGAGCAGTAACT,0,1573232
galEp3,0.2,4,4,CTGTGCCGCAGTCATCCCCG,0,1586432
galEp3,0.2,4,4,CTGTATATCAGAGAGGTTCA,0,1570932
galEp3,0.2,4,4,CTGGTTTTGGTCGTGAGCGT,0,1573378
galEp3,0.2,4,4,CTGGGCGCCCAAATAGCAAA,0,1569826
galEp3,0.2,4,4,CTGGGCACCGGCCCGTGTAA,0,1590892
galEp3,0.2,4,4,CTGGCGCATGATTGTCAACT,0,1594084
galEp3,0.2,4,4,CTGCTAACATACTGCTCGGA,0,1587275
galEp3,0.2,4,4,CTGCGGTCTTTTAGAGAGGA,0,1568771
galEp3,0.2,4,4,CTGCCACGGGAAAATAGATG,0,1555386
galEp3,0.2,4,4,CTGATGAAATATCTTATAGT,0,1589541
galEp3,0.2,4,4,CTGAGCCATTACGCCGCAAA,0,1559495
galEp3,0.2,4,4,CTGACCAGTACTTCCGGTTG,0,1556854
galEp3,0.2,4,4,CTGAAAGATCGGAAATTCCC,0,1548059
galEp3,0.2,4,4,CTGAAAAAGAGCACACAAGG,0,1551923
galEp3,0.2,4,4,CTCTTAGATGGTAATACCCA,0,1554329
galEp3,0.2,4,4,CTCTGGCGGCCTTCGGAGGG,0,1569772
galEp3,0.2,4,4,CTCTGCGGTATGCCTATCAT,0,1570603
galEp3,0.2,4,4,CTCTAGTGGAACTTCGCGCT,0,1567639
galEp3,0.2,4,4,CTCTAGGGAACGTATGAACA,0,1554503
galEp3,0.2,4,4,CTCGTTTACCTAGGAGAGCG,0,1581610
galEp3,0.2,4,4,CTCGGGTCAAATGCTTGTAT,0,1558966
galEp3,0.2,4,4,CTCGGGATACGCACCACGAC,0,1581431
galEp3,0.2,4,4,CTCGATGGGCTGCACCACGT,0,1572125
galEp3,0.2,4,4,CTCGACTGTGTCAAGGGTCC,0,1558568
galEp3,0.2,4,4,CTCCCATTGGTGCTTGACGT,0,1565669
galEp3,0.2,4,4,CTCCCACATTTCTGCCCCCA,0,1555385
galEp3,0.2,4,4,CTCATGCGCTACCTGTGATT,0,1560413
galEp3,0.2,4,4,CTCATACCGCACCCATATGC,0,1586717
galEp3,0.2,4,4,CTCACTTGACATAAGAAGCT,0,1568400
galEp3,0.2,4,4,CTATTCAACTCGAAGCTTAA,0,1561715
galEp3,0.2,4,4,CTATTACTAACACGGTTCTT,0,1551377
galEp3,0.2,4,4,CTATGGTTAACGGCATTCGA,0,1592840
galEp3,0.2,4,4,CTATGATTTAGGCCCTACAC,0,1576626
galEp3,0.2,4,4,CTATGACTTACTCGAATTGA,0,1554719
galEp3,0.2,4,4,CTATGACACGATAAACAATA,0,1566126
galEp3,0.2,4,4,CTAGGACAATATGCGTTGTT,0,1594204
galEp3,0.2,4,4,CTAGCCCCCTAGTTTCTGGT,0,1591705
galEp3,0.2,4,4,CTAGCAACGGGGACTGCCAC,0,1587375
galEp3,0.2,4,4,CTAGAGGGCAATAATCCCTC,0,1581969
galEp3,0.2,4,4,CTAGAAATAGGGTAGATGAC,0,1593299
galEp3,0.2,4,4,CTACTGATGTGCTCTATCAA,0,1577520
galEp3,0.2,4,4,CTACGTATCCCTTCTAATTC,0,1581907
galEp3,0.2,4,4,CTACGGTGCATCAGTTCCAT,0,1593769
galEp3,0.2,4,4,CTACGATCTAAAGGAGGCAA,0,1588942
galEp3,0.2,4,4,CTAAGCTAGGATACAGTCTC,0,1582191
galEp3,0.2,4,4,CTAAGATACTTTAGTATCTA,0,1580888
galEp3,0.2,4,4,CTAAATTATAAGCTTGTCCC,0,1571471
galEp3,0.2,4,4,CTAAAAAATTGGCAAAGCAG,0,1550727
galEp3,0.2,4,4,CGTTTTAGGCGAACGACTGA,0,1559394
galEp3,0.2,4,4,CGTTTCCTCCCTGTGACCTC,0,1553774
galEp3,0.2,4,4,CGTTCATAGCGTTGTCTATC,0,1552925
galEp3,0.2,4,4,CGTTATTGCCAGTTCGGCCA,0,1560167
galEp3,0.2,4,4,CGTGTTATCATCTTGACAAC,0,1549783
galEp3,0.2,4,4,CGTGTTAGCATTGCGGGTCT,0,1556951
galEp3,0.2,4,4,CGTGCAGGTCTCGGTTCCAA,0,1556504
galEp3,0.2,4,4,CGTGAGTCCGCGTCCCATGA,0,1565047
galEp3,0.2,4,4,CGTCATCCCGGAGTTCTAAG,0,1562245
galEp3,0.2,4,4,CGTATTCGATCGGGATCAAG,0,1557572
galEp3,0.2,4,4,CGTAGTGTAGGATAAGGCTC,0,1590779
galEp3,0.2,4,4,CGTAGAGGCCACGAAATTGT,0,1547896
galEp3,0.2,4,4,CGTACGTTCGCACACACACA,0,1584483
galEp3,0.2,4,4,CGTACATAGCCTCACACCCA,0,1560415
galEp3,0.2,4,4,CGGTGCGCACCGGCTAGCCA,0,1587585
galEp3,0.2,4,4,CGGTCCTAGGAATTCGAAGC,0,1558298
galEp3,0.2,4,4,CGGTCAAGAAGATTCGTCAT,0,1584724
galEp3,0.2,4,4,CGGTATAATCAGTCCGACTG,0,1581423
galEp3,0.2,4,4,CGGGGGTTTCGCGGACATGT,0,1592415
galEp3,0.2,4,4,CGGGGGTGCGTAGTTACGGA,0,1589502
galEp3,0.2,4,4,CGGGGGCCCTCTGCTCCCGT,0,1575267
galEp3,0.2,4,4,CGGGGCGTATAGCAAGATTC,0,1550626
galEp3,0.2,4,4,CGGGGACATTAATTCAAGGT,0,1585847
galEp3,0.2,4,4,CGGGCTATTAACCGGGCGTT,0,1566745
galEp3,0.2,4,4,CGGGCGTAGGCATAATGCAC,0,1555011
galEp3,0.2,4,4,CGGCGTAGTGGGATTCAGTA,0,1585154
galEp3,0.2,4,4,CGGCGGACTTATCGGACCTT,0,1584689
galEp3,0.2,4,4,CGGCGCGAAAGTTATGTGGT,0,1573212
galEp3,0.2,4,4,CGGCGAGGGTCCCGTGCTTC,0,1554104
galEp3,0.2,4,4,CGGCCCCGAGAGTTTTAGGA,0,1591660
galEp3,0.2,4,4,CGGCCCATGGGGGAAAGAGG,0,1548106
galEp3,0.2,4,4,CGGCCAGTATGACGCCTCAT,0,1559287
galEp3,0.2,4,4,CGGCAATGATTAGAGCTAGG,0,1557295
galEp3,0.2,4,4,CGGCAAAACTAAATTATCAT,0,1592770
galEp3,0.2,4,4,CGGATGTACGGCTGGTAAGT,0,1555918
galEp3,0.2,4,4,CGGAGGCGGACAGGCGGCTT,0,1584001
galEp3,0.2,4,4,CGGAGCTGATAGACGTTAGC,0,1564923
galEp3,0.2,4,4,CGGACCGAAGGGGTTGGCCA,0,1582364
galEp3,0.2,4,4,CGCTAAAAAATTGATACGGA,0,1560444
galEp3,0.2,4,4,CGCGGGTCGGCCACGTCCCG,0,1571267
galEp3,0.2,4,4,CGCGCGAGGACTAACTATAC,0,1577724
galEp3,0.2,4,4,CGCCTTTTGGCATGGGAAAA,0,1578634
galEp3,0.2,4,4,CGCCTCTGATGGTTATTCTC,0,1595174
galEp3,0.2,4,4,CGCCGGGAACAGTCATCGCA,0,1566477
galEp3,0.2,4,4,CGCCCACATATTCGCTAAGT,0,1561506
galEp3,0.2,4,4,CGCATGACTCGTCAAAGTTA,0,1556396
galEp3,0.2,4,4,CGCATCTAAAGAGTTATTTG,0,1575427
galEp3,0.2,4,4,CGCATATATCTACAATCATC,0,1579715
galEp3,0.2,4,4,CGCAGGAACAACGTACGTAA,0,1558939
galEp3,0.2,4,4,CGATTAGTCAGGCGCGTAAT,0,1568667
galEp3,0.2,4,4,CGATGGACTGCGTATCCCTT,0,1570454
galEp3,0.2,4,4,CGATCCTTTTACTGAACGGT,0,1584617
galEp3,0.2,4,4,CGATCATAACGGCCTAGGCT,0,1576413
galEp3,0.2,4,4,CGAGTTGTTACGAGCTCATG,0,1589618
galEp3,0.2,4,4,CGAGGGTGTCTAATGTGTTA,0,1569253
galEp3,0.2,4,4,CGAGGCAGTGACTCTGCGCC,0,1577536
galEp3,0.2,4,4,CGAGGCAGCTGAATATCCCC,0,1571065
galEp3,0.2,4,4,CGAGGCACTTACAAACGATA,0,1560292
galEp3,0.2,4,4,CGAGCGTGGTACCTATAGCT,0,1584766
galEp3,0.2,4,4,CGAGCGCCGTGTATCAGTTG,0,1554384
galEp3,0.2,4,4,CGAGATACGAATTCAGGTCT,0,1559455
galEp3,0.2,4,4,CGAGACGCGGCTCTTTCACG,0,1559013
galEp3,0.2,4,4,CGAGACCTTGGACCTGATCG,0,1559703
galEp3,0.2,4,4,CGAGACCGAAATGACGGTAA,0,1580016
galEp3,0.2,4,4,CGACCGTAGTTGATTCGACA,0,1584548
galEp3,0.2,4,4,CGAATCTTTGATTCTTAGGG,0,1585866
galEp3,0.2,4,4,CGAAGTATGCCCATTAAGCC,0,1564783
galEp3,0.2,4,4,CGAAGGCCTAGGAAGGACCA,0,1560818
galEp3,0.2,4,4,CGAAGCGTGCTACGAAAATA,0,1589295
galEp3,0.2,4,4,CCTTTCATCGTTATCGGGCT,0,1594036
galEp3,0.2,4,4,CCTGTGGTGTCGGAGACCAT,0,1587265
galEp3,0.2,4,4,CCTGTCCCGCACGCTAATCT,0,1574412
galEp3,0.2,4,4,CCTGCGTTCCACCGTTCGTG,0,1551831
galEp3,0.2,4,4,CCTCGGATCTAATCCTGCAG,0,1576369
galEp3,0.2,4,4,CCTCGAGAATGGCGCCATGT,0,1570349
galEp3,0.2,4,4,CCTCCTTTCACAAGTTAGGA,0,1565593
galEp3,0.2,4,4,CCGTCCACAGTAGAGGCCAT,0,1593415
galEp3,0.2,4,4,CCGTCAGATAACCGTATTAT,0,1555119
galEp3,0.2,4,4,CCGTATGCACTCAACATGTG,0,1569593
galEp3,0.2,4,4,CCGTAACTGATTCCTACTTG,0,1548342
galEp3,0.2,4,4,CCGGTGGAAATGACGCCCAG,0,1574758
galEp3,0.2,4,4,CCGGTGACAATCAGTAAGGG,0,1564251
galEp3,0.2,4,4,CCGGGCGGGGGCACAGCGAC,0,1574422
galEp3,0.2,4,4,CCGGGCCTGTAAGCCATGGG,0,1559481
galEp3,0.2,4,4,CCGGCCAAAAATCACCCTGA,0,1576524
galEp3,0.2,4,4,CCGGACCGAGCTACAACTAT,0,1563812
galEp3,0.2,4,4,CCGCTGGGAGCGCCCACCAG,0,1564798
galEp3,0.2,4,4,CCGCTCTAAACACACGGGGG,0,1551767
galEp3,0.2,4,4,CCGCGCTTATTACTCGGGAT,0,1587205
galEp3,0.2,4,4,CCGCCGGTGACGTTTTATGT,0,1581433
galEp3,0.2,4,4,CCGCCGACGATTGTTTTAAG,0,1587636
galEp3,0.2,4,4,CCGCCCTCGGGCCAGGCCTA,0,1568426
galEp3,0.2,4,4,CCGCCAATCCGTCGTGGGAC,0,1579036
galEp3,0.2,4,4,CCGCAGCCGCGAGCGGGTTA,0,1550053
galEp3,0.2,4,4,CCGCAAACCTAATGCTTAGC,0,1584594
galEp3,0.2,4,4,CCGATTCTAGTTCCTCAGTA,0,1551420
galEp3,0.2,4,4,CCGATATTGCCAGTACTGCT,0,1571583
galEp3,0.2,4,4,CCGATACTCCTCGACCGATG,0,1570813
galEp3,0.2,4,4,CCGAGTGGAGCCATGCCTGT,0,1592397
galEp3,0.2,4,4,CCGAGAGCGTACACATCCAA,0,1571790
galEp3,0.2,4,4,CCCTGTTTAATGGGTCACTG,0,1547936
galEp3,0.2,4,4,CCCTGTACATTAACATAGGT,0,1576367
galEp3,0.2,4,4,CCCTCTTGTCCGTAGGGTCA,0,1549874
galEp3,0.2,4,4,CCCTCGTTTAGTTAAAGTAG,0,1566744
galEp3,0.2,4,4,CCCTCAGAAGGACCGAACGT,0,1580334
galEp3,0.2,4,4,CCCTATCAGGTTGAATTTTT,0,1551557
galEp3,0.2,4,4,CCCTACCAGCGGAACTTCAA,0,1583253
galEp3,0.2,4,4,CCCTAATTGTGGGCCAGGCC,0,1580385
galEp3,0.2,4,4,CCCGTAAGTCAGAAGTGGAA,0,1559136
galEp3,0.2,4,4,CCCGGTGTATCTGCTCGCTT,0,1585033
galEp3,0.2,4,4,CCCCTGTTCGATGAGAGCGT,0,1581521
galEp3,0.2,4,4,CCCCGCCGTTGTGCCCGGGT,0,1580010
galEp3,0.2,4,4,CCCCGCCGGCCGGCAGATAG,0,1585575
galEp3,0.2,4,4,CCCCCGGCCTACACTAAGCT,0,1573243
galEp3,0.2,4,4,CCCCACCCACCGTATTTACA,0,1565276
galEp3,0.2,4,4,CCCATTTGGGGACGCAATTA,0,1574902
galEp3,0.2,4,4,CCCATTCTCGGGGATCCCTC,0,1556464
galEp3,0.2,4,4,CCCATAAGCTTAGGGGACGT,0,1589513
galEp3,0.2,4,4,CCCAGAAAGTTTACAGTGGC,0,1593319
galEp3,0.2,4,4,CCCAAGCCCAGACTAGAGCT,0,1577239
galEp3,0.2,4,4,CCCAAGAAACACGAGAACAA,0,1583023
galEp3,0.2,4,4,CCCAAAAATGGCTGTGCCAG,0,1579760
galEp3,0.2,4,4,CCATTGCTGCCATTCGGCGG,0,1579001
galEp3,0.2,4,4,CCATCTTCACTTCCGGGCTG,0,1586895
galEp3,0.2,4,4,CCATCCGTAGTAACGTCTCG,0,1570469
galEp3,0.2,4,4,CCATATCGACCACTGGGTGA,0,1557501
galEp3,0.2,4,4,CCAGTCGGTATGTTGGAAAG,0,1553988
galEp3,0.2,4,4,CCAGGTAAGTCGTGAACTTT,0,1562415
galEp3,0.2,4,4,CCAGGGGAGCCGCCGGCGCT,0,1557235
galEp3,0.2,4,4,CCAGGGCGGACCCGGAAGCT,0,1548975
galEp3,0.2,4,4,CCACTGCCTTTATTACATCC,0,1590945
galEp3,0.2,4,4,CCACGAGCTGGCAGTAATGC,0,1588010
galEp3,0.2,4,4,CCACGAAGGGTTTTGATATC,0,1592462
galEp3,0.2,4,4,CCACGAACCGTCGGGCAATA,0,1555916
galEp3,0.2,4,4,CCACAGAGTAGAACTCTACT,0,1592692
galEp3,0.2,4,4,CCAATCTAATTCTTTTGATC,0,1568145
galEp3,0.2,4,4,CCAAATTGTAGCGAAGGACT,0,1576057
galEp3,0.2,4,4,CCAAACGGGTTCAATTGCAG,0,1573149
galEp3,0.2,4,4,CCAAACAGGTGATGAATCCG,0,1591641
galEp3,0.2,4,4,CATTCCTAGGGAGGCGTCTC,0,1554361
galEp3,0.2,4,4,CATGGGTAGTTCTTCAAGGG,0,1592694
galEp3,0.2,4,4,CATGCTGCCGCGTAAGTGAT,0,1590655
galEp3,0.2,4,4,CATCTGGTCATAAATAGATG,0,1567326
galEp3,0.2,4,4,CATCGTTATATCAGCCCTCA,0,1581174
galEp3,0.2,4,4,CATCGCTCATCTCATTAAAA,0,1590409
galEp3,0.2,4,4,CATCACGATTTGTAAATTTG,0,1593417
galEp3,0.2,4,4,CATCACAGTCCTATGTGAGT,0,1594770
galEp3,0.2,4,4,CATATGCCGCGACAGGTCTT,0,1581074
galEp3,0.2,4,4,CATATACCTAAAAGGTAAAT,0,1587763
galEp3,0.2,4,4,CATAGATGGGCCACCCGTCC,0,1578065
galEp3,0.2,4,4,CATACATTCCTTGGAGTGCG,0,1571002
galEp3,0.2,4,4,CAGTTTGCGTCTTGCACTAA,0,1555606
galEp3,0.2,4,4,CAGTTTGACGCTCACGAATC,0,1563559
galEp3,0.2,4,4,CAGTTCGGGTAGTACAATTA,0,1573946
galEp3,0.2,4,4,CAGTGCGCACAGCTCCGAGA,0,1594155
galEp3,0.2,4,4,CAGTGAACAATCGAGCCTTT,0,1576955
galEp3,0.2,4,4,CAGTCTCCGGAAGAGGAGAT,0,1562622
galEp3,0.2,4,4,CAGTCGTTTAGGCCGTAACC,0,1579433
galEp3,0.2,4,4,CAGTAGACATTGGATGAGGT,0,1566358
galEp3,0.2,4,4,CAGGTTAACTGGGATCATTC,0,1557166
galEp3,0.2,4,4,CAGGGTAAGCTGAACTATCC,0,1582882
galEp3,0.2,4,4,CAGGGGCCGCTCAAGAGAAT,0,1562543
galEp3,0.2,4,4,CAGGGGCAGTGGTTGGTCCC,0,1583465
galEp3,0.2,4,4,CAGGGCATCAATCTGTGGCT,0,1574963
galEp3,0.2,4,4,CAGCCTCTTCGGTCCGAGGC,0,1570336
galEp3,0.2,4,4,CAGCACGTGTTCGGTTGCCT,0,1593173
galEp3,0.2,4,4,CAGCACACTGAGGCATGGAA,0,1589268
galEp3,0.2,4,4,CAGATGTTCGTTTTTATCGC,0,1580530
galEp3,0.2,4,4,CAGACTTATAGTGCAGCGGG,0,1555270
galEp3,0.2,4,4,CAGAACCTAGACGGATCAGG,0,1586093
galEp3,0.2,4,4,CACTTTCTCCAGGCTAGATG,0,1548737
galEp3,0.2,4,4,CACTTAGTGTTACAATATGG,0,1570091
galEp3,0.2,4,4,CACTATATGGTAGTTCTTCT,0,1574938
galEp3,0.2,4,4,CACGTTAGCATCGCCGCTTG,0,1548633
galEp3,0.2,4,4,CACGGACCGGACAGTATTGG,0,1585484
galEp3,0.2,4,4,CACGACTGTTTAACGTTGAT,0,1576900
galEp3,0.2,4,4,CACGAACGTATGCGGTCACT,0,1580872
galEp3,0.2,4,4,CACCAGAGTTAGAACTCGAT,0,1581243
galEp3,0.2,4,4,CACATTTAATTATAGAGTTA,0,1583395
galEp3,0.2,4,4,CACATATCAGGTGTACTTCC,0,1555147
galEp3,0.2,4,4,CACAGTGCCGGAGTCCACCT,0,1581479
galEp3,0.2,4,4,CACAGCGCGTACTAATATGC,0,1547975
galEp3,0.2,4,4,CACAGAGGTGGGGCATCTGC,0,1587186
galEp3,0.2,4,4,CACACTCCCCCTCCAACGAG,0,1552974
galEp3,0.2,4,4,CACAAACGCAGCCGGCTCAC,0,1551910
galEp3,0.2,4,4,CACAAACGACGCAATTTAGC,0,1565319
galEp3,0.2,4,4,CAATTCGCGGATGTGAGGTT,0,1548347
galEp3,0.2,4,4,CAATTAGGCTCTCTTCAGGA,0,1566525
galEp3,0.2,4,4,CAATTACCGGTTCTTTAGTC,0,1571175
galEp3,0.2,4,4,CAATAACTAGACCTTAAGGC,0,1552862
galEp3,0.2,4,4,CAAGTGAAATCCCTATAGCT,0,1590750
galEp3,0.2,4,4,CAAGGATGGGCTCGCTACGG,0,1586291
galEp3,0.2,4,4,CAAGGACAAACTCGGGGGTA,0,1552736
galEp3,0.2,4,4,CAAGCGGCTGCTTGGAGGCC,0,1547297
galEp3,0.2,4,4,CAAGCCCAATTTGTCTACTT,0,1575060
galEp3,0.2,4,4,CAAGAGGTCGGTGTGAAGGT,0,1586329
galEp3,0.2,4,4,CAAGAATTGCCAGTTTCTGA,0,1556130
galEp3,0.2,4,4,CAACTACTATCGTGCAATGG,0,1550137
galEp3,0.2,4,4,CAACGTGAGGCGTGATCTGT,0,1555391
galEp3,0.2,4,4,CAACCATTCGTGATAATCCG,0,1591746
galEp3,0.2,4,4,CAACAAAGCACGCTAAGGAC,0,1556321
galEp3,0.2,4,4,CAAATCATATGACGGCATCG,0,1590428
galEp3,0.2,4,4,CAAAGTAAATCCTCTTAGTA,0,1578497
galEp3,0.2,4,4,CAAAGCTTACACAAAGAAAA,0,1589051
galEp3,0.2,4,4,CAAAGAACCGGTTCTGGACT,0,1561994
galEp3,0.2,4,4,CAAACTTACGTGCAGAGTCG,0,1561033
galEp3,0.2,4,4,CAAACAGGGGCATCCCTCTT,0,1570685
galEp3,0.2,4,4,CAAAAACTGGACCCTCAGCA,0,1567441
galEp3,0.2,4,4,ATTTTCTGGCGGGGCGACTA,0,1590630
galEp3,0.2,4,4,ATTTTATGGGTAAACTGACC,0,1582604
galEp3,0.2,4,4,ATTTTATACCTACGGTGTAG,0,1548653
galEp3,0.2,4,4,ATTTCGTCCGCAGTTCTTCA,0,1592144
galEp3,0.2,4,4,ATTTCCCGCGCACCCCGAAC,0,1574265
galEp3,0.2,4,4,ATTGTTCGTCGGTATTCATT,0,1559185
galEp3,0.2,4,4,ATTGGTTAAATGGAGATACC,0,1570155
galEp3,0.2,4,4,ATTGGCCGGCCATCCAGAAG,0,1554618
galEp3,0.2,4,4,ATTGCGACTGGATCTCACGC,0,1566872
galEp3,0.2,4,4,ATTGCCCAGGCGCCTATCGC,0,1571452
galEp3,0.2,4,4,ATTGAGGCTCGCCAACGTCG,0,1586908
galEp3,0.2,4,4,ATTCTGGTTGTTGTTACGTC,0,1575330
galEp3,0.2,4,4,ATTCATCAGGTTCCGGCCAT,0,1592611
galEp3,0.2,4,4,ATTCAATCTCCTCTACATAC,0,1548535
galEp3,0.2,4,4,ATTCAAGTACGATCAGCCAC,0,1560094
galEp3,0.2,4,4,ATTCAAAACTACGGAATTGC,0,1590104
galEp3,0.2,4,4,ATTATCATTGCGGTATGGTC,0,1575505
galEp3,0.2,4,4,ATTAGGGACGGGGACCCTTT,0,1592928
galEp3,0.2,4,4,ATTACGCCGAAAAGGTGTTA,0,1586886
galEp3,0.2,4,4,ATTAAGTCGCCCCTCACTTT,0,1581547
galEp3,0.2,4,4,ATGTGGGCTAGCACCACCGT,0,1559251
galEp3,0.2,4,4,ATGTCTACTAGCGGGCATGG,0,1563674
galEp3,0.2,4,4,ATGTCATTCGAGCGACCACA,0,1557682
galEp3,0.2,4,4,ATGTCAATAAGGGTTGGAAT,0,1590370
galEp3,0.2,4,4,ATGTACGTCTGACGGCCCTA,0,1569260
galEp3,0.2,4,4,ATGTAAAGGTTCGGCGTTCA,0,1592156
galEp3,0.2,4,4,ATGGTAGACGACTATTGGAC,0,1561933
galEp3,0.2,4,4,ATGGGTAACTTACTTGAAAA,0,1552445
galEp3,0.2,4,4,ATGGGATGGTACCGTAAGTC,0,1558596
galEp3,0.2,4,4,ATGGCTAATTATGATTATTG,0,1591731
galEp3,0.2,4,4,ATGGCCACCAATACTCATAC,0,1583785
galEp3,0.2,4,4,ATGGAGCCAAAATTACGTAT,0,1580779
galEp3,0.2,4,4,ATGGAATTTCCTAATACGTT,0,1570964
galEp3,0.2,4,4,ATGCGGGATGTGTTAGGTCG,0,1553841
galEp3,0.2,4,4,ATGATTAGGATAACCGGGTA,0,1565581
galEp3,0.2,4,4,ATCTTGTTCATAGTCACACA,0,1550159
galEp3,0.2,4,4,ATCTTCCCCGAACCGCGTCT,0,1550756
galEp3,0.2,4,4,ATCTCTTGTTTGAAAACGCA,0,1569384
galEp3,0.2,4,4,ATCTATCATTGCCTTTTCTG,0,1557540
galEp3,0.2,4,4,ATCGTTGTAGTAAGCTTCAA,0,1580961
galEp3,0.2,4,4,ATCGTTGAAGGTAGGAGGAG,0,1555634
galEp3,0.2,4,4,ATCGTGAAAGGACAGAGACA,0,1559940
galEp3,0.2,4,4,ATCGCGCGGCCTCGGTCGTG,0,1554321
galEp3,0.2,4,4,ATCCTGCCATCATTCAGGGG,0,1579700
galEp3,0.2,4,4,ATCCGCCCCGCGACCTTCGT,0,1549580
galEp3,0.2,4,4,ATCCGAGTCGCGTAGAAAGC,0,1569768
galEp3,0.2,4,4,ATCCCTAGTAAGGCTCTATT,0,1589258
galEp3,0.2,4,4,ATCCCAGGTCGCTGAATTAT,0,1572520
galEp3,0.2,4,4,ATCATCGAATAGTTATCGCA,0,1565282
galEp3,0.2,4,4,ATCAGCCACAAGTTGACTGA,0,1572048
galEp3,0.2,4,4,ATCACGGGCTGATGGACCGC,0,1580478
galEp3,0.2,4,4,ATCAATGACCGGCTGTGTCG,0,1553737
galEp3,0.2,4,4,ATCAACTGATCCTAATGTGG,0,1555345
galEp3,0.2,4,4,ATCAACAGCGTAAGTACTTC,0,1552440
galEp3,0.2,4,4,ATCAAAGGCGGTTGCAAGAT,0,1568360
galEp3,0.2,4,4,ATCAAACATATATAATACGA,0,1570018
galEp3,0.2,4,4,ATATTTGCTCACTTCTACTA,0,1589472
galEp3,0.2,4,4,ATATCAAGAGGGAAGCGTTT,0,1591347
galEp3,0.2,4,4,ATATAGATTAGCAAGTCAGA,0,1581247
galEp3,0.2,4,4,ATATACTTCCCCGAGCCAGT,0,1574458
galEp3,0.2,4,4,ATAGCCCAGTTGACACTTAT,0,1576558
galEp3,0.2,4,4,ATAGAGGTTCGGCGCCCTCA,0,1588107
galEp3,0.2,4,4,ATAGAGGATGGACCTGGTAC,0,1572558
galEp3,0.2,4,4,ATACGTGTGTGCGTTGCGTG,0,1563476
galEp3,0.2,4,4,ATACCATTTATCTTAATTGA,0,1547713
galEp3,0.2,4,4,ATACAAGTTCCCGTTAACAA,0,1594631
galEp3,0.2,4,4,ATAATCTCAATATGCCGAGT,0,1592315
galEp3,0.2,4,4,ATAATATGGCCGAAGCTCAT,0,1571949
galEp3,0.2,4,4,ATAATAGGAATTCGGTTATA,0,1548258
galEp3,0.2,4,4,ATAAAGTCGCGTCTCCGGCA,0,1563372
galEp3,0.2,4,4,ATAAACGCAGGTTCGTGGGA,0,1560342
galEp3,0.2,4,4,AGTTTACTGAAAGCTATACA,0,1569572
galEp3,0.2,4,4,AGTTTACCCCGGCGGGCATA,0,1566371
galEp3,0.2,4,4,AGTTGTTTAAGCAGCGTGTA,0,1572899
galEp3,0.2,4,4,AGTTGGGTGATATGTCACGG,0,1558480
galEp3,0.2,4,4,AGTTGCTCGTCGCATTCACG,0,1557216
galEp3,0.2,4,4,AGTTGATGAAACCTCTGGCT,0,1578426
galEp3,0.2,4,4,AGTTCTACACCGAATATGCT,0,1590879
galEp3,0.2,4,4,AGTTAGCCTCACTCCTAGGT,0,1567028
galEp3,0.2,4,4,AGTGTGAACTTAGGGCCGGT,0,1550529
galEp3,0.2,4,4,AGTGTCTCCAGCTGCATCCA,0,1552174
galEp3,0.2,4,4,AGTGGTTTTTTAAGGGTGCT,0,1551565
galEp3,0.2,4,4,AGTGGCAGATTGCTTCGGGT,0,1581683
galEp3,0.2,4,4,AGTCTCTTTTGGCACCATAA,0,1570757
galEp3,0.2,4,4,AGTCTACGGCTCGTTTAAAG,0,1555978
galEp3,0.2,4,4,AGTCGTCGTAGCTATTATCG,0,1584120
galEp3,0.2,4,4,AGTCGATACGGTAAAGTTTA,0,1550773
galEp3,0.2,4,4,AGTCCGCATTGAGGCAACCT,0,1582380
galEp3,0.2,4,4,AGTCCGAGCGTGGGTCGTCG,0,1573382
galEp3,0.2,4,4,AGTCCAAGAGGAGGTCTATT,0,1552457
galEp3,0.2,4,4,AGTCACTGAAAGTCCTGGAT,0,1573177
galEp3,0.2,4,4,AGTATTTTTTGGGTTGAGTC,0,1552138
galEp3,0.2,4,4,AGTAGCATGCGTGAGTTTCT,0,1559291
galEp3,0.2,4,4,AGTAGAACATCACCCTTGGT,0,1560182
galEp3,0.2,4,4,AGTACTGGTCGGTCGTGTTT,0,1591504
galEp3,0.2,4,4,AGTACCCTCAAGGCTTGCCC,0,1555953
galEp3,0.2,4,4,AGGTGTAATTGTGGGCTGCT,0,1593956
galEp3,0.2,4,4,AGGTCTCGGCGAGTGCCACC,0,1549710
galEp3,0.2,4,4,AGGTCCCCTGTGATGATCGA,0,1583916
galEp3,0.2,4,4,AGGTACGGTTGTAGGGTAAA,0,1571109
galEp3,0.2,4,4,AGGGTGCAAATATCAATGTG,0,1577422
galEp3,0.2,4,4,AGGGTAAAACACGTTATTCA,0,1569780
galEp3,0.2,4,4,AGGGGCTGTTATGTGCCAGT,0,1549572
galEp3,0.2,4,4,AGGGCTCGGAATTTACGGAA,0,1563653
galEp3,0.2,4,4,AGGGCCGTTAATCTCCTAGA,0,1592716
galEp3,0.2,4,4,AGGCTACGCCCTGGCGTTAC,0,1553345
galEp3,0.2,4,4,AGGCGTACAGCGAGGTTTAA,0,1584365
galEp3,0.2,4,4,AGGCCAGTATCAGCCACCGT,0,1570796
galEp3,0.2,4,4,AGGCCAGACCAGGGGGAAGT,0,1546459
galEp3,0.2,4,4,AGGCATTGCCTAGTCTCGGA,0,1551453
galEp3,0.2,4,4,AGGATGTCCGGGCTGTGGCA,0,1552954
galEp3,0.2,4,4,AGGATGCAGCCACACTAGGT,0,1595171
galEp3,0.2,4,4,AGGATCCGGACATGAGTCCT,0,1554458
galEp3,0.2,4,4,AGGAGATACCAGTCAGATGA,0,1567953
galEp3,0.2,4,4,AGGACGCCCAAGTGTGAAAT,0,1564998
galEp3,0.2,4,4,AGGACCGTTGAAAGAGCCAT,0,1569344
galEp3,0.2,4,4,AGCTCGGGCAGAGATCGATC,0,1555553
galEp3,0.2,4,4,AGCTATTGTGATTGGGGGTT,0,1573513
galEp3,0.2,4,4,AGCTAATAAGGCACACATTG,0,1567052
galEp3,0.2,4,4,AGCGGCGTTCGAATGCATTG,0,1569187
galEp3,0.2,4,4,AGCGGCAAAATCCCGTATTG,0,1550631
galEp3,0.2,4,4,AGCGCATAACTAATCGTGGT,0,1558917
galEp3,0.2,4,4,AGCGCAAGGCTCGCCCCGTA,0,1577567
galEp3,0.2,4,4,AGCCTGAAACCGTTAGTGCG,0,1566894
galEp3,0.2,4,4,AGCCTATCGTGCGCGCACCA,0,1559162
galEp3,0.2,4,4,AGCCATACTTTGTTGCTTTT,0,1584390
galEp3,0.2,4,4,AGCCAGGCTGGATAGGCCCA,0,1589667
galEp3,0.2,4,4,AGCAGAAGTGGATTGACCTG,0,1582050
galEp3,0.2,4,4,AGCACGGAGTTTTCCCCAAT,0,1586624
galEp3,0.2,4,4,AGCAATGGTGGGGGATACGG,0,1557919
galEp3,0.2,4,4,AGCAAGTTTGGGAGGTTCAC,0,1561488
galEp3,0.2,4,4,AGATTTCCCGCATTATGTTC,0,1580527
galEp3,0.2,4,4,AGATTCGTCCTCTATGGGCT,0,1578075
galEp3,0.2,4,4,AGATGCAAAATGACAGCAAC,0,1580582
galEp3,0.2,4,4,AGATGAGGAACAGTCGAATG,0,1586155
galEp3,0.2,4,4,AGATCTGGTCTGAATGAAGG,0,1573371
galEp3,0.2,4,4,AGATAAGGGCGTGTTTGGGG,0,1572459
galEp3,0.2,4,4,AGAGGGGGTGTAGTGTACGT,0,1571981
galEp3,0.2,4,4,AGAGCCCAACCCAAATGGAT,0,1565812
galEp3,0.2,4,4,AGACCACGCTGGCGTAGGTA,0,1558598
galEp3,0.2,4,4,AGACATTGGGTTACTTGAGG,0,1562121
galEp3,0.2,4,4,AGACAATCCCAGATTCACAT,0,1591740
galEp3,0.2,4,4,AGAACTGTGTCCGAGGAAAG,0,1565550
galEp3,0.2,4,4,ACTTTTTGGTATGAGGAACC,0,1553604
galEp3,0.2,4,4,ACTTTGGAGAAACCTACCTT,0,1577084
galEp3,0.2,4,4,ACTTTGCACACGGGGACAAT,0,1566541
galEp3,0.2,4,4,ACTTCCTTTTGAAATACGGA,0,1571992
galEp3,0.2,4,4,ACTTCCCGTGCGGGGCGAAT,0,1550926
galEp3,0.2,4,4,ACTTAGCGATACAGTTGCAT,0,1566612
galEp3,0.2,4,4,ACTGTACCCATGTATGGTCT,0,1561622
galEp3,0.2,4,4,ACTGGACTTCGGAGACGCCC,0,1548685
galEp3,0.2,4,4,ACTGAGCATACTGTGGATTC,0,1583565
galEp3,0.2,4,4,ACTGACTCAGAATCTCTAAG,0,1579392
galEp3,0.2,4,4,ACTCTCACTAGCGTTCCACG,0,1574580
galEp3,0.2,4,4,ACTCCCAGGTGGCGAGATTA,0,1568422
galEp3,0.2,4,4,ACTATGCAGAATGGAAAATC,0,1590335
galEp3,0.2,4,4,ACTACGGTTTTTGCGGTCTG,0,1568249
galEp3,0.2,4,4,ACTAAAGAGCGACTGGGATG,0,1586043
galEp3,0.2,4,4,ACGTTATACGCCTCTATGGA,0,1562181
galEp3,0.2,4,4,ACGTGTTTTGGCTCGGCATT,0,1572894
galEp3,0.2,4,4,ACGTGTATGCGACACGGGCA,0,1552526
galEp3,0.2,4,4,ACGTGATCGGCGTACCGGAT,0,1568189
galEp3,0.2,4,4,ACGTCGCAACAGAAAACGAC,0,1556606
galEp3,0.2,4,4,ACGTCAGTTCCGGGGACACC,0,1563854
galEp3,0.2,4,4,ACGGTGCGGGCAAGTGATAT,0,1557809
galEp3,0.2,4,4,ACGGTCGATTTCTGCGCTTG,0,1547717
galEp3,0.2,4,4,ACGGGGGGAGTGAATGATCC,0,1553469
galEp3,0.2,4,4,ACGGGATGCTGATCATTTGT,0,1558431
galEp3,0.2,4,4,ACGGACTTCGGTTTGTCAGG,0,1584969
galEp3,0.2,4,4,ACGCGGTACGTATGGATTTA,0,1567271
galEp3,0.2,4,4,ACGATGCAGCAGTTGTTAAT,0,1569885
galEp3,0.2,4,4,ACGACCTAAAGTTTTGCAGC,0,1588992
galEp3,0.2,4,4,ACGACCGCGGCTTGTACGCA,0,1558415
galEp3,0.2,4,4,ACCTGTTGCATCCCATATTA,0,1574566
galEp3,0.2,4,4,ACCTGTCGGTAAGTTTTATA,0,1582291
galEp3,0.2,4,4,ACCGCGGTAGGGTCATTCAA,0,1583030
galEp3,0.2,4,4,ACCGAAGATGTTAGGGGTCT,0,1558483
galEp3,0.2,4,4,ACCCTGCATAAGACTTTGAT,0,1572961
galEp3,0.2,4,4,ACCCACGCTGTAGACTAAAG,0,1557923
galEp3,0.2,4,4,ACCCACACTTAGATCGGCTT,0,1570849
galEp3,0.2,4,4,ACCATCGACCATTTCTGCCG,0,1592348
galEp3,0.2,4,4,ACCAGCGGATGGATCAGCAC,0,1572442
galEp3,0.2,4,4,ACCAGAGGGCCAACTAAGCC,0,1546794
galEp3,0.2,4,4,ACCAATAATTATAGCTGTGA,0,1554774
galEp3,0.2,4,4,ACATTTAAACCGGCAAGACC,0,1556200
galEp3,0.2,4,4,ACATCGACGATATGAATGCA,0,1580036
galEp3,0.2,4,4,ACATCAGGGGAATGCCGCGT,0,1562651
galEp3,0.2,4,4,ACAGTCCGGGCAGCTTGATT,0,1563145
galEp3,0.2,4,4,ACAGTCCGAGGGTATAAGGT,0,1573884
galEp3,0.2,4,4,ACAGTACAACAGATCCCGGG,0,1575879
galEp3,0.2,4,4,ACAGGCCATGGTGATTTGAG,0,1562117
galEp3,0.2,4,4,ACAGGCACGTTAGAAAACTA,0,1562658
galEp3,0.2,4,4,ACAGCTCGAGTATGTACTTC,0,1562934
galEp3,0.2,4,4,ACAGCGGTCAATGGTCCACG,0,1566298
galEp3,0.2,4,4,ACAGCGCGAAGATTGAGAGT,0,1576808
galEp3,0.2,4,4,ACAGAGGTATGCTGCAGCAA,0,1576227
galEp3,0.2,4,4,ACAGAAGTATCTCCAGACTA,0,1555398
galEp3,0.2,4,4,ACACCATGGTCCTACGCGAG,0,1569158
galEp3,0.2,4,4,ACACACTCCTCTTAGGACCA,0,1587325
galEp3,0.2,4,4,ACACACCCATAGGATAGGTT,0,1584292
galEp3,0.2,4,4,ACAAAAAGTGGCAGGGCCTC,0,1587992
galEp3,0.2,4,4,AATTTTACTCTCTCCGTCTC,0,1563963
galEp3,0.2,4,4,AATTGGGCGCACCTCGTTAT,0,1570452
galEp3,0.2,4,4,AATTCCATTCCTGGAAACAC,0,1565700
galEp3,0.2,4,4,AATTATCGCTTTAGCTCCAG,0,1583212
galEp3,0.2,4,4,AATTACGGGTTATGCAGGAC,0,1575609
galEp3,0.2,4,4,AATGTTTCTGCACAACTACG,0,1565463
galEp3,0.2,4,4,AATGTGGTCCTGGATGGTAG,0,1569702
galEp3,0.2,4,4,AATGGTCTGCAACTCAACCG,0,1588779
galEp3,0.2,4,4,AATGGGGCCACGACCATTAT,0,1585101
galEp3,0.2,4,4,AATGGCCTTTTTTAGCCAGA,0,1582357
galEp3,0.2,4,4,AATGCCACTGCGGAATCGCG,0,1573342
galEp3,0.2,4,4,AATCTAGATAATAGCATCAT,0,1594716
galEp3,0.2,4,4,AATCCGTTCATTAATAACTC,0,1582877
galEp3,0.2,4,4,AATCAAAGCGCACAGTTCAA,0,1556693
galEp3,0.2,4,4,AATATCCACCCCTAAGGTAA,0,1591530
galEp3,0.2,4,4,AATATCAACGCCGGAAGTTC,0,1584912
galEp3,0.2,4,4,AATACGGAAAATCGTTACCG,0,1557871
galEp3,0.2,4,4,AATAACCCAAACTGTGGGAT,0,1591258
galEp3,0.2,4,4,AAGTTGGAACGCGCCCAGGA,0,1548579
galEp3,0.2,4,4,AAGTCTCGAGTATTTTGATC,0,1556728
galEp3,0.2,4,4,AAGTATCGACATGTGCCAAG,0,1592848
galEp3,0.2,4,4,AAGGTGTGACTGTTCACAAA,0,1558646
galEp3,0.2,4,4,AAGGCATAACTTGTATCAAT,0,1581676
galEp3,0.2,4,4,AAGCTCGGTAATCACTAGCT,0,1574524
galEp3,0.2,4,4,AAGCTATGGAACTACTTTCC,0,1581507
galEp3,0.2,4,4,AAGCGTGTTTCTATCGCTAG,0,1592695
galEp3,0.2,4,4,AAGCCAGAGCTAGTGACAGG,0,1569807
galEp3,0.2,4,4,AAGCAAATAGATTACAGCGT,0,1550363
galEp3,0.2,4,4,AAGATCTAACTTACATTAAA,0,1589382
galEp3,0.2,4,4,AAGACTAAATCTTCTTCTTG,0,1563793
galEp3,0.2,4,4,AAGACGGATAGATGAAAGGA,0,1561313
galEp3,0.2,4,4,AAGACATACAACTTACCGGA,0,1592961
galEp3,0.2,4,4,AAGAATTCAAGGGTAAACGA,0,1592328
galEp3,0.2,4,4,AACTTGGGACGAAGAAGGGG,0,1559519
galEp3,0.2,4,4,AACTTCTCCGGTGCATGTAC,0,1586385
galEp3,0.2,4,4,AACTCGTGGTCTGTAACAGT,0,1584284
galEp3,0.2,4,4,AACTCCTATGTCACGTGCAT,0,1573910
galEp3,0.2,4,4,AACTACGTATCAAGCACGAT,0,1557320
galEp3,0.2,4,4,AACGGTTATGCACTTTTCAT,0,1565063
galEp3,0.2,4,4,AACGGCTAAATGCTTCACAT,0,1568298
galEp3,0.2,4,4,AACGCCAACAGTGTCGTCTG,0,1547578
galEp3,0.2,4,4,AACGCAAACGTTTATTTAGC,0,1552808
galEp3,0.2,4,4,AACCGGCCCCTTTTGCGTAG,0,1583818
galEp3,0.2,4,4,AACCCTTTATACGATTAAGT,0,1581689
galEp3,0.2,4,4,AACCCTGTCCCGCCGCGCGC,0,1554814
galEp3,0.2,4,4,AACCCTAACACTTGCAACTT,0,1590586
galEp3,0.2,4,4,AACCAATGGTTAATCACCTC,0,1563306
galEp3,0.2,4,4,AACATTTTGGACGGATGTAA,0,1555831
galEp3,0.2,4,4,AACATGGTAAGCCCATGCCA,0,1563355
galEp3,0.2,4,4,AACAAGATGGGTCCTTGCGA,0,1550383
galEp3,0.2,4,4,AAATGAAGCTCCGTTATGTA,0,1547519
galEp3,0.2,4,4,AAAGTTGTTATTCTAGACAG,0,1565995
galEp3,0.2,4,4,AAAGTTAGACTAGCGCCGGA,0,1569718
galEp3,0.2,4,4,AAAGTCCGTGCAAGGCGGGA,0,1557484
galEp3,0.2,4,4,AAAGCAGCGAGCCGCACCAT,0,1568525
galEp3,0.2,4,4,AAAGATAGAAGTTTCAATAG,0,1591872
galEp3,0.2,4,4,AAAGAGTGAATCGAGGAAGT,0,1573555
galEp3,0.2,4,4,AAAGAGCGATACTTGGGCTA,0,1560027
galEp3,0.2,4,4,AAAGAATATCTTTGGTGCGC,0,1573757
galEp3,0.2,4,4,AAACGAACGCTCACCTGTAA,0,1587639
galEp3,0.2,4,4,AAACCATGGAAATGCATATA,0,1557577
galEp3,0.2,4,4,AAACAGCCGTTCGCGGGGGT,0,1574350
galEp3,0.2,4,4,AAACAGAGGGTACTACGTGC,0,1594866
galEp3,0.2,4,4,AAAATGTGAAGACTTAGGGT,0,1575269
galEp3,0.2,4,4,AAAAGTTTACGATTGAAGTG,0,1561658
galEp3,0.2,4,4,AAAAGGCGGTTTATGCTTCC,0,1572090
galEp3,0.2,4,4,AAAACGCTCCTAAGTCAGAG,0,1548768
galEp3,0.2,4,4,AAAACAAAGGCAGATTCAGG,0,1572238
galEp3,0.2,4,4,AAAAATGTCCAATAGCGTCC,0,1589366
galEp3,0.2,4,4,AAAAACATAAACGGCACTAG,0,1588589
galEp3,0.25,3,3,TTTTTGCGTGGATTAGGCAG,0,1581518
galEp3,0.25,3,3,TTTTTGCCGGAGTCTGAGCC,0,1570751
galEp3,0.25,3,3,TTTTCCCCTCGTGTACTGTA,0,1577734
galEp3,0.25,3,3,TTTTATAATGCCTGTGACCA,0,1583258
galEp3,0.25,3,3,TTTTACGAGCGGGGCGGATA,0,1587747
galEp3,0.25,3,3,TTTTAATCTCCAGTATGGAC,0,1594135
galEp3,0.25,3,3,TTTTAAGAATACTGTGGCAA,0,1571278
galEp3,0.25,3,3,TTTGTTTGTTGACGGCTATT,0,1571523
galEp3,0.25,3,3,TTTGGTTAAAATCTCAAACC,0,1592483
galEp3,0.25,3,3,TTTGCGTTTGTCAGCGTAGC,0,1576997
galEp3,0.25,3,3,TTTCGTGGCCCTGGTGGGAA,0,1578027
galEp3,0.25,3,3,TTTCGTATTCGTTCCAGAAG,0,1582366
galEp3,0.25,3,3,TTTCGGCGTGGTTCTCTAGA,0,1577177
galEp3,0.25,3,3,TTTCAGAAGGATGCTCTTCA,0,1594038
galEp3,0.25,3,3,TTTCACTTCAGCGTAGCGGG,0,1590116
galEp3,0.25,3,3,TTTACTTATTGCCTAAGAAA,0,1583911
galEp3,0.25,3,3,TTTACGTGCTGTCGTGCTGA,0,1551004
galEp3,0.25,3,3,TTTACCCGGTTCCGATTTCG,0,1556963
galEp3,0.25,3,3,TTGTTAAGCTAGCTGGTGCT,0,1584161
galEp3,0.25,3,3,TTGTGAGCCTCACACTTTCA,0,1589567
galEp3,0.25,3,3,TTGTGAAAGGGGACAGCGAG,0,1560881
galEp3,0.25,3,3,TTGTCACTGGTGCTGTGTTC,0,1547305
galEp3,0.25,3,3,TTGGGGGGGATTTCGTCTAA,0,1592179
galEp3,0.25,3,3,TTGGGAATGAGCAAGGAATG,0,1569774
galEp3,0.25,3,3,TTGGATATTATGTCCGGCTT,0,1584610
galEp3,0.25,3,3,TTGCTCCATCGAGCAGATTA,0,1573607
galEp3,0.25,3,3,TTGCATACACGGAGCATTGT,0,1593306
galEp3,0.25,3,3,TTGATTGTCACCCATAGTTG,0,1570953
galEp3,0.25,3,3,TTGAGTAATAACTGTCCGAC,0,1557574
galEp3,0.25,3,3,TTGAGCTATCATTTAATATG,0,1577080
galEp3,0.25,3,3,TTGAGATATCGGGCGAAGTA,0,1575191
galEp3,0.25,3,3,TTGACAGCATGGCCGAAAAG,0,1556337
galEp3,0.25,3,3,TTCTTCGAAGGTGAGGGCCA,0,1586132
galEp3,0.25,3,3,TTCTTATCTTCTCCACGTTT,0,1559514
galEp3,0.25,3,3,TTCTGGAGCAACCACTCTCA,0,1574102
galEp3,0.25,3,3,TTCTGGAACACTCTTATGCG,0,1580257
galEp3,0.25,3,3,TTCTACATTTCCTGGGACCC,0,1565144
galEp3,0.25,3,3,TTCGGCATCTGGGCTCAAAC,0,1567279
galEp3,0.25,3,3,TTCGCTTACCTAGTGCTAAG,0,1548739
galEp3,0.25,3,3,TTCGCCTGGGATATGTATCT,0,1584812
galEp3,0.25,3,3,TTCGATTTAAACTATAGTGC,0,1573639
galEp3,0.25,3,3,TTCCTAGGTAAAGCGTGGTG,0,1567127
galEp3,0.25,3,3,TTCCCTATAATGTTAGTAGA,0,1571846
galEp3,0.25,3,3,TTCCAGATGGGGTCCTATCT,0,1567908
galEp3,0.25,3,3,TTCCACTATAGAGTACAAGA,0,1568983
galEp3,0.25,3,3,TTCCAACTCACCATGGGACG,0,1573278
galEp3,0.25,3,3,TTCATTGACGCACTCTTAGA,0,1582174
galEp3,0.25,3,3,TTCATGAGAGGGTGATAGTT,0,1567330
galEp3,0.25,3,3,TTCAGTCGGTCTCTCGGTTG,0,1568613
galEp3,0.25,3,3,TTCACCGGCGATCAGTCAAC,0,1550430
galEp3,0.25,3,3,TTCACCCGATGCTGTATCGC,0,1588839
galEp3,0.25,3,3,TTCACAAGGACCACCCGTCG,0,1580075
galEp3,0.25,3,3,TTCAATTTCAGGATAGGGGG,0,1579922
galEp3,0.25,3,3,TTATTTTCCGATAAATTCTT,0,1590517
galEp3,0.25,3,3,TTATGGCACCGTCGCGAATA,0,1571448
galEp3,0.25,3,3,TTATCTCACGGCATTCGTTG,0,1548921
galEp3,0.25,3,3,TTATATTCGCTCTTAAGTGC,0,1588367
galEp3,0.25,3,3,TTATAGTACGTTAGGGTAAG,0,1579263
galEp3,0.25,3,3,TTATAGATAAGGCGTCTTTC,0,1592932
galEp3,0.25,3,3,TTAGTGACGAGCTTTGCAGC,0,1589862
galEp3,0.25,3,3,TTAGCTGGGAATATCCGCAT,0,1587679
galEp3,0.25,3,3,TTAGCGGCTACCTAATACCC,0,1593468
galEp3,0.25,3,3,TTACTGGGGTTCTTTCAAGT,0,1571966
galEp3,0.25,3,3,TTACCCACCGGCCCACTTAA,0,1563013
galEp3,0.25,3,3,TTAATCTTCAGCAAGGTCTC,0,1562777
galEp3,0.25,3,3,TTAATACGGCTTAATTGGTA,0,1584894
galEp3,0.25,3,3,TTAAGTATCATGCCGCTAGG,0,1568845
galEp3,0.25,3,3,TTAAGCAGGTTCCCGGGAGA,0,1565308
galEp3,0.25,3,3,TTAAACAATCGCGTCGCTCC,0,1588326
galEp3,0.25,3,3,TGTTTAGTATCCTGGCGGAT,0,1556889
galEp3,0.25,3,3,TGTTGTATAATAAGCGGCAA,0,1547038
galEp3,0.25,3,3,TGTGTGTGCCACCACGTCAT,0,1550418
galEp3,0.25,3,3,TGTGTACTTATAAATTTCCA,0,1550705
galEp3,0.25,3,3,TGTGGTAGAGGGATCCGTAC,0,1573577
galEp3,0.25,3,3,TGTGGCCATGCGGCTGGGGG,0,1549945
galEp3,0.25,3,3,TGTGGACGGCGATAGGCTTT,0,1586055
galEp3,0.25,3,3,TGTGGAAAGTTCTAAGGATA,0,1558874
galEp3,0.25,3,3,TGTGCTTGCTTTCGTTGAGG,0,1582570
galEp3,0.25,3,3,TGTGCAAGAGGATCTCGACG,0,1584268
galEp3,0.25,3,3,TGTGATCGAGTTTTCAACGA,0,1559239
galEp3,0.25,3,3,TGTGATATCTGGCTGTCGTA,0,1587689
galEp3,0.25,3,3,TGTCTCCTTTGAAGTGAGAG,0,1548386
galEp3,0.25,3,3,TGTCCGCGAAACAATAAGAT,0,1575409
galEp3,0.25,3,3,TGTATAACTCGAGGCTTACA,0,1568410
galEp3,0.25,3,3,TGTATAAATACCGGTCTATA,0,1554651
galEp3,0.25,3,3,TGTAGTTTTGTGCCTTCAAG,0,1559424
galEp3,0.25,3,3,TGTAGAACCGCGTCTAATTC,0,1558708
galEp3,0.25,3,3,TGTACAAATGTTAGAAGATT,0,1567508
galEp3,0.25,3,3,TGTAACAAGCTTTTGCTTGC,0,1583061
galEp3,0.25,3,3,TGTAAACCGACGTCAATAGG,0,1578631
galEp3,0.25,3,3,TGGTAGTGGAGTACTTTTAG,0,1558532
galEp3,0.25,3,3,TGGTAGACACATCGTCCATC,0,1560236
galEp3,0.25,3,3,TGGGGTCGCAACTTCACGCC,0,1553632
galEp3,0.25,3,3,TGGGGATTCCGTGATAAGAG,0,1558641
galEp3,0.25,3,3,TGGGAGAGTTTTGTAGGAAT,0,1581210
galEp3,0.25,3,3,TGGGACTGTTATTGGTGTAA,0,1557034
galEp3,0.25,3,3,TGGGACGGTCGTCTTTTCGA,0,1577662
galEp3,0.25,3,3,TGGCTTAGTAGCCACGAGTA,0,1584711
galEp3,0.25,3,3,TGGCTGTATGGCCCGATGAT,0,1552461
galEp3,0.25,3,3,TGGCTCGCCCATACGGTGAT,0,1582432
galEp3,0.25,3,3,TGGCCTCAATGCCTTGTTAA,0,1585676
galEp3,0.25,3,3,TGGCCAACTTGCATGTTGGT,0,1589489
galEp3,0.25,3,3,TGGATTGCCCCTAACACCAG,0,1567350
galEp3,0.25,3,3,TGGATGAGGACTGAATAGGG,0,1568654
galEp3,0.25,3,3,TGGATCGTCTAAGCAGCGAG,0,1589466
galEp3,0.25,3,3,TGGATCGGGAGTAACATCAC,0,1547672
galEp3,0.25,3,3,TGGATCCACAGGAGTGCTAA,0,1584053
galEp3,0.25,3,3,TGGAGGTCGTCTACTTCAGT,0,1587966
galEp3,0.25,3,3,TGGAGCTCACGCAAATTTAG,0,1568855
galEp3,0.25,3,3,TGGAGATCCTTGATAGCGCA,0,1583184
galEp3,0.25,3,3,TGGACTTAGTTGCGGCTTCG,0,1561509
galEp3,0.25,3,3,TGGACAAATAATTTGCACCG,0,1581738
galEp3,0.25,3,3,TGGAATAAATTAGGGGTGCC,0,1566469
galEp3,0.25,3,3,TGGAAGTCGAACTGATGAAA,0,1585841
galEp3,0.25,3,3,TGCTTGGAACGCCAGCCTCG,0,1565607
galEp3,0.25,3,3,TGCTGTAAATATAAGGTTTA,0,1560073
galEp3,0.25,3,3,TGCTCTGGGCGGGGGACAGC,0,1549633
galEp3,0.25,3,3,TGCTATCAGTGATGTTTTAT,0,1558851
galEp3,0.25,3,3,TGCGTCAAACCTAAGAGTAC,0,1563752
galEp3,0.25,3,3,TGCGGTGGTCCGTGCGTTCT,0,1572898
galEp3,0.25,3,3,TGCGGGTTTCTAAATATGAC,0,1569261
galEp3,0.25,3,3,TGCGCTCGGAAGACATGGTC,0,1587884
galEp3,0.25,3,3,TGCGCAACCATAGGTTACGG,0,1593673
galEp3,0.25,3,3,TGCGAGCTTCCTCGTACTCC,0,1564053
galEp3,0.25,3,3,TGCCTATTCGTCCAGCCAGC,0,1564502
galEp3,0.25,3,3,TGCCTAGTGGAAAAACCCAT,0,1548627
galEp3,0.25,3,3,TGCCGTGAGAAAAATCAGTA,0,1576415
galEp3,0.25,3,3,TGCCGACGTTATCGGAATCT,0,1589793
galEp3,0.25,3,3,TGCCCTTACACAGTAAACAA,0,1577320
galEp3,0.25,3,3,TGCCCACAGCCGTGCTCGAC,0,1584273
galEp3,0.25,3,3,TGCCAGGGAGACAAACCAGT,0,1554881
galEp3,0.25,3,3,TGCATTTGGGTTGGTGGTCA,0,1556431
galEp3,0.25,3,3,TGCATACGTGCAATTCCGGT,0,1579554
galEp3,0.25,3,3,TGCAGGCGCACCAGCGCTGT,0,1585564
galEp3,0.25,3,3,TGCAGCTCATATGTTACGCC,0,1551191
galEp3,0.25,3,3,TGCACCAGTGCAGAATCGTC,0,1551911
galEp3,0.25,3,3,TGATTGCTCTTCAGGAAAAC,0,1591904
galEp3,0.25,3,3,TGATGTTCCGGCGTTCTATG,0,1579314
galEp3,0.25,3,3,TGATGTGATAGCACATCCTA,0,1571454
galEp3,0.25,3,3,TGATGCCAGTTGACCCCACC,0,1549047
galEp3,0.25,3,3,TGATCTGAGGGACAAAGGTG,0,1565846
galEp3,0.25,3,3,TGATCTCAGCCGCCTTGGAC,0,1564978
galEp3,0.25,3,3,TGATCAGGCTGCGCTCACCC,0,1593285
galEp3,0.25,3,3,TGAGCCCTCGCTTTCCACGT,0,1580117
galEp3,0.25,3,3,TGACTTCGTAAAAGGGTCGC,0,1567829
galEp3,0.25,3,3,TGACGGTAAAAAAAGAACAT,0,1580979
galEp3,0.25,3,3,TGACGGCGCCGGGTGAACGG,0,1570151
galEp3,0.25,3,3,TGACCCCGTATCCAACTCAA,0,1562282
galEp3,0.25,3,3,TGAATGGGTATATATCCGAG,0,1569210
galEp3,0.25,3,3,TGAAATCCAAGTTGATGGTC,0,1585920
galEp3,0.25,3,3,TGAAACGCTATATGACACAA,0,1582805
galEp3,0.25,3,3,TGAAAAACGATGCGTATTCT,0,1578845
galEp3,0.25,3,3,TCTTTACCCAAATTACGTCA,0,1556496
galEp3,0.25,3,3,TCTTGCGCGGACAGTCCGCA,0,1585800
galEp3,0.25,3,3,TCTTCGAATCGTCTAGCTGG,0,1593698
galEp3,0.25,3,3,TCTGTCGTACTAAGGGCTAA,0,1592642
galEp3,0.25,3,3,TCTGTAGAGGAGAACGTAGT,0,1581204
galEp3,0.25,3,3,TCTGTACCTGTCTTGGGTAT,0,1554537
galEp3,0.25,3,3,TCTGTACCAGCATGCCGCTG,0,1586253
galEp3,0.25,3,3,TCTGGAATCGTGATCCTAAC,0,1547190
galEp3,0.25,3,3,TCTGATATACTACCACTCAT,0,1590974
galEp3,0.25,3,3,TCTCGCAGAAAGACATTATA,0,1556372
galEp3,0.25,3,3,TCTCGAAACGGTTTATCGTC,0,1591047
galEp3,0.25,3,3,TCTCCCGTCAAGTTAGGTTC,0,1559175
galEp3,0.25,3,3,TCTCATATACCAGACAGAGA,0,1554425
galEp3,0.25,3,3,TCTACTACATATGCCATACC,0,1553197
galEp3,0.25,3,3,TCTACAGGGCCTTGTGGTCA,0,1564506
galEp3,0.25,3,3,TCTACACTAGGCAAGTACAA,0,1571447
galEp3,0.25,3,3,TCTAAAGGGTGCCGTATAAA,0,1589640
galEp3,0.25,3,3,TCGTTTTCACTCGAAGATGG,0,1565755
galEp3,0.25,3,3,TCGTTCCGAGTGCACTCAAA,0,1587584
galEp3,0.25,3,3,TCGTTAGTTGCGATTGGATA,0,1570431
galEp3,0.25,3,3,TCGTGTACCCTCTTGACTCA,0,1561646
galEp3,0.25,3,3,TCGTCGGTATATAGATTGGT,0,1566259
galEp3,0.25,3,3,TCGTCATGGGAGTTATCTAA,0,1546934
galEp3,0.25,3,3,TCGTATTTCCAATATTGTTG,0,1555387
galEp3,0.25,3,3,TCGGTCTATGTTGCCGACAG,0,1585471
galEp3,0.25,3,3,TCGGTCCGCGGCAGTTTGAT,0,1547107
galEp3,0.25,3,3,TCGGGATTATGCGGTTTGAC,0,1555276
galEp3,0.25,3,3,TCGGCCTGCACACCCACGGC,0,1586676
galEp3,0.25,3,3,TCGGCAGATAATGGGGGTTT,0,1575870
galEp3,0.25,3,3,TCGGAGCCATGACATGAGTC,0,1590061
galEp3,0.25,3,3,TCGGAACGGGGATATTGCTC,0,1576471
galEp3,0.25,3,3,TCGCGTGGCAGGATCCGGGT,0,1594104
galEp3,0.25,3,3,TCGCGGTTAAACGGACACGG,0,1588971
galEp3,0.25,3,3,TCGCGGGTTAGATCACTGAT,0,1569753
galEp3,0.25,3,3,TCGCCACTCCGGATGCTGCG,0,1559946
galEp3,0.25,3,3,TCGCATCCTATCGGTCCCAA,0,1565716
galEp3,0.25,3,3,TCGACATGAATGCGACCATT,0,1550057
galEp3,0.25,3,3,TCGAATCTCTGATACTCATA,0,1562020
galEp3,0.25,3,3,TCCTGCGATTGACGGTGCTC,0,1574705
galEp3,0.25,3,3,TCCTCGGATCAAAGTAATTG,0,1589385
galEp3,0.25,3,3,TCCGTGCCGGACCAACGCAT,0,1573352
galEp3,0.25,3,3,TCCGTGAACGTTCGGTTCGT,0,1591668
galEp3,0.25,3,3,TCCGTATCGAAATGTGAGGC,0,1582403
galEp3,0.25,3,3,TCCGGGCTCGGTATCTACCG,0,1587027
galEp3,0.25,3,3,TCCGGGCGTTACAGTTATGT,0,1590250
galEp3,0.25,3,3,TCCGGCGAGATTGGCGTAAG,0,1583683
galEp3,0.25,3,3,TCCGCAGAGAGCTGGTCCAT,0,1547642
galEp3,0.25,3,3,TCCGATCGTCGGTCAGGTTA,0,1593030
galEp3,0.25,3,3,TCCGAAAACACAAACTCTTG,0,1591543
galEp3,0.25,3,3,TCCCTTCCAATCAAGTGTTT,0,1560281
galEp3,0.25,3,3,TCCCTCCTACCCAACCCCGT,0,1556257
galEp3,0.25,3,3,TCCCATGACGTAAACCATTT,0,1571885
galEp3,0.25,3,3,TCCCATATGTAGTTAGGGCA,0,1583513
galEp3,0.25,3,3,TCCCACTTTTCAAGACCGGA,0,1592198
galEp3,0.25,3,3,TCCATCTTTCCAGGGTCTTG,0,1592482
galEp3,0.25,3,3,TCCATCGTCATATAGGGGAG,0,1594924
galEp3,0.25,3,3,TCCATATCGCTATAAATCGC,0,1579958
galEp3,0.25,3,3,TCCATAGTCGAGGGTATTGG,0,1570262
galEp3,0.25,3,3,TCCAATAGTTGGCGCGTGTT,0,1573826
galEp3,0.25,3,3,TCCAAGAGGAGCGTGCTGAC,0,1592860
galEp3,0.25,3,3,TCATTATCAGGGCAGCTTAT,0,1575693
galEp3,0.25,3,3,TCATCCGTTATACCCTGCGG,0,1570420
galEp3,0.25,3,3,TCATAAGTCTCTGCCCGTAA,0,1586570
galEp3,0.25,3,3,TCAGTCGGCGTAGCAATGTA,0,1574883
galEp3,0.25,3,3,TCAGTCGCCTCGCTCTGTTC,0,1569687
galEp3,0.25,3,3,TCAGGGCAGGGTCTACAATT,0,1570253
galEp3,0.25,3,3,TCAGATAAGGGCATATTCAT,0,1570428
galEp3,0.25,3,3,TCACTGATTCAGATCATTAA,0,1558564
galEp3,0.25,3,3,TCACTCGTGTAGTGTATCCG,0,1591203
galEp3,0.25,3,3,TCACTATCGTCACACTGCTA,0,1579526
galEp3,0.25,3,3,TCACTACCAGGCTGTAGCCC,0,1553652
galEp3,0.25,3,3,TCACGGACACTCAGGACCAT,0,1558890
galEp3,0.25,3,3,TCACCCCCCTCGATGCACTT,0,1551735
galEp3,0.25,3,3,TCAATGGGAGTAGCCATTAA,0,1576522
galEp3,0.25,3,3,TCAATGCCCTGGAAGTGCAA,0,1563933
galEp3,0.25,3,3,TCAAGATAAGTAAGGTCTTA,0,1564020
galEp3,0.25,3,3,TCAAGACCGTTGTATGTTAC,0,1553316
galEp3,0.25,3,3,TCAACTGAGGGGTAACATTT,0,1591506
galEp3,0.25,3,3,TCAAAGCGGCTAAGCCATCC,0,1561537
galEp3,0.25,3,3,TCAAACGCGTGTTATTGACG,0,1574755
galEp3,0.25,3,3,TATTTTGTTCCGATAGAATT,0,1586536
galEp3,0.25,3,3,TATTTCGAGTAGGCATTATG,0,1563402
galEp3,0.25,3,3,TATTGTAGTCGATCAAATGA,0,1578465
galEp3,0.25,3,3,TATTCGACACTCATCCAGAG,0,1562411
galEp3,0.25,3,3,TATTCATCGGCCCCGGACGA,0,1579665
galEp3,0.25,3,3,TATTATGAGCTATCAGCGTG,0,1594714
galEp3,0.25,3,3,TATTAGAAGGACGCAGGGTC,0,1546685
galEp3,0.25,3,3,TATGCTGAGACGTTCGTTGA,0,1550394
galEp3,0.25,3,3,TATGACCATAGATGCGTCTT,0,1561623
galEp3,0.25,3,3,TATCACTCCATTCAGGGGTG,0,1580397
galEp3,0.25,3,3,TATCAAGAAGCATATGGATA,0,1588861
galEp3,0.25,3,3,TATATCATGTATTTCTTCGT,0,1549431
galEp3,0.25,3,3,TATAGGCTACTACATGCGTA,0,1575717
galEp3,0.25,3,3,TATAGGACCTCTGATGTTTC,0,1592854
galEp3,0.25,3,3,TATAGCGCTCGTTGTCGGGT,0,1557916
galEp3,0.25,3,3,TATACGTTCACTTGCCAAAT,0,1594884
galEp3,0.25,3,3,TATACGAGTTTCAGATAGCT,0,1548132
galEp3,0.25,3,3,TAGTGTGTTAGGTGAAGCTG,0,1591825
galEp3,0.25,3,3,TAGGTTACGCAACTTGCTAT,0,1568698
galEp3,0.25,3,3,TAGGTTAATATCACGGCCGC,0,1589902
galEp3,0.25,3,3,TAGGTCGCAGCTCGGATAGC,0,1566241
galEp3,0.25,3,3,TAGGGTCAATGGCTCGTCGT,0,1561619
galEp3,0.25,3,3,TAGGGTAAAACGGGAGTACG,0,1548920
galEp3,0.25,3,3,TAGGGGGGTAAATTGGCTAA,0,1590636
galEp3,0.25,3,3,TAGGAAAGAGCTTATGATGT,0,1578540
galEp3,0.25,3,3,TAGCGTGACAAGATGCCTTC,0,1588795
galEp3,0.25,3,3,TAGCCATAGCGATTGCAAAT,0,1591109
galEp3,0.25,3,3,TAGAGGTGTATATCTCGCTA,0,1563475
galEp3,0.25,3,3,TAGAGGGACTACTCGTTACC,0,1565314
galEp3,0.25,3,3,TAGAGCTGATCGGTACGCTA,0,1557867
galEp3,0.25,3,3,TAGACGGCATAGCAAAGTCA,0,1573337
galEp3,0.25,3,3,TACTTCGGCCACGTCGTCAC,0,1547719
galEp3,0.25,3,3,TACTCCGTAGCTTGGCTAAA,0,1547362
galEp3,0.25,3,3,TACTCACCAACACTATTTCC,0,1588900
galEp3,0.25,3,3,TACTATAGCACAATCGGCAT,0,1592183
galEp3,0.25,3,3,TACGTCGTCATCTTTCATAC,0,1551753
galEp3,0.25,3,3,TACGGTGGCGTAGTACCAAC,0,1572211
galEp3,0.25,3,3,TACGGCTTCTTGTATTAGTA,0,1576220
galEp3,0.25,3,3,TACGCTTTGTCGTGGTGTTG,0,1583707
galEp3,0.25,3,3,TACGCTCGCTGGTCTGGTGC,0,1582610
galEp3,0.25,3,3,TACGCCTCTCACTGAGGAGC,0,1593933
galEp3,0.25,3,3,TACGCAGTTTTATACACATC,0,1562529
galEp3,0.25,3,3,TACCTTCCCTAGGGCAAGCT,0,1587574
galEp3,0.25,3,3,TACCTTCCCCCAGCGATACA,0,1562484
galEp3,0.25,3,3,TACCGTATGATATACCATCG,0,1551279
galEp3,0.25,3,3,TACCGGACAGCGAAGCGCTA,0,1566684
galEp3,0.25,3,3,TACAGTGGCGAGGACCCTCT,0,1556272
galEp3,0.25,3,3,TACACTTGGCAATCGGAATG,0,1575996
galEp3,0.25,3,3,TACACGAGTTGACATGCTCC,0,1564330
galEp3,0.25,3,3,TAATTCGGCCGTTTTGTGAT,0,1575133
galEp3,0.25,3,3,TAATGGCAGTAGTCGTGCTC,0,1564466
galEp3,0.25,3,3,TAATCTTGGTGGCACTCCGA,0,1570692
galEp3,0.25,3,3,TAATCCCAGCGGAAATGTTC,0,1558675
galEp3,0.25,3,3,TAATAGATAGGTTAACAACA,0,1576011
galEp3,0.25,3,3,TAAGTTAATGCCCCGTGTAA,0,1586079
galEp3,0.25,3,3,TAAGTGTACTTAGATCATGT,0,1560346
galEp3,0.25,3,3,TAAGTCTAGAAACTTAAAGA,0,1594760
galEp3,0.25,3,3,TAAGCGGTAGCCCCTTCGAC,0,1588833
galEp3,0.25,3,3,TAAGCACTGGCAGCCTCGTA,0,1594773
galEp3,0.25,3,3,TAAGCAAGCATACCAGCTCA,0,1551701
galEp3,0.25,3,3,TAAGATACTGCGGATGAGGG,0,1573857
galEp3,0.25,3,3,TAAGAAGTGAGTATTGCTTC,0,1555017
galEp3,0.25,3,3,TAAGAAAACTTAGACTGTAT,0,1564315
galEp3,0.25,3,3,TAACTGTTAAGTAACATTTA,0,1554871
galEp3,0.25,3,3,TAACTGTCCAAGGGGAGATC,0,1581799
galEp3,0.25,3,3,TAACTCTATTTAGCATGGAG,0,1554076
galEp3,0.25,3,3,TAACGTAGTCAAGCTGAGAT,0,1565549
galEp3,0.25,3,3,TAACCTAAGTTTTGGCCGTC,0,1572668
galEp3,0.25,3,3,TAACCGTCTTGACACCCTTT,0,1580942
galEp3,0.25,3,3,TAACCATTGACGAGCATGAA,0,1547413
galEp3,0.25,3,3,TAACCAGTAAGCAATGATTT,0,1564741
galEp3,0.25,3,3,TAACAGTGATTGTTTGGGTT,0,1554417
galEp3,0.25,3,3,TAAAGCTTTAATGCCTAGGT,0,1577675
galEp3,0.25,3,3,TAAAGCCAGGTTCAAGAGCC,0,1560521
galEp3,0.25,3,3,TAAACCAAACCGGTGAGATC,0,1567637
galEp3,0.25,3,3,TAAAAAGTACGCTCGGATCA,0,1569855
galEp3,0.25,3,3,TAAAAACTACTGTACCGGGT,0,1593395
galEp3,0.25,3,3,GTTTTTGACGATTATACCCA,0,1583242
galEp3,0.25,3,3,GTTTTTAAGCAGCTCTCGGC,0,1548774
galEp3,0.25,3,3,GTTTTGGGACGTGCTTCTCA,0,1564754
galEp3,0.25,3,3,GTTTGGTACAGTTTTTCTAC,0,1566497
galEp3,0.25,3,3,GTTTGGAATAGGCGCTCGCC,0,1577813
galEp3,0.25,3,3,GTTTCGTTGGCTTGATTCGT,0,1548743
galEp3,0.25,3,3,GTTTCCGACTAGGAATGGGG,0,1566681
galEp3,0.25,3,3,GTTTACTCTTCGCGGCCCGT,0,1576287
galEp3,0.25,3,3,GTTTACTCACGAAGTTATCT,0,1572655
galEp3,0.25,3,3,GTTGTATAGTCCCACTAGAA,0,1575809
galEp3,0.25,3,3,GTTGTAAATTTCCCCTGGGA,0,1565719
galEp3,0.25,3,3,GTTGCTTTAGGTGTGGGAGT,0,1563820
galEp3,0.25,3,3,GTTGATATCTCTCGTCACGT,0,1577867
galEp3,0.25,3,3,GTTCTGTAAAGATCGTACGG,0,1590841
galEp3,0.25,3,3,GTTCTGCTATGGCATGGCTA,0,1590600
galEp3,0.25,3,3,GTTCGTTGCTGATGGCTCAG,0,1550068
galEp3,0.25,3,3,GTTCGTGCATGGGTGTATTC,0,1589722
galEp3,0.25,3,3,GTTCATGGTGCCGTAATCAT,0,1578231
galEp3,0.25,3,3,GTTCAAGATAACGGGTTGAA,0,1558615
galEp3,0.25,3,3,GTTATATTTACACACACGCC,0,1553766
galEp3,0.25,3,3,GTTAGTGTTCATGTTTCGGA,0,1551228
galEp3,0.25,3,3,GTTAGAGTGGGTGATGGTTC,0,1560401
galEp3,0.25,3,3,GTTAGAGACATACAGGGTAT,0,1593421
galEp3,0.25,3,3,GTTACGGTTTGAAATCGATC,0,1555728
galEp3,0.25,3,3,GTTACCGTCCCCTGGCAGAT,0,1550168
galEp3,0.25,3,3,GTTACAAAAGACTTATGACT,0,1563772
galEp3,0.25,3,3,GTGTTGACGCTCAGGCTCAC,0,1568094
galEp3,0.25,3,3,GTGTTATTAATATAATTCGC,0,1586307
galEp3,0.25,3,3,GTGTGGACGCGCGCGGTCTA,0,1548430
galEp3,0.25,3,3,GTGTGCGCGCGGCCCAGGCA,0,1571446
galEp3,0.25,3,3,GTGTGCCAGACTGCATATAC,0,1561981
galEp3,0.25,3,3,GTGTCCCGCCGGGGAACGGC,0,1561324
galEp3,0.25,3,3,GTGTATGGGGCGGCTTACCA,0,1572505
galEp3,0.25,3,3,GTGTAGGTGCAGGGGTCTGG,0,1585522
galEp3,0.25,3,3,GTGGTCAGTGGCACTCTCAA,0,1553321
galEp3,0.25,3,3,GTGGCACGAAAGTTCAGTTA,0,1579687
galEp3,0.25,3,3,GTGGATCGACAACCATGGCG,0,1590445
galEp3,0.25,3,3,GTGCTGCAGACAGCTGCTCA,0,1579763
galEp3,0.25,3,3,GTGCGGGTCATTGAGATAGC,0,1594440
galEp3,0.25,3,3,GTGCAGGCTCCGCAAGAGGG,0,1562002
galEp3,0.25,3,3,GTGCAGCCTTTATGACAGAG,0,1586380
galEp3,0.25,3,3,GTGAGGGGTTGAGCTGGAAT,0,1550733
galEp3,0.25,3,3,GTGAGGGGTCCCCTCACCCT,0,1568473
galEp3,0.25,3,3,GTGACGGCACGGTATCCGCG,0,1551582
galEp3,0.25,3,3,GTCTTGGATTCATTATTTCC,0,1583981
galEp3,0.25,3,3,GTCTTCACTACAGAATTCTG,0,1582806
galEp3,0.25,3,3,GTCTGGGTCGAAAGGGCGCG,0,1550428
galEp3,0.25,3,3,GTCGTTACGGGGGATTGATG,0,1579852
galEp3,0.25,3,3,GTCGTCGAGGGATGGTAGAG,0,1560096
galEp3,0.25,3,3,GTCGTATTTGTTGCGGAATG,0,1567911
galEp3,0.25,3,3,GTCGGGCCATGGTACAATAG,0,1565577
galEp3,0.25,3,3,GTCCGTCGTGGTAATAACGG,0,1574418
galEp3,0.25,3,3,GTCCGCCACAATTAGTGAGC,0,1546732
galEp3,0.25,3,3,GTCCCCTAGGTTGTTCCGCT,0,1561292
galEp3,0.25,3,3,GTCCCAATAAAATGTACTAG,0,1549647
galEp3,0.25,3,3,GTCCACCAATAAATAGCCCC,0,1571883
galEp3,0.25,3,3,GTCATGTATCTGTTTGGGCT,0,1582392
galEp3,0.25,3,3,GTCACTACGTCATACTCTCC,0,1587063
galEp3,0.25,3,3,GTCACATATAATACACAAGG,0,1574552
galEp3,0.25,3,3,GTCAAAGATGTATATCGATA,0,1550505
galEp3,0.25,3,3,GTATTAGCTGATGCGCTTTA,0,1576607
galEp3,0.25,3,3,GTATGGCCTGCTCCGTCCGA,0,1568238
galEp3,0.25,3,3,GTATGCGTTGTCGGCCCGGG,0,1568022
galEp3,0.25,3,3,GTATCCATCGTTTGACTACC,0,1552436
galEp3,0.25,3,3,GTATCCATACCTCACCGTGT,0,1564055
galEp3,0.25,3,3,GTAGTTGATAAGGAGACTTT,0,1575939
galEp3,0.25,3,3,GTAGTTACCGTTGGTTAAAA,0,1584361
galEp3,0.25,3,3,GTAGGCCTGGCTCGCGTATA,0,1588638
galEp3,0.25,3,3,GTAGCGCGATGTAGTTACGT,0,1553417
galEp3,0.25,3,3,GTAGACGATGTCCCCAACTG,0,1547114
galEp3,0.25,3,3,GTACTGTCGAACCCCTCATG,0,1581949
galEp3,0.25,3,3,GTACGCCTTGTCCACCGAAC,0,1577753
galEp3,0.25,3,3,GTACGCACAATCGCTATTCA,0,1557268
galEp3,0.25,3,3,GTACGAGCCGTAAAAATCCA,0,1554749
galEp3,0.25,3,3,GTACATCGTAATACACATGT,0,1571929
galEp3,0.25,3,3,GTACACTCCCATCGTTAATA,0,1593627
galEp3,0.25,3,3,GTACAATACAGTCCATTCCT,0,1587184
galEp3,0.25,3,3,GTAATATCCACATGCGTCTA,0,1589116
galEp3,0.25,3,3,GGTTGATAATCGCCTTGGAT,0,1561780
galEp3,0.25,3,3,GGTTCTCCTGGGGATGAAGT,0,1551761
galEp3,0.25,3,3,GGTTCCAGGCGGGGCCAGTA,0,1585686
galEp3,0.25,3,3,GGTTACATTTTTTGTTTTGA,0,1549950
galEp3,0.25,3,3,GGTTAACTCTAGTAAGCGAT,0,1548821
galEp3,0.25,3,3,GGTGGGCAGCTAATACTACG,0,1549549
galEp3,0.25,3,3,GGTGGGAGGCTCATTAGTAG,0,1583369
galEp3,0.25,3,3,GGTGATGTCGGGGGACTAGA,0,1577721
galEp3,0.25,3,3,GGTCTTATTTACGACGCGGC,0,1570997
galEp3,0.25,3,3,GGTCTCTCGTAGTGTATCAA,0,1564417
galEp3,0.25,3,3,GGTCTCTCAGCAATCTGAGG,0,1563619
galEp3,0.25,3,3,GGTCTCAAGGCCAGGTAGAG,0,1550589
galEp3,0.25,3,3,GGTCGAGAGCATTCAGCGAA,0,1553629
galEp3,0.25,3,3,GGTCCTGCGTATCATACCTA,0,1547030
galEp3,0.25,3,3,GGTCACATAAGGACGTAATC,0,1565949
galEp3,0.25,3,3,GGTAGGCCGGGTGCCCCCAT,0,1587971
galEp3,0.25,3,3,GGTAGCTAGCAAAGTCATCC,0,1562591
galEp3,0.25,3,3,GGTAGCGCAAGTATGGGCTT,0,1593495
galEp3,0.25,3,3,GGTACTCCGTCTTACTTTCT,0,1585890
galEp3,0.25,3,3,GGTACCCGTGCGCGGGATGA,0,1551501
galEp3,0.25,3,3,GGTACAGTGTCGCTGAACGG,0,1586957
galEp3,0.25,3,3,GGTAATGCGAGGAACACACT,0,1582815
galEp3,0.25,3,3,GGTAAGGAGGTCCAAGGCCA,0,1570180
galEp3,0.25,3,3,GGTAACGACAGTTGGAAGCA,0,1579478
galEp3,0.25,3,3,GGTAACCGGTATATAATCAT,0,1586569
galEp3,0.25,3,3,GGTAACAGGAGGCATTGTAG,0,1580511
galEp3,0.25,3,3,GGTAAAAAGGCTTGAGGACA,0,1550954
galEp3,0.25,3,3,GGGTTGGCGGACCGTTCTGG,0,1550479
galEp3,0.25,3,3,GGGTCGCGTTAGCTTCGTAG,0,1562203
galEp3,0.25,3,3,GGGTACGGTGATAGACAGTA,0,1575105
galEp3,0.25,3,3,GGGGTGGCCGGCTTATCCTG,0,1592830
galEp3,0.25,3,3,GGGGTAAGACCGATTTGATC,0,1554602
galEp3,0.25,3,3,GGGGGCACGTGCATCCATAA,0,1578774
galEp3,0.25,3,3,GGGGCTGCACGGGGCGTTGA,0,1575529
galEp3,0.25,3,3,GGGGCCTGGTGGTTAATTGT,0,1548824
galEp3,0.25,3,3,GGGGCATGCCGCCACATACT,0,1578979
galEp3,0.25,3,3,GGGGAGGTGTTAGCTATCAG,0,1549687
galEp3,0.25,3,3,GGGGACCGTCCGGCAGGAGG,0,1587958
galEp3,0.25,3,3,GGGCTATGATCAGGAGGAGT,0,1591949
galEp3,0.25,3,3,GGGCGGTGTAACTAGTTAGT,0,1568299
galEp3,0.25,3,3,GGGCGGGTCCGGGACGTGAG,0,1565518
galEp3,0.25,3,3,GGGCCTTTGAATGGGGGAAA,0,1586842
galEp3,0.25,3,3,GGGCCGGTAGCAAAACGCTA,0,1589287
galEp3,0.25,3,3,GGGCCACGCCCACAGCCTAT,0,1582971
galEp3,0.25,3,3,GGGAGGTCGTATTACAGGTT,0,1554767
galEp3,0.25,3,3,GGGAGCCCGGGGACGGTACG,0,1573793
galEp3,0.25,3,3,GGGAAGCGAGTAAAAAGTAA,0,1572207
galEp3,0.25,3,3,GGGAACCGAACCCTGCTATT,0,1590243
galEp3,0.25,3,3,GGCTTGGTTGTCTCGGGCTG,0,1574244
galEp3,0.25,3,3,GGCTTAATAATTAGGCCAGG,0,1585451
galEp3,0.25,3,3,GGCTGCCAGATGAGCACCTA,0,1566902
galEp3,0.25,3,3,GGCTGAGACAGGATAGAATG,0,1546772
galEp3,0.25,3,3,GGCTCCGGTGACGTCGTAGA,0,1593410
galEp3,0.25,3,3,GGCTATACCCGCGAACCTTC,0,1549624
galEp3,0.25,3,3,GGCGTTGGATGTCCTTTTGT,0,1556729
galEp3,0.25,3,3,GGCGTTAAACTGCATATCGT,0,1546439
galEp3,0.25,3,3,GGCGGTCTGATCTAGACTCT,0,1583013
galEp3,0.25,3,3,GGCGCGTGCACGGCCCGAGC,0,1552938
galEp3,0.25,3,3,GGCGCCTATGTGAGAAATGA,0,1586504
galEp3,0.25,3,3,GGCCTCGTGCGCCCCGTTTT,0,1564856
galEp3,0.25,3,3,GGCCTCCTCCACCGGCCGAT,0,1555787
galEp3,0.25,3,3,GGCCCGTGCATTTATGCCGA,0,1559629
galEp3,0.25,3,3,GGCCCACTTAAGACATGGAC,0,1556259
galEp3,0.25,3,3,GGCCCAAACTCTCATCGTAG,0,1551126
galEp3,0.25,3,3,GGCCATATGTATACAGGTTT,0,1579091
galEp3,0.25,3,3,GGCCAGGCGAGCGTTATCAT,0,1572861
galEp3,0.25,3,3,GGCCAGCACGGACGCGGAAC,0,1585306
galEp3,0.25,3,3,GGCATAGAAGCCTAGACTAC,0,1566814
galEp3,0.25,3,3,GGCATAATGACTTCCGCCTT,0,1568208
galEp3,0.25,3,3,GGCAGTGACGTCCTCTGCTG,0,1580485
galEp3,0.25,3,3,GGCAGTATCCGGCCGCTTCT,0,1560751
galEp3,0.25,3,3,GGCAGGGTATTTACCCGAAG,0,1558203
galEp3,0.25,3,3,GGCAGGCTATAACGTATTAC,0,1567616
galEp3,0.25,3,3,GGCACGGTGTGTGCCCAGAG,0,1548436
galEp3,0.25,3,3,GGCACGGCATCTCACCGCTA,0,1560298
galEp3,0.25,3,3,GGCAAGCTGCCCTTGCAATG,0,1551107
galEp3,0.25,3,3,GGCAACGTCTTAAAAAAGAA,0,1550163
galEp3,0.25,3,3,GGATTTGATTGAGGCGTACA,0,1552536
galEp3,0.25,3,3,GGATTGGTGCTAGACCTTTT,0,1557900
galEp3,0.25,3,3,GGATCCTCGTTCCCATCAAA,0,1569386
galEp3,0.25,3,3,GGATAGTCGGAGTGGTAGTT,0,1546825
galEp3,0.25,3,3,GGAGTAATGGGGTTAATGAG,0,1552302
galEp3,0.25,3,3,GGAGATCACTCCTGAGACAA,0,1568049
galEp3,0.25,3,3,GGACGTAGGCAGGTAGGCGT,0,1573420
galEp3,0.25,3,3,GGACCCTGGACCTCTTAAGT,0,1547987
galEp3,0.25,3,3,GGACCCGAGGTATTGTTGTT,0,1568506
galEp3,0.25,3,3,GGACCAACGCGTGATATCAT,0,1593765
galEp3,0.25,3,3,GGAATATTGTCTACTGAAGC,0,1549685
galEp3,0.25,3,3,GGAAGTGCATAGGAACTGTT,0,1591346
galEp3,0.25,3,3,GGAAGACTCATCTTAACAAG,0,1560774
galEp3,0.25,3,3,GGAACCGTTACGTGGCCGGG,0,1574844
galEp3,0.25,3,3,GGAACATGACCTTTGTTGTA,0,1555705
galEp3,0.25,3,3,GGAAAGGCCAGCCTCAATGT,0,1561383
galEp3,0.25,3,3,GCTTTGGTAGTAGTTCCACG,0,1553976
galEp3,0.25,3,3,GCTTCTTTCGCAGTTAGCTA,0,1581424
galEp3,0.25,3,3,GCTTCCTGCGATTATCGCTC,0,1562826
galEp3,0.25,3,3,GCTTAGAAAGCCATGCCCTC,0,1550177
galEp3,0.25,3,3,GCTGTCAAGCAAGTGTGCAA,0,1571219
galEp3,0.25,3,3,GCTGTAGTTATACACCTTGA,0,1591819
galEp3,0.25,3,3,GCTGGGGACGCTGAGCACTC,0,1581671
galEp3,0.25,3,3,GCTGGGACAGCGGCACGTGA,0,1591817
galEp3,0.25,3,3,GCTGCCATGGTCTGGTTGCA,0,1576418
galEp3,0.25,3,3,GCTGCCACTCGCATACCTAT,0,1547545
galEp3,0.25,3,3,GCTGCATCAACACCGGGCTC,0,1592452
galEp3,0.25,3,3,GCTGCAAGAGTCGCCGTCGT,0,1591457
galEp3,0.25,3,3,GCTGAATGGGGTCGTGCGCT,0,1567710
galEp3,0.25,3,3,GCTCGGCGCGCTCAAGGCCG,0,1547449
galEp3,0.25,3,3,GCTCGACGCCTCCTACAGCT,0,1576416
galEp3,0.25,3,3,GCTCCTATAACCCTACTAGG,0,1582937
galEp3,0.25,3,3,GCTCAAGTTTACATATGACA,0,1593780
galEp3,0.25,3,3,GCTAGTAATAGCCAATGTAT,0,1590714
galEp3,0.25,3,3,GCTACCGGTTCTTTACTTCC,0,1577848
galEp3,0.25,3,3,GCGTCACGATAGGGCGAAGG,0,1589006
galEp3,0.25,3,3,GCGTAGTCATACTGTAGTAT,0,1573410
galEp3,0.25,3,3,GCGTAAAGGGTTTGTAGATT,0,1552223
galEp3,0.25,3,3,GCGGTGTCGAAACGATGTGG,0,1551823
galEp3,0.25,3,3,GCGGTCCACAGCAAAGAGAG,0,1587454
galEp3,0.25,3,3,GCGGCTCACGGAAATCTATT,0,1558553
galEp3,0.25,3,3,GCGGCGGGGGGAAAGCCTGG,0,1588887
galEp3,0.25,3,3,GCGGCATGCGACTCTGCCCC,0,1589969
galEp3,0.25,3,3,GCGCCTGAGCCGCGAAGCCT,0,1558611
galEp3,0.25,3,3,GCGATTTATGTAGACGCTAC,0,1559615
galEp3,0.25,3,3,GCGATCCGAAACCGGTCTAC,0,1550216
galEp3,0.25,3,3,GCGAGTTTCGTTCCACAACA,0,1591612
galEp3,0.25,3,3,GCGAGGATTTGAATCACCAT,0,1594381
galEp3,0.25,3,3,GCGACGCAGTTCCGAACGGA,0,1547976
galEp3,0.25,3,3,GCGACCCCTTCGAGTCTTAC,0,1558836
galEp3,0.25,3,3,GCGACAGGAGCGGTGTGTAA,0,1577975
galEp3,0.25,3,3,GCGAAGCCATTATCGTGTAA,0,1588725
galEp3,0.25,3,3,GCGAACATTGAAAGGTCAAC,0,1579361
galEp3,0.25,3,3,GCCTTCCACAGTGGACACAC,0,1588753
galEp3,0.25,3,3,GCCTGGGCGAGGATGTTAAG,0,1587292
galEp3,0.25,3,3,GCCTGCAAGAACAGGAGACC,0,1574409
galEp3,0.25,3,3,GCCTGATGGACATGGTCAGA,0,1569549
galEp3,0.25,3,3,GCCTGACGGGCCGATCAGAA,0,1551142
galEp3,0.25,3,3,GCCTAGTTACGATGCAAGCG,0,1573363
galEp3,0.25,3,3,GCCGGGGTAACGGTATCGAC,0,1573809
galEp3,0.25,3,3,GCCGGGGGGGGCGGTACGGT,0,1546724
galEp3,0.25,3,3,GCCGGCGTTTGAAGTGAATA,0,1567048
galEp3,0.25,3,3,GCCGGCCACTCTAGTTTTTT,0,1548134
galEp3,0.25,3,3,GCCGCGGCCGTACTCTGATT,0,1568344
galEp3,0.25,3,3,GCCGCGCTCAAACCTTTTTA,0,1559617
galEp3,0.25,3,3,GCCGCCCCGTCACGAGCCGT,0,1549964
galEp3,0.25,3,3,GCCGAATACGTGTTTAGTGC,0,1574541
galEp3,0.25,3,3,GCCCGCTACGTATGAAGGCT,0,1584830
galEp3,0.25,3,3,GCCCGAGATCGATAGTATAC,0,1587464
galEp3,0.25,3,3,GCCAGTCCATAGCGCCGTGC,0,1558175
galEp3,0.25,3,3,GCCACGGGCATAAGGGGATT,0,1579666
galEp3,0.25,3,3,GCATTTTGGACACGGGGCGT,0,1551181
galEp3,0.25,3,3,GCATTTCATTAGCCGAGAAG,0,1549881
galEp3,0.25,3,3,GCATTTCACGCTCAGATTCC,0,1579317
galEp3,0.25,3,3,GCATTGGCCCCGCTGGGACT,0,1573855
galEp3,0.25,3,3,GCATTCGGTAGACGGGACGG,0,1560466
galEp3,0.25,3,3,GCATGATTTACGGAAGTATA,0,1583840
galEp3,0.25,3,3,GCATCGCTTAGTTGCCCGGG,0,1546624
galEp3,0.25,3,3,GCATCACCGCGGGAAACGCA,0,1572413
galEp3,0.25,3,3,GCAGATTTAAAAATGACGAT,0,1560164
galEp3,0.25,3,3,GCACGGCACCCATAGACGTC,0,1547408
galEp3,0.25,3,3,GCACCGCGGGGCTCGTTGGC,0,1590036
galEp3,0.25,3,3,GCACAGTTGTGCTTCTGGTT,0,1569611
galEp3,0.25,3,3,GCACAACACTCCTACCGAGG,0,1586568
galEp3,0.25,3,3,GATTTCGCGCCAACTTTTTC,0,1591640
galEp3,0.25,3,3,GATTTAGCGACCTCGACGGC,0,1558623
galEp3,0.25,3,3,GATTTACGACGGGATAGCGT,0,1577380
galEp3,0.25,3,3,GATTGATAGCCTGTTTAGTC,0,1562745
galEp3,0.25,3,3,GATTGAAGACTCGGACCAAC,0,1566823
galEp3,0.25,3,3,GATTATGGTCCAAAGAGCGG,0,1562813
galEp3,0.25,3,3,GATTACGTTAAACGTATGCC,0,1571910
galEp3,0.25,3,3,GATTAAGCATGTCAATGATA,0,1549016
galEp3,0.25,3,3,GATGTACGAATGAGATTCGG,0,1562945
galEp3,0.25,3,3,GATGGCTGCCTTTAAGGTTA,0,1552686
galEp3,0.25,3,3,GATGCGTGTGTCGAAGTAGC,0,1582148
galEp3,0.25,3,3,GATGCAATCTTATCACGTCT,0,1567066
galEp3,0.25,3,3,GATGACACCTTGGCCGATAT,0,1574005
galEp3,0.25,3,3,GATCGGGTCACCAGTTTATG,0,1556738
galEp3,0.25,3,3,GATCCCGGCATACCGACTTA,0,1587431
galEp3,0.25,3,3,GATCAGTCTGGAGGTGGCTA,0,1594093
galEp3,0.25,3,3,GATACTAAAGCTGATCGCTA,0,1587590
galEp3,0.25,3,3,GATAACGGTGACAGGCGTCG,0,1549672
galEp3,0.25,3,3,GATAAACGGTTCGGGTCAAT,0,1547248
galEp3,0.25,3,3,GAGTTCGACGCCCTTTCCAA,0,1588776
galEp3,0.25,3,3,GAGTCAACACGATCGGCCAA,0,1585925
galEp3,0.25,3,3,GAGTACTTATAGACTACCCA,0,1576293
galEp3,0.25,3,3,GAGTACCCTAACCCAATGTA,0,1546451
galEp3,0.25,3,3,GAGGGACCCACACGCGTGTC,0,1587773
galEp3,0.25,3,3,GAGGATAAGGGCTTCATATC,0,1588566
galEp3,0.25,3,3,GAGCTGGCTTGGCCGTATAT,0,1566819
galEp3,0.25,3,3,GAGCTCTTGAGCTCCATCTT,0,1588718
galEp3,0.25,3,3,GAGCGGGCGGCCGCTAACCT,0,1565663
galEp3,0.25,3,3,GAGCGCTGCAGTTGTCAGAC,0,1564018
galEp3,0.25,3,3,GAGCGAGATCGGGATTGTTA,0,1591749
galEp3,0.25,3,3,GAGCATCGTTTACTGAGACC,0,1572747
galEp3,0.25,3,3,GAGCACCGGCATGTCGTGCA,0,1569526
galEp3,0.25,3,3,GAGCAAGCGCTCTGATATCT,0,1592232
galEp3,0.25,3,3,GAGATCTGGTTAAAATCCTG,0,1556471
galEp3,0.25,3,3,GAGAGTAGCATAATTGAGGA,0,1579323
galEp3,0.25,3,3,GAGACGACTGGCTAGTGATG,0,1555476
galEp3,0.25,3,3,GAGAATAGTTACGCCCAGTT,0,1594782
galEp3,0.25,3,3,GAGAAGTGCGCATCTCGGGA,0,1565912
galEp3,0.25,3,3,GACTTATTCGAGAGGTCTAA,0,1592738
galEp3,0.25,3,3,GACTATGACATAAATAATCC,0,1566582
galEp3,0.25,3,3,GACGAATGCCGAATTGGTGA,0,1560475
galEp3,0.25,3,3,GACGAAGACTATGGGGCTCA,0,1574979
galEp3,0.25,3,3,GACCTTGTAACGCGAAGGAC,0,1594738
galEp3,0.25,3,3,GACCGGGAGGAAAGCGGCAG,0,1556807
galEp3,0.25,3,3,GACCGCACACTGGGGATCAA,0,1580553
galEp3,0.25,3,3,GACCGATAGGAGGACGCTGG,0,1585253
galEp3,0.25,3,3,GACCCTAACCGTCAGAACAC,0,1559956
galEp3,0.25,3,3,GACCACCCCGTTACCTGGAA,0,1571292
galEp3,0.25,3,3,GACAGTACGGTCCAGTAGTG,0,1576755
galEp3,0.25,3,3,GAATTTGATGAAAGGAATAA,0,1564468
galEp3,0.25,3,3,GAATTGTATGGATGATTCGC,0,1582382
galEp3,0.25,3,3,GAATTGGAACCAGTTAGGCC,0,1594212
galEp3,0.25,3,3,GAATCGGCACAACTGACTGT,0,1579953
galEp3,0.25,3,3,GAATCAAGAGCGCACGCTCT,0,1546735
galEp3,0.25,3,3,GAATAAGTGTAGGCGCACTA,0,1563730
galEp3,0.25,3,3,GAAGTTTGACCAGCTGGCTC,0,1586240
galEp3,0.25,3,3,GAAGTTAATCTTAATCCGCT,0,1592769
galEp3,0.25,3,3,GAAGGTCATACGTTCCCTGG,0,1585017
galEp3,0.25,3,3,GAAGGTCAGGAAGACTGTGA,0,1587453
galEp3,0.25,3,3,GAAGATAGGCTCCCGAATGT,0,1577348
galEp3,0.25,3,3,GAACTTATACGTGGTCGGCT,0,1580941
galEp3,0.25,3,3,GAACTCTCGCGTTGGGGACA,0,1548913
galEp3,0.25,3,3,GAACGTGCACCAGTCCATGA,0,1583822
galEp3,0.25,3,3,GAACGGCGACCGCCGGGAAC,0,1548582
galEp3,0.25,3,3,GAACCCAGCCGCCCTAAGAT,0,1561284
galEp3,0.25,3,3,GAACAGATTCGAGGCTCGCA,0,1561954
galEp3,0.25,3,3,GAAATTCCACGTCACCATCG,0,1561063
galEp3,0.25,3,3,GAAAAAGGGGCGTAAGGCAT,0,1557485
galEp3,0.25,3,3,CTTTTGTCCTCCAGTGATCC,0,1556475
galEp3,0.25,3,3,CTTTTGTATTTGACGGTCAT,0,1550741
galEp3,0.25,3,3,CTTTTGAAAATGGTGAACAT,0,1551821
galEp3,0.25,3,3,CTTTTCGCCAGTGCGAAAAG,0,1579882
galEp3,0.25,3,3,CTTTGGTACCCACTACTAGG,0,1565103
galEp3,0.25,3,3,CTTTGCCTCTAACTTTTTCC,0,1553647
galEp3,0.25,3,3,CTTTAGAAAATCATTGCTGA,0,1581860
galEp3,0.25,3,3,CTTGTCTCAACTTTTGATCT,0,1551794
galEp3,0.25,3,3,CTTGTATTTCGATCGGTCAT,0,1590229
galEp3,0.25,3,3,CTTGGAATGAGCACGTTCAC,0,1580380
galEp3,0.25,3,3,CTTGCTAAACGCATTCTTCC,0,1554216
galEp3,0.25,3,3,CTTCGTATTCATCCACGTAT,0,1579465
galEp3,0.25,3,3,CTTCGGGGAAGCCAATGGTA,0,1547920
galEp3,0.25,3,3,CTTATGAACGTCGGAGGGAT,0,1574975
galEp3,0.25,3,3,CTTATATTTGAACATTTAAG,0,1585753
galEp3,0.25,3,3,CTTAGTACTTGAAGGGGGTC,0,1563823
galEp3,0.25,3,3,CTTACCCGCATCACATGACA,0,1580393
galEp3,0.25,3,3,CTTACCAGCTCAGTTAGAAT,0,1571856
galEp3,0.25,3,3,CTTAAGGACAGAGGGCAGAT,0,1558388
galEp3,0.25,3,3,CTTAAATCTGTTATCGAGCG,0,1554433
galEp3,0.25,3,3,CTGTTGTTTTTGGTGGCCGG,0,1571795
galEp3,0.25,3,3,CTGTCATCCAAGCTAGCCCA,0,1572774
galEp3,0.25,3,3,CTGTCAGTTTATTTTTTTGT,0,1584857
galEp3,0.25,3,3,CTGTCAAGCCGGAGTTATCG,0,1555796
galEp3,0.25,3,3,CTGTAGGTTATGCTGAGCCA,0,1574893
galEp3,0.25,3,3,CTGTACGGCGAACTGTCTTG,0,1564320
galEp3,0.25,3,3,CTGGTGTTAAGATCAGCAAG,0,1593800
galEp3,0.25,3,3,CTGGCTCCTCGGTGGAATGT,0,1554187
galEp3,0.25,3,3,CTGGACCCTAAGTGATCATA,0,1563832
galEp3,0.25,3,3,CTGCTCGCTATCCGCTTCAT,0,1574747
galEp3,0.25,3,3,CTGCAGCCAGTAGTGGTGAC,0,1553577
galEp3,0.25,3,3,CTGCAGCACCTAGGCTCCGC,0,1572245
galEp3,0.25,3,3,CTGAGGGTCTTTTATCGTTA,0,1575982
galEp3,0.25,3,3,CTGAGCGCGTTAAGGACATA,0,1583795
galEp3,0.25,3,3,CTGAGAACGCTTTGCGTGCT,0,1552443
galEp3,0.25,3,3,CTGAATGTTTAGACACGCCC,0,1553941
galEp3,0.25,3,3,CTCTCATTACCTCCTCGAAG,0,1554692
galEp3,0.25,3,3,CTCTAGAGGGCACCCGATGT,0,1562710
galEp3,0.25,3,3,CTCGGTTGGAACCGAAGAGC,0,1583073
galEp3,0.25,3,3,CTCGGTTAACTGATCAAGGA,0,1551326
galEp3,0.25,3,3,CTCGCGCGTCTCAGGTTAGA,0,1591058
galEp3,0.25,3,3,CTCGATGGCTCGCCCTGCTA,0,1575890
galEp3,0.25,3,3,CTCGAACATAATAATTAATG,0,1566124
galEp3,0.25,3,3,CTCCGTGTCAAACATGTCTC,0,1558947
galEp3,0.25,3,3,CTCCGCTGTTGTACGTCATT,0,1576322
galEp3,0.25,3,3,CTCCCTTCTCTAAAGGTCGT,0,1584271
galEp3,0.25,3,3,CTCCAGTCCTATGTCCAGAA,0,1572625
galEp3,0.25,3,3,CTCAGAGCTAGTTACCTTGT,0,1560117
galEp3,0.25,3,3,CTCAGACTACCACAAGCAGA,0,1547921
galEp3,0.25,3,3,CTCAAACTTAAACTCAGAAA,0,1591793
galEp3,0.25,3,3,CTATGCACAGAAATATATGC,0,1551576
galEp3,0.25,3,3,CTAGTCGTCCAGTCCGCCGG,0,1549031
galEp3,0.25,3,3,CTAGCTTGGGACTACGTTTA,0,1548782
galEp3,0.25,3,3,CTAGCTCGCGAGTTGCCGGC,0,1563636
galEp3,0.25,3,3,CTAGCTAAGGGGTGTTACTA,0,1581473
galEp3,0.25,3,3,CTAGCGCTGCACACCAGTCT,0,1593564
galEp3,0.25,3,3,CTAGCCAGCATACCATCACA,0,1555390
galEp3,0.25,3,3,CTAGCATATGCTGGTCATAG,0,1581408
galEp3,0.25,3,3,CTAGAGTCCCAGCTGCCAAA,0,1565754
galEp3,0.25,3,3,CTACTCGCACTTCTCCGCGC,0,1556294
galEp3,0.25,3,3,CTACCGGACCTTGCGCATTG,0,1585480
galEp3,0.25,3,3,CTACATGAGCAAGCCCCACC,0,1594241
galEp3,0.25,3,3,CTAATTCTTAATGATCCCGG,0,1585153
galEp3,0.25,3,3,CTAATTATTGGGAGCACATA,0,1551752
galEp3,0.25,3,3,CTAATAATACCCAGCAGAGT,0,1564927
galEp3,0.25,3,3,CTAACCCTTGAGAGCTACGG,0,1589826
galEp3,0.25,3,3,CTAAATCCAGTGAATTCGGA,0,1559795
galEp3,0.25,3,3,CGTTGGAAACAGTTCCGGAC,0,1563117
galEp3,0.25,3,3,CGTTAGGGATACTCGGTCTT,0,1549793
galEp3,0.25,3,3,CGTTACTAGCAAGCGTTCCA,0,1575381
galEp3,0.25,3,3,CGTGGTTGATACCAATTCGA,0,1570968
galEp3,0.25,3,3,CGTGACTCAACTCGGGTTGG,0,1562661
galEp3,0.25,3,3,CGTGAATCTTCGGGTAGGCC,0,1584795
galEp3,0.25,3,3,CGTCTACTGGCATGCAGGCT,0,1581843
galEp3,0.25,3,3,CGTCGCCTAAGTATCACAAT,0,1563639
galEp3,0.25,3,3,CGTCCCGTTACTTATTTCCG,0,1582330
galEp3,0.25,3,3,CGTCAGTAACGTCTGTACTT,0,1563866
galEp3,0.25,3,3,CGTCAGGGGTGCCAGATAAG,0,1549976
galEp3,0.25,3,3,CGTAGTAATGTGATACAGAC,0,1571307
galEp3,0.25,3,3,CGGTTTCCCTACCGATTAGT,0,1589964
galEp3,0.25,3,3,CGGTTCGACTAATACCCCTT,0,1590432
galEp3,0.25,3,3,CGGTTCCGCCTCGCTTTGTG,0,1594176
galEp3,0.25,3,3,CGGTTATGGCGCCTCTCACC,0,1573334
galEp3,0.25,3,3,CGGTGTTCACGCCCGGTCAA,0,1585152
galEp3,0.25,3,3,CGGTGCCATGCATGCAAATA,0,1591229
galEp3,0.25,3,3,CGGTCACTGCTTTGCCGTAA,0,1592691
galEp3,0.25,3,3,CGGTCAATCTCCTGTAGTTC,0,1570289
galEp3,0.25,3,3,CGGTATCTAACCCCTTCATG,0,1558052
galEp3,0.25,3,3,CGGTACGCGCTAGTTAGACT,0,1585832
galEp3,0.25,3,3,CGGTACCAATGTTTCTTGAA,0,1559446
galEp3,0.25,3,3,CGGGTAAGTTATGTGCAAAT,0,1581145
galEp3,0.25,3,3,CGGGGCTAGCGTGAAGGTCA,0,1571799
galEp3,0.25,3,3,CGGGGAACATCGTAAAAACG,0,1553697
galEp3,0.25,3,3,CGGGCAAGCCGGACGCTAGC,0,1579853
galEp3,0.25,3,3,CGGGAGTCGCAACGCCAAAG,0,1553960
galEp3,0.25,3,3,CGGGAGACACATGGTCCTCG,0,1558807
galEp3,0.25,3,3,CGGCTGTGATCGCGATGCGT,0,1577419
galEp3,0.25,3,3,CGGCTAGTCAAACGATCTCC,0,1564995
galEp3,0.25,3,3,CGGCGGAGAGATCAAGAGGA,0,1554074
galEp3,0.25,3,3,CGGCGGAAAGCTAGGCAGTA,0,1572005
galEp3,0.25,3,3,CGGCCTGACGGGCTCTCCTT,0,1567135
galEp3,0.25,3,3,CGGCCGGGGTATTTCCGATG,0,1552971
galEp3,0.25,3,3,CGGCCACGCTTTCGGGCTGT,0,1574166
galEp3,0.25,3,3,CGGCATGTATTATATTCAAT,0,1591983
galEp3,0.25,3,3,CGGATCACTTGCCGATTTAC,0,1572156
galEp3,0.25,3,3,CGGAGTGATCAGACCGTGGT,0,1562788
galEp3,0.25,3,3,CGGAGGTCTAAAAGTTTATT,0,1559879
galEp3,0.25,3,3,CGGAGACAGATAGGTCTACG,0,1555602
galEp3,0.25,3,3,CGGACGCTTCCCTGGTCCCA,0,1549879
galEp3,0.25,3,3,CGGACAAGCTGACCCACCAT,0,1584959
galEp3,0.25,3,3,CGGAAATTCTCGTGTGACAT,0,1563381
galEp3,0.25,3,3,CGCTTAAGTTGTGACTCCCT,0,1577977
galEp3,0.25,3,3,CGCTCCGGTCAACTTTGGCA,0,1574411
galEp3,0.25,3,3,CGCTACATGTTATTAAACAT,0,1593136
galEp3,0.25,3,3,CGCGTACCACACCCCCGATC,0,1593181
galEp3,0.25,3,3,CGCGGGTAAAAATGCTGGGA,0,1571200
galEp3,0.25,3,3,CGCGGGACCTTTTGGTTGTC,0,1560133
galEp3,0.25,3,3,CGCGGCAGCTAAAATCCTCG,0,1562137
galEp3,0.25,3,3,CGCGAGGGATCGCCAGGTTT,0,1573917
galEp3,0.25,3,3,CGCCGGTTCCGTCTTGATTA,0,1594206
galEp3,0.25,3,3,CGCCGCTTCTTTCACCTCGT,0,1548390
galEp3,0.25,3,3,CGCCGACCAATCGGCACCGA,0,1573431
galEp3,0.25,3,3,CGCCCATTGCAAACAACTTG,0,1562695
galEp3,0.25,3,3,CGCCATCGAATTGATACTTT,0,1577236
galEp3,0.25,3,3,CGCCAATGCCTAGAAAGCTT,0,1550196
galEp3,0.25,3,3,CGCATAACCAAAGGATAGTT,0,1580854
galEp3,0.25,3,3,CGCAGGTGGTGGGGAGAAGC,0,1582493
galEp3,0.25,3,3,CGCAGCATAAATAATATCAA,0,1566962
galEp3,0.25,3,3,CGCAGATTAATTATCGATCC,0,1570614
galEp3,0.25,3,3,CGCAGACGCGTGCCGGACGT,0,1575729
galEp3,0.25,3,3,CGCAGAAGTATAAATGTGCC,0,1574784
galEp3,0.25,3,3,CGCAGAAGCCCGGCTTCCGG,0,1561432
galEp3,0.25,3,3,CGATTCGGATCCAACACACT,0,1566961
galEp3,0.25,3,3,CGAGTTTAACGGGTGACCGG,0,1582248
galEp3,0.25,3,3,CGAGTTGCTGGCCGTTCGTC,0,1550470
galEp3,0.25,3,3,CGAGGTGAATGGGGGCGTAG,0,1566122
galEp3,0.25,3,3,CGAGGAAATTTTCTCCGTGA,0,1590358
galEp3,0.25,3,3,CGAGCAACATGTACGCGATT,0,1549817
galEp3,0.25,3,3,CGAGAGGTATTGTCTGTAAG,0,1588052
galEp3,0.25,3,3,CGAGAGGAGAGTTTTGCAGG,0,1563709
galEp3,0.25,3,3,CGACACTGCACCGTAAATTG,0,1560588
galEp3,0.25,3,3,CGACACGGTTAAACTCGGAA,0,1550186
galEp3,0.25,3,3,CGAAGTCTGCTGGAACTGAA,0,1565993
galEp3,0.25,3,3,CGAAGTCCAGAGCGAATTAT,0,1552314
galEp3,0.25,3,3,CGAAGTAAATCATCTGGACT,0,1549181
galEp3,0.25,3,3,CCTTTGTAAAAAAGCAGGAT,0,1594776
galEp3,0.25,3,3,CCTTTGCCGAGACCAGGTTT,0,1552066
galEp3,0.25,3,3,CCTTTCTTTCCCCTGCTATA,0,1561458
galEp3,0.25,3,3,CCTTTCGTGGAAAGTCACTA,0,1562337
galEp3,0.25,3,3,CCTTTATGGACCTAGGTGCA,0,1576485
galEp3,0.25,3,3,CCTTTAGTCAGGCCTAAACT,0,1582959
galEp3,0.25,3,3,CCTTGTTGTCTCGGATATTA,0,1579355
galEp3,0.25,3,3,CCTTCTCTCTATTCTGCTGT,0,1549323
galEp3,0.25,3,3,CCTTCCGTACGTCGTGATAC,0,1581577
galEp3,0.25,3,3,CCTTCATACTTCACCCCATC,0,1576239
galEp3,0.25,3,3,CCTTAGAACAAAACTTCCAG,0,1555472
galEp3,0.25,3,3,CCTGTATTGCGATACCGATG,0,1562985
galEp3,0.25,3,3,CCTGTAACGACCGTCCTTGG,0,1566160
galEp3,0.25,3,3,CCTGGGAGCGGTCGATTTGA,0,1587655
galEp3,0.25,3,3,CCTGGGAGCGCGTGTTCAGG,0,1589008
galEp3,0.25,3,3,CCTGCGCATCGGGTCTTAAA,0,1559774
galEp3,0.25,3,3,CCTGATGCCCATGTGTGTGA,0,1561219
galEp3,0.25,3,3,CCTCTTGACCATTGTAGGAT,0,1573816
galEp3,0.25,3,3,CCTCTCAGTGTCTCCTGTGC,0,1580153
galEp3,0.25,3,3,CCTCGGCCAACAGGTTGAGA,0,1548112
galEp3,0.25,3,3,CCTCCCAGTCCAGAAACTTC,0,1564551
galEp3,0.25,3,3,CCTATATTGGAACACCATTA,0,1570824
galEp3,0.25,3,3,CCTAGGCAGACGTGTAACTT,0,1556871
galEp3,0.25,3,3,CCTAGCCGCGTCCAAAGAAT,0,1579461
galEp3,0.25,3,3,CCTACGGAGAAAAGTTTGTG,0,1558256
galEp3,0.25,3,3,CCTACCATTCCGTGTCCAAA,0,1577773
galEp3,0.25,3,3,CCTACAAGACACCATCTTTT,0,1566753
galEp3,0.25,3,3,CCGTTGTGCACTGAGTCGTG,0,1590538
galEp3,0.25,3,3,CCGTTATGGAACAGCTTCCT,0,1560246
galEp3,0.25,3,3,CCGTGATAAGTAGATCCATT,0,1563429
galEp3,0.25,3,3,CCGTCATGCTATCGTTAAGC,0,1584282
galEp3,0.25,3,3,CCGTCATCCGATGCAAGTAC,0,1563532
galEp3,0.25,3,3,CCGTATATTACCGCTTCAAC,0,1547834
galEp3,0.25,3,3,CCGGTTAGGGTGAGAATTGG,0,1561815
galEp3,0.25,3,3,CCGGCTCCGGATATCAGCCT,0,1569200
galEp3,0.25,3,3,CCGGCCAACAGTGGGGAGTG,0,1566579
galEp3,0.25,3,3,CCGGAAAAAGAAAGCGTTAA,0,1558299
galEp3,0.25,3,3,CCGCGGGGCCATGCTACGAA,0,1565517
galEp3,0.25,3,3,CCGCGGGCTACCCGGGTAAC,0,1563560
galEp3,0.25,3,3,CCGCGCCTTATGGAGAGTTG,0,1551829
galEp3,0.25,3,3,CCGCGCACTAGCGATATTCG,0,1574765
galEp3,0.25,3,3,CCGCCGTCCCCCACTCTAAA,0,1577173
galEp3,0.25,3,3,CCGATTGAGTTATAACCCTG,0,1584123
galEp3,0.25,3,3,CCGATATGTGTCCAGGGCAA,0,1546682
galEp3,0.25,3,3,CCGAGGAGAATAAATCAGCC,0,1559194
galEp3,0.25,3,3,CCGAGATTTCATCTACACGG,0,1580780
galEp3,0.25,3,3,CCGAACAGCGAAATTCGGAT,0,1563388
galEp3,0.25,3,3,CCCTGTAGCTGACAAAAAAG,0,1550792
galEp3,0.25,3,3,CCCTGAGGTTTGTAGTTAAC,0,1582801
galEp3,0.25,3,3,CCCTCCGTAACGCGTGCCCT,0,1553982
galEp3,0.25,3,3,CCCTCCAGCTATCGTCATCA,0,1580910
galEp3,0.25,3,3,CCCTCATGTTCGCGCACCAC,0,1567586
galEp3,0.25,3,3,CCCTACTACCCACCTGCATT,0,1575924
galEp3,0.25,3,3,CCCGTGCGCGCATCAGCATG,0,1580307
galEp3,0.25,3,3,CCCGTCTAACGAATTGGAAC,0,1592529
galEp3,0.25,3,3,CCCGGTCTTCAGCGGTCAAC,0,1589191
galEp3,0.25,3,3,CCCGGGCTCGTTCGACTAGA,0,1590823
galEp3,0.25,3,3,CCCGAGGAATGTAATCAAAG,0,1565865
galEp3,0.25,3,3,CCCGAAATCCCCGTCAAGAA,0,1589099
galEp3,0.25,3,3,CCCAGAGCTCGAGGTGGAAC,0,1554183
galEp3,0.25,3,3,CCCACTTGAATGTGGGCGCT,0,1562613
galEp3,0.25,3,3,CCCACGAGCTCTCGTCATCA,0,1594839
galEp3,0.25,3,3,CCCACCTGATTCTGCTTTGT,0,1571665
galEp3,0.25,3,3,CCCAAGCCCTTAGGGGCCGT,0,1595192
galEp3,0.25,3,3,CCCAAAATGACAGGCGGCCG,0,1593376
galEp3,0.25,3,3,CCATTGAAATACCAAGGTAA,0,1561558
galEp3,0.25,3,3,CCATTCTGTGGCGGTGTGTT,0,1557615
galEp3,0.25,3,3,CCATGTTGATATGTTACTCA,0,1559548
galEp3,0.25,3,3,CCATGTTAACCTAATTCTCG,0,1587396
galEp3,0.25,3,3,CCATGCGTGACCATTTTCCT,0,1563252
galEp3,0.25,3,3,CCATGAGAGTGAACAAGAAC,0,1573927
galEp3,0.25,3,3,CCATAGGACTGGCAGCTCTT,0,1572917
galEp3,0.25,3,3,CCAGTTAGTAGTGAGTAATG,0,1585111
galEp3,0.25,3,3,CCAGGATCACGACGATGCGT,0,1594100
galEp3,0.25,3,3,CCAGGAGCGGACATAGGGTT,0,1562295
galEp3,0.25,3,3,CCAGCCCCGCTGACTCGCTG,0,1565737
galEp3,0.25,3,3,CCAGCCCCCTTTTTTGCATA,0,1573240
galEp3,0.25,3,3,CCACGAGTATACGAGACAAA,0,1576635
galEp3,0.25,3,3,CCACCGAGTCTAAGAGCCTT,0,1583650
galEp3,0.25,3,3,CCACACTTATATAAGACAGG,0,1557536
galEp3,0.25,3,3,CCACACAGTTTCGCACAGGG,0,1582623
galEp3,0.25,3,3,CCAATTAGTAGGCCCATTAC,0,1570484
galEp3,0.25,3,3,CCAAGACATTTGCGAGGTAA,0,1555199
galEp3,0.25,3,3,CCAACGTTCAATAGTGAAGC,0,1578608
galEp3,0.25,3,3,CCAACAATCTTAGGTGCTTT,0,1552723
galEp3,0.25,3,3,CATTTGCCGGGCAAGCGGCT,0,1570599
galEp3,0.25,3,3,CATTTCGGCGCTTTAAATAC,0,1558086
galEp3,0.25,3,3,CATTTCCTGTATATGGGGGA,0,1547741
galEp3,0.25,3,3,CATTGCAAAGAGCCGCCGTC,0,1556429
galEp3,0.25,3,3,CATTCTTGAACAGTCTGACA,0,1593064
galEp3,0.25,3,3,CATTAAGTCTGGCAGTAAGA,0,1582226
galEp3,0.25,3,3,CATGTTCGATAGATGCGGCT,0,1577539
galEp3,0.25,3,3,CATGTATTCCTCACGCTGTG,0,1586610
galEp3,0.25,3,3,CATCTGGTATGCAGGCAGGT,0,1569809
galEp3,0.25,3,3,CATCGTCCAAGCGGCTATAT,0,1576125
galEp3,0.25,3,3,CATCGAAGACCTGCCTAAAT,0,1560643
galEp3,0.25,3,3,CATCCTACATAGTTACAGGT,0,1547789
galEp3,0.25,3,3,CATCAGGTGCACTAATTATT,0,1572897
galEp3,0.25,3,3,CATCAAGCTAGTGTATTCTT,0,1594780
galEp3,0.25,3,3,CATATCGTGTTAATAGCGAG,0,1558661
galEp3,0.25,3,3,CATAGCTCACATTGAGCGGG,0,1585811
galEp3,0.25,3,3,CAGTGGATTAGTTAGCGGCA,0,1567697
galEp3,0.25,3,3,CAGTGCTCGACAAAGGGCAT,0,1577002
galEp3,0.25,3,3,CAGTGACACCAGATATGCCC,0,1582934
galEp3,0.25,3,3,CAGTCGAGTACTCAGCTGCT,0,1586413
galEp3,0.25,3,3,CAGTAAAATTTCCAGTCAGT,0,1570540
galEp3,0.25,3,3,CAGGTTGCAGCGGCTATAAT,0,1548996
galEp3,0.25,3,3,CAGGTCCTTCAGATCGAACG,0,1587057
galEp3,0.25,3,3,CAGGTCCGATATCCGGATGG,0,1555707
galEp3,0.25,3,3,CAGGGACGGGGGAACTCCAG,0,1549782
galEp3,0.25,3,3,CAGGGAACGTGTTGCCGACA,0,1590653
galEp3,0.25,3,3,CAGGCGGCTTCTTTATACCT,0,1551884
galEp3,0.25,3,3,CAGGAGTCGCGACAGAACAA,0,1587702
galEp3,0.25,3,3,CAGGACGTAGAGGTCTCCAT,0,1563039
galEp3,0.25,3,3,CAGCTCGGGAGCACGCTGTT,0,1580496
galEp3,0.25,3,3,CAGCTCAGGCTAGAACGACC,0,1570654
galEp3,0.25,3,3,CAGCTATAACTGTGGGGTTG,0,1554226
galEp3,0.25,3,3,CAGCGTTAACGCGATTCAGA,0,1574891
galEp3,0.25,3,3,CAGCCCGGGCCAAAACTGTC,0,1558912
galEp3,0.25,3,3,CAGCCATAAGAGAATTTTTT,0,1559341
galEp3,0.25,3,3,CAGCATTCAAGGATGCGCTC,0,1552662
galEp3,0.25,3,3,CAGCATAGATGAAGCAATGT,0,1583660
galEp3,0.25,3,3,CAGAGTTTAACGTTAAAGAG,0,1589801
galEp3,0.25,3,3,CAGAGTGTCGCGGCAGATAA,0,1558811
galEp3,0.25,3,3,CAGACTCTACCTCCCGTCTC,0,1551176
galEp3,0.25,3,3,CAGACGCACGTTACTTGGGC,0,1590414
galEp3,0.25,3,3,CACTTTACAATTGATATTAC,0,1567207
galEp3,0.25,3,3,CACTTCGCGTTCTCCCCGAT,0,1577263
galEp3,0.25,3,3,CACTGAACATCCGTAGTCAC,0,1552923
galEp3,0.25,3,3,CACTCACGAACATTCATATT,0,1555431
galEp3,0.25,3,3,CACTATTTACAGGCTAATAA,0,1557975
galEp3,0.25,3,3,CACGTCGCTTGGAACTGTCC,0,1589001
galEp3,0.25,3,3,CACGTACCCGTAATCCTTTA,0,1556516
galEp3,0.25,3,3,CACGGCAATCGAGCGTAGGC,0,1566053
galEp3,0.25,3,3,CACGCTACAGTTTCACTGCC,0,1555135
galEp3,0.25,3,3,CACCTGGGACTTACCTCGAC,0,1588916
galEp3,0.25,3,3,CACCATGTCGGGTCAGCCCA,0,1572305
galEp3,0.25,3,3,CACCAAGTGATTTGTGGCCC,0,1556097
galEp3,0.25,3,3,CACCAACCAGGGCGAGACTG,0,1575551
galEp3,0.25,3,3,CACATGATTGGATGGCAATA,0,1566655
galEp3,0.25,3,3,CACAGTTCGCGTTCGCAGTG,0,1561706
galEp3,0.25,3,3,CACAGGGTTCGCGGCGCGCG,0,1572127
galEp3,0.25,3,3,CACACGGGCTCCGGCTGGGT,0,1585488
galEp3,0.25,3,3,CACACCTGCGACATAGAGTG,0,1588172
galEp3,0.25,3,3,CAATTGTTTTATTTTCTTGC,0,1573658
galEp3,0.25,3,3,CAATGTCAGGCGAACGCCCC,0,1570415
galEp3,0.25,3,3,CAATGGCTTAAGCCGTTGTT,0,1572594
galEp3,0.25,3,3,CAATGATCACCTATGCATCA,0,1578462
galEp3,0.25,3,3,CAATCCTTTGTTATCATCTG,0,1549007
galEp3,0.25,3,3,CAATATAAGGGATGGGTAAC,0,1577502
galEp3,0.25,3,3,CAATAGGTTTGGCACTCTCG,0,1551651
galEp3,0.25,3,3,CAATAGAACTAGATCAATAA,0,1571857
galEp3,0.25,3,3,CAAGGGGCGAGATGCTATGT,0,1560498
galEp3,0.25,3,3,CAAGGGACCGTTAGCCAGCA,0,1562456
galEp3,0.25,3,3,CAAGGGAAGACGCTGTACAT,0,1565692
galEp3,0.25,3,3,CAAGGCCGGAGATACGTTTC,0,1550395
galEp3,0.25,3,3,CAAGGACTGAACTAAGCCGT,0,1592689
galEp3,0.25,3,3,CAAGCGTGGGGTCGCGCACC,0,1582919
galEp3,0.25,3,3,CAAGAATCACCATGACTCGT,0,1562578
galEp3,0.25,3,3,CAACGGTCCCGCTTTAGTAA,0,1565043
galEp3,0.25,3,3,CAACGGGGGCTGCTCTGTAC,0,1546952
galEp3,0.25,3,3,CAACGGATTTCAGACGACTC,0,1577582
galEp3,0.25,3,3,CAACGCTTTCTCACATGTAA,0,1587857
galEp3,0.25,3,3,CAACGCAACTCAGCTGATGG,0,1581318
galEp3,0.25,3,3,CAACCGGGATGGCCCCCGTT,0,1557017
galEp3,0.25,3,3,CAACCCTGTTTGCAAGCTAC,0,1565048
galEp3,0.25,3,3,CAACAGACAATAAATGGTAT,0,1581603
galEp3,0.25,3,3,CAAATTGATGAGTCGAAAAG,0,1547662
galEp3,0.25,3,3,CAAATGTTGATCATTGCAAA,0,1594925
galEp3,0.25,3,3,CAAAAGCGACCTCCGAGTCC,0,1578421
galEp3,0.25,3,3,CAAAACTTCGGTGGCACGAC,0,1548756
galEp3,0.25,3,3,ATTTTGGTTGACAACCACTT,0,1550094
galEp3,0.25,3,3,ATTTTGAGTTGCATTCGTAT,0,1583335
galEp3,0.25,3,3,ATTTGGGCGGGAGGATTCGT,0,1577222
galEp3,0.25,3,3,ATTTGATGATTGGTTACACC,0,1573925
galEp3,0.25,3,3,ATTTGACCGGCGCTCCTGTG,0,1571500
galEp3,0.25,3,3,ATTTCAGCCTGTGCACGCTG,0,1570422
galEp3,0.25,3,3,ATTTATCCCAGAGGAAGTCT,0,1569070
galEp3,0.25,3,3,ATTGGGTTGCGCAGGGTATG,0,1550726
galEp3,0.25,3,3,ATTGCGGCATTCAGGGGCGC,0,1570895
galEp3,0.25,3,3,ATTGACGAGTGCTGCAGACT,0,1568498
galEp3,0.25,3,3,ATTCTTTTGCTGATCGTGGG,0,1553243
galEp3,0.25,3,3,ATTCTATGGCTCGAATTAGA,0,1568253
galEp3,0.25,3,3,ATTCCGTAATACAGTGGTCA,0,1564024
galEp3,0.25,3,3,ATTCAGGATATGCCGAGTGA,0,1574184
galEp3,0.25,3,3,ATTCAGACCCGTAGTACGGC,0,1578375
galEp3,0.25,3,3,ATTCACTTTGAATGGCGCGG,0,1594149
galEp3,0.25,3,3,ATTAGGTTCTAGACATATTA,0,1549167
galEp3,0.25,3,3,ATGTTTATTTTAGTCTAGAT,0,1557261
galEp3,0.25,3,3,ATGTGATTATTTTTCGGAGT,0,1565887
galEp3,0.25,3,3,ATGTCAACTCAAAATGACTA,0,1579332
galEp3,0.25,3,3,ATGGGTCAGGAGCTTGTTGT,0,1573792
galEp3,0.25,3,3,ATGGCTTTCCCGGGAAGACT,0,1571047
galEp3,0.25,3,3,ATGGCTCGACGCAATCAGTG,0,1583729
galEp3,0.25,3,3,ATGGCGGGCATCCATCCTGC,0,1563825
galEp3,0.25,3,3,ATGGCATTTTCCTATTTATT,0,1569658
galEp3,0.25,3,3,ATGGCACGATTGGCACGGCT,0,1560704
galEp3,0.25,3,3,ATGGACGTGACGTAAGTGGT,0,1562714
galEp3,0.25,3,3,ATGCGTGCTAGACCTACCAT,0,1555514
galEp3,0.25,3,3,ATGCCGAGTGCCAACGACCA,0,1548128
galEp3,0.25,3,3,ATGCCGAGGAAGAAGGTCGG,0,1588574
galEp3,0.25,3,3,ATGCCCTTACGATTGGGTGA,0,1558441
galEp3,0.25,3,3,ATGCCCATGAATTGCAACTT,0,1563467
galEp3,0.25,3,3,ATGCAGATCGAACATCGCGA,0,1591873
galEp3,0.25,3,3,ATGATCTTTGGTGGGGCACA,0,1580056
galEp3,0.25,3,3,ATGATACCCTCGTTCAGGAG,0,1555134
galEp3,0.25,3,3,ATGAGGTCTCGCGGTCGAAC,0,1556773
galEp3,0.25,3,3,ATGAGGATGAGGATGGTGTC,0,1563997
galEp3,0.25,3,3,ATGAGATACGGACCGGATAT,0,1592645
galEp3,0.25,3,3,ATGACCGAATATGTACACCC,0,1552660
galEp3,0.25,3,3,ATGAATACGTAGCGTGGGAT,0,1585606
galEp3,0.25,3,3,ATGAAACCCGCCTGGGACTT,0,1553995
galEp3,0.25,3,3,ATCGTAAAGGCTGTGGGTAA,0,1555655
galEp3,0.25,3,3,ATCGGGTCTTAGGACGCGAT,0,1569321
galEp3,0.25,3,3,ATCGGGGCATCGTATGTTAG,0,1576402
galEp3,0.25,3,3,ATCGGCTCATAATGTGCGCG,0,1574327
galEp3,0.25,3,3,ATCGGCCTGTTTGTGTCCTA,0,1552121
galEp3,0.25,3,3,ATCGCTAGGGAGGGTTCACT,0,1562136
galEp3,0.25,3,3,ATCGCCGCGTCGTTCCCGTG,0,1584860
galEp3,0.25,3,3,ATCCGGACAGAACCTGGAGG,0,1557134
galEp3,0.25,3,3,ATCCCTGGGTACGGTAGACT,0,1576897
galEp3,0.25,3,3,ATCCCGAGGTAGTGCACCGC,0,1560345
galEp3,0.25,3,3,ATCCCCTTAGCGCAGGACGC,0,1582355
galEp3,0.25,3,3,ATCCCCGGAACATATGAACA,0,1556088
galEp3,0.25,3,3,ATCCAACGGGTTTCACCCTT,0,1593644
galEp3,0.25,3,3,ATCATCGGATGGAATCCGAG,0,1575758
galEp3,0.25,3,3,ATCATAGCTAACGTAAATGT,0,1559993
galEp3,0.25,3,3,ATCAGCGCAAAGTTATACTT,0,1581704
galEp3,0.25,3,3,ATCAGACTGGCCTTTCTTCG,0,1568966
galEp3,0.25,3,3,ATCAAGATTGTGCTCGTCTT,0,1555325
galEp3,0.25,3,3,ATCAACTCCAGGGAGGTAAA,0,1594210
galEp3,0.25,3,3,ATCAACCTCTTTGTTTTTTG,0,1589803
galEp3,0.25,3,3,ATCAAAGCAGATTGCGTCGC,0,1568808
galEp3,0.25,3,3,ATATTTATTACCGTCTACCC,0,1593464
galEp3,0.25,3,3,ATATCAACCGCCCAGTCACT,0,1592843
galEp3,0.25,3,3,ATATACAAAAATAAAATTCT,0,1576170
galEp3,0.25,3,3,ATAGTGTCAGTCAATCAGAC,0,1562446
galEp3,0.25,3,3,ATAGTATCGATTTTACGCCC,0,1559668
galEp3,0.25,3,3,ATAGGTACACTTAGACCTCA,0,1591187
galEp3,0.25,3,3,ATAGGATGACACGCAACATC,0,1575136
galEp3,0.25,3,3,ATAGGACATAAGGCTCGCTC,0,1560301
galEp3,0.25,3,3,ATAGCGTTGACAGGCTGATC,0,1558015
galEp3,0.25,3,3,ATAGATGCTAGGAGTTCTCC,0,1587021
galEp3,0.25,3,3,ATACTTGGTTTGATTACAAC,0,1588114
galEp3,0.25,3,3,ATACTACAAATTCTTCTTGA,0,1581764
galEp3,0.25,3,3,ATACGGTGAGTAGGCGGTTA,0,1585142
galEp3,0.25,3,3,ATACGGATTGGAACCTCACT,0,1573173
galEp3,0.25,3,3,ATACCGTCAAGAATCCTGCA,0,1558243
galEp3,0.25,3,3,ATACCGCAGTTCTCACAGGG,0,1547604
galEp3,0.25,3,3,ATACCACGTCTGGTGCTGCC,0,1583344
galEp3,0.25,3,3,ATACAGTAAGCTCAACCCGT,0,1582171
galEp3,0.25,3,3,ATAATTTGTCTGAAACGAAT,0,1556434
galEp3,0.25,3,3,ATAAGTCCTTGGGATTAGGC,0,1563131
galEp3,0.25,3,3,ATAACGGTAACGCATCCAGA,0,1589420
galEp3,0.25,3,3,ATAACGATTGGGACCTCCCG,0,1555474
galEp3,0.25,3,3,ATAAATTTAGGGGTCAAAAG,0,1592613
galEp3,0.25,3,3,AGTTCCAATTAGATGTGCAG,0,1568556
galEp3,0.25,3,3,AGTTACGTCACGGCATCTCG,0,1561610
galEp3,0.25,3,3,AGTTACGCGCAAGCATTTTG,0,1554211
galEp3,0.25,3,3,AGTGTCATACGTGACAAACT,0,1566875
galEp3,0.25,3,3,AGTGGGTCTGAACCCGTTTT,0,1564084
galEp3,0.25,3,3,AGTGCTGGGTGTGAGCTTTC,0,1588232
galEp3,0.25,3,3,AGTGAGAGCGACTGGAATTT,0,1568703
galEp3,0.25,3,3,AGTGAGACCCCGCTTCGTGA,0,1556954
galEp3,0.25,3,3,AGTGACGGTTCAGGGATTAG,0,1588278
galEp3,0.25,3,3,AGTCTAGGCATTCCTTATAC,0,1550775
galEp3,0.25,3,3,AGTCGCCTGACAACGTTAGG,0,1571497
galEp3,0.25,3,3,AGTCCTTGCAACCTGCAATC,0,1553785
galEp3,0.25,3,3,AGTCCACTGCCGCCACCTCT,0,1577746
galEp3,0.25,3,3,AGTATCGATAGAAGTTCTTC,0,1559942
galEp3,0.25,3,3,AGTATACACGGGGCACAACT,0,1546846
galEp3,0.25,3,3,AGTAGTCCCTGACTGTCGGG,0,1562436
galEp3,0.25,3,3,AGTAGACTGATCCGGTCGTT,0,1567641
galEp3,0.25,3,3,AGTAATTCATCAGCCGTAAC,0,1576594
galEp3,0.25,3,3,AGTAAATGGTGGTGGGCGAT,0,1564058
galEp3,0.25,3,3,AGGTTGAATCCTGGAGGAAT,0,1569805
galEp3,0.25,3,3,AGGTTGAAGACGGCGAACGT,0,1554888
galEp3,0.25,3,3,AGGTTAAAGAGTCCTCCGAA,0,1554431
galEp3,0.25,3,3,AGGTGTGGTAGGCAGTGTTA,0,1547641
galEp3,0.25,3,3,AGGTCTTTCATGCTACTTGC,0,1559197
galEp3,0.25,3,3,AGGTCGTGTAGGATCTGAGC,0,1568650
galEp3,0.25,3,3,AGGTCCGAGTAGACATCCTG,0,1558789
galEp3,0.25,3,3,AGGTCCCTTTGTTCATCTAA,0,1555565
galEp3,0.25,3,3,AGGTATGTGCACTGCGACGG,0,1563991
galEp3,0.25,3,3,AGGTATACTACAAACAACCA,0,1551630
galEp3,0.25,3,3,AGGTAGAGGCCACAACCCGA,0,1564289
galEp3,0.25,3,3,AGGTAATACAGTATCCTGGG,0,1560823
galEp3,0.25,3,3,AGGGTTGGGTCGGTAAATCC,0,1566965
galEp3,0.25,3,3,AGGGTGGAGGACGTCCGACA,0,1561394
galEp3,0.25,3,3,AGGGTAGCCAGTGGATTCTA,0,1556028
galEp3,0.25,3,3,AGGGGTGGGATTAGTACGTT,0,1555349
galEp3,0.25,3,3,AGGGGTACCAGGAGCCGTCA,0,1546982
galEp3,0.25,3,3,AGGGCTCCTCTCGGAAACGA,0,1592102
galEp3,0.25,3,3,AGGGAACGAGCATAGGCGAA,0,1549701
galEp3,0.25,3,3,AGGCTACACCGGACACTCTA,0,1587035
galEp3,0.25,3,3,AGGCGAACGGGGCTCCTGCG,0,1559182
galEp3,0.25,3,3,AGGCCGGTGTCAGGGATCGG,0,1581185
galEp3,0.25,3,3,AGGCAGGCAGCTCTGTTTCT,0,1549721
galEp3,0.25,3,3,AGGCACGGCGAACTATAGAC,0,1594883
galEp3,0.25,3,3,AGGCAATAAACGTTACAGAC,0,1589389
galEp3,0.25,3,3,AGGATGTGCGCAGTCATTAT,0,1577126
galEp3,0.25,3,3,AGGACGGCCAGCGACGCAGT,0,1592166
galEp3,0.25,3,3,AGGACGAAGCTGCGCGGTTG,0,1577452
galEp3,0.25,3,3,AGGACCTTACCGTGCAGCCA,0,1589670
galEp3,0.25,3,3,AGGAACTAGCCTCACTCGAT,0,1570541
galEp3,0.25,3,3,AGCTTCCAATAAGTAGACAA,0,1555428
galEp3,0.25,3,3,AGCGCAAAATGTCCCCTATA,0,1574128
galEp3,0.25,3,3,AGCGAACGTATCGGCATTCT,0,1556943
galEp3,0.25,3,3,AGCCGCTGTCCTACCGGTAA,0,1575491
galEp3,0.25,3,3,AGCATCAATTGATGATTAAG,0,1572147
galEp3,0.25,3,3,AGCATAAGCAGTCTCTGAAA,0,1569825
galEp3,0.25,3,3,AGATTCGAAATCTAAATATC,0,1592037
galEp3,0.25,3,3,AGATTCCTTCGCAATATCAA,0,1555520
galEp3,0.25,3,3,AGATTACGTGCCTAAGTCTC,0,1577295
galEp3,0.25,3,3,AGATTACACCTACGCTATCT,0,1552860
galEp3,0.25,3,3,AGATTACACAGGACTCTCCT,0,1551633
galEp3,0.25,3,3,AGATGTCGGCCGCTATTTCC,0,1568612
galEp3,0.25,3,3,AGATCTCTAGGTCCCATCAT,0,1593810
galEp3,0.25,3,3,AGATCCTTAAGAACCCTTCT,0,1579471
galEp3,0.25,3,3,AGATACTTTATACCGCCAAT,0,1592765
galEp3,0.25,3,3,AGATACTGGCATGCACCGGG,0,1555190
galEp3,0.25,3,3,AGAGTCGGTTCATCTTGAAG,0,1561535
galEp3,0.25,3,3,AGAGTAGATGCTGCTTCCCG,0,1551315
galEp3,0.25,3,3,AGAGTAACAAACTGTTCTAG,0,1575975
galEp3,0.25,3,3,AGACTCCCCGTCTACTTCCC,0,1591318
galEp3,0.25,3,3,AGACTACTAAACAGCACTAA,0,1582283
galEp3,0.25,3,3,AGACCACCGATATTGCCAAC,0,1546644
galEp3,0.25,3,3,AGACATAGGATTCTGTATTT,0,1557417
galEp3,0.25,3,3,AGAATGTATTGGACTGGGTC,0,1575302
galEp3,0.25,3,3,AGAATGAAGTTGGTAACTGT,0,1588711
galEp3,0.25,3,3,AGAATCCATCCAAGCGGCAG,0,1574085
galEp3,0.25,3,3,ACTTTTGGTAAACTGACGCA,0,1554254
galEp3,0.25,3,3,ACTTCGCTTGAGAAGCAAGG,0,1590505
galEp3,0.25,3,3,ACTTCGAAGCTCCCTGTAGA,0,1549338
galEp3,0.25,3,3,ACTTCCTAAAAGGCCAACCT,0,1575531
galEp3,0.25,3,3,ACTGTACGGGGTGTTTCAAA,0,1584702
galEp3,0.25,3,3,ACTGTACATACGGTGAGATT,0,1586486
galEp3,0.25,3,3,ACTGGGGGTGGAGCTGGAAG,0,1562332
galEp3,0.25,3,3,ACTCTTTATGCTTAAGGATA,0,1568456
galEp3,0.25,3,3,ACTCTGGCGTGGTTCATCTC,0,1584826
galEp3,0.25,3,3,ACTCTCACACCGACGCATGT,0,1571865
galEp3,0.25,3,3,ACTCGCGGCCCGGTGTGTTG,0,1557989
galEp3,0.25,3,3,ACTCCGTCTTCTTGGGAGCC,0,1584217
galEp3,0.25,3,3,ACTCCGTAATTCACGTCCGG,0,1574178
galEp3,0.25,3,3,ACTCCGGTGAGGCGGCAAGG,0,1573921
galEp3,0.25,3,3,ACTCCGCCGCAACAAGAATG,0,1569393
galEp3,0.25,3,3,ACTCCCCATTGCTCGGCGGG,0,1563439
galEp3,0.25,3,3,ACTCACGACGGAATAGCGTG,0,1559482
galEp3,0.25,3,3,ACTCACACGTAGGCCCCTAG,0,1584574
galEp3,0.25,3,3,ACTACTGATGTTGCACGACC,0,1589595
galEp3,0.25,3,3,ACGTTGACTTTCGACGTTGT,0,1563411
galEp3,0.25,3,3,ACGTTCCGGGCCTTTTCTCG,0,1578528
galEp3,0.25,3,3,ACGTTACTCGAGCGGGTTCT,0,1548425
galEp3,0.25,3,3,ACGTTACCCACTCTACTCGC,0,1559111
galEp3,0.25,3,3,ACGTGATCGTCGTTAGGCTA,0,1569411
galEp3,0.25,3,3,ACGTCGAATTTGCGGTAATA,0,1562087
galEp3,0.25,3,3,ACGTACTCCCCCACAAGAAA,0,1589892
galEp3,0.25,3,3,ACGTACGGTAAGTACATTGC,0,1547381
galEp3,0.25,3,3,ACGTAAGACAGACGGATTAA,0,1555906
galEp3,0.25,3,3,ACGGGAGGCTACCGTTTGAA,0,1573512
galEp3,0.25,3,3,ACGGCTGACCCCGGTGGCAG,0,1588934
galEp3,0.25,3,3,ACGGCTCCTGGCCAACAAAG,0,1559803
galEp3,0.25,3,3,ACGGAGATCGCGTATGATTC,0,1579933
galEp3,0.25,3,3,ACGCTTAGAAAAGACATGAT,0,1582402
galEp3,0.25,3,3,ACGCGAGCGGGGTGGATCTT,0,1559568
galEp3,0.25,3,3,ACGCCCTGCAGCTTTCAGCA,0,1547569
galEp3,0.25,3,3,ACGCAGGGACAGGGTAGCAA,0,1561748
galEp3,0.25,3,3,ACGATGGGGTATGAACCCCC,0,1575804
galEp3,0.25,3,3,ACGATCGGCATTCAGTATAC,0,1593450
galEp3,0.25,3,3,ACGAGGTCTTTGCTAGGCGG,0,1578930
galEp3,0.25,3,3,ACGAGGCAAAGTCTGAGTCA,0,1547351
galEp3,0.25,3,3,ACGACACGTCGGCAGTCCAT,0,1557212
galEp3,0.25,3,3,ACCTTCTCAGTATACATCCT,0,1571494
galEp3,0.25,3,3,ACCTTATTAAAGGCACGAGC,0,1567520
galEp3,0.25,3,3,ACCTGACCGCCTTCGGATCA,0,1590417
galEp3,0.25,3,3,ACCTCAATATCTGGTCCATC,0,1575363
galEp3,0.25,3,3,ACCTAGTCGAACCTGCATAC,0,1594292
galEp3,0.25,3,3,ACCTAGGACTGGCTCGGAGT,0,1576499
galEp3,0.25,3,3,ACCTAGATAGCAGTGAGCCT,0,1559923
galEp3,0.25,3,3,ACCTACTAAGAGTGGGGGTC,0,1561564
galEp3,0.25,3,3,ACCGTTCGAGTGATTCGGCA,0,1557616
galEp3,0.25,3,3,ACCGTGTTGTGACAAAGTGG,0,1592320
galEp3,0.25,3,3,ACCGGCCATCTCTAACGAAT,0,1575556
galEp3,0.25,3,3,ACCGCCTTGTAAGCGGTCTA,0,1569512
galEp3,0.25,3,3,ACCCGTGGACGATTAGGCCC,0,1592927
galEp3,0.25,3,3,ACCCGGTGAAATAACGGGAT,0,1581040
galEp3,0.25,3,3,ACCCGACCAAATTCAGCGCC,0,1563273
galEp3,0.25,3,3,ACCATTGAGCCAAAAGCGTT,0,1579989
galEp3,0.25,3,3,ACCAGTATGCGGGTGCAAGC,0,1587341
galEp3,0.25,3,3,ACCACGGATACGTCACAGAG,0,1585849
galEp3,0.25,3,3,ACCAAATACTAAACTCTTTC,0,1575580
galEp3,0.25,3,3,ACATTTTTGAGCTCTAGAGC,0,1549696
galEp3,0.25,3,3,ACATGTTCGGATGGTCGCGG,0,1588252
galEp3,0.25,3,3,ACATGACGCACGAGGTCATT,0,1584027
galEp3,0.25,3,3,ACATCCGCAAGGATCTTTTC,0,1588783
galEp3,0.25,3,3,ACATATCGACGACGCTTGTA,0,1563750
galEp3,0.25,3,3,ACAGTGGTTGCCTTCTTAGG,0,1556588
galEp3,0.25,3,3,ACAGTCTCGGAACAGTACCA,0,1546680
galEp3,0.25,3,3,ACAGCTCAGGATAAGGTAAT,0,1577259
galEp3,0.25,3,3,ACAGCGTCGAGGGATTTCGA,0,1591051
galEp3,0.25,3,3,ACAGATTACATTGATTGTGT,0,1585416
galEp3,0.25,3,3,ACAGATAGTAATACTCCACA,0,1560862
galEp3,0.25,3,3,ACAGAGCCTATCCCCTTCGA,0,1559890
galEp3,0.25,3,3,ACACGTCTATGGACCACGGA,0,1564858
galEp3,0.25,3,3,ACACAGCTTTTGGGGGCATG,0,1583987
galEp3,0.25,3,3,ACACAGCTTCTTATAAGACA,0,1552364
galEp3,0.25,3,3,ACACAGATCCTAAAAGGTGC,0,1562739
galEp3,0.25,3,3,ACACAATATTGTAAGGCAGA,0,1559773
galEp3,0.25,3,3,ACAAGCTTTGACCCCATGAT,0,1571159
galEp3,0.25,3,3,ACAACGAGTCTATGTACCTA,0,1569207
galEp3,0.25,3,3,ACAACGACTACTCGTCCGCA,0,1593486
galEp3,0.25,3,3,ACAACATATCACCCCAAGAG,0,1577640
galEp3,0.25,3,3,AATTTCTTCGGCAGCACGTC,0,1553296
galEp3,0.25,3,3,AATTGTATTACGATGGGTGA,0,1578150
galEp3,0.25,3,3,AATTAGTCAGTTCCGTGCAA,0,1587039
galEp3,0.25,3,3,AATTAAGATCCTGAAAATCA,0,1564694
galEp3,0.25,3,3,AATGGTGTATCGGACGGTAA,0,1557087
galEp3,0.25,3,3,AATGGACCGAAGTCTGACGT,0,1579268
galEp3,0.25,3,3,AATGCTCTAGACTAGAAAAG,0,1590193
galEp3,0.25,3,3,AATGCTAACCCACGGCTTTC,0,1554666
galEp3,0.25,3,3,AATGCAGACTGTATCATAAA,0,1576531
galEp3,0.25,3,3,AATGATCTTGCATAACAAGC,0,1591413
galEp3,0.25,3,3,AATGAATCTTACAGTCTAGA,0,1570719
galEp3,0.25,3,3,AATCGATGGCGTGGAATGTC,0,1562138
galEp3,0.25,3,3,AATCGAAGGCGAGTTCCACC,0,1564216
galEp3,0.25,3,3,AATCCTTATCGGCGGTCCCT,0,1557369
galEp3,0.25,3,3,AATCCCTTAGTAATATCCCT,0,1575899
galEp3,0.25,3,3,AATCAAGATTGAAGGATGGC,0,1574882
galEp3,0.25,3,3,AATATGTTTCCATTCCTTCA,0,1549642
galEp3,0.25,3,3,AATATCAAACGGTCAGGTGG,0,1585087
galEp3,0.25,3,3,AATAACAACTTTGAGCGTCT,0,1556879
galEp3,0.25,3,3,AAGTTTTTATAAGGGATTCA,0,1587811
galEp3,0.25,3,3,AAGTTCACCAGGGTGTCGCA,0,1559137
galEp3,0.25,3,3,AAGTGTGACGTATAGGCTTG,0,1558269
galEp3,0.25,3,3,AAGTGTACAACGGGCTTAGT,0,1566236
galEp3,0.25,3,3,AAGTGGAAACGGCGTAAGCG,0,1578377
galEp3,0.25,3,3,AAGTCCAACTATGAGGAGGA,0,1560040
galEp3,0.25,3,3,AAGTAGGGTTCTACAAGAAA,0,1590718
galEp3,0.25,3,3,AAGGTCAGAGGAAGAGATCA,0,1575954
galEp3,0.25,3,3,AAGGGTCCCCAATGCGAGGG,0,1575303
galEp3,0.25,3,3,AAGGGGGTTATGCAACATCA,0,1586640
galEp3,0.25,3,3,AAGGGATAGAGCATCGACAG,0,1570570
galEp3,0.25,3,3,AAGGGAGCGCAGTGTCCAGC,0,1590968
galEp3,0.25,3,3,AAGCGCTGTCAAAATCGCTT,0,1586239
galEp3,0.25,3,3,AAGCGCTCTCGTAAACGATT,0,1578975
galEp3,0.25,3,3,AAGCCTGGCATGTACCTTTT,0,1568640
galEp3,0.25,3,3,AAGAGTTTAGAGCCTTGGTT,0,1566930
galEp3,0.25,3,3,AAGAGGCGGCGGATGAGATA,0,1581153
galEp3,0.25,3,3,AAGACTGAAGTCCTCGAAGA,0,1593493
galEp3,0.25,3,3,AAGACCGTTCGCCTTGGTTG,0,1562641
galEp3,0.25,3,3,AAGACCGCTAGAAGAGATGC,0,1560778
galEp3,0.25,3,3,AAGACAGGTGGTCGCGGCTT,0,1589566
galEp3,0.25,3,3,AAGACAGATGCGTGTAATAA,0,1554531
galEp3,0.25,3,3,AACTTGCTGGCTTCTTAGCG,0,1590836
galEp3,0.25,3,3,AACTGTCCTGTAAACAGAGT,0,1588906
galEp3,0.25,3,3,AACTGTAGTGCAGCGGTTCC,0,1582177
galEp3,0.25,3,3,AACTGGGTTAGAGCCCACAG,0,1582964
galEp3,0.25,3,3,AACTCGAGGGTGATTACATG,0,1572098
galEp3,0.25,3,3,AACGTCCGTCTTCTCTAAGG,0,1548119
galEp3,0.25,3,3,AACGTACGGGGTATTCCGGG,0,1591659
galEp3,0.25,3,3,AACGGGGGGGGACGGGGTAG,0,1558166
galEp3,0.25,3,3,AACGGAAATCCAAAGTCTAC,0,1575677
galEp3,0.25,3,3,AACGCTGATGCTCTGTAAAG,0,1575079
galEp3,0.25,3,3,AACGACTATAAGGTCAAGTC,0,1577645
galEp3,0.25,3,3,AACCTCGGGGGAATGGGTAA,0,1585551
galEp3,0.25,3,3,AACCCCGCATTGCCCCAAAT,0,1558047
galEp3,0.25,3,3,AACATGGGTTTCTCCGAGCG,0,1572435
galEp3,0.25,3,3,AACATGAAGGTTCACAGGTA,0,1563862
galEp3,0.25,3,3,AACAGCATCGGTTAAAATTC,0,1575081
galEp3,0.25,3,3,AACACATTCTGGGGCTTATG,0,1585727
galEp3,0.25,3,3,AACACAACCTGTCTTAGAGA,0,1587775
galEp3,0.25,3,3,AACAATACCGGTGCCGTTTT,0,1564701
galEp3,0.25,3,3,AAATGCAAGCCCAGGCTCCT,0,1585485
galEp3,0.25,3,3,AAATCGGCGGATTGACAGCC,0,1552675
galEp3,0.25,3,3,AAATCGATTTGAATACCCAG,0,1586088
galEp3,0.25,3,3,AAATCCGCTCGGCGCGCATA,0,1549876
galEp3,0.25,3,3,AAATAGCTAGGGTCCAGGAG,0,1592070
galEp3,0.25,3,3,AAATAGAACTTTGTTCGATT,0,1549052
galEp3,0.25,3,3,AAAGTTCGCATCCAGGGGTC,0,1578543
galEp3,0.25,3,3,AAAGGGAGCCGGAATCCCAC,0,1551945
galEp3,0.25,3,3,AAAGCTAGGTCGCTGTCATG,0,1576837
galEp3,0.25,3,3,AAAGCGTCATTGGTGTGGCT,0,1565906
galEp3,0.25,3,3,AAAGACGATTATAGTCTAAA,0,1551198
galEp3,0.25,3,3,AAACTGATGTACCTTCAGAC,0,1580154
galEp3,0.25,3,3,AAACTCAGGGACCATGCAGA,0,1564971
galEp3,0.25,3,3,AAACATGCTAGAAGAGTCTA,0,1569963
galEp3,0.25,3,3,AAACATGATGCAAACTAACG,0,1551060
galEp3,0.25,3,3,AAACAGCTATATTACATCGT,0,1553890
galEp3,0.25,3,3,AAAATCACCGCGCGCTGTCC,0,1572182
galEp3,0.25,3,3,AAAAGGGTGTCGCGCATCCT,0,1590463
galEp3,0.25,3,3,AAAACTCGTCGTTCGGCTGG,0,1594459
galEp3,0.25,3,3,AAAACGGCACCCACGATGGC,0,1577160
galEp3,0.25,3,3,AAAACATCCCGGCTCCCAAT,0,1570817
galEp3,0.25,3,3,AAAAATTGCCGAGGACAGTG,0,1566359
galEp3,0.3333333333333333,2,2,TTTTTCCTCATGTGAGTATT,0,1572162
galEp3,0.3333333333333333,2,2,TTTTGTATTTGCGCTCGCGA,0,1562993
galEp3,0.3333333333333333,2,2,TTTTGGACTCCTAGACGTAC,0,1564047
galEp3,0.3333333333333333,2,2,TTTTGCCTGTAATCTGAGCA,0,1591451
galEp3,0.3333333333333333,2,2,TTTTCTTTCGCGCCTAGCCA,0,1570711
galEp3,0.3333333333333333,2,2,TTTTCTACCTCATGGTAGTA,0,1555797
galEp3,0.3333333333333333,2,2,TTTTCCCAGCATTTAAAGCC,0,1587268
galEp3,0.3333333333333333,2,2,TTTTAAGAGCGGTACCTCAT,0,1582769
galEp3,0.3333333333333333,2,2,TTTGTACGGCACTACACGTG,0,1558790
galEp3,0.3333333333333333,2,2,TTTGGCATTGATTAATGCAT,0,1556885
galEp3,0.3333333333333333,2,2,TTTGGAAGGGACTGCCGTGC,0,1590315
galEp3,0.3333333333333333,2,2,TTTGCTGATGAGTATGAGTC,0,1583268
galEp3,0.3333333333333333,2,2,TTTGCTCCGCCACGTCTGTA,0,1580187
galEp3,0.3333333333333333,2,2,TTTGCCCGTGGGGGCTATTA,0,1587026
galEp3,0.3333333333333333,2,2,TTTGCAAGAATCCAACTCGA,0,1591850
galEp3,0.3333333333333333,2,2,TTTGATAACACGTAGACATA,0,1571357
galEp3,0.3333333333333333,2,2,TTTCTGGAGTATCGAGTGTG,0,1565870
galEp3,0.3333333333333333,2,2,TTTCTGAAGTGCTAAATTCA,0,1594072
galEp3,0.3333333333333333,2,2,TTTCGTTGAGAACGAAAAAT,0,1576807
galEp3,0.3333333333333333,2,2,TTTCGTATGCAAACCTGGAC,0,1550044
galEp3,0.3333333333333333,2,2,TTTCGGAGATGGGATTTTTA,0,1590638
galEp3,0.3333333333333333,2,2,TTTCGACACAAGCTATTAGT,0,1592301
galEp3,0.3333333333333333,2,2,TTTCCCTACCCCACTTAACC,0,1588905
galEp3,0.3333333333333333,2,2,TTTCCACAGTACCATTACGC,0,1553870
galEp3,0.3333333333333333,2,2,TTTATTGGGGAGATTTTCTG,0,1565880
galEp3,0.3333333333333333,2,2,TTTATCATCCTGCTCCAAAA,0,1569582
galEp3,0.3333333333333333,2,2,TTTATAAACCCGTACACTGC,0,1589711
galEp3,0.3333333333333333,2,2,TTTAGTTGTGACACGGATTG,0,1590119
galEp3,0.3333333333333333,2,2,TTTAGGATAGAATGTGCGGT,0,1586148
galEp3,0.3333333333333333,2,2,TTTACGAAGATGCGTTGGCA,0,1570023
galEp3,0.3333333333333333,2,2,TTTAACAAAGGTTATTCTGA,0,1546716
galEp3,0.3333333333333333,2,2,TTGTTGCCCCCCGCGGCACA,0,1588921
galEp3,0.3333333333333333,2,2,TTGTCGTCGTTCAGTGGCTA,0,1558876
galEp3,0.3333333333333333,2,2,TTGTCAACGTACAAGGACTA,0,1550908
galEp3,0.3333333333333333,2,2,TTGTAATTCATAATGATTGG,0,1567489
galEp3,0.3333333333333333,2,2,TTGGTCCAGTTGTCGCCGCA,0,1573751
galEp3,0.3333333333333333,2,2,TTGGGACCTCATCTGGTTTA,0,1590662
galEp3,0.3333333333333333,2,2,TTGGCGGTCAGTTGCTAGCA,0,1574671
galEp3,0.3333333333333333,2,2,TTGGCGCCACCAGCAAATCT,0,1550816
galEp3,0.3333333333333333,2,2,TTGGATTAACACGTCTCAGG,0,1588601
galEp3,0.3333333333333333,2,2,TTGCTCCCGATTAGCGCAGG,0,1572104
galEp3,0.3333333333333333,2,2,TTGCTAGAGCGCAATCAGGC,0,1562925
galEp3,0.3333333333333333,2,2,TTGCTAAGGGCTTTTACCAT,0,1558664
galEp3,0.3333333333333333,2,2,TTGCGGATCATCATGAACTT,0,1591965
galEp3,0.3333333333333333,2,2,TTGCGAACTGTTCATTGAGG,0,1574529
galEp3,0.3333333333333333,2,2,TTGCATCTTATAGCCGCAAA,0,1594601
galEp3,0.3333333333333333,2,2,TTGATTTCATATGGGGACTA,0,1550552
galEp3,0.3333333333333333,2,2,TTGAGGTTGCGGCACCCCCT,0,1568988
galEp3,0.3333333333333333,2,2,TTGAGGCCTTTGCGCCAGTG,0,1582879
galEp3,0.3333333333333333,2,2,TTGAGGAATGAAAAGTGGGG,0,1570186
galEp3,0.3333333333333333,2,2,TTGACCAAATTTCCGGCGTA,0,1583896
galEp3,0.3333333333333333,2,2,TTGAATACCTTTGCCGATTT,0,1572740
galEp3,0.3333333333333333,2,2,TTGAAAGTCATTTTGGGTGT,0,1582567
galEp3,0.3333333333333333,2,2,TTCTGGTCATAAAATCGGAT,0,1586998
galEp3,0.3333333333333333,2,2,TTCTGAGTCCAGGCAGTGAA,0,1580852
galEp3,0.3333333333333333,2,2,TTCTGAACGATTCGGGAAGT,0,1558489
galEp3,0.3333333333333333,2,2,TTCTCTTATTTCATGGACCA,0,1591082
galEp3,0.3333333333333333,2,2,TTCTCTGCTTGGTTTGAGTT,0,1563500
galEp3,0.3333333333333333,2,2,TTCTCCTCCCGCTTTTACAT,0,1557169
galEp3,0.3333333333333333,2,2,TTCTCAACGAAGTAGTCAAT,0,1580145
galEp3,0.3333333333333333,2,2,TTCTAAGGTGCGGGGCGAAT,0,1573040
galEp3,0.3333333333333333,2,2,TTCGTTAAGGCTGACTCCTT,0,1552547
galEp3,0.3333333333333333,2,2,TTCGGCCTCCAAAGTCCAAA,0,1586609
galEp3,0.3333333333333333,2,2,TTCGCCCGCAACTAGGATAC,0,1571894
galEp3,0.3333333333333333,2,2,TTCGCCCGATTAAGGTGTTG,0,1569242
galEp3,0.3333333333333333,2,2,TTCGAGTTGTAGGGCGCCGT,0,1555016
galEp3,0.3333333333333333,2,2,TTCCGTGTAAATTTATCGTA,0,1550684
galEp3,0.3333333333333333,2,2,TTCCGAGAATAATTCGGTGC,0,1585693
galEp3,0.3333333333333333,2,2,TTCCGAACGGCCAGTGTCAA,0,1583098
galEp3,0.3333333333333333,2,2,TTCCCTCAGCTATCACGCGC,0,1552410
galEp3,0.3333333333333333,2,2,TTCCCCACTGAGGAGTTAAA,0,1588879
galEp3,0.3333333333333333,2,2,TTCCACGACTCATTCAAGTG,0,1550015
galEp3,0.3333333333333333,2,2,TTCCACCGTGGACTCCTACT,0,1562669
galEp3,0.3333333333333333,2,2,TTCATGGACAAGACCTAGTG,0,1563751
galEp3,0.3333333333333333,2,2,TTCAGGCCGGGACATAATCG,0,1578506
galEp3,0.3333333333333333,2,2,TTCAGATGCAAGTATACCGT,0,1552206
galEp3,0.3333333333333333,2,2,TTCACATATGGATGGCTGGT,0,1564686
galEp3,0.3333333333333333,2,2,TTCAAAGGCCGATCGTAACT,0,1593552
galEp3,0.3333333333333333,2,2,TTCAAACGTGAAGCAAGGGG,0,1592160
galEp3,0.3333333333333333,2,2,TTATTTTCAACCTAATGAGC,0,1564779
galEp3,0.3333333333333333,2,2,TTATTTCTTCAAGGCGTTAG,0,1576506
galEp3,0.3333333333333333,2,2,TTATGCCGCGTCTAGCACGG,0,1552044
galEp3,0.3333333333333333,2,2,TTATGAGTAGCACGTAACGC,0,1592279
galEp3,0.3333333333333333,2,2,TTATGAAATCTAGTAGTTAG,0,1578596
galEp3,0.3333333333333333,2,2,TTATCGTTATCACAGCTCGG,0,1557653
galEp3,0.3333333333333333,2,2,TTATAGTACAGACCTCGCTA,0,1551789
galEp3,0.3333333333333333,2,2,TTATAATGCCCTTCTTTTCA,0,1553609
galEp3,0.3333333333333333,2,2,TTAGTTCGTCGGTACACCCC,0,1559500
galEp3,0.3333333333333333,2,2,TTAGGCCACTCGTGAAGGAA,0,1585168
galEp3,0.3333333333333333,2,2,TTAGACCGGCTCCAGCGCAA,0,1574719
galEp3,0.3333333333333333,2,2,TTACTAGCTACCTTCAACAG,0,1572662
galEp3,0.3333333333333333,2,2,TTACGAGCTGTACACAGCAG,0,1577202
galEp3,0.3333333333333333,2,2,TTACACTCCAGGAGAGGTTA,0,1591537
galEp3,0.3333333333333333,2,2,TTAATCGGGCTCTAGTTTTG,0,1580800
galEp3,0.3333333333333333,2,2,TTAATACATGTATCTAGTAA,0,1552091
galEp3,0.3333333333333333,2,2,TTAAGCACAGTATCGGTTTC,0,1564996
galEp3,0.3333333333333333,2,2,TTAAAGTCTTGGCCTAGCAA,0,1573057
galEp3,0.3333333333333333,2,2,TTAAAGATAGATCGAAAAGG,0,1579108
galEp3,0.3333333333333333,2,2,TGTTTTTAATGCTCACACGA,0,1581309
galEp3,0.3333333333333333,2,2,TGTTTGACGGTTTAGTACAG,0,1583940
galEp3,0.3333333333333333,2,2,TGTTTCGCGTTTGAGCGAGT,0,1556479
galEp3,0.3333333333333333,2,2,TGTTTATTAACCGTATCTCT,0,1587216
galEp3,0.3333333333333333,2,2,TGTTTACGCCGAAGTTCCGT,0,1582909
galEp3,0.3333333333333333,2,2,TGTTGTCCCGGTCGGTGTAG,0,1566539
galEp3,0.3333333333333333,2,2,TGTTCAGCTTTTCGGCGCCC,0,1594007
galEp3,0.3333333333333333,2,2,TGTGTATTTGCAGCGTTTCA,0,1581940
galEp3,0.3333333333333333,2,2,TGTGTAAACCGAACCCAGAC,0,1568211
galEp3,0.3333333333333333,2,2,TGTGGCTTTGCTTGATTAAG,0,1563494
galEp3,0.3333333333333333,2,2,TGTGGAGAAGCTTGTGCGAG,0,1565666
galEp3,0.3333333333333333,2,2,TGTGCTTTATAGTGCCCCCT,0,1549225
galEp3,0.3333333333333333,2,2,TGTGCCACACCAACCCATAG,0,1575979
galEp3,0.3333333333333333,2,2,TGTCTTTGCATGCGTTCACC,0,1578781
galEp3,0.3333333333333333,2,2,TGTCCGCAGGCGTGTAGTGT,0,1577873
galEp3,0.3333333333333333,2,2,TGTCCACTTGGAGCAAATTG,0,1581291
galEp3,0.3333333333333333,2,2,TGTCAGTAGATGCGTAGTTT,0,1579070
galEp3,0.3333333333333333,2,2,TGTACCGTCAGCACGGTTTT,0,1591394
galEp3,0.3333333333333333,2,2,TGTAATCAAGGAGTGAGGAC,0,1566838
galEp3,0.3333333333333333,2,2,TGGTTCGCAATATATGGCGA,0,1557847
galEp3,0.3333333333333333,2,2,TGGTTCCCCAGGATTCGTAA,0,1575336
galEp3,0.3333333333333333,2,2,TGGTGGTATCATTAAAGGCT,0,1553553
galEp3,0.3333333333333333,2,2,TGGTGCACTACGTAATTAGA,0,1566544
galEp3,0.3333333333333333,2,2,TGGTCTTACTGACAAATGCC,0,1558572
galEp3,0.3333333333333333,2,2,TGGTCTCCTGAGACACGGTT,0,1552473
galEp3,0.3333333333333333,2,2,TGGTCCGCTTCCTTAACAGA,0,1551833
galEp3,0.3333333333333333,2,2,TGGTCACCTGGAGGTACCAG,0,1567612
galEp3,0.3333333333333333,2,2,TGGGTGGGTACTGATCTAGG,0,1567228
galEp3,0.3333333333333333,2,2,TGGGTGCCGGGTCAGGACGC,0,1571518
galEp3,0.3333333333333333,2,2,TGGGTCTCAAAATCGCGATT,0,1565038
galEp3,0.3333333333333333,2,2,TGGGTAGTGCTTCTAACTGA,0,1549157
galEp3,0.3333333333333333,2,2,TGGGCCTTAGGCCGCCTTGC,0,1564693
galEp3,0.3333333333333333,2,2,TGGGCCCCCTTGGACACCGT,0,1586874
galEp3,0.3333333333333333,2,2,TGGGACGTCGGTCCCCATGC,0,1585614
galEp3,0.3333333333333333,2,2,TGGCTAGATGTCGGGCTCGG,0,1557781
galEp3,0.3333333333333333,2,2,TGGCAAAGGGAACTTTTATT,0,1567201
galEp3,0.3333333333333333,2,2,TGGACCTCGTGTCGGACTGT,0,1553170
galEp3,0.3333333333333333,2,2,TGGAAGAAACCCGGCAGCCG,0,1568954
galEp3,0.3333333333333333,2,2,TGCTTTTAGGTTTAGACTGC,0,1553565
galEp3,0.3333333333333333,2,2,TGCTTCGGCAATCGGTCCCA,0,1577486
galEp3,0.3333333333333333,2,2,TGCTCGGCGGTAAAGTTCTT,0,1581328
galEp3,0.3333333333333333,2,2,TGCTCCTGGTAGATAAGGTC,0,1578688
galEp3,0.3333333333333333,2,2,TGCTATGATTACAGCGAGAT,0,1576873
galEp3,0.3333333333333333,2,2,TGCTAGCGTGGAGTGCCAAT,0,1590220
galEp3,0.3333333333333333,2,2,TGCGTCTAGTTTGTCGCTGC,0,1570597
galEp3,0.3333333333333333,2,2,TGCGCGTAAGTTTGCCCGCA,0,1582886
galEp3,0.3333333333333333,2,2,TGCGACCAACTAGCTTGGTG,0,1585118
galEp3,0.3333333333333333,2,2,TGCCTTCGCACACGGACACT,0,1579969
galEp3,0.3333333333333333,2,2,TGCCTCGATCATACGTTAGA,0,1595045
galEp3,0.3333333333333333,2,2,TGCCGTATACCAGAAATACC,0,1571281
galEp3,0.3333333333333333,2,2,TGCCGATTCTTAAAGTAACA,0,1571093
galEp3,0.3333333333333333,2,2,TGCCGAACACGTTGCGCCTT,0,1554801
galEp3,0.3333333333333333,2,2,TGCCCTGGGTCATTTGGTAT,0,1578573
galEp3,0.3333333333333333,2,2,TGCCAGGCATTAGGGGCTGC,0,1556537
galEp3,0.3333333333333333,2,2,TGCCAACAGGTCACAACTGC,0,1548482
galEp3,0.3333333333333333,2,2,TGCATTAGATAAAGGTAAAC,0,1565086
galEp3,0.3333333333333333,2,2,TGCATTACAGGGCCGACTGT,0,1568519
galEp3,0.3333333333333333,2,2,TGCACGCGCGGCAGAGAGCT,0,1570767
galEp3,0.3333333333333333,2,2,TGCACGAACGTGTAGTAACT,0,1583134
galEp3,0.3333333333333333,2,2,TGCAAAACCATACGGTCTAT,0,1589799
galEp3,0.3333333333333333,2,2,TGATTGGACATGGGGCTGGG,0,1588829
galEp3,0.3333333333333333,2,2,TGATTGGAAATAATAGCCCG,0,1556114
galEp3,0.3333333333333333,2,2,TGATTCGAAGGGAATCAATG,0,1568206
galEp3,0.3333333333333333,2,2,TGATGGGCTTGAGCCGCGAA,0,1590796
galEp3,0.3333333333333333,2,2,TGATCTGAACTCCCCAGATA,0,1557389
galEp3,0.3333333333333333,2,2,TGATCCTGACTTATGTGCGA,0,1584888
galEp3,0.3333333333333333,2,2,TGATAACCTGGAACTCAGAC,0,1554855
galEp3,0.3333333333333333,2,2,TGAGTTAACTAGCGATTTAG,0,1586735
galEp3,0.3333333333333333,2,2,TGAGTGTACCGGAGTCTTTT,0,1583739
galEp3,0.3333333333333333,2,2,TGAGTGATGGAGAGCGAATC,0,1579030
galEp3,0.3333333333333333,2,2,TGAGCGACAATGCTAAGGAT,0,1562095
galEp3,0.3333333333333333,2,2,TGAGCCGAGTGTCATCCATC,0,1568281
galEp3,0.3333333333333333,2,2,TGAGAGAGAATCACGCTTTA,0,1555619
galEp3,0.3333333333333333,2,2,TGACTGGATTTCCCATCGCA,0,1571467
galEp3,0.3333333333333333,2,2,TGACGGTTCATACCGCTAAG,0,1592448
galEp3,0.3333333333333333,2,2,TGACGCAATTCCCATTCACT,0,1567800
galEp3,0.3333333333333333,2,2,TGACAGTGTCTACCTACGTA,0,1574456
galEp3,0.3333333333333333,2,2,TGACACTCTACGTCTGGCTA,0,1572078
galEp3,0.3333333333333333,2,2,TGACACGGGATGGCTTACGT,0,1592230
galEp3,0.3333333333333333,2,2,TGACAATTTGTAAATAGACG,0,1549124
galEp3,0.3333333333333333,2,2,TGAAGTTGAATTGTGCTAAG,0,1563506
galEp3,0.3333333333333333,2,2,TGAAGGATCGTGCTTCACGA,0,1558062
galEp3,0.3333333333333333,2,2,TGAACTTAGTAGATTCTTCG,0,1556972
galEp3,0.3333333333333333,2,2,TGAACGCATGAGTCACCCCT,0,1562787
galEp3,0.3333333333333333,2,2,TCTTTTAAGTTTTGAATATC,0,1586791
galEp3,0.3333333333333333,2,2,TCTTTGCCTCGGGTCAGTCA,0,1554472
galEp3,0.3333333333333333,2,2,TCTTGGTACATTAATCTTGT,0,1561808
galEp3,0.3333333333333333,2,2,TCTTCCCCCGACTGTGGATT,0,1578913
galEp3,0.3333333333333333,2,2,TCTTCCCCACTCCCTACTTT,0,1569727
galEp3,0.3333333333333333,2,2,TCTTCATCACGTGAATATTG,0,1574432
galEp3,0.3333333333333333,2,2,TCTTATCAGTGCGGGACATC,0,1591440
galEp3,0.3333333333333333,2,2,TCTGCTCGCTCTCATGAATT,0,1551306
galEp3,0.3333333333333333,2,2,TCTGAATCACGGTTTTGGTC,0,1573585
galEp3,0.3333333333333333,2,2,TCTGAAAGTGTGGTATACCA,0,1584149
galEp3,0.3333333333333333,2,2,TCTCTGGCCGAGTGAGGCGA,0,1560087
galEp3,0.3333333333333333,2,2,TCTCTCAGATAGCGGCCTTG,0,1576330
galEp3,0.3333333333333333,2,2,TCTCGAGAGGACACGGACAC,0,1578748
galEp3,0.3333333333333333,2,2,TCTCCGGTGATGCAAAGGCT,0,1559693
galEp3,0.3333333333333333,2,2,TCTCCCCAAACGGAATACAA,0,1565843
galEp3,0.3333333333333333,2,2,TCTATTTTGCGGATCTGTGG,0,1590952
galEp3,0.3333333333333333,2,2,TCTATTTCGCGCGTAAAATT,0,1589441
galEp3,0.3333333333333333,2,2,TCTACGGGTTTCCCGCTAAA,0,1559359
galEp3,0.3333333333333333,2,2,TCTAAGCATCAATGGTTGTT,0,1578877
galEp3,0.3333333333333333,2,2,TCTAAAAACGCTTGGTCTCA,0,1562441
galEp3,0.3333333333333333,2,2,TCGTTTGCGCAAGTGGGGAA,0,1559753
galEp3,0.3333333333333333,2,2,TCGTTCAGCTGCATAAGTTC,0,1559521
galEp3,0.3333333333333333,2,2,TCGTGTCTAATTGACCCTGC,0,1577994
galEp3,0.3333333333333333,2,2,TCGTGCCAACTCGAGAGGTG,0,1548271
galEp3,0.3333333333333333,2,2,TCGTGATTTTATACACCTGA,0,1550578
galEp3,0.3333333333333333,2,2,TCGTGAAGGTGCACGAGACC,0,1555575
galEp3,0.3333333333333333,2,2,TCGGTTGTGAAGGAAAGGTA,0,1547338
galEp3,0.3333333333333333,2,2,TCGGGCAATCGGCGTGTTGG,0,1560496
galEp3,0.3333333333333333,2,2,TCGGCTAAGGGAAGCGCAAT,0,1580318
galEp3,0.3333333333333333,2,2,TCGGCCTACCAGTTTAATGT,0,1578103
galEp3,0.3333333333333333,2,2,TCGGCATAGCCGGTACGTGC,0,1592412
galEp3,0.3333333333333333,2,2,TCGCTTGGTGAGTTAGGACC,0,1562629
galEp3,0.3333333333333333,2,2,TCGCGTGATTAACACAAGAG,0,1565592
galEp3,0.3333333333333333,2,2,TCGCGAATAAATTGGCCGCT,0,1576701
galEp3,0.3333333333333333,2,2,TCGCAGTTCGAACTCCAGTT,0,1558583
galEp3,0.3333333333333333,2,2,TCGCACCTATGCACTGTACG,0,1559257
galEp3,0.3333333333333333,2,2,TCGATTGGGGTAGCACTAGA,0,1569787
galEp3,0.3333333333333333,2,2,TCGATTGGATACTCAGCCTC,0,1580687
galEp3,0.3333333333333333,2,2,TCGACCTGTGATTCGTTTTT,0,1573729
galEp3,0.3333333333333333,2,2,TCGAATACGGTGGACCCTCT,0,1578517
galEp3,0.3333333333333333,2,2,TCCTTAGGTTATGACGAGGG,0,1558955
galEp3,0.3333333333333333,2,2,TCCTGCATGGTAGCGGATCG,0,1578084
galEp3,0.3333333333333333,2,2,TCCTCTCGGACCTATAGGCC,0,1568138
galEp3,0.3333333333333333,2,2,TCCTAAAGATCGGGCTGTGG,0,1552456
galEp3,0.3333333333333333,2,2,TCCGTTCGTTACGCGATATC,0,1573451
galEp3,0.3333333333333333,2,2,TCCGTGGCGATTTAACCTCT,0,1555207
galEp3,0.3333333333333333,2,2,TCCGGGTGTGAGCCCGCATC,0,1586237
galEp3,0.3333333333333333,2,2,TCCGGGCTCGAGAGCGCACC,0,1587130
galEp3,0.3333333333333333,2,2,TCCGGGCACAGTCAAAACAA,0,1577051
galEp3,0.3333333333333333,2,2,TCCGGCTATCTAGTCAGGGT,0,1565435
galEp3,0.3333333333333333,2,2,TCCGCTTCGTAGCCTTTTTT,0,1553535
galEp3,0.3333333333333333,2,2,TCCGCAGGAATTGCAGTGAG,0,1580017
galEp3,0.3333333333333333,2,2,TCCGAGAGCGGAGTACCAGC,0,1549011
galEp3,0.3333333333333333,2,2,TCCGAACCTACTGAATGGGT,0,1591759
galEp3,0.3333333333333333,2,2,TCCCTGCGCGGCGATTAGTG,0,1554190
galEp3,0.3333333333333333,2,2,TCCCGCTTGCGGGGTTGCCA,0,1573766
galEp3,0.3333333333333333,2,2,TCCCCACCGTAGATATCTTT,0,1558109
galEp3,0.3333333333333333,2,2,TCCAGGGCGGGGGGTGCTCG,0,1565693
galEp3,0.3333333333333333,2,2,TCCAGCTCGCATTCTTGAGA,0,1562151
galEp3,0.3333333333333333,2,2,TCCAGAAGGAGTTAGAGTGG,0,1556779
galEp3,0.3333333333333333,2,2,TCCACGGTTATTTGCGACTG,0,1591533
galEp3,0.3333333333333333,2,2,TCCACCCATCCACCTGATTC,0,1564787
galEp3,0.3333333333333333,2,2,TCCAATTGGGCTTTGTTACG,0,1576951
galEp3,0.3333333333333333,2,2,TCCAATTCCCGTAACTTGAA,0,1575142
galEp3,0.3333333333333333,2,2,TCCAAGTACTACGTACTCCT,0,1561146
galEp3,0.3333333333333333,2,2,TCCAACGAAAATTCGTCCGA,0,1550692
galEp3,0.3333333333333333,2,2,TCATTGGAGTGGAGTCCCGA,0,1584344
galEp3,0.3333333333333333,2,2,TCATTAGCATATACAACTCA,0,1567051
galEp3,0.3333333333333333,2,2,TCATGGGCTCCTCGAGTAAG,0,1584776
galEp3,0.3333333333333333,2,2,TCATGCAGGCGACCCCTTTT,0,1578363
galEp3,0.3333333333333333,2,2,TCATGAGGTGGCCCCCAAAT,0,1559801
galEp3,0.3333333333333333,2,2,TCATCTGACAGTTTAGCTGT,0,1566432
galEp3,0.3333333333333333,2,2,TCATCCCGTTCCAGGGCTCG,0,1550408
galEp3,0.3333333333333333,2,2,TCATAGGTAGGGTGTGGATT,0,1565419
galEp3,0.3333333333333333,2,2,TCATACCAAGGGAGTTTGTA,0,1561942
galEp3,0.3333333333333333,2,2,TCAGTGAGCCTCGGAAAGTG,0,1560797
galEp3,0.3333333333333333,2,2,TCAGGGTTATCCCCTCTAGA,0,1587806
galEp3,0.3333333333333333,2,2,TCACTCCCGGGAACTTATGT,0,1580639
galEp3,0.3333333333333333,2,2,TCACGGTCCCCATAGGGAAA,0,1551182
galEp3,0.3333333333333333,2,2,TCACCGCCACGTCACTCAAA,0,1584834
galEp3,0.3333333333333333,2,2,TCACCCCCTTCCTGCCGCCT,0,1560289
galEp3,0.3333333333333333,2,2,TCACCAGACGGACAAATGCA,0,1583449
galEp3,0.3333333333333333,2,2,TCACCAGACCGCTTGTCTTG,0,1565102
galEp3,0.3333333333333333,2,2,TCAATGGTAGAACGTCCCCT,0,1564747
galEp3,0.3333333333333333,2,2,TCAAGTCAATCTCTTTGTTG,0,1561104
galEp3,0.3333333333333333,2,2,TCAAGGTCTTTCAAATGGGT,0,1562894
galEp3,0.3333333333333333,2,2,TCAAAGTTGTTGTGGAGCTA,0,1583827
galEp3,0.3333333333333333,2,2,TATTTTTGTCCATCCCCGGG,0,1554715
galEp3,0.3333333333333333,2,2,TATTTATGGCCCCTTTTATC,0,1576217
galEp3,0.3333333333333333,2,2,TATTTAAGCCTTTCGCGGTA,0,1576549
galEp3,0.3333333333333333,2,2,TATTGTGAGAAGACTGTGGA,0,1575867
galEp3,0.3333333333333333,2,2,TATTCTGTCAAGGCCTCCCA,0,1582186
galEp3,0.3333333333333333,2,2,TATTCTAATGGCTTCGTAAC,0,1576137
galEp3,0.3333333333333333,2,2,TATTCGGCGGACCGATAATC,0,1573545
galEp3,0.3333333333333333,2,2,TATTCCTGAAACGGCGACGT,0,1574068
galEp3,0.3333333333333333,2,2,TATTACCGGCCTAGGGGTGA,0,1564850
galEp3,0.3333333333333333,2,2,TATGTGTTCCGTAAGTCGCG,0,1562720
galEp3,0.3333333333333333,2,2,TATGGTTCGGACGACTGTAA,0,1575715
galEp3,0.3333333333333333,2,2,TATGCTGTTCCCTGTGCGGA,0,1587299
galEp3,0.3333333333333333,2,2,TATGCTGGAATAGTTCGCCA,0,1567275
galEp3,0.3333333333333333,2,2,TATGCTCCTGTAGTCCTGCA,0,1568653
galEp3,0.3333333333333333,2,2,TATGCCATGGTGTCGGGAGA,0,1562006
galEp3,0.3333333333333333,2,2,TATGATGGGTAAAAAACTCA,0,1578336
galEp3,0.3333333333333333,2,2,TATGAAATGTAGTGTAACTT,0,1553915
galEp3,0.3333333333333333,2,2,TATCTTCTTAGAGTCTAGCG,0,1547392
galEp3,0.3333333333333333,2,2,TATCTATGACAGAACCACGC,0,1590803
galEp3,0.3333333333333333,2,2,TATCTACGTAGCGCGGATGA,0,1590872
galEp3,0.3333333333333333,2,2,TATCCACGGTGATATTCAAG,0,1585817
galEp3,0.3333333333333333,2,2,TATATGTTAATGTGCTCTGA,0,1582506
galEp3,0.3333333333333333,2,2,TATATGGTTCTAGATTTTTA,0,1560410
galEp3,0.3333333333333333,2,2,TATAGTGCCCCATCTGGTGT,0,1548570
galEp3,0.3333333333333333,2,2,TATACGCGGACGACGCGGTG,0,1549573
galEp3,0.3333333333333333,2,2,TATAAACTCCCAAGAGGAAT,0,1555531
galEp3,0.3333333333333333,2,2,TAGTGCACCCGATGGGCCAG,0,1575326
galEp3,0.3333333333333333,2,2,TAGGTGGGGGCTACCAATGG,0,1547423
galEp3,0.3333333333333333,2,2,TAGGGGTCGCCGTACCAGCA,0,1560341
galEp3,0.3333333333333333,2,2,TAGGCCAATAATCGCCAAAG,0,1574678
galEp3,0.3333333333333333,2,2,TAGGCATAACACAAAAGCAT,0,1593708
galEp3,0.3333333333333333,2,2,TAGGCAGTGCATATTGAACG,0,1553532
galEp3,0.3333333333333333,2,2,TAGGATCACCCGCAAAGAAT,0,1586781
galEp3,0.3333333333333333,2,2,TAGGAGTATAAGCTCGTCAT,0,1575859
galEp3,0.3333333333333333,2,2,TAGCGCGCTGCACGTGATGG,0,1578923
galEp3,0.3333333333333333,2,2,TAGCGATCGCTTCCATACCT,0,1549818
galEp3,0.3333333333333333,2,2,TAGCCTATATGTGCATTTTC,0,1554555
galEp3,0.3333333333333333,2,2,TAGCCCGAGTAGACACACTA,0,1570021
galEp3,0.3333333333333333,2,2,TAGCATTGACGTGAGGCCGT,0,1580939
galEp3,0.3333333333333333,2,2,TAGCAGTATTCGGAGGCTAC,0,1549164
galEp3,0.3333333333333333,2,2,TAGATCGCAAGTGGTTAGGG,0,1564547
galEp3,0.3333333333333333,2,2,TAGATATTTCGGAGTCATCT,0,1549339
galEp3,0.3333333333333333,2,2,TAGAGAGGTATACCTGAGGT,0,1576130
galEp3,0.3333333333333333,2,2,TAGAGAGATCTTTACCCCCC,0,1571234
galEp3,0.3333333333333333,2,2,TAGAATTGAGAGCTCCTGAA,0,1570146
galEp3,0.3333333333333333,2,2,TAGAACAACATCCCCGACTC,0,1581740
galEp3,0.3333333333333333,2,2,TAGAAACCGGATACCGTTAT,0,1588279
galEp3,0.3333333333333333,2,2,TACTGCGCACGTCTTTATTA,0,1568864
galEp3,0.3333333333333333,2,2,TACTGCCTATCGGGGGCCCA,0,1567752
galEp3,0.3333333333333333,2,2,TACTCAGTCGGTCGGAAAGC,0,1573924
galEp3,0.3333333333333333,2,2,TACTCAACATCGCCAATTTG,0,1586510
galEp3,0.3333333333333333,2,2,TACTACGCAATACAACCGCT,0,1594518
galEp3,0.3333333333333333,2,2,TACGACCGGGCCTCCCAGGG,0,1570019
galEp3,0.3333333333333333,2,2,TACCGGATACAGATCCCGAT,0,1594895
galEp3,0.3333333333333333,2,2,TACCGCTCGGCAGGAGAGTT,0,1555591
galEp3,0.3333333333333333,2,2,TACCCTTCTCGATATCTCAA,0,1555183
galEp3,0.3333333333333333,2,2,TACCCTGATAAAGATACCGG,0,1549387
galEp3,0.3333333333333333,2,2,TACCCGTCGTAGAAAGCACC,0,1582771
galEp3,0.3333333333333333,2,2,TACCCATCACCATTCTTTTC,0,1594733
galEp3,0.3333333333333333,2,2,TACCATTTGGGAGAATATCG,0,1565831
galEp3,0.3333333333333333,2,2,TACCATACGTTCCACCCGCG,0,1549612
galEp3,0.3333333333333333,2,2,TACCAGGGGCCAGCTAGTCG,0,1586976
galEp3,0.3333333333333333,2,2,TACATTTACCTCATAGGCGA,0,1581549
galEp3,0.3333333333333333,2,2,TACATGTGTGAGGGTATTGA,0,1584650
galEp3,0.3333333333333333,2,2,TACATATCTGCTCATAGAAT,0,1571214
galEp3,0.3333333333333333,2,2,TACAGAGAAAGAAAGGGATC,0,1562545
galEp3,0.3333333333333333,2,2,TAATGATGGGTTTAAGGAAC,0,1561482
galEp3,0.3333333333333333,2,2,TAAGGTTAGGGTAGATACAG,0,1549547
galEp3,0.3333333333333333,2,2,TAAGGTGCAATGCTCTTAGG,0,1549737
galEp3,0.3333333333333333,2,2,TAAGCCCCCGTTGTAGAACG,0,1576363
galEp3,0.3333333333333333,2,2,TAAGACCATTGTACATACTT,0,1549200
galEp3,0.3333333333333333,2,2,TAAGAATCGCTGCATTCGTA,0,1593750
galEp3,0.3333333333333333,2,2,TAACTTCTTTCGCACGGAGT,0,1560414
galEp3,0.3333333333333333,2,2,TAACTCAATGCCCAACTGCC,0,1572135
galEp3,0.3333333333333333,2,2,TAACGTCCGCGCGACTGCAA,0,1562200
galEp3,0.3333333333333333,2,2,TAACGAAGGTCCGCTAGTCA,0,1592575
galEp3,0.3333333333333333,2,2,TAACCGGGCCTTCATCACGA,0,1569416
galEp3,0.3333333333333333,2,2,TAACCCATAAGCGTACTGTG,0,1547296
galEp3,0.3333333333333333,2,2,TAACCATGGTTATCTAGGTC,0,1562522
galEp3,0.3333333333333333,2,2,TAACATGTGGCAAAGCGGTT,0,1572541
galEp3,0.3333333333333333,2,2,TAACATGCGACCAAGAACAC,0,1547795
galEp3,0.3333333333333333,2,2,TAAAGCGCCTTGCCTAACCA,0,1576237
galEp3,0.3333333333333333,2,2,TAAACGGTCCTAACAGTTAG,0,1584750
galEp3,0.3333333333333333,2,2,TAAACATACTCTTCAACTAA,0,1547613
galEp3,0.3333333333333333,2,2,GTTTCTTTGCTCAATGGTAT,0,1557219
galEp3,0.3333333333333333,2,2,GTTTCGTCGCATGCTATTCC,0,1559785
galEp3,0.3333333333333333,2,2,GTTTAAGTAGGAGTCGGAGA,0,1549635
galEp3,0.3333333333333333,2,2,GTTGGTAGACTGAAGACTGG,0,1562655
galEp3,0.3333333333333333,2,2,GTTGGGATGAAAGGTCCGGT,0,1589536
galEp3,0.3333333333333333,2,2,GTTGGCGAGTTAGACCTTTT,0,1593858
galEp3,0.3333333333333333,2,2,GTTGCCGCTAGTCCATTCGG,0,1582661
galEp3,0.3333333333333333,2,2,GTTGCCGACTTGAACGTAAT,0,1559152
galEp3,0.3333333333333333,2,2,GTTGATACACGTCACATATA,0,1563157
galEp3,0.3333333333333333,2,2,GTTCTTCTTTATTTTAATCT,0,1548786
galEp3,0.3333333333333333,2,2,GTTCTGACTGGCTGGTTCGA,0,1555021
galEp3,0.3333333333333333,2,2,GTTCTCCGGTATGCCTTATG,0,1555395
galEp3,0.3333333333333333,2,2,GTTCTATGAACGAGGTGCTT,0,1563712
galEp3,0.3333333333333333,2,2,GTTCTATAGTCTATGCCAAG,0,1574040
galEp3,0.3333333333333333,2,2,GTTCTAGCGCCTTTAGCCGA,0,1565667
galEp3,0.3333333333333333,2,2,GTTCGACCGCAACAAGAGCA,0,1556734
galEp3,0.3333333333333333,2,2,GTTCAAAACAACAATGTAGC,0,1549571
galEp3,0.3333333333333333,2,2,GTTATACACTGTCAACACTT,0,1589934
galEp3,0.3333333333333333,2,2,GTTAGCATCGTTGTGGCGCA,0,1546636
galEp3,0.3333333333333333,2,2,GTTACTGGAATTTAACTACA,0,1557654
galEp3,0.3333333333333333,2,2,GTTAATAAATCCGCCACCTC,0,1587246
galEp3,0.3333333333333333,2,2,GTTAAGTAGTCTCCTGCCTA,0,1569312
galEp3,0.3333333333333333,2,2,GTGTGGGTTTAGCGATTTCT,0,1559211
galEp3,0.3333333333333333,2,2,GTGGGGGTATATTGCGCTAA,0,1566116
galEp3,0.3333333333333333,2,2,GTGGGCTTAAAGATTTCTTG,0,1586147
galEp3,0.3333333333333333,2,2,GTGGGCCAGCGCAACATAGT,0,1548671
galEp3,0.3333333333333333,2,2,GTGGGCAGTACTATTACGAA,0,1547675
galEp3,0.3333333333333333,2,2,GTGCTTTAATATATTTTATG,0,1569688
galEp3,0.3333333333333333,2,2,GTGCTGTTTGTCTTAGCGCC,0,1551292
galEp3,0.3333333333333333,2,2,GTGCTAGAATCTACTGGGCT,0,1562097
galEp3,0.3333333333333333,2,2,GTGCCAGGCAGATGTAGTGC,0,1593668
galEp3,0.3333333333333333,2,2,GTGCACGCGTTGCATCTACC,0,1575852
galEp3,0.3333333333333333,2,2,GTGATAGTTGCCAAATTTCT,0,1565251
galEp3,0.3333333333333333,2,2,GTGATAACAGCTAGTAACCA,0,1571821
galEp3,0.3333333333333333,2,2,GTGAGTCGTTGTCCGCGTAT,0,1589599
galEp3,0.3333333333333333,2,2,GTGACCATTCTGTGTGTTGG,0,1582569
galEp3,0.3333333333333333,2,2,GTGACACAATATCAAGGGTT,0,1582852
galEp3,0.3333333333333333,2,2,GTGAATCAACCTCATACGTC,0,1585096
galEp3,0.3333333333333333,2,2,GTGAACGAGCCGTACCTGCC,0,1560460
galEp3,0.3333333333333333,2,2,GTCTTTTGCGGTCAATCAAA,0,1592450
galEp3,0.3333333333333333,2,2,GTCTTTTATGACTCAACGAG,0,1580066
galEp3,0.3333333333333333,2,2,GTCTTTATTTATGGCTATTA,0,1557354
galEp3,0.3333333333333333,2,2,GTCTTATTGGGGGAAACCCT,0,1565697
galEp3,0.3333333333333333,2,2,GTCTGTCCAGCATCCACCCA,0,1574570
galEp3,0.3333333333333333,2,2,GTCTGTAAGGGTGCCCGGTC,0,1581152
galEp3,0.3333333333333333,2,2,GTCTGTAACGCGCAATCTCC,0,1577186
galEp3,0.3333333333333333,2,2,GTCTAGCGCGTTGCAGTCTA,0,1556354
galEp3,0.3333333333333333,2,2,GTCTACTGTTAATCTTTCAG,0,1546634
galEp3,0.3333333333333333,2,2,GTCTAACATTAGCTGTCGGT,0,1576642
galEp3,0.3333333333333333,2,2,GTCGTCGATGCCGTCCCGTG,0,1555577
galEp3,0.3333333333333333,2,2,GTCGGGCAGGGTTGTGGTAA,0,1553251
galEp3,0.3333333333333333,2,2,GTCGCTATGTCGAGGTTTGT,0,1583529
galEp3,0.3333333333333333,2,2,GTCGCCCACAACGCTAAAGC,0,1583610
galEp3,0.3333333333333333,2,2,GTCGCAAAGGGCTCCTATTG,0,1576359
galEp3,0.3333333333333333,2,2,GTCCTTCCGTCCCGGGAGCC,0,1569212
galEp3,0.3333333333333333,2,2,GTCCCGGCTAGAGGCCAGGC,0,1593999
galEp3,0.3333333333333333,2,2,GTCCCGATATGATGTGAGCA,0,1592820
galEp3,0.3333333333333333,2,2,GTCCCCTAGAAGGACATGGT,0,1553914
galEp3,0.3333333333333333,2,2,GTCCACTTAAATTCCGCGGG,0,1553957
galEp3,0.3333333333333333,2,2,GTCATTAAGTATCTCAATGT,0,1576525
galEp3,0.3333333333333333,2,2,GTCATGGGCCAACGGAAACG,0,1573172
galEp3,0.3333333333333333,2,2,GTCACTCCTGGGATGCTAGC,0,1591540
galEp3,0.3333333333333333,2,2,GTCACCGCTCGCTCCATAAC,0,1563994
galEp3,0.3333333333333333,2,2,GTCACAGCTCCATGGGCAAA,0,1585609
galEp3,0.3333333333333333,2,2,GTCACAAAAGACAAGAAGCA,0,1549846
galEp3,0.3333333333333333,2,2,GTATTTGTACAGATCGCGCA,0,1550686
galEp3,0.3333333333333333,2,2,GTATTGTGTCATCTCGTCAA,0,1589982
galEp3,0.3333333333333333,2,2,GTATTAATGTAGGCATCGTT,0,1575781
galEp3,0.3333333333333333,2,2,GTATGTTTGGTTTACATAAA,0,1556310
galEp3,0.3333333333333333,2,2,GTATGGTTCCTCTTGAGGCT,0,1591419
galEp3,0.3333333333333333,2,2,GTATGACCGTCGTAGGTGTA,0,1567091
galEp3,0.3333333333333333,2,2,GTATCCTTCTGGCTTTCGCA,0,1555133
galEp3,0.3333333333333333,2,2,GTATATAGCTCCCCGGTCCT,0,1552105
galEp3,0.3333333333333333,2,2,GTATATAAACGCCGGTCGTG,0,1559604
galEp3,0.3333333333333333,2,2,GTATAGGGCAGTGTGGGCGC,0,1554976
galEp3,0.3333333333333333,2,2,GTATAAATAGCCCATCCGCA,0,1548268
galEp3,0.3333333333333333,2,2,GTAGTTTGGTAGGGCGACCT,0,1579291
galEp3,0.3333333333333333,2,2,GTAGTTTCCCCTGGAGGCTC,0,1565659
galEp3,0.3333333333333333,2,2,GTAGTGCCGCGCGACTAATC,0,1556061
galEp3,0.3333333333333333,2,2,GTAGCATAGATGTTATTTGC,0,1554500
galEp3,0.3333333333333333,2,2,GTAGATCCGTAACACCTACA,0,1591538
galEp3,0.3333333333333333,2,2,GTAGACGGGTGTCCTTGTAG,0,1554423
galEp3,0.3333333333333333,2,2,GTAGAACAGATTCAGAAAAA,0,1549277
galEp3,0.3333333333333333,2,2,GTACTGGTCAACGCCGATCG,0,1573911
galEp3,0.3333333333333333,2,2,GTACTGGAGTTGAAGACGAT,0,1583445
galEp3,0.3333333333333333,2,2,GTACGTGCATTCTAAGTACA,0,1554323
galEp3,0.3333333333333333,2,2,GTACGAGTCTACGTCCTGAC,0,1568809
galEp3,0.3333333333333333,2,2,GTACACGATCCTTTCACATG,0,1585670
galEp3,0.3333333333333333,2,2,GTACAACGCACGATCTTCCT,0,1594796
galEp3,0.3333333333333333,2,2,GGTTTTATGGAAGTCGGGAT,0,1550576
galEp3,0.3333333333333333,2,2,GGTTTCCACGCACCGGCAAG,0,1573948
galEp3,0.3333333333333333,2,2,GGTTTACCTAGCAATATATC,0,1552534
galEp3,0.3333333333333333,2,2,GGTTTAAGTAGTATGAATAG,0,1562596
galEp3,0.3333333333333333,2,2,GGTTGTATAGTAAAAATACT,0,1593731
galEp3,0.3333333333333333,2,2,GGTTGAGGCGGAACGGTCAT,0,1586070
galEp3,0.3333333333333333,2,2,GGTTCTTTCATTGAAGGGTC,0,1561554
galEp3,0.3333333333333333,2,2,GGTTCTGCGACGGACCTTAA,0,1581880
galEp3,0.3333333333333333,2,2,GGTTCGGGGCTACCCTTCCG,0,1579277
galEp3,0.3333333333333333,2,2,GGTTCGATATAATTAAGGAT,0,1587015
galEp3,0.3333333333333333,2,2,GGTGTGCAAATATGGCATCT,0,1563528
galEp3,0.3333333333333333,2,2,GGTGTGATTTTCGCATGAGA,0,1554762
galEp3,0.3333333333333333,2,2,GGTGTCGGTTTCTCCCGCGC,0,1573145
galEp3,0.3333333333333333,2,2,GGTGTCGGGAAGTCGAGCTG,0,1582441
galEp3,0.3333333333333333,2,2,GGTGGACGAGGGGATCACTT,0,1549166
galEp3,0.3333333333333333,2,2,GGTGCTCAAAAGAACACACT,0,1549861
galEp3,0.3333333333333333,2,2,GGTGCGCGTACGGGGTATGG,0,1570360
galEp3,0.3333333333333333,2,2,GGTGAAACATTTCTCTGGAT,0,1566727
galEp3,0.3333333333333333,2,2,GGTCGTCCCCATTCGTTGGC,0,1567149
galEp3,0.3333333333333333,2,2,GGTCCCATAATCTCGAGTTG,0,1555806
galEp3,0.3333333333333333,2,2,GGTAGGCACGGGTTTTCTCC,0,1555410
galEp3,0.3333333333333333,2,2,GGTAGCTTCTAACATTAAAT,0,1559856
galEp3,0.3333333333333333,2,2,GGTACTGTTGGACAGGGCTG,0,1567485
galEp3,0.3333333333333333,2,2,GGTACAGCGGGTTCATGGAT,0,1577341
galEp3,0.3333333333333333,2,2,GGGTTATACAATCCAGGTTT,0,1582510
galEp3,0.3333333333333333,2,2,GGGTGACGTCAGTCGGAGCT,0,1548750
galEp3,0.3333333333333333,2,2,GGGTGAACTCAGAAGGCATT,0,1573732
galEp3,0.3333333333333333,2,2,GGGTCTGCCGCCAAACTGAG,0,1562166
galEp3,0.3333333333333333,2,2,GGGTCTATACGACAGTAGTG,0,1577832
galEp3,0.3333333333333333,2,2,GGGTATCTTTTGATCATCTC,0,1555326
galEp3,0.3333333333333333,2,2,GGGTAATTATACGCGTGATT,0,1564565
galEp3,0.3333333333333333,2,2,GGGTAAGATACGACTTGGCA,0,1590368
galEp3,0.3333333333333333,2,2,GGGGTGTTTGCCCCCTCATA,0,1575885
galEp3,0.3333333333333333,2,2,GGGGTGCTAGCCGCCTTGTG,0,1548372
galEp3,0.3333333333333333,2,2,GGGGTCTGAGGCATAACGCT,0,1552471
galEp3,0.3333333333333333,2,2,GGGGTACTTCGGATCAGTCA,0,1572461
galEp3,0.3333333333333333,2,2,GGGGGTATCTCGGGTGCAGA,0,1567243
galEp3,0.3333333333333333,2,2,GGGGGTACATAACACTGGAT,0,1565600
galEp3,0.3333333333333333,2,2,GGGGGGTATAGATTACCCTG,0,1562590
galEp3,0.3333333333333333,2,2,GGGGGGAGCTCGATCTAGTC,0,1575009
galEp3,0.3333333333333333,2,2,GGGGGCGCTAATAATGCTAA,0,1587457
galEp3,0.3333333333333333,2,2,GGGGCCGCTAGGGGACGCTT,0,1588235
galEp3,0.3333333333333333,2,2,GGGGAACTATTTACGCTAAC,0,1590579
galEp3,0.3333333333333333,2,2,GGGGAAATCCATTCGCTCAA,0,1553060
galEp3,0.3333333333333333,2,2,GGGCTTAGGTCGGATGGTAC,0,1577689
galEp3,0.3333333333333333,2,2,GGGCGTTGCCACGTCTAAGT,0,1546741
galEp3,0.3333333333333333,2,2,GGGCGGTGCGGCATCGGCGA,0,1557608
galEp3,0.3333333333333333,2,2,GGGCGGATTAAGTAAATTTT,0,1581777
galEp3,0.3333333333333333,2,2,GGGCGCATGCTGTGGCGTCA,0,1569998
galEp3,0.3333333333333333,2,2,GGGCGCAAGTCTATGTGTGA,0,1570954
galEp3,0.3333333333333333,2,2,GGGCCCAGGGGCCGTTCAAG,0,1576135
galEp3,0.3333333333333333,2,2,GGGCAGGAGGCTCGGTCCAG,0,1563021
galEp3,0.3333333333333333,2,2,GGGCACTACTATTTGCGTGA,0,1551545
galEp3,0.3333333333333333,2,2,GGGATGGCACATAACCTTGG,0,1557041
galEp3,0.3333333333333333,2,2,GGGAGCCCAGAGTGCCATCC,0,1580282
galEp3,0.3333333333333333,2,2,GGGAGCATAACGATCAGGGC,0,1572582
galEp3,0.3333333333333333,2,2,GGGACCGTGTCTTAATGAAG,0,1575765
galEp3,0.3333333333333333,2,2,GGGAAGAGTCAACCCTGTAT,0,1566334
galEp3,0.3333333333333333,2,2,GGCTTGGGTATAAACTAATT,0,1567948
galEp3,0.3333333333333333,2,2,GGCTTGAACTACGGGGAGCG,0,1580175
galEp3,0.3333333333333333,2,2,GGCTGTGATTCAAGATCTTT,0,1568852
galEp3,0.3333333333333333,2,2,GGCTGGATGTGGCCATCGTT,0,1546992
galEp3,0.3333333333333333,2,2,GGCTGAATTCCGGGGGCTTG,0,1558842
galEp3,0.3333333333333333,2,2,GGCTCCGGATAAAGTTTGTA,0,1549272
galEp3,0.3333333333333333,2,2,GGCTCAGACCATAACTTACC,0,1575813
galEp3,0.3333333333333333,2,2,GGCGTGACGAGTTGACTCTC,0,1549574
galEp3,0.3333333333333333,2,2,GGCGGCTCCCACCGTCTGTA,0,1554287
galEp3,0.3333333333333333,2,2,GGCGGATTCATCCTGCAATG,0,1568290
galEp3,0.3333333333333333,2,2,GGCGCCTCCTTCAACACCTC,0,1563047
galEp3,0.3333333333333333,2,2,GGCGCCAGCCCAGTTGCCTT,0,1575391
galEp3,0.3333333333333333,2,2,GGCGCAAGTCTAATCTGACC,0,1551602
galEp3,0.3333333333333333,2,2,GGCGAGTTGCATAACAATTG,0,1570496
galEp3,0.3333333333333333,2,2,GGCGAGGCAAGGCCTCTTGG,0,1567486
galEp3,0.3333333333333333,2,2,GGCCTTACGGCGCAGGTTCG,0,1550400
galEp3,0.3333333333333333,2,2,GGCCGACGGAGTGCTCTAAT,0,1585417
galEp3,0.3333333333333333,2,2,GGCCCCGCATCCACGCCCAT,0,1556551
galEp3,0.3333333333333333,2,2,GGCATGTTCGTGGCACGGTT,0,1578195
galEp3,0.3333333333333333,2,2,GGCAGTTATGTAGTTCAGAG,0,1558370
galEp3,0.3333333333333333,2,2,GGCAGTGCGCATCAGAAGAT,0,1578507
galEp3,0.3333333333333333,2,2,GGCAGGGGGTGTAACTACAC,0,1568724
galEp3,0.3333333333333333,2,2,GGCAGATAGGTGAAGGGCGG,0,1564087
galEp3,0.3333333333333333,2,2,GGCAGACCTGAAGCCTCCAC,0,1550448
galEp3,0.3333333333333333,2,2,GGCAATACGTCGATAAATGG,0,1566706
galEp3,0.3333333333333333,2,2,GGATTTTGTTCGCTTCTCCG,0,1582650
galEp3,0.3333333333333333,2,2,GGATTACGTACCGCGAGAAA,0,1594524
galEp3,0.3333333333333333,2,2,GGATGAGATTTTAGGGCATT,0,1558962
galEp3,0.3333333333333333,2,2,GGATCGATATCGCAGGAGTT,0,1585011
galEp3,0.3333333333333333,2,2,GGATCCCGGGGAATTACTCC,0,1558023
galEp3,0.3333333333333333,2,2,GGATCAGCTGGTATCACCCT,0,1584922
galEp3,0.3333333333333333,2,2,GGATATCTGTGCAGTGTTAG,0,1561476
galEp3,0.3333333333333333,2,2,GGATAAGCCCGCCCTCCCAA,0,1549229
galEp3,0.3333333333333333,2,2,GGAGTTTGAATTTTTTAAAA,0,1585739
galEp3,0.3333333333333333,2,2,GGAGTATGGTGAAACAATTT,0,1564909
galEp3,0.3333333333333333,2,2,GGAGGTAAAACCTGACTAAA,0,1588871
galEp3,0.3333333333333333,2,2,GGAGCTTTAGGCCGGTCCCG,0,1549033
galEp3,0.3333333333333333,2,2,GGAGAATCATGTGCGGAGTT,0,1579597
galEp3,0.3333333333333333,2,2,GGAGAAGGGTCTTGGCCACC,0,1565416
galEp3,0.3333333333333333,2,2,GGAGAAAAGGCTTAGGTCGG,0,1562204
galEp3,0.3333333333333333,2,2,GGACTTGCGCATGCGTGTGA,0,1572532
galEp3,0.3333333333333333,2,2,GGACTCCATTTGCCTCCAAC,0,1575557
galEp3,0.3333333333333333,2,2,GGACGTAAGTACAGGAGAGA,0,1566504
galEp3,0.3333333333333333,2,2,GGACCTGCTAGCGCGACGAT,0,1554995
galEp3,0.3333333333333333,2,2,GGACCTCTCCTCCCTACCAC,0,1555507
galEp3,0.3333333333333333,2,2,GGACCGGACCACTGGGGTAC,0,1594851
galEp3,0.3333333333333333,2,2,GGACCGCTCCAGCGAACAAA,0,1593718
galEp3,0.3333333333333333,2,2,GGACACACCCAGGGAGTCGT,0,1563533
galEp3,0.3333333333333333,2,2,GGAATGTCGCATTTCGCCTA,0,1592712
galEp3,0.3333333333333333,2,2,GGAATAAACGACCAAAGGCA,0,1587716
galEp3,0.3333333333333333,2,2,GGAAGTGAGTCACGATTGTT,0,1593058
galEp3,0.3333333333333333,2,2,GGAAGCGAACGCTTACCGGA,0,1576641
galEp3,0.3333333333333333,2,2,GGAAGACAGCGAAGAGAGTT,0,1579247
galEp3,0.3333333333333333,2,2,GGAACTGAAACCCTTCCGTC,0,1564287
galEp3,0.3333333333333333,2,2,GGAACTATGAATCCACACCC,0,1549848
galEp3,0.3333333333333333,2,2,GGAACGGATCCAGCTCCACA,0,1553592
galEp3,0.3333333333333333,2,2,GGAACGATGTCTCCCAGCCT,0,1554432
galEp3,0.3333333333333333,2,2,GGAACAAAACAACAAGTTTT,0,1572013
galEp3,0.3333333333333333,2,2,GGAAATGTTAGAGAGAATTA,0,1551243
galEp3,0.3333333333333333,2,2,GGAAACCTCGTCTCATTATG,0,1557199
galEp3,0.3333333333333333,2,2,GCTTGTAAGTCATATAACGC,0,1566187
galEp3,0.3333333333333333,2,2,GCTTGCAGAGGACATCTCAT,0,1551700
galEp3,0.3333333333333333,2,2,GCTTCGCGTTTCCACTTGCG,0,1566613
galEp3,0.3333333333333333,2,2,GCTTATACATTGACACACAG,0,1583300
galEp3,0.3333333333333333,2,2,GCTTACGACGCGTTAACGAA,0,1580644
galEp3,0.3333333333333333,2,2,GCTTAACCCCATCCACGGAA,0,1571667
galEp3,0.3333333333333333,2,2,GCTGTCTACACAGGGCAGCC,0,1585602
galEp3,0.3333333333333333,2,2,GCTGTCGCTTCTGACACTAC,0,1555837
galEp3,0.3333333333333333,2,2,GCTGGTTTACTTTTAATTCA,0,1574252
galEp3,0.3333333333333333,2,2,GCTGGGCCGGCTCGAGATAT,0,1549521
galEp3,0.3333333333333333,2,2,GCTGCTTTTAACTCTTGTAT,0,1559108
galEp3,0.3333333333333333,2,2,GCTGCGACCGATTGGACATT,0,1567799
galEp3,0.3333333333333333,2,2,GCTGATCAGGCGGAATATTC,0,1585511
galEp3,0.3333333333333333,2,2,GCTCGAGGTCCTACCACTTT,0,1588664
galEp3,0.3333333333333333,2,2,GCTCCTACCCAGTCTACCTG,0,1592429
galEp3,0.3333333333333333,2,2,GCTCACGGTGTCGCGTGTCA,0,1576080
galEp3,0.3333333333333333,2,2,GCTCACGGTGGAGATGTCAC,0,1567781
galEp3,0.3333333333333333,2,2,GCTATTGAGGATAGGATCCT,0,1594331
galEp3,0.3333333333333333,2,2,GCTATATAATACAAGTGGGT,0,1593234
galEp3,0.3333333333333333,2,2,GCTAGGACGTAGTACGAATC,0,1552191
galEp3,0.3333333333333333,2,2,GCTAGCTACATTAATGACAG,0,1551528
galEp3,0.3333333333333333,2,2,GCTACGGTGTGGAAACCACG,0,1587053
galEp3,0.3333333333333333,2,2,GCGTTGTGTAACCCTCTGCT,0,1587701
galEp3,0.3333333333333333,2,2,GCGTTCCCTTACGTCAGGCA,0,1558474
galEp3,0.3333333333333333,2,2,GCGTTCACACTTACTCTGCA,0,1548556
galEp3,0.3333333333333333,2,2,GCGTGCTCCCTCTTTGATAT,0,1552421
galEp3,0.3333333333333333,2,2,GCGTGATACAACCATTAGGA,0,1584603
galEp3,0.3333333333333333,2,2,GCGTGAGATACTTACAAACC,0,1551319
galEp3,0.3333333333333333,2,2,GCGTCAATCCAGACGACTGC,0,1594408
galEp3,0.3333333333333333,2,2,GCGTACGGTGATAGGACGTC,0,1580562
galEp3,0.3333333333333333,2,2,GCGGGCACCTGATATTCAGT,0,1564458
galEp3,0.3333333333333333,2,2,GCGGGACTTCTTCTCGCTTC,0,1560347
galEp3,0.3333333333333333,2,2,GCGGCGACTTGGCCGGTATC,0,1585899
galEp3,0.3333333333333333,2,2,GCGGCCCGGGTGAAATGAGG,0,1553054
galEp3,0.3333333333333333,2,2,GCGGCACTCTCCGTAACTAG,0,1566763
galEp3,0.3333333333333333,2,2,GCGGAGCGAATATGGGCACG,0,1580129
galEp3,0.3333333333333333,2,2,GCGCTGGACACGGAGTTCTT,0,1560403
galEp3,0.3333333333333333,2,2,GCGCTCTGTTACGCTAGTAC,0,1580752
galEp3,0.3333333333333333,2,2,GCGCTCGATTCAGCAAGGTC,0,1561742
galEp3,0.3333333333333333,2,2,GCGCGTCTCTGCCTCGCCGC,0,1549305
galEp3,0.3333333333333333,2,2,GCGCCTTCCTGGTCGATTAC,0,1551907
galEp3,0.3333333333333333,2,2,GCGCACGCGTTAGGAAAAAC,0,1574016
galEp3,0.3333333333333333,2,2,GCGCAAAACTGGTGAATAAG,0,1576121
galEp3,0.3333333333333333,2,2,GCGATGTTTAGAAGACATGC,0,1569426
galEp3,0.3333333333333333,2,2,GCGATCTAATTCTATTGGCA,0,1577825
galEp3,0.3333333333333333,2,2,GCGATATCGGGCCAAGGTTG,0,1577681
galEp3,0.3333333333333333,2,2,GCGAGTTTCATCACTTATGG,0,1576452
galEp3,0.3333333333333333,2,2,GCGAGTCGAATGCGAGTCAG,0,1574809
galEp3,0.3333333333333333,2,2,GCGAGAACTAACTACGTTGG,0,1557217
galEp3,0.3333333333333333,2,2,GCCTGCCCCATTACGGCCCC,0,1547024
galEp3,0.3333333333333333,2,2,GCCTGAAATGCAAAGACCAC,0,1589327
galEp3,0.3333333333333333,2,2,GCCTCTTCTTATAGATGGTA,0,1565509
galEp3,0.3333333333333333,2,2,GCCTCGCTCTCCGCGACTAC,0,1578121
galEp3,0.3333333333333333,2,2,GCCTATCCGGACACAGGCGG,0,1580068
galEp3,0.3333333333333333,2,2,GCCTAACTGTGGCGGCGCCG,0,1572024
galEp3,0.3333333333333333,2,2,GCCTAACCCATGGCACCAGG,0,1555526
galEp3,0.3333333333333333,2,2,GCCGGCACACTACTGGTCTG,0,1549826
galEp3,0.3333333333333333,2,2,GCCCGCTCCAGTATGTCTAA,0,1568521
galEp3,0.3333333333333333,2,2,GCCCGCATGTGATTACGAGA,0,1569222
galEp3,0.3333333333333333,2,2,GCCCGAGGATTGGTTAGGAG,0,1583847
galEp3,0.3333333333333333,2,2,GCCCAGTGCGAGTGGGGTAT,0,1580681
galEp3,0.3333333333333333,2,2,GCCCAGGTCAGGGATCCGCA,0,1590507
galEp3,0.3333333333333333,2,2,GCCCACGGACAAGTAGGGAA,0,1566144
galEp3,0.3333333333333333,2,2,GCCAGGGTGAGCACGGGAGA,0,1547043
galEp3,0.3333333333333333,2,2,GCCACAGTCTTATGCAACCA,0,1573728
galEp3,0.3333333333333333,2,2,GCCAATTCGTTCGACACTGT,0,1576681
galEp3,0.3333333333333333,2,2,GCATTGGGGGGGGGCCGGGA,0,1552363
galEp3,0.3333333333333333,2,2,GCATTCTGTATTTCCACACC,0,1567191
galEp3,0.3333333333333333,2,2,GCATTAACAGAGGTACGGAC,0,1570622
galEp3,0.3333333333333333,2,2,GCAGTTCCCGGTATCAGTCA,0,1589465
galEp3,0.3333333333333333,2,2,GCAGTAGCCGTCCCAACATA,0,1569063
galEp3,0.3333333333333333,2,2,GCAGGACGTAGGTAGGTAAA,0,1575521
galEp3,0.3333333333333333,2,2,GCAGCTTTATTTTCGGGCGG,0,1561837
galEp3,0.3333333333333333,2,2,GCACTCATAGTACAGCATAC,0,1587090
galEp3,0.3333333333333333,2,2,GCACCGAACTATAGCCTATA,0,1588719
galEp3,0.3333333333333333,2,2,GCACCCTTACAGGTGACGTT,0,1586582
galEp3,0.3333333333333333,2,2,GCACCATCTTATGGCATTGA,0,1591773
galEp3,0.3333333333333333,2,2,GCACATGGGGCGAACTTAAG,0,1579110
galEp3,0.3333333333333333,2,2,GCACAAACCCTTTCATCCTT,0,1558605
galEp3,0.3333333333333333,2,2,GCAATTCCGAGCTTTTCACA,0,1587629
galEp3,0.3333333333333333,2,2,GCAATATCCGTCTATCCGTA,0,1563913
galEp3,0.3333333333333333,2,2,GCAAGTCAGTGAGAGAGCAG,0,1586819
galEp3,0.3333333333333333,2,2,GCAAGGTCTGATTTAAACCT,0,1578693
galEp3,0.3333333333333333,2,2,GCAAGAGCCAAGGATCGGCA,0,1568158
galEp3,0.3333333333333333,2,2,GCAACTTGGAACGGGCAACT,0,1589373
galEp3,0.3333333333333333,2,2,GCAACTTCAAATGACAAATT,0,1548780
galEp3,0.3333333333333333,2,2,GCAACTCGGTAGATCGAGCA,0,1557204
galEp3,0.3333333333333333,2,2,GCAAAGAGCTGTTCCATATC,0,1559522
galEp3,0.3333333333333333,2,2,GATTTCGTGCGCGCCTGGGC,0,1557487
galEp3,0.3333333333333333,2,2,GATTGTGGGTATCGCATCCT,0,1581125
galEp3,0.3333333333333333,2,2,GATTGCTCCCAGTCACCCCT,0,1558145
galEp3,0.3333333333333333,2,2,GATTCCCCGCTCGGCCGAAT,0,1576710
galEp3,0.3333333333333333,2,2,GATTCAACCGCGTCTGGGAG,0,1577278
galEp3,0.3333333333333333,2,2,GATGTGCAGCCCACGAACGC,0,1566810
galEp3,0.3333333333333333,2,2,GATGTATTGGGGCCAACCAG,0,1572703
galEp3,0.3333333333333333,2,2,GATGTAGTAACCAACTTTGA,0,1563034
galEp3,0.3333333333333333,2,2,GATGGTAGAGGGTGCGGTGT,0,1578015
galEp3,0.3333333333333333,2,2,GATGGTAGAAACGGCTAGTA,0,1574962
galEp3,0.3333333333333333,2,2,GATCTGAATCTGGGATGTCT,0,1592871
galEp3,0.3333333333333333,2,2,GATCTCGAAGGTCGCGAGTT,0,1553651
galEp3,0.3333333333333333,2,2,GATCTCAGTTGTAACCCAGA,0,1578243
galEp3,0.3333333333333333,2,2,GATCGACCAGCTCACCACTT,0,1592547
galEp3,0.3333333333333333,2,2,GATCATTACCAATTAGTAGA,0,1584267
galEp3,0.3333333333333333,2,2,GATCAATTTGAACCATTCAC,0,1568618
galEp3,0.3333333333333333,2,2,GATATTCGCTAGAGGCTATC,0,1589564
galEp3,0.3333333333333333,2,2,GATATCTGGGTACTCTCGCC,0,1558257
galEp3,0.3333333333333333,2,2,GATATAGATGCGGTACTGGC,0,1559747
galEp3,0.3333333333333333,2,2,GATAGAAATATGTAGCCTAG,0,1576037
galEp3,0.3333333333333333,2,2,GATACTATATAGTGTACAGA,0,1561738
galEp3,0.3333333333333333,2,2,GATAATTTGTTATACTTTGT,0,1569594
galEp3,0.3333333333333333,2,2,GATAAAGTGTTGGTGTTTCA,0,1567644
galEp3,0.3333333333333333,2,2,GATAAAGTCATATCACTTGT,0,1583215
galEp3,0.3333333333333333,2,2,GATAAAGGAAACACTGAACT,0,1549968
galEp3,0.3333333333333333,2,2,GATAAAAGCACATTTACGAA,0,1574181
galEp3,0.3333333333333333,2,2,GATAAAAAATTTTTAGATGC,0,1592015
galEp3,0.3333333333333333,2,2,GAGTAACGATCCCGGTCGCT,0,1567956
galEp3,0.3333333333333333,2,2,GAGGTCTAGAAACCTCTAAC,0,1568643
galEp3,0.3333333333333333,2,2,GAGGCAAGCGCTAAATTCCA,0,1587995
galEp3,0.3333333333333333,2,2,GAGGATGTACATTAGAAGCC,0,1560600
galEp3,0.3333333333333333,2,2,GAGGAGAGCTGCATATATGT,0,1561534
galEp3,0.3333333333333333,2,2,GAGGAAGTCAAGTTTCGTAA,0,1575019
galEp3,0.3333333333333333,2,2,GAGCGAGGTTTGTCATAAAA,0,1591093
galEp3,0.3333333333333333,2,2,GAGCATCTCGCCCCAACTAG,0,1562216
galEp3,0.3333333333333333,2,2,GAGCATAACATGGCAACCTC,0,1565161
galEp3,0.3333333333333333,2,2,GAGATCCGTGGAATTGCTAT,0,1556785
galEp3,0.3333333333333333,2,2,GAGAGGCAGAGTTAAAACAA,0,1576187
galEp3,0.3333333333333333,2,2,GAGAGACTCCGAAGAGTGAC,0,1576069
galEp3,0.3333333333333333,2,2,GAGACGCCCTAAGCGTCTAG,0,1568890
galEp3,0.3333333333333333,2,2,GAGACATTATGCCCAAGTTG,0,1568003
galEp3,0.3333333333333333,2,2,GAGAATTCGTTTCCTATCGC,0,1565698
galEp3,0.3333333333333333,2,2,GAGAATGGCGTCTAAATTAG,0,1583469
galEp3,0.3333333333333333,2,2,GAGAAACAGGACGTATGCTG,0,1559726
galEp3,0.3333333333333333,2,2,GACTTTATTCCCCGGATGGT,0,1594686
galEp3,0.3333333333333333,2,2,GACTTAATCGCTCCGGGAAC,0,1559468
galEp3,0.3333333333333333,2,2,GACTATTTAGAAGCCCGAAT,0,1575881
galEp3,0.3333333333333333,2,2,GACGTACTACCACCCGCTAT,0,1553421
galEp3,0.3333333333333333,2,2,GACGCTGTGGTCTTTTACCC,0,1578078
galEp3,0.3333333333333333,2,2,GACGCTGATCAGAACGCTTA,0,1553363
galEp3,0.3333333333333333,2,2,GACGCTCGTATAATGCGATG,0,1589929
galEp3,0.3333333333333333,2,2,GACGCGCATACACGCGCCAT,0,1582159
galEp3,0.3333333333333333,2,2,GACGCCCCTCTAGATTAGTC,0,1574135
galEp3,0.3333333333333333,2,2,GACGCCAAAAGGACAAGAAT,0,1579248
galEp3,0.3333333333333333,2,2,GACGATTTCGTAGAAATCGT,0,1584469
galEp3,0.3333333333333333,2,2,GACGATCGCGCTTGCGGCCA,0,1571909
galEp3,0.3333333333333333,2,2,GACGAGTGTGGACTGTGCCA,0,1548864
galEp3,0.3333333333333333,2,2,GACGACTAGAACCTCGTAAC,0,1563083
galEp3,0.3333333333333333,2,2,GACCTTTGAAAAGACGGGGT,0,1592391
galEp3,0.3333333333333333,2,2,GACCTGCCATACAATCGTGG,0,1571797
galEp3,0.3333333333333333,2,2,GACCGGGGCACTGCATCCGT,0,1578639
galEp3,0.3333333333333333,2,2,GACCCGGGTCTGTTTGGCTA,0,1554768
galEp3,0.3333333333333333,2,2,GACATATAAAGGGAGAGAAG,0,1569170
galEp3,0.3333333333333333,2,2,GACACTTCCCCGATGTAATT,0,1593026
galEp3,0.3333333333333333,2,2,GACACTTCAATAAATCTCTG,0,1590447
galEp3,0.3333333333333333,2,2,GACACTCTGGTTCTGTTGCG,0,1555064
galEp3,0.3333333333333333,2,2,GACAACCTCGAAAACACAGG,0,1562171
galEp3,0.3333333333333333,2,2,GACAACATGTTTATTTACCC,0,1568000
galEp3,0.3333333333333333,2,2,GACAACAGACTACGCAAACC,0,1561845
galEp3,0.3333333333333333,2,2,GAATTTTGGATTCGCTATAT,0,1582358
galEp3,0.3333333333333333,2,2,GAATTCGAAAGGCTGTGAAA,0,1548608
galEp3,0.3333333333333333,2,2,GAATGTCAGGGACTGGAGAC,0,1554784
galEp3,0.3333333333333333,2,2,GAATGGACAAGTTTACTCGG,0,1578378
galEp3,0.3333333333333333,2,2,GAATGCACTATGCCTGGTGG,0,1555663
galEp3,0.3333333333333333,2,2,GAATATTACGGGTTGATGCT,0,1548356
galEp3,0.3333333333333333,2,2,GAATAACCGTCCGTAACCAC,0,1579058
galEp3,0.3333333333333333,2,2,GAAGTCACTGAGGTGCAAAG,0,1574654
galEp3,0.3333333333333333,2,2,GAAGGAATACATTAAAATTA,0,1572086
galEp3,0.3333333333333333,2,2,GAAGAATAGAGTTTAAGAGA,0,1548200
galEp3,0.3333333333333333,2,2,GAAGAAGGTGGCGAATAAGC,0,1590084
galEp3,0.3333333333333333,2,2,GAACTGCCCAGCAGTCCTAG,0,1563538
galEp3,0.3333333333333333,2,2,GAACGTCAGAAAATTATCGT,0,1561543
galEp3,0.3333333333333333,2,2,GAACGGCAATACGTGCGGTC,0,1549306
galEp3,0.3333333333333333,2,2,GAACGGAACTAGCGAACTCA,0,1547652
galEp3,0.3333333333333333,2,2,GAACGCAATAATTACATGTA,0,1576970
galEp3,0.3333333333333333,2,2,GAACGATAAAAACGTTCTAA,0,1577215
galEp3,0.3333333333333333,2,2,GAACCTTTGTACACCTTAGG,0,1555842
galEp3,0.3333333333333333,2,2,GAACATTTACCCCGAACGAT,0,1572361
galEp3,0.3333333333333333,2,2,GAACAGCCGACTAGACCGGC,0,1555442
galEp3,0.3333333333333333,2,2,GAACACGCCTTCCCTACGAC,0,1560954
galEp3,0.3333333333333333,2,2,GAACACACTGAGACGTTAAA,0,1567177
galEp3,0.3333333333333333,2,2,GAAATGGGTATCTAGATTCT,0,1581163
galEp3,0.3333333333333333,2,2,GAAATAACTGAACGGAAGGA,0,1576875
galEp3,0.3333333333333333,2,2,GAAAGGGTCATGGAAGGTTG,0,1556032
galEp3,0.3333333333333333,2,2,GAAAGCTAAGCTTCAGGGCG,0,1555579
galEp3,0.3333333333333333,2,2,GAAACCTGCTTTAATCCCGT,0,1567078
galEp3,0.3333333333333333,2,2,CTTTTTTTGTCTTGAGCAAA,0,1572395
galEp3,0.3333333333333333,2,2,CTTTTTATGGTGAAGTGATG,0,1573875
galEp3,0.3333333333333333,2,2,CTTTGGAGCTCGCATCTGTT,0,1586806
galEp3,0.3333333333333333,2,2,CTTTCTTGGAGGTATATCAA,0,1561702
galEp3,0.3333333333333333,2,2,CTTTCGCGGGTACACAGTTA,0,1580680
galEp3,0.3333333333333333,2,2,CTTGTCAGCCGACCCTACAT,0,1581205
galEp3,0.3333333333333333,2,2,CTTGGTGCTGTAGATCCGGA,0,1579003
galEp3,0.3333333333333333,2,2,CTTCTTGAAAGCTAACATGG,0,1568210
galEp3,0.3333333333333333,2,2,CTTCTCGGGGTTACCCGACG,0,1570140
galEp3,0.3333333333333333,2,2,CTTCGTCAGACCAGGGCTAG,0,1558490
galEp3,0.3333333333333333,2,2,CTTCGGGAAGGGTCACTGGA,0,1574334
galEp3,0.3333333333333333,2,2,CTTCGCTTTTTCACCCGGGG,0,1563799
galEp3,0.3333333333333333,2,2,CTTCGCGTAATTAGATTCTC,0,1562455
galEp3,0.3333333333333333,2,2,CTTCGCGGACAGTGCGTGCA,0,1585815
galEp3,0.3333333333333333,2,2,CTTCATTCCTACTGGATCTG,0,1574414
galEp3,0.3333333333333333,2,2,CTTCAAGGGTATCAGGAGCT,0,1567451
galEp3,0.3333333333333333,2,2,CTTATGTCGCGAATAATTCG,0,1550970
galEp3,0.3333333333333333,2,2,CTTAGTGGTCGCACCCACAA,0,1592844
galEp3,0.3333333333333333,2,2,CTTAGGGGTATACTGTGGCA,0,1546845
galEp3,0.3333333333333333,2,2,CTTACTCACTTAGGAAGACT,0,1562260
galEp3,0.3333333333333333,2,2,CTTACAGAAGGCGACACAGA,0,1568706
galEp3,0.3333333333333333,2,2,CTGTTCGCTAGTATGATACA,0,1577046
galEp3,0.3333333333333333,2,2,CTGTTAGTGTAGCGCGGTGA,0,1547554
galEp3,0.3333333333333333,2,2,CTGTTAACTACAACCCCAGT,0,1584475
galEp3,0.3333333333333333,2,2,CTGTCTTTTTGCGGTCGGCA,0,1578052
galEp3,0.3333333333333333,2,2,CTGTCTGCCGTCCGTGTTTG,0,1552659
galEp3,0.3333333333333333,2,2,CTGTCTCGCGTGGCTAGCCA,0,1571852
galEp3,0.3333333333333333,2,2,CTGTATGGCCTACTACACTT,0,1579520
galEp3,0.3333333333333333,2,2,CTGTACACAGGATATTGAGA,0,1569643
galEp3,0.3333333333333333,2,2,CTGTAAGGTACTTCGCTCGT,0,1558610
galEp3,0.3333333333333333,2,2,CTGTAACTGGCGTTATTTTT,0,1553401
galEp3,0.3333333333333333,2,2,CTGGTTTATGTTTTGCGTAC,0,1569390
galEp3,0.3333333333333333,2,2,CTGGTGGACATGCCGATGGC,0,1581659
galEp3,0.3333333333333333,2,2,CTGGGCTGGAAAACTAATTC,0,1585774
galEp3,0.3333333333333333,2,2,CTGGGCTGCGCTTCTAGCCG,0,1565756
galEp3,0.3333333333333333,2,2,CTGGGATTTGTGCAATTTTA,0,1548219
galEp3,0.3333333333333333,2,2,CTGGGAGGACTTCCTGTGTC,0,1582336
galEp3,0.3333333333333333,2,2,CTGGCCTAACCTTTGGTTTA,0,1575678
galEp3,0.3333333333333333,2,2,CTGGATGCCCTTCAAATCGC,0,1551227
galEp3,0.3333333333333333,2,2,CTGGACGGGTATAGTCTAAT,0,1566577
galEp3,0.3333333333333333,2,2,CTGCTCAGGACGTTGGGAGA,0,1565182
galEp3,0.3333333333333333,2,2,CTGCGGGGTCAGGTACGCCG,0,1579122
galEp3,0.3333333333333333,2,2,CTGCGCCTGCAGAGAGCGCC,0,1592665
galEp3,0.3333333333333333,2,2,CTGCGATCCAGCCAGCGATT,0,1555904
galEp3,0.3333333333333333,2,2,CTGCACAGTGCGATTCTGAT,0,1589516
galEp3,0.3333333333333333,2,2,CTGATTGTAGGGTATCGAGG,0,1589634
galEp3,0.3333333333333333,2,2,CTGAGGGTCGTGTGCGCTTC,0,1592277
galEp3,0.3333333333333333,2,2,CTGACAAAAGTATCTCCCAG,0,1562414
galEp3,0.3333333333333333,2,2,CTGAATTTCGACGCCCTCTC,0,1572225
galEp3,0.3333333333333333,2,2,CTGAAGTTGGATAGTGAAAA,0,1587934
galEp3,0.3333333333333333,2,2,CTCTGTGTGAGACCTTCCGG,0,1591792
galEp3,0.3333333333333333,2,2,CTCTGATTCTATTAACAGTA,0,1558766
galEp3,0.3333333333333333,2,2,CTCTCGTCTCCTCCGACTCG,0,1587744
galEp3,0.3333333333333333,2,2,CTCTAGACATGGACGCTAAA,0,1571095
galEp3,0.3333333333333333,2,2,CTCGTACTCCAATAACAGGG,0,1586891
galEp3,0.3333333333333333,2,2,CTCGGTTAAGAAATCGGTAT,0,1593178
galEp3,0.3333333333333333,2,2,CTCGCCTGCAATCACAACCT,0,1561532
galEp3,0.3333333333333333,2,2,CTCGATTCATCCCCCCACAG,0,1586962
galEp3,0.3333333333333333,2,2,CTCCTCCGCCCAGGTGCTGG,0,1561187
galEp3,0.3333333333333333,2,2,CTCCGAGGTGGTATCAAGTT,0,1591859
galEp3,0.3333333333333333,2,2,CTCCCGGGTGCTAGGGTTCC,0,1592543
galEp3,0.3333333333333333,2,2,CTCCAGCTAATAGGAGGTTT,0,1555581
galEp3,0.3333333333333333,2,2,CTCCACAAAAAATTCAGCTT,0,1547922
galEp3,0.3333333333333333,2,2,CTCCAATATGACGGCGATAC,0,1579712
galEp3,0.3333333333333333,2,2,CTCATGGGTGTTCACTTGAG,0,1576705
galEp3,0.3333333333333333,2,2,CTCATCGTGTTTTGCTAGCT,0,1578969
galEp3,0.3333333333333333,2,2,CTCATCCTTTTTGGGCCATA,0,1560952
galEp3,0.3333333333333333,2,2,CTCATCCGGTGCGCAAAGGA,0,1558913
galEp3,0.3333333333333333,2,2,CTCATACGTTCTTGTTAAAG,0,1579692
galEp3,0.3333333333333333,2,2,CTCACCGGGTGCGCGGGGAC,0,1582503
galEp3,0.3333333333333333,2,2,CTCAATTGTATCTGGGCTAC,0,1570335
galEp3,0.3333333333333333,2,2,CTCAAAAAGCATAGGCTTAA,0,1558333
galEp3,0.3333333333333333,2,2,CTATTTCGAAGTAGAACGCC,0,1591838
galEp3,0.3333333333333333,2,2,CTATTGGATAACGTTAAAAG,0,1582375
galEp3,0.3333333333333333,2,2,CTATTGCTTACCAAACACCT,0,1578071
galEp3,0.3333333333333333,2,2,CTATTATACGGGGCTACGTA,0,1580512
galEp3,0.3333333333333333,2,2,CTATGTTTTGGAAGCTTCGA,0,1568475
galEp3,0.3333333333333333,2,2,CTATCGGCGCATATCAAGAT,0,1583423
galEp3,0.3333333333333333,2,2,CTATACCAAGGACGAAGAGG,0,1583282
galEp3,0.3333333333333333,2,2,CTATACATACTACTCATAGG,0,1553309
galEp3,0.3333333333333333,2,2,CTAGTTAGGCTCTCAGGGTC,0,1587348
galEp3,0.3333333333333333,2,2,CTAGCTCCATACCTTGTGCC,0,1591165
galEp3,0.3333333333333333,2,2,CTACTATTCATGTCGGGAAA,0,1562746
galEp3,0.3333333333333333,2,2,CTACAAGCCCCGGCACGCTA,0,1576899
galEp3,0.3333333333333333,2,2,CTACAACTCTCGTCGTCCTC,0,1573226
galEp3,0.3333333333333333,2,2,CTAATTTCCCCTGCTACAAT,0,1557593
galEp3,0.3333333333333333,2,2,CTAATCCCCTCATTAAAACT,0,1563413
galEp3,0.3333333333333333,2,2,CTAAGGCGTTAATAAGGCTA,0,1583439
galEp3,0.3333333333333333,2,2,CTAACTTACCTCTCTTAAGG,0,1562959
galEp3,0.3333333333333333,2,2,CGTTTGTTGATGCTGATCCC,0,1583784
galEp3,0.3333333333333333,2,2,CGTTTGCTAAGCAAATTACC,0,1557537
galEp3,0.3333333333333333,2,2,CGTTGGTCGAAGGTACGAAG,0,1547313
galEp3,0.3333333333333333,2,2,CGTTCGAGGTGGTTGCTACG,0,1585976
galEp3,0.3333333333333333,2,2,CGTTCGAAAGCGGCGGACGT,0,1553820
galEp3,0.3333333333333333,2,2,CGTTCCGATGAGTTGGGTCA,0,1552688
galEp3,0.3333333333333333,2,2,CGTTCATAATCGCTGAGGAA,0,1587161
galEp3,0.3333333333333333,2,2,CGTTCAGTGTTTATTGGGAC,0,1571789
galEp3,0.3333333333333333,2,2,CGTGTGAGCCCCTGGTCTGT,0,1578821
galEp3,0.3333333333333333,2,2,CGTGTCCTAAGCACGCCGAC,0,1548658
galEp3,0.3333333333333333,2,2,CGTGTCAACCGAGACATTAA,0,1592408
galEp3,0.3333333333333333,2,2,CGTGGTAAAGGCAATCAACT,0,1563105
galEp3,0.3333333333333333,2,2,CGTGGCGGAGTCCACTACAA,0,1586978
galEp3,0.3333333333333333,2,2,CGTGATTTAATAGGCTGCAA,0,1584429
galEp3,0.3333333333333333,2,2,CGTCTCCTTTATAGTTGGCA,0,1588781
galEp3,0.3333333333333333,2,2,CGTCTCACAATTTTGGAGAG,0,1553247
galEp3,0.3333333333333333,2,2,CGTCGGCTCGCGGCATTTGG,0,1582022
galEp3,0.3333333333333333,2,2,CGTCCCGATAACTGGGGTGT,0,1585288
galEp3,0.3333333333333333,2,2,CGTCATATACAGTTCTCATG,0,1569047
galEp3,0.3333333333333333,2,2,CGTCAATCTCTCTTCAGCAT,0,1575404
galEp3,0.3333333333333333,2,2,CGTCAATATCGAGTTCGGAC,0,1549290
galEp3,0.3333333333333333,2,2,CGTATTGGAACCCCGGCCAG,0,1569712
galEp3,0.3333333333333333,2,2,CGTAGTTGGCCTAAGGAAGA,0,1586534
galEp3,0.3333333333333333,2,2,CGTAGGCAGGCAATCAGAAA,0,1561499
galEp3,0.3333333333333333,2,2,CGTACAAATCTTTCCGACGT,0,1594491
galEp3,0.3333333333333333,2,2,CGTAATTGTGGAGTCCACGT,0,1551699
galEp3,0.3333333333333333,2,2,CGTAAGTGGAGCGACGCTAG,0,1561650
galEp3,0.3333333333333333,2,2,CGGTTACGATCTACTTTGAC,0,1567820
galEp3,0.3333333333333333,2,2,CGGTGGTTTCACATCCTTCT,0,1551274
galEp3,0.3333333333333333,2,2,CGGTGCAGGCGATTCTAGAT,0,1590875
galEp3,0.3333333333333333,2,2,CGGTAGGCATAATCCGTATA,0,1587378
galEp3,0.3333333333333333,2,2,CGGGTTGTACCGACGCATGT,0,1587097
galEp3,0.3333333333333333,2,2,CGGGTCATAAATGGACAAAG,0,1566424
galEp3,0.3333333333333333,2,2,CGGGGCGGTGCTTGTAGGGG,0,1548427
galEp3,0.3333333333333333,2,2,CGGGCGGATACGTTGGGCCT,0,1581411
galEp3,0.3333333333333333,2,2,CGGGAGTTCGCGTTGGCAAT,0,1559164
galEp3,0.3333333333333333,2,2,CGGGAGGTACACAGTCGGCG,0,1577778
galEp3,0.3333333333333333,2,2,CGGGACCCATGCGACTGAGT,0,1556051
galEp3,0.3333333333333333,2,2,CGGCGTTACGCTCAAATGCA,0,1550823
galEp3,0.3333333333333333,2,2,CGGCCTAGAAGGATTGCCTT,0,1590336
galEp3,0.3333333333333333,2,2,CGGCCCCGGGTAATCCTCAT,0,1555908
galEp3,0.3333333333333333,2,2,CGGCCATTACCCCGGCAGTG,0,1562743
galEp3,0.3333333333333333,2,2,CGGCAGGGCCATTTTATCAA,0,1591665
galEp3,0.3333333333333333,2,2,CGGATGATCGTGCGGTATTG,0,1578607
galEp3,0.3333333333333333,2,2,CGGATCGCGAATGGCGGTTT,0,1581640
galEp3,0.3333333333333333,2,2,CGGATATCTTTATTGCTCGA,0,1546563
galEp3,0.3333333333333333,2,2,CGGAGTCTTAGATGTCAAGG,0,1547129
galEp3,0.3333333333333333,2,2,CGGAGGTGAATTGTGCATGT,0,1546549
galEp3,0.3333333333333333,2,2,CGGAGCAGGCACCAATGGCA,0,1591535
galEp3,0.3333333333333333,2,2,CGGAAAGGTCGCCATCTACG,0,1594105
galEp3,0.3333333333333333,2,2,CGGAAACAGTCAATAGCGAC,0,1556603
galEp3,0.3333333333333333,2,2,CGCTGCGGTGATTGTTTAGA,0,1580298
galEp3,0.3333333333333333,2,2,CGCTCTGTGAGCCGCCATTT,0,1555689
galEp3,0.3333333333333333,2,2,CGCTCTCGCTCTCCCTTTGT,0,1555745
galEp3,0.3333333333333333,2,2,CGCTATGCAGTCACGGTAGC,0,1593777
galEp3,0.3333333333333333,2,2,CGCGTTCTTTGTTTAATACA,0,1560468
galEp3,0.3333333333333333,2,2,CGCGTGGGACTACGTTGCTT,0,1559262
galEp3,0.3333333333333333,2,2,CGCGTCGCGGGTGGGCGGAC,0,1584066
galEp3,0.3333333333333333,2,2,CGCGTACCGAACCACCTTGG,0,1581650
galEp3,0.3333333333333333,2,2,CGCGGTGAAGAGGTTCAAGA,0,1581209
galEp3,0.3333333333333333,2,2,CGCGGGAGGTGCCCCCGAAA,0,1546948
galEp3,0.3333333333333333,2,2,CGCGGCGTCAGAACGACTCC,0,1568722
galEp3,0.3333333333333333,2,2,CGCGCGTTTCGCCATTTTAA,0,1575289
galEp3,0.3333333333333333,2,2,CGCGAGTCATTATTGCGCAT,0,1559139
galEp3,0.3333333333333333,2,2,CGCCTTACTAACGCGGGGCT,0,1553414
galEp3,0.3333333333333333,2,2,CGCCCGGAGGCTTGGGCCTT,0,1562818
galEp3,0.3333333333333333,2,2,CGCATTATGGTGCCCTCGTA,0,1590651
galEp3,0.3333333333333333,2,2,CGCAGTTCCCCTCTGGGACC,0,1549195
galEp3,0.3333333333333333,2,2,CGCACCAATATCGGCACTTT,0,1560432
galEp3,0.3333333333333333,2,2,CGCAACTTGGAACGTAATTA,0,1561720
galEp3,0.3333333333333333,2,2,CGATGGTGTATCATAGCCCC,0,1555702
galEp3,0.3333333333333333,2,2,CGATCCACGTGTACTCATGA,0,1575482
galEp3,0.3333333333333333,2,2,CGATAGGAGAATAGTCACAA,0,1571796
galEp3,0.3333333333333333,2,2,CGATAACACATTCACAAATG,0,1554623
galEp3,0.3333333333333333,2,2,CGAGGTTGGTTTGTTAATGG,0,1559697
galEp3,0.3333333333333333,2,2,CGAGGCGAACTACCGGCGGC,0,1567250
galEp3,0.3333333333333333,2,2,CGAGATGTATTGACCGGCAG,0,1546577
galEp3,0.3333333333333333,2,2,CGAGACTTTTTTGGGATTTT,0,1564062
galEp3,0.3333333333333333,2,2,CGACTTATATTCATTTTATC,0,1577742
galEp3,0.3333333333333333,2,2,CGACTATGTGTGCAGACGTT,0,1550676
galEp3,0.3333333333333333,2,2,CGACGTCCCACTTAAAATTA,0,1562316
galEp3,0.3333333333333333,2,2,CGACAGGACTTAACCCTATC,0,1557678
galEp3,0.3333333333333333,2,2,CGACACAACAAGCTTATCCA,0,1563484
galEp3,0.3333333333333333,2,2,CGACAAATCTAGGCACTCGT,0,1572249
galEp3,0.3333333333333333,2,2,CGAATTCCTATTAAAATATA,0,1579731
galEp3,0.3333333333333333,2,2,CGAATGTGCTAGTGCAACTA,0,1560149
galEp3,0.3333333333333333,2,2,CGAATGCCGCGGCCTGTTAC,0,1573136
galEp3,0.3333333333333333,2,2,CGAAGTACACTAAAGGTAGT,0,1590180
galEp3,0.3333333333333333,2,2,CGAACCGTTGCCCCGCACGC,0,1589250
galEp3,0.3333333333333333,2,2,CGAAAGCTCCCATTCGAAGT,0,1549201
galEp3,0.3333333333333333,2,2,CGAAAGATTGCTTGGTAGAC,0,1558132
galEp3,0.3333333333333333,2,2,CGAAACTTGAGCACAGGTTA,0,1563072
galEp3,0.3333333333333333,2,2,CGAAACCATGTACAACGTGC,0,1546690
galEp3,0.3333333333333333,2,2,CGAAAACTCTTTCCATAGTG,0,1556727
galEp3,0.3333333333333333,2,2,CCTTGCGTTGAGGGCTGTAG,0,1547013
galEp3,0.3333333333333333,2,2,CCTTCTCCTCACGATCAGTG,0,1584198
galEp3,0.3333333333333333,2,2,CCTTCAGGTTCCTTAGATGG,0,1565789
galEp3,0.3333333333333333,2,2,CCTTATTAAATGAATCGAAA,0,1578558
galEp3,0.3333333333333333,2,2,CCTGTTTAAGGCGCAGGGAT,0,1559292
galEp3,0.3333333333333333,2,2,CCTGGGGCGTTGGGATCATA,0,1546833
galEp3,0.3333333333333333,2,2,CCTGGAGACTATACGGGATA,0,1573416
galEp3,0.3333333333333333,2,2,CCTGGACCAGGCGCCTGGAT,0,1591698
galEp3,0.3333333333333333,2,2,CCTGCACAGTAGGCACATAG,0,1575325
galEp3,0.3333333333333333,2,2,CCTCTCGGCCGCGCTGATGT,0,1577389
galEp3,0.3333333333333333,2,2,CCTCCTGGCCCATCGCGGGT,0,1587381
galEp3,0.3333333333333333,2,2,CCTCCCCCCAAGATGCAAGT,0,1572453
galEp3,0.3333333333333333,2,2,CCTCCAGAAGCAGCGATTCA,0,1572004
galEp3,0.3333333333333333,2,2,CCTCAATAGCGAGGGCGCGT,0,1557091
galEp3,0.3333333333333333,2,2,CCTATGGGTTTCTCAAGCAG,0,1587688
galEp3,0.3333333333333333,2,2,CCTAGTGCGGACAGCGGCAC,0,1573229
galEp3,0.3333333333333333,2,2,CCGTTTAGTGAACGCAACTA,0,1566531
galEp3,0.3333333333333333,2,2,CCGTTCGGTCTGGGCTACGC,0,1577878
galEp3,0.3333333333333333,2,2,CCGTGGTTGAATTGATCCAT,0,1587133
galEp3,0.3333333333333333,2,2,CCGTGCACTATCACAACGGA,0,1564407
galEp3,0.3333333333333333,2,2,CCGTGATGCCGACACAACGC,0,1590730
galEp3,0.3333333333333333,2,2,CCGTGACGCCATTTTTATAC,0,1583991
galEp3,0.3333333333333333,2,2,CCGTGAAACGGCTCTAAGCT,0,1572353
galEp3,0.3333333333333333,2,2,CCGTCCTATTAAATGCAGCA,0,1593111
galEp3,0.3333333333333333,2,2,CCGTACCGATGCGACGTTAT,0,1556927
galEp3,0.3333333333333333,2,2,CCGGTTATGCTAGATACGGT,0,1557257
galEp3,0.3333333333333333,2,2,CCGGGATGGCGACTATCAGT,0,1556875
galEp3,0.3333333333333333,2,2,CCGGCGGGTCACCATGCAAC,0,1569379
galEp3,0.3333333333333333,2,2,CCGGCGCCAAAAAGAATGAC,0,1583573
galEp3,0.3333333333333333,2,2,CCGCGGGATTTCGTCTTCCT,0,1571441
galEp3,0.3333333333333333,2,2,CCGCGGAATCTGGTTCGCAA,0,1592410
galEp3,0.3333333333333333,2,2,CCGCGCGATAAAGTGCACCT,0,1579548
galEp3,0.3333333333333333,2,2,CCGCGAATTTTCTACAGGCG,0,1563344
galEp3,0.3333333333333333,2,2,CCGCCCTGCACGTCCACGCT,0,1561175
galEp3,0.3333333333333333,2,2,CCGCCCTCCGTCAAGTAAGT,0,1570749
galEp3,0.3333333333333333,2,2,CCGCAGAAAACCACTCAATA,0,1567298
galEp3,0.3333333333333333,2,2,CCGCACACGGTTCTGGACTA,0,1559943
galEp3,0.3333333333333333,2,2,CCGCACAATGATTCGCCCCA,0,1549975
galEp3,0.3333333333333333,2,2,CCGATTTACCCAGCTCAACC,0,1574158
galEp3,0.3333333333333333,2,2,CCGATCCAATTCTCGGTGTT,0,1592414
galEp3,0.3333333333333333,2,2,CCGATCAAAGGTTGTTGAGT,0,1556715
galEp3,0.3333333333333333,2,2,CCGAGAGTAAAAAGGCTGTT,0,1592252
galEp3,0.3333333333333333,2,2,CCGAATTCAAGGAGAATTCA,0,1581062
galEp3,0.3333333333333333,2,2,CCCTTGGAATGTTAGCGTCG,0,1557220
galEp3,0.3333333333333333,2,2,CCCTTGAACATCTGTACCCA,0,1589312
galEp3,0.3333333333333333,2,2,CCCTTACGCCCACCCCTAAC,0,1573329
galEp3,0.3333333333333333,2,2,CCCTGTCTGACATTCGTAAA,0,1570818
galEp3,0.3333333333333333,2,2,CCCTCTGTGGTTGAACAACA,0,1564896
galEp3,0.3333333333333333,2,2,CCCTCCCGTCCCTCCGGACT,0,1569467
galEp3,0.3333333333333333,2,2,CCCTCCATCATGTCCAAATG,0,1571496
galEp3,0.3333333333333333,2,2,CCCTCCAGCTGCGTTGGTCG,0,1557188
galEp3,0.3333333333333333,2,2,CCCGTTTACTGGCGTGAGCT,0,1559900
galEp3,0.3333333333333333,2,2,CCCGTTCGTGGTCACCACGC,0,1585220
galEp3,0.3333333333333333,2,2,CCCGTCAAACCCGTCCACAT,0,1553811
galEp3,0.3333333333333333,2,2,CCCGTATAATCACGTAGCGA,0,1558648
galEp3,0.3333333333333333,2,2,CCCGTAGGTGCGTTTACGGA,0,1553031
galEp3,0.3333333333333333,2,2,CCCGTAGGTCACCCGGGACC,0,1561074
galEp3,0.3333333333333333,2,2,CCCGGCCACTACTACCGAAC,0,1594240
galEp3,0.3333333333333333,2,2,CCCGGAGTGTACTTCATTGT,0,1551063
galEp3,0.3333333333333333,2,2,CCCGGACACAAGTCTCAATC,0,1572302
galEp3,0.3333333333333333,2,2,CCCGCGAGACCTAGAACGAA,0,1563188
galEp3,0.3333333333333333,2,2,CCCGACAACCGAGGCGGAAG,0,1575344
galEp3,0.3333333333333333,2,2,CCCCAATACAACAAGACAGA,0,1588439
galEp3,0.3333333333333333,2,2,CCCATTAGTCAAGGCTGAAG,0,1570144
galEp3,0.3333333333333333,2,2,CCCATCTTCATGTCTCTGGG,0,1570811
galEp3,0.3333333333333333,2,2,CCCAGGGCGGGCACGACGTT,0,1557211
galEp3,0.3333333333333333,2,2,CCCAGCCCAATGCCCTCGTC,0,1573101
galEp3,0.3333333333333333,2,2,CCCACAGTGGTACGTTACTC,0,1553835
galEp3,0.3333333333333333,2,2,CCCAAGTAGCGGGAGGCAGC,0,1548887
galEp3,0.3333333333333333,2,2,CCCAAGGCGTGTGACTTCTG,0,1550502
galEp3,0.3333333333333333,2,2,CCATGGTTTATGCGGCGTAT,0,1572173
galEp3,0.3333333333333333,2,2,CCATGGAGGTGGACATGTTG,0,1591118
galEp3,0.3333333333333333,2,2,CCATGCTTTGGCCGGTACTT,0,1570940
galEp3,0.3333333333333333,2,2,CCATCTCAAGTCTACGGTGT,0,1586834
galEp3,0.3333333333333333,2,2,CCATCGTCTGAACCGGGATG,0,1573605
galEp3,0.3333333333333333,2,2,CCATCGCAACCCATTTCTTT,0,1583433
galEp3,0.3333333333333333,2,2,CCATCACGTCGGTTTGAATA,0,1559146
galEp3,0.3333333333333333,2,2,CCATAGAGTTTCAAAGGATG,0,1558033
galEp3,0.3333333333333333,2,2,CCATACCCATTCTTTGATTG,0,1584619
galEp3,0.3333333333333333,2,2,CCAGTTTAGGGTACCAGTGG,0,1564384
galEp3,0.3333333333333333,2,2,CCAGTTATCTCCAAAGCTGT,0,1550541
galEp3,0.3333333333333333,2,2,CCAGGTGAGCTAGAAGTTGG,0,1581352
galEp3,0.3333333333333333,2,2,CCAGGTCATCAAAACGCGGT,0,1590198
galEp3,0.3333333333333333,2,2,CCAGGGCCGTTGCGTTCCAC,0,1561127
galEp3,0.3333333333333333,2,2,CCAGGAACCAACGAACAAAG,0,1560698
galEp3,0.3333333333333333,2,2,CCAGATAGCTTGCAGTGAGA,0,1593219
galEp3,0.3333333333333333,2,2,CCAGATAAATCTAGATCAGA,0,1585146
galEp3,0.3333333333333333,2,2,CCAGACATTAGAAGAGGTAG,0,1554578
galEp3,0.3333333333333333,2,2,CCACGTGGTTGTTAAACGGA,0,1584713
galEp3,0.3333333333333333,2,2,CCACCGGATGCGGCTCGCGT,0,1552240
galEp3,0.3333333333333333,2,2,CCACCGGAACTCGTCCAGGA,0,1569578
galEp3,0.3333333333333333,2,2,CCACAATGATATACAGTCTG,0,1549664
galEp3,0.3333333333333333,2,2,CCAATGTGCGCTGAGAGGTG,0,1576984
galEp3,0.3333333333333333,2,2,CCAATGGGCCTCAAGATTTC,0,1594845
galEp3,0.3333333333333333,2,2,CCAATATTGTTACACGGTAT,0,1586336
galEp3,0.3333333333333333,2,2,CCAAGGTGTGCGATTGCTCT,0,1549814
galEp3,0.3333333333333333,2,2,CCAAGGCATGTCAACGAGGA,0,1564164
galEp3,0.3333333333333333,2,2,CATTTGTCCCGCACAAATCA,0,1578733
galEp3,0.3333333333333333,2,2,CATTCAGGGGTCGATAAGGC,0,1569444
galEp3,0.3333333333333333,2,2,CATTAAGTCGGCTCTACTTG,0,1566006
galEp3,0.3333333333333333,2,2,CATGTGACCCTATACGGCCC,0,1584920
galEp3,0.3333333333333333,2,2,CATGTAAACACTCCAGGACC,0,1592463
galEp3,0.3333333333333333,2,2,CATGAACAAGTGAAATTCGT,0,1589230
galEp3,0.3333333333333333,2,2,CATGAAAATAGCCGCGGTCA,0,1585691
galEp3,0.3333333333333333,2,2,CATCTAGTTCCGCATACGGA,0,1578136
galEp3,0.3333333333333333,2,2,CATCCACCGTACTGACGGTC,0,1569561
galEp3,0.3333333333333333,2,2,CATCAGGTGTGGTTCTGCCA,0,1549136
galEp3,0.3333333333333333,2,2,CATATTGGCAAGTCTCAAGA,0,1589410
galEp3,0.3333333333333333,2,2,CATAGGGGGACTCAACGTTA,0,1583054
galEp3,0.3333333333333333,2,2,CATAAACTACAAGTGATCTT,0,1592614
galEp3,0.3333333333333333,2,2,CAGTTTCACTACGCTCTCGA,0,1577679
galEp3,0.3333333333333333,2,2,CAGTCTTCGCATGTATATTT,0,1571429
galEp3,0.3333333333333333,2,2,CAGTATAGCGAGGTCGTGTC,0,1586743
galEp3,0.3333333333333333,2,2,CAGTAGGTGGATGTCAGCTG,0,1550385
galEp3,0.3333333333333333,2,2,CAGGTCTGCAGTGTGTTTTA,0,1552663
galEp3,0.3333333333333333,2,2,CAGGTAATGCCAAGTCGGAC,0,1561193
galEp3,0.3333333333333333,2,2,CAGGGTTTGTTGCCCAGCCA,0,1569511
galEp3,0.3333333333333333,2,2,CAGGGGACTTCGCGTTTTCG,0,1548583
galEp3,0.3333333333333333,2,2,CAGGGATCTGGCCCTCCCAC,0,1553639
galEp3,0.3333333333333333,2,2,CAGGCTGCGCTGGTAACCTT,0,1551668
galEp3,0.3333333333333333,2,2,CAGGCGGCGGGCACTTCTCA,0,1559492
galEp3,0.3333333333333333,2,2,CAGGCCAGCCCAAGTCAAGG,0,1591188
galEp3,0.3333333333333333,2,2,CAGGATATGATATGTAACTA,0,1570822
galEp3,0.3333333333333333,2,2,CAGGATATATGTTAACCGTA,0,1555049
galEp3,0.3333333333333333,2,2,CAGGATAGCTATTGATATAC,0,1548309
galEp3,0.3333333333333333,2,2,CAGCTATAGGAACAGCACAC,0,1587363
galEp3,0.3333333333333333,2,2,CAGCGATGGCAGGGTATAAG,0,1582454
galEp3,0.3333333333333333,2,2,CAGCCATGCATCATTTGGCT,0,1552221
galEp3,0.3333333333333333,2,2,CAGATTTCCTTAAAAGCTAG,0,1560771
galEp3,0.3333333333333333,2,2,CAGATTGCAAGAAAGTCAGG,0,1592855
galEp3,0.3333333333333333,2,2,CAGATCCGATGTGTGCGGAT,0,1591172
galEp3,0.3333333333333333,2,2,CAGAGGTCTCTAAGGCCCAG,0,1588710
galEp3,0.3333333333333333,2,2,CAGAACATACCAAAGACTAC,0,1578750
galEp3,0.3333333333333333,2,2,CAGAACACGGAAAATCTTTG,0,1594179
galEp3,0.3333333333333333,2,2,CACTTCCGCTCGGATAATGT,0,1576550
galEp3,0.3333333333333333,2,2,CACTTCACGTTGGGCGGACG,0,1557628
galEp3,0.3333333333333333,2,2,CACTGTTCCGGTTAACTTAT,0,1564525
galEp3,0.3333333333333333,2,2,CACTATTAATTAGACGTTTT,0,1564472
galEp3,0.3333333333333333,2,2,CACTAACTTCCGTGCACAAT,0,1586575
galEp3,0.3333333333333333,2,2,CACGGCAAAGGGAACCATCA,0,1564455
galEp3,0.3333333333333333,2,2,CACGCACCGCGGTGCTACCA,0,1591782
galEp3,0.3333333333333333,2,2,CACCTGAGGGGCATCTTAGG,0,1557021
galEp3,0.3333333333333333,2,2,CACCTCGCCGATCTTAGAAT,0,1550840
galEp3,0.3333333333333333,2,2,CACCCTGTACCAGCTGCGGG,0,1549134
galEp3,0.3333333333333333,2,2,CACCCCTTATTTTACCACAA,0,1565762
galEp3,0.3333333333333333,2,2,CACCCATGGAACTTTTTATC,0,1585197
galEp3,0.3333333333333333,2,2,CACCCAGTTTGAGGGTGTTC,0,1574700
galEp3,0.3333333333333333,2,2,CACCAGGCCGCAGCATCCGT,0,1548091
galEp3,0.3333333333333333,2,2,CACAGTGTCGTATAATCCAT,0,1594743
galEp3,0.3333333333333333,2,2,CACAGTAGTGGCCACATTTG,0,1566905
galEp3,0.3333333333333333,2,2,CACAGCGTAAAAATCTCACG,0,1576835
galEp3,0.3333333333333333,2,2,CACAGACGGGGGACAAGCGC,0,1562919
galEp3,0.3333333333333333,2,2,CACACCAATTGGCTCAGGTA,0,1586104
galEp3,0.3333333333333333,2,2,CACAAGTCAAACCAAGTATC,0,1554388
galEp3,0.3333333333333333,2,2,CACAAGACGGTATGACCTCT,0,1568372
galEp3,0.3333333333333333,2,2,CACAAAAGCGCATTACAAGA,0,1573588
galEp3,0.3333333333333333,2,2,CAATGTTGCATTATTTGCGA,0,1594041
galEp3,0.3333333333333333,2,2,CAATGACGCTAAGATAGTCC,0,1565061
galEp3,0.3333333333333333,2,2,CAATCCTGTTTTTCTTAACA,0,1557991
galEp3,0.3333333333333333,2,2,CAATAGAGGCAAGGGCGATT,0,1552423
galEp3,0.3333333333333333,2,2,CAATACACCTGAAAGTGGCT,0,1550338
galEp3,0.3333333333333333,2,2,CAATAAACTCTATAGAGAGG,0,1576698
galEp3,0.3333333333333333,2,2,CAAGTATCCGCATAGTCTCA,0,1547071
galEp3,0.3333333333333333,2,2,CAAGTAATTTTTGGCGTCAT,0,1594395
galEp3,0.3333333333333333,2,2,CAAGGGGCAGAGTCCAGACC,0,1547777
galEp3,0.3333333333333333,2,2,CAAGGGATCCAATTGCGCGA,0,1575168
galEp3,0.3333333333333333,2,2,CAAGGCATCTTCTTTGTTGT,0,1579276
galEp3,0.3333333333333333,2,2,CAAGGAGTGGGTTTAGTCTC,0,1594494
galEp3,0.3333333333333333,2,2,CAAGCTTATTTAAAACCCTC,0,1553810
galEp3,0.3333333333333333,2,2,CAAGCTCCGCTTCACTGGAC,0,1559347
galEp3,0.3333333333333333,2,2,CAAGCACAGTGTTATGGGAT,0,1580757
galEp3,0.3333333333333333,2,2,CAAGATGGCTTCACGACCAC,0,1554808
galEp3,0.3333333333333333,2,2,CAAGAGGGGATTTTCAGACA,0,1563878
galEp3,0.3333333333333333,2,2,CAACTTGGAGTTTCTGTATC,0,1591096
galEp3,0.3333333333333333,2,2,CAACTGGCGTCCAGATTAAT,0,1585350
galEp3,0.3333333333333333,2,2,CAAATCATTTTTTGACCCTA,0,1562451
galEp3,0.3333333333333333,2,2,CAAATCATCGGTGTAAGCCA,0,1551613
galEp3,0.3333333333333333,2,2,CAAAGTAATTCTGTGGATAA,0,1580302
galEp3,0.3333333333333333,2,2,CAAAATACACGCGGAGTCAT,0,1595078
galEp3,0.3333333333333333,2,2,CAAAACTTCACGAGGTCTGC,0,1593857
galEp3,0.3333333333333333,2,2,ATTTTCGGCTTCGATTACCC,0,1550468
galEp3,0.3333333333333333,2,2,ATTTGTCGGGTATGGCGGCG,0,1586590
galEp3,0.3333333333333333,2,2,ATTTAGTAATGGTTATCCTT,0,1553967
galEp3,0.3333333333333333,2,2,ATTTACGGAGCCCCTACAGG,0,1587227
galEp3,0.3333333333333333,2,2,ATTGTGCAGCGCATGACCCA,0,1549712
galEp3,0.3333333333333333,2,2,ATTGTAAAATTTAGGTTGGA,0,1552873
galEp3,0.3333333333333333,2,2,ATTGGTTGGAGTATTATACA,0,1561843
galEp3,0.3333333333333333,2,2,ATTGGCACCTCTATGCAAGC,0,1577381
galEp3,0.3333333333333333,2,2,ATTGCGAATATCCGGGATAG,0,1578461
galEp3,0.3333333333333333,2,2,ATTGCCGGATTCTCTTGTGT,0,1563146
galEp3,0.3333333333333333,2,2,ATTGATCCGGACGCTATCTC,0,1562726
galEp3,0.3333333333333333,2,2,ATTGACGCCACGGTAAAGTT,0,1574872
galEp3,0.3333333333333333,2,2,ATTCTACCTATACGAATTGC,0,1564516
galEp3,0.3333333333333333,2,2,ATTCAGAGCTCGCAGATATT,0,1556233
galEp3,0.3333333333333333,2,2,ATTCACTGCCGCTAGCAGCA,0,1593687
galEp3,0.3333333333333333,2,2,ATTATTTCGTGGCACACGTT,0,1586430
galEp3,0.3333333333333333,2,2,ATTATGCAGGTCCTTTCCCT,0,1549147
galEp3,0.3333333333333333,2,2,ATTATATCCCAGTTGTTTAA,0,1567015
galEp3,0.3333333333333333,2,2,ATTATAGCAGGGTACACATC,0,1591414
galEp3,0.3333333333333333,2,2,ATTACGGAGGAGTCATGTGC,0,1593919
galEp3,0.3333333333333333,2,2,ATTACCTTGCCGGTTGGCGT,0,1588048
galEp3,0.3333333333333333,2,2,ATTACCTGGTTAACGTCGGA,0,1592742
galEp3,0.3333333333333333,2,2,ATTAATTGGCAGATATACCT,0,1558657
galEp3,0.3333333333333333,2,2,ATTAATCACTGCGGGGGTCC,0,1565486
galEp3,0.3333333333333333,2,2,ATTAAGCATGTTCAGAGCGT,0,1551645
galEp3,0.3333333333333333,2,2,ATGTGTGGGGCAAGATCTCG,0,1549410
galEp3,0.3333333333333333,2,2,ATGTGTGAGGGTCTGATGTC,0,1594224
galEp3,0.3333333333333333,2,2,ATGTGTATGCGTATGTAGTA,0,1566173
galEp3,0.3333333333333333,2,2,ATGTGGGCATTAACTAGAAC,0,1571902
galEp3,0.3333333333333333,2,2,ATGTGCTCCATACATATATG,0,1560712
galEp3,0.3333333333333333,2,2,ATGTGAGGTAGAACTAGAGT,0,1580858
galEp3,0.3333333333333333,2,2,ATGTCGTTTAATCATAACCT,0,1582660
galEp3,0.3333333333333333,2,2,ATGTATTACGCTTCTTGAAC,0,1593231
galEp3,0.3333333333333333,2,2,ATGTACATATGAGGTACACG,0,1557851
galEp3,0.3333333333333333,2,2,ATGGTGAGGGAAATCTGTTT,0,1562537
galEp3,0.3333333333333333,2,2,ATGGTCTTGTCTACGACACC,0,1548505
galEp3,0.3333333333333333,2,2,ATGGGCATGGGTTAAACGTT,0,1564057
galEp3,0.3333333333333333,2,2,ATGGCTCATAATAAATACGT,0,1593345
galEp3,0.3333333333333333,2,2,ATGGCCGCCACGTAGAGTTC,0,1591607
galEp3,0.3333333333333333,2,2,ATGGCAAAAATTGCTCAAAT,0,1579544
galEp3,0.3333333333333333,2,2,ATGCGTGAACTAAGTGATGA,0,1561046
galEp3,0.3333333333333333,2,2,ATGCGGCTCGGCAAGTCCCA,0,1584294
galEp3,0.3333333333333333,2,2,ATGCGCCTGTCGAGCCTTAT,0,1590752
galEp3,0.3333333333333333,2,2,ATGCAGATTTTCTCGCGCTT,0,1579898
galEp3,0.3333333333333333,2,2,ATGATTTCGTGTGTTGCTCT,0,1573300
galEp3,0.3333333333333333,2,2,ATGATTGGAGAGACCCGGGA,0,1567193
galEp3,0.3333333333333333,2,2,ATGATGATCAACAAGGATGT,0,1563510
galEp3,0.3333333333333333,2,2,ATGAGTCTACCCTGCTAGGA,0,1593314
galEp3,0.3333333333333333,2,2,ATGAACACCATGCCTTTGAT,0,1552564
galEp3,0.3333333333333333,2,2,ATCTTTAAAGCAATTGCGGG,0,1558509
galEp3,0.3333333333333333,2,2,ATCTGACCAACCATTTTCAA,0,1551643
galEp3,0.3333333333333333,2,2,ATCTATTCGTTTAGCAGACA,0,1585697
galEp3,0.3333333333333333,2,2,ATCTAGTCGGAGTTCTATAC,0,1549577
galEp3,0.3333333333333333,2,2,ATCGTCAATAATAATACCCC,0,1589715
galEp3,0.3333333333333333,2,2,ATCGGTATGTACTCTATGTC,0,1585041
galEp3,0.3333333333333333,2,2,ATCGGGTCTAGAATAAGTAA,0,1591154
galEp3,0.3333333333333333,2,2,ATCGGGGCTGAGGTTCACTA,0,1552159
galEp3,0.3333333333333333,2,2,ATCGGCCTGCCTGTGGCCTG,0,1576589
galEp3,0.3333333333333333,2,2,ATCGGAGTAGTAGTGGGAGC,0,1550876
galEp3,0.3333333333333333,2,2,ATCGGAACAAAGGAATTTAA,0,1592300
galEp3,0.3333333333333333,2,2,ATCGCGGGTCCTGCAAGACG,0,1556307
galEp3,0.3333333333333333,2,2,ATCGCCGAGTGTGGACTTTC,0,1570280
galEp3,0.3333333333333333,2,2,ATCGCATTAAAGAGTGTCGT,0,1593095
galEp3,0.3333333333333333,2,2,ATCGATTGCGCATCGGGTAT,0,1560072
galEp3,0.3333333333333333,2,2,ATCCTTGATGGAGACGGAAG,0,1579069
galEp3,0.3333333333333333,2,2,ATCCTATACAGTGCGCTCGA,0,1565209
galEp3,0.3333333333333333,2,2,ATCCTATAATGAGGTTGTGT,0,1575714
galEp3,0.3333333333333333,2,2,ATCCGCGCCTCTTAGTTAGG,0,1553130
galEp3,0.3333333333333333,2,2,ATCCGAGGGCAAGCAATTCC,0,1546921
galEp3,0.3333333333333333,2,2,ATCCCTCATATGATCGTTCT,0,1552684
galEp3,0.3333333333333333,2,2,ATCCATATAGGGAGGGGAAT,0,1577846
galEp3,0.3333333333333333,2,2,ATCCACGTTTCGTTGAAGGG,0,1571490
galEp3,0.3333333333333333,2,2,ATCCACCAGTCTTGCCCAGG,0,1574366
galEp3,0.3333333333333333,2,2,ATCATCGGGTGAGTCGAGGC,0,1586747
galEp3,0.3333333333333333,2,2,ATCAGGTCGGAACAAAATCC,0,1560566
galEp3,0.3333333333333333,2,2,ATCAGCAGTGACAAAACATG,0,1559459
galEp3,0.3333333333333333,2,2,ATCACCTTGTGGCGTACCTC,0,1561676
galEp3,0.3333333333333333,2,2,ATCAAATTTGGTCCGCTTGT,0,1550300
galEp3,0.3333333333333333,2,2,ATATTTTATCGCAGATGGTG,0,1566082
galEp3,0.3333333333333333,2,2,ATATGTCACCACGGGGGTTG,0,1546754
galEp3,0.3333333333333333,2,2,ATATGGTCTGTGTGCATCTC,0,1590494
galEp3,0.3333333333333333,2,2,ATATCGTTTCGAAAGCACAG,0,1551080
galEp3,0.3333333333333333,2,2,ATATCCTTGGCCGATTAAAA,0,1573790
galEp3,0.3333333333333333,2,2,ATATCAATTTCACTCAGGAC,0,1548108
galEp3,0.3333333333333333,2,2,ATATATTTGGCTCGATGCTA,0,1549108
galEp3,0.3333333333333333,2,2,ATATATCAGCCAGTAAGAGG,0,1568554
galEp3,0.3333333333333333,2,2,ATATACGAGTACACCCCAAT,0,1594936
galEp3,0.3333333333333333,2,2,ATAGTAGGTACTTGTTCTCA,0,1591213
galEp3,0.3333333333333333,2,2,ATAGGTTTTGAAAGCCGCGC,0,1579411
galEp3,0.3333333333333333,2,2,ATAGACTCTGAACGATGTCA,0,1585009
galEp3,0.3333333333333333,2,2,ATAGACTAGCAAATGTCACT,0,1589085
galEp3,0.3333333333333333,2,2,ATACTTTGCGTCGTGACGGA,0,1573676
galEp3,0.3333333333333333,2,2,ATACTTGCGAACACGGATGA,0,1580604
galEp3,0.3333333333333333,2,2,ATACTCATTAGGACCGATAT,0,1569714
galEp3,0.3333333333333333,2,2,ATACTACCCGAGCTAACGTG,0,1560250
galEp3,0.3333333333333333,2,2,ATACGTAATATAGCATCCAG,0,1572813
galEp3,0.3333333333333333,2,2,ATACGGTTGCAGACCAGTCA,0,1588570
galEp3,0.3333333333333333,2,2,ATACGGGAAGATCCCGACCA,0,1548303
galEp3,0.3333333333333333,2,2,ATACGGCGCCCCCATCGTCT,0,1579284
galEp3,0.3333333333333333,2,2,ATACGCTGTACGGGTTACGG,0,1593920
galEp3,0.3333333333333333,2,2,ATACGCGATGTGAATGTTAC,0,1546705
galEp3,0.3333333333333333,2,2,ATACCCTGTGTCAACGCATA,0,1588757
galEp3,0.3333333333333333,2,2,ATACCCGCCATTTATGAAGA,0,1585740
galEp3,0.3333333333333333,2,2,ATACCACTCGATGATTTCCA,0,1557773
galEp3,0.3333333333333333,2,2,ATACAGTCGCGACTGTATCC,0,1550351
galEp3,0.3333333333333333,2,2,ATACACGGTTACGAGTTAGG,0,1590057
galEp3,0.3333333333333333,2,2,ATAAGATAAAAAATTCCAAT,0,1593537
galEp3,0.3333333333333333,2,2,ATAAACGTCCGGAGTGCTAA,0,1566637
galEp3,0.3333333333333333,2,2,AGTTAGTGAGATCATAAGTC,0,1550950
galEp3,0.3333333333333333,2,2,AGTTAGCGACGCCAGAAATG,0,1572702
galEp3,0.3333333333333333,2,2,AGTGTCAACGCAATGCCCAT,0,1580008
galEp3,0.3333333333333333,2,2,AGTGCTCAGTGGTGCGTGAT,0,1552931
galEp3,0.3333333333333333,2,2,AGTCCGATGAAAGGTCTTTT,0,1580988
galEp3,0.3333333333333333,2,2,AGTCCCTGGAGTTACCTGGC,0,1575298
galEp3,0.3333333333333333,2,2,AGTCAGGCTTGTGCCAGAAG,0,1592956
galEp3,0.3333333333333333,2,2,AGTAGACGTGTTGTTCCTGC,0,1574084
galEp3,0.3333333333333333,2,2,AGTACTACTGGTTATGTTGT,0,1561181
galEp3,0.3333333333333333,2,2,AGTAAGCGCCAGTAGGAGAT,0,1550037
galEp3,0.3333333333333333,2,2,AGTAACACCTTTTAAGTTAT,0,1556580
galEp3,0.3333333333333333,2,2,AGGTGTGCACACGACTCAAA,0,1568958
galEp3,0.3333333333333333,2,2,AGGTAGCCTTATTAATAGAA,0,1591905
galEp3,0.3333333333333333,2,2,AGGTAATCTTTACCAATTTT,0,1558810
galEp3,0.3333333333333333,2,2,AGGGTTTCGTTTATATACAG,0,1564687
galEp3,0.3333333333333333,2,2,AGGGTGAGTATGCCCATCGG,0,1562250
galEp3,0.3333333333333333,2,2,AGGGTAGAGACGGTTGGTTA,0,1588351
galEp3,0.3333333333333333,2,2,AGGGGTCTGGCCCATGTGCC,0,1547977
galEp3,0.3333333333333333,2,2,AGGGGTCAGCTCCTTGAATT,0,1591098
galEp3,0.3333333333333333,2,2,AGGGGCTGCGGCGGTTGAGC,0,1563070
galEp3,0.3333333333333333,2,2,AGGGGCAGCCCACCGATTGC,0,1563836
galEp3,0.3333333333333333,2,2,AGGGCTCACATTCGTCCGCA,0,1565016
galEp3,0.3333333333333333,2,2,AGGGCCGGAAGCGCCGTCGC,0,1564637
galEp3,0.3333333333333333,2,2,AGGGCCGCGACGATGGTTTA,0,1555468
galEp3,0.3333333333333333,2,2,AGGGATTACTTTCACGGGCA,0,1569786
galEp3,0.3333333333333333,2,2,AGGGACCATGTGATCCACAG,0,1557152
galEp3,0.3333333333333333,2,2,AGGGAATCGACGCGAGTGAT,0,1576242
galEp3,0.3333333333333333,2,2,AGGCTGTTTGTGTCATCGGG,0,1590746
galEp3,0.3333333333333333,2,2,AGGCTCCTAACTTCTTCGCA,0,1548875
galEp3,0.3333333333333333,2,2,AGGCGGAAGAATTAGCATGG,0,1547473
galEp3,0.3333333333333333,2,2,AGGCCTCATTTGTTCGCCAC,0,1586644
galEp3,0.3333333333333333,2,2,AGGCCCTGTTGCCAAGTGTT,0,1593141
galEp3,0.3333333333333333,2,2,AGGCATTGTTGAATGGTGGT,0,1547138
galEp3,0.3333333333333333,2,2,AGGCACTCCCAATTTCTAGT,0,1565827
galEp3,0.3333333333333333,2,2,AGGCAATTGTATAGCTGGAA,0,1554186
galEp3,0.3333333333333333,2,2,AGGATTCGGTCACATACAGC,0,1559485
galEp3,0.3333333333333333,2,2,AGGATAGGGGAGTCGGCCTC,0,1578267
galEp3,0.3333333333333333,2,2,AGGAGTGCACAGTCGGACAA,0,1553687
galEp3,0.3333333333333333,2,2,AGGAGGGGCTTACCAGGCCA,0,1560376
galEp3,0.3333333333333333,2,2,AGGAAGGTTACCCGGACCAG,0,1570393
galEp3,0.3333333333333333,2,2,AGGAACGTATGCAGGGAGAA,0,1554861
galEp3,0.3333333333333333,2,2,AGCTTTTGTAGTCCGGTATC,0,1559188
galEp3,0.3333333333333333,2,2,AGCTGGCCGAGGAACAGTAG,0,1553684
galEp3,0.3333333333333333,2,2,AGCTGAACTCGATCAATTCG,0,1592267
galEp3,0.3333333333333333,2,2,AGCTCAAGGGTAGGTGACAT,0,1586677
galEp3,0.3333333333333333,2,2,AGCTATGGCACGGTATAGGT,0,1551359
galEp3,0.3333333333333333,2,2,AGCTATGCTCCTTCGGACAG,0,1566954
galEp3,0.3333333333333333,2,2,AGCTATCCATGCTTAACAAT,0,1573195
galEp3,0.3333333333333333,2,2,AGCTATCCAACCCTAAACAA,0,1575612
galEp3,0.3333333333333333,2,2,AGCGTTGGCCGTGGGCACAA,0,1580146
galEp3,0.3333333333333333,2,2,AGCGTAGTTATTATGGTGTT,0,1550923
galEp3,0.3333333333333333,2,2,AGCGGTAAGGCATTTGATGG,0,1569172
galEp3,0.3333333333333333,2,2,AGCGGACGGAAGGGTCCGGA,0,1561508
galEp3,0.3333333333333333,2,2,AGCGCATCCTGAATCGATAC,0,1550293
galEp3,0.3333333333333333,2,2,AGCGAGTACCACGGTTTAAG,0,1589464
galEp3,0.3333333333333333,2,2,AGCCCATAACTCCCGCTATA,0,1573798
galEp3,0.3333333333333333,2,2,AGCCCAAGGTCCTTCGCCGC,0,1562281
galEp3,0.3333333333333333,2,2,AGCCACGGTCACCAACCCCC,0,1593379
galEp3,0.3333333333333333,2,2,AGCCACGCGCGTCGCGGTAG,0,1560663
galEp3,0.3333333333333333,2,2,AGCATGGAGCGGGAGGCCCG,0,1553819
galEp3,0.3333333333333333,2,2,AGCAGCAGGGCCGCGTTAAG,0,1575667
galEp3,0.3333333333333333,2,2,AGCACTCATTGTAAGAGGCA,0,1548284
galEp3,0.3333333333333333,2,2,AGATTTTTGCCCATGGGTTG,0,1565024
galEp3,0.3333333333333333,2,2,AGATGTCCACCGCATTATGG,0,1582897
galEp3,0.3333333333333333,2,2,AGATGATTGCAAAACACTTG,0,1591988
galEp3,0.3333333333333333,2,2,AGATGAAGGATGCCATTCTC,0,1578816
galEp3,0.3333333333333333,2,2,AGATCCACCTGATGACATTC,0,1587017
galEp3,0.3333333333333333,2,2,AGATAATATTATCTGGAATT,0,1568373
galEp3,0.3333333333333333,2,2,AGAGTCGGCCTGGTGAAACC,0,1557280
galEp3,0.3333333333333333,2,2,AGAGGTCCTGCAACACGGCT,0,1586898
galEp3,0.3333333333333333,2,2,AGAGAATATGTCGGTTGAGT,0,1587605
galEp3,0.3333333333333333,2,2,AGAGAACCTAATCGCATTCG,0,1558133
galEp3,0.3333333333333333,2,2,AGACTTATGATGTGAGTGGG,0,1556042
galEp3,0.3333333333333333,2,2,AGACGGTTGAGCGAAGCCCC,0,1587025
galEp3,0.3333333333333333,2,2,AGACGCATTCATAAGGTGAA,0,1577702
galEp3,0.3333333333333333,2,2,AGACCCATGGGAGGTGTCGT,0,1568096
galEp3,0.3333333333333333,2,2,AGACCCAATCCTTTTTGTAG,0,1571808
galEp3,0.3333333333333333,2,2,AGACATCACTAGCTGTACAT,0,1568005
galEp3,0.3333333333333333,2,2,AGACAAGGACAAATGGGAGA,0,1576999
galEp3,0.3333333333333333,2,2,AGAATGAAGTATAAAGGTTT,0,1559881
galEp3,0.3333333333333333,2,2,AGAAGTATGTTGCTCAGTAG,0,1577009
galEp3,0.3333333333333333,2,2,AGAACGTATCGATTGTATCT,0,1585539
galEp3,0.3333333333333333,2,2,AGAACACAGAGTATAGGTCA,0,1579136
galEp3,0.3333333333333333,2,2,AGAAACTTGTAAAGGGGCGC,0,1585073
galEp3,0.3333333333333333,2,2,ACTTTGTTTAATGCGATTCC,0,1549821
galEp3,0.3333333333333333,2,2,ACTTTGTGCAGGGGGCAGAA,0,1594342
galEp3,0.3333333333333333,2,2,ACTTTAGCGACGAAAGTCGC,0,1564852
galEp3,0.3333333333333333,2,2,ACTTGGGGTAGTACAGCACT,0,1548856
galEp3,0.3333333333333333,2,2,ACTTGGCCCCCGCGTATGTA,0,1570930
galEp3,0.3333333333333333,2,2,ACTTCGAGCTGACACGACGA,0,1591907
galEp3,0.3333333333333333,2,2,ACTTCAATCAACTCCAATTA,0,1579962
galEp3,0.3333333333333333,2,2,ACTTAGCGAAAATCAGCCGG,0,1558003
galEp3,0.3333333333333333,2,2,ACTTAATCCTTCCGGAAATC,0,1569295
galEp3,0.3333333333333333,2,2,ACTGTTTGCGAACTTCTAAG,0,1561130
galEp3,0.3333333333333333,2,2,ACTGTTTGAGGGCTCACCTC,0,1574946
galEp3,0.3333333333333333,2,2,ACTGGTTAAGTAATAAATTC,0,1562620
galEp3,0.3333333333333333,2,2,ACTGGGCGGCTTATTCGCCA,0,1586011
galEp3,0.3333333333333333,2,2,ACTGGAGCGAACACCACATA,0,1569941
galEp3,0.3333333333333333,2,2,ACTGCTGGGCCGTTCGAAGT,0,1567175
galEp3,0.3333333333333333,2,2,ACTGCGGTCGGCTAACTGGT,0,1548339
galEp3,0.3333333333333333,2,2,ACTGCGGCCCACTTTACAGA,0,1576436
galEp3,0.3333333333333333,2,2,ACTGCGCTCCGTTAGGTGGA,0,1576236
galEp3,0.3333333333333333,2,2,ACTGAAGGCATGGGGACTAT,0,1583793
galEp3,0.3333333333333333,2,2,ACTCTGCCCCTCTTAAGCGT,0,1593210
galEp3,0.3333333333333333,2,2,ACTCTCTTCGATCAGCCAGC,0,1588275
galEp3,0.3333333333333333,2,2,ACTCGTGTATCCCGCGCTCT,0,1586115
galEp3,0.3333333333333333,2,2,ACTCAGTACGGAGTTCATTT,0,1584833
galEp3,0.3333333333333333,2,2,ACTAAGTGGGATTCAGTAGG,0,1592685
galEp3,0.3333333333333333,2,2,ACTAACTCCAAAGCGCGGTA,0,1586424
galEp3,0.3333333333333333,2,2,ACTAAAGCAGACAACTCACA,0,1564968
galEp3,0.3333333333333333,2,2,ACGTTATCTGAGTGTAGGTT,0,1556096
galEp3,0.3333333333333333,2,2,ACGTGGCGTCTGCGGGAAAG,0,1556793
galEp3,0.3333333333333333,2,2,ACGTGGACTTTTCGATCTTA,0,1553858
galEp3,0.3333333333333333,2,2,ACGTCCATGCTCCTGATTTT,0,1568992
galEp3,0.3333333333333333,2,2,ACGTCATGGATTATGAACCT,0,1590208
galEp3,0.3333333333333333,2,2,ACGGTGTCTTTCACGCTGCG,0,1549473
galEp3,0.3333333333333333,2,2,ACGGTCTGCCTTAAGAATTC,0,1558250
galEp3,0.3333333333333333,2,2,ACGGGGGAGGTGTGACGTTC,0,1569988
galEp3,0.3333333333333333,2,2,ACGGCGTGGATTGGGCTGGA,0,1551075
galEp3,0.3333333333333333,2,2,ACGGCCTTTGCACTAATATA,0,1588273
galEp3,0.3333333333333333,2,2,ACGCTTTGGGCTTGTACAAG,0,1557323
galEp3,0.3333333333333333,2,2,ACGCGGCGAAGCGTGACACA,0,1564792
galEp3,0.3333333333333333,2,2,ACGCCATTTTGAATCATGAA,0,1578536
galEp3,0.3333333333333333,2,2,ACGCATGCCTCCCGAAACTC,0,1552689
galEp3,0.3333333333333333,2,2,ACGCATCTCCCGGGGGGAGT,0,1585309
galEp3,0.3333333333333333,2,2,ACGAGTCCTGCTAGTATCAG,0,1583825
galEp3,0.3333333333333333,2,2,ACGAGGGGTTGCATCCGGAC,0,1577585
galEp3,0.3333333333333333,2,2,ACCTGTTCATGTTAGAGGCT,0,1553555
galEp3,0.3333333333333333,2,2,ACCTATCACGGGGACGACTG,0,1594014
galEp3,0.3333333333333333,2,2,ACCTACAGCGTTTGCGACGG,0,1576553
galEp3,0.3333333333333333,2,2,ACCTAAGCGGTTGGCATAAC,0,1560524
galEp3,0.3333333333333333,2,2,ACCGTAAACGGCCTTAATCA,0,1549345
galEp3,0.3333333333333333,2,2,ACCGGTAGGTGCAAAGCCCT,0,1578539
galEp3,0.3333333333333333,2,2,ACCGCAATTAAACGATACCT,0,1547978
galEp3,0.3333333333333333,2,2,ACCGATTATTGACAGGCTAA,0,1564611
galEp3,0.3333333333333333,2,2,ACCGACTGGCGGGGGTATTT,0,1547244
galEp3,0.3333333333333333,2,2,ACCGAATTGAGAACCGATTG,0,1587045
galEp3,0.3333333333333333,2,2,ACCCTAAAGTGCCACCCCCC,0,1591066
galEp3,0.3333333333333333,2,2,ACCCGGGAGCAATAATTCAC,0,1551586
galEp3,0.3333333333333333,2,2,ACCCAGTGTGGCCTATCGTG,0,1552789
galEp3,0.3333333333333333,2,2,ACCATTCCATGGGCTGGAGG,0,1564829
galEp3,0.3333333333333333,2,2,ACCAGTTCGACTAAACATTG,0,1576801
galEp3,0.3333333333333333,2,2,ACCAGCTCCTGACGGGTATC,0,1578008
galEp3,0.3333333333333333,2,2,ACCAGCGGTGCATGCAGCGG,0,1582664
galEp3,0.3333333333333333,2,2,ACCAGCACCAGTGGTAAGTT,0,1547636
galEp3,0.3333333333333333,2,2,ACCACGGCCGCCAGGGTGAA,0,1556950
galEp3,0.3333333333333333,2,2,ACCACAGATAGGACAAATCC,0,1567843
galEp3,0.3333333333333333,2,2,ACCAAAGGTTTCTAAATACT,0,1592964
galEp3,0.3333333333333333,2,2,ACATTTTCATTCAATCATTT,0,1592283
galEp3,0.3333333333333333,2,2,ACATTCTGACTGTGCTGCCA,0,1592325
galEp3,0.3333333333333333,2,2,ACATGCCGTCGCATTCTGCC,0,1578505
galEp3,0.3333333333333333,2,2,ACAGGCGATGCGTCTACCCG,0,1589828
galEp3,0.3333333333333333,2,2,ACAGGACACCTGGTGGCATT,0,1575416
galEp3,0.3333333333333333,2,2,ACAGCGTCACATACAAATTA,0,1593412
galEp3,0.3333333333333333,2,2,ACAGCACTCGTAAGGGGTAA,0,1567774
galEp3,0.3333333333333333,2,2,ACAGCAACAATTCGCTGACG,0,1555112
galEp3,0.3333333333333333,2,2,ACAGAGCAGCCACATAGTTA,0,1584293
galEp3,0.3333333333333333,2,2,ACACCACGCGGACGTGTGAG,0,1592513
galEp3,0.3333333333333333,2,2,ACACATTCTCCCCCAGTGTA,0,1571558
galEp3,0.3333333333333333,2,2,ACACATGTGGCCTCCGGGCT,0,1550879
galEp3,0.3333333333333333,2,2,ACACAGCGCATTCGTCCGGC,0,1587155
galEp3,0.3333333333333333,2,2,ACACAGAGTAAGGATAGCTA,0,1546569
galEp3,0.3333333333333333,2,2,ACAATTTGTGAACGAGCTGG,0,1560885
galEp3,0.3333333333333333,2,2,ACAATTTGGCTTTTCTACCC,0,1557232
galEp3,0.3333333333333333,2,2,ACAAGATGGGAGAATTTTAT,0,1565886
galEp3,0.3333333333333333,2,2,ACAAGAGTCTGGTGCAGCGA,0,1577480
galEp3,0.3333333333333333,2,2,ACAAATTAGCACGTCATCGG,0,1585505
galEp3,0.3333333333333333,2,2,ACAAACCCATTCTCGCACAA,0,1548194
galEp3,0.3333333333333333,2,2,ACAAACCAGTTGGCCCCTGA,0,1550456
galEp3,0.3333333333333333,2,2,AATTTTCTGCGCGGTGTTAG,0,1553067
galEp3,0.3333333333333333,2,2,AATTTACCGACTGGCAAGGG,0,1594602
galEp3,0.3333333333333333,2,2,AATTGTTGATACGTCAGCTC,0,1574778
galEp3,0.3333333333333333,2,2,AATTGTTGAAGGACTTTAGA,0,1592244
galEp3,0.3333333333333333,2,2,AATTCAGACGACGAGTCCGT,0,1569513
galEp3,0.3333333333333333,2,2,AATTAGCGAAAACTGATGCT,0,1553761
galEp3,0.3333333333333333,2,2,AATGTCACAGTGGACGAACC,0,1553520
galEp3,0.3333333333333333,2,2,AATGGAATTTGGGTCTATAT,0,1593814
galEp3,0.3333333333333333,2,2,AATGCACAAATTTGACTGCC,0,1576537
galEp3,0.3333333333333333,2,2,AATCTGCTTCTTACTTGATT,0,1586012
galEp3,0.3333333333333333,2,2,AATCGTACTACTTATTCATG,0,1593666
galEp3,0.3333333333333333,2,2,AATCGAGGTTCAAGGGTATA,0,1556593
galEp3,0.3333333333333333,2,2,AATCGAGAAGGTGTGGGTCT,0,1583895
galEp3,0.3333333333333333,2,2,AATCGAAGAATGTATCTAGA,0,1578626
galEp3,0.3333333333333333,2,2,AATCCGGATCAGCGGTGATG,0,1559973
galEp3,0.3333333333333333,2,2,AATCCGCATCTCTGTCTAGG,0,1557800
galEp3,0.3333333333333333,2,2,AATCCAGACCGAGTGACACT,0,1553792
galEp3,0.3333333333333333,2,2,AATCATGGTGCCTCTTCCTG,0,1556877
galEp3,0.3333333333333333,2,2,AATCATCGAGTTTGCCTCAG,0,1588590
galEp3,0.3333333333333333,2,2,AATATTACGTAACGTGATAT,0,1568370
galEp3,0.3333333333333333,2,2,AATATACATTTTCGCTAAAC,0,1574047
galEp3,0.3333333333333333,2,2,AATACGCAATAGCAACGGGA,0,1563261
galEp3,0.3333333333333333,2,2,AATACAGGTCCTAATCTAGG,0,1556264
galEp3,0.3333333333333333,2,2,AATAATCTACGTAGGGTGGG,0,1585569
galEp3,0.3333333333333333,2,2,AATAACACATCGACGGCAAC,0,1585452
galEp3,0.3333333333333333,2,2,AAGTTCGCTGAGTGGCTTAT,0,1589080
galEp3,0.3333333333333333,2,2,AAGTGTGTAGTTCCGGGGAC,0,1579929
galEp3,0.3333333333333333,2,2,AAGTGCCCGAAACGGTAAGA,0,1563025
galEp3,0.3333333333333333,2,2,AAGGTTCTGGCCGGGTTTTC,0,1571242
galEp3,0.3333333333333333,2,2,AAGGTCGTCGTGGTGCGAAA,0,1554320
galEp3,0.3333333333333333,2,2,AAGGGTGTTTCTGCGGTCGC,0,1555956
galEp3,0.3333333333333333,2,2,AAGGCTGCTTTGCCGCTGCG,0,1574527
galEp3,0.3333333333333333,2,2,AAGGCGATTTGGCTTGAATT,0,1585005
galEp3,0.3333333333333333,2,2,AAGGCCTGAAGCTGACTGCG,0,1547275
galEp3,0.3333333333333333,2,2,AAGGCCAGCGTATTACGGCA,0,1548795
galEp3,0.3333333333333333,2,2,AAGGAGTGAAGCGCACAGCT,0,1590877
galEp3,0.3333333333333333,2,2,AAGGAGATCTAAGGATTTAG,0,1581076
galEp3,0.3333333333333333,2,2,AAGCTTGGTTGCGCTGGCCA,0,1555202
galEp3,0.3333333333333333,2,2,AAGCTTGGGTGTAGATCTCA,0,1553786
galEp3,0.3333333333333333,2,2,AAGCGGAACCCCTTCAGTAT,0,1587132
galEp3,0.3333333333333333,2,2,AAGCAGGGTGGTTTTAAGTA,0,1575851
galEp3,0.3333333333333333,2,2,AAGAAATGAAGGGCAGTATT,0,1548791
galEp3,0.3333333333333333,2,2,AACTTGAAGAAATCTGTTGT,0,1589004
galEp3,0.3333333333333333,2,2,AACTTAACGGCAATTAGGCT,0,1568303
galEp3,0.3333333333333333,2,2,AACTGGTCAGTGGGCCACGA,0,1580508
galEp3,0.3333333333333333,2,2,AACTCGAGCTTTCTAACACG,0,1561743
galEp3,0.3333333333333333,2,2,AACTCATCTTCTATTTCAGA,0,1592713
galEp3,0.3333333333333333,2,2,AACGTTGAAGCGTGTCCTGG,0,1593997
galEp3,0.3333333333333333,2,2,AACGGTTTTAGTCTAGCGCA,0,1570921
galEp3,0.3333333333333333,2,2,AACGGCATCTGTTATTGGGT,0,1594675
galEp3,0.3333333333333333,2,2,AACGCGAGTGATGCTACCTT,0,1587489
galEp3,0.3333333333333333,2,2,AACGAGGGTAGCCCCATCAC,0,1564753
galEp3,0.3333333333333333,2,2,AACGAAGTAGTATTATCAGA,0,1566561
galEp3,0.3333333333333333,2,2,AACCGTTCAGATTACCGTTA,0,1577123
galEp3,0.3333333333333333,2,2,AACCGGCCCTGCCGAATTAT,0,1571010
galEp3,0.3333333333333333,2,2,AACCGACCCTTAACCACTTG,0,1563332
galEp3,0.3333333333333333,2,2,AACCCCGGGGGACTGTGAAG,0,1566188
galEp3,0.3333333333333333,2,2,AACCCACGTAAGACTTAGTT,0,1571705
galEp3,0.3333333333333333,2,2,AACCAGTATGGAGGGACACC,0,1576759
galEp3,0.3333333333333333,2,2,AACATCGAATTAGATGCAAA,0,1557196
galEp3,0.3333333333333333,2,2,AACAGTATCTTGATTGCGAG,0,1579425
galEp3,0.3333333333333333,2,2,AACAGGTCTGCGTATGTAAG,0,1549792
galEp3,0.3333333333333333,2,2,AACAGCTTACATCCATCGTC,0,1547774
galEp3,0.3333333333333333,2,2,AACAGCGTGTCTTCTTCTTC,0,1558373
galEp3,0.3333333333333333,2,2,AACAGCATAGCAGTCCGTTT,0,1553955
galEp3,0.3333333333333333,2,2,AACACTGATCCATAAATTTT,0,1560030
galEp3,0.3333333333333333,2,2,AACACCTGACGTTATTACTT,0,1570475
galEp3,0.3333333333333333,2,2,AACAACATTCAATGAACTCA,0,1555224
galEp3,0.3333333333333333,2,2,AAATTTCTCACTCCGGTTCA,0,1562161
galEp3,0.3333333333333333,2,2,AAATGTCACAACGTCAGGGT,0,1561751
galEp3,0.3333333333333333,2,2,AAATGTACAGCTGTGAATGC,0,1561285
galEp3,0.3333333333333333,2,2,AAATCGCCGTGGCGACTCAA,0,1593787
galEp3,0.3333333333333333,2,2,AAATCATAGGTTCGCCCTCG,0,1589830
galEp3,0.3333333333333333,2,2,AAATAGCTTAATTCTATTTT,0,1551178
galEp3,0.3333333333333333,2,2,AAAGTGATTCAATGGCCACT,0,1564573
galEp3,0.3333333333333333,2,2,AAAGGGGCTCGCAACGGCTT,0,1566073
galEp3,0.3333333333333333,2,2,AAAGGCTTCTTTTCAACATT,0,1547111
galEp3,0.3333333333333333,2,2,AAAGGAAGTTGTAAAAAATC,0,1562983
galEp3,0.3333333333333333,2,2,AAAGATGAGTCACGTTTATA,0,1577670
galEp3,0.3333333333333333,2,2,AAAGAAACAGCCGTAGAGGA,0,1555552
galEp3,0.3333333333333333,2,2,AAACTCCGCATGGTAGCCAT,0,1560291
galEp3,0.3333333333333333,2,2,AAACTACCAGGATGAACTTG,0,1569268
galEp3,0.3333333333333333,2,2,AAACGGAAACGGTTCTCTTA,0,1561977
galEp3,0.3333333333333333,2,2,AAACGCGAAGCTGCTCTGGT,0,1593396
galEp3,0.3333333333333333,2,2,AAACGCCAGGCTCCAAGGTT,0,1571876
galEp3,0.3333333333333333,2,2,AAACCGTGTTGAAGTCACCT,0,1574124
galEp3,0.3333333333333333,2,2,AAACAGTTATGTAACTTTAC,0,1578902
galEp3,0.3333333333333333,2,2,AAAATTCCCGGCTCAATTGT,0,1548185
galEp3,0.3333333333333333,2,2,AAAATCTGGTGTACGGTGGA,0,1566780
galEp3,0.3333333333333333,2,2,AAAATCTGCATCAAGGCGCT,0,1588759
galEp3,0.3333333333333333,2,2,AAAATATTTGCTGTGCTACA,0,1574014
galEp3,0.3333333333333333,2,2,AAAAGTGAAATCTCTCTAAT,0,1585918
galEp3,0.3333333333333333,2,2,AAAAGTCCTTCAAATCGGAC,0,1583984
galEp3,0.3333333333333333,2,2,AAAAGTACAAGGAGAAAGGC,0,1546557
galEp3,0.3333333333333333,2,2,AAAAGGTGCCATGGAATATA,0,1574816
galEp3,0.3333333333333333,2,2,AAAAGGAGCGCGGCCCCTCG,0,1582111
galEp3,0.3333333333333333,2,2,AAAACTTATGAAATATACTT,0,1547790
galEp3,0.3333333333333333,2,2,AAAACGACGTCGGATAGGTC,0,1558738
galEp3,0.3333333333333333,2,2,AAAACATGTGCCCTATTGAA,0,1553085
galEp3,0.3333333333333333,2,2,AAAAAGTAGTGTTGTTACCT,0,1562881
galEp3,0.5,1,1,TTTTTTAAGATTCAGGAATA,0,1571807
galEp3,0.5,1,1,TTTTTGAGCGTGAATATGAT,0,1567775
galEp3,0.5,1,1,TTTTTATGGAAGTTACTGGA,0,1594050
galEp3,0.5,1,1,TTTTGCTTGTCCCCACCGAG,0,1569918
galEp3,0.5,1,1,TTTTGCGTCTCGATGATGAG,0,1569041
galEp3,0.5,1,1,TTTTGATGGAGATGCAAGTA,0,1591975
galEp3,0.5,1,1,TTTTCTTCGAGAAATTAAGG,0,1583900
galEp3,0.5,1,1,TTTTCTCATGTGCACCAGTA,0,1564440
galEp3,0.5,1,1,TTTTCGGTGAGGGGCGTCAA,0,1547491
galEp3,0.5,1,1,TTTTCGAGTGTGTGCCTGTC,0,1584734
galEp3,0.5,1,1,TTTTCCGATGGTTGAAGGGG,0,1552589
galEp3,0.5,1,1,TTTTCAACATACCGGGTTGG,0,1571363
galEp3,0.5,1,1,TTTTATGCCGATTCCACCAG,0,1548673
galEp3,0.5,1,1,TTTTAAGTACAGCGTGTACA,0,1586372
galEp3,0.5,1,1,TTTGTGCTGAAAAAACGGGC,0,1568849
galEp3,0.5,1,1,TTTGGTTGGACCTTGAGGGT,0,1553253
galEp3,0.5,1,1,TTTGCTTCAACAGTTAGCTA,0,1588480
galEp3,0.5,1,1,TTTGCATATCCGTGTAGTTC,0,1594676
galEp3,0.5,1,1,TTTGAACGTTTAGCGGATGT,0,1589219
galEp3,0.5,1,1,TTTCTTCGTCACAGGGAGAA,0,1556211
galEp3,0.5,1,1,TTTCTGAGTTTTCGTACGTT,0,1585623
galEp3,0.5,1,1,TTTCTAGTAAGACGCCTGCA,0,1554798
galEp3,0.5,1,1,TTTCCACAGCTGCATTGCGG,0,1556791
galEp3,0.5,1,1,TTTCCAAGGGATGTAAGTAG,0,1547720
galEp3,0.5,1,1,TTTCACAGAGTCGGGTCTTG,0,1572158
galEp3,0.5,1,1,TTTATGGCGACAGGTAGCAA,0,1594940
galEp3,0.5,1,1,TTTATAGACCCACGGTAACA,0,1554426
galEp3,0.5,1,1,TTTATAAAACTACCCCTGTG,0,1571239
galEp3,0.5,1,1,TTTACCAGAGCTGCAGCGAC,0,1555118
galEp3,0.5,1,1,TTTACACCGCGCCCATTGGT,0,1580152
galEp3,0.5,1,1,TTTAACCTACCGGGGGTAAT,0,1585187
galEp3,0.5,1,1,TTTAAATGTGGGATGACCTG,0,1557012
galEp3,0.5,1,1,TTGTTTATACGCTGTGTATA,0,1556730
galEp3,0.5,1,1,TTGTTGTAGGAAGTGAGCTA,0,1579158
galEp3,0.5,1,1,TTGTGCGAACTGAGGGGTGT,0,1580040
galEp3,0.5,1,1,TTGTGCATATCAGCACTACT,0,1552678
galEp3,0.5,1,1,TTGTCGGTCCCACACAGCTC,0,1555560
galEp3,0.5,1,1,TTGTCGGTAAGAGCATAGCG,0,1568617
galEp3,0.5,1,1,TTGTATCTTCACTGGTCGAA,0,1558737
galEp3,0.5,1,1,TTGTAGCGCAGAGCCGTCGA,0,1571208
galEp3,0.5,1,1,TTGTAGCCCTCTAGAGATAC,0,1585573
galEp3,0.5,1,1,TTGTACCGTCGATGTTGGTA,0,1593079
galEp3,0.5,1,1,TTGGTGACCCATACCCCGTA,0,1577631
galEp3,0.5,1,1,TTGGTGACACGCGGGACTTT,0,1554994
galEp3,0.5,1,1,TTGGTATGCTCGTAATAGGT,0,1569013
galEp3,0.5,1,1,TTGGGTTACGTTGACATCTT,0,1590271
galEp3,0.5,1,1,TTGGGCGTCTCCACTTTATA,0,1555381
galEp3,0.5,1,1,TTGGCGTTACGGTGGCAGGG,0,1559661
galEp3,0.5,1,1,TTGGCACCCTAGGCTTACTC,0,1587506
galEp3,0.5,1,1,TTGGCAAGGTTCGGCCGTAT,0,1572844
galEp3,0.5,1,1,TTGGATAGTCTACAAACGAT,0,1574619
galEp3,0.5,1,1,TTGCTAAGTAGGGACAGCAT,0,1568879
galEp3,0.5,1,1,TTGCGTCCATTACAACATGG,0,1572979
galEp3,0.5,1,1,TTGCGACGTCGGGAAACTCT,0,1549332
galEp3,0.5,1,1,TTGCCGTACCTGCTGGTACA,0,1561744
galEp3,0.5,1,1,TTGCAGAGCTTATGTTCGTG,0,1585553
galEp3,0.5,1,1,TTGCACGGCCTGGTCTATCA,0,1589974
galEp3,0.5,1,1,TTGCACGCTAGGCAGCCTGC,0,1573888
galEp3,0.5,1,1,TTGCAATCACCGACCCTGAT,0,1590248
galEp3,0.5,1,1,TTGATCTCAATCGCGGGTGA,0,1550548
galEp3,0.5,1,1,TTGATAGCTGTCGTTCGGCA,0,1589388
galEp3,0.5,1,1,TTGATAAGCGTTTCTCGACT,0,1581452
galEp3,0.5,1,1,TTGAGGGAATAACCGCCTAA,0,1560303
galEp3,0.5,1,1,TTGAGCTTCCTATTTCTATA,0,1575776
galEp3,0.5,1,1,TTGACGCTGACTCAGCTCGC,0,1580316
galEp3,0.5,1,1,TTGAACGGCCGGGTTAACTC,0,1594412
galEp3,0.5,1,1,TTGAAATGGCGCCTTCAAGG,0,1576562
galEp3,0.5,1,1,TTCTTTTTGCGTCATTACAC,0,1588698
galEp3,0.5,1,1,TTCTTCACAAGCGACCGGTG,0,1577759
galEp3,0.5,1,1,TTCTGCCTCCACTTATAGGG,0,1568527
galEp3,0.5,1,1,TTCTGACCGACCAACGAGGC,0,1574343
galEp3,0.5,1,1,TTCTCCACCCATGTGAATGG,0,1582106
galEp3,0.5,1,1,TTCTAGCCAACTGGGCAATA,0,1580344
galEp3,0.5,1,1,TTCTAATCGCGCTTCGTCAA,0,1586269
galEp3,0.5,1,1,TTCGTAAAGTTGTATTATGA,0,1583381
galEp3,0.5,1,1,TTCGGTTTTTCATTGATAAT,0,1549495
galEp3,0.5,1,1,TTCGGACCCTTCAAGACGAA,0,1567657
galEp3,0.5,1,1,TTCGCTCGTTGCGGTCGGGT,0,1553259
galEp3,0.5,1,1,TTCGCTCGTGCCCAGTTCCC,0,1573711
galEp3,0.5,1,1,TTCGCGCTACGCATTCACAC,0,1583214
galEp3,0.5,1,1,TTCGACCTCACAATGTGGCC,0,1583063
galEp3,0.5,1,1,TTCCTTCGACGCACACGGCG,0,1589809
galEp3,0.5,1,1,TTCCTTATGGCGTAGAGGGA,0,1567935
galEp3,0.5,1,1,TTCCTAGGAGGGGAAACGCA,0,1563877
galEp3,0.5,1,1,TTCCGATTCCGTAATTGGTT,0,1548754
galEp3,0.5,1,1,TTCCATGCATTCTCCCTTAG,0,1585414
galEp3,0.5,1,1,TTCATTTTCAAGCTTCCCGA,0,1576405
galEp3,0.5,1,1,TTCATATAGTTCCAGGTTCC,0,1558818
galEp3,0.5,1,1,TTCATACGGGACTTTCTAAC,0,1562405
galEp3,0.5,1,1,TTCAGTGATGCGAACAGCAT,0,1587104
galEp3,0.5,1,1,TTCACTAGCGGAAGCACGGG,0,1587767
galEp3,0.5,1,1,TTCACACATACTCTCGACGC,0,1584190
galEp3,0.5,1,1,TTCAAGCGAACTAGCCAGGC,0,1556090
galEp3,0.5,1,1,TTATTTAATTAGAGCATCGT,0,1587599
galEp3,0.5,1,1,TTATTGACAACCGTCATGAA,0,1568151
galEp3,0.5,1,1,TTATGCGCCGAAGTGGTAAT,0,1570551
galEp3,0.5,1,1,TTATATCCAACTCTATTGCG,0,1577499
galEp3,0.5,1,1,TTATAATAGCCGGTCTTGTC,0,1571653
galEp3,0.5,1,1,TTATAACTCACGAGTGAAGA,0,1593042
galEp3,0.5,1,1,TTAGTTTGGGGAAAGTATTG,0,1548009
galEp3,0.5,1,1,TTAGTAACCGAGATAGCTAA,0,1583910
galEp3,0.5,1,1,TTAGGATGGCCGAATACCTG,0,1561226
galEp3,0.5,1,1,TTAGGATCCATGATTTTTCT,0,1559590
galEp3,0.5,1,1,TTAGGACCGCACATAATCAA,0,1570769
galEp3,0.5,1,1,TTAGATACATCCCGAAAGCT,0,1586425
galEp3,0.5,1,1,TTAGAGATGTAGAGGTCACC,0,1578630
galEp3,0.5,1,1,TTAGACCGTCCAGGCCGACA,0,1572206
galEp3,0.5,1,1,TTAGAATGCTGATTTTCCGG,0,1564552
galEp3,0.5,1,1,TTACTTCTTGACGTGTCAAG,0,1548955
galEp3,0.5,1,1,TTACTGGATGCAGTAGTCCT,0,1593588
galEp3,0.5,1,1,TTACTCCGCCGACGCTCCAC,0,1581548
galEp3,0.5,1,1,TTACTCCCTCTCCTCATATC,0,1586911
galEp3,0.5,1,1,TTACGGGGCGTCCAAGCACT,0,1584401
galEp3,0.5,1,1,TTACGATGATCGGTCGGAGT,0,1583149
galEp3,0.5,1,1,TTACAGGAGACTGCTTGTAT,0,1577189
galEp3,0.5,1,1,TTACAACGGGAGTTTTAGGA,0,1558576
galEp3,0.5,1,1,TTACAAAGGGGTCAGAGCTG,0,1569878
galEp3,0.5,1,1,TTAATAGTTAGCTCCCGATC,0,1546709
galEp3,0.5,1,1,TTAACTTCCTAGTCCTAATA,0,1567837
galEp3,0.5,1,1,TTAACGCATTTAGAGACAAT,0,1550777
galEp3,0.5,1,1,TTAACATGTATCTCCAGGAC,0,1549706
galEp3,0.5,1,1,TTAAATTCCGTATTAAGTGT,0,1590578
galEp3,0.5,1,1,TGTTTTGACTAATCGGGGGT,0,1569018
galEp3,0.5,1,1,TGTTTTCAAGGTATTCGAAG,0,1594974
galEp3,0.5,1,1,TGTTGGTCGAACTGTGCATA,0,1591129
galEp3,0.5,1,1,TGTTGGCAGATCAAATGGTG,0,1552515
galEp3,0.5,1,1,TGTTAGCCCAAGTCGTAAGC,0,1547866
galEp3,0.5,1,1,TGTGTTGTTTCTCACAAAGC,0,1555954
galEp3,0.5,1,1,TGTGTCAAATACCATTCGGT,0,1556263
galEp3,0.5,1,1,TGTGTAGCTTCAGAAGGGCA,0,1593494
galEp3,0.5,1,1,TGTGGGACCCCCTGTGTACT,0,1590284
galEp3,0.5,1,1,TGTGGCGAAACTACGGCTTG,0,1566080
galEp3,0.5,1,1,TGTGCTTAAGCGGACGCCTG,0,1548480
galEp3,0.5,1,1,TGTGCCCACTAACTTATGCA,0,1591709
galEp3,0.5,1,1,TGTGATCCACTAGACAGCGG,0,1577677
galEp3,0.5,1,1,TGTCGAGAAATACTCAAACG,0,1551531
galEp3,0.5,1,1,TGTCCCTCCCCTCCACTCTG,0,1565859
galEp3,0.5,1,1,TGTCCCATTTTGTGTATCTA,0,1567397
galEp3,0.5,1,1,TGTCCCATATGGCCAATAGT,0,1572255
galEp3,0.5,1,1,TGTCAGGGACTACAGATTGA,0,1563499
galEp3,0.5,1,1,TGTCAGCCAGCATGCGCGTG,0,1582059
galEp3,0.5,1,1,TGTCACTATCGGGACGTAAC,0,1571124
galEp3,0.5,1,1,TGTCACAGCAGAATTGGGTT,0,1591693
galEp3,0.5,1,1,TGTATGTATGATACACAGGC,0,1562717
galEp3,0.5,1,1,TGTAGGTAAGTGGGTTGTCT,0,1547140
galEp3,0.5,1,1,TGTACTCGCGTCTCTGAGAT,0,1563014
galEp3,0.5,1,1,TGTACGCGTATTGCTAAGCA,0,1582663
galEp3,0.5,1,1,TGTACATAGTCCTAGACAAC,0,1586573
galEp3,0.5,1,1,TGTAAAGAATGCGACTAACA,0,1547021
galEp3,0.5,1,1,TGGTTACACAAACATGTCGT,0,1548251
galEp3,0.5,1,1,TGGTGTAGGTCTGGCGTGAC,0,1570391
galEp3,0.5,1,1,TGGTGGCCGGCACTACGTCA,0,1553165
galEp3,0.5,1,1,TGGTGCCTGATATAATTTGT,0,1585190
galEp3,0.5,1,1,TGGTCAGCGTTTTCCCACGA,0,1569989
galEp3,0.5,1,1,TGGTAATGCGTTCGGAGGCC,0,1587544
galEp3,0.5,1,1,TGGGTATACGCCTCTGCCTT,0,1548729
galEp3,0.5,1,1,TGGGGCCAGATTTCTCCCAA,0,1585716
galEp3,0.5,1,1,TGGGACTCATTTTCGTGGGG,0,1582751
galEp3,0.5,1,1,TGGCTGTGAATCTCATGCTG,0,1570283
galEp3,0.5,1,1,TGGCGTCCTTAAAGCGTAAT,0,1548865
galEp3,0.5,1,1,TGGCGCCATACGTTCGGGTC,0,1584300
galEp3,0.5,1,1,TGGCGCAAGGAATGGTCTGT,0,1584511
galEp3,0.5,1,1,TGGCCTAGGCCCTCGATACC,0,1592282
galEp3,0.5,1,1,TGGCCCTAGAATAGTGAGCA,0,1559912
galEp3,0.5,1,1,TGGCCCGAACTGCCTCATTT,0,1562242
galEp3,0.5,1,1,TGGCAGGGAGCTTACTTAGA,0,1576232
galEp3,0.5,1,1,TGGATCTGAACGCACACCAG,0,1560148
galEp3,0.5,1,1,TGGATCCTCGAGGCTAATAT,0,1567852
galEp3,0.5,1,1,TGGATCATTCGCACCAATGA,0,1576334
galEp3,0.5,1,1,TGGAGCTGAGTACGCACTCA,0,1589000
galEp3,0.5,1,1,TGGAGATCGGGAATAACATC,0,1551649
galEp3,0.5,1,1,TGGACGTCGTGATCATGTTA,0,1593297
galEp3,0.5,1,1,TGGACGGAATCATGGCTCCC,0,1555992
galEp3,0.5,1,1,TGGAACCGCCAGGGAAATGC,0,1594707
galEp3,0.5,1,1,TGGAACAGGAGAAAGTGTAC,0,1564526
galEp3,0.5,1,1,TGCTTGTTCCCCGTGTCTCA,0,1572329
galEp3,0.5,1,1,TGCTTGATCTGGCGGATTAT,0,1576013
galEp3,0.5,1,1,TGCTTCACACCCCGCTAAGT,0,1558705
galEp3,0.5,1,1,TGCTCCTACGGCAGTAGCAC,0,1573413
galEp3,0.5,1,1,TGCTCCGTTGGGTAAATTCT,0,1555856
galEp3,0.5,1,1,TGCTCCCCACCGGAAGGCCC,0,1592564
galEp3,0.5,1,1,TGCTCAGGATCGAACTCCAT,0,1565062
galEp3,0.5,1,1,TGCTAGGCAACGTCTTAGTT,0,1585601
galEp3,0.5,1,1,TGCGTGCTGTGTCGATACGT,0,1562243
galEp3,0.5,1,1,TGCGTAGTGTTGCAGTTGTC,0,1582665
galEp3,0.5,1,1,TGCGGCCTATGACACCCATC,0,1547309
galEp3,0.5,1,1,TGCGCTATCTATATGATGCA,0,1594363
galEp3,0.5,1,1,TGCGCGGTATAGTTTGACAT,0,1576763
galEp3,0.5,1,1,TGCGCCCCGTAAGTTCCCTT,0,1559472
galEp3,0.5,1,1,TGCGACTGGCCTTGTCCTTG,0,1585923
galEp3,0.5,1,1,TGCGACATTTGGGAGGCTAT,0,1548248
galEp3,0.5,1,1,TGCGACATCCCTGTAGTATA,0,1579264
galEp3,0.5,1,1,TGCCGCATCGCTCTAGTAGT,0,1573817
galEp3,0.5,1,1,TGCCCTTCACGTTTCTACCT,0,1583694
galEp3,0.5,1,1,TGCCATCATCCTAGATACAC,0,1567533
galEp3,0.5,1,1,TGCATAGGCAGAAAGGCCCT,0,1580652
galEp3,0.5,1,1,TGCAGGGTGTCATGCCGGGA,0,1567531
galEp3,0.5,1,1,TGCACTTTTGTTCGCAAGCC,0,1556311
galEp3,0.5,1,1,TGCAATGTCCGGCCATTTTC,0,1562409
galEp3,0.5,1,1,TGCAACTGTGGCACTACGTG,0,1582659
galEp3,0.5,1,1,TGATGGCCGCCTTGGGGCAA,0,1546984
galEp3,0.5,1,1,TGATCAGCCGGGGATGGGAC,0,1574480
galEp3,0.5,1,1,TGATATTCGGAAAGGAATAG,0,1555436
galEp3,0.5,1,1,TGATAGTCTTGGTAACTTAG,0,1585638
galEp3,0.5,1,1,TGAGTGGAGATGTCCCGCTC,0,1583689
galEp3,0.5,1,1,TGAGTCCACTACGCTGTCAT,0,1567324
galEp3,0.5,1,1,TGAGTAGAGCTATCCGGCCC,0,1573644
galEp3,0.5,1,1,TGAGTAACCTTAGATTCCTG,0,1580708
galEp3,0.5,1,1,TGAGGGCTTGCAAATCCTAT,0,1562105
galEp3,0.5,1,1,TGAGGGCGGAGCATTAAAGA,0,1558883
galEp3,0.5,1,1,TGAGCTTCTTGGACCCGTTC,0,1590249
galEp3,0.5,1,1,TGAGCCTTGCTCTAAAAGGC,0,1570537
galEp3,0.5,1,1,TGAGCAGTTCGCAGAACAGT,0,1547602
galEp3,0.5,1,1,TGAGCAAACCCACTTCAGAA,0,1592311
galEp3,0.5,1,1,TGAGAATGGGGTTCGGCCAA,0,1587355
galEp3,0.5,1,1,TGACTATCGGTCTATTGACC,0,1564371
galEp3,0.5,1,1,TGACGAGTTTTTTGGGCAAG,0,1582921
galEp3,0.5,1,1,TGACAGTGATTACGATACTA,0,1587395
galEp3,0.5,1,1,TGACACCAGCCAGCGCACAT,0,1584274
galEp3,0.5,1,1,TGACACACCGACGGCCGTGG,0,1580401
galEp3,0.5,1,1,TGACAACGTCATAGAGTTAT,0,1585991
galEp3,0.5,1,1,TGAATGTGTGGTTGAGACTA,0,1589408
galEp3,0.5,1,1,TGAATCACCAGTACTCCCCA,0,1593128
galEp3,0.5,1,1,TGAAGTACGGCCCCCGAACC,0,1579209
galEp3,0.5,1,1,TGAACCTCGTAAAGTAAACT,0,1570579
galEp3,0.5,1,1,TGAAATCAAACGTTAATAAG,0,1575973
galEp3,0.5,1,1,TCTTTTCGTGACCGCGCGTT,0,1584436
galEp3,0.5,1,1,TCTTTTACTCCTCCCTGTGG,0,1586227
galEp3,0.5,1,1,TCTTTCACGACCAGAGTGTT,0,1553239
galEp3,0.5,1,1,TCTTTAAGCTAATCTCGGCT,0,1551875
galEp3,0.5,1,1,TCTTGGTGTGTTCATAATAA,0,1570079
galEp3,0.5,1,1,TCTTCTTTATCGCTTTTGTT,0,1585289
galEp3,0.5,1,1,TCTTCAGGTGCCTCGTGTAA,0,1547318
galEp3,0.5,1,1,TCTTCAATCAGATTCAAGCC,0,1581668
galEp3,0.5,1,1,TCTTAGAAGATTTGTGATCC,0,1587973
galEp3,0.5,1,1,TCTTAAAGGGGAACGTGAGC,0,1570755
galEp3,0.5,1,1,TCTGTTTTTGCGGCTACGGT,0,1574666
galEp3,0.5,1,1,TCTGTCCATTTTGATAGCCA,0,1585626
galEp3,0.5,1,1,TCTGTAAGCGGGGTATTTCG,0,1552386
galEp3,0.5,1,1,TCTGGGTCCGCGTTTTGTTA,0,1592884
galEp3,0.5,1,1,TCTGGCGAATGGCCTGGGAC,0,1547664
galEp3,0.5,1,1,TCTGATCTCACGTCGTAAAC,0,1588690
galEp3,0.5,1,1,TCTGACGTGCGAAGGGCTAA,0,1565090
galEp3,0.5,1,1,TCTGACCCCTAGACTGCCAG,0,1553389
galEp3,0.5,1,1,TCTCTTTGCTCGTGGAGCCT,0,1584113
galEp3,0.5,1,1,TCTCTCTTATAGAACGCCCC,0,1581340
galEp3,0.5,1,1,TCTCGTGCGCCCAGCCCGTA,0,1566807
galEp3,0.5,1,1,TCTCATTGGGACTACTGGAG,0,1574652
galEp3,0.5,1,1,TCTCAAGGAGTTACCTATGC,0,1578819
galEp3,0.5,1,1,TCTATTTCAATCGAGTGATA,0,1567126
galEp3,0.5,1,1,TCTAGGTTATGTTCGACCGG,0,1590850
galEp3,0.5,1,1,TCTAGGGATTAAGTAAGGGT,0,1582426
galEp3,0.5,1,1,TCTACTTTGTGATGACAGGC,0,1555947
galEp3,0.5,1,1,TCTAAGACCATCAGGTTGCC,0,1582627
galEp3,0.5,1,1,TCTAACATGAACAACTTCAC,0,1567450
galEp3,0.5,1,1,TCGTGCTCGTTATACCTAAA,0,1584704
galEp3,0.5,1,1,TCGTCTAGTCCACCGCAGAG,0,1576308
galEp3,0.5,1,1,TCGTCTAGGGGAGGTGGGTC,0,1582870
galEp3,0.5,1,1,TCGTAAAGGAACTGCCCATT,0,1548387
galEp3,0.5,1,1,TCGGTGTATTCTGTCCCTAG,0,1583538
galEp3,0.5,1,1,TCGGTGCCCTTCTAGGAACT,0,1568328
galEp3,0.5,1,1,TCGGGTTGTAATAGGGGGAT,0,1574608
galEp3,0.5,1,1,TCGGGCCGATGAGGCGGGAT,0,1578154
galEp3,0.5,1,1,TCGGCGCGAGGCACGCCTTC,0,1590081
galEp3,0.5,1,1,TCGGCATCCCGTGCCACCTT,0,1565956
galEp3,0.5,1,1,TCGGACGCATACTTCACGTG,0,1584408
galEp3,0.5,1,1,TCGGACACCTTCAGTAGTTC,0,1571801
galEp3,0.5,1,1,TCGGAATAACTGCGCCGCCA,0,1568635
galEp3,0.5,1,1,TCGCTGTGACGGAAGTGCGT,0,1591828
galEp3,0.5,1,1,TCGCGCGGATATATCTGATT,0,1546488
galEp3,0.5,1,1,TCGCCTTATTAGTCATTATG,0,1581853
galEp3,0.5,1,1,TCGCCGGGACGGAAACTCAC,0,1559760
galEp3,0.5,1,1,TCGCATTATGTTGGGTTCCA,0,1589365
galEp3,0.5,1,1,TCGATTCTCTGAGCTAACAA,0,1561072
galEp3,0.5,1,1,TCGATATTGGGCACACTCTC,0,1563112
galEp3,0.5,1,1,TCGACAGGACGCGAGGCACA,0,1579092
galEp3,0.5,1,1,TCGAAGATTTGATAGGTCAA,0,1577369
galEp3,0.5,1,1,TCGAAATGGAGCCCATGGAT,0,1558254
galEp3,0.5,1,1,TCCTGTAAGGAAAGGACCTT,0,1585922
galEp3,0.5,1,1,TCCTGCTTTCGGCGACCCGG,0,1546633
galEp3,0.5,1,1,TCCTGCATGCACCAAGTTTT,0,1547520
galEp3,0.5,1,1,TCCTGCAAGTCGAAGGGACT,0,1558889
galEp3,0.5,1,1,TCCGGTCCACATTCGGGATA,0,1578779
galEp3,0.5,1,1,TCCGGGTGTATTTGGTTGCA,0,1553480
galEp3,0.5,1,1,TCCGGAATAGATGTCTGACG,0,1550103
galEp3,0.5,1,1,TCCGCCGCCCGTTACACACT,0,1594968
galEp3,0.5,1,1,TCCGATGCTGCCCTGAAGTT,0,1575542
galEp3,0.5,1,1,TCCGATGACTGGCGCCGCCC,0,1562254
galEp3,0.5,1,1,TCCCTCTGTGTGTCCCGCGC,0,1565807
galEp3,0.5,1,1,TCCCGGGAACGGCTTATCGT,0,1579848
galEp3,0.5,1,1,TCCCCTGCCCGCTGAAGTTT,0,1565819
galEp3,0.5,1,1,TCCCCAGTCTAGAGACAGCT,0,1555786
galEp3,0.5,1,1,TCCCCAATACTTCAAGTTTG,0,1577809
galEp3,0.5,1,1,TCCCATAGTTACTTTAAGAA,0,1582564
galEp3,0.5,1,1,TCCCAAGACATAGCCAGTTG,0,1550195
galEp3,0.5,1,1,TCCATTTCACAAAGGACCAG,0,1573402
galEp3,0.5,1,1,TCCATTATCAACGACGTCTT,0,1580490
galEp3,0.5,1,1,TCCATCTGTCATTCATACTA,0,1585185
galEp3,0.5,1,1,TCCATCTAGCGATGTAGATT,0,1587770
galEp3,0.5,1,1,TCCATCAAATTAAGATGATT,0,1563022
galEp3,0.5,1,1,TCCAGTACGGGCAGGCAAAA,0,1578932
galEp3,0.5,1,1,TCCACCCCTCGGGTCCCTTC,0,1557866
galEp3,0.5,1,1,TCCAATTACTCCGGTGAGTG,0,1578756
galEp3,0.5,1,1,TCCAATGAATAGTTTATCTA,0,1580055
galEp3,0.5,1,1,TCCAAGCTGCGTGCAATCAA,0,1585119
galEp3,0.5,1,1,TCATTGGACGGCGAGCCCAA,0,1593894
galEp3,0.5,1,1,TCATTCGAGAGCCACCAAAT,0,1557569
galEp3,0.5,1,1,TCATGTTCACATAGACTTGA,0,1582541
galEp3,0.5,1,1,TCATCTGACATACTCTCTAC,0,1566611
galEp3,0.5,1,1,TCATATCAAAGCCTACAGTG,0,1563830
galEp3,0.5,1,1,TCATAGCTCGATTAGTATGG,0,1560772
galEp3,0.5,1,1,TCAGTTAGGACCACTAAAGT,0,1577331
galEp3,0.5,1,1,TCAGGTTAGCCGTTGGCGTG,0,1580256
galEp3,0.5,1,1,TCAGCGGATGGAGGAGACTG,0,1590627
galEp3,0.5,1,1,TCAGCGCAGATAATACGCAG,0,1577026
galEp3,0.5,1,1,TCAGCCGTGTTGAAGCCTTC,0,1590754
galEp3,0.5,1,1,TCAGCCGGTACCTTTTCCGT,0,1553635
galEp3,0.5,1,1,TCAGATTAAGGAGTTGCTCT,0,1558314
galEp3,0.5,1,1,TCAGACAGGAAAATCTCACC,0,1551901
galEp3,0.5,1,1,TCAGAAATGGTCGTCGTACT,0,1549887
galEp3,0.5,1,1,TCACTCACCGAAGGTTCTTG,0,1567492
galEp3,0.5,1,1,TCACCCAACGATCCTGTACA,0,1583095
galEp3,0.5,1,1,TCACAGTGCTCGTAATCTTA,0,1548411
galEp3,0.5,1,1,TCACACTTCGTGAGATGAAA,0,1551371
galEp3,0.5,1,1,TCAATTCCAGCAAAATCGAA,0,1572599
galEp3,0.5,1,1,TCAATAGCGCGATCATAACC,0,1569818
galEp3,0.5,1,1,TCAACCTCATCACGGCTGCA,0,1575767
galEp3,0.5,1,1,TCAACAACGCCCGAGATAGA,0,1564437
galEp3,0.5,1,1,TCAAATAATAGAAATAAGGT,0,1556895
galEp3,0.5,1,1,TATTTTTTAGCTCTATGGTG,0,1574355
galEp3,0.5,1,1,TATTTACCTCTCACATACGT,0,1588831
galEp3,0.5,1,1,TATTGGTACGCCGTCGAATT,0,1559503
galEp3,0.5,1,1,TATTGCTACACGCGTCTTTG,0,1580188
galEp3,0.5,1,1,TATTGATAATCCGACCACCG,0,1558764
galEp3,0.5,1,1,TATTCTCACAACGTTTTGGA,0,1592892
galEp3,0.5,1,1,TATTCGGCCTAAGTCAAGCG,0,1584414
galEp3,0.5,1,1,TATTACATTGAATTCACGAC,0,1557862
galEp3,0.5,1,1,TATGTGACCGCGAACGCGCC,0,1585803
galEp3,0.5,1,1,TATGTAGGTCTAGCCTCGCC,0,1563045
galEp3,0.5,1,1,TATGGTAGGCAGTTTGCACC,0,1580338
galEp3,0.5,1,1,TATGGGGCGCCCTACCATAT,0,1559551
galEp3,0.5,1,1,TATGCGCCTTCCACTTAGAT,0,1551393
galEp3,0.5,1,1,TATGAGCCAGAAAAGAACCT,0,1561352
galEp3,0.5,1,1,TATGACGTAGAATAACAGAT,0,1591493
galEp3,0.5,1,1,TATCTGTCCCGCTCTACCTC,0,1594999
galEp3,0.5,1,1,TATCCTAATAAATCCTGCGC,0,1594640
galEp3,0.5,1,1,TATCCAGGACCCTCTTAACA,0,1567811
galEp3,0.5,1,1,TATATGACAGATTGAATGTG,0,1565413
galEp3,0.5,1,1,TATATAGGGGACCGGTGTCT,0,1566621
galEp3,0.5,1,1,TATATACCGACCACTGGGCC,0,1552850
galEp3,0.5,1,1,TATAGATTGATGCTAACTGG,0,1587414
galEp3,0.5,1,1,TATACTGGCCACTACGTTTT,0,1594873
galEp3,0.5,1,1,TATACGCGGGTGACCGTGCG,0,1587841
galEp3,0.5,1,1,TATAATTCCGGTTGATGCAA,0,1573432
galEp3,0.5,1,1,TAGGTTTTCGTCTAGTTTTA,0,1578504
galEp3,0.5,1,1,TAGGTTGAGTGATGTCTGCT,0,1561255
galEp3,0.5,1,1,TAGGTGTTTTAATATGGCTC,0,1554289
galEp3,0.5,1,1,TAGGGTGTGGTTTCCCAGAC,0,1582179
galEp3,0.5,1,1,TAGGGGCCAGGTTCAGACGA,0,1585261
galEp3,0.5,1,1,TAGGCGGCACCTGCTTGATG,0,1551858
galEp3,0.5,1,1,TAGGATGCTGAAAGTACGTG,0,1578939
galEp3,0.5,1,1,TAGCTATTACTTGCAAAGCT,0,1562664
galEp3,0.5,1,1,TAGCGTCATACATAGGTCGT,0,1559142
galEp3,0.5,1,1,TAGCGGTTGTTGCAACCAGT,0,1582234
galEp3,0.5,1,1,TAGCGCGCTCCGAATAACCT,0,1562246
galEp3,0.5,1,1,TAGCGAGAGTGCGTGCAAAG,0,1572045
galEp3,0.5,1,1,TAGCCTAGGAAAGACAACGT,0,1587698
galEp3,0.5,1,1,TAGCATCGTATACTCACCCC,0,1565914
galEp3,0.5,1,1,TAGATGTGTAGATACCGGAA,0,1564763
galEp3,0.5,1,1,TAGATAAACCCGACAGGCAA,0,1546995
galEp3,0.5,1,1,TAGAGTGAAAAGTCTGAGGC,0,1575963
galEp3,0.5,1,1,TAGAGTCTAATGGCTGTACG,0,1569333
galEp3,0.5,1,1,TAGAGGACGAGGGGCCTTTT,0,1577235
galEp3,0.5,1,1,TAGAGATTAGTGCGTTCTGC,0,1565044
galEp3,0.5,1,1,TAGAGAGTTGAAACCCCACT,0,1586330
galEp3,0.5,1,1,TAGAAAGGCTCGGGAAATTG,0,1560400
galEp3,0.5,1,1,TACTGCATTTGTACAAGTCT,0,1589035
galEp3,0.5,1,1,TACTCTGTAATAAAAGCTAA,0,1573882
galEp3,0.5,1,1,TACTCGTCCTAGGCATGAGG,0,1559100
galEp3,0.5,1,1,TACTCCTACCCCGCACGATA,0,1593626
galEp3,0.5,1,1,TACTACTGTCGGGAGGCCAA,0,1553189
galEp3,0.5,1,1,TACTAATGTTTCGCTCCAAA,0,1561758
galEp3,0.5,1,1,TACGTTGTGTAATTTAGCCG,0,1579100
galEp3,0.5,1,1,TACGGTGCAACATAAAGACT,0,1568630
galEp3,0.5,1,1,TACGGCTACAAAACGATTCG,0,1592209
galEp3,0.5,1,1,TACGGCCGCGTTAACAAAGG,0,1586461
galEp3,0.5,1,1,TACGACTTTGGTCGAATCAA,0,1587566
galEp3,0.5,1,1,TACCGGTTAGATATCGCCAA,0,1569316
galEp3,0.5,1,1,TACCGGCCCAACAGAGCCTA,0,1582419
galEp3,0.5,1,1,TACCGGACAATAAGACCCTT,0,1551044
galEp3,0.5,1,1,TACCCGATACCAGCAGGTAT,0,1580657
galEp3,0.5,1,1,TACCCCTTGTTTAATTTACG,0,1569820
galEp3,0.5,1,1,TACCAGCTAAACGAAACATG,0,1559972
galEp3,0.5,1,1,TACATCCTACGCGCATTTGG,0,1593316
galEp3,0.5,1,1,TACACTTCCCTCTAGGTAAT,0,1548828
galEp3,0.5,1,1,TACACCACGCCGCACCGGGA,0,1579860
galEp3,0.5,1,1,TACACACCGTAACTCGAGCC,0,1563678
galEp3,0.5,1,1,TACAATGCATTTTAAACCCC,0,1562057
galEp3,0.5,1,1,TAATTCGAGCATAAGATGCA,0,1581621
galEp3,0.5,1,1,TAATTCCTGCTCTCTCTCTG,0,1593200
galEp3,0.5,1,1,TAATTCCGTCGCTGGCCACG,0,1555136
galEp3,0.5,1,1,TAATAGAACGTGCGCGGGGG,0,1555955
galEp3,0.5,1,1,TAATAAGTTGCCAAGGCTTT,0,1566305
galEp3,0.5,1,1,TAATAAGAGCTGGAGCCTCT,0,1573250
galEp3,0.5,1,1,TAATAAAATCGACGTCATCG,0,1563114
galEp3,0.5,1,1,TAAGTGTGGTAAAATGGTTA,0,1546568
galEp3,0.5,1,1,TAAGTCCCCTCAGTCTTTAC,0,1554136
galEp3,0.5,1,1,TAAGTAGCTAACTGAAGACT,0,1585315
galEp3,0.5,1,1,TAAGGGCAGCGTTGGGCTGA,0,1558776
galEp3,0.5,1,1,TAAGCATAGTAGGGCCTCTC,0,1574267
galEp3,0.5,1,1,TAACGTATCTCGAGTCATTA,0,1566430
galEp3,0.5,1,1,TAACGTAGGATGGTAACAAT,0,1589426
galEp3,0.5,1,1,TAACGAAGCATGTTTATATT,0,1576414
galEp3,0.5,1,1,TAACCTGGGAACCTGTACCT,0,1553028
galEp3,0.5,1,1,TAACCTATTGTCATAGCAAG,0,1548481
galEp3,0.5,1,1,TAACCGGGGACACAATCTCA,0,1588945
galEp3,0.5,1,1,TAACCCAATCGACTGCGAAC,0,1570785
galEp3,0.5,1,1,TAACCATGTGCCCGGGACTG,0,1570187
galEp3,0.5,1,1,TAACAGCGTGAGAGACTCGT,0,1573016
galEp3,0.5,1,1,TAACACCGCTCTCAAGGTTA,0,1550085
galEp3,0.5,1,1,TAACAACACGGGATCACTTG,0,1572900
galEp3,0.5,1,1,TAAATTCTAGGTGGAAAAAT,0,1569208
galEp3,0.5,1,1,TAAATCCGTTAGGTAATTTA,0,1593061
galEp3,0.5,1,1,TAAATAAGCGGAGGCGCATG,0,1566248
galEp3,0.5,1,1,TAAAATATTTGATCGACAGC,0,1551572
galEp3,0.5,1,1,TAAAACGCAATTATCGTAAG,0,1552335
galEp3,0.5,1,1,GTTTTCTGAATGGAACTGGA,0,1565206
galEp3,0.5,1,1,GTTTTCCGAACGCCCCCGTA,0,1588713
galEp3,0.5,1,1,GTTTGTTTTTCGAGGAATGT,0,1579353
galEp3,0.5,1,1,GTTTGGGTCCGGTTCGCTCT,0,1586902
galEp3,0.5,1,1,GTTTGACAGTATAGCTTTTC,0,1587091
galEp3,0.5,1,1,GTTTAATTATCGTGGCAGTC,0,1576497
galEp3,0.5,1,1,GTTTAAGGCGTGTGGGCCCA,0,1546510
galEp3,0.5,1,1,GTTTAAGCTGTTACTGCTTA,0,1562437
galEp3,0.5,1,1,GTTGTTCATTTACGGTAATG,0,1576028
galEp3,0.5,1,1,GTTGTCTCATGCTGGAATGA,0,1551788
galEp3,0.5,1,1,GTTGGTACGAAATAGATCTG,0,1553753
galEp3,0.5,1,1,GTTGGAGTCACGCCTTTTGT,0,1551480
galEp3,0.5,1,1,GTTGCAGCAACGCATAGTCT,0,1557214
galEp3,0.5,1,1,GTTGATGTCGTATGGTTTTT,0,1579512
galEp3,0.5,1,1,GTTGAGCTCCGCGGGTGAAA,0,1584889
galEp3,0.5,1,1,GTTGACAATCCGTCTCATGC,0,1548340
galEp3,0.5,1,1,GTTCTTTTGTCGAGCCAGCT,0,1550472
galEp3,0.5,1,1,GTTCTGGGGGACGGCTAGGT,0,1580495
galEp3,0.5,1,1,GTTCCTCCTAGGTCAAGATC,0,1557302
galEp3,0.5,1,1,GTTCCCCTGGGGTATATCTT,0,1588422
galEp3,0.5,1,1,GTTCCCAGCATAAGTCCCGG,0,1561710
galEp3,0.5,1,1,GTTCAGGTCCCAAAATTTGC,0,1574649
galEp3,0.5,1,1,GTTCAGAGATGAATATATTT,0,1573077
galEp3,0.5,1,1,GTTATTGGAATGGTCGCCCT,0,1578591
galEp3,0.5,1,1,GTTATTGACATAGTAGTGAA,0,1583387
galEp3,0.5,1,1,GTTAGTATAGTTGCGCTCGA,0,1556391
galEp3,0.5,1,1,GTTACCTATGCGGTAGCACG,0,1589043
galEp3,0.5,1,1,GTTAAGAAAAATCCCCCCAA,0,1549472
galEp3,0.5,1,1,GTTAACTTTCCTACACTCGA,0,1588412
galEp3,0.5,1,1,GTTAACTTGTAAGTATGGAC,0,1547809
galEp3,0.5,1,1,GTTAACTAAGGACGGATAAG,0,1573122
galEp3,0.5,1,1,GTTAAAAGATCCTTCTTTAC,0,1576877
galEp3,0.5,1,1,GTGTTTTCATGCACTGTCCA,0,1549708
galEp3,0.5,1,1,GTGTGCCAATGATCTATATA,0,1567259
galEp3,0.5,1,1,GTGTGATCTGTCGAGAGTTC,0,1573288
galEp3,0.5,1,1,GTGTCATAAAGGTGCACCGA,0,1589561
galEp3,0.5,1,1,GTGTCAAGCCGTACGAACCT,0,1555022
galEp3,0.5,1,1,GTGTAGGTGCAAGTGCGCGC,0,1546444
galEp3,0.5,1,1,GTGTAGACGACGGGCTCCGT,0,1561527
galEp3,0.5,1,1,GTGGTCGTGGGCGGACGTTA,0,1552582
galEp3,0.5,1,1,GTGGGGCGGAAGGGTGTTCT,0,1564473
galEp3,0.5,1,1,GTGGCGTTCCGGGCACGGGG,0,1583199
galEp3,0.5,1,1,GTGCTTGGGTACAATCTCAA,0,1568723
galEp3,0.5,1,1,GTGCTGCGTACGCTAGGGAT,0,1561872
galEp3,0.5,1,1,GTGCTCGGTCCAAATGGCCT,0,1592388
galEp3,0.5,1,1,GTGCGCTTTTCCACCGGGAA,0,1548533
galEp3,0.5,1,1,GTGCCTTGACGCAGCCACAT,0,1552486
galEp3,0.5,1,1,GTGCCTGGTTAAAAACACAG,0,1579065
galEp3,0.5,1,1,GTGCCGTTCTTCGCAGTGCG,0,1548657
galEp3,0.5,1,1,GTGCCCCATGCGATACTCAA,0,1553636
galEp3,0.5,1,1,GTGCAATGCTGGGCCTCTCG,0,1564404
galEp3,0.5,1,1,GTGCAATCAACCCCTATGAC,0,1581537
galEp3,0.5,1,1,GTGATGCTTGCCTAGGGCGT,0,1562961
galEp3,0.5,1,1,GTGATAGGTTAAGTAAATCA,0,1589753
galEp3,0.5,1,1,GTGAGTGGTGTCGTCGAGTG,0,1552117
galEp3,0.5,1,1,GTGAGTACACAGGGCCTCGT,0,1576228
galEp3,0.5,1,1,GTGAGGCACTGCAACCTCGA,0,1568491
galEp3,0.5,1,1,GTGACCCTAGGGATGGGCTT,0,1572527
galEp3,0.5,1,1,GTGACATACTTATCTCTGGG,0,1586338
galEp3,0.5,1,1,GTGACAATCAGGAGGGGCGT,0,1553989
galEp3,0.5,1,1,GTGAATAGGGCTCGTGTAAC,0,1592178
galEp3,0.5,1,1,GTCTTCGCACAACATGGGTC,0,1566238
galEp3,0.5,1,1,GTCTGTTCCGACCGCCTGTG,0,1565935
galEp3,0.5,1,1,GTCTGCTTTTACGTGACAGT,0,1567761
galEp3,0.5,1,1,GTCTGCGTTCCGACAGGGCT,0,1556589
galEp3,0.5,1,1,GTCTCTCGGACGTTAACCCG,0,1590038
galEp3,0.5,1,1,GTCTCGCTTTAACAAGGGAC,0,1546726
galEp3,0.5,1,1,GTCTCACCCCACGCCGTTCT,0,1582910
galEp3,0.5,1,1,GTCTAGCGTAACAAGCTAAA,0,1591012
galEp3,0.5,1,1,GTCTACCATATAGCGAGCTG,0,1584367
galEp3,0.5,1,1,GTCTAATAACCCCTACTGGT,0,1566568
galEp3,0.5,1,1,GTCGGGAAACAAAGTTATTG,0,1581757
galEp3,0.5,1,1,GTCGCGGCAATAGCTTTCGG,0,1560599
galEp3,0.5,1,1,GTCGAAAACTAATCCCAATT,0,1549767
galEp3,0.5,1,1,GTCCGGTCCACCTTCTTGTC,0,1570416
galEp3,0.5,1,1,GTCCGGCCGGCGAAGGGGTA,0,1553014
galEp3,0.5,1,1,GTCCGCAAGTTGCAAACTGA,0,1593778
galEp3,0.5,1,1,GTCCATACATGACAACTTAG,0,1557841
galEp3,0.5,1,1,GTCCAACGAACAGATAGTGA,0,1564953
galEp3,0.5,1,1,GTCATATGCTTGTGCGGGTT,0,1558074
galEp3,0.5,1,1,GTCATAAGACGCTTGCCGAG,0,1551642
galEp3,0.5,1,1,GTCACATCCTGGATAGGGAC,0,1586042
galEp3,0.5,1,1,GTCACATATGAAGAGCGACG,0,1558380
galEp3,0.5,1,1,GTCACATAGGGCCAGGGATA,0,1586200
galEp3,0.5,1,1,GTCACACCATTGCTTGAAGC,0,1583747
galEp3,0.5,1,1,GTATTGGAGGAAAGCATAAA,0,1553679
galEp3,0.5,1,1,GTATTACCCTTTGGGGTTTA,0,1592270
galEp3,0.5,1,1,GTATGCTATACCACTTTTGA,0,1570838
galEp3,0.5,1,1,GTATGCGGGTACCGCAATCA,0,1553601
galEp3,0.5,1,1,GTATGAAGCCTTACTGTTTG,0,1551802
galEp3,0.5,1,1,GTATCGATGGGCCAGGACAT,0,1549771
galEp3,0.5,1,1,GTATCCTTGCGAGATCGGTC,0,1571918
galEp3,0.5,1,1,GTATCCAGAGGCCTTCCTCG,0,1590247
galEp3,0.5,1,1,GTATCACGCCTATGCCATAA,0,1570479
galEp3,0.5,1,1,GTATCAAGCCAAATTTCCCC,0,1591666
galEp3,0.5,1,1,GTATACCCAAGCCGTTAGCA,0,1567983
galEp3,0.5,1,1,GTATAAATGCCACTTATCAG,0,1576062
galEp3,0.5,1,1,GTAGTGTAATCTGTAAAATC,0,1549578
galEp3,0.5,1,1,GTAGGTACGTGGTGAAAGGT,0,1594069
galEp3,0.5,1,1,GTAGGGTGTGGCTCGTCAAT,0,1555541
galEp3,0.5,1,1,GTAGGGACACATTGGAGGGG,0,1562236
galEp3,0.5,1,1,GTAGGCCCACGGAAAGCAGA,0,1549425
galEp3,0.5,1,1,GTAGGAAATCTCCATGTATT,0,1556112
galEp3,0.5,1,1,GTAGCTAGGACTAACCAAAA,0,1568530
galEp3,0.5,1,1,GTAGCGTATGCCTCAATCAA,0,1565662
galEp3,0.5,1,1,GTACTGTGGGCGAACCTGAA,0,1580633
galEp3,0.5,1,1,GTACTCGAGCGGGGCGGTGC,0,1593816
galEp3,0.5,1,1,GTACGTGTTTTAATATGTGC,0,1559283
galEp3,0.5,1,1,GTACGGAGACTGGGCCTCAC,0,1567558
galEp3,0.5,1,1,GTACGCGTCCCTGGACCGTG,0,1556170
galEp3,0.5,1,1,GTACCCTAACAAACTGGATC,0,1589092
galEp3,0.5,1,1,GTACAGTTATTAAGGAGACT,0,1574306
galEp3,0.5,1,1,GTACACCAGGCATACGGGAC,0,1591044
galEp3,0.5,1,1,GTACACAGCCGCTCGCATTC,0,1588243
galEp3,0.5,1,1,GTAACTCGCTATTACAGATG,0,1568833
galEp3,0.5,1,1,GTAACGTATGTGATGGCCTC,0,1587846
galEp3,0.5,1,1,GTAACATTACAACATGTCTA,0,1591447
galEp3,0.5,1,1,GTAAAAGCGATTAAAACCAG,0,1590660
galEp3,0.5,1,1,GGTTTGTGCGTAGTGATTTT,0,1582213
galEp3,0.5,1,1,GGTTTCGGATTGAAAGGTGG,0,1576294
galEp3,0.5,1,1,GGTTGCGTGTTTTAAACGAA,0,1558980
galEp3,0.5,1,1,GGTTCTTTCCGCAAAAAAGA,0,1574987
galEp3,0.5,1,1,GGTTAGGCTTAGTGGCCCAA,0,1594329
galEp3,0.5,1,1,GGTGTGGAGTAGGTCACTGG,0,1561396
galEp3,0.5,1,1,GGTGGCACAGTACCACATCG,0,1564997
galEp3,0.5,1,1,GGTGGATAAATATCACGCCT,0,1589623
galEp3,0.5,1,1,GGTGGAGCCGTTAAAAAGCC,0,1554802
galEp3,0.5,1,1,GGTGCTATCTAGTGCATCGA,0,1583549
galEp3,0.5,1,1,GGTGCGAGTTCCAGTGGTCA,0,1551720
galEp3,0.5,1,1,GGTGCAGTGCACCTCTTGGA,0,1584272
galEp3,0.5,1,1,GGTGATAAAGTTGCCACAAT,0,1564366
galEp3,0.5,1,1,GGTGAAAAGTTATAGGCGGC,0,1571401
galEp3,0.5,1,1,GGTCTGGATGTTGCGGCGAA,0,1548820
galEp3,0.5,1,1,GGTCTCTGTCGATGACCTCG,0,1560372
galEp3,0.5,1,1,GGTCTATGAGGCCAACCGAC,0,1586841
galEp3,0.5,1,1,GGTCTACAGGATACAGCCAG,0,1565926
galEp3,0.5,1,1,GGTCGTTATCTTCCCGGGAG,0,1557967
galEp3,0.5,1,1,GGTCGGCGCTTGAACTTTTA,0,1575252
galEp3,0.5,1,1,GGTCCTGAAGAAGTAACGGA,0,1561203
galEp3,0.5,1,1,GGTCCATGCGTGTGATGGAC,0,1573954
galEp3,0.5,1,1,GGTCCAGGCCTATTAATTGT,0,1591423
galEp3,0.5,1,1,GGTCCACTTGTCACTTGTTG,0,1556694
galEp3,0.5,1,1,GGTATTAATCAGGCTTATTT,0,1573978
galEp3,0.5,1,1,GGTATGAACCCGACGCTAAT,0,1560912
galEp3,0.5,1,1,GGTATAATGTTACACCTCGA,0,1581871
galEp3,0.5,1,1,GGTAGAGCACCGATTGTTGA,0,1586846
galEp3,0.5,1,1,GGTACTCCTGAGGCCATGCA,0,1592856
galEp3,0.5,1,1,GGTACGTCACTTAATGATAA,0,1577844
galEp3,0.5,1,1,GGTACCTTCTGAGATACGCC,0,1558506
galEp3,0.5,1,1,GGTAATCCTGCTTCTCTGCA,0,1582845
galEp3,0.5,1,1,GGTAACCATCTGTAGCAATC,0,1573530
galEp3,0.5,1,1,GGTAAAACTTTAAGTAAGGG,0,1556467
galEp3,0.5,1,1,GGGTTTGCTGTAGGGGAACT,0,1565527
galEp3,0.5,1,1,GGGTTCTAAATCGTTGTTTT,0,1554126
galEp3,0.5,1,1,GGGTTCAATAAAAATGCCGC,0,1559265
galEp3,0.5,1,1,GGGTTACCATGGCAGGCCTC,0,1573756
galEp3,0.5,1,1,GGGTGGATCTGCACAAATGG,0,1578388
galEp3,0.5,1,1,GGGTACTTAAAGCCGAGAGA,0,1594677
galEp3,0.5,1,1,GGGGTCGTCCGGCGTCTAGC,0,1577217
galEp3,0.5,1,1,GGGGTATCTCCCAGGGGGTC,0,1554106
galEp3,0.5,1,1,GGGGTAGCTAATTCCGTGAC,0,1547946
galEp3,0.5,1,1,GGGGTACTACCAACTGGAAC,0,1565612
galEp3,0.5,1,1,GGGGGGTTCAGCTGACTCGC,0,1587981
galEp3,0.5,1,1,GGGGGCTGCCCCCCTATCTT,0,1576076
galEp3,0.5,1,1,GGGGGAGTAGCTTCCAACAG,0,1591190
galEp3,0.5,1,1,GGGGGAAGGTAAATGGCTGC,0,1592145
galEp3,0.5,1,1,GGGGCTTGGGGTGACGACTA,0,1583302
galEp3,0.5,1,1,GGGGCTGTCTTCTCCAATAT,0,1569159
galEp3,0.5,1,1,GGGGCACGCCGATTTAAGTT,0,1571533
galEp3,0.5,1,1,GGGGAGCTTCTAATATACGA,0,1560525
galEp3,0.5,1,1,GGGGAGAACCGCTGCACCTA,0,1568292
galEp3,0.5,1,1,GGGCTATAGCGAGGGCTTTT,0,1575495
galEp3,0.5,1,1,GGGCGGAATCAGACGGTCTA,0,1576261
galEp3,0.5,1,1,GGGCGATTGAATTGAGATTG,0,1576191
galEp3,0.5,1,1,GGGCCGAACAAAGGTCCAGC,0,1587007
galEp3,0.5,1,1,GGGCCAGACAAGAAGAGTAT,0,1563387
galEp3,0.5,1,1,GGGCCACAGGGAGAGCTTCT,0,1554886
galEp3,0.5,1,1,GGGATTGTGGGACACCACTC,0,1581354
galEp3,0.5,1,1,GGGAGGCATGCTTGGGGTAT,0,1581345
galEp3,0.5,1,1,GGGAGAATATGATTAGAGAG,0,1584214
galEp3,0.5,1,1,GGGACTTTCCTAGACGTCTC,0,1565515
galEp3,0.5,1,1,GGGACAAGCGTACGTGAATA,0,1547337
galEp3,0.5,1,1,GGCTCCGGGTAAGAAACTTG,0,1575941
galEp3,0.5,1,1,GGCTCCACATAGTCTACACA,0,1551083
galEp3,0.5,1,1,GGCTAGAGCGCAGGTCGTCA,0,1575210
galEp3,0.5,1,1,GGCTAAGGCATGACACCGCA,0,1554354
galEp3,0.5,1,1,GGCGTCATAAGGTCTAGTTT,0,1552387
galEp3,0.5,1,1,GGCGTAGTCCTCCGGCAGAA,0,1588425
galEp3,0.5,1,1,GGCGGTCTATGACTCATTCT,0,1562996
galEp3,0.5,1,1,GGCGGTAAATTGGCAGCACA,0,1574668
galEp3,0.5,1,1,GGCGGGACAATCCCGCATCG,0,1593020
galEp3,0.5,1,1,GGCGGCAGGAGGGTCTGGGT,0,1584452
galEp3,0.5,1,1,GGCGGACAACCGTAGCCGAT,0,1573787
galEp3,0.5,1,1,GGCGCAACTCAAGAAGACTA,0,1567444
galEp3,0.5,1,1,GGCGAATTCACAACCTGTAT,0,1547385
galEp3,0.5,1,1,GGCCTGTACTTGGCCTTGGT,0,1580159
galEp3,0.5,1,1,GGCCTCTAAGTCTCACGTAC,0,1559513
galEp3,0.5,1,1,GGCCGTTACAACGATAATTT,0,1560926
galEp3,0.5,1,1,GGCCGCCCGTACGTAGGCTA,0,1580387
galEp3,0.5,1,1,GGCCCTCGAGTGAACCCTGC,0,1552840
galEp3,0.5,1,1,GGCCCTCAAAGTTCCCCCCT,0,1568821
galEp3,0.5,1,1,GGCCACTGCAGGATCGTTAC,0,1588672
galEp3,0.5,1,1,GGCATTGAGGCACTTCGGAA,0,1582891
galEp3,0.5,1,1,GGCATTCGAGGACAGGATAC,0,1594582
galEp3,0.5,1,1,GGCATGAGATGACGAAACTC,0,1592010
galEp3,0.5,1,1,GGCAGGAGCTTAGTTTAGAA,0,1573398
galEp3,0.5,1,1,GGCAGGAATTGGGACGGTGT,0,1557180
galEp3,0.5,1,1,GGCAGCGAGGGCCGTGAGTA,0,1576171
galEp3,0.5,1,1,GGCAGATCAAACTTTACGGG,0,1587442
galEp3,0.5,1,1,GGCAAGTATCCTGTTAGATC,0,1574746
galEp3,0.5,1,1,GGATTGTGCGTCCCGTGCGG,0,1578083
galEp3,0.5,1,1,GGATTGGTTCGACGCCATTC,0,1556584
galEp3,0.5,1,1,GGATTGGTAGCCACAGGCGT,0,1566284
galEp3,0.5,1,1,GGATGGCCGCTATTGTTCGT,0,1574503
galEp3,0.5,1,1,GGATCGGAGACAAGATACAT,0,1582001
galEp3,0.5,1,1,GGATCCCGCTACCCTAAGTT,0,1548515
galEp3,0.5,1,1,GGATCAAGAACCAAGTAATC,0,1550844
galEp3,0.5,1,1,GGATAGCTGCCCCAGCTGCC,0,1555356
galEp3,0.5,1,1,GGATACAATCGCCTGAGATA,0,1582546
galEp3,0.5,1,1,GGAGTTTGTATGTAGCCTTT,0,1556189
galEp3,0.5,1,1,GGAGTGGGTCAAGGGTTGGA,0,1548048
galEp3,0.5,1,1,GGAGGTTAGCTACTTCGAGT,0,1574904
galEp3,0.5,1,1,GGAGGTCAGGGCCGTATTAA,0,1577819
galEp3,0.5,1,1,GGAGGCTCATGTGAGCTCAC,0,1594615
galEp3,0.5,1,1,GGAGGACGTCTCGTGTAACC,0,1590082
galEp3,0.5,1,1,GGAGGAAACCGTCCAAGTTT,0,1594063
galEp3,0.5,1,1,GGAGCGGGCCTTACCCAAGC,0,1573214
galEp3,0.5,1,1,GGAGCATGGCCAGGCTAACC,0,1566423
galEp3,0.5,1,1,GGAGATTTTATCCATGTGGC,0,1572497
galEp3,0.5,1,1,GGAGAAACTAGACGATTAGT,0,1582819
galEp3,0.5,1,1,GGACTCGTCGCACGGAAAAC,0,1586469
galEp3,0.5,1,1,GGACTACGAAGGGCGAGCTA,0,1562660
galEp3,0.5,1,1,GGACGGTGCAGTCCGGCAAC,0,1562253
galEp3,0.5,1,1,GGACGGGATACGGGGTCAAC,0,1568979
galEp3,0.5,1,1,GGACCTCAGAAAGCCGTCGT,0,1563468
galEp3,0.5,1,1,GGACACCGATGTAACCATTC,0,1550043
galEp3,0.5,1,1,GGACAACGTATAGATGTATC,0,1563037
galEp3,0.5,1,1,GGACAACATCGTCTAGATGC,0,1570340
galEp3,0.5,1,1,GGAATATCATTTCGCGCCGT,0,1568502
galEp3,0.5,1,1,GGAATACGGACGAGACATGA,0,1551604
galEp3,0.5,1,1,GGAATAACGATGCCCAACTT,0,1580178
galEp3,0.5,1,1,GGAAGACTCCTAGTCGAAGC,0,1550747
galEp3,0.5,1,1,GGAACTGCTGGGACGACGGC,0,1591526
galEp3,0.5,1,1,GGAACCTCGTGCAGTATATA,0,1582391
galEp3,0.5,1,1,GGAACAGGTCCACCAGGGGG,0,1592947
galEp3,0.5,1,1,GGAACACCAGCCACTTTGCT,0,1573435
galEp3,0.5,1,1,GGAACAACTTGCAAGCGGGC,0,1554983
galEp3,0.5,1,1,GGAACAAACGGGATCGAGAC,0,1570477
galEp3,0.5,1,1,GGAAATCTCTGGGAAACATC,0,1578129
galEp3,0.5,1,1,GGAAACTGCGTCTGTGTTCC,0,1582115
galEp3,0.5,1,1,GCTTTGGATGAATTCCGCCA,0,1556224
galEp3,0.5,1,1,GCTTTAGTTTGACTACGAGT,0,1587659
galEp3,0.5,1,1,GCTTTAAGTTAGAGTCCTGA,0,1550986
galEp3,0.5,1,1,GCTTGTAGCGGGTCGTACCA,0,1585987
galEp3,0.5,1,1,GCTTGCAATCGCCTAACCGT,0,1562528
galEp3,0.5,1,1,GCTTCGTGCTAATAGTGCAG,0,1571772
galEp3,0.5,1,1,GCTTCATTAGACAAGATCGC,0,1566318
galEp3,0.5,1,1,GCTTATGCAGGTCCAGTGTC,0,1562142
galEp3,0.5,1,1,GCTTAGGTTAGGTTACCTTT,0,1569676
galEp3,0.5,1,1,GCTTAGATTTTTCTCTTTGG,0,1588429
galEp3,0.5,1,1,GCTGGTGCAATCGTGCCGCC,0,1580475
galEp3,0.5,1,1,GCTGCACGGTCTGTATCATA,0,1592525
galEp3,0.5,1,1,GCTGAGACCTTTAATAAGAG,0,1574858
galEp3,0.5,1,1,GCTCTCCTAATTCCTTGTTA,0,1551716
galEp3,0.5,1,1,GCTCTCCCATCTCTTTACCG,0,1558531
galEp3,0.5,1,1,GCTCTAGGTTACGATACAAG,0,1559947
galEp3,0.5,1,1,GCTCTAAACCCATTGCATTA,0,1555471
galEp3,0.5,1,1,GCTCGGGTACCCTTCTGGCA,0,1561034
galEp3,0.5,1,1,GCTCGCGCTTGAACTGTAAG,0,1565924
galEp3,0.5,1,1,GCTCCCATTGAGCTTTCTAC,0,1552126
galEp3,0.5,1,1,GCTCATGGCCCCTAGTGATA,0,1558360
galEp3,0.5,1,1,GCTAGTTCTTTGTCGCAGAG,0,1571990
galEp3,0.5,1,1,GCTAGACGTGAGTCCCCTAA,0,1565630
galEp3,0.5,1,1,GCTAACCTCTGGACTTGTTA,0,1580094
galEp3,0.5,1,1,GCTAAAAGGCCGAGCGGAAA,0,1549847
galEp3,0.5,1,1,GCGTTCAGGCAGCTCTCGAG,0,1563462
galEp3,0.5,1,1,GCGTGCCAATGTTCAGGGGA,0,1564524
galEp3,0.5,1,1,GCGTCTGCTGTTCAAGCCTG,0,1584730
galEp3,0.5,1,1,GCGTCGGATTGGAAGGTGCT,0,1558083
galEp3,0.5,1,1,GCGTACAGGTAACACGGGAA,0,1591369
galEp3,0.5,1,1,GCGTAATGCGGTTTGCCACC,0,1571758
galEp3,0.5,1,1,GCGGGGTCATGCAGTTCGTA,0,1548289
galEp3,0.5,1,1,GCGGCATAAATTACGGAGCG,0,1562293
galEp3,0.5,1,1,GCGGATGAGAATTGTCATAG,0,1591438
galEp3,0.5,1,1,GCGGAATCGGTACCTGCTCA,0,1556271
galEp3,0.5,1,1,GCGCTTTAGAACACAATCGT,0,1561631
galEp3,0.5,1,1,GCGCTGTTTTTCGGCGCGAC,0,1558096
galEp3,0.5,1,1,GCGCATCATGGCACGCGCAA,0,1579704
galEp3,0.5,1,1,GCGCAGAATAGACCGTGTCG,0,1581641
galEp3,0.5,1,1,GCGCACAGTCTACGAGAGCA,0,1553855
galEp3,0.5,1,1,GCGATTTCTGTCGGACAATG,0,1548529
galEp3,0.5,1,1,GCGAGTAGGGCTTTTGTCAA,0,1552245
galEp3,0.5,1,1,GCGAGGCGCTCCCTCGACTC,0,1574525
galEp3,0.5,1,1,GCGAGCGTATACTTCTTTCT,0,1572937
galEp3,0.5,1,1,GCGAGCCGGGCGGGGAAAAT,0,1576331
galEp3,0.5,1,1,GCGAGAGTAGCGAGGTGTAA,0,1585707
galEp3,0.5,1,1,GCGACCGTCCACTACAAGCA,0,1587339
galEp3,0.5,1,1,GCGACCCTACGAATGTCAAG,0,1591317
galEp3,0.5,1,1,GCGAAATTAGGGACAGGGGA,0,1547973
galEp3,0.5,1,1,GCGAAAGAGTACTCATGGCA,0,1566570
galEp3,0.5,1,1,GCCTTGGCGGAGGCCCCGCA,0,1567278
galEp3,0.5,1,1,GCCTTCATGCTAGGAACTCT,0,1558497
galEp3,0.5,1,1,GCCTCTTAGACCGTTTTTAC,0,1565892
galEp3,0.5,1,1,GCCTCATCGAAGCCAACGGA,0,1579502
galEp3,0.5,1,1,GCCTATATTGCTACGACAAG,0,1578189
galEp3,0.5,1,1,GCCGTGCATGGCAGGGCCTC,0,1550310
galEp3,0.5,1,1,GCCGTGCAGAGGTAGTAAAA,0,1573068
galEp3,0.5,1,1,GCCGGTAAAATACCAAGTAC,0,1591137
galEp3,0.5,1,1,GCCGGCCAATGCAAGTTAGT,0,1555750
galEp3,0.5,1,1,GCCGGACACGGTTGCGCGTC,0,1575169
galEp3,0.5,1,1,GCCGCCGGTCACAACACATC,0,1568335
galEp3,0.5,1,1,GCCGCAGCTTACACACTCAA,0,1566300
galEp3,0.5,1,1,GCCCTGGGTGTCAATATTGT,0,1571519
galEp3,0.5,1,1,GCCCTCTCACGTGGGGCAGG,0,1564451
galEp3,0.5,1,1,GCCCGTGCCGAGAGCTTACC,0,1570159
galEp3,0.5,1,1,GCCCGGATTACTCTCGCCGT,0,1579737
galEp3,0.5,1,1,GCCATGAGGGTGAGCTTGGC,0,1563951
galEp3,0.5,1,1,GCCATAGAACAGAGTTTAGG,0,1577374
galEp3,0.5,1,1,GCCAGTTTTAGTCGGAATGC,0,1562062
galEp3,0.5,1,1,GCCAGGACTAACGGAAGTGA,0,1586126
galEp3,0.5,1,1,GCCAGCCCGGATTATGTAAC,0,1588596
galEp3,0.5,1,1,GCCAGATTTAGCAGGCTCTG,0,1582960
galEp3,0.5,1,1,GCCACTCAACGCATCCCGCG,0,1592147
galEp3,0.5,1,1,GCCACGATGAAGAGCACAGA,0,1565739
galEp3,0.5,1,1,GCCACATGTGCACGGAGAGA,0,1557598
galEp3,0.5,1,1,GCATTGGTGACCTACTTGGT,0,1549789
galEp3,0.5,1,1,GCATGGCCAGATTAAACTTG,0,1583068
galEp3,0.5,1,1,GCATGCGCGCATCAGAAAGT,0,1585016
galEp3,0.5,1,1,GCATCTCAGTCCTGAAATAG,0,1577802
galEp3,0.5,1,1,GCATCGCTCAAACATAGTGT,0,1550893
galEp3,0.5,1,1,GCATCAGTTCACTCGTACAA,0,1587425
galEp3,0.5,1,1,GCATATGGCTCCTTACATCG,0,1568288
galEp3,0.5,1,1,GCATATAGGTAGTCTTACAG,0,1579379
galEp3,0.5,1,1,GCATATAGGGCAACCAGGTA,0,1579338
galEp3,0.5,1,1,GCATATAATCAGTTATGAAG,0,1552932
galEp3,0.5,1,1,GCAGTTCTTATCTAGAATAC,0,1554102
galEp3,0.5,1,1,GCAGTTAGTAGGGTTGTCTT,0,1557274
galEp3,0.5,1,1,GCAGTTAGGCAGTGCACAGT,0,1552892
galEp3,0.5,1,1,GCAGTAATTGCGGCATTCGA,0,1575408
galEp3,0.5,1,1,GCAGGGATATACGGGATGAC,0,1555966
galEp3,0.5,1,1,GCAGGGAGAATTGGTACTAA,0,1549095
galEp3,0.5,1,1,GCAGCTGACAGGCCGCTACG,0,1593642
galEp3,0.5,1,1,GCAGCGCTTTGTGGTACACC,0,1548343
galEp3,0.5,1,1,GCAGAAAACGTACCGTGGAT,0,1592653
galEp3,0.5,1,1,GCACGTTCCGGAAAAGAAGG,0,1572787
galEp3,0.5,1,1,GCACGGGATCTCCCATTGAT,0,1551888
galEp3,0.5,1,1,GCACAGGAGAGTAGTCGTTC,0,1592265
galEp3,0.5,1,1,GCAATGGTCAACTTCTGCTA,0,1551025
galEp3,0.5,1,1,GCAAGCGTAGCAGACTGCCA,0,1565691
galEp3,0.5,1,1,GCAAGCGGCAGTCTTTCATT,0,1571635
galEp3,0.5,1,1,GCAACGCACAAATACAGTAA,0,1577962
galEp3,0.5,1,1,GCAAAACGACCCGAGGCCGT,0,1561427
galEp3,0.5,1,1,GATTTCATCTGACCCGTATC,0,1546442
galEp3,0.5,1,1,GATTTACAGCGCAGAACAAG,0,1581208
galEp3,0.5,1,1,GATTCTTGCTCAGTCTATAT,0,1590673
galEp3,0.5,1,1,GATTCGTCGGATGAAACCAT,0,1551493
galEp3,0.5,1,1,GATTCATATCGGTGTTAGGC,0,1579099
galEp3,0.5,1,1,GATTATCCTGAAGCGGGACT,0,1572621
galEp3,0.5,1,1,GATTAGGCTCTTTAATCGCT,0,1579337
galEp3,0.5,1,1,GATTAGGAGCTAGACCTCGT,0,1579695
galEp3,0.5,1,1,GATTAATTTGGTGCCGGAGC,0,1579655
galEp3,0.5,1,1,GATGTTACGCCGATGCTATT,0,1566714
galEp3,0.5,1,1,GATGTGAGTATAGGAACACG,0,1562147
galEp3,0.5,1,1,GATGTACGATAAATCGCAAC,0,1546912
galEp3,0.5,1,1,GATGCCGAAGTGCCAAAGAC,0,1570263
galEp3,0.5,1,1,GATGCCCGAGACAATTTTTA,0,1571126
galEp3,0.5,1,1,GATGCACTTCGTGTTCCGGA,0,1562666
galEp3,0.5,1,1,GATGAACCAATACGTACACC,0,1573614
galEp3,0.5,1,1,GATCTTACCGAGGGCGGCGA,0,1564276
galEp3,0.5,1,1,GATCTATGAAATGGCAGTTA,0,1566117
galEp3,0.5,1,1,GATCTACCAAAAATATCACT,0,1570035
galEp3,0.5,1,1,GATCGGCGAAATACATATCG,0,1580114
galEp3,0.5,1,1,GATCGAGCCTACTCATAGGT,0,1594979
galEp3,0.5,1,1,GATCATTCCCTGGTCGTTCT,0,1569413
galEp3,0.5,1,1,GATCATCCGGAGTCATTTTT,0,1562936
galEp3,0.5,1,1,GATCAGAGAAAAGTGCGGCT,0,1574949
galEp3,0.5,1,1,GATCACTAAACTAACCGTCA,0,1592296
galEp3,0.5,1,1,GATATGGAACTTTCAGACAA,0,1566086
galEp3,0.5,1,1,GATAGGCTGTTTTCGAAAGG,0,1586606
galEp3,0.5,1,1,GATAGGATAGCATGGTTCCA,0,1551068
galEp3,0.5,1,1,GATACTTTGATTTAACAGCC,0,1592686
galEp3,0.5,1,1,GATACCACGACTGTTTCACA,0,1562814
galEp3,0.5,1,1,GATAATAGCAAGAGGCCTAA,0,1574991
galEp3,0.5,1,1,GATAAGAAGGATAGAGTCAC,0,1568425
galEp3,0.5,1,1,GATAACGGGCTGGGACGTGA,0,1572865
galEp3,0.5,1,1,GAGTGTTGTGATCGTAGTAC,0,1561053
galEp3,0.5,1,1,GAGTCCAGGCATGCTATGGA,0,1574413
galEp3,0.5,1,1,GAGTCAGAATGGCCAACGTC,0,1553543
galEp3,0.5,1,1,GAGGGGCCTCCACCACGTAC,0,1586939
galEp3,0.5,1,1,GAGGCTAGTTTGACTACAAG,0,1589588
galEp3,0.5,1,1,GAGGATAGTACCGGAGGATA,0,1571847
galEp3,0.5,1,1,GAGGAGAAACCCACTTAAGT,0,1574472
galEp3,0.5,1,1,GAGCTTTAGGAGTCCTTGGT,0,1555060
galEp3,0.5,1,1,GAGCCGGCTTGGATGTTGCC,0,1572126
galEp3,0.5,1,1,GAGCCAGCATACGAGGCTTA,0,1571228
galEp3,0.5,1,1,GAGAGCATCTAGTTAAATGG,0,1555563
galEp3,0.5,1,1,GAGACGCTCAATGCGGGCGC,0,1583431
galEp3,0.5,1,1,GACTGCCTGTAACAATACTC,0,1592272
galEp3,0.5,1,1,GACTGCATAACCCCGTCCGA,0,1559850
galEp3,0.5,1,1,GACTCTCCGATGGCCAGGCA,0,1585878
galEp3,0.5,1,1,GACTCGAAGCTTAGCCATAT,0,1571125
galEp3,0.5,1,1,GACTCCGTCGTTATGCTTGC,0,1561507
galEp3,0.5,1,1,GACTCCGGTTAGATAATAGT,0,1579022
galEp3,0.5,1,1,GACTCCGGAACAGCGGCACG,0,1574442
galEp3,0.5,1,1,GACTCAGATGTGTTTTATAT,0,1579965
galEp3,0.5,1,1,GACTATACTATCGGGGTTAC,0,1571465
galEp3,0.5,1,1,GACGTCAGAAACGCTGATTT,0,1576182
galEp3,0.5,1,1,GACGTAGTGGACTTCGCGAC,0,1566064
galEp3,0.5,1,1,GACCTCATAGTAACTAATCT,0,1585535
galEp3,0.5,1,1,GACCGTGAGAGCCACGTCGC,0,1573328
galEp3,0.5,1,1,GACCGTACTTCCCTCGAATC,0,1559811
galEp3,0.5,1,1,GACCGCGAAAATGGCGAGGA,0,1586339
galEp3,0.5,1,1,GACCCTTTCATGTTCTATGC,0,1559797
galEp3,0.5,1,1,GACCCGGAGTAATTAATTAC,0,1576697
galEp3,0.5,1,1,GACCCGATTCGCCGGGGACC,0,1581645
galEp3,0.5,1,1,GACCCCTGCCTAGCCCTTAC,0,1586694
galEp3,0.5,1,1,GACCAAACGTTGTCTGGAAC,0,1579318
galEp3,0.5,1,1,GACATCCGGGGATTTCGAGT,0,1559174
galEp3,0.5,1,1,GACAGCCAGGGCGCACGACG,0,1570460
galEp3,0.5,1,1,GACACTATCGTGAGCGTAAG,0,1565939
galEp3,0.5,1,1,GACAAACCGAGGTTATACCT,0,1557355
galEp3,0.5,1,1,GAATTTAGTGGTCAGTAGGC,0,1546854
galEp3,0.5,1,1,GAATTATACCACCGCGCCTC,0,1550437
galEp3,0.5,1,1,GAATGGGACCTTAGATTGAA,0,1556713
galEp3,0.5,1,1,GAATCCAGGAACGTATGCCC,0,1590912
galEp3,0.5,1,1,GAAGTTCTTTTGATAGCGTC,0,1584501
galEp3,0.5,1,1,GAAGCGTATGCAAGCGGCAA,0,1556520
galEp3,0.5,1,1,GAAGCAAGCGCCATTCGCGG,0,1586830
galEp3,0.5,1,1,GAAGATAGAATCGTCCTGAA,0,1594448
galEp3,0.5,1,1,GAAGAGATGTGCCAAGCGAT,0,1556859
galEp3,0.5,1,1,GAAGAAATGTCTGCCGCCAG,0,1580277
galEp3,0.5,1,1,GAACGCAGTTTTGCGAACTC,0,1559230
galEp3,0.5,1,1,GAACAGAATTTGTAATGAGG,0,1589324
galEp3,0.5,1,1,GAACAAGCATTGTATGTCAA,0,1570935
galEp3,0.5,1,1,GAAATCCAGCTTGCATACTC,0,1577323
galEp3,0.5,1,1,GAAATCATCATTGGAGTTCT,0,1564467
galEp3,0.5,1,1,GAAAGCATCAGTGTAGTTGT,0,1574126
galEp3,0.5,1,1,GAAACTAGCGAATCGGCCTC,0,1585368
galEp3,0.5,1,1,GAAACCTGTGTCGAGTTAAT,0,1569376
galEp3,0.5,1,1,GAAAACATCGGGAGGGAGAA,0,1575882
galEp3,0.5,1,1,CTTTTCGCATGGCAGCGATT,0,1579455
galEp3,0.5,1,1,CTTTGTCCATGGAAGCGCCC,0,1553809
galEp3,0.5,1,1,CTTTGTCAGAGGCTGGGCAG,0,1574930
galEp3,0.5,1,1,CTTTGTAGACCGCCGTCCTT,0,1565753
galEp3,0.5,1,1,CTTTGATCGACTCATCGGAG,0,1549173
galEp3,0.5,1,1,CTTTGAGCGTTGACTGATAT,0,1558816
galEp3,0.5,1,1,CTTTGACAAGATTGGGACAC,0,1552267
galEp3,0.5,1,1,CTTTCTTATTGCTCATCCCT,0,1556447
galEp3,0.5,1,1,CTTTCTCCCGATCGGTCTGC,0,1592981
galEp3,0.5,1,1,CTTTCCAATGCCAAACATGC,0,1553619
galEp3,0.5,1,1,CTTTACGCGCTGAATTTCAA,0,1572559
galEp3,0.5,1,1,CTTGTACTTGGTTAGAGGTT,0,1594169
galEp3,0.5,1,1,CTTGGTGGTTGATTATCCTG,0,1585311
galEp3,0.5,1,1,CTTGGTCATATATACCATCT,0,1554092
galEp3,0.5,1,1,CTTGCTGAACGGCGACGCTA,0,1569065
galEp3,0.5,1,1,CTTGCGCGTTGTTGCCAATT,0,1549087
galEp3,0.5,1,1,CTTGAGTGGTGCCACAATGG,0,1590394
galEp3,0.5,1,1,CTTGAATTTATACCATATAT,0,1570499
galEp3,0.5,1,1,CTTCTGTGCTGGACGGGGAA,0,1576310
galEp3,0.5,1,1,CTTCTCAACCGGGTTACCGG,0,1562992
galEp3,0.5,1,1,CTTCGGGGAGTTAGACTGTC,0,1593951
galEp3,0.5,1,1,CTTCCTGTAAAGTGTCAGAT,0,1563558
galEp3,0.5,1,1,CTTCCATTGCAAACTGGTTT,0,1549668
galEp3,0.5,1,1,CTTCATCATAAGACTACGCC,0,1557436
galEp3,0.5,1,1,CTTCAACGTCGATATTCTAC,0,1547489
galEp3,0.5,1,1,CTTATGTGCCGGATCCGGAG,0,1562592
galEp3,0.5,1,1,CTTATGGGACAATTTTGGCA,0,1576226
galEp3,0.5,1,1,CTTAGGCATCAATGTTGAGA,0,1578983
galEp3,0.5,1,1,CTTAGGACTTTATACCCCTG,0,1551119
galEp3,0.5,1,1,CTTACTGGAGTAAGTCTTCT,0,1570108
galEp3,0.5,1,1,CTTACAAGTATGTCCGCACG,0,1591144
galEp3,0.5,1,1,CTTAACTCAAGGGACCTGTA,0,1549961
galEp3,0.5,1,1,CTTAAAGGTCTCTCAGCTGA,0,1569621
galEp3,0.5,1,1,CTGTTTGTGTTCGGTTCTGC,0,1568533
galEp3,0.5,1,1,CTGTTTATTTACGGTTCGAT,0,1587124
galEp3,0.5,1,1,CTGTGCTGCCGAACCTCGTG,0,1554905
galEp3,0.5,1,1,CTGTCTATATAGTGTTATCG,0,1554854
galEp3,0.5,1,1,CTGTCGTGAAACACTAATAT,0,1564253
galEp3,0.5,1,1,CTGTCCTCCCGTGGCGTAAC,0,1547803
galEp3,0.5,1,1,CTGTCAACTTATCAGTAGGC,0,1572521
galEp3,0.5,1,1,CTGTACGGGCAGGCTAGGGG,0,1569423
galEp3,0.5,1,1,CTGTACCACTTCTCTTGGAT,0,1562724
galEp3,0.5,1,1,CTGTAAAGTGGCGCATAATG,0,1553204
galEp3,0.5,1,1,CTGGTTGGGCGCCGGGGCGG,0,1577818
galEp3,0.5,1,1,CTGGTTATTCTTGTGCATAC,0,1562729
galEp3,0.5,1,1,CTGGTGGCAATGCTGCTCAT,0,1592364
galEp3,0.5,1,1,CTGGTAGATCGCCACGAGAA,0,1556281
galEp3,0.5,1,1,CTGGGTTAAAATTGAGGCGA,0,1548019
galEp3,0.5,1,1,CTGGGTCAGCCAGCAGTGGT,0,1572134
galEp3,0.5,1,1,CTGGGCTTGGTTTACCTCTG,0,1554604
galEp3,0.5,1,1,CTGGGCTTAGTTAATCCGCT,0,1585308
galEp3,0.5,1,1,CTGGCTGGCACTGATACGAT,0,1557112
galEp3,0.5,1,1,CTGGCGCTGTCGAGGCTAAA,0,1586209
galEp3,0.5,1,1,CTGGAGGGGTTTACCAGCAG,0,1594836
galEp3,0.5,1,1,CTGGAGAAAGCCCAGTCATG,0,1553530
galEp3,0.5,1,1,CTGGAACAAATGCCGTCTAC,0,1576711
galEp3,0.5,1,1,CTGCTTAGGAGCGTACGCGG,0,1558040
galEp3,0.5,1,1,CTGCTGCCGGGAAGGAAGCA,0,1552032
galEp3,0.5,1,1,CTGCTCCAGTTTACAGAGTA,0,1571203
galEp3,0.5,1,1,CTGCGGAGCCCAAAGTCATT,0,1553860
galEp3,0.5,1,1,CTGCCTAGGTCGTGATTAAT,0,1571238
galEp3,0.5,1,1,CTGCCGCCAGTTAGGTCCGA,0,1550509
galEp3,0.5,1,1,CTGCATGAGGCATAGCACCA,0,1571383
galEp3,0.5,1,1,CTGCATCCATGAGATGCTTT,0,1571139
galEp3,0.5,1,1,CTGCAGCTACTACAACTATG,0,1564163
galEp3,0.5,1,1,CTGATTGATCGGTTGGCACA,0,1574983
galEp3,0.5,1,1,CTGATGTCTCTGCCTGCTCG,0,1549346
galEp3,0.5,1,1,CTGATAGCAGCCATTAAGGC,0,1570513
galEp3,0.5,1,1,CTGAGCTTACCACAATGCGA,0,1570640
galEp3,0.5,1,1,CTGAGCAAAAAATTTGTTGG,0,1560731
galEp3,0.5,1,1,CTGAATTCCGCTCTTCTAGG,0,1573085
galEp3,0.5,1,1,CTGAACTTATCAGTTTATCT,0,1573264
galEp3,0.5,1,1,CTCTTTGGTGGTAATGTGTG,0,1579137
galEp3,0.5,1,1,CTCTTGGTCGTTAAGCCTAC,0,1582417
galEp3,0.5,1,1,CTCTGTGACCTAGTGTTGGA,0,1555836
galEp3,0.5,1,1,CTCTCGCATAGGCTAATGTA,0,1553614
galEp3,0.5,1,1,CTCTAAGGCGCAGAGAATTA,0,1594583
galEp3,0.5,1,1,CTCTAACAGGCCTCTTGGCG,0,1585215
galEp3,0.5,1,1,CTCGTCTTCCCTATTTCGCA,0,1566033
galEp3,0.5,1,1,CTCGTCGCAGTCTGTAGGTT,0,1564422
galEp3,0.5,1,1,CTCGCATGGGAGCTCATGGA,0,1567024
galEp3,0.5,1,1,CTCGAAAAGTTACGCGATGA,0,1568413
galEp3,0.5,1,1,CTCCTCGCAAGTTTTGACGT,0,1567582
galEp3,0.5,1,1,CTCCTATCGAAGGGAGCATC,0,1582869
galEp3,0.5,1,1,CTCCGCTATTGCGAGCCAGA,0,1571364
galEp3,0.5,1,1,CTCCAGCAGACCCTCCAATA,0,1578605
galEp3,0.5,1,1,CTCCACATATGTGAGTAAGC,0,1592318
galEp3,0.5,1,1,CTCATGGCCATAGTTGACTT,0,1592868
galEp3,0.5,1,1,CTCAGTGTGTCAGGTATCGA,0,1587501
galEp3,0.5,1,1,CTCAGTGGGATATTGTAGCG,0,1590736
galEp3,0.5,1,1,CTCACGTTTCTTTGACGAAC,0,1564937
galEp3,0.5,1,1,CTCAATTGGACGCTGGTTCC,0,1593489
galEp3,0.5,1,1,CTATTTAATATCTGCGGTAT,0,1593056
galEp3,0.5,1,1,CTATTCGCCCGCTTATGCCA,0,1572522
galEp3,0.5,1,1,CTATTATTAGGTAGGTCGGA,0,1549221
galEp3,0.5,1,1,CTATGGAAGACGACAAGGAC,0,1587386
galEp3,0.5,1,1,CTATGCCGTGTATTTGGTAG,0,1550664
galEp3,0.5,1,1,CTATGAGTAGCGTGAAATAC,0,1555352
galEp3,0.5,1,1,CTATCCTTTTTTATCTCGAA,0,1550906
galEp3,0.5,1,1,CTATATATCCCCCCACGATC,0,1576194
galEp3,0.5,1,1,CTATAAAAGAAGAACTCGCA,0,1590258
galEp3,0.5,1,1,CTAGTTGCCTAATAGGGCAA,0,1557228
galEp3,0.5,1,1,CTAGGTGGCTGTCCCAATCC,0,1570754
galEp3,0.5,1,1,CTAGGGAGGGGGGTCTGATG,0,1550621
galEp3,0.5,1,1,CTAGCTGGACTGCGAGCAGC,0,1568912
galEp3,0.5,1,1,CTACTGTTGGCCGGGTTATT,0,1553920
galEp3,0.5,1,1,CTACTGGTCACAGACTAACT,0,1568175
galEp3,0.5,1,1,CTACGCGAACATCCCTCCAT,0,1552506
galEp3,0.5,1,1,CTACGCCACTATTAGAAGCA,0,1555755
galEp3,0.5,1,1,CTACGACCAGCTGCCGTCAA,0,1589501
galEp3,0.5,1,1,CTACCGATGGAGTGACATAT,0,1571991
galEp3,0.5,1,1,CTACATTTCGTCTTGTGTCA,0,1590605
galEp3,0.5,1,1,CTAATTAACCATTATCCACT,0,1566499
galEp3,0.5,1,1,CTAATGTGCGAAGCCCGGCG,0,1563353
galEp3,0.5,1,1,CTAAGGCAGCCGAAAAACTG,0,1576205
galEp3,0.5,1,1,CTAAGACGGGCAATGCCGAA,0,1589878
galEp3,0.5,1,1,CTAACATCGTATCGTCCCGA,0,1583430
galEp3,0.5,1,1,CTAACAATGATTTTGGACTC,0,1591958
galEp3,0.5,1,1,CTAAAATTGGGAAAAAACAA,0,1585844
galEp3,0.5,1,1,CGTTTTGCAGACAGAGCCCA,0,1574249
galEp3,0.5,1,1,CGTTTGCAGTGGATGTCTGG,0,1562196
galEp3,0.5,1,1,CGTTGTGCCAAAAGGGTCCC,0,1591392
galEp3,0.5,1,1,CGTTGCTCGGTGCCCAGTTG,0,1569858
galEp3,0.5,1,1,CGTTGCGGAAGGGTATGGTT,0,1587551
galEp3,0.5,1,1,CGTTCTTGACGTTGAGAAGC,0,1586422
galEp3,0.5,1,1,CGTTCCCTGATGAAAATACT,0,1584716
galEp3,0.5,1,1,CGTTATGGTTAAGTCGGAAT,0,1577138
galEp3,0.5,1,1,CGTTATATGAAAGTTTCTGT,0,1575406
galEp3,0.5,1,1,CGTTATACTTACGCGGAACG,0,1576588
galEp3,0.5,1,1,CGTGTCTAAATAATAAAGCT,0,1591171
galEp3,0.5,1,1,CGTGTATGCGGGACGAATGA,0,1584758
galEp3,0.5,1,1,CGTGGTTGTGCTGAGTTTAC,0,1573522
galEp3,0.5,1,1,CGTGGGTATTGTTAATTGAT,0,1574284
galEp3,0.5,1,1,CGTGGCAAAGGGGGCACACG,0,1555645
galEp3,0.5,1,1,CGTGAGTAGACCATTTGCCC,0,1580913
galEp3,0.5,1,1,CGTGAACCAGTAGACCGGGG,0,1555605
galEp3,0.5,1,1,CGTCTCTCCCGGTTAACAAA,0,1582745
galEp3,0.5,1,1,CGTCGAACACCGCAACATGC,0,1571458
galEp3,0.5,1,1,CGTCCGTAGCGTCCGTTGCC,0,1572581
galEp3,0.5,1,1,CGTCCGGGTCATGTGGGCAG,0,1581789
galEp3,0.5,1,1,CGTCCAGAAAAATACTCGCC,0,1571504
galEp3,0.5,1,1,CGTCCACTCGTATACCCTCA,0,1584626
galEp3,0.5,1,1,CGTCATTAGCAGAACTCTCG,0,1577668
galEp3,0.5,1,1,CGTCATCTCTATGGCCAAGT,0,1574888
galEp3,0.5,1,1,CGTATCGTAGGCAGTCCGAC,0,1560471
galEp3,0.5,1,1,CGTATATCTCGAGCCTACTT,0,1574011
galEp3,0.5,1,1,CGTAGAGGTTTGGTTTTTGA,0,1559924
galEp3,0.5,1,1,CGTACTCTCTTTTAGTTCGT,0,1573080
galEp3,0.5,1,1,CGTACCCTAAAAGGGTTGGG,0,1582632
galEp3,0.5,1,1,CGTAATAATACACTTATTAA,0,1585937
galEp3,0.5,1,1,CGTAAACAGCCAGCCTGTAT,0,1571954
galEp3,0.5,1,1,CGGTTTAGCGTGTCATGAAA,0,1593628
galEp3,0.5,1,1,CGGTTCCACGATTGCAATAT,0,1549632
galEp3,0.5,1,1,CGGTGGTCTAGGCTAAGAGG,0,1572501
galEp3,0.5,1,1,CGGTGGGGTCTGGAATATAT,0,1587780
galEp3,0.5,1,1,CGGTGGAGGCATGCACTTCT,0,1562962
galEp3,0.5,1,1,CGGTGCCATCAAGTTAAGCC,0,1570436
galEp3,0.5,1,1,CGGTCTGAATTCGCAGTATA,0,1557264
galEp3,0.5,1,1,CGGTCTCATAGGCGCAATAC,0,1569723
galEp3,0.5,1,1,CGGTCCGAGCAACCCTGCAG,0,1579892
galEp3,0.5,1,1,CGGGTTCATCGGGCCGGAGG,0,1572286
galEp3,0.5,1,1,CGGGTATTGTATATTATACC,0,1585071
galEp3,0.5,1,1,CGGGTACGTTAGGCTATCTC,0,1580954
galEp3,0.5,1,1,CGGGGCATAACGCTCATTGG,0,1565481
galEp3,0.5,1,1,CGGGCTGGGGTATCAGGAGT,0,1590710
galEp3,0.5,1,1,CGGGATGAAAAATCGATCAA,0,1563267
galEp3,0.5,1,1,CGGGATATCTCATCTCGGAT,0,1548898
galEp3,0.5,1,1,CGGGAGTCCTGGGGGCGGAC,0,1586161
galEp3,0.5,1,1,CGGGAAAACCTTACTGGTTT,0,1580057
galEp3,0.5,1,1,CGGCTGCGCTCTAGTCTGGT,0,1555220
galEp3,0.5,1,1,CGGCGGGGGCTAACTACTCT,0,1569456
galEp3,0.5,1,1,CGGCGCTGAATTGGGCCAGG,0,1577128
galEp3,0.5,1,1,CGGCCCTTGGTCTGGGAAAC,0,1557330
galEp3,0.5,1,1,CGGCAATAAAGTCTCAGTAG,0,1586665
galEp3,0.5,1,1,CGGATGTGCGAGTAGAGGCA,0,1552351
galEp3,0.5,1,1,CGGAGGATCTGGTGCGAACG,0,1588958
galEp3,0.5,1,1,CGGAGAGATCGTTCTCCGCG,0,1547432
galEp3,0.5,1,1,CGGAGACCAAGCAAACCGAT,0,1576477
galEp3,0.5,1,1,CGGACTTATGAAGATTTTGA,0,1573053
galEp3,0.5,1,1,CGGACCAGTGCAGATAAATG,0,1593624
galEp3,0.5,1,1,CGGAACCACGATTTAACCGG,0,1552590
galEp3,0.5,1,1,CGCTGGCTCACGTCCAGGTT,0,1585694
galEp3,0.5,1,1,CGCTCCATAGTAGTGGCGCA,0,1589218
galEp3,0.5,1,1,CGCTCAATTGAAGCTCAGTT,0,1575637
galEp3,0.5,1,1,CGCTAATCCCCCAGTCATCT,0,1547311
galEp3,0.5,1,1,CGCGTTTTCTGCTGTGCGAT,0,1592163
galEp3,0.5,1,1,CGCGTTCATGCAGGTTTGAA,0,1587970
galEp3,0.5,1,1,CGCGTGATTCATTTAATACA,0,1559264
galEp3,0.5,1,1,CGCGTCTTCATTCCTCGTTT,0,1590669
galEp3,0.5,1,1,CGCGGTATAATACGTTATGC,0,1578527
galEp3,0.5,1,1,CGCGGACAGGCAAACTAGAC,0,1555697
galEp3,0.5,1,1,CGCGGAAGTTGCGCGCCCTT,0,1594213
galEp3,0.5,1,1,CGCGCTCAAGGGCCGCCCGT,0,1571115
galEp3,0.5,1,1,CGCGCTAACTACGGGCGGAC,0,1574567
galEp3,0.5,1,1,CGCGCACAGCGGCACTTAGC,0,1557686
galEp3,0.5,1,1,CGCGATAATTTTTAAAGTGA,0,1570285
galEp3,0.5,1,1,CGCGAGAGAGTCCAGCACAA,0,1583540
galEp3,0.5,1,1,CGCCGGTACAGATACACACC,0,1565242
galEp3,0.5,1,1,CGCCCGGGCAAGTTATTAGT,0,1565382
galEp3,0.5,1,1,CGCCCGCGCAGAGCTAGGCG,0,1559452
galEp3,0.5,1,1,CGCCCAATAGGCGTATACGG,0,1557259
galEp3,0.5,1,1,CGCCAACCATACCTTGTCAG,0,1571727
galEp3,0.5,1,1,CGCATGTGCCCTCGCAGGTA,0,1588755
galEp3,0.5,1,1,CGCATCGGTGTATTGCCATA,0,1567039
galEp3,0.5,1,1,CGCAGTTGTAGAAGGATGGC,0,1572943
galEp3,0.5,1,1,CGCAGGCAAACCCCAAGACT,0,1566836
galEp3,0.5,1,1,CGCACGTCAATGTCATACCC,0,1566280
galEp3,0.5,1,1,CGCAATGTGTAACTTTTCCA,0,1566213
galEp3,0.5,1,1,CGCAAGCCAAATACTCGCAA,0,1571296
galEp3,0.5,1,1,CGCAACGTTACAATTTCGTT,0,1564594
galEp3,0.5,1,1,CGATTTACAGTTATACAGTG,0,1555358
galEp3,0.5,1,1,CGATTTAACCCGCCATGGAG,0,1583227
galEp3,0.5,1,1,CGATTAGCATCCCATATATG,0,1570967
galEp3,0.5,1,1,CGATGCGTAACAGTCGCTGT,0,1574931
galEp3,0.5,1,1,CGATGATAAACGCTCCTGTT,0,1570759
galEp3,0.5,1,1,CGATAGCCTGCATCACCTCA,0,1566028
galEp3,0.5,1,1,CGATAGCACACAGTGTGGTT,0,1585615
galEp3,0.5,1,1,CGATAATCCGTCGTTCGGTT,0,1548732
galEp3,0.5,1,1,CGAGTCCAAATTGCAATGAG,0,1547068
galEp3,0.5,1,1,CGAGCGCTGTCCTGTCCGGT,0,1565207
galEp3,0.5,1,1,CGAGCAGAATACCTCTAAGT,0,1546958
galEp3,0.5,1,1,CGAGACTTAGAGGGGTCCGA,0,1575592
galEp3,0.5,1,1,CGAGACTCCGACAGAAAGAG,0,1566198
galEp3,0.5,1,1,CGACTGCTAAATGCATGTCA,0,1573379
galEp3,0.5,1,1,CGACTACAAATCTTCTGTGC,0,1548741
galEp3,0.5,1,1,CGACGTCGGTAGTCGCCGGC,0,1574663
galEp3,0.5,1,1,CGACGCGATTCATCATGATA,0,1573700
galEp3,0.5,1,1,CGACATGGCGGGATTAGCTT,0,1580299
galEp3,0.5,1,1,CGAATCCCGGACTAACGAGA,0,1576166
galEp3,0.5,1,1,CGAATCAAGCACTTTGGCAC,0,1565255
galEp3,0.5,1,1,CGAAAGAGGATATGTAATTG,0,1584243
galEp3,0.5,1,1,CCTTTGTCATGTGGGAACGA,0,1589160
galEp3,0.5,1,1,CCTTTCGCGTGCTCTTCCGT,0,1588380
galEp3,0.5,1,1,CCTTTCGCAAATATCGAAGC,0,1555558
galEp3,0.5,1,1,CCTTTATAACTTCCTGCCGT,0,1575286
galEp3,0.5,1,1,CCTTCTACCGAACGGTTCGA,0,1558209
galEp3,0.5,1,1,CCTTCCCCGGTCCCCGGATA,0,1566428
galEp3,0.5,1,1,CCTGTTGGAGGTGGTGCCTA,0,1592049
galEp3,0.5,1,1,CCTGTCATGAGGGGAAGTTC,0,1548532
galEp3,0.5,1,1,CCTGTAGTGGTTAATGTCCC,0,1556213
galEp3,0.5,1,1,CCTGCTAGCCGCCTCACACA,0,1584731
galEp3,0.5,1,1,CCTGATTGGGACTACAACCG,0,1584236
galEp3,0.5,1,1,CCTCGGCCATCGCGTTTCTC,0,1566420
galEp3,0.5,1,1,CCTCGCCCTACGGACTGTGA,0,1554655
galEp3,0.5,1,1,CCTCGCCACTGCCGTACCGA,0,1552261
galEp3,0.5,1,1,CCTCCTGGAAATAGAGAAGT,0,1580554
galEp3,0.5,1,1,CCTCCGGGGTCTGACCATTC,0,1591445
galEp3,0.5,1,1,CCTCCAGCCTACTCTACTGA,0,1583222
galEp3,0.5,1,1,CCTCAGACAAAACCGGGCTC,0,1580337
galEp3,0.5,1,1,CCTATTTGCGTCGTTATATC,0,1578021
galEp3,0.5,1,1,CCTATTGCGAATCGTCTCAT,0,1563108
galEp3,0.5,1,1,CCTATCGAATCCTAGCGCTA,0,1571419
galEp3,0.5,1,1,CCTAGGTCGATCTAGACAAT,0,1590444
galEp3,0.5,1,1,CCTAGACGTTAACCTGCAGA,0,1581470
galEp3,0.5,1,1,CCTAGACGGCAGACATTCCC,0,1586932
galEp3,0.5,1,1,CCTAATGCCGTACTGGATTA,0,1551018
galEp3,0.5,1,1,CCGTTGTCTTCTTGGCAATA,0,1555723
galEp3,0.5,1,1,CCGTTGGGGTGCGCAGCAGA,0,1553983
galEp3,0.5,1,1,CCGTTCGACTCTTTTCGGAG,0,1564017
galEp3,0.5,1,1,CCGTTACCCCTAGACTGGGC,0,1548041
galEp3,0.5,1,1,CCGTAGCCGTAACGATACCC,0,1594528
galEp3,0.5,1,1,CCGTACCATTTTCATACTCA,0,1551193
galEp3,0.5,1,1,CCGGTCCCCGGGCACTCAGG,0,1567401
galEp3,0.5,1,1,CCGGGTCTATTGTGAGCTGA,0,1569944
galEp3,0.5,1,1,CCGGGTAAGTAAAGTTCTTC,0,1550963
galEp3,0.5,1,1,CCGGGAGGCAAAATTCCCAA,0,1568574
galEp3,0.5,1,1,CCGGATATCGACCGGCTCTG,0,1588827
galEp3,0.5,1,1,CCGCTGCGATCCCGTATGTA,0,1552899
galEp3,0.5,1,1,CCGCCTGGAGTAGTTCGTAC,0,1547457
galEp3,0.5,1,1,CCGCCCGAGAGTGACTCCAA,0,1558536
galEp3,0.5,1,1,CCGCAGGTGCCCCGTCCCCT,0,1568396
galEp3,0.5,1,1,CCGCACCCATTACCTTTAAT,0,1548262
galEp3,0.5,1,1,CCGATAGGTAGGTCTGCACA,0,1563974
galEp3,0.5,1,1,CCGACAGACCGTAGAGTTCG,0,1552697
galEp3,0.5,1,1,CCCTTTCGCACGAATAAGGA,0,1549142
galEp3,0.5,1,1,CCCTTGCATTATGGCCGGCA,0,1559085
galEp3,0.5,1,1,CCCTGACGAAGTCAAGCCTC,0,1576470
galEp3,0.5,1,1,CCCTCGGCCGTAGCCGAGTT,0,1557803
galEp3,0.5,1,1,CCCTCCTACTAGAGATATAT,0,1565665
galEp3,0.5,1,1,CCCTAGTGAACTTTTCGGAT,0,1569922
galEp3,0.5,1,1,CCCGCCTCGGGTCTGTGTGC,0,1562317
galEp3,0.5,1,1,CCCGCAGGTGCATCGGGTAC,0,1557127
galEp3,0.5,1,1,CCCGCAACCCCTGTCCCTTC,0,1571277
galEp3,0.5,1,1,CCCCCGTCCGACACGGTGGG,0,1557481
galEp3,0.5,1,1,CCCCCAGCTTTCGGTCGCCC,0,1587029
galEp3,0.5,1,1,CCCCAGGAATTCCCTTAGTA,0,1581148
galEp3,0.5,1,1,CCCCAAGCTGATTCAAGTTC,0,1586331
galEp3,0.5,1,1,CCCAGATCCCTCACGTGCTG,0,1562070
galEp3,0.5,1,1,CCCACCCCGAGGGTTTCAAG,0,1575668
galEp3,0.5,1,1,CCCAACCCTGCCGACCTGAA,0,1563969
galEp3,0.5,1,1,CCCAAATTTTGAATTGTATT,0,1591500
galEp3,0.5,1,1,CCATGTGTACACGAGCGATT,0,1549308
galEp3,0.5,1,1,CCATGATCGCACGTGACGGA,0,1570701
galEp3,0.5,1,1,CCATCGCACGAATTCCTGGA,0,1576419
galEp3,0.5,1,1,CCAGGTAAATGGGCCTTACA,0,1567458
galEp3,0.5,1,1,CCAGCTTAAGGTAAGTTACC,0,1590244
galEp3,0.5,1,1,CCAGCACGCTCAACAACCTC,0,1571054
galEp3,0.5,1,1,CCACTGTCTATAAGCATCAA,0,1571612
galEp3,0.5,1,1,CCACGTGGTTCCATTGCTAA,0,1587952
galEp3,0.5,1,1,CCAATTGGGGTCATACGTCG,0,1561659
galEp3,0.5,1,1,CCAATGATTCGGGCCAGCAG,0,1575967
galEp3,0.5,1,1,CCAATCGAAGAGTTGCTATG,0,1549885
galEp3,0.5,1,1,CCAATACAGAGGTAGCCCGA,0,1549717
galEp3,0.5,1,1,CCAATAAACGGACCGCAGTG,0,1566901
galEp3,0.5,1,1,CCAACACAAGCTGACTTCAT,0,1553311
galEp3,0.5,1,1,CCAACAATAGTGCACAAGAT,0,1559714
galEp3,0.5,1,1,CATTTTGAAATGGATGCCGA,0,1549969
galEp3,0.5,1,1,CATTTCGACTGGTGCACGCA,0,1580585
galEp3,0.5,1,1,CATTCGAATACTAGACAGCA,0,1569823
galEp3,0.5,1,1,CATTCAATCTCTTGTAGAAC,0,1571645
galEp3,0.5,1,1,CATTAAATCTGGCAAGGGAG,0,1549067
galEp3,0.5,1,1,CATGTTGATTTCTAGGTCCT,0,1582669
galEp3,0.5,1,1,CATGTTCACTCGGTGACCCT,0,1589109
galEp3,0.5,1,1,CATGTATGTGAGCATGTGAT,0,1588863
galEp3,0.5,1,1,CATGGATGTGAAGGCCAATT,0,1571155
galEp3,0.5,1,1,CATGGAAAGAGGGTCGCCTG,0,1576190
galEp3,0.5,1,1,CATGCCAGCTCTGCCGGCGT,0,1578384
galEp3,0.5,1,1,CATGATACTAAGTTACAGAA,0,1581378
galEp3,0.5,1,1,CATGACAGCAAGGGTTAAAT,0,1563855
galEp3,0.5,1,1,CATGAACTCCTCGTTTGCCA,0,1569254
galEp3,0.5,1,1,CATCTGTCGATACCAGTAGG,0,1588976
galEp3,0.5,1,1,CATCTGGTAGACCACACCTC,0,1586519
galEp3,0.5,1,1,CATCCAAGTCACTACTTGTC,0,1547503
galEp3,0.5,1,1,CATCATTCCACTATTAGGAA,0,1554023
galEp3,0.5,1,1,CATCAGAGAGCCTAAGATCC,0,1546559
galEp3,0.5,1,1,CATCACTCTGACCGAGGGAC,0,1547781
galEp3,0.5,1,1,CATCACATCGTCACTACTGG,0,1547983
galEp3,0.5,1,1,CATATTCGGTTCGTACAACG,0,1557580
galEp3,0.5,1,1,CATAGATGGGGGCGCACCTA,0,1569936
galEp3,0.5,1,1,CATACGCTGACACGTATCCT,0,1591861
galEp3,0.5,1,1,CAGTTGGCTCGCGTGTCATG,0,1586035
galEp3,0.5,1,1,CAGTTGGAACTAACCTTTGG,0,1565553
galEp3,0.5,1,1,CAGTTATCAGCGATCTGCGG,0,1575075
galEp3,0.5,1,1,CAGTGGCTTTCCAGTTGGGT,0,1561841
galEp3,0.5,1,1,CAGTCGCCCATGTACCCCCC,0,1587593
galEp3,0.5,1,1,CAGTCAACCGACGATGGAAG,0,1584406
galEp3,0.5,1,1,CAGTATGGTTCCTAGCATGG,0,1585447
galEp3,0.5,1,1,CAGTAGGGCGGCGCTACAAA,0,1580034
galEp3,0.5,1,1,CAGGTTCATATATTCCACTC,0,1565222
galEp3,0.5,1,1,CAGGTCCTATGTTGGATCGT,0,1564679
galEp3,0.5,1,1,CAGGGTTGGTGAGCAGCCCC,0,1584749
galEp3,0.5,1,1,CAGGGAACCCCTCGTATTAT,0,1554255
galEp3,0.5,1,1,CAGGGAACCATATCGATGAG,0,1569069
galEp3,0.5,1,1,CAGGCGCCAAGCCAACTCGC,0,1590767
galEp3,0.5,1,1,CAGGCGCATACATTCAAAAT,0,1574055
galEp3,0.5,1,1,CAGGCGCACCGTATGACTGG,0,1553961
galEp3,0.5,1,1,CAGGCCGCCGACAAGAATAG,0,1546720
galEp3,0.5,1,1,CAGGCAGCAAATGGATAATA,0,1552031
galEp3,0.5,1,1,CAGGCACCACAGTAGGGCGT,0,1573271
galEp3,0.5,1,1,CAGCTGTGGCTATCAGAGGC,0,1554256
galEp3,0.5,1,1,CAGCTGATATCCTGAATTGT,0,1565211
galEp3,0.5,1,1,CAGCGGTAGTGGCATTATTC,0,1547938
galEp3,0.5,1,1,CAGCGATTTATATCAGTTCA,0,1551984
galEp3,0.5,1,1,CAGCCCGAGGTAATATCCTT,0,1547394
galEp3,0.5,1,1,CAGCACACAGCCCCTGTCTT,0,1549611
galEp3,0.5,1,1,CAGATGAACGTTCATTGCGT,0,1583176
galEp3,0.5,1,1,CAGATCCGCAGGCACATGTT,0,1566394
galEp3,0.5,1,1,CAGAGGCACAATTATAGTCA,0,1571745
galEp3,0.5,1,1,CAGAGGATGCTGTGTTTCCT,0,1560118
galEp3,0.5,1,1,CAGAATGGAAGTAGCAGAGA,0,1553685
galEp3,0.5,1,1,CACTTTAGCGTAGTTCCTAA,0,1548348
galEp3,0.5,1,1,CACTTTAGACGCTTGATAGG,0,1549593
galEp3,0.5,1,1,CACTTCGGGGGCCAGGACTA,0,1553241
galEp3,0.5,1,1,CACTGGTGACTATCAGATAT,0,1572381
galEp3,0.5,1,1,CACTCGGCGCATCAATGAGC,0,1584196
galEp3,0.5,1,1,CACTAGCGGGGCAATAGCCA,0,1561805
galEp3,0.5,1,1,CACTAATTCATATTAATATC,0,1592748
galEp3,0.5,1,1,CACGTATAGGCGCACCGCCA,0,1558374
galEp3,0.5,1,1,CACGGGATGGCAAGTGTAAA,0,1585850
galEp3,0.5,1,1,CACGGGACCGATGCTGCTCG,0,1585216
galEp3,0.5,1,1,CACGGCACACAGGGGTGCCA,0,1584200
galEp3,0.5,1,1,CACGGATCGCCCCCATCATA,0,1585354
galEp3,0.5,1,1,CACGGATACGAGGCTACATT,0,1564991
galEp3,0.5,1,1,CACGATGAAGGAGCACTACT,0,1590025
galEp3,0.5,1,1,CACGAGGCGGTCCGACGCAT,0,1549014
galEp3,0.5,1,1,CACCGTGGAGCTAACCGTTG,0,1569296
galEp3,0.5,1,1,CACCGCACCTTGAATTCGCC,0,1565107
galEp3,0.5,1,1,CACCCTGCATCGCGCAGTTC,0,1563041
galEp3,0.5,1,1,CACCCTGACGGTTTCCCTAG,0,1567463
galEp3,0.5,1,1,CACCCTAGTGTGTACATGAC,0,1561786
galEp3,0.5,1,1,CACCCGCTTAACTTCTTGAT,0,1560374
galEp3,0.5,1,1,CACCCATCGCAGCCGACTAG,0,1589678
galEp3,0.5,1,1,CACCATCAAGCTTTTGTAAT,0,1582492
galEp3,0.5,1,1,CACCAGCTCGGGGTTTGCTG,0,1584233
galEp3,0.5,1,1,CACATGGACACGTGGGTTGT,0,1551089
galEp3,0.5,1,1,CACAGATCGCAGATCAACTG,0,1576052
galEp3,0.5,1,1,CACAGAAACAGGTTATCCAT,0,1584886
galEp3,0.5,1,1,CACACTCACAGCCTAGGGTC,0,1576252
galEp3,0.5,1,1,CACACGCGACATAGCGGGTT,0,1587567
galEp3,0.5,1,1,CACAAGTTTAAAGTCGAGAT,0,1577387
galEp3,0.5,1,1,CACAACGCCCCGTTTAGTCA,0,1566889
galEp3,0.5,1,1,CAATTTTATTCTGGGGGGTA,0,1572292
galEp3,0.5,1,1,CAATTTCTAGGCATTTAGCT,0,1550961
galEp3,0.5,1,1,CAATTCGTCGTGGTGTAGGA,0,1580280
galEp3,0.5,1,1,CAATTATCAGGACGCATCAA,0,1553005
galEp3,0.5,1,1,CAATGGGTTGTCTTGGAAAT,0,1553970
galEp3,0.5,1,1,CAATGACCCATGTTATCGCT,0,1570412
galEp3,0.5,1,1,CAATCGAGGTGCGCCATTAG,0,1569536
galEp3,0.5,1,1,CAATCAGCCCGCCGTAGCAG,0,1592357
galEp3,0.5,1,1,CAATAACCCGTATATGGCTA,0,1569851
galEp3,0.5,1,1,CAAGTCGGGTCCTTCATTCT,0,1568150
galEp3,0.5,1,1,CAACTTGCAACCCGCGAAAG,0,1553746
galEp3,0.5,1,1,CAACTGAACATAGGTATAGC,0,1563085
galEp3,0.5,1,1,CAACTCTTTATCTGGTATTC,0,1569604
galEp3,0.5,1,1,CAACCATAGGAGCCATCTGA,0,1585218
galEp3,0.5,1,1,CAACAGGGGTTAGGGACAAT,0,1575920
galEp3,0.5,1,1,CAACAGCGCGCCCAATAATT,0,1568091
galEp3,0.5,1,1,CAACAGCCAGGGTCAGTATT,0,1561969
galEp3,0.5,1,1,CAAAGCTTATATGAATACCA,0,1570456
galEp3,0.5,1,1,CAAAATTCTGCTAATCGGCA,0,1574388
galEp3,0.5,1,1,ATTTTTGTGACCGTCTTTTT,0,1585574
galEp3,0.5,1,1,ATTTTTCCTTTCATGCACAC,0,1578208
galEp3,0.5,1,1,ATTTTCATGGGCGGTGAGAG,0,1594630
galEp3,0.5,1,1,ATTTTAATATCATCACTGGG,0,1565243
galEp3,0.5,1,1,ATTTGGAATAACAAGATCAT,0,1580279
galEp3,0.5,1,1,ATTTGCTTACAAAATCTACG,0,1569639
galEp3,0.5,1,1,ATTTGAGAACCGCACGTGGC,0,1583509
galEp3,0.5,1,1,ATTTCGGTAACCAACGATTC,0,1550925
galEp3,0.5,1,1,ATTTCCAGGTTTAATGCTCC,0,1589286
galEp3,0.5,1,1,ATTTATCTAAATTAAAAACC,0,1589597
galEp3,0.5,1,1,ATTTACGGGTGATGAAGTTA,0,1553473
galEp3,0.5,1,1,ATTTACACAAGGAGTCCAAC,0,1559110
galEp3,0.5,1,1,ATTGGGGACCTCAGGAGCTT,0,1594916
galEp3,0.5,1,1,ATTGATTTGGTTTCAAACCA,0,1550020
galEp3,0.5,1,1,ATTGACTGGGGAATGACAAT,0,1579365
galEp3,0.5,1,1,ATTGACTGAATAGAACCCCT,0,1555164
galEp3,0.5,1,1,ATTCGTTTGGGCTATTTGCG,0,1588812
galEp3,0.5,1,1,ATTCGTTCAAATCCCAGATG,0,1549097
galEp3,0.5,1,1,ATTCCGGGGAGTCGGGATCT,0,1555839
galEp3,0.5,1,1,ATTCCCCATACATGGTAGTA,0,1575374
galEp3,0.5,1,1,ATTCAGGCATTATAGTAGAG,0,1552212
galEp3,0.5,1,1,ATTATCGAGGTGAAGCAATG,0,1556254
galEp3,0.5,1,1,ATTAGGTCAATGTTAAGCCC,0,1586942
galEp3,0.5,1,1,ATTAGATCTTAATCAGAGCC,0,1560915
galEp3,0.5,1,1,ATTACCCTGTGATAAGTATT,0,1590246
galEp3,0.5,1,1,ATTAAGGAGGTCGGTGTGGA,0,1553918
galEp3,0.5,1,1,ATTAAGACCCTAAGTACCAC,0,1586294
galEp3,0.5,1,1,ATTAACAGTTAGGAGTGTGC,0,1556635
galEp3,0.5,1,1,ATGTTCGGTGGCCGCGATTA,0,1578158
galEp3,0.5,1,1,ATGTGCGCGAGCAGCACCTG,0,1586542
galEp3,0.5,1,1,ATGTGACTATGAAGCCCCGC,0,1590665
galEp3,0.5,1,1,ATGTCTCGTGACGTGGCAGT,0,1548056
galEp3,0.5,1,1,ATGGGCGTTCGGAGTGCGCA,0,1552685
galEp3,0.5,1,1,ATGGCTAAGGGCTTAACAGA,0,1558706
galEp3,0.5,1,1,ATGGCCCAGTGATCCTGCTG,0,1561403
galEp3,0.5,1,1,ATGGACCTCTATTCGCTGAT,0,1550214
galEp3,0.5,1,1,ATGCGCCGTGAGCATTGGCT,0,1575903
galEp3,0.5,1,1,ATGCGCATTTACGCAGGAGA,0,1553524
galEp3,0.5,1,1,ATGCCTGAGCTTGGAACTCA,0,1548178
galEp3,0.5,1,1,ATGCCCGACCTTCCTTAAAG,0,1582787
galEp3,0.5,1,1,ATGCCCAACTCCAAGAAGAC,0,1564972
galEp3,0.5,1,1,ATGCCAATGATATGTCCACA,0,1592486
galEp3,0.5,1,1,ATGCATTATCAATTTATTGT,0,1547482
galEp3,0.5,1,1,ATGCATCTTGTGGGATCCGA,0,1552071
galEp3,0.5,1,1,ATGCAAATTAGTACTATGTC,0,1568248
galEp3,0.5,1,1,ATGATCACGAAACCGGCTAA,0,1567040
galEp3,0.5,1,1,ATGATAAGCATTTCCACTTT,0,1585556
galEp3,0.5,1,1,ATGAGTTGTGGAGGGGTGCT,0,1590696
galEp3,0.5,1,1,ATGAGCTGGAACCGGACGCC,0,1565983
galEp3,0.5,1,1,ATGACTATTGCTTTGAGTAT,0,1567225
galEp3,0.5,1,1,ATGACCGTAGGCTTATGCTA,0,1586293
galEp3,0.5,1,1,ATGAATTTTATGCTTAATCT,0,1590864
galEp3,0.5,1,1,ATGAAGTATTGACATGCATC,0,1584393
galEp3,0.5,1,1,ATGAACTGATCCCATGCACC,0,1550452
galEp3,0.5,1,1,ATCTTCTTACACCGGAGTTT,0,1567870
galEp3,0.5,1,1,ATCTTCGCTTTTAGGCCAGG,0,1587137
galEp3,0.5,1,1,ATCTGCGTCTAACTAAATGC,0,1591441
galEp3,0.5,1,1,ATCTGCCGATTTCATGGGAA,0,1590279
galEp3,0.5,1,1,ATCTAGAAATAATAAATTCG,0,1587864
galEp3,0.5,1,1,ATCTACTAGCATGGAAGTTT,0,1578557
galEp3,0.5,1,1,ATCTACAATGATGTGCAAAT,0,1547253
galEp3,0.5,1,1,ATCTAAGTGGGTTTAGGCTT,0,1564049
galEp3,0.5,1,1,ATCTAAGTCATCTCCAACGG,0,1589291
galEp3,0.5,1,1,ATCGGTGGGTGCATCAGGAC,0,1575023
galEp3,0.5,1,1,ATCGGGATGGCTGTTTATAC,0,1574945
galEp3,0.5,1,1,ATCGCTGCTTATGAGTCATG,0,1592795
galEp3,0.5,1,1,ATCGCGTCCAACAGTTGCAT,0,1579357
galEp3,0.5,1,1,ATCGATTTTAATTAACATAA,0,1557830
galEp3,0.5,1,1,ATCCTTTTGTGGCAATATGG,0,1549676
galEp3,0.5,1,1,ATCCTTGAGAAGGGTAGTGA,0,1568631
galEp3,0.5,1,1,ATCCATAAAGACGGATGCAA,0,1570239
galEp3,0.5,1,1,ATCCACTAGGTCCCTATCAA,0,1551703
galEp3,0.5,1,1,ATCCACAGGATAGGTGCGAC,0,1568944
galEp3,0.5,1,1,ATCATGTAGATTCGCCGCCC,0,1594519
galEp3,0.5,1,1,ATCAGGTTGAGTCTAATATT,0,1574665
galEp3,0.5,1,1,ATCACTGGTATCCTAGGCGC,0,1562404
galEp3,0.5,1,1,ATCACTGATCACTTCGCAAA,0,1581883
galEp3,0.5,1,1,ATCACCAGACTTTTCTGCTT,0,1558584
galEp3,0.5,1,1,ATCAATACAAATATTGGGAA,0,1590514
galEp3,0.5,1,1,ATCAAGAGGAAATCAGATTA,0,1554462
galEp3,0.5,1,1,ATATTTAACAAGATTGTACA,0,1549980
galEp3,0.5,1,1,ATATTAGAGATGTCTGGATG,0,1592514
galEp3,0.5,1,1,ATATCTCTAGATTCGAGGCT,0,1575649
galEp3,0.5,1,1,ATATATTGTAATGTGTGGCT,0,1593406
galEp3,0.5,1,1,ATATAGGAACGTAAAACAGA,0,1569175
galEp3,0.5,1,1,ATATAGAGTCTGATCATGCT,0,1550072
galEp3,0.5,1,1,ATAGTTAATTTCGACCGTCT,0,1553198
galEp3,0.5,1,1,ATAGTCACAGGTTCTTCTAT,0,1549244
galEp3,0.5,1,1,ATAGGCTGTCTGCCCTGCAG,0,1569258
galEp3,0.5,1,1,ATAGGCAGGCCCGTGTAGCT,0,1576954
galEp3,0.5,1,1,ATAGCACAAGCGAGAGGACC,0,1590683
galEp3,0.5,1,1,ATAGAGGGCTAACATGTGGG,0,1569598
galEp3,0.5,1,1,ATAGAAATAACAATCAACGG,0,1594359
galEp3,0.5,1,1,ATACGAGTTGCCAAACTTTT,0,1576169
galEp3,0.5,1,1,ATACAGAGCCTAAGATTAGG,0,1547072
galEp3,0.5,1,1,ATACACGTTTTTGTCACCGT,0,1548771
galEp3,0.5,1,1,ATACAATATTATTACGTACC,0,1594734
galEp3,0.5,1,1,ATAATGACAACCATACTAAA,0,1554909
galEp3,0.5,1,1,ATAATCCACGTCTCCAGGTG,0,1562412
galEp3,0.5,1,1,ATAATACCGGAGTCTTCTCG,0,1569157
galEp3,0.5,1,1,ATAAGTTCACCGCTTAAGAG,0,1568012
galEp3,0.5,1,1,ATAAGTACCCTTTAGTACAG,0,1576830
galEp3,0.5,1,1,ATAAGAAACCAGACAGCCTC,0,1578162
galEp3,0.5,1,1,ATAACCTGGGGACCTACCCC,0,1549412
galEp3,0.5,1,1,ATAACATCAACAGCCCTACT,0,1589013
galEp3,0.5,1,1,ATAAAGTAAAGATTTTCCCT,0,1592958
galEp3,0.5,1,1,ATAAACGCTCGTCCGCACTA,0,1554098
galEp3,0.5,1,1,AGTTTGTGCGGTTGAAGTAG,0,1555752
galEp3,0.5,1,1,AGTTTGGTCGAGTATGCCAC,0,1594954
galEp3,0.5,1,1,AGTTTGCGTAATTAACAGCG,0,1594360
galEp3,0.5,1,1,AGTTGGTTTAATGCACGTTA,0,1555473
galEp3,0.5,1,1,AGTTCCAAACACCGCGTCCC,0,1557899
galEp3,0.5,1,1,AGTTAGATCTTGAAGCCTAT,0,1593195
galEp3,0.5,1,1,AGTGTGCAATAGGCGTGCAA,0,1586410
galEp3,0.5,1,1,AGTGGGAAGAGTGGTGGACA,0,1546679
galEp3,0.5,1,1,AGTGGAGGTAACGAATGCCC,0,1563683
galEp3,0.5,1,1,AGTGGACAAAGTCCTAGGAA,0,1573936
galEp3,0.5,1,1,AGTGCGCCTTACGGGAGACT,0,1555140
galEp3,0.5,1,1,AGTGAGCTGCTACCAAGTAT,0,1590035
galEp3,0.5,1,1,AGTGAAGTAGTGCATGTGAC,0,1565642
galEp3,0.5,1,1,AGTCGTTTGCCGACATCCCA,0,1578937
galEp3,0.5,1,1,AGTCGTGTGACTAATACTGT,0,1557631
galEp3,0.5,1,1,AGTCGGAGAGGCTTGCGTAG,0,1571112
galEp3,0.5,1,1,AGTCGCAGGGACGCAAATGA,0,1546900
galEp3,0.5,1,1,AGTCCGTTCCCTCGCCTCAT,0,1554325
galEp3,0.5,1,1,AGTCCGCACCTGAATCTGGA,0,1586547
galEp3,0.5,1,1,AGTCAACATGCCGATCATGA,0,1568744
galEp3,0.5,1,1,AGTCAAACCACGGAGTGTGG,0,1583805
galEp3,0.5,1,1,AGTATTTCTCATTATTTAAA,0,1551398
galEp3,0.5,1,1,AGTAGTACTGGTAGGGAAAA,0,1580798
galEp3,0.5,1,1,AGTAGGCGACGCCCCTAGTC,0,1570213
galEp3,0.5,1,1,AGTAGCCGGATGCAAGGGGG,0,1552918
galEp3,0.5,1,1,AGTACTGGAGCTCGGAAGAT,0,1585028
galEp3,0.5,1,1,AGTACGCGCGTGAGGTGCTG,0,1588386
galEp3,0.5,1,1,AGTACCACACAGACAGCAAT,0,1580520
galEp3,0.5,1,1,AGTAATCACACAGCGAGGGC,0,1587948
galEp3,0.5,1,1,AGTAACGTGAAGCCATCCAT,0,1556824
galEp3,0.5,1,1,AGTAACCGATTCATTAAGAG,0,1593110
galEp3,0.5,1,1,AGGTTGCCGCAAGCTATTGT,0,1546612
galEp3,0.5,1,1,AGGTGCTATTGCGCCGTTGC,0,1568173
galEp3,0.5,1,1,AGGTCGCTTTTATGGTTTGC,0,1563268
galEp3,0.5,1,1,AGGTCCATGTTTGAGCGCTG,0,1569342
galEp3,0.5,1,1,AGGTCACTCTAGTCTGGCTC,0,1569934
galEp3,0.5,1,1,AGGTCAAGGAGGAAACAGTT,0,1582281
galEp3,0.5,1,1,AGGTAGTGTTTCACTTGGAC,0,1592221
galEp3,0.5,1,1,AGGTACCGACTAACAAGAGA,0,1565476
galEp3,0.5,1,1,AGGGTGGGCTTACCCCTGTC,0,1569283
galEp3,0.5,1,1,AGGGTACTATGGGATTTCGT,0,1564019
galEp3,0.5,1,1,AGGGCAGATACGCGAACCAT,0,1559685
galEp3,0.5,1,1,AGGGATTCCCCGGGACGTGA,0,1582467
galEp3,0.5,1,1,AGGGATAGCTTGGGTCAGAG,0,1558989
galEp3,0.5,1,1,AGGGAGTTACACTTAAAGAA,0,1554376
galEp3,0.5,1,1,AGGGAGTACTTGGAGCAGGT,0,1557440
galEp3,0.5,1,1,AGGCTCGCTCGGAAGCTTAG,0,1577368
galEp3,0.5,1,1,AGGCTCGCAGTTTAAGAAAC,0,1579535
galEp3,0.5,1,1,AGGCTATAATTCGGTACCTT,0,1557455
galEp3,0.5,1,1,AGGCGTCTGTTGGTTCATTA,0,1576781
galEp3,0.5,1,1,AGGCCGGGAGGGTGGCGCCT,0,1564797
galEp3,0.5,1,1,AGGCCGCAGCAGGGGGTTGT,0,1565943
galEp3,0.5,1,1,AGGCCATCAATGGAGATTGC,0,1565163
galEp3,0.5,1,1,AGGCAGCAGCCTTAAAGAAA,0,1593001
galEp3,0.5,1,1,AGGCACCTTCTTGATAGTTT,0,1566587
galEp3,0.5,1,1,AGGCAAGCAGCCTCCCCTTC,0,1561433
galEp3,0.5,1,1,AGGACTATCGGTGCATTGTG,0,1592100
galEp3,0.5,1,1,AGGACGCGGCCCTATTCATT,0,1592006
galEp3,0.5,1,1,AGGAAGGTAGTCCAGGAATC,0,1573231
galEp3,0.5,1,1,AGGAAAGAACAACTCTGTAA,0,1567955
galEp3,0.5,1,1,AGGAAAACTTGTCGCCCAAG,0,1589197
galEp3,0.5,1,1,AGCTTTGTCGCTGCCTGTTA,0,1554545
galEp3,0.5,1,1,AGCTGCTTGCGCCATCATTC,0,1578116
galEp3,0.5,1,1,AGCTACTGTTAAGCATGGAA,0,1585685
galEp3,0.5,1,1,AGCTACGCACGCTTAAGCGG,0,1592461
galEp3,0.5,1,1,AGCTACACTCATACTTGTCG,0,1576214
galEp3,0.5,1,1,AGCTACACATCGTGTGTTTC,0,1570432
galEp3,0.5,1,1,AGCGTAGATGCCCTCGATGT,0,1562943
galEp3,0.5,1,1,AGCGGCGGTTCCCATACGCG,0,1555614
galEp3,0.5,1,1,AGCGCGGGAAATTTTAAAGA,0,1569124
galEp3,0.5,1,1,AGCGCCTGAGCACAGTTGGC,0,1577185
galEp3,0.5,1,1,AGCCTTGCGCAAAACATCAG,0,1555070
galEp3,0.5,1,1,AGCCGTAGGCACATGCCGTA,0,1566129
galEp3,0.5,1,1,AGCCGACTTGTACTTACATG,0,1553671
galEp3,0.5,1,1,AGCCCCGTGCTCCTTGCGCT,0,1565951
galEp3,0.5,1,1,AGCCCAAGTAGGGGCAACCC,0,1561160
galEp3,0.5,1,1,AGCCATAATGTAGGTCGGGC,0,1567751
galEp3,0.5,1,1,AGCCAACATCCCTAGATTCC,0,1585509
galEp3,0.5,1,1,AGCAGTGTTGACAGGATAAA,0,1552767
galEp3,0.5,1,1,AGCAGCGTGTTGGATGTAAG,0,1573087
galEp3,0.5,1,1,AGCAGAGATAGCATGGAGGC,0,1592535
galEp3,0.5,1,1,AGCACTTGAAGCCTAGCTTA,0,1578888
galEp3,0.5,1,1,AGCAAGGTTTACGGGGCGAG,0,1575246
galEp3,0.5,1,1,AGCAAATGTAGACCCATAAG,0,1581308
galEp3,0.5,1,1,AGCAAAAAAACGGGGAGAAC,0,1594923
galEp3,0.5,1,1,AGATTACGGAGATCGTGTGT,0,1589747
galEp3,0.5,1,1,AGATGCTCAGCTAGTTGCAA,0,1586857
galEp3,0.5,1,1,AGATGAGAGATAACAGTTTG,0,1580859
galEp3,0.5,1,1,AGATGACGGATAGTACTGGG,0,1570347
galEp3,0.5,1,1,AGATGACCAGGCTAAAAAGC,0,1550396
galEp3,0.5,1,1,AGATCAACCATAAAGGACGT,0,1555701
galEp3,0.5,1,1,AGATATTGGGCTCGTCTCCT,0,1584418
galEp3,0.5,1,1,AGATACACCCCGCGGTCCTA,0,1571201
galEp3,0.5,1,1,AGAGTGTTTGTTACAAGCTC,0,1590720
galEp3,0.5,1,1,AGAGTGTATTTGCTTTCTAG,0,1564360
galEp3,0.5,1,1,AGAGTAGGGTAAGTTGGGGT,0,1584358
galEp3,0.5,1,1,AGAGGTGCGTTCTTTCTTCA,0,1549284
galEp3,0.5,1,1,AGAGCGTGGCCACCCAGGGT,0,1580270
galEp3,0.5,1,1,AGAGCGCGAATATTCCCATA,0,1560528
galEp3,0.5,1,1,AGAGAGCCGGTAAGTCTTTT,0,1554237
galEp3,0.5,1,1,AGACTTCGCCCCCTAGCATG,0,1565058
galEp3,0.5,1,1,AGACTAGAGACGCGTCTCCT,0,1565772
galEp3,0.5,1,1,AGACTACAGGATGTAGTGCT,0,1580902
galEp3,0.5,1,1,AGACGTGGTCCGTCAAGTTT,0,1548474
galEp3,0.5,1,1,AGACGAATTGGGTTTGAAAC,0,1557579
galEp3,0.5,1,1,AGACCGTTGTAATTCCCCAA,0,1573600
galEp3,0.5,1,1,AGACAGTCGGAATAAGCCTT,0,1577814
galEp3,0.5,1,1,AGACAAGGGCCAAATTGCAA,0,1580523
galEp3,0.5,1,1,AGAATCGTTATCACAATGAG,0,1552023
galEp3,0.5,1,1,AGAATCAGGAGCCCTTCCTC,0,1581793
galEp3,0.5,1,1,AGAATCAGATGGTAGCTTCT,0,1594348
galEp3,0.5,1,1,AGAAGATACCGATGGACATG,0,1579930
galEp3,0.5,1,1,AGAACTCTAGTTTGATCGTG,0,1561401
galEp3,0.5,1,1,AGAACCGCCTCTTAGGTCCC,0,1565988
galEp3,0.5,1,1,AGAACCCAACTAGCCAACCA,0,1563159
galEp3,0.5,1,1,ACTTGTTAGCTTCGCCGGTC,0,1586572
galEp3,0.5,1,1,ACTTGTATCAGTAATATTCT,0,1587648
galEp3,0.5,1,1,ACTTGGGTTCATTGTGCTGG,0,1574539
galEp3,0.5,1,1,ACTTCACCGCTTGTAGAGCA,0,1580745
galEp3,0.5,1,1,ACTTAGGCCTCGAACCGTAC,0,1581284
galEp3,0.5,1,1,ACTTAGGAGGTCATCGAGGA,0,1573071
galEp3,0.5,1,1,ACTCGGTTGAGCCAGGCGTA,0,1569711
galEp3,0.5,1,1,ACTCGGGAGGCCATCTTAGA,0,1561322
galEp3,0.5,1,1,ACTCAACTTGGAGTGTAAAT,0,1592901
galEp3,0.5,1,1,ACTATGTGGAACTAACGCGA,0,1559370
galEp3,0.5,1,1,ACTATGCAGGACTGTGACAG,0,1560169
galEp3,0.5,1,1,ACTAGGCGGGCATGCGCCGG,0,1559867
galEp3,0.5,1,1,ACTAGGCCCGACCAATAGCC,0,1574097
galEp3,0.5,1,1,ACTAAGCTAGGATATGCCTG,0,1589164
galEp3,0.5,1,1,ACGTTGGGTGCTGAGCACTA,0,1592949
galEp3,0.5,1,1,ACGTTACACATCCATAAGAC,0,1547974
galEp3,0.5,1,1,ACGTTAACGAGGGGGTCAAC,0,1571241
galEp3,0.5,1,1,ACGTTAACCGTAAGATCCTG,0,1563662
galEp3,0.5,1,1,ACGTGGCGCCCTCGCTTGTC,0,1564894
galEp3,0.5,1,1,ACGTGGAGCGTGGTTGATGT,0,1568386
galEp3,0.5,1,1,ACGTGCTATCCCTGGTGTTA,0,1554037
galEp3,0.5,1,1,ACGTCCTGCCTTCCGAAGTT,0,1553310
galEp3,0.5,1,1,ACGTAATCGGTTTTGGAAAG,0,1581497
galEp3,0.5,1,1,ACGGTTCCACATTCCCGGGT,0,1565436
galEp3,0.5,1,1,ACGGTGTATACAGACCCCCG,0,1593101
galEp3,0.5,1,1,ACGGTCCATTAGGAATTCTA,0,1570185
galEp3,0.5,1,1,ACGGTCAATCAGGGTGTTCG,0,1553873
galEp3,0.5,1,1,ACGGATGTCCATCAGATGGG,0,1587559
galEp3,0.5,1,1,ACGGATGATAGTTGAAGATG,0,1594449
galEp3,0.5,1,1,ACGGAGAGTCGTTTAGTTGC,0,1573098
galEp3,0.5,1,1,ACGCGTTAAGCTCCTACATA,0,1572384
galEp3,0.5,1,1,ACGCGGTTCTGGAGGCTACT,0,1547056
galEp3,0.5,1,1,ACGCGGGGTCGAAATAGGCC,0,1556375
galEp3,0.5,1,1,ACGCGGCTATGCCAGCATTT,0,1565711
galEp3,0.5,1,1,ACGCGATGCCTCAAGCATAG,0,1560227
galEp3,0.5,1,1,ACGCGACCTTGTTTGTCGTT,0,1582750
galEp3,0.5,1,1,ACGCCTGTCACCAATCGATG,0,1564857
galEp3,0.5,1,1,ACGCAGCCACTCCAAAGCCG,0,1577821
galEp3,0.5,1,1,ACGCAACGGGGGACACACTA,0,1589065
galEp3,0.5,1,1,ACGATCCGCGGATAAGGTGG,0,1549621
galEp3,0.5,1,1,ACGATACGTTGCCGGCACAG,0,1579974
galEp3,0.5,1,1,ACGAGCGGATAGAGTGGTTG,0,1575222
galEp3,0.5,1,1,ACGAGAATCGGCTTAGTAGT,0,1548618
galEp3,0.5,1,1,ACGACGGCGTTACAGTTACA,0,1585550
galEp3,0.5,1,1,ACGACCGCGTACAACTTGTT,0,1565059
galEp3,0.5,1,1,ACGAAGGCCTCCGTTTTCGA,0,1546571
galEp3,0.5,1,1,ACGAAAGACCAAATCAGAGG,0,1566329
galEp3,0.5,1,1,ACCTGTGACCCGTGTTCTTG,0,1566950
galEp3,0.5,1,1,ACCTGATGGCAAGATCTTAA,0,1568701
galEp3,0.5,1,1,ACCTCGACTGGTTGAAAGGA,0,1568235
galEp3,0.5,1,1,ACCTAGGCACGTGATCCGAG,0,1568975
galEp3,0.5,1,1,ACCGTTAGTCGTGGCGATAG,0,1547042
galEp3,0.5,1,1,ACCGTCCGGAGCGCGAAGCC,0,1582770
galEp3,0.5,1,1,ACCGGTGGATCCATTCGGTA,0,1594847
galEp3,0.5,1,1,ACCGGTATCTACCGCTAAAC,0,1569422
galEp3,0.5,1,1,ACCGGAATTAGTGTCTCTCA,0,1561111
galEp3,0.5,1,1,ACCGCGATGGCGGCACCCAC,0,1562140
galEp3,0.5,1,1,ACCGCCAGCAACTGCGGGAT,0,1594488
galEp3,0.5,1,1,ACCGAGGGGCCACGGAAGCG,0,1594842
galEp3,0.5,1,1,ACCGACGCGTGTTTACTTGC,0,1553552
galEp3,0.5,1,1,ACCGACAGATACTGTTATCT,0,1580087
galEp3,0.5,1,1,ACCCTCAGCTTGACACCATT,0,1559523
galEp3,0.5,1,1,ACCCTAAGTCTTGCACAGTC,0,1566882
galEp3,0.5,1,1,ACCCGTCCGGGTGTCTCAGA,0,1593441
galEp3,0.5,1,1,ACCCGGTAAACTGCGGAGTA,0,1558900
galEp3,0.5,1,1,ACCCATCAATCATTCTCGTT,0,1583517
galEp3,0.5,1,1,ACCCATAGTTGTGAAACGTA,0,1561118
galEp3,0.5,1,1,ACCATCGTGTCTTAAATAGA,0,1563428
galEp3,0.5,1,1,ACCATATGCACGGTTCCTTT,0,1583228
galEp3,0.5,1,1,ACCACTGGGTTTTGTTCACC,0,1549998
galEp3,0.5,1,1,ACCACGGCTTGACACAGGTG,0,1565489
galEp3,0.5,1,1,ACCACACGATGTGAAGATCG,0,1546979
galEp3,0.5,1,1,ACCAAAGGCGCGTGGATCCG,0,1554065
galEp3,0.5,1,1,ACATTGGCGCACCAGATAGT,0,1585666
galEp3,0.5,1,1,ACATTGCTTCTGTGGATGCT,0,1577808
galEp3,0.5,1,1,ACATTCTTTTCGAGTTTGTG,0,1571600
galEp3,0.5,1,1,ACATTCTCACCGCTAAGGAC,0,1581857
galEp3,0.5,1,1,ACATTACGAGTATTACGAGT,0,1582631
galEp3,0.5,1,1,ACATGGTATTGTGAACACGA,0,1591474
galEp3,0.5,1,1,ACATGGTATAGGAACCTGCA,0,1588844
galEp3,0.5,1,1,ACATGGGCTGCCCCACGTGT,0,1581341
galEp3,0.5,1,1,ACATCCTGGAGAGTCTAGTG,0,1548833
galEp3,0.5,1,1,ACATCCCACGGGACCTCAGG,0,1575003
galEp3,0.5,1,1,ACATAGCCCCACAGGATCTA,0,1587766
galEp3,0.5,1,1,ACAGTGGCGAGCTGGTAGCG,0,1583011
galEp3,0.5,1,1,ACAGTGCTACCGGAGGATCA,0,1571284
galEp3,0.5,1,1,ACAGGTGATCTGCTCGGCTC,0,1581382
galEp3,0.5,1,1,ACAGGCTTGATGGACGTCTG,0,1564174
galEp3,0.5,1,1,ACAGCCTACGCATAATCAGG,0,1575683
galEp3,0.5,1,1,ACAGCCCCTCTCGAAAGGGA,0,1590610
galEp3,0.5,1,1,ACAGATATAGGGAAGACTAG,0,1557422
galEp3,0.5,1,1,ACAGAGTTTACACTCAAGTT,0,1553119
galEp3,0.5,1,1,ACAGAGTGGCCGCGACGTTT,0,1588849
galEp3,0.5,1,1,ACAGAAACCAGAGGGGTCTT,0,1558914
galEp3,0.5,1,1,ACACGATTCCGCTACCAAGC,0,1581679
galEp3,0.5,1,1,ACACCGTCTGATATATTCGG,0,1569004
galEp3,0.5,1,1,ACACCATCAGGAGATCAAGA,0,1585082
galEp3,0.5,1,1,ACACACCTGCGATCTGATAA,0,1581090
galEp3,0.5,1,1,ACAAGAGTAATTCAACCAGA,0,1595170
galEp3,0.5,1,1,ACAACCTGGTGCCTGACGTT,0,1564111
galEp3,0.5,1,1,ACAACCGTGATCTTCGTTTG,0,1558701
galEp3,0.5,1,1,ACAACCCGATGTGTAACATA,0,1553981
galEp3,0.5,1,1,ACAACAAAAGTCTCAGTACA,0,1592314
galEp3,0.5,1,1,ACAAATGGAAAATGTTCTAG,0,1593566
galEp3,0.5,1,1,ACAAAATTTTTTGGGCAGGG,0,1575010
galEp3,0.5,1,1,AATTTACGGCGCACTGTCCA,0,1566508
galEp3,0.5,1,1,AATTGAAGCATCCTACACTG,0,1592456
galEp3,0.5,1,1,AATTCGTTTTGGAAGGGGTC,0,1574354
galEp3,0.5,1,1,AATTCGGTACTTCCAAGGCA,0,1566488
galEp3,0.5,1,1,AATTCGAGTGTGTTTACAAC,0,1584516
galEp3,0.5,1,1,AATTCGAACGCACCTGTCAG,0,1570580
galEp3,0.5,1,1,AATTCCAGGCGCGGCGAGGG,0,1586654
galEp3,0.5,1,1,AATTAATGCGGGCGTAACAT,0,1591023
galEp3,0.5,1,1,AATGGCTCACACGCGCAAGG,0,1568359
galEp3,0.5,1,1,AATGCGTGGTCGCTGCGATC,0,1552069
galEp3,0.5,1,1,AATGCGGACCTCGATTCCAG,0,1547560
galEp3,0.5,1,1,AATGCAGGAATGCAGGCCCA,0,1556615
galEp3,0.5,1,1,AATGCAGATTAGCTTTCTAC,0,1547048
galEp3,0.5,1,1,AATGATGGATGACCTGTTAC,0,1568709
galEp3,0.5,1,1,AATGAGGCGGGGTAGGTCCT,0,1557979
galEp3,0.5,1,1,AATGAGCTGGCCGGGTCGTG,0,1594516
galEp3,0.5,1,1,AATCTGTGATATCTAGAGAT,0,1555273
galEp3,0.5,1,1,AATCTGTACTCTTACTGAAC,0,1551659
galEp3,0.5,1,1,AATCGTGTCACCAGCTACTT,0,1568291
galEp3,0.5,1,1,AATCCTTATTTCCGGGATAA,0,1565418
galEp3,0.5,1,1,AATCCTCTATATGTTAGTCA,0,1561133
galEp3,0.5,1,1,AATCCTCACCTAACGGGCCG,0,1564100
galEp3,0.5,1,1,AATCATTAACGGCTGGTTAC,0,1577727
galEp3,0.5,1,1,AATCATCGTAATTCAGCGCC,0,1553696
galEp3,0.5,1,1,AATATGTCACGGCGGCAGCT,0,1550498
galEp3,0.5,1,1,AATATGGTTTGAGTGCAACC,0,1550101
galEp3,0.5,1,1,AATATGGCCCGGGAAACGAG,0,1558908
galEp3,0.5,1,1,AATATCTTCAACACACAGCT,0,1547116
galEp3,0.5,1,1,AATACTGCGGTAAGGCGACC,0,1591013
galEp3,0.5,1,1,AATACGACAGACGCCTAAGT,0,1558424
galEp3,0.5,1,1,AATAATTCGTAATACCGGTT,0,1574297
galEp3,0.5,1,1,AAGTGTTTAGTCCCTACTAG,0,1547322
galEp3,0.5,1,1,AAGTGTATAGAGGCTACCTC,0,1562425
galEp3,0.5,1,1,AAGTCTCCCGCCCCAGGCAT,0,1567961
galEp3,0.5,1,1,AAGTCCACTCCATGATATGA,0,1578858
galEp3,0.5,1,1,AAGTCACTAAACAAACACGC,0,1551180
galEp3,0.5,1,1,AAGTCAAACCGGCGAGTGTA,0,1568219
galEp3,0.5,1,1,AAGTACAAATTCAAATTTCT,0,1585086
galEp3,0.5,1,1,AAGTAATCACTCCCGCAATG,0,1553735
galEp3,0.5,1,1,AAGGGGTGAGTTGGGTAGAC,0,1566312
galEp3,0.5,1,1,AAGGCGCGTATCCCCGAGTG,0,1588731
galEp3,0.5,1,1,AAGGCCTTCCGCTTGGCATG,0,1578137
galEp3,0.5,1,1,AAGGAGGGGACCATTCCCAT,0,1581560
galEp3,0.5,1,1,AAGGACGGTGTCCCCACAAG,0,1588186
galEp3,0.5,1,1,AAGCTTATGGCGATATTGGG,0,1552427
galEp3,0.5,1,1,AAGCTTAGATCGAGTCTTGA,0,1553767
galEp3,0.5,1,1,AAGCTTAATCCAGAGTAGAC,0,1575515
galEp3,0.5,1,1,AAGCGCTTGTAGGCCAGGGT,0,1548963
galEp3,0.5,1,1,AAGCCCCAGAGTGCGACCGA,0,1550709
galEp3,0.5,1,1,AAGAGTTCTTGGGCGGTATT,0,1548141
galEp3,0.5,1,1,AAGAGCACATAGCTACTTAT,0,1589090
galEp3,0.5,1,1,AAGACGAGCATTAACCATTT,0,1573656
galEp3,0.5,1,1,AAGAACGGTCCTGCTTGACA,0,1574151
galEp3,0.5,1,1,AACTTGGGACCGAGTTTGAA,0,1571688
galEp3,0.5,1,1,AACTTGCGAAAGCGCGCGCA,0,1554429
galEp3,0.5,1,1,AACTTATAGTGCCAGATGGC,0,1579008
galEp3,0.5,1,1,AACTTACTCTACGGCAAAGA,0,1551380
galEp3,0.5,1,1,AACTGTCAATTGAGGGGGAA,0,1548623
galEp3,0.5,1,1,AACTGTATCTCACATCCGAA,0,1555934
galEp3,0.5,1,1,AACTCAGGATCGGTCGGTCG,0,1565603
galEp3,0.5,1,1,AACTAGGGGTCACAGGCAAA,0,1581655
galEp3,0.5,1,1,AACTACCCAGAGCGTGTACT,0,1574024
galEp3,0.5,1,1,AACTAAGTTACTACTTAGAA,0,1591354
galEp3,0.5,1,1,AACGGTTGACAGACAAACCA,0,1556029
galEp3,0.5,1,1,AACGGTGAGAGAGAAGTTAA,0,1562338
galEp3,0.5,1,1,AACGGTCGGGCTCGTTGAAG,0,1583994
galEp3,0.5,1,1,AACGGTACTGTGGAATTCCG,0,1584646
galEp3,0.5,1,1,AACGGGTCCGCTTCTACGAC,0,1581928
galEp3,0.5,1,1,AACGGGCGGATTGCTCAACG,0,1565422
galEp3,0.5,1,1,AACGATGGTTCGTTCAGGTA,0,1578651
galEp3,0.5,1,1,AACCTGTACATACTCCGGAA,0,1550096
galEp3,0.5,1,1,AACCTGACAATTCAATTCTA,0,1576836
galEp3,0.5,1,1,AACCTCATTAGGCCAGATGA,0,1557834
galEp3,0.5,1,1,AACCGTGATTCCCTTATAAT,0,1584831
galEp3,0.5,1,1,AACCGGTGACGCTAGCTCGT,0,1581141
galEp3,0.5,1,1,AACCGGCACGCACTTTGGGA,0,1572696
galEp3,0.5,1,1,AACCGAGTCGGTTGACAGGG,0,1584708
galEp3,0.5,1,1,AACCGAGAGAATCCAACCGC,0,1570945
galEp3,0.5,1,1,AACCCTGGTGCGGACGCATA,0,1554620
galEp3,0.5,1,1,AACCCGCTGTGAGCTTGCCG,0,1565149
galEp3,0.5,1,1,AACCCATATGGTTAACACCG,0,1581120
galEp3,0.5,1,1,AACCCAAACGATATTAGGAA,0,1582540
galEp3,0.5,1,1,AACCATGGCGCACGCTCCCG,0,1582477
galEp3,0.5,1,1,AACCAAGAGTGTCTCGGTAG,0,1591151
galEp3,0.5,1,1,AACATCACATTCGACTTGTT,0,1551839
galEp3,0.5,1,1,AACATAGGGGAAATCGGCCT,0,1546694
galEp3,0.5,1,1,AACAGGGGGGATACTAGCTC,0,1581009
galEp3,0.5,1,1,AACAGACCGTCATAGATTCC,0,1588931
galEp3,0.5,1,1,AACACACTAATCAAGAAGGG,0,1566977
galEp3,0.5,1,1,AACAATCATATCCGTGCTAA,0,1585990
galEp3,0.5,1,1,AACAACAGTCCATCAGCGTA,0,1593052
galEp3,0.5,1,1,AAATTTAACGTTTAAGGCTA,0,1560449
galEp3,0.5,1,1,AAATTGGCCGGGCACATTGG,0,1574321
galEp3,0.5,1,1,AAATTGAACGGGGACCCAAT,0,1569595
galEp3,0.5,1,1,AAATGGGCCACAACTCGCCT,0,1585674
galEp3,0.5,1,1,AAATGCAGGGCCAGAACTTT,0,1580168
galEp3,0.5,1,1,AAATGACTCCAGCTGGGAGC,0,1565583
galEp3,0.5,1,1,AAATGAATTTGGGGTGGAAT,0,1594147
galEp3,0.5,1,1,AAATAATTGAAGCAAGTTCC,0,1555815
galEp3,0.5,1,1,AAAGTCCCACGGAAAGTGGC,0,1579527
galEp3,0.5,1,1,AAAGTATCACAGGTCATTGA,0,1552822
galEp3,0.5,1,1,AAAGTACGGAGAGATTGCGG,0,1561113
galEp3,0.5,1,1,AAAGGTTCTCCAAATTGTCA,0,1557054
galEp3,0.5,1,1,AAAGCCGGGGTAAACCAGAT,0,1559135
galEp3,0.5,1,1,AAAGATCTGCTATGTGTTCA,0,1558341
galEp3,0.5,1,1,AAAGACGAACCCCAGAACAT,0,1585510
galEp3,0.5,1,1,AAACTGGCAGAGGGTTAAAT,0,1590557
galEp3,0.5,1,1,AAACGTCTTTCAGGGAAATT,0,1587557
galEp3,0.5,1,1,AAACGAAGGTGGCCAGAGAT,0,1559143
galEp3,0.5,1,1,AAACCTCAGCGAACTGCGAA,0,1573801
galEp3,0.5,1,1,AAACCCGCTTCGCTCATGTT,0,1595187
galEp3,0.5,1,1,AAACATGGGCTGTTAGAAGG,0,1548088
galEp3,0.5,1,1,AAACAGGCGATAGCGACCTC,0,1588706
galEp3,0.5,1,1,AAACAGCGAGTATATCTAGG,0,1563141
galEp3,0.5,1,1,AAACACGCAGGTGGTTAGTG,0,1547128
galEp3,0.5,1,1,AAAAGATCTGAACAAGAAGG,0,1560363
galEp3,0.5,1,1,AAAACTTCGACGCATTTGTG,0,1565208
galEp3,0.5,1,1,AAAACTAATGTGGAGAGGGT,0,1560685
galEp3,0.5,1,1,AAAACGATCGCATTCTCGAG,0,1552424
galEp3,0.5,1,1,AAAACCTGTTGAGCACTTCC,0,1571700
galEp3,0.5,1,1,AAAAACCGTAAGGTGTGTGC,0,1576327
galEp3,0.5,1,1,AAAAACAGCTACGCGGTAAG,0,1583451
galEp3,136.0,135,0,CAGAGGACAGAGGTCAAATC,135,1569419
galEp3,125.0,124,0,GAATTCTTACACCCTCGGGG,124,1583424
galEp3,123.0,122,0,GCACCTTACACCGTCACGTC,122,1571996
galEp3,110.0,109,0,GTTTAGTAGAGGGACGTAAT,109,1559453
galEp3,110.0,109,0,AACCATTGTACCAGGGGTGG,109,1582814
galEp3,102.0,101,0,CTACAGAGGCTCCGGACTAC,101,1569324
galEp3,102.0,101,0,ATATTACCCGCAAGTTTCCT,101,1594136
galEp3,94.0,93,0,TTCGTAGTATGCTTTAACAG,93,1563291
galEp3,94.0,93,0,CAGGGAACCGGACGTCGCGT,93,1547428
galEp3,92.0,91,0,AGTCTCCCTGTTTCGGTAGC,91,1589397
galEp3,90.0,89,0,GAGAAGCCTGTCTAGGTTGC,89,1564558
galEp3,85.0,84,0,TTGTACGAACCGGCCTCAAC,84,1555018
galEp3,80.0,79,0,TTAGGCCTACGACGCTCGGG,79,1575912
galEp3,78.0,77,0,TACTCTGGCCGTGCATGGTG,77,1550173
galEp3,74.0,73,0,AAATCACGGGGGATTCGTTC,73,1572656
galEp3,73.0,72,0,TGCCTCGCGATCTAAAGACT,72,1578599
galEp3,71.0,70,0,TGGTGGTTTACGTAGCCCAA,70,1594157
galEp3,71.0,70,0,TCCTGAGGGGACAGACTAAG,70,1554670
galEp3,70.0,69,0,TTCCAGAAGTCAAAAATGGG,69,1586407
galEp3,68.0,67,0,TCCCGAAATTGACCACAGTA,67,1576804
galEp3,67.0,66,0,AGGCACGGCCGTCCTCACAC,66,1593616
galEp3,64.0,63,0,ATTTCGCAATCCCGATTCTC,63,1582914
galEp3,58.0,57,0,GTCGTGAAGAATACATAAAC,57,1562495
galEp3,57.0,56,0,GGTCACTCCCCGATACGCAT,56,1570933
galEp3,57.0,56,0,CATTTCTTGGGGTTCCATTT,56,1579206
galEp3,54.0,53,0,CGAGTGAATCTCGTCTGTGA,53,1583017
galEp3,53.0,52,0,CTCGAAAAAATGACAACTTT,52,1593937
galEp3,51.0,50,0,AAAGTTGGAAAATAACTCCA,50,1586221
galEp3,50.0,49,0,TTGTCACCGGCTAACGCCCC,49,1558880
galEp3,49.0,48,0,AATGCTTTAACGCGCTCACC,48,1580684
galEp3,48.0,47,0,CCCAGATGGCGCTATTGTGG,47,1558248
galEp3,45.0,44,0,CAGCAGGCAGCGACAAAGGT,44,1575593
galEp3,39.0,38,0,GTCTTCAGTGAAAAGAAAAA,38,1593256
galEp3,36.0,35,0,GCTTGACAATAATAGCTATT,35,1569059
galEp3,32.0,31,0,TCCAAGGTTACCGTTTTGCT,31,1586612
galEp3,27.0,26,0,AGGTGTAGGCTCCTTAGTCC,26,1548196
galEp3,24.0,23,0,GTGACACTTTCTCGCTCTAA,23,1591751
galEp3,23.0,22,0,GTTTTAGGCCAACCTCGATT,22,1556880
galEp3,23.0,22,0,GTAGCCCTACCGACCCGTAT,22,1586516
galEp3,22.0,21,0,AGTTGTCGTGACCGAGTTGT,21,1552333
galEp3,20.0,19,0,ATTCTTTACGGCATTGATTA,19,1555860
galEp3,18.0,17,0,GCAGGGTTAGATACCACAGA,17,1565384
galEp3,13.0,12,0,TGGGATTCTCCGTTATCACA,12,1578149
galEp3,12.0,11,0,TAACAAGTTGGGTTATCTAG,11,1563784
galEp3,12.0,11,0,ACTGAGTCGTCTGCGTGTTC,11,1594309
galEp3,4.0,3,0,TGTAGAGAGTACGCAGGAAT,3,1579757
galEp3,4.0,3,0,CTGTCGCCTTGTGGCGAACC,3,1588368
galEp3,4.0,3,0,AGATAAGCCACCCCCACGAA,3,1581772
galEp3,4.0,3,0,AGACGGAGCAGGAAACCATG,3,1567364
galEp3,3.0,2,0,TTTGATGTTTACAAACGTAG,2,1548249
galEp3,3.0,2,0,CTCTTAGCCGCAGAGGGCTT,2,1554067
galEp3,2.0,1,0,TTTCAGGTCCTTGCATTCTA,1,1585429
galEp3,2.0,1,0,TTGTTTCATGTCGGCCCTCT,1,1577449
galEp3,2.0,1,0,TTGATAGGAGTTACCACGAA,1,1566066
galEp3,2.0,1,0,TGTAAAAATGTGAAATACTA,1,1585813
galEp3,2.0,1,0,TGGGGACCTTTGCTTCGTTT,1,1575103
galEp3,2.0,1,0,TGGACTCTAAGTTTCGGGCA,1,1593972
galEp3,2.0,1,0,TATGCAGCTGACCCCGCCAG,1,1594302
galEp3,2.0,1,0,TATAGGTCATCATTATCGTT,1,1562488
galEp3,2.0,1,0,GTTCCGGAGGGAGTCGGTAG,1,1573862
galEp3,2.0,1,0,GTTACATACCCCGTGATCGG,1,1569263
galEp3,2.0,1,0,GTAACGTAGTTGCTAGCCGC,1,1585141
galEp3,2.0,1,0,GGTCGTCGTATATAAACCAA,1,1556229
galEp3,2.0,1,0,GGGCAGTTGGTTTTCCGCCA,1,1552908
galEp3,2.0,1,0,GGCTTCCGTCAACAGATCTA,1,1582149
galEp3,2.0,1,0,GCTCAATTTAGCTAGGTAAT,1,1560070
galEp3,2.0,1,0,GCGTGCATACCCATCTAAAG,1,1590111
galEp3,2.0,1,0,GATGCTTTGAAAAACGGTCG,1,1565238
galEp3,2.0,1,0,GACTCGACTTCCTAGGGATA,1,1570362
galEp3,2.0,1,0,CTCACAGATTTAGCGTAGAT,1,1594821
galEp3,2.0,1,0,CGTGGACGTACGAGAGAGCT,1,1570215
galEp3,2.0,1,0,CGTATCTATCCATGTCGGAA,1,1587281
galEp3,2.0,1,0,CGGTTATTAACGTGAAACCG,1,1586587
galEp3,2.0,1,0,CGGGTCATTAGCTCTTAGAT,1,1565854
galEp3,2.0,1,0,CATTCAAGCGCTTCAATGTT,1,1574279
galEp3,2.0,1,0,CATTAATTGTGATTTATAAC,1,1590764
galEp3,2.0,1,0,CAGTGCCCTGCTCAAGCTAA,1,1558440
galEp3,2.0,1,0,ATCATGTACGCTCGAATCGC,1,1594470
galEp3,2.0,1,0,AGGCTAGTTTTTTACGGGGG,1,1580474
galEp3,2.0,1,0,AGACATATTCGCATGCAGTC,1,1572234
galEp3,2.0,1,0,AATGCGCCTTATAGTGGCCG,1,1571693
galEp3,2.0,1,0,AAACCATGCCCGACTACCCC,1,1550414
galEp3,2.0,1,0,AAAACAAAAAAGATGACGTC,1,1547245
