name,relative_counts,ct,ct_0,barcode,ct_1,barcode_ind
lacIp,0.5263157894736842,114,75,TAGCTTAGATCTTGTGTACA,39,2115497
lacIp,0.45161290322580644,43,30,TGGTCAAGGGACCTGTATTT,13,2096537
lacIp,0.9,17,9,GTAATTTGTCATGCAAATCG,8,2086907
lacIp,0.2,10,9,CTAGGCGCTATCCCCCCGTA,1,2095946
lacIp,0.4444444444444444,11,8,CGGCATTGAGCCTGTGGCCG,3,2090104
lacIp,0.3333333333333333,10,8,CGCAGGGCTCGTAACGAGTG,2,2087098
lacIp,0.5555555555555556,12,8,ATATCTCGTGGCCCCAAATG,4,2086230
lacIp,0.5555555555555556,12,8,AAGTACTCTAACCCGTGATA,4,2091866
lacIp,0.75,12,7,TTAAGGAGCGGTGCATCTAG,5,2101381
lacIp,1.375,17,7,TCCGTGGGCCGACCATAGCT,10,2119661
lacIp,0.25,8,7,GTATGACAAAGAGCATTAAT,1,2101003
lacIp,0.75,12,7,GGAGTACTGCTGCCTAACAG,5,2105614
lacIp,0.625,11,7,GCCTTAGGCTTCCTAGATCT,4,2086079
lacIp,0.625,11,7,CTAGACTTAGGCTAAACCAT,4,2113999
lacIp,0.42857142857142855,8,6,TGACCAAGGCCTCCGCGCCG,2,2108788
lacIp,0.2857142857142857,7,6,TACCGAAGTTTCGTTAGGGA,1,2088922
lacIp,0.42857142857142855,8,6,TAAATGATATACAACTCTGT,2,2102487
lacIp,0.7142857142857143,10,6,GTCATATCATAAGATACGGT,4,2091051
lacIp,0.2857142857142857,7,6,GAGGACCGCAATGTAATGCA,1,2100829
lacIp,0.2857142857142857,7,6,CGGGGGTGGCTGATACAACA,1,2088689
lacIp,0.42857142857142855,8,6,ATATTGCGTCTCGCACTTAT,2,2087189
lacIp,0.2857142857142857,7,6,AAACACAGCAGCGCCACGCA,1,2092491
lacIp,0.3333333333333333,6,5,TTTACCGGCCGTGAGAGGCT,1,2100058
lacIp,0.3333333333333333,6,5,TTCTCATCGACTCCAGAGCT,1,2095515
lacIp,0.3333333333333333,6,5,TTCATGGTTCGACGCAGGGA,1,2102294
lacIp,0.6666666666666666,8,5,TGAGCCAGCGTGACTGCGTT,3,2097046
lacIp,0.8333333333333334,9,5,TCCGTGTGTCAAGTCTTACT,4,2092490
lacIp,0.3333333333333333,6,5,TCATATTGCGCTGTAGCCGT,1,2095238
lacIp,1.1666666666666667,11,5,TAAGGGCGGTACAAGGGAAG,6,2097091
lacIp,0.3333333333333333,6,5,GTCATTGCGGTATATCCCTA,1,2086255
lacIp,0.3333333333333333,6,5,GTCATACCCTACCTGCCAGC,1,2114659
lacIp,0.3333333333333333,6,5,GGGCGTTGGCATGTTACTAT,1,2097696
lacIp,0.3333333333333333,6,5,GGCGACGGACGCGATACTGT,1,2088892
lacIp,0.6666666666666666,8,5,GGAACGTGTTCCAGGTAAGA,3,2090483
lacIp,0.5,7,5,GATATCAGACCCGGCCCCTG,2,2095334
lacIp,0.3333333333333333,6,5,GACATCTAGTTGGTTTTGCT,1,2086969
lacIp,0.6666666666666666,8,5,GAACAGATCTATATACCTCT,3,2114795
lacIp,0.5,7,5,ATAAGCGCCTTAGGGACGTC,2,2086145
lacIp,0.3333333333333333,6,5,ACTTCGCAGGGGAAGCTCTT,1,2093712
lacIp,0.8,7,4,TGGTCGGAACAAGGATCAGC,3,2092285
lacIp,0.4,5,4,TGCGAACGTCTTTCATGGTT,1,2109841
lacIp,0.6,6,4,TCCGCCATTAAAGTGTCGCC,2,2086567
lacIp,0.6,6,4,TCATTTAACAAGCTTGCTGT,2,2122135
lacIp,1.0,8,4,TAGCGTCACCATGGGACTCA,4,2090346
lacIp,0.6,6,4,TACTGTTGTTGGACCGGTCA,2,2090045
lacIp,0.4,5,4,GTTGATTTGTGTTTACAGTG,1,2119992
lacIp,0.4,5,4,GTAGATCGCAGCAAAATAGC,1,2089318
lacIp,0.4,5,4,GGTACGCTAGACTTGCATGG,1,2119584
lacIp,0.6,6,4,GGGCGTGGGCGTGTCACCGA,2,2112583
lacIp,0.4,5,4,GGATTCAAGTAAACGCCGAT,1,2094044
lacIp,0.4,5,4,GGAGGCTTCAATGGTCGATA,1,2114960
lacIp,0.4,5,4,GGAGGCTAAAGCGTTTACAT,1,2114909
lacIp,1.0,8,4,GCTTCGGTTTGTCGCACCGA,4,2106630
lacIp,0.6,6,4,GCACGTCAGTACGGCGATGT,2,2103565
lacIp,0.6,6,4,GCAATCGGGCCTCGAAAATG,2,2111074
lacIp,0.4,5,4,GATCGTCCGCTCCAGACCAA,1,2121182
lacIp,0.6,6,4,GAGATATCCACCGCTCCATC,2,2114738
lacIp,1.2,9,4,GACTCGCGCTAGCATCGCCC,5,2093044
lacIp,0.4,5,4,GAAGCAAGCTCTCTGTCAGT,1,2092363
lacIp,0.4,5,4,CTGGCTGAAGCTGCTGTCGC,1,2085895
lacIp,0.6,6,4,CGTGCGCTCCCAAATAGTCC,2,2116340
lacIp,0.4,5,4,CGTAACTCGGAACAAAGTCA,1,2118561
lacIp,0.6,6,4,CGGCATCGATCCCCCAGCTT,2,2117423
lacIp,0.4,5,4,CGGAAAATGTACGATATCAG,1,2089065
lacIp,0.4,5,4,CGCGAGACGTAAAATCGAGG,1,2095373
lacIp,0.4,5,4,CGCACAAACCCCATAATGAG,1,2115744
lacIp,1.2,9,4,CGCAAGCTCCGCCCGCGACA,5,2103680
lacIp,0.4,5,4,CCGCACACACCTCTCCCTGG,1,2090513
lacIp,0.4,5,4,CCCTGCACTTAGAGAGCAAA,1,2119833
lacIp,0.4,5,4,CCAACCGGTCCCTCTGAAGG,1,2099117
lacIp,0.4,5,4,CATGCCAACACGGGGACTCG,1,2109563
lacIp,0.6,6,4,CAGGCCTTCAAGAAGACCTG,2,2087137
lacIp,0.8,7,4,CAATCCACGCAGACTGATAA,3,2089014
lacIp,0.8,7,4,ATGTTGGACTCCGATCGTAC,3,2095074
lacIp,0.6,6,4,ATCATCCGTCATCAAAATAC,2,2114544
lacIp,1.0,8,4,ATCAGTAGTCAGCTCCTGTC,4,2087364
lacIp,0.6,6,4,ATAATGGCATAATTTACAAA,2,2096546
lacIp,0.6,6,4,ATAAATACGCATGGCTGGAG,2,2106327
lacIp,0.8,7,4,AGTGGCCGTCATGCACCTGC,3,2087683
lacIp,0.8,7,4,ACGGGCCACGGTAGTAGTGA,3,2086804
lacIp,0.6,6,4,ACGCGTACCCGGTCGATCGA,2,2103395
lacIp,0.8,7,4,ACCGTGGTGGACCTTCGCGT,3,2101613
lacIp,1.6,11,4,ACAGAAGTACTGGGGGCATC,7,2098923
lacIp,0.8,7,4,ACACAGCGAGTCTCAAAGCC,3,2121764
lacIp,0.6,6,4,AACTCTGATTCTCGTCCGAC,2,2085896
lacIp,0.6,6,4,AACAGTCTCTCCGGACATAT,2,2112913
lacIp,0.4,5,4,AAATAATGCGTTGTGCTGAT,1,2105206
lacIp,0.75,5,3,TTTTGTGTACGGAGTGCCGT,2,2087020
lacIp,0.75,5,3,TTTGGAGCTGATACAGGCTA,2,2089431
lacIp,0.5,4,3,TTTGCACTCCTCATCTTGGT,1,2099089
lacIp,0.5,4,3,TTGTTATTTTCGACCTAACT,1,2111357
lacIp,0.75,5,3,TTGGGACGGTAGTCACGCAT,2,2092214
lacIp,1.0,6,3,TTGATAATCCAGCAGCCGTT,3,2119229
lacIp,1.25,7,3,TTGACTCCTCTCTGTATTTG,4,2099671
lacIp,0.5,4,3,TTCGTTTGGCGTTACATAGG,1,2116690
lacIp,0.5,4,3,TTACGATCCCCGGTACATGA,1,2118469
lacIp,0.5,4,3,TTAATTGGAGCACCTGTGAC,1,2111893
lacIp,0.5,4,3,TTAACGGACTCAAATCCGAT,1,2111514
lacIp,0.5,4,3,TGTAGAAAAGCTTCCGATAA,1,2105861
lacIp,1.25,7,3,TGTACGCCTACCAATCTCTG,4,2096213
lacIp,1.0,6,3,TGGGGTCGGCTAGTGGCGCA,3,2093775
lacIp,0.5,4,3,TGCAAAGCGCGGGATGATGC,1,2101541
lacIp,0.5,4,3,TGATTTCGGCTCAGATGTAC,1,2102847
lacIp,0.5,4,3,TGACAGGGCCTGATTCTCGG,1,2111712
lacIp,1.0,6,3,TCTTCTTCAGCACCTCTGCA,3,2118655
lacIp,0.75,5,3,TCTTACCGCCAATATGGAGT,2,2106241
lacIp,0.5,4,3,TCGAGTCCTTACCACGCCTT,1,2110051
lacIp,0.5,4,3,TCCATGTCTACTTAAGTAAT,1,2087822
lacIp,0.5,4,3,TCATCTTGCGGAAACATTAT,1,2103088
lacIp,0.5,4,3,TCACAATCCGTTGCGGTTGT,1,2093090
lacIp,1.0,6,3,TCACAAAGTCCAGCAGCTCA,3,2095975
lacIp,0.5,4,3,TCAACTCTTGAAGCAACCTC,1,2095974
lacIp,0.5,4,3,TATCATTCTGCTTTAAGTGT,1,2093828
lacIp,0.75,5,3,TAAGTTCGAACTTGTTGCGA,2,2117031
lacIp,0.5,4,3,TAACTCCATATCGGTTCTTT,1,2089658
lacIp,1.25,7,3,TAACGTTTCCTCGCTTAACA,4,2096004
lacIp,0.75,5,3,GTTGAGCAACGATGCCGTTT,2,2085818
lacIp,0.5,4,3,GTGCAAGGAAGCATGCTTAG,1,2088812
lacIp,0.5,4,3,GTCACAATGACCCCAGTTCC,1,2116580
lacIp,0.5,4,3,GTAGACGGTTACCCGAGTTG,1,2090871
lacIp,0.5,4,3,GGTTGCCCGTAGCACCTCTC,1,2104972
lacIp,0.5,4,3,GGTGCCCGTGAAGTGTTCAA,1,2107054
lacIp,0.5,4,3,GGTAGTGAATCGGATTTAAA,1,2089358
lacIp,0.75,5,3,GGGGGTATCGCGTGCTAATG,2,2106948
lacIp,0.5,4,3,GGGGCATACGATTATTGTTT,1,2089381
lacIp,0.5,4,3,GGCCTATGTTATATAACGTT,1,2099333
lacIp,0.5,4,3,GGCCCGGTGAGCATATAATT,1,2110489
lacIp,0.5,4,3,GGCATTGGGCTGTCCCGTGT,1,2100689
lacIp,0.5,4,3,GGCAGCCTGGCCGGTCTATG,1,2113371
lacIp,1.25,7,3,GGAACGTAAATCAAGTAATT,4,2090543
lacIp,1.0,6,3,GCTATGAAATACTTCTACCA,3,2085976
lacIp,1.25,7,3,GCTAGAACAGAACCGAGTTG,4,2101279
lacIp,1.0,6,3,GCCTGCAGCTATCCGTGGTC,3,2104406
lacIp,0.5,4,3,GCCGGTGGTGACACGAAACA,1,2106120
lacIp,1.0,6,3,GCCGGTCGGGAAAAAATAGT,3,2091783
lacIp,0.5,4,3,GCCGCTATTAAGTCTTTGTA,1,2089892
lacIp,0.5,4,3,GCATTTCATCAGGTCCATCT,1,2092887
lacIp,0.75,5,3,GCAGTCGCATTGCTACTGCG,2,2116314
lacIp,0.5,4,3,GCACCCGTGCTTTGAGGGGT,1,2103410
lacIp,0.5,4,3,GCAACTCGTTCAACAGATTA,1,2102545
lacIp,0.5,4,3,GCAACTATGACTGCTAATAC,1,2091011
lacIp,0.5,4,3,GATTCGGCGAAGTATTGGAC,1,2091389
lacIp,0.5,4,3,GAGAGGAGGCTATGGGTAGA,1,2114317
lacIp,0.75,5,3,GACTCCATTCCACCTGGCGT,2,2101339
lacIp,0.75,5,3,GACCAGTAAAGCGTTCAGGC,2,2115585
lacIp,0.75,5,3,GACACATACTGTCTGTAGGA,2,2086481
lacIp,1.75,9,3,CTTCTAGCAAATACTTATAA,6,2086525
lacIp,0.5,4,3,CTTCGTGAAGAGTAAAGCTG,1,2096232
lacIp,0.5,4,3,CTGTTAGATCATTTGGAAGA,1,2106007
lacIp,0.75,5,3,CTGGGGGCCTCAGTTATCAG,2,2097939
lacIp,0.5,4,3,CTGGATTGTGAGAATGGTCT,1,2101328
lacIp,0.5,4,3,CTGCCCCAGCATCGGCGGTA,1,2097037
lacIp,0.5,4,3,CTGCATCTAACCAGGAAATG,1,2111801
lacIp,0.75,5,3,CTCGGACGCCTCACTTGAGT,2,2089200
lacIp,1.0,6,3,CTCGACGATGGTCTTGGATG,3,2086518
lacIp,0.5,4,3,CTCCGTAATAAAGGGTCCTG,1,2086816
lacIp,0.75,5,3,CTATAGCGACCGGTTCCGTT,2,2102253
lacIp,1.0,6,3,CTAGTGCTTTGATCGGTCGC,3,2116122
lacIp,1.5,8,3,CTACTCCCAGCCGTGAAGCA,5,2117011
lacIp,0.5,4,3,CGTTCCGTGGGGAAGGACGA,1,2100074
lacIp,0.5,4,3,CGTTACTCGGCAATCAAGTG,1,2097707
lacIp,0.5,4,3,CGTGAGACTTCATAACATCA,1,2104246
lacIp,1.75,9,3,CGGGACTCCACTCCTGCGAC,6,2089386
lacIp,0.75,5,3,CGGAGGGACTAATATGTCCC,2,2097161
lacIp,0.5,4,3,CGGAACGGGCATCATCCCGA,1,2112202
lacIp,0.5,4,3,CGCTCCGGGGTCCCACTTTA,1,2103522
lacIp,0.75,5,3,CGCCCGCGCTGCGTTGGCCG,2,2102649
lacIp,0.75,5,3,CGATAGTTGCGATCCGTTGG,2,2110395
lacIp,0.5,4,3,CGAGGCTAGTGAATATGGGT,1,2117582
lacIp,0.5,4,3,CGAAGCGTTTGCAGGGTGTT,1,2087525
lacIp,0.5,4,3,CCTTCGTAAACTTCGTTTTG,1,2115436
lacIp,0.5,4,3,CCTTATGCACATTTTGGTCA,1,2103975
lacIp,2.0,10,3,CCTGGTGTGTAACCTAAATT,7,2113324
lacIp,1.5,8,3,CCTGCGTGCCTAGCGATGAG,5,2092063
lacIp,0.5,4,3,CCGTGACAGAGAACTATCTG,1,2105021
lacIp,0.75,5,3,CCGCGGTTTCGAACGCCCCA,2,2107933
lacIp,0.5,4,3,CCGCGAACACGGCACAGCGG,1,2095466
lacIp,0.5,4,3,CCCTTCCACACCCCGAGGGT,1,2100793
lacIp,1.5,8,3,CCCGTTGCGGCGGAGCGAAT,5,2103282
lacIp,0.75,5,3,CCCGCAGAAATCTAATAAGC,2,2089196
lacIp,0.5,4,3,CCAGAATTGCGGCCGTACAA,1,2086841
lacIp,0.5,4,3,CCACGGTTGTCGCAATAGAA,1,2092297
lacIp,0.5,4,3,CCACAACGATGCTACGCAAA,1,2098180
lacIp,1.25,7,3,CCAATGATAAATCAAGGCAT,4,2097504
lacIp,0.5,4,3,CCAAGTCCTGATGGCTATAG,1,2089034
lacIp,0.75,5,3,CCAAATAGGTAAGTGAGCCT,2,2118749
lacIp,0.5,4,3,CATTCAAGTTGGAATATCTT,1,2095378
lacIp,0.75,5,3,CATCGCACCCCACGTCAGGG,2,2095624
lacIp,1.0,6,3,CATAACCCTATTCGCAACCA,3,2092428
lacIp,0.75,5,3,CAGTGACGGTCGGGTTTAGA,2,2091082
lacIp,0.5,4,3,CAGTATTATGCTAATGGTGG,1,2100518
lacIp,0.5,4,3,CAGGGTTACAGCAGTGAGGC,1,2088572
lacIp,0.75,5,3,CAGATGTGCCGGGTGGTGTG,2,2105783
lacIp,0.5,4,3,CACTTAAAGGTTTTGTAAGG,1,2092411
lacIp,0.5,4,3,CACACGGAAATTAAGAAACA,1,2087236
lacIp,0.75,5,3,CAACCGAGCGAAACCTGGTT,2,2103734
lacIp,0.5,4,3,CAAAAGCGAAAACAACTCCA,1,2090258
lacIp,0.5,4,3,ATTTTTCCTAGTACTCTCCT,1,2091410
lacIp,1.25,7,3,ATTCCGAAAATACTAAGTGT,4,2098571
lacIp,1.0,6,3,ATGAGTGTCGTTTGATGTGC,3,2090185
lacIp,0.5,4,3,AGTGCGATAGCCGAGGGTTA,1,2111178
lacIp,0.75,5,3,AGTCTTGGGGTAAGTACTGA,2,2104593
lacIp,0.75,5,3,AGTAGTACAGTTTCAGCAAC,2,2093823
lacIp,0.75,5,3,AGGGTCTGTGCTGTCGTCGG,2,2092450
lacIp,1.25,7,3,AGGCCTCACAACCTTCACCT,4,2090596
lacIp,0.75,5,3,AGGCAATGGTAGACGCCTAA,2,2117293
lacIp,1.0,6,3,AGGAGAACTCCCTCGTGACA,3,2090134
lacIp,2.0,10,3,AGCTAGTGCACGATGGATGC,7,2089488
lacIp,1.0,6,3,AGCGCGCGACATTGAGCAAA,3,2086681
lacIp,0.75,5,3,AGCCAATGAGAAACGAATGT,2,2088294
lacIp,0.5,4,3,AGAGTCGTGCGCAAGACGTT,1,2087242
lacIp,0.5,4,3,AGAGAAAAGTAGAAGATCAC,1,2092970
lacIp,0.5,4,3,ACTCTGTCGCCTGGGCTTGA,1,2113111
lacIp,0.5,4,3,ACGGCCATAAGGGAACAGTT,1,2121051
lacIp,0.5,4,3,ACGCTAGTCAGCAGTAAAAT,1,2114775
lacIp,0.5,4,3,ACGCGCGGATACCAATGCTG,1,2100868
lacIp,0.75,5,3,ACGCAGGTTCCTCAGCCTCT,2,2088488
lacIp,0.5,4,3,ACGACGAGCGGTTATGGTAC,1,2086047
lacIp,0.75,5,3,ACCTCGCTGAGGTTCGCTCT,2,2088412
lacIp,0.75,5,3,ACAAATCAGGAAGCTTAGAG,2,2107456
lacIp,1.0,6,3,AATCGGGCGCATCTCAGCCA,3,2086043
lacIp,0.75,5,3,AACTGATGGTCGTAATCGGA,2,2089470
lacIp,0.75,5,3,AACTAACGGCCGTCTGCGGA,2,2092756
lacIp,0.75,5,3,AACCCCCCGACGCAAGTTAA,2,2106971
lacIp,0.5,4,3,AAAGGAAGTGCGGACGGTGA,1,2110203
lacIp,1.3333333333333333,5,2,TTTTAAAATGGAAAAAGGAC,3,2110158
lacIp,1.3333333333333333,5,2,TTTGGTAATGGCGTAAAAGA,3,2096652
lacIp,0.6666666666666666,3,2,TTTCGAGGGCAACAACCCTT,1,2104498
lacIp,1.0,4,2,TTTACTAGGAAGACGCGGGG,2,2118671
lacIp,0.6666666666666666,3,2,TTGTTGATTTCCTTTTTCTT,1,2100024
lacIp,1.0,4,2,TTGGTTAAGAGCGCGCGATC,2,2098454
lacIp,1.0,4,2,TTGAGGTCTATGTCGGAGGT,2,2113965
lacIp,0.6666666666666666,3,2,TTGAGCCTTGGCAGCACCGG,1,2098075
lacIp,0.6666666666666666,3,2,TTGACGATGAGTATGTCTCT,1,2118133
lacIp,1.6666666666666667,6,2,TTCTCTATTCCCTTCGACGA,4,2100371
lacIp,0.6666666666666666,3,2,TTATGGTGAGAAGGGAGATA,1,2095486
lacIp,0.6666666666666666,3,2,TTATCGTACAGCACCCGCAT,1,2102220
lacIp,0.6666666666666666,3,2,TTATCGCGGAGATATAGGGT,1,2093122
lacIp,0.6666666666666666,3,2,TTAGCTTGATTAAACGTCGT,1,2112773
lacIp,0.6666666666666666,3,2,TTAGAGTGTATAGAACCATC,1,2086084
lacIp,1.0,4,2,TTACAGACTACGTGGGCCTT,2,2089357
lacIp,0.6666666666666666,3,2,TTACAACTACCCCGTCGAAT,1,2116308
lacIp,0.6666666666666666,3,2,TTAATGCTCGAGGTTTGCAA,1,2112579
lacIp,0.6666666666666666,3,2,TGTTAGCTCACGTTTAATGA,1,2117378
lacIp,1.3333333333333333,5,2,TGTGGTACAAGGTCGGTCGT,3,2087477
lacIp,1.0,4,2,TGTCTATCGTTCTGATGCTA,2,2089860
lacIp,0.6666666666666666,3,2,TGTACGTGCCACCCTGTCAG,1,2094624
lacIp,1.6666666666666667,6,2,TGTACATTTCCGCGCGATAT,4,2115656
lacIp,0.6666666666666666,3,2,TGTAAAGTAGCTTAGGGGAG,1,2120731
lacIp,1.6666666666666667,6,2,TGGTGGAGTAAGGCGATGTA,4,2096638
lacIp,1.0,4,2,TGGTCCTGATCGTTAGAGTT,2,2111554
lacIp,1.0,4,2,TGGACCGTCTGCCATCCGCC,2,2107443
lacIp,0.6666666666666666,3,2,TGCCTTGACTAACAAGGGAG,1,2110690
lacIp,0.6666666666666666,3,2,TGCCGGTCTATCAATATTCA,1,2115816
lacIp,1.3333333333333333,5,2,TGAGTTTTTATATCAAACGT,3,2115003
lacIp,0.6666666666666666,3,2,TCTTATATGTCTTGCGAAAG,1,2115975
lacIp,1.0,4,2,TCTTAATTGGTGTGAGAGGT,2,2094061
lacIp,1.3333333333333333,5,2,TCTCTACCCGGAGTTTGTCC,3,2110726
lacIp,1.0,4,2,TCTCCCTCGAACGTCTTACA,2,2087974
lacIp,0.6666666666666666,3,2,TCTATTTGTTGCTGACCACT,1,2086276
lacIp,1.0,4,2,TCGTTAGTCGGCAGTTTCAT,2,2121706
lacIp,0.6666666666666666,3,2,TCGGCGAATTAATGACGTAT,1,2089167
lacIp,1.0,4,2,TCGCCATCTCAATGGAACAG,2,2104135
lacIp,0.6666666666666666,3,2,TCGAAGTCACAAATTATCTC,1,2096418
lacIp,1.6666666666666667,6,2,TCCTCCTCACCTGCTACCTT,4,2102918
lacIp,1.0,4,2,TCCGTGTTCGGGATGCGACC,2,2096355
lacIp,0.6666666666666666,3,2,TCCGCCGGTCACGCGGTTGA,1,2105809
lacIp,1.3333333333333333,5,2,TCCGCAGCTTTGGCGCTGAT,3,2121069
lacIp,0.6666666666666666,3,2,TCCCCTTGTTGCCAAGCGTT,1,2087692
lacIp,0.6666666666666666,3,2,TCCATTGTATTTACAATTCT,1,2115601
lacIp,0.6666666666666666,3,2,TCATCACTCGGCAGAACGAA,1,2098228
lacIp,0.6666666666666666,3,2,TCAGGATCCTTTGACGCATG,1,2109016
lacIp,2.6666666666666665,9,2,TCACTACTCACGAAAACAGC,7,2096818
lacIp,1.0,4,2,TCAATTTGCGTGCAACACAT,2,2098287
lacIp,1.6666666666666667,6,2,TATTCTAGGTGTTCAGCAGC,4,2118349
lacIp,0.6666666666666666,3,2,TATCTTGCGACAAGCGTCAT,1,2100752
lacIp,0.6666666666666666,3,2,TATAATTGCCTCGTACCTAA,1,2100338
lacIp,0.6666666666666666,3,2,TAGCCGTTCTTAGAGTACAA,1,2093168
lacIp,0.6666666666666666,3,2,TAGCATTTTCTAGTCCAATA,1,2099801
lacIp,1.0,4,2,TAGAGTGGAATCACATACGC,2,2113584
lacIp,1.0,4,2,TAGAATGTCTCCCTTTGGTA,2,2108632
lacIp,0.6666666666666666,3,2,TACGTCCCCGTCCACCCACA,1,2090870
lacIp,0.6666666666666666,3,2,TACGATGATCCGCCATCATA,1,2099294
lacIp,1.0,4,2,TAATTGAGAGGATTATATGC,2,2086213
lacIp,1.0,4,2,TAATACGCCCATCCCTTCTA,2,2107986
lacIp,1.3333333333333333,5,2,TAAGACTCTGATCGAAAAGC,3,2107116
lacIp,0.6666666666666666,3,2,GTTTGGTTATTAACCCACAT,1,2092427
lacIp,1.0,4,2,GTTGTTTCGGCCTAAGTTCC,2,2093845
lacIp,0.6666666666666666,3,2,GTTGGTTCTGATTCGGATGT,1,2093069
lacIp,0.6666666666666666,3,2,GTTATGAGGCCGTATCCGGT,1,2096065
lacIp,1.3333333333333333,5,2,GTTATCCTTGCCGTATAGAT,3,2104480
lacIp,1.0,4,2,GTTACTAACGAAAATTGCCT,2,2115876
lacIp,1.0,4,2,GTTACCCCTACAGTACAGAA,2,2102569
lacIp,0.6666666666666666,3,2,GTTAACCTACCATTGTGCTT,1,2119492
lacIp,3.0,10,2,GTGCTTTATCGTTTTGAACA,8,2118179
lacIp,1.3333333333333333,5,2,GTGATCCTCATACACATGAA,3,2116250
lacIp,1.0,4,2,GTGAGACCTAATACCTTGAT,2,2096046
lacIp,0.6666666666666666,3,2,GTCTTGTCCTGATTGTATTG,1,2106355
lacIp,1.6666666666666667,6,2,GTCGGCTTTAGGCTGAATCA,4,2099388
lacIp,1.0,4,2,GTCGGATTGTCTGAATCGGA,2,2095888
lacIp,0.6666666666666666,3,2,GTCCGGTAGTAGATGCGGAG,1,2097764
lacIp,1.0,4,2,GTATTGATCCTCGCTCGCCA,2,2086520
lacIp,1.0,4,2,GTATATTGATGCGACTCCGC,2,2116369
lacIp,0.6666666666666666,3,2,GTACTATACGTTCCAAAAGC,1,2101696
lacIp,1.0,4,2,GGTTTCTTGATGTCATATCC,2,2103049
lacIp,1.3333333333333333,5,2,GGTGTAAGTATTTCTGTGGT,3,2105130
lacIp,1.0,4,2,GGTGGAGCGCCGAGATAGGC,2,2108011
lacIp,1.0,4,2,GGTCGCTCCAGATCACCGAC,2,2101931
lacIp,1.3333333333333333,5,2,GGTACAATTCTCTCTCCTCT,3,2104631
lacIp,1.0,4,2,GGGGGTCATTGCACTAATCC,2,2102351
lacIp,2.6666666666666665,9,2,GGCAACTTGTTTGTCGAGTA,7,2100853
lacIp,0.6666666666666666,3,2,GGAGGTCTGCGTCCAGGGCT,1,2102405
lacIp,2.6666666666666665,9,2,GGACTCAGGCCCCAGTCCAG,7,2117302
lacIp,1.0,4,2,GGACGAGGCTGGGGCACTCA,2,2090437
lacIp,0.6666666666666666,3,2,GGACAAGTTTGGCGTCTCCA,1,2107860
lacIp,1.3333333333333333,5,2,GCTCTCTCACTGAATAGTTC,3,2091439
lacIp,0.6666666666666666,3,2,GCGGCGCCTCAGCATTCAGA,1,2117802
lacIp,0.6666666666666666,3,2,GCGGAGCCTCGGATTAGGTG,1,2089479
lacIp,1.0,4,2,GCGCTCTGTCCTTATATAGT,2,2088984
lacIp,1.0,4,2,GCGCTATAATGAATGTGCGC,2,2119415
lacIp,0.6666666666666666,3,2,GCGACCTACATCGAGAATAA,1,2121543
lacIp,0.6666666666666666,3,2,GCGAAGAGCCCTTTACGCTT,1,2121335
lacIp,0.6666666666666666,3,2,GCGAAACCGTACTCTTGGAA,1,2096376
lacIp,0.6666666666666666,3,2,GCCTCCTTTCCCACCGAGAG,1,2104302
lacIp,0.6666666666666666,3,2,GCCTCATTATAATTGGCTTA,1,2105762
lacIp,0.6666666666666666,3,2,GCCATAGATCTCCGAGTCCT,1,2112191
lacIp,0.6666666666666666,3,2,GCCAACCGGCATCTATGCGT,1,2103052
lacIp,2.3333333333333335,8,2,GCATATTGTAACTACCCTAT,6,2104204
lacIp,1.0,4,2,GCAGTGTCTTACTACCGTCG,2,2121623
lacIp,1.0,4,2,GCAGTCTGGTGTAGACGATG,2,2095305
lacIp,1.0,4,2,GCAGCTGACTAACATACGAA,2,2096948
lacIp,1.0,4,2,GCAGCGTCATTTTCAGGTTA,2,2110249
lacIp,0.6666666666666666,3,2,GCACACTGGTAGCGGCAGGT,1,2101454
lacIp,0.6666666666666666,3,2,GCAATATCGCTTTCAAAGTG,1,2089792
lacIp,0.6666666666666666,3,2,GCAACCCGCCTGGTCAAGCA,1,2098541
lacIp,0.6666666666666666,3,2,GCAAACCATCACCAAAGAAA,1,2114836
lacIp,0.6666666666666666,3,2,GATTATTGGCACCTTAATAT,1,2096620
lacIp,0.6666666666666666,3,2,GATGGGATAAGTGACCGCTA,1,2112893
lacIp,0.6666666666666666,3,2,GATGGCCAACTGCAATCACA,1,2106141
lacIp,1.0,4,2,GATCGTACTGCTGAGCCCGA,2,2109765
lacIp,1.0,4,2,GATCCCCAGCGACAAGTGCT,2,2092969
lacIp,1.0,4,2,GATATAGTAGTGCGGTTTCT,2,2099353
lacIp,1.0,4,2,GACTTTCCCCGTGCGTTACA,2,2111395
lacIp,0.6666666666666666,3,2,GACCTATCTGTTAGCACATC,1,2088923
lacIp,1.3333333333333333,5,2,GACAGCCACGCCGAAACCAA,3,2105710
lacIp,2.0,7,2,GAATTGCTAGGGCTACATGT,5,2089452
lacIp,1.0,4,2,GAATCCAAGCGTGAAGCTAT,2,2094455
lacIp,1.0,4,2,GAATAAGTGGATCCCCGATT,2,2117125
lacIp,0.6666666666666666,3,2,GAACAGCCCTAGCATTAATC,1,2096453
lacIp,1.3333333333333333,5,2,CTTGGTTGCTTTTTGACCCT,3,2093469
lacIp,0.6666666666666666,3,2,CTTGCTGCGGGAAACCCTAG,1,2088081
lacIp,0.6666666666666666,3,2,CTTCTCTTGCAGGCTTCCCT,1,2086483
lacIp,0.6666666666666666,3,2,CTGTGAAGCACAAACGGAGC,1,2110054
lacIp,1.3333333333333333,5,2,CTGGATTCAGGCCATTGTCT,3,2093551
lacIp,1.0,4,2,CTGCGTACAGGTGCGCTAGA,2,2091378
lacIp,1.0,4,2,CTGCAATGGGTAGGTCCTTA,2,2106442
lacIp,1.0,4,2,CTGAAGGGTCGCATACACCG,2,2103676
lacIp,0.6666666666666666,3,2,CTCGCGGCGTTATCTCAAGA,1,2094881
lacIp,1.0,4,2,CTCGATCTAATGTTTCCAAT,2,2116423
lacIp,0.6666666666666666,3,2,CTCCGTGGTAACGGTTTTCA,1,2092706
lacIp,0.6666666666666666,3,2,CTATGCTAAGAGTCCGGTGT,1,2117173
lacIp,1.3333333333333333,5,2,CTAATTTCACATATGTAATA,3,2121739
lacIp,0.6666666666666666,3,2,CTAAGTGCGGGCTCATACAT,1,2088694
lacIp,1.0,4,2,CTAAATAAATCCTTTTAACC,2,2086080
lacIp,0.6666666666666666,3,2,CGTTTCATGAATTTTGCGCT,1,2099414
lacIp,1.0,4,2,CGTGGCAACACGGCTACTTT,2,2094547
lacIp,1.0,4,2,CGTCTTTGAAAACCCCTGGA,2,2093644
lacIp,0.6666666666666666,3,2,CGTCCGAATCCAGCCCACTG,1,2095754
lacIp,1.3333333333333333,5,2,CGTCCAGCGGGTGCAGACTT,3,2100329
lacIp,0.6666666666666666,3,2,CGTAGTATGACGAGTAGGCT,1,2100800
lacIp,1.0,4,2,CGTAGGGTCCTCGGCTAAAG,2,2108339
lacIp,0.6666666666666666,3,2,CGGTCCTTCGATGTTTATAC,1,2086175
lacIp,0.6666666666666666,3,2,CGGTATGGTGGAACCGTGAA,1,2105249
lacIp,0.6666666666666666,3,2,CGGGTTAGGCAGAAGTTAAC,1,2102921
lacIp,1.0,4,2,CGGGTCAGAGGCGCAGTCAT,2,2094376
lacIp,1.0,4,2,CGGCGTCACTTGCCGTCACT,2,2089735
lacIp,0.6666666666666666,3,2,CGGCCGTAGTTAATAGCTCC,1,2091328
lacIp,1.6666666666666667,6,2,CGGCCGCATCATCATATGAT,4,2111054
lacIp,1.0,4,2,CGGAACATTAACCCATAGCC,2,2087133
lacIp,0.6666666666666666,3,2,CGCTGTGCGTCAAATATATG,1,2106953
lacIp,1.0,4,2,CGCTGCACTACAGGGACCAT,2,2107937
lacIp,0.6666666666666666,3,2,CGCTATGCCTCGAACACTAT,1,2091522
lacIp,0.6666666666666666,3,2,CGACTTAGAAGTCTATTTAC,1,2089871
lacIp,2.3333333333333335,8,2,CGAACCCCCCAGCTGATCAG,6,2098710
lacIp,1.0,4,2,CGAAAATGTGTACTCTGAGC,2,2105574
lacIp,0.6666666666666666,3,2,CCTGATCGTACGATGTACCT,1,2100429
lacIp,1.3333333333333333,5,2,CCGTGGGCGAACATCATTGG,3,2099499
lacIp,1.0,4,2,CCGGGCGGCTCTAACGAGCT,2,2087285
lacIp,1.0,4,2,CCGAGTGCTTGTGATCGCTT,2,2116883
lacIp,0.6666666666666666,3,2,CCGACGAGGGCGCACGGATA,1,2117589
lacIp,0.6666666666666666,3,2,CCCGTTCTTTCCGCTACCAA,1,2097823
lacIp,0.6666666666666666,3,2,CCCGACGGTTTTCGGTTAAA,1,2091968
lacIp,1.3333333333333333,5,2,CCCCTGATGTTATTTCAGTA,3,2104831
lacIp,2.0,7,2,CCCCCTACACTGCAGATTCT,5,2097072
lacIp,1.0,4,2,CCCCAGTTCGAACAGCACTG,2,2102567
lacIp,0.6666666666666666,3,2,CCCAGGTGATTAGCACCTAA,1,2118193
lacIp,2.6666666666666665,9,2,CCATACGGCGTACAATACCA,7,2086755
lacIp,0.6666666666666666,3,2,CCATAAACGAAATCTGATTA,1,2114696
lacIp,1.0,4,2,CCAATGCTTTGTTGTGCAAT,2,2098714
lacIp,1.0,4,2,CATGTTCAGTGTGGAATTCC,2,2096822
lacIp,0.6666666666666666,3,2,CATCGGGAAGAATCGAATGT,1,2102019
lacIp,1.3333333333333333,5,2,CATATAAAAATTTTGAAAGT,3,2089768
lacIp,0.6666666666666666,3,2,CAGTGCCGCATGGTTAACCA,1,2103423
lacIp,0.6666666666666666,3,2,CAGGGTTAAATGAGAGAATA,1,2094276
lacIp,1.0,4,2,CAGAGGACTATCCGCACCAG,2,2102354
lacIp,0.6666666666666666,3,2,CACTTGTGGGGGTCTGCCTT,1,2089560
lacIp,0.6666666666666666,3,2,CACTGCAACGGGAACTTCAT,1,2089183
lacIp,0.6666666666666666,3,2,CACCGAGAGTAGTCCGCGTT,1,2117832
lacIp,0.6666666666666666,3,2,CACCCTGAGTGGCCCACGGT,1,2102713
lacIp,1.0,4,2,CACCAATCCGGACCAGTGTA,2,2118957
lacIp,4.666666666666667,15,2,CACAGGCTGAATATTAACTC,13,2090114
lacIp,1.0,4,2,CACACGACGTTTATGCCTGA,2,2092620
lacIp,1.6666666666666667,6,2,CACAACCAGCGGTCTCAGTA,4,2093409
lacIp,1.6666666666666667,6,2,CAATGGGACCGAGGTGACTC,4,2097016
lacIp,0.6666666666666666,3,2,CAATCCGCAATTGGTAGATT,1,2086682
lacIp,1.0,4,2,CAAGGGTCTCGTGGGATAGG,2,2117857
lacIp,1.0,4,2,CAACTGCCTCGTTCTTTCAT,2,2099001
lacIp,1.3333333333333333,5,2,CAACGTATATACGCAAGTAT,3,2119668
lacIp,0.6666666666666666,3,2,CAACCCACTCGTAGATTATT,1,2122189
lacIp,1.6666666666666667,6,2,CAAACTGGAGCCCGGCGGAG,4,2098452
lacIp,1.0,4,2,CAAAATCAAGTACTGGTATA,2,2086081
lacIp,1.0,4,2,ATTTAGACGGGAACGGCGGC,2,2103651
lacIp,0.6666666666666666,3,2,ATTTAAAGCTCATACTAACT,1,2114530
lacIp,2.6666666666666665,9,2,ATTGTCGCCGATCAACTGCA,7,2098379
lacIp,0.6666666666666666,3,2,ATTCAATCGCATGATCATTA,1,2095664
lacIp,0.6666666666666666,3,2,ATTAGTTAGACCCCGCGGCG,1,2092018
lacIp,1.3333333333333333,5,2,ATTACATCAGTACTATCTCT,3,2087054
lacIp,1.0,4,2,ATGTTTCCTATGACGCTGTG,2,2089936
lacIp,0.6666666666666666,3,2,ATGTGTATCTCTATCCGCCT,1,2090748
lacIp,0.6666666666666666,3,2,ATGCGAACTATAACTGGGTC,1,2093973
lacIp,0.6666666666666666,3,2,ATGCCTTCATCGGCCCGAAA,1,2091548
lacIp,1.0,4,2,ATGCAGGAAGAGCTCTCCGG,2,2087791
lacIp,0.6666666666666666,3,2,ATGAATGAGCTGACGAGCAT,1,2097971
lacIp,0.6666666666666666,3,2,ATCGTCACTTCGAGGGTTAG,1,2105886
lacIp,1.0,4,2,ATCGCGCAAAAGGCGGTTCA,2,2112781
lacIp,0.6666666666666666,3,2,ATCGATGAAGAAGCGCAGGA,1,2086484
lacIp,0.6666666666666666,3,2,ATCCTTAGTTAGGTCTGTTT,1,2115730
lacIp,0.6666666666666666,3,2,ATCCGGCTATTTAGGTTTTT,1,2111980
lacIp,0.6666666666666666,3,2,ATCACCACGCACCCAGGCAA,1,2111286
lacIp,1.0,4,2,ATCAACTCGTGACGAGACTT,2,2093263
lacIp,0.6666666666666666,3,2,ATAGGCACTACTCTCCGCCA,1,2104716
lacIp,0.6666666666666666,3,2,ATAATGCGCCATGTACCCGC,1,2109526
lacIp,0.6666666666666666,3,2,ATAACGAGTTGTCCCTATTG,1,2103973
lacIp,0.6666666666666666,3,2,AGTTTTATGGTTCGGCAGGG,1,2105797
lacIp,1.0,4,2,AGTTTAATCCGCTACTATTT,2,2107298
lacIp,0.6666666666666666,3,2,AGTGTGGAGTTAGGGGTGGT,1,2086405
lacIp,0.6666666666666666,3,2,AGGGGTATCGACAGGTGAGT,1,2104590
lacIp,0.6666666666666666,3,2,AGGGATTCAGAGTAATAATA,1,2108409
lacIp,1.0,4,2,AGGAGTCGATAACGAGCTTT,2,2109148
lacIp,0.6666666666666666,3,2,AGGACTCTACGCTAAAATGG,1,2092138
lacIp,0.6666666666666666,3,2,AGCTCATTCACCGGATCTGG,1,2100521
lacIp,0.6666666666666666,3,2,AGCGACCCAAATTGCACACC,1,2105147
lacIp,0.6666666666666666,3,2,AGCCCTCTTCGAACGAGAGG,1,2089858
lacIp,0.6666666666666666,3,2,AGAACCCGTCGCACGCGGAC,1,2091017
lacIp,0.6666666666666666,3,2,ACTTGAGTGATCAATAACTC,1,2110266
lacIp,1.0,4,2,ACTCCATGCGCTCGTTCGGT,2,2122400
lacIp,0.6666666666666666,3,2,ACTATAACTGTTATATGCCA,1,2121358
lacIp,1.6666666666666667,6,2,ACTAGGAGCATCGGCGGCGC,4,2098003
lacIp,0.6666666666666666,3,2,ACTAATCTACGATGTTTAGA,1,2098177
lacIp,0.6666666666666666,3,2,ACGTTGTTGTCGGTGATATA,1,2090663
lacIp,1.0,4,2,ACGGTAAGGCGACCCCTACA,2,2112022
lacIp,0.6666666666666666,3,2,ACGCATCGCGCGGGCGATAT,1,2111355
lacIp,1.3333333333333333,5,2,ACGCAGCTCCTCAAAAGATG,3,2113230
lacIp,0.6666666666666666,3,2,ACCCCCCATGACAACGAGTA,1,2110087
lacIp,0.6666666666666666,3,2,ACCATGCTACGGTGCGCGTA,1,2101788
lacIp,1.0,4,2,ACCACTAAACGTGACTGGTC,2,2087732
lacIp,1.0,4,2,ACCACAATTTTGCTCAAAGT,2,2090545
lacIp,3.0,10,2,ACATGGGATATGTCGAGGCA,8,2088231
lacIp,0.6666666666666666,3,2,ACATGCGCCCTGCGAATTAT,1,2117428
lacIp,2.0,7,2,ACATCCCTGGAAACAAGGCT,5,2111987
lacIp,1.3333333333333333,5,2,ACACTAACATCGGAAGCGTA,3,2107189
lacIp,0.6666666666666666,3,2,AATCTTCCAGTGTCGGATGG,1,2115737
lacIp,0.6666666666666666,3,2,AATAGTCGCACGTTGAGGGA,1,2121218
lacIp,1.0,4,2,AAGTCGCAACACAGCGGCAT,2,2099336
lacIp,0.6666666666666666,3,2,AAGGACTCCCAGAAGATATT,1,2087409
lacIp,0.6666666666666666,3,2,AAGAGATCGCCATCAAACCC,1,2101503
lacIp,0.6666666666666666,3,2,AAGACTATGGAATGAGATTT,1,2109089
lacIp,0.6666666666666666,3,2,AACTCTAGGAAGTGAGCTAG,1,2088214
lacIp,1.0,4,2,AACCATAGCACATAGCGAAG,2,2102535
lacIp,0.6666666666666666,3,2,AACAGCTTACCCCAGGTAGA,1,2094254
lacIp,0.6666666666666666,3,2,AACACTGATTACAGAACTAG,1,2088067
lacIp,0.6666666666666666,3,2,AACACGATAATAAGGTGTCG,1,2115099
lacIp,0.6666666666666666,3,2,AAACACTCTTGCGAGGTCCG,1,2088618
lacIp,0.6666666666666666,3,2,AAACACTACATATAAGCACC,1,2111341
lacIp,1.0,4,2,AAAATGCCAGGATAATGAAC,2,2087730
lacIp,0.6666666666666666,3,2,AAAACGCCGGTTAAGGCGAG,1,2111091
lacIp,1.0,2,1,TTTTCACATGCTTTAAGGCT,1,2108525
lacIp,1.5,3,1,TTTTACGAATATCGTTGATA,2,2094452
lacIp,3.0,6,1,TTTGTGCGGTAAATACGCGA,5,2106087
lacIp,3.0,6,1,TTTGGCATGGCAAACGTGTA,5,2102631
lacIp,1.0,2,1,TTTGCGCGAACAATTCACCT,1,2110197
lacIp,2.0,4,1,TTTGCGATCGACCCAAACGA,3,2095595
lacIp,1.0,2,1,TTTGCCCGCTAGGGCCGTGA,1,2095432
lacIp,1.5,3,1,TTTCTACACCCCGGCAACCC,2,2094413
lacIp,1.0,2,1,TTTATAATTGTTACACGTAC,1,2093070
lacIp,1.5,3,1,TTTAACTCGGGATCGACGCA,2,2106733
lacIp,1.0,2,1,TTGGTTTGGATAATCGTTCC,1,2107826
lacIp,1.0,2,1,TTGGTTCGGCCTGTCCGTGT,1,2107418
lacIp,1.0,2,1,TTGGTAGCCATTGGTCAAGA,1,2107862
lacIp,1.5,3,1,TTGCGGATTCACAAAGTTTT,2,2089739
lacIp,1.5,3,1,TTGCCCTTCCCGGGGATGTT,2,2097173
lacIp,1.0,2,1,TTGAGGGAACTACACGGGCG,1,2105876
lacIp,2.0,4,1,TTGAGACCTAAGTTGGACTT,3,2106240
lacIp,1.0,2,1,TTGACGTGCCACCTATGAGG,1,2097924
lacIp,1.5,3,1,TTGACATCGGTGTGCAGGCG,2,2089591
lacIp,1.0,2,1,TTGAAGGGTCACACTCCCAA,1,2086940
lacIp,1.0,2,1,TTCGGCGGGTGGCCGATCCG,1,2098722
lacIp,4.5,9,1,TTCGCTCCATCGATCTTCCT,8,2102252
lacIp,1.5,3,1,TTCGCTATGTATATTAGAAA,2,2115337
lacIp,1.5,3,1,TTCGATCAGCACCGAAACTC,2,2091764
lacIp,2.0,4,1,TTCCATGTCTCCACACTCCT,3,2109090
lacIp,2.5,5,1,TTCCAATGCGCAGGTGTAGG,4,2091947
lacIp,1.5,3,1,TTATGGACCGGTTCCTAGGA,2,2108332
lacIp,2.5,5,1,TTATAGGTTCTTCTACACCT,4,2113872
lacIp,1.0,2,1,TTAGGCGCAACTGGAGTACC,1,2116881
lacIp,1.5,3,1,TTACGTGTAGCGATGCGAAC,2,2104758
lacIp,1.5,3,1,TTACGAAAGAAATTGAGGCA,2,2107547
lacIp,1.5,3,1,TTAACTTTGGCTCGTCGCGA,2,2112769
lacIp,1.0,2,1,TTAACCGGATGCAGTGCGGT,1,2110737
lacIp,2.0,4,1,TTAAACCGGTCCAGGGAAAG,3,2098384
lacIp,1.0,2,1,TGTTGTTGGGCCACCCCGGT,1,2112640
lacIp,2.0,4,1,TGTTACGGCGTAGATCGCCT,3,2089457
lacIp,1.5,3,1,TGTGTGGCCTATCAAACAGG,2,2103655
lacIp,1.5,3,1,TGTGGCTGTCCTAATAAAAT,2,2109425
lacIp,1.0,2,1,TGTGCTCTTTGTGTCGAAAG,1,2113666
lacIp,1.0,2,1,TGTCTTGGACTGTTATCTTA,1,2098563
lacIp,1.0,2,1,TGTCTGCCCCGCTGCAGGAT,1,2118215
lacIp,1.0,2,1,TGTCGTGAGGCAGTGAGTCC,1,2109665
lacIp,1.0,2,1,TGTCACGATAATGGTATCGC,1,2087173
lacIp,1.5,3,1,TGTAACTTTACAGGGCCAAC,2,2122211
lacIp,1.0,2,1,TGGTTATTAAAGAAACGTCT,1,2117904
lacIp,1.0,2,1,TGGGGCGTTCTGTGAATGAT,1,2098593
lacIp,1.0,2,1,TGGCTCCGCGACACATCTTG,1,2087103
lacIp,1.0,2,1,TGGCGTCCGTTTGTTGGCAA,1,2092185
lacIp,1.0,2,1,TGGCCGCCTCTCGGTGGAAT,1,2090157
lacIp,1.5,3,1,TGGCAGCACGCTATGCTCTA,2,2102814
lacIp,2.5,5,1,TGGACCATCGCGGGAACTGG,4,2107405
lacIp,3.0,6,1,TGCTAATGTATTCCTGGTGT,5,2090911
lacIp,1.0,2,1,TGCGGACTAGGTCACCAGGA,1,2104698
lacIp,2.0,4,1,TGCCGGTGCGCATAACCCGT,3,2109099
lacIp,1.0,2,1,TGCCCTGACCAACGTGCGAT,1,2111890
lacIp,1.5,3,1,TGCATCGATTTGGTTCGTCC,2,2099022
lacIp,1.0,2,1,TGCACTGTAATGCCGAACGG,1,2088521
lacIp,1.5,3,1,TGATTTGCCTCTCTAACAGT,2,2107698
lacIp,1.0,2,1,TGATCGGGGAGGCCTGAGTA,1,2086430
lacIp,1.0,2,1,TGATCACGCGTAATCCAGAA,1,2105499
lacIp,1.0,2,1,TGAGTATCAAAGAAAACCAT,1,2095559
lacIp,1.0,2,1,TGAATATAGTACCGTGTGAA,1,2103792
lacIp,1.5,3,1,TGAAGCTGGACCCGGACAAA,2,2087981
lacIp,2.0,4,1,TGAAATTTCCCCGGGGCAGG,3,2112434
lacIp,1.5,3,1,TCTTTTAGGGAGCTCATCAA,2,2104398
lacIp,1.0,2,1,TCTTGTTCTTGCTTGTTCGT,1,2087910
lacIp,2.5,5,1,TCTTGTGGCAACATCTGCAG,4,2098393
lacIp,1.5,3,1,TCTTGTATGCAATCAGGGGT,2,2116658
lacIp,1.0,2,1,TCTTGGGAGGGGCTTACCAA,1,2106161
lacIp,1.5,3,1,TCTGGTTCTCTTCGGGCTTA,2,2097194
lacIp,1.5,3,1,TCTGAGTTCCATGCGCATGA,2,2089553
lacIp,7.5,15,1,TCTAGTTGGGACGTTACCGT,14,2098378
lacIp,1.5,3,1,TCGTTGTGTATAAAATTAAT,2,2092366
lacIp,1.0,2,1,TCGTCAATAGAAAGAACCGC,1,2091108
lacIp,1.0,2,1,TCGGGGATGCGAGCCAGCTC,1,2087694
lacIp,1.5,3,1,TCGCTAGCACATGGAGAGCT,2,2113276
lacIp,1.0,2,1,TCGCGTCGCCTAAGACCCAG,1,2099618
lacIp,3.0,6,1,TCGCCGGCTGGAATCGAGGA,5,2101783
lacIp,1.0,2,1,TCGCAAGCTGGTGGTTTCTA,1,2089573
lacIp,1.5,3,1,TCGACTGCCTGGCGTAGGCG,2,2103848
lacIp,1.0,2,1,TCGACTCCAACGAATAAAGA,1,2105374
lacIp,1.0,2,1,TCCGTCCGCAGAGGCACGCC,1,2121875
lacIp,1.0,2,1,TCCGCGCACTTGTGATAGTA,1,2096218
lacIp,1.0,2,1,TCCGCCAAGCCCAGTGAACC,1,2100384
lacIp,1.5,3,1,TCCGATGATCTTAAAAAATT,2,2090889
lacIp,1.5,3,1,TCCGAGTGGTGGTCTCGTTT,2,2121583
lacIp,1.0,2,1,TCCCTACATTCTCAAATTAC,1,2088191
lacIp,3.5,7,1,TCCCCACGCTGAACTCTCTC,6,2103685
lacIp,1.0,2,1,TCCACGCGGAAAATACGATG,1,2119038
lacIp,1.5,3,1,TCATGCAAATGTCATTAACG,2,2111014
lacIp,1.0,2,1,TCATAGGAACGCTACTGCAA,1,2093125
lacIp,1.0,2,1,TCATAGATACTAGGATTACG,1,2110708
lacIp,1.0,2,1,TCAGTGAAAGCATCAGCTCG,1,2097247
lacIp,1.0,2,1,TCAGCGCCTGGTGCAGATGA,1,2121105
lacIp,2.5,5,1,TCAGCACATTTCGTGATACC,4,2092758
lacIp,1.0,2,1,TCAGATTGACGACTCAGTAT,1,2113202
lacIp,2.0,4,1,TCACTAGCACGCAACGGGCT,3,2116120
lacIp,1.0,2,1,TCACCGACTGTACAAGTACG,1,2109088
lacIp,1.0,2,1,TCACAACTGCCTCCTGTCAT,1,2090858
lacIp,2.0,4,1,TATTCGAGCGAGCGGTGAAA,3,2099095
lacIp,1.0,2,1,TATTACCTACATTGGAAGTA,1,2116608
lacIp,1.5,3,1,TATGTAGTGGAGCTTCGACC,2,2094466
lacIp,1.0,2,1,TATGGGCTTAGAACCCTACG,1,2100966
lacIp,1.0,2,1,TATGGAAAGTTTATGCGTCT,1,2093953
lacIp,1.5,3,1,TATCTTTTCACGCGTATACA,2,2086486
lacIp,1.0,2,1,TATCCTGAGGTCTGACGTTT,1,2114580
lacIp,2.5,5,1,TATCACCATGACGAACACTG,4,2089450
lacIp,1.0,2,1,TATCAAAATGGTGGTCCGAG,1,2111582
lacIp,1.0,2,1,TATAGGGTAGGAAGGGGTGG,1,2115459
lacIp,2.5,5,1,TATAAATGGCTTATCCCAAC,4,2105457
lacIp,1.0,2,1,TAGGTTGAGTCAGCGGGCAA,1,2113510
lacIp,1.0,2,1,TAGGGTCTTGGTTAATGGGT,1,2089046
lacIp,2.0,4,1,TAGGCTAGGCTCCACGTAAC,3,2094211
lacIp,1.0,2,1,TAGGCCGTTTTCGTATGCAT,1,2092084
lacIp,1.0,2,1,TAGCTTATTTTGTAGACGCT,1,2114059
lacIp,1.0,2,1,TAGCGGCAGGTTGAGTTGCG,1,2087411
lacIp,1.5,3,1,TAGCCCAGGTTGGGGTATAA,2,2103950
lacIp,1.5,3,1,TAGAGATTTTCCGATATGTT,2,2093268
lacIp,1.0,2,1,TACTGATTGTTAATTCCTTT,1,2092685
lacIp,1.5,3,1,TACTAGGGGGAACTTTACAA,2,2100212
lacIp,1.0,2,1,TACTAATAGGCGCTGGGTTA,1,2121929
lacIp,1.0,2,1,TACGCACCTTGTACGATTCC,1,2115664
lacIp,1.5,3,1,TACGATGGGATTCAATGATC,2,2105930
lacIp,1.5,3,1,TACCTGGCACGCAAATGCTG,2,2118201
lacIp,1.0,2,1,TACAGCAGGGATGTGACCAC,1,2105177
lacIp,3.0,6,1,TAATGCATATAAAATTGCTG,5,2099498
lacIp,1.0,2,1,TAATCGGTACTCTCGACTAT,1,2106757
lacIp,1.0,2,1,TAATATCAACAATTGTTGTC,1,2122188
lacIp,1.5,3,1,TAAGTGCTTGAACATCCGGA,2,2099401
lacIp,3.5,7,1,TAAGGTCGTGGGTGTAAAAT,6,2107427
lacIp,1.0,2,1,TAACTACCTTGCGGTGGGTC,1,2089459
lacIp,1.0,2,1,TAAAGATAAGGCCCACAAAG,1,2090177
lacIp,1.5,3,1,TAAACGTAAATGAACGCGGA,2,2105358
lacIp,1.5,3,1,GTTTCTGCTCGGAACGTCTT,2,2112197
lacIp,1.0,2,1,GTTGTTCCTGGAGGGTGACG,1,2117845
lacIp,1.0,2,1,GTTGCGAGTCATTGGCTGCT,1,2087886
lacIp,1.0,2,1,GTTCTCGGATAAATTCGTCT,1,2117290
lacIp,1.0,2,1,GTTCATCGAGGAGGACCGCA,1,2105721
lacIp,1.0,2,1,GTTAGGAATACTAATTTTGG,1,2099170
lacIp,1.0,2,1,GTTACGGGTCGTGGTGGCTT,1,2098902
lacIp,1.0,2,1,GTGTCTTCGTCCGTCACGGT,1,2095592
lacIp,1.5,3,1,GTGTATATGCGTTAACATTT,2,2086760
lacIp,1.0,2,1,GTGGCTCGCCGTCGCCCGTA,1,2096467
lacIp,1.0,2,1,GTGGCATGAGGTATGCTCCC,1,2114910
lacIp,1.0,2,1,GTGGCAATCACGCACTAGCA,1,2112660
lacIp,1.0,2,1,GTGGAGGGCCTAACTGTACC,1,2115834
lacIp,1.0,2,1,GTGGAGATAATAGTTCCGCA,1,2106383
lacIp,2.5,5,1,GTGCCTCTATAGGTATTCCT,4,2113331
lacIp,1.0,2,1,GTGAGGGGATTGTGCGGCAT,1,2108658
lacIp,2.0,4,1,GTCTTTAGGGTTACTACGCT,3,2088169
lacIp,1.5,3,1,GTCTGTGCCACTCATACCTG,2,2104041
lacIp,1.0,2,1,GTCTGATTGTTGATGTAGAG,1,2089935
lacIp,1.5,3,1,GTCTCCGTCTGTTTGATCAA,2,2103378
lacIp,1.0,2,1,GTCTCCAAGATTAGAAATCT,1,2117459
lacIp,1.5,3,1,GTCTACGGCGCATAGGCTCA,2,2111560
lacIp,1.0,2,1,GTCTAAATCCTTTGGCCTCG,1,2094135
lacIp,1.5,3,1,GTCGTCCGGATACGGTAATA,2,2111631
lacIp,1.0,2,1,GTCGGTCAGCAATTTCGAAA,1,2098004
lacIp,2.0,4,1,GTCGCTCGCTCTCAAGTCCT,3,2098667
lacIp,1.0,2,1,GTCGCGCTTCTTTGGAAGCG,1,2104868
lacIp,1.0,2,1,GTCCTTTCTGTAAGAGGTCG,1,2100665
lacIp,1.0,2,1,GTCCTACCCTTGATAGCCAT,1,2087229
lacIp,1.0,2,1,GTCCATCTGTACCTTCTCTC,1,2100279
lacIp,1.0,2,1,GTCCAGTACAATGAGTCGTT,1,2110604
lacIp,1.5,3,1,GTCCACTACGGTGCGAAGAT,2,2111125
lacIp,1.0,2,1,GTCAAGCTCATTCTTCAAGC,1,2102959
lacIp,1.0,2,1,GTATTTGTCCTAAGTGCTAA,1,2091409
lacIp,1.5,3,1,GTATCCTGCGCAGAGATGTA,2,2110593
lacIp,1.0,2,1,GTAGTCATCGTTTATCGTGC,1,2120644
lacIp,1.0,2,1,GTAAACCTGGCTATTCGCAG,1,2110972
lacIp,1.0,2,1,GGTTTTAATTAGGTAGAGCG,1,2089286
lacIp,1.5,3,1,GGTTCGTATAGAAGTTGCTA,2,2101654
lacIp,1.0,2,1,GGTTCCTAACCGGTCGAGGT,1,2094874
lacIp,1.0,2,1,GGTTATAGCGGAATGCTGGA,1,2094162
lacIp,1.0,2,1,GGTGTTCCTGTCCGAAAAGG,1,2101433
lacIp,1.0,2,1,GGTGTCTGAATGCGGCCATT,1,2119289
lacIp,1.5,3,1,GGTGTATGGCACGGGTAAAA,2,2100326
lacIp,1.0,2,1,GGTGAGAAACGTAAACATTT,1,2088414
lacIp,1.5,3,1,GGTCCAGGCACGGCCTGGCT,2,2087415
lacIp,1.0,2,1,GGTATTTGCATTGATCATAC,1,2109720
lacIp,1.0,2,1,GGTATTTCCCTATTTGTCAT,1,2109421
lacIp,1.0,2,1,GGTATTACCCACATACCAAG,1,2102745
lacIp,1.5,3,1,GGTAGGGCTGAAGGCTATTT,2,2090485
lacIp,1.0,2,1,GGTAGCACACCCGTCCGATT,1,2092534
lacIp,1.0,2,1,GGTAAGGACTTTTGTCCGAT,1,2108875
lacIp,1.0,2,1,GGGTTTATTATGTCTCCGGG,1,2115092
lacIp,1.5,3,1,GGGTGTGGAATGGGAACGAT,2,2090452
lacIp,2.0,4,1,GGGTGGTAGTGTTTATTCCT,3,2118940
lacIp,1.0,2,1,GGGTCGCGCAGGCTGAACCT,1,2088426
lacIp,1.0,2,1,GGGGCACTACACGGAGTTTT,1,2121215
lacIp,1.0,2,1,GGGCGCCCAAACAAATCAGC,1,2095131
lacIp,1.5,3,1,GGGACTGCAGGCTTAGGATA,2,2115685
lacIp,1.0,2,1,GGGACGGGAGGATTCTTACG,1,2113329
lacIp,1.0,2,1,GGCTCATAAGAGACTGACCT,1,2121441
lacIp,1.0,2,1,GGCTAGTCTTCCATAAGGGA,1,2099535
lacIp,1.0,2,1,GGCTAAAGATGTTATGTATT,1,2106390
lacIp,1.5,3,1,GGCGTGTCGCACGCCTCATA,2,2090720
lacIp,2.5,5,1,GGCGCGTGGGGGAACGTCAA,4,2107626
lacIp,1.0,2,1,GGCGCATAGGGTGACGGAAG,1,2086776
lacIp,1.0,2,1,GGCCCTGTACGTGACTGTGC,1,2098856
lacIp,1.5,3,1,GGCCCGAAGCGTGCCGCAAA,2,2107023
lacIp,1.5,3,1,GGCCAATGTACGACCAGTTT,2,2116990
lacIp,1.0,2,1,GGCATACGTTCTTGTTTCGA,1,2097117
lacIp,1.5,3,1,GGCACTCGCTGTCCCCGAAT,2,2087329
lacIp,2.0,4,1,GGCACGACCTCAAGATCTTT,3,2087995
lacIp,1.0,2,1,GGCACAAAGCTCGGCGACTA,1,2117662
lacIp,2.5,5,1,GGATTAAGCGATAGGCGCCA,4,2096173
lacIp,1.5,3,1,GGATCATTAAAGGTACAGTT,2,2111126
lacIp,1.0,2,1,GGACGTAACTACGCAGAATG,1,2116533
lacIp,1.0,2,1,GGACACGCCATCTTCTTAAC,1,2097858
lacIp,1.0,2,1,GGAATTTATTTCGTGTGAAC,1,2091988
lacIp,1.5,3,1,GGAATTGGTCGGGTTCATAT,2,2119141
lacIp,1.0,2,1,GGAAATTTCGCGATGCCCCG,1,2089517
lacIp,1.0,2,1,GCTTATACGCAGTACAATCC,1,2102908
lacIp,1.0,2,1,GCTTAGGGGTAAAGAGAAGG,1,2092604
lacIp,1.0,2,1,GCTTAGACCGCTCGTGCGGA,1,2112370
lacIp,2.5,5,1,GCTGGGACTCGAGTGACGAA,4,2110314
lacIp,1.5,3,1,GCTGGCAAGGCCCACAAAGG,2,2098205
lacIp,1.5,3,1,GCTGAAGGATGCTGTCGTAA,2,2093658
lacIp,1.0,2,1,GCTCTCCAGTAGTGAGTGAT,1,2117158
lacIp,1.0,2,1,GCTCTCAGTTTCATTTAGGC,1,2094036
lacIp,1.0,2,1,GCTCGAGGCATCTCCTGCAG,1,2093367
lacIp,1.5,3,1,GCTATGGGTATTTGATCGAT,2,2118058
lacIp,1.5,3,1,GCTAGGGCGTACTATATAGA,2,2109185
lacIp,1.5,3,1,GCTAGAAAACACAATACTCA,2,2103822
lacIp,1.5,3,1,GCTAAATCATAGTGAATGCA,2,2109197
lacIp,1.5,3,1,GCGTGCTTCGCCTTTCCATC,2,2114678
lacIp,2.0,4,1,GCGTCACGGTTACCTCATGA,3,2111643
lacIp,1.0,2,1,GCGTATAAACAGGCAACGAG,1,2109574
lacIp,1.0,2,1,GCGTAGGAACATCGGCATGA,1,2088831
lacIp,1.5,3,1,GCGGGTGTCTGAATCGCCTA,2,2097750
lacIp,1.0,2,1,GCGGGAAACCTATTTGATGT,1,2092511
lacIp,1.0,2,1,GCGCTTCAAATGTACACCAA,1,2103438
lacIp,1.0,2,1,GCGCGGCCTGACTAATGGAT,1,2115588
lacIp,1.5,3,1,GCGCGCCGGGACCCGGAACT,2,2105501
lacIp,1.5,3,1,GCGACTTGATCGGGGGAAAG,2,2090647
lacIp,1.0,2,1,GCCTTTGGCAAAAGAGACAA,1,2098502
lacIp,1.0,2,1,GCCTCTGATAGTTGTTATTA,1,2088227
lacIp,3.0,6,1,GCCGTACCGTGCTTTGATGT,5,2116054
lacIp,1.5,3,1,GCCGGCATTAACGTGTTGTT,2,2105372
lacIp,1.0,2,1,GCCGATTATTGCTCGTCCAT,1,2100964
lacIp,1.0,2,1,GCCGAAGTGGTAGGTGTGGT,1,2099634
lacIp,1.0,2,1,GCCCTTACCAAACTGGGCAA,1,2116884
lacIp,1.0,2,1,GCCAGTCAACACGAACCCTC,1,2121697
lacIp,1.0,2,1,GCATGTGTGACATCGGCCTA,1,2093679
lacIp,2.0,4,1,GCATGGCTTCCAGCGAATGT,3,2096452
lacIp,1.5,3,1,GCATGCCGGACCGACGGGGG,2,2104457
lacIp,1.0,2,1,GCATGCACATTGTATTGATT,1,2111006
lacIp,2.0,4,1,GCATAGTGAGCCACTATCGC,3,2095285
lacIp,2.5,5,1,GCATAACTGCCGCACTAGGA,4,2118496
lacIp,2.5,5,1,GCAGCTGGTGAGCATTGCGA,4,2096307
lacIp,1.0,2,1,GCACTCTACAATGCCCCCCA,1,2103536
lacIp,1.5,3,1,GCACCTGCTTCGGCATCCCA,2,2103808
lacIp,1.0,2,1,GCAACTCCGGTCTCTAAGGC,1,2095266
lacIp,1.0,2,1,GCAACCTCATCTTCACCTCT,1,2093713
lacIp,1.0,2,1,GCAACATTCAAAACGATAAA,1,2115658
lacIp,1.0,2,1,GCAACATCTTATGGTATAAT,1,2099673
lacIp,1.5,3,1,GATTGTGTAAGTACCAGGAG,2,2107563
lacIp,1.0,2,1,GATTGACCTGGAGCGCGTTA,1,2099530
lacIp,1.0,2,1,GATTCTGCTAAGCAGGGAAG,1,2096913
lacIp,2.5,5,1,GATTACTAAGTGCGGAGTTG,4,2121531
lacIp,1.0,2,1,GATGTTAGGTCGCACGTCGT,1,2119104
lacIp,1.0,2,1,GATCTAGCTGGGCGCATCAT,1,2112937
lacIp,1.5,3,1,GATATTACTTTCAAATGGCG,2,2087027
lacIp,1.0,2,1,GATATAATATGAGTATGACA,1,2114708
lacIp,1.5,3,1,GATAGGGAGTCTTGCTTTGA,2,2115495
lacIp,1.0,2,1,GATAGGCCTCATAGCCAGTA,1,2098891
lacIp,1.0,2,1,GAGTGGTGCTGCAATCAGTA,1,2099666
lacIp,1.0,2,1,GAGTCAAACAGGAACTAAAC,1,2122225
lacIp,1.0,2,1,GAGGACGTCTAGAAGGAAGA,1,2116839
lacIp,1.5,3,1,GAGCGCATTGCATCGTGACT,2,2090033
lacIp,1.0,2,1,GAGCCGTACCTAACATAATC,1,2120416
lacIp,1.0,2,1,GAGCAACGGCAAGACGGCAT,1,2118844
lacIp,1.0,2,1,GAGATTTAGCCGTTGACACT,1,2088362
lacIp,1.0,2,1,GAGATACGGTGAGACACCAT,1,2093798
lacIp,2.5,5,1,GAGAGCATACTATCTAATTC,4,2107426
lacIp,1.0,2,1,GAGACATGCGGTTTCACTTC,1,2086355
lacIp,2.5,5,1,GACTTCCGCCCCTGTCGCTA,4,2108102
lacIp,2.0,4,1,GACTGTTTCCTACTTGCCCT,3,2099337
lacIp,1.5,3,1,GACTGCCAACGGAGTCTGCT,2,2087342
lacIp,2.0,4,1,GACTGAGGTGGCCCGCGCAA,3,2120352
lacIp,1.5,3,1,GACGGGTACACATCGCGCTT,2,2106502
lacIp,1.5,3,1,GACGCATGGAGCCAGCACCA,2,2102378
lacIp,1.0,2,1,GACGATATCTTTATCAGGAT,1,2088256
lacIp,1.0,2,1,GACGAGTGGTTATGACGGCG,1,2092394
lacIp,1.0,2,1,GACCTGTATCGCGACGGATA,1,2103917
lacIp,2.0,4,1,GACCAACGAACAGCAGCTCA,3,2099369
lacIp,5.0,10,1,GACACAGAATCCGATCTTCC,9,2111553
lacIp,1.0,2,1,GACAACAACCTCCACCGGAG,1,2118151
lacIp,2.5,5,1,GAATCTGTAAGGTCCTAAAA,4,2089383
lacIp,2.0,4,1,GAATCGTTATATGAGTAGTA,3,2101594
lacIp,1.0,2,1,GAATCCGTAGAACGATGGCA,1,2108065
lacIp,3.0,6,1,GAATATGGACGTATCTGGGA,5,2091084
lacIp,2.0,4,1,GAAGTAAAAGTCTGCTGTGT,3,2088413
lacIp,1.0,2,1,GAAGGGCGGCGCAGAATCCC,1,2111768
lacIp,1.0,2,1,GAAGAAGGCGATCCTCGAGC,1,2086693
lacIp,1.0,2,1,GAAGAACTAATAGGCACTAC,1,2110939
lacIp,2.0,4,1,GAAGAACGGCTCTCAAATCA,3,2115113
lacIp,1.0,2,1,GAAAAGCATTTAGGTCCCAA,1,2106125
lacIp,1.5,3,1,CTTTGCCGTGTCGCTAGTAT,2,2106779
lacIp,1.0,2,1,CTTGGTAATGAGATTGGAAT,1,2095225
lacIp,1.0,2,1,CTTGCTTTCTACTGTGATTA,1,2104482
lacIp,1.5,3,1,CTTGCTAGGGTATGCATAGA,2,2118131
lacIp,1.0,2,1,CTTCTCGACTTCGTAGGAGG,1,2097092
lacIp,1.0,2,1,CTTCATAAGGAGTTTCTGTG,1,2105859
lacIp,1.5,3,1,CTTCAACAGATTCACTATTT,2,2088719
lacIp,1.0,2,1,CTTATCTTAAGCCACTATAG,1,2115723
lacIp,1.0,2,1,CTTACGTGGGCGAATTTTGT,1,2112054
lacIp,1.5,3,1,CTGGTTGTCATGAAATCAGG,2,2103209
lacIp,1.5,3,1,CTGGGTCCATCTACCAGGCG,2,2086292
lacIp,1.0,2,1,CTGGACCGGTACTATTTGAT,1,2092778
lacIp,2.0,4,1,CTGCGTCCCCACGGTCGTAT,3,2098044
lacIp,1.0,2,1,CTGCGAGGATGCACAAATTT,1,2087748
lacIp,1.0,2,1,CTGCAAAAATCAAGACTTAT,1,2096327
lacIp,1.0,2,1,CTGAGTACAGCGGGTCTACA,1,2101483
lacIp,1.0,2,1,CTGACGGGTCGGTAGGCGCT,1,2106997
lacIp,1.0,2,1,CTCTTTACGTTTCACAGCAT,1,2096952
lacIp,1.0,2,1,CTCTAGCTAAAATCCATTTC,1,2103900
lacIp,1.0,2,1,CTCGTTTCTGGTCAAGCCCG,1,2102615
lacIp,1.5,3,1,CTCGTATAAACCTGGGATAA,2,2103247
lacIp,1.0,2,1,CTCGCTCACTATGGGCCGGG,1,2102053
lacIp,1.0,2,1,CTCGATTCACTACATGAGAA,1,2106253
lacIp,1.0,2,1,CTCCCATAATATGCGTGGCT,1,2105386
lacIp,1.5,3,1,CTCATTATAGTATTAATTCT,2,2096817
lacIp,1.5,3,1,CTATGGCTGTTAATGACCTT,2,2088148
lacIp,1.0,2,1,CTATGCGGGTCCGTATGGTG,1,2108165
lacIp,1.5,3,1,CTATCCTTGGTGGCCATCTC,2,2120353
lacIp,1.0,2,1,CTAGCGAAATCCTCACGCAA,1,2088999
lacIp,1.5,3,1,CTAGATAACTAACAAGTCCT,2,2095987
lacIp,2.0,4,1,CTACGTTTACCAGCTCCTCC,3,2102200
lacIp,2.5,5,1,CTACGTACTCATACTGCAGC,4,2104454
lacIp,1.5,3,1,CTACGGTAATTACCACCCTA,2,2087413
lacIp,1.5,3,1,CTACAACCGCACGTTCCTCT,2,2115873
lacIp,1.5,3,1,CTAACCTGTGCGTTCCGTGT,2,2096990
lacIp,1.0,2,1,CGTTCGATTGGGCCTAGACT,1,2110213
lacIp,1.5,3,1,CGTTCCTAGGGTCTGGGGTA,2,2105490
lacIp,2.0,4,1,CGTTCATACTCGCCGTCTGA,3,2120067
lacIp,2.0,4,1,CGTGTGTCTATATCGCGCCC,3,2113114
lacIp,1.5,3,1,CGTGTACAGGATTCTCCGGT,2,2098959
lacIp,1.5,3,1,CGTGGTTTCTTTCTTGTGAA,2,2093253
lacIp,1.0,2,1,CGTGGTATGGTGAGCATGGG,1,2095170
lacIp,1.5,3,1,CGTGGGTGATAGAACTTAAA,2,2089331
lacIp,1.0,2,1,CGTGAGAATAGGGAATGACG,1,2117504
lacIp,1.0,2,1,CGTGAAGGCCCGCCACAAGT,1,2114796
lacIp,1.5,3,1,CGTCCGTTCACCAATTAGGG,2,2114033
lacIp,1.0,2,1,CGTCAGGAATAACGGGTCTT,1,2122118
lacIp,1.5,3,1,CGTATTCATCAACTCGCTGT,2,2109934
lacIp,1.5,3,1,CGTAAGTCTTTGCGCTTCCG,2,2089934
lacIp,2.0,4,1,CGGTTTCACCCCGAAGCCAT,3,2102715
lacIp,1.5,3,1,CGGGGGTAAGCTTTCCCTAT,2,2098318
lacIp,1.5,3,1,CGGGCGTGTTGAGGATTCGT,2,2090190
lacIp,1.0,2,1,CGGGCGCACAGGGGGATGCA,1,2095684
lacIp,1.5,3,1,CGGGCCTCGGACGCAGGATG,2,2103142
lacIp,1.0,2,1,CGGAGATCGTTTCCGGTTAA,1,2096713
lacIp,1.5,3,1,CGGACGTTAAGTACAAAGGT,2,2097676
lacIp,1.0,2,1,CGGAACATGTGACATTTACA,1,2104328
lacIp,1.5,3,1,CGCTCAGACAACCTCACCTT,2,2097129
lacIp,1.0,2,1,CGCTATCTAGATTTCAGAGC,1,2098579
lacIp,1.5,3,1,CGCGTCTATGTCTTTTGATG,2,2096195
lacIp,1.0,2,1,CGCGATTCGTATGGCTCTCC,1,2105664
lacIp,1.5,3,1,CGCGATAATCGGATGGCGGT,2,2104133
lacIp,1.5,3,1,CGCCTCGAGAAAAGCTGCAA,2,2107582
lacIp,1.0,2,1,CGCCGAGATCAAGTCTAGGG,1,2102328
lacIp,2.0,4,1,CGCCAACCAAAGGACGTTCT,3,2092220
lacIp,1.0,2,1,CGCATAGGATGGGTAGAAAA,1,2116866
lacIp,1.0,2,1,CGCAGTAATGAAGTCTCGGT,1,2095971
lacIp,1.5,3,1,CGCACGTGGAATCACAGTAC,2,2100591
lacIp,2.0,4,1,CGATTTGTCGATAAACGGAC,3,2101095
lacIp,1.0,2,1,CGATGCCAAGAGAGTCGCAT,1,2093413
lacIp,1.5,3,1,CGATCCCGAGCTGGGCTCTT,2,2100232
lacIp,2.0,4,1,CGATCATGAGCAGCGGTGAT,3,2095875
lacIp,1.0,2,1,CGATATATACGGAGCACACT,1,2089329
lacIp,1.0,2,1,CGAGGGATTTTACTGGAACA,1,2101947
lacIp,2.5,5,1,CGAGCTCACAGTGCTACCCT,4,2112597
lacIp,2.0,4,1,CGAGATTTAGGGTATAGTTA,3,2098175
lacIp,1.0,2,1,CCTTTGACTGTTACAGCATT,1,2115758
lacIp,2.0,4,1,CCTTGGGTCAATACTCCCTG,3,2114348
lacIp,1.5,3,1,CCTTCATATAAGCGGTCACC,2,2104975
lacIp,2.0,4,1,CCTGTTGAACGTTCTGTCTT,3,2105971
lacIp,1.0,2,1,CCTGGTCAACAAGGGAATAG,1,2090886
lacIp,1.0,2,1,CCTGCGATCTGGGCACGAGA,1,2109524
lacIp,1.5,3,1,CCTGCCATGCAACAATTCGT,2,2090649
lacIp,1.0,2,1,CCTGCAGATACCGCTATAAC,1,2110034
lacIp,1.0,2,1,CCTGAGTTTGTCGTCAGGAC,1,2117935
lacIp,1.5,3,1,CCTCCATTTGCTTTGCACGT,2,2117681
lacIp,1.0,2,1,CCTATCCCGCTGGGAAAAGG,1,2087902
lacIp,1.5,3,1,CCTAGTGCCGTATGATTGTT,2,2115431
lacIp,1.0,2,1,CCTAAAAAACGCTGTCCACC,1,2120719
lacIp,2.0,4,1,CCGTTTTGGCTTGTAACCGA,3,2101329
lacIp,1.0,2,1,CCGTTGACGACAATCCCTAA,1,2098117
lacIp,1.0,2,1,CCGTTCGGAATGTGAGGGGT,1,2103498
lacIp,1.0,2,1,CCGTTCACTACACTGTGAGA,1,2090942
lacIp,1.5,3,1,CCGGGTACGATCCTACTCAC,2,2106648
lacIp,2.5,5,1,CCGGGGCTGGCAGCTCGAGC,4,2107439
lacIp,1.5,3,1,CCGGACGTTTGTATATGCCT,2,2090521
lacIp,1.0,2,1,CCGGACCTCCTGTTCTCCCA,1,2093474
lacIp,1.0,2,1,CCGCGCATAATCAGGTTAGT,1,2104350
lacIp,2.0,4,1,CCGCGATCACTTCGGATTGA,3,2088175
lacIp,2.0,4,1,CCGCAGTGATTGAGCAGTCG,3,2088791
lacIp,1.0,2,1,CCGATCCAACACTACGTTCA,1,2120517
lacIp,1.0,2,1,CCGATATGCCACAAACGGCC,1,2120947
lacIp,1.5,3,1,CCGATAGCTGTGCGCGTACG,2,2100554
lacIp,1.5,3,1,CCGAACCCTAGTTCGGTCAC,2,2092273
lacIp,1.0,2,1,CCCTTTATGATGGTCATATC,1,2111639
lacIp,1.5,3,1,CCCTGTCTACTTTGTCGCAG,2,2110683
lacIp,1.0,2,1,CCCTGCATGTCGCGTCTCCA,1,2089472
lacIp,1.0,2,1,CCCGCGTCAATATGACAGAG,1,2102334
lacIp,1.5,3,1,CCCCGTTCGGCAAAATTCAT,2,2096356
lacIp,1.0,2,1,CCCCCCTGATGTGGTGCTAA,1,2113467
lacIp,1.5,3,1,CCCCATCGGAGTGGAGCAAA,2,2104802
lacIp,2.0,4,1,CCCACCAATTCGAAGAAGCT,3,2088643
lacIp,1.5,3,1,CCCACAGGAAACGCACCTCC,2,2101386
lacIp,1.0,2,1,CCCACACCTAAATGTGAACA,1,2113800
lacIp,1.5,3,1,CCATTGGCTGGCCTAAGGCT,2,2113289
lacIp,1.5,3,1,CCATGCTTTCATTTTTCTTA,2,2115035
lacIp,1.0,2,1,CCAGCTTAGGATGACATGGG,1,2101338
lacIp,1.0,2,1,CCAGAGAGAAAACAGTTTAT,1,2122011
lacIp,2.0,4,1,CCACTGAGCCGCATGCTAAG,3,2089534
lacIp,1.0,2,1,CCACCAAGAGGGGTTTAAGT,1,2110360
lacIp,1.0,2,1,CCAAGGGGCACGAGCACCCT,1,2110777
lacIp,1.0,2,1,CCAAAGGGTCCAGGGCTTGA,1,2105795
lacIp,1.0,2,1,CATTTCGTACTCGTATTAGT,1,2110919
lacIp,2.0,4,1,CATTGCAGGGGGTAAAACGT,3,2098958
lacIp,1.0,2,1,CATTGACGGGGAGGCTGGAC,1,2089249
lacIp,1.0,2,1,CATGTCTGAATGCGAAGGGT,1,2108593
lacIp,1.0,2,1,CATGTACGATAATAACTAAT,1,2118097
lacIp,1.5,3,1,CATGGCTCACTCTAAAAAAA,2,2105820
lacIp,1.0,2,1,CATGCGATCGTGGAGGACGA,1,2099766
lacIp,1.5,3,1,CATGCATTTTCCCTTTTTTA,2,2087929
lacIp,1.0,2,1,CATCTCACTTAGCCACCACA,1,2114028
lacIp,1.0,2,1,CATCTAATTTACTTAGTTAG,1,2086724
lacIp,1.5,3,1,CATCGCCGGAGTTGTGTCCG,2,2100905
lacIp,1.0,2,1,CATCCAACCCGGCCGAGTGT,1,2100750
lacIp,1.0,2,1,CATATTATTTGTTTGTACTG,1,2106006
lacIp,1.0,2,1,CATACACGCACGTGCACCAA,1,2109226
lacIp,1.5,3,1,CAGTTCCCAGATCAGGAACT,2,2095376
lacIp,1.0,2,1,CAGGTAACTGGGGTCCGGTG,1,2096800
lacIp,2.5,5,1,CAGAAAAAGGGATCTCGGTA,4,2109098
lacIp,1.0,2,1,CACGTCAACGGAGAAACTCC,1,2105411
lacIp,1.0,2,1,CACGGCGAGTTAAAATTCGA,1,2095814
lacIp,2.0,4,1,CACGCTCAGCCCGGCCTCAT,3,2091264
lacIp,1.0,2,1,CACGCTATGGAGTTGCAGGG,1,2089971
lacIp,1.0,2,1,CACGCACTGGCCGACGCCGC,1,2111601
lacIp,1.0,2,1,CACGAGAGTGCAGAAAAGAT,1,2085756
lacIp,1.0,2,1,CACCGGTTTAACTTACCTGT,1,2088195
lacIp,1.0,2,1,CACCGGCTTGCTTAGATCAT,1,2096282
lacIp,2.0,4,1,CACAGTACAAGTTGGTAGGA,3,2095963
lacIp,1.0,2,1,CACACGTATGTCACGGTACA,1,2092216
lacIp,2.0,4,1,CAATTTGGGCACTAGCGTTT,3,2093265
lacIp,1.0,2,1,CAATGTCGGTCTGATGACGC,1,2108515
lacIp,1.5,3,1,CAAGCAGGAAGGGGTAAGAA,2,2092991
lacIp,1.0,2,1,CAACCTTATTGGCCAGCGAC,1,2115188
lacIp,1.0,2,1,CAAAGACCAAGGTTTTATTG,1,2112265
lacIp,1.0,2,1,CAAACAAGTAAAATAGACAA,1,2096746
lacIp,1.5,3,1,ATTGTTCTCAACGATACGGT,2,2101356
lacIp,1.0,2,1,ATTGGAAGGAGGAGGGACGA,1,2103338
lacIp,1.5,3,1,ATTCGACGTGGTGTCGCTGA,2,2107374
lacIp,1.0,2,1,ATTCACAGAAACCTGGCGTC,1,2106963
lacIp,1.0,2,1,ATTAACCTAACCCGCCAGTA,1,2118827
lacIp,1.0,2,1,ATGTCGCTATAAAAGGTATC,1,2098762
lacIp,1.5,3,1,ATGTCCCGGCCGTCGTCGTT,2,2099341
lacIp,2.0,4,1,ATGTAGACAATGCTCAAATG,3,2086910
lacIp,1.0,2,1,ATGGTGAGGTAGTGTAATTA,1,2086722
lacIp,1.5,3,1,ATGGCTCCTTGACGAGACCT,2,2121949
lacIp,1.0,2,1,ATGGAACCCTACGCTCGGTA,1,2107407
lacIp,1.5,3,1,ATGCGTATCCACTCCTCGCG,2,2116558
lacIp,1.0,2,1,ATGCCTTTCAAGTGATGCAG,1,2114706
lacIp,1.0,2,1,ATCTTTGCGGTGAGCTCTTG,1,2106431
lacIp,1.0,2,1,ATCTACTGATCTACAGCGTG,1,2096653
lacIp,1.0,2,1,ATCTAAGAGTCGTAACACCT,1,2100265
lacIp,1.0,2,1,ATCGTTTTGTAGCAACATGG,1,2092681
lacIp,1.0,2,1,ATCGGCCTACGGTCTCTTGA,1,2097057
lacIp,1.0,2,1,ATCGGCAGCTGAGACAAGCT,1,2103148
lacIp,1.0,2,1,ATCCTAGTGAGCTTTGGCCA,1,2110473
lacIp,2.0,4,1,ATCCCGCCCAGATGCCTTTG,3,2091333
lacIp,2.0,4,1,ATCCCCGTAGCGCATTGAAT,3,2105449
lacIp,2.0,4,1,ATCATCGACTTCTTGTCCGT,3,2114218
lacIp,1.5,3,1,ATCACGGTTGAATTGAAGTC,2,2097094
lacIp,1.0,2,1,ATATCCACTCTTAGGGAAGG,1,2117888
lacIp,1.0,2,1,ATATAAACGGCCGCAACTTA,1,2102350
lacIp,1.5,3,1,ATAGTCTAGCTTGAGGCGGG,2,2092780
lacIp,1.5,3,1,ATAGTCCAATTCGCTGCCCT,2,2105739
lacIp,1.5,3,1,ATAGTACGTCGGTCCACTTC,2,2119807
lacIp,1.0,2,1,ATACCCTCTTATGGTGGTTT,1,2094749
lacIp,1.0,2,1,ATAACGCGGACGTCGTGAAC,1,2099809
lacIp,1.5,3,1,ATAAACAGTTAAGGATGTCA,2,2104553
lacIp,1.5,3,1,AGTTGCGCTGCTTCGTTCAC,2,2087374
lacIp,1.0,2,1,AGTTCTTAACACGAGATGTA,1,2099054
lacIp,1.5,3,1,AGTGTTCATGGACAACGTAT,2,2105035
lacIp,2.5,5,1,AGTGTAACAAGTACAGGTTC,4,2110868
lacIp,1.0,2,1,AGTGCACATTTACATTCGTG,1,2105630
lacIp,1.5,3,1,AGTCCGGGTCCCTGTCGGGT,2,2096136
lacIp,1.0,2,1,AGTCCGCGTCCAGTATGCTT,1,2092247
lacIp,2.0,4,1,AGTAAATTCGTTAGGATCCT,3,2086806
lacIp,2.5,5,1,AGTAAACGCGCTATAAAAGC,4,2114467
lacIp,1.0,2,1,AGGTTTGTCCTCCATCCATA,1,2090531
lacIp,1.5,3,1,AGGTGGCATTCGCATTTGCC,2,2107978
lacIp,1.0,2,1,AGGTCTGTAGCCGTAGTCTT,1,2119785
lacIp,4.0,8,1,AGGTATTTCAGGACACGGAC,7,2088447
lacIp,1.5,3,1,AGGGTGTCTCCGCACCCGGA,2,2118065
lacIp,2.5,5,1,AGGGGGTGCATCCCATCAAA,4,2107429
lacIp,1.0,2,1,AGGGGCTGCATTGCGGCAGG,1,2119522
lacIp,2.0,4,1,AGGGCGGACGTTAACCGCCA,3,2107181
lacIp,1.5,3,1,AGGGACGAGCAGATTCAAAG,2,2112401
lacIp,1.0,2,1,AGGCTTAGGGTCAAATCTTA,1,2095136
lacIp,1.0,2,1,AGGCTAGCTATCTCAACGTT,1,2106196
lacIp,2.0,4,1,AGGCTAGCTACCCTTATCGC,3,2115964
lacIp,1.5,3,1,AGGCCCGGCAATTTCTAGCC,2,2090568
lacIp,1.0,2,1,AGGATGTGGTGGCTCGAACG,1,2089589
lacIp,1.0,2,1,AGGATACAGCAGCGATTCTT,1,2106742
lacIp,1.5,3,1,AGGACAAGCATCCGCCCAAG,2,2091612
lacIp,1.5,3,1,AGGAACAGTTCCGTTGTTGT,2,2099223
lacIp,1.5,3,1,AGCTTGCGTCTCCAAGGCGA,2,2115890
lacIp,1.0,2,1,AGCTTGAGTGGTTCCTTGCG,1,2089921
lacIp,1.0,2,1,AGCTGCATTTAACAGGCGAT,1,2112433
lacIp,2.0,4,1,AGCTGCACACCGTCTTACTA,3,2118904
lacIp,1.0,2,1,AGCTCGATTGAGTTAATTTA,1,2113753
lacIp,1.0,2,1,AGCTAAGCGGAGCGCACGCC,1,2117735
lacIp,1.0,2,1,AGCGTGCCGGGCGCCATGAG,1,2118077
lacIp,2.0,4,1,AGCGGTCAGCACCAGTTCTA,3,2109714
lacIp,1.5,3,1,AGCGCTTCGTATTGTCACTA,2,2088927
lacIp,1.0,2,1,AGCGCAGTCGTGATCGGATA,1,2103409
lacIp,1.0,2,1,AGCGACCGAATCTTGTAGGC,1,2089842
lacIp,1.0,2,1,AGCCTAGTGCCCCTGAGGGG,1,2110893
lacIp,1.5,3,1,AGCCGGGAACAATTCATTCT,2,2102122
lacIp,2.0,4,1,AGCCGCGGTACTGGGTCCCA,3,2114962
lacIp,1.0,2,1,AGCCCTCTGGATGAGTAAAT,1,2090857
lacIp,1.0,2,1,AGCCCAACGGAGAAAACTCC,1,2101695
lacIp,1.5,3,1,AGCATCCGGCCGGATCATTG,2,2085791
lacIp,1.0,2,1,AGCAGGGTTCATGACCGGAG,1,2085883
lacIp,2.0,4,1,AGCAAGCCATCGACGAATTG,3,2098711
lacIp,1.0,2,1,AGATCTTTTAACACGGCCAT,1,2098782
lacIp,2.0,4,1,AGAGCAGCACTATACGGGCT,3,2086298
lacIp,1.5,3,1,AGACGCAGGCAGCGGAAACT,2,2104309
lacIp,1.0,2,1,AGACCGGCTACTCGCCCTTT,1,2103929
lacIp,1.0,2,1,AGACCAGTGTTAGCGGAGTA,1,2105875
lacIp,1.0,2,1,AGAATTCCGCTACTTTGGTA,1,2111058
lacIp,1.0,2,1,AGAACTTGAGAATAGTTACA,1,2095382
lacIp,1.5,3,1,AGAACGTCGATGGCAGAGCA,2,2102384
lacIp,1.5,3,1,AGAACGAAGAATTTGCTGAC,2,2098580
lacIp,1.0,2,1,AGAAAAAGAGTAGCATTTCT,1,2105678
lacIp,1.0,2,1,ACTTGTCGAGCATTCGTACG,1,2089471
lacIp,2.0,4,1,ACTTGCTTCTTCTATCGGAC,3,2106242
lacIp,1.0,2,1,ACTTGAATGGAACAGTCGAT,1,2097059
lacIp,1.0,2,1,ACTTCGCCTGAAGTGCGTGT,1,2107143
lacIp,1.0,2,1,ACTGTAAGTGATACTAATGC,1,2103894
lacIp,1.0,2,1,ACTGCAGCGGCTAAAGCCGC,1,2106306
lacIp,1.0,2,1,ACTGAATCACACACCTCAGA,1,2109007
lacIp,1.0,2,1,ACTCTGAAACTTTCCGTTGA,1,2094662
lacIp,1.0,2,1,ACTCGATCAGTCAACGTAAT,1,2104497
lacIp,1.0,2,1,ACTCCGGGAGTCCAGCACAA,1,2114092
lacIp,1.5,3,1,ACTCCCATAGTCCGACAGAT,2,2090987
lacIp,1.5,3,1,ACTAGGTCCGCGGTCCACTA,2,2086042
lacIp,1.5,3,1,ACTACGAACTTCTGTATCAC,2,2092733
lacIp,1.0,2,1,ACTACAAACGCTGAATGCGC,1,2094324
lacIp,1.0,2,1,ACGTTTTGTGTCGATTCCGC,1,2109901
lacIp,2.0,4,1,ACGTTACAAGATATCTGTGA,3,2110292
lacIp,1.0,2,1,ACGTTAATGAGCGTTGGCTA,1,2106788
lacIp,2.5,5,1,ACGGACATTCTTCGCACAAT,4,2100621
lacIp,1.0,2,1,ACGGAAATCTCAAGACATTG,1,2088387
lacIp,1.5,3,1,ACGGAAAGATTGCGTAGTCT,2,2120585
lacIp,1.5,3,1,ACGCTGCACAGATATCGCTC,2,2113815
lacIp,1.0,2,1,ACGCAGGCACTTGATATTTA,1,2086249
lacIp,1.5,3,1,ACGCAAACCGGCAGATATAT,2,2096305
lacIp,1.5,3,1,ACGATCTTCGAGTCCAGAGA,2,2100646
lacIp,1.0,2,1,ACCTCCGGTTTCAACGGACG,1,2093150
lacIp,1.0,2,1,ACCGTCCTGGTATCCGGTTG,1,2087283
lacIp,1.0,2,1,ACCGTAGGAAAGCACCCCAC,1,2093178
lacIp,2.0,4,1,ACCGCCGACCGTCTGCAGGA,3,2097445
lacIp,1.5,3,1,ACCCATCTACATTTTGTATA,2,2112487
lacIp,1.0,2,1,ACCCAACGGGAAGCGATTGG,1,2089859
lacIp,1.5,3,1,ACCATGAAATGAATGGCCCA,2,2088739
lacIp,1.0,2,1,ACCAGTCTGTTGCCTGGTGG,1,2105897
lacIp,3.0,6,1,ACCACCTCAATCCCCTACGA,5,2106192
lacIp,1.0,2,1,ACATTCATACATGCCCGGGA,1,2092684
lacIp,1.0,2,1,ACATGAGTTGTCGGTGGTGA,1,2087961
lacIp,1.0,2,1,ACATACCCCAGCTGTTTTTT,1,2098840
lacIp,1.0,2,1,ACAGATAACGGGGCCTAGAC,1,2099646
lacIp,1.0,2,1,ACAGAGCTCGCGATGCGAGA,1,2108831
lacIp,1.0,2,1,ACACTAATACCCGTGCCACA,1,2118290
lacIp,1.0,2,1,ACACGGTGACAGGCAAGTTA,1,2115799
lacIp,1.5,3,1,ACACATTGGTTTGGCAAGTC,2,2102872
lacIp,1.5,3,1,ACACATGATCAGGATAGAGG,2,2087056
lacIp,1.0,2,1,ACACACTTCTAGTAGGGTGT,1,2096149
lacIp,1.5,3,1,ACAATGCGATAGTAGTCAAC,2,2087334
lacIp,2.5,5,1,ACAATGCGACCCTTCTAGCA,4,2089581
lacIp,2.0,4,1,ACAATCACACTCTCCAATTT,3,2089726
lacIp,1.0,2,1,AATTTTGTGTATGTCAGAGA,1,2092181
lacIp,1.0,2,1,AATTGTAAGGGACTTCACAG,1,2109772
lacIp,1.0,2,1,AATTGGCGTGATTCCACATG,1,2099008
lacIp,1.0,2,1,AATTAGCAAAGGTTGTGTCC,1,2100937
lacIp,2.0,4,1,AATTACAGGGCCATGTCAAA,3,2108271
lacIp,2.0,4,1,AATGTGAATAAGCAGAACCT,3,2087669
lacIp,2.0,4,1,AATCCGACCAGGCCTGGGCA,3,2115945
lacIp,1.0,2,1,AATAAGACTCCGAAGATAAG,1,2090441
lacIp,1.0,2,1,AAGTTTATTTGAGTACTTAG,1,2087066
lacIp,1.5,3,1,AAGTTCCTCAAGTGCGCGGG,2,2099986
lacIp,1.0,2,1,AAGTGTAACTTTGTGATGTA,1,2101077
lacIp,1.0,2,1,AAGTGGGCGTAGACAATACT,1,2119635
lacIp,1.5,3,1,AAGTGCCTCTGTGCTGTTTT,2,2097534
lacIp,1.0,2,1,AAGTAGGCGTCATACTCTAG,1,2091298
lacIp,1.0,2,1,AAGGTAAATTCCATGGTTGA,1,2099497
lacIp,1.0,2,1,AAGGGCGAGCTATGTCACTT,1,2110782
lacIp,1.0,2,1,AAGCGTAAACCGTAGCGATT,1,2093527
lacIp,1.0,2,1,AAGAGCTGCCAGCTGTGGAC,1,2119398
lacIp,1.0,2,1,AAGACCGTCGCAGTCGGACA,1,2115178
lacIp,1.0,2,1,AACTTGTTAGCTACTAGGAC,1,2115529
lacIp,1.0,2,1,AACTTGATAGATTATTTGCC,1,2112123
lacIp,1.0,2,1,AACTCTGCATCACCTGAGGC,1,2096244
lacIp,1.0,2,1,AACTCTAGATTCATAGATTT,1,2119587
lacIp,1.5,3,1,AACTACACTAAAAGGCATAT,2,2097968
lacIp,1.0,2,1,AACGTCTTCATGGTGTCTGC,1,2120332
lacIp,1.5,3,1,AACGGGGCACTCTGAGATGA,2,2113667
lacIp,1.5,3,1,AACCCTCGATCCCGAGAGTT,2,2100525
lacIp,1.0,2,1,AACCCCGGTATCGTCATGGG,1,2100834
lacIp,1.0,2,1,AACCAGCTTAGGAGGACCTA,1,2096306
lacIp,1.0,2,1,AACATCTCAGTAAAGACTGA,1,2107966
lacIp,1.0,2,1,AACACTGCATATCCCCAACT,1,2111021
lacIp,1.0,2,1,AACAAAACGAGCCCGTGGGA,1,2117698
lacIp,1.0,2,1,AAATTGCTATCTAGTCTCAT,1,2093350
lacIp,1.0,2,1,AAAGGCGGGGAGACAATAGC,1,2089598
lacIp,1.0,2,1,AAAAGACTTCTGTGGAGGGT,1,2102632
lacIp,0.1111111111111111,8,8,TGGGATCAGAAGTGACCCCA,0,2086482
lacIp,0.1111111111111111,8,8,CTTTCTGTATGCCTTTTCAG,0,2093526
lacIp,0.1111111111111111,8,8,CTTGAATAGCTTAACGTTGT,0,2106523
lacIp,0.125,7,7,GTGCCCGCAGTTAAACGCAG,0,2088944
lacIp,0.125,7,7,ATCGAAGCAGGGCCTAAGGT,0,2094564
lacIp,0.14285714285714285,6,6,TGCTGCTGAGTCGAAAATAT,0,2100791
lacIp,0.14285714285714285,6,6,TCTGCGCTGGTGTATCACTA,0,2099224
lacIp,0.14285714285714285,6,6,TCGTTGAGACCTAGGGTCCT,0,2091494
lacIp,0.14285714285714285,6,6,GTGGCAAGTATCGAGTCCGA,0,2094288
lacIp,0.14285714285714285,6,6,GATAACGGGGCAGTTATGCC,0,2115929
lacIp,0.14285714285714285,6,6,CTTACCTGCTTCAGATTATG,0,2102329
lacIp,0.14285714285714285,6,6,CATGTTATAGAGAATAAGCA,0,2113112
lacIp,0.14285714285714285,6,6,ATGCGAATTATCCAAGGAAC,0,2105246
lacIp,0.14285714285714285,6,6,AGGCGCGTCAAAGGGCGGGT,0,2113691
lacIp,0.16666666666666666,5,5,TTTCTAGAGAGTCAAATGAT,0,2092272
lacIp,0.16666666666666666,5,5,TGCCAGAGCTTGAGGTTCTT,0,2108901
lacIp,0.16666666666666666,5,5,GTATGTGATCGCTGCATCGA,0,2092168
lacIp,0.16666666666666666,5,5,GGCGTAGCATGGGGGGACGA,0,2100218
lacIp,0.16666666666666666,5,5,GGCGAAGCGTTAGGTGCTGG,0,2092391
lacIp,0.16666666666666666,5,5,GGCAGTTATATTAGGCGTAC,0,2096752
lacIp,0.16666666666666666,5,5,GCGCCCCAGTATTGTTCGGT,0,2089518
lacIp,0.16666666666666666,5,5,GACACTGAGTATCTCCACAT,0,2091648
lacIp,0.16666666666666666,5,5,CTCGACCAACCTTTGGATCG,0,2087966
lacIp,0.16666666666666666,5,5,CGTTAACTGGACCTAGGCAT,0,2088408
lacIp,0.16666666666666666,5,5,AGTACCCAGACACCCCCATA,0,2087272
lacIp,0.16666666666666666,5,5,AGGGTGGCCCGGCGCAGTTA,0,2087524
lacIp,0.16666666666666666,5,5,AGCGGGTGGATGGTTGGTAC,0,2120817
lacIp,0.16666666666666666,5,5,AGCGACCGATGGCGTCGGAG,0,2094813
lacIp,0.16666666666666666,5,5,AGCAATGGGGGGTCTTGTAT,0,2113302
lacIp,0.16666666666666666,5,5,AATACTTCCATAGAGGCGAT,0,2108441
lacIp,0.2,4,4,TTTTTCTTATCTGTCCTACT,0,2101131
lacIp,0.2,4,4,TTTCCTACAAGTCACCTGAT,0,2094448
lacIp,0.2,4,4,TTTAGCTCGAAACTGGGGGG,0,2105187
lacIp,0.2,4,4,TTGCAAGCAGATGCCTGCAA,0,2087391
lacIp,0.2,4,4,TTCGGGGGACTAAAGCACAT,0,2106472
lacIp,0.2,4,4,TTAAGAACCAACGCCACCAG,0,2088512
lacIp,0.2,4,4,TGGTAATAGCACGGCACGGG,0,2105685
lacIp,0.2,4,4,TGCTATCCACCTTCCGCTGT,0,2111577
lacIp,0.2,4,4,TGCGTGCCAAGTCATACAAA,0,2118956
lacIp,0.2,4,4,TGCAGAGGGAAGGGCTTAGC,0,2090816
lacIp,0.2,4,4,TCGCGGGTCTCCTTAGACCC,0,2087244
lacIp,0.2,4,4,TCCCCTAGGCGAAACCAAAA,0,2109399
lacIp,0.2,4,4,TCAAGGAGGAATGATGTCGG,0,2090218
lacIp,0.2,4,4,TAGCGGGGAGTAGCACTAAT,0,2116761
lacIp,0.2,4,4,TACCGGTAAGATCCGACCAG,0,2094658
lacIp,0.2,4,4,TACATGTGAGCAGAGCATGA,0,2115340
lacIp,0.2,4,4,GTGTTTGCCAACGATCAAGG,0,2094118
lacIp,0.2,4,4,GTCGTAACGACTACTATTGA,0,2090843
lacIp,0.2,4,4,GGGTCCGACATAAACATATC,0,2110327
lacIp,0.2,4,4,GGCTTTTTTATTATTAGCCG,0,2106780
lacIp,0.2,4,4,GGCCGGGGCTGCGGCTTGTT,0,2111739
lacIp,0.2,4,4,GGCCGGGCTAGTTAAGTGGA,0,2090047
lacIp,0.2,4,4,GCTAGACATATTCATTGTAC,0,2104358
lacIp,0.2,4,4,GCGTTCCGCGGTAGGGATCA,0,2092853
lacIp,0.2,4,4,GCGCACTTAAGCAGCTCGCC,0,2109272
lacIp,0.2,4,4,GCACAATATTAGCATCAATA,0,2112374
lacIp,0.2,4,4,GAGTTGGAACCCTGTTCGTC,0,2101767
lacIp,0.2,4,4,GAGGATAATCGGCAGTGAGG,0,2101210
lacIp,0.2,4,4,GACACGCCCCAGTTACCGTA,0,2105615
lacIp,0.2,4,4,CTTATACTGACGGCGGCAGA,0,2103112
lacIp,0.2,4,4,CGGTAGAGTCAAGAATCCCT,0,2110994
lacIp,0.2,4,4,CGCACGTACAGCCAGAGAGA,0,2105326
lacIp,0.2,4,4,CCCTTGTGTAGGACGCTGCA,0,2115785
lacIp,0.2,4,4,CCCCGCTTTTTCAACGCACA,0,2092460
lacIp,0.2,4,4,CCCCCCAGTCCCCGCATAAT,0,2106709
lacIp,0.2,4,4,CCAACCCAGTCTCCGACGGT,0,2091250
lacIp,0.2,4,4,CATCTCTTTGCCGATGAAGT,0,2101714
lacIp,0.2,4,4,CATCCGCCTGGGCTGCGATA,0,2094086
lacIp,0.2,4,4,CAGGTGATCCAGGAGTGGGA,0,2120929
lacIp,0.2,4,4,CAGCCCGGGATCCGTTTGCC,0,2110145
lacIp,0.2,4,4,CAATACCGACACTCTTCAAA,0,2092815
lacIp,0.2,4,4,CAACATGGCCGACGACATGC,0,2086303
lacIp,0.2,4,4,CAAATTGGCAACTACCAACA,0,2094213
lacIp,0.2,4,4,CAAAAAGAGAGGGGGAGAGC,0,2120857
lacIp,0.2,4,4,ATTCCTGCTATTTCGAGTAT,0,2090786
lacIp,0.2,4,4,ATGCCCCGGTTTTTTAACGA,0,2093408
lacIp,0.2,4,4,ATATACCGACTGGCATCAAC,0,2114870
lacIp,0.2,4,4,ATAACGCACAACCAGAGGCT,0,2092645
lacIp,0.2,4,4,AGCATGTTTGTGGAGTGGAA,0,2093230
lacIp,0.2,4,4,AGAGACCAGGAGCGGTGTTC,0,2093764
lacIp,0.2,4,4,ACAGAATGATTCTGGATGAT,0,2092850
lacIp,0.2,4,4,AATGCTCATGTCGCTTGGCT,0,2091276
lacIp,0.2,4,4,AACCCGCGGGGTAATTTTAC,0,2087965
lacIp,0.25,3,3,TTTGTAAAATTTGAATTTGC,0,2109490
lacIp,0.25,3,3,TTTGACGCTCCTTTGGCTTG,0,2087436
lacIp,0.25,3,3,TTTGAAGGCCACGGAGGACC,0,2101214
lacIp,0.25,3,3,TTTAGTACAGAATGCCGGGT,0,2087714
lacIp,0.25,3,3,TTTAATAGCTAGTTATCAAG,0,2102904
lacIp,0.25,3,3,TTGTACAGTTGGTCGCTCGC,0,2103789
lacIp,0.25,3,3,TTGGTATCAGATTGCCGCAA,0,2109629
lacIp,0.25,3,3,TTGCGGGGCTGTAGCGCGAA,0,2088324
lacIp,0.25,3,3,TTGAGACTTGACTTTTACGA,0,2111580
lacIp,0.25,3,3,TTGAATTACGCTCCAGAACT,0,2100410
lacIp,0.25,3,3,TTCGGCGATGCGCTAAAGTC,0,2092728
lacIp,0.25,3,3,TTCCATGCAACGGGGATACA,0,2096199
lacIp,0.25,3,3,TTCCAGCGAAATTTTCGAAA,0,2087273
lacIp,0.25,3,3,TTATGTGTAGAGGTCTTGCT,0,2099622
lacIp,0.25,3,3,TTATCACCGAACCGCTCTCA,0,2096796
lacIp,0.25,3,3,TTAGCGCGACCGGAGACCCA,0,2095039
lacIp,0.25,3,3,TTAGCCTACAAATTGACTAG,0,2106195
lacIp,0.25,3,3,TTAATAGCAGTCTCAGCGTC,0,2119508
lacIp,0.25,3,3,TGTTCTGATACAGGATCAAG,0,2101481
lacIp,0.25,3,3,TGGTTGTGAAGCATCCACAT,0,2110391
lacIp,0.25,3,3,TGGTCATCTTCCGGAACGTC,0,2090695
lacIp,0.25,3,3,TGGGCATTTCGCTGCACCTT,0,2097485
lacIp,0.25,3,3,TGCTTTCCACTCTGACTTTG,0,2106973
lacIp,0.25,3,3,TGCTGTTACACGTTATCGCA,0,2105535
lacIp,0.25,3,3,TGCACATAATATATTGCTGA,0,2097195
lacIp,0.25,3,3,TGATGCTGTACCTCAGCACG,0,2119182
lacIp,0.25,3,3,TGATCCGATCGAGCGGTTCA,0,2101088
lacIp,0.25,3,3,TGAGTTGGGTGAACGTCCAA,0,2113109
lacIp,0.25,3,3,TCTTGAGGTGTGACATGGAT,0,2109991
lacIp,0.25,3,3,TCTAGTGGGGGCTGGCGGGT,0,2109606
lacIp,0.25,3,3,TCGTACTATACGCTCTCATA,0,2102126
lacIp,0.25,3,3,TCGGCGACGGGGACCTCCGT,0,2094146
lacIp,0.25,3,3,TCGCTCGTCATGCGGGGGCA,0,2119956
lacIp,0.25,3,3,TCGACTAGAGGGACTAGCCA,0,2105506
lacIp,0.25,3,3,TCGAAGAACGTAGGTCAACG,0,2087544
lacIp,0.25,3,3,TCCTTAGTACGATTGTATAA,0,2116019
lacIp,0.25,3,3,TCCGGCAACATTGCCAGGGA,0,2120186
lacIp,0.25,3,3,TCCGCGCTAAGACTGCAGAT,0,2089687
lacIp,0.25,3,3,TCACTCTATCGTTCGACGTG,0,2112241
lacIp,0.25,3,3,TCACGCTGCGTTGGCGCCGG,0,2107732
lacIp,0.25,3,3,TCAAATACTTTACTTCGTCT,0,2107053
lacIp,0.25,3,3,TATTTTTCAGGTGAAGGATG,0,2096354
lacIp,0.25,3,3,TATTGGTATATATCTTAAAA,0,2092715
lacIp,0.25,3,3,TATGCTTGCATTACGTAGTT,0,2089870
lacIp,0.25,3,3,TATGAAGGTGGTTCACCGTT,0,2088264
lacIp,0.25,3,3,TATAAAACGAACCCTCTGGA,0,2092783
lacIp,0.25,3,3,TAGCTCTAAGCTAGCCCCCA,0,2099556
lacIp,0.25,3,3,TAGATCAGGAACCTCGAAGA,0,2103886
lacIp,0.25,3,3,TAGACGTACGGACCGTCCAT,0,2088539
lacIp,0.25,3,3,TACGAGAGTGTACATGCTGT,0,2099245
lacIp,0.25,3,3,TACCCATAATAGCCCGAAGG,0,2112133
lacIp,0.25,3,3,TACCCACCCCCTTCTGCTGA,0,2091745
lacIp,0.25,3,3,TACCATACGTGTGTTTGTCG,0,2089399
lacIp,0.25,3,3,GTTGTCACGTCCTTCGAGAA,0,2094946
lacIp,0.25,3,3,GTTGGACCGCTGGTTCCGAG,0,2112339
lacIp,0.25,3,3,GTTCGCAGCACCGGTTCAAT,0,2107483
lacIp,0.25,3,3,GTTCCAAACAGGTCGTTATT,0,2106392
lacIp,0.25,3,3,GTGTTGAGTCGCGGTTAGAA,0,2089639
lacIp,0.25,3,3,GTGGGAACCCGACGTAGACC,0,2089004
lacIp,0.25,3,3,GTGCTATAGAAGTCTTGTGT,0,2094396
lacIp,0.25,3,3,GTGAGTGGGAGACTGATACA,0,2111096
lacIp,0.25,3,3,GTGAGGCGTCAGATTTTTCA,0,2096545
lacIp,0.25,3,3,GTGAACCGGAGTGTTGCACT,0,2094367
lacIp,0.25,3,3,GTCGTCAGGTTTCGGTTAAG,0,2094903
lacIp,0.25,3,3,GTCAACACGGGAAAGCTGCC,0,2115603
lacIp,0.25,3,3,GTATGAGCAGCTCGTTCAAT,0,2100895
lacIp,0.25,3,3,GTAGACAGCAAAGCGACCTC,0,2110059
lacIp,0.25,3,3,GTACCAGCTCAAGCCACCTT,0,2101816
lacIp,0.25,3,3,GTAATGTCGCTAGTGCGTAG,0,2097093
lacIp,0.25,3,3,GTAAGGGGATAGCATGCCTA,0,2095508
lacIp,0.25,3,3,GTAAGCAGGCGACGGCAAGG,0,2101586
lacIp,0.25,3,3,GTAACGGGTTATCACAGACT,0,2116162
lacIp,0.25,3,3,GGTCCGTTCAAATGGCTTAG,0,2090212
lacIp,0.25,3,3,GGGGTAGTTACGAGAGCCAT,0,2107205
lacIp,0.25,3,3,GGGAATACTAAGCCATATGT,0,2107203
lacIp,0.25,3,3,GGCTTTATCGTCACAGTATT,0,2088102
lacIp,0.25,3,3,GGATGGCAAATGACACCGAA,0,2096902
lacIp,0.25,3,3,GGATACGGAGTAAATACCTT,0,2115386
lacIp,0.25,3,3,GGACTCCACTGATGAATGCA,0,2108714
lacIp,0.25,3,3,GGACACGTGTGCACATGGTC,0,2098253
lacIp,0.25,3,3,GGAACGACAAGGGTATTCCC,0,2094116
lacIp,0.25,3,3,GCTTTAGTCTCGGGACATCT,0,2113301
lacIp,0.25,3,3,GCTTGTCGATATTACCCTCT,0,2113439
lacIp,0.25,3,3,GCTGCTTTGAGCGACTGGTC,0,2118497
lacIp,0.25,3,3,GCTGAGGGTCAGACGCCGGT,0,2110493
lacIp,0.25,3,3,GCTCGGTAAGTAATTATCCA,0,2115413
lacIp,0.25,3,3,GCGTATAAACGTTGTCGCCC,0,2110333
lacIp,0.25,3,3,GCGGTATACATCTTACTATA,0,2111680
lacIp,0.25,3,3,GCCTGAGTGTTTTTTCTTTA,0,2120460
lacIp,0.25,3,3,GCCCTGGGTGGATGGTGGGC,0,2095785
lacIp,0.25,3,3,GCCCGGCGGTCGCGCAGTGT,0,2095273
lacIp,0.25,3,3,GCCCGCGTTCTGGCCTTTAT,0,2106062
lacIp,0.25,3,3,GCCAGGATCCGGCCCTGCTT,0,2098960
lacIp,0.25,3,3,GCAGTCTTAACCTCCGATTA,0,2088260
lacIp,0.25,3,3,GCAGTCGGGAGTCCTTACAG,0,2114569
lacIp,0.25,3,3,GCACCAGTTAGGGGGACTTA,0,2086815
lacIp,0.25,3,3,GCAACCTGGAAGGACGGTTT,0,2088286
lacIp,0.25,3,3,GCAAACGCGCCAGTTCTGTT,0,2095567
lacIp,0.25,3,3,GATTGTGCTACGTGTGCGTT,0,2092499
lacIp,0.25,3,3,GATCTTGTGGTTTCGGTATT,0,2091236
lacIp,0.25,3,3,GATAGACACCTTTACTTGGG,0,2114986
lacIp,0.25,3,3,GACTTAGTCCGCCGCTAAAC,0,2104741
lacIp,0.25,3,3,GACTACATGTACTTTGAAGT,0,2120706
lacIp,0.25,3,3,GACGATCGATGGTGAGTCCT,0,2122055
lacIp,0.25,3,3,GAAGAGTCAGGGGCGCATAA,0,2111868
lacIp,0.25,3,3,GAACCCCTATCGCGACCACA,0,2087174
lacIp,0.25,3,3,CTTAAGATTTGTGCTGTCTC,0,2098134
lacIp,0.25,3,3,CTGTTGATCGTGAGCAGACG,0,2107729
lacIp,0.25,3,3,CTGGTCAAATTTGAACAAAT,0,2117531
lacIp,0.25,3,3,CTGCTCATGTGATGGATGAC,0,2088312
lacIp,0.25,3,3,CTGAGGTTGATCGACGTGAC,0,2104524
lacIp,0.25,3,3,CTCTCGAGCATAGGGTCTGA,0,2094917
lacIp,0.25,3,3,CTCTATTGAAATCTTTCCTA,0,2119568
lacIp,0.25,3,3,CTCCTAACGCTATTCTTCCA,0,2090890
lacIp,0.25,3,3,CTCCGCATAAGTTCAGACCT,0,2102874
lacIp,0.25,3,3,CTAGGGTGGAAGACACAGGA,0,2091681
lacIp,0.25,3,3,CTAGAGCGGCCACACACAGA,0,2089066
lacIp,0.25,3,3,CTAAGAAGGCCCCGCGAAAT,0,2109379
lacIp,0.25,3,3,CTAAACGTCGTATAAATAAA,0,2114164
lacIp,0.25,3,3,CGTAAGTACAAGCTGGCCAT,0,2104804
lacIp,0.25,3,3,CGGTTCACTTATTTTTGCTG,0,2097558
lacIp,0.25,3,3,CGGTCTGTTGTTGCCGTAAA,0,2087200
lacIp,0.25,3,3,CGGGGGGGTAGCATTGAAGA,0,2097338
lacIp,0.25,3,3,CGGAAGCATAAGCAATTACG,0,2110319
lacIp,0.25,3,3,CGCTTGACAAATGCTTAACT,0,2098314
lacIp,0.25,3,3,CGCTAGCACCGCACTACGCA,0,2097547
lacIp,0.25,3,3,CGCTACATATGGGAGTGGGC,0,2103445
lacIp,0.25,3,3,CGCGTCTGGAACGATCGTGT,0,2090475
lacIp,0.25,3,3,CGCGGTGAAAATGTAATCCA,0,2093542
lacIp,0.25,3,3,CGCGGCCGAGATTCACCAGC,0,2088378
lacIp,0.25,3,3,CGCCTTATAAGAGGGGGGCT,0,2086216
lacIp,0.25,3,3,CCTGAGTCATTGTTGTGGCT,0,2102782
lacIp,0.25,3,3,CCTGAACCACGAGTTCAACG,0,2089001
lacIp,0.25,3,3,CCTCACGAATTTAGTAGGTT,0,2121872
lacIp,0.25,3,3,CCTATGTTCAAGCCATTAGT,0,2089864
lacIp,0.25,3,3,CCGTCAACGAAGTTCGGATA,0,2094582
lacIp,0.25,3,3,CCGCGCAAACCCGCGAGCTT,0,2105908
lacIp,0.25,3,3,CCGATACGAGACCGGCGGAT,0,2112435
lacIp,0.25,3,3,CCGACTTGTTGGACAAGGGG,0,2093583
lacIp,0.25,3,3,CCCCATTCACGTCATTATAA,0,2115029
lacIp,0.25,3,3,CCACCGATGGTGGGTGACCA,0,2110186
lacIp,0.25,3,3,CATCTGGGCTACGAGGCAGA,0,2118269
lacIp,0.25,3,3,CATCATGTGTTGTTTCAATT,0,2110925
lacIp,0.25,3,3,CATATAGTGCTATTTGATAA,0,2089519
lacIp,0.25,3,3,CAGTTAGTCGCCAACGTGCG,0,2106091
lacIp,0.25,3,3,CAGTGTCACTAATCTCATCA,0,2096648
lacIp,0.25,3,3,CAGTCTTAATGATGTACGAT,0,2092388
lacIp,0.25,3,3,CAGTATATCGTATTCAGCCT,0,2114078
lacIp,0.25,3,3,CAGTAGGCATTGCGCGCATG,0,2121288
lacIp,0.25,3,3,CAGGCCGCACTGGGACGGCA,0,2104281
lacIp,0.25,3,3,CAGCTTGCTATTCCCGGCAT,0,2102663
lacIp,0.25,3,3,CACCCCCCTTGTATTGTCGT,0,2107171
lacIp,0.25,3,3,CACCAGGAGGGGTACCAACA,0,2109063
lacIp,0.25,3,3,CACCAAGCCAGCATTTCTCA,0,2111057
lacIp,0.25,3,3,CACAACTGGAGGTTCGCGTG,0,2101211
lacIp,0.25,3,3,CAAGTTGTACTTATCTCCTT,0,2100269
lacIp,0.25,3,3,CAAAGGGCGGCGGACACGGC,0,2092061
lacIp,0.25,3,3,ATTTGTGGGAACCGGGTCAC,0,2095568
lacIp,0.25,3,3,ATGTGTAGGACCTTGGTTTA,0,2087274
lacIp,0.25,3,3,ATGGGTGACGTGTAACGTAT,0,2100348
lacIp,0.25,3,3,ATCGTTGCAGTCAACGGGAA,0,2104685
lacIp,0.25,3,3,ATCGTGACCGTCTTGCAAGG,0,2094657
lacIp,0.25,3,3,ATCGTATGTGTACGGAATTG,0,2104140
lacIp,0.25,3,3,ATCCACCGTCGGTGAGTGGT,0,2086113
lacIp,0.25,3,3,ATATTTTAGTCACCTTATCC,0,2120163
lacIp,0.25,3,3,ATAGGATGCAACGAAAGGCT,0,2101129
lacIp,0.25,3,3,ATACTTGATTTCTTACAATG,0,2116923
lacIp,0.25,3,3,ATACCTAGAGCCTAGGTTTG,0,2095650
lacIp,0.25,3,3,ATAACATTTGGGTATATAAG,0,2114740
lacIp,0.25,3,3,AGTGCATGAGAAATCTACTT,0,2094418
lacIp,0.25,3,3,AGTGACATGCCTTAAGCTGA,0,2118608
lacIp,0.25,3,3,AGTCCTTAAGGGGAGCCACT,0,2091183
lacIp,0.25,3,3,AGGTTGATGTCCTGCGTGTG,0,2116082
lacIp,0.25,3,3,AGGAGACACAGCAGACTCTA,0,2098499
lacIp,0.25,3,3,AGCGGCGGAGATCCAGGGAA,0,2121386
lacIp,0.25,3,3,AGCCGGTGTAGTTATTGGTA,0,2117867
lacIp,0.25,3,3,AGCACGTTCCCAGGAGAAGT,0,2091306
lacIp,0.25,3,3,AGATAATTGACCTAGGGATA,0,2105600
lacIp,0.25,3,3,AGAAGGTATGACACCTCTAG,0,2097397
lacIp,0.25,3,3,ACTCTAGGTCTTTGTGAGTC,0,2114077
lacIp,0.25,3,3,ACTATGCTAATGATGGAGGT,0,2100944
lacIp,0.25,3,3,ACGTGGAAAGCTGATTTCGT,0,2088558
lacIp,0.25,3,3,ACGTCGAACGGTTCCTTTTA,0,2102865
lacIp,0.25,3,3,ACGGCCTAAGGCTTTTATGA,0,2120736
lacIp,0.25,3,3,ACGGCAACCCCCCGAGTGTT,0,2119527
lacIp,0.25,3,3,ACGCTTAACATCTTGCCCGA,0,2109213
lacIp,0.25,3,3,ACGACGGCTATTCACGATGA,0,2092524
lacIp,0.25,3,3,ACATACGTACTTTTTCCGTA,0,2093486
lacIp,0.25,3,3,AATGGCAGTGGATCCGGCCT,0,2095317
lacIp,0.25,3,3,AATCTAGCCCGTATGCTATA,0,2096377
lacIp,0.25,3,3,AATCGATTGAAGCCCACGTC,0,2106245
lacIp,0.25,3,3,AATAATTCGTAACTCGCGCC,0,2092774
lacIp,0.25,3,3,AAGTCGTAGCACCCTGGGTA,0,2110517
lacIp,0.25,3,3,AAGACTTTAGCTTATTGACT,0,2101658
lacIp,0.25,3,3,AACCTTTAGTCCTGATGCAG,0,2088538
lacIp,0.25,3,3,AACCGGTTTAAAGTGCTCCA,0,2091090
lacIp,0.25,3,3,AAATCTGTCGCGACACGTTA,0,2116073
lacIp,0.3333333333333333,2,2,TTTTAGGGCAGCTGGAGTAC,0,2110230
lacIp,0.3333333333333333,2,2,TTTTAACTCTCGTTTGTATC,0,2115226
lacIp,0.3333333333333333,2,2,TTTGTGCTGGTCATATCAAT,0,2118054
lacIp,0.3333333333333333,2,2,TTTGGTTGCTGCGGTGCGAT,0,2101010
lacIp,0.3333333333333333,2,2,TTTGAGCGCGCGCACCAAGT,0,2121339
lacIp,0.3333333333333333,2,2,TTTGACATATGCTTATCCAT,0,2110272
lacIp,0.3333333333333333,2,2,TTTCGGGGTTCATCGCTAAT,0,2103884
lacIp,0.3333333333333333,2,2,TTTCATCCAGACTGTCCTAA,0,2110148
lacIp,0.3333333333333333,2,2,TTTCATATTTGAGTATATCC,0,2098581
lacIp,0.3333333333333333,2,2,TTTCAGCAGTTCCAGTAAAA,0,2102541
lacIp,0.3333333333333333,2,2,TTTATTCAAGAAACCCAAGA,0,2119993
lacIp,0.3333333333333333,2,2,TTTAGGGACACGCGGTCACT,0,2097766
lacIp,0.3333333333333333,2,2,TTTACTTGGTTATCCGCTTG,0,2090876
lacIp,0.3333333333333333,2,2,TTGTGCGACACTATCCGTGA,0,2114214
lacIp,0.3333333333333333,2,2,TTGTCCTCGAGCCCAACAAT,0,2093151
lacIp,0.3333333333333333,2,2,TTGTCAGCAGCAGCCTCGCA,0,2102881
lacIp,0.3333333333333333,2,2,TTGGTATAATTGAGCAAGAT,0,2095815
lacIp,0.3333333333333333,2,2,TTGGCCCGTATTTGTAATAC,0,2088703
lacIp,0.3333333333333333,2,2,TTGGCACTTTACTTCGGGTT,0,2106829
lacIp,0.3333333333333333,2,2,TTGCATGTATGCGAATACTT,0,2107183
lacIp,0.3333333333333333,2,2,TTGATTACATGTGACACACC,0,2116419
lacIp,0.3333333333333333,2,2,TTGATGGCGAAGAGAGAGGT,0,2089072
lacIp,0.3333333333333333,2,2,TTGACGTTAAGGATCAATAG,0,2111449
lacIp,0.3333333333333333,2,2,TTGACACCTCCAGTAGGGGG,0,2086032
lacIp,0.3333333333333333,2,2,TTCTGGTCCGGCTAAACCGC,0,2110022
lacIp,0.3333333333333333,2,2,TTCTAAGGTGGAATGTATAA,0,2099798
lacIp,0.3333333333333333,2,2,TTCCGTCAGATACCAGCTAA,0,2087941
lacIp,0.3333333333333333,2,2,TTCCCAATGATGGATGTCTG,0,2103705
lacIp,0.3333333333333333,2,2,TTCAGAATTTTTATCATTGA,0,2092403
lacIp,0.3333333333333333,2,2,TTATGCCGGCCCTTGTCCTA,0,2098230
lacIp,0.3333333333333333,2,2,TTATCTCCATTTACAGGAAC,0,2097967
lacIp,0.3333333333333333,2,2,TTATATACACCATTAAATGT,0,2110974
lacIp,0.3333333333333333,2,2,TTATAATCGCAGCCAGAAAT,0,2103631
lacIp,0.3333333333333333,2,2,TTAGGGCTCCCAGGCGCCAA,0,2087024
lacIp,0.3333333333333333,2,2,TTACCTTGAGCCCCCTTAAC,0,2108243
lacIp,0.3333333333333333,2,2,TTACCGCCTCGGGATCCGAT,0,2101363
lacIp,0.3333333333333333,2,2,TTACACTTTGCGTTGTCATA,0,2121109
lacIp,0.3333333333333333,2,2,TTACACAAGTGCGCGACCCC,0,2121688
lacIp,0.3333333333333333,2,2,TTAATTAAGCTTCAGATGAA,0,2098380
lacIp,0.3333333333333333,2,2,TTAAGTATCACAAGATTAAC,0,2105048
lacIp,0.3333333333333333,2,2,TTAAGGCTACCATTCTGGTA,0,2109547
lacIp,0.3333333333333333,2,2,TTAACTACAATGCCAAACAT,0,2104474
lacIp,0.3333333333333333,2,2,TTAACGGGCACTGCGGTACA,0,2115372
lacIp,0.3333333333333333,2,2,TGTTGGAAATCGAGGGCGAT,0,2114804
lacIp,0.3333333333333333,2,2,TGTTGCACCACCTGTAATGA,0,2110625
lacIp,0.3333333333333333,2,2,TGTTATATGTAGGGGAAAGG,0,2103727
lacIp,0.3333333333333333,2,2,TGTGTTGGCAAACCTAGAGT,0,2117540
lacIp,0.3333333333333333,2,2,TGTGTTCGCTCTCCTAGCAT,0,2105881
lacIp,0.3333333333333333,2,2,TGTGCACTTGAGACGTACAG,0,2086267
lacIp,0.3333333333333333,2,2,TGTCTTTTAGTCTACGGGCC,0,2103023
lacIp,0.3333333333333333,2,2,TGTCTGGTTAGGTCCTCAAT,0,2094481
lacIp,0.3333333333333333,2,2,TGTCTAGTTTTACGTGTGCT,0,2089890
lacIp,0.3333333333333333,2,2,TGTCGGGTAAATTACTGGGA,0,2099645
lacIp,0.3333333333333333,2,2,TGGTATAGCCCACTTCGGAG,0,2096743
lacIp,0.3333333333333333,2,2,TGGTAATGAGTCCGTGGTGA,0,2086849
lacIp,0.3333333333333333,2,2,TGGGTTAGTGTCAATCGCGA,0,2109444
lacIp,0.3333333333333333,2,2,TGGGGTACGCAGACGCAAAG,0,2097223
lacIp,0.3333333333333333,2,2,TGGGCTCTTAGAGCGGCAGA,0,2096826
lacIp,0.3333333333333333,2,2,TGGGCTCTGGACATCGGCGA,0,2112235
lacIp,0.3333333333333333,2,2,TGGGAGTTCGAATGCGATCT,0,2093341
lacIp,0.3333333333333333,2,2,TGGGACTTTTTAAGTGACTT,0,2107835
lacIp,0.3333333333333333,2,2,TGGGAAGTCTGGTAGTGTTT,0,2101179
lacIp,0.3333333333333333,2,2,TGGCCGCGCACGGGCACCTA,0,2090118
lacIp,0.3333333333333333,2,2,TGGCAGACAGCGGCCCAACC,0,2106028
lacIp,0.3333333333333333,2,2,TGGATGCAGCATTATTGGGG,0,2118238
lacIp,0.3333333333333333,2,2,TGGACTTCGGCCGCACGATG,0,2120263
lacIp,0.3333333333333333,2,2,TGGACGAGTACGTCGGGGAT,0,2101985
lacIp,0.3333333333333333,2,2,TGGACACAAGAGAGCCCATT,0,2108057
lacIp,0.3333333333333333,2,2,TGCTTACGTCTCGGCAGCTA,0,2100520
lacIp,0.3333333333333333,2,2,TGCCTTTGAAAGCCCTTACT,0,2103053
lacIp,0.3333333333333333,2,2,TGCAGAGTCATTTGATGCAT,0,2093890
lacIp,0.3333333333333333,2,2,TGATAGATGCTAGGGTTGGG,0,2113730
lacIp,0.3333333333333333,2,2,TGAGTCACGGATAATAGGAC,0,2108073
lacIp,0.3333333333333333,2,2,TGAGGTATAGGGGCGCGGTC,0,2091828
lacIp,0.3333333333333333,2,2,TGACTTCGTGTCGCCGTACT,0,2118863
lacIp,0.3333333333333333,2,2,TGACGTAAAATTCTCCATCG,0,2110545
lacIp,0.3333333333333333,2,2,TGACAGTGTTAAACGGGCTA,0,2109344
lacIp,0.3333333333333333,2,2,TGAATTTGCTTGAGTGACAA,0,2092533
lacIp,0.3333333333333333,2,2,TGAATTGTATGGTACGCGCG,0,2105952
lacIp,0.3333333333333333,2,2,TGAAGTGCCATCTAGGCTCG,0,2090035
lacIp,0.3333333333333333,2,2,TGAACCGCCCTCGTGTAGAA,0,2103525
lacIp,0.3333333333333333,2,2,TCTTCGTTGCGCCTGAAAGT,0,2115771
lacIp,0.3333333333333333,2,2,TCTGAAAACCCTCGGGTCAA,0,2092598
lacIp,0.3333333333333333,2,2,TCTCCTTGCAAAGCACATAA,0,2103280
lacIp,0.3333333333333333,2,2,TCTCCGGAAGGGAACCGGTT,0,2116691
lacIp,0.3333333333333333,2,2,TCTAATATTTCCGATGCCGT,0,2096862
lacIp,0.3333333333333333,2,2,TCGTTCACACTATATTAGCC,0,2094196
lacIp,0.3333333333333333,2,2,TCGTGCGTCATCAGGAGATT,0,2102907
lacIp,0.3333333333333333,2,2,TCGGTCTCCATTTTTAGGCT,0,2115411
lacIp,0.3333333333333333,2,2,TCGGATCATATGCTTTACAA,0,2094614
lacIp,0.3333333333333333,2,2,TCGGACTATTACTGACTAAA,0,2100457
lacIp,0.3333333333333333,2,2,TCGCTGAACACAACTTCGTG,0,2098888
lacIp,0.3333333333333333,2,2,TCGCGAGCGCGCAGGCACTA,0,2112710
lacIp,0.3333333333333333,2,2,TCGAATTTCAAGAATATATC,0,2088592
lacIp,0.3333333333333333,2,2,TCGAATCATGCAATTAAGAT,0,2099942
lacIp,0.3333333333333333,2,2,TCCTGAGCGTGGATGGGTGA,0,2105706
lacIp,0.3333333333333333,2,2,TCCGTGCAGAGAGTTTGATT,0,2103139
lacIp,0.3333333333333333,2,2,TCCGGTCGTAAGTTTGAGTA,0,2118695
lacIp,0.3333333333333333,2,2,TCCGAGCATTACCCTCGTAG,0,2090852
lacIp,0.3333333333333333,2,2,TCCCTGTGTCGAGTTTTCCA,0,2112980
lacIp,0.3333333333333333,2,2,TCCCAAGGCACTCGGTCCCC,0,2087287
lacIp,0.3333333333333333,2,2,TCCAGGTTCTTATTCATCAA,0,2105300
lacIp,0.3333333333333333,2,2,TCCAGGCAATTCACCGGTGG,0,2088534
lacIp,0.3333333333333333,2,2,TCATGGATAGCTCGGGAACT,0,2111012
lacIp,0.3333333333333333,2,2,TCATCTTGACCTGGTCCAAC,0,2096723
lacIp,0.3333333333333333,2,2,TCATCGGCAGGACTCGCGTA,0,2102327
lacIp,0.3333333333333333,2,2,TCATATATTTAAGGGCAGGC,0,2090888
lacIp,0.3333333333333333,2,2,TCAGGGAACGTTTACTGCTT,0,2091600
lacIp,0.3333333333333333,2,2,TCAGGCTTCGGGCTGGGTGG,0,2104058
lacIp,0.3333333333333333,2,2,TCACCCGCGTCGAAGCGTAC,0,2101912
lacIp,0.3333333333333333,2,2,TCACCCATCTACGAATGCCA,0,2099442
lacIp,0.3333333333333333,2,2,TCACATTGATGTCAACATCT,0,2120637
lacIp,0.3333333333333333,2,2,TCAATTGCTAAGTTTCTCAT,0,2090948
lacIp,0.3333333333333333,2,2,TATTTTCAGGGGCTTTAGGT,0,2110067
lacIp,0.3333333333333333,2,2,TATTTGCTGATCATTGCTAT,0,2110709
lacIp,0.3333333333333333,2,2,TATTGCGGGAAAGCCGGATT,0,2095637
lacIp,0.3333333333333333,2,2,TATTGAGAATAGCCACTGTC,0,2102902
lacIp,0.3333333333333333,2,2,TATTGAAACACATACAAAAG,0,2115522
lacIp,0.3333333333333333,2,2,TATTCACGATATACGCGCGA,0,2093634
lacIp,0.3333333333333333,2,2,TATTATTCTAGGCCCACATG,0,2107747
lacIp,0.3333333333333333,2,2,TATGGAATAAGGTCACGGAA,0,2112863
lacIp,0.3333333333333333,2,2,TATCTAGTGGTGATTGATAC,0,2088816
lacIp,0.3333333333333333,2,2,TATCAGAGAAAATGAGGCAC,0,2087130
lacIp,0.3333333333333333,2,2,TATCACCTCCCGGCGTGATG,0,2086943
lacIp,0.3333333333333333,2,2,TATACAGTCGGCAGAAAAAT,0,2108737
lacIp,0.3333333333333333,2,2,TATACAGAGGGGTTATTTCA,0,2107735
lacIp,0.3333333333333333,2,2,TAGCTGTGATTCGTAAGGGC,0,2110361
lacIp,0.3333333333333333,2,2,TAGATTCTGCATCAAAAGAG,0,2093144
lacIp,0.3333333333333333,2,2,TACTTCACCACGCAAATAGT,0,2105825
lacIp,0.3333333333333333,2,2,TACTCGATGCATGATAAACG,0,2095596
lacIp,0.3333333333333333,2,2,TACTCAGCGTGGGGTTGTGG,0,2085715
lacIp,0.3333333333333333,2,2,TACTAACCGGGGCTTGACAA,0,2101895
lacIp,0.3333333333333333,2,2,TACGTAACGGTGGGCTCTAG,0,2103451
lacIp,0.3333333333333333,2,2,TACGCGTCCGAAGATCAAGT,0,2102335
lacIp,0.3333333333333333,2,2,TACGAAAAATCTTAGATTAC,0,2093390
lacIp,0.3333333333333333,2,2,TACCCGAGGAATAAATTCGA,0,2093660
lacIp,0.3333333333333333,2,2,TACCAGTGGGTGCATTTAAT,0,2120038
lacIp,0.3333333333333333,2,2,TACATTGCCTCGTCTGTCTC,0,2090787
lacIp,0.3333333333333333,2,2,TACACTGATGGATAATTTGA,0,2106304
lacIp,0.3333333333333333,2,2,TACAATTTTTTGGCGAACTG,0,2089210
lacIp,0.3333333333333333,2,2,TAATTATGAGGGGACAGCTG,0,2115802
lacIp,0.3333333333333333,2,2,TAATCTCTCAAGCTCACCTT,0,2112645
lacIp,0.3333333333333333,2,2,TAATCGGTCCACGAAGACAG,0,2107692
lacIp,0.3333333333333333,2,2,TAATACAGCGACTCAGGCCA,0,2114574
lacIp,0.3333333333333333,2,2,TAAGTTTAGATGGAAAATGA,0,2088428
lacIp,0.3333333333333333,2,2,TAACGCGGCTACGCCCACGG,0,2091595
lacIp,0.3333333333333333,2,2,TAAATATAAGCCTCAAGCCT,0,2088627
lacIp,0.3333333333333333,2,2,TAAATACCCTAAATAACAGC,0,2109625
lacIp,0.3333333333333333,2,2,GTTTTATCGACAAATCCAGA,0,2102333
lacIp,0.3333333333333333,2,2,GTTGTATAGTCGGTACGCCC,0,2114655
lacIp,0.3333333333333333,2,2,GTTGAGGGGCACGCGTCGTC,0,2120659
lacIp,0.3333333333333333,2,2,GTTCGGGACCCCTACCGGAA,0,2086114
lacIp,0.3333333333333333,2,2,GTTCACTTCTGGCGCCACCT,0,2103769
lacIp,0.3333333333333333,2,2,GTTCACACTCTGGCATCGGA,0,2106730
lacIp,0.3333333333333333,2,2,GTTATTAGCTCAATGGGCTG,0,2102093
lacIp,0.3333333333333333,2,2,GTTAGCTGGATCCACGGCCC,0,2099489
lacIp,0.3333333333333333,2,2,GTGTCTGTTGTTCCATTAAG,0,2089617
lacIp,0.3333333333333333,2,2,GTGTAAGCGAGGTGATAGCA,0,2089499
lacIp,0.3333333333333333,2,2,GTGTAACAACCTTTACCGAA,0,2108882
lacIp,0.3333333333333333,2,2,GTGCTCGTTGTCGCTCTCAT,0,2121544
lacIp,0.3333333333333333,2,2,GTGCGCATAAGGAAGGGGGA,0,2092823
lacIp,0.3333333333333333,2,2,GTGCGAGAATCGTATTAGTG,0,2108213
lacIp,0.3333333333333333,2,2,GTGCAGAATGCGCTCGGTAG,0,2093958
lacIp,0.3333333333333333,2,2,GTGAGTCATTTCAATCCTGC,0,2104278
lacIp,0.3333333333333333,2,2,GTGAGGGGAGCCCATACCAA,0,2096835
lacIp,0.3333333333333333,2,2,GTCTTTGTACTCGCGGAAGT,0,2098279
lacIp,0.3333333333333333,2,2,GTCTTAACTGGACCGATGGG,0,2117232
lacIp,0.3333333333333333,2,2,GTCTGGATGATCTTGAATGT,0,2098844
lacIp,0.3333333333333333,2,2,GTCGGGTCCCATACCACCAT,0,2087978
lacIp,0.3333333333333333,2,2,GTCCCGTGCAGGAGCTCCAC,0,2100452
lacIp,0.3333333333333333,2,2,GTCCATGGGTTTGCGCAAAT,0,2112289
lacIp,0.3333333333333333,2,2,GTCATGCATGGAATGACAAA,0,2094450
lacIp,0.3333333333333333,2,2,GTCATCAGGGTACTTAGTAT,0,2115546
lacIp,0.3333333333333333,2,2,GTCATATTGGTTATAGCATA,0,2086364
lacIp,0.3333333333333333,2,2,GTCACGGGTCACCAAATGTG,0,2107921
lacIp,0.3333333333333333,2,2,GTCAATCCGGCCATGTGCCA,0,2110280
lacIp,0.3333333333333333,2,2,GTCAAGGAGTGCTGGCTCTC,0,2106405
lacIp,0.3333333333333333,2,2,GTATTACAGTTCTTAACGGT,0,2090817
lacIp,0.3333333333333333,2,2,GTATCAACCGCTATAGCAAT,0,2109153
lacIp,0.3333333333333333,2,2,GTAGTGCTATTTAACTGTGA,0,2086991
lacIp,0.3333333333333333,2,2,GTAGGTCAGGGACTGAGAAC,0,2111162
lacIp,0.3333333333333333,2,2,GTAGCGGCATGATTCCTAGT,0,2117789
lacIp,0.3333333333333333,2,2,GTAGCAGCATCTTGGACAAG,0,2108125
lacIp,0.3333333333333333,2,2,GTAGAGTTGTTTTGCGTCCA,0,2117664
lacIp,0.3333333333333333,2,2,GTACCTCCCGGGCAGAATTT,0,2110471
lacIp,0.3333333333333333,2,2,GTACCAATGCTACTCGAGTG,0,2107151
lacIp,0.3333333333333333,2,2,GTACATGAGCCTTTGGCGTA,0,2086547
lacIp,0.3333333333333333,2,2,GTAATGGGCTATTTGTGGTC,0,2117715
lacIp,0.3333333333333333,2,2,GTAATGCGCTGTTTCGAGTT,0,2087323
lacIp,0.3333333333333333,2,2,GTAACCCTGTGCTTAAATAG,0,2091112
lacIp,0.3333333333333333,2,2,GGTTTAAGCGGGTGTCACCG,0,2100870
lacIp,0.3333333333333333,2,2,GGTTGGGGTGACGTGCTATA,0,2088477
lacIp,0.3333333333333333,2,2,GGTTACGGGTATACACTTAT,0,2090372
lacIp,0.3333333333333333,2,2,GGTTAATTGATCTCGGACAT,0,2111681
lacIp,0.3333333333333333,2,2,GGTGCAAGCTTACGGCACAT,0,2106073
lacIp,0.3333333333333333,2,2,GGTCTGTGTGCAGCGTGAGC,0,2107616
lacIp,0.3333333333333333,2,2,GGTCCGGATTAGGCCGCGTA,0,2099118
lacIp,0.3333333333333333,2,2,GGTAGTACGCCGAGCATAGA,0,2099902
lacIp,0.3333333333333333,2,2,GGTAGCGGGTTGTTACGGAA,0,2087507
lacIp,0.3333333333333333,2,2,GGTAGCCTCCTAACGAAAAA,0,2097734
lacIp,0.3333333333333333,2,2,GGTACACAGAGTAGCCTCAA,0,2094727
lacIp,0.3333333333333333,2,2,GGTAATGTGACCAGCACGTA,0,2112318
lacIp,0.3333333333333333,2,2,GGGTGTTGCAGCACAATCGG,0,2107718
lacIp,0.3333333333333333,2,2,GGGTAGGGTCCAGAGTGACG,0,2109219
lacIp,0.3333333333333333,2,2,GGGTAGGGGAGTCGTGATCC,0,2092395
lacIp,0.3333333333333333,2,2,GGGTACTCGTAAAGTGTCCC,0,2099365
lacIp,0.3333333333333333,2,2,GGGGTGGTGGCGCATACGGA,0,2097113
lacIp,0.3333333333333333,2,2,GGGGTCCCTCGAGCCCTACA,0,2113126
lacIp,0.3333333333333333,2,2,GGGCATTAGTTGGGCATTTG,0,2093741
lacIp,0.3333333333333333,2,2,GGGATGTCTATAGCTATGAA,0,2119876
lacIp,0.3333333333333333,2,2,GGGATGAATCAGAATCGAAC,0,2100580
lacIp,0.3333333333333333,2,2,GGGACCGGCCGGGTCAGATA,0,2107366
lacIp,0.3333333333333333,2,2,GGGAAACGGTTCAGAGCGCG,0,2105471
lacIp,0.3333333333333333,2,2,GGCTGATTATTAAACCTGAG,0,2089601
lacIp,0.3333333333333333,2,2,GGCTCTCTTCATCGATGTGC,0,2110674
lacIp,0.3333333333333333,2,2,GGCTCCCACGGGCTGCGTCT,0,2113641
lacIp,0.3333333333333333,2,2,GGCTCACGTGCGTAGGAGCC,0,2091920
lacIp,0.3333333333333333,2,2,GGCTATTCAGGTTCGTTGTA,0,2116937
lacIp,0.3333333333333333,2,2,GGCGTGGGAAGTGGCCACTA,0,2114357
lacIp,0.3333333333333333,2,2,GGCGTACGGCTTAGGGTGGG,0,2122224
lacIp,0.3333333333333333,2,2,GGCGTACAGGCATTGGCACT,0,2106985
lacIp,0.3333333333333333,2,2,GGCGGTGCTAACGTTCCATG,0,2113253
lacIp,0.3333333333333333,2,2,GGCGGCCCTTGGGGAAGTAA,0,2086972
lacIp,0.3333333333333333,2,2,GGCGCGTGCTCAAACCCAGA,0,2108160
lacIp,0.3333333333333333,2,2,GGCCGGACCCGCGCTCCGGG,0,2120289
lacIp,0.3333333333333333,2,2,GGCCGATATTCAGACGCCAC,0,2112684
lacIp,0.3333333333333333,2,2,GGCATCTCAAAATATATAGA,0,2102418
lacIp,0.3333333333333333,2,2,GGCAGAGGGCGTGTTCGGCA,0,2112723
lacIp,0.3333333333333333,2,2,GGCACGCCCGCCATAGCGAC,0,2091260
lacIp,0.3333333333333333,2,2,GGCAAAGTTATCGAGAAAGG,0,2112560
lacIp,0.3333333333333333,2,2,GGATTGGTAACCATTGCCAA,0,2101484
lacIp,0.3333333333333333,2,2,GGATGGGCCAGCTGGAGTTA,0,2101936
lacIp,0.3333333333333333,2,2,GGATGGCCTTGCCATGCACA,0,2109279
lacIp,0.3333333333333333,2,2,GGATCTGGCTAACGGGAACG,0,2099116
lacIp,0.3333333333333333,2,2,GGATCGCACCGCCGAACGCA,0,2101540
lacIp,0.3333333333333333,2,2,GGATACGAGCCACCAGGGAA,0,2100432
lacIp,0.3333333333333333,2,2,GGAGGTTGGAACGTCCAAAT,0,2089569
lacIp,0.3333333333333333,2,2,GGAGCCTCACCCTACAACTT,0,2119590
lacIp,0.3333333333333333,2,2,GGAGATGATCGGGTGCATGT,0,2117647
lacIp,0.3333333333333333,2,2,GGAGAACGAACCGCTTTGGC,0,2109761
lacIp,0.3333333333333333,2,2,GGACTTTTTAATACGATAGT,0,2119865
lacIp,0.3333333333333333,2,2,GGACGTCTAGCCGCTTGCGG,0,2115093
lacIp,0.3333333333333333,2,2,GGACAGTCTCTCTCGTATGG,0,2090976
lacIp,0.3333333333333333,2,2,GGACACCGGACTTCCTCTTC,0,2090730
lacIp,0.3333333333333333,2,2,GGACACCGCGACACCCCTGA,0,2119638
lacIp,0.3333333333333333,2,2,GGAACGATACACGGAATACC,0,2109637
lacIp,0.3333333333333333,2,2,GGAAACGAAAATACTGACCA,0,2101972
lacIp,0.3333333333333333,2,2,GCTGGTGTGTGTGCACATAT,0,2088560
lacIp,0.3333333333333333,2,2,GCTGGGGTGTTATTAGATAG,0,2089552
lacIp,0.3333333333333333,2,2,GCTGCAAGGAGTAGGCGCTT,0,2116396
lacIp,0.3333333333333333,2,2,GCTCTTGTCCAGGACCTTCT,0,2107858
lacIp,0.3333333333333333,2,2,GCTCTATGCGTTTAGCACCT,0,2101488
lacIp,0.3333333333333333,2,2,GCTCGAGTATATGCATTTGG,0,2117607
lacIp,0.3333333333333333,2,2,GCTCCCACCCGGCTGACACT,0,2095197
lacIp,0.3333333333333333,2,2,GCTCACTCGCGGATTCGAAC,0,2115214
lacIp,0.3333333333333333,2,2,GCTATTGGAGTTAGACCAAC,0,2114584
lacIp,0.3333333333333333,2,2,GCTAAGGAACTCAGTACATA,0,2112650
lacIp,0.3333333333333333,2,2,GCGTTGCTACTGTGGTAGAT,0,2099355
lacIp,0.3333333333333333,2,2,GCGTTCAGTCAATGGGCGCT,0,2100528
lacIp,0.3333333333333333,2,2,GCGTGGCCTGTGGCACCTGA,0,2094016
lacIp,0.3333333333333333,2,2,GCGTGAATCATGATTGAGGA,0,2105256
lacIp,0.3333333333333333,2,2,GCGTGAACTATTTATAAATT,0,2087110
lacIp,0.3333333333333333,2,2,GCGTCTTGGCCTGGAGTCGT,0,2115316
lacIp,0.3333333333333333,2,2,GCGTCGAACAACGGCTCAGC,0,2111695
lacIp,0.3333333333333333,2,2,GCGTAATCAAAGTGTTTGCT,0,2089903
lacIp,0.3333333333333333,2,2,GCGGTCTGAGTACCTCTGGG,0,2092915
lacIp,0.3333333333333333,2,2,GCGGTCCTGTAGATTTCCGG,0,2111685
lacIp,0.3333333333333333,2,2,GCGGCTGTAAGTAGCTACAC,0,2121572
lacIp,0.3333333333333333,2,2,GCGGCCAGCAGCTTTCCCGT,0,2116109
lacIp,0.3333333333333333,2,2,GCGGAGGTTGTATCACGCAT,0,2102594
lacIp,0.3333333333333333,2,2,GCGCCTCGGATCTGTGAACC,0,2098942
lacIp,0.3333333333333333,2,2,GCGCCCAGTCGGGCCATGGA,0,2087715
lacIp,0.3333333333333333,2,2,GCGAGGTTTGACATGCGTTT,0,2103170
lacIp,0.3333333333333333,2,2,GCGAGCACAGATGTCCAACG,0,2095812
lacIp,0.3333333333333333,2,2,GCGACGCAGTTTAATCAACT,0,2090219
lacIp,0.3333333333333333,2,2,GCGACACAGGTAGATTATCC,0,2119935
lacIp,0.3333333333333333,2,2,GCGAAGGCTGGATTTCCGGC,0,2094321
lacIp,0.3333333333333333,2,2,GCGAAACTTAGGGGGTAGGT,0,2085826
lacIp,0.3333333333333333,2,2,GCCGGGACAAATTTCAACCA,0,2119178
lacIp,0.3333333333333333,2,2,GCCGCGGGTACGGCAGATCT,0,2110995
lacIp,0.3333333333333333,2,2,GCCCTTCGCTGTTTGTTGCG,0,2117379
lacIp,0.3333333333333333,2,2,GCCCTGTGCTTAGCTTCCTA,0,2113064
lacIp,0.3333333333333333,2,2,GCCATGGAACGAACTCGGGT,0,2092619
lacIp,0.3333333333333333,2,2,GCCAATCACACATGGCGCAG,0,2109317
lacIp,0.3333333333333333,2,2,GCATTCGTTCGCTTCATTAT,0,2114381
lacIp,0.3333333333333333,2,2,GCATTAATAAGCCATCTCAG,0,2105276
lacIp,0.3333333333333333,2,2,GCATGGGTGTCCGTCACTTC,0,2095741
lacIp,0.3333333333333333,2,2,GCAGCTAGATTGATCATCAA,0,2098588
lacIp,0.3333333333333333,2,2,GCAGACCAAGGTTACAAGCC,0,2089198
lacIp,0.3333333333333333,2,2,GCAGAACTGGTACCGGAGAT,0,2103330
lacIp,0.3333333333333333,2,2,GCACGGACCTCCTTTTGTTA,0,2099030
lacIp,0.3333333333333333,2,2,GCACCAGGTATCGTCCATAC,0,2100644
lacIp,0.3333333333333333,2,2,GCAAAGCGCGGCAAAGGATC,0,2099858
lacIp,0.3333333333333333,2,2,GATTCCGGTGGACCCATAAG,0,2091772
lacIp,0.3333333333333333,2,2,GATTCCGAACTACCGTATCA,0,2092679
lacIp,0.3333333333333333,2,2,GATTAGAAACTGACGTGCCC,0,2118323
lacIp,0.3333333333333333,2,2,GATGTCAATGGCGTCGGTCT,0,2090191
lacIp,0.3333333333333333,2,2,GATGGACAGCGGTTGATATG,0,2120439
lacIp,0.3333333333333333,2,2,GATGCCAACTGGGGGAGATT,0,2118038
lacIp,0.3333333333333333,2,2,GATCTGTGGTTGCTACCGGT,0,2088564
lacIp,0.3333333333333333,2,2,GATCTCCAACTGTGTATGCC,0,2085875
lacIp,0.3333333333333333,2,2,GATCGTCCATACCGAAGCCA,0,2118819
lacIp,0.3333333333333333,2,2,GATCGCTAGATCGGCGGACA,0,2117921
lacIp,0.3333333333333333,2,2,GATCACAATTGTGGCAGACT,0,2117790
lacIp,0.3333333333333333,2,2,GATCAACTATCGCAACGACT,0,2095176
lacIp,0.3333333333333333,2,2,GATCAAACGGATGGGGGATA,0,2088964
lacIp,0.3333333333333333,2,2,GATATACCATCGGTAGGTGT,0,2105761
lacIp,0.3333333333333333,2,2,GAGTTCCACGGATCAATATT,0,2094948
lacIp,0.3333333333333333,2,2,GAGTGTAAGACCGTTCTGAC,0,2101161
lacIp,0.3333333333333333,2,2,GAGTCAATAACGGCAACAGT,0,2108171
lacIp,0.3333333333333333,2,2,GAGTATCGTAGCTTCATCTT,0,2100561
lacIp,0.3333333333333333,2,2,GAGGGACTTTAATAGTTAAA,0,2105474
lacIp,0.3333333333333333,2,2,GAGGCATCTAGTCCGGCTCA,0,2107940
lacIp,0.3333333333333333,2,2,GAGGATCGGATCCCAATGGT,0,2088103
lacIp,0.3333333333333333,2,2,GAGGACTTACCTATAAGACT,0,2097953
lacIp,0.3333333333333333,2,2,GAGCTATTCGAGTTCTTTTC,0,2106485
lacIp,0.3333333333333333,2,2,GAGCAAACAAGTGGGGATTC,0,2103283
lacIp,0.3333333333333333,2,2,GAGAATTCGAGGTTGAGATA,0,2101182
lacIp,0.3333333333333333,2,2,GAGAACTGGCTCAGTTTTGG,0,2095284
lacIp,0.3333333333333333,2,2,GACTGGTGTCCCACATCTAA,0,2107066
lacIp,0.3333333333333333,2,2,GACTCGCGGGCTCGTGTGGT,0,2094999
lacIp,0.3333333333333333,2,2,GACTCATTTTCACAGTCTCG,0,2097763
lacIp,0.3333333333333333,2,2,GACTACACAACAATGTGGAC,0,2110050
lacIp,0.3333333333333333,2,2,GACGCTGATAGCCTGTTCCA,0,2086257
lacIp,0.3333333333333333,2,2,GACGCTGAGTTTTGCTTCTC,0,2097115
lacIp,0.3333333333333333,2,2,GACGAAGCCTAGGCAGAACT,0,2100280
lacIp,0.3333333333333333,2,2,GACAGCTGAAGAACACCCGT,0,2110945
lacIp,0.3333333333333333,2,2,GAATTTGAGCAGCATCAATC,0,2115216
lacIp,0.3333333333333333,2,2,GAATTGAGATCTTTAAGTGA,0,2095804
lacIp,0.3333333333333333,2,2,GAATTATCTCGGCCGGGATT,0,2104637
lacIp,0.3333333333333333,2,2,GAAGTCCCGCAGATACGCGA,0,2108828
lacIp,0.3333333333333333,2,2,GAAGGACAGGCTTGACGAGG,0,2090411
lacIp,0.3333333333333333,2,2,GAAGATCTTAGCCCGCCGTT,0,2098755
lacIp,0.3333333333333333,2,2,GAAGAACGCCTTGGAGCGGC,0,2099705
lacIp,0.3333333333333333,2,2,GAACTAACCCGGGCGGATAC,0,2101941
lacIp,0.3333333333333333,2,2,GAACGTGGACACGACCTCAA,0,2116084
lacIp,0.3333333333333333,2,2,GAACGGTGAAGTGATGCTAC,0,2106724
lacIp,0.3333333333333333,2,2,GAACAACGCGCTCCCTTAGA,0,2102038
lacIp,0.3333333333333333,2,2,GAAATGCCACGGGCAGTGGC,0,2105225
lacIp,0.3333333333333333,2,2,CTTTCGTTCTGGCTAGAATC,0,2121456
lacIp,0.3333333333333333,2,2,CTTTCCAGTAAGCACTGCTC,0,2099870
lacIp,0.3333333333333333,2,2,CTTGCTACAGTTAATAAAAT,0,2108985
lacIp,0.3333333333333333,2,2,CTTGAGCCGTACAATGAGCA,0,2087286
lacIp,0.3333333333333333,2,2,CTTCTCCTTTTGCCCGAATT,0,2102094
lacIp,0.3333333333333333,2,2,CTTCGGAGAAGAAATAAACT,0,2095258
lacIp,0.3333333333333333,2,2,CTTCGCTGGGGACTCAGAAT,0,2091256
lacIp,0.3333333333333333,2,2,CTTCAGTGGTCCTAAGCTAA,0,2119445
lacIp,0.3333333333333333,2,2,CTTATGGCTTCCATACTTGA,0,2102146
lacIp,0.3333333333333333,2,2,CTGTGGTTAACGGAGGTCCT,0,2105406
lacIp,0.3333333333333333,2,2,CTGTGGTCTTGTTCAAGTGG,0,2087971
lacIp,0.3333333333333333,2,2,CTGTGGTATCTGGCCCCCAC,0,2091989
lacIp,0.3333333333333333,2,2,CTGTCGGATTTGAGTGAAGT,0,2087537
lacIp,0.3333333333333333,2,2,CTGTAGCTCATCGGAATCCA,0,2087843
lacIp,0.3333333333333333,2,2,CTGTAAGGGGCACCTTCATA,0,2116671
lacIp,0.3333333333333333,2,2,CTGGTGGTCACTGCGAGTCC,0,2088391
lacIp,0.3333333333333333,2,2,CTGGTCTAGTTACGATAGAT,0,2121107
lacIp,0.3333333333333333,2,2,CTGGTCATATGGGAGTTCTC,0,2089274
lacIp,0.3333333333333333,2,2,CTGGGCAGAAACAAAAGTTT,0,2090415
lacIp,0.3333333333333333,2,2,CTGCCGTATCCAGGAAATTT,0,2110845
lacIp,0.3333333333333333,2,2,CTGCAACAGGGCAACAGTTG,0,2109924
lacIp,0.3333333333333333,2,2,CTGATGCTTCTCGTGTGAAA,0,2093366
lacIp,0.3333333333333333,2,2,CTGAGTTTATCAAAGTTTTA,0,2114241
lacIp,0.3333333333333333,2,2,CTGAGTCCACCGCGTTGAGG,0,2103971
lacIp,0.3333333333333333,2,2,CTGAGCCCATCGAACACACA,0,2097379
lacIp,0.3333333333333333,2,2,CTGAGATCGCCTGAGGTGGT,0,2093787
lacIp,0.3333333333333333,2,2,CTGAAGTCGCGCCCGATACC,0,2105696
lacIp,0.3333333333333333,2,2,CTCTTCGCGAGCAACCTTAC,0,2115102
lacIp,0.3333333333333333,2,2,CTCTGTGAACTTGTGCGGGA,0,2089353
lacIp,0.3333333333333333,2,2,CTCTGCGCTGCCGTCAGTTA,0,2088372
lacIp,0.3333333333333333,2,2,CTCCTCCCGAACGTATCTCA,0,2085984
lacIp,0.3333333333333333,2,2,CTCCTCCATTCCTCTCTAGT,0,2110516
lacIp,0.3333333333333333,2,2,CTCCCGAGGATGGACACACT,0,2089195
lacIp,0.3333333333333333,2,2,CTCATGCGATGCGCAGGGGT,0,2113686
lacIp,0.3333333333333333,2,2,CTCAGGCATAACCGAGAGCC,0,2103850
lacIp,0.3333333333333333,2,2,CTCAGCCCAGACTTCCCTGC,0,2103149
lacIp,0.3333333333333333,2,2,CTATGAAAGAGAGGCAGGTT,0,2090940
lacIp,0.3333333333333333,2,2,CTATCGGCAAAGTAAACGGT,0,2117094
lacIp,0.3333333333333333,2,2,CTATACGCGCTCGTGCATTA,0,2108083
lacIp,0.3333333333333333,2,2,CTAGGCAGCAAGTCCCTGTA,0,2100797
lacIp,0.3333333333333333,2,2,CTAGGACGCTTCCCGTCTTT,0,2108270
lacIp,0.3333333333333333,2,2,CTAGCTCAAACACTCGGGTC,0,2115387
lacIp,0.3333333333333333,2,2,CTAGCGAAAGAAGGGCGATT,0,2110663
lacIp,0.3333333333333333,2,2,CTAGAAATGGGGCTTGCTTT,0,2103151
lacIp,0.3333333333333333,2,2,CTACCTAAGAATTCTAACGG,0,2104352
lacIp,0.3333333333333333,2,2,CTACCCATCACAGCGGGAGA,0,2096831
lacIp,0.3333333333333333,2,2,CTAAGGAAGCAACCAACCTA,0,2119547
lacIp,0.3333333333333333,2,2,CTAACCTTGGGGAGTAATAG,0,2088259
lacIp,0.3333333333333333,2,2,CGTTTAAGCGAATTGAATGA,0,2095435
lacIp,0.3333333333333333,2,2,CGTTGTGGTTGCGTCGTATG,0,2086455
lacIp,0.3333333333333333,2,2,CGTTGGGCGTCCAAGCCGCC,0,2088804
lacIp,0.3333333333333333,2,2,CGTTATTTGGGTACTGCGTC,0,2090978
lacIp,0.3333333333333333,2,2,CGTGTCTGCCTGTCGCGACG,0,2087410
lacIp,0.3333333333333333,2,2,CGTGGTTCGAAGCGCTGTTT,0,2104377
lacIp,0.3333333333333333,2,2,CGTGCGCTGATATACCATCG,0,2116264
lacIp,0.3333333333333333,2,2,CGTCGTCCCCGCCTTTGACT,0,2099963
lacIp,0.3333333333333333,2,2,CGTATACACACAAGGCGGAG,0,2085989
lacIp,0.3333333333333333,2,2,CGGTGATTGGACGTCTCGGA,0,2097273
lacIp,0.3333333333333333,2,2,CGGGCCGACTGGAATAATGT,0,2090374
lacIp,0.3333333333333333,2,2,CGGCTTCGTGAGGTCATTGA,0,2103497
lacIp,0.3333333333333333,2,2,CGGCGCTAATTTAGATCTGT,0,2086944
lacIp,0.3333333333333333,2,2,CGGCCTAAACTACGCATCGA,0,2117653
lacIp,0.3333333333333333,2,2,CGGCCGGGTGGAGTGGTGGA,0,2107501
lacIp,0.3333333333333333,2,2,CGGCAGGCGTCCCCGAGGCT,0,2089554
lacIp,0.3333333333333333,2,2,CGGCACGAGCACCCGCCGCT,0,2092062
lacIp,0.3333333333333333,2,2,CGGATACTAGGTTACGGCTA,0,2088047
lacIp,0.3333333333333333,2,2,CGGAGGCCTGTATGTAGAAA,0,2094106
lacIp,0.3333333333333333,2,2,CGGACACTTGTACCATAGGC,0,2108738
lacIp,0.3333333333333333,2,2,CGGACACGTGGGTGAATCGT,0,2089384
lacIp,0.3333333333333333,2,2,CGGAACCCGAGAGAGTAGCT,0,2100257
lacIp,0.3333333333333333,2,2,CGCTGCAATTTGCTATGCTT,0,2096765
lacIp,0.3333333333333333,2,2,CGCGTATCAGCCCCACAACG,0,2092093
lacIp,0.3333333333333333,2,2,CGCGGAGACGCGAGATCGGG,0,2095593
lacIp,0.3333333333333333,2,2,CGCGAGGGGAATGCACCGCT,0,2087849
lacIp,0.3333333333333333,2,2,CGCCTCTGCGGCTCTCAGCC,0,2089045
lacIp,0.3333333333333333,2,2,CGCCGCTAAACCTTTCCGGT,0,2100949
lacIp,0.3333333333333333,2,2,CGCCGACCAGGGACGAGTTT,0,2103805
lacIp,0.3333333333333333,2,2,CGCCATGTCCGCCTGGAGTT,0,2107932
lacIp,0.3333333333333333,2,2,CGCCAATCCCAGAAGCAGTC,0,2087248
lacIp,0.3333333333333333,2,2,CGATTTAATAATGAGCGCTA,0,2117478
lacIp,0.3333333333333333,2,2,CGAGGGCGAACTTGTCCTGT,0,2111962
lacIp,0.3333333333333333,2,2,CGAGGATACGGGGACTGGGA,0,2086373
lacIp,0.3333333333333333,2,2,CGAGGAACGTTACGCAGTTC,0,2116557
lacIp,0.3333333333333333,2,2,CGAGACTCAAACGGACATTA,0,2114575
lacIp,0.3333333333333333,2,2,CGACTCTGAACTTGGAGTTC,0,2104077
lacIp,0.3333333333333333,2,2,CGACTCCGCAAACTATCGGG,0,2093340
lacIp,0.3333333333333333,2,2,CGACGAATGTCGGGAGGTAG,0,2089550
lacIp,0.3333333333333333,2,2,CGAATTTAATGTTAGTGAAG,0,2110126
lacIp,0.3333333333333333,2,2,CGAATACAGCTCTACCCGTG,0,2100484
lacIp,0.3333333333333333,2,2,CGAACTGACATATATGGTAT,0,2092994
lacIp,0.3333333333333333,2,2,CGAACCGGTGAGGATCGCTT,0,2099469
lacIp,0.3333333333333333,2,2,CCTTGGCATCCGGGGCGCTA,0,2113508
lacIp,0.3333333333333333,2,2,CCTGTAAATCAATCATGCCT,0,2099367
lacIp,0.3333333333333333,2,2,CCTGGTCATTAACCGAGTTG,0,2098181
lacIp,0.3333333333333333,2,2,CCTGGCATATTTTCGGTACA,0,2088746
lacIp,0.3333333333333333,2,2,CCTCTGCCGATTAGCAACAG,0,2096401
lacIp,0.3333333333333333,2,2,CCTCCTTGAAGGTTGCTCTG,0,2111931
lacIp,0.3333333333333333,2,2,CCTCCGACTGCTGACTCAGA,0,2100481
lacIp,0.3333333333333333,2,2,CCTATTAACCAAAATGCCGT,0,2109823
lacIp,0.3333333333333333,2,2,CCTATCATCTAGTAGGAACA,0,2095485
lacIp,0.3333333333333333,2,2,CCTACCCGTATCGATATCTC,0,2104504
lacIp,0.3333333333333333,2,2,CCGTGATAAGCGTCTCGTCT,0,2088392
lacIp,0.3333333333333333,2,2,CCGTGACCAACGGCATATAT,0,2100625
lacIp,0.3333333333333333,2,2,CCGGTACTCTCACGCGCTTA,0,2097637
lacIp,0.3333333333333333,2,2,CCGGTAATGAGTCTTTCGAA,0,2100021
lacIp,0.3333333333333333,2,2,CCGGGTCCTACGCACCATCC,0,2100728
lacIp,0.3333333333333333,2,2,CCGGATGACTACGCCCAGTA,0,2113964
lacIp,0.3333333333333333,2,2,CCGGAAGGCGCCCACTCAAC,0,2093758
lacIp,0.3333333333333333,2,2,CCGCGAACAATAGTAAGGAC,0,2093095
lacIp,0.3333333333333333,2,2,CCGCCGGAGGAGGTGATAGA,0,2112616
lacIp,0.3333333333333333,2,2,CCGCAACCGACCGGTACTAT,0,2086757
lacIp,0.3333333333333333,2,2,CCGAGGGGAGGGTAACGGTA,0,2089962
lacIp,0.3333333333333333,2,2,CCGAAGTTTGGAGACTACTT,0,2090347
lacIp,0.3333333333333333,2,2,CCCTTCGTGCCGCGAAATAT,0,2115287
lacIp,0.3333333333333333,2,2,CCCTCCAGCACATTGTAAAC,0,2091261
lacIp,0.3333333333333333,2,2,CCCTAAAGTAACAATTGTGT,0,2093140
lacIp,0.3333333333333333,2,2,CCCGCGGGGGTGTTGTGAGT,0,2116565
lacIp,0.3333333333333333,2,2,CCCGAGGCGAGGTTTTAGCT,0,2103825
lacIp,0.3333333333333333,2,2,CCCCATGCACCCCTGGGACA,0,2096798
lacIp,0.3333333333333333,2,2,CCCAGGCGCGCTGTACACTT,0,2114221
lacIp,0.3333333333333333,2,2,CCCACCTATCTAGACTGGTA,0,2101584
lacIp,0.3333333333333333,2,2,CCCACACAAGAGCATCTGGG,0,2118473
lacIp,0.3333333333333333,2,2,CCATTGTATCCTAAAAGTAT,0,2111459
lacIp,0.3333333333333333,2,2,CCATGTGCGACTGTTCCTGG,0,2100710
lacIp,0.3333333333333333,2,2,CCATGGATCTGTTGAAGACG,0,2099229
lacIp,0.3333333333333333,2,2,CCATGCAGGCATATCGCAAA,0,2086176
lacIp,0.3333333333333333,2,2,CCATAAGTCTGGCACTTTTT,0,2113398
lacIp,0.3333333333333333,2,2,CCAGTGTATTGCTGCAGTTT,0,2102841
lacIp,0.3333333333333333,2,2,CCAGTACAGTCCATGTCCAC,0,2097541
lacIp,0.3333333333333333,2,2,CCAGCCATGACAGGTGGTCG,0,2085719
lacIp,0.3333333333333333,2,2,CCACTGGGCAATCGTATCAA,0,2090637
lacIp,0.3333333333333333,2,2,CCACACTTTCACAGTGGGAT,0,2088921
lacIp,0.3333333333333333,2,2,CATTTTTGCGGATCTGCTAG,0,2086880
lacIp,0.3333333333333333,2,2,CATTTAACGAGGTGCCGAAT,0,2117996
lacIp,0.3333333333333333,2,2,CATTGAACAAATACGAGAAT,0,2111839
lacIp,0.3333333333333333,2,2,CATTCAGACTGCACACGTAA,0,2096163
lacIp,0.3333333333333333,2,2,CATGTTAAACAGATTGGTGA,0,2118220
lacIp,0.3333333333333333,2,2,CATCGTACACGCATACTGCG,0,2113985
lacIp,0.3333333333333333,2,2,CATCCGAATCGCAAGTGCAT,0,2113147
lacIp,0.3333333333333333,2,2,CATCATGTACTCCCTCAGAG,0,2114192
lacIp,0.3333333333333333,2,2,CATCATCTCGGTCGCACTTT,0,2091088
lacIp,0.3333333333333333,2,2,CATACGGACTGGATGTCACT,0,2094617
lacIp,0.3333333333333333,2,2,CATACATGTATAAAGTCAAC,0,2115584
lacIp,0.3333333333333333,2,2,CAGGTTTCAGGCCTCCCAGG,0,2110223
lacIp,0.3333333333333333,2,2,CAGGGTGTGCCCGAGATAAT,0,2106372
lacIp,0.3333333333333333,2,2,CAGGGGGCGGACGCGCGGTA,0,2102537
lacIp,0.3333333333333333,2,2,CAGGCTTGCGCACCCGTGGC,0,2088250
lacIp,0.3333333333333333,2,2,CAGCTCGACCGCATAATCCG,0,2111528
lacIp,0.3333333333333333,2,2,CAGCGACATCAGTACCCTCG,0,2114638
lacIp,0.3333333333333333,2,2,CAGCCTAGGAAATGCCCCTG,0,2107939
lacIp,0.3333333333333333,2,2,CAGCCGGCTTTACAGACCTT,0,2115736
lacIp,0.3333333333333333,2,2,CAGCCCCTACGCAATTGGCC,0,2117962
lacIp,0.3333333333333333,2,2,CAGAGGTAAAGCACCCATAT,0,2109900
lacIp,0.3333333333333333,2,2,CAGACGTTCGGGTACTCACC,0,2093541
lacIp,0.3333333333333333,2,2,CAGAAGGTGTGTACACAGCT,0,2115980
lacIp,0.3333333333333333,2,2,CACTTCTAAAATTGTGCACG,0,2110007
lacIp,0.3333333333333333,2,2,CACTCTCGACACTAAAGAAT,0,2095462
lacIp,0.3333333333333333,2,2,CACTACCAGGGTAGATATTA,0,2104677
lacIp,0.3333333333333333,2,2,CACGTTACGAAGACTGCCTT,0,2099119
lacIp,0.3333333333333333,2,2,CACGTCGAACCCGTGGGGAT,0,2118417
lacIp,0.3333333333333333,2,2,CACGAGTTTTTTTGCAGTCA,0,2090188
lacIp,0.3333333333333333,2,2,CACCTGGCCCTACTTCGTAC,0,2105215
lacIp,0.3333333333333333,2,2,CACCGTTCGACGGAGTATTG,0,2095374
lacIp,0.3333333333333333,2,2,CACCGTGCGCAGGAGGTGAG,0,2098297
lacIp,0.3333333333333333,2,2,CACCGGGGAGTTAAGTATGG,0,2120390
lacIp,0.3333333333333333,2,2,CACCAGGGCCTCGGTAAACA,0,2116461
lacIp,0.3333333333333333,2,2,CACATTAATACATAGTTTCC,0,2087559
lacIp,0.3333333333333333,2,2,CACATGATGGTATAATCCCG,0,2120781
lacIp,0.3333333333333333,2,2,CAATGTCTCTGCGAGTGTCA,0,2086688
lacIp,0.3333333333333333,2,2,CAATCTCCGGCGTACACTGA,0,2088200
lacIp,0.3333333333333333,2,2,CAATAGAATTATAATAGCAT,0,2087304
lacIp,0.3333333333333333,2,2,CAAGTAGACGAGGCTACGTA,0,2108878
lacIp,0.3333333333333333,2,2,CAAGGTTGAGGGGCGTGTGA,0,2094713
lacIp,0.3333333333333333,2,2,CAAGGTTCGAGGCGTTGGAG,0,2090597
lacIp,0.3333333333333333,2,2,CAAGGGGTCTCTGCGGCCGC,0,2091679
lacIp,0.3333333333333333,2,2,CAACCAGAATAACGGTTTTC,0,2097758
lacIp,0.3333333333333333,2,2,CAAATTTTCGCTAAGGCATG,0,2117560
lacIp,0.3333333333333333,2,2,CAAATTCGTCCGTGGCTTCG,0,2110711
lacIp,0.3333333333333333,2,2,CAAATGATATTCCGCTAATT,0,2108294
lacIp,0.3333333333333333,2,2,CAAAGTCGCCTCCAGTGTGT,0,2093789
lacIp,0.3333333333333333,2,2,ATTTTTTTTTGTGTAAAATT,0,2118256
lacIp,0.3333333333333333,2,2,ATTTAGATCAAGAAACGGCA,0,2121716
lacIp,0.3333333333333333,2,2,ATTGTACGCCCGTCAGGTTC,0,2110135
lacIp,0.3333333333333333,2,2,ATTGGCAACAAGGAGTGGTA,0,2096538
lacIp,0.3333333333333333,2,2,ATTGAGGTTCCAGATCTCGC,0,2101215
lacIp,0.3333333333333333,2,2,ATTCTAACGCACGACACCAA,0,2119625
lacIp,0.3333333333333333,2,2,ATTCGTTCAAGGTCTTCTGA,0,2091971
lacIp,0.3333333333333333,2,2,ATTCCCATCATAAGCCCCAC,0,2116501
lacIp,0.3333333333333333,2,2,ATTCCAAGAAATAGCACTCA,0,2095445
lacIp,0.3333333333333333,2,2,ATTCAGTGGTCTGCGGAGTC,0,2109902
lacIp,0.3333333333333333,2,2,ATTCACGAGCGCGACCAATG,0,2100599
lacIp,0.3333333333333333,2,2,ATGTTGGGATATATTCGTAA,0,2113688
lacIp,0.3333333333333333,2,2,ATGTCCCCCGTGCATCGGGA,0,2099200
lacIp,0.3333333333333333,2,2,ATGGTGTTGCGTGTGTCGGG,0,2088675
lacIp,0.3333333333333333,2,2,ATGGTCTTTGACGAAGTGGA,0,2099877
lacIp,0.3333333333333333,2,2,ATGGGGCTTCGCATGGCAGT,0,2097608
lacIp,0.3333333333333333,2,2,ATGGGCAGAAATCGTAGGGT,0,2114891
lacIp,0.3333333333333333,2,2,ATGGCTTCGCGAAGGTAAGT,0,2095929
lacIp,0.3333333333333333,2,2,ATGGATTCGTAATGTAATTG,0,2101508
lacIp,0.3333333333333333,2,2,ATGCTGACCGCATAAATCAA,0,2114347
lacIp,0.3333333333333333,2,2,ATGCCCGGTACGGTTTAAGT,0,2086777
lacIp,0.3333333333333333,2,2,ATGATTACAAGGGCATGTTA,0,2097311
lacIp,0.3333333333333333,2,2,ATGAGGCATCCTCCTCGCGC,0,2122367
lacIp,0.3333333333333333,2,2,ATGAATCAGGGTAGAGACAT,0,2110308
lacIp,0.3333333333333333,2,2,ATCGGTAGGATTTAAGTAAA,0,2112981
lacIp,0.3333333333333333,2,2,ATCGGCAGCGTACCCGGGCA,0,2092336
lacIp,0.3333333333333333,2,2,ATCCTGCGCCATAGTCTGTC,0,2108694
lacIp,0.3333333333333333,2,2,ATCCTACATCCTTCATAGAT,0,2097738
lacIp,0.3333333333333333,2,2,ATCCGTAGAGTGGAAGGTGG,0,2088742
lacIp,0.3333333333333333,2,2,ATCCGATGCTCATAATTTTC,0,2090719
lacIp,0.3333333333333333,2,2,ATCATAACGACTCCTACGCA,0,2120079
lacIp,0.3333333333333333,2,2,ATCAACTTTCTCCAAGAGAT,0,2102716
lacIp,0.3333333333333333,2,2,ATATCATATGGCGAACGAGC,0,2086523
lacIp,0.3333333333333333,2,2,ATATAGAATTAAAATAGGGA,0,2092693
lacIp,0.3333333333333333,2,2,ATAATATCGGTAACTGCAAG,0,2087237
lacIp,0.3333333333333333,2,2,ATAATACGATCGGCGGGATT,0,2108655
lacIp,0.3333333333333333,2,2,AGTTGGCTGTATTCTCGATA,0,2115633
lacIp,0.3333333333333333,2,2,AGTTCCCTCGTCCAATACGT,0,2119877
lacIp,0.3333333333333333,2,2,AGTTATTCTCGGGTCTTAGT,0,2117991
lacIp,0.3333333333333333,2,2,AGTTAGTACGATGAAGACGG,0,2098866
lacIp,0.3333333333333333,2,2,AGTGTGGTACGACCATTCGC,0,2107137
lacIp,0.3333333333333333,2,2,AGTGCGGGTGTCGGTTAAAA,0,2090844
lacIp,0.3333333333333333,2,2,AGTCACCCGTACGACCATCA,0,2103228
lacIp,0.3333333333333333,2,2,AGTCAAGGAAGCTGACTTCC,0,2100936
lacIp,0.3333333333333333,2,2,AGTCAAAATGACACGCCCTA,0,2110077
lacIp,0.3333333333333333,2,2,AGTATCGTACCGACGATCCA,0,2115692
lacIp,0.3333333333333333,2,2,AGTACGGGTAGTAGGCAATC,0,2097241
lacIp,0.3333333333333333,2,2,AGTAAACAGAGCAAGTTGGT,0,2094508
lacIp,0.3333333333333333,2,2,AGGTTCGATCTCAGACATTG,0,2105473
lacIp,0.3333333333333333,2,2,AGGTTACTGATAGAAGGCGT,0,2112236
lacIp,0.3333333333333333,2,2,AGGTCTAATGGGCGGATATT,0,2107705
lacIp,0.3333333333333333,2,2,AGGTCCGACAAACTCCCGAG,0,2117759
lacIp,0.3333333333333333,2,2,AGGTCATCTTCGAAGTATAT,0,2109164
lacIp,0.3333333333333333,2,2,AGGTCACGGGCGTGTGGGAA,0,2086950
lacIp,0.3333333333333333,2,2,AGGTCAATGATAGAATCGTC,0,2112412
lacIp,0.3333333333333333,2,2,AGGTATGGCGATCAGGATCA,0,2110291
lacIp,0.3333333333333333,2,2,AGGTACGGGTGGATTCTGAC,0,2102408
lacIp,0.3333333333333333,2,2,AGGGTAAGCTATCTTCAGCT,0,2100761
lacIp,0.3333333333333333,2,2,AGGGGATGTGTGGCTCTCGA,0,2102989
lacIp,0.3333333333333333,2,2,AGGGGAAACGTCTGTTGGGT,0,2103227
lacIp,0.3333333333333333,2,2,AGGGCGACGAACGATTAGTA,0,2106222
lacIp,0.3333333333333333,2,2,AGGGAAAAAAGGAAGCTTCC,0,2099420
lacIp,0.3333333333333333,2,2,AGGAGACTCCAGGCCAGAGC,0,2118351
lacIp,0.3333333333333333,2,2,AGGACCTACGCGCCTAAGAA,0,2091305
lacIp,0.3333333333333333,2,2,AGGACCCTCGCCGTGTCAAA,0,2086939
lacIp,0.3333333333333333,2,2,AGCTTGCGCTTCGAGCTCCA,0,2111353
lacIp,0.3333333333333333,2,2,AGCTGGCGGGAAGGGATGAC,0,2089882
lacIp,0.3333333333333333,2,2,AGCTGATTTTTATCCCCCTA,0,2107617
lacIp,0.3333333333333333,2,2,AGCTCGGAATTCTGGAAGAT,0,2114712
lacIp,0.3333333333333333,2,2,AGCTCATCTTATCCTATTAC,0,2102994
lacIp,0.3333333333333333,2,2,AGCGTGGTTCAGATCGAAAC,0,2090032
lacIp,0.3333333333333333,2,2,AGCGTATCGCACGCTACTTC,0,2113826
lacIp,0.3333333333333333,2,2,AGCGATGTTTATGAGGACTT,0,2092020
lacIp,0.3333333333333333,2,2,AGCCTGGACAGTTACCATTT,0,2095021
lacIp,0.3333333333333333,2,2,AGCCTGAGAGCAAAATGTTG,0,2087968
lacIp,0.3333333333333333,2,2,AGCCCTACGCTTAGCGTTTA,0,2104483
lacIp,0.3333333333333333,2,2,AGCCACAAATGATATTGCAT,0,2099709
lacIp,0.3333333333333333,2,2,AGCACTCAGGTGCTTTATGC,0,2090102
lacIp,0.3333333333333333,2,2,AGCACACATCGAGTATACTT,0,2091496
lacIp,0.3333333333333333,2,2,AGATCAGGGGACGCGTCTCT,0,2088498
lacIp,0.3333333333333333,2,2,AGATATTATAAATTCCCGTT,0,2088054
lacIp,0.3333333333333333,2,2,AGATACACTGGAACGGGTTG,0,2102958
lacIp,0.3333333333333333,2,2,AGATAATGGCGGGCCACACA,0,2098677
lacIp,0.3333333333333333,2,2,AGAGTGCCTGATGTCGGACT,0,2107169
lacIp,0.3333333333333333,2,2,AGAGTAATGCTGCTGTATCA,0,2107703
lacIp,0.3333333333333333,2,2,AGAGGCTTGCCCGCTCCTGA,0,2108533
lacIp,0.3333333333333333,2,2,AGAGACCCAGTATGAGTGCA,0,2096449
lacIp,0.3333333333333333,2,2,AGAGACAAGTATAGATGAAC,0,2105646
lacIp,0.3333333333333333,2,2,AGACAGGTTATATTAACCGC,0,2108390
lacIp,0.3333333333333333,2,2,AGAATAAATCAGCGTTTCGC,0,2108744
lacIp,0.3333333333333333,2,2,AGAAGTTCCCACACTGGATA,0,2120447
lacIp,0.3333333333333333,2,2,AGAAGCCTCCGACCATACTA,0,2093662
lacIp,0.3333333333333333,2,2,ACTTTCCGATCCAAAAGTCG,0,2094191
lacIp,0.3333333333333333,2,2,ACTTTCCAGAATGATAGTAT,0,2102830
lacIp,0.3333333333333333,2,2,ACTTAATAGCCTCCTGTTTT,0,2118352
lacIp,0.3333333333333333,2,2,ACTGGCGTTTAATATGCTCT,0,2098679
lacIp,0.3333333333333333,2,2,ACTATTATGTTTGAGATCCC,0,2096319
lacIp,0.3333333333333333,2,2,ACTAAGTATATTTGTAGGAG,0,2118163
lacIp,0.3333333333333333,2,2,ACGTTGGCAACATTGGCTCT,0,2102697
lacIp,0.3333333333333333,2,2,ACGTTAGCAATAAGCATGCC,0,2121009
lacIp,0.3333333333333333,2,2,ACGTATACTCACGGCAATGG,0,2086083
lacIp,0.3333333333333333,2,2,ACGTAGAGTGCAAACCTCGA,0,2118758
lacIp,0.3333333333333333,2,2,ACGGGTTGCCAGTCCTACTA,0,2108281
lacIp,0.3333333333333333,2,2,ACGGCGTTAATGACTCCCGA,0,2098709
lacIp,0.3333333333333333,2,2,ACGGAATGACGTTTTCATTC,0,2090818
lacIp,0.3333333333333333,2,2,ACGCTCTTCACGGTACTACC,0,2101457
lacIp,0.3333333333333333,2,2,ACGCATGGGGGATGAAGGTG,0,2097074
lacIp,0.3333333333333333,2,2,ACGAGAGATTTAACAACCAC,0,2122194
lacIp,0.3333333333333333,2,2,ACGACGGTGCTACGACATAG,0,2121067
lacIp,0.3333333333333333,2,2,ACCTTTTGTCGAACGCTAAC,0,2087023
lacIp,0.3333333333333333,2,2,ACCTGGGTTTCCCGGGGTCG,0,2106144
lacIp,0.3333333333333333,2,2,ACCTACAAGGATGTGCTAGC,0,2090780
lacIp,0.3333333333333333,2,2,ACCTAATGTGATTTGGTCCG,0,2116146
lacIp,0.3333333333333333,2,2,ACCGTAAGCCCTTCTCTCAA,0,2087145
lacIp,0.3333333333333333,2,2,ACCGGACGGTAATGACTCCA,0,2113007
lacIp,0.3333333333333333,2,2,ACCGCGCGTTAATGGACCAT,0,2104028
lacIp,0.3333333333333333,2,2,ACCCTAACGGGGACCTTCCA,0,2111465
lacIp,0.3333333333333333,2,2,ACCCGATCCACATGCTGTTG,0,2110848
lacIp,0.3333333333333333,2,2,ACCAGCCAATATGGGTAGAG,0,2092431
lacIp,0.3333333333333333,2,2,ACCACGAGCGTTTACCTGCC,0,2113396
lacIp,0.3333333333333333,2,2,ACCAAGTAATTGGTCGGACG,0,2104080
lacIp,0.3333333333333333,2,2,ACATGGTGGGCCGATCCCAG,0,2101822
lacIp,0.3333333333333333,2,2,ACATCGCTAGCACGGTTTGT,0,2093433
lacIp,0.3333333333333333,2,2,ACATACTAGGCCCGCGAAGC,0,2100854
lacIp,0.3333333333333333,2,2,ACACTGGATTTGGCTAGTGA,0,2096402
lacIp,0.3333333333333333,2,2,ACACGTTGTCGAGGGTCGGA,0,2091443
lacIp,0.3333333333333333,2,2,ACACGTGATTCTCATGTTGT,0,2108957
lacIp,0.3333333333333333,2,2,ACACCTGACCGGTGAAACTA,0,2102585
lacIp,0.3333333333333333,2,2,ACACACGACTGACAGAGAGA,0,2114517
lacIp,0.3333333333333333,2,2,ACAAAAAACGAGTATTTGTG,0,2106853
lacIp,0.3333333333333333,2,2,AATTCTACCTGGCATTAGGG,0,2117407
lacIp,0.3333333333333333,2,2,AATTCGTCACGTTATGACAT,0,2096912
lacIp,0.3333333333333333,2,2,AATTCGGGGCGTAGCTATTT,0,2097717
lacIp,0.3333333333333333,2,2,AATTCATCCCTCACGAAGGT,0,2093670
lacIp,0.3333333333333333,2,2,AATTAAATAATCAAACCAGA,0,2120648
lacIp,0.3333333333333333,2,2,AATTAAAACTGGTCTATGGG,0,2112394
lacIp,0.3333333333333333,2,2,AATGTTCTAAGGTTGCATCA,0,2114309
lacIp,0.3333333333333333,2,2,AATGTAACCAAACTGCCGAC,0,2109440
lacIp,0.3333333333333333,2,2,AATCTCCGAAGCCCGTCATG,0,2102285
lacIp,0.3333333333333333,2,2,AATCTACGGCAACCACTATT,0,2115230
lacIp,0.3333333333333333,2,2,AATCGACTTGTAGACTGGCA,0,2115202
lacIp,0.3333333333333333,2,2,AATCACTGTTGAGGCTTAAG,0,2088611
lacIp,0.3333333333333333,2,2,AATAGTGTCTCCGCCGGCCT,0,2089269
lacIp,0.3333333333333333,2,2,AAGTGCTCTGAGGATGTTTT,0,2122375
lacIp,0.3333333333333333,2,2,AAGTCGCTGGCGCTATATTA,0,2092646
lacIp,0.3333333333333333,2,2,AAGGTGAATTAGGTAAGGAA,0,2088644
lacIp,0.3333333333333333,2,2,AAGGAGCAGTAAAATTGTCT,0,2087399
lacIp,0.3333333333333333,2,2,AAGCTTCCTCTGCATGCCTA,0,2099569
lacIp,0.3333333333333333,2,2,AAGCGGCGACCAATGTCGGG,0,2109194
lacIp,0.3333333333333333,2,2,AAGCATTAGGAGTGACGAAA,0,2094568
lacIp,0.3333333333333333,2,2,AAGATCTCGCACAGGCTGTC,0,2090040
lacIp,0.3333333333333333,2,2,AAGAGCATTGTTGCAGATAC,0,2095315
lacIp,0.3333333333333333,2,2,AAGACCTCTGATGATGATTC,0,2113912
lacIp,0.3333333333333333,2,2,AAGAAATAGGTGAAAACACT,0,2109113
lacIp,0.3333333333333333,2,2,AACTTTTGCGTCTTCCAGAG,0,2120319
lacIp,0.3333333333333333,2,2,AACTTACAATGGGGGTGAAG,0,2088002
lacIp,0.3333333333333333,2,2,AACTGGAGCTGATACAGGTG,0,2121525
lacIp,0.3333333333333333,2,2,AACGTTGAGAACTAGGATGA,0,2105767
lacIp,0.3333333333333333,2,2,AACGGCGAATTCTTGCTGTT,0,2107783
lacIp,0.3333333333333333,2,2,AACCGATGTGCCGCAGAGGG,0,2093290
lacIp,0.3333333333333333,2,2,AACACCTTTTCGGTTATAGA,0,2121223
lacIp,0.3333333333333333,2,2,AACAAGAATCTCTTGCGTGT,0,2103041
lacIp,0.3333333333333333,2,2,AAATTTTTTGGACCAAACAG,0,2121020
lacIp,0.3333333333333333,2,2,AAATCAGTCGGGTTCTAAGA,0,2104755
lacIp,0.3333333333333333,2,2,AAATATTCTGATTTGCCAAA,0,2111940
lacIp,0.3333333333333333,2,2,AAAGTCAGGCAAGTAAGAGT,0,2111382
lacIp,0.3333333333333333,2,2,AAAGGTATAGGGCTACGCCA,0,2089060
lacIp,0.3333333333333333,2,2,AAAGCTTGCCTTTGGAAATC,0,2104484
lacIp,0.3333333333333333,2,2,AAAAGGCTCGAGATACGTTT,0,2118677
lacIp,0.3333333333333333,2,2,AAAAGGACCCACTGTTGGTT,0,2116166
lacIp,0.3333333333333333,2,2,AAAAGCCTACGTCATAAGCA,0,2106386
lacIp,0.5,1,1,TTTTTGGAAGATCGGGGAGT,0,2088271
lacIp,0.5,1,1,TTTTTGCGAGACGAAATTTT,0,2102030
lacIp,0.5,1,1,TTTTTAGCCGACATCCATGT,0,2103665
lacIp,0.5,1,1,TTTTTAGATGGCCCTCGATA,0,2105731
lacIp,0.5,1,1,TTTTGTGTCTACAATCAACC,0,2085871
lacIp,0.5,1,1,TTTTGGTTGCGGCAACATCT,0,2113266
lacIp,0.5,1,1,TTTTCGAGTGGTAGTCTAAA,0,2116921
lacIp,0.5,1,1,TTTTCCGCTGCTCACAACTA,0,2119892
lacIp,0.5,1,1,TTTTCACACACTCCTGAGGG,0,2088646
lacIp,0.5,1,1,TTTTAGTCAAACGGCTAGTT,0,2091826
lacIp,0.5,1,1,TTTTACCTATTGCCGTAGTA,0,2105208
lacIp,0.5,1,1,TTTGTAAGCATGTCGTGACC,0,2112919
lacIp,0.5,1,1,TTTGGTCCTTCGAAGTACTG,0,2088955
lacIp,0.5,1,1,TTTGGGCATTGAATCTGCAG,0,2114732
lacIp,0.5,1,1,TTTGGAAACAGTTAGAAGCA,0,2110998
lacIp,0.5,1,1,TTTGCTTATATTTTTCGTTG,0,2112332
lacIp,0.5,1,1,TTTGCCTTGGTTAATCGTTT,0,2095772
lacIp,0.5,1,1,TTTCTTTTCGAAAGAGGCGG,0,2100139
lacIp,0.5,1,1,TTTCTTGTTCGCGCGGCGGC,0,2112450
lacIp,0.5,1,1,TTTCTTGGGAGTGAAAAAGC,0,2105505
lacIp,0.5,1,1,TTTCGGATTTTGCTTGTTAG,0,2101283
lacIp,0.5,1,1,TTTCGCACCTAGACCTCAAA,0,2087554
lacIp,0.5,1,1,TTTCCTTTTTCGTGCACAAA,0,2103846
lacIp,0.5,1,1,TTTCCGTAAGGTCAGCTCAT,0,2120114
lacIp,0.5,1,1,TTTCATGCATGTCAACGGCT,0,2095878
lacIp,0.5,1,1,TTTCAGTCAACACATGGAAA,0,2088625
lacIp,0.5,1,1,TTTCAGAGTATGGAATCCGC,0,2099198
lacIp,0.5,1,1,TTTCACCCTTCAGTGGTAAA,0,2102222
lacIp,0.5,1,1,TTTATTGACTAGGGACCACC,0,2092496
lacIp,0.5,1,1,TTTATGGGTTTACAGGGCTG,0,2090980
lacIp,0.5,1,1,TTTATGCGAAGGTTGCGAAA,0,2107304
lacIp,0.5,1,1,TTTATGCCGCTCACACGTAT,0,2100753
lacIp,0.5,1,1,TTTATCTATCGTTTTTTGTT,0,2101127
lacIp,0.5,1,1,TTTATCGGGAGTATAACTAG,0,2091221
lacIp,0.5,1,1,TTTAGTTTTGTACAAGAGGC,0,2095554
lacIp,0.5,1,1,TTTAGGTTTGCTACGGAAGA,0,2118219
lacIp,0.5,1,1,TTTACTTTGCAACGTCAGTT,0,2111416
lacIp,0.5,1,1,TTTACTCCTGAGAGTCACAT,0,2085872
lacIp,0.5,1,1,TTTAATGATAAACACTCCCC,0,2087526
lacIp,0.5,1,1,TTTAAGCCATTATTGCAGAA,0,2106447
lacIp,0.5,1,1,TTTAACCGACGAATGAAAGG,0,2106895
lacIp,0.5,1,1,TTTAACCACTCTCATGTAGG,0,2091324
lacIp,0.5,1,1,TTTAAAAGTCCCGACCATGC,0,2097128
lacIp,0.5,1,1,TTGTTTTGTTTAAATGTTGT,0,2117915
lacIp,0.5,1,1,TTGTGTACTTCTTTCCTTCA,0,2119290
lacIp,0.5,1,1,TTGTGCTATTGGGTCATATT,0,2115503
lacIp,0.5,1,1,TTGTGCAATTGCGGAAACTT,0,2106138
lacIp,0.5,1,1,TTGTCTCTGATCAAGTTGAA,0,2103366
lacIp,0.5,1,1,TTGTCGTTGGTAGTTAGTGC,0,2117793
lacIp,0.5,1,1,TTGTCAGACGGGTCACTAGC,0,2107854
lacIp,0.5,1,1,TTGTAGGTATCTAAAGAAGG,0,2099125
lacIp,0.5,1,1,TTGTAACGGACCAGGCCTCT,0,2104710
lacIp,0.5,1,1,TTGTAACGCACCTGAAATAG,0,2087573
lacIp,0.5,1,1,TTGTAAACACACCTGGGATA,0,2103849
lacIp,0.5,1,1,TTGGTGTTAGCATAACTTTT,0,2112730
lacIp,0.5,1,1,TTGGTCGAGTGTGTACTTCC,0,2087862
lacIp,0.5,1,1,TTGGTCCTGAGTCTTAGCCA,0,2105937
lacIp,0.5,1,1,TTGGTACTAGAGGCGCGACT,0,2117645
lacIp,0.5,1,1,TTGGGTGCACTGCCTTACCG,0,2104189
lacIp,0.5,1,1,TTGGGGCGATTGGCGTAAAT,0,2111463
lacIp,0.5,1,1,TTGGGGACGTACTCTCGGCA,0,2113436
lacIp,0.5,1,1,TTGGGCAACGTTGTAAGGAG,0,2101846
lacIp,0.5,1,1,TTGGGAGCGCCATACTTATT,0,2107072
lacIp,0.5,1,1,TTGGCTAGGTCGGATTTGAT,0,2098350
lacIp,0.5,1,1,TTGGCGTCAGGGCTGCCTCA,0,2106768
lacIp,0.5,1,1,TTGGCGCGGCATACTAAAAT,0,2117750
lacIp,0.5,1,1,TTGGCCTTTGGGTAGCAATA,0,2086706
lacIp,0.5,1,1,TTGGATCGAAGAGTATATAT,0,2109280
lacIp,0.5,1,1,TTGGATATTTTGCTCGCGGA,0,2104039
lacIp,0.5,1,1,TTGGAGCTTCGGCAAGGTGC,0,2087684
lacIp,0.5,1,1,TTGGAGAGCGACTAATAACG,0,2105544
lacIp,0.5,1,1,TTGGAATCGGGTGTCATTAT,0,2107839
lacIp,0.5,1,1,TTGCTGCGGAGATGGACGCA,0,2103295
lacIp,0.5,1,1,TTGCTGCCCCTAAGGCGTTG,0,2099515
lacIp,0.5,1,1,TTGCTCTCGTGGGGACAACG,0,2095306
lacIp,0.5,1,1,TTGCTAGATGCCGTCTCAGA,0,2105787
lacIp,0.5,1,1,TTGCGTAGATTTAAGGAGGA,0,2096766
lacIp,0.5,1,1,TTGCGGGAATCAACATGTGC,0,2097466
lacIp,0.5,1,1,TTGCGACGAACATTGCAAGT,0,2105539
lacIp,0.5,1,1,TTGCCTTCGCACTGATCACA,0,2119310
lacIp,0.5,1,1,TTGCCGATCTAGCAGTGAAT,0,2106093
lacIp,0.5,1,1,TTGCCCGTTCAGGTATAGGA,0,2113917
lacIp,0.5,1,1,TTGCCAGCTTTGACCTGCAA,0,2089571
lacIp,0.5,1,1,TTGCAAATAGAAGCGCCAAC,0,2114723
lacIp,0.5,1,1,TTGCAAACCGAATATCCATA,0,2121569
lacIp,0.5,1,1,TTGATGAGAACCGCTCGTTG,0,2115055
lacIp,0.5,1,1,TTGATCTAAGTGTTTACAGT,0,2111836
lacIp,0.5,1,1,TTGATAGCTTGAGTGTCTAA,0,2114121
lacIp,0.5,1,1,TTGAGCTGCGTTGGGGGTCG,0,2110029
lacIp,0.5,1,1,TTGAGCAATCATCAGGTAAA,0,2122209
lacIp,0.5,1,1,TTGACTAATCGCCCATAATG,0,2108192
lacIp,0.5,1,1,TTGACGTCTACACCCTGTCA,0,2088952
lacIp,0.5,1,1,TTGAATGGGATCAGTCCACC,0,2096844
lacIp,0.5,1,1,TTCTTATACGAACATGGTCA,0,2121772
lacIp,0.5,1,1,TTCTTACAGACCTTAATTTT,0,2112496
lacIp,0.5,1,1,TTCTTAATCTTAGGTTGGAC,0,2089633
lacIp,0.5,1,1,TTCTGGGCGTCCGAAGCGGA,0,2093338
lacIp,0.5,1,1,TTCTGGACCTACATGCGTCA,0,2090676
lacIp,0.5,1,1,TTCTCTTTCCGGTACTATAT,0,2098425
lacIp,0.5,1,1,TTCTCGCTTGAAGGCGATAT,0,2113042
lacIp,0.5,1,1,TTCTATCGTGGGCAAGACAT,0,2093038
lacIp,0.5,1,1,TTCGTAGCCCTGGCCACCGT,0,2087881
lacIp,0.5,1,1,TTCGGTAGGATGGTATCGCA,0,2116307
lacIp,0.5,1,1,TTCGGTAAAGGGCCTACGTT,0,2103152
lacIp,0.5,1,1,TTCGGCGAAACGGGTGGGCC,0,2115432
lacIp,0.5,1,1,TTCGATAAGGTTCCCTACAT,0,2109511
lacIp,0.5,1,1,TTCGAGGCTGAACAAATAAA,0,2120161
lacIp,0.5,1,1,TTCGAGCTGCACCCGGGGGG,0,2101735
lacIp,0.5,1,1,TTCGAATTTCAGATATGATC,0,2102265
lacIp,0.5,1,1,TTCCTAGGAAATCAAGCCTG,0,2113463
lacIp,0.5,1,1,TTCCGAACCTTCGGCCGTTG,0,2087527
lacIp,0.5,1,1,TTCCCTAATCGGGGTGTAGT,0,2121979
lacIp,0.5,1,1,TTCCCCTGCAAGGGTAGTTG,0,2093219
lacIp,0.5,1,1,TTCCAAGTTCCCGCCTCCTA,0,2110258
lacIp,0.5,1,1,TTCATGTCAGAGCCTGGTGA,0,2110515
lacIp,0.5,1,1,TTCAGTACATTGGAACCGGT,0,2099025
lacIp,0.5,1,1,TTCACTCAAGGCCCGTCTAT,0,2111985
lacIp,0.5,1,1,TTCAATGACAGGGATCAATC,0,2092147
lacIp,0.5,1,1,TTCAATCGTGCCGTTTTGGT,0,2122269
lacIp,0.5,1,1,TTCAACGCGATCAGGTCCCT,0,2111763
lacIp,0.5,1,1,TTATTGGACCAGCTATTTTT,0,2097620
lacIp,0.5,1,1,TTATGTATTCGGTTGTTAAT,0,2096482
lacIp,0.5,1,1,TTATGGGTTAAGGAATAGTA,0,2092930
lacIp,0.5,1,1,TTATGGGGGCAGGTGTCCAG,0,2095206
lacIp,0.5,1,1,TTATGGATCGGTCAGCGGCT,0,2109135
lacIp,0.5,1,1,TTATGCCCCGGGAAATGACA,0,2098903
lacIp,0.5,1,1,TTATGAGAGTCCGATGTGGT,0,2108769
lacIp,0.5,1,1,TTATCATGAAAGGCTGGCAA,0,2111485
lacIp,0.5,1,1,TTATCATCCCCTTGGGCGGA,0,2100039
lacIp,0.5,1,1,TTAGTTGACTGGAGCCTATA,0,2088101
lacIp,0.5,1,1,TTAGTGATAAACCACACCTG,0,2120269
lacIp,0.5,1,1,TTAGTCTAAGCTAAGTGATG,0,2117156
lacIp,0.5,1,1,TTAGCGGGGTGCGTCGCAAG,0,2104555
lacIp,0.5,1,1,TTAGATTGTTCGGTAACCGT,0,2086691
lacIp,0.5,1,1,TTACTGCTCAATAATTTGTG,0,2115121
lacIp,0.5,1,1,TTACTAAGGGAAGCAATTAT,0,2106990
lacIp,0.5,1,1,TTACGTCTTGAGATCAGACG,0,2109569
lacIp,0.5,1,1,TTACGCGACCTTTCGGAACG,0,2108078
lacIp,0.5,1,1,TTACATTGAGGGAATATCAG,0,2093017
lacIp,0.5,1,1,TTACAGAGGGGTTTTTTGTA,0,2108607
lacIp,0.5,1,1,TTACACTACTTTTAAATAGT,0,2086284
lacIp,0.5,1,1,TTACAATGTTGAATGGGGAT,0,2086305
lacIp,0.5,1,1,TTACAACTCGACAGGATTAT,0,2102690
lacIp,0.5,1,1,TTAATGTATCTTTATGACAT,0,2092855
lacIp,0.5,1,1,TTAAGTCAGAAATAAGGGTG,0,2098457
lacIp,0.5,1,1,TTAAGACTGTGTTGGCACCT,0,2107752
lacIp,0.5,1,1,TTAACTGCAGGAAGCTAACC,0,2099519
lacIp,0.5,1,1,TTAACGTAGAGGGAACGCTG,0,2087866
lacIp,0.5,1,1,TTAACGTAAGAAAGTTGAAT,0,2096020
lacIp,0.5,1,1,TTAAATTAGGTTATAATACA,0,2118071
lacIp,0.5,1,1,TTAAAGATGTCAACCTCATC,0,2088715
lacIp,0.5,1,1,TTAAACTTTTCTCATTGCGA,0,2087848
lacIp,0.5,1,1,TGTTTGTGCAGAGCGTGCCC,0,2111152
lacIp,0.5,1,1,TGTTTGCGCCGGGGCGTCCA,0,2090792
lacIp,0.5,1,1,TGTTTCTTGCTAGGGGAGAT,0,2099450
lacIp,0.5,1,1,TGTTCTGCGGTATCTTACCA,0,2091561
lacIp,0.5,1,1,TGTTCAAGAAGGACGGATGC,0,2098989
lacIp,0.5,1,1,TGTTCAACATAGGTCGCTCA,0,2097552
lacIp,0.5,1,1,TGTTATAGAACCCGGATTGG,0,2114215
lacIp,0.5,1,1,TGTTAGTACGGGCCATCCCG,0,2088325
lacIp,0.5,1,1,TGTTAAACCACTTTAAACCA,0,2097264
lacIp,0.5,1,1,TGTGTGTCGGGGCGATATGT,0,2107233
lacIp,0.5,1,1,TGTGTGGAGTGGCCCCGCCT,0,2121092
lacIp,0.5,1,1,TGTGTATAGTCACGTCATTC,0,2121858
lacIp,0.5,1,1,TGTGGTGGCGCGTTGCACGG,0,2105821
lacIp,0.5,1,1,TGTGGTAAGGCGCGTAACGG,0,2099139
lacIp,0.5,1,1,TGTGGCAATACAAAGTACTT,0,2100185
lacIp,0.5,1,1,TGTGGATACATACTTTTTTA,0,2094166
lacIp,0.5,1,1,TGTGATGTCCTCGCCTAACG,0,2111933
lacIp,0.5,1,1,TGTGAGCTCAGGATTGTTCT,0,2110526
lacIp,0.5,1,1,TGTGAACCAATATCCAGCCG,0,2108858
lacIp,0.5,1,1,TGTCGGAAGACGCAAAACAA,0,2085755
lacIp,0.5,1,1,TGTCGAAGGAGATTAATGTT,0,2092014
lacIp,0.5,1,1,TGTCCTCGGATTAATTGTCC,0,2088541
lacIp,0.5,1,1,TGTCCTAGACTACCGGCTGT,0,2109188
lacIp,0.5,1,1,TGTCCGGGCACTTCAGCAAT,0,2111586
lacIp,0.5,1,1,TGTCCCATTAGCGAGAAGCA,0,2105431
lacIp,0.5,1,1,TGTCCAAAATCCCTATGCGT,0,2097484
lacIp,0.5,1,1,TGTCACGCAGCTTACTATTC,0,2096863
lacIp,0.5,1,1,TGTAGTTGCGATAGAATGAT,0,2115494
lacIp,0.5,1,1,TGTAGTGACGCGCGCGCGGA,0,2116145
lacIp,0.5,1,1,TGTAGCTGTCGTAGCCGTAG,0,2118069
lacIp,0.5,1,1,TGTAGAGACGTTTCTGGCCA,0,2104287
lacIp,0.5,1,1,TGTAATACTGAAAAAGATAT,0,2101490
lacIp,0.5,1,1,TGTAAGATTGCAGTGTCTTT,0,2094174
lacIp,0.5,1,1,TGGTTTTTAAATTGTCGTGG,0,2119155
lacIp,0.5,1,1,TGGTTTACTACTACTCAGGT,0,2099965
lacIp,0.5,1,1,TGGTTGTGGGGTCCGTGATT,0,2089421
lacIp,0.5,1,1,TGGTTGGGAAACGGAGTACA,0,2113171
lacIp,0.5,1,1,TGGTTGGCCGGTTCTGGAAT,0,2120414
lacIp,0.5,1,1,TGGTGACGGCATGTTGAGGT,0,2115392
lacIp,0.5,1,1,TGGTCACTGTAAGACGGGCG,0,2111450
lacIp,0.5,1,1,TGGTATGTCGAGACGCTGTG,0,2103796
lacIp,0.5,1,1,TGGTAGCGGTCTGATCAAAA,0,2107758
lacIp,0.5,1,1,TGGGTGTAAAGTCTGACAAA,0,2115911
lacIp,0.5,1,1,TGGGTGCGGCTGAGCCCTAA,0,2089070
lacIp,0.5,1,1,TGGGGTTGTACCGGACATGT,0,2088918
lacIp,0.5,1,1,TGGGGGTGTGTCGCATACGG,0,2101996
lacIp,0.5,1,1,TGGGGCCTTTTCACATGCCA,0,2100114
lacIp,0.5,1,1,TGGGCTTGGTCATGCCCCCG,0,2117438
lacIp,0.5,1,1,TGGGCGATGTCAGAGAAGGT,0,2115359
lacIp,0.5,1,1,TGGGACGGGCCGTGGAGTGC,0,2110835
lacIp,0.5,1,1,TGGGACCTATTAAGGCCGAA,0,2088207
lacIp,0.5,1,1,TGGCTCCTGGACATAGGAAT,0,2102208
lacIp,0.5,1,1,TGGCTAGCGACGTGTTATAA,0,2096209
lacIp,0.5,1,1,TGGCGTGGGGAACTTTAATA,0,2092501
lacIp,0.5,1,1,TGGCGTCAGTTGTAATGTAC,0,2089505
lacIp,0.5,1,1,TGGCGGTTAAATGGATGGCT,0,2110378
lacIp,0.5,1,1,TGGCGCCTTACCACCATACC,0,2117949
lacIp,0.5,1,1,TGGCGAGATCCGGTCCACCC,0,2088693
lacIp,0.5,1,1,TGGCGAATTCATATAAACGC,0,2095125
lacIp,0.5,1,1,TGGCCTAGGACGGGCCTACA,0,2101249
lacIp,0.5,1,1,TGGCCGTAGCGGGCGGCTTC,0,2113305
lacIp,0.5,1,1,TGGCCGAGGACCTCGCTAAG,0,2103528
lacIp,0.5,1,1,TGGCCATATTCGGCATCGGC,0,2091455
lacIp,0.5,1,1,TGGCATGGATAACTCGGAAT,0,2121587
lacIp,0.5,1,1,TGGCATCGGGCCTTTGCACC,0,2122390
lacIp,0.5,1,1,TGGCATATCCAAAGCTCGTG,0,2117402
lacIp,0.5,1,1,TGGCAGACAATTTCTCTCTG,0,2094585
lacIp,0.5,1,1,TGGATTCTCTGAGTTTAGGA,0,2085742
lacIp,0.5,1,1,TGGATAACCAGTCGCGATAT,0,2092173
lacIp,0.5,1,1,TGGAGATGACTCGATCCTAT,0,2089662
lacIp,0.5,1,1,TGGACCAACTACGAGCGGCG,0,2106248
lacIp,0.5,1,1,TGGAACCATCAGTAGGGAGA,0,2096613
lacIp,0.5,1,1,TGCTGCCCCCAGTCTCGTAG,0,2093109
lacIp,0.5,1,1,TGCTCAAATGCTCTCGAATG,0,2111777
lacIp,0.5,1,1,TGCTATCGTCATCAAAACAT,0,2108187
lacIp,0.5,1,1,TGCTATATACTGATCTGACG,0,2100651
lacIp,0.5,1,1,TGCTAGTACCCGTCCTCTGA,0,2114995
lacIp,0.5,1,1,TGCTACTGCAATGATGGACA,0,2103918
lacIp,0.5,1,1,TGCGTTGTGGTAGCTCTTCG,0,2105044
lacIp,0.5,1,1,TGCGTAGGACCTGACTACTA,0,2113553
lacIp,0.5,1,1,TGCGTAATCTTATCGACATG,0,2119722
lacIp,0.5,1,1,TGCGCTATGGATTCAAATAC,0,2096776
lacIp,0.5,1,1,TGCGCGGGCGCATGTGCCAG,0,2088449
lacIp,0.5,1,1,TGCGCATGTGAAACCCGCAT,0,2119955
lacIp,0.5,1,1,TGCGAACTTCTGTTCCGCGC,0,2098933
lacIp,0.5,1,1,TGCGAACCCGTATGCCTGAA,0,2115233
lacIp,0.5,1,1,TGCCGTGTCAACACCAGATA,0,2087217
lacIp,0.5,1,1,TGCCGCCTTATCATAGAGCT,0,2088915
lacIp,0.5,1,1,TGCCAGGCCAGTACATTCGC,0,2103351
lacIp,0.5,1,1,TGCATTACGACATACTTGCT,0,2111175
lacIp,0.5,1,1,TGCATGCTAAGGCAACGGAC,0,2117989
lacIp,0.5,1,1,TGCATGCACAGTTTAAGTTG,0,2112316
lacIp,0.5,1,1,TGCATAGGGGGGAAATGCCA,0,2122398
lacIp,0.5,1,1,TGCATAGCGATCCATTCCAC,0,2097986
lacIp,0.5,1,1,TGCATACCGGGGACGAGTCT,0,2103608
lacIp,0.5,1,1,TGCAGTACGGATCGCGGACT,0,2096745
lacIp,0.5,1,1,TGCAGGATTGCATGCGGTAA,0,2108287
lacIp,0.5,1,1,TGCAGCCCAGAAACACCCAC,0,2114292
lacIp,0.5,1,1,TGCAGCACTTAAGAAGCATA,0,2104208
lacIp,0.5,1,1,TGCACGCATATCGATGAAGA,0,2093763
lacIp,0.5,1,1,TGCACGAGTCCCATCATAGT,0,2111581
lacIp,0.5,1,1,TGCACCGCTGTCTTCCACGC,0,2106712
lacIp,0.5,1,1,TGCACCAGCAATTGGGTATG,0,2101428
lacIp,0.5,1,1,TGCAATACCCGGGTAATCTT,0,2121905
lacIp,0.5,1,1,TGCAAGGAATGTTGCCTCAC,0,2112174
lacIp,0.5,1,1,TGCAAGATGGTCACCCATGA,0,2092873
lacIp,0.5,1,1,TGCAAAAGGGCTCCGCATGT,0,2119860
lacIp,0.5,1,1,TGATTTTCAAGGTCGCCAAA,0,2095816
lacIp,0.5,1,1,TGATTTCATGGAGTGCAATT,0,2103205
lacIp,0.5,1,1,TGATTTCACCCTTTTCTGGC,0,2091223
lacIp,0.5,1,1,TGATTGTGAATTACATCGGG,0,2096479
lacIp,0.5,1,1,TGATTCCAACGATCACGGCT,0,2096649
lacIp,0.5,1,1,TGATGTCCCGGGAACCGTTC,0,2090598
lacIp,0.5,1,1,TGATGGTCAGGGGTTTAAAG,0,2098658
lacIp,0.5,1,1,TGATGGCTGATTGTCCCGGT,0,2103331
lacIp,0.5,1,1,TGATGGCCGTACGGCTGGAC,0,2090898
lacIp,0.5,1,1,TGATGCTATAACGGACTTCC,0,2105440
lacIp,0.5,1,1,TGATGAAGTCTTAGACCTGG,0,2119064
lacIp,0.5,1,1,TGATCGTTTGTTCGCTTGTC,0,2096999
lacIp,0.5,1,1,TGATATCGCCATAAGAGGAC,0,2094172
lacIp,0.5,1,1,TGATACGTTTGATTATCTGG,0,2095202
lacIp,0.5,1,1,TGATACGGGCCGGAACTGTC,0,2111608
lacIp,0.5,1,1,TGATACAATAAAAACGGCAG,0,2104600
lacIp,0.5,1,1,TGAGTTTTATAGATGCTTAT,0,2100706
lacIp,0.5,1,1,TGAGTGAGGGGAAACAAGGG,0,2095204
lacIp,0.5,1,1,TGAGTATGCGGTTCGTTGTA,0,2096769
lacIp,0.5,1,1,TGAGTAGCGCTAATATTGCA,0,2102494
lacIp,0.5,1,1,TGAGTAGCCTCCTAGGGTAT,0,2090848
lacIp,0.5,1,1,TGAGTACTTAAGCACACTAA,0,2090981
lacIp,0.5,1,1,TGAGGACTGTTAATGAATCA,0,2094744
lacIp,0.5,1,1,TGAGCGAGGGCGTTCATGGT,0,2105912
lacIp,0.5,1,1,TGAGCCATACTAACTGTACC,0,2089385
lacIp,0.5,1,1,TGAGATCGATCTCTTCGAGG,0,2110497
lacIp,0.5,1,1,TGAGACACTGTTACATGTAA,0,2117458
lacIp,0.5,1,1,TGACTCAAGGGTGGGCCTGC,0,2094586
lacIp,0.5,1,1,TGACTATCATTGGTTTCAAC,0,2097808
lacIp,0.5,1,1,TGACTACATTTGGGACTCAT,0,2099002
lacIp,0.5,1,1,TGACGGCCATTCCCGTCTAT,0,2086122
lacIp,0.5,1,1,TGACGCGGCCGCTAACTTTT,0,2099777
lacIp,0.5,1,1,TGACCGTGTAGCAATCGCAG,0,2096315
lacIp,0.5,1,1,TGACCAAAAGGCCGGTAGCT,0,2096204
lacIp,0.5,1,1,TGAATTGTCCTCGCATGTAG,0,2111982
lacIp,0.5,1,1,TGAATATCATAAAACGCAGA,0,2093537
lacIp,0.5,1,1,TGAAGTGAGCCGTTAGATTC,0,2091147
lacIp,0.5,1,1,TGAAGTCCCGTTACATCTGC,0,2098211
lacIp,0.5,1,1,TGAACAGCCGTCCGTTACTA,0,2098811
lacIp,0.5,1,1,TCTTGTCCATCGCCCCCGGC,0,2095221
lacIp,0.5,1,1,TCTTGTATGAGCGACTGGAC,0,2097802
lacIp,0.5,1,1,TCTTCCCTACTACATTACAC,0,2107850
lacIp,0.5,1,1,TCTTACCAATACGATCACGT,0,2116356
lacIp,0.5,1,1,TCTTAATGGCGCGACGCTTA,0,2110490
lacIp,0.5,1,1,TCTGTCCCTTCGATGCGCTA,0,2092087
lacIp,0.5,1,1,TCTGGGAACATAATGTACGC,0,2115501
lacIp,0.5,1,1,TCTGCTAGCTCCGTAAAGCT,0,2106389
lacIp,0.5,1,1,TCTGCCACCTGAAGGTTACA,0,2115312
lacIp,0.5,1,1,TCTGACAAGTAAATCAATGT,0,2097188
lacIp,0.5,1,1,TCTGAATCTTGGAGACACCG,0,2088115
lacIp,0.5,1,1,TCTCTGGGCGGGCTTGCCCT,0,2089777
lacIp,0.5,1,1,TCTCTGCCCGTCTCTAGAAA,0,2122324
lacIp,0.5,1,1,TCTCTGCAGTACCGCCGAGC,0,2118140
lacIp,0.5,1,1,TCTCTCCCTTGATCGCGGCG,0,2091855
lacIp,0.5,1,1,TCTCGTACTCGAATGCAAAC,0,2106194
lacIp,0.5,1,1,TCTCGGTCTTGTCTAAAGCT,0,2106139
lacIp,0.5,1,1,TCTCGGTCAAGCACTTATAC,0,2119945
lacIp,0.5,1,1,TCTCCTTATGGGCACTATAG,0,2093425
lacIp,0.5,1,1,TCTCCGGCGGACCCGGTGGA,0,2112524
lacIp,0.5,1,1,TCTCAGGGTGAGAGCCATGA,0,2087973
lacIp,0.5,1,1,TCTCAGACGGCGGGGGTGGA,0,2119051
lacIp,0.5,1,1,TCTCACTCACGTTGGTGGCC,0,2100316
lacIp,0.5,1,1,TCTCAACGAATACCCGGCCA,0,2122229
lacIp,0.5,1,1,TCTAGGGGAGGCCACTTCTA,0,2120802
lacIp,0.5,1,1,TCTAGAGGTGACAACCGTTT,0,2107968
lacIp,0.5,1,1,TCTACAATACGGCCTTAACT,0,2090469
lacIp,0.5,1,1,TCTAATGGGGATCTGTAGAC,0,2095401
lacIp,0.5,1,1,TCTAATGGCAGTCGGTTTCC,0,2090514
lacIp,0.5,1,1,TCTAAGGCCTAACCTCACTT,0,2116550
lacIp,0.5,1,1,TCTAACCACTTGCAATGTCA,0,2120168
lacIp,0.5,1,1,TCGTTTAAAATCGGTGACGA,0,2092909
lacIp,0.5,1,1,TCGTTGTTGCTGGTTTGTGT,0,2093695
lacIp,0.5,1,1,TCGTTGAGCGCTCGGACACG,0,2114680
lacIp,0.5,1,1,TCGTTCGGCGGGACCGCAGA,0,2111506
lacIp,0.5,1,1,TCGTTACTGGATGCTCTGTC,0,2085960
lacIp,0.5,1,1,TCGTGGGCGTACACGTGACG,0,2089659
lacIp,0.5,1,1,TCGTGGATAATTGTTCACGA,0,2114137
lacIp,0.5,1,1,TCGTGCGAGCCTATCGGAAC,0,2119399
lacIp,0.5,1,1,TCGTCTTGCAATTTATGAGT,0,2100540
lacIp,0.5,1,1,TCGTCGGGGCACCGGCAGCT,0,2097174
lacIp,0.5,1,1,TCGTCCGCCGAAGCACGGAA,0,2112017
lacIp,0.5,1,1,TCGTATCTTAGCAGAGAGAT,0,2105286
lacIp,0.5,1,1,TCGTAGTCTAAGTTAGCCCA,0,2108320
lacIp,0.5,1,1,TCGTAGGTCGTGACTATTTA,0,2120529
lacIp,0.5,1,1,TCGGTAGTCTTAATGGGGGA,0,2087917
lacIp,0.5,1,1,TCGGGTTAAATGTACTAACA,0,2119330
lacIp,0.5,1,1,TCGGGGCTGCATAAGGACTG,0,2111644
lacIp,0.5,1,1,TCGGGAATCCTAGATTTTAA,0,2085979
lacIp,0.5,1,1,TCGGCCGAACGATCCGCCCT,0,2106367
lacIp,0.5,1,1,TCGCTTGCGTGTAAAAGAGG,0,2114307
lacIp,0.5,1,1,TCGCTTCGGACAAGTAAGGC,0,2112442
lacIp,0.5,1,1,TCGCTAAATCATTACATAGG,0,2097550
lacIp,0.5,1,1,TCGCGTTCCGTGCAAGAAGG,0,2107204
lacIp,0.5,1,1,TCGCGTATTAAGAGACGGGG,0,2099863
lacIp,0.5,1,1,TCGCGCTTAAATGTAAGTGT,0,2086896
lacIp,0.5,1,1,TCGCCATTAGAAGTACTAGA,0,2108058
lacIp,0.5,1,1,TCGCCAGAGATCGGTTTTGT,0,2087163
lacIp,0.5,1,1,TCGCAGTGTATGCCTTTCTG,0,2095892
lacIp,0.5,1,1,TCGCAATCGAACCCATAACA,0,2094298
lacIp,0.5,1,1,TCGATTCGCATTTGTTTTAC,0,2101209
lacIp,0.5,1,1,TCGATTAAGGTGGCCGGATG,0,2119382
lacIp,0.5,1,1,TCGATCTCCAACGGCGGTAG,0,2087891
lacIp,0.5,1,1,TCGAGACCTAGGCACAGGTT,0,2099424
lacIp,0.5,1,1,TCGACTGCATCAGATAGCCA,0,2116083
lacIp,0.5,1,1,TCGAATGTAATGGACAACTG,0,2093514
lacIp,0.5,1,1,TCCTTTTGATGAGCACAGCG,0,2103887
lacIp,0.5,1,1,TCCTTCGTAAAAGTGCCCAT,0,2111340
lacIp,0.5,1,1,TCCTTCGGGGTCGCTGAAAA,0,2086636
lacIp,0.5,1,1,TCCTTCCATGGACTTCATTT,0,2098572
lacIp,0.5,1,1,TCCTTAACTAGGCAACGCGT,0,2086818
lacIp,0.5,1,1,TCCTGCGTAGGGAAGGTCCT,0,2115335
lacIp,0.5,1,1,TCCTCTTATATTCGACTGAA,0,2110212
lacIp,0.5,1,1,TCCTATCACGTCGGTGCGCG,0,2107756
lacIp,0.5,1,1,TCCTACGTGACTATTGGTGT,0,2108634
lacIp,0.5,1,1,TCCTAATTGTTTGAAGGGCA,0,2115665
lacIp,0.5,1,1,TCCGTTCAATGCAAGTAAAT,0,2108827
lacIp,0.5,1,1,TCCGGTTCACTACATCTTCT,0,2100009
lacIp,0.5,1,1,TCCGGGTAGTACAACCCGTA,0,2119176
lacIp,0.5,1,1,TCCGGCAACAATAGTAAGAA,0,2120144
lacIp,0.5,1,1,TCCGCTATTACGCTCTCTGG,0,2116291
lacIp,0.5,1,1,TCCGCGGGCCGCATGCTCGT,0,2117200
lacIp,0.5,1,1,TCCGCCTGTTAATACGAACT,0,2095774
lacIp,0.5,1,1,TCCGAATTACTCTACCGAGT,0,2106864
lacIp,0.5,1,1,TCCGAAAGGTGGTCGCGCAG,0,2100075
lacIp,0.5,1,1,TCCCTTCTGTCGCAAGGCGT,0,2086571
lacIp,0.5,1,1,TCCCTCTTTTTCGGGATTTG,0,2115851
lacIp,0.5,1,1,TCCCTCCGCACACATATAGT,0,2094977
lacIp,0.5,1,1,TCCCTCACATGTTGGTCTAT,0,2094107
lacIp,0.5,1,1,TCCCGTGACGCTGCCGGTTG,0,2102723
lacIp,0.5,1,1,TCCCGGAAAATTGGCCTCTA,0,2095456
lacIp,0.5,1,1,TCCCATGCATAAGACGTTGA,0,2105572
lacIp,0.5,1,1,TCCCAAAAGACGTCCATCCG,0,2105205
lacIp,0.5,1,1,TCCATGCATCAGATACTAGA,0,2116549
lacIp,0.5,1,1,TCCATCGCACAGAATGGAGA,0,2092952
lacIp,0.5,1,1,TCCATAGGACGTGGTCGGCG,0,2121217
lacIp,0.5,1,1,TCCAGGCATTCCAAACTCAG,0,2098987
lacIp,0.5,1,1,TCCAGCGACTTTATTAATAC,0,2096230
lacIp,0.5,1,1,TCCAGAATGTTATCGGCTTG,0,2104777
lacIp,0.5,1,1,TCCACTGACCCATCGGGCAA,0,2114616
lacIp,0.5,1,1,TCCACCTTCGCCAACGGTCC,0,2096448
lacIp,0.5,1,1,TCCAATCGTAAGCTACCCAG,0,2085758
lacIp,0.5,1,1,TCATTTCTACTGCTTATCGC,0,2103334
lacIp,0.5,1,1,TCATTGTAAACGATAACGAT,0,2101724
lacIp,0.5,1,1,TCATTCCACAGCGGCATAAG,0,2118983
lacIp,0.5,1,1,TCATTACGGAGATCCTCCTT,0,2121809
lacIp,0.5,1,1,TCATGTGCTTTTTGTCATTA,0,2096729
lacIp,0.5,1,1,TCATGCTGAGATGGTTGTTT,0,2107329
lacIp,0.5,1,1,TCATCATGAATGCCCCCTTT,0,2088425
lacIp,0.5,1,1,TCATCAAAAGATGTCACCTT,0,2121136
lacIp,0.5,1,1,TCATATGGTGACTTAGGTAG,0,2116614
lacIp,0.5,1,1,TCATAGGGTAATGCTACACC,0,2113046
lacIp,0.5,1,1,TCATAGGGAATCAGACCCAC,0,2101869
lacIp,0.5,1,1,TCAGTGTGTCCATTCCATGA,0,2119098
lacIp,0.5,1,1,TCAGTGCAATGGACTGGCTA,0,2089213
lacIp,0.5,1,1,TCAGTCTGGGACGTACTCCA,0,2107956
lacIp,0.5,1,1,TCAGTCTACTGCTTCCGGGG,0,2119975
lacIp,0.5,1,1,TCAGTACCCGTATACCCTAG,0,2103454
lacIp,0.5,1,1,TCAGGTGCTGCAAGCGGATC,0,2112732
lacIp,0.5,1,1,TCAGGCCTTCAAGAAAGTAC,0,2113034
lacIp,0.5,1,1,TCAGGCAGTTTCAAGGAATA,0,2092274
lacIp,0.5,1,1,TCAGGCAAATTCTTTTGTGT,0,2106524
lacIp,0.5,1,1,TCAGCTCGTCGAGACGGACA,0,2112238
lacIp,0.5,1,1,TCAGCCGTAGCCACACATGA,0,2107895
lacIp,0.5,1,1,TCAGCAGGCAGGCACATATT,0,2105410
lacIp,0.5,1,1,TCAGCAGCCGGCATAAGACT,0,2110559
lacIp,0.5,1,1,TCAGCACCTGTTAAAGGTGG,0,2089320
lacIp,0.5,1,1,TCAGACTCCTGCCGTTCTGG,0,2114840
lacIp,0.5,1,1,TCAGACGCTGAGACATTTGC,0,2106474
lacIp,0.5,1,1,TCACTGGAGGTATAGTGCCA,0,2110623
lacIp,0.5,1,1,TCACTCATGTTGGGTTGTAG,0,2090512
lacIp,0.5,1,1,TCACTCAAAATCATCCCGAT,0,2098397
lacIp,0.5,1,1,TCACGTGGCTTCCACGTCTC,0,2107124
lacIp,0.5,1,1,TCACGGTTTCTCCACGACAC,0,2118414
lacIp,0.5,1,1,TCACGGTTTCTACATAATAT,0,2096485
lacIp,0.5,1,1,TCACCTTTTTGGAAACTGAG,0,2103066
lacIp,0.5,1,1,TCACCGTGGCGGCGACACTT,0,2102051
lacIp,0.5,1,1,TCACCCATACATAAAGAGTA,0,2101872
lacIp,0.5,1,1,TCACCACTTCCCTGCGCCGC,0,2121088
lacIp,0.5,1,1,TCACATCTGTTCTCCGGCTT,0,2087088
lacIp,0.5,1,1,TCACAGGATTGGGAATATCA,0,2090051
lacIp,0.5,1,1,TCACAAATTGATATCAGTTT,0,2102871
lacIp,0.5,1,1,TCAACTCTTGTTGGGGACGC,0,2085860
lacIp,0.5,1,1,TCAACGTGCATTGCCCTTCT,0,2110122
lacIp,0.5,1,1,TCAACGTCTGGTGTGTAATA,0,2108656
lacIp,0.5,1,1,TCAACGGTTTGGCGCATGTT,0,2106430
lacIp,0.5,1,1,TCAACGCCCCAACGGGAATA,0,2085698
lacIp,0.5,1,1,TCAACACACCAGTGTTATAT,0,2098216
lacIp,0.5,1,1,TCAACAAATCAGTGACGTCT,0,2095035
lacIp,0.5,1,1,TCAAAGATAACGTACGATGA,0,2115807
lacIp,0.5,1,1,TCAAACAGGCCAGCTCTCGA,0,2097590
lacIp,0.5,1,1,TATTTGTGCCACGCCAAAGG,0,2111945
lacIp,0.5,1,1,TATTGAGACTATATTTACTT,0,2101841
lacIp,0.5,1,1,TATTGACAGTGGTACTTTTC,0,2092194
lacIp,0.5,1,1,TATTCGGAAAACTCCCCAAT,0,2120453
lacIp,0.5,1,1,TATTCCTAGTGGATCTAGCC,0,2108009
lacIp,0.5,1,1,TATTCCATCGGTTCGCCCAT,0,2097479
lacIp,0.5,1,1,TATTATAGGCGCGAGCGAGA,0,2094630
lacIp,0.5,1,1,TATTACTTAACCGTCAAAAA,0,2098617
lacIp,0.5,1,1,TATGTTGTTAATACGCATTT,0,2095200
lacIp,0.5,1,1,TATGTAAGTCACGTCGTTTG,0,2115022
lacIp,0.5,1,1,TATGGTGGTCTCGTTATTGA,0,2107777
lacIp,0.5,1,1,TATGGTGGCTATAGAGGTTA,0,2107370
lacIp,0.5,1,1,TATGGCTTATGACTGTATTA,0,2095535
lacIp,0.5,1,1,TATGGCCCTCCCACGAACTC,0,2108762
lacIp,0.5,1,1,TATGCCCGTGACCTAAATGA,0,2097487
lacIp,0.5,1,1,TATGCAAGGCGAGAACTCAA,0,2101341
lacIp,0.5,1,1,TATGACAAGCAGAGAGCGCG,0,2111441
lacIp,0.5,1,1,TATGAATATCTGGTAAATGC,0,2104307
lacIp,0.5,1,1,TATCTTCGGCGAGTGTATAT,0,2094215
lacIp,0.5,1,1,TATCGTGCATAATGCCTGCA,0,2086466
lacIp,0.5,1,1,TATCGTCACAAAGAGCGAAG,0,2120680
lacIp,0.5,1,1,TATCGCTGGACGCGTGTGTC,0,2118759
lacIp,0.5,1,1,TATCGCGAGTGCTTGTGGCT,0,2106905
lacIp,0.5,1,1,TATCGCAACGCTAATGGGTC,0,2103272
lacIp,0.5,1,1,TATCGAAGTCGTATCGACGA,0,2119226
lacIp,0.5,1,1,TATCCCTGACCTGACTGAGA,0,2111084
lacIp,0.5,1,1,TATCCCGGGGACACAGTTTA,0,2118631
lacIp,0.5,1,1,TATCAATCAATGTACCCGTA,0,2095748
lacIp,0.5,1,1,TATCAAGGATTAGGCGGATG,0,2116724
lacIp,0.5,1,1,TATATTTACGTGCTCACTCA,0,2103044
lacIp,0.5,1,1,TATATTCAGGCCTAATATTT,0,2085808
lacIp,0.5,1,1,TATATAGATCGTCTCCGACC,0,2116094
lacIp,0.5,1,1,TATAGGTCCTGCTGCGTATT,0,2120658
lacIp,0.5,1,1,TATACAGTAGGTTGACGGAA,0,2100225
lacIp,0.5,1,1,TATACAGCACTGTTTAGTAT,0,2117329
lacIp,0.5,1,1,TATACAAACTCGGAAAAGGG,0,2091928
lacIp,0.5,1,1,TATAAGTGCTTCGGGAAGTC,0,2088810
lacIp,0.5,1,1,TAGTGTCTCCAAAAACGCTT,0,2113995
lacIp,0.5,1,1,TAGTCCTTGGCTGTAGTGGC,0,2112313
lacIp,0.5,1,1,TAGGTTGTGGGAGCAGTGAC,0,2096058
lacIp,0.5,1,1,TAGGTTGGGGCCTCCTAATA,0,2114093
lacIp,0.5,1,1,TAGGTTCGGGTCACACGCGT,0,2109366
lacIp,0.5,1,1,TAGGTCACTGCATTATGGCG,0,2088864
lacIp,0.5,1,1,TAGGGCCACCTCTTAGACCA,0,2113118
lacIp,0.5,1,1,TAGGGAGGCCTATTAGAGGT,0,2096090
lacIp,0.5,1,1,TAGGCTTTTTAATTCAGATT,0,2099665
lacIp,0.5,1,1,TAGGCTTTAGACTCTGCAAG,0,2112271
lacIp,0.5,1,1,TAGGCACATGTACTAAACGG,0,2106899
lacIp,0.5,1,1,TAGGAGGACCTGCCACATCG,0,2091739
lacIp,0.5,1,1,TAGGAACGTCACGGCGGAGC,0,2087385
lacIp,0.5,1,1,TAGGAACCTAAGACCATGCT,0,2097873
lacIp,0.5,1,1,TAGCTGGGAACCATTAAGAT,0,2104942
lacIp,0.5,1,1,TAGCTCACCCTATGGTACTT,0,2115612
lacIp,0.5,1,1,TAGCGGGGACATTTCGCCTC,0,2098058
lacIp,0.5,1,1,TAGCGAGGGACGACGGCGCA,0,2121997
lacIp,0.5,1,1,TAGCCGTGCCAAAATATGTT,0,2092251
lacIp,0.5,1,1,TAGCCGTCATACGTCTCTTG,0,2101952
lacIp,0.5,1,1,TAGCCATAGATGGCTTGCTC,0,2087534
lacIp,0.5,1,1,TAGCAAGCTCTCGACTCCTT,0,2118189
lacIp,0.5,1,1,TAGATTCAGCGGTTTTAATG,0,2111505
lacIp,0.5,1,1,TAGATCTGTACACTGCTCTA,0,2091651
lacIp,0.5,1,1,TAGAGTGTCTCGCTTAGGGC,0,2118267
lacIp,0.5,1,1,TAGAACGATGGTTGGGGGTA,0,2095572
lacIp,0.5,1,1,TAGAAAGCGACGAGACAAGC,0,2095375
lacIp,0.5,1,1,TACTTGAAAGGCCCTATGTC,0,2121188
lacIp,0.5,1,1,TACTGTGCATGTCTATTCCT,0,2085777
lacIp,0.5,1,1,TACTGCGTCCCTTCTCCGGT,0,2097020
lacIp,0.5,1,1,TACTGCCAGGCATTCCCCGT,0,2102424
lacIp,0.5,1,1,TACTCTGACACCGGGTTCGC,0,2102542
lacIp,0.5,1,1,TACTCGCCAGCTTTCCTGGC,0,2094557
lacIp,0.5,1,1,TACTCGATTCGAATGCGGAC,0,2094951
lacIp,0.5,1,1,TACTCATTCCAGTCTTGGAT,0,2093330
lacIp,0.5,1,1,TACTACTATTGACTGATTGG,0,2113094
lacIp,0.5,1,1,TACGTATTTAACCAGGGGCG,0,2109405
lacIp,0.5,1,1,TACGTATGGATTGGAGTCGT,0,2092495
lacIp,0.5,1,1,TACGGTGGTACTGAATGGCT,0,2101224
lacIp,0.5,1,1,TACGGACTGCCTACACGTCA,0,2088877
lacIp,0.5,1,1,TACGGAACGATACATGTAGA,0,2117363
lacIp,0.5,1,1,TACCTTTCGGGTGTACGATG,0,2100318
lacIp,0.5,1,1,TACCTACTCCGACGCCACGA,0,2113278
lacIp,0.5,1,1,TACCGTTTCTTGAGTCGGAT,0,2115774
lacIp,0.5,1,1,TACCGGAGCCCCCTCCCGTT,0,2116001
lacIp,0.5,1,1,TACCCCAGCGGGTACAAGCG,0,2109348
lacIp,0.5,1,1,TACCAGGCATGGCGCCGTGG,0,2104455
lacIp,0.5,1,1,TACATGAGCCACAACACGGG,0,2106415
lacIp,0.5,1,1,TACATGAAGATTGTGTAGAT,0,2105606
lacIp,0.5,1,1,TACAGGGTAACGGTACCCCA,0,2116930
lacIp,0.5,1,1,TACAGGACGTTTCCACGACA,0,2108188
lacIp,0.5,1,1,TACAGCCAACAGTTTGGTCC,0,2098794
lacIp,0.5,1,1,TAATTGATATTCACGATACG,0,2096141
lacIp,0.5,1,1,TAATTCCGGGCCGTGACTGC,0,2096917
lacIp,0.5,1,1,TAATTATTCGTAGGGGTCAA,0,2091917
lacIp,0.5,1,1,TAATTAGTGTTCGATTCTGT,0,2089693
lacIp,0.5,1,1,TAATCTTTTACCACCTGAAT,0,2090124
lacIp,0.5,1,1,TAATATAAGAGGTTATATCA,0,2092113
lacIp,0.5,1,1,TAATACGTTTGTCACTGTAA,0,2086843
lacIp,0.5,1,1,TAATACACGTCGGGTTGTCG,0,2111508
lacIp,0.5,1,1,TAATAACAGCCGTGGTCTAA,0,2086120
lacIp,0.5,1,1,TAAGTTACGGAGCAATATTT,0,2119939
lacIp,0.5,1,1,TAAGTCGGCATGTTCCGCCT,0,2095747
lacIp,0.5,1,1,TAAGGTTTACGCTTCCTCAT,0,2102987
lacIp,0.5,1,1,TAAGGCTCTATGGCCAAAAT,0,2090626
lacIp,0.5,1,1,TAAGGCTATATGGGAAACTC,0,2111594
lacIp,0.5,1,1,TAAGGAGTATGCCGATGCAT,0,2117039
lacIp,0.5,1,1,TAAGCTTATGCTCATACAGT,0,2112584
lacIp,0.5,1,1,TAAGCATTTGCTTTGTAGAT,0,2113280
lacIp,0.5,1,1,TAAGACTTCCACGAGTTTGC,0,2113986
lacIp,0.5,1,1,TAACTTGCCTAGGAAATTTG,0,2089987
lacIp,0.5,1,1,TAACTGGTTTACACGTGTAT,0,2098756
lacIp,0.5,1,1,TAACTAGCATGTATCCAAAT,0,2107808
lacIp,0.5,1,1,TAACGTGACCTACCATGGAT,0,2096935
lacIp,0.5,1,1,TAACCGGCACGAAGCCTAAC,0,2103048
lacIp,0.5,1,1,TAACCCGTGTGTCACACCGT,0,2109362
lacIp,0.5,1,1,TAACATCACTATAGTGGAAC,0,2114075
lacIp,0.5,1,1,TAACACCGGGGCAATATACA,0,2103985
lacIp,0.5,1,1,TAAATATTGCGCCCCTGTAT,0,2099024
lacIp,0.5,1,1,TAAATACTGTGCGTCATCGT,0,2108545
lacIp,0.5,1,1,TAAAGGTTGGGAACTCCGAT,0,2101359
lacIp,0.5,1,1,TAAAGGACTAGCTTAAAGGA,0,2106868
lacIp,0.5,1,1,TAAAGCTTATGATGTCATTG,0,2102406
lacIp,0.5,1,1,TAAACTGGCCGCGGCTTGTG,0,2094242
lacIp,0.5,1,1,TAAACTAGAGCTATCGACAA,0,2122399
lacIp,0.5,1,1,TAAACGCAAATCCTTCGACT,0,2091304
lacIp,0.5,1,1,TAAACAAACCCACGGAGCGA,0,2119001
lacIp,0.5,1,1,TAAAAGTTCAATACTGTAAA,0,2098324
lacIp,0.5,1,1,TAAAAAGAAAAATTACGAGT,0,2096920
lacIp,0.5,1,1,GTTTTTATGGCGCCATTACA,0,2092122
lacIp,0.5,1,1,GTTTGGTCCACGGGACCGTA,0,2114692
lacIp,0.5,1,1,GTTTGACTTAGAGGGACTAA,0,2097220
lacIp,0.5,1,1,GTTTGACTCTGCCAGGAACG,0,2106510
lacIp,0.5,1,1,GTTTCGGGGGAGGGAACTAA,0,2098862
lacIp,0.5,1,1,GTTTCGCAGGTCCATGACGT,0,2100183
lacIp,0.5,1,1,GTTTCCCGAAGGGGTATATA,0,2088209
lacIp,0.5,1,1,GTTTAGATAGAAGCGCTATG,0,2119640
lacIp,0.5,1,1,GTTTACGTTCCTTCACTGGT,0,2116584
lacIp,0.5,1,1,GTTGGGTAATGGAATGCAGT,0,2113095
lacIp,0.5,1,1,GTTGGACATCTGAGAGGTCA,0,2114722
lacIp,0.5,1,1,GTTGCGGCGGCTACCGTGAA,0,2105141
lacIp,0.5,1,1,GTTGCCTCTATGGATTGATC,0,2100281
lacIp,0.5,1,1,GTTGCAAGCAAGTAATATTA,0,2103866
lacIp,0.5,1,1,GTTGAGCAGAAATTTTTCCT,0,2119895
lacIp,0.5,1,1,GTTGACGACCTAGAGTTGTG,0,2105798
lacIp,0.5,1,1,GTTCTATCCCAGCCACCTCC,0,2111584
lacIp,0.5,1,1,GTTCGTGGCGCTCCGAGGCG,0,2102018
lacIp,0.5,1,1,GTTCGGTGTCAGTCATAAGA,0,2115687
lacIp,0.5,1,1,GTTCGGCTGGACGTTACGCG,0,2113226
lacIp,0.5,1,1,GTTCCCATCGATAGGCCGGC,0,2093064
lacIp,0.5,1,1,GTTCACATGGAAGTTGAGCA,0,2104137
lacIp,0.5,1,1,GTTCAACAAGAGGCTTACCC,0,2093625
lacIp,0.5,1,1,GTTCAAACACTACGCTTACT,0,2108824
lacIp,0.5,1,1,GTTATGTTCAACGCAGTGAA,0,2094856
lacIp,0.5,1,1,GTTATATTGGTTTCAGCACA,0,2105652
lacIp,0.5,1,1,GTTATATCTGGGTGGTATGG,0,2107035
lacIp,0.5,1,1,GTTATATAGTGAGTCGTCCC,0,2095868
lacIp,0.5,1,1,GTTAGTTTTGTCTTCACTCA,0,2087520
lacIp,0.5,1,1,GTTAGATGCACGCCCGGAAA,0,2087021
lacIp,0.5,1,1,GTTAGACTGGAAAACTTGAG,0,2121315
lacIp,0.5,1,1,GTTACTTGAGATACAGCCTT,0,2101515
lacIp,0.5,1,1,GTTACACAGATACAAAATGC,0,2116310
lacIp,0.5,1,1,GTTAATGCAGCGGCGGGAGA,0,2106130
lacIp,0.5,1,1,GTTAACGGCAGCCGTGTCAA,0,2089564
lacIp,0.5,1,1,GTTAACCGGTCCTTCGTGAT,0,2089613
lacIp,0.5,1,1,GTTAAATCCCGGCGAGCCAC,0,2091609
lacIp,0.5,1,1,GTGTTGAACACATTTCGATG,0,2106615
lacIp,0.5,1,1,GTGTTATACATTCCTGACCA,0,2111515
lacIp,0.5,1,1,GTGTTACGCCTAGGCCGAGC,0,2118014
lacIp,0.5,1,1,GTGTTACGAATGTGATGCGA,0,2105228
lacIp,0.5,1,1,GTGTGCCCGACAGAAAAGCC,0,2110167
lacIp,0.5,1,1,GTGTCCGCTTACATGGGATG,0,2111606
lacIp,0.5,1,1,GTGTCCACCGATCCGGGGTA,0,2100742
lacIp,0.5,1,1,GTGTCATCTTTGAGGGTATG,0,2117285
lacIp,0.5,1,1,GTGTCACTAGCTACCTGCAG,0,2105610
lacIp,0.5,1,1,GTGTCAACTCCCTACTAGCA,0,2110986
lacIp,0.5,1,1,GTGTATGATATAATGTGCTT,0,2108196
lacIp,0.5,1,1,GTGTAGACAGACTTGCACGT,0,2111439
lacIp,0.5,1,1,GTGTACTGGAGTGCGCCGGG,0,2119167
lacIp,0.5,1,1,GTGTAATATAGGTGCGCGAG,0,2098758
lacIp,0.5,1,1,GTGGTTGTGCCGGCCTCGGT,0,2106066
lacIp,0.5,1,1,GTGGTTGGCCGGTAGTAAAG,0,2094987
lacIp,0.5,1,1,GTGGTTAACAGCGTCTGCGA,0,2091329
lacIp,0.5,1,1,GTGGTCTGGCTCTGTAAAGG,0,2104143
lacIp,0.5,1,1,GTGGTCGCATCGTTTGCCGA,0,2103991
lacIp,0.5,1,1,GTGGGTTTAGAGAACTCGCT,0,2117889
lacIp,0.5,1,1,GTGGGGCTGGGTAATTGGTT,0,2090180
lacIp,0.5,1,1,GTGGGCAAGCTCCAAAGGTC,0,2089022
lacIp,0.5,1,1,GTGGCTTGCCTTGTATTTTC,0,2119670
lacIp,0.5,1,1,GTGCTTCAATAGGAGATGTT,0,2114442
lacIp,0.5,1,1,GTGCTGCGACTGGTCTTACT,0,2088409
lacIp,0.5,1,1,GTGCGTTGCTGTCACCCGTC,0,2088258
lacIp,0.5,1,1,GTGCGTTCGCTGAAAGTTCG,0,2100648
lacIp,0.5,1,1,GTGCGTCAGGCGCCACATGT,0,2119854
lacIp,0.5,1,1,GTGCGTACCTGTATCTGCGT,0,2113100
lacIp,0.5,1,1,GTGCGCTGCTTAGTCCATCT,0,2103780
lacIp,0.5,1,1,GTGCCCTCCCCGGTCAGGGC,0,2111555
lacIp,0.5,1,1,GTGCCAAGACTCGTTAGCCA,0,2093692
lacIp,0.5,1,1,GTGCACGCAGTCGGGTGCCT,0,2120849
lacIp,0.5,1,1,GTGCAATTTCGAGGAGTTAT,0,2112499
lacIp,0.5,1,1,GTGATCATCATTAGTCAGAG,0,2099961
lacIp,0.5,1,1,GTGAGGAAAGCTATGACCCT,0,2111097
lacIp,0.5,1,1,GTGAGATCCAAGTTCAGACT,0,2097336
lacIp,0.5,1,1,GTGACCGCACCTGCTTTTAT,0,2100767
lacIp,0.5,1,1,GTGACATAGCGGACGTAAGC,0,2092816
lacIp,0.5,1,1,GTGAATATATTTTCGAGCAG,0,2104877
lacIp,0.5,1,1,GTGAAGCCGCTGTCGGTTCC,0,2112623
lacIp,0.5,1,1,GTGAACAAGCCACGTACGTA,0,2105331
lacIp,0.5,1,1,GTCTTTAGAGGACGAAGCGA,0,2115266
lacIp,0.5,1,1,GTCTTGTTTCGGGTCAATGG,0,2096588
lacIp,0.5,1,1,GTCTGGCTACTAACCCGTGA,0,2110114
lacIp,0.5,1,1,GTCTGGATGCAAAACCGGTT,0,2111254
lacIp,0.5,1,1,GTCTGCTCAGAGCTGCGAGC,0,2094552
lacIp,0.5,1,1,GTCTGACCTACAGCGTGCTC,0,2112899
lacIp,0.5,1,1,GTCTCGTTTGGAGGTGCCAG,0,2103953
lacIp,0.5,1,1,GTCTATCATACTTCATTACA,0,2121359
lacIp,0.5,1,1,GTCTATAACGAATATCCCAT,0,2113166
lacIp,0.5,1,1,GTCTAATTAGCGTCCTTGAT,0,2089563
lacIp,0.5,1,1,GTCTAAGAATGCTCCCAGAT,0,2120955
lacIp,0.5,1,1,GTCGTGCCAAGTAGGTTGGT,0,2107975
lacIp,0.5,1,1,GTCGTCAGAGGGTCATGTGT,0,2113385
lacIp,0.5,1,1,GTCGTATTGGATGGTCCTCA,0,2115913
lacIp,0.5,1,1,GTCGGCGGATTGACGGGGGT,0,2105221
lacIp,0.5,1,1,GTCGGCCGATAATTGTGTGG,0,2121689
lacIp,0.5,1,1,GTCGCTCTCGGCTGGGACCC,0,2110492
lacIp,0.5,1,1,GTCGCGCGCGCAGAAATGCG,0,2086564
lacIp,0.5,1,1,GTCGCAAGATGGGGTAGAGT,0,2109463
lacIp,0.5,1,1,GTCGAGTGAGAACATTGACT,0,2112658
lacIp,0.5,1,1,GTCGACTCAGGCCTCGGTTT,0,2096378
lacIp,0.5,1,1,GTCGAAGCCACTATCCTCGT,0,2119444
lacIp,0.5,1,1,GTCCTGCAACAGTGGTGGCT,0,2113940
lacIp,0.5,1,1,GTCCTCCCGGCGGTAACAGA,0,2091466
lacIp,0.5,1,1,GTCCGGTGCCCAGAGGTGGG,0,2086051
lacIp,0.5,1,1,GTCCGGCGTCAAGGATTTCT,0,2113087
lacIp,0.5,1,1,GTCCGCGACGATAGCGAATA,0,2089551
lacIp,0.5,1,1,GTCCCAGGACACTCTCAGAA,0,2085876
lacIp,0.5,1,1,GTCCAATTTTAGAGGGGTAC,0,2105737
lacIp,0.5,1,1,GTCAGTGTACAATCCCGTAC,0,2110076
lacIp,0.5,1,1,GTCAGTCGGAACTTTGTTGC,0,2099311
lacIp,0.5,1,1,GTCAGACGTCCGATAACCTC,0,2109059
lacIp,0.5,1,1,GTCACATCTCAGCCGCGGCA,0,2095957
lacIp,0.5,1,1,GTCAATTTAGTATTGGTGTT,0,2097609
lacIp,0.5,1,1,GTCAATATGTACTTGGAATT,0,2116737
lacIp,0.5,1,1,GTCAATAAATAATTACTCGC,0,2112741
lacIp,0.5,1,1,GTCAAGCCTTCTGCGCATGA,0,2087350
lacIp,0.5,1,1,GTCAACTGCCAGCTCCTAAC,0,2088713
lacIp,0.5,1,1,GTCAACTCTCTAGATCATCA,0,2092725
lacIp,0.5,1,1,GTATTTGGAATGCCTAGTCA,0,2093613
lacIp,0.5,1,1,GTATTTGCAAATTGCTCAGG,0,2086383
lacIp,0.5,1,1,GTATTCCCCACATTGGATCT,0,2097372
lacIp,0.5,1,1,GTATGTGACGGCACAACCGC,0,2095114
lacIp,0.5,1,1,GTATGAACGCAATACACTAG,0,2102595
lacIp,0.5,1,1,GTATCTGTAAATATCCTATG,0,2101919
lacIp,0.5,1,1,GTATCGATAGAGCGCCGAAG,0,2086602
lacIp,0.5,1,1,GTATCCATGATCCGCAGGTA,0,2092536
lacIp,0.5,1,1,GTATCATGCGGGGGCGAAGG,0,2086277
lacIp,0.5,1,1,GTATATCAGGATATCGGACA,0,2094661
lacIp,0.5,1,1,GTATACACGTCCCTAACAAC,0,2100330
lacIp,0.5,1,1,GTATAAGTTCGTGTAATTGT,0,2116025
lacIp,0.5,1,1,GTAGTGGGCGTTGCAGAGTC,0,2105863
lacIp,0.5,1,1,GTAGTCAGGGTCTCCAGCAT,0,2097770
lacIp,0.5,1,1,GTAGTCAACCGGCTTCCATC,0,2115222
lacIp,0.5,1,1,GTAGTATCTCTACATATTTA,0,2111393
lacIp,0.5,1,1,GTAGGTCTTTACAGTGTCCT,0,2096126
lacIp,0.5,1,1,GTAGGTCATCCATCCTTTTT,0,2116153
lacIp,0.5,1,1,GTAGGGATCTGGTCTTTACA,0,2121362
lacIp,0.5,1,1,GTAGGAAGTTGAGACGAACT,0,2104833
lacIp,0.5,1,1,GTAGCAGAGAGTACGGGGGG,0,2104389
lacIp,0.5,1,1,GTAGATTGGCTCGGAGCTGA,0,2109967
lacIp,0.5,1,1,GTAGATGTCAGGCCTGGTAC,0,2091388
lacIp,0.5,1,1,GTACTTAGGGGCGGACGATA,0,2094539
lacIp,0.5,1,1,GTAATTTGAAGCGAAGCTTG,0,2114685
lacIp,0.5,1,1,GTAATTAAGCCACCCGGATA,0,2110351
lacIp,0.5,1,1,GTAATAGGTGCTACCGAAAC,0,2122155
lacIp,0.5,1,1,GTAAGTTGTCATGAGGTCAT,0,2113157
lacIp,0.5,1,1,GTAAGGGGACCCTGCTTTTT,0,2102104
lacIp,0.5,1,1,GTAAGCTTCGGAATCAGGTC,0,2090751
lacIp,0.5,1,1,GTAACTCCGCAGGGGACTCA,0,2110749
lacIp,0.5,1,1,GTAACCTCGCCTCAAAAGGG,0,2101722
lacIp,0.5,1,1,GTAACAGAGCCCTGACCACA,0,2111148
lacIp,0.5,1,1,GTAAATTTCCCTGTGTTCTG,0,2101970
lacIp,0.5,1,1,GTAAAAGTAGACCCCAGACA,0,2102429
lacIp,0.5,1,1,GGTTTAGTTAGGAATCGGGT,0,2093546
lacIp,0.5,1,1,GGTTTAGCGGTGTCACAGTT,0,2090694
lacIp,0.5,1,1,GGTTGGCTACTAGGGGGCAA,0,2095256
lacIp,0.5,1,1,GGTTGGCCCTATCAGAGAGT,0,2120150
lacIp,0.5,1,1,GGTTGCGCATATGGCCACGG,0,2087369
lacIp,0.5,1,1,GGTTGATTTCCCATAAATGT,0,2115609
lacIp,0.5,1,1,GGTTCTAGGATAGCTACATC,0,2104252
lacIp,0.5,1,1,GGTTCGTGCGCACTTAATCT,0,2103415
lacIp,0.5,1,1,GGTTCGGTGGGTGTTAGGGA,0,2093015
lacIp,0.5,1,1,GGTTATTATCGACGACTGTT,0,2120822
lacIp,0.5,1,1,GGTTATAACTTAGGGTTGCG,0,2086142
lacIp,0.5,1,1,GGTTACAGAGTCCTGATGGG,0,2103399
lacIp,0.5,1,1,GGTTAAGTTTAAGGCACGTG,0,2092279
lacIp,0.5,1,1,GGTTAAATCTGTGAGGGTAG,0,2108474
lacIp,0.5,1,1,GGTGTAAGGGAAAGGGGAGC,0,2094814
lacIp,0.5,1,1,GGTGGTTTACTTCCCCCACT,0,2090718
lacIp,0.5,1,1,GGTGGTCGTGCCCTACCCGT,0,2099799
lacIp,0.5,1,1,GGTGCCTAATGTCAGTCGTA,0,2090140
lacIp,0.5,1,1,GGTGCATGCCACACAGATCA,0,2094689
lacIp,0.5,1,1,GGTGATACGGTGGCTATATA,0,2093448
lacIp,0.5,1,1,GGTGAGGTTCGATGTAAGAT,0,2107393
lacIp,0.5,1,1,GGTGAGGTCCATGGCTTGCT,0,2101368
lacIp,0.5,1,1,GGTGAGATCGCTTTATCGCT,0,2116081
lacIp,0.5,1,1,GGTGACGTACGGAAAATTTT,0,2096422
lacIp,0.5,1,1,GGTGACAGCATATCAATCCA,0,2091197
lacIp,0.5,1,1,GGTCTCTTCGTACACACCAT,0,2097772
lacIp,0.5,1,1,GGTCGGGAGATGACCTCAGT,0,2100059
lacIp,0.5,1,1,GGTCGGCGGACCGGCGAGGT,0,2085937
lacIp,0.5,1,1,GGTCGGCCCGATCCACATAT,0,2104388
lacIp,0.5,1,1,GGTCGGAGGTACAGGAATTC,0,2101292
lacIp,0.5,1,1,GGTCGGAATGTGGGAGTAAA,0,2114480
lacIp,0.5,1,1,GGTCGCCCATGAGTCCCTCA,0,2088563
lacIp,0.5,1,1,GGTCCTCGTTATCAGGGTCA,0,2096687
lacIp,0.5,1,1,GGTCCGGGATAGTTCATCAA,0,2103050
lacIp,0.5,1,1,GGTCCGGCGGACATTACGAG,0,2093604
lacIp,0.5,1,1,GGTCCCTACCATTAGATGAT,0,2100285
lacIp,0.5,1,1,GGTCCCAAACGCGCGCAGCG,0,2109115
lacIp,0.5,1,1,GGTCCAGCGAAGTAGCGGGA,0,2107357
lacIp,0.5,1,1,GGTCCAAGGCCACCCGATCC,0,2089493
lacIp,0.5,1,1,GGTCAGTCGACAGAGCTACG,0,2107140
lacIp,0.5,1,1,GGTATGTGTTGGAGGGCGCA,0,2106918
lacIp,0.5,1,1,GGTAGAATGAATCCATGGTT,0,2118540
lacIp,0.5,1,1,GGTACTTTAGCCCGGTATGG,0,2094108
lacIp,0.5,1,1,GGTACGAACGCAGGTGTACA,0,2111255
lacIp,0.5,1,1,GGTACAGGTGGAACAGTATT,0,2095455
lacIp,0.5,1,1,GGTAATTGTCACGGATGAAT,0,2096201
lacIp,0.5,1,1,GGTAATTAGTGGGCGTGTGA,0,2098351
lacIp,0.5,1,1,GGTAAGCTGGTTTGGGCCAT,0,2109137
lacIp,0.5,1,1,GGTAAATACGAGACGTAAGC,0,2116496
lacIp,0.5,1,1,GGGTTTGGGGTACAGGATAA,0,2113080
lacIp,0.5,1,1,GGGTTCACTTGATCAGGTTG,0,2088167
lacIp,0.5,1,1,GGGTTACTGAAATCTCATGA,0,2101723
lacIp,0.5,1,1,GGGTGTGAGCAGGAAGACTT,0,2096574
lacIp,0.5,1,1,GGGTGTATGTTATCACTCTG,0,2103213
lacIp,0.5,1,1,GGGTGCGCCGTCGGTGTCTT,0,2095117
lacIp,0.5,1,1,GGGTCCATAAGAGAGTTGAC,0,2098852
lacIp,0.5,1,1,GGGTCAGTATAATGAAGGCA,0,2096655
lacIp,0.5,1,1,GGGTCACTATCGTTTCTGCA,0,2104976
lacIp,0.5,1,1,GGGTATTCAACCGTACCGTA,0,2097803
lacIp,0.5,1,1,GGGTAACGGGGGGGGCCGCA,0,2088232
lacIp,0.5,1,1,GGGGTTGGAGCGAGCGGGCT,0,2113554
lacIp,0.5,1,1,GGGGGTATTACCGCTGAACG,0,2111034
lacIp,0.5,1,1,GGGGGGTCGCGCCTTGAGTT,0,2101868
lacIp,0.5,1,1,GGGGGGAACTATAGAAAGGC,0,2085741
lacIp,0.5,1,1,GGGGGCGTACACGCCTCGGC,0,2120005
lacIp,0.5,1,1,GGGGGAATACTCACCACACG,0,2098321
lacIp,0.5,1,1,GGGGCTTGTGCAGAGCCCCT,0,2113241
lacIp,0.5,1,1,GGGGCTCGCCAACAAGCTAC,0,2115458
lacIp,0.5,1,1,GGGGCGTCAGAATCAACTCG,0,2107588
lacIp,0.5,1,1,GGGGCAAGTTGATTCGGCTT,0,2114022
lacIp,0.5,1,1,GGGGCAACTACAAAATATAC,0,2091930
lacIp,0.5,1,1,GGGGAGTGTACGAAGGGGTA,0,2102642
lacIp,0.5,1,1,GGGGAGCTACCCTCCTTTAC,0,2116912
lacIp,0.5,1,1,GGGGAGCCATGACCACTGTC,0,2118881
lacIp,0.5,1,1,GGGCTTGGAAATAGAAGAGA,0,2089749
lacIp,0.5,1,1,GGGCTTCGCCCAAGAAAGCT,0,2086650
lacIp,0.5,1,1,GGGCGTGGCAAGCTCGCTTT,0,2090969
lacIp,0.5,1,1,GGGCGTCAAGCGCCGTAAAA,0,2108074
lacIp,0.5,1,1,GGGCGCCGTGTGTTTAATCT,0,2108689
lacIp,0.5,1,1,GGGCATTGGGGATACACCGT,0,2116446
lacIp,0.5,1,1,GGGATTGCACAGAAGGTCGG,0,2089103
lacIp,0.5,1,1,GGGATTCTAGTAAGGGCCCC,0,2121573
lacIp,0.5,1,1,GGGATGGGCCACGACACCGA,0,2111415
lacIp,0.5,1,1,GGGATCATCAAAAATTACAT,0,2099925
lacIp,0.5,1,1,GGGAGGATCCCCTTGGTGTT,0,2106545
lacIp,0.5,1,1,GGGAGCCCAGCAGAAGGGAG,0,2092995
lacIp,0.5,1,1,GGGAGCCATGGTGCGCACAA,0,2121953
lacIp,0.5,1,1,GGGAGAGCACCCCGCCCGCC,0,2091884
lacIp,0.5,1,1,GGGACTCGAAAGACCGGCCA,0,2093759
lacIp,0.5,1,1,GGGACCGCGGGGACAGCGCG,0,2086917
lacIp,0.5,1,1,GGGAACGTAGGTGGAAGAAA,0,2095400
lacIp,0.5,1,1,GGCTTTGAGCTTGCAGTTGT,0,2114741
lacIp,0.5,1,1,GGCTTAAATGTGCCTGGCTA,0,2096196
lacIp,0.5,1,1,GGCTGTGCCATCTTGTGGCC,0,2109618
lacIp,0.5,1,1,GGCTGTGACGGCGTAACAAA,0,2088801
lacIp,0.5,1,1,GGCTGCAACTTGTTGCTTAG,0,2112816
lacIp,0.5,1,1,GGCTGACCCATGCACGTATA,0,2105999
lacIp,0.5,1,1,GGCTATTCGTTCCGTAAGTT,0,2098589
lacIp,0.5,1,1,GGCTATTCCCCACTAGGGGT,0,2093538
lacIp,0.5,1,1,GGCTACCTGGCTTGCTACAT,0,2111851
lacIp,0.5,1,1,GGCTAAGTACTGAAGTAATA,0,2094404
lacIp,0.5,1,1,GGCGTCTTTCATGTGTGAGT,0,2088263
lacIp,0.5,1,1,GGCGTCAAACGTATTTTAAG,0,2111977
lacIp,0.5,1,1,GGCGGGCTCGAAAGCGAGTG,0,2116417
lacIp,0.5,1,1,GGCGGCCAGGGATGGCACGT,0,2115629
lacIp,0.5,1,1,GGCGGAGAGACCGGGCGACA,0,2092498
lacIp,0.5,1,1,GGCGCTCTTAGGGGGAGAAA,0,2111306
lacIp,0.5,1,1,GGCGAGTCGGCGTTCCAAGA,0,2119193
lacIp,0.5,1,1,GGCGACTTATTTTGACCGTT,0,2122279
lacIp,0.5,1,1,GGCGACGGTTGAGATGATAT,0,2113082
lacIp,0.5,1,1,GGCGAACTGTGAGGCCGGTT,0,2096956
lacIp,0.5,1,1,GGCCTTCAGTTTGGCATAAA,0,2115829
lacIp,0.5,1,1,GGCCTGGTCTCCTAGTTGTC,0,2102970
lacIp,0.5,1,1,GGCCTACGTTTTTACTTAAC,0,2108795
lacIp,0.5,1,1,GGCCGCGTCAATTGATGGCT,0,2108798
lacIp,0.5,1,1,GGCCGAGCCGTCCGCCACTA,0,2101059
lacIp,0.5,1,1,GGCCGACCAGGTTATGCCTA,0,2099338
lacIp,0.5,1,1,GGCCCTTCCGGGCTCGTAAT,0,2105369
lacIp,0.5,1,1,GGCCAGCCCGATAAGACGTT,0,2113929
lacIp,0.5,1,1,GGCCAGAGGTGATGCGTCGT,0,2104812
lacIp,0.5,1,1,GGCATCGTCGAATTCGGCGG,0,2088535
lacIp,0.5,1,1,GGCATCGGAATATGCATCTC,0,2108219
lacIp,0.5,1,1,GGCATCCTGCTGGTTAAAGT,0,2094656
lacIp,0.5,1,1,GGCATACATACTGCATAATA,0,2117599
lacIp,0.5,1,1,GGCAGTGAGAACAAATGACT,0,2113531
lacIp,0.5,1,1,GGCAGATTTCGTTCGAATCA,0,2106828
lacIp,0.5,1,1,GGCAGATTAGTTCAGGAGAT,0,2117936
lacIp,0.5,1,1,GGCAGACCCATACTGGAACT,0,2109630
lacIp,0.5,1,1,GGCACAATTGCTTTTGTATA,0,2092406
lacIp,0.5,1,1,GGCAATCTAGCGCATAGCAA,0,2105727
lacIp,0.5,1,1,GGCAAGCGGAGCGACGTGAT,0,2109869
lacIp,0.5,1,1,GGCAACAACCTTCTCCCAGT,0,2109615
lacIp,0.5,1,1,GGCAAAAATGCAGTTGTCAT,0,2099074
lacIp,0.5,1,1,GGATTGTGCCCAGTGGAACT,0,2098695
lacIp,0.5,1,1,GGATTAAAGTTTAGCTTTGG,0,2100900
lacIp,0.5,1,1,GGATGTCAGGAAGGTTTAGT,0,2091228
lacIp,0.5,1,1,GGATCGTCGGGGTAACGTGG,0,2118451
lacIp,0.5,1,1,GGATCAGTGGTCTTCAATAG,0,2116699
lacIp,0.5,1,1,GGATATTTGGTATCATATTT,0,2120124
lacIp,0.5,1,1,GGATATTGAGGGAAAACTTT,0,2085930
lacIp,0.5,1,1,GGATAGACGGAGAGGAAGCC,0,2114946
lacIp,0.5,1,1,GGAGTGTCTGAGCGCGGCAA,0,2118757
lacIp,0.5,1,1,GGAGTATCGTGTGGACTTGG,0,2110644
lacIp,0.5,1,1,GGAGGCTCACTTTGTATGAT,0,2092852
lacIp,0.5,1,1,GGAGGAACTGTTCCAGTGTA,0,2099724
lacIp,0.5,1,1,GGAGCTTTACTAACCAGCAG,0,2094180
lacIp,0.5,1,1,GGAGCGACAAACAACTGGGT,0,2087743
lacIp,0.5,1,1,GGAGCCGGATGAACCTGTCG,0,2107828
lacIp,0.5,1,1,GGAGCCCCAATCTTACAGAC,0,2093703
lacIp,0.5,1,1,GGAGACTCACACAGCCCGCT,0,2117670
lacIp,0.5,1,1,GGACTGTCTCGCCGGTGGGA,0,2117194
lacIp,0.5,1,1,GGACGGGCATTACTTTTGAC,0,2095972
lacIp,0.5,1,1,GGACGCTTGGTGACCTGGTG,0,2118914
lacIp,0.5,1,1,GGACGATCGCAAACTGTTCC,0,2117237
lacIp,0.5,1,1,GGACCTCCGGAGACATTCTT,0,2112821
lacIp,0.5,1,1,GGACAGGTGCCAATGACCAT,0,2102673
lacIp,0.5,1,1,GGACAGGGGGGTAGAACCTA,0,2087148
lacIp,0.5,1,1,GGACAGCAGTTGGGCAGGGG,0,2097639
lacIp,0.5,1,1,GGACAACAGACTAATCAATC,0,2097988
lacIp,0.5,1,1,GGAATGCTGGCGGTGTAACT,0,2090146
lacIp,0.5,1,1,GGAATGACGGTAGGGTTTCT,0,2101737
lacIp,0.5,1,1,GGAAGGGATCGGGGCAGAGG,0,2099221
lacIp,0.5,1,1,GGAAGGACAGAGCTACGTCC,0,2114651
lacIp,0.5,1,1,GGAAGCGGTCAGGTTGCAGT,0,2088040
lacIp,0.5,1,1,GGAACTCAGCTACACTATCT,0,2105263
lacIp,0.5,1,1,GGAACCGGTCGGACTGGAGA,0,2087572
lacIp,0.5,1,1,GGAAATCTCAGGTTCCCTGA,0,2096654
lacIp,0.5,1,1,GGAAACCGAGGTCGGGCGAA,0,2119760
lacIp,0.5,1,1,GGAAAATTTGGCACGCCGGT,0,2117059
lacIp,0.5,1,1,GCTTTTGAGTCTCAGAGATC,0,2113530
lacIp,0.5,1,1,GCTTTGAGGCCCAGTTAAAG,0,2096420
lacIp,0.5,1,1,GCTTTCGGTTAGTGCAATCA,0,2106645
lacIp,0.5,1,1,GCTTTCCCTGACATGGACAG,0,2115114
lacIp,0.5,1,1,GCTTCGGCGAGGCCCTTATC,0,2110592
lacIp,0.5,1,1,GCTTCAATCTACGGCCTTAT,0,2105461
lacIp,0.5,1,1,GCTTATCCCCTGAGTCGCTA,0,2115932
lacIp,0.5,1,1,GCTGTTTCATGGGGATTCCT,0,2101187
lacIp,0.5,1,1,GCTGTATGATGAATTAGTAT,0,2093954
lacIp,0.5,1,1,GCTGGTCTGTGGTATCTCTG,0,2100852
lacIp,0.5,1,1,GCTGGTATAACCGATGGCGT,0,2121496
lacIp,0.5,1,1,GCTGGGCATTACCGATGCCA,0,2110679
lacIp,0.5,1,1,GCTGGGAAAGCAGGATTCGG,0,2104249
lacIp,0.5,1,1,GCTGGCGCTACTTGGGGTCA,0,2090050
lacIp,0.5,1,1,GCTGGATAGGAACGCCGATA,0,2095286
lacIp,0.5,1,1,GCTGCGTTACTAAAAAAGCT,0,2098408
lacIp,0.5,1,1,GCTGCAGGGACTTGCTGTGT,0,2094611
lacIp,0.5,1,1,GCTGACGAAAAAGATTCGAA,0,2119339
lacIp,0.5,1,1,GCTGACATGATTCTCTTCAA,0,2107510
lacIp,0.5,1,1,GCTCTGGTTCACTCACTGTA,0,2086488
lacIp,0.5,1,1,GCTCTGCTGTCCATGGCTAG,0,2094454
lacIp,0.5,1,1,GCTCTCTAAATACGAGTAGT,0,2121415
lacIp,0.5,1,1,GCTCTCGTGTCCCGATCAAG,0,2092872
lacIp,0.5,1,1,GCTCTCAGGTGTCGTACCTG,0,2095013
lacIp,0.5,1,1,GCTCTACGCAGAGGTGGAGC,0,2086883
lacIp,0.5,1,1,GCTCTAACCTGCCTCTTGGC,0,2110376
lacIp,0.5,1,1,GCTCCCGCTTTGATCGAATA,0,2103414
lacIp,0.5,1,1,GCTCATGGTTCCGGTATGTT,0,2112940
lacIp,0.5,1,1,GCTCATATTGGTTTCGACCA,0,2086974
lacIp,0.5,1,1,GCTCACGATTAGAGTCTTGG,0,2104159
lacIp,0.5,1,1,GCTCAATTTACCTAAATTAC,0,2119242
lacIp,0.5,1,1,GCTCAAGGCGTTTGTCGGTA,0,2105558
lacIp,0.5,1,1,GCTCAACGGGGACCCGCGCC,0,2116056
lacIp,0.5,1,1,GCTCAACGATTGGTAAGAGT,0,2095522
lacIp,0.5,1,1,GCTATTGTTACCAGATTTCT,0,2101973
lacIp,0.5,1,1,GCTATAGGACACCTTAGCTT,0,2110324
lacIp,0.5,1,1,GCTAGTCATGCCAGTCCGAG,0,2088585
lacIp,0.5,1,1,GCTAGGACCATGTCGCCCGT,0,2102765
lacIp,0.5,1,1,GCTAGATTATGTCACCTTTT,0,2114582
lacIp,0.5,1,1,GCTACCGTGAATCTGTTTGT,0,2109442
lacIp,0.5,1,1,GCTAATGTGTGCGTGTGAGT,0,2121624
lacIp,0.5,1,1,GCTAATGGCTCTGGGTTTTC,0,2107254
lacIp,0.5,1,1,GCTAATCGATAGAGAGTCGA,0,2096237
lacIp,0.5,1,1,GCTAATCAATGTGGCCTAGC,0,2105511
lacIp,0.5,1,1,GCTAAGCCCTCCCCATAGGA,0,2090630
lacIp,0.5,1,1,GCGTTTTGCAAGGAAATTGT,0,2120957
lacIp,0.5,1,1,GCGTTACTTGGTTCGATTAG,0,2100726
lacIp,0.5,1,1,GCGTGTGTCTGTCCAACGGC,0,2096334
lacIp,0.5,1,1,GCGTGCCGATAGACTTAGTT,0,2095813
lacIp,0.5,1,1,GCGTCTGGGTCGAATATCCT,0,2103266
lacIp,0.5,1,1,GCGTATGATGGTTTTTTCAT,0,2106886
lacIp,0.5,1,1,GCGTATGATCCTCACTTTAA,0,2116726
lacIp,0.5,1,1,GCGTATCCACTTAAGAAGCC,0,2103811
lacIp,0.5,1,1,GCGTAGGCACAGGGAGGGAC,0,2117538
lacIp,0.5,1,1,GCGTACCCCTCATCGACCGG,0,2119348
lacIp,0.5,1,1,GCGTAACGTTCGGAGCGCCG,0,2086356
lacIp,0.5,1,1,GCGTAACCCAACATGTCGGA,0,2115130
lacIp,0.5,1,1,GCGGTGTCTGATCAGGGCGA,0,2093645
lacIp,0.5,1,1,GCGGGTGACTGCCGCCGATA,0,2106385
lacIp,0.5,1,1,GCGGGTCAGCCGGGAGTGAA,0,2105864
lacIp,0.5,1,1,GCGGGAGCTGGGGTCCGGCG,0,2120779
lacIp,0.5,1,1,GCGGGACCAGTCAGGTCAGG,0,2085874
lacIp,0.5,1,1,GCGGATCGTCCACCATAGAA,0,2113325
lacIp,0.5,1,1,GCGGATCATGACGCTCAACT,0,2091969
lacIp,0.5,1,1,GCGGAATACGGCCGTCGAGA,0,2105562
lacIp,0.5,1,1,GCGCTTGTCTCGGGTAGCTG,0,2099725
lacIp,0.5,1,1,GCGCTCACGGTGGAGATTGT,0,2116731
lacIp,0.5,1,1,GCGCGTCACATTCTTGGATC,0,2104117
lacIp,0.5,1,1,GCGCGGTGAGAGCTTATGTC,0,2089448
lacIp,0.5,1,1,GCGCGCCACAATTCCGAGGC,0,2090055
lacIp,0.5,1,1,GCGCCAGGTTGACTATCGTA,0,2102570
lacIp,0.5,1,1,GCGCCACAGGTGACTGGGCA,0,2098237
lacIp,0.5,1,1,GCGCACCTCGGTATTGTATT,0,2096805
lacIp,0.5,1,1,GCGCAAGAAAGGTAGGACCA,0,2088033
lacIp,0.5,1,1,GCGCAAACACATGCTCGAGT,0,2091789
lacIp,0.5,1,1,GCGATCCTGGTGGACTCCAA,0,2094249
lacIp,0.5,1,1,GCGATCCCATTTTTCTACAT,0,2090285
lacIp,0.5,1,1,GCGAGATTTGAGTTTTTACT,0,2087440
lacIp,0.5,1,1,GCGACTGAAAAAACTTTGGC,0,2111656
lacIp,0.5,1,1,GCGAACGAGATCGGGAGGCC,0,2096247
lacIp,0.5,1,1,GCGAAACTCATGTATCCCAA,0,2119940
lacIp,0.5,1,1,GCCTTTCGAATTCGCCAGAT,0,2096508
lacIp,0.5,1,1,GCCTTAGTGCGGTACGGGGT,0,2110245
lacIp,0.5,1,1,GCCTGTTAGTTGGGCTATCT,0,2113939
lacIp,0.5,1,1,GCCTGGAAACCTTATGGTTT,0,2095450
lacIp,0.5,1,1,GCCTGCGTACCCTGGATCGC,0,2099115
lacIp,0.5,1,1,GCCTGAGCATCTTGTGGCAA,0,2113721
lacIp,0.5,1,1,GCCTCTGATGACATTGGCAT,0,2114410
lacIp,0.5,1,1,GCCTCCACATGACAAGGATT,0,2108467
lacIp,0.5,1,1,GCCTCAACTCCATTACGCCC,0,2105329
lacIp,0.5,1,1,GCCTATAATAACATATAGCA,0,2094253
lacIp,0.5,1,1,GCCTAATTTCAGTCTGGGCA,0,2118309
lacIp,0.5,1,1,GCCGTTTTCGCCGGCTGGCC,0,2120582
lacIp,0.5,1,1,GCCGTGCGCGTGTTCTACGC,0,2100017
lacIp,0.5,1,1,GCCGTGCCTCCTGTAGTTGG,0,2101014
lacIp,0.5,1,1,GCCGCAGCGGATCTATATAC,0,2116292
lacIp,0.5,1,1,GCCGCACAGAGTCGGCTATG,0,2112714
lacIp,0.5,1,1,GCCGATATGTAAAGAAGTGG,0,2093528
lacIp,0.5,1,1,GCCGACTGATGTGCGCCACT,0,2111219
lacIp,0.5,1,1,GCCGACCTCCGTTGAGCGGG,0,2099710
lacIp,0.5,1,1,GCCGAAAACAAGTCGAAGCA,0,2107016
lacIp,0.5,1,1,GCCCTAAGGCATCTTAAGAT,0,2113700
lacIp,0.5,1,1,GCCCGTGTTTCTGCTGTCCA,0,2105487
lacIp,0.5,1,1,GCCCGTCCCGTTAGTGTGGC,0,2087593
lacIp,0.5,1,1,GCCCGGATCTTCTGGCCTTT,0,2113414
lacIp,0.5,1,1,GCCCGCTTCGCATGCGTGTC,0,2117067
lacIp,0.5,1,1,GCCCGCTCAAGGTTCGCAAG,0,2098963
lacIp,0.5,1,1,GCCCGCGACACATAATCGCA,0,2103278
lacIp,0.5,1,1,GCCCGACCGGACACAGTAAC,0,2092396
lacIp,0.5,1,1,GCCCCTGTGCATGGTAACTG,0,2107987
lacIp,0.5,1,1,GCCCCACGTAGAAGACGGTA,0,2096993
lacIp,0.5,1,1,GCCCCACCGTCAAGATCACA,0,2089035
lacIp,0.5,1,1,GCCCCACCATGGCGTTAGAA,0,2105866
lacIp,0.5,1,1,GCCCATCTGCCCACAATACT,0,2097404
lacIp,0.5,1,1,GCCATGAGTGATGGCTCAGC,0,2120129
lacIp,0.5,1,1,GCCATACATGGGCGTTGCGT,0,2101798
lacIp,0.5,1,1,GCCATACATGATATGCCGTT,0,2094839
lacIp,0.5,1,1,GCCATAAAGATCTCCGACAG,0,2098435
lacIp,0.5,1,1,GCCAGTTAGAAGATTCGGGA,0,2112864
lacIp,0.5,1,1,GCCAGTACACAGGGGGGAGA,0,2112520
lacIp,0.5,1,1,GCCAGACAATCGGGATGTAT,0,2103824
lacIp,0.5,1,1,GCCACGCAATCTATAAGGAT,0,2108893
lacIp,0.5,1,1,GCCACCGCGCGAGCCACAGG,0,2098591
lacIp,0.5,1,1,GCCAATAGTGAATGAGGTCT,0,2117172
lacIp,0.5,1,1,GCATGTTTACGACCTGTAAT,0,2087326
lacIp,0.5,1,1,GCATGGGTACCTCTGGAGAC,0,2113831
lacIp,0.5,1,1,GCATGCTGTCGCCGTCATTA,0,2096938
lacIp,0.5,1,1,GCATGCTCTAAAAAAGAACA,0,2097048
lacIp,0.5,1,1,GCATCTGTAGGTTCTCCTTG,0,2088132
lacIp,0.5,1,1,GCATAGGAGCTGGGACCAGG,0,2110999
lacIp,0.5,1,1,GCATACAAACGTCGGCCGGA,0,2089003
lacIp,0.5,1,1,GCAGTGGCTAGACGATTAGC,0,2112268
lacIp,0.5,1,1,GCAGTCATTCGGCTGGAGTG,0,2109276
lacIp,0.5,1,1,GCAGGAGTCGTATAAACTAT,0,2090519
lacIp,0.5,1,1,GCAGCCCTCCAGCTGACGGT,0,2114081
lacIp,0.5,1,1,GCAGCATCGGCAGAGTGTAT,0,2088983
lacIp,0.5,1,1,GCAGACGGCTGGGTCATAGC,0,2122236
lacIp,0.5,1,1,GCAGAAGTATGCGCGGTCAG,0,2121030
lacIp,0.5,1,1,GCACTTTCCAGCTAGTTAGA,0,2088825
lacIp,0.5,1,1,GCACTTGGGACGGCTATGTA,0,2102256
lacIp,0.5,1,1,GCACGTGCCTGAAGCTTCGG,0,2095639
lacIp,0.5,1,1,GCACCGGCCAGGACGGTAGG,0,2103750
lacIp,0.5,1,1,GCACCAGGGCGTGTTAGGCA,0,2090117
lacIp,0.5,1,1,GCACAGTCGGATAGATCAGG,0,2094286
lacIp,0.5,1,1,GCACACTGGACCACCAGCTC,0,2099096
lacIp,0.5,1,1,GCACAACCACTTTCACGGCA,0,2089423
lacIp,0.5,1,1,GCAATTTTGTTATTCTAAAC,0,2109795
lacIp,0.5,1,1,GCAATGGGGCGTTCGCTACA,0,2105967
lacIp,0.5,1,1,GCAAGTTCAGCGCATTGGCA,0,2114248
lacIp,0.5,1,1,GCAAGGGTGTTGTGGGAAGC,0,2090979
lacIp,0.5,1,1,GCAAGGCCCCAGCCGTCGTA,0,2100127
lacIp,0.5,1,1,GCAAGGACGACGGGCATCAC,0,2099152
lacIp,0.5,1,1,GCAAGAGAATATAACTAATC,0,2100494
lacIp,0.5,1,1,GCAAGACACACACCGGAGAG,0,2104724
lacIp,0.5,1,1,GCAACTTCTGTATAGCCCAG,0,2121980
lacIp,0.5,1,1,GCAACTGGACCGTGGAACCT,0,2107774
lacIp,0.5,1,1,GCAACGCGTATATGGTCCTA,0,2117273
lacIp,0.5,1,1,GCAACCTTCACACGGGACAA,0,2117404
lacIp,0.5,1,1,GCAACCTCCGTAAGGTTAGT,0,2089405
lacIp,0.5,1,1,GCAACCGATGCACCTCCAGT,0,2095261
lacIp,0.5,1,1,GCAACAGTAAGCGTTCTCGG,0,2095806
lacIp,0.5,1,1,GCAAATTTCTTAGCCAATAA,0,2098706
lacIp,0.5,1,1,GCAAATTCCAATATAGGCCG,0,2087686
lacIp,0.5,1,1,GCAAAGCCCGGGATAGGTTC,0,2092571
lacIp,0.5,1,1,GCAAACACCCCATGTAGGGG,0,2102734
lacIp,0.5,1,1,GATTTTTAGGTTGCAACCAG,0,2103872
lacIp,0.5,1,1,GATTCGGGAGACTCACTTAG,0,2119358
lacIp,0.5,1,1,GATTCGCGCCTTTGTTTTAG,0,2104640
lacIp,0.5,1,1,GATTCGCCTGCACCAGACCG,0,2086861
lacIp,0.5,1,1,GATTCAGCGCTAGGATAGCC,0,2101719
lacIp,0.5,1,1,GATTAGGCAAAATTACACTA,0,2104956
lacIp,0.5,1,1,GATTACTCGTTACCCGCATT,0,2103368
lacIp,0.5,1,1,GATGTCTCAGGTGTCTACAT,0,2115854
lacIp,0.5,1,1,GATGGGGATAGCGATGAATT,0,2112941
lacIp,0.5,1,1,GATGCTCTCCCATCTTGGTA,0,2101349
lacIp,0.5,1,1,GATGCGGGACGAGCGGGTTG,0,2092592
lacIp,0.5,1,1,GATGCGCCGATTTGGCTCCA,0,2100893
lacIp,0.5,1,1,GATCTTCGGGATCAGCCGTG,0,2094627
lacIp,0.5,1,1,GATCGGTCAGATTTAGCGTT,0,2106914
lacIp,0.5,1,1,GATCGGCGTCACTAGCTACC,0,2102409
lacIp,0.5,1,1,GATCGCCAGTGGACCGCGAT,0,2104769
lacIp,0.5,1,1,GATCCGTTTGGTCCACGACT,0,2087104
lacIp,0.5,1,1,GATCCCTTTCCTAAAGTTGC,0,2110354
lacIp,0.5,1,1,GATCAGAGCCGGAGGTTCTT,0,2116382
lacIp,0.5,1,1,GATCACAGATAGGTTCTCGT,0,2101222
lacIp,0.5,1,1,GATATGTGTCGCGCTGCTGA,0,2113669
lacIp,0.5,1,1,GATAATTCGACGTATCTACA,0,2117089
lacIp,0.5,1,1,GATAATGAGACAGTGCTATT,0,2087191
lacIp,0.5,1,1,GAGTTTGCTCGCCAGTGTAC,0,2108586
lacIp,0.5,1,1,GAGTGAGCCAGCTTAAGAGA,0,2116962
lacIp,0.5,1,1,GAGTCTGTCCGTATCTCTGA,0,2102358
lacIp,0.5,1,1,GAGTAGTCGTACTATACCTG,0,2104029
lacIp,0.5,1,1,GAGTAGCATGAATTGCTCAA,0,2110216
lacIp,0.5,1,1,GAGGTTATGTGCGAGGGAAT,0,2111247
lacIp,0.5,1,1,GAGGGTTCTTGGGATTGAAG,0,2100912
lacIp,0.5,1,1,GAGGGTATTGTCAACTGAGC,0,2107711
lacIp,0.5,1,1,GAGGGCGATCGCATAAGCTA,0,2115880
lacIp,0.5,1,1,GAGGGATGTTGACACCGGTT,0,2107728
lacIp,0.5,1,1,GAGGGATCTACTGATAGGGT,0,2098853
lacIp,0.5,1,1,GAGGCGTTGATTAAGCGGCG,0,2094046
lacIp,0.5,1,1,GAGGCCTTCAGAAGAAACGG,0,2117163
lacIp,0.5,1,1,GAGGCATTGGTCGCCGTGAC,0,2118577
lacIp,0.5,1,1,GAGGAGCTGTGTGGGATTTT,0,2116418
lacIp,0.5,1,1,GAGGACTTGGACACGAACAA,0,2113424
lacIp,0.5,1,1,GAGGACGAACTGAGCGACGA,0,2121694
lacIp,0.5,1,1,GAGGAAGTGAGAGTTGCTCT,0,2102491
lacIp,0.5,1,1,GAGCTTCGGCTTCACTACGC,0,2118802
lacIp,0.5,1,1,GAGCTCCAACAACGAGTCGT,0,2098335
lacIp,0.5,1,1,GAGCGTTCAGCCACAATTTG,0,2116810
lacIp,0.5,1,1,GAGCGGTGCCTCAGGGTTTT,0,2115587
lacIp,0.5,1,1,GAGCGAGGGGGGTTGTGATC,0,2108317
lacIp,0.5,1,1,GAGCGAGACCTCCAATTTAG,0,2097670
lacIp,0.5,1,1,GAGCCCTATTAAGGGTTTGT,0,2088255
lacIp,0.5,1,1,GAGCCAAGCGCTGTTATCAT,0,2093926
lacIp,0.5,1,1,GAGCATTTCAAGGCGCTCCT,0,2100695
lacIp,0.5,1,1,GAGCACGGAAAGGGCCACTC,0,2088432
lacIp,0.5,1,1,GAGATTAATCTTACTGGGCT,0,2103154
lacIp,0.5,1,1,GAGATGCATTGCGCGAAGGT,0,2117035
lacIp,0.5,1,1,GAGATCAACACGGATGATAT,0,2098732
lacIp,0.5,1,1,GAGACCCACCCCCGCGCAGT,0,2087852
lacIp,0.5,1,1,GAGACAAGTGGGGCAATCAG,0,2106789
lacIp,0.5,1,1,GAGAATGGAACCTTCGTGAG,0,2095665
lacIp,0.5,1,1,GAGAAATGCAGCTAGCGAAG,0,2092670
lacIp,0.5,1,1,GACTTTTATAACAGGATCAA,0,2109933
lacIp,0.5,1,1,GACTGTCGGTTTGCACTTAC,0,2104471
lacIp,0.5,1,1,GACTGGAAGCAGGCTTCATG,0,2108464
lacIp,0.5,1,1,GACTGCGGCCCTCTTCCTAT,0,2114144
lacIp,0.5,1,1,GACTATTGGCATGGACCAAC,0,2117806
lacIp,0.5,1,1,GACTATCGTTATGAACAATT,0,2088619
lacIp,0.5,1,1,GACTAGGTTTGCCACAGGGA,0,2100386
lacIp,0.5,1,1,GACTAATTTGCAGCTCTTGA,0,2091344
lacIp,0.5,1,1,GACGTTGGGGTTAGCGTCCT,0,2112791
lacIp,0.5,1,1,GACGTTATCGCCAGAGTCAA,0,2106166
lacIp,0.5,1,1,GACGTCTTGTAATAAGATCG,0,2119546
lacIp,0.5,1,1,GACGTCCCCTTAATAACTCC,0,2116274
lacIp,0.5,1,1,GACGGGATTCAGCACGGTCA,0,2119033
lacIp,0.5,1,1,GACGGCCATCGAACGTTATC,0,2117579
lacIp,0.5,1,1,GACGCTGCTAGCGGTGCACT,0,2104641
lacIp,0.5,1,1,GACGCTCGACCTAAATCAGT,0,2094368
lacIp,0.5,1,1,GACGCGACGCCTACGGAACC,0,2098759
lacIp,0.5,1,1,GACGCCTCTCGGACCCTTAT,0,2114765
lacIp,0.5,1,1,GACCTACGTGCAGGTGCGTT,0,2100705
lacIp,0.5,1,1,GACCTAATTACGGGCAGAGA,0,2117944
lacIp,0.5,1,1,GACCGTAATCCGTGACTTTT,0,2121533
lacIp,0.5,1,1,GACCGGGAAACAGCAGACAT,0,2101002
lacIp,0.5,1,1,GACCGCCGCGTACGAATAGT,0,2096463
lacIp,0.5,1,1,GACCGCATAGCTGTCTAAGG,0,2087469
lacIp,0.5,1,1,GACCGAGCATAACTCCCAGC,0,2105218
lacIp,0.5,1,1,GACCAGGAGCTAAATGCATA,0,2116202
lacIp,0.5,1,1,GACCAAATAAGGGTTGCACG,0,2088196
lacIp,0.5,1,1,GACATGTCCGCGCCGGCTAA,0,2090369
lacIp,0.5,1,1,GACAGTGTTGGGAAGGTACT,0,2095011
lacIp,0.5,1,1,GACAGGGTCCGGCACAGACT,0,2099006
lacIp,0.5,1,1,GACAGGCATAATATCGCGGG,0,2116510
lacIp,0.5,1,1,GACAGCCTATTACGCACTTT,0,2112744
lacIp,0.5,1,1,GACAGATGGGGCCATCACCT,0,2085882
lacIp,0.5,1,1,GACAGAAAAAAGGGGTACCA,0,2114320
lacIp,0.5,1,1,GACACTTCGCTCGGTAAGTG,0,2100256
lacIp,0.5,1,1,GACACGTGATGGAACACACC,0,2099600
lacIp,0.5,1,1,GACAAACCTCACTACGTCCC,0,2089611
lacIp,0.5,1,1,GAATTTAGATGCTAAACATA,0,2089000
lacIp,0.5,1,1,GAATTCTTAGTCCTAGGGCT,0,2100775
lacIp,0.5,1,1,GAATTCGAGAGCACTTCTAA,0,2092030
lacIp,0.5,1,1,GAATGTTATCGCACCGCAAG,0,2120205
lacIp,0.5,1,1,GAATGTTAAATCCAAAGGAT,0,2121399
lacIp,0.5,1,1,GAATGTCCTATCTACAACCC,0,2100491
lacIp,0.5,1,1,GAATGCTAGGCTGTCAGGGA,0,2117244
lacIp,0.5,1,1,GAATCTTGGGCCAGTTGCCA,0,2090324
lacIp,0.5,1,1,GAATCAAGGCTGTTGTCACT,0,2116108
lacIp,0.5,1,1,GAATAAGGTTCTGTAGCGAG,0,2119506
lacIp,0.5,1,1,GAAGGCATTCCTATAATCAC,0,2094703
lacIp,0.5,1,1,GAAGCTGTGCGAGGAAGGGT,0,2098179
lacIp,0.5,1,1,GAAGCAGTGAAATCGTCCCA,0,2087480
lacIp,0.5,1,1,GAAGCACCCTGCTAGGCCTC,0,2101084
lacIp,0.5,1,1,GAAGAGTGCTTACTGGAGAG,0,2101598
lacIp,0.5,1,1,GAAGAGTCCGCGCTGTCCTT,0,2100649
lacIp,0.5,1,1,GAAGAACAGATAAGCACGCT,0,2089453
lacIp,0.5,1,1,GAACTTCTCTTGGCTATAGT,0,2104935
lacIp,0.5,1,1,GAACTCCTGGTTCCGACTGG,0,2086568
lacIp,0.5,1,1,GAACGTGTTGAAATCGATTA,0,2107372
lacIp,0.5,1,1,GAACGCGGGAGAAGTTCCCT,0,2114344
lacIp,0.5,1,1,GAACGCACGCTGCCTTTGCC,0,2115786
lacIp,0.5,1,1,GAACCCTATCCCGATATGCA,0,2111020
lacIp,0.5,1,1,GAACCAAGAAATGTCCGACC,0,2099485
lacIp,0.5,1,1,GAACACCATCTGTTTTGTAT,0,2094842
lacIp,0.5,1,1,GAAATTGTATCACCCTGAGG,0,2107172
lacIp,0.5,1,1,GAAAGCAAAGGTATTGTCCA,0,2097860
lacIp,0.5,1,1,GAAACTTACGAAAGAGTCCA,0,2114471
lacIp,0.5,1,1,GAAACGTCCTAAGGCCACCG,0,2111951
lacIp,0.5,1,1,GAAACGTCAAAAGGCGTGGC,0,2117861
lacIp,0.5,1,1,GAAACCAAACATTGGACAGT,0,2087839
lacIp,0.5,1,1,GAAAATTTCGACCAGTCCCA,0,2109277
lacIp,0.5,1,1,GAAAAGTGTTCGTACGGCGG,0,2108072
lacIp,0.5,1,1,GAAAAGTCCTTCAAGTTATA,0,2092335
lacIp,0.5,1,1,GAAAACTCGTGAAATGAGTA,0,2118953
lacIp,0.5,1,1,GAAAACAACCCCTATCGGGG,0,2114165
lacIp,0.5,1,1,CTTTTCCGGCTTCAGAGACG,0,2089447
lacIp,0.5,1,1,CTTTTCCGAGACATACGAAT,0,2112051
lacIp,0.5,1,1,CTTTTCAAGTTGTACTTCAA,0,2098615
lacIp,0.5,1,1,CTTTTATTCAGTTAGCTTTA,0,2103941
lacIp,0.5,1,1,CTTTTACACTTCTAGTTCCA,0,2112745
lacIp,0.5,1,1,CTTTGGGGAGTGGGGCCTGT,0,2112813
lacIp,0.5,1,1,CTTTGCCCGGAGTAAGGTAC,0,2090261
lacIp,0.5,1,1,CTTTCTTCAGACCGGTTGGC,0,2091838
lacIp,0.5,1,1,CTTTCGCCGGTGCTATAAAA,0,2107121
lacIp,0.5,1,1,CTTTATTGCATCGTCTCCTG,0,2105663
lacIp,0.5,1,1,CTTTAGGGCAGGGGTGCAGT,0,2113545
lacIp,0.5,1,1,CTTGTTATCGTCTGGGCCAA,0,2111891
lacIp,0.5,1,1,CTTGTCAGCGAAGCCGTCGG,0,2089264
lacIp,0.5,1,1,CTTGGTAAGCACCCTTGCAT,0,2118672
lacIp,0.5,1,1,CTTGGGGTGTGACGCCATCA,0,2108129
lacIp,0.5,1,1,CTTGGCAGACAGGTAGGTTA,0,2100874
lacIp,0.5,1,1,CTTGGAAAGTTAATTGTTCA,0,2088080
lacIp,0.5,1,1,CTTGCTATCCATTTCGCTCG,0,2100231
lacIp,0.5,1,1,CTTGCAGCGTTGCATGCTCC,0,2102020
lacIp,0.5,1,1,CTTGATAAGCCGTAGGGAGA,0,2099282
lacIp,0.5,1,1,CTTGAGAGAATAAGACAAGC,0,2097754
lacIp,0.5,1,1,CTTGACATGCTGATTTAACG,0,2090439
lacIp,0.5,1,1,CTTCTGGCTTGATATATGTA,0,2102293
lacIp,0.5,1,1,CTTCGGTTCGGCATTATCTA,0,2101128
lacIp,0.5,1,1,CTTCGGTGGTCTGCGGTTCA,0,2121417
lacIp,0.5,1,1,CTTCCTGACCCCTGGCACAT,0,2109068
lacIp,0.5,1,1,CTTCCGGCATTGAAAATCCC,0,2087540
lacIp,0.5,1,1,CTTCAGTTAGAAGTCTCGAA,0,2087783
lacIp,0.5,1,1,CTTCAGGGCACTCTTGGTCG,0,2099225
lacIp,0.5,1,1,CTTCACTGGCAAGCAATCGC,0,2103745
lacIp,0.5,1,1,CTTATGAATCTCGCCACCCT,0,2086177
lacIp,0.5,1,1,CTTAGGCTTATCTGGGGTCG,0,2118231
lacIp,0.5,1,1,CTTAGCCTTTCACTCCCCCA,0,2101394
lacIp,0.5,1,1,CTTACGTCACGGACGAGGCT,0,2096955
lacIp,0.5,1,1,CTTACCATGTGGCCGATATA,0,2109381
lacIp,0.5,1,1,CTTAATCAAGAAATCCGTCA,0,2121795
lacIp,0.5,1,1,CTTAAGAGTTGGCATTCTAC,0,2088981
lacIp,0.5,1,1,CTTAAGACCTGGCACTTAGA,0,2094323
lacIp,0.5,1,1,CTGTTGTGGCACACGTTAAA,0,2121863
lacIp,0.5,1,1,CTGTTACTACGGAGTTGTAA,0,2118139
lacIp,0.5,1,1,CTGTGAATCATTACTAACGC,0,2086304
lacIp,0.5,1,1,CTGTACGGACTAAGCGCCCG,0,2107408
lacIp,0.5,1,1,CTGGTCTAGTGATTTATCAG,0,2093873
lacIp,0.5,1,1,CTGGTCGTGGTATTTCCGCA,0,2091879
lacIp,0.5,1,1,CTGGTACGCCATGAAAGTTG,0,2097001
lacIp,0.5,1,1,CTGGGGTGACATAACCCCCG,0,2094855
lacIp,0.5,1,1,CTGGGCCCCGGCCACTCAAC,0,2097958
lacIp,0.5,1,1,CTGGCTGGTCTGGATGCCCT,0,2099712
lacIp,0.5,1,1,CTGGCTATCGGGGTTGTGAA,0,2104803
lacIp,0.5,1,1,CTGGCATCACCCTTTTGACA,0,2117381
lacIp,0.5,1,1,CTGGAACACACCAATCGCGG,0,2100980
lacIp,0.5,1,1,CTGCTGGGCACCCAACTTGT,0,2104855
lacIp,0.5,1,1,CTGCTGAAGGCTGATCATTA,0,2090106
lacIp,0.5,1,1,CTGCTCGTTCGAGGGTCAGG,0,2103650
lacIp,0.5,1,1,CTGCTCACTTAAGAAGACAA,0,2114839
lacIp,0.5,1,1,CTGCGTTACGGTAACGGAGA,0,2098701
lacIp,0.5,1,1,CTGCGTGTCTACACCAGCAT,0,2119258
lacIp,0.5,1,1,CTGCGTAACTAAAGTTATTC,0,2094629
lacIp,0.5,1,1,CTGCGCAAGAACGTCCTGAA,0,2088594
lacIp,0.5,1,1,CTGCCTTCAGGGCGCCCGGC,0,2106134
lacIp,0.5,1,1,CTGCCAAGAGTACGGTCGAA,0,2090294
lacIp,0.5,1,1,CTGCATGTACCCTGATCGGG,0,2113245
lacIp,0.5,1,1,CTGCATCTACTACGGATATT,0,2093609
lacIp,0.5,1,1,CTGCAAATTATGACACGCAT,0,2103286
lacIp,0.5,1,1,CTGAGAAGTGTGGACCTAGA,0,2107754
lacIp,0.5,1,1,CTGAATCAGTGTTTCTGCAG,0,2118382
lacIp,0.5,1,1,CTGAACGGGTCGTACGTTCA,0,2085995
lacIp,0.5,1,1,CTGAACAGAAACGCGATTAA,0,2093505
lacIp,0.5,1,1,CTGAAAGCGAACTGTGAGGC,0,2100725
lacIp,0.5,1,1,CTCTTAGGGCCAGCTTGCTC,0,2112264
lacIp,0.5,1,1,CTCTGGTTTTTCACAGACGC,0,2116136
lacIp,0.5,1,1,CTCTCAACTCAGGCGCACTA,0,2118719
lacIp,0.5,1,1,CTCTAGTTTTTATAGCGCCA,0,2088940
lacIp,0.5,1,1,CTCTAACTCGGAGCCATAAG,0,2102008
lacIp,0.5,1,1,CTCGTTGTAGCTGCAACGAA,0,2116221
lacIp,0.5,1,1,CTCGTTAGTACGTGCTGTGT,0,2094663
lacIp,0.5,1,1,CTCGTGTTCGTCGCTTCGGA,0,2120165
lacIp,0.5,1,1,CTCGTGCAGGGCTCTACCGC,0,2111241
lacIp,0.5,1,1,CTCGTCTAAGCCCACCCTTA,0,2106369
lacIp,0.5,1,1,CTCGGTAGCCTTGCAGGAGC,0,2115354
lacIp,0.5,1,1,CTCGGGGGGCAGTTTTTGAG,0,2112083
lacIp,0.5,1,1,CTCGGGGATTAGAAAGCGGG,0,2103559
lacIp,0.5,1,1,CTCGGCTTATGCGAGTCGTT,0,2089122
lacIp,0.5,1,1,CTCGCTTGTGACGTTAATTC,0,2105365
lacIp,0.5,1,1,CTCGCTACAGGCGCTTATCC,0,2093704
lacIp,0.5,1,1,CTCGCGTGTTGTTTAGATAG,0,2099486
lacIp,0.5,1,1,CTCGCGCATAGGATGCGGCT,0,2122088
lacIp,0.5,1,1,CTCGACGGGTGTTCTGGTAA,0,2096084
lacIp,0.5,1,1,CTCCTTTCTGTTTATGCGTG,0,2089937
lacIp,0.5,1,1,CTCCGTTGCGGCGCATGTAT,0,2088867
lacIp,0.5,1,1,CTCCGTAGCAACATATCATT,0,2094405
lacIp,0.5,1,1,CTCCCCAACATAGCTGGATT,0,2116922
lacIp,0.5,1,1,CTCCAGTTTTATTCAGCGCT,0,2087847
lacIp,0.5,1,1,CTCCAGATTGATACTAAAAT,0,2105011
lacIp,0.5,1,1,CTCCAGATTATCTGGACTCA,0,2117154
lacIp,0.5,1,1,CTCCAGAACTGGCCGAAGGT,0,2108055
lacIp,0.5,1,1,CTCATGGATCGGTATTTAGA,0,2087556
lacIp,0.5,1,1,CTCATATCACACGCCATTCT,0,2118475
lacIp,0.5,1,1,CTCAGTGCCCGCTCTTGACA,0,2107017
lacIp,0.5,1,1,CTCAGGTCCGAGTCAAGCTT,0,2085959
lacIp,0.5,1,1,CTCAGCCTAAACTGCGGTCC,0,2114597
lacIp,0.5,1,1,CTCAGAAGGTTCGTGTATAA,0,2105887
lacIp,0.5,1,1,CTCACCATGTGGTGGTTTTG,0,2113708
lacIp,0.5,1,1,CTCAAGTGCGCTCCGCGTTG,0,2119564
lacIp,0.5,1,1,CTCAAGGCTTGACTGCCTAA,0,2091277
lacIp,0.5,1,1,CTCAAGATTAACATGGGCAG,0,2092784
lacIp,0.5,1,1,CTCAAAATACGCGTCACCTG,0,2119483
lacIp,0.5,1,1,CTATTTTGCGATGCGTGCGG,0,2111941
lacIp,0.5,1,1,CTATTTTATTTTCGGGAAAG,0,2109570
lacIp,0.5,1,1,CTATTCCCGGTTAAATTGAA,0,2117954
lacIp,0.5,1,1,CTATGTCGTAGGGGGGTCTC,0,2088119
lacIp,0.5,1,1,CTATGTCCCTGGGTCCAGCC,0,2105453
lacIp,0.5,1,1,CTATGTAGGCCACGCCCAAT,0,2105303
lacIp,0.5,1,1,CTATGGATGTGTCAAGGGCA,0,2094385
lacIp,0.5,1,1,CTATGCTTTCGCCATTGGAA,0,2102382
lacIp,0.5,1,1,CTATGCTATGCCCTAGGTGA,0,2110563
lacIp,0.5,1,1,CTATGAGGTGAACATTGTTG,0,2116736
lacIp,0.5,1,1,CTATGAGACGCGTCACCCAC,0,2094451
lacIp,0.5,1,1,CTATATCGGTGTCACGTCAG,0,2114170
lacIp,0.5,1,1,CTATACTCGGCAGTAAGCGC,0,2109898
lacIp,0.5,1,1,CTAGTTAAAGGATGCTTTGA,0,2107142
lacIp,0.5,1,1,CTAGTGCGGGTATAGCCTCG,0,2096659
lacIp,0.5,1,1,CTAGTAAACGTCGGGTCGAA,0,2096062
lacIp,0.5,1,1,CTAGGAGACTGGAATTAAAA,0,2104920
lacIp,0.5,1,1,CTAGCGTCTGTCAGCATAGG,0,2090901
lacIp,0.5,1,1,CTAGCGAGTGAATACGCACA,0,2104355
lacIp,0.5,1,1,CTAGCCGAGTGTCTGATACG,0,2102916
lacIp,0.5,1,1,CTAGATAGGGGATCAGTAAG,0,2107147
lacIp,0.5,1,1,CTACTCCACCGCGGGCTGAT,0,2111009
lacIp,0.5,1,1,CTACTAACTGCAAAGTACGA,0,2093635
lacIp,0.5,1,1,CTACGTGTCTGCTCCTAGAT,0,2093485
lacIp,0.5,1,1,CTACCGCCCGGCTCCTCCTA,0,2092761
lacIp,0.5,1,1,CTACCCTCTCATGGTGAGCG,0,2104486
lacIp,0.5,1,1,CTACACGGTCTTAGCACGGG,0,2119512
lacIp,0.5,1,1,CTACACCCTCAACCGTTAGG,0,2106098
lacIp,0.5,1,1,CTAATTTTCAGTTGATGGCC,0,2087568
lacIp,0.5,1,1,CTAATTAAAGAGGTTTGTAG,0,2096587
lacIp,0.5,1,1,CTAATGCGGCAGACTCGCTT,0,2100541
lacIp,0.5,1,1,CTAATATGCGCAGGTTCGTA,0,2094169
lacIp,0.5,1,1,CTAATAGGCAAAGCGCATGC,0,2107608
lacIp,0.5,1,1,CTAATACAACGCACGGGTTA,0,2113435
lacIp,0.5,1,1,CTAAGGCTTCTAGACGTGTT,0,2094838
lacIp,0.5,1,1,CTAACTTGTTTACCCGTGCC,0,2089769
lacIp,0.5,1,1,CTAACCGGATCTTACCCCAA,0,2105248
lacIp,0.5,1,1,CTAACACAAAACTGGCTCGG,0,2112633
lacIp,0.5,1,1,CTAAAGGACTCATCCGCGGG,0,2118017
lacIp,0.5,1,1,CTAAACCGCGTATTAACTTT,0,2100062
lacIp,0.5,1,1,CGTTTGAGAACTAAAGCGGG,0,2086785
lacIp,0.5,1,1,CGTTTCGTAGCCCCGGGTTC,0,2092599
lacIp,0.5,1,1,CGTTTCCTTATCATGGAGCG,0,2120099
lacIp,0.5,1,1,CGTTGGCGGGCGCACCCCAG,0,2106503
lacIp,0.5,1,1,CGTTGGACTAACAGGACTAT,0,2118098
lacIp,0.5,1,1,CGTTCCTACAAATCTGGCGT,0,2106827
lacIp,0.5,1,1,CGTGTCTGGGGTCACGACGT,0,2091300
lacIp,0.5,1,1,CGTGTCCAGGGGGTTTAATA,0,2093266
lacIp,0.5,1,1,CGTGTACCTATATTTCTGCA,0,2109445
lacIp,0.5,1,1,CGTGGTGGGAAGTATTGTTG,0,2096889
lacIp,0.5,1,1,CGTGGTGCATATTACCGCTA,0,2106831
lacIp,0.5,1,1,CGTGGGATAGGGAAGGTTAA,0,2103424
lacIp,0.5,1,1,CGTGGGACCTATTCCGCACT,0,2100078
lacIp,0.5,1,1,CGTGCTCTACATAATTAAGC,0,2120455
lacIp,0.5,1,1,CGTGCTCAAGTTGTGGAACA,0,2093728
lacIp,0.5,1,1,CGTGCCGATTTCGTCGATTC,0,2108956
lacIp,0.5,1,1,CGTGCATACTTGTATCAATG,0,2119130
lacIp,0.5,1,1,CGTGATATCTAGTCGATCGC,0,2107343
lacIp,0.5,1,1,CGTGAAGTACGACTAAAGGC,0,2097733
lacIp,0.5,1,1,CGTCTTGGTTCCGACCTGGT,0,2108327
lacIp,0.5,1,1,CGTCTTAGCTCATGAAGTGG,0,2108692
lacIp,0.5,1,1,CGTCTGCCGAAAATCTACGA,0,2099032
lacIp,0.5,1,1,CGTCTGAGGATTCATGCGGC,0,2108790
lacIp,0.5,1,1,CGTCTGAAGCGTACCTACGT,0,2106662
lacIp,0.5,1,1,CGTCTCGTACCGCAGTCTCG,0,2089607
lacIp,0.5,1,1,CGTCTCCATAGTACTATCCC,0,2104240
lacIp,0.5,1,1,CGTCTAAGACGTCAGACTTC,0,2113476
lacIp,0.5,1,1,CGTCGTCCACGCGACCAGAT,0,2096953
lacIp,0.5,1,1,CGTCGCACACCTTCGAGGAC,0,2103475
lacIp,0.5,1,1,CGTCCGGCGAAGTTGTTATC,0,2106124
lacIp,0.5,1,1,CGTCAAATATTCGAAACAAT,0,2098771
lacIp,0.5,1,1,CGTATTTTCGACTGCAATCA,0,2096405
lacIp,0.5,1,1,CGTATGTAGAGCAGCTATGT,0,2090602
lacIp,0.5,1,1,CGTATGACGCGTGACCCAGC,0,2099730
lacIp,0.5,1,1,CGTAGTATGCATGGGCGGAG,0,2119897
lacIp,0.5,1,1,CGTAGACAGGTCCAATAAAG,0,2091542
lacIp,0.5,1,1,CGTAGAAACTAGGGCGAAAC,0,2108892
lacIp,0.5,1,1,CGTACGGACCCTGACTGACC,0,2110222
lacIp,0.5,1,1,CGTACGCTGGACTGAAGTCA,0,2093584
lacIp,0.5,1,1,CGTAATGCTAGGCATCTCGA,0,2098427
lacIp,0.5,1,1,CGTAATCATTTTGCTAAACT,0,2117186
lacIp,0.5,1,1,CGTAAGCGCTGCGACGTCTG,0,2107957
lacIp,0.5,1,1,CGTAACAAGCCGTAGCCGCG,0,2092888
lacIp,0.5,1,1,CGGTGGCGCAGTATTCTCAA,0,2109448
lacIp,0.5,1,1,CGGTGGCCGAGCCATCACTC,0,2092858
lacIp,0.5,1,1,CGGTGCGCGTGGGATCGACG,0,2085885
lacIp,0.5,1,1,CGGTGATACGCTGACCCTAC,0,2119919
lacIp,0.5,1,1,CGGTCTGTGGTATGCCCAAA,0,2112331
lacIp,0.5,1,1,CGGTCCAATCAAAACCTGTC,0,2110476
lacIp,0.5,1,1,CGGTCATGCTAATAGGCTTT,0,2094591
lacIp,0.5,1,1,CGGTCACTCTACCGATGTAC,0,2090357
lacIp,0.5,1,1,CGGTATAAGCAGATGACAAA,0,2104424
lacIp,0.5,1,1,CGGTACCTCTCGCTGAGCAT,0,2096662
lacIp,0.5,1,1,CGGTAACCGGTTCCGATGCT,0,2103396
lacIp,0.5,1,1,CGGGTTAGGATAGGAGCAGG,0,2113948
lacIp,0.5,1,1,CGGGTGTTTCATATTGTCTT,0,2112049
lacIp,0.5,1,1,CGGGTGTTCTACGAGCGCGT,0,2121515
lacIp,0.5,1,1,CGGGTGTAGTCAAGAACAGA,0,2105939
lacIp,0.5,1,1,CGGGTACTATCCTTCGAAGG,0,2092945
lacIp,0.5,1,1,CGGGGGGTAGGCGAAAGGCT,0,2086476
lacIp,0.5,1,1,CGGGGGAGAGCTTTGCGGGT,0,2107174
lacIp,0.5,1,1,CGGGGCGACTCGTCTTCTCG,0,2118145
lacIp,0.5,1,1,CGGGGAGTATCTCGCAATAC,0,2114409
lacIp,0.5,1,1,CGGGCTGGATTCGCCCACGA,0,2109081
lacIp,0.5,1,1,CGGGCTACGGATGAGCCGCG,0,2103394
lacIp,0.5,1,1,CGGGCCGGACAGGACATATG,0,2120790
lacIp,0.5,1,1,CGGGACTCGTACGCAATGTA,0,2088621
lacIp,0.5,1,1,CGGGACCTCAGTCTAGGGCG,0,2094947
lacIp,0.5,1,1,CGGGACAATGATCCAGCCAC,0,2088827
lacIp,0.5,1,1,CGGGAAGGCCTAGCCCGGAG,0,2107586
lacIp,0.5,1,1,CGGCTTTATCCTCGGTGTGA,0,2090355
lacIp,0.5,1,1,CGGCTTAGGACCTCGTGGTG,0,2117912
lacIp,0.5,1,1,CGGCTGGCTCTGCTTCTCTA,0,2108217
lacIp,0.5,1,1,CGGCTGACATCCACCGCCAG,0,2105520
lacIp,0.5,1,1,CGGCTCTAGTCGGACAATTA,0,2091746
lacIp,0.5,1,1,CGGCGTGGTAGAGCCCCAAG,0,2099822
lacIp,0.5,1,1,CGGCGGTCCTGATACGAAAT,0,2112042
lacIp,0.5,1,1,CGGCGGTCAGTGTCGAGCAG,0,2107211
lacIp,0.5,1,1,CGGCGAAGTCTACTCCTAAT,0,2092469
lacIp,0.5,1,1,CGGCGAAGTCGTCACGGGTA,0,2095076
lacIp,0.5,1,1,CGGCCGTCTCCTGATAGATC,0,2103944
lacIp,0.5,1,1,CGGCAGGAGCACCGTAAACT,0,2090107
lacIp,0.5,1,1,CGGCACAAGAGCAAGGTTAG,0,2098969
lacIp,0.5,1,1,CGGATTGAGTAGAGGGTAAG,0,2104006
lacIp,0.5,1,1,CGGATTCACGGTATCTTCGA,0,2091532
lacIp,0.5,1,1,CGGATGATGTTTGGTGAAAT,0,2115611
lacIp,0.5,1,1,CGGATCTGCGAATATATATA,0,2104468
lacIp,0.5,1,1,CGGATCGCCCTACTTACCGA,0,2106160
lacIp,0.5,1,1,CGGAGGTCGAGCGTTGGCCT,0,2094374
lacIp,0.5,1,1,CGGAGGATGCGTGGAATCAA,0,2120327
lacIp,0.5,1,1,CGGACGTTGGCGGCGCTATG,0,2113600
lacIp,0.5,1,1,CGGACCTGCAGTAGCGCCAT,0,2111725
lacIp,0.5,1,1,CGGACCGACTATTAAGGCAG,0,2121717
lacIp,0.5,1,1,CGGACAGGCAGCTTTCATTT,0,2102880
lacIp,0.5,1,1,CGGAATGGGCATCTACACCT,0,2106359
lacIp,0.5,1,1,CGGAATGCATTCGTCGCTTG,0,2111759
lacIp,0.5,1,1,CGGAAGTGTTTTATCCTCCC,0,2098529
lacIp,0.5,1,1,CGGAAGGGTGACGTACATTA,0,2090576
lacIp,0.5,1,1,CGGAAGCTCATTCTCCGCCT,0,2096381
lacIp,0.5,1,1,CGGAACTGCTTCAATCCACT,0,2100703
lacIp,0.5,1,1,CGCTGGTGAGAGGAGCTAGT,0,2090528
lacIp,0.5,1,1,CGCTGGCATGATCAGCCCTT,0,2118865
lacIp,0.5,1,1,CGCTGCCAGCCGCGAACCTT,0,2094927
lacIp,0.5,1,1,CGCTCAGAACAAGAGCGAAA,0,2116194
lacIp,0.5,1,1,CGCTATCCTTCACGCTCGTT,0,2087830
lacIp,0.5,1,1,CGCTAGGAACTGAGGTTGAT,0,2112454
lacIp,0.5,1,1,CGCTAGATCTGAGCACAGGA,0,2113397
lacIp,0.5,1,1,CGCGTGTTAAATATTTGCTC,0,2087239
lacIp,0.5,1,1,CGCGTCTTAACCAGCAGTTT,0,2088744
lacIp,0.5,1,1,CGCGTCATAATGTGGAGGGA,0,2104052
lacIp,0.5,1,1,CGCGGGTACGACTCAGAAAC,0,2087589
lacIp,0.5,1,1,CGCGGCGTTACAGACGGTAG,0,2085919
lacIp,0.5,1,1,CGCGATGCCGCGTATTTTCA,0,2090496
lacIp,0.5,1,1,CGCGATCGACTCCTCGGATT,0,2109540
lacIp,0.5,1,1,CGCGACATGATGACGGGTCG,0,2102400
lacIp,0.5,1,1,CGCGAATCGTGAGGTGCTAA,0,2116443
lacIp,0.5,1,1,CGCCTTACTTCCGCTTGCAA,0,2098966
lacIp,0.5,1,1,CGCCTGTTCCGCTGATACAC,0,2086624
lacIp,0.5,1,1,CGCCTCGTGGCCTATATTAC,0,2100934
lacIp,0.5,1,1,CGCCTACGTGAAAGGGCGCA,0,2089164
lacIp,0.5,1,1,CGCCGTCTCTCCGGTGAATT,0,2085911
lacIp,0.5,1,1,CGCCGCCCGACCATCAGCTT,0,2111417
lacIp,0.5,1,1,CGCCCCTTGTCTTCCCTCAG,0,2115027
lacIp,0.5,1,1,CGCCAGCGAATGATGTAGTT,0,2092137
lacIp,0.5,1,1,CGCCAATAGTCATCGTTTCG,0,2090264
lacIp,0.5,1,1,CGCCAACGTATTTTGTTTTC,0,2089323
lacIp,0.5,1,1,CGCATTTGTAGCGAACAATT,0,2094961
lacIp,0.5,1,1,CGCATGTTTTATTGACCTCT,0,2113372
lacIp,0.5,1,1,CGCAGGAGTCAGTCTACATG,0,2118376
lacIp,0.5,1,1,CGCAGACCAAAGTGACCTCA,0,2112168
lacIp,0.5,1,1,CGCAGAACGGGGCTTTATAC,0,2101769
lacIp,0.5,1,1,CGCAGAACCTGTCAATCCAG,0,2094051
lacIp,0.5,1,1,CGCACTTCGCGCGTACAAAG,0,2101998
lacIp,0.5,1,1,CGCACGCTAAAACAAACGTC,0,2089363
lacIp,0.5,1,1,CGCACGCGATGAGTTAGGGC,0,2097151
lacIp,0.5,1,1,CGCACCAAGTCCGAAGATAT,0,2121287
lacIp,0.5,1,1,CGCACATCAATTGGGGTGCG,0,2087486
lacIp,0.5,1,1,CGCACAGATATCACTTAAGT,0,2099459
lacIp,0.5,1,1,CGCAACTTCGCGCATGCGCA,0,2088183
lacIp,0.5,1,1,CGATTTTTAGTCTCATACGG,0,2094398
lacIp,0.5,1,1,CGATTGTCAACGTGCGCCTT,0,2086435
lacIp,0.5,1,1,CGATGGTCAATGACGGTCAG,0,2088481
lacIp,0.5,1,1,CGATCCGATAGATTACGTGG,0,2101575
lacIp,0.5,1,1,CGATAGCTAACATCTTCTAT,0,2114404
lacIp,0.5,1,1,CGAGTGCACCCGATAGCTGA,0,2109070
lacIp,0.5,1,1,CGAGGTTCGCTGTGCGGTGT,0,2087204
lacIp,0.5,1,1,CGAGCAGCGGACCGTTACGA,0,2114199
lacIp,0.5,1,1,CGAGATGTCGTGAATGCGGG,0,2107258
lacIp,0.5,1,1,CGAGATCGTGGCAAGGACAT,0,2117197
lacIp,0.5,1,1,CGAGAAATTGTTACATGCGT,0,2099236
lacIp,0.5,1,1,CGAGAAATTCCTAGGACGGC,0,2114570
lacIp,0.5,1,1,CGACTATCGCGCCCACTCAT,0,2111180
lacIp,0.5,1,1,CGACGTCCTCAGGTAGCCAC,0,2090026
lacIp,0.5,1,1,CGACGGTTTTTCGGCATCTA,0,2090482
lacIp,0.5,1,1,CGACGGGAGCGCACTGGATT,0,2120290
lacIp,0.5,1,1,CGACGCGTCTTTAATCGATG,0,2106994
lacIp,0.5,1,1,CGACCGTATCATGAATGCAT,0,2098161
lacIp,0.5,1,1,CGACCCGTGTACTTAAATTA,0,2100392
lacIp,0.5,1,1,CGACATGTCTGTCTCAGTTA,0,2093874
lacIp,0.5,1,1,CGAATGCGGCGGTGCCTGAA,0,2102573
lacIp,0.5,1,1,CGAATGAACTCCGGAGCCAA,0,2116519
lacIp,0.5,1,1,CGAAGTTTCCCTGAGTTTAA,0,2105182
lacIp,0.5,1,1,CGAAGGCAGCAACAAGGCCT,0,2095007
lacIp,0.5,1,1,CGAACGGTGGGCGTTAGGAA,0,2114345
lacIp,0.5,1,1,CGAACCGGGATAGACTTGGT,0,2092918
lacIp,0.5,1,1,CGAACAATGGGTCGCTTGAT,0,2090325
lacIp,0.5,1,1,CGAAATCTTGTTCAGGCGCC,0,2117454
lacIp,0.5,1,1,CGAAAGTATGCTGACAAAAT,0,2108636
lacIp,0.5,1,1,CGAAAGGTACGTAACCCGAT,0,2096206
lacIp,0.5,1,1,CGAAAGCGCGGTGTTTAGCG,0,2087246
lacIp,0.5,1,1,CCTTTCACGCCTGGCGGAAA,0,2096791
lacIp,0.5,1,1,CCTTTCACATGGGATGCTGC,0,2097636
lacIp,0.5,1,1,CCTTGGCATAACTGCGGTAG,0,2102637
lacIp,0.5,1,1,CCTTGCGTTAAGAGGATATA,0,2117457
lacIp,0.5,1,1,CCTTGCACGTCTATACCTCA,0,2100082
lacIp,0.5,1,1,CCTTCCGGTGCTACATTCGG,0,2101511
lacIp,0.5,1,1,CCTTCACGGGCGCCGGAAAG,0,2121443
lacIp,0.5,1,1,CCTTAGTTATGCACCTTGGC,0,2104721
lacIp,0.5,1,1,CCTTAGCGGATATTGGAACG,0,2086150
lacIp,0.5,1,1,CCTGTTACACTGGAAGGATT,0,2093443
lacIp,0.5,1,1,CCTGTCATTAGGGTCTAAAA,0,2105186
lacIp,0.5,1,1,CCTGTACTGTTCCCTTCTAA,0,2091004
lacIp,0.5,1,1,CCTGCTCCTGGTTAAGATTT,0,2104378
lacIp,0.5,1,1,CCTCGGCGTCGTGAGGTGCT,0,2115342
lacIp,0.5,1,1,CCTCCCTGAGAGTTAATCAT,0,2117795
lacIp,0.5,1,1,CCTCAAGAGATGGATTCTTG,0,2119701
lacIp,0.5,1,1,CCTATGTGGTTTTGTGGTTG,0,2088287
lacIp,0.5,1,1,CCTATCTCTCTTAACTAAGT,0,2108482
lacIp,0.5,1,1,CCTAGGTCACAGATCTGAGT,0,2112056
lacIp,0.5,1,1,CCTAGGGGACGTATTTACCA,0,2092833
lacIp,0.5,1,1,CCTAGGCGGCGGACATGCGG,0,2108490
lacIp,0.5,1,1,CCTAGCATTGGCATTATCAA,0,2120633
lacIp,0.5,1,1,CCTAGAGTCTAGGTCGGACT,0,2100804
lacIp,0.5,1,1,CCTACGGGGTAAAACAGAGT,0,2110927
lacIp,0.5,1,1,CCTAATTTAAAGGTTGCCGA,0,2099922
lacIp,0.5,1,1,CCTAACCGCATTCATGACAT,0,2112441
lacIp,0.5,1,1,CCGTTTGTGAATAGAATAAC,0,2112503
lacIp,0.5,1,1,CCGTTTCCCAGGCATGTTTG,0,2109332
lacIp,0.5,1,1,CCGTTCCGGTAGTGTAGGTT,0,2105702
lacIp,0.5,1,1,CCGTGTAGGACATAGAGGTG,0,2104382
lacIp,0.5,1,1,CCGTGATATAAGATGACAAC,0,2108166
lacIp,0.5,1,1,CCGTCCTAGATGTGTACCCA,0,2110055
lacIp,0.5,1,1,CCGTCAGTTACGAAGCGTGA,0,2086725
lacIp,0.5,1,1,CCGTATGTGCAAATCAGTCA,0,2096308
lacIp,0.5,1,1,CCGGTGCTTTCTCTAGCAAT,0,2088561
lacIp,0.5,1,1,CCGGTATAACGGACGTTGGG,0,2105444
lacIp,0.5,1,1,CCGGTAGTATCGGGGCGTAG,0,2086375
lacIp,0.5,1,1,CCGGGTGGTAGGTATATCAC,0,2092530
lacIp,0.5,1,1,CCGGGGCGTTGATAGCAGGA,0,2095343
lacIp,0.5,1,1,CCGGGCCGCCCTTGGGTCAA,0,2102289
lacIp,0.5,1,1,CCGGGCAGGCGCTCACTACA,0,2115141
lacIp,0.5,1,1,CCGGGATGTTCCAACCGCGC,0,2110254
lacIp,0.5,1,1,CCGGCTAAAGGGCTAAATAA,0,2109904
lacIp,0.5,1,1,CCGGCGGTAGAAACGGGTGT,0,2108836
lacIp,0.5,1,1,CCGGCGCCTGTCGAACTTTT,0,2119232
lacIp,0.5,1,1,CCGGATTTAACCTACGGTAG,0,2111625
lacIp,0.5,1,1,CCGGAGTGGTGTTTCTGTAC,0,2116223
lacIp,0.5,1,1,CCGGACCGCTGACACGGCTT,0,2097920
lacIp,0.5,1,1,CCGGACAAACAAATAATGAA,0,2102714
lacIp,0.5,1,1,CCGCTGGGGATTCGATTCTC,0,2096248
lacIp,0.5,1,1,CCGCTGCTCTGATATATCAA,0,2105325
lacIp,0.5,1,1,CCGCTGCATATAATATGGAG,0,2113057
lacIp,0.5,1,1,CCGCCCAGTATACGGGTGCG,0,2106856
lacIp,0.5,1,1,CCGCCAACCGAGTGTACAAT,0,2122034
lacIp,0.5,1,1,CCGATGACCGTGGGTGCGAT,0,2101585
lacIp,0.5,1,1,CCGAGGTTTCGAAGTCACCC,0,2096353
lacIp,0.5,1,1,CCGAGGGGGACTCTACAGAT,0,2115420
lacIp,0.5,1,1,CCGACGCATGGTATCCCATC,0,2107093
lacIp,0.5,1,1,CCGACCTATCTACAATAAGC,0,2115556
lacIp,0.5,1,1,CCGACAATCTTGGTTGGATC,0,2113712
lacIp,0.5,1,1,CCGAAGTTGCACGGGTACGC,0,2096550
lacIp,0.5,1,1,CCGAAGGTAACAATATTAGG,0,2117575
lacIp,0.5,1,1,CCGAAGGAACCCCTTTACAA,0,2104384
lacIp,0.5,1,1,CCGAACCATAGCGTCGCGAT,0,2097857
lacIp,0.5,1,1,CCGAACCAGCAAGGACCGCT,0,2117859
lacIp,0.5,1,1,CCCTGACATCGAAGCCCAAC,0,2121839
lacIp,0.5,1,1,CCCTGACAGGGCGGCTCTCA,0,2115165
lacIp,0.5,1,1,CCCTGAACCCGTTACATTCG,0,2107548
lacIp,0.5,1,1,CCCTACTAATAAGCGAGGCC,0,2088321
lacIp,0.5,1,1,CCCTACAAGATATGCTCGTG,0,2094449
lacIp,0.5,1,1,CCCGTTTTGTGCGCGCTCGA,0,2105382
lacIp,0.5,1,1,CCCGGCGCGACTATGACGGT,0,2095781
lacIp,0.5,1,1,CCCGCTTATTCAGCTTAGTG,0,2115470
lacIp,0.5,1,1,CCCGCGTTTCCACATACAAG,0,2101101
lacIp,0.5,1,1,CCCGATGTCAACCCTGCGGC,0,2109950
lacIp,0.5,1,1,CCCGACCTCACGAAGCTGAG,0,2094403
lacIp,0.5,1,1,CCCCTTCCGTAGGGGGAGGT,0,2092038
lacIp,0.5,1,1,CCCCTCAAGGAGCGGTTATG,0,2098267
lacIp,0.5,1,1,CCCCGTGGTACTCCGGTCCG,0,2105477
lacIp,0.5,1,1,CCCCGCTTTTTGGAATTATT,0,2117205
lacIp,0.5,1,1,CCCCGCCGGGTTCCCGTGAC,0,2105370
lacIp,0.5,1,1,CCCCCCAACGCAACACCTTG,0,2118857
lacIp,0.5,1,1,CCCCATGTTAATTGGTCTCC,0,2094456
lacIp,0.5,1,1,CCCCAGATCAAAAGTTGTCC,0,2108962
lacIp,0.5,1,1,CCCATGTGTCTAACTAAACC,0,2114903
lacIp,0.5,1,1,CCCATGGTCTACCTGACGGT,0,2087510
lacIp,0.5,1,1,CCCATGCGAGTGGTCGCTCT,0,2098136
lacIp,0.5,1,1,CCCAGGAAGACCTCCGGAGC,0,2098073
lacIp,0.5,1,1,CCCAGCAACTCAAAAACTCC,0,2118808
lacIp,0.5,1,1,CCCAGACAGTGACGCTGCCC,0,2120489
lacIp,0.5,1,1,CCCAGAAAGCTCTATTTTGT,0,2120988
lacIp,0.5,1,1,CCCACCGCGACACTATGGCG,0,2095469
lacIp,0.5,1,1,CCCACACGCCATAAATGGCA,0,2099398
lacIp,0.5,1,1,CCCACACCAGTTTGGCCACG,0,2087238
lacIp,0.5,1,1,CCCAATGATCAATCATTCCA,0,2112045
lacIp,0.5,1,1,CCCAAAGAGCTTTTGACTGA,0,2106301
lacIp,0.5,1,1,CCATTATGCGCATGTCGTTA,0,2099053
lacIp,0.5,1,1,CCATTAGGAGAAAAATGGCT,0,2121408
lacIp,0.5,1,1,CCATTAGAAATGCCTGAGCT,0,2116197
lacIp,0.5,1,1,CCATTACAAGAGTCACGGGA,0,2095775
lacIp,0.5,1,1,CCATGACCATATAAGAGTGT,0,2085827
lacIp,0.5,1,1,CCATCTACGGTATGAGATAG,0,2108916
lacIp,0.5,1,1,CCATCGTTTACAAAAAAAAG,0,2110807
lacIp,0.5,1,1,CCATCGATAAATAATGCGTT,0,2102225
lacIp,0.5,1,1,CCATACCTTTCAGTTTCCAA,0,2103284
lacIp,0.5,1,1,CCAGTGTGCAATGTCGTGAC,0,2114688
lacIp,0.5,1,1,CCAGTCTTCGACACGGCAAT,0,2093414
lacIp,0.5,1,1,CCAGTCTACGCCGGGGCGCA,0,2114766
lacIp,0.5,1,1,CCAGGGGTCAGCGGAGTTGC,0,2097363
lacIp,0.5,1,1,CCAGGAACGGACATCGTCAC,0,2101075
lacIp,0.5,1,1,CCAGCTATAAGCGCCGTCAT,0,2107671
lacIp,0.5,1,1,CCAGCCGAAGACGGGGTAGT,0,2111957
lacIp,0.5,1,1,CCAGCAGTAGGAAATTCGGT,0,2119111
lacIp,0.5,1,1,CCAGATCCCCTGCCCTTTAG,0,2091782
lacIp,0.5,1,1,CCAGACTTGAACGGAATTCA,0,2113490
lacIp,0.5,1,1,CCAGACGACGGTTGTCACAT,0,2121104
lacIp,0.5,1,1,CCAGACACCACCTTGTGTTG,0,2118702
lacIp,0.5,1,1,CCACGTGGAGCAATTAACGT,0,2103603
lacIp,0.5,1,1,CCACGAGTGATTGGCATGAT,0,2107763
lacIp,0.5,1,1,CCACCCGTCTTATCTTTGAG,0,2087291
lacIp,0.5,1,1,CCACATATTGTATCCCTGGG,0,2104272
lacIp,0.5,1,1,CCACAGCCAGGGCGGGCCAA,0,2112527
lacIp,0.5,1,1,CCAATGCCCCGAGGTAGGTA,0,2101718
lacIp,0.5,1,1,CCAATCTAGCCGGCTAGCCA,0,2121318
lacIp,0.5,1,1,CCAAGTTCACGTGCGCGATA,0,2094397
lacIp,0.5,1,1,CCAAGCTTGCAGCCATACCC,0,2096958
lacIp,0.5,1,1,CCAAGCGGTGGCTTTTCGGT,0,2088007
lacIp,0.5,1,1,CCAAGATTGAAGTTCAGGCG,0,2099580
lacIp,0.5,1,1,CCAACTACACAACCTTGCAG,0,2112712
lacIp,0.5,1,1,CCAACCTATCCGACGCGGAT,0,2093310
lacIp,0.5,1,1,CCAAACGCCCTTCTTATAAG,0,2096572
lacIp,0.5,1,1,CATTTTAGTAGCTGTAGCCT,0,2115169
lacIp,0.5,1,1,CATTTGTTACGCAGTTTCCT,0,2099197
lacIp,0.5,1,1,CATTTGGAAAGGGGTATATA,0,2105131
lacIp,0.5,1,1,CATTTCTGGGGAGCCAACTG,0,2121687
lacIp,0.5,1,1,CATTGTTGGGTGCTCGAGTT,0,2092573
lacIp,0.5,1,1,CATTGGGCCTGGATGCCACT,0,2111651
lacIp,0.5,1,1,CATTGGCTAACATCATCTAG,0,2116764
lacIp,0.5,1,1,CATTGGCATATACTGACCCT,0,2112747
lacIp,0.5,1,1,CATTCGGCTGGAACATCCTA,0,2116217
lacIp,0.5,1,1,CATTCGCAAACCACGTCGTT,0,2120464
lacIp,0.5,1,1,CATTCACGCTGCGGCGTAAT,0,2098028
lacIp,0.5,1,1,CATTATGATCCTTAAAAGCT,0,2113016
lacIp,0.5,1,1,CATTAGTGAGTTAATCGCTT,0,2106182
lacIp,0.5,1,1,CATTAGGTCAAGCACATGGA,0,2100827
lacIp,0.5,1,1,CATTAGATAATGCCGGTCCG,0,2114207
lacIp,0.5,1,1,CATTAAGCGCCTCATGCGAG,0,2087109
lacIp,0.5,1,1,CATTAAATCCAAGTCGTATC,0,2115549
lacIp,0.5,1,1,CATGTTTTTGAATCACTGAT,0,2089781
lacIp,0.5,1,1,CATGTTTAGGTCTACTCATC,0,2101717
lacIp,0.5,1,1,CATGGGAGCGGGGAAGGATT,0,2101871
lacIp,0.5,1,1,CATGGATCTACTCTTGCTAC,0,2094635
lacIp,0.5,1,1,CATGGAGGTCCGCAAGATCA,0,2099853
lacIp,0.5,1,1,CATGGACCCCTGGTAGGATG,0,2114937
lacIp,0.5,1,1,CATGCTTCCGAGAGCCATCG,0,2111964
lacIp,0.5,1,1,CATGCATTATTCATTTTCGG,0,2118659
lacIp,0.5,1,1,CATGAAGTCAGATTACATGT,0,2092702
lacIp,0.5,1,1,CATGAAAGCGCGAACCATGA,0,2113585
lacIp,0.5,1,1,CATCTTGTCGTGGTAAGCCA,0,2098692
lacIp,0.5,1,1,CATCTGGTATAAACCAACAC,0,2098304
lacIp,0.5,1,1,CATCTCAGCAATTCTCATGT,0,2116306
lacIp,0.5,1,1,CATCGCTACTGCTCCAAAAA,0,2115953
lacIp,0.5,1,1,CATCGCCGCGTCTTCCGACG,0,2098189
lacIp,0.5,1,1,CATCGACTCGGGGGCTCAAT,0,2091498
lacIp,0.5,1,1,CATCCTACAGCATCTCCAGG,0,2096505
lacIp,0.5,1,1,CATCCGTGAAAGCTGCCGAG,0,2098072
lacIp,0.5,1,1,CATCCGGTAGAGCTCCCAGT,0,2101246
lacIp,0.5,1,1,CATCAGCAGCGGCTTAGATT,0,2104146
lacIp,0.5,1,1,CATCAGCACGGGGTGTATTT,0,2089727
lacIp,0.5,1,1,CATCACACGCAAAGTGCGGG,0,2099268
lacIp,0.5,1,1,CATCAATGACTATACATCTC,0,2090856
lacIp,0.5,1,1,CATATTCTTGTCGTCAGAAC,0,2115660
lacIp,0.5,1,1,CATATGGGTGCGCCCCATCT,0,2107755
lacIp,0.5,1,1,CATAGTTGACTTGACAAGCT,0,2122288
lacIp,0.5,1,1,CATAGGTGCGGGCTCCTAGT,0,2106964
lacIp,0.5,1,1,CATAGATGGATTTGGGCAAC,0,2106272
lacIp,0.5,1,1,CATACTGTAAGTGGCACCCT,0,2113891
lacIp,0.5,1,1,CATACTGCGCTAAGCGCAGC,0,2113472
lacIp,0.5,1,1,CATACTACGCACGATAATGT,0,2109903
lacIp,0.5,1,1,CATACGTGCGGTCGCGGGAG,0,2114984
lacIp,0.5,1,1,CATACCCTCTAGGGTCGTCA,0,2111696
lacIp,0.5,1,1,CATAATCGTTTCATATTCCT,0,2100821
lacIp,0.5,1,1,CATAAGTGATAGCAATCTAA,0,2090192
lacIp,0.5,1,1,CAGTGATAGACAACGACTCG,0,2095580
lacIp,0.5,1,1,CAGTCTAATGGCCCTGTCGT,0,2096832
lacIp,0.5,1,1,CAGTCATCTCTTCGTCTGGT,0,2120232
lacIp,0.5,1,1,CAGTAGCCACTTCTCAAAGA,0,2098258
lacIp,0.5,1,1,CAGTACACTATATCGCAATT,0,2089079
lacIp,0.5,1,1,CAGGTTGTAAAGGAATCCCC,0,2114191
lacIp,0.5,1,1,CAGGGCGGGGCGAATTTCCC,0,2087699
lacIp,0.5,1,1,CAGGGATCAGCCGTCGAGTT,0,2115667
lacIp,0.5,1,1,CAGGGACAGGGAATACAATT,0,2107683
lacIp,0.5,1,1,CAGGCTAGGAACAGAACGCT,0,2104219
lacIp,0.5,1,1,CAGGCTAACCACAGTCAAGG,0,2089746
lacIp,0.5,1,1,CAGGCCTGCTATAGGATTTG,0,2088411
lacIp,0.5,1,1,CAGGCAGGGAACTAGCAGTA,0,2104567
lacIp,0.5,1,1,CAGGATATTTGTGAGAGGGG,0,2117281
lacIp,0.5,1,1,CAGGAGCGAAGTTACTGACT,0,2121298
lacIp,0.5,1,1,CAGCTCTACTGGATTGGACA,0,2090846
lacIp,0.5,1,1,CAGCGCATCAGCACCGACGC,0,2103130
lacIp,0.5,1,1,CAGCGCAACTTGCAGCAATT,0,2112420
lacIp,0.5,1,1,CAGCGAATGCGTGAATCGGT,0,2094199
lacIp,0.5,1,1,CAGCCGCTGTATCGAGGCAG,0,2089609
lacIp,0.5,1,1,CAGCCCGGTCAGTAGTAAAA,0,2086468
lacIp,0.5,1,1,CAGCCCCGCATAAACCAGAA,0,2116119
lacIp,0.5,1,1,CAGCAGCGTGACTGTTTATT,0,2105626
lacIp,0.5,1,1,CAGCACAAGTGTCTCACAAA,0,2096352
lacIp,0.5,1,1,CAGATGGGGGTCCTCGAGCG,0,2104634
lacIp,0.5,1,1,CAGAGCCCCTTTAAGATCAG,0,2122137
lacIp,0.5,1,1,CAGAGCAATCAGACTGGTCA,0,2094728
lacIp,0.5,1,1,CAGACTAGCGTGGGTTGATA,0,2105472
lacIp,0.5,1,1,CAGACCTGGATCATTTGCTT,0,2099035
lacIp,0.5,1,1,CAGACAGGGAAATCTCCTCC,0,2103810
lacIp,0.5,1,1,CAGACAAATGCGCCTTGCGA,0,2109605
lacIp,0.5,1,1,CAGAATTGCTGCCACCCGCA,0,2092456
lacIp,0.5,1,1,CACTTGAGGATTCTAGACTT,0,2097443
lacIp,0.5,1,1,CACTGAGGGCTGTAATCCAA,0,2105734
lacIp,0.5,1,1,CACTCCACTGGCCAATACCC,0,2101382
lacIp,0.5,1,1,CACTCAGTATCGGTGATTCT,0,2092633
lacIp,0.5,1,1,CACTACGACATTGAAAACTC,0,2087828
lacIp,0.5,1,1,CACTACCCAAAGATCTTTTA,0,2090250
lacIp,0.5,1,1,CACTAAATCCGTAAGTCGTA,0,2114985
lacIp,0.5,1,1,CACGTGACCTTACGGTCTTT,0,2087629
lacIp,0.5,1,1,CACGTCATAAGCTTGGCCGT,0,2104363
lacIp,0.5,1,1,CACGGCACTTGCAAGGAATG,0,2093606
lacIp,0.5,1,1,CACGCTCGGTCGTTCCGCAG,0,2108846
lacIp,0.5,1,1,CACGCCTATTCACGCACAAC,0,2119567
lacIp,0.5,1,1,CACCTTGGCTCGAGTAGCAT,0,2119359
lacIp,0.5,1,1,CACCTGTCGTGTGAATGGCC,0,2107315
lacIp,0.5,1,1,CACCTGAGGGCCAGGGACAA,0,2100142
lacIp,0.5,1,1,CACCGTTAGCCGTGATTAGG,0,2102744
lacIp,0.5,1,1,CACCGATGCTCAACTCCGAT,0,2088233
lacIp,0.5,1,1,CACCGAAACACGTGAATCGA,0,2092224
lacIp,0.5,1,1,CACCCTCTCAGAATTCGGGA,0,2094540
lacIp,0.5,1,1,CACCCCCAAGCAATTCTCCT,0,2100287
lacIp,0.5,1,1,CACCCATGACGGGACAGCAC,0,2105781
lacIp,0.5,1,1,CACCAGCCATACCGGCACTT,0,2088933
lacIp,0.5,1,1,CACATGGTGTGCCCAATTTC,0,2100376
lacIp,0.5,1,1,CACATCTTCGGCCTCATGAG,0,2111456
lacIp,0.5,1,1,CACATATAATAGTTTGCACC,0,2087539
lacIp,0.5,1,1,CACACGCTCTGGGATCATAC,0,2093846
lacIp,0.5,1,1,CACACATTCTAGAATAATCT,0,2099088
lacIp,0.5,1,1,CACACAGCGTGGTAATAGCC,0,2101125
lacIp,0.5,1,1,CACACACGTGCACAAACCGA,0,2088342
lacIp,0.5,1,1,CACAAGATTGCCTTATTCCA,0,2096133
lacIp,0.5,1,1,CACAACGGGTAGCGCTGCTG,0,2102490
lacIp,0.5,1,1,CACAACGCCCTTTCGATTCG,0,2096252
lacIp,0.5,1,1,CAATTTGGCGCGTTGCTTCC,0,2088417
lacIp,0.5,1,1,CAATGTAAAAATGTTGGTTT,0,2108019
lacIp,0.5,1,1,CAATGGGGAGTGTAGACGCT,0,2114474
lacIp,0.5,1,1,CAATGGGACCCTTCTCGATA,0,2113646
lacIp,0.5,1,1,CAATGCTCTGGTTTATTGGG,0,2089710
lacIp,0.5,1,1,CAATCTGAGGTGTATGTTCT,0,2089635
lacIp,0.5,1,1,CAATCCATACCCGCTCTTGA,0,2089794
lacIp,0.5,1,1,CAATCATTCGGACCACGCGA,0,2113778
lacIp,0.5,1,1,CAATCACTAACTCACCAAAG,0,2116804
lacIp,0.5,1,1,CAATATCAGGTCCCTGAAGC,0,2108897
lacIp,0.5,1,1,CAATACACCGATCATACGTC,0,2099716
lacIp,0.5,1,1,CAATAATCCAACTACGCTAA,0,2099055
lacIp,0.5,1,1,CAAGTTCTTAACTGAGCGCG,0,2113573
lacIp,0.5,1,1,CAAGTTCATGACAGTGGCGT,0,2107226
lacIp,0.5,1,1,CAAGTTAACCTCGAATTCCG,0,2086158
lacIp,0.5,1,1,CAAGTGAACCAATTGTTCGA,0,2122009
lacIp,0.5,1,1,CAAGTCTTGCCAATCCGGCA,0,2122391
lacIp,0.5,1,1,CAAGTAGTCCGCATACTCAG,0,2094953
lacIp,0.5,1,1,CAAGGTTGACAGTCATTCCC,0,2098112
lacIp,0.5,1,1,CAAGGTCTACGGAGGCATTA,0,2108808
lacIp,0.5,1,1,CAAGGGGCAAAATCGCACGT,0,2113142
lacIp,0.5,1,1,CAAGGGCTGATTTGCCGGTA,0,2088078
lacIp,0.5,1,1,CAAGGACAACGACTAAAACT,0,2094913
lacIp,0.5,1,1,CAAGCGTTTTCCGATGCGGT,0,2104738
lacIp,0.5,1,1,CAAGCGGGTCGGCACGCGCA,0,2115339
lacIp,0.5,1,1,CAAGCAGAATGCTTGGCGTC,0,2086056
lacIp,0.5,1,1,CAAGACTACATAAATCGTCG,0,2104349
lacIp,0.5,1,1,CAACGTTAAAATCCGGCGGA,0,2112862
lacIp,0.5,1,1,CAACGGGTGACTACGCGGCT,0,2113227
lacIp,0.5,1,1,CAACCATTGATTACTTACAT,0,2109131
lacIp,0.5,1,1,CAACATAGTTGAGCGAAGGT,0,2092977
lacIp,0.5,1,1,CAACAGCCCCGGTCCAAGCC,0,2112868
lacIp,0.5,1,1,CAACACCTCCCCCGTTTTCC,0,2113375
lacIp,0.5,1,1,CAACACAACCTAAATTTATG,0,2110393
lacIp,0.5,1,1,CAACAAAATGACACCTCCCG,0,2119364
lacIp,0.5,1,1,CAAATCGTTATGGGGCTGAT,0,2097507
lacIp,0.5,1,1,CAAAGTCGTCCGGTGATTCA,0,2112335
lacIp,0.5,1,1,CAAACATGTTTAACCGTTAA,0,2113503
lacIp,0.5,1,1,CAAAAGTCGGGCGTGATTGG,0,2120759
lacIp,0.5,1,1,CAAAACGCGTCGAGGAGTGA,0,2100089
lacIp,0.5,1,1,CAAAAACTAGCGCGACTATT,0,2112279
lacIp,0.5,1,1,ATTTTTTCAGTCTAGTTGAC,0,2103204
lacIp,0.5,1,1,ATTTTTTACGTCTGGATTAA,0,2096506
lacIp,0.5,1,1,ATTTTGGCTGTGCATCGATC,0,2115527
lacIp,0.5,1,1,ATTTTCGTAGGTGCTTCGCG,0,2103372
lacIp,0.5,1,1,ATTTTCGCAGATTAAGTTAG,0,2102597
lacIp,0.5,1,1,ATTTTATTACTTAGGGCTTT,0,2099150
lacIp,0.5,1,1,ATTTGTCGGCCATCCGATCA,0,2089104
lacIp,0.5,1,1,ATTTGTCGCTACAGTTTCGT,0,2095663
lacIp,0.5,1,1,ATTTCTTCTGCCGCCGATTG,0,2104263
lacIp,0.5,1,1,ATTTCGGCGTTGTTTAGTTT,0,2087300
lacIp,0.5,1,1,ATTTCCCGTCTCTTTGTGTT,0,2089439
lacIp,0.5,1,1,ATTTATAGTCGCAGCAAGGT,0,2097532
lacIp,0.5,1,1,ATTTAGGTAAAGCACGAGGG,0,2096014
lacIp,0.5,1,1,ATTTACGTGCCCCGAGTCCC,0,2112327
lacIp,0.5,1,1,ATTTACGTGATGGGCCGATC,0,2110449
lacIp,0.5,1,1,ATTTAAATGAATCACTCAGG,0,2103291
lacIp,0.5,1,1,ATTGTGAACGGTGTTACGCG,0,2104286
lacIp,0.5,1,1,ATTGTCACGGCATATGGAAA,0,2109436
lacIp,0.5,1,1,ATTGTAAGCTACGTGCTGAT,0,2098077
lacIp,0.5,1,1,ATTGGTAGCGACAAATCGGC,0,2116117
lacIp,0.5,1,1,ATTGGGTAGTAACTGGCAAC,0,2091946
lacIp,0.5,1,1,ATTGCGGGGTGCTGTCGGGG,0,2095636
lacIp,0.5,1,1,ATTGCAGTTGGGTTCTCCAG,0,2107350
lacIp,0.5,1,1,ATTGCAGGGCCGACATTACG,0,2109316
lacIp,0.5,1,1,ATTGATACCCTGGTCGGGGT,0,2107659
lacIp,0.5,1,1,ATTGAAGGAACGCTTAAACC,0,2122033
lacIp,0.5,1,1,ATTGAAAGCAGTCTCAATAC,0,2102062
lacIp,0.5,1,1,ATTCTTATGTATGGAGCAGT,0,2110229
lacIp,0.5,1,1,ATTCGCTCGCGAGTGCCATG,0,2092141
lacIp,0.5,1,1,ATTCGCGGTCCGAGATCGTG,0,2090396
lacIp,0.5,1,1,ATTCGCCCCCTCCACAAAAG,0,2093978
lacIp,0.5,1,1,ATTCCCTGTCTTGGAAACTT,0,2089243
lacIp,0.5,1,1,ATTCATGTTACTCGTTTGGT,0,2094666
lacIp,0.5,1,1,ATTCAGGCAACGCCAGGTAG,0,2099797
lacIp,0.5,1,1,ATTCACTATTTCAGTTGTGA,0,2096150
lacIp,0.5,1,1,ATTCAAGTTGGGGCACCGTA,0,2117800
lacIp,0.5,1,1,ATTCAAGCTTGATCGATCAT,0,2106871
lacIp,0.5,1,1,ATTATTCATACACGACAATG,0,2097596
lacIp,0.5,1,1,ATTATGCCCAAACAAGGATA,0,2103823
lacIp,0.5,1,1,ATTATCGGTTGGATTATGGA,0,2092492
lacIp,0.5,1,1,ATTATACGCGTGCCTGTGAT,0,2119651
lacIp,0.5,1,1,ATTACCTGGATGCCGTGGGA,0,2092082
lacIp,0.5,1,1,ATTACATCCCTCGCCCGCTT,0,2108631
lacIp,0.5,1,1,ATTAAACGCTGTCCACCCGA,0,2102754
lacIp,0.5,1,1,ATGTTTGTGTGAAAGGAGAA,0,2090476
lacIp,0.5,1,1,ATGTTTGTCATAAATTCCCT,0,2113214
lacIp,0.5,1,1,ATGTTCCGGACAACTACCCT,0,2098944
lacIp,0.5,1,1,ATGTTACTCGCATCCCATGA,0,2104581
lacIp,0.5,1,1,ATGTTACAGGCGTGTTCGTT,0,2099708
lacIp,0.5,1,1,ATGTGGGGGGTCCGTGCGTG,0,2121983
lacIp,0.5,1,1,ATGTCTGGTAGCCGACGCGT,0,2092120
lacIp,0.5,1,1,ATGTCTCCATGGCGGGTTTC,0,2102962
lacIp,0.5,1,1,ATGTCGTAGGCCACCGGTAC,0,2112167
lacIp,0.5,1,1,ATGTCGATATATTGAGCCAG,0,2102201
lacIp,0.5,1,1,ATGTATTTGGTCATGCGTAC,0,2109193
lacIp,0.5,1,1,ATGTATCGAACTATAGGTGC,0,2089988
lacIp,0.5,1,1,ATGGTGTTCAAATGGTGAGG,0,2100537
lacIp,0.5,1,1,ATGGTGCCAGCTCGAATCCA,0,2086374
lacIp,0.5,1,1,ATGGTGATTAAGCTTTAGAC,0,2091605
lacIp,0.5,1,1,ATGGTCTGGTGCCGTCGTCT,0,2101533
lacIp,0.5,1,1,ATGGGTTGAGGTTGAAAGCG,0,2107330
lacIp,0.5,1,1,ATGGGTTCGTGCGACGGGGC,0,2109624
lacIp,0.5,1,1,ATGGGGGTTCTGGCCCTCTT,0,2100667
lacIp,0.5,1,1,ATGGGCTCCGGAGACTTAAA,0,2089201
lacIp,0.5,1,1,ATGGCGAGACTAGAGCTGGA,0,2109253
lacIp,0.5,1,1,ATGGCACAGGCATAAGTTTG,0,2092339
lacIp,0.5,1,1,ATGGATCAAGGGATAGGGGG,0,2090571
lacIp,0.5,1,1,ATGCTCCCCACAAGAGGTCG,0,2093224
lacIp,0.5,1,1,ATGCTACTCGCTAGGTCCGG,0,2119308
lacIp,0.5,1,1,ATGCTACGTACGGCACGTAG,0,2116143
lacIp,0.5,1,1,ATGCTACCACGATTACTCCA,0,2103784
lacIp,0.5,1,1,ATGCGTGCAGCACCCGCGAA,0,2118570
lacIp,0.5,1,1,ATGCGGCGTTTTAAACTTGG,0,2090646
lacIp,0.5,1,1,ATGCCTTGGCTCTAGTAGCA,0,2088397
lacIp,0.5,1,1,ATGCCTGTGGAGTAATGTTA,0,2117102
lacIp,0.5,1,1,ATGCCCACGTAATGCCCGAA,0,2086182
lacIp,0.5,1,1,ATGCATTGGTTACAACGGAG,0,2099422
lacIp,0.5,1,1,ATGCATGGGAGACGCCAAAG,0,2120982
lacIp,0.5,1,1,ATGCAGCTTTCCTAGGGTGA,0,2098936
lacIp,0.5,1,1,ATGCACACAGTTGCGGAGGT,0,2101593
lacIp,0.5,1,1,ATGCAAATCGGCCAAAAACG,0,2103845
lacIp,0.5,1,1,ATGATTCGCCAATTGTACTC,0,2117920
lacIp,0.5,1,1,ATGATGGTCGGTATTAAGAT,0,2104619
lacIp,0.5,1,1,ATGAGCTCTACTCATGAGGG,0,2117037
lacIp,0.5,1,1,ATGACAATATCCGGAGCAAC,0,2092897
lacIp,0.5,1,1,ATGAATTCAAAAGAGCGTAG,0,2097966
lacIp,0.5,1,1,ATGAAGAACAAGTACGGTGA,0,2109319
lacIp,0.5,1,1,ATCTTTCACCGAGTGCCAGA,0,2110501
lacIp,0.5,1,1,ATCTTAAAAGCCTTAGACTC,0,2109946
lacIp,0.5,1,1,ATCTGGCTCAGTCGGTGAAT,0,2114464
lacIp,0.5,1,1,ATCTGCGATTTAATTTGGGA,0,2113444
lacIp,0.5,1,1,ATCTGCCTACGCTGCCCTTT,0,2118340
lacIp,0.5,1,1,ATCTGAGATCCACCGTGTGA,0,2109528
lacIp,0.5,1,1,ATCTCGTGTGCTAGCACGAG,0,2090027
lacIp,0.5,1,1,ATCTCCGTCTAACTGCACTA,0,2107630
lacIp,0.5,1,1,ATCTCACGTTCCTGGCGTAG,0,2119129
lacIp,0.5,1,1,ATCTAGCCCTGCACGCTGGC,0,2109434
lacIp,0.5,1,1,ATCTAACGGCAGACTATTCT,0,2098807
lacIp,0.5,1,1,ATCGTGTACTCCATGACAAC,0,2118025
lacIp,0.5,1,1,ATCGGTACTTGGGGAGACAC,0,2121743
lacIp,0.5,1,1,ATCGGATCTTGCGTGTTGTA,0,2092712
lacIp,0.5,1,1,ATCGCGGACCCGTTTCCCAT,0,2115894
lacIp,0.5,1,1,ATCGCGAGCGTTAGTACGCA,0,2111390
lacIp,0.5,1,1,ATCGCCCAGTTCGAGGGTAC,0,2101334
lacIp,0.5,1,1,ATCGATACCAACCTTCGAAT,0,2095060
lacIp,0.5,1,1,ATCGAATAGAGTTTCATCGG,0,2109091
lacIp,0.5,1,1,ATCCTTAGATTCTCTCAGGT,0,2102149
lacIp,0.5,1,1,ATCCTGGTATGCTCACCCCT,0,2103570
lacIp,0.5,1,1,ATCCTCCTCGGTAATTTGGA,0,2105317
lacIp,0.5,1,1,ATCCGGACCCGGACGCTTGC,0,2090941
lacIp,0.5,1,1,ATCCGATTGACCACGAAGGT,0,2099914
lacIp,0.5,1,1,ATCCCAGTGCAGATGGGTGT,0,2101792
lacIp,0.5,1,1,ATCCAACCGCAGGTGTTACT,0,2097468
lacIp,0.5,1,1,ATCCAAATCTAGATGGGGGA,0,2094719
lacIp,0.5,1,1,ATCATTATGCCGTGGGCAGC,0,2111462
lacIp,0.5,1,1,ATCATGCCCCATATTGCAAC,0,2109548
lacIp,0.5,1,1,ATCATATTTTCTTTGTGCAG,0,2108986
lacIp,0.5,1,1,ATCATACTGCACGAGCTGGA,0,2091846
lacIp,0.5,1,1,ATCAGTGCCGCAACCAAATT,0,2115025
lacIp,0.5,1,1,ATCAGGGCTCTTAAGCTTAA,0,2113441
lacIp,0.5,1,1,ATCAGCGTCCGTCGGGTATC,0,2103051
lacIp,0.5,1,1,ATCAGCATGCAGTGCGTTTC,0,2104215
lacIp,0.5,1,1,ATCACCGAACCAGCGTTAGT,0,2110310
lacIp,0.5,1,1,ATCAACGATCAGACGACGTA,0,2110734
lacIp,0.5,1,1,ATCAACATTGCAATTTCGCT,0,2120185
lacIp,0.5,1,1,ATATTAGTGGGAACGTTAAA,0,2122212
lacIp,0.5,1,1,ATATGTGGAGTATAGGGCAG,0,2105403
lacIp,0.5,1,1,ATATGTCGTATTTTCAAAAG,0,2121058
lacIp,0.5,1,1,ATATGAGAGAGAAGAATTCT,0,2101130
lacIp,0.5,1,1,ATATCTTAGTTTTTCGATAA,0,2121396
lacIp,0.5,1,1,ATATCCTAGACAAAAGTGGA,0,2116910
lacIp,0.5,1,1,ATAGTTTCCTGATACCCTAG,0,2108280
lacIp,0.5,1,1,ATAGTTCCCACATAGCAAAA,0,2086954
lacIp,0.5,1,1,ATAGTTCATGGAGCTACCAT,0,2102808
lacIp,0.5,1,1,ATAGTCGTACAGGCTTGGAA,0,2094584
lacIp,0.5,1,1,ATAGTATTGAGAAGGCTGCC,0,2107406
lacIp,0.5,1,1,ATAGTAGTTTAGTAGCCAGT,0,2090473
lacIp,0.5,1,1,ATAGGTGTTTGATGGACTTC,0,2103812
lacIp,0.5,1,1,ATAGGGTTCGATAGTACGAC,0,2086236
lacIp,0.5,1,1,ATAGGATATACACTTGTGTA,0,2095209
lacIp,0.5,1,1,ATAGCGGTAGTGCCGTCGTC,0,2088008
lacIp,0.5,1,1,ATAGCCCGTCTCTGTTCCGG,0,2094262
lacIp,0.5,1,1,ATAGCACCGAGATCTGTTTG,0,2110575
lacIp,0.5,1,1,ATACTCGGGAACAAATACAC,0,2108999
lacIp,0.5,1,1,ATACGTAGGCGCTAGAGCCC,0,2096277
lacIp,0.5,1,1,ATACGGACGACCAAGGCGCG,0,2098843
lacIp,0.5,1,1,ATACGCCGCAGGACCCTGTA,0,2091776
lacIp,0.5,1,1,ATACCGCGAAAGCAGCTGGG,0,2112944
lacIp,0.5,1,1,ATACCCGGGATGACATGGCA,0,2113506
lacIp,0.5,1,1,ATACCAAACCTCCGGTTAGT,0,2085851
lacIp,0.5,1,1,ATACAGCAGATCCACGGCGA,0,2108483
lacIp,0.5,1,1,ATACACCACGTCAGTCCGCA,0,2095880
lacIp,0.5,1,1,ATAATGAGTTACGCATACTA,0,2087141
lacIp,0.5,1,1,ATAATGAAATGGGCGGCCAG,0,2098937
lacIp,0.5,1,1,ATAAGTACCGTTTTGATACA,0,2093766
lacIp,0.5,1,1,ATAAGGCTTCGTGCCGGGCT,0,2102415
lacIp,0.5,1,1,ATAAGCAAACCCAAGCCAGA,0,2121053
lacIp,0.5,1,1,ATAAGACGATCAGTATCCAC,0,2101225
lacIp,0.5,1,1,ATAACTAAACCACAAGTGGG,0,2110036
lacIp,0.5,1,1,ATAACGGAACGCGAGTCTAA,0,2092576
lacIp,0.5,1,1,ATAAAGCCCTAGCAAGGCAG,0,2094201
lacIp,0.5,1,1,ATAAACGGGCAAAGAGTGCC,0,2087380
lacIp,0.5,1,1,AGTTTTGGTTTACAAGTTGT,0,2092007
lacIp,0.5,1,1,AGTTTTAGGCGTTCCCACAC,0,2098250
lacIp,0.5,1,1,AGTTTCTCCGTCACACATTG,0,2104265
lacIp,0.5,1,1,AGTTGGGCAGGGCACTAAAA,0,2117541
lacIp,0.5,1,1,AGTTGGAGTACGAGATTTGC,0,2091766
lacIp,0.5,1,1,AGTTGCCGTAGTATTCGATT,0,2101346
lacIp,0.5,1,1,AGTTGAAAATTGTCCAACTA,0,2120000
lacIp,0.5,1,1,AGTTCTGGCGTATACGATTA,0,2107299
lacIp,0.5,1,1,AGTTCTAAGTCGGTTAGTCG,0,2096847
lacIp,0.5,1,1,AGTTCGGACGGGCGATCCAT,0,2116222
lacIp,0.5,1,1,AGTTCGAAACGTCACAATAC,0,2092436
lacIp,0.5,1,1,AGTTCCTGCGTCTGCGTGAC,0,2101866
lacIp,0.5,1,1,AGTTCCGATTGCTTCTATCA,0,2106047
lacIp,0.5,1,1,AGTTCCCTTGGGGCTAGCCC,0,2091023
lacIp,0.5,1,1,AGTTAATATGGGAGCGAAAA,0,2105791
lacIp,0.5,1,1,AGTGTCTGACTTAGCAGGCA,0,2095978
lacIp,0.5,1,1,AGTGGGATAGGACCTCACCT,0,2102003
lacIp,0.5,1,1,AGTGGCGTTACCATCCTGCT,0,2115663
lacIp,0.5,1,1,AGTGCAATTTTGTTTATAGT,0,2098618
lacIp,0.5,1,1,AGTGATTGAAGACACGCAGT,0,2120733
lacIp,0.5,1,1,AGTCTTTGATGGGCCGGATA,0,2095564
lacIp,0.5,1,1,AGTCTTTCTTTGTTGTCTGG,0,2104475
lacIp,0.5,1,1,AGTCTGCGCACGATATGCTG,0,2101267
lacIp,0.5,1,1,AGTCTACGCGATTACGAATG,0,2091768
lacIp,0.5,1,1,AGTCCGGCGAGCACGTTCAT,0,2090544
lacIp,0.5,1,1,AGTCATGCTTCACGGGTTCG,0,2107458
lacIp,0.5,1,1,AGTATAGGGGAGAGTTGTGG,0,2094065
lacIp,0.5,1,1,AGTAGGGCGGGAGTGAGTCG,0,2108296
lacIp,0.5,1,1,AGTAGGCAAGATGCGCGCGG,0,2098133
lacIp,0.5,1,1,AGTAGCGACGTTTGGAGCTT,0,2115938
lacIp,0.5,1,1,AGTAGCCTACTAAAGACCTG,0,2087574
lacIp,0.5,1,1,AGTACCTTGTAGTGGGAGGA,0,2085934
lacIp,0.5,1,1,AGTACCAGTTAGCAACAATT,0,2091704
lacIp,0.5,1,1,AGTAATCTGCCTTCATATCA,0,2117410
lacIp,0.5,1,1,AGGTGTAAGCATAAACCCAA,0,2094717
lacIp,0.5,1,1,AGGTGGTGTATGCTAGATGT,0,2116183
lacIp,0.5,1,1,AGGTCTGAACATCTTCGTAT,0,2102878
lacIp,0.5,1,1,AGGTCCTTTATCCTCACATC,0,2088899
lacIp,0.5,1,1,AGGTATTTAACGCGTGGTGG,0,2119610
lacIp,0.5,1,1,AGGTAATACCTGCGGAATTG,0,2100973
lacIp,0.5,1,1,AGGTAAGGGGACATTTCTTC,0,2119632
lacIp,0.5,1,1,AGGTAAGCATGTTTAGGTCC,0,2102095
lacIp,0.5,1,1,AGGGTGCGCTCCCGGAAGTG,0,2096242
lacIp,0.5,1,1,AGGGTCGTAGGAAAGAGTCT,0,2108426
lacIp,0.5,1,1,AGGGGCGCTCCTTGACCGCT,0,2106735
lacIp,0.5,1,1,AGGGCTAATGCCGTGGTGAT,0,2118555
lacIp,0.5,1,1,AGGGCGGCATTTAGTACTCA,0,2112300
lacIp,0.5,1,1,AGGGCAAGGAAGAAGCTCCT,0,2118392
lacIp,0.5,1,1,AGGGATGACCAAGGCAGCTT,0,2111965
lacIp,0.5,1,1,AGGGAGAAACCCAGAATTCT,0,2114394
lacIp,0.5,1,1,AGGCTTCTCCTTTCACCCGA,0,2098652
lacIp,0.5,1,1,AGGCTTCGCCGCAGAGATGT,0,2113668
lacIp,0.5,1,1,AGGCTCCCCTTGCCCACTGT,0,2116986
lacIp,0.5,1,1,AGGCCTTCCCCCTAACGTAG,0,2121827
lacIp,0.5,1,1,AGGCCGCGTACAAGACCACT,0,2105139
lacIp,0.5,1,1,AGGCCAGCCAAATGCGACAG,0,2116006
lacIp,0.5,1,1,AGGCCACAATACGCAGGCGA,0,2105500
lacIp,0.5,1,1,AGGCATACCCATTAGGGCAT,0,2098157
lacIp,0.5,1,1,AGGCATAATATATCACTCAC,0,2114223
lacIp,0.5,1,1,AGGCAGATAGGATACGATTA,0,2095103
lacIp,0.5,1,1,AGGATAGCACACCACGATAC,0,2092641
lacIp,0.5,1,1,AGGATACAGATGCTCTGAGA,0,2109649
lacIp,0.5,1,1,AGGAGCGCCTGTATCACGGT,0,2103732
lacIp,0.5,1,1,AGGACGTGGTGGCGGACCCA,0,2095463
lacIp,0.5,1,1,AGGACAGCTATTGCTCGCGA,0,2097358
lacIp,0.5,1,1,AGGACAATGGATTGAACAGA,0,2104251
lacIp,0.5,1,1,AGGAACTGTAATTTCTGGTG,0,2091728
lacIp,0.5,1,1,AGGAACTCCCGCCCTTCATA,0,2094029
lacIp,0.5,1,1,AGGAAAATTGTAGGTGTCCC,0,2098708
lacIp,0.5,1,1,AGCTTCGAACGCGGGTATAA,0,2106507
lacIp,0.5,1,1,AGCTTAGATGCCGGTGCAAT,0,2112044
lacIp,0.5,1,1,AGCTTAATGTTGCCTCTCTA,0,2107052
lacIp,0.5,1,1,AGCTGTTCCGCTTCTAGAGC,0,2108176
lacIp,0.5,1,1,AGCTGGTGTGTATCCGGGAC,0,2115346
lacIp,0.5,1,1,AGCTGGTGTGATTTACTGGT,0,2098534
lacIp,0.5,1,1,AGCTGGCTTTGTAATGTGGC,0,2104503
lacIp,0.5,1,1,AGCTGACGGCCTGAAGAGAG,0,2101958
lacIp,0.5,1,1,AGCTCCAGATGGAACTTAGT,0,2115147
lacIp,0.5,1,1,AGCTCATAGCGGGCTTATGG,0,2096331
lacIp,0.5,1,1,AGCTATGTGTGTTTCGCTTA,0,2119515
lacIp,0.5,1,1,AGCTATATGGCCACATAGAT,0,2091871
lacIp,0.5,1,1,AGCGTTTATCCAGATGCTGT,0,2112667
lacIp,0.5,1,1,AGCGGTAGGCTGCTTCCTGG,0,2105283
lacIp,0.5,1,1,AGCGGCGACGCAGGAAATTA,0,2101932
lacIp,0.5,1,1,AGCGGCCTGTGTTTCAGGTC,0,2094023
lacIp,0.5,1,1,AGCGGACCCACATGCTAAGG,0,2108993
lacIp,0.5,1,1,AGCGCGCAGCTTTTAGCGCC,0,2098927
lacIp,0.5,1,1,AGCGATCGCACAGAGTCAAA,0,2091519
lacIp,0.5,1,1,AGCGAACTCGGACGGGTTTT,0,2111100
lacIp,0.5,1,1,AGCCTGCGATCAACCTAACG,0,2106497
lacIp,0.5,1,1,AGCCGCGGTATTCGTATGGT,0,2090097
lacIp,0.5,1,1,AGCCGCAAGCGTGTACCGAA,0,2095110
lacIp,0.5,1,1,AGCCCGTTGGTGTTATTATC,0,2110966
lacIp,0.5,1,1,AGCCCCGGCGGAGAAGCTGG,0,2116525
lacIp,0.5,1,1,AGCAGGTTAGGAAAAGTCGT,0,2110399
lacIp,0.5,1,1,AGCAGGGGTCCTAGCAGGGT,0,2094173
lacIp,0.5,1,1,AGCAGCCATGCACGTGATTT,0,2099310
lacIp,0.5,1,1,AGCACTTGGTTAGAAAAGAT,0,2109650
lacIp,0.5,1,1,AGATTTCCTACTCGTTTGTG,0,2092946
lacIp,0.5,1,1,AGATTGTAACTCGGGGGCTC,0,2099864
lacIp,0.5,1,1,AGATTCAAGATGGTAGAGAT,0,2108370
lacIp,0.5,1,1,AGATGGGAAAGAGGGTGTTA,0,2095809
lacIp,0.5,1,1,AGATCGTTCGGTAGAGACTG,0,2099065
lacIp,0.5,1,1,AGATCCGACCAAGGGCCGGA,0,2107846
lacIp,0.5,1,1,AGATATTACGGCCAAATATA,0,2096061
lacIp,0.5,1,1,AGATACATTAGCCTACCCGG,0,2107412
lacIp,0.5,1,1,AGAGTTCTCCCAAGCATTCT,0,2111095
lacIp,0.5,1,1,AGAGTGCGTACGTTCCCTCC,0,2085739
lacIp,0.5,1,1,AGAGGATATGTGTCCTGGAT,0,2103439
lacIp,0.5,1,1,AGAGCTTGGCTAGTGGGGTT,0,2089734
lacIp,0.5,1,1,AGAGCGGTAAACGTAGCCTA,0,2093217
lacIp,0.5,1,1,AGAGCGGCTGTATGACAGTA,0,2111078
lacIp,0.5,1,1,AGAGCCACAGGGACACGTTG,0,2114776
lacIp,0.5,1,1,AGAGCACAAGCGACTGCGGG,0,2096161
lacIp,0.5,1,1,AGAGACGACTGTAGATGGAG,0,2103083
lacIp,0.5,1,1,AGAGACACGACCGGGCAGTA,0,2108637
lacIp,0.5,1,1,AGACTTGACCCCGGCTTTCG,0,2095077
lacIp,0.5,1,1,AGACGGCCGCTTATTCAGGC,0,2112244
lacIp,0.5,1,1,AGACGGAAGCCGCACAAACA,0,2086648
lacIp,0.5,1,1,AGACGAGAGCAGGGTTGCTC,0,2100579
lacIp,0.5,1,1,AGACCGACAGTACACTGCGT,0,2097569
lacIp,0.5,1,1,AGACCATGCTAATTTGTAGC,0,2092189
lacIp,0.5,1,1,AGACCAGCGCGGGCATTACC,0,2121070
lacIp,0.5,1,1,AGACAGCCTCGCTTAAACAT,0,2114976
lacIp,0.5,1,1,AGACACACACCGCTTAGATG,0,2102153
lacIp,0.5,1,1,AGAAGGGGTCCTGGTCGTGG,0,2100327
lacIp,0.5,1,1,AGAAGAAATCGCCATGACGC,0,2103634
lacIp,0.5,1,1,AGAACTCCGTACTGGCTTAA,0,2103748
lacIp,0.5,1,1,AGAACCAATGTCCATCCGGT,0,2118637
lacIp,0.5,1,1,AGAACAGAACCTTCTACGTG,0,2087576
lacIp,0.5,1,1,AGAAAATCACGTGCGGCAGC,0,2096834
lacIp,0.5,1,1,AGAAAAGTGCAGGCGAGGCA,0,2086410
lacIp,0.5,1,1,AGAAAACTACCTCCTACATC,0,2116188
lacIp,0.5,1,1,ACTTTCGGAGATGAACCACT,0,2107011
lacIp,0.5,1,1,ACTTGGGGCCTATGGGTCGT,0,2109119
lacIp,0.5,1,1,ACTTGCTTTACATGTGACTA,0,2121314
lacIp,0.5,1,1,ACTTGCAATGTAAGGGGCTA,0,2113470
lacIp,0.5,1,1,ACTTCAATTCAACCGTCAAT,0,2094047
lacIp,0.5,1,1,ACTTATTTTAGACCGCTCCC,0,2094295
lacIp,0.5,1,1,ACTTAGAGGTATTTAGCCTA,0,2106009
lacIp,0.5,1,1,ACTTACTCACCTCACGTCTT,0,2093678
lacIp,0.5,1,1,ACTTACAGATCCCCGCCGAA,0,2119392
lacIp,0.5,1,1,ACTGTTCTGGCTAGACTAGC,0,2099642
lacIp,0.5,1,1,ACTGTGTCCGGGCAACGTTA,0,2101463
lacIp,0.5,1,1,ACTGGTTAGGCCACCTAGTA,0,2119987
lacIp,0.5,1,1,ACTGGGTTATGGAATCTTGG,0,2092064
lacIp,0.5,1,1,ACTGGGCGGATAAACGACCG,0,2103261
lacIp,0.5,1,1,ACTGGGCACCGGCGGACCGC,0,2094112
lacIp,0.5,1,1,ACTGGACCCGGATGACTTTT,0,2121661
lacIp,0.5,1,1,ACTGCTGAGTCAGTATCGTC,0,2117834
lacIp,0.5,1,1,ACTGCGTTAGTAAAGGAGGG,0,2114034
lacIp,0.5,1,1,ACTGATTAGACCCCGATCGC,0,2104958
lacIp,0.5,1,1,ACTGACGAAGTAGTTCTCAA,0,2086223
lacIp,0.5,1,1,ACTGAAGAGGGGGAACCTCA,0,2106435
lacIp,0.5,1,1,ACTCGGCTGGATTCCCGCAG,0,2103601
lacIp,0.5,1,1,ACTCGCAGAAGAGTGAAATT,0,2111599
lacIp,0.5,1,1,ACTCGATTAATGTATCTCAG,0,2091296
lacIp,0.5,1,1,ACTCCGTCATTACGCGAGTG,0,2094247
lacIp,0.5,1,1,ACTCCACGTCCCACCGTTGA,0,2092628
lacIp,0.5,1,1,ACTCCAAACTTTGCTGCGAT,0,2111858
lacIp,0.5,1,1,ACTCATTGGATAGTTGGCTT,0,2088450
lacIp,0.5,1,1,ACTCAGACATCGGTACAGGC,0,2102783
lacIp,0.5,1,1,ACTCAATAAGGTATTTATAA,0,2121151
lacIp,0.5,1,1,ACTCAAGTTCCGCACGGGTT,0,2103208
lacIp,0.5,1,1,ACTATGGGTGGCAGACTTAA,0,2115211
lacIp,0.5,1,1,ACTATACCCAATCAGTCTAC,0,2120233
lacIp,0.5,1,1,ACTAGCAGTAGGTTCCTAAG,0,2119385
lacIp,0.5,1,1,ACTAGAAGGATCGGCTCGTT,0,2112379
lacIp,0.5,1,1,ACTACGAGGAGGTCGTTTGT,0,2102812
lacIp,0.5,1,1,ACTACCTCTGCACGTTCACC,0,2087532
lacIp,0.5,1,1,ACTAAGCTATCGAGTGGACT,0,2119094
lacIp,0.5,1,1,ACTAAGAATGCCGGACCACT,0,2089558
lacIp,0.5,1,1,ACTAAAGCATTGGCCTAGAC,0,2103263
lacIp,0.5,1,1,ACTAAACCAGCGGACACCAA,0,2112488
lacIp,0.5,1,1,ACGTGTGTATTTATATGAAT,0,2119400
lacIp,0.5,1,1,ACGTGTGCCGACGAAGACAA,0,2103770
lacIp,0.5,1,1,ACGTGATGAAGGTATAACGC,0,2117667
lacIp,0.5,1,1,ACGTGAGGGAGTGCCAGTGT,0,2112911
lacIp,0.5,1,1,ACGTCTACCGTGATAAGTTA,0,2095014
lacIp,0.5,1,1,ACGTCGGTGGACTACAGGCC,0,2122303
lacIp,0.5,1,1,ACGTCAGAAAAGATGGACGA,0,2097312
lacIp,0.5,1,1,ACGTATCCTGTCAATAGCCA,0,2091998
lacIp,0.5,1,1,ACGTACTTAAATGTGATCCG,0,2092116
lacIp,0.5,1,1,ACGGGGGTTCAAGTTGTACC,0,2119800
lacIp,0.5,1,1,ACGGGGCGATCCCGCCAGCG,0,2095811
lacIp,0.5,1,1,ACGGGACCTGGAAAGAGGTG,0,2121439
lacIp,0.5,1,1,ACGGCACTCCACCTCCAGCA,0,2103819
lacIp,0.5,1,1,ACGGAATCAACTTGTAAGGT,0,2087548
lacIp,0.5,1,1,ACGCTGGAGTTAACACGGTA,0,2105202
lacIp,0.5,1,1,ACGCGTTTTCTACACGAAAA,0,2091619
lacIp,0.5,1,1,ACGCGGTCAGCGATGCACGA,0,2097545
lacIp,0.5,1,1,ACGCGGACATCGGGTGGAAC,0,2121523
lacIp,0.5,1,1,ACGCGCTTGGCGGAGTGTCC,0,2118393
lacIp,0.5,1,1,ACGCGAATAACAGACCTTAT,0,2088376
lacIp,0.5,1,1,ACGCCTGGTCTGGCCCCCCA,0,2090584
lacIp,0.5,1,1,ACGCCTATCTTTGATTTGAA,0,2106163
lacIp,0.5,1,1,ACGCCGTGCTCCGCGAATGT,0,2105273
lacIp,0.5,1,1,ACGCCGCGTTAGGCCGACCA,0,2120990
lacIp,0.5,1,1,ACGCCACGCGTAACGCTGAT,0,2102123
lacIp,0.5,1,1,ACGCATGAGTTGGGGTACAG,0,2110645
lacIp,0.5,1,1,ACGATTGAGTCGCGCAATAT,0,2105681
lacIp,0.5,1,1,ACGATGTGACCAGATTCGGG,0,2107209
lacIp,0.5,1,1,ACGATGCATCCGTCTAGCTT,0,2118982
lacIp,0.5,1,1,ACGAGGTAAGGTCGATTTAT,0,2110084
lacIp,0.5,1,1,ACGAGGTAAGGCAGCTTAGG,0,2091278
lacIp,0.5,1,1,ACGAGGATACGGCAACAGAA,0,2109691
lacIp,0.5,1,1,ACGACTTCGGAATTGTTTCA,0,2107351
lacIp,0.5,1,1,ACGACTTCCTCGTATGCGTG,0,2109359
lacIp,0.5,1,1,ACGAATCCGTCTTGGGTTTC,0,2116161
lacIp,0.5,1,1,ACGAAGCACCAGAAATTTGG,0,2093844
lacIp,0.5,1,1,ACGAACGGCATACATACATC,0,2094994
lacIp,0.5,1,1,ACGAACACTGTACGTAGGGA,0,2100731
lacIp,0.5,1,1,ACCTTTTTTGGCAAATCGCT,0,2109553
lacIp,0.5,1,1,ACCTTAATGGCTGATTTGCA,0,2095742
lacIp,0.5,1,1,ACCTGGTAGAGGCATAGTCT,0,2121269
lacIp,0.5,1,1,ACCTATAGATCAGATCATCA,0,2101048
lacIp,0.5,1,1,ACCGTGGCCACTTTTTCATC,0,2120481
lacIp,0.5,1,1,ACCGGGGCGTAATGTAGCCT,0,2087292
lacIp,0.5,1,1,ACCGGATCAACTCGCCATAA,0,2119931
lacIp,0.5,1,1,ACCGGACCCTATTCATTAAC,0,2118096
lacIp,0.5,1,1,ACCGCCGGCTTTCAACCGTC,0,2117180
lacIp,0.5,1,1,ACCGCATATGCGGTACCGGT,0,2107232
lacIp,0.5,1,1,ACCGACTCTCAGATAGGGTA,0,2091677
lacIp,0.5,1,1,ACCCTTCATCTTCGTGGCGG,0,2093080
lacIp,0.5,1,1,ACCCTGCCCTTCGTGAGTCT,0,2122014
lacIp,0.5,1,1,ACCCTCCTTTCGATCAAGAA,0,2103238
lacIp,0.5,1,1,ACCCTACCGATGATTGCCTT,0,2097424
lacIp,0.5,1,1,ACCCGCGATTGTCGTGAAGC,0,2090648
lacIp,0.5,1,1,ACCCCCTTCTTATACAGTGG,0,2109897
lacIp,0.5,1,1,ACCCATCATGTAGGCTATTA,0,2105988
lacIp,0.5,1,1,ACCCATACTTGTTTCGAATT,0,2085688
lacIp,0.5,1,1,ACCCAAACAGAATTGACTGT,0,2088138
lacIp,0.5,1,1,ACCATTCGTAGGGTCGCTCC,0,2090181
lacIp,0.5,1,1,ACCATCCGGTAACTTGTACA,0,2090631
lacIp,0.5,1,1,ACCATCCATCTACGAGTATC,0,2096535
lacIp,0.5,1,1,ACCAGTAAGCCACGTAACTC,0,2121001
lacIp,0.5,1,1,ACCAGGTTACTACATAATGT,0,2101666
lacIp,0.5,1,1,ACCAGGTGCATCCTACGCGT,0,2103767
lacIp,0.5,1,1,ACCAGCTACGGAGCCCGCCA,0,2114424
lacIp,0.5,1,1,ACCAGATGCTTAATGGAACT,0,2111963
lacIp,0.5,1,1,ACCAGATCATCTCTACTCGC,0,2095335
lacIp,0.5,1,1,ACCACTAGAAATTTATCGCT,0,2100406
lacIp,0.5,1,1,ACCACAAGGTGGCCAGGGGA,0,2117063
lacIp,0.5,1,1,ACCAATTAAAATCGATACTG,0,2086116
lacIp,0.5,1,1,ACCAATGGAAATCTAACTTA,0,2116837
lacIp,0.5,1,1,ACCAACTATACTGAATCATT,0,2091142
lacIp,0.5,1,1,ACCAACGAAAGGGATTCTTG,0,2118481
lacIp,0.5,1,1,ACCAAAGTAACTAACCTTTA,0,2103374
lacIp,0.5,1,1,ACATTTAGGGACTTGACAGT,0,2092215
lacIp,0.5,1,1,ACATTGGCTTCGGCGAGGGT,0,2107055
lacIp,0.5,1,1,ACATTATTACGGATGCCCTG,0,2112020
lacIp,0.5,1,1,ACATTAGCCGTTTCATGGCT,0,2089523
lacIp,0.5,1,1,ACATGTACGGCTTATAATTT,0,2087529
lacIp,0.5,1,1,ACATGGACACATGGTCGGTC,0,2110514
lacIp,0.5,1,1,ACATGAAGAAGACCACGACG,0,2116918
lacIp,0.5,1,1,ACATAAAAGCTTAGGATCAC,0,2099283
lacIp,0.5,1,1,ACAGTGTGGGCGGCCGGAAT,0,2092398
lacIp,0.5,1,1,ACAGGTTCGCCAAGTCCTGT,0,2103361
lacIp,0.5,1,1,ACAGGATTAGTCACCACAGC,0,2120011
lacIp,0.5,1,1,ACAGCAAGCCCTTCACGGTG,0,2102866
lacIp,0.5,1,1,ACAGACTCAGCCGTACAGGG,0,2116552
lacIp,0.5,1,1,ACACTGGAATACATTCGTAC,0,2109770
lacIp,0.5,1,1,ACACTGATTGCCACAAAGGA,0,2119257
lacIp,0.5,1,1,ACACTCGGGAGATGCACTCC,0,2094163
lacIp,0.5,1,1,ACACTCGGAATCAAGGTACA,0,2092785
lacIp,0.5,1,1,ACACTCCTCGGAATGCAGCT,0,2097422
lacIp,0.5,1,1,ACACGGCTCACCGCCCCGCA,0,2107627
lacIp,0.5,1,1,ACACGATGTAAAAGGTCAGA,0,2092213
lacIp,0.5,1,1,ACACCGGTGCAAGAGAGCTA,0,2098410
lacIp,0.5,1,1,ACACCGCCGTGGATTCTTAA,0,2110981
lacIp,0.5,1,1,ACACCATATCCCCGACTTTG,0,2105915
lacIp,0.5,1,1,ACACATGTTCGCGACGAACC,0,2098909
lacIp,0.5,1,1,ACAATATCTTGGTGCGGCCA,0,2118115
lacIp,0.5,1,1,ACAATACCGAGATAGTGAGT,0,2104940
lacIp,0.5,1,1,ACAATAATTGGACTGGATAT,0,2111765
lacIp,0.5,1,1,ACAAGGGGGCACTCTACAGA,0,2089865
lacIp,0.5,1,1,ACAACGGCTGGTTCTGGAGC,0,2112491
lacIp,0.5,1,1,ACAACGGCAGAGGTAGTAGT,0,2100368
lacIp,0.5,1,1,ACAACGCGCAAATGCGGGGG,0,2121266
lacIp,0.5,1,1,ACAACCTGAGATATTTACAC,0,2107540
lacIp,0.5,1,1,ACAAAGCACAGCCGAAACCT,0,2105687
lacIp,0.5,1,1,AATTTGGCTGTACATCATTC,0,2100375
lacIp,0.5,1,1,AATTTGCATCAGTGATGTGT,0,2114167
lacIp,0.5,1,1,AATTTATTTGGTAGATTCAG,0,2115358
lacIp,0.5,1,1,AATTTATTCCGGACTGCCTC,0,2104907
lacIp,0.5,1,1,AATTGGTCGTTGCTTGACAA,0,2104438
lacIp,0.5,1,1,AATTGCTCGGGACGGGGGCG,0,2111363
lacIp,0.5,1,1,AATTGATCGCCGTGCTATGA,0,2106437
lacIp,0.5,1,1,AATTGAAGGTCCCGACTACT,0,2117938
lacIp,0.5,1,1,AATTGAAAGGCATAGGCGTG,0,2115291
lacIp,0.5,1,1,AATTCTCAGTTTATACACGG,0,2085799
lacIp,0.5,1,1,AATTCGTAATACTATATTCA,0,2117351
lacIp,0.5,1,1,AATTCGGGAAACAACATGAG,0,2108884
lacIp,0.5,1,1,AATTCGATTGTGGACGAGAA,0,2104142
lacIp,0.5,1,1,AATTCGAGTCGGGCTTGCGC,0,2092146
lacIp,0.5,1,1,AATTAGGTACCTTGCCGCAT,0,2096940
lacIp,0.5,1,1,AATTACGAACCGCTGGTATT,0,2108666
lacIp,0.5,1,1,AATGTCTGCGGGGTCTTCGA,0,2121317
lacIp,0.5,1,1,AATGTAGGCCTGACCGCCCA,0,2101499
lacIp,0.5,1,1,AATGGCTTCTCGAGTAGGCC,0,2089197
lacIp,0.5,1,1,AATGGCGTTGCGGGGCCGGC,0,2093355
lacIp,0.5,1,1,AATGCCGATATTTTGTGACA,0,2114225
lacIp,0.5,1,1,AATGCCGACATACCAAGGTC,0,2096678
lacIp,0.5,1,1,AATGCCCGGCTCTAGGCAGA,0,2109964
lacIp,0.5,1,1,AATGCATAATAAAACCCTAG,0,2115443
lacIp,0.5,1,1,AATGAGCGTCACATTGGTTG,0,2109011
lacIp,0.5,1,1,AATGAACTTTTACTCGTGAC,0,2108396
lacIp,0.5,1,1,AATCTGGTCCACCTGGATAG,0,2091029
lacIp,0.5,1,1,AATCTACATTCCAGATCAAT,0,2092440
lacIp,0.5,1,1,AATCGGGGTGGTCACCCTGG,0,2103974
lacIp,0.5,1,1,AATCGCATCAATACGGTCAC,0,2089139
lacIp,0.5,1,1,AATCGAGCTGACTAAGCCCG,0,2114930
lacIp,0.5,1,1,AATCATTAGGAGTTCATACT,0,2099954
lacIp,0.5,1,1,AATCATGTAGCCGGACGTAC,0,2116628
lacIp,0.5,1,1,AATCAGGGGGCGTACGCAAC,0,2110968
lacIp,0.5,1,1,AATCACCGAATAGTCTTGGA,0,2094867
lacIp,0.5,1,1,AATATTTCTAGCCTAGACGC,0,2095487
lacIp,0.5,1,1,AATAGTTAGTTTGGATCCCA,0,2095947
lacIp,0.5,1,1,AATAGGCACGCTCCTATACC,0,2100940
lacIp,0.5,1,1,AATAATCTTCCGGTCTCAAC,0,2092001
lacIp,0.5,1,1,AATAATCCAGGACCATTGCT,0,2115068
lacIp,0.5,1,1,AATAACGGATTACCGGAATA,0,2089360
lacIp,0.5,1,1,AATAACAGTTTGCGAGGCGC,0,2090252
lacIp,0.5,1,1,AAGTTTAGGCTGTCTCATGC,0,2113538
lacIp,0.5,1,1,AAGTTGCCCCTTCGAACTCG,0,2111589
lacIp,0.5,1,1,AAGTTATCTCGGACATGGTC,0,2115779
lacIp,0.5,1,1,AAGTTAGCTTAGTGTGGCAC,0,2092891
lacIp,0.5,1,1,AAGTTAGAACGAACGACGAC,0,2091382
lacIp,0.5,1,1,AAGTGTGTGACAAACGATGG,0,2099209
lacIp,0.5,1,1,AAGTGGGGGTCTAAAAGTTG,0,2108613
lacIp,0.5,1,1,AAGTGCTTCTTGTTTTGGAA,0,2105092
lacIp,0.5,1,1,AAGTCTTTGCCGCCTAGAGC,0,2122377
lacIp,0.5,1,1,AAGTCGCAAACCGGCAAAGT,0,2107639
lacIp,0.5,1,1,AAGTCCCGGATTTCTGCCGC,0,2096155
lacIp,0.5,1,1,AAGTCAAACTTAGGCGAACA,0,2110372
lacIp,0.5,1,1,AAGTATTGTGGGCGAAACAA,0,2105084
lacIp,0.5,1,1,AAGTAACGCCGAAATTAGCG,0,2091748
lacIp,0.5,1,1,AAGGTGTGCAGCTTGGGTTA,0,2116154
lacIp,0.5,1,1,AAGGTGTGAGGCGGGTTGTG,0,2088253
lacIp,0.5,1,1,AAGGTAGTCAGACACCACGA,0,2105732
lacIp,0.5,1,1,AAGGGTTCCTTATTCTTTAT,0,2103028
lacIp,0.5,1,1,AAGGCTACGTATCATTAGAC,0,2096450
lacIp,0.5,1,1,AAGGCAAAAGACAAGAGCCA,0,2114194
lacIp,0.5,1,1,AAGGACTGGCGCACGGAGCT,0,2093019
lacIp,0.5,1,1,AAGCTTTTCCTCGGTGCTAG,0,2109034
lacIp,0.5,1,1,AAGCTTGCTACGCGTATTAC,0,2096007
lacIp,0.5,1,1,AAGCTCGCCTTTGACTATGC,0,2114561
lacIp,0.5,1,1,AAGCGTATAGCCCCCCTATC,0,2111961
lacIp,0.5,1,1,AAGCGTACAGGATAACTTTA,0,2106993
lacIp,0.5,1,1,AAGCGCGCTATCCTGCGATT,0,2095005
lacIp,0.5,1,1,AAGCGAAGGTAACAATCCGA,0,2090865
lacIp,0.5,1,1,AAGCCATTGCTTTTAGATGT,0,2103879
lacIp,0.5,1,1,AAGCATGTGGTCGCCTTATG,0,2111295
lacIp,0.5,1,1,AAGCATAGGTTTGTCCGCTT,0,2090351
lacIp,0.5,1,1,AAGATTGGGCATAAACTGCG,0,2095443
lacIp,0.5,1,1,AAGATATCTGCTCGGATAGT,0,2087096
lacIp,0.5,1,1,AAGATAAGTAGTGAATGGTA,0,2104837
lacIp,0.5,1,1,AAGAGCACGACACGTAGTGA,0,2093552
lacIp,0.5,1,1,AAGACCTTGGAAAGGGTGTA,0,2093500
lacIp,0.5,1,1,AAGACAATCACTCTTGTTAT,0,2088304
lacIp,0.5,1,1,AAGAATTGAAAGAATCGCTA,0,2102148
lacIp,0.5,1,1,AAGAATCCTAAGAAATTCTT,0,2089588
lacIp,0.5,1,1,AAGAAGCCGCACGAGTACAC,0,2114863
lacIp,0.5,1,1,AAGAACATAGCGATTCTCTA,0,2098932
lacIp,0.5,1,1,AACTTGCATCCGGGGATTTA,0,2099707
lacIp,0.5,1,1,AACTTCCTACTGTCAATGCT,0,2101007
lacIp,0.5,1,1,AACTTCCCGGTTGTACTGTC,0,2087355
lacIp,0.5,1,1,AACTTCCATGCGCATAGCTA,0,2100714
lacIp,0.5,1,1,AACTGTTTGAAATACTACAC,0,2091114
lacIp,0.5,1,1,AACTGGCGGGCAGCCCCGTC,0,2110307
lacIp,0.5,1,1,AACTGAGCTGCGGAACCGTG,0,2092627
lacIp,0.5,1,1,AACTGACAGCCGCGCCTCAG,0,2086311
lacIp,0.5,1,1,AACTGAAGCGCTCAAAGCTA,0,2111150
lacIp,0.5,1,1,AACTCTGCCGCCGTCATCTG,0,2101145
lacIp,0.5,1,1,AACTCGGAAAACGGACGAAC,0,2095671
lacIp,0.5,1,1,AACTCGCCTCTAGGTGTCTA,0,2106178
lacIp,0.5,1,1,AACTCGAACACAGCTTACCA,0,2101321
lacIp,0.5,1,1,AACGTTGATCATACTTCAAT,0,2100177
lacIp,0.5,1,1,AACGTCGTAGGTGTTAAACG,0,2090159
lacIp,0.5,1,1,AACGTATGCTGTCTATTTTT,0,2121898
lacIp,0.5,1,1,AACGGTATTAACGAGAAGAA,0,2105107
lacIp,0.5,1,1,AACGGGGTCTACGTAGGTCA,0,2093960
lacIp,0.5,1,1,AACGGGGGTAACTAGCGAAA,0,2096764
lacIp,0.5,1,1,AACGGGCATAGTCATTAGTT,0,2111383
lacIp,0.5,1,1,AACGGATAGATAGTCTGTCG,0,2102712
lacIp,0.5,1,1,AACGCTATACGATACCACGA,0,2116819
lacIp,0.5,1,1,AACGCGGCGCTTGTTATCTA,0,2093255
lacIp,0.5,1,1,AACGCATTAGAAGGGTAAAT,0,2087298
lacIp,0.5,1,1,AACGCACCCCCCATGTACAG,0,2118916
lacIp,0.5,1,1,AACGCAAGGGTCTTCCACAT,0,2107954
lacIp,0.5,1,1,AACGCAACTCGGTTCGCTTT,0,2113333
lacIp,0.5,1,1,AACCTGACGCACCCCGGTCA,0,2097156
lacIp,0.5,1,1,AACCTCAAAGCATTCCGAGA,0,2116935
lacIp,0.5,1,1,AACCGTCATCAAGAAGGTGT,0,2117225
lacIp,0.5,1,1,AACCGGTCTGTATCAATGTT,0,2119031
lacIp,0.5,1,1,AACCGCATTACGAATGCGTA,0,2112403
lacIp,0.5,1,1,AACCGACCCAAACTACTGAG,0,2102157
lacIp,0.5,1,1,AACCGAACCTGGTAGTAGGA,0,2089142
lacIp,0.5,1,1,AACCCGGTAAACATTCGTGT,0,2115321
lacIp,0.5,1,1,AACCCGAGAGGCGGCGCCGT,0,2092984
lacIp,0.5,1,1,AACCCCCAAAGCGATTCAAC,0,2090262
lacIp,0.5,1,1,AACCATGTGTCGTCCAGAAT,0,2115053
lacIp,0.5,1,1,AACCATGAAAGTTCTCACGA,0,2101510
lacIp,0.5,1,1,AACCACAAACGTCCGCTAGG,0,2105782
lacIp,0.5,1,1,AACCAATTACAATCCCGCTC,0,2105245
lacIp,0.5,1,1,AACCAATCCTTACATTGTTG,0,2118606
lacIp,0.5,1,1,AACATATGGAATCCGAGACT,0,2096351
lacIp,0.5,1,1,AACAGGATAATAATTTAGCG,0,2114239
lacIp,0.5,1,1,AACAGGAGCAGAATTCTTCG,0,2120928
lacIp,0.5,1,1,AAATTCCATGATACAACATC,0,2101844
lacIp,0.5,1,1,AAATTCAGTCTTACCCATAT,0,2100431
lacIp,0.5,1,1,AAATGTTAGCTTAAATGATG,0,2119052
lacIp,0.5,1,1,AAATGGCTAGTGAAGGAGCA,0,2098538
lacIp,0.5,1,1,AAATGGCGCCTAACGGGTTT,0,2087340
lacIp,0.5,1,1,AAATGATATCTTATTGAGAA,0,2089771
lacIp,0.5,1,1,AAATCTGTATACTGAACTTT,0,2087312
lacIp,0.5,1,1,AAATCTCCTAGAGACTGGGG,0,2115760
lacIp,0.5,1,1,AAATCGACCTTCCCTCGTAC,0,2093587
lacIp,0.5,1,1,AAATATAATGGTCCATACTC,0,2089121
lacIp,0.5,1,1,AAATAGTGTAGTCCTTGCGC,0,2112286
lacIp,0.5,1,1,AAATACGGGTTGCACTGTAG,0,2098347
lacIp,0.5,1,1,AAATACCTGGAGAAGGGGGG,0,2090053
lacIp,0.5,1,1,AAAGTCGGCATTCAATCACT,0,2102058
lacIp,0.5,1,1,AAAGTACCTTTAAAGTCCCT,0,2099655
lacIp,0.5,1,1,AAAGGGGCAGATAACGCCCG,0,2115981
lacIp,0.5,1,1,AAAGGGCAATTGCCGCGCCT,0,2099204
lacIp,0.5,1,1,AAAGGCCCCAGGGTAAGGCA,0,2116722
lacIp,0.5,1,1,AAAGCCTTTCATGCGAGAGT,0,2089330
lacIp,0.5,1,1,AAAGAGCAAGGTGTCAGCGA,0,2120789
lacIp,0.5,1,1,AAAGACTATTTGAAATGCGT,0,2120745
lacIp,0.5,1,1,AAACTTACATGGTCCGGATG,0,2113204
lacIp,0.5,1,1,AAACTGATGTATTTTAGATG,0,2100969
lacIp,0.5,1,1,AAACTCTTGATTCCCAAACA,0,2095638
lacIp,0.5,1,1,AAACTCGACGTCCTATCGTC,0,2117153
lacIp,0.5,1,1,AAACTATCTGCCACATTACA,0,2091444
lacIp,0.5,1,1,AAACTATCAGAGCCTCCGCA,0,2115631
lacIp,0.5,1,1,AAACGGAGGAGCTGGAGGGA,0,2094017
lacIp,0.5,1,1,AAACGCCCAAGGTGAAAGAG,0,2108268
lacIp,0.5,1,1,AAACCTTGATGCGCCGTCTT,0,2104767
lacIp,0.5,1,1,AAACCTGCCCGTGTACTTCG,0,2117201
lacIp,0.5,1,1,AAACCGCACAGTTCCTCTCG,0,2096926
lacIp,0.5,1,1,AAACCCCGCTGGGCGGTGAT,0,2120166
lacIp,0.5,1,1,AAACCCAGGGTCATAAAGTG,0,2087516
lacIp,0.5,1,1,AAACCAGTCGGGCACTTTTT,0,2110964
lacIp,0.5,1,1,AAACACGGGTTCTTGTGCTC,0,2112923
lacIp,0.5,1,1,AAACAAGTCCTGAATGCTAT,0,2090697
lacIp,0.5,1,1,AAAATTCATTTCACGTGATG,0,2090259
lacIp,0.5,1,1,AAAATGTCGCGGCTAGAAGC,0,2095945
lacIp,0.5,1,1,AAAAGTTACGCGTCCTACAA,0,2116735
lacIp,0.5,1,1,AAAAGTACTTTCATGATGGG,0,2090061
lacIp,0.5,1,1,AAAAGCGTGTGGTACTTGGG,0,2104642
lacIp,0.5,1,1,AAAAGAGTTGGATGGATTTA,0,2109314
lacIp,0.5,1,1,AAAACTTACAGACCACGCCT,0,2094623
lacIp,0.5,1,1,AAAACTCGCTGTCTCCTGAA,0,2114578
lacIp,0.5,1,1,AAAACGTCCGATCCGGGGGG,0,2121734
lacIp,0.5,1,1,AAAACGCAGACACATCTCGA,0,2094458
lacIp,0.5,1,1,AAAACAATGACCTGAGACTC,0,2100073
lacIp,0.5,1,1,AAAACAAATTTCGTGGAACA,0,2105222
lacIp,0.5,1,1,AAAAATTGACCTTCATTGGA,0,2107177
lacIp,0.5,1,1,AAAAAAAGTGGAGGTCGTTG,0,2105542
lacIp,21.0,20,0,GAGGGCCGCCTGGAAGTCAA,20,2086646
lacIp,11.0,10,0,CAGTAGAATCTTACGTTCCG,10,2091083
lacIp,7.0,6,0,TGACAACTGCGCAAAAGTTG,6,2121585
lacIp,7.0,6,0,GCTCTCCTGTGGTAAGCGGA,6,2114395
lacIp,7.0,6,0,CGGATGTGGTTCACTACCTA,6,2106633
lacIp,7.0,6,0,ACAGCCTGTCAGCTTGCACT,6,2114117
lacIp,6.0,5,0,TTTATGGGCATGTAACTCAA,5,2119097
lacIp,6.0,5,0,TCTAGGGTTCTTTGGTCAAG,5,2107775
lacIp,6.0,5,0,TCATCGCTGATGGGGCCTGA,5,2115586
lacIp,6.0,5,0,GTAGGTGTAACATACAGACT,5,2104190
lacIp,6.0,5,0,GGCATATCGCCTGCCCATGA,5,2115002
lacIp,6.0,5,0,GGAACAAGGATAAATGCATA,5,2093447
lacIp,6.0,5,0,CGCTTCCGCCCGAGCTGAGA,5,2104594
lacIp,6.0,5,0,CGCCGCAATGCGGTTGGGAA,5,2092913
lacIp,6.0,5,0,CGCACTTCTCTAAGTTGGAA,5,2117264
lacIp,6.0,5,0,CCATAGCCGTAGGTAGGGGT,5,2091931
lacIp,6.0,5,0,CAGGGTCAATTAAATAGCGA,5,2087729
lacIp,6.0,5,0,CACTATGCCTTACTGCTTTT,5,2101195
lacIp,6.0,5,0,CAATATCGGGCCTACACCTT,5,2090399
lacIp,6.0,5,0,ATTGGGCACAAGGGGTTTGT,5,2111978
lacIp,6.0,5,0,ATTATTGCCTCCCGCTCTGA,5,2106136
lacIp,6.0,5,0,AAGGGATACCGCGGTGATAG,5,2121966
lacIp,6.0,5,0,AAGCACGGCGGACCCTTGTT,5,2097316
lacIp,5.0,4,0,TTCCGTGCCTACAGGAATAA,4,2098921
lacIp,5.0,4,0,TGATTGTTTTGAGAATTTCT,4,2106200
lacIp,5.0,4,0,TCTATGTGGTGCAAGGAAGG,4,2098386
lacIp,5.0,4,0,TCCTGTGGTCAGCAATTTGG,4,2093847
lacIp,5.0,4,0,TCCGGAACAGGTACAAACGT,4,2121098
lacIp,5.0,4,0,TCAGATAAATATGATGGCCC,4,2117298
lacIp,5.0,4,0,TACCTGTTTAGTGTTTGAAC,4,2117427
lacIp,5.0,4,0,TACACTAGAAGTTACCTCCT,4,2121457
lacIp,5.0,4,0,GTTTACTAATCACCTGGCTT,4,2086674
lacIp,5.0,4,0,GTTGAGAAGAATTCAAATCT,4,2117380
lacIp,5.0,4,0,GTTACAATATACTTTAGCTG,4,2113628
lacIp,5.0,4,0,GTGAGCATAGGTCTGTGACG,4,2095912
lacIp,5.0,4,0,GTCCTCTCTCCGCCTTCAGT,4,2110052
lacIp,5.0,4,0,GGGTATCTGTCAGTGCGGAT,4,2100230
lacIp,5.0,4,0,GGGAGCCTACAAGTGCTTAT,4,2102414
lacIp,5.0,4,0,GGCGCTGTCCTCATCCCGAA,4,2098091
lacIp,5.0,4,0,GGCACTGGTTCTACTTCGAT,4,2090385
lacIp,5.0,4,0,GGATTCAAACTCGGGTGAGT,4,2115043
lacIp,5.0,4,0,GGATCTCGACTGCACCAGAC,4,2099506
lacIp,5.0,4,0,GCAGCCCCGTTGTACGAGCC,4,2115168
lacIp,5.0,4,0,GATCCCAAGGTTGCTTTGGA,4,2115986
lacIp,5.0,4,0,CTATCCAGAGATTAACACGT,4,2103762
lacIp,5.0,4,0,CGCACCCGATCTCGTGAAGC,4,2111551
lacIp,5.0,4,0,CGCAAAGGGGGTCTTTGATT,4,2094230
lacIp,5.0,4,0,CCTCGTCTCTTGCCCGGTTG,4,2107380
lacIp,5.0,4,0,CCCCATTGTGAACGTTACCA,4,2102920
lacIp,5.0,4,0,CAATTATGACAGCCGCTTTT,4,2115120
lacIp,5.0,4,0,ATCAACAGTCTCCGTGCTGA,4,2105360
lacIp,5.0,4,0,ATAGCTAAGCTAATAAGCTT,4,2087022
lacIp,5.0,4,0,AGGGCATATTACCGCGGGTC,4,2106703
lacIp,5.0,4,0,AGAAATGCCCGTCCATACGT,4,2095844
lacIp,5.0,4,0,AACAGGTCCTGTTCAACTTG,4,2113228
lacIp,5.0,4,0,AAAGTTGCGAACTTGCACGT,4,2089393
lacIp,4.0,3,0,TTGGGGTAGCACCTGTTTCC,3,2099987
lacIp,4.0,3,0,TTGCAGCATTCTCTCTGGGA,3,2112248
lacIp,4.0,3,0,TTCTGCTTGCTAAATTGTGC,3,2089465
lacIp,4.0,3,0,TTCGTGCCTGCTATTAAAGG,3,2096011
lacIp,4.0,3,0,TTCAGGGGACAGCAACACCA,3,2092467
lacIp,4.0,3,0,TTATACGTCAGCTACGACCC,3,2121488
lacIp,4.0,3,0,TTAGAGGTCAAGTAATGCTA,3,2100763
lacIp,4.0,3,0,TGGTTATTGTGAAGATCCCC,3,2098330
lacIp,4.0,3,0,TGGTAAGACATGCAATGCGA,3,2113334
lacIp,4.0,3,0,TGGGGGGGTATGATTGGCTT,3,2098720
lacIp,4.0,3,0,TGGCGCGGAATCAAGCTGCG,3,2113415
lacIp,4.0,3,0,TGGCCCTTCGTTTTCGGTAA,3,2091790
lacIp,4.0,3,0,TGGCATCCCCATTCTGAAAG,3,2121212
lacIp,4.0,3,0,TGCGGGCACTGTTATCCTTC,3,2115800
lacIp,4.0,3,0,TGCGGGAGAGGGTGGTTGGG,3,2106095
lacIp,4.0,3,0,TCTTTACGTATATACGCCCA,3,2090267
lacIp,4.0,3,0,TCGGAAAGGTAACCGGCAAA,3,2110427
lacIp,4.0,3,0,TCGCGAAAGTTTTCGTTAAG,3,2098826
lacIp,4.0,3,0,TCGAGCGGTGATATCTGCAA,3,2102377
lacIp,4.0,3,0,TCCATGAATCGCTCTACATA,3,2105717
lacIp,4.0,3,0,TCAGCGTGACAAATACCTGA,3,2107434
lacIp,4.0,3,0,TAGAGTCGAGATGTGCAGCC,3,2103332
lacIp,4.0,3,0,TAGAACTGGTATAAACTGCA,3,2113445
lacIp,4.0,3,0,TACTGTTGACAATAAAGGCT,3,2121367
lacIp,4.0,3,0,TAATTGGGTTTGATACAGCA,3,2090842
lacIp,4.0,3,0,GTTGTTTTGTGCCAATTTGT,3,2121170
lacIp,4.0,3,0,GTGTGGTACGGTGAGCTGAT,3,2094931
lacIp,4.0,3,0,GTGTAAGTATATTACAAATC,3,2109613
lacIp,4.0,3,0,GGTGGCGCTGGTCGTCGATT,3,2086978
lacIp,4.0,3,0,GGGCTGATTTATAACGAATC,3,2102233
lacIp,4.0,3,0,GGCAAGGTCCCTGGTCCAGA,3,2119128
lacIp,4.0,3,0,GGAGAGGATGGCTTATGGCA,3,2094965
lacIp,4.0,3,0,GCTAACGCCGCTAGGCGAGG,3,2085682
lacIp,4.0,3,0,GCGGGCTACTTAGATATTGA,3,2086082
lacIp,4.0,3,0,GCCTCGGCGCTAATAACGGG,3,2119511
lacIp,4.0,3,0,GCCGACTTATTGCTAGGCAT,3,2114219
lacIp,4.0,3,0,GCACTGCGGCTTCTTCATTG,3,2098231
lacIp,4.0,3,0,GCACTAGGTGCACGCTGTGT,3,2120570
lacIp,4.0,3,0,GATTGGAGCACACTAAGGAT,3,2091390
lacIp,4.0,3,0,GATTGACGATCATCCATTGA,3,2103744
lacIp,4.0,3,0,GATATGTTATCTGAAGGAGT,3,2114627
lacIp,4.0,3,0,GATAACCAAGGTCGCATGAT,3,2090501
lacIp,4.0,3,0,GAGTTGGAAAACCCCCCTTT,3,2100967
lacIp,4.0,3,0,GAGTCCGGCCCTTGGAAGAT,3,2117848
lacIp,4.0,3,0,GAGCCCCTAACTGGTACGTA,3,2106781
lacIp,4.0,3,0,GAGAGCACGGTGATTTATGA,3,2099364
lacIp,4.0,3,0,GACTTTGCCTTTCTAGAGGC,3,2093771
lacIp,4.0,3,0,GACGTGTTGATCATAGAAGA,3,2089404
lacIp,4.0,3,0,CTTCCTTTTGGCATACGGCC,3,2106084
lacIp,4.0,3,0,CTTCACTGGGCTTTCCAACT,3,2095188
lacIp,4.0,3,0,CTGATCATTTGGCATTCAGC,3,2115514
lacIp,4.0,3,0,CTGAGGCCGCGGGACGTGGA,3,2100628
lacIp,4.0,3,0,CTCGGATTTTAACGCTACAG,3,2109627
lacIp,4.0,3,0,CTCGACATAAACAGGCGTAC,3,2118178
lacIp,4.0,3,0,CTCAGTATCCGTTAATATCT,3,2095437
lacIp,4.0,3,0,CTACCATGCTGAACTATTTT,3,2113091
lacIp,4.0,3,0,CGTTAACCTCAAAGCGTTAA,3,2106870
lacIp,4.0,3,0,CGTAGATGACTCAGACCGAC,3,2117672
lacIp,4.0,3,0,CGTACGGTTTTTGTAGAAAT,3,2090831
lacIp,4.0,3,0,CGGTGTAGCTGAGAGCTATA,3,2118134
lacIp,4.0,3,0,CGGAACTGCATGATGTAACT,3,2109478
lacIp,4.0,3,0,CGACGCGGTCACCGTGCATC,3,2089098
lacIp,4.0,3,0,CGAAGTAACGCCTATGTGGA,3,2117737
lacIp,4.0,3,0,CCTGGAGCACTCGGAACTCC,3,2091257
lacIp,4.0,3,0,CCGAGGTAAGTACCCCTCAG,3,2111762
lacIp,4.0,3,0,CCCGCTTGTGTCTGGGTGCG,3,2094054
lacIp,4.0,3,0,CATTCCTACCATATGTGGAC,3,2093094
lacIp,4.0,3,0,CATGTACCCCTATTAGAACG,3,2119908
lacIp,4.0,3,0,CAGTCACCATCTTAGTGCAA,3,2103529
lacIp,4.0,3,0,CACGTTTCGTTACGAAAAAT,3,2105184
lacIp,4.0,3,0,CAATCCAGATTTTCACTGAT,3,2089696
lacIp,4.0,3,0,ATTTATCGCTTGCGAAGTCT,3,2113122
lacIp,4.0,3,0,ATTAACTAAGTCGTTATGGT,3,2090669
lacIp,4.0,3,0,ATGTACGAGGATTGGCAACA,3,2110371
lacIp,4.0,3,0,ATGATCTAGCCGTAGTTAGT,3,2116970
lacIp,4.0,3,0,ATGACACAGACCAGTCACAA,3,2118901
lacIp,4.0,3,0,ATGAAAGCCTTATGGGCTTC,3,2101074
lacIp,4.0,3,0,ATACGGGGAATAGATGTATT,3,2113749
lacIp,4.0,3,0,AGTTTGCTCCCGCTTTTGCT,3,2096957
lacIp,4.0,3,0,AGTTCCTTGCCAATACCTTG,3,2095142
lacIp,4.0,3,0,AGTCTAGGTAGTTCTTCTTG,3,2109300
lacIp,4.0,3,0,AGGTAAAGGGTGAATCTAGG,3,2106873
lacIp,4.0,3,0,AGGGGGTGCCCGTCGTAAGA,3,2111946
lacIp,4.0,3,0,AGGATAGGGGTCGGGGTCTG,3,2115866
lacIp,4.0,3,0,AGCTTTTCCTTTAGGATTCC,3,2093216
lacIp,4.0,3,0,AGCTTCGAACTAGGGGCCAC,3,2102100
lacIp,4.0,3,0,AGCTTAATGTGCTTAGTGAT,3,2117383
lacIp,4.0,3,0,AGCGATTAAGACGAGCTTTA,3,2101662
lacIp,4.0,3,0,AGAGACGTCCTGTTGGCGAT,3,2112847
lacIp,4.0,3,0,ACTTGACACGTCCCTTCAAT,3,2105700
lacIp,4.0,3,0,ACTTATATGCCTCTAAACTA,3,2103679
lacIp,4.0,3,0,ACTGCAATAACATAGGTTTT,3,2112746
lacIp,4.0,3,0,ACTCGGCTTATTGCTGAAAG,3,2098195
lacIp,4.0,3,0,ACGCGGGCCTGCTACGGCAT,3,2099662
lacIp,4.0,3,0,ACGCGCCGGTCACCGAAGCT,3,2092818
lacIp,4.0,3,0,ACGACCACCGTGAATCACCC,3,2089586
lacIp,4.0,3,0,ACCTGCGCCTCGCCTTTATT,3,2106391
lacIp,4.0,3,0,ACCCGCACAAAAATAAGGAA,3,2094395
lacIp,4.0,3,0,ACCAGTCGCCGCGGTAGAGC,3,2086651
lacIp,4.0,3,0,AATAAGCACGAGATGCAGGC,3,2096461
lacIp,4.0,3,0,AACTGTTCAAGCTAGGTAAC,3,2093003
lacIp,4.0,3,0,AACAGCCGAGATTACGAATA,3,2103025
lacIp,4.0,3,0,AAATCATTGAGCTGAACGAC,3,2097938
lacIp,3.0,2,0,TTTTTTAATGCCGCCTGCAG,2,2114319
lacIp,3.0,2,0,TTTTCGAAGTGCCAAACTCA,2,2120466
lacIp,3.0,2,0,TTGGACAGGATAGGCTGTCG,2,2098890
lacIp,3.0,2,0,TTGGACAAGGCAGCCATCGC,2,2108476
lacIp,3.0,2,0,TTGCACCTCCGAGGTGATCA,2,2110753
lacIp,3.0,2,0,TTGATTTGAAGGAACATATT,2,2111248
lacIp,3.0,2,0,TTGATAATCAGTGTCGGATG,2,2120117
lacIp,3.0,2,0,TTGACCGTCGGTGTTGGGCT,2,2108787
lacIp,3.0,2,0,TTCTGCCATAACGTGAGGCT,2,2101487
lacIp,3.0,2,0,TTCTCCGTGGTGCTCGCTTA,2,2119891
lacIp,3.0,2,0,TTCTATCGAGTTGCTGGTCG,2,2096070
lacIp,3.0,2,0,TTCGCAGCCGTGAAATGATC,2,2088917
lacIp,3.0,2,0,TTCGCACGGTAGCCTCGTAT,2,2118171
lacIp,3.0,2,0,TTCCTGTCAGGGGAAGGCAA,2,2105784
lacIp,3.0,2,0,TTCCCTATCTTTGGGTCCAT,2,2086044
lacIp,3.0,2,0,TTCCAAGCGGCTGCATGTAG,2,2101988
lacIp,3.0,2,0,TTCACCCAAGGGGACATATC,2,2102221
lacIp,3.0,2,0,TTACTGGGTGACAGACAGCA,2,2111157
lacIp,3.0,2,0,TTACGCACCGTGGGCTGCCG,2,2107331
lacIp,3.0,2,0,TGTTGACTGGCAATCTCTTG,2,2091845
lacIp,3.0,2,0,TGTTCGCCATGTCAATAGAA,2,2100399
lacIp,3.0,2,0,TGTCTAAGTTGCAAAGGATT,2,2103827
lacIp,3.0,2,0,TGTCGTTTGTGGATACGACC,2,2089093
lacIp,3.0,2,0,TGTAGTCCACTGTAAATGGT,2,2093723
lacIp,3.0,2,0,TGTAAGTATGAAAGGGCTTG,2,2108854
lacIp,3.0,2,0,TGGGCTACCCACAGTCATTT,2,2100083
lacIp,3.0,2,0,TGGGCGTATTTCCAATGCCT,2,2112852
lacIp,3.0,2,0,TGGCTCCCATGTGTGTGTTC,2,2110863
lacIp,3.0,2,0,TGGCGTACCATTATTGGTCA,2,2113911
lacIp,3.0,2,0,TGGATCATTGTCCTATCTGA,2,2115439
lacIp,3.0,2,0,TGGAGCGAGGATAGGGTAAA,2,2099356
lacIp,3.0,2,0,TGCTCTCGTGGGTGGTGATA,2,2113020
lacIp,3.0,2,0,TGCGGCGAGGGGCGAACAGA,2,2104839
lacIp,3.0,2,0,TGCCCCGCGATTCTCATCAT,2,2110721
lacIp,3.0,2,0,TGATTCAGGCACGGACTAGA,2,2097671
lacIp,3.0,2,0,TGATAGCCTCTCCGTATCAA,2,2105816
lacIp,3.0,2,0,TGAGGAGCGCACATTCAGAC,2,2092112
lacIp,3.0,2,0,TGAGATTGTTGCCATCTGAA,2,2111396
lacIp,3.0,2,0,TGACAGCCCCTATCCCTGTT,2,2115100
lacIp,3.0,2,0,TCTTCACACCAAAGGCTCAA,2,2119556
lacIp,3.0,2,0,TCTTAGTCATATCCCTGTGT,2,2111426
lacIp,3.0,2,0,TCTGTTAGAGGCTGGACGCT,2,2121908
lacIp,3.0,2,0,TCTGCAGTATATGAAGGAAT,2,2116387
lacIp,3.0,2,0,TCTCTAAATCAACGCTTTCT,2,2102103
lacIp,3.0,2,0,TCTCGTCTGTGTAGGGACTG,2,2095916
lacIp,3.0,2,0,TCTCCCCATATCCTCTGTGT,2,2096273
lacIp,3.0,2,0,TCGCTCTGTACTAGGCAGTA,2,2092356
lacIp,3.0,2,0,TCGAGCCCGTAATGGACGAG,2,2109156
lacIp,3.0,2,0,TCGACTTCCTTGGCAGCGGG,2,2093446
lacIp,3.0,2,0,TCCGTCCCTCGTAGGCCGAA,2,2089267
lacIp,3.0,2,0,TCCGAAACCGGTCATCGCAA,2,2086308
lacIp,3.0,2,0,TCATCGTGGTTACACACATG,2,2094245
lacIp,3.0,2,0,TCATATCTCTCTTTTCTTAC,2,2092996
lacIp,3.0,2,0,TCAGTATCAAAAGACATTGT,2,2108424
lacIp,3.0,2,0,TCAGCAAGGGTCCTCATGCC,2,2108850
lacIp,3.0,2,0,TCAGATTTAGTCATTGCGGA,2,2102705
lacIp,3.0,2,0,TCACCAGGTCAACTTAACTG,2,2117578
lacIp,3.0,2,0,TCACACGCTAGCTGTCTTCA,2,2118501
lacIp,3.0,2,0,TCAAGAAATATACACACGAC,2,2110243
lacIp,3.0,2,0,TATTGAGCGCTATTTCCTAA,2,2107478
lacIp,3.0,2,0,TATGGCAACGATGACCAATT,2,2122232
lacIp,3.0,2,0,TATCTGAAAGTTGCGTTCGT,2,2100043
lacIp,3.0,2,0,TAGGGTTCACTGGGGGAACT,2,2119262
lacIp,3.0,2,0,TAGGCCATGCGATTTGAAGG,2,2116105
lacIp,3.0,2,0,TAGAGTCCTAATCAAGCTAT,2,2088419
lacIp,3.0,2,0,TAGAATGGCACTACCTGACA,2,2117544
lacIp,3.0,2,0,TACCAGGGCCGTGCGTCAGG,2,2099848
lacIp,3.0,2,0,TACAGTAACAAGCACTACAG,2,2113777
lacIp,3.0,2,0,TACAGGTATCGGGGATCACC,2,2102036
lacIp,3.0,2,0,TAATCTCTGTGAACGCACGT,2,2103329
lacIp,3.0,2,0,TAATCAATAGCTGGGGCCAA,2,2109017
lacIp,3.0,2,0,TAACGGATGGTGCTCGTGCG,2,2104270
lacIp,3.0,2,0,TAACCCAGGATTTCCCACAC,2,2086676
lacIp,3.0,2,0,TAAACACATTCATGAAGATG,2,2098857
lacIp,3.0,2,0,GTTGGACCGCAATTAAGTGA,2,2108242
lacIp,3.0,2,0,GTTCCATAATTACAGCCTTT,2,2120440
lacIp,3.0,2,0,GTTCATAACCCGCAGTTTGC,2,2098500
lacIp,3.0,2,0,GTTATGCTTGTCTAAGGCAT,2,2095625
lacIp,3.0,2,0,GTTATCCTCCGAGCACTTCG,2,2093205
lacIp,3.0,2,0,GTTAGGATAGCGAGCGACGA,2,2119002
lacIp,3.0,2,0,GTTACCCAGCAGACTTGGTT,2,2092225
lacIp,3.0,2,0,GTGTGCGACGGGACTAGCAA,2,2120679
lacIp,3.0,2,0,GTGGCCCCACCAATGTACAA,2,2114543
lacIp,3.0,2,0,GTCTGAGTCAGGGATCAAAA,2,2093793
lacIp,3.0,2,0,GTCCCTTTGTATGCTTACCG,2,2107739
lacIp,3.0,2,0,GTCAGTTAGAGCACAAGCCG,2,2104825
lacIp,3.0,2,0,GTCACACGAAAGACATTTTT,2,2096991
lacIp,3.0,2,0,GTCAATCACTCAAAGAAGAG,2,2096357
lacIp,3.0,2,0,GTCAAGCAGGACACCTTTAT,2,2090091
lacIp,3.0,2,0,GTATTTGATTTTGTGTGGAC,2,2109538
lacIp,3.0,2,0,GTATCTCGAGATAACTGACT,2,2102017
lacIp,3.0,2,0,GTAGCTTTCAAACTCCCTCT,2,2105741
lacIp,3.0,2,0,GTAGCTCCAGTTCGAGAAGA,2,2086434
lacIp,3.0,2,0,GGTTCTTTAGCCGTTCTCCT,2,2113277
lacIp,3.0,2,0,GGTGTTCAGGGACAAGCGTG,2,2109177
lacIp,3.0,2,0,GGTGAGCAAGGTTCGAGAGA,2,2106221
lacIp,3.0,2,0,GGTATCCGCTTGCCCTGGGA,2,2092497
lacIp,3.0,2,0,GGGTGTTATGGCAAAGAGTC,2,2100727
lacIp,3.0,2,0,GGGTGGGTCGCGTCGATACT,2,2098007
lacIp,3.0,2,0,GGGGTTGGATTTAGGAGAGT,2,2111164
lacIp,3.0,2,0,GGGGTGGAGGCCAAGTTTAG,2,2090413
lacIp,3.0,2,0,GGGGTCCAAGTAGGGAGTTT,2,2103888
lacIp,3.0,2,0,GGGCATCCGGTTTGTCATAA,2,2094143
lacIp,3.0,2,0,GGGCAGTCAAGATGGGAGTC,2,2099880
lacIp,3.0,2,0,GGGACCAAGGTTCTCCGTAC,2,2120330
lacIp,3.0,2,0,GGGAAACGCGCCAGCGGGAT,2,2115177
lacIp,3.0,2,0,GGGAAACCTCACTTTGACGA,2,2092953
lacIp,3.0,2,0,GGCTAAATCCTCCGGGGTTT,2,2119911
lacIp,3.0,2,0,GGCGTTTTGCGCCGAATCCT,2,2106761
lacIp,3.0,2,0,GGCCGTAGCGTCGTAAGAAC,2,2090213
lacIp,3.0,2,0,GGCATGACAAAGGCGGGCCA,2,2087344
lacIp,3.0,2,0,GGATTTGTTGAAGACAGTAC,2,2113031
lacIp,3.0,2,0,GGATTCGGGTGGGGACGTTG,2,2086243
lacIp,3.0,2,0,GGATTCCCTACCACACGAGT,2,2085795
lacIp,3.0,2,0,GGATCCGAAATTGCACATAA,2,2088900
lacIp,3.0,2,0,GGAGTAAGAGTCATGCTGAC,2,2117354
lacIp,3.0,2,0,GGACTTTGAGGGATTTAGTG,2,2115317
lacIp,3.0,2,0,GCTTTCGGGGGGGGGAGCTC,2,2110130
lacIp,3.0,2,0,GCGTGGGATGGTAATGAGTA,2,2098743
lacIp,3.0,2,0,GCGTACTTCGGTCGTAAAGT,2,2102700
lacIp,3.0,2,0,GCGGTGGCGGTTACCAAGGA,2,2106406
lacIp,3.0,2,0,GCGGGAGCACCGGGATTCTT,2,2103677
lacIp,3.0,2,0,GCGGACATTAGATAGGTTTC,2,2116655
lacIp,3.0,2,0,GCGAAGCGTTAGGCGTAGTA,2,2119727
lacIp,3.0,2,0,GCCTTGTGCCCCAGCAACCA,2,2102554
lacIp,3.0,2,0,GCCTTAACATAAACCATGAT,2,2092757
lacIp,3.0,2,0,GCCTGGGATATAGTGGACAG,2,2100581
lacIp,3.0,2,0,GCCGTTTAATGTCTGAGATA,2,2119144
lacIp,3.0,2,0,GCCGTAAAAGGGATTGAATA,2,2094928
lacIp,3.0,2,0,GCCGATCCATTCAAAGCCCT,2,2096511
lacIp,3.0,2,0,GCCCTACTGAGCGCCTACGT,2,2109136
lacIp,3.0,2,0,GCCCCGCGAACAGCGCTTGC,2,2087276
lacIp,3.0,2,0,GCCATCACGCTTCAGGCATT,2,2087139
lacIp,3.0,2,0,GCAGTTAGGCTGGCTGAGCG,2,2102031
lacIp,3.0,2,0,GCACTGAGACTCCCCCAAGG,2,2096658
lacIp,3.0,2,0,GCACTACGGCAACGCCCGTT,2,2115574
lacIp,3.0,2,0,GCACGCATTGTTGATTGTCT,2,2091520
lacIp,3.0,2,0,GCAAGTTAATAGCCAATTTC,2,2094003
lacIp,3.0,2,0,GATCCGTATACGTGTCCGCA,2,2099395
lacIp,3.0,2,0,GATAAGGCGTTCATCTTCAT,2,2088497
lacIp,3.0,2,0,GAGGAGGCGCGAGTCCTGTG,2,2110642
lacIp,3.0,2,0,GAGATCATCCGAGGGGATCA,2,2098745
lacIp,3.0,2,0,GACTTGTAGAGCTTCATGAC,2,2111052
lacIp,3.0,2,0,GACTGGCATGTCTTCCTCTA,2,2111195
lacIp,3.0,2,0,GACGTGATAGATCTTAAAAT,2,2113938
lacIp,3.0,2,0,GACCAGGCGTACTGCGAAAT,2,2092409
lacIp,3.0,2,0,GAACTCCGAAGGTTTTGCGT,2,2097597
lacIp,3.0,2,0,GAACGCAGGATATTTTACAG,2,2086184
lacIp,3.0,2,0,CTTGGTTTGCCTTTGATAGT,2,2104502
lacIp,3.0,2,0,CTTGGTATTGCGCAGCGCGA,2,2095259
lacIp,3.0,2,0,CTTATGGTCTCTTGTTCTAT,2,2116259
lacIp,3.0,2,0,CTTAGAATTGGTATTCTAAA,2,2105970
lacIp,3.0,2,0,CTTAACTATTAGATTGCGCT,2,2120951
lacIp,3.0,2,0,CTGGTTTTCCTTCTTTTAAA,2,2112364
lacIp,3.0,2,0,CTGGTGTACAGTTATTCCCA,2,2098204
lacIp,3.0,2,0,CTGATAAATCTACTTACGAA,2,2085820
lacIp,3.0,2,0,CTCTTGTTGTCAGTCATGAT,2,2102144
lacIp,3.0,2,0,CTCGTGCTTCAAACGGGCAT,2,2112525
lacIp,3.0,2,0,CTCCTTGAGAGACCGTGACG,2,2093629
lacIp,3.0,2,0,CTCCGCTAGGTTAATCGCGT,2,2093875
lacIp,3.0,2,0,CTATGCTTTGTCCTAAATTA,2,2100795
lacIp,3.0,2,0,CTAAATGACGACTTTCTGAC,2,2100388
lacIp,3.0,2,0,CTAAAACAGCGTCCCCGGGG,2,2117803
lacIp,3.0,2,0,CGTTCCGAAATATTCTTTTC,2,2115853
lacIp,3.0,2,0,CGTGAAACATGAAACGAAAA,2,2086426
lacIp,3.0,2,0,CGTAGAGACTGATAGACGAT,2,2103487
lacIp,3.0,2,0,CGTAGACCGGGGAACGTCAG,2,2086265
lacIp,3.0,2,0,CGGTTCCCACTCAAAATGTA,2,2106940
lacIp,3.0,2,0,CGGTCTCCATGGTTGCACGA,2,2101517
lacIp,3.0,2,0,CGGGTAAATTCGTAGTTGCT,2,2086261
lacIp,3.0,2,0,CGGGAAATAAATGTCCAGGT,2,2091050
lacIp,3.0,2,0,CGGCTGGCCGACGCATTGTA,2,2119655
lacIp,3.0,2,0,CGGAAGGAGACGCTCGCCTT,2,2086649
lacIp,3.0,2,0,CGCGACCTGTGTACTTGATT,2,2113326
lacIp,3.0,2,0,CGCCCATTCCTACACGCAGC,2,2121179
lacIp,3.0,2,0,CGCATCATAGGCGGGGATTG,2,2098315
lacIp,3.0,2,0,CGATTTCAGGTCTGCCGCTA,2,2096623
lacIp,3.0,2,0,CGAGCTGACTATTTTCCTGA,2,2100798
lacIp,3.0,2,0,CGAGCATTTGGGAGGATCAA,2,2106642
lacIp,3.0,2,0,CGACTGCAGTTAAACAAACG,2,2103153
lacIp,3.0,2,0,CGAACACACGCATTCTGCTT,2,2118143
lacIp,3.0,2,0,CCTTCGCGCGTTCCGGGAAT,2,2092708
lacIp,3.0,2,0,CCTGGTCCACAAGGTTTGTG,2,2091203
lacIp,3.0,2,0,CCTCCCCCTTCCTACACGAT,2,2099998
lacIp,3.0,2,0,CCTACGGCATTACCAGCTAA,2,2101173
lacIp,3.0,2,0,CCGTGTTATCTGCAACCCCG,2,2111250
lacIp,3.0,2,0,CCGTCCTCACGGTACCATTA,2,2105940
lacIp,3.0,2,0,CCGGGCTCCGTATCAACCAG,2,2110373
lacIp,3.0,2,0,CCGGGAATGTACGTCAGATT,2,2117422
lacIp,3.0,2,0,CCGCGTCCTGTCGCACGAGA,2,2108260
lacIp,3.0,2,0,CCGCGGCTTAAGCTAGCTGT,2,2113729
lacIp,3.0,2,0,CCGCGGCTCAAGGAACGAAA,2,2097793
lacIp,3.0,2,0,CCGCCACCAAGCGAGACAAG,2,2097353
lacIp,3.0,2,0,CCGATGTCGTTTCGCTTCGT,2,2114043
lacIp,3.0,2,0,CCGAGCTATCTTTCCACTAA,2,2118138
lacIp,3.0,2,0,CCGAGACCCAATGACAGTTC,2,2095770
lacIp,3.0,2,0,CCGACACGTGGTTAACCTAT,2,2103034
lacIp,3.0,2,0,CCGAACGACCCCTATAGAGT,2,2112849
lacIp,3.0,2,0,CCCTCCGTGGGTAATATCAT,2,2100148
lacIp,3.0,2,0,CCCGCTTGTGAAAATACAGG,2,2100594
lacIp,3.0,2,0,CCCAACATCTTAGGGTCTAA,2,2116965
lacIp,3.0,2,0,CCATATTCAGAACCGCCAAT,2,2121423
lacIp,3.0,2,0,CCAGTCTTCTTTGACCGATC,2,2090743
lacIp,3.0,2,0,CCAGTCACGGTGGTTTCAGA,2,2097871
lacIp,3.0,2,0,CCAGACCTTGTTGACCGAGC,2,2114200
lacIp,3.0,2,0,CCACTCAGAAACAGAGCAGA,2,2111649
lacIp,3.0,2,0,CCAATGATCTCTTAAGCCGT,2,2095953
lacIp,3.0,2,0,CATTGTTCGGTGTATGAGCA,2,2101178
lacIp,3.0,2,0,CATTGTGAACACCGGCACGA,2,2088437
lacIp,3.0,2,0,CATTGGTTACGGTAACTCTC,2,2091097
lacIp,3.0,2,0,CATTGCATGTGTCGGTAGAT,2,2109315
lacIp,3.0,2,0,CATGCAGCCTTCAGCTGCTG,2,2088297
lacIp,3.0,2,0,CATCATACGATCATGATCCA,2,2106850
lacIp,3.0,2,0,CATCAGTGGACTCCCAATTT,2,2106904
lacIp,3.0,2,0,CATACCGGTTACCGCTGGGA,2,2089924
lacIp,3.0,2,0,CAGTGTCTGCGGCCCACTTT,2,2114280
lacIp,3.0,2,0,CAGTACATTGTCTTCGGAAG,2,2098717
lacIp,3.0,2,0,CAGGTATCGCCCTGTAATGT,2,2090740
lacIp,3.0,2,0,CAGGGCCGCGAAATGACGGA,2,2089382
lacIp,3.0,2,0,CAGGCACCGATTTGAGTGGA,2,2099162
lacIp,3.0,2,0,CAGCCGTTGGTTTAGTACCC,2,2107812
lacIp,3.0,2,0,CACTTCCATAAGTTAGAGAT,2,2100539
lacIp,3.0,2,0,CACTACAAGGGGATGTACTG,2,2091332
lacIp,3.0,2,0,CACGTAAATCTACTCCAGTT,2,2100962
lacIp,3.0,2,0,CACGGTGGGAGTGTCATGGG,2,2091996
lacIp,3.0,2,0,CACGCCGCGACACAGCCAGC,2,2108033
lacIp,3.0,2,0,CACCGTATAGTGGTCTCACC,2,2100523
lacIp,3.0,2,0,CAATGGGTTGGGAACGCGGC,2,2099153
lacIp,3.0,2,0,CAAGAGGACTAATTAACCTA,2,2119245
lacIp,3.0,2,0,CAACTCCCGATGACCAGCGC,2,2111132
lacIp,3.0,2,0,CAAAGACGGTATGATCCCGT,2,2106456
lacIp,3.0,2,0,CAAACCATAATTTTCCTGAA,2,2099542
lacIp,3.0,2,0,ATTTGGGGCGTGCCCTCGCC,2,2104884
lacIp,3.0,2,0,ATTAGTAATGAGAAAGACAC,2,2105103
lacIp,3.0,2,0,ATTAGGTTATGTATCCAGCT,2,2097588
lacIp,3.0,2,0,ATTAAGCTCTGAGGAACACG,2,2106965
lacIp,3.0,2,0,ATGCCAGTTACTGTTGCGGC,2,2106388
lacIp,3.0,2,0,ATGAGTCGGGGAGGCGACGG,2,2092680
lacIp,3.0,2,0,ATGACTGGCGCGTAGTGTTT,2,2106399
lacIp,3.0,2,0,ATGAATAGCGCTAATGGCAG,2,2112945
lacIp,3.0,2,0,ATCTTGCCTGTGGGTGTGTA,2,2086144
lacIp,3.0,2,0,ATCTGAGGTCTTAATGACCA,2,2087718
lacIp,3.0,2,0,ATCCGTTTCTTCACTTATAT,2,2089161
lacIp,3.0,2,0,ATCCGTAGGGTGTGGGGATA,2,2099572
lacIp,3.0,2,0,ATCCGCGAAGGTTCGGGGGT,2,2114097
lacIp,3.0,2,0,ATCACAAAACTTAGCCGTGT,2,2095240
lacIp,3.0,2,0,ATATCCCCTCGGACCTGGTA,2,2117434
lacIp,3.0,2,0,ATACCGCAAGATGGGATGCA,2,2122203
lacIp,3.0,2,0,AGTGTCCTAGGTGTGTTAAG,2,2119899
lacIp,3.0,2,0,AGTGAGAGCTGTGTTCCGCA,2,2101550
lacIp,3.0,2,0,AGTCTCCCTTGGGAGCCTAG,2,2107390
lacIp,3.0,2,0,AGTCCGATGATTTCTATATG,2,2093932
lacIp,3.0,2,0,AGTCAACATCAATAAATAAT,2,2111500
lacIp,3.0,2,0,AGGTTTCCAGGAGCACCCCC,2,2110922
lacIp,3.0,2,0,AGGTCCCTCGTCTACCAACC,2,2096579
lacIp,3.0,2,0,AGGTACTGTAGAGGGAGAAC,2,2116347
lacIp,3.0,2,0,AGGGGTCTTTCTACTAAAAT,2,2111960
lacIp,3.0,2,0,AGGGGAGGCCGGGAGAGGGT,2,2093946
lacIp,3.0,2,0,AGGGCTGACTCTCCGACCAC,2,2110081
lacIp,3.0,2,0,AGGGAACCAGTCGCTTTGGT,2,2087412
lacIp,3.0,2,0,AGGCACAGACTCCAGCTGCC,2,2095745
lacIp,3.0,2,0,AGCTCACCCACCGGACTGTG,2,2087563
lacIp,3.0,2,0,AGCTAACTCCTCGACCGGGA,2,2093939
lacIp,3.0,2,0,AGCGTGTTTGCTACAGAAAG,2,2088320
lacIp,3.0,2,0,AGCGGGGAGGTAAGGGTCAC,2,2119286
lacIp,3.0,2,0,AGCGCACTGAACGGCGAACT,2,2105375
lacIp,3.0,2,0,AGCATCATGGGACCAAAGAC,2,2089256
lacIp,3.0,2,0,AGATGCACGCGGTCCACGTA,2,2092589
lacIp,3.0,2,0,AGATCGCCCACCATCCTTGT,2,2099366
lacIp,3.0,2,0,AGAATGACACCGCGATGCCC,2,2104686
lacIp,3.0,2,0,AGAAATTGGCATCATTCAGG,2,2086726
lacIp,3.0,2,0,ACTTGCTTGTACGTGCACAA,2,2112914
lacIp,3.0,2,0,ACTTAAGATGAGTCGTGACC,2,2102832
lacIp,3.0,2,0,ACTAGAATGATTTGTGCTGA,2,2099071
lacIp,3.0,2,0,ACTAGAATCCCGAATCATCA,2,2093174
lacIp,3.0,2,0,ACGTTCACACCTGGAATCAG,2,2104372
lacIp,3.0,2,0,ACGTCAATTTGGGAGTCTAT,2,2118962
lacIp,3.0,2,0,ACGAAATCTCGGCTCCCCCA,2,2101580
lacIp,3.0,2,0,ACCCTCGGATTCTCAATCTT,2,2089503
lacIp,3.0,2,0,ACCCCCTTTTGTCCCACTAA,2,2105599
lacIp,3.0,2,0,ACATTGTTAGCGGAGGCGTC,2,2111770
lacIp,3.0,2,0,ACACAGTTTGGGATCTCCAG,2,2093665
lacIp,3.0,2,0,ACACACGCACGTAATGCCCT,2,2107290
lacIp,3.0,2,0,AATTGCTTTTTGCTCTTGCG,2,2087067
lacIp,3.0,2,0,AATGGGGCGATTATTGAGAT,2,2104944
lacIp,3.0,2,0,AATGGAAACACACATCACTG,2,2087739
lacIp,3.0,2,0,AATCCGTTAGTCGGTGAAGC,2,2093786
lacIp,3.0,2,0,AATCAAGAGTTATACAGGGT,2,2100971
lacIp,3.0,2,0,AATATTGATATCAATGCAAA,2,2104592
lacIp,3.0,2,0,AAGTGCTGACCAGAACGATA,2,2121280
lacIp,3.0,2,0,AAGTCGCTCAATATGAGTAA,2,2095631
lacIp,3.0,2,0,AAGGCGTGAGCGTGCATGGA,2,2109759
lacIp,3.0,2,0,AAGACTGGTAGCGGTGTGAG,2,2102145
lacIp,3.0,2,0,AAGAAGTAGGTGAGTGGCGT,2,2111337
lacIp,3.0,2,0,AAGAACCGGCATTAACTGTC,2,2108282
lacIp,3.0,2,0,AACCTTTGCATTTCGGCAGT,2,2098479
lacIp,3.0,2,0,AACCGTTTGTTAAGTGTGGA,2,2119019
lacIp,3.0,2,0,AACCCGACCTGTTGATCAAC,2,2121621
lacIp,3.0,2,0,AAATTCATTGGAAACATGTT,2,2109095
lacIp,3.0,2,0,AAATAGGTGCAGACTGACCA,2,2120431
lacIp,3.0,2,0,AAAGTGCGAGATTTCTCTTG,2,2101138
lacIp,3.0,2,0,AAACGAGTGGCCTCCGTGAG,2,2088044
lacIp,3.0,2,0,AAACCCAACGCGTGGTATGG,2,2104909
lacIp,2.0,1,0,TTTTAGCTATCTTCCTCACG,1,2119539
lacIp,2.0,1,0,TTTTACGTGGGCGACACCTC,1,2099533
lacIp,2.0,1,0,TTTGCTACTCGCAACTGACA,1,2109170
lacIp,2.0,1,0,TTTGCACTACCTACCTTTCA,1,2089732
lacIp,2.0,1,0,TTTCCACATAACATCCTGGA,1,2101518
lacIp,2.0,1,0,TTTATGTCTTGAGCCAAGTC,1,2092980
lacIp,2.0,1,0,TTTAGTGCGATGCGCTGCCT,1,2106294
lacIp,2.0,1,0,TTTACCTTTCCTTGCACTGT,1,2116057
lacIp,2.0,1,0,TTGTGTCTGCAAGTTCTCAC,1,2112740
lacIp,2.0,1,0,TTGTGGGCCTTGAAGAACAC,1,2111843
lacIp,2.0,1,0,TTGTCTGTTACGAGAGCCGG,1,2088053
lacIp,2.0,1,0,TTGTCTATTTCCAGACCGCA,1,2089305
lacIp,2.0,1,0,TTGTACGAACCCATGACACA,1,2111942
lacIp,2.0,1,0,TTGGTATTATTGCCATCTCC,1,2106547
lacIp,2.0,1,0,TTGGGTTCCTAGTGGGGACG,1,2117615
lacIp,2.0,1,0,TTGGGTGTGACAGCACTGGT,1,2093071
lacIp,2.0,1,0,TTGGGCTGGGTTTCGTAGGA,1,2095379
lacIp,2.0,1,0,TTGGCACGAATAGTGCCCAA,1,2112625
lacIp,2.0,1,0,TTGCTAACTATTGTGCATTA,1,2095565
lacIp,2.0,1,0,TTGAGGAATTGAGCTCCGCG,1,2099090
lacIp,2.0,1,0,TTCTTGCGGAGCTTGCGTTA,1,2107830
lacIp,2.0,1,0,TTCTATTGTAGTGTATAACC,1,2122067
lacIp,2.0,1,0,TTCGTTGGCCGTTTGTTGAA,1,2089813
lacIp,2.0,1,0,TTCGTCCACGGGCATATAAT,1,2110241
lacIp,2.0,1,0,TTCGCCTTGCTCGCTCATAT,1,2119449
lacIp,2.0,1,0,TTCGCCGGTAACACTGTGAT,1,2119994
lacIp,2.0,1,0,TTCGATGAGTCTGAGGCGCT,1,2089718
lacIp,2.0,1,0,TTCCGGAAGAGTAATCACCT,1,2091916
lacIp,2.0,1,0,TTCAGTTTACAGAGGCAATA,1,2121428
lacIp,2.0,1,0,TTCAGGCTACAGACTCGTGT,1,2098150
lacIp,2.0,1,0,TTCAAATGCTCCATAGCTAT,1,2096603
lacIp,2.0,1,0,TTATGAACAGTATTGCGTTC,1,2107964
lacIp,2.0,1,0,TTATCTCTACCTTTCAAGCG,1,2118132
lacIp,2.0,1,0,TTATCAGACATATTTCGAAT,1,2093235
lacIp,2.0,1,0,TTATCAACATGTTTTATTGC,1,2097078
lacIp,2.0,1,0,TTAGTCTGGCGTGATAACGA,1,2095356
lacIp,2.0,1,0,TTAGGCCCACTCTTTGGCCA,1,2119350
lacIp,2.0,1,0,TTAGAAATTCGAGGTTGTCC,1,2104329
lacIp,2.0,1,0,TTACTGAGGCTTCACCGCAT,1,2099217
lacIp,2.0,1,0,TTACTCGCTACATCATCGAG,1,2087706
lacIp,2.0,1,0,TTACTAATTACCTGCCAGGA,1,2107628
lacIp,2.0,1,0,TTACCACTGCAGGGCAAGAT,1,2086967
lacIp,2.0,1,0,TTACATTTAACAGTGGTACA,1,2088336
lacIp,2.0,1,0,TTAAAGTTCACCAAGCTGGA,1,2112081
lacIp,2.0,1,0,TTAAAAGCCCTCACCCTTCT,1,2109008
lacIp,2.0,1,0,TGTTTTCCTGCCAACAACTT,1,2112954
lacIp,2.0,1,0,TGTTTCTCCAAGCTCGTTCT,1,2103923
lacIp,2.0,1,0,TGTTCTTAATTTATATTCCA,1,2088913
lacIp,2.0,1,0,TGTTATCAGAGAAATGAGAT,1,2121516
lacIp,2.0,1,0,TGTGTTACTTAGCGATGTTA,1,2091085
lacIp,2.0,1,0,TGTGTGTACATGCACTGTGT,1,2121290
lacIp,2.0,1,0,TGTGTGAAGTTGAGGAATTT,1,2098980
lacIp,2.0,1,0,TGTGGATCCCCGAGGGCTCT,1,2116890
lacIp,2.0,1,0,TGTAGATACGTCTGTTTCGT,1,2099408
lacIp,2.0,1,0,TGTACACGTAGCAACAGGAC,1,2088690
lacIp,2.0,1,0,TGGTTTCAAGTTGTGTGCTT,1,2110558
lacIp,2.0,1,0,TGGTTGTGGTGCCTACTGTT,1,2110800
lacIp,2.0,1,0,TGGTGCCTCGGATTATGTTT,1,2120541
lacIp,2.0,1,0,TGGGGCCATGCTAATCATAG,1,2095981
lacIp,2.0,1,0,TGGGCTTCCAATGTAAATTA,1,2109482
lacIp,2.0,1,0,TGGGACTTAGGATGTTAAAC,1,2112181
lacIp,2.0,1,0,TGGCCTCTGGAAGCTTGAAG,1,2089426
lacIp,2.0,1,0,TGGCCCCTTCCGTCATATGT,1,2086512
lacIp,2.0,1,0,TGGCATCATTCATCGGTTCG,1,2117049
lacIp,2.0,1,0,TGCTGCAAAGGGAATGTTCC,1,2089056
lacIp,2.0,1,0,TGCTGATCGGCCCACGCTGA,1,2098208
lacIp,2.0,1,0,TGCTCCAACAATGTTTAAGC,1,2101934
lacIp,2.0,1,0,TGCGTACCTGGCATCAGAGG,1,2121062
lacIp,2.0,1,0,TGCGATGGCTGGCGTCTCTT,1,2103495
lacIp,2.0,1,0,TGCCACATTGCTATGACGCT,1,2107759
lacIp,2.0,1,0,TGCATATAGCGACGACCTAG,1,2086671
lacIp,2.0,1,0,TGCATAGGTATCATGAGCTA,1,2117596
lacIp,2.0,1,0,TGCATAATAAATGTGCGGTA,1,2093896
lacIp,2.0,1,0,TGCAATCCGGAGCTTTCCGG,1,2116280
lacIp,2.0,1,0,TGAGTACGGTCAAGAATGAC,1,2107480
lacIp,2.0,1,0,TGAGGCACCGCGGTCACCTT,1,2107056
lacIp,2.0,1,0,TGACTCAGTGCGCACGACTA,1,2106088
lacIp,2.0,1,0,TGACTAAACTTGCTCGATTA,1,2096380
lacIp,2.0,1,0,TGACAGTTCTCCCCCGGTCG,1,2115896
lacIp,2.0,1,0,TGAAGCTCGATATGTACCTC,1,2122401
lacIp,2.0,1,0,TGAAGAGATGATAGGGTGAG,1,2086654
lacIp,2.0,1,0,TGAAAAGTAAACGTTTATCT,1,2115097
lacIp,2.0,1,0,TCTTTGCCCTCAGAGCCGTG,1,2085700
lacIp,2.0,1,0,TCTTGCGGGCAGTCCACATA,1,2115852
lacIp,2.0,1,0,TCTTGAGCTTTGTCAGCTCA,1,2099989
lacIp,2.0,1,0,TCTTACCGCTACGGACCATC,1,2107433
lacIp,2.0,1,0,TCTGGCGCGCATTAAGTTGC,1,2090887
lacIp,2.0,1,0,TCTCTAGAAATCATATTACA,1,2103021
lacIp,2.0,1,0,TCTCCCTTACTTATCACACA,1,2087820
lacIp,2.0,1,0,TCTCCCGAGCGGCACCCAAT,1,2113945
lacIp,2.0,1,0,TCTCCACCTTTCTGGGACCT,1,2107941
lacIp,2.0,1,0,TCTAGTGCACGGGCTGACAC,1,2089285
lacIp,2.0,1,0,TCTAGTCCGGGGGGACTTTC,1,2118348
lacIp,2.0,1,0,TCTACATTCCCACGCGTGAT,1,2092175
lacIp,2.0,1,0,TCGTTGTAACTACTGTGACA,1,2099561
lacIp,2.0,1,0,TCGTGTTAAACGTGAATGCA,1,2121710
lacIp,2.0,1,0,TCGTGTGATTAAATAAGTTT,1,2093776
lacIp,2.0,1,0,TCGTGAGTAAAATGGAGCGA,1,2090664
lacIp,2.0,1,0,TCGTCTAGATTATGTCACTA,1,2114038
lacIp,2.0,1,0,TCGTCCATCGTCCAATCGGA,1,2092277
lacIp,2.0,1,0,TCGTCAGAATACCTCAACAG,1,2090985
lacIp,2.0,1,0,TCGGGTCCCCCCGCCATGCG,1,2115705
lacIp,2.0,1,0,TCGGCATCACCACATCTTCG,1,2114503
lacIp,2.0,1,0,TCGCGGTAAACTTCACATAC,1,2090772
lacIp,2.0,1,0,TCGCGGCATATTCGGGTTTA,1,2099043
lacIp,2.0,1,0,TCGCCTCTGAAGCGTGTTGC,1,2112114
lacIp,2.0,1,0,TCGCCGTTTTAAGGTTGCCT,1,2110375
lacIp,2.0,1,0,TCGCATAAATAATCCGGTGG,1,2104499
lacIp,2.0,1,0,TCGATATGACCTAATGTCCT,1,2090737
lacIp,2.0,1,0,TCGAGCCATAGAGTCCTTCC,1,2094113
lacIp,2.0,1,0,TCGACGTCCCGCACGTGTAC,1,2098463
lacIp,2.0,1,0,TCGACCCCGGTTCAAGTAAT,1,2095651
lacIp,2.0,1,0,TCCTGACGGCGTCTGCTAAG,1,2089557
lacIp,2.0,1,0,TCCTATACTTGGTTCCTTGG,1,2112588
lacIp,2.0,1,0,TCCTAGTCTCCCTTTTTCCA,1,2120872
lacIp,2.0,1,0,TCCTAGCTTTTGAACGGTTC,1,2118404
lacIp,2.0,1,0,TCCGCTTGGCGTGTCCGAGG,1,2119028
lacIp,2.0,1,0,TCCGCCAGCACTCGGATCTA,1,2090915
lacIp,2.0,1,0,TCCGAGCCTCCGGACTCTGA,1,2120662
lacIp,2.0,1,0,TCCCGATGGTGGTGCACGTA,1,2108678
lacIp,2.0,1,0,TCCATAAAAGTGTTACGTCT,1,2115949
lacIp,2.0,1,0,TCCAGTTGCCTCGCGAACCC,1,2117674
lacIp,2.0,1,0,TCCAAAGTCTTACCATCGTA,1,2105534
lacIp,2.0,1,0,TCCAAAGGACTCACGGGTAC,1,2120626
lacIp,2.0,1,0,TCATTCTTTGAGGCGTGCGA,1,2104937
lacIp,2.0,1,0,TCATGTCGGCGGGCACGAGC,1,2094940
lacIp,2.0,1,0,TCATCGACCGGCACGCTCTC,1,2095992
lacIp,2.0,1,0,TCAGTCAAACAGTTAGAAGG,1,2092889
lacIp,2.0,1,0,TCAGACCATGTTTCCTAAGA,1,2107187
lacIp,2.0,1,0,TCAGAAGGCTACGTGGGACA,1,2093326
lacIp,2.0,1,0,TCACGACCAGGCATCGAAAT,1,2095132
lacIp,2.0,1,0,TCACCTTCCGCGTTCCTCCT,1,2096202
lacIp,2.0,1,0,TCACCGAGTAATAGGAAGAA,1,2119609
lacIp,2.0,1,0,TATTTTGTATACCGCGCTGG,1,2117734
lacIp,2.0,1,0,TATTTCACTCTGGAAATCCT,1,2115341
lacIp,2.0,1,0,TATGTTCGTAGACCGTAACT,1,2103188
lacIp,2.0,1,0,TATGAAATGGTTGCATTTTG,1,2091028
lacIp,2.0,1,0,TATCGTGCTGGTCAAAGTGG,1,2115882
lacIp,2.0,1,0,TATCCCCCTCGTAATACCTT,1,2092024
lacIp,2.0,1,0,TATCCACTGTTAATATGCGC,1,2108968
lacIp,2.0,1,0,TATAGTGGAGGGGGTCGAGC,1,2085956
lacIp,2.0,1,0,TATAATACGCTTCAAGCGTC,1,2095222
lacIp,2.0,1,0,TAGGGCAGCGGTACGCCCGC,1,2088395
lacIp,2.0,1,0,TAGGACCTATACAACCGTAA,1,2085798
lacIp,2.0,1,0,TAGCTGACTTACCGCCGTCA,1,2094414
lacIp,2.0,1,0,TAGCGGGAAGGGTAGGCCCA,1,2110502
lacIp,2.0,1,0,TAGCCTTAAGGGAGTTTCGC,1,2098247
lacIp,2.0,1,0,TAGCCCCTGGTGAAGGACTC,1,2100794
lacIp,2.0,1,0,TAGCCAAATATTCAGAACAC,1,2107327
lacIp,2.0,1,0,TAGCACGTAGCGGAGCCTTC,1,2096779
lacIp,2.0,1,0,TAGCACGGATTCGGTGACAC,1,2109114
lacIp,2.0,1,0,TAGAGGCTGGGGGATTTGTC,1,2113817
lacIp,2.0,1,0,TAGAGCTGACGGATAGTTAT,1,2112085
lacIp,2.0,1,0,TAGAAGGGCTGATTGTAATA,1,2103056
lacIp,2.0,1,0,TACTTTAAGCGAACTCGTAT,1,2093686
lacIp,2.0,1,0,TACTGACGCCTTATCATATT,1,2099418
lacIp,2.0,1,0,TACGTGACTAACAGACACGC,1,2098178
lacIp,2.0,1,0,TACGTGAAGTGAATTTTGGC,1,2096697
lacIp,2.0,1,0,TACGTAGCGTACGCCAGGGC,1,2087670
lacIp,2.0,1,0,TACGACCGGTGCACTATCGA,1,2100963
lacIp,2.0,1,0,TACCGGCAAGCTGTGTGTAT,1,2114799
lacIp,2.0,1,0,TACCGATGTAGTTGATTTCA,1,2093729
lacIp,2.0,1,0,TACACTCCCGACCGAGCCGA,1,2093082
lacIp,2.0,1,0,TACACCTCGATGCATGGTTC,1,2114141
lacIp,2.0,1,0,TACAAACTTCTACCAATAGA,1,2106496
lacIp,2.0,1,0,TAATTTTACTAGGGGTACTA,1,2095308
lacIp,2.0,1,0,TAATTGTGTATCCTCCCTTT,1,2095484
lacIp,2.0,1,0,TAATGACATCAACGTCCTCC,1,2092550
lacIp,2.0,1,0,TAATCGTTCAATGCTATTAG,1,2093680
lacIp,2.0,1,0,TAATAGCCCTTGTGGCCTAC,1,2099776
lacIp,2.0,1,0,TAATACATCTGTAACCAGAG,1,2102974
lacIp,2.0,1,0,TAAGCGTCTATTAGACGGCA,1,2093740
lacIp,2.0,1,0,TAAGCGTCGTTCATAGCAGA,1,2105844
lacIp,2.0,1,0,TAAGCGGTAATTTCCAATGT,1,2095067
lacIp,2.0,1,0,TAACCGAGGGCACGATATTA,1,2121363
lacIp,2.0,1,0,TAACATAAACCGTACGAGGG,1,2102050
lacIp,2.0,1,0,TAAATCCGCCTCTGGGCGGC,1,2095668
lacIp,2.0,1,0,TAAAGTTATTATACGAGATT,1,2111944
lacIp,2.0,1,0,TAAAGTACCCCGGTGGATTG,1,2109653
lacIp,2.0,1,0,TAAAGGATAGTACTCAGAAA,1,2086381
lacIp,2.0,1,0,GTTTCGCGGCTGCTCCCTTT,1,2097720
lacIp,2.0,1,0,GTTGCTGCGGTTTTCTCTTT,1,2121424
lacIp,2.0,1,0,GTTGATAGGCGGACGGTTCT,1,2114240
lacIp,2.0,1,0,GTTGAATTTAACGTATGGGG,1,2102966
lacIp,2.0,1,0,GTTACGCATGTCAGGGCATG,1,2094399
lacIp,2.0,1,0,GTGTTGGGCAGAACGGGGTA,1,2117519
lacIp,2.0,1,0,GTGTTCCGGAGCCCGCAGCG,1,2100670
lacIp,2.0,1,0,GTGTGGAGTTATTATGGTCC,1,2091340
lacIp,2.0,1,0,GTGTGCTGGGTACAAGCAAT,1,2103161
lacIp,2.0,1,0,GTGTCAGGCTGACGTGATAT,1,2111334
lacIp,2.0,1,0,GTGTACGCGGATTCGGCCAT,1,2093116
lacIp,2.0,1,0,GTGTAACACATCTTCCGTTC,1,2100221
lacIp,2.0,1,0,GTGGTGGAATAGTTTTGCGA,1,2101641
lacIp,2.0,1,0,GTGGTCGATTCGACTCAGTC,1,2093876
lacIp,2.0,1,0,GTGGCAGGATGCATGGACCA,1,2100193
lacIp,2.0,1,0,GTGGAGCGTATCGCAATCAA,1,2107561
lacIp,2.0,1,0,GTGCTGATGGGTGAATCCGG,1,2097964
lacIp,2.0,1,0,GTGCCCAAACCGGCAAAGCA,1,2088349
lacIp,2.0,1,0,GTGATCTCATAGGTATGGGA,1,2097112
lacIp,2.0,1,0,GTGATCGAGCCAGAGTTGTT,1,2113180
lacIp,2.0,1,0,GTCTTTCCGGGGCTAGCGCG,1,2091086
lacIp,2.0,1,0,GTCTGGTTCTATATAGGAAT,1,2094424
lacIp,2.0,1,0,GTCGGTTCGGACTGCAGGGG,1,2099447
lacIp,2.0,1,0,GTCGCATCCCTACTTTCTCA,1,2090391
lacIp,2.0,1,0,GTCGAGAGTCGTTCCACCTA,1,2099866
lacIp,2.0,1,0,GTCCTGTAGAACCGATCTTT,1,2090662
lacIp,2.0,1,0,GTCCGCCGCATCGTCCAGAT,1,2110218
lacIp,2.0,1,0,GTCCCGAATAACCGATGTGA,1,2090604
lacIp,2.0,1,0,GTCATGAACAGACTCACTGG,1,2096795
lacIp,2.0,1,0,GTCATCTGATCCAGAAATAC,1,2092455
lacIp,2.0,1,0,GTCACGGGGTATTACCTTCG,1,2096064
lacIp,2.0,1,0,GTATTTGGTCGCAGGGGCTG,1,2101020
lacIp,2.0,1,0,GTATGCTTACGTGCCTCAGC,1,2116858
lacIp,2.0,1,0,GTATGAACGAAGCGACCAAG,1,2092290
lacIp,2.0,1,0,GTATAGAATTGAGGTCAGCC,1,2099630
lacIp,2.0,1,0,GTAGGTACCTGCGTAGGTCG,1,2090493
lacIp,2.0,1,0,GTAGGCTAGTCTTTCGCTGT,1,2106170
lacIp,2.0,1,0,GTAGCTATGGTGCGCATCTT,1,2098129
lacIp,2.0,1,0,GTAGCACCGCAGTTTCGAGT,1,2110123
lacIp,2.0,1,0,GTAGCAAACTTACATCATCA,1,2110794
lacIp,2.0,1,0,GTAGATTGGAGTGCCGGTGG,1,2115847
lacIp,2.0,1,0,GTAGAGCATCGGGAGGACAT,1,2104635
lacIp,2.0,1,0,GTACTAGCTTTCGGGTGATT,1,2087964
lacIp,2.0,1,0,GTACGTAGAGCTCAAAGAGA,1,2086635
lacIp,2.0,1,0,GTACGACACACCATTACAAT,1,2102807
lacIp,2.0,1,0,GTACCATTTTGTATCGAAAT,1,2112581
lacIp,2.0,1,0,GTACCACCAGCGTGTTTGCA,1,2109778
lacIp,2.0,1,0,GTACACCCGGCGAAGAGTTC,1,2102263
lacIp,2.0,1,0,GTAAAACCTGAAGGTATTCC,1,2103195
lacIp,2.0,1,0,GGTTTCGAACGGGTTGGGCT,1,2109101
lacIp,2.0,1,0,GGTTCTTCTACCCCACTTTT,1,2121576
lacIp,2.0,1,0,GGTGTTAATGGGGTCCCGGT,1,2096932
lacIp,2.0,1,0,GGTGGTCTATGGTAGTTAGC,1,2108395
lacIp,2.0,1,0,GGTGGGTTGGTGAAGCAATT,1,2109367
lacIp,2.0,1,0,GGTGGCTATGACACTGGTCA,1,2101621
lacIp,2.0,1,0,GGTGGCGCAAGCACTGAGAA,1,2109787
lacIp,2.0,1,0,GGTGCCCTATGTTGGTGCAT,1,2099706
lacIp,2.0,1,0,GGTGCATGGGGGCCTGTTGT,1,2096596
lacIp,2.0,1,0,GGTGACAATGCGCCGCCCAC,1,2107807
lacIp,2.0,1,0,GGTCTGCCTCAGTCCACTAG,1,2101236
lacIp,2.0,1,0,GGTCCAATAGCTCACTATCG,1,2088668
lacIp,2.0,1,0,GGTATGCATTAACATAATGT,1,2103373
lacIp,2.0,1,0,GGTAGTTCGCAGGCCCGACA,1,2113116
lacIp,2.0,1,0,GGTAGCATGATGATGAGGCG,1,2093180
lacIp,2.0,1,0,GGTACTTCTGTAGGCAGAGC,1,2095973
lacIp,2.0,1,0,GGTACGGTTTCCTAGGCACA,1,2117374
lacIp,2.0,1,0,GGTACACGGTACCAAACAAC,1,2086982
lacIp,2.0,1,0,GGTAAAGCATTGTATGAGAA,1,2113039
lacIp,2.0,1,0,GGGTTCGGATTCCGTATCGC,1,2087528
lacIp,2.0,1,0,GGGTGGTAATTAGGATATCA,1,2108081
lacIp,2.0,1,0,GGGTCCAAGTGTTCCTACAC,1,2098209
lacIp,2.0,1,0,GGGTATCAAACTAGCAGGCC,1,2096928
lacIp,2.0,1,0,GGGTATATCTGCGAGAGTTG,1,2111697
lacIp,2.0,1,0,GGGGGGCAAACTATTTCAAT,1,2109005
lacIp,2.0,1,0,GGGGCGTCGTTATCAACAAG,1,2121244
lacIp,2.0,1,0,GGGCTGTATTTCATTTACCT,1,2113412
lacIp,2.0,1,0,GGGCTCCGGACTACGCCGTC,1,2106913
lacIp,2.0,1,0,GGGCCATGGCATTCTCAACG,1,2106787
lacIp,2.0,1,0,GGGATCATTACCTGCGCGAG,1,2101383
lacIp,2.0,1,0,GGGAGGTATTCTCTCGATGG,1,2091950
lacIp,2.0,1,0,GGCTTTTCATTTAAGCATTT,1,2105432
lacIp,2.0,1,0,GGCTGGTTGTACTAACGGTG,1,2112756
lacIp,2.0,1,0,GGCGTGTCTCTGAGAGGGTC,1,2116424
lacIp,2.0,1,0,GGCGTGACTGATCCTGAGTT,1,2101679
lacIp,2.0,1,0,GGCCTTTTGTAAATACATGG,1,2085754
lacIp,2.0,1,0,GGCCTACATGTTCCTTCTCA,1,2094227
lacIp,2.0,1,0,GGCCGGACCCGACAGGCTGT,1,2108052
lacIp,2.0,1,0,GGCCATGATCAATGGGCGGT,1,2110776
lacIp,2.0,1,0,GGCACCCGGCAGAGCTATGT,1,2090546
lacIp,2.0,1,0,GGATTACTACGGTTTCGTGT,1,2099568
lacIp,2.0,1,0,GGATGTTTCGGCTGCCATAA,1,2107173
lacIp,2.0,1,0,GGATCGGGCTCCCCAGTACG,1,2108873
lacIp,2.0,1,0,GGAGGGATGGACGCGCTGTC,1,2088034
lacIp,2.0,1,0,GGAGCTCTCCGGATGGCTGA,1,2110408
lacIp,2.0,1,0,GGAGCATTCGGATGCAAGAA,1,2097589
lacIp,2.0,1,0,GGACTGGGCAATGGCGGCGA,1,2089361
lacIp,2.0,1,0,GGACGTGAAGTCGTTATTGC,1,2114407
lacIp,2.0,1,0,GGACGGAGCCCCCTAAGGTT,1,2096396
lacIp,2.0,1,0,GGACAGAGGGAGTACCGAGT,1,2106412
lacIp,2.0,1,0,GGAAATACCCCGGCACGAAA,1,2096715
lacIp,2.0,1,0,GCTTAATGAAGGTACCCCGC,1,2111062
lacIp,2.0,1,0,GCTGTTGCTACCGAGGCTTG,1,2102516
lacIp,2.0,1,0,GCTCTTTGCTTTGTTTGAAG,1,2109058
lacIp,2.0,1,0,GCTCTCAGCAAGCTCCGCGA,1,2097593
lacIp,2.0,1,0,GCTCTAGAACCGACATCTCT,1,2090406
lacIp,2.0,1,0,GCTCGGAATTCCGTCCTTGT,1,2104088
lacIp,2.0,1,0,GCTCAGGTCGAGCTTCCATC,1,2104591
lacIp,2.0,1,0,GCTCACTCGGGACCTCCGCT,1,2097538
lacIp,2.0,1,0,GCTCAAGCTACCAGAGGTTG,1,2094941
lacIp,2.0,1,0,GCTACGTCTTGGCCAAACCT,1,2092849
lacIp,2.0,1,0,GCGTTATCGATTGCGGCACC,1,2102975
lacIp,2.0,1,0,GCGTTAGATCCTGAGGTGAC,1,2122323
lacIp,2.0,1,0,GCGTGTCAGAATATCCGGTG,1,2117969
lacIp,2.0,1,0,GCGTCCAGTTGAGACGTGGG,1,2112851
lacIp,2.0,1,0,GCGTATTCATGGGTACGACG,1,2106416
lacIp,2.0,1,0,GCGGGCTTAAGGGAACCCTT,1,2099803
lacIp,2.0,1,0,GCGGCTAGGCTAACCGTGCC,1,2086180
lacIp,2.0,1,0,GCGCGCCCGGATTTTTTATA,1,2095675
lacIp,2.0,1,0,GCGCCGCATCGCTAACGAGT,1,2111216
lacIp,2.0,1,0,GCGCAATATAGGCTTCGGAT,1,2099393
lacIp,2.0,1,0,GCGAGTCTCTAGTCCTGGAG,1,2093737
lacIp,2.0,1,0,GCCTACTCCTGACGTCAGGG,1,2110989
lacIp,2.0,1,0,GCCGGCAATAACGCTCGCGA,1,2115371
lacIp,2.0,1,0,GCCGAGTGAACACTACGGAA,1,2098503
lacIp,2.0,1,0,GCCCATGATACGTATAGGGT,1,2121967
lacIp,2.0,1,0,GCCCATGACGCACCCCCCCT,1,2106732
lacIp,2.0,1,0,GCCATCTACTCACTTGCTAG,1,2120826
lacIp,2.0,1,0,GCCACCTGCCCGGTTAGATA,1,2120645
lacIp,2.0,1,0,GCCAACATCCGATGTCGGCA,1,2104275
lacIp,2.0,1,0,GCCAAAGGACGTCCACCCCT,1,2100683
lacIp,2.0,1,0,GCATCCGGACAGTTTGGATC,1,2116995
lacIp,2.0,1,0,GCAGGTGTCTCCTGTTGGAC,1,2104886
lacIp,2.0,1,0,GCAGATGTAAAAAGACTGTC,1,2120696
lacIp,2.0,1,0,GCAGATCCATAAGTTAGCTT,1,2113059
lacIp,2.0,1,0,GCAGAGATCAAAACCAAGCG,1,2097515
lacIp,2.0,1,0,GCACGTTGGCTCACTTAGTC,1,2096174
lacIp,2.0,1,0,GCACCGGGATCAAGGTGCGA,1,2105297
lacIp,2.0,1,0,GCAATACATTGCGGGGGCGA,1,2110455
lacIp,2.0,1,0,GCAACGGCACTGGTTAATGG,1,2092943
lacIp,2.0,1,0,GATTGGTGAGAATTCAACGG,1,2107832
lacIp,2.0,1,0,GATTGAATTAAATGGCATGT,1,2093681
lacIp,2.0,1,0,GATGAACCTGTTAGAACTTG,1,2112613
lacIp,2.0,1,0,GATCTTGTTAGGGCGCATTG,1,2117539
lacIp,2.0,1,0,GATCGTGCAATATCGTCGTA,1,2094248
lacIp,2.0,1,0,GATATAAGGGCGTTTGCTGT,1,2115871
lacIp,2.0,1,0,GATAGGCGTTGTAAAGTTAC,1,2117297
lacIp,2.0,1,0,GAGTGGTGTTTTCAGTCAAA,1,2090144
lacIp,2.0,1,0,GAGTCGACTCATAAATCATC,1,2088871
lacIp,2.0,1,0,GAGTACATATTATCATGTTA,1,2087094
lacIp,2.0,1,0,GAGGCTGATAAACGTTGGGC,1,2087915
lacIp,2.0,1,0,GAGGCATGGGACCTGCGTTT,1,2092625
lacIp,2.0,1,0,GAGGCAAGGATTGGACCTTC,1,2089893
lacIp,2.0,1,0,GAGCGACCGGGCCCAGGGTT,1,2103029
lacIp,2.0,1,0,GAGCAGCACTCCATTCAGCA,1,2103059
lacIp,2.0,1,0,GAGAATCGGCTAACCGCATT,1,2093399
lacIp,2.0,1,0,GAGAACCTGTGAGTCGCAGT,1,2111847
lacIp,2.0,1,0,GAGAAAGGCGGATGTCAGAT,1,2090726
lacIp,2.0,1,0,GACTTGTTTTGCCGCCACAG,1,2109810
lacIp,2.0,1,0,GACCTAATCATCGCGTATCG,1,2099773
lacIp,2.0,1,0,GACCAAGAACCTGCTGGACT,1,2107119
lacIp,2.0,1,0,GACAGAAAGAATCGGCAGAG,1,2111425
lacIp,2.0,1,0,GACACTAGGTGCACCCGGGA,1,2111682
lacIp,2.0,1,0,GACACAACAGTCTGTAGGGT,1,2087846
lacIp,2.0,1,0,GACAAAAGAATCACGGTTAT,1,2091581
lacIp,2.0,1,0,GAATGGGTGAGGACAGCGAG,1,2094151
lacIp,2.0,1,0,GAATGCATTCTAGCCAAGAC,1,2094002
lacIp,2.0,1,0,GAATAGTTGATTAGAGTGGA,1,2107457
lacIp,2.0,1,0,GAATAATCACATGACTATGC,1,2120415
lacIp,2.0,1,0,GAATAAACGTAAAAAAACGT,1,2111251
lacIp,2.0,1,0,GAAGTGCGTATATTATCGAG,1,2113507
lacIp,2.0,1,0,GAAGTCTAGGGGAGCAGGCT,1,2107988
lacIp,2.0,1,0,GAAGCACTCCATGTACCAGC,1,2095201
lacIp,2.0,1,0,GAACGGAGGCGGGGGGGTCC,1,2090007
lacIp,2.0,1,0,GAACGGACGGCATTCAAGAG,1,2115379
lacIp,2.0,1,0,GAACGCCTACTGAACTACTA,1,2090167
lacIp,2.0,1,0,GAACGCATTCTCAAATGCTC,1,2106076
lacIp,2.0,1,0,GAACGAATCCCGTGGCCTGT,1,2102413
lacIp,2.0,1,0,GAACCCGGTCATTCTTTTTA,1,2109385
lacIp,2.0,1,0,GAACAGAAGGCCTGAACAAT,1,2117914
lacIp,2.0,1,0,GAACAACAATTCTTCGCACC,1,2116938
lacIp,2.0,1,0,GAAAATGAGATGATTGTGTC,1,2093297
lacIp,2.0,1,0,GAAAAGGCATATCTGTTATC,1,2088986
lacIp,2.0,1,0,CTTTTCGCAATTGGCTGCTT,1,2121761
lacIp,2.0,1,0,CTTGGTGATCGTGTTCTCGA,1,2107580
lacIp,2.0,1,0,CTTGGGTAAGTATGAAAGAC,1,2098536
lacIp,2.0,1,0,CTTCCCCCCCCAGCTCGAAG,1,2107460
lacIp,2.0,1,0,CTTCCAAGCGACTGAGGCGC,1,2095744
lacIp,2.0,1,0,CTTAGACTACACATGCCTAG,1,2107452
lacIp,2.0,1,0,CTTACTATACGCTCCTAATA,1,2090246
lacIp,2.0,1,0,CTTACGGGCGTGTGAGTATC,1,2097947
lacIp,2.0,1,0,CTTAATGTCGATGGCAACGT,1,2117198
lacIp,2.0,1,0,CTTAACCATAAGACACTCAC,1,2112016
lacIp,2.0,1,0,CTGTTCCCTTCCGGAAGGCT,1,2098746
lacIp,2.0,1,0,CTGTGAAGCAACGTGCGTTT,1,2120020
lacIp,2.0,1,0,CTGTCAAGTTAACTGATATC,1,2112047
lacIp,2.0,1,0,CTGTAGATTAGCATTAAACC,1,2091351
lacIp,2.0,1,0,CTGTACGATGATACTTACGA,1,2087437
lacIp,2.0,1,0,CTGTAATACATCAGCCGCGG,1,2104939
lacIp,2.0,1,0,CTGTAACGAACACAACGTCA,1,2115828
lacIp,2.0,1,0,CTGGGTCAGGCCAACCCTGC,1,2103327
lacIp,2.0,1,0,CTGGAAGGTAGCAACGGGTA,1,2120169
lacIp,2.0,1,0,CTGCTGACTCGTAACGTGCA,1,2087397
lacIp,2.0,1,0,CTGCCTAAACGATTGCTAGC,1,2119569
lacIp,2.0,1,0,CTGAGCCTCAACCGGCGGGG,1,2102936
lacIp,2.0,1,0,CTCTCGCAATCACAACGTTA,1,2086001
lacIp,2.0,1,0,CTCTCATTTTAGTAAGAGGC,1,2116512
lacIp,2.0,1,0,CTCGGGTATTTGTGCTACGG,1,2117608
lacIp,2.0,1,0,CTCCTAAAAGGATGGCAGAT,1,2108478
lacIp,2.0,1,0,CTCCGGTAGAGGTGATGAGT,1,2097221
lacIp,2.0,1,0,CTCCGCGCTGCATACAAGCC,1,2102353
lacIp,2.0,1,0,CTCCATAATGTTCGTATCAA,1,2099147
lacIp,2.0,1,0,CTCCAAGGGGGAGACTGCAT,1,2111620
lacIp,2.0,1,0,CTCACTATGTAATAGACTAT,1,2110026
lacIp,2.0,1,0,CTCACACTCCCTGTAAGTGG,1,2094933
lacIp,2.0,1,0,CTCAATCGCAGCGTAGTAAA,1,2112846
lacIp,2.0,1,0,CTCAAGCTTTACTGAGGTGG,1,2099220
lacIp,2.0,1,0,CTCAAGCCAGAATAGGTTAA,1,2107148
lacIp,2.0,1,0,CTATTAAACGAAATAAAATC,1,2106637
lacIp,2.0,1,0,CTATGAGCGGTATCGGTGTG,1,2089492
lacIp,2.0,1,0,CTATCCCTGGACTTTAGGTG,1,2118856
lacIp,2.0,1,0,CTATACAGACGACATGATCA,1,2095843
lacIp,2.0,1,0,CTAGTTTAAGTCGGCTCTTT,1,2116958
lacIp,2.0,1,0,CTAGCTCGCCTAGGCTTATT,1,2087840
lacIp,2.0,1,0,CTAGCGACTGTGGGGTCCGA,1,2099996
lacIp,2.0,1,0,CTAGATCGAGCTATTGGGAA,1,2104085
lacIp,2.0,1,0,CTACGGCTTTGAATTAATCG,1,2108475
lacIp,2.0,1,0,CTACCCAAACGTGTCGTTAA,1,2118247
lacIp,2.0,1,0,CTACACTGATAACGGCTTGA,1,2086256
lacIp,2.0,1,0,CTAATTCAGACGGAAGCCCT,1,2099517
lacIp,2.0,1,0,CTAAGAGTGATATTTATCGA,1,2116481
lacIp,2.0,1,0,CGTTCTCTCGCGATATCGAA,1,2088968
lacIp,2.0,1,0,CGTTCCGCGAAGGTTACGTG,1,2115710
lacIp,2.0,1,0,CGTGCCTCTCCACCAAATGA,1,2090516
lacIp,2.0,1,0,CGTCTTCATTCAGGAATGGC,1,2087319
lacIp,2.0,1,0,CGTCGGACAAATTGGATTGG,1,2111272
lacIp,2.0,1,0,CGTCCAGGCTTTGATGCCAA,1,2107751
lacIp,2.0,1,0,CGTCAGAATTGGGTTGCAGA,1,2093590
lacIp,2.0,1,0,CGTAAGCAATTTCCATTCAA,1,2103127
lacIp,2.0,1,0,CGGTTTAAGCTAAAGGGTAG,1,2112617
lacIp,2.0,1,0,CGGTCGTGTTCGAAAGATTG,1,2103113
lacIp,2.0,1,0,CGGTCCGGGGTCTGTGATCC,1,2109474
lacIp,2.0,1,0,CGGTCCCTCATGCATTTGGC,1,2098920
lacIp,2.0,1,0,CGGTACGAGGTCGCCAGTCC,1,2085927
lacIp,2.0,1,0,CGGTACAGGGCGGTCCTCAT,1,2090977
lacIp,2.0,1,0,CGGTAATTTATCGGTGAATA,1,2114734
lacIp,2.0,1,0,CGGGTAACTAGCTCGCTCGT,1,2086949
lacIp,2.0,1,0,CGGGGGGGGTCCATCAGTTG,1,2095496
lacIp,2.0,1,0,CGGGAAGAGTTTATTCGCCA,1,2094850
lacIp,2.0,1,0,CGGCGGGTACCGGGAGATCT,1,2097701
lacIp,2.0,1,0,CGGCCACCGATCAGTCTCGA,1,2097414
lacIp,2.0,1,0,CGGATGTACCAGGGATCGGA,1,2120260
lacIp,2.0,1,0,CGGAGAGGTCTTGTCCTACC,1,2108311
lacIp,2.0,1,0,CGCTTTAACATTGTTCAGGG,1,2098040
lacIp,2.0,1,0,CGCTTAACGCTAGACTTTTA,1,2121660
lacIp,2.0,1,0,CGCGCTGGTAGGGTTGTCTT,1,2094220
lacIp,2.0,1,0,CGCGCCCTTAAGGTGTAGGA,1,2107530
lacIp,2.0,1,0,CGCGATCCAGTGCCATTTCC,1,2107936
lacIp,2.0,1,0,CGCCTACTGAGGGGAACTTT,1,2115153
lacIp,2.0,1,0,CGCCCGCGGAACACAGCGTC,1,2120925
lacIp,2.0,1,0,CGCCACAACGGAGACACGGG,1,2109033
lacIp,2.0,1,0,CGCCAACATAAGAGGTCCTC,1,2097631
lacIp,2.0,1,0,CGCACCATGCGCCTCCCGAT,1,2116532
lacIp,2.0,1,0,CGCACACAAAGCCGCTATAA,1,2092248
lacIp,2.0,1,0,CGATGGTCATGTCCAGTACT,1,2091713
lacIp,2.0,1,0,CGATCCGTATCGTGCGGCTA,1,2118558
lacIp,2.0,1,0,CGATAGTAAGACAGTCATTT,1,2103664
lacIp,2.0,1,0,CGATACTTGAGCAACCATTA,1,2090739
lacIp,2.0,1,0,CGATACGAGTTCACTGTCAT,1,2101785
lacIp,2.0,1,0,CGAGTGTTGGTGTCGAGCAG,1,2115119
lacIp,2.0,1,0,CGAGCCTTATCGTCTGGTAT,1,2088567
lacIp,2.0,1,0,CGAGAGCAAAAGGCGTTGGA,1,2096979
lacIp,2.0,1,0,CGACTTTCTAGACTGCGCAA,1,2102352
lacIp,2.0,1,0,CGACTTCACGCGCCGTTGCG,1,2116388
lacIp,2.0,1,0,CGACAAATTGAGAGTAAATT,1,2101046
lacIp,2.0,1,0,CGAATGCACATGTGATTCAT,1,2093208
lacIp,2.0,1,0,CGAAGCCAAATATAAGGCCT,1,2095434
lacIp,2.0,1,0,CGAAGAACTAACTCTTGCGC,1,2108699
lacIp,2.0,1,0,CCTTTCGGGGTCGTAGCAAT,1,2091752
lacIp,2.0,1,0,CCTTGGGTCTCGTCCTTGTA,1,2096827
lacIp,2.0,1,0,CCTTGGACTGAGGTAGTATC,1,2115269
lacIp,2.0,1,0,CCTTGCCAGGAGAACCCGAT,1,2100042
lacIp,2.0,1,0,CCTTAGAGCTAGGTAATGAA,1,2116059
lacIp,2.0,1,0,CCTGTGCGAGGACAGGGCGG,1,2119815
lacIp,2.0,1,0,CCTGGCGACCCGGAACGTAA,1,2120090
lacIp,2.0,1,0,CCTGACCGCCAGGGGGGGTT,1,2086022
lacIp,2.0,1,0,CCTCTTTATGCCCAGTGGGG,1,2092076
lacIp,2.0,1,0,CCTCTCGATAGAACCCTCCT,1,2107127
lacIp,2.0,1,0,CCTATTTAGGGCGACCAGTG,1,2107897
lacIp,2.0,1,0,CCTATTATTGGGTATTAACC,1,2119329
lacIp,2.0,1,0,CCTAGTAAGTAGTAAAGGTC,1,2092171
lacIp,2.0,1,0,CCTAGCTGTTAAGTCTTCGT,1,2118361
lacIp,2.0,1,0,CCTACGTGATGGTCATTACT,1,2106528
lacIp,2.0,1,0,CCTACGCTCACAGGATTTGA,1,2102576
lacIp,2.0,1,0,CCGTTACATGGTTCCGTATG,1,2112218
lacIp,2.0,1,0,CCGTGTGTTGTTATGTTCAC,1,2105042
lacIp,2.0,1,0,CCGTCTAGCTGGCCGTAACT,1,2114744
lacIp,2.0,1,0,CCGTAAAAAGGAGAGCAACC,1,2105571
lacIp,2.0,1,0,CCGGTTAACACTTGAGCGTT,1,2106506
lacIp,2.0,1,0,CCGGTCCCCTGGCATACACT,1,2115875
lacIp,2.0,1,0,CCGGGGTTTATACTAGAACC,1,2121171
lacIp,2.0,1,0,CCGGGAAGTCGCGGCAGATA,1,2103560
lacIp,2.0,1,0,CCGGCTTCACCATCCCGAGC,1,2092819
lacIp,2.0,1,0,CCGGAGCAAGTGCCGTTGCG,1,2119666
lacIp,2.0,1,0,CCGCTTATTCTCGGAGCGAC,1,2103592
lacIp,2.0,1,0,CCGCGTGTTGTGGACGGCGT,1,2118826
lacIp,2.0,1,0,CCGCCGTACGAGTGCAGTCG,1,2089536
lacIp,2.0,1,0,CCGCAAGGGCCTCCTGTCAA,1,2120945
lacIp,2.0,1,0,CCCTGAATATTCTATATCCC,1,2103442
lacIp,2.0,1,0,CCCTAACGTTGAGGGACACA,1,2099500
lacIp,2.0,1,0,CCCGGGTCACAGGTATACGT,1,2086489
lacIp,2.0,1,0,CCCGGGCAACAACATGACTG,1,2119606
lacIp,2.0,1,0,CCCGCTCACCAAGCTGCAAA,1,2120138
lacIp,2.0,1,0,CCCCTTGAGTCGATACACTG,1,2116638
lacIp,2.0,1,0,CCCCTGGCGACAAAAAAGTG,1,2098390
lacIp,2.0,1,0,CCCCGTGTCCCAAGAAAGTT,1,2107894
lacIp,2.0,1,0,CCCCGAGCAATCGTGCGGCT,1,2122282
lacIp,2.0,1,0,CCCCAGATTTTACACGAGCA,1,2107345
lacIp,2.0,1,0,CCCAGGGATCATCAACCACA,1,2100224
lacIp,2.0,1,0,CCCAGGCATCACCGACTGTG,1,2109925
lacIp,2.0,1,0,CCCAAGTGATTCCGCGGCCA,1,2116561
lacIp,2.0,1,0,CCCAAAGCACGACGTGATGC,1,2105051
lacIp,2.0,1,0,CCAGTTTCGCGTGCTTTATG,1,2106968
lacIp,2.0,1,0,CCAGTGGGACTCGCGTTAAC,1,2111607
lacIp,2.0,1,0,CCAGGTACTAACAATGCGGG,1,2098707
lacIp,2.0,1,0,CCAGGGGTTCAAGGTACACT,1,2102016
lacIp,2.0,1,0,CCAGATGGGGAGCGTTGGAT,1,2111490
lacIp,2.0,1,0,CCACTCAATACTTCGTTCAT,1,2113973
lacIp,2.0,1,0,CCACACAAGACTTCGCAAAC,1,2104048
lacIp,2.0,1,0,CCAACCGCTGTTGTCTATAC,1,2110691
lacIp,2.0,1,0,CATTTTGCGCGACATGGGAT,1,2108031
lacIp,2.0,1,0,CATTTGCTGCCCTAATAAAC,1,2121548
lacIp,2.0,1,0,CATTTACCAGAAAAGCCGAA,1,2108529
lacIp,2.0,1,0,CATTCTAAGTATAGCGCGAC,1,2121964
lacIp,2.0,1,0,CATTACACCTTTTTGGCTCC,1,2107179
lacIp,2.0,1,0,CATGTGTAGAATAAAGCGCG,1,2098076
lacIp,2.0,1,0,CATGTCACCTGTCTCGAATG,1,2120408
lacIp,2.0,1,0,CATGTACTACAGAATGGCGT,1,2096087
lacIp,2.0,1,0,CATGGGGAGACGTTGTAATC,1,2115596
lacIp,2.0,1,0,CATGGGCTCGGGATCAAGGA,1,2089466
lacIp,2.0,1,0,CATCTGGGCGTTCAAATCGT,1,2107120
lacIp,2.0,1,0,CATCACGTATCGCTCGGGCT,1,2121106
lacIp,2.0,1,0,CATAGCAAGCTCGGCAATTC,1,2099796
lacIp,2.0,1,0,CATACGACTTGGCTTTGGTT,1,2100450
lacIp,2.0,1,0,CATAATGCAGCTGCTGATAA,1,2100335
lacIp,2.0,1,0,CATAAATGGACGGCGGATTC,1,2103006
lacIp,2.0,1,0,CAGTTAGTTATAGTCGGGGA,1,2088166
lacIp,2.0,1,0,CAGTGACACGCTGACAAGGC,1,2108743
lacIp,2.0,1,0,CAGGGTACATCTGCTTCTAC,1,2092163
lacIp,2.0,1,0,CAGGCCTTCTGGCAGCTGTG,1,2097400
lacIp,2.0,1,0,CAGCTAGGTACGTACGTGTG,1,2093705
lacIp,2.0,1,0,CAGCGGGACCTATGAGCATA,1,2089108
lacIp,2.0,1,0,CAGCCGGAATAACATTGGTA,1,2113821
lacIp,2.0,1,0,CAGCCACCGCAGAGGGACAC,1,2119555
lacIp,2.0,1,0,CAGCAATTCTTAGACTAACT,1,2116507
lacIp,2.0,1,0,CAGATCTACTGACCGCTATC,1,2103691
lacIp,2.0,1,0,CAGACTCACCATATCTCGCT,1,2116252
lacIp,2.0,1,0,CACTTCGACTTTCGCTGTAA,1,2111804
lacIp,2.0,1,0,CACTCGGGTGTTTCGCGACT,1,2104912
lacIp,2.0,1,0,CACTCAATAGCTCGGCCCGA,1,2096491
lacIp,2.0,1,0,CACTACCTGGACCTGTGCGT,1,2095708
lacIp,2.0,1,0,CACGTCACTGGTTTGCAGAC,1,2109601
lacIp,2.0,1,0,CACGGACCTTGTTCAATCAG,1,2113818
lacIp,2.0,1,0,CACGATCTCCGCCCGCTCGA,1,2110164
lacIp,2.0,1,0,CACGAGGATGTAATTGTTGC,1,2088645
lacIp,2.0,1,0,CACGAAGCGAAAATCTTACG,1,2088943
lacIp,2.0,1,0,CACCGGGTCGGCTTCGGTAA,1,2119497
lacIp,2.0,1,0,CACCCCCCTTGGTCGAGCCT,1,2118110
lacIp,2.0,1,0,CACAGTGTCCGTTCTACGGC,1,2108079
lacIp,2.0,1,0,CACAACAAAACGGGTCGTCG,1,2091012
lacIp,2.0,1,0,CAAGTCACATTCTTAAACAT,1,2098344
lacIp,2.0,1,0,CAAGCTCCATAGTGGTTGGG,1,2086123
lacIp,2.0,1,0,CAAGCCGCTGTCGGAAAGGG,1,2093176
lacIp,2.0,1,0,CAAGAGTCTGTTCCGTCTGC,1,2090170
lacIp,2.0,1,0,CAACGGCTCGAGGCTCAGGT,1,2104744
lacIp,2.0,1,0,CAACGCTTTAGGTGGCGCAT,1,2108611
lacIp,2.0,1,0,CAACATAGTTCGCTGGCAAT,1,2107589
lacIp,2.0,1,0,CAAACATCCCCGGCTAAGAG,1,2103060
lacIp,2.0,1,0,CAAAAGAGGTAACGACTTCG,1,2088314
lacIp,2.0,1,0,ATTTTTTGTACCAGTAGAGC,1,2092299
lacIp,2.0,1,0,ATTTTACGCAATACGTGGTG,1,2087240
lacIp,2.0,1,0,ATTTGGACCCCACTGGACGG,1,2093249
lacIp,2.0,1,0,ATTGTATCGCAACGGCCATT,1,2090313
lacIp,2.0,1,0,ATTCAGTTCACGTCTCTGCC,1,2121752
lacIp,2.0,1,0,ATTCAGAATTCCTGCGAAGA,1,2116400
lacIp,2.0,1,0,ATTATAAATCTTATGTTAAG,1,2115931
lacIp,2.0,1,0,ATGTTTGCACATGTGGATAA,1,2120197
lacIp,2.0,1,0,ATGTGGTGGATGTCTCCTAG,1,2094243
lacIp,2.0,1,0,ATGTACTATCTCTAACTGCT,1,2103026
lacIp,2.0,1,0,ATGGGCGGAGGCTTGAGAAA,1,2108665
lacIp,2.0,1,0,ATGGACATGACCCAGCGGTA,1,2100464
lacIp,2.0,1,0,ATGCGGGGTCGGGGATCTAT,1,2106303
lacIp,2.0,1,0,ATGCCTTATGGGGCGATTCG,1,2121047
lacIp,2.0,1,0,ATGACGAGGCCCTCCTAATA,1,2113063
lacIp,2.0,1,0,ATGACCCGTGCATGTGCGGA,1,2090703
lacIp,2.0,1,0,ATGACCCGGAAAGGGCAATA,1,2088300
lacIp,2.0,1,0,ATCTAGAGGGCTGAGGTGCA,1,2086376
lacIp,2.0,1,0,ATCGTACTTAACGTCACGAG,1,2113153
lacIp,2.0,1,0,ATCGTAATAATCAGGTAATG,1,2103597
lacIp,2.0,1,0,ATCGAAAACAAAAATGAAAC,1,2108763
lacIp,2.0,1,0,ATCCCCTCCATATAATCTGA,1,2093113
lacIp,2.0,1,0,ATCCCATACAGCGGGGGCTG,1,2105860
lacIp,2.0,1,0,ATCATGCCCAAGTACGGCAG,1,2113536
lacIp,2.0,1,0,ATCATCAGGTAGGGGGGGGG,1,2114546
lacIp,2.0,1,0,ATCAGACGATCTGTCGGAAT,1,2103815
lacIp,2.0,1,0,ATCACTCGTGGCCCGTTATG,1,2090854
lacIp,2.0,1,0,ATCACAAATCCCGGGTTCCT,1,2114687
lacIp,2.0,1,0,ATATCATCTCAGCCGGCCCC,1,2110370
lacIp,2.0,1,0,ATATATCTTTGGTAACAAAT,1,2104550
lacIp,2.0,1,0,ATATATAGACTCGAGTACAA,1,2107946
lacIp,2.0,1,0,ATATAACGTTTTTATTCGTA,1,2119763
lacIp,2.0,1,0,ATAGTGCGGATTGCGGGGCG,1,2114760
lacIp,2.0,1,0,ATAGGTCTTCCTCCATGTAC,1,2088747
lacIp,2.0,1,0,ATACTGCCTAAGCACAGCTG,1,2100841
lacIp,2.0,1,0,ATACGGGTTTCGCTTCTCGC,1,2098999
lacIp,2.0,1,0,ATACGCTTCGATCTTGCCCT,1,2092777
lacIp,2.0,1,0,ATACCTATAACAGGGCGTGC,1,2091991
lacIp,2.0,1,0,ATACACAGTTTAATCCACCT,1,2085680
lacIp,2.0,1,0,ATAAGTAGGCTGAGTAAAGG,1,2102227
lacIp,2.0,1,0,AGTTTGTCCTCGGTTTGAAG,1,2093610
lacIp,2.0,1,0,AGTTGTTTGACTGGGGAATC,1,2087290
lacIp,2.0,1,0,AGTTGGGAGTAGTTCGGATA,1,2107779
lacIp,2.0,1,0,AGTTAAGCACTATGAGGCTA,1,2091476
lacIp,2.0,1,0,AGTGTGTTACTAACCACTAA,1,2116011
lacIp,2.0,1,0,AGTGCGTATCGCGGTGCGAC,1,2106809
lacIp,2.0,1,0,AGTGATGGCAATGTTATATG,1,2086642
lacIp,2.0,1,0,AGTGACTTTCTGGTTGTGTC,1,2115798
lacIp,2.0,1,0,AGTCTGCCTTACCTTGAACT,1,2100400
lacIp,2.0,1,0,AGTCTCGGAACTGTAGCGGG,1,2098941
lacIp,2.0,1,0,AGTCGGGCCACCCTCAACAC,1,2119942
lacIp,2.0,1,0,AGTCGGACTGGTCGTACTAC,1,2090438
lacIp,2.0,1,0,AGTCGCTGCCAACTGGTACT,1,2103742
lacIp,2.0,1,0,AGTCCTTGATCTCCATTGTG,1,2110429
lacIp,2.0,1,0,AGTCAGGCCAGTGGTCTAAG,1,2115724
lacIp,2.0,1,0,AGTCACCCTAGAGTAGTCGG,1,2088042
lacIp,2.0,1,0,AGTATTAGAGCAGGATCAGC,1,2088492
lacIp,2.0,1,0,AGTAGGCACTTGAGTCAGCG,1,2091649
lacIp,2.0,1,0,AGTACGAGTGTGTAAAACGG,1,2092876
lacIp,2.0,1,0,AGTACCTATTTATATCTACG,1,2109389
lacIp,2.0,1,0,AGGTTCTAGACAGTCTGTAC,1,2090353
lacIp,2.0,1,0,AGGTGGAATGACTAGAACTA,1,2092043
lacIp,2.0,1,0,AGGTCTTATCGCATCCCGCG,1,2093395
lacIp,2.0,1,0,AGGTCGCGGCGTGTCGGAGT,1,2102098
lacIp,2.0,1,0,AGGTCCCGGTAAAGGGTGAT,1,2113657
lacIp,2.0,1,0,AGGTAACAATCGACAGTCAC,1,2095666
lacIp,2.0,1,0,AGGGTGTTTAGATGTATGGC,1,2119236
lacIp,2.0,1,0,AGGGTGGTCCAGTTTTTAAG,1,2088513
lacIp,2.0,1,0,AGGGCATCTCCGTTTCATTG,1,2106255
lacIp,2.0,1,0,AGGCAGGTTACCATCGTGTG,1,2088182
lacIp,2.0,1,0,AGGATGATAGAGGTGTTATT,1,2100077
lacIp,2.0,1,0,AGGAGGGTCACGAACGCATT,1,2106690
lacIp,2.0,1,0,AGGAGATGGCACGTAAGAAT,1,2090727
lacIp,2.0,1,0,AGGACGGGGTTGATCGGATC,1,2106577
lacIp,2.0,1,0,AGGAAGAACGGCCCACGAGC,1,2096683
lacIp,2.0,1,0,AGCTGAACCCGCAGATGACA,1,2097955
lacIp,2.0,1,0,AGCGTGGAACTCAGCAATAC,1,2119910
lacIp,2.0,1,0,AGCCGGGAATGGCAGAGAAT,1,2119708
lacIp,2.0,1,0,AGCCAGTTAATATCTTGCGC,1,2086380
lacIp,2.0,1,0,AGCATCGCCAATATTTCTCC,1,2118943
lacIp,2.0,1,0,AGCACTGCAAGGCTACGTTA,1,2109140
lacIp,2.0,1,0,AGCACCATAAGGATGTAATT,1,2093891
lacIp,2.0,1,0,AGCACAGGAGCGAGCAGCCT,1,2116588
lacIp,2.0,1,0,AGCAAAAGGCAGCTTGTGTT,1,2098182
lacIp,2.0,1,0,AGATAGTACTCTCCCGAACC,1,2107160
lacIp,2.0,1,0,AGATAGCGCATCTAGCACCA,1,2101698
lacIp,2.0,1,0,AGATAACCGTCTTTAGAGCT,1,2099906
lacIp,2.0,1,0,AGAGATTTAGCTCTCAAGGC,1,2091220
lacIp,2.0,1,0,AGACCAGCCCAGTTAAACCC,1,2104523
lacIp,2.0,1,0,AGAATCTCTTACGTACTAAA,1,2112458
lacIp,2.0,1,0,AGAAACCCTCCTACCGCTGC,1,2092296
lacIp,2.0,1,0,AGAAACATTTACAGGCCGTA,1,2110063
lacIp,2.0,1,0,AGAAAAGGCGTCGAACGTCG,1,2086990
lacIp,2.0,1,0,ACTTTTCGAGTGATTAGTGC,1,2098686
lacIp,2.0,1,0,ACTTTACATATAGACCGTTT,1,2106008
lacIp,2.0,1,0,ACTTAGTGCTGACGGCTAAA,1,2113670
lacIp,2.0,1,0,ACTTAAGCGGTCCTGATCAG,1,2093558
lacIp,2.0,1,0,ACTGTGCATTGAATCTGGAT,1,2114282
lacIp,2.0,1,0,ACTGCAATATTAGGGAAGGG,1,2116660
lacIp,2.0,1,0,ACTCGGTAGTCTGCCCCGGA,1,2094690
lacIp,2.0,1,0,ACTCATCGTTGTTACTCCTA,1,2102746
lacIp,2.0,1,0,ACTCAGGTGAGGGGTAGTCT,1,2090465
lacIp,2.0,1,0,ACTAGCGTATGGTGTTTCAA,1,2088117
lacIp,2.0,1,0,ACTACGGGCTGTAGACCTGC,1,2099979
lacIp,2.0,1,0,ACTACGAATGACGAACAAAT,1,2090912
lacIp,2.0,1,0,ACTACCTCTGGGGTGCATTC,1,2101240
lacIp,2.0,1,0,ACGTTGGACTTAAGTTGGGG,1,2089010
lacIp,2.0,1,0,ACGTTGATGGACGAGACTTC,1,2118146
lacIp,2.0,1,0,ACGTTATTAAGAAAAAGGTA,1,2106611
lacIp,2.0,1,0,ACGTCCCCTCACTGCCTCAC,1,2113937
lacIp,2.0,1,0,ACGTAATTTTATAGGCCTAA,1,2097949
lacIp,2.0,1,0,ACGGAGGGACAGCGGTGCTT,1,2117686
lacIp,2.0,1,0,ACGGAGACTGTGAAAGAACC,1,2094974
lacIp,2.0,1,0,ACGGACACAAAGCCGAAATA,1,2090578
lacIp,2.0,1,0,ACGCGGCTGGCAGTGGATTA,1,2105262
lacIp,2.0,1,0,ACGAGTGTATAGGTCGGTGT,1,2120774
lacIp,2.0,1,0,ACCTTGAAAAGTTAAAGAGA,1,2096022
lacIp,2.0,1,0,ACCGTCCCGCCGAGTAGCGG,1,2086641
lacIp,2.0,1,0,ACCGGTCCCTACGCATTGGT,1,2094902
lacIp,2.0,1,0,ACCGCTTTTAGCTGGAACTT,1,2093412
lacIp,2.0,1,0,ACCGAGCTTGTCTATGGTTA,1,2115140
lacIp,2.0,1,0,ACCCTGCCTAAATTATGTTC,1,2121807
lacIp,2.0,1,0,ACCCTGCCGGGGTCCCGGTC,1,2095977
lacIp,2.0,1,0,ACCCTCCACTGTATGTGTAA,1,2104192
lacIp,2.0,1,0,ACCCATGTCTAAGAGTACTG,1,2093751
lacIp,2.0,1,0,ACCATGGTGATAGCAAGCTC,1,2110963
lacIp,2.0,1,0,ACCATGGCTTGTCAGCTTCG,1,2086419
lacIp,2.0,1,0,ACCAGTCATAGTACGCTTCA,1,2101011
lacIp,2.0,1,0,ACCAGAGGATAGGAACGTGT,1,2103115
lacIp,2.0,1,0,ACCAATTGAGCCGGAGTTCC,1,2107284
lacIp,2.0,1,0,ACCAAGAACTTGGTGGACTC,1,2086007
lacIp,2.0,1,0,ACATGTCTTGCACGCGAGCA,1,2117785
lacIp,2.0,1,0,ACATGCTGTGGTACTCCCCC,1,2111667
lacIp,2.0,1,0,ACATAAGCTACTCTGCGCAA,1,2101091
lacIp,2.0,1,0,ACAGTTCACTTCAACAGTGT,1,2119284
lacIp,2.0,1,0,ACAGACTCAGCTACCGGATT,1,2086538
lacIp,2.0,1,0,ACACTCTCAAAATAATCAAC,1,2094563
lacIp,2.0,1,0,ACACCGCGGCAGGAGTGATG,1,2118636
lacIp,2.0,1,0,ACAACTTGTCATTACTTATC,1,2110573
lacIp,2.0,1,0,ACAAACTTCCCCCTGTTAAA,1,2105308
lacIp,2.0,1,0,AATTTCGGTATTTAAATGGA,1,2111661
lacIp,2.0,1,0,AATTTCCTTAAATCGTAGAG,1,2088351
lacIp,2.0,1,0,AATTTAGAACACCAGTGATC,1,2091725
lacIp,2.0,1,0,AATTGCTAAAACGGGATCCA,1,2086146
lacIp,2.0,1,0,AATTGCAATGTATGTCGTGA,1,2094206
lacIp,2.0,1,0,AATTGAACGATATCGGGGCT,1,2085901
lacIp,2.0,1,0,AATTAGTATTTGGACAGGGT,1,2106582
lacIp,2.0,1,0,AATGTTTTCAATCATAATGA,1,2089428
lacIp,2.0,1,0,AATGGAATTCGAATCTTATT,1,2088050
lacIp,2.0,1,0,AATGCGCACACCGCGCTCGA,1,2099676
lacIp,2.0,1,0,AATGAGTACCTAGTACCGTA,1,2103683
lacIp,2.0,1,0,AATCAAGTCAGCGTCGTGTA,1,2100674
lacIp,2.0,1,0,AATAGAAACCAAGTGTGCTT,1,2107898
lacIp,2.0,1,0,AAGTTCCTCAGGGACGGTTG,1,2114694
lacIp,2.0,1,0,AAGTGTAGAGACGAAGTGTC,1,2101519
lacIp,2.0,1,0,AAGTGGTGCCAGTGTTTTGA,1,2113767
lacIp,2.0,1,0,AAGTATAGGTAGCGAGCAGG,1,2112166
lacIp,2.0,1,0,AAGGTTATCAATGTACCAAC,1,2114335
lacIp,2.0,1,0,AAGGATTGTCTTTATACATG,1,2095654
lacIp,2.0,1,0,AAGGATGTAGTCTGAATGCA,1,2088111
lacIp,2.0,1,0,AAGCGTGGGTGGATAACAAT,1,2100172
lacIp,2.0,1,0,AAGCCTGTGGGGTAATACTA,1,2110136
lacIp,2.0,1,0,AAGCAAAGTTAGGTGCACTC,1,2114322
lacIp,2.0,1,0,AAGATCTCGCGTACATCTCC,1,2093730
lacIp,2.0,1,0,AAGAAGGCGTGTGCATAGAC,1,2099957
lacIp,2.0,1,0,AACTTGAAGCTTTTGTGGTC,1,2095956
lacIp,2.0,1,0,AACTCAGTTAGGGCTCTCCG,1,2092719
lacIp,2.0,1,0,AACGTTGCCTTTTTAGTCGT,1,2110299
lacIp,2.0,1,0,AACGTTCTTTGGCGTCATTT,1,2121050
lacIp,2.0,1,0,AACGCATAATAGAGGAGCTC,1,2093654
lacIp,2.0,1,0,AACGCACTACATAGGCGTAG,1,2087596
lacIp,2.0,1,0,AACCGACCTTCGTCTTTCGG,1,2088878
lacIp,2.0,1,0,AACAACGAATGCGGAAACGA,1,2086864
lacIp,2.0,1,0,AAATTTCGCTCGATAGGAAT,1,2086057
lacIp,2.0,1,0,AAATCGATCGACAAAATGGC,1,2120557
lacIp,2.0,1,0,AAAGTTTCTATCTAACAAGA,1,2120160
lacIp,2.0,1,0,AAAGACTAGGCTACCACCTC,1,2109717
lacIp,2.0,1,0,AAACTTTCAAGCTGGTGATA,1,2093559
lacIp,2.0,1,0,AAAAGTTGCATTGGCTGTGA,1,2091547
