name,relative_counts,ct,ct_0,barcode,ct_1,barcode_ind
dgoRp,0.6363636363636364,322,197,AGATAATAAGATTTCCTCTA,125,841414
dgoRp,0.18309859154929578,166,141,ACGTTTGGGAGATTTAACAC,25,835992
dgoRp,0.09022556390977443,143,132,CACGTGGGGGGTTGGTAAAG,11,851032
dgoRp,0.3387096774193548,164,123,CTGTGCATGAGACCTTACCC,41,843476
dgoRp,0.5166666666666667,180,119,CGATCATACTGAATTACGTA,61,843866
dgoRp,5.043103448275862,699,115,CCAGGAGGGGGCGTGAAACA,584,836117
dgoRp,0.5929203539823009,178,112,AATGGGTAACGGATGTGATG,66,835885
dgoRp,0.25225225225225223,137,110,CTGCGCAAGCGGAGGCTGAA,27,860233
dgoRp,0.8207547169811321,191,105,TACAAGTCATATATCTTAGG,86,835940
dgoRp,0.9489795918367347,189,97,TGGAAAGACGGGAAGTCCTG,92,857334
dgoRp,0.7127659574468085,159,93,CATGGTCGCGTAATGCGGCA,66,837137
dgoRp,3.095744680851064,383,93,AGGCCACTTAATTCTCGAAT,290,836118
dgoRp,0.45652173913043476,132,91,TCAATCTAAGGGACATGAGT,41,860243
dgoRp,0.45977011494252873,125,86,CGGGCTGACCTTAGGAGTGG,39,860808
dgoRp,0.6206896551724138,139,86,AGGGCTTAGATCATCTTTGT,53,844286
dgoRp,0.5,127,85,GTCTCCCGACGATGGCAGTC,42,836056
dgoRp,0.023255813953488372,86,85,AGCGTATTTTATCTGCGGGT,1,837803
dgoRp,0.4117647058823529,118,84,TATGCAACAAGTCCTGCGCA,34,842801
dgoRp,0.17857142857142858,97,83,ACCGTGGCCGTACATTGGAG,14,838357
dgoRp,0.0875,85,79,TCCCGCCGATAACCCCGGTC,6,852935
dgoRp,0.1875,93,79,CGAGATAATATCCACGGTTC,14,836872
dgoRp,0.8227848101265823,142,78,GGGGAAACTCCTGAAAGATA,64,847663
dgoRp,0.7341772151898734,135,78,GATCCGTTATCAGGCAGCAA,57,851931
dgoRp,0.4936708860759494,116,78,CGATCCCAGGCGTTGGCCAT,38,864691
dgoRp,0.23076923076923078,94,77,CACGTCAATAGAAAGGAGTT,17,836686
dgoRp,0.7272727272727273,131,76,TGTGCGACCTTAAGCAGAGA,55,851783
dgoRp,0.4,103,74,TCACAATGGTCTTAGTAGGT,29,836275
dgoRp,0.37333333333333335,101,74,CCAACCGGGCTCATTGCTGG,27,846420
dgoRp,0.2972972972972973,94,73,TGGAAGCCCATTAAGTGAGT,21,836292
dgoRp,0.3918918918918919,101,73,AAGGGCATCGGAGTCGTGAT,28,845652
dgoRp,1.2602739726027397,163,72,CAGTATCTTCACCACGGATT,91,836998
dgoRp,0.06944444444444445,75,71,CTGGAGGGAACACGAACAAA,4,845381
dgoRp,0.3055555555555556,92,71,CCATGTCGGAATCCTTCACT,21,837866
dgoRp,0.8169014084507042,127,70,CCCACAATCGTAAATTTCGC,57,857655
dgoRp,0.04225352112676056,72,70,AATGTCTGTCAGTGGGCACA,2,844940
dgoRp,0.15942028985507245,78,68,TGTCAAGGGGTAACACTGGT,10,850279
dgoRp,0.463768115942029,99,68,CGGACGGAGCGTCACAGCTG,31,856195
dgoRp,0.3382352941176471,89,67,TCCCAAATTGAGTACCGTCG,22,859142
dgoRp,0.4117647058823529,94,67,CCCGACTTAACGCCCCTTTC,27,849824
dgoRp,0.11940298507462686,73,66,GGCCGAATAAACGAGTTTGG,7,854222
dgoRp,1.3134328358208955,153,66,AAAGTGGCCTCGACGTAGAT,87,850742
dgoRp,0.8484848484848485,120,65,TATAAGTACATACTCGTCCG,55,851543
dgoRp,0.6515151515151515,107,65,TAATGGTACCTGCGAGGTCA,42,844345
dgoRp,0.7878787878787878,116,65,GGGAGCAAGCCCAGTGATCG,51,851704
dgoRp,0.696969696969697,110,65,GACCCCATTCTTTGTGGTCG,45,838170
dgoRp,0.8787878787878788,122,65,CATAACCCCATGTTACAGAT,57,835968
dgoRp,0.7121212121212122,111,65,ATACGCCATGAGTTCTCGAT,46,844944
dgoRp,2.276923076923077,211,64,CGGAGGGTAAGTGGCTTGGA,147,836119
dgoRp,2.4615384615384617,223,64,CCTTTCAGTATTCCTGAGTA,159,867255
dgoRp,0.265625,79,63,CCATGCAAGGTACGATGCTG,16,844637
dgoRp,5.125,390,63,ACAGACAGGCCCAACACACC,327,860616
dgoRp,0.07936507936507936,66,62,GTTAAGGAGCAGGCACGCTC,4,849822
dgoRp,0.2903225806451613,78,61,GGAGGAATCGTCCGAAGGCG,17,845644
dgoRp,0.3870967741935484,84,61,CACTCAGAATGCGAGTACTC,23,859915
dgoRp,0.1774193548387097,71,61,AGCAACTGCAGATCTTCCCG,10,856171
dgoRp,0.43548387096774194,87,61,AAGCTGGAAGTTTGGATCGA,26,861292
dgoRp,0.32786885245901637,79,60,TCCTGGCGACTACACCAGGA,19,853846
dgoRp,0.5409836065573771,92,60,TCCAGTCAAAGAGGGTCTTG,32,841398
dgoRp,0.4918032786885246,89,60,TCATATTCGCTGTACCGATC,29,865276
dgoRp,0.45901639344262296,87,60,TACTGGACGGTGTTGGTCGG,27,838624
dgoRp,0.18032786885245902,70,60,TACGTTGACTAGCAATGGAA,10,836360
dgoRp,0.6229508196721312,97,60,GTCGGTCATCCGTTGTCGGA,37,863748
dgoRp,0.15,67,59,TGGGTGGTCAGTATCGCTCA,8,836833
dgoRp,0.5,88,59,TAAAGTTGCTAAGGTAATTA,29,851033
dgoRp,1.0666666666666667,122,59,GCCGCGAGCCGCGTGTGCCA,63,839726
dgoRp,0.35,79,59,GAGCAGGTGACCTCAATGAG,20,835809
dgoRp,1.15,127,59,CGGTAAAACTCTTCAACAGG,68,837212
dgoRp,0.3,76,59,ATGGAGCGTAGCTCTGCACA,17,844623
dgoRp,0.95,115,59,ATAGTCGTTTGTGATCGCGC,56,836326
dgoRp,0.3728813559322034,79,58,CAACCTAAGATACATGCTAT,21,859449
dgoRp,1.4915254237288136,145,58,AAACCTCATAGGAAACGTAT,87,843306
dgoRp,0.034482758620689655,58,57,TGGCGGCATAGACGCTCGGT,1,846901
dgoRp,0.10344827586206896,62,57,GTTATAGCGCTCAGACAAAA,5,857234
dgoRp,0.896551724137931,108,57,GTGTCCTGCTCTTGTGCTTG,51,845256
dgoRp,0.1896551724137931,67,57,CTCGTACTAACGAATTATCA,10,838706
dgoRp,0.3448275862068966,76,57,CATGTAGATGGGGTAGATCA,19,848577
dgoRp,0.3275862068965517,75,57,AGGCTAGGATAATACTTCTT,18,852297
dgoRp,0.5517241379310345,88,57,AGAGTTGTAGCCTCTGTGCA,31,840300
dgoRp,0.7758620689655172,101,57,AAAGTGCGGAGTTGAGCAGA,44,863205
dgoRp,0.38596491228070173,77,56,TGTTCAGGCCTCGCTTTGCA,21,846497
dgoRp,0.2982456140350877,72,56,TGGTAGTTTGTCCGTCCTAC,16,848789
dgoRp,0.12280701754385964,62,56,GGGGCGATGGGTTTAATGAC,6,867176
dgoRp,0.3333333333333333,74,56,CTGTGCTTCTCGGGCACCGT,18,840402
dgoRp,0.24561403508771928,69,56,CGGCAGGGCAGCTTAGGGTA,13,843068
dgoRp,0.5892857142857143,87,55,CGTATCAGGAGATTCGGATT,32,862305
dgoRp,0.5,82,55,AGGACTAACATTCAACAGTG,27,836218
dgoRp,0.07142857142857142,58,55,AAATACTGACCCGTGACTTT,3,843962
dgoRp,1.7818181818181817,151,54,TTCTATTTCCCCGCACCTAT,97,838595
dgoRp,0.7636363636363637,95,54,TACTTCACACGGCAAGAGTG,41,836751
dgoRp,0.36363636363636365,73,54,CGGCCGGACAGGTATGGGCT,19,857290
dgoRp,2.1818181818181817,173,54,CGCTAACCGTAAACTCAGCC,119,842704
dgoRp,1.1272727272727272,115,54,CAAGTCTACAAGATCAGATA,61,841841
dgoRp,0.37037037037037035,72,53,TCTGCGAGGTATAAACATAT,19,850174
dgoRp,0.037037037037037035,54,53,TCGGCATATCACACATTTGA,1,841640
dgoRp,0.5185185185185185,80,53,GTGCCGGGGAAACTTCGGTT,27,859246
dgoRp,0.6296296296296297,86,53,GACTTAGGTTTGATTGATAA,33,835923
dgoRp,0.14814814814814814,60,53,CGTCTACAGATCCAGCGTAG,7,835945
dgoRp,0.12962962962962962,59,53,CGGCTATGTAACGAGGCAAC,6,844446
dgoRp,1.1111111111111112,112,53,CCATACTTCCATATAAAGTT,59,845607
dgoRp,1.6296296296296295,140,53,AATGGCCAGTTTACGATTCG,87,858989
dgoRp,0.2777777777777778,67,53,AACACAGCCTAGCATGGAAG,14,841420
dgoRp,0.5660377358490566,81,52,TGTTACGGTATGAATGGCCG,29,852565
dgoRp,0.07547169811320754,55,52,GTCAACCCCGCAGCGGGATT,3,836263
dgoRp,5.0754716981132075,320,52,GCGTGCGTGGCGGATATAAT,268,843986
dgoRp,0.3584905660377358,70,52,CTCTACCGCATCTGAAGCGT,18,861091
dgoRp,1.1320754716981132,111,52,AGCTAATTAAGGCTTCGAAC,59,844264
dgoRp,0.9038461538461539,97,51,TCAATGTTCCGGTTAGATCA,46,836533
dgoRp,0.46153846153846156,74,51,GTTTACGAGAATAGCCTACA,23,839639
dgoRp,1.0576923076923077,105,51,CGGAAGACCTAGCCAGGAGC,54,855049
dgoRp,0.28846153846153844,65,51,ATCCTGATGCCGCCAGACGA,14,855126
dgoRp,0.5192307692307693,77,51,AAGGTACTTACGTACGTGCA,26,843254
dgoRp,0.35294117647058826,67,50,TTTCTTCTCATCCGGGACCC,17,859209
dgoRp,0.6274509803921569,81,50,TTCGAAACTGCCACGTACGA,31,850618
dgoRp,1.6274509803921569,132,50,TGTTAAACCCATCGATCGTT,82,844124
dgoRp,0.6666666666666666,83,50,TGCATTTAAAACCGAGTATA,33,847912
dgoRp,0.3333333333333333,66,50,TCCCCACTTAGGTAAGCGTA,16,840656
dgoRp,0.5490196078431373,77,50,GGGACACACAGTTGGTATAT,27,843124
dgoRp,0.43137254901960786,71,50,GCGTTTCTCTGCCTAATTAT,21,857928
dgoRp,0.6078431372549019,80,50,GACGGGGCCACGGTCGCTGA,30,838667
dgoRp,0.0392156862745098,51,50,GAAGAGGCTAACTGTCTCCA,1,852196
dgoRp,0.2549019607843137,62,50,CGTAGTCCACGGAGGAGGCC,12,839336
dgoRp,0.3137254901960784,65,50,CGGAATGTCCTGTATGACGC,15,835967
dgoRp,0.6666666666666666,83,50,CACTTTGTAACCATTTTTAA,33,848891
dgoRp,0.42,69,49,TGACTGAGGGTCACCGGGAA,20,851657
dgoRp,0.24,60,49,GGCAGTTTTCAAACCCTATA,11,840212
dgoRp,0.2,58,49,GCGAGTCGTACACCCCCCTA,9,837398
dgoRp,1.32,114,49,GATGATGCAGCGGCTAGATG,65,838452
dgoRp,0.62,79,49,CTTATAACCGCTTTTAACAT,30,840476
dgoRp,1.02,99,49,CTCTATAGTGCGCTCCTCGC,50,838187
dgoRp,0.2,58,49,CTATTCTGTATAAAAAGGCT,9,841275
dgoRp,1.18,107,49,CGGTAGAGCAGGTCTGGACC,58,854453
dgoRp,0.38,67,49,CCGTCGGCGGGGGCAAATCA,18,836448
dgoRp,0.9,93,49,CCGCATTTTCCGCCTTACAT,44,849639
dgoRp,0.52,74,49,CACCTTCCTATCTGGTTTCT,25,839699
dgoRp,1.04,100,49,AGGGAAGAGCCATACAAACA,51,849381
dgoRp,0.82,89,49,AGAAGCTTAGAGGGCAATAA,40,857829
dgoRp,0.32,64,49,ACTACGCACATTGTAAATAG,15,837427
dgoRp,0.92,94,49,ACGCTCGTAGACGCCGTTAG,45,838828
dgoRp,0.30612244897959184,62,48,TTAGGCAGCCCGTGCCCGTA,14,837921
dgoRp,0.2857142857142857,61,48,TGTCCTGACCCCCTATCGCA,13,838716
dgoRp,1.2653061224489797,109,48,GGGTTTGGTCGTGAAGTTTA,61,841591
dgoRp,0.3877551020408163,66,48,CTATCGCATATTACCTGAAT,18,858464
dgoRp,0.14285714285714285,54,48,CACCCTCATCGCTACATATG,6,845438
dgoRp,0.3125,61,47,TGCGTCTAACGCAGAATCTT,14,849710
dgoRp,1.4166666666666667,114,47,TCTTCTCAAGATGCACAGCA,67,845501
dgoRp,0.625,76,47,TCCTGCTCCCGTTATCTAAT,29,841931
dgoRp,0.2708333333333333,59,47,CTGTATCGGATCAAGGCGTC,12,839886
dgoRp,0.041666666666666664,48,47,CTGCACCGCCTGGTCAGTTT,1,856672
dgoRp,0.3958333333333333,65,47,CGGTTAGCACATCGTGTGGA,18,864317
dgoRp,0.0625,49,47,ATACGCGGGTACGATCGCTT,2,861662
dgoRp,0.3333333333333333,62,47,ATAAGCAAGTCATATTACGC,15,849315
dgoRp,0.7708333333333334,83,47,AACCCGCGCCTTTATAGACA,36,851926
dgoRp,0.10638297872340426,50,46,TTACGCTCGTTCAATAAATC,4,839388
dgoRp,0.0425531914893617,47,46,GAGGCTCTTCTGTTCTAATT,1,856273
dgoRp,1.1063829787234043,97,46,GAACAATAAGGCTTTCGTCC,51,867216
dgoRp,0.3404255319148936,61,46,CGATAGTTTGAGAACTCGTC,15,850055
dgoRp,0.5531914893617021,71,46,CCCACGCAGACCAGGGTGAT,25,838576
dgoRp,0.2765957446808511,58,46,CAGACGACCAGGATTCGAAC,12,851585
dgoRp,0.6170212765957447,74,46,AGGGCCATGTCTTGGCGTAG,28,839890
dgoRp,0.3829787234042553,63,46,AGGAATGTATCGCACCTAAT,17,851669
dgoRp,1.3191489361702127,107,46,ACCACGTGCCTCGGGACTAT,61,844217
dgoRp,1.0,92,46,ACACGGGGCGTCTCAACAAT,46,851400
dgoRp,1.6595744680851063,123,46,ACAAGGGTTTTACCTTTTTG,77,840400
dgoRp,0.21739130434782608,54,45,TTCGAAACTTACGGCTGTAG,9,855952
dgoRp,1.326086956521739,105,45,TCGGTCAAGCGAGCTTTATG,60,845721
dgoRp,0.5217391304347826,68,45,TAGGGGTTATGCTTTTAGAA,23,854519
dgoRp,0.1956521739130435,53,45,GCAATGAATGGGTCAGAATA,8,865564
dgoRp,0.5217391304347826,68,45,GAGAAGCGACTTATGGCTGA,23,865371
dgoRp,0.10869565217391304,49,45,CTCGGGGATCATTCAGGGAT,4,848469
dgoRp,0.34782608695652173,60,45,CGGGTCTCCTACATTGACTT,15,845498
dgoRp,0.32608695652173914,59,45,CGCTTGGGGACTCCCTCGAA,14,840213
dgoRp,0.4782608695652174,66,45,CGCGAGCGTTGCGACTATAG,21,852649
dgoRp,1.673913043478261,121,45,CGAGTTCACCGGAATGCGGA,76,849631
dgoRp,0.34782608695652173,60,45,CCGGCGTGGCCACTTACCGA,15,836937
dgoRp,0.5652173913043478,70,45,CACCCCACAATATTCAGTGG,25,840604
dgoRp,0.43478260869565216,64,45,AGATACATACGTCCGCGGCA,19,846599
dgoRp,0.08888888888888889,47,44,TTACACGGAGTGTCGCGGAC,3,836694
dgoRp,0.4444444444444444,63,44,TAGGACGGACTTCAGAGGAG,19,847800
dgoRp,0.3333333333333333,58,44,GTCCGGGTATTAGAGCAATT,14,837994
dgoRp,0.044444444444444446,45,44,GGCTGCTTTATAGGCGCAGT,1,838805
dgoRp,0.9555555555555556,86,44,GCGGGGCGGTCGGCGAAATG,42,853399
dgoRp,0.7555555555555555,77,44,CTAGGCTGCAATCATAGGCA,33,838545
dgoRp,0.5555555555555556,68,44,CCCAGCAGCGGTCGTTTGTC,24,837895
dgoRp,0.2222222222222222,53,44,CCATTCTAGGAACCTCGGAC,9,836098
dgoRp,0.6444444444444445,72,44,AGGTCCTTTTCCGGAACAAA,28,840183
dgoRp,0.5111111111111111,66,44,AAATTACGGCGAGTGGGATA,22,865056
dgoRp,0.45454545454545453,62,43,TGTCCTTCGGCCGGGGTAGT,19,844927
dgoRp,0.5227272727272727,65,43,TGGCGATCACCCGACATTTA,22,845548
dgoRp,1.2954545454545454,99,43,TAAATTACTACCGTCAAGGT,56,840456
dgoRp,0.8636363636363636,80,43,GGTAACGACTCGGTTTCTTA,37,838691
dgoRp,0.3181818181818182,56,43,GAATAAATGGGTCAATCGGA,13,853632
dgoRp,1.0227272727272727,87,43,CGCAGACGTGCGTTTGCCAG,44,852035
dgoRp,0.8863636363636364,81,43,CCGTACCTTCGTAAGCCCTT,38,835993
dgoRp,0.4318181818181818,61,43,CATCGCATGGAGCGGCAGAT,18,849925
dgoRp,0.09090909090909091,46,43,CATACATAGGCTCGGTGGCA,3,865904
dgoRp,0.36363636363636365,58,43,CAGATCAGGTCAGTTAACCC,15,843791
dgoRp,0.2727272727272727,54,43,CACACCTGAACTGAAGCTCG,11,841012
dgoRp,0.2727272727272727,54,43,ACGATCAACACCGCGAGCCG,11,839897
dgoRp,0.45454545454545453,62,43,AATTCTGCTGCACGGTCTTC,19,836972
dgoRp,0.4318181818181818,61,43,AACATGAACCTAACATTGGA,18,839135
dgoRp,0.09090909090909091,46,43,AAAGGCTGAATCCAACTCAA,3,845242
dgoRp,0.06976744186046512,44,42,TTCGAGATTTGAAAACACTA,2,836999
dgoRp,0.27906976744186046,53,42,TTCCAAATGGAGCTCGCTCT,11,861808
dgoRp,0.4883720930232558,62,42,TGTTCCAGCCTCAGCGAATC,20,840301
dgoRp,0.4883720930232558,62,42,TGAGGTGAACGTTGAGTTTA,20,847515
dgoRp,0.5813953488372093,66,42,TGAGACAGTATCGAGGGTTC,24,858106
dgoRp,1.0930232558139534,88,42,GACGCTGTGACTATCCATCA,46,853805
dgoRp,0.37209302325581395,57,42,CCTTCGCAATCATTTTTTTA,15,847736
dgoRp,0.9069767441860465,80,42,CCTTAGAAAGACTAGACCGA,38,845441
dgoRp,0.27906976744186046,53,42,CCATACGAGGCCGCGAGGAA,11,863529
dgoRp,0.3953488372093023,58,42,CATGTGTTACAGGAGCAATG,16,847408
dgoRp,0.6744186046511628,70,42,CACCCAAGGCAGTACCCCCC,28,852002
dgoRp,0.046511627906976744,43,42,CACAGGGAGTACGGTCCCGT,1,842131
dgoRp,0.3023255813953488,54,42,CAAGTAAGGACGGCTAGCAG,12,857417
dgoRp,0.9302325581395349,81,42,AGGGTAGACAGCAACAATAA,39,851611
dgoRp,0.27906976744186046,53,42,AGCTATTGCGCGATACTTGT,11,844687
dgoRp,0.6511627906976745,69,42,AAAGAAAATAAGGTAATTCT,27,837079
dgoRp,0.5,61,41,TCCCAGGGAGGCTTGCCCAA,20,848777
dgoRp,0.9761904761904762,81,41,TCACCAAATAACGCGTTCCT,40,866783
dgoRp,0.5476190476190477,63,41,GTGCTAGTTTGAGAGAACCG,22,853585
dgoRp,0.11904761904761904,45,41,GGGTTAAATTTTGGAGGCTG,4,838510
dgoRp,0.11904761904761904,45,41,GGGAGTTTATAATGTCGTAA,4,848292
dgoRp,1.1428571428571428,88,41,CCGGCCTTCAACAAGAATTA,47,857070
dgoRp,0.07142857142857142,43,41,CCAGTCCTGCCAGAACGGCT,2,853545
dgoRp,0.6666666666666666,68,41,CATATCCCCGAGGCCGACAC,27,838053
dgoRp,0.07142857142857142,43,41,ATGGGAATCCACTGAAGCCT,2,852964
dgoRp,0.047619047619047616,42,41,AAATAATCTGTCAGCACATA,1,858000
dgoRp,0.43902439024390244,57,40,TTTGCCACCGGGCACAGATC,17,845220
dgoRp,0.4146341463414634,56,40,TTGGCCTCGGGGTTGAGGTA,16,839128
dgoRp,0.7804878048780488,71,40,TTAGAGGACACAGAGTTACA,31,836247
dgoRp,0.9512195121951219,78,40,TGCTCAGGTACAGGGCAGGA,38,861729
dgoRp,0.12195121951219512,44,40,TCCCAGGGACGAACATCCGA,4,844317
dgoRp,0.6585365853658537,66,40,GTGCAAGATGACCCCGGGTA,26,862524
dgoRp,0.21951219512195122,48,40,GCGGTCCACTATTTGGTTTA,8,857423
dgoRp,0.5609756097560976,62,40,GAGTGTTACGGATACACTAA,22,845794
dgoRp,0.4634146341463415,58,40,GAAGGGCGTTATCGCGCGGA,18,840741
dgoRp,0.04878048780487805,41,40,CTCGCGCGGGCTTAGGAAAG,1,840619
dgoRp,2.926829268292683,159,40,CTAGGGGCCGATTGGTATTA,119,858139
dgoRp,0.12195121951219512,44,40,CGGGAGCCCCTGTCCAACGT,4,845770
dgoRp,0.43902439024390244,57,40,CCGATCTAAAAAACATGGTG,17,842963
dgoRp,0.7073170731707317,68,40,CAGGACTCGGCTTAATTATT,28,838289
dgoRp,0.2682926829268293,50,40,ATCGCTCCGCGAGAGGACCA,10,837081
dgoRp,0.175,45,39,TTTTCAGGTATAAGTGTCCT,6,849335
dgoRp,0.875,73,39,TTTACCCCTTCGCGGAAGAG,34,856871
dgoRp,0.05,40,39,TTGCAGGAGGCTTTCTCTTC,1,847075
dgoRp,0.725,67,39,TGGGCTGGTCCTCCCGCTCC,28,848525
dgoRp,0.975,77,39,TCGGTGGTTGCGCACTTTTG,38,845899
dgoRp,0.225,47,39,TAACTGGCTAGCGACATAAG,8,856917
dgoRp,1.525,99,39,GGTGTGCTGCTCGGGACCCT,60,846600
dgoRp,0.325,51,39,ATTGATCCCCCTGAGCACAG,12,845957
dgoRp,0.75,68,39,AAGTTCCTTGTTGCTGACGT,29,839389
dgoRp,0.8974358974358975,72,38,TTTGAGGCGAGCTCGATTGT,34,863889
dgoRp,1.3076923076923077,88,38,TTATATCGTCAGGTCATCAA,50,841538
dgoRp,1.0769230769230769,79,38,TGATGCTCGACTGTTTGCCT,41,836222
dgoRp,0.07692307692307693,40,38,TCTTAAACTCACACATTGGG,2,842099
dgoRp,0.6666666666666666,63,38,GTAATCAGCCTATAAATTGA,25,862516
dgoRp,0.5128205128205128,57,38,GGTCAGGCGCCTCAGCTTGT,19,849063
dgoRp,0.20512820512820512,45,38,GGCAAGGGTCTACTAAACTA,7,845361
dgoRp,2.5128205128205128,135,38,GACTCAAACGGATGCGCCCA,97,854051
dgoRp,0.2564102564102564,47,38,CTGATTGATTGCAGCGTTCT,9,860140
dgoRp,0.3333333333333333,50,38,CGTTACACCTAGAGAACCAT,12,843468
dgoRp,0.46153846153846156,55,38,CGGGGCCTGCTTGGGGTATA,17,842180
dgoRp,1.6923076923076923,103,38,CGAATTACATATACATGTTA,65,855818
dgoRp,0.38461538461538464,52,38,ACGAAAGGAGTAAGGTTCCG,14,850620
dgoRp,0.05128205128205128,39,38,AATACCGTAACCTGGTGCGA,1,851659
dgoRp,0.10256410256410256,41,38,AAGGCGACGAGTCACTTCTG,3,863411
dgoRp,0.2894736842105263,47,37,TTCCTTGGGAACTTCGGAAA,10,845719
dgoRp,0.6052631578947368,59,37,TGACATGGGTAGTGTGTGAC,22,838219
dgoRp,0.7368421052631579,64,37,GTGCGTCGTGATGAGTCCTT,27,838290
dgoRp,0.2631578947368421,46,37,GGTAAAGGCGTCTCCGGATT,9,854609
dgoRp,0.05263157894736842,38,37,GGCTATTGATATTACATCTG,1,848510
dgoRp,0.9736842105263158,73,37,GGCAATTAGAACACAATTAT,36,838804
dgoRp,0.5789473684210527,58,37,GCACTGGAACCTCGTCTGAG,21,858394
dgoRp,0.9473684210526315,72,37,GAGCACCAAAAGGTATTTAG,35,838543
dgoRp,0.2894736842105263,47,37,CTAAGCAGTCCCATCACCCC,10,843714
dgoRp,0.15789473684210525,42,37,CGCGTCTGTGCGTATCCGAT,5,845758
dgoRp,0.5263157894736842,56,37,CCTGTCATGCGCATGCCGTA,19,865119
dgoRp,0.7631578947368421,65,37,CCTAGACGCCAATAGTTTAG,28,866653
dgoRp,0.3684210526315789,50,37,CAATCTAGTCGGAGCTTTTG,13,839963
dgoRp,0.5,55,37,CAAGCCCTCTATGCGGTTAG,18,841552
dgoRp,0.05263157894736842,38,37,ACGCGCAGAGGCTACCCTAT,1,857834
dgoRp,0.05263157894736842,38,37,AAGCAAACTCGCGTAGGGGC,1,861857
dgoRp,1.105263157894737,78,37,AACAGGATTCCAATAGTACG,41,841933
dgoRp,0.43243243243243246,51,36,TTTTAAGGGAACACTTTTGG,15,839245
dgoRp,1.837837837837838,103,36,TCCGATGTCCGTCGGGCGAG,67,840473
dgoRp,0.43243243243243246,51,36,TCATCTGGTCAACGGCACTC,15,839765
dgoRp,0.05405405405405406,37,36,GGACAGAAGCGACCTCACAA,1,841125
dgoRp,0.05405405405405406,37,36,GCGAGGATGAAGGAAAACAA,1,858859
dgoRp,0.7297297297297297,62,36,GCCACCGGCCATCGTCGGCA,26,850353
dgoRp,0.8918918918918919,68,36,GAGGCAGGTATTGTTAGTTG,32,845728
dgoRp,0.6216216216216216,58,36,CGGTGTACATGATCCACATA,22,849870
dgoRp,0.5945945945945946,57,36,CGCTTTGTGGGTTGCGGCCA,21,853638
dgoRp,0.1891891891891892,42,36,CGCATCACGATGAGGACGTT,6,844492
dgoRp,0.35135135135135137,48,36,CGATCGTTGACAACTAGCGT,12,858714
dgoRp,0.6486486486486487,59,36,CCCAGCACTGGCCCACAGGT,23,845333
dgoRp,0.6216216216216216,58,36,CATTTACAATTACTCTTGTG,22,844584
dgoRp,0.32432432432432434,47,36,ATTTGTCGTACGTAGCGCTA,11,854390
dgoRp,1.3513513513513513,85,36,AGGTGCTATTTAGTCTGGTA,49,842986
dgoRp,0.9459459459459459,70,36,AGAGGATTCGTACGGTCCGT,34,853679
dgoRp,0.35135135135135137,48,36,AGAGATGGCGTTCAAGGACG,12,858680
dgoRp,0.4864864864864865,53,36,AAACCCTGTCCTTTACACGG,17,836268
dgoRp,1.1944444444444444,77,35,TTTCAAGGGAGCACGTCGTT,42,861594
dgoRp,1.1111111111111112,74,35,TGTAGATGATCATATAACCT,39,837440
dgoRp,1.4444444444444444,86,35,TGGATCTAAAACAGCATGTA,51,850484
dgoRp,0.9166666666666666,67,35,TGCCAGTTGCGCGCTGGACA,32,853804
dgoRp,1.0,70,35,TCGTCGCATTGAAACTTTGT,35,840794
dgoRp,0.2777777777777778,44,35,TCGGGTATGCGCCAAGTATT,9,837503
dgoRp,0.16666666666666666,40,35,TCGACGGCTTTCCAGGCGAT,5,854417
dgoRp,0.8333333333333334,64,35,TCCAAAGGCAGTCCTTTCAT,29,845583
dgoRp,0.6111111111111112,56,35,TACGCATAAAAGATTGACAA,21,849134
dgoRp,1.5555555555555556,90,35,GTGAGTCTCCTTTAGCATGA,55,849185
dgoRp,0.08333333333333333,37,35,GGGTACTGCTGGTGATTTCA,2,846778
dgoRp,0.5,52,35,GGCCCAGTAGTTGTAACTTA,17,858487
dgoRp,0.2222222222222222,42,35,GAGCGCTCAACTGTTGGTAA,7,842259
dgoRp,1.1666666666666667,76,35,CTGGACGTTCGGACGGCACC,41,851404
dgoRp,0.05555555555555555,36,35,CGGTTCCTATAGTGACCCGA,1,849773
dgoRp,0.5277777777777778,53,35,CGATAGTGGCTGCGAGATCT,18,853350
dgoRp,0.8055555555555556,63,35,CCGGCTCTGACGCACTCTAT,28,838574
dgoRp,0.4166666666666667,49,35,CATGTGGCTGGAGTAGGGCG,14,855105
dgoRp,1.0277777777777777,71,35,CATCGTGAGGGGACTCCGTT,36,836162
dgoRp,0.19444444444444445,41,35,ATGAGGCGCACGAGGTCAAT,6,839310
dgoRp,0.6666666666666666,58,35,AGTTGGTGAAGTTATTCGGG,23,839636
dgoRp,0.05555555555555555,36,35,AGGCGTTAATACGAATGTAT,1,858788
dgoRp,1.5833333333333333,91,35,AGCATCATTCCATGTAATCA,56,866920
dgoRp,0.2222222222222222,42,35,AATCCCGACTTGAATGAAAC,7,842907
dgoRp,0.25,43,35,AATACCTGTCTCGAAGTCAG,8,858858
dgoRp,0.7777777777777778,62,35,AAGTCTGTGAGCGAGAGCGA,27,853247
dgoRp,0.2857142857142857,43,34,TTCCAAGTAACTCATTCTAG,9,841261
dgoRp,0.6571428571428571,56,34,TGATAAAACATGCTCCTACT,22,850022
dgoRp,2.5428571428571427,122,34,TCTACCGTATGATTCGTCTG,88,856086
dgoRp,1.3714285714285714,81,34,TCCTTGTACGCGTGAGTGGT,47,864067
dgoRp,2.085714285714286,106,34,TCCTAACACAACTACGTCTT,72,840636
dgoRp,0.3142857142857143,44,34,TCCCACAACCCTCTCCCTAT,10,839086
dgoRp,0.6,54,34,TATGGAGATTCGGTTAGTTA,20,842482
dgoRp,0.17142857142857143,39,34,TATGAGTGTGCTGACTGTAA,5,848569
dgoRp,0.2,40,34,TAGGCTGTCTCAGGCAGCGC,6,847951
dgoRp,1.3142857142857143,79,34,GTCTCCCGGCGCACAGAATG,45,841983
dgoRp,1.0285714285714285,69,34,GTAGTCGCATAACCTAGCGA,35,845679
dgoRp,0.8571428571428571,63,34,GGGCCGGACTCCATACGGGG,29,847196
dgoRp,0.4,47,34,GGCTCCGGCACACATTTAAC,13,846234
dgoRp,0.8857142857142857,64,34,CTAAATGGCGGGCTGGTCCT,30,840597
dgoRp,1.1142857142857143,72,34,CGGGGGCTATATATGTGACT,38,841887
dgoRp,0.6285714285714286,55,34,CCTCAGCACCAGTAGAGTAC,21,863728
dgoRp,2.9714285714285715,137,34,CCGGCACAAGGGGTCTCATG,103,840827
dgoRp,1.0285714285714285,69,34,CCGGAAAAGAGTAGAATTAG,35,856105
dgoRp,0.8857142857142857,64,34,CATCCTACGGGTGTTAGGAA,30,861315
dgoRp,1.2285714285714286,76,34,CAGGCGTTAATAGGCGCTGC,42,850086
dgoRp,1.1714285714285715,74,34,ATCTCACCCAATGCTCGAAC,40,836418
dgoRp,0.6285714285714286,55,34,AGAAGTCAGGCCGCTTAATG,21,847439
dgoRp,1.8571428571428572,98,34,ACGCACATGCTATAGAACGT,64,839331
dgoRp,1.4,82,34,ACAAAGAGCCTCTATGGGCT,48,841932
dgoRp,1.3142857142857143,79,34,AAGGACGGGACTCTGTTTTT,45,862522
dgoRp,0.6,54,34,AAGATGTGGTGTTGGACACA,20,850730
dgoRp,0.2857142857142857,43,34,AACTGACAATGGGTGGCTGT,9,835887
dgoRp,0.8235294117647058,60,33,TTCCCTCGTCACACGTCAAC,27,850655
dgoRp,0.5882352941176471,52,33,TGGTGCCTAGAACAAGCTTT,19,842609
dgoRp,0.14705882352941177,37,33,TGGACGGTCGTGGACTAATG,4,853772
dgoRp,0.20588235294117646,39,33,TCGATCATGTGTTTTTAAGA,6,838522
dgoRp,0.058823529411764705,34,33,TCCAAAAGTACGTGAGGAAC,1,859290
dgoRp,1.0,66,33,TACCGTGCATCGGCCCACAG,33,850820
dgoRp,0.7941176470588235,59,33,TACCGTCGCTTTCGGTGCAT,26,854608
dgoRp,0.29411764705882354,42,33,GTTTCGTGTCTTCAGGTGAT,9,860323
dgoRp,0.5,49,33,GTTCTCCCTGGAAGCTCAAT,16,859867
dgoRp,0.3235294117647059,43,33,GTCTTGCGGTAGAGTGACCT,10,863574
dgoRp,0.6176470588235294,53,33,GGGTCAGCAAATTGTCCAAG,20,840287
dgoRp,0.4411764705882353,47,33,GATGGCCACAGAATATCAAA,14,847053
dgoRp,1.0,66,33,CTGAGGGCACTCCTCGCGAT,33,854957
dgoRp,0.5588235294117647,51,33,CCGGTTAGTCCGTACAGCGC,18,849533
dgoRp,0.5294117647058824,50,33,CCCTCACCTATGTATGCCTT,17,840639
dgoRp,0.058823529411764705,34,33,CCCGTGGGCGGATAGGATTA,1,836276
dgoRp,0.7647058823529411,58,33,CACAATGGACCCGTACCCGT,25,847206
dgoRp,1.2352941176470589,74,33,CAACGTAAGAGGAGAGGCTT,41,836859
dgoRp,2.823529411764706,128,33,CAAATACGTGTGAAGTATCT,95,839745
dgoRp,1.2058823529411764,73,33,ATCAAAGCAGAAAGGTATGG,40,859511
dgoRp,0.058823529411764705,34,33,AGTCGGCTTGTGCAACTATT,1,841690
dgoRp,1.2352941176470589,74,33,AGCATGAATAGTTAAGGAAT,41,863814
dgoRp,1.1470588235294117,71,33,ACCAGCTTGCGGGCAAGGAG,38,865260
dgoRp,0.47058823529411764,48,33,ACAGTTAACTAACGATTTCG,15,842024
dgoRp,0.21212121212121213,38,32,TTGCACGAGTGTTAGCGTTT,6,841571
dgoRp,0.36363636363636365,43,32,TTAAACTAACTGAATTGAGA,11,836101
dgoRp,0.3333333333333333,42,32,TGATCCCTCCCGTGTGACAT,10,859269
dgoRp,0.6363636363636364,52,32,TGAGGCCCGACACGAACAAT,20,853116
dgoRp,0.8787878787878788,60,32,TGACTGATATTTAATCGCCT,28,836858
dgoRp,0.24242424242424243,39,32,TCAAAAAAGGCCATCCATGA,7,841058
dgoRp,0.3939393939393939,44,32,TAAAACCCACGTGACCGGCT,12,836058
dgoRp,0.6363636363636364,52,32,GTTACACTCTTGTAAGAACA,20,841969
dgoRp,0.36363636363636365,43,32,GGCGTAGCCCACTATCACGT,11,841731
dgoRp,0.8787878787878788,60,32,GGAGACTGGGCCTATCGCTA,28,842494
dgoRp,0.42424242424242425,45,32,GAGTCTGGCACCTTTTTGGC,13,849782
dgoRp,2.121212121212121,101,32,GACTTAAGTAAGTATTGAGA,69,854948
dgoRp,0.696969696969697,54,32,GACGCAGCCCTCTCCAAGTA,22,855188
dgoRp,0.3333333333333333,42,32,GAAGAAAGAACCGAGTCCTG,10,856006
dgoRp,0.30303030303030304,41,32,CGGTACAAAGGAACAGCAAC,9,841521
dgoRp,0.06060606060606061,33,32,CCGTGAGCCCTCCTATTTGA,1,857904
dgoRp,2.4545454545454546,112,32,CATCTGCAGGGTACGGTCAT,80,844193
dgoRp,0.36363636363636365,43,32,CACATCGCTGAAGCCGCCGA,11,864761
dgoRp,1.696969696969697,87,32,ATTAAGTTTCGGATTCCAAA,55,843299
dgoRp,0.6363636363636364,52,32,ATGCGTCATTAGGCGGGGAA,20,861312
dgoRp,0.2727272727272727,40,32,ATATCTGTGAGAACATGTGT,8,844448
dgoRp,0.48484848484848486,47,32,ATACATCAACAGACGGTGTA,15,864305
dgoRp,0.8181818181818182,58,32,AGAGTCATATGGACTTCAAG,26,853945
dgoRp,0.696969696969697,54,32,ACTTGGTATGATGGTGCACC,22,850411
dgoRp,0.8181818181818182,58,32,ACAGTAACAACGCAGATCTT,26,858427
dgoRp,4.848484848484849,191,32,AATGGGCAAGCATTGCGTCA,159,851617
dgoRp,1.6363636363636365,85,32,AAGGCATTGCCAAGAGTATC,53,861229
dgoRp,0.4375,44,31,TTGTGCGTGAGTAGCACTTA,13,866445
dgoRp,0.28125,39,31,TTGACCTTGCAAGTTATACA,8,842179
dgoRp,0.15625,35,31,TTAACACCTTAACTCCATTC,4,850714
dgoRp,0.84375,57,31,TGCGTAAAAGTGCGTACTTA,26,839562
dgoRp,1.1875,68,31,TCGCAAGTTTCGCACCGAAG,37,846450
dgoRp,0.8125,56,31,TCCCCGCTTAAGTAAGTGGT,25,844122
dgoRp,0.25,38,31,TCAAAGCCAGACCTTTCAGA,7,839638
dgoRp,0.5625,48,31,TACCGCTAATACTCAGTCAG,17,850754
dgoRp,0.65625,51,31,TAAGACTGTGGAGACTTCAT,20,841774
dgoRp,0.75,54,31,GTGGTAAACACCTAAATCGA,23,846056
dgoRp,0.625,50,31,GGCTCTGCTTTACGTAAAAG,19,838580
dgoRp,0.4375,44,31,GGCCCCATACCCGATCGTGG,13,838254
dgoRp,0.65625,51,31,GCGTGGATCCATTCTTAAAC,20,836873
dgoRp,1.03125,63,31,GCCGCGTATCGGACTTACGT,32,841840
dgoRp,0.96875,61,31,GATTTTCCCGCGAGCCAGTC,30,837275
dgoRp,1.0625,64,31,GAGATGTGCTGCTCTATCAG,33,836834
dgoRp,0.34375,41,31,GAGACCTCGCGGTGTGGTGG,10,846177
dgoRp,0.0625,32,31,CTTGACCATAAGTCTTGTTA,1,845235
dgoRp,1.84375,89,31,CTGGGGAGACCCACGCGTTC,58,841838
dgoRp,0.3125,40,31,CTCCCATCCGAGGGTGAAAA,9,837138
dgoRp,0.15625,35,31,CTAGTTAGGTCAATGTCGCA,4,846931
dgoRp,0.25,38,31,CGGAAGCTGTTAGAATGGTA,7,842057
dgoRp,0.75,54,31,CGATTTATAGGTATAGAGTT,23,838878
dgoRp,0.4375,44,31,CGAGCAGTAAATTTTCCGTT,13,846543
dgoRp,0.3125,40,31,CCCAAATACATCTTTTGATG,9,838162
dgoRp,0.25,38,31,CCACAATGAGCAGTAGGTCA,7,838956
dgoRp,0.75,54,31,CAGTCAACATACATCAAAAG,23,849397
dgoRp,0.59375,49,31,CAGCAGGGATATCATAGGTC,18,854490
dgoRp,0.625,50,31,CACATGCCTGGGTCAATAGC,19,838890
dgoRp,0.9375,60,31,ATTCGGTTTATCATTTGACT,29,865129
dgoRp,0.0625,32,31,ATGACAGGATCCGCCACATA,1,849884
dgoRp,0.875,58,31,ATCTAAACGGGACTCCTTTA,27,855616
dgoRp,2.125,98,31,ATCCCGTAAAGGCCACAGTT,67,856117
dgoRp,0.46875,45,31,ACCTAAAGCGTGCCTCAAGA,14,841687
dgoRp,0.6875,52,31,AACGTGCTGAGGGAACGGCC,21,852257
dgoRp,0.8387096774193549,55,30,TTGTCATACAGCGTGGACAT,25,849829
dgoRp,0.45161290322580644,43,30,TTCCTCTGGTAGGCCGACGT,13,848898
dgoRp,0.7741935483870968,53,30,TTCACCGCTCGGATACTGTG,23,852234
dgoRp,0.3225806451612903,39,30,TCGCTATCAGAGATCACGAT,9,844744
dgoRp,0.3225806451612903,39,30,TCCGCAAGTTCATTTCACAT,9,841363
dgoRp,0.3225806451612903,39,30,TATTTCTAGGTTAGAGAGCG,9,842979
dgoRp,0.7419354838709677,52,30,TATTGTAACCTCCGAGTCCA,22,866454
dgoRp,2.6451612903225805,111,30,TACTCTTGCGCCACGATCAT,81,855250
dgoRp,0.0967741935483871,32,30,TACTAGAGTAAGATCACCTG,2,842818
dgoRp,1.5483870967741935,77,30,TACCTTTCGATGGATACTAT,47,855634
dgoRp,0.7419354838709677,52,30,GTGATGCATAGTGCCCTGAC,22,842258
dgoRp,0.45161290322580644,43,30,GTACTTCCAGTTGAAGTCAT,13,850061
dgoRp,0.12903225806451613,33,30,GGGTTTGGATCGGATTTTCA,3,860882
dgoRp,0.3225806451612903,39,30,GGGTCGTTCGTCAATTGTCT,9,860957
dgoRp,0.5483870967741935,46,30,GGGAGTGTCATGGCATCTAA,16,848999
dgoRp,0.1935483870967742,35,30,GGCGGTGATGTTCATTATAA,5,839393
dgoRp,0.3548387096774194,40,30,GCTGAGGGCGACCTACCTCA,10,863180
dgoRp,1.1935483870967742,66,30,GAGTCCACCTTATTCGTAGT,36,840566
dgoRp,0.22580645161290322,36,30,GAGGCGTGGCATTCTATCGC,6,847857
dgoRp,0.3870967741935484,41,30,CTGCAGTGCCCCGGGCCAGG,11,838715
dgoRp,1.0,60,30,CTAGTGAGATTGCTTGCACT,30,839982
dgoRp,0.5483870967741935,46,30,CGTGAAGCTTCCCTAGCCAC,16,853946
dgoRp,1.4838709677419355,75,30,CGCGTCGCAGTACGCACGTT,45,856546
dgoRp,0.41935483870967744,42,30,CCAGCGGGTCACCTTAGGAT,12,841457
dgoRp,0.5806451612903226,47,30,CATCTGCTCCGGAGGGATAA,17,848154
dgoRp,0.9354838709677419,58,30,CATCCGGTGGTTATGTGCCC,28,848559
dgoRp,0.3870967741935484,41,30,CACTGTCGTTCCGATTGGGG,11,860907
dgoRp,1.1935483870967742,66,30,CAATTATGATGGTCGGTGCG,36,856569
dgoRp,1.4838709677419355,75,30,ATTCACACAGAGTGACGGAT,45,860272
dgoRp,0.6451612903225806,49,30,ATCGCACCTGTGTAATAAGT,19,857107
dgoRp,0.8709677419354839,56,30,ATAACATAATTTCTTAAGAT,26,838034
dgoRp,1.064516129032258,62,30,AGGGTTAATGATACAATCCT,32,841615
dgoRp,0.3870967741935484,41,30,AGGCCTCTAACGATTCCTAC,11,844220
dgoRp,0.41935483870967744,42,30,ACTCCTCTCAGCTAATCTGC,12,849037
dgoRp,0.3548387096774194,40,30,AATCGAAATCCATACATTGT,10,865662
dgoRp,1.2333333333333334,65,29,TTTCATGTTTGAAGACTCGT,36,858627
dgoRp,0.7666666666666667,51,29,TTCAGTTCCTACGGGGGAGA,22,856119
dgoRp,0.06666666666666667,30,29,TGCTGGGGAGGCACTAGCGC,1,861576
dgoRp,0.36666666666666664,39,29,TCATAGAGCCTGGGCCGTGT,10,859646
dgoRp,1.0333333333333334,59,29,TAGCTCCTCTGTTGCAGGCA,30,841126
dgoRp,1.0,58,29,TAAGCATTTCCGCGCTTTCA,29,839500
dgoRp,1.4666666666666666,72,29,TAAGCAACCTTAACGGCCTG,43,836063
dgoRp,0.36666666666666664,39,29,GTGCCTGCTCTAAGTAATAC,10,849665
dgoRp,0.5,43,29,GGTGTAGTCCTTTGGCGGTA,14,840118
dgoRp,0.06666666666666667,30,29,GGGTAGCTCTACTGTCCTGC,1,845829
dgoRp,0.06666666666666667,30,29,GGGCCTTACTTTCAGGACAC,1,841759
dgoRp,0.6333333333333333,47,29,GGCCGCCTTTCTCGTTGGGG,18,854694
dgoRp,0.5666666666666667,45,29,GGAGAATTATTGCCCAACAA,16,863084
dgoRp,0.26666666666666666,36,29,GCGAAGCAGGATAGTCGCAT,7,845435
dgoRp,1.8,82,29,GCCCTCTTCGTATTTCGGAT,53,864261
dgoRp,0.5333333333333333,44,29,GCACGACCACTATATCGCTA,15,852305
dgoRp,0.7333333333333333,50,29,GATTTAGGAGGGCTATGGCA,21,849342
dgoRp,0.3,37,29,GATCAGGAAGGGCATCACAA,8,858541
dgoRp,0.6666666666666666,48,29,GACAAAAACGAAAAGCTATG,19,851515
dgoRp,0.7666666666666667,51,29,CTTATGGATAAAAGTTAAAA,22,838144
dgoRp,3.1333333333333333,122,29,CTCTTAAAGTACCCTATCTA,93,841015
dgoRp,0.6,46,29,CTCGGCGAATAAAAAGCTAC,17,840404
dgoRp,1.0666666666666667,60,29,CTAGGATCCTATTAGAACGC,31,842478
dgoRp,1.2666666666666666,66,29,CTAACGTTGTGGCCGACCCT,37,865586
dgoRp,0.3333333333333333,38,29,CCAGTGAGTAAGCCAGATTA,9,865439
dgoRp,0.9666666666666667,57,29,CCAGAGTAAGTACTGATTCT,28,846144
dgoRp,0.3,37,29,CACTAGCTTTGCCTGAAGGG,8,854718
dgoRp,2.8666666666666667,114,29,CAATATATACACAACCAGGG,85,866488
dgoRp,0.5333333333333333,44,29,ATGTGCAGTCTCGACATGAA,15,836490
dgoRp,1.0,58,29,ATCGAAGAACCGTAGTTCTC,29,848419
dgoRp,0.4666666666666667,42,29,ATAACACCAATTACGGAGAT,13,856272
dgoRp,0.6333333333333333,47,29,ACCCGTTCAAAGAGCCTTGT,18,858755
dgoRp,0.6666666666666666,48,29,AAGAACAGCCGGGCAACAGC,19,837249
dgoRp,0.3448275862068966,37,28,TTGGGTGTAGACACCCTCAC,9,838929
dgoRp,0.6896551724137931,47,28,TTGCAGCTAACATTCATTGG,19,837251
dgoRp,0.4482758620689655,40,28,TGTGGATTGCATCCACTTTC,12,845394
dgoRp,0.2413793103448276,34,28,TGGCGTCCAGCTTTCGCCCT,6,847591
dgoRp,0.6206896551724138,45,28,TCTATGCGTGGCATTCGCTT,17,864162
dgoRp,1.4827586206896552,70,28,TCGTTCCCATGATACGGAAC,42,842005
dgoRp,0.06896551724137931,29,28,TCGACGTGTTCGCCACCCTA,1,857047
dgoRp,0.3793103448275862,38,28,TATGGTGCTTGGACCGGTTT,10,840401
dgoRp,0.06896551724137931,29,28,TAACCTATTAGGCTACGAAT,1,841356
dgoRp,0.7931034482758621,50,28,GTTAGGCCTTCCGTACGAAG,22,837214
dgoRp,0.896551724137931,53,28,GTGGCAATGAGCAGTCAACC,25,842743
dgoRp,0.6896551724137931,47,28,GTCAGAAAGGATCAAGAGGA,19,839391
dgoRp,0.3448275862068966,37,28,GTATCCCGCCGCCCCAAACC,9,841318
dgoRp,0.3103448275862069,36,28,GTAGTGTGCTCGATGGGCTT,8,857225
dgoRp,1.1379310344827587,60,28,GTAATTACTGGCCATGCAGT,32,848811
dgoRp,0.6206896551724138,45,28,GGGCGGAACGTCAAATCCGC,17,846079
dgoRp,1.0689655172413792,58,28,GGCTAATGGCCGGCTGTGGA,30,849572
dgoRp,0.8275862068965517,51,28,GCCGCATGTAGCACCATTCA,23,841846
dgoRp,0.4827586206896552,41,28,GCCAGATGATCGAAGGTGTT,13,865394
dgoRp,0.6206896551724138,45,28,GCAATCAAGGAAAGATTTTC,17,848661
dgoRp,0.3793103448275862,38,28,CTTATATCTAACGGGTGGCG,10,849099
dgoRp,2.896551724137931,111,28,CTCGTCCAGCCTTTCCTCAC,83,843298
dgoRp,0.7241379310344828,48,28,CGGGGACAGGGGGTGCGTCA,20,836753
dgoRp,0.5517241379310345,43,28,CGCGCACCCCTTTATAGTTT,15,857359
dgoRp,0.41379310344827586,39,28,CGACCGTTACTCGTCCTCCA,11,836879
dgoRp,1.206896551724138,62,28,CCTACGGAGTTGGACACTTA,34,859620
dgoRp,0.7586206896551724,49,28,CCGTAAGTCCGGATGTAGCA,21,849734
dgoRp,0.13793103448275862,31,28,CCGGGATCCAAGTTTTCAAA,3,836797
dgoRp,0.8275862068965517,51,28,CCCGGTGCAATGACGCACTT,23,843329
dgoRp,0.896551724137931,53,28,CAGGCTCGCATTCCTCTCCA,25,859911
dgoRp,0.06896551724137931,29,28,CAGGCCCTTATAATGTAGTT,1,866013
dgoRp,1.6896551724137931,76,28,CAGCAGGATTTTCGCCACGA,48,852719
dgoRp,1.1724137931034482,61,28,CAATTAATCATCGCGTGACT,33,848493
dgoRp,2.2758620689655173,93,28,CAACATTTCCATTGGAAGAA,65,864416
dgoRp,1.6206896551724137,74,28,ATGTGGGATTGTAGGTTCTT,46,851342
dgoRp,1.4137931034482758,68,28,ATGAAGTTGTACTCCGGCTC,40,836574
dgoRp,0.3103448275862069,36,28,ATCATGCCAGGGCAGAACAG,8,853383
dgoRp,0.5172413793103449,42,28,ATATAGCGTAGTCTCAACCT,14,851509
dgoRp,0.06896551724137931,29,28,AGCTCTACCTAAAGACTCAG,1,837841
dgoRp,1.2413793103448276,63,28,AGACCACTGGGCGTGAAACG,35,848057
dgoRp,0.06896551724137931,29,28,ACGTATTCAGGCAGAGTACC,1,838238
dgoRp,1.4137931034482758,68,28,ACAACGTGCAAAGTGACAAT,40,837352
dgoRp,1.1379310344827587,60,28,AAATCAATCCCCGGTACGAT,32,839701
dgoRp,0.2857142857142857,34,27,TTGTGTGCGAGTATAAGTGC,7,843790
dgoRp,0.2857142857142857,34,27,TGTTCGCTGGCACGAGTGTC,7,841689
dgoRp,1.0357142857142858,55,27,TGGGCCAGAGGGCGCTTCCA,28,857114
dgoRp,1.1428571428571428,58,27,TGCGTGGGTCCTATTCCCTG,31,844121
dgoRp,1.1428571428571428,58,27,TCCCTAGTGTACCCAATTAT,31,841106
dgoRp,0.5,40,27,TAGCAGCGAGGAAGATGTAA,13,855028
dgoRp,1.4285714285714286,66,27,TAACCAGGCGAGACGGGGAC,39,839354
dgoRp,0.39285714285714285,37,27,TAAATACGCGGGCACTCTGG,10,852556
dgoRp,1.4285714285714286,66,27,GGACCTCAATGCTTCTATCC,39,846167
dgoRp,0.07142857142857142,28,27,GCCCTACAGGGACTTATATT,1,859843
dgoRp,1.2857142857142858,62,27,GCCAATCGATAGGCAGGGGG,35,840846
dgoRp,0.42857142857142855,38,27,GCACTGCTCTACCGCACAAC,11,863631
dgoRp,0.6785714285714286,45,27,GATTCTAAGGTATTGTGCAA,18,839233
dgoRp,0.32142857142857145,35,27,GATGGCCAGATAATCGATCT,8,860121
dgoRp,0.7857142857142857,48,27,CTTTGGCCAGTCATGCAAAA,21,842610
dgoRp,0.35714285714285715,36,27,CTGTCTGCTTTTCTCGGGGG,9,845458
dgoRp,0.6785714285714286,45,27,CGGTCTCTAAGAGGTAGGAA,18,856994
dgoRp,0.17857142857142858,31,27,CGGGTACTAATGTTGTACGA,4,844587
dgoRp,0.7857142857142857,48,27,CGGCTAACAACGACACATGT,21,841334
dgoRp,4.928571428571429,164,27,CGAGCGGTTCACTTTCGTAG,137,841439
dgoRp,0.7142857142857143,46,27,CGAGAGTGTCCCAATTCATG,19,852240
dgoRp,0.17857142857142858,31,27,CCGGTTGCGCAGTAGACTCT,4,843967
dgoRp,0.9285714285714286,52,27,CATATTCGGCCTCCCAGTGC,25,846272
dgoRp,0.9285714285714286,52,27,CAGCCTCTAAGGATATTCCT,25,839197
dgoRp,0.6071428571428571,43,27,CACCTTTCGATGTAGGTAAT,16,842299
dgoRp,0.5714285714285714,42,27,ATACGCCCTGACGTTTTGGC,15,844643
dgoRp,0.35714285714285715,36,27,ATAATATAATCATAACAGTA,9,841514
dgoRp,0.6071428571428571,43,27,AGGTGTGACGTGATCTAGCC,16,861144
dgoRp,1.3214285714285714,63,27,AGGAGAGAATACTAAGCGGG,36,838609
dgoRp,0.14285714285714285,30,27,AATTCTGACAAGAGGAGACA,3,862457
dgoRp,0.32142857142857145,35,27,AACGTGGTTGCTGGCATTAC,8,860109
dgoRp,0.6785714285714286,45,27,AACAGAAGGCTTAAGCTAAG,18,857989
dgoRp,2.037037037037037,80,26,TTTCTAGAGCAGGACGGACA,54,851468
dgoRp,1.0,52,26,TGCCGATGGATTCATGTCGG,26,856795
dgoRp,1.1851851851851851,57,26,TCAAGGAGAATCATAGAAGT,31,840144
dgoRp,0.8148148148148148,47,26,TAACAGTGGACAACTAGGTT,21,855320
dgoRp,0.4444444444444444,37,26,GTGCACCTCTTTTGATATCT,11,852749
dgoRp,1.1111111111111112,55,26,GTCCTGAACTAGGCTTCCAG,29,853347
dgoRp,0.5925925925925926,41,26,GCTTCCGGACTTGCACTTGT,15,846171
dgoRp,0.7777777777777778,46,26,GCCATATTTTTTCAGGGTCT,20,839234
dgoRp,0.48148148148148145,38,26,GAGGTCGGCACAGCCTGTTT,12,862695
dgoRp,0.4444444444444444,37,26,CTACGACGCTAGTATTCTTC,11,837859
dgoRp,0.2962962962962963,33,26,CCTCACTACTGCCATCCTTA,7,847878
dgoRp,1.5185185185185186,66,26,CCGGCGACCAACGTTGTTCA,40,864735
dgoRp,2.111111111111111,82,26,CCCCGCGATAGGATCCAGCC,56,841512
dgoRp,0.8888888888888888,49,26,CATTTCGGAGCGTGTACGTC,23,856809
dgoRp,1.7777777777777777,73,26,CAGGAAAATAACCTCGTAGA,47,861107
dgoRp,2.888888888888889,103,26,CACCGTAAGAGTGTGTAGAT,77,851655
dgoRp,0.07407407407407407,27,26,CAACCGCGACAGGCACACGC,1,836420
dgoRp,1.037037037037037,53,26,ATCTTGTCCGTCACCTGATA,27,860136
dgoRp,0.7777777777777778,46,26,ATCCATTGCTGGCTCCCTTA,20,860580
dgoRp,0.5185185185185185,39,26,AGTGTGTTTGACGGTGTCGT,13,850490
dgoRp,1.7777777777777777,73,26,AGAGAGCGGCGGCTAGTGTA,47,854005
dgoRp,0.6296296296296297,42,26,ACTCCTGACACAGACGGGAC,16,851684
dgoRp,0.5185185185185185,39,26,ACGCTGAGATCGTCTCACCG,13,862521
dgoRp,0.37037037037037035,35,26,ACAGATATGCGGGCTAAGGT,9,842152
dgoRp,0.6666666666666666,43,26,AAGTCCATCATTTAGGCGTA,17,843830
dgoRp,0.8888888888888888,49,26,AAGCACCATTGGGGTTTATA,23,857644
dgoRp,0.7407407407407407,45,26,AACATAGGATCTGCACATTT,19,853677
dgoRp,0.7777777777777778,46,26,AACAAACCCAAAATAAGGAA,20,840131
dgoRp,1.4444444444444444,64,26,AAACCGACGCATAAATATTA,38,852353
dgoRp,0.5,37,25,TTTAATATCTAGACTAGCGG,12,855319
dgoRp,0.2692307692307692,31,25,TGAATGGGGAGGACCTTGGT,6,848356
dgoRp,0.7692307692307693,44,25,TCTAGTGCGCTCCTCCCTAA,19,837765
dgoRp,0.2692307692307692,31,25,TCGTCGTGATTTGTCGTAAG,6,847297
dgoRp,0.4230769230769231,35,25,TCCATCAGACCGTACTAGGA,10,849983
dgoRp,0.6538461538461539,41,25,TAGCTCCTGATGGACACAAC,16,850906
dgoRp,1.0769230769230769,52,25,TACTGTATTGGTTTCATAAT,27,845006
dgoRp,0.6923076923076923,42,25,TAATGGGATGCGAATGCTGA,17,845830
dgoRp,1.0,50,25,GTTGGTTGAGTAGAAGATAA,25,842608
dgoRp,0.6153846153846154,40,25,GTGTTCGCGTCTTAAAGTTT,15,846053
dgoRp,0.46153846153846156,36,25,GTGGCCCCACCGTCCTTTAC,11,837297
dgoRp,2.6153846153846154,92,25,GTGAGAGGGCGTACGGGGAC,67,845511
dgoRp,0.7692307692307693,44,25,GGTCAGCCCCGTTGGGAAAT,19,841294
dgoRp,0.6153846153846154,40,25,GGGTTTTTGCTCAAGAAACA,15,857646
dgoRp,1.4230769230769231,61,25,GGCTTTCCCTCACCACTGGA,36,847563
dgoRp,1.2692307692307692,57,25,GGCCCTGAGTCCTGGCCGGA,32,841231
dgoRp,0.8461538461538461,46,25,GGCCCCAAGGATCAATGCAT,21,849638
dgoRp,1.6538461538461537,67,25,GGATCTGGGGGGCGCACCTC,42,841557
dgoRp,0.7692307692307693,44,25,GATGCCACGTGTGGCCGATC,19,842022
dgoRp,0.07692307692307693,26,25,GAGTTTACTTCGCGGTTCTG,1,845039
dgoRp,0.38461538461538464,34,25,GACGACGAATGCGCTGGATC,9,846656
dgoRp,0.5384615384615384,38,25,GACCTTCAGCGTTTCGCATC,13,839479
dgoRp,0.34615384615384615,33,25,GAAGCCTCATATTAACATTT,8,839266
dgoRp,1.0384615384615385,51,25,CTCCTTCTGTCATAAGGTAA,26,836938
dgoRp,0.2692307692307692,31,25,CTCCAAATTTTTTACATACG,6,852831
dgoRp,1.3076923076923077,58,25,CGGAAGTTAAAGAACCGGTT,33,836452
dgoRp,1.0384615384615385,51,25,CGAATGCGGGAAGACGCGCT,26,852111
dgoRp,0.2692307692307692,31,25,CCTTCTAACGACTCCCCCGG,6,844740
dgoRp,0.4230769230769231,35,25,CCATGTCCGGGGGAGTGAAT,10,847146
dgoRp,1.1153846153846154,53,25,CATGCCCCGAGTAGGAAAAC,28,835862
dgoRp,0.07692307692307693,26,25,CATCTAAGAGCCCAAAAGTC,1,844631
dgoRp,0.15384615384615385,28,25,CATCGAAGCAGGCCTAATAG,3,861530
dgoRp,1.5,63,25,AGTCCCCAAACGGTCAGGAG,38,839008
dgoRp,0.2692307692307692,31,25,AGGTTTGCCAAAGGGCTAGG,6,841658
dgoRp,0.6923076923076923,42,25,AGGGTAACCTCCGGTGGATC,17,855217
dgoRp,0.07692307692307693,26,25,AGAGCCGGACTCGTACCGAA,1,847978
dgoRp,1.5769230769230769,65,25,ACTTTGCCTGGAACAAAGAA,40,836470
dgoRp,0.6923076923076923,42,25,ACGCGTTGGACGTCATAAGT,17,852474
dgoRp,0.5769230769230769,39,25,ACCCCGAATGGGCCAGGCAT,14,862101
dgoRp,0.15384615384615385,28,25,ACCAACTTACGAGTGTTCAT,3,844383
dgoRp,0.07692307692307693,26,25,AAGATCTGAATGGCCTTTAG,1,854663
dgoRp,0.36,32,24,TTTTGACAGGGCGGGGCAGT,8,837476
dgoRp,0.28,30,24,TTCTGACTGAAGCCCACATG,6,849628
dgoRp,0.32,31,24,TTAGTTCTGCACGGCCGGAG,7,857621
dgoRp,1.72,66,24,TGCTGCGTGTTATAAGCCCT,42,851302
dgoRp,0.56,37,24,TGACTTCTTTTTAATTTCAC,13,856100
dgoRp,1.24,54,24,TCTGGGTGGGATGAGTCTTT,30,857466
dgoRp,0.36,32,24,TCGCCTGCACTTACTCGCCA,8,848117
dgoRp,0.16,27,24,TCAAGGAAAATTAAAGCAGT,3,856228
dgoRp,0.84,44,24,TAGCGATGATCGACTCGAAC,20,846888
dgoRp,0.48,35,24,GTCCCTTATTTTAGTCGGAA,11,853699
dgoRp,0.2,28,24,GTCAGGGTGACCATGACAGT,4,843531
dgoRp,1.8,68,24,GGGTGTCCCAGCAGCATTCA,44,837949
dgoRp,0.64,39,24,GGCCGGGGTAACAGTTCAAG,15,839868
dgoRp,0.08,25,24,GGACCAACCATTACACTCAC,1,848215
dgoRp,0.08,25,24,GCCAATGTTATGGGAACGAT,1,850852
dgoRp,0.32,31,24,GATCGTGGTCTTATAGGCCA,7,836842
dgoRp,0.76,42,24,GACTCGTCCAGGTTTGCCGA,18,848545
dgoRp,0.56,37,24,GAATTTACATACCTGAACGG,13,840570
dgoRp,0.36,32,24,CTGTTGCGGGCTGTATCTAC,8,837544
dgoRp,1.44,59,24,CTAGACGAGTAGCGCGACAA,35,850539
dgoRp,0.64,39,24,CTACACAAGTGAAGGCTGTT,15,842910
dgoRp,9.0,248,24,CGCGCAAGCGGCATCTGGCT,224,858138
dgoRp,0.6,38,24,CGCCACTTGTTTGTAGAAGA,14,858574
dgoRp,0.28,30,24,CGCACCGCCACAATTTGAAG,6,841264
dgoRp,1.88,70,24,CAGGCTTGAATGGTATTGAA,46,844715
dgoRp,0.08,25,24,CAGCTTAGGGTAAAGGTGGG,1,855926
dgoRp,1.8,68,24,CACCCTACCTGGGTTACAAA,44,850161
dgoRp,0.52,36,24,ATTGTCGGGCAATCCAGTAA,12,863204
dgoRp,2.6,88,24,ATTCCGTTGTTAGTCGATGC,64,841981
dgoRp,1.6,63,24,ATGTAAAGGTTCGCTCGGTT,39,862790
dgoRp,0.16,27,24,ATGGGATTTTTGGTGAGCTT,3,836217
dgoRp,8.2,228,24,AGGTTGCGACACCGTGGCTG,204,859711
dgoRp,0.76,42,24,AGATCTTGACCGCTCAAGTA,18,845419
dgoRp,1.36,57,24,ACTCGCCTCAATGAACCGGC,33,858421
dgoRp,0.8,43,24,ACTCGATACTCTCAGTGACT,19,849642
dgoRp,2.12,76,24,ACTCCGGGGCGTCTCCGCGC,52,844010
dgoRp,0.8,43,24,ACCTGGTTCTTCAGGGGGTC,19,846199
dgoRp,0.92,46,24,ACCCCCAAGAGGCCGAGTAT,22,836441
dgoRp,0.125,25,23,TTACGCGTGGAGGCTGGCTT,2,847844
dgoRp,2.2083333333333335,75,23,TTAACGGGGAGTCCAATGAA,52,863150
dgoRp,0.4166666666666667,32,23,TGCGCATTTTTTCTGAGTAA,9,861912
dgoRp,0.8333333333333334,42,23,TGAGTGTTCTCACCTGGGCA,19,848963
dgoRp,0.5416666666666666,35,23,TCCAACATTTGGGGGCATTA,12,852866
dgoRp,0.5833333333333334,36,23,TCACACGCGGCACATTATGA,13,864318
dgoRp,0.4583333333333333,33,23,TCAACGTAAAGTTGAAGAGG,10,840243
dgoRp,2.0,70,23,TATGCCTTACTGAAAATGTT,47,840985
dgoRp,0.9583333333333334,45,23,TATGATACCCAGACACGCAT,22,845613
dgoRp,0.125,25,23,TACAGATTAATCAAGGTGTC,2,841773
dgoRp,0.875,43,23,TAAGCGCACGTTTCTCCAGA,20,839136
dgoRp,0.5833333333333334,36,23,TAAAGACCCAGCAACAGAAG,13,854175
dgoRp,0.9583333333333334,45,23,GGCGATTTCTATTCTTTCTA,22,856584
dgoRp,0.5416666666666666,35,23,GCGCATCTTCATTGTACCTT,12,853489
dgoRp,0.5,34,23,GCGAGGTTGTACAGAGTAGG,11,844201
dgoRp,0.08333333333333333,24,23,GCAAGAGTTCCAGCTCAAAG,1,842897
dgoRp,0.875,43,23,GCAACAACTTGGGCCAAGAG,20,850548
dgoRp,0.4583333333333333,33,23,GATAGGTCTAATGTCATAAC,10,848942
dgoRp,0.8333333333333334,42,23,GAGCCTACGAGATTAATCTA,19,842703
dgoRp,0.625,37,23,CCGGCAATGTTACGGGCGTA,14,856711
dgoRp,3.25,100,23,CCGAATCGCTTACCCGACCT,77,850716
dgoRp,1.0833333333333333,48,23,CCAGAACTTCTTGTAGCATC,25,849128
dgoRp,1.0,46,23,CCACATTCACCGAATCGCAG,23,841777
dgoRp,0.7916666666666666,41,23,CAGGGCGTTCTTCATAATGA,18,842661
dgoRp,1.0416666666666667,47,23,CAGGGCGTTCGACAACTGCG,24,840535
dgoRp,1.1666666666666667,50,23,CACGATTTCTCCTGAATTAA,27,850575
dgoRp,1.125,49,23,CACGAGTATTGCACACGGCA,26,862292
dgoRp,0.125,25,23,CAATCATGTAAGCCCCGCTA,2,839036
dgoRp,0.7083333333333334,39,23,CAAGCTTTGAAATCGTCCTG,16,836069
dgoRp,0.5833333333333334,36,23,ATTGAGGTAGGGTCAATACG,13,836939
dgoRp,2.0833333333333335,72,23,ATCTGCAACTTCGGTACCCT,49,841656
dgoRp,0.3333333333333333,30,23,ATAAGCGAAAAGTAGCACCT,7,845543
dgoRp,0.75,40,23,AGTCCTTTTCCCGCCCAGAG,17,839369
dgoRp,1.125,49,23,AGCATGGTCAAGCTTGTCGC,26,865258
dgoRp,0.9583333333333334,45,23,AGAGGTGCAGACTTACTTGT,22,849171
dgoRp,0.5416666666666666,35,23,ACTTGATCCGTACACCTATG,12,857068
dgoRp,2.1666666666666665,74,23,ACTCGGGTTCTCTTCATATT,51,849695
dgoRp,0.5416666666666666,35,23,ACGGTTCTGGGGACTTAGGT,12,866871
dgoRp,0.5,34,23,ACGGTTCATTGAGCGCACGC,11,851705
dgoRp,0.4166666666666667,32,23,ACGGTGTGACGGGCCTATCT,9,862012
dgoRp,0.625,37,23,ACGCGGCCCGAATTGTTGAT,14,849433
dgoRp,0.625,37,23,ACAAATGTGAGGCTACATAG,14,849131
dgoRp,0.9166666666666666,44,23,AAGACTATTAAACTTAGCAA,21,841366
dgoRp,0.5833333333333334,36,23,AAGACATGCCCGAGATCCTT,13,839365
dgoRp,0.25,28,23,AAGACAAAACTTTTATAATT,5,849584
dgoRp,0.4782608695652174,32,22,TTTCTGGTCGCTTCATGAAA,10,854644
dgoRp,0.5217391304347826,33,22,TTTCAGATCAGATCCTAATG,11,850297
dgoRp,0.6086956521739131,35,22,TTTAGCAGGATCCGGAACGA,13,838016
dgoRp,2.6956521739130435,83,22,TTAACCATCCGCACGCCGGA,61,856542
dgoRp,0.4782608695652174,32,22,TGGGCCTGCCCAGAAAACAG,10,843683
dgoRp,0.30434782608695654,28,22,TGCATGATATGCCAATACCG,6,838454
dgoRp,0.08695652173913043,23,22,TGACCGCGTTCACCTCGGTA,1,843884
dgoRp,0.13043478260869565,24,22,TCTATGATCCGTACTAAAAA,2,860904
dgoRp,1.173913043478261,48,22,TCTAGGCAGACTCCGTGTCT,26,848114
dgoRp,0.6086956521739131,35,22,TATTAGGCCACGATATTATA,13,849781
dgoRp,4.130434782608695,116,22,TAGATAAGCCCCGCACAAGC,94,840054
dgoRp,1.1304347826086956,47,22,GTTCTACGTTGTCTATCAAG,25,847890
dgoRp,0.4782608695652174,32,22,GTTCGGGATAATTTTATAAG,10,844493
dgoRp,0.30434782608695654,28,22,GTTAGTTGTTTCGACGTCTA,6,849484
dgoRp,1.2173913043478262,49,22,GTGTGGCACGGTAAGTTCTG,27,856248
dgoRp,0.2608695652173913,27,22,GTCTGAAGCGCGCTCCGGAA,5,850764
dgoRp,0.782608695652174,39,22,GGTCAGTTACCGCAACATAT,17,854049
dgoRp,0.5652173913043478,34,22,GGGCACCGTACTCTACACAA,12,845059
dgoRp,0.7391304347826086,38,22,GGGATCGCATCGTTCAGGGA,16,857864
dgoRp,0.5652173913043478,34,22,GGCACGGAACGTTTGTCTCT,12,854151
dgoRp,0.391304347826087,30,22,GGAACCCGACTCTACCGAGG,8,862984
dgoRp,1.0869565217391304,46,22,GCTCTCCCGTAATTGGAAGG,24,838642
dgoRp,0.782608695652174,39,22,GCATTCAGACTGGCATTAGT,17,853540
dgoRp,0.5217391304347826,33,22,GCATCCTCTGTATCGGTTTC,11,853773
dgoRp,0.6956521739130435,37,22,GCACCTCTTGAGATTGAAAA,15,863179
dgoRp,0.34782608695652173,29,22,GCACATTCCGATACACTTCG,7,865611
dgoRp,0.5652173913043478,34,22,GAACTCCCACAATAAATTCA,12,836926
dgoRp,0.5217391304347826,33,22,CTGGATAACCTGTCATGAAG,11,862951
dgoRp,0.43478260869565216,31,22,CTGCTGAACGGCTGTTGATA,9,838261
dgoRp,1.6521739130434783,59,22,CGATCGTGATTCTTTGTTGT,37,857467
dgoRp,0.13043478260869565,24,22,CGACTCTAGACGATCGCCTA,2,836274
dgoRp,0.6956521739130435,37,22,CGAAAAACGGCAAATTACAG,15,850294
dgoRp,1.4782608695652173,55,22,CCGGACGGCTGAAAACGGTT,33,839448
dgoRp,1.1304347826086956,47,22,CCGGACAGGCCTCCGTAACC,25,857339
dgoRp,1.7391304347826086,61,22,CCCCTGCGATCGTGCATTGT,39,837106
dgoRp,0.5217391304347826,33,22,CATGTGCGCCCCACATAGCA,11,852328
dgoRp,1.8695652173913044,64,22,CATAAATTTAAGGTCCTCTT,42,860134
dgoRp,0.4782608695652174,32,22,CACGTGTCCCAACCTAGCGG,10,837481
dgoRp,0.5217391304347826,33,22,CACACGGTTCTGCATACCTC,11,848099
dgoRp,1.2173913043478262,49,22,CAAGCGTCTGAATTATGCGC,27,844668
dgoRp,1.9565217391304348,66,22,ATTCTCACAACCTTTTGTCA,44,836013
dgoRp,1.1304347826086956,47,22,ATGAGGGGATCTCAGTGGCC,25,851703
dgoRp,0.6521739130434783,36,22,ATGACCGGAACACCTTGGAC,14,849717
dgoRp,1.0,44,22,ATCGTAACAGCCCGTTGGCA,22,849506
dgoRp,0.4782608695652174,32,22,ATATGTATGTTTCACGGGCT,10,842807
dgoRp,0.6521739130434783,36,22,AGTTTATCTGAGGAGCAAGC,14,856544
dgoRp,0.9130434782608695,42,22,AGTCTGCCATTGCCGATTAC,20,850440
dgoRp,1.0869565217391304,46,22,AGTCAACCTCGTAGAACGAT,24,857245
dgoRp,0.08695652173913043,23,22,AGCCCGAGTGGTTACAATCA,1,841194
dgoRp,1.0434782608695652,45,22,AGACACGAGTTAGACTAGAG,23,845143
dgoRp,0.4782608695652174,32,22,ACGGACTTTCTGTATGTGTC,10,847296
dgoRp,0.30434782608695654,28,22,ACGAGTCGTCATCATACTAA,6,844909
dgoRp,0.4782608695652174,32,22,AATGTATGGCTTTGTGTGCA,10,846184
dgoRp,0.5217391304347826,33,22,AATCCCGATGGGTCTCCCAA,11,864061
dgoRp,1.4782608695652173,55,22,AATACGATCCTGTGATGCGT,33,864339
dgoRp,1.0434782608695652,45,22,AAGTGTGTTTCCGTTGGGTT,23,861993
dgoRp,0.8260869565217391,40,22,AACCGGAAAGCGAGGCACGC,18,865378
dgoRp,0.6086956521739131,35,22,AAAATGGTCAAGAGCATTGC,13,861606
dgoRp,0.7727272727272727,37,21,TTTACGAGTGGATCTTATTT,16,864976
dgoRp,0.9090909090909091,40,21,TTTAACCAGACTAGGTTGGG,19,861702
dgoRp,0.9545454545454546,41,21,TTGATAAAGGATGTGACTTA,20,844085
dgoRp,1.0454545454545454,43,21,TTCGGTAGATTGCTCTACCA,22,844447
dgoRp,0.4090909090909091,29,21,TGGCAAAAACGTTGGGTTTT,8,837643
dgoRp,1.0454545454545454,43,21,TGCCCAGGGAGGGTCCTACG,22,855039
dgoRp,0.6363636363636364,34,21,TCTTTTTATGAATTAACATT,13,850692
dgoRp,0.18181818181818182,24,21,TCTGTGTCAGGGCCGTTAAT,3,857394
dgoRp,0.4090909090909091,29,21,TCTCCAGGGTTGTGGAACCT,8,840992
dgoRp,1.9090909090909092,62,21,TCGCGTTCGATGGAACGGTA,41,855873
dgoRp,1.0,42,21,TCGCGGTAAAAAACGACATA,21,851034
dgoRp,0.4090909090909091,29,21,TCCCAGAATTGGAGGGGAGT,8,863082
dgoRp,0.5,31,21,TACTATAGTGTATCAGACTG,10,859066
dgoRp,2.1363636363636362,67,21,TACATGAAGTTGTGGTATCT,46,838596
dgoRp,1.7272727272727273,58,21,GTGGTACCTCACTATTAGCA,37,860602
dgoRp,0.6363636363636364,34,21,GTACCATGTATACTGGCGCA,13,855173
dgoRp,0.09090909090909091,22,21,GGTGGTGGGATACTTACACA,1,848677
dgoRp,0.36363636363636365,28,21,GGTCTTAAGCGCCTGCTTAT,7,839064
dgoRp,0.5909090909090909,33,21,GGTCGCTTATAGGAAGGCTA,12,865472
dgoRp,0.13636363636363635,23,21,GGTAGTTACCGTCCGAGCAG,2,850393
dgoRp,2.6363636363636362,78,21,GGGAGACTTCAACCGTACTT,57,858709
dgoRp,0.6363636363636364,34,21,GGGACTCCCAATTGTGGGTG,13,846657
dgoRp,0.7727272727272727,37,21,GGAGAGAGTGCCAGCGCGTC,16,859912
dgoRp,0.22727272727272727,25,21,GCGGGTAGCTATAAGAGGCG,4,850481
dgoRp,1.6363636363636365,56,21,GCCGAATAGGCCTCTAGGAG,35,841156
dgoRp,0.45454545454545453,30,21,GCCCTCTCCACACGGTTCGC,9,837583
dgoRp,0.2727272727272727,26,21,GCATGGGCTGGCGCGGAATG,5,861939
dgoRp,1.6363636363636365,56,21,GAGTGAAGTCACCCGACTAT,35,845512
dgoRp,0.5,31,21,GAGTCAGGCATAAGAAAGTG,10,856695
dgoRp,1.0454545454545454,43,21,GAGTACAGTGCCCCTATGGG,22,858395
dgoRp,0.09090909090909091,22,21,GAGCCAGCTACTACGTGGGA,1,853721
dgoRp,2.0,64,21,GAGACGGTGGACCGTGTCTA,43,860041
dgoRp,0.45454545454545453,30,21,GAGAAATTGCGTGTACGCTA,9,838062
dgoRp,1.5,53,21,GACACAACGCAACTAAGCAG,32,856081
dgoRp,1.5,53,21,GAATCCCTTTGAGTCACTGT,32,841880
dgoRp,1.3636363636363635,50,21,CGAATTCGGCAGTGATTAAC,29,864851
dgoRp,1.7272727272727273,58,21,CCTTGGCATATTCCCTCTGT,37,848224
dgoRp,0.2727272727272727,26,21,CCTTATTTCACTGCGGCATC,5,846519
dgoRp,2.5,75,21,CCTGCTCCGTCGTGCACCCA,54,854585
dgoRp,0.09090909090909091,22,21,CCGGGACATCCCTCCACCTG,1,848794
dgoRp,1.0909090909090908,44,21,CCGCGATGAGCGAGGGTCAT,23,862491
dgoRp,0.45454545454545453,30,21,CCAATTACAACAACCTTGTA,9,837922
dgoRp,0.2727272727272727,26,21,CAGATTTCAGAACTTTTGTC,5,842263
dgoRp,0.5454545454545454,32,21,CACCCCTCTCGGACTACGGC,11,857517
dgoRp,2.727272727272727,80,21,CACAGTGATACGCCCGCAAT,59,847893
dgoRp,0.8181818181818182,38,21,CAATACTATTATGACCCTCT,17,839216
dgoRp,1.2727272727272727,48,21,ATTGGTTCTGGAGGCGTTCA,27,856554
dgoRp,1.3181818181818181,49,21,ATTAATCCAACCTGCTCGGC,28,852352
dgoRp,0.09090909090909091,22,21,AGTTAGAATCGGGAGAATAT,1,840067
dgoRp,0.09090909090909091,22,21,AGCCCGTAGGTCACGCCGCA,1,849867
dgoRp,0.7727272727272727,37,21,ACTTTTGTTATACGGAGCAT,16,861821
dgoRp,0.36363636363636365,28,21,ACCTTTGGTAAGAGTCTATT,7,851326
dgoRp,1.0909090909090908,44,21,AATCGATGCCAAAGTCGCCT,23,864038
dgoRp,0.7142857142857143,34,20,TTTTGATCAGCTTGATCGTT,14,856770
dgoRp,1.1428571428571428,43,20,TTTCGCCGGCGGAGCCGAAT,23,859591
dgoRp,1.0,40,20,TTGTTCAAAAGTTTCAATTA,20,843392
dgoRp,0.5238095238095238,30,20,TTGTGGCACGGTGTATACCA,10,867004
dgoRp,1.8571428571428572,58,20,TTGCCGTGTAGCTCATTCGC,38,845272
dgoRp,0.38095238095238093,27,20,TTGCAGGTTCGATTCAAATA,7,841636
dgoRp,1.4761904761904763,50,20,TTCGATGCGCAGACAATACT,30,862096
dgoRp,0.5714285714285714,31,20,TTCACCTGATGTACTAGCAT,11,838993
dgoRp,0.8095238095238095,36,20,TTATAACCCCAAAAGTTTGT,16,861379
dgoRp,0.09523809523809523,21,20,TGGGTTGCATTGCTTTCGAT,1,849679
dgoRp,0.8571428571428571,37,20,TGGACAGATTGGCAGTTGGA,17,844646
dgoRp,0.2857142857142857,25,20,TGCCCACCCAGTCTACCGCA,5,837681
dgoRp,0.9047619047619048,38,20,TGAATGCGCTTCCTCGAGGG,18,854165
dgoRp,0.6666666666666666,33,20,TCTTCAAAAGTGGGAATAAG,13,857971
dgoRp,0.6190476190476191,32,20,TCGTTTATACCATGTCCTAT,12,852923
dgoRp,0.8571428571428571,37,20,TAGGCCGGTCTGCACCTTTC,17,858863
dgoRp,0.9047619047619048,38,20,TAGCATCCTCTGGGGAGTAT,18,848992
dgoRp,2.2857142857142856,67,20,TAAAGCGGGATTCCGCGCAA,47,861975
dgoRp,0.42857142857142855,28,20,GTGGACAGTTTTCGGTGAAC,8,838735
dgoRp,1.9523809523809523,60,20,GTCGAAGGCCCGGTCCTCTT,40,853457
dgoRp,0.5238095238095238,30,20,GTCCGGGTCATTACACTGCA,10,836710
dgoRp,0.38095238095238093,27,20,GTCCCCTAGTGTATCAGGAC,7,847959
dgoRp,0.19047619047619047,23,20,GGTGTCGTTTGCAGCTCAAT,3,842268
dgoRp,0.5238095238095238,30,20,GGTCAGACTTACGTAACGTC,10,848547
dgoRp,2.7142857142857144,76,20,GGCGGTATTCAGGGAGGACC,56,841360
dgoRp,0.09523809523809523,21,20,GGAGACTACCAAGGGTTTAG,1,852799
dgoRp,0.5714285714285714,31,20,GCGGCTCGAGAATTAGCAAT,11,846378
dgoRp,0.38095238095238093,27,20,GCCCGTTAGAATCGTGGATG,7,859686
dgoRp,0.9047619047619048,38,20,GCATTGTCTTCTTGACCCGG,18,863353
dgoRp,0.3333333333333333,26,20,GCAGGACTGGGCTTCGCAGA,6,849936
dgoRp,1.2380952380952381,45,20,GCAAAAGTCTATCAGCTCTT,25,860291
dgoRp,2.380952380952381,69,20,GATTCGTATCCGGGAGTGCA,49,839265
dgoRp,0.5714285714285714,31,20,GATCGTCATATACTGTTGGA,11,847017
dgoRp,1.619047619047619,53,20,GATACACAGATACCATTTCA,33,837667
dgoRp,0.09523809523809523,21,20,GAGTCATAGGATAGAATTGG,1,859588
dgoRp,0.5238095238095238,30,20,GAATGGTGAAATAAACGGAT,10,845138
dgoRp,0.6190476190476191,32,20,CTTCCTGGGTAACGGGAAAT,12,845334
dgoRp,0.14285714285714285,22,20,CTCGCACCAACTAGCGGTTA,2,856174
dgoRp,1.2857142857142858,46,20,CTCACACCAAACTCAATCAG,26,848394
dgoRp,0.09523809523809523,21,20,CTATGGTGGTAGGCCAGGTA,1,848514
dgoRp,0.9523809523809523,39,20,CTAGTAGGGCTAGACACTTA,19,839313
dgoRp,0.9047619047619048,38,20,CTACGCTAAGTTACGAGTAG,18,852238
dgoRp,4.428571428571429,112,20,CTACGCAAATATACATCCTC,92,851810
dgoRp,0.09523809523809523,21,20,CTACATCTGAAAGACCAAAT,1,837758
dgoRp,1.4761904761904763,50,20,CGTGGTGTGGGGCGCGGTAA,30,853378
dgoRp,0.6190476190476191,32,20,CGTATATCGGATCACCATTT,12,847144
dgoRp,1.0,40,20,CGTAGGCAACTAGGGTGGCC,20,839597
dgoRp,0.7142857142857143,34,20,CGGTGCAGCGCGCACAACGC,14,836072
dgoRp,0.09523809523809523,21,20,CGCTATCAGCTCTTCAGCGT,1,849187
dgoRp,3.5714285714285716,94,20,CGCAGCTACTCATAAAACTC,74,854436
dgoRp,0.09523809523809523,21,20,CCGGCGCGGAGCAAGTTCAG,1,847066
dgoRp,1.6666666666666667,54,20,CCGCATCACTATCGGATTTG,34,860677
dgoRp,0.5714285714285714,31,20,CCGATACAAGCCGGCGAGCT,11,864215
dgoRp,1.8571428571428572,58,20,CCCCCTCAGAGATATTGCAA,38,837760
dgoRp,0.23809523809523808,24,20,ATGTCCTTCGGAGAATCGTT,4,845383
dgoRp,0.5238095238095238,30,20,ATATTGGGCTTACAAAGGAA,10,838226
dgoRp,0.5238095238095238,30,20,ATAGCCGATAAGTACGAATT,10,852327
dgoRp,0.09523809523809523,21,20,AGTAGTGATGAGGACTGAGA,1,838111
dgoRp,0.8095238095238095,36,20,AGGGTTAGAAGGTCGCCGCT,16,850966
dgoRp,0.38095238095238093,27,20,AGGGTATAATACACCATCGT,7,847942
dgoRp,0.7619047619047619,35,20,AGATAGATTAAGAAGCAAAA,15,855269
dgoRp,0.9047619047619048,38,20,ACTTAACCAAGCTCAGACCA,18,843155
dgoRp,1.2857142857142858,46,20,ACGTTGGCGGCTTCGAGAAA,26,861979
dgoRp,0.7142857142857143,34,20,ACCGAGTCTGGATCCCCCGG,14,838818
dgoRp,1.0952380952380953,42,20,AAGTATGGGTAATCCCTTGA,22,847220
dgoRp,1.1428571428571428,43,20,AAGGCCACCGATACCCCTAG,23,854282
dgoRp,1.2380952380952381,45,20,AACCTTCTCAACAAAGGACC,25,857106
dgoRp,1.4285714285714286,49,20,AACCTCGGCACCCCAACTGC,29,842677
dgoRp,0.75,33,19,TTGACATCTCCGGTCCTGAC,14,860471
dgoRp,1.2,42,19,TTCTCATAGAGCCCCGTCAA,23,859204
dgoRp,0.1,20,19,TTCGTTGTCTGACTCAGTGG,1,836976
dgoRp,1.3,44,19,TTAGGCTCGAGTGGATAGAA,25,844240
dgoRp,0.55,29,19,TTACATAGTAAACTCTATCA,10,857067
dgoRp,0.35,25,19,TGAGGTTACAAGGTAAAACC,6,856519
dgoRp,1.05,39,19,TGAAGCTCAGTGTGAGAGCG,20,862082
dgoRp,1.4,46,19,TCTGATGGTTAACGACATCT,27,846155
dgoRp,0.7,32,19,TCGTTAGGGGGTTCTCTACT,13,850868
dgoRp,0.45,27,19,TCGTCCGCGCAATTGAACAA,8,835838
dgoRp,1.45,47,19,TCCTGATCCCTCTCAAGTCT,28,861128
dgoRp,0.9,36,19,TCCAGTATAAGAAAAATAAA,17,839243
dgoRp,1.15,41,19,TATGCTGACACTCGACGCAT,22,837787
dgoRp,2.05,59,19,TATCTCATTCCGAACTCATA,40,848390
dgoRp,0.95,37,19,TAGGTCATTCGTACTTAAGT,18,861454
dgoRp,0.6,30,19,TAGGCGTCAGGATCAACTCA,11,839863
dgoRp,1.25,43,19,TACGACGTGCGTATGCCTAA,24,850088
dgoRp,1.65,51,19,TACCTAGGAGACATTATAAG,32,865448
dgoRp,0.5,28,19,TAAATGCGATTTATCGGTGA,9,860211
dgoRp,1.05,39,19,GTTGGCGTGTAACGTCCAAC,20,840364
dgoRp,1.65,51,19,GTCTCGTCTCGGCCATAGGT,32,857462
dgoRp,2.15,61,19,GGCCCTCGGCCATTTTTTAA,42,864992
dgoRp,0.95,37,19,GCTCCAGCGGAGCTCGACTA,18,857705
dgoRp,0.65,31,19,GCGTTCACGAGGAAACAGTT,12,858288
dgoRp,1.45,47,19,GCATCTTGCCACGCCTATAA,28,840896
dgoRp,0.75,33,19,GCAGACGGCACATTTGTCGC,14,850244
dgoRp,1.1,40,19,GCACTGTCCATAGGAGAGTC,21,837163
dgoRp,1.3,44,19,GATTTACGAGTATGTTCGTC,25,849705
dgoRp,0.55,29,19,GAGGCACACGACATTCGGTT,10,848223
dgoRp,1.75,53,19,GACATTAGTGAGATGTCTAG,34,862584
dgoRp,0.25,23,19,GAACGGCATCGGAATGCGGT,4,846322
dgoRp,0.5,28,19,CTGCCGGCGCACTCAATCAA,9,846338
dgoRp,0.65,31,19,CTAGTCTTAAATACGCAGAG,12,853743
dgoRp,2.2,62,19,CGTCGGACGTACATTAGTCG,43,863492
dgoRp,0.8,34,19,CGTACGCAGCGAGACTTCTA,15,840314
dgoRp,1.8,54,19,CGGTGTCGTGGGGTCCACGC,35,851504
dgoRp,2.2,62,19,CGGTCAATCATAGAGCAAAC,43,854552
dgoRp,0.25,23,19,CGGTACTTCGTAGAGTATTG,4,848943
dgoRp,3.7,92,19,CGGCCCGTTACAGCGGTATT,73,837594
dgoRp,1.05,39,19,CGCCAGTAATTGCGCGCTGT,20,850278
dgoRp,1.45,47,19,CGATCGGGGCATTATGAATT,28,861017
dgoRp,0.95,37,19,CGACCCGTCCGACGGGGCCA,18,848817
dgoRp,1.5,48,19,CCGAATGCTTAGTACGCGAT,29,857929
dgoRp,0.4,26,19,CCATGTCAATCCCGAACCGA,7,847995
dgoRp,0.9,36,19,CCACCTCTTTACAATCCAAC,17,864645
dgoRp,0.7,32,19,CACATCTCGGTTGGCTCAAT,13,846996
dgoRp,0.15,21,19,CACAGCTATGTTAAAGCAGC,2,857643
dgoRp,1.25,43,19,CAATGGCCCAGCCCGCTGGC,24,846970
dgoRp,1.75,53,19,ATTGGTTCGGGATTCTGTTG,34,842822
dgoRp,0.75,33,19,ATGCATACATCCTCGTCCCT,14,850831
dgoRp,2.9,76,19,ATGAGCTCCTGGCTAGACAA,57,850123
dgoRp,1.25,43,19,AGTGGGGAGCCATCCTAGCT,24,851183
dgoRp,0.75,33,19,AGGTTTGTTGCCACAGGAAC,14,851241
dgoRp,0.55,29,19,AGGCGGCCCACAACCGGAAG,10,853942
dgoRp,1.0,38,19,AGCTCTGGTTTGTAACAAAG,19,836266
dgoRp,0.3,24,19,AGATTTGGGTCGGATGCAGT,5,855456
dgoRp,0.8,34,19,ACGATACCTGCGATCTAGCT,15,850909
dgoRp,0.9,36,19,ACCCTAGCAAGGCTAACTAT,17,842783
dgoRp,1.9,56,19,AATGGATAGTACTGCCAGTA,37,839366
dgoRp,0.75,33,19,AATGGACCATTTACTTCGTA,14,844893
dgoRp,0.35,25,19,AATAGGCTCGAAATAGCAGA,6,862221
dgoRp,1.0,38,19,AAGTAGGATCGCCAGATGAA,19,838435
dgoRp,0.6,30,19,AAGACGCAGAGTACGCGATA,11,851964
dgoRp,1.263157894736842,41,18,TTTGGGCCTATGCGTGGATA,23,843850
dgoRp,0.8947368421052632,34,18,TTTGATTTGGGGCTTTAAAG,16,854342
dgoRp,0.631578947368421,29,18,TTGTACCACGCTAGAGTGTT,11,843475
dgoRp,0.8421052631578947,33,18,TTGCAAAGCATTCTTTACGA,15,840499
dgoRp,0.5789473684210527,28,18,TTCCCCGAGCGTGGCGTACC,10,856918
dgoRp,1.2105263157894737,40,18,TGTGGGGAACATTTACATTC,22,855711
dgoRp,0.10526315789473684,19,18,TGGTGTGGCCGCTGCATCCT,1,859336
dgoRp,1.263157894736842,41,18,TCTCTGCAGGTGTGTCTTGT,23,847294
dgoRp,3.526315789473684,84,18,TCGGCTCGAGCAGTAATTGC,66,839760
dgoRp,0.47368421052631576,26,18,TCGCACATTCCGCTTATGGT,8,858996
dgoRp,1.368421052631579,43,18,TCCACTTGCTTCGGGAGGAG,25,863408
dgoRp,0.8421052631578947,33,18,TATGCAGGAACACACCTGTC,15,838246
dgoRp,0.10526315789473684,19,18,TATATTAGCGATGGTCCGTG,1,838223
dgoRp,1.5263157894736843,46,18,TATACCCTGCACCTCTCTGC,28,861304
dgoRp,0.2631578947368421,22,18,TAGCATAGGTTGGTCCTGGG,4,856995
dgoRp,0.10526315789473684,19,18,TACTTCTCATCGCGATGTTC,1,860138
dgoRp,1.894736842105263,53,18,TACCCTTCTCCACCTTGCCA,35,856429
dgoRp,1.368421052631579,43,18,TAATGTCGTGCGAGCACCAC,25,844235
dgoRp,0.8947368421052632,34,18,TAAGCCGGGACATTGTCCCT,16,837229
dgoRp,0.3684210526315789,24,18,GTGTTATTGACTCGAAGCGC,6,846425
dgoRp,0.8421052631578947,33,18,GTGTCACCATTTGGATCTAT,15,839021
dgoRp,0.8421052631578947,33,18,GTGTAGCCGCATTGTGAGTC,15,840782
dgoRp,1.1578947368421053,39,18,GTCGGGGGTATGTAAGCTAT,21,860116
dgoRp,5.526315789473684,122,18,GGGGTCTCGTCTCTCCGAGC,104,864441
dgoRp,1.105263157894737,38,18,GGGATGGCTGCGCCCGCTTA,20,843089
dgoRp,0.42105263157894735,25,18,GGAAATGTCAGATACCCCTT,7,848121
dgoRp,0.7368421052631579,31,18,GCCTCACGTATACAGGCCGG,13,838114
dgoRp,2.473684210526316,64,18,GCCGTCTTTATCGTGACTGA,46,839159
dgoRp,3.789473684210526,89,18,GCACCGATGCGAACACTTGT,71,845646
dgoRp,1.0526315789473684,37,18,GATAAAGCCGTTTGCTGACA,19,859644
dgoRp,0.5789473684210527,28,18,GAGCCCTTAGCCGCGCGAAG,10,847541
dgoRp,0.7894736842105263,32,18,GACAGTATCGTTGTTTCATA,14,866448
dgoRp,1.368421052631579,43,18,GAAGTGCCGGTGAGCGAAAA,25,845737
dgoRp,2.6842105263157894,68,18,CTGATCCTCTGTTGACACCT,50,835865
dgoRp,1.1578947368421053,39,18,CTCTGTCAACATCACTGCGC,21,859951
dgoRp,1.3157894736842106,42,18,CGGGGAAAGAGTCACGTAGC,24,862568
dgoRp,0.5789473684210527,28,18,CGAAGGCTATCGAGAAAGCA,10,844606
dgoRp,5.421052631578948,120,18,CCTCTCAGTCGGGGTGTTTA,102,854901
dgoRp,0.47368421052631576,26,18,CCGTTGTGCACGAAGATTTG,8,852167
dgoRp,1.6842105263157894,49,18,CCGTTGCCACAGTAGAATGC,31,862242
dgoRp,0.7368421052631579,31,18,CCGTCTGGCGCAGCCCAGAG,13,839287
dgoRp,1.3157894736842106,42,18,CCGTAACATTTACCCCCGCG,24,840140
dgoRp,0.6842105263157895,30,18,CCGCCAAACCAAGGGGCTAC,12,862396
dgoRp,1.263157894736842,41,18,CCGAGTTCCATGACTCCTTA,23,863209
dgoRp,1.368421052631579,43,18,CCCCAATGTCCTGCGTCGAT,25,845609
dgoRp,0.42105263157894735,25,18,CCAGGGTCAATTCGCTCAGC,7,854227
dgoRp,0.7368421052631579,31,18,CCACCGATGAGATGTGCCCT,13,845624
dgoRp,3.4210526315789473,82,18,CCAACGTGATTCCGGGTATT,64,864994
dgoRp,1.4736842105263157,45,18,CATGGCCTCTCACGGAACAA,27,840090
dgoRp,1.631578947368421,48,18,CAGCCCCCGGTCTCTGGTTA,30,863007
dgoRp,0.10526315789473684,19,18,CAACGCCAGAAATGATGCGA,1,865145
dgoRp,2.0526315789473686,56,18,ATTGCCAACCTGGGGACCAA,38,845500
dgoRp,0.7894736842105263,32,18,ATGTTAGTTACAGGGGCTAG,14,838190
dgoRp,0.3684210526315789,24,18,ATCACGTGAAAGCCTGCTCG,6,837614
dgoRp,8.526315789473685,179,18,ATATAACATACGCTAGTGAT,161,864228
dgoRp,0.7368421052631579,31,18,ATAGATTGGAATCGTGCACG,13,865407
dgoRp,0.10526315789473684,19,18,AGTAATGTAAGCCCCCTTTT,1,860769
dgoRp,0.7894736842105263,32,18,AGGAGTATTTATCTATGGAC,14,861291
dgoRp,1.736842105263158,50,18,ACTCGAATACGACGAAGGCG,32,841234
dgoRp,0.42105263157894735,25,18,ACTCGAACACGTCGCAGTTC,7,844542
dgoRp,1.3157894736842106,42,18,ACGCGCGCTACTATGGGATT,24,837377
dgoRp,2.0526315789473686,56,18,ACCAGATCTGAGGGTAGGTT,38,837365
dgoRp,0.5789473684210527,28,18,ACCACTGTATAGGATTAATT,10,849532
dgoRp,1.263157894736842,41,18,AAGCTGTGGAATAATCGTCA,23,849634
dgoRp,1.0526315789473684,37,18,AAGATACAGAGTGCCACAAA,19,845544
dgoRp,0.10526315789473684,19,18,AAGAGATAACGCATCGACAT,1,848418
dgoRp,1.0526315789473684,37,18,AACCACCTTGTACTTAGCAG,19,864773
dgoRp,0.5789473684210527,28,18,AAAGCGAGCTAGGCGGTAAC,10,860695
dgoRp,0.5263157894736842,27,18,AAACTAAGTGTGGTATGTAA,9,844009
dgoRp,1.9444444444444444,51,17,TTTTCATTGGTATCAAGTGC,34,838882
dgoRp,0.9444444444444444,33,17,TTGTGATGCGTCAATCCGCT,16,856200
dgoRp,0.6666666666666666,28,17,TTGCCCTGCCATACGGAAAC,11,841812
dgoRp,0.8333333333333334,31,17,TTCGGTCACGTTGGACGCAT,14,837759
dgoRp,0.1111111111111111,18,17,TGTGCGTTGTGATACATAGT,1,865748
dgoRp,1.1111111111111112,36,17,TGTCGTCCGAGTGACCCGAA,19,840895
dgoRp,1.5,43,17,TGATGCTTGGGTGACTTAAG,26,838189
dgoRp,0.4444444444444444,24,17,TGAACGTGGGGGGCCTATAT,7,862471
dgoRp,1.5,43,17,TCCTGTGTTGATCGCCGGAA,26,840995
dgoRp,3.4444444444444446,78,17,TCATTACAGCAGGGGACAAA,61,848763
dgoRp,1.2222222222222223,38,17,TATATGAGTGGAGAGATTCG,21,849362
dgoRp,0.6666666666666666,28,17,TATAGTTTTGGAGACGTTGA,11,859230
dgoRp,1.6666666666666667,46,17,TAGCGTTAAGTTAGATGTGG,29,851569
dgoRp,1.1666666666666667,37,17,TAGCCTGTGGTGGGTTACAA,20,860297
dgoRp,0.7777777777777778,30,17,GTCTTGTCCCCGTGCAAACC,13,836001
dgoRp,0.1111111111111111,18,17,GTCTCACTCGACTTCGTAGG,1,861573
dgoRp,0.9444444444444444,33,17,GTCCGGCGTCACGCATGTAG,16,858682
dgoRp,0.1111111111111111,18,17,GTAACGGGGGACAGTCATAT,1,854746
dgoRp,0.8888888888888888,32,17,GGGCGTGCACTTCGGGTCTT,15,865184
dgoRp,0.7222222222222222,29,17,GGCGACATAAAGCCGGGGTG,12,850971
dgoRp,0.8888888888888888,32,17,GGATTAATACAAACATTAGT,15,847023
dgoRp,0.4444444444444444,24,17,GGAACACGCTGCGTGGCCGT,7,852005
dgoRp,0.8333333333333334,31,17,GCGTTTTACATGACACCAAA,14,836372
dgoRp,0.9444444444444444,33,17,GCCTTCGACCACCGGGGCTC,16,835995
dgoRp,1.0,34,17,GCATTTCTCGATCCTCATGA,17,844385
dgoRp,0.1111111111111111,18,17,GCATCCCTGTTAGGTTTGAT,1,838412
dgoRp,0.2222222222222222,20,17,GATTATGGCATCACAACTAC,3,851770
dgoRp,1.0,34,17,GATAAAACGCAATACACCAT,17,856798
dgoRp,0.5,25,17,GACTCTGCTTGTGCTCCGAA,8,838075
dgoRp,0.2777777777777778,21,17,GACTCGACGGGATCCCGTAT,4,855077
dgoRp,0.4444444444444444,24,17,GACGCACCAACACACCGGTA,7,843708
dgoRp,0.8333333333333334,31,17,CTGGACACTAAAGATAGTTT,14,851967
dgoRp,0.6666666666666666,28,17,CTAATAAATGCCATGTACGG,11,856634
dgoRp,0.8888888888888888,32,17,CGTTGTGGGATGTGAACGTG,15,862874
dgoRp,1.1666666666666667,37,17,CGTTCCGGCCTTGTAAGCAC,20,840369
dgoRp,1.2222222222222223,38,17,CGATCAAGATCTCTGCGGAC,21,839936
dgoRp,1.1666666666666667,37,17,CCTTTAAATGCTGCAATAAA,20,860163
dgoRp,0.1111111111111111,18,17,CCTCGTATTATGCATTACTC,1,847737
dgoRp,0.3333333333333333,22,17,CCTCGTAATATAAGCTGAAC,5,860295
dgoRp,1.2777777777777777,39,17,CCGAGAGACTGATTCGCAGT,22,838991
dgoRp,0.1111111111111111,18,17,CCCTGGCAACGGGCGAGGGG,1,859284
dgoRp,2.2222222222222223,56,17,CCCCTGGGTATGACACCGCT,39,855321
dgoRp,1.5555555555555556,44,17,CCAGTGGGCGTGCGCATGGG,27,849296
dgoRp,4.055555555555555,89,17,CCAGAAGTCTGCACAGCCCG,72,866722
dgoRp,0.8888888888888888,32,17,CCACGGGCAATAGGCAGTTC,15,837762
dgoRp,0.1111111111111111,18,17,CATGTTGTCCTATAAGGTAT,1,865519
dgoRp,0.7777777777777778,30,17,CAGTCCTCCCTGCTTTACGT,13,840303
dgoRp,0.1111111111111111,18,17,CAGATTGTTAGCCCGCATAT,1,837005
dgoRp,0.1111111111111111,18,17,CAGATCAATGTGGACCAGAG,1,836705
dgoRp,0.7777777777777778,30,17,CAGAATAAAGGGTGGGGTCC,13,839268
dgoRp,0.8333333333333334,31,17,CACTCGGAAACTGGCCTACC,14,839116
dgoRp,1.0,34,17,ATTTATTCTTGATACTCCGA,17,856981
dgoRp,0.8333333333333334,31,17,ATGGGGCGTACGATAAGCAA,14,855619
dgoRp,0.6666666666666666,28,17,ATGAGGCCGCTGTTTGTGAA,11,849598
dgoRp,0.3888888888888889,23,17,ATGACTCCAGTACAACTTTG,6,861267
dgoRp,0.7777777777777778,30,17,ATCGACAAACGCATAGCGAA,13,846629
dgoRp,0.5,25,17,ATCCAGTTTTGAGGAGGATA,8,857862
dgoRp,0.5,25,17,AGTTTAACTCCTAGGTAAGT,8,853214
dgoRp,0.2222222222222222,20,17,AGTTCTGGCGAGGTGCATCT,3,837057
dgoRp,0.8888888888888888,32,17,AGGTATAGGGCTGGCCTCGA,15,867472
dgoRp,0.5,25,17,AGGCGATACGCTGGCATCTT,8,862722
dgoRp,0.7777777777777778,30,17,AGATAGCATTATCTCAGCAT,13,841192
dgoRp,0.2222222222222222,20,17,AGAGGACCTGGTCTATTCAT,3,848948
dgoRp,0.5,25,17,ACTTCGACAATTGCAAGACG,8,845798
dgoRp,1.1111111111111112,36,17,ACTCCCTAAACACTTTCTAA,19,837236
dgoRp,0.5555555555555556,26,17,ACGCCCCCATAACCCAGCTA,9,862382
dgoRp,0.8888888888888888,32,17,ACCGCGAGGCTTTTACGAGG,15,867367
dgoRp,1.1666666666666667,37,17,AATACGCTTCATAGGCAACC,20,849352
dgoRp,2.4444444444444446,60,17,AAGCTATATTGGGGTTATCA,43,863910
dgoRp,1.0555555555555556,35,17,AAGCACAAGGAGTGCAACAT,18,857713
dgoRp,0.7222222222222222,29,17,AACCGTGTCAACAACCTTTG,12,856970
dgoRp,0.4444444444444444,24,17,AACCCACCGTTCGTGTAGTT,7,866092
dgoRp,1.1666666666666667,37,17,AAAGAAGACGTATCGAACAT,20,840787
dgoRp,0.7647058823529411,28,16,TTGCCTCTGTTTTGGCGGAA,12,846875
dgoRp,0.47058823529411764,23,16,TTGAATCTCCCTCGTTGGCA,7,849507
dgoRp,0.7058823529411765,27,16,TTCATGCCGTGGGCTGAGGG,11,846352
dgoRp,0.8823529411764706,30,16,TGTGTTATTTAATAACTCGG,14,839734
dgoRp,1.7058823529411764,44,16,TGCTGAGACACATACGGCAA,28,859464
dgoRp,1.8235294117647058,46,16,TGCGAAAATCTGCTGCGGTT,30,838613
dgoRp,5.470588235294118,108,16,TCTTGGAAAAGAGTCTCTGT,92,846108
dgoRp,1.8235294117647058,46,16,TCCGTTTTCCAATCAGTCCT,30,843446
dgoRp,0.23529411764705882,19,16,TATTTGCAGGTTTTTTGAAA,3,855142
dgoRp,0.11764705882352941,17,16,TATCCTAGGGCTCCTCACTG,1,847816
dgoRp,1.8235294117647058,46,16,TAGAGCCAAGGCCTAAATAA,30,847033
dgoRp,0.23529411764705882,19,16,TACTCGCGACACGAAATGCA,3,839390
dgoRp,0.5294117647058824,24,16,TAATATAGTTATACGGGTGA,8,854949
dgoRp,0.47058823529411764,23,16,TAATACATGTAACTCCTGTC,7,844470
dgoRp,1.411764705882353,39,16,TAAGTTGGGGTTAAGCCGAT,23,840717
dgoRp,1.2352941176470589,36,16,TAACGAATTGGGCTTTTCAA,20,865388
dgoRp,0.11764705882352941,17,16,TAAACAGGTGTGTACAAAAT,1,848791
dgoRp,3.8823529411764706,81,16,GTTTGGGAGTCCGTAGCCAC,65,851825
dgoRp,1.8823529411764706,47,16,GTTGAGTGTCATGTTTGACT,31,865360
dgoRp,0.6470588235294118,26,16,GTTCAGTGACATACAACCTG,10,858845
dgoRp,1.7058823529411764,44,16,GTGGCTGGACCGTGTGTAAC,28,859619
dgoRp,0.7647058823529411,28,16,GTCTATTCAGTACATACTCA,12,849028
dgoRp,1.1764705882352942,35,16,GTCCCGGCGTCGTGTTGCAA,19,857320
dgoRp,1.1764705882352942,35,16,GTATGGACTTGTCTGTTAAC,19,853892
dgoRp,0.8235294117647058,29,16,GTATATCAATCCCTAGTCAA,13,845102
dgoRp,1.2352941176470589,36,16,GGTTCTGCTGTAGAGTTCCT,20,838719
dgoRp,0.29411764705882354,20,16,GGTCTCAGGGTCTAGTATTC,4,858507
dgoRp,1.6470588235294117,43,16,GGATCGTGGAATCGCGTGTT,27,840856
dgoRp,0.5882352941176471,25,16,GCTGCAACTCGTATCCAGCT,9,849975
dgoRp,0.6470588235294118,26,16,GCATGACGCCAGCAATGAGT,10,855669
dgoRp,0.35294117647058826,21,16,GCATCAGATCGGGCGCGTAG,5,838410
dgoRp,1.1176470588235294,34,16,GATTACGGGCCAACCTGACT,18,852787
dgoRp,0.35294117647058826,21,16,GATCGTATTCGTCGGCTGGG,5,865228
dgoRp,0.5294117647058824,24,16,GATCCTCGGTCGGCGGCGAG,8,837826
dgoRp,1.6470588235294117,43,16,GAGTATGTCTCCGAGTCGGA,27,837956
dgoRp,0.29411764705882354,20,16,GACAGCGCACGTGACCGGAA,4,836181
dgoRp,1.1764705882352942,35,16,CTTTTGCGATGGGCAAATGC,19,838860
dgoRp,0.35294117647058826,21,16,CTTAATGCAAAATCGTCCTT,5,841675
dgoRp,1.1764705882352942,35,16,CTCAATGGCATTCGCTCTGG,19,839254
dgoRp,1.3529411764705883,38,16,CTATCAAGAACTCCAGCTTG,22,855288
dgoRp,0.5882352941176471,25,16,CTAATTGGGTATCTGAACCC,9,839836
dgoRp,0.47058823529411764,23,16,CGTTGAGCAGTGCAGTGCTT,7,855417
dgoRp,1.3529411764705883,38,16,CGTACTGCCTTCCAGAAGTT,22,840829
dgoRp,1.2941176470588236,37,16,CGGTATTGCGGTGATGATAA,21,846828
dgoRp,3.823529411764706,80,16,CGCGTTCGACGCGTCTCTAG,64,851620
dgoRp,0.4117647058823529,22,16,CGAGTTGATCATCGAGACCC,6,857130
dgoRp,0.47058823529411764,23,16,CGACAGTACGAGGCAGACGA,7,838737
dgoRp,1.6470588235294117,43,16,CCTGAGTTTGTATAATCGAA,27,856678
dgoRp,0.4117647058823529,22,16,CCTGAGTGGTAACCCCAACC,6,842779
dgoRp,3.0,66,16,CCAAGTTGATACGCTCAATT,50,858971
dgoRp,0.7647058823529411,28,16,CAGGGCTCCAGTTACTTCGT,12,852137
dgoRp,0.47058823529411764,23,16,CAGGAGCGACCTGCTTCTTG,7,856902
dgoRp,0.4117647058823529,22,16,CAGCAATTGAAGGTGGATTA,6,864625
dgoRp,1.588235294117647,42,16,CAGACGTTCCAGCCAATGGT,26,845878
dgoRp,1.8823529411764706,47,16,CAATGAACCACCGCGTATGA,31,852385
dgoRp,0.8235294117647058,29,16,CAAGACGCCCATACCACTTT,13,840744
dgoRp,0.11764705882352941,17,16,ATGCTCTGGGGATGGCCTGC,1,842297
dgoRp,1.8823529411764706,47,16,ATGCCCCCACTCCCGGTCTA,31,849398
dgoRp,0.7647058823529411,28,16,ATCCGGCATATAAGTACCTA,12,862670
dgoRp,0.17647058823529413,18,16,ATCCCTTCATCTTGCCGTAA,2,841839
dgoRp,0.47058823529411764,23,16,ATCAAGAGCGGTTAAGACTT,7,844508
dgoRp,0.5294117647058824,24,16,AGGTCAGTTCGCTCTATAGT,8,840912
dgoRp,0.7647058823529411,28,16,AGGCTATGCATATTGCTATC,12,859182
dgoRp,0.6470588235294118,26,16,AGCAGCCTCACCAGGGGTAA,10,847977
dgoRp,2.7058823529411766,61,16,AGATAGATATAACGGACGGA,45,857365
dgoRp,1.1764705882352942,35,16,AGAGGCACTGAATCCTCCGT,19,837680
dgoRp,1.2941176470588236,37,16,ACGGAACATAATGCAGCTAC,21,865683
dgoRp,2.2941176470588234,54,16,ACGACGTGTTCACATGCTAC,38,852468
dgoRp,1.2352941176470589,36,16,ACCCAGGGTTGAGGTCAATA,20,858787
dgoRp,1.6470588235294117,43,16,ACAAAACAGGTGATGTCCGA,27,838666
dgoRp,0.11764705882352941,17,16,AACGCGAAAAATGTCATGGA,1,839680
dgoRp,1.7058823529411764,44,16,AACAAGGCCCCCGTTTTATA,28,841200
dgoRp,1.3529411764705883,38,16,AAATCTCATCGTTCTAATTA,22,867006
dgoRp,0.6875,25,15,TTTTAGGTTTGAGAAATTCA,10,836760
dgoRp,0.9375,29,15,TTGTTTGCTGCCCTCGGCTG,14,837871
dgoRp,0.125,16,15,TTGTCACGGAGCAAGACTTT,1,836929
dgoRp,1.8125,43,15,TTCATCCCTTTTTCGGCTAC,28,840635
dgoRp,0.9375,29,15,TGTTCATGAGTACATCCTGC,14,851162
dgoRp,0.3125,19,15,TGGTTACTCATACATCCGTG,4,865484
dgoRp,0.875,28,15,TGGAATTATTATCTTCGGAG,13,839949
dgoRp,0.75,26,15,TGAGGACCCTGTCAAGACTG,11,865010
dgoRp,2.375,52,15,TGAAATGCAGTCACCTCGGT,37,855491
dgoRp,0.625,24,15,TCTCGGGCCAAGGGTCGTAC,9,843676
dgoRp,1.5,38,15,TCGGCTACTGGCCGAGTGCT,23,863614
dgoRp,0.125,16,15,TCCGGACTATTGATCTATAC,1,851561
dgoRp,1.125,32,15,TCAACGGGGACTGCCTGGAA,17,858573
dgoRp,1.75,42,15,TATTCATGCCTGGTTAAAGA,27,858640
dgoRp,0.6875,25,15,TATGCATCACCTACACCTAA,10,840845
dgoRp,1.9375,45,15,TACCTACCTATAAGCGTGTG,30,848762
dgoRp,0.6875,25,15,TACATATGCCAACGTGTTTA,10,841152
dgoRp,0.9375,29,15,TACACGTTGTCGCACATGCC,14,861195
dgoRp,0.875,28,15,TACACACGACCGGCTTATCT,13,849323
dgoRp,2.0,46,15,TAAGCGGCGGAAGATCCGTC,31,835823
dgoRp,0.125,16,15,TAACGACCGGTGTCTCCACA,1,863996
dgoRp,0.1875,17,15,TAAACCCTGCTACTCGAATT,2,854537
dgoRp,1.5,38,15,GTTCCGGGATTTCCGACAAG,23,838036
dgoRp,1.3125,35,15,GTTATGGCCCGCCTAGGTTA,20,837480
dgoRp,0.75,26,15,GTGCAGCCAGTGTGTGTGTC,11,863964
dgoRp,1.75,42,15,GTCTTCGGTCAGGTTTGGGA,27,838962
dgoRp,0.875,28,15,GGGCAGGGGGATCGGCAAAA,13,838983
dgoRp,2.5,54,15,GGCGTTAAGAGGCCCCCACA,39,851035
dgoRp,1.5625,39,15,GGCCCGCGGGCAGAGACGAA,24,843069
dgoRp,0.8125,27,15,GGAGGGTTAATACGATAGTA,12,844263
dgoRp,0.1875,17,15,GGAATTCGTACCTCGCACCA,2,846504
dgoRp,0.3125,19,15,GGAAAGGGGCCTTCGTACTT,4,845439
dgoRp,5.5,102,15,GCTTGTAGCCTTTGATGGAA,87,859124
dgoRp,0.1875,17,15,GCTCCCGAAGTTAAGTCGTA,2,852405
dgoRp,0.25,18,15,GCGCCGCTATGCGGTTCAAT,3,838721
dgoRp,0.375,20,15,GCCGGCGCTGGTTCCTTGTA,5,861163
dgoRp,0.875,28,15,GCAGCCTCTGCGCGCTGCCA,13,853024
dgoRp,1.0,30,15,GATGACTGGTGGAACTGATT,15,864977
dgoRp,1.375,36,15,GATAGGACGGGACCCATCGT,21,862570
dgoRp,1.25,34,15,GATACAACTTAGGGCTACCA,19,849640
dgoRp,0.25,18,15,GATAACGGGAAATTAACAGA,3,840362
dgoRp,1.25,34,15,GAGTTCTCGGTTCGGGGATA,19,840842
dgoRp,0.375,20,15,GACGTCTCTGGCCTTTGCAA,5,849732
dgoRp,1.5,38,15,GAAGTGTGCACAGTGCATCT,23,851823
dgoRp,1.0,30,15,CTTTCCACCTGACAATGGGT,15,838817
dgoRp,0.4375,21,15,CTGCCGGCATGTGTGTGCAT,6,846521
dgoRp,1.9375,45,15,CTGAACAAGCATTGTTGCTT,30,856857
dgoRp,1.5,38,15,CTATTGGACAACCGAACAGT,23,836126
dgoRp,0.9375,29,15,CTAGGCCGGAGCCAAGAGGC,14,859716
dgoRp,0.625,24,15,CTACCACAGCAGACCTGTCC,9,858211
dgoRp,0.4375,21,15,CTAACAGTTATCCTCTTTCT,6,862376
dgoRp,0.625,24,15,CGTTTGCCCGGTTATCTCTT,9,848039
dgoRp,0.6875,25,15,CGTTTATGTTAGGGGAAGAA,10,857131
dgoRp,1.4375,37,15,CGCCTTGAAATAACAAAGTG,22,845287
dgoRp,1.3125,35,15,CGCCATGGCATACTATATGT,20,855012
dgoRp,0.75,26,15,CCTGAGCAGATCCAGTTTTT,11,842419
dgoRp,1.625,40,15,CCGGTTCAATGTGGAATCAG,25,845010
dgoRp,1.0625,31,15,CCCAAAGCCCCATCTCGCTG,16,859844
dgoRp,0.625,24,15,CCACGTTGGACACTGCGACC,9,839155
dgoRp,1.4375,37,15,CCAACCTGTCCAATGTCGTC,22,839237
dgoRp,5.4375,101,15,CATTTGCGTATAAGAATTCT,86,852587
dgoRp,1.1875,33,15,CATGTATCAGAGGTGACAGA,18,864724
dgoRp,1.5,38,15,CATGGTGGTGAAACCCCTAT,23,865812
dgoRp,0.8125,27,15,CAATTTCGGACGTTGTTCTA,12,853807
dgoRp,0.6875,25,15,CAAGATTGCTTCTCCGCGGA,10,859649
dgoRp,0.125,16,15,CAAAGAACAGCCATGCCCTC,1,862515
dgoRp,0.75,26,15,ATTTTAGGCTCGATCCGCGC,11,842181
dgoRp,1.0,30,15,ATTTGTTGTTACGGCGACCT,15,852360
dgoRp,1.0625,31,15,ATCCGCCTGACCCTTATAGT,16,838497
dgoRp,0.375,20,15,ATCACCACAGGCATCCTAAA,5,842067
dgoRp,0.4375,21,15,ATAGTTCTTCTGGTGTATGT,6,853842
dgoRp,0.3125,19,15,AGTGCGAAGAGACGAGCTAA,4,865462
dgoRp,0.875,28,15,AGGTTTCCGAGCACTACTCT,13,865369
dgoRp,0.875,28,15,AGGTCAAGCAAGATTCTACA,13,835864
dgoRp,0.8125,27,15,AGGATTTACCATAGCCAGCC,12,864471
dgoRp,2.8125,59,15,AGAGGTTCGACATTCTAGTC,44,850718
dgoRp,2.0,46,15,ACTCTCGGTCCCACTGCCCA,31,854224
dgoRp,0.75,26,15,ACGGGCTCAGTGCCATGCGC,11,852689
dgoRp,0.3125,19,15,ACGCAAATTCCGCCGCACCA,4,843867
dgoRp,0.9375,29,15,ACGACAGCTGTGCACTTCAC,14,845502
dgoRp,2.3125,51,15,ACCCGAACCCTGGCATAACA,36,843756
dgoRp,0.4375,21,15,ACCATGAGAAGTCTCAGGCG,6,836771
dgoRp,1.375,36,15,ACAAATCAATGTGTCACCAC,21,835924
dgoRp,3.8125,75,15,AATTCGCTGCCTATCGTGAT,60,848919
dgoRp,0.125,16,15,AACTGGGATATTGCGGAATT,1,853319
dgoRp,0.6875,25,15,AACCTGACCGTCTGCAATTA,10,843376
dgoRp,0.75,26,15,AACAATGATTGACTTGGTAC,11,845762
dgoRp,0.6875,25,15,AAAGGGCAAGGCACACCGGT,10,847681
dgoRp,7.266666666666667,122,14,TTCATCATGGTACTTGCTCT,108,864420
dgoRp,0.13333333333333333,15,14,TTCAGGACAACGACTGCCGT,1,839840
dgoRp,1.2666666666666666,32,14,TTCACAGACGTGGTCCCCGA,18,853887
dgoRp,0.6,22,14,TTAGTACCAGTTCGAGCATT,8,842006
dgoRp,0.6666666666666666,23,14,TTACCTGTCGCAAACCCGGT,9,839482
dgoRp,0.26666666666666666,17,14,TTAATCTTGCATCATATCAT,3,849290
dgoRp,1.3333333333333333,33,14,TGTGTGACAAGCATGTTGCA,19,838485
dgoRp,1.0,28,14,TGTGGGGGGGGAGTTTTAAA,14,841471
dgoRp,1.0,28,14,TGTGGGCTCATAGATCGTGC,14,850087
dgoRp,0.7333333333333333,24,14,TGTGAGCATCATGGGAGTCT,10,843679
dgoRp,1.0666666666666667,29,14,TGGCTAATCTTGTATCACCT,15,851151
dgoRp,1.0666666666666667,29,14,TGGACCGGCGCTGTGTGTTG,15,844585
dgoRp,1.2666666666666666,32,14,TGCGCGACTTTAAGGCTCGT,18,847506
dgoRp,0.6666666666666666,23,14,TGACGTCACTTTTCGTTAAT,9,864743
dgoRp,1.6666666666666667,38,14,TCTCTCAGAGAGCTGTGTAC,24,847849
dgoRp,1.0666666666666667,29,14,TCGTTTCCGTAATCTTACAG,15,858738
dgoRp,0.8666666666666667,26,14,TCCTTAATATATGCGGATAC,12,841949
dgoRp,2.0,43,14,TCCTCCCCAACAGCTGCTTC,29,854825
dgoRp,0.4666666666666667,20,14,TCCCGAGCGAGCCATCTATG,6,837568
dgoRp,0.4,19,14,TCCAAGGTTCCCATGGCAGC,5,861047
dgoRp,0.8666666666666667,26,14,TCAACGCTGGTACCGATGCC,12,853312
dgoRp,0.7333333333333333,24,14,TATAGGATATCAGCTCCTGG,10,854340
dgoRp,0.13333333333333333,15,14,TAGACGGTTCTATCGCAAGA,1,865610
dgoRp,11.133333333333333,180,14,TACTGTCCCGGAGTGAGCGG,166,866134
dgoRp,1.4,34,14,TACACGGATAACGAAACGAA,20,841487
dgoRp,0.26666666666666666,17,14,TAATAGAATGTTGCTGAGAG,3,843259
dgoRp,0.3333333333333333,18,14,TAAAATGTCTTTATTCTCCA,4,854208
dgoRp,1.0,28,14,GTTGGACTCTCTTGATCGAC,14,852864
dgoRp,1.0,28,14,GTTAGGTTACATTGAATTAT,14,847988
dgoRp,1.1333333333333333,30,14,GTCCCGGACAGTCCCGGCTC,16,844527
dgoRp,0.4666666666666667,20,14,GTATGCACCATCGCGCAACA,6,843965
dgoRp,0.6666666666666666,23,14,GTACAAGTAACATATGGGAA,9,842163
dgoRp,3.466666666666667,65,14,GTAAATGAGCTTTCTAAGGA,51,846743
dgoRp,1.0666666666666667,29,14,GGTTAAGGTTCTAGTAAATT,15,863057
dgoRp,0.7333333333333333,24,14,GGGTCAACAGTCGGACCCCC,10,863865
dgoRp,3.533333333333333,66,14,GGATAATTGAAAACAACCAT,52,845367
dgoRp,0.26666666666666666,17,14,GCTATCGTAATCGGTGATTA,3,853779
dgoRp,0.5333333333333333,21,14,GCGATATCCGAACTCTGATG,7,846518
dgoRp,0.4,19,14,GCATCTCATGGCCCCAGGGT,5,838571
dgoRp,0.8666666666666667,26,14,GATAAAACCCCGGACCGTCA,12,837621
dgoRp,0.3333333333333333,18,14,GAGTGATATTGTCTCAATGG,4,855823
dgoRp,1.0666666666666667,29,14,GAGCCCAGGGGTCGTTCTTC,15,846451
dgoRp,1.2666666666666666,32,14,GACGTGTCCCGGCCTCAGAT,18,851601
dgoRp,1.4,34,14,GAATTTGTGGTAGCCTTAAC,20,841425
dgoRp,1.2666666666666666,32,14,GAATACCTAAGTTTACCAGA,18,840080
dgoRp,0.3333333333333333,18,14,GAACCGCATGCCGCGCGGTA,4,846372
dgoRp,1.3333333333333333,33,14,CTTCGGGTTAGAGTATCTAT,19,853429
dgoRp,3.066666666666667,59,14,CTTCGCATTGAGGTGGGCGC,45,843451
dgoRp,0.8666666666666667,26,14,CTTCCAGTGAAAACTCTATC,12,855065
dgoRp,0.13333333333333333,15,14,CTTACGGAGGAAAATTGTCA,1,857693
dgoRp,1.6,37,14,CTGCGTGAAATCCTGTGTAT,23,859564
dgoRp,0.3333333333333333,18,14,CTGACGAGTGAGATGGGGCT,4,856343
dgoRp,1.2,31,14,CTAATTCTTTGCCATAGTTA,17,864633
dgoRp,0.6666666666666666,23,14,CGGTCGGTATACTGATCAGA,9,845045
dgoRp,0.8666666666666667,26,14,CGGGAACGGCACGGGCTGTC,12,855405
dgoRp,1.4,34,14,CGGATTGCGTTGTGGATCAA,20,843279
dgoRp,1.4666666666666666,35,14,CGGAGAACTCTGACATTATG,21,865575
dgoRp,2.066666666666667,44,14,CGCAACTCTACGGTTATATG,30,841109
dgoRp,1.1333333333333333,30,14,CGATGTTCTTGTCCTACCGG,16,850986
dgoRp,2.533333333333333,51,14,CCGTTCATTCGAACTTCTTT,37,841769
dgoRp,0.6666666666666666,23,14,CCGTCTCGCTATCGGTATTC,9,843305
dgoRp,1.1333333333333333,30,14,CCGGGGACATGCCGCTTCCC,16,854063
dgoRp,1.2,31,14,CCGCGGATTTTTGTATTTAA,17,856964
dgoRp,0.4,19,14,CCCCTCTGATAGAGGGAAGA,5,866253
dgoRp,1.0666666666666667,29,14,CCCCCGTCCGTTGTTTACCT,15,840155
dgoRp,1.1333333333333333,30,14,CCAGCGCTTGTGGGTGTTTT,16,852969
dgoRp,0.7333333333333333,24,14,CATGACGTGAGTTCCTCGGT,10,842223
dgoRp,1.6666666666666667,38,14,CATCAGTTGTTAAACTGTAC,24,865309
dgoRp,1.9333333333333333,42,14,CATAAGATTGTAGCTCGTGT,28,848934
dgoRp,0.4,19,14,CATAAGACCAATCGTCACAG,5,847843
dgoRp,1.6666666666666667,38,14,CACATTCACGCGCTCAAATG,24,840305
dgoRp,0.6666666666666666,23,14,CAAGGCCAGGGCCAGTCGAC,9,836380
dgoRp,0.3333333333333333,18,14,CAAATGTATTGGATTCAGGT,4,839442
dgoRp,0.3333333333333333,18,14,ATTGGTCCAGCTTGCGGGAA,4,855292
dgoRp,1.5333333333333334,36,14,ATTCGCCCATAATCCATTCA,22,847557
dgoRp,0.8,25,14,ATGTCTATGACAATTCAATC,11,867251
dgoRp,1.1333333333333333,30,14,ATGGGGTCCAGATAGGAGCT,16,853908
dgoRp,1.4666666666666666,35,14,ATGCCCTCCAAATGGCCCAA,21,838427
dgoRp,0.3333333333333333,18,14,ATGCCCAACAACTGACGCAT,4,842296
dgoRp,1.7333333333333334,39,14,ATCTCAACGCTATCTTCTTC,25,859606
dgoRp,0.9333333333333333,27,14,ATCTAGGGTGATACGTCAAG,13,853568
dgoRp,0.13333333333333333,15,14,ATCCGTTAAACACAGCATAT,1,852273
dgoRp,1.0666666666666667,29,14,ATAGAGAAGCCATCTCTGTG,15,846769
dgoRp,2.7333333333333334,54,14,ATACATTTGATATTTCTCCT,40,859992
dgoRp,1.8,40,14,ATAAGAATTCTCCACCAGTC,26,846499
dgoRp,1.8,40,14,AGCTGTAGTTTCGCTGATAC,26,862480
dgoRp,0.3333333333333333,18,14,AGACACGACAGTCAGCCCAT,4,856305
dgoRp,1.3333333333333333,33,14,ACTGGCCCGTTCACTTTATG,19,854066
dgoRp,0.4,19,14,ACTCAAAGCTTGCGTCAGGT,5,842746
dgoRp,1.1333333333333333,30,14,ACGTTTGGAACTCACTATTG,16,837582
dgoRp,0.13333333333333333,15,14,ACGTGGGTGGAGATTACACA,1,848262
dgoRp,3.066666666666667,59,14,ACGTGAGCCCTGGCGCATTA,45,838258
dgoRp,1.0,28,14,ACCCACCGCAACAGTTGATA,14,839344
dgoRp,1.0,28,14,AAGGGGCTCTCCAGTCTGGT,14,838035
dgoRp,4.533333333333333,81,14,AACTCGCTCGTAAGTTCCTG,67,846745
dgoRp,0.6666666666666666,23,14,AACCCAACTGCCAAGGGATG,9,861675
dgoRp,0.8666666666666667,26,14,AAAAAATAGACGTAAGAAGC,12,858715
dgoRp,0.14285714285714285,14,13,TTTTAAATGCGACAATCTGT,1,855099
dgoRp,0.7857142857142857,23,13,TTCGTCATCTTACCTATGCA,10,837252
dgoRp,1.0,26,13,TTCATAGATACTCCCACATC,13,843087
dgoRp,1.4285714285714286,32,13,TTAATCTATCCATATACGGC,19,855912
dgoRp,2.0,40,13,TGTTGGCTGCGTCATTCGGA,27,850320
dgoRp,0.5,19,13,TGTGTCGCAATGGACTCCCT,6,837378
dgoRp,1.6428571428571428,35,13,TGTGGGAAGCAGGTGTAACA,22,856727
dgoRp,2.142857142857143,42,13,TGTAGCAACCTGACGTTCCA,29,855455
dgoRp,1.7142857142857142,36,13,TGGGATATCCGCGGTGGTGG,23,865479
dgoRp,0.14285714285714285,14,13,TGCTCGCGGGTGGCTTTGGA,1,843494
dgoRp,1.0714285714285714,27,13,TGAGCCCTAAAGTGGAAAGA,14,858115
dgoRp,0.7142857142857143,22,13,TGAAGCGACGCTAACTAACG,9,838429
dgoRp,0.5,19,13,TCGCCGTCCCTCCCGACGTA,6,848983
dgoRp,1.2142857142857142,29,13,TCCTCGCCCTCTGGGGCCAG,16,858526
dgoRp,3.0714285714285716,55,13,TCCGCCACCAGAGGTCTGTA,42,836752
dgoRp,0.42857142857142855,18,13,TCCAGCCACGAGGGTATACG,5,850242
dgoRp,4.357142857142857,73,13,TCCACAGCCGATCAGGCACT,60,863681
dgoRp,1.1428571428571428,28,13,TCACAGGCGTACCGTAGTAG,15,841785
dgoRp,0.14285714285714285,14,13,TCAAAATTCGCAAAACGAGT,1,836880
dgoRp,2.857142857142857,52,13,TATCACGATAAAAATTAGTA,39,836773
dgoRp,2.357142857142857,45,13,TAGGTCAGTTAAGGGAGGGT,32,847395
dgoRp,2.7857142857142856,51,13,TAGCCGTGTCAACGCATCCG,38,854011
dgoRp,0.5,19,13,TACCGGAAAGACGGTGATAG,6,848674
dgoRp,0.14285714285714285,14,13,TACATAGAATCGCTAACCCT,1,865977
dgoRp,1.5,33,13,TACAGGTATCTCCTTTGCGT,20,839358
dgoRp,0.9285714285714286,25,13,TAAGGGCTTGTGCTTGGCAG,12,841659
dgoRp,2.142857142857143,42,13,GTTGCGAGCCCCGGAATCAC,29,866856
dgoRp,1.2857142857142858,30,13,GTGAGAGTGCGCTAATGCGA,17,846508
dgoRp,0.7857142857142857,23,13,GTCCTCGTACTTATACCATC,10,852276
dgoRp,0.2857142857142857,16,13,GGTAGTGGCCACAGGGAACA,3,856567
dgoRp,0.6428571428571429,21,13,GGGAAACCATGCTCCGCCTA,8,864497
dgoRp,1.0714285714285714,27,13,GGCCATATCATAGAAGTGCT,14,857030
dgoRp,3.5714285714285716,62,13,GGCATCATATAGGTCAGAGG,49,846741
dgoRp,1.6428571428571428,35,13,GGCAGCGTAGCCAATATGTA,22,851744
dgoRp,0.5714285714285714,20,13,GGACAATAAACCCTACCCCC,7,856103
dgoRp,0.14285714285714285,14,13,GCTTTTAAAACACCTACGTT,1,861417
dgoRp,1.4285714285714286,32,13,GCTTTGAGTGTTTCCGTCGT,19,848933
dgoRp,0.14285714285714285,14,13,GCTTAGCTCATAGCCTCGGA,1,856982
dgoRp,17.5,257,13,GCTCTAACGCCGCGCAGATA,244,857742
dgoRp,0.42857142857142855,18,13,GCGTGCTATGGCTAGCGATG,5,860142
dgoRp,1.0,26,13,GCGGGGCAACAGTGGCTATA,13,866788
dgoRp,1.1428571428571428,28,13,GCCGTAGAGCTGCCAGATAT,15,853318
dgoRp,1.5,33,13,GAGATACCTCGGTTGGTCCA,20,846949
dgoRp,2.4285714285714284,46,13,GAGAGGCCTCCATGTTTTTT,33,865015
dgoRp,1.1428571428571428,28,13,GAGAAACATTATCCAGGGAA,15,856304
dgoRp,0.8571428571428571,24,13,GAATATGGTTAAATGTTCCA,11,846973
dgoRp,1.1428571428571428,28,13,GAAAGAATAATAGCCTAAGC,15,852330
dgoRp,0.14285714285714285,14,13,CTTGTACGTAATTGCGTCTG,1,847787
dgoRp,0.42857142857142855,18,13,CTTAATCACTGCACGTTAAT,5,862294
dgoRp,3.0714285714285716,55,13,CTGTTGGGATCCACTAGCAA,42,839588
dgoRp,0.5,19,13,CTGTGCGTCCGGCGGAACGT,6,866286
dgoRp,1.9285714285714286,39,13,CTCCCTGACGTGCAGAGTTC,26,866496
dgoRp,4.142857142857143,70,13,CTCCCGGAGTCGTTTGTCAC,57,846915
dgoRp,0.42857142857142855,18,13,CTACCGATCGCCTATAGAGT,5,845651
dgoRp,0.9285714285714286,25,13,CGTTATTCACATAAAAACGT,12,863203
dgoRp,1.6428571428571428,35,13,CGGTGGTAGACCGTGGCGAG,22,859173
dgoRp,0.14285714285714285,14,13,CGAAATTAGGATCAGCTAAC,1,843249
dgoRp,0.5,19,13,CCTCTCAGGTAGCACGGGGT,6,841158
dgoRp,1.0,26,13,CCTCGATAAGGTTGCATTGT,13,848305
dgoRp,2.0,40,13,CCGCGCTGAGTGACCCGTCT,27,857999
dgoRp,0.8571428571428571,24,13,CCGACGGCCCGAGCGTCATG,11,863672
dgoRp,0.7857142857142857,23,13,CCCGATACGCGATGCTTAAC,10,856574
dgoRp,0.2857142857142857,16,13,CCCCCGGGACTAAAGCCAAA,3,862198
dgoRp,0.14285714285714285,14,13,CCCACTGAAGGTTACCTCAA,1,848855
dgoRp,1.5,33,13,CCATGGCCTTTTGCATCTCT,20,857884
dgoRp,0.21428571428571427,15,13,CCAGCCGTTCCAAGCTCAGG,2,858670
dgoRp,0.7142857142857143,22,13,CATCTTGGACCGAACGAACC,9,848144
dgoRp,0.5714285714285714,20,13,CATCACATAGACCTGCTCCG,7,843164
dgoRp,1.2142857142857142,29,13,CACTAGCTAGCCATTCGTAA,16,842201
dgoRp,0.2857142857142857,16,13,CACCACGCAACCAGCAATGA,3,862591
dgoRp,1.7857142857142858,37,13,CAAGGCAGTTTAGGCAAAAG,24,865160
dgoRp,1.6428571428571428,35,13,ATTGGAGCTGTCACACTACA,22,839398
dgoRp,1.0714285714285714,27,13,ATTCGAGAACACGTTGAATT,14,851062
dgoRp,0.5714285714285714,20,13,ATTAGTTTCACGTATCCAAT,7,853591
dgoRp,0.14285714285714285,14,13,ATCTTTCGTAATGAGCTGCG,1,839937
dgoRp,1.6428571428571428,35,13,ATCCACACCGATCACGCGGT,22,863922
dgoRp,1.2142857142857142,29,13,ATACTTGGACGAAGCTGGCG,16,837909
dgoRp,0.6428571428571429,21,13,ATAAGGGAGAGGTTTTTTAT,8,846781
dgoRp,1.0714285714285714,27,13,ATAACAAGCATAGTCTTCTC,14,858994
dgoRp,1.0,26,13,AGGTGGAAGTGGAGCTCATC,13,866875
dgoRp,0.6428571428571429,21,13,AGCTCGACATACGACCATAA,8,843435
dgoRp,0.7857142857142857,23,13,AGCAAACAGGGAGACGGTTT,10,854950
dgoRp,1.3571428571428572,31,13,AGAGGTTTTTAACGGTGTAT,18,866697
dgoRp,2.642857142857143,49,13,AGAGATTACGGACAGACAAT,36,839367
dgoRp,1.2857142857142858,30,13,AGAAAAGCTGGTAACAGCCC,17,858953
dgoRp,1.8571428571428572,38,13,ACTCTCAGGCTGTTCACACC,25,841421
dgoRp,0.2857142857142857,16,13,ACGGTGCACCCGTTCTGAAC,3,865167
dgoRp,0.7857142857142857,23,13,ACATGCATACCGCAGTCCTA,10,861838
dgoRp,2.9285714285714284,53,13,ACATCACTGACACACGATTA,40,849413
dgoRp,0.7142857142857143,22,13,ACAGGCGATCAGGCTGGCCC,9,850984
dgoRp,4.857142857142857,80,13,ACACGTATCGTCAGCGTATG,67,862205
dgoRp,1.3571428571428572,31,13,AATACATTTGCTATCTATAT,18,838893
dgoRp,1.1428571428571428,28,13,AAGTTCTTCCCCCTCAAGTT,15,855931
dgoRp,1.5714285714285714,34,13,AAGTCACTGACTTGCCGGCG,21,859789
dgoRp,1.1428571428571428,28,13,AAGGTCTGATCTATTAAAGG,15,844639
dgoRp,1.0,26,13,AACGGTGCCAGCGACGCCGT,13,858088
dgoRp,0.14285714285714285,14,13,AAATATACAAGTTTAAGGCA,1,852298
dgoRp,0.9285714285714286,25,13,AAAAGCACATACTAGAGGCT,12,847692
dgoRp,0.7692307692307693,21,12,TTTTGATCATTAGATCAAGA,9,839891
dgoRp,0.5384615384615384,18,12,TTGCTTCAGTCTAAACAATG,6,857269
dgoRp,1.3076923076923077,28,12,TTGCGACACGAAGCGAGACT,16,858258
dgoRp,4.384615384615385,68,12,TTGCACTTGGTGAGGCAGTC,56,846216
dgoRp,0.3076923076923077,15,12,TTGCAAAAGAGAATCGACCA,3,861805
dgoRp,0.7692307692307693,21,12,TTCTGTGGGGTGCCTGGTTA,9,844494
dgoRp,0.9230769230769231,23,12,TTCGCTTATTGCCGCATTTG,11,849901
dgoRp,1.0769230769230769,25,12,TTAGTCGCCTCGCGTCCCAC,13,850573
dgoRp,0.7692307692307693,21,12,TTAGGCGGCGCTTTTAACAA,9,854865
dgoRp,1.1538461538461537,26,12,TTACGGAGACCCTACGTTTT,14,863815
dgoRp,2.076923076923077,38,12,TTAAGCTCCGACCAAATGCG,26,853307
dgoRp,1.6153846153846154,32,12,TGTAACCAATAAGGGTAATT,20,839269
dgoRp,0.46153846153846156,17,12,TGCGAGAGCACGAAGCTTTA,5,850715
dgoRp,3.076923076923077,51,12,TGAACTGCACTGGTACCTAT,39,838598
dgoRp,0.15384615384615385,13,12,TCTGCGCTATGCGCTTCCCT,1,846885
dgoRp,1.1538461538461537,26,12,TCTCACAGCGGTATCTCGTA,14,859143
dgoRp,0.38461538461538464,16,12,TCTATGGGACTTAGACAGTT,4,859756
dgoRp,4.538461538461538,70,12,TCGGGTATCGCCTTCCATCT,58,859469
dgoRp,0.7692307692307693,21,12,TCGAGCACGGTATGTCACCG,9,863686
dgoRp,1.6153846153846154,32,12,TCCTCTTCTACCCTCTCCAC,20,850661
dgoRp,2.230769230769231,40,12,TCCATTTGTGTGGGTCCAGT,28,862734
dgoRp,1.1538461538461537,26,12,TAGCCGAGACCGACAAATAT,14,848051
dgoRp,1.1538461538461537,26,12,TAGAATCGTATCGGATTGGG,14,847349
dgoRp,0.5384615384615384,18,12,TACCGCGGACTAGCACCTAA,6,840830
dgoRp,2.0,37,12,TAACGGGCATCCCGGCACAT,25,847618
dgoRp,0.7692307692307693,21,12,TAAAATAAGCGGATTAGCGC,9,864292
dgoRp,0.15384615384615385,13,12,GTTATCCGCTAAGCCCAAGA,1,864707
dgoRp,1.2307692307692308,27,12,GTGTCGAGAGTCCGAATGAG,15,843502
dgoRp,1.1538461538461537,26,12,GTGACAGAACATAAGATAAG,14,837656
dgoRp,1.6153846153846154,32,12,GTCGAGCTTAGAGTGACCTC,20,841803
dgoRp,2.923076923076923,49,12,GTCCTTACCGGCTCTGTACA,37,857778
dgoRp,1.4615384615384615,30,12,GTAGTGCCGATCTAGTCATC,18,863734
dgoRp,1.2307692307692308,27,12,GGTAGCTTTTGTGTTGAGAT,15,857556
dgoRp,1.1538461538461537,26,12,GGTACGTCCGCTGGGTCTTA,14,841418
dgoRp,0.6923076923076923,20,12,GGGGGGCATCCTTGATTCAA,8,862461
dgoRp,1.5384615384615385,31,12,GGGGGATGTAGATCCCTACA,19,866067
dgoRp,0.8461538461538461,22,12,GGCCATATCCCAATTTCCAA,10,856453
dgoRp,0.15384615384615385,13,12,GCTTTTTCCAAATTGGCTCA,1,848743
dgoRp,0.8461538461538461,22,12,GCTGGATGTGGATGTAAAAT,10,855112
dgoRp,0.8461538461538461,22,12,GCGCTGATCGAGGAAAGTGC,10,856705
dgoRp,2.230769230769231,40,12,GCGATTCGGTGAGCTGCGGT,28,838925
dgoRp,2.1538461538461537,39,12,GCGAGGGCTGAGCCACGCGG,27,838602
dgoRp,0.5384615384615384,18,12,GCGAAGGAACGCCGGTGTTC,6,850275
dgoRp,1.6923076923076923,33,12,GCATCCTTCAAGTTAAGAAC,21,859251
dgoRp,2.6153846153846154,45,12,GCAGTTAGGTACATTACAAA,33,838275
dgoRp,0.6153846153846154,19,12,GCAGTACGTATAGGTATGTA,7,840620
dgoRp,0.15384615384615385,13,12,GCAAGTCAGTGAGTTCCGCG,1,842687
dgoRp,1.6923076923076923,33,12,GCAAGCATCTACACTGGATG,21,861771
dgoRp,0.46153846153846156,17,12,GAGGCAAAAGAACTGGGCTA,5,854190
dgoRp,1.0,24,12,GACTAATGCGTTATAAGCTG,12,839240
dgoRp,1.7692307692307692,34,12,GACCCTAACGTAACCTACCA,22,841985
dgoRp,0.15384615384615385,13,12,GAACCTGACCTTATAAAGGC,1,858735
dgoRp,0.15384615384615385,13,12,CTTCCTCCAAGCTGACGCGA,1,865057
dgoRp,2.230769230769231,40,12,CTTAATACTCGGCAGCAGCA,28,865983
dgoRp,0.9230769230769231,23,12,CTTAACAAGATAACCCCCGT,11,860261
dgoRp,0.46153846153846156,17,12,CTGATGTTCCTTCGGCTCGC,5,851844
dgoRp,0.15384615384615385,13,12,CTATATATAATGGCTACGGG,1,847630
dgoRp,2.8461538461538463,48,12,CTACCGAATGCTTCCGGAGT,36,844501
dgoRp,0.8461538461538461,22,12,CGGGGCCGACGATGGCCGCT,10,847746
dgoRp,1.6923076923076923,33,12,CGGCTGTGTAATCACGCGTC,21,846824
dgoRp,0.6923076923076923,20,12,CGGCCCACACGGTTCGGCTC,8,852502
dgoRp,0.7692307692307693,21,12,CGGCACACCACGGGGTCCCC,9,865406
dgoRp,2.076923076923077,38,12,CGCGTGCTTGCGCACACCCG,26,857559
dgoRp,1.0769230769230769,25,12,CGCGGAGAGTCCGGGTCCTT,13,848365
dgoRp,1.0,24,12,CGAAATAATTCAGCTGGGAA,12,855145
dgoRp,2.0,37,12,CCTAGCAGAGAACTCAGCTT,25,848967
dgoRp,0.5384615384615384,18,12,CCGTGTGGTCCGGTCCCGGC,6,854164
dgoRp,0.46153846153846156,17,12,CCGTGGTCCAGACTGAATTT,5,865120
dgoRp,1.7692307692307692,34,12,CCGCAAGTTTATGAAACACG,22,853625
dgoRp,2.0,37,12,CCGAAAAACTTGTGTGCCCA,25,844520
dgoRp,0.3076923076923077,15,12,CCCAGTCATCATGTTCTCAC,3,859141
dgoRp,4.538461538461538,70,12,CCACGAATTTCCGGGAGGCT,58,843987
dgoRp,2.1538461538461537,39,12,CATATAAGAACATCGATCTT,27,864757
dgoRp,0.38461538461538464,16,12,CATAGTGGGCACTGATAAGA,4,857532
dgoRp,1.7692307692307692,34,12,CAGGTTAGACCCTAACAGGA,22,835891
dgoRp,7.538461538461538,109,12,CAGGTTACTTGCCCTGTGTT,97,848924
dgoRp,0.6923076923076923,20,12,CAGATAAGGCGCAACAAGTC,8,847896
dgoRp,0.6923076923076923,20,12,CAGAGACTTTGGCGAGTCTA,8,861871
dgoRp,7.923076923076923,114,12,CACATTGGCTTAGGGTGTTA,102,839357
dgoRp,2.6153846153846154,45,12,CAATGGCTGGCGTGGATGCA,33,866227
dgoRp,0.7692307692307693,21,12,CAAGGAAGGTACGCCCTTGA,9,844559
dgoRp,0.46153846153846156,17,12,ATTGAAAACCGCCTTAGGAA,5,837947
dgoRp,1.6923076923076923,33,12,ATGCCGGTTGAACCCGTATT,21,839368
dgoRp,1.4615384615384615,30,12,ATGCCACGTTACACCGGTTG,18,865231
dgoRp,0.9230769230769231,23,12,ATGAAACCTTGCTTTTCGTC,11,848899
dgoRp,2.3846153846153846,42,12,ATCAGGTCTGACCCCAGATG,30,841688
dgoRp,1.0769230769230769,25,12,ATATCATCGCTTCGCTATCT,13,854584
dgoRp,1.4615384615384615,30,12,ATACGGAGAGTCGAGAGGTC,18,846890
dgoRp,5.076923076923077,77,12,ATACCCGTTTTTGTCAGGTA,65,858612
dgoRp,1.6153846153846154,32,12,ATAATCAAACAATCTACACA,20,855104
dgoRp,1.7692307692307692,34,12,AGGGTCAATTATGGATGATT,22,846203
dgoRp,0.15384615384615385,13,12,AGCATCGGTGATCTCTTAGA,1,842084
dgoRp,0.23076923076923078,14,12,AGACCGTTTCACCCCCAGCC,2,867020
dgoRp,0.8461538461538461,22,12,ACTTTAGAATTGCCAAGGAG,10,863882
dgoRp,1.4615384615384615,30,12,ACTGTGGCTAAGGAACTAAA,18,851903
dgoRp,0.9230769230769231,23,12,ACTGTGCGACATGGTGTTGT,11,845437
dgoRp,0.7692307692307693,21,12,ACTAAACACTGGCAGACACC,9,837555
dgoRp,0.5384615384615384,18,12,ACGTTCGTTGCTGCATCGTA,6,864022
dgoRp,0.46153846153846156,17,12,ACGTCACGGTATCAGCTGGC,5,844747
dgoRp,1.3076923076923077,28,12,ACGGTCTAACGCTCTGCCCC,16,857019
dgoRp,0.5384615384615384,18,12,ACCTCAAGTCGTCTGGCCCA,6,845172
dgoRp,1.0,24,12,ACCGGTGGAGTAGGTATCCC,12,835886
dgoRp,1.3076923076923077,28,12,ACCACGCATCGACGGGAGCC,16,839009
dgoRp,0.23076923076923078,14,12,ACACTTGGCGGTTGTCTATT,2,847837
dgoRp,0.3076923076923077,15,12,ACAATCTAGCGTACCCGGGT,3,855423
dgoRp,0.7692307692307693,21,12,AAGGGTGGGCATAGCGCCCT,9,842617
dgoRp,1.3076923076923077,28,12,AAGGGTCCCATGTAGAATAC,16,840749
dgoRp,0.7692307692307693,21,12,AACGATGGCCCTCTCCCGAG,9,842245
dgoRp,0.8461538461538461,22,12,AAATTGGTTGAGTTGAGAAT,10,847306
dgoRp,1.0,24,12,AAAGGTTTATGGCGTCGGGG,12,861055
dgoRp,0.15384615384615385,13,12,AAACGCGTAGCCCCAGGTCG,1,865244
dgoRp,3.0833333333333335,47,11,TTTTCAATCCATCTTCTGTT,36,844502
dgoRp,0.16666666666666666,12,11,TTGTGGAGGCTCTCCCGCAT,1,855096
dgoRp,0.6666666666666666,18,11,TTGCGAGTTGGACGGAGGCA,7,865872
dgoRp,1.0,22,11,TTGATCCGGGCGATAGGGCT,11,847200
dgoRp,0.5833333333333334,17,11,TTCCGCCGTTTTGGTGGTCG,6,854300
dgoRp,2.6666666666666665,42,11,TTCAAAAAAGGGCTACATAC,31,859157
dgoRp,1.8333333333333333,32,11,TTATCACAATAGTGGTCGGT,21,854690
dgoRp,1.0833333333333333,23,11,TGGGACAGTAAACCTGAACG,12,842786
dgoRp,1.1666666666666667,24,11,TGCACAACCCTAGCGACCGT,13,848348
dgoRp,1.4166666666666667,27,11,TGACAGCAGCGGGGTCCTTT,16,855408
dgoRp,0.16666666666666666,12,11,TGACACTTCCGTGGTCCAAT,1,855520
dgoRp,1.6666666666666667,30,11,TGAACTTTCGCTTAAACTCA,19,861806
dgoRp,0.9166666666666666,21,11,TCTTATTGTTCACCGTCGTT,10,866621
dgoRp,0.9166666666666666,21,11,TCTCAGCTCCTATCTAAAGA,10,851955
dgoRp,0.75,19,11,TCGTTTAAACCTAGAGGGTG,8,841701
dgoRp,2.25,37,11,TCGTGGTCCGTAATCGAAAT,26,854618
dgoRp,1.5,28,11,TCGTGAGGGTCAGTGATAGA,17,857164
dgoRp,1.1666666666666667,24,11,TCGACATTCGTTTATTCCTT,13,864687
dgoRp,1.9166666666666667,33,11,TATTACTTACTAACTCTGTG,22,837416
dgoRp,0.16666666666666666,12,11,TAGGTTTCAGGAGGACCCAG,1,855009
dgoRp,17.416666666666668,219,11,TAGGTGGAAGCACTGGGAGG,208,840360
dgoRp,1.3333333333333333,26,11,TAGCCTCGAGGTCCCCAGTT,15,839218
dgoRp,3.5,52,11,TAGAATGAATGGTACGGTGT,41,866021
dgoRp,0.16666666666666666,12,11,TACGGAGGCGTCGAAACGGT,1,861829
dgoRp,1.9166666666666667,33,11,TAAGACATGGTACCGTGACC,22,854435
dgoRp,4.25,61,11,GTGGCGTCTTTGCCTATTAG,50,850208
dgoRp,0.4166666666666667,15,11,GTGGCCCAGCGCACACTGGA,4,846181
dgoRp,1.4166666666666667,27,11,GTGCTGCTCGTGCCAAGCCA,16,866551
dgoRp,0.9166666666666666,21,11,GTCTCCGATCAGTACGGCTA,10,860527
dgoRp,0.16666666666666666,12,11,GTCCTCTTCCTCCCAGTGGT,1,842877
dgoRp,0.9166666666666666,21,11,GTATTTACCTGCGGATGGAG,10,853326
dgoRp,0.75,19,11,GTATTACTTATGTAATTTAT,8,855406
dgoRp,1.8333333333333333,32,11,GTATATTTAGGCCTTTCTAG,21,863337
dgoRp,1.6666666666666667,30,11,GTAAAGCGGTCGGCAATGGA,19,863649
dgoRp,0.25,13,11,GTAAAATGGCAAAACCGTTT,2,865359
dgoRp,0.4166666666666667,15,11,GGTTCAACTTTGCGGTCGGT,4,859186
dgoRp,0.5833333333333334,17,11,GGTGCTGACGACAGGCTTCT,6,848448
dgoRp,1.75,31,11,GGTGCCGTGGAGACCCCGAT,20,852283
dgoRp,1.1666666666666667,24,11,GGTGAGCTTCCCACGAATTA,13,855163
dgoRp,1.25,25,11,GGTATATACACAGCGAACAT,14,836124
dgoRp,1.9166666666666667,33,11,GGGCGGAAAGCGTCGCCGGG,22,843607
dgoRp,1.75,31,11,GGGCGAACACGTTCTCTTCA,20,863297
dgoRp,0.9166666666666666,21,11,GGGCAGTAAGGATGGTATTT,10,857569
dgoRp,0.16666666666666666,12,11,GGCGTTCTTCGGGATGTATA,1,861143
dgoRp,0.3333333333333333,14,11,GGCGGGTCAGCGGTGATCGG,3,842375
dgoRp,1.9166666666666667,33,11,GGCGACCCCCTGAACTGTGT,22,839599
dgoRp,1.25,25,11,GGATGGCGCCCAAGGTGGTT,14,844270
dgoRp,0.9166666666666666,21,11,GGAGTGCAGATTCAGTAGTG,10,849109
dgoRp,0.3333333333333333,14,11,GGACGCCCGAACTTAGGCAG,3,847011
dgoRp,0.16666666666666666,12,11,GGAACCTTTGTGTGTCCGGA,1,840798
dgoRp,1.9166666666666667,33,11,GCTGACGTCAAACTTTTCGA,22,848938
dgoRp,1.75,31,11,GCGTCAATGGAGCCTCTGCA,20,858189
dgoRp,0.9166666666666666,21,11,GCGTAAGTGCCAATATGTAG,10,857564
dgoRp,0.75,19,11,GCCCTTTCATAACAATGCGT,8,857464
dgoRp,0.3333333333333333,14,11,GCATTAACCCGAGGGTCTAC,3,860520
dgoRp,0.16666666666666666,12,11,GATAGAGCTCTAATACTCGG,1,857832
dgoRp,1.0833333333333333,23,11,GATAAGGTTGGTTACCGGTC,12,839236
dgoRp,1.75,31,11,GAGGCGGTACCGTAACTTCG,20,847841
dgoRp,0.9166666666666666,21,11,GAGATATCGATCAAAGCGAC,10,854651
dgoRp,1.0,22,11,GACCTTCGGAAGATCGCCTA,11,852326
dgoRp,0.16666666666666666,12,11,GACAATTATACGAGCGCTGC,1,838212
dgoRp,0.4166666666666667,15,11,GAATTAAAACCGGAGTACAG,4,856925
dgoRp,1.1666666666666667,24,11,GAACCCTCTCCTGTTGAGAC,13,841227
dgoRp,4.25,61,11,GAAAAGGTCAACCTAGTGAG,50,848760
dgoRp,0.25,13,11,CTGTTTATCTGCACTACGAT,2,844518
dgoRp,3.4166666666666665,51,11,CTGGGCCGACGATCAACGTT,40,839746
dgoRp,0.4166666666666667,15,11,CTATTAGTATCGTAACTCTG,4,845236
dgoRp,2.5,40,11,CTAGACCGCCTGTTAACAAA,29,861601
dgoRp,1.5833333333333333,29,11,CTACGACTACGCATCCAAGA,18,852909
dgoRp,0.75,19,11,CGTTTGGATCATGGTACTGA,8,863995
dgoRp,1.4166666666666667,27,11,CGTTCACGGGAATCCTTGGA,16,860989
dgoRp,1.25,25,11,CGTGTCGCAACCCCTTGGCA,14,864856
dgoRp,0.6666666666666666,18,11,CGTGATGTTGCTCTTCTTTA,7,863497
dgoRp,1.0833333333333333,23,11,CGTCCTAGGTCCAGCACCTG,12,842529
dgoRp,2.3333333333333335,38,11,CGGTGAGGCTGGCTGTTCCA,27,846458
dgoRp,2.9166666666666665,45,11,CGGCTGTCTTTTCTGGGATG,34,841207
dgoRp,3.0,46,11,CGGCCGGCGCGAAAGCTACA,35,842620
dgoRp,5.0,70,11,CGGAACAGCCTCGCTTGTAC,59,843192
dgoRp,1.0,22,11,CGCGTCTGTGGTGGGCTATG,11,867076
dgoRp,0.9166666666666666,21,11,CGCAGTTACCCTTGTGCGAT,10,853655
dgoRp,1.0833333333333333,23,11,CGCACGGGACCACGGTCGCT,12,835962
dgoRp,1.1666666666666667,24,11,CGCAAATCCTACAGTGGCTT,13,850687
dgoRp,1.5,28,11,CCTGCGAAGGAGTCCAAGAC,17,846880
dgoRp,1.3333333333333333,26,11,CCTAGCAGTAATGTACTGTA,15,842335
dgoRp,0.6666666666666666,18,11,CCTAAACCGTATCTCGCGGA,7,864111
dgoRp,2.3333333333333335,38,11,CCGTAACCGAATTAGCACCT,27,862020
dgoRp,0.25,13,11,CCCCAACCCAGAGCTTCGGA,2,849748
dgoRp,0.16666666666666666,12,11,CCATTCTGACGGTGCCGCAT,1,839037
dgoRp,6.416666666666667,87,11,CCAGATCGCAGACAGGTCCG,76,848818
dgoRp,0.3333333333333333,14,11,CATCCAAGAAGGTTTATCGA,3,835996
dgoRp,0.16666666666666666,12,11,CACGGCTAACTATAGATACT,1,847070
dgoRp,1.5833333333333333,29,11,CACCTTAACCCATTCTCGGT,18,839154
dgoRp,4.666666666666667,66,11,ATTTGCGAGACATTAATCGC,55,865734
dgoRp,0.8333333333333334,20,11,ATTTCCAGGGGAGTGGGTCC,9,846279
dgoRp,0.8333333333333334,20,11,ATGGGATAGCTGAACTCTAA,9,863795
dgoRp,3.0833333333333335,47,11,ATCCGCTTGCCGGCGTTAAA,36,843313
dgoRp,1.9166666666666667,33,11,ATAGAAACTGGATCTTGACT,22,837179
dgoRp,1.0,22,11,AGTTTGGCGTGATTCCTTCT,11,837926
dgoRp,1.25,25,11,AGTTAGCGCTTCCTCTAGTT,14,856443
dgoRp,1.4166666666666667,27,11,AGTCGTCTCGTATTTAGTTG,16,865907
dgoRp,1.0,22,11,AGTAACCATGTCGCATCCCG,11,857190
dgoRp,1.0833333333333333,23,11,AGGTAAATGGTTCTATAATG,12,836225
dgoRp,2.0833333333333335,35,11,AGGCTACCGCTCAGGGTTAC,24,846373
dgoRp,1.25,25,11,AGCTCACCCAGGCTGCGGAG,14,837688
dgoRp,1.0833333333333333,23,11,AGAAGCCTTGAGCCTACTAC,12,839688
dgoRp,1.1666666666666667,24,11,AGAACATCAAAGTGTGTCAG,13,862304
dgoRp,1.25,25,11,ACTGTGTCAAAATACTTTGT,14,838703
dgoRp,1.25,25,11,ACTCTCCACGATGAGGCTTG,14,860089
dgoRp,3.4166666666666665,51,11,ACTATGGTTCGCGGGGTCAC,40,858097
dgoRp,0.9166666666666666,21,11,ACCCGTCTCGTTGCAGCCTT,10,858467
dgoRp,0.9166666666666666,21,11,ACCCGACGCAAGTATCCGGC,10,863382
dgoRp,4.916666666666667,69,11,ACAGGCCTTCGTGAACGCAG,58,843301
dgoRp,1.9166666666666667,33,11,ACACGATCATTTCAGGTCTA,22,844926
dgoRp,0.25,13,11,AAGGAATTCAACTGTGCTGC,2,864550
dgoRp,1.1666666666666667,24,11,AACGAGGGCACGGGGCACGC,13,851714
dgoRp,5.25,73,11,AACCCCGCTCGCAGCTAAGA,62,843223
dgoRp,1.8333333333333333,32,11,AAACGTGTAGGCGGAAACAT,21,849599
dgoRp,0.3333333333333333,14,11,AAAATAAATTTCTGCGCAAA,3,837083
dgoRp,2.4545454545454546,36,10,TTTTGCCCGGCAGGGTTTGT,26,837483
dgoRp,1.6363636363636365,27,10,TTTGTATCACACGAATGACT,17,855629
dgoRp,2.3636363636363638,35,10,TTGTCCTTCACGGAGCCGAG,25,852434
dgoRp,5.363636363636363,68,10,TTGCTTGGGTTGATATCTAC,58,845520
dgoRp,1.9090909090909092,30,10,TTGCGGCTACCAAGTATGAC,20,854434
dgoRp,1.8181818181818181,29,10,TTCGTATCTTAGTTTTACAG,19,852584
dgoRp,4.7272727272727275,61,10,TTCGTACACTTACCGTCAGT,51,854854
dgoRp,3.4545454545454546,47,10,TTCGATTATGAACGTATCCC,37,843858
dgoRp,1.6363636363636365,27,10,TTCACGTGTATCCGCCACGG,17,846805
dgoRp,0.6363636363636364,16,10,TTCACCCTTGAGGTCGGGAT,6,843406
dgoRp,3.4545454545454546,47,10,TTATGGTGTCGTACTTTGGC,37,853154
dgoRp,1.0,20,10,TTACTTAGCCTATAAAAAAA,10,850441
dgoRp,2.090909090909091,32,10,TTACGGGTGAGCAAAAGCTT,22,859981
dgoRp,1.3636363636363635,24,10,TGTTGTATTCGGGACGCAGG,14,841456
dgoRp,1.9090909090909092,30,10,TGTGGATTCAGTTATCCAGC,20,839504
dgoRp,3.8181818181818183,51,10,TGTATACCCGGGAAGACATG,41,859167
dgoRp,4.090909090909091,54,10,TGTACGGCTATGAAACCGTA,44,847688
dgoRp,1.8181818181818181,29,10,TGGGCGGCATTAACTATAGT,19,841556
dgoRp,2.0,31,10,TGCCTCCCCCCTGGGGCACT,21,847713
dgoRp,1.5454545454545454,26,10,TGCATTCAATAAGGGCGGCA,16,857465
dgoRp,2.1818181818181817,33,10,TGATTCCTTGAGAGAGTATT,23,856361
dgoRp,0.36363636363636365,13,10,TGAGGAAGACTGAACAAATA,3,862746
dgoRp,1.4545454545454546,25,10,TGAACAGTTGGATTGCCCTC,15,843635
dgoRp,0.8181818181818182,18,10,TCTCTATGTTGGTCTGAGAA,8,850350
dgoRp,1.6363636363636365,27,10,TCGTGGGGTACAGCATCAAT,17,866966
dgoRp,1.1818181818181819,22,10,TCGTCCCGGGGGCACAGGGC,12,858782
dgoRp,1.1818181818181819,22,10,TCCTTTACGTCTGTACTGTG,12,842497
dgoRp,2.6363636363636362,38,10,TCCTTCCTGCTTGTTGGTAA,28,860040
dgoRp,0.6363636363636364,16,10,TCCCTGGTTCGGTTGGGTCG,6,842483
dgoRp,2.727272727272727,39,10,TCAGTTGTGGTTTCCCACAC,29,839124
dgoRp,2.1818181818181817,33,10,TCAGGGCGTATTGGGTAATG,23,836140
dgoRp,0.45454545454545453,14,10,TCACTTGCAATCCTGCCGCA,4,840822
dgoRp,1.5454545454545454,26,10,TCAATATCCTAGTTATGCTT,16,856150
dgoRp,1.2727272727272727,23,10,TATGTGGGTCCTCATCCGCG,13,845823
dgoRp,1.9090909090909092,30,10,TATGCATTTGGTCTGGGACC,20,863587
dgoRp,2.1818181818181817,33,10,TATAGGATGAGTCTAAAGGA,23,842883
dgoRp,3.3636363636363638,46,10,TAGCGTTGTTACGCCAGTAA,36,842364
dgoRp,1.1818181818181819,22,10,TAAGTGGCCGGTATTTTCGG,12,838492
dgoRp,4.363636363636363,57,10,TAACAGGCCTGTCTAATGAG,47,854088
dgoRp,0.5454545454545454,15,10,GTTTTCGAAGCGGCGTCCGA,5,841657
dgoRp,1.0909090909090908,21,10,GTTCTTGGTGTGACCTCTTA,11,844519
dgoRp,1.3636363636363635,24,10,GTGTTGCGCCTACACCATTT,14,862914
dgoRp,2.3636363636363638,35,10,GTGCCGAAAGTATAATTCTA,25,866109
dgoRp,0.7272727272727273,17,10,GTGCAAGTTACATGCGACAA,7,853001
dgoRp,0.9090909090909091,19,10,GTCAATCGAGCAGCAGATTT,9,859512
dgoRp,0.6363636363636364,16,10,GTACACAATATACGATTTTG,6,849517
dgoRp,2.1818181818181817,33,10,GTAAATTAGCAACAGAGCCA,23,853117
dgoRp,1.5454545454545454,26,10,GGTCTGCAGGCCGTCACTAT,16,847137
dgoRp,1.1818181818181819,22,10,GGGGATGGACCTACCGTGAG,12,840134
dgoRp,3.0,42,10,GGCCATTTTAGCATCATCCT,32,851615
dgoRp,0.18181818181818182,11,10,GGAAACACTGAGAGGTTTCA,1,837625
dgoRp,0.45454545454545453,14,10,GCTCCCAAAAAGGCGAGCAG,4,866430
dgoRp,1.1818181818181819,22,10,GCTACAAGTGCGCGTTTGTC,12,836307
dgoRp,1.5454545454545454,26,10,GCGACGAGAGATCGAGGGCA,16,858708
dgoRp,1.0909090909090908,21,10,GCCAGTATCGACCATACGTA,11,851708
dgoRp,1.0909090909090908,21,10,GCCAGATCGCGTTGACATTC,11,853630
dgoRp,0.5454545454545454,15,10,GCAGTCCTATCCGGAAGTCT,5,859091
dgoRp,1.5454545454545454,26,10,GCAGTAGTGTGACCACTGTA,16,855791
dgoRp,1.4545454545454546,25,10,GCACCTATTCGTACGATGTT,15,846868
dgoRp,5.818181818181818,73,10,GCACAAGAAGATCGTCGGTA,63,838958
dgoRp,1.9090909090909092,30,10,GCAATAAGCCGTTCGAACGG,20,849503
dgoRp,4.7272727272727275,61,10,GATTTATCTTATGGCGGACT,51,843453
dgoRp,0.18181818181818182,11,10,GATCAAGGTGAGCCGGCTTT,1,857537
dgoRp,0.36363636363636365,13,10,GATATAGAAAACCGTTGATG,3,860362
dgoRp,2.909090909090909,41,10,GAGTCACTCAAGCATGGGAG,31,864617
dgoRp,0.18181818181818182,11,10,GACTGTCCCGTGAGCCGTGT,1,837355
dgoRp,1.3636363636363635,24,10,GACTCTGGGGGTATACTTTC,14,840246
dgoRp,1.9090909090909092,30,10,GAATCTGATCAGACATCATC,20,837616
dgoRp,0.6363636363636364,16,10,GAACTCCCTGACATCCGGGG,6,857304
dgoRp,0.18181818181818182,11,10,CTTTGGGTGTAGCGTAATAA,1,853025
dgoRp,2.909090909090909,41,10,CTGTAGTTCAATTTGGCGTA,31,843317
dgoRp,0.6363636363636364,16,10,CTGATTGCACTCGATAAGTC,6,839146
dgoRp,3.1818181818181817,44,10,CTGACGTAAGCTGGATCATT,34,856445
dgoRp,0.6363636363636364,16,10,CTGAAACAGTCTAGGCGTGT,6,863634
dgoRp,1.0909090909090908,21,10,CTCTGGAGAGGGGCTCCATT,11,866758
dgoRp,0.7272727272727273,17,10,CTACGTCCATTCAGATCTTG,7,849636
dgoRp,0.7272727272727273,17,10,CTACAGCGATTACTAACGGC,7,852372
dgoRp,1.4545454545454546,25,10,CTACACTACGGCGTTTATAA,15,845013
dgoRp,1.4545454545454546,25,10,CGTATTAACATACTTGCAGA,15,845677
dgoRp,1.2727272727272727,23,10,CGTAGTACTCCATATTGTAG,13,839134
dgoRp,0.18181818181818182,11,10,CGGTGAGCAGACCGCTTGCG,1,837818
dgoRp,2.4545454545454546,36,10,CGGGCATCTAAAGAACTGAA,26,858275
dgoRp,0.18181818181818182,11,10,CGGACTCGTAGTACGAATCT,1,865032
dgoRp,0.18181818181818182,11,10,CGGAAGGCTTCGATTCTTTG,1,856972
dgoRp,0.45454545454545453,14,10,CGCGCGAAAGAGGGTGTTTA,4,853693
dgoRp,1.6363636363636365,27,10,CGCGAGTCGCTTGCCCCCAT,17,851016
dgoRp,0.18181818181818182,11,10,CCTATTGCGTCGTCTCAGGT,1,853963
dgoRp,0.6363636363636364,16,10,CCCATGTGGTCAGTTGGTGT,6,860644
dgoRp,1.8181818181818181,29,10,CCAATAAGGTAAAGGTTTCA,19,846054
dgoRp,0.8181818181818182,18,10,CATTACGTGTTAATGAGCAG,8,852259
dgoRp,1.1818181818181819,22,10,CATGTGTCTAACATCAAGGG,12,856116
dgoRp,1.8181818181818181,29,10,CAGTAGTACCAGCGATGCGG,19,843589
dgoRp,1.9090909090909092,30,10,CAGGGGTATCACCCTGAGGG,20,849504
dgoRp,0.18181818181818182,11,10,CAGCTTTGTAGTCCGATACT,1,847181
dgoRp,0.18181818181818182,11,10,CAGCCACAACGTCGGGTAAA,1,846945
dgoRp,1.3636363636363635,24,10,CAGCAAGCACAGAGGAGGTG,14,839012
dgoRp,1.3636363636363635,24,10,CACGCGGAGCATGGGATAAA,14,852395
dgoRp,0.7272727272727273,17,10,CACACCCGGATAGTTACTCT,7,848901
dgoRp,1.0909090909090908,21,10,CAATGTCTAATGGGGCGGCC,11,860529
dgoRp,0.9090909090909091,19,10,CAACATGGTGTGAGAGCCCT,9,863116
dgoRp,0.7272727272727273,17,10,ATTTTTGGACTATACCAGCG,7,842629
dgoRp,2.0,31,10,ATTTGGGTACATGGATGACA,21,846280
dgoRp,1.5454545454545454,26,10,ATTCCTGGCTTATTCGCCTG,16,854275
dgoRp,1.7272727272727273,28,10,ATGTATTCCTAACCTCATAG,18,848135
dgoRp,1.2727272727272727,23,10,ATGCGATGTGATCCCAATTT,13,854395
dgoRp,1.2727272727272727,23,10,ATCTCGTGCAGGCCCTCATT,13,837370
dgoRp,2.0,31,10,ATATGCCCGACAAATGACGA,21,855504
dgoRp,1.6363636363636365,27,10,ATATCGCTTATGTTTCAACT,17,852958
dgoRp,1.5454545454545454,26,10,AGTTTATTTAAGTTCGAACG,16,848991
dgoRp,2.3636363636363638,35,10,AGTTCCTTTCCTAGCGATCT,25,867278
dgoRp,0.8181818181818182,18,10,AGTTATTTGCAGACTAACGG,8,859661
dgoRp,0.8181818181818182,18,10,AGTGCGGAAGCTGTCTAAGT,8,846456
dgoRp,1.9090909090909092,30,10,AGTGCGCCGAGAATACCTAA,20,841664
dgoRp,1.9090909090909092,30,10,AGGGATCCGATAAAGGCAAA,20,836462
dgoRp,2.0,31,10,AGGGAAAAGAGTCGGTTCTG,21,857624
dgoRp,0.36363636363636365,13,10,AGCGCACGGGACCTATTAGT,3,841067
dgoRp,1.7272727272727273,28,10,AGCCCGGCCAAAGCGATGCA,18,854225
dgoRp,0.7272727272727273,17,10,AGCAACTTCCGTTTCCGGTG,7,853989
dgoRp,0.45454545454545453,14,10,AGAGACTCGCTATTCGGTAC,4,845091
dgoRp,1.6363636363636365,27,10,AGAGACAGCAACTCACCCGC,17,838707
dgoRp,0.8181818181818182,18,10,ACGTTGTAGAGTAGGGCATT,8,863226
dgoRp,2.727272727272727,39,10,ACGGGGGTCCAAACATACGG,29,851851
dgoRp,0.45454545454545453,14,10,ACGCAGCAGTGTGCGCGGCC,4,855198
dgoRp,0.7272727272727273,17,10,ACGACATTTAAAGCTCAATA,7,837745
dgoRp,1.0,20,10,ACCCATATCTGGCGAACGAT,10,865574
dgoRp,0.45454545454545453,14,10,ACCAGAGTGGCCATCCGAAT,4,861715
dgoRp,3.272727272727273,45,10,ACACGGGCTCCCAGAGGTAG,35,845524
dgoRp,0.8181818181818182,18,10,AATGGTGCTTCAATATTTTT,8,851090
dgoRp,1.5454545454545454,26,10,AAGGTTTCATAATGATTTAT,16,842331
dgoRp,1.6363636363636365,27,10,AAGGTAGCGTAAAAGGGGGT,17,860704
dgoRp,0.6363636363636364,16,10,AAGGGCCTAATATCGCCGTA,6,866056
dgoRp,1.4545454545454546,25,10,AAGCGCACTTACGGGATGCT,15,866406
dgoRp,1.5454545454545454,26,10,AAGATTGAATACACACTTTC,16,836002
dgoRp,0.7272727272727273,17,10,AACTTCTGGTGGCGGGTCAA,7,861565
dgoRp,0.18181818181818182,11,10,AACTTCTAAGGCCAGAGCCT,1,851339
dgoRp,1.3636363636363635,24,10,AACAACCCGACCATCGATCT,14,844749
dgoRp,0.45454545454545453,14,10,AAATTTCGATCGTGATTGAA,4,853688
dgoRp,1.3,21,9,TTGGGTCTAGCCGACGCGAT,12,849779
dgoRp,1.2,20,9,TTGGCGCCATGACTCCTCTT,11,863827
dgoRp,1.2,20,9,TTCTCCGGGCCTCCTTTTTG,11,854875
dgoRp,1.9,27,9,TTCCCACAGTACGAGAGAAG,18,839919
dgoRp,1.8,26,9,TTAGAGCTGTCTCCTGTGGT,17,836273
dgoRp,0.2,10,9,TGTCAATTCCACTATGTGTG,1,856243
dgoRp,1.4,22,9,TGGTTGTATAGGAGACGTCG,13,866870
dgoRp,0.9,17,9,TGGCGCCGCAAAAGGTAAAC,8,843903
dgoRp,0.9,17,9,TGGCCTAACTTCTCGATTTT,8,861868
dgoRp,0.3,11,9,TGCAGCCAGTTTAGGGTTAA,2,836088
dgoRp,1.4,22,9,TGATGGGTTGTGTGGGGCTC,13,842098
dgoRp,0.6,14,9,TGATCGAGAGGCGGGTATGC,5,860871
dgoRp,1.0,18,9,TCTCCGCCGGCCCTAACCAT,9,841984
dgoRp,1.6,24,9,TCGTATTTAACCCTAGTAAA,15,848209
dgoRp,2.0,28,9,TCGTATAATCGAACAAGTCC,19,847559
dgoRp,1.2,20,9,TCGCAGCGCTTCTGGCACTG,11,853196
dgoRp,2.4,32,9,TCCTAGGTGTGGTGATAACG,23,845647
dgoRp,3.4,42,9,TCCGTAGGTAGAACCGATTC,33,851962
dgoRp,2.4,32,9,TCCCATCATCCGTGCGGGAG,23,857539
dgoRp,1.5,23,9,TCCACATAGAATCTCGACGC,14,851462
dgoRp,2.8,36,9,TCATTTACAGGAAGACAAGG,27,845617
dgoRp,1.9,27,9,TCATTCTTGGAATTATCGCT,18,836750
dgoRp,2.4,32,9,TCATGGGGAAGCTCGGCAGT,23,843244
dgoRp,1.3,21,9,TATTGTAGACTTAGGCACAT,12,861457
dgoRp,2.0,28,9,TATTACGGGAAAAAAAGTTT,19,857367
dgoRp,1.6,24,9,TATGGCCGCCGTACCGAAGA,15,840304
dgoRp,0.2,10,9,TATCATACCCACAGGCCCTG,1,842276
dgoRp,2.6,34,9,TATAAGGTGATGGTACAATT,25,864710
dgoRp,0.9,17,9,TAGAGCTAGCATTAGTACTA,8,860953
dgoRp,2.0,28,9,TACTGCGCAAATTAGCGTTA,19,841354
dgoRp,0.2,10,9,TACCGGACCATCAGTTCATC,1,854610
dgoRp,1.3,21,9,TACCATTCACATCTGTCGCA,12,836034
dgoRp,3.0,38,9,TACAACATAAATGCGTCCTC,29,854507
dgoRp,0.9,17,9,TAAGTCCGCGTCGCACAGGC,8,865147
dgoRp,3.1,39,9,TAAGTATGACCGCCACAAAG,30,845270
dgoRp,2.0,28,9,TAAAGTAGACTTCCTTACAT,19,859076
dgoRp,0.2,10,9,GTTTCATTGCTCATGTAAAA,1,844156
dgoRp,1.5,23,9,GTTACCGCTATCTACATAGA,14,839165
dgoRp,0.9,17,9,GTGGTCCCACAACCGCAGGT,8,851702
dgoRp,4.2,50,9,GTCCTTTAAGCACAAATACA,41,853049
dgoRp,0.2,10,9,GTCCGATGATTCGCAATTAA,1,838000
dgoRp,2.2,30,9,GTATAATGCTTTAGCCGATC,21,849913
dgoRp,2.4,32,9,GTAGTCAGTTACCTCCGCTC,23,851101
dgoRp,1.6,24,9,GTACAGGTCCCGAGGCGTCA,15,857505
dgoRp,0.2,10,9,GGTTGGGCCGAGTTTTTAGG,1,850577
dgoRp,2.9,37,9,GGTAACAATAGTTCTGCACC,28,839394
dgoRp,1.5,23,9,GGGTCATTCTCGGAAATCGA,14,847994
dgoRp,3.6,44,9,GGGGTTCTCATAGCATGAAC,35,858454
dgoRp,0.2,10,9,GGGCCAATCATAGTTTGGAC,1,842156
dgoRp,0.6,14,9,GGCTTGCCAGGCAGTTACTT,5,859874
dgoRp,2.0,28,9,GGCCTTCCCGTAGATTATAA,19,864325
dgoRp,1.7,25,9,GGCAGTGTAGTACAAAGTCT,16,857120
dgoRp,2.5,33,9,GGACAACAAAGCGGTTATAA,24,864100
dgoRp,1.4,22,9,GCTTGTCATAAGTCTGTCAA,13,849129
dgoRp,0.6,14,9,GCGTCCCTTTGCCGTTTCTA,5,858508
dgoRp,0.2,10,9,GCGGGCGGTGGCTATCTGAC,1,863549
dgoRp,1.5,23,9,GCGCGCTCAATTGTTTGACT,14,847708
dgoRp,7.7,85,9,GCCCCCCTTATGCCCCACGC,76,844198
dgoRp,1.4,22,9,GCACCTTTTCAAAAGCTTGA,13,854589
dgoRp,2.0,28,9,GATTCTAGGTTCTGCCCCTG,19,864410
dgoRp,1.4,22,9,GATTACAGACGGTATGTGCA,13,836219
dgoRp,1.8,26,9,GATGCTTCTCATCCTACCGA,17,847518
dgoRp,6.5,73,9,GAGATAGCATCATCCTATGC,64,846968
dgoRp,1.1,19,9,GAGACTCCATGTATATAGGC,10,855132
dgoRp,4.4,52,9,GACTTCGCTAGTGAAGCTCT,43,847838
dgoRp,1.8,26,9,GACGGATATAAATTCGATCG,17,852003
dgoRp,0.8,16,9,GAAGTTCCACTCCGTGGGTA,7,858544
dgoRp,1.7,25,9,CTTATTGCTCAGTCGGTGTA,16,859975
dgoRp,1.0,18,9,CTTAGGTAAAAGCGTCCTTC,9,856724
dgoRp,1.3,21,9,CTGTGACGGGACCGCGCAGA,12,844194
dgoRp,0.2,10,9,CTGCCGATCGAGAGGTATCA,1,858190
dgoRp,2.2,30,9,CTCTCATGGTAGCGTTCAGT,21,855472
dgoRp,5.2,60,9,CTCCTACGATCCTAAGACTA,51,865673
dgoRp,1.6,24,9,CTATAGTCCGAGAAACTCGA,15,854025
dgoRp,1.9,27,9,CTACCTAAATAACGTTCTGA,18,852375
dgoRp,1.7,25,9,CTACAGGATCGGGCTTATTC,16,854329
dgoRp,3.8,46,9,CTAATCCACTTTTATATGAG,37,850075
dgoRp,1.8,26,9,CGTGGGTAGACCGGGTTAGG,17,849267
dgoRp,0.7,15,9,CGTGATCCCTCTTGGGTGTA,6,836050
dgoRp,2.8,36,9,CGTCGTAGTGACGGCTAAGC,27,860607
dgoRp,1.3,21,9,CGTCCGTGAGCCGTGACAAC,12,837439
dgoRp,1.0,18,9,CGTAGAAAGGAAAGATAATT,9,861535
dgoRp,0.2,10,9,CGGTCCGAAATGTGAGCACT,1,851206
dgoRp,2.2,30,9,CGGCGTTTGCACGGGCAGTG,21,865580
dgoRp,2.4,32,9,CGGATTTTACGTACGAAGTT,23,860402
dgoRp,2.2,30,9,CGCCCCCGGGAGCGTTAGCC,21,837475
dgoRp,1.4,22,9,CGCAGACTGCAAAATTCGCG,13,850438
dgoRp,2.5,33,9,CGATTCCCCTGTACACGATT,24,863781
dgoRp,1.3,21,9,CGATGTTCTAGGCATCGAAC,12,856247
dgoRp,1.1,19,9,CGACGTTATAATTTCTGCAT,10,862993
dgoRp,1.7,25,9,CCTTTGCAATATGCATGCAA,16,843535
dgoRp,3.5,43,9,CCGTGAAGGCACTCGCCCAC,34,865427
dgoRp,1.5,23,9,CCGGTAATGGACGTATCTAT,14,862024
dgoRp,6.4,72,9,CCGGGGCACCCGGATTGGTA,63,843218
dgoRp,4.2,50,9,CCGGCGCGTAGGAGACCAGA,41,838360
dgoRp,0.2,10,9,CCGGATCATAGAGTTTAAGT,1,842467
dgoRp,2.2,30,9,CCGGACATGAGACAGAGGAT,21,844414
dgoRp,1.7,25,9,CCGCCATCGTGGTTGCTCAC,16,853160
dgoRp,0.5,13,9,CCGAGGGCTCCCATCTCTAC,4,851717
dgoRp,1.3,21,9,CCCGTTTTTCACCTACGTAC,12,849743
dgoRp,4.6,54,9,CCCGCTGGTCTTTAGGCACA,45,850120
dgoRp,1.0,18,9,CCCCGCTAGGTAGGGTGCTA,9,851354
dgoRp,2.8,36,9,CCCCAGACCATACTCGATGT,27,855732
dgoRp,1.3,21,9,CCCAGGAATTAACCTCGCCT,12,858495
dgoRp,4.8,56,9,CCATCGGCATGGAAACTCGT,47,860755
dgoRp,0.5,13,9,CCAGATGCTTGTTATCCTGG,4,846775
dgoRp,2.4,32,9,CCACGTGGCCAACGTGATGC,23,864332
dgoRp,2.6,34,9,CATGTAAACAGAAGGCATCT,25,855067
dgoRp,2.0,28,9,CATGGTAATTGACGGAAGAG,19,863514
dgoRp,1.3,21,9,CATGATATAAAGCAAAGCAA,12,854929
dgoRp,1.1,19,9,CAGTGTACAGGAACCCGAAT,10,858684
dgoRp,2.1,29,9,CAGTGCTCTCGGGTTCGGAT,20,842709
dgoRp,6.3,71,9,CAGTCGAGGTCCGGCCGGGA,62,862575
dgoRp,2.2,30,9,CAGTAGGCTCAGAGCTCGCG,21,846903
dgoRp,2.4,32,9,CAGGACCCAACTTGTCCCGC,23,836595
dgoRp,0.5,13,9,CAGCTCAACGAGAGGGGTGA,4,853621
dgoRp,1.4,22,9,CACGGAAACACCAGCCAATC,13,851262
dgoRp,1.1,19,9,CACGACTGGACTTAATTCAA,10,837264
dgoRp,1.4,22,9,CACGAATACTCAGCGTGCAG,13,858049
dgoRp,2.4,32,9,CAAGGTCCTAGTGCAGATTG,23,838553
dgoRp,3.3,41,9,CAACACTTCGGCTGACAAGA,32,846706
dgoRp,2.3,31,9,CAAAAGGTCTTGGGATGTAT,22,845705
dgoRp,1.2,20,9,CAAAAACCGTAAAGTTACTG,11,840055
dgoRp,2.4,32,9,ATTGTCTATAAACCAACCCA,23,845671
dgoRp,2.2,30,9,ATTGGTAGTGGCTAGTTATT,21,864991
dgoRp,5.7,65,9,ATGCTCCACAGTAACTGATC,56,847720
dgoRp,1.8,26,9,ATGCCCGCGATCCTTCCCGG,17,866945
dgoRp,2.6,34,9,ATCTACAATTGGGGGGTTAA,25,858793
dgoRp,1.4,22,9,ATCCCCCTCGGTACCAGAGT,13,862826
dgoRp,1.3,21,9,ATATGGATTATGACGCATTT,12,859947
dgoRp,0.8,16,9,ATACCTCCGGGGTTACTGCT,7,850509
dgoRp,2.3,31,9,ATAAGTATGGGTGAATACAT,22,841620
dgoRp,0.7,15,9,AGTGCTTCCTGGACGGCGGC,6,845436
dgoRp,2.6,34,9,AGTCCCGAGGGCTTTCTGGC,25,852580
dgoRp,1.3,21,9,AGTCAGGCTTGTTGCATTAC,12,839140
dgoRp,14.2,150,9,AGTATGGGTCAGGTGCATGT,141,840357
dgoRp,2.6,34,9,AGCGTCCCACACACTGAGTA,25,848847
dgoRp,0.2,10,9,AGCGCTATCCATCCTTCCGT,1,866606
dgoRp,0.4,12,9,AGCAATTTGGAGTTTGAGGG,3,862250
dgoRp,0.2,10,9,AGATAGGAAAGGCCCAGATA,1,866328
dgoRp,4.4,52,9,ACTTGCTGCATCGGAATAAG,43,861046
dgoRp,0.9,17,9,ACTCGCCGGTCCGGTGGATG,8,840104
dgoRp,0.2,10,9,ACGTAACTTTGGCACGTTTT,1,841310
dgoRp,0.2,10,9,ACCCTCTAGGGCAGCGAGGT,1,856226
dgoRp,1.9,27,9,ACCACGCGCCAAAAGTTTCA,18,853029
dgoRp,2.9,37,9,ACCACCGTCAGTCTTGGGGG,28,865845
dgoRp,4.3,51,9,ACATTTGCGCATTTTAGTAT,42,845793
dgoRp,2.3,31,9,ACATAAGTGGAGCCGTCAGC,22,863005
dgoRp,0.2,10,9,ACAGTGGGACTTGGATAGAA,1,864668
dgoRp,1.6,24,9,ACAGATTGACTCCCATAAGT,15,844779
dgoRp,1.6,24,9,ACAGAAGGGTGGCGTTTGTG,15,846093
dgoRp,1.7,25,9,ACACGACATCGTGCTAGTAT,16,843101
dgoRp,1.2,20,9,AATACGCCTACAAGAAAACC,11,857561
dgoRp,0.5,13,9,AAGTGTGAGCCCCAGTAAAC,4,843961
dgoRp,2.7,35,9,AAGCTGCACTAGATGGGTGA,26,860263
dgoRp,1.5,23,9,AAGCAAACGAATCGTTGTAG,14,839452
dgoRp,2.3,31,9,AACTGGCGCCGCAAATACCC,22,852786
dgoRp,4.4,52,9,AACTAAGGCGTCTAGTGTAG,43,854909
dgoRp,0.3333333333333333,10,8,TTTGCGCCTAGTGATAATGA,2,866273
dgoRp,2.5555555555555554,30,8,TTTCAAGTTAGGGGGGGGAA,22,852280
dgoRp,1.6666666666666667,22,8,TTGGCCCTGGTGTCTTCTGA,14,857205
dgoRp,0.7777777777777778,14,8,TTGGAGCCGCCGAATATTCA,6,845515
dgoRp,5.333333333333333,55,8,TTCTATGTAAACTGCAGAGA,47,851814
dgoRp,1.8888888888888888,24,8,TTCGTAAAAGAAGATTTACA,16,848774
dgoRp,1.1111111111111112,17,8,TTCAGCCCGCTCTCGGGCCA,9,856803
dgoRp,0.8888888888888888,15,8,TTCAAACCACTCTCCAGATG,7,844100
dgoRp,2.7777777777777777,32,8,TTAAGGGGATAAAATCTACG,24,858083
dgoRp,0.2222222222222222,9,8,TGTTACTATATAGAAAGTCT,1,851676
dgoRp,1.8888888888888888,24,8,TGTGACTAGCTCTACTCTAA,16,843072
dgoRp,2.5555555555555554,30,8,TGGCAATTCTGCTATAGGCT,22,854789
dgoRp,1.8888888888888888,24,8,TGCGCGAGACCGACCGCTTT,16,859730
dgoRp,2.111111111111111,26,8,TGCAACAATGACGTCAACGA,18,844421
dgoRp,5.555555555555555,57,8,TGAAAGCCACGAAGGTTCTC,49,837222
dgoRp,3.111111111111111,35,8,TCTTGGAACTACCCCCCATT,27,856201
dgoRp,2.0,25,8,TCGTTTGATCTGCCTGCGAA,17,858084
dgoRp,2.888888888888889,33,8,TCGGATTTTGGCAATGAATT,25,839894
dgoRp,1.1111111111111112,17,8,TCAATGGACATCACGTTGAT,9,842707
dgoRp,1.0,16,8,TATATGCTGAAAATCCGCAG,8,860684
dgoRp,1.1111111111111112,17,8,TAGCGGTCCGGCTCTCCCTT,9,862724
dgoRp,34.22222222222222,315,8,TAGAGCAGATCTCTTCATCA,307,858611
dgoRp,1.6666666666666667,22,8,TAGACACGGTTCGCCCGGAG,14,856796
dgoRp,1.2222222222222223,18,8,TACAGTCTGAGGTTTGATCT,10,844034
dgoRp,1.8888888888888888,24,8,TAATAGCGCCATGTTACATA,16,839747
dgoRp,13.555555555555555,129,8,TAACGTTAACGTGGGTCTGA,121,836120
dgoRp,2.6666666666666665,31,8,TAAATAAAAGCACCAAATAG,23,847382
dgoRp,15.777777777777779,149,8,GTTACTCCGCTATCACTTGA,141,844203
dgoRp,2.3333333333333335,28,8,GTGTAACCCCTCACACACAG,20,847530
dgoRp,5.111111111111111,53,8,GTCGCATAACCATAAGTCAC,45,849952
dgoRp,1.6666666666666667,22,8,GTCCCGACGGTCGGTTGATC,14,836449
dgoRp,3.0,34,8,GTATTAACGGGAAGTTTCAG,26,839153
dgoRp,0.2222222222222222,9,8,GTATCTTCGTACGCTTTAGT,1,836690
dgoRp,1.1111111111111112,17,8,GGTTCCGGACGGGCGCGGGT,9,839876
dgoRp,1.4444444444444444,20,8,GGTGGACATCCCTCGCAGAT,12,866106
dgoRp,5.888888888888889,60,8,GGTCGGTTTCTATCAGTTTT,52,838312
dgoRp,2.3333333333333335,28,8,GGGGTTTGCGGCATAAAGGC,20,865336
dgoRp,2.111111111111111,26,8,GGGGATAGGCGCCAAGTAGA,18,843988
dgoRp,2.0,25,8,GGGGAGCAGAGCTCGTTCGA,17,841150
dgoRp,2.0,25,8,GGGCGTCGGGTTCACGTCTT,17,849298
dgoRp,3.111111111111111,35,8,GGGCGGCAACGGTGGTGCAC,27,861656
dgoRp,0.5555555555555556,12,8,GGCGTATTTCACTCTTAGGC,4,853817
dgoRp,8.11111111111111,80,8,GGCACCGTCTGCAGAAAATT,72,866485
dgoRp,1.3333333333333333,19,8,GGATTCGCGTCGGTCTGTGC,11,859628
dgoRp,2.0,25,8,GGAACGGCAAAACCGATTCC,17,867207
dgoRp,2.111111111111111,26,8,GCTTTGAGTATCAGAGAAAA,18,853603
dgoRp,2.5555555555555554,30,8,GCTGCATATACCTCGCGCAA,22,842231
dgoRp,2.3333333333333335,28,8,GCTACGTCCTGATTGCGGCA,20,844875
dgoRp,1.7777777777777777,23,8,GCGTGTTCAGCATCGCGGGT,15,852827
dgoRp,2.0,25,8,GCGCGTGGCAGGCTAAATAT,17,865392
dgoRp,0.2222222222222222,9,8,GCGAATACGGCTAGTTGGTA,1,838083
dgoRp,0.2222222222222222,9,8,GCAGTGCCACGCAGTGCCTC,1,845073
dgoRp,2.3333333333333335,28,8,GATACGGACAGTATGCATGA,20,848584
dgoRp,0.5555555555555556,12,8,GAGGCCACGCAAAGACTTCT,4,858904
dgoRp,1.5555555555555556,21,8,GACACGTAACAATAACGGTA,13,858400
dgoRp,2.0,25,8,GAATTCGAAGATGGATATGT,17,858262
dgoRp,1.6666666666666667,22,8,GAAGAGGGCTGTTCGAGTAA,14,856425
dgoRp,3.7777777777777777,41,8,CTTTGAAACCGAACGAGGAT,33,857927
dgoRp,1.6666666666666667,22,8,CTTTCTACACGATATTCCTT,14,863612
dgoRp,0.2222222222222222,9,8,CTTTAATGTGTACGAGCGAT,1,860771
dgoRp,2.6666666666666665,31,8,CTTTAATACGCCATACGTGA,23,864080
dgoRp,0.2222222222222222,9,8,CTTGAATCCTTTGACAAATC,1,853446
dgoRp,1.5555555555555556,21,8,CTTCTTTGTAACTTTGTAAG,13,844669
dgoRp,0.5555555555555556,12,8,CTTACCCACCGTAATCTTGG,4,850504
dgoRp,2.3333333333333335,28,8,CTGACCGTTCCCTCTCTCGT,20,839570
dgoRp,0.6666666666666666,13,8,CTCTTAGGGACCAGTCCCAC,5,846710
dgoRp,1.1111111111111112,17,8,CTCTCTCGATATATATAGGC,9,858880
dgoRp,0.2222222222222222,9,8,CGTAAGAACCTTTAACCTAA,1,851607
dgoRp,2.111111111111111,26,8,CGGTGTGTGATATAGTCCTG,18,836393
dgoRp,0.2222222222222222,9,8,CGGGCGTTTTTTTTAGATGT,1,849039
dgoRp,0.8888888888888888,15,8,CGGGACCGGCTGTTAAAGAA,7,848322
dgoRp,1.6666666666666667,22,8,CGGACCGGTCTGCGCGCCAA,14,851129
dgoRp,2.4444444444444446,29,8,CGCTTTTAGCTTATTTAGTA,21,857626
dgoRp,0.5555555555555556,12,8,CGCGCCGTGTAGTGGCTGGC,4,858792
dgoRp,1.4444444444444444,20,8,CCTCAACCAAAATCGCCGTT,12,846980
dgoRp,3.5555555555555554,39,8,CCTATGTCTACCAAGCTTCA,31,843700
dgoRp,5.444444444444445,56,8,CCGCAACTTGGAGGGGTCTG,48,842561
dgoRp,1.0,16,8,CCCCTTCCTTCTACGACTAA,8,836494
dgoRp,1.3333333333333333,19,8,CCATCCGCGGTGTGACGTAG,11,850231
dgoRp,1.5555555555555556,21,8,CCACCCATGACTGGTAGGCT,13,864014
dgoRp,2.2222222222222223,27,8,CATTTCCAAGAGCGCCGTTT,19,859514
dgoRp,1.8888888888888888,24,8,CAGGTCCCCGTTAATCTAAT,16,845263
dgoRp,2.111111111111111,26,8,CAGGCAGTTGCAATGAGTAG,18,861422
dgoRp,1.4444444444444444,20,8,CACGGTTAGGCGGGTAGTTA,12,848528
dgoRp,1.6666666666666667,22,8,CACGGGTGCTACTATCACAG,14,840223
dgoRp,1.0,16,8,CACAGGGTACGAGGGAACTA,8,848142
dgoRp,1.5555555555555556,21,8,CACAGGGGGATCCTGCTGTA,13,837058
dgoRp,2.0,25,8,CACAGAAGTTGTCGAGACGC,17,863702
dgoRp,1.8888888888888888,24,8,ATTCAATCGTCCCAGAGATA,16,838718
dgoRp,2.111111111111111,26,8,ATCCAAATGCAGTAATCCCT,18,862589
dgoRp,2.3333333333333335,28,8,ATCAGTTTATTTTCTTTTAC,20,850277
dgoRp,3.3333333333333335,37,8,ATATATCGTGTCCGACAAGC,29,839151
dgoRp,8.0,79,8,ATACTCAAACCTGTTCCCGC,71,860551
dgoRp,2.0,25,8,ATAAGCTCAACTGTGCTACA,17,836912
dgoRp,3.5555555555555554,39,8,ATAAATTGCCTTTCGGTTTA,31,845401
dgoRp,1.8888888888888888,24,8,AGTTGTATATGTGCGTACGG,16,859557
dgoRp,3.4444444444444446,38,8,AGTTGAAAAACGCCGAGGCA,30,845269
dgoRp,2.7777777777777777,32,8,AGTTAGGGTAACAGTAGGCA,24,836012
dgoRp,0.5555555555555556,12,8,AGTGTATTTGGGCCAAGTGG,4,857075
dgoRp,1.2222222222222223,18,8,AGTAGTCGGTACCTCTTAAA,10,854565
dgoRp,5.0,52,8,AGGGACGGTCTATTGGCAGA,44,840252
dgoRp,0.2222222222222222,9,8,AGGCGGCATGACCATAGTTA,1,853129
dgoRp,1.8888888888888888,24,8,AGGACAAATGGTCGCGTGAA,16,844325
dgoRp,1.2222222222222223,18,8,AGCTTTGGCTAGTCAGCGAG,10,851251
dgoRp,0.7777777777777778,14,8,AGCTCCACATCCTCTTTGCG,6,858677
dgoRp,3.6666666666666665,40,8,AGCGCTATCTCATAACTGGC,32,849736
dgoRp,1.4444444444444444,20,8,AGCCAACCAGTACCCGATTA,12,851408
dgoRp,0.4444444444444444,11,8,AGCAATGAGTCTCGGACAAC,3,845121
dgoRp,3.2222222222222223,36,8,AGCAAGAGAAGCCGATTCCC,28,858110
dgoRp,2.5555555555555554,30,8,AGATCTAATATAACGATTAT,22,837784
dgoRp,0.7777777777777778,14,8,AGATAGCGGGAGGCTATGGG,6,844690
dgoRp,3.5555555555555554,39,8,AGAACAGCCTTTGTGGTTCG,31,858719
dgoRp,1.8888888888888888,24,8,ACTTTGAACGGCGGATCCAA,16,845890
dgoRp,2.2222222222222223,27,8,ACTTAGAGGCAACATCAGCG,19,861929
dgoRp,2.0,25,8,ACTCCTTAGATGATGGATCC,17,859158
dgoRp,1.8888888888888888,24,8,ACTCCCGGTGTGGTAGCCGG,16,836305
dgoRp,1.1111111111111112,17,8,ACGTACTCCCTAAATAACGA,9,851487
dgoRp,1.4444444444444444,20,8,ACGGTTGTAAGGCTGTGTTT,12,855284
dgoRp,0.2222222222222222,9,8,ACGGTCGGACGAAAGACTTA,1,835997
dgoRp,0.6666666666666666,13,8,ACCTCGCGGCGTCAACTGGA,5,854471
dgoRp,0.2222222222222222,9,8,ACCGTCACTTGAGCAGGTCA,1,854065
dgoRp,0.8888888888888888,15,8,ACCGTAGCACTGCCCAGAAG,7,838692
dgoRp,2.3333333333333335,28,8,ACCGCACGTGGAGTGACGTG,20,841890
dgoRp,2.6666666666666665,31,8,ACCCTCGTTTACCATACAAC,23,842563
dgoRp,2.3333333333333335,28,8,ACCCTAAAAGTGTAGATCGA,20,866323
dgoRp,1.6666666666666667,22,8,ACCAGCGAGGGAAGATCCTC,14,844429
dgoRp,2.6666666666666665,31,8,ACAAAAGGGGCACATAGCGG,23,847260
dgoRp,2.0,25,8,AATATAAGCTAGATCTTAGG,17,838960
dgoRp,1.2222222222222223,18,8,AACTGTGGTTGTACACCTCC,10,842424
dgoRp,2.7777777777777777,32,8,AACTGCGATTCAGTCCGTAT,24,862293
dgoRp,4.111111111111111,44,8,AACTGAATGCCTCCATGATT,36,854442
dgoRp,0.3333333333333333,10,8,AACTCTCATCACATACGTTC,2,867079
dgoRp,2.7777777777777777,32,8,AACGGCGATGCTATAGGCAA,24,856712
dgoRp,3.111111111111111,35,8,AACGCCCCGGCCAAGCGTTC,27,858933
dgoRp,0.5555555555555556,12,8,AACGACTAGCCCTGAACGCC,4,839148
dgoRp,1.8888888888888888,24,8,AACCAGAGTTCAAGGATTGG,16,852377
dgoRp,2.5555555555555554,30,8,AAACATGAGCGGTCCGGCTA,22,858878
dgoRp,0.875,13,7,TTTTGCTGCCCCCTCCTCTG,6,841093
dgoRp,1.125,15,7,TTTATTCAAGCTTCGATGTT,8,841461
dgoRp,0.25,8,7,TTGGTAAGTCTGCGTTCGAC,1,860610
dgoRp,1.625,19,7,TTGATCGAATCATATTGGTT,12,847089
dgoRp,0.5,10,7,TTATTGTCGAAACATACACT,3,857206
dgoRp,1.75,20,7,TGTTTTAGATGAGGCCGTGT,13,862735
dgoRp,2.5,26,7,TGTTGGCTGCGAGCGTTCAA,19,846114
dgoRp,0.25,8,7,TGTCGTTCTACGGTAACTCT,1,852320
dgoRp,1.625,19,7,TGTCAAATCCTACACATTAA,12,843316
dgoRp,0.375,9,7,TGGATATGCGAACTCACGGG,2,862536
dgoRp,5.125,47,7,TGCGTGATTCGTCCTCTACT,40,856182
dgoRp,4.25,40,7,TGCATAAGACGAGAATCTTG,33,863598
dgoRp,3.125,31,7,TGATCTCCACTACTACTCAA,24,861155
dgoRp,0.625,11,7,TGAATCATAATCCAAAAAAC,4,848894
dgoRp,1.75,20,7,TGAAACTCTGTCAACTGTTA,13,845178
dgoRp,1.125,15,7,TCTGCGTTCGGCGCTATCTA,8,837406
dgoRp,0.375,9,7,TCGCTTCCTATGGTCAGAAG,2,841995
dgoRp,0.75,12,7,TCGCATATCATGCTAGCTTT,5,841941
dgoRp,1.375,17,7,TCGCAGGCCCGTGAGAAAAG,10,841386
dgoRp,1.125,15,7,TCCGGCCAACCCCTTCGAGT,8,854100
dgoRp,0.25,8,7,TCCAAGATACGTCTCTCTAG,1,836540
dgoRp,1.75,20,7,TCCAAATGTCAGTGCCAATC,13,863110
dgoRp,1.625,19,7,TCACCCGGGGGAACCTTAGT,12,865724
dgoRp,1.25,16,7,TATTATCTCACTGCCTGTGG,9,850266
dgoRp,1.375,17,7,TAATTACTTGTTATTTGAGA,10,837443
dgoRp,2.0,22,7,GTTTGACCAGGATGGCTGTC,15,838136
dgoRp,2.625,27,7,GTTTAGGGCTCATCTAGCAA,20,865635
dgoRp,3.125,31,7,GTTGGGAGGACAGTACAACT,24,842843
dgoRp,2.125,23,7,GTTCGCCACCGTATTAAGCT,16,859668
dgoRp,3.625,35,7,GTGGACAGCGGGTCGAATGG,28,852941
dgoRp,2.375,25,7,GTGCCGAGGGTTGTCTTTCT,18,839348
dgoRp,2.5,26,7,GTCTCGAGCGACCGTGGCAA,19,852432
dgoRp,2.625,27,7,GTATGGCCGCTGACCGCATC,20,851277
dgoRp,1.0,14,7,GTACCTGAGTTTGATTCGGG,7,859552
dgoRp,0.875,13,7,GGTTCTGACCGCGAATTTCC,6,856406
dgoRp,1.5,18,7,GGTTCTATTCTGTGTCGCAT,11,846705
dgoRp,6.25,56,7,GGTCTACCTCCGTAACCGTT,49,855332
dgoRp,2.625,27,7,GGTACTGCTATGAGCCTTCT,20,857830
dgoRp,2.375,25,7,GGGTTTAAAGAAATTCAGCC,18,857775
dgoRp,2.625,27,7,GGGGACTATGTCTCGGGCAT,20,856987
dgoRp,1.375,17,7,GGCAGAAGAGATCCGATAGG,10,838257
dgoRp,1.625,19,7,GGCAATAGTCCAAAAACGCG,12,841265
dgoRp,2.75,28,7,GGATTGAGAGACCCAAGAAA,21,855478
dgoRp,2.5,26,7,GCTGGTGAATGCAGGTTGCT,19,842149
dgoRp,2.0,22,7,GCTCTGGATTTAATTAGGTA,15,840976
dgoRp,1.5,18,7,GCTCCTCCCGGCAACGATCA,11,866031
dgoRp,5.0,46,7,GCTCCGTAATATAGCGGCCT,39,857554
dgoRp,2.875,29,7,GCTATGATAATCATCTAAGA,22,835907
dgoRp,2.375,25,7,GCCGGCCTACACGTTCGTTG,18,841362
dgoRp,1.75,20,7,GCCCGTGTGAGTATTATCTG,13,837444
dgoRp,5.5,50,7,GCCCAATTCACCCGTTAGGT,43,851614
dgoRp,2.75,28,7,GCATAGGGTTTGCCCCGCCA,21,854071
dgoRp,0.5,10,7,GATTTTGACTGGCGCACGTG,3,845387
dgoRp,1.375,17,7,GATTCACTATCTGTGTAGGC,10,847036
dgoRp,2.375,25,7,GATGACATATAGTTGAAAAT,18,860212
dgoRp,1.5,18,7,GAGGGTTTACTTTCAGGAGA,11,849043
dgoRp,0.25,8,7,GAGGGCAGGTTGCTGCACCT,1,843180
dgoRp,0.375,9,7,GACGATCTAAAGCTCGTTTT,2,848764
dgoRp,3.0,30,7,GACCGCATTGATGACTGACT,23,867211
dgoRp,0.625,11,7,GAAAACAGTGCATACGATGT,4,836060
dgoRp,3.125,31,7,CTTTAGCCAATGAACCAAGC,24,840202
dgoRp,1.625,19,7,CTCCTTGTTAGAGCGCGCGA,12,865275
dgoRp,2.25,24,7,CTACGTGGGTATCGTCCGGG,17,864236
dgoRp,1.0,14,7,CTAAACTCTTTAGATTGACT,7,841160
dgoRp,3.5,34,7,CGTTACCAACCAGAGGCCCT,27,867260
dgoRp,1.0,14,7,CGTCACATTGAAGCTCCGAT,7,837608
dgoRp,1.875,21,7,CGTATAGAAAGCGCAGTGTT,14,858019
dgoRp,5.25,48,7,CGGCAATAGTCTCAGTTATC,41,846217
dgoRp,2.875,29,7,CGCGCTAGGTTCTGCGAGTT,22,840858
dgoRp,2.375,25,7,CGATGACCTGTGCAGTTTTC,18,836407
dgoRp,3.25,32,7,CGAAGTCTGTCTAGCACTAA,25,846818
dgoRp,0.375,9,7,CCTGTAGAAAGAGAGAAATG,2,864923
dgoRp,1.75,20,7,CCTGGCAGGGCGGTGATTAT,13,847571
dgoRp,2.75,28,7,CCTCGATGCTTGCGCTTTGC,21,844097
dgoRp,1.75,20,7,CCTATGGTTTGCGTCAACGC,13,844349
dgoRp,1.625,19,7,CCGCTCCCTTGGTCGGCCTG,12,839028
dgoRp,1.75,20,7,CCCTTGAGGGATTTAATGGT,13,864151
dgoRp,0.75,12,7,CCACCGCCCTCAATTCTGTC,5,857990
dgoRp,1.125,15,7,CATTCCAGCATCACTCCTGT,8,837248
dgoRp,0.875,13,7,CATCAAATCGAATATGCTCC,6,859203
dgoRp,0.375,9,7,CATACACGCCACGTCGGGGT,2,862875
dgoRp,2.375,25,7,CAGGCTCTCGGTATGTCACG,18,850486
dgoRp,0.75,12,7,CAGCCAAATCATGCACCCAA,5,866113
dgoRp,1.5,18,7,CACGAATCAGTGCGCGTCCA,11,840110
dgoRp,2.625,27,7,CACAAATGATCAGCGGGAAT,20,859662
dgoRp,0.375,9,7,CAATACGGTATTGTGGCCCA,2,867192
dgoRp,2.375,25,7,ATTTCGGATGTGCTTGATAT,18,845708
dgoRp,1.0,14,7,ATTTCCACATATGAATAGGT,7,852096
dgoRp,1.125,15,7,ATTCTCGAACTGGCGCGTTC,8,844985
dgoRp,2.0,22,7,ATTATTGTGATTCCCAGGCT,15,858140
dgoRp,2.625,27,7,ATGCGGCCTGCAGTGCATTA,20,847403
dgoRp,3.375,33,7,ATGAGTATTGTACTGAGTTA,26,858601
dgoRp,1.5,18,7,ATGAGACTCGGTGGATACTC,11,863947
dgoRp,1.625,19,7,ATCTTTAGTGTCCCTCTTCT,12,852750
dgoRp,2.75,28,7,ATCGGTAACATTTTCGACTA,21,852217
dgoRp,1.5,18,7,ATACCTCAGCGCGGATATGA,11,853462
dgoRp,1.125,15,7,ATAATCTCTTCCGTCTGGTC,8,836294
dgoRp,1.5,18,7,ATAAGGGTCACTCCATCCTT,11,861322
dgoRp,2.625,27,7,ATAACGGGGGTCGTTATTAC,20,839299
dgoRp,1.875,21,7,AGTTCCAAGCGAGGAATTTA,14,860049
dgoRp,4.875,45,7,AGTCGGTCATCAGCCCAGGT,38,864919
dgoRp,1.625,19,7,AGTACATTGGGCGTATTATG,12,855182
dgoRp,8.75,76,7,AGTACACACGGACAGGAATT,69,865731
dgoRp,4.0,38,7,AGGTGTAAGAGGCAAGAAAT,31,844206
dgoRp,0.25,8,7,AGGAGGCTACTGAAGCAGAA,1,839526
dgoRp,1.875,21,7,ACTTGAGTTATCACTCCCGA,14,856749
dgoRp,1.5,18,7,ACTCAGCGTGATTCACTATC,11,856621
dgoRp,1.0,14,7,ACTCAATCAGATGAGCTAAG,7,850264
dgoRp,0.5,10,7,ACGTGGGCAACTACCTAGTC,3,858779
dgoRp,1.75,20,7,ACGACTCTGTCCCGGCCGTG,13,867300
dgoRp,0.25,8,7,ACCTACAGGTTGGCGCTGCA,1,842329
dgoRp,1.875,21,7,ACCGTCGCGTCCGCTCATGG,14,845614
dgoRp,1.625,19,7,ACCGGACAACATGTCTACCC,12,859553
dgoRp,1.125,15,7,ACATTGGTGCTGTAGTGTTT,8,839063
dgoRp,2.125,23,7,ACATGTAACGCATCGGGTCA,16,852380
dgoRp,3.125,31,7,ACATCGTAAGTCGTCAGAGG,24,861766
dgoRp,2.5,26,7,AATCCGCGTGTCCCGACTCT,19,849344
dgoRp,2.375,25,7,AATATTGCGAGCCGTCATCA,18,839547
dgoRp,1.75,20,7,AAGTTTGTTGGTTAAGTCCA,13,847739
dgoRp,1.25,16,7,AAGATGTGGAAGCATGGCCC,9,839309
dgoRp,2.0,22,7,AAGAGGGCACATGCCCCGTT,15,840843
dgoRp,2.125,23,7,AACGGGTTAGATGTCTGAAA,16,840410
dgoRp,2.375,25,7,AACCATTAAGATCCATTTTC,18,863510
dgoRp,2.625,27,7,AAATTGATTTGCCAAGGCAT,20,837617
dgoRp,0.25,8,7,AAACTGCCCGCTATGTCAAG,1,848654
dgoRp,4.428571428571429,36,6,TTTTGTTCTTCGCCTTCACA,30,857555
dgoRp,0.42857142857142855,8,6,TTTGGCCAGCGTTCTTCCCT,2,851006
dgoRp,2.2857142857142856,21,6,TTTCCTTACATTAATGGCGT,15,860470
dgoRp,1.4285714285714286,15,6,TTGTTCGTTGCTAGGGCCAT,9,846865
dgoRp,0.2857142857142857,7,6,TTGGCCGATAGGCATAACTG,1,851921
dgoRp,1.2857142857142858,14,6,TTCTGGTCGGAAAGCTAGGT,8,856978
dgoRp,0.2857142857142857,7,6,TTATTTCCCCCTTCCCAATA,1,848217
dgoRp,2.857142857142857,25,6,TTAGGTTAACTTCTTTGTAA,19,852777
dgoRp,1.4285714285714286,15,6,TGTGCCGGTTGCAGAGGGAA,9,850596
dgoRp,1.7142857142857142,17,6,TGTAATTTGTAAGTCGAAAG,11,859384
dgoRp,3.857142857142857,32,6,TGGGGACAACACAGAATAAC,26,843925
dgoRp,1.8571428571428572,18,6,TGCTCTGTGATCCTCGCGGA,12,841280
dgoRp,1.5714285714285714,16,6,TGCGCAGACCACTAATACCC,10,854439
dgoRp,0.8571428571428571,11,6,TGCACAAAGCAGGAGTACTA,5,852743
dgoRp,5.285714285714286,42,6,TGACAGCGGTCAAATCGGTT,36,842208
dgoRp,4.142857142857143,34,6,TGACACCCCTACGCAAGACT,28,849513
dgoRp,0.8571428571428571,11,6,TCTCAGTGCGCGACCCCTAT,5,848759
dgoRp,3.5714285714285716,30,6,TCGTTGCTACCTCCTTTCGG,24,866149
dgoRp,2.5714285714285716,23,6,TCGGTATCATGGGCGCTGGG,17,847731
dgoRp,1.2857142857142858,14,6,TCGGCAGACAAGCCGGGGTC,8,854994
dgoRp,2.2857142857142856,21,6,TCGCTTGACGACGCACTCAC,15,854478
dgoRp,2.0,19,6,TCGATGGGTCTCCGCACCCT,13,854767
dgoRp,1.8571428571428572,18,6,TCCGATTAACCTCTTGACAA,12,853222
dgoRp,0.7142857142857143,10,6,TCCAAATAACCTATTTTTTA,4,859875
dgoRp,2.2857142857142856,21,6,TCATACGGGATTACGCTCCT,15,852668
dgoRp,0.8571428571428571,11,6,TCAGCGCGAGGTCTCTGAGT,5,849147
dgoRp,4.142857142857143,34,6,TCAATAAACAACTGTCCAGT,28,840464
dgoRp,2.5714285714285716,23,6,TCAAGGGTATCAGGCCTCGG,17,863034
dgoRp,2.0,19,6,TCAACTAATAGCTAGCGTAA,13,861794
dgoRp,1.1428571428571428,13,6,TATTCACCGTCGCGTCATCT,7,845606
dgoRp,4.142857142857143,34,6,TATGCCATTGACTGTTCATA,28,860230
dgoRp,0.42857142857142855,8,6,TACGCGATTAAATATTGATC,2,851100
dgoRp,2.0,19,6,GTTCCCGACTTCGGCCTGGT,13,861468
dgoRp,3.4285714285714284,29,6,GTGTCCGAGTACCTGCTATC,23,837333
dgoRp,1.0,12,6,GTGGAGTTGGCGCGCAGGCG,6,858698
dgoRp,1.1428571428571428,13,6,GTGCTTTCATGCTAGTGGCC,7,839480
dgoRp,3.142857142857143,27,6,GTGATTATGTAAACCGATCA,21,856079
dgoRp,1.5714285714285714,16,6,GTCTAACTGAAGTGGGGATT,10,847757
dgoRp,3.142857142857143,27,6,GTCCTTCCCAGTAAGCGCCC,21,850282
dgoRp,2.142857142857143,20,6,GTCCACCCCGAGGCATTAGA,14,850209
dgoRp,5.142857142857143,41,6,GTACGTCCGTGATATAAGAT,35,859040
dgoRp,2.857142857142857,25,6,GTACACGCCCACGCGTGAAA,19,842817
dgoRp,1.8571428571428572,18,6,GTAAGCTCGTAAATGGAAAT,12,840042
dgoRp,2.4285714285714284,22,6,GGTCGGAATCGCGAGCTTAT,16,841904
dgoRp,1.4285714285714286,15,6,GGTAAGGATCATATGGGTCT,9,863825
dgoRp,2.2857142857142856,21,6,GGGCGGTAAAGGCGTCGTTC,15,845749
dgoRp,7.285714285714286,56,6,GGCTGCGGGGTTTAGCAGCA,50,844204
dgoRp,0.42857142857142855,8,6,GGCGTCATCTGGTCCTGTTC,2,836935
dgoRp,0.8571428571428571,11,6,GGAAACAGTTTCAACGCATC,5,847707
dgoRp,10.285714285714286,77,6,GCTTGTCTTCACGATGCGCA,71,846225
dgoRp,1.8571428571428572,18,6,GCTGTGAGTGCCATGAATGG,12,854752
dgoRp,5.428571428571429,43,6,GCGGGAACTGTGTTGGAAGT,37,858040
dgoRp,3.0,26,6,GCGATCTTTCTACGACGTTT,20,859102
dgoRp,1.5714285714285714,16,6,GCATGTCCAAGCGGACAAGG,10,861914
dgoRp,2.142857142857143,20,6,GCATGCGGTCCCTGACTAAA,14,836100
dgoRp,2.142857142857143,20,6,GCAGTTGCGAAAGTTCCTGG,14,843694
dgoRp,4.285714285714286,35,6,GCAACAGTCAGAGAGTTTTC,29,852241
dgoRp,2.2857142857142856,21,6,GATTTAACGGACCTAGTAAT,15,848532
dgoRp,1.0,12,6,GATGGATACCGATCTTTTGA,6,844245
dgoRp,0.7142857142857143,10,6,GATCTAGAGTCACTGTAGTA,4,836006
dgoRp,2.2857142857142856,21,6,GATAGTCGAGTGCTTCGCTA,15,862859
dgoRp,0.7142857142857143,10,6,GATAACTGGGGTTTCCGCGA,4,855766
dgoRp,0.8571428571428571,11,6,GAGTAGTGCAAGCGCGGACA,5,856663
dgoRp,3.2857142857142856,28,6,GAGGAGAATTTACACGAGGT,22,864595
dgoRp,0.7142857142857143,10,6,GACGCAGCCAACCAGCATCT,4,857565
dgoRp,4.285714285714286,35,6,GACAGATATGATATGTAGCT,29,844977
dgoRp,0.7142857142857143,10,6,GACACATACGAACCGGATGA,4,850642
dgoRp,1.4285714285714286,15,6,GAATAGTTATTGAACTACTA,9,840143
dgoRp,1.0,12,6,GAACGTGGAGGATTACTTTC,6,855831
dgoRp,1.4285714285714286,15,6,GAACGTATGGTTGGCACTTG,9,856959
dgoRp,1.7142857142857142,17,6,GAAAGGCGCGAGGCCAGACT,11,838599
dgoRp,1.7142857142857142,17,6,CTTGTTGTTAGGGAGCACAT,11,839595
dgoRp,1.2857142857142858,14,6,CTTGATCAACCTTCGTCTCA,8,843849
dgoRp,6.571428571428571,51,6,CTTACTCGTGGAGGCGAGAA,45,850115
dgoRp,2.857142857142857,25,6,CTTACGGTAATCTTCGGCGC,19,837804
dgoRp,2.2857142857142856,21,6,CTGCGGTTGGTATGGATGAA,15,852211
dgoRp,1.8571428571428572,18,6,CTCCCAGTAGCGTTGGACGC,12,861841
dgoRp,3.142857142857143,27,6,CTCCAACCGCGCCAGTGTTA,21,865153
dgoRp,4.428571428571429,36,6,CTAGGTGCAGCACCTATGGA,30,865584
dgoRp,1.5714285714285714,16,6,CTAGGGCGACAAAGGCTCAA,10,855073
dgoRp,0.42857142857142855,8,6,CTAGCCCATAATTTTCTGTT,2,866260
dgoRp,3.2857142857142856,28,6,CTAGAACGTCACACCTCCGT,22,841432
dgoRp,2.2857142857142856,21,6,CTACGCTGCTCTTATGCAAA,15,840835
dgoRp,3.7142857142857144,31,6,CTACCTGATTTGGACGCTGC,25,839292
dgoRp,0.7142857142857143,10,6,CGTTGCGTGAGCCCCAAAGT,4,836957
dgoRp,1.4285714285714286,15,6,CGTATAGCATAGCGGATACC,9,861178
dgoRp,1.8571428571428572,18,6,CGGAGGGGAGCTTACGAATC,12,851666
dgoRp,2.2857142857142856,21,6,CGGACTCCTACGGGCGGTCA,15,860575
dgoRp,0.2857142857142857,7,6,CGCCTTTAGTACAATTGATT,1,850186
dgoRp,0.42857142857142855,8,6,CGATATCGCCCCTTACCCGC,2,855806
dgoRp,2.142857142857143,20,6,CGAGCTTGAGACACTGCTGG,14,842060
dgoRp,2.142857142857143,20,6,CGACGCCGTAGTCCACAGGA,14,852834
dgoRp,1.0,12,6,CGAAATCTATTTGGCGTACG,6,840516
dgoRp,5.0,40,6,CCTGGTCCCAAACGAGGCTG,34,848766
dgoRp,1.1428571428571428,13,6,CCTAGTAGGTCAGGCGAGCA,7,838886
dgoRp,1.8571428571428572,18,6,CCGGGACCAAAGATTCCCAG,12,850645
dgoRp,1.0,12,6,CCGGAGAGGGTTGCTTAAGT,6,845268
dgoRp,3.0,26,6,CCGAACGCACCCGATGTCAG,20,838505
dgoRp,0.7142857142857143,10,6,CCATCTAGGAGATACTGGTG,4,839524
dgoRp,3.857142857142857,32,6,CCAGTGGGCTCAGCATTTGA,26,865270
dgoRp,6.285714285714286,49,6,CCACGACAATTTAGATGGTA,43,851341
dgoRp,4.142857142857143,34,6,CCACACCACTTCGAAATCAC,28,837595
dgoRp,1.5714285714285714,16,6,CATTATTGGATCCGGCAATA,10,860141
dgoRp,2.857142857142857,25,6,CATGATTGGGCTAGCTCTAA,19,852080
dgoRp,1.0,12,6,CAGTATAACCGGTCGAAGAA,6,838054
dgoRp,0.2857142857142857,7,6,CAGCGACCTACTCTTGAGCC,1,847283
dgoRp,1.8571428571428572,18,6,CAGACCTGATCAATGCGAGT,12,847996
dgoRp,0.2857142857142857,7,6,CACTCCGATCGGTTTCTGTG,1,858590
dgoRp,2.857142857142857,25,6,CACTATTCGAGTTTCCAAAG,19,864807
dgoRp,2.5714285714285716,23,6,CACGTGTATCATTCGTGAAA,17,847883
dgoRp,1.5714285714285714,16,6,CACGAAGGACGGAAGCGTTA,10,856036
dgoRp,2.857142857142857,25,6,CACCCCTTCCATACAGAGTT,19,846141
dgoRp,2.2857142857142856,21,6,CAATGTGGCGTAATCGGGAG,15,862348
dgoRp,0.2857142857142857,7,6,ATTTTCTCAGCATTCGTCTG,1,843770
dgoRp,1.8571428571428572,18,6,ATTTGGCCGGTTTATTGAAC,12,841754
dgoRp,1.4285714285714286,15,6,ATTGTGTTATGTTCATAAAG,9,850122
dgoRp,1.0,12,6,ATCGGTCCTAAATTATTGGA,6,842766
dgoRp,4.285714285714286,35,6,ATCGACTGGGTCGGGTATCT,29,850638
dgoRp,1.5714285714285714,16,6,ATCAAGCGATCGAAGGGAAA,10,863427
dgoRp,0.7142857142857143,10,6,ATATTTGTAATAGAGTTAGT,4,841132
dgoRp,2.7142857142857144,24,6,ATATTCAGGCGTAAATGCGT,18,840561
dgoRp,1.8571428571428572,18,6,ATAGTGGTTCTTTGGGTGAC,12,857113
dgoRp,0.8571428571428571,11,6,ATACGAACGCACGTATTGAC,5,847709
dgoRp,3.2857142857142856,28,6,AGTTATCTCCTCCTCCCACC,22,850635
dgoRp,0.42857142857142855,8,6,AGTTACCCATTATACTCGAA,2,843397
dgoRp,1.8571428571428572,18,6,AGTCCTCCTCTGGACTGATC,12,860496
dgoRp,2.7142857142857144,24,6,AGTCAACGAAAGCTCCGCAA,18,862953
dgoRp,0.5714285714285714,9,6,AGTACCCTGGACGCAAAACT,3,849847
dgoRp,3.142857142857143,27,6,AGGGGTTCTCGTGTATCGCA,21,863273
dgoRp,3.142857142857143,27,6,AGGCTTAAGAGTGAGATCAT,21,846495
dgoRp,2.5714285714285716,23,6,AGCTTGGAGTCCCCAACCCT,17,863610
dgoRp,0.8571428571428571,11,6,AGCTGGCTGCTTTCAGAACC,5,859172
dgoRp,0.7142857142857143,10,6,AGCATCCGGGCTCTAAGTTG,4,851055
dgoRp,0.2857142857142857,7,6,AGATGTCTGATGCAGGTCGG,1,860605
dgoRp,2.142857142857143,20,6,AGAGAGGGTGTGTTTATTAA,14,843135
dgoRp,0.8571428571428571,11,6,AGAAGTGCTTAAGTAGCCAT,5,847205
dgoRp,1.2857142857142858,14,6,ACTTCACCGGTTGCTGATCC,8,838930
dgoRp,1.0,12,6,ACTGAATCTATTTCGCCTTT,6,837790
dgoRp,0.5714285714285714,9,6,ACGGCCCCAGTCCTGCAAAG,3,842277
dgoRp,0.2857142857142857,7,6,ACGGACCAAGTTTTTTGTCC,1,864588
dgoRp,0.5714285714285714,9,6,ACCGAATGTGTCAGAACAAC,3,847858
dgoRp,7.857142857142857,60,6,ACCCAATCCTTGATCATGGA,54,844132
dgoRp,2.5714285714285716,23,6,ACCATTACGAGTATGGGGGA,17,846135
dgoRp,5.428571428571429,43,6,AAGTACGGCCTAGTCAGGCG,37,859187
dgoRp,3.142857142857143,27,6,AAGTAAGGATCGGACCAGCA,21,859181
dgoRp,0.2857142857142857,7,6,AACTAGGAGCATATATCCAT,1,859272
dgoRp,9.285714285714286,70,6,AACCTTCGGTAAAAAATTAA,64,854848
dgoRp,0.2857142857142857,7,6,AACCGATTGTGAACTAGCCA,1,837512
dgoRp,2.857142857142857,25,6,AAATTGAGTAGAGCCTAGAA,19,848242
dgoRp,1.5714285714285714,16,6,AAAGTTGGCTTCGACGCGAC,10,840904
dgoRp,1.8571428571428572,18,6,AAAGAGCTATGTGGCAGGGC,12,851910
dgoRp,0.6666666666666666,8,5,TTTTTCTGAACTTGAGCCCT,3,851269
dgoRp,2.8333333333333335,21,5,TTTCGTCCGTGCGACGTCGC,16,861344
dgoRp,2.8333333333333335,21,5,TTTCGTCATTAAGAAACTTT,16,852290
dgoRp,2.3333333333333335,18,5,TTTCATAAATGTTTGAGCCT,13,853530
dgoRp,2.1666666666666665,17,5,TTTATATGGTTCGGTAGAGG,12,837108
dgoRp,1.3333333333333333,12,5,TTGGTCACTGTAGTGGGTCT,7,854057
dgoRp,1.5,13,5,TTGGAATTCCAAAGTGACCA,8,843948
dgoRp,2.3333333333333335,18,5,TTGATCTCCATTCTCCAGGT,13,839046
dgoRp,0.5,7,5,TTGAACTTGTGCCAGGTAAT,2,864243
dgoRp,2.5,19,5,TTCTATGGCCTGGTCCTACT,14,852001
dgoRp,3.0,22,5,TTCGCGATGGGTGTGCGACA,17,852741
dgoRp,0.3333333333333333,6,5,TTCCTATCGGTTCCCAAGAA,1,861220
dgoRp,3.3333333333333335,24,5,TTATCCGAAGCGGATATACG,19,851417
dgoRp,2.6666666666666665,20,5,TTAGTTTGTTAACTAAACGC,15,839174
dgoRp,0.6666666666666666,8,5,TTAGTAACTGGGAAATGTTT,3,849401
dgoRp,3.5,25,5,TGTGACAAAGTTACAGCACG,20,837089
dgoRp,0.6666666666666666,8,5,TGGGTTAAATTGCGGCATAA,3,864950
dgoRp,0.5,7,5,TGCCGACTGCTGCTTACCAC,2,848573
dgoRp,2.8333333333333335,21,5,TGCAACTGTCGGCAGACTGA,16,865212
dgoRp,4.333333333333333,30,5,TGATTTGCTACAGCTAATCT,25,840203
dgoRp,3.1666666666666665,23,5,TGATCAATGAGCAGTATCCA,18,837400
dgoRp,1.0,10,5,TCTCGCAAAACGTTTTGCGG,5,862912
dgoRp,2.3333333333333335,18,5,TCCGTTCCACCAACTTCGTC,13,838193
dgoRp,3.0,22,5,TCATTTAACGGCGCGCTCAC,17,865159
dgoRp,5.833333333333333,39,5,TCATCCACGCGGCTCGATGA,34,846814
dgoRp,5.5,37,5,TCAGATAGCATCACATCATC,32,846737
dgoRp,1.8333333333333333,15,5,TCACGAGCTCCACGCTCAGT,10,847679
dgoRp,2.1666666666666665,17,5,TCAACTGAATTGTCTGTGGT,12,862850
dgoRp,9.666666666666666,62,5,TCAAAACTGTAGCGAGAGAC,57,846551
dgoRp,1.6666666666666667,14,5,TAGGTAATCATTAGAGATGA,9,859829
dgoRp,1.6666666666666667,14,5,TAGGGGTCGGAGTCCCAAAT,9,840833
dgoRp,4.833333333333333,33,5,TAGATAGGTTTCATAATCTT,28,853717
dgoRp,1.3333333333333333,12,5,TACTTTTGGACGGTTTACCA,7,835812
dgoRp,5.166666666666667,35,5,TACGATAGTTTGATAACACT,30,852609
dgoRp,3.0,22,5,TACGAATTTATTGAGAATAT,17,857558
dgoRp,1.6666666666666667,14,5,TAAGCGTTCGATATTGGGTG,9,844625
dgoRp,3.0,22,5,TAAGACCATGCCCTTCCTTA,17,859317
dgoRp,9.5,61,5,GTGGGTGCCGTAGAACAGCA,56,848912
dgoRp,1.6666666666666667,14,5,GTGGCCTGACAGAGCCGGCA,9,858679
dgoRp,1.6666666666666667,14,5,GTGACGCGTTTATGGTTGCC,9,859530
dgoRp,2.6666666666666665,20,5,GTCGGGATCCGATGATCCTC,15,853374
dgoRp,2.5,19,5,GTAGTTTGAATTCACACCCT,14,844650
dgoRp,2.5,19,5,GTACCGGTCGGACGGAGGAG,14,841595
dgoRp,2.5,19,5,GGTTAAGTCAAGTGGGACGT,14,865965
dgoRp,5.666666666666667,38,5,GGTTAAGTATGATAATAAGT,33,836720
dgoRp,5.166666666666667,35,5,GGTGTAACCTGATCTAATTA,30,862995
dgoRp,1.3333333333333333,12,5,GGTGAACTTAGAGTTGAGGT,7,861088
dgoRp,0.8333333333333334,9,5,GGTATAGACACATGGCCATT,4,840189
dgoRp,1.1666666666666667,11,5,GGTAACTATCGGTTGACGGG,6,863685
dgoRp,2.5,19,5,GGGTGAAAACGGAAGGCCAT,14,861915
dgoRp,1.8333333333333333,15,5,GGGGTCCCGAAGATTCTCTC,10,857543
dgoRp,1.6666666666666667,14,5,GGGGATGTATTTTGGGACGC,9,850326
dgoRp,6.5,43,5,GGGGACACGGTCCCTCGGAC,38,862332
dgoRp,1.1666666666666667,11,5,GGGGAAGCGCCAAGAGAGGA,6,844928
dgoRp,3.5,25,5,GGGCCTTTTCGTATGTTCAC,20,850762
dgoRp,1.0,10,5,GGCTACATTATCGCGGTGCC,5,864541
dgoRp,1.3333333333333333,12,5,GGCGGGTCACGTCAGACCTA,7,863457
dgoRp,2.0,16,5,GGAATTCTCTCGTCTCCAAG,11,841340
dgoRp,5.166666666666667,35,5,GGAAGCCTCACAAGCAAGTT,30,855165
dgoRp,2.3333333333333335,18,5,GGAAAATTCTTTGTAAGGGG,13,865205
dgoRp,2.5,19,5,GCTGGTGAAGAGCCCCAATT,14,847105
dgoRp,2.8333333333333335,21,5,GCGTGTCTTCCATACGTACA,16,857178
dgoRp,0.8333333333333334,9,5,GCCTCACAGAACCCGAATCT,4,851907
dgoRp,1.6666666666666667,14,5,GCCCTTCCGAATGGAGGGGG,9,836840
dgoRp,3.5,25,5,GCCAAGCAAAATATGTACCA,20,859997
dgoRp,1.5,13,5,GCATCACACAGGATCGGACG,8,863666
dgoRp,1.3333333333333333,12,5,GCAGCTGGTCTCTGAATCCA,7,861050
dgoRp,0.3333333333333333,6,5,GCAGATCGAGCTGCATAGGC,1,858925
dgoRp,1.5,13,5,GCACTGACATATCCAACGGT,8,862637
dgoRp,2.3333333333333335,18,5,GATTCACATCGCAAGAATGC,13,840915
dgoRp,0.3333333333333333,6,5,GAGGTAGTCCCCAGTGGTAC,1,852159
dgoRp,0.3333333333333333,6,5,GAGCCAACAATCTCTATAAT,1,850630
dgoRp,3.6666666666666665,26,5,GACTACGTAAACGTCCACCA,21,847904
dgoRp,4.833333333333333,33,5,GAAGCACCCATTTCAGCGTA,28,839076
dgoRp,25.333333333333332,156,5,CTTTCGTCCCATAGCACATT,151,846221
dgoRp,2.6666666666666665,20,5,CTTGTCAACGCAGGTTTTTC,15,844159
dgoRp,2.5,19,5,CTTGAAGTAGTGGTACGAAT,14,865075
dgoRp,0.5,7,5,CTGTGGTGGGGCGTACGACA,2,864686
dgoRp,0.3333333333333333,6,5,CTGGTGACGAGTTCGTGAGG,1,836688
dgoRp,4.333333333333333,30,5,CTGCACACTTTGAGCCAAAA,25,854971
dgoRp,1.8333333333333333,15,5,CTCTGGCTAGGAAGAAGTAA,10,855344
dgoRp,3.3333333333333335,24,5,CTCGAAAGATCTCAGTCCAC,19,855747
dgoRp,3.8333333333333335,27,5,CTCCGTGCAATGGCTGTGCT,22,852581
dgoRp,0.3333333333333333,6,5,CTCACGTAGACCACCTACGT,1,854845
dgoRp,2.0,16,5,CTATCTATTAGTTGCGGCGT,11,847587
dgoRp,3.1666666666666665,23,5,CGTGCTTAGTACTAAACGAG,18,840993
dgoRp,1.0,10,5,CGTAATTTCTACGGAACTTT,5,858200
dgoRp,0.3333333333333333,6,5,CGGTGCGGGCGCACAATTTC,1,848675
dgoRp,2.5,19,5,CGGTCGGGGGAAGTTGCCCC,14,849577
dgoRp,8.333333333333334,54,5,CGGTACTGCCAAAATTGGGT,49,863971
dgoRp,0.8333333333333334,9,5,CGGGGGAATCCACGACGAAT,4,840722
dgoRp,2.1666666666666665,17,5,CGGGCGCGAAGGGACTAGCC,12,863731
dgoRp,2.1666666666666665,17,5,CGGCGACCCCCATAATGATC,12,854343
dgoRp,0.5,7,5,CGGATACAAAAGGGCGGTTA,2,854132
dgoRp,2.8333333333333335,21,5,CGCCTCGACGGTGGCAGTAC,16,850603
dgoRp,1.3333333333333333,12,5,CGCCGGAACAGCAGAAAGTT,7,858629
dgoRp,2.8333333333333335,21,5,CGCATTCACTGCTCCGAAGA,16,857885
dgoRp,1.6666666666666667,14,5,CGCAAATCCACTACGGTATC,9,857373
dgoRp,0.3333333333333333,6,5,CGATTAAGACCCGATGATTA,1,854796
dgoRp,2.3333333333333335,18,5,CGATGTTGTTACGACTTATT,13,858424
dgoRp,3.5,25,5,CGAGGTAACCCGATTTCGAT,20,851799
dgoRp,3.0,22,5,CGACGTCACGTATAGAATTT,17,839864
dgoRp,4.666666666666667,32,5,CCTTTGCGACAGACAGGCGG,27,845761
dgoRp,0.5,7,5,CCTGCTGCGAACTATCTGTA,2,837200
dgoRp,1.3333333333333333,12,5,CCTAGATCAACCACCGCTAA,7,859914
dgoRp,2.5,19,5,CCTACAAACTCTGCGCCCTA,14,860090
dgoRp,6.166666666666667,41,5,CCGTAGCGAAAAATAAATGT,36,857519
dgoRp,0.5,7,5,CCGGGCCGAAGGGCGCTCGT,2,853710
dgoRp,1.8333333333333333,15,5,CCGGAATTGGAGTGCCGCAG,10,842809
dgoRp,5.833333333333333,39,5,CCCCTGGGTCCCGACCATCC,34,847381
dgoRp,0.6666666666666666,8,5,CCAGTAAATTCACGCATGCA,3,858335
dgoRp,1.5,13,5,CCACGATAATGGCCGTCCTT,8,849102
dgoRp,0.3333333333333333,6,5,CCAATTCTGAAAGCGGCCAA,1,842915
dgoRp,3.5,25,5,CATGCACTAGGCGGTGGGTA,20,859753
dgoRp,0.3333333333333333,6,5,CATCAGAAAGACGACGTCTA,1,855764
dgoRp,0.5,7,5,CACGAGCGTGTCTATAGATA,2,854742
dgoRp,1.5,13,5,CAACCTACCTCTTGTTCCCG,8,847203
dgoRp,0.8333333333333334,9,5,ATTGGATGGCTAACGAACGG,4,848046
dgoRp,6.666666666666667,44,5,ATGTCGAGTAAGGTGATCGT,39,860552
dgoRp,2.1666666666666665,17,5,ATGCCAGGGTTAATGTAGGT,12,853030
dgoRp,2.5,19,5,ATCGGGTGGTCCCAATCAAT,14,866757
dgoRp,0.3333333333333333,6,5,ATCCACGTGCGAGTCCCCCA,1,849284
dgoRp,2.5,19,5,ATATCTTACTTATTCCCCGC,14,848994
dgoRp,3.1666666666666665,23,5,ATATAAGGGGCATATCCATT,18,860546
dgoRp,3.8333333333333335,27,5,ATAGCGCGTAGGACCACTTA,22,855459
dgoRp,0.6666666666666666,8,5,ATAACAGCGTACCGGTGGCT,3,863028
dgoRp,0.5,7,5,AGTTACATGGGGGTGAATGT,2,847881
dgoRp,1.1666666666666667,11,5,AGTGCTCGCAGGTTAGGGAA,6,859650
dgoRp,0.3333333333333333,6,5,AGTATGGATCGACTAGAAGC,1,855366
dgoRp,0.3333333333333333,6,5,AGTAATGCCGGTATACGAAA,1,839418
dgoRp,0.3333333333333333,6,5,AGGGGAGGGGGTCACGAAGA,1,847889
dgoRp,2.0,16,5,AGGACGACCCCCCTCAGTTT,11,863887
dgoRp,2.6666666666666665,20,5,AGCTCTTCGGGCCACCGGCG,15,846241
dgoRp,2.6666666666666665,20,5,AGCAAGGTATGAACCACCTG,15,858024
dgoRp,2.0,16,5,AGCAACTAACAAGCATGGCG,11,848511
dgoRp,1.6666666666666667,14,5,AGATCATGGGATACGAACGA,9,849429
dgoRp,1.8333333333333333,15,5,AGACAATTCCACATCAACCT,10,850814
dgoRp,2.3333333333333335,18,5,AGAAAGTTTGCTGAAAGCTC,13,849291
dgoRp,4.166666666666667,29,5,ACTCTGTACGGAAGTCAGTA,24,856512
dgoRp,6.166666666666667,41,5,ACTATGGGGGGTAGCGCATC,36,843303
dgoRp,4.333333333333333,30,5,ACTATCACTCCATCCGCATA,25,857533
dgoRp,1.8333333333333333,15,5,ACTACCATAGTTAATCACCT,10,855124
dgoRp,2.6666666666666665,20,5,ACGTAACGTGTCGATACGCA,15,845669
dgoRp,0.8333333333333334,9,5,ACGATCTGTGGACCTGTATA,4,850338
dgoRp,2.8333333333333335,21,5,ACCCGTCTTCATATCATAAG,16,853822
dgoRp,4.833333333333333,33,5,ACCCGTCACCATTAGCTACA,28,850582
dgoRp,1.5,13,5,ACAGGGATATTGGTAACGCC,8,845261
dgoRp,1.8333333333333333,15,5,ACACCGCAAGGGTATCGTAA,10,849697
dgoRp,1.5,13,5,AATTACAGGTGTCTGTCTGT,8,848850
dgoRp,2.6666666666666665,20,5,AATGGGAACGCATATCAACA,15,863969
dgoRp,2.1666666666666665,17,5,AATCAATTTGTAGCAGCAGC,12,858606
dgoRp,4.833333333333333,33,5,AATAGGATTATACCCTTGCA,28,856769
dgoRp,2.6666666666666665,20,5,AAGGCGTCTACAGTCTCTGG,15,858158
dgoRp,1.8333333333333333,15,5,AACTGTACCACAAGATTCCG,10,855613
dgoRp,2.3333333333333335,18,5,AACCATTCGATGCCGGGACC,13,839661
dgoRp,5.0,34,5,AAATGGGCGCAAGACCGCCT,29,852379
dgoRp,2.3333333333333335,18,5,AAATCTATGAGTGAGTATAG,13,853094
dgoRp,3.3333333333333335,24,5,AAAGATTCTTCGGAGCAGCC,19,860088
dgoRp,3.0,22,5,AAACGGTACGTGCTGTTGCA,17,848676
dgoRp,1.5,13,5,AAAATGGCGGATCGTCCCCT,8,864274
dgoRp,0.8333333333333334,9,5,AAAAACGCCAAGTGGAACAA,4,843165
dgoRp,2.4,15,4,TTTTCACTCAGCGCCCTTGT,11,859189
dgoRp,5.2,29,4,TTTTAAAAGACCGGATTTTG,25,848925
dgoRp,5.0,28,4,TTGTCAAACTACTGCCCGTA,24,856345
dgoRp,1.0,8,4,TTGCTCGTTCCAGATTTTAG,4,867415
dgoRp,5.4,30,4,TTCCTAATTGGGACGAATAA,26,845720
dgoRp,3.2,19,4,TTCCCCGACTCGTGTATTAA,15,836979
dgoRp,2.8,17,4,TTATTTTGATGGAGCCTTAT,13,841025
dgoRp,3.8,22,4,TTAGCTCAGCACCGAACAAC,18,841851
dgoRp,2.8,17,4,TTACCGCCGAATGCTCCAAC,13,863504
dgoRp,2.6,16,4,TTAACGCGGTTTTAGACCCG,12,846033
dgoRp,1.2,9,4,TGGGGTAAAATAGTCTCGAG,5,858289
dgoRp,3.4,20,4,TGGACCGGTTCGCGGGGCTA,16,846230
dgoRp,3.0,18,4,TGGACCGCGCGTTATGGTCT,14,864939
dgoRp,1.6,11,4,TGCTGACTGCCTCAGTATCC,7,843263
dgoRp,1.2,9,4,TGCTCCAAATGTATTAGTCT,5,840657
dgoRp,2.6,16,4,TGCTAAGAAAATTCTTGTTC,12,851661
dgoRp,1.4,10,4,TCTTCTTATGGTTATCACCT,6,862782
dgoRp,2.2,14,4,TCTAGTTCCCGGCCAGTTAT,10,865106
dgoRp,1.8,12,4,TCGTCAGTCTTGATAACCCT,8,865350
dgoRp,0.4,5,4,TCGTACCTCATCGGTACTGC,1,861958
dgoRp,0.8,7,4,TCGCTCCCGCACTCCTTTGA,3,847080
dgoRp,4.0,23,4,TCGAGGGGCAGTCGGTAACA,19,854108
dgoRp,5.0,28,4,TCGACGTCGGCTTGTCAAAG,24,858615
dgoRp,4.6,26,4,TCATGTCCTCCCAGCAGTAA,22,863361
dgoRp,3.4,20,4,TCATGAGTTCAAGGATCTCA,16,842668
dgoRp,1.2,9,4,TCAGTGGGCGGTGGAACCCA,5,852455
dgoRp,4.2,24,4,TCAGAATCTAACACGTGGGC,20,861517
dgoRp,3.6,21,4,TATTCGTCCGGTGCATCTAG,17,862273
dgoRp,2.0,13,4,TAGATCGTCTGTCCCCCCTT,9,859755
dgoRp,3.0,18,4,TACCTGACCCTTTATCGAGA,14,855995
dgoRp,7.2,39,4,TAAGTTATATCACATGAATT,35,838476
dgoRp,2.4,15,4,TAAGGAGAATAGAGCTTGAA,11,857501
dgoRp,3.2,19,4,TAACTTGCTCGCCATCCTAG,15,857242
dgoRp,2.0,13,4,GTTGGCCATCATACTCCTAA,9,857965
dgoRp,3.2,19,4,GTTAGGTTACCGTCCCCGTC,15,864892
dgoRp,13.0,68,4,GTGTGCCAGGGGAGGTATTC,64,843227
dgoRp,3.2,19,4,GTCGGCCGCGAACTGGGCAA,15,865913
dgoRp,3.6,21,4,GTCAAATCCGAAGTAGCTAA,17,852561
dgoRp,4.0,23,4,GTAGTCTGGTGGCCACCAGT,19,858496
dgoRp,3.6,21,4,GGTACCAAATCAAATACGGT,17,855438
dgoRp,10.4,55,4,GGGTCTCCTCGCAGCGTACT,51,848879
dgoRp,1.4,10,4,GGGGTAGCAAACTAGGCGCC,6,859227
dgoRp,10.8,57,4,GGGGGTCTGATTGGAAATAG,53,862442
dgoRp,3.6,21,4,GGGGGGTTCATATTGCATTC,17,852603
dgoRp,3.4,20,4,GGCTTCTGTAGATGGGACTC,16,853336
dgoRp,2.8,17,4,GGCGTCCATTGGTCTTCATA,13,861628
dgoRp,0.6,6,4,GGCACGGGAGGGGTTCTATG,2,842219
dgoRp,7.4,40,4,GGATGTTGTAGAAAGGCTTC,36,867456
dgoRp,3.4,20,4,GCTTGCCATGTAATTGCGCA,16,841592
dgoRp,2.2,14,4,GCTGCTTCCTTGTTGCGTAA,10,858320
dgoRp,0.8,7,4,GCTCGCGGGGGGATCCCCTT,3,844192
dgoRp,2.8,17,4,GCTAGCGTCTGAACGGTGGC,13,848423
dgoRp,2.6,16,4,GCGTCTTACGGGTGGGAATA,12,862445
dgoRp,3.8,22,4,GCGCCTCATGTTGTCTTGCA,18,857029
dgoRp,3.2,19,4,GCGACGCTTATTTTCGTTAT,15,864141
dgoRp,3.4,20,4,GCCCACAGAATCTATAAGGA,16,837686
dgoRp,3.6,21,4,GCCAGTGCATCTCGTTTAGG,17,851567
dgoRp,3.2,19,4,GCAGGCTTCGGGCCGCATAC,15,851298
dgoRp,2.0,13,4,GCAAATCATACAAAATGGCA,9,836713
dgoRp,2.2,14,4,GAGTAAAACGAACGTCTAGG,10,848285
dgoRp,15.2,79,4,GAGATCCGTTTGCTCGTAAC,75,857746
dgoRp,0.8,7,4,GACTGCATGTTGATATCGAG,3,852889
dgoRp,0.8,7,4,GACCTTTGTCACCTCCCTGT,3,837185
dgoRp,4.8,27,4,GAAGGCAGTATATATAGATT,23,845828
dgoRp,4.4,25,4,CTGTGTGTTGGGAGCTTGAG,21,836122
dgoRp,1.2,9,4,CTCTGCGCCCCTTCCCCTTT,5,837177
dgoRp,13.2,69,4,CTCGTCTTGTCCCAACGATG,65,865014
dgoRp,6.4,35,4,CTCAACAATGACGAGCAGGG,31,865565
dgoRp,2.2,14,4,CTATTTTGCGCATCAAACAG,10,855471
dgoRp,0.6,6,4,CTATTATCAGTCCCGCGATC,2,837186
dgoRp,3.2,19,4,CTATAGAATGTATTTTCTAG,15,863304
dgoRp,0.8,7,4,CTACTATAATCTAAGATAGG,3,855767
dgoRp,1.0,8,4,CTAAGGTAAGCATCGTCGCC,4,850599
dgoRp,1.0,8,4,CGTTCCTTTATGCTCCTTGT,4,843852
dgoRp,1.8,12,4,CGTTCCGCGTACCCTCAAAG,8,862686
dgoRp,3.0,18,4,CGTGGTGAGGATTTATTCTG,14,836297
dgoRp,2.6,16,4,CGGGGTAAGACTTGAATGCA,12,862592
dgoRp,1.8,12,4,CGGCTCTCTTCACATGAGGT,8,840247
dgoRp,1.2,9,4,CGGATTTAGGCATTGGGGGA,5,844589
dgoRp,2.0,13,4,CGGACGTCGCCAGAATAACA,9,859260
dgoRp,4.4,25,4,CGCGGGAGATGTATTATACA,21,858932
dgoRp,1.2,9,4,CCGGGAGCCGTCCCGGGATG,5,858756
dgoRp,0.4,5,4,CCGGAGTAAGATGGCTATGT,1,852927
dgoRp,3.4,20,4,CCGCTAGGTGTTACCGAGGT,16,842866
dgoRp,2.8,17,4,CCGATTTGCTCAGGATCCAC,13,850062
dgoRp,1.6,11,4,CCCTATTTCTTCCCGGAGCA,7,846460
dgoRp,1.2,9,4,CCATCAACCCTCCTTCCGGT,5,846027
dgoRp,0.8,7,4,CCAGCTAGCAACCTTCGGAT,3,846115
dgoRp,1.6,11,4,CATTGGTGCCCTTAGCTATA,7,851240
dgoRp,2.2,14,4,CATGTCAAAAAAGTACTTCT,10,853852
dgoRp,3.2,19,4,CATCGTTGTGTTAAGCAGGC,15,836224
dgoRp,0.4,5,4,CAGATGGCGGTAGCTGGCCC,1,843009
dgoRp,1.0,8,4,CAAGTCACCGACGAGGAACA,4,857356
dgoRp,6.0,33,4,CAACCGCTTTAATAAGGTTC,29,838888
dgoRp,2.8,17,4,ATTTGCAGGTATTTCTCTGG,13,850333
dgoRp,3.0,18,4,ATCTCAAGCGGTGACAAGAT,14,841144
dgoRp,4.2,24,4,ATCTAACGGTTGTCTTCGGG,20,849289
dgoRp,1.4,10,4,ATCGCGCGCTAAGCCTGAGA,6,841440
dgoRp,2.4,15,4,ATATGTCGTTTTGCCAGGTG,11,856409
dgoRp,1.2,9,4,ATATGAGGCTTTATATGACC,5,862733
dgoRp,3.2,19,4,ATATAATCAGGCGCCGGACT,15,850113
dgoRp,6.0,33,4,ATAGGATCCCGGAACTTACC,29,861768
dgoRp,5.6,31,4,ATAGCAGTATTCCGAATGCA,27,848027
dgoRp,5.4,30,4,ATAATTTAATTACATCTCGC,26,862483
dgoRp,5.2,29,4,AGGGTGTTGATGGTGCAAGG,25,859125
dgoRp,2.6,16,4,AGGAGTGGCACTGGGCTACT,12,856870
dgoRp,2.8,17,4,AGCGTGTCCCCCCTTCCACC,13,847254
dgoRp,5.2,29,4,AGCAGTGTGCAATTGCTGGG,25,842576
dgoRp,2.0,13,4,ACTCTTTTGTGGTAGTCAGG,9,836073
dgoRp,3.6,21,4,ACGTCGCCTTGTCCATAGGC,17,845463
dgoRp,2.4,15,4,ACGCTGAGAGCGTCGGCTCC,11,866728
dgoRp,3.0,18,4,ACGCCGGATTCTGACAAGTA,14,847999
dgoRp,3.2,19,4,ACCGTTTAAGCCTTCAACCC,15,845266
dgoRp,3.2,19,4,ACCGTCTCGGAACTTCCAGA,15,844205
dgoRp,13.0,68,4,ACCGCAAACCGGTACTATCT,64,860562
dgoRp,0.6,6,4,ACCATGAACCACTCGACTCT,2,845139
dgoRp,3.2,19,4,ACCACCGTACCCCGGAGATA,15,838744
dgoRp,2.8,17,4,ACATTATAAACTTCATACCG,13,837402
dgoRp,1.8,12,4,ACACCTGCAAATTCAGTTAA,8,857812
dgoRp,2.0,13,4,ACAAGCTTTGCCTACAAGCG,9,854907
dgoRp,0.4,5,4,AATTCTCAATCTGAGAATCA,1,843698
dgoRp,0.8,7,4,AATACTGCGTACCTAATCGG,3,846276
dgoRp,1.4,10,4,AAGTCCAAAGGTAATCACCC,6,863442
dgoRp,4.6,26,4,AAGGAGCGAACGGATGCCCT,22,844125
dgoRp,0.6,6,4,AACTGTGAAGATTGCTCTTT,2,852903
dgoRp,4.0,23,4,AACACGTGCGAACTCATAAT,19,852471
dgoRp,2.8,17,4,AAATCGATACCAGTCGGCTC,13,836491
dgoRp,1.8,12,4,AAACTCGAGATACTGAAGAC,8,849491
dgoRp,6.5,28,3,TTTTCTGTGCCGTCAAGAAC,25,860326
dgoRp,2.75,13,3,TTTCAAGCCCCGGAGGTATG,10,848913
dgoRp,3.5,16,3,TTTACGAAATTACGTCGGGC,13,853284
dgoRp,3.75,17,3,TTGTAACAGCCAGGCCAACT,14,848990
dgoRp,3.75,17,3,TTCAGAGCGGCATGGAGGGG,14,839761
dgoRp,4.25,19,3,TTACGTTCAGTACGGCACCT,16,839846
dgoRp,3.75,17,3,TTACGGGCTATTCACGATAT,14,865591
dgoRp,2.5,12,3,TTAAAATACGTGCAGTATTA,9,863929
dgoRp,8.25,35,3,TGTCTTCCCTTTGTGAGTTA,32,859201
dgoRp,4.25,19,3,TGGTTGCACCTATGTCGGGT,16,853668
dgoRp,3.25,15,3,TGCGTGTCGCCGTGGGGCTA,12,862014
dgoRp,1.25,7,3,TGCGTCTCCTTTCTACCCCT,4,845535
dgoRp,4.25,19,3,TGCGGACGATCGCTTTCGTG,16,840989
dgoRp,0.75,5,3,TGCCAGGGGTAAAAGGTCGC,2,849404
dgoRp,2.5,12,3,TGCACGAACTTGGATAAGTT,9,867459
dgoRp,1.25,7,3,TGATCTTTATTCTGGCCTAC,4,838403
dgoRp,1.75,9,3,TGATCCGGGCGAGCCATAGA,6,852462
dgoRp,1.75,9,3,TGATACCAAAAATCTGTAGC,6,860460
dgoRp,13.25,55,3,TGAGGTTGATAGCCACGGCC,52,845523
dgoRp,0.5,4,3,TGAAAAATGGACGGTCGTAA,1,857268
dgoRp,1.0,6,3,TCTGGTGCGGGTCACTATGT,3,847777
dgoRp,6.75,29,3,TCTAGTTAGTTTTGGCGCTA,26,836789
dgoRp,7.25,31,3,TCGTCCCCGCTCGATCATGG,28,861754
dgoRp,3.25,15,3,TCGGGATTCATCGGTACTAT,12,860431
dgoRp,0.75,5,3,TCGCCCTTGAAGCAAAATCT,2,860069
dgoRp,1.0,6,3,TCCAGGCGGCCGTATACCCG,3,866352
dgoRp,2.5,12,3,TCCACTTCGGTTAGGCTTGC,9,861410
dgoRp,5.25,23,3,TCCACATTTGTGTTTCACAA,20,845183
dgoRp,0.5,4,3,TCAAGTAGGCTCAGCATGGT,1,850706
dgoRp,3.5,16,3,TATTCTCGACGGGTGCTAGC,13,836836
dgoRp,4.25,19,3,TATGTCTCGTTACATCCGCG,16,854708
dgoRp,7.75,33,3,TATCACTTCCGATAAGGGGG,30,857790
dgoRp,1.5,8,3,TAGGATTCGGCGATCTGGAT,5,848214
dgoRp,2.5,12,3,TAGCTAGTCAATACCCCTCT,9,845047
dgoRp,1.5,8,3,TACCCCTACTTGATTCAGTA,5,840828
dgoRp,1.75,9,3,TACATTTGTTTATCTACTCC,6,843632
dgoRp,3.0,14,3,TAATAAAGTGCTAAGGGGGT,11,843076
dgoRp,4.25,19,3,TAAGCGCAAGCAACCGGTAC,16,859261
dgoRp,2.25,11,3,GTTCTGCATCCATGTTTGCA,8,837872
dgoRp,7.75,33,3,GTTCCTCCGAATTGCGTCGT,30,851371
dgoRp,4.0,18,3,GTGGTGGATGCACTTGATTG,15,841274
dgoRp,7.0,30,3,GTGCCTTCTGTATACGATAC,27,838546
dgoRp,1.75,9,3,GTGATAGATTACGTTACATG,6,838316
dgoRp,4.0,18,3,GTCTACATGACCGCGGTAAG,15,865837
dgoRp,3.0,14,3,GTCCCTTGTCGGCGGTTAGA,11,835999
dgoRp,2.25,11,3,GTCAATGCATCCATGGGAGC,8,849483
dgoRp,1.0,6,3,GTAGCCCTAGCAGAAGGTCT,3,843841
dgoRp,1.25,7,3,GTAGACCGTTGTGGACTAGA,4,838163
dgoRp,4.75,21,3,GGTTTTGACGACTTGCGTCC,18,852629
dgoRp,1.0,6,3,GGTCGAGTACTGGTCTCCCA,3,860325
dgoRp,5.0,22,3,GGGGTTCCCCAGTCATGCGT,19,847113
dgoRp,1.0,6,3,GGGAGATACGCCAGTGGCTA,3,856470
dgoRp,1.75,9,3,GGCCCCGAGCATGGACAAAA,6,853658
dgoRp,4.0,18,3,GGCAGCACACTTGGCGTCTG,15,845267
dgoRp,2.75,13,3,GGACTCGGTAACCAGGGGAT,10,859717
dgoRp,1.0,6,3,GGAACGGTCACAGCCCGGAT,3,854763
dgoRp,6.0,26,3,GCTTCGTCATCAATGTTGAA,23,845440
dgoRp,3.25,15,3,GCTCGGAGTCCATGATGTAA,12,866022
dgoRp,2.75,13,3,GCTAAACCCGGCGCGGGGGA,10,850175
dgoRp,3.0,14,3,GCGTGCCTCGGCAAAGCGTG,11,847640
dgoRp,3.0,14,3,GCGTCGGATTGCCATTCTGG,11,849770
dgoRp,1.75,9,3,GCCGTTTCCGTGGAGTGATA,6,837669
dgoRp,4.75,21,3,GCATGTCTTCGTTCTCCCTG,18,838670
dgoRp,4.25,19,3,GCATCGGGACAAGTTTAACA,16,856901
dgoRp,0.5,4,3,GCAACCCGTACGTGCGGGAG,1,857313
dgoRp,5.5,24,3,GAGTAGCGGCGGACATCTGT,21,844196
dgoRp,4.0,18,3,GAGAAGCACATAGCAAAGGA,15,847957
dgoRp,4.0,18,3,GACCCTATCGGCCACGGAGT,15,848293
dgoRp,0.5,4,3,GACAACCGCCAGTATTCGTA,1,853341
dgoRp,5.0,22,3,GAATAGACCCAAGTTCCTCC,19,842063
dgoRp,3.25,15,3,GAATAAAGTTCAGTCACTTA,12,847910
dgoRp,0.5,4,3,GAACGTTCATCAGAAGAAAC,1,837306
dgoRp,0.75,5,3,CTCTTTACGCAGATGGGAAT,2,863156
dgoRp,4.25,19,3,CTATCGTGTCTACGGCATTC,16,843579
dgoRp,4.25,19,3,CTATCCTAGATATATAAAAG,16,845187
dgoRp,7.25,31,3,CTAGGCCGGTTTGGTGCCAA,28,857553
dgoRp,4.5,20,3,CGTGGGAGGAACTGAGTTTC,17,848689
dgoRp,3.0,14,3,CGGGGATTAGTACGTGCTTC,11,859516
dgoRp,0.5,4,3,CGGATAGGGGGTAAAAGCAT,1,857311
dgoRp,3.25,15,3,CGCTAACCGTAACCTCAGCC,12,842716
dgoRp,3.0,14,3,CGCCCAAGCGCCGTAGTCTT,11,837232
dgoRp,6.25,27,3,CGATAGAATTTTTCTCACCT,24,849427
dgoRp,3.25,15,3,CGAGCATTCGACAGACACTC,12,855338
dgoRp,0.5,4,3,CCTTGGGATACAGCAAAATT,1,861438
dgoRp,3.5,16,3,CCTGTTCTATTCCGTATCCA,13,855305
dgoRp,1.0,6,3,CCTATATGAAGCGACCTGTT,3,848651
dgoRp,3.75,17,3,CCTAAAGGTAAGGCCAGGTG,14,847019
dgoRp,13.75,57,3,CCGTGTAGTGAGTTTGGCGA,54,846120
dgoRp,3.0,14,3,CCGTACTTCGAATGGGACTC,11,860947
dgoRp,10.25,43,3,CCGCGGACAAGGGCAATTTT,40,862328
dgoRp,0.5,4,3,CCGACTAGACCTTCATGCCA,1,847001
dgoRp,4.5,20,3,CCCTTAGAGAGAGCCACTCT,17,863588
dgoRp,2.75,13,3,CCCGGGATAGTCGCAGCATG,10,850867
dgoRp,8.25,35,3,CCCGGAGGTCGTGCTCTGCG,32,853521
dgoRp,5.0,22,3,CCCGATAACCAACCCCGCAA,19,865441
dgoRp,3.0,14,3,CCATCTCGCATTGAGGAGTT,11,838139
dgoRp,1.75,9,3,CCATCAACACTTACTGATGG,6,847573
dgoRp,1.75,9,3,CCAGTTGATGTCAACCAATG,6,863978
dgoRp,3.0,14,3,CCAGGAGCGCAAAGAAATGG,11,858107
dgoRp,3.75,17,3,CATTTACCACCTTCCCCTAC,14,862495
dgoRp,3.5,16,3,CATTGGTGTCTCGTACGTGG,13,858862
dgoRp,1.75,9,3,CATTCTGTCCTGGCCCGACC,6,843381
dgoRp,3.75,17,3,CATCAGAGTTTAGGAAGCGC,14,863054
dgoRp,1.75,9,3,CAGTTTCCGCTGGGCCTTAG,6,862566
dgoRp,1.0,6,3,CAGGGCGAGATAGTACATAG,3,840715
dgoRp,4.0,18,3,CAGAAAGTTGGTATCGCGCG,15,853248
dgoRp,3.25,15,3,CACGTCAGGACTGTCCCAAC,12,864837
dgoRp,14.75,61,3,CACGGTTGATCGACGATGAT,58,860548
dgoRp,2.75,13,3,CACGCAATTATCTTGAAAAA,10,836121
dgoRp,4.5,20,3,CACCTAGGAAAGCGCGGAGG,17,843429
dgoRp,6.0,26,3,CACCGCCCTACGTACACGTT,23,845522
dgoRp,5.0,22,3,CAATAGTACAATAGGAGACA,19,858243
dgoRp,2.75,13,3,ATTCTAGTTGCTTATTCCAT,10,850189
dgoRp,3.75,17,3,ATTCACAATCCGTGACCTAA,14,867333
dgoRp,0.5,4,3,ATTATAAGGGGTTTAACCCT,1,843158
dgoRp,5.25,23,3,ATGTGCCTGGGGCTTGTTCA,20,861197
dgoRp,0.75,5,3,ATCCGTACGGCCTAGGTTTT,2,838315
dgoRp,2.0,10,3,ATATTGAAGACGGTCGGCGT,7,845081
dgoRp,2.0,10,3,ATAGTGATCCGCGATGTTTC,7,858579
dgoRp,5.25,23,3,ATAATTTATGAACTATAGCA,20,865576
dgoRp,0.5,4,3,ATAATGTTCATGTGAAGGCC,1,847167
dgoRp,7.0,30,3,ATAAGTGGAAATTCAGTTTT,27,862097
dgoRp,3.75,17,3,AGTCTAGTTCTAGGGGTTAC,14,861198
dgoRp,4.5,20,3,AGGTGCCTAATGCCACAGGC,17,836497
dgoRp,3.25,15,3,AGATTAGGTATGAGAGGGTT,12,854413
dgoRp,0.5,4,3,AGACTAGCGCGAACTATGGC,1,836535
dgoRp,1.25,7,3,ACGCTCTATTTTAGAAAGAT,4,840165
dgoRp,4.5,20,3,ACATGCCCATTTACGCGCAT,17,844459
dgoRp,3.75,17,3,ACAGTAATCCATCTATTGAG,14,845461
dgoRp,7.75,33,3,ACACCTCAGAGAACCGTGAT,30,838125
dgoRp,6.5,28,3,AATGTTGTTGAGAACGCAGA,25,867247
dgoRp,6.25,27,3,AATAAAAGCCTCTTTTTGTC,24,846747
dgoRp,1.5,8,3,AAGGGTCGCGCCGGATGGCG,5,853702
dgoRp,1.25,7,3,AAGGGGCTTTTCTGGGCTAG,4,858635
dgoRp,5.75,25,3,AAGGGCCTGTGCAGGGTGAA,22,849366
dgoRp,5.75,25,3,AAGAGATACCGAGCATGGAT,22,844127
dgoRp,3.5,16,3,AACTTCGCGTGCAAACATAG,13,853751
dgoRp,4.25,19,3,AACCCGGGCCGGCCCTTTCT,16,840374
dgoRp,6.25,27,3,AAAACCGCCTGGCAATACGG,24,859663
dgoRp,3.3333333333333335,11,2,TTTTTTAATTTGGATTAAAC,9,842960
dgoRp,2.0,7,2,TTGGTTATCAATCATGTATA,5,843111
dgoRp,5.0,16,2,TTGGGGACCTAGTTTTCTTT,14,857235
dgoRp,5.333333333333333,17,2,TTCTCTTTCAGGGTACTGAC,15,843882
dgoRp,6.666666666666667,21,2,TTCCCGTTAAAATTTCTCGC,19,847161
dgoRp,9.0,28,2,TTCCCATGGCTCCATGTCAT,26,841692
dgoRp,0.6666666666666666,3,2,TTATGTTTCAGCGGTAGGCG,1,856682
dgoRp,1.0,4,2,TGTGACGAAGGTGGGGACAA,2,842713
dgoRp,1.6666666666666667,6,2,TGGTTGTTAGGGGTCAATGC,4,860656
dgoRp,1.3333333333333333,5,2,TGGTGGATCAAGCAATAGGT,3,859086
dgoRp,3.0,10,2,TGGCGTATATCAGGCAACAT,8,867200
dgoRp,6.333333333333333,20,2,TGGCCCCGTGCGAGGTTCGT,18,836434
dgoRp,1.6666666666666667,6,2,TGGATTGAAGTCTACAGGCA,4,865443
dgoRp,5.666666666666667,18,2,TGGATTAACTATTCTCCATC,16,838965
dgoRp,3.6666666666666665,12,2,TGCTTCCACGGTTTGTTAGA,10,836534
dgoRp,2.6666666666666665,9,2,TGACGAGTTATTTACAAGTA,7,846078
dgoRp,7.0,22,2,TGACCCAAGAACGTGAGGCA,20,866136
dgoRp,1.3333333333333333,5,2,TGACAGTGATGCTAGATAGT,3,836945
dgoRp,4.333333333333333,14,2,TCTTTTGAATGTATCGGTTC,12,854348
dgoRp,1.3333333333333333,5,2,TCTTATGCCCTCTTGCCAAC,3,843737
dgoRp,2.0,7,2,TCTCGTTGTGGTGCACTGTA,5,842599
dgoRp,3.6666666666666665,12,2,TCTAGTTCGGGCAACTATTC,10,859205
dgoRp,0.6666666666666666,3,2,TCTAGCCGAGGACCAGATCT,1,837619
dgoRp,0.6666666666666666,3,2,TCGCGGATGGACTGCAGATT,1,856849
dgoRp,1.6666666666666667,6,2,TCGCAATCCACTATCTCCGC,4,840245
dgoRp,9.333333333333334,29,2,TCCTTCTATTATTTCATTAG,27,850131
dgoRp,6.333333333333333,20,2,TCATCATGCTAGGAGAAGAT,18,844095
dgoRp,0.6666666666666666,3,2,TCAGAAGTGGTGAGATCACG,1,862057
dgoRp,5.666666666666667,18,2,TACGGTTGCGATTTATCTAT,16,863835
dgoRp,3.6666666666666665,12,2,TACACACTAGGCAAGACAAT,10,837562
dgoRp,6.666666666666667,21,2,TAATCTATCCATCGAAAAGC,19,857463
dgoRp,2.6666666666666665,9,2,TAAACGGTGGATATGGCTTG,7,867195
dgoRp,4.666666666666667,15,2,GTTTATGATCTTGCACACTC,13,842456
dgoRp,0.6666666666666666,3,2,GTCCCTCCGGCTTTTCTATA,1,853912
dgoRp,22.0,67,2,GTAACGCAAGGGATCTGTAA,65,846226
dgoRp,4.0,13,2,GGTTATCGCGACAACGGGTT,11,839099
dgoRp,9.666666666666666,30,2,GGTGTTGTTGTGAGATCTAA,28,845345
dgoRp,5.666666666666667,18,2,GGTGAGCATAGAACCGGCTC,16,844618
dgoRp,0.6666666666666666,3,2,GGTCACTTGACTGAGAGAAG,1,848225
dgoRp,2.3333333333333335,8,2,GGTAAGGTAGTGAGATTTCT,6,837259
dgoRp,0.6666666666666666,3,2,GGGTTATCCCATTAAAACGT,1,839567
dgoRp,2.0,7,2,GGGGGACAAAACCGTATATG,5,848911
dgoRp,8.333333333333334,26,2,GGGCTTGTCAATCAACCGGG,24,865898
dgoRp,6.0,19,2,GGGCACTGAAGCTTTTTCTC,17,840010
dgoRp,6.0,19,2,GGGATATCTAGGCTAGATTT,17,841491
dgoRp,1.0,4,2,GGGAATACCTCACCTCCTTT,2,836104
dgoRp,1.0,4,2,GGCTCTCGATGGGCCGCTCC,2,849061
dgoRp,4.333333333333333,14,2,GGCTCCTCAGATCCTCTTAA,12,843666
dgoRp,2.0,7,2,GGCGGTCGTAGAGCAGTTTT,5,855913
dgoRp,10.666666666666666,33,2,GGCGAAGCATGACTGACTAA,31,838738
dgoRp,4.333333333333333,14,2,GGCCCGCAAGGCTAGGTTCC,12,863801
dgoRp,4.0,13,2,GCTCGCATCTAGTCGCTTGC,11,836179
dgoRp,1.6666666666666667,6,2,GCGTCTCGGATACCAGAATG,4,867368
dgoRp,3.6666666666666665,12,2,GCGGCCACCTAGCCCCAATT,10,862327
dgoRp,8.666666666666666,27,2,GCGGCAACATGTCATTCGAG,25,852736
dgoRp,0.6666666666666666,3,2,GCCGTTGGGATGCACGGCAA,1,866622
dgoRp,2.3333333333333335,8,2,GCATTGCTCAAATACTCTCC,6,848066
dgoRp,3.6666666666666665,12,2,GCATCTGCTAGTAGCAAATA,10,844599
dgoRp,2.6666666666666665,9,2,GCATCCGAGAACAACCTTCA,7,839744
dgoRp,9.333333333333334,29,2,GATGATCAAGCTGGTCTCTA,27,841974
dgoRp,1.3333333333333333,5,2,GATACTGGGAACGCTTAAAT,3,859169
dgoRp,1.0,4,2,GAGTCCGTGGAGGTGTAGGA,2,859973
dgoRp,4.0,13,2,GAGCTTCAAAGTGTTCATTT,11,855915
dgoRp,6.0,19,2,GAGCATCTGGACCACAGACA,17,858890
dgoRp,3.6666666666666665,12,2,GACAAAACCCGTAGGTCGGC,10,862739
dgoRp,7.0,22,2,CTTGTGAAGGAGTCGGTGTT,20,862793
dgoRp,2.6666666666666665,9,2,CTTATGCATTATGAGAAGAA,7,859119
dgoRp,7.666666666666667,24,2,CTGTCTATGGAAAGGTAGAA,22,847090
dgoRp,4.0,13,2,CTGCGACGGGAATGCGGCAA,11,854982
dgoRp,11.0,34,2,CTGAGGCGTCTGAACATTCC,32,851822
dgoRp,0.6666666666666666,3,2,CTAAAGAAACGCTAGCGTCG,1,835850
dgoRp,1.3333333333333333,5,2,CGTCAAACTTCTGGTTATTA,3,845155
dgoRp,4.0,13,2,CGTATTACAGTGGCGTCCGA,11,852050
dgoRp,6.0,19,2,CGGTGCCTCGCCTACCCGGT,17,857604
dgoRp,4.333333333333333,14,2,CGGAGTAGCGCATATATCGC,12,846452
dgoRp,8.0,25,2,CGCTGAGGTCTGCCGGGTGA,23,851613
dgoRp,0.6666666666666666,3,2,CGCTCGATCTGGCCCTTCAC,1,848455
dgoRp,2.3333333333333335,8,2,CGCAGGGGACGGGAAAGGCT,6,837958
dgoRp,7.0,22,2,CGAGTCCCTTGCAGGTTCTT,20,842739
dgoRp,3.0,10,2,CGACGGCCCGATCCAGCCTA,8,841667
dgoRp,0.6666666666666666,3,2,CGACGATCAAGCCTGGCATC,1,850437
dgoRp,6.0,19,2,CGACCCTGCCCGAGGCCCCG,17,857880
dgoRp,2.0,7,2,CCTTAGACTTCACCACAACT,5,852922
dgoRp,0.6666666666666666,3,2,CCTGTCTCGTAGGATGATGT,1,858259
dgoRp,4.0,13,2,CCTGCGTCCTGTCTCAGGAG,11,859314
dgoRp,2.6666666666666665,9,2,CCGGGAAATCGGGACTGGCA,7,839973
dgoRp,4.666666666666667,15,2,CCCTCGTGAGCGAGGGACTG,13,840460
dgoRp,8.0,25,2,CCATATAGACCCAAGGTTAA,23,848050
dgoRp,7.333333333333333,23,2,CCATAAGTCCAAAGCAGAGG,21,844150
dgoRp,2.3333333333333335,8,2,CAGTCAATTACACAGGTTCC,6,857773
dgoRp,9.666666666666666,30,2,CAGTAAGTCGGGCTACAGTC,28,850891
dgoRp,1.0,4,2,CAGGTGACCCAGGGCTGTTA,2,847401
dgoRp,0.6666666666666666,3,2,CAGAACAAGGTTTACTATTA,1,848346
dgoRp,14.333333333333334,44,2,CACTTTTGCACGTCGGCTTA,42,857743
dgoRp,1.3333333333333333,5,2,CACAAGATCACGTAGTTGAC,3,865150
dgoRp,8.666666666666666,27,2,ATTTGAATTGGGACAATGGG,25,863618
dgoRp,4.0,13,2,ATTCTTGTTCACCAATGTCT,11,854719
dgoRp,3.6666666666666665,12,2,ATTAGTTCCCCTGGTAGTGA,10,865208
dgoRp,4.666666666666667,15,2,ATGGTGAGATCAGTGGTAGT,13,837742
dgoRp,3.3333333333333335,11,2,ATGGGTACAGGTGGTTCCTT,9,850644
dgoRp,6.0,19,2,ATGGGGTTGGGTACAGAAGT,17,851314
dgoRp,4.333333333333333,14,2,ATGATGGGCGTACGTCACTT,12,845424
dgoRp,1.0,4,2,ATGAACAGCGGCCCCCCCTT,2,836057
dgoRp,6.666666666666667,21,2,ATCTGTAGAGAGAGCTTAAA,19,842967
dgoRp,0.6666666666666666,3,2,ATATGTCATAAACCAAAGTA,1,867166
dgoRp,4.0,13,2,ATATCGTATTGGGGTCCCGT,11,842450
dgoRp,4.0,13,2,ATAACCACGGTCAAGGTTTC,11,845209
dgoRp,3.3333333333333335,11,2,ATAACAATGGCTGGTTAAGT,9,851040
dgoRp,3.0,10,2,AGGTGCCCTCTTTATTTGTT,8,840780
dgoRp,5.0,16,2,AGGGTACTCATATTATAAAT,14,864418
dgoRp,3.3333333333333335,11,2,AGGCATAATATCTGTTTGTA,9,860798
dgoRp,19.0,58,2,AGGATGATGAATACGGTAAG,56,867239
dgoRp,3.0,10,2,AGGAAAAGGTGCTAATGGGG,8,858082
dgoRp,1.3333333333333333,5,2,AGCAACCACCGACGCTATCT,3,857218
dgoRp,7.0,22,2,AGACTCTTGGGACAACCGCT,20,839359
dgoRp,5.0,16,2,ACTTGTCGCAGGGCCATCAT,14,837096
dgoRp,9.0,28,2,ACTGGCGCCAGGATATTTAT,26,844113
dgoRp,0.6666666666666666,3,2,ACTCACGCGGCGACAAAGCT,1,863362
dgoRp,5.666666666666667,18,2,ACTAGCCCGCAGACTGTCCC,16,840898
dgoRp,3.3333333333333335,11,2,ACTACGGTGTTGTATGTACA,9,838460
dgoRp,0.6666666666666666,3,2,ACGTACGGCCCGCATCTATG,1,838361
dgoRp,6.333333333333333,20,2,ACGATATATGATAGGTTGCT,18,863797
dgoRp,11.333333333333334,35,2,ACGAAGCGGCCGAACATACC,33,859137
dgoRp,3.3333333333333335,11,2,ACCTCCGTGTATGTCACATT,9,846124
dgoRp,2.6666666666666665,9,2,ACCGGCTTGGGTCACTTTCT,7,846246
dgoRp,2.6666666666666665,9,2,ACCACTTAGCAAACATATGA,7,850114
dgoRp,6.333333333333333,20,2,ACCACGATCAACGCGATTAA,18,840430
dgoRp,12.333333333333334,38,2,AATCTAGCATTGCGATATGA,36,864231
dgoRp,1.6666666666666667,6,2,AATAAATTTTGTTAAGCTAC,4,857886
dgoRp,11.333333333333334,35,2,AAGTCGTGTCTTAACGAGTC,33,863905
dgoRp,5.0,16,2,AAGGTGTAAACTCGCATGCG,14,836708
dgoRp,5.666666666666667,18,2,AAGCACAGCGTCTACGTCTC,16,863385
dgoRp,2.6666666666666665,9,2,AACTCCGTGTTTAGGGCTGG,7,838874
dgoRp,6.0,19,2,AACCCTGCGCCATACTCCGG,17,848853
dgoRp,13.666666666666666,42,2,AAATCTGCAACGGTGGTCCG,40,864417
dgoRp,5.0,16,2,AAACCTGTCTGCTTTTGAAA,14,847786
dgoRp,1.0,2,1,TTTGTCGTGGGTTCTGGGAA,1,867409
dgoRp,1.5,3,1,TTTGAGTTCACACGGTATAG,2,849159
dgoRp,5.5,11,1,TTTAATCACTCGGCCGCTCT,10,852535
dgoRp,5.5,11,1,TTGTCCCTAGGGTCGTGCTA,10,857488
dgoRp,10.0,20,1,TTGGGCAGCTCACCACCAGT,19,863943
dgoRp,1.0,2,1,TTGCGGGTGGCGGGTTGTCA,1,851296
dgoRp,10.0,20,1,TTGAGCGCAGATCGAACCGC,19,837967
dgoRp,2.0,4,1,TTCTGAGAGTTCGGAGCGAT,3,863175
dgoRp,12.0,24,1,TTCTCAGCAGAGTTCTTAAG,23,837663
dgoRp,12.5,25,1,TTCGGGTAGGGCGAGTGTAC,24,863881
dgoRp,8.5,17,1,TTAGAAGCCATCCACGCTGG,16,844540
dgoRp,5.5,11,1,TGTTTCATTGTCGCTTAATA,10,856527
dgoRp,4.5,9,1,TGTGTTCGCTATATACAACT,8,849635
dgoRp,8.0,16,1,TGTATGACGACCGGTAGGAG,15,866880
dgoRp,1.0,2,1,TGTAGCTTTTCAAATATCCC,1,865822
dgoRp,7.0,14,1,TGGTCGCGAGGTACGGGGTC,13,864178
dgoRp,8.0,16,1,TGCTTCTAGAGAGATCGAAC,15,863190
dgoRp,3.0,6,1,TGCTGAGTCCATCGGGCACG,5,844897
dgoRp,2.5,5,1,TGCCTGCTGTGAGCGCGCTT,4,858801
dgoRp,1.0,2,1,TGCAGGCGATAACGTTTAAT,1,856059
dgoRp,7.0,14,1,TGATAATATCTCAGTCTTAG,13,841157
dgoRp,13.5,27,1,TGAAGTACGCCGGGATCCGA,26,836232
dgoRp,4.0,8,1,TCGGCTAGTGGAGTTAGTCC,7,839375
dgoRp,7.0,14,1,TCCCTAGGCCTATTGATTTG,13,852198
dgoRp,1.0,2,1,TCACTCGCTCGGGTTCCGTA,1,860265
dgoRp,6.0,12,1,TCACGTGGTAGCATAATCTA,11,854141
dgoRp,7.0,14,1,TCACCGACCACGTGGCACTA,13,857345
dgoRp,4.5,9,1,TCAAATCGCACCGTTACAAC,8,841023
dgoRp,1.0,2,1,TATTGTGGCAGGTGGCAGAA,1,840850
dgoRp,9.5,19,1,TATGGTCAGGGCACCTGGAC,18,860299
dgoRp,5.5,11,1,TAGCAACCAATGCCGTAGTT,10,852400
dgoRp,2.0,4,1,TACGTGTCACAATCTGACAA,3,843781
dgoRp,3.5,7,1,TACGGCTACCTCTGAACATC,6,850065
dgoRp,4.5,9,1,TACGCGCGCGAAGGGGTACA,8,859450
dgoRp,9.0,18,1,TAAGTATCGGAAAAAGCGAA,17,859467
dgoRp,8.0,16,1,GTTTGCGCGTTGCCTGGAGA,15,849364
dgoRp,10.0,20,1,GTGAGAGCCCGCCACAAGTG,19,838425
dgoRp,1.0,2,1,GTCATCGCGAAAAAGGTGCC,1,836537
dgoRp,3.5,7,1,GTACGGATATTGTGCCGGCT,6,841644
dgoRp,7.5,15,1,GGTTTGAATTCTTGCTTCCT,14,845572
dgoRp,8.0,16,1,GGTGCCTTTACAATCAAAAT,15,841710
dgoRp,6.0,12,1,GGGTACTCACATCATCCTCA,11,848737
dgoRp,1.0,2,1,GGGATCATATAGGTCAGAGG,1,846760
dgoRp,8.0,16,1,GGCTTAAGAATGTACCTCTT,15,866600
dgoRp,3.5,7,1,GGCTAGGACTGCTCATCATT,6,843399
dgoRp,28.5,57,1,GGATTCCGACTTTCGAGCAA,56,865021
dgoRp,3.5,7,1,GCTCCGCTCTAGATTTCTAG,6,860045
dgoRp,11.0,22,1,GCGCTCCGGCTGAATCTCCG,21,839505
dgoRp,2.5,5,1,GCGATCCGACAGGGCGCCTC,4,863566
dgoRp,18.0,36,1,GCCATCAGGCTTGTGTCTGG,35,843982
dgoRp,4.5,9,1,GCCATCAAGCATCGAGAGCA,8,841806
dgoRp,3.5,7,1,GCATGCAGTTTGTATCCCGT,6,845910
dgoRp,6.0,12,1,GCAGGGTTGGAATAGCGGAT,11,860491
dgoRp,21.0,42,1,GCAGGAGCGGATTTCGGGTC,41,859466
dgoRp,3.0,6,1,GCAGCGGTTTGCAGGGAAGT,5,863459
dgoRp,13.0,26,1,GCACGTAACATTTCCGGTGC,25,841357
dgoRp,8.0,16,1,GATATGCGTTACGGATTAGG,15,836161
dgoRp,9.5,19,1,GAGCTAGGCTGCGGCAGGAG,18,865656
dgoRp,12.0,24,1,GAGAAGGCGATGAAATGTAA,23,850583
dgoRp,8.5,17,1,GACGCCAGGAAATACCCCTC,16,864232
dgoRp,3.5,7,1,GACCCGAATCCACACTAAGC,6,859123
dgoRp,10.0,20,1,GAAAATGCCATAAGCTGACA,19,867435
dgoRp,8.0,16,1,GAAAAGCGTCTACCCTGCAG,15,866348
dgoRp,15.0,30,1,CTTTGACATGCCGACGCAGA,29,842619
dgoRp,19.5,39,1,CTTCTCACGACTACACTGGT,38,846567
dgoRp,6.5,13,1,CTGGAGATGCCGCATCACTG,12,865349
dgoRp,1.0,2,1,CTGCACTAGCTACGGTAAAC,1,845206
dgoRp,6.5,13,1,CTCTTTTTTACTAACCTGCC,12,865162
dgoRp,6.5,13,1,CTCGTTATACGAGAGTTAAA,12,852745
dgoRp,4.5,9,1,CTATGTTAACGACGCCAGCA,8,837284
dgoRp,21.5,43,1,CGTCTTTAGTAATTTAGAAA,42,857754
dgoRp,2.0,4,1,CGTATGCGTCGGTCCAAATG,3,844128
dgoRp,8.0,16,1,CGGATGTCTTGTGTTCGGTA,15,861842
dgoRp,10.0,20,1,CGGATATGAAGCATGGTCGC,19,844134
dgoRp,2.0,4,1,CGGAGCCACCATCATGGGAA,3,844640
dgoRp,4.5,9,1,CGGAATTTGGCTTGCACCCC,8,848122
dgoRp,6.0,12,1,CGCTGACCGATCTTTGTGCT,11,865894
dgoRp,11.5,23,1,CGCAGCTTTTTGTGGACGGA,22,847142
dgoRp,1.0,2,1,CGAGGCCAGCGTCAAATCCT,1,856337
dgoRp,1.0,2,1,CCTTCCAAGGGTGAATTAGT,1,862986
dgoRp,5.0,10,1,CCTGCCCGACCAACAGAACG,9,861575
dgoRp,20.5,41,1,CCTGCATCGTATGGCCGTCA,40,846744
dgoRp,1.5,3,1,CCGACACTGCTGGTTGGCAT,2,864429
dgoRp,1.0,2,1,CCCTGTGGCTCATGAGCTTA,1,865342
dgoRp,1.5,3,1,CCATTTTATAGATGGGTTTA,2,861774
dgoRp,9.5,19,1,CCAGAGCCCTCTATCACCAT,18,855877
dgoRp,8.5,17,1,CATTGGGGCAGCACGTTTCA,16,859517
dgoRp,16.5,33,1,CATCATTCGTAGGGAAACGT,32,852383
dgoRp,3.0,6,1,CATACGCAACCAGCCGGCGG,5,853050
dgoRp,2.5,5,1,CAGTTGCGATTCATGTTTAT,4,860810
dgoRp,6.0,12,1,CAGTGCTCCTGCTTCCGGTC,11,847182
dgoRp,3.0,6,1,CAGGAGTGAGTACCTGCAAG,5,838259
dgoRp,9.5,19,1,CAGCGGGCGAAGCTGCAGAT,18,855546
dgoRp,8.0,16,1,CAGATAGCTATAGGGAGGTG,15,862567
dgoRp,4.5,9,1,CAGAGGAGTGATTTAAACAG,8,852363
dgoRp,9.0,18,1,CAGACGGCCGACATCAGCAT,17,865763
dgoRp,10.0,20,1,CACTGCACTGTTCTTCTGCA,19,844760
dgoRp,5.0,10,1,CACCGACAGAATGCGTTTTC,9,848479
dgoRp,8.0,16,1,CACATCCGTCGCGCATACCC,15,856781
dgoRp,2.5,5,1,CAATTTTTGTCCACGGTTCT,4,845611
dgoRp,2.5,5,1,CAAGGGCTGAACTTACATCT,4,856637
dgoRp,1.0,2,1,CAACGGTCGGATCAAAACAA,1,837558
dgoRp,5.0,10,1,CAAACGCTCCCTACCGGTTT,9,861238
dgoRp,1.5,3,1,ATTTTAGGGAATATAGGGTC,2,840244
dgoRp,10.0,20,1,ATTCGAAACGGCCTACTCGG,19,843677
dgoRp,1.0,2,1,ATGGTTCAGTATGGGAGAAC,1,859229
dgoRp,6.5,13,1,ATGGTCTCACAGATCGGTGC,12,852650
dgoRp,5.0,10,1,ATGGGCGGAACCAGTTGCTC,9,857482
dgoRp,10.5,21,1,ATGCTGTGCCTGGCGGCGGG,20,861609
dgoRp,4.0,8,1,ATGCGAAAGCTTGGCGCGAG,7,846517
dgoRp,15.5,31,1,ATGATCCGCTTAAATGCCCA,30,859163
dgoRp,2.0,4,1,ATGATATTTGGGGTGCCACT,3,851268
dgoRp,2.0,4,1,ATCGGGTTCAAGAGTAGGGA,3,848821
dgoRp,13.5,27,1,ATCACCAACTTTACCTGAGT,26,849406
dgoRp,23.5,47,1,ATAACAAAAGCGAATCATTT,46,847039
dgoRp,33.0,66,1,AGGTACTATCAGGCGGCCGC,65,846218
dgoRp,6.0,12,1,AGCCTCCGATCCGACTGTAA,11,855896
dgoRp,26.0,52,1,AGCCCAGTATCGATCCTGTA,51,858616
dgoRp,4.0,8,1,AGATGAGCGCAGCGAGCTGC,7,845054
dgoRp,4.0,8,1,AGATCGGTCCTAAAAGAGTT,7,848629
dgoRp,4.5,9,1,AGACGAATTTCTCCACAACT,8,851161
dgoRp,6.5,13,1,ACTTTGGTTATGACTGGGTG,12,842696
dgoRp,11.5,23,1,ACTCATAGAGGACGGCTGAA,22,862799
dgoRp,8.5,17,1,ACTCACACGTTGCGTCACCA,16,864191
dgoRp,14.5,29,1,ACGACGCAGACGGTGTCTCT,28,850108
dgoRp,1.0,2,1,ACCTCGAGTGAAGAGTCTCA,1,863829
dgoRp,5.5,11,1,ACCTCCGTAGGCATTCTTCC,10,867271
dgoRp,55.5,111,1,ACCCGACTGCGAATCACGCC,110,846219
dgoRp,1.0,2,1,ACACACCAGCCAGAGCCGGC,1,853289
dgoRp,7.0,14,1,ACAAATCCACGGTCGCTCCA,13,847583
dgoRp,11.0,22,1,AATTAGGGTGCAGCTAACTC,21,841484
dgoRp,6.5,13,1,AATTAAGATTCACTAGATAT,12,838389
dgoRp,7.5,15,1,AATCGCAACTGAAATTTTTG,14,861779
dgoRp,26.0,52,1,AATAGTTAGCACTGATCGAG,51,854484
dgoRp,4.0,8,1,AATAGTTAGAAGAGTCTTCC,7,844099
dgoRp,10.0,20,1,AATACAGTCTAAGGCCTACG,19,844901
dgoRp,13.0,26,1,AACTAATTCAAATTGTCGAA,25,850817
dgoRp,8.5,17,1,AACGGGCTCATCAACTGCAT,16,856092
dgoRp,12.0,24,1,AACCGTTTGGGGTCACGTAG,23,857815
dgoRp,25.5,51,1,AAAGCTCGTTATCAATCTGT,50,848683
dgoRp,0.013513513513513514,73,73,TGGCGTAGTCGCATTTCTAT,0,836291
dgoRp,0.013513513513513514,73,73,GGCCGTATCTCTTTGCGCAT,0,841612
dgoRp,0.014285714285714285,69,69,AGTGCCCTTGACTTAACTGT,0,846321
dgoRp,0.014925373134328358,66,66,GCCCAGGTCTAGAGCTAAGA,0,838830
dgoRp,0.015625,63,63,TAATATTTGGGTAGTCTGGT,0,835836
dgoRp,0.016666666666666666,59,59,GAGAAAGCCTCAACATGTTC,0,849022
dgoRp,0.016666666666666666,59,59,GAAGAACAACCCAGGTTTGT,0,844172
dgoRp,0.017241379310344827,57,57,ATCGTTACAGATCGGTGTGT,0,847295
dgoRp,0.017857142857142856,55,55,CTACATACGATTGACCGGAG,0,857961
dgoRp,0.017857142857142856,55,55,ACGTTGTCGTAGTCCGTGGT,0,861428
dgoRp,0.018518518518518517,53,53,GGCCAATCCTGCTCGTGCGA,0,857659
dgoRp,0.018518518518518517,53,53,CGGTACAATGACGAAGTCAG,0,848022
dgoRp,0.019230769230769232,51,51,GGGACGATCTCAGTTTGGTA,0,846786
dgoRp,0.0196078431372549,50,50,TAACATTCTGAGCGAATCCT,0,848249
dgoRp,0.02,49,49,TACGCGAACAGCAACGGGAG,0,860393
dgoRp,0.02,49,49,CATAAACTTTGCTCAGGAAG,0,843802
dgoRp,0.02,49,49,AAGTTCTGACGCCACAGGGA,0,840865
dgoRp,0.020833333333333332,47,47,CTCTATCATGAAGGGTTTGC,0,838494
dgoRp,0.020833333333333332,47,47,CGGCCGGTGACTCTATGCTA,0,866579
dgoRp,0.020833333333333332,47,47,CGAAATTGCGTCTGGCATAC,0,861637
dgoRp,0.020833333333333332,47,47,CACAGCGCCCTCTCGTGGGT,0,838134
dgoRp,0.02127659574468085,46,46,GGGATCTATAAGCAGATACT,0,857541
dgoRp,0.02127659574468085,46,46,GGATACATTACGAGTGTTCG,0,840894
dgoRp,0.021739130434782608,45,45,GACCTTGTTCTCGGAAATCC,0,837030
dgoRp,0.021739130434782608,45,45,CTGCTGAGTCGCGACTACTT,0,849098
dgoRp,0.021739130434782608,45,45,CATTACGTCGTAGGTAGTAG,0,854189
dgoRp,0.022222222222222223,44,44,TTGGAGCAGACCCGTTTCTG,0,854084
dgoRp,0.022222222222222223,44,44,CACCATAGTACGTTGAGACT,0,845335
dgoRp,0.022727272727272728,43,43,TTGAACATGGTAAGGTTTGA,0,857485
dgoRp,0.022727272727272728,43,43,GGTTATTCCTAAATCGCACA,0,855533
dgoRp,0.022727272727272728,43,43,ACTATATCGGAGGGTATTAA,0,836489
dgoRp,0.022727272727272728,43,43,ACGTAGTTTAGTGCGAGGCA,0,839115
dgoRp,0.023255813953488372,42,42,TATCCCCACTATGTAGGATA,0,862897
dgoRp,0.023255813953488372,42,42,GTTTGTGCGTCATTGATCGA,0,843366
dgoRp,0.023255813953488372,42,42,CGCGAGGCGAAGGTCACGCA,0,861624
dgoRp,0.023255813953488372,42,42,ATCCATATCCTCTGTTGATT,0,845643
dgoRp,0.023255813953488372,42,42,ACATCCGCGTCTGGAGGCAT,0,847727
dgoRp,0.023809523809523808,41,41,TCCCCTGTCGTTTGCACCAC,0,840302
dgoRp,0.023809523809523808,41,41,CTAGCGTATCAGGCTACGCA,0,860133
dgoRp,0.024390243902439025,40,40,GCAGTACTCCATGTCCGGCG,0,848294
dgoRp,0.024390243902439025,40,40,GAGCTCCATATAAGTCGGGT,0,846075
dgoRp,0.024390243902439025,40,40,ACGGAATCCGGACTAGCTTT,0,855770
dgoRp,0.024390243902439025,40,40,ACCTTCAAGAGCCCGTAAAT,0,855885
dgoRp,0.025,39,39,TCGGCGGCACTATGAGTTTG,0,847603
dgoRp,0.025,39,39,CTCCATTCGACGTTGCATGT,0,850809
dgoRp,0.025,39,39,CCGAATGGGGTCACCGCAGA,0,849823
dgoRp,0.025,39,39,ATCCGGGGTCCCCCCACGTT,0,867261
dgoRp,0.025,39,39,AGGCGGGTTCGGGCGTCTTA,0,851012
dgoRp,0.025,39,39,AGCTGTTGGAAGCATCTTGT,0,850985
dgoRp,0.025,39,39,AGAGAACAGGCCCTGAATAT,0,849825
dgoRp,0.025,39,39,AAAGGCTCATGCGAAAATAT,0,859728
dgoRp,0.02564102564102564,38,38,TTGGATAAGTTCTAGAGTAC,0,856924
dgoRp,0.02564102564102564,38,38,TGAGATGTGTAAGCATGCGA,0,858888
dgoRp,0.02564102564102564,38,38,GCTCACAGAGACAACCCTAT,0,849737
dgoRp,0.02564102564102564,38,38,GATAGAGCTAGATGGGTCCC,0,838717
dgoRp,0.02564102564102564,38,38,CGCCTTTCAAAAGCTCATGC,0,851217
dgoRp,0.02564102564102564,38,38,CCGGGAGCTTTATGACGGAT,0,855000
dgoRp,0.02564102564102564,38,38,AGCAGGCACCTTTGTTAGCA,0,850694
dgoRp,0.02631578947368421,37,37,TTCGCAAGCACTTTAAGGTC,0,836876
dgoRp,0.02631578947368421,37,37,CTCGGTCATCTCTGTCGTAC,0,854766
dgoRp,0.02631578947368421,37,37,CGTTGGGGCTCACGTCTTCG,0,854107
dgoRp,0.02631578947368421,37,37,ATCTGTGAAGACCAGCCAAA,0,841380
dgoRp,0.02631578947368421,37,37,ATCGTTCTGTGTAGAGAGAT,0,850024
dgoRp,0.02631578947368421,37,37,ATAGATGAGTTTTTGGTCTT,0,837027
dgoRp,0.02702702702702703,36,36,TTGGAAGGCATTCGCGGGTT,0,846873
dgoRp,0.02702702702702703,36,36,TCCTGGGACTCAGATTGATT,0,853153
dgoRp,0.02702702702702703,36,36,GTGTGCGTTAGCGCTGCTAC,0,850352
dgoRp,0.02702702702702703,36,36,AGAGGTAAATGTCGCGTGTC,0,837682
dgoRp,0.02702702702702703,36,36,ACCAGAACAAACCGTTGTGG,0,842343
dgoRp,0.027777777777777776,35,35,TTGTAAGATCCTCCCTACTA,0,861697
dgoRp,0.027777777777777776,35,35,TACTCCGTCTATTCATAGAA,0,836419
dgoRp,0.027777777777777776,35,35,GATCGACCCGCGTTAAGCTA,0,840707
dgoRp,0.027777777777777776,35,35,CCGTCGTATAAGAGGCACTG,0,840498
dgoRp,0.027777777777777776,35,35,ATACTTGTTGATGGACCATT,0,862924
dgoRp,0.02857142857142857,34,34,TCGGCGTGCAACCCGAATGG,0,837549
dgoRp,0.02857142857142857,34,34,TCAACCACTGGACACCTCTC,0,838376
dgoRp,0.02857142857142857,34,34,GGAACTGTGCGCATCGAGTT,0,851674
dgoRp,0.02857142857142857,34,34,CTAACCGAATCGACTAAATG,0,840085
dgoRp,0.02857142857142857,34,34,CGTTGGGCGCAATCTTATAG,0,837543
dgoRp,0.02857142857142857,34,34,CATACTTCTATGGAGATAAT,0,860862
dgoRp,0.02857142857142857,34,34,CACGCCCCGTATGTCCCTCG,0,856137
dgoRp,0.02857142857142857,34,34,ATTGGGCACAGAAAACCCGG,0,845666
dgoRp,0.02857142857142857,34,34,ACAGCTGCGCGTTTCTCTAT,0,847876
dgoRp,0.029411764705882353,33,33,TGAGGCATGGTTTATCAGGT,0,841874
dgoRp,0.029411764705882353,33,33,TCGTCTTGAGAGGCGTTTGT,0,854586
dgoRp,0.029411764705882353,33,33,TACATCCTGTGCCTTGGGGT,0,849060
dgoRp,0.029411764705882353,33,33,GTGCCCCCTCAAAGCCCGTG,0,842995
dgoRp,0.029411764705882353,33,33,GTATACTAATAGGATGGTGG,0,861562
dgoRp,0.029411764705882353,33,33,GGGGGTAGTTAACACTTGGT,0,836374
dgoRp,0.029411764705882353,33,33,GGCGTGTGACGCTGGTCCCT,0,858436
dgoRp,0.029411764705882353,33,33,GGAGAATGAATTCATGTTCA,0,851769
dgoRp,0.029411764705882353,33,33,GCCCTTAGTACGATAAGGAA,0,838381
dgoRp,0.029411764705882353,33,33,GATATGAGATTCACATTCAT,0,858393
dgoRp,0.029411764705882353,33,33,CGTGTCTTCAAACTAAAAGG,0,859674
dgoRp,0.029411764705882353,33,33,CAGTCAGTTCTATGGAACAG,0,843480
dgoRp,0.029411764705882353,33,33,CAGAAAGATTCAACTCAAGT,0,856099
dgoRp,0.029411764705882353,33,33,CACATAGGTGCAATATGCAG,0,854131
dgoRp,0.029411764705882353,33,33,CAATAGAGTCCTCGACAGTG,0,848854
dgoRp,0.029411764705882353,33,33,ACATCAACGCGTCCTTGTAA,0,839548
dgoRp,0.029411764705882353,33,33,AATTCAGCATGGGATTTTCC,0,861316
dgoRp,0.030303030303030304,32,32,TTGATGACCGTGGCCTTGAA,0,855771
dgoRp,0.030303030303030304,32,32,TTCCAATGTATCTTAGGGAC,0,861802
dgoRp,0.030303030303030304,32,32,TGTTGGTAAGCGAGTGATGC,0,861968
dgoRp,0.030303030303030304,32,32,TGTAGTTGGTGCTGAACTTT,0,854646
dgoRp,0.030303030303030304,32,32,TCGAGATGCGTCGAGAAGTG,0,839010
dgoRp,0.030303030303030304,32,32,TCAGGCGGGAATTGACGAAA,0,839561
dgoRp,0.030303030303030304,32,32,GTACAAGTGACAGAACCTAT,0,838173
dgoRp,0.030303030303030304,32,32,GCGATTGGCACTCTAGGCCG,0,842630
dgoRp,0.030303030303030304,32,32,GAGTCTTCCCTGTAAATTAG,0,836201
dgoRp,0.030303030303030304,32,32,GAGGCGGGTGGTTGAGCGTG,0,841638
dgoRp,0.030303030303030304,32,32,CTACTCCGGCTATCTCGTTC,0,849160
dgoRp,0.030303030303030304,32,32,CGGAGGCGCCTTCATCCAGA,0,838255
dgoRp,0.030303030303030304,32,32,CGGACGGAGATTCAGACGCA,0,850574
dgoRp,0.030303030303030304,32,32,CCCACCTCCACGCCGCCACA,0,851058
dgoRp,0.030303030303030304,32,32,ATGCAGTGAAACAGCTCAGA,0,860188
dgoRp,0.030303030303030304,32,32,ATCGGCACAATGACCCTACT,0,843919
dgoRp,0.030303030303030304,32,32,ATAAAAGTGCCCGGTCACGC,0,837946
dgoRp,0.030303030303030304,32,32,ACCGACGTGCCCGTGGTGAA,0,859372
dgoRp,0.030303030303030304,32,32,AAACTGTTATCGGTGTACGG,0,842726
dgoRp,0.03125,31,31,TTGAGGCCGAGCTTGCGAAT,0,855369
dgoRp,0.03125,31,31,TTCAGAGCCGGGTGGGAGAC,0,837159
dgoRp,0.03125,31,31,TGCAAAGTCAGTTTGGACCT,0,848007
dgoRp,0.03125,31,31,TCGATGAAAATTAAGCTCAG,0,855540
dgoRp,0.03125,31,31,TACAAGGCTGTACATTTGCG,0,849024
dgoRp,0.03125,31,31,TAAGGCCGGCGCGCAATCAG,0,865412
dgoRp,0.03125,31,31,TAAACACGCCACGTGACCGT,0,866674
dgoRp,0.03125,31,31,GGCCCGCACTCGCGGCTAGG,0,849749
dgoRp,0.03125,31,31,CAGGTCGTTTTGTAAAGAAG,0,850531
dgoRp,0.03125,31,31,CACCAGCCAGTCCTACGGAA,0,862534
dgoRp,0.03125,31,31,ATTAACTTATGTCGAAACAT,0,841693
dgoRp,0.03125,31,31,AGTTCCTAATCTAGGCTTTT,0,864307
dgoRp,0.03125,31,31,AGGCAGCGAAGTAGCTGGTG,0,863200
dgoRp,0.03225806451612903,30,30,TTGTTCCGGATCGTGGAATG,0,837308
dgoRp,0.03225806451612903,30,30,TTCGGCTGGTGAGACGGTTT,0,839927
dgoRp,0.03225806451612903,30,30,TTCAATATATTAATGGTTCC,0,848471
dgoRp,0.03225806451612903,30,30,TTACGAAGGGTAAACCTTCT,0,836293
dgoRp,0.03225806451612903,30,30,TGTAGGCTGAAGCTTACATT,0,843090
dgoRp,0.03225806451612903,30,30,TGGTCGCAGTAGGCGCTCAG,0,853259
dgoRp,0.03225806451612903,30,30,TGCCAGGCTGTTCCGGGCCG,0,852867
dgoRp,0.03225806451612903,30,30,TCTCTACTATTCCCGTGCTA,0,836361
dgoRp,0.03225806451612903,30,30,TCATCACATGAACGGGCGGG,0,852555
dgoRp,0.03225806451612903,30,30,GGTGCGCCAATGCACCTCAA,0,865408
dgoRp,0.03225806451612903,30,30,GGAGCCCCCTAGGGAGGGAG,0,838643
dgoRp,0.03225806451612903,30,30,GATGACGGGCCTTGGTGGTC,0,860827
dgoRp,0.03225806451612903,30,30,GATCGGATACGCGGCCAGCC,0,860207
dgoRp,0.03225806451612903,30,30,GAGAGGAGATCGATGAACGG,0,843794
dgoRp,0.03225806451612903,30,30,CTTAACAGTCCCGTTTGGTT,0,847972
dgoRp,0.03225806451612903,30,30,CGGCCAAATCAGCGCATTGC,0,858964
dgoRp,0.03225806451612903,30,30,CCCTTAGAGCCGCATTCAGT,0,840801
dgoRp,0.03225806451612903,30,30,CCCCCCGGAGTTCATTTCGG,0,867081
dgoRp,0.03225806451612903,30,30,CCAAACCACACTACCAGTGT,0,863652
dgoRp,0.03225806451612903,30,30,CAGCCTCGTAGAAGGCGATT,0,835994
dgoRp,0.03225806451612903,30,30,CAATCCGCTTCGTACAATCA,0,866320
dgoRp,0.03225806451612903,30,30,AGGTAAATACGGGTCCCTCT,0,841934
dgoRp,0.03225806451612903,30,30,AAGGCTGCGTGCCGCGGCAA,0,858313
dgoRp,0.03333333333333333,29,29,TTAGAATATTACTCTAGATA,0,860858
dgoRp,0.03333333333333333,29,29,TCTTTTTACACTGTTCAGAA,0,845382
dgoRp,0.03333333333333333,29,29,TCGTTTCGCGTCTCTAAGCC,0,861831
dgoRp,0.03333333333333333,29,29,TCGTCTATTGTTACTATAAA,0,842852
dgoRp,0.03333333333333333,29,29,TAGATTGGCGTTATTTACCG,0,835972
dgoRp,0.03333333333333333,29,29,GTGGAGGTAGCGACAGTTGC,0,848018
dgoRp,0.03333333333333333,29,29,GGGGTATACAAGGTGTGATG,0,847276
dgoRp,0.03333333333333333,29,29,GACAAAGGGAGAGACTAGAT,0,851843
dgoRp,0.03333333333333333,29,29,CTGGCGCCCCGCGTTCATTG,0,864101
dgoRp,0.03333333333333333,29,29,CGCGAACTTTAGAAAGGGTT,0,836439
dgoRp,0.03333333333333333,29,29,ACTTACACTCGGAAGTGCGC,0,861994
dgoRp,0.03333333333333333,29,29,ACGGGTCGCTCCAATGAGTA,0,861885
dgoRp,0.03333333333333333,29,29,ACCACAACGGGCCATATCAT,0,854486
dgoRp,0.034482758620689655,28,28,TTTTCAGTATATAACGCCAA,0,847580
dgoRp,0.034482758620689655,28,28,TTACTTCTGCCGATTAACAA,0,840593
dgoRp,0.034482758620689655,28,28,TCCTGGGGTCCTATTCTACG,0,844789
dgoRp,0.034482758620689655,28,28,TCAATTGCCCTTCATTAAAA,0,857700
dgoRp,0.034482758620689655,28,28,TACATGACTTGAGTTGGCTA,0,848243
dgoRp,0.034482758620689655,28,28,GGGGGGGTGTCCTCACCATA,0,861935
dgoRp,0.034482758620689655,28,28,GGGAGAACACTCTCTAATGA,0,850696
dgoRp,0.034482758620689655,28,28,GGCATACTATAAACATACAC,0,855615
dgoRp,0.034482758620689655,28,28,GCGGGAGAGAGCAAGCGATC,0,853152
dgoRp,0.034482758620689655,28,28,GCAGATCCAGATACCAACAT,0,845509
dgoRp,0.034482758620689655,28,28,CTGTGTTGTTCTCAGGTGTG,0,844698
dgoRp,0.034482758620689655,28,28,CTGTCCACCGCCTGTTCCAG,0,859877
dgoRp,0.034482758620689655,28,28,CGTGAGAATGTGCTGGATGA,0,862403
dgoRp,0.034482758620689655,28,28,CGCTCCAAAAGAAGGTGGAC,0,847953
dgoRp,0.034482758620689655,28,28,CGCCTTGACGAGAGGCTGAT,0,850505
dgoRp,0.034482758620689655,28,28,CCTACACCGCGGACGGGGAA,0,849174
dgoRp,0.034482758620689655,28,28,CCGTCTTACTGCACTGGTGA,0,851044
dgoRp,0.034482758620689655,28,28,CAACGACAGTCATCCCTGTA,0,854430
dgoRp,0.034482758620689655,28,28,ATGCGAAACGTTTTTGCTGC,0,856944
dgoRp,0.034482758620689655,28,28,AGATCCGATCCTACACGAAT,0,849105
dgoRp,0.034482758620689655,28,28,ACCTTGGCCGATCGAGAATG,0,845017
dgoRp,0.034482758620689655,28,28,ACCGTAACTTTCCGTCATAA,0,848993
dgoRp,0.034482758620689655,28,28,ACATATAGTTTTGAGCGTAA,0,841455
dgoRp,0.034482758620689655,28,28,AACCGTTTTTGTTAATACCA,0,844455
dgoRp,0.03571428571428571,27,27,TTGATATATCTAGCGCCCGG,0,847862
dgoRp,0.03571428571428571,27,27,TTAACGTTGTTTTGTTGTAG,0,842914
dgoRp,0.03571428571428571,27,27,TGTGGTAACGGGCAGCCCAA,0,859941
dgoRp,0.03571428571428571,27,27,TGTGCTGCGGCGGCTGGAGA,0,845699
dgoRp,0.03571428571428571,27,27,TCTGTATAAAGCTCGCCATA,0,848636
dgoRp,0.03571428571428571,27,27,TCGGAAGTTCGGTACCCACA,0,866636
dgoRp,0.03571428571428571,27,27,TACGGACAGTTTGTCGAAAG,0,856632
dgoRp,0.03571428571428571,27,27,TACGAGCTATAGAACTAGAA,0,862821
dgoRp,0.03571428571428571,27,27,TAACGCGAACCACATTGTTA,0,850615
dgoRp,0.03571428571428571,27,27,GTCACTTGACCGGCCAACGC,0,849224
dgoRp,0.03571428571428571,27,27,GTAGCACTTGAGCGACCGTG,0,850924
dgoRp,0.03571428571428571,27,27,GCGGTTATCGACCGGACAAT,0,836950
dgoRp,0.03571428571428571,27,27,GCCGTTCAGGGATCGACCTA,0,843885
dgoRp,0.03571428571428571,27,27,GATCGGCTGAGCACGTTAAC,0,865873
dgoRp,0.03571428571428571,27,27,GACGCACCGTATTTCAATAA,0,837026
dgoRp,0.03571428571428571,27,27,GAACCTTTCCACCGAAATTT,0,838926
dgoRp,0.03571428571428571,27,27,CGGGTGATGCGAAGCGTGAA,0,841242
dgoRp,0.03571428571428571,27,27,CGAGTCAGTGACCCCCGGGG,0,843864
dgoRp,0.03571428571428571,27,27,CGAGAGTTGATTGTTAGAGT,0,855532
dgoRp,0.03571428571428571,27,27,CCGTGGGAGTAGTCTTTTAC,0,847165
dgoRp,0.03571428571428571,27,27,CCGGCCGGCACCGGGGTTCT,0,843022
dgoRp,0.03571428571428571,27,27,CAGACTCTAGGCGTCCGGTC,0,849768
dgoRp,0.03571428571428571,27,27,ATCCGCACGGGCAGATGAAT,0,844982
dgoRp,0.03571428571428571,27,27,ATACCACTCTGCTACGCTGA,0,841639
dgoRp,0.03571428571428571,27,27,AGTTCCATGCCATCGAATCT,0,844644
dgoRp,0.03571428571428571,27,27,AGCAGAACTCGCTGTCCGTG,0,837364
dgoRp,0.03571428571428571,27,27,AGATTGGGGGCCACTTCGGA,0,849025
dgoRp,0.03571428571428571,27,27,ACGCGGTATCCAGTTGTCTC,0,856285
dgoRp,0.03571428571428571,27,27,ACATCGAGTTCTGAGTTACA,0,844598
dgoRp,0.037037037037037035,26,26,TTCAAGTACCCACTGCCGGC,0,858871
dgoRp,0.037037037037037035,26,26,TGTCAGATTAGTGCTGTATC,0,851067
dgoRp,0.037037037037037035,26,26,TGGTATCCCCAAGTGTTCTT,0,863880
dgoRp,0.037037037037037035,26,26,TGGGCAGCGTCGAAAGCCAT,0,839984
dgoRp,0.037037037037037035,26,26,GTTGAATCGATGCCTAGCCT,0,844371
dgoRp,0.037037037037037035,26,26,GTGGCTGACACAGGGATTCC,0,854750
dgoRp,0.037037037037037035,26,26,GGTGCCGGCCTTACAGCGAA,0,857182
dgoRp,0.037037037037037035,26,26,GGCTAGTTTCACCCTTAGAC,0,850702
dgoRp,0.037037037037037035,26,26,GGAGGGAAGTCGATCCAGGC,0,842097
dgoRp,0.037037037037037035,26,26,GCTCGTTTCCGCTAGTGAAT,0,859976
dgoRp,0.037037037037037035,26,26,GCAGGTGACGTTTCATTAGG,0,845459
dgoRp,0.037037037037037035,26,26,CTGCGTGCATGCCTAATGAC,0,844739
dgoRp,0.037037037037037035,26,26,CTAAATATTAAGTCCCGGTC,0,842257
dgoRp,0.037037037037037035,26,26,CGTCTTCCGTCACGCCTACT,0,843808
dgoRp,0.037037037037037035,26,26,CCTACCGCTCCCAAAACTTT,0,846969
dgoRp,0.037037037037037035,26,26,CCGAAAGGGTCTGGAACTCT,0,852152
dgoRp,0.037037037037037035,26,26,CCCATGCGCGGTATTATCAG,0,848234
dgoRp,0.037037037037037035,26,26,CAGATCACGACTGGGTAGAT,0,841618
dgoRp,0.037037037037037035,26,26,CACGTGCCCCACCTGGACCT,0,863986
dgoRp,0.037037037037037035,26,26,CAAGAACTGTGGTTACACAT,0,841784
dgoRp,0.037037037037037035,26,26,ATCAACTGGGGCCCCGCGGA,0,846028
dgoRp,0.037037037037037035,26,26,ATAGAGATGGCGGTTACGTT,0,835843
dgoRp,0.037037037037037035,26,26,AGTTCCATTGTACAGGGCTA,0,839591
dgoRp,0.037037037037037035,26,26,AGGTAGTAGTTTTTGGTAAT,0,839288
dgoRp,0.037037037037037035,26,26,AGCGGAACATCACTAGGCAT,0,845588
dgoRp,0.037037037037037035,26,26,AGCGCTTAGTGAAGGACTGC,0,850207
dgoRp,0.037037037037037035,26,26,ACGTATCTATCCGCGCAGAG,0,841572
dgoRp,0.037037037037037035,26,26,ACGGGTTGTCACGTATTTGT,0,852612
dgoRp,0.037037037037037035,26,26,ACCATTGGACACCAGAAGAG,0,837213
dgoRp,0.037037037037037035,26,26,ACAGATAGGCTCGCGCCCCT,0,851461
dgoRp,0.037037037037037035,26,26,AAAGAGGAACCAATAGCTAA,0,856242
dgoRp,0.038461538461538464,25,25,TTTCCATCCTGGCGGCAGCG,0,836455
dgoRp,0.038461538461538464,25,25,TTAGCTCCATGGAAGAGGTT,0,838363
dgoRp,0.038461538461538464,25,25,TGTATGGGTCTTCTGCAGAA,0,853832
dgoRp,0.038461538461538464,25,25,TGGTCTCCTGAAGACTATCG,0,853091
dgoRp,0.038461538461538464,25,25,TGCAGGGCGCGATAGACTTG,0,837744
dgoRp,0.038461538461538464,25,25,TGAGGCGGGCGGCTTTAAGT,0,847278
dgoRp,0.038461538461538464,25,25,TCCTGCGGTGTGCTATTGTT,0,848153
dgoRp,0.038461538461538464,25,25,TATTGGACTTTAGCTAGGTT,0,866293
dgoRp,0.038461538461538464,25,25,TATGCTTCCCTCGCTCATAT,0,853496
dgoRp,0.038461538461538464,25,25,TACACAGAGGTGCAGTTCAT,0,846972
dgoRp,0.038461538461538464,25,25,TAAGGGATGGCGGAACGGAC,0,855552
dgoRp,0.038461538461538464,25,25,GTTTACAAATTTATGGTTCC,0,852063
dgoRp,0.038461538461538464,25,25,GGTCGTTGGAATGCAGGAAT,0,855797
dgoRp,0.038461538461538464,25,25,GGTACCAAATAGGGAATAAA,0,865113
dgoRp,0.038461538461538464,25,25,GGCACTCGCACGGAGTCTGC,0,864468
dgoRp,0.038461538461538464,25,25,GCCTTAGGTGGGGGAAAGGA,0,853774
dgoRp,0.038461538461538464,25,25,CTTGCTTGCCAGAGCCATAC,0,836500
dgoRp,0.038461538461538464,25,25,CTCATCCCCGGGTGTTCTGT,0,837948
dgoRp,0.038461538461538464,25,25,CTAATAGACTAAGACCAACA,0,844170
dgoRp,0.038461538461538464,25,25,CGGGCACGAGCGAGACCACG,0,839312
dgoRp,0.038461538461538464,25,25,CGGCACGGTGCAATTGTTAC,0,853828
dgoRp,0.038461538461538464,25,25,CGCCTCCGAGCAATTTGAAT,0,847445
dgoRp,0.038461538461538464,25,25,CCGCGTCCGATGGGTGGGAC,0,837450
dgoRp,0.038461538461538464,25,25,CCGAGTACAGGCACATCCTC,0,839498
dgoRp,0.038461538461538464,25,25,CCATTCTTTCTTAGTACTGG,0,837453
dgoRp,0.038461538461538464,25,25,CCACAACGGGGGCCAGACCT,0,862291
dgoRp,0.038461538461538464,25,25,CAGCGTCTGCTCTCATGGCA,0,850690
dgoRp,0.038461538461538464,25,25,CACTCGAATTAGGGCAGTAA,0,845571
dgoRp,0.038461538461538464,25,25,CACATGCATAGTTGTAAGGA,0,836689
dgoRp,0.038461538461538464,25,25,ATAGTCTCAACACAGCACCT,0,862220
dgoRp,0.038461538461538464,25,25,AGTGGAGCATCGTCGCTTTC,0,855712
dgoRp,0.038461538461538464,25,25,AGTCACCCCGTCGCTTACGC,0,844896
dgoRp,0.038461538461538464,25,25,AGGCTGGGAGTTAAGTACCA,0,851157
dgoRp,0.038461538461538464,25,25,AGCATCTAGGCCCTCCCTTG,0,849210
dgoRp,0.038461538461538464,25,25,ACGATGCCCTCGAACCTAGC,0,853875
dgoRp,0.038461538461538464,25,25,AAGTGGGTTAACCTCCCGTG,0,858006
dgoRp,0.038461538461538464,25,25,AAGTGCCTGGTAGAGTGACA,0,840344
dgoRp,0.038461538461538464,25,25,AAGGACTCCCTAGAAATAAT,0,840739
dgoRp,0.038461538461538464,25,25,AAGAACAAAAGTGTGTATTC,0,850972
dgoRp,0.038461538461538464,25,25,AACGATAGTCAAGGGTACAC,0,837219
dgoRp,0.038461538461538464,25,25,AAACATTTAGGGGGTACGCT,0,848795
dgoRp,0.04,24,24,TTGCTGTACGCCGACCGGAA,0,859560
dgoRp,0.04,24,24,TGTGAGACGGTTATAGTGGC,0,845558
dgoRp,0.04,24,24,TGTCCATCATTCAGTGCAAC,0,854821
dgoRp,0.04,24,24,TCCTTCAGACCTACGTCGTG,0,860296
dgoRp,0.04,24,24,TCCTGCGTGGTATATGGGAT,0,853046
dgoRp,0.04,24,24,TCATGCTACCGTAGGTAAAA,0,836363
dgoRp,0.04,24,24,TATCGGCCAAAGTGCGTCTT,0,838314
dgoRp,0.04,24,24,GGCGTGGTGGAGGGCTCCTC,0,866594
dgoRp,0.04,24,24,GACTAAAGTCCGTGTGAATT,0,863172
dgoRp,0.04,24,24,GAAATTTATAGGCAACCGGC,0,858855
dgoRp,0.04,24,24,CTGCGTCGTCCGTGCCCCAC,0,845434
dgoRp,0.04,24,24,CTCGCTTATGCTTCAAAATG,0,860320
dgoRp,0.04,24,24,CTCCCGAGTTAGGAACGCAA,0,855094
dgoRp,0.04,24,24,CTAGCATTCTCGGCTTGAAT,0,860351
dgoRp,0.04,24,24,CGCATAGATTTCGGAAACTG,0,845147
dgoRp,0.04,24,24,CCCGCCATCAATAAAGCATT,0,848601
dgoRp,0.04,24,24,CATGATGTGTAGCCTGCGTA,0,853304
dgoRp,0.04,24,24,CAGCTAGGGGAGTTTCTAAA,0,847058
dgoRp,0.04,24,24,CAGCATCCACAGATTGGGGT,0,843103
dgoRp,0.04,24,24,CAACATGTACACTGTGATGA,0,866150
dgoRp,0.04,24,24,ATACATGCACATTGAAACCA,0,839980
dgoRp,0.04,24,24,ATAAGCGTCAGGGCGGAACA,0,857357
dgoRp,0.04,24,24,AGTTGCCTCACAGTTCAACC,0,853002
dgoRp,0.04,24,24,AGGTATGGTCTTCGGTACAG,0,843971
dgoRp,0.04,24,24,AGCGTTAACCGAAGCATTTT,0,845956
dgoRp,0.04,24,24,AGATCCGTTATTTCTACAGG,0,837898
dgoRp,0.04,24,24,AGATACACCGTGATACATAC,0,864922
dgoRp,0.04,24,24,AGAACACTGCATCCTCCGTC,0,856659
dgoRp,0.04,24,24,ACTTGCTCAAGGCTCTGTTC,0,856636
dgoRp,0.04,24,24,ACTCGGATATTGCCTGTCTC,0,847548
dgoRp,0.04,24,24,ACGTAAGATCGGGCAATTTA,0,844522
dgoRp,0.04,24,24,ACGATCACGCCTTTGAGTCA,0,866718
dgoRp,0.04,24,24,AAAATGGCCACAGCAGCACG,0,853263
dgoRp,0.041666666666666664,23,23,TTCTGACCTAAGGCGAGGCT,0,850280
dgoRp,0.041666666666666664,23,23,TTAAATGGGTACGCACTAAG,0,862789
dgoRp,0.041666666666666664,23,23,TGTGCTCTTCGGGGAGCAGC,0,866654
dgoRp,0.041666666666666664,23,23,TGCCGGCTCACGCGGGTGCC,0,849848
dgoRp,0.041666666666666664,23,23,TGCAGGCCACCGGTTCCGAT,0,849154
dgoRp,0.041666666666666664,23,23,TGAGGAGCCACTCATGCACA,0,862709
dgoRp,0.041666666666666664,23,23,TGACTGTCCCCTTAGACCCG,0,848349
dgoRp,0.041666666666666664,23,23,TCTTACCTTTCGGCCAAAGA,0,845176
dgoRp,0.041666666666666664,23,23,TCTATTTGCCCTGTACGTAT,0,842588
dgoRp,0.041666666666666664,23,23,TCCAGGTATGGTGTGGTCAT,0,845446
dgoRp,0.041666666666666664,23,23,TCCAGCCGGGCTGCTCCCTG,0,850227
dgoRp,0.041666666666666664,23,23,GTTGGAAATACTGGAAGAGA,0,847744
dgoRp,0.041666666666666664,23,23,GTGGTCATCCACGTTGAGCA,0,838578
dgoRp,0.041666666666666664,23,23,GTGGAGGAGAATATTGGGGT,0,852825
dgoRp,0.041666666666666664,23,23,GGGGCGCCGGTATCTTACAG,0,859431
dgoRp,0.041666666666666664,23,23,GGGCGCTGGTCGAAGTGTCT,0,861225
dgoRp,0.041666666666666664,23,23,GCTGTGTTCTATCAGAGGAA,0,849979
dgoRp,0.041666666666666664,23,23,GCGATGCACGCGGTCGCCCT,0,856388
dgoRp,0.041666666666666664,23,23,GATAGGTCTTAAAATGAGCA,0,838175
dgoRp,0.041666666666666664,23,23,GACTAATATATGGAGAGTTC,0,842784
dgoRp,0.041666666666666664,23,23,CTTTAAACTACTAGCACGCT,0,855001
dgoRp,0.041666666666666664,23,23,CTGTCATAGGGTCGGAGATG,0,846187
dgoRp,0.041666666666666664,23,23,CTGTAGTGTTAAAAGTAACT,0,842068
dgoRp,0.041666666666666664,23,23,CTCTGTCATTCTCTGGATCA,0,855181
dgoRp,0.041666666666666664,23,23,CTAACGCGTCCCGGTAGAGA,0,838668
dgoRp,0.041666666666666664,23,23,CGTCCAAGCGATTAAGTCAC,0,837870
dgoRp,0.041666666666666664,23,23,CCGGCGCCGGCCAGGATATT,0,845418
dgoRp,0.041666666666666664,23,23,CCAGATAAGGCAACAGTGGT,0,860617
dgoRp,0.041666666666666664,23,23,CCACTTCACATCCAAGAGCA,0,843038
dgoRp,0.041666666666666664,23,23,CATGGGGACGCAGGCTTCGA,0,845460
dgoRp,0.041666666666666664,23,23,CAGTGACTGTCGAGGGCCTA,0,843717
dgoRp,0.041666666666666664,23,23,ATCTATGGGACTTCCGGCAA,0,854321
dgoRp,0.041666666666666664,23,23,ATAGGAGTGTAGAGACAGCA,0,862164
dgoRp,0.041666666666666664,23,23,AGCCACTGGTGGTACTAGCT,0,859678
dgoRp,0.041666666666666664,23,23,AGCAGGATTGAACGCTCGTT,0,843578
dgoRp,0.041666666666666664,23,23,AGATGTGGGACGTGAGAATC,0,859374
dgoRp,0.041666666666666664,23,23,ACTGGGGTATTGTAGCTCAC,0,864754
dgoRp,0.041666666666666664,23,23,ACTATCGTTAAGGAATAAGA,0,835855
dgoRp,0.041666666666666664,23,23,AAGCAACGGCTCTGAAAGCG,0,855270
dgoRp,0.041666666666666664,23,23,AAAGCTCAGCAATTGTCATG,0,861242
dgoRp,0.043478260869565216,22,22,TTAATTGAGTCTGATCTATT,0,851323
dgoRp,0.043478260869565216,22,22,TGGGGAACAATGCGAGTTTG,0,850861
dgoRp,0.043478260869565216,22,22,TCTCGCACCTGTCCTGGACA,0,854925
dgoRp,0.043478260869565216,22,22,TATTAGCGGCGGCATTGTGA,0,860113
dgoRp,0.043478260869565216,22,22,TATGGCACCGGCAGCGCGCG,0,854869
dgoRp,0.043478260869565216,22,22,TATGAGGGGGTGAATCGAAT,0,851886
dgoRp,0.043478260869565216,22,22,TAGCTACTTTCTCAGAAACA,0,849951
dgoRp,0.043478260869565216,22,22,TAGAAAAAAGGGTGATGGGA,0,852752
dgoRp,0.043478260869565216,22,22,TAAATGAGTTACAGGATGAA,0,855602
dgoRp,0.043478260869565216,22,22,GTTGCGACTCAGTTTGTTAT,0,850321
dgoRp,0.043478260869565216,22,22,GTTAGTTGAAACTTCGTATG,0,843098
dgoRp,0.043478260869565216,22,22,GTCTAGGTCATACACTAGGG,0,851665
dgoRp,0.043478260869565216,22,22,GGTGGGTGTAGCAAGAAGCA,0,847301
dgoRp,0.043478260869565216,22,22,GGGACCTGTCAAAGGTGATG,0,864177
dgoRp,0.043478260869565216,22,22,GGCGCGTCGTTCACCCACGA,0,839658
dgoRp,0.043478260869565216,22,22,GGAGTCGGAAATATGCGCGG,0,847088
dgoRp,0.043478260869565216,22,22,GGAGTCCCATGACCCGGCTT,0,840766
dgoRp,0.043478260869565216,22,22,GCTGGTTTAACGCTATGAAT,0,855164
dgoRp,0.043478260869565216,22,22,GCTGGTACAGCGGATCTCGA,0,865227
dgoRp,0.043478260869565216,22,22,GCTGGGTTTCCGATCGCAAG,0,853073
dgoRp,0.043478260869565216,22,22,GCTGGGGGATCCGACATTTA,0,845909
dgoRp,0.043478260869565216,22,22,GCAAAATCGTGGCTTCTCGG,0,840132
dgoRp,0.043478260869565216,22,22,GATTAGGATTCGAGCATGAC,0,848513
dgoRp,0.043478260869565216,22,22,GAACTCGTCAGGGCTCATGA,0,863813
dgoRp,0.043478260869565216,22,22,CTTGTACACAGACCTTGTCC,0,840139
dgoRp,0.043478260869565216,22,22,CTGCATCGGGGCGCAAGGAT,0,861456
dgoRp,0.043478260869565216,22,22,CTCCTCGTGTGGACAGGACC,0,847353
dgoRp,0.043478260869565216,22,22,CTCAAAGGCATCACTCGCAT,0,859426
dgoRp,0.043478260869565216,22,22,CTAGCACTTATCGTCATACG,0,851467
dgoRp,0.043478260869565216,22,22,CGTTCAGCACCCGCAGTTTG,0,844515
dgoRp,0.043478260869565216,22,22,CGGTTGGAGACTAAGATTGA,0,860192
dgoRp,0.043478260869565216,22,22,CCTGGTAATACCAATTCGTC,0,857360
dgoRp,0.043478260869565216,22,22,CCTGGCAGAGGGGACTCGGT,0,853934
dgoRp,0.043478260869565216,22,22,CCGGTCTCACCATGTTACGA,0,838281
dgoRp,0.043478260869565216,22,22,CCCTATAACAAAGACGGAAA,0,850385
dgoRp,0.043478260869565216,22,22,CATGGCGTTAGCTAATCTGC,0,848470
dgoRp,0.043478260869565216,22,22,CATCCGAAGTAAACCGTCAA,0,862545
dgoRp,0.043478260869565216,22,22,CAGGGATCCTACAAAAACCC,0,842678
dgoRp,0.043478260869565216,22,22,CAGGCGACTGGAACCTTCCA,0,854998
dgoRp,0.043478260869565216,22,22,CAAGCTAGACTCGCGCTGAC,0,848515
dgoRp,0.043478260869565216,22,22,ATTCGGCTCGATTGTGATCA,0,862982
dgoRp,0.043478260869565216,22,22,ATCTTTCACTGTTGTGTCCT,0,837379
dgoRp,0.043478260869565216,22,22,ATCCATATCAGTTGACTCTA,0,839993
dgoRp,0.043478260869565216,22,22,AGTTAGGTACTCATGTGAAG,0,860231
dgoRp,0.043478260869565216,22,22,AGGTTCTCTCTCTGCCTTAG,0,855051
dgoRp,0.043478260869565216,22,22,ACTCTCCGATTGTGGGTCGT,0,856098
dgoRp,0.043478260869565216,22,22,AATGTCGGGTAAATAAAACG,0,852619
dgoRp,0.043478260869565216,22,22,AATGAAAACCCTTCTACCGA,0,861286
dgoRp,0.043478260869565216,22,22,AAGAGCCCACCTCACATATT,0,861031
dgoRp,0.043478260869565216,22,22,AACCACAGAGCGCGCCCGCG,0,836248
dgoRp,0.043478260869565216,22,22,AAAGCCTTGCGACGCTTATC,0,839337
dgoRp,0.043478260869565216,22,22,AAAACTGCAAAACCGCTGTT,0,843255
dgoRp,0.045454545454545456,21,21,TTTCAGGTACCCTCGGCAGA,0,854192
dgoRp,0.045454545454545456,21,21,TTGGGGCACGTACAGTCATC,0,867094
dgoRp,0.045454545454545456,21,21,TTATCGACAAAGCTTAGTTA,0,855792
dgoRp,0.045454545454545456,21,21,TGGGGAGAGTAGGACATCAG,0,856177
dgoRp,0.045454545454545456,21,21,TGCTCACGTGGGTGTTCGTC,0,850413
dgoRp,0.045454545454545456,21,21,TGCGCGGAATTAGACTACTT,0,863525
dgoRp,0.045454545454545456,21,21,TCTCTTGTGTTTCTCTGGAG,0,864327
dgoRp,0.045454545454545456,21,21,TCTCAGTAAGCTGTTCAGAA,0,851710
dgoRp,0.045454545454545456,21,21,TCGTTTGCCGCGGATATTGG,0,847293
dgoRp,0.045454545454545456,21,21,TATCCCTAGGCATTCTCCGG,0,853422
dgoRp,0.045454545454545456,21,21,TAGAGATTGTTGATTTTTTA,0,846982
dgoRp,0.045454545454545456,21,21,GTTTGTGCGAACAAAGCTAT,0,846138
dgoRp,0.045454545454545456,21,21,GTTTAGCATCTCCCGGAACC,0,837781
dgoRp,0.045454545454545456,21,21,GTGCGTGTCAGTCTGTCCTC,0,838997
dgoRp,0.045454545454545456,21,21,GTGCGGGGCTCTACAGTGTT,0,847188
dgoRp,0.045454545454545456,21,21,GTCTGCTGGGGCGGTTAATT,0,866046
dgoRp,0.045454545454545456,21,21,GTCCTGTCTTCGGCCTTTAA,0,844972
dgoRp,0.045454545454545456,21,21,GGTGGATCATAGCGGCCTTG,0,857411
dgoRp,0.045454545454545456,21,21,GCCTACCCGGCCATATCCCC,0,844965
dgoRp,0.045454545454545456,21,21,GAGTTGGAAGTGTGAACCTG,0,851904
dgoRp,0.045454545454545456,21,21,GAGAGGGCAAGTCCTGTAAG,0,851866
dgoRp,0.045454545454545456,21,21,GAATTTAGGCGCTGCACGCA,0,840136
dgoRp,0.045454545454545456,21,21,GAAGTTTGCACCCGGCGAGG,0,838955
dgoRp,0.045454545454545456,21,21,CTGACGTCAGTAGTATACGA,0,847801
dgoRp,0.045454545454545456,21,21,CTAAAACTAGACGCGTTTCA,0,836983
dgoRp,0.045454545454545456,21,21,CGTTTTAGGCCGCGTAGCTA,0,847504
dgoRp,0.045454545454545456,21,21,CGGTTAGTGCTCGGACACGT,0,862037
dgoRp,0.045454545454545456,21,21,CGACACAGACGCATTGTCGT,0,853778
dgoRp,0.045454545454545456,21,21,CCTTGCATATGGATAGGTCG,0,861378
dgoRp,0.045454545454545456,21,21,CCTGTGAGCAGGGTTGGTTA,0,859058
dgoRp,0.045454545454545456,21,21,CCTGTAGCGCGACTTAAGGG,0,839889
dgoRp,0.045454545454545456,21,21,CCTCGAAAGCCATGGCCTAG,0,864836
dgoRp,0.045454545454545456,21,21,CCCCGATATTTGGTCCCAGA,0,838632
dgoRp,0.045454545454545456,21,21,CAGATGTTTATGCCCCCGCG,0,854314
dgoRp,0.045454545454545456,21,21,CACGAAGTGAGATAAGGGTA,0,842187
dgoRp,0.045454545454545456,21,21,CACATTTATGTTAGAGCCAG,0,864827
dgoRp,0.045454545454545456,21,21,CAAGCGGATCACCTGGAAAA,0,863248
dgoRp,0.045454545454545456,21,21,ATATATATTTGGGGCGTCCA,0,849543
dgoRp,0.045454545454545456,21,21,AGTTGTTTTCGGTTTGTTTG,0,857888
dgoRp,0.045454545454545456,21,21,AGCTGAGTGAAATTCCTTAC,0,841700
dgoRp,0.045454545454545456,21,21,AGATTGCGCCGCACGATAAG,0,836020
dgoRp,0.045454545454545456,21,21,AGAGCCGCTGCCTTCGGCCC,0,839948
dgoRp,0.045454545454545456,21,21,ACACAGGTCAGGCATCGGTG,0,854293
dgoRp,0.045454545454545456,21,21,AAGTCCCAAGCACCTGTCAG,0,854260
dgoRp,0.045454545454545456,21,21,AAGGGAATGCGACCCTGCAG,0,858457
dgoRp,0.045454545454545456,21,21,AAACTATTGATCACAGGCAA,0,855981
dgoRp,0.047619047619047616,20,20,TTTCGTTTGAATAGTCCTGC,0,847194
dgoRp,0.047619047619047616,20,20,TTTCACAGATTGAATTGTTG,0,844659
dgoRp,0.047619047619047616,20,20,TTTATCAGTAGTACATCCCA,0,854867
dgoRp,0.047619047619047616,20,20,TTCAAGATTCTGGATACTAC,0,857638
dgoRp,0.047619047619047616,20,20,TTACAATAGGACAAACTACT,0,854422
dgoRp,0.047619047619047616,20,20,TGGTCGTCTCGCGTAAAATA,0,848494
dgoRp,0.047619047619047616,20,20,TGCTTCCCCCGCTGTTAATT,0,844560
dgoRp,0.047619047619047616,20,20,TGCTCGGTACCCTCGAATCA,0,839893
dgoRp,0.047619047619047616,20,20,TCTTATCTCTAAAGCAGGGT,0,859621
dgoRp,0.047619047619047616,20,20,TCGCAGCGATGCCAGAGGCA,0,846375
dgoRp,0.047619047619047616,20,20,TCCTAAAAGTGGGACAAAGA,0,850306
dgoRp,0.047619047619047616,20,20,TCACATCAATGAGAGTGAAG,0,848118
dgoRp,0.047619047619047616,20,20,TAGCGGCTGATGGCTATAAT,0,839084
dgoRp,0.047619047619047616,20,20,GTTCGGAAGAATTGCGAGAG,0,851242
dgoRp,0.047619047619047616,20,20,GTAGTACAGTCCTTGGTTCG,0,860773
dgoRp,0.047619047619047616,20,20,GGGCAATAGGGCGGGTTGAT,0,849301
dgoRp,0.047619047619047616,20,20,GGGAGCTCACACAAGTGTCT,0,847143
dgoRp,0.047619047619047616,20,20,GGCTGCCTCCTCAAACTCTC,0,858389
dgoRp,0.047619047619047616,20,20,GGCGTCGTGCGCGTTTAGGA,0,854700
dgoRp,0.047619047619047616,20,20,GGATTCGTACCAAATCCGGA,0,836942
dgoRp,0.047619047619047616,20,20,GCTCATGCTGTATACCAAGA,0,838320
dgoRp,0.047619047619047616,20,20,GCCTTCGGCAAGCAGGATAT,0,850323
dgoRp,0.047619047619047616,20,20,GCCGGTCAGAACGCCACCAT,0,839387
dgoRp,0.047619047619047616,20,20,GATCACGGGGCACCGATGTA,0,837576
dgoRp,0.047619047619047616,20,20,GATAGGCCTGCCATAGCCTT,0,843168
dgoRp,0.047619047619047616,20,20,GAGCGAACGCGTTTTCCAGC,0,850162
dgoRp,0.047619047619047616,20,20,GACTGGAGGTACCTCGTGTT,0,842197
dgoRp,0.047619047619047616,20,20,CTTTCTGGTTTGGCATGTAT,0,847911
dgoRp,0.047619047619047616,20,20,CTTCACCTAGTACATATGCA,0,857818
dgoRp,0.047619047619047616,20,20,CTTAACCCCTTATTCGGTTC,0,853940
dgoRp,0.047619047619047616,20,20,CTGTTCGAGTCTATTCGAGA,0,862500
dgoRp,0.047619047619047616,20,20,CTCGGGTTTGATTTAAAATT,0,864265
dgoRp,0.047619047619047616,20,20,CTAGTTCGTGGAAGTATCTA,0,866410
dgoRp,0.047619047619047616,20,20,CGTGGGGTACCTGATCAGCT,0,865699
dgoRp,0.047619047619047616,20,20,CGGCATTTCAACAGCATCCG,0,855063
dgoRp,0.047619047619047616,20,20,CGCGAATCTTGGCATCCGAA,0,838671
dgoRp,0.047619047619047616,20,20,CGCATTCAGGGGCACTCAAA,0,843722
dgoRp,0.047619047619047616,20,20,CCTCTCTGAGCAAAAGAGAG,0,851706
dgoRp,0.047619047619047616,20,20,CCTAGACTATGCACCGAACA,0,863045
dgoRp,0.047619047619047616,20,20,CCGGTTCATGCTACCCACCC,0,847891
dgoRp,0.047619047619047616,20,20,CAACCGAAACAATCCGGGCA,0,864782
dgoRp,0.047619047619047616,20,20,ATTGGTTTGTACAAACACCA,0,846468
dgoRp,0.047619047619047616,20,20,ATTAGCGGATCATTTAAGAC,0,860284
dgoRp,0.047619047619047616,20,20,ATGCTCTGTAGCACATACCA,0,838646
dgoRp,0.047619047619047616,20,20,ATCATCGGATGCTCAACCCG,0,844993
dgoRp,0.047619047619047616,20,20,ATACATCACAGATTAAGGGT,0,849940
dgoRp,0.047619047619047616,20,20,AGGGTTTGAGACAGGTAAAG,0,850988
dgoRp,0.047619047619047616,20,20,ACTCTATGTGTTAGCGGTGG,0,855651
dgoRp,0.047619047619047616,20,20,ACTCGCAAGCGCCAGTCTCT,0,843877
dgoRp,0.047619047619047616,20,20,ACCGGGACCGACTTGTCACC,0,842628
dgoRp,0.047619047619047616,20,20,ACAAGCGCTTAGAAAATTAA,0,851925
dgoRp,0.047619047619047616,20,20,AATGCGTACTTCCATATCGC,0,861162
dgoRp,0.047619047619047616,20,20,AATCAACTCGAAAGGTAATT,0,852376
dgoRp,0.047619047619047616,20,20,AAGTAAGGCACTCACCGCAA,0,837295
dgoRp,0.047619047619047616,20,20,AACCCGGCCGCGGATCTGCC,0,849226
dgoRp,0.047619047619047616,20,20,AAATTGAGGATGCCTGTTGA,0,853824
dgoRp,0.05,19,19,TTTTGCCACTACCATCTTCT,0,861340
dgoRp,0.05,19,19,TTTGTTGGGGGCACCACGGA,0,836593
dgoRp,0.05,19,19,TTTGTATAGCGGAGCGGGGT,0,864951
dgoRp,0.05,19,19,TTGTCCACCCGTGAAGTGTG,0,839767
dgoRp,0.05,19,19,TTGTACAAACATCCCGGGCA,0,843432
dgoRp,0.05,19,19,TTGGAACGGTGGCCGCCATG,0,857582
dgoRp,0.05,19,19,TGTACATGATACTCGCAGTA,0,840897
dgoRp,0.05,19,19,TGGGCAGTAGTTAAGCGCAT,0,858471
dgoRp,0.05,19,19,TGGGATACGGAGTCCACACT,0,864609
dgoRp,0.05,19,19,TGACTGTATAAATCGGGCCA,0,857578
dgoRp,0.05,19,19,TGACGAATGAGTTAGAAACG,0,865674
dgoRp,0.05,19,19,TCGTCCTTTTGTCCATGGAT,0,860160
dgoRp,0.05,19,19,TCGGCCACCAAAAACAGGTG,0,851860
dgoRp,0.05,19,19,TCACAAGGGACCTACCAACT,0,843654
dgoRp,0.05,19,19,TAAGGGCGTCGTAGTTCGTA,0,851325
dgoRp,0.05,19,19,GTTCAGTTTACTCCGCTATA,0,839455
dgoRp,0.05,19,19,GTGCGTACCACGTCATGTCT,0,860344
dgoRp,0.05,19,19,GTGCGGAGACTGTAGCACGA,0,837220
dgoRp,0.05,19,19,GTCGCCCCGGGACTACGCCA,0,866962
dgoRp,0.05,19,19,GTCATGTCCGGCGTGAAAAT,0,853477
dgoRp,0.05,19,19,GTCATGCGTCTCGGCACAGT,0,862132
dgoRp,0.05,19,19,GTATAACGGAGCTTAACATA,0,852336
dgoRp,0.05,19,19,GGCAGCATTTCAACTTTTGA,0,860456
dgoRp,0.05,19,19,GGCAAAATGGCGGTCTTATA,0,844851
dgoRp,0.05,19,19,GCATGTCGGATAAAGAGTCA,0,854740
dgoRp,0.05,19,19,GACTCCGGGCGTGCACCGGC,0,859063
dgoRp,0.05,19,19,GAATTGCCAGTGCAAGAGAG,0,845901
dgoRp,0.05,19,19,CTTGTGGCCTGGTAACTGGA,0,855404
dgoRp,0.05,19,19,CTTAGAATAACTATAACGGA,0,853308
dgoRp,0.05,19,19,CTTACGAGAGCGCGTAGCAG,0,837451
dgoRp,0.05,19,19,CTGTCTTTTATATTCTCTAG,0,838550
dgoRp,0.05,19,19,CTGGTACTCTCGCATTTTGT,0,853582
dgoRp,0.05,19,19,CTGCATTGAAACCCGCCCTT,0,842909
dgoRp,0.05,19,19,CTGATGACCTCGCTGATAGA,0,845763
dgoRp,0.05,19,19,CTCTTGAGAGAGCTCGCTAC,0,845700
dgoRp,0.05,19,19,CTCGTCAGGGGTGCGGCCAG,0,862672
dgoRp,0.05,19,19,CGTTTAGGCATACGGTTGAA,0,863435
dgoRp,0.05,19,19,CGTCACGCGGGCCAGAGGAT,0,849906
dgoRp,0.05,19,19,CGGTCGGCACGGTTACGTAA,0,851152
dgoRp,0.05,19,19,CGGGACCGTGAACGAGACTC,0,854266
dgoRp,0.05,19,19,CGCTACCTGTCGTGCCCCGG,0,839554
dgoRp,0.05,19,19,CGCGCAACGTCCGACGTGTC,0,866571
dgoRp,0.05,19,19,CGCCGATGGGCGGACACTTA,0,845998
dgoRp,0.05,19,19,CCGTGCAACGTGGTCCGTCG,0,853678
dgoRp,0.05,19,19,CCACAAACCTTATTTGTGCT,0,850274
dgoRp,0.05,19,19,CACAGATATTCGTTCCACGA,0,841083
dgoRp,0.05,19,19,ATTGTGACCTCCAGCGGGTT,0,856969
dgoRp,0.05,19,19,ATTAATCGTGACAATTGCAT,0,849240
dgoRp,0.05,19,19,ATGTAGACAGCCGGTGTCCT,0,851322
dgoRp,0.05,19,19,ATATCAGTGCGACGCCAACT,0,844954
dgoRp,0.05,19,19,AGTGATTTATGTGCGGGAGG,0,855548
dgoRp,0.05,19,19,AGTCCTAACTAGGTCTAGTC,0,844717
dgoRp,0.05,19,19,AGGTTCCAATGTTTCCTGGT,0,850499
dgoRp,0.05,19,19,AGGGGCAGGGCTGTTGGTGC,0,840135
dgoRp,0.05,19,19,AGCGTCCATATCCTCCAAGG,0,848576
dgoRp,0.05,19,19,AGAGATTCACGTTTAATATT,0,850241
dgoRp,0.05,19,19,ACTCCAGAGCCTGATGGCCA,0,843744
dgoRp,0.05,19,19,ACTAACGTGGATTTGAAAAG,0,855944
dgoRp,0.05,19,19,ACGTTACGTACTCCGGATCG,0,840095
dgoRp,0.05,19,19,ACGTAGGACTTTACGACTTT,0,839048
dgoRp,0.05,19,19,ACCCCCCAGCCATAAGCAAT,0,841427
dgoRp,0.05,19,19,AATCCCTGTGTGAACAGGTC,0,846905
dgoRp,0.05,19,19,AAGTGTAGGTAGCGTACCCA,0,848793
dgoRp,0.05,19,19,AAGACGGATATATTTGCTAC,0,835813
dgoRp,0.05,19,19,AACTCCTTGGCGACACGTTG,0,849020
dgoRp,0.05263157894736842,18,18,TTTAGCCTGTGACAGGTGAG,0,838297
dgoRp,0.05263157894736842,18,18,TTGTATAATACCTCCGTCGT,0,860601
dgoRp,0.05263157894736842,18,18,TTCGTACACGTTGCATACGA,0,856541
dgoRp,0.05263157894736842,18,18,TTAGGCCCGTTATGGTAGGT,0,844748
dgoRp,0.05263157894736842,18,18,TTACTCAGCCACAGCTCAGC,0,857926
dgoRp,0.05263157894736842,18,18,TTACCGAGTCAGGAAATACC,0,856694
dgoRp,0.05263157894736842,18,18,TGTTGCAGGGTGGGGATCCT,0,839499
dgoRp,0.05263157894736842,18,18,TGATGCGGTTCGTTAGCTAG,0,838927
dgoRp,0.05263157894736842,18,18,TCGAGTTTATGAGAGATGAT,0,850362
dgoRp,0.05263157894736842,18,18,GTTACTTGCACACCGCATCT,0,841870
dgoRp,0.05263157894736842,18,18,GTGTCCGCAGCCTAGCCCTA,0,854952
dgoRp,0.05263157894736842,18,18,GTCGTACGCTCGGATGCGCA,0,863725
dgoRp,0.05263157894736842,18,18,GTCGATATTTCTTAAACAGA,0,849083
dgoRp,0.05263157894736842,18,18,GTCCGATTCTAATAAGACGT,0,862610
dgoRp,0.05263157894736842,18,18,GTCCCCGTTTATCGACTAGA,0,855655
dgoRp,0.05263157894736842,18,18,GTATCGATTCGTTAGGCAAC,0,838264
dgoRp,0.05263157894736842,18,18,GGTGATCATTATCTAGCTTC,0,839011
dgoRp,0.05263157894736842,18,18,GGCTTGAGGAGATCGAAAAC,0,862688
dgoRp,0.05263157894736842,18,18,GGCATAGCACACGCCTGTAC,0,859595
dgoRp,0.05263157894736842,18,18,GGACATTCCATAAACTTCCG,0,851440
dgoRp,0.05263157894736842,18,18,GCTCCATACTACGCCACTAG,0,844712
dgoRp,0.05263157894736842,18,18,GCGCGCGCATATTTCTAAGA,0,853674
dgoRp,0.05263157894736842,18,18,GCCTCCAATGGTCTCAGATG,0,837265
dgoRp,0.05263157894736842,18,18,GCCAGTCCGTGATGGGGGCA,0,863984
dgoRp,0.05263157894736842,18,18,GATCTCTCCTTCTACGGAAC,0,848213
dgoRp,0.05263157894736842,18,18,GATCGGATAAGTAAGGGCTT,0,837657
dgoRp,0.05263157894736842,18,18,GAGGGCGGGGAAGCGGCGTG,0,862547
dgoRp,0.05263157894736842,18,18,GAGCTCACCTCTGCTCAATT,0,859727
dgoRp,0.05263157894736842,18,18,GACCGCAAGGTCGTTTCCTT,0,855858
dgoRp,0.05263157894736842,18,18,GAACCGATTCTATGATGACA,0,839769
dgoRp,0.05263157894736842,18,18,CTTCAGGAGATAGAGTGCCT,0,845850
dgoRp,0.05263157894736842,18,18,CTGGGCGCGGCGGCAGTCTG,0,837473
dgoRp,0.05263157894736842,18,18,CTGCTCAACTAACTGTGCTT,0,858991
dgoRp,0.05263157894736842,18,18,CTACGTTTATCAAGTTGCGC,0,850890
dgoRp,0.05263157894736842,18,18,CGTTGGCTGGATGCCCGACT,0,863951
dgoRp,0.05263157894736842,18,18,CGTGTAGTTAGGAGGTGGTT,0,855243
dgoRp,0.05263157894736842,18,18,CGACTTTCACGCCGTATAGG,0,855714
dgoRp,0.05263157894736842,18,18,CGAAGGCAGAATGGCTGGGG,0,838244
dgoRp,0.05263157894736842,18,18,CCTCCATCAGGCGCGCCAAT,0,836454
dgoRp,0.05263157894736842,18,18,CCGTGAAGTGCGGATTATCG,0,854873
dgoRp,0.05263157894736842,18,18,CCATGCGAAGTGACCAGGAG,0,860238
dgoRp,0.05263157894736842,18,18,CCAGCAACATCTCACGAGAG,0,865937
dgoRp,0.05263157894736842,18,18,CCAATGACATGCATTGTTAA,0,856118
dgoRp,0.05263157894736842,18,18,CATTCAACGCGTCGGACCTG,0,845009
dgoRp,0.05263157894736842,18,18,CAGATGCAAGAACTGAGTGA,0,858295
dgoRp,0.05263157894736842,18,18,CACCGCTTCCGGGCACTGTA,0,847157
dgoRp,0.05263157894736842,18,18,ATTGTTGTTAGTGTGTACGA,0,865533
dgoRp,0.05263157894736842,18,18,ATTCTAGAACATTTATGCGA,0,851225
dgoRp,0.05263157894736842,18,18,ATGTCCAGGAGTAGAGGTAT,0,848694
dgoRp,0.05263157894736842,18,18,ATGTAATATCTTGTCTTATG,0,853208
dgoRp,0.05263157894736842,18,18,ATCTTCATAGTCGTTAGTCA,0,840781
dgoRp,0.05263157894736842,18,18,ATCTCCATCTTAATGCAATC,0,843281
dgoRp,0.05263157894736842,18,18,ATCAGCGTGTTATACGTGAC,0,863654
dgoRp,0.05263157894736842,18,18,AGGTTCTTCCCTATTGATCC,0,841437
dgoRp,0.05263157894736842,18,18,AGGGCCTTAAGGATGAATTT,0,864023
dgoRp,0.05263157894736842,18,18,AGGCGGCCATGCTGGACCGC,0,859856
dgoRp,0.05263157894736842,18,18,AGGAGTAGGGGTCTACCGGT,0,846622
dgoRp,0.05263157894736842,18,18,AGCTGAATTGATTACGGCTA,0,859690
dgoRp,0.05263157894736842,18,18,AGAGGTAAACGTCGCGGGTT,0,843652
dgoRp,0.05263157894736842,18,18,ACTGTACCTTGCTCCCACAC,0,844775
dgoRp,0.05263157894736842,18,18,ACTATAAGGACATGTGTGGT,0,853919
dgoRp,0.05263157894736842,18,18,ACGTTAGCAGGTTGCTAGGA,0,844774
dgoRp,0.05263157894736842,18,18,ACGCCCAGTCTTGAGAAAGA,0,841733
dgoRp,0.05263157894736842,18,18,ACCTCGAAACTAGCGATAAT,0,850828
dgoRp,0.05263157894736842,18,18,ACCGATTCGGTCCACGATAG,0,853676
dgoRp,0.05263157894736842,18,18,ACCGACGAGAAAGCTGCATT,0,849391
dgoRp,0.05263157894736842,18,18,AAGCCGCGAGATTCCCCGTT,0,848326
dgoRp,0.05263157894736842,18,18,AACGTGTAAGGTCGTCTACA,0,851211
dgoRp,0.05263157894736842,18,18,AACGATATCGTGAAATTCTT,0,861672
dgoRp,0.05263157894736842,18,18,AAACATAGGTGGCCTCCAAT,0,845825
dgoRp,0.05555555555555555,17,17,TTGAAGAGACTCATATGTTC,0,845824
dgoRp,0.05555555555555555,17,17,TTATATCGGGACGAGCGAAA,0,850187
dgoRp,0.05555555555555555,17,17,TTAGTTAGCCTATGTGCTAA,0,838171
dgoRp,0.05555555555555555,17,17,TTACTACGGGCTCTACGGCA,0,860352
dgoRp,0.05555555555555555,17,17,TGGCTGCGAATAGTCCATCT,0,837739
dgoRp,0.05555555555555555,17,17,TGGAACGGTAAGGGAGGATG,0,856929
dgoRp,0.05555555555555555,17,17,TGCCGTAATTTTGATGTCCG,0,851906
dgoRp,0.05555555555555555,17,17,TGCACGCCTCAGATCACCAG,0,859409
dgoRp,0.05555555555555555,17,17,TGCACAAGTTGACGGCATGT,0,845070
dgoRp,0.05555555555555555,17,17,TGATTTTCATGAGGCCGGTC,0,844588
dgoRp,0.05555555555555555,17,17,TGATTTAGAAGGGAAGGGAC,0,841358
dgoRp,0.05555555555555555,17,17,TCGGACTACATACTTGGACT,0,837840
dgoRp,0.05555555555555555,17,17,TCCAGACGCCTCTTATTAAA,0,852410
dgoRp,0.05555555555555555,17,17,TCACACCGTAGACTAGCTAC,0,846182
dgoRp,0.05555555555555555,17,17,TATTTGGCGCGTTGTACTCG,0,858420
dgoRp,0.05555555555555555,17,17,TATCGAATCTACTCGCAACC,0,846830
dgoRp,0.05555555555555555,17,17,TACGTCCTTGTGGTGGTATA,0,856056
dgoRp,0.05555555555555555,17,17,TACCATTTTCAATCTTCAGG,0,856346
dgoRp,0.05555555555555555,17,17,TACCATTGTGGTTATTACGA,0,847032
dgoRp,0.05555555555555555,17,17,TAAGTGCGGGTAAAGTAGCA,0,848244
dgoRp,0.05555555555555555,17,17,GTTTGTAGTGCAGGGTGGCG,0,861649
dgoRp,0.05555555555555555,17,17,GTTTGGTTCACGACGGGTGA,0,839549
dgoRp,0.05555555555555555,17,17,GTTCACAACCCTTGAGTTTA,0,850138
dgoRp,0.05555555555555555,17,17,GTTAAAATAAAGCTAGAGAG,0,862596
dgoRp,0.05555555555555555,17,17,GTCTAGTAGGCTGGCAAGGC,0,852873
dgoRp,0.05555555555555555,17,17,GTCTAATCAATCACATCTCA,0,851406
dgoRp,0.05555555555555555,17,17,GTCGATTCATCTAATGCCCA,0,845103
dgoRp,0.05555555555555555,17,17,GGTTCAGTAAGGAGTAGTAT,0,849172
dgoRp,0.05555555555555555,17,17,GGTCGGTTTAAAATCCGAGT,0,848422
dgoRp,0.05555555555555555,17,17,GGTAGCTTTCTCATTCTGAC,0,842741
dgoRp,0.05555555555555555,17,17,GGGTAAATTGATCCAGCTTA,0,851757
dgoRp,0.05555555555555555,17,17,GGGCGGCCACTAGGCTTGCT,0,843671
dgoRp,0.05555555555555555,17,17,GGGAGCGATCGTTCCTTAGA,0,853490
dgoRp,0.05555555555555555,17,17,GGCTGGCAGATTAGGGTCTA,0,862557
dgoRp,0.05555555555555555,17,17,GGAGGCGACCTAAGTTATGT,0,865551
dgoRp,0.05555555555555555,17,17,GGAGAGTAGCAAAGGTGAGT,0,837545
dgoRp,0.05555555555555555,17,17,GGACCTCGGGAATATCTCCA,0,865660
dgoRp,0.05555555555555555,17,17,GGACCCATGGTTCGAGTGTT,0,865745
dgoRp,0.05555555555555555,17,17,GCTGACTAGAGTAACCTTGT,0,861604
dgoRp,0.05555555555555555,17,17,GCTCTCTGAAGGCTCTTGTG,0,845177
dgoRp,0.05555555555555555,17,17,GCGTACGGCGGTGGGGTGCT,0,861946
dgoRp,0.05555555555555555,17,17,GCATCACGCTTACATAGGCA,0,863148
dgoRp,0.05555555555555555,17,17,GCAAACCATTCGAAGATGAA,0,841175
dgoRp,0.05555555555555555,17,17,GATTCCAATAAAATTAATAG,0,854784
dgoRp,0.05555555555555555,17,17,GAGCAAGACTGGGACCAAGT,0,859036
dgoRp,0.05555555555555555,17,17,GACGAATTAGTGCACAGGTT,0,854235
dgoRp,0.05555555555555555,17,17,GACATTCGGTTAAAGACCAA,0,856442
dgoRp,0.05555555555555555,17,17,GAAAATCTCTAGGGACCCTC,0,844347
dgoRp,0.05555555555555555,17,17,CTTCCCGAATCTATGGCCTC,0,837635
dgoRp,0.05555555555555555,17,17,CTTCCACGAGTAACCGAATT,0,836695
dgoRp,0.05555555555555555,17,17,CGTTGTCATTTCTGGAACCG,0,859805
dgoRp,0.05555555555555555,17,17,CGTGGGTATCCGAGGCCGTG,0,836953
dgoRp,0.05555555555555555,17,17,CGGCATAGTCACCCGCGTAG,0,853131
dgoRp,0.05555555555555555,17,17,CGCGGAAAGCGAGGGCAAAA,0,837951
dgoRp,0.05555555555555555,17,17,CGCATGAGTGTGTTCTCATT,0,842173
dgoRp,0.05555555555555555,17,17,CGAGGGTGCCACCGTACCAA,0,841359
dgoRp,0.05555555555555555,17,17,CGAATTCACTTACATTGTTA,0,856120
dgoRp,0.05555555555555555,17,17,CCTGGTTAGAAGATAGGAAG,0,849630
dgoRp,0.05555555555555555,17,17,CCTACACTACACTGAGGACG,0,860242
dgoRp,0.05555555555555555,17,17,CCTAAAGAAGCCGGCAAAAA,0,865863
dgoRp,0.05555555555555555,17,17,CCGTTCTAATAAGGCATTAC,0,863101
dgoRp,0.05555555555555555,17,17,CCGGCGTACAACGAGACTCA,0,861817
dgoRp,0.05555555555555555,17,17,CCGCGGCTTAAGGCATGGCT,0,851896
dgoRp,0.05555555555555555,17,17,CCATAACTCGTCCACAGGGA,0,840513
dgoRp,0.05555555555555555,17,17,CCAGGGCTGCTGAGGTGTGT,0,841947
dgoRp,0.05555555555555555,17,17,CCAGGAAGGCCCGCCCCACC,0,838037
dgoRp,0.05555555555555555,17,17,CACTGGTTGATCGGATCAGC,0,843021
dgoRp,0.05555555555555555,17,17,CACTGGCGAGCTAAGCACGG,0,841253
dgoRp,0.05555555555555555,17,17,CACTGAAAAAGGGCTACTAC,0,852997
dgoRp,0.05555555555555555,17,17,CACCCCCGGTCTAGCCATTA,0,854024
dgoRp,0.05555555555555555,17,17,CAATCCACACAGGGCCGATA,0,837937
dgoRp,0.05555555555555555,17,17,ATGTCATTGGATATCGAGGG,0,846336
dgoRp,0.05555555555555555,17,17,ATGGCCGTGGATGAATCCTC,0,862502
dgoRp,0.05555555555555555,17,17,ATATCTTCAATCGACCATAT,0,851436
dgoRp,0.05555555555555555,17,17,ATATACGGCGGGAACCTCTT,0,847543
dgoRp,0.05555555555555555,17,17,AGGTCTTGACCGCGATAGTT,0,839837
dgoRp,0.05555555555555555,17,17,AGGCGTACGGACTTGGGTAA,0,867086
dgoRp,0.05555555555555555,17,17,AGCCCGCTCATACGAACGAT,0,855144
dgoRp,0.05555555555555555,17,17,AGCACGGAGTACAGGTAGCA,0,860681
dgoRp,0.05555555555555555,17,17,AGATGGCGGAAGCGGGAGGT,0,848219
dgoRp,0.05555555555555555,17,17,AGAGGCAGGTTAGGATTCTT,0,842217
dgoRp,0.05555555555555555,17,17,AGAACGTGAAAACGCTGCAA,0,861382
dgoRp,0.05555555555555555,17,17,ACTGGGGATGCATTGACTGT,0,848598
dgoRp,0.05555555555555555,17,17,ACGAGACCTGCTTGGGAAGG,0,846515
dgoRp,0.05555555555555555,17,17,ACCCTGCAAGTGTGGAAGTA,0,854650
dgoRp,0.05555555555555555,17,17,ACCAGTTCCCTAAAGACAGG,0,866478
dgoRp,0.05555555555555555,17,17,ACCACAGCATGGGGGTACGG,0,836223
dgoRp,0.05555555555555555,17,17,ACAAGCACCAAGTAAAAAAT,0,837637
dgoRp,0.05555555555555555,17,17,AAGTATGCTAGAAGCATTAG,0,841765
dgoRp,0.05555555555555555,17,17,AACTACTGGCGGTGCATATC,0,842961
dgoRp,0.05555555555555555,17,17,AACAGCGCCTCGGGAATTGC,0,844268
dgoRp,0.05555555555555555,17,17,AAAAATTTTGTCAATCGCAG,0,849232
dgoRp,0.05555555555555555,17,17,AAAAATCCTCCAAGAGCATA,0,851281
dgoRp,0.058823529411764705,16,16,TTTTGACTCTATTATCGGAT,0,851434
dgoRp,0.058823529411764705,16,16,TTTGCAGCGGCATTGTAATA,0,838006
dgoRp,0.058823529411764705,16,16,TTGCTGGCGAGCCGCGCGGG,0,854261
dgoRp,0.058823529411764705,16,16,TTAGAACGAGCTCCACTCCC,0,862867
dgoRp,0.058823529411764705,16,16,TTACGGTGCGACACGTCATG,0,839062
dgoRp,0.058823529411764705,16,16,TGTTGGTTACCGGGATAAAT,0,848452
dgoRp,0.058823529411764705,16,16,TGTGGGAGGACCCGTGGTTG,0,842765
dgoRp,0.058823529411764705,16,16,TGGTTTGGAGTGCATGGCCT,0,867046
dgoRp,0.058823529411764705,16,16,TGGATCAGCCTTAATGTGCC,0,858552
dgoRp,0.058823529411764705,16,16,TGAGTAGGGATTTGCCTCAG,0,861270
dgoRp,0.058823529411764705,16,16,TGACACTTGATCAGGGCAGA,0,839930
dgoRp,0.058823529411764705,16,16,TCGGGAATACTTAGGAATAA,0,839637
dgoRp,0.058823529411764705,16,16,TCCTTTAAGTTGCCTGTAAG,0,842631
dgoRp,0.058823529411764705,16,16,TCCTGTCGAAGGGAATGAAA,0,855849
dgoRp,0.058823529411764705,16,16,TCCCGCTTAAGATACTATGG,0,860488
dgoRp,0.058823529411764705,16,16,TCATGTGACGGAACTGGGGT,0,844697
dgoRp,0.058823529411764705,16,16,TATTTATAAGTTCCCTGCAG,0,846936
dgoRp,0.058823529411764705,16,16,TATTGGTGCTACTTTCGTAT,0,861712
dgoRp,0.058823529411764705,16,16,TATAATCTCTCACATAATTC,0,850658
dgoRp,0.058823529411764705,16,16,TAGAGATTTACGTTTGGTAA,0,837120
dgoRp,0.058823529411764705,16,16,TACGAATTTTTTCATTGGGG,0,864107
dgoRp,0.058823529411764705,16,16,TACCAGAACCTGTTGGAGAC,0,848282
dgoRp,0.058823529411764705,16,16,TACAGCGAGTACCGCAAGTG,0,843775
dgoRp,0.058823529411764705,16,16,TAAGCTCTACGCACTCGTAT,0,846369
dgoRp,0.058823529411764705,16,16,GTGGGTCAAATTGCTCCATA,0,837399
dgoRp,0.058823529411764705,16,16,GTGCCGTTCAATTCGGGCGA,0,846473
dgoRp,0.058823529411764705,16,16,GTCCTCTTAGTCGAGGTAAT,0,843871
dgoRp,0.058823529411764705,16,16,GTAGAACCCCTTGGGCTTAA,0,862165
dgoRp,0.058823529411764705,16,16,GTACCGTATACCTATCTCGG,0,845181
dgoRp,0.058823529411764705,16,16,GGTTTCACCCTGGGGCATGG,0,856589
dgoRp,0.058823529411764705,16,16,GGTCCAGCGGGGGGAAACAT,0,850099
dgoRp,0.058823529411764705,16,16,GGGTGCTGCTCATGGCGAGT,0,842633
dgoRp,0.058823529411764705,16,16,GGGTATCAGTAGCCTGGAGA,0,862413
dgoRp,0.058823529411764705,16,16,GGGGGGGCGATGTTCAAGAG,0,856376
dgoRp,0.058823529411764705,16,16,GGGGCCTGCTTCCTTCGTCA,0,844681
dgoRp,0.058823529411764705,16,16,GGGAGTCGTTTACTCATGTG,0,849029
dgoRp,0.058823529411764705,16,16,GGGAACACGGCAATCAAGTA,0,840121
dgoRp,0.058823529411764705,16,16,GGCACTTCGCAATTGTAACA,0,843367
dgoRp,0.058823529411764705,16,16,GGAGGTCTCCACGAACGAGA,0,867328
dgoRp,0.058823529411764705,16,16,GGAACTAGCAGCTTTTGTTC,0,857301
dgoRp,0.058823529411764705,16,16,GCTTCCTTAAGCCCATTGGC,0,863994
dgoRp,0.058823529411764705,16,16,GCTGCCCGACCGGGCCGTCT,0,853092
dgoRp,0.058823529411764705,16,16,GCTATCTGTGACGTGTAATC,0,856058
dgoRp,0.058823529411764705,16,16,GCGGAATCCATGACCATAAC,0,851189
dgoRp,0.058823529411764705,16,16,GCGCAAAAGGGCCGACAGGT,0,862217
dgoRp,0.058823529411764705,16,16,GCACGCGTTCATACGGGTAA,0,846461
dgoRp,0.058823529411764705,16,16,GCAATGCACGCTTGAAGAAT,0,851894
dgoRp,0.058823529411764705,16,16,GCAAATCAGAGGGTACTGTT,0,867199
dgoRp,0.058823529411764705,16,16,GATTATCTTAGCGGTGCTCT,0,856633
dgoRp,0.058823529411764705,16,16,GATCGGGGACAGCCGTCCGC,0,848736
dgoRp,0.058823529411764705,16,16,GACTAGGATAATGTCTTGGC,0,845234
dgoRp,0.058823529411764705,16,16,GAATGAGGATCATGATCACT,0,837896
dgoRp,0.058823529411764705,16,16,GAAGTCCTTTATGATTTTGG,0,850545
dgoRp,0.058823529411764705,16,16,GAACAATAAATTATATTCTT,0,858857
dgoRp,0.058823529411764705,16,16,GAAATATCGCATTAAGCATT,0,845363
dgoRp,0.058823529411764705,16,16,CTTTAGTTCGCATGATATTG,0,843902
dgoRp,0.058823529411764705,16,16,CTTCCCACACTTCCGCACAG,0,859275
dgoRp,0.058823529411764705,16,16,CTGCAAGCTCTTTCACAGGA,0,863081
dgoRp,0.058823529411764705,16,16,CTACCCCGCGTGCTTTTTTT,0,847961
dgoRp,0.058823529411764705,16,16,CGTGATATGTAAATAGGACA,0,861585
dgoRp,0.058823529411764705,16,16,CGGGCGCCTATGGTGGCCCA,0,853057
dgoRp,0.058823529411764705,16,16,CGGGACAGATCACTTGTCTT,0,849186
dgoRp,0.058823529411764705,16,16,CGGCGCAATATTGCATCATG,0,837494
dgoRp,0.058823529411764705,16,16,CGCTAATCGACAGTAAACAG,0,850445
dgoRp,0.058823529411764705,16,16,CGCCGGGTTAGTAATTAATT,0,838063
dgoRp,0.058823529411764705,16,16,CGCACGTGGACGCCAAGGTA,0,854019
dgoRp,0.058823529411764705,16,16,CGAGGTCGGTTTACTAACAA,0,846250
dgoRp,0.058823529411764705,16,16,CGAAGCAGCCGGGGCATCAT,0,862079
dgoRp,0.058823529411764705,16,16,CGAAGAGAACGTCTGACGTG,0,852778
dgoRp,0.058823529411764705,16,16,CCGTACCTTGCTCTCGAATC,0,837785
dgoRp,0.058823529411764705,16,16,CCGCTTTATGTCGGGCGCCT,0,859007
dgoRp,0.058823529411764705,16,16,CCGAGTAAGAACTGACGTAA,0,864987
dgoRp,0.058823529411764705,16,16,CCATTCGTATCAGTAGGCTT,0,853287
dgoRp,0.058823529411764705,16,16,CATAGTGCCTGCTGAGCGGA,0,854216
dgoRp,0.058823529411764705,16,16,CATAGCACGTTAATCGGACG,0,862900
dgoRp,0.058823529411764705,16,16,CATAGAGCTCTACAGCATCA,0,852339
dgoRp,0.058823529411764705,16,16,CAGTGATCAGCGTGGTGGGA,0,863796
dgoRp,0.058823529411764705,16,16,CAGCAATCTTATGTGAATAG,0,843837
dgoRp,0.058823529411764705,16,16,CAAGGTTGCGGTTCTTTTTC,0,843425
dgoRp,0.058823529411764705,16,16,ATTGGACTTGTACCTCCGTT,0,847544
dgoRp,0.058823529411764705,16,16,ATGTAAGCACGGGGCCTCTC,0,865715
dgoRp,0.058823529411764705,16,16,ATGGGTCTGTGTTTTATACC,0,840764
dgoRp,0.058823529411764705,16,16,ATGGGCTAAGTTCCGAATAG,0,844434
dgoRp,0.058823529411764705,16,16,ATGCTACTCTGCACGAGTGT,0,858809
dgoRp,0.058823529411764705,16,16,ATCGTTCACCCAATGCCCCA,0,848690
dgoRp,0.058823529411764705,16,16,ATCCGTGGGCATCGAGATGA,0,836883
dgoRp,0.058823529411764705,16,16,ATATTCCCACATCGGGTCCT,0,843462
dgoRp,0.058823529411764705,16,16,ATATCTATATAGGCTCTTTT,0,863409
dgoRp,0.058823529411764705,16,16,ATAGTTCAGCCTCAAGTGAA,0,866330
dgoRp,0.058823529411764705,16,16,ATACGTTAGTGTGCCCATCT,0,854415
dgoRp,0.058823529411764705,16,16,ATACAGCGAGTAATCGTATC,0,839983
dgoRp,0.058823529411764705,16,16,AGTCATCTATGGGCCGCGAC,0,845759
dgoRp,0.058823529411764705,16,16,AGTATGGTATGGACAGCTGT,0,860599
dgoRp,0.058823529411764705,16,16,AGTAATGTTTTCCATTAAAC,0,845200
dgoRp,0.058823529411764705,16,16,AGGGTTGAGGTCATTGTCGG,0,849462
dgoRp,0.058823529411764705,16,16,AGGGTATTGATAGAGGGCTT,0,862276
dgoRp,0.058823529411764705,16,16,AGGGTACTGAGTGGTCGGAC,0,850945
dgoRp,0.058823529411764705,16,16,AGGGGAGCGGTCGCAGCTGT,0,843471
dgoRp,0.058823529411764705,16,16,AGGCTTTAGGTTGTTTGCGT,0,848216
dgoRp,0.058823529411764705,16,16,AGCTCGCTAGTACTAAACTT,0,835942
dgoRp,0.058823529411764705,16,16,AGCGAAATTCTGAGGCAGAT,0,857025
dgoRp,0.058823529411764705,16,16,AGCAAAGTTGGATTGGTAAT,0,841935
dgoRp,0.058823529411764705,16,16,AGAGAGCCCTCGGTGAATTA,0,855441
dgoRp,0.058823529411764705,16,16,AGACGGCGACACAGAGGATT,0,856673
dgoRp,0.058823529411764705,16,16,ACTTCAGTCTTTGGGTGTAG,0,841802
dgoRp,0.058823529411764705,16,16,ACTCGAGCTTCCAATATTAT,0,857531
dgoRp,0.058823529411764705,16,16,ACGGCACTGCGACGCATACA,0,843584
dgoRp,0.058823529411764705,16,16,ACGAAAAATAACTCCAAGAT,0,852281
dgoRp,0.058823529411764705,16,16,ACCGTATCGTCCACATTCAC,0,852865
dgoRp,0.058823529411764705,16,16,ACCGCTTTTAAAAATCACTT,0,853090
dgoRp,0.058823529411764705,16,16,ACCGCTAGGCAAGTGCGTTA,0,836257
dgoRp,0.058823529411764705,16,16,ACATGGGTGTGCCTGGAGTA,0,858970
dgoRp,0.058823529411764705,16,16,AATGATCAGCGCGGGTCCTC,0,842612
dgoRp,0.058823529411764705,16,16,AAGTGCTGTGGTGCGTCACC,0,861233
dgoRp,0.058823529411764705,16,16,AAGGGTTAAGAGGATTGGCG,0,849534
dgoRp,0.058823529411764705,16,16,AAGCCAGCGCCTCACCCATC,0,848602
dgoRp,0.0625,15,15,TTTCCTGGCCCGACACATCT,0,853464
dgoRp,0.0625,15,15,TTTAACCAGTTCAGAAATAT,0,847184
dgoRp,0.0625,15,15,TTGCTCGGATTTGACGTTTA,0,865751
dgoRp,0.0625,15,15,TTCCCTGTAGAGTACGGATA,0,845499
dgoRp,0.0625,15,15,TTCATCTAGGATATATGTGT,0,848143
dgoRp,0.0625,15,15,TGTTATCGTTCCGCGCGGTG,0,852277
dgoRp,0.0625,15,15,TGGGGTTTCCCGCTCGGAAT,0,845380
dgoRp,0.0625,15,15,TGCTGTACGCGCTCGCCAGT,0,861134
dgoRp,0.0625,15,15,TGCAGTGCCTACCGTAAGAA,0,843070
dgoRp,0.0625,15,15,TGAGGCGTATTTGTCTGATC,0,852153
dgoRp,0.0625,15,15,TCTGTTACGTTCGGGAGTGC,0,845389
dgoRp,0.0625,15,15,TCTGCGTGAGTAAGATGTAG,0,845590
dgoRp,0.0625,15,15,TCGGGGTCCCGTGGATCCGA,0,844052
dgoRp,0.0625,15,15,TCCTCACGAGCCATCCCCAT,0,849516
dgoRp,0.0625,15,15,TCATTGGCGCAATGTGTTAT,0,864343
dgoRp,0.0625,15,15,TCAGGTGGCACCCAGAGTGC,0,861892
dgoRp,0.0625,15,15,TATTTGTGGGAGTGGAACCA,0,850999
dgoRp,0.0625,15,15,TATGGTCGGCAGAGGGCGGA,0,866882
dgoRp,0.0625,15,15,TATGCTGGCAAAGTGCCATT,0,854029
dgoRp,0.0625,15,15,TAGGGAATGAGGGTTTCAAG,0,866235
dgoRp,0.0625,15,15,TAGCCGCAAAATTGAAGATC,0,844692
dgoRp,0.0625,15,15,TAATCTCCACCGTTTACGGT,0,847863
dgoRp,0.0625,15,15,TAAGATTTAGAATACTCGAT,0,849189
dgoRp,0.0625,15,15,GTTTGGCGCACTCTGGTTGT,0,848633
dgoRp,0.0625,15,15,GTTGAATCGGCAATCTACGA,0,845294
dgoRp,0.0625,15,15,GTTCCTGGGGTGGGTTGAGA,0,864166
dgoRp,0.0625,15,15,GTTAAACCTAGGGTGCAAGT,0,842114
dgoRp,0.0625,15,15,GTGTGTAAATCAACGAGTAG,0,861161
dgoRp,0.0625,15,15,GTCCGCCTGCGTGACGTCCG,0,853321
dgoRp,0.0625,15,15,GTCCGCAGACCACTTTGGGA,0,859813
dgoRp,0.0625,15,15,GTCCCTGTTCACGTTCAGGT,0,861534
dgoRp,0.0625,15,15,GTATTTCTTACCAACTTTGT,0,841584
dgoRp,0.0625,15,15,GTATGCTAGACCTCCACGGT,0,865709
dgoRp,0.0625,15,15,GTAGTCACTCCGAAACGAGA,0,855834
dgoRp,0.0625,15,15,GTAACAGAATAGCGAGGTGA,0,860789
dgoRp,0.0625,15,15,GGTTTACGTAAGATTCCATC,0,836776
dgoRp,0.0625,15,15,GGCTTTGGCCAAAATCATTC,0,861171
dgoRp,0.0625,15,15,GCTGGATATCCTGCTATGCT,0,853626
dgoRp,0.0625,15,15,GCGTATATCTGAAGCCAATC,0,845290
dgoRp,0.0625,15,15,GCGCGCTTTTATTTCTTTGG,0,841734
dgoRp,0.0625,15,15,GCGCACTAAAACATCTCTAG,0,845542
dgoRp,0.0625,15,15,GCGAGCTTGGCCGAAAAGAT,0,857306
dgoRp,0.0625,15,15,GCCCTGCCGGCTAATCTGCG,0,838631
dgoRp,0.0625,15,15,GAGTGTCAGTAGACACAGGT,0,862807
dgoRp,0.0625,15,15,GACTAGGTTTCCTGGCAGAA,0,859383
dgoRp,0.0625,15,15,GACACCACAGACGAAGTCGT,0,842195
dgoRp,0.0625,15,15,GACAATACGCGCCAGCGGGA,0,865194
dgoRp,0.0625,15,15,GAATTCGTGGATACCTCGAT,0,847440
dgoRp,0.0625,15,15,GAATACTCCATCACACTTCA,0,842363
dgoRp,0.0625,15,15,CTTCGGTTAGGACGGCTTCG,0,845477
dgoRp,0.0625,15,15,CTTCGGATTCGTGAGGGCTG,0,848873
dgoRp,0.0625,15,15,CTGCTCGGTATGCTCTTTAT,0,840069
dgoRp,0.0625,15,15,CTGAGATCGAAGAACACGGC,0,852093
dgoRp,0.0625,15,15,CTCCACTCGACAGAAACGCA,0,848710
dgoRp,0.0625,15,15,CTATTTGCGTGGGTTTATGG,0,864786
dgoRp,0.0625,15,15,CTATATTTTCGTGACCCAAC,0,844377
dgoRp,0.0625,15,15,CTAGGGTGTCCACCGCACTA,0,849316
dgoRp,0.0625,15,15,CGTGGGAGCAGCGGAGGAAT,0,842069
dgoRp,0.0625,15,15,CGTGCGGAATTAGGCACGGA,0,849190
dgoRp,0.0625,15,15,CGTGACTGCGTCACCAGGTG,0,858336
dgoRp,0.0625,15,15,CGGATGCCGCTAGTAGGGCT,0,857237
dgoRp,0.0625,15,15,CGCGCGGGGGCTAATATTTC,0,859913
dgoRp,0.0625,15,15,CGAGGAAGCGGTCACCGCTG,0,850483
dgoRp,0.0625,15,15,CGAAGTTGAATCAGTTTGAT,0,848184
dgoRp,0.0625,15,15,CGAACTTACTCAAAGCGCGC,0,863331
dgoRp,0.0625,15,15,CCTGGACCCGATACGGTATG,0,838634
dgoRp,0.0625,15,15,CCTGCTAGCAACTTTGTATA,0,844238
dgoRp,0.0625,15,15,CCTCCTGGCTCCAACCATTG,0,852871
dgoRp,0.0625,15,15,CCTATTAATAATGAAAGCGT,0,852127
dgoRp,0.0625,15,15,CCTATGCGTAATGAACGTCA,0,843950
dgoRp,0.0625,15,15,CCTAGAGACAGAAGTAACGT,0,865638
dgoRp,0.0625,15,15,CCCGCTGCCCCCAGTTCTGG,0,859081
dgoRp,0.0625,15,15,CCATTCTTCGGCCCTTCGGC,0,854276
dgoRp,0.0625,15,15,CCACCGTTTCATCGTCCAGC,0,853260
dgoRp,0.0625,15,15,CATTGTGGTCTACATACCGA,0,862481
dgoRp,0.0625,15,15,CAGTGTGGTCACTTAGTCCC,0,849198
dgoRp,0.0625,15,15,CAGCAGGTAATATATCAAAT,0,856613
dgoRp,0.0625,15,15,CAGCACCTTCGCTCGCCTAC,0,844984
dgoRp,0.0625,15,15,CACATAGGATCAACGCTGGA,0,854026
dgoRp,0.0625,15,15,CAAATAAATAATACTCGGTT,0,842325
dgoRp,0.0625,15,15,ATGGGCGGGTTAAATTCGTC,0,863276
dgoRp,0.0625,15,15,ATGGGCGCTACGTTAGATTG,0,865396
dgoRp,0.0625,15,15,ATCTTACTCTTTGATTTCCA,0,859898
dgoRp,0.0625,15,15,ATCTATACAATTCCTTTTGA,0,840710
dgoRp,0.0625,15,15,ATATCTTTTAAGAGGACACA,0,861634
dgoRp,0.0625,15,15,ATAAGCCAAAATATCCCCGT,0,861132
dgoRp,0.0625,15,15,ATAACCCCTTAATAGGGCAT,0,850656
dgoRp,0.0625,15,15,AGTGGGTGTATATTCCGAGG,0,866018
dgoRp,0.0625,15,15,AGGTAATCTAAGTAGTCGCA,0,859971
dgoRp,0.0625,15,15,AGGAGAGATTGGAACGCCCT,0,849425
dgoRp,0.0625,15,15,AGGAACCATGTGGTAACCGT,0,846036
dgoRp,0.0625,15,15,AGCGGACACAACGCCTCTGA,0,851873
dgoRp,0.0625,15,15,AGCCCTTCTGCCAAGTGACG,0,866265
dgoRp,0.0625,15,15,AGCATGACGGTAGAATCCCG,0,837148
dgoRp,0.0625,15,15,AGAACCGTACAGTCCCGTGC,0,856367
dgoRp,0.0625,15,15,AGAAAAACCACGGGCATCGG,0,850808
dgoRp,0.0625,15,15,ACTTACGCGCGCACTCGTGA,0,854429
dgoRp,0.0625,15,15,ACGGCATCAGACGCCGTCTT,0,844586
dgoRp,0.0625,15,15,ACGCATACAATAGTGATTAA,0,863955
dgoRp,0.0625,15,15,ACCCCCACATACTAACGGTA,0,842780
dgoRp,0.0625,15,15,ACACCACGTGGGTGCGCCTC,0,851305
dgoRp,0.0625,15,15,AATCATGGGGAGTACCTCAA,0,862100
dgoRp,0.0625,15,15,AAGAGGCCCTTACTAATATG,0,843304
dgoRp,0.0625,15,15,AACCTACCAACCACTCTAGG,0,852977
dgoRp,0.06666666666666667,14,14,TTGCGATGCGGTCAACTGTT,0,848006
dgoRp,0.06666666666666667,14,14,TTCGCCTGAACATCCCCGGT,0,849677
dgoRp,0.06666666666666667,14,14,TTATTAGTATCACTATGGGA,0,853555
dgoRp,0.06666666666666667,14,14,TTAGTTCGGACAGTTTAACT,0,855018
dgoRp,0.06666666666666667,14,14,TTACGTGTTGGAGTCGTTGT,0,846576
dgoRp,0.06666666666666667,14,14,TTAACGACAGACTGTGAATC,0,839364
dgoRp,0.06666666666666667,14,14,TGTTGTATGAATACCTCGAG,0,857391
dgoRp,0.06666666666666667,14,14,TGTGGCGCGTGGTGTCTCAG,0,843618
dgoRp,0.06666666666666667,14,14,TGGTATCTGTGCCCATGGAG,0,843045
dgoRp,0.06666666666666667,14,14,TGGCTGTCTTATACGACGTA,0,851337
dgoRp,0.06666666666666667,14,14,TGGATTCGGGGGAAGGGGGG,0,864338
dgoRp,0.06666666666666667,14,14,TGCGCTGACGTGGGGGGTCT,0,852845
dgoRp,0.06666666666666667,14,14,TCTGCTTGTGGCACATATCA,0,843071
dgoRp,0.06666666666666667,14,14,TCGCCTTGGTTCCATTCGAT,0,863550
dgoRp,0.06666666666666667,14,14,TCGAATGAGAAATCATCTGG,0,840971
dgoRp,0.06666666666666667,14,14,TCCCCCAGTTTATGCCGGTT,0,848741
dgoRp,0.06666666666666667,14,14,TCATGGCGAACCTCCGAGAT,0,835953
dgoRp,0.06666666666666667,14,14,TCACCGAGAAGAATAGTAAA,0,851446
dgoRp,0.06666666666666667,14,14,TCAATTGGTCTTCACCGGCA,0,853962
dgoRp,0.06666666666666667,14,14,TCAATTGGCACCGCTCGGAC,0,852715
dgoRp,0.06666666666666667,14,14,TAGGGGGATTCCAGTGGTTC,0,839933
dgoRp,0.06666666666666667,14,14,TACTGCGGGTTCGGAGGGTA,0,862949
dgoRp,0.06666666666666667,14,14,TACGGCGGAGCGCACACACT,0,840531
dgoRp,0.06666666666666667,14,14,TAATGCAAATGAGTTAAACT,0,850030
dgoRp,0.06666666666666667,14,14,TAATCCTTCTAGTTTTACAC,0,839564
dgoRp,0.06666666666666667,14,14,TAAATTCGGTAATATACACG,0,855768
dgoRp,0.06666666666666667,14,14,GTGGTACGCATATTAGCCAA,0,847802
dgoRp,0.06666666666666667,14,14,GTGGGAGGCGTCGTCCTATG,0,844452
dgoRp,0.06666666666666667,14,14,GTGCCTTTGGATCAGTTAAA,0,862831
dgoRp,0.06666666666666667,14,14,GTGCCCCATGAATAGTAGAT,0,850377
dgoRp,0.06666666666666667,14,14,GTCTGACGTTCCCCTTGTCT,0,853542
dgoRp,0.06666666666666667,14,14,GTCTCATTGCGTTCCGCAGA,0,848599
dgoRp,0.06666666666666667,14,14,GTCCATCACCCTCAAAGCCG,0,844078
dgoRp,0.06666666666666667,14,14,GTCATATAGCTGGCTGGTTC,0,841703
dgoRp,0.06666666666666667,14,14,GTCAGGAACGGAAATCCTGC,0,845412
dgoRp,0.06666666666666667,14,14,GTATGAACGGTTTAGGGCTA,0,847860
dgoRp,0.06666666666666667,14,14,GTAAGCGTGCAAGCTACTAG,0,860855
dgoRp,0.06666666666666667,14,14,GGTGATAGATCTTCTCCGAA,0,864792
dgoRp,0.06666666666666667,14,14,GGTATGAAGGCCCTTCCACT,0,836458
dgoRp,0.06666666666666667,14,14,GGGGTGGCCCAGCAGTTCAG,0,845996
dgoRp,0.06666666666666667,14,14,GGGCGTTTGCGTTGTCTTTA,0,859660
dgoRp,0.06666666666666667,14,14,GGGCACTCGCGGAGTCCCTG,0,853554
dgoRp,0.06666666666666667,14,14,GGGACGTTCTTAAATGCTAG,0,861646
dgoRp,0.06666666666666667,14,14,GGCTACCCGCTCCATCCACA,0,858378
dgoRp,0.06666666666666667,14,14,GGAGACATCGGTCGTACGAA,0,841204
dgoRp,0.06666666666666667,14,14,GGACAATGGACAATCTTAAA,0,866222
dgoRp,0.06666666666666667,14,14,GGAATGCCGATCCGCTTAGG,0,837581
dgoRp,0.06666666666666667,14,14,GGAAGTCTCAGGGCATCGCC,0,859313
dgoRp,0.06666666666666667,14,14,GCTATAAAAAAAGTTACTTT,0,842209
dgoRp,0.06666666666666667,14,14,GCGTTATGCCAGCTCTCACA,0,854953
dgoRp,0.06666666666666667,14,14,GCGGTGGCCATAAGTTGATA,0,862653
dgoRp,0.06666666666666667,14,14,GCGAGTTTAGTCATCCGGGT,0,846376
dgoRp,0.06666666666666667,14,14,GCCTGGAAACCCGTCAGGTA,0,847609
dgoRp,0.06666666666666667,14,14,GCCAGGATTGGTGTGCAGTG,0,865847
dgoRp,0.06666666666666667,14,14,GCATACAGTCTATAGCATTC,0,838711
dgoRp,0.06666666666666667,14,14,GCACACACCGGGCTAAATGC,0,855159
dgoRp,0.06666666666666667,14,14,GATTTAAATTTTATGTATTA,0,844872
dgoRp,0.06666666666666667,14,14,GATTGCTGCAGCCGCGAGTG,0,842840
dgoRp,0.06666666666666667,14,14,GAGTTCGAACCAATCGCGCT,0,866055
dgoRp,0.06666666666666667,14,14,GAGTACTTTAGGGCAGGGGG,0,850273
dgoRp,0.06666666666666667,14,14,GAGGCCAGACGTTGCGGAGA,0,860271
dgoRp,0.06666666666666667,14,14,GAGGACATGTGTTATTACAG,0,846193
dgoRp,0.06666666666666667,14,14,GAGCGGCGAAATTACCAGCC,0,844874
dgoRp,0.06666666666666667,14,14,GAGCGCTATGAGCCGACCGT,0,851066
dgoRp,0.06666666666666667,14,14,GACTTTGATCAGATGCTACT,0,862225
dgoRp,0.06666666666666667,14,14,GACGCTCTGTTCAATCAGCA,0,839493
dgoRp,0.06666666666666667,14,14,GACGACTAATAGAGGTGTGA,0,858195
dgoRp,0.06666666666666667,14,14,GAAGACGGTAAGAGCACATT,0,861175
dgoRp,0.06666666666666667,14,14,GAACTATGAAATTGCGCCAT,0,867262
dgoRp,0.06666666666666667,14,14,GAAAGAATCCCCAGAATTTG,0,853111
dgoRp,0.06666666666666667,14,14,CTTAGATGCAACACGTATCA,0,859057
dgoRp,0.06666666666666667,14,14,CTTAAGAATGATTTTTCAAT,0,839910
dgoRp,0.06666666666666667,14,14,CTGTTGTGGGGAGCAAGGAA,0,854447
dgoRp,0.06666666666666667,14,14,CTGGACGTACGGAAAAGTTA,0,861512
dgoRp,0.06666666666666667,14,14,CTGCCGGGTGTGGTCTTGTG,0,836163
dgoRp,0.06666666666666667,14,14,CTCCCTTAGAGGACATGAAG,0,854153
dgoRp,0.06666666666666667,14,14,CTCATCTAAGCGCAAGGATC,0,865776
dgoRp,0.06666666666666667,14,14,CTATTATAAATTTATTGTTG,0,854391
dgoRp,0.06666666666666667,14,14,CTAGATTCCCTCTACCGACC,0,860885
dgoRp,0.06666666666666667,14,14,CTACGCCAGCCAGATCGGTA,0,840411
dgoRp,0.06666666666666667,14,14,CTAATCAGGCGGTTATATCA,0,853661
dgoRp,0.06666666666666667,14,14,CGTTTAGTGTAGTTATTATA,0,856900
dgoRp,0.06666666666666667,14,14,CGTTCCTCGAACAGGGTGAA,0,854472
dgoRp,0.06666666666666667,14,14,CGTGTGATCGTATCTCTGAT,0,842037
dgoRp,0.06666666666666667,14,14,CGTGCTAGCACGTGATGATA,0,853470
dgoRp,0.06666666666666667,14,14,CGTGACTAGGCTGGCAGGGT,0,844292
dgoRp,0.06666666666666667,14,14,CGGTTGGGGTTGAATGTGGG,0,862482
dgoRp,0.06666666666666667,14,14,CGCTCTGGGGGGCTCAAGCC,0,858186
dgoRp,0.06666666666666667,14,14,CGCGTGGCACTGACCGATGC,0,842118
dgoRp,0.06666666666666667,14,14,CGCCGGGGGACAATGGCGGA,0,835982
dgoRp,0.06666666666666667,14,14,CGCCACTAGCCATGCGGAAG,0,864780
dgoRp,0.06666666666666667,14,14,CGATGGTCAAGATCCGGCGG,0,841553
dgoRp,0.06666666666666667,14,14,CGACTAGTGTGCGTGTCTCA,0,848344
dgoRp,0.06666666666666667,14,14,CGAAGATTGAAATTCCCTCA,0,836304
dgoRp,0.06666666666666667,14,14,CCTGGTTTGTTAAGGCATGC,0,859311
dgoRp,0.06666666666666667,14,14,CCTGCTTTATATTGAAACAC,0,850941
dgoRp,0.06666666666666667,14,14,CCTCAAGGTACCGCGACCCG,0,848871
dgoRp,0.06666666666666667,14,14,CCGGTGTTTACGTGCGTACT,0,843561
dgoRp,0.06666666666666667,14,14,CCGGCGGTATCCTGGACTCG,0,844686
dgoRp,0.06666666666666667,14,14,CCGAATAGGTAATGCAGAGA,0,846976
dgoRp,0.06666666666666667,14,14,CCGAATAAGTCATGCCTAAG,0,841277
dgoRp,0.06666666666666667,14,14,CCCGACAAGGTTTCGGTGTT,0,849251
dgoRp,0.06666666666666667,14,14,CCCAAGTAGGCCAAGAGTGT,0,843285
dgoRp,0.06666666666666667,14,14,CCAGGTTCTGGGCGAAGCGA,0,864525
dgoRp,0.06666666666666667,14,14,CCAGCTTGCTCTGCCCCGGT,0,849274
dgoRp,0.06666666666666667,14,14,CCAAAAGAACGATGACCGGC,0,850616
dgoRp,0.06666666666666667,14,14,CATCGAGTTAAGACTGACTC,0,839239
dgoRp,0.06666666666666667,14,14,CATATTGAGATCGGATCTAT,0,858554
dgoRp,0.06666666666666667,14,14,CATATCACGGGCGATTCGCT,0,847741
dgoRp,0.06666666666666667,14,14,CAGGCGTTCTTCCGGGCCAC,0,838201
dgoRp,0.06666666666666667,14,14,CAGGCCGCCATTGGCTTCTT,0,838018
dgoRp,0.06666666666666667,14,14,CACGTTCGAAGAGGGCACAA,0,858334
dgoRp,0.06666666666666667,14,14,ATTGTACCGCATGATATACA,0,851439
dgoRp,0.06666666666666667,14,14,ATTAGGGCACCACGTTCTCT,0,846613
dgoRp,0.06666666666666667,14,14,ATGGCGGTACGCATTAGCAA,0,842868
dgoRp,0.06666666666666667,14,14,ATCGGTACATGTGATAGGTA,0,840018
dgoRp,0.06666666666666667,14,14,ATCCGTCTAATGCCTCTACT,0,850532
dgoRp,0.06666666666666667,14,14,ATCATGTGAGTGTCCAATTT,0,858754
dgoRp,0.06666666666666667,14,14,ATCATGGTCGATCTCAGGTA,0,864463
dgoRp,0.06666666666666667,14,14,ATCAGCGGTCCCGCACTCAC,0,854783
dgoRp,0.06666666666666667,14,14,ATAGCGTTGTGATCGTCGGT,0,867090
dgoRp,0.06666666666666667,14,14,ATACACTATAGGCGCATTCT,0,838399
dgoRp,0.06666666666666667,14,14,ATAATTCTAGCGGAATCCGA,0,838457
dgoRp,0.06666666666666667,14,14,AGGTTGACGGGGATATCGCT,0,858374
dgoRp,0.06666666666666667,14,14,AGGTAACATCTAGATACGGT,0,865687
dgoRp,0.06666666666666667,14,14,AGCTTAGCATGATGCTGGGA,0,853789
dgoRp,0.06666666666666667,14,14,AGAGCTTGATCCCTGAACGT,0,838268
dgoRp,0.06666666666666667,14,14,AGAGCCAGACACGGACGTCT,0,845448
dgoRp,0.06666666666666667,14,14,AGAGATTGCAAGGGGCACAT,0,838723
dgoRp,0.06666666666666667,14,14,AGAAGAACGTCCATGTCTCA,0,864601
dgoRp,0.06666666666666667,14,14,ACTGATGCTTCTGGCCGATC,0,850328
dgoRp,0.06666666666666667,14,14,ACGTAATGCCAGGAGCGGGG,0,863102
dgoRp,0.06666666666666667,14,14,ACGGGTTTTGCACGACCCTC,0,838274
dgoRp,0.06666666666666667,14,14,ACCGGAGCTGAGGGCTGCGT,0,844711
dgoRp,0.06666666666666667,14,14,ACCGCGGGGTTAGGAGTAGA,0,862277
dgoRp,0.06666666666666667,14,14,ACCCGTGTTACTAGCGGACC,0,859822
dgoRp,0.06666666666666667,14,14,ACCCAGGTTCAACATAGCAA,0,842064
dgoRp,0.06666666666666667,14,14,ACCAGTTGCTGGAGTTATTT,0,845341
dgoRp,0.06666666666666667,14,14,ACAGTCCCCCTATGTCAATA,0,843755
dgoRp,0.06666666666666667,14,14,AATTGCGCGATGTTCCTATA,0,862598
dgoRp,0.06666666666666667,14,14,AATTAGCTCAGGTAAGGCTC,0,861442
dgoRp,0.06666666666666667,14,14,AATATATTCAAAGAACGTTG,0,861978
dgoRp,0.06666666666666667,14,14,AAGGGGTAGATATTCCCCTT,0,837414
dgoRp,0.06666666666666667,14,14,AAGCGTAAATACCTGACCAT,0,861380
dgoRp,0.06666666666666667,14,14,AACGCTGTCCATCGGCTATA,0,841516
dgoRp,0.06666666666666667,14,14,AAAGGGGGGACAGGTAACAT,0,861753
dgoRp,0.06666666666666667,14,14,AAAGCCTTTTTAGGGTGGCG,0,840718
dgoRp,0.06666666666666667,14,14,AAAGACGTTTAACCAGCGAC,0,855328
dgoRp,0.06666666666666667,14,14,AAACGGCTCGTCACGCAGCA,0,838866
dgoRp,0.07142857142857142,13,13,TTTTGGGGAAGGTCGCGGTA,0,849595
dgoRp,0.07142857142857142,13,13,TTTTCGGCCTTGCCCTAATC,0,852275
dgoRp,0.07142857142857142,13,13,TTTGCCTCTCCGTCCGGAAC,0,849805
dgoRp,0.07142857142857142,13,13,TTGGCGCGAGGAGAAGTTAA,0,855048
dgoRp,0.07142857142857142,13,13,TTGCGGGATGAAAGGAGTTC,0,837634
dgoRp,0.07142857142857142,13,13,TTGAAAGCGCGAGGCGTCTT,0,843465
dgoRp,0.07142857142857142,13,13,TTAAGGATAGCAAATGTCAC,0,857560
dgoRp,0.07142857142857142,13,13,TGTCACGCATTCTAGGAGGA,0,860247
dgoRp,0.07142857142857142,13,13,TGTATCGGGCCATTAGTCTA,0,842233
dgoRp,0.07142857142857142,13,13,TGTAGCTGGTCTAAGCGCGG,0,862223
dgoRp,0.07142857142857142,13,13,TGTACATCATGGAAACTCCT,0,837086
dgoRp,0.07142857142857142,13,13,TGGGATGCCTTCAGTATGCA,0,851990
dgoRp,0.07142857142857142,13,13,TGGCGGGGTGATCAACGGCT,0,855391
dgoRp,0.07142857142857142,13,13,TGGCACAAAACTACAGTTCG,0,861337
dgoRp,0.07142857142857142,13,13,TGGAGTTAATCCTCTGAAAT,0,838502
dgoRp,0.07142857142857142,13,13,TGGAGGCTATCCACCGTTGA,0,836722
dgoRp,0.07142857142857142,13,13,TGGACCGGCTTGTAAGCCAA,0,835902
dgoRp,0.07142857142857142,13,13,TGCTTATCTGACGGGCGCAA,0,859492
dgoRp,0.07142857142857142,13,13,TGCTGCACCCACGCATTACT,0,850940
dgoRp,0.07142857142857142,13,13,TGCCGATGGTCATAATATAT,0,861224
dgoRp,0.07142857142857142,13,13,TCGCTGAGCGTCGAAAGGTT,0,843547
dgoRp,0.07142857142857142,13,13,TCGACAAGCAAGGGGTATGG,0,862766
dgoRp,0.07142857142857142,13,13,TCCCAGGAACTTGGAAGTGA,0,858957
dgoRp,0.07142857142857142,13,13,TCAATTAGCGATTGGTTTAC,0,843427
dgoRp,0.07142857142857142,13,13,TATGCAAAGACTCTGTCTCG,0,849151
dgoRp,0.07142857142857142,13,13,TAGGTAGGATGTCGCCCTAC,0,849691
dgoRp,0.07142857142857142,13,13,TAGGAAACCCTTACCTCCCG,0,852924
dgoRp,0.07142857142857142,13,13,TAGCTCGAGGCCGGTGCCAC,0,847726
dgoRp,0.07142857142857142,13,13,TAGAGTGCCCAAACGTTTCG,0,855668
dgoRp,0.07142857142857142,13,13,TACTTTGTTCAATTCTCGAT,0,864817
dgoRp,0.07142857142857142,13,13,TACGAGTAGTGATAATGAGT,0,850485
dgoRp,0.07142857142857142,13,13,TACACTAGCCAGCGTCTAGG,0,836843
dgoRp,0.07142857142857142,13,13,TAACCCACTAATACTGCTGG,0,860603
dgoRp,0.07142857142857142,13,13,TAAAATCCGCTTTTCGAGGC,0,855500
dgoRp,0.07142857142857142,13,13,GTTTTGTGATACACATCGCA,0,854156
dgoRp,0.07142857142857142,13,13,GTTTCGCATACTCTAGATGC,0,864966
dgoRp,0.07142857142857142,13,13,GTTGGTCCAAAGCCCAAACC,0,836271
dgoRp,0.07142857142857142,13,13,GTTGCTAAGAGAATGGTTAA,0,848303
dgoRp,0.07142857142857142,13,13,GTGTCACGGGTGTGCACAGC,0,839675
dgoRp,0.07142857142857142,13,13,GTGGAGTTCTGCCATCAGCG,0,845046
dgoRp,0.07142857142857142,13,13,GTGCTGTCCACCATTGAATC,0,853890
dgoRp,0.07142857142857142,13,13,GTGCGATGCGGAGAGCAAAG,0,847102
dgoRp,0.07142857142857142,13,13,GTCCCGTTTTACCGCGCTAC,0,854653
dgoRp,0.07142857142857142,13,13,GTATTAAAGATCGAGCTTAG,0,862030
dgoRp,0.07142857142857142,13,13,GTATGGATATCAGTGGTAGG,0,859098
dgoRp,0.07142857142857142,13,13,GTAGGTGTGGGAAAAGTCTA,0,857987
dgoRp,0.07142857142857142,13,13,GTACTTAACTGTTTTGCCCA,0,852748
dgoRp,0.07142857142857142,13,13,GTAACACATCTGCCGCGCTA,0,858811
dgoRp,0.07142857142857142,13,13,GGTTATGAGCCCTTGAGTAT,0,836812
dgoRp,0.07142857142857142,13,13,GGTGTACTATCACCCTGGCT,0,866954
dgoRp,0.07142857142857142,13,13,GGTGGAGCGAGAGCGATACG,0,849541
dgoRp,0.07142857142857142,13,13,GGGTGTCTGCTGACAGATCG,0,857193
dgoRp,0.07142857142857142,13,13,GGGTGGGGCGGTGAAGCCGA,0,860526
dgoRp,0.07142857142857142,13,13,GGGTGCCAGAGGCTGGCGCA,0,849656
dgoRp,0.07142857142857142,13,13,GGGGGACGTAAAGCGGGGTA,0,851102
dgoRp,0.07142857142857142,13,13,GGCCTGTGGCGCGGCCAAAG,0,866026
dgoRp,0.07142857142857142,13,13,GGATGTAGGGACTTAAAAAA,0,855367
dgoRp,0.07142857142857142,13,13,GGATATAGGAGTTGCGGTCG,0,858815
dgoRp,0.07142857142857142,13,13,GGATACAGCATGGGTAGTGT,0,848880
dgoRp,0.07142857142857142,13,13,GGAGTAATGATGTTACATAA,0,850763
dgoRp,0.07142857142857142,13,13,GGACCGTAACACGTGACACG,0,857134
dgoRp,0.07142857142857142,13,13,GCTGCTGACAGTCCTAGCTG,0,839340
dgoRp,0.07142857142857142,13,13,GCTGAGGGCTAACATTTCTA,0,851372
dgoRp,0.07142857142857142,13,13,GCGTGCCCCTGACATACGTA,0,848417
dgoRp,0.07142857142857142,13,13,GCGGGGGGGCGCTTACGAGG,0,846900
dgoRp,0.07142857142857142,13,13,GCGCGCCCATTTGATGTAAA,0,862354
dgoRp,0.07142857142857142,13,13,GCGCAAGCTTAATCAACGAC,0,854521
dgoRp,0.07142857142857142,13,13,GCGACGTTTGGGGACGCGAC,0,839461
dgoRp,0.07142857142857142,13,13,GCGAAGGTCGCTGGACGCTC,0,852666
dgoRp,0.07142857142857142,13,13,GCCTACGTGCTTGCTCCCCC,0,852840
dgoRp,0.07142857142857142,13,13,GCCACAATAAAAGTTCGCGC,0,865705
dgoRp,0.07142857142857142,13,13,GCAAATAACTGGGCGGGCAG,0,854218
dgoRp,0.07142857142857142,13,13,GATTAATGGAGCCTCGAGCT,0,864158
dgoRp,0.07142857142857142,13,13,GATGTATAAGTGCCTCTTGT,0,844845
dgoRp,0.07142857142857142,13,13,GATCAACGGGAGGCGCAATC,0,851956
dgoRp,0.07142857142857142,13,13,GAGTAGTCGTGGTTGTCACT,0,846947
dgoRp,0.07142857142857142,13,13,GACGTCTGCGTCAGCCCGCT,0,853265
dgoRp,0.07142857142857142,13,13,GACATCCATTATCGTGTGTG,0,847107
dgoRp,0.07142857142857142,13,13,GACACGCTTTCGACGCTCCT,0,842782
dgoRp,0.07142857142857142,13,13,GAATTTTCGAACCCACTTGT,0,839787
dgoRp,0.07142857142857142,13,13,GAAAAGAGTTTGGGGCTGTA,0,867018
dgoRp,0.07142857142857142,13,13,CTTTCCTTATGGGTGACGAT,0,841050
dgoRp,0.07142857142857142,13,13,CTTAGCTACGAAGAATTAAC,0,838401
dgoRp,0.07142857142857142,13,13,CTGCCAGTTTAGCGAGGATG,0,839217
dgoRp,0.07142857142857142,13,13,CTCGATCACCGTGCCGGGGT,0,843371
dgoRp,0.07142857142857142,13,13,CTCATAGGCGCAGGTCTTGG,0,864217
dgoRp,0.07142857142857142,13,13,CTACTATGGGATCAGGCCGC,0,839141
dgoRp,0.07142857142857142,13,13,CTACAGATATTATTGCGCAA,0,862671
dgoRp,0.07142857142857142,13,13,CTACACGGGCACAGGCAGAA,0,863868
dgoRp,0.07142857142857142,13,13,CGTTGCTACTTTCATACGAA,0,862290
dgoRp,0.07142857142857142,13,13,CGTTAGAACCTGACAGTTTG,0,860894
dgoRp,0.07142857142857142,13,13,CGTGGGAATCCAGTCACGAA,0,850602
dgoRp,0.07142857142857142,13,13,CGTGAAGAATGTCGCATAAG,0,840595
dgoRp,0.07142857142857142,13,13,CGTCGTACCCAAATCAGTGG,0,855925
dgoRp,0.07142857142857142,13,13,CGTCACGTGAACGGTTTGGA,0,850697
dgoRp,0.07142857142857142,13,13,CGTAGCAAATGTACAATATC,0,837658
dgoRp,0.07142857142857142,13,13,CGTAATGTCTCACATTTTAT,0,840502
dgoRp,0.07142857142857142,13,13,CGGGGGGCCTGTATGTAGTA,0,846183
dgoRp,0.07142857142857142,13,13,CGGATCCGCCGGGCTTTCGA,0,863103
dgoRp,0.07142857142857142,13,13,CGGATCCCACACTGCGTCAT,0,842948
dgoRp,0.07142857142857142,13,13,CGCTGGGTAAATTCCTGTCC,0,839525
dgoRp,0.07142857142857142,13,13,CGCACCAGGTTCGTGACTGC,0,845997
dgoRp,0.07142857142857142,13,13,CGATAGGAACCCTGGCTAAG,0,863761
dgoRp,0.07142857142857142,13,13,CGACTAGGACAATTGTAAGG,0,837741
dgoRp,0.07142857142857142,13,13,CGAATGGATGGTGCGAGCCT,0,851766
dgoRp,0.07142857142857142,13,13,CCGTACTACAAGACGGGCGT,0,855370
dgoRp,0.07142857142857142,13,13,CCGGACATGGGAGGGCACGG,0,860118
dgoRp,0.07142857142857142,13,13,CCGGAATTCATGGGCCACCT,0,837296
dgoRp,0.07142857142857142,13,13,CCGCACATCCCGCCCGTAGA,0,839931
dgoRp,0.07142857142857142,13,13,CCCAGGGGACACCATTCCGG,0,857487
dgoRp,0.07142857142857142,13,13,CCAACAACGGGTATGTAAAA,0,857958
dgoRp,0.07142857142857142,13,13,CCAAATATGGTGCTGCTGCG,0,850908
dgoRp,0.07142857142857142,13,13,CATAGAAGGAAGTAATGAGA,0,859459
dgoRp,0.07142857142857142,13,13,CAGGCGAAATACTAATGATA,0,854006
dgoRp,0.07142857142857142,13,13,CAGGATCCAGGTCTCTCGAC,0,849709
dgoRp,0.07142857142857142,13,13,CAGCGCTCCCCCACCTGGTT,0,843093
dgoRp,0.07142857142857142,13,13,CAGAAGCGCGACTGGCGTAG,0,836333
dgoRp,0.07142857142857142,13,13,CACTTTGACACGGCTTCCCG,0,860376
dgoRp,0.07142857142857142,13,13,CAAGTACTACCTACGTTTTG,0,855976
dgoRp,0.07142857142857142,13,13,CAAATCACTCTAATACGTGA,0,839503
dgoRp,0.07142857142857142,13,13,ATTTCAGATACGGTTGTTTA,0,837165
dgoRp,0.07142857142857142,13,13,ATTATAAACGCGTTCCAGAC,0,842643
dgoRp,0.07142857142857142,13,13,ATTAATATAATTTCCAACTA,0,838544
dgoRp,0.07142857142857142,13,13,ATGTCACGTATATCAGGCGT,0,865681
dgoRp,0.07142857142857142,13,13,ATGCGGCTATTGTTTTCTAG,0,837661
dgoRp,0.07142857142857142,13,13,ATGCCCGGGTACACATGTCA,0,856202
dgoRp,0.07142857142857142,13,13,ATCTCGTACCATGGTGGGAT,0,846598
dgoRp,0.07142857142857142,13,13,ATCGTATATGCTTAAGGTAA,0,859171
dgoRp,0.07142857142857142,13,13,ATCGAATAGTTTCTCAATAT,0,866387
dgoRp,0.07142857142857142,13,13,ATCAGGGCCAAGATAATTCA,0,863993
dgoRp,0.07142857142857142,13,13,ATCACACCCAGGTAGTCTAC,0,844098
dgoRp,0.07142857142857142,13,13,ATACTTATCCGTTCGTGTAA,0,852304
dgoRp,0.07142857142857142,13,13,ATACACGACTGGAGCAAGCA,0,855523
dgoRp,0.07142857142857142,13,13,AGGGTTTGAGCTCTGCTACT,0,847326
dgoRp,0.07142857142857142,13,13,AGGCTGCCGTTATACAGTTT,0,838535
dgoRp,0.07142857142857142,13,13,AGGATTCATTGTCTCCCTGA,0,841819
dgoRp,0.07142857142857142,13,13,AGCTACCCTTGGTTCGCCAT,0,855436
dgoRp,0.07142857142857142,13,13,AGACTCGAGACTGTATTTGA,0,859211
dgoRp,0.07142857142857142,13,13,AGAACTTCCGTTTAGGCTCA,0,842819
dgoRp,0.07142857142857142,13,13,ACTTCGCACCGGTGATTGAT,0,845905
dgoRp,0.07142857142857142,13,13,ACGTCGTCGATGTTTCACCC,0,847156
dgoRp,0.07142857142857142,13,13,ACGATGGACATTAGGGGCGT,0,866354
dgoRp,0.07142857142857142,13,13,ACCTTAATTTAGGGTCGTTG,0,849643
dgoRp,0.07142857142857142,13,13,ACCGCACCTGCTATGTGTAA,0,844413
dgoRp,0.07142857142857142,13,13,ACCCAAAGTGGGCGACTACC,0,845760
dgoRp,0.07142857142857142,13,13,ACCAATGGAAGCAAATGCTT,0,865878
dgoRp,0.07142857142857142,13,13,ACATTCACCGCTTCTTCTCA,0,858312
dgoRp,0.07142857142857142,13,13,ACAGAGTTGAGGTCAGACGT,0,841168
dgoRp,0.07142857142857142,13,13,AATTTGAATGGCTGCTTACA,0,852181
dgoRp,0.07142857142857142,13,13,AATGATCTGTCAGAGGTTTA,0,841417
dgoRp,0.07142857142857142,13,13,AATGATCACTTAGCGCTTTG,0,850296
dgoRp,0.07142857142857142,13,13,AATCGTATAGGGTCGGTTCG,0,836109
dgoRp,0.07142857142857142,13,13,AAGCTCTAAAAAGAAGTAGG,0,867068
dgoRp,0.07142857142857142,13,13,AAGAGCTTCTCTAAATTTAA,0,855280
dgoRp,0.07142857142857142,13,13,AAGACGTCCCGGCTTCAAGT,0,845580
dgoRp,0.07142857142857142,13,13,AACTGCTGTCGCCACCCTTA,0,854670
dgoRp,0.07142857142857142,13,13,AACGGAGGAGTTACACGCGC,0,859555
dgoRp,0.07142857142857142,13,13,AACGACTGACCAAGGTTAAG,0,854450
dgoRp,0.07142857142857142,13,13,AAAGCCGGCTCAATTGGATA,0,837752
dgoRp,0.07692307692307693,12,12,TTTTTGGGGCCTACGTGATC,0,847695
dgoRp,0.07692307692307693,12,12,TTTGTACGAGGTTAGTTAGT,0,843056
dgoRp,0.07692307692307693,12,12,TTGTCACCGTAAAGCTGGCC,0,859554
dgoRp,0.07692307692307693,12,12,TTGAATGTAAATATTTCGGA,0,857108
dgoRp,0.07692307692307693,12,12,TTCAGACGTCATACCTGGCT,0,855666
dgoRp,0.07692307692307693,12,12,TTAGACGCTACCGTGCGGCA,0,854624
dgoRp,0.07692307692307693,12,12,TTACCCTTCAGTAGGATCGG,0,853843
dgoRp,0.07692307692307693,12,12,TGTAGAACCGCTGCTAGTTA,0,851218
dgoRp,0.07692307692307693,12,12,TGGGAGCAGGCTGCGGCCAT,0,836518
dgoRp,0.07692307692307693,12,12,TGCTAGAAGTTAGCCAAAAA,0,840934
dgoRp,0.07692307692307693,12,12,TGCGCCGGTTTTCGGGACCT,0,843460
dgoRp,0.07692307692307693,12,12,TGATTGGATCGATGTGCTTA,0,842261
dgoRp,0.07692307692307693,12,12,TGATGCATATTTCTGCGGTT,0,837498
dgoRp,0.07692307692307693,12,12,TCTGTCGCTCAGCGCTAGTA,0,852559
dgoRp,0.07692307692307693,12,12,TCGGCACGATGATTGTCGCG,0,845048
dgoRp,0.07692307692307693,12,12,TCGCTCCTGGAAGAGAGCTA,0,841757
dgoRp,0.07692307692307693,12,12,TCGACACGAACTCCGGAGAA,0,862848
dgoRp,0.07692307692307693,12,12,TCGAAAGGTAAAGCAAGAAC,0,861116
dgoRp,0.07692307692307693,12,12,TCCCTAGTTCTCCCCAGTAG,0,853660
dgoRp,0.07692307692307693,12,12,TCCCGTCACATAGCCGATGC,0,844324
dgoRp,0.07692307692307693,12,12,TCATGTCATCTAAGACGGGT,0,865483
dgoRp,0.07692307692307693,12,12,TCAGTCCGGCGGGGCATGAC,0,850953
dgoRp,0.07692307692307693,12,12,TCAATGCAAGGAAAATGAGT,0,856366
dgoRp,0.07692307692307693,12,12,TATTGTGCCGGTCTCCGCGT,0,854194
dgoRp,0.07692307692307693,12,12,TATCGATGGTTCGCTCAGCG,0,852626
dgoRp,0.07692307692307693,12,12,TATAAGCTAATAGCTCCGGT,0,851911
dgoRp,0.07692307692307693,12,12,TAGGCTCGGGAGCCCGTGGT,0,848152
dgoRp,0.07692307692307693,12,12,TAGGCCTAGTCCACCAGACC,0,842980
dgoRp,0.07692307692307693,12,12,TACCAAAGCCGGTATTTAAT,0,839071
dgoRp,0.07692307692307693,12,12,TACAGCTCGTAACGTCTTCC,0,848270
dgoRp,0.07692307692307693,12,12,TAATTCGAAGTCATTGGGCG,0,846145
dgoRp,0.07692307692307693,12,12,TAATGACTATTGACCTGGTC,0,850939
dgoRp,0.07692307692307693,12,12,GTTTACTCTTATGAGTCGGA,0,862351
dgoRp,0.07692307692307693,12,12,GTTGTTCTGCCAGTTTATGT,0,837517
dgoRp,0.07692307692307693,12,12,GTTAGCTACTCATCCGTGAA,0,835998
dgoRp,0.07692307692307693,12,12,GTGTGATGCACATGTGTAAT,0,851398
dgoRp,0.07692307692307693,12,12,GTGGGGATTAGGATCGACTG,0,851208
dgoRp,0.07692307692307693,12,12,GTCGCGGATGAAGACTTCTC,0,836138
dgoRp,0.07692307692307693,12,12,GTCACCACTGAACAACGGGA,0,840001
dgoRp,0.07692307692307693,12,12,GTATGTTTCTGGTAGATCCT,0,866578
dgoRp,0.07692307692307693,12,12,GTAGTCGATTCGTAAGGCGC,0,865116
dgoRp,0.07692307692307693,12,12,GTACTCTTCAGATGTGGGCT,0,840098
dgoRp,0.07692307692307693,12,12,GTACCACGCCGGCGGACCAG,0,862640
dgoRp,0.07692307692307693,12,12,GGTTTGTCTTTCTTGTTAGA,0,848220
dgoRp,0.07692307692307693,12,12,GGTGGACTGTCCTTTGGAGA,0,847351
dgoRp,0.07692307692307693,12,12,GGGATACAGTCAGAGCATAT,0,854045
dgoRp,0.07692307692307693,12,12,GGCGGAAGGCTTACAGGAAG,0,849324
dgoRp,0.07692307692307693,12,12,GGCCTCCATGTTTAGCGCGC,0,855866
dgoRp,0.07692307692307693,12,12,GGCATTGACCAAAGTCAAGT,0,845330
dgoRp,0.07692307692307693,12,12,GGCACGCACCGAAGGCCCAA,0,841871
dgoRp,0.07692307692307693,12,12,GGAGGTCGCTTGCCTATGTG,0,850850
dgoRp,0.07692307692307693,12,12,GGAAAGTCGGAAATGACAAC,0,862981
dgoRp,0.07692307692307693,12,12,GCTTGGGGCCTCGGGGGCTT,0,841772
dgoRp,0.07692307692307693,12,12,GCTCCATGGCAATGAACAAC,0,840621
dgoRp,0.07692307692307693,12,12,GCTCAATCGGATGTGATTCC,0,862868
dgoRp,0.07692307692307693,12,12,GCTATATTAACAGTTAGACC,0,843461
dgoRp,0.07692307692307693,12,12,GCGGGGGTAACTCAAAGGAC,0,846423
dgoRp,0.07692307692307693,12,12,GCGCTGCCCTGCCTTATGAC,0,857883
dgoRp,0.07692307692307693,12,12,GCCGTCGGACCTAGGCTCGC,0,856276
dgoRp,0.07692307692307693,12,12,GCCCGGGGGCGACACAAGGT,0,854922
dgoRp,0.07692307692307693,12,12,GCCCATCTGACACTCTTCTA,0,865882
dgoRp,0.07692307692307693,12,12,GCCATTCCGCAATGACAGCT,0,848111
dgoRp,0.07692307692307693,12,12,GCATGCGATGACTGTACAGT,0,846058
dgoRp,0.07692307692307693,12,12,GCATATTAGCGTTAGTACGC,0,842229
dgoRp,0.07692307692307693,12,12,GCAGAGCGTAGGAAAAATTG,0,860790
dgoRp,0.07692307692307693,12,12,GCACCGGCGGGGTTCATTAA,0,863236
dgoRp,0.07692307692307693,12,12,GATGTTCCCAATTTCTCCTG,0,842808
dgoRp,0.07692307692307693,12,12,GATGGTACTTGTGTGGGTTC,0,848721
dgoRp,0.07692307692307693,12,12,GATGAGTAAGCGACCATATT,0,843028
dgoRp,0.07692307692307693,12,12,GAGGTGGCGCGTAAGTCAAC,0,859017
dgoRp,0.07692307692307693,12,12,GAGAGTAAACCCATGTAACC,0,837035
dgoRp,0.07692307692307693,12,12,GACTCTGAACTTCAATGGGT,0,862684
dgoRp,0.07692307692307693,12,12,GACCAAACTTGGAGAGGTCC,0,843123
dgoRp,0.07692307692307693,12,12,GAATGCGCTGCGCACCCTTT,0,840040
dgoRp,0.07692307692307693,12,12,CTTTGCGTCCTCGCCGCAAC,0,857848
dgoRp,0.07692307692307693,12,12,CTTATCATTCGGTTATGCAG,0,844741
dgoRp,0.07692307692307693,12,12,CTTACTTTCCGATGACGGCC,0,845074
dgoRp,0.07692307692307693,12,12,CTTACAGCACCCTACCTGCT,0,857208
dgoRp,0.07692307692307693,12,12,CTGTATACATCATTGAGACA,0,863225
dgoRp,0.07692307692307693,12,12,CTGATTTTGTGCCCAGATAC,0,863726
dgoRp,0.07692307692307693,12,12,CTGATGGAAGTAGTACCGAA,0,839818
dgoRp,0.07692307692307693,12,12,CTCGTTGAGCCCGACTGACG,0,866347
dgoRp,0.07692307692307693,12,12,CTCAGATTAGACTTCGGGTT,0,843256
dgoRp,0.07692307692307693,12,12,CTAGAGCCATATAAAACTTC,0,853782
dgoRp,0.07692307692307693,12,12,CTAGAGCAATCTACCTCATG,0,846142
dgoRp,0.07692307692307693,12,12,CGTTACCAAAGGGCAGGACA,0,853325
dgoRp,0.07692307692307693,12,12,CGTGTTACGGGCGCCTTGGT,0,840740
dgoRp,0.07692307692307693,12,12,CGTGCGTTTTCCGGGCTGTT,0,845142
dgoRp,0.07692307692307693,12,12,CGTCCCACTTAATCACCACC,0,863535
dgoRp,0.07692307692307693,12,12,CGTAGCATCCCGCTGGTTGT,0,841938
dgoRp,0.07692307692307693,12,12,CGCCTGGCGAGTTAACTAAG,0,866604
dgoRp,0.07692307692307693,12,12,CGCCGGACTATTAGGACGTC,0,848288
dgoRp,0.07692307692307693,12,12,CGCCCGCGGGGTTCTGTCAA,0,850536
dgoRp,0.07692307692307693,12,12,CGCAAACCGAAGTAGTGCCT,0,864665
dgoRp,0.07692307692307693,12,12,CGACCTCGACAGGTTACTCG,0,841094
dgoRp,0.07692307692307693,12,12,CCTTCCAGCTAGAACAGCGA,0,858349
dgoRp,0.07692307692307693,12,12,CCTGTCCCTCTTAATCAGCT,0,856219
dgoRp,0.07692307692307693,12,12,CCGTTGTGTGCAAGGAAGGG,0,857051
dgoRp,0.07692307692307693,12,12,CCGCCCAATAGCTACGTAAT,0,863044
dgoRp,0.07692307692307693,12,12,CCGCAGAAAGAGTAGTCTGA,0,861622
dgoRp,0.07692307692307693,12,12,CCGATTATTGCAATGCACGT,0,844152
dgoRp,0.07692307692307693,12,12,CCGACATAATTTCGAAAATG,0,864342
dgoRp,0.07692307692307693,12,12,CCCTCCTCATCCGCACCCAA,0,844742
dgoRp,0.07692307692307693,12,12,CCCGTGCCCCCGGAGCCTGT,0,843641
dgoRp,0.07692307692307693,12,12,CCATGGAAGATCCGCCCCTA,0,851958
dgoRp,0.07692307692307693,12,12,CCAGCTTCAAACGATATGCA,0,863591
dgoRp,0.07692307692307693,12,12,CCAGAACCTAGACACCTCAA,0,840914
dgoRp,0.07692307692307693,12,12,CATGCGCCTCAACCACGATG,0,864561
dgoRp,0.07692307692307693,12,12,CATCCTAGTCCCCTACTTGC,0,855680
dgoRp,0.07692307692307693,12,12,CAGGCCTGTAACCGCGACAG,0,839401
dgoRp,0.07692307692307693,12,12,CAGAGTAGAGAACGGTTCAT,0,866039
dgoRp,0.07692307692307693,12,12,CACGATATCCGATGAGGATC,0,846770
dgoRp,0.07692307692307693,12,12,CACCTCGGATCCTTGATGCG,0,838829
dgoRp,0.07692307692307693,12,12,CACATCCCACTAAATACTAA,0,852930
dgoRp,0.07692307692307693,12,12,CACACACAGTAAGACAGGAG,0,846897
dgoRp,0.07692307692307693,12,12,CAATAGAGCTCGGTCATGGA,0,852998
dgoRp,0.07692307692307693,12,12,CAAGCGAGGAAGGAGGTCTG,0,851324
dgoRp,0.07692307692307693,12,12,CAAACACGACTATGTTAGCA,0,866272
dgoRp,0.07692307692307693,12,12,ATTTGGTGCTGGGATAACGA,0,854587
dgoRp,0.07692307692307693,12,12,ATTTGCGAAGCATCGTGTAC,0,856043
dgoRp,0.07692307692307693,12,12,ATTGGACTGTGCACTCGGCA,0,843291
dgoRp,0.07692307692307693,12,12,ATGTACGGCATACCTCAGTG,0,861056
dgoRp,0.07692307692307693,12,12,ATGGCAATGGTGTTGAAGCT,0,841195
dgoRp,0.07692307692307693,12,12,ATGCAGTGAGAGAACACTCT,0,860816
dgoRp,0.07692307692307693,12,12,ATCTTCGCACTCAGCGTGGA,0,836341
dgoRp,0.07692307692307693,12,12,ATCTATTGGCCACTCGACAG,0,855336
dgoRp,0.07692307692307693,12,12,ATCGTCCATGGCTGGGTAGT,0,838060
dgoRp,0.07692307692307693,12,12,ATCCTCTGTCAGAAAGTCGC,0,838491
dgoRp,0.07692307692307693,12,12,ATAGGCGTTAACTCAAATTC,0,843395
dgoRp,0.07692307692307693,12,12,ATAGCGGTTTTTCCACACTC,0,845005
dgoRp,0.07692307692307693,12,12,ATACCACCCACTGGATTGTG,0,863710
dgoRp,0.07692307692307693,12,12,AGTTGATTCTTCACGACATA,0,857404
dgoRp,0.07692307692307693,12,12,AGTTCTCCGTGTGGCAAGTT,0,859761
dgoRp,0.07692307692307693,12,12,AGGGTTGTTGTGAGAGGCTT,0,843861
dgoRp,0.07692307692307693,12,12,AGGGTGAGCTATAAATAGGA,0,848343
dgoRp,0.07692307692307693,12,12,AGGGGCTCCGTACCGTTCGC,0,858004
dgoRp,0.07692307692307693,12,12,AGGCTGAGAGTCTTAGTCAC,0,856373
dgoRp,0.07692307692307693,12,12,AGGCGAGCAGGAGTCAGCAT,0,852718
dgoRp,0.07692307692307693,12,12,AGGACATCTCTTATTAATTA,0,849104
dgoRp,0.07692307692307693,12,12,AGCTCCCCCTGCGGAAATGC,0,856352
dgoRp,0.07692307692307693,12,12,AGCTAAACCATGGTGCACCA,0,845916
dgoRp,0.07692307692307693,12,12,AGCGACTGGTTTAAACACTC,0,865767
dgoRp,0.07692307692307693,12,12,AGCACGCCCGACAGCGTGAT,0,848366
dgoRp,0.07692307692307693,12,12,AGACCTCTACGCCGTAACTT,0,839781
dgoRp,0.07692307692307693,12,12,ACTCTAGGGGGACTATAAAC,0,842544
dgoRp,0.07692307692307693,12,12,ACGTGCACCTGTGATACCAA,0,862243
dgoRp,0.07692307692307693,12,12,ACCTTTAGAGTGTATATCTT,0,840743
dgoRp,0.07692307692307693,12,12,ACCTCACTGGCGGGTTAGGC,0,859836
dgoRp,0.07692307692307693,12,12,ACCCTAAGAGAGTACCGTAA,0,856280
dgoRp,0.07692307692307693,12,12,ACATTATTTCGTCGCGGAAA,0,857397
dgoRp,0.07692307692307693,12,12,ACATTAGAAATACGCAAGTT,0,842054
dgoRp,0.07692307692307693,12,12,ACATCGAGCGTGTAAACTGA,0,837999
dgoRp,0.07692307692307693,12,12,ACACGTGATGATTTTTGAGT,0,843496
dgoRp,0.07692307692307693,12,12,ACAATTCGACCACGGGAATT,0,837769
dgoRp,0.07692307692307693,12,12,ACAACGGAGACTCCTCAAGT,0,846773
dgoRp,0.07692307692307693,12,12,AATGTATGTGGAAATGGGTA,0,846067
dgoRp,0.07692307692307693,12,12,AATATTTGTCTATCCGAGTT,0,867114
dgoRp,0.07692307692307693,12,12,AAGAATATCAGATCGTCTAG,0,857358
dgoRp,0.07692307692307693,12,12,AACTTATGCAAACGTGAGCT,0,862966
dgoRp,0.07692307692307693,12,12,AACTGTAGGACAGGGAGGAG,0,837000
dgoRp,0.07692307692307693,12,12,AAATAGAAGCTTAGACACCA,0,846658
dgoRp,0.07692307692307693,12,12,AAACGGTGTCTCATCAGGTT,0,859332
dgoRp,0.08333333333333333,11,11,TTGTGGAGCAACCAACGTAA,0,847551
dgoRp,0.08333333333333333,11,11,TTGTCAAGACGCCCTGAGAG,0,851367
dgoRp,0.08333333333333333,11,11,TTGTACATATTAAATACGCA,0,853673
dgoRp,0.08333333333333333,11,11,TTGGGGACAATCGCGAACTG,0,864081
dgoRp,0.08333333333333333,11,11,TTCTTGCATCTTTACGTAAC,0,864945
dgoRp,0.08333333333333333,11,11,TTCGTGCAAAGCTATTGCTC,0,854333
dgoRp,0.08333333333333333,11,11,TTCGATAGTCGAACATAGAT,0,851193
dgoRp,0.08333333333333333,11,11,TTCCACACAGCTAAAGTGCT,0,860042
dgoRp,0.08333333333333333,11,11,TTCCAACTAAGAGATCGGGA,0,847673
dgoRp,0.08333333333333333,11,11,TTCACGAAGGTTTAGTCTTG,0,841617
dgoRp,0.08333333333333333,11,11,TTAGCCACCTACCATTTAGT,0,853348
dgoRp,0.08333333333333333,11,11,TTAGAAATATTGACATACCA,0,856588
dgoRp,0.08333333333333333,11,11,TTACTTACCGGCCACTAATG,0,844061
dgoRp,0.08333333333333333,11,11,TTACGATGCCTCGTATGGTT,0,856691
dgoRp,0.08333333333333333,11,11,TTAAGAGACGTGCGGGCGCG,0,857340
dgoRp,0.08333333333333333,11,11,TGTTGAGTTTTACGAGGAGA,0,857217
dgoRp,0.08333333333333333,11,11,TGTTCATTAATTTCGCTCTT,0,845694
dgoRp,0.08333333333333333,11,11,TGTGTGTCAGCCGCTTACCA,0,860881
dgoRp,0.08333333333333333,11,11,TGTCAACGCCAAACGATCCT,0,840075
dgoRp,0.08333333333333333,11,11,TGTAATGTTGCTGTTCTGCA,0,842595
dgoRp,0.08333333333333333,11,11,TGGGTCAAAGTCAAACTTCA,0,848566
dgoRp,0.08333333333333333,11,11,TGGGGGGGAATCACTTTTGG,0,845557
dgoRp,0.08333333333333333,11,11,TGGCCCCTGGAAAATAACTC,0,865632
dgoRp,0.08333333333333333,11,11,TGGAAGTGCTTTGTGCCATC,0,842308
dgoRp,0.08333333333333333,11,11,TGCGGGGACGTCCAGATCAG,0,849064
dgoRp,0.08333333333333333,11,11,TGCCAGTGATGCGCACATAA,0,857791
dgoRp,0.08333333333333333,11,11,TGCAACTTCAACAGGGCAAA,0,844738
dgoRp,0.08333333333333333,11,11,TGCAAAGAAGCACATTGTCA,0,859115
dgoRp,0.08333333333333333,11,11,TGATGTACGGATATCTGGAC,0,862683
dgoRp,0.08333333333333333,11,11,TGAGAATGCTTCATGACCAG,0,854035
dgoRp,0.08333333333333333,11,11,TGAAGGCCGAGTACTCCTCG,0,847728
dgoRp,0.08333333333333333,11,11,TGAAACGCCCGGACGGGCTA,0,844397
dgoRp,0.08333333333333333,11,11,TGAAAAAGGGTGCTGACGGT,0,849603
dgoRp,0.08333333333333333,11,11,TCTTCCGATGCGCTCACAGT,0,836394
dgoRp,0.08333333333333333,11,11,TCTGCCAGACCTCTGCAACC,0,855130
dgoRp,0.08333333333333333,11,11,TCGTAGCTCCCGGAATGCGG,0,842295
dgoRp,0.08333333333333333,11,11,TCGGCTTCATTGCTCTGATA,0,854870
dgoRp,0.08333333333333333,11,11,TCGGACCTTAACCCGCAATG,0,858193
dgoRp,0.08333333333333333,11,11,TCGCTGAATTGAATAATACT,0,861938
dgoRp,0.08333333333333333,11,11,TCGCCCGGGCCGTCATAATC,0,866417
dgoRp,0.08333333333333333,11,11,TCGATTAGCACCGCGCCTGA,0,850090
dgoRp,0.08333333333333333,11,11,TCGAAGGCCTGTGTGGGCGC,0,841635
dgoRp,0.08333333333333333,11,11,TCCGGGCACTTACGAATCTA,0,858626
dgoRp,0.08333333333333333,11,11,TCCGGCTTGTGTTCTTACCA,0,843774
dgoRp,0.08333333333333333,11,11,TCATATCTAGGAGTTCAAGA,0,837141
dgoRp,0.08333333333333333,11,11,TCACGCGTACTACTACCTAG,0,835977
dgoRp,0.08333333333333333,11,11,TCACAGAGGATGACAAGGCA,0,839705
dgoRp,0.08333333333333333,11,11,TCAACGGCGGTGCGAACCAT,0,854739
dgoRp,0.08333333333333333,11,11,TCAAAAACTTTAGTTGCAGC,0,849459
dgoRp,0.08333333333333333,11,11,TATTCTCCGTGCGTACAGTT,0,850361
dgoRp,0.08333333333333333,11,11,TATTATGTGTAATTTCTACG,0,849718
dgoRp,0.08333333333333333,11,11,TATGCAATTGAATGCAGAAT,0,863925
dgoRp,0.08333333333333333,11,11,TATATTGTAGCCAAGTGTAT,0,844239
dgoRp,0.08333333333333333,11,11,TATATGCTATGGTGCATGGA,0,852800
dgoRp,0.08333333333333333,11,11,TAGGGGCTGCAACGCTATTA,0,863481
dgoRp,0.08333333333333333,11,11,TAGCTGGTCTGGTAAATGAA,0,857931
dgoRp,0.08333333333333333,11,11,TAGCGATCGTTGCTAGTAGC,0,866096
dgoRp,0.08333333333333333,11,11,TAGCAGCCTGGGACTCCGGT,0,844963
dgoRp,0.08333333333333333,11,11,TACGCAGCAAGACTCCTTAG,0,862068
dgoRp,0.08333333333333333,11,11,TACAGCGATTACCGGCTTTT,0,855007
dgoRp,0.08333333333333333,11,11,TAACTTTCCAAGATCGTAAG,0,843023
dgoRp,0.08333333333333333,11,11,GTTGCAAGAAGAGGGTCCGT,0,854073
dgoRp,0.08333333333333333,11,11,GTTCCTTCCGGTGTTCAGAT,0,839334
dgoRp,0.08333333333333333,11,11,GTGTAAGGGTTGGCCGAACT,0,850728
dgoRp,0.08333333333333333,11,11,GTGGGGGCTAGGATGTCTGA,0,859271
dgoRp,0.08333333333333333,11,11,GTGGCATATTCAGGAGCTAG,0,856963
dgoRp,0.08333333333333333,11,11,GTGCCGTTCGGGCATAAAGA,0,859312
dgoRp,0.08333333333333333,11,11,GTGCCCATGCGGCGTGTTCA,0,848157
dgoRp,0.08333333333333333,11,11,GTGCAGGCGATCCCCATCTT,0,861732
dgoRp,0.08333333333333333,11,11,GTCGGGTTCGTATACAGGCT,0,863023
dgoRp,0.08333333333333333,11,11,GTCCCCCTCGTTGGGGCGGC,0,863547
dgoRp,0.08333333333333333,11,11,GTAGCACGCGGGAACTAGGT,0,849438
dgoRp,0.08333333333333333,11,11,GTACGTCAACATCGTAGATG,0,851727
dgoRp,0.08333333333333333,11,11,GTACACAGCGTCCTCTGTTT,0,838055
dgoRp,0.08333333333333333,11,11,GTAACGGCCGTACGGGGTCG,0,861647
dgoRp,0.08333333333333333,11,11,GGTTTACTGGTGTTTCGTAC,0,849005
dgoRp,0.08333333333333333,11,11,GGTTATTCCAGGCTTGCCAG,0,861579
dgoRp,0.08333333333333333,11,11,GGGTTGCGTGAGCTACACAT,0,858786
dgoRp,0.08333333333333333,11,11,GGGTTCTTGCTGTGCACAGT,0,859918
dgoRp,0.08333333333333333,11,11,GGGGATGACGGGTGAGATCG,0,857939
dgoRp,0.08333333333333333,11,11,GGGCCTGAGGTCCTCATAAT,0,862544
dgoRp,0.08333333333333333,11,11,GGCTGACATTCAATAAGACG,0,848016
dgoRp,0.08333333333333333,11,11,GGCTAACCGTTTTAATTCCT,0,865760
dgoRp,0.08333333333333333,11,11,GGCGGTGAGCGTCTCCGGCC,0,866739
dgoRp,0.08333333333333333,11,11,GGCACAAGCATGAATTTCGT,0,863499
dgoRp,0.08333333333333333,11,11,GGCAAGGTTGCCTGTATCGT,0,857071
dgoRp,0.08333333333333333,11,11,GGATGAGCAGCTATGTTACG,0,859772
dgoRp,0.08333333333333333,11,11,GGACGCAGTTCAGTCCCTGC,0,840893
dgoRp,0.08333333333333333,11,11,GGAATGAGTGCTCCATGACG,0,859456
dgoRp,0.08333333333333333,11,11,GGAATAGCCGGTAATGGCTT,0,852310
dgoRp,0.08333333333333333,11,11,GGAAGAGAGCCGGCCCGTGT,0,855618
dgoRp,0.08333333333333333,11,11,GCTTATAATCAAGGCGCCAC,0,855334
dgoRp,0.08333333333333333,11,11,GCTCGACCTGATCAACTACT,0,843414
dgoRp,0.08333333333333333,11,11,GCTATTGGGCCAGTGTTTCA,0,856474
dgoRp,0.08333333333333333,11,11,GCGTTTTGAGTGGAAAGTGT,0,860683
dgoRp,0.08333333333333333,11,11,GCGTACTGTTCGCGGCAATG,0,839199
dgoRp,0.08333333333333333,11,11,GCGCTCACGTGCACGCATAG,0,839339
dgoRp,0.08333333333333333,11,11,GCGCCTCATGAATATTTGCT,0,857065
dgoRp,0.08333333333333333,11,11,GCGCAACGCTGGCGTGACTG,0,857141
dgoRp,0.08333333333333333,11,11,GCGATGTTCGGTCATTTTAT,0,858128
dgoRp,0.08333333333333333,11,11,GCCCTGGCCGGACATATAAC,0,856357
dgoRp,0.08333333333333333,11,11,GCCACATGATGGACTCTTGC,0,857580
dgoRp,0.08333333333333333,11,11,GCCACACCAGCGAGCATGCA,0,850217
dgoRp,0.08333333333333333,11,11,GCAGAAACGGCCGCTGAATC,0,838172
dgoRp,0.08333333333333333,11,11,GATTGTATCGAACCCTCCGA,0,852246
dgoRp,0.08333333333333333,11,11,GATCTTCGTAATTCGGTCTA,0,838239
dgoRp,0.08333333333333333,11,11,GATCACAACGGAGGGAGTGC,0,845942
dgoRp,0.08333333333333333,11,11,GAGTCCGGCTCGTGGTAACT,0,838547
dgoRp,0.08333333333333333,11,11,GAGTACGCACTGCTCTAGGC,0,853502
dgoRp,0.08333333333333333,11,11,GAGATCATGTGTGTTAGGTA,0,840936
dgoRp,0.08333333333333333,11,11,GACGAATACATGTGTCTTCA,0,866376
dgoRp,0.08333333333333333,11,11,GACATCTCCTATGCTCATTT,0,856529
dgoRp,0.08333333333333333,11,11,GACAGTAGATATGTTGCGAT,0,866617
dgoRp,0.08333333333333333,11,11,GAATGATTACTTAACCGGGA,0,845667
dgoRp,0.08333333333333333,11,11,GAATCTCCAACGCTCGGTCT,0,849575
dgoRp,0.08333333333333333,11,11,GAATCACACGAACCAGATCG,0,841559
dgoRp,0.08333333333333333,11,11,GAACCTCCGTGGACGTCAAT,0,859647
dgoRp,0.08333333333333333,11,11,CTTTGGTATAGTGGAGATAA,0,844305
dgoRp,0.08333333333333333,11,11,CTTGTCGGTAATTTGTTCCA,0,839200
dgoRp,0.08333333333333333,11,11,CTTCTTGGACCAGACCTGTT,0,842473
dgoRp,0.08333333333333333,11,11,CTGCAATAGTTCGTAAAAGT,0,857617
dgoRp,0.08333333333333333,11,11,CTGAACCCGTGACTCACTGC,0,839341
dgoRp,0.08333333333333333,11,11,CTCCGAGCCGATTGTTAGTG,0,845710
dgoRp,0.08333333333333333,11,11,CTCAGGGTTCGGGGGTTACT,0,866537
dgoRp,0.08333333333333333,11,11,CTAAAAGGATCCGGCACTGC,0,857415
dgoRp,0.08333333333333333,11,11,CGTTTATAATTTTCTCTCAT,0,839291
dgoRp,0.08333333333333333,11,11,CGTTGATCGCTTTAAATGCT,0,846659
dgoRp,0.08333333333333333,11,11,CGTTCTGACACCTTACTAAA,0,856034
dgoRp,0.08333333333333333,11,11,CGTGGAAGTCCACGCCGATT,0,846618
dgoRp,0.08333333333333333,11,11,CGGGGCCGTGCGGGACGGCT,0,864460
dgoRp,0.08333333333333333,11,11,CGGCACGTGCTTAACTCCAT,0,845023
dgoRp,0.08333333333333333,11,11,CGCTTACTTTCCAAGGGATG,0,857031
dgoRp,0.08333333333333333,11,11,CGCCAATTGGGAATTTTATA,0,844384
dgoRp,0.08333333333333333,11,11,CGATCGAGGGTGTCGTATGT,0,865149
dgoRp,0.08333333333333333,11,11,CGAGCGTAAGGCTGCAAACG,0,847581
dgoRp,0.08333333333333333,11,11,CGACGGGAACGTACGGCTAG,0,860563
dgoRp,0.08333333333333333,11,11,CGACCTGACTCAGTCAGTCA,0,851366
dgoRp,0.08333333333333333,11,11,CGACCGCCTGTTCAAATGCT,0,865629
dgoRp,0.08333333333333333,11,11,CCTTGGGAGCGGTGTTGTTT,0,843529
dgoRp,0.08333333333333333,11,11,CCTATCAACAAGCTCCTGTT,0,866447
dgoRp,0.08333333333333333,11,11,CCGTGTGTTAGGTGTCAGGC,0,853396
dgoRp,0.08333333333333333,11,11,CCGTGGAAGTAGGGGGTCAG,0,851959
dgoRp,0.08333333333333333,11,11,CCGTCAAGCGGCTGCGTCAT,0,867136
dgoRp,0.08333333333333333,11,11,CCGGTGGATATCTGGCCAGA,0,857811
dgoRp,0.08333333333333333,11,11,CCGCCTTTGCGGCTTGGTAG,0,857861
dgoRp,0.08333333333333333,11,11,CCCTGGGGCGAGTACCATAA,0,842077
dgoRp,0.08333333333333333,11,11,CCCGCATAATGTTGCTGCAG,0,864957
dgoRp,0.08333333333333333,11,11,CCCCGCCAAGACCCCTCGCA,0,839913
dgoRp,0.08333333333333333,11,11,CCCATTAAGCGTTCAAGTAA,0,856628
dgoRp,0.08333333333333333,11,11,CCACGGCCTAAACAAAGGAC,0,864974
dgoRp,0.08333333333333333,11,11,CCAAGTTAGGGCAGATGCAG,0,836284
dgoRp,0.08333333333333333,11,11,CCAAATCCCAGTAGTATCGA,0,859101
dgoRp,0.08333333333333333,11,11,CATCATGTCAAAGTTAGCTC,0,839563
dgoRp,0.08333333333333333,11,11,CATAATGAAGATTTGAGCAT,0,858492
dgoRp,0.08333333333333333,11,11,CAGGACGACGAGAGCTCCTT,0,851848
dgoRp,0.08333333333333333,11,11,CAGCAGGCCACAGGGAGATT,0,854279
dgoRp,0.08333333333333333,11,11,CAGCACCGTAGCGCAGCGAT,0,845732
dgoRp,0.08333333333333333,11,11,CAGACTAGCCGGTAACCCAG,0,844072
dgoRp,0.08333333333333333,11,11,CAGAATCCTCAGCACGCGGC,0,850873
dgoRp,0.08333333333333333,11,11,CAGAAGCGCACCCACGGTAG,0,842723
dgoRp,0.08333333333333333,11,11,CACCGGCATGGGTTGACCAT,0,852210
dgoRp,0.08333333333333333,11,11,CACATTAACCGCGGACCGGC,0,841139
dgoRp,0.08333333333333333,11,11,ATTGACTTGGGTATGCCAGA,0,862721
dgoRp,0.08333333333333333,11,11,ATTCGGCCTTGGGGGAGATT,0,840216
dgoRp,0.08333333333333333,11,11,ATTCCACGAGTCATTTAGTG,0,859848
dgoRp,0.08333333333333333,11,11,ATGTGTTGGCCGGAATTTCT,0,845999
dgoRp,0.08333333333333333,11,11,ATGTCTCAGAACGATATGAA,0,859491
dgoRp,0.08333333333333333,11,11,ATGCGGGTCGCTCTAGCAGG,0,866632
dgoRp,0.08333333333333333,11,11,ATGCGACTCGTATCCCCGAA,0,861032
dgoRp,0.08333333333333333,11,11,ATCTGAACTCGACCTACGAT,0,850399
dgoRp,0.08333333333333333,11,11,ATCGGCCCGGTCAAAGGGTT,0,847866
dgoRp,0.08333333333333333,11,11,ATCAGATCTGGGTAACATTC,0,856805
dgoRp,0.08333333333333333,11,11,ATCAACCTAGACTGGGCAAT,0,853622
dgoRp,0.08333333333333333,11,11,ATAGTTCCCAACCATACGGG,0,850482
dgoRp,0.08333333333333333,11,11,AGTTGGGAACCGGAACATTC,0,860643
dgoRp,0.08333333333333333,11,11,AGGGGGGCTATAGCCGGCCA,0,855939
dgoRp,0.08333333333333333,11,11,AGGCGAGAAAGTGCATGGCC,0,845789
dgoRp,0.08333333333333333,11,11,AGGCAACTACCGTCTGCTCG,0,841193
dgoRp,0.08333333333333333,11,11,AGCCCCTCAACTCCTATAGC,0,847927
dgoRp,0.08333333333333333,11,11,AGATTGACGACGAGCACCGC,0,842964
dgoRp,0.08333333333333333,11,11,AGAACCGCCCGGAAAGTCCT,0,847280
dgoRp,0.08333333333333333,11,11,ACTGGTTGTCATGGTCCTGG,0,845755
dgoRp,0.08333333333333333,11,11,ACTCAAATTAAGGGCGTTAA,0,857180
dgoRp,0.08333333333333333,11,11,ACTACAGGACGAGGGAGCGC,0,866146
dgoRp,0.08333333333333333,11,11,ACTAATGGAGGACCCGAAAA,0,847935
dgoRp,0.08333333333333333,11,11,ACGTCGTAGGCGTATTCCTT,0,854215
dgoRp,0.08333333333333333,11,11,ACGGGTTTTTCCTGGGCTGT,0,861296
dgoRp,0.08333333333333333,11,11,ACGCGGGACTGGTTTTAGAT,0,842931
dgoRp,0.08333333333333333,11,11,ACGATTTCCATGTTAAGGGA,0,843321
dgoRp,0.08333333333333333,11,11,ACCGGCCGAGCATCCCCGAA,0,861146
dgoRp,0.08333333333333333,11,11,ACCATATCTAGAGGTGTTAA,0,859533
dgoRp,0.08333333333333333,11,11,AATTGAGCCGTATGACAGAA,0,840020
dgoRp,0.08333333333333333,11,11,AATTCCAGTTCGACGAGTTT,0,862168
dgoRp,0.08333333333333333,11,11,AATGTGAAGTGAAATGTAAC,0,838300
dgoRp,0.08333333333333333,11,11,AATGAATGGCGGAAATAAGT,0,863446
dgoRp,0.08333333333333333,11,11,AATCTATCAATCAGAAACAA,0,847106
dgoRp,0.08333333333333333,11,11,AATACCGGCTGTGCATTCGG,0,858311
dgoRp,0.08333333333333333,11,11,AAGTAAACAAGCGCGTCATC,0,842708
dgoRp,0.08333333333333333,11,11,AAGGAGATGGCCCCTGATGA,0,846240
dgoRp,0.08333333333333333,11,11,AAGCACTGCATCATCTCTTT,0,857844
dgoRp,0.08333333333333333,11,11,AACTGATATTAACAGTCCAA,0,862507
dgoRp,0.08333333333333333,11,11,AACTCGAACTCTTCAGACAG,0,853606
dgoRp,0.08333333333333333,11,11,AACCTTCTACTTCATGGTGG,0,858494
dgoRp,0.08333333333333333,11,11,AACCGTAGGGTGGGAGAATT,0,853382
dgoRp,0.08333333333333333,11,11,AACAATTGTTACCAGTGGTG,0,845800
dgoRp,0.08333333333333333,11,11,AAATTTTTAGGGTGCATACA,0,862152
dgoRp,0.08333333333333333,11,11,AAAGGGAGTCAAAATCGTAA,0,866287
dgoRp,0.08333333333333333,11,11,AAACGCGTCTCAACACGGTT,0,848037
dgoRp,0.08333333333333333,11,11,AAAAGGCTGCGAAGACAGTT,0,838278
dgoRp,0.09090909090909091,10,10,TTTCTGCAACAGTTGTCACT,0,852212
dgoRp,0.09090909090909091,10,10,TTTCGGTCCATAAATCTCGT,0,861631
dgoRp,0.09090909090909091,10,10,TTGTTACCGGGGGGATGAGA,0,859593
dgoRp,0.09090909090909091,10,10,TTGTGCGGTGCATCTAGTCG,0,836775
dgoRp,0.09090909090909091,10,10,TTGTAATTGGGCAGGTGAGC,0,863476
dgoRp,0.09090909090909091,10,10,TTGGTTCTGGTAGGATTTAA,0,858174
dgoRp,0.09090909090909091,10,10,TTGGGGACATCCAAGTGTCA,0,849137
dgoRp,0.09090909090909091,10,10,TTGGCACGGGTGTAACCAAG,0,865102
dgoRp,0.09090909090909091,10,10,TTGCATGACTATCCTAAAAT,0,866037
dgoRp,0.09090909090909091,10,10,TTGATAGGTGCAGCCGGGTC,0,856999
dgoRp,0.09090909090909091,10,10,TTCTCTTTACCGGAAATCTG,0,843156
dgoRp,0.09090909090909091,10,10,TTCGGGTCAAATAAACCGTA,0,840529
dgoRp,0.09090909090909091,10,10,TTCGCTGAAGGACGGTCTGT,0,862778
dgoRp,0.09090909090909091,10,10,TTCCCGACGTTTCCCTCTAA,0,844320
dgoRp,0.09090909090909091,10,10,TTATTTTGAGTCGGCGAGGT,0,854972
dgoRp,0.09090909090909091,10,10,TTATGCCTAGGATCTCCCTG,0,846168
dgoRp,0.09090909090909091,10,10,TTAGGAGTATGCCGACCCCA,0,835903
dgoRp,0.09090909090909091,10,10,TGTTTGGGCCACGTGGGTTA,0,858545
dgoRp,0.09090909090909091,10,10,TGTGGGGGCTTTGAAACTGC,0,845396
dgoRp,0.09090909090909091,10,10,TGTGGAGCCACTGAGCGTCG,0,840335
dgoRp,0.09090909090909091,10,10,TGTGCTGACAATATGGCTAG,0,843300
dgoRp,0.09090909090909091,10,10,TGTGAATCGCTGTTGTGTCA,0,840769
dgoRp,0.09090909090909091,10,10,TGGTACCCCCCTTTGTTTGT,0,864029
dgoRp,0.09090909090909091,10,10,TGGGGAGTGTATACTGTAGT,0,854102
dgoRp,0.09090909090909091,10,10,TGCAGATAAAAAGGACTAAT,0,861667
dgoRp,0.09090909090909091,10,10,TGCAATTTTTAACGCCACGC,0,835842
dgoRp,0.09090909090909091,10,10,TGACAGCAAGGTTGTCTCCC,0,854924
dgoRp,0.09090909090909091,10,10,TGAATGGGATCGACCGGGCA,0,841903
dgoRp,0.09090909090909091,10,10,TCTTGACAGGCCGATAGGAA,0,846703
dgoRp,0.09090909090909091,10,10,TCTTATTTTACAATATCGAA,0,864803
dgoRp,0.09090909090909091,10,10,TCTGGCCCGTGACCCTATTA,0,848783
dgoRp,0.09090909090909091,10,10,TCTCGAAAGGTTTAATCTGT,0,839244
dgoRp,0.09090909090909091,10,10,TCTCCGTATTCGAATCCGTA,0,852490
dgoRp,0.09090909090909091,10,10,TCTAAGAGACCTCTAAAGCC,0,854722
dgoRp,0.09090909090909091,10,10,TCGGACGGCGGGTAAGAACA,0,852101
dgoRp,0.09090909090909091,10,10,TCGCTGACGTACTGGGCCAG,0,865749
dgoRp,0.09090909090909091,10,10,TCGACACTAAAAGTCGCGGC,0,855416
dgoRp,0.09090909090909091,10,10,TCCTCTGTGAACTCTACTTT,0,864150
dgoRp,0.09090909090909091,10,10,TCCTCGGCCTTATGGCAGGG,0,856669
dgoRp,0.09090909090909091,10,10,TCCTAGTTCACCCTTATGCT,0,840089
dgoRp,0.09090909090909091,10,10,TCCAGGTCTCCCCGGGTCCG,0,861140
dgoRp,0.09090909090909091,10,10,TCCACAGGCACTTACCGAAG,0,840669
dgoRp,0.09090909090909091,10,10,TCAATGCGCCTCGCCATCAA,0,846673
dgoRp,0.09090909090909091,10,10,TCAACGATTCACCTCTGCGG,0,852258
dgoRp,0.09090909090909091,10,10,TATCTCGGACGGTAAGGAGG,0,857656
dgoRp,0.09090909090909091,10,10,TATACAAGTAACGCCCTCCC,0,848679
dgoRp,0.09090909090909091,10,10,TAGGACGGTCAACAGCCAAC,0,846930
dgoRp,0.09090909090909091,10,10,TAGGACCGAAAAAGGCGACT,0,841750
dgoRp,0.09090909090909091,10,10,TAGGAAGCGGGATAGAGGCT,0,866964
dgoRp,0.09090909090909091,10,10,TAGCCTTTCAATCGCTCAAG,0,855040
dgoRp,0.09090909090909091,10,10,TAGCAAATCCAGACCGTTAA,0,851713
dgoRp,0.09090909090909091,10,10,TACTTGCGGTAAGAAATTAA,0,841825
dgoRp,0.09090909090909091,10,10,TACAGAACACCGTTAAAATT,0,845673
dgoRp,0.09090909090909091,10,10,TACAATCTTGTTGAGAGCCC,0,837783
dgoRp,0.09090909090909091,10,10,TAAGGAGAAAGTGTTGAATA,0,853761
dgoRp,0.09090909090909091,10,10,TAAGAGATCCGGCTTGGAGG,0,844553
dgoRp,0.09090909090909091,10,10,TAAATCCCATAACCCCTTCG,0,856737
dgoRp,0.09090909090909091,10,10,TAAAGCGAATACGTCGGCAT,0,863438
dgoRp,0.09090909090909091,10,10,GTTGGGTGGGACTAGCTGTG,0,851580
dgoRp,0.09090909090909091,10,10,GTTGAGATCTATGGACTTCG,0,858297
dgoRp,0.09090909090909091,10,10,GTTCGCGGGATTGGACCGGC,0,854196
dgoRp,0.09090909090909091,10,10,GTTCATGCCCCACAATGCAA,0,852647
dgoRp,0.09090909090909091,10,10,GTGTGTAGGAGCGGTGTTGG,0,842504
dgoRp,0.09090909090909091,10,10,GTGCGCGAAGCAGATTTTGG,0,837088
dgoRp,0.09090909090909091,10,10,GTGCAATTGCACGTTCGATG,0,849318
dgoRp,0.09090909090909091,10,10,GTCTCCACGATGAGGATCCC,0,847631
dgoRp,0.09090909090909091,10,10,GTCGAGGACTAGCACAGGAA,0,840594
dgoRp,0.09090909090909091,10,10,GTCCGGCCATGACCAAGGCA,0,853596
dgoRp,0.09090909090909091,10,10,GTAATCATGATGGGTGCATG,0,837724
dgoRp,0.09090909090909091,10,10,GTAACAAGTAAGCCACAGTG,0,845930
dgoRp,0.09090909090909091,10,10,GGTGCCCGCGAGTGCCCACT,0,840568
dgoRp,0.09090909090909091,10,10,GGTCAGGGACCAGGGACACA,0,836897
dgoRp,0.09090909090909091,10,10,GGGTGCTGATCACACGGTAT,0,848021
dgoRp,0.09090909090909091,10,10,GGGGAGGCCAGAGTGTGTTC,0,842623
dgoRp,0.09090909090909091,10,10,GGGCCACCCTGACACTGGAA,0,857906
dgoRp,0.09090909090909091,10,10,GGGCCAAAAATACCCCACGC,0,841818
dgoRp,0.09090909090909091,10,10,GGGACGATACTTCGACTAAT,0,849436
dgoRp,0.09090909090909091,10,10,GGCGATAGAAGACGCCCCCG,0,858052
dgoRp,0.09090909090909091,10,10,GGCCTGTTCGTCGCAAGGCT,0,862247
dgoRp,0.09090909090909091,10,10,GGCCGGGTCAACACTGGGTC,0,863319
dgoRp,0.09090909090909091,10,10,GGCCCCGGGAGTACCATCAG,0,843735
dgoRp,0.09090909090909091,10,10,GGCAATACAAGCGACCATAT,0,840859
dgoRp,0.09090909090909091,10,10,GGATGCTCCCGGGACTTGCC,0,840088
dgoRp,0.09090909090909091,10,10,GGATCTGCTGTTCAATCCTC,0,860144
dgoRp,0.09090909090909091,10,10,GGACTGAAATCGCTCTTCTG,0,852452
dgoRp,0.09090909090909091,10,10,GGACATTGCCGAGTGCTTAG,0,851060
dgoRp,0.09090909090909091,10,10,GGAACGACAATCGCAGATCC,0,835817
dgoRp,0.09090909090909091,10,10,GCTAGAGCTGCAAATCCGGC,0,865053
dgoRp,0.09090909090909091,10,10,GCGTGGGTGAGCAGGTTAAT,0,853108
dgoRp,0.09090909090909091,10,10,GCGGGTATAAAGAGGCGAAG,0,848178
dgoRp,0.09090909090909091,10,10,GCGGGGATCCCCTATATGAA,0,855565
dgoRp,0.09090909090909091,10,10,GCGCCAGAGAGTGCTCGATT,0,856212
dgoRp,0.09090909090909091,10,10,GCGACATTGGTGCAGTTACC,0,850951
dgoRp,0.09090909090909091,10,10,GCCGTTTAATCCGCCTGAGT,0,846049
dgoRp,0.09090909090909091,10,10,GCCGAGGCCTGGCACCCTTA,0,857413
dgoRp,0.09090909090909091,10,10,GCCCTAACGGCTTGGGATAA,0,858919
dgoRp,0.09090909090909091,10,10,GCCCCTTAGCAACGGGTGCG,0,852694
dgoRp,0.09090909090909091,10,10,GCATTGTGTACGCGAACCAC,0,850322
dgoRp,0.09090909090909091,10,10,GCATAGACAACTGGATACCC,0,861967
dgoRp,0.09090909090909091,10,10,GCAGCCTGGGGCAGGTTCAT,0,849082
dgoRp,0.09090909090909091,10,10,GCAGCCCATCTCTGACTAGA,0,837674
dgoRp,0.09090909090909091,10,10,GCAGCATAGGACGGTTCTGA,0,862590
dgoRp,0.09090909090909091,10,10,GCAATTCTATTTTGTAACTA,0,866552
dgoRp,0.09090909090909091,10,10,GCAACAACTCTAACCGAGTA,0,838317
dgoRp,0.09090909090909091,10,10,GAGTTCTGTCCACGAGAAGT,0,845175
dgoRp,0.09090909090909091,10,10,GAGGAATTGGGATATGTGTT,0,839235
dgoRp,0.09090909090909091,10,10,GAATTCTAAGGATAAATGTG,0,850628
dgoRp,0.09090909090909091,10,10,GAATGAGGAGTGCAGTTGAT,0,843754
dgoRp,0.09090909090909091,10,10,GAAGGCCTTCTCAGAGTCGT,0,856324
dgoRp,0.09090909090909091,10,10,GAACTCTCTGGCACGTCAAC,0,864259
dgoRp,0.09090909090909091,10,10,GAACTCACTACAGGCTTTAC,0,850947
dgoRp,0.09090909090909091,10,10,GAACAACCATTTCTTACTCA,0,857017
dgoRp,0.09090909090909091,10,10,GAAAGTTACCACGGAGGTGC,0,849188
dgoRp,0.09090909090909091,10,10,CTTTAAAATGCTCATGTAAA,0,855008
dgoRp,0.09090909090909091,10,10,CTTGTGACACATACGTGCGA,0,849909
dgoRp,0.09090909090909091,10,10,CTGCCGCTACCCTTCAGACA,0,863648
dgoRp,0.09090909090909091,10,10,CTGATCTGATTACCCGCGGG,0,850023
dgoRp,0.09090909090909091,10,10,CTGAATTGTCAGGTGACATA,0,865326
dgoRp,0.09090909090909091,10,10,CTACTCCTTTTGATGTATGT,0,864995
dgoRp,0.09090909090909091,10,10,CTACGGCATGCGAGGGAATT,0,856215
dgoRp,0.09090909090909091,10,10,CGTTGGTTACAACGCGCGAA,0,861241
dgoRp,0.09090909090909091,10,10,CGTGTTCTTGAGGGTCCCAT,0,849235
dgoRp,0.09090909090909091,10,10,CGTATCGTTTGGAGCTTCAT,0,841155
dgoRp,0.09090909090909091,10,10,CGGTGCATAACTTCGTTCGG,0,852417
dgoRp,0.09090909090909091,10,10,CGGGTCATCCTCAAGTTCTC,0,839130
dgoRp,0.09090909090909091,10,10,CGGGAACAGGTATCTGTATC,0,839672
dgoRp,0.09090909090909091,10,10,CGGCCTCTTCGCAGGCAGTG,0,855199
dgoRp,0.09090909090909091,10,10,CGGCCCGGGTAAGTTTCTGC,0,845774
dgoRp,0.09090909090909091,10,10,CGGAGAGGCATGCGTGGGAC,0,857557
dgoRp,0.09090909090909091,10,10,CGGACAACGCTAATAGTGGC,0,863160
dgoRp,0.09090909090909091,10,10,CGCTTTGTCCGTTGGTATGC,0,846208
dgoRp,0.09090909090909091,10,10,CGCATACACGGGCTCGTGTC,0,850623
dgoRp,0.09090909090909091,10,10,CGAGCGTAAACTTAGTATAC,0,847486
dgoRp,0.09090909090909091,10,10,CGACGGCGTTCGGACAAATC,0,863158
dgoRp,0.09090909090909091,10,10,CGACAACAGGAAACATAGCC,0,840215
dgoRp,0.09090909090909091,10,10,CGAATCCGGTCGAACTTCTA,0,836061
dgoRp,0.09090909090909091,10,10,CGAACGGTCCTAGCGACTCT,0,863901
dgoRp,0.09090909090909091,10,10,CCTTTACGCTTCTGTCGGAT,0,839965
dgoRp,0.09090909090909091,10,10,CCTTGTCCTACGCCTCGGAT,0,837638
dgoRp,0.09090909090909091,10,10,CCTTGCGTACAAGCTGGCGA,0,836739
dgoRp,0.09090909090909091,10,10,CCTAAATTTAAGGTCAGCCC,0,841062
dgoRp,0.09090909090909091,10,10,CCGCTGTAGATGCCCAGGCA,0,844829
dgoRp,0.09090909090909091,10,10,CCGACTGAAGTCAGGGGCGG,0,838002
dgoRp,0.09090909090909091,10,10,CCCGTCAAGGTCGGACACAT,0,850506
dgoRp,0.09090909090909091,10,10,CCCCTGGGCTGCGTCGCAGA,0,838306
dgoRp,0.09090909090909091,10,10,CCCCGAGGAGATTTGGATAC,0,838293
dgoRp,0.09090909090909091,10,10,CCATCTTTCGATAGCTTAGC,0,857986
dgoRp,0.09090909090909091,10,10,CCAGTTAGGCGCCTTCCAAA,0,848712
dgoRp,0.09090909090909091,10,10,CCAGACGGGAACACGTGCAT,0,866729
dgoRp,0.09090909090909091,10,10,CCAAAGTTTTGTGTAGCCCT,0,866389
dgoRp,0.09090909090909091,10,10,CATTGTAAGTATAGCAACCC,0,840250
dgoRp,0.09090909090909091,10,10,CATGTTCTAACGATTCTAAG,0,843818
dgoRp,0.09090909090909091,10,10,CATATTTCTCCGCATCATAA,0,836054
dgoRp,0.09090909090909091,10,10,CATATGACAAGATTCTGGGT,0,843773
dgoRp,0.09090909090909091,10,10,CATATCTCCAATGCCACTGA,0,857296
dgoRp,0.09090909090909091,10,10,CAGTGAGTTAACCTCCACAT,0,855097
dgoRp,0.09090909090909091,10,10,CAGATATGGGGGGCTGTTGG,0,839508
dgoRp,0.09090909090909091,10,10,CACGCTCCGTCTTGACAATA,0,844526
dgoRp,0.09090909090909091,10,10,CACCGAACGTTGTAGGCGCC,0,856905
dgoRp,0.09090909090909091,10,10,CACCAATCGAGTTAAATAGG,0,863302
dgoRp,0.09090909090909091,10,10,CAATGCGGCTCACGGAAAGG,0,861735
dgoRp,0.09090909090909091,10,10,CAAGTACATTGCATTCAATA,0,860522
dgoRp,0.09090909090909091,10,10,CAACCTCCTCCTCCCTACGG,0,842621
dgoRp,0.09090909090909091,10,10,CAACCACCCCAAAACGCGCA,0,863073
dgoRp,0.09090909090909091,10,10,CAACACTAAGGGCCGGACGA,0,840471
dgoRp,0.09090909090909091,10,10,CAACAAGCTAATTGGCTACT,0,840323
dgoRp,0.09090909090909091,10,10,CAAAGGCGTCTTGGAGAGAA,0,862851
dgoRp,0.09090909090909091,10,10,CAAACTCTACTCCGAGGACC,0,848306
dgoRp,0.09090909090909091,10,10,ATTGCAGTTAGGTATAGGAT,0,864112
dgoRp,0.09090909090909091,10,10,ATTCCAGCTGTAGCAGAGTG,0,841881
dgoRp,0.09090909090909091,10,10,ATTCAGTTGTATCCTGAAGG,0,836318
dgoRp,0.09090909090909091,10,10,ATTATGTTGAGGTACCCTCA,0,848574
dgoRp,0.09090909090909091,10,10,ATGTATGAACGGGAAAAGCC,0,852278
dgoRp,0.09090909090909091,10,10,ATGGGAATGCCGACAATACA,0,843727
dgoRp,0.09090909090909091,10,10,ATCTCAGAGACCACCCGACA,0,857384
dgoRp,0.09090909090909091,10,10,ATCGAGTGTCAGTGATTAGA,0,853886
dgoRp,0.09090909090909091,10,10,ATCATGTATGATAGTGGGCA,0,856543
dgoRp,0.09090909090909091,10,10,ATCAGATGCAAGCTTGCCAC,0,865098
dgoRp,0.09090909090909091,10,10,ATATGCGCAGTAAACAGTTA,0,845080
dgoRp,0.09090909090909091,10,10,ATATACCGTGGGCGCTATGC,0,849266
dgoRp,0.09090909090909091,10,10,ATACTTTATAGCACGTTCTC,0,859474
dgoRp,0.09090909090909091,10,10,ATACAATACTGGCGTTGAAG,0,840672
dgoRp,0.09090909090909091,10,10,AGTTGTATAAGTCGTGTCGG,0,851570
dgoRp,0.09090909090909091,10,10,AGTGCGTGCAGATATTTGTG,0,857102
dgoRp,0.09090909090909091,10,10,AGTGCGTCCGTAGGGCCTGT,0,856375
dgoRp,0.09090909090909091,10,10,AGTCCTAGATGTAAGCTTGC,0,859684
dgoRp,0.09090909090909091,10,10,AGGTTACGGCTATCAGGCCC,0,865085
dgoRp,0.09090909090909091,10,10,AGGTAGAGGTGGAAGAAAAT,0,848945
dgoRp,0.09090909090909091,10,10,AGGGGAGCCGAGACGCGGGG,0,840105
dgoRp,0.09090909090909091,10,10,AGGCGTGCCGTTGCAAGGTT,0,839640
dgoRp,0.09090909090909091,10,10,AGGATAAGGCGTGCGCTCAT,0,855531
dgoRp,0.09090909090909091,10,10,AGCCATACTCGTATTATTTC,0,862431
dgoRp,0.09090909090909091,10,10,AGATCCTTCACGCGGTAAAT,0,842193
dgoRp,0.09090909090909091,10,10,AGAGACGCTCAACGTCTGTA,0,856596
dgoRp,0.09090909090909091,10,10,AGACATGAGGGGAGTCTTTA,0,841795
dgoRp,0.09090909090909091,10,10,AGACAATCGCCAAGCACTAG,0,861177
dgoRp,0.09090909090909091,10,10,AGAATGGCTGATACCAAAGT,0,845852
dgoRp,0.09090909090909091,10,10,AGAACGTGGCTTGTACGTAT,0,836962
dgoRp,0.09090909090909091,10,10,ACTTGCCGGTAAAAACCTGT,0,860962
dgoRp,0.09090909090909091,10,10,ACTGGCGTCCAAGGGGTCCC,0,849067
dgoRp,0.09090909090909091,10,10,ACTCTGAACAACACGGTAGG,0,864311
dgoRp,0.09090909090909091,10,10,ACTCGCAGATCCATCGCCTC,0,843831
dgoRp,0.09090909090909091,10,10,ACTATAGTGGGTCCGCTTAC,0,843431
dgoRp,0.09090909090909091,10,10,ACTACAAGGCGAATAGTCAT,0,852055
dgoRp,0.09090909090909091,10,10,ACGTTGTCTACACCTCAGGT,0,847775
dgoRp,0.09090909090909091,10,10,ACGTTAGAAGGCGTGCGTCT,0,860293
dgoRp,0.09090909090909091,10,10,ACGTGATGACCGTGATAAGG,0,857907
dgoRp,0.09090909090909091,10,10,ACGTGAATCGAAAAGAGGTT,0,836813
dgoRp,0.09090909090909091,10,10,ACGGTATCGGTGGGCTTGGT,0,846335
dgoRp,0.09090909090909091,10,10,ACCCGGCCCTGAATCTTCTA,0,836235
dgoRp,0.09090909090909091,10,10,ACATTAAAGCCAATCTATCT,0,853491
dgoRp,0.09090909090909091,10,10,ACATAGACATCAACGGATCA,0,847071
dgoRp,0.09090909090909091,10,10,ACAGTATTAACCTGAGGTAC,0,855614
dgoRp,0.09090909090909091,10,10,ACACCTCTGATTTGTCATTA,0,839566
dgoRp,0.09090909090909091,10,10,ACACCAGTATCCTTGGCACG,0,860004
dgoRp,0.09090909090909091,10,10,AATGGGCATCAAGTTTCGAC,0,855946
dgoRp,0.09090909090909091,10,10,AATGAATAGGAATTACCACG,0,845203
dgoRp,0.09090909090909091,10,10,AATCATGGGGATTATACGCG,0,862520
dgoRp,0.09090909090909091,10,10,AAGTTGGGCCACAATGGTAG,0,838160
dgoRp,0.09090909090909091,10,10,AAGTTAATTGGAGGCCACTG,0,848595
dgoRp,0.09090909090909091,10,10,AAGTCATCCTTGCAAGTGAT,0,857046
dgoRp,0.09090909090909091,10,10,AAGATGCCGTAGGTAACCTA,0,860509
dgoRp,0.09090909090909091,10,10,AACGTCGCTCCGACGAAGTC,0,854757
dgoRp,0.09090909090909091,10,10,AACGCGCTTGGTCCTTAAAT,0,857793
dgoRp,0.09090909090909091,10,10,AACATCGATGCGGCATGGAC,0,865988
dgoRp,0.09090909090909091,10,10,AACAGTATCATAGCGTTCAT,0,842543
dgoRp,0.09090909090909091,10,10,AACAACAACCTCTGATGCTA,0,838256
dgoRp,0.09090909090909091,10,10,AAATGAATTGGCGCTTTGAC,0,855719
dgoRp,0.09090909090909091,10,10,AAACTGCTCGTCCGAGGCGA,0,857810
dgoRp,0.09090909090909091,10,10,AAACAGTTCTTAATCGGTGG,0,856452
dgoRp,0.09090909090909091,10,10,AAACACGGCTACAGGTGATC,0,845264
dgoRp,0.1,9,9,TTTGGGGGTGGAAACACTGA,0,855152
dgoRp,0.1,9,9,TTTGGCACCCCATTTCAACA,0,859732
dgoRp,0.1,9,9,TTTGCGAAGCACTGTCTCGT,0,848734
dgoRp,0.1,9,9,TTTATAAATGTATGTCACAT,0,846030
dgoRp,0.1,9,9,TTTACTAGTGGCTCCGTATT,0,852972
dgoRp,0.1,9,9,TTTACCCGGGATCCAACGTG,0,849954
dgoRp,0.1,9,9,TTTACATTGACCCTAACAAT,0,851166
dgoRp,0.1,9,9,TTTAAAGGCCGCACTGACAG,0,865101
dgoRp,0.1,9,9,TTGTTACGTCACTGTCGGGT,0,839285
dgoRp,0.1,9,9,TTGTATGTGCTGCTCGTGGA,0,841111
dgoRp,0.1,9,9,TTGGTCTAGATATGGGGCAA,0,842047
dgoRp,0.1,9,9,TTGGAACCCATAGGGAGAAC,0,861341
dgoRp,0.1,9,9,TTGCGTGAAGGCATGTGCAT,0,858111
dgoRp,0.1,9,9,TTGCGCCGAATATTCGTGAA,0,848650
dgoRp,0.1,9,9,TTCTGCCCTCTAAAAGGAGA,0,862528
dgoRp,0.1,9,9,TTCTCCACTTAGAAAATGGG,0,836563
dgoRp,0.1,9,9,TTCGAGTAAATATCTAGTCC,0,863165
dgoRp,0.1,9,9,TGTTGGATTTATAACCAGAG,0,861549
dgoRp,0.1,9,9,TGTGGACCTGTTCGAACGAA,0,847380
dgoRp,0.1,9,9,TGTCGTCTAAATATCCTAAA,0,852303
dgoRp,0.1,9,9,TGTCGAGGCAATTTTCGCTT,0,857228
dgoRp,0.1,9,9,TGTATTGCGACCCCGACTAT,0,866721
dgoRp,0.1,9,9,TGTAAACAATATCTTTTATG,0,837269
dgoRp,0.1,9,9,TGGTCGCGAGATGTGACTCA,0,844941
dgoRp,0.1,9,9,TGGGGACTCCGGCTGCAAGG,0,866203
dgoRp,0.1,9,9,TGGGGACGTCTTTTAGGTCC,0,846019
dgoRp,0.1,9,9,TGGCAGGCGTTGCTCTATTC,0,853288
dgoRp,0.1,9,9,TGCTAACGGCCGACAAGTAT,0,841316
dgoRp,0.1,9,9,TGCCCAGATCGAATGGCAAC,0,850302
dgoRp,0.1,9,9,TGCAGCGTCGGAGACGGACA,0,855389
dgoRp,0.1,9,9,TGATCATGACCACACATATG,0,856395
dgoRp,0.1,9,9,TGATAATAGGTCGAGACCTA,0,855426
dgoRp,0.1,9,9,TGAGGTACAAGGTGTAGTTA,0,860070
dgoRp,0.1,9,9,TGAGGCCCAGTGTCTTGGTT,0,853935
dgoRp,0.1,9,9,TGAACCAATTCAGAGTTTTA,0,860864
dgoRp,0.1,9,9,TCTTTGCTTACAAAGCGCAG,0,859255
dgoRp,0.1,9,9,TCTTCCTCGATATAGATACG,0,860061
dgoRp,0.1,9,9,TCTGTGGTACGTAGACCATC,0,852713
dgoRp,0.1,9,9,TCTATGGCGAGACTTAGCTG,0,857436
dgoRp,0.1,9,9,TCTATACTGCGAGCTAATGC,0,864088
dgoRp,0.1,9,9,TCGGTGCGTAGAACCGCTAC,0,844689
dgoRp,0.1,9,9,TCGCAACAATCGGTGCGTTT,0,837319
dgoRp,0.1,9,9,TCCTCCCAGGAAGGAGCTAC,0,857044
dgoRp,0.1,9,9,TCCCTTAGCGGCGACATCTT,0,847748
dgoRp,0.1,9,9,TCCATATTAGCGCAGCGAGC,0,858398
dgoRp,0.1,9,9,TCACTAACCTGAGAAACAAG,0,850173
dgoRp,0.1,9,9,TATTATATGTCTATCAAATT,0,859318
dgoRp,0.1,9,9,TATCTCCACTGAAGCCTGAA,0,843266
dgoRp,0.1,9,9,TATCGTCTCTCCGAAATTGG,0,838456
dgoRp,0.1,9,9,TATCATAGCTCTCGTTACAG,0,844660
dgoRp,0.1,9,9,TAGGATTATCAGGTTATGCT,0,837692
dgoRp,0.1,9,9,TACGGTATCACAATTTGTCC,0,855930
dgoRp,0.1,9,9,TACGGGATATGGCGTCTGTA,0,867419
dgoRp,0.1,9,9,TACCTCAGAAAACGCCCCTA,0,846879
dgoRp,0.1,9,9,TACCGCAGTACCCAGGGTGT,0,843050
dgoRp,0.1,9,9,TACCGATGCCGTGGTGTGGT,0,842106
dgoRp,0.1,9,9,TACATTCCTGGACAGATATG,0,854115
dgoRp,0.1,9,9,TAAGCAACGTATATCTTAAT,0,843083
dgoRp,0.1,9,9,TAACTTTTGGTGATTGCGCT,0,856135
dgoRp,0.1,9,9,TAACGACAGTCACTGTAGCT,0,859940
dgoRp,0.1,9,9,TAAAGTTATTTCGATTATCT,0,863544
dgoRp,0.1,9,9,TAAACGGTCATTCATATCTG,0,836510
dgoRp,0.1,9,9,GTTCTAAGGGGCAAATGATT,0,862676
dgoRp,0.1,9,9,GTTCGGTAGCCACTACCACT,0,837995
dgoRp,0.1,9,9,GTTCACTGACATCCTGGATC,0,842618
dgoRp,0.1,9,9,GTTAGTTACGTCCTAAGGGT,0,862339
dgoRp,0.1,9,9,GTTAAGGTTTATATATTCGC,0,847589
dgoRp,0.1,9,9,GTGTTCGAACGCGGTATACT,0,839779
dgoRp,0.1,9,9,GTGTGCTACGATACCTGTGT,0,845865
dgoRp,0.1,9,9,GTGTCAGTCCGGCTGGGCGG,0,840584
dgoRp,0.1,9,9,GTGACCCTTACCCGAGTGAG,0,844326
dgoRp,0.1,9,9,GTGAAAAAGTGCCCCGCAGA,0,848345
dgoRp,0.1,9,9,GTCGTTTGTGTGTATGTGTA,0,858543
dgoRp,0.1,9,9,GTCGGTCGCTCACTCTTATT,0,852910
dgoRp,0.1,9,9,GTCGCGCATGCATATGACTT,0,854280
dgoRp,0.1,9,9,GTCGCACTAAGGGTCGTGTT,0,861904
dgoRp,0.1,9,9,GTCGAAGTATGGTTGGGAGT,0,857821
dgoRp,0.1,9,9,GTCCTCTGTCACGTACAAAA,0,847318
dgoRp,0.1,9,9,GTCCAGCCCGGCTAGGCAAA,0,853065
dgoRp,0.1,9,9,GTCACCCCTGTCTGGACCAA,0,866215
dgoRp,0.1,9,9,GTCAACATTACATACTGTCT,0,842172
dgoRp,0.1,9,9,GTATGGCTATGTTTATGGCA,0,839396
dgoRp,0.1,9,9,GTAGGGGCATATCTTGTCAG,0,858597
dgoRp,0.1,9,9,GTACTAAAATAATGCTTTCG,0,850927
dgoRp,0.1,9,9,GTACGAAGAGTGACAATCTG,0,843524
dgoRp,0.1,9,9,GTAAAGAAGACGTCGAACGA,0,860775
dgoRp,0.1,9,9,GGTGGGTGGGCCGGTAGTAA,0,853175
dgoRp,0.1,9,9,GGTCTTTCTAACGAAGGTTT,0,842615
dgoRp,0.1,9,9,GGTCCAGGTTTCGTACACGA,0,859760
dgoRp,0.1,9,9,GGTATCCCTGACTAAATGGA,0,848579
dgoRp,0.1,9,9,GGTAAACCGGAACCTCGGCC,0,848781
dgoRp,0.1,9,9,GGGACTCCTTTGTGGACGAG,0,839230
dgoRp,0.1,9,9,GGGAATACTGGGGACGCCCG,0,838879
dgoRp,0.1,9,9,GGCTGGGACATGACCATGAG,0,853099
dgoRp,0.1,9,9,GGCAGTCTCTATGCGATTTG,0,865682
dgoRp,0.1,9,9,GGATTGTAACCGAAATACTA,0,853107
dgoRp,0.1,9,9,GGATCTGATTATAGTGTAGT,0,861908
dgoRp,0.1,9,9,GGACCGTATCCCTAGGAATG,0,840038
dgoRp,0.1,9,9,GGACCCGCGAATGGGGCTGA,0,843170
dgoRp,0.1,9,9,GGAAACCATGCCAGATCACT,0,845415
dgoRp,0.1,9,9,GCTTTAAATGTAATACCGTG,0,860398
dgoRp,0.1,9,9,GCTCGGAGAACGCGGTAAAC,0,844990
dgoRp,0.1,9,9,GCGTCTCCGACGTATAGTCA,0,859418
dgoRp,0.1,9,9,GCGGTAAAGAGGTCTCAACA,0,843570
dgoRp,0.1,9,9,GCGGCTGCAAAGCTCCTCGT,0,843182
dgoRp,0.1,9,9,GCCCAAATAATCCATGCCCC,0,863831
dgoRp,0.1,9,9,GCATTGTCATGGTTGGCAAT,0,866673
dgoRp,0.1,9,9,GCATCCGGGCTTACTCACCT,0,862478
dgoRp,0.1,9,9,GCATCAGCGGACCGCACATG,0,838402
dgoRp,0.1,9,9,GCACTGCAGCCATCACACTT,0,837337
dgoRp,0.1,9,9,GCAAGATTTCTGTAAACCCG,0,853823
dgoRp,0.1,9,9,GATTTCCATGCGGTAAACGT,0,861629
dgoRp,0.1,9,9,GATTACGCGGGTGTCATGTG,0,849288
dgoRp,0.1,9,9,GATGAGTTCAATGCAGTGAA,0,836746
dgoRp,0.1,9,9,GATCGGGCACGTCGCTAAAT,0,838004
dgoRp,0.1,9,9,GATCCCCCTTTCTCAAACAT,0,856351
dgoRp,0.1,9,9,GATAGGGAACATACGACCGG,0,841877
dgoRp,0.1,9,9,GAGTCGTTTGTCTAGATCAG,0,837327
dgoRp,0.1,9,9,GAGTCCCTGGGCCATGGACT,0,857215
dgoRp,0.1,9,9,GAGGGACGATAGGCACACTA,0,853369
dgoRp,0.1,9,9,GAGGCCAGAACTGCTTTCGA,0,837761
dgoRp,0.1,9,9,GAGCGTCAAACCACGCAAGG,0,844022
dgoRp,0.1,9,9,GAGATTGTCACCTAGTATCC,0,836228
dgoRp,0.1,9,9,GAGAAGGTAACTCACAGATT,0,846274
dgoRp,0.1,9,9,GACGAATAGTGAGGATACCC,0,841807
dgoRp,0.1,9,9,GACGAAGCTGGCAGTCCTTA,0,857887
dgoRp,0.1,9,9,GACCGCCCTAGATTTGCTCC,0,863776
dgoRp,0.1,9,9,GACCGAGGAGTTCCCACGTA,0,866767
dgoRp,0.1,9,9,GAACTCAAGGACTGCGGGAC,0,843181
dgoRp,0.1,9,9,GAACCGTGACCTGTAGGTAA,0,843931
dgoRp,0.1,9,9,GAAATAACGCCGCTAGCGAG,0,855082
dgoRp,0.1,9,9,CTTGGTGGAGAAGCATCCAT,0,851437
dgoRp,0.1,9,9,CTTGGCGAAAGCCATTACGC,0,865261
dgoRp,0.1,9,9,CTTGCGAGCTAACACTAATC,0,866518
dgoRp,0.1,9,9,CTGTCCACCAGATATATGTG,0,861260
dgoRp,0.1,9,9,CTGGTGGGTAATGGCAAACT,0,860740
dgoRp,0.1,9,9,CTGCGTGTGCTTAAGCGCGA,0,843523
dgoRp,0.1,9,9,CTGCCACCGGGTATGGCTCT,0,852716
dgoRp,0.1,9,9,CTCTCTGAACCCATGAGATC,0,852311
dgoRp,0.1,9,9,CTCTCAAGCAACGTATAGTT,0,854977
dgoRp,0.1,9,9,CTCGTAAGGTTGTATTCTCA,0,836711
dgoRp,0.1,9,9,CTCGACGGGATAAGGCTCCG,0,855706
dgoRp,0.1,9,9,CTCCCGCGGGGAGAATAAGG,0,836362
dgoRp,0.1,9,9,CTCCAGATCTGGGTACCTCT,0,855644
dgoRp,0.1,9,9,CTATCGCGGGTTTATTCTCA,0,847847
dgoRp,0.1,9,9,CTATCCCGAGCGAGTCAGGA,0,847807
dgoRp,0.1,9,9,CTATATCATTTTCTCGGTCA,0,839273
dgoRp,0.1,9,9,CTAGACGGTAAACCTGGCGG,0,837510
dgoRp,0.1,9,9,CTAACCATGACCTATGCGCC,0,837389
dgoRp,0.1,9,9,CTAAATTCCGGTCGATCATC,0,843528
dgoRp,0.1,9,9,CTAAAAGCACTAGCGGGTAA,0,861941
dgoRp,0.1,9,9,CGTCCATCCGGAAGATTGAC,0,844294
dgoRp,0.1,9,9,CGGTTACTGTGGGTTGACAC,0,861515
dgoRp,0.1,9,9,CGGTCCCGCCACACGAGGCG,0,849985
dgoRp,0.1,9,9,CGGGGCAACGACTTTCCAAA,0,850880
dgoRp,0.1,9,9,CGGCGGGGCTTTCGTGGGGA,0,837260
dgoRp,0.1,9,9,CGGCAGGCCGGCCCGCTGAT,0,862762
dgoRp,0.1,9,9,CGGCAACTAGCACTGCATTG,0,845881
dgoRp,0.1,9,9,CGCGTTTCACTCTCTCCGGT,0,841641
dgoRp,0.1,9,9,CGCGCCGGTTAAATTTCTTA,0,862509
dgoRp,0.1,9,9,CGCCAGCTCAAATCACATCC,0,852484
dgoRp,0.1,9,9,CGCCAACAGAACTACCACAA,0,858864
dgoRp,0.1,9,9,CGATCGCTATCAGGACAGTA,0,860171
dgoRp,0.1,9,9,CGAGAGAAGAGGAACGCGTG,0,865548
dgoRp,0.1,9,9,CGAGACAACCAAAAAGCCTA,0,838530
dgoRp,0.1,9,9,CGACGTGGCAACCAAGGCAA,0,837374
dgoRp,0.1,9,9,CGAAAGCATCGATGAGCCAT,0,840931
dgoRp,0.1,9,9,CCTTGCAGAGTCGAAGGGCA,0,849292
dgoRp,0.1,9,9,CCTGCTAGTGCCTACGTAGA,0,852435
dgoRp,0.1,9,9,CCTCTAAACGCGGTCTGTGA,0,861281
dgoRp,0.1,9,9,CCTAGGTGCGGGGGGTATAG,0,853859
dgoRp,0.1,9,9,CCTAGGCTGTCATTAGCGGT,0,840068
dgoRp,0.1,9,9,CCTAACGCCTTCGAATACAT,0,856148
dgoRp,0.1,9,9,CCGTATGCAGTTAGCGTGAT,0,857893
dgoRp,0.1,9,9,CCGATGATTCCAACAACTAA,0,840678
dgoRp,0.1,9,9,CCGAATGTTGCACCAGCGCA,0,846506
dgoRp,0.1,9,9,CCCAAATTAAATATGCCTGT,0,853906
dgoRp,0.1,9,9,CCATCATGTCCTGGGTTTTT,0,856340
dgoRp,0.1,9,9,CCAGGCCCAGTACACTAATT,0,850240
dgoRp,0.1,9,9,CCAGAAGGCGTACGTCAGGA,0,844652
dgoRp,0.1,9,9,CCAAACTTATTAGGCCACAC,0,854381
dgoRp,0.1,9,9,CATGTGTTTTCCCACGCATT,0,849317
dgoRp,0.1,9,9,CATGCCGTAGTGAGTCACGT,0,851409
dgoRp,0.1,9,9,CATCTAGTTCTTCCCGTCCG,0,864584
dgoRp,0.1,9,9,CAGCCGCAATCCTAAGAATA,0,848778
dgoRp,0.1,9,9,CAGCCAACAGAACTCGCCGT,0,848969
dgoRp,0.1,9,9,CAGAAGGAACCAATTCCAGC,0,851982
dgoRp,0.1,9,9,CACTGTCCGCATTGTTCCTG,0,857499
dgoRp,0.1,9,9,CACGTTTAAACCGGGTGTGA,0,864808
dgoRp,0.1,9,9,CACGCCCATGCTAGGTGAAT,0,840505
dgoRp,0.1,9,9,CACGCCATCCACCTTTCCTG,0,851472
dgoRp,0.1,9,9,CACGATATCGTTGGCTCTTA,0,845692
dgoRp,0.1,9,9,CACAAAATGGCAAGCATTTC,0,844168
dgoRp,0.1,9,9,CAATATTGTAATCGGGGGAA,0,864360
dgoRp,0.1,9,9,CAAGTCTCGCGAACACACAT,0,853503
dgoRp,0.1,9,9,CAAGCCGCCTACAACCCCGA,0,857135
dgoRp,0.1,9,9,CAACAAAATCGGGCAGTGCG,0,851788
dgoRp,0.1,9,9,ATTTAGAGGAATGTCAGCCA,0,845447
dgoRp,0.1,9,9,ATTCGGCGGGTATCCCTCCT,0,862307
dgoRp,0.1,9,9,ATTCATTCGACCGCCTGGGC,0,838896
dgoRp,0.1,9,9,ATTAGTCGGTTCCTGGGACG,0,856726
dgoRp,0.1,9,9,ATTAGACTCTCTGCTACGTA,0,861266
dgoRp,0.1,9,9,ATTACGTCCAGACATCGGGA,0,840230
dgoRp,0.1,9,9,ATTACGGCAGGGCCGGGATC,0,840214
dgoRp,0.1,9,9,ATGTCTCCAACAGCCTTTGG,0,861053
dgoRp,0.1,9,9,ATGTAGCGAACATTAATCGC,0,854263
dgoRp,0.1,9,9,ATGGTATTTGTTCAGTGCGC,0,862579
dgoRp,0.1,9,9,ATGAATAGCTGTTTAGATTA,0,849002
dgoRp,0.1,9,9,ATCTGTAGAGTGCTTTACAG,0,851213
dgoRp,0.1,9,9,ATCTCGCAGTGCAAAAGGTT,0,858239
dgoRp,0.1,9,9,ATCCTCAGCATGCGCCTAGT,0,837524
dgoRp,0.1,9,9,ATATTCTAAGGCATGACGTA,0,866208
dgoRp,0.1,9,9,ATATGCGAAGTACGGGTCTT,0,862492
dgoRp,0.1,9,9,ATAGCAACATGTTAGAGCGG,0,861859
dgoRp,0.1,9,9,ATACGCTCTTTTTGTTGTCC,0,856766
dgoRp,0.1,9,9,ATAACTGATGGATTAGTGTA,0,860961
dgoRp,0.1,9,9,ATAAAGTCTCCTAGATATGC,0,847164
dgoRp,0.1,9,9,AGTTCCCTCAGTACGTCTCA,0,852907
dgoRp,0.1,9,9,AGTGCAACTGTCGTACGTTT,0,848014
dgoRp,0.1,9,9,AGTCGAGTAAGCAGAGGCTC,0,851126
dgoRp,0.1,9,9,AGTCCCTCGAGGACCCGTCG,0,857843
dgoRp,0.1,9,9,AGTCCCTCGAGACACAATGG,0,856679
dgoRp,0.1,9,9,AGTAGATGCGCGCCCTTGAA,0,837592
dgoRp,0.1,9,9,AGGTGTCCGGTTGGAAGATA,0,852356
dgoRp,0.1,9,9,AGGTGTAGGAGCGAAGGCAG,0,842759
dgoRp,0.1,9,9,AGGTCTCTGTTTGCGGGATT,0,864960
dgoRp,0.1,9,9,AGGGCATTAAGATGAATCGC,0,843163
dgoRp,0.1,9,9,AGGGAAGGTTGCATGCTCTT,0,846878
dgoRp,0.1,9,9,AGGACTTAACTTAGTTGAAC,0,862432
dgoRp,0.1,9,9,AGGAAACTGAAAAATTCTCG,0,866944
dgoRp,0.1,9,9,AGCGTTGATTCCTTGGTGAC,0,866344
dgoRp,0.1,9,9,AGCGCCCGGGTGACAACATG,0,852090
dgoRp,0.1,9,9,AGCGACCTTTCGAATTTTCG,0,858071
dgoRp,0.1,9,9,AGCCAAGCTAAGTAGTCTTT,0,852329
dgoRp,0.1,9,9,AGCATTTAGGGCGGAGGTAA,0,848468
dgoRp,0.1,9,9,AGCAACCATTACCGTGCTCC,0,861740
dgoRp,0.1,9,9,AGATAGCTGTATAGAGTGGA,0,844319
dgoRp,0.1,9,9,AGAGTTTTCTCAGGCGACCT,0,859528
dgoRp,0.1,9,9,AGAGTAAAGAATTGGTTGGC,0,843604
dgoRp,0.1,9,9,AGAGAGTAGCTACGTATATT,0,849467
dgoRp,0.1,9,9,ACTTAGATCCTTAATGCGAG,0,843681
dgoRp,0.1,9,9,ACTGGAGGACCAGACATTCA,0,865958
dgoRp,0.1,9,9,ACTCTCCCACTGCGGGACGG,0,844835
dgoRp,0.1,9,9,ACGTTTAATTTTAAACATTA,0,865352
dgoRp,0.1,9,9,ACGGGTTGGCATAGTTACCG,0,863060
dgoRp,0.1,9,9,ACGCTTGAGAACATGTACCT,0,855558
dgoRp,0.1,9,9,ACGATATAAGCTCGACAAGA,0,854483
dgoRp,0.1,9,9,ACGAATGTTTGTTAGGGGAA,0,858315
dgoRp,0.1,9,9,ACCGTTGACTCTAATCTGCG,0,855463
dgoRp,0.1,9,9,ACCCGCCGCGTTTCGTCCAC,0,853654
dgoRp,0.1,9,9,ACATATTAGGGGCGACTTAC,0,866624
dgoRp,0.1,9,9,ACAGATCAGATACGAGTGAT,0,850701
dgoRp,0.1,9,9,AATGGAGGTTACTTCTGCTT,0,849804
dgoRp,0.1,9,9,AATCTTCGCCACTACTGCGT,0,858339
dgoRp,0.1,9,9,AATCGCTCGTCGTGGTCAAG,0,850158
dgoRp,0.1,9,9,AATACTGTCGTCACGCGTCG,0,864528
dgoRp,0.1,9,9,AAGTGGTAGTTGCAGCTTGT,0,856426
dgoRp,0.1,9,9,AAGTGGGTCAGCATGGTCTT,0,850804
dgoRp,0.1,9,9,AAGTGATTAGGAAGGTGGCG,0,848657
dgoRp,0.1,9,9,AAGTATTGGGAATCGTACGA,0,843899
dgoRp,0.1,9,9,AAGGGGGAGGAACTGGGGAG,0,864363
dgoRp,0.1,9,9,AAGGGCGGTCTAGCATAGAA,0,855631
dgoRp,0.1,9,9,AAGGCTTTCAGTGTGGTCCA,0,866686
dgoRp,0.1,9,9,AAGGCCCAGCTTTCACGAGG,0,846832
dgoRp,0.1,9,9,AAGACGACGTAGGGTCATTG,0,842368
dgoRp,0.1,9,9,AACTAAAACTTTCTTGACAA,0,839997
dgoRp,0.1,9,9,AACGGCTGAAACTCATATGT,0,862412
dgoRp,0.1,9,9,AACGGAATGGTCAGGCGCGC,0,851209
dgoRp,0.1,9,9,AACGCTGAGAGGATTGAATG,0,843623
dgoRp,0.1,9,9,AACCCTGGATGTAACGCTCA,0,848886
dgoRp,0.1,9,9,AACCACGAGATATGATTCGA,0,853071
dgoRp,0.1,9,9,AACACAAGCTGGATAACTCA,0,844167
dgoRp,0.1,9,9,AAATGTTTTAATATCGATTA,0,855128
dgoRp,0.1,9,9,AAATGAGTGCCACCCCAGCT,0,861383
dgoRp,0.1,9,9,AAAGGGCTGGCAAGTGAAGT,0,859754
dgoRp,0.1,9,9,AAAGGATCCGACGCTGGAAC,0,843467
dgoRp,0.1,9,9,AAACCTTTTGTTAGTTTGCT,0,864831
dgoRp,0.1,9,9,AAACAGTATATAGTCTTCTC,0,864356
dgoRp,0.1,9,9,AAAACCTTCGCCCACTTAGT,0,857566
dgoRp,0.1111111111111111,8,8,TTTGTCATATATGCGAGGAG,0,856618
dgoRp,0.1111111111111111,8,8,TTTCGCATCTAGCGACTCAA,0,851786
dgoRp,0.1111111111111111,8,8,TTTAGCTACGCGCAACTATA,0,859535
dgoRp,0.1111111111111111,8,8,TTTACTTTCTACAGGTGGTT,0,839962
dgoRp,0.1111111111111111,8,8,TTGTCAAGGGGTGCAAATGC,0,850439
dgoRp,0.1111111111111111,8,8,TTGGCTAGTTCCGTACTGTT,0,856547
dgoRp,0.1111111111111111,8,8,TTGCGGAACTTTCTGACTGA,0,849336
dgoRp,0.1111111111111111,8,8,TTGAATGCACTTTGGGGCTA,0,862010
dgoRp,0.1111111111111111,8,8,TTCAGCGGCCCGTGCGGTGC,0,857020
dgoRp,0.1111111111111111,8,8,TTCAGCGCGGCTCAGTGAGT,0,842039
dgoRp,0.1111111111111111,8,8,TTATTGATCCTAGCAGAAAA,0,849556
dgoRp,0.1111111111111111,8,8,TTATGCCCGACCCTGAGTCC,0,839862
dgoRp,0.1111111111111111,8,8,TTAGCAGATCTACGCCGCTA,0,862636
dgoRp,0.1111111111111111,8,8,TTAGAAGTCTCTGGTGTTTA,0,856181
dgoRp,0.1111111111111111,8,8,TTACGCGTCAGCAAATCATT,0,848210
dgoRp,0.1111111111111111,8,8,TTAATTGTGCGGAACATCAT,0,837118
dgoRp,0.1111111111111111,8,8,TTAAGCTTGTACTGGAGATA,0,855848
dgoRp,0.1111111111111111,8,8,TGTTTAAAAGCCCCTATCCA,0,845173
dgoRp,0.1111111111111111,8,8,TGTGTCACCGAGCAGTAACT,0,836539
dgoRp,0.1111111111111111,8,8,TGTGGGCGCCCTGTTTCACT,0,842793
dgoRp,0.1111111111111111,8,8,TGTCCATCCCGACCGGCTGT,0,855620
dgoRp,0.1111111111111111,8,8,TGTAATGTTTTTTCGGCTGG,0,854351
dgoRp,0.1111111111111111,8,8,TGTAATACAAGGTATAGATA,0,842947
dgoRp,0.1111111111111111,8,8,TGGTTCTTGGCAGGGTTTAG,0,836249
dgoRp,0.1111111111111111,8,8,TGGTGAGAAAGCAGGTCTTC,0,854380
dgoRp,0.1111111111111111,8,8,TGGGTCCGGAAGGAGGGACT,0,855722
dgoRp,0.1111111111111111,8,8,TGGGCCTTATCAACGGCTCA,0,848015
dgoRp,0.1111111111111111,8,8,TGGCATGCTCAGGATGAAAA,0,857846
dgoRp,0.1111111111111111,8,8,TGGCACGACCGTGCCATGCC,0,840783
dgoRp,0.1111111111111111,8,8,TGGAGCTACCGTCGCTAGTA,0,858828
dgoRp,0.1111111111111111,8,8,TGGACAAACGACTATACGTC,0,842058
dgoRp,0.1111111111111111,8,8,TGGAATGGACATTCGCACTA,0,841203
dgoRp,0.1111111111111111,8,8,TGCTCCGAATATCAAAAACT,0,841364
dgoRp,0.1111111111111111,8,8,TGCCCATTAACGTAGGGCTG,0,852272
dgoRp,0.1111111111111111,8,8,TGATGTTTAGATACTAAAAA,0,840973
dgoRp,0.1111111111111111,8,8,TGAGGGTAAGCTTTTCGCCA,0,843582
dgoRp,0.1111111111111111,8,8,TGACTACTACTCGGGTAGCA,0,845922
dgoRp,0.1111111111111111,8,8,TGACAGTTCTGGGTAGAATC,0,844232
dgoRp,0.1111111111111111,8,8,TGAATTCTTCTCCATTCGGT,0,862518
dgoRp,0.1111111111111111,8,8,TCTTGCAAGAACTTCAATAC,0,838463
dgoRp,0.1111111111111111,8,8,TCTTCATAGCGTTCCGTTCA,0,845296
dgoRp,0.1111111111111111,8,8,TCTAGTTACGCACTCAAGAA,0,842805
dgoRp,0.1111111111111111,8,8,TCGGTTCCGTCTTTTGGGCG,0,849080
dgoRp,0.1111111111111111,8,8,TCGCGTGTAATAATGAGTCA,0,855776
dgoRp,0.1111111111111111,8,8,TCGAATCACTGGATGATTTA,0,852402
dgoRp,0.1111111111111111,8,8,TCCTGTTTCAGATCCGTCTG,0,842660
dgoRp,0.1111111111111111,8,8,TCCGTGGTAAGGTGCTTGTG,0,864148
dgoRp,0.1111111111111111,8,8,TCCCTTGTTACAACCGGTGA,0,864560
dgoRp,0.1111111111111111,8,8,TCAGCATTGCCGACAGTGAG,0,839101
dgoRp,0.1111111111111111,8,8,TCAGCAGCAAACGATATACT,0,839539
dgoRp,0.1111111111111111,8,8,TCACTCAGCTAACCGGCGAA,0,848116
dgoRp,0.1111111111111111,8,8,TCACAGTGAGCTGTTTTGTT,0,865510
dgoRp,0.1111111111111111,8,8,TATTTCGCCGTGAAACGAAT,0,856495
dgoRp,0.1111111111111111,8,8,TATTGCAGCGTATTTAGTGC,0,846651
dgoRp,0.1111111111111111,8,8,TATGCCGTGGATTCAGGAAA,0,862929
dgoRp,0.1111111111111111,8,8,TATGAGTTGCCCGTGATCTC,0,857293
dgoRp,0.1111111111111111,8,8,TATCGCAATGTAACCCCGTC,0,840675
dgoRp,0.1111111111111111,8,8,TATCCGAGAAATGACGGGAC,0,852908
dgoRp,0.1111111111111111,8,8,TATCAGAAAGTTGCTCTATT,0,856748
dgoRp,0.1111111111111111,8,8,TATACGTAAATCATCAGCCT,0,843832
dgoRp,0.1111111111111111,8,8,TAGAAACCGTGATCGTAGCG,0,851707
dgoRp,0.1111111111111111,8,8,TACATGCCTTGGATTGGGAA,0,860427
dgoRp,0.1111111111111111,8,8,TAATGACTGGGTGTGAATAC,0,855547
dgoRp,0.1111111111111111,8,8,TAATACGTTGGGCGGCGAAA,0,849365
dgoRp,0.1111111111111111,8,8,TAAGTCTCTTTTGCGGCGGC,0,855765
dgoRp,0.1111111111111111,8,8,TAAGATTTTACTCCTCGCCT,0,845186
dgoRp,0.1111111111111111,8,8,TAACGGTTACATTAGGGTAC,0,838629
dgoRp,0.1111111111111111,8,8,GTTTTCCGTGGTCATGTCTT,0,844348
dgoRp,0.1111111111111111,8,8,GTTTCCTTTTGAAAACCCCG,0,846863
dgoRp,0.1111111111111111,8,8,GTTGTTTAGCTTCTCTGCCG,0,836335
dgoRp,0.1111111111111111,8,8,GTTGTGGTTCGTGCACAGTA,0,854751
dgoRp,0.1111111111111111,8,8,GTTCCAAGTCTAGCAGGAGG,0,854696
dgoRp,0.1111111111111111,8,8,GTTCATGCAATACTAGCGTT,0,844056
dgoRp,0.1111111111111111,8,8,GTGTTGGACGGACCCAATTA,0,865946
dgoRp,0.1111111111111111,8,8,GTGGTTTTTCAGACGCTTGA,0,859296
dgoRp,0.1111111111111111,8,8,GTGCGACGTGAGGGTAACCA,0,861460
dgoRp,0.1111111111111111,8,8,GTGCCGGGACAGTGTCACAC,0,839462
dgoRp,0.1111111111111111,8,8,GTGATAAAGCATTGGGTATT,0,844834
dgoRp,0.1111111111111111,8,8,GTCTGTGTCGGCTTGAGTAA,0,855514
dgoRp,0.1111111111111111,8,8,GTCTGAAAAGGACCTGTCGC,0,861459
dgoRp,0.1111111111111111,8,8,GTCGTCGTAAACCCTTAGAG,0,844647
dgoRp,0.1111111111111111,8,8,GTCGTAGGGGAGGAACACAT,0,840711
dgoRp,0.1111111111111111,8,8,GTCCTAGGTACGCGAAGAGA,0,850626
dgoRp,0.1111111111111111,8,8,GTCCCGGTGAAATTCAAGGG,0,856677
dgoRp,0.1111111111111111,8,8,GTAGTGGGGTGCTCCGACAG,0,862932
dgoRp,0.1111111111111111,8,8,GTAGTAGTCGAGATCGACAG,0,847279
dgoRp,0.1111111111111111,8,8,GTAGGGGAAGTATTTGTAAC,0,845288
dgoRp,0.1111111111111111,8,8,GTACTAATCGACGGGAGTCG,0,847575
dgoRp,0.1111111111111111,8,8,GGTTATGCAGGGGGTATTAC,0,855974
dgoRp,0.1111111111111111,8,8,GGTCCGGACCCAGCTCGTGT,0,848684
dgoRp,0.1111111111111111,8,8,GGTATTGTCGTTTGGTGTCG,0,841817
dgoRp,0.1111111111111111,8,8,GGTAATTCGCGCAGTAGCAT,0,856308
dgoRp,0.1111111111111111,8,8,GGTAACAGACTCTATGGCGT,0,867078
dgoRp,0.1111111111111111,8,8,GGTAAACACCCGTGACTGTC,0,863238
dgoRp,0.1111111111111111,8,8,GGGTTGTTGCAAGACGTTCT,0,840289
dgoRp,0.1111111111111111,8,8,GGGTTAGACGCAAAAAAGGG,0,840115
dgoRp,0.1111111111111111,8,8,GGGGGTCTCAGTCTAGGGGA,0,843809
dgoRp,0.1111111111111111,8,8,GGGGGGAAAGAACGGTGAGA,0,838490
dgoRp,0.1111111111111111,8,8,GGGGCTACCGTGTTTGCCAG,0,861937
dgoRp,0.1111111111111111,8,8,GGGGCCAAGACCGCGATTGA,0,857341
dgoRp,0.1111111111111111,8,8,GGGGACCGAAGTCTCAGTGT,0,863683
dgoRp,0.1111111111111111,8,8,GGGCGGCGTTTAATGCATCG,0,841943
dgoRp,0.1111111111111111,8,8,GGGCACGATTAACCGATATC,0,862456
dgoRp,0.1111111111111111,8,8,GGGCAATTTCTAACAATGGG,0,843797
dgoRp,0.1111111111111111,8,8,GGGCAAAGGCGCTCGGTTTT,0,850032
dgoRp,0.1111111111111111,8,8,GGGATCGGTCCGGCGGCCCA,0,855688
dgoRp,0.1111111111111111,8,8,GGGAGGCTTCCTCCTACACA,0,852966
dgoRp,0.1111111111111111,8,8,GGGACGCCTGACGGACAAAC,0,848572
dgoRp,0.1111111111111111,8,8,GGGAATGATACGGCTGGCGT,0,842974
dgoRp,0.1111111111111111,8,8,GGCTCCGTACATCCCCCTCG,0,848478
dgoRp,0.1111111111111111,8,8,GGCGTCATAGACCCATGGTA,0,842070
dgoRp,0.1111111111111111,8,8,GGCGGGTCGTTTATTGGGAG,0,852613
dgoRp,0.1111111111111111,8,8,GGCCGTCCATCAGGCCTGCA,0,838400
dgoRp,0.1111111111111111,8,8,GGCATTTCAGGACCCCCAAT,0,861991
dgoRp,0.1111111111111111,8,8,GGCATCTACCAGTATATCCA,0,859056
dgoRp,0.1111111111111111,8,8,GGCACAAGAGGGTGAAGTCA,0,842294
dgoRp,0.1111111111111111,8,8,GGATAGGGTCTTTCGTACGT,0,863651
dgoRp,0.1111111111111111,8,8,GGAAGCCTACAGTCTCCCAG,0,860168
dgoRp,0.1111111111111111,8,8,GGAAATCAGCCATGTGACCA,0,860453
dgoRp,0.1111111111111111,8,8,GCTCTACTCCATTCGCGGGG,0,862962
dgoRp,0.1111111111111111,8,8,GCTCCTGGTCTGATCGGACA,0,845903
dgoRp,0.1111111111111111,8,8,GCTAAGGGTTGTAACTGCTT,0,857584
dgoRp,0.1111111111111111,8,8,GCGTCAGGTGGACTATCACG,0,847842
dgoRp,0.1111111111111111,8,8,GCGGGGAATTAAGTCTCGTA,0,850862
dgoRp,0.1111111111111111,8,8,GCGGGCAGCTATAAGATGAT,0,845238
dgoRp,0.1111111111111111,8,8,GCGAGGTGCTCCGACACTTT,0,854204
dgoRp,0.1111111111111111,8,8,GCGAACGAAATGTGATTTAT,0,844375
dgoRp,0.1111111111111111,8,8,GCCCCCGGAGAGCCTCAGAC,0,848190
dgoRp,0.1111111111111111,8,8,GCCAGCATTTGCATAGTGAG,0,844191
dgoRp,0.1111111111111111,8,8,GCATTGACGGTAAGGGGCAA,0,867401
dgoRp,0.1111111111111111,8,8,GCATACCAGGGACTATTTGT,0,838523
dgoRp,0.1111111111111111,8,8,GCAGCTAGGCGTTGAGCCTA,0,840187
dgoRp,0.1111111111111111,8,8,GCACTGGGCCTTAAGTAAGC,0,842447
dgoRp,0.1111111111111111,8,8,GCAATGGACTGCACCCGGGA,0,859285
dgoRp,0.1111111111111111,8,8,GCAACATTAGACAACCTTTG,0,844572
dgoRp,0.1111111111111111,8,8,GATGCGGGTTGTCCAGGATT,0,839623
dgoRp,0.1111111111111111,8,8,GATCTGGCGAGTGTCCGTAT,0,860895
dgoRp,0.1111111111111111,8,8,GATCCTATTAGACGTGAACC,0,861314
dgoRp,0.1111111111111111,8,8,GATATGAGCTCAACTCTGGG,0,838542
dgoRp,0.1111111111111111,8,8,GAGTCACCTCCGACTTTGTC,0,840642
dgoRp,0.1111111111111111,8,8,GAGCCTGTAGGAAGCGCCAC,0,844109
dgoRp,0.1111111111111111,8,8,GAGAGCCGTAACGTTGGAAT,0,864725
dgoRp,0.1111111111111111,8,8,GAGAACATGGGCTAAACGAA,0,861734
dgoRp,0.1111111111111111,8,8,GACTTTTCCCCCAGATTCTT,0,837334
dgoRp,0.1111111111111111,8,8,GACTTCAGATTACCGCGTGC,0,860913
dgoRp,0.1111111111111111,8,8,GACTGGGTCAATATGGTACC,0,852024
dgoRp,0.1111111111111111,8,8,GACGGTTCCGCTGGGACCTA,0,849573
dgoRp,0.1111111111111111,8,8,GACCTTACGGCCCGCAGACG,0,836424
dgoRp,0.1111111111111111,8,8,GACCAGCGAGGCTCGCACTG,0,842639
dgoRp,0.1111111111111111,8,8,GACAGCAGCATGGGACCTAA,0,837418
dgoRp,0.1111111111111111,8,8,GACACATATTTAATCCTCCA,0,861626
dgoRp,0.1111111111111111,8,8,GAATCCCAAGTGTGGCGACT,0,858899
dgoRp,0.1111111111111111,8,8,GAAAAAACGGAAGTGAATCC,0,848594
dgoRp,0.1111111111111111,8,8,CTTTGGGATCGAGCTAACCT,0,843840
dgoRp,0.1111111111111111,8,8,CTTTCTAGTAGCACATCGAT,0,864521
dgoRp,0.1111111111111111,8,8,CTTGTGGCCAACCGGTCGTA,0,867490
dgoRp,0.1111111111111111,8,8,CTTGTCGTCAATGTCGGACT,0,863384
dgoRp,0.1111111111111111,8,8,CTTGGAAAATTGCTTACGGC,0,861820
dgoRp,0.1111111111111111,8,8,CTTCAGAATCCAACTGCCCC,0,847803
dgoRp,0.1111111111111111,8,8,CTTAGTTTAGAGTAAAGGAA,0,854294
dgoRp,0.1111111111111111,8,8,CTGGCTGTGCACCAATATCA,0,861527
dgoRp,0.1111111111111111,8,8,CTCTTCCCGCCTGCCCGAAG,0,860888
dgoRp,0.1111111111111111,8,8,CTCTTAACGTTGCATGCGGG,0,857871
dgoRp,0.1111111111111111,8,8,CTCTCAATCTTTCGACGCAG,0,842225
dgoRp,0.1111111111111111,8,8,CTCTACCAGGCAGTAACCTT,0,855237
dgoRp,0.1111111111111111,8,8,CTCGTTCACGCAGGGGCAGC,0,857882
dgoRp,0.1111111111111111,8,8,CTCCTGCAGACAGGGGGTTG,0,835897
dgoRp,0.1111111111111111,8,8,CTCCATGCGTAGACCTCGAC,0,865693
dgoRp,0.1111111111111111,8,8,CTCATTGCGGTCCTCTCTTC,0,838433
dgoRp,0.1111111111111111,8,8,CTCATGAAGTGAGGGACGGC,0,857275
dgoRp,0.1111111111111111,8,8,CTCATCGGGTAAAACGGGAG,0,859868
dgoRp,0.1111111111111111,8,8,CTCACGCCGGTCCCGGACAT,0,844914
dgoRp,0.1111111111111111,8,8,CTCAAAAACAGGGGTTATCT,0,858869
dgoRp,0.1111111111111111,8,8,CTATCTACGCTGGGACTCGG,0,847799
dgoRp,0.1111111111111111,8,8,CTATCCTCAGGGTGGCAGTT,0,839946
dgoRp,0.1111111111111111,8,8,CTAGAGGATATGCGCTCGAT,0,842688
dgoRp,0.1111111111111111,8,8,CTACTTGCGCGTGTTCATTT,0,860220
dgoRp,0.1111111111111111,8,8,CGTTTCTTAGCGCTGGGCTC,0,836874
dgoRp,0.1111111111111111,8,8,CGTTTATCGTTGGTGAACGG,0,864122
dgoRp,0.1111111111111111,8,8,CGTCTGTATTGAGGGATTGT,0,842844
dgoRp,0.1111111111111111,8,8,CGGTGCCATGCGGGTTGCCA,0,861185
dgoRp,0.1111111111111111,8,8,CGGTAACGCCCGACCGGGAT,0,843162
dgoRp,0.1111111111111111,8,8,CGGTAACGACCAATCTAACT,0,846907
dgoRp,0.1111111111111111,8,8,CGGGATCCAAGGACCTAATC,0,838386
dgoRp,0.1111111111111111,8,8,CGGAGGCCTACACATATGCA,0,846549
dgoRp,0.1111111111111111,8,8,CGGAGGATTACACGGTATTG,0,849872
dgoRp,0.1111111111111111,8,8,CGGAGACGCTACAACCCTTG,0,865871
dgoRp,0.1111111111111111,8,8,CGCGCTGGATTAATGGAAGG,0,854136
dgoRp,0.1111111111111111,8,8,CGCGCGGGAAACACGTAACT,0,852811
dgoRp,0.1111111111111111,8,8,CGCATCTCTATGTTAGTCGT,0,863968
dgoRp,0.1111111111111111,8,8,CGCAGTGATATTACCAAATC,0,853458
dgoRp,0.1111111111111111,8,8,CGCACTCGCTTAATGGGTGT,0,845158
dgoRp,0.1111111111111111,8,8,CGATGATGCAATCTCGCCCT,0,854366
dgoRp,0.1111111111111111,8,8,CGAGTTCTATCCTGTGGCAT,0,850660
dgoRp,0.1111111111111111,8,8,CGAGGTCCAGAAACGGTTAC,0,838483
dgoRp,0.1111111111111111,8,8,CGACGGGTGGTAGGTAGGCT,0,837117
dgoRp,0.1111111111111111,8,8,CGAAGGTATCTCTTACATCG,0,855788
dgoRp,0.1111111111111111,8,8,CGAACTCCCCTAGGGGATGG,0,853609
dgoRp,0.1111111111111111,8,8,CCTTCGTAATTATTTAACTG,0,844426
dgoRp,0.1111111111111111,8,8,CCTTCGCGCACCGCGGACTA,0,853731
dgoRp,0.1111111111111111,8,8,CCTGGATCTCAGGGGGTGTT,0,849338
dgoRp,0.1111111111111111,8,8,CCTGCGGGCATTGCGCCCGC,0,842787
dgoRp,0.1111111111111111,8,8,CCTCGGGGCATTCGGTTAAG,0,863163
dgoRp,0.1111111111111111,8,8,CCTAGAACGGCGATGCACAT,0,841463
dgoRp,0.1111111111111111,8,8,CCGTTTTGTTTGCCGACGGG,0,853936
dgoRp,0.1111111111111111,8,8,CCGTATCGTCAAATCACCCC,0,866566
dgoRp,0.1111111111111111,8,8,CCGAGTTAACGCTACGGCCG,0,863869
dgoRp,0.1111111111111111,8,8,CCCTTTTGTTTTCGGAAGAG,0,852191
dgoRp,0.1111111111111111,8,8,CCCTGCCTTCATCCGCCACA,0,838577
dgoRp,0.1111111111111111,8,8,CCCTCAGAGGGGTCCTCGGT,0,851521
dgoRp,0.1111111111111111,8,8,CCCGCTACGTTGGCTGCCCC,0,843896
dgoRp,0.1111111111111111,8,8,CCCGCCATTACGGCGATGAA,0,841988
dgoRp,0.1111111111111111,8,8,CCCCAATTCCGGGCAGCACG,0,856061
dgoRp,0.1111111111111111,8,8,CCCAGGAGCTTCAAGCATTC,0,848659
dgoRp,0.1111111111111111,8,8,CCAGGTTGTGCGCCTACCAA,0,858897
dgoRp,0.1111111111111111,8,8,CCAGGGGAGTGCGTGAACCA,0,856489
dgoRp,0.1111111111111111,8,8,CCAGGCCATCTATTATTATC,0,846475
dgoRp,0.1111111111111111,8,8,CCAAGTCGTCATATATTGAG,0,852848
dgoRp,0.1111111111111111,8,8,CCAAGATCGAGAGCTTTTCC,0,851784
dgoRp,0.1111111111111111,8,8,CATTACCGTTAAGTCGCCGA,0,845636
dgoRp,0.1111111111111111,8,8,CATGAGTCAGGGGACCTTCA,0,843804
dgoRp,0.1111111111111111,8,8,CATGAAAATTGGAAGAGCGA,0,844279
dgoRp,0.1111111111111111,8,8,CATCAGTAGCGTTGCGTTAT,0,838630
dgoRp,0.1111111111111111,8,8,CATCACATCAATGTAACGTG,0,837753
dgoRp,0.1111111111111111,8,8,CATACTAAACGGGAGTGCAT,0,845223
dgoRp,0.1111111111111111,8,8,CATAAGTTTATGGAATACTT,0,861654
dgoRp,0.1111111111111111,8,8,CAGTTTTGCGAAGCTTATCA,0,839481
dgoRp,0.1111111111111111,8,8,CAGTTACTCGCTGTGATAGG,0,865982
dgoRp,0.1111111111111111,8,8,CAGTTAAAAGGGAGTGGCCT,0,856592
dgoRp,0.1111111111111111,8,8,CAGTATATGCCATATAACTA,0,862067
dgoRp,0.1111111111111111,8,8,CAGGGCGCGCTGGAATAGAC,0,863310
dgoRp,0.1111111111111111,8,8,CAGGATAGAGGAGCCACACA,0,847040
dgoRp,0.1111111111111111,8,8,CAGGAGGATTCATCGTGAGC,0,843659
dgoRp,0.1111111111111111,8,8,CAGCTACTTGCGCAGCCGTA,0,851215
dgoRp,0.1111111111111111,8,8,CAGAATGAATAGGCTTGGTG,0,851490
dgoRp,0.1111111111111111,8,8,CACTTAAAGTGGCGGGCTTG,0,838432
dgoRp,0.1111111111111111,8,8,CACGTCGTGTAACTAGGAAA,0,848611
dgoRp,0.1111111111111111,8,8,CACCTTAGCGATCGATCGAA,0,841135
dgoRp,0.1111111111111111,8,8,CAATCGGCTTACGGGAGAGC,0,844693
dgoRp,0.1111111111111111,8,8,CAAGTCGGTATATAATCAGT,0,837092
dgoRp,0.1111111111111111,8,8,CAACATTTGCCGCACATTTA,0,843673
dgoRp,0.1111111111111111,8,8,CAAACAGGCGACAGGGTTCA,0,859576
dgoRp,0.1111111111111111,8,8,ATTTGTGCACTGTAACCGGG,0,858668
dgoRp,0.1111111111111111,8,8,ATTGTTACCCTGTTGGCATC,0,843937
dgoRp,0.1111111111111111,8,8,ATTGGATGAAGCCCGCAATA,0,853845
dgoRp,0.1111111111111111,8,8,ATTGATTCCCTTGGTCAAAG,0,842236
dgoRp,0.1111111111111111,8,8,ATTCGTCGGTCTGCTGTGCT,0,838194
dgoRp,0.1111111111111111,8,8,ATTACATAGGATTTGTTGGA,0,855892
dgoRp,0.1111111111111111,8,8,ATTAATATCTCGTGCGGTGT,0,867302
dgoRp,0.1111111111111111,8,8,ATTAAGTTGCATCTTGTTAA,0,844664
dgoRp,0.1111111111111111,8,8,ATTAAACAGGTTCGAGGGAA,0,842214
dgoRp,0.1111111111111111,8,8,ATGTTTAAGCTAGGTAATTA,0,858816
dgoRp,0.1111111111111111,8,8,ATGTCCCTCATGACCCCAAA,0,860812
dgoRp,0.1111111111111111,8,8,ATGTATTTTTTGGAGCTAGG,0,858037
dgoRp,0.1111111111111111,8,8,ATGGGCATTCTCGACTTGCG,0,839703
dgoRp,0.1111111111111111,8,8,ATGGCCGCATGAGGCCGAGC,0,836893
dgoRp,0.1111111111111111,8,8,ATGCTATCATCTACGCTTAA,0,866840
dgoRp,0.1111111111111111,8,8,ATCTTAGACAAAGCGCGCCT,0,850717
dgoRp,0.1111111111111111,8,8,ATCGATCCGTTGGAGGTGTT,0,855044
dgoRp,0.1111111111111111,8,8,ATCCGATGTGGATATCACCA,0,846233
dgoRp,0.1111111111111111,8,8,ATCCATCGTACCTTATTGCG,0,866412
dgoRp,0.1111111111111111,8,8,ATCAGCTGTAGTACGTAGTA,0,842541
dgoRp,0.1111111111111111,8,8,ATATCACTTTCCAAGTTCCG,0,839989
dgoRp,0.1111111111111111,8,8,ATAGTCAGGTCACGGATAAA,0,847176
dgoRp,0.1111111111111111,8,8,ATACTCCGCTATGTTAGTAG,0,838206
dgoRp,0.1111111111111111,8,8,ATACGGCCAGAATAAGGTCT,0,855550
dgoRp,0.1111111111111111,8,8,ATACCAAGCCTCGAGCTCGC,0,863372
dgoRp,0.1111111111111111,8,8,ATACAGGATCGTGCTAGGGT,0,848023
dgoRp,0.1111111111111111,8,8,ATAATCTGGCATCTTGTTTT,0,846474
dgoRp,0.1111111111111111,8,8,ATAAATGCAGTGCTCCGGGG,0,865235
dgoRp,0.1111111111111111,8,8,AGTTGCGGATTTAAACGGCT,0,863526
dgoRp,0.1111111111111111,8,8,AGTGCGACCGGGTTACACTA,0,860067
dgoRp,0.1111111111111111,8,8,AGTCTTGCAATTCAAGGCCT,0,836062
dgoRp,0.1111111111111111,8,8,AGTCTATGCGGAGTCAGGAA,0,848682
dgoRp,0.1111111111111111,8,8,AGTCGAGTAAAAAAGTAGAT,0,844903
dgoRp,0.1111111111111111,8,8,AGTCCTTGCTAGTGCAACGA,0,848981
dgoRp,0.1111111111111111,8,8,AGTCATAACTCTTAAATCTA,0,862612
dgoRp,0.1111111111111111,8,8,AGTAGTCTATACTTACGTTC,0,865779
dgoRp,0.1111111111111111,8,8,AGTAGATAGGCGTCACGTCT,0,859316
dgoRp,0.1111111111111111,8,8,AGGTGTAATTGCCCCCATTT,0,861625
dgoRp,0.1111111111111111,8,8,AGGCGATTTGCTACTTTAAG,0,854713
dgoRp,0.1111111111111111,8,8,AGGCAATCGAGGGCTGATGC,0,865423
dgoRp,0.1111111111111111,8,8,AGGACTATGTCACGCGACAA,0,840339
dgoRp,0.1111111111111111,8,8,AGGAATCTTCCTTACCAGCG,0,857109
dgoRp,0.1111111111111111,8,8,AGGAAGTCCGAAGGTGGCTC,0,854418
dgoRp,0.1111111111111111,8,8,AGCTAGGTCAGGTTGGGAGG,0,862372
dgoRp,0.1111111111111111,8,8,AGCTAGCCGCAGTGGTATTG,0,857959
dgoRp,0.1111111111111111,8,8,AGCGGCACGAGCACGCACCA,0,848139
dgoRp,0.1111111111111111,8,8,AGCATTTCCGTTGCCCGCCC,0,861160
dgoRp,0.1111111111111111,8,8,AGCAGTCAAAGGTGCTGCTT,0,853261
dgoRp,0.1111111111111111,8,8,AGCACCGCGGACCTATGGAT,0,863924
dgoRp,0.1111111111111111,8,8,AGAGTAGGGTTCGGGATTTC,0,849177
dgoRp,0.1111111111111111,8,8,AGAGTACACAACCTCCCGTA,0,839416
dgoRp,0.1111111111111111,8,8,AGAAGACCCAGACAGATCAT,0,837369
dgoRp,0.1111111111111111,8,8,AGAACATAGGTCGTCTTAGT,0,850944
dgoRp,0.1111111111111111,8,8,ACTTAACACCGCGCGCCTAC,0,845385
dgoRp,0.1111111111111111,8,8,ACTGGAAGGGTGCTGGTGGC,0,846579
dgoRp,0.1111111111111111,8,8,ACTGAGGTCCCAAGGATCCA,0,846783
dgoRp,0.1111111111111111,8,8,ACTCTACAAAGGAACCACTG,0,859623
dgoRp,0.1111111111111111,8,8,ACTCGCAGGGAAGAATACTA,0,859935
dgoRp,0.1111111111111111,8,8,ACTCCGTGGCCGAACACAGG,0,849982
dgoRp,0.1111111111111111,8,8,ACTAGGCGACCTGCGCGAAC,0,855283
dgoRp,0.1111111111111111,8,8,ACGTGGGAGAGGAACAGGAA,0,850876
dgoRp,0.1111111111111111,8,8,ACGTCATCAGCAGATTACCG,0,845751
dgoRp,0.1111111111111111,8,8,ACGTATCGCTTCTAGAGAGG,0,849463
dgoRp,0.1111111111111111,8,8,ACGCATCTTCAAACGCAGAC,0,855845
dgoRp,0.1111111111111111,8,8,ACGATTTCCAATTTGACGCG,0,843368
dgoRp,0.1111111111111111,8,8,ACGATATGTATGCACAAGGC,0,839132
dgoRp,0.1111111111111111,8,8,ACCTTCGGTCCCGGGAAGAA,0,857248
dgoRp,0.1111111111111111,8,8,ACCGTATTCCTCGATTATAG,0,865189
dgoRp,0.1111111111111111,8,8,ACCGTATGGAATATGATGGT,0,838140
dgoRp,0.1111111111111111,8,8,ACCGGGGTTTTTGTTCCCCA,0,839295
dgoRp,0.1111111111111111,8,8,ACCGGGGTATGATCGCATAT,0,843739
dgoRp,0.1111111111111111,8,8,ACCGCATTCTTGGTACTTTG,0,844855
dgoRp,0.1111111111111111,8,8,ACCCTCTCGCAAATGACCCT,0,850818
dgoRp,0.1111111111111111,8,8,ACCCAGCGTTTACTCGCGAG,0,835943
dgoRp,0.1111111111111111,8,8,ACCCAAGGTGCGATCGTAGT,0,848713
dgoRp,0.1111111111111111,8,8,ACCACAGCTCCAATGATCTT,0,844973
dgoRp,0.1111111111111111,8,8,ACAGTCGTTATTTTTCCGGC,0,858840
dgoRp,0.1111111111111111,8,8,ACACGACGGCGCGACTACCG,0,849173
dgoRp,0.1111111111111111,8,8,AATTGATTCTACGGGAAAGG,0,854027
dgoRp,0.1111111111111111,8,8,AATTAGTTGAAATGTAAAGT,0,845805
dgoRp,0.1111111111111111,8,8,AATGGCACATCAGTGCCGTA,0,847625
dgoRp,0.1111111111111111,8,8,AATCTAGGGCAAATATCTCC,0,855692
dgoRp,0.1111111111111111,8,8,AATCGGGTGCTCCAGAATAA,0,837107
dgoRp,0.1111111111111111,8,8,AATCAGTAGTTCGATTTAGT,0,839483
dgoRp,0.1111111111111111,8,8,AATCAGGTACATATAGGTTG,0,860870
dgoRp,0.1111111111111111,8,8,AATATCCTCTTAGAAGAACC,0,842745
dgoRp,0.1111111111111111,8,8,AAGTCGCGGGAACTTAGCAG,0,858177
dgoRp,0.1111111111111111,8,8,AAGGGTTGGGTTAAAGGGCG,0,863603
dgoRp,0.1111111111111111,8,8,AAGGAGTATGAATCGAGGCC,0,854588
dgoRp,0.1111111111111111,8,8,AAGCGAGGTTAGTGCCCCCC,0,866640
dgoRp,0.1111111111111111,8,8,AAGCAGAGCGCGAGGCAGCC,0,852946
dgoRp,0.1111111111111111,8,8,AACTTCGGCCAATGGGATTG,0,859883
dgoRp,0.1111111111111111,8,8,AACTCCAGCGGGTGCAGGTC,0,854308
dgoRp,0.1111111111111111,8,8,AACCGGGGTTAACGCTTATT,0,862588
dgoRp,0.1111111111111111,8,8,AACCCTATGGAGAGTCCTGT,0,844791
dgoRp,0.1111111111111111,8,8,AACCACATCCCTGTCGGAGA,0,855829
dgoRp,0.1111111111111111,8,8,AACAATCCGCTCACGCGCAG,0,863921
dgoRp,0.1111111111111111,8,8,AAATTGAATCCCGTATTTGT,0,858100
dgoRp,0.1111111111111111,8,8,AAATCCAGCGGTCTGTGGAA,0,852617
dgoRp,0.1111111111111111,8,8,AAAAAGAGTTGATGAACGGA,0,860710
dgoRp,0.1111111111111111,8,8,AAAAAGAAACAGTCTGCTTA,0,862044
dgoRp,0.125,7,7,TTTTCAAAAAGGTAGCAGTT,0,847067
dgoRp,0.125,7,7,TTTTACTACATTGGGTCAGA,0,865718
dgoRp,0.125,7,7,TTGTGCACTAAAGCAATAAA,0,838911
dgoRp,0.125,7,7,TTGTGCAAGAGTAATTCAGA,0,849742
dgoRp,0.125,7,7,TTGTCCCAACGGCAGATAGA,0,843288
dgoRp,0.125,7,7,TTGGGGTCAATGACCTCGCA,0,864466
dgoRp,0.125,7,7,TTGGAGCTTACTAAACACCC,0,841613
dgoRp,0.125,7,7,TTGCTGTGGAGGCCTTACGT,0,855709
dgoRp,0.125,7,7,TTGCCGTGGCATTGTGCAAG,0,855894
dgoRp,0.125,7,7,TTGCACAAAACCTGATTCAA,0,859323
dgoRp,0.125,7,7,TTGATAACAGTTCGAAGATA,0,840148
dgoRp,0.125,7,7,TTGAGTCCGCGAACTAGAAA,0,856909
dgoRp,0.125,7,7,TTCGTCCAAAGAGGGTCAGC,0,837342
dgoRp,0.125,7,7,TTCGCGGTTCTTCCCATTCA,0,840626
dgoRp,0.125,7,7,TTAGCGCACAGCCTCTACTT,0,842846
dgoRp,0.125,7,7,TTAGAGGTTGTTTGTAATTG,0,858825
dgoRp,0.125,7,7,TTAATGTATCCTCCGTGCTG,0,861486
dgoRp,0.125,7,7,TTAACGGGACGTTACACCGG,0,847582
dgoRp,0.125,7,7,TGTTTCTTGGGAGTGTCCGC,0,859476
dgoRp,0.125,7,7,TGTTCACACCGCGCAGATCG,0,850501
dgoRp,0.125,7,7,TGTGGGGCTTTATGGAAATG,0,862156
dgoRp,0.125,7,7,TGTACTCACACAGGTAGCTA,0,837382
dgoRp,0.125,7,7,TGTACGCGCCACAAAGAAAC,0,848838
dgoRp,0.125,7,7,TGGTCTGGCACACCTATTAT,0,867291
dgoRp,0.125,7,7,TGGTCTCCGGAAGTCCAGAT,0,850954
dgoRp,0.125,7,7,TGGGCCGGGGTCGCATTAAG,0,862179
dgoRp,0.125,7,7,TGGGACCCATTTCCGGATCA,0,844233
dgoRp,0.125,7,7,TGGCCAGCAGACAAAAAGTA,0,838430
dgoRp,0.125,7,7,TGGCATGTTCTCCTTCTGCC,0,843433
dgoRp,0.125,7,7,TGGCAGTCAAGACGTTCGAA,0,856876
dgoRp,0.125,7,7,TGCTTTCGGGTCTAGCGCAA,0,849578
dgoRp,0.125,7,7,TGCGAGCCATCTTGGGGCTG,0,856996
dgoRp,0.125,7,7,TGCCCGTGGATTCTCGTAGG,0,850064
dgoRp,0.125,7,7,TGACATATTCCCCTTGGTGA,0,867235
dgoRp,0.125,7,7,TGAAGGTAATTCTGCGCGGA,0,839981
dgoRp,0.125,7,7,TCTGCGAATGTAGCCGGCCT,0,836693
dgoRp,0.125,7,7,TCTGAAGTAGGCTGGTAGAT,0,851221
dgoRp,0.125,7,7,TCTCTAAATGGCATGTTTGC,0,861861
dgoRp,0.125,7,7,TCGTATACTTAGATACCTGG,0,844653
dgoRp,0.125,7,7,TCGGCGGCATAGGGTCGTAC,0,839501
dgoRp,0.125,7,7,TCGGCAGGAAGCGGCACGCA,0,853075
dgoRp,0.125,7,7,TCGATCATGTGACTAAGGCA,0,841367
dgoRp,0.125,7,7,TCGACTTGGTCGGTGAATAC,0,856961
dgoRp,0.125,7,7,TCCTGGAGACAAGTAATCGC,0,837807
dgoRp,0.125,7,7,TCCTGCACGTCCCGATATCC,0,839511
dgoRp,0.125,7,7,TCCCTGTGCACCTCCAGTTT,0,864627
dgoRp,0.125,7,7,TCACGAAGATGGTGTCAACA,0,853220
dgoRp,0.125,7,7,TATTCTGGCTTGGCCCCGAT,0,847524
dgoRp,0.125,7,7,TATGTCATGTCCGAATTATT,0,865947
dgoRp,0.125,7,7,TATGACTGGCCGAAGAGGTT,0,848529
dgoRp,0.125,7,7,TATCAGACCGAACTGTGGCA,0,847730
dgoRp,0.125,7,7,TAGGCCTAGGCGCATTTAAC,0,854733
dgoRp,0.125,7,7,TAGCTTAGTGACTTCCTGCA,0,861221
dgoRp,0.125,7,7,TAGATATAATTGAGCGTCAT,0,858646
dgoRp,0.125,7,7,TAGAAACTAAAGGCTTATCA,0,861561
dgoRp,0.125,7,7,TACTGTGGCATTAAATAAGG,0,855460
dgoRp,0.125,7,7,TACTCTTGGCTAACTTTACC,0,838526
dgoRp,0.125,7,7,TACGCTCTCTCAGTCCAATT,0,865318
dgoRp,0.125,7,7,TACGCCGAGACAAGTTCTAA,0,849440
dgoRp,0.125,7,7,TACAAAATGGCCTTTGAAGT,0,862497
dgoRp,0.125,7,7,TAAGTGATTTTTCGGGGCGG,0,841196
dgoRp,0.125,7,7,TAAGGATAGCTGACCGCCAA,0,848255
dgoRp,0.125,7,7,TAAGCGATATTGAGACGTAG,0,839087
dgoRp,0.125,7,7,TAACGTCCAGCCGGTCTTGA,0,850547
dgoRp,0.125,7,7,TAACGCCAGTGTGGCGTCTC,0,854278
dgoRp,0.125,7,7,TAAATATCATTTTCCGGATC,0,854647
dgoRp,0.125,7,7,TAAAGTTGACGTCATAGGCA,0,862185
dgoRp,0.125,7,7,GTTGAGGCTCGCGAGTATTT,0,839405
dgoRp,0.125,7,7,GTTGACATACTTACTCCAAA,0,839991
dgoRp,0.125,7,7,GTTCGCGCTTCGGTAGCTGT,0,838610
dgoRp,0.125,7,7,GTTAAAAAGTTACTTAATTA,0,857623
dgoRp,0.125,7,7,GTGTCCTGAACCTAGCCCAC,0,835950
dgoRp,0.125,7,7,GTGTACCGCAGCTCGCATAC,0,840836
dgoRp,0.125,7,7,GTGGTGAAAGTAGTTGTGAT,0,837740
dgoRp,0.125,7,7,GTGGGATAGAAATATCCAGC,0,842694
dgoRp,0.125,7,7,GTCTTTGCGTCAAACAGCCT,0,845386
dgoRp,0.125,7,7,GTCTCTCTTGAAGTCGCCAA,0,850950
dgoRp,0.125,7,7,GTCTATTAAGAGGCCTGGGA,0,836385
dgoRp,0.125,7,7,GTCCATTTAAAACTTGAGAA,0,837869
dgoRp,0.125,7,7,GTCATGTTGTTAGGCTGAAA,0,860202
dgoRp,0.125,7,7,GTACCGGTTAACGTCATCAA,0,846682
dgoRp,0.125,7,7,GGTTGTGCATATGATGGCGG,0,842100
dgoRp,0.125,7,7,GGTTGATTACTACTTAGACT,0,866601
dgoRp,0.125,7,7,GGTTCCTGAACACGATTGAT,0,847672
dgoRp,0.125,7,7,GGTTAGAGACGGTATCCCCA,0,858051
dgoRp,0.125,7,7,GGTTAGAAATCCATGAAAGG,0,837821
dgoRp,0.125,7,7,GGTTAAAGCAGGTCCAAGAC,0,853987
dgoRp,0.125,7,7,GGTGGTCATCTAAGACTCAA,0,864042
dgoRp,0.125,7,7,GGTGGCCACGTGCAGAACCT,0,850027
dgoRp,0.125,7,7,GGTGGACTTATGTAGCGTCA,0,854732
dgoRp,0.125,7,7,GGTCACGCCCCCTGATGGGG,0,836581
dgoRp,0.125,7,7,GGTAGGCCGCCGGGATTTTA,0,854786
dgoRp,0.125,7,7,GGGGTGTTCTCCTTGTGAGA,0,858701
dgoRp,0.125,7,7,GGGGTCGCTGAGGTTCAGTC,0,865969
dgoRp,0.125,7,7,GGGGTATGTAGAGGCATGAG,0,852066
dgoRp,0.125,7,7,GGGCCTGATGCGAGCGCTCG,0,854072
dgoRp,0.125,7,7,GGGCCTAAACAACTTCAAGA,0,866411
dgoRp,0.125,7,7,GGCTTAGGTATGGTATGACG,0,857682
dgoRp,0.125,7,7,GGCGTCGTTGGGCTCAGGAT,0,861560
dgoRp,0.125,7,7,GGCCGGCAGATATCCATTTG,0,853292
dgoRp,0.125,7,7,GGCCACGGACGCTAAGCTGG,0,857072
dgoRp,0.125,7,7,GGCATGGTAGGAAGCAATTG,0,838652
dgoRp,0.125,7,7,GGCACGTTGTTTCTGTAAAC,0,842036
dgoRp,0.125,7,7,GGATCGTCCTAAAGAAGCAT,0,844558
dgoRp,0.125,7,7,GGATCCCCCGCTCCTTCGGC,0,843901
dgoRp,0.125,7,7,GGAATTGGATGCGCGAGATC,0,865303
dgoRp,0.125,7,7,GGAAACACTCTTAACGGACC,0,866526
dgoRp,0.125,7,7,GCTTCCGCATTTTTAGCTAC,0,848474
dgoRp,0.125,7,7,GCTGTTAGCCACTCTTCAAG,0,867113
dgoRp,0.125,7,7,GCTCACGCCTAGTATGTTAC,0,846944
dgoRp,0.125,7,7,GCTAAGTAGCGGAAGTATGC,0,858012
dgoRp,0.125,7,7,GCTAACGCACATTTGCTGCC,0,864832
dgoRp,0.125,7,7,GCGTACAGCTATGTAGAGCT,0,858992
dgoRp,0.125,7,7,GCGGTGTTACCGGGTCGGGA,0,842882
dgoRp,0.125,7,7,GCGGGGCCAGAATCCGAGTA,0,864790
dgoRp,0.125,7,7,GCGCTTTGAGGTCTCTGCAG,0,842135
dgoRp,0.125,7,7,GCGCCATCGACTGCACGAGG,0,840799
dgoRp,0.125,7,7,GCCTGGCTACAAACTCTGAG,0,848041
dgoRp,0.125,7,7,GCCTGAGCAATTACGTCATG,0,864737
dgoRp,0.125,7,7,GCCGTAAAGAACGTGCTCCC,0,861773
dgoRp,0.125,7,7,GCCGCGGCGTATTCGAGCTA,0,851041
dgoRp,0.125,7,7,GCCCCGCCTGTAGAACTTCA,0,852416
dgoRp,0.125,7,7,GCCAGCCCGAGACGGAGCGA,0,843297
dgoRp,0.125,7,7,GCCACGTGATACGCCGTGAT,0,838864
dgoRp,0.125,7,7,GCCAATGACGTAAAAGCAGT,0,865514
dgoRp,0.125,7,7,GCATTGCTTTTCCCTTTTTG,0,860087
dgoRp,0.125,7,7,GCAGCGCACTGGAAATAGCA,0,836242
dgoRp,0.125,7,7,GCAGCGAGCACCGCTCCGAC,0,850913
dgoRp,0.125,7,7,GATTTTCAAATGTTGTCGAG,0,858697
dgoRp,0.125,7,7,GATTAGTTCGATGCAATGTC,0,837277
dgoRp,0.125,7,7,GATGGTTCATATGCACCCTT,0,862199
dgoRp,0.125,7,7,GATGGTGCAGCTCTTCCATT,0,866774
dgoRp,0.125,7,7,GATGGAATGGAACGAGCCCC,0,842527
dgoRp,0.125,7,7,GATGCCAGCTACTGGTCACT,0,860350
dgoRp,0.125,7,7,GATCGTGTCGCAGTAATTGA,0,846069
dgoRp,0.125,7,7,GATCAGTCGCGATATCTATT,0,853732
dgoRp,0.125,7,7,GATATGACGGACAGGAGTTA,0,844082
dgoRp,0.125,7,7,GATATCCCCAGAAGAGTTCG,0,855138
dgoRp,0.125,7,7,GATAACGGATATAAAGCATT,0,857590
dgoRp,0.125,7,7,GATAAAGTGACAGTAATGTT,0,852450
dgoRp,0.125,7,7,GAGTTCTACAAGGGATCTAG,0,839289
dgoRp,0.125,7,7,GAGTCTACCCAGGGTGGGAA,0,855600
dgoRp,0.125,7,7,GAGTCCATTGCGAATCACGA,0,856776
dgoRp,0.125,7,7,GAGTATCTGTCCCGTTGATC,0,860951
dgoRp,0.125,7,7,GAGTAACTTTGCGCGCGCAC,0,854520
dgoRp,0.125,7,7,GAGGTGTTAACCAGAAAGAA,0,853746
dgoRp,0.125,7,7,GAGGGTGAAGCCGTGAACTC,0,863506
dgoRp,0.125,7,7,GAGACGCGTCGCAATCGAAC,0,863493
dgoRp,0.125,7,7,GAGACACATGCGGGCCTCGT,0,840086
dgoRp,0.125,7,7,GACTGAGAGGTTAGTTATCC,0,864395
dgoRp,0.125,7,7,GACTCTTCGCTGTATCAGTT,0,840658
dgoRp,0.125,7,7,GACTCCAGCCTTCGTGAACT,0,856125
dgoRp,0.125,7,7,GACTACGGCTCCGTCTTTTA,0,855010
dgoRp,0.125,7,7,GACGGTGAGGTATTGTGGAT,0,859249
dgoRp,0.125,7,7,GACCAATTTGACAGTTCGCG,0,860204
dgoRp,0.125,7,7,GAATCGCAACGGGCGTGCGC,0,846702
dgoRp,0.125,7,7,GAATACCTAATATAACGGGA,0,836980
dgoRp,0.125,7,7,GAACTCGTTTCTACCGCACA,0,848108
dgoRp,0.125,7,7,GAACGTCATCGACTTGCTAG,0,853662
dgoRp,0.125,7,7,GAACGGATCATGCATAGGTT,0,844173
dgoRp,0.125,7,7,GAACACCGAAATGGCAAAAC,0,861385
dgoRp,0.125,7,7,GAAAATCTGCACTGGCGCGG,0,864660
dgoRp,0.125,7,7,GAAAACTTGAATGCTTGTTC,0,856899
dgoRp,0.125,7,7,CTTTTGACGAGTCGGCATTC,0,856515
dgoRp,0.125,7,7,CTTTTCGTTGCCAGTACCAT,0,851376
dgoRp,0.125,7,7,CTTTCTGACCTGCGAAAGTT,0,852557
dgoRp,0.125,7,7,CTTCGCGCTTGTGGGTGAAC,0,864404
dgoRp,0.125,7,7,CTTATGCCATTGAATAGAAC,0,862272
dgoRp,0.125,7,7,CTTAATTTTACTCAGTCCCG,0,863841
dgoRp,0.125,7,7,CTGGGGGGAGCGTTGCCAGC,0,844787
dgoRp,0.125,7,7,CTGGAACTGGTCGGGCAGGG,0,858061
dgoRp,0.125,7,7,CTGGAACAGGGGAATAGAAT,0,848863
dgoRp,0.125,7,7,CTGCGAGTGTTATTCATTGA,0,864930
dgoRp,0.125,7,7,CTGCGAGAATATGTATATGA,0,862226
dgoRp,0.125,7,7,CTGAGGGATGCAGGTTAGCT,0,844614
dgoRp,0.125,7,7,CTGACAGCGCTTCCGAGAAT,0,845954
dgoRp,0.125,7,7,CTGAAGTAACCGGCTACGCG,0,863660
dgoRp,0.125,7,7,CTCTTGGAACGAAATAATGT,0,849135
dgoRp,0.125,7,7,CTCTGGTTTCGCGGATAGGA,0,848861
dgoRp,0.125,7,7,CTCTATCCGAGATCCAATTC,0,856249
dgoRp,0.125,7,7,CTCCCGATCGCCACAATCTG,0,856600
dgoRp,0.125,7,7,CTCAGCTGTCACCCACTAAG,0,837504
dgoRp,0.125,7,7,CTATTGCGCAACTAATACTT,0,851318
dgoRp,0.125,7,7,CTAGTCTCGCTGGTACGTGG,0,845323
dgoRp,0.125,7,7,CTAGGGAGTACTAGCGCCCC,0,841197
dgoRp,0.125,7,7,CTAGCTACTCGCTTTGGAGT,0,848136
dgoRp,0.125,7,7,CTACTATCATTCTCACGGAG,0,840637
dgoRp,0.125,7,7,CTAAGAGGATATGAGTACGG,0,838065
dgoRp,0.125,7,7,CGTGCACAGCGGCGGAACTT,0,853776
dgoRp,0.125,7,7,CGTGAAGCTAATACTACGAA,0,858791
dgoRp,0.125,7,7,CGTCTGTTGCAGCAGTGTTT,0,848744
dgoRp,0.125,7,7,CGTACTTAGTGTGCGCAGTA,0,848347
dgoRp,0.125,7,7,CGTACACGTCTGTGAGTTTG,0,835895
dgoRp,0.125,7,7,CGGTATATTTGCCTGAACAG,0,842372
dgoRp,0.125,7,7,CGGTAGAATATCCATCCGGT,0,845735
dgoRp,0.125,7,7,CGGGGTGGAGTGAGAGACGA,0,846500
dgoRp,0.125,7,7,CGGAGTTTGTGGTATAATCC,0,851413
dgoRp,0.125,7,7,CGGACGTGTGGATAGTGGTA,0,857951
dgoRp,0.125,7,7,CGCGGGGGCATTGGGTAAAA,0,848553
dgoRp,0.125,7,7,CGCGCCTCAGTGACGACACC,0,852929
dgoRp,0.125,7,7,CGCCTCATCCGGCTTTGAGC,0,841419
dgoRp,0.125,7,7,CGCCACGGGTACCCAAACAC,0,862103
dgoRp,0.125,7,7,CGATCTACTTATCCCGGAGA,0,863900
dgoRp,0.125,7,7,CGAGATTGCTGTGTTTTGAC,0,837178
dgoRp,0.125,7,7,CGACATTTCAATTAGTGACA,0,864489
dgoRp,0.125,7,7,CGAATGTCTAGGACAGTCGT,0,851517
dgoRp,0.125,7,7,CGAAACCTCAACCTGGGTCC,0,856962
dgoRp,0.125,7,7,CCTTGCCGCATCCAATGAAA,0,861191
dgoRp,0.125,7,7,CCTTCTGGGGATCCCTTCTC,0,854792
dgoRp,0.125,7,7,CCTGTTGGTCACTGACGATA,0,842983
dgoRp,0.125,7,7,CCTCGGGTAGCAGAAGGTGG,0,836379
dgoRp,0.125,7,7,CCTCCGGAGGAACCACCGGA,0,844308
dgoRp,0.125,7,7,CCTCCCCCTGTGACTGTACA,0,862808
dgoRp,0.125,7,7,CCTAGAGGTTTATCGCCCAG,0,848012
dgoRp,0.125,7,7,CCGTACTTCCGCTGGGAAGC,0,860952
dgoRp,0.125,7,7,CCGGGAATGCGGTTCCAATT,0,856208
dgoRp,0.125,7,7,CCGCGGCGGCGTCACGCTCA,0,847734
dgoRp,0.125,7,7,CCGAGGGGATCTTGACGAGC,0,862124
dgoRp,0.125,7,7,CCGACCACAACGGTACAAAA,0,848995
dgoRp,0.125,7,7,CCCTGAAGTCCTAAGGCCGG,0,852398
dgoRp,0.125,7,7,CCCTATGGGCAAAATATATG,0,853110
dgoRp,0.125,7,7,CCCGAAAATCCTAGGTACAA,0,850731
dgoRp,0.125,7,7,CCCCTTCTTTTGTCAGAATC,0,841276
dgoRp,0.125,7,7,CCAGTGGGCGCGGACACGGA,0,839873
dgoRp,0.125,7,7,CCAGCCTGTGGTGAAGCGGA,0,842242
dgoRp,0.125,7,7,CCACGGATGATATGTTGGGC,0,848113
dgoRp,0.125,7,7,CCAACCCCCTTGCCGTGCGA,0,846644
dgoRp,0.125,7,7,CATTTACCGCTGGATGCTAG,0,839323
dgoRp,0.125,7,7,CATTCTGTGTAATAACTGCA,0,843893
dgoRp,0.125,7,7,CATTAGATATTCCATCTTCC,0,841541
dgoRp,0.125,7,7,CATGGTGCGGCCACCAAAGT,0,851037
dgoRp,0.125,7,7,CATGAGCGGCGTATTAGGGT,0,840808
dgoRp,0.125,7,7,CATCCTTAATATACTATTTT,0,844248
dgoRp,0.125,7,7,CATACGCTAAGGCGCATGTT,0,839634
dgoRp,0.125,7,7,CAGGTTCACGGATCGGTAGT,0,836327
dgoRp,0.125,7,7,CAGGTCGAACAGTGGCTATG,0,858861
dgoRp,0.125,7,7,CAGCGGGACAATGACCGACG,0,842781
dgoRp,0.125,7,7,CACTGCGGTAGCCTCTCGGG,0,839673
dgoRp,0.125,7,7,CACGTGGATTGCATCGCACT,0,867279
dgoRp,0.125,7,7,CACGGACATTCTTGTACGCG,0,840655
dgoRp,0.125,7,7,CACGCCGTTCGTCGCTGGAG,0,856062
dgoRp,0.125,7,7,CACGCCAGCCCATAATCCAT,0,837467
dgoRp,0.125,7,7,CACGATGTATAAAGTTTTGA,0,840047
dgoRp,0.125,7,7,CACCTGTGATTGTGTAGTGC,0,860863
dgoRp,0.125,7,7,CACAGCGGTCCAGAGATGTC,0,855003
dgoRp,0.125,7,7,CACAGAACTACAAGATAAAC,0,845966
dgoRp,0.125,7,7,CAATTAAAGCTAGCGTACAC,0,849221
dgoRp,0.125,7,7,CAATGACCAGCCATCAATTG,0,842575
dgoRp,0.125,7,7,CAAGTTAATAGGAACTTTGG,0,835951
dgoRp,0.125,7,7,CAACTGCCCTACTGTACCAA,0,852097
dgoRp,0.125,7,7,CAAATTACGCTTGTTAAAAC,0,857512
dgoRp,0.125,7,7,CAAAGATGAGTGCGCGCATG,0,838645
dgoRp,0.125,7,7,ATTGCCGTTAAGTGCCACAG,0,846477
dgoRp,0.125,7,7,ATTCCACCCTGTTTACCAGG,0,849987
dgoRp,0.125,7,7,ATTATAGATGGATAACTGCA,0,841926
dgoRp,0.125,7,7,ATGTTAAATCTGCTCATGCC,0,865168
dgoRp,0.125,7,7,ATGTGGTAAACAGGGGTCAA,0,847035
dgoRp,0.125,7,7,ATGTGCCAGGTACATTCCGT,0,840713
dgoRp,0.125,7,7,ATGGCCAGGTTGTGCCGTTA,0,841661
dgoRp,0.125,7,7,ATGGAAGACGCAGAGCTGCG,0,851721
dgoRp,0.125,7,7,ATGCTAAATAGACTGTCGGT,0,865875
dgoRp,0.125,7,7,ATGCGGAAGCTCCGAAGGAA,0,864270
dgoRp,0.125,7,7,ATGCAATGTGATGCGTTTGA,0,857048
dgoRp,0.125,7,7,ATGAAGCGCGCGGCTAAAAT,0,835876
dgoRp,0.125,7,7,ATCTTCGCTGCGCTCCAACA,0,855275
dgoRp,0.125,7,7,ATCGTTCCGCAATAGCGGCC,0,862551
dgoRp,0.125,7,7,ATCGGAGATTGGTACAATCA,0,856090
dgoRp,0.125,7,7,ATCGACTATAATCAACTTGA,0,848370
dgoRp,0.125,7,7,ATCATTGCTGCGCCTTAGCC,0,845967
dgoRp,0.125,7,7,ATATTGTTGGCACAAGCGGT,0,867443
dgoRp,0.125,7,7,ATACGTGCCAAAGTGTGCTG,0,864349
dgoRp,0.125,7,7,ATAACCCCCGGTCTCTTAGT,0,858408
dgoRp,0.125,7,7,AGTTGTCGCTGCTTTTCAAG,0,861298
dgoRp,0.125,7,7,AGTTGTATCGTCATAGCTTT,0,858960
dgoRp,0.125,7,7,AGTTCTCATCAGCACGTGCG,0,840146
dgoRp,0.125,7,7,AGTTCTATACGCAGCCGGAG,0,862211
dgoRp,0.125,7,7,AGTATCGGGACGAAATAGGC,0,843139
dgoRp,0.125,7,7,AGTACCGATTAGAAGTTGCA,0,867416
dgoRp,0.125,7,7,AGGGGCTATAGGGTACAGCA,0,843819
dgoRp,0.125,7,7,AGGGCCTCCAACGTTGCATG,0,864647
dgoRp,0.125,7,7,AGGCAGCTTCACAATTTATC,0,847772
dgoRp,0.125,7,7,AGCTTTAGCGTGTTAAGCCA,0,847325
dgoRp,0.125,7,7,AGCTGCAGACTACCTCCACA,0,843194
dgoRp,0.125,7,7,AGCACGCAATCAATCATAGC,0,863181
dgoRp,0.125,7,7,AGATCCATCTGAGCCTAGCC,0,862692
dgoRp,0.125,7,7,AGATATACCAGCCTGTAGCC,0,861029
dgoRp,0.125,7,7,AGACCTACCGTCGCGTTAGG,0,838056
dgoRp,0.125,7,7,AGAAGAACCTTCGGGACACT,0,840457
dgoRp,0.125,7,7,AGAACGCAGCACAGCTGCGG,0,842589
dgoRp,0.125,7,7,ACTTCGAAAGGTAAATGTTG,0,850369
dgoRp,0.125,7,7,ACTGCGAACATTGGAGAGTG,0,845020
dgoRp,0.125,7,7,ACTGAATATTGTCTTCCTCT,0,845619
dgoRp,0.125,7,7,ACTACGAGGCCAATAACTGG,0,851418
dgoRp,0.125,7,7,ACGTGCCCATCGCGCGAACA,0,865981
dgoRp,0.125,7,7,ACGTCTGGGCTCCCTGGTCT,0,845650
dgoRp,0.125,7,7,ACGTCGCCACGCGGATGCTA,0,847209
dgoRp,0.125,7,7,ACGTATCGGGGTCGTAGCAA,0,844106
dgoRp,0.125,7,7,ACGGTTTGAGGTTCGTACTA,0,866972
dgoRp,0.125,7,7,ACGGATGTTTAGTATTGAAA,0,836264
dgoRp,0.125,7,7,ACGCTTACGGACGCATCAAG,0,838489
dgoRp,0.125,7,7,ACCTTTCAGCTACTCATTGG,0,864566
dgoRp,0.125,7,7,ACCTTCAGGGCCGTCACTCA,0,845402
dgoRp,0.125,7,7,ACCGTGAGGCTCTGTTGACG,0,864591
dgoRp,0.125,7,7,ACCGGCGCAACCCGTCGCCC,0,845900
dgoRp,0.125,7,7,ACCGGCAAATTAATAAGTTG,0,845665
dgoRp,0.125,7,7,ACCGCCAGACCTGTTCAGCA,0,844815
dgoRp,0.125,7,7,ACCCTTGTGAATAGGTCAAC,0,865951
dgoRp,0.125,7,7,ACCCGATTCCCATTTATTCA,0,844788
dgoRp,0.125,7,7,ACCCCACCACGATACCGATA,0,845803
dgoRp,0.125,7,7,ACCATGTGACATCCAAGTGA,0,856354
dgoRp,0.125,7,7,ACCAGTATGTAGTTGATAGC,0,856614
dgoRp,0.125,7,7,ACCAATATACTAGCAGATGT,0,859773
dgoRp,0.125,7,7,ACATCAGAAGGAAATGAGAC,0,855324
dgoRp,0.125,7,7,ACACGTTGAAGAGCAGACAG,0,838487
dgoRp,0.125,7,7,ACAAGCGTATCGGATTAGCA,0,842038
dgoRp,0.125,7,7,AATTTGAACCCATCCCAAGT,0,843889
dgoRp,0.125,7,7,AATTTACACATGACCGGTTG,0,860586
dgoRp,0.125,7,7,AATTGATGGGATTAACAGTG,0,857300
dgoRp,0.125,7,7,AATTCTCTGGCAAAACATGA,0,855125
dgoRp,0.125,7,7,AATTAAACAGCTATGTAGAC,0,849469
dgoRp,0.125,7,7,AATGTTGGCCGCTAAGGGCA,0,860119
dgoRp,0.125,7,7,AATCGAGACTTTCAGTCTAC,0,862961
dgoRp,0.125,7,7,AATCGAGACCCTAGACCGAG,0,841730
dgoRp,0.125,7,7,AATATTACAGTGTGGGCAGT,0,846831
dgoRp,0.125,7,7,AATAGTATTAGACGGAGAGT,0,840709
dgoRp,0.125,7,7,AATAATGGATGTCCATCATT,0,836259
dgoRp,0.125,7,7,AAGTGTAAATAGATAACGAC,0,845125
dgoRp,0.125,7,7,AAGTGACTTGCGGTATTGTT,0,861196
dgoRp,0.125,7,7,AAGTCTAGGGTGGGCAGGGA,0,836277
dgoRp,0.125,7,7,AAGTCGCATGGCCTTAAAAA,0,840832
dgoRp,0.125,7,7,AAGTCCTCAGTTTCTGAGGT,0,852712
dgoRp,0.125,7,7,AAGGTGACCTCTTGCATAAT,0,861200
dgoRp,0.125,7,7,AAGCGCTTGAGGCACACCGA,0,858192
dgoRp,0.125,7,7,AAGCCCGTTCTGAGACGTTT,0,857706
dgoRp,0.125,7,7,AAGCAATCATAGCTAACGAA,0,843008
dgoRp,0.125,7,7,AACTCGTACTGTCCATTGAA,0,845648
dgoRp,0.125,7,7,AACGCGATGGCTCTTTCGTC,0,836459
dgoRp,0.125,7,7,AACCTGTTAGACCGAACGGA,0,850512
dgoRp,0.125,7,7,AACCTCACCAGTTCGTTTCC,0,861543
dgoRp,0.125,7,7,AAATTGCACACGGCATATCA,0,853215
dgoRp,0.125,7,7,AAATCTGTCAAACTCTAAGT,0,864713
dgoRp,0.125,7,7,AAATAAGATCACATGATCAC,0,862424
dgoRp,0.125,7,7,AAACGAGTTGTATTTAGGGA,0,853874
dgoRp,0.125,7,7,AAACCCTACACAACCGATTT,0,857890
dgoRp,0.125,7,7,AAAATGTTCAAAGTACGAGT,0,847789
dgoRp,0.14285714285714285,6,6,TTTGCAATTCATTAGCTATG,0,848238
dgoRp,0.14285714285714285,6,6,TTTCTTGCTCCAAGGGCGAT,0,840417
dgoRp,0.14285714285714285,6,6,TTTCCAAGTTTAGCCCCTTA,0,865215
dgoRp,0.14285714285714285,6,6,TTTCACCGGACGTGGAGTTA,0,856511
dgoRp,0.14285714285714285,6,6,TTTATCGGCCCTGTAGGAGG,0,838575
dgoRp,0.14285714285714285,6,6,TTTAGGGAACCACGGCGCGG,0,857210
dgoRp,0.14285714285714285,6,6,TTGTTGAACAACATGGCGCG,0,861917
dgoRp,0.14285714285714285,6,6,TTGGCTTTGCCTCATTACCT,0,850140
dgoRp,0.14285714285714285,6,6,TTGCGTCTTTCCTACGGAAC,0,858908
dgoRp,0.14285714285714285,6,6,TTGCCTACACCTCTGTTCGA,0,854481
dgoRp,0.14285714285714285,6,6,TTGCAGTCTCAACGTTGTCA,0,859210
dgoRp,0.14285714285714285,6,6,TTCGCCTGTTCGGCGTGGTA,0,837497
dgoRp,0.14285714285714285,6,6,TTCCGCGAAATCTCCCGCTC,0,861730
dgoRp,0.14285714285714285,6,6,TTCATTGAGGTGGATGTGTC,0,853192
dgoRp,0.14285714285714285,6,6,TTATTGCCTTATTATCGTGT,0,857262
dgoRp,0.14285714285714285,6,6,TTATTCGGTTGCGACAATGT,0,861999
dgoRp,0.14285714285714285,6,6,TTATGTATTGTGGCTACTTT,0,850905
dgoRp,0.14285714285714285,6,6,TTATGCACGTGGAGCGGCTC,0,838669
dgoRp,0.14285714285714285,6,6,TTATACGAAGTAAAGAGAAG,0,856011
dgoRp,0.14285714285714285,6,6,TTAGTGCCAGTGAGACGGTA,0,857960
dgoRp,0.14285714285714285,6,6,TTACGTCACTATATCCCCAG,0,842182
dgoRp,0.14285714285714285,6,6,TTACGCTAAGAAAGCTGGTT,0,847840
dgoRp,0.14285714285714285,6,6,TTACGAAAACCCCGTCCATT,0,857581
dgoRp,0.14285714285714285,6,6,TTACCTGACGTAATTAAGAT,0,860729
dgoRp,0.14285714285714285,6,6,TTAATGCTGGACAACATGAG,0,843421
dgoRp,0.14285714285714285,6,6,TGTTTCGCAATAAGGACCAT,0,836451
dgoRp,0.14285714285714285,6,6,TGTTCCGACCCGGGTAACTA,0,866516
dgoRp,0.14285714285714285,6,6,TGTGAAAAGATTAGGGACTC,0,839088
dgoRp,0.14285714285714285,6,6,TGTCGCGATACGGCAATTGT,0,866470
dgoRp,0.14285714285714285,6,6,TGGTAACGGCACCGAGTTTA,0,842043
dgoRp,0.14285714285714285,6,6,TGGGCAGGTGGAAGTAAAAA,0,857042
dgoRp,0.14285714285714285,6,6,TGGAATATCTTTGATTTGTA,0,846133
dgoRp,0.14285714285714285,6,6,TGGAAGTGGGCAGAAGGCCA,0,845076
dgoRp,0.14285714285714285,6,6,TGCTCAACCGAACAGACGTA,0,835925
dgoRp,0.14285714285714285,6,6,TGCGGGATCCCTACAAGGCC,0,862391
dgoRp,0.14285714285714285,6,6,TGCGCCCAGTTAACCTAGTC,0,851402
dgoRp,0.14285714285714285,6,6,TGCCTTCTACAACATTTTAA,0,852575
dgoRp,0.14285714285714285,6,6,TGCCGGCGGACGTCGGCAGC,0,854419
dgoRp,0.14285714285714285,6,6,TGCCCTCTCACCTGAGGCCC,0,839589
dgoRp,0.14285714285714285,6,6,TGCCCTCCACGCAAGCCGAA,0,847185
dgoRp,0.14285714285714285,6,6,TGCATCACCGGTCATTCCTT,0,844887
dgoRp,0.14285714285714285,6,6,TGCATATAACGTGCCTGTGT,0,854680
dgoRp,0.14285714285714285,6,6,TGATTCTCTGGGGGTGGACG,0,855875
dgoRp,0.14285714285714285,6,6,TGATTATGTAGGCCCTCATT,0,854617
dgoRp,0.14285714285714285,6,6,TGACCTTGGATCCTCTGGAA,0,839395
dgoRp,0.14285714285714285,6,6,TGACCGATGTGGGCCGCAGA,0,845423
dgoRp,0.14285714285714285,6,6,TGACCCCCCACCCGTTCGTG,0,852792
dgoRp,0.14285714285714285,6,6,TGACAAAGCGTGTCGTGATT,0,836882
dgoRp,0.14285714285714285,6,6,TGAAGCTTTCACCACATGGT,0,841554
dgoRp,0.14285714285714285,6,6,TCTTTGCGGCCGTAGGTCCG,0,856176
dgoRp,0.14285714285714285,6,6,TCTTGTTATATCTGGCTTTA,0,862817
dgoRp,0.14285714285714285,6,6,TCTGTTCCCAAGAGGCCGCC,0,858548
dgoRp,0.14285714285714285,6,6,TCTCTCAAAGAAATGGTGAT,0,845649
dgoRp,0.14285714285714285,6,6,TCTCATCGGAGGCTTCGACA,0,846198
dgoRp,0.14285714285714285,6,6,TCTATGCCAATGCGTTTCCT,0,844495
dgoRp,0.14285714285714285,6,6,TCTATGCACTGGGGCTGATC,0,861065
dgoRp,0.14285714285714285,6,6,TCTAGGTACCCGAGTAGCGT,0,848785
dgoRp,0.14285714285714285,6,6,TCTAATATCCAGCACTGCAG,0,837988
dgoRp,0.14285714285714285,6,6,TCGTTATAACTGGTCTCGCG,0,851749
dgoRp,0.14285714285714285,6,6,TCGTGGCCGGAATCAAGAAC,0,858746
dgoRp,0.14285714285714285,6,6,TCGGTTGATCACCAGGAATG,0,844563
dgoRp,0.14285714285714285,6,6,TCGGGCGTGAATGAACCGAA,0,864346
dgoRp,0.14285714285714285,6,6,TCGCGGTAAATCGTCCTTGC,0,861863
dgoRp,0.14285714285714285,6,6,TCGCGCTATTGTGCGAGTCT,0,864705
dgoRp,0.14285714285714285,6,6,TCGATTTTATCGACCGTTGG,0,837531
dgoRp,0.14285714285714285,6,6,TCCTTAGAGATTCCGGTGCT,0,866562
dgoRp,0.14285714285714285,6,6,TCCGTAGTAATGGACCATGC,0,851460
dgoRp,0.14285714285714285,6,6,TCCCTAGATTGCTCACCCTT,0,842975
dgoRp,0.14285714285714285,6,6,TCCCGTTTTTCTGGCCCTGG,0,836723
dgoRp,0.14285714285714285,6,6,TCATTACGGACATCAGGATT,0,852472
dgoRp,0.14285714285714285,6,6,TCAGAACCGGGCGCTAATGA,0,839433
dgoRp,0.14285714285714285,6,6,TCACTTGGCACGGCCTCATC,0,864881
dgoRp,0.14285714285714285,6,6,TCACCAGACTGTCCCGGACC,0,842169
dgoRp,0.14285714285714285,6,6,TCAACCTCTCGTACGTGACT,0,843184
dgoRp,0.14285714285714285,6,6,TATTGACCGACACCAATACT,0,855002
dgoRp,0.14285714285714285,6,6,TATGGCGTATCTACAACGAT,0,838895
dgoRp,0.14285714285714285,6,6,TATCAGATGCATAAATGATA,0,847095
dgoRp,0.14285714285714285,6,6,TATAGGTCGAGTAAGGGGTC,0,860741
dgoRp,0.14285714285714285,6,6,TATAAGAAAGGGCATGGCCT,0,854499
dgoRp,0.14285714285714285,6,6,TAGCTTGCGATTTTACCCGA,0,854770
dgoRp,0.14285714285714285,6,6,TAGAGCTATAGGGCTTGTTC,0,844091
dgoRp,0.14285714285714285,6,6,TAGAGCAAGCCCAGATACTA,0,856788
dgoRp,0.14285714285714285,6,6,TACTTATGGACACAGACAGG,0,855684
dgoRp,0.14285714285714285,6,6,TACTGGGGCATACTGACGTT,0,838437
dgoRp,0.14285714285714285,6,6,TACTCATCTGTCAACCTGGA,0,863013
dgoRp,0.14285714285714285,6,6,TACTAAGGCTTTACATCGCC,0,862682
dgoRp,0.14285714285714285,6,6,TACGTCGAAGCATTGCATAG,0,838074
dgoRp,0.14285714285714285,6,6,TACCGCTCGAGGGTGGTAGT,0,847810
dgoRp,0.14285714285714285,6,6,TACCCGCACATCGACGCAAA,0,850141
dgoRp,0.14285714285714285,6,6,TACATGGTGCAAACGTTAGA,0,866239
dgoRp,0.14285714285714285,6,6,TACAGAAGTCGTGGATCCCG,0,839568
dgoRp,0.14285714285714285,6,6,TACACATGTGCAACCAGCAT,0,859731
dgoRp,0.14285714285714285,6,6,TAATCCATCGGTGCTTAGAG,0,855297
dgoRp,0.14285714285714285,6,6,TAATAAAATGCATCCCTCGA,0,852757
dgoRp,0.14285714285714285,6,6,TAAGTTCTCTCAATCTAATA,0,854323
dgoRp,0.14285714285714285,6,6,TAAGGTAAGACCGTAGATGA,0,851134
dgoRp,0.14285714285714285,6,6,TAAATCGACGAAACTACTCG,0,864239
dgoRp,0.14285714285714285,6,6,TAAATAGCTGAGGATCTCTT,0,844564
dgoRp,0.14285714285714285,6,6,TAAACATCAGCGTGTCGTGG,0,855553
dgoRp,0.14285714285714285,6,6,TAAAAAAGGGCAGCTGAAGT,0,857963
dgoRp,0.14285714285714285,6,6,GTTGGTTTGTGTTGGAATAG,0,856289
dgoRp,0.14285714285714285,6,6,GTTGGAGTGGCGTAATACAT,0,861306
dgoRp,0.14285714285714285,6,6,GTTGATGAGATTCCCATTCC,0,837006
dgoRp,0.14285714285714285,6,6,GTTGAGTCATCATCTTGATA,0,861311
dgoRp,0.14285714285714285,6,6,GTTCTGAGGATCAACGGCAT,0,863754
dgoRp,0.14285714285714285,6,6,GTTCAGATACGCCCGTCCAC,0,842028
dgoRp,0.14285714285714285,6,6,GTTCACATCATAACTACAAC,0,851673
dgoRp,0.14285714285714285,6,6,GTTATACAGTATTCGGTCGT,0,843447
dgoRp,0.14285714285714285,6,6,GTTAGCTCCGTCAGGGCGTG,0,862338
dgoRp,0.14285714285714285,6,6,GTTACTCTCGTGCGTGGTGC,0,851993
dgoRp,0.14285714285714285,6,6,GTGTCCGCAGCCTAGCGCTA,0,854970
dgoRp,0.14285714285714285,6,6,GTGTCATATGAATGTCCGGC,0,842453
dgoRp,0.14285714285714285,6,6,GTGTATCGCAGAACAAGAAT,0,848351
dgoRp,0.14285714285714285,6,6,GTGTACGTGGTAATCGATGT,0,859861
dgoRp,0.14285714285714285,6,6,GTGGTGCCTGGCTCGTTCAC,0,863763
dgoRp,0.14285714285714285,6,6,GTGGTACGTTCTGCCGTCGG,0,848354
dgoRp,0.14285714285714285,6,6,GTGGCACGCTGGGGCCATAA,0,844946
dgoRp,0.14285714285714285,6,6,GTGGACGCTGCACGCTGAAC,0,857116
dgoRp,0.14285714285714285,6,6,GTGCTGGTGGGGATACATGG,0,849644
dgoRp,0.14285714285714285,6,6,GTCTTTGCGATTAGTAGGAA,0,850051
dgoRp,0.14285714285714285,6,6,GTCTGACCTTTCAACGCTGC,0,849225
dgoRp,0.14285714285714285,6,6,GTCTCTCTTGTGTTACCCGC,0,858912
dgoRp,0.14285714285714285,6,6,GTCGCATGCACGTGCTCGAG,0,861307
dgoRp,0.14285714285714285,6,6,GTCCCTAAGCCTACTCTTAG,0,864667
dgoRp,0.14285714285714285,6,6,GTCCCGGGTGGATTAGTGGT,0,854919
dgoRp,0.14285714285714285,6,6,GTCCCCATGAAGCGCCGTTA,0,866873
dgoRp,0.14285714285714285,6,6,GTCCAGCATATCAAGATTCT,0,859945
dgoRp,0.14285714285714285,6,6,GTCCACTCTCCGCCAAGGGA,0,858551
dgoRp,0.14285714285714285,6,6,GTCATGTATTGAGTCCCGAA,0,857104
dgoRp,0.14285714285714285,6,6,GTCACGGATGGAATTTATAC,0,856615
dgoRp,0.14285714285714285,6,6,GTCAAGAGTGTTGTCCCCTT,0,853891
dgoRp,0.14285714285714285,6,6,GTATCAAAAAGGCTGCGTCC,0,843721
dgoRp,0.14285714285714285,6,6,GTAGTTAAGTCACGGTTTCA,0,855945
dgoRp,0.14285714285714285,6,6,GTAGCATACTCCAAACGTGC,0,859085
dgoRp,0.14285714285714285,6,6,GTAGCAGTCTTCCGGTCACT,0,861788
dgoRp,0.14285714285714285,6,6,GTAGAATTAGAGTTCTCGTT,0,845547
dgoRp,0.14285714285714285,6,6,GTACGTACTTAAAGTGGAGA,0,860300
dgoRp,0.14285714285714285,6,6,GTACGGGCTGTACATAGCGG,0,850755
dgoRp,0.14285714285714285,6,6,GTACATGACCGGGATCTACC,0,846000
dgoRp,0.14285714285714285,6,6,GTAATTGGTTGCCTGAAGTC,0,842274
dgoRp,0.14285714285714285,6,6,GTAACTAGGCAGTTACCGAG,0,848495
dgoRp,0.14285714285714285,6,6,GTAAACTCGATTAGGACTAG,0,837221
dgoRp,0.14285714285714285,6,6,GGTTCGGGTAAGGCGCGTAT,0,851562
dgoRp,0.14285714285714285,6,6,GGTGTTATCCGGAGAAAAAG,0,838071
dgoRp,0.14285714285714285,6,6,GGTGTGCCCGGTCGGGTCTA,0,864179
dgoRp,0.14285714285714285,6,6,GGTGATTCAGGCCTAAATTC,0,858972
dgoRp,0.14285714285714285,6,6,GGTATCGCCGACCAGGGGGG,0,854002
dgoRp,0.14285714285714285,6,6,GGTATACGCGTGTCGGAAGA,0,860926
dgoRp,0.14285714285714285,6,6,GGGTTCTGCTACACTATCGG,0,839410
dgoRp,0.14285714285714285,6,6,GGGTAGTCCACCGCAATGGT,0,841479
dgoRp,0.14285714285714285,6,6,GGGGGATTAGGGTACATCTG,0,859264
dgoRp,0.14285714285714285,6,6,GGGGCGAGTCTATCTTCGTT,0,864562
dgoRp,0.14285714285714285,6,6,GGGGCATAAACTTCTAATCG,0,850213
dgoRp,0.14285714285714285,6,6,GGGGACCATTGCGTCGTAGT,0,852917
dgoRp,0.14285714285714285,6,6,GGGCGTGCGGCATGCATAGT,0,860687
dgoRp,0.14285714285714285,6,6,GGGCCACCACCTAAAAGTGA,0,837074
dgoRp,0.14285714285714285,6,6,GGGATAGACAGGCAAAGGGT,0,854709
dgoRp,0.14285714285714285,6,6,GGGACAGGGCCAAACCGCGT,0,851994
dgoRp,0.14285714285714285,6,6,GGGACAGAAAGCAGAGGCGG,0,863285
dgoRp,0.14285714285714285,6,6,GGCTGTGTGACGCAGTCCTC,0,841597
dgoRp,0.14285714285714285,6,6,GGCTGATTAGGGGGTAGAAA,0,847470
dgoRp,0.14285714285714285,6,6,GGCTCGAGCAGCACGCGGGC,0,866028
dgoRp,0.14285714285714285,6,6,GGCGCGCTGGGATCGCTACC,0,850449
dgoRp,0.14285714285714285,6,6,GGCCCCTTCAACAGAGGTCT,0,858903
dgoRp,0.14285714285714285,6,6,GGCACGAGTAGCTGTCAGAC,0,848126
dgoRp,0.14285714285714285,6,6,GGCACAGACTCCCGGACGCG,0,848968
dgoRp,0.14285714285714285,6,6,GGATTTGATATAAGATATTG,0,839892
dgoRp,0.14285714285714285,6,6,GGATGCGATTTATTTATATT,0,846101
dgoRp,0.14285714285714285,6,6,GGAGCTTTTATTAGGCCCGC,0,836928
dgoRp,0.14285714285714285,6,6,GGACGAGGTCTTTAGTCGCG,0,865206
dgoRp,0.14285714285714285,6,6,GGACCCTGTACGTAGAATTT,0,848236
dgoRp,0.14285714285714285,6,6,GGAAATCGTGGAACATCCGA,0,844289
dgoRp,0.14285714285714285,6,6,GCTTGGGAATTAGATACATA,0,858150
dgoRp,0.14285714285714285,6,6,GCTTATTACGGATTAGTTTT,0,847780
dgoRp,0.14285714285714285,6,6,GCTGGTGCACTGCTATTAGC,0,846627
dgoRp,0.14285714285714285,6,6,GCTCGAAAATCTCAGGGAAC,0,854771
dgoRp,0.14285714285714285,6,6,GCTCCTCGTACTTGGCGTGA,0,852542
dgoRp,0.14285714285714285,6,6,GCTCAAGACAAAATGTCATA,0,837587
dgoRp,0.14285714285714285,6,6,GCTCAAGAAAACTCCGAACG,0,844750
dgoRp,0.14285714285714285,6,6,GCTATACACAGGCTCAACCT,0,836089
dgoRp,0.14285714285714285,6,6,GCTACCGGCAACTCTATTGC,0,842026
dgoRp,0.14285714285714285,6,6,GCGTTATTGCACAAAAGGCC,0,843947
dgoRp,0.14285714285714285,6,6,GCGTGGATACAATCTGCTTT,0,858459
dgoRp,0.14285714285714285,6,6,GCGTAGCCGTTCAGTAGTAC,0,861869
dgoRp,0.14285714285714285,6,6,GCGGATAAGTCTGCTCAAGC,0,842949
dgoRp,0.14285714285714285,6,6,GCGCACTTTGGGGCATTCCT,0,854993
dgoRp,0.14285714285714285,6,6,GCGATCTGCAAGGACTGCAT,0,847821
dgoRp,0.14285714285714285,6,6,GCCTGGAACATCGGTCCATG,0,853694
dgoRp,0.14285714285714285,6,6,GCCTGACCAAAATCGCGAAT,0,849031
dgoRp,0.14285714285714285,6,6,GCCGCAACCACTTCTGGGCG,0,845654
dgoRp,0.14285714285714285,6,6,GCCAGTTAAAACACATTAAC,0,838709
dgoRp,0.14285714285714285,6,6,GCCAGCGCACCTGTAGATTC,0,855296
dgoRp,0.14285714285714285,6,6,GCATGCATAGGAGGACTTGA,0,840363
dgoRp,0.14285714285714285,6,6,GCATCCTCGGCCACATGAGA,0,860648
dgoRp,0.14285714285714285,6,6,GCACGATAGCAGCCTCGAAT,0,843362
dgoRp,0.14285714285714285,6,6,GATTCTACTTTTAGCTTACG,0,859596
dgoRp,0.14285714285714285,6,6,GATTAGTCAGTGCATCAAAA,0,864632
dgoRp,0.14285714285714285,6,6,GATTAAGGGGATAGGTAGTA,0,852331
dgoRp,0.14285714285714285,6,6,GATCGTCAGCAAGTCGAAGT,0,839987
dgoRp,0.14285714285714285,6,6,GATCCCTTATGGTAACGCTG,0,842994
dgoRp,0.14285714285714285,6,6,GAGTTTGATTTCCGATTCCT,0,837187
dgoRp,0.14285714285714285,6,6,GAGTTCTTCTTCTATGCGGG,0,859432
dgoRp,0.14285714285714285,6,6,GAGTCGATGTGACTTCGAAC,0,860518
dgoRp,0.14285714285714285,6,6,GAGTCCTGTAAGTATAGAAA,0,847523
dgoRp,0.14285714285714285,6,6,GAGGCTCCGGCTCAATCACA,0,855168
dgoRp,0.14285714285714285,6,6,GAGGCGTAACGTAGTGCACA,0,844826
dgoRp,0.14285714285714285,6,6,GAGGATAGGAACCAGTTGCC,0,838377
dgoRp,0.14285714285714285,6,6,GAGGATACTGTCGATCTAAA,0,867370
dgoRp,0.14285714285714285,6,6,GAGCGCATTCGGAGGGGATG,0,852793
dgoRp,0.14285714285714285,6,6,GAGCCCTAATCCCCGGAGAG,0,865351
dgoRp,0.14285714285714285,6,6,GACTAACTCAGGCGTAATAC,0,866100
dgoRp,0.14285714285714285,6,6,GACCTATTCCAACGAGCTTT,0,851545
dgoRp,0.14285714285714285,6,6,GACCGACACACCTCCATCTT,0,853278
dgoRp,0.14285714285714285,6,6,GACAAGGACATGTACCACTT,0,841409
dgoRp,0.14285714285714285,6,6,GAATTACCACTGATAAATGG,0,854166
dgoRp,0.14285714285714285,6,6,GAATCAAATCCAATCAGAAT,0,858676
dgoRp,0.14285714285714285,6,6,GAATAGTGAACGGTCAGCAA,0,843975
dgoRp,0.14285714285714285,6,6,GAACTTGTCTCAGCCGGCTA,0,866854
dgoRp,0.14285714285714285,6,6,CTTTTAATACAACACTCCGG,0,839788
dgoRp,0.14285714285714285,6,6,CTTTGTGTTCAAGTAGATTC,0,844472
dgoRp,0.14285714285714285,6,6,CTTTACCCATCCGGGGAGTT,0,859825
dgoRp,0.14285714285714285,6,6,CTTGGGTCGCCCACGAGCCC,0,860705
dgoRp,0.14285714285714285,6,6,CTTGCGAACAAGAATTATAT,0,866501
dgoRp,0.14285714285714285,6,6,CTTCTAGTGCCGGGGTAGCA,0,862573
dgoRp,0.14285714285714285,6,6,CTTCGTCCGGCGGAGCCGGT,0,859497
dgoRp,0.14285714285714285,6,6,CTTCACGCATGGTCGGAACG,0,844297
dgoRp,0.14285714285714285,6,6,CTTAGTGTTAATTTGCTCAG,0,851380
dgoRp,0.14285714285714285,6,6,CTTAGCAAATCCGCTATGGT,0,836838
dgoRp,0.14285714285714285,6,6,CTGTATTTACTCGTGGGGGG,0,860218
dgoRp,0.14285714285714285,6,6,CTGGTGTTTGGAGCACCATC,0,856313
dgoRp,0.14285714285714285,6,6,CTGGATGATACATGCGTAAG,0,859896
dgoRp,0.14285714285714285,6,6,CTGCCGGTAGAAGTTAAATA,0,848246
dgoRp,0.14285714285714285,6,6,CTGACGTGAACTTCGGATAA,0,848652
dgoRp,0.14285714285714285,6,6,CTCTTGTGCCTAGCTAAGCG,0,849551
dgoRp,0.14285714285714285,6,6,CTCTTACACCGACAAATATG,0,867041
dgoRp,0.14285714285714285,6,6,CTCTATCCGGCTAAGGAGGT,0,850334
dgoRp,0.14285714285714285,6,6,CTCTAATGAACAGATCGTAC,0,862309
dgoRp,0.14285714285714285,6,6,CTCGTTGAAGGTATTATGTC,0,865912
dgoRp,0.14285714285714285,6,6,CTCCTCAATCTCAGTCTGAG,0,855921
dgoRp,0.14285714285714285,6,6,CTCCTAGCACGGGTGGGGCA,0,861738
dgoRp,0.14285714285714285,6,6,CTCAGCCGGCACTCCCGTGG,0,837642
dgoRp,0.14285714285714285,6,6,CTATTGGGTCTTAGATCGGG,0,853510
dgoRp,0.14285714285714285,6,6,CTACATAGCGAGCCTGAAGC,0,852264
dgoRp,0.14285714285714285,6,6,CTAAGTCCTCTGCAACTGTA,0,866761
dgoRp,0.14285714285714285,6,6,CTAAATGCTTTGCTTATGTT,0,845160
dgoRp,0.14285714285714285,6,6,CTAAAACTGCAGGATCAAAG,0,853269
dgoRp,0.14285714285714285,6,6,CGTTTTCACTATCGGCAAAT,0,843369
dgoRp,0.14285714285714285,6,6,CGTTTCTCAGCCTAAACAAT,0,862378
dgoRp,0.14285714285714285,6,6,CGTTGCGAAACACTTCTGAT,0,853445
dgoRp,0.14285714285714285,6,6,CGTTGATACTGTAAGCATTA,0,851850
dgoRp,0.14285714285714285,6,6,CGTTCTTACCGATAGAAGGT,0,835827
dgoRp,0.14285714285714285,6,6,CGTTCAGGCCCATTATCTGA,0,840459
dgoRp,0.14285714285714285,6,6,CGTTATATCCTGTGGCAGGG,0,852032
dgoRp,0.14285714285714285,6,6,CGTGTCCATGGACCCTGGTA,0,846860
dgoRp,0.14285714285714285,6,6,CGTGGTTGATAAGGGCCACG,0,847971
dgoRp,0.14285714285714285,6,6,CGTGGTACGGGTCGGTGTAT,0,838166
dgoRp,0.14285714285714285,6,6,CGTCGGAAAGTCTGAGGGCG,0,851344
dgoRp,0.14285714285714285,6,6,CGTCCTTTTCCTCAACGTAG,0,848450
dgoRp,0.14285714285714285,6,6,CGTCCTATTTAAGATTCTGT,0,860404
dgoRp,0.14285714285714285,6,6,CGTCAGTTGGGGGCCTGGAA,0,851565
dgoRp,0.14285714285714285,6,6,CGTAGTAATCCCGGAGAGTT,0,865033
dgoRp,0.14285714285714285,6,6,CGTACGCCTGCAATTTCCCT,0,838446
dgoRp,0.14285714285714285,6,6,CGTAACGAGATGGCGCGCCG,0,847150
dgoRp,0.14285714285714285,6,6,CGGTTCGCGATTTGGTTAAG,0,851531
dgoRp,0.14285714285714285,6,6,CGGTGTCTTAGGTCATTACG,0,854052
dgoRp,0.14285714285714285,6,6,CGGTGGGTGCTACCGTTAGT,0,843073
dgoRp,0.14285714285714285,6,6,CGGTCTAGATGGGTCACACT,0,850513
dgoRp,0.14285714285714285,6,6,CGGTACATGGGTACAGTTTG,0,849593
dgoRp,0.14285714285714285,6,6,CGGCGTTGGTTTGATAAGTA,0,860397
dgoRp,0.14285714285714285,6,6,CGGCCTGTTGACCGCCCACA,0,846648
dgoRp,0.14285714285714285,6,6,CGGCATCGATAGTTTTACGA,0,851752
dgoRp,0.14285714285714285,6,6,CGGCAACGATACCTGCGTGC,0,857165
dgoRp,0.14285714285714285,6,6,CGGAGGATAAATTCTATCGA,0,839149
dgoRp,0.14285714285714285,6,6,CGGACATTAGCTAGAAAAGC,0,862937
dgoRp,0.14285714285714285,6,6,CGGAATCCGCACTTGATGGA,0,837659
dgoRp,0.14285714285714285,6,6,CGGAAAATTGAGGTTCTAAG,0,839489
dgoRp,0.14285714285714285,6,6,CGCGTTCCGGGGTGGCATAT,0,837615
dgoRp,0.14285714285714285,6,6,CGCGTTATGACTGCATAGGA,0,865506
dgoRp,0.14285714285714285,6,6,CGCGTCTTCAACATAATTAA,0,837520
dgoRp,0.14285714285714285,6,6,CGCGCATTACAAAGAGAGTG,0,837933
dgoRp,0.14285714285714285,6,6,CGCGATGCCAAGGTATAGGC,0,857055
dgoRp,0.14285714285714285,6,6,CGCAGTAGGTTCCTGTTGCG,0,842055
dgoRp,0.14285714285714285,6,6,CGCAATATCGCCGGTGTCTA,0,846650
dgoRp,0.14285714285714285,6,6,CGCAAACAAAAGTGGGTTTA,0,855468
dgoRp,0.14285714285714285,6,6,CGAGTTAGTTGAGGCAATAT,0,846327
dgoRp,0.14285714285714285,6,6,CGACTATCGTGGGGGACTGG,0,863387
dgoRp,0.14285714285714285,6,6,CGACGCTATGGCTAAGTGTT,0,852286
dgoRp,0.14285714285714285,6,6,CGACATTTAAACCTAGCTGT,0,848398
dgoRp,0.14285714285714285,6,6,CGACAGGGTTTGAACCTTAA,0,866254
dgoRp,0.14285714285714285,6,6,CGAATATAGATAATAGCGGT,0,862146
dgoRp,0.14285714285714285,6,6,CGAACTCCCCCGCAGGATGA,0,841281
dgoRp,0.14285714285714285,6,6,CGAAAGGTTTTTAGTATTGG,0,840666
dgoRp,0.14285714285714285,6,6,CCTGCGTTGTGCACTGCGCA,0,856858
dgoRp,0.14285714285714285,6,6,CCTGCAACCTACAAAGGCCT,0,858330
dgoRp,0.14285714285714285,6,6,CCTCTTCCAGTAACATCGTT,0,853797
dgoRp,0.14285714285714285,6,6,CCTCAGGGACACCGTAACAA,0,845848
dgoRp,0.14285714285714285,6,6,CCTAGCACCGTTACTGACGG,0,856382
dgoRp,0.14285714285714285,6,6,CCGTGTCCCCAGGCGAAGTA,0,835930
dgoRp,0.14285714285714285,6,6,CCGTCAACTAGCTACAGTAC,0,855715
dgoRp,0.14285714285714285,6,6,CCGTATGAAGGGTTTCTATG,0,862517
dgoRp,0.14285714285714285,6,6,CCGGGTGACCTGCGCCCAGG,0,864840
dgoRp,0.14285714285714285,6,6,CCGGGTCGAAAGTAATAGGA,0,861131
dgoRp,0.14285714285714285,6,6,CCGGCTAAAAACGCGTCGCT,0,856447
dgoRp,0.14285714285714285,6,6,CCGCGACATGGGTCTCAAAC,0,852155
dgoRp,0.14285714285714285,6,6,CCGACAATCGAGGTTTGCAA,0,849209
dgoRp,0.14285714285714285,6,6,CCGAAAAGTACATGCGCGCG,0,859482
dgoRp,0.14285714285714285,6,6,CCCTTGCCCGTAGGTACCCT,0,862871
dgoRp,0.14285714285714285,6,6,CCCGAGAAATTTCGCGTAGT,0,841648
dgoRp,0.14285714285714285,6,6,CCCCGTTCTAACCATAACAA,0,859605
dgoRp,0.14285714285714285,6,6,CCCCCCAGTGATGTACATCT,0,849993
dgoRp,0.14285714285714285,6,6,CCCATTCAATTAACTCTCCA,0,861676
dgoRp,0.14285714285714285,6,6,CCCAACGGGTTAGGCTTAGT,0,839531
dgoRp,0.14285714285714285,6,6,CCATTCTGTGAGGAGGCTGA,0,847255
dgoRp,0.14285714285714285,6,6,CCATGTATCCCTCATTATCC,0,842640
dgoRp,0.14285714285714285,6,6,CCATACAGAAGCCAAGAAGT,0,866773
dgoRp,0.14285714285714285,6,6,CCAGGGCCAAGGCTTCGGTA,0,836149
dgoRp,0.14285714285714285,6,6,CCACGTCTGCGCCCCGTTGC,0,858669
dgoRp,0.14285714285714285,6,6,CCACCCTGTAAACCGGGAGA,0,838220
dgoRp,0.14285714285714285,6,6,CCAATGTAGGCAGTCCTACT,0,863258
dgoRp,0.14285714285714285,6,6,CATTGTCGGGCAGATGGTCT,0,863328
dgoRp,0.14285714285714285,6,6,CATTCTTTGTGTCATATAAG,0,846607
dgoRp,0.14285714285714285,6,6,CATGTTTGAGTAACCTTGGT,0,839845
dgoRp,0.14285714285714285,6,6,CATGGGTTCAGCACGCGACA,0,842210
dgoRp,0.14285714285714285,6,6,CATGCTCATGATTGACGATT,0,857872
dgoRp,0.14285714285714285,6,6,CATACGTACAATGTATATCA,0,848079
dgoRp,0.14285714285714285,6,6,CATACACGGCATACCTGACT,0,860110
dgoRp,0.14285714285714285,6,6,CATACAAACGTGCGTCGACT,0,845826
dgoRp,0.14285714285714285,6,6,CATAAGATGAATAACGACAC,0,864538
dgoRp,0.14285714285714285,6,6,CAGTACACGTTTGACTAGAA,0,855273
dgoRp,0.14285714285714285,6,6,CAGGAAAATTTGTCCCAAGA,0,846624
dgoRp,0.14285714285714285,6,6,CAGCGGGGAGCTAGGCAGGC,0,856122
dgoRp,0.14285714285714285,6,6,CAGCACGTGGCGCTCATTGA,0,859890
dgoRp,0.14285714285714285,6,6,CAGCAACGTAAGAGGGCAAA,0,853917
dgoRp,0.14285714285714285,6,6,CAGATATAGTGGGGACACCA,0,852921
dgoRp,0.14285714285714285,6,6,CAGACAGGGCGCGGTTTCGT,0,841582
dgoRp,0.14285714285714285,6,6,CAGAATTATTAGGCGCTGAT,0,859484
dgoRp,0.14285714285714285,6,6,CACTTCGATCCAGCCGCAGT,0,841944
dgoRp,0.14285714285714285,6,6,CACTGGTGTCTCTTCTTGTA,0,862758
dgoRp,0.14285714285714285,6,6,CACTGACATTTATAGAGACG,0,850973
dgoRp,0.14285714285714285,6,6,CACGAAGATCCCTAACCCAC,0,841868
dgoRp,0.14285714285714285,6,6,CACCGTTGGAGTCGGCCCCA,0,860466
dgoRp,0.14285714285714285,6,6,CACATGTTTGTACCTTGGGG,0,837438
dgoRp,0.14285714285714285,6,6,CACACAATCTATTAGAGTAT,0,844155
dgoRp,0.14285714285714285,6,6,CACAAACGATGCTACAGAAC,0,853158
dgoRp,0.14285714285714285,6,6,CAATTCATCTAGTGCTTGTA,0,851435
dgoRp,0.14285714285714285,6,6,CAATCGATCAGGTGAACTTA,0,854923
dgoRp,0.14285714285714285,6,6,CAATCCGCTTGACACGCTAT,0,852343
dgoRp,0.14285714285714285,6,6,CAATATTATCTGGAGGACCC,0,861856
dgoRp,0.14285714285714285,6,6,CAAGGGGTCGTAGGTAGTTG,0,838229
dgoRp,0.14285714285714285,6,6,CAACCGCGGCACGTCTCGAA,0,839222
dgoRp,0.14285714285714285,6,6,CAAACGCACACGGCCCTTCG,0,859353
dgoRp,0.14285714285714285,6,6,ATTGTTGGTAGGATAACTGT,0,866857
dgoRp,0.14285714285714285,6,6,ATTCTCTAGCAATCGTGTAC,0,856671
dgoRp,0.14285714285714285,6,6,ATTCGGACTGAATGATTGCA,0,844768
dgoRp,0.14285714285714285,6,6,ATTCCGGAACCCTAGAGCTT,0,852537
dgoRp,0.14285714285714285,6,6,ATTCATTGAAGTAAACGCAT,0,852052
dgoRp,0.14285714285714285,6,6,ATTATGGGGTTAAGCACATT,0,860813
dgoRp,0.14285714285714285,6,6,ATTACTGTGTACTGTCTAAC,0,860347
dgoRp,0.14285714285714285,6,6,ATGTCCGGCAAATTTGCGGT,0,852680
dgoRp,0.14285714285714285,6,6,ATGTCACCAGAGGATGACAG,0,863272
dgoRp,0.14285714285714285,6,6,ATGCTTGGTCATCCAGTTAC,0,852982
dgoRp,0.14285714285714285,6,6,ATGCACAAGCAAGGTGGCCA,0,836709
dgoRp,0.14285714285714285,6,6,ATGATCTTGGGGATGTGATT,0,859212
dgoRp,0.14285714285714285,6,6,ATCTGCCAGTTTATTAGTTC,0,862349
dgoRp,0.14285714285714285,6,6,ATCTGACTCCGGTCCATCGT,0,863611
dgoRp,0.14285714285714285,6,6,ATCGCGTCGCCTCTGAATTG,0,847517
dgoRp,0.14285714285714285,6,6,ATCCAGTACTCGCGTCAGGG,0,861205
dgoRp,0.14285714285714285,6,6,ATCACGCTTCCAGATCTCTT,0,851319
dgoRp,0.14285714285714285,6,6,ATCAAGAAAGTAGAACCGCT,0,859726
dgoRp,0.14285714285714285,6,6,ATATCTATAACTCGCGACGA,0,849733
dgoRp,0.14285714285714285,6,6,ATATCCGACTGTAGTACACC,0,855027
dgoRp,0.14285714285714285,6,6,ATAGATGAAACGTCAATTAT,0,851675
dgoRp,0.14285714285714285,6,6,ATACGAAGCGTATACGGAGT,0,858568
dgoRp,0.14285714285714285,6,6,ATAATGTGGTTTCATCACGT,0,855624
dgoRp,0.14285714285714285,6,6,AGTTAAGCATCTTCGAAGGA,0,849442
dgoRp,0.14285714285714285,6,6,AGTGGGACTCTCCATGAGTT,0,851154
dgoRp,0.14285714285714285,6,6,AGTGCGAACCATGACACTGT,0,838727
dgoRp,0.14285714285714285,6,6,AGTCTTGTATTTCTGGGTCA,0,861955
dgoRp,0.14285714285714285,6,6,AGTCTGCGTCGGCACTATTG,0,839527
dgoRp,0.14285714285714285,6,6,AGTCGGCGGAATAAACCTTA,0,866634
dgoRp,0.14285714285714285,6,6,AGTCCTGAACTACGTGGAGT,0,840920
dgoRp,0.14285714285714285,6,6,AGTCACATACCTGAGTACTA,0,844262
dgoRp,0.14285714285714285,6,6,AGTAGTCAACCTATGATGGC,0,839590
dgoRp,0.14285714285714285,6,6,AGGTCGTGGCCCAACGCACC,0,847491
dgoRp,0.14285714285714285,6,6,AGGGTGGACTAACCTCGTCC,0,860205
dgoRp,0.14285714285714285,6,6,AGGGGCCGCTTAGAATACGG,0,862508
dgoRp,0.14285714285714285,6,6,AGGGCCAAACTCCTGCCTCC,0,865209
dgoRp,0.14285714285714285,6,6,AGGGACCGCTTGAGTCTCCG,0,858468
dgoRp,0.14285714285714285,6,6,AGGCTGTGTGGATAGCTACT,0,855147
dgoRp,0.14285714285714285,6,6,AGGCGGCTGAACCCTAAGGG,0,860787
dgoRp,0.14285714285714285,6,6,AGGCGGCGGCCTCGCAAGCA,0,861737
dgoRp,0.14285714285714285,6,6,AGCGTAATGCGAAGAGTTAA,0,858426
dgoRp,0.14285714285714285,6,6,AGCCTGAATGTTAAAACACT,0,837180
dgoRp,0.14285714285714285,6,6,AGCCTACACTAATGTGGAAT,0,851499
dgoRp,0.14285714285714285,6,6,AGCCATTACGTGTTATTCGT,0,852169
dgoRp,0.14285714285714285,6,6,AGCCATCATACCTACAGGCG,0,848842
dgoRp,0.14285714285714285,6,6,AGATTGGCACATCCACGGTT,0,843365
dgoRp,0.14285714285714285,6,6,AGATGCGTCTCGTTCCTAGA,0,865230
dgoRp,0.14285714285714285,6,6,AGAGTTGGTAAGTTGAGGCT,0,841634
dgoRp,0.14285714285714285,6,6,AGAGTTCGTTCTTGCTCCTG,0,866296
dgoRp,0.14285714285714285,6,6,AGAGCCGGTGATACAAAGAG,0,840329
dgoRp,0.14285714285714285,6,6,AGAGACGCAGGCACCTGCAG,0,866635
dgoRp,0.14285714285714285,6,6,AGAGACCATACACGTCCAAC,0,843506
dgoRp,0.14285714285714285,6,6,AGACTGGGCTGATTAAAGAC,0,844849
dgoRp,0.14285714285714285,6,6,AGACCGGGACTTCGTGGGGG,0,865916
dgoRp,0.14285714285714285,6,6,AGAACCGGCAACCACACGAG,0,838644
dgoRp,0.14285714285714285,6,6,AGAAAGCGTGCATTCCCAGC,0,867165
dgoRp,0.14285714285714285,6,6,AGAAACTTAAGAATTCATGG,0,837060
dgoRp,0.14285714285714285,6,6,ACTTTCGCGATGGAAGTGTG,0,858245
dgoRp,0.14285714285714285,6,6,ACTTTCACTCAAGAGTGTAG,0,850434
dgoRp,0.14285714285714285,6,6,ACTCGCGGCTGTTGCCGAAG,0,858476
dgoRp,0.14285714285714285,6,6,ACTAGGTGATATCGGTGGAT,0,865495
dgoRp,0.14285714285714285,6,6,ACTACGCTGCCAGGGCGCTC,0,863940
dgoRp,0.14285714285714285,6,6,ACGGGGTTCGCAGATCTGTA,0,846042
dgoRp,0.14285714285714285,6,6,ACGGCCGTTGTCCGATAGTT,0,837448
dgoRp,0.14285714285714285,6,6,ACGGCACTTCGGACATATGT,0,862593
dgoRp,0.14285714285714285,6,6,ACGGACATTAGCTACCCGTT,0,861321
dgoRp,0.14285714285714285,6,6,ACGCGCATGGACTTCCTTAT,0,838679
dgoRp,0.14285714285714285,6,6,ACGATAGGGATCTTGCACAG,0,859823
dgoRp,0.14285714285714285,6,6,ACCGTACTGGAATTTCGAGG,0,853413
dgoRp,0.14285714285714285,6,6,ACCGTACTGATGTATGTGGT,0,844745
dgoRp,0.14285714285714285,6,6,ACCGCTTTTGATTTTCGTAC,0,852095
dgoRp,0.14285714285714285,6,6,ACCGCACTTTCCTGTAGACT,0,867482
dgoRp,0.14285714285714285,6,6,ACCGACTTCGACTTCTAGAT,0,866332
dgoRp,0.14285714285714285,6,6,ACCCTTCTATGTATAACGGT,0,858043
dgoRp,0.14285714285714285,6,6,ACACTGCGGGTACACCATCG,0,848179
dgoRp,0.14285714285714285,6,6,ACAAATGGAGTCTGGAAATA,0,838200
dgoRp,0.14285714285714285,6,6,ACAAAAGAAGCCTGTCGTCT,0,845388
dgoRp,0.14285714285714285,6,6,AATGTTTGGTGGTCAACAAT,0,843928
dgoRp,0.14285714285714285,6,6,AATCGTATGTGCGGAACTTC,0,866264
dgoRp,0.14285714285714285,6,6,AATAGCGTGGCTAGTAGGAG,0,839325
dgoRp,0.14285714285714285,6,6,AAGTGGAAAAATCTGCTCGT,0,850069
dgoRp,0.14285714285714285,6,6,AAGTGCGAGGTGGTATGCCC,0,844832
dgoRp,0.14285714285714285,6,6,AAGTCGTATGATTTCGGAAC,0,862641
dgoRp,0.14285714285714285,6,6,AAGTCCTCCTTCCAACGAAC,0,850963
dgoRp,0.14285714285714285,6,6,AAGGATAGACCCACCAGGGA,0,857996
dgoRp,0.14285714285714285,6,6,AAGCGGAGTTGGTCTCGCCT,0,863931
dgoRp,0.14285714285714285,6,6,AAGCGCTCCAACTACCACTG,0,851224
dgoRp,0.14285714285714285,6,6,AAGCCGTGTGTTTTGCTTGA,0,839409
dgoRp,0.14285714285714285,6,6,AAGCCAGGGCATCAGGTAAC,0,858881
dgoRp,0.14285714285714285,6,6,AAGCATCGTGGAGCACATGA,0,846273
dgoRp,0.14285714285714285,6,6,AAGCAACGTATAACATGTTT,0,836387
dgoRp,0.14285714285714285,6,6,AAGATTCGCAGTATTCGGGA,0,851401
dgoRp,0.14285714285714285,6,6,AAGATCGGCTGGGTCAGTCG,0,840892
dgoRp,0.14285714285714285,6,6,AAGAAGTCAGGTGGCCAAGT,0,838276
dgoRp,0.14285714285714285,6,6,AACGTAGGCGCCTAGTTCTA,0,848565
dgoRp,0.14285714285714285,6,6,AACGGTTAAACGAATTCCGC,0,843274
dgoRp,0.14285714285714285,6,6,AACCAGCGTATCATCTCGGG,0,855418
dgoRp,0.14285714285714285,6,6,AACATCGCTGATCCTGGAGA,0,858328
dgoRp,0.14285714285714285,6,6,AAATGTGAGCAAGGTAGTTA,0,862034
dgoRp,0.14285714285714285,6,6,AAATAGAATGCGAGATATTC,0,860854
dgoRp,0.14285714285714285,6,6,AAATAAAAGCTGTGTTTAAG,0,856751
dgoRp,0.14285714285714285,6,6,AAAGGGGATGGGCAAGGATA,0,848158
dgoRp,0.14285714285714285,6,6,AAACGGGCGCAACTCCATTA,0,838049
dgoRp,0.14285714285714285,6,6,AAAAGATCATCACATGAGCT,0,853386
dgoRp,0.14285714285714285,6,6,AAAAGAAGCTGTTTCAGTGA,0,863688
dgoRp,0.14285714285714285,6,6,AAAAATTAGCTAATTTGACA,0,854362
dgoRp,0.14285714285714285,6,6,AAAAACTGATAGAAATTTGT,0,847413
dgoRp,0.16666666666666666,5,5,TTTTCTCTAGTCAGACCTGA,0,852688
dgoRp,0.16666666666666666,5,5,TTTGGAATCGTGACCTCGGT,0,864654
dgoRp,0.16666666666666666,5,5,TTTCGCTGGATTTTTCATTC,0,849384
dgoRp,0.16666666666666666,5,5,TTTCCGCGACGACCGAAGCT,0,861319
dgoRp,0.16666666666666666,5,5,TTTAGCAATTATATGGGCAG,0,851969
dgoRp,0.16666666666666666,5,5,TTTACAGACTACGGCTTAGT,0,856101
dgoRp,0.16666666666666666,5,5,TTGGGAGACAGTTCACATTG,0,850191
dgoRp,0.16666666666666666,5,5,TTGGCACACGAGAGGTTTTT,0,866666
dgoRp,0.16666666666666666,5,5,TTGGACTTGGTGAGGAATAA,0,856421
dgoRp,0.16666666666666666,5,5,TTGGAAGGCAGTATGTTTAA,0,851495
dgoRp,0.16666666666666666,5,5,TTGCTTGCGCGTTCCTCTGG,0,848779
dgoRp,0.16666666666666666,5,5,TTGCTCTGAAGTGTCCATTT,0,842309
dgoRp,0.16666666666666666,5,5,TTGCGAGCTCCTCGAATAGT,0,836567
dgoRp,0.16666666666666666,5,5,TTGCATAAAGCAGGTCCGCA,0,865414
dgoRp,0.16666666666666666,5,5,TTCCTTCAGATTTCTAGAGA,0,846172
dgoRp,0.16666666666666666,5,5,TTCCGCTCGCACAGGATTCC,0,850433
dgoRp,0.16666666666666666,5,5,TTCAGCGAAATTATTAATCT,0,866049
dgoRp,0.16666666666666666,5,5,TTATGGGTAATATCTGGCCA,0,840616
dgoRp,0.16666666666666666,5,5,TTATGCACCAGTCCGCCCCC,0,849574
dgoRp,0.16666666666666666,5,5,TTAGTTGCACTGGAAACTCG,0,839347
dgoRp,0.16666666666666666,5,5,TTACCACTTGTCTACGCGTG,0,857967
dgoRp,0.16666666666666666,5,5,TTAATCCTGCAAACGACGGA,0,865986
dgoRp,0.16666666666666666,5,5,TTAACTCAGGGTGTGGCATT,0,864251
dgoRp,0.16666666666666666,5,5,TGTTCTTGGTAACTAAGGAG,0,841098
dgoRp,0.16666666666666666,5,5,TGTGTAATAATTGTATCTGA,0,851989
dgoRp,0.16666666666666666,5,5,TGTGGGTCAACGCTATCACT,0,845118
dgoRp,0.16666666666666666,5,5,TGTCTCATGAGCGGCTGGCG,0,855977
dgoRp,0.16666666666666666,5,5,TGTCCTATAAGTGTAAAAGG,0,849567
dgoRp,0.16666666666666666,5,5,TGTCACCCGGGTACAGACCA,0,860886
dgoRp,0.16666666666666666,5,5,TGTACCTTGAGTTTCACCGT,0,862158
dgoRp,0.16666666666666666,5,5,TGTACCCCGCGCTTATATTG,0,842353
dgoRp,0.16666666666666666,5,5,TGGTTATCCGTTGCCAGACA,0,865176
dgoRp,0.16666666666666666,5,5,TGGTGTGTTCGGGCCTGATA,0,837281
dgoRp,0.16666666666666666,5,5,TGGTCAGCGGGGTTTCAAGG,0,860780
dgoRp,0.16666666666666666,5,5,TGGTATAGTCGGACATATTA,0,857991
dgoRp,0.16666666666666666,5,5,TGGGGGCGGTTCCGCTGGTA,0,838525
dgoRp,0.16666666666666666,5,5,TGGGATCTAAAAAACGGCCC,0,838549
dgoRp,0.16666666666666666,5,5,TGGGAGGCTCAAAGTGGCAC,0,839671
dgoRp,0.16666666666666666,5,5,TGGGACGCTGTAAACAAGCC,0,849461
dgoRp,0.16666666666666666,5,5,TGGGACCTTGGTCCTTTGCA,0,842571
dgoRp,0.16666666666666666,5,5,TGGGACCGGGGACCAGCTAC,0,841245
dgoRp,0.16666666666666666,5,5,TGGACTAGGCTAAGACGGCC,0,860294
dgoRp,0.16666666666666666,5,5,TGCTTCCACATTTTCAGCTC,0,857708
dgoRp,0.16666666666666666,5,5,TGCTGTTCTACCGTAATTCA,0,847341
dgoRp,0.16666666666666666,5,5,TGCTGAAGAGACAGGTAAAC,0,844602
dgoRp,0.16666666666666666,5,5,TGCGGTACCGGAGGCGTTGG,0,857050
dgoRp,0.16666666666666666,5,5,TGCGAGAAACGGGGCTGATA,0,841258
dgoRp,0.16666666666666666,5,5,TGCCTTACTCATTAGGTCGC,0,843331
dgoRp,0.16666666666666666,5,5,TGCCGGCTAATTAAATTAAG,0,857721
dgoRp,0.16666666666666666,5,5,TGCCGCATTTTACCCGGGGT,0,850035
dgoRp,0.16666666666666666,5,5,TGCCGCAAACTTTCAGGCAG,0,844200
dgoRp,0.16666666666666666,5,5,TGCCCCGGGTAAGAGGGTAC,0,858456
dgoRp,0.16666666666666666,5,5,TGCATCCGCCATTCTTGAGC,0,863441
dgoRp,0.16666666666666666,5,5,TGCAACGTAGCCGCTGTTTA,0,839261
dgoRp,0.16666666666666666,5,5,TGATGGGTTTGCCTCGGTCA,0,841847
dgoRp,0.16666666666666666,5,5,TGACGTGGACATCCCGATCG,0,840670
dgoRp,0.16666666666666666,5,5,TGACAAAAGCACTACAACCC,0,845885
dgoRp,0.16666666666666666,5,5,TGAAGCTCCGGATTTGATGA,0,848473
dgoRp,0.16666666666666666,5,5,TGAACTGAGGTCCAGGTAAA,0,861633
dgoRp,0.16666666666666666,5,5,TGAACGTTGTGGGCCGCCAA,0,850686
dgoRp,0.16666666666666666,5,5,TCTTTTAATAAAGAGCAAGC,0,836371
dgoRp,0.16666666666666666,5,5,TCTTCTTCGCTTTGAGGGAA,0,862587
dgoRp,0.16666666666666666,5,5,TCTTCAGAAGGTCGGTATTG,0,853218
dgoRp,0.16666666666666666,5,5,TCTTACAAGATTTGCCGTTT,0,842110
dgoRp,0.16666666666666666,5,5,TCTGTTTAAAAGCTATTTAA,0,861969
dgoRp,0.16666666666666666,5,5,TCTGGATGGCATGCTTTCTT,0,861881
dgoRp,0.16666666666666666,5,5,TCTGCTGCAGGTGCCTTCAT,0,864998
dgoRp,0.16666666666666666,5,5,TCTCGATAACTTGGGTTACA,0,856393
dgoRp,0.16666666666666666,5,5,TCTCACAGTATTTTTGTAGA,0,847132
dgoRp,0.16666666666666666,5,5,TCGGGGAATTTTCGCAGCGG,0,840370
dgoRp,0.16666666666666666,5,5,TCGCCTCCACTGATTTTGAG,0,867161
dgoRp,0.16666666666666666,5,5,TCGACGCGTCTGAACGGCAG,0,843525
dgoRp,0.16666666666666666,5,5,TCCGTTCGCGTGTGACGTCC,0,849591
dgoRp,0.16666666666666666,5,5,TCCCTAAAAATAGCCGACAT,0,845995
dgoRp,0.16666666666666666,5,5,TCCCGGATTATATGATTACC,0,836478
dgoRp,0.16666666666666666,5,5,TCCCGCAAACGAGCGGATGT,0,850691
dgoRp,0.16666666666666666,5,5,TCCCCAAGGTTGTCTCATCC,0,861409
dgoRp,0.16666666666666666,5,5,TCCCATGAGTACATATCACA,0,866830
dgoRp,0.16666666666666666,5,5,TCCCAGGCCAAAGTATCTAG,0,863184
dgoRp,0.16666666666666666,5,5,TCCAACGAGCTAGGCATCTG,0,845055
dgoRp,0.16666666666666666,5,5,TCATCGAAAGTTTCGGGGTG,0,840366
dgoRp,0.16666666666666666,5,5,TCATCCGCAGCGGGTGAGCC,0,861673
dgoRp,0.16666666666666666,5,5,TCAGGTCTACAAGCCGCACA,0,838736
dgoRp,0.16666666666666666,5,5,TCAGACACTAGAGAATGATG,0,841361
dgoRp,0.16666666666666666,5,5,TCACTTTTGTCTATGTACGT,0,861174
dgoRp,0.16666666666666666,5,5,TCACATTGGAATAATTGATT,0,846876
dgoRp,0.16666666666666666,5,5,TCAACTTGGTTACCGAACCA,0,861696
dgoRp,0.16666666666666666,5,5,TATTTAACCGGAACATAGGT,0,849594
dgoRp,0.16666666666666666,5,5,TATTGAGAATCTGTCACCCG,0,836860
dgoRp,0.16666666666666666,5,5,TATGTTAAAGTCTTTAATCC,0,852079
dgoRp,0.16666666666666666,5,5,TAGGGTGAGATTGGCCCTCT,0,866313
dgoRp,0.16666666666666666,5,5,TAGGCAATGCAGGGATGCTC,0,854324
dgoRp,0.16666666666666666,5,5,TAGGAGAGCCCTAGAAGTCA,0,856013
dgoRp,0.16666666666666666,5,5,TAGCCCAATGGCCTTCATGA,0,845369
dgoRp,0.16666666666666666,5,5,TAGCAATAATTACAATTATG,0,859821
dgoRp,0.16666666666666666,5,5,TAGATATCGGGTAGCGCCAA,0,864358
dgoRp,0.16666666666666666,5,5,TACTGGTTTATCGTTTGACA,0,855940
dgoRp,0.16666666666666666,5,5,TACTCGTCCATATTGTAGTG,0,866243
dgoRp,0.16666666666666666,5,5,TACGGGCTCTTGAAGCGGTA,0,854491
dgoRp,0.16666666666666666,5,5,TACGGAGAGACAAAGCCCTA,0,855263
dgoRp,0.16666666666666666,5,5,TACGATCAAGCTTTTAAGTT,0,865535
dgoRp,0.16666666666666666,5,5,TACCTCTCGTATGCATTACT,0,838883
dgoRp,0.16666666666666666,5,5,TACCGTGATTTAAGGTTGAA,0,842803
dgoRp,0.16666666666666666,5,5,TACCCGAATACGCCATTAAC,0,860407
dgoRp,0.16666666666666666,5,5,TACCAATGAAAATTGGTTAT,0,843619
dgoRp,0.16666666666666666,5,5,TACAACCGGTACGCCGACTC,0,847696
dgoRp,0.16666666666666666,5,5,TAATGACCTTCTAAAGTCAT,0,850067
dgoRp,0.16666666666666666,5,5,TAATAGATCGAATGACCTTG,0,843131
dgoRp,0.16666666666666666,5,5,TAAGTGATTAGTCAGATCTT,0,863599
dgoRp,0.16666666666666666,5,5,TAACGCGAATGAATGTTGTT,0,845681
dgoRp,0.16666666666666666,5,5,TAAATTAAGCATACGGCCAA,0,857970
dgoRp,0.16666666666666666,5,5,TAAAGGTTGCGTGTAAGAGG,0,866101
dgoRp,0.16666666666666666,5,5,TAAAAAGTAACACGCAATAC,0,858469
dgoRp,0.16666666666666666,5,5,GTTTTTAGCCTTCGCGCCCA,0,856450
dgoRp,0.16666666666666666,5,5,GTTTAAAGGCAAGTTTCAAA,0,836351
dgoRp,0.16666666666666666,5,5,GTTTAAAAGGGGCACACTGG,0,844753
dgoRp,0.16666666666666666,5,5,GTTCTATAGTAAGGGGATAG,0,855435
dgoRp,0.16666666666666666,5,5,GTTCCTGGCATCCACCGTGC,0,841810
dgoRp,0.16666666666666666,5,5,GTTCCCTCGTGTGAGATCAG,0,849435
dgoRp,0.16666666666666666,5,5,GTTCAGGTGTGAACGTCAGC,0,864775
dgoRp,0.16666666666666666,5,5,GTTCACGACCGGAAACCTTA,0,851930
dgoRp,0.16666666666666666,5,5,GTTATCGGTCATGTTACGCT,0,845156
dgoRp,0.16666666666666666,5,5,GTGTCATCAAATGCCAGGCA,0,840231
dgoRp,0.16666666666666666,5,5,GTGGGTTTGCACGAGAATAT,0,860423
dgoRp,0.16666666666666666,5,5,GTGGAAGTAAAGTTAGAAAA,0,847171
dgoRp,0.16666666666666666,5,5,GTGATTAAGTTAGACCCATT,0,861271
dgoRp,0.16666666666666666,5,5,GTGATTAAAGTATTATCAGC,0,852902
dgoRp,0.16666666666666666,5,5,GTGAATCCATTCTAGAAAGT,0,853623
dgoRp,0.16666666666666666,5,5,GTGAACAGAGATTGTATTTC,0,861022
dgoRp,0.16666666666666666,5,5,GTCTTCTATTTCCTGTATAT,0,858673
dgoRp,0.16666666666666666,5,5,GTCGTTCGGGCGTAATAAAG,0,849300
dgoRp,0.16666666666666666,5,5,GTCGATGAACAAGAGGGTCA,0,860591
dgoRp,0.16666666666666666,5,5,GTATACCCACGCTTGTCTCC,0,840184
dgoRp,0.16666666666666666,5,5,GTAGGTAGGACCTCGGCTCC,0,851306
dgoRp,0.16666666666666666,5,5,GTAGATCCAAAGTTGTTTTG,0,864539
dgoRp,0.16666666666666666,5,5,GTACGTGTGGATCTAACGTC,0,846704
dgoRp,0.16666666666666666,5,5,GTACACGGGGAGTAGATGCA,0,848600
dgoRp,0.16666666666666666,5,5,GTACAAGAAAGCTGTGATTG,0,854661
dgoRp,0.16666666666666666,5,5,GTACAACGCTATGTGGAGAG,0,842913
dgoRp,0.16666666666666666,5,5,GTAATGAATACGTGAGCAGG,0,858523
dgoRp,0.16666666666666666,5,5,GGTTTTCGGCTGTTCGGGTG,0,839162
dgoRp,0.16666666666666666,5,5,GGTGTTAATGAGCGACTATA,0,852456
dgoRp,0.16666666666666666,5,5,GGTGACAAGAGCGGAACAAG,0,852596
dgoRp,0.16666666666666666,5,5,GGTCGGCAAGATGAGCAGAT,0,862076
dgoRp,0.16666666666666666,5,5,GGTCCGACGATGACCTGACA,0,851229
dgoRp,0.16666666666666666,5,5,GGTCAGGCATCAATGCAGGC,0,842025
dgoRp,0.16666666666666666,5,5,GGTCACTCGAAGGTGGTAAA,0,859765
dgoRp,0.16666666666666666,5,5,GGTATGTAACCAGAAAACTG,0,844529
dgoRp,0.16666666666666666,5,5,GGTATCCCCTAAGGTACAAT,0,864461
dgoRp,0.16666666666666666,5,5,GGTAGTGTACATCCAGACTA,0,843319
dgoRp,0.16666666666666666,5,5,GGTAGCTATTTTGGCTTCAA,0,865972
dgoRp,0.16666666666666666,5,5,GGTACGTGATATAGTCAGAT,0,855686
dgoRp,0.16666666666666666,5,5,GGGTGTCTTCGCGCGTCCGT,0,844648
dgoRp,0.16666666666666666,5,5,GGGTACTGTTATTTTAGACA,0,859148
dgoRp,0.16666666666666666,5,5,GGGGTCTCAGGGGGGACATG,0,854416
dgoRp,0.16666666666666666,5,5,GGGGTCTAATCATGTGGGAT,0,851248
dgoRp,0.16666666666666666,5,5,GGGGGACAATGATGAAGGGA,0,863312
dgoRp,0.16666666666666666,5,5,GGGCGTTGTATGGTCCGGAC,0,851171
dgoRp,0.16666666666666666,5,5,GGGCGCGGAACGTGGGCAGA,0,851817
dgoRp,0.16666666666666666,5,5,GGGCACGGCGCGTCTCCAAC,0,850299
dgoRp,0.16666666666666666,5,5,GGGATTCAACCTTTCTGACA,0,854069
dgoRp,0.16666666666666666,5,5,GGGAGAAGTTATCGGCTTCC,0,866439
dgoRp,0.16666666666666666,5,5,GGGAAAGCCGCGTATCCTCG,0,840263
dgoRp,0.16666666666666666,5,5,GGCTGCGTAGTAGGTGCTCA,0,857074
dgoRp,0.16666666666666666,5,5,GGCTAGATAAGGGCGTCGAT,0,863811
dgoRp,0.16666666666666666,5,5,GGCGTCCGTGGAATCCACAG,0,837116
dgoRp,0.16666666666666666,5,5,GGCCGGTGTAACAGGAGGAA,0,863584
dgoRp,0.16666666666666666,5,5,GGCCGAGATGGGTAAGATGA,0,853562
dgoRp,0.16666666666666666,5,5,GGCCCTTCCCCTAAGCAGAC,0,861918
dgoRp,0.16666666666666666,5,5,GGCCAAGCGGAAACTGCCTA,0,848477
dgoRp,0.16666666666666666,5,5,GGCATCAAGGAAGACTTTAT,0,850949
dgoRp,0.16666666666666666,5,5,GGCACCTTATAAGAATTATA,0,848173
dgoRp,0.16666666666666666,5,5,GGCACAAACCCATCAACTTC,0,849949
dgoRp,0.16666666666666666,5,5,GGATTTGGCATACAGAGCTG,0,858894
dgoRp,0.16666666666666666,5,5,GGATTGTACACTGGGTGGGT,0,839160
dgoRp,0.16666666666666666,5,5,GGATTGGTTCTTAGGGCGAT,0,859013
dgoRp,0.16666666666666666,5,5,GGATGCAAATACGTACTCCA,0,851957
dgoRp,0.16666666666666666,5,5,GGATACGTCCTTATCGGCCC,0,849784
dgoRp,0.16666666666666666,5,5,GGAGATTTTGGCCCAGAATG,0,854221
dgoRp,0.16666666666666666,5,5,GCTTGTGGAGCAAGTGTTGA,0,849590
dgoRp,0.16666666666666666,5,5,GCTGGTCGGTTAGTCCCACC,0,866838
dgoRp,0.16666666666666666,5,5,GCTGCAGCACGAATCACTAT,0,861051
dgoRp,0.16666666666666666,5,5,GCTGATGTGCAGCGATTCAA,0,845391
dgoRp,0.16666666666666666,5,5,GCTCTAGGGGCGCACTAGGC,0,843398
dgoRp,0.16666666666666666,5,5,GCTCCAGCTTCGCTGACTAC,0,846856
dgoRp,0.16666666666666666,5,5,GCTATGCATTCGTTCTGGGC,0,846590
dgoRp,0.16666666666666666,5,5,GCTACACACCTGTGGAGAAC,0,862016
dgoRp,0.16666666666666666,5,5,GCGTTTGTGCATAATCGTGG,0,865259
dgoRp,0.16666666666666666,5,5,GCGTTGACGTTAAAAGTTTT,0,862098
dgoRp,0.16666666666666666,5,5,GCGGTGTAATCTTTCTCTTC,0,860187
dgoRp,0.16666666666666666,5,5,GCGGCGAATACAACCGCATG,0,859626
dgoRp,0.16666666666666666,5,5,GCGCTTGCTTTTAGGTTAGG,0,850811
dgoRp,0.16666666666666666,5,5,GCGCGGGAATGACAAGGCGC,0,854375
dgoRp,0.16666666666666666,5,5,GCGACTGTTGTGATTGGTTG,0,856875
dgoRp,0.16666666666666666,5,5,GCCTCGAAACTATGAGTGTG,0,860730
dgoRp,0.16666666666666666,5,5,GCCGTGAAAGCCTTAAATTC,0,851441
dgoRp,0.16666666666666666,5,5,GCCGCCGGCTCTTCAAGCGT,0,841248
dgoRp,0.16666666666666666,5,5,GCCGAAGCAGCATATTATCG,0,862058
dgoRp,0.16666666666666666,5,5,GCCCGCTTCGCGATCATTAT,0,843566
dgoRp,0.16666666666666666,5,5,GCATGAGGCTGGTAACAAAA,0,838674
dgoRp,0.16666666666666666,5,5,GCATGAGCAAAGCGAACGCC,0,854121
dgoRp,0.16666666666666666,5,5,GCATAGTTCGCTTCGGCTTA,0,837847
dgoRp,0.16666666666666666,5,5,GCAGATTTGGGAATTGCCTT,0,853781
dgoRp,0.16666666666666666,5,5,GCAGATCTCCAGAGCTCTTT,0,835904
dgoRp,0.16666666666666666,5,5,GCACTTGGCAGAGTTACGAT,0,848544
dgoRp,0.16666666666666666,5,5,GCACCTATGCCCATACCCCG,0,843583
dgoRp,0.16666666666666666,5,5,GCACCCCCCAAAACGAGTGA,0,860099
dgoRp,0.16666666666666666,5,5,GCAAGTGGCTGCACTGCCGT,0,863936
dgoRp,0.16666666666666666,5,5,GATGAGACGGCGGTTATAAA,0,865444
dgoRp,0.16666666666666666,5,5,GATCGGCGATATTTTGTCAT,0,843325
dgoRp,0.16666666666666666,5,5,GATCCATGAGTGCGATTTGG,0,852939
dgoRp,0.16666666666666666,5,5,GATATTCTGGATATTTTCTG,0,849422
dgoRp,0.16666666666666666,5,5,GATACCGTTATAAGCTGACT,0,863071
dgoRp,0.16666666666666666,5,5,GATAAATCCCGTTGGTCTAG,0,837851
dgoRp,0.16666666666666666,5,5,GAGTCCCTGTTGCGGCGCGC,0,846358
dgoRp,0.16666666666666666,5,5,GAGTCATTGCTACGAATGTC,0,861164
dgoRp,0.16666666666666666,5,5,GAGGTCGCGATGTTGACCCA,0,844799
dgoRp,0.16666666666666666,5,5,GAGGTAATTGGGCCTTGGAA,0,865474
dgoRp,0.16666666666666666,5,5,GAGGGGGACTGCCTATGCCT,0,836207
dgoRp,0.16666666666666666,5,5,GAGCTTTTGAAGTCAGGGCT,0,851210
dgoRp,0.16666666666666666,5,5,GACTAGGGAGTTAAAGGATG,0,856330
dgoRp,0.16666666666666666,5,5,GACGGGAATCTTGGGGCGCG,0,843812
dgoRp,0.16666666666666666,5,5,GACGCGACGTACTATAACTA,0,863237
dgoRp,0.16666666666666666,5,5,GACCTAGTATGAGGCAACAA,0,862988
dgoRp,0.16666666666666666,5,5,GACCAGACCTAACTTGAGAC,0,862395
dgoRp,0.16666666666666666,5,5,GAATTGTGGATGTCTCGGCT,0,851003
dgoRp,0.16666666666666666,5,5,GAATGCCATATCAATTCGTC,0,846670
dgoRp,0.16666666666666666,5,5,GAATGCAGTGCAACTGATTC,0,846672
dgoRp,0.16666666666666666,5,5,GAATATAGTATCTAAAGGCG,0,852652
dgoRp,0.16666666666666666,5,5,GAAGTGGTCGCACGCTTCCC,0,850589
dgoRp,0.16666666666666666,5,5,GAAGTACAAGGGGGACGAGA,0,838291
dgoRp,0.16666666666666666,5,5,GAACGCGGATCTCCTTAAAA,0,851385
dgoRp,0.16666666666666666,5,5,GAACAAATCACTACTCAAGG,0,854299
dgoRp,0.16666666666666666,5,5,CTTTCTGCATTCACTATTAA,0,849956
dgoRp,0.16666666666666666,5,5,CTTTACCAGGGTGCGACAGT,0,862275
dgoRp,0.16666666666666666,5,5,CTTGTTGAGGTGTGACCTAC,0,846649
dgoRp,0.16666666666666666,5,5,CTTGGGTCTGCAAGCAGGTG,0,844374
dgoRp,0.16666666666666666,5,5,CTTGCGTGAACCTTATTTCA,0,864973
dgoRp,0.16666666666666666,5,5,CTTGATCAACTATGTAACGT,0,855425
dgoRp,0.16666666666666666,5,5,CTTCAGCAGTCTCTAGCACA,0,862181
dgoRp,0.16666666666666666,5,5,CTTAGTTAAAAATCGCGCGC,0,851845
dgoRp,0.16666666666666666,5,5,CTTAGGTTACATCCAGACGG,0,842635
dgoRp,0.16666666666666666,5,5,CTGTCGAGAGCCGATTTGGA,0,860579
dgoRp,0.16666666666666666,5,5,CTGTAGAGGAGTTGTTCCCT,0,845939
dgoRp,0.16666666666666666,5,5,CTGCGAATCCGGTGCCCTAT,0,839464
dgoRp,0.16666666666666666,5,5,CTGATCCGGAATAAGAGGAA,0,837454
dgoRp,0.16666666666666666,5,5,CTGAGCGCTTTGGTGACGTT,0,861945
dgoRp,0.16666666666666666,5,5,CTGACCGCCGCTGTCCTGCA,0,844737
dgoRp,0.16666666666666666,5,5,CTGAAGCTACCACATGCTCT,0,848054
dgoRp,0.16666666666666666,5,5,CTCTGCCGCAAGTATTGTTT,0,837746
dgoRp,0.16666666666666666,5,5,CTCTGAGACTCGGAGGGCTG,0,856487
dgoRp,0.16666666666666666,5,5,CTCTCAAGCCGTCTGTATAT,0,842885
dgoRp,0.16666666666666666,5,5,CTCGCTGGCGGGGATCACCA,0,841104
dgoRp,0.16666666666666666,5,5,CTCGCGGATACCCACATTCG,0,838695
dgoRp,0.16666666666666666,5,5,CTCGAGCTCTAACAATGACC,0,839909
dgoRp,0.16666666666666666,5,5,CTCCTCGGGGGGGGCATCAA,0,866819
dgoRp,0.16666666666666666,5,5,CTCCGACAGAGAGACACTGT,0,839018
dgoRp,0.16666666666666666,5,5,CTCCCAGCCAGTCAGTGCGG,0,857603
dgoRp,0.16666666666666666,5,5,CTCCACCCTATTCACCATGA,0,848575
dgoRp,0.16666666666666666,5,5,CTCACCCGACAGCTGCCGGA,0,865295
dgoRp,0.16666666666666666,5,5,CTATGCGAGAGTTAAATTAT,0,861218
dgoRp,0.16666666666666666,5,5,CTATCAGTCACCTCTGAGTG,0,839573
dgoRp,0.16666666666666666,5,5,CTACGACAACAGTTATACTA,0,867096
dgoRp,0.16666666666666666,5,5,CTACCCTGGAAGTCTGCGTT,0,838984
dgoRp,0.16666666666666666,5,5,CTACACATGTTACGGTCTAC,0,839315
dgoRp,0.16666666666666666,5,5,CGTTTATATGGAGCTTAAAT,0,862997
dgoRp,0.16666666666666666,5,5,CGTTCCATCCAACCCGATTC,0,858742
dgoRp,0.16666666666666666,5,5,CGTGGCTTGATCGTGGCCGT,0,841815
dgoRp,0.16666666666666666,5,5,CGTGGCGGCTTCGCGGTAGT,0,853053
dgoRp,0.16666666666666666,5,5,CGTGGATGTCGCAGGCACAC,0,845730
dgoRp,0.16666666666666666,5,5,CGTCGAGGACTATTACCGAT,0,863592
dgoRp,0.16666666666666666,5,5,CGTATAGGGATTGCCTGGAT,0,840317
dgoRp,0.16666666666666666,5,5,CGGTCAGAACGGTTGGGCTG,0,836338
dgoRp,0.16666666666666666,5,5,CGGTAGGCCTCCCACAACTG,0,848280
dgoRp,0.16666666666666666,5,5,CGGGGGGTAATTCCTTAGAA,0,854411
dgoRp,0.16666666666666666,5,5,CGGGAGACGGTCCCTGGTAC,0,866284
dgoRp,0.16666666666666666,5,5,CGGCTATGGGATAGATCTGA,0,863228
dgoRp,0.16666666666666666,5,5,CGGCATCAACGTCATAAGCG,0,849492
dgoRp,0.16666666666666666,5,5,CGGCAGCGCTGCCCCCGAGT,0,856681
dgoRp,0.16666666666666666,5,5,CGGAGGGAGCCCTCTGATCC,0,864576
dgoRp,0.16666666666666666,5,5,CGGAGCCCACCGACCTTTGG,0,859411
dgoRp,0.16666666666666666,5,5,CGGAGAGCGATTCCTTATGT,0,848083
dgoRp,0.16666666666666666,5,5,CGCTGCTTTCTTTTACGCTG,0,860533
dgoRp,0.16666666666666666,5,5,CGCTCCTGTACTTAGCAGAA,0,852157
dgoRp,0.16666666666666666,5,5,CGCGCTATTATCAACCTGGT,0,863709
dgoRp,0.16666666666666666,5,5,CGCGAGAGGCCCGCGGTTAA,0,860832
dgoRp,0.16666666666666666,5,5,CGCGACGAGGCCAACGTCCC,0,845960
dgoRp,0.16666666666666666,5,5,CGCCGGATTGTACGTATCTA,0,850528
dgoRp,0.16666666666666666,5,5,CGCATAGGGTTCTTAGCTCC,0,862503
dgoRp,0.16666666666666666,5,5,CGCACGTGGTTCGCGCACCT,0,839210
dgoRp,0.16666666666666666,5,5,CGCACCAGCTCTGTCGTATA,0,863278
dgoRp,0.16666666666666666,5,5,CGATTCCGTGCTGGACTCAT,0,848568
dgoRp,0.16666666666666666,5,5,CGATCCACTCTAGTCTGTTC,0,858885
dgoRp,0.16666666666666666,5,5,CGAGGCCTTGGCACAGGAAC,0,840660
dgoRp,0.16666666666666666,5,5,CGAGGAGGTCTAAGTCTCAG,0,843091
dgoRp,0.16666666666666666,5,5,CGAGCGTGAATTTTAAGCAG,0,838230
dgoRp,0.16666666666666666,5,5,CGACTCCGCAATCACTAAAC,0,851662
dgoRp,0.16666666666666666,5,5,CGACAGTAAGCGTATCCCAA,0,852164
dgoRp,0.16666666666666666,5,5,CGAATTTCGAGGGAGGGACC,0,861508
dgoRp,0.16666666666666666,5,5,CGAACGAAACTTTGGCCGTG,0,853421
dgoRp,0.16666666666666666,5,5,CCTTTACGAGTGAGAGGACG,0,853172
dgoRp,0.16666666666666666,5,5,CCTTGCTTGATCTACAGGCA,0,855489
dgoRp,0.16666666666666666,5,5,CCTGTGAAACCTTTGTAGTT,0,846470
dgoRp,0.16666666666666666,5,5,CCTGGACGCTTGCGGACCTT,0,847495
dgoRp,0.16666666666666666,5,5,CCTGACGGCGTGTCGTTTTT,0,864083
dgoRp,0.16666666666666666,5,5,CCTCGGAGCGGGAGTGGATA,0,859791
dgoRp,0.16666666666666666,5,5,CCTCAAGCGGATATATTTTA,0,840423
dgoRp,0.16666666666666666,5,5,CCTAGTCGCGTTGTCCTTGA,0,858009
dgoRp,0.16666666666666666,5,5,CCTAGCCTGGCTGTGCAATC,0,847263
dgoRp,0.16666666666666666,5,5,CCTACTCTTAGCTGTACTTA,0,856281
dgoRp,0.16666666666666666,5,5,CCGTGTCAAGCTAGGACCCA,0,847342
dgoRp,0.16666666666666666,5,5,CCGGTTCCTCGACAATCGAC,0,862917
dgoRp,0.16666666666666666,5,5,CCGGTCGCTCTTCTCCTGGT,0,841365
dgoRp,0.16666666666666666,5,5,CCGGTAAGAAATGCTCCTAT,0,861846
dgoRp,0.16666666666666666,5,5,CCGGGGTACGTCCTAGACTC,0,838477
dgoRp,0.16666666666666666,5,5,CCGGCACATACTCTCGCCGA,0,843559
dgoRp,0.16666666666666666,5,5,CCGCGGATAGCCGCCGGTAG,0,853322
dgoRp,0.16666666666666666,5,5,CCGAAGGGCATCTAGTGAAG,0,847606
dgoRp,0.16666666666666666,5,5,CCCTTGCACAACAAAGGGGG,0,842690
dgoRp,0.16666666666666666,5,5,CCCTCTGATGCGTAGTCGCA,0,837554
dgoRp,0.16666666666666666,5,5,CCCGGAGGGACAACCCGAGT,0,860853
dgoRp,0.16666666666666666,5,5,CCCCTCGACATAAGGAGGGA,0,852065
dgoRp,0.16666666666666666,5,5,CCCCAGGGCGAGTTAGCAAC,0,861145
dgoRp,0.16666666666666666,5,5,CCCACGTGCTAAATTTTTTC,0,863139
dgoRp,0.16666666666666666,5,5,CCATTTTCGGGTATGCACTA,0,857327
dgoRp,0.16666666666666666,5,5,CCAGGTCCCGGTAACAAAAC,0,844514
dgoRp,0.16666666666666666,5,5,CCAGGCGCTCGAATGTCATT,0,844070
dgoRp,0.16666666666666666,5,5,CCAGGATCGGGCCGAGCTAG,0,846855
dgoRp,0.16666666666666666,5,5,CCAGGAAGACGCGCGTAGCT,0,860726
dgoRp,0.16666666666666666,5,5,CCAGCCTCCTCAGCTGAAAA,0,866198
dgoRp,0.16666666666666666,5,5,CCAGCACGGTGTGATTCGTA,0,863930
dgoRp,0.16666666666666666,5,5,CCACTGGCGAGTAAATTCTT,0,857284
dgoRp,0.16666666666666666,5,5,CCAATCTGTCCCCCGACCCA,0,847929
dgoRp,0.16666666666666666,5,5,CCAAGGCGTTACTACTTCTT,0,863952
dgoRp,0.16666666666666666,5,5,CCAACGGCCTCGTCATCATA,0,842587
dgoRp,0.16666666666666666,5,5,CATTGTTGGTTATACGTCGG,0,837029
dgoRp,0.16666666666666666,5,5,CATTCTCTGGTGGGGCACGT,0,841676
dgoRp,0.16666666666666666,5,5,CATTAGAGCAAGCAACGAGC,0,857171
dgoRp,0.16666666666666666,5,5,CATGCTGACCAGATTTTCAA,0,857390
dgoRp,0.16666666666666666,5,5,CATCGCACCTTCCCTGGGAC,0,858589
dgoRp,0.16666666666666666,5,5,CATCGATCAACTTCCAACGA,0,856864
dgoRp,0.16666666666666666,5,5,CAGTGGGGTAATCTGCCTCA,0,864755
dgoRp,0.16666666666666666,5,5,CAGTACTAAACGCTTAGAAT,0,847062
dgoRp,0.16666666666666666,5,5,CAGGTGCAGTATAGTGTCGT,0,866952
dgoRp,0.16666666666666666,5,5,CAGGTAGCAATGTGTGATAA,0,840217
dgoRp,0.16666666666666666,5,5,CAGGATGTTCCCTTTAATCG,0,863903
dgoRp,0.16666666666666666,5,5,CAGGAGGAGCTGTGCTAAGT,0,861600
dgoRp,0.16666666666666666,5,5,CAGGACGTTCATACGATATG,0,843477
dgoRp,0.16666666666666666,5,5,CAGCTTGTAGAAGAGGAGCC,0,846283
dgoRp,0.16666666666666666,5,5,CAGCTCTCTGAATGCCGCTA,0,856018
dgoRp,0.16666666666666666,5,5,CAGCTACGCTTAGTTGATCC,0,840249
dgoRp,0.16666666666666666,5,5,CAGCGGGGCCTGACGATTCA,0,861791
dgoRp,0.16666666666666666,5,5,CAGCGCCTTTTCTCCCGGGA,0,836009
dgoRp,0.16666666666666666,5,5,CAGCAGCTGTCAAACCTGCC,0,854524
dgoRp,0.16666666666666666,5,5,CAGCACCAGCCACAGTTTAT,0,842524
dgoRp,0.16666666666666666,5,5,CAGATTCTTTAGTCGGAGTG,0,838299
dgoRp,0.16666666666666666,5,5,CAGATCAGATCTCTCAATAC,0,859979
dgoRp,0.16666666666666666,5,5,CAGAGGAAGTAAGGTCGCGG,0,858711
dgoRp,0.16666666666666666,5,5,CACTTTGAAACGTACTCTCT,0,843112
dgoRp,0.16666666666666666,5,5,CACTCGAGGGAAAATCCGAT,0,839055
dgoRp,0.16666666666666666,5,5,CACGCTGACGTGCTGCTTGA,0,841107
dgoRp,0.16666666666666666,5,5,CACGAGTCAATCGACCAAAT,0,853986
dgoRp,0.16666666666666666,5,5,CACCTTCACCTGTCTTGCAA,0,866715
dgoRp,0.16666666666666666,5,5,CACCATGTACTTGACGCAAG,0,848564
dgoRp,0.16666666666666666,5,5,CACACTACCGCTACTGCAAC,0,840409
dgoRp,0.16666666666666666,5,5,CACACCTTCATCTTGGGAAT,0,863948
dgoRp,0.16666666666666666,5,5,CACACATGGATGAAACATAA,0,860974
dgoRp,0.16666666666666666,5,5,CACACAGTGATCTACCGCAG,0,842962
dgoRp,0.16666666666666666,5,5,CACACAAAATTTTCTCGGTC,0,847885
dgoRp,0.16666666666666666,5,5,CAATGGAAGTCGCTTCCCAC,0,836099
dgoRp,0.16666666666666666,5,5,CAATCCTGAAGGGCTCCGGT,0,836548
dgoRp,0.16666666666666666,5,5,CAATAAAGCCGAGGGACCAA,0,867178
dgoRp,0.16666666666666666,5,5,CAAGCCGTTAGTTGAAGGAG,0,861843
dgoRp,0.16666666666666666,5,5,CAAGCATGTAAGTAACTGCG,0,841905
dgoRp,0.16666666666666666,5,5,CAAGAATAAAGAACAAAGGA,0,867342
dgoRp,0.16666666666666666,5,5,CAACGGTCGGAAATGGTGCA,0,857105
dgoRp,0.16666666666666666,5,5,CAACGGTACAGTTGCTTCAA,0,844334
dgoRp,0.16666666666666666,5,5,CAAACATTTTTACTGGCGAC,0,852037
dgoRp,0.16666666666666666,5,5,ATTTTGTATTGATTAGAAAT,0,848765
dgoRp,0.16666666666666666,5,5,ATTTGGTTTCGAGGGCAAAG,0,835900
dgoRp,0.16666666666666666,5,5,ATTGTGCTTTCAGGGTTTCG,0,848475
dgoRp,0.16666666666666666,5,5,ATTGGAAGCCAACATGTAGG,0,854253
dgoRp,0.16666666666666666,5,5,ATTCGTGGATCTTGCGTGAT,0,860664
dgoRp,0.16666666666666666,5,5,ATTCGCCCCCTGCCATCAAT,0,862125
dgoRp,0.16666666666666666,5,5,ATTCCATAAAATAACAGAGA,0,843372
dgoRp,0.16666666666666666,5,5,ATTCATTGTACAATGGTCTC,0,851064
dgoRp,0.16666666666666666,5,5,ATTCATGCAAGTAACCTGTG,0,845581
dgoRp,0.16666666666666666,5,5,ATTAGAGAAGCCATGGTTCC,0,862049
dgoRp,0.16666666666666666,5,5,ATGTTTTGGTAACAGATAAC,0,849260
dgoRp,0.16666666666666666,5,5,ATGTTCTATATAGAAAACTA,0,848845
dgoRp,0.16666666666666666,5,5,ATGGGCCTGGGTCTGCCCCC,0,843907
dgoRp,0.16666666666666666,5,5,ATGGGCACATTGAATGGCAG,0,845457
dgoRp,0.16666666666666666,5,5,ATGGCCTTCGTAAAATAATC,0,865550
dgoRp,0.16666666666666666,5,5,ATGCTAATCTACACGATGAC,0,853544
dgoRp,0.16666666666666666,5,5,ATGACGCGAGCCCATACGTA,0,855303
dgoRp,0.16666666666666666,5,5,ATGAAGTAGACAAGTTGCCA,0,843981
dgoRp,0.16666666666666666,5,5,ATCTGCGTAAAGACTGCAAG,0,846044
dgoRp,0.16666666666666666,5,5,ATCTCCCGCACATGGGGCTG,0,840863
dgoRp,0.16666666666666666,5,5,ATCTCACACGGCGCCGTAGT,0,847317
dgoRp,0.16666666666666666,5,5,ATCGCAAATACGCGCTGTAC,0,866921
dgoRp,0.16666666666666666,5,5,ATCCGAAGGCGTTACATCTG,0,852679
dgoRp,0.16666666666666666,5,5,ATATTGTAGTGTCACTCGTG,0,850580
dgoRp,0.16666666666666666,5,5,ATATTGACAGGGCATCTATG,0,837768
dgoRp,0.16666666666666666,5,5,ATATTAGGTTTGACCATCAA,0,853982
dgoRp,0.16666666666666666,5,5,ATATTAACGTCGTGAGTATG,0,845504
dgoRp,0.16666666666666666,5,5,ATATGTGCCTGCCGCGCACC,0,854162
dgoRp,0.16666666666666666,5,5,ATAGGATCGCTTTGCGGGTA,0,844816
dgoRp,0.16666666666666666,5,5,ATAGCGTTGCCGAAAGAAGT,0,845693
dgoRp,0.16666666666666666,5,5,ATAGCCATGACGCATTTAGA,0,865094
dgoRp,0.16666666666666666,5,5,ATACAGTGAGCGCAGAAAGA,0,852651
dgoRp,0.16666666666666666,5,5,ATACAAAAGTGACAATCTTG,0,851997
dgoRp,0.16666666666666666,5,5,ATAATTGGTGAACATAGTCT,0,844309
dgoRp,0.16666666666666666,5,5,ATAATCCGAGTCACAAAGCT,0,859841
dgoRp,0.16666666666666666,5,5,ATAACTTATCTGTTAAATTC,0,854615
dgoRp,0.16666666666666666,5,5,ATAAATCTCGAAATCTTCAC,0,863998
dgoRp,0.16666666666666666,5,5,ATAAACAGCCATCCGCTGCA,0,843464
dgoRp,0.16666666666666666,5,5,AGTGTTACAACTGACGGCTT,0,842613
dgoRp,0.16666666666666666,5,5,AGTGTGTCGGGACCATATGA,0,853720
dgoRp,0.16666666666666666,5,5,AGTGGGAATGCATTAACTTC,0,864099
dgoRp,0.16666666666666666,5,5,AGTGCCGCTCCGCCAAGGGA,0,846085
dgoRp,0.16666666666666666,5,5,AGTCCCAAAGTTATTTGGAT,0,839918
dgoRp,0.16666666666666666,5,5,AGTCACACACCCTCCGGCAG,0,853335
dgoRp,0.16666666666666666,5,5,AGGTCTTGCTGCTTTAGTGC,0,838693
dgoRp,0.16666666666666666,5,5,AGGGTTGTCAGGTGGGTAGC,0,860462
dgoRp,0.16666666666666666,5,5,AGGGTGCAACTGCGCATAAG,0,847585
dgoRp,0.16666666666666666,5,5,AGGGTATCTCCGTTCTCAGG,0,850892
dgoRp,0.16666666666666666,5,5,AGGGGTAACTTTAGTTCCCT,0,856716
dgoRp,0.16666666666666666,5,5,AGGGGACTAGCCAGTTAAGT,0,837014
dgoRp,0.16666666666666666,5,5,AGGGCTAATACAGCCAATGG,0,845876
dgoRp,0.16666666666666666,5,5,AGGCACGGGCATATCTCTTT,0,866553
dgoRp,0.16666666666666666,5,5,AGGATTGGCGTTGTTTGGTT,0,864638
dgoRp,0.16666666666666666,5,5,AGGAGTAATGTAAACAGAAA,0,848837
dgoRp,0.16666666666666666,5,5,AGGAGCATCAAAAATCATAA,0,851263
dgoRp,0.16666666666666666,5,5,AGCTCAATCACGCATAGGTA,0,847745
dgoRp,0.16666666666666666,5,5,AGCTAACTTGCGTTTGGGGG,0,857111
dgoRp,0.16666666666666666,5,5,AGCCTCCGTCGTTGAAGATT,0,847257
dgoRp,0.16666666666666666,5,5,AGCCCTTACAAGGCGATGGT,0,856639
dgoRp,0.16666666666666666,5,5,AGCATTTTGTCACGCGACCT,0,865374
dgoRp,0.16666666666666666,5,5,AGCATGTAATTCCAACCTCG,0,866585
dgoRp,0.16666666666666666,5,5,AGCAGTCATCTTAATTTGTT,0,863902
dgoRp,0.16666666666666666,5,5,AGCACGGGAGATCGATATCA,0,854464
dgoRp,0.16666666666666666,5,5,AGATGCGGAAAAGTCACTCG,0,835892
dgoRp,0.16666666666666666,5,5,AGAGTGATTCCGAATGTATT,0,866759
dgoRp,0.16666666666666666,5,5,AGAGCCATCTCCAAGTTAAA,0,852473
dgoRp,0.16666666666666666,5,5,AGACAACAAATGCGTTGTCA,0,856549
dgoRp,0.16666666666666666,5,5,AGAACTTAATTCGTGAGTTT,0,862107
dgoRp,0.16666666666666666,5,5,AGAAACGAGTCCTCCTGCAG,0,856683
dgoRp,0.16666666666666666,5,5,ACTTTCCCAAGAACGGCACA,0,859360
dgoRp,0.16666666666666666,5,5,ACTTCGCTGAGAGAACCTGT,0,839204
dgoRp,0.16666666666666666,5,5,ACTGAACTGAGAGTCATAAG,0,854067
dgoRp,0.16666666666666666,5,5,ACTAGGTGGCGTGGGGCCCT,0,853211
dgoRp,0.16666666666666666,5,5,ACTAGATTAACATCGCCAGC,0,861432
dgoRp,0.16666666666666666,5,5,ACTAGATCACCATATCCTGA,0,845576
dgoRp,0.16666666666666666,5,5,ACGGTATTACCGGACAGTTG,0,860701
dgoRp,0.16666666666666666,5,5,ACGGGTAACGGTCCACAGAT,0,836648
dgoRp,0.16666666666666666,5,5,ACGGAATTGGGGCTGAGTAG,0,854523
dgoRp,0.16666666666666666,5,5,ACGAGCGCGTAGCGGACTAG,0,839085
dgoRp,0.16666666666666666,5,5,ACGACTCTTGAGCCTTCCTT,0,853541
dgoRp,0.16666666666666666,5,5,ACCTTATTGATTTTTTACCC,0,851878
dgoRp,0.16666666666666666,5,5,ACCCTTGGTCGCTCTCGGGG,0,840800
dgoRp,0.16666666666666666,5,5,ACCCGAGGACTTCCAATAGG,0,852503
dgoRp,0.16666666666666666,5,5,ACCCCAGACAGACTCGGCCC,0,863774
dgoRp,0.16666666666666666,5,5,ACCACCGGTCAACTTGCTCC,0,865917
dgoRp,0.16666666666666666,5,5,ACCAAGAGTGTGGCCATCTG,0,852135
dgoRp,0.16666666666666666,5,5,ACATTCCGCGGCCTGATGGA,0,843538
dgoRp,0.16666666666666666,5,5,ACATACTGTCGATACCCGAC,0,861411
dgoRp,0.16666666666666666,5,5,ACAGTTACCCCTGACTGGTA,0,836156
dgoRp,0.16666666666666666,5,5,ACAGGGGGTCCAAAGGTCCC,0,837115
dgoRp,0.16666666666666666,5,5,ACAGAGCTAAATAAGTCGGC,0,846290
dgoRp,0.16666666666666666,5,5,ACAGACACCTCAGGGCGTTC,0,846810
dgoRp,0.16666666666666666,5,5,ACACCCAAATCTGGGCCATA,0,845030
dgoRp,0.16666666666666666,5,5,ACAAAGACCTTGCGTCAAGC,0,840087
dgoRp,0.16666666666666666,5,5,AATTAATTTTGCCGCAATAT,0,849706
dgoRp,0.16666666666666666,5,5,AATGTCGTGGTCGCAAAGCC,0,847258
dgoRp,0.16666666666666666,5,5,AATGGGCGATTTTAATGAGC,0,839250
dgoRp,0.16666666666666666,5,5,AATCTCGTTACGTTGTCGAT,0,861334
dgoRp,0.16666666666666666,5,5,AATATTTTAGGCCAAATTGT,0,858805
dgoRp,0.16666666666666666,5,5,AATATTATGTGAAGGCGTTA,0,851079
dgoRp,0.16666666666666666,5,5,AATATACACTTACCAATGGC,0,840137
dgoRp,0.16666666666666666,5,5,AATACTACGCGCTATTGGAT,0,856863
dgoRp,0.16666666666666666,5,5,AATACAGATGTGGTGAGCCT,0,841752
dgoRp,0.16666666666666666,5,5,AAGTTGCACCAGCTAAGGGG,0,865527
dgoRp,0.16666666666666666,5,5,AAGTCATCCTCTCGGATCAA,0,861974
dgoRp,0.16666666666666666,5,5,AAGTAATCAAATAGGCCGCG,0,858591
dgoRp,0.16666666666666666,5,5,AAGGTTGACTCTTCGTGAAC,0,866515
dgoRp,0.16666666666666666,5,5,AAGGCTCTAGTCCCTTGGAG,0,859957
dgoRp,0.16666666666666666,5,5,AAGATGACCGAGCAACATTC,0,841295
dgoRp,0.16666666666666666,5,5,AAGAACTACCGCATGCGTGT,0,841518
dgoRp,0.16666666666666666,5,5,AACTAACGAAGGGGCATTCA,0,839728
dgoRp,0.16666666666666666,5,5,AACGACTGCAAAAAGTACGA,0,836075
dgoRp,0.16666666666666666,5,5,AACCTATAGATAGCATGGAC,0,845289
dgoRp,0.16666666666666666,5,5,AACAGCATCAGGGGGGAACG,0,855020
dgoRp,0.16666666666666666,5,5,AACACTGTAGCGTGCATAAC,0,841297
dgoRp,0.16666666666666666,5,5,AACACGGACAAAATGCGGAA,0,844333
dgoRp,0.16666666666666666,5,5,AAATTGTTTTTACCACCGGA,0,857591
dgoRp,0.16666666666666666,5,5,AAATCATTTAGATGAGGCGG,0,857414
dgoRp,0.16666666666666666,5,5,AAAGGTGTCATCGTAACCTA,0,864921
dgoRp,0.16666666666666666,5,5,AAAGATTGCACCATAACTAC,0,856394
dgoRp,0.16666666666666666,5,5,AAAACACGCTGATTCGCAAA,0,839059
dgoRp,0.2,4,4,TTTTGTAGGCTCAACTCCGA,0,839838
dgoRp,0.2,4,4,TTTTGGTCATGGGGCCACCA,0,859417
dgoRp,0.2,4,4,TTTTACGTTCCGGAAGTCGT,0,866206
dgoRp,0.2,4,4,TTTGTTGGTGACGCAGGTAT,0,865970
dgoRp,0.2,4,4,TTTCGTGTGCCGGGTTCTGG,0,845589
dgoRp,0.2,4,4,TTTCGCGCCAGTATTCACTT,0,856764
dgoRp,0.2,4,4,TTTCCTGTGACAGACACGAA,0,848653
dgoRp,0.2,4,4,TTTCACGCCGACTTGGTTAT,0,847320
dgoRp,0.2,4,4,TTTATAGCCAATGGACGAAG,0,842264
dgoRp,0.2,4,4,TTTAGCGCGCTTGGGTATTG,0,846541
dgoRp,0.2,4,4,TTGTGTTAGACTCACGTCTA,0,850134
dgoRp,0.2,4,4,TTGTCGTTCCTAGATTTGAT,0,845659
dgoRp,0.2,4,4,TTGTCCTAGACATTTTGGAT,0,850853
dgoRp,0.2,4,4,TTGTATAGTTTCTAAACGAT,0,859233
dgoRp,0.2,4,4,TTGTACGGGCTCACTTTGAC,0,859315
dgoRp,0.2,4,4,TTGGGCGAAGGTCTATAGGG,0,846147
dgoRp,0.2,4,4,TTGCTAAAGGTGAGCGTTTG,0,863575
dgoRp,0.2,4,4,TTGCCTGGCTGGTTTATGTA,0,843488
dgoRp,0.2,4,4,TTGATATTATTGTGTCATGA,0,858737
dgoRp,0.2,4,4,TTCTCTCTAACTGTCCACCT,0,853978
dgoRp,0.2,4,4,TTCTAGTTGGAGCAGAACAT,0,842900
dgoRp,0.2,4,4,TTCGGATTTCTCACAACCTG,0,856261
dgoRp,0.2,4,4,TTCGGAGGCTCGTTTAGACC,0,867317
dgoRp,0.2,4,4,TTCGACTCCCCTCACCCTCG,0,837205
dgoRp,0.2,4,4,TTCCTTCGGGCTTTCAAATG,0,852285
dgoRp,0.2,4,4,TTCCACGCGGATGGGTAAGT,0,851590
dgoRp,0.2,4,4,TTCCAAAATCTATGCAACTG,0,844129
dgoRp,0.2,4,4,TTCAAGCCCGCGAGCGTCCA,0,842916
dgoRp,0.2,4,4,TTATGGTACGTCGGTTCGAG,0,864868
dgoRp,0.2,4,4,TTAGTTAAGTGTCCACGCAA,0,837206
dgoRp,0.2,4,4,TTAGTAGGTAAGATCAATCT,0,861283
dgoRp,0.2,4,4,TTAGGGTGCTCTTCCCATCA,0,858321
dgoRp,0.2,4,4,TTAGGGCGTTAAAAGCGATG,0,862468
dgoRp,0.2,4,4,TTAGGCGCCAGGGGGTTCGG,0,848010
dgoRp,0.2,4,4,TTAGCACGAGAGGCACCCCT,0,851423
dgoRp,0.2,4,4,TTACTATGGGACGAACAATA,0,836231
dgoRp,0.2,4,4,TTACCACTCTGGTGCCGTAG,0,865323
dgoRp,0.2,4,4,TTAATTATCGACGTAGTATC,0,851971
dgoRp,0.2,4,4,TTAAGACGCACCTTCTGAGG,0,861303
dgoRp,0.2,4,4,TTAAAATGTTTATCGTTCGA,0,842086
dgoRp,0.2,4,4,TGTTTTCTTGGACTTCTTGA,0,865256
dgoRp,0.2,4,4,TGTTTTCGAACGCGTATTGG,0,835941
dgoRp,0.2,4,4,TGTTGGGGGAGGAGCTCTTC,0,843002
dgoRp,0.2,4,4,TGTTACGCCAAAAGGCTGAA,0,843857
dgoRp,0.2,4,4,TGTGTTGCAACTACTACCTA,0,858702
dgoRp,0.2,4,4,TGTGTGTCTTGAGGTCGTTT,0,837457
dgoRp,0.2,4,4,TGTGGCGCAGGCCTTCTGAT,0,864548
dgoRp,0.2,4,4,TGTGCACTCCGTGATACGGG,0,843845
dgoRp,0.2,4,4,TGTGACGTGGGGGCTGCAGC,0,860619
dgoRp,0.2,4,4,TGTCATGGGTAGTGATGGCA,0,851573
dgoRp,0.2,4,4,TGTATGGGGGCAGACTTGTG,0,863264
dgoRp,0.2,4,4,TGTAGGACGGGATAATTGGG,0,865764
dgoRp,0.2,4,4,TGTAATTGGGCGGCTTGCCG,0,853816
dgoRp,0.2,4,4,TGGTTATCTACTTGGCCCAT,0,837628
dgoRp,0.2,4,4,TGGTTAGCTGGTCACGGATA,0,864020
dgoRp,0.2,4,4,TGGTCCTCGTGGCAATCTTC,0,842034
dgoRp,0.2,4,4,TGGTCATGGCGTACCCCAAC,0,846767
dgoRp,0.2,4,4,TGGTATCTCTTGCGACGGCT,0,843586
dgoRp,0.2,4,4,TGGGGATCACCGAGAGAAGT,0,836887
dgoRp,0.2,4,4,TGGCGGTTGTCAGACATTCA,0,836718
dgoRp,0.2,4,4,TGGCGGGCAGGTCTCTCGTC,0,837954
dgoRp,0.2,4,4,TGGAATATTCTGGGCAATGT,0,841820
dgoRp,0.2,4,4,TGCTAACGCCTGAAGTGAGG,0,839311
dgoRp,0.2,4,4,TGCGTGATATGGGATGCAAC,0,861272
dgoRp,0.2,4,4,TGCGTCATGCGCAATGTAGG,0,842449
dgoRp,0.2,4,4,TGCGATCGCCAAAGACTCGG,0,839137
dgoRp,0.2,4,4,TGCGAGCCCGATTTTTACCG,0,846714
dgoRp,0.2,4,4,TGCGACCGGGATACCATGGG,0,856687
dgoRp,0.2,4,4,TGCCTCAATTCAATTTCCGG,0,845092
dgoRp,0.2,4,4,TGCCTACCCGAGTAATTGGC,0,846238
dgoRp,0.2,4,4,TGCCGCTCGCGATTTATCTT,0,837564
dgoRp,0.2,4,4,TGCCCGGAGGGATTGCGCTT,0,853543
dgoRp,0.2,4,4,TGCCAGTGATTATTTATAAT,0,849155
dgoRp,0.2,4,4,TGCATTTTTTTGTGAATAAT,0,858942
dgoRp,0.2,4,4,TGATGCATAGTTGGGCTACT,0,846140
dgoRp,0.2,4,4,TGATGAGGATGGTCATACAT,0,852100
dgoRp,0.2,4,4,TGATATTGACCTTTGCGGCA,0,839241
dgoRp,0.2,4,4,TGACGTCGGCAGCACAAGTT,0,859419
dgoRp,0.2,4,4,TGACCAGCGCGAAGCAAATT,0,853847
dgoRp,0.2,4,4,TGAATATCGGGGGTGAGAGA,0,867388
dgoRp,0.2,4,4,TGAAACCTTCCAGCTTGATG,0,857076
dgoRp,0.2,4,4,TCTTGAATACTGATCGATCT,0,843712
dgoRp,0.2,4,4,TCTGTATAGTGCATTTGACT,0,846935
dgoRp,0.2,4,4,TCTGATTACTCAAGGAAGGA,0,844287
dgoRp,0.2,4,4,TCTGAAGGCTTCTTAACTGA,0,839220
dgoRp,0.2,4,4,TCTGAACAATGCGGCGCGAG,0,843088
dgoRp,0.2,4,4,TCTCGCATAACGTTCCAGTT,0,839439
dgoRp,0.2,4,4,TCTCACAGGACATGCGGCGG,0,838262
dgoRp,0.2,4,4,TCTATCGTCAGGAGCTGTGC,0,855075
dgoRp,0.2,4,4,TCTAGTATCTTATAGAGATT,0,841642
dgoRp,0.2,4,4,TCTACGTCATTAGTTGACTG,0,842341
dgoRp,0.2,4,4,TCGTGTGACGGGCGAATACA,0,857458
dgoRp,0.2,4,4,TCGTAACCATGCGCTTTTAC,0,850822
dgoRp,0.2,4,4,TCGGTGAATCAGCGGGCCAA,0,836900
dgoRp,0.2,4,4,TCGCCTAGGAACCCAGCTGT,0,861326
dgoRp,0.2,4,4,TCGCAGGCGCGAGACTACTT,0,838840
dgoRp,0.2,4,4,TCGATCCGCCTGTTACTTCC,0,845569
dgoRp,0.2,4,4,TCGAATGTCCTGGCGAGCGA,0,859831
dgoRp,0.2,4,4,TCCTGCTGGTTGGTCTGATG,0,842874
dgoRp,0.2,4,4,TCCTCTTTTGCTTAGGCCGC,0,850619
dgoRp,0.2,4,4,TCCTACGACCCAGTACCAAT,0,856136
dgoRp,0.2,4,4,TCCGGAGTAAATGGTGGCCG,0,844318
dgoRp,0.2,4,4,TCCGCCTCAGCTTGGGGGTC,0,853552
dgoRp,0.2,4,4,TCCCGTGATTCTGGAATCTA,0,863146
dgoRp,0.2,4,4,TCCCGGTTCGCTCGCTCCGA,0,851195
dgoRp,0.2,4,4,TCCCGGTGGCGAGAAGCACT,0,844630
dgoRp,0.2,4,4,TCCCGCTCTGCACTCGGATG,0,856141
dgoRp,0.2,4,4,TCCCGCGCTCGGAAGATTCC,0,839551
dgoRp,0.2,4,4,TCCCATGAAGATCCGCGGTC,0,866066
dgoRp,0.2,4,4,TCCACCTCGCGTTGCCACTG,0,843377
dgoRp,0.2,4,4,TCATTTTCTTTAAAATATTA,0,860949
dgoRp,0.2,4,4,TCATTAGGCTGAAGCTCCAT,0,864575
dgoRp,0.2,4,4,TCAGTTTCCTTATCCCAAAC,0,841805
dgoRp,0.2,4,4,TCAGTTGGTAAGATGAAGCT,0,850598
dgoRp,0.2,4,4,TCACTATCGGCGGGTTCCTT,0,843094
dgoRp,0.2,4,4,TCACACAGAGATGGTACCGA,0,859919
dgoRp,0.2,4,4,TCAATTCGGGAGCAAGCGTT,0,840024
dgoRp,0.2,4,4,TCAACACACGCGTGGTCGTC,0,853004
dgoRp,0.2,4,4,TCAAAACCATAACGGCAAAC,0,848252
dgoRp,0.2,4,4,TATTTTTTATAGTTTCGTTT,0,839718
dgoRp,0.2,4,4,TATTGATCTATCGGACTAAT,0,850749
dgoRp,0.2,4,4,TATGCAAAATCGATACGGTC,0,844352
dgoRp,0.2,4,4,TATGAAAGATCCACTGGCGA,0,860321
dgoRp,0.2,4,4,TATATCGTATAGGGTGGCCC,0,838928
dgoRp,0.2,4,4,TAGGCCGGCCGTCGTGACGC,0,851312
dgoRp,0.2,4,4,TAGCCTCGTGGGGATATCCT,0,839945
dgoRp,0.2,4,4,TAGCAAGGCTCTTTAGGGAA,0,859558
dgoRp,0.2,4,4,TAGATACCCTTAACTTAGCT,0,849565
dgoRp,0.2,4,4,TAGACGTTGAAGGCGAGAAT,0,865657
dgoRp,0.2,4,4,TAGAAGCATGTGGTCCGCCC,0,847331
dgoRp,0.2,4,4,TACTCGATTAGCATAAGAAG,0,865664
dgoRp,0.2,4,4,TACTCGACCGATACCAGCAT,0,864594
dgoRp,0.2,4,4,TACGTTGGAACGGTAGCCCA,0,867110
dgoRp,0.2,4,4,TACGTTGCCTGCTCAATGCT,0,854014
dgoRp,0.2,4,4,TACGTCGTCTCCGGCAATTT,0,839817
dgoRp,0.2,4,4,TACGGTATTTATCTCTCGTG,0,861920
dgoRp,0.2,4,4,TACGGCTCATGTCCCTCTCC,0,854460
dgoRp,0.2,4,4,TACGCGACAGTCAGACGAAG,0,864405
dgoRp,0.2,4,4,TACGCCCATGTATGACAATC,0,861346
dgoRp,0.2,4,4,TACCTTAGGGTAATAGGAGG,0,844449
dgoRp,0.2,4,4,TACCGTTCACCGCGACGCAC,0,849649
dgoRp,0.2,4,4,TACCGCCCTGTTACCCACTG,0,862224
dgoRp,0.2,4,4,TACCCGAGTAGCTTGTGTAA,0,836759
dgoRp,0.2,4,4,TACAAAGCCGGCCGGGAAGC,0,847665
dgoRp,0.2,4,4,TAATTGTGGTCGCGGCATAT,0,854831
dgoRp,0.2,4,4,TAATGACTCATAGCTAGCAA,0,848583
dgoRp,0.2,4,4,TAATATCTAGCCCAGCTAGG,0,848527
dgoRp,0.2,4,4,TAAGTGAATAGGATTACTTA,0,864266
dgoRp,0.2,4,4,TAAGGGGATTAATTTTTATA,0,857918
dgoRp,0.2,4,4,TAAGGGATCACCAGGCACGC,0,854255
dgoRp,0.2,4,4,TAAGCGTATAGTGGGCGTCC,0,863812
dgoRp,0.2,4,4,TAAGATCAACTCGTCCATTT,0,863153
dgoRp,0.2,4,4,TAAGATATCTCTCTGTATAC,0,857393
dgoRp,0.2,4,4,TAACTATTTTCAACAAGGCG,0,839371
dgoRp,0.2,4,4,TAACGTGGCGGCGAACAGAT,0,859435
dgoRp,0.2,4,4,TAACCCGGCCCAAGACCAAC,0,839127
dgoRp,0.2,4,4,TAACAGCAAGCCTCCACCGT,0,845368
dgoRp,0.2,4,4,TAAATTGCATATATGAATAG,0,836817
dgoRp,0.2,4,4,TAAAGTGTGAGGAATCTATA,0,864865
dgoRp,0.2,4,4,GTTTTACAATGACGGTGTGT,0,841341
dgoRp,0.2,4,4,GTTTGCCACTTGTATTTACG,0,857563
dgoRp,0.2,4,4,GTTGTGGTTCCTCATGGTGG,0,846975
dgoRp,0.2,4,4,GTTCTGGAACCTTGGTAGGT,0,853126
dgoRp,0.2,4,4,GTGTGTAAGGAGTGTTTCCT,0,860348
dgoRp,0.2,4,4,GTGTGAAGTGCGACGCCAGA,0,840661
dgoRp,0.2,4,4,GTGGGACAGCCACACGCAGA,0,848757
dgoRp,0.2,4,4,GTGGAGGATTATCCTCGGCC,0,849981
dgoRp,0.2,4,4,GTGGACGGTAGAACGAGACT,0,861722
dgoRp,0.2,4,4,GTGCTCAGATAGACTATGGC,0,853806
dgoRp,0.2,4,4,GTGCCCACGTAAAGGCGCGT,0,851488
dgoRp,0.2,4,4,GTGCCATATATCGAACGGGG,0,853794
dgoRp,0.2,4,4,GTCTGGGAGGGTTGTAACCC,0,843054
dgoRp,0.2,4,4,GTCTCTGTGCATTTGAGTGA,0,839783
dgoRp,0.2,4,4,GTCTATATAGTATACACGGG,0,852049
dgoRp,0.2,4,4,GTCTACTGAAATAGGATCAA,0,844012
dgoRp,0.2,4,4,GTCGCTTAGCTCAAACGTTA,0,836279
dgoRp,0.2,4,4,GTCGAGTTAATCTATTCCAT,0,858187
dgoRp,0.2,4,4,GTCGAGCTAAAGGGTAATAT,0,846859
dgoRp,0.2,4,4,GTCGAAAATTCAGGCCCATG,0,862563
dgoRp,0.2,4,4,GTCCTCCGTTATGCGAAGAG,0,859653
dgoRp,0.2,4,4,GTCCTATTAGCCGTGTCCAA,0,847913
dgoRp,0.2,4,4,GTCATGCGGCCGAGTTAGCA,0,844566
dgoRp,0.2,4,4,GTCACCCCCTTTGCCTCGAG,0,864742
dgoRp,0.2,4,4,GTCAATTACTGCACCCGGCG,0,836571
dgoRp,0.2,4,4,GTCAATCTGCGAAAAGGCGA,0,854220
dgoRp,0.2,4,4,GTATGGGCTCCGACATCACG,0,841373
dgoRp,0.2,4,4,GTATGAACGGGCAAGCGCTA,0,849926
dgoRp,0.2,4,4,GTAGTCACATGATTTGAACG,0,853712
dgoRp,0.2,4,4,GTAGGCGCGAGTTAAGATTG,0,851871
dgoRp,0.2,4,4,GTAGCTCCTATACTATAGTT,0,856139
dgoRp,0.2,4,4,GTAATGAACCGGGTCAGCGT,0,855625
dgoRp,0.2,4,4,GTAAGCGAATTACCCGGTAC,0,856745
dgoRp,0.2,4,4,GTAACATCTTACTCAGCTAG,0,853972
dgoRp,0.2,4,4,GGTTACATCGACGAAGGTTG,0,853357
dgoRp,0.2,4,4,GGTGAGCCGTGCCAGGTCTT,0,867042
dgoRp,0.2,4,4,GGTCGGCAACAGTTTTCCCA,0,849085
dgoRp,0.2,4,4,GGTCGAGATATAGCAGTAAG,0,861293
dgoRp,0.2,4,4,GGTCGAAGTCTCTAGTGGAT,0,851514
dgoRp,0.2,4,4,GGTCCTCAGGGCGATTACGT,0,837952
dgoRp,0.2,4,4,GGTCATTCAGGCCGTACAAA,0,848807
dgoRp,0.2,4,4,GGTATTGGTTGGGTATCATC,0,835909
dgoRp,0.2,4,4,GGGTTCTGCTAAGTTAAGTG,0,857905
dgoRp,0.2,4,4,GGGTGAAGGCAAAGGTGAGC,0,856259
dgoRp,0.2,4,4,GGGTACCCACGAGGTATTCA,0,859826
dgoRp,0.2,4,4,GGGGTCGTGAGCAAAGCCCT,0,842953
dgoRp,0.2,4,4,GGGGGTTCGCTACGAAGGTG,0,855068
dgoRp,0.2,4,4,GGGGATAGGATATTTGAGTA,0,838811
dgoRp,0.2,4,4,GGGCTTCGGAGCACGTTGTC,0,840078
dgoRp,0.2,4,4,GGGCGGTAGTGTGTGGAATC,0,836877
dgoRp,0.2,4,4,GGGCGAAGCTGGCTCTGCCT,0,865646
dgoRp,0.2,4,4,GGGCCTGGACCGGCTGGTGT,0,838116
dgoRp,0.2,4,4,GGGCCAATCCCACATCCTTC,0,855623
dgoRp,0.2,4,4,GGGATTCTCCATGAGGAATT,0,856414
dgoRp,0.2,4,4,GGGAGGTTGCCATACCAAAG,0,859978
dgoRp,0.2,4,4,GGGAGGTCATGATGAGTTCA,0,848829
dgoRp,0.2,4,4,GGGAGATCTTGGGTTGCAAC,0,836507
dgoRp,0.2,4,4,GGGAGAGTTAAAGACATCTA,0,852378
dgoRp,0.2,4,4,GGGAAGTAAGTGACTAGGCA,0,847869
dgoRp,0.2,4,4,GGCTCGGGAGACGGACTTCG,0,839550
dgoRp,0.2,4,4,GGCTCAGGCAGTGCCAGTGG,0,846370
dgoRp,0.2,4,4,GGCTAGGAGAAGCTCGTTAT,0,851582
dgoRp,0.2,4,4,GGCGGCACGTTATATTCCCT,0,850516
dgoRp,0.2,4,4,GGCCTTCCGGCGTGGGTATT,0,864664
dgoRp,0.2,4,4,GGCCGCAATTCCACCACGCC,0,842851
dgoRp,0.2,4,4,GGATGGGTAATTCCATGTCA,0,862723
dgoRp,0.2,4,4,GGATCCTAGAACTGCGAGTC,0,855300
dgoRp,0.2,4,4,GGATACGATACTTGGGCTTC,0,858287
dgoRp,0.2,4,4,GGAGATCATCGATTGCCGGT,0,849576
dgoRp,0.2,4,4,GGACCGTACGATATGGCTTA,0,854753
dgoRp,0.2,4,4,GGAATTATTTGGCGTTACGG,0,840807
dgoRp,0.2,4,4,GCTTATTGAATTTCGTGTGG,0,865079
dgoRp,0.2,4,4,GCTGGGCACAGCATTCATAC,0,841402
dgoRp,0.2,4,4,GCTGGATCGCTGTAGTCTGT,0,841804
dgoRp,0.2,4,4,GCTCGGTGATCCGTACGTAG,0,836728
dgoRp,0.2,4,4,GCTATTCTCAGCTGGTAGTA,0,846431
dgoRp,0.2,4,4,GCTATTCGCGGTGCTACTAG,0,863117
dgoRp,0.2,4,4,GCTATATCTTGAGCACGATT,0,858695
dgoRp,0.2,4,4,GCTACATATCGAGAAGAGAT,0,848746
dgoRp,0.2,4,4,GCGTTGAGACAAAAACTGTT,0,843869
dgoRp,0.2,4,4,GCGTCATAGAGAATTGGCTA,0,836025
dgoRp,0.2,4,4,GCGTCAAATACCGCGATTCA,0,843929
dgoRp,0.2,4,4,GCGGTTCATACCTATGACCA,0,865936
dgoRp,0.2,4,4,GCGGGCTCCAGGTTGCAGGC,0,853333
dgoRp,0.2,4,4,GCGGACCATCTTTTCGAGTG,0,847570
dgoRp,0.2,4,4,GCGGAATAAGATACCCATTG,0,852925
dgoRp,0.2,4,4,GCGCTCGGTATATTTAGTTC,0,847690
dgoRp,0.2,4,4,GCGCCTTCGGTTGGTGAGGT,0,837809
dgoRp,0.2,4,4,GCGATGTATGTCCTTGAGTA,0,847187
dgoRp,0.2,4,4,GCGATCCTTGAATACTGTAG,0,837860
dgoRp,0.2,4,4,GCGACTGGTCAATCAAGGTC,0,863474
dgoRp,0.2,4,4,GCGAACGTGTTCCTTAGCCG,0,865538
dgoRp,0.2,4,4,GCCTTGATTTCGGGAAATAG,0,836426
dgoRp,0.2,4,4,GCCTCGTAGAACGTCTCCCT,0,860909
dgoRp,0.2,4,4,GCCGTCGGTGCAGGTTCTCA,0,854125
dgoRp,0.2,4,4,GCCGTCAAATGCCGCTCTGG,0,856573
dgoRp,0.2,4,4,GCCGCATTCGAACGATCGAA,0,858790
dgoRp,0.2,4,4,GCCCGCTGACGGAGAGAGAA,0,859440
dgoRp,0.2,4,4,GCCCACGCAAACGAGTGAGA,0,839592
dgoRp,0.2,4,4,GCCATCTCTAAACCCTTGAA,0,837231
dgoRp,0.2,4,4,GCCACATAACCCTAAAAAAA,0,849375
dgoRp,0.2,4,4,GCCAAAGGGTAGATCTCCGA,0,861487
dgoRp,0.2,4,4,GCATCCTCGGTAGTGTGTAG,0,849803
dgoRp,0.2,4,4,GCATATCACGGAAATTATCA,0,849854
dgoRp,0.2,4,4,GCATAGTACTCTACCAAGGT,0,864373
dgoRp,0.2,4,4,GCATAGGTGAACTACATAGA,0,861007
dgoRp,0.2,4,4,GCAGGAATGTCATATAATAT,0,847633
dgoRp,0.2,4,4,GCACTACAGTGGGACACGGA,0,867470
dgoRp,0.2,4,4,GCACGTAAGCCAAAATTCGA,0,838585
dgoRp,0.2,4,4,GCACGCCGGGACGATGCACG,0,850443
dgoRp,0.2,4,4,GCACCCGCACGATGCTGGTA,0,836946
dgoRp,0.2,4,4,GCACATTCGCTGCAACAGCC,0,857620
dgoRp,0.2,4,4,GCACATGCCCGGTATCATGA,0,865428
dgoRp,0.2,4,4,GCACATCATCCTAACGGTTC,0,867341
dgoRp,0.2,4,4,GCAATAACGTTCAATCAGCG,0,843772
dgoRp,0.2,4,4,GCAACTCGGGGGCATACATC,0,859028
dgoRp,0.2,4,4,GATTCCAGCTGCGTGGTTGC,0,842770
dgoRp,0.2,4,4,GATTCATTCTTTCAATAGCG,0,863883
dgoRp,0.2,4,4,GATTATAGGGCGGCGTGAGT,0,866183
dgoRp,0.2,4,4,GATGGATTGCGGCAGTACGA,0,856877
dgoRp,0.2,4,4,GATCTTTAGCATAAGCCAGA,0,858781
dgoRp,0.2,4,4,GATCGAATGGCGGGTTGGAC,0,843697
dgoRp,0.2,4,4,GATCAGCATCGCGGTGGTAT,0,837751
dgoRp,0.2,4,4,GATCACTGCGGATCATACCG,0,845320
dgoRp,0.2,4,4,GATACTTAGGATCTCTAGTG,0,856423
dgoRp,0.2,4,4,GATACGTATGCCCGTGCACA,0,866457
dgoRp,0.2,4,4,GAGTGGCAACAAGGTCCAGT,0,865739
dgoRp,0.2,4,4,GAGCTTGCATCGTGTCGCAT,0,843966
dgoRp,0.2,4,4,GAGCTCAGGGCTCCCCATCG,0,848504
dgoRp,0.2,4,4,GAGCCGCTACGAGACGGAGG,0,862540
dgoRp,0.2,4,4,GAGCCAATCTGGCGTGTTAG,0,841955
dgoRp,0.2,4,4,GAGCAGGATGGCTGAGTGTG,0,844077
dgoRp,0.2,4,4,GAGAGATGCAGCCCAGTCGT,0,849524
dgoRp,0.2,4,4,GAGACACGCCTATACGATAT,0,866862
dgoRp,0.2,4,4,GAGAAGATGGCAGCTTTCAT,0,839749
dgoRp,0.2,4,4,GACTTGTCAGTCACACGGGC,0,849175
dgoRp,0.2,4,4,GACTGGGGTACATGGCCTAG,0,838832
dgoRp,0.2,4,4,GACGGGAGACACCGGCGAGT,0,857969
dgoRp,0.2,4,4,GACATAAAGGGTGTAGAGTA,0,853918
dgoRp,0.2,4,4,GACAGTTATTCTTATTGTGC,0,849800
dgoRp,0.2,4,4,GACAGTAACCCCAACTTTGC,0,842922
dgoRp,0.2,4,4,GACAGCGAGCGGATCCTAAG,0,863291
dgoRp,0.2,4,4,GAATTGACCTCTGGTCCACT,0,863885
dgoRp,0.2,4,4,GAAGGCTTCCCCCATTATCC,0,856838
dgoRp,0.2,4,4,GAAGCGCCCTGTGACGGATA,0,854918
dgoRp,0.2,4,4,GAAGCCGGTATTGCCGTACA,0,856246
dgoRp,0.2,4,4,GAACCCTTTTAAAGTGGCTG,0,853534
dgoRp,0.2,4,4,GAACCCTGGGACATTTATTG,0,857747
dgoRp,0.2,4,4,GAACATAAGGAAATCGAAGA,0,854664
dgoRp,0.2,4,4,GAAATTACGGTTCGCTGCGT,0,845470
dgoRp,0.2,4,4,GAAATCTCCTAGCCCTTACT,0,849065
dgoRp,0.2,4,4,CTTTGTTTGACGGAGTCTAT,0,850036
dgoRp,0.2,4,4,CTTTGGGTGGCCCAAATTCG,0,849144
dgoRp,0.2,4,4,CTTTGGACCTATCGTGCAGC,0,847175
dgoRp,0.2,4,4,CTTTCAGCGCTAATCCATAG,0,859860
dgoRp,0.2,4,4,CTTGTCGCTAAAAATCACCG,0,846621
dgoRp,0.2,4,4,CTTGGACTAAACCCTTGGGG,0,855224
dgoRp,0.2,4,4,CTTGCGGGGGTAGAAACTTA,0,838524
dgoRp,0.2,4,4,CTTCCGCTTGAAGCAGGTAT,0,838945
dgoRp,0.2,4,4,CTGGCTAGTCCCATCGACGG,0,855223
dgoRp,0.2,4,4,CTGGCCGTATTTTGCTCACT,0,862952
dgoRp,0.2,4,4,CTGGATTAAGCAGACAAGAT,0,838378
dgoRp,0.2,4,4,CTGCCCACGTTGCCAATTCA,0,841473
dgoRp,0.2,4,4,CTGACACGGCGTGAGGTGAG,0,856494
dgoRp,0.2,4,4,CTCTGAGCAACCGGTCAAGA,0,853844
dgoRp,0.2,4,4,CTCTCTGGGCACACCTTAGC,0,838871
dgoRp,0.2,4,4,CTCTCACGCGAAACGGGTCT,0,861077
dgoRp,0.2,4,4,CTCGTGTCCTATACCCGAAG,0,845427
dgoRp,0.2,4,4,CTCGGGGATTCTAGAGGTTT,0,856399
dgoRp,0.2,4,4,CTCGCAATCTGCAGGCAAAG,0,855901
dgoRp,0.2,4,4,CTCGACGGTAGCACTCCGCG,0,849596
dgoRp,0.2,4,4,CTCGAATGCCTTATACCCAA,0,847636
dgoRp,0.2,4,4,CTCCTTAATCAGGGAAGAAT,0,847771
dgoRp,0.2,4,4,CTCCGCTTATCGCAAGACTG,0,855139
dgoRp,0.2,4,4,CTCCAAGTTGAGTTTAAAGG,0,847446
dgoRp,0.2,4,4,CTCATTGGGAAGTCACCTTT,0,863347
dgoRp,0.2,4,4,CTCATAAGCAATGTGGCTTG,0,854480
dgoRp,0.2,4,4,CTCAAAGGAACGTTAACAAT,0,842578
dgoRp,0.2,4,4,CTATAAGATCTTCTCTAGTT,0,843838
dgoRp,0.2,4,4,CTAGTTCTCGCATCATACTT,0,863946
dgoRp,0.2,4,4,CTAGCTGTGCCCATGCGTGT,0,844415
dgoRp,0.2,4,4,CTAGCTATGAATGTTTAGGG,0,846997
dgoRp,0.2,4,4,CTAGCGGTATTGGAGTATAT,0,845668
dgoRp,0.2,4,4,CTAGCGACTGTGCGTAGGGG,0,853311
dgoRp,0.2,4,4,CTAGCAGACGGACTGGCATG,0,842950
dgoRp,0.2,4,4,CTACATTGGACTAGCCACAC,0,866826
dgoRp,0.2,4,4,CTAAGGCCGACATTTAGGCC,0,856008
dgoRp,0.2,4,4,CTAAACGGTTTGTTGTCAGT,0,864028
dgoRp,0.2,4,4,CGTGTTAAGAGCCTGCCTGA,0,854140
dgoRp,0.2,4,4,CGTGGCCTCAAACCACCCGT,0,854864
dgoRp,0.2,4,4,CGTGATATTGTGATTAATGT,0,836651
dgoRp,0.2,4,4,CGTGACTCACTCACATCGAT,0,837850
dgoRp,0.2,4,4,CGTCGCCCTACTGTATACCA,0,843404
dgoRp,0.2,4,4,CGTCCGTTCTGGCTGATTAG,0,837685
dgoRp,0.2,4,4,CGTATACCGTCCGACTTCCA,0,838767
dgoRp,0.2,4,4,CGTAAGTCCGTGCAAAAAGC,0,861952
dgoRp,0.2,4,4,CGGTGGTTACCAACGCGGGC,0,866072
dgoRp,0.2,4,4,CGGTACATTAAGTTTGTCAT,0,861513
dgoRp,0.2,4,4,CGGGTTCTCTGTTGTACTAA,0,843183
dgoRp,0.2,4,4,CGGGGTCAGGGCTTGGCAGC,0,852408
dgoRp,0.2,4,4,CGGGGGCTGCCTGTAGTGTT,0,848060
dgoRp,0.2,4,4,CGGGGGAGCCCGACCGCGGG,0,844841
dgoRp,0.2,4,4,CGGGCCTTTACACTACAGTA,0,863613
dgoRp,0.2,4,4,CGGGCCGGGTATATCTTTAA,0,839896
dgoRp,0.2,4,4,CGGGAGAAATATCGATCTAT,0,855795
dgoRp,0.2,4,4,CGGCCGTGCTCGAAAGCTAA,0,839402
dgoRp,0.2,4,4,CGGCCATTCTCGCGTGCCCT,0,854693
dgoRp,0.2,4,4,CGGCAGACCCCAGGCCTTAG,0,858310
dgoRp,0.2,4,4,CGGATTTCGGTGACTGTGTT,0,856170
dgoRp,0.2,4,4,CGCTGCAACAGCGTGAGCCA,0,837441
dgoRp,0.2,4,4,CGCTCGCCAAGGCGGATGAT,0,847336
dgoRp,0.2,4,4,CGCTATCTGTGACGTTTGGC,0,855833
dgoRp,0.2,4,4,CGCGGTGTCGAATTTACGCG,0,838146
dgoRp,0.2,4,4,CGCCGTACCGGACCAAGATA,0,864492
dgoRp,0.2,4,4,CGCCCAGCCCTCTCGAACCT,0,857858
dgoRp,0.2,4,4,CGATTTGTCCATTGTAAAGT,0,848402
dgoRp,0.2,4,4,CGATTGCTCTTGGACGTATC,0,844174
dgoRp,0.2,4,4,CGATGTAAACGGGAGGTTCG,0,867397
dgoRp,0.2,4,4,CGAGGGGACAGGATCAGGCC,0,846139
dgoRp,0.2,4,4,CGAGGGCTTGTAGACAAAGA,0,856816
dgoRp,0.2,4,4,CGAGGCTAACGCACTCGTAG,0,860830
dgoRp,0.2,4,4,CGAGGAATTGACTTCATCAA,0,842764
dgoRp,0.2,4,4,CGAGCCGCCCAGAGTGTGAG,0,849832
dgoRp,0.2,4,4,CGAGAACAGACGACTTGCAA,0,840478
dgoRp,0.2,4,4,CGACCGTCATGTAGGTCGGA,0,859020
dgoRp,0.2,4,4,CGAATTTATCAGAGCCAGAA,0,852483
dgoRp,0.2,4,4,CGAAGGTTCTTAGGTGCATG,0,861362
dgoRp,0.2,4,4,CCTTTCGCCCCGTAGCGTGC,0,860065
dgoRp,0.2,4,4,CCTTTCGCCAACGCCGATCA,0,854171
dgoRp,0.2,4,4,CCTTTCCACGGTGGAGGCTC,0,845245
dgoRp,0.2,4,4,CCTTAATAAGCGTTCGGGAG,0,846738
dgoRp,0.2,4,4,CCTGTGGACGAGCTTCATGT,0,866263
dgoRp,0.2,4,4,CCTGGACACCTGAGTTCCGG,0,845053
dgoRp,0.2,4,4,CCTGCACGGGGTGCGGGCTT,0,839841
dgoRp,0.2,4,4,CCTGAGTCAAGTAGGCCCGA,0,862669
dgoRp,0.2,4,4,CCTGAATACTAGCGAAATAC,0,858979
dgoRp,0.2,4,4,CCTCGTGTGTTCGCATTTTC,0,842826
dgoRp,0.2,4,4,CCTAAGGACGAAATCTTAAG,0,838650
dgoRp,0.2,4,4,CCGTGAAAAGTGGTTCAAGT,0,860728
dgoRp,0.2,4,4,CCGGGAGAGGGACGCTACAT,0,858047
dgoRp,0.2,4,4,CCGCGGGGGCGGGACTATGG,0,846169
dgoRp,0.2,4,4,CCGCGAGCGAAAGTTAGACT,0,840623
dgoRp,0.2,4,4,CCGCCAACAACAAGGTAAGA,0,861079
dgoRp,0.2,4,4,CCGAACAACCGAGCGCGTCA,0,840196
dgoRp,0.2,4,4,CCCTAGCAACCTAGTGTCCT,0,852815
dgoRp,0.2,4,4,CCCCTAAAAAACGAGAGATG,0,843216
dgoRp,0.2,4,4,CCCCGGAATCCGGATGTCTT,0,856942
dgoRp,0.2,4,4,CCCCCTTAAAGACTTTCCCC,0,849900
dgoRp,0.2,4,4,CCCCCTCCACCACTATGGGA,0,855927
dgoRp,0.2,4,4,CCCCATTCGCAAGTGTTAAG,0,857535
dgoRp,0.2,4,4,CCCATTCAGAGCAGCCTACT,0,853398
dgoRp,0.2,4,4,CCCATCGCACTTAAGTGGAT,0,862353
dgoRp,0.2,4,4,CCCATCAACGCAATTGGTGT,0,860147
dgoRp,0.2,4,4,CCCACAAAATTGGCCCCGGA,0,840123
dgoRp,0.2,4,4,CCATTGGATCTTCCGGGGGT,0,836365
dgoRp,0.2,4,4,CCATGCACTCGTCCGGGATT,0,861093
dgoRp,0.2,4,4,CCATATGGGCGCTGTTTAAC,0,844071
dgoRp,0.2,4,4,CCAGCTGGACAGTCATGCCA,0,861803
dgoRp,0.2,4,4,CCACTAATGCTCTAGGTTTT,0,838739
dgoRp,0.2,4,4,CCAACGCCTTTCCTCATGGC,0,851167
dgoRp,0.2,4,4,CCAAACCTGGCTGACGAAAG,0,836059
dgoRp,0.2,4,4,CATTTTGCCCTGCGGGTCTG,0,838548
dgoRp,0.2,4,4,CATTTGCACCCAAGTGAGGG,0,863691
dgoRp,0.2,4,4,CATTTAAATGAGCATCCCCA,0,845947
dgoRp,0.2,4,4,CATTCCGTGTGACCCTATTG,0,848546
dgoRp,0.2,4,4,CATGTGGATGCTTGTAGGTA,0,853014
dgoRp,0.2,4,4,CATCTATTCAACAAATTAGC,0,863736
dgoRp,0.2,4,4,CATCGACTGTCAGTCCGCCA,0,845366
dgoRp,0.2,4,4,CATATGGATGCTAGTGCTGC,0,840768
dgoRp,0.2,4,4,CATAGACCAGTGCATCAGTG,0,854152
dgoRp,0.2,4,4,CATAAGGGGATTAACATGCT,0,866311
dgoRp,0.2,4,4,CATAAAAGGCGGGTGCCGGG,0,841643
dgoRp,0.2,4,4,CAGTGTACCGTCTCAAACTG,0,844554
dgoRp,0.2,4,4,CAGGTGGCTAGCTGTTCTGG,0,863414
dgoRp,0.2,4,4,CAGGTCCGACGTGGTGCATT,0,850911
dgoRp,0.2,4,4,CAGGGGTTAGAGAGTTAAAT,0,841451
dgoRp,0.2,4,4,CAGGCGACTGATCGCCTTTG,0,845414
dgoRp,0.2,4,4,CAGGAGACCAGGCTCTAAGC,0,863983
dgoRp,0.2,4,4,CAGCTGGCACGCGGCTTCCA,0,841883
dgoRp,0.2,4,4,CAGCGGGGTTAGCGGCTAAA,0,864931
dgoRp,0.2,4,4,CAGCGGCTTATAAGGGATCT,0,866477
dgoRp,0.2,4,4,CAGCGCTGACAAATGTACAA,0,864704
dgoRp,0.2,4,4,CAGCGAGAAAGACGAGCGAT,0,844552
dgoRp,0.2,4,4,CAGCCGCCGGAATAGAAATG,0,838619
dgoRp,0.2,4,4,CAGCCCTCAGCCATGCGTAA,0,836841
dgoRp,0.2,4,4,CAGCATTCCTACCGGCGCGT,0,836781
dgoRp,0.2,4,4,CAGAGTCCAAGACAAGCGCT,0,864543
dgoRp,0.2,4,4,CAGAGGTGATTTAATCGGAG,0,843792
dgoRp,0.2,4,4,CAGAGACCAAAGGTAGCTTA,0,850918
dgoRp,0.2,4,4,CAGAATGGATAACACATCGA,0,840186
dgoRp,0.2,4,4,CACTTTTGGAGAGCGACGGT,0,852625
dgoRp,0.2,4,4,CACGGTGCTGTCAGCCTAGG,0,839100
dgoRp,0.2,4,4,CACGCGCAGAGTCGCAGAAC,0,866792
dgoRp,0.2,4,4,CACGATCTATGGAAGGGTTA,0,853818
dgoRp,0.2,4,4,CACGATAGTAATCGGGAAAA,0,856147
dgoRp,0.2,4,4,CACCGCGCTCAAAACGTTCA,0,837487
dgoRp,0.2,4,4,CACCATACTGCGCTGGATCA,0,855278
dgoRp,0.2,4,4,CACCAGTACGCTATAACAGT,0,848782
dgoRp,0.2,4,4,CACAGTAGCGAAGAGATATT,0,853157
dgoRp,0.2,4,4,CAATGTCCGCATCTATGGCG,0,836366
dgoRp,0.2,4,4,CAATCGATGCTAAGTCGGAA,0,854295
dgoRp,0.2,4,4,CAACCTTTCATGCGACCCCG,0,850048
dgoRp,0.2,4,4,CAACCGAGAATAGGACATTT,0,843776
dgoRp,0.2,4,4,CAACCATCGAGTAGGAACGG,0,850081
dgoRp,0.2,4,4,CAACATTCCCAGATGGTTCT,0,855808
dgoRp,0.2,4,4,CAAAGTTGCTACTGACAGTG,0,842446
dgoRp,0.2,4,4,CAAAGGACCCGGGATCCACT,0,848247
dgoRp,0.2,4,4,CAAAAAAGGACACTCTTCAA,0,859099
dgoRp,0.2,4,4,ATTTGGGCGAAAAAGAGGCA,0,857227
dgoRp,0.2,4,4,ATTTGCACGTATTCACAATG,0,865002
dgoRp,0.2,4,4,ATTTCACAAGCGTTGGGTCA,0,862539
dgoRp,0.2,4,4,ATTTATTCCTACTACCACAT,0,837495
dgoRp,0.2,4,4,ATTTAGTGAAACAGGAACGT,0,858917
dgoRp,0.2,4,4,ATTTAAGCATTCTCCAAGGT,0,861519
dgoRp,0.2,4,4,ATTTAAAGATGGGCTGACTA,0,839150
dgoRp,0.2,4,4,ATTGGAGGGGTGAGTTAGAT,0,844537
dgoRp,0.2,4,4,ATTGCGTCACACAGAGCGGC,0,864749
dgoRp,0.2,4,4,ATTGAAGTCTGAATCTAAGC,0,844517
dgoRp,0.2,4,4,ATTAGATCGTCCGGCCAAAG,0,840923
dgoRp,0.2,4,4,ATTAGAACAAAGTTATGCAG,0,837923
dgoRp,0.2,4,4,ATTAAGGGATATAGTGCACC,0,856967
dgoRp,0.2,4,4,ATTAAATCGAGGTCCCAATT,0,854643
dgoRp,0.2,4,4,ATGTTCCGTATCTTTGTACT,0,838647
dgoRp,0.2,4,4,ATGTAACCTTGTACGAAAAC,0,842768
dgoRp,0.2,4,4,ATGTAAAGGGACAGTGAAGC,0,836761
dgoRp,0.2,4,4,ATGGTGAAAGGCATCCAGCC,0,847880
dgoRp,0.2,4,4,ATGGGTGATACAAAGGGTTT,0,854305
dgoRp,0.2,4,4,ATGGGAAATGGCGCGAGGAG,0,854754
dgoRp,0.2,4,4,ATGCCTATCTTTCAGAATGG,0,851654
dgoRp,0.2,4,4,ATGCAGATCTGGAGGCTTCA,0,837216
dgoRp,0.2,4,4,ATGAGTATTATGAGCGAAGT,0,850866
dgoRp,0.2,4,4,ATGAATAGTCTGATCGAGTT,0,843769
dgoRp,0.2,4,4,ATCTGTTGGGGGGGCTAAGT,0,841695
dgoRp,0.2,4,4,ATCGTGCGAGAGTGATTGTC,0,862116
dgoRp,0.2,4,4,ATCGTCAAACGCAGCATTCA,0,840648
dgoRp,0.2,4,4,ATCGTACGTGTTAGGCGCTG,0,861302
dgoRp,0.2,4,4,ATCGTACATGTGCTCATATG,0,844743
dgoRp,0.2,4,4,ATCGTAATATGGGAATCATA,0,861786
dgoRp,0.2,4,4,ATCGGGATCGAAGATTGTCT,0,841574
dgoRp,0.2,4,4,ATCGCTGGGGCTAGAGATAG,0,857602
dgoRp,0.2,4,4,ATCCCGACGGCAATGCGATT,0,849460
dgoRp,0.2,4,4,ATCCACAAACTATATTTGCA,0,865398
dgoRp,0.2,4,4,ATCATAGCACGCCGTCATGG,0,859162
dgoRp,0.2,4,4,ATATGGGAATTGACACTGCT,0,847877
dgoRp,0.2,4,4,ATATGCTACGTGTTCCATCC,0,867348
dgoRp,0.2,4,4,ATATCTCTGTGCAGATGACC,0,856968
dgoRp,0.2,4,4,ATATCGCGACACCCGTAATT,0,856256
dgoRp,0.2,4,4,ATATCATCGAGAATTGGATT,0,838362
dgoRp,0.2,4,4,ATATACAACCCTCTCCGCAA,0,854345
dgoRp,0.2,4,4,ATAGAGGGTTGAACATAAGC,0,860170
dgoRp,0.2,4,4,ATACTAAGTTGGCCCATGAC,0,858038
dgoRp,0.2,4,4,ATAATCTGGGGTTATCCCCA,0,836105
dgoRp,0.2,4,4,ATAATAGTTGATTCTAACTA,0,850994
dgoRp,0.2,4,4,ATAATAGTATTTTCTGCACA,0,841235
dgoRp,0.2,4,4,ATAACTCGGCCCTCCATCAG,0,858625
dgoRp,0.2,4,4,ATAACAATAGATAAATTTTG,0,855811
dgoRp,0.2,4,4,AGTTTCGCTCGGTAGACTGT,0,856211
dgoRp,0.2,4,4,AGTTCCGAAGCGCGGAGACG,0,842085
dgoRp,0.2,4,4,AGTTCAGACTTCCCTGGCGT,0,854832
dgoRp,0.2,4,4,AGTGGTTAGTAATGGCAGCG,0,839178
dgoRp,0.2,4,4,AGTGGCGTCTACGGAATTCC,0,865582
dgoRp,0.2,4,4,AGTGGCCTCCTGATATATAA,0,849505
dgoRp,0.2,4,4,AGTCTCCATATGTTTATGCT,0,850179
dgoRp,0.2,4,4,AGTCACCTGCAAGTTAAAGA,0,862833
dgoRp,0.2,4,4,AGTCAATTATCTCGTACGCC,0,862767
dgoRp,0.2,4,4,AGTAGGATTGGGTAATCGGC,0,852036
dgoRp,0.2,4,4,AGTAATTGCTGCGCAACCCA,0,836227
dgoRp,0.2,4,4,AGTAATCCTAGTACGCCAGG,0,837845
dgoRp,0.2,4,4,AGGGTTTTTTGTCGTCCACT,0,852868
dgoRp,0.2,4,4,AGGGTTTGGACCATCTGCCC,0,853974
dgoRp,0.2,4,4,AGGGCTCGTAAACTTGCAAG,0,842665
dgoRp,0.2,4,4,AGGGCCTGTGCATATAAACC,0,863920
dgoRp,0.2,4,4,AGGCCTGGGCCGAACGCCTG,0,856808
dgoRp,0.2,4,4,AGGAGTGGCTAAGTGCTTCT,0,846459
dgoRp,0.2,4,4,AGGACATTAGCGCTAACGCA,0,865364
dgoRp,0.2,4,4,AGGACAGATCTAAGGAGAAG,0,838251
dgoRp,0.2,4,4,AGGACACCTGTTTTAGGTAG,0,864133
dgoRp,0.2,4,4,AGGAACGCGACGACCGCACC,0,855929
dgoRp,0.2,4,4,AGCTGAATACTAGACCACCA,0,864181
dgoRp,0.2,4,4,AGCTATTACGGATTTGGGGA,0,857751
dgoRp,0.2,4,4,AGCTACAGGCCGAGATAGTG,0,838458
dgoRp,0.2,4,4,AGCGGTATATGTGTTGGGGT,0,845932
dgoRp,0.2,4,4,AGCGGCGTCGCGATCCAGCA,0,865919
dgoRp,0.2,4,4,AGCGACTGACATTATTGCGC,0,849254
dgoRp,0.2,4,4,AGCCTAGTTAGACATTATCT,0,855379
dgoRp,0.2,4,4,AGCCGGAAAGCCTGAGGCAA,0,848251
dgoRp,0.2,4,4,AGCACGTGCTAGTAACCTCG,0,864569
dgoRp,0.2,4,4,AGCAAGTCATTTACTGTACT,0,836065
dgoRp,0.2,4,4,AGATTGTCCCAAGTTGATGA,0,847992
dgoRp,0.2,4,4,AGATGCATGAAACCTAACAT,0,850606
dgoRp,0.2,4,4,AGAGTTGACCCGCACGATAT,0,841884
dgoRp,0.2,4,4,AGAGCTTGTCGGCTCCCGGT,0,851071
dgoRp,0.2,4,4,AGACGACGTGCAGAAATAGA,0,838556
dgoRp,0.2,4,4,AGAAGTGCAGTCCACAATCG,0,858713
dgoRp,0.2,4,4,AGAAGGGATGGCATGTCCAG,0,849853
dgoRp,0.2,4,4,AGAACAGGGATAACGTCGGT,0,848498
dgoRp,0.2,4,4,ACTTAGCACGTTCTGGTAGC,0,856385
dgoRp,0.2,4,4,ACTGTGTAGGGGTTGTTAAA,0,850063
dgoRp,0.2,4,4,ACTGTCACCGGCATGTGTCG,0,861078
dgoRp,0.2,4,4,ACTGGATACGCGTCGGGATC,0,848392
dgoRp,0.2,4,4,ACTGAGTGCCCGGGTGCACT,0,841131
dgoRp,0.2,4,4,ACTCTGCTTGTGACCGAACT,0,854145
dgoRp,0.2,4,4,ACTATACTGGTTAATGTTCG,0,844764
dgoRp,0.2,4,4,ACTAGACGGGTGATATTGGC,0,866214
dgoRp,0.2,4,4,ACGTGTGCTGTGTAAGGGCT,0,860329
dgoRp,0.2,4,4,ACGTCTTGCAAGAGCTGGTA,0,850183
dgoRp,0.2,4,4,ACGTCTACGCCAATCCAGTG,0,842154
dgoRp,0.2,4,4,ACGGGACCGCCGTGGGCAAA,0,848256
dgoRp,0.2,4,4,ACGGCGCGTCAGCCTCCCCA,0,865886
dgoRp,0.2,4,4,ACGGCGCGCCCCGCGGTAGC,0,852653
dgoRp,0.2,4,4,ACGGCCCGCTAGAATTCAGC,0,849549
dgoRp,0.2,4,4,ACGGAGGGGACACTCCACCT,0,853741
dgoRp,0.2,4,4,ACGGAGCCAGCACGCTCTTA,0,838192
dgoRp,0.2,4,4,ACGCCGGGCCGTGTAACCTG,0,846439
dgoRp,0.2,4,4,ACGCCACTTCCAGTCAGCTC,0,864824
dgoRp,0.2,4,4,ACGCATTAACGTGGGGATAC,0,863289
dgoRp,0.2,4,4,ACGATAGGGAGCGCCCTCGA,0,862047
dgoRp,0.2,4,4,ACGACCCCCACCTGCCGATG,0,849497
dgoRp,0.2,4,4,ACCTGGGTGGAACTGCTGAA,0,853780
dgoRp,0.2,4,4,ACCTCAAAGGTAGGGGCACG,0,860064
dgoRp,0.2,4,4,ACCGCGGCTCGTCATTGCCT,0,851138
dgoRp,0.2,4,4,ACCCTGTGATTACTAACGTA,0,848065
dgoRp,0.2,4,4,ACCCTGGATTCACGTTAGGG,0,841064
dgoRp,0.2,4,4,ACCCAGTACTCATTACCCCA,0,848964
dgoRp,0.2,4,4,ACCCACCCGTTGGCCCAACG,0,849675
dgoRp,0.2,4,4,ACCAAATGTCATTGGTGTAA,0,863355
dgoRp,0.2,4,4,ACATTGACACGTGGGTATGA,0,863844
dgoRp,0.2,4,4,ACAGGTGCTAGGTGATGGGA,0,840130
dgoRp,0.2,4,4,ACACGGAAGTACCAGCATAG,0,855879
dgoRp,0.2,4,4,ACACAAGGAAAAGAAGTTGG,0,851349
dgoRp,0.2,4,4,ACAACGGCCTAGCTCGCACG,0,853858
dgoRp,0.2,4,4,ACAACCAATCAGTCGAATGA,0,836986
dgoRp,0.2,4,4,ACAAAAAACCCTTGCGTGGA,0,857870
dgoRp,0.2,4,4,AATTGTAGATGCCGGACAGT,0,840232
dgoRp,0.2,4,4,AATTAGCACCACCTATTGAT,0,854879
dgoRp,0.2,4,4,AATGTTATCGTCTCACCAGA,0,854525
dgoRp,0.2,4,4,AATGCTGAACATTTTACAGT,0,845904
dgoRp,0.2,4,4,AATGCGCAGTCTTGTAACTC,0,841669
dgoRp,0.2,4,4,AATCTCTAAGGGTCAACTCG,0,847785
dgoRp,0.2,4,4,AATCCTGTCACTGCTTGAGA,0,856310
dgoRp,0.2,4,4,AATATTATCATGGGGATCGA,0,836788
dgoRp,0.2,4,4,AATACGGGCATCGCTAAATT,0,862313
dgoRp,0.2,4,4,AATAATACCCGTTTTGTTTG,0,850507
dgoRp,0.2,4,4,AATAAATCCAGTGCCGGCGC,0,860005
dgoRp,0.2,4,4,AAGTTGGGGTGCATCTTTAG,0,837961
dgoRp,0.2,4,4,AAGTTAAAAGCCACTTGCAG,0,837493
dgoRp,0.2,4,4,AAGTGTTAAACATTGCGACC,0,862548
dgoRp,0.2,4,4,AAGTGAGAAACACTAACTAA,0,859206
dgoRp,0.2,4,4,AAGTAGGCTCACTAAAGATG,0,864310
dgoRp,0.2,4,4,AAGTAGGACATTTAGAATTT,0,842418
dgoRp,0.2,4,4,AAGGTTTCTCAAGTTTCAAA,0,851005
dgoRp,0.2,4,4,AAGGGGGATGGGCATCTTCA,0,841074
dgoRp,0.2,4,4,AAGGGAAATTACATGTGTAG,0,850803
dgoRp,0.2,4,4,AAGGCTCGTGCTGCAGGGCT,0,865489
dgoRp,0.2,4,4,AAGCGGCAATCAGTATCGTG,0,851933
dgoRp,0.2,4,4,AAGCACTCATGAGCCACTCG,0,848453
dgoRp,0.2,4,4,AAGAGAACCTGGGGTGCTTG,0,851847
dgoRp,0.2,4,4,AACTGATCCTCGACATGCGG,0,853947
dgoRp,0.2,4,4,AACGCCCCTAGCGCTTTTGC,0,862393
dgoRp,0.2,4,4,AACGCCCAGTAAAAAAATTT,0,856121
dgoRp,0.2,4,4,AACATCCTTCAGAAGACGGG,0,866492
dgoRp,0.2,4,4,AACATAACCTGCATTTATGC,0,860193
dgoRp,0.2,4,4,AACAGTTCTGTAATCATTTA,0,837151
dgoRp,0.2,4,4,AACAGCAAGAGACTCTCAGC,0,845071
dgoRp,0.2,4,4,AACACGTTACGGATTACGCG,0,850412
dgoRp,0.2,4,4,AACACCAGGAACCAGTATGT,0,840873
dgoRp,0.2,4,4,AAATCCGGATGCGAAAGTAA,0,855560
dgoRp,0.2,4,4,AAAGTGCGGGAACGGATACA,0,844795
dgoRp,0.2,4,4,AAACGTCCTTGGGCAGACCC,0,859534
dgoRp,0.2,4,4,AAACCAGCTCAGGCCAGTAG,0,854032
dgoRp,0.2,4,4,AAAATTAGTCCTCCCAGTAC,0,863498
dgoRp,0.2,4,4,AAAATACTCGCTCTATAATA,0,848649
dgoRp,0.25,3,3,TTTTTCCTATCAACGGTCAG,0,842693
dgoRp,0.25,3,3,TTTTTAGGCCCCAGAGAAAT,0,852665
dgoRp,0.25,3,3,TTTTGGTTCCGACAGTTTAC,0,850221
dgoRp,0.25,3,3,TTTTGAGTGACACTTGCTCC,0,866631
dgoRp,0.25,3,3,TTTTCGTCACTATGGAGTGA,0,843696
dgoRp,0.25,3,3,TTTTCCCTCACATTCCGGGC,0,859969
dgoRp,0.25,3,3,TTTGGGCTCGTAGTTGGCGA,0,856222
dgoRp,0.25,3,3,TTTGAAATTTGGAGCTGTTT,0,845724
dgoRp,0.25,3,3,TTTCTCCGCTAAGTGCAAAA,0,859977
dgoRp,0.25,3,3,TTTCGAGTGGGACGAAACGT,0,848851
dgoRp,0.25,3,3,TTTATGATGTTCGGGCATTA,0,853750
dgoRp,0.25,3,3,TTTACCCTCCTCAAGGCGGG,0,854927
dgoRp,0.25,3,3,TTTACCACCACACACAAACT,0,848180
dgoRp,0.25,3,3,TTTAAAAACGGGTGGCCGTT,0,865544
dgoRp,0.25,3,3,TTGTTGCAGTTTATCCTACC,0,844561
dgoRp,0.25,3,3,TTGTGGATCGAATAATCGCT,0,842123
dgoRp,0.25,3,3,TTGTCCGCTGCACCCGACAT,0,842311
dgoRp,0.25,3,3,TTGCCTAACTGGAGGAGTCT,0,850357
dgoRp,0.25,3,3,TTGATCGTGAGCGCAAGGTG,0,850957
dgoRp,0.25,3,3,TTGAACCAGTGTGCACGGCA,0,849547
dgoRp,0.25,3,3,TTCTTATCAGAAGGTCATAA,0,839372
dgoRp,0.25,3,3,TTCTCGTGCTCCGGCAGAAA,0,863816
dgoRp,0.25,3,3,TTCGGACCCAGCTCGTGGGA,0,839603
dgoRp,0.25,3,3,TTCGATGGCTCCGGTCGTGG,0,865097
dgoRp,0.25,3,3,TTCCCCGTCTTAGGATGGTT,0,847074
dgoRp,0.25,3,3,TTCAGGAAAACTTTCGGAGC,0,866520
dgoRp,0.25,3,3,TTCAACAGGAATACATTCCC,0,849030
dgoRp,0.25,3,3,TTATTCCGCGGAAACAAAAT,0,849420
dgoRp,0.25,3,3,TTATAGGGTAATACATTCTC,0,858087
dgoRp,0.25,3,3,TTAGTTGACGGTCACGCGAA,0,859610
dgoRp,0.25,3,3,TTACGTTAATGCGAGACTTC,0,847343
dgoRp,0.25,3,3,TTACGCCATCCAGTGGAACT,0,858771
dgoRp,0.25,3,3,TTACGATAAAATGTTCGATG,0,846933
dgoRp,0.25,3,3,TTACAATGATGGGGTGGCGC,0,863621
dgoRp,0.25,3,3,TTAAGCCGAGGTCCGTTTCA,0,862918
dgoRp,0.25,3,3,TTAAAGGTGCAGGGTTGCTT,0,862647
dgoRp,0.25,3,3,TTAAACGATGGGTGATAATG,0,845185
dgoRp,0.25,3,3,TGTTATCATGTTAGGATTTT,0,860047
dgoRp,0.25,3,3,TGTGTGGCAGACATGTACAC,0,858382
dgoRp,0.25,3,3,TGTGGTACACTAAGTGCGAG,0,837702
dgoRp,0.25,3,3,TGTGGGTGATTGAACCTCGG,0,836151
dgoRp,0.25,3,3,TGTGCAGCTCATGCACCCCA,0,846816
dgoRp,0.25,3,3,TGTCTGCGTTTCGGGGACAA,0,855410
dgoRp,0.25,3,3,TGTCTGACACCGACTTGCCA,0,854502
dgoRp,0.25,3,3,TGTCGGTCAAGCATACCCTA,0,842946
dgoRp,0.25,3,3,TGTCCTGGGAATCCGAGGGG,0,852401
dgoRp,0.25,3,3,TGTCATGCCCTCCTGGACAA,0,840727
dgoRp,0.25,3,3,TGTAGTGGAGAACCCTCAAT,0,839861
dgoRp,0.25,3,3,TGTAGGAGTACGGACACAAT,0,836572
dgoRp,0.25,3,3,TGGTTGCTGAAGATCAGGGA,0,848780
dgoRp,0.25,3,3,TGGTGGGGCAATCGGGCTCT,0,839879
dgoRp,0.25,3,3,TGGTACTGATCTAAGGAGCA,0,855822
dgoRp,0.25,3,3,TGGGCTACGAGAATGGGCGT,0,839966
dgoRp,0.25,3,3,TGGCCGAGCTGGTGGTGATA,0,852494
dgoRp,0.25,3,3,TGGAGCGGACTGATCAGTGA,0,855184
dgoRp,0.25,3,3,TGGAAACGGGCTATCAAGTT,0,845179
dgoRp,0.25,3,3,TGCTGCACACCGCACGACCT,0,855890
dgoRp,0.25,3,3,TGCGTCAAGATAAGTCGCTA,0,840070
dgoRp,0.25,3,3,TGCGTACATACAAAGGGTGA,0,857988
dgoRp,0.25,3,3,TGCGCTCCCTCCTGGCGTAC,0,862244
dgoRp,0.25,3,3,TGCGCAATCTTCATCTCTTG,0,849087
dgoRp,0.25,3,3,TGCCTTACTTAATCGATTCA,0,867082
dgoRp,0.25,3,3,TGCCCGTGTTAGTCCACATC,0,838676
dgoRp,0.25,3,3,TGCCAGGTTGATTAGTAGGC,0,847768
dgoRp,0.25,3,3,TGCAGGCCAAATTTCCGTGA,0,845859
dgoRp,0.25,3,3,TGCACCCAGTCCTAACATAC,0,851374
dgoRp,0.25,3,3,TGATGGTGCTGCCCCCGTAG,0,862768
dgoRp,0.25,3,3,TGAGTTCCCAAATGCTCCAT,0,864888
dgoRp,0.25,3,3,TGACTTCTCGAACCTCAGAT,0,856674
dgoRp,0.25,3,3,TGACTAGGCGTTGAACTCTA,0,867468
dgoRp,0.25,3,3,TGACGGATACTACGTTGAGC,0,861636
dgoRp,0.25,3,3,TGAATTCTAACCGTGGAGTA,0,852085
dgoRp,0.25,3,3,TGAATTACTCACAACCTATC,0,853628
dgoRp,0.25,3,3,TGAATCAAGATGGCTGCGGT,0,841948
dgoRp,0.25,3,3,TGAACAGAGGCATCCGGTAA,0,839755
dgoRp,0.25,3,3,TCTTTCACATCTTCAGAGAA,0,846864
dgoRp,0.25,3,3,TCTTTAACAGCGTGACTACC,0,852182
dgoRp,0.25,3,3,TCTTGGTTCACCTACGGTAT,0,866248
dgoRp,0.25,3,3,TCTTGGCTGTCGCTCCTAGT,0,849437
dgoRp,0.25,3,3,TCTTGGCTGATTGGCGGACG,0,861674
dgoRp,0.25,3,3,TCTTCTACCTGAGTTTAGCT,0,860363
dgoRp,0.25,3,3,TCTTCATCCTCGCTTGTCCA,0,853048
dgoRp,0.25,3,3,TCTGGGGCAAGAAATCCGCA,0,854827
dgoRp,0.25,3,3,TCTCAGCTCGCGTGTAGAAC,0,846974
dgoRp,0.25,3,3,TCTATCGAATGGAATTGGGC,0,852158
dgoRp,0.25,3,3,TCTAGCCCACAGAATCATGC,0,850308
dgoRp,0.25,3,3,TCTAGAGCGTCTGGTCGCTG,0,865910
dgoRp,0.25,3,3,TCTACGTCTCTCCGACCTCC,0,836074
dgoRp,0.25,3,3,TCTACAGTTACTTTGGCAGC,0,835971
dgoRp,0.25,3,3,TCGTTTGTATGTCATGTTTG,0,850996
dgoRp,0.25,3,3,TCGTTCCCAAGTTAGCACGG,0,838032
dgoRp,0.25,3,3,TCGTCCGCTGAATGCGTACA,0,840806
dgoRp,0.25,3,3,TCGTATTAAAGCGAAAGCTC,0,843416
dgoRp,0.25,3,3,TCGTATGTCAATGCTACCGG,0,859084
dgoRp,0.25,3,3,TCGTATCGTAAGAAAGTCAG,0,846809
dgoRp,0.25,3,3,TCGGTCTGGGTAAAGCACAG,0,841198
dgoRp,0.25,3,3,TCGGTCAGCTGAGTAGCGCT,0,836229
dgoRp,0.25,3,3,TCGGTAGGCCCGATACTTCA,0,859774
dgoRp,0.25,3,3,TCGGGGAGACTAGACGTCTG,0,838359
dgoRp,0.25,3,3,TCGGCATCAGAGCGTGTCAG,0,866931
dgoRp,0.25,3,3,TCGGAGTACGGTGCGTCGTA,0,853666
dgoRp,0.25,3,3,TCGGAGCTTATTTTGATCGA,0,858580
dgoRp,0.25,3,3,TCGGAACTGGAACGTTGTGT,0,841278
dgoRp,0.25,3,3,TCGCTGTGCGCGCGACTTTA,0,851280
dgoRp,0.25,3,3,TCGCTGGACGGGTCAACCTT,0,855773
dgoRp,0.25,3,3,TCGCTCCAAATAAATAACGT,0,860046
dgoRp,0.25,3,3,TCGCCCTCACAAGATATTAG,0,840990
dgoRp,0.25,3,3,TCGCAAAGTAATGCGGAGTT,0,847179
dgoRp,0.25,3,3,TCGATTCATTGATACAGGGG,0,860646
dgoRp,0.25,3,3,TCGAGCCGTATAGGACGTGT,0,863088
dgoRp,0.25,3,3,TCGACGATCAATGATATTCA,0,860761
dgoRp,0.25,3,3,TCGACAAGTTACACTACATT,0,847135
dgoRp,0.25,3,3,TCCTCAGGGCGGCCCCGATC,0,842434
dgoRp,0.25,3,3,TCCTCAATCAAGCATGAGCG,0,852614
dgoRp,0.25,3,3,TCCTACAGGGCGCTGTGACA,0,839895
dgoRp,0.25,3,3,TCCGTATGGCAGCGGGTGGT,0,853402
dgoRp,0.25,3,3,TCCGATAGCGTGGATTCAAT,0,860765
dgoRp,0.25,3,3,TCCCAATCCGGGTTCGCGGT,0,841467
dgoRp,0.25,3,3,TCCAGAAGAACTGCGGATTT,0,852203
dgoRp,0.25,3,3,TCCAATTCCAGATCTGAGCC,0,860628
dgoRp,0.25,3,3,TCCAATCCCCTTGGGAAACG,0,854838
dgoRp,0.25,3,3,TCCAACATCATGAAGGACCG,0,849328
dgoRp,0.25,3,3,TCATGCTTCACGTATGTAAA,0,843382
dgoRp,0.25,3,3,TCATGCCTATTGCAGCAAAG,0,862861
dgoRp,0.25,3,3,TCAGTACGATGTTTAAACCA,0,848166
dgoRp,0.25,3,3,TCAGGTGAATCCGGGGCGTT,0,854217
dgoRp,0.25,3,3,TCACTGCCGGGTCTTACACA,0,848375
dgoRp,0.25,3,3,TCACAACTCGTTAAGGCTCC,0,838203
dgoRp,0.25,3,3,TCAAGTTAGAGCGACGTGGA,0,840942
dgoRp,0.25,3,3,TATTTGTTTCCGGCTTGGGA,0,840601
dgoRp,0.25,3,3,TATTGCGGGACCATTCTGGG,0,845476
dgoRp,0.25,3,3,TATTCTGACGGCTCTTCGGG,0,843872
dgoRp,0.25,3,3,TATTATCATCGGAGGGCCGG,0,852025
dgoRp,0.25,3,3,TATGTGCATTCGTTCACCAG,0,855058
dgoRp,0.25,3,3,TATGTCGTGATGGCCGCTCA,0,839844
dgoRp,0.25,3,3,TATGTAAGTGGGAGAGTAAG,0,854701
dgoRp,0.25,3,3,TATGCTCGTTCGAAAAGGGG,0,851942
dgoRp,0.25,3,3,TATGCAAGACCCCGGAAATA,0,857968
dgoRp,0.25,3,3,TATCTACCCCGACCATCTTT,0,846367
dgoRp,0.25,3,3,TATCGGGCAGGGCGAACACG,0,864972
dgoRp,0.25,3,3,TATATATCACGTAATCAGTA,0,849788
dgoRp,0.25,3,3,TAGGTACAAGCAGTGGTGAG,0,863464
dgoRp,0.25,3,3,TAGGGCTGCACCATCCAAAC,0,853938
dgoRp,0.25,3,3,TAGGCTGAATAGGGATGACC,0,867104
dgoRp,0.25,3,3,TAGGATTTGGCCGGGCCACA,0,855274
dgoRp,0.25,3,3,TAGCTTGGTGCTCGACCTTG,0,867379
dgoRp,0.25,3,3,TAGCTGGCAGGATTCCTGCA,0,837928
dgoRp,0.25,3,3,TAGCGAGTCAAACCGCGGTC,0,852333
dgoRp,0.25,3,3,TAGCATTGCATAGAGATGTG,0,857795
dgoRp,0.25,3,3,TAGCATAACTCGAAATTAGA,0,851988
dgoRp,0.25,3,3,TAGATTTATCGACGCAACTC,0,867105
dgoRp,0.25,3,3,TAGACTCGGGTGAGTGAGAC,0,846134
dgoRp,0.25,3,3,TAGAAGTACGCGTTAATAAC,0,850178
dgoRp,0.25,3,3,TACTTCCTCAACAATGGTTC,0,844902
dgoRp,0.25,3,3,TACTTCCGGTCCGGTTGGTG,0,861996
dgoRp,0.25,3,3,TACTGCTAAAAACTCTCTGC,0,837985
dgoRp,0.25,3,3,TACTGCGCTAAACAGTGATT,0,845943
dgoRp,0.25,3,3,TACGTGGAGCAGCAGAAAAT,0,847947
dgoRp,0.25,3,3,TACGGTCCATCGGGGCAGTA,0,863437
dgoRp,0.25,3,3,TACGGTATATCAAAAGTAAC,0,854964
dgoRp,0.25,3,3,TACGGGTGCGCAGATCTGAA,0,856400
dgoRp,0.25,3,3,TACGGACGTGTCCTCTAGTG,0,839427
dgoRp,0.25,3,3,TACGATTAGGGCGCGACCAG,0,837501
dgoRp,0.25,3,3,TACCTCTGTGGAACCTGGCG,0,863444
dgoRp,0.25,3,3,TACCGTGTCGCAGTTCGAAG,0,839139
dgoRp,0.25,3,3,TACCGATAGAAGGCGTATAA,0,866809
dgoRp,0.25,3,3,TACCAAGTTTCTTATCCCAC,0,864610
dgoRp,0.25,3,3,TACCAAGTAGCAAAATTAGT,0,856146
dgoRp,0.25,3,3,TACAATGTGGAGTACCCGCA,0,851944
dgoRp,0.25,3,3,TAATTCTTACATAGAGGGTA,0,841712
dgoRp,0.25,3,3,TAATAGGTGCTCTACGGAGA,0,840506
dgoRp,0.25,3,3,TAATACGTTTGAGGCAACAT,0,853228
dgoRp,0.25,3,3,TAAGTAGCACGGAAATCTTA,0,845362
dgoRp,0.25,3,3,TAAGTAAAGGTTTGGTTAAT,0,851072
dgoRp,0.25,3,3,TAACTTCAGTCAATTATGCA,0,856661
dgoRp,0.25,3,3,TAACGTATCTTCGATTGAAC,0,861436
dgoRp,0.25,3,3,TAACGCTTGCATTGGCACTC,0,845144
dgoRp,0.25,3,3,TAACGCATAAAAAACGTCCT,0,863846
dgoRp,0.25,3,3,TAACGCAGGCGAAGACCGCG,0,856218
dgoRp,0.25,3,3,TAAATTCAAAAATTTGTTCC,0,843663
dgoRp,0.25,3,3,TAAAGTAGTTAGGAGAAGTT,0,863138
dgoRp,0.25,3,3,GTTTCGTGTTTTGCGGGATG,0,846762
dgoRp,0.25,3,3,GTTGGAGTTCCTAATATCTC,0,856904
dgoRp,0.25,3,3,GTTGCTTCTAGGGCGTGCGC,0,858681
dgoRp,0.25,3,3,GTTGCTACGAAACATGTTAA,0,850166
dgoRp,0.25,3,3,GTTGCATCACGCCGGGGGGT,0,854902
dgoRp,0.25,3,3,GTTGAAAATTTTAGCACTGG,0,841450
dgoRp,0.25,3,3,GTTCGCTACTCGTCTATGCA,0,858929
dgoRp,0.25,3,3,GTTCCATACACTCGCAATAG,0,853343
dgoRp,0.25,3,3,GTTCAGTCGGCTTTGCTACA,0,864254
dgoRp,0.25,3,3,GTTCAAGCGCTAACCACATC,0,851715
dgoRp,0.25,3,3,GTTAACACAGGGTGGTTTCT,0,852515
dgoRp,0.25,3,3,GTTAAAAGCATCATGGTCTT,0,849686
dgoRp,0.25,3,3,GTGTGATATTCGATTTCGAT,0,856189
dgoRp,0.25,3,3,GTGTCTTAGTCGTAAAGTAG,0,849464
dgoRp,0.25,3,3,GTGGTGGTTGGAGTAGGCTC,0,861950
dgoRp,0.25,3,3,GTGGTGGTGGCACTCCTGCA,0,860111
dgoRp,0.25,3,3,GTGGCTGCACCGTTTTGTGC,0,858586
dgoRp,0.25,3,3,GTGGCTCGCGGATACGACTA,0,852751
dgoRp,0.25,3,3,GTGGCCGGGCAAATGAAAGC,0,842013
dgoRp,0.25,3,3,GTGGATTCCATTCGATAGCG,0,855856
dgoRp,0.25,3,3,GTGGAGTCGGGCGATGGTAA,0,848497
dgoRp,0.25,3,3,GTGATGTGTCTTTGCGATTG,0,857052
dgoRp,0.25,3,3,GTGATGGTGACCGGAGTCGT,0,865000
dgoRp,0.25,3,3,GTGAGGGGGCATACGATGTG,0,844986
dgoRp,0.25,3,3,GTGAATATATATGTCGTGAT,0,859461
dgoRp,0.25,3,3,GTCTCGGTGACCGGTCGTTT,0,851663
dgoRp,0.25,3,3,GTCTCGCACCTCTTAGTCAG,0,838145
dgoRp,0.25,3,3,GTCGGGAGGGTCGTTCACTT,0,866925
dgoRp,0.25,3,3,GTCGCGGAAAAGAGAAGCTA,0,838198
dgoRp,0.25,3,3,GTCCGTGTGGGCGCCAAGTC,0,864341
dgoRp,0.25,3,3,GTCCGTCCAATGACAGGCTC,0,866200
dgoRp,0.25,3,3,GTCCAGACCAGGGATCATTA,0,846676
dgoRp,0.25,3,3,GTCACGCCCGGGCGACGTTC,0,847013
dgoRp,0.25,3,3,GTCACATTCTGTGGACTGAA,0,846874
dgoRp,0.25,3,3,GTATGATCTTGTACTAAGCT,0,855151
dgoRp,0.25,3,3,GTATGAAGCTAGGACTGAAT,0,842917
dgoRp,0.25,3,3,GTATCTTATCGAACAAGGGG,0,854966
dgoRp,0.25,3,3,GTATCTCATGCGAAAGAATG,0,842598
dgoRp,0.25,3,3,GTATCGGTATGAGTGTCCAG,0,838743
dgoRp,0.25,3,3,GTAGGTGTATACGTTTAGTG,0,848738
dgoRp,0.25,3,3,GTAGGAAGTGGCTAAATTTT,0,855780
dgoRp,0.25,3,3,GTAGCCTATGGGGTAGTCAC,0,842830
dgoRp,0.25,3,3,GTACTTTGCCAGACTATCTC,0,860120
dgoRp,0.25,3,3,GTACTGATTCCAAGGTAGAC,0,850180
dgoRp,0.25,3,3,GTACGGTTCCGTCCCGCGGA,0,847145
dgoRp,0.25,3,3,GTACGACGCGCAGTGAGCAT,0,862227
dgoRp,0.25,3,3,GTACGAATGAATGGCGTCTC,0,851492
dgoRp,0.25,3,3,GTACATGTAATAATACACAC,0,842865
dgoRp,0.25,3,3,GTACATGGCAATATACGCGT,0,852846
dgoRp,0.25,3,3,GTAAGCGCGTGAACGGGTCA,0,866080
dgoRp,0.25,3,3,GTAAGCCGGCAGTGTAACGC,0,857184
dgoRp,0.25,3,3,GTAAAGATACCGTACGTCTA,0,865855
dgoRp,0.25,3,3,GTAAAATGTTACCGACCGCT,0,847747
dgoRp,0.25,3,3,GGTTTGGCGAGACTTTGCGT,0,853375
dgoRp,0.25,3,3,GGTTGCGATAACACCCATAA,0,863533
dgoRp,0.25,3,3,GGTTAGAGGCTGGTCCATCC,0,864000
dgoRp,0.25,3,3,GGTGTCTACATTCGGGAATG,0,866638
dgoRp,0.25,3,3,GGTGTCGATATGTTTCTAAT,0,858600
dgoRp,0.25,3,3,GGTGGGCCGCGTTTAGGTGA,0,839704
dgoRp,0.25,3,3,GGTGGCTTTAGCTTGGCGAG,0,864347
dgoRp,0.25,3,3,GGTGGAGGATATTTCTTCCC,0,838936
dgoRp,0.25,3,3,GGTGAGGAAGCGGGTTCACA,0,851991
dgoRp,0.25,3,3,GGTGAACGAAGTATCGTTTT,0,841991
dgoRp,0.25,3,3,GGTCGTCCGTTTGTCTTTTG,0,850636
dgoRp,0.25,3,3,GGTCCTGCTAGCGCCCTGAC,0,842426
dgoRp,0.25,3,3,GGTACCTCATTAGGATCGTA,0,845596
dgoRp,0.25,3,3,GGGTTTGGCCACGCGTGAGA,0,838395
dgoRp,0.25,3,3,GGGTTATAATGATTGGCGAA,0,860718
dgoRp,0.25,3,3,GGGTGTTAAAAAGGACCAAT,0,858802
dgoRp,0.25,3,3,GGGTCGCGCGTCAATTTTAT,0,862525
dgoRp,0.25,3,3,GGGTATCTGATAGTACATTT,0,838318
dgoRp,0.25,3,3,GGGTAGCTTCCAAATAAGAG,0,857469
dgoRp,0.25,3,3,GGGTACTCTATATCGTTGTA,0,835929
dgoRp,0.25,3,3,GGGTAAGCGCGTTGATCATG,0,858603
dgoRp,0.25,3,3,GGGGTCGGCGTCCGCCATTA,0,840779
dgoRp,0.25,3,3,GGGGTCCATGTTGTTTATGT,0,864869
dgoRp,0.25,3,3,GGGGTACCAAGTGCGTACGT,0,856919
dgoRp,0.25,3,3,GGGGGTAGGGTCCTTGCAGC,0,841129
dgoRp,0.25,3,3,GGGCTACACACCCCCAAGCA,0,860764
dgoRp,0.25,3,3,GGGCGCTGCTACAGTACACA,0,853229
dgoRp,0.25,3,3,GGGCGAACAGTGTGGCAAAG,0,840017
dgoRp,0.25,3,3,GGGCAGCCTATCGAGGGTGA,0,853400
dgoRp,0.25,3,3,GGGCACAGTTTTGTAAGCTT,0,865587
dgoRp,0.25,3,3,GGGAGGGAGGACAAATGCTT,0,852156
dgoRp,0.25,3,3,GGGACACGTAGGTATGTATG,0,843723
dgoRp,0.25,3,3,GGCTTGGGTGTAATAACGAC,0,837868
dgoRp,0.25,3,3,GGCTTCAGTACCCGGGAGTG,0,840767
dgoRp,0.25,3,3,GGCGTTTCACGTTATTTAAA,0,847474
dgoRp,0.25,3,3,GGCGTGATTTCAGGAAAGTC,0,844827
dgoRp,0.25,3,3,GGCGTCCGGCAATACGTAAT,0,854458
dgoRp,0.25,3,3,GGCGCGGAACAGCTGAATAG,0,842367
dgoRp,0.25,3,3,GGCGCCGCGAGTTTAGTAGT,0,862857
dgoRp,0.25,3,3,GGCGAGGGACATTACATTAG,0,847498
dgoRp,0.25,3,3,GGCCCTGTATCGGCAGGTTT,0,861384
dgoRp,0.25,3,3,GGCCATTGAATCTGAAGCAG,0,866350
dgoRp,0.25,3,3,GGCATATGGCACACGAGACC,0,859766
dgoRp,0.25,3,3,GGCAGGCCCGAGCGTTTTCG,0,859382
dgoRp,0.25,3,3,GGCACGGAAGAGGTGCAGAC,0,861880
dgoRp,0.25,3,3,GGATGTACACGAGACATACT,0,849806
dgoRp,0.25,3,3,GGATGCGGAGCGGATAGAAT,0,839646
dgoRp,0.25,3,3,GGATCGGATAAGCAAAGCAG,0,855790
dgoRp,0.25,3,3,GGAGTTGTGCGCGGGTTAAT,0,840239
dgoRp,0.25,3,3,GGAGTGCGGGCGATTATAAC,0,849241
dgoRp,0.25,3,3,GGAGTAATCTATAATGGTTG,0,862935
dgoRp,0.25,3,3,GGAGGGCGTCCAATCACATA,0,841779
dgoRp,0.25,3,3,GGAGCCTCCTGGGCGGCGTT,0,845454
dgoRp,0.25,3,3,GGAGAAGCTCGGCAGCGTCA,0,859493
dgoRp,0.25,3,3,GGACTCCGCAGATCGTAACA,0,842498
dgoRp,0.25,3,3,GGACGTCCGTGTGGGTTACA,0,836997
dgoRp,0.25,3,3,GGACATTTTTTAACCACATG,0,864953
dgoRp,0.25,3,3,GGAACGTCCTTTTCTGTCAC,0,857297
dgoRp,0.25,3,3,GGAACCCGGCACGGGTGTTT,0,843875
dgoRp,0.25,3,3,GGAACATAGTTGTGTTCTGT,0,846671
dgoRp,0.25,3,3,GCTTTGTAATGACTTAGTCC,0,846829
dgoRp,0.25,3,3,GCTTTGCTCGGGGTGAGTCT,0,856005
dgoRp,0.25,3,3,GCTTCCCCGTTGCTCTTGCA,0,847937
dgoRp,0.25,3,3,GCTTACAGCTCACACCAAAG,0,847386
dgoRp,0.25,3,3,GCTGCCAATGAGGGTATCAA,0,841727
dgoRp,0.25,3,3,GCTGATCACAAAAACAATTT,0,850230
dgoRp,0.25,3,3,GCTCGACATATGTCGATGGA,0,858892
dgoRp,0.25,3,3,GCTAGGTGTACCTACACTCT,0,857704
dgoRp,0.25,3,3,GCTAGAGGAGGGAATGATGT,0,838439
dgoRp,0.25,3,3,GCTAAATCCCTGCTTGATTA,0,843389
dgoRp,0.25,3,3,GCGTTAGGGGCCTACATGGA,0,857144
dgoRp,0.25,3,3,GCGTCTAGTCAAGAGTCCTT,0,842869
dgoRp,0.25,3,3,GCGTAGTGCAGACATAACCC,0,862166
dgoRp,0.25,3,3,GCGGGGATCCATGCTGGTCA,0,855424
dgoRp,0.25,3,3,GCGGCCACCTGCCCGGAAGC,0,866368
dgoRp,0.25,3,3,GCGGCAGTTTGTATGGACCC,0,850046
dgoRp,0.25,3,3,GCGGATGAGTTATCACCTCA,0,864348
dgoRp,0.25,3,3,GCGCGCATCGGATATAGTGA,0,854555
dgoRp,0.25,3,3,GCGCGCATCACGAGACCAAG,0,865700
dgoRp,0.25,3,3,GCGAGTGCGTGGTGGAATCG,0,851812
dgoRp,0.25,3,3,GCCTTCTGCCAGTGGGGCGT,0,865595
dgoRp,0.25,3,3,GCCTTAAAGATAACCCAGAG,0,857912
dgoRp,0.25,3,3,GCCCTTCGCTGTGGACTACG,0,854420
dgoRp,0.25,3,3,GCCCCGCCGGAGCACTCCGT,0,843157
dgoRp,0.25,3,3,GCCCCAACGTAGTGGTTCAG,0,842546
dgoRp,0.25,3,3,GCCATGTAGCCGCTCATGAT,0,837557
dgoRp,0.25,3,3,GCCAGTCGCCAGCTTTGGAG,0,862404
dgoRp,0.25,3,3,GCCAGTACACAGAATTGTTA,0,852088
dgoRp,0.25,3,3,GCCAGGACGGGAAACGCGAA,0,847473
dgoRp,0.25,3,3,GCATGTCATAGGGAGTCTGC,0,853905
dgoRp,0.25,3,3,GCATCGAGCGACGTTGCTGT,0,867377
dgoRp,0.25,3,3,GCATCCATGCCTGGTTCTCT,0,848176
dgoRp,0.25,3,3,GCAGTATGGAATAGGGGGCT,0,859824
dgoRp,0.25,3,3,GCAGCTTGCTGGGGTGCGGG,0,865179
dgoRp,0.25,3,3,GCAGCCCTGTAGATGCTTGG,0,839015
dgoRp,0.25,3,3,GCAGCATCTTGGCATCGTCA,0,842186
dgoRp,0.25,3,3,GCAGATACCGGTAGACCTCG,0,854921
dgoRp,0.25,3,3,GCAGAACGTGGGGTAACAAG,0,860884
dgoRp,0.25,3,3,GCAATTTCGTAAAACGCACA,0,866095
dgoRp,0.25,3,3,GCAATCCAGTACATCCCGAA,0,861183
dgoRp,0.25,3,3,GCAACAAAATCGTTAAGCTA,0,858260
dgoRp,0.25,3,3,GCAAAACGGCGACTATGTAG,0,843680
dgoRp,0.25,3,3,GATTTCACTTATGTTGATGT,0,838948
dgoRp,0.25,3,3,GATTTAAAGTCTCCATACTA,0,861332
dgoRp,0.25,3,3,GATTGGTCAATTAAATGGAC,0,845769
dgoRp,0.25,3,3,GATTCTCCCGAGCTATCGAC,0,856859
dgoRp,0.25,3,3,GATTCGCAAGGAGCTGTGCT,0,863027
dgoRp,0.25,3,3,GATTCATACGGTAGACGACC,0,867441
dgoRp,0.25,3,3,GATGTGGGAGTAGGCCGTCG,0,864519
dgoRp,0.25,3,3,GATGCCCCCATCCCTATATA,0,840233
dgoRp,0.25,3,3,GATCGTTTTTGGGATATCGT,0,853810
dgoRp,0.25,3,3,GATAACTCACATCAGCGCTT,0,855682
dgoRp,0.25,3,3,GAGTTTTGGAAGGTGGCCTG,0,848296
dgoRp,0.25,3,3,GAGCTGAGGTGACCTGTCGC,0,855683
dgoRp,0.25,3,3,GAGCATCCAGGCTTCCACAT,0,860074
dgoRp,0.25,3,3,GAGCAATCGTAGTCTCGAAT,0,860364
dgoRp,0.25,3,3,GAGATCTTTCGGAGAATTAC,0,855769
dgoRp,0.25,3,3,GAGATCGATCAGGCGTTTGT,0,837786
dgoRp,0.25,3,3,GAGAGGCAGCGGAGCCCCTG,0,848441
dgoRp,0.25,3,3,GACTATCTTCGGGAAGTAAT,0,847565
dgoRp,0.25,3,3,GACGATCGGCCCCAGTATGT,0,858546
dgoRp,0.25,3,3,GACCTCGTCCGACTGCACGA,0,844227
dgoRp,0.25,3,3,GACCTAGCTAGGCGTGTAAG,0,846287
dgoRp,0.25,3,3,GACCGTCCAGTTAGGCTCTT,0,859414
dgoRp,0.25,3,3,GACCGGTCAAGCTACAAGCA,0,842955
dgoRp,0.25,3,3,GACCGAGAAACGTAGCGGTA,0,866748
dgoRp,0.25,3,3,GACCACGGCAATAACTGACT,0,838862
dgoRp,0.25,3,3,GACAGCGACCGGTTTTTCGG,0,863061
dgoRp,0.25,3,3,GACAATCTCAAAGCGATATA,0,845309
dgoRp,0.25,3,3,GAATTCTGTAACATTTTATA,0,842184
dgoRp,0.25,3,3,GAATGTTCTACCAATAAGGG,0,842365
dgoRp,0.25,3,3,GAATCACTCAAATTAACCTT,0,841898
dgoRp,0.25,3,3,GAATAACCATACTTCCAAAA,0,839616
dgoRp,0.25,3,3,GAAGTGACAGGTAGCATCCT,0,864648
dgoRp,0.25,3,3,GAACTGCGTCATGTGGTGAC,0,864494
dgoRp,0.25,3,3,GAACGGGCCGCACACTCAAT,0,846296
dgoRp,0.25,3,3,GAAAATTTTGAGTCACCCTC,0,865583
dgoRp,0.25,3,3,GAAAACCGCTGAGACTTCTG,0,857036
dgoRp,0.25,3,3,CTTTTCTCCGCATTAGCCTG,0,844417
dgoRp,0.25,3,3,CTTTGTTATTTGGTCTTCGT,0,852042
dgoRp,0.25,3,3,CTTTGTCAATGGCTGCATGA,0,866812
dgoRp,0.25,3,3,CTTTATCATCTCCTTGGACG,0,839821
dgoRp,0.25,3,3,CTTGTTTAAGGGAGCTAACG,0,846136
dgoRp,0.25,3,3,CTTGGCCGTACCTAGGCGCA,0,862356
dgoRp,0.25,3,3,CTTGCAAAGTCAGAGTCAAC,0,861509
dgoRp,0.25,3,3,CTTGAATTTTCGCTTGTAGG,0,855452
dgoRp,0.25,3,3,CTTCGGTAATTGATACGTTC,0,847340
dgoRp,0.25,3,3,CTTCGGGCGCAGGCGGAAAA,0,849510
dgoRp,0.25,3,3,CTTCGAATATATATTCCTTA,0,852299
dgoRp,0.25,3,3,CTTCCGGTGTATAGAACCGC,0,863354
dgoRp,0.25,3,3,CTTATGCATCACCCAAAGAT,0,861275
dgoRp,0.25,3,3,CTTATAGGGGCAGGAGCCAG,0,840719
dgoRp,0.25,3,3,CTTAGTTAGTCGGAGATACG,0,836940
dgoRp,0.25,3,3,CTTAGCTTGCAAAACTTGTG,0,838600
dgoRp,0.25,3,3,CTTAGAAACTTGAGTAGAGT,0,861884
dgoRp,0.25,3,3,CTTACTTGACTCTTTGCGGT,0,860432
dgoRp,0.25,3,3,CTTACATGGCATGAGAGACA,0,852574
dgoRp,0.25,3,3,CTGTTAAGCTACAAACTTGT,0,849117
dgoRp,0.25,3,3,CTGTGTGGCTCTATTATTCT,0,859394
dgoRp,0.25,3,3,CTGTGTGCGGATGTTCAGAC,0,848588
dgoRp,0.25,3,3,CTGTCTGCCTTCGGAAATCG,0,867256
dgoRp,0.25,3,3,CTGTCGTGCTTTAAAGGACG,0,839360
dgoRp,0.25,3,3,CTGTCGGGGGGCTGTTGGTG,0,865302
dgoRp,0.25,3,3,CTGGGAATAGCGAGTTTTTG,0,863632
dgoRp,0.25,3,3,CTGGCGTTGATCGTTGCATT,0,860167
dgoRp,0.25,3,3,CTGCTCTTATCATCTACTCT,0,843394
dgoRp,0.25,3,3,CTGCGCTCACTTCGGACCGA,0,857703
dgoRp,0.25,3,3,CTGAGGGCGTTGGGCTCCAA,0,866554
dgoRp,0.25,3,3,CTGAGAATTATCAAATGTCT,0,846455
dgoRp,0.25,3,3,CTCTTAAGTCTGCTATCTTG,0,846516
dgoRp,0.25,3,3,CTCTCTATATTATCTACGGA,0,839392
dgoRp,0.25,3,3,CTCGATTTGTTAAACTGTCC,0,856403
dgoRp,0.25,3,3,CTCACACTGGGATTTCACCC,0,836177
dgoRp,0.25,3,3,CTCAAGAAGGCGATTACTCA,0,852216
dgoRp,0.25,3,3,CTATTGCAAAGGATCCCCAG,0,867063
dgoRp,0.25,3,3,CTATTCCGTTGGGCAGGCCC,0,856468
dgoRp,0.25,3,3,CTATGTAGGGAGTGGCCTTA,0,861568
dgoRp,0.25,3,3,CTATGGTAGGTACCGTATAC,0,839502
dgoRp,0.25,3,3,CTAGTGGCTTGATCCCAGCG,0,842912
dgoRp,0.25,3,3,CTAGGGAATTGGACGAGTGT,0,861363
dgoRp,0.25,3,3,CTAGCCTAAATGACCGGTGG,0,860809
dgoRp,0.25,3,3,CTAGCATACATGCACTATAA,0,852017
dgoRp,0.25,3,3,CTAGCAACTGTGCGATCAAA,0,847804
dgoRp,0.25,3,3,CTAGAACCGGTTCCAGGGGT,0,836964
dgoRp,0.25,3,3,CTACTGTATCGTCTCCAGCG,0,854947
dgoRp,0.25,3,3,CTACTGAGATCTAGAGGATC,0,860396
dgoRp,0.25,3,3,CTACGTTTTTTATAAGGACG,0,839700
dgoRp,0.25,3,3,CTACGTTTGTCCCGCGTTTG,0,858977
dgoRp,0.25,3,3,CTAATCCCGGATCCAGGCCA,0,846092
dgoRp,0.25,3,3,CTAACTTTGTCATCAGGTTC,0,838191
dgoRp,0.25,3,3,CGTGCCTAATTTTCAGATAT,0,853531
dgoRp,0.25,3,3,CGTGATCGGTTCATATAGGT,0,855256
dgoRp,0.25,3,3,CGTCTGGTGTAGCCGCGGTT,0,851174
dgoRp,0.25,3,3,CGTCACGAAAAGTAATCTCC,0,845906
dgoRp,0.25,3,3,CGTAGCTGGAGGTACGGAGC,0,845302
dgoRp,0.25,3,3,CGGTTAGGAAACAATATCGG,0,857881
dgoRp,0.25,3,3,CGGGTCCGAGCGCGGAACCT,0,845733
dgoRp,0.25,3,3,CGGGGGTTAGAACGAGGAGA,0,847901
dgoRp,0.25,3,3,CGGATTTCGCTGTTACGGAG,0,855232
dgoRp,0.25,3,3,CGGAGTTTTAATAAACCCGA,0,839768
dgoRp,0.25,3,3,CGCTGGACAGCACTCTGAAA,0,860244
dgoRp,0.25,3,3,CGCTGCGAGGACCACACGAG,0,863436
dgoRp,0.25,3,3,CGCTGCCTCAGGAGGTCCTT,0,855781
dgoRp,0.25,3,3,CGCTGAGAATACATCTGTAC,0,864788
dgoRp,0.25,3,3,CGCTAATAGTCATTAACATA,0,840372
dgoRp,0.25,3,3,CGCGTTCAGATACAAATTAT,0,865746
dgoRp,0.25,3,3,CGCGGTAGCCAAACGCGACT,0,838842
dgoRp,0.25,3,3,CGCATCAGCTCCGACATGGA,0,836021
dgoRp,0.25,3,3,CGCAGTAAAAGACGGCGATA,0,860652
dgoRp,0.25,3,3,CGATTCTAACTCGGGTGGAA,0,859420
dgoRp,0.25,3,3,CGATGGATGCATGGAGGTGC,0,856620
dgoRp,0.25,3,3,CGATGCGCAAGTTTAACCTT,0,838944
dgoRp,0.25,3,3,CGATGCAAGATAGTACGAGA,0,856070
dgoRp,0.25,3,3,CGATCGAGACGGTGTCCAAA,0,837979
dgoRp,0.25,3,3,CGATCCGAAGTTACAAAGAC,0,848998
dgoRp,0.25,3,3,CGAGGGTACGAGACAGGGCT,0,850948
dgoRp,0.25,3,3,CGAGGGGAAAGAATTTAGCC,0,861705
dgoRp,0.25,3,3,CGAGGAGTCGGGTACGGGAG,0,860530
dgoRp,0.25,3,3,CGACTTACTACAGAGCGAGG,0,849684
dgoRp,0.25,3,3,CGACGACCCCTACTTTGCTG,0,846601
dgoRp,0.25,3,3,CGACCGGCGGGACTCTGAGC,0,842267
dgoRp,0.25,3,3,CGAATGGGGATACATGACAC,0,836947
dgoRp,0.25,3,3,CGAATCGTTATTGACATTAA,0,866318
dgoRp,0.25,3,3,CGAATCGCAGTCGGGGTAGA,0,855826
dgoRp,0.25,3,3,CGAAGCGCATATAAGTCGGT,0,855169
dgoRp,0.25,3,3,CCTTTGAACTAACCGCGCGT,0,840023
dgoRp,0.25,3,3,CCTTTATTCTAGAGAAGGGC,0,847204
dgoRp,0.25,3,3,CCTTTATATACGGGAGGTCC,0,848009
dgoRp,0.25,3,3,CCTTGGCTGGGAAATCTAAC,0,848446
dgoRp,0.25,3,3,CCTTACGTCCTACGGAAAGA,0,863212
dgoRp,0.25,3,3,CCTGTTCCTAATCACAAGCG,0,861837
dgoRp,0.25,3,3,CCTGCTGTGCACGATTACGT,0,855172
dgoRp,0.25,3,3,CCTCGGGGATCAAGGGACCA,0,850387
dgoRp,0.25,3,3,CCTCCTGCCAGTGTGAACGC,0,858263
dgoRp,0.25,3,3,CCTATCAAAGGCCGGAATAT,0,852697
dgoRp,0.25,3,3,CCGTTGCTTGTCAATGTACA,0,839065
dgoRp,0.25,3,3,CCGTTACTTTAGGCCCCTCC,0,852692
dgoRp,0.25,3,3,CCGTCATACCAATACAACTG,0,862408
dgoRp,0.25,3,3,CCGGTGGGTATTTTCCGTTC,0,865148
dgoRp,0.25,3,3,CCGGGTGGCGACCGCGGGGC,0,862714
dgoRp,0.25,3,3,CCGGAGTTGACACCAGGATT,0,845257
dgoRp,0.25,3,3,CCGCTAAGTCAGAAATCTCA,0,850156
dgoRp,0.25,3,3,CCGCCTCAATGGTCGATTTT,0,866288
dgoRp,0.25,3,3,CCGACGACAGTAATCATGCC,0,857674
dgoRp,0.25,3,3,CCGAAGGGAGCATCAAGTTG,0,857240
dgoRp,0.25,3,3,CCCTTTGCTGGTAGGGCGTC,0,838892
dgoRp,0.25,3,3,CCCGGTGGAACGATGTATGT,0,855257
dgoRp,0.25,3,3,CCCCTTCCGCTCGAGATGAA,0,841159
dgoRp,0.25,3,3,CCCCGTCTCAATGCTAGAGT,0,848208
dgoRp,0.25,3,3,CCCCGTAGACGCGACCGCGA,0,858665
dgoRp,0.25,3,3,CCCACGTAGACCTATAGGCT,0,854976
dgoRp,0.25,3,3,CCCACAATCAACGAAGGCTC,0,841616
dgoRp,0.25,3,3,CCATTTTATGAAGGGCCTCG,0,844030
dgoRp,0.25,3,3,CCATTCCCGCTATAGGGGAC,0,852519
dgoRp,0.25,3,3,CCATAGGGGCGTCTCAGCAG,0,843504
dgoRp,0.25,3,3,CCAGCTACACTATCAACCTA,0,842859
dgoRp,0.25,3,3,CCAGAACAAATGGACCCGAT,0,849796
dgoRp,0.25,3,3,CCACGTCAGGAGGTATGCTG,0,837863
dgoRp,0.25,3,3,CCACGGCTGTGAGTCCTGAA,0,849545
dgoRp,0.25,3,3,CCACCGTGCCCATGGACATG,0,856836
dgoRp,0.25,3,3,CCACCGCACAACAGTACCCC,0,846524
dgoRp,0.25,3,3,CCAATAACCCTAGCTAATTA,0,850408
dgoRp,0.25,3,3,CCAAGTTGGAACCTGCGAAC,0,850775
dgoRp,0.25,3,3,CCAAGGACGTGGAGCACCGT,0,847198
dgoRp,0.25,3,3,CCAACGATGTTACAAAGGAT,0,838880
dgoRp,0.25,3,3,CCAACCGTGCTCTACGTGAA,0,844303
dgoRp,0.25,3,3,CATTTTCACCTCCGTCTTCT,0,835874
dgoRp,0.25,3,3,CATTGATTGACCACCGCCGC,0,853135
dgoRp,0.25,3,3,CATTGAGGAAGGCCACACGT,0,838710
dgoRp,0.25,3,3,CATGCGATGGATCATCTGTA,0,849849
dgoRp,0.25,3,3,CATCGTCCGCTTCCAGCGAT,0,849299
dgoRp,0.25,3,3,CATCCCAATGGGAAAGCGTC,0,858813
dgoRp,0.25,3,3,CATATCTGTACGTTGTGGGT,0,856492
dgoRp,0.25,3,3,CAGTTCCGTGGATCCATCGG,0,838045
dgoRp,0.25,3,3,CAGTAAGTGGTGGTAGCCTA,0,861627
dgoRp,0.25,3,3,CAGGGGCCAATGCAATTCTT,0,847879
dgoRp,0.25,3,3,CAGGAGAGCCTTGTGCGCCT,0,837725
dgoRp,0.25,3,3,CAGGACCAACGTTTTGCAGG,0,853448
dgoRp,0.25,3,3,CAGCCGTGCCCAGAAGCTAA,0,841299
dgoRp,0.25,3,3,CAGCCATTTCCGACGCGCGC,0,843302
dgoRp,0.25,3,3,CAGCATTTGGAGTTAGGGAC,0,867358
dgoRp,0.25,3,3,CAGCATAACAACCCCGGGGC,0,856557
dgoRp,0.25,3,3,CAGATTTTATACTGTAATGT,0,853885
dgoRp,0.25,3,3,CAGATGCACATGCTACTCTA,0,864025
dgoRp,0.25,3,3,CAGACGAGTATCGTACTACC,0,849690
dgoRp,0.25,3,3,CACTGAGGAGATGTTTCATC,0,852607
dgoRp,0.25,3,3,CACTATCCTAACTGGAAGCA,0,865115
dgoRp,0.25,3,3,CACGTATACTAGCGGAGAGT,0,860253
dgoRp,0.25,3,3,CACGGAGATTCCCCCTAGAG,0,837960
dgoRp,0.25,3,3,CACGCGTAATCCCATTTAGG,0,860506
dgoRp,0.25,3,3,CACGCAAACCTTAGTTCGCA,0,837162
dgoRp,0.25,3,3,CACCTTTGCGAATTCAGGTG,0,838138
dgoRp,0.25,3,3,CACCCGCATTATCAAAATTG,0,847814
dgoRp,0.25,3,3,CACATGGAGTTTTCTTCCGG,0,854961
dgoRp,0.25,3,3,CACATAGGGATGTCGAGGCG,0,837366
dgoRp,0.25,3,3,CACAAGGGACCGATCTTCGC,0,847014
dgoRp,0.25,3,3,CAATGGGATGAACCTATATA,0,859293
dgoRp,0.25,3,3,CAATCAGGATGGTGGTTAAT,0,850037
dgoRp,0.25,3,3,CAAGCGGAATGTCTCGGAAC,0,865778
dgoRp,0.25,3,3,CAAGAGGAATCATGATGAAA,0,847333
dgoRp,0.25,3,3,CAAGAAGTGAAGGTGGTGCT,0,837722
dgoRp,0.25,3,3,CAACCGAACCGCCGAACCCA,0,852006
dgoRp,0.25,3,3,CAAATTGCCGCCAGGCTTGG,0,863794
dgoRp,0.25,3,3,CAAATGTAATACGCATCTAC,0,855507
dgoRp,0.25,3,3,CAAAGTTTCCCGCGGGTGGT,0,852364
dgoRp,0.25,3,3,CAAAGAGATAGTGCATAAAT,0,855942
dgoRp,0.25,3,3,CAAAATCTGGAACCGGTGAG,0,849542
dgoRp,0.25,3,3,CAAAACCGGGGGTTCCAAGG,0,843911
dgoRp,0.25,3,3,ATTTAGGACCAGTTGATGAA,0,859283
dgoRp,0.25,3,3,ATTGTAGTGTGCTACCCGCT,0,858588
dgoRp,0.25,3,3,ATTGTAATTGGGCAGAGGGT,0,847638
dgoRp,0.25,3,3,ATTGGAGGGTTGCTTATCTT,0,854122
dgoRp,0.25,3,3,ATTGAGGTACTTTACGCCCT,0,852068
dgoRp,0.25,3,3,ATTCGGTATTTAGCACTGCT,0,854965
dgoRp,0.25,3,3,ATTCAAACCCGCTCTAGTTT,0,860043
dgoRp,0.25,3,3,ATTAGTACGAGGTCATCATC,0,856349
dgoRp,0.25,3,3,ATTAGGATATCTTCACAGAG,0,847805
dgoRp,0.25,3,3,ATTAGGAGCACCGGGTACAT,0,847811
dgoRp,0.25,3,3,ATTACTGTAGGCTATGTAAC,0,857419
dgoRp,0.25,3,3,ATTACTATTGGGGTAGGTTC,0,857681
dgoRp,0.25,3,3,ATGTCTCTTGTCGCTCTAAC,0,835889
dgoRp,0.25,3,3,ATGGTTCCCTGCGTGACTTA,0,850617
dgoRp,0.25,3,3,ATGGTCAAGACGGATCTGGC,0,859338
dgoRp,0.25,3,3,ATGGTAACTGTGGCGCTGGT,0,851164
dgoRp,0.25,3,3,ATGGGGGTAGCGTCGAGCAT,0,847738
dgoRp,0.25,3,3,ATGGGGCGTTTCGACCCGCA,0,861692
dgoRp,0.25,3,3,ATGGGCGAGAAATCTACGGC,0,844151
dgoRp,0.25,3,3,ATGGCTTCGTTGTCGACATC,0,841388
dgoRp,0.25,3,3,ATGCCTGTGATTGATCCACA,0,838188
dgoRp,0.25,3,3,ATGCAGGAATTTGTCTCAAT,0,851383
dgoRp,0.25,3,3,ATGCAGCGAAAGATTTACGC,0,838358
dgoRp,0.25,3,3,ATGACCTTATCGACCGGACT,0,865914
dgoRp,0.25,3,3,ATCTGTGCTTAGTGGTATTT,0,856612
dgoRp,0.25,3,3,ATCGGACAGTTTATTTTTTA,0,859200
dgoRp,0.25,3,3,ATCCCTCCCGAGTCTACAAT,0,836767
dgoRp,0.25,3,3,ATCCATGGCCAAGGGGTGCT,0,863568
dgoRp,0.25,3,3,ATCATATCCTTTAGGATGAA,0,845514
dgoRp,0.25,3,3,ATCAGCGGTCAGACCAGGAA,0,850847
dgoRp,0.25,3,3,ATCACCGCTGAAGCCTGCGC,0,852243
dgoRp,0.25,3,3,ATCAATGTCATGGCGGTCAA,0,835926
dgoRp,0.25,3,3,ATCAACATTTCTCTCGAAGT,0,841596
dgoRp,0.25,3,3,ATCAAAGGTAAGTGCAGGAG,0,853463
dgoRp,0.25,3,3,ATATGGGCAGAGGGCGTAGG,0,848792
dgoRp,0.25,3,3,ATATCAGGCGTGTGGCGGGA,0,844762
dgoRp,0.25,3,3,ATATAGAATCGTAAGTCACA,0,866681
dgoRp,0.25,3,3,ATAGCGACGCAAAGTCCCAG,0,839702
dgoRp,0.25,3,3,ATACGAGTCGGTTCGTTATT,0,861819
dgoRp,0.25,3,3,ATACCGCGCACGACAGATCC,0,836296
dgoRp,0.25,3,3,ATACATAATATTCTCAAGGA,0,853889
dgoRp,0.25,3,3,ATACAGCCAAGACTGTCGAG,0,858029
dgoRp,0.25,3,3,ATAATGTGAACGCTCGGTTA,0,846064
dgoRp,0.25,3,3,ATAAGTTCCATGTAGGGGAT,0,859434
dgoRp,0.25,3,3,ATAACGATCCGCATAGGGGT,0,856923
dgoRp,0.25,3,3,AGTGTCTACGCCGGAAGACA,0,862140
dgoRp,0.25,3,3,AGTGCTCATATGCCTACGAC,0,851065
dgoRp,0.25,3,3,AGTAGCGTCGTAGTGATCGT,0,850938
dgoRp,0.25,3,3,AGGTTTGTTGGAGAGAGGTA,0,838384
dgoRp,0.25,3,3,AGGTTGGGTTCCCCCAAATG,0,845090
dgoRp,0.25,3,3,AGGTTCTCGTAGGCGCTTGA,0,854734
dgoRp,0.25,3,3,AGGTCCTTATTTTCCAGTCT,0,844836
dgoRp,0.25,3,3,AGGTACTCGGGGATATTTAA,0,852419
dgoRp,0.25,3,3,AGGGTGACTACAACCTTCAC,0,841915
dgoRp,0.25,3,3,AGGGGGGCGTTACGCGAACG,0,854277
dgoRp,0.25,3,3,AGGGGCTGTAGGACACCGGG,0,859980
dgoRp,0.25,3,3,AGGGGCCTTGACATGCCCCC,0,839345
dgoRp,0.25,3,3,AGGGGCCTAGGATAGGACTT,0,851519
dgoRp,0.25,3,3,AGGGAGACTGGGTGGGCCGG,0,842269
dgoRp,0.25,3,3,AGGCGGCAGTCGTCGGGCAG,0,838570
dgoRp,0.25,3,3,AGGCCTCGACACCAGGAGGA,0,839992
dgoRp,0.25,3,3,AGGCAGTGAGACAATGAAAA,0,859827
dgoRp,0.25,3,3,AGGATTATTGAATACGTCGG,0,860757
dgoRp,0.25,3,3,AGGATGGCGGAAGAAAGTGC,0,862866
dgoRp,0.25,3,3,AGGATCGCATAACACCGGAT,0,862455
dgoRp,0.25,3,3,AGGAGTGGCACTTATGGACA,0,861860
dgoRp,0.25,3,3,AGGACGTACCGTATCCAGGG,0,846962
dgoRp,0.25,3,3,AGGACGCATTGAAACGGTTA,0,841016
dgoRp,0.25,3,3,AGGACCTCAGAAGAAAACCA,0,861368
dgoRp,0.25,3,3,AGGACAGTATCCGCAAGGAC,0,850251
dgoRp,0.25,3,3,AGGACAGACCCGGACAGTTG,0,837442
dgoRp,0.25,3,3,AGCTGGCGCCATATCCTAAT,0,840041
dgoRp,0.25,3,3,AGCTCCTCCCCTGGGCTCCT,0,858404
dgoRp,0.25,3,3,AGCTAGCTCTCAAGGCCACC,0,865710
dgoRp,0.25,3,3,AGCTAATCCTACTGAAAGGT,0,839898
dgoRp,0.25,3,3,AGCGTCTCACGTCATCGACT,0,838978
dgoRp,0.25,3,3,AGCGTAAATTCTGCGGTTTA,0,857053
dgoRp,0.25,3,3,AGCGGTTTAGCTTCTAGGGG,0,853271
dgoRp,0.25,3,3,AGCCCTCTGGGGCCATGCTC,0,836316
dgoRp,0.25,3,3,AGCCCCGACACTCTCAGGAC,0,851900
dgoRp,0.25,3,3,AGCACCACGCCTCCATAAAA,0,845348
dgoRp,0.25,3,3,AGATGTCCACGCAAAAGTCT,0,861801
dgoRp,0.25,3,3,AGATACCCCGGTACCTTACA,0,839238
dgoRp,0.25,3,3,AGAGGAATAGGAAAGGAGTG,0,862249
dgoRp,0.25,3,3,AGAGCGTGGAAAAGAAAAGA,0,861497
dgoRp,0.25,3,3,AGAACCACCAGGAGAAGGAC,0,862434
dgoRp,0.25,3,3,ACTTGTAATCCTCTATGCCG,0,866746
dgoRp,0.25,3,3,ACTTGCCGCGTAGCGACGAA,0,838989
dgoRp,0.25,3,3,ACTTAAAATTCTAATGTGAG,0,840281
dgoRp,0.25,3,3,ACTGTCGCATTGGTGCCGCG,0,854822
dgoRp,0.25,3,3,ACTGTCATTTGCTCTAGTAT,0,857677
dgoRp,0.25,3,3,ACTGACACCTAGAGCCCTAC,0,862864
dgoRp,0.25,3,3,ACTCGTTAGCTGCTACACTA,0,842744
dgoRp,0.25,3,3,ACTCCCTCATGTCCGCAAAT,0,853573
dgoRp,0.25,3,3,ACTCCCCTCAAGTCTTTGTG,0,865859
dgoRp,0.25,3,3,ACTCAAGGAGTCAAATTTAC,0,840526
dgoRp,0.25,3,3,ACTACTATACGTGCAGGAAG,0,854111
dgoRp,0.25,3,3,ACGTTTGGATCTAGCGAAAA,0,849807
dgoRp,0.25,3,3,ACGTTTAAAATGTCATACTA,0,855407
dgoRp,0.25,3,3,ACGTGTTACCGCACACCGAT,0,844057
dgoRp,0.25,3,3,ACGTGTATTATATTAGCAGG,0,859759
dgoRp,0.25,3,3,ACGTGTATGCTCCGCGAGTA,0,853100
dgoRp,0.25,3,3,ACGTGGCACTTCCCGACCCC,0,850391
dgoRp,0.25,3,3,ACGTGCAAACAATGGCGTGT,0,842460
dgoRp,0.25,3,3,ACGTATGGGTATTCCACCAG,0,837754
dgoRp,0.25,3,3,ACGGTGTCTGTCTCGTAACA,0,846103
dgoRp,0.25,3,3,ACGGTCGCGGTTCGGGCCTT,0,842159
dgoRp,0.25,3,3,ACGCAGCATTCGGTTGTATA,0,852833
dgoRp,0.25,3,3,ACGATGATTCCGAGGCGACA,0,853096
dgoRp,0.25,3,3,ACGAGACCCGGGCTAAGGTA,0,852986
dgoRp,0.25,3,3,ACCTTGGTGTCATACACGCA,0,841698
dgoRp,0.25,3,3,ACCTTGATCGTCCTTGGCGC,0,841191
dgoRp,0.25,3,3,ACCTTGACCCCGGATAAATG,0,848275
dgoRp,0.25,3,3,ACCTGTCTTGACTCTGCGAT,0,846605
dgoRp,0.25,3,3,ACCTATCATGTGATAACAGC,0,852802
dgoRp,0.25,3,3,ACCGTCACTGATTAGGACTA,0,848560
dgoRp,0.25,3,3,ACCGGCGCCAGTTTTTTGGT,0,866683
dgoRp,0.25,3,3,ACCGCCCTACCCAAACAGGA,0,846424
dgoRp,0.25,3,3,ACCCTTGTTCCTAGGCAAGG,0,843771
dgoRp,0.25,3,3,ACCCGTCAATCGTGAGTCTA,0,841371
dgoRp,0.25,3,3,ACCATACACAGAAGTTGTGT,0,861810
dgoRp,0.25,3,3,ACCAGGCGTACTCCGCTCCA,0,863552
dgoRp,0.25,3,3,ACCAGCGTTCTATGTCTGCG,0,852776
dgoRp,0.25,3,3,ACCACGGCGAGACCGAAGCT,0,837700
dgoRp,0.25,3,3,ACCAATACGGGAGAGGGGGT,0,844350
dgoRp,0.25,3,3,ACCAAAACTGGTGAAAACCA,0,842107
dgoRp,0.25,3,3,ACATTGGGAACCCTTGAAGG,0,854130
dgoRp,0.25,3,3,ACACTGGGCCTTAGAGATGT,0,849963
dgoRp,0.25,3,3,ACACTCTGGCAACTTAACTA,0,858075
dgoRp,0.25,3,3,ACACAACCATGAATAGCGTC,0,847980
dgoRp,0.25,3,3,ACAACAATCGTCCCAAGGGA,0,866755
dgoRp,0.25,3,3,AATTTGGCCGCTGTTGGATC,0,846331
dgoRp,0.25,3,3,AATTGCGCGAAACGCTCCAT,0,847030
dgoRp,0.25,3,3,AATGACCATCGCGCTCAAAC,0,865226
dgoRp,0.25,3,3,AATGAATGCTCACCAGTTTC,0,865860
dgoRp,0.25,3,3,AATCAATACGTGGAATTCCC,0,835952
dgoRp,0.25,3,3,AATATAGTGCCGGTTTGATG,0,857457
dgoRp,0.25,3,3,AATAGGTGGGCGACTTCGGG,0,837518
dgoRp,0.25,3,3,AAGTTAATATCGGGAAATCA,0,865649
dgoRp,0.25,3,3,AAGTGCCTGACCGTGGGGGT,0,836171
dgoRp,0.25,3,3,AAGTCTTGAATCACCGGAAG,0,854672
dgoRp,0.25,3,3,AAGGCCCGCCCTCGCCGCTG,0,849218
dgoRp,0.25,3,3,AAGCTAATCTGTGGGCGCTT,0,841495
dgoRp,0.25,3,3,AAGCACTGGATCATCTCTTT,0,857857
dgoRp,0.25,3,3,AAGACATCTTGGCCTAAATG,0,840520
dgoRp,0.25,3,3,AAGACACCCCTTCGGTTCTA,0,849111
dgoRp,0.25,3,3,AAGAAGTTACGCCCCGCTCC,0,851141
dgoRp,0.25,3,3,AAGAAAAATCAGTGGGATTG,0,857852
dgoRp,0.25,3,3,AACTTGGTGTAAGCAGGGCA,0,863389
dgoRp,0.25,3,3,AACTTGAGGTCGGACCTGCT,0,865121
dgoRp,0.25,3,3,AACGTACACCACAGCGTGTA,0,844277
dgoRp,0.25,3,3,AACGCTGTTGAGGTTTTGAC,0,859578
dgoRp,0.25,3,3,AACGCTCGCAACCGGATCTT,0,859946
dgoRp,0.25,3,3,AACCTCGATGGAAAATAGAG,0,839615
dgoRp,0.25,3,3,AACCGTTGGCACCTCTCACG,0,851059
dgoRp,0.25,3,3,AACCGGGCAGCTCATATCAC,0,853279
dgoRp,0.25,3,3,AACCATATTTCTAGTTGGGA,0,858685
dgoRp,0.25,3,3,AACCACCGCACGGCACCAGC,0,859174
dgoRp,0.25,3,3,AACAGATGTGCGTCAGCAGG,0,866948
dgoRp,0.25,3,3,AACAGAGGGACTGTTTGCCC,0,844966
dgoRp,0.25,3,3,AACACCACGCAATCATGGCT,0,852729
dgoRp,0.25,3,3,AACAACAAGTTAGGTTGAGT,0,839129
dgoRp,0.25,3,3,AAATTAGCCTTGTTTGACCT,0,843486
dgoRp,0.25,3,3,AAATGGGGTGCTTCGCGCGA,0,844658
dgoRp,0.25,3,3,AAATGCATCTGAGGGCTTTC,0,841625
dgoRp,0.25,3,3,AAATCTGGCAACTTTCTCTG,0,842591
dgoRp,0.25,3,3,AAATACCTACAGCATCGAAT,0,843602
dgoRp,0.25,3,3,AAAGTAGTACTACATATAAT,0,859329
dgoRp,0.25,3,3,AAAGCAGAAGCATTCACTGA,0,843159
dgoRp,0.25,3,3,AAAGAGCATAGCCCTTTGTA,0,860268
dgoRp,0.25,3,3,AAAGACGGTAATGTGGAAGT,0,847864
dgoRp,0.25,3,3,AAACCCAATTTTAGTGTGCC,0,850070
dgoRp,0.25,3,3,AAACAAACGGAGCATTCCGG,0,843973
dgoRp,0.25,3,3,AAAATCACGCGAATACATCA,0,860747
dgoRp,0.25,3,3,AAAACCGGGTGACATGGCCC,0,852233
dgoRp,0.25,3,3,AAAAAGTTGCAACAACCGTT,0,865424
dgoRp,0.3333333333333333,2,2,TTTTTGACTCTTGGCATCTA,0,855837
dgoRp,0.3333333333333333,2,2,TTTTCTTCAGCTGATCTGTA,0,866539
dgoRp,0.3333333333333333,2,2,TTTTCGCGTTAGTGAATGGT,0,856080
dgoRp,0.3333333333333333,2,2,TTTTATAGTTTCACAACACA,0,837413
dgoRp,0.3333333333333333,2,2,TTTGTGGAGTATCCGGTCGT,0,838913
dgoRp,0.3333333333333333,2,2,TTTGGCTTACTATTACGAAA,0,857518
dgoRp,0.3333333333333333,2,2,TTTGCAAAACAGCACATGCG,0,842526
dgoRp,0.3333333333333333,2,2,TTTGATGAAGTACCGGCAGG,0,858081
dgoRp,0.3333333333333333,2,2,TTTCTAATATGAGGTAAGCG,0,857981
dgoRp,0.3333333333333333,2,2,TTTCCTGTCCACCGACTTGG,0,866316
dgoRp,0.3333333333333333,2,2,TTTCATTTGATCCATATAAG,0,854456
dgoRp,0.3333333333333333,2,2,TTTCAAGCTGAGGTGCCAAA,0,842191
dgoRp,0.3333333333333333,2,2,TTTATTACGAAGTCTTCAAC,0,863708
dgoRp,0.3333333333333333,2,2,TTTATGAGGTTTGTGTTCAT,0,864607
dgoRp,0.3333333333333333,2,2,TTTACAACCAGGCCACACCT,0,862065
dgoRp,0.3333333333333333,2,2,TTTAATCATAAAAGGTGCAT,0,853801
dgoRp,0.3333333333333333,2,2,TTTAATATCTGCCGATGGGA,0,861796
dgoRp,0.3333333333333333,2,2,TTGTGCACATTTGCCCTATT,0,844123
dgoRp,0.3333333333333333,2,2,TTGGTGGCATTGGGGGAGAC,0,848230
dgoRp,0.3333333333333333,2,2,TTGGTGATACTTCGAGAGGT,0,856802
dgoRp,0.3333333333333333,2,2,TTGGGGCATGCGGCGTTCGC,0,853809
dgoRp,0.3333333333333333,2,2,TTGCGTATGCGATCGATGGA,0,859598
dgoRp,0.3333333333333333,2,2,TTGCCGTCATCGCTGTCCGC,0,858063
dgoRp,0.3333333333333333,2,2,TTGCCGGGTCCTAGCAACCT,0,852696
dgoRp,0.3333333333333333,2,2,TTGCCAGCTGACAGTCAAAT,0,842470
dgoRp,0.3333333333333333,2,2,TTGCAAATAACAGCATAAAT,0,837647
dgoRp,0.3333333333333333,2,2,TTGAGATCGACGCAGCAAAC,0,842271
dgoRp,0.3333333333333333,2,2,TTGAGAAAAGGCCGGGTCCC,0,846110
dgoRp,0.3333333333333333,2,2,TTGACGTGATGTTCTATTGC,0,851092
dgoRp,0.3333333333333333,2,2,TTGAAGCTCGGGCATCTCCA,0,865884
dgoRp,0.3333333333333333,2,2,TTCTTCCGGGGCCGTGCAAC,0,859094
dgoRp,0.3333333333333333,2,2,TTCTCGACCGGGGTTACGCT,0,841682
dgoRp,0.3333333333333333,2,2,TTCTACCCGGATCCCTTGAT,0,863035
dgoRp,0.3333333333333333,2,2,TTCGTTCCGCTGATAAGATT,0,859565
dgoRp,0.3333333333333333,2,2,TTCGGGTCCTTACTTCGGTG,0,857147
dgoRp,0.3333333333333333,2,2,TTCGCGATTCGGAGGTAGTG,0,858510
dgoRp,0.3333333333333333,2,2,TTCCTCTTAGGCAATAGCAT,0,839996
dgoRp,0.3333333333333333,2,2,TTCCGGTGGAAGGAATCAAC,0,836453
dgoRp,0.3333333333333333,2,2,TTCCGCAAAAGCCAGAATGC,0,857712
dgoRp,0.3333333333333333,2,2,TTCCGAGTGGCTTGAAAATG,0,862710
dgoRp,0.3333333333333333,2,2,TTCATTACGGTCGATTTGCT,0,853112
dgoRp,0.3333333333333333,2,2,TTCATGTGCTGCCTAAGGTT,0,865525
dgoRp,0.3333333333333333,2,2,TTATTGGCTTAGAATATAAG,0,853928
dgoRp,0.3333333333333333,2,2,TTATTCATTTATGAAACGAC,0,861069
dgoRp,0.3333333333333333,2,2,TTATGCCCTGATACCTGTGA,0,859905
dgoRp,0.3333333333333333,2,2,TTATGACGAGTATCTGCCTC,0,855859
dgoRp,0.3333333333333333,2,2,TTAGCCCTCAGATCTAAGTC,0,860157
dgoRp,0.3333333333333333,2,2,TTACACCACGCTTAGTGTAT,0,851685
dgoRp,0.3333333333333333,2,2,TTACAACGACATCGGGTATG,0,866953
dgoRp,0.3333333333333333,2,2,TTAATGTCTCATCCATGATT,0,846239
dgoRp,0.3333333333333333,2,2,TTAATCCGAAACATGTGCGC,0,860606
dgoRp,0.3333333333333333,2,2,TTAAGCGTGGAGCAAAGGCT,0,862908
dgoRp,0.3333333333333333,2,2,TTAAAACTCGGGATCAAATG,0,838838
dgoRp,0.3333333333333333,2,2,TGTTTGGGCAAGCTCTCTTG,0,847616
dgoRp,0.3333333333333333,2,2,TGTTGGCACATAGGTCGCCT,0,843598
dgoRp,0.3333333333333333,2,2,TGTTACGAAAAGAGCTATAG,0,848019
dgoRp,0.3333333333333333,2,2,TGTTACCCCTTTTGACTAGC,0,850870
dgoRp,0.3333333333333333,2,2,TGTGTCTCAGGTCTGGCTGT,0,848561
dgoRp,0.3333333333333333,2,2,TGTCATAGCGAGGCAGTCTT,0,837477
dgoRp,0.3333333333333333,2,2,TGTCACCGATGTAGCGCGAA,0,860612
dgoRp,0.3333333333333333,2,2,TGTATCGTCACAGTATCTAT,0,843452
dgoRp,0.3333333333333333,2,2,TGTATATGTGCTATATGCCA,0,845198
dgoRp,0.3333333333333333,2,2,TGTACGCATATTTGAAAACT,0,856339
dgoRp,0.3333333333333333,2,2,TGTACAAGTCTTATGGACAT,0,860196
dgoRp,0.3333333333333333,2,2,TGGTTAATCACGCTCTAACA,0,846699
dgoRp,0.3333333333333333,2,2,TGGTCTAATTATACTCAGCT,0,853659
dgoRp,0.3333333333333333,2,2,TGGTCGCTCCTGCGATCTAC,0,862122
dgoRp,0.3333333333333333,2,2,TGGTATAGTGAAAATGGGAA,0,864455
dgoRp,0.3333333333333333,2,2,TGGGTTGCTTAATGGAACTA,0,859060
dgoRp,0.3333333333333333,2,2,TGGGATCATACTCGTCGCCT,0,836221
dgoRp,0.3333333333333333,2,2,TGGGATACGGCAAAGAGCCC,0,842902
dgoRp,0.3333333333333333,2,2,TGGGACCCCAACCCGCCGGT,0,860954
dgoRp,0.3333333333333333,2,2,TGGCTCAGTAGTTTGATAGT,0,842540
dgoRp,0.3333333333333333,2,2,TGGCCCCTGTAACCTAATTA,0,853993
dgoRp,0.3333333333333333,2,2,TGGCAGTACGTGGGTTCCTT,0,859920
dgoRp,0.3333333333333333,2,2,TGGATGTAGAGTAAAACCCC,0,865183
dgoRp,0.3333333333333333,2,2,TGGATATGTTGCAAGAATGG,0,846530
dgoRp,0.3333333333333333,2,2,TGGACCTTCTTTCGCACTGA,0,839797
dgoRp,0.3333333333333333,2,2,TGGAAGTGCGGCGGCGCACC,0,867308
dgoRp,0.3333333333333333,2,2,TGGAAGTAAGGCCACCAGCA,0,841876
dgoRp,0.3333333333333333,2,2,TGCTTCCGTGGTGGTTTTCC,0,861280
dgoRp,0.3333333333333333,2,2,TGCTGATCCACAACCTGGCT,0,850330
dgoRp,0.3333333333333333,2,2,TGCTCGGGCAATACCCGAGG,0,848000
dgoRp,0.3333333333333333,2,2,TGCTCACTGTGCATGGCTGC,0,842379
dgoRp,0.3333333333333333,2,2,TGCGGAACTTACAGGGATGG,0,841018
dgoRp,0.3333333333333333,2,2,TGCCTGCGTGCCTTAAAGGT,0,840227
dgoRp,0.3333333333333333,2,2,TGCCTCTGGGCGCAGCCTAT,0,835880
dgoRp,0.3333333333333333,2,2,TGCCGTAGTCTCTTTTAAAT,0,842328
dgoRp,0.3333333333333333,2,2,TGCATCCCGTGTTCATCTAT,0,860696
dgoRp,0.3333333333333333,2,2,TGCACTCAGAGCCCTGCGTG,0,866112
dgoRp,0.3333333333333333,2,2,TGCACCAATCCTGCGACGTT,0,858632
dgoRp,0.3333333333333333,2,2,TGCAATCAGTTATTAGGGGG,0,862298
dgoRp,0.3333333333333333,2,2,TGAGGCACTTAGGGGAACAT,0,856945
dgoRp,0.3333333333333333,2,2,TGAGCCCGCTGTAACCTCAA,0,851285
dgoRp,0.3333333333333333,2,2,TGACGCTCAACTTCGGCCTG,0,861243
dgoRp,0.3333333333333333,2,2,TGAATGAAGTAATCAGCCTT,0,857691
dgoRp,0.3333333333333333,2,2,TGAATCAAGGATTCCACCAA,0,858773
dgoRp,0.3333333333333333,2,2,TGAAGGTACAATAGAAAGGC,0,858269
dgoRp,0.3333333333333333,2,2,TGAACACACCTCATGCCCGA,0,841873
dgoRp,0.3333333333333333,2,2,TCTTTGCAGGCTGCGCTTAC,0,847034
dgoRp,0.3333333333333333,2,2,TCTTTCACTCTTTATACACA,0,857343
dgoRp,0.3333333333333333,2,2,TCTGTTGATGTTTCAATATG,0,864329
dgoRp,0.3333333333333333,2,2,TCTGTGCATTCAAGGGAGAT,0,848622
dgoRp,0.3333333333333333,2,2,TCTGGCAAGGGCAGCCCCTG,0,866684
dgoRp,0.3333333333333333,2,2,TCTCCAGTGCAGGGGTTGAT,0,854506
dgoRp,0.3333333333333333,2,2,TCTCAACCTAGTCCGGTTGT,0,838508
dgoRp,0.3333333333333333,2,2,TCTATTGCAATTTACTCCAG,0,865568
dgoRp,0.3333333333333333,2,2,TCTATAACTTAGATTCCGCT,0,848227
dgoRp,0.3333333333333333,2,2,TCTAGGCTCGAGCGCACTCG,0,846326
dgoRp,0.3333333333333333,2,2,TCTAGGCGTTTTCGCTCCTT,0,836524
dgoRp,0.3333333333333333,2,2,TCTACATCGTTCTAACATGC,0,866984
dgoRp,0.3333333333333333,2,2,TCTAAGTCCCTTGTCTGTAA,0,860096
dgoRp,0.3333333333333333,2,2,TCGTTCTTGTATGTAACGAA,0,861733
dgoRp,0.3333333333333333,2,2,TCGTTATGCGCCGTCGTTCG,0,845194
dgoRp,0.3333333333333333,2,2,TCGTTAATTGCCTTTGGATA,0,840640
dgoRp,0.3333333333333333,2,2,TCGTGGGCCGGCGGTTGGGG,0,861141
dgoRp,0.3333333333333333,2,2,TCGTCCGATCTGCGCACTAC,0,836495
dgoRp,0.3333333333333333,2,2,TCGGCATTCGGGATATAGAC,0,844411
dgoRp,0.3333333333333333,2,2,TCGGATTATGTTTAAGAGCG,0,865123
dgoRp,0.3333333333333333,2,2,TCGGACTGTAACTCGCATCG,0,839938
dgoRp,0.3333333333333333,2,2,TCGCAGGGGATAAATGTGCA,0,848431
dgoRp,0.3333333333333333,2,2,TCGCAACGCTATATACGTGG,0,863105
dgoRp,0.3333333333333333,2,2,TCGACGTTCGGTCTAAGGAT,0,866506
dgoRp,0.3333333333333333,2,2,TCGAAAAGTGTGAGAGTACA,0,847259
dgoRp,0.3333333333333333,2,2,TCCTTTGCTCTCGAGCTGGT,0,845192
dgoRp,0.3333333333333333,2,2,TCCTTCCTATGTAGCCGTTT,0,863313
dgoRp,0.3333333333333333,2,2,TCCGTACGTTTCGCCATTTT,0,836853
dgoRp,0.3333333333333333,2,2,TCCGGTCTCAATCGTGCAAC,0,849367
dgoRp,0.3333333333333333,2,2,TCCGCTATTTGTCTCGCTCG,0,863619
dgoRp,0.3333333333333333,2,2,TCCGACTATATGAAGTCGCC,0,864886
dgoRp,0.3333333333333333,2,2,TCCCTTGGTGCGGACCTCTT,0,846836
dgoRp,0.3333333333333333,2,2,TCCCGGGTGTATTACACTAG,0,864825
dgoRp,0.3333333333333333,2,2,TCCCCTGTTAATCTGGTATA,0,849708
dgoRp,0.3333333333333333,2,2,TCCAGCATTCATCACTTAGC,0,837160
dgoRp,0.3333333333333333,2,2,TCCACGTGAATAGCATCTTG,0,855819
dgoRp,0.3333333333333333,2,2,TCCACCGACTATTCGCGGGC,0,838903
dgoRp,0.3333333333333333,2,2,TCATGGATCGTCTCATAAGT,0,855004
dgoRp,0.3333333333333333,2,2,TCATCGTTGCGGTCAACCAA,0,839785
dgoRp,0.3333333333333333,2,2,TCATCCCCGGGTTTCCTTTG,0,850047
dgoRp,0.3333333333333333,2,2,TCATATTACCCCAACACGGC,0,866234
dgoRp,0.3333333333333333,2,2,TCAGTTTGGAAATTTCGCTC,0,851163
dgoRp,0.3333333333333333,2,2,TCAGGGTAGTTCTCAGAAAA,0,850234
dgoRp,0.3333333333333333,2,2,TCAGCAAGGAATATTTCCCA,0,843307
dgoRp,0.3333333333333333,2,2,TCAGACGGGGACGCCAATCG,0,852449
dgoRp,0.3333333333333333,2,2,TCAGACGGGAGGCGCCTTCA,0,847920
dgoRp,0.3333333333333333,2,2,TCAGACGCTCGTGTAGGTCT,0,853707
dgoRp,0.3333333333333333,2,2,TCACGGGACCGTCATTAGTC,0,844171
dgoRp,0.3333333333333333,2,2,TCACCAGTCTCCAAAGCAAT,0,864064
dgoRp,0.3333333333333333,2,2,TCAATGGTTGCTTGTTAAGA,0,845343
dgoRp,0.3333333333333333,2,2,TCAATCTTAATGAGCAGGGT,0,850489
dgoRp,0.3333333333333333,2,2,TCAATCTCCGCCGATATCGC,0,855271
dgoRp,0.3333333333333333,2,2,TCAAGGTTTTGCTCTCGTGG,0,853813
dgoRp,0.3333333333333333,2,2,TCAAGATTAGTAGACTATAC,0,849735
dgoRp,0.3333333333333333,2,2,TCAAATCTGACCTGTTTATC,0,849293
dgoRp,0.3333333333333333,2,2,TATTCGTGACCCGAGTATAG,0,854508
dgoRp,0.3333333333333333,2,2,TATTCAAGGTACGAGAGCGT,0,858900
dgoRp,0.3333333333333333,2,2,TATTCAAGCATTAGACACCT,0,854932
dgoRp,0.3333333333333333,2,2,TATTATTCGAGACAGGAAAA,0,841756
dgoRp,0.3333333333333333,2,2,TATGTTCGTTTCGGCGATTG,0,843074
dgoRp,0.3333333333333333,2,2,TATGTATGAAGTGTGGCACC,0,865478
dgoRp,0.3333333333333333,2,2,TATGTAATCATTGAGAAAAA,0,849834
dgoRp,0.3333333333333333,2,2,TATGGATCTTGTAGCCTGTT,0,836425
dgoRp,0.3333333333333333,2,2,TATGCTATATCGCCTTAGGT,0,846277
dgoRp,0.3333333333333333,2,2,TATGCTAATATACCACAGGC,0,865311
dgoRp,0.3333333333333333,2,2,TATCGTTAGCCGCCCCTGGC,0,859694
dgoRp,0.3333333333333333,2,2,TATCCGTGCAGAGGTCTGGC,0,852282
dgoRp,0.3333333333333333,2,2,TATCACTGAAATTTTGTCGC,0,851887
dgoRp,0.3333333333333333,2,2,TATCACAGTCCTTACTCAAA,0,852337
dgoRp,0.3333333333333333,2,2,TATCAAGTCCTCTGTCCATA,0,848833
dgoRp,0.3333333333333333,2,2,TATATAAAACATAGAAGCGA,0,857043
dgoRp,0.3333333333333333,2,2,TATACACGTAGAGGTACTAC,0,859199
dgoRp,0.3333333333333333,2,2,TATAATTGAAACTACTTGCT,0,843963
dgoRp,0.3333333333333333,2,2,TAGTAATTATGCGTCTCTGG,0,849713
dgoRp,0.3333333333333333,2,2,TAGGTGTTGATATTGGCCGA,0,852790
dgoRp,0.3333333333333333,2,2,TAGGTGTCGAAGGCTCGGCC,0,846466
dgoRp,0.3333333333333333,2,2,TAGGGGTACGGTGCTCTGAG,0,848822
dgoRp,0.3333333333333333,2,2,TAGGCCGAGGAGTAAACCTG,0,865042
dgoRp,0.3333333333333333,2,2,TAGCGGGACTGCGAGTGCGA,0,863490
dgoRp,0.3333333333333333,2,2,TAGCGAGTATCATCTAGATT,0,850276
dgoRp,0.3333333333333333,2,2,TAGCCTTTCCGACAACATCG,0,857368
dgoRp,0.3333333333333333,2,2,TAGCAGGGCCGGTACAGGGG,0,848647
dgoRp,0.3333333333333333,2,2,TAGAGCGCATAACATTAGTA,0,863252
dgoRp,0.3333333333333333,2,2,TAGAGAGGCGCGTCACGTTC,0,856642
dgoRp,0.3333333333333333,2,2,TAGACCTACTGTGCCATCGC,0,843733
dgoRp,0.3333333333333333,2,2,TACTTTCGAAAAAATTGTTA,0,863461
dgoRp,0.3333333333333333,2,2,TACTGTGACACTAAGCCGAG,0,856570
dgoRp,0.3333333333333333,2,2,TACTCTGATAGAGAATGGTG,0,848228
dgoRp,0.3333333333333333,2,2,TACGCTAAACCAAATTGGTC,0,854241
dgoRp,0.3333333333333333,2,2,TACGCAAATGCCACACATAG,0,853716
dgoRp,0.3333333333333333,2,2,TACCCTCGCTCCAGTGTCGT,0,859812
dgoRp,0.3333333333333333,2,2,TACAGGACCCATTGAGGTGA,0,859518
dgoRp,0.3333333333333333,2,2,TACACGTCGGTGCAAGAAGC,0,837215
dgoRp,0.3333333333333333,2,2,TACAAGTACCAGATACCAAC,0,841331
dgoRp,0.3333333333333333,2,2,TAAGGCCTACGGGGGATCAA,0,856293
dgoRp,0.3333333333333333,2,2,TAAGAGAAGAGGCCGGCCAA,0,848174
dgoRp,0.3333333333333333,2,2,TAACAAGGGTTGCTTAACTG,0,843675
dgoRp,0.3333333333333333,2,2,TAAATAAGCAAAGCTCACAT,0,865966
dgoRp,0.3333333333333333,2,2,GTTTCTGCGGTACATCATAG,0,849846
dgoRp,0.3333333333333333,2,2,GTTTCTATCGAGGAATCCAG,0,847812
dgoRp,0.3333333333333333,2,2,GTTTAAAAATGATCCCCCGG,0,837815
dgoRp,0.3333333333333333,2,2,GTTGTAAGAAGCATTTGAGG,0,836329
dgoRp,0.3333333333333333,2,2,GTTCTGTTTGGGTCAGATTT,0,841162
dgoRp,0.3333333333333333,2,2,GTTCTGCACATACCTCACTT,0,863939
dgoRp,0.3333333333333333,2,2,GTTCTCTCAACGTTTCATGC,0,849554
dgoRp,0.3333333333333333,2,2,GTTCTCAATGAGGGGGCGGT,0,844054
dgoRp,0.3333333333333333,2,2,GTTCGAGTCGGAATGGAGTA,0,861607
dgoRp,0.3333333333333333,2,2,GTTCCTAGCGGTTGATAGGA,0,849885
dgoRp,0.3333333333333333,2,2,GTTACGGGGCAAATTCGAGA,0,844266
dgoRp,0.3333333333333333,2,2,GTGTATTAAGGGGGTACTCA,0,856239
dgoRp,0.3333333333333333,2,2,GTGGGAACAACGTCAAAAAA,0,837567
dgoRp,0.3333333333333333,2,2,GTGCCTGCACGTAAGCTGTT,0,861247
dgoRp,0.3333333333333333,2,2,GTGCCGGCACGTCCGATGTT,0,862970
dgoRp,0.3333333333333333,2,2,GTGCATTCGATCGTGATTAG,0,839411
dgoRp,0.3333333333333333,2,2,GTGATGATCGATGACCCTCG,0,838279
dgoRp,0.3333333333333333,2,2,GTGATATCGAAGTCCCTAGA,0,859537
dgoRp,0.3333333333333333,2,2,GTGATAGTCAGTTTGGGTCG,0,862687
dgoRp,0.3333333333333333,2,2,GTGACCCCGCGAGGCGTTAA,0,850074
dgoRp,0.3333333333333333,2,2,GTGAAGCCTTTCGACGAACT,0,840277
dgoRp,0.3333333333333333,2,2,GTGAAATTCGTGACTCGGAT,0,863208
dgoRp,0.3333333333333333,2,2,GTCTTGTCAGGCTTCGGCAA,0,858800
dgoRp,0.3333333333333333,2,2,GTCTGTGGGTTCAAGATCTA,0,855106
dgoRp,0.3333333333333333,2,2,GTCTCTGCCGACCGAACGTC,0,866083
dgoRp,0.3333333333333333,2,2,GTCTCGATTCGGCGGCACGC,0,849597
dgoRp,0.3333333333333333,2,2,GTCTCATGTCCAAAGACAAG,0,860107
dgoRp,0.3333333333333333,2,2,GTCTATTTGTTCCGTCCAAA,0,848025
dgoRp,0.3333333333333333,2,2,GTCTATAACACCTACCAGGG,0,842928
dgoRp,0.3333333333333333,2,2,GTCTAATCGTAGCGCTTCAT,0,846677
dgoRp,0.3333333333333333,2,2,GTCTAAGCTAGCAATAACCT,0,841575
dgoRp,0.3333333333333333,2,2,GTCGTTAGAATCTACGTTAG,0,855295
dgoRp,0.3333333333333333,2,2,GTCGTGGAAGTTGTCCGTGC,0,853653
dgoRp,0.3333333333333333,2,2,GTCGCGCATCGGAGGATATG,0,839228
dgoRp,0.3333333333333333,2,2,GTCGAATAGTTTTGGGCCTG,0,843097
dgoRp,0.3333333333333333,2,2,GTCCTTAATTATGTCAGTTC,0,858042
dgoRp,0.3333333333333333,2,2,GTCCACGCCGTCGGGTTAAA,0,862529
dgoRp,0.3333333333333333,2,2,GTCCACATTACTCTACGTCC,0,837303
dgoRp,0.3333333333333333,2,2,GTCATGCCCAGGCCGGTGGC,0,849780
dgoRp,0.3333333333333333,2,2,GTCACTTTGAAGTGGGGACA,0,842686
dgoRp,0.3333333333333333,2,2,GTATACAGTTGCAATCATCG,0,867303
dgoRp,0.3333333333333333,2,2,GTAGGGCGGGATCGTGACTT,0,850492
dgoRp,0.3333333333333333,2,2,GTAGGCGAGTTTGAGCCGTT,0,836542
dgoRp,0.3333333333333333,2,2,GTAGCTTATCGGTGTGAGAC,0,847219
dgoRp,0.3333333333333333,2,2,GTAGCAGGCGATCACAGCAG,0,843310
dgoRp,0.3333333333333333,2,2,GTAGCAGGCATGCCATCCGG,0,851960
dgoRp,0.3333333333333333,2,2,GTAGAGCTCTTGATGCTAGG,0,863531
dgoRp,0.3333333333333333,2,2,GTAGACTGATTGCACCGAAG,0,866591
dgoRp,0.3333333333333333,2,2,GTAGACAGTCCATCTAACTG,0,837003
dgoRp,0.3333333333333333,2,2,GTACTGTAGTGACGGATCTT,0,852970
dgoRp,0.3333333333333333,2,2,GTACTGAGGCCAGTGTTCGG,0,858831
dgoRp,0.3333333333333333,2,2,GTACCGGGCAACAAAGGAAC,0,840392
dgoRp,0.3333333333333333,2,2,GTACACATGATCGTTACTGA,0,845616
dgoRp,0.3333333333333333,2,2,GTACAAGCGGCGCTGGTTAA,0,859193
dgoRp,0.3333333333333333,2,2,GTAATTCGTTGCATCATTCC,0,853328
dgoRp,0.3333333333333333,2,2,GTAATTAATCCTCGTGCTTG,0,851558
dgoRp,0.3333333333333333,2,2,GTAATCCAGCGGTGTTGCGT,0,857292
dgoRp,0.3333333333333333,2,2,GTAATAGCTAGAAGTAGTCA,0,845857
dgoRp,0.3333333333333333,2,2,GTAATAATTCGTAATTTCTA,0,855394
dgoRp,0.3333333333333333,2,2,GTAAGATGAAGCAGTGAGTT,0,859165
dgoRp,0.3333333333333333,2,2,GTAAAACATCTCAGCTCTCA,0,860856
dgoRp,0.3333333333333333,2,2,GGTTTGGCAAAGTTCCGCGC,0,862535
dgoRp,0.3333333333333333,2,2,GGTTGAGCGCAACCATGGGG,0,843554
dgoRp,0.3333333333333333,2,2,GGTGTGGAACGTTAATCATG,0,858990
dgoRp,0.3333333333333333,2,2,GGTGGTCTCTCAATCGCCAG,0,864256
dgoRp,0.3333333333333333,2,2,GGTCTGCCGGCTGTAGTGTA,0,840987
dgoRp,0.3333333333333333,2,2,GGTCTAGTTGTGGGCCGAAA,0,855254
dgoRp,0.3333333333333333,2,2,GGTCCCATATCTCGCTAAGC,0,846109
dgoRp,0.3333333333333333,2,2,GGTAGGTATGAAGGTGCTAT,0,844970
dgoRp,0.3333333333333333,2,2,GGTACCGTCCTAGAAACCCT,0,853775
dgoRp,0.3333333333333333,2,2,GGTACAAGGGACCTAAAGAA,0,839825
dgoRp,0.3333333333333333,2,2,GGTAAGGTATCTCTACCCAA,0,854112
dgoRp,0.3333333333333333,2,2,GGGTTAGTCTTACGTGATGA,0,856427
dgoRp,0.3333333333333333,2,2,GGGGTCTGATGGTGCTGGCA,0,845340
dgoRp,0.3333333333333333,2,2,GGGGTAAGACCAGATAAGGC,0,859677
dgoRp,0.3333333333333333,2,2,GGGGGACTCCAACGGATCCT,0,848798
dgoRp,0.3333333333333333,2,2,GGGGCCATCACAGGCTCCGT,0,850384
dgoRp,0.3333333333333333,2,2,GGGCTGAAAAATCGTCTTAA,0,864557
dgoRp,0.3333333333333333,2,2,GGGCTCGCCTCCTCGGCCTT,0,860762
dgoRp,0.3333333333333333,2,2,GGGCTCGCAAATTAGACGGA,0,862496
dgoRp,0.3333333333333333,2,2,GGGCAGTTTGACCTGCCGTC,0,850634
dgoRp,0.3333333333333333,2,2,GGGATAGCTCCTTTCCTCAT,0,842656
dgoRp,0.3333333333333333,2,2,GGGACTCATCCCGTCACAGA,0,863980
dgoRp,0.3333333333333333,2,2,GGGACCGGTTGAGATCATCT,0,860988
dgoRp,0.3333333333333333,2,2,GGGACATCCTCCAAACTATG,0,863314
dgoRp,0.3333333333333333,2,2,GGCTTTGATCATAACCACCG,0,849370
dgoRp,0.3333333333333333,2,2,GGCTGTGCCCTGGAAGGCTT,0,858419
dgoRp,0.3333333333333333,2,2,GGCTGAGCATATAGAACAAG,0,845827
dgoRp,0.3333333333333333,2,2,GGCTCGTGTGTGACGAATTC,0,845549
dgoRp,0.3333333333333333,2,2,GGCGGGGGCGTCAACCCTGG,0,855718
dgoRp,0.3333333333333333,2,2,GGCGGATAGCCAGTAGAGCG,0,859909
dgoRp,0.3333333333333333,2,2,GGCGCGACCTCGCCTCCCAA,0,849445
dgoRp,0.3333333333333333,2,2,GGCGACCCCCCGCGATGGAT,0,837817
dgoRp,0.3333333333333333,2,2,GGCCTTCGTAGTATGCGATG,0,860754
dgoRp,0.3333333333333333,2,2,GGCCGTGAAAGTTTCTATTA,0,851196
dgoRp,0.3333333333333333,2,2,GGCAGTGGAACGAGATCGTT,0,865511
dgoRp,0.3333333333333333,2,2,GGCAGGTGTCGGGCAATTTC,0,836167
dgoRp,0.3333333333333333,2,2,GGCAGGTAGATCCCCCATTA,0,847930
dgoRp,0.3333333333333333,2,2,GGCAGCAGGCGATAATGTAT,0,841558
dgoRp,0.3333333333333333,2,2,GGCACGGTCAAAGAAAATGA,0,859671
dgoRp,0.3333333333333333,2,2,GGCAATGGCAAGTGTCCAAA,0,864858
dgoRp,0.3333333333333333,2,2,GGATGGGTTTCTTATATATC,0,845012
dgoRp,0.3333333333333333,2,2,GGATGGGGCTGATAAGGCAT,0,864234
dgoRp,0.3333333333333333,2,2,GGATGCAAGGAACCGTCAAG,0,863327
dgoRp,0.3333333333333333,2,2,GGATGACTAGCTCGCTGTGC,0,866903
dgoRp,0.3333333333333333,2,2,GGATCACTGGAATTGCATCT,0,854476
dgoRp,0.3333333333333333,2,2,GGAGTTGGGTGGTCTAGATC,0,862644
dgoRp,0.3333333333333333,2,2,GGAGGACTTTTAATCGATTC,0,847352
dgoRp,0.3333333333333333,2,2,GGAGCTGACCTGAGGTTGGG,0,858151
dgoRp,0.3333333333333333,2,2,GGAGCATCTCACTGATATAA,0,855239
dgoRp,0.3333333333333333,2,2,GGAATGGGGTCAAATATCCC,0,859454
dgoRp,0.3333333333333333,2,2,GGAACTAATCAGGGTCACAA,0,853648
dgoRp,0.3333333333333333,2,2,GGAAAGTATGAGTGGCACGA,0,844578
dgoRp,0.3333333333333333,2,2,GCTTTCAGGGTCCTTAATCA,0,850340
dgoRp,0.3333333333333333,2,2,GCTTGTTAGAGAGTGCCGGT,0,864518
dgoRp,0.3333333333333333,2,2,GCTTGCCCCTATCACCGTCG,0,850255
dgoRp,0.3333333333333333,2,2,GCTGTTTGCTACAAAGGCGA,0,862950
dgoRp,0.3333333333333333,2,2,GCTGTTCCACCAACGCCAAA,0,841153
dgoRp,0.3333333333333333,2,2,GCTGTAACTCGGGTGGTATA,0,845465
dgoRp,0.3333333333333333,2,2,GCTGCTATAGATAGAGGTGA,0,864636
dgoRp,0.3333333333333333,2,2,GCTGACATGGAGTCAAAGAT,0,860620
dgoRp,0.3333333333333333,2,2,GCTCCACCCGGGGCTTCGGA,0,856931
dgoRp,0.3333333333333333,2,2,GCTCACACTAATCCGCGGAT,0,851970
dgoRp,0.3333333333333333,2,2,GCTATCCTACCTTATCATTT,0,835901
dgoRp,0.3333333333333333,2,2,GCTAGGTGTTGTGACTTCAT,0,849719
dgoRp,0.3333333333333333,2,2,GCTAGCGTGGGGTGCCCCTA,0,853252
dgoRp,0.3333333333333333,2,2,GCGTTCTCGATCGTGAAGGT,0,843012
dgoRp,0.3333333333333333,2,2,GCGTTAACGAACCAACGAGT,0,857658
dgoRp,0.3333333333333333,2,2,GCGTGCATTCGAAGGTAATT,0,865780
dgoRp,0.3333333333333333,2,2,GCGTCTATACTTGAACACTT,0,858237
dgoRp,0.3333333333333333,2,2,GCGGTCCATATTATGTGCCA,0,863346
dgoRp,0.3333333333333333,2,2,GCGGCTCGTGTCGCGTATGC,0,841629
dgoRp,0.3333333333333333,2,2,GCGCATGGCTTTATTGCGGA,0,840986
dgoRp,0.3333333333333333,2,2,GCGCACGGTTCCGAGGCTCT,0,844873
dgoRp,0.3333333333333333,2,2,GCGATGTTTGGGTCTATTGT,0,862740
dgoRp,0.3333333333333333,2,2,GCGAGGTGTGTCTGCACTCG,0,843653
dgoRp,0.3333333333333333,2,2,GCGAGCTAAGGTATGCAATT,0,854951
dgoRp,0.3333333333333333,2,2,GCCTGGTAAACTAGCACAAC,0,839970
dgoRp,0.3333333333333333,2,2,GCCTGGAGTTACTGGGTCCG,0,859377
dgoRp,0.3333333333333333,2,2,GCCGACACCGCGGTTCTTAA,0,848607
dgoRp,0.3333333333333333,2,2,GCCGAATGTGACCAGTCAGA,0,846520
dgoRp,0.3333333333333333,2,2,GCCCTGGGAAGTATTGGGGT,0,835873
dgoRp,0.3333333333333333,2,2,GCCCTGACTATATAAGGATC,0,848082
dgoRp,0.3333333333333333,2,2,GCCCTATTCGTAAGTAACAG,0,846170
dgoRp,0.3333333333333333,2,2,GCCCCTGGTTCGGGCAAGAA,0,851350
dgoRp,0.3333333333333333,2,2,GCCAGAGCTGCCCCGCGTGG,0,863715
dgoRp,0.3333333333333333,2,2,GCCAGACACTGTTGATGTAG,0,867157
dgoRp,0.3333333333333333,2,2,GCCAATTCCGCGACATGAGA,0,841739
dgoRp,0.3333333333333333,2,2,GCCAAGCTTGAACAGGCCGG,0,854346
dgoRp,0.3333333333333333,2,2,GCCAAATCAATATCTTACCC,0,843780
dgoRp,0.3333333333333333,2,2,GCATAGGGCTAACAGGTCTG,0,847133
dgoRp,0.3333333333333333,2,2,GCATAAATGCTTTGCGTCCA,0,850794
dgoRp,0.3333333333333333,2,2,GCAGGACACAGACAAACAGT,0,851184
dgoRp,0.3333333333333333,2,2,GCACCTTAATTTTGGAGCGC,0,842872
dgoRp,0.3333333333333333,2,2,GCACCTGGCTTTGGTTAGGC,0,838745
dgoRp,0.3333333333333333,2,2,GCACCCTGTGAGTGTCGATG,0,838266
dgoRp,0.3333333333333333,2,2,GCAATGGGGATAACGACGAC,0,855821
dgoRp,0.3333333333333333,2,2,GCAACAATCTAAATGCCAAT,0,836818
dgoRp,0.3333333333333333,2,2,GATTTAAACCTGGGGTACCC,0,856971
dgoRp,0.3333333333333333,2,2,GATTCCCCAATAGCGGAGGA,0,854370
dgoRp,0.3333333333333333,2,2,GATTATGCGGGCTGTACTTT,0,855566
dgoRp,0.3333333333333333,2,2,GATTACACTACACTTCCTGC,0,862050
dgoRp,0.3333333333333333,2,2,GATGGAGATTTCCCACAGAG,0,839731
dgoRp,0.3333333333333333,2,2,GATCTGATCTTTCCCTCACA,0,866988
dgoRp,0.3333333333333333,2,2,GATCGGATATTCTGGCTCTG,0,839994
dgoRp,0.3333333333333333,2,2,GATCGAGTGCTCCGGTTTGT,0,862321
dgoRp,0.3333333333333333,2,2,GATCATACAGAAAACGCAGC,0,842495
dgoRp,0.3333333333333333,2,2,GATATTGGTGCTACGTGAGA,0,864990
dgoRp,0.3333333333333333,2,2,GATAGGAGACTGGAAATTAA,0,842998
dgoRp,0.3333333333333333,2,2,GATAGCTGGAATCCACAGAA,0,857452
dgoRp,0.3333333333333333,2,2,GATAGCGATTGCTTACTGTT,0,858062
dgoRp,0.3333333333333333,2,2,GAGTTTTTGCTCGCGGTGAA,0,839900
dgoRp,0.3333333333333333,2,2,GAGTCGGCCGTACCTTTAAA,0,865063
dgoRp,0.3333333333333333,2,2,GAGTACGTACGGTATGGCTA,0,847130
dgoRp,0.3333333333333333,2,2,GAGGTGCTCATTGAAGCTGC,0,861559
dgoRp,0.3333333333333333,2,2,GAGGTCGAGAGATTTGATCT,0,838699
dgoRp,0.3333333333333333,2,2,GAGGTACTCGTCTGTCGCTC,0,843900
dgoRp,0.3333333333333333,2,2,GAGGGTTCCCCCAGAACAAT,0,866467
dgoRp,0.3333333333333333,2,2,GAGGCTTAGGTGGTCCGCGG,0,855847
dgoRp,0.3333333333333333,2,2,GAGGCGGAACTTGCACCATC,0,857863
dgoRp,0.3333333333333333,2,2,GACTGTAGCATGCTAAATCC,0,866242
dgoRp,0.3333333333333333,2,2,GACTACTGTTGCTTTTGCTT,0,862219
dgoRp,0.3333333333333333,2,2,GACGTTAAATAGTCAACTGC,0,849502
dgoRp,0.3333333333333333,2,2,GACGCTAGAAGTTCCGGTCA,0,839454
dgoRp,0.3333333333333333,2,2,GACGCCATCAAAGGTTGAAA,0,836910
dgoRp,0.3333333333333333,2,2,GACCTGTGACCTGAGTGGAA,0,860346
dgoRp,0.3333333333333333,2,2,GACCTGATAGTGCGGGGGAA,0,865163
dgoRp,0.3333333333333333,2,2,GACCATGTTTCGCCCACCAG,0,839343
dgoRp,0.3333333333333333,2,2,GACCACGTTTCACTTCAAAG,0,858376
dgoRp,0.3333333333333333,2,2,GACATTTGCACACACGTCAT,0,853286
dgoRp,0.3333333333333333,2,2,GACAGTAGTGGAAAAGCCTC,0,853177
dgoRp,0.3333333333333333,2,2,GACAGGATGTGGGTTATTCC,0,863196
dgoRp,0.3333333333333333,2,2,GACAGATGAGCGTTAAGACT,0,838001
dgoRp,0.3333333333333333,2,2,GAATGGATGACCAAACAATC,0,836464
dgoRp,0.3333333333333333,2,2,GAACGTAGGAACGCTTATCA,0,838836
dgoRp,0.3333333333333333,2,2,GAACGGCTACGATGTTGCGT,0,847776
dgoRp,0.3333333333333333,2,2,GAACATGTGTGGCTATCATT,0,836283
dgoRp,0.3333333333333333,2,2,GAAATTGATCAGCCGACAGA,0,851577
dgoRp,0.3333333333333333,2,2,GAAATGCGGATATGGATGTC,0,848186
dgoRp,0.3333333333333333,2,2,GAAATCCGATTCACTGGGGT,0,837456
dgoRp,0.3333333333333333,2,2,GAAACTGACCCCAGATAGCT,0,859362
dgoRp,0.3333333333333333,2,2,GAAACGGTTTAAATCTGATT,0,837747
dgoRp,0.3333333333333333,2,2,GAAAAGATTGTAACGTGTGG,0,850821
dgoRp,0.3333333333333333,2,2,GAAAACTTTAAGCCTAGCCT,0,848947
dgoRp,0.3333333333333333,2,2,CTTTTTCTAAAGGCTCAACA,0,843167
dgoRp,0.3333333333333333,2,2,CTTTTGTCCAACCCAGCCCC,0,858930
dgoRp,0.3333333333333333,2,2,CTTTTCCCGACTTGCAAACC,0,851038
dgoRp,0.3333333333333333,2,2,CTTTGTGGCTGAATCAAATA,0,855066
dgoRp,0.3333333333333333,2,2,CTTTGTAAGTCGAAGTTCGT,0,851025
dgoRp,0.3333333333333333,2,2,CTTTGATACGCTGGAGCAGC,0,853850
dgoRp,0.3333333333333333,2,2,CTTTAAATCCAATCATCTCT,0,861919
dgoRp,0.3333333333333333,2,2,CTTGTCTTTGCTGTTTCTGC,0,853213
dgoRp,0.3333333333333333,2,2,CTTCTTCTAATCCTTGGAAT,0,863325
dgoRp,0.3333333333333333,2,2,CTTCTGATGTGAGAGTTTTA,0,845105
dgoRp,0.3333333333333333,2,2,CTTCGATATAAGTTTAGTTT,0,850975
dgoRp,0.3333333333333333,2,2,CTTCGACTCAGGGGCCTAGG,0,858956
dgoRp,0.3333333333333333,2,2,CTTCACGTTCATCTCAACAA,0,857145
dgoRp,0.3333333333333333,2,2,CTTATGGTTCGAGTATGTTC,0,838834
dgoRp,0.3333333333333333,2,2,CTTATAGTGCTTTGGTCAAT,0,845305
dgoRp,0.3333333333333333,2,2,CTTATAGAGGCGTATTAAAG,0,837171
dgoRp,0.3333333333333333,2,2,CTTAGGAAGCTCATGCGGCC,0,853212
dgoRp,0.3333333333333333,2,2,CTTAATACAACTGCCGCGCT,0,839977
dgoRp,0.3333333333333333,2,2,CTTAAACCCTTCGGTACCAT,0,861239
dgoRp,0.3333333333333333,2,2,CTGTTGGACAGTTATTTTGA,0,853169
dgoRp,0.3333333333333333,2,2,CTGTTCCGGGCTGCACTAGA,0,841866
dgoRp,0.3333333333333333,2,2,CTGTGTGACAGGATAAAACT,0,835837
dgoRp,0.3333333333333333,2,2,CTGTACGGCTAACGTCGCCG,0,857026
dgoRp,0.3333333333333333,2,2,CTGGGAGCCACCACTATGAA,0,865880
dgoRp,0.3333333333333333,2,2,CTGGCATCCGGGCTTCTCTA,0,864224
dgoRp,0.3333333333333333,2,2,CTGGAACCGCCACTTCGTTT,0,847443
dgoRp,0.3333333333333333,2,2,CTGCCGTCTGGTGGGTGGAA,0,851239
dgoRp,0.3333333333333333,2,2,CTGCCATCAGGATGAGGCAT,0,863277
dgoRp,0.3333333333333333,2,2,CTGCATTGATCTTCCTGAAG,0,858447
dgoRp,0.3333333333333333,2,2,CTGAGGGTTCTGGGCGATGA,0,858154
dgoRp,0.3333333333333333,2,2,CTGAATGTCTTGCGAGTCCT,0,851946
dgoRp,0.3333333333333333,2,2,CTGAATCAGGTGGAAGGTGG,0,850339
dgoRp,0.3333333333333333,2,2,CTCTTAGAACTAGATGCCTA,0,846345
dgoRp,0.3333333333333333,2,2,CTCTCTATGCAAAAGCGGTT,0,846922
dgoRp,0.3333333333333333,2,2,CTCTAATATTGTGGTTGTAT,0,864753
dgoRp,0.3333333333333333,2,2,CTCGTTCAGAAAAGCTTTCT,0,866817
dgoRp,0.3333333333333333,2,2,CTCGTCGAAAGACGGTTTGC,0,852789
dgoRp,0.3333333333333333,2,2,CTCGGGCACCCTCACCCGCC,0,844967
dgoRp,0.3333333333333333,2,2,CTCGGCTTTTGCTCAGGGAA,0,854246
dgoRp,0.3333333333333333,2,2,CTCGGCGGTGGGAGAAAGGG,0,861030
dgoRp,0.3333333333333333,2,2,CTCCTAAATCGGGCGGGCAT,0,845114
dgoRp,0.3333333333333333,2,2,CTCCGGAATACGGGTTCGGT,0,856444
dgoRp,0.3333333333333333,2,2,CTCCCATAATGTGCTTTAGC,0,844605
dgoRp,0.3333333333333333,2,2,CTCCAGCTTGGGAATTGGTC,0,846784
dgoRp,0.3333333333333333,2,2,CTCACCATAACGACTTCAGG,0,850029
dgoRp,0.3333333333333333,2,2,CTATTTTTACTCAATCAACG,0,853601
dgoRp,0.3333333333333333,2,2,CTATTGGGATCATTTATGGT,0,864147
dgoRp,0.3333333333333333,2,2,CTATTCTTAAGCCGGAAAGT,0,851373
dgoRp,0.3333333333333333,2,2,CTATCTTCATTGGATCTCCA,0,860922
dgoRp,0.3333333333333333,2,2,CTATCTGGCTGCAATACGAC,0,841651
dgoRp,0.3333333333333333,2,2,CTAGTGTTAATCTTCATTGG,0,836758
dgoRp,0.3333333333333333,2,2,CTAGTCAGAAATTTGTACGC,0,847383
dgoRp,0.3333333333333333,2,2,CTAGCACACCTATTCGTAAA,0,858267
dgoRp,0.3333333333333333,2,2,CTACGAAGCTTTTCATCCCT,0,836250
dgoRp,0.3333333333333333,2,2,CTACCTGCGCTTGCATACTG,0,855889
dgoRp,0.3333333333333333,2,2,CTACCTGAAGTTAATAATAG,0,840259
dgoRp,0.3333333333333333,2,2,CTACAACGGTTTCTTTCATG,0,845004
dgoRp,0.3333333333333333,2,2,CTAATTCACTACTTTCATGT,0,849388
dgoRp,0.3333333333333333,2,2,CTAATATTCCAGGTCTGCCC,0,866716
dgoRp,0.3333333333333333,2,2,CGTTGTTAGCGGAGGGCAGT,0,867139
dgoRp,0.3333333333333333,2,2,CGTTGTATTGAGAAGCTGGC,0,847387
dgoRp,0.3333333333333333,2,2,CGTTCAGCGGGAGCCGTAAC,0,841598
dgoRp,0.3333333333333333,2,2,CGTGTTATACTGTTTCATCT,0,852547
dgoRp,0.3333333333333333,2,2,CGTGTTAGAACCAGGCGCTT,0,866789
dgoRp,0.3333333333333333,2,2,CGTGTGGCCAAAGAAAACTG,0,850190
dgoRp,0.3333333333333333,2,2,CGTGGGTGCAGAGCAATGTC,0,862730
dgoRp,0.3333333333333333,2,2,CGTGGCTATCGGGATGTTGT,0,845952
dgoRp,0.3333333333333333,2,2,CGTGCTCTCGGCACGAACGC,0,842666
dgoRp,0.3333333333333333,2,2,CGTGCGTTAGGCGAGCTCCT,0,852443
dgoRp,0.3333333333333333,2,2,CGTGAGTACGAATCCGTCCA,0,844179
dgoRp,0.3333333333333333,2,2,CGTCTCGCAGAGAAACTACA,0,845127
dgoRp,0.3333333333333333,2,2,CGTCTCCTCGCGGGCAAGGA,0,838607
dgoRp,0.3333333333333333,2,2,CGTCGTCGAAATGTCCCGGC,0,838869
dgoRp,0.3333333333333333,2,2,CGTCCATCCTGATTACAGGC,0,859039
dgoRp,0.3333333333333333,2,2,CGTAGTGTGCCCCAGGAGCG,0,849199
dgoRp,0.3333333333333333,2,2,CGTACTCCGGTAGTGTAGAG,0,847900
dgoRp,0.3333333333333333,2,2,CGTAATATTTAAAGCTCAGG,0,860860
dgoRp,0.3333333333333333,2,2,CGGTCTGGAGGCAACGCTAG,0,864563
dgoRp,0.3333333333333333,2,2,CGGTCCGTGGACAGGTCTTT,0,839404
dgoRp,0.3333333333333333,2,2,CGGTCAATTTTTGATAACGT,0,837315
dgoRp,0.3333333333333333,2,2,CGGTATTATAGCAAAGGAGG,0,840984
dgoRp,0.3333333333333333,2,2,CGGGTTTAACAGATGGACAA,0,856664
dgoRp,0.3333333333333333,2,2,CGGGTTGCTCAATACGTGTA,0,841384
dgoRp,0.3333333333333333,2,2,CGGGCTTTAAGTTCTTGTGA,0,849552
dgoRp,0.3333333333333333,2,2,CGGGCTCGCTATCGGGCGAC,0,859379
dgoRp,0.3333333333333333,2,2,CGGGCGTGGGCGCCCTTGTG,0,849838
dgoRp,0.3333333333333333,2,2,CGGCTTGCATAAGGAATTAT,0,855641
dgoRp,0.3333333333333333,2,2,CGGCTAGCAGGGTCACGCGG,0,840607
dgoRp,0.3333333333333333,2,2,CGGCCCATAGGAAGGTCAGT,0,837460
dgoRp,0.3333333333333333,2,2,CGGCCAGGTTAGTTTCGATC,0,838908
dgoRp,0.3333333333333333,2,2,CGGCAGGTGTAATAGGGCTG,0,845468
dgoRp,0.3333333333333333,2,2,CGGATTGTGGCCCTTACGAG,0,847147
dgoRp,0.3333333333333333,2,2,CGGATGTTTGCACACCTGGG,0,847923
dgoRp,0.3333333333333333,2,2,CGGAGATTGCTACGCATGCC,0,841233
dgoRp,0.3333333333333333,2,2,CGGAACGTGGTCAGCACATA,0,844657
dgoRp,0.3333333333333333,2,2,CGCTGAGTAGACCATTTTCA,0,856922
dgoRp,0.3333333333333333,2,2,CGCGTTAGCTGGTGGCTCAT,0,836113
dgoRp,0.3333333333333333,2,2,CGCGTGAGCAGCAATAAGAT,0,839540
dgoRp,0.3333333333333333,2,2,CGCGGCGTTCAAACTGTCCA,0,836230
dgoRp,0.3333333333333333,2,2,CGCGCTTTGATATGGCCATG,0,836582
dgoRp,0.3333333333333333,2,2,CGCGCGATCGTACTAAAATC,0,837699
dgoRp,0.3333333333333333,2,2,CGCGATACTTTCTCTATTGA,0,851690
dgoRp,0.3333333333333333,2,2,CGCCTCGCGAAGGCGGCGCT,0,835934
dgoRp,0.3333333333333333,2,2,CGCAGCTACAGCTTCTAGAT,0,849712
dgoRp,0.3333333333333333,2,2,CGCACGCTACTCCACCAGAG,0,849945
dgoRp,0.3333333333333333,2,2,CGCAATCGTGCACCTCGTAC,0,847437
dgoRp,0.3333333333333333,2,2,CGATGGGCAAAGCGGCCATA,0,850997
dgoRp,0.3333333333333333,2,2,CGATGGAACATTATCGGGAA,0,857709
dgoRp,0.3333333333333333,2,2,CGATCTGGCTGCATGCAGTC,0,838292
dgoRp,0.3333333333333333,2,2,CGATAGAGGGTTGCATGGAA,0,864285
dgoRp,0.3333333333333333,2,2,CGATAAGCCTTCTGTAGCCA,0,838405
dgoRp,0.3333333333333333,2,2,CGAGTTCACATTCGATTCGC,0,840857
dgoRp,0.3333333333333333,2,2,CGAGTAGACATAGCTTGCCC,0,852279
dgoRp,0.3333333333333333,2,2,CGAGCATCCAGTACGTGGTA,0,850386
dgoRp,0.3333333333333333,2,2,CGACTTTGTGATATCGCTGG,0,853715
dgoRp,0.3333333333333333,2,2,CGACTGGGCGCCGATGATAA,0,850248
dgoRp,0.3333333333333333,2,2,CGACTGAATAGGTTTACTGC,0,855667
dgoRp,0.3333333333333333,2,2,CGACGCACATCGGGTAGGCG,0,848900
dgoRp,0.3333333333333333,2,2,CGACATACATCGAGCTCAAG,0,843842
dgoRp,0.3333333333333333,2,2,CGACATAATGGAGTAGAAAA,0,839400
dgoRp,0.3333333333333333,2,2,CGACAATCCGGCCCATATCG,0,858617
dgoRp,0.3333333333333333,2,2,CGAATGGAATTAGACATACC,0,837805
dgoRp,0.3333333333333333,2,2,CGAATCCGCTGTGCGGTCTC,0,858706
dgoRp,0.3333333333333333,2,2,CGAATATGGTGTAGTGACCC,0,841775
dgoRp,0.3333333333333333,2,2,CGAAGCGCAAGAGTACTCGA,0,852307
dgoRp,0.3333333333333333,2,2,CGAAAGTCATGTGTATATAA,0,857364
dgoRp,0.3333333333333333,2,2,CCTTGGCTTCGCCCGGCTCT,0,847954
dgoRp,0.3333333333333333,2,2,CCTGGCCCCCAACGTCTCAA,0,858824
dgoRp,0.3333333333333333,2,2,CCTGCGAGGAATTAAATGAG,0,853130
dgoRp,0.3333333333333333,2,2,CCTGAGAGGGATATTACGGG,0,847542
dgoRp,0.3333333333333333,2,2,CCTGAAGTCAAGCGGCATTT,0,848055
dgoRp,0.3333333333333333,2,2,CCTCTACACGCGAAATTCCG,0,843501
dgoRp,0.3333333333333333,2,2,CCTCGTGGCGAGGTGCATGT,0,846955
dgoRp,0.3333333333333333,2,2,CCTCCGATCACATTATCTCC,0,849011
dgoRp,0.3333333333333333,2,2,CCTCCCGCGGGCAGACTTTT,0,850416
dgoRp,0.3333333333333333,2,2,CCTATCTTTGTTGCGGTTGA,0,838861
dgoRp,0.3333333333333333,2,2,CCTAGGAGGACGCTGACCCG,0,865989
dgoRp,0.3333333333333333,2,2,CCTAGATATTGGTTCACGCC,0,850503
dgoRp,0.3333333333333333,2,2,CCTACTGCATGATCGAGGAT,0,845169
dgoRp,0.3333333333333333,2,2,CCTAAAGACTAGGAGGCTCT,0,861711
dgoRp,0.3333333333333333,2,2,CCGTTCTAGTTCTCTCCGTA,0,841262
dgoRp,0.3333333333333333,2,2,CCGTTCCCGTGCCTATTGCA,0,862194
dgoRp,0.3333333333333333,2,2,CCGTTAAGTATTGGGAGTCA,0,865390
dgoRp,0.3333333333333333,2,2,CCGTGGTGCACTAGCTGTCT,0,841089
dgoRp,0.3333333333333333,2,2,CCGTAGCCCTTAATTTCTTC,0,857966
dgoRp,0.3333333333333333,2,2,CCGGCGGTCATCCACTCTGC,0,864671
dgoRp,0.3333333333333333,2,2,CCGGCGGGGAGTAAGTCGAG,0,847319
dgoRp,0.3333333333333333,2,2,CCGCTATCATTATCTGACTT,0,865534
dgoRp,0.3333333333333333,2,2,CCGCGGAATCTAGTTCCGAT,0,843348
dgoRp,0.3333333333333333,2,2,CCGCATAATCCATCCCGTGC,0,860751
dgoRp,0.3333333333333333,2,2,CCGCAGCTACTTATCCGGTG,0,862013
dgoRp,0.3333333333333333,2,2,CCGATACGCTCCGGAGCCCT,0,849559
dgoRp,0.3333333333333333,2,2,CCGACGGAGTGGAAGTGGTC,0,848273
dgoRp,0.3333333333333333,2,2,CCGAATGGGTCAGCGGTCAC,0,839899
dgoRp,0.3333333333333333,2,2,CCGAATCCTGATAACTCTCA,0,840224
dgoRp,0.3333333333333333,2,2,CCCTTGGCGCCAATGCCTAT,0,838196
dgoRp,0.3333333333333333,2,2,CCCTGGGCAAAGAGTCAGAA,0,865232
dgoRp,0.3333333333333333,2,2,CCCTGGAGAGTGTTGTGCTG,0,837056
dgoRp,0.3333333333333333,2,2,CCCTGCTATCAGCTGTTCCA,0,855209
dgoRp,0.3333333333333333,2,2,CCCTCGTGGGCGCGTCGCGT,0,851511
dgoRp,0.3333333333333333,2,2,CCCTCGGGTGCCCTCCAGCC,0,845913
dgoRp,0.3333333333333333,2,2,CCCTATCCTTTTCGCTGCTA,0,864884
dgoRp,0.3333333333333333,2,2,CCCGTGCGATCTTTGTTGTG,0,838894
dgoRp,0.3333333333333333,2,2,CCCGGTTTGGTCCGGGAGGG,0,851181
dgoRp,0.3333333333333333,2,2,CCCGGTGCTAAAGCCGGGTC,0,867326
dgoRp,0.3333333333333333,2,2,CCCGCGTTAGGGTAGAAAAA,0,858221
dgoRp,0.3333333333333333,2,2,CCCCGAGTCGCATATGGTTC,0,836835
dgoRp,0.3333333333333333,2,2,CCCATCGCCCACGTGTGACT,0,859090
dgoRp,0.3333333333333333,2,2,CCCAAGCGACGTGCCTAGAC,0,859278
dgoRp,0.3333333333333333,2,2,CCCAACGAGATTGTTATACC,0,847104
dgoRp,0.3333333333333333,2,2,CCATTCTTCTCGGTACCATC,0,849487
dgoRp,0.3333333333333333,2,2,CCATTCGGTATGATATGAAA,0,858988
dgoRp,0.3333333333333333,2,2,CCATTAAGTAAGAGAAAAGT,0,857601
dgoRp,0.3333333333333333,2,2,CCATCCTGAAGGCTCCGGAG,0,861655
dgoRp,0.3333333333333333,2,2,CCATCCCGTATTTAGCACAG,0,852582
dgoRp,0.3333333333333333,2,2,CCATCAGGGCCAGATCACGA,0,851578
dgoRp,0.3333333333333333,2,2,CCATAAACAGTCCTGCGCCA,0,859536
dgoRp,0.3333333333333333,2,2,CCAGGCCGAGGATCATTATT,0,840437
dgoRp,0.3333333333333333,2,2,CCAGCTATAAGTAGCACGTC,0,860758
dgoRp,0.3333333333333333,2,2,CCACGCGCAGCCGGCTCAAA,0,863055
dgoRp,0.3333333333333333,2,2,CCAATCTTCGAAGCCGCTAC,0,839304
dgoRp,0.3333333333333333,2,2,CCAAATGACTGGAGATTCCA,0,857168
dgoRp,0.3333333333333333,2,2,CATTATCCCGATATTATGGG,0,836252
dgoRp,0.3333333333333333,2,2,CATTAGTTTCCCACACGAAA,0,861623
dgoRp,0.3333333333333333,2,2,CATTACATACTCGCCTAACT,0,840571
dgoRp,0.3333333333333333,2,2,CATGTATCCGTGCTCGCGTT,0,838247
dgoRp,0.3333333333333333,2,2,CATGCACCGCCATTTCGTTC,0,860444
dgoRp,0.3333333333333333,2,2,CATGATGGGATGTACTGCAA,0,839691
dgoRp,0.3333333333333333,2,2,CATCTCATCTACGGGAACAC,0,865666
dgoRp,0.3333333333333333,2,2,CATCACATGAGTACGCGGTC,0,852691
dgoRp,0.3333333333333333,2,2,CATATCAGACGGTCAGCAGT,0,866228
dgoRp,0.3333333333333333,2,2,CATAGTCTGAGAATCCGTAA,0,863784
dgoRp,0.3333333333333333,2,2,CATAGGGACCCGCTTGTAGC,0,841694
dgoRp,0.3333333333333333,2,2,CAGTTTTGACGCGTCCCCCC,0,853904
dgoRp,0.3333333333333333,2,2,CAGTTTGATGGGAGATCTTC,0,849006
dgoRp,0.3333333333333333,2,2,CAGTGGTGAAGAGATGTAAT,0,858299
dgoRp,0.3333333333333333,2,2,CAGTCGTCGGTCTCCTTAAT,0,864946
dgoRp,0.3333333333333333,2,2,CAGTCATGTTCCCAGGTACG,0,836568
dgoRp,0.3333333333333333,2,2,CAGTCACATGTGACGCCCCA,0,852655
dgoRp,0.3333333333333333,2,2,CAGGTTGACGAAATCTGTGC,0,846730
dgoRp,0.3333333333333333,2,2,CAGGGCTGATTGTGCACATA,0,841960
dgoRp,0.3333333333333333,2,2,CAGGAAAGCCCGTGACCTAC,0,863505
dgoRp,0.3333333333333333,2,2,CAGCGGCCATACGATCGCTT,0,857702
dgoRp,0.3333333333333333,2,2,CAGCGCACATTCCGCCTCTT,0,861331
dgoRp,0.3333333333333333,2,2,CAGCGATTATTTGTGAGCAA,0,853698
dgoRp,0.3333333333333333,2,2,CAGCCGCCACGAAGACTCAT,0,845444
dgoRp,0.3333333333333333,2,2,CAGCCGATCGGCGCGATCCC,0,861338
dgoRp,0.3333333333333333,2,2,CAGCCCGGTCGGCCAGGTCA,0,844451
dgoRp,0.3333333333333333,2,2,CAGCAGACCTCGGAGAATTT,0,856082
dgoRp,0.3333333333333333,2,2,CAGCACAAGAAGCTAGACTC,0,847489
dgoRp,0.3333333333333333,2,2,CAGACTGCTGGTATACGCTG,0,860237
dgoRp,0.3333333333333333,2,2,CAGAAACAACACGAGTCATC,0,839203
dgoRp,0.3333333333333333,2,2,CACTTACTAAAGTCTCAGAA,0,837076
dgoRp,0.3333333333333333,2,2,CACTCAGACGTCCGAAGGGG,0,836955
dgoRp,0.3333333333333333,2,2,CACTATAATGTTCGATAAGC,0,858584
dgoRp,0.3333333333333333,2,2,CACGCGTGTTCGGCCCTGGA,0,853567
dgoRp,0.3333333333333333,2,2,CACCTTGTGATAAGTCGGTA,0,854860
dgoRp,0.3333333333333333,2,2,CACATGTGTATGGTATACCC,0,848639
dgoRp,0.3333333333333333,2,2,CACAATGCTAATTTCCCGAC,0,859291
dgoRp,0.3333333333333333,2,2,CAATTTCGATTATGAGAATA,0,847546
dgoRp,0.3333333333333333,2,2,CAATTCGGATAATGGGTGTT,0,859439
dgoRp,0.3333333333333333,2,2,CAATGGATCGGGTTTCTTGC,0,863067
dgoRp,0.3333333333333333,2,2,CAATACTCCAAACGGAGATT,0,864149
dgoRp,0.3333333333333333,2,2,CAAGTGTATTCTCGGTAAAG,0,858927
dgoRp,0.3333333333333333,2,2,CAAGTCGTCGGAAGTTAAAG,0,852620
dgoRp,0.3333333333333333,2,2,CAAGTAGGTCACCGGTGAAG,0,852306
dgoRp,0.3333333333333333,2,2,CAAGGGAGTGACCGGTAATT,0,855596
dgoRp,0.3333333333333333,2,2,CAAGGCAGTGGGAAGCTTGT,0,856459
dgoRp,0.3333333333333333,2,2,CAAGCCACGGAGATAAATCC,0,843185
dgoRp,0.3333333333333333,2,2,CAAGCAGCTCGACTGGTGTG,0,849860
dgoRp,0.3333333333333333,2,2,CAAGAAGGCCTGACGACCTT,0,857322
dgoRp,0.3333333333333333,2,2,CAACGTTGATGTTAAGGCTT,0,847332
dgoRp,0.3333333333333333,2,2,CAACCCCCGCCGAGCGGGAG,0,841528
dgoRp,0.3333333333333333,2,2,CAACAGGTAAACCAGAACGA,0,848081
dgoRp,0.3333333333333333,2,2,CAACAGCGTGGGAGAAAAAC,0,844177
dgoRp,0.3333333333333333,2,2,CAAATGTATTCATGGTAAAA,0,858317
dgoRp,0.3333333333333333,2,2,CAAATGAAAGAGTTCAGGAG,0,858528
dgoRp,0.3333333333333333,2,2,CAAAGGATAACCTAATCGAT,0,846602
dgoRp,0.3333333333333333,2,2,CAAAGCAATGGTTCAATAAA,0,842827
dgoRp,0.3333333333333333,2,2,CAAAGAATACAGGTGCAGCC,0,858337
dgoRp,0.3333333333333333,2,2,CAAAACAGTTATGGCCGGTT,0,837806
dgoRp,0.3333333333333333,2,2,CAAAAACATGACGTCCGGGA,0,844273
dgoRp,0.3333333333333333,2,2,CAAAAACATCATACAGGTAC,0,864344
dgoRp,0.3333333333333333,2,2,ATTTTAGAGGTTGCAAATTC,0,854118
dgoRp,0.3333333333333333,2,2,ATTTGCAACGTGAGGGTAAG,0,865547
dgoRp,0.3333333333333333,2,2,ATTTCGCTCGAGATCAGAAC,0,857536
dgoRp,0.3333333333333333,2,2,ATTTCAGGCCGGACAATTAG,0,860452
dgoRp,0.3333333333333333,2,2,ATTTCAATGACCGGCAACAA,0,840284
dgoRp,0.3333333333333333,2,2,ATTTCAAGGTATGCGAGTCC,0,842742
dgoRp,0.3333333333333333,2,2,ATTTAGACACAAGAAGATCG,0,853841
dgoRp,0.3333333333333333,2,2,ATTGGAAGAGCCGACGCGCC,0,845384
dgoRp,0.3333333333333333,2,2,ATTGCGCGACAGAACCGTGT,0,848177
dgoRp,0.3333333333333333,2,2,ATTCGCAGGTTGGAAGTCCA,0,858555
dgoRp,0.3333333333333333,2,2,ATTCCTCTTTAATATGCCGC,0,842431
dgoRp,0.3333333333333333,2,2,ATTATAATATCACAATTGCA,0,845167
dgoRp,0.3333333333333333,2,2,ATGTGGTTAAAGTACTAGAT,0,840961
dgoRp,0.3333333333333333,2,2,ATGGTACTCTAGGGCCTTGG,0,864291
dgoRp,0.3333333333333333,2,2,ATGGGCTGGGGAAACGGTCA,0,848461
dgoRp,0.3333333333333333,2,2,ATGGCCTTCATCCTTGGGTT,0,848705
dgoRp,0.3333333333333333,2,2,ATGGATTCAGGTACCCTTTC,0,836158
dgoRp,0.3333333333333333,2,2,ATGCTTTGCAATTGCGGGCG,0,848521
dgoRp,0.3333333333333333,2,2,ATGCTAGCCCCCGATGGGGA,0,845726
dgoRp,0.3333333333333333,2,2,ATGCAGGGGGTACTAGCTCA,0,840518
dgoRp,0.3333333333333333,2,2,ATGAGTACCAAAAGATTCTA,0,848229
dgoRp,0.3333333333333333,2,2,ATGAAGGATAGAGTCTCGGG,0,848666
dgoRp,0.3333333333333333,2,2,ATCTGTTGAGCGTCAGTTGC,0,835969
dgoRp,0.3333333333333333,2,2,ATCTCATCCAGAAGTCAGGA,0,851343
dgoRp,0.3333333333333333,2,2,ATCGTGCTCTCAGGATCAGT,0,843195
dgoRp,0.3333333333333333,2,2,ATCGTAATAGTCCGCTTTAT,0,850300
dgoRp,0.3333333333333333,2,2,ATCCGCTCAGGCTCCTGCCC,0,858525
dgoRp,0.3333333333333333,2,2,ATCCCCACTGATCCCTTCGC,0,867186
dgoRp,0.3333333333333333,2,2,ATCCACGGATCGCGAGACAT,0,856473
dgoRp,0.3333333333333333,2,2,ATCATTTTCATCTCGCAATA,0,853581
dgoRp,0.3333333333333333,2,2,ATCATGTATATGTCGAATCA,0,865617
dgoRp,0.3333333333333333,2,2,ATCAGGCATACTTTCACTTC,0,844431
dgoRp,0.3333333333333333,2,2,ATCAGAGCGAACCAAGTTCA,0,865340
dgoRp,0.3333333333333333,2,2,ATCACGTTGCGACAATTTAC,0,852301
dgoRp,0.3333333333333333,2,2,ATCACGCGTCTTACGAGGGT,0,853657
dgoRp,0.3333333333333333,2,2,ATATGTGAACGTGTCACTCG,0,853461
dgoRp,0.3333333333333333,2,2,ATATGGGAGGCCCAGCACAC,0,836898
dgoRp,0.3333333333333333,2,2,ATATCGTGGGCCTCCTCACT,0,838241
dgoRp,0.3333333333333333,2,2,ATATATGCATGATGGGCCAA,0,852546
dgoRp,0.3333333333333333,2,2,ATACTTGCGCCGCGCCGAAT,0,856466
dgoRp,0.3333333333333333,2,2,ATACTTCAACGAAGGCCATT,0,836472
dgoRp,0.3333333333333333,2,2,ATACGGTTGGGGAGCAACCA,0,838038
dgoRp,0.3333333333333333,2,2,ATACGGCACCTTGTTGCCAA,0,866777
dgoRp,0.3333333333333333,2,2,ATACCCCGACCCCTACCTGC,0,865554
dgoRp,0.3333333333333333,2,2,ATACAGTAGATTGATTGGCA,0,862073
dgoRp,0.3333333333333333,2,2,ATACAACGCCCTCGCGGTGC,0,843122
dgoRp,0.3333333333333333,2,2,ATAATCGCAATTTTATGAGA,0,845856
dgoRp,0.3333333333333333,2,2,ATAAGTCTAACTGGGGTCGC,0,854569
dgoRp,0.3333333333333333,2,2,ATAACTGAGGTCCATCTATA,0,841901
dgoRp,0.3333333333333333,2,2,ATAACGGAGTGTCCTGTGGT,0,851664
dgoRp,0.3333333333333333,2,2,ATAAAGGACGAGGTCGGGGT,0,838509
dgoRp,0.3333333333333333,2,2,ATAAAGCTGATGACAGAAAT,0,849214
dgoRp,0.3333333333333333,2,2,AGTTGTGATCCGGGAGGAAC,0,853425
dgoRp,0.3333333333333333,2,2,AGTTGCCGGTTTGTAAACTT,0,867284
dgoRp,0.3333333333333333,2,2,AGTTGATCAGATCTGCTTAA,0,845292
dgoRp,0.3333333333333333,2,2,AGTTCGAAAACAGACGAGGT,0,841942
dgoRp,0.3333333333333333,2,2,AGTTAGTACGCGGGAGCAAC,0,848830
dgoRp,0.3333333333333333,2,2,AGTTAGATTACTCAACCACT,0,852451
dgoRp,0.3333333333333333,2,2,AGTTAATCTCTTTACCGCGC,0,857654
dgoRp,0.3333333333333333,2,2,AGTGGCCGCGATGTTCAAGG,0,863432
dgoRp,0.3333333333333333,2,2,AGTGAGGGCTAAGGCACGGT,0,837368
dgoRp,0.3333333333333333,2,2,AGTGAGCCAAATCAAAACTA,0,851748
dgoRp,0.3333333333333333,2,2,AGTATTGGACAGAATCCCGG,0,838142
dgoRp,0.3333333333333333,2,2,AGTATTAGACACGTTCGGTA,0,856874
dgoRp,0.3333333333333333,2,2,AGTATGACCTCAGATCGTAT,0,864672
dgoRp,0.3333333333333333,2,2,AGTAGTCCGCTCACTCCCAC,0,841524
dgoRp,0.3333333333333333,2,2,AGTAACATAGGACGCCGGTG,0,856730
dgoRp,0.3333333333333333,2,2,AGTAACACGGCCGGGGTCAT,0,853148
dgoRp,0.3333333333333333,2,2,AGTAAACTTCTTGCATAGCA,0,853486
dgoRp,0.3333333333333333,2,2,AGGTTTCTGCATGTTCTAAC,0,867009
dgoRp,0.3333333333333333,2,2,AGGTTAACTCTTAATGTACT,0,867331
dgoRp,0.3333333333333333,2,2,AGGTCACTTTGCGACTCTGC,0,854120
dgoRp,0.3333333333333333,2,2,AGGGTTAAAACGTCGAGGAT,0,865784
dgoRp,0.3333333333333333,2,2,AGGGGGTACGTTTGTTCGGT,0,865733
dgoRp,0.3333333333333333,2,2,AGGGGCGAGCTAATACATGG,0,841088
dgoRp,0.3333333333333333,2,2,AGGGCGTAAGTTGGGTGGTA,0,866110
dgoRp,0.3333333333333333,2,2,AGGGAGACTCTAGGGGTCCT,0,860371
dgoRp,0.3333333333333333,2,2,AGGCGTCTAAATTTTTTACT,0,850327
dgoRp,0.3333333333333333,2,2,AGGCGCCCATACGCTCGTAG,0,841907
dgoRp,0.3333333333333333,2,2,AGGCGATGCCGGGCCAGTTG,0,856555
dgoRp,0.3333333333333333,2,2,AGGCAGGAATTAATTCAGAA,0,850681
dgoRp,0.3333333333333333,2,2,AGGCAGCTTGCCAATTATGA,0,837936
dgoRp,0.3333333333333333,2,2,AGGACTGGTTAGCTAATGGA,0,858753
dgoRp,0.3333333333333333,2,2,AGGAAGCTGTCGAAAATACT,0,859943
dgoRp,0.3333333333333333,2,2,AGCTTCACAATGCTGGCCTG,0,854283
dgoRp,0.3333333333333333,2,2,AGCTGGTCTTGTATGTCTCT,0,839824
dgoRp,0.3333333333333333,2,2,AGCTGATCCAGTTCATGGCC,0,864321
dgoRp,0.3333333333333333,2,2,AGCTATCAAATGACTGACGT,0,841351
dgoRp,0.3333333333333333,2,2,AGCTACGGACCATATACATT,0,857998
dgoRp,0.3333333333333333,2,2,AGCGGGTGTTGTCAGGGGGA,0,846324
dgoRp,0.3333333333333333,2,2,AGCGGCTCCGACAAAGTAAG,0,853587
dgoRp,0.3333333333333333,2,2,AGCGAGGGGTGCAGATCTAT,0,838051
dgoRp,0.3333333333333333,2,2,AGCGACGCGCCCATAATTCT,0,853465
dgoRp,0.3333333333333333,2,2,AGCGACACGGTCTCGTGTTG,0,839888
dgoRp,0.3333333333333333,2,2,AGCCGTCTGTACTTAGGTTA,0,855738
dgoRp,0.3333333333333333,2,2,AGCCGTCCTCGGGGCTCACA,0,855638
dgoRp,0.3333333333333333,2,2,AGCCCGTTTATAGCAACTGG,0,854560
dgoRp,0.3333333333333333,2,2,AGCCCAAGGGTTGAGGGGTA,0,840162
dgoRp,0.3333333333333333,2,2,AGCCAGGGGTAGCCCTCGAG,0,853966
dgoRp,0.3333333333333333,2,2,AGCCAGATTAGCGCAAATGG,0,845188
dgoRp,0.3333333333333333,2,2,AGCAGTGTAAACAGCGATAC,0,862252
dgoRp,0.3333333333333333,2,2,AGCAAAAAGTACGACCTTGT,0,862991
dgoRp,0.3333333333333333,2,2,AGATTTTTTCTTTGAGCCAG,0,845259
dgoRp,0.3333333333333333,2,2,AGATTGGCGCTAGCGCGTAC,0,855326
dgoRp,0.3333333333333333,2,2,AGATTCTGATGCCAGCGAGG,0,846270
dgoRp,0.3333333333333333,2,2,AGATGCCTAGGTCCGATTGA,0,864963
dgoRp,0.3333333333333333,2,2,AGATCCACTGGCGGCTAATA,0,860222
dgoRp,0.3333333333333333,2,2,AGATAACCTCTTTCATAAGC,0,862905
dgoRp,0.3333333333333333,2,2,AGAGTGTAGCTACGTATATT,0,849480
dgoRp,0.3333333333333333,2,2,AGAGGGGGACAAGTAATGGC,0,837918
dgoRp,0.3333333333333333,2,2,AGAGCGGGACGCAGAGCCGA,0,848187
dgoRp,0.3333333333333333,2,2,AGAGAACTCCCGGGCATGTG,0,855501
dgoRp,0.3333333333333333,2,2,AGACGATAGGACACCGTGGG,0,858113
dgoRp,0.3333333333333333,2,2,AGACCGTTACGCCAATACGG,0,861023
dgoRp,0.3333333333333333,2,2,AGACATGGTCGATGAACGCA,0,845455
dgoRp,0.3333333333333333,2,2,AGACAGGAGTTCATAGGCAT,0,849865
dgoRp,0.3333333333333333,2,2,AGACACACACCTCAGCACAT,0,861847
dgoRp,0.3333333333333333,2,2,AGAAGTGGATGAAGAAACTT,0,836373
dgoRp,0.3333333333333333,2,2,ACTTACGGTATAATTAGTTC,0,849648
dgoRp,0.3333333333333333,2,2,ACTGTGAGAAGATGTTCGAC,0,855499
dgoRp,0.3333333333333333,2,2,ACTGGGGGGTGCGAATCCTT,0,866918
dgoRp,0.3333333333333333,2,2,ACTGCATGGTGCCGAAGCTT,0,854553
dgoRp,0.3333333333333333,2,2,ACTCTAACCGTTCGTCCGGA,0,841621
dgoRp,0.3333333333333333,2,2,ACTCGTGGATCTGCGTAATG,0,842507
dgoRp,0.3333333333333333,2,2,ACTCCGTCGATCGCTACCTC,0,843092
dgoRp,0.3333333333333333,2,2,ACTATGTTCCACATACGAAG,0,836011
dgoRp,0.3333333333333333,2,2,ACTAGGGCAAATTAACAGTG,0,846337
dgoRp,0.3333333333333333,2,2,ACTAGCTCCAACCCTAGGTC,0,844821
dgoRp,0.3333333333333333,2,2,ACTAGCCTTACCAGTGAAAA,0,856162
dgoRp,0.3333333333333333,2,2,ACTAAATGTACAGAGACCCG,0,851286
dgoRp,0.3333333333333333,2,2,ACTAAACACAAGGGCGTTGG,0,847173
dgoRp,0.3333333333333333,2,2,ACGTTCATCAGCACTCCGCC,0,853163
dgoRp,0.3333333333333333,2,2,ACGTAGTATGTGCTTGCAAG,0,865330
dgoRp,0.3333333333333333,2,2,ACGTAAGTTAGAGCCAGCAA,0,857251
dgoRp,0.3333333333333333,2,2,ACGGTGGGAGCTTTCGACTA,0,865482
dgoRp,0.3333333333333333,2,2,ACGGTGCTCATTCCGGCGGA,0,861167
dgoRp,0.3333333333333333,2,2,ACGGTAAATCGTGTAGTCTT,0,839998
dgoRp,0.3333333333333333,2,2,ACGGGGAGATTGATACTGCG,0,859972
dgoRp,0.3333333333333333,2,2,ACGGGCTCCCAAAAGACCAC,0,846492
dgoRp,0.3333333333333333,2,2,ACGGGAGCTAAACCCACACC,0,844169
dgoRp,0.3333333333333333,2,2,ACGGATCGCTTCTACCTGCA,0,837584
dgoRp,0.3333333333333333,2,2,ACGCTTTGTGAGCGCCCTGG,0,866244
dgoRp,0.3333333333333333,2,2,ACGCTTTAATCGCTTAGGGT,0,854339
dgoRp,0.3333333333333333,2,2,ACGCGCCTACAAAGAGTCGT,0,856777
dgoRp,0.3333333333333333,2,2,ACGCAAGTTTGGTTCTGTCG,0,842724
dgoRp,0.3333333333333333,2,2,ACGATCCAGGCGAGTTCCCC,0,855681
dgoRp,0.3333333333333333,2,2,ACGAGTTAATCTTAGAAGTT,0,842177
dgoRp,0.3333333333333333,2,2,ACGACGGTTGTGTGATTGTT,0,866700
dgoRp,0.3333333333333333,2,2,ACGACCTGCTTCTTTGAGGG,0,843026
dgoRp,0.3333333333333333,2,2,ACGAAAGCCAGCTCAAAATT,0,835928
dgoRp,0.3333333333333333,2,2,ACCTGTACGAGAGTTACAGG,0,847277
dgoRp,0.3333333333333333,2,2,ACCTGGGATGCAACTTACTT,0,846503
dgoRp,0.3333333333333333,2,2,ACCTGGCAGCAGGATTGCAT,0,861071
dgoRp,0.3333333333333333,2,2,ACCTGGATGTCACGCACGGG,0,851438
dgoRp,0.3333333333333333,2,2,ACCTCTACAAGTTGGCGCCC,0,860663
dgoRp,0.3333333333333333,2,2,ACCTCGATGTTATGCCGATG,0,848787
dgoRp,0.3333333333333333,2,2,ACCGTTTACATTGTACCCTA,0,859159
dgoRp,0.3333333333333333,2,2,ACCGTACGTGCTGAAGAGCT,0,852720
dgoRp,0.3333333333333333,2,2,ACCGGAGTGGCAGTTAGGAG,0,846325
dgoRp,0.3333333333333333,2,2,ACCGGACCCATAGACCGCGT,0,859188
dgoRp,0.3333333333333333,2,2,ACCGATGCTACCAGCTCCTT,0,849868
dgoRp,0.3333333333333333,2,2,ACCATCTGATTCACAAAAAG,0,839520
dgoRp,0.3333333333333333,2,2,ACCACTCGTTTTTAGGGTCA,0,852222
dgoRp,0.3333333333333333,2,2,ACATTCTCGCCTCCGCTCAG,0,851470
dgoRp,0.3333333333333333,2,2,ACATTCCGGAGACCACCCTT,0,865695
dgoRp,0.3333333333333333,2,2,ACATCTGAGACAGGTATGTG,0,865849
dgoRp,0.3333333333333333,2,2,ACATAAGGCTTCATAGCAAT,0,857500
dgoRp,0.3333333333333333,2,2,ACAGTATTTCGGGTTGAGAG,0,861793
dgoRp,0.3333333333333333,2,2,ACAGAAGCTGTACGTGCTAG,0,838434
dgoRp,0.3333333333333333,2,2,ACACGCAGCGATAGATTCGT,0,861308
dgoRp,0.3333333333333333,2,2,ACACCAAGCTTGTGTTGATG,0,850262
dgoRp,0.3333333333333333,2,2,ACACAAGCCGTGCAATCTTG,0,865542
dgoRp,0.3333333333333333,2,2,ACAATCTGAATGCTTGCGGC,0,851368
dgoRp,0.3333333333333333,2,2,ACAAGGTATGCCCTGACCGC,0,849086
dgoRp,0.3333333333333333,2,2,ACAAACCGTTCGGGAGGTCT,0,866268
dgoRp,0.3333333333333333,2,2,AATTTAGTGCATTGATTTAG,0,847960
dgoRp,0.3333333333333333,2,2,AATTGTTCTGCAGCCCTGTC,0,839872
dgoRp,0.3333333333333333,2,2,AATTCGCGCTCGCGAACGTA,0,856348
dgoRp,0.3333333333333333,2,2,AATTCATACATCAGCCCTGA,0,853784
dgoRp,0.3333333333333333,2,2,AATTACTCCCACCTCGTAAG,0,844237
dgoRp,0.3333333333333333,2,2,AATGTACTGACGCTTGTAGG,0,855131
dgoRp,0.3333333333333333,2,2,AATGGCATCTAAGCGTCGTA,0,841401
dgoRp,0.3333333333333333,2,2,AATGCTTCCTGCAAACGAGT,0,860239
dgoRp,0.3333333333333333,2,2,AATGAAGGATCCGCGGTGGA,0,838225
dgoRp,0.3333333333333333,2,2,AATCGGACAGATACCGGAGC,0,854301
dgoRp,0.3333333333333333,2,2,AATCCTGGGCTAAGTTTTCC,0,855723
dgoRp,0.3333333333333333,2,2,AATCCGCCGGTGGGTCTGTT,0,852319
dgoRp,0.3333333333333333,2,2,AATCATCAGCCGAATCAGTG,0,855779
dgoRp,0.3333333333333333,2,2,AATAATCATTACTCTTATCG,0,855200
dgoRp,0.3333333333333333,2,2,AAGTTCCATCATCGACAGAG,0,846454
dgoRp,0.3333333333333333,2,2,AAGTGCAGCCGAAGTGGTCT,0,859335
dgoRp,0.3333333333333333,2,2,AAGTCACCCAAGGTGGTAAG,0,858103
dgoRp,0.3333333333333333,2,2,AAGGTTGCTGCTGTATGCCG,0,836969
dgoRp,0.3333333333333333,2,2,AAGGTGGGGGACAGCGACAT,0,838064
dgoRp,0.3333333333333333,2,2,AAGGATAAGACGCTTCGCGT,0,841282
dgoRp,0.3333333333333333,2,2,AAGCGGGTTCGACTTTCGTC,0,862791
dgoRp,0.3333333333333333,2,2,AAGATAGTGTAGGGCGATAC,0,862088
dgoRp,0.3333333333333333,2,2,AACTGTGGGGTCCTTCCGTT,0,847449
dgoRp,0.3333333333333333,2,2,AACTGGCCGCGCTAGACCGT,0,840325
dgoRp,0.3333333333333333,2,2,AACTCTCCGTCGGGCGGCAA,0,841266
dgoRp,0.3333333333333333,2,2,AACGTGCGGGACCAGATCAA,0,859604
dgoRp,0.3333333333333333,2,2,AACGTATTGCACGTTACATG,0,864967
dgoRp,0.3333333333333333,2,2,AACGGCGCGGGCCGTAAATT,0,839316
dgoRp,0.3333333333333333,2,2,AACGGCGCACCTCGGCTCAC,0,858598
dgoRp,0.3333333333333333,2,2,AACGCGTGCCCTCGGCAGGG,0,852219
dgoRp,0.3333333333333333,2,2,AACCTTGTGGGGCATTGTAC,0,848668
dgoRp,0.3333333333333333,2,2,AACCTAAGATCCAAACGGAA,0,847819
dgoRp,0.3333333333333333,2,2,AACCGCAGCTACTTTTAAGG,0,863010
dgoRp,0.3333333333333333,2,2,AACCCGTACATGAAGAAGCA,0,844422
dgoRp,0.3333333333333333,2,2,AACATGCCATAACGCAGGTA,0,863745
dgoRp,0.3333333333333333,2,2,AACAGCGGTGGGAAAGTATA,0,858121
dgoRp,0.3333333333333333,2,2,AACAAGTACGTCGCCAGATA,0,842015
dgoRp,0.3333333333333333,2,2,AAATGCGTTACGACCACCTC,0,862957
dgoRp,0.3333333333333333,2,2,AAATGACTTTCGTGATTCGT,0,856383
dgoRp,0.3333333333333333,2,2,AAAGGGCACCAAGATGGGGA,0,864993
dgoRp,0.3333333333333333,2,2,AAAGCGTCGGGCAGTTTGCT,0,854554
dgoRp,0.3333333333333333,2,2,AAACTCATGCGGTACACTGT,0,866935
dgoRp,0.3333333333333333,2,2,AAACAGGATTCAAGCGGAGG,0,840916
dgoRp,0.3333333333333333,2,2,AAACACGGGGTAGGTGCAAA,0,856510
dgoRp,0.3333333333333333,2,2,AAAATCTGAGTATCAAGGAG,0,845791
dgoRp,0.3333333333333333,2,2,AAAATAGTAGAGTTTCATTC,0,838863
dgoRp,0.3333333333333333,2,2,AAAACGAATCCTGCGGAGTA,0,849271
dgoRp,0.3333333333333333,2,2,AAAACGAAAGGTCAACCTGG,0,854877
dgoRp,0.3333333333333333,2,2,AAAACCTCAAAGCGGGGACA,0,852664
dgoRp,0.3333333333333333,2,2,AAAACAGCTCAAGGTGATAC,0,864488
dgoRp,0.3333333333333333,2,2,AAAAATGAGTAAGCTGCCTA,0,866386
dgoRp,0.5,1,1,TTTTTTGGGTCATTAGGCTC,0,837182
dgoRp,0.5,1,1,TTTTTTCCTCGCTATCGGTC,0,850246
dgoRp,0.5,1,1,TTTTTCGCACGGGTATAGTG,0,836367
dgoRp,0.5,1,1,TTTTCTTGAAAATTCTATTA,0,850109
dgoRp,0.5,1,1,TTTTCGTCTGGTTGACCACC,0,843320
dgoRp,0.5,1,1,TTTTAGATGTATAAAACCAT,0,862561
dgoRp,0.5,1,1,TTTGGGCCTCTGCGCTCTTT,0,842833
dgoRp,0.5,1,1,TTTGGACCCGCGACGCTTGC,0,837738
dgoRp,0.5,1,1,TTTGCGCGGTTAAGGGAGGT,0,845879
dgoRp,0.5,1,1,TTTCGCAGGATCTCCCTCTA,0,838985
dgoRp,0.5,1,1,TTTCCAGTTCAGTCCCGGGC,0,862915
dgoRp,0.5,1,1,TTTATTTTCCGAGCGATGTT,0,862906
dgoRp,0.5,1,1,TTTATTGCGCCTTAAAGAGA,0,847806
dgoRp,0.5,1,1,TTTATGTGTGCGTTTTATGC,0,858182
dgoRp,0.5,1,1,TTTAGTATTTCAGGGTAGCA,0,842664
dgoRp,0.5,1,1,TTTAGGGACTCGGAGCTCGC,0,862704
dgoRp,0.5,1,1,TTTAAGACGACGAAACTGCG,0,844291
dgoRp,0.5,1,1,TTGTGCCGCGCCTGGATTAC,0,863558
dgoRp,0.5,1,1,TTGTAGGGGTCGATCGTTCC,0,847875
dgoRp,0.5,1,1,TTGTACAGGTAACTGTGGGT,0,838813
dgoRp,0.5,1,1,TTGGTGGAGTGGTGACCAGA,0,843409
dgoRp,0.5,1,1,TTGGTCATATACGCTTGATT,0,859061
dgoRp,0.5,1,1,TTGGTAGAAGGCTGGCCAGC,0,844727
dgoRp,0.5,1,1,TTGCGACCTGTCATCAGCCC,0,852610
dgoRp,0.5,1,1,TTGATCGATAGGCCGGGGGA,0,861760
dgoRp,0.5,1,1,TTGATCCGTTCATCAGTATC,0,848740
dgoRp,0.5,1,1,TTGATAAAAATAGCTGAAGC,0,841513
dgoRp,0.5,1,1,TTGAAAGTGCGAGATCGTCC,0,841343
dgoRp,0.5,1,1,TTCTTCGAACTGATGATACA,0,861520
dgoRp,0.5,1,1,TTCTGTAATTGACTCGTCTT,0,853884
dgoRp,0.5,1,1,TTCTGTAATAGACTCGTCTT,0,853877
dgoRp,0.5,1,1,TTCTGACCATATATGCCTCC,0,836269
dgoRp,0.5,1,1,TTCTCTGGCCGCATACGCGT,0,865513
dgoRp,0.5,1,1,TTCTCGAAGAATCGACAGGA,0,862899
dgoRp,0.5,1,1,TTCTATGAAAAAGCGGTTTC,0,836906
dgoRp,0.5,1,1,TTCTATATGTTCCTAGGATG,0,856014
dgoRp,0.5,1,1,TTCTACTGGGAGCCGTAAAC,0,852839
dgoRp,0.5,1,1,TTCGCTTTAGCTACTGAGTC,0,857592
dgoRp,0.5,1,1,TTCGAGTAGACTAAAAGCCT,0,860889
dgoRp,0.5,1,1,TTCGAATACTGATTTGGAAA,0,850212
dgoRp,0.5,1,1,TTCGAAAACAAAATGTAAGG,0,853546
dgoRp,0.5,1,1,TTCCTGACATCTCGTCCCTT,0,839103
dgoRp,0.5,1,1,TTCCGTGGGGTATATCGGGT,0,851813
dgoRp,0.5,1,1,TTCCAGACTGGCTACCTAAA,0,839912
dgoRp,0.5,1,1,TTCATGGCCATTCAGTAACA,0,864762
dgoRp,0.5,1,1,TTCATAGCGTTGCTCTCGCG,0,865747
dgoRp,0.5,1,1,TTCATACGTTCTGACGGTTC,0,856088
dgoRp,0.5,1,1,TTCAGTCGCGGACCCTACGT,0,857764
dgoRp,0.5,1,1,TTCAGGCGTGCTTCTGCTGA,0,846146
dgoRp,0.5,1,1,TTCAGATCTGATGAGCCTAC,0,844120
dgoRp,0.5,1,1,TTCAAGTGTTGCTCGTTTGG,0,840408
dgoRp,0.5,1,1,TTCAAGCAGTCGCATAAGGT,0,836504
dgoRp,0.5,1,1,TTCAAGACACGTTGTATTCT,0,854138
dgoRp,0.5,1,1,TTATTTGACCTCTAGATCGT,0,862085
dgoRp,0.5,1,1,TTATTCCCATTACAAGACAT,0,862022
dgoRp,0.5,1,1,TTATACTTACGAGGCTACAA,0,845795
dgoRp,0.5,1,1,TTAGTCCTCAGTTACGACCT,0,841342
dgoRp,0.5,1,1,TTAGTAAGTTATAAAATTGG,0,855186
dgoRp,0.5,1,1,TTAGGCTGGTTGTTGGTGAG,0,838484
dgoRp,0.5,1,1,TTAGGACGCTGTCTGCAATG,0,862147
dgoRp,0.5,1,1,TTAGCGCTCGAGAAGTGGAA,0,847158
dgoRp,0.5,1,1,TTAGCGAACGAAGCACCTAC,0,864823
dgoRp,0.5,1,1,TTAGAAGGCACGGTAGCGCC,0,837234
dgoRp,0.5,1,1,TTAGAACCTTCGGGAATCAG,0,857611
dgoRp,0.5,1,1,TTACTAACACTGGTTGCCCT,0,842799
dgoRp,0.5,1,1,TTACGCTACAAAAAGTGCCT,0,866186
dgoRp,0.5,1,1,TTAAGGCTAAGCTAGGCATG,0,854281
dgoRp,0.5,1,1,TTAAATAGGCGTCGTTCGTT,0,859253
dgoRp,0.5,1,1,TGTTTTTTTCGAAGGTTTTT,0,854526
dgoRp,0.5,1,1,TGTTGAGACACAATTGATAG,0,845727
dgoRp,0.5,1,1,TGTTCCCCATTAGGAGGGTC,0,865029
dgoRp,0.5,1,1,TGTTCACTGTCAGTCCTAGG,0,843125
dgoRp,0.5,1,1,TGTGTTTGAAGACAAATCTA,0,845902
dgoRp,0.5,1,1,TGTGTAATTGTGCCCCGCGG,0,838195
dgoRp,0.5,1,1,TGTGGTATTAATTGGGACAG,0,862019
dgoRp,0.5,1,1,TGTGCTTTTAACTGCGGCGA,0,864139
dgoRp,0.5,1,1,TGTGCTATCCTGTTCAGGCT,0,856012
dgoRp,0.5,1,1,TGTGACCCTAATATTCATAG,0,849072
dgoRp,0.5,1,1,TGTGAACCGTATCCGTAGTA,0,851410
dgoRp,0.5,1,1,TGTCTTCGCCCAATCAAACC,0,845653
dgoRp,0.5,1,1,TGTCGTCTCTTTTTGACTGG,0,853114
dgoRp,0.5,1,1,TGTCGCTCAAATCAGCGCAT,0,864514
dgoRp,0.5,1,1,TGTATCCGCGACATTCTGCT,0,859599
dgoRp,0.5,1,1,TGTAGGGATGTCCGCTCGTC,0,852022
dgoRp,0.5,1,1,TGTAGGCCGTTTCAGTCCCC,0,847892
dgoRp,0.5,1,1,TGTACATAGGGGGTACGTAC,0,852855
dgoRp,0.5,1,1,TGTAACGGCCACAAGTATGC,0,853184
dgoRp,0.5,1,1,TGGTTGCGCTGAGCCTACTC,0,838868
dgoRp,0.5,1,1,TGGTTCAGGTCTAATAACAA,0,864629
dgoRp,0.5,1,1,TGGTGCTCTATCCGTCCGCG,0,858922
dgoRp,0.5,1,1,TGGTCTTGACTTTGACTCAA,0,846332
dgoRp,0.5,1,1,TGGTCTGGGTTAGGTGACAG,0,848882
dgoRp,0.5,1,1,TGGTCACGCTTGTAATCAGG,0,866126
dgoRp,0.5,1,1,TGGGTACTCCGTGTCACCTA,0,843370
dgoRp,0.5,1,1,TGGGGCTAGAAACAGCCGAC,0,865315
dgoRp,0.5,1,1,TGGGCAGAACTCGACAAGAC,0,866118
dgoRp,0.5,1,1,TGGGAGTCACCAACCTACCT,0,844882
dgoRp,0.5,1,1,TGGCTCGCCGTACACTATCA,0,842139
dgoRp,0.5,1,1,TGGCCAAAAGGGTTAATCAC,0,858710
dgoRp,0.5,1,1,TGGCAATATTCGATTATCCA,0,867263
dgoRp,0.5,1,1,TGGATCACTGCTCCAGGAAA,0,859288
dgoRp,0.5,1,1,TGGAGGAACCTGAATCGTTC,0,856943
dgoRp,0.5,1,1,TGGACATTCAGAGGAGACCA,0,863824
dgoRp,0.5,1,1,TGGACACGGTGAGTTCCATA,0,848643
dgoRp,0.5,1,1,TGCTTGATCGGCTTGATTGA,0,857063
dgoRp,0.5,1,1,TGCTCCCTATCAAGCGGGGG,0,856728
dgoRp,0.5,1,1,TGCTACGGATTCTTTATCCT,0,858576
dgoRp,0.5,1,1,TGCGCCCCTGACGGTGTGAC,0,845113
dgoRp,0.5,1,1,TGCGATGCCTCGACCCCAGC,0,851522
dgoRp,0.5,1,1,TGCCCTTAGGCTTACGGGGT,0,849958
dgoRp,0.5,1,1,TGCATGACTATCTCCCGGTC,0,864160
dgoRp,0.5,1,1,TGCATGACATCAAGGACTGG,0,850025
dgoRp,0.5,1,1,TGCAGTAATAGTAAGTGCGC,0,853216
dgoRp,0.5,1,1,TGATTTGGCAACCGTAGTAA,0,857167
dgoRp,0.5,1,1,TGATCACGACGTGTGGGAGG,0,838843
dgoRp,0.5,1,1,TGATAGTTGGTACAAGGCTT,0,842736
dgoRp,0.5,1,1,TGATAGTGCGGCTGTATGAC,0,847199
dgoRp,0.5,1,1,TGAGGTACATAGGCTCTGAC,0,863771
dgoRp,0.5,1,1,TGAGGCATAAGGCGTCGGGT,0,857839
dgoRp,0.5,1,1,TGAGCACATATCTATTGGTC,0,851091
dgoRp,0.5,1,1,TGAGATAGTCAGTTTTATAC,0,850830
dgoRp,0.5,1,1,TGAGAGTCGCCTCCATATGT,0,843187
dgoRp,0.5,1,1,TGAGAAGGCTACGGAAGCTC,0,858654
dgoRp,0.5,1,1,TGACTGACCGATGGCAGTTT,0,856848
dgoRp,0.5,1,1,TGACCCCCTCTTGTGTGTCG,0,857307
dgoRp,0.5,1,1,TGAATGGAGCTGAAACACCG,0,851140
dgoRp,0.5,1,1,TGAATAGTATACGCGGAAGT,0,857418
dgoRp,0.5,1,1,TGAAGTCTCCAGTGTCTACT,0,851311
dgoRp,0.5,1,1,TGAAGAACGTTCCTTACGGT,0,854034
dgoRp,0.5,1,1,TGAAAGATCGGTGTTCCAGA,0,859916
dgoRp,0.5,1,1,TCTTTTTTTCTGGGAAGGGG,0,856227
dgoRp,0.5,1,1,TCTTTGGTTCCACATAGTAA,0,867028
dgoRp,0.5,1,1,TCTTGATGTAAATGGATGTT,0,835816
dgoRp,0.5,1,1,TCTTAGGAAGCCTCGGCGAA,0,857337
dgoRp,0.5,1,1,TCTGTGCTATACCAGGATTA,0,856688
dgoRp,0.5,1,1,TCTGGTGGGACTTCTTTTTC,0,860476
dgoRp,0.5,1,1,TCTGGGAAATTACTTCTCGA,0,842492
dgoRp,0.5,1,1,TCTGCTGTGAGTCAGAATTA,0,839183
dgoRp,0.5,1,1,TCTGCGTGACGGAACACACT,0,854806
dgoRp,0.5,1,1,TCTGCGGTTAGAGTAGTACC,0,846542
dgoRp,0.5,1,1,TCTGATCTGGACGCAGAAGT,0,850591
dgoRp,0.5,1,1,TCTCTGTTTATTTTCCCCGT,0,844500
dgoRp,0.5,1,1,TCTCTACCTATACTTTACCG,0,837254
dgoRp,0.5,1,1,TCTCGGCATTCTTCGACTAT,0,846978
dgoRp,0.5,1,1,TCTCCCCGCGCACCAGACAA,0,838499
dgoRp,0.5,1,1,TCTCAAAGTATAGGATGACG,0,851929
dgoRp,0.5,1,1,TCTATTAGTGCGCTCTCGAC,0,848032
dgoRp,0.5,1,1,TCGTTCACACCCCCCGGGCC,0,845051
dgoRp,0.5,1,1,TCGTCTTGACCGGTACAGAT,0,864720
dgoRp,0.5,1,1,TCGTACGAAGACAATTAGGA,0,867008
dgoRp,0.5,1,1,TCGGGTGTACTCGCTCGTTT,0,862728
dgoRp,0.5,1,1,TCGGCGGAAGTGACAAAAGT,0,838959
dgoRp,0.5,1,1,TCGGACCGTGGGCGGAAGCG,0,853367
dgoRp,0.5,1,1,TCGGAACATATATTTCCCTA,0,846688
dgoRp,0.5,1,1,TCGCGGAGAACATTTGTTCT,0,860287
dgoRp,0.5,1,1,TCGCACGAATAATTGTCTGG,0,849826
dgoRp,0.5,1,1,TCGCACAGGACTGGTTGTGT,0,850796
dgoRp,0.5,1,1,TCGATCGTGGGTGGCGGTGT,0,859479
dgoRp,0.5,1,1,TCGAGTTTAAGGTTGATGTT,0,843540
dgoRp,0.5,1,1,TCGAGTCTGCCCCAAAGCAA,0,853747
dgoRp,0.5,1,1,TCGAGGGCTTTACTTCCCTA,0,855339
dgoRp,0.5,1,1,TCCTTGCCCTTAGCTTCGTA,0,852235
dgoRp,0.5,1,1,TCCTGGGCTTCAAAGATTAG,0,843385
dgoRp,0.5,1,1,TCCTCAGTGGACACATTATA,0,860203
dgoRp,0.5,1,1,TCCGTGCGGGGTAGTCAAAC,0,850229
dgoRp,0.5,1,1,TCCGGTGAAAAGGCTGTGGT,0,854229
dgoRp,0.5,1,1,TCCCTGCTCATAGGCGTCCG,0,840876
dgoRp,0.5,1,1,TCCCTCAATGGTCACGCCAT,0,855277
dgoRp,0.5,1,1,TCCCGGTATTGAACATTAGG,0,846719
dgoRp,0.5,1,1,TCCCATTCCGCGTCTCCGAA,0,862149
dgoRp,0.5,1,1,TCCAGTGGAGATTTTGGAGT,0,851260
dgoRp,0.5,1,1,TCATTTTGTTGGATGTGGCT,0,846200
dgoRp,0.5,1,1,TCATTGTATGCAATAGTCGT,0,856767
dgoRp,0.5,1,1,TCATGCACTTAATGATTGTC,0,867486
dgoRp,0.5,1,1,TCATAAGTCAGACGAGACTG,0,843051
dgoRp,0.5,1,1,TCAGGCTTAGGATGATCGCC,0,867077
dgoRp,0.5,1,1,TCAGGCTCATCGCCGTCAAC,0,841164
dgoRp,0.5,1,1,TCAGCTGGTGGCTGCTGGGA,0,842448
dgoRp,0.5,1,1,TCAGCTATTTTGAGCGAGCT,0,854134
dgoRp,0.5,1,1,TCAGCGCAACTCCAGACCGT,0,853728
dgoRp,0.5,1,1,TCACTCTTTACTTTCTGACT,0,854824
dgoRp,0.5,1,1,TCACTACGATTTCGATCATC,0,840867
dgoRp,0.5,1,1,TCACGGTGGCGGGCCTGGCG,0,848790
dgoRp,0.5,1,1,TCACCATATAGTCTTGCACA,0,858827
dgoRp,0.5,1,1,TCACATTCTTGGTAACGAGT,0,864216
dgoRp,0.5,1,1,TCACAGGCTGGTCAATGCAT,0,860374
dgoRp,0.5,1,1,TCAATCGACCTATACTACAG,0,857265
dgoRp,0.5,1,1,TCAATAAGCTCGGTGAGTGC,0,852221
dgoRp,0.5,1,1,TCAACATATCTACGCCAGAG,0,856715
dgoRp,0.5,1,1,TATTTCAGCAACAAACATTG,0,861899
dgoRp,0.5,1,1,TATTTATACCGCCTAGAATT,0,841560
dgoRp,0.5,1,1,TATTGGGGATTACTTTAAGG,0,839587
dgoRp,0.5,1,1,TATTCTCCGATACCAGGGCC,0,860792
dgoRp,0.5,1,1,TATTCCCGCCTCAGGTTGTT,0,836800
dgoRp,0.5,1,1,TATGTTGGGACGAAACGTGA,0,862269
dgoRp,0.5,1,1,TATGGTGCAAACTAGAAAGT,0,839333
dgoRp,0.5,1,1,TATGGTAACGCCTCTGATCT,0,844628
dgoRp,0.5,1,1,TATGGCTTCAGGCTGTCGCA,0,842188
dgoRp,0.5,1,1,TATGCGGACGCTACCCCTTC,0,853467
dgoRp,0.5,1,1,TATGATTTCTGAGGCCAGGG,0,846077
dgoRp,0.5,1,1,TATCTTACCTCGTGCTAATG,0,841034
dgoRp,0.5,1,1,TATATGGAGGAACCCAAGAA,0,863950
dgoRp,0.5,1,1,TATAGCGACATGAGAAACAG,0,866619
dgoRp,0.5,1,1,TATAGCCCAGGTCTCCCTGG,0,853045
dgoRp,0.5,1,1,TATACATCGTGGATTAACGC,0,846918
dgoRp,0.5,1,1,TATAAGGGATTCCTTCTTAG,0,848277
dgoRp,0.5,1,1,TATAAATGTACTCCCAACTA,0,862818
dgoRp,0.5,1,1,TAGTGGAGCAGTTGGTACTG,0,849519
dgoRp,0.5,1,1,TAGGGCCTATTCAGGAAGAC,0,862499
dgoRp,0.5,1,1,TAGGGATTTTGAGGCGATCG,0,865639
dgoRp,0.5,1,1,TAGGGATGTGGGCTGTTCAG,0,840403
dgoRp,0.5,1,1,TAGCGGATCAACCGCACGCC,0,852184
dgoRp,0.5,1,1,TAGCGCGGACATGTTGGTTT,0,855229
dgoRp,0.5,1,1,TAGCACCTCATGCGGTGCCT,0,848488
dgoRp,0.5,1,1,TAGATGTCCTTTGGCATCCG,0,851046
dgoRp,0.5,1,1,TAGATGGTGATATAGGTGTT,0,861258
dgoRp,0.5,1,1,TAGATCACATCGAAATAGCC,0,847454
dgoRp,0.5,1,1,TAGATATACCAACTCTTTAG,0,856813
dgoRp,0.5,1,1,TAGAGCCTATTAAAGTCTCA,0,848784
dgoRp,0.5,1,1,TAGACTTAGCGGGGCACTGT,0,851723
dgoRp,0.5,1,1,TAGAAGGAGCCCGTGTGGTG,0,866545
dgoRp,0.5,1,1,TAGAACGTCATTGGGAGCCT,0,865219
dgoRp,0.5,1,1,TACTGGTCTTGTAGTACTAT,0,835944
dgoRp,0.5,1,1,TACGGGTACGGTAAGAGGAT,0,849828
dgoRp,0.5,1,1,TACGCCTCATGGTCGGCCCC,0,838428
dgoRp,0.5,1,1,TACCGTGTACAAATAGACAA,0,850041
dgoRp,0.5,1,1,TACCAGGATAGCACGCATCC,0,841814
dgoRp,0.5,1,1,TACCAGCTGCGCAGTGGGGC,0,839614
dgoRp,0.5,1,1,TACATTTAAGGATGCCCAAA,0,860554
dgoRp,0.5,1,1,TACAGCCTCTGGCGTAAGCT,0,840190
dgoRp,0.5,1,1,TACAAAACGACAGATAGGTT,0,858050
dgoRp,0.5,1,1,TAAGCGTGGACCTGACATCT,0,856315
dgoRp,0.5,1,1,TAAGACTGGGCCGAGGTCCG,0,854239
dgoRp,0.5,1,1,TAAGAACGCTATGGTATTTG,0,844949
dgoRp,0.5,1,1,TAACTTTTCACAAACCCGGA,0,845104
dgoRp,0.5,1,1,TAACTAGGACTCTGTTCATA,0,865615
dgoRp,0.5,1,1,TAACGGTCATTGTTATCCAA,0,858377
dgoRp,0.5,1,1,TAAATATCATTTGCTTGTAT,0,845108
dgoRp,0.5,1,1,TAAAGCACAGAGCGGCCGGG,0,866711
dgoRp,0.5,1,1,TAAAAGTACAAGAGTTTGAG,0,837846
dgoRp,0.5,1,1,TAAAAATGGAATGTAAAGCT,0,846811
dgoRp,0.5,1,1,GTTTTTGGCCCGGCAGGCTA,0,845914
dgoRp,0.5,1,1,GTTTTCTTATCTGCCGGTAG,0,863850
dgoRp,0.5,1,1,GTTTGTCCTGACATTAAGAC,0,856344
dgoRp,0.5,1,1,GTTTGGGTTCTATAAGAGTA,0,853081
dgoRp,0.5,1,1,GTTTGGACCCCAGTGCCTAA,0,857363
dgoRp,0.5,1,1,GTTTCGTCCCAGTAGTGAGA,0,842570
dgoRp,0.5,1,1,GTTTAAGTCGTTGGGCAAGC,0,861681
dgoRp,0.5,1,1,GTTGTCCCGCAGCGTGTATG,0,852693
dgoRp,0.5,1,1,GTTGAATCCTGACACACGGT,0,864608
dgoRp,0.5,1,1,GTTCTCATCAGGTATTATAA,0,859713
dgoRp,0.5,1,1,GTTCCAGCACTCGCGTTAGA,0,848226
dgoRp,0.5,1,1,GTTCATCTGCAGTCACTGTG,0,861558
dgoRp,0.5,1,1,GTTATCCGCTAAGCCCAAGT,0,864722
dgoRp,0.5,1,1,GTTATAAAGCAGGAGATAGC,0,863410
dgoRp,0.5,1,1,GTTAGCCTGGCTTTAATATA,0,862231
dgoRp,0.5,1,1,GTGTTATCGGAAGTGGCCTA,0,866866
dgoRp,0.5,1,1,GTGTGTCGTGATGATAGGTA,0,846904
dgoRp,0.5,1,1,GTGTGGTCATCAGAGTACCC,0,856906
dgoRp,0.5,1,1,GTGTAGTATTCGCTCCTTCA,0,836600
dgoRp,0.5,1,1,GTGGTTAAGACGAGTGTAGA,0,855519
dgoRp,0.5,1,1,GTGGTCCTGAGCTCACGAGA,0,843678
dgoRp,0.5,1,1,GTGGCATTAGACGTTCATAT,0,863551
dgoRp,0.5,1,1,GTGGCAACTATACACGTGAC,0,843343
dgoRp,0.5,1,1,GTGCTTCGTAGAATTATAGC,0,860950
dgoRp,0.5,1,1,GTGCTTCGGGCGCTCTGTAC,0,858651
dgoRp,0.5,1,1,GTGATGTGCCCGGAAGGTAG,0,856089
dgoRp,0.5,1,1,GTGAGTGCTATACGAACTGC,0,838957
dgoRp,0.5,1,1,GTCTTTGGGGTAAAGTCTAC,0,863945
dgoRp,0.5,1,1,GTCTCTGCCGTAATCAGAGT,0,842241
dgoRp,0.5,1,1,GTCTCTCGGAGCCAGCGAAC,0,861414
dgoRp,0.5,1,1,GTCTATAATGTGTGCAGGCC,0,847025
dgoRp,0.5,1,1,GTCGGGGAATCAGAGTAAGT,0,854695
dgoRp,0.5,1,1,GTCGAGGCGAAGGGGCCGAT,0,861067
dgoRp,0.5,1,1,GTCGAACGCCCACCTCAGAG,0,859495
dgoRp,0.5,1,1,GTCCTCCACAGAGACTGTGG,0,864890
dgoRp,0.5,1,1,GTCCTCAGCACAAAGTGGCT,0,855056
dgoRp,0.5,1,1,GTCCACATGAGACGATTTGT,0,836111
dgoRp,0.5,1,1,GTCAGTTCTTCTCTTTCCCG,0,853447
dgoRp,0.5,1,1,GTCAGTGGCTGACTTAAGCG,0,854604
dgoRp,0.5,1,1,GTCAAGGAATGTCGATCGTA,0,849486
dgoRp,0.5,1,1,GTATTGCCTTGTATGTGTTA,0,842728
dgoRp,0.5,1,1,GTATCGTGGCTCGTAGTCAT,0,848381
dgoRp,0.5,1,1,GTATAGGACTACGATCTAGT,0,866647
dgoRp,0.5,1,1,GTAGCGGCGGATATCAATCA,0,866297
dgoRp,0.5,1,1,GTAGAGCTGGCGTACAACGA,0,866171
dgoRp,0.5,1,1,GTACCGAAGCGTCGTGCGTT,0,860334
dgoRp,0.5,1,1,GTAATGAGCACCGCCTTAGG,0,849230
dgoRp,0.5,1,1,GTAAGTTAGGTGTAACAAGG,0,865204
dgoRp,0.5,1,1,GTAAGAAGACGACTGACTAA,0,847091
dgoRp,0.5,1,1,GGTTGGATATAGGAAGAAAG,0,866114
dgoRp,0.5,1,1,GGTTAGCATTACAGATGGCC,0,844930
dgoRp,0.5,1,1,GGTTACGGTGGGCAACGTCG,0,858205
dgoRp,0.5,1,1,GGTGTCACTACTCTGTGGTG,0,836757
dgoRp,0.5,1,1,GGTGGTGAGTTCTGCACGGT,0,861531
dgoRp,0.5,1,1,GGTGGGTAGGAATTGTGCTG,0,852332
dgoRp,0.5,1,1,GGTGGGAAGCTTTTTGGTGA,0,846471
dgoRp,0.5,1,1,GGTGGAATAGCTTGGAATAA,0,864174
dgoRp,0.5,1,1,GGTGCTTGTGTATACCGCTG,0,858036
dgoRp,0.5,1,1,GGTGACATCCGCAGGAAGCT,0,849023
dgoRp,0.5,1,1,GGTCTGTTTAGCTACGTTCC,0,857801
dgoRp,0.5,1,1,GGTCTGTTACAGTTAGCCGT,0,837750
dgoRp,0.5,1,1,GGTCCTATTAGGTACTACGT,0,855979
dgoRp,0.5,1,1,GGTCCTATAGAGAGTCTCAT,0,866534
dgoRp,0.5,1,1,GGTCAGGGTTTAGTCACGGT,0,846347
dgoRp,0.5,1,1,GGTCAGGGCTGCTGTTCTAT,0,859069
dgoRp,0.5,1,1,GGTATCCCTGGAATGTAATC,0,839663
dgoRp,0.5,1,1,GGTATAGATAGACTAGGCTT,0,837110
dgoRp,0.5,1,1,GGTAGTCCAGTATTGGTACC,0,858962
dgoRp,0.5,1,1,GGTAGGGAGAAAATTCTGAC,0,856534
dgoRp,0.5,1,1,GGTACGTATGGGTTACACCC,0,845579
dgoRp,0.5,1,1,GGTACGAGTTGATGCTGTAT,0,855664
dgoRp,0.5,1,1,GGTACCCTCCGCATTCTCCC,0,836155
dgoRp,0.5,1,1,GGTACATTGAATTCACGGGA,0,858185
dgoRp,0.5,1,1,GGTAATTGTCAACAGTGAGG,0,847358
dgoRp,0.5,1,1,GGGTGTCACCAGCCGAGCAA,0,847202
dgoRp,0.5,1,1,GGGTCCTGCCTAGTATGTAT,0,867344
dgoRp,0.5,1,1,GGGTCCACACTGGGAAAAGA,0,836343
dgoRp,0.5,1,1,GGGTATCGAGGACGGGTCGC,0,852954
dgoRp,0.5,1,1,GGGTAGGTCGAAGAAATAGT,0,840860
dgoRp,0.5,1,1,GGGGTACTGGCGAAAGGGTA,0,843534
dgoRp,0.5,1,1,GGGGCAGGATGGACCAAAGG,0,847729
dgoRp,0.5,1,1,GGGGCACAAAGTCTCCTACC,0,837820
dgoRp,0.5,1,1,GGGCTGGGCCGGGTCTGGGA,0,861792
dgoRp,0.5,1,1,GGGCTAGATTGTGAGACGGA,0,865099
dgoRp,0.5,1,1,GGGCCGGCAAGACACATATA,0,853227
dgoRp,0.5,1,1,GGGATTTGTAGGCTCCAGTG,0,854158
dgoRp,0.5,1,1,GGGATAACCGGCATAGACGA,0,843030
dgoRp,0.5,1,1,GGGAGTTAAACCACCGCTCA,0,842634
dgoRp,0.5,1,1,GGGAGGTAATTACAGCTCTC,0,864904
dgoRp,0.5,1,1,GGGAATAGGTCTGCTGGAGT,0,850689
dgoRp,0.5,1,1,GGGAAGGTGGCGAAGATACT,0,862127
dgoRp,0.5,1,1,GGCTTTAAAACCAGCTCATC,0,866934
dgoRp,0.5,1,1,GGCTTCGTGATGTAGGTTTA,0,850688
dgoRp,0.5,1,1,GGCTTATGGTCGTCAACAAC,0,842230
dgoRp,0.5,1,1,GGCTGACGGCATCAAAGCCT,0,854756
dgoRp,0.5,1,1,GGCTCGCTTGAGCAGCTCAT,0,837111
dgoRp,0.5,1,1,GGCTCATGAGTAACTAAAAG,0,838720
dgoRp,0.5,1,1,GGCGCACCCTTCGCCTTCGT,0,843946
dgoRp,0.5,1,1,GGCGAAGTGGACACAGGCGG,0,842273
dgoRp,0.5,1,1,GGCGAAACACTGCTATTTCA,0,859959
dgoRp,0.5,1,1,GGCCGTAGTGTTCTGCACGC,0,852041
dgoRp,0.5,1,1,GGCCCGAACAACGGGATAAT,0,841350
dgoRp,0.5,1,1,GGCATTCAAAGCCCCCCCTT,0,857744
dgoRp,0.5,1,1,GGCATGGCGCCAAACCACAT,0,865297
dgoRp,0.5,1,1,GGCATGGACGCCCGCGCGTT,0,862854
dgoRp,0.5,1,1,GGCATGCAAGGGTTCATTTG,0,866926
dgoRp,0.5,1,1,GGCACTCTGTCCGGTTGAGA,0,840875
dgoRp,0.5,1,1,GGCACGTTAAGGATAGTTCT,0,863886
dgoRp,0.5,1,1,GGCACACGGACTTTCGGATT,0,840841
dgoRp,0.5,1,1,GGATTCGAAGTTGGTAGATA,0,839847
dgoRp,0.5,1,1,GGATTACGCTGGGGCTTCAA,0,856424
dgoRp,0.5,1,1,GGATTACCTGGAGTGTAGTG,0,835847
dgoRp,0.5,1,1,GGATGCAAGAATCCAATATG,0,866390
dgoRp,0.5,1,1,GGATCGCTTGAACAGACCAG,0,837865
dgoRp,0.5,1,1,GGATAGCAATTCACATGAAA,0,853268
dgoRp,0.5,1,1,GGAGTGGACCGCTATGGGTG,0,850163
dgoRp,0.5,1,1,GGAGTAATGTTGTGTCCTAT,0,837514
dgoRp,0.5,1,1,GGAGGTGTTCCTTTGATGTC,0,838137
dgoRp,0.5,1,1,GGAGGTGCGCAGGGGGGACT,0,860756
dgoRp,0.5,1,1,GGAGGGGCGGAAAACGTCAA,0,848181
dgoRp,0.5,1,1,GGAGAGTTGTAGCCATCATC,0,836108
dgoRp,0.5,1,1,GGACGAGCACTGTGACTTAG,0,858466
dgoRp,0.5,1,1,GGACCCTGAAATTGGAGGCT,0,852199
dgoRp,0.5,1,1,GGACCCGCCGGGACCCCAGT,0,854815
dgoRp,0.5,1,1,GGACAGTTATCATGTTCAGA,0,859480
dgoRp,0.5,1,1,GGAATCACCCGGTCGGGTAT,0,840019
dgoRp,0.5,1,1,GGAAAGGCATCATACAGACA,0,836005
dgoRp,0.5,1,1,GCTTTTATCCGAACACGGCC,0,841982
dgoRp,0.5,1,1,GCTTTGGGAATCCCTGGGAG,0,855685
dgoRp,0.5,1,1,GCTTTAACGGAACTCATCAC,0,849646
dgoRp,0.5,1,1,GCTTCGCGGTTTCGCGACCA,0,851884
dgoRp,0.5,1,1,GCTTCATGCAGTACCTTTAC,0,844019
dgoRp,0.5,1,1,GCTTAGCTCAACTAATGTCT,0,856077
dgoRp,0.5,1,1,GCTTAGCGCGAGTAGAACCC,0,842174
dgoRp,0.5,1,1,GCTGGTAATATACTGTCTGT,0,855564
dgoRp,0.5,1,1,GCTGGGTAGGGATACCCGGA,0,866413
dgoRp,0.5,1,1,GCTGGCCCACGACAGCCACA,0,838935
dgoRp,0.5,1,1,GCTGATGCTTGGTAGCGTTA,0,838390
dgoRp,0.5,1,1,GCTGACATATAAAAAGAGTT,0,857209
dgoRp,0.5,1,1,GCTCGTTATCCGTCGCCTAG,0,842884
dgoRp,0.5,1,1,GCTAGTTCGCCCACTCATAG,0,844149
dgoRp,0.5,1,1,GCTACCTAGCGTTTAACGAG,0,837449
dgoRp,0.5,1,1,GCTACATTCACAGTTCCTGA,0,859257
dgoRp,0.5,1,1,GCTACAGCATGAGACAGTCA,0,863021
dgoRp,0.5,1,1,GCTAATCTAGCATAACGTCG,0,837917
dgoRp,0.5,1,1,GCGTGTATCCTAGGACTATG,0,858013
dgoRp,0.5,1,1,GCGTCGGTGGCGGACGCTTC,0,846755
dgoRp,0.5,1,1,GCGGTTCTTGGCAGGCACAG,0,857425
dgoRp,0.5,1,1,GCGGTTAAATGATCACGCGA,0,855536
dgoRp,0.5,1,1,GCGGCTCTCAGAGCCTGTAA,0,842991
dgoRp,0.5,1,1,GCGGAACTGGATCTCCACAT,0,846379
dgoRp,0.5,1,1,GCGGAACTACACCCACTGCG,0,851076
dgoRp,0.5,1,1,GCGCTAGTTACGAGAGTGAT,0,836038
dgoRp,0.5,1,1,GCGCTAACGCCGTCATGTCA,0,845618
dgoRp,0.5,1,1,GCGCTAAAGCAGACTATGAT,0,866514
dgoRp,0.5,1,1,GCGCAGTTAAGGTTATGATG,0,860260
dgoRp,0.5,1,1,GCGATGCGATCTAAGATCCA,0,855734
dgoRp,0.5,1,1,GCGACCCCTTGCGATTTAGC,0,845221
dgoRp,0.5,1,1,GCGACACGACAAGCCATTGC,0,867191
dgoRp,0.5,1,1,GCGAATGTGCAATGCTTAGG,0,840838
dgoRp,0.5,1,1,GCCTTTATGGGCATTGTTCT,0,853381
dgoRp,0.5,1,1,GCCTGGCCCCTTATTGTTAC,0,855825
dgoRp,0.5,1,1,GCCTGACGGGCGGTTGACAG,0,864493
dgoRp,0.5,1,1,GCCTCCTGCAACACTTAATC,0,840282
dgoRp,0.5,1,1,GCCGTTGAGCCCACGTGGGT,0,852019
dgoRp,0.5,1,1,GCCGTTCAGTTCATAATATG,0,855183
dgoRp,0.5,1,1,GCCGTCAATTTTTAAGTTGA,0,836086
dgoRp,0.5,1,1,GCCGCGAGGGAGAGCAACGA,0,850680
dgoRp,0.5,1,1,GCCGATAATAGCTATAGTCT,0,862312
dgoRp,0.5,1,1,GCCGAGTGCTTTTGGGTCAA,0,860927
dgoRp,0.5,1,1,GCCGACGGACGCTTAGAACC,0,850111
dgoRp,0.5,1,1,GCCGAATCATAAGACGGGGT,0,861052
dgoRp,0.5,1,1,GCCCGGTCTGATAGGGTAAG,0,861900
dgoRp,0.5,1,1,GCCCATTGGGAAAACCTTGC,0,840802
dgoRp,0.5,1,1,GCCCAGAAGCGTTAATTAAC,0,850284
dgoRp,0.5,1,1,GCCATCCTGATCCGATGGTG,0,848104
dgoRp,0.5,1,1,GCCAGCCACGCGACTTTATT,0,861961
dgoRp,0.5,1,1,GCCACGCCGTACGTTTTGTA,0,843345
dgoRp,0.5,1,1,GCCACGACCGACGCCTATTG,0,862631
dgoRp,0.5,1,1,GCCAACAGTATATCGCGGCG,0,867234
dgoRp,0.5,1,1,GCCAACAAGGATCAGAAGTC,0,838606
dgoRp,0.5,1,1,GCATTCTACGGTGAAGGAGT,0,850198
dgoRp,0.5,1,1,GCATCCTATCTACTATACTA,0,838841
dgoRp,0.5,1,1,GCAGTTGGGCTCTGTGCAAG,0,854567
dgoRp,0.5,1,1,GCAGCTAACTAGGCTCGCGT,0,860641
dgoRp,0.5,1,1,GCAGCGGCGATTGCCGCGAA,0,863992
dgoRp,0.5,1,1,GCAGATACGCGGAACCATCG,0,836974
dgoRp,0.5,1,1,GCACGGTCCGATGGTTGGTC,0,854174
dgoRp,0.5,1,1,GCACGATTCGGTGACTAAGT,0,866863
dgoRp,0.5,1,1,GCACCGAGTTGTCCGTTCAC,0,862498
dgoRp,0.5,1,1,GCACATGTTCTCAAATAGCT,0,840750
dgoRp,0.5,1,1,GCAATTTCTATGCCGCAGTA,0,836977
dgoRp,0.5,1,1,GCAATCGGTATTGCAGTTAC,0,867484
dgoRp,0.5,1,1,GCAAACAGAAGCGGTATCGG,0,846635
dgoRp,0.5,1,1,GATTGTGCATTGTGCCGGCT,0,859093
dgoRp,0.5,1,1,GATTGTGAAGGTGTTTAGAG,0,852154
dgoRp,0.5,1,1,GATGTCGGGGTGTAAGCACC,0,864176
dgoRp,0.5,1,1,GATGTATAGTTAGCAAAGCA,0,852186
dgoRp,0.5,1,1,GATGGATCTTAATAGACCCG,0,865400
dgoRp,0.5,1,1,GATGGAAGGCGTAATTTTTG,0,848026
dgoRp,0.5,1,1,GATGATTGAAGGCCGTGGGC,0,863108
dgoRp,0.5,1,1,GATCTTTTACGATGCTCGCA,0,844102
dgoRp,0.5,1,1,GATCTCCTTCGTAGTTGCAT,0,858291
dgoRp,0.5,1,1,GATCGCCACACACGGTCTCT,0,838677
dgoRp,0.5,1,1,GATCGAGCGGCATAGTCGTA,0,861659
dgoRp,0.5,1,1,GATATTAGGTAGAGGTATTA,0,839967
dgoRp,0.5,1,1,GATATGGCAAAAGAGTTCCA,0,844732
dgoRp,0.5,1,1,GATATGACAGTCCGGGGTCA,0,840730
dgoRp,0.5,1,1,GATACCGGGCGGATCCCAGC,0,856149
dgoRp,0.5,1,1,GATAATTATCCACGACGGTA,0,853142
dgoRp,0.5,1,1,GAGTTGAGAGTCAGTCAACA,0,843815
dgoRp,0.5,1,1,GAGTTCAGGCAAGAAGGGAG,0,864640
dgoRp,0.5,1,1,GAGTGGTATAATCATTCAAT,0,856311
dgoRp,0.5,1,1,GAGTGGCAGCCACATCGCAT,0,862720
dgoRp,0.5,1,1,GAGTGCTTGCTACGACTACA,0,852548
dgoRp,0.5,1,1,GAGTATTAGCGAGCTTCTTC,0,847438
dgoRp,0.5,1,1,GAGGTTGTCTTCTGAGGGTA,0,841305
dgoRp,0.5,1,1,GAGGTCATGCATCTCAGAGG,0,859121
dgoRp,0.5,1,1,GAGGTAAGGAGTCTCCGCTA,0,860719
dgoRp,0.5,1,1,GAGGGGGGTTGAGGAATACA,0,861537
dgoRp,0.5,1,1,GAGGGAACTTCTTGGTGGCC,0,853379
dgoRp,0.5,1,1,GAGCGAGAGCTTACTTAAAA,0,849637
dgoRp,0.5,1,1,GAGCCGCCGTGTTAAAATAT,0,857486
dgoRp,0.5,1,1,GAGCCCCCAAAGCGCTTAAT,0,858092
dgoRp,0.5,1,1,GAGCACCTTACACAGTATAG,0,839133
dgoRp,0.5,1,1,GAGCAACGTCTCCATGGGGT,0,851284
dgoRp,0.5,1,1,GAGATATCATCCACGGCCTT,0,854504
dgoRp,0.5,1,1,GAGACTGTGCGTTGCTTCGC,0,836801
dgoRp,0.5,1,1,GACTTTGTGCAATCGAGTCT,0,858108
dgoRp,0.5,1,1,GACTGCTTTACCTACTTCTA,0,839622
dgoRp,0.5,1,1,GACTCGTCACATCCGATATG,0,857892
dgoRp,0.5,1,1,GACTCGGTCCTTTTTTTGCA,0,844471
dgoRp,0.5,1,1,GACTCGCGCGCCTGGAACTC,0,844794
dgoRp,0.5,1,1,GACTATGCATTTTGACAGTT,0,862066
dgoRp,0.5,1,1,GACTATATGTACCAGATAGC,0,840729
dgoRp,0.5,1,1,GACGGACTTTTTACTTGTTC,0,847226
dgoRp,0.5,1,1,GACCTGAGTTCAGGTCTGAA,0,838284
dgoRp,0.5,1,1,GACCTCGACTTTTACAAGGT,0,865080
dgoRp,0.5,1,1,GACCAGGCGGGAACCTGTCA,0,846258
dgoRp,0.5,1,1,GACACATTACACGATGCGGG,0,841711
dgoRp,0.5,1,1,GACAATGGCCCTACATAAAA,0,865555
dgoRp,0.5,1,1,GACAAGTCATGATACACGGG,0,844844
dgoRp,0.5,1,1,GAATTCTCTGGGTCCCGATA,0,862254
dgoRp,0.5,1,1,GAATTACACAAAGCTGATAC,0,842493
dgoRp,0.5,1,1,GAATGGGCCGGGCGCAGACG,0,863680
dgoRp,0.5,1,1,GAATAGACTCACTTAAAAGC,0,853273
dgoRp,0.5,1,1,GAAGGGCTGATCTCTGCTTC,0,855932
dgoRp,0.5,1,1,GAAGAGTTAGTAGTGCGATG,0,835988
dgoRp,0.5,1,1,GAACTGGCCTGCCAAGGTTA,0,857220
dgoRp,0.5,1,1,GAACACGCCACAGGGCGTGC,0,859026
dgoRp,0.5,1,1,GAACAATGCTTTTTAAATGC,0,846328
dgoRp,0.5,1,1,CTTTGAAGGCTGGCTCTTCG,0,852323
dgoRp,0.5,1,1,CTTTCAACAGGATAGCCCAC,0,853967
dgoRp,0.5,1,1,CTTGGTTACTACCATCCCGT,0,837435
dgoRp,0.5,1,1,CTTGAAGATGCTGTAGGAGC,0,846284
dgoRp,0.5,1,1,CTTCTTGCCGGGGCACATAA,0,855561
dgoRp,0.5,1,1,CTTCTTCACGATTGGCCCCC,0,857369
dgoRp,0.5,1,1,CTTCGCCGGCCGATGAGTCT,0,864812
dgoRp,0.5,1,1,CTTCAATTCATGACGGGTTC,0,835983
dgoRp,0.5,1,1,CTTCAACAGAGCTGTGTACT,0,842166
dgoRp,0.5,1,1,CTTATGATAGGGTTTCCTTA,0,836861
dgoRp,0.5,1,1,CTTACGTTCTGTGCGCTGCA,0,866760
dgoRp,0.5,1,1,CTTACATGTTAGTGATACCA,0,854015
dgoRp,0.5,1,1,CTTAACAAAATTGGCCGGGA,0,837242
dgoRp,0.5,1,1,CTGTTGCCGGGAGGGTGGGT,0,860571
dgoRp,0.5,1,1,CTGTTCGGTAATAGGCCTAG,0,844184
dgoRp,0.5,1,1,CTGTGTAGGGTTTTGCTATG,0,863111
dgoRp,0.5,1,1,CTGTGTAAATAAAACGAATT,0,847664
dgoRp,0.5,1,1,CTGTGAGACTTCTGTTATGG,0,850530
dgoRp,0.5,1,1,CTGTCCAAATACGTCGTAAA,0,844457
dgoRp,0.5,1,1,CTGGTCTGAACTTTAACAGG,0,864954
dgoRp,0.5,1,1,CTGGTCAATTAACAGCTAGA,0,841911
dgoRp,0.5,1,1,CTGGGTGATAACAGTACAGA,0,858884
dgoRp,0.5,1,1,CTGCATTCTTCCCATTCACA,0,848077
dgoRp,0.5,1,1,CTGACAGGGCAATACTTAGT,0,837412
dgoRp,0.5,1,1,CTCTTATCAGCGTTGCACAC,0,857675
dgoRp,0.5,1,1,CTCTCTCAGAGCAAACAACT,0,858117
dgoRp,0.5,1,1,CTCTCGATCACAGCGCTTTT,0,861277
dgoRp,0.5,1,1,CTCTATCCTGGGTGTCATTT,0,855846
dgoRp,0.5,1,1,CTCGTGTGGGAGCCGTATTC,0,862927
dgoRp,0.5,1,1,CTCGTATAGGTCCCATAGAT,0,858901
dgoRp,0.5,1,1,CTCGTAATGACTTGCCAGCG,0,847072
dgoRp,0.5,1,1,CTCGGTTTGTGCACAAATAA,0,855557
dgoRp,0.5,1,1,CTCGGAACGTTACAAGGCCC,0,858257
dgoRp,0.5,1,1,CTCGCTGGACGTGCTCGCAG,0,851212
dgoRp,0.5,1,1,CTCGCATCTTTGGGGTAGTT,0,851842
dgoRp,0.5,1,1,CTCGAGGGTGATCTTGGTTT,0,847357
dgoRp,0.5,1,1,CTCCTTCGCTGGCACCGCAA,0,857618
dgoRp,0.5,1,1,CTCCGTTTCAGGACGGCCCT,0,862650
dgoRp,0.5,1,1,CTCCGAACTTGTCGGGTTCG,0,835970
dgoRp,0.5,1,1,CTCCCTGTCAAGCGAACGAC,0,864062
dgoRp,0.5,1,1,CTCCCGCTACCAACTGCATG,0,864853
dgoRp,0.5,1,1,CTCCAAGAACCTTGGTGGTT,0,857406
dgoRp,0.5,1,1,CTCAGTATTGTTAACTCTTC,0,857529
dgoRp,0.5,1,1,CTCACAAGCCGCTCGTCTAG,0,854691
dgoRp,0.5,1,1,CTCAATGAAACTGGACATAC,0,839956
dgoRp,0.5,1,1,CTATCTGGGACCGGCGCTAC,0,847820
dgoRp,0.5,1,1,CTATATTGCTAGGTCCTAGA,0,847149
dgoRp,0.5,1,1,CTAGTATTAGAGATGGATTT,0,859016
dgoRp,0.5,1,1,CTAGTAGTACATGAGGAGGC,0,843352
dgoRp,0.5,1,1,CTACTCAAGCCGAGATGCGC,0,864436
dgoRp,0.5,1,1,CTAATACAGTAAAGCTAGTA,0,849204
dgoRp,0.5,1,1,CTAAGTGATGAAGTAAAGTT,0,854302
dgoRp,0.5,1,1,CTAAGGTTACTTCGGCCGAG,0,836509
dgoRp,0.5,1,1,CTAACCCCCACCTTCGGGAA,0,847212
dgoRp,0.5,1,1,CGTTTGGTGATTGGGCTTAA,0,846564
dgoRp,0.5,1,1,CGTTTGACTTAGGGGACCAC,0,847166
dgoRp,0.5,1,1,CGTTTGAATAACGACACACA,0,847120
dgoRp,0.5,1,1,CGTTGCGGTGTCACGTGCCG,0,842103
dgoRp,0.5,1,1,CGTTGAACTGTAGCAAAAAC,0,848958
dgoRp,0.5,1,1,CGTTATGGGATAGCACCAAA,0,863485
dgoRp,0.5,1,1,CGTTACGCAGTGTATGCTAT,0,860077
dgoRp,0.5,1,1,CGTGTCTTACCTCTCGCCTG,0,853556
dgoRp,0.5,1,1,CGTGGTCAGTACAATGACAA,0,862121
dgoRp,0.5,1,1,CGTGGCGTACTGAGCATTCG,0,863189
dgoRp,0.5,1,1,CGTGCGGTAGGTGATCAACT,0,845304
dgoRp,0.5,1,1,CGTGCCTCCCTTTGCGCCAA,0,860883
dgoRp,0.5,1,1,CGTGCCGTTCTCCTTGGGTC,0,862280
dgoRp,0.5,1,1,CGTGCCAAGCTGTAAACAAT,0,845318
dgoRp,0.5,1,1,CGTGATTCGGTACCTCTTAA,0,843661
dgoRp,0.5,1,1,CGTGAGTCTGAGGGGCGGCA,0,844718
dgoRp,0.5,1,1,CGTGAGGGTTTATTTCCCTA,0,849047
dgoRp,0.5,1,1,CGTCTTAATCATACAGAGAT,0,840847
dgoRp,0.5,1,1,CGTCTGTGTATGATTATTGA,0,842132
dgoRp,0.5,1,1,CGTCGATTTACTTCCCTATA,0,852968
dgoRp,0.5,1,1,CGTCCAGTTCGTAGCAGATG,0,854613
dgoRp,0.5,1,1,CGTCAGACGATTCATCGGTT,0,862414
dgoRp,0.5,1,1,CGTATAGTCGCGGAGCTAGA,0,860234
dgoRp,0.5,1,1,CGTATAGCAAGCGTGCCTCA,0,836014
dgoRp,0.5,1,1,CGTATAAACCGTACACTCAC,0,857236
dgoRp,0.5,1,1,CGGTTTGCGCGCGACGCCGC,0,854931
dgoRp,0.5,1,1,CGGTTTCTGCCAGCATACTC,0,864443
dgoRp,0.5,1,1,CGGTGGACTCAGTCTCATGT,0,845293
dgoRp,0.5,1,1,CGGTCCCTAAGGAAATCGAT,0,855717
dgoRp,0.5,1,1,CGGGTCGGAATAAGCGCCCT,0,844722
dgoRp,0.5,1,1,CGGGGCAAAGTATAGGAAAA,0,866504
dgoRp,0.5,1,1,CGGCGCCTGTTGTTCTTTAA,0,852995
dgoRp,0.5,1,1,CGGCCCGTAAATTCAGGAGT,0,847963
dgoRp,0.5,1,1,CGGCACTTAATTGCACCAGA,0,841134
dgoRp,0.5,1,1,CGGATTATCTATGCTCGGGT,0,862531
dgoRp,0.5,1,1,CGGATCAATGAGTGGGCGCT,0,850990
dgoRp,0.5,1,1,CGGAATGCCTCCGCTGAGGT,0,843844
dgoRp,0.5,1,1,CGCTTGGTTTTGAGGGTTAA,0,850955
dgoRp,0.5,1,1,CGCTTAGGGTTTACCCTTTG,0,845959
dgoRp,0.5,1,1,CGCGTAAACCAAGTTAACCT,0,838566
dgoRp,0.5,1,1,CGCGATATTCGGTAACAACG,0,864891
dgoRp,0.5,1,1,CGCGACTAGAAGCCTAAGGG,0,852669
dgoRp,0.5,1,1,CGCGAAAGGGGCTCGCACGG,0,847447
dgoRp,0.5,1,1,CGCCTAGTTACTATTTGTGG,0,865862
dgoRp,0.5,1,1,CGCCCCTGCGTGCCCTAAAT,0,861112
dgoRp,0.5,1,1,CGCCCCGGCATTAGACAGCT,0,848970
dgoRp,0.5,1,1,CGCCCATAGAGAACTGATAT,0,850766
dgoRp,0.5,1,1,CGCCACATGAAGATAAGGTT,0,850401
dgoRp,0.5,1,1,CGCAGGCAAACTGTCTGCAA,0,853083
dgoRp,0.5,1,1,CGCAATGTATAGCTCACGAC,0,841845
dgoRp,0.5,1,1,CGCAAAATTCGCGGAAATTT,0,863320
dgoRp,0.5,1,1,CGCAAAAGACCTGGCTGGGC,0,856134
dgoRp,0.5,1,1,CGATTCCGTTGACCCGCTCC,0,840415
dgoRp,0.5,1,1,CGATTCCGTCGAACTAATTT,0,848637
dgoRp,0.5,1,1,CGATGACCGCAAAAGGTGCA,0,836457
dgoRp,0.5,1,1,CGATATCACGGAGGCCGAGC,0,842451
dgoRp,0.5,1,1,CGATAGGATCGGATGATCCT,0,857697
dgoRp,0.5,1,1,CGATAATTGACTGGTACCCA,0,851745
dgoRp,0.5,1,1,CGAGTTGCTAACTCAGATTC,0,864200
dgoRp,0.5,1,1,CGAGGGGGATCATTTCATGT,0,853230
dgoRp,0.5,1,1,CGAGGGCTGATTTGTGCCCA,0,839453
dgoRp,0.5,1,1,CGAGGGCAGTGTTCCCTGGA,0,866735
dgoRp,0.5,1,1,CGAGGCCTGAAGGTATCATT,0,857173
dgoRp,0.5,1,1,CGAGCACCATTACATCAACC,0,841279
dgoRp,0.5,1,1,CGAGATCCTCTAGCGCTTAA,0,850851
dgoRp,0.5,1,1,CGAGACTAAGTAAGGATACC,0,847217
dgoRp,0.5,1,1,CGAGACGCTCTTAACTGCTC,0,852564
dgoRp,0.5,1,1,CGACGTTAAACGACGCAATA,0,853334
dgoRp,0.5,1,1,CGACCCTTGTTCAGACGGGG,0,837546
dgoRp,0.5,1,1,CGACAGCGATGGTAGACTCT,0,847154
dgoRp,0.5,1,1,CGAATCGTGGCCTACTAAAA,0,864564
dgoRp,0.5,1,1,CGAATCGGTCATATGCAGGT,0,858090
dgoRp,0.5,1,1,CGAAGTGGGTAAACATTGGA,0,840480
dgoRp,0.5,1,1,CGAAGTCAAATTCCCGCAAA,0,860485
dgoRp,0.5,1,1,CGAAGACAAACTGCTGACTA,0,846641
dgoRp,0.5,1,1,CCTTTTTCAGCCGAGATTCT,0,843638
dgoRp,0.5,1,1,CCTTTTGCCAGAAGACTCGA,0,856378
dgoRp,0.5,1,1,CCTTTGGGCTGTATCCTATG,0,864431
dgoRp,0.5,1,1,CCTTTGATATCACGCTCTGG,0,839417
dgoRp,0.5,1,1,CCTTTAGTGTGAAACCGCGT,0,845955
dgoRp,0.5,1,1,CCTTGTTTAGTAACCTATGG,0,836233
dgoRp,0.5,1,1,CCTTCCCCCACCTTGAGACT,0,856154
dgoRp,0.5,1,1,CCTTAGTAAATCGGTGCGGG,0,863758
dgoRp,0.5,1,1,CCTTACGACGGTCTCCACCA,0,849548
dgoRp,0.5,1,1,CCTGGGGCCGAGACCGATCA,0,838881
dgoRp,0.5,1,1,CCTGGCTCCCACGCCGAATT,0,865727
dgoRp,0.5,1,1,CCTGATTCGATCAGTGTCTG,0,858830
dgoRp,0.5,1,1,CCTCTATGGCTTGTGTCGGT,0,849905
dgoRp,0.5,1,1,CCTCCTGTCAGAGCGGCTGT,0,839521
dgoRp,0.5,1,1,CCTCATTCGGCGCGCGAGCA,0,856127
dgoRp,0.5,1,1,CCTCAGCATTCATTGGTCTT,0,844310
dgoRp,0.5,1,1,CCTATCAGGGTGGGTCCGAA,0,858141
dgoRp,0.5,1,1,CCTAGGTTCCGGGGCCGGAC,0,864066
dgoRp,0.5,1,1,CCTAGACTAAAATCAAGGTT,0,848563
dgoRp,0.5,1,1,CCTAAATACAGCGAGCATAG,0,851527
dgoRp,0.5,1,1,CCGTAGGTCGCCCTCAAGAG,0,844302
dgoRp,0.5,1,1,CCGGTCTCCTGGCTCCTACA,0,839552
dgoRp,0.5,1,1,CCGGGGAGAAGATTGCGACT,0,849930
dgoRp,0.5,1,1,CCGGCACCCACCCAGTGCCG,0,859361
dgoRp,0.5,1,1,CCGGCAACAGCCGAAGGACG,0,866116
dgoRp,0.5,1,1,CCGGAACCACTGTCATCGGA,0,846552
dgoRp,0.5,1,1,CCGCTTTATATATTGCAAGC,0,863982
dgoRp,0.5,1,1,CCGCTGTAGGCCAGCGCTTT,0,845110
dgoRp,0.5,1,1,CCGCTGCGAGCCGCTTAGAG,0,854773
dgoRp,0.5,1,1,CCGCGTATCCATATGCACTT,0,866667
dgoRp,0.5,1,1,CCGCCTCGGGGCTTGTCTTT,0,861718
dgoRp,0.5,1,1,CCGCCCTCGCGCAGGGCTGT,0,856885
dgoRp,0.5,1,1,CCGCCAACCACACAAGTTCC,0,847155
dgoRp,0.5,1,1,CCGCAGGTTCGCGGAGTCAT,0,846081
dgoRp,0.5,1,1,CCGCAGGGTCGGGAGGACAC,0,841043
dgoRp,0.5,1,1,CCGAGGTCCTCTACGGTATA,0,857784
dgoRp,0.5,1,1,CCGACTGCCGGGCGGCAAGG,0,859494
dgoRp,0.5,1,1,CCCTTTGGTTAACGACACGA,0,854096
dgoRp,0.5,1,1,CCCTTGGGCATCCTCGGAGT,0,859262
dgoRp,0.5,1,1,CCCTTCACTCACGGGAACGC,0,851572
dgoRp,0.5,1,1,CCCTGTACGGGGCAAGATTC,0,843396
dgoRp,0.5,1,1,CCCTCGTTTCCGTCAGAGCA,0,842439
dgoRp,0.5,1,1,CCCTAATCTTGGGCGGCTTA,0,842886
dgoRp,0.5,1,1,CCCGGTATCGCGGATTTACG,0,855034
dgoRp,0.5,1,1,CCCGCGCGGTCACTATTACA,0,855043
dgoRp,0.5,1,1,CCCGCCACGCTGTAAAGGCC,0,843779
dgoRp,0.5,1,1,CCCCTCGTGTGAGAACGCGG,0,851244
dgoRp,0.5,1,1,CCCCTCGGAGTATCAATACG,0,861595
dgoRp,0.5,1,1,CCCCGACTATCTTCCGTAGT,0,840646
dgoRp,0.5,1,1,CCCCGACAATCGGATCATTA,0,848520
dgoRp,0.5,1,1,CCCCAGGAGTCGGTCCACCT,0,838528
dgoRp,0.5,1,1,CCCATTGAAGTCTTAGGCAA,0,865684
dgoRp,0.5,1,1,CCCATCATTGACTTTATTAA,0,851523
dgoRp,0.5,1,1,CCCATATCGTCGAAGCGTCA,0,845201
dgoRp,0.5,1,1,CCCAGGCGGACTTTTTAAAT,0,839624
dgoRp,0.5,1,1,CCCAGGCAATTCACGGGTTT,0,857813
dgoRp,0.5,1,1,CCCACTTGAGCCGTGGATCA,0,864866
dgoRp,0.5,1,1,CCATTGCATGGAAATGTTCA,0,835921
dgoRp,0.5,1,1,CCATGGTTGTCAGCCAAGGA,0,845442
dgoRp,0.5,1,1,CCATGGCAGGCAATACTTAT,0,858879
dgoRp,0.5,1,1,CCATCTTAGAAGCCAGAATC,0,852173
dgoRp,0.5,1,1,CCATCCACAAGTAAAAGCAT,0,851507
dgoRp,0.5,1,1,CCATCAGGTAGGGCTTGATC,0,846298
dgoRp,0.5,1,1,CCAGTCGATAGTCGCCGTTG,0,845032
dgoRp,0.5,1,1,CCAGGCTTTGACCAGAGTAG,0,837836
dgoRp,0.5,1,1,CCAGGAGGTCGTACACTAGA,0,860129
dgoRp,0.5,1,1,CCAGCCATGACCTTCCAGTA,0,862026
dgoRp,0.5,1,1,CCACTCAAGTGGTGCGGTCG,0,852475
dgoRp,0.5,1,1,CCACGTTTTGCTGGAAAGTC,0,853811
dgoRp,0.5,1,1,CCACGTGAAAAAGACTGGAC,0,836064
dgoRp,0.5,1,1,CCACAAGCCACGACTTCATA,0,854213
dgoRp,0.5,1,1,CCAAGATAGGGGTCTGAGAG,0,860172
dgoRp,0.5,1,1,CCAACAGGTTTTTGGAATCG,0,855465
dgoRp,0.5,1,1,CATTTCTATCGGCCTCCCGA,0,855549
dgoRp,0.5,1,1,CATTGTCGAATTGCTCACGT,0,854259
dgoRp,0.5,1,1,CATTGGCTGTACGGGTTAAT,0,862605
dgoRp,0.5,1,1,CATTGCTAAACCACAAACCA,0,861548
dgoRp,0.5,1,1,CATTGACGGGAGATTGAAAA,0,866121
dgoRp,0.5,1,1,CATTCAACGAGCGTAAGGCA,0,837267
dgoRp,0.5,1,1,CATGGCATGGTATCTCTCCT,0,862190
dgoRp,0.5,1,1,CATGGAAAGGACATCTAGGC,0,852516
dgoRp,0.5,1,1,CATGAATTCTTGAACGACGT,0,847641
dgoRp,0.5,1,1,CATGAAATTTGATCTCGCGT,0,837301
dgoRp,0.5,1,1,CATCTCAATCTCGCAGTAAG,0,843241
dgoRp,0.5,1,1,CATCGAGGATATGGATTTTT,0,859276
dgoRp,0.5,1,1,CATCCCTTCAACATCTTACA,0,859083
dgoRp,0.5,1,1,CATATGGCCTTTGGCACCAT,0,858547
dgoRp,0.5,1,1,CATAGGGAGGCAAGTGAATG,0,855713
dgoRp,0.5,1,1,CATACTAACGTCGCGAAAAC,0,850815
dgoRp,0.5,1,1,CATAACAATCAACTACAGAC,0,856502
dgoRp,0.5,1,1,CAGTCGTGGCACGGGGACCG,0,864980
dgoRp,0.5,1,1,CAGTCGAGCGAGTGACATCC,0,860377
dgoRp,0.5,1,1,CAGGTCTTATGATGGTCCAT,0,848733
dgoRp,0.5,1,1,CAGGTCAGCGCTAAGTTCGG,0,852957
dgoRp,0.5,1,1,CAGGGTTTTCACATGTGCCT,0,839730
dgoRp,0.5,1,1,CAGGGTTGTGTATGGGATAG,0,849193
dgoRp,0.5,1,1,CAGGGAGATCAAAACCAGTT,0,860240
dgoRp,0.5,1,1,CAGGCAAAGGCTCTAAGTTT,0,866216
dgoRp,0.5,1,1,CAGCGTCGCATCTGCAGCTG,0,839626
dgoRp,0.5,1,1,CAGCCGCCCGATTACACGCG,0,861139
dgoRp,0.5,1,1,CAGCCATGTACCTCCGAGCA,0,858455
dgoRp,0.5,1,1,CAGCACTCATGACGAGCAAT,0,859042
dgoRp,0.5,1,1,CAGAGTCGTCCGGCTGTAGT,0,837552
dgoRp,0.5,1,1,CAGAGTCCTATAAGTGTTAA,0,846606
dgoRp,0.5,1,1,CAGAGTATGGCGCGGTATGA,0,865750
dgoRp,0.5,1,1,CAGAGAGACGGTTCCCTCCA,0,861033
dgoRp,0.5,1,1,CAGACGTACCTCCACTTACG,0,848198
dgoRp,0.5,1,1,CAGAAAAAAGTGCCGCAAGG,0,853901
dgoRp,0.5,1,1,CACTTTGTGCGTCCGCAACG,0,859925
dgoRp,0.5,1,1,CACTTGGTTCTCACCACAAG,0,842750
dgoRp,0.5,1,1,CACTTGCGCCGTTAGACCGG,0,857771
dgoRp,0.5,1,1,CACTGTGACCGTTTCAATAC,0,864211
dgoRp,0.5,1,1,CACTGCGAGAGCTGCGGACT,0,842785
dgoRp,0.5,1,1,CACTCTCTCGAACTGAAAGT,0,859240
dgoRp,0.5,1,1,CACTACGAGGCGGCCGATCC,0,848975
dgoRp,0.5,1,1,CACGTGGTGCAAAGCTTGTT,0,841650
dgoRp,0.5,1,1,CACGCACCAGGGAGATCAAT,0,865942
dgoRp,0.5,1,1,CACCCCAGAGGCCATGGTCT,0,857370
dgoRp,0.5,1,1,CACCAGAATCAGCAAACTCG,0,852215
dgoRp,0.5,1,1,CACCACTTTCACCTCAACAT,0,866675
dgoRp,0.5,1,1,CACATAGAGGTCATACAGGA,0,855293
dgoRp,0.5,1,1,CACAGGTTAAACCTTAGGAA,0,838901
dgoRp,0.5,1,1,CACAGCTCCACCGACTCTAA,0,852891
dgoRp,0.5,1,1,CACAGAGGTTTTACAACAAG,0,859501
dgoRp,0.5,1,1,CAATTGTGAGAAGGTTGTTC,0,843777
dgoRp,0.5,1,1,CAATTGGCGGCGGAGGTGTA,0,859256
dgoRp,0.5,1,1,CAATTCAGCGCAACGGACAT,0,863650
dgoRp,0.5,1,1,CAATTAATCGCTTGTAATTA,0,865233
dgoRp,0.5,1,1,CAATCGGCTGAGTAGACCAT,0,838394
dgoRp,0.5,1,1,CAATAGTTTGCGGCGACCAC,0,841136
dgoRp,0.5,1,1,CAATAAGTCTCCTTAAGTAT,0,861650
dgoRp,0.5,1,1,CAATAACGCATACATTGAGT,0,859352
dgoRp,0.5,1,1,CAAGGTGAGGATGGTTCACT,0,862646
dgoRp,0.5,1,1,CAAGGGGGATGTGCTAGTCT,0,836721
dgoRp,0.5,1,1,CAAGGCAACGTTGATGAATC,0,865930
dgoRp,0.5,1,1,CAAGAATGCTAATTGGGACC,0,859378
dgoRp,0.5,1,1,CAACGTCGGGAACTGACGAT,0,841301
dgoRp,0.5,1,1,CAACGGTACGTCCTGAACGT,0,862661
dgoRp,0.5,1,1,CAACCTGCCAAGAACAAAAG,0,849876
dgoRp,0.5,1,1,CAACCCACTCTGTGTGCCCA,0,864719
dgoRp,0.5,1,1,CAACCAGGTGATGATCCTTC,0,841405
dgoRp,0.5,1,1,CAACATTCGTAGCTACAACA,0,849953
dgoRp,0.5,1,1,CAAATGAGCAGAGTCCTAAG,0,855161
dgoRp,0.5,1,1,CAAATATCCTCACTGTAACA,0,847564
dgoRp,0.5,1,1,CAAACGCCGAAAACGGGTTT,0,863433
dgoRp,0.5,1,1,CAAACCTCTATTCGCACATT,0,866184
dgoRp,0.5,1,1,ATTTTGGCTTGCTGCAGCTT,0,856374
dgoRp,0.5,1,1,ATTTGTACTCACCTCCTTTC,0,840712
dgoRp,0.5,1,1,ATTTGGACAATAGGAGCGGG,0,844008
dgoRp,0.5,1,1,ATTTGCGCACGCGACGTGAA,0,864351
dgoRp,0.5,1,1,ATTTCGTTGGTGAACTCATA,0,866979
dgoRp,0.5,1,1,ATTTCACGCTAGGGAAAACA,0,862017
dgoRp,0.5,1,1,ATTTAATGATCCCGACAGGC,0,855146
dgoRp,0.5,1,1,ATTGGGGCACATTGACTGGC,0,858286
dgoRp,0.5,1,1,ATTGGCCGAATGTCAAATGG,0,851932
dgoRp,0.5,1,1,ATTGCAACCCTGGGAACCTT,0,848656
dgoRp,0.5,1,1,ATTGACATCCTCAGTCATGG,0,835927
dgoRp,0.5,1,1,ATTCCGACTTCCTGGATACC,0,837899
dgoRp,0.5,1,1,ATTCATACGGTTCATTTTTC,0,851568
dgoRp,0.5,1,1,ATTATGGTAATGTTGCACCG,0,844353
dgoRp,0.5,1,1,ATTACAAGTCTCATCCATAC,0,860073
dgoRp,0.5,1,1,ATTAAGGTGCAACGTGGCTC,0,847594
dgoRp,0.5,1,1,ATGTTTTTCTCGATGCACAT,0,849108
dgoRp,0.5,1,1,ATGTCACCCGCTTTCTGACT,0,837788
dgoRp,0.5,1,1,ATGTAAACTATTGTCGGGAC,0,865409
dgoRp,0.5,1,1,ATGGGGAACCACTGGTTTCA,0,859876
dgoRp,0.5,1,1,ATGGGCAAGGTCCTATCGCC,0,849771
dgoRp,0.5,1,1,ATGGCGGGTCGAAAGTACAA,0,841293
dgoRp,0.5,1,1,ATGGAGTGGTATTCACGTAC,0,841169
dgoRp,0.5,1,1,ATGGACCGGGCCTGTACTAA,0,865887
dgoRp,0.5,1,1,ATGGAAACCTCCTTTAGGAC,0,842455
dgoRp,0.5,1,1,ATGCGTGATCCCTGCCGGCA,0,858688
dgoRp,0.5,1,1,ATGCCTAGTCTATCATATGC,0,850621
dgoRp,0.5,1,1,ATGCCCTTATTAGATGTGTG,0,844798
dgoRp,0.5,1,1,ATGCATATAGGGACCGACGC,0,862756
dgoRp,0.5,1,1,ATGCAGTGACTATCTGTCAT,0,861054
dgoRp,0.5,1,1,ATGCAAAACTTCATTGCGAT,0,864078
dgoRp,0.5,1,1,ATGATCAACGAATGCGGACG,0,860505
dgoRp,0.5,1,1,ATGAGGGCAAAGTTCCGGCA,0,846679
dgoRp,0.5,1,1,ATCTTTTAAATGTACTTTAT,0,837037
dgoRp,0.5,1,1,ATCTTTCAGGTGCCTAAGTT,0,848254
dgoRp,0.5,1,1,ATCTGGCACGGGAGTTGATC,0,839512
dgoRp,0.5,1,1,ATCGTAGTGGAGTTGAGATC,0,839272
dgoRp,0.5,1,1,ATCCTCCTCCATATAGAGTA,0,846243
dgoRp,0.5,1,1,ATCCGCCCAGCGATGACTAG,0,856124
dgoRp,0.5,1,1,ATCCATCACATTCAAATTAT,0,844450
dgoRp,0.5,1,1,ATCCAGGACGTTCACACGAT,0,851205
dgoRp,0.5,1,1,ATCCACAAGCCCTGCTCCCA,0,849088
dgoRp,0.5,1,1,ATCCAAATCCAGTCGAATAA,0,845802
dgoRp,0.5,1,1,ATCATAAGCAGGCGTCCTAA,0,846006
dgoRp,0.5,1,1,ATCAGCCATTCAGCAGGTAT,0,849003
dgoRp,0.5,1,1,ATCAGCAGGTAACCATATAC,0,850823
dgoRp,0.5,1,1,ATATTGCATCCATACCAACG,0,852431
dgoRp,0.5,1,1,ATATTAGGCTATGGCTTCTC,0,855477
dgoRp,0.5,1,1,ATATGTACAGCTACACGCGT,0,843920
dgoRp,0.5,1,1,ATATGAGCTGATCAGGGAGC,0,849340
dgoRp,0.5,1,1,ATATCTGGGAACTGTAGGTA,0,838066
dgoRp,0.5,1,1,ATATACCTGCTGATGATGTT,0,850832
dgoRp,0.5,1,1,ATATAAGATACCTATCATTT,0,867267
dgoRp,0.5,1,1,ATAGTTATCAGGGTTTTTAT,0,847152
dgoRp,0.5,1,1,ATAGTCGTTTGTGATAGCGC,0,836358
dgoRp,0.5,1,1,ATAGGTTGGGTGTAGCCCCA,0,838042
dgoRp,0.5,1,1,ATAGCTGCTAATGACGTTGT,0,847712
dgoRp,0.5,1,1,ATAGATAGGATGACAACGCT,0,849650
dgoRp,0.5,1,1,ATAGAGCGGTGTACACAGAC,0,844899
dgoRp,0.5,1,1,ATAGAAGCTCCTTTTATGCA,0,858761
dgoRp,0.5,1,1,ATACTGTTAACAAGCAAGCG,0,861882
dgoRp,0.5,1,1,ATACTGAGAAGATGAGACAT,0,854874
dgoRp,0.5,1,1,ATACTCTGCTACCTAGCTCA,0,840309
dgoRp,0.5,1,1,ATAAGATACTCGGCCCCACT,0,865463
dgoRp,0.5,1,1,AGTTTTACACCTCGGGGATT,0,850290
dgoRp,0.5,1,1,AGTTTCCTGAATATAAAGGT,0,844410
dgoRp,0.5,1,1,AGTTGTTTATGAAGCGTTGT,0,861377
dgoRp,0.5,1,1,AGTTATTCACCGTTAAGTCC,0,866078
dgoRp,0.5,1,1,AGTGTGCGATTGTCAGTTAG,0,849068
dgoRp,0.5,1,1,AGTGTATATATCCCGGTTTT,0,856274
dgoRp,0.5,1,1,AGTGGGCGGACCGTGTTTTC,0,854354
dgoRp,0.5,1,1,AGTGCGACTGGTCACTTCTG,0,855772
dgoRp,0.5,1,1,AGTGCCAGGCGCGCATCCCA,0,836967
dgoRp,0.5,1,1,AGTCTGTCAAGTTCGGGCTA,0,844265
dgoRp,0.5,1,1,AGTCCAAACGCTTAGGCCTT,0,836609
dgoRp,0.5,1,1,AGTCCAAAACAAGTCGGCGT,0,842558
dgoRp,0.5,1,1,AGTAGAGGCCCACGTGATGA,0,853423
dgoRp,0.5,1,1,AGGTGTGCAGTTGGGACATC,0,849346
dgoRp,0.5,1,1,AGGTCTGCGAAAGGTTTGGG,0,844370
dgoRp,0.5,1,1,AGGTCGAACGAAGCAACGAT,0,863451
dgoRp,0.5,1,1,AGGTAGGGCCTATACCGAGT,0,860100
dgoRp,0.5,1,1,AGGGTTCATTGTACACTGGA,0,842864
dgoRp,0.5,1,1,AGGGTTAGTTAGCGGTGATT,0,863202
dgoRp,0.5,1,1,AGGGTGAGACGGTGTGTGTG,0,862104
dgoRp,0.5,1,1,AGGGTCCGGCATTTTATGTC,0,858401
dgoRp,0.5,1,1,AGGGGGCCTTGAAAGATTGG,0,866614
dgoRp,0.5,1,1,AGGGGATCCTAACTTGCCAA,0,857994
dgoRp,0.5,1,1,AGGGGATCAAGTGTGGAATC,0,847928
dgoRp,0.5,1,1,AGGGGACAATCGCGTGGAGT,0,846190
dgoRp,0.5,1,1,AGGGCTTGTGATTTGCGAAA,0,835840
dgoRp,0.5,1,1,AGGGAACCACAGCACGCGTG,0,842087
dgoRp,0.5,1,1,AGGCTAGTAGGTAACAAAAC,0,852178
dgoRp,0.5,1,1,AGGCACACTGGACCTATCCT,0,863512
dgoRp,0.5,1,1,AGGATCGACTCAAAATCGGC,0,842322
dgoRp,0.5,1,1,AGGATCCATCCACGGTGTTG,0,866776
dgoRp,0.5,1,1,AGGAGCGGGCGGTGGACCGG,0,840511
dgoRp,0.5,1,1,AGGACGTACAGGGTCGAAAA,0,865491
dgoRp,0.5,1,1,AGGACAATCTTGAACTACCC,0,855258
dgoRp,0.5,1,1,AGGAAATGTAGGCGATGTTT,0,856322
dgoRp,0.5,1,1,AGCTTCCGCGCAGACGGCCA,0,852078
dgoRp,0.5,1,1,AGCTGATGAAGATAAAGGGG,0,855851
dgoRp,0.5,1,1,AGCTAGTACATACTCCAACT,0,849989
dgoRp,0.5,1,1,AGCTACACGCGGCTGAACAG,0,859242
dgoRp,0.5,1,1,AGCGTTGAATTTCGGGGACG,0,851927
dgoRp,0.5,1,1,AGCGGGGGCCGGTTTTAGTT,0,861395
dgoRp,0.5,1,1,AGCGAGTCGAACCATAGTTT,0,861106
dgoRp,0.5,1,1,AGCGACCGGCACTCAATCTT,0,844051
dgoRp,0.5,1,1,AGCCGTAGGAGGATATCGTC,0,864872
dgoRp,0.5,1,1,AGCCGTAAACGCTAAGGTTT,0,839314
dgoRp,0.5,1,1,AGCCGATAAATGAGAATACA,0,850819
dgoRp,0.5,1,1,AGCCCGAGGACTGGCCATAA,0,860615
dgoRp,0.5,1,1,AGCCCGACGAATTATGGGGG,0,866349
dgoRp,0.5,1,1,AGCCCATTGTTCTGTGAACA,0,859375
dgoRp,0.5,1,1,AGCCATATTTTAAAACGTTC,0,849715
dgoRp,0.5,1,1,AGCAGTGCGCTGCTACACTT,0,847742
dgoRp,0.5,1,1,AGCAGGGTTTATGATTGTCA,0,845570
dgoRp,0.5,1,1,AGCAGGGGGGTGAGGAAGAG,0,857544
dgoRp,0.5,1,1,AGCAGCTTCTTGGATTGACC,0,863011
dgoRp,0.5,1,1,AGCAGAGGTTCAAGGCAGCC,0,839029
dgoRp,0.5,1,1,AGCACGCGTTCTGGGCGGTT,0,836724
dgoRp,0.5,1,1,AGCACGATTGTAAGGGGGTA,0,862470
dgoRp,0.5,1,1,AGATTTGTTAGGCGGTAAAG,0,854505
dgoRp,0.5,1,1,AGATGGCCGATCTTGAATGC,0,836886
dgoRp,0.5,1,1,AGATCGCTTTCGAAATACCT,0,866493
dgoRp,0.5,1,1,AGATCAAGACAACGTCCGGC,0,848655
dgoRp,0.5,1,1,AGATACCCGTATTGCTCACC,0,839093
dgoRp,0.5,1,1,AGATAAGGGGTTCGATGCCA,0,856232
dgoRp,0.5,1,1,AGAGTATCCGCTTGCAAGGC,0,861516
dgoRp,0.5,1,1,AGAGGGGCAGGTCCAACGGT,0,852890
dgoRp,0.5,1,1,AGAGGGCACGTCCTGTTCTC,0,856002
dgoRp,0.5,1,1,AGAGGGAAGGAAGGGGATCA,0,838409
dgoRp,0.5,1,1,AGACTTTTCCACGCCTCTTC,0,866032
dgoRp,0.5,1,1,AGACCCGGTAGCATCTGCTT,0,860445
dgoRp,0.5,1,1,AGACCCAAGTCAGTTGGGTA,0,840057
dgoRp,0.5,1,1,AGACAGTGGTGAACGTTATT,0,844306
dgoRp,0.5,1,1,AGACAGGGTACTAGCCTTGA,0,859037
dgoRp,0.5,1,1,AGACACAATGTAGTACTTCA,0,851320
dgoRp,0.5,1,1,AGACAAAGTGGACAAACTCT,0,838383
dgoRp,0.5,1,1,AGAATTTCTATTATCACGTG,0,862777
dgoRp,0.5,1,1,AGAAGCGGGATACATTGATG,0,855729
dgoRp,0.5,1,1,AGAAGATCCCGAGGCACCCA,0,863826
dgoRp,0.5,1,1,AGAAGAGTGCACGCGGGCAT,0,862616
dgoRp,0.5,1,1,ACTTGGGGGATAAATGTCCG,0,840784
dgoRp,0.5,1,1,ACTGTTTAAAGTCCCCACAG,0,859842
dgoRp,0.5,1,1,ACTGAGAATGCATCCTACGT,0,854155
dgoRp,0.5,1,1,ACTCGTCAGTCATAGTGTTA,0,841352
dgoRp,0.5,1,1,ACTCGGCATTTCTGGCTGGT,0,839351
dgoRp,0.5,1,1,ACTCGACGTGAAGGCATCAG,0,840861
dgoRp,0.5,1,1,ACTCCCGATAGTCACATCTA,0,856205
dgoRp,0.5,1,1,ACTATAGTCAACGCGGGCTC,0,852849
dgoRp,0.5,1,1,ACTAGGTAGTTAGGCTTCCT,0,851463
dgoRp,0.5,1,1,ACTAAGCGCAGACTTGGCAC,0,836802
dgoRp,0.5,1,1,ACTAAGCGATACCATGTGTT,0,855421
dgoRp,0.5,1,1,ACGTTTTTACTTCAGGTTTA,0,855696
dgoRp,0.5,1,1,ACGTTGCGGAGCAACCTCTT,0,841519
dgoRp,0.5,1,1,ACGTTCTAACTAGAACATGC,0,836671
dgoRp,0.5,1,1,ACGTCTCGCGGAGCAACACT,0,859424
dgoRp,0.5,1,1,ACGTCAAACGTGCTCTTTTC,0,853082
dgoRp,0.5,1,1,ACGTATCGTTCGGAGGATTA,0,836602
dgoRp,0.5,1,1,ACGTATCAAACGTAACGGGG,0,840142
dgoRp,0.5,1,1,ACGGTTTGAGGTTCGTACAA,0,866971
dgoRp,0.5,1,1,ACGGTGTGCTTGGATGTATG,0,854070
dgoRp,0.5,1,1,ACGGTACCACGAAAAGTAGA,0,839017
dgoRp,0.5,1,1,ACGGGACGTAAAGGTGTCGT,0,866730
dgoRp,0.5,1,1,ACGGCCCTCCCCGACAGGGA,0,853624
dgoRp,0.5,1,1,ACGGCATTCTATTTAGCGCA,0,849632
dgoRp,0.5,1,1,ACGCTTGAGCCTCGATCATG,0,839932
dgoRp,0.5,1,1,ACGCGGGCACGGGGCTAGCC,0,867343
dgoRp,0.5,1,1,ACGCCTACTTGTCTGGTTGT,0,842682
dgoRp,0.5,1,1,ACGCCGGTGCCTGACGTGTA,0,865332
dgoRp,0.5,1,1,ACGAGAAGCTCAGTGATGTA,0,865417
dgoRp,0.5,1,1,ACCTTGAAGTAATTGGATTC,0,838909
dgoRp,0.5,1,1,ACCTCGCGCCACCGAGGATT,0,864848
dgoRp,0.5,1,1,ACCGAAACAGTTCGGCGTAT,0,840862
dgoRp,0.5,1,1,ACCCGGCTGTAAAGATCACT,0,859243
dgoRp,0.5,1,1,ACCCCTACCGAGGAGTATTA,0,860682
dgoRp,0.5,1,1,ACCATGGAACTGGGCCGGTT,0,842136
dgoRp,0.5,1,1,ACCAATATAGCGGGCTTGGA,0,843847
dgoRp,0.5,1,1,ACCAAGTGAATGCCTAGACC,0,849980
dgoRp,0.5,1,1,ACCAACGTCTTCATACCCGC,0,864549
dgoRp,0.5,1,1,ACATGTGGCGGTCCTTCCGC,0,841202
dgoRp,0.5,1,1,ACATGGCGCTAATCCCAACT,0,853752
dgoRp,0.5,1,1,ACATGATCTTTTGTTTTGTA,0,846498
dgoRp,0.5,1,1,ACATCAGTACTAGCTAGGAC,0,853161
dgoRp,0.5,1,1,ACATCAGGCTCTCGAGGCTG,0,853814
dgoRp,0.5,1,1,ACATCAGGAAGACAACTCAG,0,850245
dgoRp,0.5,1,1,ACAGTTCCAGGGAAAACCCC,0,835841
dgoRp,0.5,1,1,ACAGTGCTTGATGCGTTCTA,0,854424
dgoRp,0.5,1,1,ACAGCGTTGAGGAATGAACG,0,841459
dgoRp,0.5,1,1,ACACTTATAAGGGTTCGTTA,0,851759
dgoRp,0.5,1,1,ACACTGGTTTCGGCCGAATG,0,842748
dgoRp,0.5,1,1,ACACTCTTTTGGTCACTATT,0,840117
dgoRp,0.5,1,1,ACACGCTTTCAAGCGCAACT,0,848680
dgoRp,0.5,1,1,ACACGCGGGTAATATAGTCC,0,855428
dgoRp,0.5,1,1,ACACGAGGCCCGCAACTCCT,0,855633
dgoRp,0.5,1,1,ACACCGGGATCTCTTTCTCC,0,851974
dgoRp,0.5,1,1,ACACCCGGGAGGGGGGACCA,0,857676
dgoRp,0.5,1,1,ACAATTTAATACAGCTATTA,0,853210
dgoRp,0.5,1,1,ACAATTACCTCAGGCCTAAG,0,844288
dgoRp,0.5,1,1,ACAAGGGCACATACCAGCGT,0,866201
dgoRp,0.5,1,1,ACAAGCGTATCGCCTTCTGC,0,863259
dgoRp,0.5,1,1,ACAACTGTGCTAGCTGCCAA,0,856299
dgoRp,0.5,1,1,ACAAACGCATCCGCGTAGGA,0,866160
dgoRp,0.5,1,1,AATTTTCGGGCTGGCCTGCA,0,849280
dgoRp,0.5,1,1,AATTTGTGCCTCCGGGCTGA,0,842138
dgoRp,0.5,1,1,AATTAGCAAGGAGCTTTGGA,0,840752
dgoRp,0.5,1,1,AATTAGACATGGTAGCAGGG,0,858002
dgoRp,0.5,1,1,AATGTGCGAGGCGAAACCCT,0,850316
dgoRp,0.5,1,1,AATGCCCAGCAGGTCGGGAG,0,841525
dgoRp,0.5,1,1,AATGAATAACCTATGTCCCA,0,862933
dgoRp,0.5,1,1,AATCGCTCCGGGGGTAATTA,0,842502
dgoRp,0.5,1,1,AATCCATACGAATACGACCT,0,855110
dgoRp,0.5,1,1,AATAGTGTCGTACTAAGACG,0,849212
dgoRp,0.5,1,1,AATACGTCCACTTGATTAAT,0,855205
dgoRp,0.5,1,1,AAGTGCGGGTCATTCATGTA,0,837459
dgoRp,0.5,1,1,AAGTCGTCCGGCCGTGTAGC,0,849869
dgoRp,0.5,1,1,AAGTAAACTTTACCCGGAGG,0,843742
dgoRp,0.5,1,1,AAGGTTTCATGACGACGAGT,0,859032
dgoRp,0.5,1,1,AAGGTATGCGATCTGCGGAT,0,844322
dgoRp,0.5,1,1,AAGGCATAATGGTAGGTTTG,0,853352
dgoRp,0.5,1,1,AAGGACTCTGCTATTGTACA,0,854296
dgoRp,0.5,1,1,AAGCTCAGTAAATCAACGCC,0,846236
dgoRp,0.5,1,1,AAGCGGGGGGTTACTGACGT,0,850779
dgoRp,0.5,1,1,AAGCAGCAATTAAAATGGTG,0,850059
dgoRp,0.5,1,1,AAGATAGTTACCGAACTCCT,0,859477
dgoRp,0.5,1,1,AAGAGGATTCGGTAATCTAA,0,845731
dgoRp,0.5,1,1,AACTGAAGTGTGTGTATACT,0,858758
dgoRp,0.5,1,1,AACTACACGCTCCCCTCTTT,0,840000
dgoRp,0.5,1,1,AACGAACTTATACACCCATA,0,864871
dgoRp,0.5,1,1,AACCTTCCCTATACTACTTG,0,862308
dgoRp,0.5,1,1,AACCAGGATTCCTCAGCAGT,0,850695
dgoRp,0.5,1,1,AACATTGTGTTCGGAAGTAT,0,854509
dgoRp,0.5,1,1,AACATGAAATCGGGTTTCAC,0,849835
dgoRp,0.5,1,1,AACACCTCCGTAACGGGCGG,0,852495
dgoRp,0.5,1,1,AAATTTAAGGTATTTTGTTA,0,867240
dgoRp,0.5,1,1,AAATTCTGGTGTGAGAAGGC,0,854451
dgoRp,0.5,1,1,AAATTACGTAGTCGGCGAGT,0,841013
dgoRp,0.5,1,1,AAATGTTCTGGTTCACCTTC,0,861582
dgoRp,0.5,1,1,AAATGGACGTGCACACTAGG,0,860859
dgoRp,0.5,1,1,AAATCAACGAATATTTCTTA,0,844592
dgoRp,0.5,1,1,AAAGTTTCGCACTCGCTCTC,0,858016
dgoRp,0.5,1,1,AAAGTTCGTACAGCCGCTGT,0,856879
dgoRp,0.5,1,1,AAAGGGTAAATGACGGGAGA,0,852892
dgoRp,0.5,1,1,AAAGGGGTCAGGACGGCCAA,0,852791
dgoRp,0.5,1,1,AAAGCGCCGCTACGGCTGGT,0,863879
dgoRp,0.5,1,1,AAAGCCGACTTCCCCGTCTC,0,844131
dgoRp,0.5,1,1,AAACTCGATTCGTACGCAAC,0,857612
dgoRp,0.5,1,1,AAACCAGTATTCGGATGAGG,0,846526
dgoRp,0.5,1,1,AAAATTGTTGCTATGAGCTA,0,838722
dgoRp,0.5,1,1,AAAATGGGCCTGAACAGCTT,0,849799
dgoRp,0.5,1,1,AAAATGCTCTGAGAAGACGC,0,856172
dgoRp,0.5,1,1,AAAATATACTAAGGCACCGG,0,849927
dgoRp,121.0,120,0,GCCTAATGGCTTGGGTGTTT,120,843202
dgoRp,78.0,77,0,CGTCAGGCCTGGCCAGTCGT,77,858613
dgoRp,36.0,35,0,CGTAAGTTTGTGAGCGGTTA,35,843231
dgoRp,33.0,32,0,CTTAAAGCACATTAAGGTGA,32,861845
dgoRp,30.0,29,0,GGGACGAGTATCGTCTGTCG,29,841445
dgoRp,29.0,28,0,CACAGATGCTACTAATGCCT,28,836794
dgoRp,29.0,28,0,ACATCTCTGCTTCGATAAGT,28,861246
dgoRp,27.0,26,0,GACAAATGGGGTGTGGGTGT,26,842622
dgoRp,27.0,26,0,CGAGGATGTGGATGCCCATT,26,863858
dgoRp,27.0,26,0,AGGAGGTTCAGGTTTGTCCT,26,851448
dgoRp,27.0,26,0,ACCTTTGGTAACTAACCTTG,26,851833
dgoRp,25.0,24,0,GAAGGACCCAATCTAGTCCA,24,864531
dgoRp,25.0,24,0,AATTGTTTTTGTAACTGTCA,24,864511
dgoRp,24.0,23,0,TCTCTGCGCATTTATTACGA,23,836375
dgoRp,24.0,23,0,TCATTGGACATAATCAGATC,23,863749
dgoRp,24.0,23,0,TCATTAAGCCGCTTAACTAA,23,841964
dgoRp,24.0,23,0,CCCGTCGTAACGAGTGTAAT,23,847389
dgoRp,24.0,23,0,CAATTCGTTCAATCATAGCT,23,846222
dgoRp,24.0,23,0,ACTCTACCGAACATCAGAGG,23,862011
dgoRp,24.0,23,0,AAATTGCAATACGCTTGACT,23,854193
dgoRp,23.0,22,0,TTTCTCTCTAGCCGGCTTGA,22,856397
dgoRp,23.0,22,0,GCTTTCATCCCCTGGAAAGG,22,860365
dgoRp,22.0,21,0,TTCAGGACAACTGGGCACCC,21,843878
dgoRp,22.0,21,0,TACAGTAATAGGGCGAGGAA,21,853351
dgoRp,22.0,21,0,ACGAGGTAGGGATAATACTG,21,849434
dgoRp,21.0,20,0,GGGGGCAAAGGGTTGAAAGA,20,866919
dgoRp,21.0,20,0,CCGGGCCATCGAATTGCGGA,20,843674
dgoRp,21.0,20,0,ATTAACCAGAGCTGGTTGTC,20,850388
dgoRp,20.0,19,0,CGGGCGCTACACTAGCGCGA,19,852071
dgoRp,20.0,19,0,ACATGTAATCTCCCGGAGGC,19,846746
dgoRp,20.0,19,0,AAGACGGATTAGCTAACTAT,19,863197
dgoRp,19.0,18,0,TTTTGACATGTAAACGCAGA,18,861081
dgoRp,19.0,18,0,TCGATATTCTTTATGCTCTC,18,843984
dgoRp,19.0,18,0,TATATGATGCACGCGGCTTC,18,859681
dgoRp,19.0,18,0,GTGCGTAGTACCTTGGCAAG,18,839904
dgoRp,19.0,18,0,GACTCTCGGCTAACGCTTTA,18,843219
dgoRp,19.0,18,0,CGCCCAATGAAAGAGTTTGA,18,865899
dgoRp,19.0,18,0,CCCTACCGAAGGCCCTGGCT,18,854463
dgoRp,19.0,18,0,AATGCAACCTGGAATGGGTG,18,837486
dgoRp,18.0,17,0,TCGAGATAGGATGGAAGCGG,17,839517
dgoRp,18.0,17,0,TCACATCTAACGCTAACGGT,17,862333
dgoRp,18.0,17,0,GCATACAGTCTTTTACAGTC,17,865605
dgoRp,18.0,17,0,GCAGACACCTGGATGGCTGT,17,839484
dgoRp,18.0,17,0,GCAACCGAGGTCTGGGCAGG,17,861179
dgoRp,18.0,17,0,GATTGGGGCAATTTCGAAAA,17,844524
dgoRp,18.0,17,0,CAGATAAATATCCGCTGATG,17,843222
dgoRp,18.0,17,0,AGTACCTGGAGCCCTGACCC,17,843941
dgoRp,17.0,16,0,TTGCCTGTTACATGTAGGGT,16,859376
dgoRp,17.0,16,0,TCCCCTGCTCATTACCTTGC,16,853611
dgoRp,17.0,16,0,CGATCGGCTACTCAGGTCCA,16,849000
dgoRp,17.0,16,0,ATTGGATTTGCGCAGGCACC,16,835888
dgoRp,17.0,16,0,ATGCGGTTCGCCTCATCGAG,16,856741
dgoRp,16.0,15,0,TTCACTATTGGTTAGTGATG,15,839171
dgoRp,16.0,15,0,TAGATATGCGTAGGGATCCA,15,855325
dgoRp,16.0,15,0,GTGGGGAGGGGTCAGCATAA,15,860545
dgoRp,16.0,15,0,GGCGAGTAGTTTAAATGACT,15,865438
dgoRp,16.0,15,0,CTTATACTGGGTATGCGCGG,15,839951
dgoRp,16.0,15,0,ACCTGCGCCTCCTCCTAATT,15,842011
dgoRp,16.0,15,0,AATCTTGGTGTTATCATCTC,15,839576
dgoRp,15.0,14,0,TTGTCCTGGCGCTCTTATAA,14,857179
dgoRp,15.0,14,0,CTTCTTGACGTGGAAATGCC,14,850182
dgoRp,15.0,14,0,CTGTAGTTTTTCAGACTGGA,14,847711
dgoRp,15.0,14,0,CAGGCCGAGGGGTCATCATA,14,863625
dgoRp,15.0,14,0,CAATAACGGCCGGTCTGTTA,14,842727
dgoRp,15.0,14,0,ATTTAAAGTTCAAAAGGCAA,14,863527
dgoRp,15.0,14,0,ACTGTAAGATAACCGGTACT,14,864778
dgoRp,15.0,14,0,AAGCGCGTAGGGGGTAACGT,14,846128
dgoRp,14.0,13,0,TCACACAGACCAGATATAAC,13,861755
dgoRp,14.0,13,0,TAATGGGTACATGGATTTCG,13,844852
dgoRp,14.0,13,0,TAAGTCCGACCATTAGAGGA,13,854968
dgoRp,14.0,13,0,GGATGCGTACTGCGTTGCAA,13,854908
dgoRp,14.0,13,0,GGACGCGAGGCACGTTTTAA,13,845630
dgoRp,14.0,13,0,GCTCGGTGAAAGCGGGATAG,13,866076
dgoRp,14.0,13,0,GCCCTACTTCCAGTGCATGC,13,857748
dgoRp,14.0,13,0,CCAGTAAGGGACCCAAGCTA,13,837218
dgoRp,14.0,13,0,AGCGTAAGCCTCAAACCCTA,13,853183
dgoRp,13.0,12,0,GAATCGAGCCGAGGCCGGTA,12,840840
dgoRp,13.0,12,0,CGTAACTGCATTCACTATCT,12,847710
dgoRp,13.0,12,0,CCATTCCATGCACCCCAGGG,12,862865
dgoRp,12.0,11,0,TTTATTAATTTGAATAGGAT,11,853156
dgoRp,12.0,11,0,TTCCCCAACATCTTGGCCGG,11,843990
dgoRp,12.0,11,0,TCCATGCGTTGTCCGAGATG,11,841468
dgoRp,12.0,11,0,TAGTCAAGTTTATTTTAGCC,11,855813
dgoRp,12.0,11,0,CTGCCATAATCCACTGAGCA,11,866133
dgoRp,12.0,11,0,CAGAGTATCCGAGGTCAGAT,11,850643
dgoRp,11.0,10,0,TCTAGTCCGGTCGTGCTTTC,10,837343
dgoRp,11.0,10,0,TCCATTAGACTGCTCCCCGT,10,853605
dgoRp,11.0,10,0,GTCGGACACATTCTTTTGCA,10,842238
dgoRp,11.0,10,0,CGAGGGTCAACTGTGTAATT,10,865848
dgoRp,11.0,10,0,CAAGACGACCACGTGGTAAC,10,864185
dgoRp,11.0,10,0,AGGACACGGCTAGCACGACC,10,852317
dgoRp,10.0,9,0,TATTAGTCGTGCCGATCTTA,9,840060
dgoRp,10.0,9,0,TATTAGGGCTAGAGTCCGCA,9,838865
dgoRp,10.0,9,0,GCTTTTGTTGAGTTCATACA,9,849018
dgoRp,10.0,9,0,GATCTAGCCTCACTGCCGTA,9,843153
dgoRp,10.0,9,0,CGCGACGGATTTCTTTGAGG,9,837881
dgoRp,10.0,9,0,CACGTATCAGCGCTGTTAAG,9,854846
dgoRp,10.0,9,0,AATGCAGGGTCATGCATTAA,9,864894
dgoRp,10.0,9,0,AATGAGGTGTGTAGGCTGGA,9,841993
dgoRp,9.0,8,0,TTGTTGGCTGGTGTGGAGCT,8,836466
dgoRp,9.0,8,0,TTCCTGCCTTACGGATTTAG,8,848918
dgoRp,9.0,8,0,GGTCACTTTCGACCATCTCC,8,838518
dgoRp,9.0,8,0,GCTTCTATTGATCGGAACGT,8,837407
dgoRp,9.0,8,0,GCGCGGGTCCGTTAGTCCAA,8,839487
dgoRp,9.0,8,0,GAGTTATCTGATTTCCTATC,8,855474
dgoRp,9.0,8,0,CCCAGCTCTACCTAAGATGC,8,837199
dgoRp,8.0,7,0,TGTAGGCCTCGCACTGATCG,7,844695
dgoRp,8.0,7,0,TGAACTTCTTTACTCGAACT,7,850119
dgoRp,8.0,7,0,CGTAGCTCTATGCGACGTAC,7,846742
dgoRp,8.0,7,0,ATCTAGCGACTTTTCACATC,7,843634
dgoRp,8.0,7,0,ATATCGTTATCAAATAACAC,7,846229
dgoRp,7.0,6,0,TTTGTAATACGTTATACTGT,6,860523
dgoRp,7.0,6,0,TAATACTAATATTCGACAGC,6,841465
dgoRp,7.0,6,0,GGTAGCGTCAGGCTTATGGG,6,848860
dgoRp,7.0,6,0,GGAGTGTGTCTTGGTTCAAC,6,837484
dgoRp,7.0,6,0,ATGTAGACCCCTGACCTACA,6,862397
dgoRp,7.0,6,0,AGGAAGGAAGCCGATAACGA,6,847934
dgoRp,7.0,6,0,ACCAACTACAACGGCTAAAA,6,841206
dgoRp,6.0,5,0,TTTTGCGCTGTGATAGCGGG,5,859166
dgoRp,6.0,5,0,TTATTCTGTGGGGTGCGAAT,5,865604
dgoRp,6.0,5,0,TAACCCGCCTCAAGCGGTTG,5,850263
dgoRp,6.0,5,0,ATGTTCAACGAGAGCACCTC,5,848140
dgoRp,6.0,5,0,ATCCATCCTGCCGCCTCCTT,5,845541
dgoRp,5.0,4,0,TTGTGGACAGCGTTCCAATG,4,841954
dgoRp,5.0,4,0,TGCCTGGTTAACCTATGTCC,4,863167
dgoRp,5.0,4,0,TCGCTGTGCAGTACCTGGCA,4,839790
dgoRp,5.0,4,0,CCGATGAGCTGATAATATGA,4,856501
dgoRp,5.0,4,0,ACGTCAGGTCAATCGACGTC,4,840525
dgoRp,5.0,4,0,ACCTTTTGGATTCCTTTTCT,4,844180
dgoRp,5.0,4,0,ACCTTAATGGCCTCTCAGAC,4,836496
dgoRp,4.0,3,0,TTTTAGTTTATGAAACGATG,3,866094
dgoRp,4.0,3,0,TCAGTGGCATATTATTTTCA,3,858736
dgoRp,4.0,3,0,GTTTCTGATCCGCCCCTGTA,3,854954
dgoRp,4.0,3,0,CGTAGCGATTTACTGCGCTT,3,841307
dgoRp,4.0,3,0,CCGTGTTAGGCCAATACCTT,3,848133
dgoRp,4.0,3,0,CACGCGCCGCTCTCCGTTGT,3,867019
dgoRp,4.0,3,0,ATGGGCGAATTTTGTCAGGG,3,846080
dgoRp,4.0,3,0,ATGGAACTGCGCTCGGTGCT,3,849034
dgoRp,4.0,3,0,ATAATGGTTCCAAGCGCCAT,3,846853
dgoRp,3.0,2,0,TTTCGGCGGCACCGGCAAAC,2,845101
dgoRp,3.0,2,0,TGAGTCCTGGAGTGGAGGGA,2,846921
dgoRp,3.0,2,0,AATTCTGCTACCCATAAATT,2,836152
dgoRp,3.0,2,0,AATGTCCAACCAGTTTTTCA,2,848812
dgoRp,2.0,1,0,TTTACGAAAATGGCATCTAT,1,862261
dgoRp,2.0,1,0,TTCATTTCTCGAATCTCGTT,1,844029
dgoRp,2.0,1,0,GGTTCTTGCTTAGTTCCCCC,1,864510
dgoRp,2.0,1,0,GGTGATTGTGTGCAAGAGTA,1,844701
dgoRp,2.0,1,0,GGCAACGGGTGACCTGAGTA,1,865735
dgoRp,2.0,1,0,GCCCCGGGACCACAGTGCCG,1,846761
dgoRp,2.0,1,0,CTGCCCATAACACTTTGAGA,1,863305
dgoRp,2.0,1,0,CGGCTATTGATCCGTTAGTG,1,857741
dgoRp,2.0,1,0,CGCTTTTTAGCGAGCGATGG,1,865245
dgoRp,2.0,1,0,CGATGGAAAGCCACAGCTTT,1,854257
dgoRp,2.0,1,0,CCCCACACGCAGGAGTTTGG,1,864522
dgoRp,2.0,1,0,CAAACAAAGGTATGGCACGC,1,836202
dgoRp,2.0,1,0,ATTTTGCCGAATGGTCCCGT,1,840285
dgoRp,2.0,1,0,ATTGCCACAGCGAGAACAGG,1,843296
dgoRp,2.0,1,0,ATGTGCTGAAGGCAAAGCCG,1,841786
dgoRp,2.0,1,0,ATCGCGAATATACAGTACGG,1,851928
dgoRp,2.0,1,0,ACCTAAAGCGTGCCTCAAGT,1,841719
dgoRp,2.0,1,0,AATGTGTTCGCTCTTTTGAA,1,840786
