name,relative_counts,ct,ct_0,barcode,ct_1,barcode_ind
ompRp1,3.3098591549295775,610,141,ACCGTGATGAGAACATAAAA,469,2765806
ompRp1,5.813432835820896,911,133,GGGCTACGTGCTGCAAATTT,778,2793296
ompRp1,4.104838709677419,631,123,GTCTATGTTATGGGACGTGT,508,2791190
ompRp1,0.9032258064516129,175,92,CCCGCGTGAGGGATTCTCTC,83,2765788
ompRp1,3.6511627906976742,398,85,ATGTGGCCCGGCATTGCTAT,313,2766591
ompRp1,0.041666666666666664,73,71,CGAAACTATGCAAATGCCGG,2,2766132
ompRp1,5.361111111111111,456,71,ACAAAGCCCACCTCAAGGGT,385,2765598
ompRp1,1.957142857142857,205,69,CCAATGATCTATGGTGACTC,136,2821853
ompRp1,0.3088235294117647,87,67,ATCAGGAACTGTGATTTGAA,20,2783337
ompRp1,0.029850746268656716,67,66,GAGCTCCTTTAATGAAAAGA,1,2781082
ompRp1,1.0606060606060606,134,65,CTCTAGAGGGCATTGGGGTA,69,2765252
ompRp1,0.046153846153846156,66,64,AGTGGCGTGAGGACATTGAC,2,2778138
ompRp1,2.34375,212,63,AGTCAACCTTTCCAAACGTT,149,2799976
ompRp1,2.9523809523809526,247,62,AGGATCACTGTCCTAAGCTT,185,2766039
ompRp1,0.03333333333333333,60,59,GAGGGTAGAATGTCAGCGCA,1,2783270
ompRp1,1.7627118644067796,161,58,AGTACTCGATGCGTCCTACT,103,2809279
ompRp1,1.1578947368421053,121,56,TCACGAGGCGGGGAGGCAGT,65,2769383
ompRp1,0.03571428571428571,56,55,GGGGGGACCAACGCTTGTGA,1,2765860
ompRp1,0.18518518518518517,62,53,GTTGTGCTGCGGGGGAAGCA,9,2783074
ompRp1,0.7962962962962963,95,53,ATACGGCCAGCCCCGTAGGT,42,2766655
ompRp1,3.1481481481481484,222,53,AAAGGTTCCCCGGCTAATGA,169,2813087
ompRp1,3.0943396226415096,215,52,TTAGCAACAATACCTGCCAT,163,2822517
ompRp1,1.0943396226415094,109,52,AACGGCAGTGGAACTTGCAT,57,2789391
ompRp1,1.3076923076923077,118,51,CCGTTTATAGTGTCGCTGAT,67,2797526
ompRp1,0.057692307692307696,53,51,AGCCCAGGCCTTGAGACCGA,2,2783068
ompRp1,0.28846153846153844,65,51,ACAGGTGGTTAATCTCCGAC,14,2776843
ompRp1,1.6862745098039216,135,50,GTGCGTTAGGGCCGTACTGG,85,2790507
ompRp1,0.0392156862745098,51,50,CGCCTAGGAAACGTCCTAAC,1,2786983
ompRp1,2.0,148,49,GATCTCCTATATATCTACGT,99,2820333
ompRp1,0.06,51,49,AGCCACCGTTTGACTTGTTT,2,2788815
ompRp1,4.816326530612245,283,48,GGACGTGCCGCTCTGGAAGC,235,2772111
ompRp1,4.081632653061225,247,48,ACCTGGATTCGCTGTGTAAA,199,2786154
ompRp1,2.9791666666666665,189,47,TTCGGAAGGGTAAGGTCCAT,142,2798272
ompRp1,10.5,550,47,TGCCACGCATCTGGCAGCAG,503,2780534
ompRp1,0.06382978723404255,48,46,CTCCTCTTTCTAGCTTGACA,2,2804377
ompRp1,0.0425531914893617,47,46,AGTGACGACCAGGCCCTGCT,1,2791093
ompRp1,0.0425531914893617,47,46,AGGCGGGCCTCAATAGGTAA,1,2765309
ompRp1,0.3829787234042553,63,46,AGCTTCTGTGCACATGACCA,17,2784070
ompRp1,0.06382978723404255,48,46,AAGCCTTTTCCGAGTTAAAA,2,2781014
ompRp1,1.0638297872340425,95,46,AAATCCGCAGCAACTGTAAG,49,2789395
ompRp1,2.130434782608696,142,45,TTCGGGCTCGAACAGAATTT,97,2782883
ompRp1,0.13043478260869565,50,45,CTCGTAAGCACCACGTCTAT,5,2786096
ompRp1,0.6521739130434783,74,45,CCGGGACGGACGGCCTCCTC,29,2766312
ompRp1,0.06521739130434782,47,45,CATAAATCAACTTTCACTTC,2,2767052
ompRp1,0.043478260869565216,46,45,AGGAAGAATACTCGCGTAAA,1,2790724
ompRp1,0.08695652173913043,48,45,ACGTCAATCCCCACCGTTCT,3,2771491
ompRp1,6.133333333333334,319,44,TCCCGCTCTGTGGGAAGCAG,275,2784624
ompRp1,0.2222222222222222,53,44,GCGAGGAAAGCATCGGTGGA,9,2811065
ompRp1,1.8888888888888888,128,44,CAAATGAGAGGGTTAGTAGC,84,2767756
ompRp1,2.272727272727273,142,43,TAAGGTGGCTCGGCATGTCT,99,2767993
ompRp1,0.8863636363636364,81,43,CTTTTGTGGTAGCCCCAGGA,38,2803818
ompRp1,0.20454545454545456,51,43,CGCGTCTCATGCATAGCGTA,8,2772429
ompRp1,12.113636363636363,575,43,AGCATGAGGCAAACTGCACA,532,2775862
ompRp1,3.4186046511627906,188,42,TCTCGCCGAAAAGGATTGTA,146,2776996
ompRp1,3.5348837209302326,193,42,TCATCACCGGTTACAATTTG,151,2790331
ompRp1,2.7906976744186047,161,42,TCAGAGAAGCACCCAGTGGA,119,2767578
ompRp1,8.790697674418604,419,42,GCCATGCCAGTCAGTCTCGA,377,2814159
ompRp1,0.046511627906976744,43,42,GCAATACAGGGGGGCACTTA,1,2794356
ompRp1,0.7441860465116279,73,42,ACAGGTTAATTTATACAGGT,31,2796963
ompRp1,0.07142857142857142,43,41,GTGATACAGCGGAGGAGTAG,2,2803438
ompRp1,1.5,103,41,CGCTTCAGACGCATCACGGA,62,2801312
ompRp1,3.2857142857142856,178,41,AGTCATAGAGTCTTGAGGGT,137,2817591
ompRp1,4.439024390243903,221,40,GTGGTTTCTAATAATAGGAT,181,2766774
ompRp1,0.1951219512195122,47,40,CCAAGCGTCCTTAATGAATA,7,2813416
ompRp1,0.07317073170731707,42,40,ATCGTCGTTATTGGCTTTGA,2,2791700
ompRp1,2.707317073170732,150,40,AGGTTGTAGGAAGAATGGTT,110,2783683
ompRp1,3.8536585365853657,197,40,AATAGTTGCTAGTGTCGATG,157,2775694
ompRp1,6.8,310,39,TAAGTACTCTATGGCAACGA,271,2773214
ompRp1,0.1,42,39,CGTCCATTCATCGGGACGCT,3,2768511
ompRp1,0.05,40,39,CGGTAAACCGATAGCGGGTA,1,2783225
ompRp1,0.05,40,39,CGGCCCAACGGACTCGGGCA,1,2813306
ompRp1,1.075,81,39,CGAAGAGGATTGGTGATTTA,42,2789011
ompRp1,0.05,40,39,CCAACTGACTGCGGTTGTGT,1,2793729
ompRp1,0.6,62,39,CACTAACTTGGCGGCACCAA,23,2813604
ompRp1,0.07692307692307693,40,38,TTGACGCACCGCGGAGCTAA,2,2800094
ompRp1,5.487179487179487,251,38,TACCATCCTTGCGCGGACCT,213,2774804
ompRp1,3.6666666666666665,180,38,GGTTTGATGTGCCTCGTCAT,142,2767021
ompRp1,0.5641025641025641,59,38,GGCAAGCGAGGACGTAGCGA,21,2766738
ompRp1,0.10256410256410256,41,38,CCGCGCGGGTTGGGCGAGGT,3,2818000
ompRp1,1.3846153846153846,91,38,CACGGAGGTACTGCGAGGAT,53,2778681
ompRp1,0.4473684210526316,53,37,TTTGGTAGATCATTGGCCAC,16,2789470
ompRp1,0.05263157894736842,38,37,TGAGGTGGTCTCAGGCTAAA,1,2781076
ompRp1,7.2368421052631575,311,37,CGGCGACTTCAGCCGGGTAT,274,2771230
ompRp1,3.4864864864864864,164,36,TTGTGTTAAGAGGCGTTCGT,128,2795751
ompRp1,0.7837837837837838,64,36,GTCGTCGTTTTCCACGTTCA,28,2766278
ompRp1,0.5405405405405406,55,36,GAGTCAACGTTAGCTCAGCA,19,2775196
ompRp1,0.05405405405405406,37,36,CGTGGTAGGCCCATATGTCA,1,2786644
ompRp1,2.054054054054054,111,36,CGGATTGCGACAGCGGCCAA,75,2791699
ompRp1,0.8378378378378378,66,36,CCTAATTTAAACTTTCGTCT,30,2780985
ompRp1,0.5675675675675675,56,36,ATGTGACACGTGGCCGCCTC,20,2818954
ompRp1,2.7567567567567566,137,36,AGTCTTAGTCCCTAGACCGT,101,2790929
ompRp1,6.864864864864865,289,36,AGGGATTATAGCTGGCACTC,253,2780607
ompRp1,0.05405405405405406,37,36,AAAGATGAATTGATACACAT,1,2773398
ompRp1,0.05555555555555555,36,35,TTAGTAGAGCATTGATGCCC,1,2786572
ompRp1,2.0833333333333335,109,35,TGCACCTAGAGTGGACAGTA,74,2776813
ompRp1,0.1388888888888889,39,35,GGTAAGTATGGACGGCGCGT,4,2766971
ompRp1,1.3888888888888888,84,35,GGCGAGCATGGCCCTTCGGA,49,2807210
ompRp1,2.3055555555555554,117,35,GCAGCCGTCAGGTACCACTC,82,2774030
ompRp1,1.8333333333333333,100,35,GCAAGAGGGAGAAATTTCAA,65,2810623
ompRp1,2.4722222222222223,123,35,GCAAGACATAAGCATTTAAT,88,2767596
ompRp1,3.0277777777777777,143,35,ATCGGGTCCGCTTATGGAAC,108,2809734
ompRp1,1.8055555555555556,99,35,ACTGGCGACCTGATACTCCC,64,2765385
ompRp1,2.7714285714285714,130,34,TGTACATTGAGGTCCCTAGC,96,2767024
ompRp1,0.08571428571428572,36,34,TCCAGCAAGGGGCTCGCGGT,2,2815883
ompRp1,0.05714285714285714,35,34,TCAGCCTAGCTCTTGGGCAT,1,2806303
ompRp1,5.4,222,34,GTCTGGCTTCGCCGGCTGTC,188,2766749
ompRp1,3.6285714285714286,160,34,GTCTAGGACTAATTGTTGTA,126,2775039
ompRp1,0.05714285714285714,35,34,GGTTAAATCTCTTACAAGCA,1,2776443
ompRp1,2.5714285714285716,123,34,GGCGTTTTCCGTGAGCTGGA,89,2767779
ompRp1,1.0857142857142856,71,34,GACCGCCGCTAGGGAGACCT,37,2789248
ompRp1,4.857142857142857,203,34,GAACCCTGACCGGTTTCGTG,169,2772531
ompRp1,2.7714285714285714,130,34,CGCGCGCGATCCGCCAGATA,96,2776522
ompRp1,0.08571428571428572,36,34,CAGGGGCGTAGCTGAAATTG,2,2779567
ompRp1,2.857142857142857,133,34,CACTGTACTCTCATCGACAC,99,2795658
ompRp1,1.3714285714285714,81,34,CACGTATGTACTTTGACTTG,47,2812532
ompRp1,0.08571428571428572,36,34,AGCGATAGTAACCTCGGATG,2,2771159
ompRp1,4.114285714285714,177,34,AGATTACCCGCTAGTTTCCA,143,2767550
ompRp1,5.235294117647059,210,33,TTTTCAGTGTCCCGGGAGCT,177,2780477
ompRp1,5.176470588235294,208,33,TGGCGAATGACGTTGGTACT,175,2784672
ompRp1,0.058823529411764705,34,33,TATTCTATTATGGGAACTCA,1,2765762
ompRp1,4.970588235294118,201,33,TACGTGCCAACCGGAGCAAT,168,2778812
ompRp1,0.058823529411764705,34,33,GGACCGCGACGCACTCGGAT,1,2794190
ompRp1,0.058823529411764705,34,33,CTGTTCAAGTAAGACGCGGT,1,2797063
ompRp1,3.2058823529411766,141,33,CTGAGGAAGCGATCTGTAGA,108,2793348
ompRp1,2.0,100,33,CCGTTTTGCTTGTCGTAAGT,67,2774316
ompRp1,0.11764705882352941,36,33,CAGGGTCTATCCTGATGTGT,3,2813667
ompRp1,1.6764705882352942,89,33,CACGTCTGCGGGTATAAAGA,56,2786499
ompRp1,1.1764705882352942,72,33,AGAGTCGCCCCAGTGGAACA,39,2824152
ompRp1,0.058823529411764705,34,33,AAGGCTGACATATTGTTGCC,1,2797825
ompRp1,0.06060606060606061,33,32,TTAAACAAATAGGATTCAAG,1,2798862
ompRp1,1.4545454545454546,79,32,TATAAATAATCGAGCTATAT,47,2787390
ompRp1,0.12121212121212122,35,32,GTGAGATATACACGGCCGCG,3,2796436
ompRp1,0.06060606060606061,33,32,GTCCAGGTTGTGATCATCGT,1,2772057
ompRp1,0.06060606060606061,33,32,GAGGCCCCTCCAGAGCCCCT,1,2777766
ompRp1,0.24242424242424243,39,32,GAACTGCAACAGCGTTGAAC,7,2799254
ompRp1,0.06060606060606061,33,32,CTGTCCAGGGGCTGATAGAT,1,2794178
ompRp1,3.6363636363636362,151,32,CGTTGAGCACATCATGGACA,119,2778679
ompRp1,2.0606060606060606,99,32,ATTGGAGACCTATACTTCGG,67,2769618
ompRp1,0.12121212121212122,35,32,ATGGCCTTAATGTATACGTC,3,2766402
ompRp1,1.7575757575757576,89,32,ACAGAACAGACAATGCCCGC,57,2817592
ompRp1,0.0625,32,31,TGGGGGGCGAGTTGGGAGGC,1,2785533
ompRp1,0.59375,49,31,TGGGGACGGCATGACACGAA,18,2768761
ompRp1,1.21875,69,31,TCCATTCTCTTCGAGGTGTA,38,2822250
ompRp1,0.0625,32,31,TCACAGTGGAATATAAAGAC,1,2799760
ompRp1,3.65625,147,31,GGAACCAGCATCTTAATCAC,116,2810572
ompRp1,0.0625,32,31,GCTGGTATTAACTGGCTGTA,1,2815920
ompRp1,2.53125,111,31,GCGTCCGGTGGAAGCTGGTA,80,2794855
ompRp1,4.46875,173,31,CTATGATTGACCTAGTGCTC,142,2768549
ompRp1,0.375,42,31,CGGGTACCGACGCTGGTCAC,11,2777065
ompRp1,0.84375,57,31,CGCGGCGGCACAGTTATAAA,26,2824214
ompRp1,1.3125,72,31,CGACGGAAGAGGCAAACATG,41,2767752
ompRp1,0.40625,43,31,CCCCCCTTATTGAAAGACGG,12,2811476
ompRp1,0.0625,32,31,ATCATGGGGAAGCGCTACAT,1,2818586
ompRp1,3.6451612903225805,142,30,TTCTAAGGGACAGGGGCGGG,112,2807635
ompRp1,0.06451612903225806,31,30,TTCGCGATTGATTAACTGAT,1,2784610
ompRp1,0.25806451612903225,37,30,TTCAACTTGTAGTCATGATT,7,2777015
ompRp1,4.483870967741935,168,30,TAGGGCCTTCTCTTGAGTTT,138,2775288
ompRp1,0.06451612903225806,31,30,CTCAGCCTAGTGTTCCGGCG,1,2810161
ompRp1,0.06451612903225806,31,30,CTATGCTGAGTAAGGGACAG,1,2817560
ompRp1,2.5483870967741935,108,30,CCGCATGTTGGTGCGGCTTT,78,2767425
ompRp1,0.0967741935483871,32,30,CCATGGTATGCTGGCGGCGT,2,2771624
ompRp1,0.8709677419354839,56,30,CATTGAAGAGGTGTGGTCCT,26,2815982
ompRp1,0.0967741935483871,32,30,AATGCAGCCGGTAGGGCATT,2,2815903
ompRp1,0.06666666666666667,30,29,TGCTGACCGGCAGCTGAGCA,1,2770367
ompRp1,0.06666666666666667,30,29,TATCCACACATTAAGACGAT,1,2784853
ompRp1,0.06666666666666667,30,29,GTCCACCGCTAAGCCCAAAA,1,2815651
ompRp1,2.0,88,29,GTACCTTGAGACGGAGGTTA,59,2773770
ompRp1,4.566666666666666,165,29,GGTTGAGCCGTTCCCACGCT,136,2817400
ompRp1,9.466666666666667,312,29,GGTGATCCTACTCCCGTGCT,283,2775511
ompRp1,0.1,31,29,GGGAGACCGTAGTCGCCCGT,2,2811595
ompRp1,1.0333333333333334,59,29,GCGTTGTATTGTGTCAGACA,30,2798827
ompRp1,0.06666666666666667,30,29,CGTTGAATTTGCCGATCTTT,1,2805403
ompRp1,2.2,94,29,CGGTAGAACGGAAAATTTAG,65,2801477
ompRp1,4.066666666666666,150,29,CGAGTCGTGATCAACTTTGG,121,2804082
ompRp1,1.7,79,29,CCGTTAGTGCGTACTCAGCT,50,2817699
ompRp1,14.866666666666667,474,29,AGGGGCTGCTTGAGAGCCTT,445,2822918
ompRp1,0.5333333333333333,44,29,AGCACATAGTGGCTTGACAG,15,2793976
ompRp1,0.06666666666666667,30,29,AGACCACGTGACCGTGTGAA,1,2777973
ompRp1,1.0,58,29,ACTTGAAGATCTAGCTTATG,29,2780393
ompRp1,1.4333333333333333,71,29,ACGTGAGATCCCGTGCACGT,42,2802068
ompRp1,3.3333333333333335,128,29,AACTAACATCCCATCCGACT,99,2818345
ompRp1,0.10344827586206896,30,28,TTATGGTAGGAAATAATTCT,2,2797922
ompRp1,4.0,143,28,TGTGAGTGCATGAAGCCTAC,115,2814587
ompRp1,0.10344827586206896,30,28,TGGTGACACGATGTGATTGC,2,2798034
ompRp1,0.3448275862068966,37,28,TATAGGGGATAGTATCGAAA,9,2768822
ompRp1,2.7241379310344827,106,28,TAGCCTTCAGCTCCCAAATA,78,2790274
ompRp1,0.06896551724137931,29,28,GAACTTTCACACCAAAGCGG,1,2806075
ompRp1,0.06896551724137931,29,28,CTTCTTCATTTTATGGGGTT,1,2776494
ompRp1,0.06896551724137931,29,28,CTGCAGCACGTTTAACTGAT,1,2801805
ompRp1,25.655172413793103,771,28,CGCGAAGCGATCCGGTTATA,743,2781288
ompRp1,2.0,85,28,CCAGTCTAGGGTCACAACTA,57,2766809
ompRp1,4.206896551724138,149,28,ATCGAACCTTTCATCGGCGT,121,2816679
ompRp1,4.103448275862069,146,28,AAGTGTCCCCAAATCGTAAT,118,2796903
ompRp1,0.5862068965517241,44,28,AAAAGGTTGGTTCCATTAAT,16,2770340
ompRp1,6.142857142857143,198,27,TGGTTTAGCGCCCGGCTTCA,171,2812153
ompRp1,4.107142857142857,141,27,TCGCGGTCCCTCAGGCCGGG,114,2823421
ompRp1,0.07142857142857142,28,27,GTGAAGGTTAATCAGGGGGG,1,2793257
ompRp1,2.642857142857143,100,27,GCGAGTAGCAGCGCTGAAGG,73,2779725
ompRp1,7.785714285714286,244,27,GCCTACACAAACGTTCATCT,217,2775172
ompRp1,0.7142857142857143,46,27,GACGGAACGCAGCCATCTTC,19,2768960
ompRp1,0.2857142857142857,34,27,CTCAGACCCATGAGGTTGAG,7,2767679
ompRp1,0.8928571428571429,51,27,CTAAAGGATGCAATGAGTCA,24,2783924
ompRp1,1.2142857142857142,60,27,CGGTGACATTCGTACACAAA,33,2787544
ompRp1,2.0,82,27,CGATCTAGAGACATACTGCA,55,2765634
ompRp1,1.1785714285714286,59,27,CGACTATAGGGTGAGATTAC,32,2775697
ompRp1,4.75,159,27,CCGAAATGGTTATTTTTGAC,132,2808980
ompRp1,3.1785714285714284,115,27,ATATCACTGAAGATGGTTTT,88,2766986
ompRp1,0.42857142857142855,38,27,ATAATGGCGATAGGTCTGGT,11,2806967
ompRp1,5.642857142857143,184,27,AGGGACCAATGTTGCGGCTA,157,2781904
ompRp1,0.10714285714285714,29,27,AGCACAGTCGTAACGGTACA,2,2782298
ompRp1,3.0357142857142856,111,27,AACAACGCAGTGTGAATTAG,84,2771626
ompRp1,0.07407407407407407,27,26,TGCTACTCCGTCCCGTGTTA,1,2820840
ompRp1,0.18518518518518517,30,26,TCATAATATTTGGCACTGAA,4,2765680
ompRp1,2.1481481481481484,83,26,GTCGAGCCTGTCTACTGAAT,57,2802851
ompRp1,0.1111111111111111,28,26,GTACGGTGCTTGAAGTCATT,2,2811641
ompRp1,0.07407407407407407,27,26,GGATCCTGGCGGTGCCGTGA,1,2805477
ompRp1,1.2962962962962963,60,26,GATCAATGTTGGCAAGACCA,34,2771504
ompRp1,0.07407407407407407,27,26,GAACAGTTGCGAAGCAATGA,1,2772174
ompRp1,0.9629629629629629,51,26,CTTGTCACCTATCACTTGAA,25,2765340
ompRp1,3.1481481481481484,110,26,CTGGATATGCGGGCGGCTGT,84,2767912
ompRp1,1.7407407407407407,72,26,CTCCGTAGGGCTGCACTGCT,46,2798450
ompRp1,0.07407407407407407,27,26,CGTTGGCACCACACCAATCC,1,2802620
ompRp1,1.037037037037037,53,26,CCGGGGGGGGAGCACCATGA,27,2772645
ompRp1,14.185185185185185,408,26,CCAGTACTACCAAAGCGTAT,382,2783424
ompRp1,5.851851851851852,183,26,ATCGACCACCTTCGGAGAGG,157,2784098
ompRp1,0.07407407407407407,27,26,AGTCTGTTTTTGGCTTCAAT,1,2784851
ompRp1,0.9629629629629629,51,26,ACATCTCGGGGGGGGCGATG,25,2765426
ompRp1,3.5925925925925926,122,26,ACAGTTTCGGGTCGGCGTTT,96,2780239
ompRp1,8.76923076923077,252,25,TACAGCGCTCTCAGTTCGGT,227,2797475
ompRp1,1.8076923076923077,71,25,TACAATAGAGTTCCGAGCGT,46,2814147
ompRp1,0.07692307692307693,26,25,GTCGAAATTGGATCTTCGGG,1,2804210
ompRp1,4.846153846153846,150,25,GCCGGGTAAGAACCTCGGAA,125,2768751
ompRp1,5.038461538461538,155,25,GCCCGCATAGCAGACAAAGG,130,2806868
ompRp1,2.8076923076923075,97,25,CTGTTTGTGTTTCTTGGCTG,72,2812192
ompRp1,2.230769230769231,82,25,CTGGAACACTTGTGGCGAAA,57,2775202
ompRp1,5.615384615384615,170,25,CTGCCACATGCGTCACCTGT,145,2781260
ompRp1,0.07692307692307693,26,25,CTAGATTTGAATCCCTGCAG,1,2786981
ompRp1,0.07692307692307693,26,25,CGGTGCGAACGCCGCTGGGT,1,2765761
ompRp1,6.538461538461538,194,25,CGCTGGATATTAAGGCAAGA,169,2805986
ompRp1,1.6923076923076923,68,25,ATACCGTAACCGGTCGCAAG,43,2784373
ompRp1,0.07692307692307693,26,25,ACCATTGAGGTGGTTTTTTT,1,2815820
ompRp1,0.11538461538461539,27,25,ACAGCTTCAGTTATGCTCTT,2,2780389
ompRp1,0.15384615384615385,28,25,AAACGCGCCCCTGCCACATC,3,2810669
ompRp1,1.16,52,24,TTCTTGCAACTCATACTCGA,28,2766084
ompRp1,11.8,318,24,TCTGTAAATTCATAAAAAAC,294,2768362
ompRp1,0.08,25,24,TCTCGACTGTAAGGTACTGA,1,2778624
ompRp1,8.48,235,24,TCTACCACTGATGGTACCTA,211,2786532
ompRp1,0.12,26,24,TCGGTATACTCACGGCGGTA,2,2779931
ompRp1,5.4,158,24,TAACTTGTTTTAACGCGGTG,134,2816930
ompRp1,0.6,38,24,GTAAGGAGGGCTGGCCGGTG,14,2803771
ompRp1,0.08,25,24,GCTTTAGCCCCAGGATTCCA,1,2814506
ompRp1,2.56,87,24,GCAATCTTTGTCGAAACTTG,63,2817951
ompRp1,4.4,133,24,GCAAGCGGGTCTATCGGGTT,109,2793564
ompRp1,9.08,250,24,GAGTCAACGCTAGCAGCATT,226,2817835
ompRp1,3.04,99,24,GAGGAGGGCCTCAGAGGACA,75,2781616
ompRp1,0.12,26,24,GAATCGACAATGCAGGGTGT,2,2781890
ompRp1,3.24,104,24,CGGGTACTCGTAGAGCTGAT,80,2824293
ompRp1,0.08,25,24,CGGAGCTGGAAAACCCGATT,1,2786536
ompRp1,2.28,80,24,CGACGCCTAAGACCGGGCGA,56,2779301
ompRp1,8.56,237,24,CCAAGCAATTACATTGCTGC,213,2787395
ompRp1,0.08,25,24,CAACTTAATAAGTAATACTT,1,2789378
ompRp1,0.08,25,24,ATTAGGAGACCCCGTTACTT,1,2784805
ompRp1,0.08,25,24,AGGCGGTTGCGTGGGCTGTT,1,2778623
ompRp1,0.08,25,24,AGGCGCATGGTACATCCGGC,1,2793879
ompRp1,0.88,45,24,AGCTTTTCTTGGGACGACAT,21,2765444
ompRp1,0.2,28,24,AGAAATGGTATAGACACCCG,4,2805289
ompRp1,0.96,47,24,ACGACCATTTACCAGCGTCA,23,2789681
ompRp1,0.08,25,24,ACCCGATGTAACATCGGTCT,1,2766984
ompRp1,3.2,103,24,AAAAACATCCTGCAAGGAAA,79,2807138
ompRp1,1.9166666666666667,68,23,TTCTATCCGTAACGTTCTAG,45,2795951
ompRp1,0.08333333333333333,24,23,TGGGGAGTATATACTAATTC,1,2792776
ompRp1,3.5416666666666665,107,23,TGCGTTAAACGGCTGAGACT,84,2781862
ompRp1,0.6666666666666666,38,23,TGATTGGTCAGCGGAGAAAA,15,2781015
ompRp1,5.791666666666667,161,23,TCTGAGTGAGTTTCGATGTG,138,2771975
ompRp1,0.7083333333333334,39,23,TCGGCTTTTCTAAGCAGATT,16,2782885
ompRp1,0.16666666666666666,26,23,TCGGCCAGAAGCCGGCTGCA,3,2770098
ompRp1,0.08333333333333333,24,23,TCATGCCTTGGGACGCGCCA,1,2808926
ompRp1,0.125,25,23,TATGATAAGCCCACGTGACT,2,2821231
ompRp1,0.08333333333333333,24,23,TAAGTTCAAAGTCTTAGCCC,1,2808025
ompRp1,0.125,25,23,TAAGGATTCCTTTCTGGGCT,2,2804542
ompRp1,0.08333333333333333,24,23,GTTTCCAGGCAGGAACGGGT,1,2822329
ompRp1,0.08333333333333333,24,23,GTAATGGATGCGTGCGGCCA,1,2784800
ompRp1,2.875,91,23,GGTGCTCCGGGCGGCCATTA,68,2782823
ompRp1,0.125,25,23,GGTCACTTATGGCAGCTACC,2,2767169
ompRp1,0.08333333333333333,24,23,GGCTGGACCCTCGACTTGAG,1,2771490
ompRp1,0.08333333333333333,24,23,GCTAGCTTAGACCCACAGAT,1,2783228
ompRp1,12.125,313,23,GAATCAAGTGGCTTTCCCAT,290,2787644
ompRp1,3.8333333333333335,114,23,GAAGCAATATGCGCTGGGTA,91,2796873
ompRp1,8.041666666666666,215,23,CTCTAGTATAGGTGCAGTAG,192,2788323
ompRp1,5.458333333333333,153,23,CTACGGGGCAAGGGGGGGTC,130,2809727
ompRp1,0.08333333333333333,24,23,CTAATACCACAGCAGAGACC,1,2778476
ompRp1,1.75,64,23,CGGAGGTGGAGACTTATTAA,41,2770444
ompRp1,0.08333333333333333,24,23,CCCGAAGAACGGGGATCTAA,1,2783338
ompRp1,1.2083333333333333,51,23,CCAGATTTCAGAGTGGACAA,28,2767863
ompRp1,0.75,40,23,CAGCCGTGACGTAGCTGGGA,17,2802058
ompRp1,0.08333333333333333,24,23,ATGGATGACTTTCGTTTCGC,1,2793494
ompRp1,16.625,421,23,ATCCATAAGCATCGGCTCGT,398,2798443
ompRp1,5.333333333333333,150,23,ATAACGGGTACTTATATAAG,127,2812271
ompRp1,4.666666666666667,134,23,AGTTTCCGATTCTCTTGAGT,111,2786072
ompRp1,0.08333333333333333,24,23,ACATTGTAACCCCGCCAGCG,1,2794672
ompRp1,0.5,34,23,ACATACAGGGAGTCAGCTAA,11,2789920
ompRp1,6.083333333333333,168,23,AAGTACGGTACGAATCAGGA,145,2804653
ompRp1,6.565217391304348,172,22,TTGTTTTACCTATGCATTTG,150,2813301
ompRp1,0.13043478260869565,24,22,TGTCGCAACCTAAAGTCGCT,2,2794402
ompRp1,2.4782608695652173,78,22,TGGAGCGTCGGAAGGCATTT,56,2783103
ompRp1,0.08695652173913043,23,22,TAGCGTCAGGCGGTGCTGGG,1,2779856
ompRp1,1.3478260869565217,52,22,TAAAACCTTGTGCTGCGCCA,30,2795054
ompRp1,0.08695652173913043,23,22,GTTCGTACCTTAGTTTTACA,1,2812145
ompRp1,0.5217391304347826,33,22,GTTCAACGAGTAATTCGGGA,11,2801924
ompRp1,6.217391304347826,164,22,GTACGTCAGTCGCGTCGATA,142,2802316
ompRp1,1.3043478260869565,51,22,GGTTGGACATAACGGCGCCT,29,2775819
ompRp1,0.7391304347826086,38,22,GGTATCCCGGTAGCACAAGT,16,2773691
ompRp1,10.826086956521738,270,22,GGGTATTGGGTGAAGAACAT,248,2796029
ompRp1,0.13043478260869565,24,22,GGATGAATGCTGCATGGCTT,2,2799588
ompRp1,10.782608695652174,269,22,GACGTTGTTGCTGTGACATG,247,2769997
ompRp1,0.08695652173913043,23,22,CTTGTACCGTGGGTTTCGTG,1,2820896
ompRp1,0.08695652173913043,23,22,CTTACGTCCGATTCACGTCA,1,2804423
ompRp1,1.2608695652173914,50,22,CTGTTTGGCCATCTAATTCT,28,2815732
ompRp1,2.5217391304347827,79,22,CTGTTCGGCAGACGCTAGAT,57,2789908
ompRp1,0.6521739130434783,36,22,CTGACGATCATTCTGGGCAT,14,2775523
ompRp1,4.130434782608695,116,22,CGTTGACACTTGGCTTCATA,94,2774447
ompRp1,0.08695652173913043,23,22,CGATAGACACGGAGCTCATT,1,2822754
ompRp1,5.217391304347826,141,22,CGAGGGCACTATCTTTCACT,119,2787439
ompRp1,0.6521739130434783,36,22,CCTTGCGAACGGAGGGGCTT,14,2802865
ompRp1,5.434782608695652,146,22,CCCCCCAGTTCATTATTTGA,124,2767899
ompRp1,4.565217391304348,126,22,CAGAAGTAGGCATGCATCAA,104,2818697
ompRp1,0.2608695652173913,27,22,CACCAGATTCGATACGACCC,5,2797214
ompRp1,5.695652173913044,152,22,ATATCGTCAGACAAGCAGCA,130,2779753
ompRp1,5.521739130434782,148,22,AGGTAGATGCGCTGATTCGC,126,2791051
ompRp1,5.782608695652174,154,22,AGGAGGCTCCCCTTTTCCGA,132,2769948
ompRp1,0.08695652173913043,23,22,AGAGCGAATCAAGGTCGAAT,1,2777064
ompRp1,0.08695652173913043,23,22,ACCGTGCATTCCACGAGGGG,1,2777945
ompRp1,0.2608695652173913,27,22,AAGTACCGAGGGCTGCCAGC,5,2797672
ompRp1,0.08695652173913043,23,22,AAGGAGATACGCCGGCGACG,1,2782604
ompRp1,5.181818181818182,134,21,TTTTAACTTAAACGTCCGGT,113,2781213
ompRp1,5.181818181818182,134,21,TTGGTCAGGCGGTGCCAGGA,113,2822851
ompRp1,0.2727272727272727,26,21,TTCCCATAGAGTACCGGGGT,5,2812566
ompRp1,0.09090909090909091,22,21,TCTTTGTGCAGTCCTATTAT,1,2785164
ompRp1,0.09090909090909091,22,21,TCATCTGTCAGTTAGGCAAA,1,2779787
ompRp1,0.13636363636363635,23,21,TAATAGGTAGAATACTTGAG,2,2770904
ompRp1,0.09090909090909091,22,21,TAACGATCCGCCAACTGCTA,1,2790732
ompRp1,0.9545454545454546,41,21,GTGGCGGATAACTTACGCTT,20,2768182
ompRp1,0.09090909090909091,22,21,GGGTATCGCAGCCTATCTTC,1,2812390
ompRp1,0.09090909090909091,22,21,GGATCCCCCGGCTCAGCGTA,1,2804292
ompRp1,4.2272727272727275,113,21,GCTTGGGCAAACACCTGCAG,92,2820903
ompRp1,4.090909090909091,110,21,GCGTCACAGGCCCATGCGCT,89,2791804
ompRp1,0.5,31,21,GAGGACGGTCCCCGCGGCTC,10,2776602
ompRp1,4.045454545454546,109,21,GAAGGGGCGAGCCCTGCACA,88,2823450
ompRp1,0.9090909090909091,40,21,GAAAGTGGGGCTTGTCTTAA,19,2790869
ompRp1,0.13636363636363635,23,21,CTTTTTTTAAAATACTGAAT,2,2804336
ompRp1,0.09090909090909091,22,21,CTGAAACATTACAGTATCCT,1,2767199
ompRp1,0.09090909090909091,22,21,CTAGTCGGCAAAATCGCGTA,1,2808158
ompRp1,4.2727272727272725,114,21,CCCATAATGTCTCGACAGCA,93,2812924
ompRp1,1.5454545454545454,54,21,CCAGCCTGTCGGAACGTGGC,33,2811051
ompRp1,1.7727272727272727,59,21,CCAAAAACAACGACAATTAG,38,2785716
ompRp1,0.09090909090909091,22,21,CATACTGCGTGAGTGCTTTG,1,2785129
ompRp1,0.09090909090909091,22,21,CATAAGTGGCCTGATACCTA,1,2777971
ompRp1,4.681818181818182,123,21,CACAGAGGCCAAGTTTACAA,102,2790822
ompRp1,0.09090909090909091,22,21,ATGTGGATAGACTTGAATTA,1,2782649
ompRp1,0.09090909090909091,22,21,ATGACGGCCCATTGTACCGT,1,2800465
ompRp1,0.13636363636363635,23,21,ATCACATACGCGATATCCCA,2,2767207
ompRp1,0.09090909090909091,22,21,ATACGTAGAGCCGCACTGAA,1,2783033
ompRp1,4.681818181818182,123,21,AGTAGTCTGCCTAACATCAG,102,2793892
ompRp1,2.3181818181818183,71,21,AGGCGTAAAGTAAGTTTACT,50,2790305
ompRp1,2.9545454545454546,85,21,AGCTTTCGTGCAAGCATTAG,64,2808991
ompRp1,1.2272727272727273,47,21,AGCCCGAAGTCGTCTCGAGT,26,2773350
ompRp1,22.227272727272727,509,21,AGAGTCTTCTCTATACCGAA,488,2771371
ompRp1,8.090909090909092,198,21,AATCGTGGCTGGCTGGCACT,177,2783587
ompRp1,7.2272727272727275,179,21,AATCGTCATACCACCGTCTT,158,2810808
ompRp1,0.09090909090909091,22,21,AAGCGCTGCGCATACCACCC,1,2774092
ompRp1,7.0,174,21,AAACCCAGAGCACATTATGA,153,2770771
ompRp1,0.09523809523809523,21,20,TGGTGAATCCGCCATCTTTG,1,2812570
ompRp1,0.09523809523809523,21,20,TGGGTACGGCTTAGGTGGTA,1,2780478
ompRp1,8.142857142857142,190,20,TGGGCAATGTTGGACCGCAG,170,2810178
ompRp1,0.09523809523809523,21,20,TGATGGCGGGCACCGTGTGT,1,2805514
ompRp1,0.23809523809523808,24,20,TCGGTTTTTTGAGAAGGGCA,4,2779225
ompRp1,5.190476190476191,128,20,TCGAGTTGCCTTGAGTTGCC,108,2799673
ompRp1,3.0952380952380953,84,20,TCCGGTGGTTACTCGTGCTA,64,2821002
ompRp1,0.19047619047619047,23,20,TCCCTCGCAGTGTTTCATAC,3,2816517
ompRp1,3.857142857142857,100,20,TCAGAGGAACTGAAAGCGTA,80,2807720
ompRp1,0.09523809523809523,21,20,TCAATGGTTCGTCACGGCTA,1,2768022
ompRp1,0.09523809523809523,21,20,TATGGCCGCGAAGAAGATTG,1,2811765
ompRp1,0.09523809523809523,21,20,TAATCTGATCTTACACCCTT,1,2809495
ompRp1,0.2857142857142857,25,20,GTCCGAGCCTTGGCGCGTGA,5,2766183
ompRp1,2.1904761904761907,65,20,GGTCTAACAGCGTGTGGCCC,45,2781239
ompRp1,0.38095238095238093,27,20,GGTACGCAAGTACCAACACT,7,2808595
ompRp1,11.571428571428571,262,20,GGGAGTACATAGCCGGTTCA,242,2801582
ompRp1,0.23809523809523808,24,20,GCTACGTCAACTGCAGCTGT,4,2765809
ompRp1,2.238095238095238,66,20,GCGCAGACAATGCGCCGTTG,46,2771411
ompRp1,5.523809523809524,135,20,GCCGGACCCACTCAAAAGTT,115,2793896
ompRp1,0.09523809523809523,21,20,GCCATGTGGAGTATTGACCA,1,2799861
ompRp1,2.857142857142857,79,20,GCAAAATCAACGCAATGGGA,59,2821271
ompRp1,3.619047619047619,95,20,GATTGATCAGTCTCCTTACT,75,2783350
ompRp1,7.428571428571429,175,20,CTGGTTAGGGTGCCAGCGTG,155,2787883
ompRp1,0.09523809523809523,21,20,CTGGGAATGGTAAATGAGCA,1,2791733
ompRp1,9.333333333333334,215,20,CTGATCGAGTCTCTGAGCTT,195,2812782
ompRp1,2.6666666666666665,75,20,CTGAGCTTGAGTGGGTGGAC,55,2767059
ompRp1,0.09523809523809523,21,20,CTCTGTAACGAAGTTTCGTA,1,2768669
ompRp1,12.571428571428571,283,20,CTACGCAGCTACGATAACCT,263,2771414
ompRp1,1.9523809523809523,60,20,CGTCAAAAGCATTCAGTAGA,40,2795688
ompRp1,5.333333333333333,131,20,CGGGCATCCCGGCCAACTAT,111,2804449
ompRp1,0.9047619047619048,38,20,CGGGCACCGCTGGGCAATTA,18,2817868
ompRp1,0.09523809523809523,21,20,CCTAGTTCTGGCCCCTTGGG,1,2772665
ompRp1,5.857142857142857,142,20,CCGTTTCCCCCGCGGATAAA,122,2811739
ompRp1,23.047619047619047,503,20,CCGGCTGCTTGCTTCGGGCT,483,2818100
ompRp1,4.0476190476190474,104,20,CATATACGGTCTTTTTGCGT,84,2770095
ompRp1,4.476190476190476,113,20,CAGCGAACCACTATAAGCGT,93,2800566
ompRp1,2.619047619047619,74,20,CACTTTATGCACTATCCCTG,54,2784928
ompRp1,8.571428571428571,199,20,CACCTAGAGTGAACCGGTTA,179,2777074
ompRp1,0.14285714285714285,22,20,CACAATGGTAGGGGGCGTGT,2,2786097
ompRp1,0.09523809523809523,21,20,CAATAGATTACCTCGTTATA,1,2780439
ompRp1,6.428571428571429,154,20,ATTCGGGGCGTTCTTGAGAT,134,2776914
ompRp1,1.5714285714285714,52,20,ATTAGCATTTTAAGGCGTGA,32,2784821
ompRp1,8.714285714285714,202,20,ATCGCTCCTGTGCATAAGCT,182,2780557
ompRp1,1.0476190476190477,41,20,AGCGCTTGGCCGCTTTCAAT,21,2813599
ompRp1,0.09523809523809523,21,20,AGATAGTCCTTGTTTACCAT,1,2797044
ompRp1,4.095238095238095,105,20,ACTTGCCCGTCCGTCATGTG,85,2766155
ompRp1,0.7142857142857143,34,20,ACGTGCTGCCTTCCGTATGC,14,2810240
ompRp1,0.09523809523809523,21,20,ACGGGTATAAGGCAGGCACA,1,2797277
ompRp1,6.476190476190476,155,20,AAAGGTTCCGATAACACGTA,135,2779045
ompRp1,0.09523809523809523,21,20,AAAATCAGAAGGCTACATCT,1,2774842
ompRp1,0.09523809523809523,21,20,AAAAAAGAAACGCCCTTGTC,1,2822661
ompRp1,0.1,20,19,TTGCCGTTGCACTATCAGGC,1,2765681
ompRp1,0.1,20,19,TGCGGCGCCATGAGTCCCAC,1,2785458
ompRp1,0.35,25,19,TGAACTTTTGACGTATGCAG,6,2798999
ompRp1,0.1,20,19,TCTTGACGGTCCATTGGCTA,1,2793954
ompRp1,0.1,20,19,TCTGATGATAACTAATCTGA,1,2765344
ompRp1,0.1,20,19,TCGTTTTGGTCTCCAAAAAA,1,2771798
ompRp1,0.2,22,19,TCCCGTTGGAGGGTCCGAAG,3,2767411
ompRp1,0.1,20,19,TCAGGCCAGTGAACACACGT,1,2787790
ompRp1,0.1,20,19,TACTTTGTTGACGTTAGCAA,1,2787121
ompRp1,0.8,34,19,TAAGCCTGGGAACTTACATG,15,2809774
ompRp1,4.65,111,19,GTTTTGCCTAACGCCCTTCT,92,2774843
ompRp1,0.15,21,19,GTCCTTCCTTCGGGATATTC,2,2782734
ompRp1,8.05,179,19,GTATAACTCATCCCGGACAC,160,2821281
ompRp1,9.2,202,19,GGTACGTATCTCCCGAAATA,183,2790857
ompRp1,1.3,44,19,GGGTTGGTCGTTCGGTGCGC,25,2797106
ompRp1,0.1,20,19,GGCTGCGCAGACTCGTCACG,1,2810845
ompRp1,5.9,136,19,GGCGAAAACCAGGGGCTCAA,117,2781491
ompRp1,0.1,20,19,GGCCACCCATAGTTGAGTGG,1,2813332
ompRp1,0.45,27,19,GGAATCGGCGTTCGCAATGT,8,2767061
ompRp1,1.9,56,19,GGAAATCTTCGAGACTTATA,37,2802560
ompRp1,4.75,113,19,GCCTTGTGAAGTGCATCCGT,94,2804858
ompRp1,0.1,20,19,GCCGATTGTCTTACTTTAAG,1,2772530
ompRp1,1.05,39,19,GCCCACGTCGTGGATCTTGT,20,2778811
ompRp1,0.3,24,19,GAGGACATGTTGATTGTCTA,5,2772806
ompRp1,2.4,66,19,GACGTCCCACTAGCCGTGAT,47,2811441
ompRp1,0.15,21,19,GAAAGCAGGGCGGATTGCAT,2,2785284
ompRp1,0.15,21,19,CTCTCATAAAACATAACCTG,2,2766916
ompRp1,8.55,189,19,CTATAGCATCGGCGACAGAT,170,2781559
ompRp1,0.3,24,19,CTACGTTCCTAGAATTAAGT,5,2790316
ompRp1,0.6,30,19,CGGGCGTTATATAATGTGGA,11,2809162
ompRp1,0.1,20,19,CGGACATCAGCAGCTAAGAT,1,2780912
ompRp1,3.65,91,19,CGACACAAAACTTAAATTTC,72,2802314
ompRp1,1.6,50,19,CCTCGCAGGCCTCGGTAAAT,31,2803663
ompRp1,8.6,190,19,CCTCCACACTGGTGCTGTTA,171,2795674
ompRp1,0.65,31,19,CCTAACTGAGGTTGGCCCAC,12,2790755
ompRp1,1.85,55,19,CCCGCTTGGTTCATGATATT,36,2792255
ompRp1,0.1,20,19,CCATCCGCGCGCAGATCACT,1,2777760
ompRp1,0.1,20,19,CATCGAGATCCTATTAGAGT,1,2814027
ompRp1,1.85,55,19,CACAAGCGCCGGTCGTTACT,36,2801453
ompRp1,15.4,326,19,CAAGGGGTCAACAGACGGCG,307,2781289
ompRp1,0.1,20,19,CAAGGGACAACGCGGATATT,1,2781439
ompRp1,0.5,28,19,CAAGATAACGCTGTGATCAG,9,2806885
ompRp1,4.25,103,19,CAACCTCCTGATCACTGGGA,84,2769516
ompRp1,0.1,20,19,ATTAGCAAACTTGCTAAGCT,1,2816034
ompRp1,0.7,32,19,ATGCCTTCATATTGGTTTCT,13,2812751
ompRp1,0.1,20,19,ATCCTGGATTAAACTATCTT,1,2793432
ompRp1,0.1,20,19,ATCACTGCGGCTAATCGCCG,1,2801994
ompRp1,4.0,98,19,ATATAGGCCCTCGGTATACT,79,2805988
ompRp1,0.1,20,19,AGGGGAGAAGGGCCGGAAAA,1,2770990
ompRp1,0.1,20,19,AGGGCGAAGCATGCAAGCGG,1,2808283
ompRp1,0.15,21,19,AGCGTGATCCTGGGAAACTA,2,2771618
ompRp1,4.4,106,19,AGCAAGTCATTAGGTAGCAA,87,2780276
ompRp1,0.1,20,19,AGAGGTCGTATCCGGGCTCA,1,2777068
ompRp1,0.1,20,19,ACAGGAGGGTTCCATGCCTC,1,2817495
ompRp1,0.75,33,19,AATGCATGTTCAGAGTAAGA,14,2768709
ompRp1,0.1,20,19,AAGAGGACACGCCGTCTAAA,1,2765641
ompRp1,0.10526315789473684,19,18,TTTACTATACCTTAAGAGCT,1,2768358
ompRp1,4.052631578947368,94,18,TTGTTTCTATCTCAAGTTGA,76,2778680
ompRp1,0.10526315789473684,19,18,TTGGCCCACGACCGAACTGA,1,2794320
ompRp1,11.421052631578947,234,18,TTCATTTACACAGGTAGCAA,216,2801439
ompRp1,2.6315789473684212,67,18,TGGTAAAGATCATCCTAAAC,49,2798310
ompRp1,0.10526315789473684,19,18,TGGCCTATTATCTAAATAAG,1,2821044
ompRp1,2.3157894736842106,61,18,TGGCAGTGTAGAAGAAAGCA,43,2802043
ompRp1,4.684210526315789,106,18,TGCAAGACTTTCCCACATGG,88,2784024
ompRp1,2.526315789473684,65,18,TGATCCCTTTGACACAGCCA,47,2810212
ompRp1,0.10526315789473684,19,18,TCTCTGGTGTGCCCGGTGAA,1,2772328
ompRp1,0.47368421052631576,26,18,TCCTGATCCGTTTGAGAATA,8,2823753
ompRp1,0.10526315789473684,19,18,TCCATTACGTGGGGGGACAC,1,2801546
ompRp1,0.10526315789473684,19,18,TCACGTCTGCCAGGAACGAT,1,2769955
ompRp1,0.15789473684210525,20,18,TAGGGGCTTGATCCTGGATA,2,2770995
ompRp1,0.10526315789473684,19,18,GTGAGGACCCCAGGCCAGAG,1,2782449
ompRp1,3.3684210526315788,81,18,GTCAGCCTAGGGCGGTAGGC,63,2789627
ompRp1,0.10526315789473684,19,18,GTAGAACTGATCTTCGGACC,1,2819357
ompRp1,4.842105263157895,109,18,GTACTTCGCTTATTCTTAAG,91,2818592
ompRp1,7.578947368421052,161,18,GGTATCCTCACCAGGTTGCC,143,2780162
ompRp1,1.4210526315789473,44,18,GGCGTTTTTTGGAAACGGCA,26,2811594
ompRp1,0.10526315789473684,19,18,GGCCTGTGCAAGGGCAGAGA,1,2779024
ompRp1,1.6842105263157894,49,18,GGAAGGCCATTAAGGCTTTC,31,2768087
ompRp1,2.1052631578947367,57,18,GCTTGTAGGCATTGCGCCAT,39,2785861
ompRp1,2.6315789473684212,67,18,GCTGTACTAAAAGATTGTGT,49,2817683
ompRp1,4.631578947368421,105,18,GCTATTACGGGAAAGCAGAC,87,2768175
ompRp1,1.0,36,18,GCGTACCGGGACGTGCTGAT,18,2797834
ompRp1,0.10526315789473684,19,18,GCGCACAGTGCCTAAACGAG,1,2798350
ompRp1,7.315789473684211,156,18,GAGTGTTGCTGTCATGGAAC,138,2793442
ompRp1,0.10526315789473684,19,18,GAGCTCAAACGCTGGATTTG,1,2789573
ompRp1,3.8947368421052633,91,18,GACATCTTTATTCTCGTAGC,73,2765947
ompRp1,0.2631578947368421,22,18,GAAGTTCCATCAGGTATGAC,4,2781048
ompRp1,4.7894736842105265,108,18,CTGCGTGCTAAGATTGTATA,90,2800256
ompRp1,0.10526315789473684,19,18,CTGCGGCTTTCGTTTTATAT,1,2782910
ompRp1,5.7368421052631575,126,18,CTGACAATTTACTCCGGAAA,108,2792282
ompRp1,0.3684210526315789,24,18,CTCACGTCTTTGCCGACCAG,6,2766450
ompRp1,0.21052631578947367,21,18,CTACAGACACTAATGGGATC,3,2818230
ompRp1,0.15789473684210525,20,18,CTACACATATACATGTGCCA,2,2793153
ompRp1,0.10526315789473684,19,18,CTAAGACGTTACCACCGATC,1,2785106
ompRp1,6.052631578947368,132,18,CGTTGTATGGTGGTCTCAGT,114,2813561
ompRp1,0.6842105263157895,30,18,CGGGCGCATGCAGACCTCCA,12,2804247
ompRp1,0.10526315789473684,19,18,CGGCGACGGCTGCATCTGGC,1,2799084
ompRp1,2.1052631578947367,57,18,CGGATCCCCAGTTTGAATGC,39,2784285
ompRp1,3.6315789473684212,86,18,CGGACCACCCCTTTCCTGTA,68,2777028
ompRp1,0.10526315789473684,19,18,CGCGGCTTTAGGCCATGTCG,1,2769741
ompRp1,4.052631578947368,94,18,CGAAAAGACACTGCATTTGA,76,2786492
ompRp1,1.263157894736842,41,18,CCTAAATTTGTCCACCTATA,23,2813005
ompRp1,0.15789473684210525,20,18,CCCTTGAATCGCCTTAGGCT,2,2782477
ompRp1,3.3684210526315788,81,18,CCCGGTCCTGCACTGGGTAA,63,2770664
ompRp1,0.10526315789473684,19,18,CCCCACTGACCGATGCCTCT,1,2788814
ompRp1,7.368421052631579,157,18,CATGGGTAGATGGTCGGTGA,139,2788472
ompRp1,8.105263157894736,171,18,CAGTAGTCCCACGGGTATAT,153,2774089
ompRp1,1.263157894736842,41,18,CAACAGTCCTTTTGTGGAGT,23,2768306
ompRp1,0.10526315789473684,19,18,CAAAATGTTATGTCGCGTAG,1,2799707
ompRp1,8.157894736842104,172,18,ATTCACCGATATATCGGATC,154,2804162
ompRp1,5.105263157894737,114,18,ATCACAACTCATGGGTATTG,96,2795984
ompRp1,2.3157894736842106,61,18,AGTGAGTAATTCTTTCTCGG,43,2794223
ompRp1,0.10526315789473684,19,18,AGTCCAAATGGTTAAATCTC,1,2789642
ompRp1,0.10526315789473684,19,18,AGGTCTGTCGCATGTGCGCT,1,2817618
ompRp1,0.10526315789473684,19,18,AGGTCCAGGTTGTTTACCAA,1,2809589
ompRp1,0.10526315789473684,19,18,AGGGGGCGGCTCGGCAGAAT,1,2802986
ompRp1,2.736842105263158,69,18,AGGGGACACATAATTAGTTA,51,2770646
ompRp1,2.1578947368421053,58,18,AGGACTCTCCATTTTTTTAA,40,2823959
ompRp1,9.421052631578947,196,18,ACAGGACTGGGGCTTCTGCG,178,2822344
ompRp1,12.052631578947368,246,18,AAGCAAGCACCAATGGTCAA,228,2776140
ompRp1,0.10526315789473684,19,18,AACGGCTCCTGCAGTTCAAA,1,2795595
ompRp1,3.9473684210526314,92,18,AACAAAGGGTTTGGGTATAC,74,2792507
ompRp1,18.894736842105264,376,18,AAACGAGAAGTGGTCGAACT,358,2786151
ompRp1,6.947368421052632,149,18,AAAACTGCATGATAGGAGGT,131,2790268
ompRp1,5.055555555555555,107,17,TTCCACTTCCATTCGCGAAT,90,2797182
ompRp1,6.277777777777778,129,17,TTCATCCTGTCTTGCAGTTA,112,2792806
ompRp1,10.944444444444445,213,17,TGTCCCCAACGTTGAACGAG,196,2811604
ompRp1,12.722222222222221,245,17,TGGCGTTAGGCCCGAACGGA,228,2787940
ompRp1,9.11111111111111,180,17,TGGCCGGCCCGATCGCGTTA,163,2788053
ompRp1,0.1111111111111111,18,17,TGGCACCGAAACATTAACTG,1,2824049
ompRp1,3.7222222222222223,83,17,TGCAACGGAACTCCGGGTAT,66,2816265
ompRp1,0.1111111111111111,18,17,TGCAAAAGAAGCGGATCCAT,1,2790911
ompRp1,0.1111111111111111,18,17,TGAGTGTGCTAAGTCTTGAG,1,2800941
ompRp1,17.0,322,17,TCCCTCTTCACTATATCTAG,305,2796918
ompRp1,3.888888888888889,86,17,GTTTCTCCCATTTGCTTCAC,69,2786048
ompRp1,0.4444444444444444,24,17,GTGACCGCTAAGAAAGGTAC,7,2805416
ompRp1,0.1111111111111111,18,17,GTCAGTCAAATGTCGTACCT,1,2786606
ompRp1,5.444444444444445,114,17,GGGTTAAGCCTCCTTAGAAG,97,2813093
ompRp1,0.1111111111111111,18,17,GGCGTCCAAGGCTTAGGGCA,1,2766866
ompRp1,0.5,25,17,GGCCACGTAATGCTTTCATA,8,2798983
ompRp1,0.1111111111111111,18,17,GGATGGGATCCAACGTTCGG,1,2773348
ompRp1,0.6666666666666666,28,17,GGAGTATATATCTTACCGTA,11,2796595
ompRp1,0.1111111111111111,18,17,GGACTGCAGTCATAAACATT,1,2786717
ompRp1,3.1666666666666665,73,17,GCTCGGCTGGAGGTGTGGAA,56,2799522
ompRp1,6.277777777777778,129,17,GCGCTATTGCATGGTAAGTT,112,2806263
ompRp1,0.1111111111111111,18,17,GCGCCAAGTGGAAACTGAAT,1,2777733
ompRp1,0.5,25,17,GCGAGCTTTTGTAACTCGAT,8,2813089
ompRp1,0.16666666666666666,19,17,GCCTGTTAAACACCTCGATC,2,2771353
ompRp1,0.1111111111111111,18,17,GCCGCACGTACGGAGCTCGT,1,2768587
ompRp1,0.1111111111111111,18,17,GCAAACCCTCAATCCCCCTC,1,2767242
ompRp1,0.1111111111111111,18,17,GAGCTTTTAAATACGTCCGA,1,2819435
ompRp1,7.833333333333333,157,17,GAGATAAGTGTAAGTGTCAT,140,2810806
ompRp1,0.1111111111111111,18,17,GACTGTTCGGGGTCCCAGAA,1,2812080
ompRp1,25.27777777777778,471,17,GAACAGGCACGCCGCGGGTC,454,2775158
ompRp1,3.0,70,17,CTTGCTAGCTATGGAGCTAT,53,2818596
ompRp1,0.1111111111111111,18,17,CTTCTGAGAGGCTAGAAAAG,1,2784324
ompRp1,0.1111111111111111,18,17,CTTATTCGCTTAGCGAGCTT,1,2776348
ompRp1,0.1111111111111111,18,17,CTGAAGATCATGCATGGGCA,1,2815271
ompRp1,7.555555555555555,152,17,CTCGGTCCCCGTATGGATAC,135,2774600
ompRp1,3.8333333333333335,85,17,CTAGTTTACTATCTGCCAGC,68,2778988
ompRp1,0.1111111111111111,18,17,CTAGGAGTATCCCTAGTCAC,1,2814344
ompRp1,0.1111111111111111,18,17,CTAGCTGCAGAAGTACCGTT,1,2797916
ompRp1,5.166666666666667,109,17,CGTTTCGGCGTGTGCTCAGT,92,2808789
ompRp1,9.555555555555555,188,17,CGTAACTAGGTTTTGATCTA,171,2784782
ompRp1,11.0,214,17,CGGAAACTTTAGCCCAGTTA,197,2800445
ompRp1,0.16666666666666666,19,17,CGAAGTGTCCAATGACGGAG,2,2802479
ompRp1,0.1111111111111111,18,17,CCTTAGGACTTTGCAATGGA,1,2781995
ompRp1,0.1111111111111111,18,17,CCTGGGTTTAGGGCAATGTC,1,2797873
ompRp1,0.1111111111111111,18,17,CCCCGTAGATGTCATGGGAT,1,2815475
ompRp1,5.944444444444445,123,17,CCCCGCGCTCGACCTGCAAG,106,2782094
ompRp1,0.1111111111111111,18,17,CCAGTAGGATATATGTCGTA,1,2803502
ompRp1,12.833333333333334,247,17,CATGGGAGGACCAACGCGAT,230,2794330
ompRp1,6.666666666666667,136,17,CATCTTCATATTAGCATCAG,119,2792869
ompRp1,2.5,61,17,CATACCAACTTTTAGAGGCT,44,2783819
ompRp1,5.777777777777778,120,17,CAGGTCTATATGGCGGGGAA,103,2814455
ompRp1,6.055555555555555,125,17,CAGGTAGGAGTGGGTGCACT,108,2774041
ompRp1,3.2222222222222223,74,17,CAATAGACCTCGCAAGACTG,57,2819826
ompRp1,0.1111111111111111,18,17,ATCTATAAGCTACTAAGTAT,1,2803010
ompRp1,0.5,25,17,ATCAGGACCCATCACACCGG,8,2786720
ompRp1,7.944444444444445,159,17,AGGTTCACCGTGCTCGTTAC,142,2791393
ompRp1,2.1666666666666665,55,17,AGCGAACGTGGCCTTCGGGT,38,2768513
ompRp1,0.7777777777777778,30,17,AGATGAGGATTAAGCTCCGT,13,2802281
ompRp1,0.16666666666666666,19,17,AGAATAGCCGAACGCGAAGA,2,2823419
ompRp1,9.666666666666666,190,17,AGAAGCAAACTTCTAGCTTG,173,2806167
ompRp1,5.277777777777778,111,17,ACTTTTGCAGGTTGAACACT,94,2823250
ompRp1,4.388888888888889,95,17,ACTGGCGGCAACAGTCGAGG,78,2780551
ompRp1,6.277777777777778,129,17,ACTCCTATTGTACTGGGTCT,112,2772804
ompRp1,4.222222222222222,92,17,ACTATTGACTTATTGACCAG,75,2786242
ompRp1,0.1111111111111111,18,17,ACGTCCGCTTTGACCCGATA,1,2775289
ompRp1,3.8333333333333335,85,17,ACGTCCCTGTCAACGGCCAT,68,2806644
ompRp1,0.1111111111111111,18,17,ACGATTGCTTAAAGCTGTCA,1,2766292
ompRp1,7.666666666666667,154,17,ACGAGACTTGGACAAAGGAA,137,2813723
ompRp1,0.16666666666666666,19,17,ACCGGTTCAGAAGGGTATCG,2,2804072
ompRp1,8.777777777777779,174,17,ACCCAGGTACCCCAATTCAC,157,2786239
ompRp1,0.2222222222222222,20,17,ACATACTTTGTGCGACGGAA,3,2797420
ompRp1,0.5555555555555556,26,17,ACACTGCGTTATTCTTTCAA,9,2784755
ompRp1,0.1111111111111111,18,17,AATGTATCTTTTTGCGTCCC,1,2803171
ompRp1,3.111111111111111,72,17,AAGGGGTAAGGCACCTAATG,55,2783323
ompRp1,0.16666666666666666,19,17,AAAGATGCTAACTCTGGACT,2,2791766
ompRp1,6.352941176470588,123,16,TTGTAGCCGCCTTTCAGCGA,107,2810939
ompRp1,5.705882352941177,112,16,TTGCTGAGCACCTTTGGGGG,96,2816511
ompRp1,6.647058823529412,128,16,TTGAAAGGCCCACTTTGCAT,112,2798549
ompRp1,0.4117647058823529,22,16,TTATCCAAAGAGTTACTTAA,6,2767902
ompRp1,2.4705882352941178,57,16,TTACGACATATGGAGGATAA,41,2820306
ompRp1,6.294117647058823,122,16,TTACAAAATGCCGCGGGTTT,106,2769697
ompRp1,6.411764705882353,124,16,TTAAGGGATCTCACGTCGGT,108,2774841
ompRp1,12.529411764705882,228,16,TGTGAGCTTACGATTAGGTC,212,2767113
ompRp1,2.8823529411764706,64,16,TGCCGAACATATTCAGGTCA,48,2772695
ompRp1,0.11764705882352941,17,16,TGCACGGTCACTAACATGGG,1,2796665
ompRp1,3.823529411764706,80,16,TGATGCGCAGGGAAGCCAAT,64,2816041
ompRp1,0.11764705882352941,17,16,TGACCATGAAGGGTCTCACA,1,2781270
ompRp1,0.4117647058823529,22,16,TCAGAGAACGTACCACCGAT,6,2806205
ompRp1,0.11764705882352941,17,16,TATGGAGGCTATCCACCACA,1,2796106
ompRp1,9.117647058823529,170,16,GTTACACTAGGATTTTTGCA,154,2788378
ompRp1,1.0588235294117647,33,16,GTGTCGGTTAAGAGGCGAGA,17,2779415
ompRp1,0.11764705882352941,17,16,GTCCGGACATAGTTGCCCCT,1,2780320
ompRp1,0.11764705882352941,17,16,GTACTTTGGCCCCAACTCCC,1,2765948
ompRp1,0.11764705882352941,17,16,GGGTTCTGGCATTTCCAAAT,1,2765958
ompRp1,3.4705882352941178,74,16,GGCCTTCGGACGTGCGGGAG,58,2775414
ompRp1,6.588235294117647,127,16,GGCAGCCTGAAATTTGGCTC,111,2815729
ompRp1,4.470588235294118,91,16,GGATTCAATACTCCGAGTCA,75,2816094
ompRp1,0.11764705882352941,17,16,GGACGCAGTTGCCGGTGTCA,1,2792476
ompRp1,1.3529411764705883,38,16,GCGGCCCTTATCGATTTGAA,22,2788780
ompRp1,8.294117647058824,156,16,GCAGGGGCAATTTGGAAGTT,140,2795248
ompRp1,0.11764705882352941,17,16,GACTTCAGCTGACGCTTTTA,1,2783095
ompRp1,0.11764705882352941,17,16,GAATAATCAGGGCCACTTCA,1,2804249
ompRp1,2.9411764705882355,65,16,GAAGGTGAGGTTGGCTTTTA,49,2803241
ompRp1,4.411764705882353,90,16,CTCCTATCTTTCGCTGCTTG,74,2804147
ompRp1,5.0588235294117645,101,16,CTAGCTGGCCTATCGTACCC,85,2773101
ompRp1,8.647058823529411,162,16,CGTTCTGGGTCAAGCTCCGA,146,2780145
ompRp1,1.1176470588235294,34,16,CGTGATATACTAGAAGAACG,18,2783462
ompRp1,2.0588235294117645,50,16,CGTACACACCCCACCAAAAA,34,2785054
ompRp1,7.470588235294118,142,16,CGCTGGACAACGCCAATTAC,126,2776070
ompRp1,0.11764705882352941,17,16,CGCATGACGAAAACCGCAGA,1,2776774
ompRp1,0.11764705882352941,17,16,CGAGCATGTGGTTGCCAATA,1,2774718
ompRp1,2.9411764705882355,65,16,CGACAGTGTCTGTAGAGTAG,49,2816179
ompRp1,6.823529411764706,131,16,CCTCAGCAATCGGTGTACTG,115,2768958
ompRp1,15.529411764705882,279,16,CCGTTTCGCTACTCCTTAAA,263,2775415
ompRp1,0.11764705882352941,17,16,CCGTCCGGAACTGCATTTAG,1,2783342
ompRp1,9.058823529411764,169,16,CCCTTTTGATTATAGTTAAT,153,2767412
ompRp1,0.29411764705882354,20,16,CCCTCTCTGAGACCAGGTGA,4,2790912
ompRp1,6.352941176470588,123,16,CAGGGCGCGTTCCCAATTAC,107,2778720
ompRp1,0.11764705882352941,17,16,CAGACTTGAGGTGTTTAAGT,1,2780574
ompRp1,0.11764705882352941,17,16,CACTCCCTAAGCCACGCTAG,1,2768681
ompRp1,15.529411764705882,279,16,CACTACAGTATAGTCCATTT,263,2790031
ompRp1,0.23529411764705882,19,16,CACCTATTTCTGGTCGCTTA,3,2810358
ompRp1,7.823529411764706,148,16,CACAATGGCCTCTGGTGACT,132,2784633
ompRp1,5.235294117647059,104,16,CAAGCACACCGTGCAAGCTA,88,2793355
ompRp1,4.705882352941177,95,16,ATTGCAACGGCTCGAAAGGT,79,2780508
ompRp1,8.058823529411764,152,16,ATGGTTATCTTAATTGGTCT,136,2783952
ompRp1,5.764705882352941,113,16,ATCTGTCCACGTACCAGCCG,97,2807817
ompRp1,7.9411764705882355,150,16,ATCGTAAGGGACATACCTGC,134,2790858
ompRp1,0.11764705882352941,17,16,AGTATAACTTTCAGGCGGTA,1,2801080
ompRp1,0.11764705882352941,17,16,AGTAGAATTGATCAGTGTTG,1,2821763
ompRp1,0.11764705882352941,17,16,AGGTATGACTCCGTACAATG,1,2802813
ompRp1,9.647058823529411,179,16,AGGTAACTAGCCTCAGGCAT,163,2805129
ompRp1,3.588235294117647,76,16,AGGCCGACAATCTCTGACTA,60,2797114
ompRp1,0.17647058823529413,18,16,ACTGGGTACGTCTACGTGTG,2,2794489
ompRp1,9.588235294117647,178,16,ACCATTTCGACCTCTCCACG,162,2808722
ompRp1,6.176470588235294,120,16,ACAGGTCCGTGCCGGGTCCT,104,2785391
ompRp1,0.17647058823529413,18,16,ACAGGAGTTGTTTAGTCTTT,2,2794660
ompRp1,0.11764705882352941,17,16,ACAAGCGATTACTTCTCACC,1,2809915
ompRp1,1.0588235294117647,33,16,AATGGGTTAAGTTCATTGTT,17,2794767
ompRp1,0.11764705882352941,17,16,AAGGTGCACGGCCGGGGGAG,1,2778390
ompRp1,2.588235294117647,59,16,AACGCATATGCGCCGTAAAG,43,2771158
ompRp1,12.117647058823529,221,16,AAATGGCTAACGGATGCATC,205,2772694
ompRp1,0.5,22,15,TTTCCAGATGAGCGTGTTAG,7,2796028
ompRp1,0.5625,23,15,TTGTGTATGTGGTGCAGTGA,8,2773907
ompRp1,0.1875,17,15,TTCGGCCTGTAAAAAACGCA,2,2795508
ompRp1,0.25,18,15,TTCCATCCGGCATAGCACCG,3,2783070
ompRp1,9.3125,163,15,TTCAGAGTAGCGCCGTCTTG,148,2768363
ompRp1,0.125,16,15,TTCAAGCAAATAAACACGTC,1,2777310
ompRp1,4.0625,79,15,TTAACGTAGTGTACGGGACA,64,2784927
ompRp1,0.125,16,15,TGTTTTGCCCCTTGGTCTTA,1,2821921
ompRp1,0.125,16,15,TGTCTGGTAGTGAACAACGG,1,2768856
ompRp1,9.125,160,15,TGTAGAGTCGCAATCGCATT,145,2819518
ompRp1,3.25,66,15,TGTAATTAGAACGATTTGCT,51,2800022
ompRp1,4.5625,87,15,TGGGTCATAATTCAAGAAGT,72,2786628
ompRp1,0.1875,17,15,TGATCGTTCTGGTACCATTT,2,2782391
ompRp1,0.125,16,15,TCTCCGGTGAACGCGGTTTT,1,2789923
ompRp1,4.5,86,15,TCGGGAAATCATCATGACGC,71,2817635
ompRp1,3.5625,71,15,TCGAGCTTCGCCAGCGGCCC,56,2779343
ompRp1,0.1875,17,15,TCCTTTGGCATTCGCTGATT,2,2810528
ompRp1,0.125,16,15,TCACACTATGGTGTATCGAA,1,2766608
ompRp1,10.9375,189,15,TAGATGAGCAGGCGCTAGGG,174,2815446
ompRp1,1.9375,45,15,GTTTAATTGGGTTGTTCGAT,30,2786875
ompRp1,2.375,52,15,GTGCAGCTAGTAGCGAACGT,37,2782454
ompRp1,0.4375,21,15,GTGAGGACGGAAGCGGGCTT,6,2770408
ompRp1,3.125,64,15,GTCGTACAAAGTCGAGTTGA,49,2789928
ompRp1,0.25,18,15,GTAGGTTAGAGCTAATAAAG,3,2784158
ompRp1,0.125,16,15,GGGGAGACCGAGTGTACTAG,1,2813585
ompRp1,0.125,16,15,GGCGCGGTACGGGATGGAAG,1,2782769
ompRp1,4.5625,87,15,GCGGGGCCTCCATACTACTT,72,2767780
ompRp1,0.125,16,15,GCAGTCCCGCTAACTCATCA,1,2819921
ompRp1,0.4375,21,15,GCACCAGCCCTTGCCAGAAC,6,2797019
ompRp1,9.4375,165,15,GATCTACCCAGGTGCCTCTG,150,2799877
ompRp1,0.125,16,15,GAGCGGATTCATGATTGATG,1,2775594
ompRp1,0.25,18,15,GACGCCACATTGCATACCAA,3,2766857
ompRp1,1.0,30,15,GACAGACAGGGGATTTCTAT,15,2821447
ompRp1,5.0625,95,15,GAAGGGGAGGTCGTAGTCCT,80,2780406
ompRp1,17.0,286,15,CTTGGGGAACCACGGTTTCA,271,2775179
ompRp1,0.4375,21,15,CTCCGCCATTTAGACCTCTA,6,2797950
ompRp1,1.5,38,15,CTCAGGTTGTCTCTGTTAGT,23,2781258
ompRp1,0.125,16,15,CTACTGACTGGCGTTCTACA,1,2776382
ompRp1,9.0,158,15,CTACAGCCTAACGTCGTTTC,143,2789817
ompRp1,0.3125,19,15,CGTCACTTGTTCCATGATCT,4,2820983
ompRp1,8.625,152,15,CGGAGCCGCGGACTTATGGC,137,2785504
ompRp1,1.125,32,15,CGCCTTAAAAAGTTTTGAGT,17,2820726
ompRp1,0.25,18,15,CGCCATAATAAAGCTTAGGT,3,2793050
ompRp1,0.3125,19,15,CGACGAAGCAAAGATACTAC,4,2796390
ompRp1,5.5625,103,15,CCTTCGATCTGTGTAAAGAG,88,2802377
ompRp1,12.0,206,15,CCTTCAAAACTGTGACATTG,191,2773261
ompRp1,2.9375,61,15,CCTATCAAGGGGGACCCTTC,46,2771728
ompRp1,4.25,82,15,CCGTAAGCCCGAGACACCCT,67,2823860
ompRp1,0.125,16,15,CCGGCATGCGAGGGAGGCGG,1,2783770
ompRp1,0.8125,27,15,CCGCGGGCTTGCTATTGGTT,12,2767476
ompRp1,3.875,76,15,CCGCCACGGTCGGGGGATAT,61,2800020
ompRp1,3.4375,69,15,CCGACCCGTAGTCAGTATTA,54,2791239
ompRp1,0.125,16,15,CCCTAGCCTTCAGTGGTTTG,1,2801289
ompRp1,0.125,16,15,CCCACACAGGACCCGGTCAC,1,2777794
ompRp1,0.125,16,15,CCATTGTCACACAATACGGT,1,2823869
ompRp1,6.8125,123,15,CATCTGTGTGCAAACCGTCT,108,2783104
ompRp1,0.25,18,15,CACTCAAGACTACTGCCTTA,3,2777842
ompRp1,0.125,16,15,CACATGTTAGCAAAACATTA,1,2788810
ompRp1,0.1875,17,15,CAATGGCTCTAGCAATGGGA,2,2769712
ompRp1,2.375,52,15,CAATAGATGCATCGGCCCCA,37,2765730
ompRp1,10.4375,181,15,ATTCTTCTACATGTTGGATA,166,2793147
ompRp1,0.25,18,15,ATTCTGAGTTGCGGGCATGA,3,2780798
ompRp1,3.0,62,15,ATTCCGCGTGTCTTGGATCT,47,2773217
ompRp1,0.4375,21,15,ATGGGTTTTTCTTCCTGCAG,6,2796719
ompRp1,4.0,78,15,ATGAGTCCAGAGCTGCCAGG,63,2766094
ompRp1,1.9375,45,15,ATCGTTTGTGTACGAACACA,30,2773218
ompRp1,7.5,134,15,ATCCAATCGCAATCATGCAA,119,2779803
ompRp1,3.875,76,15,AGGCTTGCGTTGATGCCCAA,61,2796594
ompRp1,12.0625,207,15,AGCTGGTAACAGGTTATCGC,192,2788976
ompRp1,13.75,234,15,AGCGTCACTATCGTCGCTTC,219,2799212
ompRp1,0.75,26,15,AGATTAGACTCTCTCGGGCA,11,2822489
ompRp1,2.875,60,15,ACTGTGCACTGCGGGTCCCG,45,2772583
ompRp1,3.9375,77,15,ACAAGGAGAAACGTGCATAC,62,2768449
ompRp1,4.625,88,15,AATCGTAGTGGCTGTTTATA,73,2773811
ompRp1,0.13333333333333333,15,14,TTTTCGGCTGATAATAAAGA,1,2770443
ompRp1,0.13333333333333333,15,14,TTTCCATTCTTAAGCAGAGC,1,2804022
ompRp1,0.13333333333333333,15,14,TTGTCTGAGAATATTTAGAT,1,2788283
ompRp1,3.0,58,14,TTGGGACCGTATGCACGTCA,44,2783543
ompRp1,5.0,88,14,TTGGACGCGGAGTTTGGTCC,74,2807566
ompRp1,5.4,94,14,TTGCGTGAGAAAAGACGCGT,80,2791470
ompRp1,0.13333333333333333,15,14,TTGAGCCCCTCGTTAATACG,1,2818830
ompRp1,10.133333333333333,165,14,TGTGCGTTACTGCAGGCCAA,151,2803009
ompRp1,3.066666666666667,59,14,TGGGCAACTGCGTCAAGCGA,45,2823303
ompRp1,0.2,16,14,TGGAGTAAAGGGGGTCGTGG,2,2780216
ompRp1,0.2,16,14,TGGACTGGAAGGTGAGGCTT,2,2782252
ompRp1,0.8,25,14,TGGAAGCGTCATCGTGAAGT,11,2785373
ompRp1,4.6,82,14,TGATTCCGCTTTTGTGGTCC,68,2780953
ompRp1,0.26666666666666666,17,14,TCGCATGGATGGTAGTAAGA,3,2781366
ompRp1,0.2,16,14,TCGCATGCATGTAATGGGAC,2,2765254
ompRp1,5.0,88,14,TCGACCGTATATGGGTAGAT,74,2813907
ompRp1,0.13333333333333333,15,14,TCCTCCCGCCCGCTGCGATT,1,2791772
ompRp1,0.13333333333333333,15,14,TCCAACGTAATGTACCCCTT,1,2809672
ompRp1,1.4666666666666666,35,14,TATTCTTTTGCTCCACTGAG,21,2784027
ompRp1,1.6,37,14,TATCTGGTTCATGACACCTC,23,2765998
ompRp1,0.13333333333333333,15,14,TATAAAGTCCGCGCATTGGG,1,2781721
ompRp1,4.133333333333334,75,14,TAGCGGTCTGCTGTTAAGTC,61,2775505
ompRp1,2.3333333333333335,48,14,TACTGTCCGGGGGGCTTGGT,34,2777793
ompRp1,2.933333333333333,57,14,TAATTACGCATTCTTCATCC,43,2783343
ompRp1,6.466666666666667,110,14,GTGATGTTGAACATGAACCA,96,2789876
ompRp1,10.8,175,14,GTCGAAGCGGCTATCGGTTA,161,2796551
ompRp1,7.933333333333334,132,14,GGCGAAATGTTCACTACGCA,118,2816696
ompRp1,5.6,97,14,GGACTAGGGCTCTGTACTCT,83,2815521
ompRp1,36.4,559,14,GGAACCCGGAATCGAACGTG,545,2813635
ompRp1,3.2666666666666666,62,14,GCTTGCGCATGAGGGTCGAC,48,2818043
ompRp1,0.3333333333333333,18,14,GCATGGATGGGGGATCAAAA,4,2782971
ompRp1,3.2666666666666666,62,14,GCACGTTTGGCTGATGTAAA,48,2817886
ompRp1,0.13333333333333333,15,14,GCAACACCTGATACACATGC,1,2813634
ompRp1,0.13333333333333333,15,14,GATGTAGGATTAGCGACTTT,1,2816120
ompRp1,2.6666666666666665,53,14,GAGCAAGGGGCGCCATGATT,39,2811490
ompRp1,2.8666666666666667,56,14,CTTTGCGCACGACATACGCA,42,2817294
ompRp1,8.333333333333334,138,14,CTTTATCGGGGGTTATGCCA,124,2777003
ompRp1,0.13333333333333333,15,14,CTTGTAGCGTAGCCATGTGC,1,2816692
ompRp1,0.4,19,14,CTGCCCACTGACAAGGTCAG,5,2810801
ompRp1,2.533333333333333,51,14,CTCTCATCATAGGTTTGCGG,37,2796684
ompRp1,0.8,25,14,CTCGAGGTCTCCGCCATTCC,11,2775603
ompRp1,8.333333333333334,138,14,CTCGAAGGCGGCAGCGATCA,124,2805447
ompRp1,1.4,34,14,CTCAACTCACCAGTCATTAG,20,2777889
ompRp1,4.066666666666666,74,14,CTATCGATAAAAGCTTGCAT,60,2782353
ompRp1,9.133333333333333,150,14,CTACGCTATATCATGATTCC,136,2782388
ompRp1,11.733333333333333,189,14,CGTTCTCACATTGGAGACGT,175,2780909
ompRp1,0.13333333333333333,15,14,CGTCTGAGAAAGTCCCGCTA,1,2782838
ompRp1,0.13333333333333333,15,14,CGTCTACTTCGAGGCTTAAT,1,2793949
ompRp1,7.2,121,14,CGGCGGGAGGTCCGCCGTAA,107,2794906
ompRp1,0.4,19,14,CGCTGGTACACCCTTCGCTC,5,2779546
ompRp1,0.13333333333333333,15,14,CGCGATCCGGCACTCTAATG,1,2803265
ompRp1,0.13333333333333333,15,14,CGAAAACCGGACGATCAGGG,1,2799852
ompRp1,5.6,97,14,CCGCCAGTAGGGTAGTTTTA,83,2795019
ompRp1,5.733333333333333,99,14,CCATACGTGCCCCTGAACAT,85,2811647
ompRp1,0.13333333333333333,15,14,CCAAAGAAACCAGTTCAGCC,1,2824338
ompRp1,11.066666666666666,179,14,CAGCATGAACGGTGCTTAGT,165,2775601
ompRp1,0.13333333333333333,15,14,CACTCTAATAAGGCGTGTAT,1,2814283
ompRp1,0.13333333333333333,15,14,CACGGCTAATTGGATCCTTT,1,2776775
ompRp1,0.13333333333333333,15,14,CACGCAGTGAAGTTAAGACA,1,2819837
ompRp1,1.0,28,14,CAATATTTCATGGCGCCGGA,14,2799520
ompRp1,3.7333333333333334,69,14,ATTTTGAGTCCATCAGCTGA,55,2795471
ompRp1,0.13333333333333333,15,14,ATGTGTGCCGGAGAGGGATT,1,2794281
ompRp1,3.933333333333333,72,14,ATGCCTTGCTTCATATTTGC,58,2790082
ompRp1,12.6,202,14,ATCCACTCACAGTTTACTCG,188,2769059
ompRp1,0.13333333333333333,15,14,ATACCAACAGAGGCAGGGGT,1,2777368
ompRp1,8.066666666666666,134,14,AGGGCGGCCAGGTGATCTGG,120,2803601
ompRp1,0.13333333333333333,15,14,AGAACAGGTGGAGTTATTTG,1,2769064
ompRp1,7.866666666666666,131,14,ACTGAGTCATGCGCTTGTGC,117,2821379
ompRp1,1.0,28,14,ACGTACAAGCATGACCGTCA,14,2765394
ompRp1,0.13333333333333333,15,14,ACGGGCAGACTCTGGGCTGG,1,2780815
ompRp1,1.4,34,14,ACGCGGTGTCTCATAGGGAA,20,2787941
ompRp1,0.13333333333333333,15,14,ACGACTCCTAGAGCAGTATT,1,2776804
ompRp1,0.5333333333333333,21,14,ACCAATTCAATGGTCGTTCT,7,2786632
ompRp1,1.6,37,14,ACATACTCAATGCCCAACTA,23,2818498
ompRp1,3.933333333333333,72,14,ACAATGTAGGTTCCCGTAAA,58,2780919
ompRp1,2.933333333333333,57,14,ACAATGCCCTGAAAACGTAG,43,2772693
ompRp1,0.2,16,14,AATCGACAAAGGGATGCGTT,2,2816768
ompRp1,0.5333333333333333,21,14,AAGTCGCGTCTGGGATTCGT,7,2808466
ompRp1,9.866666666666667,161,14,AAGCTATTACAGAAAACACA,147,2813648
ompRp1,6.066666666666666,104,14,AAGCAAGCTCTGTAAAACAC,90,2799523
ompRp1,12.133333333333333,195,14,AACGTAATTGACGTTTCGTA,181,2793309
ompRp1,0.26666666666666666,17,14,AACCACCTCAATGGCCTCGC,3,2797933
ompRp1,12.071428571428571,181,13,TTTTGCTTTCGCGTAGGGGG,168,2802855
ompRp1,2.357142857142857,45,13,TTTAGCATTCTGGGTGCATT,32,2773599
ompRp1,3.357142857142857,59,13,TTGTCCGCTCGGTCATGTTA,46,2816272
ompRp1,0.21428571428571427,15,13,TTGGTATCATCCGTGCAGTA,2,2797883
ompRp1,7.428571428571429,116,13,TTGGGTTAGTCTTACGCGTT,103,2769515
ompRp1,5.428571428571429,88,13,TTCGTTGCCGTACGCGCTTG,75,2773752
ompRp1,16.071428571428573,237,13,TTACGGGGGACATTTCAGTT,224,2821402
ompRp1,0.42857142857142855,18,13,TGGTGGTATAGGAGTTTTTT,5,2810574
ompRp1,7.071428571428571,111,13,TGGCTTAGCCAGTACACCCT,98,2815646
ompRp1,0.14285714285714285,14,13,TGGATACGAACATAGAAACT,1,2768807
ompRp1,3.5714285714285716,62,13,TCTCTCTTTGGGTATAAGGC,49,2770601
ompRp1,12.0,180,13,TCGGGCACCGTACTTCACGA,167,2823745
ompRp1,1.0,26,13,TCGGCCACTCTTGTACAATT,13,2780051
ompRp1,8.857142857142858,136,13,TCGCGATGGTCGCTGTTTTC,123,2788683
ompRp1,0.14285714285714285,14,13,TCCTACGGTGTGGTTGACGA,1,2800134
ompRp1,0.14285714285714285,14,13,TCAGTTCCTTAGATTGCGAT,1,2807458
ompRp1,0.14285714285714285,14,13,TCACGTGTTGAGTGGAGCTC,1,2792781
ompRp1,13.571428571428571,202,13,TATGTAAAAGCATAACTATT,189,2787942
ompRp1,0.14285714285714285,14,13,TAGCTCATCCGTGCGGACGA,1,2814620
ompRp1,13.142857142857142,196,13,TAGCCAATCTAAGTAACTTG,183,2818604
ompRp1,0.5714285714285714,20,13,TACTTTAGGCAACCCCCATC,7,2779296
ompRp1,4.0,68,13,TACTAAGTTCCCAGTGGGTC,55,2775426
ompRp1,6.428571428571429,102,13,TACGTCCGAATAAGTTGTCT,89,2782364
ompRp1,0.21428571428571427,15,13,GTTTCCAGTATTAGGGCCAT,2,2808159
ompRp1,13.785714285714286,205,13,GTTTATATCGGGAGAAGTAT,192,2779107
ompRp1,8.142857142857142,126,13,GTTATATTATGGCCCCCTCA,113,2815519
ompRp1,0.14285714285714285,14,13,GTGCTAACTACGTTGCGTTG,1,2770027
ompRp1,3.4285714285714284,60,13,GTCTTTCGGACCGCGTAAAG,47,2797835
ompRp1,0.21428571428571427,15,13,GTCCATTGTGGTGTATGTTC,2,2788032
ompRp1,9.642857142857142,147,13,GGTCTCAAAATTGCCTGTGG,134,2804738
ompRp1,0.14285714285714285,14,13,GGTCCTTATTAGGGAGCTTT,1,2806063
ompRp1,7.642857142857143,119,13,GGGGGCTAACCTACTCGAGT,106,2815826
ompRp1,0.14285714285714285,14,13,GGCATAAAACGACAACGCTA,1,2823178
ompRp1,10.5,159,13,GGAATCACCACACACTATAC,146,2820691
ompRp1,0.7857142857142857,23,13,GCGTGAGCGTGACTGACCTG,10,2812223
ompRp1,0.14285714285714285,14,13,GCGTACCGCTGGCTTGCCGA,1,2821395
ompRp1,10.0,152,13,GCGGCTCTCCACATCCCCAC,139,2776142
ompRp1,4.0,68,13,GCCTGGTGGTCCTATCGTGT,55,2813463
ompRp1,0.14285714285714285,14,13,GCCTACATCCGTTGATATTG,1,2794671
ompRp1,0.14285714285714285,14,13,GCATCCAATAGTGTAAAGTG,1,2814757
ompRp1,0.2857142857142857,16,13,GATGTGTTCACTCCGTAGTT,3,2775097
ompRp1,6.5,103,13,GAGCCTCGGCCGCACCCTAG,90,2776529
ompRp1,8.142857142857142,126,13,GACGCGCACCTAGCAGTATT,113,2788676
ompRp1,10.357142857142858,157,13,GACGATGCGACGCAACTCAT,144,2769735
ompRp1,0.14285714285714285,14,13,GAATCAACATTTCTCTACAT,1,2778188
ompRp1,2.142857142857143,42,13,GAAGTGTCTTAGGCCCCGTA,29,2774045
ompRp1,10.285714285714286,156,13,GAAGACCCTGTGTCAGCGAG,143,2799866
ompRp1,0.2857142857142857,16,13,GAAATGTGAGCGTCACGGAA,3,2803383
ompRp1,8.571428571428571,132,13,CTTTAATTTTTGATAGTCAA,119,2804166
ompRp1,5.071428571428571,83,13,CTTGTAGATGTCTCCCTCCA,70,2784195
ompRp1,5.642857142857143,91,13,CTGGACGTTCGTCATTGCCT,78,2806143
ompRp1,2.9285714285714284,53,13,CTCGTGAAACAGGGGAACTG,40,2795126
ompRp1,1.2142857142857142,29,13,CTCGAGCGGATCTACGCATT,16,2814462
ompRp1,7.571428571428571,118,13,CTCAGTCTGAGCCGATGAGG,105,2785877
ompRp1,0.14285714285714285,14,13,CTACGAGCACACTAAATGGC,1,2790650
ompRp1,0.21428571428571427,15,13,CGTTACATCAAGTTACTACT,2,2807854
ompRp1,0.21428571428571427,15,13,CGTATGGATACCACGCTGCG,2,2814817
ompRp1,0.14285714285714285,14,13,CGGTAAATGAAGCTTCCTAT,1,2780536
ompRp1,0.14285714285714285,14,13,CGCCTACAGACCGAGTTGTT,1,2812993
ompRp1,13.428571428571429,200,13,CGCCGTCCATACTCAACGAT,187,2800668
ompRp1,0.14285714285714285,14,13,CGAGAGGTCGTTCACGGGGA,1,2780990
ompRp1,11.5,173,13,CGACGGGTTTTAGCCCGCGC,160,2772867
ompRp1,7.928571428571429,123,13,CGACAGTAAGTGTGATCAGG,110,2791191
ompRp1,0.8571428571428571,24,13,CCTTGACTGTACGTACTGAG,11,2788156
ompRp1,20.214285714285715,295,13,CCTGGAAGATCCTGTTCACT,282,2806901
ompRp1,0.14285714285714285,14,13,CCTATCGCGTTTTTTTACTT,1,2821478
ompRp1,0.14285714285714285,14,13,CCGTCTTATTGTCGGCTGCG,1,2819574
ompRp1,8.785714285714286,135,13,CCGGGCGTCGTGACTACAGA,122,2810181
ompRp1,0.14285714285714285,14,13,CCGGCCCCAGGTCTGAAGTC,1,2811960
ompRp1,3.5,61,13,CCCTCCGGACTGACTACATT,48,2797915
ompRp1,0.2857142857142857,16,13,CCAACAGCACCTAGCTACGA,3,2810475
ompRp1,3.9285714285714284,67,13,CAGCATGTGCTTCGGGTGGA,54,2776344
ompRp1,4.071428571428571,69,13,CACCTTTCCGCCCACTGAAG,56,2782462
ompRp1,0.2857142857142857,16,13,CAAGTGGGCACGCGGTGCGT,3,2815642
ompRp1,0.42857142857142855,18,13,CAAGTCCTTCACTGCAAACT,5,2768088
ompRp1,9.928571428571429,151,13,CAAGTAAAACTAGAAATCGA,138,2790449
ompRp1,0.14285714285714285,14,13,CAAACTTACCTACTCAGTGA,1,2793226
ompRp1,0.14285714285714285,14,13,ATGCAAAGCTACAGTACGCC,1,2772657
ompRp1,0.14285714285714285,14,13,ATCTGAGGATTACTAGCTTG,1,2774601
ompRp1,9.642857142857142,147,13,ATAGCAGTCCGACTTTCGTA,134,2766810
ompRp1,0.14285714285714285,14,13,AGTTTCGTCGAGACCACTGT,1,2805193
ompRp1,3.2142857142857144,57,13,AGTCAGGCCGCATGCGGCAG,44,2809958
ompRp1,0.14285714285714285,14,13,AGTACTTTGCCTTCGCATCA,1,2772055
ompRp1,0.14285714285714285,14,13,AGGTGGTAGGTTCTCGTGTT,1,2799165
ompRp1,0.14285714285714285,14,13,AGGGGGGATACATCCTTCTG,1,2821804
ompRp1,10.571428571428571,160,13,AGCGTCTCCATTCGCGGTAT,147,2800381
ompRp1,0.14285714285714285,14,13,AGCCGCATGTATTTTTCCTA,1,2814083
ompRp1,9.142857142857142,140,13,AGACCCATGGCACCTTGGGT,127,2789901
ompRp1,0.7142857142857143,22,13,AGAAAGGACGAGTTTCTCAT,9,2790441
ompRp1,0.14285714285714285,14,13,ACTGCGCGAATCACAGAGCG,1,2801876
ompRp1,0.14285714285714285,14,13,ACGTGCTGGAGAGAGTGTCA,1,2785694
ompRp1,5.714285714285714,92,13,ACGGGGATTCTCAAGTCAAA,79,2780682
ompRp1,11.571428571428571,174,13,ACCTCATGACTGTCGGGGTT,161,2781775
ompRp1,0.35714285714285715,17,13,ACCGGTCACCCGGGAAGTTG,4,2802713
ompRp1,0.14285714285714285,14,13,ACCATTAGGCATAAACATCG,1,2789386
ompRp1,0.6428571428571429,21,13,ACACTTAAGTTCAATGTTGT,8,2798003
ompRp1,0.21428571428571427,15,13,AAGAATAGTATGTGCGCGAG,2,2792499
ompRp1,0.14285714285714285,14,13,AAGAAGAAAGGGTTAAGGTA,1,2821811
ompRp1,0.14285714285714285,14,13,AACGGTCACAGGTTCTAGCA,1,2794963
ompRp1,0.14285714285714285,14,13,AACCTTTGCAGGTATAGGTT,1,2794803
ompRp1,20.571428571428573,300,13,AAAAGCTTGCATTATGTTTA,287,2799981
ompRp1,0.15384615384615385,13,12,TTTTACTGCTACGTAAGAGA,1,2771451
ompRp1,0.15384615384615385,13,12,TTTCTAGAAGTGCCGAAAAA,1,2765733
ompRp1,0.15384615384615385,13,12,TTTCCGGTCTGTTTTGTCAC,1,2779672
ompRp1,10.692307692307692,150,12,TTGGTTGCCGCGCCTCTGCA,138,2817019
ompRp1,8.076923076923077,116,12,TTCTGGACACATGCAAAACT,104,2769816
ompRp1,0.9230769230769231,23,12,TTAAAGCAGGTCCTGAAATG,11,2795657
ompRp1,0.15384615384615385,13,12,TGTTTAGGTCGTATGTGGAA,1,2798087
ompRp1,5.153846153846154,78,12,TGTGGGTGAGAAGATCGAAC,66,2795128
ompRp1,8.384615384615385,120,12,TGTCCTATCGCATGGGTCAT,108,2789434
ompRp1,2.076923076923077,38,12,TGTCACAATTAGCTTATTGT,26,2785657
ompRp1,0.38461538461538464,16,12,TGGCCAGTTTCAGGTCTTAA,4,2791939
ompRp1,0.46153846153846156,17,12,TGGACTTCAATCGGCTCTCG,5,2798088
ompRp1,6.461538461538462,95,12,TGCTCCTAGGTTTGATGAGG,83,2813419
ompRp1,0.15384615384615385,13,12,TGCAATGTCGTAGCCTGATT,1,2774443
ompRp1,0.23076923076923078,14,12,TGACTGGTCACCCGGGGTGA,2,2781265
ompRp1,11.076923076923077,155,12,TCTTTGAATGTAAACAGCAA,143,2813374
ompRp1,15.538461538461538,213,12,TCGTTTCATCGGCACGGGCG,201,2791991
ompRp1,6.769230769230769,99,12,TCGCGATTTGAGCAAGATCT,87,2814145
ompRp1,4.076923076923077,64,12,TCGACACGTGGTCTATCGCT,52,2787868
ompRp1,11.846153846153847,165,12,TCCCGTGCATTATGTTGATA,153,2807986
ompRp1,0.3076923076923077,15,12,TCCAATGAAAGTCAGGTCCT,3,2792145
ompRp1,0.15384615384615385,13,12,TCACGGCAGCTGCACGCGCA,1,2766382
ompRp1,0.15384615384615385,13,12,TATTTTGCATCCTTGTTTCG,1,2792004
ompRp1,2.6153846153846154,45,12,TACTTTCACTCTTAAGGCTC,33,2805169
ompRp1,1.0,24,12,TACGACGGGATCGAATGCAG,12,2797191
ompRp1,3.4615384615384617,56,12,TAAGGCCGAGGTCTGGTCTT,44,2818903
ompRp1,0.15384615384615385,13,12,TAAGCACAGGTTGCAGGTGG,1,2777102
ompRp1,1.4615384615384615,30,12,GTTTCCAGCTTTTTCGTCCC,18,2778190
ompRp1,13.461538461538462,186,12,GTTATTAGTTGAGACCGCGT,174,2816612
ompRp1,0.15384615384615385,13,12,GTGTGGACTCGGGTAGACGG,1,2800101
ompRp1,0.15384615384615385,13,12,GTGTAAGAGGGGCAACCCAG,1,2806212
ompRp1,8.307692307692308,119,12,GTGGGCAACAACTCTGCCCA,107,2815137
ompRp1,11.153846153846153,156,12,GTAGGCGGACACAGTCGAAT,144,2805738
ompRp1,3.3846153846153846,55,12,GTACTCCTATGGCCCGGGAA,43,2803382
ompRp1,11.0,154,12,GGTCGTCTAGAAACGTTTCC,142,2816214
ompRp1,0.23076923076923078,14,12,GGTAGAGCACAGTAGTCGGT,2,2765900
ompRp1,0.38461538461538464,16,12,GGTAAGCCCATCGGTCTGTA,4,2790727
ompRp1,17.307692307692307,236,12,GGTAAACTATCCACAGTGTT,224,2781287
ompRp1,10.23076923076923,144,12,GGGGATACAAACCTAATCGG,132,2783308
ompRp1,0.15384615384615385,13,12,GGCGCGACAAGGTCATGAGG,1,2785137
ompRp1,6.6923076923076925,98,12,GGCAGGCTAGAATATGCCAA,86,2822634
ompRp1,1.0,24,12,GCTTAATCGGATATGGTCTG,12,2809847
ompRp1,0.15384615384615385,13,12,GCGGGTGTAGACCAACACTA,1,2808309
ompRp1,3.230769230769231,53,12,GCGGGAGTCCTACATGGGAA,41,2770250
ompRp1,0.15384615384615385,13,12,GCGCAACTCTGGACGTTTGC,1,2797746
ompRp1,0.15384615384615385,13,12,GCGAGCAGTGAACTCGTAAC,1,2795886
ompRp1,0.23076923076923078,14,12,GCCGGTGTGCTAACATAACG,2,2794863
ompRp1,5.769230769230769,86,12,GCCGGAGACAGAGCGAGAAA,74,2798571
ompRp1,9.076923076923077,129,12,GCATCCCTTGAGGTTATTAG,117,2773709
ompRp1,23.46153846153846,316,12,GATATCGCGTGCTCAGTATG,304,2771552
ompRp1,10.153846153846153,143,12,CTTTCAGCATAGGGTTCATA,131,2793300
ompRp1,0.15384615384615385,13,12,CTTTAGGTTGACCGGACGAC,1,2783733
ompRp1,0.3076923076923077,15,12,CTTCTATTGAACTGGCCCCA,3,2820311
ompRp1,0.15384615384615385,13,12,CTGTGGTACAATACATCGGA,1,2784623
ompRp1,0.23076923076923078,14,12,CTGATGCATCGATGGTCGGG,2,2799843
ompRp1,3.923076923076923,62,12,CTCATACATACTACGTTTAG,50,2787802
ompRp1,0.38461538461538464,16,12,CTCACTTTGTCACGGTCAGA,4,2766401
ompRp1,9.0,128,12,CTACTACATTGTACATCGAT,116,2790425
ompRp1,1.3846153846153846,29,12,CTAAAAGTAGACCTGGCCTT,17,2806547
ompRp1,0.15384615384615385,13,12,CGTTCGGGGTTCAGTTTCAT,1,2792861
ompRp1,12.538461538461538,174,12,CGTAGGGATTTACACACGCA,162,2772288
ompRp1,0.15384615384615385,13,12,CGCTCAGATCCCATATCTAC,1,2795177
ompRp1,8.692307692307692,124,12,CGCGAGTCTATTCGGCCTTG,112,2788705
ompRp1,3.076923076923077,51,12,CGCCAATCTCCCGGAGCAGT,39,2781356
ompRp1,4.6923076923076925,72,12,CGACTAAACGGTACAGGGAA,60,2791738
ompRp1,8.846153846153847,126,12,CCGTGGACTCAACGTAGTAG,114,2791008
ompRp1,11.76923076923077,164,12,CCGATAAGGTGACTAATCTA,152,2786351
ompRp1,7.461538461538462,108,12,CCACGCCCTGCCTCCACTTA,96,2792612
ompRp1,14.538461538461538,200,12,CATTGGACAGCTCCGAGAGA,188,2793312
ompRp1,0.15384615384615385,13,12,CATTGAAGTACATAGTCCCG,1,2818629
ompRp1,0.15384615384615385,13,12,CATGTTCGGAGGTTTTAGGG,1,2776562
ompRp1,7.923076923076923,114,12,CAGTGGTCAACGAGCAACTG,102,2803609
ompRp1,0.15384615384615385,13,12,CAGAGCTGCTAGCATCAGCC,1,2804939
ompRp1,0.15384615384615385,13,12,ATTTTTACTAAGACCTTTAG,1,2789251
ompRp1,4.230769230769231,66,12,ATTCGGTTGGTGGGACCCGA,54,2791287
ompRp1,9.461538461538462,134,12,ATGGATGGCTAGAGTACAAA,122,2784804
ompRp1,4.076923076923077,64,12,ATGCCAGTACGGTTCTCGGA,52,2770100
ompRp1,4.384615384615385,68,12,ATGAGATCAATCCGATACCA,56,2768357
ompRp1,18.76923076923077,255,12,ATCGTCAGTTCGTGTAACTG,243,2792148
ompRp1,11.076923076923077,155,12,ATCCGGTAGATTATTGTCCT,143,2798203
ompRp1,0.23076923076923078,14,12,ATACTGCACTAATACTCGAA,2,2800851
ompRp1,8.153846153846153,117,12,ATAAATGCATTGAGTAGGCT,105,2810887
ompRp1,0.15384615384615385,13,12,AGTTCGTCGTGCCTGATTTG,1,2770738
ompRp1,6.076923076923077,90,12,AGGTATTCGTGCGGCACGGT,78,2819170
ompRp1,0.15384615384615385,13,12,AGCTCACGCCGTTAGATTTC,1,2804450
ompRp1,2.769230769230769,47,12,AGCGTCTGTGGTTTTAACGT,35,2766773
ompRp1,2.769230769230769,47,12,ACTTCTGGCAGGCCAGTCGG,35,2779519
ompRp1,1.0769230769230769,25,12,ACTGGCGTTAATGCGAGTAC,13,2800343
ompRp1,0.9230769230769231,23,12,ACTCGTTAGGGACCATAGCA,11,2808073
ompRp1,11.23076923076923,157,12,ACTAGCAAATGTTCGAACGG,145,2791770
ompRp1,8.23076923076923,118,12,ACTAACTGACGCCCAGGTCT,106,2791882
ompRp1,7.076923076923077,103,12,ACGGGTTACGGCGTGCGAGA,91,2816196
ompRp1,11.692307692307692,163,12,ACGCAGGCTCAGCCGTGCTT,151,2813311
ompRp1,0.23076923076923078,14,12,ACCGGTGCTAATTTACAAGC,2,2822800
ompRp1,10.307692307692308,145,12,ACACAATCGATGCAGCAAGG,133,2789880
ompRp1,16.153846153846153,221,12,AAGCGGCTGGAGCGTCCCGG,209,2790435
ompRp1,0.15384615384615385,13,12,AAGCCCGCGGACCCCTAGCT,1,2817000
ompRp1,1.2307692307692308,27,12,AAATCGGGGACTTAGTCATT,15,2796149
ompRp1,1.3846153846153846,29,12,AAAGGGTGGTAATCGCGACA,17,2770905
ompRp1,0.15384615384615385,13,12,AAAGGGGCCACGATTGTTTT,1,2806434
ompRp1,14.692307692307692,202,12,AAAGATCGTGGATTTGATGA,190,2811822
ompRp1,5.384615384615385,81,12,AAACTTGTAACATACCAATC,69,2817715
ompRp1,5.25,73,11,TTTAGTATTTAAACCTCTTT,62,2769617
ompRp1,1.1666666666666667,24,11,TTTAGGATGGTGTCCAAATT,13,2804273
ompRp1,1.4166666666666667,27,11,TTGTAATACCGTTCCGTGCT,16,2818098
ompRp1,4.083333333333333,59,11,TTGGCCTGGTGAGACCCGTG,48,2818595
ompRp1,0.5,16,11,TTCGGACAATATGATCACCT,5,2768966
ompRp1,0.16666666666666666,12,11,TTATAGAGAGGCAGTGTATC,1,2777982
ompRp1,8.833333333333334,116,11,TTAGGGTCACGCCTCGGGTA,105,2823966
ompRp1,11.833333333333334,152,11,TTAATCTTACTGCTACCTTC,141,2787555
ompRp1,10.083333333333334,131,11,TGCTCGGAATCAAGTACTTA,120,2782453
ompRp1,4.166666666666667,60,11,TGCCCTTTGCTAGCACCACA,49,2796438
ompRp1,0.6666666666666666,18,11,TGCATTCGTACGTCTCCGAA,7,2789555
ompRp1,0.3333333333333333,14,11,TGAATAAATATCTTTAGTAA,3,2811615
ompRp1,0.25,13,11,TGAACTGCATTCTGTAGCCT,2,2777861
ompRp1,4.0,58,11,TCTCCCTTTTCTGGCTGCCT,47,2795176
ompRp1,8.166666666666666,108,11,TCTATGGAGTTGAACCGTCT,97,2799178
ompRp1,0.16666666666666666,12,11,TCGGATCGAAAAGTTGGGGA,1,2778111
ompRp1,7.25,97,11,TCGACGAAAGTTGGTGGTCG,86,2806030
ompRp1,1.25,25,11,TCCTGCCCGGTGGTTAGTTA,14,2785280
ompRp1,4.083333333333333,59,11,TCCGTTCATACAGGGTCATG,48,2796046
ompRp1,11.916666666666666,153,11,TATCGCTTGGACGGTCATGG,142,2804512
ompRp1,0.16666666666666666,12,11,TATAATGGACGCGGCACTCT,1,2780645
ompRp1,1.5833333333333333,29,11,TAGGTAATCAAGTATGAGAG,18,2766975
ompRp1,1.6666666666666667,30,11,TACTTTCCGGTACCTAGGCT,19,2771293
ompRp1,0.16666666666666666,12,11,TACCGCTACCAAGACTCAAC,1,2816836
ompRp1,21.75,271,11,TACCCGTCGCTCAAATTTAT,260,2775882
ompRp1,0.16666666666666666,12,11,TAACAACCTGACAAACAACT,1,2782144
ompRp1,16.166666666666668,204,11,GTTGTAAGGGTGGAGTAGCT,193,2771413
ompRp1,0.16666666666666666,12,11,GTTAAAGTATGAGGGGCGTA,1,2808070
ompRp1,23.166666666666668,288,11,GTCCTGTTGCAGGATGACCA,277,2786383
ompRp1,8.416666666666666,111,11,GTCCGCTCGCAGGGTAAGAT,100,2784019
ompRp1,0.25,13,11,GTCATGAATAACTGGAAGAG,2,2824306
ompRp1,3.75,55,11,GTATGGGTTGACGGCGCATC,44,2817188
ompRp1,0.16666666666666666,12,11,GTACTGATAAAGGTTGGCTA,1,2776588
ompRp1,4.416666666666667,63,11,GTAACCGTCGTCCGAGCCAA,52,2778851
ompRp1,6.0,82,11,GGTTGTCCGGGGGTATCATA,71,2815152
ompRp1,2.9166666666666665,45,11,GGTAGGGATAGCCAGAGAGT,34,2776776
ompRp1,0.16666666666666666,12,11,GGGGTCGGGGGCCGAGCTGC,1,2817399
ompRp1,2.6666666666666665,42,11,GGGCGGTTAGGTAACTTAAC,31,2821031
ompRp1,9.416666666666666,123,11,GGCTGATAGGTAGTATTGAC,112,2768687
ompRp1,24.916666666666668,309,11,GGCGCTAATGGCGCTTAATA,298,2807683
ompRp1,7.833333333333333,104,11,GGAGCTACTAAGTGTCGCCC,93,2780729
ompRp1,2.8333333333333335,44,11,GCTTTACCTGTTATAACCTG,33,2800211
ompRp1,14.666666666666666,186,11,GCTCCGGCACGTGGAGCTGA,175,2820728
ompRp1,12.083333333333334,155,11,GCGGCTAATGATTTGAAACG,144,2819679
ompRp1,7.25,97,11,GCCGTGACAATAAGCGTAAA,86,2823002
ompRp1,12.5,160,11,GCCGAGCTCGGGCGAACTCT,149,2786755
ompRp1,0.25,13,11,GCCCTCGTAAACGTGCGAAT,2,2791649
ompRp1,12.916666666666666,165,11,GCCCTAGTTCCATGACTAAA,154,2776606
ompRp1,0.25,13,11,GCCACATGTCCTGGAGCAAG,2,2775927
ompRp1,14.583333333333334,185,11,GCAGTCTTAGCATAGGGTTG,174,2796907
ompRp1,38.166666666666664,468,11,GCAGCAGGTAAGATGTTTTC,457,2791767
ompRp1,10.75,139,11,GATGGTGCATTCGGCAGTCT,128,2790883
ompRp1,0.16666666666666666,12,11,GAGGGCTACTTTTTCGGTGT,1,2814028
ompRp1,8.333333333333334,110,11,GACGAATATTGGTAAATCAA,99,2770954
ompRp1,1.0,22,11,GAATGAGTCATAGGCGCGGG,11,2813882
ompRp1,0.25,13,11,GAATCAATCCCGGTAGCTGT,2,2767963
ompRp1,10.083333333333334,131,11,CTTGCCCCGGCGGTTAGTGC,120,2790033
ompRp1,0.16666666666666666,12,11,CTTCAGGTGGTTCGGAATGT,1,2806579
ompRp1,0.16666666666666666,12,11,CTGTCTTTTTTAAGGCCGGG,1,2808425
ompRp1,0.25,13,11,CTGTCCTGTTGCATGAGTCC,2,2780608
ompRp1,2.3333333333333335,38,11,CTGACGTCAAGATCGTCGAT,27,2796033
ompRp1,0.16666666666666666,12,11,CGTTCGGTTATAGGTGGAGA,1,2793581
ompRp1,0.16666666666666666,12,11,CGTTAGCGGTCGTTTGCCCC,1,2813145
ompRp1,1.4166666666666667,27,11,CGGTTGACGTCTAGCCGAAA,16,2768101
ompRp1,4.416666666666667,63,11,CGCTGGACGACGAGGTGTAG,52,2773974
ompRp1,1.6666666666666667,30,11,CGCCCTGTGCTATAGGTTTT,19,2809160
ompRp1,20.5,256,11,CGCAATTTGTCTATATATCT,245,2810018
ompRp1,0.25,13,11,CGATGCACCTATAACTTTCT,2,2802873
ompRp1,6.75,91,11,CGAGGACTCACTGGGGCGTA,80,2796868
ompRp1,0.16666666666666666,12,11,CGACCTAGGCGTTAAGTAGC,1,2788479
ompRp1,0.16666666666666666,12,11,CGACATATGTATCATCAAAT,1,2803499
ompRp1,9.5,124,11,CCTTTACACTCTCCTGAGCT,113,2780396
ompRp1,0.25,13,11,CCTCGAACGGGGTTGCCACA,2,2769925
ompRp1,0.16666666666666666,12,11,CCGTAATAGTGGATTCCCCA,1,2791512
ompRp1,5.5,76,11,CCGGTGAGGGCAGATGCAAG,65,2806502
ompRp1,7.0,94,11,CCGAGCACCCAGAGGTCTTG,83,2766860
ompRp1,2.5833333333333335,41,11,CCGACTTGAATGTGCGGGAG,30,2775293
ompRp1,1.25,25,11,CCCGCCCCTCAATGTGCCCA,14,2795271
ompRp1,0.16666666666666666,12,11,CCCCGCTCCTACTAGGTGCG,1,2769517
ompRp1,10.75,139,11,CCACATCTCAAATAATGGAG,128,2789663
ompRp1,11.833333333333334,152,11,CATTCGTCAATCAAGGCTAT,141,2767784
ompRp1,2.75,43,11,CATCTCCAGAGAGCATCGAA,32,2807162
ompRp1,1.25,25,11,CATCCGATTGAATTCCTGCT,14,2804331
ompRp1,0.5,16,11,CATATAACATTTTATCTGCT,5,2798679
ompRp1,17.916666666666668,225,11,CAGGTCTCCAGTGTACCGTG,214,2781299
ompRp1,0.16666666666666666,12,11,CAGGCTGCTCGATAGTCATG,1,2776800
ompRp1,0.25,13,11,CAATACCGACCCGGACCGAT,2,2799217
ompRp1,0.16666666666666666,12,11,ATTTTGGGGATATACGTTTA,1,2798683
ompRp1,0.16666666666666666,12,11,ATTGTCATTGATATGGATAA,1,2808521
ompRp1,17.083333333333332,215,11,ATTCGCATCGAGTATTGGCT,204,2806146
ompRp1,1.0833333333333333,23,11,ATGACATTATAGGTCATAAA,12,2770182
ompRp1,0.16666666666666666,12,11,ATCTATGCGTGTCTACCACC,1,2779981
ompRp1,0.16666666666666666,12,11,ATCGGTCAAACGTTCTCTGG,1,2801804
ompRp1,5.25,73,11,ATATTGGCAGAGCTCCGGTG,62,2784944
ompRp1,0.16666666666666666,12,11,ATAGTGAGTGGGAGTCAGAG,1,2771967
ompRp1,0.16666666666666666,12,11,ATAGAAACCATCCTATGCGG,1,2776101
ompRp1,13.416666666666666,171,11,ATACGATCAAACGCACCTTC,160,2769698
ompRp1,0.16666666666666666,12,11,ATAATCACTTGCACGGCAGT,1,2823051
ompRp1,1.0,22,11,AGTGTCTCGGCGCCCAATCT,11,2768422
ompRp1,17.083333333333332,215,11,AGTAGCCTGGACAACACATA,204,2823325
ompRp1,1.25,25,11,AGGCACCAGCACTTACAGAC,14,2808685
ompRp1,5.333333333333333,74,11,AGGACCTGAGTCAACGGGTA,63,2783239
ompRp1,10.75,139,11,AGCCTGGGCCTGCGGTATTG,128,2768752
ompRp1,7.833333333333333,104,11,AGCCGCCAGATCCGCATCTT,93,2813345
ompRp1,0.4166666666666667,15,11,AGATCATCTCTTAGTCGAGT,4,2804547
ompRp1,19.916666666666668,249,11,AGACGCATGATACCATGGAA,238,2808768
ompRp1,0.25,13,11,AGAACGGGATGCTCCTGGCT,2,2814966
ompRp1,0.16666666666666666,12,11,AGAAAAACCGGATAACCCAT,1,2820649
ompRp1,2.0833333333333335,35,11,ACTTACCCGAATCGGGGAAT,24,2791938
ompRp1,4.333333333333333,62,11,ACTCAAGCTAATACATAAGG,51,2821753
ompRp1,0.5833333333333334,17,11,ACTATCATAGGTGTAGGGGT,6,2813552
ompRp1,0.25,13,11,ACCTGCCACATTACGGTCTC,2,2766623
ompRp1,9.5,124,11,ACAAGGAGATATCAGAAGAA,113,2778192
ompRp1,11.75,151,11,AATCGGGAGTAAGCCCGTTC,140,2816442
ompRp1,11.916666666666666,153,11,AATCCGGGCAGGTGATCATA,142,2816784
ompRp1,3.6666666666666665,54,11,AAGTAGCAGTTCACCAATTA,43,2800880
ompRp1,8.916666666666666,117,11,AAGGCCGGCACAGGTCGATC,106,2811998
ompRp1,0.16666666666666666,12,11,AACGTCACAACTGGCGGGCG,1,2767273
ompRp1,0.3333333333333333,14,11,AACCTGCTCCGACCCTTTCG,3,2772113
ompRp1,15.75,199,11,AACAAAAGGCATCTCATACG,188,2807461
ompRp1,0.25,13,11,AAACAAGTAGTATCGGTCAC,2,2802527
ompRp1,0.3333333333333333,14,11,AAAATCCTAACATATGCTCT,3,2785840
ompRp1,13.583333333333334,173,11,AAAAATGTCCCAGGACTACC,162,2817217
ompRp1,0.16666666666666666,12,11,AAAAATGTCCAAGCACTTTT,1,2819972
ompRp1,7.545454545454546,92,10,TTTTTTTCCGCCACAAACTC,82,2794150
ompRp1,16.363636363636363,189,10,TTTGCTAACGAACAATAAGG,179,2810873
ompRp1,0.36363636363636365,13,10,TTTCCAGCAGAACGTACCAT,3,2812598
ompRp1,0.18181818181818182,11,10,TTGTTGTATTCTCGTCTGTA,1,2797964
ompRp1,2.272727272727273,34,10,TTGTTACCAGGTCCCGCAAG,24,2814152
ompRp1,0.18181818181818182,11,10,TTGGCCGGCTATCCCCATCT,1,2795877
ompRp1,2.3636363636363638,35,10,TTACTGACAGCTTGCGGTAA,25,2797280
ompRp1,0.2727272727272727,12,10,TGTTAACTCGTACACTCACC,2,2807781
ompRp1,0.18181818181818182,11,10,TGTCAAAGTATCTGCAGCCC,1,2769944
ompRp1,5.0,64,10,TGGGAGTCACACCGGGTGAG,54,2787881
ompRp1,7.2727272727272725,89,10,TGAGTCTTTAGAGACGATGT,79,2819655
ompRp1,0.2727272727272727,12,10,TGACGTGCTCACATAGGGGA,2,2818172
ompRp1,10.545454545454545,125,10,TGAAGACGCGTCATGATGTA,115,2807456
ompRp1,3.909090909090909,52,10,TCTCTTGCAGATCCAGGTTT,42,2810567
ompRp1,2.4545454545454546,36,10,TCTCATTGCGTTGGCGGCTT,26,2775866
ompRp1,0.18181818181818182,11,10,TCGGTACTTGAGGACAGCTC,1,2815351
ompRp1,9.181818181818182,110,10,TCGCCAGGGATGCTTATCAC,100,2824665
ompRp1,3.0,42,10,TATTCATGAAGGCTCCCACG,32,2774658
ompRp1,13.363636363636363,156,10,TATGTAATGCCCGTCTGCGA,146,2778358
ompRp1,11.181818181818182,132,10,TATGCTAGTGTTGTGGATGG,122,2766624
ompRp1,10.363636363636363,123,10,TATGCATAGAAGCTGCGAGG,113,2800380
ompRp1,0.18181818181818182,11,10,TAAGGTTAACTCTATCCATC,1,2766660
ompRp1,0.7272727272727273,17,10,TAAGGCGCAGGCTCGAGAGT,7,2818693
ompRp1,12.636363636363637,148,10,GTGGCAGGACAGTGCTTTTC,138,2777130
ompRp1,5.0,64,10,GTGCAAGTCAGTCTCTCCGT,54,2785173
ompRp1,0.18181818181818182,11,10,GTCTCTGTACGCAAATAAAG,1,2768085
ompRp1,2.3636363636363638,35,10,GTCGCCCGGGGTGAGCTCCA,25,2780614
ompRp1,0.18181818181818182,11,10,GTCCTCAAGTCAGCACGAAA,1,2805787
ompRp1,0.18181818181818182,11,10,GTCCTACGGGCCATCGGCCA,1,2803652
ompRp1,13.181818181818182,154,10,GTCATTCGGGCTGTCACCAC,144,2783383
ompRp1,3.909090909090909,52,10,GTATGGAGGCGCGTAATTTT,42,2813496
ompRp1,4.454545454545454,58,10,GTAGTTTCGCATTTGGAACA,48,2819997
ompRp1,2.3636363636363638,35,10,GGTTTCGTAATTGCAGCACG,25,2790754
ompRp1,5.636363636363637,71,10,GGTGGGATTGAACGCAGCTT,61,2802207
ompRp1,0.18181818181818182,11,10,GGTGACCTGGCCCCAACTCA,1,2766917
ompRp1,3.090909090909091,43,10,GGTAACATTCTTTGGCTGAT,33,2816479
ompRp1,0.45454545454545453,14,10,GGGGCGACCTTTTATCGTCT,4,2794264
ompRp1,14.272727272727273,166,10,GGGGCCTACGTGGGATGAGA,156,2811013
ompRp1,11.090909090909092,131,10,GGCCATTGACCAGTTCTACT,121,2806975
ompRp1,5.363636363636363,68,10,GGCCACTAATAGAGTGATTT,58,2805625
ompRp1,0.18181818181818182,11,10,GGACACCGCCCAAGACGTAG,1,2802790
ompRp1,2.5454545454545454,37,10,GCTTCCCGGATGCGCTCGCC,27,2821319
ompRp1,16.454545454545453,190,10,GCTGCCGTTGCGGCGTAGGT,180,2810888
ompRp1,11.272727272727273,133,10,GCGTAGGAAAAATGACTGCA,123,2805380
ompRp1,0.7272727272727273,17,10,GCGGTATAGTCCTGGTAATA,7,2823194
ompRp1,6.0,75,10,GCGATAGTGAAGCTCCCGGC,65,2767538
ompRp1,0.18181818181818182,11,10,GCCTGTAGCCAAGGTCACAG,1,2785076
ompRp1,9.454545454545455,113,10,GCCGTAGAGGACATTTTGAC,103,2802515
ompRp1,0.18181818181818182,11,10,GCCGTACAACAAGCCAAAGT,1,2795879
ompRp1,7.7272727272727275,94,10,GCACGCTTCACCGATCACCT,84,2780615
ompRp1,0.18181818181818182,11,10,GCAAGCTTACGGTTGCGGGA,1,2802561
ompRp1,5.909090909090909,74,10,GAGTTTGGAACGTCCCTCCC,64,2768356
ompRp1,4.090909090909091,54,10,GAGTACACTTCGCTGCTGCA,44,2765914
ompRp1,0.18181818181818182,11,10,GACTACCTTGTTAATATCAA,1,2791453
ompRp1,13.454545454545455,157,10,GAATGTTGCATGGATTAGTC,147,2808973
ompRp1,0.18181818181818182,11,10,CTTGTGGTGTGGCCAGACGG,1,2766214
ompRp1,0.2727272727272727,12,10,CTGTTCAAGCTGCGGGGAAG,2,2816171
ompRp1,0.18181818181818182,11,10,CTCGTTCGGGCGGAATACTA,1,2781949
ompRp1,1.0,20,10,CTCGATTTGTGACATGTGAG,10,2780041
ompRp1,2.4545454545454546,36,10,CTAGGTCACGGTATGCCGCA,26,2798982
ompRp1,7.7272727272727275,94,10,CGTTTCTAGCCAGATCTAGC,84,2791837
ompRp1,2.3636363636363638,35,10,CGTTGTCAGATTACCGCCCT,25,2808013
ompRp1,0.18181818181818182,11,10,CGTCAAAGGAGGTCGTCTGG,1,2790032
ompRp1,1.0,20,10,CGGTTATTCAATGACATCCT,10,2772499
ompRp1,1.0,20,10,CGGTAGCAAGTGACTTGATC,10,2775550
ompRp1,79.72727272727273,886,10,CGGAAAAGTGAGACGCACTA,876,2774444
ompRp1,2.4545454545454546,36,10,CGATCGGGCCTCGTCGCCCT,26,2790725
ompRp1,8.818181818181818,106,10,CCTTACCCTTTGCCAGGTTC,96,2775872
ompRp1,2.3636363636363638,35,10,CCTAGCCCGAAGAAAATCCC,25,2821791
ompRp1,2.4545454545454546,36,10,CCGCGACTGTCATTCTTTCA,26,2789398
ompRp1,16.636363636363637,192,10,CCGATTTAGCTGCTGAAGAC,182,2772052
ompRp1,0.45454545454545453,14,10,CCCTGTGTAAATATTCATGC,4,2783395
ompRp1,4.181818181818182,55,10,CCCGCGTTGGTCACCCAGCT,45,2774082
ompRp1,1.4545454545454546,25,10,CCCCTGTTGGGCCTTACGGA,15,2823704
ompRp1,11.818181818181818,139,10,CCAGAAATTTCGAGAAATGT,129,2792777
ompRp1,0.18181818181818182,11,10,CCACGGTCCTACAGCACTGA,1,2779857
ompRp1,0.18181818181818182,11,10,CCACCGCAAAGAGAGCATGC,1,2766087
ompRp1,17.454545454545453,201,10,CCAAAAATTACAGTCCGGCA,191,2817579
ompRp1,13.181818181818182,154,10,CATTGGCGTCCTCGCGCGTA,144,2803738
ompRp1,0.18181818181818182,11,10,CATCATTGTGTCACCCCTTT,1,2786421
ompRp1,17.818181818181817,205,10,CATAATAACGTGTTAGGGGA,195,2790293
ompRp1,3.4545454545454546,47,10,CAGGGGAAAATAGTTAGACA,37,2781370
ompRp1,5.7272727272727275,72,10,CAGGCCTGAAGCCCCTCCAA,62,2804971
ompRp1,2.6363636363636362,38,10,CAGCCGATTGCCATTCCGCA,28,2820057
ompRp1,0.18181818181818182,11,10,CAGACACGGCGAAGATTCGG,1,2779620
ompRp1,1.9090909090909092,30,10,CAAGACCTCTGCAATGGTCA,20,2767498
ompRp1,0.18181818181818182,11,10,CAAACGCACCTCCAGTCCAA,1,2814161
ompRp1,13.181818181818182,154,10,ATGGTAATATGGAGCGTCGT,144,2798386
ompRp1,16.727272727272727,193,10,ATGCAGTTTTCGAACTCACG,183,2822695
ompRp1,29.454545454545453,333,10,ATCCAATATAAGTGTAGTTG,323,2777851
ompRp1,0.18181818181818182,11,10,ATCAGGGTCGGGTCAGAGTC,1,2774458
ompRp1,20.0,229,10,ATCAACTACTTGTCTGAAAT,219,2767244
ompRp1,0.18181818181818182,11,10,AGTTTATATTCCTACAAAGG,1,2797779
ompRp1,0.36363636363636365,13,10,AGTGAAAGGTTAAAGTTAAA,3,2805199
ompRp1,8.636363636363637,104,10,AGGGACCAGAGAGTATCTGC,94,2803319
ompRp1,9.727272727272727,116,10,AGGAGACACTCCAGCAGGGG,106,2809280
ompRp1,5.636363636363637,71,10,AGCTAGGTTCATCTTCCCTC,61,2801005
ompRp1,17.09090909090909,197,10,AGCCAAGTACGCTGCATCCT,187,2817510
ompRp1,0.6363636363636364,16,10,ACTTTAGTGGTCAGCGCTAA,6,2795481
ompRp1,0.18181818181818182,11,10,ACTTCAGCATGATAACCTTG,1,2766633
ompRp1,0.18181818181818182,11,10,ACTACGTCAGAGGTTCGGCG,1,2780102
ompRp1,10.272727272727273,122,10,ACGGAGAGACCTGGTTCTAT,112,2794434
ompRp1,0.45454545454545453,14,10,ACGACGCGGTTGGGAGCCCC,4,2765464
ompRp1,32.45454545454545,366,10,ACCCGAGTCGCACAGCACAC,356,2804633
ompRp1,14.363636363636363,167,10,ACAGTAGAAGATCTTTCGGC,157,2803989
ompRp1,13.545454545454545,158,10,ACAGTACACCAACCGCAACC,148,2783444
ompRp1,10.0,119,10,ACAGACTCTGTACAGCCGAC,109,2823470
ompRp1,3.727272727272727,50,10,AAGGGAGAATCGTGAACCAT,40,2780531
ompRp1,0.18181818181818182,11,10,AAGATGGCGTCGCAAAAAGA,1,2774465
ompRp1,0.18181818181818182,11,10,AACTCTAGTTCACCCCAATA,1,2768081
ompRp1,0.18181818181818182,11,10,AACCAAGCTGATTCGTGTAA,1,2773705
ompRp1,1.0909090909090908,21,10,AACACTTTGTCTGGGACTTA,11,2768701
ompRp1,1.0909090909090908,21,10,AAATCAGCCTTGCAGGAGTC,11,2807021
ompRp1,3.4545454545454546,47,10,AAATACCGAAAATAGAACGC,37,2766436
ompRp1,6.5,73,9,TTTTCGACCTTAGCGGTCCC,64,2803395
ompRp1,17.7,185,9,TTTGTTGTCTTTCGGGCCAA,176,2823976
ompRp1,10.3,111,9,TTTCCTGTAAGATCGGCATT,102,2784567
ompRp1,3.2,40,9,TTGTGCCCTATTTTGAACGA,31,2801633
ompRp1,0.6,14,9,TTGTCCCCCAGACCCCGTGT,5,2790027
ompRp1,4.2,50,9,TTCTTCTAAACGTTATCTCC,41,2817273
ompRp1,12.8,136,9,TTCTACTCACCGTAATACTG,127,2781051
ompRp1,2.2,30,9,TTCGGTCGGCTAGGTAATGA,21,2782739
ompRp1,0.7,15,9,TTCCGGAATGAAACGCAATT,6,2772458
ompRp1,0.2,10,9,TTATTGGTCCAACCGGGCGC,1,2775868
ompRp1,19.7,205,9,TGCATAAGATTCCGTGTTGC,196,2792872
ompRp1,0.2,10,9,TGCAACCACCCCAGCGTCCT,1,2778016
ompRp1,0.2,10,9,TGATCTTGGGAATCGGGTGT,1,2805273
ompRp1,9.3,101,9,TGACTCGTGTTTCGAGTATT,92,2780196
ompRp1,0.2,10,9,TGACAGAGTATACCAGTGAA,1,2793751
ompRp1,0.3,11,9,TGAATGGAGGCCCGAGTAAA,2,2812817
ompRp1,0.3,11,9,TCTCTATCCGGTGGTTCCTG,2,2799064
ompRp1,2.1,29,9,TCTCCGATTTGGATAGATTT,20,2775088
ompRp1,0.2,10,9,TCGTACCGCAACCCGGACTT,1,2775215
ompRp1,0.3,11,9,TCGGCTCCCGGACGAGGATA,2,2811128
ompRp1,0.4,12,9,TCCCTGACCATTTCTGCGCA,3,2787380
ompRp1,0.8,16,9,TCCCACGGGACCGTAGCTTC,7,2776741
ompRp1,1.1,19,9,TCATTTGCTGGGAGGGATAT,10,2769273
ompRp1,2.6,34,9,TCAGGGGCGAGATCCAGCAA,25,2786861
ompRp1,5.6,64,9,TCAGGACGTGATCCGAATGT,55,2821273
ompRp1,4.2,50,9,TCAGACTGACAATCTATACT,41,2812744
ompRp1,4.9,57,9,TATTAAATTAACCTGATTTA,48,2776799
ompRp1,24.8,256,9,TATCGGGCTTGTTTTACTAT,247,2790456
ompRp1,0.2,10,9,TATCGGATACATTCAAGGCC,1,2768991
ompRp1,4.6,54,9,TATCCTTCATTGATTTAGAA,45,2786670
ompRp1,0.2,10,9,TATCACTGGGTAGCACCATT,1,2809030
ompRp1,3.3,41,9,TAGGAGTCAAGGTCCGCCGA,32,2818725
ompRp1,0.4,12,9,TACTGCGTCGACAGAGTCAT,3,2797490
ompRp1,7.6,84,9,TACGTTGACTTGATGTTTAA,75,2811020
ompRp1,0.2,10,9,TAAGGGACCGCTGTGGCTCG,1,2792195
ompRp1,11.0,118,9,GTTCTGGTTCGAGGAACAGG,109,2801603
ompRp1,11.2,120,9,GTTAGTTGCAAGCGCGAAAA,111,2809341
ompRp1,13.1,139,9,GTGTGCCTTATGGTGAGCCT,130,2814282
ompRp1,2.4,32,9,GTGGACGCGGGGCACCAAAC,23,2808259
ompRp1,0.3,11,9,GTGATAGTTCTATCTACTCT,2,2772736
ompRp1,0.2,10,9,GTCGGATCATGCAAAACAAT,1,2804389
ompRp1,9.2,100,9,GTCCTAACGACCCGTTCAGG,91,2788423
ompRp1,0.2,10,9,GTCAAGGTATAAGTTATCGT,1,2784009
ompRp1,3.5,43,9,GTCAAACTGTCTGGTCCATT,34,2802123
ompRp1,0.3,11,9,GTATATGGAACTGGTCCCAA,2,2779316
ompRp1,4.8,56,9,GTAGTGAAGGCATTTAGGGT,47,2781422
ompRp1,0.3,11,9,GTAGTATCTCGTGCTAGCTC,2,2816610
ompRp1,16.6,174,9,GTAATCCGGGTCAGTATTGC,165,2785830
ompRp1,23.1,239,9,GGTATGAGTCAGAGCTCACA,230,2772868
ompRp1,31.9,327,9,GGTAGCCCTCGATGCGTGAC,318,2818528
ompRp1,0.2,10,9,GGGGTCACGTGACTGTCTTA,1,2798126
ompRp1,3.4,42,9,GGGAAAACGGGTGGCCCTGA,33,2816933
ompRp1,0.2,10,9,GGCTTCACTTACTACCCGAG,1,2785460
ompRp1,0.4,12,9,GGCGTATGAAGACAGACTAG,3,2820198
ompRp1,0.3,11,9,GGCGGAACGGTGCGGGTAAA,2,2781830
ompRp1,9.7,105,9,GGCATTTAGCGCTAACCCAC,96,2773174
ompRp1,0.3,11,9,GGCAAGGGCACTTTCACTAT,2,2768424
ompRp1,0.2,10,9,GCTTCAGTGCCTTAATCTTC,1,2794669
ompRp1,0.3,11,9,GCTCAACCGCTTGGTTTTTT,2,2802315
ompRp1,12.5,133,9,GCTAGCCACTACAGGATTAG,124,2791740
ompRp1,1.9,27,9,GCGCGTCAAGTGGCGTGACT,18,2811645
ompRp1,0.2,10,9,GCGAGTTAGGTTTTAGACTA,1,2765867
ompRp1,5.9,67,9,GCCTTGTTAATTTGTAATGA,58,2811834
ompRp1,0.2,10,9,GCATGCATGGTACTACCGTT,1,2783769
ompRp1,0.2,10,9,GATGGGCTAAGGGGTCTGTG,1,2781534
ompRp1,14.0,148,9,GATCCTGTTTGCATCCGTGT,139,2782201
ompRp1,5.5,63,9,GATATTATAGACGACTTCAT,54,2791654
ompRp1,21.3,221,9,GATAGGATCATCCTGAAGTA,212,2788523
ompRp1,13.8,146,9,GAGGGAGTGCTATTGCCCGG,137,2803929
ompRp1,3.8,46,9,GAGCTGCTGATCAGACGGAA,37,2808068
ompRp1,23.3,241,9,GAGCTGCGTTAATGCTATAC,232,2809645
ompRp1,12.5,133,9,GAGCAAAATGAACCCTTCGT,124,2794725
ompRp1,0.6,14,9,GACTGAGTTATAAACACCAT,5,2802317
ompRp1,2.9,37,9,GACAATCGTTCGAAAGACTG,28,2785693
ompRp1,4.9,57,9,GAATCTATACCATCGGCGGT,48,2808729
ompRp1,0.2,10,9,GAATAGCCTACTATGCGTTA,1,2795541
ompRp1,13.8,146,9,GAACGGTAACGATGACTCAA,137,2808230
ompRp1,1.8,26,9,CTTTGCGAGCTGCGAGTGCT,17,2815530
ompRp1,19.4,202,9,CTTTCTATGAAAGAAAGGAT,193,2809434
ompRp1,1.0,18,9,CTTTATTTCGTACTATACCT,9,2810886
ompRp1,0.2,10,9,CTTGTTCACATTCAAAATCA,1,2799974
ompRp1,0.8,16,9,CTTGCCCGTATACAAAACAT,7,2806629
ompRp1,19.5,203,9,CTGGTATACAAGGGGCGACA,194,2806753
ompRp1,0.2,10,9,CTCGGGACTCAGGGGCTACG,1,2814456
ompRp1,3.5,43,9,CTCGACATTGCTACCGTCTT,34,2805122
ompRp1,0.8,16,9,CTATGGCTCCTATGTCCCCA,7,2778221
ompRp1,0.2,10,9,CTACAGAGTTCTCAGTTCGC,1,2808808
ompRp1,0.2,10,9,CTACAACATAGGCGTATTCT,1,2786819
ompRp1,6.5,73,9,CTAAGACATTTATCAAACTT,64,2795425
ompRp1,14.7,155,9,CGTTATAGGGCAGGCCCGTA,146,2800646
ompRp1,11.0,118,9,CGTCTGTGCGTCGAAACTAC,109,2797524
ompRp1,0.3,11,9,CGGTCCTAGATTATTAGAAG,2,2784948
ompRp1,0.2,10,9,CGGGAGTGTCGGTTCTTAGA,1,2769650
ompRp1,12.1,129,9,CGGCTCTGGGTTTCTACACA,120,2802039
ompRp1,10.1,109,9,CGGCGAGGATAGTCCAACCT,100,2808771
ompRp1,0.2,10,9,CGGAACGCCTAATAGGGGGT,1,2808917
ompRp1,0.3,11,9,CGCTCTAGAGCCCTAATTTA,2,2776027
ompRp1,9.2,100,9,CGCGCACCCTTCTTGGTCGT,91,2813031
ompRp1,0.2,10,9,CGCATGACCCGCTGTTAGAC,1,2800870
ompRp1,3.3,41,9,CGCAGGTACCTCTGCGCTTG,32,2771625
ompRp1,0.2,10,9,CGAGTTAAGTTGTGTCTCCT,1,2775371
ompRp1,0.2,10,9,CGACTCTGGGACTCCTCGAG,1,2765497
ompRp1,3.1,39,9,CGACGCAGCGCTCACTCTCT,30,2791881
ompRp1,0.2,10,9,CCTGAGTCTGGCAACGAGGT,1,2795045
ompRp1,0.2,10,9,CCGTCTTTTCCGTGTCGGTT,1,2804886
ompRp1,8.3,91,9,CCGATGTCCAGTTGTCCCTC,82,2798045
ompRp1,0.2,10,9,CCCGTAGTGCCGGTCCGGGA,1,2813092
ompRp1,0.2,10,9,CCCGCGTGAGGGTTTCTCTC,1,2765805
ompRp1,9.9,107,9,CCATTGCGTTGCGTGGTTAT,98,2771679
ompRp1,13.0,138,9,CCATGGACCAGCCCCTGGCG,129,2797847
ompRp1,6.7,75,9,CCATCGTGTCGCAAAAATTC,66,2779048
ompRp1,2.1,29,9,CCACCGGACCCAGTGGGGAC,20,2775040
ompRp1,0.2,10,9,CACGTGCAGTCCCAAAGGTA,1,2777485
ompRp1,3.3,41,9,CACGGAAGGGTCTGCCTCAA,32,2811103
ompRp1,2.9,37,9,CACCAACCGAACTATCATGT,28,2793367
ompRp1,0.4,12,9,CAAGGGGCATCCAATGTCCT,3,2812852
ompRp1,0.3,11,9,CAACGATAAAATCCGAGGCC,2,2805233
ompRp1,14.0,148,9,CAAATTACCGGATCCACCCC,139,2800307
ompRp1,3.8,46,9,CAAACACGTCTCCTTTGAAC,37,2784679
ompRp1,0.2,10,9,ATTTTGTAAGAACATGCTGC,1,2813018
ompRp1,0.3,11,9,ATTTGTATGAACTTCAAGTG,2,2799063
ompRp1,0.6,14,9,ATTGATCACACTCATGAATA,5,2801085
ompRp1,0.2,10,9,ATGTTACGGTTATGTCAGGG,1,2771901
ompRp1,5.6,64,9,ATGGGAGAAAGCTTCCATTT,55,2766459
ompRp1,0.2,10,9,ATGGCTCTCATGCCCGAAGT,1,2785312
ompRp1,0.3,11,9,ATGGACACCCCCGTGGAGAG,2,2776526
ompRp1,7.5,83,9,ATGCTTTAATTCAGTTGAAC,74,2788141
ompRp1,0.2,10,9,ATGCTTGTATTGACTTGCCA,1,2795952
ompRp1,0.3,11,9,ATGCTTCTGTCATTTTACGC,2,2765688
ompRp1,0.3,11,9,ATCTTAGGGATAACGGCCCA,2,2778956
ompRp1,3.8,46,9,ATCAAACGGGCAGACGGATA,37,2775644
ompRp1,1.2,20,9,ATATTACGATCGCTTTGGTA,11,2781264
ompRp1,0.7,15,9,ATATCCGTCCGGCGTACTAG,6,2794451
ompRp1,17.7,185,9,AGTTTGCCAATTAATCAAGC,176,2823742
ompRp1,0.3,11,9,AGTCAACTATGCAGTTTATC,2,2810929
ompRp1,6.8,76,9,AGGTTTCGGCTTGGTCATCA,67,2765693
ompRp1,10.4,112,9,AGGGGCCGTTGTGGGATTTT,103,2770923
ompRp1,29.7,305,9,AGGGGATGGACCACAACATA,296,2809459
ompRp1,9.0,98,9,AGGCGGGGCAGACCTCTTCA,89,2794726
ompRp1,0.2,10,9,AGCTGTATGAATCGCATTAC,1,2783783
ompRp1,20.7,215,9,AGATAATATCATTAATAGTT,206,2814375
ompRp1,0.2,10,9,AGACGGGATCTGGCAGGTAG,1,2816148
ompRp1,0.2,10,9,AGACGCCTAGGCCTAATTTG,1,2823457
ompRp1,1.1,19,9,AGAAGCCCAATGGCTCCGTT,10,2777098
ompRp1,9.0,98,9,ACGGTAGTTCGGGCCACGGT,89,2811597
ompRp1,0.2,10,9,ACGGAGCGATGGAGACAGGT,1,2796215
ompRp1,19.4,202,9,ACGCAATTAAAACCGTCATG,193,2783156
ompRp1,3.7,45,9,ACCTACGTGTTGCGTATTCT,36,2810968
ompRp1,0.2,10,9,ACCGCAATGTAACTACCGGG,1,2806004
ompRp1,11.9,127,9,ACCGAGACAGGCTAAAGAAC,118,2781701
ompRp1,0.2,10,9,ACCCGCCAAGTGGGCTCCTG,1,2771405
ompRp1,8.5,93,9,ACCCCGTATAGTCGTGACAG,84,2778810
ompRp1,14.1,149,9,ACCATTGATTGCCACAACTA,140,2805463
ompRp1,0.2,10,9,ACACCGAGTTTAATCAATCC,1,2801597
ompRp1,1.3,21,9,ACAATCGCGATGCGCATATA,12,2816082
ompRp1,0.2,10,9,AATTCCTGCCCACTGACAAT,1,2782968
ompRp1,0.9,17,9,AATGGGGTGAGGTCTGCCTG,8,2793015
ompRp1,0.3,11,9,AAGATGTTATAGTTTATGTA,2,2793173
ompRp1,10.3,111,9,AACTCCTAACTGTGGTTTCA,102,2775483
ompRp1,12.0,128,9,AACGCGCGCTTACTCCAGTT,119,2784508
ompRp1,18.0,188,9,AACCCCTCGCGCGATAGGGT,179,2785072
ompRp1,12.5,133,9,AAAATAAGTTGATTGGCGCG,124,2775175
ompRp1,5.888888888888889,60,8,TTTCCTTCCGCCGACGTCTG,52,2814281
ompRp1,13.0,124,8,TTTCATGGGATCTGGCCGAA,116,2776740
ompRp1,1.1111111111111112,17,8,TTGTACGAGCCTGCAGTTCC,9,2804251
ompRp1,0.2222222222222222,9,8,TTGGTGAGCGGTACTGTCCT,1,2788671
ompRp1,0.2222222222222222,9,8,TTGGGTGGACCGGCGGTCTA,1,2796840
ompRp1,0.2222222222222222,9,8,TTGAGCATAGACACTTAGCG,1,2766670
ompRp1,1.2222222222222223,18,8,TTGACTGTGATTCTATTGAC,10,2809740
ompRp1,0.2222222222222222,9,8,TTGAAGACCTGTTAAACGAA,1,2796878
ompRp1,8.222222222222221,81,8,TTCATTAAGTTACGGAAACT,73,2801352
ompRp1,15.555555555555555,147,8,TTACTGTAAACGAGCGTATG,139,2767822
ompRp1,12.555555555555555,120,8,TTACCCGAATATGGGCTAAG,112,2806632
ompRp1,4.333333333333333,46,8,TGTTCTCGGGATCTCGATAA,38,2778430
ompRp1,0.8888888888888888,15,8,TGTTACGTCACCGCTTGGTG,7,2807759
ompRp1,0.2222222222222222,9,8,TGGTAGAGGAAGCCAACATA,1,2780617
ompRp1,16.11111111111111,152,8,TGGGATGGCCAAGAACAGTG,144,2776807
ompRp1,1.5555555555555556,21,8,TGGCCGACAGCGGCGGGTCC,13,2820924
ompRp1,0.6666666666666666,13,8,TGATCACCACCGCACGCATG,5,2784375
ompRp1,21.88888888888889,204,8,TGACACTGGGTTCCCGGGAT,196,2804088
ompRp1,7.555555555555555,75,8,TCGGCACGTCAGCGTGCCAC,67,2812219
ompRp1,15.444444444444445,146,8,TCGACGAGAGCGCGACCGGG,138,2804515
ompRp1,4.222222222222222,45,8,TCCGTTTGGTTGCTAGCGTT,37,2787486
ompRp1,0.6666666666666666,13,8,TCAGCCTCTCGTAAAAGTAG,5,2807455
ompRp1,5.777777777777778,59,8,TCAACAGCTACTAATATATT,51,2814457
ompRp1,14.11111111111111,134,8,TACGGTTCGGCCCGAGGTTT,126,2791317
ompRp1,16.77777777777778,158,8,TACGACGATTGTTTTTGGAG,150,2814069
ompRp1,0.5555555555555556,12,8,TACAGAGCTTAGATAGGGTG,4,2784190
ompRp1,10.88888888888889,105,8,TAAGGCCGCTGGGTAATCGG,97,2816579
ompRp1,16.88888888888889,159,8,GTGCGGAAACTTATTTTCTA,151,2814945
ompRp1,4.111111111111111,44,8,GTGCCCATGCACGACAGATG,36,2791248
ompRp1,4.666666666666667,49,8,GTGACTCCCATCAGTTCGAA,41,2769549
ompRp1,9.666666666666666,94,8,GTCTCGGATGTAGATAGTTT,86,2822907
ompRp1,0.2222222222222222,9,8,GTCTAACTGAGGCTACTCAG,1,2768626
ompRp1,6.111111111111111,62,8,GTCCGTTTTCGGAGTACAAA,54,2771452
ompRp1,16.11111111111111,152,8,GTCAGGTGTAAAAGACGCGA,144,2797708
ompRp1,17.0,160,8,GTAGTCGGATCTCATTCGAG,152,2821861
ompRp1,18.333333333333332,172,8,GGGTTATACCGCTCAAATCG,164,2782982
ompRp1,0.2222222222222222,9,8,GGGGACACAAAGGAGAGACT,1,2821135
ompRp1,7.333333333333333,73,8,GGGCATTTGTGCGGCTGCCC,65,2788428
ompRp1,0.4444444444444444,11,8,GGGATCAAATTGTGCGGGTA,3,2790878
ompRp1,1.0,16,8,GGGACCAGGAGTAAGCGAGG,8,2781259
ompRp1,2.6666666666666665,31,8,GGCTCATCTCCTTATAAATG,23,2789469
ompRp1,3.5555555555555554,39,8,GGCGTCGATTACCGAGGCCG,31,2779108
ompRp1,0.2222222222222222,9,8,GGCGCAGTCTTACTTTGTGA,1,2770309
ompRp1,0.2222222222222222,9,8,GGCCCCCGATCCTTAGATTA,1,2813420
ompRp1,0.2222222222222222,9,8,GGATTCTATAAGCATTGAGA,1,2824599
ompRp1,0.2222222222222222,9,8,GGATGGTGCTATAGAAAGCA,1,2802408
ompRp1,16.22222222222222,153,8,GGAGTACCAGAATGACGTTT,145,2807370
ompRp1,12.555555555555555,120,8,GCTTAGTTCTGCATGGGTAT,112,2796385
ompRp1,0.2222222222222222,9,8,GCTGGGGGTGGTAGGGTTCA,1,2795022
ompRp1,11.777777777777779,113,8,GCTCCCTTGAGTAGGATTTC,105,2796975
ompRp1,19.333333333333332,181,8,GCGTAGGGTCGAGGTTTTTC,173,2792883
ompRp1,0.2222222222222222,9,8,GCGGCCCGCCAGGCTGCAGT,1,2792982
ompRp1,0.2222222222222222,9,8,GCCTGGTCCAATTATTACGG,1,2807692
ompRp1,9.0,88,8,GCCTCCTCACTACCCCATGA,80,2808333
ompRp1,5.0,52,8,GCATCCCTAGTTAGGACTCG,44,2799525
ompRp1,0.2222222222222222,9,8,GCATAGCTTGTGGTCTCGGA,1,2804073
ompRp1,4.444444444444445,47,8,GCATAATCGTGAGGACCCTA,39,2789559
ompRp1,0.3333333333333333,10,8,GCACTTCCAACACGCCGCAA,2,2823615
ompRp1,10.777777777777779,104,8,GCACCGCGTCGTCTAGGCTA,96,2821185
ompRp1,29.666666666666668,274,8,GATTCAGCAGTGCTGTTGGC,266,2774192
ompRp1,0.2222222222222222,9,8,GATGGACGACCGCAGATATT,1,2787727
ompRp1,0.2222222222222222,9,8,GATAGAGATATTCTTATAAA,1,2795880
ompRp1,0.3333333333333333,10,8,GATACATATCCTATACGCGT,2,2790403
ompRp1,6.888888888888889,69,8,GACCCTAACATAGTGTGGAC,61,2801494
ompRp1,0.2222222222222222,9,8,GACAACTCTAGTGTAATTTT,1,2794206
ompRp1,0.7777777777777778,14,8,GAAGTTGTGATCCGGGGCTC,6,2789626
ompRp1,0.8888888888888888,15,8,GAACGCTATAGGCGTTACTT,7,2778480
ompRp1,6.222222222222222,63,8,GAACGAATTTCTACAAACTC,55,2817233
ompRp1,0.2222222222222222,9,8,CTTACGCGTTGTCGCCCCTA,1,2784992
ompRp1,5.444444444444445,56,8,CTGTTCTTATAGTCTTGATC,48,2790487
ompRp1,0.2222222222222222,9,8,CTGCCTCTCAAAGTCACCTC,1,2819072
ompRp1,0.3333333333333333,10,8,CTGAAACTTCTTGGTGAATG,2,2813911
ompRp1,1.4444444444444444,20,8,CTCTGTCTAAACAGGTGGAC,12,2799663
ompRp1,0.2222222222222222,9,8,CTCGGCGTAACTATTTGATT,1,2786243
ompRp1,6.0,61,8,CTCCTAATACAGTGAAAAAA,53,2798370
ompRp1,15.11111111111111,143,8,CTATAGAAAAAGCATAAGTA,135,2782610
ompRp1,6.777777777777778,68,8,CTAGGTCTGCGAGCTAAGGT,60,2819702
ompRp1,0.2222222222222222,9,8,CTAGGGCGTAGGAGGAGGCC,1,2782983
ompRp1,2.4444444444444446,29,8,CTAGCTCAGAGGGCACTATC,21,2782737
ompRp1,0.2222222222222222,9,8,CGTTTCCCACTGGCGTTGTA,1,2801436
ompRp1,0.2222222222222222,9,8,CGTGGCCCAACCCTTACAGG,1,2798533
ompRp1,1.1111111111111112,17,8,CGTGATCGTAAGCCACGCTA,9,2799371
ompRp1,0.2222222222222222,9,8,CGTGATACGGAACAGTTAAA,1,2785663
ompRp1,25.333333333333332,235,8,CGGTGTCCTTCTTATTAGTA,227,2814077
ompRp1,1.7777777777777777,23,8,CGGTCCTAAGCAAGTCATCA,15,2787046
ompRp1,0.2222222222222222,9,8,CGGCGCTTTATATTATGTCC,1,2770217
ompRp1,38.666666666666664,355,8,CGCCAAGTCTATAGTGTTGA,347,2783185
ompRp1,8.666666666666666,85,8,CGCATTTTAATGTCGCTGAT,77,2765899
ompRp1,0.2222222222222222,9,8,CGAGTGGGATCTCTCGCCAT,1,2821645
ompRp1,16.11111111111111,152,8,CGACTTCCACATATAAGTAT,144,2806503
ompRp1,18.22222222222222,171,8,CGACGGGTTGCTGGCCTGTG,163,2814229
ompRp1,0.2222222222222222,9,8,CGAATTTAGGCAAGCAGTGG,1,2812887
ompRp1,12.666666666666666,121,8,CCTTAGCTCTCTTAGTCATA,113,2776973
ompRp1,2.2222222222222223,27,8,CCTATCTTAATCATTCTCCT,19,2790384
ompRp1,0.2222222222222222,9,8,CCGGTGATCACTGCCCATCG,1,2776148
ompRp1,1.4444444444444444,20,8,CCGGACGCGGGCATGCTGGG,12,2772152
ompRp1,0.2222222222222222,9,8,CCGAGTCTACGTTACACGAT,1,2789706
ompRp1,10.88888888888889,105,8,CCCGGGGTTGTGCTTCCATA,97,2778537
ompRp1,25.11111111111111,233,8,CCCAATGAAATATTTATCCC,225,2772772
ompRp1,11.0,106,8,CCCAAACTAGGGTGGTTGGA,98,2819074
ompRp1,0.4444444444444444,11,8,CCAGGGTGAATCCACTGTTT,3,2769569
ompRp1,2.3333333333333335,28,8,CCACTATAGAAAACGATCCA,20,2766547
ompRp1,6.666666666666667,67,8,CATTACCACTTTGCTATAGT,59,2789102
ompRp1,20.666666666666668,193,8,CATATACGCCGATTGTTGAT,185,2803011
ompRp1,0.2222222222222222,9,8,CATAACAATACAACAGACGT,1,2814995
ompRp1,10.666666666666666,103,8,CAGAGTCAGAGGCCTGGGAT,95,2772195
ompRp1,0.2222222222222222,9,8,ATTTCGACGTGGAGCCCAAA,1,2811305
ompRp1,13.666666666666666,130,8,ATTATGCAGTGCGTAGTTGA,122,2774031
ompRp1,0.2222222222222222,9,8,ATGGCAAACGATCATGGGAT,1,2804339
ompRp1,0.3333333333333333,10,8,ATGCAAAGACAGCGGTTTCA,2,2787207
ompRp1,3.0,34,8,ATCCACATAGGGACTCGCAG,26,2804413
ompRp1,0.2222222222222222,9,8,ATCACCAGAGATTGTCTCTA,1,2817269
ompRp1,3.5555555555555554,39,8,ATCACAGCTGGGTAGGTTGA,31,2773044
ompRp1,8.88888888888889,87,8,ATATCAAACCTACCGTGGAG,79,2818425
ompRp1,6.888888888888889,69,8,ATAGAGTGGTGAATTCCGTT,61,2824686
ompRp1,2.0,25,8,AGTTGGGGCCGCAAGAGCCT,17,2792885
ompRp1,0.2222222222222222,9,8,AGTCGGATAGAACTTATATT,1,2820907
ompRp1,7.0,70,8,AGGATATAAATCGTAGTCTT,62,2768764
ompRp1,0.2222222222222222,9,8,AGGATAGGTATTGGACGATA,1,2769786
ompRp1,1.8888888888888888,24,8,AGCTTGAACACTCAATTGCA,16,2785377
ompRp1,1.7777777777777777,23,8,AGATCGATTCCAGGGAGTTT,15,2798157
ompRp1,0.2222222222222222,9,8,AGAGGCAACGTTTATCGGGT,1,2823066
ompRp1,22.555555555555557,210,8,AGAGCACAGTCTTTAGTTCA,202,2820857
ompRp1,13.666666666666666,130,8,AGAAAGAATTACATATGTTA,122,2768514
ompRp1,7.888888888888889,78,8,ACTTCCCGCCAGTTCCGCCA,70,2780970
ompRp1,13.555555555555555,129,8,ACTCAATGATAGACTGGAAA,121,2783640
ompRp1,0.4444444444444444,11,8,ACTATGGAAGTCCACAGACG,3,2769168
ompRp1,1.5555555555555556,21,8,ACTACGAGGACGATAGGAGA,13,2794157
ompRp1,32.55555555555556,300,8,ACGAGATGTCCTAAGCTATT,292,2807801
ompRp1,0.2222222222222222,9,8,ACCGTAGGCCGCAGGCAGAC,1,2822107
ompRp1,0.2222222222222222,9,8,ACCGCCGTCCAAGATCGACC,1,2788011
ompRp1,0.2222222222222222,9,8,ACCATAGGTATGTCATCTCA,1,2775261
ompRp1,0.2222222222222222,9,8,ACCACTTTTGGTTCAAATTC,1,2821058
ompRp1,7.444444444444445,74,8,ACACTCATATTGCGCTCCTG,66,2806174
ompRp1,6.222222222222222,63,8,ACACGAATCACGCGTACTCA,55,2776345
ompRp1,0.7777777777777778,14,8,ACAATTTCACTGGCTGGTAC,6,2815968
ompRp1,7.888888888888889,78,8,ACAACCACGATGCCCAAGGA,70,2779110
ompRp1,24.77777777777778,230,8,AATCGAAATCTCGGAATATC,222,2783886
ompRp1,0.3333333333333333,10,8,AAAGAGATACAGGAATTAAA,2,2773953
ompRp1,0.25,8,7,TTTTTGCCACATGTGGATGA,1,2767875
ompRp1,6.25,56,7,TTTTGGATGGTCACATGGAA,49,2793436
ompRp1,5.75,52,7,TTTTGCCTAGGGGTAATTTC,45,2792778
ompRp1,7.375,65,7,TTGTACATCCACGTGCCCAA,58,2774990
ompRp1,7.75,68,7,TTGTAAGCCCGATCCACAAA,61,2775164
ompRp1,0.25,8,7,TTGGCCGGTCATGACCAGGG,1,2787766
ompRp1,17.375,145,7,TTGAGTTCACCTCTCCATAT,138,2793299
ompRp1,4.25,40,7,TTCTAAGCCTTACTACCATC,33,2790856
ompRp1,3.5,34,7,TTCCAGAGTGCGCTCATATT,27,2784760
ompRp1,2.375,25,7,TTCCACGCCCTGGATTCGTT,18,2796140
ompRp1,3.5,34,7,TTCCACACAAATGCTATGGC,27,2767735
ompRp1,10.125,87,7,TTAGTTATTATAACGCCGAC,80,2813718
ompRp1,0.5,10,7,TTAAGGGCATAAATACGTAT,3,2784685
ompRp1,1.5,18,7,TGTCTTGAGTGCACTGAGGT,11,2771876
ompRp1,0.25,8,7,TGTCTCCCTGCGAAGAGAGC,1,2824276
ompRp1,3.375,33,7,TGTACCGTAATACCGGGTGG,26,2800303
ompRp1,4.625,43,7,TGGTTGGGAGGGTTCAGAGC,36,2784192
ompRp1,15.625,131,7,TGGCAGCCCTATTATTATGA,124,2787354
ompRp1,0.25,8,7,TGGCAATCCCTTTTCAGGGA,1,2782398
ompRp1,1.625,19,7,TGCCGTAATGCAGATCCTAC,12,2784155
ompRp1,0.5,10,7,TGATCACGGTAGGCATCTTG,3,2794316
ompRp1,0.25,8,7,TGACGTGCAACTTGGCCCGT,1,2796397
ompRp1,0.25,8,7,TGAAATTTACGATACCACCT,1,2769518
ompRp1,2.625,27,7,TCGTGCGGGTTGCAGGTCCG,20,2792788
ompRp1,1.125,15,7,TCGTGCAGGGTGAAAGTAAA,8,2804257
ompRp1,0.25,8,7,TCGGGGGCTCTCCCTACCTT,1,2776307
ompRp1,2.0,22,7,TCGGACGAACCCTTGACACA,15,2820969
ompRp1,0.25,8,7,TCGCGCTCGGAGTCGATCTA,1,2822935
ompRp1,2.5,26,7,TCGCCAGCTCGGATGGACTT,19,2799398
ompRp1,0.25,8,7,TCGCAAACTAAGTATTAAAT,1,2804440
ompRp1,4.0,38,7,TCGAACGACAGGTATTCCCA,31,2821856
ompRp1,0.25,8,7,TCCTTTTATTGTGCTTTAAC,1,2782448
ompRp1,12.375,105,7,TCCTACTACCGCTGGTAATA,98,2792448
ompRp1,14.625,123,7,TCCCCGTGCTTTGCGAACCG,116,2807239
ompRp1,0.25,8,7,TCAGTCCAGTCGTTAGTTAG,1,2799848
ompRp1,27.125,223,7,TCAGCCGCCTCTAGCCGCCT,216,2778729
ompRp1,0.25,8,7,TCAATGTTTGTGTTTACCGA,1,2805944
ompRp1,18.625,155,7,TATGTTGTCGGCGTGAAATC,148,2805609
ompRp1,0.25,8,7,TATGTAGGCAAAGAATAAGA,1,2797717
ompRp1,15.375,129,7,TATCCGGCAGCCCTACGGTG,122,2771799
ompRp1,4.375,41,7,TATAGCGGTGCAAGAAGCGT,34,2773253
ompRp1,0.5,10,7,TAGGAGGGGCGCCTCATCAT,3,2799399
ompRp1,14.5,122,7,TACTCATCAACGGGCCTACG,115,2789515
ompRp1,5.75,52,7,TACCATCGGAATGATCACAA,45,2780874
ompRp1,28.25,232,7,TACATAGTGACATCGCACTG,225,2765789
ompRp1,0.25,8,7,TACACGAGAGATCCACATAA,1,2776682
ompRp1,12.0,102,7,TAATCCACATGCATTGAGTA,95,2775548
ompRp1,0.25,8,7,TAAGGGTTTTACAAGTTAAC,1,2791858
ompRp1,0.5,10,7,TAACTGGTATATGCCCCCGG,3,2798288
ompRp1,1.125,15,7,TAACGCGGCGCTAGCTTCTT,8,2769010
ompRp1,14.5,122,7,TAAATCGAAGGTTCGACAAG,115,2771918
ompRp1,36.125,295,7,TAAAACCCATCAAAATTTTA,288,2775883
ompRp1,15.875,133,7,TAAAAAATACTTCTAGATTG,126,2783025
ompRp1,1.75,20,7,GTTCCGCGATCGTGCGTCTT,13,2802531
ompRp1,1.875,21,7,GTTCAGGGTTCGCATCGAGC,14,2804276
ompRp1,0.25,8,7,GTGTGGAGCGCAAACTACTA,1,2816795
ompRp1,4.625,43,7,GTGGCGCGTCTTCCATAAAA,36,2808225
ompRp1,24.875,205,7,GTGGACCATAGCCATTGAGA,198,2784037
ompRp1,24.75,204,7,GTATAAGGATGATGTATCAA,197,2793302
ompRp1,3.375,33,7,GTAGTACGGGCGGAGAAAAC,26,2767794
ompRp1,8.375,73,7,GTAGATAGACTAACGTTAAC,66,2820282
ompRp1,8.125,71,7,GTAAGAGTAACTGCTTTAAG,64,2796773
ompRp1,12.75,108,7,GGTTTGACATTAGTAAGTAG,101,2792540
ompRp1,0.25,8,7,GGGTTCGAATTAATATGTTC,1,2766530
ompRp1,0.375,9,7,GGGTGCGACAGTGTGGACCA,2,2813858
ompRp1,3.25,32,7,GGGGCGGTAGTAACTAAGTT,25,2785141
ompRp1,23.375,193,7,GGGAAAGCGTTCCCATCAGA,186,2765259
ompRp1,2.75,28,7,GGCGTGATATAGAGATGATT,21,2792886
ompRp1,0.75,12,7,GGCGCTTAACGGCGGATGGT,5,2772782
ompRp1,0.25,8,7,GGCGCTATCTACAGGACCGA,1,2801412
ompRp1,0.25,8,7,GGCCGTGCTACGCGGTGATC,1,2804884
ompRp1,11.0,94,7,GGCCACACGTGACTTGAACA,87,2777521
ompRp1,1.125,15,7,GGACCGACAAAGTCCTTCTC,8,2823711
ompRp1,0.25,8,7,GCTTGTTCTCCGCATTCGTG,1,2814851
ompRp1,0.25,8,7,GCTTCTTATATCCAGCACTG,1,2771347
ompRp1,0.25,8,7,GCTGCGGGACGCTCGCGTTA,1,2796123
ompRp1,0.25,8,7,GCTCCGGACTGGTTATGTGC,1,2797339
ompRp1,12.5,106,7,GCTAGGGAGGGTGGGTTTTT,99,2784425
ompRp1,1.25,16,7,GCGTTTGGTAGTCAGACTCT,9,2809491
ompRp1,0.25,8,7,GCGGATGCGAAAGTACCAGG,1,2791351
ompRp1,8.875,77,7,GCGGACCGGTCGCCGAGGCT,70,2768564
ompRp1,0.25,8,7,GCGCGACCCATACAGCAGCT,1,2793263
ompRp1,14.625,123,7,GCGCCTTCCGTCGAACTGTG,116,2798582
ompRp1,0.25,8,7,GCCTAATTGAGCGCCACACA,1,2777795
ompRp1,0.25,8,7,GCCGCTGCATTAATGCATAA,1,2778552
ompRp1,0.75,12,7,GCCCCTGTGGCACCAAGTTA,5,2808385
ompRp1,17.875,149,7,GCATGGTGCTTTCTGGTCTC,142,2775198
ompRp1,0.25,8,7,GAGTACGTGAGAACGGAGAG,1,2792477
ompRp1,8.25,72,7,GAGGCCGTACACAGTACAAA,65,2776972
ompRp1,6.25,56,7,GACAAGCAGGTAGAGGCCCA,49,2771688
ompRp1,0.75,12,7,GAATATTATGGGAAGGACCC,5,2817617
ompRp1,4.75,44,7,CTTCTTCGTGATACATTAGG,37,2821703
ompRp1,0.25,8,7,CTTCTGCTATGTATTCTAGG,1,2769568
ompRp1,0.25,8,7,CTTCGGTTGGCTGTACCGAC,1,2780481
ompRp1,0.25,8,7,CTGTATTCCCACTTGGGAGC,1,2798439
ompRp1,7.25,64,7,CTGCGCCCCATTCTCAAGTC,57,2789621
ompRp1,13.625,115,7,CTGCCGTAATTATTGATTGA,108,2799027
ompRp1,0.25,8,7,CTCCACTAGCCTGACGTCAA,1,2793824
ompRp1,0.25,8,7,CTATAAACTAATTTACACAA,1,2812693
ompRp1,11.75,100,7,CTAACGGCGCGTCATTTGAG,93,2778047
ompRp1,0.375,9,7,CTAACCTGGTCGCTCTAAGA,2,2811116
ompRp1,14.75,124,7,CGTTAACGATGAGTACCCTT,117,2818175
ompRp1,0.25,8,7,CGTAACTATAACCGGTGTCA,1,2788821
ompRp1,13.625,115,7,CGGTGTTACCAATTCGCCCT,108,2816645
ompRp1,0.25,8,7,CGGTAAGCGTTGATAAAGGG,1,2789700
ompRp1,2.625,27,7,CGGGTCGTATACGTACAGTT,20,2767556
ompRp1,0.375,9,7,CGGCTATACCCTTCTTGCCC,2,2767469
ompRp1,2.5,26,7,CGCGTTACTCGGCTAGGAGA,19,2815727
ompRp1,9.625,83,7,CGCATGTCGCTACTGTGACA,76,2778147
ompRp1,12.375,105,7,CGAGACCGCAGACCCTCTGA,98,2800257
ompRp1,21.875,181,7,CCTGGAGGAAGGTTAGAGGG,174,2796666
ompRp1,0.5,10,7,CCGTCAACTACCGCTGAAAG,3,2806584
ompRp1,0.25,8,7,CCGGATCACGACCTGTTGCT,1,2807133
ompRp1,0.25,8,7,CCGAATAGCTGAGAAACCAC,1,2792285
ompRp1,0.25,8,7,CCCCCTGGTAGGGGATTAAG,1,2779043
ompRp1,3.625,35,7,CCATAAAGTGGTGACGCAAT,28,2788820
ompRp1,21.25,176,7,CCAGCTCCTCGATCCAGGGG,169,2795199
ompRp1,1.875,21,7,CCAGCGCGAGTATCTGTCCC,14,2816528
ompRp1,0.5,10,7,CCACTTGGAACAACCAATAA,3,2810025
ompRp1,15.625,131,7,CATTGACGGACGACATTACC,124,2773746
ompRp1,2.5,26,7,CATGCTTAGATACCCCCTAT,19,2796435
ompRp1,4.375,41,7,CATCAATGATCGTAGTGGGA,34,2788468
ompRp1,4.375,41,7,CATATTTAGCACCCTCACGA,34,2799341
ompRp1,1.0,14,7,CATATCCCACACTACGGAAA,7,2765685
ompRp1,22.375,185,7,CAGCGGCCACATGATTGACT,178,2782594
ompRp1,0.75,12,7,CACGCCCCTCGTTGAGCAGA,5,2771203
ompRp1,10.25,88,7,CACAACGTTTCATAGTCGAG,81,2800438
ompRp1,2.5,26,7,CAATGAGTAATGTAGCGACA,19,2796902
ompRp1,0.25,8,7,CAATCCTATTGGTTAACCAC,1,2802407
ompRp1,10.75,92,7,CAAGCCCTCGCGGCGGCGAC,85,2820309
ompRp1,0.375,9,7,CAAAGGCCGACACTCAATTC,2,2766424
ompRp1,25.75,212,7,ATTCGTTAGCAAAAGTGTCC,205,2768625
ompRp1,0.25,8,7,ATTACACATGCAAGTACATG,1,2773246
ompRp1,0.25,8,7,ATGGTTAGCCGCAGGGCAGC,1,2802659
ompRp1,0.25,8,7,ATGGGTAATGTGGGGATAAG,1,2815756
ompRp1,0.25,8,7,ATGGCGACTTCTGATTGTTT,1,2798493
ompRp1,28.0,230,7,ATCGGACTCCCGTAGTAGTG,223,2818072
ompRp1,0.375,9,7,ATCCATTGCGCAGAGACTCT,2,2804602
ompRp1,8.0,70,7,ATCAAGCTAGCATAGTAAAT,63,2784929
ompRp1,1.375,17,7,ATAGTGGAGCGTACGCATGT,10,2793292
ompRp1,0.25,8,7,ATAGTGAAGGCGTCCTAGGT,1,2796961
ompRp1,5.125,47,7,ATAGCGATTAGTGCCCCTTG,40,2816143
ompRp1,15.0,126,7,ATACTCCTATCCCGTCGATT,119,2808459
ompRp1,0.25,8,7,ATAATTAACGGCTCTTCAAA,1,2817461
ompRp1,0.25,8,7,ATAAGCATGAAGTCCGAACT,1,2795607
ompRp1,31.5,258,7,AGGTCCACCTCGGTCTCCTT,251,2773251
ompRp1,12.625,107,7,AGGAACATAAGAGTAATATC,100,2823041
ompRp1,21.0,174,7,AGCTTGGGTGTGCCATCAGT,167,2795929
ompRp1,21.875,181,7,AGCGGGATCCAAGGCCTCCT,174,2782616
ompRp1,0.375,9,7,AGCGATTCGCGTCGCGCCAT,2,2783643
ompRp1,6.125,55,7,AGCCTTCGAAACTGACGTAT,48,2796720
ompRp1,11.75,100,7,AGCAAACACCGGTGCAGGTC,93,2783549
ompRp1,7.75,68,7,AGACTGAGTATAGGGTGAAA,61,2821752
ompRp1,9.375,81,7,AGAAGCGGGGCCGTGCGGAT,74,2777231
ompRp1,25.5,210,7,ACTTTAGAACCTATCCACCC,203,2807625
ompRp1,12.625,107,7,ACTGCGTGCTTTCACGGCTG,100,2769555
ompRp1,18.0,150,7,ACTGACTTTAAATGGCGAGG,143,2768122
ompRp1,0.375,9,7,ACTCTGGTTTAATCGCTAGA,2,2805880
ompRp1,0.25,8,7,ACTCAGGACGGACTGATTTT,1,2808696
ompRp1,12.5,106,7,ACTATTATCAATCGTCAATC,99,2775572
ompRp1,0.25,8,7,ACTAGGTGACTCCCGTGGAT,1,2796255
ompRp1,0.25,8,7,ACTAAATTTGTTGAACCTGG,1,2795474
ompRp1,0.25,8,7,ACGCGACACGGGCCGATTCT,1,2774208
ompRp1,0.25,8,7,ACGCCGGGTGTTTCTCGGGA,1,2817083
ompRp1,6.375,57,7,ACCTCTATGCCGAAAGAACA,50,2785776
ompRp1,0.25,8,7,ACATTCAGTCTAAAGCCCTA,1,2806549
ompRp1,0.25,8,7,ACATAATGCCACCACTTTAA,1,2779654
ompRp1,0.25,8,7,ACAGTGCGCTATCGAAGGAG,1,2784865
ompRp1,0.25,8,7,ACAGGTATGTCCGGTACAGC,1,2770470
ompRp1,7.875,69,7,ACACGATGATATTGAATGCC,62,2790631
ompRp1,0.25,8,7,AATTCCGTGCAAAGCCAGAA,1,2815652
ompRp1,0.25,8,7,AATCTAGCGCTCCGAATTGA,1,2789919
ompRp1,0.25,8,7,AATCGCCCGGCCCGAATATC,1,2775032
ompRp1,12.375,105,7,AATAGAGTGTCCCGGGTATC,98,2801882
ompRp1,26.5,218,7,AAGGTCATCGGCAGCGGCGC,211,2808076
ompRp1,0.25,8,7,AAGGCCCAATCCCAGGTAGC,1,2773116
ompRp1,1.25,16,7,AAGCCGCAGACCAACTGGGA,9,2774215
ompRp1,7.625,67,7,AAGCAGGAAGTTACCCGAAT,60,2772193
ompRp1,0.375,9,7,AACTGTTTCCTTATATAGGA,2,2783720
ompRp1,0.25,8,7,AACTGTCCATCTTTTTTGTC,1,2810878
ompRp1,28.875,237,7,AACGCAGGAGGAAACATGAG,230,2773216
ompRp1,3.125,31,7,AACCATGGCAGCCTACCTTC,24,2812736
ompRp1,3.375,33,7,AACCACAACTTCAAGCCCTG,26,2800620
ompRp1,20.5,170,7,AAATGGATACTTCGGGCGCT,163,2814286
ompRp1,12.625,107,7,AAAGCACTCAAGGTCGCTGG,100,2806354
ompRp1,0.25,8,7,AAAAGGAACCCTGCCTATAG,1,2816894
ompRp1,0.25,8,7,AAAACGTTGTCTTTCCAGCT,1,2777904
ompRp1,4.571428571428571,37,6,TTTATATTCGGACAAATCAT,31,2798255
ompRp1,18.571428571428573,135,6,TTTATACCGTTCCCCGACAA,129,2823261
ompRp1,9.142857142857142,69,6,TTTAGCGCTTATCTCTCGAT,63,2771766
ompRp1,0.2857142857142857,7,6,TTGTGGCAAAAGCCCGTTTC,1,2773830
ompRp1,0.2857142857142857,7,6,TTGCGAGCGTCCAATCAGGG,1,2807760
ompRp1,6.857142857142857,53,6,TTCTCCTCATCATCATCCAT,47,2777419
ompRp1,0.8571428571428571,11,6,TTCAGAAGGGTTCGTACATG,5,2777829
ompRp1,7.428571428571429,57,6,TTATTTTGCATTTAGTTGTT,51,2774970
ompRp1,3.2857142857142856,28,6,TTATGGAAATCCGTTCCAGA,22,2813499
ompRp1,0.2857142857142857,7,6,TTACACTTTGAATTATATGA,1,2808950
ompRp1,10.714285714285714,80,6,TGTTTTTCGGTCTCCATGGG,74,2779109
ompRp1,5.285714285714286,42,6,TGTTACCATCTGGCGATTGG,36,2779344
ompRp1,0.2857142857142857,7,6,TGTACGTTATCTATCCATTT,1,2795770
ompRp1,12.142857142857142,90,6,TGTAAACCGGTTGAGGCATA,84,2765440
ompRp1,0.2857142857142857,7,6,TGGAAGTGGATCGATCTTGG,1,2768529
ompRp1,18.571428571428573,135,6,TGCTGCTTAAATCAGTGCAT,129,2820512
ompRp1,0.5714285714285714,9,6,TGCTAGACATGCGCGTTTGT,3,2774511
ompRp1,15.714285714285714,115,6,TGCTACAACGGGTTCTGCGT,109,2818838
ompRp1,0.2857142857142857,7,6,TGCCTGTAAGGATTGGCTTA,1,2803345
ompRp1,0.2857142857142857,7,6,TGCATATTCATAATTCTCGT,1,2824798
ompRp1,16.285714285714285,119,6,TCTTGACTGTCTTAGTCTCA,113,2776666
ompRp1,0.2857142857142857,7,6,TCGTTACCATGTGGGTCATT,1,2767142
ompRp1,5.714285714285714,45,6,TCGTGGCGTCCTGTATTTAT,39,2817403
ompRp1,3.857142857142857,32,6,TCGGCTATTATGACCGTTTA,26,2773352
ompRp1,0.2857142857142857,7,6,TCGGATAGGGAGAGCGTGTC,1,2782286
ompRp1,28.0,201,6,TCGATGCCCTAGTCTATCAA,195,2822215
ompRp1,22.428571428571427,162,6,TCCTTCGATAGTGGGGCCGA,156,2775240
ompRp1,0.2857142857142857,7,6,TCCTAGGTAATATCGTCATA,1,2801837
ompRp1,13.857142857142858,102,6,TCCCTCGCCAGTGGTCGATA,96,2788033
ompRp1,26.571428571428573,191,6,TCATGGCTTAACCACCGTGT,185,2778076
ompRp1,19.428571428571427,141,6,TCATATCGAGACACTGGGTA,135,2797042
ompRp1,0.2857142857142857,7,6,TCAGCAGTGAAATTTCCTGC,1,2821687
ompRp1,0.2857142857142857,7,6,TCACACGTGTCCTACCCACA,1,2822875
ompRp1,1.2857142857142858,14,6,TCAATACGCATAAGTATTAA,8,2783430
ompRp1,17.714285714285715,129,6,TATCGGGAATGAATACGTAA,123,2822792
ompRp1,6.857142857142857,53,6,TATCGAGGATAGGTCGCTCA,47,2801946
ompRp1,25.142857142857142,181,6,TAGGAATGCTTGTTAAGCGG,175,2777095
ompRp1,17.142857142857142,125,6,TAGGAAGGAGGAGGATACTC,119,2806536
ompRp1,19.0,138,6,TACCTTGTTTCTTCGACTTA,132,2810573
ompRp1,14.571428571428571,107,6,TACCTCTGGGACGAATATTT,101,2800934
ompRp1,0.2857142857142857,7,6,TACCCTCAACTACTGATAAT,1,2816112
ompRp1,0.2857142857142857,7,6,TACAAAACATTGGGTGTAAT,1,2788446
ompRp1,0.5714285714285714,9,6,TAAGGGCGTTCTACTTGTTC,3,2770424
ompRp1,0.2857142857142857,7,6,TAACATAACATACTACTCGA,1,2807060
ompRp1,6.714285714285714,52,6,GTTGGGATAGTTAGTGTAAG,46,2776067
ompRp1,3.142857142857143,27,6,GTTGGCTGGGTTAACCCTGC,21,2801500
ompRp1,6.142857142857143,48,6,GTTCTTGGCGTTATGGGTCC,42,2767087
ompRp1,25.142857142857142,181,6,GTGCTTTACTGTTCCTAAGC,175,2777854
ompRp1,21.285714285714285,154,6,GTGCAACATCAGAGGCGGAA,148,2801404
ompRp1,0.2857142857142857,7,6,GTCTTGGATTGCTTAGAAAC,1,2786864
ompRp1,0.2857142857142857,7,6,GTCCGGTTGACAATAGCCTT,1,2810741
ompRp1,22.571428571428573,163,6,GTAGATGAAAGACCCAGGAC,157,2810851
ompRp1,10.142857142857142,76,6,GTACACACCCGGATCAAGGC,70,2777665
ompRp1,6.0,47,6,GTAAGTTGGATGGCGGTGTG,41,2798221
ompRp1,1.4285714285714286,15,6,GGTGTCGGCCTGTACCAAGA,9,2807359
ompRp1,0.2857142857142857,7,6,GGTCCGGACTAGACGTTCGG,1,2797373
ompRp1,18.714285714285715,136,6,GGTAGCTAGGGCTGGTCTAT,130,2774723
ompRp1,8.0,61,6,GGTACTTCCAGCGGCGGTGA,55,2787123
ompRp1,14.714285714285714,108,6,GGTACGCACAGTAAGCGGGT,102,2790186
ompRp1,0.2857142857142857,7,6,GGTAACACCATTGACATGCG,1,2790814
ompRp1,1.0,12,6,GGGTCATCTCCTTATAAATG,6,2789501
ompRp1,0.2857142857142857,7,6,GGGGAGGTTTTAAGCCCGGA,1,2781108
ompRp1,2.4285714285714284,22,6,GGGGAACAGAAACTGCCGGT,16,2797205
ompRp1,0.2857142857142857,7,6,GGGCTGGGCTTTTCACGTTC,1,2765852
ompRp1,4.857142857142857,39,6,GGATACGATGGGGCCATAGC,33,2775425
ompRp1,3.7142857142857144,31,6,GGAGCGATATGTCACCGCTG,25,2784785
ompRp1,12.285714285714286,91,6,GGAACGTTACGGGGTACCTA,85,2766873
ompRp1,0.8571428571428571,11,6,GCTTGGTAAGAGGCTGGACC,5,2812592
ompRp1,14.0,103,6,GCTCAGTGGCCTAGTGGTCA,97,2781868
ompRp1,37.42857142857143,267,6,GCGCTGTAGCTGAATATTAA,261,2782285
ompRp1,6.0,47,6,GCGCGATGTGTCTGTATCCT,41,2791521
ompRp1,0.42857142857142855,8,6,GCGCCGCCAGGCTCAGACCA,2,2770561
ompRp1,2.2857142857142856,21,6,GCCTATAGGACCCAGTTCTG,15,2817370
ompRp1,7.0,54,6,GCCACATTCGTGCCTTCAAG,48,2782354
ompRp1,3.2857142857142856,28,6,GCATTGGACGGTCTGAACCA,22,2774733
ompRp1,0.2857142857142857,7,6,GCAATAGTACGGAAGACCCA,1,2784801
ompRp1,3.7142857142857144,31,6,GCAAGAACTTTCGTACGGAT,25,2777666
ompRp1,0.42857142857142855,8,6,GCAAAGACAGTTCGTCGAAA,2,2768732
ompRp1,0.2857142857142857,7,6,GATGGCGGGGAAGTCGGTGC,1,2793980
ompRp1,0.8571428571428571,11,6,GATGCATAAAACAATCGCGT,5,2771713
ompRp1,26.857142857142858,193,6,GATCTGTCCCAATTGCGGGA,187,2786910
ompRp1,1.5714285714285714,16,6,GATCGGCATGCTAAGAGCAG,10,2792665
ompRp1,10.428571428571429,78,6,GATACATTAGCTCACCATCG,72,2792039
ompRp1,0.2857142857142857,7,6,GACGTGTGGCAACACCTGTC,1,2784733
ompRp1,16.142857142857142,118,6,GACCCTCCGCGGGAGCCGCG,112,2780491
ompRp1,3.857142857142857,32,6,GACCCAAAATCCTGGCTCTG,26,2780176
ompRp1,16.285714285714285,119,6,GACCAGATAGGGGCATAGAC,113,2808766
ompRp1,18.428571428571427,134,6,GAATGTATGTGCGCCGCTAG,128,2808639
ompRp1,0.2857142857142857,7,6,GAAGTTTGCAGTGGCAGGTT,1,2818413
ompRp1,8.428571428571429,64,6,GAAGGGGGACCCGCATCAGG,58,2774070
ompRp1,16.571428571428573,121,6,GAAGCTCGGACGCAATACTC,115,2779112
ompRp1,0.42857142857142855,8,6,CTTTCGTGCCTTTACCGGCA,2,2792139
ompRp1,4.428571428571429,36,6,CTTTCCAAGCAACACTAGCC,30,2772047
ompRp1,2.142857142857143,20,6,CTTGGACAATCCCGAGCAAG,14,2775496
ompRp1,0.42857142857142855,8,6,CTGCTGTGTAGGTATCACGA,2,2795422
ompRp1,0.2857142857142857,7,6,CTCTGGGCGACGAGTTCAAT,1,2787896
ompRp1,8.428571428571429,64,6,CTCGGAACAGCTACATTCGT,58,2771631
ompRp1,15.428571428571429,113,6,CTCCTCGGTTCCCTTACCCT,107,2773571
ompRp1,1.1428571428571428,13,6,CTCCGGTATGTCTCCTTGCA,7,2770611
ompRp1,0.42857142857142855,8,6,CTCCGCGGCCTCAAAGGTAC,2,2821564
ompRp1,0.2857142857142857,7,6,CTAACCCCTCCTATTCCTCT,1,2780797
ompRp1,5.142857142857143,41,6,CGTTTTTAACTCCTCTTTCC,35,2790416
ompRp1,0.2857142857142857,7,6,CGTATTCATCCGTGTGTGTA,1,2808918
ompRp1,0.2857142857142857,7,6,CGTAGATCCGGTTCCCGCCA,1,2788426
ompRp1,12.857142857142858,95,6,CGGTAGGCTCGAGGCAAAAG,89,2815326
ompRp1,14.285714285714286,105,6,CGGCCGCAAGCGTTTTGACG,99,2823458
ompRp1,2.4285714285714284,22,6,CGCAGAGTTCTGGAGCGTTG,16,2770588
ompRp1,9.857142857142858,74,6,CCTTGTTTTTATTGTGCGCA,68,2777934
ompRp1,23.142857142857142,167,6,CCTGCTATCGCGTTGGCCAT,161,2777082
ompRp1,2.857142857142857,25,6,CCTATTTAGAGTTGCCGCGA,19,2790197
ompRp1,0.2857142857142857,7,6,CCGTGAATAGAACACACCAG,1,2783496
ompRp1,4.428571428571429,36,6,CCGACATTGGTAGTTACGGA,30,2813636
ompRp1,2.857142857142857,25,6,CCCTAGATAAAACATTGTTA,19,2767684
ompRp1,0.2857142857142857,7,6,CCCGTCTTGGTAAGAGTTTC,1,2794518
ompRp1,38.42857142857143,274,6,CCCAGTGTATATTGCGTCGT,268,2771236
ompRp1,0.2857142857142857,7,6,CCCAAAGTCGCCATGGTTTG,1,2791904
ompRp1,7.857142857142857,60,6,CCATGTATCCCCGGCGGCCC,54,2800385
ompRp1,7.714285714285714,59,6,CCATCAGTGAATTTAGACCC,53,2811894
ompRp1,1.8571428571428572,18,6,CCAACTTGCGGCGATCATAT,12,2820745
ompRp1,40.142857142857146,286,6,CATTTCACCCCGATTGCTTT,280,2821346
ompRp1,0.2857142857142857,7,6,CATATTGATTACTATCAGAG,1,2783501
ompRp1,0.2857142857142857,7,6,CATATGAAATCTCATGCGAC,1,2820002
ompRp1,4.857142857142857,39,6,CATAGAACCACCTGCTAAAA,33,2781996
ompRp1,7.571428571428571,58,6,CAGTTTACATTATCTATTCG,52,2782828
ompRp1,17.0,124,6,CAGTTCGTTTTTATGGAGGA,118,2795047
ompRp1,0.2857142857142857,7,6,CAGGGTGTCGCCTGATTAAA,1,2769199
ompRp1,0.42857142857142855,8,6,CAGGACGAGACAATGTGCCA,2,2805724
ompRp1,3.857142857142857,32,6,CAGCAGGAAAGGGCTACATA,26,2798227
ompRp1,1.7142857142857142,17,6,CACCGAGCGGCATGGGGGCA,11,2799847
ompRp1,0.42857142857142855,8,6,CACATTGAAAGCTAGGTAGT,2,2802529
ompRp1,24.285714285714285,175,6,CACATAAAGTCTGACACCAC,169,2772890
ompRp1,11.285714285714286,84,6,CACAACTCGCGGTTTAAATG,78,2788305
ompRp1,0.42857142857142855,8,6,CAATGATCGGTGTGTGTGTA,2,2823972
ompRp1,0.2857142857142857,7,6,CAACTGGACTCACCACCGGT,1,2797518
ompRp1,0.2857142857142857,7,6,ATTTCTTCTCACAGGTTAGT,1,2782889
ompRp1,12.142857142857142,90,6,ATTGCACTCTGACTGTGCAA,84,2778939
ompRp1,0.2857142857142857,7,6,ATTCGGTTCATCCCCTCTGA,1,2800168
ompRp1,0.2857142857142857,7,6,ATGGGTCACAATTACGCTAT,1,2812932
ompRp1,9.571428571428571,72,6,ATGGATATCGCCATGATTCG,66,2790286
ompRp1,1.0,12,6,ATGCGTCCAAATCTGGAGTA,6,2803854
ompRp1,58.142857142857146,412,6,ATCGGCTCCGTTGCATTCTG,406,2768731
ompRp1,24.714285714285715,178,6,ATATGCGATATGTTAACCCT,172,2795824
ompRp1,11.857142857142858,88,6,ATAGGCACGGTGTTCTTTAC,82,2809569
ompRp1,0.2857142857142857,7,6,ATAGAACCCACGTAACTTAT,1,2772875
ompRp1,0.2857142857142857,7,6,ATAAGCCTATTCTCACGCCT,1,2776381
ompRp1,3.0,26,6,AGTTGCGCCCACACATAGGA,20,2808282
ompRp1,9.142857142857142,69,6,AGGGCTGTATGATTATGTTA,63,2778629
ompRp1,19.285714285714285,140,6,AGGCACCTGTTTCCGGTCAG,134,2812525
ompRp1,11.571428571428571,86,6,AGGAAGTCAGATTTTCTGTA,80,2822852
ompRp1,18.142857142857142,132,6,AGCGATCCCAACCGGTACAG,126,2781907
ompRp1,11.857142857142858,88,6,AGCCAGTGACCACGTAGGAG,82,2771205
ompRp1,0.2857142857142857,7,6,AGATGTCCGCTTGTTTTTAC,1,2791362
ompRp1,0.2857142857142857,7,6,AGATGTAAGAAATACCCTTG,1,2769266
ompRp1,5.571428571428571,44,6,AGATCTGGTCTTCACCAGAT,38,2790889
ompRp1,10.714285714285714,80,6,AGAATCTGGGAATGCTGGGG,74,2801283
ompRp1,5.571428571428571,44,6,AGAAATCCTCCTGCTCGTGT,38,2820352
ompRp1,35.285714285714285,252,6,ACTTCATCTGGGGCCACTTG,246,2808373
ompRp1,0.2857142857142857,7,6,ACTGGTCCACTCCGTTCGGA,1,2781339
ompRp1,1.0,12,6,ACTCCCGTCGTTCCAGCTGT,6,2768517
ompRp1,30.285714285714285,217,6,ACGTGCCAAATCTATACTGC,211,2781619
ompRp1,4.571428571428571,37,6,ACCGTACACGTCGTATACGC,31,2811702
ompRp1,0.2857142857142857,7,6,ACCCGGTAGACTATTGCGAT,1,2795364
ompRp1,0.2857142857142857,7,6,ACAGTGGGTTCCGGAGTCGC,1,2816229
ompRp1,0.2857142857142857,7,6,ACACCAGATGGAGTTCACCC,1,2771536
ompRp1,7.142857142857143,55,6,AATTATGAGGCCGTGCCGGC,49,2823537
ompRp1,1.0,12,6,AATTACTAGCGCCACCATTT,6,2819524
ompRp1,5.0,40,6,AATGCTTGCGACGCTAGTAT,34,2817546
ompRp1,0.7142857142857143,10,6,AATCGTTAAGTCTAAGATCT,4,2787216
ompRp1,1.7142857142857142,17,6,AATCCATATTCCCGCATAAT,11,2770153
ompRp1,15.0,110,6,AAGTCAATAAACCACGCAGT,104,2799526
ompRp1,26.428571428571427,190,6,AAGGGCATCTGTAAACGACA,184,2823978
ompRp1,0.2857142857142857,7,6,AAGGACCGTGTCAATTTGAT,1,2768809
ompRp1,3.857142857142857,32,6,AACCAACAATTCCCATTTGA,26,2770011
ompRp1,9.142857142857142,69,6,AACAGGTGAATTCTTGGTAT,63,2814071
ompRp1,13.714285714285714,101,6,AAAAGTGTGCCACTCCCGGT,95,2799604
ompRp1,0.3333333333333333,6,5,TTTTGATAACATGGATCATG,1,2797327
ompRp1,0.3333333333333333,6,5,TTTTCTCGACGCCTAACGTC,1,2822629
ompRp1,9.833333333333334,63,5,TTTTAATCGCGAGCAAGGAC,58,2800093
ompRp1,18.333333333333332,114,5,TTTAGCTACGCGAGCTTGGC,109,2782613
ompRp1,4.5,31,5,TTTACCTCGTTCTCCGTATG,26,2822998
ompRp1,0.3333333333333333,6,5,TTGCGAACTGGACCTGAAGG,1,2777367
ompRp1,28.333333333333332,174,5,TTGACTTGTGTATTGTTCTA,169,2810536
ompRp1,0.3333333333333333,6,5,TTGACTGGCCGTGCTGACGT,1,2782292
ompRp1,21.833333333333332,135,5,TTCAGCCGAACCACACAAGA,130,2824073
ompRp1,17.833333333333332,111,5,TTACTCACCCTCTCGCCGTG,106,2776088
ompRp1,0.3333333333333333,6,5,TTAATCATATGCTTTGATGA,1,2824407
ompRp1,14.833333333333334,93,5,TTAACGTCGGCCTGGGCTGG,88,2772950
ompRp1,9.166666666666666,59,5,TGTTTCGCCGTAGAAGCCGG,54,2824205
ompRp1,19.166666666666668,119,5,TGTCTAATATTGATCTTTCC,114,2777741
ompRp1,0.3333333333333333,6,5,TGGTCGAAGGCCAGCAGCAG,1,2788077
ompRp1,0.3333333333333333,6,5,TGGGTATGGGATGGCGAGGT,1,2807803
ompRp1,0.3333333333333333,6,5,TGGCTGTTGTTCCCGATGGT,1,2797243
ompRp1,0.3333333333333333,6,5,TGGCGCTTATCGTCGGGTCC,1,2823357
ompRp1,3.0,22,5,TGGATCTTAAGCTAACTATC,17,2779257
ompRp1,2.1666666666666665,17,5,TGGATCGCTAACAGGTGTGG,12,2812882
ompRp1,10.0,64,5,TGCGGGGGGTCAAGCGGTTT,59,2774150
ompRp1,16.0,100,5,TGCGCGCTACATAACCGGAA,95,2781367
ompRp1,5.5,37,5,TGCGAATCTCGGGTGTCCAA,32,2804929
ompRp1,0.3333333333333333,6,5,TGCATCGCTCTCAGTCGGCC,1,2803647
ompRp1,6.0,40,5,TGATCTCGTTGCTTGATGAA,35,2765312
ompRp1,14.0,88,5,TGAGCCCGATACCGTTCAGC,83,2807814
ompRp1,4.166666666666667,29,5,TGAAGACGCGGTAAGGGGCT,24,2793901
ompRp1,0.3333333333333333,6,5,TGAACTCCATTGGATTATTC,1,2796337
ompRp1,0.3333333333333333,6,5,TGAAATCAAGTGTGTATGAG,1,2785505
ompRp1,17.0,106,5,TCTCATTATTTTCCCTGATA,101,2786379
ompRp1,2.3333333333333335,18,5,TCGGTCGCAGGATCCTGTGA,13,2787561
ompRp1,13.333333333333334,84,5,TCGGACTAGCATCCAGGTCT,79,2786063
ompRp1,7.333333333333333,48,5,TCGCCTAGGCTGTAGGCCTA,43,2789483
ompRp1,17.0,106,5,TCGATTATGGGAAGAGAGGC,101,2820278
ompRp1,0.5,7,5,TCGAGAGGGTTCCTATTAGC,2,2774671
ompRp1,1.6666666666666667,14,5,TCGACCACACCCCGTCGCAT,9,2782656
ompRp1,19.5,121,5,TCCTCGTGTGGGCATATAAA,116,2777226
ompRp1,4.5,31,5,TCCTACCTTCCTACCTCTCG,26,2805678
ompRp1,2.8333333333333335,21,5,TCCCTGTGGCCACCAGCGTG,16,2769318
ompRp1,0.3333333333333333,6,5,TCATGATTGCAGCTAGGGTC,1,2804913
ompRp1,3.5,25,5,TCAGGTAAGTGAGTGAGAGC,20,2794399
ompRp1,0.3333333333333333,6,5,TCAGAGCGGTAGAGGAAATT,1,2777430
ompRp1,17.833333333333332,111,5,TATTGATATCCAGTTGGCAG,106,2778180
ompRp1,0.3333333333333333,6,5,TATGAGCCCGTTGCTGAGTC,1,2808949
ompRp1,12.666666666666666,80,5,TATCGCCGGAATTAGATGTC,75,2786115
ompRp1,22.333333333333332,138,5,TATCCTTAGAGCGCTACACT,133,2792565
ompRp1,0.3333333333333333,6,5,TATAGCGTCTCACATCCCAA,1,2772232
ompRp1,0.3333333333333333,6,5,TAGACTTTGTGGAAGTGTGG,1,2784748
ompRp1,0.3333333333333333,6,5,TACTTGGTCGGACAGGTTTA,1,2823692
ompRp1,0.3333333333333333,6,5,TACGGACAGTGCGCAGGAAA,1,2820329
ompRp1,0.3333333333333333,6,5,TACCTTATGTTTACGACTTA,1,2781075
ompRp1,8.333333333333334,54,5,TACCTGTGAGCAGTTTTACG,49,2812738
ompRp1,33.5,205,5,TAATTGACGACTCCCCCATG,200,2803070
ompRp1,0.5,7,5,TAATATTGGACAGTAAAGGA,2,2767324
ompRp1,21.833333333333332,135,5,TAAGGGGGTTCTGGGCAGAT,130,2817961
ompRp1,3.3333333333333335,24,5,TAAGAGTCCGATCCTTTGGT,19,2820752
ompRp1,6.666666666666667,44,5,GTTTGTCGGGGTACCTAATA,39,2776785
ompRp1,0.3333333333333333,6,5,GTTATAACCTGGCCTACGGA,1,2811159
ompRp1,15.833333333333334,99,5,GTGTGCATGAGCATTCATTC,94,2793155
ompRp1,0.3333333333333333,6,5,GTGTCCAGGATAACCCAATA,1,2787027
ompRp1,0.3333333333333333,6,5,GTGGCGCTTTAGCAACTGAG,1,2816926
ompRp1,0.3333333333333333,6,5,GTGGAGTCCGCCTGGATCCT,1,2820144
ompRp1,0.3333333333333333,6,5,GTGCTGTATAGGTAAGAGGG,1,2778994
ompRp1,34.666666666666664,212,5,GTGCTGACTTTTAACAGTTT,207,2817706
ompRp1,71.16666666666667,431,5,GGTTAGGAGAATTCAATTGT,426,2809405
ompRp1,8.5,55,5,GGTCGATATTGTCATAAGAG,50,2787640
ompRp1,1.6666666666666667,14,5,GGTCATTCAGCGATAAGCAG,9,2790836
ompRp1,20.5,127,5,GGTAATATAGTATTCTATGA,122,2804857
ompRp1,6.0,40,5,GGGGTTTAGAGGACTAATTA,35,2782045
ompRp1,18.166666666666668,113,5,GGGGCTTGGTAAAGGACTAT,108,2810179
ompRp1,4.5,31,5,GGGAAGCGTGACACCTGGTG,26,2783435
ompRp1,2.1666666666666665,17,5,GGGAAAGGGCGAAAAATGAC,12,2785509
ompRp1,2.0,16,5,GGATCGGCCAGTAAAGAGAG,11,2814705
ompRp1,0.6666666666666666,8,5,GGAGGATAAGAAGACAGCGA,3,2780238
ompRp1,1.3333333333333333,12,5,GGACAATCAGTCCTGCTGCT,7,2770215
ompRp1,0.3333333333333333,6,5,GGACAACGCGCCGTATCGTC,1,2800980
ompRp1,0.3333333333333333,6,5,GGAATGCCATTATCCCTAAG,1,2780739
ompRp1,16.5,103,5,GGAACGTGCTTCACTCAATA,98,2766198
ompRp1,1.3333333333333333,12,5,GCTCATCCCTGGCGCGCGCG,7,2802208
ompRp1,3.1666666666666665,23,5,GCTAAGCCAAGGACACAAAG,18,2790183
ompRp1,20.5,127,5,GCGTCTCATCCAAATGCCAT,122,2824091
ompRp1,5.666666666666667,38,5,GCGGTGTCTATTCAAGGAAT,33,2770991
ompRp1,0.5,7,5,GCGCCTACAGTCCAGGCTGG,2,2813736
ompRp1,2.3333333333333335,18,5,GCGCCCGTAGCGAATCGATC,13,2813413
ompRp1,0.3333333333333333,6,5,GCCTTGCACAGTTCTTTTAG,1,2772138
ompRp1,13.166666666666666,83,5,GCCTGCGAAAGATAGGGTTT,78,2799426
ompRp1,0.3333333333333333,6,5,GCCATGTGATCTAAAATAGT,1,2776801
ompRp1,0.3333333333333333,6,5,GCATTTCCTCGGACTATAGC,1,2770122
ompRp1,0.3333333333333333,6,5,GCAGACTACTGGTCTACCAA,1,2810331
ompRp1,6.5,43,5,GCACAAAGCGGCGATCCGAC,38,2791514
ompRp1,0.3333333333333333,6,5,GATTGATGTACTTTCACTAT,1,2816771
ompRp1,0.6666666666666666,8,5,GATCTTAGTCCAAGGCCCCA,3,2793387
ompRp1,24.666666666666668,152,5,GATAGTGACATCTCCCGATT,147,2795795
ompRp1,19.166666666666668,119,5,GAGTTTGATGGAACGACCAT,114,2774454
ompRp1,13.833333333333334,87,5,GACCTACTTGGTCTTTAAGA,82,2766349
ompRp1,0.3333333333333333,6,5,GACCACATGGCAGCTCCCCA,1,2815890
ompRp1,0.3333333333333333,6,5,GAACTGATTATGGGACAACA,1,2804545
ompRp1,1.1666666666666667,11,5,CTTTGTTGATTGGTACACTC,6,2815929
ompRp1,30.166666666666668,185,5,CTTTACCATTGCCCTGTTTA,180,2808779
ompRp1,0.6666666666666666,8,5,CTTGGGTTAGGGCAGGCACG,3,2811405
ompRp1,0.3333333333333333,6,5,CTTCTGGGTCATACCGCGCT,1,2795661
ompRp1,23.833333333333332,147,5,CTTCAGTAATTTATCGAACA,142,2790736
ompRp1,27.666666666666668,170,5,CTTATGAAATAAGCTATGTC,165,2779159
ompRp1,1.8333333333333333,15,5,CTTAATAGCATCCGGTGTTC,10,2793102
ompRp1,0.5,7,5,CTTAATAAGAACACACGCCT,2,2788289
ompRp1,0.3333333333333333,6,5,CTGTGCATTTTCTTCATACT,1,2781539
ompRp1,21.0,130,5,CTGTCGTAGTGACAGAAAGG,125,2770577
ompRp1,10.333333333333334,66,5,CTGGCCAGCTGTTTGATGGC,61,2780961
ompRp1,0.3333333333333333,6,5,CTCAGTCTTGACACAGTGGA,1,2815142
ompRp1,0.3333333333333333,6,5,CTATTGCCGGCCAGTGACTC,1,2808558
ompRp1,0.3333333333333333,6,5,CTATCTTATCGATCGGCCCA,1,2812893
ompRp1,6.833333333333333,45,5,CTATAGTTGTGATCCACTTA,40,2799234
ompRp1,21.333333333333332,132,5,CTACTCCGTAGGTGTACCTA,127,2792421
ompRp1,2.3333333333333335,18,5,CGTTTTAGACTTACACAGCT,13,2787739
ompRp1,7.5,49,5,CGTATTCCGGGCACTTGCGT,44,2781148
ompRp1,7.0,46,5,CGGGTGTGTGCGAGACATCG,41,2814460
ompRp1,0.3333333333333333,6,5,CGGGCTCGACGGAGCCACAC,1,2818899
ompRp1,3.6666666666666665,26,5,CGGCAGTACTGCTGATGATC,21,2802691
ompRp1,20.666666666666668,128,5,CGCTGTGACATGACTAGACC,123,2803568
ompRp1,25.666666666666668,158,5,CGCTGATTCAGCACCCATTG,153,2803806
ompRp1,0.6666666666666666,8,5,CGCTCGGTCTCTACCCCCTG,3,2787458
ompRp1,0.5,7,5,CGCGGTTACTAATATTTATA,2,2808064
ompRp1,28.333333333333332,174,5,CGCGACGTGCGGAGTGAAGT,169,2770446
ompRp1,23.666666666666668,146,5,CGACGTAGAGCTTTGGAGGG,141,2789560
ompRp1,1.6666666666666667,14,5,CGACGATCGATGCCCATCTT,9,2788038
ompRp1,17.333333333333332,108,5,CCTTTCGCAAATCGCTGGCC,103,2823159
ompRp1,0.6666666666666666,8,5,CCTTGAGTCTGAAAATCGAT,3,2805731
ompRp1,0.3333333333333333,6,5,CCTTCTGAAAATTCGGTGAA,1,2783697
ompRp1,0.3333333333333333,6,5,CCTGATTACGAGATTGGCGG,1,2810473
ompRp1,1.5,13,5,CCGGCCGGCTGTTCATCCGT,8,2780044
ompRp1,0.3333333333333333,6,5,CCGGATGTCTACATGATGAA,1,2797529
ompRp1,0.3333333333333333,6,5,CCCTTGACCTCCCTCAGTGT,1,2780612
ompRp1,20.5,127,5,CCCTCACCCCGGGATTTGAT,122,2797917
ompRp1,8.5,55,5,CCCGTCACGCATCAAAATCA,50,2775167
ompRp1,1.1666666666666667,11,5,CCCCGGAATTGTTCTAGGGG,6,2797234
ompRp1,0.3333333333333333,6,5,CCCCGCAAGATGGGCTACGG,1,2798011
ompRp1,0.3333333333333333,6,5,CCCAAACCCCATCTCTTATC,1,2808456
ompRp1,6.5,43,5,CCAGATGGCATCAGGTATAT,38,2791323
ompRp1,29.166666666666668,179,5,CATTTAAGTCTTAGGGTACA,174,2820106
ompRp1,25.0,154,5,CATTAGACCGCATTGTGATC,149,2770959
ompRp1,1.3333333333333333,12,5,CATGGTCACTCCAAGTGACT,7,2812967
ompRp1,1.6666666666666667,14,5,CATCATGGAACTGTCAAGCA,9,2770955
ompRp1,1.0,10,5,CATCAGGCTGGGTAACATGC,5,2814412
ompRp1,2.0,16,5,CAGGATGGGCAAGCCTTCCC,11,2766861
ompRp1,10.666666666666666,68,5,CACGTAAAGTGGCCGAATAT,63,2802914
ompRp1,0.3333333333333333,6,5,CACGGCCACAGTCGGAACAG,1,2794661
ompRp1,22.333333333333332,138,5,CACCGTCACGAGTCTTGATG,133,2801596
ompRp1,0.3333333333333333,6,5,CACCACCTCATAAGTAGCGA,1,2790284
ompRp1,37.166666666666664,227,5,CACATTTAACGCTCCCATGC,222,2770377
ompRp1,0.3333333333333333,6,5,CACACCGGGATCAATCGTGA,1,2808838
ompRp1,3.1666666666666665,23,5,CACAACGATTAACAAGATTC,18,2822478
ompRp1,0.3333333333333333,6,5,CAAGATTGTACCTTTCATCG,1,2801056
ompRp1,0.3333333333333333,6,5,CAACGTTTCTTTAATGTAGT,1,2792325
ompRp1,5.166666666666667,35,5,ATTGAGGGATCTGCGAACCT,30,2793029
ompRp1,23.666666666666668,146,5,ATGTCCTGTACACATCGGTA,141,2784803
ompRp1,17.5,109,5,ATGGAATTGGGGCCTTATAC,104,2779198
ompRp1,0.3333333333333333,6,5,ATGCTGCGCGAGTGAGAACT,1,2786729
ompRp1,2.0,16,5,ATGAGATTCCATGGTGCCAA,11,2800794
ompRp1,30.166666666666668,185,5,ATGACAGGAATGCCTTCCCC,180,2781325
ompRp1,30.166666666666668,185,5,ATGAATTGGTGCTTCAGGCC,180,2784462
ompRp1,18.333333333333332,114,5,ATCTTTGTTTGGCGGGTTGA,109,2799439
ompRp1,22.0,136,5,ATCTTATTTTCCGTAGGATA,131,2765386
ompRp1,0.3333333333333333,6,5,ATCTGTTTGGTCAGATGGAT,1,2778302
ompRp1,27.0,166,5,ATCCATACCATAGAGAATTG,161,2801406
ompRp1,0.3333333333333333,6,5,ATAGATAGCCATATAACCAC,1,2770206
ompRp1,0.5,7,5,AGTAGAATACTTATGGGAGC,2,2820695
ompRp1,10.333333333333334,66,5,AGGGATGACCGTCGATCGTT,61,2819008
ompRp1,9.666666666666666,62,5,AGGATGTACGGCTCCTGCTT,57,2811196
ompRp1,6.0,40,5,AGGAGAGTCTGGGACGTAAT,35,2801368
ompRp1,0.3333333333333333,6,5,AGCGGTCCTTGATTTTCATC,1,2810330
ompRp1,0.6666666666666666,8,5,AGCGAGGCAGTCATAGCGCA,3,2812886
ompRp1,0.3333333333333333,6,5,AGCAAATTGTTGTGCGTCTC,1,2766032
ompRp1,1.6666666666666667,14,5,AGATCACCGCCTTCAGTGAG,9,2815953
ompRp1,7.5,49,5,ACTTTCGCTATCCCGTATGA,44,2803620
ompRp1,0.3333333333333333,6,5,ACTCTCCTGCAACGGTATCT,1,2783273
ompRp1,0.3333333333333333,6,5,ACTAGAGCGGCCGAACCCCT,1,2793844
ompRp1,4.333333333333333,30,5,ACGGCGCAACTGGGACCCAA,25,2810690
ompRp1,25.5,157,5,ACGCCGGGGTATGGTTGAGC,152,2794324
ompRp1,0.3333333333333333,6,5,ACCGGAATGGCGTCGGCCAC,1,2818359
ompRp1,0.5,7,5,ACCGCTAATAGAGCGCCTGG,2,2793694
ompRp1,20.5,127,5,ACCATTCCTCTGACGCATAA,122,2771166
ompRp1,0.3333333333333333,6,5,ACAGCGGCAAAAGTAGGGGG,1,2777066
ompRp1,24.666666666666668,152,5,ACAAGTCCCATACGACATTT,147,2788869
ompRp1,0.3333333333333333,6,5,ACAACCGATACTTCTATATA,1,2776253
ompRp1,0.5,7,5,AATCCTTCAGTCTTGCACCT,2,2821616
ompRp1,16.5,103,5,AATCCCCGTGTACCGGGGGA,98,2816099
ompRp1,0.3333333333333333,6,5,AATCACCTCCGCAGCGCAAA,1,2820212
ompRp1,7.166666666666667,47,5,AATATGGTAATGCATTAGCC,42,2785588
ompRp1,8.0,52,5,AAGTCCCCGGCATGGTGTCT,47,2806638
ompRp1,6.333333333333333,42,5,AAGGGTACTGCCGCTTTTTT,37,2798316
ompRp1,33.333333333333336,204,5,AAGCCCGCTTCATCCATGTA,199,2784941
ompRp1,33.333333333333336,204,5,AAGAAGGCAAGGTTTGACTT,199,2817404
ompRp1,0.5,7,5,AACAATTTTCTGCCAGACGT,2,2808370
ompRp1,7.333333333333333,48,5,AAATAAACTTAGGGTTTGTA,43,2807934
ompRp1,0.3333333333333333,6,5,AAAGTAGGAGTTCTAATTCA,1,2794961
ompRp1,32.333333333333336,198,5,AAACGGTCCGCGCACGAATG,193,2805127
ompRp1,8.0,52,5,AAAATGCGTAGCCTCATCAG,47,2793948
ompRp1,8.0,43,4,TTTTCATCTCCCTGTTTATC,39,2811363
ompRp1,0.8,7,4,TTTGTAAGTTATCGAGGGAA,3,2772750
ompRp1,0.4,5,4,TTTCGAGTGATTGGCGTGTT,1,2818078
ompRp1,26.8,137,4,TTTCATTACTACGTTTGCCC,133,2814233
ompRp1,0.4,5,4,TTGTTCCGGGTCTGGTGAGG,1,2793785
ompRp1,33.4,170,4,TTGTGGGAATACTAAATCAA,166,2812569
ompRp1,0.4,5,4,TTGTCTTTTAGACGGAAGGC,1,2773958
ompRp1,9.4,50,4,TTGGCGGGCTGCCTGCTTGC,46,2784289
ompRp1,9.2,49,4,TTGACAAGTTGTTTTGTCTC,45,2773223
ompRp1,0.4,5,4,TTCTGGCGTATCTCTGGTTA,1,2790694
ompRp1,9.2,49,4,TTCGACCACGATAAACCGGG,45,2813948
ompRp1,0.4,5,4,TTCCGTCTTTGAGGAATTTT,1,2790930
ompRp1,1.6,11,4,TTCATAGACTCTGCTCAGCC,7,2783106
ompRp1,0.6,6,4,TTCAAGTAGTAGGCCCCAAT,2,2787602
ompRp1,0.4,5,4,TTATCTACAGTGCGATGTAC,1,2810983
ompRp1,3.0,18,4,TTATACGTTTAGTCCGTGTG,14,2773244
ompRp1,0.4,5,4,TTACTCCTCTAAGCGTTTAA,1,2791900
ompRp1,5.4,30,4,TTACGCAATCTTTTCGCCGG,26,2816236
ompRp1,20.8,107,4,TGTACAGCGGGCGCAGAAAC,103,2806441
ompRp1,0.4,5,4,TGTAATCTTTGTGTTTTGCC,1,2805456
ompRp1,8.2,44,4,TGGCCCTAAGCATCACCGAT,40,2822274
ompRp1,19.4,100,4,TGATTTAGTCAATTCGAATT,96,2779114
ompRp1,0.6,6,4,TGATCACACGCAACTTACAT,2,2799480
ompRp1,4.4,25,4,TGAGAGTCCCTCAAAGGCCA,21,2774857
ompRp1,38.4,195,4,TGACTCATGGCTATTCATAT,191,2770288
ompRp1,0.4,5,4,TGAACCCCCTAGTGTGTGAA,1,2817642
ompRp1,7.0,38,4,TCTCAGAAGATCTGCGACTA,34,2808737
ompRp1,0.4,5,4,TCGTTCAAGATGAGGTTACT,1,2802489
ompRp1,0.4,5,4,TCGGACTTATCCTAAAACGC,1,2767240
ompRp1,1.6,11,4,TCGAGTGCGTGTTCTCTAGC,7,2793318
ompRp1,6.6,36,4,TCGAACGCACAATATGAGAC,32,2819119
ompRp1,0.4,5,4,TCCTATTCGATTCGGTAGTA,1,2822140
ompRp1,3.4,20,4,TCCCAATGACGCCCTTCACA,16,2787117
ompRp1,23.6,121,4,TCATGGAGGTAGGGTGTGAT,117,2793620
ompRp1,36.4,185,4,TCAGTTCCGATCACGTTTGA,181,2815918
ompRp1,33.6,171,4,TCAGAGTGCTCAAATGTCGG,167,2793880
ompRp1,0.4,5,4,TCAAAATAGATCCAGCACAA,1,2820075
ompRp1,30.6,156,4,TATTTGAACGTGTCCTGGAG,152,2772755
ompRp1,33.4,170,4,TATGTGTTTCCGACATGACC,166,2773809
ompRp1,0.4,5,4,TATAGAGCTTCCCAGGCCGA,1,2776957
ompRp1,8.4,45,4,TAGGCCGCCAGGGCGTTTGG,41,2804075
ompRp1,18.6,96,4,TAGACATATGACCATGGCCC,92,2786142
ompRp1,11.2,59,4,TAGAATCACAGACTCGGCGT,55,2776754
ompRp1,0.6,6,4,TAGAAAAAAAGTCGCTGATA,2,2794870
ompRp1,26.6,136,4,TACTCTAGACGACTATGGGA,132,2780956
ompRp1,9.4,50,4,TACGTAGTCGCTGGCACATC,46,2770745
ompRp1,8.2,44,4,TAATCTTGGAGGGTTACAGA,40,2814874
ompRp1,0.8,7,4,GTTTGCAGTAGTCGTCAGTA,3,2772945
ompRp1,11.2,59,4,GTTTGAAAGATCTGGAAGAA,55,2771913
ompRp1,4.6,26,4,GTTTCCGTACGCAATTCAAG,22,2791658
ompRp1,0.4,5,4,GTTGTATAGTCCAACGTTGA,1,2823432
ompRp1,0.8,7,4,GTTGGTTAATCCGTCGTTTA,3,2810402
ompRp1,29.8,152,4,GTTGAGGCCCCGTACCTAAG,148,2767796
ompRp1,14.2,74,4,GTTCGCAGCGCAGATCCGTA,70,2781906
ompRp1,1.4,10,4,GTTCATTTAATCAAGGATGT,6,2765715
ompRp1,0.6,6,4,GTTAGAAGTTTGTCGTATAA,2,2767565
ompRp1,0.4,5,4,GTGGTGTTGTGCAATTCCCG,1,2795178
ompRp1,1.8,12,4,GTCTTCCATTCGATGTTGTC,8,2814222
ompRp1,18.0,93,4,GTCGGGCGCGAGATCAGTAT,89,2767872
ompRp1,4.2,24,4,GTCGAAGATAGGATAGCGGC,20,2821759
ompRp1,18.0,93,4,GTATTTAACATCGCACTTGC,89,2770407
ompRp1,0.4,5,4,GTAGAGTCGGGCGGGGTTGT,1,2811786
ompRp1,5.0,28,4,GTACGCGAAGTTGGTCACAC,24,2810809
ompRp1,77.8,392,4,GTAACTTCCTGCATAGCGAA,388,2790279
ompRp1,37.0,188,4,GGTGGTTCGATAATGTACTC,184,2767239
ompRp1,0.4,5,4,GGCGTACATACATGGCATTC,1,2778031
ompRp1,7.0,38,4,GGCCTCCGATTGTCTAAATT,34,2794225
ompRp1,24.8,127,4,GGCACTTCGTATGTTTCCCC,123,2775340
ompRp1,1.0,8,4,GGATCGTTGGCCGCCCGGCA,4,2784934
ompRp1,0.4,5,4,GGACGGGTTCAAGGGAACAG,1,2766990
ompRp1,11.2,59,4,GGAAATCTTTTCAATTCTCT,55,2789279
ompRp1,0.4,5,4,GGAAAACATGGGTTATTGAT,1,2790689
ompRp1,20.0,103,4,GCTGAGTCCGTCAGAGTGGC,99,2796911
ompRp1,1.8,12,4,GCTCGGTCCCGTGGCCGATG,8,2787031
ompRp1,6.8,37,4,GCTCCGACCTAGGGTAGTTC,33,2787997
ompRp1,0.4,5,4,GCGCGGGACGCCCTTTATTT,1,2815701
ompRp1,20.4,105,4,GCCACAGGGGTGAATGAAGT,101,2802814
ompRp1,24.4,125,4,GCATGAGAAGCGTTTCAACA,121,2810495
ompRp1,3.8,22,4,GCAGGCAGACAATTCGGCTC,18,2785402
ompRp1,15.0,78,4,GCAAGGTTTACATATGCGGC,74,2777317
ompRp1,0.4,5,4,GATACCTGAAGAGCCTTCAC,1,2779125
ompRp1,0.4,5,4,GACGTTTCTGTTCGACGGAC,1,2776971
ompRp1,0.4,5,4,GACGCAAGTCTCAGATACGA,1,2767553
ompRp1,10.4,55,4,GACCCGGCGGATTTTATTAG,51,2789471
ompRp1,0.4,5,4,GAATTCGAGTACTGACGCTA,1,2793184
ompRp1,0.4,5,4,GAATAAGTGCGCTATGTTTT,1,2795829
ompRp1,0.4,5,4,GAAGTTGGATCGGAGACTAC,1,2813501
ompRp1,0.4,5,4,GAACGGAATCTTTACAAAAT,1,2775439
ompRp1,26.0,133,4,GAAAATGTGTGTCACCATTG,129,2809667
ompRp1,2.8,17,4,CTTTGTGGTGGCCGCCCGGT,13,2775902
ompRp1,0.4,5,4,CTTGAGCGCATCGCTACACC,1,2812933
ompRp1,0.4,5,4,CTGGTCTGCATTTGTATCTA,1,2782699
ompRp1,7.0,38,4,CTGCTGGGGTACCGGCACCA,34,2806010
ompRp1,0.6,6,4,CTGATTCCGCCTTCTGCTTC,2,2779297
ompRp1,1.0,8,4,CTCCTGTTGGTAGACGTTAA,4,2765959
ompRp1,20.0,103,4,CTCCGAGCGTTTAGGGTGAA,99,2811230
ompRp1,0.4,5,4,CTCACCCAAAGTAGTCGCCG,1,2787136
ompRp1,0.4,5,4,CTAAATTGTCAAGTAGCCAC,1,2787178
ompRp1,0.4,5,4,CGTGACTATTTCAAGCAGCT,1,2799696
ompRp1,7.6,41,4,CGTCTGTCCTTCTCGCGTTG,37,2780284
ompRp1,0.4,5,4,CGTAGCCAAGGAGCAAACTT,1,2813601
ompRp1,26.8,137,4,CGGCGATGACATTGTGTCTT,133,2782840
ompRp1,0.6,6,4,CGGCCTGCCCCATGGCGCCG,2,2806064
ompRp1,3.2,19,4,CGGATCCCGTCCAGAATTCC,15,2781402
ompRp1,45.8,232,4,CGCGTATTGAGGGGATTAGG,228,2807758
ompRp1,0.4,5,4,CGCGATGGTCCTCGCGAAAC,1,2819132
ompRp1,0.4,5,4,CGCCAGGTTTTCCTCTGGAT,1,2781535
ompRp1,0.4,5,4,CGCACGGATTCCTAAGGTGA,1,2796212
ompRp1,49.8,252,4,CGCACGGACCCAACGAGGAA,248,2814214
ompRp1,2.2,14,4,CGAGTCCCCTCGGGAGTGTC,10,2788498
ompRp1,64.2,324,4,CGACCTCGGATGTACTGACC,320,2817863
ompRp1,43.2,219,4,CGAAGGACATGTTAGCCTAG,215,2796774
ompRp1,2.4,15,4,CCTTTTCGTGCGACCAACTC,11,2796866
ompRp1,0.4,5,4,CCTTTGGGGTCCCATTCTCA,1,2798229
ompRp1,7.8,42,4,CCTTCATCTGGACAGAAGTA,38,2793346
ompRp1,7.0,38,4,CCGTCGCATCTCGGTATAAA,34,2782302
ompRp1,5.8,32,4,CCGGTGGCGGTACGTGGTCG,28,2815884
ompRp1,20.8,107,4,CCGGTCCCACCATGCACTAG,103,2774924
ompRp1,0.4,5,4,CCGCATAATCTTTGTTCACG,1,2781570
ompRp1,16.4,85,4,CCCGGTCTCGCTTCATATTG,81,2780064
ompRp1,5.8,32,4,CCCGGGGCGTATACTCGTCT,28,2777897
ompRp1,16.8,87,4,CCCACGGCTATCTTACCGAA,83,2810531
ompRp1,5.4,30,4,CCATCCGAAGAGCTGAATAC,26,2786144
ompRp1,15.0,78,4,CCAGTCACGCTTAAAGCCCT,74,2781872
ompRp1,22.0,113,4,CCAGCTAAGGCATTTAGATT,109,2778051
ompRp1,14.4,75,4,CCACTCGGTGTCGCCCGAGC,71,2790904
ompRp1,23.0,118,4,CCACTCCAGAGTAGTAAGCG,114,2808265
ompRp1,24.0,123,4,CCAAGCAGCTACCATCAGTT,119,2820100
ompRp1,0.4,5,4,CCAAGATTGGGTAACATTTG,1,2779317
ompRp1,5.6,31,4,CCAAAGTAAAGATAGTTCCT,27,2794859
ompRp1,0.6,6,4,CATTAAAGTCAAGTATCCCG,2,2815961
ompRp1,22.2,114,4,CATGTATTGATTCAGGGTAA,110,2793435
ompRp1,0.4,5,4,CAGGCTCTTCCTACTCGGGA,1,2815141
ompRp1,13.2,69,4,CAGACCAGCGTTCGCGACAA,65,2803990
ompRp1,0.4,5,4,CAGAAACCGTCCTCACCTCC,1,2787945
ompRp1,0.4,5,4,CACTTTTCGTTGGGAACGAC,1,2819784
ompRp1,4.0,23,4,CACTGGACGAGGTAGGTATC,19,2814947
ompRp1,0.4,5,4,CACGATCCTGCTCTCAGAGT,1,2811401
ompRp1,28.4,145,4,CACCGGAGCAGGTTGGGGTG,141,2778037
ompRp1,0.4,5,4,CACCAAACTTCGTAATCTTA,1,2778702
ompRp1,0.6,6,4,CACATCAAGTCCGAACCAAC,2,2776036
ompRp1,0.4,5,4,CAAGTAAAGATCTTGCATAA,1,2818176
ompRp1,26.8,137,4,CAAGGTCGGTCTACTAGACG,133,2772707
ompRp1,16.8,87,4,CAACTCTCATCTTTCCTTTA,83,2812291
ompRp1,28.8,147,4,CAACTCGGTAAACCGACCTG,143,2795423
ompRp1,0.4,5,4,CAAACAAACAAAGCACCCCG,1,2799259
ompRp1,15.6,81,4,ATTGCCCGTGCTCTAGGCCT,77,2818727
ompRp1,6.2,34,4,ATTGACCGACAAGTTCTATA,30,2805488
ompRp1,21.6,111,4,ATTAAAGTAGACTATGGTTC,107,2781291
ompRp1,6.6,36,4,ATGGTACAGAACATCGTATA,32,2772720
ompRp1,0.4,5,4,ATGGACCTGCGTCACTAGAA,1,2779201
ompRp1,13.2,69,4,ATGCTCGTTACAAGAACTGA,65,2815681
ompRp1,11.4,60,4,ATGAAGCACCTACCACATCA,56,2805399
ompRp1,18.0,93,4,ATGAAAGTCTGTGGCATCGC,89,2780807
ompRp1,0.8,7,4,ATCGCTGCTCATAATCGGCG,3,2798584
ompRp1,26.6,136,4,ATCGCAGCTATTTCGCATTT,132,2772159
ompRp1,0.4,5,4,ATCAGGTAAGCTTCGAGAAA,1,2794395
ompRp1,35.0,178,4,ATAGTCCCTTCTCCAAAGTA,174,2796178
ompRp1,0.4,5,4,ATACGGGTAAATAAAACCGG,1,2796164
ompRp1,0.8,7,4,ATACAGCCGCTCCCCCGGGG,3,2771007
ompRp1,0.6,6,4,ATACAGCACTGGGGAGTAAG,2,2810813
ompRp1,26.2,134,4,AGTTGAAGGGAGGTAACTAT,130,2794430
ompRp1,0.4,5,4,AGTTCTGTGAGTTACAGGGA,1,2823963
ompRp1,1.8,12,4,AGTGACTTGGTGATGCGCGT,8,2784746
ompRp1,0.4,5,4,AGTAACGGGACCTCCTAAAG,1,2822204
ompRp1,3.2,19,4,AGCGTTCCCTAATCCACCTT,15,2807051
ompRp1,0.4,5,4,AGCCGTATCACGAAAGGTCC,1,2805606
ompRp1,0.4,5,4,AGCCAAGATCCCGTGGGATG,1,2806361
ompRp1,0.4,5,4,AGAGAAGTATGCGGTTTCCT,1,2786059
ompRp1,0.4,5,4,AGACGAAGAAACACGGAGAG,1,2792574
ompRp1,0.4,5,4,ACGTGCTTGTCGATCCTCTT,1,2808546
ompRp1,0.8,7,4,ACGTCGCCTCCCCTGATTGT,3,2803891
ompRp1,0.6,6,4,ACGCGTTCTGTTCGATGACC,2,2819974
ompRp1,21.8,112,4,ACGCAACCGATGAGTACGTC,108,2791850
ompRp1,37.0,188,4,ACGAGTCGAGATTGGGTATG,184,2804527
ompRp1,11.2,59,4,ACCATGTGTCACGCCGCACG,55,2789319
ompRp1,0.4,5,4,ACCACGTAGACACCTCGATT,1,2803925
ompRp1,0.6,6,4,ACATCGGGAAGACATGCGCC,2,2809630
ompRp1,2.8,17,4,ACAGGCCCGGTGTCTCCACT,13,2768766
ompRp1,0.4,5,4,ACAGCCAGGTCAGAGGCAAC,1,2788982
ompRp1,7.8,42,4,AATTAGTAACCCACCACGTG,38,2814656
ompRp1,34.6,176,4,AATCTCAGACGGAAACGGGT,172,2806910
ompRp1,31.6,161,4,AAGTCCCGCTGCCTTTCGGT,157,2775168
ompRp1,18.0,93,4,AAGTATAATGCCTTGAAACG,89,2790799
ompRp1,0.4,5,4,AAGGGGAGAACTTAAGGAAG,1,2775216
ompRp1,0.6,6,4,AAGGAATTATTGAACTGAGT,2,2780087
ompRp1,16.4,85,4,AACTTCGAATATTAATGTTT,81,2814402
ompRp1,0.6,6,4,AACGCAAGGGTAACTGGCGA,2,2794729
ompRp1,6.6,36,4,AACATAGGTAAGTGTAATGT,32,2807298
ompRp1,0.4,5,4,AACAGGCCGTCAGCCACGGC,1,2809765
ompRp1,11.6,61,4,AAATTTGAGTCCGGGAAACA,57,2796031
ompRp1,0.4,5,4,AAAGCCCTGAATCCACTTTG,1,2786171
ompRp1,7.0,38,4,AAAACATGACCTCATTTTGG,34,2800784
ompRp1,27.25,111,3,TTTTCCCCAACAGTAACTCC,108,2789751
ompRp1,25.5,104,3,TTTGGATCAATATATAACTA,101,2814097
ompRp1,0.5,4,3,TTTAGAAACGTATAACTCAC,1,2811362
ompRp1,29.5,120,3,TTGCTAGGATGTCTGTATTG,117,2768858
ompRp1,9.5,40,3,TTATCGCCCTAAACTATTAA,37,2773815
ompRp1,3.25,15,3,TTAGTGACACATAGTATAAT,12,2819658
ompRp1,0.5,4,3,TTACGTGGCGTGAACCGTTT,1,2792235
ompRp1,0.5,4,3,TTACATATTCGCGTACGGAC,1,2769647
ompRp1,77.0,310,3,TGTGGAACTGGTCATACTCC,307,2822484
ompRp1,0.5,4,3,TGTCTGTAACAATACGTGTC,1,2815823
ompRp1,0.5,4,3,TGTCTGCTTCGCACGGACCA,1,2816352
ompRp1,0.5,4,3,TGGTGGCTGGGGGCAGTATT,1,2808057
ompRp1,0.5,4,3,TGGCCTTGAAACCTCTCAGC,1,2772123
ompRp1,0.5,4,3,TGGACGCATGATAAAGGTAT,1,2782157
ompRp1,0.75,5,3,TGCGTCCATTCAATGGACCT,2,2782824
ompRp1,0.5,4,3,TGCGGACACGGTTAATCCCT,1,2772701
ompRp1,8.75,37,3,TGCCGTTCCGGCAATTCGTT,34,2809469
ompRp1,5.0,22,3,TGCACGAAATTTGTGTTATC,19,2819573
ompRp1,2.25,11,3,TGATTTTGACTAAGGGTGAT,8,2773919
ompRp1,50.25,203,3,TGATCGTGCAAAGCCAGAAA,200,2807584
ompRp1,6.0,26,3,TGATCCACTTCACAGTGGTG,23,2788301
ompRp1,0.5,4,3,TCTTCCTCTGATTTGGTTAT,1,2806523
ompRp1,0.5,4,3,TCTGTGGCGACGTGATGCTT,1,2796875
ompRp1,107.75,433,3,TCTACCTAGGACAAGCCCCT,430,2796161
ompRp1,0.5,4,3,TCGTTATCTCCAGCTACCGA,1,2776912
ompRp1,0.5,4,3,TCGTACATTGGTTATTCACT,1,2796674
ompRp1,0.5,4,3,TCGCTTTAAGGGATACACAG,1,2778625
ompRp1,38.75,157,3,TCGCTTAGAGGGTGCCCAAT,154,2823415
ompRp1,4.5,20,3,TCGAATCGTAATCACCCTCC,17,2769811
ompRp1,0.75,5,3,TCCGGATCGCGGTAGTGATG,2,2811135
ompRp1,14.75,61,3,TCCGCCCTAGCTAGCTGCAT,58,2770494
ompRp1,0.75,5,3,TCCCTTGAGTAACGTCCAAG,2,2781593
ompRp1,26.75,109,3,TCCCTGATTACGACTCAATG,106,2810882
ompRp1,5.5,24,3,TCCCTCCTTAGAGGACTTCG,21,2797516
ompRp1,0.5,4,3,TCCCTCCGCGTGCGGTTCGA,1,2781142
ompRp1,0.75,5,3,TCAAGAGGTACAGTTAGAGC,2,2801733
ompRp1,0.5,4,3,TCAAAAGGGGCATGTCCACA,1,2769859
ompRp1,12.0,50,3,TATTCCGGTTAATCCTTCTG,47,2777365
ompRp1,5.5,24,3,TATCATCAAGTGGGACTAGG,21,2813842
ompRp1,4.0,18,3,TATACGCTTAGAATGCTTTA,15,2779850
ompRp1,4.0,18,3,TAGCCTCGTGATGGAGTCAG,15,2824668
ompRp1,43.25,175,3,TAGAACCCCGTTAAGTCCAT,172,2779262
ompRp1,42.75,173,3,TACGGTTACCCACTGGCACG,170,2771021
ompRp1,2.75,13,3,TACGGCGGGCGCCAGAGTTA,10,2770910
ompRp1,3.75,17,3,TACCGCATCCACCATTCTAG,14,2799401
ompRp1,21.0,86,3,GTTTGATTCTAGCACCGCGG,83,2793737
ompRp1,25.75,105,3,GTTGGCAAAAGTAGACTGTA,102,2791208
ompRp1,0.5,4,3,GTTCTTCTACTCACTTGTCC,1,2812389
ompRp1,59.0,238,3,GTTCCATACCTGCATACCCT,235,2790415
ompRp1,10.25,43,3,GTGGACCAGATGTTCTAGTT,40,2773228
ompRp1,12.25,51,3,GTGCACTCGAGTGCCTTCTC,48,2785041
ompRp1,0.5,4,3,GTCGAACTGCGTACCTATCA,1,2793049
ompRp1,4.5,20,3,GTCCAGGGTGCCGCTTTCGG,17,2820068
ompRp1,24.75,101,3,GTCATTTCAATCAGCAGATC,98,2773950
ompRp1,1.25,7,3,GTAGAGCGCTTCGACTTTGA,4,2792643
ompRp1,0.5,4,3,GTAAGGGAGGACAGACGTAT,1,2792541
ompRp1,22.5,92,3,GGTTTTCGTGGGTTATTGGC,89,2770472
ompRp1,16.0,66,3,GGTTCGAATCTGTGCATAAT,63,2768677
ompRp1,1.25,7,3,GGTCTAGGGTCAGCGCGGAC,4,2781691
ompRp1,26.25,107,3,GGTAGACGCTACGACGATGT,104,2774239
ompRp1,0.5,4,3,GGGTACGATTATCCTAGCCT,1,2778036
ompRp1,16.5,68,3,GGGGCTGCTTGCCGGCCAGC,65,2802202
ompRp1,0.5,4,3,GGGCGATTCGATAGTCGAGT,1,2776959
ompRp1,11.25,47,3,GGGAGCCCGAAAAAAGGCCA,44,2773440
ompRp1,11.75,49,3,GGGAACCCCGTCATGCTAGG,46,2821810
ompRp1,13.75,57,3,GGCGTGGAAACCAATGTCAT,54,2766041
ompRp1,1.0,6,3,GGCGCACGGAATTATTGTAA,3,2775444
ompRp1,19.25,79,3,GGCCTTGGGTTTTTCCGGGG,76,2780965
ompRp1,0.5,4,3,GGCCCCCTTTTTTACTACGT,1,2814158
ompRp1,0.75,5,3,GGCACTACGGTCTTTATCAG,2,2810634
ompRp1,5.0,22,3,GGATGGCCCGAATACTTAGC,19,2771121
ompRp1,0.5,4,3,GCTTTGAGGGGATTATCTAG,1,2822975
ompRp1,1.0,6,3,GCTCGATCCATTGCTTTAGG,3,2790859
ompRp1,11.5,48,3,GCGTGAGAGCTTGTGACAAT,45,2810605
ompRp1,1.25,7,3,GCGTCGTTCAGAGGTGGGTT,4,2768388
ompRp1,38.75,157,3,GCGTCGCCCTTAAGCAGTAC,154,2785990
ompRp1,24.0,98,3,GCGGTTTGCGTCGCTCCCAA,95,2817246
ompRp1,30.75,125,3,GCGCCGCTCAATCACCAGTT,122,2797520
ompRp1,0.5,4,3,GCCCGTCGAAACGGTCCTGA,1,2803945
ompRp1,5.75,25,3,GCATAGTGAGTTTTCCGGCA,22,2814736
ompRp1,31.75,129,3,GATTCTGCAGAAATATTTTC,126,2792137
ompRp1,20.75,85,3,GATGGTTTTCGATAATGCTA,82,2794088
ompRp1,1.5,8,3,GAGTTACCGATTCAGCTTCT,5,2790844
ompRp1,21.5,88,3,GAGGCTGGGGGAGAGGTCGA,85,2817707
ompRp1,8.75,37,3,GAGGCCTAAGTTACAAATAT,34,2772722
ompRp1,0.75,5,3,GACTTAGGGGCATTATCACT,2,2786993
ompRp1,10.75,45,3,GACTCACGTTTTGCCTCCAT,42,2795473
ompRp1,14.25,59,3,GACGCAGATTCACCATCCAC,56,2809792
ompRp1,32.75,133,3,GACAAACGTGCCACTTTCTA,130,2776860
ompRp1,17.25,71,3,GAAGGCACTTCCAAAAGGAT,68,2784989
ompRp1,1.25,7,3,GAACAAGGTCAGAACGCAAT,4,2822706
ompRp1,1.0,6,3,CTTTGCCACACACTCCGTCT,3,2781184
ompRp1,0.5,4,3,CTTATCGCGTATGACGCCTG,1,2791371
ompRp1,9.0,38,3,CTGTGATGGGTCGAGTGATT,35,2777440
ompRp1,0.5,4,3,CTGTATCGTATAGACCGTAT,1,2795500
ompRp1,7.0,30,3,CTGGTGTTTATGACCCGGGC,27,2810627
ompRp1,10.5,44,3,CTCTTGATGATACGGCAGTT,41,2777109
ompRp1,0.5,4,3,CTCGCTTGCGGCAGGGCATT,1,2816925
ompRp1,6.25,27,3,CTCCTCTATGGAATGGCCAT,24,2779155
ompRp1,78.75,317,3,CTATCTTGAGTCAGAAGTTG,314,2809167
ompRp1,0.5,4,3,CTAACCCACCTCGTTCTTAA,1,2782244
ompRp1,5.75,25,3,CGTGTGCAGTACAGCCGGAA,22,2788236
ompRp1,0.5,4,3,CGTGGAGGCCCTCGTTCCAG,1,2768595
ompRp1,0.5,4,3,CGTCAGTCATTGTTGATCAA,1,2787205
ompRp1,0.5,4,3,CGTCACCGTGTTAGGGGTGT,1,2774323
ompRp1,0.75,5,3,CGTAAAATCCAAATCCAGTG,2,2806216
ompRp1,10.0,42,3,CGGGCGGTTCATGTACACTG,39,2815859
ompRp1,15.0,62,3,CGGGAGTGCCGCAAACCTAA,59,2791879
ompRp1,1.0,6,3,CGGAGCTCGCATGGCTATCG,3,2777799
ompRp1,34.75,141,3,CGAGATTAAAGAAGTCGCAT,138,2779943
ompRp1,0.5,4,3,CCTTCGAAACCCCTGCAGAA,1,2800275
ompRp1,7.25,31,3,CCTGCTCATTGGCTTTAGAG,28,2767704
ompRp1,1.5,8,3,CCGTTTGGTGGGTACAAGTT,5,2771092
ompRp1,26.25,107,3,CCCTGCACTGATGATGAGCT,104,2807470
ompRp1,6.5,28,3,CCCTATAACCGGAGTGAGAG,25,2800156
ompRp1,18.75,77,3,CCCGTACCAGTTTCGAGTTA,74,2767580
ompRp1,15.0,62,3,CCCATCGGAGGTTAGACAGG,59,2797967
ompRp1,9.0,38,3,CCCACATTTAGCAGGTGAGG,35,2816824
ompRp1,6.25,27,3,CCCACATAGCATAACAAATC,24,2816678
ompRp1,2.5,12,3,CCACGTGGCATTTGGATAAG,9,2778254
ompRp1,9.5,40,3,CATCGCGCTCAAGGGGCAAC,37,2768116
ompRp1,0.5,4,3,CATCAACCTCTGTCGGAGCA,1,2768650
ompRp1,0.5,4,3,CAGTTACATCTTTGCTGGTA,1,2822860
ompRp1,0.5,4,3,CAGTATAACCGTAAACGCTT,1,2787441
ompRp1,0.5,4,3,CAGGAAATATCTGAGGCCAG,1,2787566
ompRp1,9.5,40,3,CAGAGGTCTGGCCTCCACCA,37,2822134
ompRp1,1.75,9,3,CACGCTGGCCTCATTTCTAG,6,2774670
ompRp1,6.25,27,3,CAATGGTTGCTCTTCGAAAT,24,2805446
ompRp1,19.25,79,3,CAATCTACACAGTGGATCTG,76,2815848
ompRp1,19.0,78,3,CAAGGTAGACTAAGATGATA,75,2775657
ompRp1,36.0,146,3,CAAAGCCTATCAACTCTGCG,143,2817641
ompRp1,8.75,37,3,ATTGACCGGCCGAGCCGGTT,34,2771094
ompRp1,28.5,116,3,ATTCTTCTCGGATAGTCACT,113,2782061
ompRp1,2.5,12,3,ATTCCCGACCCAAGAGTTTG,9,2818547
ompRp1,12.5,52,3,ATGGTTCTGCACTTAGGATT,49,2804081
ompRp1,0.5,4,3,ATGGTGACGTAGCTACGTTC,1,2774278
ompRp1,14.75,61,3,ATGGGTCGATAATAATTAGG,58,2811323
ompRp1,0.5,4,3,ATGCTTGAGTGATCTTATGC,1,2807485
ompRp1,8.75,37,3,ATGAAGTCGCTTCGCGCGAG,34,2773129
ompRp1,12.5,52,3,ATCTAACAGGCCACCACACA,49,2775005
ompRp1,0.5,4,3,ATCCATCAAAGTCAGCTAAG,1,2789118
ompRp1,45.0,182,3,ATCAGATCATGAATGACGCG,179,2802864
ompRp1,0.5,4,3,ATCACGCTCTATATAGATCA,1,2815765
ompRp1,6.75,29,3,ATAATACGCTGAGCTCTTAT,26,2801635
ompRp1,0.5,4,3,AGTTGCGGAATACTTCCTGT,1,2773876
ompRp1,0.5,4,3,AGTTAAAATGCCGACTGAGT,1,2815065
ompRp1,18.75,77,3,AGGATATGATTTTAGTTCCG,74,2817014
ompRp1,0.5,4,3,AGGAGAAAGAGGTACCCGAT,1,2804834
ompRp1,57.5,232,3,AGGAATGATGCTGACAGCCA,229,2805133
ompRp1,1.75,9,3,AGCGTACTACCGTACAATTC,6,2803564
ompRp1,0.5,4,3,AGCGGTATAGTTATGGTCCT,1,2781032
ompRp1,0.75,5,3,AGAGCACATAATCTGCCAGT,2,2775773
ompRp1,0.75,5,3,ACTTGCTGCTTGTATTTACG,2,2780113
ompRp1,14.25,59,3,ACTGCCCGTGCGACTCTCCT,56,2768662
ompRp1,0.5,4,3,ACGTACGTACGTACTCTGGA,1,2819455
ompRp1,12.25,51,3,ACGGAAGCTTACTTATGTCC,48,2817969
ompRp1,3.0,14,3,ACGAGTCATAATGTAGCCGC,11,2807459
ompRp1,4.75,21,3,ACCTCAGCGAACAGCTAGCT,18,2792966
ompRp1,0.5,4,3,ACCTACGGTGGAATGTTCGT,1,2807643
ompRp1,3.75,17,3,ACCGGAGCCTGGTGTACAGC,14,2776789
ompRp1,0.75,5,3,ACCCCTCTTGTTTTTACGTA,2,2807275
ompRp1,0.5,4,3,ACCACCATCTCACTTCGCGA,1,2766523
ompRp1,0.5,4,3,ACATCACCCCTGTCTGCCTA,1,2799501
ompRp1,25.0,102,3,ACATATTGCCGCCAGTACGC,99,2815997
ompRp1,0.5,4,3,ACACCGTCCACCTCGGAGCG,1,2819350
ompRp1,11.0,46,3,ACAAATTGATTCTCCTCAGT,43,2824204
ompRp1,0.5,4,3,AATTGGTAGATCAGCAGCCA,1,2797192
ompRp1,22.5,92,3,AATTCTCGCGAAACTCCAAA,89,2791294
ompRp1,0.75,5,3,AATGGACCGCAGAACATATG,2,2772231
ompRp1,0.5,4,3,AATCGCTAAGGTGTTTGTAA,1,2793578
ompRp1,16.75,69,3,AATCACTAACATGAACTCGG,66,2795564
ompRp1,0.75,5,3,AAGCCCACAGATACGGACTG,2,2788652
ompRp1,18.5,76,3,AAATTATAGAACCGGTTTGA,73,2793320
ompRp1,26.75,109,3,AAAGGTTGAAGGCGCTTGCG,106,2780327
ompRp1,67.5,272,3,AAAGGTAAGTAGGTAGTGAC,269,2799977
ompRp1,15.75,65,3,AAACTGTCTGAGTACTGGGG,62,2777838
ompRp1,5.5,24,3,AAACGTATTCATTAAGCGCG,21,2770468
ompRp1,17.25,71,3,AAACCCAAAGTAAGAGCCAA,68,2769202
ompRp1,2.0,10,3,AAAATCTAAGGTACTTACCA,7,2804708
ompRp1,8.0,25,2,TTTTTTGAAGATAGTAGTAC,23,2811381
ompRp1,1.0,4,2,TTTTTGGGTAGTTGACGCAT,2,2804644
ompRp1,34.0,103,2,TTTTAACGCAGAGTGCCCCG,101,2824309
ompRp1,118.0,355,2,TTTGGGTCGCAGTTATTGTC,353,2784153
ompRp1,48.333333333333336,146,2,TTTCGCGCGAGCTGCATATG,144,2804368
ompRp1,12.666666666666666,39,2,TTTACCCTTTGTTCAGTCTC,37,2821400
ompRp1,0.6666666666666666,3,2,TTTACATCGAGAGAGGCGGA,1,2794235
ompRp1,2.3333333333333335,8,2,TTTAACTTTGCATCTGGTCA,6,2812574
ompRp1,0.6666666666666666,3,2,TTGTGAAATTAGTATCGGCT,1,2790257
ompRp1,2.3333333333333335,8,2,TTGGCTGGTGACAAGGACGC,6,2790572
ompRp1,1.0,4,2,TTGCTTTGTTAGGCCAACCA,2,2806815
ompRp1,31.666666666666668,96,2,TTGCGTATAAGAGAATTATT,94,2788440
ompRp1,39.666666666666664,120,2,TTGCCACTGGTGCGCGGAGC,118,2790492
ompRp1,21.333333333333332,65,2,TTGCACTGTGCTGTATGATA,63,2811533
ompRp1,0.6666666666666666,3,2,TTGAGATAAAAGAGTATATG,1,2806902
ompRp1,12.666666666666666,39,2,TTCGTGTGGGTATTTTTAGG,37,2772959
ompRp1,0.6666666666666666,3,2,TTCCGCAAAGCACGTACGGT,1,2791644
ompRp1,38.333333333333336,116,2,TTCACCGTCTCAGGCGATGC,114,2793933
ompRp1,0.6666666666666666,3,2,TTAGTTTGGGCCTGGATGTT,1,2790735
ompRp1,22.333333333333332,68,2,TTAGCCTTCCCGGAGAACGT,66,2781419
ompRp1,5.0,16,2,TTACTGGTCCTAAAAACCCA,14,2770344
ompRp1,0.6666666666666666,3,2,TTACGTTTCAGCATCTCCAA,1,2791035
ompRp1,23.666666666666668,72,2,TTACCTGTGGGGCTCGCGTC,70,2765379
ompRp1,31.0,94,2,TGTGGGTTAGCACGCCCGTC,92,2792940
ompRp1,0.6666666666666666,3,2,TGGTCTACCGTACCATTAAA,1,2770741
ompRp1,7.666666666666667,24,2,TGGGTGTCCACGACCGATTT,22,2824021
ompRp1,67.33333333333333,203,2,TGGGTCCTATTTCGGCCCTT,201,2792854
ompRp1,42.333333333333336,128,2,TGGAAACCGCTCCTTCCATT,126,2779306
ompRp1,22.333333333333332,68,2,TGCTTAAAGTGGCCCTCAGA,66,2779713
ompRp1,49.333333333333336,149,2,TGCCCCCACTCTCCTCAGGT,147,2810619
ompRp1,10.666666666666666,33,2,TGATCCTCGTGTAACCAATA,31,2813705
ompRp1,31.0,94,2,TGATAACCTCCCAGGACTGA,92,2781942
ompRp1,0.6666666666666666,3,2,TGACTCTTTAATGGCGGCTG,1,2772774
ompRp1,0.6666666666666666,3,2,TGAATTTTTCGGAGAGATAT,1,2807500
ompRp1,0.6666666666666666,3,2,TGAAAGAATGGTGCGATCAT,1,2785707
ompRp1,0.6666666666666666,3,2,TGAAAAAGTATGTTTTTAAC,1,2799296
ompRp1,0.6666666666666666,3,2,TCTTTCTGTGGCGCGACGTC,1,2797751
ompRp1,10.666666666666666,33,2,TCTGGCGCGCGCCCGTGCTG,31,2775180
ompRp1,3.0,10,2,TCTAGCTGCCTGAAAAAGAT,8,2771118
ompRp1,0.6666666666666666,3,2,TCTACGTCATATGCCCGAAT,1,2820314
ompRp1,11.666666666666666,36,2,TCGTGACGTTCCAGCTTCCT,34,2806939
ompRp1,48.333333333333336,146,2,TCGAGAGCGCCATGGTCCAG,144,2768096
ompRp1,8.333333333333334,26,2,TCCCGTCAAACCTGGACAAA,24,2811958
ompRp1,0.6666666666666666,3,2,TCAGCAGGTTGGGCAGGACC,1,2804132
ompRp1,0.6666666666666666,3,2,TCACATTAATGTGAAATTAA,1,2774656
ompRp1,1.0,4,2,TCACACTGAAATCCAGGGCA,2,2782389
ompRp1,39.333333333333336,119,2,TCAACCTCACACAATGTGCC,117,2808102
ompRp1,37.333333333333336,113,2,TATTCAGGGGGCATAGCCGT,111,2806918
ompRp1,43.333333333333336,131,2,TATGTCGTTGCACATAACTA,129,2784852
ompRp1,27.333333333333332,83,2,TATAATAGCCGCAGCACACA,81,2817739
ompRp1,25.333333333333332,77,2,TAGGGTATCTAGAACGAGCG,75,2781875
ompRp1,23.333333333333332,71,2,TAGGGGACAGCTACTCTCAC,69,2787744
ompRp1,68.66666666666667,207,2,TAGGGAACTTGGACAGCTGT,205,2792868
ompRp1,63.0,190,2,TAGACAAAGTCTAAAGACGT,188,2807798
ompRp1,0.6666666666666666,3,2,TACGCGGGCATGGTCAGACT,1,2824144
ompRp1,3.0,10,2,TACCGGGTGAATACTTACTA,8,2801419
ompRp1,0.6666666666666666,3,2,TACCATCCGCCGCAGCCTTA,1,2787572
ompRp1,2.0,7,2,TACAGATTGGTAATTGAGCT,5,2821744
ompRp1,1.0,4,2,TACACCGTTACTTGCGACGA,2,2810057
ompRp1,0.6666666666666666,3,2,TAAGCTCTAGAGACACAGAA,1,2820782
ompRp1,0.6666666666666666,3,2,TAAATGCGCTACGTCCGGTT,1,2807101
ompRp1,0.6666666666666666,3,2,GTTGTCAAGCTGTGATATAA,1,2810086
ompRp1,80.0,241,2,GTTCCAATTCCCATTCTGAA,239,2777140
ompRp1,0.6666666666666666,3,2,GTTCAGAAAAATTTTCGCTT,1,2819975
ompRp1,27.0,82,2,GTGTGACGTGCTGTTGCGCT,80,2804734
ompRp1,1.0,4,2,GTGTCCGAAGGACTCTACCT,2,2786992
ompRp1,1.0,4,2,GTGGTAGGCGGGTCTCGTAA,2,2775941
ompRp1,37.666666666666664,114,2,GTGCGGTTGTAGAAACGTCG,112,2795580
ompRp1,21.333333333333332,65,2,GTGCCCTTGTCTGGCTTCCT,63,2780825
ompRp1,23.666666666666668,72,2,GTGATTCATCCGTGAATAGT,70,2771454
ompRp1,28.666666666666668,87,2,GTGACGTTGTTCGCCAAGGA,85,2792417
ompRp1,20.333333333333332,62,2,GTCTGCCCACTTTCTCAACT,60,2781520
ompRp1,16.666666666666668,51,2,GTCCTAAGAGTTGCCTACTG,49,2800056
ompRp1,7.333333333333333,23,2,GTCAGGGTTAGTTGGTCTTT,21,2778251
ompRp1,0.6666666666666666,3,2,GTCACCCCGCACGATTTCGA,1,2767116
ompRp1,15.333333333333334,47,2,GTCAACAGTTAACACACTTG,45,2769998
ompRp1,0.6666666666666666,3,2,GTATTCGCCTATTAGATTGG,1,2804268
ompRp1,0.6666666666666666,3,2,GTATTATCGGTCTCCGAGTG,1,2813678
ompRp1,1.0,4,2,GTAGGGTGCTATGAGAGAAT,2,2810537
ompRp1,5.0,16,2,GTACGTGACTACAGTCGGAC,14,2799724
ompRp1,20.333333333333332,62,2,GTAATTCAACGGTAGGGACC,60,2811047
ompRp1,9.0,28,2,GTAACTAGGTATACTCGGTA,26,2786432
ompRp1,24.666666666666668,75,2,GGTAAAAGCGACACCACCAT,73,2774416
ompRp1,0.6666666666666666,3,2,GGGTAACCAAAGGTCCTAAT,1,2819421
ompRp1,1.0,4,2,GGGGTAAGCGTGGGTTTGCA,2,2810881
ompRp1,6.333333333333333,20,2,GGGGGGATCAGTGGATTTGG,18,2771956
ompRp1,36.333333333333336,110,2,GGGCGTACCGAACGTGTCAA,108,2810545
ompRp1,13.0,40,2,GGCTTCCCTCTCAACCGATA,38,2801813
ompRp1,33.666666666666664,102,2,GGCTCACGCCCAGATACGGA,100,2778330
ompRp1,0.6666666666666666,3,2,GGCGGGTGTCGCAGGACGGC,1,2824574
ompRp1,65.66666666666667,198,2,GGCAGTTCTCCGCAGGAATT,196,2789912
ompRp1,0.6666666666666666,3,2,GGCAGAAATAGGACGCGGCA,1,2793738
ompRp1,9.666666666666666,30,2,GGATTGGCATTGCAGTTCCT,28,2796237
ompRp1,26.0,79,2,GGATGGATACCGAAAAACCT,77,2806917
ompRp1,0.6666666666666666,3,2,GGACGAACTGTCGCGTCAAC,1,2790423
ompRp1,0.6666666666666666,3,2,GGACATGTGATAGCACGTAT,1,2804511
ompRp1,6.333333333333333,20,2,GCTGCTGGTTCTTCGACTTG,18,2774629
ompRp1,17.0,52,2,GCGTAACTGGCCTTTTACGA,50,2816002
ompRp1,8.333333333333334,26,2,GCGAACCTGGCGACTGATTA,24,2788433
ompRp1,62.666666666666664,189,2,GCCGAGACGTCCGTGATTTT,187,2778074
ompRp1,22.333333333333332,68,2,GCCGAACCCTAGAACGCGGC,66,2810911
ompRp1,0.6666666666666666,3,2,GCCCTTAGCCCTCGCTCGTT,1,2778093
ompRp1,1.3333333333333333,5,2,GCCCATCTCCAAATCTGCGA,3,2777408
ompRp1,55.0,166,2,GCATAAGGTTTACGCCGGTG,164,2798226
ompRp1,0.6666666666666666,3,2,GCAATGCAGATGGTATTCAG,1,2816568
ompRp1,2.6666666666666665,9,2,GATTTAGTGTGAAACAGCGA,7,2809576
ompRp1,12.0,37,2,GATGGGACATGTGATGCAAG,35,2773271
ompRp1,0.6666666666666666,3,2,GATCTTCTTTGTGAAGCAGG,1,2792652
ompRp1,19.666666666666668,60,2,GATCGAGGTTCTGGGAGGAA,58,2809623
ompRp1,94.0,283,2,GAGGCTTTGCCTGGCAAGAC,281,2780395
ompRp1,14.0,43,2,GAGGCGCATGCAAAAGTCGG,41,2786897
ompRp1,0.6666666666666666,3,2,GAGAACAGGAACGGGGAAAG,1,2788862
ompRp1,56.666666666666664,171,2,GACCTCAGCCGATAAGCTCT,169,2801232
ompRp1,2.0,7,2,GACCTCACCGCTTCAGCTTA,5,2806463
ompRp1,0.6666666666666666,3,2,GAATTTAGGTACATTGGAGA,1,2780129
ompRp1,5.0,16,2,GAATTATCCTGAGATGGACA,14,2821678
ompRp1,0.6666666666666666,3,2,GAACCGTCGGTCCTCAGCAC,1,2795806
ompRp1,0.6666666666666666,3,2,GAAAGGTACCAGACCGCACA,1,2785408
ompRp1,50.0,151,2,CTTTCGCAGAATTCGCAGAG,149,2811481
ompRp1,5.0,16,2,CTTGCCTCCTTATTTTAAGT,14,2791566
ompRp1,1.0,4,2,CTGTGGGGGGGATGGATGCT,2,2797319
ompRp1,0.6666666666666666,3,2,CTGTACTATTACTTGATATT,1,2770725
ompRp1,44.0,133,2,CTGCGCGTTAGAGATTTGGA,131,2819269
ompRp1,11.333333333333334,35,2,CTGATTTGCCAGAGTGCTGG,33,2790386
ompRp1,5.0,16,2,CTCGAATGGACACACGAGCA,14,2800167
ompRp1,0.6666666666666666,3,2,CTATTCGCAGTACCTTCCGG,1,2814444
ompRp1,3.6666666666666665,12,2,CTATCCGGGCCTGATCGCCC,10,2814490
ompRp1,1.0,4,2,CTATATATACCTGTTGCAAT,2,2767085
ompRp1,0.6666666666666666,3,2,CTACCTTGAACATTCATAGA,1,2797519
ompRp1,0.6666666666666666,3,2,CTAATGCAAGAGGCTGGCTG,1,2803740
ompRp1,0.6666666666666666,3,2,CTAAGTAGTCAGCTTATATC,1,2806628
ompRp1,0.6666666666666666,3,2,CGTGTAAATAATGCAGAGGG,1,2769195
ompRp1,27.0,82,2,CGTCCTTGGGTGTTTACTTG,80,2786420
ompRp1,3.0,10,2,CGTCATAGTACGACAATACC,8,2778062
ompRp1,4.333333333333333,14,2,CGGGCTGATCACAGCAAGGC,12,2780050
ompRp1,18.333333333333332,56,2,CGGCCACCAGTTTATGGGAT,54,2768364
ompRp1,78.0,235,2,CGCTCTATAGGTCCAGTTCG,233,2771970
ompRp1,36.0,109,2,CGCGTGGCAAGCGGGTGGGT,107,2802443
ompRp1,1.0,4,2,CGCATGTTAGATACCTCATG,2,2784107
ompRp1,1.0,4,2,CGAGTGGGAAGGTATATAGT,2,2811222
ompRp1,0.6666666666666666,3,2,CGACGTATCCTTACCATGGC,1,2824064
ompRp1,51.333333333333336,155,2,CGACAACATGCTGATTCCCA,153,2805413
ompRp1,53.333333333333336,161,2,CGAATTAGGGTGATAACTCC,159,2784932
ompRp1,22.0,67,2,CCTGTCGTTGAGATTCAAGA,65,2780799
ompRp1,36.666666666666664,111,2,CCGTGGCCCAGCGAACAGTG,109,2804725
ompRp1,7.666666666666667,24,2,CCGTGCCGCACTCTCTGAGG,22,2784998
ompRp1,54.333333333333336,164,2,CCGCACGACCCACTAGGGCA,162,2809006
ompRp1,28.0,85,2,CCGCAACGCTCGGGTAAAGA,83,2800666
ompRp1,0.6666666666666666,3,2,CCCCGGCTCGTGGCTCTTCA,1,2796927
ompRp1,0.6666666666666666,3,2,CCATTTTAACAACTTCGCCG,1,2772713
ompRp1,6.666666666666667,21,2,CCATTAGTAGGCGTCACATG,19,2807699
ompRp1,0.6666666666666666,3,2,CCACGACAAACCGCCACGTA,1,2779058
ompRp1,18.0,55,2,CATTCCAGTGAGTTAGGTGA,53,2773111
ompRp1,23.0,70,2,CATGCTTTTTTGACATTCGC,68,2801048
ompRp1,40.666666666666664,123,2,CATGCCGCTTGGAAGATCCC,121,2793563
ompRp1,0.6666666666666666,3,2,CATACGACGATTGCACGGCG,1,2792562
ompRp1,16.333333333333332,50,2,CAGTTAACGGGATAAGCACC,48,2803602
ompRp1,0.6666666666666666,3,2,CAGTCGCCACACAGATGGGG,1,2817803
ompRp1,0.6666666666666666,3,2,CAGTATTCCGACGGGGCAGA,1,2774991
ompRp1,0.6666666666666666,3,2,CAGGGTTGCATGCTAAGCAG,1,2791735
ompRp1,0.6666666666666666,3,2,CAGGGCTCCGAAGCCGTCAA,1,2814445
ompRp1,0.6666666666666666,3,2,CAGCCATCTTTCTTGCGGTG,1,2796320
ompRp1,9.0,28,2,CAGCAAAGCATTACGTCACG,26,2780464
ompRp1,57.0,172,2,CAGATGATCCCTGTCCAGAG,170,2824063
ompRp1,0.6666666666666666,3,2,CAGAAAACCAGAGGCGAGCT,1,2809927
ompRp1,6.333333333333333,20,2,CACGTGTCACACGGCTCGAG,18,2822766
ompRp1,56.333333333333336,170,2,CACCTATACACAATTGTCCT,168,2822213
ompRp1,15.0,46,2,CACAGGCTGAGAGAAATTAA,44,2777169
ompRp1,0.6666666666666666,3,2,CACACCTAGCATGTTATGAT,1,2804530
ompRp1,12.0,37,2,CACAAATTAGACAGTCGCCT,35,2767317
ompRp1,0.6666666666666666,3,2,CAATGAATGTTGTAATAGTT,1,2786170
ompRp1,31.0,94,2,CAAGGTTTATGGATTAACGG,92,2782038
ompRp1,1.0,4,2,CAAGAAGAGGGGCCTGTATT,2,2766322
ompRp1,0.6666666666666666,3,2,CAAAAGCTGGAGCCCGATTA,1,2797680
ompRp1,31.666666666666668,96,2,ATTATATGTGTGATAGAGAG,94,2817730
ompRp1,1.0,4,2,ATGTCTATATCTGGTTGTCT,2,2769737
ompRp1,37.0,112,2,ATGTATGTTGTATAGCAACT,110,2772291
ompRp1,0.6666666666666666,3,2,ATGCGGTCCGTCCCGCATTA,1,2789968
ompRp1,0.6666666666666666,3,2,ATCGTACTGGGCCGGGTCAA,1,2813343
ompRp1,69.66666666666667,210,2,ATCGGACATTCGTGATTGCA,208,2815830
ompRp1,6.666666666666667,21,2,ATCGCATGATTAGTCCCTTC,19,2798188
ompRp1,24.333333333333332,74,2,ATCCATCGAACCAGGCTTTT,72,2817864
ompRp1,0.6666666666666666,3,2,ATAGGAACTAATACGCACGT,1,2820552
ompRp1,0.6666666666666666,3,2,ATACTCTAATTCTTAAACCA,1,2780942
ompRp1,52.333333333333336,158,2,AGTTCCAACCCAGGCTTGAT,156,2813803
ompRp1,1.0,4,2,AGTGGTGGTGGGTGTCCCGG,2,2822428
ompRp1,2.3333333333333335,8,2,AGGTCTACCCGATGAGCGGA,6,2786244
ompRp1,42.666666666666664,129,2,AGGTAACTCGTCCCTTAGTT,127,2816653
ompRp1,3.3333333333333335,11,2,AGGTAAAGGTTGAGATCAAT,9,2767964
ompRp1,0.6666666666666666,3,2,AGGGGGTCAATATTGAGTTC,1,2785603
ompRp1,25.0,76,2,AGGCGTCTCTTGTATAGCGG,74,2798440
ompRp1,0.6666666666666666,3,2,AGGCAAGGCACCTCGATGCT,1,2807685
ompRp1,0.6666666666666666,3,2,AGGATCTTAGCGTTGAAATC,1,2777341
ompRp1,0.6666666666666666,3,2,AGGAGGGTCCACGGCAGTGT,1,2791070
ompRp1,7.333333333333333,23,2,AGGACAGCCGTGGTCGTTTG,21,2771008
ompRp1,3.0,10,2,AGCGGTGCACAGTTCAACTC,8,2810224
ompRp1,3.0,10,2,AGATTTGTTTTTTCTAGACT,8,2790606
ompRp1,39.0,118,2,AGAGAAGCGCTGAACAGCCT,116,2772408
ompRp1,4.666666666666667,15,2,ACTTTGGTGTAGATGATACG,13,2817716
ompRp1,0.6666666666666666,3,2,ACTTGTGCGACTGCACAATC,1,2811727
ompRp1,1.3333333333333333,5,2,ACTACTTATATGGGAGACTA,3,2795566
ompRp1,35.0,106,2,ACGTCGCGTCTTCGGCCCTA,104,2820652
ompRp1,58.666666666666664,177,2,ACGGCAGAGCCTTCCGGGTT,175,2791568
ompRp1,1.0,4,2,ACGCGTGACTAGCGGCCTTG,2,2823166
ompRp1,0.6666666666666666,3,2,ACGCGCGAGGCAGCGTCTAC,1,2768184
ompRp1,0.6666666666666666,3,2,ACGCACATCTCACGCCCTAT,1,2775586
ompRp1,5.0,16,2,ACGAATTGAACGTTTATTCC,14,2821712
ompRp1,2.3333333333333335,8,2,ACCCCTTCTACACTAGGTAA,6,2783385
ompRp1,4.0,13,2,ACCAATTAGGCTGTGAGTTG,11,2797497
ompRp1,0.6666666666666666,3,2,ACATGATATGTAGCGGACCA,1,2765430
ompRp1,0.6666666666666666,3,2,ACACTTCGGGGGCTAGAAAT,1,2768983
ompRp1,15.0,46,2,AATTCTTGCGGGTAGCATGG,44,2771859
ompRp1,26.0,79,2,AATGATGACGAAGTGGTCTG,77,2788988
ompRp1,0.6666666666666666,3,2,AATCGTCGTTCCTACGACCT,1,2784525
ompRp1,0.6666666666666666,3,2,AATATGATAGTTGGCGATAG,1,2799076
ompRp1,0.6666666666666666,3,2,AATAACATTGTTTCTTTCGG,1,2821756
ompRp1,0.6666666666666666,3,2,AAGTGGGGACCGTAATGACC,1,2785626
ompRp1,0.6666666666666666,3,2,AAGGACCGTGAGGAATGCGC,1,2807544
ompRp1,0.6666666666666666,3,2,AAGATGGGACTGGGCTTGAA,1,2790363
ompRp1,33.666666666666664,102,2,AACCTTCCGATGCTCACTGC,100,2797879
ompRp1,1.0,4,2,AACCGGTGAGCAATAAATCT,2,2814815
ompRp1,37.666666666666664,114,2,AACCACACATCATCTGTTTA,112,2799869
ompRp1,0.6666666666666666,3,2,AACCAAGAAGATTGTCACTT,1,2819690
ompRp1,3.0,10,2,AAAATCCTGGCAGCTTAAGA,8,2786290
ompRp1,11.666666666666666,36,2,AAAATAGTGAGGGTATACTC,34,2797881
ompRp1,1.0,2,1,TTTGCGTGCCCATTCGTGCC,1,2782022
ompRp1,13.0,26,1,TTTGCGACTGGTTTGATCGC,25,2802354
ompRp1,3.5,7,1,TTTATCGTCGCCAAATCAGA,6,2798953
ompRp1,1.0,2,1,TTGTCGTGCTAGTCTCTCGT,1,2765617
ompRp1,55.5,111,1,TTGGGATAATTCTGTTACTA,110,2789408
ompRp1,25.5,51,1,TTGCGATTTCCGGATCATAG,50,2780112
ompRp1,5.5,11,1,TTGCCTTAAACGATACATCT,10,2819365
ompRp1,37.5,75,1,TTGAAGTCCCGCTTACCTTA,74,2770925
ompRp1,25.0,50,1,TTCTTCTTCGCAATCTTTGA,49,2811007
ompRp1,20.5,41,1,TTCTAGGTAGCAATAGATTC,40,2789952
ompRp1,1.0,2,1,TTCCACGTCGGCGGAGGCGC,1,2767876
ompRp1,25.0,50,1,TTCACGTGGATTTCTTCAAA,49,2775178
ompRp1,48.0,96,1,TTCACAGGTCGCTTAATGCC,95,2819441
ompRp1,32.5,65,1,TTACGTGTTCCTTCAACAGT,64,2780173
ompRp1,23.5,47,1,TTACCCCCCCTCGGTCAGTC,46,2779732
ompRp1,1.0,2,1,TTAATAACTCGCTCAGTCCT,1,2789904
ompRp1,1.0,2,1,TGTTTTAAAATCTCTTTTCA,1,2799486
ompRp1,26.0,52,1,TGTTTCGATAATGGAACAGG,51,2788438
ompRp1,12.5,25,1,TGTTAGAGGCAACAGTAATT,24,2822346
ompRp1,44.0,88,1,TGTGCGCCTCTATAGGCCGA,87,2810242
ompRp1,44.5,89,1,TGTCCTAGACTTTATCATTG,88,2823852
ompRp1,47.0,94,1,TGTCACGGAGTGAGGACGTG,93,2781290
ompRp1,107.0,214,1,TGTAGCTTATATTGGGACGC,213,2815157
ompRp1,32.5,65,1,TGCGTTTCCCGAAATATCGT,64,2776621
ompRp1,1.0,2,1,TGCGAAAGAATGGCAACGGA,1,2783965
ompRp1,20.0,40,1,TGCCGGTTGAGGTTTTTGCA,39,2770225
ompRp1,25.5,51,1,TGCATGCGCTTTAAATAGAC,50,2779331
ompRp1,53.0,106,1,TGATATACACCGTGGTGAAT,105,2766182
ompRp1,70.0,140,1,TGATAGCGTAGCGTCAGATA,139,2809087
ompRp1,7.0,14,1,TGAGCTAAAACGGTAAAACT,13,2778197
ompRp1,116.5,233,1,TGAGCCGGGCTGCATCGAGA,232,2809908
ompRp1,6.5,13,1,TGAATCAGCCCTGGTCTTCA,12,2812897
ompRp1,82.0,164,1,TCTCGACAGCATAAAACGAC,163,2815193
ompRp1,46.5,93,1,TCTAGCTAGTTGAACTTCTG,92,2823389
ompRp1,59.5,119,1,TCTAAGGAGCCATGTAGCAT,118,2783416
ompRp1,2.0,4,1,TCGCGGCTCTTTTAGTGACA,3,2819209
ompRp1,1.0,2,1,TCATCCTAGCATTGGCTCGT,1,2821465
ompRp1,24.0,48,1,TCACCATGATAGGAGTATCA,47,2766948
ompRp1,61.5,123,1,TATTTCACATCAACTGTCTA,122,2772716
ompRp1,75.0,150,1,TATTGTTATCGTTGATCTTA,149,2772019
ompRp1,3.0,6,1,TATTGCCTACTTTAACCCGG,5,2778784
ompRp1,72.0,144,1,TAGGCGAACTTATTCGGGTC,143,2799332
ompRp1,1.0,2,1,TAGATAGACAACTATGACTT,1,2821795
ompRp1,2.5,5,1,TACCTACCCGTCTATACCCT,4,2785231
ompRp1,41.5,83,1,TAATCGGAAGTTACAGGGAG,82,2816701
ompRp1,1.0,2,1,TAACCGAGACATCCGGCCCC,1,2785733
ompRp1,1.0,2,1,TAAACAGTAGGGCCACTTAA,1,2820080
ompRp1,66.5,133,1,TAAAAGTTCATTGGGTCAGT,132,2784779
ompRp1,57.5,115,1,GTTTTGGAGGCACGATATTT,114,2812732
ompRp1,1.0,2,1,GTTCGCTCGAAGCATGGTCT,1,2788457
ompRp1,1.0,2,1,GTTCAGGCGGAACCTACGGG,1,2812055
ompRp1,25.0,50,1,GTGGCTACAGCCCTGGGCAT,49,2784692
ompRp1,25.5,51,1,GTGCGGAATTGGCCACTCTC,50,2784689
ompRp1,1.0,2,1,GTGCAAACGAACATTTTCGA,1,2783666
ompRp1,7.0,14,1,GTCCAGGCCCAGGTGGAGTT,13,2772203
ompRp1,6.0,12,1,GTATGGACCTCAAATAGACT,11,2811115
ompRp1,1.0,2,1,GGTTGAGCAACCACATCAAA,1,2797486
ompRp1,1.0,2,1,GGTTCCGCTTAATGCCAGGT,1,2809575
ompRp1,8.5,17,1,GGTAATCTCTGTACCCTTCC,16,2815478
ompRp1,1.0,2,1,GGGTGAACTTCAGGGGTTGA,1,2813370
ompRp1,1.0,2,1,GGGGCTGTTATCAGCAAATA,1,2798430
ompRp1,18.5,37,1,GGGATGCGATCATAATTTGT,36,2778682
ompRp1,1.0,2,1,GGCGAGACTGGGTTACCCGT,1,2783969
ompRp1,39.0,78,1,GGCGAACAGATAGATTAGTG,77,2816217
ompRp1,1.0,2,1,GGCAGGGCTCCCATTATCCT,1,2790823
ompRp1,1.0,2,1,GGAGGATCACAAACATTACA,1,2812708
ompRp1,35.5,71,1,GGACTATGGCCGGGCTACCC,70,2815629
ompRp1,2.0,4,1,GGACAGGTCTAAGTTGGAGT,3,2779304
ompRp1,3.5,7,1,GGAACCGGACCTTAGCAGCA,6,2777136
ompRp1,55.5,111,1,GCTTGGTAGAGTCCACGCCG,110,2770510
ompRp1,1.5,3,1,GCGTTGCGTGAAGGCGTCTC,2,2810317
ompRp1,27.0,54,1,GCGGACTGCAACTTGTTTGG,53,2772874
ompRp1,73.5,147,1,GCGCGGACACGGAGATGACA,146,2783526
ompRp1,24.5,49,1,GCGCAAAAACAAGACTGCCA,48,2786272
ompRp1,66.5,133,1,GCCTGCAACGGATCGCGCCC,132,2776851
ompRp1,1.0,2,1,GCCAACCTAGCGATTAGCCC,1,2777740
ompRp1,2.5,5,1,GCATGCATTTGCCTGCATCC,4,2769321
ompRp1,1.0,2,1,GCAGGTTCTTATGGCACAAC,1,2797324
ompRp1,2.0,4,1,GCAGATGCCACTATCCCTCT,3,2817342
ompRp1,1.0,2,1,GCAAGTATTCACTCGGAATT,1,2793881
ompRp1,93.5,187,1,GCAACCTGTTTGTGACTCCG,186,2783463
ompRp1,78.0,156,1,GATGTCCAAGCGCTTCGTTA,155,2821453
ompRp1,1.0,2,1,GATCTATGCGATGACCTTTG,1,2796883
ompRp1,1.0,2,1,GATCGACTGCACATCCTGGA,1,2773836
ompRp1,55.0,110,1,GAGGCCTATATAAGGTAAGT,109,2798057
ompRp1,40.5,81,1,GACGCCGACACTCAGGTTGA,80,2788040
ompRp1,2.0,4,1,GACGATCTCAGAGCAGGCGG,3,2820756
ompRp1,1.0,2,1,GACCAGCCTACTAGGCAACT,1,2809987
ompRp1,81.0,162,1,GACATCGGATAGCTCTCCTG,161,2823453
ompRp1,49.0,98,1,GAACCGCATTCGCATGGGTG,97,2813673
ompRp1,1.0,2,1,GAAACTAAAACTTAATGTAG,1,2767159
ompRp1,139.5,279,1,GAAAACAATATGAAACAGTC,278,2820041
ompRp1,11.5,23,1,CTTGCATAGCATTAATCAAC,22,2776915
ompRp1,2.0,4,1,CTGACTGCGGAGGGGTGGGT,3,2774559
ompRp1,6.0,12,1,CTGACCACGGACGGGCTCAT,11,2811590
ompRp1,50.0,100,1,CTCTCTTGTTGCTCGTTTGC,99,2779630
ompRp1,41.0,82,1,CTCCAATAAGCGACGACACA,81,2766945
ompRp1,9.5,19,1,CTATGTGGCAGGGTGGCCAA,18,2797674
ompRp1,49.0,98,1,CTAGTGCGATCACTCCGCTC,97,2790044
ompRp1,1.0,2,1,CTAGGGTTCCGTTTATGGTA,1,2815998
ompRp1,1.0,2,1,CTAGGCGCACAATACAGTCC,1,2765496
ompRp1,30.5,61,1,CTAGGCCTCTCAGTCCAGCG,60,2823370
ompRp1,40.0,80,1,CTAAGCTCTGCCCTGACCTA,79,2801689
ompRp1,1.0,2,1,CGTTTAAAGCTGGGTCGGTA,1,2799489
ompRp1,36.0,72,1,CGTTCCTGAAACATCTTGAT,71,2815601
ompRp1,2.5,5,1,CGTCGGCAGGTTTTCTTCGT,4,2817237
ompRp1,28.0,56,1,CGTACTTCGGCCCGCGAGCC,55,2777845
ompRp1,7.0,14,1,CGTAACCGGACAGCCAGCCT,13,2808694
ompRp1,22.5,45,1,CGGTCTAGGTCACGCAACCA,44,2810892
ompRp1,22.0,44,1,CGGTATGGAGCCCCGATGCC,43,2769637
ompRp1,1.0,2,1,CGGGCCAGGATCCTGTGACG,1,2823801
ompRp1,1.5,3,1,CGGACCGTGTAGTGCCCATT,2,2785394
ompRp1,1.0,2,1,CGGACAAGAGAGACGGCGGA,1,2819792
ompRp1,1.0,2,1,CGCTGGCATTAGACGGTATG,1,2813389
ompRp1,1.5,3,1,CGCCTTGACAGGCACTTTCT,2,2819216
ompRp1,11.5,23,1,CGATAGTTCGGCACAAAAGA,22,2773249
ompRp1,43.0,86,1,CGACACATGTGCCTCCAACT,85,2807586
ompRp1,7.0,14,1,CGAAGGTTTAACTCTCACAA,13,2817506
ompRp1,1.0,2,1,CGAACTGGCTAGAATCGCGT,1,2808773
ompRp1,104.5,209,1,CGAAAGGCATCCGGTACTAT,208,2780109
ompRp1,42.5,85,1,CCTGCTTCCGGCCCCACGGT,84,2806017
ompRp1,29.5,59,1,CCTACTATGTCACGTGAGCA,58,2819215
ompRp1,1.0,2,1,CCGTCGCGTAGGCCACCATT,1,2793043
ompRp1,1.0,2,1,CCGCAACAGCGTCATACTGT,1,2790933
ompRp1,26.5,53,1,CCGAGTCGAGTCACAACGGT,52,2823483
ompRp1,1.0,2,1,CCGAGGGTTGATGCGTGGAG,1,2778728
ompRp1,52.5,105,1,CCCTGCCAAAATACTGTGGA,104,2783224
ompRp1,5.0,10,1,CCCCATGCCGGATCACCTGG,9,2800301
ompRp1,14.0,28,1,CCCCAATATATCCGTGCAAA,27,2780958
ompRp1,15.0,30,1,CCATAGCGGCCTGGTGCAAT,29,2777155
ompRp1,9.5,19,1,CATCGCGGGAGCAGTAACGG,18,2787958
ompRp1,1.5,3,1,CATCGCAACTGGTCACCGTA,2,2819481
ompRp1,1.0,2,1,CAGTCCGGCACTTGTTAACG,1,2783928
ompRp1,1.0,2,1,CAGCGCAAGTGATAGAGGCC,1,2787073
ompRp1,1.0,2,1,CAGCAGCGCGTACTATTGAT,1,2794565
ompRp1,30.5,61,1,CAGAAACCACGCGTTCAAGT,60,2787552
ompRp1,5.5,11,1,CACGGGCGATTGAGGAGGAT,10,2810441
ompRp1,103.0,206,1,CAATCGTGAGCGCCAGTATG,205,2795786
ompRp1,69.5,139,1,CAAGGGTTAGGTGTTCGAAC,138,2784388
ompRp1,78.5,157,1,CAAGACGGTGGGTAGTGAAC,156,2771250
ompRp1,87.0,174,1,CAAAGCTTTAGAACCTTCGG,173,2805634
ompRp1,1.5,3,1,ATTTCGGGGTGCAAGCGGTC,2,2819228
ompRp1,40.5,81,1,ATTGCTTGGAATTATGCTTA,80,2823086
ompRp1,9.5,19,1,ATTGCATCTAACTCGAACAG,18,2811666
ompRp1,1.5,3,1,ATTGAACCAATGGTACGCTA,2,2771674
ompRp1,127.0,254,1,ATTAGCCATAAGGGTGATCA,253,2803414
ompRp1,25.0,50,1,ATGTGCACTACGTAACTCGA,49,2767906
ompRp1,30.0,60,1,ATGGTCAGCAGCCTGACAGA,59,2772741
ompRp1,1.5,3,1,ATGGCTTCGTGCTCGCTCCG,2,2797886
ompRp1,69.5,139,1,ATGCGGGAGCCGGCTTCCGT,138,2784595
ompRp1,11.0,22,1,ATGCATCATCCTATCTCAAA,21,2772777
ompRp1,35.5,71,1,ATCTAAACTTACAGCTCCTC,70,2812025
ompRp1,1.0,2,1,ATAGTATAACGGAGGAGCCC,1,2776798
ompRp1,1.0,2,1,ATAAGGACAGCGGACATTAC,1,2772397
ompRp1,86.5,173,1,AGTGTAAGTTGATCAGGTTC,172,2774613
ompRp1,1.5,3,1,AGTGGCTGACTCGTTTCGAG,2,2775187
ompRp1,17.0,34,1,AGTCTGTAAATGGAATGGGG,33,2809954
ompRp1,1.5,3,1,AGTAGTCCCTAGCTCCTGGA,2,2775880
ompRp1,46.5,93,1,AGTACTGAAAAGTCCTGCGT,92,2790022
ompRp1,1.0,2,1,AGTACTACACGAAATGCATC,1,2777391
ompRp1,9.5,19,1,AGTAATGTCATCGTATTTGA,18,2772335
ompRp1,1.0,2,1,AGGGTACTGGTTAATACTGG,1,2796962
ompRp1,1.0,2,1,AGGCCGTCTAGCGGTGGCAG,1,2775255
ompRp1,8.5,17,1,AGGCATGGGTGCTTTGCGAC,16,2815839
ompRp1,1.0,2,1,AGCTCTTTGATTATAGGTTC,1,2810625
ompRp1,1.0,2,1,AGCGGCTAATTCTATCAGAG,1,2775084
ompRp1,36.0,72,1,AGCAGTCCGGTTTAGACTGT,71,2778997
ompRp1,1.0,2,1,AGCAACTCGAAGAATAGCGG,1,2812236
ompRp1,1.0,2,1,AGAGACATAATTACGAGGAT,1,2786578
ompRp1,15.5,31,1,AGACAGCAATCGGGTACGTC,30,2792927
ompRp1,1.0,2,1,ACTCGGAGAGGCACCTCTGT,1,2812108
ompRp1,2.5,5,1,ACTCGGAAATTCAGCCAGGA,4,2768736
ompRp1,39.0,78,1,ACTATGCTAAAATGATAGTT,77,2804516
ompRp1,16.5,33,1,ACGTGGCCGGGTATAAGGAC,32,2811757
ompRp1,1.0,2,1,ACCTCGTCAGGACGGAGGGA,1,2818058
ompRp1,31.0,62,1,ACCGGTGATAAAATTTAGTG,61,2810803
ompRp1,1.0,2,1,ACCGCCAAGTTGACTCATTC,1,2820238
ompRp1,1.0,2,1,ACCAAGAAGCGCTACGGAAT,1,2823307
ompRp1,1.0,2,1,ACACTAAAGCTGTGGCTAAC,1,2819807
ompRp1,54.0,108,1,AATTGTTGGCCCTTTGGATG,107,2784031
ompRp1,34.5,69,1,AATCGGAACTTTCGAATGGC,68,2793495
ompRp1,72.5,145,1,AATCCTTAGTCAGAACTAAA,144,2765264
ompRp1,1.0,2,1,AATCAATCAAAGCATCGGCT,1,2793504
ompRp1,64.0,128,1,AATCAAAGGTCCCACCCATT,127,2790455
ompRp1,1.0,2,1,AATATTCTGAAATAACAATC,1,2775062
ompRp1,1.0,2,1,AACTCTTTTTCCCTCAGTAC,1,2789949
ompRp1,1.0,2,1,AACGCCTTTGTCAAGACAAA,1,2803351
ompRp1,1.0,2,1,AACGCACATCGCAGAGGCCT,1,2781873
ompRp1,1.0,2,1,AACAATACCAGCGCAGGACC,1,2797306
ompRp1,24.5,49,1,AAACGTCGCGAGTATAGATT,48,2765263
ompRp1,48.5,97,1,AAACAGATGCAACTAGCTAT,96,2767654
ompRp1,0.011235955056179775,88,88,CTAAGCGTGTGGGCCATAGT,0,2824028
ompRp1,0.013888888888888888,71,71,GGGAGTTTCATCGGTTGGTA,0,2811803
ompRp1,0.013888888888888888,71,71,AGGCTGGCGTACCCTGATTT,0,2769956
ompRp1,0.014492753623188406,68,68,CCGCTATGAGCCATTAGGCT,0,2779220
ompRp1,0.01639344262295082,60,60,CCCGACGGTGTTACAAGGAC,0,2793570
ompRp1,0.016666666666666666,59,59,ATCCAGACTGACGCTGGGCA,0,2794663
ompRp1,0.01694915254237288,58,58,AGCCTCGAACGGGGTCTCTA,0,2780554
ompRp1,0.018867924528301886,52,52,GTTGGAGTCATATTCTTATA,0,2779568
ompRp1,0.019230769230769232,51,51,AGAGGCGTGGTAATATAGAT,0,2820550
ompRp1,0.02,49,49,GGTCTGATAATAACTGGACA,0,2810967
ompRp1,0.02,49,49,CGACGTATTAATCTTTCTAT,0,2817885
ompRp1,0.02,49,49,CAACCCAGATTCTCTACTAC,0,2775412
ompRp1,0.02,49,49,AGACGCGATCGCGCTTGGAC,0,2805704
ompRp1,0.02040816326530612,48,48,GCATAATAAGGCGAGGTAGT,0,2772457
ompRp1,0.02127659574468085,46,46,CTAGCTAGTAGGCGTTTTGC,0,2780727
ompRp1,0.021739130434782608,45,45,GGTTGATCCATGCAGGAGAA,0,2792064
ompRp1,0.022727272727272728,43,43,AGAATTCCCTGAGGCCGTTA,0,2782349
ompRp1,0.023255813953488372,42,42,CTATAAGTGCTGGTAGCGAA,0,2810433
ompRp1,0.023255813953488372,42,42,CACGATCTTCTACAGGAATT,0,2766343
ompRp1,0.024390243902439025,40,40,TCAGAATTGAAGCTACGCTT,0,2771348
ompRp1,0.024390243902439025,40,40,TAGAGTCTGTAAAACATGTG,0,2766257
ompRp1,0.025,39,39,TTAGGTCTTTGTTGCTCCGG,0,2774407
ompRp1,0.025,39,39,TCTACCATATCGACGAGTCA,0,2810759
ompRp1,0.025,39,39,GGCACATGCTTGACACCTAT,0,2772951
ompRp1,0.025,39,39,CCGAAGTGGCAGCTATCTAT,0,2811951
ompRp1,0.025,39,39,CAAAAGATTCACGAGCAATG,0,2817516
ompRp1,0.02564102564102564,38,38,TTTCACTGAAATGTGTTACT,0,2779973
ompRp1,0.02564102564102564,38,38,GTGGGGAATAACGGACTGGT,0,2788182
ompRp1,0.02564102564102564,38,38,GCACATACCCTTTTTCGGTG,0,2784072
ompRp1,0.02564102564102564,38,38,CCGTTCGACGGCAGTGGCCG,0,2795710
ompRp1,0.02564102564102564,38,38,ACGATACTGATTGGTACCAA,0,2801631
ompRp1,0.02631578947368421,37,37,TACTTACCGCGATTGTTGGA,0,2822556
ompRp1,0.02631578947368421,37,37,GTCACATGGGCTGAGCGAAT,0,2788861
ompRp1,0.02631578947368421,37,37,GGCCTTTCTTGTTGCCCTCA,0,2772503
ompRp1,0.02631578947368421,37,37,CCGGCGGGACACGATCTAAA,0,2776079
ompRp1,0.02631578947368421,37,37,AATGTGTGGCGCGGTAAGTG,0,2769734
ompRp1,0.02702702702702703,36,36,TTAGTGCCTCCGGTCGCTAT,0,2818755
ompRp1,0.02702702702702703,36,36,GCTGGTGGGTGCCTCACCTG,0,2771183
ompRp1,0.02702702702702703,36,36,GCGTAACACGGCATACGATA,0,2772284
ompRp1,0.02702702702702703,36,36,GCATGGACCAGAGGCATTTC,0,2818587
ompRp1,0.02702702702702703,36,36,AGGACTGTCTAAGAGCAAAA,0,2777970
ompRp1,0.027777777777777776,35,35,GTACTGTAGATGGTGAGTAA,0,2781085
ompRp1,0.027777777777777776,35,35,GCCCTTGGGATGGATCATAA,0,2768961
ompRp1,0.027777777777777776,35,35,CTCACGCTGTGTGTTGTCAC,0,2805448
ompRp1,0.027777777777777776,35,35,CGGATCGGCTTTGGTTGACT,0,2801516
ompRp1,0.027777777777777776,35,35,CAGCGTAGGAGGGTCGGTAA,0,2765979
ompRp1,0.027777777777777776,35,35,ATCCGTAGTGGCACCTGATT,0,2775197
ompRp1,0.027777777777777776,35,35,ACGCAGGAAGTAATCGGGCA,0,2790678
ompRp1,0.027777777777777776,35,35,ACCATCCGCCACCAGCGTAG,0,2809990
ompRp1,0.027777777777777776,35,35,ACAAATGATAGCCTCTTGAG,0,2799117
ompRp1,0.027777777777777776,35,35,AAGACACAGAGTGCTAAAAG,0,2804452
ompRp1,0.02857142857142857,34,34,TTGTACGGCCGGATGCATGG,0,2770735
ompRp1,0.02857142857142857,34,34,TAAGGTCGAATAGCGCTGAT,0,2818374
ompRp1,0.02857142857142857,34,34,GTCGAGGCTTAATCACCTAC,0,2769646
ompRp1,0.02857142857142857,34,34,CTGCTTCTGTGGTCATGCGT,0,2790330
ompRp1,0.02857142857142857,34,34,CGTAATCAGCGAGATATAAA,0,2782383
ompRp1,0.02857142857142857,34,34,CCCTGGGGCCATAGGCAGTG,0,2781825
ompRp1,0.02857142857142857,34,34,ATCGATTCGTTCCCTACATA,0,2766991
ompRp1,0.029411764705882353,33,33,TCCTGACACAGAATATATTA,0,2806965
ompRp1,0.029411764705882353,33,33,GTCCGGCCAGCAGCCAGGGC,0,2796248
ompRp1,0.029411764705882353,33,33,GTCAGACAAAAGGCCCCTGG,0,2780833
ompRp1,0.029411764705882353,33,33,GGCAGCCTGCGCGTGTGAAC,0,2768919
ompRp1,0.029411764705882353,33,33,GCCCGTTAGCGTAGATGGTA,0,2770229
ompRp1,0.029411764705882353,33,33,CACTATAATGAGAACACGCA,0,2796828
ompRp1,0.029411764705882353,33,33,AGCTGCGGCAACCCATCTCA,0,2814070
ompRp1,0.029411764705882353,33,33,AAGTGGAAATTTAGGCGCGG,0,2786143
ompRp1,0.030303030303030304,32,32,TGGTATGACTCACGTATCGC,0,2773905
ompRp1,0.030303030303030304,32,32,TGGCCACAATGTGCGACTTT,0,2788424
ompRp1,0.030303030303030304,32,32,TACCGACCCGCCTAGAACGT,0,2791648
ompRp1,0.030303030303030304,32,32,GTCAGGGAGAGCTACGTACC,0,2796474
ompRp1,0.030303030303030304,32,32,CGGGTATGGCTGTCTCCTAA,0,2783084
ompRp1,0.030303030303030304,32,32,CCGGTATATTCATCCAATTA,0,2803196
ompRp1,0.030303030303030304,32,32,CCACAAGTAAATAGTGCGAC,0,2805807
ompRp1,0.030303030303030304,32,32,CACATAACCGAACAGGCCAG,0,2775351
ompRp1,0.030303030303030304,32,32,CACAGTGAACTCGCAGCGGA,0,2796137
ompRp1,0.030303030303030304,32,32,ATAGGCGCATAGTGGAGTTC,0,2790981
ompRp1,0.030303030303030304,32,32,AAATCGCGGAGTTGATGTGA,0,2779655
ompRp1,0.03125,31,31,TCCGTTCATACTCCTTTTAC,0,2768223
ompRp1,0.03125,31,31,TCCGGAATCGTCTACCAGGT,0,2778556
ompRp1,0.03125,31,31,TCAAAACGACAAGTGCACAT,0,2813933
ompRp1,0.03125,31,31,TACAGGATCGGAGAACGACA,0,2766134
ompRp1,0.03125,31,31,TAATTACGAGAGTTCAGGAT,0,2792653
ompRp1,0.03125,31,31,GGCTAAAAACGTAGTATCCT,0,2786688
ompRp1,0.03125,31,31,GAACCCCGAGAAATTCAATT,0,2787551
ompRp1,0.03125,31,31,CGTTCTTATCTGAAGGGTCT,0,2814920
ompRp1,0.03125,31,31,CCGGGTCTGGTTATTCGTAC,0,2795567
ompRp1,0.03125,31,31,CACGGTTTCCGGAACTCATT,0,2801958
ompRp1,0.03125,31,31,ATCAGCACAACTTCAATGGC,0,2788282
ompRp1,0.03125,31,31,ATCAAATATTCCATCAGTAT,0,2769190
ompRp1,0.03125,31,31,AGTAACATGGGAGAAAAAAC,0,2775693
ompRp1,0.03125,31,31,ACATTAGCCTAACTTAGCAA,0,2768015
ompRp1,0.03125,31,31,AAGGGTCACTGCATGAACGT,0,2822186
ompRp1,0.03125,31,31,AACACATTTAAAACTTACAT,0,2777938
ompRp1,0.03225806451612903,30,30,TTTAGGGCAGCAAGCGGTCG,0,2821482
ompRp1,0.03225806451612903,30,30,TGGCCCTGATCGATATGCCG,0,2791049
ompRp1,0.03225806451612903,30,30,TCGGCGCTAGTGTTTATGCT,0,2802761
ompRp1,0.03225806451612903,30,30,TCCACAAAAAGTAACGAACA,0,2767206
ompRp1,0.03225806451612903,30,30,GTGAAGATGTCACACATTAT,0,2821922
ompRp1,0.03225806451612903,30,30,GGGTTGACATGCTTTTAATG,0,2797515
ompRp1,0.03225806451612903,30,30,GGGCTGACATAATCAAAGGA,0,2774540
ompRp1,0.03225806451612903,30,30,GCTAAAGAAGTCTTCTGCTT,0,2803344
ompRp1,0.03225806451612903,30,30,GATTAATGATGGTAGAAGCA,0,2772003
ompRp1,0.03225806451612903,30,30,CTTCTCTGAAATTGCGGTCC,0,2769145
ompRp1,0.03225806451612903,30,30,CTCCATTGCTGACCCTGGGT,0,2818202
ompRp1,0.03225806451612903,30,30,CCTGACTAATGACCCTACCT,0,2784328
ompRp1,0.03225806451612903,30,30,CCCTTAATTGGATCGCAACC,0,2800131
ompRp1,0.03225806451612903,30,30,ATTGGTATGCAAGTGTCTGG,0,2821914
ompRp1,0.03225806451612903,30,30,AGCTCCTGTTAAGGATTACA,0,2777650
ompRp1,0.03333333333333333,29,29,TGGTTTTACGCGTAAAACGG,0,2824013
ompRp1,0.03333333333333333,29,29,TGGTTGGTATGGCGAAAACG,0,2782966
ompRp1,0.03333333333333333,29,29,TCGTTTACGGCTCATGCGCT,0,2772114
ompRp1,0.03333333333333333,29,29,TCGCAGCGTTTACCGCTCAG,0,2779222
ompRp1,0.03333333333333333,29,29,TCAATTCGTGGATGCCCGGC,0,2773356
ompRp1,0.03333333333333333,29,29,TAATGGCTGAGACTGCCGGA,0,2769194
ompRp1,0.03333333333333333,29,29,TAAAGTACCAGCGAGAAGGC,0,2772401
ompRp1,0.03333333333333333,29,29,GACGATACAAGGAAGAGATT,0,2818961
ompRp1,0.03333333333333333,29,29,GAATCGTGAGCCCCCATAAA,0,2794397
ompRp1,0.03333333333333333,29,29,CATCCGGGATGGTGCCTCTA,0,2797706
ompRp1,0.03333333333333333,29,29,CAATACTTCTCTCGTCGGGG,0,2805062
ompRp1,0.03333333333333333,29,29,CAAGGCTCTGCACGTGCTTT,0,2789202
ompRp1,0.03333333333333333,29,29,ATATATACGCAACCGGCCAG,0,2822553
ompRp1,0.03333333333333333,29,29,AGGTACTGGTAGGGATTTAT,0,2781438
ompRp1,0.03333333333333333,29,29,AACGTGCCCATATCAAGCTA,0,2768821
ompRp1,0.03333333333333333,29,29,AAACATTCATCCTACATATT,0,2794431
ompRp1,0.034482758620689655,28,28,TTCCCTGGTGCGCGTTGTGG,0,2769146
ompRp1,0.034482758620689655,28,28,TGCTGCATTTATCCAATATC,0,2770149
ompRp1,0.034482758620689655,28,28,TCATGTTATCAGCGCCTAGA,0,2771957
ompRp1,0.034482758620689655,28,28,TCAGGATATCTTTTAAATGT,0,2798727
ompRp1,0.034482758620689655,28,28,TAAAACTACAGGGGTCAAAG,0,2771291
ompRp1,0.034482758620689655,28,28,GTTCACTGGAACTGTTACGC,0,2779742
ompRp1,0.034482758620689655,28,28,GTATGAGCTGCTTACATCTA,0,2804638
ompRp1,0.034482758620689655,28,28,GTAGTCTTTCTGCGCTGCTG,0,2768597
ompRp1,0.034482758620689655,28,28,GGGAGAATTTGGCTACACCC,0,2769262
ompRp1,0.034482758620689655,28,28,GGAAGTCCCGTATAAAAATA,0,2793345
ompRp1,0.034482758620689655,28,28,GCGTAGACATGGTGATTCCA,0,2817234
ompRp1,0.034482758620689655,28,28,GAGACTAAACTTAATCTGCA,0,2770737
ompRp1,0.034482758620689655,28,28,GACTGCCCGGACAACGCAGG,0,2779609
ompRp1,0.034482758620689655,28,28,CTGGTTGACGATGCGAATGG,0,2820189
ompRp1,0.034482758620689655,28,28,CTCTAGGGTCAGGGCTGGGG,0,2819504
ompRp1,0.034482758620689655,28,28,CCGTGGTGTGGGCTGGCCGC,0,2806350
ompRp1,0.034482758620689655,28,28,CCCAAATCGTCTGCCGATAG,0,2778474
ompRp1,0.034482758620689655,28,28,AGGAAGGACATTGTTTCGTC,0,2790486
ompRp1,0.034482758620689655,28,28,AGAGCATCTAGCCCGAGGGG,0,2805113
ompRp1,0.03571428571428571,27,27,TCGACCTATCGGCGCGCAAT,0,2772869
ompRp1,0.03571428571428571,27,27,TAAGTTCTGCACTCGTTGTA,0,2822725
ompRp1,0.03571428571428571,27,27,TAAAATGTGATGTAACCACA,0,2772502
ompRp1,0.03571428571428571,27,27,GTAGGCAGCTATCATAGTCT,0,2803187
ompRp1,0.03571428571428571,27,27,GAGAGGGCCTCTCTAGTCCT,0,2814737
ompRp1,0.03571428571428571,27,27,CGTCTCGACAAGTTCGCAGA,0,2805551
ompRp1,0.03571428571428571,27,27,CGTCACCATCTGATTGAGTA,0,2774307
ompRp1,0.03571428571428571,27,27,CCGGAGATGTGGAATCTAGT,0,2788383
ompRp1,0.03571428571428571,27,27,ATGATGAAAGTCGCTGGTCT,0,2817331
ompRp1,0.03571428571428571,27,27,ATCACAGATCTTACGTTGAC,0,2804347
ompRp1,0.03571428571428571,27,27,ATAGCTTAGGTTCGATCATG,0,2790213
ompRp1,0.03571428571428571,27,27,AGGGCAGGGGTCAAGCCCTG,0,2791158
ompRp1,0.03571428571428571,27,27,AGCATATGTGCGAATTCTCA,0,2818173
ompRp1,0.03571428571428571,27,27,AGAACGACACAGAAGAGGAC,0,2783688
ompRp1,0.03571428571428571,27,27,ACTACCCAGCAAGTATCGTT,0,2775925
ompRp1,0.03571428571428571,27,27,ACGCCTGGTCATACTGCCGA,0,2790048
ompRp1,0.03571428571428571,27,27,ACGCCGGCGATACTATCTAA,0,2794556
ompRp1,0.03571428571428571,27,27,AAGCATCCGGGGGGGAATTT,0,2776456
ompRp1,0.03571428571428571,27,27,AACTAATTGTCTGTATGTCC,0,2818673
ompRp1,0.037037037037037035,26,26,TCGTGTAAAGCATGTGGCTC,0,2776313
ompRp1,0.037037037037037035,26,26,GTAGTTTACGGGTCCACGAT,0,2779190
ompRp1,0.037037037037037035,26,26,GGCGCGATCTGTGGTGGCTA,0,2773734
ompRp1,0.037037037037037035,26,26,GCGGTATACGAAGGTTTTGA,0,2820727
ompRp1,0.037037037037037035,26,26,GCCACTCCTGGGATGCGAAG,0,2773292
ompRp1,0.037037037037037035,26,26,CCTCCCTTTCTTTTAAGATT,0,2775642
ompRp1,0.037037037037037035,26,26,CCGGCGGTGATACCACAGGT,0,2783276
ompRp1,0.037037037037037035,26,26,CCGCTAACCCTGGACGGCCA,0,2780553
ompRp1,0.037037037037037035,26,26,CAGATATGACATTGAACAAT,0,2775808
ompRp1,0.037037037037037035,26,26,ATGGGAACAGAACCTGGAAT,0,2800970
ompRp1,0.037037037037037035,26,26,ATCGGTCAGAATAATTTCAA,0,2775546
ompRp1,0.037037037037037035,26,26,ATATATACGCGCTCAAAAAT,0,2785294
ompRp1,0.037037037037037035,26,26,AGCTTGGGGGGCTGCCCGGG,0,2793151
ompRp1,0.037037037037037035,26,26,AGCCCAGCATGATAATATCA,0,2804401
ompRp1,0.037037037037037035,26,26,ACGGATCTTGGCGTCAGCGG,0,2777150
ompRp1,0.037037037037037035,26,26,ACCTCAATGTAGTTTGGCTC,0,2796831
ompRp1,0.037037037037037035,26,26,ACAGATAATATAGTGACGTT,0,2791641
ompRp1,0.037037037037037035,26,26,AATATTGCCACGGTCTTACC,0,2813974
ompRp1,0.037037037037037035,26,26,AAGGCAATATCCCTGCACAT,0,2795292
ompRp1,0.038461538461538464,25,25,TTGTGCATCACCAAGTTCCA,0,2804334
ompRp1,0.038461538461538464,25,25,TTAGATGCTTACAATACCTA,0,2801755
ompRp1,0.038461538461538464,25,25,TGTTGAAACCGGTCGTGCTT,0,2812078
ompRp1,0.038461538461538464,25,25,TGGCCGATAACGACCTGGTA,0,2788096
ompRp1,0.038461538461538464,25,25,TCATACAACGCTTAGATAAG,0,2816587
ompRp1,0.038461538461538464,25,25,GTCGAGTTGCGCATCAGTCT,0,2788923
ompRp1,0.038461538461538464,25,25,GGTGTCTATGCATAGTTGTG,0,2768163
ompRp1,0.038461538461538464,25,25,GCATTAACAAGATGTTCTGC,0,2771494
ompRp1,0.038461538461538464,25,25,CTTACCTTGCCGTTCAAGTG,0,2768336
ompRp1,0.038461538461538464,25,25,CTAACTTGTCTCGGAGATCT,0,2798869
ompRp1,0.038461538461538464,25,25,CGCGTGCATAGCGCTATCGA,0,2790306
ompRp1,0.038461538461538464,25,25,CGCGACAGGGCTTTCGTGAA,0,2792334
ompRp1,0.038461538461538464,25,25,CGCAGGTCAGTAGCGCGATA,0,2773066
ompRp1,0.038461538461538464,25,25,CCGCGGGGCAGGCGTGACGT,0,2774345
ompRp1,0.038461538461538464,25,25,CCACTCTTCCGTTCTCCGAA,0,2790122
ompRp1,0.038461538461538464,25,25,CAGTATAGTTCAACCTCCTC,0,2775287
ompRp1,0.038461538461538464,25,25,ATCTATAGAGCCTGACTGGT,0,2792254
ompRp1,0.038461538461538464,25,25,ATACAACTATTGCTTGACGT,0,2795467
ompRp1,0.038461538461538464,25,25,ACGTGGGCATTGGCGATCGA,0,2793024
ompRp1,0.038461538461538464,25,25,ACAGTCCGAGCGGTGAATCA,0,2797023
ompRp1,0.038461538461538464,25,25,ACACGATGGCGCCTCTCAGT,0,2777612
ompRp1,0.038461538461538464,25,25,ACAACAGTAAGGTGGGGCAT,0,2769362
ompRp1,0.038461538461538464,25,25,AACAGTTTGTGCACTGGGAC,0,2814242
ompRp1,0.04,24,24,TTGAAGACGATAAGCTCCTG,0,2786863
ompRp1,0.04,24,24,TTATAGAGGTGGGCTTCGGA,0,2767586
ompRp1,0.04,24,24,TGTGAATCTACCCAAGTTCC,0,2785796
ompRp1,0.04,24,24,TGGTTACGATCTAGTGAACA,0,2771161
ompRp1,0.04,24,24,TCGCAGTCGTGAGGTTCGTG,0,2778189
ompRp1,0.04,24,24,TAGATTGCGACTAGAAGATT,0,2801688
ompRp1,0.04,24,24,TACCTAGGAAGTGGGGTGAG,0,2774196
ompRp1,0.04,24,24,TAACGAGTTCATCGGCGGAC,0,2776063
ompRp1,0.04,24,24,TAACCCTATTGTTATGAGTC,0,2808465
ompRp1,0.04,24,24,TAACCCCGCACCATTAGGAA,0,2815120
ompRp1,0.04,24,24,TAACACGATAGCCAAATTTG,0,2793498
ompRp1,0.04,24,24,GGGATTCTCGTGTTCTGGAG,0,2821181
ompRp1,0.04,24,24,GGAACTCCCAGAGCTTTTAT,0,2775571
ompRp1,0.04,24,24,GCTGATCACTCTAGGCCAGG,0,2808523
ompRp1,0.04,24,24,GCGTATCTCGAGCCAAATTG,0,2777763
ompRp1,0.04,24,24,GCGGTCACCGATCTATTAAT,0,2785463
ompRp1,0.04,24,24,GCCGAGCCTCGTATTTCATT,0,2797024
ompRp1,0.04,24,24,GACGTAGTCACCTTGAGTAC,0,2772143
ompRp1,0.04,24,24,GACACGTTCCTGTAACACTG,0,2770097
ompRp1,0.04,24,24,GAATCCGTGTACAATTTTCA,0,2811987
ompRp1,0.04,24,24,CTGCTGGCTATGCAATGGCA,0,2788867
ompRp1,0.04,24,24,CTAGGTATGACAGACGCAAA,0,2784323
ompRp1,0.04,24,24,CGGATCATTCCTGAGCGCTC,0,2766361
ompRp1,0.04,24,24,CGATTATATTCTATCGAGAG,0,2768624
ompRp1,0.04,24,24,CGAGCAGCCCGGCAGAACAA,0,2772430
ompRp1,0.04,24,24,CGAACTCCTTAAGAAATGGG,0,2784333
ompRp1,0.04,24,24,CCTCGGACTGAAGGGATTAC,0,2806500
ompRp1,0.04,24,24,CCGGAGAAGTGCGTACTGGC,0,2815398
ompRp1,0.04,24,24,CCGAGGCGCAGGATCCTATA,0,2796664
ompRp1,0.04,24,24,CCACTAGGTTGGCAGTGATT,0,2790092
ompRp1,0.04,24,24,CAGTTAACCCGATCCACATC,0,2771903
ompRp1,0.04,24,24,ATGGGCTTGTCTCGGTCTAA,0,2788232
ompRp1,0.04,24,24,ATGACACTGCCCTCGTTACA,0,2781991
ompRp1,0.04,24,24,ATATGGGTGAATCGACTCTA,0,2808556
ompRp1,0.04,24,24,ATACAGATTATGTGGGATAA,0,2815958
ompRp1,0.04,24,24,AGCAAGGCACTAGGATTTTG,0,2816853
ompRp1,0.04,24,24,ACCATAAAGATAGGTTCCGT,0,2765901
ompRp1,0.04,24,24,ACAGACTGGCGTATTACTTG,0,2787545
ompRp1,0.04,24,24,ACAAGGGCCTACCGGTCTGA,0,2819614
ompRp1,0.04,24,24,AATCATGACAACAGCGGCAG,0,2766714
ompRp1,0.04,24,24,AACCGCTGTCACCGTGTGTT,0,2786463
ompRp1,0.04,24,24,AACAGGTACGGGGGAGTCTC,0,2817501
ompRp1,0.041666666666666664,23,23,TTGCACCGGTTCGGGGGTCT,0,2780644
ompRp1,0.041666666666666664,23,23,TGGGTTCAAGGCCTCCGTAG,0,2769088
ompRp1,0.041666666666666664,23,23,TGGCCACCGACATACAACAG,0,2776346
ompRp1,0.041666666666666664,23,23,TGCCTGTGACTCCGGTACGT,0,2797962
ompRp1,0.041666666666666664,23,23,TGCAGCCAGAGGGTTTATCC,0,2767149
ompRp1,0.041666666666666664,23,23,TCCTGTCTTGGCGCCGAGTA,0,2773288
ompRp1,0.041666666666666664,23,23,TAGCGTAACCTTTCATCGAC,0,2813252
ompRp1,0.041666666666666664,23,23,TAAGTCTTGGAGAATTCTTT,0,2771633
ompRp1,0.041666666666666664,23,23,GTGTTTTCGCGGGGTCTTGT,0,2773502
ompRp1,0.041666666666666664,23,23,GGCTCCGGGTATCGAGTCGG,0,2781776
ompRp1,0.041666666666666664,23,23,GGCCTCCGTCAGTAGACTTT,0,2817887
ompRp1,0.041666666666666664,23,23,GGCAGGCAAGCCTCCGGGGA,0,2768921
ompRp1,0.041666666666666664,23,23,GCTGACGGCAACGAAGAAGT,0,2774968
ompRp1,0.041666666666666664,23,23,GAGCGCTCCCAGCTCCCGAT,0,2820749
ompRp1,0.041666666666666664,23,23,GAAGGCATGTCCACTGGTCT,0,2805595
ompRp1,0.041666666666666664,23,23,CTTATAAGCCACAGCTGCAT,0,2780275
ompRp1,0.041666666666666664,23,23,CGTCATCAAACCTTATTCCT,0,2767054
ompRp1,0.041666666666666664,23,23,CGGTAGGCGATATATCGTAG,0,2806686
ompRp1,0.041666666666666664,23,23,CGCATAGGAGGTGCATTGTT,0,2805203
ompRp1,0.041666666666666664,23,23,CCCGATGGCGATTTTGCGCT,0,2768361
ompRp1,0.041666666666666664,23,23,CCAGTGGAACAAACCTGCAT,0,2808391
ompRp1,0.041666666666666664,23,23,CCAAATCCTGTATAGCCAAT,0,2793142
ompRp1,0.041666666666666664,23,23,CATAAGACCTAGATGGACGG,0,2803027
ompRp1,0.041666666666666664,23,23,CAAAATGTTCGTTCTGTACG,0,2790273
ompRp1,0.041666666666666664,23,23,ATGCAGAGAACCCACCTTCT,0,2781591
ompRp1,0.041666666666666664,23,23,ATCGCGCGTAATCAAAACAA,0,2794405
ompRp1,0.041666666666666664,23,23,ATATTGCTAAGACCAACAGT,0,2781257
ompRp1,0.041666666666666664,23,23,AGGCTTGACATCTTTACTTA,0,2769039
ompRp1,0.041666666666666664,23,23,AGCATGCGGCTGTCGCACCG,0,2767387
ompRp1,0.041666666666666664,23,23,ACTTGAGACGGGGCCTGCGC,0,2765810
ompRp1,0.041666666666666664,23,23,ACGGTCTTCGGAGAACGTTA,0,2791647
ompRp1,0.041666666666666664,23,23,ACGCGGTGAAGGCGCGAGTA,0,2785296
ompRp1,0.041666666666666664,23,23,ACGATCCAGAGCAGCGTGTG,0,2790700
ompRp1,0.041666666666666664,23,23,ACAAACCGACCAGTTGAGGG,0,2819537
ompRp1,0.041666666666666664,23,23,AATCGGGAAGATTTCGCAAT,0,2790211
ompRp1,0.041666666666666664,23,23,AAGATACCACTATCACAGCG,0,2768754
ompRp1,0.041666666666666664,23,23,AAGAAGTATCAACACATGTG,0,2769263
ompRp1,0.041666666666666664,23,23,AACGAAAGTACTCCGTAGCC,0,2777508
ompRp1,0.041666666666666664,23,23,AACAGCGATAAGTCACTCTT,0,2783069
ompRp1,0.041666666666666664,23,23,AAACGCCTATCTCTGACCAT,0,2809105
ompRp1,0.043478260869565216,22,22,TTGGACATCAGGACCTGAAA,0,2783274
ompRp1,0.043478260869565216,22,22,TGTTAGCCAACGGCCCTCAC,0,2801076
ompRp1,0.043478260869565216,22,22,TGGCCGGATGGCGAGAGTAT,0,2806682
ompRp1,0.043478260869565216,22,22,TGGACAAAGGCGATTGAGCC,0,2793924
ompRp1,0.043478260869565216,22,22,TGCCAGACGACACAATGGTA,0,2793840
ompRp1,0.043478260869565216,22,22,GTTCAAGGTTTTCTTACTGG,0,2803134
ompRp1,0.043478260869565216,22,22,GTCAGGTGCATAAAAACCAC,0,2775760
ompRp1,0.043478260869565216,22,22,GGTAATCCACCCAGCTCTAT,0,2791702
ompRp1,0.043478260869565216,22,22,GGGATGTTAGGCCAGTACAT,0,2789801
ompRp1,0.043478260869565216,22,22,GGCATGCGGACGAACGAGCA,0,2798576
ompRp1,0.043478260869565216,22,22,GCGTAGGCACGTTTACTACA,0,2812001
ompRp1,0.043478260869565216,22,22,GCCGGGCTGTAAAGCGTTAG,0,2811603
ompRp1,0.043478260869565216,22,22,GCCCTGTAGTTCAGTCATCG,0,2767816
ompRp1,0.043478260869565216,22,22,GATACACTTCCCTATGGGGT,0,2772388
ompRp1,0.043478260869565216,22,22,GAGTATCTTCGCGGGATGCA,0,2766444
ompRp1,0.043478260869565216,22,22,GAGGATCTTTCTTTCATTAC,0,2804333
ompRp1,0.043478260869565216,22,22,GACTGGGTAGTAACGTTACA,0,2820833
ompRp1,0.043478260869565216,22,22,GACTCTGGGGTGATTTAGTT,0,2769119
ompRp1,0.043478260869565216,22,22,GACCACAGCATGTCAGGCGT,0,2791236
ompRp1,0.043478260869565216,22,22,CGTTTTACCGAGTACGGACC,0,2771667
ompRp1,0.043478260869565216,22,22,CGGGCGTAACACAACATCAG,0,2769268
ompRp1,0.043478260869565216,22,22,CGGCGGTTGCTGGATTTATG,0,2819257
ompRp1,0.043478260869565216,22,22,CCACGTCTTTTCAGGGTCTA,0,2824488
ompRp1,0.043478260869565216,22,22,CATTAGGTCACGCATATTCT,0,2797270
ompRp1,0.043478260869565216,22,22,CAGTGCCACGTGGGTTTCGG,0,2779223
ompRp1,0.043478260869565216,22,22,CACTGAAACATAGCATTCTA,0,2787202
ompRp1,0.043478260869565216,22,22,CAATGATTGTACTGTCAACT,0,2779523
ompRp1,0.043478260869565216,22,22,ATGCCGACACTGAGTGGATA,0,2819015
ompRp1,0.043478260869565216,22,22,ATCTGAACGGCCCCTGGGTA,0,2767379
ompRp1,0.043478260869565216,22,22,ATCGCGTTCGACGACGGTGA,0,2795477
ompRp1,0.043478260869565216,22,22,ATCCGTTGACACATCAGAAA,0,2777158
ompRp1,0.043478260869565216,22,22,ATCCCGCAACGCGAAGTTGA,0,2800642
ompRp1,0.043478260869565216,22,22,AGTGATAATTAGGTACTCAC,0,2799949
ompRp1,0.043478260869565216,22,22,AGTAGAGCTCTAATTACGAA,0,2799400
ompRp1,0.043478260869565216,22,22,AGGTCGCACTCCGGCGTAGG,0,2800473
ompRp1,0.043478260869565216,22,22,AGGGCCAGTTTACTTAAGAG,0,2786996
ompRp1,0.043478260869565216,22,22,AGGCATCCAGATGCGGTTAA,0,2798488
ompRp1,0.043478260869565216,22,22,AGCAGGGACGTTGATTCTTT,0,2766863
ompRp1,0.043478260869565216,22,22,AGATTGCAGTACCGGTGAAC,0,2765791
ompRp1,0.043478260869565216,22,22,AATGGTTGTGAAGGAACTAA,0,2769744
ompRp1,0.043478260869565216,22,22,AAGGACTTCAAAATACATTG,0,2789563
ompRp1,0.043478260869565216,22,22,AACGGTTCTCAAAGAGCGAT,0,2778293
ompRp1,0.045454545454545456,21,21,TTTATTACTGGACAACCTAC,0,2811497
ompRp1,0.045454545454545456,21,21,TTGCCGCCGAGGCGAATTCA,0,2778582
ompRp1,0.045454545454545456,21,21,TTAGTAGTTGCTCAGCTGAT,0,2788422
ompRp1,0.045454545454545456,21,21,TGGTGTTGGCCCGCTCACGA,0,2812274
ompRp1,0.045454545454545456,21,21,TGGTGCCCTTTGGTAATGTT,0,2817236
ompRp1,0.045454545454545456,21,21,TGCTGTTTTTGGGTACATAT,0,2793275
ompRp1,0.045454545454545456,21,21,TGCTGTGTCCGGTATCGGTG,0,2770465
ompRp1,0.045454545454545456,21,21,TGCAGGAGGACCCCCAGCGT,0,2813492
ompRp1,0.045454545454545456,21,21,TGAAACTGGCATATTGCAGT,0,2793261
ompRp1,0.045454545454545456,21,21,TATTTAATAGTGGTGATTGA,0,2780170
ompRp1,0.045454545454545456,21,21,TAGATAATATTATTCAGTAC,0,2808198
ompRp1,0.045454545454545456,21,21,GTGCGTCTTCACACTGGACA,0,2797325
ompRp1,0.045454545454545456,21,21,GTCTAGTTCAGCCGAAGTTT,0,2804952
ompRp1,0.045454545454545456,21,21,GTATGTTCTAGGCCAGCTCC,0,2806072
ompRp1,0.045454545454545456,21,21,GGTTGCGCGAGTTATCAGAT,0,2790864
ompRp1,0.045454545454545456,21,21,GGTTCACGTGCCAAGGATAA,0,2809250
ompRp1,0.045454545454545456,21,21,GGATAGTAAACAGCCGCCTT,0,2819001
ompRp1,0.045454545454545456,21,21,GCTCTATATGGGCGGGACAA,0,2772248
ompRp1,0.045454545454545456,21,21,GCTACGGCCGGACGCTGTTG,0,2788902
ompRp1,0.045454545454545456,21,21,GCCCCCTAAGGTGGATAGAG,0,2818897
ompRp1,0.045454545454545456,21,21,GCCACAGATTCTGGGAGTTG,0,2821561
ompRp1,0.045454545454545456,21,21,GCACAGAAGCTGAATTATGC,0,2785071
ompRp1,0.045454545454545456,21,21,GAGTTCTAGTGAAGGTTCAG,0,2765950
ompRp1,0.045454545454545456,21,21,GAGGTGGTAGTCTAGAGTAA,0,2768016
ompRp1,0.045454545454545456,21,21,GAGAGGGTGCGTTAGCGCTA,0,2770989
ompRp1,0.045454545454545456,21,21,GACGAGAACGCGATGCGCGC,0,2777594
ompRp1,0.045454545454545456,21,21,GACAACGGGTTGAGCGTGAT,0,2793148
ompRp1,0.045454545454545456,21,21,CTTTAGATGTCAAGATGGCC,0,2794278
ompRp1,0.045454545454545456,21,21,CTTAGCTCAATCGGTTTCAT,0,2776275
ompRp1,0.045454545454545456,21,21,CTGTCTGCAGGGAGGGTGAT,0,2767832
ompRp1,0.045454545454545456,21,21,CTGCCAGAACGCTTCAGTAC,0,2774657
ompRp1,0.045454545454545456,21,21,CTGACCCGTTGGTCTAGAAA,0,2776883
ompRp1,0.045454545454545456,21,21,CTCTATGGCGGGTGCTATCA,0,2821655
ompRp1,0.045454545454545456,21,21,CGTCAGGGGCAACGATTTAC,0,2783583
ompRp1,0.045454545454545456,21,21,CGCTATGGACCTCGCGCCTC,0,2787011
ompRp1,0.045454545454545456,21,21,CGCACCGATGGCTGTCTGGT,0,2813006
ompRp1,0.045454545454545456,21,21,CGAGCTTCATATTTTGACTG,0,2804071
ompRp1,0.045454545454545456,21,21,CGAGAGTTACGGCAATAGTG,0,2787175
ompRp1,0.045454545454545456,21,21,CCTCTCGGTTGCTATTACTT,0,2773135
ompRp1,0.045454545454545456,21,21,CCTCCCATGAGCCCGAAGTA,0,2815738
ompRp1,0.045454545454545456,21,21,CCTACACGTATAGTAGGCAA,0,2798934
ompRp1,0.045454545454545456,21,21,CCGAGAAGCTGCTAGGCCGT,0,2782047
ompRp1,0.045454545454545456,21,21,CCAAGCCGTTGATGTGAGGA,0,2782050
ompRp1,0.045454545454545456,21,21,CCAAGAGCCCAAAGTGCTTA,0,2819501
ompRp1,0.045454545454545456,21,21,CATGCCAACGCCGCCACTCG,0,2822728
ompRp1,0.045454545454545456,21,21,CATCGCTCGACGAATGTCGG,0,2791835
ompRp1,0.045454545454545456,21,21,CATCGCCGAGGGTAGCTGGT,0,2773169
ompRp1,0.045454545454545456,21,21,CATACCTGTCAATAGAAGAC,0,2820955
ompRp1,0.045454545454545456,21,21,CAGAGCTTTGCCTCAGGACA,0,2783842
ompRp1,0.045454545454545456,21,21,CACGCTTTCCCCATGTTAAC,0,2812112
ompRp1,0.045454545454545456,21,21,CACCGGTGGAAATCGCCATA,0,2810162
ompRp1,0.045454545454545456,21,21,CAACGCTGCGTTCGCCTGGT,0,2774536
ompRp1,0.045454545454545456,21,21,ATTACAAGCGCAGGCCCTAG,0,2801044
ompRp1,0.045454545454545456,21,21,ATGGCGAAGTATGATGGTCT,0,2818091
ompRp1,0.045454545454545456,21,21,ATACCGATTAGGAAAACAAC,0,2821045
ompRp1,0.045454545454545456,21,21,AGGTTTGCCCCGTCTCCCAC,0,2807716
ompRp1,0.045454545454545456,21,21,AGCGCTGTGGGGTGTGTAGG,0,2795127
ompRp1,0.045454545454545456,21,21,AGACTAAATGAGACGGGTTT,0,2772957
ompRp1,0.045454545454545456,21,21,ACTTGTATTAAGCCGGGGGA,0,2787068
ompRp1,0.045454545454545456,21,21,ACGGTCACGCAAGGTAGATA,0,2771493
ompRp1,0.045454545454545456,21,21,ACGCTTGCCATCACACCCAC,0,2776557
ompRp1,0.045454545454545456,21,21,ACCTGTTGTAGCTGAGGGAT,0,2789250
ompRp1,0.045454545454545456,21,21,AAGGTCTTTTCCCGCATGAG,0,2794280
ompRp1,0.045454545454545456,21,21,AACTATATGTGCTGTCGCAT,0,2775241
ompRp1,0.045454545454545456,21,21,AACGAATGTCGGTTTTGACT,0,2773133
ompRp1,0.045454545454545456,21,21,AACCTGCGGAGCTGTCTGTA,0,2789327
ompRp1,0.045454545454545456,21,21,AAAGGCCTCCTAAGGGCGAG,0,2770464
ompRp1,0.045454545454545456,21,21,AAAGAGTGAACCATCAAGAT,0,2783667
ompRp1,0.045454545454545456,21,21,AAACTGCGGTGCCTCAATCG,0,2790338
ompRp1,0.045454545454545456,21,21,AAACCCAAATACTGTAGGAT,0,2778473
ompRp1,0.045454545454545456,21,21,AAAATAGGGATTGATCATCC,0,2822679
ompRp1,0.047619047619047616,20,20,TTTGTCTGCGTGCAGACTCT,0,2768646
ompRp1,0.047619047619047616,20,20,TTCGTTGGCCAGCAGGATAT,0,2790862
ompRp1,0.047619047619047616,20,20,TTCCCGTGACTATCAACCTA,0,2800160
ompRp1,0.047619047619047616,20,20,TTAATTAGGATTGAGTGGGG,0,2801759
ompRp1,0.047619047619047616,20,20,TGTTCCATTGAAGGGTATCA,0,2804255
ompRp1,0.047619047619047616,20,20,TGTTCATGACCGGAAACTCT,0,2797303
ompRp1,0.047619047619047616,20,20,TGGTGACTCGAGTATGAATG,0,2823566
ompRp1,0.047619047619047616,20,20,TGGATCTTCATCGCGACGAT,0,2801756
ompRp1,0.047619047619047616,20,20,TGCGTTCGGCCGAGTGGCTG,0,2814406
ompRp1,0.047619047619047616,20,20,TGCGCTACACTGCTCATAAA,0,2808673
ompRp1,0.047619047619047616,20,20,TGAAACGAGACCGGCGGAGA,0,2810773
ompRp1,0.047619047619047616,20,20,TCGGTACCTGCACTCCGTCC,0,2810849
ompRp1,0.047619047619047616,20,20,TCGCTGGTGGGCGTTTTATA,0,2777426
ompRp1,0.047619047619047616,20,20,TCGCATTAGACACTCTGCGG,0,2768303
ompRp1,0.047619047619047616,20,20,TCGCATGCTTGCAAAGAAGT,0,2790307
ompRp1,0.047619047619047616,20,20,TCGATATCTTAAAAGCTTGG,0,2765807
ompRp1,0.047619047619047616,20,20,TATTGAGGGAACCTGTTAAG,0,2816035
ompRp1,0.047619047619047616,20,20,TATTATGCGATACGAAGCAA,0,2784284
ompRp1,0.047619047619047616,20,20,TATCAGTTTCATCCGCTAGG,0,2805919
ompRp1,0.047619047619047616,20,20,TACATTCCCAATAAGGGTTG,0,2803510
ompRp1,0.047619047619047616,20,20,TAATCATCAGTACTGCTACT,0,2809390
ompRp1,0.047619047619047616,20,20,GTTGTCCATGGCTATTTGTA,0,2816704
ompRp1,0.047619047619047616,20,20,GTCTTGGGCCGACATGCGGT,0,2802048
ompRp1,0.047619047619047616,20,20,GTCGTTCCGGCGAAAGCTCA,0,2799632
ompRp1,0.047619047619047616,20,20,GTAGTTTAATAAAGTTTCAC,0,2794057
ompRp1,0.047619047619047616,20,20,GGTGTCTACAAGGTTGCGGC,0,2772285
ompRp1,0.047619047619047616,20,20,GGCCAGCCGCTCGACATTTT,0,2783078
ompRp1,0.047619047619047616,20,20,GGACTGGCGGGTCGTCTGAG,0,2766227
ompRp1,0.047619047619047616,20,20,GGAAGATGTGACCGAGCGCA,0,2797250
ompRp1,0.047619047619047616,20,20,GCGCCTTCTAAAATAGCTTT,0,2772625
ompRp1,0.047619047619047616,20,20,GCGAAATGCGACCTGAGCTA,0,2823230
ompRp1,0.047619047619047616,20,20,GCCGCTTCAGTGTCACGGTG,0,2773773
ompRp1,0.047619047619047616,20,20,GCCGAGCTAAGCAGCGGCAA,0,2770442
ompRp1,0.047619047619047616,20,20,GCAGGCTTTCACACCCTGCA,0,2784802
ompRp1,0.047619047619047616,20,20,GATAATTCCTGGTCCTTATG,0,2769947
ompRp1,0.047619047619047616,20,20,GAGGCCTTTTACATAGCCAA,0,2794224
ompRp1,0.047619047619047616,20,20,GAGAAATGCGGAATTGTTTC,0,2792253
ompRp1,0.047619047619047616,20,20,GACCTGGGCTTCGTTAGAAC,0,2793583
ompRp1,0.047619047619047616,20,20,CTTTCCAACGCATTGTTCAA,0,2779855
ompRp1,0.047619047619047616,20,20,CTTGGCTCAACATACGAGAA,0,2804213
ompRp1,0.047619047619047616,20,20,CTGGCGCGAGTTGACTGTCA,0,2811693
ompRp1,0.047619047619047616,20,20,CTGACAGATAAGACGGCCGA,0,2800279
ompRp1,0.047619047619047616,20,20,CTCTTTTATCACAGATTAGT,0,2783962
ompRp1,0.047619047619047616,20,20,CTCTCTGCAGCCTGTGGCCA,0,2790594
ompRp1,0.047619047619047616,20,20,CTCCGAGTCCGATATGCACA,0,2813794
ompRp1,0.047619047619047616,20,20,CTCAGGTTTTTTCAGAGCGT,0,2789480
ompRp1,0.047619047619047616,20,20,CTATTATTTGGGGGCTCATT,0,2770002
ompRp1,0.047619047619047616,20,20,CTATCGCGAGGGCTTCACGG,0,2801126
ompRp1,0.047619047619047616,20,20,CTAGGGTTACGTATTATATC,0,2800201
ompRp1,0.047619047619047616,20,20,CTAAGTATTGTCTGAGGGTG,0,2792472
ompRp1,0.047619047619047616,20,20,CGTTCACGATATGCGGAGGT,0,2795809
ompRp1,0.047619047619047616,20,20,CGGCACACGCCCATAGGAGT,0,2806111
ompRp1,0.047619047619047616,20,20,CGGAACTCCCTTGTCATTTA,0,2767027
ompRp1,0.047619047619047616,20,20,CGCGGTAGTAAGGTGGACGG,0,2782040
ompRp1,0.047619047619047616,20,20,CGCCATGGTTGTAATTTCGT,0,2801123
ompRp1,0.047619047619047616,20,20,CGACTATAGAGGGTGTGGGA,0,2774963
ompRp1,0.047619047619047616,20,20,CGACCCAGCTCTACCTGCAG,0,2820697
ompRp1,0.047619047619047616,20,20,CCTGATGCATGTTTACAGCC,0,2776072
ompRp1,0.047619047619047616,20,20,CCTCCCATCTCAGCTACTCC,0,2806553
ompRp1,0.047619047619047616,20,20,CCGAATTTAACTTGGCTATA,0,2772385
ompRp1,0.047619047619047616,20,20,CCCCGTTGTTTACAATGAGA,0,2811178
ompRp1,0.047619047619047616,20,20,CCCAGACTTAGATGTCAGGA,0,2768675
ompRp1,0.047619047619047616,20,20,CCATAAAGGATCGTTTACTC,0,2792488
ompRp1,0.047619047619047616,20,20,CCACGCAAGAACGCTGAAAA,0,2791352
ompRp1,0.047619047619047616,20,20,CATCGAGTACACTGGAGTCG,0,2771678
ompRp1,0.047619047619047616,20,20,CAGAAGAGTCGTAAGCTGCA,0,2797661
ompRp1,0.047619047619047616,20,20,CAATTCTCCTAGATAGACAA,0,2784866
ompRp1,0.047619047619047616,20,20,CAAACATAACTGGTTTTCGT,0,2798628
ompRp1,0.047619047619047616,20,20,ATTCTAGTATCCCATAGGGT,0,2773358
ompRp1,0.047619047619047616,20,20,ATCAAATCGTACCAGTAGTG,0,2797961
ompRp1,0.047619047619047616,20,20,ATACTCCCTGTGTCCGGCTA,0,2779153
ompRp1,0.047619047619047616,20,20,AGTGTGGGGGATTATCTCCA,0,2781678
ompRp1,0.047619047619047616,20,20,AGTCTGAACCGTGCTTAGTC,0,2766710
ompRp1,0.047619047619047616,20,20,ACTACGGGCTCTTTTGATGA,0,2773744
ompRp1,0.047619047619047616,20,20,ACGAGCGTACTTTATGGAAC,0,2794765
ompRp1,0.047619047619047616,20,20,AAGTTGGTAACGTTTATCAA,0,2777652
ompRp1,0.047619047619047616,20,20,AACTATGGCTATGTGTTGAC,0,2784344
ompRp1,0.047619047619047616,20,20,AACACCTAGGCAAAGTGTGG,0,2770992
ompRp1,0.05,19,19,TTTGGTTCTTAGACGTATAG,0,2822663
ompRp1,0.05,19,19,TTGCGCTCTGTCTCAATCGT,0,2775794
ompRp1,0.05,19,19,TTGCGAGTTGTTGGTGCGAT,0,2807376
ompRp1,0.05,19,19,TTCTGAGGGCGAGAATGCGC,0,2803049
ompRp1,0.05,19,19,TTCTACTACTCAACCGCCCT,0,2776519
ompRp1,0.05,19,19,TGCTGCCAGCCCCATTACGG,0,2811235
ompRp1,0.05,19,19,TGCGATCTTTGCAGTGCGCC,0,2768623
ompRp1,0.05,19,19,TGCCAGGGCATCTCATGGTC,0,2787263
ompRp1,0.05,19,19,TGATGTGAGAAATCGCCATA,0,2815895
ompRp1,0.05,19,19,TGATAGTTCCGTTCTTTCTT,0,2788967
ompRp1,0.05,19,19,TGAGGATTCCTCTGTAACGC,0,2806635
ompRp1,0.05,19,19,TGAATTGACTGTAGGAATCT,0,2820101
ompRp1,0.05,19,19,TCGTGGCCAGCATGACTGAA,0,2797370
ompRp1,0.05,19,19,TCGCCTCTACTGCTTACAGG,0,2780986
ompRp1,0.05,19,19,TCGAGCTTCCTTTTACGCAT,0,2803688
ompRp1,0.05,19,19,TCGACCTGGGATCCATCAGT,0,2801871
ompRp1,0.05,19,19,TCCGTCCTGGTAGAGGAGAG,0,2787558
ompRp1,0.05,19,19,TCATGCCCCGGTGCCGTTAT,0,2809324
ompRp1,0.05,19,19,TCAGGAAATATGAACGCAGT,0,2798816
ompRp1,0.05,19,19,TCAGATTCGTCTCGCGACGA,0,2792808
ompRp1,0.05,19,19,TATCTGTTCAAAATGCGCTA,0,2774879
ompRp1,0.05,19,19,TAGCACAGTAAGCTTGATTC,0,2808207
ompRp1,0.05,19,19,TACCCCCCTAGCGGTAGGAT,0,2780357
ompRp1,0.05,19,19,TAAGAATAAACAGCGCCGAC,0,2785128
ompRp1,0.05,19,19,TAACCGGGGTGAATAGAACC,0,2804131
ompRp1,0.05,19,19,GTTCTGAATCGTTAGGACCA,0,2802764
ompRp1,0.05,19,19,GTGTCTCACGCACTTCCATG,0,2791771
ompRp1,0.05,19,19,GTGATCCGTATAAATAAAGG,0,2797338
ompRp1,0.05,19,19,GTCGGCGCTGTGACCCTGCG,0,2797619
ompRp1,0.05,19,19,GTCGAGCTGTTGCCCGGTGG,0,2799759
ompRp1,0.05,19,19,GTAACTAGTTTACAATGTTG,0,2788147
ompRp1,0.05,19,19,GTAAATTATTTATAAAAGAT,0,2771199
ompRp1,0.05,19,19,GGTATCAAGGACAACGAGAA,0,2816200
ompRp1,0.05,19,19,GGTAAATAACCACGTGACCT,0,2795046
ompRp1,0.05,19,19,GGGGATTTCGGGTTTGCGTC,0,2823154
ompRp1,0.05,19,19,GGGGAGTAATGGGGTATTGA,0,2776308
ompRp1,0.05,19,19,GGCGTGAGTGATCCTTAGGC,0,2779471
ompRp1,0.05,19,19,GGCAGCACCATAACCTCTGA,0,2781487
ompRp1,0.05,19,19,GGATATTCATGCACGCGGCG,0,2798383
ompRp1,0.05,19,19,GGACTACGCCGCTCGACTCT,0,2824392
ompRp1,0.05,19,19,GCGCTGTGTATGCAGGATCT,0,2766136
ompRp1,0.05,19,19,GCCACATCCAGGCGTTGTCT,0,2792335
ompRp1,0.05,19,19,GCACTAATAAAGCACGGTAA,0,2780432
ompRp1,0.05,19,19,GATTAAATGAGTTAGTTTAA,0,2823358
ompRp1,0.05,19,19,GATGGTGGGCTCTAGAGCGA,0,2808160
ompRp1,0.05,19,19,GATGAGGTAGATACATGGCG,0,2793935
ompRp1,0.05,19,19,GATAAGGTCGTCCTTTCCGA,0,2784244
ompRp1,0.05,19,19,GATAAGACGGAGAACAATGA,0,2776226
ompRp1,0.05,19,19,GAGTCAGGATTTGGTGTATG,0,2767510
ompRp1,0.05,19,19,GAGGTGTACTATACGAGTTC,0,2770672
ompRp1,0.05,19,19,GAGCCAGGCGGCACGAAAGC,0,2779603
ompRp1,0.05,19,19,GAATCCCGTGTCTAACCAAC,0,2820397
ompRp1,0.05,19,19,GAAAGGACGAAGCAGGCATG,0,2774837
ompRp1,0.05,19,19,CTTAGTAGCGCGAGCAAGTT,0,2789252
ompRp1,0.05,19,19,CTGTCCTTCTTGAAGCTAAA,0,2802661
ompRp1,0.05,19,19,CTCGGGCTTCAGACTAGATG,0,2765988
ompRp1,0.05,19,19,CTAGCTCGGCCCACAGCGGC,0,2773911
ompRp1,0.05,19,19,CGGTTTTGGACACAGCGAAT,0,2778075
ompRp1,0.05,19,19,CGGTGGGGGTAGCCAAACAT,0,2791751
ompRp1,0.05,19,19,CGGGTCTTGAAATGCATAGA,0,2802042
ompRp1,0.05,19,19,CGGCCAGAGGGTTACGCCAT,0,2804248
ompRp1,0.05,19,19,CGGCATACTACTCACACAGT,0,2804751
ompRp1,0.05,19,19,CGGAGCTGTGGCCCCTTGGA,0,2791934
ompRp1,0.05,19,19,CGATCTTAGGTAAAGTAACT,0,2765507
ompRp1,0.05,19,19,CCTGAGCAAGGGTTAGCAAG,0,2766074
ompRp1,0.05,19,19,CCGTTAGGACGTTTAACTCC,0,2796880
ompRp1,0.05,19,19,CCGCTGGGTACCGCACGCAA,0,2783530
ompRp1,0.05,19,19,CCCGGGTCCAATTTGCTTTA,0,2807011
ompRp1,0.05,19,19,CCAGCCGGTAGTGGTACAGG,0,2808192
ompRp1,0.05,19,19,CCAGAATTAGGGAATTCGCA,0,2772176
ompRp1,0.05,19,19,CACCGGTGCTCGGAATGCTC,0,2810906
ompRp1,0.05,19,19,CACCCGCGGCGTTCGGGGGG,0,2778767
ompRp1,0.05,19,19,CAATCTCCTCGGACGGTGCT,0,2789875
ompRp1,0.05,19,19,CAATCGCGTAGAGTTAATAT,0,2807926
ompRp1,0.05,19,19,CAAGACACCCGCAACTCTTT,0,2802812
ompRp1,0.05,19,19,CAAATGAGGGGAGATATTTG,0,2814207
ompRp1,0.05,19,19,ATGTTCGCTAGGGAGGTTCT,0,2767818
ompRp1,0.05,19,19,ATGTAATTGATAGGAGTAGT,0,2771584
ompRp1,0.05,19,19,ATCCTGGCACAGGTCTGCTG,0,2775522
ompRp1,0.05,19,19,ATCCGGAGAGGCGGAGGGCG,0,2773432
ompRp1,0.05,19,19,ATCATCCCTGGCCATGTTAG,0,2788209
ompRp1,0.05,19,19,ATACAATGTCGGTAGCTAAA,0,2805954
ompRp1,0.05,19,19,AGTTTGTACCTACTGTGCAA,0,2779749
ompRp1,0.05,19,19,AGTCAAACCAGGGCGCAGGC,0,2785719
ompRp1,0.05,19,19,AGGTGGTGACTAGCAAGTAA,0,2770858
ompRp1,0.05,19,19,AGGCTAAGGAAGGTGTTGAT,0,2819787
ompRp1,0.05,19,19,AGGCGGCCCGTACTACCAGG,0,2774189
ompRp1,0.05,19,19,AGCTGAGCGAATGGACTCCA,0,2780215
ompRp1,0.05,19,19,AGCCGTTTTCAGTGGACCCA,0,2800463
ompRp1,0.05,19,19,AGCACTTATTTTCTAAAATT,0,2788114
ompRp1,0.05,19,19,AGAATTTAATTGGTAGTCTG,0,2796358
ompRp1,0.05,19,19,AGAATTAGAGTGGGGTTAAA,0,2777491
ompRp1,0.05,19,19,ACGGGTTATTGAGTTTAACG,0,2801547
ompRp1,0.05,19,19,ACGGCATAGGGTTGACCGGC,0,2785860
ompRp1,0.05,19,19,ACGAGGTGCTTTTTAACTCT,0,2792416
ompRp1,0.05,19,19,ACCGTGCGGCTAACTACGGA,0,2780653
ompRp1,0.05,19,19,ACATGGGCTGGGCACGCGCA,0,2772803
ompRp1,0.05,19,19,AATTTTACCCTAAGCCTCTA,0,2782927
ompRp1,0.05,19,19,AATCTATAGGGGCACTCATT,0,2766259
ompRp1,0.05,19,19,AAGGAGAAAAGGCAGCGGGT,0,2820357
ompRp1,0.05,19,19,AAGCCCCCACCCGGTCGCTA,0,2810856
ompRp1,0.05,19,19,AAGCATGGCTCCATACAGAT,0,2810152
ompRp1,0.05,19,19,AACCGCAAGTCGCCAATGAT,0,2778754
ompRp1,0.05,19,19,AAAGAGTATTCCTATTTTGA,0,2795712
ompRp1,0.05263157894736842,18,18,TTGTTGTCAGACTGATCCGA,0,2773127
ompRp1,0.05263157894736842,18,18,TTGTCAGATTTACAACTTTA,0,2821040
ompRp1,0.05263157894736842,18,18,TTGCGTACGCTTCCTTTACA,0,2777228
ompRp1,0.05263157894736842,18,18,TTAATCCCATATAGGGGATC,0,2777549
ompRp1,0.05263157894736842,18,18,TGTGCCGCTTACTCTCCGTT,0,2780759
ompRp1,0.05263157894736842,18,18,TGTGAGGGCGTGTCTTTCAA,0,2823861
ompRp1,0.05263157894736842,18,18,TGGCAAGAATACGCTCATGT,0,2765863
ompRp1,0.05263157894736842,18,18,TGCGAAGTATAGCCAGTTAC,0,2812595
ompRp1,0.05263157894736842,18,18,TGAGGTAGTAACGAGGAGTG,0,2767583
ompRp1,0.05263157894736842,18,18,TCTGTGAGTGACACACACGG,0,2779357
ompRp1,0.05263157894736842,18,18,TCTCATACTACGATGCTGAC,0,2812783
ompRp1,0.05263157894736842,18,18,TCTCAGGCTTGACGTTTAAC,0,2772230
ompRp1,0.05263157894736842,18,18,TCGGGACACGGACCGCAATA,0,2774190
ompRp1,0.05263157894736842,18,18,TCCTTGACCAACACGCAAAA,0,2781861
ompRp1,0.05263157894736842,18,18,TCCCAACAGACGGGTTAGTT,0,2781355
ompRp1,0.05263157894736842,18,18,TCAGGTCCTGGTCTGAGGGT,0,2768855
ompRp1,0.05263157894736842,18,18,TCAACCTATTTGCATTAGGC,0,2772432
ompRp1,0.05263157894736842,18,18,TATCGCCCGAGCAATAAACC,0,2770134
ompRp1,0.05263157894736842,18,18,TACGCAGGTTCTCCTAACCT,0,2767680
ompRp1,0.05263157894736842,18,18,TACCCGCCAGTGCGCCAGAA,0,2774676
ompRp1,0.05263157894736842,18,18,TAAAGCCACTATGGGTGCAA,0,2801718
ompRp1,0.05263157894736842,18,18,GTGTGGACCGGATTCTGGAT,0,2794109
ompRp1,0.05263157894736842,18,18,GTGATTAGGTTTGGTCAACT,0,2782857
ompRp1,0.05263157894736842,18,18,GTCTCTGACGTTTGCTTAAA,0,2770178
ompRp1,0.05263157894736842,18,18,GTATCCATTTTTCATCAGCT,0,2813010
ompRp1,0.05263157894736842,18,18,GTATATGCTGCAGCACTCCA,0,2819722
ompRp1,0.05263157894736842,18,18,GTATAGCGAAATAATATACG,0,2769693
ompRp1,0.05263157894736842,18,18,GGTTCTGCTACATATTAAGA,0,2821169
ompRp1,0.05263157894736842,18,18,GGTTAAGACTGGACGGCGTC,0,2777860
ompRp1,0.05263157894736842,18,18,GGTCATTGTTTACCGAGTTT,0,2781323
ompRp1,0.05263157894736842,18,18,GGGCTGAACTATGTCATATA,0,2799074
ompRp1,0.05263157894736842,18,18,GGCGAAAGTTGATGGAATTA,0,2800437
ompRp1,0.05263157894736842,18,18,GGCCTGGCACATTGACAGAT,0,2809907
ompRp1,0.05263157894736842,18,18,GGATCTGCGCTGACCAGGTA,0,2781187
ompRp1,0.05263157894736842,18,18,GGAGGGTATCAATCAGGAGG,0,2795749
ompRp1,0.05263157894736842,18,18,GGAACCGCCCCTGCGTCACA,0,2806352
ompRp1,0.05263157894736842,18,18,GCGGGCTCACGTTAGGCCAT,0,2783592
ompRp1,0.05263157894736842,18,18,GATCTGTGTGGACTTTATCC,0,2801226
ompRp1,0.05263157894736842,18,18,GATCAGGGAGACTAAACCGA,0,2781910
ompRp1,0.05263157894736842,18,18,GATATTCGCCAAAAGCGGGT,0,2806433
ompRp1,0.05263157894736842,18,18,GACGGTTGAGATGGCTACGA,0,2778318
ompRp1,0.05263157894736842,18,18,GAATTGATTTCCTACAGTGT,0,2767056
ompRp1,0.05263157894736842,18,18,CTTTCTACTGGGGGTGAACA,0,2774136
ompRp1,0.05263157894736842,18,18,CTGTTGGTACGCTCTAAAGT,0,2780904
ompRp1,0.05263157894736842,18,18,CTGTGGAAAATCTTAAACCT,0,2801939
ompRp1,0.05263157894736842,18,18,CTGGCTACTTTGCAAGGGGT,0,2822993
ompRp1,0.05263157894736842,18,18,CTGCTAGCATCAATTTGGCG,0,2778256
ompRp1,0.05263157894736842,18,18,CTCGGGGCTTGAATGATACA,0,2809028
ompRp1,0.05263157894736842,18,18,CTCGATTGCGGACCGGAGTG,0,2787262
ompRp1,0.05263157894736842,18,18,CTAATGCATTAGCGCTACAC,0,2777493
ompRp1,0.05263157894736842,18,18,CGTGAACGAACAGCGCACCT,0,2802279
ompRp1,0.05263157894736842,18,18,CGTCTAAAGCCACTAAACGT,0,2784240
ompRp1,0.05263157894736842,18,18,CGTATTATATATTGGGCAGC,0,2797411
ompRp1,0.05263157894736842,18,18,CGGACGAGGGCAGTCGTGAT,0,2803025
ompRp1,0.05263157894736842,18,18,CGGAAATCTGGGTCGAGATA,0,2776936
ompRp1,0.05263157894736842,18,18,CGCTTACTAGAGAGCACCTT,0,2778952
ompRp1,0.05263157894736842,18,18,CGCGACGGGGTCTTTTGTTG,0,2809921
ompRp1,0.05263157894736842,18,18,CGCCTGAACTCGCCCGTTTG,0,2818814
ompRp1,0.05263157894736842,18,18,CGCCACTTTGTATAGGTCAT,0,2812806
ompRp1,0.05263157894736842,18,18,CGCCACGGCCATTCGAAGGG,0,2775207
ompRp1,0.05263157894736842,18,18,CGAAGCGTAAGACTGTTTTA,0,2783142
ompRp1,0.05263157894736842,18,18,CGAAAGGCGAATTTGGCTCT,0,2805884
ompRp1,0.05263157894736842,18,18,CCTAGAGATTGGGCCTATTT,0,2773236
ompRp1,0.05263157894736842,18,18,CCGTTGGGGTGCGTATTTTA,0,2813020
ompRp1,0.05263157894736842,18,18,CCGTCGGTGACCCGGTCAGG,0,2786376
ompRp1,0.05263157894736842,18,18,CCGGGGTAATATAAGCGAAA,0,2801995
ompRp1,0.05263157894736842,18,18,CCCGCGGATTTTTCTACGTC,0,2796606
ompRp1,0.05263157894736842,18,18,CCATATAGTAATTGACGCGG,0,2793891
ompRp1,0.05263157894736842,18,18,CCAGGAGTTCTTGAATCATA,0,2769011
ompRp1,0.05263157894736842,18,18,CCACCGTTCGCCAATGGATT,0,2770696
ompRp1,0.05263157894736842,18,18,CATGAGTCTGTCGCCCGAAG,0,2821041
ompRp1,0.05263157894736842,18,18,CAGGATAATGGGTGTGCTTT,0,2797407
ompRp1,0.05263157894736842,18,18,CAGCTAGGGTACACTAGCTA,0,2814514
ompRp1,0.05263157894736842,18,18,CAGACGAATCTCAGTGTGTA,0,2774069
ompRp1,0.05263157894736842,18,18,CACAGGCTCGAGGTCAATGG,0,2769484
ompRp1,0.05263157894736842,18,18,CAAGAGCTTACCAATATGCC,0,2791687
ompRp1,0.05263157894736842,18,18,ATTAGGCGCTCTGCGCGTAA,0,2807719
ompRp1,0.05263157894736842,18,18,ATGTCTGGTGGATCGGCAGA,0,2796835
ompRp1,0.05263157894736842,18,18,ATGGGGCTTAGTATCGGTAT,0,2820204
ompRp1,0.05263157894736842,18,18,ATGGGATCCGCGGTGCCGGC,0,2798730
ompRp1,0.05263157894736842,18,18,ATCTTTACTTTAAGCTCCGA,0,2787879
ompRp1,0.05263157894736842,18,18,ATCTCTAACTGGACCTTAAA,0,2778539
ompRp1,0.05263157894736842,18,18,ATAGACTCGACCCAACCGTA,0,2783358
ompRp1,0.05263157894736842,18,18,AGTTGATGATCTGTTTTACT,0,2770375
ompRp1,0.05263157894736842,18,18,AGGGCATAGTGATTAAGTGT,0,2770220
ompRp1,0.05263157894736842,18,18,ACTCATCACGTAGTAATTGA,0,2785507
ompRp1,0.05263157894736842,18,18,ACGGAAGTAGTGGGGTTGAT,0,2778560
ompRp1,0.05263157894736842,18,18,ACGAGCCGTATCAGATGCAG,0,2777096
ompRp1,0.05263157894736842,18,18,ACGACTTCGCTTAGGTAAAC,0,2765864
ompRp1,0.05263157894736842,18,18,ACAGTAGGGTGGACAGAGTG,0,2798086
ompRp1,0.05263157894736842,18,18,ACACAACCGCACGAGGAGTC,0,2803133
ompRp1,0.05263157894736842,18,18,AAGGCAGCTTGAGAGATGGT,0,2772596
ompRp1,0.05263157894736842,18,18,AAGCTCGAGAGCTAAGGCGA,0,2819817
ompRp1,0.05263157894736842,18,18,AAGCCGTAAAAGGTCTAGTT,0,2802942
ompRp1,0.05263157894736842,18,18,AACGCGAGCGTGGCTGTGTC,0,2772048
ompRp1,0.05263157894736842,18,18,AAATTCGATGCGATAATGTA,0,2777525
ompRp1,0.05555555555555555,17,17,TTTTAATGCGTCGTTGGGAC,0,2796832
ompRp1,0.05555555555555555,17,17,TTGTCTTGGAAGATTGTTTG,0,2783603
ompRp1,0.05555555555555555,17,17,TTCCAACAAATACGACCGAC,0,2796319
ompRp1,0.05555555555555555,17,17,TTCACAGTCTGTGGTACGGA,0,2806276
ompRp1,0.05555555555555555,17,17,TTCAAGCAGACTATTGTCAT,0,2775339
ompRp1,0.05555555555555555,17,17,TGTTTACTACCCCAATATGA,0,2776395
ompRp1,0.05555555555555555,17,17,TGTGGTGTTCATGTCAGCCG,0,2799015
ompRp1,0.05555555555555555,17,17,TGTCTTCGATATTACCTATA,0,2803986
ompRp1,0.05555555555555555,17,17,TGGTAAACTGTGCTTCGGAC,0,2765894
ompRp1,0.05555555555555555,17,17,TGGCGGCTTCTTATGCACTA,0,2804553
ompRp1,0.05555555555555555,17,17,TGGACCCTGAGGCTGCTCTC,0,2802277
ompRp1,0.05555555555555555,17,17,TGCGTGACGCAGTTAATAAT,0,2823744
ompRp1,0.05555555555555555,17,17,TGCGAAACCTGAACATGGAA,0,2767480
ompRp1,0.05555555555555555,17,17,TGCCACCCCAAGTCAGTCCT,0,2794956
ompRp1,0.05555555555555555,17,17,TGACTTACGGATTGTCCCAC,0,2781994
ompRp1,0.05555555555555555,17,17,TGAATAGTAGCACAGGATGC,0,2789065
ompRp1,0.05555555555555555,17,17,TCTGCCTGAACGTTTTTGCT,0,2796403
ompRp1,0.05555555555555555,17,17,TCTCGACGTCGCAGTAGGTA,0,2784152
ompRp1,0.05555555555555555,17,17,TCGTAGAATCATAAAGTAAT,0,2801272
ompRp1,0.05555555555555555,17,17,TCGCGAATTCTACGAAAACT,0,2824354
ompRp1,0.05555555555555555,17,17,TCCTTGTGATTCAGGGGCAG,0,2784238
ompRp1,0.05555555555555555,17,17,TCCCAATACCCGGTGGCGCT,0,2788215
ompRp1,0.05555555555555555,17,17,TCCCAAGGGAGAGCTTAGAG,0,2810935
ompRp1,0.05555555555555555,17,17,TCATTACCGCGCTCACGCGG,0,2798685
ompRp1,0.05555555555555555,17,17,TCATGGGATTGAATGTTCAA,0,2810811
ompRp1,0.05555555555555555,17,17,TCATGCACCGACCCCTGACA,0,2793351
ompRp1,0.05555555555555555,17,17,TCACCCCCGGTAAAAATTCG,0,2795950
ompRp1,0.05555555555555555,17,17,TCACAAGCTCTAACTAACGT,0,2767913
ompRp1,0.05555555555555555,17,17,TCACAAAGTCAAACACCCTA,0,2814589
ompRp1,0.05555555555555555,17,17,TCAACGGGATAAGACAGGGA,0,2820268
ompRp1,0.05555555555555555,17,17,TATAATCCCGTATTGAAGAC,0,2789623
ompRp1,0.05555555555555555,17,17,TAGGGTCAGTTCGCACCATG,0,2796389
ompRp1,0.05555555555555555,17,17,TAGGGACTCCTGGGTGCGTG,0,2782654
ompRp1,0.05555555555555555,17,17,TAGCTTCCCGAAAGGCGAAT,0,2772773
ompRp1,0.05555555555555555,17,17,GTGGACGGGCTAGTCCGCGT,0,2805294
ompRp1,0.05555555555555555,17,17,GTGATGCACTGTAGCGGTCA,0,2786721
ompRp1,0.05555555555555555,17,17,GTCTGTTTTATAATTGGCAT,0,2824765
ompRp1,0.05555555555555555,17,17,GTCGGGTGCCTCAGCGCGTT,0,2802388
ompRp1,0.05555555555555555,17,17,GTCGCGTCAAACCCCATCAT,0,2768326
ompRp1,0.05555555555555555,17,17,GTCGCATTTGCTAGCCATTT,0,2822358
ompRp1,0.05555555555555555,17,17,GTCGAACTGCTCACCTTCAG,0,2821732
ompRp1,0.05555555555555555,17,17,GTAAGCGGAACGCCGGTCTT,0,2768656
ompRp1,0.05555555555555555,17,17,GGGTGCCGGGATTCCAGCAT,0,2802110
ompRp1,0.05555555555555555,17,17,GGGGCGCATTTCGGGAAGTC,0,2775597
ompRp1,0.05555555555555555,17,17,GGGAGCGGACCTACGTCAGA,0,2805306
ompRp1,0.05555555555555555,17,17,GGGAATCGTCACAGAGAGAA,0,2778829
ompRp1,0.05555555555555555,17,17,GGCCGAGCTGACAGCACTGA,0,2796908
ompRp1,0.05555555555555555,17,17,GGCATGTCGAACCAAGGATA,0,2808867
ompRp1,0.05555555555555555,17,17,GGACTAATGCCCACCTTTGG,0,2810238
ompRp1,0.05555555555555555,17,17,GCTTGAACAGCCCCCCACCG,0,2801185
ompRp1,0.05555555555555555,17,17,GCGTGCCTGTGACATTCTGG,0,2782696
ompRp1,0.05555555555555555,17,17,GCGCGTGGAATGAGTGGAAC,0,2818520
ompRp1,0.05555555555555555,17,17,GCAATTGTGTAGCAGTTAAC,0,2822748
ompRp1,0.05555555555555555,17,17,GATCAGACGCAATTGGAGTT,0,2820367
ompRp1,0.05555555555555555,17,17,GAGTTCCAAAGTGTTTAAGT,0,2791354
ompRp1,0.05555555555555555,17,17,GAGTATAGTACGTCCGCTCT,0,2810529
ompRp1,0.05555555555555555,17,17,GACTGTCGTTGAATTAAACC,0,2818816
ompRp1,0.05555555555555555,17,17,GAAGGTAATGACCCAATGAT,0,2787944
ompRp1,0.05555555555555555,17,17,GAAGCGTTAGGCGACGCAGT,0,2807754
ompRp1,0.05555555555555555,17,17,GAACCCGGGAGTGGGCATTG,0,2771379
ompRp1,0.05555555555555555,17,17,GAACACGAGCAGTACTGTCC,0,2806586
ompRp1,0.05555555555555555,17,17,CTTGCGCGATATGGACGATG,0,2784211
ompRp1,0.05555555555555555,17,17,CTTCTCCAGTGAGCGCCCAA,0,2771727
ompRp1,0.05555555555555555,17,17,CTCAAGACACTAGCTGCGTA,0,2795992
ompRp1,0.05555555555555555,17,17,CTATGATGCATTTATCTAAC,0,2770180
ompRp1,0.05555555555555555,17,17,CTAATAATGCAAAAGGCTCT,0,2770662
ompRp1,0.05555555555555555,17,17,CTAAAGCGCAGTCACTAAAG,0,2771737
ompRp1,0.05555555555555555,17,17,CGTGAAGAGATTATAGGTTT,0,2786089
ompRp1,0.05555555555555555,17,17,CGGGTGGTTGGAAAATTTTT,0,2798729
ompRp1,0.05555555555555555,17,17,CGGACACTCGCAATCCCGAT,0,2806859
ompRp1,0.05555555555555555,17,17,CGCTCAACAAGAGGGCGGTT,0,2785024
ompRp1,0.05555555555555555,17,17,CGCTATAAATTTTTGTCTCC,0,2777859
ompRp1,0.05555555555555555,17,17,CGCCGCTACGCACGTCATAT,0,2779196
ompRp1,0.05555555555555555,17,17,CGATTTATTCTTCTGCGGGA,0,2766152
ompRp1,0.05555555555555555,17,17,CCTTTGGCTACGCACTTGGA,0,2820750
ompRp1,0.05555555555555555,17,17,CCTCCACGAGGACCTTGCGC,0,2816092
ompRp1,0.05555555555555555,17,17,CCGAATAGCTCCGTACGCGT,0,2821586
ompRp1,0.05555555555555555,17,17,CCCCCATAGTTGCAAGACAT,0,2824033
ompRp1,0.05555555555555555,17,17,CCATTGATGCGATACGGTTG,0,2810737
ompRp1,0.05555555555555555,17,17,CCATACAATGAACACTCAGT,0,2803979
ompRp1,0.05555555555555555,17,17,CCACACGCCAAGTTTTAATA,0,2802376
ompRp1,0.05555555555555555,17,17,CATCTCCCATGCTCAAAACC,0,2803148
ompRp1,0.05555555555555555,17,17,CAAGCCGATGTTCTCCGGAT,0,2819677
ompRp1,0.05555555555555555,17,17,CAACTCTTACCGGCCCTAAG,0,2803521
ompRp1,0.05555555555555555,17,17,ATGGTTCGTGGTCTTGCGTC,0,2800863
ompRp1,0.05555555555555555,17,17,ATGATCCATCAATCCGGCAT,0,2782844
ompRp1,0.05555555555555555,17,17,ATGAATCGCTAAGGGACCGT,0,2788463
ompRp1,0.05555555555555555,17,17,ATCGGCTAGTGTGGTCAGCT,0,2783450
ompRp1,0.05555555555555555,17,17,ATATCGGTTCTCTGGGCGGT,0,2773698
ompRp1,0.05555555555555555,17,17,ATACCATGTCTTAAAGTATG,0,2794100
ompRp1,0.05555555555555555,17,17,ATACAGCTCGTGTTTCGAGA,0,2783092
ompRp1,0.05555555555555555,17,17,AGTGTCGATCCAGGTTGACA,0,2773969
ompRp1,0.05555555555555555,17,17,AGGTTATGCAATTGACACAG,0,2767157
ompRp1,0.05555555555555555,17,17,AGCTAAAGTGATCATGAGGT,0,2778195
ompRp1,0.05555555555555555,17,17,AGCCCCGAGTTGATGTGCTT,0,2800387
ompRp1,0.05555555555555555,17,17,AGATCAGATGTCTGATCTAT,0,2813717
ompRp1,0.05555555555555555,17,17,ACTTTCTTTGGGAACGGGGT,0,2791703
ompRp1,0.05555555555555555,17,17,ACTGTTAGGCAGTCTGGTGC,0,2812355
ompRp1,0.05555555555555555,17,17,ACTACCGTTCCACGTGAGCT,0,2821428
ompRp1,0.05555555555555555,17,17,ACGTTGCTATCGTTACTCAC,0,2772345
ompRp1,0.05555555555555555,17,17,ACGTGGCCGCACCCTGACAA,0,2792140
ompRp1,0.05555555555555555,17,17,ACGGTGGGCATTATGGTTGC,0,2768164
ompRp1,0.05555555555555555,17,17,ACGACGTAACTCAAGATGAG,0,2814155
ompRp1,0.05555555555555555,17,17,ACCTCTGAGTAGTGTGCTAT,0,2810246
ompRp1,0.05555555555555555,17,17,ACCCGGCTATGACTCAGGTT,0,2787832
ompRp1,0.05555555555555555,17,17,ACCATTCGTGAGTCATCATA,0,2776209
ompRp1,0.05555555555555555,17,17,ACCATAATCGCAGGGCCTTA,0,2771305
ompRp1,0.05555555555555555,17,17,AATTATGATTAAGCTAAGTA,0,2778150
ompRp1,0.05555555555555555,17,17,AATCCCAGCATATGACCCGC,0,2796669
ompRp1,0.05555555555555555,17,17,AAGATGCGGCGACGTGAACG,0,2797426
ompRp1,0.05555555555555555,17,17,AACTTTTATTAGCACTTTCT,0,2776442
ompRp1,0.058823529411764705,16,16,TTTCTGGTTGTCTATATTGT,0,2819678
ompRp1,0.058823529411764705,16,16,TTCGCGGAGTCAAGGCCATA,0,2785108
ompRp1,0.058823529411764705,16,16,TTATTATCCTGGGACAGATT,0,2818341
ompRp1,0.058823529411764705,16,16,TTAGCGTGGGCGTATATGTA,0,2790731
ompRp1,0.058823529411764705,16,16,TTACGGTGCACTGGCATCAC,0,2773084
ompRp1,0.058823529411764705,16,16,TTACCAATTACCCAAGATTA,0,2766405
ompRp1,0.058823529411764705,16,16,TTAATGACGTCAACGGATGC,0,2804885
ompRp1,0.058823529411764705,16,16,TGTTTCATAGCAGCTCACAC,0,2781864
ompRp1,0.058823529411764705,16,16,TGTATAACTAATGGACGGGG,0,2777011
ompRp1,0.058823529411764705,16,16,TGTACTAGATTTTCGGTTGA,0,2808163
ompRp1,0.058823529411764705,16,16,TGGGTTGAAGTCATCAGCAA,0,2779482
ompRp1,0.058823529411764705,16,16,TGGGCTCGGGCCGCTTCGAT,0,2817584
ompRp1,0.058823529411764705,16,16,TGGCGTTTCAACGAAATTCT,0,2792330
ompRp1,0.058823529411764705,16,16,TGCTGGTGGAAGGCGTGTCT,0,2804832
ompRp1,0.058823529411764705,16,16,TGCGAACATCACACTAGATA,0,2813902
ompRp1,0.058823529411764705,16,16,TGCCAGCGCCGTCGCTGAAC,0,2802578
ompRp1,0.058823529411764705,16,16,TGATAAGATTTCACGCACAC,0,2823042
ompRp1,0.058823529411764705,16,16,TGACTGCGAATAGGCACTTT,0,2769120
ompRp1,0.058823529411764705,16,16,TGACCGAGAAGATTCACAGA,0,2803264
ompRp1,0.058823529411764705,16,16,TCTTTACTTTACGAAGGGTT,0,2777599
ompRp1,0.058823529411764705,16,16,TCTTCCTGAATGCTCTCGGT,0,2775138
ompRp1,0.058823529411764705,16,16,TCTGGACAGTGCTTGATGCT,0,2772593
ompRp1,0.058823529411764705,16,16,TCATTCTTTGGACTCGTGCT,0,2789619
ompRp1,0.058823529411764705,16,16,TCATATCTCTACTTGTATCA,0,2795470
ompRp1,0.058823529411764705,16,16,TCAATGGTACTTGATCGCTA,0,2797380
ompRp1,0.058823529411764705,16,16,TATTCGGTGCAATAAGTCCC,0,2792608
ompRp1,0.058823529411764705,16,16,TATTCCTGGCCTCAACTTAT,0,2794804
ompRp1,0.058823529411764705,16,16,TAGGGGATCTAGGCATCACG,0,2771235
ompRp1,0.058823529411764705,16,16,TAGATGATACTCACGTATCA,0,2805107
ompRp1,0.058823529411764705,16,16,TAAGCGAAATATCTCCGGTT,0,2805679
ompRp1,0.058823529411764705,16,16,GTTAGGGGTGTTACTGCGAG,0,2774480
ompRp1,0.058823529411764705,16,16,GTGTCAGAACCACACCCCTA,0,2787096
ompRp1,0.058823529411764705,16,16,GTCCCTCAGGACAGTAAAAC,0,2800882
ompRp1,0.058823529411764705,16,16,GTATGACACGCTTATTGCTC,0,2810393
ompRp1,0.058823529411764705,16,16,GTATGAAGATGTCAAAGAGT,0,2823931
ompRp1,0.058823529411764705,16,16,GTAGATGTACTAAGGGTCGC,0,2773784
ompRp1,0.058823529411764705,16,16,GTAACAGTAACACACGCCAT,0,2765310
ompRp1,0.058823529411764705,16,16,GGTTAGTACAGTGGCACTGT,0,2769368
ompRp1,0.058823529411764705,16,16,GGTCGAGCCGAGACATTGTG,0,2822349
ompRp1,0.058823529411764705,16,16,GGGCGTTCAGGCCGTCCGAA,0,2814779
ompRp1,0.058823529411764705,16,16,GGGAAATGCCTTTCTGAGTT,0,2790144
ompRp1,0.058823529411764705,16,16,GGCCGGTTTCGCGCCAAAGG,0,2777309
ompRp1,0.058823529411764705,16,16,GGACGAGGTATGGCCCCCAG,0,2790549
ompRp1,0.058823529411764705,16,16,GCTATATTTTTAATCTACCT,0,2784566
ompRp1,0.058823529411764705,16,16,GCTACATGTACTGATGTGGT,0,2795355
ompRp1,0.058823529411764705,16,16,GCGGAAGCCGCGGAGCGAGA,0,2815860
ompRp1,0.058823529411764705,16,16,GCGAAGCATTGAGTGCGGCA,0,2766871
ompRp1,0.058823529411764705,16,16,GCAGGTGGAAGCGATTGGTG,0,2795980
ompRp1,0.058823529411764705,16,16,GCACACGGTACCACCACCAG,0,2782057
ompRp1,0.058823529411764705,16,16,GACTACTCGCACGCTCCGTG,0,2779051
ompRp1,0.058823529411764705,16,16,GAAGTCTATATTGCTGTTGC,0,2779401
ompRp1,0.058823529411764705,16,16,GAACAATACGCCCAACAAAA,0,2814247
ompRp1,0.058823529411764705,16,16,GAAAGTCGGCTGCTATACCA,0,2813017
ompRp1,0.058823529411764705,16,16,CTTTACTCATCTGTCTGTCT,0,2768440
ompRp1,0.058823529411764705,16,16,CTTACTTTAATCATGCTTAT,0,2820437
ompRp1,0.058823529411764705,16,16,CTTAAATTACACTCCTAATC,0,2794778
ompRp1,0.058823529411764705,16,16,CTGGTCCCGGGGGTAAAGAA,0,2816553
ompRp1,0.058823529411764705,16,16,CTGGGAAACGAGGCTTACCA,0,2767588
ompRp1,0.058823529411764705,16,16,CTGCTGACGTCTCGGCAGAA,0,2804743
ompRp1,0.058823529411764705,16,16,CTCGCATCCAGGCACTGCAT,0,2783344
ompRp1,0.058823529411764705,16,16,CTCATGGGGATTCATCACTA,0,2819443
ompRp1,0.058823529411764705,16,16,CTCACCCCACGTATACACGA,0,2784104
ompRp1,0.058823529411764705,16,16,CTCAAAAACACTAAGACGGG,0,2809631
ompRp1,0.058823529411764705,16,16,CTATAATGTATGGAGGTCCT,0,2770673
ompRp1,0.058823529411764705,16,16,CTAAGTGAGGGAGCCACTGT,0,2796138
ompRp1,0.058823529411764705,16,16,CGTAGCTGTGGAGGTGCAAC,0,2821973
ompRp1,0.058823529411764705,16,16,CGGGACAAGGTTAAAGACAA,0,2785893
ompRp1,0.058823529411764705,16,16,CGGACTAATCGATCGTGAAC,0,2794603
ompRp1,0.058823529411764705,16,16,CGCGTGCGGGTATTGACGGA,0,2789258
ompRp1,0.058823529411764705,16,16,CGCGACCCCTTGGCAATTTA,0,2766593
ompRp1,0.058823529411764705,16,16,CGCCTGAAAAGAGGATATAG,0,2790943
ompRp1,0.058823529411764705,16,16,CGATACCGTTCCGGGTATTA,0,2778594
ompRp1,0.058823529411764705,16,16,CCTTTGACCGGCCCTCCGTT,0,2809953
ompRp1,0.058823529411764705,16,16,CCTGTCCTGAGAGCTCGACA,0,2802126
ompRp1,0.058823529411764705,16,16,CCGGAAATTATATCCCCGGA,0,2767129
ompRp1,0.058823529411764705,16,16,CCGCTGCCCACTTCCTGGAC,0,2766881
ompRp1,0.058823529411764705,16,16,CCGATAGTAGTTAATTTATT,0,2819492
ompRp1,0.058823529411764705,16,16,CCCCCGCTGGCTCCTATTAC,0,2787381
ompRp1,0.058823529411764705,16,16,CCCATCGTCCGGGTGGTCTT,0,2780261
ompRp1,0.058823529411764705,16,16,CCAGATGAATAGTCATACTG,0,2793789
ompRp1,0.058823529411764705,16,16,CATGTGTAGACTCTTTGGCC,0,2767025
ompRp1,0.058823529411764705,16,16,CAGATTCGGCTAGACCTATA,0,2792188
ompRp1,0.058823529411764705,16,16,CACTGGCGTGCATCATGTTG,0,2772861
ompRp1,0.058823529411764705,16,16,CACTGGATTTAATGGGGGAC,0,2788186
ompRp1,0.058823529411764705,16,16,CACCGTCCCTCTGCGTATCC,0,2785163
ompRp1,0.058823529411764705,16,16,CACCCTAAGCCCGTCAACTC,0,2795030
ompRp1,0.058823529411764705,16,16,CACCACGAGGACCATGTTAA,0,2770150
ompRp1,0.058823529411764705,16,16,CAATTGTCTGGGTTACGAGA,0,2769441
ompRp1,0.058823529411764705,16,16,ATTACGATGTGGTCGAAAAA,0,2784236
ompRp1,0.058823529411764705,16,16,ATGTTATCCACATGTCTAAC,0,2786994
ompRp1,0.058823529411764705,16,16,ATGGTATTCCCTGGCTCGGT,0,2776846
ompRp1,0.058823529411764705,16,16,ATGGCCCCGGGCGCTTCGTT,0,2817586
ompRp1,0.058823529411764705,16,16,ATGCGAAGGGTTTAGTACTT,0,2785718
ompRp1,0.058823529411764705,16,16,ATCATAATTATTTACGTCCT,0,2773741
ompRp1,0.058823529411764705,16,16,ATATCAAATTTGGCATCGCT,0,2786161
ompRp1,0.058823529411764705,16,16,ATAGCGAACGAAGAACACAT,0,2795012
ompRp1,0.058823529411764705,16,16,AGTCCGATCGGTCGTATTCG,0,2800553
ompRp1,0.058823529411764705,16,16,AGGGTTATAACTTTGGAAAA,0,2778214
ompRp1,0.058823529411764705,16,16,AGCGTAGGTGAACACTGTAA,0,2792378
ompRp1,0.058823529411764705,16,16,AGCCTCGGGCACTGAGTAAA,0,2777016
ompRp1,0.058823529411764705,16,16,AGCAAGTTATTATCATATAT,0,2776941
ompRp1,0.058823529411764705,16,16,AGATCAGTAATCCGACACTT,0,2811939
ompRp1,0.058823529411764705,16,16,AGAAGTTCACTTGGAAAAGG,0,2809626
ompRp1,0.058823529411764705,16,16,ACTGCTATTCACTACGTAAA,0,2822053
ompRp1,0.058823529411764705,16,16,ACTCTGGACTGAACGTCCGA,0,2787724
ompRp1,0.058823529411764705,16,16,ACTCTGCTTCTCTCGAATAT,0,2777930
ompRp1,0.058823529411764705,16,16,ACTAGAGAGTTCCAGAGGCA,0,2806039
ompRp1,0.058823529411764705,16,16,ACTACGTGGTTAGAGTGTCA,0,2793206
ompRp1,0.058823529411764705,16,16,ACGTTACCGTGCGGGCCTTC,0,2795273
ompRp1,0.058823529411764705,16,16,ACCGGGTTTGGTCAGAATTC,0,2774884
ompRp1,0.058823529411764705,16,16,ACCGGGTGGAGGAGCAAAGA,0,2808375
ompRp1,0.058823529411764705,16,16,ACCGAACTACTGCGGATCAG,0,2795918
ompRp1,0.058823529411764705,16,16,ACCCTCTAGCGCTGGTCCTT,0,2821404
ompRp1,0.058823529411764705,16,16,AATGGGTGTGTTGTTTCAGC,0,2770580
ompRp1,0.058823529411764705,16,16,AATCCGATTAACGTATAATC,0,2822662
ompRp1,0.058823529411764705,16,16,AAGTACACCTCGTCAATTTG,0,2790784
ompRp1,0.058823529411764705,16,16,AAGCTGCCATAATGGCAACT,0,2781080
ompRp1,0.058823529411764705,16,16,AAGCGGATTTTGGCTATGCA,0,2805331
ompRp1,0.058823529411764705,16,16,AAGAGCATAGGCTGGGTGTA,0,2780672
ompRp1,0.058823529411764705,16,16,AACCGAAGGGGTTTTATTTC,0,2766469
ompRp1,0.0625,15,15,TTTTGTATCAAGGCGGTCTT,0,2788870
ompRp1,0.0625,15,15,TTTTCCACTATATGAGCTTG,0,2820795
ompRp1,0.0625,15,15,TTTGGGCTTATGTATACCGC,0,2823889
ompRp1,0.0625,15,15,TTTCGGCTAGTACTGAAGTC,0,2784449
ompRp1,0.0625,15,15,TTTCACATTCGTGTTAATGA,0,2812187
ompRp1,0.0625,15,15,TTTAGTATGATGACAGCCAT,0,2771856
ompRp1,0.0625,15,15,TTGCGGTCATACCGAAGTGG,0,2779059
ompRp1,0.0625,15,15,TTGCCAAGGGACGCATGTTG,0,2802379
ompRp1,0.0625,15,15,TTCATTACATTTTGGCAGAA,0,2804783
ompRp1,0.0625,15,15,TTAGGGCGGGCTCGAGCTAG,0,2808381
ompRp1,0.0625,15,15,TTAACATGAGTCGCGTTATG,0,2817552
ompRp1,0.0625,15,15,TGGTACAGATTGGGACCCGA,0,2803627
ompRp1,0.0625,15,15,TGGGTCAGTAGGGATTACGA,0,2771416
ompRp1,0.0625,15,15,TGGCGCGTGCCATGGGAGTA,0,2799682
ompRp1,0.0625,15,15,TGCTTTCTCCGTGCAGATAA,0,2778384
ompRp1,0.0625,15,15,TGCTGAGGTCGTACATACTA,0,2800675
ompRp1,0.0625,15,15,TGCACCCATGGCTTTGGGAA,0,2773735
ompRp1,0.0625,15,15,TGAAAAGCAATCAGAGACAG,0,2805504
ompRp1,0.0625,15,15,TCTGCCTGCCCACTGTTACT,0,2766040
ompRp1,0.0625,15,15,TCTCGCAGGCTACTAAGGGA,0,2816732
ompRp1,0.0625,15,15,TCGTACTCCTGCGTTAGCCA,0,2778027
ompRp1,0.0625,15,15,TCGGCCTCCTCTCCGGCCGA,0,2822820
ompRp1,0.0625,15,15,TCGGAAAGACTTCCCAGCGC,0,2798261
ompRp1,0.0625,15,15,TATATTTTCACAAGGCAGTG,0,2765996
ompRp1,0.0625,15,15,TAGCATTACGGTAGCAAATC,0,2788155
ompRp1,0.0625,15,15,TACTTAAAGAAGAGCTAGAA,0,2769191
ompRp1,0.0625,15,15,TACCCCTTCAGCTTAGTGGT,0,2789705
ompRp1,0.0625,15,15,TAAACTGAGTGGTCAGTGCG,0,2809248
ompRp1,0.0625,15,15,GTTTGGGGATCGCCAGTAAC,0,2768165
ompRp1,0.0625,15,15,GTTGTCAGACGCGCAACAGG,0,2807753
ompRp1,0.0625,15,15,GTGGAATCGACAAGGACGGG,0,2784631
ompRp1,0.0625,15,15,GTGCTACGTCCTCTAGGAAT,0,2765987
ompRp1,0.0625,15,15,GTGCCAAGTCGAAGCAGAAG,0,2769970
ompRp1,0.0625,15,15,GTCTCAACTGTATGGTATTC,0,2782382
ompRp1,0.0625,15,15,GTCACGGGCCACCGTTCCCA,0,2818919
ompRp1,0.0625,15,15,GTATCGAGATTGCAATGTTT,0,2765819
ompRp1,0.0625,15,15,GTAGTGTTCCACGGATCCTG,0,2812188
ompRp1,0.0625,15,15,GTAAGTTAATAGAACCGGCA,0,2796239
ompRp1,0.0625,15,15,GGTGGGGCGGGGACAGTGCA,0,2801629
ompRp1,0.0625,15,15,GGTAAATTTCTGCATTCAGG,0,2782384
ompRp1,0.0625,15,15,GGGTCGGCCGCCCCTTACGC,0,2798920
ompRp1,0.0625,15,15,GGGCAACGGGTCACAGATGT,0,2776884
ompRp1,0.0625,15,15,GGGACAAAGAGGGTTGCATG,0,2798254
ompRp1,0.0625,15,15,GGGAATTCAACCAGACGTGT,0,2813909
ompRp1,0.0625,15,15,GGCTGCCACAATGTTCTTAG,0,2780480
ompRp1,0.0625,15,15,GGCTGATTTAATCTCAAGCT,0,2819912
ompRp1,0.0625,15,15,GGCGGGTACTCAACCCGAGT,0,2805920
ompRp1,0.0625,15,15,GGCGAGCGGAATCTCGCTGC,0,2802070
ompRp1,0.0625,15,15,GGCATGCATCTGGAACACAC,0,2777099
ompRp1,0.0625,15,15,GGCATGACATCTATTTTGAT,0,2813053
ompRp1,0.0625,15,15,GGATAATACACCGCTTCAAT,0,2795405
ompRp1,0.0625,15,15,GGACATCACCGCATTATACT,0,2815824
ompRp1,0.0625,15,15,GGAAGCGCATGACGGAGGAC,0,2802603
ompRp1,0.0625,15,15,GGAAAGTATCCCGGTCGGTT,0,2821047
ompRp1,0.0625,15,15,GCTGGTGGACTGTGGTAAAT,0,2799784
ompRp1,0.0625,15,15,GCTGGAGCTTCGAGTAACGA,0,2799908
ompRp1,0.0625,15,15,GCTCCCAGGTACATGTGCAT,0,2807348
ompRp1,0.0625,15,15,GCGTAATGGCGGGTTGCTAG,0,2813418
ompRp1,0.0625,15,15,GCGGGACTGCCTAAGTTTGT,0,2793855
ompRp1,0.0625,15,15,GCGCGGCCGTACCGTGGATT,0,2766570
ompRp1,0.0625,15,15,GCCGTAATGCATCCTTTATA,0,2789259
ompRp1,0.0625,15,15,GCCGCGGATGGATTGCGTCA,0,2812963
ompRp1,0.0625,15,15,GCCCCTTAAAAAGTGTGCAG,0,2801849
ompRp1,0.0625,15,15,GCCACTCTCCCCGGAAGAGT,0,2768235
ompRp1,0.0625,15,15,GCCACTCTCAGCCCTTTTTT,0,2773690
ompRp1,0.0625,15,15,GCCACGGGGTAATCATACTA,0,2819815
ompRp1,0.0625,15,15,GCATACCTGTACAGTTTGAT,0,2805784
ompRp1,0.0625,15,15,GCAGTCTTCCTACATTGCAG,0,2792961
ompRp1,0.0625,15,15,GCAGGCCTTTAAACTTCCAG,0,2812709
ompRp1,0.0625,15,15,GATTAAATGGCTGGGAGAGA,0,2771499
ompRp1,0.0625,15,15,GATCCCAGGAAGATGACTAG,0,2789717
ompRp1,0.0625,15,15,GAGTAGACTCCTCCACCAAA,0,2794022
ompRp1,0.0625,15,15,GAGCGACTAGGTACAGGTAC,0,2805202
ompRp1,0.0625,15,15,GAGATTAAGCGTGAATATGA,0,2768132
ompRp1,0.0625,15,15,GACTCGTAGGTGAACGGCGG,0,2820861
ompRp1,0.0625,15,15,GAAGTGGGCTGGGACGTTGT,0,2813163
ompRp1,0.0625,15,15,CTTTTTGACGAACGTGGCCA,0,2814738
ompRp1,0.0625,15,15,CTTTAACTGAATCTGCAAGA,0,2814849
ompRp1,0.0625,15,15,CTTGTGCGACAGAAGCTCAT,0,2780988
ompRp1,0.0625,15,15,CTTGTATCTAAATTCGGATG,0,2792063
ompRp1,0.0625,15,15,CTTCGGTTGCTTTCTTTGAG,0,2792810
ompRp1,0.0625,15,15,CTTAGTGTTGACCAAGCTGT,0,2783866
ompRp1,0.0625,15,15,CTGTAGTCGGGATTCTGAAT,0,2789346
ompRp1,0.0625,15,15,CTGTACTAGGTTTATGGCGG,0,2807717
ompRp1,0.0625,15,15,CTGGTTGCGTTTATCGTCCG,0,2778516
ompRp1,0.0625,15,15,CTGACTCACTATGGTCATGC,0,2795011
ompRp1,0.0625,15,15,CTGAACCCTACCGGCCGGTA,0,2778319
ompRp1,0.0625,15,15,CTCGGAAAATTAAGGTTTTG,0,2805120
ompRp1,0.0625,15,15,CTCCGGAATAGTAGACCCTC,0,2779576
ompRp1,0.0625,15,15,CGTTCACAGAGGTACGTGGT,0,2791298
ompRp1,0.0625,15,15,CGTGTGTTGTACGTGTATCG,0,2811582
ompRp1,0.0625,15,15,CGGGTTAATGATCGCGATGA,0,2788972
ompRp1,0.0625,15,15,CGGGTATCTAGAAGACGTAA,0,2812479
ompRp1,0.0625,15,15,CGGGCATGACCTGGTAAGAC,0,2805676
ompRp1,0.0625,15,15,CGGCCCCATTACATCCGAAA,0,2773045
ompRp1,0.0625,15,15,CGCTCATATTCGAGTCCCGT,0,2795420
ompRp1,0.0625,15,15,CGATGTACGATCTAACTTCA,0,2776383
ompRp1,0.0625,15,15,CGACCTTTCTCAAACACTTC,0,2804341
ompRp1,0.0625,15,15,CGACCGCGAATGATAGTTAT,0,2784017
ompRp1,0.0625,15,15,CGAACATGTAATCCTCAAAG,0,2803022
ompRp1,0.0625,15,15,CCTTCTGATGGCTCCCTTTG,0,2808924
ompRp1,0.0625,15,15,CCTTATATCTGCATGCTGAG,0,2777331
ompRp1,0.0625,15,15,CCTCTAGTCGTTTGTAATTA,0,2771492
ompRp1,0.0625,15,15,CCGGTATGGCTATGAGGGAG,0,2789110
ompRp1,0.0625,15,15,CCGGACATCGGATCGCGCCT,0,2813097
ompRp1,0.0625,15,15,CCGCGCTACAGATTATTGGT,0,2798166
ompRp1,0.0625,15,15,CCGCACCACACAGAAACGGA,0,2770099
ompRp1,0.0625,15,15,CCGACGAACCGTTCCGAGTC,0,2810360
ompRp1,0.0625,15,15,CCCGCGTAAATGCTCGGACT,0,2782417
ompRp1,0.0625,15,15,CCCCCGTAAACGTTAGAGGT,0,2820545
ompRp1,0.0625,15,15,CCCCCGGCGTCAAACCTATG,0,2804907
ompRp1,0.0625,15,15,CCATGGGACCGGACGTAGAA,0,2796718
ompRp1,0.0625,15,15,CCAGCTCTAAGAACTGAACA,0,2774506
ompRp1,0.0625,15,15,CCACCGGATAGTACATCGAT,0,2790788
ompRp1,0.0625,15,15,CCACAATCGCGGTATCAGCG,0,2790627
ompRp1,0.0625,15,15,CATTTTTTTCAGAACCGTAT,0,2804917
ompRp1,0.0625,15,15,CATTTCTCGACGCACAGCGG,0,2804842
ompRp1,0.0625,15,15,CATTAATATAGCCGGCACCA,0,2766187
ompRp1,0.0625,15,15,CATCTGTGCCGGACAAAGAC,0,2790146
ompRp1,0.0625,15,15,CATCTACTTAGCGAAACATA,0,2809518
ompRp1,0.0625,15,15,CAGTAATCCTGCACAGGTGA,0,2777261
ompRp1,0.0625,15,15,CAGGGAACCGATGTTTTGCT,0,2775765
ompRp1,0.0625,15,15,CAGACCTCGGGCTAGCAGTG,0,2784988
ompRp1,0.0625,15,15,CACCAGGGTTACTGGTCTAT,0,2803900
ompRp1,0.0625,15,15,CAATCAAGAAAAGACTGTAC,0,2771954
ompRp1,0.0625,15,15,CAAGTCCATCTCTGAATAAA,0,2787693
ompRp1,0.0625,15,15,CAAGGACGATGTGGTGAGAG,0,2767161
ompRp1,0.0625,15,15,CAACATCTGAGAAAAACTGT,0,2818563
ompRp1,0.0625,15,15,ATTGTGGACAGTTAGGGCTT,0,2781682
ompRp1,0.0625,15,15,ATTCTGCCGAACGGCACACT,0,2800581
ompRp1,0.0625,15,15,ATGTTGCTTTCTCTTCCGAA,0,2824361
ompRp1,0.0625,15,15,ATGTTGACCTTTAGCATGAC,0,2786328
ompRp1,0.0625,15,15,ATGGGGTCCCACGGTATCTA,0,2803466
ompRp1,0.0625,15,15,ATGGGGGACGGTTTAGTGGA,0,2811534
ompRp1,0.0625,15,15,ATCTGACCCGGTAACACGGT,0,2803312
ompRp1,0.0625,15,15,ATCTACAGGATTATCAAGAG,0,2774525
ompRp1,0.0625,15,15,ATCCAGCCTTGATAATAAAT,0,2811283
ompRp1,0.0625,15,15,ATAGTAGTGCCTCACCCCAT,0,2797384
ompRp1,0.0625,15,15,ATACTGCGCCAGAAAGGCGG,0,2793197
ompRp1,0.0625,15,15,AGTTTAAATAGGTTTAACTT,0,2778522
ompRp1,0.0625,15,15,AGTTAATGGCAGCTGACTTC,0,2782929
ompRp1,0.0625,15,15,AGTGTCTGGCTAACGGTAGA,0,2818080
ompRp1,0.0625,15,15,AGTGTCCGCGCAACTTTCGG,0,2805035
ompRp1,0.0625,15,15,AGTGCCATGGATCACATCGA,0,2782572
ompRp1,0.0625,15,15,AGTGAGCACAGTGTAAATCG,0,2776059
ompRp1,0.0625,15,15,AGTCTCACCTAACCGTGCAT,0,2812180
ompRp1,0.0625,15,15,AGGTCTGGGGCGGGCAGGTT,0,2774035
ompRp1,0.0625,15,15,AGGCCGAACGTCCTTGAGGG,0,2782248
ompRp1,0.0625,15,15,AGGCCCACCGATATAAATGT,0,2769909
ompRp1,0.0625,15,15,AGCTCACTAGAATTTGGCGC,0,2790364
ompRp1,0.0625,15,15,AGCTAGATCTCCAAAGGGAT,0,2771181
ompRp1,0.0625,15,15,AGCCCTTTGCTACTGCCTTA,0,2813373
ompRp1,0.0625,15,15,AGATTGGTAAACGCGTAACT,0,2787116
ompRp1,0.0625,15,15,AGATTGGATCGGGAGTCATG,0,2773573
ompRp1,0.0625,15,15,AGAACTGGGGTACAGAACAG,0,2788966
ompRp1,0.0625,15,15,ACTTTCTCGCAGGAAATCAA,0,2788047
ompRp1,0.0625,15,15,ACTGGGTCATGATGTGTTGT,0,2807581
ompRp1,0.0625,15,15,ACTCTGGGCTCACCGGAAGG,0,2767278
ompRp1,0.0625,15,15,ACTCCTAGGTTGGTCCTGGC,0,2781214
ompRp1,0.0625,15,15,ACTATATTGATTAGCGCCGT,0,2816122
ompRp1,0.0625,15,15,ACTAGACTCTGAAGCAGAGG,0,2797533
ompRp1,0.0625,15,15,ACGTTCTCGAGTAATTCCAC,0,2783680
ompRp1,0.0625,15,15,ACGTAACCATGCGTGTGCAA,0,2805802
ompRp1,0.0625,15,15,ACGGTATAGCTCAATTATTG,0,2789811
ompRp1,0.0625,15,15,ACGGAGCAGGCACGCAAACT,0,2770299
ompRp1,0.0625,15,15,ACGCTATTTTTGGTACGGCG,0,2776025
ompRp1,0.0625,15,15,ACATGCCATTGCCTCTGTCA,0,2778183
ompRp1,0.0625,15,15,ACACTTGGTCTACGTTATGT,0,2768730
ompRp1,0.0625,15,15,ACAACCTGCGGTGGATGGGA,0,2792190
ompRp1,0.0625,15,15,AATTTGAGTAAACAGGCAAA,0,2797228
ompRp1,0.0625,15,15,AATCGATTTTATGGGTGATC,0,2824676
ompRp1,0.0625,15,15,AATCACCAAGGGGGTGCGAA,0,2814816
ompRp1,0.0625,15,15,AATACAGACCGGACTCGCGA,0,2804053
ompRp1,0.0625,15,15,AAGCAAAGTGCTCGAGCGTA,0,2782303
ompRp1,0.0625,15,15,AAGAGAAGCAGTAAGCCTGA,0,2786620
ompRp1,0.0625,15,15,AACGGCCCATGGATGCTAGT,0,2793433
ompRp1,0.0625,15,15,AAATCTATACGGGCGGGCCA,0,2766184
ompRp1,0.06666666666666667,14,14,TTTTAAGAGATACGAGGTCG,0,2794564
ompRp1,0.06666666666666667,14,14,TTTGATGCGGCACTGGGGTT,0,2813537
ompRp1,0.06666666666666667,14,14,TTTAGTAACGATACCCCGAT,0,2823380
ompRp1,0.06666666666666667,14,14,TTGCAAGAAATACTGCGTCG,0,2805817
ompRp1,0.06666666666666667,14,14,TTCCTGGCACTATGGGCAAA,0,2769901
ompRp1,0.06666666666666667,14,14,TTATAATGATGATCCCTTTC,0,2782877
ompRp1,0.06666666666666667,14,14,TTAGTTTAAAACTGTACCTA,0,2815034
ompRp1,0.06666666666666667,14,14,TTAACATCCGTCCACCGTCA,0,2820571
ompRp1,0.06666666666666667,14,14,TGTGTGAAAAAATGGCTTCA,0,2785279
ompRp1,0.06666666666666667,14,14,TGTGGAGGATTAGGACCACA,0,2824181
ompRp1,0.06666666666666667,14,14,TGTCTAGGATACAAACAAAG,0,2767135
ompRp1,0.06666666666666667,14,14,TGTATAGTTTAATAGCTCTC,0,2778426
ompRp1,0.06666666666666667,14,14,TGTAGTTGGGACTCTATCTT,0,2781467
ompRp1,0.06666666666666667,14,14,TGTAATTTCAGCATTGTCTA,0,2789582
ompRp1,0.06666666666666667,14,14,TGGTTGCGATTAGTAAAGAC,0,2783407
ompRp1,0.06666666666666667,14,14,TGGTAACTATGGTACTGGTT,0,2811399
ompRp1,0.06666666666666667,14,14,TGCTAATAGTCTAGTACGGT,0,2779044
ompRp1,0.06666666666666667,14,14,TGCGGTATCTCCCAGGAAGG,0,2783626
ompRp1,0.06666666666666667,14,14,TGCACTTACACGGTAAAGCA,0,2775834
ompRp1,0.06666666666666667,14,14,TGCAACTGGAGGATACTGAC,0,2786200
ompRp1,0.06666666666666667,14,14,TGAGAAAGACCATAGACACA,0,2824336
ompRp1,0.06666666666666667,14,14,TCTCTCAAGGAAGGCAAGAT,0,2818662
ompRp1,0.06666666666666667,14,14,TCTCCGGGTTTTATAATAAC,0,2777825
ompRp1,0.06666666666666667,14,14,TCTAAGGATTTGCCCCAAAT,0,2766980
ompRp1,0.06666666666666667,14,14,TCGGGGCACATCATACGTCA,0,2817958
ompRp1,0.06666666666666667,14,14,TCGGGAAAAGTGCCTCAAGC,0,2801411
ompRp1,0.06666666666666667,14,14,TCGAGTCGTCTTGGCGTACT,0,2770806
ompRp1,0.06666666666666667,14,14,TCCTCTTGGCGCTCTGTTCG,0,2786652
ompRp1,0.06666666666666667,14,14,TCCGGTTGATCAAAGGCCCC,0,2796010
ompRp1,0.06666666666666667,14,14,TCCGCCGTTGCACGTAATGG,0,2767471
ompRp1,0.06666666666666667,14,14,TCCGAATCCCTATAGCTCTT,0,2783014
ompRp1,0.06666666666666667,14,14,TCCATCACCCGGAACGTTTA,0,2770644
ompRp1,0.06666666666666667,14,14,TCCATACTGCAAAGGCCTAC,0,2804332
ompRp1,0.06666666666666667,14,14,TCCAAGGAGATGCTTAATCA,0,2815615
ompRp1,0.06666666666666667,14,14,TCATATGCCTTATGATGCTT,0,2798504
ompRp1,0.06666666666666667,14,14,TCATACAGGTGCTTGGGTCG,0,2815444
ompRp1,0.06666666666666667,14,14,TCAGTCGTGGGAGTAACCAG,0,2810263
ompRp1,0.06666666666666667,14,14,TCAATCGGATCGCGACGTGC,0,2800203
ompRp1,0.06666666666666667,14,14,TCAAAGTGTGCCTTGAATGA,0,2813935
ompRp1,0.06666666666666667,14,14,TCAAACCGAAAAAGTCCGAT,0,2768648
ompRp1,0.06666666666666667,14,14,TATTGCTGTTGTGCTGCAGA,0,2775519
ompRp1,0.06666666666666667,14,14,TAGAATGGATCTTATCTCTA,0,2807498
ompRp1,0.06666666666666667,14,14,TACGAAAGTGCCGGAGACTG,0,2765640
ompRp1,0.06666666666666667,14,14,TAAGGATTTAGGATTGGACA,0,2787939
ompRp1,0.06666666666666667,14,14,TAAAATCTACTTACAATAGG,0,2808166
ompRp1,0.06666666666666667,14,14,GTTTATCCTATTTTCCCCTA,0,2779605
ompRp1,0.06666666666666667,14,14,GTTACATATGGTGCCTTCAC,0,2766884
ompRp1,0.06666666666666667,14,14,GTGGTTTCCATGTTGACAGT,0,2773171
ompRp1,0.06666666666666667,14,14,GTGGGGGTTCTCTGGACTAT,0,2787702
ompRp1,0.06666666666666667,14,14,GTCTGAACAATGTTCGCGAA,0,2821315
ompRp1,0.06666666666666667,14,14,GTCAGAATACGTTGGGCTGG,0,2780290
ompRp1,0.06666666666666667,14,14,GTATGACACTGCGGTTATTT,0,2785651
ompRp1,0.06666666666666667,14,14,GTAGGCCAAGTGATTAGTCT,0,2813090
ompRp1,0.06666666666666667,14,14,GTAAGTGCCAAGAATCGTAT,0,2766258
ompRp1,0.06666666666666667,14,14,GTAAGCACAAGCAATATACA,0,2793883
ompRp1,0.06666666666666667,14,14,GTAAAACAAACTTTTCTTCT,0,2804737
ompRp1,0.06666666666666667,14,14,GGTTGGAAAGCGAAACAGTA,0,2816499
ompRp1,0.06666666666666667,14,14,GGTGATGTGAAATCCCTGCA,0,2806351
ompRp1,0.06666666666666667,14,14,GGTCCTCGGCCCGGCGACAA,0,2769080
ompRp1,0.06666666666666667,14,14,GGTCAAATCCGAATGGGCAC,0,2788287
ompRp1,0.06666666666666667,14,14,GGGGCGTATCAGGGGTGTTG,0,2772838
ompRp1,0.06666666666666667,14,14,GGGCGGCGTCTGCTCCACTA,0,2799498
ompRp1,0.06666666666666667,14,14,GGGACCGGGGTCTACACCGT,0,2805945
ompRp1,0.06666666666666667,14,14,GGCTATGCTAGTTACGGAGC,0,2823113
ompRp1,0.06666666666666667,14,14,GGCTACATTCGATATAGGAG,0,2765374
ompRp1,0.06666666666666667,14,14,GGACTGGAGCTTTCAAATGG,0,2783992
ompRp1,0.06666666666666667,14,14,GCTTGCACAATCACTTGGGG,0,2774419
ompRp1,0.06666666666666667,14,14,GCTGAATATGTACTTAGCTA,0,2793101
ompRp1,0.06666666666666667,14,14,GCTATAACAGATGCGAGATC,0,2769778
ompRp1,0.06666666666666667,14,14,GCGTGAAAATCAAGTGGAAT,0,2777597
ompRp1,0.06666666666666667,14,14,GCGGTTATGGAGTTTAGTCT,0,2787996
ompRp1,0.06666666666666667,14,14,GCGGGGAATTGCCAGAGCGT,0,2790879
ompRp1,0.06666666666666667,14,14,GCGATAGGACGACGACATGA,0,2771946
ompRp1,0.06666666666666667,14,14,GCCTTACTAAGGCCGTGCTT,0,2814943
ompRp1,0.06666666666666667,14,14,GCCGGAATGTAAATTACCGT,0,2783100
ompRp1,0.06666666666666667,14,14,GCCGAGTATTAGCACAGCCT,0,2786018
ompRp1,0.06666666666666667,14,14,GCCATCCTTCATGTCGGCAG,0,2771058
ompRp1,0.06666666666666667,14,14,GCCACCTGTAGGGTGTTTTG,0,2791478
ompRp1,0.06666666666666667,14,14,GCACAGGTGCACCCCTCAGA,0,2806321
ompRp1,0.06666666666666667,14,14,GAGTTTCATGCGTTGTTATC,0,2769586
ompRp1,0.06666666666666667,14,14,GACGCTGGTGGAGTGGGGTT,0,2813971
ompRp1,0.06666666666666667,14,14,GACCGCTTCCGGCAAGAAGG,0,2779414
ompRp1,0.06666666666666667,14,14,GACCCAGCTATGTACAGACC,0,2800485
ompRp1,0.06666666666666667,14,14,GAAGCGCTTTTAGTTGACCT,0,2798865
ompRp1,0.06666666666666667,14,14,GAACCCGTATACAGGACGAT,0,2799476
ompRp1,0.06666666666666667,14,14,CTTGTACGTGGGCTGCCTCT,0,2769265
ompRp1,0.06666666666666667,14,14,CTTGCAGCGCAGGTGTGTGC,0,2804130
ompRp1,0.06666666666666667,14,14,CTTATCTGCGATCCTGTCTC,0,2784164
ompRp1,0.06666666666666667,14,14,CTTACCGACTAATGCGTGGT,0,2805723
ompRp1,0.06666666666666667,14,14,CTGAAATGAGAGGCAGTCTT,0,2802372
ompRp1,0.06666666666666667,14,14,CTCCATTTCGACGGCTGCGG,0,2767384
ompRp1,0.06666666666666667,14,14,CTCAGATGAGGCGATGGGAT,0,2773083
ompRp1,0.06666666666666667,14,14,CTACTCGTGCTCAGAACTTA,0,2777610
ompRp1,0.06666666666666667,14,14,CTACGCGAAGTCCTCTACTA,0,2769431
ompRp1,0.06666666666666667,14,14,CTAATTCTTGGGTTTGGAAG,0,2801541
ompRp1,0.06666666666666667,14,14,CTAAAGGCAGTTAATGCTCT,0,2805891
ompRp1,0.06666666666666667,14,14,CGTTATTAGGGCATATCTTA,0,2768256
ompRp1,0.06666666666666667,14,14,CGTAACCAGGTCGGTTAGTT,0,2772920
ompRp1,0.06666666666666667,14,14,CGGGGGCCTCTATGATCGGA,0,2782159
ompRp1,0.06666666666666667,14,14,CGGACTAAGGTACCCCCTAG,0,2808335
ompRp1,0.06666666666666667,14,14,CGCTTTGTAGCGTTAATACC,0,2794241
ompRp1,0.06666666666666667,14,14,CGCGTTGAAAGTGGACTTTG,0,2785358
ompRp1,0.06666666666666667,14,14,CGCAGCTTTTGCAACCCATT,0,2773092
ompRp1,0.06666666666666667,14,14,CGATAACGAAGATACCTGAA,0,2818038
ompRp1,0.06666666666666667,14,14,CGAACTCAGAATCCTCACTA,0,2767696
ompRp1,0.06666666666666667,14,14,CGAACCTTCCCCAACTTCGC,0,2769849
ompRp1,0.06666666666666667,14,14,CGAAACGACTTCCACCACTT,0,2779881
ompRp1,0.06666666666666667,14,14,CCTTTCCTTTTAAAGTGTGT,0,2771715
ompRp1,0.06666666666666667,14,14,CCTTCGGGGACGCACTTAAG,0,2775286
ompRp1,0.06666666666666667,14,14,CCTGAGTTAGGCGCATCAGA,0,2824002
ompRp1,0.06666666666666667,14,14,CCTAGGCGAGATAAAATCGT,0,2796360
ompRp1,0.06666666666666667,14,14,CCCTGTCAAACTCGATTGAT,0,2809419
ompRp1,0.06666666666666667,14,14,CCCGTCGCTGGTTAAAGGGT,0,2781333
ompRp1,0.06666666666666667,14,14,CCCGAGGACACTTGCATCTA,0,2796000
ompRp1,0.06666666666666667,14,14,CCCCTCTGAATCCGCGATAG,0,2797617
ompRp1,0.06666666666666667,14,14,CCCCGGCTAGCCTGATGTAC,0,2775599
ompRp1,0.06666666666666667,14,14,CCCCGCGCCACGAATAGGCG,0,2790281
ompRp1,0.06666666666666667,14,14,CCCCCGTCGAGGGTAGGATA,0,2775230
ompRp1,0.06666666666666667,14,14,CCCACCTTCCATCAGTCAGA,0,2809287
ompRp1,0.06666666666666667,14,14,CCCACACATTCTACAGGCGT,0,2795540
ompRp1,0.06666666666666667,14,14,CCAACACTTCCAAAATGTTA,0,2807268
ompRp1,0.06666666666666667,14,14,CATGTTAATGATGTCACTGA,0,2777826
ompRp1,0.06666666666666667,14,14,CATGCATGGAGTAGTCAGAG,0,2787003
ompRp1,0.06666666666666667,14,14,CATAGGGAGTCTGACTCTGC,0,2792479
ompRp1,0.06666666666666667,14,14,CAGTGTTAGGGGTAACCGGT,0,2804974
ompRp1,0.06666666666666667,14,14,CAGGCCGGCGAAACCAGTTC,0,2784886
ompRp1,0.06666666666666667,14,14,CACTGTTACAATTGAACAAT,0,2815454
ompRp1,0.06666666666666667,14,14,CACTCTCTGTCGTAGCGCTA,0,2817629
ompRp1,0.06666666666666667,14,14,CACGTAGGGCTGCTTACCTA,0,2786610
ompRp1,0.06666666666666667,14,14,CACCCTGATATCAATGTTTC,0,2789170
ompRp1,0.06666666666666667,14,14,ATTTGAAACGGCAGTCAGGC,0,2778937
ompRp1,0.06666666666666667,14,14,ATTGTTACACCTAGACGGAC,0,2786866
ompRp1,0.06666666666666667,14,14,ATTATTGACCTGTTTTGTGC,0,2794029
ompRp1,0.06666666666666667,14,14,ATGGCGGGCTAGGGATTCAC,0,2819295
ompRp1,0.06666666666666667,14,14,ATGCCACTTACAGGAATCCG,0,2816013
ompRp1,0.06666666666666667,14,14,ATACTGGCGGGGGGGCCACG,0,2774036
ompRp1,0.06666666666666667,14,14,AGTTGGCACTGAACGGCAAC,0,2797241
ompRp1,0.06666666666666667,14,14,AGTTGACGTAGTTGGGACTA,0,2817459
ompRp1,0.06666666666666667,14,14,AGTCATAGTATGCAGAGAAG,0,2821900
ompRp1,0.06666666666666667,14,14,AGGTGTTCATTGATGTCTTT,0,2786592
ompRp1,0.06666666666666667,14,14,AGGTGAAATGCACGTCTGAA,0,2793796
ompRp1,0.06666666666666667,14,14,AGGGCGCTTCCCGTGGAGTT,0,2773130
ompRp1,0.06666666666666667,14,14,AGGCGGACACCGGTGACGGC,0,2766941
ompRp1,0.06666666666666667,14,14,AGCGGGTAAATGTTCTTGGC,0,2821613
ompRp1,0.06666666666666667,14,14,AGCGGCTCCTTACTGCTAGA,0,2795601
ompRp1,0.06666666666666667,14,14,AGCGCGGGATGGCTATTTCC,0,2770641
ompRp1,0.06666666666666667,14,14,AGCGCCCAAGCTACTGCGAT,0,2809029
ompRp1,0.06666666666666667,14,14,AGCGCCAAGCATGAGTGCTC,0,2795720
ompRp1,0.06666666666666667,14,14,AGCCGCTCGGTACAGTCTCC,0,2808526
ompRp1,0.06666666666666667,14,14,AGATGGAGACGATCGGATTA,0,2790181
ompRp1,0.06666666666666667,14,14,AGAGCCATTAGCCATACATG,0,2767422
ompRp1,0.06666666666666667,14,14,AGACTTGTATGCGGTAGCCC,0,2788901
ompRp1,0.06666666666666667,14,14,AGACTCCCGATCCTTTATTC,0,2813099
ompRp1,0.06666666666666667,14,14,ACTCAAGTTAAAGAATCATG,0,2791737
ompRp1,0.06666666666666667,14,14,ACGGGTGTGCTTCCTATTCC,0,2795000
ompRp1,0.06666666666666667,14,14,ACGCGTACGAAAACTCGAGA,0,2798684
ompRp1,0.06666666666666667,14,14,ACGCCAATCCACTGATCATA,0,2803456
ompRp1,0.06666666666666667,14,14,ACGCCAACTGTGCATATGCG,0,2818443
ompRp1,0.06666666666666667,14,14,ACCGGGACAGAACAGCACAC,0,2791109
ompRp1,0.06666666666666667,14,14,ACCCATCCCTTAATGCTCTT,0,2771157
ompRp1,0.06666666666666667,14,14,ACATAAGTCCGCACTCAGGA,0,2817705
ompRp1,0.06666666666666667,14,14,ACAGCCAGATGCCATGAGGG,0,2767884
ompRp1,0.06666666666666667,14,14,ACAGCAGTTGCAGACTGTAC,0,2783497
ompRp1,0.06666666666666667,14,14,ACAACTGTTCAGTACCTTGA,0,2807519
ompRp1,0.06666666666666667,14,14,AATTGGCTACGGGCGGCTAT,0,2802204
ompRp1,0.06666666666666667,14,14,AATGAGAGTGCATGATATTT,0,2768531
ompRp1,0.06666666666666667,14,14,AATAGGGTGTGTCGAAGTAT,0,2781357
ompRp1,0.06666666666666667,14,14,AAGTATCCTTTTCCGTTCAT,0,2770848
ompRp1,0.06666666666666667,14,14,AAGTAGATGGAGGAGGAGAG,0,2805591
ompRp1,0.06666666666666667,14,14,AAGGCTCAAAACAATTACGT,0,2794599
ompRp1,0.06666666666666667,14,14,AAGCGAAACATGCGCTACAG,0,2789814
ompRp1,0.06666666666666667,14,14,AAGACATCGAAGTGTGCGGT,0,2799674
ompRp1,0.06666666666666667,14,14,AAGAAAACGCCCTACTGATG,0,2813242
ompRp1,0.06666666666666667,14,14,AACGTGCTGACGTTACAATC,0,2766858
ompRp1,0.06666666666666667,14,14,AACGAGGCCGGGAGCAAGAA,0,2790244
ompRp1,0.06666666666666667,14,14,AACCGATAGATCATTCGGCT,0,2798944
ompRp1,0.06666666666666667,14,14,AACCCTGGGCCCGTCCAGGA,0,2795484
ompRp1,0.06666666666666667,14,14,AAATAGCGTTAAGTTCGCCT,0,2815518
ompRp1,0.06666666666666667,14,14,AAATAATACCGATCAGAGGA,0,2810016
ompRp1,0.06666666666666667,14,14,AAAGGGGACCCGCGGAGCGG,0,2812594
ompRp1,0.06666666666666667,14,14,AAACAGAGGGTGAGCGGGGG,0,2797153
ompRp1,0.06666666666666667,14,14,AAACAACCTCGCGCTGGCGC,0,2807270
ompRp1,0.07142857142857142,13,13,TTTTTTCGCGCTCTAAAGGC,0,2768502
ompRp1,0.07142857142857142,13,13,TTTTGGCATACATGTAAACA,0,2785641
ompRp1,0.07142857142857142,13,13,TTTGGTTTTGTTCGTTGTTG,0,2768431
ompRp1,0.07142857142857142,13,13,TTTGGTAGCGTTAAGGAAGG,0,2782283
ompRp1,0.07142857142857142,13,13,TTTCAAGTTCATATGTAGTA,0,2779028
ompRp1,0.07142857142857142,13,13,TTGGTACCCGGGCGCCAGCT,0,2773224
ompRp1,0.07142857142857142,13,13,TTGGGGCCAACTAAGACTGT,0,2807580
ompRp1,0.07142857142857142,13,13,TTGGGCTCAGGCTGGCCGGA,0,2795410
ompRp1,0.07142857142857142,13,13,TTGCTAGAGTATCTCGTTGG,0,2795565
ompRp1,0.07142857142857142,13,13,TTGAAGTGTAGAATTCGAAT,0,2804640
ompRp1,0.07142857142857142,13,13,TTCGGACCGATGAACACCAT,0,2784474
ompRp1,0.07142857142857142,13,13,TTCGCTTGTTATCGCGTACT,0,2798009
ompRp1,0.07142857142857142,13,13,TTATCCAATATTTAAGGCAG,0,2783754
ompRp1,0.07142857142857142,13,13,TTATACTAGGGCAAGACTAG,0,2773872
ompRp1,0.07142857142857142,13,13,TTAGCAACGTGCACTTCCCC,0,2794490
ompRp1,0.07142857142857142,13,13,TGTTGTTTGGTTCAGAAGGA,0,2795750
ompRp1,0.07142857142857142,13,13,TGTTGTTTGACGCTACTTGA,0,2767501
ompRp1,0.07142857142857142,13,13,TGTTGGCAGGTCGTGTAGTC,0,2777007
ompRp1,0.07142857142857142,13,13,TGTGCGGTTATCTGGGCACG,0,2768224
ompRp1,0.07142857142857142,13,13,TGTCGGGTTGGTCGTAAATG,0,2821981
ompRp1,0.07142857142857142,13,13,TGTCCGGGATGGTTTCGGGT,0,2782046
ompRp1,0.07142857142857142,13,13,TGTATAATTTGAGGGGGCTT,0,2770001
ompRp1,0.07142857142857142,13,13,TGTACTTTAATTGTTACTTA,0,2801223
ompRp1,0.07142857142857142,13,13,TGGTCAAGTAAATAGCGATG,0,2779052
ompRp1,0.07142857142857142,13,13,TGCTTATACTTCGGATCTAG,0,2796967
ompRp1,0.07142857142857142,13,13,TGCCAGACTAAGGGTCGAGG,0,2797744
ompRp1,0.07142857142857142,13,13,TGCAGCATGACGGAGAGGGA,0,2803735
ompRp1,0.07142857142857142,13,13,TGAGTGGCTCAATTGGAGGC,0,2824317
ompRp1,0.07142857142857142,13,13,TGACTGGCCGTGGGAGTCCC,0,2770627
ompRp1,0.07142857142857142,13,13,TGACGACCAGACACCCTTGG,0,2796165
ompRp1,0.07142857142857142,13,13,TGACACTAGGATAGGCTGTA,0,2772702
ompRp1,0.07142857142857142,13,13,TCTTAGGCTTAACAGGGTTG,0,2789306
ompRp1,0.07142857142857142,13,13,TCTGTGGGATTCCGATCGGT,0,2774715
ompRp1,0.07142857142857142,13,13,TCTGACAGTAATGCGTCTAT,0,2816413
ompRp1,0.07142857142857142,13,13,TCGCGCTTGTAAAGGAGACT,0,2817800
ompRp1,0.07142857142857142,13,13,TCCTGTAACTTATGAATCGA,0,2767682
ompRp1,0.07142857142857142,13,13,TCCTAAGATTAGGAATGCGT,0,2805680
ompRp1,0.07142857142857142,13,13,TCCGTTGCACGAGAACCCGC,0,2784095
ompRp1,0.07142857142857142,13,13,TCCGTTACGATAGGTCAAAC,0,2813901
ompRp1,0.07142857142857142,13,13,TCAGTGGCGATTGGCCTGTT,0,2777545
ompRp1,0.07142857142857142,13,13,TCACTCGCCGAGCGCGATTC,0,2800790
ompRp1,0.07142857142857142,13,13,TATGGCTCGATTCAAAATCC,0,2776221
ompRp1,0.07142857142857142,13,13,TATGCGCTCGTTCGCCAGTA,0,2814554
ompRp1,0.07142857142857142,13,13,TATCCACTTGTTTACGGGGT,0,2789896
ompRp1,0.07142857142857142,13,13,TAGGGATCAACCTCGTCTAT,0,2765253
ompRp1,0.07142857142857142,13,13,TAGCTTCGACCACCGGACAC,0,2819037
ompRp1,0.07142857142857142,13,13,TAGCGAGCGGATCGCAGCAT,0,2772873
ompRp1,0.07142857142857142,13,13,TAGAACACGGCGAGAGATAT,0,2771820
ompRp1,0.07142857142857142,13,13,TACATCACTGTCAGAGGTCA,0,2786310
ompRp1,0.07142857142857142,13,13,TAATTGATACCGTTTGGGTT,0,2802284
ompRp1,0.07142857142857142,13,13,TAATTAAGTGACTCGCGATA,0,2787645
ompRp1,0.07142857142857142,13,13,TAAGTCCCTCAGGTGATGAA,0,2775423
ompRp1,0.07142857142857142,13,13,TAACGCTCACGCGCCCGGAA,0,2796970
ompRp1,0.07142857142857142,13,13,TAAATCGACCTTCATAGTAG,0,2796254
ompRp1,0.07142857142857142,13,13,TAAAGTGAATGGTCAATCAC,0,2808016
ompRp1,0.07142857142857142,13,13,TAAAAGTTTCAACCCAAAGG,0,2790569
ompRp1,0.07142857142857142,13,13,GTTCCTGCCAGGGCCTTCCT,0,2824027
ompRp1,0.07142857142857142,13,13,GTTACCACGTTGTCTGCGCT,0,2774880
ompRp1,0.07142857142857142,13,13,GTGTCCAATCTTTACCACGG,0,2798863
ompRp1,0.07142857142857142,13,13,GTGGTTACCCCGGAAATGTG,0,2803483
ompRp1,0.07142857142857142,13,13,GTGAACCTCGCAGTGGGCGA,0,2811616
ompRp1,0.07142857142857142,13,13,GTCGTTGAGGGCATGGCAAC,0,2765319
ompRp1,0.07142857142857142,13,13,GTATCTCCGCGCATTCTAAT,0,2823737
ompRp1,0.07142857142857142,13,13,GGTAGCGTTCGCCAACCTCG,0,2818291
ompRp1,0.07142857142857142,13,13,GGGTCATCACCACTTTCAAA,0,2791592
ompRp1,0.07142857142857142,13,13,GGGGCAGTCTGGCTCGGCAT,0,2824111
ompRp1,0.07142857142857142,13,13,GGGCCAAGTTTTCATAGATC,0,2777465
ompRp1,0.07142857142857142,13,13,GGGAATACTCGAACTCAAAG,0,2765808
ompRp1,0.07142857142857142,13,13,GGGAAGTTGTGACGCTCATA,0,2765508
ompRp1,0.07142857142857142,13,13,GGCGCATCTGTGCCCAACAA,0,2777006
ompRp1,0.07142857142857142,13,13,GGCCACCCCGGTTTCGTTAT,0,2807136
ompRp1,0.07142857142857142,13,13,GGCAGCGAACTTTGCGGCCC,0,2768589
ompRp1,0.07142857142857142,13,13,GGCAAGGACTCACCGTTTCA,0,2810361
ompRp1,0.07142857142857142,13,13,GGATTCCTGATTCCTGTATC,0,2795243
ompRp1,0.07142857142857142,13,13,GGAGTGGACTCGAAGTGCCA,0,2802804
ompRp1,0.07142857142857142,13,13,GGACATTTTGTTCAGCTATC,0,2787063
ompRp1,0.07142857142857142,13,13,GGAACCTCTGCGCCGCGCAT,0,2767689
ompRp1,0.07142857142857142,13,13,GCTGGGTATCGTTCGCATTC,0,2787388
ompRp1,0.07142857142857142,13,13,GCTCGAACATCGACCGGGAC,0,2779258
ompRp1,0.07142857142857142,13,13,GCTATCTGAAGACGGTACTG,0,2776386
ompRp1,0.07142857142857142,13,13,GCTACTTGGAATGAAAATTT,0,2807494
ompRp1,0.07142857142857142,13,13,GCGTACACACAGCGTTCCAG,0,2780278
ompRp1,0.07142857142857142,13,13,GCGGCGGACATTAATAAAGG,0,2772872
ompRp1,0.07142857142857142,13,13,GCGACGGTCTATTCAACTAG,0,2800568
ompRp1,0.07142857142857142,13,13,GCCTACGAGCGTAATCACAC,0,2816640
ompRp1,0.07142857142857142,13,13,GCCCGCGGAAGTGGGCAGTG,0,2819017
ompRp1,0.07142857142857142,13,13,GCCCGCGATTACTGAGTTCC,0,2766704
ompRp1,0.07142857142857142,13,13,GCCCCCGGGGATGATATATG,0,2777776
ompRp1,0.07142857142857142,13,13,GCATCTCACAATCTACTTAA,0,2806790
ompRp1,0.07142857142857142,13,13,GCATCCAGCCTGGTGAATCT,0,2801135
ompRp1,0.07142857142857142,13,13,GCACTGTGGACGCAGATACA,0,2788626
ompRp1,0.07142857142857142,13,13,GCACGACTCACGTATAACTC,0,2819486
ompRp1,0.07142857142857142,13,13,GCACCCACCGTCTTTTCGAC,0,2795543
ompRp1,0.07142857142857142,13,13,GCACATCTCAGCGGCCGTGT,0,2815373
ompRp1,0.07142857142857142,13,13,GCACAACTGTTTTTAATGTA,0,2802768
ompRp1,0.07142857142857142,13,13,GATGTAGGCAACCTACCTAG,0,2797342
ompRp1,0.07142857142857142,13,13,GATACAGGCAAGAGTTTTAA,0,2819033
ompRp1,0.07142857142857142,13,13,GAGGGTAATAATCTTGTGTT,0,2791444
ompRp1,0.07142857142857142,13,13,GAGGAATCTTAATCTCATTA,0,2775695
ompRp1,0.07142857142857142,13,13,GAGCGCAGGCGAACGTCCCG,0,2772581
ompRp1,0.07142857142857142,13,13,GAGAAGGTTATGGGCTGTTG,0,2802759
ompRp1,0.07142857142857142,13,13,GACGATGTCCCGACACCAGA,0,2776886
ompRp1,0.07142857142857142,13,13,GACCGGCTCGGCAAGTCCCT,0,2780111
ompRp1,0.07142857142857142,13,13,GACACTGTCAGGAGCGTTAT,0,2811817
ompRp1,0.07142857142857142,13,13,GACACCAATAGCAAGATCAT,0,2779778
ompRp1,0.07142857142857142,13,13,GAATGCGGAATCTGGATATA,0,2801535
ompRp1,0.07142857142857142,13,13,GAAGTTTCGTCTGTATGATA,0,2807841
ompRp1,0.07142857142857142,13,13,GAAGTTCTGACTCTTACCGT,0,2791046
ompRp1,0.07142857142857142,13,13,GAAGGCTTTCATCTTCATGT,0,2796904
ompRp1,0.07142857142857142,13,13,GAACTTTTCGATTGGATTGA,0,2787580
ompRp1,0.07142857142857142,13,13,GAACTTTCCAGAATACGTGG,0,2821979
ompRp1,0.07142857142857142,13,13,GAACACTACATCAATCTTGA,0,2794999
ompRp1,0.07142857142857142,13,13,CTTTGTTGAGATCAACAGAT,0,2774560
ompRp1,0.07142857142857142,13,13,CTTTACCAGTAAGTGTTCGG,0,2793149
ompRp1,0.07142857142857142,13,13,CTTCACGGCGATGGACCAGA,0,2818235
ompRp1,0.07142857142857142,13,13,CTGGTACCGGTGTACCATGC,0,2771412
ompRp1,0.07142857142857142,13,13,CTGCTGAGAGAGGGAGTGCT,0,2781723
ompRp1,0.07142857142857142,13,13,CTGCGTAGATTCGTGTGTCC,0,2784326
ompRp1,0.07142857142857142,13,13,CTGCGGTATATCGTACCCGT,0,2790184
ompRp1,0.07142857142857142,13,13,CTGCCTTAACGGTTCCATTT,0,2795380
ompRp1,0.07142857142857142,13,13,CTGCCCGCATACTGTACACG,0,2822518
ompRp1,0.07142857142857142,13,13,CTGACAAGCTTAAATCGTGA,0,2804318
ompRp1,0.07142857142857142,13,13,CTCTTGCGTTTAAAGAAGCG,0,2803048
ompRp1,0.07142857142857142,13,13,CTCTTACGAATAGCGCACCG,0,2769085
ompRp1,0.07142857142857142,13,13,CTCCATGATTTAGCGTCATG,0,2800213
ompRp1,0.07142857142857142,13,13,CTCATTTCCAGGCGCGGATT,0,2822064
ompRp1,0.07142857142857142,13,13,CTCAGGGCTGATCCCGGGGA,0,2808256
ompRp1,0.07142857142857142,13,13,CTATTTTACGTTGACTCGTA,0,2790521
ompRp1,0.07142857142857142,13,13,CTAGGTGTTGAGCCCAGAAT,0,2768627
ompRp1,0.07142857142857142,13,13,CTAGCTATAAATGCCAACGC,0,2771290
ompRp1,0.07142857142857142,13,13,CTAATAGACAGTGGTATGCG,0,2773622
ompRp1,0.07142857142857142,13,13,CGTGATCAGATAATATGGAG,0,2797142
ompRp1,0.07142857142857142,13,13,CGTCGTTCGTAAAATTCGTG,0,2816586
ompRp1,0.07142857142857142,13,13,CGTCAATCTTGTTAATGCTG,0,2785459
ompRp1,0.07142857142857142,13,13,CGGTTCGCTATTCAGGCACT,0,2800391
ompRp1,0.07142857142857142,13,13,CGGTTCAGTGGTTTCTCATA,0,2799891
ompRp1,0.07142857142857142,13,13,CGGTCATAATGGTCTATGCG,0,2791110
ompRp1,0.07142857142857142,13,13,CGGTAAGGGGGACTCCCTCT,0,2765983
ompRp1,0.07142857142857142,13,13,CGGGGTACTTGGCCGGAGCG,0,2776107
ompRp1,0.07142857142857142,13,13,CGGGGATCATTCAAAATCCT,0,2799955
ompRp1,0.07142857142857142,13,13,CGGGCGAGAGCCCTATGATT,0,2808379
ompRp1,0.07142857142857142,13,13,CGGGATATCCAAACGATATA,0,2798823
ompRp1,0.07142857142857142,13,13,CGGGAGAGCGCCGACGGCAT,0,2824583
ompRp1,0.07142857142857142,13,13,CGGAGTGGTAGTGCCGAATG,0,2803812
ompRp1,0.07142857142857142,13,13,CGCTGCAGTCCGTTTAGCCG,0,2777488
ompRp1,0.07142857142857142,13,13,CGCCTCAAGGGGTCATGGTG,0,2807541
ompRp1,0.07142857142857142,13,13,CGCCGGAGGGGGTCCAAGTA,0,2797797
ompRp1,0.07142857142857142,13,13,CGCAGTTCGGCTTACGTCGT,0,2790489
ompRp1,0.07142857142857142,13,13,CGATGGTCTGTCATCATCCC,0,2772995
ompRp1,0.07142857142857142,13,13,CGATAATAGATCTCTCGCTC,0,2818464
ompRp1,0.07142857142857142,13,13,CGATAAAGGGCGAAGGCCTG,0,2822192
ompRp1,0.07142857142857142,13,13,CGAGTGGATACGGTGCTAAT,0,2808751
ompRp1,0.07142857142857142,13,13,CGAGTAATAGCATGTTCCAG,0,2784505
ompRp1,0.07142857142857142,13,13,CGAGAGGTTATTGGTCTTTG,0,2770037
ompRp1,0.07142857142857142,13,13,CGACCACGTTAAATCCTCTC,0,2809430
ompRp1,0.07142857142857142,13,13,CCTTAAATTGACGTGCCGGA,0,2807353
ompRp1,0.07142857142857142,13,13,CCTGGTTACCCCTGTATCAT,0,2783160
ompRp1,0.07142857142857142,13,13,CCTCTGGTCCGGGATGACTT,0,2772463
ompRp1,0.07142857142857142,13,13,CCTCATTCCTGCATATCCGA,0,2784514
ompRp1,0.07142857142857142,13,13,CCGCGAACCTTGCGGTAGGG,0,2821702
ompRp1,0.07142857142857142,13,13,CCGATTACTAGGATTCCTTT,0,2778487
ompRp1,0.07142857142857142,13,13,CCGAAAGGTGACAGACATAA,0,2777420
ompRp1,0.07142857142857142,13,13,CCCGTTTACCGGTACAAGCG,0,2819082
ompRp1,0.07142857142857142,13,13,CCCGGGTCCGGTAACGCTTT,0,2784374
ompRp1,0.07142857142857142,13,13,CCCCTGGGTTCGTAGTGTAC,0,2803450
ompRp1,0.07142857142857142,13,13,CCCAGCGGTATAGTGTGCGC,0,2791394
ompRp1,0.07142857142857142,13,13,CCCAACTAATGTAGGAGAAA,0,2784767
ompRp1,0.07142857142857142,13,13,CCAGCACTTCTCCGGAGTGC,0,2822486
ompRp1,0.07142857142857142,13,13,CCACGTAAGTGTGGTGGGCA,0,2788063
ompRp1,0.07142857142857142,13,13,CCAATATCTACAGACGAAAA,0,2805949
ompRp1,0.07142857142857142,13,13,CCAAATTGAAGCTACGTGAA,0,2786764
ompRp1,0.07142857142857142,13,13,CCAAAGTTTCTCGGGGCGCA,0,2769398
ompRp1,0.07142857142857142,13,13,CATTCTGTTCCGGCTTTAGT,0,2794279
ompRp1,0.07142857142857142,13,13,CATTAACAACGGGAAAAGCA,0,2802941
ompRp1,0.07142857142857142,13,13,CATAATCGTGACCTATGTGC,0,2775888
ompRp1,0.07142857142857142,13,13,CAGTTTCGTGTCTTATTTTA,0,2783524
ompRp1,0.07142857142857142,13,13,CAGATTCTATGGTTATCCTA,0,2793792
ompRp1,0.07142857142857142,13,13,CAGATGGCTCCACCTTAGTC,0,2819253
ompRp1,0.07142857142857142,13,13,CAGAGAGTCTCTTGCGCCGT,0,2814518
ompRp1,0.07142857142857142,13,13,CACTGACCTGATTAGGGATA,0,2771546
ompRp1,0.07142857142857142,13,13,CACCTATACCAATGAATGTG,0,2787608
ompRp1,0.07142857142857142,13,13,CACATGCTTTCGTCCGATTG,0,2770199
ompRp1,0.07142857142857142,13,13,CAATGGCTTTCTATGGAATC,0,2766438
ompRp1,0.07142857142857142,13,13,CAATCAACAGTTCTTAGAGA,0,2766166
ompRp1,0.07142857142857142,13,13,CAATAAGCATCAGATGAGTT,0,2787066
ompRp1,0.07142857142857142,13,13,CAAGCCTTTTGAACCGCAAC,0,2780702
ompRp1,0.07142857142857142,13,13,CAACTAGCGGAGCCAAGAAG,0,2786329
ompRp1,0.07142857142857142,13,13,ATGGATTCTTCTGTAGAAGA,0,2786354
ompRp1,0.07142857142857142,13,13,ATGCAGCCTCGAAATAATAA,0,2800356
ompRp1,0.07142857142857142,13,13,ATCCTCGGGTGAACTGGCCG,0,2782969
ompRp1,0.07142857142857142,13,13,ATCCGCCACATACCGACCAT,0,2798526
ompRp1,0.07142857142857142,13,13,ATCCACTACTGAACCCCTCC,0,2805449
ompRp1,0.07142857142857142,13,13,ATCATAGGAGGCGCCCACAC,0,2809214
ompRp1,0.07142857142857142,13,13,ATCAATCCGAGGTCGTGCCC,0,2810764
ompRp1,0.07142857142857142,13,13,ATATGAGTGAGGCGTAGTAA,0,2787569
ompRp1,0.07142857142857142,13,13,ATAGGCTAGGACAGACATTT,0,2768365
ompRp1,0.07142857142857142,13,13,ATAGCGTGCGAATGCAACGT,0,2814206
ompRp1,0.07142857142857142,13,13,ATAAGCCGGCACGCATTGTA,0,2774391
ompRp1,0.07142857142857142,13,13,AGTTCAATGTATGTTGTATG,0,2780984
ompRp1,0.07142857142857142,13,13,AGTTACAGTTTGCGTACAAG,0,2817333
ompRp1,0.07142857142857142,13,13,AGTACAAGGGTTTCCACACA,0,2797415
ompRp1,0.07142857142857142,13,13,AGGTCTGTATGGCCGAGCTA,0,2787162
ompRp1,0.07142857142857142,13,13,AGGCGACGAAGACTATAGAT,0,2765644
ompRp1,0.07142857142857142,13,13,AGGCCTCAGTAACGGAAGGA,0,2802493
ompRp1,0.07142857142857142,13,13,AGGACAACCCGGTTTAACGA,0,2822165
ompRp1,0.07142857142857142,13,13,AGACTGATAAGGAAGGGAAA,0,2772865
ompRp1,0.07142857142857142,13,13,AGACCCTTAACTCAGAATAA,0,2809226
ompRp1,0.07142857142857142,13,13,AGAATTACGCAAAGACCGTG,0,2779953
ompRp1,0.07142857142857142,13,13,AGAAGTCTCGCCACGCCCAA,0,2818617
ompRp1,0.07142857142857142,13,13,ACTTAGTAAGCTCTACATTT,0,2821859
ompRp1,0.07142857142857142,13,13,ACTCTGTGGTATCCTCACAA,0,2814120
ompRp1,0.07142857142857142,13,13,ACTAGCGGCAAGGTGGAACA,0,2779152
ompRp1,0.07142857142857142,13,13,ACTAAAGCCGCCAGTTCTGT,0,2818820
ompRp1,0.07142857142857142,13,13,ACGTTTCCACCTTGGCCGCT,0,2770667
ompRp1,0.07142857142857142,13,13,ACGGTCGGCCTATGCGCCCC,0,2781704
ompRp1,0.07142857142857142,13,13,ACGCGTTTCAGCATAATTAG,0,2769498
ompRp1,0.07142857142857142,13,13,ACGCGACCTCGTCGGTTGTA,0,2805523
ompRp1,0.07142857142857142,13,13,ACCTGGGTGGCTTAGGTTTA,0,2776521
ompRp1,0.07142857142857142,13,13,ACCTCGTTAGCTCTACATAA,0,2813029
ompRp1,0.07142857142857142,13,13,ACCGTGGTGCAGCGAAAGAA,0,2776958
ompRp1,0.07142857142857142,13,13,ACCATTAGCCTACCGCCAGG,0,2800074
ompRp1,0.07142857142857142,13,13,ACCAGAACGCGTGGAGTATT,0,2771204
ompRp1,0.07142857142857142,13,13,ACAGTGAAGACCCAGCGTCC,0,2788160
ompRp1,0.07142857142857142,13,13,ACAGGAAGTCAAGATCAAGA,0,2815634
ompRp1,0.07142857142857142,13,13,ACAGATCACCATTGGTAGCT,0,2805960
ompRp1,0.07142857142857142,13,13,ACAAACTTCGGGCAACTTTG,0,2791353
ompRp1,0.07142857142857142,13,13,AATTGCAAATACGGTCTCAT,0,2785841
ompRp1,0.07142857142857142,13,13,AATGGGAATGGTCCTCGCGT,0,2816145
ompRp1,0.07142857142857142,13,13,AATGCTAAGAAATGCAATTA,0,2812217
ompRp1,0.07142857142857142,13,13,AAGTAGTGTGATCGAGCCAC,0,2775524
ompRp1,0.07142857142857142,13,13,AAGGCTATTCCGAATAGGTA,0,2805262
ompRp1,0.07142857142857142,13,13,AAGCTGACGTTGAATTCGGA,0,2817517
ompRp1,0.07142857142857142,13,13,AAGAGTTCCGTCCAATCACT,0,2823284
ompRp1,0.07142857142857142,13,13,AAGACCCTAGCCTTTGTGAC,0,2789393
ompRp1,0.07142857142857142,13,13,AACGGGCTACCATGAGAGAC,0,2806270
ompRp1,0.07142857142857142,13,13,AACGCTTTAAACACACTTAG,0,2798783
ompRp1,0.07142857142857142,13,13,AACGATTAAAAGCACCGTGA,0,2770986
ompRp1,0.07142857142857142,13,13,AACCAGGACGTTGTCGTTTT,0,2797201
ompRp1,0.07142857142857142,13,13,AACAATTGGGCGTTGTTAAG,0,2796038
ompRp1,0.07142857142857142,13,13,AAATCAGGATCAAGTACGCT,0,2767581
ompRp1,0.07692307692307693,12,12,TTTGTTTAGAAAAGCAACAT,0,2789307
ompRp1,0.07692307692307693,12,12,TTTGGGACCATCCGACGAGA,0,2783313
ompRp1,0.07692307692307693,12,12,TTTGGCCGACAGTGCTACGT,0,2796630
ompRp1,0.07692307692307693,12,12,TTTGCCTGGACATGTTAGTA,0,2779727
ompRp1,0.07692307692307693,12,12,TTTGCAGGGGGAATAATTGT,0,2808564
ompRp1,0.07692307692307693,12,12,TTTCTGCGGTGCCACGTGGC,0,2785744
ompRp1,0.07692307692307693,12,12,TTTCGTACGCGGATACCCGT,0,2823639
ompRp1,0.07692307692307693,12,12,TTTCCACCGGTGGGATAGTT,0,2816052
ompRp1,0.07692307692307693,12,12,TTTAGGCTTTGGCCGCGGAC,0,2794728
ompRp1,0.07692307692307693,12,12,TTGTTGTCCATACTTACCGC,0,2785888
ompRp1,0.07692307692307693,12,12,TTGTACGTGTTTGTTACCCA,0,2802293
ompRp1,0.07692307692307693,12,12,TTGGGCTAGGTCACACGGTA,0,2783682
ompRp1,0.07692307692307693,12,12,TTGGAACAGGTTAGGTGGGG,0,2812820
ompRp1,0.07692307692307693,12,12,TTGCTGTGGAGGGTAACTTC,0,2785934
ompRp1,0.07692307692307693,12,12,TTGCTGCCATGTCGGGACGT,0,2790233
ompRp1,0.07692307692307693,12,12,TTGATCTCGGCCATACATCC,0,2822722
ompRp1,0.07692307692307693,12,12,TTCTCCATGTAGTAGCTTCG,0,2798258
ompRp1,0.07692307692307693,12,12,TTCGGACTCAAAAGCATTTC,0,2815324
ompRp1,0.07692307692307693,12,12,TTCGCGTCCTGGGAGCGGCG,0,2782311
ompRp1,0.07692307692307693,12,12,TTATGTCACGTTTTCGGTCT,0,2766974
ompRp1,0.07692307692307693,12,12,TTAGCTTGCTTGAAGAGTGC,0,2789062
ompRp1,0.07692307692307693,12,12,TTACTCATTTAAACTCCGCT,0,2788863
ompRp1,0.07692307692307693,12,12,TTACATATGTCTCAGGTGTT,0,2798125
ompRp1,0.07692307692307693,12,12,TGTTCAGGTCTCTCAGCTTT,0,2801687
ompRp1,0.07692307692307693,12,12,TGTGTGTGATTGGCGTGTTA,0,2808286
ompRp1,0.07692307692307693,12,12,TGTGCCCTCGTACGAGATCG,0,2820399
ompRp1,0.07692307692307693,12,12,TGTGATCGTAACCCCCGCCT,0,2798390
ompRp1,0.07692307692307693,12,12,TGGGTCTTATATGTCAGGTT,0,2817142
ompRp1,0.07692307692307693,12,12,TGGGACTGAGCTTTGCCATA,0,2787058
ompRp1,0.07692307692307693,12,12,TGGCTACGCAGTTGGCTGAC,0,2785214
ompRp1,0.07692307692307693,12,12,TGGCAAAAGCCACATGGCCA,0,2793499
ompRp1,0.07692307692307693,12,12,TGCCTAAGGGAGTGCGGCTC,0,2799274
ompRp1,0.07692307692307693,12,12,TGCAGATTTGTGAAGCAGCC,0,2813385
ompRp1,0.07692307692307693,12,12,TGCAAAACAAAAGGATTAAT,0,2769585
ompRp1,0.07692307692307693,12,12,TGATGGAAGACCGGACACGT,0,2778858
ompRp1,0.07692307692307693,12,12,TGACGAGGGACCCCAGCTTT,0,2802615
ompRp1,0.07692307692307693,12,12,TGAATATTTTAGTATTTGCT,0,2807349
ompRp1,0.07692307692307693,12,12,TCTTGAGGCTGCTATTGAAT,0,2794727
ompRp1,0.07692307692307693,12,12,TCTTGACCACGAGAAGTTCA,0,2792954
ompRp1,0.07692307692307693,12,12,TCTAGATCGTCTTGGTAAAC,0,2799592
ompRp1,0.07692307692307693,12,12,TCTAAGTTACCCTTGCGTTT,0,2781359
ompRp1,0.07692307692307693,12,12,TCGTTGTTAATTTACGGTGC,0,2773001
ompRp1,0.07692307692307693,12,12,TCGTTCCAATCAATGCGTGT,0,2807229
ompRp1,0.07692307692307693,12,12,TCGGTGCCGTCATATTGTTC,0,2777139
ompRp1,0.07692307692307693,12,12,TCCTCGGGGCAGGCAGTCTT,0,2787884
ompRp1,0.07692307692307693,12,12,TCCGACGAATATGCTGCTGG,0,2799433
ompRp1,0.07692307692307693,12,12,TCCCGGGTACGGAGATTTGT,0,2791408
ompRp1,0.07692307692307693,12,12,TCCATAGTAGTCTTCGATTA,0,2787597
ompRp1,0.07692307692307693,12,12,TCAGGAGTTCACGTTCGGAG,0,2814625
ompRp1,0.07692307692307693,12,12,TCAGCCATTACGCCTAAAAG,0,2791113
ompRp1,0.07692307692307693,12,12,TATATGGTTGAAGCAACTGT,0,2795617
ompRp1,0.07692307692307693,12,12,TAGGGCTGACTCTCGTGAAC,0,2795384
ompRp1,0.07692307692307693,12,12,TAGAACAATTGGATTGCAGA,0,2790728
ompRp1,0.07692307692307693,12,12,TACTATGCGCGCCCTGTAAT,0,2779440
ompRp1,0.07692307692307693,12,12,TACCCCGACATCGTAATTAT,0,2805163
ompRp1,0.07692307692307693,12,12,TAATGGTGGCAAGACTGGTC,0,2814979
ompRp1,0.07692307692307693,12,12,TAATGCTCGGGAGCCGGCTA,0,2777701
ompRp1,0.07692307692307693,12,12,TAAGTGCGGGCCTTTATCCA,0,2789384
ompRp1,0.07692307692307693,12,12,TAAGGGTCATAAAAGAGAAG,0,2772812
ompRp1,0.07692307692307693,12,12,TAAGCGGGGTTCTCAGGTGT,0,2807702
ompRp1,0.07692307692307693,12,12,GTTTCGGCGTGTACGTGACG,0,2786542
ompRp1,0.07692307692307693,12,12,GTTGTCGCTTATTTCCGATT,0,2775203
ompRp1,0.07692307692307693,12,12,GTTGTATCCAATGGCCCCGA,0,2799264
ompRp1,0.07692307692307693,12,12,GTTGGTGCGTATCCTGTCGC,0,2791536
ompRp1,0.07692307692307693,12,12,GTTCTCAAGGTACAGCTTGC,0,2772008
ompRp1,0.07692307692307693,12,12,GTTCGTTTTTGGTGGAGGTT,0,2792155
ompRp1,0.07692307692307693,12,12,GTTCGCGTCTTTAAGGGACT,0,2787335
ompRp1,0.07692307692307693,12,12,GTGTCGTGAGGTCGTCTCGA,0,2779901
ompRp1,0.07692307692307693,12,12,GTGTATAGCTTGCCGCCAAT,0,2774028
ompRp1,0.07692307692307693,12,12,GTGGTTCTTAATAACAGTAC,0,2773764
ompRp1,0.07692307692307693,12,12,GTGGATACGTCCAAATTGTC,0,2790872
ompRp1,0.07692307692307693,12,12,GTGGAAACAGAGGGCACGTT,0,2812687
ompRp1,0.07692307692307693,12,12,GTGAGAGTCAGTCAAAAAGG,0,2804154
ompRp1,0.07692307692307693,12,12,GTCTGCAACAAGATCTAGAA,0,2812801
ompRp1,0.07692307692307693,12,12,GTCGTGGACTTTGTGAGACT,0,2767814
ompRp1,0.07692307692307693,12,12,GTCCAGGACACGGCGGCGAG,0,2770181
ompRp1,0.07692307692307693,12,12,GTCATTTACGGGAGGTAGCA,0,2765454
ompRp1,0.07692307692307693,12,12,GTCACTGAAAAATATGACTG,0,2803242
ompRp1,0.07692307692307693,12,12,GTATTGTGGGTTTTAGGGAC,0,2791603
ompRp1,0.07692307692307693,12,12,GTATGCCTTAGCAGACGTAA,0,2777020
ompRp1,0.07692307692307693,12,12,GTAAGCGGACATCCTAGTCC,0,2800085
ompRp1,0.07692307692307693,12,12,GTAAGAGTTGGATATTCCCA,0,2820313
ompRp1,0.07692307692307693,12,12,GGTCGCTCGGGGTAAATCGG,0,2808504
ompRp1,0.07692307692307693,12,12,GGTCCCAAGGGAGTGAGTGG,0,2787772
ompRp1,0.07692307692307693,12,12,GGTCAATGGTAGTTCACCAA,0,2771958
ompRp1,0.07692307692307693,12,12,GGGTCTAGAGTGTTGGGTTC,0,2818470
ompRp1,0.07692307692307693,12,12,GGGGCAGGTCCGCCTTGACT,0,2788965
ompRp1,0.07692307692307693,12,12,GGGCGCAAATTAAGGCGCAA,0,2811246
ompRp1,0.07692307692307693,12,12,GGGCGATAGCGCGACCCCTA,0,2802939
ompRp1,0.07692307692307693,12,12,GGGCCATCCCGGTTTACTTG,0,2787085
ompRp1,0.07692307692307693,12,12,GGGACCCCAGGTTCATAGTG,0,2794468
ompRp1,0.07692307692307693,12,12,GGCTCGCGTGTATCTAAATA,0,2794025
ompRp1,0.07692307692307693,12,12,GGCTCCGATCTGGAACAGTG,0,2775375
ompRp1,0.07692307692307693,12,12,GGCTAGCGGCAAAGTTAAGC,0,2809577
ompRp1,0.07692307692307693,12,12,GGCCAGGGTGTGTGCTTTCC,0,2804027
ompRp1,0.07692307692307693,12,12,GGATGAAGTCATGTAGAACT,0,2820913
ompRp1,0.07692307692307693,12,12,GGAGTGCCATCTTACAACGA,0,2804784
ompRp1,0.07692307692307693,12,12,GGAGTCCCAAGTGTATGGGT,0,2774517
ompRp1,0.07692307692307693,12,12,GGAGGGTCATTTCAAACTAC,0,2808151
ompRp1,0.07692307692307693,12,12,GGACAAATGTCGGATTTCGC,0,2779679
ompRp1,0.07692307692307693,12,12,GGAATCAAGCCGAGGCGAAG,0,2779710
ompRp1,0.07692307692307693,12,12,GGAAATGCACCACCACGGCA,0,2817585
ompRp1,0.07692307692307693,12,12,GCTTGGTGGTACATGTCTGG,0,2789557
ompRp1,0.07692307692307693,12,12,GCTTCTACCGTCGGGTCAGG,0,2794406
ompRp1,0.07692307692307693,12,12,GCTTACCTGGTCGGAACGCA,0,2799531
ompRp1,0.07692307692307693,12,12,GCTGACGATTGCTGTTCTGA,0,2823111
ompRp1,0.07692307692307693,12,12,GCTAGCCTAGATGCAGCAGT,0,2814405
ompRp1,0.07692307692307693,12,12,GCTAAGAACCTGGGGAATAG,0,2804234
ompRp1,0.07692307692307693,12,12,GCGGGTATATGTGGACTATA,0,2820693
ompRp1,0.07692307692307693,12,12,GCGATAGTGGAGCCCAACAT,0,2771585
ompRp1,0.07692307692307693,12,12,GCCTGCGGAAGGGGACTCTT,0,2798007
ompRp1,0.07692307692307693,12,12,GCCTACTGCCTCTGGGGTAA,0,2803357
ompRp1,0.07692307692307693,12,12,GCCGTAGGTTAGCACACCTG,0,2822717
ompRp1,0.07692307692307693,12,12,GCCCGCTAAGTCTGAGCGAT,0,2766533
ompRp1,0.07692307692307693,12,12,GCCCGAGCTCCGTAATGTGT,0,2769847
ompRp1,0.07692307692307693,12,12,GCCCCTAGCGCGCACGTTGG,0,2778326
ompRp1,0.07692307692307693,12,12,GCATCCGGTTGCCTTCAACA,0,2775335
ompRp1,0.07692307692307693,12,12,GCACCCCGGCATAGCTAATT,0,2790094
ompRp1,0.07692307692307693,12,12,GCAAAAGTATTCCTCTCTTG,0,2789311
ompRp1,0.07692307692307693,12,12,GCAAAAATGCGGTAGTCAGA,0,2768630
ompRp1,0.07692307692307693,12,12,GATTCCATGGACGAAGCAAT,0,2778028
ompRp1,0.07692307692307693,12,12,GATCAGCTTCCCGAGGGACG,0,2801765
ompRp1,0.07692307692307693,12,12,GATAAAGAAAAGTGGCTCTA,0,2790909
ompRp1,0.07692307692307693,12,12,GAGTTACTCAAGAAATCTGC,0,2798750
ompRp1,0.07692307692307693,12,12,GAGGATTTCGGCTTACGCCG,0,2811048
ompRp1,0.07692307692307693,12,12,GAGCCGGGCCGTAACGATAA,0,2778366
ompRp1,0.07692307692307693,12,12,GACTGTGTATCGAAAGCCCA,0,2782455
ompRp1,0.07692307692307693,12,12,GACGGCACTAGAGCAAGCCA,0,2778249
ompRp1,0.07692307692307693,12,12,GACATTGTGCGTGGCGCGGT,0,2779935
ompRp1,0.07692307692307693,12,12,GACAGCAAGGCAACTTCAGT,0,2785299
ompRp1,0.07692307692307693,12,12,GAATTGCTTATAGGCTGGCA,0,2789739
ompRp1,0.07692307692307693,12,12,GAATCGGGTAATGGGTACAA,0,2803072
ompRp1,0.07692307692307693,12,12,GAATCCCCATTCCTGTAAGG,0,2771292
ompRp1,0.07692307692307693,12,12,GAAGCGGACAGCCCATACTA,0,2772886
ompRp1,0.07692307692307693,12,12,GAACTTGTCAGACGAACGTC,0,2796589
ompRp1,0.07692307692307693,12,12,GAACTAACACGGGGACGCCC,0,2766671
ompRp1,0.07692307692307693,12,12,GAACGCAAAGGGCTGGGTAA,0,2799524
ompRp1,0.07692307692307693,12,12,GAAACTGTAGGTTCAACCTA,0,2776019
ompRp1,0.07692307692307693,12,12,CTTCTAACTCAAGAGGCATT,0,2772663
ompRp1,0.07692307692307693,12,12,CTGTGTACGTGAAAGCTCTA,0,2801540
ompRp1,0.07692307692307693,12,12,CTGTCGGTGTTCAGAGACGG,0,2808830
ompRp1,0.07692307692307693,12,12,CTGGGTGAGTAGCTCGATGG,0,2822914
ompRp1,0.07692307692307693,12,12,CTGGGAGTAAGTGCCTCGAC,0,2765509
ompRp1,0.07692307692307693,12,12,CTGCGTGATATAATTCTATG,0,2809851
ompRp1,0.07692307692307693,12,12,CTGCCCGCAAAAATGCCACT,0,2821499
ompRp1,0.07692307692307693,12,12,CTGCATAGATAGCTCCACGG,0,2783340
ompRp1,0.07692307692307693,12,12,CTCTTAAGCGTTGACTGTAA,0,2781404
ompRp1,0.07692307692307693,12,12,CTCGGTGTCTACCGATCGCA,0,2809306
ompRp1,0.07692307692307693,12,12,CTCACTGAGCAATAAGCAAC,0,2817162
ompRp1,0.07692307692307693,12,12,CTATCCCAAGAGGGGCAAGT,0,2765275
ompRp1,0.07692307692307693,12,12,CTATCAGAAGAGGTGCTATA,0,2809571
ompRp1,0.07692307692307693,12,12,CTATCACAAACAAGCCAATC,0,2784167
ompRp1,0.07692307692307693,12,12,CTAGTGCTCCTATTTCGGCA,0,2816902
ompRp1,0.07692307692307693,12,12,CTAGTAGCCACGAATCAACG,0,2822360
ompRp1,0.07692307692307693,12,12,CTAGCGCCGAACGCCTGCCT,0,2822375
ompRp1,0.07692307692307693,12,12,CTAGATTCCCACCACAACTC,0,2806976
ompRp1,0.07692307692307693,12,12,CTAGAAAATTCGAGGTGACA,0,2784157
ompRp1,0.07692307692307693,12,12,CTACGACATTCGCCACAGAT,0,2786355
ompRp1,0.07692307692307693,12,12,CTAACTGGGCCACTAGAGGA,0,2812877
ompRp1,0.07692307692307693,12,12,CGTTGTGGAAACCATGATTG,0,2812824
ompRp1,0.07692307692307693,12,12,CGTCCCAGTGACGATCTGGG,0,2823540
ompRp1,0.07692307692307693,12,12,CGTAATCGGCACGAATAGCC,0,2787557
ompRp1,0.07692307692307693,12,12,CGGTGAGTCCCGACCTGATC,0,2782596
ompRp1,0.07692307692307693,12,12,CGGGGGAACGCAGCCACCAT,0,2770997
ompRp1,0.07692307692307693,12,12,CGGAGGCCTCTTGACCCCGG,0,2773086
ompRp1,0.07692307692307693,12,12,CGCTGATTCAAGATCAGTCC,0,2774462
ompRp1,0.07692307692307693,12,12,CGCGTCCCTTTGAGTTACAT,0,2785567
ompRp1,0.07692307692307693,12,12,CGCGGACATTTTGGGTATCA,0,2768305
ompRp1,0.07692307692307693,12,12,CGCCGGAATCAATGAAGGCT,0,2775200
ompRp1,0.07692307692307693,12,12,CGCCAGGAGCATGTCTTGTC,0,2803435
ompRp1,0.07692307692307693,12,12,CGCATTGTCGATATATAGAT,0,2786942
ompRp1,0.07692307692307693,12,12,CGAACGGGTCTTGGAATCCC,0,2801922
ompRp1,0.07692307692307693,12,12,CCTGTTGGTGCTGCATCATC,0,2805462
ompRp1,0.07692307692307693,12,12,CCTGGCGCCCTTTGGGACTC,0,2772821
ompRp1,0.07692307692307693,12,12,CCTCTAAGACAAAGCCATGA,0,2788525
ompRp1,0.07692307692307693,12,12,CCTCATACCGACCGTACGTC,0,2812603
ompRp1,0.07692307692307693,12,12,CCGGTTTTGCCACGTTAGGG,0,2766918
ompRp1,0.07692307692307693,12,12,CCGGACAGCTCAATGGATAT,0,2796027
ompRp1,0.07692307692307693,12,12,CCGCCAGGGGTATATTCTTG,0,2794526
ompRp1,0.07692307692307693,12,12,CCGAAGACATACGCGTTGTT,0,2766439
ompRp1,0.07692307692307693,12,12,CCCTGGTTACAACTGTTCGT,0,2815375
ompRp1,0.07692307692307693,12,12,CCCCTCCACTTGAGTTAATG,0,2789304
ompRp1,0.07692307692307693,12,12,CCCCGAAACATACTTCGAAG,0,2772151
ompRp1,0.07692307692307693,12,12,CCCACTCTAATCGATTCAAC,0,2792108
ompRp1,0.07692307692307693,12,12,CCCACGGGGACCCCAGTGCT,0,2818237
ompRp1,0.07692307692307693,12,12,CCATTAGTCACGAGTGCGAC,0,2814279
ompRp1,0.07692307692307693,12,12,CCACTCTGAGGCGCTACTTA,0,2819011
ompRp1,0.07692307692307693,12,12,CCACAAGTAGCATCGATTGG,0,2789260
ompRp1,0.07692307692307693,12,12,CATTCTAACATCGGCTTGAT,0,2781443
ompRp1,0.07692307692307693,12,12,CATTCGGATGTACCCAAGCA,0,2801536
ompRp1,0.07692307692307693,12,12,CATGCTACCACAGATGTCAT,0,2797207
ompRp1,0.07692307692307693,12,12,CATCGCACTGGTGCAACTGT,0,2816547
ompRp1,0.07692307692307693,12,12,CATCAACAGACACCCTTTTC,0,2765955
ompRp1,0.07692307692307693,12,12,CAGTTCTTGGGATTCTCGCA,0,2809835
ompRp1,0.07692307692307693,12,12,CAGGCTAGCTATGCGAAAGA,0,2793204
ompRp1,0.07692307692307693,12,12,CAGCACCCCGTCAGATGTTC,0,2821618
ompRp1,0.07692307692307693,12,12,CAGACTTTGGTGGAATGGGA,0,2787479
ompRp1,0.07692307692307693,12,12,CACCGGCGGCCTTCGCTGCC,0,2777275
ompRp1,0.07692307692307693,12,12,CACCGATGGGACACCGACAT,0,2807234
ompRp1,0.07692307692307693,12,12,CACAGCTGTACTCTCGGGCT,0,2792182
ompRp1,0.07692307692307693,12,12,CAATGTAACGTGTCGCCAGT,0,2806862
ompRp1,0.07692307692307693,12,12,CAACTAGAGTGCGTCGTTAC,0,2809274
ompRp1,0.07692307692307693,12,12,CAAAAAGGCGCAGTCCGCAA,0,2817197
ompRp1,0.07692307692307693,12,12,ATTTAAGACCGAGTTGGTTC,0,2783772
ompRp1,0.07692307692307693,12,12,ATTGAGCCTTTCCTGCTACC,0,2818305
ompRp1,0.07692307692307693,12,12,ATTGACGAATGGTGGGATGG,0,2780684
ompRp1,0.07692307692307693,12,12,ATTGACAATGTGGCTTTTCA,0,2816807
ompRp1,0.07692307692307693,12,12,ATTGAAGGGTCATGTACATG,0,2767029
ompRp1,0.07692307692307693,12,12,ATTCATCCACTCGGGTATAC,0,2819930
ompRp1,0.07692307692307693,12,12,ATTATGCCGTCACCACTTCA,0,2783830
ompRp1,0.07692307692307693,12,12,ATTAGCTTGCGATGGGGATT,0,2815139
ompRp1,0.07692307692307693,12,12,ATTACTAAGTTACCTATTCC,0,2793731
ompRp1,0.07692307692307693,12,12,ATTACGGTGTGTCGGCAGAT,0,2821571
ompRp1,0.07692307692307693,12,12,ATGTGGTTTATCGAGCTAGA,0,2798682
ompRp1,0.07692307692307693,12,12,ATGTCTAGCACTCTGTCTCT,0,2794403
ompRp1,0.07692307692307693,12,12,ATGGTGCTGTATGCCTTTTT,0,2769078
ompRp1,0.07692307692307693,12,12,ATGGCCCGGACTATGGCAAG,0,2789839
ompRp1,0.07692307692307693,12,12,ATGCGCCCGCTCGGCATCGG,0,2803856
ompRp1,0.07692307692307693,12,12,ATGACCACCACGGGGGCAAG,0,2777890
ompRp1,0.07692307692307693,12,12,ATCTCTTATTGTTAACTTGG,0,2783540
ompRp1,0.07692307692307693,12,12,ATCTACCTTTCGTTCTCAGT,0,2787260
ompRp1,0.07692307692307693,12,12,ATCCTCAATAATCCGGTGAT,0,2774982
ompRp1,0.07692307692307693,12,12,ATCCCAGATGGTCGTTAATG,0,2797684
ompRp1,0.07692307692307693,12,12,ATCCATCCACAGGTAGGTCA,0,2769949
ompRp1,0.07692307692307693,12,12,ATCATACTGGATCGCATAAA,0,2799057
ompRp1,0.07692307692307693,12,12,ATATTTAGCCACCGACTTTA,0,2767835
ompRp1,0.07692307692307693,12,12,ATATCCAAAGTGTTTAGAGC,0,2788341
ompRp1,0.07692307692307693,12,12,ATATATGTATTTGGCACGGG,0,2788673
ompRp1,0.07692307692307693,12,12,ATACTTTCGAAACTTTCGTT,0,2815676
ompRp1,0.07692307692307693,12,12,ATAAGTGTATTAATGTATCC,0,2790590
ompRp1,0.07692307692307693,12,12,ATAACGTCGGTAGATAACTG,0,2808914
ompRp1,0.07692307692307693,12,12,AGTTTGCCAGGAGCATCCTA,0,2774665
ompRp1,0.07692307692307693,12,12,AGGTGGACTTGACGCCCGGC,0,2800132
ompRp1,0.07692307692307693,12,12,AGGTAGCGCGATTCCTGCCA,0,2799051
ompRp1,0.07692307692307693,12,12,AGGCGGAACAAGGGTCACAG,0,2766047
ompRp1,0.07692307692307693,12,12,AGGCACAGGTCGGAATTAAA,0,2769700
ompRp1,0.07692307692307693,12,12,AGGACGGTGGGACTGTAAAA,0,2776021
ompRp1,0.07692307692307693,12,12,AGGACCAACAGCCCATTCAG,0,2785831
ompRp1,0.07692307692307693,12,12,AGGAATCGGCTTCCCTCAGG,0,2779491
ompRp1,0.07692307692307693,12,12,AGCGTTTCCGTCGAGCAACT,0,2789622
ompRp1,0.07692307692307693,12,12,AGCGGACACTGTGGACACGA,0,2805117
ompRp1,0.07692307692307693,12,12,AGATCGGTGGTCCCTGTCTT,0,2792392
ompRp1,0.07692307692307693,12,12,AGAAGCGCTTTGTGGTCTGT,0,2786443
ompRp1,0.07692307692307693,12,12,AGAAACGGTCCTGCGGGAGA,0,2782203
ompRp1,0.07692307692307693,12,12,ACTGCACAAGGTATCGCACC,0,2795883
ompRp1,0.07692307692307693,12,12,ACTATTGTTCGCCCTTAGAT,0,2783403
ompRp1,0.07692307692307693,12,12,ACGGTTGACTGGCCGCGCGG,0,2788284
ompRp1,0.07692307692307693,12,12,ACGGGGAACCGTGGGCAGTA,0,2785436
ompRp1,0.07692307692307693,12,12,ACGGCAGACAGGAGTAACGG,0,2813982
ompRp1,0.07692307692307693,12,12,ACGCTGTACATTAGATTAGG,0,2805376
ompRp1,0.07692307692307693,12,12,ACGAATGCCCCAACTAGAGG,0,2793649
ompRp1,0.07692307692307693,12,12,ACCTGGTCTCCGGAGAGTGT,0,2792001
ompRp1,0.07692307692307693,12,12,ACCTCAGACTCTAAGCGAGT,0,2769865
ompRp1,0.07692307692307693,12,12,ACCTAGCTGTAACGAGCTAG,0,2781646
ompRp1,0.07692307692307693,12,12,ACAGTTGGAAAGAACCTTGG,0,2785351
ompRp1,0.07692307692307693,12,12,ACAGTAATCAGCCCAGCGAT,0,2791593
ompRp1,0.07692307692307693,12,12,ACAGCGTCTGTATTTGGTTG,0,2818375
ompRp1,0.07692307692307693,12,12,ACAGAGGCTGACCTACGCTT,0,2780296
ompRp1,0.07692307692307693,12,12,ACACTATGAGGCCCAACTGT,0,2778187
ompRp1,0.07692307692307693,12,12,AATTCACCTCAACTATGCGA,0,2804211
ompRp1,0.07692307692307693,12,12,AATGGGAACCCTTTACTAGG,0,2766865
ompRp1,0.07692307692307693,12,12,AATGCGCATCGTTGCTTGTG,0,2798275
ompRp1,0.07692307692307693,12,12,AATCAGGTTTTAAATCTTAA,0,2779472
ompRp1,0.07692307692307693,12,12,AATCAATAACTGCCGGGACT,0,2781564
ompRp1,0.07692307692307693,12,12,AATCAAAGATCTGACGTGTG,0,2770807
ompRp1,0.07692307692307693,12,12,AAGTTCGTGGCTGCCACTCA,0,2800293
ompRp1,0.07692307692307693,12,12,AAGTCCTGCTTAAAAGATCA,0,2773602
ompRp1,0.07692307692307693,12,12,AAGGGTCCGGTCACTTGTCT,0,2781293
ompRp1,0.07692307692307693,12,12,AAGGACCCAACCTGGAGGAT,0,2803247
ompRp1,0.07692307692307693,12,12,AAGCGCCGTCTAGTACACAC,0,2818666
ompRp1,0.07692307692307693,12,12,AAGCCAGGTCGTCCCGCAGA,0,2765347
ompRp1,0.07692307692307693,12,12,AACTGGCCGTGTCCGGATTT,0,2771420
ompRp1,0.07692307692307693,12,12,AACGTGAGGGCGCAGAGTAA,0,2822455
ompRp1,0.07692307692307693,12,12,AACGATCTGGACAGGCCAGA,0,2815033
ompRp1,0.07692307692307693,12,12,AACCTGGACCGCACACAACG,0,2791389
ompRp1,0.07692307692307693,12,12,AACCCGGGCTCCACTGTTGG,0,2806071
ompRp1,0.07692307692307693,12,12,AACCCAACTATAATTGAGAC,0,2777184
ompRp1,0.07692307692307693,12,12,AACATCATCGGGCATTGGAA,0,2809817
ompRp1,0.07692307692307693,12,12,AACATACGTTCGACGGCATT,0,2791222
ompRp1,0.07692307692307693,12,12,AACACAGTGTGACACTCTAT,0,2784776
ompRp1,0.07692307692307693,12,12,AACAAGCTCGAACAACTCAG,0,2821350
ompRp1,0.07692307692307693,12,12,AAATCGCAATTATTCGAGTA,0,2813107
ompRp1,0.07692307692307693,12,12,AAAGTCCCAGACTTTGCACA,0,2774677
ompRp1,0.07692307692307693,12,12,AAAAAGCGTTGCCCAAGATA,0,2808910
ompRp1,0.08333333333333333,11,11,TTTGCAATAGTGGTCCAGTG,0,2770671
ompRp1,0.08333333333333333,11,11,TTTATAGAGCTTCCTCTACG,0,2781676
ompRp1,0.08333333333333333,11,11,TTGTGGTCCCGTGAAATGAA,0,2774455
ompRp1,0.08333333333333333,11,11,TTGGCTGTCCGATAAAGGAA,0,2783816
ompRp1,0.08333333333333333,11,11,TTGGCGAGTGGAACTTCGGC,0,2772946
ompRp1,0.08333333333333333,11,11,TTGAGCGGTGTGCTGCCCAT,0,2786505
ompRp1,0.08333333333333333,11,11,TTCTCAGTTTATAGATTAAT,0,2802598
ompRp1,0.08333333333333333,11,11,TTCTAACCAGTCGTGCCTCT,0,2808015
ompRp1,0.08333333333333333,11,11,TTCGCGCTATCCAATGCCGG,0,2773864
ompRp1,0.08333333333333333,11,11,TTCGACGCTACCCAATGCAT,0,2781362
ompRp1,0.08333333333333333,11,11,TTCACGAAGTCCCATGGAGG,0,2767345
ompRp1,0.08333333333333333,11,11,TTATTCGACGAATAGGAAGG,0,2801045
ompRp1,0.08333333333333333,11,11,TTACTGCATACCAGTTTGAA,0,2796166
ompRp1,0.08333333333333333,11,11,TTAACTGTTGCGTATATTCT,0,2769787
ompRp1,0.08333333333333333,11,11,TTAACGTGAGGAGTTTAGTA,0,2768838
ompRp1,0.08333333333333333,11,11,TTAAAGCACTGCGGGTAATT,0,2789682
ompRp1,0.08333333333333333,11,11,TGTTTCTGTCATTAGGAGAA,0,2777661
ompRp1,0.08333333333333333,11,11,TGTTGGCACCCATACATGAT,0,2804456
ompRp1,0.08333333333333333,11,11,TGTTAGGAGAGGATCAACTT,0,2781132
ompRp1,0.08333333333333333,11,11,TGTGTCGCTCACCACCCGTT,0,2789305
ompRp1,0.08333333333333333,11,11,TGTGGCGCGCTGGTCTTAGA,0,2781030
ompRp1,0.08333333333333333,11,11,TGTGGCATCGACCTGTCACA,0,2814244
ompRp1,0.08333333333333333,11,11,TGTATGGGCGTGCGCGACTC,0,2806812
ompRp1,0.08333333333333333,11,11,TGGTGTGCCTACGGGCGGGA,0,2809512
ompRp1,0.08333333333333333,11,11,TGGTCGGACTTTCGTGACGT,0,2798933
ompRp1,0.08333333333333333,11,11,TGGCTCGGAACCGGTAGGCA,0,2807626
ompRp1,0.08333333333333333,11,11,TGGCCCGGATCCTGACCTTT,0,2796441
ompRp1,0.08333333333333333,11,11,TGGCCAGAGAACACAACAGG,0,2791839
ompRp1,0.08333333333333333,11,11,TGGCCAATAACCCATCTGCG,0,2782314
ompRp1,0.08333333333333333,11,11,TGGCATATCCTAGATTTTGT,0,2806315
ompRp1,0.08333333333333333,11,11,TGGATTGTCGAGACCCGCGG,0,2804087
ompRp1,0.08333333333333333,11,11,TGGATATCCTAGACCGACTG,0,2796668
ompRp1,0.08333333333333333,11,11,TGCTTGGAGGTGGCATTCAT,0,2810596
ompRp1,0.08333333333333333,11,11,TGCTTGCGGGGCGCGCGGAA,0,2794050
ompRp1,0.08333333333333333,11,11,TGCGTTGTTCGCGGACTCTG,0,2789643
ompRp1,0.08333333333333333,11,11,TGCATACTTCCGTTGGACGA,0,2795424
ompRp1,0.08333333333333333,11,11,TGATGTCTGCGATTTTCGGC,0,2777106
ompRp1,0.08333333333333333,11,11,TGATCTGACTCGATACAAAT,0,2816859
ompRp1,0.08333333333333333,11,11,TGAGGCAGTATTTCATGTTG,0,2774075
ompRp1,0.08333333333333333,11,11,TGAGAACACAAGTGGTACGA,0,2824372
ompRp1,0.08333333333333333,11,11,TGACTGGGTGATGATATATG,0,2771441
ompRp1,0.08333333333333333,11,11,TGAAGTCATGGGCATGCTTG,0,2789249
ompRp1,0.08333333333333333,11,11,TGAAGTAATCTACGTGCTAT,0,2811792
ompRp1,0.08333333333333333,11,11,TCTTCGCTTAGCCCTAGCGC,0,2785349
ompRp1,0.08333333333333333,11,11,TCTGCTGATCATGTCAGAAC,0,2818386
ompRp1,0.08333333333333333,11,11,TCGTTAAATCCTCGAGCAAC,0,2813246
ompRp1,0.08333333333333333,11,11,TCGTGACTGCCGGGGCTTGT,0,2798464
ompRp1,0.08333333333333333,11,11,TCGTAAGCGCAGAAAGAACA,0,2822923
ompRp1,0.08333333333333333,11,11,TCGGTCTGACTTCTTTCTGC,0,2765818
ompRp1,0.08333333333333333,11,11,TCGGTACGTAGCATGATTAT,0,2783966
ompRp1,0.08333333333333333,11,11,TCGGCTCGGTGAGAAGGGGA,0,2794966
ompRp1,0.08333333333333333,11,11,TCGGATAGGGGCTCCGGTGT,0,2791946
ompRp1,0.08333333333333333,11,11,TCGCAGGCATAGACTAGAGG,0,2795604
ompRp1,0.08333333333333333,11,11,TCGCAGCTGGCCATTCAGCC,0,2771048
ompRp1,0.08333333333333333,11,11,TCCTGGACAGTGGAATGCTA,0,2787130
ompRp1,0.08333333333333333,11,11,TCCCCGGCGAGTTGTACGGC,0,2817904
ompRp1,0.08333333333333333,11,11,TCCATGGTTCCGTGTCTGTA,0,2794566
ompRp1,0.08333333333333333,11,11,TCCATCCAATACGTTGATTA,0,2773957
ompRp1,0.08333333333333333,11,11,TCCAGTCCGCCTACGAGCCA,0,2808454
ompRp1,0.08333333333333333,11,11,TCCAATCTGTTGTGGCTGGC,0,2799431
ompRp1,0.08333333333333333,11,11,TCATGTGGAGACAATTCCTC,0,2814093
ompRp1,0.08333333333333333,11,11,TCAGGATATCGATACGTAAA,0,2819080
ompRp1,0.08333333333333333,11,11,TCAGCGGGTAGTTCCCAAGA,0,2788247
ompRp1,0.08333333333333333,11,11,TCACGGCGGCAAGACGCCGT,0,2768017
ompRp1,0.08333333333333333,11,11,TCACCGGATCAGTACACGGT,0,2817201
ompRp1,0.08333333333333333,11,11,TCACAAGCCGTGAGCCATAG,0,2779728
ompRp1,0.08333333333333333,11,11,TCAATGCTGCAAAAGGGTAG,0,2779210
ompRp1,0.08333333333333333,11,11,TCAAGCTGAAGGGAAATCGA,0,2809216
ompRp1,0.08333333333333333,11,11,TATTGTTGTTCAGGTCGAAA,0,2800736
ompRp1,0.08333333333333333,11,11,TATGCTTGTGAATGGTACAG,0,2793560
ompRp1,0.08333333333333333,11,11,TATGCTGTCTCGGGTGTATC,0,2769361
ompRp1,0.08333333333333333,11,11,TATCTTGTCCAAATAAATTA,0,2789941
ompRp1,0.08333333333333333,11,11,TATCATAGGTACGCAAATAT,0,2821252
ompRp1,0.08333333333333333,11,11,TATCAGCAAGTTTTTCCGCT,0,2814317
ompRp1,0.08333333333333333,11,11,TATACCTTCTATTGGATCTA,0,2771503
ompRp1,0.08333333333333333,11,11,TAGCGGCTTCACACGGTCAG,0,2811967
ompRp1,0.08333333333333333,11,11,TAGCCACAGTCTAGCCGATT,0,2767923
ompRp1,0.08333333333333333,11,11,TAGCATGAGTCTGGGATGCT,0,2794188
ompRp1,0.08333333333333333,11,11,TAGAAAACAGAGGAGAAGGG,0,2768922
ompRp1,0.08333333333333333,11,11,TACGCGTACTGCTCATACGA,0,2800522
ompRp1,0.08333333333333333,11,11,TACGAAAACATAATCGGATT,0,2812081
ompRp1,0.08333333333333333,11,11,TACAGTTATACACGAATGCA,0,2805419
ompRp1,0.08333333333333333,11,11,TAATGGAGCCGACCTGAGTT,0,2785890
ompRp1,0.08333333333333333,11,11,TAAGGGGGAGCCAGGAACTT,0,2805850
ompRp1,0.08333333333333333,11,11,TAAAGATGCGGAGTGTGCGC,0,2807031
ompRp1,0.08333333333333333,11,11,TAAAACACCAAATTTTTTTG,0,2821758
ompRp1,0.08333333333333333,11,11,GTTTGATCAGTTCCCTCGGT,0,2794857
ompRp1,0.08333333333333333,11,11,GTTGTCTGCCTGATCGGGCT,0,2780149
ompRp1,0.08333333333333333,11,11,GTTCTTCAGAATCAACGTCT,0,2807097
ompRp1,0.08333333333333333,11,11,GTTCTGTATTTGTTAAGGAT,0,2796415
ompRp1,0.08333333333333333,11,11,GTTCGGCCTGTCACCGGCCT,0,2767766
ompRp1,0.08333333333333333,11,11,GTTATGGCGACGGAGTAGCC,0,2777487
ompRp1,0.08333333333333333,11,11,GTTACGAACTAATGAGCTTT,0,2781138
ompRp1,0.08333333333333333,11,11,GTTAAGAATCGTATCGTTAT,0,2809766
ompRp1,0.08333333333333333,11,11,GTGTATATTATTTAGCGTCT,0,2809579
ompRp1,0.08333333333333333,11,11,GTGGTTCTCTCAACGTCATG,0,2786179
ompRp1,0.08333333333333333,11,11,GTGGCCGCCCAGGCGGGTAA,0,2812862
ompRp1,0.08333333333333333,11,11,GTGAGCCCGCTAGCGCTCGG,0,2811215
ompRp1,0.08333333333333333,11,11,GTCGGCGGTACTCCCTACAC,0,2806528
ompRp1,0.08333333333333333,11,11,GTCCCTAAGGCTGGGATGAC,0,2808368
ompRp1,0.08333333333333333,11,11,GTCATACTATCAAGAACCTA,0,2806683
ompRp1,0.08333333333333333,11,11,GTCAGGTCCGGTGGTACTCC,0,2795003
ompRp1,0.08333333333333333,11,11,GTCAAAATCGTGACTGGCTG,0,2781720
ompRp1,0.08333333333333333,11,11,GTATGACGAAAGGGTCATTG,0,2810566
ompRp1,0.08333333333333333,11,11,GTACGCATCCACGTTAGAGC,0,2803741
ompRp1,0.08333333333333333,11,11,GTACCCCAGACCAACTCTAG,0,2786581
ompRp1,0.08333333333333333,11,11,GGTTATTGAGTCTATATCAA,0,2820272
ompRp1,0.08333333333333333,11,11,GGTTAGGGTAAGTACTTAAG,0,2794149
ompRp1,0.08333333333333333,11,11,GGTGTGCCGGATCTCTGGAA,0,2789423
ompRp1,0.08333333333333333,11,11,GGTGAACGAGCCGTCTCCCC,0,2823085
ompRp1,0.08333333333333333,11,11,GGGTGCGCGATAGCGACTGA,0,2771669
ompRp1,0.08333333333333333,11,11,GGGTCTGTCATCCCGTCGTT,0,2773445
ompRp1,0.08333333333333333,11,11,GGGTCGTGGTTATGTCAGCT,0,2807272
ompRp1,0.08333333333333333,11,11,GGGGTTCCCCAGTCAGCTGC,0,2820657
ompRp1,0.08333333333333333,11,11,GGGGGCCAGCGCACTCTTTT,0,2809219
ompRp1,0.08333333333333333,11,11,GGGCTACGAGCTTGATCATA,0,2809307
ompRp1,0.08333333333333333,11,11,GGGCGCACATACATGAGTAC,0,2787730
ompRp1,0.08333333333333333,11,11,GGGCCGTTGAGCTTGGCGCC,0,2789820
ompRp1,0.08333333333333333,11,11,GGGCACCGCTCCCGCGACAC,0,2771670
ompRp1,0.08333333333333333,11,11,GGGAGGGTAAGTGTACGTAC,0,2767417
ompRp1,0.08333333333333333,11,11,GGGAGAATATCCTTGCCTAG,0,2777651
ompRp1,0.08333333333333333,11,11,GGGAAACACTCGATGGAAAT,0,2779265
ompRp1,0.08333333333333333,11,11,GGGAAAAGGAAGTGGCTGAT,0,2782325
ompRp1,0.08333333333333333,11,11,GGCTCCATGATCTCAATCCG,0,2784515
ompRp1,0.08333333333333333,11,11,GGCGTCTTCGCAATGACGGT,0,2788306
ompRp1,0.08333333333333333,11,11,GGCATGTTAGAACCACGGTA,0,2782421
ompRp1,0.08333333333333333,11,11,GGCAGAGGTACGGGAGACTC,0,2818840
ompRp1,0.08333333333333333,11,11,GGCACGGTTTACGTCCGCTA,0,2798005
ompRp1,0.08333333333333333,11,11,GGATTTCTCTAAAAAATGGT,0,2784771
ompRp1,0.08333333333333333,11,11,GGATCAGTCGCATCTGCGAT,0,2795027
ompRp1,0.08333333333333333,11,11,GGAGCAGCCAAGTGGTGCGT,0,2799258
ompRp1,0.08333333333333333,11,11,GCTTGCACGGTCCGTGGGGT,0,2823119
ompRp1,0.08333333333333333,11,11,GCTTCGACGCAATGGTACGG,0,2810036
ompRp1,0.08333333333333333,11,11,GCTGTAAGTGTCTTATATGG,0,2785889
ompRp1,0.08333333333333333,11,11,GCTGGTTTTGTTCAAGACTA,0,2783504
ompRp1,0.08333333333333333,11,11,GCTGACGACTGCTGGATAGA,0,2802445
ompRp1,0.08333333333333333,11,11,GCTCTGGATCCTGGGCTCCA,0,2771306
ompRp1,0.08333333333333333,11,11,GCTCCTCCACTCCGTCTCTA,0,2805926
ompRp1,0.08333333333333333,11,11,GCTCACTTTACATTCTTATG,0,2806791
ompRp1,0.08333333333333333,11,11,GCTAGACGGGGTACTGCGGA,0,2790440
ompRp1,0.08333333333333333,11,11,GCTAAAACCGGGCATCCTGC,0,2801841
ompRp1,0.08333333333333333,11,11,GCGCTTGTTGCGATGAGGTA,0,2787138
ompRp1,0.08333333333333333,11,11,GCGCTTCGTTTATGCGCCGA,0,2800299
ompRp1,0.08333333333333333,11,11,GCGCCAAACGCATGGCCACC,0,2797220
ompRp1,0.08333333333333333,11,11,GCGCATCACGGCTGTGCCTC,0,2768548
ompRp1,0.08333333333333333,11,11,GCGACAGACGCCAAACCGCA,0,2775791
ompRp1,0.08333333333333333,11,11,GCGAACTCGATGCCGTGCAG,0,2824247
ompRp1,0.08333333333333333,11,11,GCCTTCCTCCAGGTAAGTTT,0,2786150
ompRp1,0.08333333333333333,11,11,GCCTTACGCTCCATAACTGT,0,2814929
ompRp1,0.08333333333333333,11,11,GCCGTTTGAGCTCTAAGGCG,0,2803848
ompRp1,0.08333333333333333,11,11,GCCCTCCCGAAGTCGTACCA,0,2775549
ompRp1,0.08333333333333333,11,11,GCCACCGGTCCAACATACGT,0,2803240
ompRp1,0.08333333333333333,11,11,GCCAAGATATACAGAAGAAT,0,2771448
ompRp1,0.08333333333333333,11,11,GCATATTTGCGCAAGTACTA,0,2819384
ompRp1,0.08333333333333333,11,11,GCAGTTCACCGTTGTGCCCA,0,2810124
ompRp1,0.08333333333333333,11,11,GCAGGTCAGTTAAGGTTTTT,0,2806006
ompRp1,0.08333333333333333,11,11,GCAGATTGTAAACCTAGGTA,0,2818296
ompRp1,0.08333333333333333,11,11,GCAGATCCTACCGGGGCCGA,0,2768021
ompRp1,0.08333333333333333,11,11,GCACTAAGAATGGGTCTTCT,0,2816319
ompRp1,0.08333333333333333,11,11,GCACGTGCCCCGAGACAACA,0,2808055
ompRp1,0.08333333333333333,11,11,GCACGACCTTCAGATAAATG,0,2786148
ompRp1,0.08333333333333333,11,11,GCAAGCGGATCTTCCGGAAG,0,2813141
ompRp1,0.08333333333333333,11,11,GATTACTCCCCACCAAGCTG,0,2804209
ompRp1,0.08333333333333333,11,11,GATTAAGACCTTACGGGAGC,0,2820972
ompRp1,0.08333333333333333,11,11,GATGGCTTACAGATTGCTCT,0,2803470
ompRp1,0.08333333333333333,11,11,GATCTCTTCGAAAGCATTCT,0,2797375
ompRp1,0.08333333333333333,11,11,GATCCAGCCAACCTTTAGAA,0,2810539
ompRp1,0.08333333333333333,11,11,GATCAGTCGCACCGGTATAA,0,2799141
ompRp1,0.08333333333333333,11,11,GATCAAGGCCGACTGGGTGT,0,2793835
ompRp1,0.08333333333333333,11,11,GAGTCATGACGCAGCCATGC,0,2771757
ompRp1,0.08333333333333333,11,11,GAGGCGATCTGTTAGCCGCA,0,2820747
ompRp1,0.08333333333333333,11,11,GACTACTGACAATATGAATA,0,2801261
ompRp1,0.08333333333333333,11,11,GACGGGTGTCAGGTGACAGT,0,2784881
ompRp1,0.08333333333333333,11,11,GACCTGCCCGTTATGCTCGT,0,2805865
ompRp1,0.08333333333333333,11,11,GAATATTCCGTCATGACCGT,0,2806403
ompRp1,0.08333333333333333,11,11,GAAGTTTGGGGAGTGGTAGA,0,2770187
ompRp1,0.08333333333333333,11,11,GAAGTCCGACTTACACCAAT,0,2801151
ompRp1,0.08333333333333333,11,11,GAAGGGCACAACAGGACCAT,0,2801654
ompRp1,0.08333333333333333,11,11,GAACGGGCCTACAAGTTAGA,0,2804219
ompRp1,0.08333333333333333,11,11,GAACGACTGGGTCCTTGTGA,0,2796977
ompRp1,0.08333333333333333,11,11,GAACCACCTACCGAACATGG,0,2769566
ompRp1,0.08333333333333333,11,11,GAAACTATGAGTCTGGTTCC,0,2779396
ompRp1,0.08333333333333333,11,11,CTTTGTGTCAATGATTCGAG,0,2797472
ompRp1,0.08333333333333333,11,11,CTTTCTCAAGTCTCTTTCTT,0,2803498
ompRp1,0.08333333333333333,11,11,CTTTCTAACGACTCATGCCA,0,2784118
ompRp1,0.08333333333333333,11,11,CTTCTAAAAGGCTTCCCTAA,0,2775807
ompRp1,0.08333333333333333,11,11,CTTCCGAACAGTGGGCAGCT,0,2822477
ompRp1,0.08333333333333333,11,11,CTTCATAGGTAATTGGAGCC,0,2790586
ompRp1,0.08333333333333333,11,11,CTGTTACGTTTATGGGCGAT,0,2776349
ompRp1,0.08333333333333333,11,11,CTGGTTGCCTTGTGACCGAT,0,2776064
ompRp1,0.08333333333333333,11,11,CTGGCGAGTGCGCGCGACCA,0,2787725
ompRp1,0.08333333333333333,11,11,CTGCATGGTTAAAGCCAAAT,0,2792931
ompRp1,0.08333333333333333,11,11,CTGATGAAAGGAGTCATTAT,0,2822671
ompRp1,0.08333333333333333,11,11,CTGACTTAGAATATAGAAGA,0,2810685
ompRp1,0.08333333333333333,11,11,CTGAAATCACGCTACCGTAT,0,2801402
ompRp1,0.08333333333333333,11,11,CTCTACTATCGATACCGGGA,0,2807602
ompRp1,0.08333333333333333,11,11,CTCCGGGGGGCCAGGATGCA,0,2818073
ompRp1,0.08333333333333333,11,11,CTATGACAGTGTCCTATAAA,0,2782161
ompRp1,0.08333333333333333,11,11,CTATAAATAAGCGGAGTACA,0,2787090
ompRp1,0.08333333333333333,11,11,CTAGCGCCCAAGCGACAAGT,0,2812474
ompRp1,0.08333333333333333,11,11,CTAGCAGGTCCTGTTATTGA,0,2781101
ompRp1,0.08333333333333333,11,11,CGTCGTATACTATGGCGAAG,0,2810112
ompRp1,0.08333333333333333,11,11,CGTCCTGTTCTTATTACATG,0,2792302
ompRp1,0.08333333333333333,11,11,CGTCCGAATTCGATGGGGGT,0,2790524
ompRp1,0.08333333333333333,11,11,CGTCAATTCGTCAGTGTTCT,0,2819488
ompRp1,0.08333333333333333,11,11,CGGTTTGTATACCAACATTT,0,2806699
ompRp1,0.08333333333333333,11,11,CGGTCAGTAACACGGCGGAT,0,2791471
ompRp1,0.08333333333333333,11,11,CGGTAACAGTCCGTCGAACA,0,2773239
ompRp1,0.08333333333333333,11,11,CGGGCAATTATCTCCGTGGA,0,2785074
ompRp1,0.08333333333333333,11,11,CGGCTGGTGCAACGAGAATA,0,2791944
ompRp1,0.08333333333333333,11,11,CGGCGGTTGGTGGAGAAACG,0,2822876
ompRp1,0.08333333333333333,11,11,CGGCGGAGGGTGCTGACGTG,0,2814683
ompRp1,0.08333333333333333,11,11,CGGCCCTACAAGTTTAAGAT,0,2804458
ompRp1,0.08333333333333333,11,11,CGGCATCAGATATGGGTGGT,0,2794681
ompRp1,0.08333333333333333,11,11,CGGCAGCATAGAATAGGCCA,0,2803246
ompRp1,0.08333333333333333,11,11,CGGAGCGAAGAACGCACAGC,0,2810553
ompRp1,0.08333333333333333,11,11,CGGACCTCCCAGGCAGACTA,0,2805019
ompRp1,0.08333333333333333,11,11,CGGACAGATCGTGGGGTGTG,0,2785833
ompRp1,0.08333333333333333,11,11,CGGACACGGGGGTAGCGCTT,0,2795785
ompRp1,0.08333333333333333,11,11,CGCGGCCTGGTCTGTGAGGC,0,2770349
ompRp1,0.08333333333333333,11,11,CGCGCGGGGCTAGGGGTCTT,0,2815001
ompRp1,0.08333333333333333,11,11,CGCGCGGGCCTTTACGTCGC,0,2809868
ompRp1,0.08333333333333333,11,11,CGCCGGTAGTAATCAAGAAC,0,2811468
ompRp1,0.08333333333333333,11,11,CGCCCCACCTGATTATCAAT,0,2823515
ompRp1,0.08333333333333333,11,11,CGATTTCAGCTAGGAATTAT,0,2768429
ompRp1,0.08333333333333333,11,11,CGACTTGAAAGACTGGGTGG,0,2765316
ompRp1,0.08333333333333333,11,11,CGAAAGTTGTGTACACACTT,0,2815691
ompRp1,0.08333333333333333,11,11,CCTTATGTAGGCAGGACACC,0,2784456
ompRp1,0.08333333333333333,11,11,CCTGGGCCTGCGAGGCTTCG,0,2782631
ompRp1,0.08333333333333333,11,11,CCTGCGCGTAGGGGCGCGTG,0,2818468
ompRp1,0.08333333333333333,11,11,CCTCTTGTGGGCACCAAGCT,0,2790424
ompRp1,0.08333333333333333,11,11,CCTCCTCAGGCGTCCTCACG,0,2810678
ompRp1,0.08333333333333333,11,11,CCTCAAGTGCTAAACAGTTC,0,2808804
ompRp1,0.08333333333333333,11,11,CCGGATTCCTGAGCGTGCTT,0,2801326
ompRp1,0.08333333333333333,11,11,CCGCCACACTGCGCGAAGGA,0,2783353
ompRp1,0.08333333333333333,11,11,CCGCAATTCATTGTGCTTAA,0,2778243
ompRp1,0.08333333333333333,11,11,CCGAAGTGGCATTGTAGTCG,0,2804912
ompRp1,0.08333333333333333,11,11,CCCTTTGTGGCCGTACCTGC,0,2783102
ompRp1,0.08333333333333333,11,11,CCCTGCCGCCAGAGGTCTAT,0,2819555
ompRp1,0.08333333333333333,11,11,CCCCGCTAACCACGTTTTAG,0,2778242
ompRp1,0.08333333333333333,11,11,CCCCAGGCTTCTGGTAGCGA,0,2777432
ompRp1,0.08333333333333333,11,11,CCCATCTCCTGGAAGCCCTT,0,2819747
ompRp1,0.08333333333333333,11,11,CCCAGGAGCTCACCCACCAC,0,2786968
ompRp1,0.08333333333333333,11,11,CCATTTGGCTAAACACATAC,0,2765384
ompRp1,0.08333333333333333,11,11,CCATTGCGCGCCCGGAGAAG,0,2765610
ompRp1,0.08333333333333333,11,11,CCATACGAATAGCAATCCAC,0,2768435
ompRp1,0.08333333333333333,11,11,CCAGGGGGATTCGGAGCCAG,0,2790897
ompRp1,0.08333333333333333,11,11,CCAACCCTGACAAGAGCTGG,0,2812115
ompRp1,0.08333333333333333,11,11,CATTTTTTTAGCAGCACTAG,0,2789486
ompRp1,0.08333333333333333,11,11,CATTTGTCAGGTGGTGCGGA,0,2824199
ompRp1,0.08333333333333333,11,11,CATTTCGAGTGCTGCCGACG,0,2790676
ompRp1,0.08333333333333333,11,11,CATTGGGATAAACGAGCCCA,0,2805733
ompRp1,0.08333333333333333,11,11,CATTGGCTCAGTTAAAAAGT,0,2777595
ompRp1,0.08333333333333333,11,11,CATGTATACGTGTGGGATTG,0,2781047
ompRp1,0.08333333333333333,11,11,CATGTAAGCCGAATTTATGT,0,2770530
ompRp1,0.08333333333333333,11,11,CATGCCCATCTCGGTGGCAA,0,2814924
ompRp1,0.08333333333333333,11,11,CATGCCAGGGCTGGCGGCGA,0,2772287
ompRp1,0.08333333333333333,11,11,CATGAATTGCCAATGGCATC,0,2809836
ompRp1,0.08333333333333333,11,11,CATCGTTGCCGAATCTTGCT,0,2818758
ompRp1,0.08333333333333333,11,11,CATCAAACAATCGCGCGATG,0,2782179
ompRp1,0.08333333333333333,11,11,CATATGGGGGAGTCCCATAG,0,2817386
ompRp1,0.08333333333333333,11,11,CAGGTCATACGATAACTAGC,0,2810970
ompRp1,0.08333333333333333,11,11,CAGGTATGCGTAGAGTGTAG,0,2793390
ompRp1,0.08333333333333333,11,11,CAGGGCAGAGTAAGAATCGG,0,2799954
ompRp1,0.08333333333333333,11,11,CAGGGAAGTCTTCGGTCTCA,0,2785939
ompRp1,0.08333333333333333,11,11,CAGGCGACAATGCGTGCACC,0,2812652
ompRp1,0.08333333333333333,11,11,CAGCCTTTGCGTTCAGCGGG,0,2769696
ompRp1,0.08333333333333333,11,11,CAGCCCACTATACACAGCGT,0,2806654
ompRp1,0.08333333333333333,11,11,CAGAAAGTTGCTAACGTGGA,0,2793872
ompRp1,0.08333333333333333,11,11,CACTGTAAAGGGTGATGGGT,0,2787229
ompRp1,0.08333333333333333,11,11,CACTGAGATTGGACTGCGTC,0,2814717
ompRp1,0.08333333333333333,11,11,CACTAATCTGGCGAGGTCAG,0,2780224
ompRp1,0.08333333333333333,11,11,CACGGGGCATTGCTCTTGAG,0,2783140
ompRp1,0.08333333333333333,11,11,CAATTCTAAATCAGCCCACA,0,2823269
ompRp1,0.08333333333333333,11,11,CAATTAGTGCCGTAGGCGGT,0,2788327
ompRp1,0.08333333333333333,11,11,CAATGGTTTTACTTAGTGCA,0,2772649
ompRp1,0.08333333333333333,11,11,CAATACGGACAGTTAGTTTA,0,2804407
ompRp1,0.08333333333333333,11,11,CAAGTAGACCTACTGCGAGA,0,2816248
ompRp1,0.08333333333333333,11,11,CAAGATTCATTCCAAATCAG,0,2808500
ompRp1,0.08333333333333333,11,11,CAACTGGCTGGAGTTGCAGA,0,2813581
ompRp1,0.08333333333333333,11,11,CAACAGGAGACTTATCTCTT,0,2814991
ompRp1,0.08333333333333333,11,11,ATTCACTGCTAGTAGGATCG,0,2804533
ompRp1,0.08333333333333333,11,11,ATTCAACAATCCTTGGTTGA,0,2807582
ompRp1,0.08333333333333333,11,11,ATTAGCAGCCCCTTGCAATT,0,2775812
ompRp1,0.08333333333333333,11,11,ATTACGGACCCTACAGTCCT,0,2813937
ompRp1,0.08333333333333333,11,11,ATGTGTGCGGAGTACTATGC,0,2788390
ompRp1,0.08333333333333333,11,11,ATGGCGTGGATATCCGGCGC,0,2793654
ompRp1,0.08333333333333333,11,11,ATGCTCTACGGGTACAAAGT,0,2805318
ompRp1,0.08333333333333333,11,11,ATGCGACCAAGGGCACGATT,0,2776928
ompRp1,0.08333333333333333,11,11,ATGCCACACGACTAATAGTT,0,2804459
ompRp1,0.08333333333333333,11,11,ATGCCACACAGTGCCCAACG,0,2787317
ompRp1,0.08333333333333333,11,11,ATGAGGCCGTATTTTCGCGT,0,2784611
ompRp1,0.08333333333333333,11,11,ATGAATAATTCATTACCACG,0,2817401
ompRp1,0.08333333333333333,11,11,ATCTCCATAGACCTCATTTT,0,2820832
ompRp1,0.08333333333333333,11,11,ATCTAAAGCGAAACCGTGAA,0,2769147
ompRp1,0.08333333333333333,11,11,ATCGGTCTGGATCCCCACAA,0,2812149
ompRp1,0.08333333333333333,11,11,ATCGACAGAAAGATCTTGTT,0,2793198
ompRp1,0.08333333333333333,11,11,ATCATGCACGTGTGTGAAAC,0,2785243
ompRp1,0.08333333333333333,11,11,ATCAGCCAACTCCACACCGG,0,2797715
ompRp1,0.08333333333333333,11,11,ATATAGGGTACTGGCCGCGG,0,2774095
ompRp1,0.08333333333333333,11,11,ATAGGGACCATCAATCCGGT,0,2803449
ompRp1,0.08333333333333333,11,11,ATAGCTCGACGTCTGTAGCT,0,2772083
ompRp1,0.08333333333333333,11,11,ATAGAGTGATACTGAAAGCC,0,2783116
ompRp1,0.08333333333333333,11,11,ATACGGGGGGTCAAAGAGTC,0,2774228
ompRp1,0.08333333333333333,11,11,ATAACATACAGAAATTTTCC,0,2813903
ompRp1,0.08333333333333333,11,11,AGTTCCGCTTTGATTACCGA,0,2814674
ompRp1,0.08333333333333333,11,11,AGTGTAGTGCTCTTCACTCG,0,2792779
ompRp1,0.08333333333333333,11,11,AGTGAAAACGGATAACCTTA,0,2780179
ompRp1,0.08333333333333333,11,11,AGTCTGCTATAAGTGATTCT,0,2768959
ompRp1,0.08333333333333333,11,11,AGGTAAATGAATACGGTCCG,0,2798124
ompRp1,0.08333333333333333,11,11,AGGGATTACAGAGAACGTTC,0,2781638
ompRp1,0.08333333333333333,11,11,AGGCAACGTCCATATTGGCT,0,2770901
ompRp1,0.08333333333333333,11,11,AGGATATACCTAATTTTCAG,0,2794037
ompRp1,0.08333333333333333,11,11,AGGACATGTGTACGTTCTAA,0,2775928
ompRp1,0.08333333333333333,11,11,AGCTTCTCCCAAACCGTTCA,0,2805260
ompRp1,0.08333333333333333,11,11,AGCTTCGGCAGGCAAGCGCG,0,2800270
ompRp1,0.08333333333333333,11,11,AGCTGCTACGTTGAATTCAT,0,2816465
ompRp1,0.08333333333333333,11,11,AGCGGATGCTTGTTCCGTGA,0,2814008
ompRp1,0.08333333333333333,11,11,AGCGGAACATGAACGAGCTA,0,2795088
ompRp1,0.08333333333333333,11,11,AGCGAGAGTTGAAAGGTTAA,0,2809171
ompRp1,0.08333333333333333,11,11,AGCAGGCAAAGAGCCACAGT,0,2791086
ompRp1,0.08333333333333333,11,11,AGCAATATCACCTTATCAGT,0,2787771
ompRp1,0.08333333333333333,11,11,AGATTCCATAGTCTCAACTC,0,2772991
ompRp1,0.08333333333333333,11,11,AGAGGAGGGACTGAGAGCAT,0,2769148
ompRp1,0.08333333333333333,11,11,AGAATAGCCGAGACCCATTA,0,2807947
ompRp1,0.08333333333333333,11,11,AGAAGTTAGCGCGTATTATA,0,2788488
ompRp1,0.08333333333333333,11,11,ACTTTGTCTTAGTTAAATTT,0,2817489
ompRp1,0.08333333333333333,11,11,ACTTTACGTGAAGAGTTGTT,0,2774673
ompRp1,0.08333333333333333,11,11,ACTTGTAACTGCGTCACGTT,0,2798483
ompRp1,0.08333333333333333,11,11,ACTGTCGTCAATAGCTTTAT,0,2795535
ompRp1,0.08333333333333333,11,11,ACTGATCGTCGGAAAATAGG,0,2791159
ompRp1,0.08333333333333333,11,11,ACTCGTATTGGCTCGGTACG,0,2806554
ompRp1,0.08333333333333333,11,11,ACTCCTCGTATGGGCTGTTT,0,2811946
ompRp1,0.08333333333333333,11,11,ACTCACTAATGTTGCCCATA,0,2777353
ompRp1,0.08333333333333333,11,11,ACTACAAATCACACTTGCAA,0,2789112
ompRp1,0.08333333333333333,11,11,ACGTATGACGCATTAAGTTC,0,2779160
ompRp1,0.08333333333333333,11,11,ACGGTCCGATGTTTGGTTTT,0,2804337
ompRp1,0.08333333333333333,11,11,ACGGAATTACGAGTTGCAAG,0,2774524
ompRp1,0.08333333333333333,11,11,ACGCTTGGAAATTCACATTC,0,2788037
ompRp1,0.08333333333333333,11,11,ACGCATTTACGCGTTTCGGC,0,2816327
ompRp1,0.08333333333333333,11,11,ACGAATTTCGGATGGCAAGG,0,2803691
ompRp1,0.08333333333333333,11,11,ACCTAAATTCCCTTTTCGTA,0,2805894
ompRp1,0.08333333333333333,11,11,ACCGGTGCTTACGGGGATCA,0,2810723
ompRp1,0.08333333333333333,11,11,ACCAATTTAGCCTGGGAGCA,0,2789023
ompRp1,0.08333333333333333,11,11,ACATGGTGCCGATCAAGCCA,0,2767277
ompRp1,0.08333333333333333,11,11,ACATGATATTAGTCCAGTGT,0,2787181
ompRp1,0.08333333333333333,11,11,ACATAGAAAGGTATCCATCA,0,2803977
ompRp1,0.08333333333333333,11,11,ACATAAATGAGGCTTGCGGA,0,2781587
ompRp1,0.08333333333333333,11,11,ACAGGCTGCGGTATTGAGGG,0,2779397
ompRp1,0.08333333333333333,11,11,ACAGCCGCTAGGCGATGAAA,0,2820035
ompRp1,0.08333333333333333,11,11,ACACTAGCAGATATCGATAC,0,2807513
ompRp1,0.08333333333333333,11,11,ACACGGGCGCATCTCGTATA,0,2790127
ompRp1,0.08333333333333333,11,11,ACACATGGCGTCCGCTCAGT,0,2795612
ompRp1,0.08333333333333333,11,11,ACACACCGGGCGATTAAAGA,0,2773557
ompRp1,0.08333333333333333,11,11,AATTTGGCAATGCACGCTAG,0,2822628
ompRp1,0.08333333333333333,11,11,AATTTCGCGTTAGGAAGTCG,0,2788499
ompRp1,0.08333333333333333,11,11,AATTCGCCCAGCGTGCCCGG,0,2774408
ompRp1,0.08333333333333333,11,11,AATTAAGAGGTGTGCGATTG,0,2784856
ompRp1,0.08333333333333333,11,11,AATCTTCATCAGGGGAGCCT,0,2790126
ompRp1,0.08333333333333333,11,11,AATATGGGTCCAGTGTCTAG,0,2778475
ompRp1,0.08333333333333333,11,11,AAGTAGCCGGACCGCCGGAG,0,2768590
ompRp1,0.08333333333333333,11,11,AAGGTACCATCTTCCGTTAG,0,2810729
ompRp1,0.08333333333333333,11,11,AAGGGAACTGTAAGTGCGGC,0,2799846
ompRp1,0.08333333333333333,11,11,AAGCTAATTTCGTACCTACT,0,2795110
ompRp1,0.08333333333333333,11,11,AAGCATGAGTTCTAGGGACC,0,2798529
ompRp1,0.08333333333333333,11,11,AAGATTCCCACTGACCTGCG,0,2799337
ompRp1,0.08333333333333333,11,11,AAGACGGAATTATCCCTGCT,0,2779300
ompRp1,0.08333333333333333,11,11,AACTTATGGCGGTGATCGTG,0,2774134
ompRp1,0.08333333333333333,11,11,AACCGCTACGACGCAGTGTC,0,2778778
ompRp1,0.08333333333333333,11,11,AACATTAGAACCCGAGAGAG,0,2799081
ompRp1,0.08333333333333333,11,11,AACAGCAGAGTCTAACACAG,0,2775811
ompRp1,0.08333333333333333,11,11,AACACCGAGCTATTCTGATC,0,2780322
ompRp1,0.08333333333333333,11,11,AAATTGATGATTTTTCTCTT,0,2796804
ompRp1,0.08333333333333333,11,11,AAATGTCTACCACCAGTGAC,0,2799370
ompRp1,0.08333333333333333,11,11,AAATCCGCGGAGGCTTTCGA,0,2790840
ompRp1,0.08333333333333333,11,11,AAAGTTTCATAAGTGACACT,0,2813931
ompRp1,0.08333333333333333,11,11,AAAGCTCAATGACATTCCTG,0,2791993
ompRp1,0.08333333333333333,11,11,AAACGCACCAGGAAACCCAG,0,2795721
ompRp1,0.08333333333333333,11,11,AAAAGTTAGGAGCCAGGTAT,0,2777709
ompRp1,0.09090909090909091,10,10,TTTTTCTCAATTGGCGCGGA,0,2794572
ompRp1,0.09090909090909091,10,10,TTTTGATAAACTCTTCCCAT,0,2818786
ompRp1,0.09090909090909091,10,10,TTTTGAAAGGCACGGCCTAG,0,2767601
ompRp1,0.09090909090909091,10,10,TTTTCCCGGGGACATGTGCG,0,2779730
ompRp1,0.09090909090909091,10,10,TTTTCAGAAAGGGGAGTCTA,0,2814508
ompRp1,0.09090909090909091,10,10,TTTTAACGCTTTTTTTACTT,0,2787115
ompRp1,0.09090909090909091,10,10,TTTGATTACTCACGGATTTA,0,2772067
ompRp1,0.09090909090909091,10,10,TTTCGTGCGGGAGCGGCTGT,0,2798728
ompRp1,0.09090909090909091,10,10,TTGCACCGGTGTAAACCTGG,0,2786991
ompRp1,0.09090909090909091,10,10,TTGATAATGGCCTCGAGTTA,0,2812691
ompRp1,0.09090909090909091,10,10,TTGAGTGTACGACTTAACCT,0,2803053
ompRp1,0.09090909090909091,10,10,TTGAACAGTGATTCCCGAGA,0,2773183
ompRp1,0.09090909090909091,10,10,TTCTCCGGGGCGCATACGTT,0,2820604
ompRp1,0.09090909090909091,10,10,TTCTAATTCACAGTCACTAT,0,2820209
ompRp1,0.09090909090909091,10,10,TTCGCAGTGGACAGCTCCGT,0,2784682
ompRp1,0.09090909090909091,10,10,TTCCAGCAGTAATGCTGTGG,0,2787032
ompRp1,0.09090909090909091,10,10,TTCACCCTTTAAGTTGCTTA,0,2821217
ompRp1,0.09090909090909091,10,10,TTATATGTGACGGTGTCAAC,0,2783693
ompRp1,0.09090909090909091,10,10,TTACGTCGGGGTGGTCGTGT,0,2768664
ompRp1,0.09090909090909091,10,10,TTAAATGGGTTGGGGCACGA,0,2789655
ompRp1,0.09090909090909091,10,10,TGTCGCGGATCACAGTATGT,0,2772887
ompRp1,0.09090909090909091,10,10,TGTCCACTATACCAAGTTAA,0,2775737
ompRp1,0.09090909090909091,10,10,TGGGCATCCGGGGCCAAACC,0,2792785
ompRp1,0.09090909090909091,10,10,TGGGAGTCAGGTCCAAGATC,0,2821293
ompRp1,0.09090909090909091,10,10,TGGCCCTTTGATGTGAGAAA,0,2765984
ompRp1,0.09090909090909091,10,10,TGGCAAGACTATGTTCACGC,0,2806481
ompRp1,0.09090909090909091,10,10,TGGAGGTTGTTATGGGCGCA,0,2809735
ompRp1,0.09090909090909091,10,10,TGGACATGTAAGACATAACC,0,2823452
ompRp1,0.09090909090909091,10,10,TGCTCACCTGTTGTCCAGGA,0,2772255
ompRp1,0.09090909090909091,10,10,TGCGTACTGAGATGATTGAG,0,2769521
ompRp1,0.09090909090909091,10,10,TGCGGGCGTTGGTGACGTAC,0,2811531
ompRp1,0.09090909090909091,10,10,TGCGACTATGCAAAGCAGGT,0,2797979
ompRp1,0.09090909090909091,10,10,TGCCGGGCATTTAGTTCCTG,0,2810312
ompRp1,0.09090909090909091,10,10,TGCCCAAGTTCTACTCCTCA,0,2788845
ompRp1,0.09090909090909091,10,10,TGCCAATAGACCATGGTTTA,0,2801579
ompRp1,0.09090909090909091,10,10,TGATGATGGAAGTAACGAAA,0,2771550
ompRp1,0.09090909090909091,10,10,TGAGGTTGCACGTCTGTAGT,0,2771803
ompRp1,0.09090909090909091,10,10,TGAGACTGGCGAGCTGCCAC,0,2770102
ompRp1,0.09090909090909091,10,10,TGAATGTGTACGGTCAGAGA,0,2775926
ompRp1,0.09090909090909091,10,10,TCTTGGCGCAGCGAGGGCCA,0,2809832
ompRp1,0.09090909090909091,10,10,TCTTGCTGGAGGGCACGCAG,0,2809024
ompRp1,0.09090909090909091,10,10,TCTTGAGGCCCGGATAAATG,0,2813304
ompRp1,0.09090909090909091,10,10,TCTTCGGTTCTGTCATGCGC,0,2792483
ompRp1,0.09090909090909091,10,10,TCTTCGGTGGCCACCGTGAT,0,2788183
ompRp1,0.09090909090909091,10,10,TCTTCAGCCGGGCAGAATGG,0,2820766
ompRp1,0.09090909090909091,10,10,TCTGGGTGCGAACGGAAGTT,0,2766683
ompRp1,0.09090909090909091,10,10,TCTCGGCGGCTTGACCTTTT,0,2823485
ompRp1,0.09090909090909091,10,10,TCTACATATGGCCCTGCAGC,0,2788319
ompRp1,0.09090909090909091,10,10,TCGGGTTTTAAAGTGCACAG,0,2781397
ompRp1,0.09090909090909091,10,10,TCGGAGCAACACGGGGGGCT,0,2819152
ompRp1,0.09090909090909091,10,10,TCGCTTCCCGCGAGGCGCAT,0,2774941
ompRp1,0.09090909090909091,10,10,TCGAGCCAAGTATATTTACT,0,2804663
ompRp1,0.09090909090909091,10,10,TCGACCTCAATCTGGACTAA,0,2815736
ompRp1,0.09090909090909091,10,10,TCCTTTTTGCTAGGTGCGAA,0,2800976
ompRp1,0.09090909090909091,10,10,TCCTTCATATCAGAAGCCCC,0,2788779
ompRp1,0.09090909090909091,10,10,TCCTCGAGAGTAGTTTAGCT,0,2772947
ompRp1,0.09090909090909091,10,10,TCCGGTACCATCAAAATGGA,0,2817960
ompRp1,0.09090909090909091,10,10,TCCGAGCTTAGCGGATCTCA,0,2775569
ompRp1,0.09090909090909091,10,10,TCCCTCCGGGTCAGTATGTA,0,2790723
ompRp1,0.09090909090909091,10,10,TCCCGGGACTGAGTGCGTAC,0,2775584
ompRp1,0.09090909090909091,10,10,TCCCGAGCATTAATCGAGGA,0,2767692
ompRp1,0.09090909090909091,10,10,TCCAGTCGAGAGTCAAGGTG,0,2770467
ompRp1,0.09090909090909091,10,10,TCATTCGAGTGACTTTAGCT,0,2773295
ompRp1,0.09090909090909091,10,10,TCATGCTCGTTCGTATCGTA,0,2784940
ompRp1,0.09090909090909091,10,10,TCATACCGTGCCGGTCGCAT,0,2768420
ompRp1,0.09090909090909091,10,10,TCATAATTCCTCGCAGACTA,0,2776211
ompRp1,0.09090909090909091,10,10,TCAGTATGGATAACACGGAT,0,2813408
ompRp1,0.09090909090909091,10,10,TCAGAGTACCAAGATGGACC,0,2801330
ompRp1,0.09090909090909091,10,10,TCACTTGCGGCGAACATTTT,0,2768436
ompRp1,0.09090909090909091,10,10,TCACTGGCTTCCCATCGCAA,0,2766775
ompRp1,0.09090909090909091,10,10,TCACGGTTTAATTAGCCTCA,0,2770635
ompRp1,0.09090909090909091,10,10,TCACCTGTGGACCAAATGTA,0,2779613
ompRp1,0.09090909090909091,10,10,TCACAGGGATGACAGCTCCG,0,2790488
ompRp1,0.09090909090909091,10,10,TCAACCTTAGAAACTTATCA,0,2810449
ompRp1,0.09090909090909091,10,10,TATCTTTACTTGGGGTGTAT,0,2820182
ompRp1,0.09090909090909091,10,10,TATACCTACCCTCCTTCTCA,0,2814400
ompRp1,0.09090909090909091,10,10,TAGGTCGGCAGACTCAGGGT,0,2809527
ompRp1,0.09090909090909091,10,10,TAGGCGGCCTGGATTTGCTT,0,2808343
ompRp1,0.09090909090909091,10,10,TAGCAATTGCTTATTAGGGC,0,2771882
ompRp1,0.09090909090909091,10,10,TAGAAGTGGTCCAAAAAGGG,0,2811285
ompRp1,0.09090909090909091,10,10,TAGAACGACGGAGACATTGA,0,2782893
ompRp1,0.09090909090909091,10,10,TACGTGATCCATTACATCTC,0,2804089
ompRp1,0.09090909090909091,10,10,TACCACATATTGGGTTCCTG,0,2803307
ompRp1,0.09090909090909091,10,10,TACAGGCACTAAGGAAAATT,0,2778257
ompRp1,0.09090909090909091,10,10,TACACGTCCGCAGCGGGTAC,0,2781484
ompRp1,0.09090909090909091,10,10,TAATGAGCCACGGCTGGTGT,0,2808575
ompRp1,0.09090909090909091,10,10,TAAGTATTAATCTATCTCGG,0,2803384
ompRp1,0.09090909090909091,10,10,TAAGCTCCCTCGAGCAGCCA,0,2819446
ompRp1,0.09090909090909091,10,10,TAACGTACGAGGCGCCAATT,0,2773788
ompRp1,0.09090909090909091,10,10,TAACGCATTGTAACCTTGCT,0,2804414
ompRp1,0.09090909090909091,10,10,TAAACAGACGTAAGGAGAGT,0,2817911
ompRp1,0.09090909090909091,10,10,GTTTCAATAATGACCGGGCT,0,2798099
ompRp1,0.09090909090909091,10,10,GTTTAAGAGAAGTGGCCAGA,0,2765556
ompRp1,0.09090909090909091,10,10,GTTGAGAGACAAGTGCCTAA,0,2811892
ompRp1,0.09090909090909091,10,10,GTTCGCATCATGGCATCGAG,0,2800318
ompRp1,0.09090909090909091,10,10,GTTCATAAAAGCTTTCCGTA,0,2791774
ompRp1,0.09090909090909091,10,10,GTTATGGTCTTTTTTCAGAC,0,2805237
ompRp1,0.09090909090909091,10,10,GTGTCGCTCCCCACAAAATA,0,2792081
ompRp1,0.09090909090909091,10,10,GTGTCATGTTAACGCCCATA,0,2783400
ompRp1,0.09090909090909091,10,10,GTGTCACCTCCTTTGATTGG,0,2811860
ompRp1,0.09090909090909091,10,10,GTGGGCACTCGGGTGCACGG,0,2805620
ompRp1,0.09090909090909091,10,10,GTCTTTAAGCGGTAAATGCA,0,2810359
ompRp1,0.09090909090909091,10,10,GTCGTGGTATTCCCATAAGC,0,2795479
ompRp1,0.09090909090909091,10,10,GTCGGATGTTCCGTGAGCCT,0,2821466
ompRp1,0.09090909090909091,10,10,GTCCACGTGTGTAAGTACTG,0,2798984
ompRp1,0.09090909090909091,10,10,GTCAATCAGGTGGATAGGCT,0,2789989
ompRp1,0.09090909090909091,10,10,GTATCGTTTACGGCAACCAA,0,2820663
ompRp1,0.09090909090909091,10,10,GTAGGTACTTAATGGAACAA,0,2790818
ompRp1,0.09090909090909091,10,10,GTAGGCCCCCTGTAAAGAGG,0,2793781
ompRp1,0.09090909090909091,10,10,GTAGACCATTGATTCCCCAT,0,2814787
ompRp1,0.09090909090909091,10,10,GTACTTTCGAAAGATCCTAG,0,2823891
ompRp1,0.09090909090909091,10,10,GTACTTAGTTCCAAGTAGTC,0,2821513
ompRp1,0.09090909090909091,10,10,GTACACCTGGTAATTACTCA,0,2799638
ompRp1,0.09090909090909091,10,10,GTAAGGACTCAATTATATTG,0,2794898
ompRp1,0.09090909090909091,10,10,GTAACCAGGCCGGTGGGAGA,0,2808542
ompRp1,0.09090909090909091,10,10,GGTTGGGGGTGCGAGCGTTT,0,2768376
ompRp1,0.09090909090909091,10,10,GGTTGCCAGCCTAGCGTTCT,0,2806360
ompRp1,0.09090909090909091,10,10,GGTTATCCTGGGTCATATCT,0,2796323
ompRp1,0.09090909090909091,10,10,GGTTACTCTTCAGTTAACGA,0,2824193
ompRp1,0.09090909090909091,10,10,GGTGGCTTGTTCCGGGGGTA,0,2767007
ompRp1,0.09090909090909091,10,10,GGTCTCGGACAATGTCTGAA,0,2819580
ompRp1,0.09090909090909091,10,10,GGTCGGCTAGATCACGGGCT,0,2777303
ompRp1,0.09090909090909091,10,10,GGTCGATTGTAAAGCCGACT,0,2770852
ompRp1,0.09090909090909091,10,10,GGTCGAATTTGCTTGGGGAG,0,2819627
ompRp1,0.09090909090909091,10,10,GGTCAAAACCGACGTGCATC,0,2797022
ompRp1,0.09090909090909091,10,10,GGTATTGCGCGGACGATCCA,0,2787025
ompRp1,0.09090909090909091,10,10,GGTATTACATCGAGCCGGAC,0,2805234
ompRp1,0.09090909090909091,10,10,GGTAGACTCGACACTCACAG,0,2816562
ompRp1,0.09090909090909091,10,10,GGGGTCCCTAATGGAACTTT,0,2811762
ompRp1,0.09090909090909091,10,10,GGGGATAGCCAGAGCCTTAA,0,2769783
ompRp1,0.09090909090909091,10,10,GGGGAGGGCAACAAGTGAAC,0,2792925
ompRp1,0.09090909090909091,10,10,GGGGACTCATCCGAGATCTC,0,2801020
ompRp1,0.09090909090909091,10,10,GGGCGTTCGTGCTACCAATA,0,2804421
ompRp1,0.09090909090909091,10,10,GGGCGGGTATTCGGTCTCCT,0,2766672
ompRp1,0.09090909090909091,10,10,GGGCCACACTCTATAATCAA,0,2775806
ompRp1,0.09090909090909091,10,10,GGGATACATAATGTGAACAA,0,2778306
ompRp1,0.09090909090909091,10,10,GGGACGTCTAGATTCCCTTG,0,2790432
ompRp1,0.09090909090909091,10,10,GGGACAATGCCACGCATCTA,0,2806639
ompRp1,0.09090909090909091,10,10,GGGAATGCTTCGGTACCCAT,0,2779021
ompRp1,0.09090909090909091,10,10,GGGAAGCAAAATTTACTCGC,0,2797554
ompRp1,0.09090909090909091,10,10,GGCTTCTTGTTTGTCCCTGG,0,2789686
ompRp1,0.09090909090909091,10,10,GGCGATGAACCTACAAGTTT,0,2804730
ompRp1,0.09090909090909091,10,10,GGCCAACTCATGTATTGTGC,0,2784889
ompRp1,0.09090909090909091,10,10,GGCCAAAGGGTTCCCTAAGG,0,2774344
ompRp1,0.09090909090909091,10,10,GGCAGGCCCGATATTCGAAT,0,2810030
ompRp1,0.09090909090909091,10,10,GGATTCTTGGGTCTGTATTG,0,2804909
ompRp1,0.09090909090909091,10,10,GGAGCATCACGGTAGGTCCA,0,2791869
ompRp1,0.09090909090909091,10,10,GGACTTCAATGGGGACCTTA,0,2786611
ompRp1,0.09090909090909091,10,10,GGACTGCTTGGGGCTGGGCT,0,2775376
ompRp1,0.09090909090909091,10,10,GGACTGAGCGGTTGTACTCT,0,2793438
ompRp1,0.09090909090909091,10,10,GGACCCAAACCGCTAGAATG,0,2804999
ompRp1,0.09090909090909091,10,10,GGAATTACGGATCGAAGCGC,0,2783777
ompRp1,0.09090909090909091,10,10,GGAATAGCGTGCATTCAGCA,0,2815957
ompRp1,0.09090909090909091,10,10,GGAAAATCGCTGATACACTG,0,2811414
ompRp1,0.09090909090909091,10,10,GCTTTTTTACTTAGGACCGT,0,2824288
ompRp1,0.09090909090909091,10,10,GCTGAGGATTATTTTCAATC,0,2805031
ompRp1,0.09090909090909091,10,10,GCTGAAAGAAGTGTTGCGAC,0,2793657
ompRp1,0.09090909090909091,10,10,GCTCTACAGCTTGAAATACA,0,2810624
ompRp1,0.09090909090909091,10,10,GCTCGCGACATCATTACTGG,0,2791698
ompRp1,0.09090909090909091,10,10,GCTATAGGGCTACAGACAAA,0,2774499
ompRp1,0.09090909090909091,10,10,GCTATACGGTGTGTCGCATT,0,2794108
ompRp1,0.09090909090909091,10,10,GCTAGTCTGTGACCAACCAA,0,2794181
ompRp1,0.09090909090909091,10,10,GCGTGTTAGGGCCATTACCC,0,2794290
ompRp1,0.09090909090909091,10,10,GCGGTGCTAGTATACTTGGG,0,2800860
ompRp1,0.09090909090909091,10,10,GCGGGTCGTTACGCCGTTAG,0,2819887
ompRp1,0.09090909090909091,10,10,GCGGGGCCCGTACCATCGAT,0,2791477
ompRp1,0.09090909090909091,10,10,GCGGCTGTCACCATTGCACT,0,2777490
ompRp1,0.09090909090909091,10,10,GCGATCGGCACCGCTTTTAG,0,2807907
ompRp1,0.09090909090909091,10,10,GCGAGTACTTGGTAGATCAC,0,2793017
ompRp1,0.09090909090909091,10,10,GCGACCAATCACTCAGCTTC,0,2810971
ompRp1,0.09090909090909091,10,10,GCCTTGTTAACAGTGACTTC,0,2810591
ompRp1,0.09090909090909091,10,10,GCCTCTACGGCCGGGTAATT,0,2804548
ompRp1,0.09090909090909091,10,10,GCCTATCCGATTACTTCGTT,0,2789409
ompRp1,0.09090909090909091,10,10,GCCGCTACCGTGATGAATTG,0,2819312
ompRp1,0.09090909090909091,10,10,GCATTTTCATGAATTCGGCG,0,2809008
ompRp1,0.09090909090909091,10,10,GCATGTTAGACTAAGGCGGG,0,2802538
ompRp1,0.09090909090909091,10,10,GCATAAGTTCTGCCGCGTCA,0,2789387
ompRp1,0.09090909090909091,10,10,GCAGGTAGTGGAGGACAGCG,0,2775810
ompRp1,0.09090909090909091,10,10,GCAGACCGCCGTACAAATTG,0,2787423
ompRp1,0.09090909090909091,10,10,GCACTAAGCGTACCGCCTCA,0,2775789
ompRp1,0.09090909090909091,10,10,GCAACAGTTTCATGTAATAG,0,2782092
ompRp1,0.09090909090909091,10,10,GCAACAGCACCAGTACGTCA,0,2789558
ompRp1,0.09090909090909091,10,10,GCAAAGGCGTGTTATCCAAT,0,2767375
ompRp1,0.09090909090909091,10,10,GCAAACGCCGCCACTCTCGA,0,2777018
ompRp1,0.09090909090909091,10,10,GATTGGATTTAATGTTGGTG,0,2776778
ompRp1,0.09090909090909091,10,10,GATTGCCCCGTGACTCACCA,0,2785020
ompRp1,0.09090909090909091,10,10,GATGAAACGTACTAAAACCT,0,2792286
ompRp1,0.09090909090909091,10,10,GATCGGATAGACCTTATGAT,0,2783018
ompRp1,0.09090909090909091,10,10,GATCATAGGCTGTTGACGAA,0,2772158
ompRp1,0.09090909090909091,10,10,GAGTCTCGCTTTAGAGCATG,0,2818771
ompRp1,0.09090909090909091,10,10,GAGTCGGAGGTATGATGCTA,0,2784293
ompRp1,0.09090909090909091,10,10,GAGTCCCTGTGTAGCATAGG,0,2781729
ompRp1,0.09090909090909091,10,10,GAGTCCACTATATGCCAACT,0,2766186
ompRp1,0.09090909090909091,10,10,GAGGGCGATGCTTGCACGCA,0,2776118
ompRp1,0.09090909090909091,10,10,GACGGGGTCTCCAGATCTAT,0,2815892
ompRp1,0.09090909090909091,10,10,GACGCAGCGAAGAAGCGGGA,0,2767624
ompRp1,0.09090909090909091,10,10,GACAGGTCCCCTTCAGACAG,0,2798596
ompRp1,0.09090909090909091,10,10,GACACCGCGGCCCGAAGTAC,0,2802413
ompRp1,0.09090909090909091,10,10,GAATATCACCCTGGGATAGA,0,2765390
ompRp1,0.09090909090909091,10,10,GAATAGCGGAAAAAAATGAT,0,2774803
ompRp1,0.09090909090909091,10,10,GAAGTGACACGTCGTGCCAG,0,2767758
ompRp1,0.09090909090909091,10,10,GAAGCTACCGCACGCAAAAT,0,2796338
ompRp1,0.09090909090909091,10,10,GAAATAGACTAGCGTAGGAT,0,2824305
ompRp1,0.09090909090909091,10,10,GAAATAATGGCTTCCCAACC,0,2807383
ompRp1,0.09090909090909091,10,10,GAAACCGTTCACCTCTGTCC,0,2814074
ompRp1,0.09090909090909091,10,10,GAAAACCCTCGGTCCAGAAT,0,2777313
ompRp1,0.09090909090909091,10,10,CTTTCTAGAGTGCTTTTTAT,0,2792811
ompRp1,0.09090909090909091,10,10,CTTTAATCCCCACCGTTAGC,0,2794802
ompRp1,0.09090909090909091,10,10,CTTGTTGGTACGCCCGCGGA,0,2786757
ompRp1,0.09090909090909091,10,10,CTTGCCGCAACTGTTGTCGT,0,2784160
ompRp1,0.09090909090909091,10,10,CTTCTATTTCCGCGGGGGAG,0,2775278
ompRp1,0.09090909090909091,10,10,CTTCGACGCGTCACGATGGC,0,2806273
ompRp1,0.09090909090909091,10,10,CTTAGAACCACCGACGGCGC,0,2771249
ompRp1,0.09090909090909091,10,10,CTTACTGAACGGCCGAAGAT,0,2816554
ompRp1,0.09090909090909091,10,10,CTGTCTCGTGGTTCTACGTC,0,2798531
ompRp1,0.09090909090909091,10,10,CTGGCTTCGAAACTGTCGGC,0,2812538
ompRp1,0.09090909090909091,10,10,CTGATGGGTTCTTCGGCCCT,0,2785640
ompRp1,0.09090909090909091,10,10,CTCGAGTTTATGAGTCAGTA,0,2798031
ompRp1,0.09090909090909091,10,10,CTCCACATCATGTCGCCAAT,0,2819220
ompRp1,0.09090909090909091,10,10,CTATTTATCCTTCCAGCGCG,0,2814892
ompRp1,0.09090909090909091,10,10,CTAGTTCATTAAGATCGAAA,0,2822494
ompRp1,0.09090909090909091,10,10,CTAGGTGGACAGGTGCTGCT,0,2778588
ompRp1,0.09090909090909091,10,10,CTACGGGAAGCTGCGTCATG,0,2781824
ompRp1,0.09090909090909091,10,10,CTACCAATCAACTACCCCCG,0,2813194
ompRp1,0.09090909090909091,10,10,CTACATTCAATAGTCTGGCT,0,2801273
ompRp1,0.09090909090909091,10,10,CTAATCGAAAGCAAACTTGG,0,2805119
ompRp1,0.09090909090909091,10,10,CTAATACCTTAAGTGCTATC,0,2789684
ompRp1,0.09090909090909091,10,10,CTAACTTCTCTCCCGTAAAA,0,2804338
ompRp1,0.09090909090909091,10,10,CGTTAAGTAACGGCCGACTG,0,2779751
ompRp1,0.09090909090909091,10,10,CGTCCATATCCGGCTTACTA,0,2812946
ompRp1,0.09090909090909091,10,10,CGTCCAGCCACGGAACGAAC,0,2769482
ompRp1,0.09090909090909091,10,10,CGTATAACGTGACTCGTCAC,0,2780887
ompRp1,0.09090909090909091,10,10,CGGTTTTTGGCCGAGCCCTC,0,2769218
ompRp1,0.09090909090909091,10,10,CGGTTATATGCTCGAGGTTT,0,2799896
ompRp1,0.09090909090909091,10,10,CGGTGCTGCAAGCGCTGAGT,0,2823716
ompRp1,0.09090909090909091,10,10,CGGTAAGCGGGTGAGACCTG,0,2814702
ompRp1,0.09090909090909091,10,10,CGGTAAGAGGACAGATGGGG,0,2778622
ompRp1,0.09090909090909091,10,10,CGGGTGTTTTACCTGTTGTT,0,2792074
ompRp1,0.09090909090909091,10,10,CGGGGACAGAACTCCTAGCT,0,2782517
ompRp1,0.09090909090909091,10,10,CGGGCGTTAGCAGGTTTCTC,0,2769870
ompRp1,0.09090909090909091,10,10,CGGGATGATGCAATCGGCTG,0,2775249
ompRp1,0.09090909090909091,10,10,CGGCTCAATTGAGAGTCAGT,0,2798168
ompRp1,0.09090909090909091,10,10,CGGCCTTCGTGAGGGGTGAA,0,2778244
ompRp1,0.09090909090909091,10,10,CGGCCAATACCACCTAGAAG,0,2808195
ompRp1,0.09090909090909091,10,10,CGGAGGGTTCGTAGCTCAGA,0,2812434
ompRp1,0.09090909090909091,10,10,CGGAGAGGCTAAACGAATTA,0,2814567
ompRp1,0.09090909090909091,10,10,CGCTTCGTCGTAGGTGTTAG,0,2777891
ompRp1,0.09090909090909091,10,10,CGCTAACGGGGACACCAGAA,0,2779888
ompRp1,0.09090909090909091,10,10,CGCGGGGCGTTTGTGGGTAT,0,2765318
ompRp1,0.09090909090909091,10,10,CGCGAGCAGATCTATGTCCA,0,2801443
ompRp1,0.09090909090909091,10,10,CGCCGACCCCGGGACAAGAA,0,2774909
ompRp1,0.09090909090909091,10,10,CGCCAGCCTTGTGAGGACAC,0,2819873
ompRp1,0.09090909090909091,10,10,CGCATTCGTCAAGTGATTAG,0,2771843
ompRp1,0.09090909090909091,10,10,CGATTCTCATGCCGCTGGCT,0,2778707
ompRp1,0.09090909090909091,10,10,CGATAGCCCCAGATTCCGTA,0,2815682
ompRp1,0.09090909090909091,10,10,CGAGTTCGTGCGATCCGCTC,0,2784292
ompRp1,0.09090909090909091,10,10,CGAGTGGCTCCGGCGGATAA,0,2778113
ompRp1,0.09090909090909091,10,10,CGAGCTAGGTATTACTATTG,0,2794036
ompRp1,0.09090909090909091,10,10,CGAGCCCGGGGTTTAGAAGT,0,2794398
ompRp1,0.09090909090909091,10,10,CGACACGAAGAGGCCTTGAT,0,2765317
ompRp1,0.09090909090909091,10,10,CGAAGATCGAGACGTTCGCG,0,2798743
ompRp1,0.09090909090909091,10,10,CGAAATGGCTGTCGTAAACC,0,2790816
ompRp1,0.09090909090909091,10,10,CCTTATGCTGGAGCCAAGAC,0,2795201
ompRp1,0.09090909090909091,10,10,CCTTACTTTCCGATTCATCA,0,2805495
ompRp1,0.09090909090909091,10,10,CCTGATCACTGATGAAAAGT,0,2791741
ompRp1,0.09090909090909091,10,10,CCTGACGGGACGGGAAATTC,0,2798873
ompRp1,0.09090909090909091,10,10,CCTCTCTAGTATTTTCAGAC,0,2807135
ompRp1,0.09090909090909091,10,10,CCTCTCAAGACACCCCTACA,0,2816174
ompRp1,0.09090909090909091,10,10,CCTCGGATGGCATCCGACGA,0,2775271
ompRp1,0.09090909090909091,10,10,CCTATCAAAGCTGGGTACAA,0,2768786
ompRp1,0.09090909090909091,10,10,CCTAGTCGCTGAATACGGTT,0,2813315
ompRp1,0.09090909090909091,10,10,CCGTTCAATTATGCGAAGTG,0,2795924
ompRp1,0.09090909090909091,10,10,CCGTGTGCCGTTCCAGTCGT,0,2800562
ompRp1,0.09090909090909091,10,10,CCGGCACAATCCATCTCAGT,0,2775143
ompRp1,0.09090909090909091,10,10,CCGCAAACACTTTTGGGGGG,0,2789629
ompRp1,0.09090909090909091,10,10,CCGAGGGAACGTCCGGTGAG,0,2798532
ompRp1,0.09090909090909091,10,10,CCGAGCTATGGTTGCCCGTG,0,2818459
ompRp1,0.09090909090909091,10,10,CCCTGTCGGGATTAGGCGCG,0,2817957
ompRp1,0.09090909090909091,10,10,CCCTGAAGCGGGTTTATGGG,0,2791263
ompRp1,0.09090909090909091,10,10,CCCGATTGTAACCTATGATC,0,2812825
ompRp1,0.09090909090909091,10,10,CCCCTATCCCGTGAGGGAAT,0,2768594
ompRp1,0.09090909090909091,10,10,CCCCGCATGCTGTATCGGAC,0,2789881
ompRp1,0.09090909090909091,10,10,CCCCGACTGATCATAGGCTG,0,2766150
ompRp1,0.09090909090909091,10,10,CCCCATAATGTATCGTGAGT,0,2794099
ompRp1,0.09090909090909091,10,10,CCCCAGGTGTGAAGGAGACG,0,2775762
ompRp1,0.09090909090909091,10,10,CCCATTTTAGAATGCCCTCT,0,2779978
ompRp1,0.09090909090909091,10,10,CCAGTATAAGAGAGAGCCTG,0,2799943
ompRp1,0.09090909090909091,10,10,CCAGGCCAGATGATCATCCT,0,2800818
ompRp1,0.09090909090909091,10,10,CCACGCCGTTAGTGACAATT,0,2791510
ompRp1,0.09090909090909091,10,10,CCACCTCTATGTTTATATCA,0,2782249
ompRp1,0.09090909090909091,10,10,CCAAGGGTGCTCCTTATGAC,0,2790785
ompRp1,0.09090909090909091,10,10,CATTATCAACATCACGCTCA,0,2800979
ompRp1,0.09090909090909091,10,10,CATGTATACATATGGGGCAA,0,2804635
ompRp1,0.09090909090909091,10,10,CATAGATCAGTCCTTTCGAT,0,2769676
ompRp1,0.09090909090909091,10,10,CAGTTCTGGCGAAGTGATTC,0,2813088
ompRp1,0.09090909090909091,10,10,CAGTACAAGACTGCGTTTTA,0,2786651
ompRp1,0.09090909090909091,10,10,CAGGTGTTAACGGTAAGTGC,0,2821469
ompRp1,0.09090909090909091,10,10,CAGGGTCACCTGCTACTTCC,0,2765345
ompRp1,0.09090909090909091,10,10,CAGGAGACTGATGCTATACA,0,2808998
ompRp1,0.09090909090909091,10,10,CAGGACAATTGCAACAGAGT,0,2770536
ompRp1,0.09090909090909091,10,10,CAGCACCCTGTCACTATGGA,0,2797539
ompRp1,0.09090909090909091,10,10,CACTTGTGCTTTTTCGTCAA,0,2789380
ompRp1,0.09090909090909091,10,10,CACGCGCTGCACGATGCTTT,0,2766197
ompRp1,0.09090909090909091,10,10,CACGAAATGGGACTCATCTC,0,2818343
ompRp1,0.09090909090909091,10,10,CACCTCACTCCACAAGGGTT,0,2785684
ompRp1,0.09090909090909091,10,10,CACCCGTTGTAGGGCGCAAC,0,2820694
ompRp1,0.09090909090909091,10,10,CACATAGAGGTAAACCCCAC,0,2794197
ompRp1,0.09090909090909091,10,10,CACAGCCCATTGAGGATGCT,0,2798936
ompRp1,0.09090909090909091,10,10,CACAGAAGCCGCCGAAAAAA,0,2823377
ompRp1,0.09090909090909091,10,10,CAATTACGTTTATCGACAAA,0,2769112
ompRp1,0.09090909090909091,10,10,CAATGCCAGGTACCGATTCA,0,2768505
ompRp1,0.09090909090909091,10,10,CAAGTGATGGCGTGCCACAA,0,2812721
ompRp1,0.09090909090909091,10,10,CAAGGACTCTGTTTAACCAA,0,2781522
ompRp1,0.09090909090909091,10,10,CAACCCACCTTAGAATGCTA,0,2769076
ompRp1,0.09090909090909091,10,10,CAAATGTAAGGCTCGTTTCA,0,2775813
ompRp1,0.09090909090909091,10,10,ATTTTCGAATGTATGGCGGA,0,2787177
ompRp1,0.09090909090909091,10,10,ATTTCACAAATCACCGCTCA,0,2794459
ompRp1,0.09090909090909091,10,10,ATTTATATCCATAGACTGTA,0,2817085
ompRp1,0.09090909090909091,10,10,ATTGGAATGGCGGCACCGGC,0,2813086
ompRp1,0.09090909090909091,10,10,ATTGATAGGGCAACCGCGGA,0,2795062
ompRp1,0.09090909090909091,10,10,ATTCGGAGGAATACTGGTTT,0,2783016
ompRp1,0.09090909090909091,10,10,ATTCCCGACAATAGAGTAAT,0,2786802
ompRp1,0.09090909090909091,10,10,ATTACCACAACGTTCTTCTC,0,2824782
ompRp1,0.09090909090909091,10,10,ATGTAGACGATGCCCACAAT,0,2786011
ompRp1,0.09090909090909091,10,10,ATGGTGTGATCGAATTCCAT,0,2817031
ompRp1,0.09090909090909091,10,10,ATGCTAGTCGAAATATAACT,0,2822308
ompRp1,0.09090909090909091,10,10,ATGCGGACTGTCGTGAACGC,0,2779022
ompRp1,0.09090909090909091,10,10,ATGCGCTTTCGCAGATCATT,0,2779677
ompRp1,0.09090909090909091,10,10,ATGAGGGAGCAGTTTGGCTG,0,2789924
ompRp1,0.09090909090909091,10,10,ATGACTTTTGTAAATAGCTA,0,2776535
ompRp1,0.09090909090909091,10,10,ATCTTTGATGTATAGAGGGG,0,2795167
ompRp1,0.09090909090909091,10,10,ATCTCTCATCGCCGCTTCTA,0,2770275
ompRp1,0.09090909090909091,10,10,ATCTCACTACACTTGGGGCG,0,2796610
ompRp1,0.09090909090909091,10,10,ATCGTCGTCACCTTTGGTCA,0,2810200
ompRp1,0.09090909090909091,10,10,ATCGGACGTTAGCTCCCGTC,0,2790983
ompRp1,0.09090909090909091,10,10,ATCCTCGATCCTCTAGCACA,0,2807807
ompRp1,0.09090909090909091,10,10,ATCCGGAAGGTCTAGGTTCA,0,2794282
ompRp1,0.09090909090909091,10,10,ATATCATAGCTCCCCGTCGG,0,2795913
ompRp1,0.09090909090909091,10,10,ATATATTGCCGGTATAGGTA,0,2819416
ompRp1,0.09090909090909091,10,10,ATACTCGGTTGCAGTTATTA,0,2784112
ompRp1,0.09090909090909091,10,10,ATAACTACACATGTGTGACT,0,2768199
ompRp1,0.09090909090909091,10,10,AGTTTAGGTAGGGACTCATA,0,2782576
ompRp1,0.09090909090909091,10,10,AGTTACAGTAGTCTGCCTGT,0,2802482
ompRp1,0.09090909090909091,10,10,AGTGTCCATCTCACCCTCAA,0,2767994
ompRp1,0.09090909090909091,10,10,AGTGGTGTTGCCTCGATGAA,0,2772272
ompRp1,0.09090909090909091,10,10,AGTGGCCAGGGAAACTGGAA,0,2771849
ompRp1,0.09090909090909091,10,10,AGTCAAAAGTTAGTTAGGAA,0,2766347
ompRp1,0.09090909090909091,10,10,AGTAAAGAGTACGAGCAAGT,0,2819429
ompRp1,0.09090909090909091,10,10,AGGTTTCGCTCGCGGTGGGA,0,2793028
ompRp1,0.09090909090909091,10,10,AGGTGAGGGGTGTAGCGGTC,0,2779744
ompRp1,0.09090909090909091,10,10,AGGTGAAATGCGTCGAAGTA,0,2794522
ompRp1,0.09090909090909091,10,10,AGGTCTATTGAGCCATCACT,0,2773141
ompRp1,0.09090909090909091,10,10,AGGTCGTTTTCGACACCAAG,0,2808726
ompRp1,0.09090909090909091,10,10,AGGGTTGAATGGTTACCAAT,0,2785794
ompRp1,0.09090909090909091,10,10,AGGGTAGATGTTCGCACTTT,0,2816681
ompRp1,0.09090909090909091,10,10,AGGGCGCATCGGCTAAAGTC,0,2780053
ompRp1,0.09090909090909091,10,10,AGCGCTGCCCGGAATCCACG,0,2768414
ompRp1,0.09090909090909091,10,10,AGCCTTGATTAGCGGGCCTA,0,2770145
ompRp1,0.09090909090909091,10,10,AGCCTTCCGGGTGTGACAAA,0,2767164
ompRp1,0.09090909090909091,10,10,AGCCGTTATAAGTCCCAAAG,0,2803313
ompRp1,0.09090909090909091,10,10,AGCCCCCCTGAATCACCTGA,0,2820804
ompRp1,0.09090909090909091,10,10,AGCCCATTGTTAGTAAGAGG,0,2805339
ompRp1,0.09090909090909091,10,10,AGCCACCACTCGGGGTTTTA,0,2801641
ompRp1,0.09090909090909091,10,10,AGAGTGTCTCGTAACTTGCC,0,2789921
ompRp1,0.09090909090909091,10,10,AGAGGGAGCTCATTAGTGCG,0,2809524
ompRp1,0.09090909090909091,10,10,AGACGTCCAGTGCGCTAATA,0,2809707
ompRp1,0.09090909090909091,10,10,AGAATAAACAGATCGTTCTT,0,2784551
ompRp1,0.09090909090909091,10,10,AGAACTTGAGGGCGAGTCGG,0,2789823
ompRp1,0.09090909090909091,10,10,AGAACGCTTCCCCGGACCGA,0,2787946
ompRp1,0.09090909090909091,10,10,ACTTTTGTGCCGCAGTTGAC,0,2810931
ompRp1,0.09090909090909091,10,10,ACTTGGGACCGTTTCTCGCG,0,2774250
ompRp1,0.09090909090909091,10,10,ACTGCTTCGGCAATAAAGAT,0,2817502
ompRp1,0.09090909090909091,10,10,ACTCTAACTGAGTTCAATCA,0,2799372
ompRp1,0.09090909090909091,10,10,ACTCGTTAGCGCTACCGCTA,0,2816119
ompRp1,0.09090909090909091,10,10,ACTCAGTTACTGCGACAAGT,0,2800436
ompRp1,0.09090909090909091,10,10,ACTAGGGAAGGCGTCGAGAA,0,2815480
ompRp1,0.09090909090909091,10,10,ACTACGGCGCAAGGCGAAAG,0,2768322
ompRp1,0.09090909090909091,10,10,ACTAATTCGGCGCGGGACAC,0,2820360
ompRp1,0.09090909090909091,10,10,ACGTCATCACCGACATGACT,0,2804946
ompRp1,0.09090909090909091,10,10,ACGGGTTAACAGAGCTGTCC,0,2773634
ompRp1,0.09090909090909091,10,10,ACGGCAAGAGCGTACACATA,0,2780731
ompRp1,0.09090909090909091,10,10,ACGCTTACGTGTAGTGCCTC,0,2769745
ompRp1,0.09090909090909091,10,10,ACGATGGGGCGCGCTAAAAG,0,2787835
ompRp1,0.09090909090909091,10,10,ACGACTCGCGATGTATTGTG,0,2780159
ompRp1,0.09090909090909091,10,10,ACGACAGGACGCGAGGGGAT,0,2777055
ompRp1,0.09090909090909091,10,10,ACGAATTGCTTGTGCCCGGT,0,2801651
ompRp1,0.09090909090909091,10,10,ACCTCATGGCACGGCCCGTC,0,2798481
ompRp1,0.09090909090909091,10,10,ACCGTCAACAAAATGGACAC,0,2802083
ompRp1,0.09090909090909091,10,10,ACCCTTTAACAATCTAATAG,0,2817882
ompRp1,0.09090909090909091,10,10,ACCCTCCGCACAAACGACAG,0,2807095
ompRp1,0.09090909090909091,10,10,ACCCAGTAAAGGCGGGGGTG,0,2800146
ompRp1,0.09090909090909091,10,10,ACATTCCTCGCGTCTTATCC,0,2808052
ompRp1,0.09090909090909091,10,10,ACATGCTCGGGAGAGAACGG,0,2799066
ompRp1,0.09090909090909091,10,10,ACATGATCTGTTTCAGGGAA,0,2805482
ompRp1,0.09090909090909091,10,10,ACATCAAATGCCGGGGCGCA,0,2809838
ompRp1,0.09090909090909091,10,10,ACACTAGCTAGATTATAGAT,0,2787290
ompRp1,0.09090909090909091,10,10,ACACGTCGCCATGGGGCAGT,0,2765333
ompRp1,0.09090909090909091,10,10,ACACCATTCCTGTGAACGTC,0,2798347
ompRp1,0.09090909090909091,10,10,ACACACAAGGATCCACGTAC,0,2794142
ompRp1,0.09090909090909091,10,10,ACAAAGACGATTGCGAGTGG,0,2773596
ompRp1,0.09090909090909091,10,10,AATGTCGGACGGCTCTCACC,0,2801692
ompRp1,0.09090909090909091,10,10,AATGTAATACACCAAGGGTC,0,2811201
ompRp1,0.09090909090909091,10,10,AATGGGCCGTAGTGCGTAAT,0,2783101
ompRp1,0.09090909090909091,10,10,AATCAACCAATCAGCTCAGT,0,2766514
ompRp1,0.09090909090909091,10,10,AATAACCGGAACCCAATCGC,0,2818856
ompRp1,0.09090909090909091,10,10,AAGTTGTAGTTGCGCGCGAA,0,2777489
ompRp1,0.09090909090909091,10,10,AAGTGCCGGGTTGAAATAAG,0,2794455
ompRp1,0.09090909090909091,10,10,AAGTGAATAGCGAGGGGTAA,0,2811956
ompRp1,0.09090909090909091,10,10,AAGTCCCGTATCAGTATATG,0,2811356
ompRp1,0.09090909090909091,10,10,AAGGAAAGGAGGAAAACCTA,0,2783085
ompRp1,0.09090909090909091,10,10,AAGCATTCATGATAGCAGTG,0,2788384
ompRp1,0.09090909090909091,10,10,AAGCACAGAGTTAACAACCC,0,2775886
ompRp1,0.09090909090909091,10,10,AAGAAGTTATCGGGCACGAC,0,2814623
ompRp1,0.09090909090909091,10,10,AACTATCACCCCAATATCTT,0,2794952
ompRp1,0.09090909090909091,10,10,AACCTTCTCCCGTATTAAGA,0,2792471
ompRp1,0.09090909090909091,10,10,AACCGGTATCAGCTGCGTAA,0,2819889
ompRp1,0.09090909090909091,10,10,AACCCGCCGACGTCTATAGG,0,2815962
ompRp1,0.09090909090909091,10,10,AACATTTACGCCGCAGGTTA,0,2775817
ompRp1,0.09090909090909091,10,10,AACAGAGTTCAATCGGGGTC,0,2813739
ompRp1,0.09090909090909091,10,10,AAATGCTCTTTTAAGAAAGA,0,2814594
ompRp1,0.09090909090909091,10,10,AAACTTCCGATTACTACGTC,0,2793647
ompRp1,0.09090909090909091,10,10,AAACGTGGCAACTCAATACT,0,2792870
ompRp1,0.09090909090909091,10,10,AAAAATAGTCATCTAATTAA,0,2765423
ompRp1,0.09090909090909091,10,10,AAAAAGAGTACTGAGGAGCA,0,2812077
ompRp1,0.1,9,9,TTTTGCATGGCCCTAATAGT,0,2790824
ompRp1,0.1,9,9,TTTGTGTCTGTGGCCGAACC,0,2791801
ompRp1,0.1,9,9,TTTCGTGCTGCACATTGGGG,0,2775096
ompRp1,0.1,9,9,TTTCGGATGTTATGTCACCC,0,2773433
ompRp1,0.1,9,9,TTTCCTACGGGTGTCTCGAG,0,2813305
ompRp1,0.1,9,9,TTTCCAAGGTTAACCTGAGA,0,2814992
ompRp1,0.1,9,9,TTGTTACGGAGCGCTAGGAT,0,2801769
ompRp1,0.1,9,9,TTGGGCGCGCTCGTAATGGA,0,2771807
ompRp1,0.1,9,9,TTGGCCCGGTGTTCCAAGCA,0,2782941
ompRp1,0.1,9,9,TTGCGACAACTGGATACAAT,0,2766237
ompRp1,0.1,9,9,TTGCCGCAGCGTGTCTCCTT,0,2793669
ompRp1,0.1,9,9,TTGATATAAGTCATGCTCCA,0,2816239
ompRp1,0.1,9,9,TTGAGCCGTGGTCCTAACAA,0,2790057
ompRp1,0.1,9,9,TTCTTTGGTAGTGATGCTTA,0,2771317
ompRp1,0.1,9,9,TTCGTTCAGACACCGCCCGG,0,2783821
ompRp1,0.1,9,9,TTCGGTATGGTCGCCAGCAT,0,2769390
ompRp1,0.1,9,9,TTCGCCCTGCTGATGTCCGT,0,2771443
ompRp1,0.1,9,9,TTCGAGGTGTCCGTTCACGT,0,2798385
ompRp1,0.1,9,9,TTCCTGAAACAAGCGGAACC,0,2823259
ompRp1,0.1,9,9,TTCATTTAGTTCACATATCG,0,2806324
ompRp1,0.1,9,9,TTCAAGTTAGCAGCACTGGT,0,2781453
ompRp1,0.1,9,9,TTCAACCATAACCACGGAGT,0,2786767
ompRp1,0.1,9,9,TTATTCCGAGCGTGTGAGCT,0,2769117
ompRp1,0.1,9,9,TTAGTGTATGTATAATTTAA,0,2766140
ompRp1,0.1,9,9,TTAGTCCATTTTTATGGCAT,0,2782082
ompRp1,0.1,9,9,TTAGATGCTCTAGAGGGTTC,0,2797914
ompRp1,0.1,9,9,TTACGTGACACAGACATTGT,0,2782114
ompRp1,0.1,9,9,TTACCGAGACTAAGGGTGGC,0,2771716
ompRp1,0.1,9,9,TTAATAGGGAAATGCATTCA,0,2769038
ompRp1,0.1,9,9,TGTTGGGGAAAGGTAAGTAT,0,2796285
ompRp1,0.1,9,9,TGTTCACTTTCCCGACGATA,0,2812568
ompRp1,0.1,9,9,TGTTATGATTCGAAGGAGCG,0,2770906
ompRp1,0.1,9,9,TGTGCACGAGGGCTTCTCCA,0,2792673
ompRp1,0.1,9,9,TGTCTGATAAACGAGATATC,0,2806002
ompRp1,0.1,9,9,TGTCCTTCCGGCCGTATGAT,0,2789145
ompRp1,0.1,9,9,TGTAAGAGTCCTATTAACAT,0,2804313
ompRp1,0.1,9,9,TGGTGTAGTGGTCAAGGATA,0,2803683
ompRp1,0.1,9,9,TGGTGTACAGTACGCGATTG,0,2796730
ompRp1,0.1,9,9,TGGGTCAAACTACGGTATAC,0,2796312
ompRp1,0.1,9,9,TGGGTAATACGCTAAACGAT,0,2782829
ompRp1,0.1,9,9,TGGGAAAGTCTTGAGCATTC,0,2806583
ompRp1,0.1,9,9,TGGCGTAGGCGACGTTATTG,0,2795729
ompRp1,0.1,9,9,TGGCAGACTCCACGTAAGGT,0,2816559
ompRp1,0.1,9,9,TGGATTGTAGGGTGTGCGGA,0,2767503
ompRp1,0.1,9,9,TGGAGAAGCCGAGTAGACAA,0,2765424
ompRp1,0.1,9,9,TGGACTCGGGTATCCCTAAA,0,2780338
ompRp1,0.1,9,9,TGGAAGCTCGGTTCTCAACG,0,2823106
ompRp1,0.1,9,9,TGCTGGAGTCCTGTTACAAC,0,2787079
ompRp1,0.1,9,9,TGCTGAGTAAGTCACCGGCC,0,2773971
ompRp1,0.1,9,9,TGCTCTTGTACCCGCTAGGT,0,2823306
ompRp1,0.1,9,9,TGCTCTATGCGGCTACCTAG,0,2792283
ompRp1,0.1,9,9,TGCTATAAGGCACCGGCGAC,0,2801595
ompRp1,0.1,9,9,TGCTAACAAGCGCGCGAATT,0,2787546
ompRp1,0.1,9,9,TGCGTCGAATGGATAATAGT,0,2772998
ompRp1,0.1,9,9,TGCGGGTGTGACCGCATCCA,0,2798563
ompRp1,0.1,9,9,TGCGGCCGTCACGCTTTATG,0,2776215
ompRp1,0.1,9,9,TGCGCAGGATCCCGTATTTA,0,2768606
ompRp1,0.1,9,9,TGCGATCGGTGAACCACATT,0,2808671
ompRp1,0.1,9,9,TGCGACTTGGCATAGCAGAC,0,2822767
ompRp1,0.1,9,9,TGCCCGCAGCGAGCCGATTG,0,2818444
ompRp1,0.1,9,9,TGCCAACGGGTCGCTTGCGC,0,2766868
ompRp1,0.1,9,9,TGCATCCCCGCAGGTTACAT,0,2770962
ompRp1,0.1,9,9,TGCACTTAAAGATATGACCG,0,2811642
ompRp1,0.1,9,9,TGATTTTTATGGACGCATTA,0,2795573
ompRp1,0.1,9,9,TGATGAGTAGTACCGCCGCG,0,2800972
ompRp1,0.1,9,9,TGATGAAGCTTGTTCACGCA,0,2794462
ompRp1,0.1,9,9,TGATCGCTAGTTGAAGCTTG,0,2794562
ompRp1,0.1,9,9,TGATCACGTCTTACACGTAT,0,2823053
ompRp1,0.1,9,9,TGATAGAGGCAAGTGGTTCT,0,2766977
ompRp1,0.1,9,9,TGATACATTGGTCTGGCCAG,0,2793779
ompRp1,0.1,9,9,TGAGCGCTATTATAACTGAT,0,2801451
ompRp1,0.1,9,9,TGAAGCAAAGCTGTGTGGTC,0,2774528
ompRp1,0.1,9,9,TGAAGACTATAATCTTCTAC,0,2803013
ompRp1,0.1,9,9,TCTTAATCTGCCTATCGTCA,0,2803705
ompRp1,0.1,9,9,TCTGCCTAAGTGTTTCGGAG,0,2800504
ompRp1,0.1,9,9,TCTGATTGATCGGGCCTCCA,0,2770469
ompRp1,0.1,9,9,TCTGATCCAAGACAGTCCTC,0,2811361
ompRp1,0.1,9,9,TCTGAACTAGGAGAAGGACA,0,2774848
ompRp1,0.1,9,9,TCTCTCAGGTCAGCACGAGA,0,2792291
ompRp1,0.1,9,9,TCTCAAGCCATCGTTCACTT,0,2789207
ompRp1,0.1,9,9,TCTAATCCACCTCGTTAGGT,0,2819294
ompRp1,0.1,9,9,TCGTCCGTACCGGACCCCAT,0,2782394
ompRp1,0.1,9,9,TCGTCCGCGCGTCGTCTAGG,0,2794162
ompRp1,0.1,9,9,TCGGCTATTCCGCTAGAGGA,0,2770380
ompRp1,0.1,9,9,TCGCTATGTTATGAGACAAG,0,2795606
ompRp1,0.1,9,9,TCGCGAACGGGTAGGCATAA,0,2796677
ompRp1,0.1,9,9,TCGCCTTAAACATCAGCTAA,0,2777972
ompRp1,0.1,9,9,TCGCCGGTTCAGAGCGACCA,0,2780765
ompRp1,0.1,9,9,TCGCATATGATGGCATTTAT,0,2769866
ompRp1,0.1,9,9,TCGAAAACTTGAGGCGTCCT,0,2772459
ompRp1,0.1,9,9,TCCTAGGCTATTGCGGTCTT,0,2801864
ompRp1,0.1,9,9,TCCGTAATGATCTTGTAAGA,0,2775815
ompRp1,0.1,9,9,TCCGCACGTCGGGCGCACTT,0,2786426
ompRp1,0.1,9,9,TCCCCGGAGCTCTATCTCTT,0,2786506
ompRp1,0.1,9,9,TCCCCAGCACGACATGAATA,0,2811443
ompRp1,0.1,9,9,TCCATATCAGGCTCACGCTA,0,2794533
ompRp1,0.1,9,9,TCCAGTCACCGTAAGGACCT,0,2801140
ompRp1,0.1,9,9,TCCAAGGGAGGGCGTCAAGA,0,2768974
ompRp1,0.1,9,9,TCAGCGGCGGTAGTGATGCA,0,2790130
ompRp1,0.1,9,9,TCAGCGCGGGTTTCGGCAAT,0,2805888
ompRp1,0.1,9,9,TCAGCATGAAAACTACTCAG,0,2771239
ompRp1,0.1,9,9,TCACTCGTCGCCTTCTCGGT,0,2782664
ompRp1,0.1,9,9,TCACAAGGCAATCAGTTTGT,0,2798794
ompRp1,0.1,9,9,TCAATGTTCCTCCATCGTGT,0,2804656
ompRp1,0.1,9,9,TATTGTCAAATTGCCGTTTT,0,2767645
ompRp1,0.1,9,9,TATGGAAGCATACTATTCGA,0,2781832
ompRp1,0.1,9,9,TATGCGGAGATTGGGCAAAA,0,2781360
ompRp1,0.1,9,9,TATGACCTTTCTCACTCTGT,0,2808684
ompRp1,0.1,9,9,TATCATTCCTACGTGAGCAT,0,2784237
ompRp1,0.1,9,9,TATATTCCTCTGAACCCTTG,0,2796472
ompRp1,0.1,9,9,TATATCTGCGGTGTACAGAA,0,2780021
ompRp1,0.1,9,9,TATACTGGCAATTTACTAGA,0,2799789
ompRp1,0.1,9,9,TAGGCCCCGCAGAACAAGTT,0,2776615
ompRp1,0.1,9,9,TAGCTCGAGCCATACATTGA,0,2772054
ompRp1,0.1,9,9,TAGCAGAGAGCGGCGCGTGG,0,2765866
ompRp1,0.1,9,9,TAGCACAACGCTCAAGCAGT,0,2809026
ompRp1,0.1,9,9,TAGAGCTGGGATCCAAATGA,0,2823440
ompRp1,0.1,9,9,TAGAACAATATCTTACAGCC,0,2787382
ompRp1,0.1,9,9,TACTTCGCGCGCCGCTTCTA,0,2800412
ompRp1,0.1,9,9,TACTGACTTCAAGAGAGCGC,0,2809691
ompRp1,0.1,9,9,TACCCCTATACCGAACAGGA,0,2816591
ompRp1,0.1,9,9,TACATTTCACACCAACGCTC,0,2810432
ompRp1,0.1,9,9,TAATGAAGATTAATTGGTTT,0,2786751
ompRp1,0.1,9,9,TAATATACGGAGAAAGGCGT,0,2787955
ompRp1,0.1,9,9,TAACTCATCAAACGGCCCAG,0,2817764
ompRp1,0.1,9,9,TAACGTGGACTAAGGCGGGT,0,2809913
ompRp1,0.1,9,9,TAACCGGGCATTATCGATTA,0,2788344
ompRp1,0.1,9,9,GTTTTACGCCCTATGGAAGT,0,2795506
ompRp1,0.1,9,9,GTTTGTTCCGCTTGTACCAT,0,2810807
ompRp1,0.1,9,9,GTTTGGGCATGTAACTCTAC,0,2776517
ompRp1,0.1,9,9,GTTTAATACGTGCCTTCAGG,0,2786433
ompRp1,0.1,9,9,GTTGCGAACTCCATGACTCA,0,2791241
ompRp1,0.1,9,9,GTTCCAGGCACTTAGCAAAC,0,2792281
ompRp1,0.1,9,9,GTGTCAGAAGTGAAACAGAA,0,2766465
ompRp1,0.1,9,9,GTGGCTAGCATGAGGTTCAA,0,2768608
ompRp1,0.1,9,9,GTGATGGACGAGGTCGGCTA,0,2802487
ompRp1,0.1,9,9,GTGAGATACAGTGGGACCCT,0,2821888
ompRp1,0.1,9,9,GTGACTTTTGTTTGATTAGC,0,2819791
ompRp1,0.1,9,9,GTCTGGCTGATAACCCTAGA,0,2803399
ompRp1,0.1,9,9,GTCCTCGTACCCTCCATTTT,0,2778813
ompRp1,0.1,9,9,GTCCGTGTTCTAACGCGTGT,0,2782833
ompRp1,0.1,9,9,GTCCGTGTAGTGTTCGTGCC,0,2796084
ompRp1,0.1,9,9,GTCCAATGGTTAGTGTGCGA,0,2766406
ompRp1,0.1,9,9,GTCACAACGGTTGGCACAGG,0,2773952
ompRp1,0.1,9,9,GTCACAACGCAGGCGGTCGC,0,2780153
ompRp1,0.1,9,9,GTATAACCAGGTGACATTGC,0,2818059
ompRp1,0.1,9,9,GTACGGGAGCACTTGTGGAA,0,2799761
ompRp1,0.1,9,9,GTAATCGGGGCCGCCCTTCA,0,2820403
ompRp1,0.1,9,9,GTAACTTGGCTGAGCTGCCT,0,2818209
ompRp1,0.1,9,9,GGTTTGCCGGCGCCATTCGC,0,2812593
ompRp1,0.1,9,9,GGTTGTCCGCAGCGGGGCCT,0,2774191
ompRp1,0.1,9,9,GGTTGGCTGGTGGAGTCACG,0,2782990
ompRp1,0.1,9,9,GGTTCACCACGGCGGCGATC,0,2772200
ompRp1,0.1,9,9,GGTTAAAAAGTATCATGGTA,0,2799136
ompRp1,0.1,9,9,GGTGTGCTTTTCGTTTCGCC,0,2774721
ompRp1,0.1,9,9,GGTGTATGACTCGCGGTATA,0,2772913
ompRp1,0.1,9,9,GGTGCCATACCCTCGGATCC,0,2778053
ompRp1,0.1,9,9,GGTGCATTGCGGTTTAAGGT,0,2783467
ompRp1,0.1,9,9,GGTCTTTGCCGTGGCATTAA,0,2789265
ompRp1,0.1,9,9,GGTCAAACCGGGGCCTAATT,0,2805264
ompRp1,0.1,9,9,GGTAGCGCAAAACACGATAG,0,2820190
ompRp1,0.1,9,9,GGTACTTCTACACAGCATCA,0,2806262
ompRp1,0.1,9,9,GGGTTCTTTTTACCGCAAGC,0,2820719
ompRp1,0.1,9,9,GGGTTATATTCCATGGGAGT,0,2810180
ompRp1,0.1,9,9,GGGGGGGGATGAGGTTAGTA,0,2784710
ompRp1,0.1,9,9,GGGGGCTATGATAGTTGCAT,0,2810110
ompRp1,0.1,9,9,GGGGGCACGGCGTGCTGGTT,0,2809998
ompRp1,0.1,9,9,GGGGCGCACTAGACCCATGT,0,2790665
ompRp1,0.1,9,9,GGGCCGCCTTAGTAAACGTA,0,2779495
ompRp1,0.1,9,9,GGGAGTGGCAGGTATCAACC,0,2813727
ompRp1,0.1,9,9,GGGAGAGTCGTCACAATGGT,0,2811236
ompRp1,0.1,9,9,GGGAGACACGGTTGCCGTCG,0,2769784
ompRp1,0.1,9,9,GGGACCCGAGGATCTGGCGC,0,2802992
ompRp1,0.1,9,9,GGCGTGGAAGAGCTTGGTTA,0,2805164
ompRp1,0.1,9,9,GGCGTCTAGGGAACCCAATC,0,2801758
ompRp1,0.1,9,9,GGCGGATACTACGGGGACTT,0,2814341
ompRp1,0.1,9,9,GGCGCGTGACCTAAAGGTCG,0,2806312
ompRp1,0.1,9,9,GGCGAGGTGGCAGTAGGTCA,0,2799580
ompRp1,0.1,9,9,GGCCCTGAGGTTCCTGTCCA,0,2774614
ompRp1,0.1,9,9,GGCCCCCAATGAAATAGTGC,0,2805415
ompRp1,0.1,9,9,GGCATTGAGGAAGCCGTTGT,0,2778416
ompRp1,0.1,9,9,GGCACTGGCCAGGTCAAAGT,0,2785571
ompRp1,0.1,9,9,GGATTTCCCCGGGGTGATAT,0,2766720
ompRp1,0.1,9,9,GGATTCCACGACTCCATCCT,0,2801316
ompRp1,0.1,9,9,GGATAACCTGTTGCAATACT,0,2788672
ompRp1,0.1,9,9,GGAGGGCTTTTAGTTGGAAA,0,2783134
ompRp1,0.1,9,9,GGAGACAGGCGAGTGATGCC,0,2775137
ompRp1,0.1,9,9,GGACTTAGAAACTGGGGGGA,0,2820044
ompRp1,0.1,9,9,GGACGTGGGAAGCAGGGATG,0,2783423
ompRp1,0.1,9,9,GGACGCAGAGTAAACTCGGC,0,2774584
ompRp1,0.1,9,9,GGACCCCCAAATATAGTGGC,0,2809138
ompRp1,0.1,9,9,GGACCCAGCCCATATGATAC,0,2811489
ompRp1,0.1,9,9,GGACATTAGGGTGCACTGTC,0,2802209
ompRp1,0.1,9,9,GGACACAGGTACTTCCCGTG,0,2783563
ompRp1,0.1,9,9,GGAAAGACAGGGCAAGCTAA,0,2807768
ompRp1,0.1,9,9,GCTTTGTTAGATGCGTGGGT,0,2805238
ompRp1,0.1,9,9,GCTGCTCGTTTCTACCTCCG,0,2812894
ompRp1,0.1,9,9,GCTGAGTTTATCATTAGTTT,0,2774090
ompRp1,0.1,9,9,GCTCTCTTGCACGAGGCCAC,0,2765957
ompRp1,0.1,9,9,GCTCTCACCTAACTAATGGT,0,2781106
ompRp1,0.1,9,9,GCTCAGCGCAACACGTGGTG,0,2769297
ompRp1,0.1,9,9,GCTATCGGTGCTCTGCCAGC,0,2811131
ompRp1,0.1,9,9,GCTACTATTCCCTCTGTGCC,0,2806349
ompRp1,0.1,9,9,GCTAACTCGGGAGGGTTTAC,0,2779373
ompRp1,0.1,9,9,GCGGGGTCGGACCCGTTCTC,0,2773213
ompRp1,0.1,9,9,GCGCTTAGTTGTATCGTAGG,0,2783582
ompRp1,0.1,9,9,GCGCTCACGCCATATCCGGA,0,2783271
ompRp1,0.1,9,9,GCGCAATCAGGTGGTTGCCT,0,2816905
ompRp1,0.1,9,9,GCGACCTAAGGTATGCGTTC,0,2783648
ompRp1,0.1,9,9,GCCTCCACTGGATTAATCTA,0,2798008
ompRp1,0.1,9,9,GCCGCAGTGAGTGAGCTCGA,0,2814169
ompRp1,0.1,9,9,GCCGACCGAGCCCTCATCAT,0,2790129
ompRp1,0.1,9,9,GCCGACACGCGGTAATCTAT,0,2819948
ompRp1,0.1,9,9,GCCCGCGATATGTCCTACAA,0,2823139
ompRp1,0.1,9,9,GCCACTTTACCCTGTCTGAA,0,2799768
ompRp1,0.1,9,9,GCAGTTATGTCAGCCACCGA,0,2786828
ompRp1,0.1,9,9,GCAGCTCAGACTCGCGTGTT,0,2769714
ompRp1,0.1,9,9,GCAGCGCGACTTGACTCTGA,0,2797855
ompRp1,0.1,9,9,GCAGCCTCCGTTTCGAGTTG,0,2788679
ompRp1,0.1,9,9,GCACTAGCACTCTCGAAAAA,0,2803809
ompRp1,0.1,9,9,GATTGGACCTGTACAAACCA,0,2773620
ompRp1,0.1,9,9,GATGGTGCCTACGTGACGCT,0,2813410
ompRp1,0.1,9,9,GATCGGGGAATCTGGGGTGT,0,2780610
ompRp1,0.1,9,9,GATCATGGTCTTTATAGTCT,0,2784114
ompRp1,0.1,9,9,GATAGGTTCACGGGACGATT,0,2814852
ompRp1,0.1,9,9,GATAGGGCCGTCAGGTAATT,0,2781442
ompRp1,0.1,9,9,GATAACGTTTGCCAGTTAAG,0,2824260
ompRp1,0.1,9,9,GAGTTACACGCCGAGGGTGG,0,2782845
ompRp1,0.1,9,9,GAGTCTTGCCGGTCCAGATG,0,2807352
ompRp1,0.1,9,9,GAGTAATCGTTCTCTAAAGT,0,2768188
ompRp1,0.1,9,9,GAGTAACGACTCACAAACAA,0,2800262
ompRp1,0.1,9,9,GAGCTATAAGTAGTCACCCT,0,2773472
ompRp1,0.1,9,9,GAGCGCCTTGGCCCATATCA,0,2770694
ompRp1,0.1,9,9,GAGCAGACAGATACCCCGCT,0,2773339
ompRp1,0.1,9,9,GAGATAGGCGCTAGCGCCTT,0,2810046
ompRp1,0.1,9,9,GAGATAAGCTCACTCAGCAT,0,2780911
ompRp1,0.1,9,9,GAGAGAGTAAGAATAACTTA,0,2818562
ompRp1,0.1,9,9,GAGAATTGTATAGCCACGGT,0,2800016
ompRp1,0.1,9,9,GACCCTACGAGATTTGTGGC,0,2793732
ompRp1,0.1,9,9,GACACTGCACAACACACGTC,0,2809454
ompRp1,0.1,9,9,GACAATGTAAGCCGCCAAGA,0,2782048
ompRp1,0.1,9,9,GAATACGGTGTCTATACGAA,0,2782041
ompRp1,0.1,9,9,GAAGGTCTGACGTGCTCCAG,0,2804300
ompRp1,0.1,9,9,GAAGCCCATACGGCAAGAGT,0,2802499
ompRp1,0.1,9,9,GAAGCAGGCGGTCGAAAGCA,0,2791692
ompRp1,0.1,9,9,GAACGGGCTTTACAAGATCA,0,2823102
ompRp1,0.1,9,9,GAACGAATTCCTGGTAGCGG,0,2778981
ompRp1,0.1,9,9,GAACAGCCAAAGTTGATCGT,0,2782295
ompRp1,0.1,9,9,CTTTTCGGAATGTCGGTTTA,0,2804245
ompRp1,0.1,9,9,CTTTGTAACGCGCGGCTTGA,0,2766273
ompRp1,0.1,9,9,CTTGTAAGTCTGGATCGCGA,0,2807762
ompRp1,0.1,9,9,CTTGGTGCTATGGGAGCCTC,0,2768859
ompRp1,0.1,9,9,CTTGGTAGTCACCACGGTAA,0,2805628
ompRp1,0.1,9,9,CTTGCCTGAGGACTAAGGAA,0,2806684
ompRp1,0.1,9,9,CTTCCTCGCGTAATTCCCGT,0,2765982
ompRp1,0.1,9,9,CTGCGGCTAGTGGCCTCAAT,0,2789562
ompRp1,0.1,9,9,CTGCCAAACCTTGTATATGA,0,2805378
ompRp1,0.1,9,9,CTGAGTTGGCAGATCAGAAG,0,2791479
ompRp1,0.1,9,9,CTGACACTACTCGAAAGCGC,0,2765422
ompRp1,0.1,9,9,CTCTTAGACTCTGGTACGCG,0,2772835
ompRp1,0.1,9,9,CTCGGCTGTTCGAGATATCA,0,2803948
ompRp1,0.1,9,9,CTCGGCATCGCCCTTCCTTA,0,2776597
ompRp1,0.1,9,9,CTCGACGATGCAACAGGCGC,0,2816374
ompRp1,0.1,9,9,CTCGAACCCGCTTAGACTCT,0,2818732
ompRp1,0.1,9,9,CTCCCGGTAGAATCCTCGGT,0,2815818
ompRp1,0.1,9,9,CTCCACCTGGGAAGTCAGTA,0,2784908
ompRp1,0.1,9,9,CTCCACAGGAAGAGGGGCTC,0,2791777
ompRp1,0.1,9,9,CTCATGCCCTTTGCTCGGCA,0,2802495
ompRp1,0.1,9,9,CTCAGAGTGCCTCATAAATG,0,2809837
ompRp1,0.1,9,9,CTCACTGCCCTTTCGCACAG,0,2815428
ompRp1,0.1,9,9,CTATGGAGGACCCGCTGTAG,0,2809393
ompRp1,0.1,9,9,CTATCTGACGCCTGCGCGAA,0,2798292
ompRp1,0.1,9,9,CTATACCTGAAGGACTCAAA,0,2768054
ompRp1,0.1,9,9,CTAGCGTCAGGTGTTATGAA,0,2792138
ompRp1,0.1,9,9,CTACGGCGTCGTTCAGCTTA,0,2807766
ompRp1,0.1,9,9,CTACGAATCTGTCAACGTTT,0,2793650
ompRp1,0.1,9,9,CTAATTCAGAGCGTCCACTC,0,2779956
ompRp1,0.1,9,9,CTAACAAGTTAGCGTATTTC,0,2770736
ompRp1,0.1,9,9,CTAAACGTTTCTACCATATG,0,2781679
ompRp1,0.1,9,9,CGTTCAAGATTATATACAGT,0,2782721
ompRp1,0.1,9,9,CGTTAAATTTTTCGTTTGAG,0,2804552
ompRp1,0.1,9,9,CGTGATTAGACAAATATAAG,0,2797194
ompRp1,0.1,9,9,CGTGAGTGTTGGTCTTAGCA,0,2813910
ompRp1,0.1,9,9,CGTGAGCGACCGTTTTTAGG,0,2804479
ompRp1,0.1,9,9,CGTCTTCCCGGAGGGACCGC,0,2801397
ompRp1,0.1,9,9,CGTCTCGTTCTTAATCCCAC,0,2810731
ompRp1,0.1,9,9,CGTCCATCCATCAACGGTCC,0,2809182
ompRp1,0.1,9,9,CGTATGGGGTGACGGACGTC,0,2803557
ompRp1,0.1,9,9,CGGTGCTGGCTAGGCCACCT,0,2804598
ompRp1,0.1,9,9,CGGTCTGCCGAACGGGTACC,0,2816854
ompRp1,0.1,9,9,CGGGTTTACATGGCTGCCGC,0,2801767
ompRp1,0.1,9,9,CGGGTCTCCTCGGTCATCCA,0,2784021
ompRp1,0.1,9,9,CGGGATTCAATCGTGAAATA,0,2813519
ompRp1,0.1,9,9,CGGCCGTCTTTCCCATTCAC,0,2801584
ompRp1,0.1,9,9,CGGCCACCCCTAAGACTGGA,0,2801245
ompRp1,0.1,9,9,CGGCAATCCGTGTGCCCATG,0,2815505
ompRp1,0.1,9,9,CGGATCACTTCGTAGCTCTG,0,2771212
ompRp1,0.1,9,9,CGCTGATTAAACCTCGGGTG,0,2781440
ompRp1,0.1,9,9,CGCTCGGCTGGCTTAGGAAT,0,2775614
ompRp1,0.1,9,9,CGCGAGTTTTCCTTGTTCAT,0,2765306
ompRp1,0.1,9,9,CGCCGTTGGTCGTCCTTGAT,0,2780816
ompRp1,0.1,9,9,CGCCGTAGGCAACTATACCA,0,2768971
ompRp1,0.1,9,9,CGATTGCTTACTTTCGAACG,0,2810890
ompRp1,0.1,9,9,CGATGTGGCCATCATAGCCA,0,2793061
ompRp1,0.1,9,9,CGATCAACAGTCGTCTCGGA,0,2796418
ompRp1,0.1,9,9,CGACCTTCCTGCTAAACTCA,0,2781411
ompRp1,0.1,9,9,CGAATTGAAGTACTTACATT,0,2794380
ompRp1,0.1,9,9,CGAATCCGAGTTACCGATCT,0,2788828
ompRp1,0.1,9,9,CGAAGCGTTCCTGACATCCC,0,2820904
ompRp1,0.1,9,9,CGAAACATTGATATATTTGC,0,2800576
ompRp1,0.1,9,9,CCTTTCAAAGGGTGCGCTTG,0,2774280
ompRp1,0.1,9,9,CCTTGAACATGGGGTACATC,0,2774849
ompRp1,0.1,9,9,CCTGGCGCGATGGGAAATAT,0,2816995
ompRp1,0.1,9,9,CCTGGCCAAACGTACCCACT,0,2774668
ompRp1,0.1,9,9,CCTGACAACCTACTACGCAT,0,2772832
ompRp1,0.1,9,9,CCTCCTAGAACCCCCTATGC,0,2782787
ompRp1,0.1,9,9,CCGTCCACTCCTGCTCCTCC,0,2824092
ompRp1,0.1,9,9,CCGGGGGCGAGGTCAACTAG,0,2809842
ompRp1,0.1,9,9,CCGGCCGGACTTTGACGCGC,0,2789103
ompRp1,0.1,9,9,CCGATACCTGCGGGCTGGAA,0,2784010
ompRp1,0.1,9,9,CCCTGGGAAACTTCTGGTAA,0,2789385
ompRp1,0.1,9,9,CCCTCAAACACAAGTACCGG,0,2817267
ompRp1,0.1,9,9,CCCGTAGGCGGCAGCGGCGT,0,2817900
ompRp1,0.1,9,9,CCCGAGGCACGGCCCTGAAT,0,2797208
ompRp1,0.1,9,9,CCCCCGTCCGATAACAGGCT,0,2787243
ompRp1,0.1,9,9,CCCCCGGGTTGCGGGGAGGT,0,2810980
ompRp1,0.1,9,9,CCCATGCCATTGAGTGTCTG,0,2786812
ompRp1,0.1,9,9,CCCATGATTACCGATGAACC,0,2775675
ompRp1,0.1,9,9,CCCATCTAGTGCTCAGCCAA,0,2814063
ompRp1,0.1,9,9,CCCAGTTATAAATGCACTTG,0,2809757
ompRp1,0.1,9,9,CCCAAGCTCCTGGATTCGAT,0,2822690
ompRp1,0.1,9,9,CCCAAAGTCCATTGAATAAC,0,2769815
ompRp1,0.1,9,9,CCACCGTTCTCCTGCCCGCA,0,2813867
ompRp1,0.1,9,9,CCACACAGAGCCCGACCCTA,0,2810274
ompRp1,0.1,9,9,CCACAACTGGTATTGAGATC,0,2767909
ompRp1,0.1,9,9,CCAATATTGCTTTTACCGTA,0,2801013
ompRp1,0.1,9,9,CATTTAGAATCTACCACTAT,0,2800765
ompRp1,0.1,9,9,CATTGTCCAACTTCTTAGGG,0,2822114
ompRp1,0.1,9,9,CATTCTGAAGCGGTTATCCG,0,2799022
ompRp1,0.1,9,9,CATTCTCGGGTATGGGGGCT,0,2803141
ompRp1,0.1,9,9,CATGTAAAGGTCCATGTTAA,0,2777001
ompRp1,0.1,9,9,CATGGTTTTAATGGCTGTCT,0,2770238
ompRp1,0.1,9,9,CATACTGAATCCACAGGGTG,0,2776451
ompRp1,0.1,9,9,CATACGTGTGAAGTCTAGCC,0,2791783
ompRp1,0.1,9,9,CATACGACATTGATTCAGTG,0,2774887
ompRp1,0.1,9,9,CATACATCGCTGTGGCATCA,0,2779675
ompRp1,0.1,9,9,CAGTCATACATATGGAACTT,0,2806714
ompRp1,0.1,9,9,CAGGGTATTTGTATGCACTT,0,2783088
ompRp1,0.1,9,9,CAGCTGATGCAAACCCGCCC,0,2824246
ompRp1,0.1,9,9,CAGCTGATACGTGAACAACA,0,2783628
ompRp1,0.1,9,9,CAGCACCGCTAAGGACACGG,0,2807195
ompRp1,0.1,9,9,CAGAGGTATCTCCTCCGACA,0,2784813
ompRp1,0.1,9,9,CAGACAGTAAGACTATTCCT,0,2806028
ompRp1,0.1,9,9,CAGAATATTTTGAAATAACA,0,2820509
ompRp1,0.1,9,9,CAGAAGAATCACTAACGTAA,0,2804779
ompRp1,0.1,9,9,CAGAAAGTACAGTTAACGTT,0,2801372
ompRp1,0.1,9,9,CACTTAGGCGTACTACTCTA,0,2765837
ompRp1,0.1,9,9,CACGGTAGTCCGTCCATTTG,0,2824082
ompRp1,0.1,9,9,CACCGAGTGTAGCAATCACT,0,2813293
ompRp1,0.1,9,9,CACCCACCGGGTATTGCTAT,0,2786573
ompRp1,0.1,9,9,CACCAATTTAAGGTGTCACC,0,2769899
ompRp1,0.1,9,9,CACAGCCAGACCAGCAGTTC,0,2821177
ompRp1,0.1,9,9,CACACCTGAATGTAATGCCA,0,2794284
ompRp1,0.1,9,9,CAATACCTTCAACTGTCAAC,0,2766627
ompRp1,0.1,9,9,CAAGTGTCTCATGGAGTACA,0,2771537
ompRp1,0.1,9,9,CAAGACATGCACTTGTAAAA,0,2792563
ompRp1,0.1,9,9,CAAGAATATGTCGAATTGCG,0,2796869
ompRp1,0.1,9,9,CAACAATGGAACTGACGTCA,0,2792002
ompRp1,0.1,9,9,CAAACGCGTCAAAGTGTAAT,0,2790635
ompRp1,0.1,9,9,ATTTGATGTTCCTTCTATTT,0,2805769
ompRp1,0.1,9,9,ATTTCCTGGTGAGATTTGTA,0,2779974
ompRp1,0.1,9,9,ATTGGCCGGGCGTAGTCTAC,0,2765728
ompRp1,0.1,9,9,ATTGAGCGGTGTAGGCAGCT,0,2818521
ompRp1,0.1,9,9,ATTCTAGAACAGGATCGGCA,0,2813587
ompRp1,0.1,9,9,ATTCTAAAGGTGTCATGAAA,0,2799708
ompRp1,0.1,9,9,ATTCGCTCTACCAATCTACT,0,2783662
ompRp1,0.1,9,9,ATTCCTCTGACGGCGGGTGC,0,2771846
ompRp1,0.1,9,9,ATTCCTAGCGTACTTGCCCT,0,2791599
ompRp1,0.1,9,9,ATTCCCAACTGTACCGTCTT,0,2809619
ompRp1,0.1,9,9,ATTATTTGTCTGACTTTAGA,0,2787496
ompRp1,0.1,9,9,ATGTTATTATCTGAGGGTAA,0,2794401
ompRp1,0.1,9,9,ATGTTAGAGAACTCGGACAC,0,2802682
ompRp1,0.1,9,9,ATGTATACTGAAAAGCAGCA,0,2780983
ompRp1,0.1,9,9,ATGGTTGAGAAGCTTGTAGA,0,2792420
ompRp1,0.1,9,9,ATGGGGGCATCCCGTTAGAG,0,2812970
ompRp1,0.1,9,9,ATGCTGGCCTGGATATTTAC,0,2792386
ompRp1,0.1,9,9,ATGCCAGGCTCATATGCCCA,0,2824521
ompRp1,0.1,9,9,ATGCAGGACGCGTTTTTGAA,0,2800495
ompRp1,0.1,9,9,ATGACCCCTCTTATTGCGCT,0,2791823
ompRp1,0.1,9,9,ATCTGGCTACGCATGCAGCG,0,2772849
ompRp1,0.1,9,9,ATCTAACTAGAGTGGGCGGT,0,2773597
ompRp1,0.1,9,9,ATCGTAGTGGCAGGTCAGGG,0,2789754
ompRp1,0.1,9,9,ATCGTAGGCACGTTCATACC,0,2773503
ompRp1,0.1,9,9,ATCGGTCGCCTTGTGACCTG,0,2798382
ompRp1,0.1,9,9,ATCGCTAACAGTGGGATTGT,0,2768377
ompRp1,0.1,9,9,ATCGATTGTGTCATCATCAA,0,2792814
ompRp1,0.1,9,9,ATCCTGTCTTTTAACACCAA,0,2785219
ompRp1,0.1,9,9,ATCCGCTGGCCAGTCGGACC,0,2815450
ompRp1,0.1,9,9,ATCCACGGCGGACGGATTAC,0,2796264
ompRp1,0.1,9,9,ATCACGTCTTTTTACTGACG,0,2785639
ompRp1,0.1,9,9,ATCACCTCAGGACCTTATAG,0,2818330
ompRp1,0.1,9,9,ATATTGTTACGGAGCAAGAA,0,2785049
ompRp1,0.1,9,9,ATATGGGTTAGGTTAGGCCT,0,2798619
ompRp1,0.1,9,9,ATACTGACAAAACGAGTCCA,0,2811440
ompRp1,0.1,9,9,ATACTCCGAACTCCTTCTAC,0,2778110
ompRp1,0.1,9,9,ATACGCCATAACTCGGTCTT,0,2791060
ompRp1,0.1,9,9,ATAAACCGGCGGAGTTTCAC,0,2782200
ompRp1,0.1,9,9,AGTTGGAATGTTTGACCCAG,0,2800323
ompRp1,0.1,9,9,AGTTGCTGTAGCGAATTTCC,0,2792916
ompRp1,0.1,9,9,AGTTGACTCGTACCCGTACT,0,2786173
ompRp1,0.1,9,9,AGTTACCCGGGTATACCGCG,0,2788288
ompRp1,0.1,9,9,AGTGTATGAATGATCAGTCC,0,2783935
ompRp1,0.1,9,9,AGTGGGCCAGACCCCAGGAT,0,2765473
ompRp1,0.1,9,9,AGTGGAACATCTCGGGTTCA,0,2787383
ompRp1,0.1,9,9,AGTCTCCACCGGAACGTTAT,0,2770483
ompRp1,0.1,9,9,AGTCGGTGTGCATTGGCCAA,0,2782373
ompRp1,0.1,9,9,AGTAACAACCTGATCTGTAA,0,2810127
ompRp1,0.1,9,9,AGGTTTAGGCTTACCGCGTT,0,2784110
ompRp1,0.1,9,9,AGGTTGGAAGGACTAGCGCC,0,2817559
ompRp1,0.1,9,9,AGGTGGGTGTGCCATTTGCA,0,2803604
ompRp1,0.1,9,9,AGGTCCCAACCGTGTGTCGG,0,2770296
ompRp1,0.1,9,9,AGGTAGCTGGGCAACTTCTC,0,2814891
ompRp1,0.1,9,9,AGGGTCCTTCCACATCGTCC,0,2775730
ompRp1,0.1,9,9,AGGGGTTACCGTGGGACATA,0,2816874
ompRp1,0.1,9,9,AGGGCTTTTCAGACACTAAA,0,2778184
ompRp1,0.1,9,9,AGGGACTTCCATATTATTCA,0,2800871
ompRp1,0.1,9,9,AGGGACAGGAATAGCAGTGA,0,2799845
ompRp1,0.1,9,9,AGGGACAGCCACCGACATGT,0,2804713
ompRp1,0.1,9,9,AGGATATGATTACATTCGAC,0,2818049
ompRp1,0.1,9,9,AGGAGGCGTTAGCCCATTGT,0,2772387
ompRp1,0.1,9,9,AGCTGTGGTGCGCAAACTAT,0,2769747
ompRp1,0.1,9,9,AGCTGCACTCCTGTGCTACA,0,2794954
ompRp1,0.1,9,9,AGCTAAAGTTAAGCGGCAGC,0,2778651
ompRp1,0.1,9,9,AGCGGCGATCTACCCCGATA,0,2800733
ompRp1,0.1,9,9,AGCACTCTTTCTCACTTTCT,0,2772714
ompRp1,0.1,9,9,AGATGATGGCATGGGGAGCA,0,2776844
ompRp1,0.1,9,9,AGAGTCGGTGACTTAGGGGT,0,2780091
ompRp1,0.1,9,9,AGAGGCCCTCGGCGTAACGC,0,2773355
ompRp1,0.1,9,9,AGAGCGGGGTCAGTAATGTT,0,2782457
ompRp1,0.1,9,9,AGAGCGGGGAATCAGATGAC,0,2771361
ompRp1,0.1,9,9,AGACGCTGATCGCATCTAAC,0,2800638
ompRp1,0.1,9,9,AGACGCCAGGAACCACTTAT,0,2766521
ompRp1,0.1,9,9,AGACCATTGGTTAGGTGGTA,0,2780568
ompRp1,0.1,9,9,ACTTTTGTGACTCGCTGCCA,0,2816318
ompRp1,0.1,9,9,ACTTGTTTCCTTTTCACGCA,0,2766042
ompRp1,0.1,9,9,ACTGGATCAAGTACCCCCGT,0,2805330
ompRp1,0.1,9,9,ACTGAGCGGGCGCATAACTG,0,2795133
ompRp1,0.1,9,9,ACTCTAAGGCAAGTTACTAG,0,2777718
ompRp1,0.1,9,9,ACTCGTCAGTGCCTAACAAA,0,2791817
ompRp1,0.1,9,9,ACTCGATGGTAGTGACAGTA,0,2776764
ompRp1,0.1,9,9,ACTATAGCATGTTGAGTATC,0,2791996
ompRp1,0.1,9,9,ACGTTGGTTCTATTTATCAT,0,2811155
ompRp1,0.1,9,9,ACGTGGCTCACCTAGGGTGT,0,2772647
ompRp1,0.1,9,9,ACGTGGCATAGGCCACTATT,0,2769189
ompRp1,0.1,9,9,ACGGTGCGGCCCAGGGTGTC,0,2812889
ompRp1,0.1,9,9,ACGGGGGAATTCTGAGATAT,0,2779532
ompRp1,0.1,9,9,ACGGCTGGTAACATGTAGGA,0,2795991
ompRp1,0.1,9,9,ACGGCTACCCCAGGAGCTAC,0,2773021
ompRp1,0.1,9,9,ACGGCGTAATCCCGATATTA,0,2814003
ompRp1,0.1,9,9,ACGCTCCGGTAGCGGGTAGA,0,2804128
ompRp1,0.1,9,9,ACGCTCAGAAGCGGTTTGTT,0,2808332
ompRp1,0.1,9,9,ACGAGGGGTGTTCGGAGCAT,0,2782044
ompRp1,0.1,9,9,ACGAAAAGATTATTGTCGGC,0,2784713
ompRp1,0.1,9,9,ACCTTTCAGGAGCCTGGCGT,0,2812466
ompRp1,0.1,9,9,ACCTGTTTAAGTGCATGTGC,0,2783588
ompRp1,0.1,9,9,ACCTCTGCGGGTACCGACTA,0,2783803
ompRp1,0.1,9,9,ACCGTTGATTTGTCATAGTG,0,2769959
ompRp1,0.1,9,9,ACCGTCCCAGTGCACAAAAG,0,2769270
ompRp1,0.1,9,9,ACCGCACGCGCGCACCCTGT,0,2769095
ompRp1,0.1,9,9,ACCGATAAATCAATGGCTAA,0,2796324
ompRp1,0.1,9,9,ACCCTAAGCATCTGTTACAG,0,2776935
ompRp1,0.1,9,9,ACCCGTCTGTTGCTACTCTT,0,2776401
ompRp1,0.1,9,9,ACCCGAGCCAGGCTTCGTCC,0,2815035
ompRp1,0.1,9,9,ACCCCGGTCCATGGGTCGTT,0,2823516
ompRp1,0.1,9,9,ACCCAGAGCTCAACCCCAGT,0,2778442
ompRp1,0.1,9,9,ACCATGTGTACCCGTGAAGC,0,2803036
ompRp1,0.1,9,9,ACCATGCAGCGCAACCTTAG,0,2810805
ompRp1,0.1,9,9,ACCAGTAGTATAGTTGGTCA,0,2813091
ompRp1,0.1,9,9,ACCACCTTTAAGCGCTACAA,0,2780437
ompRp1,0.1,9,9,ACCAAATATCGGACCCGTGA,0,2778936
ompRp1,0.1,9,9,ACAGTAATCACTAGGGAGTT,0,2808788
ompRp1,0.1,9,9,ACAGAAAACTATTCCATAGG,0,2767158
ompRp1,0.1,9,9,ACACGTTGAAGCCTCAAGGA,0,2783629
ompRp1,0.1,9,9,ACACAGAAGGCATGCAATTA,0,2765547
ompRp1,0.1,9,9,ACAAAGTCTCCTGAACTCAA,0,2797543
ompRp1,0.1,9,9,AATTCCGATCATGTTATGTA,0,2780042
ompRp1,0.1,9,9,AATGAGTAAGCTGTTTATCT,0,2785281
ompRp1,0.1,9,9,AATGAGGTCCGCGGTCGCAA,0,2805753
ompRp1,0.1,9,9,AATCTTACGCAGCGGCCTCA,0,2820175
ompRp1,0.1,9,9,AATCGCCATGCTTCCGGTAC,0,2808634
ompRp1,0.1,9,9,AATCCGTGGAGTGTTTTTTG,0,2772504
ompRp1,0.1,9,9,AATCAAGACCTATCAGAAAG,0,2793165
ompRp1,0.1,9,9,AATCAAAATTCCAGGATCTA,0,2788391
ompRp1,0.1,9,9,AATAGGGCATGCTTAACTGA,0,2770107
ompRp1,0.1,9,9,AAGTTAATGACGCTCCAATA,0,2793936
ompRp1,0.1,9,9,AAGTGGCCTAAATGTCTTCA,0,2782273
ompRp1,0.1,9,9,AAGGGCGCAGCTCGTTGACA,0,2811032
ompRp1,0.1,9,9,AAGGCTGTGTGCCATCTAAT,0,2807413
ompRp1,0.1,9,9,AAGGCATCAATATTGCTTCC,0,2775092
ompRp1,0.1,9,9,AAGGAATAAGTGTAAGTGAT,0,2792996
ompRp1,0.1,9,9,AAGCGTAGTCACTAAAATAT,0,2788584
ompRp1,0.1,9,9,AAGCAGCCCCCGGTACTCAC,0,2812095
ompRp1,0.1,9,9,AAGCAATGAGCTCAAGTTAC,0,2769234
ompRp1,0.1,9,9,AAGAGTAAGCTGCGTACGAG,0,2769838
ompRp1,0.1,9,9,AAGACGTAAGCCATTTACTA,0,2812612
ompRp1,0.1,9,9,AACGGCTCGAAAATGGTTAC,0,2781744
ompRp1,0.1,9,9,AACGGCGAAGACGATATACT,0,2813593
ompRp1,0.1,9,9,AACGCTGAGGGTGCTGGAAT,0,2820775
ompRp1,0.1,9,9,AACGCACCGAACTTCTGGTG,0,2807388
ompRp1,0.1,9,9,AACGAACGGGTAAATATCAG,0,2791937
ompRp1,0.1,9,9,AACCGCGCTTGAGGAGGAGC,0,2821557
ompRp1,0.1,9,9,AACATATTAAACCTGGTTTA,0,2823192
ompRp1,0.1,9,9,AACACACCCAGGCAATTATA,0,2800207
ompRp1,0.1,9,9,AACAATATGTGTGTTCTTTG,0,2791438
ompRp1,0.1,9,9,AAATTGAGTCATGCGCGGAT,0,2807623
ompRp1,0.1,9,9,AAATTCATCGCACTTGGAAT,0,2778118
ompRp1,0.1,9,9,AAAGTGTGGCCACGGAACAT,0,2765552
ompRp1,0.1,9,9,AAAGGCGACGCCTTGCGCTA,0,2783847
ompRp1,0.1,9,9,AAACGTTTGGTCTAAGGAAA,0,2818137
ompRp1,0.1,9,9,AAACCTTACCCTACTATTGG,0,2821765
ompRp1,0.1,9,9,AAACCGTTCAGATCTAAGCG,0,2785565
ompRp1,0.1,9,9,AAACACGTCCAGTTCAAGTC,0,2802991
ompRp1,0.1,9,9,AAAATCTTCATAGTACTGTG,0,2773132
ompRp1,0.1,9,9,AAAAGACACACGCAAATTGA,0,2793386
ompRp1,0.1,9,9,AAAAAAAATGGCAAAGTTTC,0,2782241
ompRp1,0.1111111111111111,8,8,TTTTTTTTGTAGGAGCCATC,0,2786418
ompRp1,0.1111111111111111,8,8,TTTTTTCAATTTACAGTATT,0,2816261
ompRp1,0.1111111111111111,8,8,TTTTAGATTCTATGCAAATA,0,2820476
ompRp1,0.1111111111111111,8,8,TTTGTTCTGTAGTAAATATA,0,2791442
ompRp1,0.1111111111111111,8,8,TTTGATAGCGGCGCGAGGCT,0,2802954
ompRp1,0.1111111111111111,8,8,TTTCGGGGAAAGGAACTAGC,0,2824255
ompRp1,0.1111111111111111,8,8,TTGTGGGGTCGCGGTCAAGG,0,2796401
ompRp1,0.1111111111111111,8,8,TTGTACTGATTTATCTTTTC,0,2803090
ompRp1,0.1111111111111111,8,8,TTGGGCCTTTCCATTCCCGA,0,2779980
ompRp1,0.1111111111111111,8,8,TTGGAAACCAAGGACTTCAG,0,2811367
ompRp1,0.1111111111111111,8,8,TTGCGCTGCTACGCTCCGGT,0,2798462
ompRp1,0.1111111111111111,8,8,TTGCGCTCAGAGAGATGCTC,0,2767233
ompRp1,0.1111111111111111,8,8,TTGCCTTATCAGGCTAAATT,0,2820219
ompRp1,0.1111111111111111,8,8,TTGCCCGGTCGAGTTTGTCC,0,2817173
ompRp1,0.1111111111111111,8,8,TTGCCACCCTACTTTTCGCT,0,2767073
ompRp1,0.1111111111111111,8,8,TTGACTAATAAACACATGTC,0,2820541
ompRp1,0.1111111111111111,8,8,TTCTTTAAAGCGTGTCGTTC,0,2805483
ompRp1,0.1111111111111111,8,8,TTCTAGCACTCCTGACCCTC,0,2817762
ompRp1,0.1111111111111111,8,8,TTCGGAAAAGCGCTGTAGGT,0,2799769
ompRp1,0.1111111111111111,8,8,TTCGCCCGTCCAGACCGCGG,0,2803244
ompRp1,0.1111111111111111,8,8,TTCCGTTGTAGACGAACGCT,0,2778868
ompRp1,0.1111111111111111,8,8,TTCCCGGGGGTTCATATTTA,0,2776605
ompRp1,0.1111111111111111,8,8,TTCAGCATTTGTGGAGCGAT,0,2784025
ompRp1,0.1111111111111111,8,8,TTCAGATCTTGAAGCCTAGA,0,2791594
ompRp1,0.1111111111111111,8,8,TTATGGTTATAGGGTAGGGG,0,2814985
ompRp1,0.1111111111111111,8,8,TTATCCGGAACTTTTTGGGT,0,2793623
ompRp1,0.1111111111111111,8,8,TTAGTCGCTAGGGCGAAGCG,0,2765387
ompRp1,0.1111111111111111,8,8,TTAGGTTAAAACTTGCTGTG,0,2772587
ompRp1,0.1111111111111111,8,8,TTACCGGACTACCACAATAA,0,2776979
ompRp1,0.1111111111111111,8,8,TTACCAGACATCATTGAATC,0,2782162
ompRp1,0.1111111111111111,8,8,TTAAGTCCGCTGCGTTCTAA,0,2794670
ompRp1,0.1111111111111111,8,8,TGTTTTTAATGGGTGTACAG,0,2802080
ompRp1,0.1111111111111111,8,8,TGTTGGTTAACACATCTTTC,0,2820107
ompRp1,0.1111111111111111,8,8,TGTTACCGGAGATGATGGGT,0,2768970
ompRp1,0.1111111111111111,8,8,TGTGTTCTTTTTGTCACCCC,0,2806040
ompRp1,0.1111111111111111,8,8,TGTGGGATCACAGGGTAATG,0,2783888
ompRp1,0.1111111111111111,8,8,TGTCTATGCACCAAAGCCTA,0,2822849
ompRp1,0.1111111111111111,8,8,TGGTAAATTCATGCGGTAAC,0,2817153
ompRp1,0.1111111111111111,8,8,TGGGTAACAGTTACCCTGCA,0,2809511
ompRp1,0.1111111111111111,8,8,TGGGCGTCACCTAATGTCCA,0,2803958
ompRp1,0.1111111111111111,8,8,TGGGCAACGACGGCGCATCC,0,2802799
ompRp1,0.1111111111111111,8,8,TGGGCAACAATTCAGTCTTG,0,2781939
ompRp1,0.1111111111111111,8,8,TGGCAGCATCTGCGCGGATA,0,2795427
ompRp1,0.1111111111111111,8,8,TGGCACGTCAAGAGAAGATA,0,2802571
ompRp1,0.1111111111111111,8,8,TGCTCTTTCAGAATTTAAGT,0,2812441
ompRp1,0.1111111111111111,8,8,TGCTACACCCATGCTTAATC,0,2815169
ompRp1,0.1111111111111111,8,8,TGCGTATCTCCCTTTACCCG,0,2773428
ompRp1,0.1111111111111111,8,8,TGCGGATGACAGCGGAAATG,0,2782965
ompRp1,0.1111111111111111,8,8,TGCGCAGTCGGAACGGCTTT,0,2818277
ompRp1,0.1111111111111111,8,8,TGCCGATTCCCGTCTATACC,0,2823598
ompRp1,0.1111111111111111,8,8,TGCCGAGGCGCGGGGAAGAA,0,2800117
ompRp1,0.1111111111111111,8,8,TGCCAGCAACTGCCAGCAGG,0,2772021
ompRp1,0.1111111111111111,8,8,TGCCACTGCAGATCACTATT,0,2797371
ompRp1,0.1111111111111111,8,8,TGCATTCATACGCTATATTT,0,2805389
ompRp1,0.1111111111111111,8,8,TGCATGTGCAGGGGTGCCGT,0,2769857
ompRp1,0.1111111111111111,8,8,TGCAGTCTCCGGGGGGCCCG,0,2793736
ompRp1,0.1111111111111111,8,8,TGCAGTCACTGTATCCGTTC,0,2790827
ompRp1,0.1111111111111111,8,8,TGCACGCTGACCCATAGTTT,0,2821119
ompRp1,0.1111111111111111,8,8,TGATTGCCCACATATCGTCG,0,2781324
ompRp1,0.1111111111111111,8,8,TGATTGAGAGTCTATCTCGG,0,2772069
ompRp1,0.1111111111111111,8,8,TGATTACAACCAGTTTCGGA,0,2789837
ompRp1,0.1111111111111111,8,8,TGAGTGCAGATCCGGTCGCT,0,2778565
ompRp1,0.1111111111111111,8,8,TGACCCGGTCAAATATTGCG,0,2781472
ompRp1,0.1111111111111111,8,8,TGAATAGCGGTGTCCTCGGC,0,2769015
ompRp1,0.1111111111111111,8,8,TGAACTGGCTTAGTAGAGCC,0,2766534
ompRp1,0.1111111111111111,8,8,TGAAAATGCATAAATCCGTA,0,2823312
ompRp1,0.1111111111111111,8,8,TCTTCCTAAGCATGGCTGCT,0,2781185
ompRp1,0.1111111111111111,8,8,TCTTCACGACTGCATGTTCT,0,2781410
ompRp1,0.1111111111111111,8,8,TCTGTACTGCCTCAGTAGTT,0,2772406
ompRp1,0.1111111111111111,8,8,TCTGCCTATGTAGCTACGGA,0,2820837
ompRp1,0.1111111111111111,8,8,TCTATCCGTTATAGCCCCTG,0,2819412
ompRp1,0.1111111111111111,8,8,TCGTTGTCGGCCACTACAAC,0,2776933
ompRp1,0.1111111111111111,8,8,TCGTGCTATGGATGCTCCCA,0,2791156
ompRp1,0.1111111111111111,8,8,TCGTGACGGTACCCCAAGGC,0,2769239
ompRp1,0.1111111111111111,8,8,TCGGGTATGTATACACATGT,0,2804968
ompRp1,0.1111111111111111,8,8,TCGGGGGCTACCTCGGGTTC,0,2788250
ompRp1,0.1111111111111111,8,8,TCGGCGTACGGCGGTAGATA,0,2787075
ompRp1,0.1111111111111111,8,8,TCGGCGTAACGTAGCGGCGA,0,2772767
ompRp1,0.1111111111111111,8,8,TCGGCCAGATTCCCTGGACA,0,2818571
ompRp1,0.1111111111111111,8,8,TCGGCACGTGGCTGGTATTC,0,2789702
ompRp1,0.1111111111111111,8,8,TCGCCGCTTCGGATGGTGAA,0,2781400
ompRp1,0.1111111111111111,8,8,TCGCAGAATGCCAGCGTTCT,0,2803047
ompRp1,0.1111111111111111,8,8,TCGAGTGGGGTATACTCCTA,0,2775652
ompRp1,0.1111111111111111,8,8,TCGAGGCTTTGCCGCTGACT,0,2798864
ompRp1,0.1111111111111111,8,8,TCGAGCTAGTATAGCGGGGA,0,2806879
ompRp1,0.1111111111111111,8,8,TCGAGAAAGTTGTCGAAACT,0,2814745
ompRp1,0.1111111111111111,8,8,TCGACTGGATGTGGTCTAGT,0,2812268
ompRp1,0.1111111111111111,8,8,TCGAATCGGCAGACGTAAGC,0,2812690
ompRp1,0.1111111111111111,8,8,TCCTTTAGGTATTTGCGACA,0,2810310
ompRp1,0.1111111111111111,8,8,TCCTTGGCGACGCTCGTCAA,0,2776427
ompRp1,0.1111111111111111,8,8,TCCTTGGATACTTATCGATC,0,2775352
ompRp1,0.1111111111111111,8,8,TCCTGCATACGTGGTGCCTA,0,2785896
ompRp1,0.1111111111111111,8,8,TCCGTGCGAAGACGCACTGT,0,2786440
ompRp1,0.1111111111111111,8,8,TCCGCGTGTACGCAAGGTCT,0,2797804
ompRp1,0.1111111111111111,8,8,TCCCTGGTTTCCTCGCAGGG,0,2798101
ompRp1,0.1111111111111111,8,8,TCCCTCGCTACATTGAATCT,0,2807751
ompRp1,0.1111111111111111,8,8,TCCCGTGGGCCACATGCCCT,0,2814550
ompRp1,0.1111111111111111,8,8,TCCATCGAACTACAACCCTG,0,2788817
ompRp1,0.1111111111111111,8,8,TCATGGACAGGGTGAAGAAT,0,2790089
ompRp1,0.1111111111111111,8,8,TCATCTCGAGCACAGCGGAT,0,2788527
ompRp1,0.1111111111111111,8,8,TCATAGTACCGTTGTCTCGA,0,2820553
ompRp1,0.1111111111111111,8,8,TCAGGCAGCCGTATCCCCAA,0,2772227
ompRp1,0.1111111111111111,8,8,TCAGGATGGTGCGGCCGATC,0,2794159
ompRp1,0.1111111111111111,8,8,TCAGCGTTCTCGTACGTCCC,0,2822382
ompRp1,0.1111111111111111,8,8,TCAGCGACGACCCATAGTTT,0,2786050
ompRp1,0.1111111111111111,8,8,TCAGAGGTTCCAAAGCATTG,0,2770665
ompRp1,0.1111111111111111,8,8,TCACTAGGTTTACGGGTCTA,0,2783684
ompRp1,0.1111111111111111,8,8,TCACACGGGTCTTGGGCATC,0,2777987
ompRp1,0.1111111111111111,8,8,TCACACCACACCGCTTTCCC,0,2824163
ompRp1,0.1111111111111111,8,8,TATTCCCCTAGCGGGCAGTC,0,2799382
ompRp1,0.1111111111111111,8,8,TATTAGGTGGTGCCCAAAGT,0,2793681
ompRp1,0.1111111111111111,8,8,TATTAGGAGGCGGAGTTGAA,0,2777792
ompRp1,0.1111111111111111,8,8,TATCATGTGTGCGAAATTTG,0,2789840
ompRp1,0.1111111111111111,8,8,TATACCGGATGAGCCCTGAA,0,2785862
ompRp1,0.1111111111111111,8,8,TATAAGGGGATCAGGCCATT,0,2819258
ompRp1,0.1111111111111111,8,8,TAGGTGATGGAGTGCTGACA,0,2819193
ompRp1,0.1111111111111111,8,8,TAGGGTTCCAAAGGGTACCT,0,2766711
ompRp1,0.1111111111111111,8,8,TAGCTACGGCAGTGTCACAC,0,2796792
ompRp1,0.1111111111111111,8,8,TAGCGGGCTCACCATGTGGA,0,2819833
ompRp1,0.1111111111111111,8,8,TAGCGATTGGTTTGAGACAT,0,2786334
ompRp1,0.1111111111111111,8,8,TAGCCCACATTTGCGGGCGT,0,2772084
ompRp1,0.1111111111111111,8,8,TAGATGTGTGATATAGTGAT,0,2792314
ompRp1,0.1111111111111111,8,8,TAGAGGGCGCTCGGGCTCTA,0,2824034
ompRp1,0.1111111111111111,8,8,TAGACTCGGTGGGTTTGCCG,0,2788394
ompRp1,0.1111111111111111,8,8,TACGTAACTCAGCGAGTGTA,0,2803985
ompRp1,0.1111111111111111,8,8,TACGGGAACAGCCAAGGTAC,0,2787745
ompRp1,0.1111111111111111,8,8,TACGACTCGGCGTGTCAGTA,0,2801049
ompRp1,0.1111111111111111,8,8,TACCTACATGCGAGGGGATA,0,2799642
ompRp1,0.1111111111111111,8,8,TACCCGGGGTTTTTTGCCAG,0,2774152
ompRp1,0.1111111111111111,8,8,TACAGCGCTAAAATGGGGAT,0,2778971
ompRp1,0.1111111111111111,8,8,TACAAGAACAATTCGTGAGC,0,2766639
ompRp1,0.1111111111111111,8,8,TAATTAGCTCCAGCCTAAGG,0,2816717
ompRp1,0.1111111111111111,8,8,TAAGACTATCTCTCTTAATC,0,2779261
ompRp1,0.1111111111111111,8,8,TAACTATGGATATTGACTAA,0,2809552
ompRp1,0.1111111111111111,8,8,TAACGGTACGGGCTGTAGGC,0,2813314
ompRp1,0.1111111111111111,8,8,TAACCCGGTCTTGAGATCTC,0,2811447
ompRp1,0.1111111111111111,8,8,TAAATAGGGTTACGGCCCAG,0,2781722
ompRp1,0.1111111111111111,8,8,TAAATACCCCATGCTACCCC,0,2800912
ompRp1,0.1111111111111111,8,8,TAAAGGGAGCAAACCTCTTC,0,2817220
ompRp1,0.1111111111111111,8,8,TAAAAGGCAACCCTACACGA,0,2777743
ompRp1,0.1111111111111111,8,8,GTTTTCAACGTTCGGTTATA,0,2770869
ompRp1,0.1111111111111111,8,8,GTTTGAAGGTCGTTTACTTC,0,2781406
ompRp1,0.1111111111111111,8,8,GTTTCTCGATACCCGGTTGA,0,2779025
ompRp1,0.1111111111111111,8,8,GTTTCGGAATGTGGCCTGCG,0,2771586
ompRp1,0.1111111111111111,8,8,GTTGGTGCGCGGATTCTTAT,0,2819308
ompRp1,0.1111111111111111,8,8,GTTGGGGAATCCGTCGTACA,0,2780019
ompRp1,0.1111111111111111,8,8,GTTGCATCCCGCGCAATAAA,0,2792290
ompRp1,0.1111111111111111,8,8,GTTCGCTCACGGATGCCACT,0,2786511
ompRp1,0.1111111111111111,8,8,GTTCGCACCTCTCTAGATCG,0,2796108
ompRp1,0.1111111111111111,8,8,GTTCAGAGACTCCGATGTTA,0,2798006
ompRp1,0.1111111111111111,8,8,GTTATGGTCCCGACTGACAG,0,2816578
ompRp1,0.1111111111111111,8,8,GTTAACGGAAAGCCCAGTAG,0,2794710
ompRp1,0.1111111111111111,8,8,GTGTGGGGCCGTAGAGTGAA,0,2809898
ompRp1,0.1111111111111111,8,8,GTGTCGTTTGGCGTGGAGCA,0,2785522
ompRp1,0.1111111111111111,8,8,GTGGGTCCCTGGGATGGCTC,0,2798400
ompRp1,0.1111111111111111,8,8,GTGGCACCGCTGATGTTGCT,0,2798903
ompRp1,0.1111111111111111,8,8,GTGCGTGAATAATGATTAGA,0,2814590
ompRp1,0.1111111111111111,8,8,GTGCCTTTCGATTTTCAATC,0,2797659
ompRp1,0.1111111111111111,8,8,GTGAAGTTTGTTAAGACCAC,0,2783677
ompRp1,0.1111111111111111,8,8,GTGAAAAAGAGTGAGTTTCC,0,2796043
ompRp1,0.1111111111111111,8,8,GTCTTCATACCCTGATGGAT,0,2776885
ompRp1,0.1111111111111111,8,8,GTCTCCATTAAACTACAATA,0,2818536
ompRp1,0.1111111111111111,8,8,GTCGGTGGATATCCTACTAC,0,2784370
ompRp1,0.1111111111111111,8,8,GTCCGGCAACCGTGCTAAGA,0,2799799
ompRp1,0.1111111111111111,8,8,GTCCCTTCATTTAAGGCCCA,0,2790390
ompRp1,0.1111111111111111,8,8,GTCCCAGGATGTCTTTTCAC,0,2810673
ompRp1,0.1111111111111111,8,8,GTCCATGACTACTAGGGATG,0,2805412
ompRp1,0.1111111111111111,8,8,GTCATTAAGACCCGGCGAGA,0,2795887
ompRp1,0.1111111111111111,8,8,GTCAACGAAACGCGCCTTTG,0,2823599
ompRp1,0.1111111111111111,8,8,GTCAAACCGGTATACAATCA,0,2779885
ompRp1,0.1111111111111111,8,8,GTCAAAAACTCTCTGTCTCC,0,2787152
ompRp1,0.1111111111111111,8,8,GTATTTCCTGACAGGATGAC,0,2814208
ompRp1,0.1111111111111111,8,8,GTATTCCGTTCGATTGTTAG,0,2821794
ompRp1,0.1111111111111111,8,8,GTATGGGCATAATCGCGTGG,0,2791610
ompRp1,0.1111111111111111,8,8,GTATGGAGTATTGCCGCGGA,0,2811049
ompRp1,0.1111111111111111,8,8,GTATACCATCCCAAATCTAC,0,2782796
ompRp1,0.1111111111111111,8,8,GTAGTATGCGGCGAATCTGG,0,2792851
ompRp1,0.1111111111111111,8,8,GTAGTACAATTCCTAAGACT,0,2811375
ompRp1,0.1111111111111111,8,8,GTACTATGGCCACCCGCGCA,0,2790726
ompRp1,0.1111111111111111,8,8,GTACCGAAGGACGTATCTTG,0,2819147
ompRp1,0.1111111111111111,8,8,GTAATTGTAAGTTTGAGAAC,0,2800583
ompRp1,0.1111111111111111,8,8,GTAATTCGGTTGGTTCCATT,0,2765639
ompRp1,0.1111111111111111,8,8,GTAAGCGTCTGGTTTTGCTT,0,2816851
ompRp1,0.1111111111111111,8,8,GTAACAATGAATTCCAGTTA,0,2815882
ompRp1,0.1111111111111111,8,8,GGTTTTCGACCGTCGTACAA,0,2805956
ompRp1,0.1111111111111111,8,8,GGTTTGAAGGGCTCTCATAA,0,2817163
ompRp1,0.1111111111111111,8,8,GGTTTACCGAGTGGCACCAC,0,2770750
ompRp1,0.1111111111111111,8,8,GGTTTAAGCGAGAAGACCTA,0,2774198
ompRp1,0.1111111111111111,8,8,GGTTGTAGAGGGGCAGAGTG,0,2801740
ompRp1,0.1111111111111111,8,8,GGTTAAGTAACGGTAGGCGA,0,2804297
ompRp1,0.1111111111111111,8,8,GGTGGTGAAAGCGGCAGGAA,0,2796318
ompRp1,0.1111111111111111,8,8,GGTGCAGTGTCCAGAACAAG,0,2804079
ompRp1,0.1111111111111111,8,8,GGTCTTCTGCTGAGCAGCGC,0,2798621
ompRp1,0.1111111111111111,8,8,GGTCTGTGTCCAACTTTTAT,0,2779264
ompRp1,0.1111111111111111,8,8,GGTCTATAAATGTAGGGACA,0,2790971
ompRp1,0.1111111111111111,8,8,GGTATCCTCCTAAATAAGGT,0,2784626
ompRp1,0.1111111111111111,8,8,GGTAGGGTTGGGCGTTGGCA,0,2813067
ompRp1,0.1111111111111111,8,8,GGTAGGCCGACGTTACCAAG,0,2821718
ompRp1,0.1111111111111111,8,8,GGTACATTGCTCACAGATGA,0,2810628
ompRp1,0.1111111111111111,8,8,GGTAAGTTGGGACACCTGCA,0,2821035
ompRp1,0.1111111111111111,8,8,GGGTGACTCGAGCAAATGTA,0,2775582
ompRp1,0.1111111111111111,8,8,GGGGGCTTTGGTCGTCAAGC,0,2769426
ompRp1,0.1111111111111111,8,8,GGGGACCGTACACAGGTAGA,0,2781154
ompRp1,0.1111111111111111,8,8,GGGGACCAACATATTCTGAT,0,2771442
ompRp1,0.1111111111111111,8,8,GGGCTTGACCAAGCGTCATG,0,2819406
ompRp1,0.1111111111111111,8,8,GGGCGTGTCAATGATCTCTG,0,2814881
ompRp1,0.1111111111111111,8,8,GGGCCTCACGGCCTAAGATT,0,2791843
ompRp1,0.1111111111111111,8,8,GGGCCAAACGTATCCTATCG,0,2810378
ompRp1,0.1111111111111111,8,8,GGGATAGTCCCGTCCTACCC,0,2806046
ompRp1,0.1111111111111111,8,8,GGGATAAGGCGTCCTAAACA,0,2781683
ompRp1,0.1111111111111111,8,8,GGGAGCTGTAAGCTTGCCTT,0,2786892
ompRp1,0.1111111111111111,8,8,GGGAAGTTCGACTCGAAGTG,0,2799942
ompRp1,0.1111111111111111,8,8,GGCTATAGAATCACATATTC,0,2789475
ompRp1,0.1111111111111111,8,8,GGCGGTCGGTATTCTTTCAA,0,2782549
ompRp1,0.1111111111111111,8,8,GGCGGAGACAGGTCCCGGAA,0,2774305
ompRp1,0.1111111111111111,8,8,GGCGAGGCTGTAGTGTACGA,0,2794854
ompRp1,0.1111111111111111,8,8,GGCCCGGAGGGTTGCATTAG,0,2783692
ompRp1,0.1111111111111111,8,8,GGCCCACTTTCGAGGACTAA,0,2822012
ompRp1,0.1111111111111111,8,8,GGCAAGTAGGCCCACTAAAA,0,2795571
ompRp1,0.1111111111111111,8,8,GGCAAGGGAGACAATGTTTA,0,2800242
ompRp1,0.1111111111111111,8,8,GGATGCTATTTCAACAGCGC,0,2783072
ompRp1,0.1111111111111111,8,8,GGATCCCCTGAAGAAAAGTG,0,2778353
ompRp1,0.1111111111111111,8,8,GGAGGAACGTGTGACTTAGA,0,2809247
ompRp1,0.1111111111111111,8,8,GGAGAGCGCAAGGCTCTCCA,0,2812944
ompRp1,0.1111111111111111,8,8,GGACCGTAAATAATCTTACA,0,2806032
ompRp1,0.1111111111111111,8,8,GGACCCGCGAAGTTCGGCGG,0,2823214
ompRp1,0.1111111111111111,8,8,GGAAGCCCTCGCGACTCCCA,0,2808550
ompRp1,0.1111111111111111,8,8,GCTTGAATCTCGGCGAGACC,0,2773105
ompRp1,0.1111111111111111,8,8,GCTTCACTTTGTTGGAAGGA,0,2820443
ompRp1,0.1111111111111111,8,8,GCTCTAAAGAGTATACCACA,0,2790571
ompRp1,0.1111111111111111,8,8,GCTCCACCCGCGGGCCTATT,0,2766752
ompRp1,0.1111111111111111,8,8,GCTCATTCTTTGCAAGTCCT,0,2771194
ompRp1,0.1111111111111111,8,8,GCTATGCGCACTAGCTACGG,0,2804394
ompRp1,0.1111111111111111,8,8,GCTAGATGTCTAATGGGAAT,0,2807147
ompRp1,0.1111111111111111,8,8,GCTAATATATATGCTCGAGA,0,2784368
ompRp1,0.1111111111111111,8,8,GCGTTGGTTCCGGCGGTTAT,0,2819169
ompRp1,0.1111111111111111,8,8,GCGTTCACGCCTCTCTTCAC,0,2770373
ompRp1,0.1111111111111111,8,8,GCGTGTCAGGATGCGGTTAA,0,2793993
ompRp1,0.1111111111111111,8,8,GCGTCCCATGCTAAATACTT,0,2804652
ompRp1,0.1111111111111111,8,8,GCGTCATCATACGACATAAA,0,2793232
ompRp1,0.1111111111111111,8,8,GCGTATAGGTTCTAATCCGG,0,2793912
ompRp1,0.1111111111111111,8,8,GCGTACCCAAGCACCCATGT,0,2785441
ompRp1,0.1111111111111111,8,8,GCGGGCATCCCGTCCGTTCC,0,2792482
ompRp1,0.1111111111111111,8,8,GCGGGACATACATATCTTGT,0,2780487
ompRp1,0.1111111111111111,8,8,GCGGCTGTTTGGCATACATT,0,2824669
ompRp1,0.1111111111111111,8,8,GCGGCGCGGGCCTATTAACG,0,2782016
ompRp1,0.1111111111111111,8,8,GCGCTTACTGGACCGGAATT,0,2773104
ompRp1,0.1111111111111111,8,8,GCGCTAGACTAAGACTTAGT,0,2811491
ompRp1,0.1111111111111111,8,8,GCGCACTTAGTGTATCCCGA,0,2792953
ompRp1,0.1111111111111111,8,8,GCGATTGTCGAGGTAACTAA,0,2775521
ompRp1,0.1111111111111111,8,8,GCGATCTAGTCCTCTGACAG,0,2785111
ompRp1,0.1111111111111111,8,8,GCGAGGTTAACGCTAGTTGT,0,2773740
ompRp1,0.1111111111111111,8,8,GCGAGAATGTAGAATAAGGA,0,2822314
ompRp1,0.1111111111111111,8,8,GCCTGTCTGATAGATTCTTT,0,2786331
ompRp1,0.1111111111111111,8,8,GCCTAGGGGTTCTCAAGTAG,0,2795426
ompRp1,0.1111111111111111,8,8,GCCTAAGAAAAATTCGTCAG,0,2790209
ompRp1,0.1111111111111111,8,8,GCCGTGGAATCCGTTGCTTA,0,2815143
ompRp1,0.1111111111111111,8,8,GCCGTGAGCCCCAAGCGAAT,0,2794253
ompRp1,0.1111111111111111,8,8,GCCGCCCGGGCCTGAAAGTG,0,2796219
ompRp1,0.1111111111111111,8,8,GCCCTGACCTCTCATATCAG,0,2807923
ompRp1,0.1111111111111111,8,8,GCCCGGCCTGTCCATCAGAT,0,2768198
ompRp1,0.1111111111111111,8,8,GCCATCAATAACAGATCGTA,0,2798055
ompRp1,0.1111111111111111,8,8,GCCAGTTCCGTGATGGGAAT,0,2776309
ompRp1,0.1111111111111111,8,8,GCCAGGTGTAGCACCCCAAG,0,2820218
ompRp1,0.1111111111111111,8,8,GCCAATGCCCTGTTACTCTA,0,2812740
ompRp1,0.1111111111111111,8,8,GCATGGGTGTGATACGAGCC,0,2798990
ompRp1,0.1111111111111111,8,8,GCATGAGTCATGTTACCTCA,0,2794951
ompRp1,0.1111111111111111,8,8,GCATCACGCCATCCGACTGG,0,2813439
ompRp1,0.1111111111111111,8,8,GCAGTCAAATGAATAGTCCG,0,2796283
ompRp1,0.1111111111111111,8,8,GCAGGGCTTTAGCCGGTGCT,0,2807250
ompRp1,0.1111111111111111,8,8,GCAGGACGTTAAGGCTTCAC,0,2822479
ompRp1,0.1111111111111111,8,8,GCAGAGATACTTTCCGGTTT,0,2777077
ompRp1,0.1111111111111111,8,8,GCACGCATAAGCATGATACA,0,2765861
ompRp1,0.1111111111111111,8,8,GCACGATAACATACCTGATG,0,2780555
ompRp1,0.1111111111111111,8,8,GCACCACGTAATCTTGAATA,0,2800163
ompRp1,0.1111111111111111,8,8,GCAAGCCATATTCGTTCCCG,0,2811154
ompRp1,0.1111111111111111,8,8,GCAACACGCACGCCCAACAA,0,2820934
ompRp1,0.1111111111111111,8,8,GCAACACCATGATAACTAGC,0,2798748
ompRp1,0.1111111111111111,8,8,GCAAATCATGCCCCGGCGAA,0,2798093
ompRp1,0.1111111111111111,8,8,GATTTTTGTTACCTTCATCG,0,2790860
ompRp1,0.1111111111111111,8,8,GATTGTTAAGAACAACACCA,0,2774844
ompRp1,0.1111111111111111,8,8,GATTAGCAGCATATGAGTAG,0,2773172
ompRp1,0.1111111111111111,8,8,GATGTTCGTCCCCGGCTGTC,0,2793882
ompRp1,0.1111111111111111,8,8,GATGTGGTTCAAGGAACACT,0,2774881
ompRp1,0.1111111111111111,8,8,GATGTGAATAACAAAGGTAT,0,2821433
ompRp1,0.1111111111111111,8,8,GATGGGAGACAGTGCAATGG,0,2806959
ompRp1,0.1111111111111111,8,8,GATGCTCAGGAGTGTAGGTC,0,2805030
ompRp1,0.1111111111111111,8,8,GATGCAGCTTCCGGCGTATC,0,2769665
ompRp1,0.1111111111111111,8,8,GATGAGTCGTCGTGTCGTCC,0,2823481
ompRp1,0.1111111111111111,8,8,GATCTTGACTCAGGCCAACA,0,2798046
ompRp1,0.1111111111111111,8,8,GATCGTATTAACATCTGTGT,0,2785023
ompRp1,0.1111111111111111,8,8,GATCGGCCAGCGGGACAACT,0,2811906
ompRp1,0.1111111111111111,8,8,GATATTCTTCATAGTGGCGA,0,2789982
ompRp1,0.1111111111111111,8,8,GAGTACATTTCGGCCCGGAC,0,2803441
ompRp1,0.1111111111111111,8,8,GAGCAGACGAGATTTGAGAT,0,2810315
ompRp1,0.1111111111111111,8,8,GAGAATGTCGGACCGCTCAC,0,2800573
ompRp1,0.1111111111111111,8,8,GACTTTTATTGAAGACTCCG,0,2791289
ompRp1,0.1111111111111111,8,8,GACTTGGCGATGTTAAGATC,0,2771200
ompRp1,0.1111111111111111,8,8,GACTGTTGGGTTTTTAGCTC,0,2799719
ompRp1,0.1111111111111111,8,8,GACTCAATAGCGGTACATTT,0,2796015
ompRp1,0.1111111111111111,8,8,GACTAAGCTTAAAAACGTCA,0,2781841
ompRp1,0.1111111111111111,8,8,GACGCCTCCTGTAGTGTAGC,0,2805402
ompRp1,0.1111111111111111,8,8,GACGCCGACTCTCTGAGCGA,0,2773572
ompRp1,0.1111111111111111,8,8,GACCCGATATGAGGGGGCAG,0,2804651
ompRp1,0.1111111111111111,8,8,GACATATTGGAAGGCCCGTC,0,2780285
ompRp1,0.1111111111111111,8,8,GACAGTACAGCTGGTAGAAG,0,2820319
ompRp1,0.1111111111111111,8,8,GACACGTCCAACAGCTTCCA,0,2821708
ompRp1,0.1111111111111111,8,8,GACACCGTTGACCCACCGCA,0,2786157
ompRp1,0.1111111111111111,8,8,GAATTTAATTGTCTGTCATC,0,2793255
ompRp1,0.1111111111111111,8,8,GAATGCAAAGTGCGATGGAC,0,2821036
ompRp1,0.1111111111111111,8,8,GAAGCCGCCAGACACTCCCG,0,2778849
ompRp1,0.1111111111111111,8,8,GAACGTTGTTCGTCAGAAAT,0,2790345
ompRp1,0.1111111111111111,8,8,GAACCTGCAAAGTGTTTGGG,0,2811118
ompRp1,0.1111111111111111,8,8,GAACATGAGCAACGCACATA,0,2791642
ompRp1,0.1111111111111111,8,8,GAAAGGATTCGGAGCCCGAT,0,2824391
ompRp1,0.1111111111111111,8,8,CTTTTGGCTGTTCCTTTACA,0,2810956
ompRp1,0.1111111111111111,8,8,CTTTGCGAAGGGATAGAGAT,0,2767557
ompRp1,0.1111111111111111,8,8,CTTGGGAAAATGGGGGCTGC,0,2773199
ompRp1,0.1111111111111111,8,8,CTTGGCGCATGAGGTGGCCT,0,2765862
ompRp1,0.1111111111111111,8,8,CTTGCGCGGAATTGCATCTT,0,2824510
ompRp1,0.1111111111111111,8,8,CTTCTGCAGGAAGTTAGGCG,0,2815378
ompRp1,0.1111111111111111,8,8,CTTAGTTGAACTGCTAAGCA,0,2812339
ompRp1,0.1111111111111111,8,8,CTTAGGTGGTTGAGTCAGCA,0,2781916
ompRp1,0.1111111111111111,8,8,CTTAGCGACTTTAGTGCTTC,0,2791739
ompRp1,0.1111111111111111,8,8,CTGTCTCAGTTAGGAAATCA,0,2795997
ompRp1,0.1111111111111111,8,8,CTGGCTCCCCGATTACTTTC,0,2806267
ompRp1,0.1111111111111111,8,8,CTGGACCCGCCAGACGCACT,0,2818949
ompRp1,0.1111111111111111,8,8,CTGAAATAGAGCTTAGCGGT,0,2765315
ompRp1,0.1111111111111111,8,8,CTCGTCTTGCGCGTACAGCG,0,2822395
ompRp1,0.1111111111111111,8,8,CTCGCAGTTCTCATGTGCGT,0,2795620
ompRp1,0.1111111111111111,8,8,CTCCTAGGCAAAAAAGCTGC,0,2780616
ompRp1,0.1111111111111111,8,8,CTCCGGTCCGCCCAGTGGGG,0,2795801
ompRp1,0.1111111111111111,8,8,CTCCGCTTTGGACGATGGAT,0,2773777
ompRp1,0.1111111111111111,8,8,CTCCAAGAGCATCCACCTAT,0,2767070
ompRp1,0.1111111111111111,8,8,CTCACCCTACGTCCCCGCGG,0,2777668
ompRp1,0.1111111111111111,8,8,CTCAACCAGGGCATCCGTCT,0,2772112
ompRp1,0.1111111111111111,8,8,CTATTGCGACTTCCTGGGCA,0,2817422
ompRp1,0.1111111111111111,8,8,CTATTGAGTCCCAGAAATTA,0,2769903
ompRp1,0.1111111111111111,8,8,CTATTCCCGTTGGTTAAAAC,0,2790207
ompRp1,0.1111111111111111,8,8,CTATGGTCTTCGGCAAATAC,0,2824169
ompRp1,0.1111111111111111,8,8,CTACTGGGGGTACGCTGTCT,0,2803352
ompRp1,0.1111111111111111,8,8,CTAATATGAAGTTTAAGAGT,0,2779522
ompRp1,0.1111111111111111,8,8,CGTTTTGGTTGTCTGCCACG,0,2781730
ompRp1,0.1111111111111111,8,8,CGTTGCTATCAGATGTGCCG,0,2766657
ompRp1,0.1111111111111111,8,8,CGTGATCTCGGTTCTGGAAG,0,2794105
ompRp1,0.1111111111111111,8,8,CGTCTGTCTCCTTTCTGTAA,0,2768302
ompRp1,0.1111111111111111,8,8,CGTCGGAACTTCCGCATCAT,0,2812340
ompRp1,0.1111111111111111,8,8,CGTCGAACGTCTATAGTCGG,0,2822583
ompRp1,0.1111111111111111,8,8,CGTACTTGCTATAAGCTGGG,0,2803768
ompRp1,0.1111111111111111,8,8,CGTACGATACACTCAAGATA,0,2770293
ompRp1,0.1111111111111111,8,8,CGTAAAAGCACGTTACTCTC,0,2821291
ompRp1,0.1111111111111111,8,8,CGGTGGGATCCTCGGAGTTT,0,2820746
ompRp1,0.1111111111111111,8,8,CGGTGACTGAACCGCTTACC,0,2807361
ompRp1,0.1111111111111111,8,8,CGGTCCGATTTACCAGGAGG,0,2811472
ompRp1,0.1111111111111111,8,8,CGGTATGTACACGTGCCTCG,0,2816644
ompRp1,0.1111111111111111,8,8,CGGGTTCAGTGATTATAGAT,0,2811891
ompRp1,0.1111111111111111,8,8,CGGGTACCCTAGTGAATTGA,0,2796003
ompRp1,0.1111111111111111,8,8,CGGGGGTGAAGTGATGTTAT,0,2811474
ompRp1,0.1111111111111111,8,8,CGGGGCCTACCTCTAAGAAT,0,2789980
ompRp1,0.1111111111111111,8,8,CGGGGAAGCGGCAACGAGCG,0,2805914
ompRp1,0.1111111111111111,8,8,CGGGCATGGGGACTAATCGC,0,2809831
ompRp1,0.1111111111111111,8,8,CGGCTGGCGTGGTCTTTGGA,0,2795855
ompRp1,0.1111111111111111,8,8,CGGCTCTGGCGCCTAAAAAG,0,2809659
ompRp1,0.1111111111111111,8,8,CGGCGCCGCCTTTCCAGCGA,0,2801945
ompRp1,0.1111111111111111,8,8,CGGCCCTTAACCGCGAACCC,0,2805759
ompRp1,0.1111111111111111,8,8,CGGATGTCTTTGCGCAACGA,0,2814527
ompRp1,0.1111111111111111,8,8,CGGATAATAAGCATTCCAAA,0,2769488
ompRp1,0.1111111111111111,8,8,CGCTTGGGACAACAATTAGA,0,2805506
ompRp1,0.1111111111111111,8,8,CGCTGTACATTCCCGTGAGT,0,2820188
ompRp1,0.1111111111111111,8,8,CGCTGGGTCACTAATGCGGT,0,2804919
ompRp1,0.1111111111111111,8,8,CGCTCGCTCATATATGTTTA,0,2765513
ompRp1,0.1111111111111111,8,8,CGCTCAATAGCTTTTGACGT,0,2804283
ompRp1,0.1111111111111111,8,8,CGCGCGGTTTATTTAGTGAC,0,2819000
ompRp1,0.1111111111111111,8,8,CGCGCATCGCTCCTGAAGGG,0,2799950
ompRp1,0.1111111111111111,8,8,CGCGAGGCCATAGGACGTAG,0,2802044
ompRp1,0.1111111111111111,8,8,CGCCGGTTTACAAACGTGAT,0,2812037
ompRp1,0.1111111111111111,8,8,CGCCGGTCCTTTGTACCGAT,0,2785911
ompRp1,0.1111111111111111,8,8,CGCCAGAGGTGCTGAATCGC,0,2821762
ompRp1,0.1111111111111111,8,8,CGCATCGGGGTCAGCAGACC,0,2776731
ompRp1,0.1111111111111111,8,8,CGCAGACGACCGCTACCAGT,0,2781675
ompRp1,0.1111111111111111,8,8,CGATTGGTCCGGAGACTCTA,0,2800792
ompRp1,0.1111111111111111,8,8,CGATTGACGTGTCACCTCTT,0,2789060
ompRp1,0.1111111111111111,8,8,CGATTCGCTAGTAAAGTTGA,0,2809988
ompRp1,0.1111111111111111,8,8,CGATTAATCACTTTCGACAA,0,2788097
ompRp1,0.1111111111111111,8,8,CGAGACGCTCTAGGTCCGTA,0,2819619
ompRp1,0.1111111111111111,8,8,CGACGCTGGCCACCTGCAGA,0,2779986
ompRp1,0.1111111111111111,8,8,CGACCGCATTCGACCGGTCG,0,2823629
ompRp1,0.1111111111111111,8,8,CGACCCTCCCATGCTCCAAT,0,2794362
ompRp1,0.1111111111111111,8,8,CGACAGATCCGGAGAACGAG,0,2802980
ompRp1,0.1111111111111111,8,8,CGAATTCTCTTAACGGTCGC,0,2803765
ompRp1,0.1111111111111111,8,8,CGAAGCCATGGTTCGCACTT,0,2799892
ompRp1,0.1111111111111111,8,8,CGAACCGGAGATCGTGCATG,0,2806407
ompRp1,0.1111111111111111,8,8,CGAAATATGGGAAGAAGCCT,0,2800797
ompRp1,0.1111111111111111,8,8,CGAAAGGTCCATATGCACAC,0,2822011
ompRp1,0.1111111111111111,8,8,CCTTGCCTTGTCTGCCGGGA,0,2785239
ompRp1,0.1111111111111111,8,8,CCTTCTCGCCAATGGTCCAC,0,2787294
ompRp1,0.1111111111111111,8,8,CCTTCGCACGTTGAATGTGG,0,2802506
ompRp1,0.1111111111111111,8,8,CCTGGACATTAGCATGTCAT,0,2792537
ompRp1,0.1111111111111111,8,8,CCTCGAATTGTAGGATCCGC,0,2822967
ompRp1,0.1111111111111111,8,8,CCTCCAGTATAATCGGCCGT,0,2820049
ompRp1,0.1111111111111111,8,8,CCTCACCTGTCATGCCCCAC,0,2808344
ompRp1,0.1111111111111111,8,8,CCTATCATTGGAGCGCATCA,0,2802385
ompRp1,0.1111111111111111,8,8,CCTAGCGCGAGTAAGACATG,0,2782124
ompRp1,0.1111111111111111,8,8,CCTAGCCGGCAACAAGCTCC,0,2769717
ompRp1,0.1111111111111111,8,8,CCGTGATCGAAGTGCGAACA,0,2773745
ompRp1,0.1111111111111111,8,8,CCGGTAGCGCGGGCTGCACT,0,2768857
ompRp1,0.1111111111111111,8,8,CCGGCCTAAAAGGAGGTATA,0,2798528
ompRp1,0.1111111111111111,8,8,CCGGAGGCAGAAGGTTAGTC,0,2791108
ompRp1,0.1111111111111111,8,8,CCGCTTCTGAAGTTGTGAAG,0,2810854
ompRp1,0.1111111111111111,8,8,CCGCTACCAATATGTGGCTT,0,2798693
ompRp1,0.1111111111111111,8,8,CCGCGGTACTGTCGTTACAA,0,2780894
ompRp1,0.1111111111111111,8,8,CCGCCTTGCACAGAAAACTA,0,2807181
ompRp1,0.1111111111111111,8,8,CCGCCTTATGGAGTTATTGG,0,2818901
ompRp1,0.1111111111111111,8,8,CCGATTTAGAATATGCTACG,0,2794244
ompRp1,0.1111111111111111,8,8,CCGAGTGTACTGAAGAATAA,0,2766788
ompRp1,0.1111111111111111,8,8,CCGAGGCAGGCGAATGCAGT,0,2791220
ompRp1,0.1111111111111111,8,8,CCGAAAATGTCTGATAAAAT,0,2779487
ompRp1,0.1111111111111111,8,8,CCCTGTGCGGCATAGGGTAC,0,2823567
ompRp1,0.1111111111111111,8,8,CCCTCTCGCCTGCTATGTGT,0,2819172
ompRp1,0.1111111111111111,8,8,CCCTATCTCGACGTTTTGAT,0,2785226
ompRp1,0.1111111111111111,8,8,CCCGGAGGCTTCAGTCTGGC,0,2799245
ompRp1,0.1111111111111111,8,8,CCCGGAAAGCTCGACTCAGC,0,2802415
ompRp1,0.1111111111111111,8,8,CCCGGAAAAATAAGTGAAGT,0,2785130
ompRp1,0.1111111111111111,8,8,CCCGCGAGGCAGGTAACGGA,0,2811328
ompRp1,0.1111111111111111,8,8,CCCCGCATCAGATCGAATGG,0,2767782
ompRp1,0.1111111111111111,8,8,CCCCCTACTCTATATGACAC,0,2775348
ompRp1,0.1111111111111111,8,8,CCCCCCCGTCTTTCATAATA,0,2793838
ompRp1,0.1111111111111111,8,8,CCCAGGCCTAGTCGCAAAGG,0,2799214
ompRp1,0.1111111111111111,8,8,CCCACTATTAGTGGTCACCT,0,2786297
ompRp1,0.1111111111111111,8,8,CCATGTCGTGCTTTGTGGAC,0,2810953
ompRp1,0.1111111111111111,8,8,CCAGACGTCTGTAGCTAATA,0,2793025
ompRp1,0.1111111111111111,8,8,CCACTCTTTTTCAAGTTACA,0,2794392
ompRp1,0.1111111111111111,8,8,CCAATGTCAGACATTCCGAA,0,2814856
ompRp1,0.1111111111111111,8,8,CCAACAAGGGGGAGTTCTTT,0,2772236
ompRp1,0.1111111111111111,8,8,CCAAAACTAACTGTAGTTAT,0,2791281
ompRp1,0.1111111111111111,8,8,CATTTGCTTGAGGGCAGGAC,0,2818292
ompRp1,0.1111111111111111,8,8,CATTGTCTGAGGTGTAAAAC,0,2769779
ompRp1,0.1111111111111111,8,8,CATTCGTTTTTTCTGGTCGT,0,2808997
ompRp1,0.1111111111111111,8,8,CATTAGCTATTCGAAGGATA,0,2783735
ompRp1,0.1111111111111111,8,8,CATTAGATATACCAATAATA,0,2775199
ompRp1,0.1111111111111111,8,8,CATTACCGATGGTGGTTCGT,0,2800046
ompRp1,0.1111111111111111,8,8,CATGAAACCGCCCGAGATTG,0,2796753
ompRp1,0.1111111111111111,8,8,CATCATGGCGACGGGGAATT,0,2803479
ompRp1,0.1111111111111111,8,8,CATAGTTCAATAGGATGAAG,0,2810580
ompRp1,0.1111111111111111,8,8,CATACTGCCATCCCTAAAAG,0,2784339
ompRp1,0.1111111111111111,8,8,CATAACGCAAGATTGCGTCC,0,2804007
ompRp1,0.1111111111111111,8,8,CAGTGGGATCTCATATCTGA,0,2765879
ompRp1,0.1111111111111111,8,8,CAGTATCCGCTGTAACGTGC,0,2813914
ompRp1,0.1111111111111111,8,8,CAGTACATGATACGGTTGTA,0,2794146
ompRp1,0.1111111111111111,8,8,CAGCCTTAATCATTACTTAT,0,2819175
ompRp1,0.1111111111111111,8,8,CAGCAAGTCCTGCTACGGGT,0,2767702
ompRp1,0.1111111111111111,8,8,CAGCAAATCCTGTTAACGTG,0,2774289
ompRp1,0.1111111111111111,8,8,CAGAGATAACGCGTATAGAT,0,2815463
ompRp1,0.1111111111111111,8,8,CAGAGAGTCCGTAGCTAGGT,0,2782042
ompRp1,0.1111111111111111,8,8,CAGACGGGACCTCATGACGT,0,2795585
ompRp1,0.1111111111111111,8,8,CACTGAAGCTTCATGTTGCC,0,2779065
ompRp1,0.1111111111111111,8,8,CACTCTTAGAGCAGAATTAT,0,2800474
ompRp1,0.1111111111111111,8,8,CACGTATCCGCTAAGGGCTA,0,2812596
ompRp1,0.1111111111111111,8,8,CACCTTCGCTTCCCGCACGA,0,2784706
ompRp1,0.1111111111111111,8,8,CACCTGCGATAATTAGTTGC,0,2776518
ompRp1,0.1111111111111111,8,8,CACCTCAGCGCCTGTTGGAT,0,2801557
ompRp1,0.1111111111111111,8,8,CACCTAGCTCATGTTCCTCA,0,2816185
ompRp1,0.1111111111111111,8,8,CACCGCCTCGTGGGTTCGTA,0,2822771
ompRp1,0.1111111111111111,8,8,CACAGCCATGGTAGGACATT,0,2817464
ompRp1,0.1111111111111111,8,8,CAATTTTGACCGAGTAATCT,0,2769579
ompRp1,0.1111111111111111,8,8,CAATTGGTCGCATACCGGAG,0,2824254
ompRp1,0.1111111111111111,8,8,CAATGCTTGGTGAACGTGCA,0,2793544
ompRp1,0.1111111111111111,8,8,CAATCACGCTAGGACTAGAT,0,2773989
ompRp1,0.1111111111111111,8,8,CAAGCTAGAGGACCGGGTCT,0,2800050
ompRp1,0.1111111111111111,8,8,CAAGCACGGGGGCTTTAGGG,0,2784538
ompRp1,0.1111111111111111,8,8,CAAGCAATCTCTGGCTATTG,0,2774484
ompRp1,0.1111111111111111,8,8,CAACTCCCAGCCTTAAGGAG,0,2821000
ompRp1,0.1111111111111111,8,8,CAACGTTCAGTTACTGCAAT,0,2798734
ompRp1,0.1111111111111111,8,8,CAACCGAAGTAATGAGTGTA,0,2805997
ompRp1,0.1111111111111111,8,8,CAACCCCCGTTTAGTGCCCG,0,2777153
ompRp1,0.1111111111111111,8,8,CAACAAGGCTATGGGTACCG,0,2818093
ompRp1,0.1111111111111111,8,8,CAAATATCGGTGTTAAAGCT,0,2787077
ompRp1,0.1111111111111111,8,8,CAAACGGCGTACGCTATATG,0,2774854
ompRp1,0.1111111111111111,8,8,ATTTATACCGGACCTTGACT,0,2772506
ompRp1,0.1111111111111111,8,8,ATTGTACACCTGGTGGGTGT,0,2790212
ompRp1,0.1111111111111111,8,8,ATTGATAATGCCACCTGGGT,0,2822081
ompRp1,0.1111111111111111,8,8,ATTCTTGGAAAACGAAGAGT,0,2819438
ompRp1,0.1111111111111111,8,8,ATTCGAGGTCTAGTTTAACT,0,2778352
ompRp1,0.1111111111111111,8,8,ATTCATTCAGAATCGGCGGT,0,2809031
ompRp1,0.1111111111111111,8,8,ATTCACACAAGAAATTTCTT,0,2817272
ompRp1,0.1111111111111111,8,8,ATTATCGTCCGCTGGACTAT,0,2816936
ompRp1,0.1111111111111111,8,8,ATTATCCAATACAGCCCGCT,0,2797749
ompRp1,0.1111111111111111,8,8,ATTAAGTAGTTGCCCCGTAT,0,2805037
ompRp1,0.1111111111111111,8,8,ATGTAACCGGATTAGTGAGC,0,2767998
ompRp1,0.1111111111111111,8,8,ATGGTCGGCAGGGGAAATCG,0,2773442
ompRp1,0.1111111111111111,8,8,ATGGGGAACATTTTACCGTC,0,2813028
ompRp1,0.1111111111111111,8,8,ATGGGCGTTCGGATCCACTT,0,2790283
ompRp1,0.1111111111111111,8,8,ATGGGCGACGAGGAACGAGA,0,2815138
ompRp1,0.1111111111111111,8,8,ATGGCTAAGAGTATGAACGT,0,2814098
ompRp1,0.1111111111111111,8,8,ATGGCAGCATTCTCGCTTCA,0,2814921
ompRp1,0.1111111111111111,8,8,ATGGATGTGTAACCTCAAGT,0,2803754
ompRp1,0.1111111111111111,8,8,ATGGAGATGAAGGTTAGTTT,0,2776144
ompRp1,0.1111111111111111,8,8,ATGATCACTTAATACATTTT,0,2769116
ompRp1,0.1111111111111111,8,8,ATGACCTACTATCATGGTGA,0,2793627
ompRp1,0.1111111111111111,8,8,ATGAATGCATGATTTCCTTT,0,2795487
ompRp1,0.1111111111111111,8,8,ATCTTGGACAAGGGTCCTTT,0,2773869
ompRp1,0.1111111111111111,8,8,ATCTTCTTCAATGTTTAACA,0,2778478
ompRp1,0.1111111111111111,8,8,ATCTGTACACTCCTTGGGCT,0,2818564
ompRp1,0.1111111111111111,8,8,ATCTGGGTGCTCGGGGATAC,0,2792874
ompRp1,0.1111111111111111,8,8,ATCTAGTGTTATCGGAGGTT,0,2796222
ompRp1,0.1111111111111111,8,8,ATCGGTAAGTGAGGTAGACA,0,2816988
ompRp1,0.1111111111111111,8,8,ATCCAGTCGCCTAAAGGCTA,0,2803942
ompRp1,0.1111111111111111,8,8,ATCAAGGGCGTGTCCGTGTT,0,2820678
ompRp1,0.1111111111111111,8,8,ATATTTGTTAGGCTAGTATG,0,2772487
ompRp1,0.1111111111111111,8,8,ATATTGTTGTAGACGATGCC,0,2811373
ompRp1,0.1111111111111111,8,8,ATATTGCTGGCATAGTCCAA,0,2817600
ompRp1,0.1111111111111111,8,8,ATATACGGTTAACTTATGGC,0,2792196
ompRp1,0.1111111111111111,8,8,ATAGTGTGAGGTTTTTTCGC,0,2822357
ompRp1,0.1111111111111111,8,8,ATAGAATTCAATCAAGGCCA,0,2815303
ompRp1,0.1111111111111111,8,8,ATAGAAAGTGTATAACTTGG,0,2773091
ompRp1,0.1111111111111111,8,8,ATACTCGGCTAACTACAACA,0,2794667
ompRp1,0.1111111111111111,8,8,ATACTAACCGGAGGGACACG,0,2816278
ompRp1,0.1111111111111111,8,8,ATACAGTATACACTTTCTGC,0,2818706
ompRp1,0.1111111111111111,8,8,ATAACGAGCAGGTCCACGTA,0,2821122
ompRp1,0.1111111111111111,8,8,ATAAAGGAACGCCTGGCCGC,0,2767928
ompRp1,0.1111111111111111,8,8,AGTTTGAGCAGGAGGCTTCA,0,2802444
ompRp1,0.1111111111111111,8,8,AGTTTAAATAACGGAACTTT,0,2783774
ompRp1,0.1111111111111111,8,8,AGTTGTAAGTAGAGGGGTCG,0,2776020
ompRp1,0.1111111111111111,8,8,AGTTGCTCAGGCTTGAATAA,0,2785766
ompRp1,0.1111111111111111,8,8,AGTGTCGGCCACCGATCGTC,0,2769193
ompRp1,0.1111111111111111,8,8,AGTGGCGTAGGGTTAAACCA,0,2792929
ompRp1,0.1111111111111111,8,8,AGTGATTAACATAACTTTCC,0,2785227
ompRp1,0.1111111111111111,8,8,AGTGAGCCCACTCGGAACTA,0,2798074
ompRp1,0.1111111111111111,8,8,AGTCTTGGGGATGCCTGGGA,0,2771013
ompRp1,0.1111111111111111,8,8,AGTCGGTAGAGATTCAGGTC,0,2767238
ompRp1,0.1111111111111111,8,8,AGTCATAGGGCTAGGGGGGT,0,2803583
ompRp1,0.1111111111111111,8,8,AGTAGTAGCAGGCTACGTAT,0,2782691
ompRp1,0.1111111111111111,8,8,AGTACCTGATTCGGTCGCCA,0,2783230
ompRp1,0.1111111111111111,8,8,AGGTTGTAGCCAGTCTAGAC,0,2812879
ompRp1,0.1111111111111111,8,8,AGGTTCACTCATCTTCTAAC,0,2808593
ompRp1,0.1111111111111111,8,8,AGGTTATCAGCATGTTCGCA,0,2799315
ompRp1,0.1111111111111111,8,8,AGGTCCTGGGGCGTAGCTTA,0,2809591
ompRp1,0.1111111111111111,8,8,AGGTCAATGATTTGAATGCT,0,2770772
ompRp1,0.1111111111111111,8,8,AGGTAAGTTTTTCGAGGCGA,0,2812346
ompRp1,0.1111111111111111,8,8,AGGGTTCTAGCGCGCCCGAT,0,2772764
ompRp1,0.1111111111111111,8,8,AGGGTCCGAACAAGACGCTA,0,2794357
ompRp1,0.1111111111111111,8,8,AGGGATATTAGAGGCCCTAT,0,2782097
ompRp1,0.1111111111111111,8,8,AGGGACCAAGACTCCTCAGT,0,2792141
ompRp1,0.1111111111111111,8,8,AGGCTGCGTTGAGGATAATA,0,2819519
ompRp1,0.1111111111111111,8,8,AGGCCACGATGGGCACTGCC,0,2800910
ompRp1,0.1111111111111111,8,8,AGGATACACTGCTTAAAAAC,0,2765997
ompRp1,0.1111111111111111,8,8,AGGAACCATCTGCGATTACG,0,2793446
ompRp1,0.1111111111111111,8,8,AGGAACAAAATGAATTTATC,0,2818047
ompRp1,0.1111111111111111,8,8,AGCTGTTACACTATACTTAA,0,2785524
ompRp1,0.1111111111111111,8,8,AGCTCTAACGGTTTTCTGTG,0,2796317
ompRp1,0.1111111111111111,8,8,AGCGTTCATCGGTTCTTGGC,0,2815031
ompRp1,0.1111111111111111,8,8,AGCGTGGACGATGTACTAAG,0,2777827
ompRp1,0.1111111111111111,8,8,AGCGGTATAGCAGGCGGCCT,0,2800049
ompRp1,0.1111111111111111,8,8,AGCGGCACGCGCTTAGCAGC,0,2778331
ompRp1,0.1111111111111111,8,8,AGCGGAGAGAGGAGTAAGCA,0,2795752
ompRp1,0.1111111111111111,8,8,AGCCCGCGTTTAAGTGAGCG,0,2765459
ompRp1,0.1111111111111111,8,8,AGCCATTCACTCTACTCGAC,0,2818431
ompRp1,0.1111111111111111,8,8,AGCCATTACGGGTCGAACCT,0,2768783
ompRp1,0.1111111111111111,8,8,AGCAGTGGGACCGAATTGTC,0,2770117
ompRp1,0.1111111111111111,8,8,AGCAGAAACTTCGTGCTCAA,0,2789683
ompRp1,0.1111111111111111,8,8,AGATCGGTCAAGGCAATTGA,0,2775833
ompRp1,0.1111111111111111,8,8,AGAGCGATCGCAAGATCGAT,0,2801233
ompRp1,0.1111111111111111,8,8,AGAGCCGTGCTTCGTCCACC,0,2814084
ompRp1,0.1111111111111111,8,8,AGAGACTACAAGGGCTATCT,0,2776104
ompRp1,0.1111111111111111,8,8,AGAGACCGCGTGTTTATTAC,0,2812701
ompRp1,0.1111111111111111,8,8,AGACGTACCGGCGTCATGTA,0,2814631
ompRp1,0.1111111111111111,8,8,AGACCGCTCTGCCGTAAAAA,0,2820511
ompRp1,0.1111111111111111,8,8,AGACAGACGGGGGAGTGCTT,0,2799599
ompRp1,0.1111111111111111,8,8,AGAATTGGAGACTGCGATTT,0,2792753
ompRp1,0.1111111111111111,8,8,AGAATTCGTGCTGCATATAA,0,2772589
ompRp1,0.1111111111111111,8,8,AGAAGTAACATCCTTTTAAG,0,2792356
ompRp1,0.1111111111111111,8,8,AGAAGGGCCAAAGCAAGATT,0,2809082
ompRp1,0.1111111111111111,8,8,AGAAGGGATCTGACTATGAA,0,2795621
ompRp1,0.1111111111111111,8,8,AGAAGGAAAAGCAGTCCAGA,0,2766949
ompRp1,0.1111111111111111,8,8,AGAAGAGTACACCAACCGAT,0,2778665
ompRp1,0.1111111111111111,8,8,ACTTTCCATGTATTGGCCGG,0,2784510
ompRp1,0.1111111111111111,8,8,ACTTCGATTCGCCTGGTCAA,0,2784720
ompRp1,0.1111111111111111,8,8,ACTTCCCTTGTGCTGCTTAG,0,2811882
ompRp1,0.1111111111111111,8,8,ACTTCAGACAGGTGTACTTC,0,2805371
ompRp1,0.1111111111111111,8,8,ACTTACGCGAGCCTATATAT,0,2793734
ompRp1,0.1111111111111111,8,8,ACTGGGGAGCACAGGGTGAA,0,2788328
ompRp1,0.1111111111111111,8,8,ACTGGACATCCTCATTCGTT,0,2790746
ompRp1,0.1111111111111111,8,8,ACTGCCTGAAGTCAACAATA,0,2773439
ompRp1,0.1111111111111111,8,8,ACTGAGATGTCGCGATTTGG,0,2805290
ompRp1,0.1111111111111111,8,8,ACTGACTTTTCGAAACGGCC,0,2791062
ompRp1,0.1111111111111111,8,8,ACTCGGTTATGATACACGTA,0,2789233
ompRp1,0.1111111111111111,8,8,ACTAGGTTCTATTGTTGGTC,0,2813668
ompRp1,0.1111111111111111,8,8,ACTAGGGATCTAACCCCCGC,0,2765446
ompRp1,0.1111111111111111,8,8,ACTAGCGAATTCAGGGCTGC,0,2804348
ompRp1,0.1111111111111111,8,8,ACTAGCCCGCGTGCTGGGTT,0,2803253
ompRp1,0.1111111111111111,8,8,ACTAGAATCGGATCGTAATA,0,2770751
ompRp1,0.1111111111111111,8,8,ACTAACAAATATACTGGCCC,0,2773825
ompRp1,0.1111111111111111,8,8,ACGTCGCTGTGCCGGCGCCT,0,2806593
ompRp1,0.1111111111111111,8,8,ACGTCCGAAATCCGTGCACT,0,2821924
ompRp1,0.1111111111111111,8,8,ACGTAACACGGTCGCTATGG,0,2820490
ompRp1,0.1111111111111111,8,8,ACGGTTTGGCGCATACACAG,0,2801942
ompRp1,0.1111111111111111,8,8,ACGGTTGCGTCTACGTCGGG,0,2773818
ompRp1,0.1111111111111111,8,8,ACGGCAAGTAGTGGCTTTAA,0,2782407
ompRp1,0.1111111111111111,8,8,ACGGACGGTGACGTGATACA,0,2811046
ompRp1,0.1111111111111111,8,8,ACGCGGGACAAAAGACGAGG,0,2786661
ompRp1,0.1111111111111111,8,8,ACGACGTCATATATTGACTT,0,2792191
ompRp1,0.1111111111111111,8,8,ACGAACCGACACTACACGTC,0,2807012
ompRp1,0.1111111111111111,8,8,ACCTGTATCTCATCCATTGA,0,2809315
ompRp1,0.1111111111111111,8,8,ACCTGATCTACAGTAACCCA,0,2766776
ompRp1,0.1111111111111111,8,8,ACCTAAAAGAAGACAGGATA,0,2768805
ompRp1,0.1111111111111111,8,8,ACCGGGTAGGTACTCTTTCG,0,2806861
ompRp1,0.1111111111111111,8,8,ACCCGATAAGGGCTAAGGGC,0,2803976
ompRp1,0.1111111111111111,8,8,ACCCCTATGTTCGCGTTAGC,0,2823721
ompRp1,0.1111111111111111,8,8,ACCCCGGTAAGTACCGTGAA,0,2822587
ompRp1,0.1111111111111111,8,8,ACCATGTTAAGGTTAAAGGT,0,2774714
ompRp1,0.1111111111111111,8,8,ACCATGAGGGGACAACAACA,0,2790030
ompRp1,0.1111111111111111,8,8,ACCACTAAGATAGCTTGTGG,0,2781193
ompRp1,0.1111111111111111,8,8,ACCAAATTGTGCCAACATCT,0,2816281
ompRp1,0.1111111111111111,8,8,ACAGCAATAAGTTCGCGATA,0,2809435
ompRp1,0.1111111111111111,8,8,ACAGAAAGGGGTTAGCACGA,0,2786219
ompRp1,0.1111111111111111,8,8,ACACTGATTTCGTTTTTATA,0,2778279
ompRp1,0.1111111111111111,8,8,ACACTCCACCAAGACATCGG,0,2811911
ompRp1,0.1111111111111111,8,8,ACACATTAGGTACAAATGTA,0,2776999
ompRp1,0.1111111111111111,8,8,ACAACGTAGACGCCCCGGAA,0,2776068
ompRp1,0.1111111111111111,8,8,ACAAAAGTCAGAGAGTTGAA,0,2806357
ompRp1,0.1111111111111111,8,8,AATTTGGGAGTTCGTTACGA,0,2784757
ompRp1,0.1111111111111111,8,8,AATTTAACCTAGTACCAGCA,0,2823299
ompRp1,0.1111111111111111,8,8,AATGTATGGTGGGGTGCCGT,0,2798680
ompRp1,0.1111111111111111,8,8,AATCATACATCGTCGGAAGC,0,2779042
ompRp1,0.1111111111111111,8,8,AATCAGTCTATCAAGCCTGG,0,2786330
ompRp1,0.1111111111111111,8,8,AATATGGAAACCCTTCAGGG,0,2805018
ompRp1,0.1111111111111111,8,8,AATATAGTATGATCTACGGA,0,2769848
ompRp1,0.1111111111111111,8,8,AATAGTAGCGAGTAATAGAC,0,2820337
ompRp1,0.1111111111111111,8,8,AAGTCTGCGAGCCAATACCC,0,2776887
ompRp1,0.1111111111111111,8,8,AAGTCCTAGCATTTGCTGGG,0,2779574
ompRp1,0.1111111111111111,8,8,AAGGTTAAATAGCCATAGAC,0,2771096
ompRp1,0.1111111111111111,8,8,AAGGCAGTACTTATCGTCGG,0,2803501
ompRp1,0.1111111111111111,8,8,AAGGATGTCCAAGCTTTCAC,0,2787270
ompRp1,0.1111111111111111,8,8,AAGGATATGTCCCGTTAATA,0,2807648
ompRp1,0.1111111111111111,8,8,AAGCTGTACGCCTCGCAAGG,0,2784715
ompRp1,0.1111111111111111,8,8,AAGCGTCATACAGTTTGCTT,0,2791295
ompRp1,0.1111111111111111,8,8,AAGCGCCGGGGGGACCTCGC,0,2777289
ompRp1,0.1111111111111111,8,8,AAGCGACCATTTTCACTTTG,0,2821488
ompRp1,0.1111111111111111,8,8,AAGCCGTGAGCCCTGGATCT,0,2792124
ompRp1,0.1111111111111111,8,8,AAGCCCCCAAAAGGGCTTAT,0,2772329
ompRp1,0.1111111111111111,8,8,AAGCCCAGCGCAACAAAGTT,0,2783708
ompRp1,0.1111111111111111,8,8,AAGCAGGACCGGATAGCCCA,0,2824220
ompRp1,0.1111111111111111,8,8,AAGCAACCCTTTAACCCGAT,0,2767481
ompRp1,0.1111111111111111,8,8,AAGAAATGGGATAATAAACT,0,2815632
ompRp1,0.1111111111111111,8,8,AACTGCAGCCCCGCCTTATT,0,2771808
ompRp1,0.1111111111111111,8,8,AACTCGACATATCACATGGC,0,2786207
ompRp1,0.1111111111111111,8,8,AACGAGTTCCGAACTTTTGT,0,2811676
ompRp1,0.1111111111111111,8,8,AACGAATGCAGGTGAGAAAG,0,2777704
ompRp1,0.1111111111111111,8,8,AACCTAAAACGGGAATCAAT,0,2797994
ompRp1,0.1111111111111111,8,8,AACCGTCGGAGAATAGAGTT,0,2770231
ompRp1,0.1111111111111111,8,8,AACCCACACCCCCTTGCCTG,0,2805054
ompRp1,0.1111111111111111,8,8,AACAGTCGTACTGGCCCGTA,0,2800067
ompRp1,0.1111111111111111,8,8,AACACCTTTGTAGTTAGTAA,0,2820193
ompRp1,0.1111111111111111,8,8,AAATCACTGGAAATCTTGAG,0,2820538
ompRp1,0.1111111111111111,8,8,AAAGGTCTTAAGGTTGGTTT,0,2797075
ompRp1,0.1111111111111111,8,8,AAAGGATGGAGTGCTGCTCC,0,2774802
ompRp1,0.1111111111111111,8,8,AAAGCTGTACTGCAAGGAAG,0,2808529
ompRp1,0.1111111111111111,8,8,AAAGCGTGGATCGGAAGACG,0,2786756
ompRp1,0.1111111111111111,8,8,AAAGCCAGAAGACTCCCACA,0,2785695
ompRp1,0.1111111111111111,8,8,AAAGCAATAAACCTTCGCCC,0,2805196
ompRp1,0.1111111111111111,8,8,AAAGATTGTGATCAGGTACA,0,2782051
ompRp1,0.1111111111111111,8,8,AAACGTTAAGTTCGGACGAA,0,2776849
ompRp1,0.1111111111111111,8,8,AAACCGACAACGTCCTGGCA,0,2797714
ompRp1,0.1111111111111111,8,8,AAAATTCTCAAGCCGCGAGT,0,2819383
ompRp1,0.1111111111111111,8,8,AAAACCAACGTTAATGTGAT,0,2821742
ompRp1,0.1111111111111111,8,8,AAAAAATGCCCTGAGGTATC,0,2806453
ompRp1,0.1111111111111111,8,8,AAAAAAATAGCTGTACATGC,0,2819060
ompRp1,0.125,7,7,TTTTTCAGGGGAGATAAATA,0,2807755
ompRp1,0.125,7,7,TTTTGGCCGAGCCGCGGGAG,0,2823378
ompRp1,0.125,7,7,TTTTGAACAGACGCTTAAGC,0,2804681
ompRp1,0.125,7,7,TTTTCGCGTAAAGGCATTAG,0,2804177
ompRp1,0.125,7,7,TTTTCAGAGCGCTAGAAAAG,0,2781863
ompRp1,0.125,7,7,TTTTCACCCAAGCATAACTA,0,2818270
ompRp1,0.125,7,7,TTTTCAACTGTGTGCACGCG,0,2791031
ompRp1,0.125,7,7,TTTGTTAGTTCGGAGTAGAT,0,2798786
ompRp1,0.125,7,7,TTTGCCGAGAGATCGCGAAA,0,2786288
ompRp1,0.125,7,7,TTTGCACCATGGAGAGCGTA,0,2788634
ompRp1,0.125,7,7,TTTGATCACAACTCAGCCCT,0,2814303
ompRp1,0.125,7,7,TTTGAGGTAGCTGCATGAGT,0,2796434
ompRp1,0.125,7,7,TTTCTTGCGATTTTGTGACA,0,2793559
ompRp1,0.125,7,7,TTTCTCAGGCGCATAATAGC,0,2769738
ompRp1,0.125,7,7,TTTCGCAATCTTATGGTTCC,0,2814163
ompRp1,0.125,7,7,TTTCCGGGTTTTTTGCCCGT,0,2769123
ompRp1,0.125,7,7,TTTCATCGTTTCACCGTAGA,0,2765397
ompRp1,0.125,7,7,TTTACAACGTTGTGAGGGAT,0,2773391
ompRp1,0.125,7,7,TTGTTCATTTTGGAGGCCCC,0,2810652
ompRp1,0.125,7,7,TTGTCTGAAATAAATCGATC,0,2781134
ompRp1,0.125,7,7,TTGTCGTGAAGCCGATGATA,0,2791033
ompRp1,0.125,7,7,TTGTCATCATCACGGATATA,0,2822450
ompRp1,0.125,7,7,TTGTAGGAGCCGTTCGGAAA,0,2775769
ompRp1,0.125,7,7,TTGGGAATACGAAGTTGAGC,0,2784506
ompRp1,0.125,7,7,TTGGGAAAGATGATTAGTGA,0,2768421
ompRp1,0.125,7,7,TTGGCTTACTTCTGTGGTGC,0,2808266
ompRp1,0.125,7,7,TTGCCTGGATTGCTCGACGA,0,2766095
ompRp1,0.125,7,7,TTGATGAGGTCCCCGAGGTC,0,2787954
ompRp1,0.125,7,7,TTGATCGTGTAGTTTTCGGA,0,2782265
ompRp1,0.125,7,7,TTGAATCGTAACCCGTAAAG,0,2784380
ompRp1,0.125,7,7,TTGAACAATTGGAATGCCCA,0,2778731
ompRp1,0.125,7,7,TTCTTAAGGGGGTGCATTTG,0,2783964
ompRp1,0.125,7,7,TTCTGCACAATCTCACTCGA,0,2806585
ompRp1,0.125,7,7,TTCTATAGAGTCATCTACCA,0,2799767
ompRp1,0.125,7,7,TTCGGTGCACATACTATGCT,0,2780125
ompRp1,0.125,7,7,TTCGGGCTGACAATTTAATA,0,2822279
ompRp1,0.125,7,7,TTCGCAAAAAGTGAAACACA,0,2783438
ompRp1,0.125,7,7,TTCCTTACCTTTTCTGTAGC,0,2809861
ompRp1,0.125,7,7,TTCATGGATGGAGGGGTCCT,0,2819884
ompRp1,0.125,7,7,TTCATGACGTTAACTTGGCT,0,2809840
ompRp1,0.125,7,7,TTCATCGCACACCGGGACTA,0,2797150
ompRp1,0.125,7,7,TTCACTTTCCAGTAGATGGA,0,2782597
ompRp1,0.125,7,7,TTCAACCTGACCAGGTCGCT,0,2787029
ompRp1,0.125,7,7,TTATCTATTCAGTTCCCCAA,0,2800621
ompRp1,0.125,7,7,TTAGGGGCCAGCATAGAATC,0,2787773
ompRp1,0.125,7,7,TTAGGATTATGGAGCTTCTC,0,2792301
ompRp1,0.125,7,7,TTAGCGCAGACCGGGACTAT,0,2774556
ompRp1,0.125,7,7,TTAGAGTAAAACATACACGG,0,2790557
ompRp1,0.125,7,7,TTACTGGGAATGTTAGGGGT,0,2791446
ompRp1,0.125,7,7,TTACGTTTGCCCCCGATTCT,0,2770534
ompRp1,0.125,7,7,TTAACGTGGGCATTCCGTTG,0,2785805
ompRp1,0.125,7,7,TTAAAGCCATCGGGAATATG,0,2800824
ompRp1,0.125,7,7,TGTTGGTACCCTCGAGCGGA,0,2812591
ompRp1,0.125,7,7,TGTTCGGCCCACATGTTGCT,0,2784034
ompRp1,0.125,7,7,TGTTCGCGCGTGATGCCGGA,0,2769208
ompRp1,0.125,7,7,TGTGTGTCCTTGCATTCTAT,0,2775091
ompRp1,0.125,7,7,TGTGGTGAGCAAAAGGTTAT,0,2820019
ompRp1,0.125,7,7,TGTGGCGGTAAAGTGTCGTA,0,2776561
ompRp1,0.125,7,7,TGTCTTAACAATTCTGGTGT,0,2795051
ompRp1,0.125,7,7,TGTCGGGCCATCAACCGAGG,0,2769812
ompRp1,0.125,7,7,TGTCACGTTTGGGTTCTTGG,0,2781782
ompRp1,0.125,7,7,TGTATTTGGGCGCACATGAC,0,2772208
ompRp1,0.125,7,7,TGGTTGCTTACAAGCGGATA,0,2810484
ompRp1,0.125,7,7,TGGTGGTTGCTATACAGGCC,0,2818135
ompRp1,0.125,7,7,TGGTATCTCACGTTCCGGCC,0,2784888
ompRp1,0.125,7,7,TGGGTTTCTCTTCTTCCATA,0,2776028
ompRp1,0.125,7,7,TGGGGGGGAGCATGTGCTAG,0,2809290
ompRp1,0.125,7,7,TGGGCCTGGAGTTACGTAGA,0,2785824
ompRp1,0.125,7,7,TGGGACGCCTAGCCACTTCG,0,2820486
ompRp1,0.125,7,7,TGGGACATGTCGCGGAGCCG,0,2821925
ompRp1,0.125,7,7,TGGGACACATGGGTCCTGAC,0,2814875
ompRp1,0.125,7,7,TGGCTTGCGAGAGTTGTGGG,0,2822632
ompRp1,0.125,7,7,TGGCTGGCCATGTTATAACT,0,2791775
ompRp1,0.125,7,7,TGGCGTGAAGATTCTGCAAG,0,2804386
ompRp1,0.125,7,7,TGGCGCCCTGTGGCGAAACA,0,2795044
ompRp1,0.125,7,7,TGGCATTTGATGCCAGGTTT,0,2772558
ompRp1,0.125,7,7,TGGCAGACGCCCAGCGGATT,0,2809780
ompRp1,0.125,7,7,TGGCACTCCGGCGCGTGAGC,0,2807464
ompRp1,0.125,7,7,TGGATTACCTGGACTCGTCA,0,2775616
ompRp1,0.125,7,7,TGGAGTTATAGATTACTTTG,0,2791141
ompRp1,0.125,7,7,TGGAGTCCGAAGGTGGGCGT,0,2766354
ompRp1,0.125,7,7,TGGAGTACCATTAAGGGAAG,0,2775065
ompRp1,0.125,7,7,TGGACTCTATGGGGAATGAA,0,2808121
ompRp1,0.125,7,7,TGCTGCCTCGAGCGTAGCGA,0,2786309
ompRp1,0.125,7,7,TGCTGCAGCGGGCCGCGTGC,0,2813394
ompRp1,0.125,7,7,TGCGTACCCGGGAGGTCTCG,0,2794809
ompRp1,0.125,7,7,TGCGGACATTGAATAAATTC,0,2809723
ompRp1,0.125,7,7,TGCGCCTCCTTGCTTAGTGT,0,2774211
ompRp1,0.125,7,7,TGCGCAGACCCGCATTAGAA,0,2792623
ompRp1,0.125,7,7,TGCGACTGCGGGCAAGCACC,0,2804384
ompRp1,0.125,7,7,TGCCGTATTAGTCAAGGCAT,0,2784421
ompRp1,0.125,7,7,TGCCGCGCCCCAGTAGGCGA,0,2812382
ompRp1,0.125,7,7,TGCCCAGTACCTAAGGCCAG,0,2822819
ompRp1,0.125,7,7,TGCCACTGGGCTAGGGTTTG,0,2777474
ompRp1,0.125,7,7,TGCAGCCGGCAGTATTAGTA,0,2779984
ompRp1,0.125,7,7,TGCACAAATAAGACATCCAA,0,2767900
ompRp1,0.125,7,7,TGCAAGCAAGGCTATCTGAG,0,2783429
ompRp1,0.125,7,7,TGATTTAACAAGCTTCGAAG,0,2783717
ompRp1,0.125,7,7,TGATGGATGCACGGCATGAT,0,2789578
ompRp1,0.125,7,7,TGATGGACAGAAAGCGTCCA,0,2788908
ompRp1,0.125,7,7,TGATCGCTTCGTTGCTTACC,0,2782134
ompRp1,0.125,7,7,TGATCCTTATTAATAATTAA,0,2822017
ompRp1,0.125,7,7,TGAGCATGGCTTGATGCGCC,0,2779226
ompRp1,0.125,7,7,TGAGAAAGTCGATAGTACGC,0,2785624
ompRp1,0.125,7,7,TGAATATGCAAGTCTCTCCA,0,2822313
ompRp1,0.125,7,7,TGAAGCGGGTGGACTTTAAG,0,2779945
ompRp1,0.125,7,7,TCTTGTATCAGTAAGCAATG,0,2812278
ompRp1,0.125,7,7,TCTTGGATGCTGAGTTCTGT,0,2791768
ompRp1,0.125,7,7,TCTTGCTCCTGGGGCGCGGG,0,2776257
ompRp1,0.125,7,7,TCTTAAGTCGCTTGTGCACA,0,2770663
ompRp1,0.125,7,7,TCTTAAGGGCGGAGTCGTCT,0,2777576
ompRp1,0.125,7,7,TCTGTACTTGCCCGTGAGTT,0,2787641
ompRp1,0.125,7,7,TCTGTAACAAAGGTCCTGCA,0,2800820
ompRp1,0.125,7,7,TCTGGCCCAAGGGACAGCCG,0,2790280
ompRp1,0.125,7,7,TCTGGACGGCATGTACTAGA,0,2790995
ompRp1,0.125,7,7,TCTCGGTTGGGCTTCAAGGC,0,2817513
ompRp1,0.125,7,7,TCTCGGATGGGTCACACGGA,0,2778277
ompRp1,0.125,7,7,TCTCCCGACTGGCAGGCTTG,0,2793567
ompRp1,0.125,7,7,TCTAGAAGTACGTTATGGAT,0,2783931
ompRp1,0.125,7,7,TCTAAGCTTTCAAGGGGTTC,0,2805991
ompRp1,0.125,7,7,TCTAAGCATCTCAGGGCGAG,0,2772658
ompRp1,0.125,7,7,TCTAAATTTGATGGGTTCGC,0,2806688
ompRp1,0.125,7,7,TCTAAACTTCCCTGCCCCGA,0,2781555
ompRp1,0.125,7,7,TCGTGTTCTTTTTACGATTT,0,2808162
ompRp1,0.125,7,7,TCGTGGATACCAACCGTATG,0,2786247
ompRp1,0.125,7,7,TCGTGATGCAGAGTGCGGTT,0,2817456
ompRp1,0.125,7,7,TCGGTTTTGGTAGACTAGTC,0,2810780
ompRp1,0.125,7,7,TCGGTCATCTACGAAGCTAA,0,2790591
ompRp1,0.125,7,7,TCGGGTTGTCCCAGCAGTGC,0,2780884
ompRp1,0.125,7,7,TCGAGGCTTTATAAGTCATA,0,2820077
ompRp1,0.125,7,7,TCCTTTGTAAGGCCTGGGCT,0,2786155
ompRp1,0.125,7,7,TCCGTAGGGTTGCGCAAACT,0,2797625
ompRp1,0.125,7,7,TCCGAATTACTCTCAGCGTT,0,2773951
ompRp1,0.125,7,7,TCCCGCGTACGTGTTTCCGC,0,2772102
ompRp1,0.125,7,7,TCCCCCAAACCGCTATCAGG,0,2808612
ompRp1,0.125,7,7,TCCCAGACCCCACCTGGTTA,0,2806566
ompRp1,0.125,7,7,TCCAGTAAGGTTTTCGGCTT,0,2792671
ompRp1,0.125,7,7,TCATTTTTCCCTTGCCCTAT,0,2809669
ompRp1,0.125,7,7,TCATCTAAAAATTATGTCAG,0,2783833
ompRp1,0.125,7,7,TCATCGCGATTTTCGCCCAG,0,2765548
ompRp1,0.125,7,7,TCATAAGAGTAAGAATTGTT,0,2803710
ompRp1,0.125,7,7,TCAGTTCGTGCTCAAAAGAT,0,2815774
ompRp1,0.125,7,7,TCAGGTTCTAACCGGGCAGT,0,2775606
ompRp1,0.125,7,7,TCAGGAAACGGCAAACCTCC,0,2823202
ompRp1,0.125,7,7,TCACTTCAATTCCTTCTGTC,0,2814209
ompRp1,0.125,7,7,TCACTGACACGATGATAGCG,0,2802283
ompRp1,0.125,7,7,TCACTCATTCCATGCTAGAG,0,2807697
ompRp1,0.125,7,7,TCACTCAGCGTCTCAATAGC,0,2783196
ompRp1,0.125,7,7,TCAAGCCATTGAGGTCCTCT,0,2783272
ompRp1,0.125,7,7,TCAACTGCTCTTCGCGATCT,0,2768808
ompRp1,0.125,7,7,TCAAATTTGGCACGCAAGGA,0,2766037
ompRp1,0.125,7,7,TCAAACTTCTACTGTAAGCT,0,2792280
ompRp1,0.125,7,7,TATTTGTCCGCGCCATAAAA,0,2804540
ompRp1,0.125,7,7,TATTGCGCAGACGGCTGCAT,0,2785689
ompRp1,0.125,7,7,TATGGGCTTCACCACAGAGC,0,2779983
ompRp1,0.125,7,7,TATGCGCGCCTGGAGGTATC,0,2809249
ompRp1,0.125,7,7,TATGCATTTCAGGGCTGCGT,0,2822536
ompRp1,0.125,7,7,TATGAAAGCACAAACATTGA,0,2820452
ompRp1,0.125,7,7,TATCTTGAGCGCTGCCAGAA,0,2795509
ompRp1,0.125,7,7,TATATGTTCCTGTCTCCTTT,0,2789115
ompRp1,0.125,7,7,TATACCCCACCCTCCCCGTG,0,2804215
ompRp1,0.125,7,7,TATAATTCTTTTTGCATTCT,0,2814616
ompRp1,0.125,7,7,TAGGCTGAAGTAGAACCTCG,0,2777374
ompRp1,0.125,7,7,TAGCGTTAGAAGATGAACCA,0,2794028
ompRp1,0.125,7,7,TAGCGAATCGGGATTCGAGG,0,2793349
ompRp1,0.125,7,7,TAGCCTTCCTGTTGGAGTCG,0,2784513
ompRp1,0.125,7,7,TAGCCCTAGTATCGGACTCA,0,2785353
ompRp1,0.125,7,7,TAGCAGTTCTAAAAACAGTT,0,2792743
ompRp1,0.125,7,7,TAGAGTGGAGCGGATGACCT,0,2810023
ompRp1,0.125,7,7,TAGAGGAATATCCCACGCTT,0,2806496
ompRp1,0.125,7,7,TAGAAGGGTAATAGGTGCCT,0,2812231
ompRp1,0.125,7,7,TACTCGCATACTGACAGTAA,0,2808505
ompRp1,0.125,7,7,TACGCCAGCCCGGCGGAACG,0,2791168
ompRp1,0.125,7,7,TACCTGCGCAAAGTTAGAGA,0,2769874
ompRp1,0.125,7,7,TACCGGGTCACAAATTTGGG,0,2769130
ompRp1,0.125,7,7,TACCCCCGGGTGAGCAATAT,0,2780318
ompRp1,0.125,7,7,TACCATCGCTGCGAGGTTCA,0,2816046
ompRp1,0.125,7,7,TACCAATTGCATGCCATTGA,0,2798789
ompRp1,0.125,7,7,TAATTAGTATCATGACTATG,0,2770476
ompRp1,0.125,7,7,TAATGTTCTTCGTGTAGATA,0,2792269
ompRp1,0.125,7,7,TAATAGCTGCCCTACATGGC,0,2785692
ompRp1,0.125,7,7,TAACGTTGAATTCTCTCGAG,0,2805730
ompRp1,0.125,7,7,TAAATTTACGCAGACATTGT,0,2802203
ompRp1,0.125,7,7,TAAAGGTCAGTCGGCTGTTA,0,2784197
ompRp1,0.125,7,7,TAAACCAATCTCGATAAGGA,0,2800239
ompRp1,0.125,7,7,TAAAAGCTGTCTAATATTAA,0,2788543
ompRp1,0.125,7,7,GTTTGCTAGTATCAGAATTA,0,2777801
ompRp1,0.125,7,7,GTTGCACCAGCTGGCGCTTT,0,2786938
ompRp1,0.125,7,7,GTTCATCTAACCCTCTGTAT,0,2774483
ompRp1,0.125,7,7,GTTATGGACAATAAGGAGGC,0,2812660
ompRp1,0.125,7,7,GTTAGTTACAACATCAAATG,0,2789826
ompRp1,0.125,7,7,GTTAGCAGATGCATGACCCC,0,2781739
ompRp1,0.125,7,7,GTTACTGGGGATGTTACACA,0,2822129
ompRp1,0.125,7,7,GTTAAGGGTATATTTTTCGC,0,2786665
ompRp1,0.125,7,7,GTTAAATGTTTGGGATTATA,0,2813930
ompRp1,0.125,7,7,GTGTTGCTCCATCTCCTCCA,0,2806612
ompRp1,0.125,7,7,GTGTAAACCTCGTTCCCAAA,0,2782362
ompRp1,0.125,7,7,GTGGGACTTCGACACTCGCC,0,2812520
ompRp1,0.125,7,7,GTGGCCTAAAGTGCACATCG,0,2792559
ompRp1,0.125,7,7,GTGCTTGAATGCCGAACATC,0,2800006
ompRp1,0.125,7,7,GTGCGCCGGATTTGACGCTA,0,2781069
ompRp1,0.125,7,7,GTGCAGTGTTGGTTTCGTCC,0,2793979
ompRp1,0.125,7,7,GTGCAGCAGGCCATACGAAC,0,2802355
ompRp1,0.125,7,7,GTGCAAGTCCGTAGAGATAG,0,2768181
ompRp1,0.125,7,7,GTGATTGTTGGCCGCTCGAA,0,2768519
ompRp1,0.125,7,7,GTGATCTCTTTGCTCAGGTC,0,2799162
ompRp1,0.125,7,7,GTGACCCGCCACCTTCTGGT,0,2796618
ompRp1,0.125,7,7,GTGACAACTATGGGCATAGC,0,2796921
ompRp1,0.125,7,7,GTGAAGACTGTCCACGCAAA,0,2813929
ompRp1,0.125,7,7,GTCGGGCTAATCGGAGGGAG,0,2782478
ompRp1,0.125,7,7,GTCCTCTAGGACATCCTCTG,0,2807274
ompRp1,0.125,7,7,GTCCGTGTGAATCTCGGAGA,0,2820869
ompRp1,0.125,7,7,GTCCAGGAGCGGCCATGAAT,0,2811012
ompRp1,0.125,7,7,GTCACTGTATTAGACAAACA,0,2815334
ompRp1,0.125,7,7,GTCAACGCCTCGTCCGTTAG,0,2776961
ompRp1,0.125,7,7,GTATGGTGTTTCGGGTTGCT,0,2805355
ompRp1,0.125,7,7,GTATCATACCGTGAATGATG,0,2817619
ompRp1,0.125,7,7,GTAGTGCCCGTCGGAATATG,0,2814585
ompRp1,0.125,7,7,GTAGGTTACCACTGCAAGTT,0,2810056
ompRp1,0.125,7,7,GTACAGTTGTCCCTATACAA,0,2783043
ompRp1,0.125,7,7,GTACAAGCAGCTGCGATCAT,0,2803339
ompRp1,0.125,7,7,GTAACTATACCGACTCTAGT,0,2781049
ompRp1,0.125,7,7,GTAACGGCCGTACAAGACTG,0,2770232
ompRp1,0.125,7,7,GTAACCGCGCTGGCACCGTC,0,2811372
ompRp1,0.125,7,7,GTAACATTTCCGGGGATCTG,0,2765398
ompRp1,0.125,7,7,GGTTTGCCATAGCGAGCGAA,0,2782718
ompRp1,0.125,7,7,GGTTTCGTCAGTCGTAGTCT,0,2816972
ompRp1,0.125,7,7,GGTTGTTGCTCCTCCAATGG,0,2775243
ompRp1,0.125,7,7,GGTTAAATGACGGTCGGGCG,0,2777264
ompRp1,0.125,7,7,GGTGGGATCAACGGACACGG,0,2767023
ompRp1,0.125,7,7,GGTGCTTAAGTTCGAACGAA,0,2781167
ompRp1,0.125,7,7,GGTCCTTCACACCGGATAAT,0,2774379
ompRp1,0.125,7,7,GGTCCTAAAACTTAGACGAG,0,2769681
ompRp1,0.125,7,7,GGTCCATGCGTCTCAGGGCA,0,2766365
ompRp1,0.125,7,7,GGTACGGGAGTCCCCCAACT,0,2809002
ompRp1,0.125,7,7,GGTAAATTAGATACAATGCG,0,2791713
ompRp1,0.125,7,7,GGTAAAATTTACACGTGTTC,0,2784938
ompRp1,0.125,7,7,GGGTTCCAGGGGCCCTCCGT,0,2772944
ompRp1,0.125,7,7,GGGTTAGCCACACAAGCCAC,0,2802322
ompRp1,0.125,7,7,GGGTTAGAACCTGTCTAGTC,0,2771758
ompRp1,0.125,7,7,GGGTCTGCCATAAGTTGCTA,0,2819493
ompRp1,0.125,7,7,GGGTATAGTCGGGGCGAGCT,0,2789324
ompRp1,0.125,7,7,GGGGTGAGGTTATTGGGATC,0,2793115
ompRp1,0.125,7,7,GGGGTCTCAGCGTGAGTAGT,0,2768413
ompRp1,0.125,7,7,GGGGGCGCATACACAAAACA,0,2793642
ompRp1,0.125,7,7,GGGGGAAACAAATCGTGGAG,0,2768965
ompRp1,0.125,7,7,GGGCGTTGATGCCTAAATGA,0,2817817
ompRp1,0.125,7,7,GGGCCGTAGTTGGCCCCATG,0,2780498
ompRp1,0.125,7,7,GGGATCAGAAAAAGGGCTTA,0,2818448
ompRp1,0.125,7,7,GGGAGCGTTGAAATCCACTA,0,2807285
ompRp1,0.125,7,7,GGGAGAGCAATATCTACGCC,0,2771675
ompRp1,0.125,7,7,GGGAAGGGACTCGCATATTG,0,2786289
ompRp1,0.125,7,7,GGGAACGTCCAGTCCAGGGG,0,2823937
ompRp1,0.125,7,7,GGCTTGGACGCATATGAGTT,0,2772982
ompRp1,0.125,7,7,GGCTCTCCCGACGTGCGTAA,0,2798022
ompRp1,0.125,7,7,GGCTCCTCCGTGCCCTCTTT,0,2772346
ompRp1,0.125,7,7,GGCTCCATGCTTCTAATCCA,0,2795762
ompRp1,0.125,7,7,GGCTCACATGATTGAAAAAT,0,2769553
ompRp1,0.125,7,7,GGCTAGAGGTCGCCTTTAGC,0,2798021
ompRp1,0.125,7,7,GGCGATTTGGATGCGCTGGG,0,2772919
ompRp1,0.125,7,7,GGCCTTTATGAACTGGTTAG,0,2778819
ompRp1,0.125,7,7,GGCCGTGCATCCGTCACGGA,0,2786146
ompRp1,0.125,7,7,GGCCCTATTCAATCATATTG,0,2778853
ompRp1,0.125,7,7,GGCCCGACGTGCAAGGACGA,0,2804466
ompRp1,0.125,7,7,GGCATCGCGGCATACACGGG,0,2799782
ompRp1,0.125,7,7,GGCATAGCAGTGATACAGGT,0,2802477
ompRp1,0.125,7,7,GGCAAGTTGTAAAGCAAGCA,0,2817371
ompRp1,0.125,7,7,GGATTCGGTAGCTACTTGTG,0,2819681
ompRp1,0.125,7,7,GGATGTTAGCGGGAGTCGTG,0,2795986
ompRp1,0.125,7,7,GGATCTTCACTGTGCTTTGT,0,2793618
ompRp1,0.125,7,7,GGATAGACCACGGTGTGACA,0,2806070
ompRp1,0.125,7,7,GGATACATGTGGAATTATCC,0,2772435
ompRp1,0.125,7,7,GGAGTTTTGCCGGAGGGCAT,0,2817806
ompRp1,0.125,7,7,GGAGTAGTTGCATAGTTGGC,0,2820802
ompRp1,0.125,7,7,GGACTCACGACGCCTAATCA,0,2775504
ompRp1,0.125,7,7,GGACTAAATTGCGGTCCTCT,0,2781109
ompRp1,0.125,7,7,GGACGTGGCTTGACGTGAAA,0,2798323
ompRp1,0.125,7,7,GGAATAGATCGTTGATGTTC,0,2816845
ompRp1,0.125,7,7,GGAAGGGACTGAGGGCCGGC,0,2802417
ompRp1,0.125,7,7,GGAACGGACGTTATTTGTTT,0,2797218
ompRp1,0.125,7,7,GGAACCTGAACTACCATAAG,0,2824389
ompRp1,0.125,7,7,GGAAAGGTTATACCTCCCTA,0,2813799
ompRp1,0.125,7,7,GCTTTTAATGTGGTACGAAC,0,2773595
ompRp1,0.125,7,7,GCTTGGCAGGCCTCTATGTA,0,2766878
ompRp1,0.125,7,7,GCTTCGTTAGACGCAATCGC,0,2782294
ompRp1,0.125,7,7,GCTTCCGGGGACTCTTGGCC,0,2780829
ompRp1,0.125,7,7,GCTTATTAGAATAGGTAGTG,0,2801863
ompRp1,0.125,7,7,GCTGGGTTGACACATAGTGA,0,2805554
ompRp1,0.125,7,7,GCTGAAACGTACAGTAATCC,0,2798082
ompRp1,0.125,7,7,GCTATTTCGGGGGTCCATGC,0,2814403
ompRp1,0.125,7,7,GCTACTTATCGAAAGTGTGT,0,2782609
ompRp1,0.125,7,7,GCTAATTGCGACTTAAATGG,0,2765767
ompRp1,0.125,7,7,GCGTTGTCAAAGCTTACAGG,0,2784369
ompRp1,0.125,7,7,GCGTAGGACGCCAGTTAGCC,0,2773914
ompRp1,0.125,7,7,GCGTAACAGACCAATGTGTT,0,2778472
ompRp1,0.125,7,7,GCGGTTTATCGTGCGTCGGA,0,2772857
ompRp1,0.125,7,7,GCGGTACAGTCACCCACCCG,0,2801941
ompRp1,0.125,7,7,GCGGGCATACAGAACATGCA,0,2819389
ompRp1,0.125,7,7,GCGGCTGGGGAGCCGGAGTG,0,2799664
ompRp1,0.125,7,7,GCGGAGCCTGCTAATACGGG,0,2775492
ompRp1,0.125,7,7,GCGCGAATGGGACTGCAGCA,0,2766451
ompRp1,0.125,7,7,GCGACTGCGGCCTGGGCTGA,0,2781834
ompRp1,0.125,7,7,GCGACGCGCCTGGACGGCGA,0,2819054
ompRp1,0.125,7,7,GCGACACGCGGACCTCTGCC,0,2811748
ompRp1,0.125,7,7,GCCTTGGAGGTCTGTCTGTC,0,2769780
ompRp1,0.125,7,7,GCCTCGTGAGCATCACTACT,0,2817760
ompRp1,0.125,7,7,GCCTATTGCGCAACCCTGCT,0,2783294
ompRp1,0.125,7,7,GCCGTCAGTCAGAACATAAT,0,2797311
ompRp1,0.125,7,7,GCCGGCATTGAATTAGCCAT,0,2806398
ompRp1,0.125,7,7,GCCGAAATCCTAATAATAGT,0,2774245
ompRp1,0.125,7,7,GCCCCGTTATAAGAGAGCGC,0,2820636
ompRp1,0.125,7,7,GCATTGGCCGTGGTTAAAGT,0,2774475
ompRp1,0.125,7,7,GCATTGAGCCGGTAGAGCTG,0,2812923
ompRp1,0.125,7,7,GCATGTTCCTCGCAGGTCTA,0,2814376
ompRp1,0.125,7,7,GCATCCAGATAGGTCACCTC,0,2797741
ompRp1,0.125,7,7,GCATACGAGGGTGCCTCAAT,0,2823155
ompRp1,0.125,7,7,GCAGTTTCCAAAGGTGAGTC,0,2809918
ompRp1,0.125,7,7,GCAGTCTCCCTGGGCTGGTT,0,2775148
ompRp1,0.125,7,7,GCAGTACGGGTGATAAAGGT,0,2822622
ompRp1,0.125,7,7,GCAGTAATGATCCGCAACGC,0,2824150
ompRp1,0.125,7,7,GCAGCTCGAGGTGTGAGACT,0,2796721
ompRp1,0.125,7,7,GCAGCGACGCCAAGGGAACG,0,2794604
ompRp1,0.125,7,7,GCAGCGACGAGAGGCTTGTC,0,2779180
ompRp1,0.125,7,7,GCAGAAGCACTAGAAAGTGC,0,2788818
ompRp1,0.125,7,7,GCACTAATCGGGACCTCCTG,0,2823636
ompRp1,0.125,7,7,GCACGCTCAGTGATTATGAA,0,2786596
ompRp1,0.125,7,7,GCAATTCTCAGTGTTTACTA,0,2801094
ompRp1,0.125,7,7,GCAATTAGAATTCCGAGTGT,0,2789830
ompRp1,0.125,7,7,GCAAGTTGAACTAGAACCAA,0,2816083
ompRp1,0.125,7,7,GCAAGACGGGCGCCATTTAC,0,2807143
ompRp1,0.125,7,7,GCAACTTGCCTGGACGTGAG,0,2787882
ompRp1,0.125,7,7,GCAAACTACTTCAGTTTTGA,0,2766883
ompRp1,0.125,7,7,GATTTGTAGAGCAACAGCTC,0,2785019
ompRp1,0.125,7,7,GATTGTAGAAAAAATGAAGT,0,2784834
ompRp1,0.125,7,7,GATTCAAAACCTGCAACGTG,0,2794143
ompRp1,0.125,7,7,GATTAATAACAATCGTATCA,0,2772431
ompRp1,0.125,7,7,GATGGGACTTAGTTCAACGT,0,2815703
ompRp1,0.125,7,7,GATCTGGCGGAGAGTTTACG,0,2803831
ompRp1,0.125,7,7,GATCTGAGAATTGCTCATAC,0,2786493
ompRp1,0.125,7,7,GATAGAATAGGTCGTGCCCA,0,2812477
ompRp1,0.125,7,7,GATACCGTGGGATGGTCGTT,0,2812575
ompRp1,0.125,7,7,GATACCCGTCTTGCGCTATA,0,2810768
ompRp1,0.125,7,7,GATAAGAAATTGGCCCCAAG,0,2784209
ompRp1,0.125,7,7,GATAACCGATGCGACGTGCA,0,2799481
ompRp1,0.125,7,7,GATAAAGTGAGGTATGGATG,0,2798174
ompRp1,0.125,7,7,GAGTGACTTCATTAAAAAGC,0,2810017
ompRp1,0.125,7,7,GAGGTGTTCGGGGCATGCAG,0,2767160
ompRp1,0.125,7,7,GAGGGAGGTTAAGCCTGAGA,0,2770814
ompRp1,0.125,7,7,GAGGCTTTCTTGGCAAGAGT,0,2772012
ompRp1,0.125,7,7,GAGGCATGCTGTTACGATGA,0,2802073
ompRp1,0.125,7,7,GAGCCAATCTGGGCTGCCCA,0,2786056
ompRp1,0.125,7,7,GAGCAGACCGACCAAGTAAT,0,2782592
ompRp1,0.125,7,7,GAGCACTTATTCACGATATG,0,2814307
ompRp1,0.125,7,7,GAGACGACTGCTTTGAGATC,0,2802607
ompRp1,0.125,7,7,GAGACAAATAAGGGGAGCGT,0,2773924
ompRp1,0.125,7,7,GAGAAACAACTCGGATACAG,0,2776803
ompRp1,0.125,7,7,GACTTTCCGTGGCTTCCATA,0,2766976
ompRp1,0.125,7,7,GACTCTCACATGACTTGAAC,0,2797718
ompRp1,0.125,7,7,GACCGACGGGCCTATGCCAC,0,2822584
ompRp1,0.125,7,7,GACCCTGCAGAGTGTACAGG,0,2810760
ompRp1,0.125,7,7,GACCAGGAGGAGGGATAGGC,0,2818677
ompRp1,0.125,7,7,GACAGAAGTGTTGTACTGTG,0,2781726
ompRp1,0.125,7,7,GACACTTTATACAAAAAACC,0,2772802
ompRp1,0.125,7,7,GAATTGGCGCGCCTTTGGTT,0,2783050
ompRp1,0.125,7,7,GAATGGAGTCAGTCTCGGTG,0,2792972
ompRp1,0.125,7,7,GAAGGTCGTACCCGTTGGTC,0,2823354
ompRp1,0.125,7,7,GAAGGGTTGGTGGACCCTGG,0,2769952
ompRp1,0.125,7,7,GAAGGCACTCTGCCTAAGCT,0,2786690
ompRp1,0.125,7,7,GAAGGAAGTGATGATTTCTG,0,2823405
ompRp1,0.125,7,7,GAACTGTTATACTGCATCGC,0,2782779
ompRp1,0.125,7,7,GAACGGTTCACAAGGGCTCT,0,2790088
ompRp1,0.125,7,7,GAACGATACTGTCCCCGCAG,0,2814335
ompRp1,0.125,7,7,GAAAGGGATGTAAAAAAATA,0,2791202
ompRp1,0.125,7,7,GAAACGATCCCCTCGGCCAT,0,2801807
ompRp1,0.125,7,7,GAAACATGGGGGCATGAGTG,0,2769490
ompRp1,0.125,7,7,CTTTCGTCAGTCCATGCTGA,0,2811889
ompRp1,0.125,7,7,CTTTCATTTGGCTCCGGTTT,0,2812465
ompRp1,0.125,7,7,CTTGTTCAGTACCCAATCTT,0,2796829
ompRp1,0.125,7,7,CTTGTCGTGCAAAATGAGTA,0,2784029
ompRp1,0.125,7,7,CTTGGGTGTTGCCTGGAAGT,0,2773509
ompRp1,0.125,7,7,CTTATGAGATAATCCCTAAT,0,2817633
ompRp1,0.125,7,7,CTTACAGACTAAGTTCTCGA,0,2819630
ompRp1,0.125,7,7,CTTAATTGGTTGCAGTATCG,0,2794957
ompRp1,0.125,7,7,CTTAATAGCCGCTTGCGTTC,0,2786388
ompRp1,0.125,7,7,CTGTTTTTCCAGGACGTCTT,0,2816602
ompRp1,0.125,7,7,CTGGGGACTAACGTTGCGTT,0,2790595
ompRp1,0.125,7,7,CTGGGCTTAGAAATTACGCT,0,2804949
ompRp1,0.125,7,7,CTGGCGTCACCCGGGACCTG,0,2780695
ompRp1,0.125,7,7,CTGCGTTCGTCATATACATC,0,2803914
ompRp1,0.125,7,7,CTGCCTTCATTCAGGTCGTT,0,2819723
ompRp1,0.125,7,7,CTGCCAACACACGATTTTAG,0,2784758
ompRp1,0.125,7,7,CTGCAAATTTAGGCTTTCGG,0,2808921
ompRp1,0.125,7,7,CTGAACATGGGATAAACGTC,0,2795599
ompRp1,0.125,7,7,CTCTGTAGGCTTAGTCCGCG,0,2780584
ompRp1,0.125,7,7,CTCTGCAGGGTCCATACTAG,0,2773808
ompRp1,0.125,7,7,CTCTCCTTCTCCGAGCACGC,0,2801869
ompRp1,0.125,7,7,CTCTCATATTTTGATCGTCG,0,2786554
ompRp1,0.125,7,7,CTCTCACCCTGCTAACCGCT,0,2822700
ompRp1,0.125,7,7,CTCGTAATTATTTAATGGAG,0,2823960
ompRp1,0.125,7,7,CTCGGTGAGGCAATGGGGAG,0,2802150
ompRp1,0.125,7,7,CTCGCGTTCGGATCTATAAA,0,2787184
ompRp1,0.125,7,7,CTCATTGCTAGTCCGGATGC,0,2787173
ompRp1,0.125,7,7,CTCATTCACCCGTGCCTTCC,0,2793160
ompRp1,0.125,7,7,CTCATATGCTGCGTCCACTG,0,2805915
ompRp1,0.125,7,7,CTCATACAACCGCCTGATAT,0,2819255
ompRp1,0.125,7,7,CTCAGAGAGCCCCGGCGCGG,0,2789889
ompRp1,0.125,7,7,CTCACTCGACTGTTTATCAA,0,2795111
ompRp1,0.125,7,7,CTCAATTTATCATAGGCGCT,0,2771300
ompRp1,0.125,7,7,CTATGCGCTTAGCGATTTCC,0,2781012
ompRp1,0.125,7,7,CTATAGGGAGGGCCTGGTCA,0,2792815
ompRp1,0.125,7,7,CTAGGGCATACTTATAGCGA,0,2808628
ompRp1,0.125,7,7,CTAGGGAAGAAATCACACTA,0,2796437
ompRp1,0.125,7,7,CTAGCCCATAGTGGCGGAGA,0,2785927
ompRp1,0.125,7,7,CTAGCCACTGCGCCGGCTCT,0,2820615
ompRp1,0.125,7,7,CTAGCATGCATTGATAGAAT,0,2807443
ompRp1,0.125,7,7,CTAGATGTCAAACTAATTCC,0,2765592
ompRp1,0.125,7,7,CTAGACCATCGAATCACTCC,0,2815645
ompRp1,0.125,7,7,CTAGAATGTTGACGAACAGA,0,2798792
ompRp1,0.125,7,7,CTACTCTGGACGCAAAGGCC,0,2783522
ompRp1,0.125,7,7,CTACGAATCTCTTGGTTGTT,0,2806963
ompRp1,0.125,7,7,CTACCTGGGGAGGTAGGCCT,0,2765433
ompRp1,0.125,7,7,CTAATCTAGGGTCATGTTTC,0,2800947
ompRp1,0.125,7,7,CTAAGGGGCTTTTAGTTCAA,0,2820759
ompRp1,0.125,7,7,CTAAGCTAAAGAGTTAAAGA,0,2770902
ompRp1,0.125,7,7,CTAAGCCATAGGTTGGAGCC,0,2800462
ompRp1,0.125,7,7,CTAAAGAGTCAGTCCCTGGA,0,2815162
ompRp1,0.125,7,7,CGTTTAGCGTAGATTATGCT,0,2798334
ompRp1,0.125,7,7,CGTTACAGCCGCCGGGCATA,0,2808681
ompRp1,0.125,7,7,CGTGTTGGTTAATGAACTGG,0,2774582
ompRp1,0.125,7,7,CGTGTCACGCCCTTGACGTG,0,2812793
ompRp1,0.125,7,7,CGTGCTGAACAACACAGATA,0,2806356
ompRp1,0.125,7,7,CGTGCGTTCACACGATTGCG,0,2796277
ompRp1,0.125,7,7,CGTGCGAAACGTTCCAGATC,0,2803810
ompRp1,0.125,7,7,CGTCTCAATGTCTCGGTCGT,0,2802807
ompRp1,0.125,7,7,CGTCCGCGGAGACAAGGTTA,0,2818567
ompRp1,0.125,7,7,CGTCCCCGCGACCCGGGACT,0,2776744
ompRp1,0.125,7,7,CGTCATTCCGACTCAGTGTC,0,2820267
ompRp1,0.125,7,7,CGTATCGAACCAGCTGGGTT,0,2788085
ompRp1,0.125,7,7,CGGTCTTTATTGCTCCACCG,0,2786466
ompRp1,0.125,7,7,CGGGTCCTTTGTGGGTTAAT,0,2805061
ompRp1,0.125,7,7,CGGGCGCACTAGACTGTGTC,0,2815109
ompRp1,0.125,7,7,CGGGCCTTTGGTCTACGACT,0,2766447
ompRp1,0.125,7,7,CGGCTATTAAAAGTACATGA,0,2767132
ompRp1,0.125,7,7,CGGCGGCGTCTTCAGATGGA,0,2805990
ompRp1,0.125,7,7,CGGCCTGAGCGAGTAGTCAT,0,2777978
ompRp1,0.125,7,7,CGGCCTACGTACATCGCCTA,0,2787686
ompRp1,0.125,7,7,CGGCCACTTGAACCTTTCTT,0,2794295
ompRp1,0.125,7,7,CGGACCTTCTCTAGCGACAC,0,2790938
ompRp1,0.125,7,7,CGGAATTTAAGCATTAATGA,0,2776938
ompRp1,0.125,7,7,CGGAAGTTTTCAGCGAAAGT,0,2816183
ompRp1,0.125,7,7,CGCTGTGGTCGCCAGATTGC,0,2806651
ompRp1,0.125,7,7,CGCTGGTATCTTAATCTCGC,0,2819458
ompRp1,0.125,7,7,CGCTCTCGTTACAATTCATT,0,2810681
ompRp1,0.125,7,7,CGCTCTATCGGTTGAGGAAG,0,2818946
ompRp1,0.125,7,7,CGCCGGTTGGGTGAAGACGT,0,2800732
ompRp1,0.125,7,7,CGCCCCTTGGGTATTCTTGA,0,2808499
ompRp1,0.125,7,7,CGCCCATGACGTCGTTTAGT,0,2803443
ompRp1,0.125,7,7,CGCCAACGCGACCCCGTCAG,0,2789579
ompRp1,0.125,7,7,CGCATTGAGGACATACCTTT,0,2790581
ompRp1,0.125,7,7,CGCATGGTGAAGAATAAGGA,0,2806422
ompRp1,0.125,7,7,CGCAGTCACGGATCCTTTGT,0,2809391
ompRp1,0.125,7,7,CGCAGCCGTTAGCTGGGTAC,0,2823480
ompRp1,0.125,7,7,CGCAGAGGGTTAGCGGTTGC,0,2818974
ompRp1,0.125,7,7,CGCACCCATTAATCGCCTTT,0,2794856
ompRp1,0.125,7,7,CGATACCCCATCTAACGGAG,0,2808962
ompRp1,0.125,7,7,CGAGAAAAGCCTGTTCATGA,0,2782148
ompRp1,0.125,7,7,CGAATTGGATGATCGGGATC,0,2779154
ompRp1,0.125,7,7,CGAACGGGTCGGCAGATCGT,0,2811543
ompRp1,0.125,7,7,CGAACCTCGGAACTCTCGTT,0,2797665
ompRp1,0.125,7,7,CGAACCGTTAAGCCTAGCCG,0,2779255
ompRp1,0.125,7,7,CGAAATTGGTGGGCTTGGCG,0,2781944
ompRp1,0.125,7,7,CCTTCCGATTACAGGATCCC,0,2782854
ompRp1,0.125,7,7,CCTTCATACGCAAACGGTTT,0,2786759
ompRp1,0.125,7,7,CCTTATCAAATTGGATGCGG,0,2768460
ompRp1,0.125,7,7,CCTTAAATTGTACTAATAGT,0,2779828
ompRp1,0.125,7,7,CCTCTGATGTCACCTCTGGT,0,2775294
ompRp1,0.125,7,7,CCTCAGCAAGTGTCTCCAAT,0,2820285
ompRp1,0.125,7,7,CCTCAGAGTACCAGCCCGTA,0,2822585
ompRp1,0.125,7,7,CCTCAGACGATAGCATCTCA,0,2788878
ompRp1,0.125,7,7,CCTACACTTCGGGCCTACAG,0,2796409
ompRp1,0.125,7,7,CCTAAAAGCATTGGCTGGGG,0,2793412
ompRp1,0.125,7,7,CCGTTCCTAGAGTGTCACTC,0,2768177
ompRp1,0.125,7,7,CCGTTCACATTGGGTGTGAC,0,2795211
ompRp1,0.125,7,7,CCGTTACCGTCGGGATTAGT,0,2819983
ompRp1,0.125,7,7,CCGTGAAGGCTTCCAAATGT,0,2777501
ompRp1,0.125,7,7,CCGTATACTTCATGGGATAA,0,2798113
ompRp1,0.125,7,7,CCGGCTTTGGTCTCTGCGTG,0,2807099
ompRp1,0.125,7,7,CCGGAGCTGTATATGCGTAT,0,2765962
ompRp1,0.125,7,7,CCGGACGAGGGCTCCGCATT,0,2810874
ompRp1,0.125,7,7,CCGCTCGCATGTGCGCTTAC,0,2781219
ompRp1,0.125,7,7,CCGCGGGTAACACCTACAAT,0,2807151
ompRp1,0.125,7,7,CCGAGTACCAATCAATACCC,0,2799494
ompRp1,0.125,7,7,CCGAGTAACCCGACCGCTAG,0,2773100
ompRp1,0.125,7,7,CCGACTGCCAACGCCGAATA,0,2817981
ompRp1,0.125,7,7,CCGAAGCCGGTCACATGGTA,0,2770281
ompRp1,0.125,7,7,CCCTTTAGAGGGTTTGTGGT,0,2810477
ompRp1,0.125,7,7,CCCGGGTTAGGTTAGGGCAT,0,2801883
ompRp1,0.125,7,7,CCCGAGTGGAGTCATACGGG,0,2782689
ompRp1,0.125,7,7,CCCGACCTAATTGATGAGAA,0,2793830
ompRp1,0.125,7,7,CCCGACACGTTAGAAGGGTT,0,2799404
ompRp1,0.125,7,7,CCCCTGCGTAGTCAGATCCA,0,2774979
ompRp1,0.125,7,7,CCCCTCCGCTGGACTTGGTA,0,2823422
ompRp1,0.125,7,7,CCCCGTCCCCAGTACTCAGG,0,2784108
ompRp1,0.125,7,7,CCCCGCTTGGGAATTTGGAG,0,2777900
ompRp1,0.125,7,7,CCCCCTTGGTCGTGTAGGCC,0,2782593
ompRp1,0.125,7,7,CCCCAGCAGGGCTCAAAACA,0,2798420
ompRp1,0.125,7,7,CCCATTGTTACATCCCCGGA,0,2785464
ompRp1,0.125,7,7,CCCATATATGATGTCCTGCT,0,2775874
ompRp1,0.125,7,7,CCCATAGCAATAGTGGCGTC,0,2819886
ompRp1,0.125,7,7,CCCATAATAATCTCGATTAC,0,2784759
ompRp1,0.125,7,7,CCCAGGCGGGCTACTTCTGA,0,2773359
ompRp1,0.125,7,7,CCCACGGTCACCCAAAGAGG,0,2811816
ompRp1,0.125,7,7,CCCACCCGAATGGGTGTTTT,0,2785506
ompRp1,0.125,7,7,CCCACAAGGAGGCCCGACTA,0,2770388
ompRp1,0.125,7,7,CCCAAAGCGTGGTTAACAGT,0,2817101
ompRp1,0.125,7,7,CCCAAAGCCTTAATCTAAGG,0,2775446
ompRp1,0.125,7,7,CCATTCAATCAGCAATCATT,0,2809600
ompRp1,0.125,7,7,CCATGCTGTAGACTGTTATT,0,2774308
ompRp1,0.125,7,7,CCATCTTGCGCGATTCGCGC,0,2769067
ompRp1,0.125,7,7,CCATAGACTGAGGTATTAAG,0,2791542
ompRp1,0.125,7,7,CCATAATTAAGTTACGAATC,0,2768432
ompRp1,0.125,7,7,CCAGGTTTGGCAGTCAAGAA,0,2787106
ompRp1,0.125,7,7,CCAGGTGCCCTCTCAGTAAT,0,2788900
ompRp1,0.125,7,7,CCAGGATGTGATACAATTTT,0,2798691
ompRp1,0.125,7,7,CCAGAGGATGTCAATCACGT,0,2799953
ompRp1,0.125,7,7,CCAGAGAGAGGGGTCACGAG,0,2815644
ompRp1,0.125,7,7,CCACTCGGAGGAGAGGACAG,0,2808561
ompRp1,0.125,7,7,CCACGACTTTTTAGTACACC,0,2805200
ompRp1,0.125,7,7,CCACATAGGTACCTTTTCCT,0,2786467
ompRp1,0.125,7,7,CCACAACTCCGTTCCCAAGC,0,2803445
ompRp1,0.125,7,7,CCAAAGATAAAGTCCTCTAG,0,2786822
ompRp1,0.125,7,7,CATTTCATGTAGTTTAGCCA,0,2821127
ompRp1,0.125,7,7,CATTGACTAAACGTGGCCTC,0,2796464
ompRp1,0.125,7,7,CATGTAGAGTATCTTAAGCA,0,2772439
ompRp1,0.125,7,7,CATGCTACACTTGGTGGGAT,0,2783151
ompRp1,0.125,7,7,CATGACGCACGCTGGAGGCG,0,2778772
ompRp1,0.125,7,7,CATCTTGGATGCACTGTAAT,0,2767131
ompRp1,0.125,7,7,CATCTCAACCGATGGCACTG,0,2776100
ompRp1,0.125,7,7,CATCGGTTCGCCAGGCTTCT,0,2766260
ompRp1,0.125,7,7,CATCGCGACTTTTTATCACT,0,2817544
ompRp1,0.125,7,7,CATCCTCTCTTATTGTAAAA,0,2818415
ompRp1,0.125,7,7,CATCAAAACGGTATCGAATG,0,2809402
ompRp1,0.125,7,7,CATAGCCCGCGTTCGCACAG,0,2817194
ompRp1,0.125,7,7,CATACTGGCCGTTCAATGTA,0,2815298
ompRp1,0.125,7,7,CATACTCTAACGGCTACCGT,0,2815238
ompRp1,0.125,7,7,CATACGACTGTTCGTCTCCT,0,2813453
ompRp1,0.125,7,7,CAGTTCGAGCTCATATTCGA,0,2766891
ompRp1,0.125,7,7,CAGTTACTCGACTATTTTTT,0,2794586
ompRp1,0.125,7,7,CAGTGGATCTGAGATCAGGC,0,2767690
ompRp1,0.125,7,7,CAGGGGGGTCAGCTCTGCAG,0,2809744
ompRp1,0.125,7,7,CAGGCTACAATAATAAGCTT,0,2807427
ompRp1,0.125,7,7,CAGGCATGCACGTTCGGTCG,0,2780681
ompRp1,0.125,7,7,CAGCTGATCCACGGAAGAAA,0,2790159
ompRp1,0.125,7,7,CAGCGGGACTGTATACGGAG,0,2790215
ompRp1,0.125,7,7,CAGATATTGGCTTTGAACCC,0,2823609
ompRp1,0.125,7,7,CAGAACCAAGCTGCTCCGTT,0,2805916
ompRp1,0.125,7,7,CACTGTTCCTCGGGTCAATC,0,2765564
ompRp1,0.125,7,7,CACTCGTTGGTTTACCAAGG,0,2780161
ompRp1,0.125,7,7,CACGGGGTTGCAGCACTACT,0,2804411
ompRp1,0.125,7,7,CACGGGAGGGCGTTTTGCCG,0,2786221
ompRp1,0.125,7,7,CACGCTCTGTCGTGGCAATA,0,2805384
ompRp1,0.125,7,7,CACCGGCAAATCTCGGGAGA,0,2767432
ompRp1,0.125,7,7,CACCAGTTATATTGAGCATC,0,2766558
ompRp1,0.125,7,7,CACATGTTTAACCGGGATAG,0,2798239
ompRp1,0.125,7,7,CACAGTACTTTGGAAGGGTT,0,2811932
ompRp1,0.125,7,7,CACAGCCATCCGTAGAGTCT,0,2772294
ompRp1,0.125,7,7,CACAAGCAGCTGATCCAGAG,0,2770681
ompRp1,0.125,7,7,CACAACCTAACAATCCTGGC,0,2804454
ompRp1,0.125,7,7,CAATTACCGAAACACGCCCA,0,2787788
ompRp1,0.125,7,7,CAATCTCTGGACCGCAACGC,0,2771592
ompRp1,0.125,7,7,CAATATTAATTCATTCAACA,0,2811232
ompRp1,0.125,7,7,CAAGTTTTACGGCCTAGTGG,0,2808257
ompRp1,0.125,7,7,CAAGTTAGGCCACGTGTCAT,0,2807686
ompRp1,0.125,7,7,CAAGGCTGACTTGTCATCTA,0,2790986
ompRp1,0.125,7,7,CAAGCCGGAGCTCTGACTCT,0,2778848
ompRp1,0.125,7,7,CAACGTGAGATCAGCGATGT,0,2772146
ompRp1,0.125,7,7,CAACGGGCCATCGACAAGGT,0,2791814
ompRp1,0.125,7,7,CAACCGGGTTAACTGCAACT,0,2803943
ompRp1,0.125,7,7,CAACAAACTGACGGCTACAA,0,2794768
ompRp1,0.125,7,7,CAACAAAAGCGAAGTTGGGG,0,2809014
ompRp1,0.125,7,7,ATTTTCGAGTAATGCAGTTG,0,2799226
ompRp1,0.125,7,7,ATTGGAACATGCCGCACGGT,0,2813288
ompRp1,0.125,7,7,ATTGCCGTGGAAGGGCACAC,0,2765754
ompRp1,0.125,7,7,ATTGAAAAGCCAGGGAGTGG,0,2805508
ompRp1,0.125,7,7,ATTCGTTATCTAGAAACATT,0,2806685
ompRp1,0.125,7,7,ATTCGCTAGGGCATCTCGGC,0,2785992
ompRp1,0.125,7,7,ATTCCAAGTGGTAGCATTCT,0,2769017
ompRp1,0.125,7,7,ATTACGGGATCAGCCTAAGA,0,2802339
ompRp1,0.125,7,7,ATGTTACATCAGTTCAGCTT,0,2769621
ompRp1,0.125,7,7,ATGTCCTTCCGATGGCCATG,0,2794183
ompRp1,0.125,7,7,ATGGTGTCAATCTGCAAACG,0,2768874
ompRp1,0.125,7,7,ATGGTCTAGTGGAGCTGGTT,0,2771842
ompRp1,0.125,7,7,ATGGGGTTTGTTCGGACGTA,0,2816400
ompRp1,0.125,7,7,ATGGACTTGATGAGGTAAAC,0,2766600
ompRp1,0.125,7,7,ATGATGCGAGCAACGGTTCT,0,2810853
ompRp1,0.125,7,7,ATGAACTCGGAACTGTTTTG,0,2768125
ompRp1,0.125,7,7,ATGAACAGCAAAGGAGAGGG,0,2809433
ompRp1,0.125,7,7,ATCTGGTTCCTTGCTGGTTG,0,2787331
ompRp1,0.125,7,7,ATCTGCTTGCCATTGTCTAG,0,2792716
ompRp1,0.125,7,7,ATCGGGAGACGCCCGAAGGC,0,2795255
ompRp1,0.125,7,7,ATCGGCTCGGAGTTGCACAT,0,2820445
ompRp1,0.125,7,7,ATCGGATACGTCCAAACGGA,0,2817023
ompRp1,0.125,7,7,ATCCTTGCGAACGTCCGGAT,0,2795827
ompRp1,0.125,7,7,ATCCCTTTCATTTGACACTA,0,2814034
ompRp1,0.125,7,7,ATCCCGGTTGCGGGGTACTT,0,2810728
ompRp1,0.125,7,7,ATCACTTGGTTAAGTGGGGA,0,2782544
ompRp1,0.125,7,7,ATCAATTACCGAAGAAATAC,0,2777500
ompRp1,0.125,7,7,ATATTTGGATGACTCAGTGT,0,2794771
ompRp1,0.125,7,7,ATATCGGTTTCTATTTACAG,0,2793019
ompRp1,0.125,7,7,ATATATGGCAGATGTGTCCC,0,2787685
ompRp1,0.125,7,7,ATAGTGCAGGCGCGGTTTAC,0,2802003
ompRp1,0.125,7,7,ATAGTCGATATACCTCACAC,0,2776445
ompRp1,0.125,7,7,ATAGTCCGGCGAGCGCCGAT,0,2789745
ompRp1,0.125,7,7,ATAGGGCAAGTTGTTTTTGG,0,2803607
ompRp1,0.125,7,7,ATAGCCTTACTCCTCCTTTT,0,2800795
ompRp1,0.125,7,7,ATACCAACAGATGCTGCAGA,0,2804863
ompRp1,0.125,7,7,ATACACAAGAAGGCACCACA,0,2772119
ompRp1,0.125,7,7,ATAATTCGGGCAGGGTGGGG,0,2819821
ompRp1,0.125,7,7,ATAATGCATCGAACGGTTGT,0,2799630
ompRp1,0.125,7,7,ATAAAGTTAAGATCACGTGT,0,2795715
ompRp1,0.125,7,7,AGTTGAATCGGCTGCACCCA,0,2816118
ompRp1,0.125,7,7,AGTTCAGGGTAAGCCTCGCG,0,2820602
ompRp1,0.125,7,7,AGTGCATAACGTCTTAATAG,0,2772822
ompRp1,0.125,7,7,AGTGATGCCCGGTCTTCTAT,0,2780428
ompRp1,0.125,7,7,AGTGATCTGGCCCCGCGCTT,0,2814146
ompRp1,0.125,7,7,AGTGAAACGTCCGCTTGCAA,0,2793162
ompRp1,0.125,7,7,AGTCTTGGATCGATTCCAGA,0,2774310
ompRp1,0.125,7,7,AGTCTGTCTTTCTACAAACT,0,2778224
ompRp1,0.125,7,7,AGTATTGCTCGTTGAGTCTG,0,2804940
ompRp1,0.125,7,7,AGTAGAAGGCGGCGCCTGTA,0,2814965
ompRp1,0.125,7,7,AGTAAGTAACTGAACGTCAA,0,2805913
ompRp1,0.125,7,7,AGGTGCCCGCACAGACGATG,0,2810288
ompRp1,0.125,7,7,AGGTAGTGAATAAAATCAGG,0,2798392
ompRp1,0.125,7,7,AGGTACTTAGTGCGTAGTTC,0,2785329
ompRp1,0.125,7,7,AGGGTGATCTGTGGTCTACA,0,2782697
ompRp1,0.125,7,7,AGGGTATCAAAGGTCACCGT,0,2778984
ompRp1,0.125,7,7,AGGGGACGTGGTCGCACAAA,0,2815586
ompRp1,0.125,7,7,AGGGACCCGGAACCCAACAC,0,2792257
ompRp1,0.125,7,7,AGGCCCGACAACATATGGTC,0,2775706
ompRp1,0.125,7,7,AGGCACTTCCCAATACGTGA,0,2777224
ompRp1,0.125,7,7,AGGAGATGGTTATGTGGTTC,0,2775413
ompRp1,0.125,7,7,AGCTTGAATAGGGCTGCGCC,0,2792606
ompRp1,0.125,7,7,AGCTGGTCAGAAAGGCGTCA,0,2793014
ompRp1,0.125,7,7,AGCTCCTCGCCCAGCTAGTA,0,2789374
ompRp1,0.125,7,7,AGCTAGCAATAATCGCATGC,0,2771817
ompRp1,0.125,7,7,AGCCAGGCGCACGGTGCAAT,0,2804796
ompRp1,0.125,7,7,AGCAGGTAATTGCGTGTTAG,0,2807454
ompRp1,0.125,7,7,AGCAGCCACGCACACTGCTA,0,2781999
ompRp1,0.125,7,7,AGATTTGAACCCGTGTGTTT,0,2820510
ompRp1,0.125,7,7,AGATGTACTGTAGCCTGGTA,0,2809166
ompRp1,0.125,7,7,AGAGTTGACTCGATGAGGTA,0,2801508
ompRp1,0.125,7,7,AGAGTCGGGAAGAGTTCAGA,0,2789512
ompRp1,0.125,7,7,AGACTTATTTTTTTCGGAGG,0,2803506
ompRp1,0.125,7,7,AGACTGTGGGCTCTGTTTGT,0,2778359
ompRp1,0.125,7,7,AGACGTACGCCACTCTGCTG,0,2806752
ompRp1,0.125,7,7,AGACCGGATGAGGGGCAGAT,0,2790445
ompRp1,0.125,7,7,AGACCGCCGCGGTGTTTGGA,0,2814591
ompRp1,0.125,7,7,AGACATCGGTCCGAACGGGT,0,2794322
ompRp1,0.125,7,7,AGACAATCAACCTATCAAGA,0,2813704
ompRp1,0.125,7,7,AGAAGGTAGCGTAAGCGCGT,0,2771325
ompRp1,0.125,7,7,AGAACAGGTAGTCGTATCGT,0,2783115
ompRp1,0.125,7,7,ACTTTATTGCGGAGAACTGT,0,2770004
ompRp1,0.125,7,7,ACTTGGCAGGCGTGGACCCA,0,2768879
ompRp1,0.125,7,7,ACTGTTGTAGATATCACCCT,0,2787735
ompRp1,0.125,7,7,ACTGTCGGAAGTCCGCGCAT,0,2769169
ompRp1,0.125,7,7,ACTGGTGTCGTGCTACGTTG,0,2766716
ompRp1,0.125,7,7,ACTGCGGAGGGCTAACATAC,0,2772128
ompRp1,0.125,7,7,ACTGATATCGTGGGGGGGAC,0,2811823
ompRp1,0.125,7,7,ACTAGGCCCTAATAGTAAGA,0,2791384
ompRp1,0.125,7,7,ACTACAGGGACCACCCATCG,0,2779979
ompRp1,0.125,7,7,ACGTTACGCCCAGACGCGTT,0,2785596
ompRp1,0.125,7,7,ACGTGACTGGGTGTGAGTCA,0,2805887
ompRp1,0.125,7,7,ACGTAATTTATCTACAGTGT,0,2790584
ompRp1,0.125,7,7,ACGTAACGCGACGTCGAGGT,0,2778034
ompRp1,0.125,7,7,ACGGTATGTCTGCCGTTCAT,0,2797310
ompRp1,0.125,7,7,ACGGGATTAACGGTGAATGT,0,2770753
ompRp1,0.125,7,7,ACGGATTGCTAATTCTCCAA,0,2777467
ompRp1,0.125,7,7,ACGGACTGCGGCCGCAGAAT,0,2803767
ompRp1,0.125,7,7,ACGCACGTGTGGCGAAGCCA,0,2774655
ompRp1,0.125,7,7,ACGATTATATTGTCTTCATC,0,2793899
ompRp1,0.125,7,7,ACGAGTGGAGTCACTTTTAC,0,2792451
ompRp1,0.125,7,7,ACGACCACGCAAGGTAGGAT,0,2819578
ompRp1,0.125,7,7,ACCTTTATATCCGTAGGCGA,0,2810490
ompRp1,0.125,7,7,ACCTTGAACGCACTTTGTAT,0,2773738
ompRp1,0.125,7,7,ACCTGGAGCACTCTCTGGTG,0,2766093
ompRp1,0.125,7,7,ACCTGCGGCGTTACCTCACA,0,2809761
ompRp1,0.125,7,7,ACCTATTCTGATTAGATGAT,0,2780642
ompRp1,0.125,7,7,ACCGTCCGGGTCCCTTTTCT,0,2776994
ompRp1,0.125,7,7,ACCGGCCGTGAGCCTAGAAA,0,2791637
ompRp1,0.125,7,7,ACCCGCTGTTTTACAGGCTT,0,2786417
ompRp1,0.125,7,7,ACCATAAGCTATATCCTGCT,0,2780024
ompRp1,0.125,7,7,ACCAGGAGAAAGCCGTTTGT,0,2808372
ompRp1,0.125,7,7,ACCACTCTGGGTTGTCTTTG,0,2810850
ompRp1,0.125,7,7,ACATTGATGAAGCTCACTTA,0,2782402
ompRp1,0.125,7,7,ACATTAGCCAGCATACTCCA,0,2785786
ompRp1,0.125,7,7,ACATGCGAGAATGACCCTGA,0,2808531
ompRp1,0.125,7,7,ACATAGTTAGATCACGATGT,0,2806471
ompRp1,0.125,7,7,ACAGTCCTTGGGGGAAAACG,0,2780647
ompRp1,0.125,7,7,ACAGTAGTAAGTGTATTGGA,0,2777406
ompRp1,0.125,7,7,ACAGGGGTCCTTACGTTGAC,0,2786274
ompRp1,0.125,7,7,ACAGCAGAGACTTCCTGGGA,0,2805560
ompRp1,0.125,7,7,ACACAATTTAGTAACAGATC,0,2824722
ompRp1,0.125,7,7,ACAAGTACTTCCATTTAACC,0,2770185
ompRp1,0.125,7,7,ACAAGGTCAATAGTGGCTGG,0,2788469
ompRp1,0.125,7,7,AATTTAGTAATAGATAATGT,0,2821263
ompRp1,0.125,7,7,AATTGGCATGGGAGAGAGTT,0,2777324
ompRp1,0.125,7,7,AATTCTCGTCCACGGGCGGA,0,2770216
ompRp1,0.125,7,7,AATTAGCAAATATGTTTGGT,0,2810133
ompRp1,0.125,7,7,AATGGGGTTTTTTCCAGTTT,0,2819259
ompRp1,0.125,7,7,AATGCGTAACCTGAAGCGCA,0,2821975
ompRp1,0.125,7,7,AATGCAGTCGTCAAATGGAC,0,2824567
ompRp1,0.125,7,7,AATCGTGTCCGCAGCCGATC,0,2792284
ompRp1,0.125,7,7,AATAGTTGCTTGAACGCATA,0,2798224
ompRp1,0.125,7,7,AATAGTCAAGACAAAAGCGG,0,2804637
ompRp1,0.125,7,7,AAGTGGAATTGCGTCCTGTC,0,2796539
ompRp1,0.125,7,7,AAGTATGGGTTTAACTGAAT,0,2807493
ompRp1,0.125,7,7,AAGGTTTACTTAAAGAGTAT,0,2784565
ompRp1,0.125,7,7,AAGGTGGCACGGCTAGGCAT,0,2786869
ompRp1,0.125,7,7,AAGGGAATCGACAGGTCCTC,0,2789536
ompRp1,0.125,7,7,AAGGCACGGGCGATCCAAAC,0,2801086
ompRp1,0.125,7,7,AAGGATGATGGGGTGAAAGT,0,2806383
ompRp1,0.125,7,7,AAGGAATTATCCGAAGCTAA,0,2792681
ompRp1,0.125,7,7,AAGCTGCGAAAGGCCTCTCG,0,2802618
ompRp1,0.125,7,7,AAGCCGGAACAAGTCCAATG,0,2796489
ompRp1,0.125,7,7,AAGCAGGACAGCACCGGTGC,0,2767211
ompRp1,0.125,7,7,AAGCACCTCACGGCTTGCCC,0,2787547
ompRp1,0.125,7,7,AAGATACACACAGGCGTGCA,0,2803650
ompRp1,0.125,7,7,AAGACGGTATTTCGTTGGAT,0,2771446
ompRp1,0.125,7,7,AACTTGTCTTCGCACTTGAA,0,2806395
ompRp1,0.125,7,7,AACTGGTGCACGCTTGAAGA,0,2809398
ompRp1,0.125,7,7,AACGTGCTCGTAGAGGCACA,0,2819034
ompRp1,0.125,7,7,AACGTCAGGGATCGCAGGGA,0,2824491
ompRp1,0.125,7,7,AACGGTGCGACCTACTCAGA,0,2767781
ompRp1,0.125,7,7,AACCTAATCTCAAATCCTTT,0,2816769
ompRp1,0.125,7,7,AACCAGGGGCGAGGTCAATC,0,2774994
ompRp1,0.125,7,7,AACATCGTCCCTGTTCGACC,0,2796793
ompRp1,0.125,7,7,AACAGCTTAACAGCCGCGGC,0,2779399
ompRp1,0.125,7,7,AACAGCGTGAGGCAATCAGA,0,2822296
ompRp1,0.125,7,7,AAATTAAGTGGGCACGACAC,0,2774812
ompRp1,0.125,7,7,AAAGGTCGTCTGCGAAATCT,0,2806094
ompRp1,0.125,7,7,AAACTCCACCCAGGGCGCGA,0,2819576
ompRp1,0.125,7,7,AAACCCTGCAGCGCCTGGGC,0,2786669
ompRp1,0.125,7,7,AAACACCATTAAGGGTGAAT,0,2803185
ompRp1,0.125,7,7,AAAATGCATTCAGAGTTAAC,0,2801002
ompRp1,0.125,7,7,AAAAGAATAGAATTATGGCC,0,2766987
ompRp1,0.125,7,7,AAAAATGAGTCTACAACCTT,0,2788317
ompRp1,0.125,7,7,AAAAACAGCTTGCCCAAGGC,0,2790422
ompRp1,0.14285714285714285,6,6,TTTTTTGTGAGGTATCTTTC,0,2802381
ompRp1,0.14285714285714285,6,6,TTTTCTAACGAACGGGATGG,0,2767034
ompRp1,0.14285714285714285,6,6,TTTTCGTTCCGTTGCCGCCA,0,2780390
ompRp1,0.14285714285714285,6,6,TTTTCCGCTATTCTAAAGCC,0,2777266
ompRp1,0.14285714285714285,6,6,TTTGTCCGATTCACTTTCAG,0,2777590
ompRp1,0.14285714285714285,6,6,TTTGGTCTCTGCAATTGGCA,0,2785594
ompRp1,0.14285714285714285,6,6,TTTGGATGCAATTACGATCT,0,2769512
ompRp1,0.14285714285714285,6,6,TTTGCATATGACTCAGGCTT,0,2787264
ompRp1,0.14285714285714285,6,6,TTTCTTTCCACTTTCCCTGT,0,2774579
ompRp1,0.14285714285714285,6,6,TTTCTTACTGCCAAGTGTTC,0,2785515
ompRp1,0.14285714285714285,6,6,TTTAGGAATCTGCTGCCCAG,0,2797556
ompRp1,0.14285714285714285,6,6,TTTAGACTGCCCTAAGGTGG,0,2816044
ompRp1,0.14285714285714285,6,6,TTTAACCGAGTAGGGGGCAT,0,2768660
ompRp1,0.14285714285714285,6,6,TTGTTAGCAATTATATACAG,0,2800334
ompRp1,0.14285714285714285,6,6,TTGTATACTCAGCAAATAGT,0,2804290
ompRp1,0.14285714285714285,6,6,TTGGGAGGGGTAGCTAAGGT,0,2804826
ompRp1,0.14285714285714285,6,6,TTGGCCGTAGCGACGGGTGG,0,2810626
ompRp1,0.14285714285714285,6,6,TTGGAGATTAACCTCTTCAC,0,2822474
ompRp1,0.14285714285714285,6,6,TTGCTTGACGTGTTTGTAAC,0,2772807
ompRp1,0.14285714285714285,6,6,TTGCTGGGGGGTTGCTGACT,0,2773574
ompRp1,0.14285714285714285,6,6,TTGCGCAGGTCATAGGCTCT,0,2779289
ompRp1,0.14285714285714285,6,6,TTGCGAAGGGCAACCACGGA,0,2772805
ompRp1,0.14285714285714285,6,6,TTGCCACCTTCGACGCAGGT,0,2798092
ompRp1,0.14285714285714285,6,6,TTGCACACAGACTAGGTCAG,0,2772224
ompRp1,0.14285714285714285,6,6,TTGATTCAGGCCCACCCTGA,0,2765898
ompRp1,0.14285714285714285,6,6,TTGATGGGTTTGCAACCCGC,0,2824606
ompRp1,0.14285714285714285,6,6,TTGATCGATAAGATTAGTGC,0,2768667
ompRp1,0.14285714285714285,6,6,TTGATCAGGAGCCCAGTATG,0,2784372
ompRp1,0.14285714285714285,6,6,TTGACACCCCGTGCAAACTC,0,2785084
ompRp1,0.14285714285714285,6,6,TTCTTTGTAATTCCTTTTTG,0,2775734
ompRp1,0.14285714285714285,6,6,TTCTAGATATGCAGCAGTCA,0,2781628
ompRp1,0.14285714285714285,6,6,TTCTACGCGTCGTAAGCGAG,0,2780283
ompRp1,0.14285714285714285,6,6,TTCGGTCGGAGGCCGGAACA,0,2787734
ompRp1,0.14285714285714285,6,6,TTCGATCAAGGGACCGAAAA,0,2786403
ompRp1,0.14285714285714285,6,6,TTCCTCTTTTTTCGGGCGAT,0,2813441
ompRp1,0.14285714285714285,6,6,TTCCTACTTACGCGCCGGCC,0,2787227
ompRp1,0.14285714285714285,6,6,TTCCGGACACCGCCGAGGCC,0,2808120
ompRp1,0.14285714285714285,6,6,TTCCCTGACTAAGAAAACGT,0,2804646
ompRp1,0.14285714285714285,6,6,TTCCCGTTCGAGGGTCTTGT,0,2793972
ompRp1,0.14285714285714285,6,6,TTCCCGTGTTCCCCCAGCAG,0,2815262
ompRp1,0.14285714285714285,6,6,TTCCATGTGGACCAAAGGAA,0,2767162
ompRp1,0.14285714285714285,6,6,TTCCACACATGGACATTGGA,0,2769525
ompRp1,0.14285714285714285,6,6,TTCATGCTCCTAATCGCTAG,0,2817836
ompRp1,0.14285714285714285,6,6,TTCATCTATGCTTGACTTTT,0,2799500
ompRp1,0.14285714285714285,6,6,TTCAGGCGCGGGCTTTAGAC,0,2781354
ompRp1,0.14285714285714285,6,6,TTCAATCTACGGGTCTGAAG,0,2780116
ompRp1,0.14285714285714285,6,6,TTATTTTGTGTCCGAAGCTA,0,2803553
ompRp1,0.14285714285714285,6,6,TTATTTGGTCTTGAAAAAAG,0,2805726
ompRp1,0.14285714285714285,6,6,TTATCACCCTGTGGGACCAG,0,2797272
ompRp1,0.14285714285714285,6,6,TTATAGGTTATACGTATTCA,0,2767163
ompRp1,0.14285714285714285,6,6,TTATACTAGGTGTATGGAAT,0,2809539
ompRp1,0.14285714285714285,6,6,TTATACGCGATGTGGAAGAA,0,2771768
ompRp1,0.14285714285714285,6,6,TTAGTAGTTGGAAAGTTCAG,0,2803800
ompRp1,0.14285714285714285,6,6,TTAGCCTAATTCCGTCATTG,0,2812218
ompRp1,0.14285714285714285,6,6,TTAGACTCACCTAAGATGAA,0,2787511
ompRp1,0.14285714285714285,6,6,TTACTTAGCATAGCCATCGC,0,2775486
ompRp1,0.14285714285714285,6,6,TTACGGCTCCCAGATCGAAT,0,2780184
ompRp1,0.14285714285714285,6,6,TTACAGAATCTGGTCGCACG,0,2811697
ompRp1,0.14285714285714285,6,6,TTACACTTGGGTAATGTTTT,0,2778559
ompRp1,0.14285714285714285,6,6,TTACACTGACATTAACAATT,0,2782112
ompRp1,0.14285714285714285,6,6,TTAATAGATCTCCGACACGC,0,2798932
ompRp1,0.14285714285714285,6,6,TGTTGGACGGTCTGAAGGTA,0,2786934
ompRp1,0.14285714285714285,6,6,TGTTGCGATGTCTGCAACGG,0,2768871
ompRp1,0.14285714285714285,6,6,TGTTGAAAGTACATGGCTCA,0,2820792
ompRp1,0.14285714285714285,6,6,TGTTAGTGAGCATGTAGGCA,0,2782393
ompRp1,0.14285714285714285,6,6,TGTGCGAATCTTCAGTTGGA,0,2802167
ompRp1,0.14285714285714285,6,6,TGTGCCTAGATTACCTGAGT,0,2818440
ompRp1,0.14285714285714285,6,6,TGTCTTCTCTATACAGCTAA,0,2795596
ompRp1,0.14285714285714285,6,6,TGTCTTCACCTACTACTGTC,0,2797151
ompRp1,0.14285714285714285,6,6,TGTCTGCCAGACAAAGTACA,0,2798004
ompRp1,0.14285714285714285,6,6,TGTATTCACTACGCACTCGT,0,2785415
ompRp1,0.14285714285714285,6,6,TGTATAGTTGTGGCATCCGG,0,2805497
ompRp1,0.14285714285714285,6,6,TGTAGTGGAAATTAGGGGAC,0,2794015
ompRp1,0.14285714285714285,6,6,TGTAGGTTTGGGGCGTCTTG,0,2786586
ompRp1,0.14285714285714285,6,6,TGTAATCGCATGAATCGGCT,0,2798495
ompRp1,0.14285714285714285,6,6,TGTAACAGTCTAGTCAGCCC,0,2818139
ompRp1,0.14285714285714285,6,6,TGGTTAGCAATCTGGCTGCC,0,2774411
ompRp1,0.14285714285714285,6,6,TGGTTAAGCATTTACACACC,0,2792365
ompRp1,0.14285714285714285,6,6,TGGTGGACACAAAGTACACC,0,2769385
ompRp1,0.14285714285714285,6,6,TGGTCGTCGGGATGTCGGAC,0,2809942
ompRp1,0.14285714285714285,6,6,TGGTATCTAAGGGTAGCCGT,0,2805829
ompRp1,0.14285714285714285,6,6,TGGGTTATCTTTGGAAATAG,0,2785978
ompRp1,0.14285714285714285,6,6,TGGCATGGGGCCAGATTAGT,0,2770376
ompRp1,0.14285714285714285,6,6,TGGCAGGTGATTATGCAGTG,0,2765388
ompRp1,0.14285714285714285,6,6,TGGATCAACTCCGTCATATC,0,2799978
ompRp1,0.14285714285714285,6,6,TGGAGTACGGTTTGGAACGG,0,2799586
ompRp1,0.14285714285714285,6,6,TGGAGAATGTTATGATGTGA,0,2821039
ompRp1,0.14285714285714285,6,6,TGGACTCAACGCGCTTCTAC,0,2795718
ompRp1,0.14285714285714285,6,6,TGCTCAGGAAAATCCTGTTA,0,2793217
ompRp1,0.14285714285714285,6,6,TGCGCTGGCAATGTCCGTCA,0,2776122
ompRp1,0.14285714285714285,6,6,TGCGCTCCATCATCTGCTTC,0,2768444
ompRp1,0.14285714285714285,6,6,TGCGCGCATGCGTTACATAT,0,2811655
ompRp1,0.14285714285714285,6,6,TGCGAGTAAAATTCTCGGAA,0,2771362
ompRp1,0.14285714285714285,6,6,TGCGACGTAAGAGGCTCGTA,0,2797037
ompRp1,0.14285714285714285,6,6,TGCGACGGGACCATGTAACC,0,2811648
ompRp1,0.14285714285714285,6,6,TGCCTGGCATCCGGGCCGAG,0,2823314
ompRp1,0.14285714285714285,6,6,TGCCGTGAAGTAGTGACGAA,0,2771302
ompRp1,0.14285714285714285,6,6,TGCCCCGTTAAGTCTTGGAG,0,2774527
ompRp1,0.14285714285714285,6,6,TGCCCATGTCATTATTCACG,0,2774896
ompRp1,0.14285714285714285,6,6,TGCATACATCACCGAGTCTT,0,2788613
ompRp1,0.14285714285714285,6,6,TGCACGGATGACTACAGCTG,0,2776892
ompRp1,0.14285714285714285,6,6,TGCACAGGGATTACCAGCTT,0,2790681
ompRp1,0.14285714285714285,6,6,TGCAATTCTTGATTTACGTT,0,2806442
ompRp1,0.14285714285714285,6,6,TGCAACATGACACGATCATT,0,2817922
ompRp1,0.14285714285714285,6,6,TGATTCTAATTTATATTTAG,0,2793778
ompRp1,0.14285714285714285,6,6,TGATGTCCGGTGTGGTCGCT,0,2799741
ompRp1,0.14285714285714285,6,6,TGAGTTTTGAGGGCGCTTAA,0,2815460
ompRp1,0.14285714285714285,6,6,TGAGTGCTGGGGCGGGACCT,0,2799746
ompRp1,0.14285714285714285,6,6,TGAGCATTAAAAGGAGTAGC,0,2776993
ompRp1,0.14285714285714285,6,6,TGAGATCGAGGGAGGGGGAT,0,2807466
ompRp1,0.14285714285714285,6,6,TGACTCTGTTATACAGCTTT,0,2789633
ompRp1,0.14285714285714285,6,6,TGACCGGTCTGCAATAGCGG,0,2769167
ompRp1,0.14285714285714285,6,6,TGAATCTTGGAATGCGCGAC,0,2771378
ompRp1,0.14285714285714285,6,6,TGAAATGTATACGACAAAAC,0,2813465
ompRp1,0.14285714285714285,6,6,TCTTTCCCAGATGAGTCCAT,0,2805607
ompRp1,0.14285714285714285,6,6,TCTTCTTTCTCGCACATGGG,0,2820558
ompRp1,0.14285714285714285,6,6,TCTTCCCTATTACTAACTTA,0,2776387
ompRp1,0.14285714285714285,6,6,TCTTAAATTTCTATTTATCT,0,2795794
ompRp1,0.14285714285714285,6,6,TCTGCGAAAGGGTAGGCCCC,0,2773050
ompRp1,0.14285714285714285,6,6,TCTGAGTGATCATGGGCTTT,0,2795836
ompRp1,0.14285714285714285,6,6,TCTCATTATCAACTAATGGT,0,2815260
ompRp1,0.14285714285714285,6,6,TCTCAATGATGGGATTGAAA,0,2809700
ompRp1,0.14285714285714285,6,6,TCTATTATAATAATGATGTA,0,2795864
ompRp1,0.14285714285714285,6,6,TCTATCCTAACTCCCAGTAG,0,2817441
ompRp1,0.14285714285714285,6,6,TCTAGGTTCGGGTACTCATG,0,2781625
ompRp1,0.14285714285714285,6,6,TCGTTGTTAGTCTGTTCCAA,0,2766452
ompRp1,0.14285714285714285,6,6,TCGTTGAACCAGAGCCTATA,0,2801891
ompRp1,0.14285714285714285,6,6,TCGTTATCCTTTTCAGCAGG,0,2786818
ompRp1,0.14285714285714285,6,6,TCGTGTCATTCGGGGTGGAT,0,2817124
ompRp1,0.14285714285714285,6,6,TCGTCTGAGAGCAATAGGTA,0,2786246
ompRp1,0.14285714285714285,6,6,TCGTACTGATTGTCGGAGGT,0,2802076
ompRp1,0.14285714285714285,6,6,TCGGGTTTGGTGCACTCCGT,0,2774033
ompRp1,0.14285714285714285,6,6,TCGGGCTCCATCATCAAATG,0,2817338
ompRp1,0.14285714285714285,6,6,TCGGCTGCTATTACCGCGTT,0,2814986
ompRp1,0.14285714285714285,6,6,TCGGCCGCAAGACACTTGGT,0,2806031
ompRp1,0.14285714285714285,6,6,TCGGATGTGGGATTGCACAT,0,2812884
ompRp1,0.14285714285714285,6,6,TCGGAGCGGCACGAATAGGT,0,2803052
ompRp1,0.14285714285714285,6,6,TCGCGCAATCCAGGTGAAAA,0,2799807
ompRp1,0.14285714285714285,6,6,TCGCATAACAGTTCCGTCAG,0,2809032
ompRp1,0.14285714285714285,6,6,TCGCAGGGCATCCAGCAACT,0,2813638
ompRp1,0.14285714285714285,6,6,TCGCAGGAGTCTTATCTCAT,0,2793353
ompRp1,0.14285714285714285,6,6,TCGATAATACTACTTTATAC,0,2813676
ompRp1,0.14285714285714285,6,6,TCGAGTAAAAACGAGAGCGA,0,2790826
ompRp1,0.14285714285714285,6,6,TCGAGCTACGGTGTGTGTTA,0,2796469
ompRp1,0.14285714285714285,6,6,TCCTGTTGCGCAGGAGTAGG,0,2772395
ompRp1,0.14285714285714285,6,6,TCCTCAAAGATGACAGTTCT,0,2783959
ompRp1,0.14285714285714285,6,6,TCCGTGGGGCCTAACGAGGT,0,2767834
ompRp1,0.14285714285714285,6,6,TCCGTGAGTCCGGAACATTC,0,2798635
ompRp1,0.14285714285714285,6,6,TCCGCGTGGATAGAATCGGC,0,2791710
ompRp1,0.14285714285714285,6,6,TCCGCCTAAGACACCTGTAT,0,2784883
ompRp1,0.14285714285714285,6,6,TCCGATTTGTGGGCTAGCAA,0,2790134
ompRp1,0.14285714285714285,6,6,TCCGAAGATGGTGCGTAAAC,0,2805856
ompRp1,0.14285714285714285,6,6,TCCCGCGTCTCCTATTCGAA,0,2795242
ompRp1,0.14285714285714285,6,6,TCCCGCGAAGTCTCTACTTC,0,2790865
ompRp1,0.14285714285714285,6,6,TCCCACGGGTCTGACTCAGT,0,2779382
ompRp1,0.14285714285714285,6,6,TCCATGTCTAAGGAGTCAGG,0,2822677
ompRp1,0.14285714285714285,6,6,TCCAGTAATGTGTGCTCGTG,0,2818895
ompRp1,0.14285714285714285,6,6,TCCAGACCGAACTTGCGAAT,0,2797480
ompRp1,0.14285714285714285,6,6,TCATCGCCCAGGAGGAAGGG,0,2778710
ompRp1,0.14285714285714285,6,6,TCATAGATAACCATATTCGA,0,2809525
ompRp1,0.14285714285714285,6,6,TCAGGGCGCCTGTTGTACTT,0,2799155
ompRp1,0.14285714285714285,6,6,TCACGTGTGCCCGCAGGTTC,0,2773175
ompRp1,0.14285714285714285,6,6,TCACCTCTGTAGGTAGGCCA,0,2795572
ompRp1,0.14285714285714285,6,6,TCACCGGGTTTAATAAGGAA,0,2813148
ompRp1,0.14285714285714285,6,6,TCACACCGATGGTCAGGCTA,0,2779074
ompRp1,0.14285714285714285,6,6,TCAAGAATCGGTAGTATTAG,0,2810296
ompRp1,0.14285714285714285,6,6,TCAACTCACGTGTCCCTCAG,0,2782406
ompRp1,0.14285714285714285,6,6,TATTTGAACGGCTACGCGGA,0,2812114
ompRp1,0.14285714285714285,6,6,TATTGTTCTCCGGCTGGGAT,0,2781358
ompRp1,0.14285714285714285,6,6,TATTGAAGAGGGGCTAAGCT,0,2821547
ompRp1,0.14285714285714285,6,6,TATTCTGCGTCTCGAAGGTG,0,2803554
ompRp1,0.14285714285714285,6,6,TATTAGGAACGATGACTCAT,0,2818337
ompRp1,0.14285714285714285,6,6,TATTAGCGTTTCATCACACG,0,2777369
ompRp1,0.14285714285714285,6,6,TATGTTAAACGGTCTCATGA,0,2801227
ompRp1,0.14285714285714285,6,6,TATGTGAAACAATACGCAAA,0,2771767
ompRp1,0.14285714285714285,6,6,TATGTCGGTGTCGTGCTCAG,0,2812468
ompRp1,0.14285714285714285,6,6,TATGTCATCGCGCGTCTCGT,0,2819296
ompRp1,0.14285714285714285,6,6,TATGTATAGACTATACAAAA,0,2816636
ompRp1,0.14285714285714285,6,6,TATGCTTGGTATCGAGGGTG,0,2800828
ompRp1,0.14285714285714285,6,6,TATGCGTCGCACTTACACAA,0,2807718
ompRp1,0.14285714285714285,6,6,TATGATAGTCTACTCTAAAT,0,2821532
ompRp1,0.14285714285714285,6,6,TATCTTGTGTATTATATTGG,0,2784448
ompRp1,0.14285714285714285,6,6,TATCTTAAAGTCATCAGACG,0,2796926
ompRp1,0.14285714285714285,6,6,TATCGTACGCACGGATTAAT,0,2811104
ompRp1,0.14285714285714285,6,6,TATCCGCCTTCTAGATTTCC,0,2824534
ompRp1,0.14285714285714285,6,6,TATACTGACCACCGGAAGAA,0,2777012
ompRp1,0.14285714285714285,6,6,TATACGCAAGACTTGCGCAA,0,2791552
ompRp1,0.14285714285714285,6,6,TATACCGCAGGTGCATTGAC,0,2810187
ompRp1,0.14285714285714285,6,6,TAGTGCCCTCGATGTTGGAG,0,2778364
ompRp1,0.14285714285714285,6,6,TAGGTGCGATTTCCCATAAA,0,2775465
ompRp1,0.14285714285714285,6,6,TAGGTAAGTGTAGGCCCATA,0,2782842
ompRp1,0.14285714285714285,6,6,TAGGGTTTTCTAGCGCGCTC,0,2773617
ompRp1,0.14285714285714285,6,6,TAGGCGGCAGACATGAAGAA,0,2780770
ompRp1,0.14285714285714285,6,6,TAGGCATTCAGTCCGTAAAC,0,2791487
ompRp1,0.14285714285714285,6,6,TAGGCAGCGCCTTGCTTATA,0,2813377
ompRp1,0.14285714285714285,6,6,TAGGAAACGCAAACCCTTCC,0,2785683
ompRp1,0.14285714285714285,6,6,TAGGAAACGAAACCTATTGC,0,2807263
ompRp1,0.14285714285714285,6,6,TAGAATTTGCTTCCAGGAGC,0,2783899
ompRp1,0.14285714285714285,6,6,TACTGTTGGGATTCTTAAGT,0,2777048
ompRp1,0.14285714285714285,6,6,TACTCACGACACCGATTGCT,0,2782742
ompRp1,0.14285714285714285,6,6,TACGGGCGGCAGTCTCAATG,0,2796399
ompRp1,0.14285714285714285,6,6,TACGACAGGCGCCAGTCCCC,0,2788356
ompRp1,0.14285714285714285,6,6,TACGAATCTGGAGCTTGGAT,0,2777320
ompRp1,0.14285714285714285,6,6,TACCTATGTTAGGGCTTTTG,0,2807407
ompRp1,0.14285714285714285,6,6,TACCCAACTCCGCAGATATA,0,2798452
ompRp1,0.14285714285714285,6,6,TACCAGTACATAATGGAGAA,0,2808196
ompRp1,0.14285714285714285,6,6,TACACGTGGATTGCAATATG,0,2797615
ompRp1,0.14285714285714285,6,6,TACACCTTTGTATACAGGTT,0,2797763
ompRp1,0.14285714285714285,6,6,TACAATGTGTGGACTCATTG,0,2782459
ompRp1,0.14285714285714285,6,6,TACAAAAGCCTAGAGAGTGA,0,2772899
ompRp1,0.14285714285714285,6,6,TAATCTTTCCTGGTGGGGTT,0,2820036
ompRp1,0.14285714285714285,6,6,TAATCTCCGCCGGACTAATG,0,2783956
ompRp1,0.14285714285714285,6,6,TAATCGGCTGTACGGTTGAG,0,2797810
ompRp1,0.14285714285714285,6,6,TAAGTATCCCGCGTTTCCTG,0,2787144
ompRp1,0.14285714285714285,6,6,TAAGGCGTGATTCAGGCAAT,0,2770947
ompRp1,0.14285714285714285,6,6,TAAGCCCAGGGTGCCTATCA,0,2818119
ompRp1,0.14285714285714285,6,6,TAACTTTAGGGAGGAGTTTA,0,2790067
ompRp1,0.14285714285714285,6,6,TAACGTACATCGAACAAGTA,0,2812528
ompRp1,0.14285714285714285,6,6,TAACCAAGCTGTCCTCGTAA,0,2819410
ompRp1,0.14285714285714285,6,6,TAAATACGGCATGCCTATTA,0,2790660
ompRp1,0.14285714285714285,6,6,GTTTTCTATGTAAGCCTCTG,0,2790243
ompRp1,0.14285714285714285,6,6,GTTTGATGTTAATCTCTCAT,0,2813877
ompRp1,0.14285714285714285,6,6,GTTTCTGCACCTTGGAGCTC,0,2809986
ompRp1,0.14285714285714285,6,6,GTTTCCCTAACATTCCAGGT,0,2789164
ompRp1,0.14285714285714285,6,6,GTTTCCATAGCCTGCGGCCT,0,2812079
ompRp1,0.14285714285714285,6,6,GTTTAGAATTTGTCAGGTTG,0,2821098
ompRp1,0.14285714285714285,6,6,GTTTACAGTCACATAAAAGA,0,2798263
ompRp1,0.14285714285714285,6,6,GTTGTCATATTTAACCAGCG,0,2820184
ompRp1,0.14285714285714285,6,6,GTTGGAGGAAACATAACGTT,0,2815080
ompRp1,0.14285714285714285,6,6,GTTGCCCGCTCTATGGCAAG,0,2799460
ompRp1,0.14285714285714285,6,6,GTTCGGACACTAAATGAATG,0,2804958
ompRp1,0.14285714285714285,6,6,GTTCGCCTCCCCGGGGATAC,0,2773826
ompRp1,0.14285714285714285,6,6,GTTCCTGTTAAACCCCAGGC,0,2768168
ompRp1,0.14285714285714285,6,6,GTTATTGACACACCCGAAAA,0,2772604
ompRp1,0.14285714285714285,6,6,GTTAGGGAGATCCCTGGGCT,0,2803811
ompRp1,0.14285714285714285,6,6,GTTACCGCTTTAGCAACAGC,0,2783817
ompRp1,0.14285714285714285,6,6,GTTAATGGATTGTTGTTGTA,0,2789105
ompRp1,0.14285714285714285,6,6,GTTAAGAGTACGGCTCCGTG,0,2803186
ompRp1,0.14285714285714285,6,6,GTTAAGAATGCATTTTGCGT,0,2771219
ompRp1,0.14285714285714285,6,6,GTGTTACTCCAAGCCTAAGG,0,2765343
ompRp1,0.14285714285714285,6,6,GTGTGCCCAGGAAGTTCGCA,0,2801136
ompRp1,0.14285714285714285,6,6,GTGTCCACGGCAGAGCCGGT,0,2775645
ompRp1,0.14285714285714285,6,6,GTGGTTGGTGCGTCTTCTTA,0,2790389
ompRp1,0.14285714285714285,6,6,GTGGCGTAGCCCAAGCTAAT,0,2798992
ompRp1,0.14285714285714285,6,6,GTGGAGGTGGTTCTTTGCAG,0,2787239
ompRp1,0.14285714285714285,6,6,GTGCCCCGCGGCGTTTCACG,0,2819076
ompRp1,0.14285714285714285,6,6,GTGCCAGGCTCAAGTAGAGC,0,2798311
ompRp1,0.14285714285714285,6,6,GTGAGACGTTCCTAAGTATT,0,2786716
ompRp1,0.14285714285714285,6,6,GTGAAGATTCTCTGGCGGTG,0,2769743
ompRp1,0.14285714285714285,6,6,GTCTTGCGACATAAGGGTAT,0,2803750
ompRp1,0.14285714285714285,6,6,GTCTTAACGCGGCGTTCTCA,0,2779777
ompRp1,0.14285714285714285,6,6,GTCTGCTTAATGGCTCGCGA,0,2779813
ompRp1,0.14285714285714285,6,6,GTCGGGCTTTGGCCCTGGAA,0,2777649
ompRp1,0.14285714285714285,6,6,GTCCTTCCGGGCTGTCCTAC,0,2814661
ompRp1,0.14285714285714285,6,6,GTCCTGGGGTTTTATACATT,0,2767001
ompRp1,0.14285714285714285,6,6,GTCCGTTGTCTCGGTCCGCG,0,2784723
ompRp1,0.14285714285714285,6,6,GTCCGAACTTCGATCTAGAC,0,2801963
ompRp1,0.14285714285714285,6,6,GTCCCACACGTACACAACGG,0,2819782
ompRp1,0.14285714285714285,6,6,GTCAGGTGAAGTCGGGGCCT,0,2778301
ompRp1,0.14285714285714285,6,6,GTCAACTGTTCACACTAAGA,0,2798583
ompRp1,0.14285714285714285,6,6,GTATTCGGGTGAGGAGGCAA,0,2772545
ompRp1,0.14285714285714285,6,6,GTATTAGTCCTTCACGCTGT,0,2802346
ompRp1,0.14285714285714285,6,6,GTATACACGGCCAGACCTGA,0,2793267
ompRp1,0.14285714285714285,6,6,GTAGTACCGCACTGTTAGGT,0,2820957
ompRp1,0.14285714285714285,6,6,GTAGGGCACTCCAGGATTAT,0,2795480
ompRp1,0.14285714285714285,6,6,GTAGCCCGTTCGCCGTTTGG,0,2800143
ompRp1,0.14285714285714285,6,6,GTAGCACCGGATCAAGGAAT,0,2766658
ompRp1,0.14285714285714285,6,6,GTACTACACACGCGCCGATT,0,2807073
ompRp1,0.14285714285714285,6,6,GTACAGGAGCCCCGTCATTA,0,2817250
ompRp1,0.14285714285714285,6,6,GTAAATCGACGATTCCCGCA,0,2768353
ompRp1,0.14285714285714285,6,6,GGTTTCTCCGAGCGTCGTAG,0,2806302
ompRp1,0.14285714285714285,6,6,GGTTTCATAGCCCCCGTACT,0,2791238
ompRp1,0.14285714285714285,6,6,GGTTTCAAAACTGGGACGTC,0,2791439
ompRp1,0.14285714285714285,6,6,GGTTGTGTTACATTTCTGTG,0,2778260
ompRp1,0.14285714285714285,6,6,GGTTGGCAGGCAGCGAGGAT,0,2772642
ompRp1,0.14285714285714285,6,6,GGTTCAGGTGCAGGGTGGGT,0,2817287
ompRp1,0.14285714285714285,6,6,GGTTAACAAGAAGCAGAGTC,0,2787539
ompRp1,0.14285714285714285,6,6,GGTGTAGCGGCTGGCTCAGC,0,2801542
ompRp1,0.14285714285714285,6,6,GGTGGTAAACCATAAACTAA,0,2791643
ompRp1,0.14285714285714285,6,6,GGTCTTAACTGGGCGCGCCA,0,2820051
ompRp1,0.14285714285714285,6,6,GGTCTAGCTCTACTTAGGTA,0,2822779
ompRp1,0.14285714285714285,6,6,GGTCTAATGCAACGGTGCGA,0,2817240
ompRp1,0.14285714285714285,6,6,GGTCCAGGTAAGAATTAAGA,0,2771214
ompRp1,0.14285714285714285,6,6,GGTCCACCTTTTGACGAATA,0,2789206
ompRp1,0.14285714285714285,6,6,GGTCATCTGTAGGTATGCCC,0,2802876
ompRp1,0.14285714285714285,6,6,GGTCAGCTTAGGGGATACTC,0,2804296
ompRp1,0.14285714285714285,6,6,GGTCAATATTTCGTGGGGAC,0,2770381
ompRp1,0.14285714285714285,6,6,GGTAGCGAAAGAGTGAGAGC,0,2805852
ompRp1,0.14285714285714285,6,6,GGGTTTACGCGGGAGGTTAA,0,2805329
ompRp1,0.14285714285714285,6,6,GGGTTGTCGCACGTGCCGGT,0,2787126
ompRp1,0.14285714285714285,6,6,GGGTTCTCGAACCCGGTCTT,0,2774139
ompRp1,0.14285714285714285,6,6,GGGTGGCCTGAGGTTGCGAC,0,2777421
ompRp1,0.14285714285714285,6,6,GGGTGCCGATTGGACTGTAT,0,2809246
ompRp1,0.14285714285714285,6,6,GGGTGAAACCGGAGTTAATG,0,2783099
ompRp1,0.14285714285714285,6,6,GGGTACAAAATGTAAGAGTT,0,2817743
ompRp1,0.14285714285714285,6,6,GGGGTGCTTCTCAGAGGGAC,0,2786868
ompRp1,0.14285714285714285,6,6,GGGGGCTCAGTGTCGAAGTC,0,2773812
ompRp1,0.14285714285714285,6,6,GGGGGCAAAGGGCCGGAGAT,0,2813542
ompRp1,0.14285714285714285,6,6,GGGGAACGGATACTCCGAGC,0,2799534
ompRp1,0.14285714285714285,6,6,GGGCCAGTAGTCAAGTTCTC,0,2807297
ompRp1,0.14285714285714285,6,6,GGGCATGTGTGGTGGGGGCG,0,2765731
ompRp1,0.14285714285714285,6,6,GGGCACATTTGTTGCGCGCT,0,2801263
ompRp1,0.14285714285714285,6,6,GGGAGGGTAACACACTATCA,0,2768046
ompRp1,0.14285714285714285,6,6,GGGAGCATCTCTACATGGCA,0,2794394
ompRp1,0.14285714285714285,6,6,GGCTTCGAATTTTCAGAGAG,0,2801211
ompRp1,0.14285714285714285,6,6,GGCTGTGATAGAGCACAGAC,0,2769491
ompRp1,0.14285714285714285,6,6,GGCTCTTTAGACTGTCTCAT,0,2803308
ompRp1,0.14285714285714285,6,6,GGCTCCTATTAGCACGTGTG,0,2806447
ompRp1,0.14285714285714285,6,6,GGCGTTGATTGGGATCGGGA,0,2787689
ompRp1,0.14285714285714285,6,6,GGCGGCGGCGTTGAGTTTAG,0,2778852
ompRp1,0.14285714285714285,6,6,GGCGACTACAGATGACCGCT,0,2809134
ompRp1,0.14285714285714285,6,6,GGCCTCATGGATACCCATCA,0,2807605
ompRp1,0.14285714285714285,6,6,GGCCGCTTCCGTTGTTGAGT,0,2796407
ompRp1,0.14285714285714285,6,6,GGCCGATGGCCTGTCACAAC,0,2811875
ompRp1,0.14285714285714285,6,6,GGATTGTTGTGGTGTAGGCC,0,2784747
ompRp1,0.14285714285714285,6,6,GGATTATTGTGGGTCCGTCC,0,2784524
ompRp1,0.14285714285714285,6,6,GGATGCTCCAGAAGCCCAAT,0,2782308
ompRp1,0.14285714285714285,6,6,GGATACTTCCCGAACCCTTA,0,2797709
ompRp1,0.14285714285714285,6,6,GGAGTGGAGGCCTATTTTCC,0,2777482
ompRp1,0.14285714285714285,6,6,GGAGTCTTACTCAGGTACCC,0,2803306
ompRp1,0.14285714285714285,6,6,GGAGCCAGAAACCACCGTGC,0,2765336
ompRp1,0.14285714285714285,6,6,GGAGCCAATAGGTGACAGGA,0,2788607
ompRp1,0.14285714285714285,6,6,GGAGATTGTAGCTTGCGGAT,0,2796461
ompRp1,0.14285714285714285,6,6,GGACGGGCGCTCTGGGCGAA,0,2771232
ompRp1,0.14285714285714285,6,6,GGACGATACGATACGGTCTC,0,2818130
ompRp1,0.14285714285714285,6,6,GGACCACTCGTCCGCAGATC,0,2813686
ompRp1,0.14285714285714285,6,6,GGAATGTCAGTCCTAGTCAA,0,2776669
ompRp1,0.14285714285714285,6,6,GGAAGCGTGTCCCGCACTTG,0,2782741
ompRp1,0.14285714285714285,6,6,GGAAGAACCTACTAAGCCGA,0,2787589
ompRp1,0.14285714285714285,6,6,GCTTGTTGTCTGCAGTCAGC,0,2775845
ompRp1,0.14285714285714285,6,6,GCTTGTCAGTTTGCTCGTTA,0,2822113
ompRp1,0.14285714285714285,6,6,GCTTGAGGCTCAAGGTTCCG,0,2779837
ompRp1,0.14285714285714285,6,6,GCTTCTTAAAAGCGCGTAAC,0,2779963
ompRp1,0.14285714285714285,6,6,GCTTACCCTTTGACCGATAA,0,2789320
ompRp1,0.14285714285714285,6,6,GCTGTGTGGGTTGTCACGCA,0,2805125
ompRp1,0.14285714285714285,6,6,GCTGTAGGCACCGAGCCGCG,0,2801586
ompRp1,0.14285714285714285,6,6,GCTGCTAGGTCCGAGAGTGG,0,2768946
ompRp1,0.14285714285714285,6,6,GCTGCGGGCGTAAGCGCAGA,0,2779268
ompRp1,0.14285714285714285,6,6,GCTGACCCTAAACACAGACT,0,2811895
ompRp1,0.14285714285714285,6,6,GCTGAATGAATCGTATTTAA,0,2803159
ompRp1,0.14285714285714285,6,6,GCTCCTACTAACCGTATGAT,0,2766679
ompRp1,0.14285714285714285,6,6,GCTCACGGAAAATGCAAGTG,0,2809640
ompRp1,0.14285714285714285,6,6,GCTATTGTCCTGTATTTCAC,0,2796905
ompRp1,0.14285714285714285,6,6,GCTAGGGCTATATGATACCA,0,2805219
ompRp1,0.14285714285714285,6,6,GCTAGCCGGGTCTCATGTGA,0,2782126
ompRp1,0.14285714285714285,6,6,GCTAGAGCCAGTTTCGGTCA,0,2814501
ompRp1,0.14285714285714285,6,6,GCTAATCGACATTTGATTTA,0,2808794
ompRp1,0.14285714285714285,6,6,GCGTGACAAGAATGCTTTGA,0,2789583
ompRp1,0.14285714285714285,6,6,GCGTGAACAAATGGAGTGGT,0,2802890
ompRp1,0.14285714285714285,6,6,GCGTCCCAAGTGCTGGTGCA,0,2797796
ompRp1,0.14285714285714285,6,6,GCGTCAACCCCTAAATATAA,0,2815299
ompRp1,0.14285714285714285,6,6,GCGTAGCATGTATGGAGAGA,0,2767446
ompRp1,0.14285714285714285,6,6,GCGGTACCCACGGGGCAAAG,0,2822379
ompRp1,0.14285714285714285,6,6,GCGGATATAAGGCTGGGCTC,0,2785438
ompRp1,0.14285714285714285,6,6,GCGGACACAATCGGGAGGAA,0,2767841
ompRp1,0.14285714285714285,6,6,GCGCGCGCTTGTGCAACAAG,0,2768985
ompRp1,0.14285714285714285,6,6,GCGCCGAAAATAGCGTTAAC,0,2766999
ompRp1,0.14285714285714285,6,6,GCGCCACACGCCATCGGCAG,0,2802004
ompRp1,0.14285714285714285,6,6,GCGCATCTGGTTGAATCAGT,0,2771717
ompRp1,0.14285714285714285,6,6,GCGCATCGCGCGGTGTGCTT,0,2793106
ompRp1,0.14285714285714285,6,6,GCGCAGCCTTCTGCTTGGTA,0,2787967
ompRp1,0.14285714285714285,6,6,GCGATCGAGGGTCGGTTCTT,0,2815263
ompRp1,0.14285714285714285,6,6,GCGATAGTCCGGGCTTACTC,0,2795021
ompRp1,0.14285714285714285,6,6,GCGAGTTAGTCTGAAGAACT,0,2786012
ompRp1,0.14285714285714285,6,6,GCGAGTCTTCTGGCGGTGTG,0,2803341
ompRp1,0.14285714285714285,6,6,GCGAAATGTTATTCTATGTA,0,2777894
ompRp1,0.14285714285714285,6,6,GCCTTTCGACGCAATCAGGG,0,2781635
ompRp1,0.14285714285714285,6,6,GCCTATCTATGGTTTTCGAC,0,2774806
ompRp1,0.14285714285714285,6,6,GCCTAGGGATATTCACTCTT,0,2812622
ompRp1,0.14285714285714285,6,6,GCCGGTGGCGATGTCCGCTC,0,2774823
ompRp1,0.14285714285714285,6,6,GCCGGGGGGATGGGTACAAA,0,2799714
ompRp1,0.14285714285714285,6,6,GCCGCTCCCCCCAGCCCAAG,0,2801865
ompRp1,0.14285714285714285,6,6,GCCCGGGCGGGCATTTTCGC,0,2822576
ompRp1,0.14285714285714285,6,6,GCCCGCTCTTGAGTTGTGAA,0,2785963
ompRp1,0.14285714285714285,6,6,GCCCCCACATTGGCTAGCTG,0,2803259
ompRp1,0.14285714285714285,6,6,GCCCATGACTGAGTTTCTCT,0,2765909
ompRp1,0.14285714285714285,6,6,GCCCACGGGGCAATGTATAA,0,2775379
ompRp1,0.14285714285714285,6,6,GCCATTCGGTTATCGGCAGC,0,2818247
ompRp1,0.14285714285714285,6,6,GCCACTTCCCTTCAAGTTTT,0,2786990
ompRp1,0.14285714285714285,6,6,GCATTCCCTGTGGAATCTAT,0,2818670
ompRp1,0.14285714285714285,6,6,GCATTATAGCCCCTGTTGTA,0,2769819
ompRp1,0.14285714285714285,6,6,GCATTAATTGGTACCGAGGC,0,2817700
ompRp1,0.14285714285714285,6,6,GCATCAGCCTCCACCCCGAC,0,2820341
ompRp1,0.14285714285714285,6,6,GCATCAGCACGCCTCAGCGA,0,2781598
ompRp1,0.14285714285714285,6,6,GCAGTGAAACACAGTAAATC,0,2789106
ompRp1,0.14285714285714285,6,6,GCAGGTGTCTCATATTACAG,0,2769138
ompRp1,0.14285714285714285,6,6,GCAGGCTGTCGCGTGCCAAA,0,2807053
ompRp1,0.14285714285714285,6,6,GCAGGCTCTTAAACGTATAT,0,2818523
ompRp1,0.14285714285714285,6,6,GCACGCCCAGAATGATGCAT,0,2767582
ompRp1,0.14285714285714285,6,6,GCACGCACCGTAACACTTCG,0,2794180
ompRp1,0.14285714285714285,6,6,GCACCCCATCTTATATGGTA,0,2810692
ompRp1,0.14285714285714285,6,6,GCACACTTGATATGCCGGTG,0,2807197
ompRp1,0.14285714285714285,6,6,GCAACATTGCTGTGTGCTTT,0,2806047
ompRp1,0.14285714285714285,6,6,GCAAAGTGGGGTCAGTAGGC,0,2787267
ompRp1,0.14285714285714285,6,6,GATTTCACACTCGATAATGG,0,2822485
ompRp1,0.14285714285714285,6,6,GATTGATACAAGTAAAGAGT,0,2821593
ompRp1,0.14285714285714285,6,6,GATTCGTGTCTCCTCGAACT,0,2779573
ompRp1,0.14285714285714285,6,6,GATTCCAGGTTTGGAGGACT,0,2769823
ompRp1,0.14285714285714285,6,6,GATGCCCATCTGGCAAGATA,0,2774672
ompRp1,0.14285714285714285,6,6,GATCTTTGAGCCCTATACAG,0,2812876
ompRp1,0.14285714285714285,6,6,GATCTCAGCCAATACGCGAG,0,2775863
ompRp1,0.14285714285714285,6,6,GATCGGTTCTTATACTGTCA,0,2810822
ompRp1,0.14285714285714285,6,6,GATCGGGTCACCGGGTAGAT,0,2797925
ompRp1,0.14285714285714285,6,6,GATCGGAAAAATTCACTCGG,0,2794136
ompRp1,0.14285714285714285,6,6,GATACGTCAACTGTAGGGAT,0,2794739
ompRp1,0.14285714285714285,6,6,GATAACCAGGCATTCCAAGT,0,2769736
ompRp1,0.14285714285714285,6,6,GAGTTGCCTCATTCTAAAGG,0,2775256
ompRp1,0.14285714285714285,6,6,GAGTTCGTCGAGTCTGAGGC,0,2804546
ompRp1,0.14285714285714285,6,6,GAGTTACTCTTGTTCACGAA,0,2809648
ompRp1,0.14285714285714285,6,6,GAGTCAAGCAAAGAAGAGTT,0,2815253
ompRp1,0.14285714285714285,6,6,GAGTAGCGATGTGTAACCAC,0,2806136
ompRp1,0.14285714285714285,6,6,GAGGTACTCATTACCGTCAA,0,2819625
ompRp1,0.14285714285714285,6,6,GAGGGCATCCGATAAAGGAT,0,2795316
ompRp1,0.14285714285714285,6,6,GAGGCTTGTTTTCTGTAGTG,0,2804926
ompRp1,0.14285714285714285,6,6,GAGGCAGAGGAATACCTGTG,0,2815819
ompRp1,0.14285714285714285,6,6,GAGCTTGGTGGTAGATGAGA,0,2798948
ompRp1,0.14285714285714285,6,6,GAGCTATTTGCGCCCGCCGC,0,2767284
ompRp1,0.14285714285714285,6,6,GAGCTAGTCGCACGAGTGGG,0,2767579
ompRp1,0.14285714285714285,6,6,GAGACGTTCGAAAGTTTCAG,0,2775624
ompRp1,0.14285714285714285,6,6,GACTTTATTTTACATGTGGT,0,2784674
ompRp1,0.14285714285714285,6,6,GACTGTTAATGGCGTACCTA,0,2818947
ompRp1,0.14285714285714285,6,6,GACTGCGGTGGAGCAAGCTC,0,2786060
ompRp1,0.14285714285714285,6,6,GACGGTATGGTGAAGGGACT,0,2767691
ompRp1,0.14285714285714285,6,6,GACGGCATCTTTCGGTCATC,0,2799762
ompRp1,0.14285714285714285,6,6,GACGGATGGTACACTTTAAT,0,2787700
ompRp1,0.14285714285714285,6,6,GACGACGGTGATCCGACGAG,0,2821930
ompRp1,0.14285714285714285,6,6,GACCCATGCAGAACCACCTG,0,2769405
ompRp1,0.14285714285714285,6,6,GACCATGGGAGACCCTAGTG,0,2799109
ompRp1,0.14285714285714285,6,6,GACCACATGCGATTCCCAAC,0,2777603
ompRp1,0.14285714285714285,6,6,GACAGGACGGCTGACCGAAC,0,2790333
ompRp1,0.14285714285714285,6,6,GACACGACTCTCTTAATTTG,0,2788858
ompRp1,0.14285714285714285,6,6,GACACCAAACCGAATCTGTG,0,2791164
ompRp1,0.14285714285714285,6,6,GACAAGTGCCAAGTTCGTGG,0,2813392
ompRp1,0.14285714285714285,6,6,GAATGTTGTCTAACCCTGGT,0,2794035
ompRp1,0.14285714285714285,6,6,GAATCTACACAGTGATTGGA,0,2814747
ompRp1,0.14285714285714285,6,6,GAATCAATCAACCTGCTCTG,0,2772229
ompRp1,0.14285714285714285,6,6,GAATATCTGGGGGTTGGGAA,0,2779534
ompRp1,0.14285714285714285,6,6,GAAGAGACAATCTGTTCCCA,0,2818898
ompRp1,0.14285714285714285,6,6,GAACTGTGATGCAGCGAGCG,0,2821339
ompRp1,0.14285714285714285,6,6,GAACGGCTTCGATCTCAGAG,0,2768093
ompRp1,0.14285714285714285,6,6,GAACCAGGGACAGGGCTTAT,0,2782831
ompRp1,0.14285714285714285,6,6,GAACACTGTTGACGTCTCAT,0,2798328
ompRp1,0.14285714285714285,6,6,GAAATTGGATAGACCTCCGG,0,2821546
ompRp1,0.14285714285714285,6,6,GAAAGCGCGTCTGCTGCCTT,0,2791204
ompRp1,0.14285714285714285,6,6,GAAAGAGGTCCAACTTCCAA,0,2810689
ompRp1,0.14285714285714285,6,6,GAAAATATTCCTGGTGTGAT,0,2813249
ompRp1,0.14285714285714285,6,6,CTTTGGTGCTCCCATCTCCA,0,2796156
ompRp1,0.14285714285714285,6,6,CTTTGCCGTCATGATTTGTT,0,2799731
ompRp1,0.14285714285714285,6,6,CTTTCCCGTTATGGCTACAC,0,2767915
ompRp1,0.14285714285714285,6,6,CTTTACCCCGACACAGTCCA,0,2769429
ompRp1,0.14285714285714285,6,6,CTTGTGACAGCTGGGGGACC,0,2800859
ompRp1,0.14285714285714285,6,6,CTTGCTGTAATGTCTTCCTA,0,2794626
ompRp1,0.14285714285714285,6,6,CTTGCAACAAGAGGCAAGCA,0,2785254
ompRp1,0.14285714285714285,6,6,CTTCTGGATAGTACATATGT,0,2785924
ompRp1,0.14285714285714285,6,6,CTTCTGCTGTCGCGAGCAAT,0,2770996
ompRp1,0.14285714285714285,6,6,CTTCGCAACGCATTTTCCGC,0,2812315
ompRp1,0.14285714285714285,6,6,CTTCCTGCACGTACTAACGG,0,2802749
ompRp1,0.14285714285714285,6,6,CTTCCCCAGAATTTGTCTCA,0,2774140
ompRp1,0.14285714285714285,6,6,CTTCATGTTAGTAGCACGTT,0,2823604
ompRp1,0.14285714285714285,6,6,CTTATAACCCAGGCCTAGGG,0,2800444
ompRp1,0.14285714285714285,6,6,CTTAGGCTCCAGGTATGTAT,0,2778103
ompRp1,0.14285714285714285,6,6,CTTACTCCATGGTAGCACTT,0,2779684
ompRp1,0.14285714285714285,6,6,CTTACACAGAGGTGCGAGGT,0,2798872
ompRp1,0.14285714285714285,6,6,CTGTTCGCCCAACCGCAGAA,0,2780445
ompRp1,0.14285714285714285,6,6,CTGTGCATCGTCTAATCTCG,0,2771445
ompRp1,0.14285714285714285,6,6,CTGTGCAAAGCACTCCCGTT,0,2775516
ompRp1,0.14285714285714285,6,6,CTGGTGTCGCCGAGGTTTAT,0,2813951
ompRp1,0.14285714285714285,6,6,CTGGGTGCACCATACCTCGA,0,2810136
ompRp1,0.14285714285714285,6,6,CTGGGGAATCTGTATGATAG,0,2817322
ompRp1,0.14285714285714285,6,6,CTGGCTCTCCAGATTGTTTT,0,2818075
ompRp1,0.14285714285714285,6,6,CTGGAAGGAACAGTGGCGGA,0,2785075
ompRp1,0.14285714285714285,6,6,CTGCCTATTACCAAGCTATG,0,2805433
ompRp1,0.14285714285714285,6,6,CTGAGGCTGCCAATATATGG,0,2783073
ompRp1,0.14285714285714285,6,6,CTGACAACCTGGATTTCGGT,0,2800300
ompRp1,0.14285714285714285,6,6,CTGAAGAAAGTCTGTAGTTC,0,2796102
ompRp1,0.14285714285714285,6,6,CTCTGCGGTGCGCCGCAACA,0,2783850
ompRp1,0.14285714285714285,6,6,CTCGGCTATACAGTAAGAGA,0,2802725
ompRp1,0.14285714285714285,6,6,CTCGGCCGATGGCGAGGATG,0,2765888
ompRp1,0.14285714285714285,6,6,CTCCGGTCATGTAGGGCGTC,0,2767101
ompRp1,0.14285714285714285,6,6,CTCCGCGTTTAAAGAAGGCC,0,2794678
ompRp1,0.14285714285714285,6,6,CTCCCGCACTGGTAGGGCCT,0,2792919
ompRp1,0.14285714285714285,6,6,CTCCCATCATACCATGGTTC,0,2806588
ompRp1,0.14285714285714285,6,6,CTCCCACGCGAATAATGTAC,0,2810777
ompRp1,0.14285714285714285,6,6,CTCCAGCCACAGCCAACGGG,0,2816121
ompRp1,0.14285714285714285,6,6,CTCAGGTGTTGTAGTTCCGT,0,2769746
ompRp1,0.14285714285714285,6,6,CTCACTGGGACTGGTACATT,0,2788095
ompRp1,0.14285714285714285,6,6,CTCACTAATGGGTCGCACTC,0,2814742
ompRp1,0.14285714285714285,6,6,CTCAACTGAGCTCGCCTTTT,0,2776066
ompRp1,0.14285714285714285,6,6,CTATTTACTGACCATATTAG,0,2803054
ompRp1,0.14285714285714285,6,6,CTATGTAGGTTAGATGGAGA,0,2799089
ompRp1,0.14285714285714285,6,6,CTATCGTTAGTTTGAATTTA,0,2815313
ompRp1,0.14285714285714285,6,6,CTATCGTAGCTGTAGTCTTT,0,2766408
ompRp1,0.14285714285714285,6,6,CTATATGCTTTAGGCCGCCA,0,2802857
ompRp1,0.14285714285714285,6,6,CTAGTTCGCAGTGGACTGGT,0,2792682
ompRp1,0.14285714285714285,6,6,CTAGGGCGACGTGACGGAAC,0,2814037
ompRp1,0.14285714285714285,6,6,CTAGGCACTACGGCCTGCCA,0,2814981
ompRp1,0.14285714285714285,6,6,CTACTTATTCTTCGACGTGA,0,2769397
ompRp1,0.14285714285714285,6,6,CTACTCTCGCGAAGTTAGCC,0,2772399
ompRp1,0.14285714285714285,6,6,CTACGCTACTTGTTTGAGTA,0,2811628
ompRp1,0.14285714285714285,6,6,CTACCTTGGGACCCAACACA,0,2820754
ompRp1,0.14285714285714285,6,6,CTACCCTAACTAATGGTTGC,0,2781735
ompRp1,0.14285714285714285,6,6,CTAATGGCTCGTTAATGGTT,0,2789730
ompRp1,0.14285714285714285,6,6,CGTTTGCCCCCGAGAATTAT,0,2766751
ompRp1,0.14285714285714285,6,6,CGTTGATGAATCTGCTGATT,0,2808920
ompRp1,0.14285714285714285,6,6,CGTTCCTTGATCTTAAAGTA,0,2804306
ompRp1,0.14285714285714285,6,6,CGTTCAGACGCCGCACTAAG,0,2784452
ompRp1,0.14285714285714285,6,6,CGTTATAAGAGGGCTCGGTA,0,2782297
ompRp1,0.14285714285714285,6,6,CGTTAGACGCTGTGCCGACA,0,2818848
ompRp1,0.14285714285714285,6,6,CGTGTTGGATGAGGTGGGAA,0,2796779
ompRp1,0.14285714285714285,6,6,CGTGTCGAGTACGAATCTAT,0,2809356
ompRp1,0.14285714285714285,6,6,CGTGCACTCAACTTTAACAC,0,2793576
ompRp1,0.14285714285714285,6,6,CGTGAGTTCCGCTTGATCGA,0,2804848
ompRp1,0.14285714285714285,6,6,CGTCTTAAATGCACTCTGTA,0,2778662
ompRp1,0.14285714285714285,6,6,CGTCTAGTGTCATACAATAA,0,2819221
ompRp1,0.14285714285714285,6,6,CGTCGCCGCGGCGTTGGCGA,0,2797761
ompRp1,0.14285714285714285,6,6,CGTCCAGATCATGCTGCTCC,0,2799711
ompRp1,0.14285714285714285,6,6,CGTCCAAGTTAAACTCCTTG,0,2814360
ompRp1,0.14285714285714285,6,6,CGTCAGAGTTTGAATGCGCA,0,2812565
ompRp1,0.14285714285714285,6,6,CGTCAACGGCATCTATACAT,0,2811631
ompRp1,0.14285714285714285,6,6,CGTAGGGTATCCAGCCAAGG,0,2787697
ompRp1,0.14285714285714285,6,6,CGTAAGAGTCAATTCAGCGC,0,2800751
ompRp1,0.14285714285714285,6,6,CGGTTTATGTTTGTTGCCAA,0,2765949
ompRp1,0.14285714285714285,6,6,CGGTTATGTAGGGAGCCTTC,0,2813720
ompRp1,0.14285714285714285,6,6,CGGTTATCCTGATCACACCG,0,2803875
ompRp1,0.14285714285714285,6,6,CGGTACGCTACGATCATGCT,0,2766188
ompRp1,0.14285714285714285,6,6,CGGGTCGATGGCAAAAGGAT,0,2812338
ompRp1,0.14285714285714285,6,6,CGGGTCACCGTACTTACACC,0,2808836
ompRp1,0.14285714285714285,6,6,CGGGGTTTAAAGTAGCCTGC,0,2811659
ompRp1,0.14285714285714285,6,6,CGGGGTCTAAAAGAAAAGGC,0,2799088
ompRp1,0.14285714285714285,6,6,CGGGGTCGTAGTTGAGTATA,0,2801806
ompRp1,0.14285714285714285,6,6,CGGGCCGCCACGATCAACTG,0,2784288
ompRp1,0.14285714285714285,6,6,CGGGCAACTGGCGACCCAAC,0,2770357
ompRp1,0.14285714285714285,6,6,CGGGATCACTACTGAGTTCT,0,2814004
ompRp1,0.14285714285714285,6,6,CGGCTGCAGTTTGATTCTGG,0,2770043
ompRp1,0.14285714285714285,6,6,CGGCGGAGGGGTTGCGACGG,0,2800967
ompRp1,0.14285714285714285,6,6,CGGCGGAGCGCCATCAACCT,0,2813253
ompRp1,0.14285714285714285,6,6,CGGCGCCCTAGGACGGACGG,0,2822319
ompRp1,0.14285714285714285,6,6,CGGCGCATTCACCTTGACTA,0,2782319
ompRp1,0.14285714285714285,6,6,CGGCGACCGGGTTCCCTAGT,0,2773059
ompRp1,0.14285714285714285,6,6,CGGCCCGTGAGCGTTAAGGG,0,2779651
ompRp1,0.14285714285714285,6,6,CGGCCATCAGAGGTTGACCA,0,2800162
ompRp1,0.14285714285714285,6,6,CGGCACGTACGGAGCGTCCG,0,2797921
ompRp1,0.14285714285714285,6,6,CGGATGGCGGTTCGTTCGCG,0,2800660
ompRp1,0.14285714285714285,6,6,CGGAGAGAAATATAGTCCGA,0,2790612
ompRp1,0.14285714285714285,6,6,CGGACTACCACGCATCGGTT,0,2779739
ompRp1,0.14285714285714285,6,6,CGGAAGGTTAGGGCTATTCC,0,2774426
ompRp1,0.14285714285714285,6,6,CGGAAGCGATATACCGTAGA,0,2801683
ompRp1,0.14285714285714285,6,6,CGGAAGAGAATTGCTACTCC,0,2816509
ompRp1,0.14285714285714285,6,6,CGGAACTGGCCGCTGTGAAT,0,2802856
ompRp1,0.14285714285714285,6,6,CGCTGTTGGAGGAAAGAACA,0,2819372
ompRp1,0.14285714285714285,6,6,CGCTCTCACACGTAATGCGA,0,2782988
ompRp1,0.14285714285714285,6,6,CGCTCCTGAAAGCTCTAACC,0,2803504
ompRp1,0.14285714285714285,6,6,CGCGGTCGTTCTTCCCCCAA,0,2774905
ompRp1,0.14285714285714285,6,6,CGCGACAGTGCCAAGGGCGA,0,2817554
ompRp1,0.14285714285714285,6,6,CGCCTCTAATGACCCTTGGT,0,2783502
ompRp1,0.14285714285714285,6,6,CGCCGTAGATCTTCTGAGTT,0,2766696
ompRp1,0.14285714285714285,6,6,CGCCGGCGCTGCGCTGAGAC,0,2809834
ompRp1,0.14285714285714285,6,6,CGCCCCGGAAGTGGCATCCA,0,2809966
ompRp1,0.14285714285714285,6,6,CGCCCCCGTCGGACGCCTCT,0,2783927
ompRp1,0.14285714285714285,6,6,CGCAGCTTAGTCTTCATTCC,0,2816439
ompRp1,0.14285714285714285,6,6,CGCAGATTAAGAAATCATCG,0,2821010
ompRp1,0.14285714285714285,6,6,CGCACATAGTATATCTCTGT,0,2780646
ompRp1,0.14285714285714285,6,6,CGCACAAGGGGGAGTAGGAA,0,2810588
ompRp1,0.14285714285714285,6,6,CGATCGAATGCACACCAACG,0,2794614
ompRp1,0.14285714285714285,6,6,CGAGTAAAGATCACTCGATC,0,2815930
ompRp1,0.14285714285714285,6,6,CGAGATTAGGACCGAACGGG,0,2776254
ompRp1,0.14285714285714285,6,6,CGACTGGGGCCTTGACTGGT,0,2781974
ompRp1,0.14285714285714285,6,6,CGACGTGGGGAAACGCGCGT,0,2776667
ompRp1,0.14285714285714285,6,6,CGACCCGACGTTGCACAATT,0,2793365
ompRp1,0.14285714285714285,6,6,CGACAAGCTCGTGGTGTCCC,0,2769060
ompRp1,0.14285714285714285,6,6,CGAATTGCGGTGTATATTCT,0,2803784
ompRp1,0.14285714285714285,6,6,CGAATCCCTCGGGTCATTCA,0,2804835
ompRp1,0.14285714285714285,6,6,CGAATCACAACCTTCTCATG,0,2767793
ompRp1,0.14285714285714285,6,6,CGAACAGTTACTAATGAAAA,0,2780279
ompRp1,0.14285714285714285,6,6,CCTTCGTTACCATAGGATTT,0,2807851
ompRp1,0.14285714285714285,6,6,CCTGCACGGTGAGATTCTGT,0,2765530
ompRp1,0.14285714285714285,6,6,CCTCCGTCACCTGTCGTCAC,0,2797476
ompRp1,0.14285714285714285,6,6,CCTCAGCTGTATGCAGTCTC,0,2782509
ompRp1,0.14285714285714285,6,6,CCTATACCCTATCCTACAAA,0,2789059
ompRp1,0.14285714285714285,6,6,CCTACACGATACCGAATTGG,0,2766440
ompRp1,0.14285714285714285,6,6,CCTAAAGACCCGAAGGCCAG,0,2793451
ompRp1,0.14285714285714285,6,6,CCGTTAGGGCATGACGCCAA,0,2817674
ompRp1,0.14285714285714285,6,6,CCGTGTACATGTGCCTTCGG,0,2821912
ompRp1,0.14285714285714285,6,6,CCGTGGTAATAGCCTTCAGG,0,2809077
ompRp1,0.14285714285714285,6,6,CCGTCACTACGGTCTTTTGG,0,2785446
ompRp1,0.14285714285714285,6,6,CCGGTTCATACATTTAAGTT,0,2818643
ompRp1,0.14285714285714285,6,6,CCGGTAGTATTTCAGACGCC,0,2781035
ompRp1,0.14285714285714285,6,6,CCGGGATCAAAGATTTCACA,0,2811742
ompRp1,0.14285714285714285,6,6,CCGGGACCATATTCCGCCTT,0,2791597
ompRp1,0.14285714285714285,6,6,CCGGCACCGGTAACGGGCTT,0,2780045
ompRp1,0.14285714285714285,6,6,CCGGCAAGCGTTAGTGGTTT,0,2805309
ompRp1,0.14285714285714285,6,6,CCGCTATGATAAGTCCCAAG,0,2814795
ompRp1,0.14285714285714285,6,6,CCGCCCCGCTCATATAAGTA,0,2802601
ompRp1,0.14285714285714285,6,6,CCGATCGTCGAAAATAAAGG,0,2788536
ompRp1,0.14285714285714285,6,6,CCGACTAACCTGCTGTACGT,0,2785645
ompRp1,0.14285714285714285,6,6,CCGACGTATTAACAACGAGG,0,2765520
ompRp1,0.14285714285714285,6,6,CCGACCACCTTTAGTCGAAT,0,2820564
ompRp1,0.14285714285714285,6,6,CCGACACCATACCAACAGGC,0,2808522
ompRp1,0.14285714285714285,6,6,CCCTTCGTACTTTCTCGCAA,0,2773085
ompRp1,0.14285714285714285,6,6,CCCTGTTCCACAGGACTTTC,0,2787808
ompRp1,0.14285714285714285,6,6,CCCTGTAACGGACAAAGAAA,0,2789472
ompRp1,0.14285714285714285,6,6,CCCTGAAGTCAAGCCCGAAG,0,2779057
ompRp1,0.14285714285714285,6,6,CCCTCTACCACATTACCGCA,0,2811620
ompRp1,0.14285714285714285,6,6,CCCTAAAAGCGATGGCGTCG,0,2789708
ompRp1,0.14285714285714285,6,6,CCCGTAGGGCCATGATATTC,0,2801507
ompRp1,0.14285714285714285,6,6,CCCGTAGCTTCAGCTGTTAC,0,2785998
ompRp1,0.14285714285714285,6,6,CCCGTAACGCCGTACATGTG,0,2778631
ompRp1,0.14285714285714285,6,6,CCCGGTTCAGGTAGCCGGAG,0,2787189
ompRp1,0.14285714285714285,6,6,CCCGGTCAAGTAGTAGGACA,0,2811488
ompRp1,0.14285714285714285,6,6,CCCGGGTCTGTACCATTCGC,0,2780560
ompRp1,0.14285714285714285,6,6,CCCGGGACGGTTGTTCCCGA,0,2779763
ompRp1,0.14285714285714285,6,6,CCCGCTACTTGCTTTTAATT,0,2778850
ompRp1,0.14285714285714285,6,6,CCCCTCGGAATGCCATCGCA,0,2810538
ompRp1,0.14285714285714285,6,6,CCCCGAAAGAATACACACGA,0,2786653
ompRp1,0.14285714285714285,6,6,CCCCAAGATCGCGGATGTAT,0,2818813
ompRp1,0.14285714285714285,6,6,CCCAGTAGTAAGACCTGGCG,0,2775307
ompRp1,0.14285714285714285,6,6,CCCACTCGTAAGCGTCCAGT,0,2791674
ompRp1,0.14285714285714285,6,6,CCCACGTACTTTTTGGATTG,0,2775971
ompRp1,0.14285714285714285,6,6,CCCACGGACATGCGCGTATC,0,2769931
ompRp1,0.14285714285714285,6,6,CCCACCGTCGTCTGGCCTTA,0,2775820
ompRp1,0.14285714285714285,6,6,CCCAATTAAGGGAGCGTATG,0,2817090
ompRp1,0.14285714285714285,6,6,CCCAAAAAGATTAGCCATAA,0,2787494
ompRp1,0.14285714285714285,6,6,CCAGTCTGACATGGTCAGGT,0,2795537
ompRp1,0.14285714285714285,6,6,CCAGGCCGTGAAGAGGTCTC,0,2766850
ompRp1,0.14285714285714285,6,6,CCAGCTAACACAAAAAAGTA,0,2782284
ompRp1,0.14285714285714285,6,6,CCAGCCAGCCCTATGACAGC,0,2819789
ompRp1,0.14285714285714285,6,6,CCACGGGCCGCTATCTAAGA,0,2808327
ompRp1,0.14285714285714285,6,6,CCACCGGAAATCGGCTAACA,0,2770430
ompRp1,0.14285714285714285,6,6,CCAAGTAGTAGCAATAGTCT,0,2780031
ompRp1,0.14285714285714285,6,6,CCAAGCCAGCCAATATTGTC,0,2814824
ompRp1,0.14285714285714285,6,6,CCAACTTACCCGTGGCGTTT,0,2793931
ompRp1,0.14285714285714285,6,6,CCAACTCAGGATTTATCGAT,0,2810169
ompRp1,0.14285714285714285,6,6,CCAACCGCCGCTCAGCGCCT,0,2813248
ompRp1,0.14285714285714285,6,6,CATTTAAGGGTATATAAAAT,0,2798751
ompRp1,0.14285714285714285,6,6,CATTATTGCCGGGACGAAGT,0,2769322
ompRp1,0.14285714285714285,6,6,CATTATTAGCGGCCAGTCAT,0,2809781
ompRp1,0.14285714285714285,6,6,CATGCAGTAATGTATCGAGT,0,2805548
ompRp1,0.14285714285714285,6,6,CATGATTCAGGCTTTGTTCA,0,2775696
ompRp1,0.14285714285714285,6,6,CATGAGCAATTTCACTATGA,0,2802151
ompRp1,0.14285714285714285,6,6,CATGACATTGGGGTCTTTGT,0,2783075
ompRp1,0.14285714285714285,6,6,CATCCGGTGACGCCGATAAT,0,2777656
ompRp1,0.14285714285714285,6,6,CATCCGGGAAGCTATTTTCA,0,2782705
ompRp1,0.14285714285714285,6,6,CATATTTCTGCTGGGTAAGA,0,2807059
ompRp1,0.14285714285714285,6,6,CATAGCAAAGGCAAGCGAGG,0,2775432
ompRp1,0.14285714285714285,6,6,CATACTCGCATAAAGTGAGT,0,2816530
ompRp1,0.14285714285714285,6,6,CATACTCAAGAGCTCCACCC,0,2772071
ompRp1,0.14285714285714285,6,6,CATAAATTCCACCCATGTAG,0,2799895
ompRp1,0.14285714285714285,6,6,CAGTCAGATGCATTGTCAAG,0,2809046
ompRp1,0.14285714285714285,6,6,CAGTATATCCAATCCGGCGG,0,2803598
ompRp1,0.14285714285714285,6,6,CAGGTTCGTTTGTAATAGAA,0,2779865
ompRp1,0.14285714285714285,6,6,CAGGTGGGCCGCCGGCAATT,0,2821939
ompRp1,0.14285714285714285,6,6,CAGGGGACACACCCACGGGA,0,2794639
ompRp1,0.14285714285714285,6,6,CAGGGCAACTGCACCGCCGG,0,2812927
ompRp1,0.14285714285714285,6,6,CAGGCTCGTTGAGCTGAGTA,0,2778769
ompRp1,0.14285714285714285,6,6,CAGGAAATGGCTATGGCGAG,0,2783611
ompRp1,0.14285714285714285,6,6,CAGCGGTCAAAAAATAGTTG,0,2802478
ompRp1,0.14285714285714285,6,6,CAGCATGTACTTGTTTATAA,0,2800861
ompRp1,0.14285714285714285,6,6,CAGCACATTAGTCGTGAGGC,0,2807905
ompRp1,0.14285714285714285,6,6,CAGATTACGCTGCGTAGGAT,0,2816235
ompRp1,0.14285714285714285,6,6,CAGAACCCAACGGCAGCTGA,0,2793439
ompRp1,0.14285714285714285,6,6,CACTTTCAAGAACATTTGTG,0,2801489
ompRp1,0.14285714285714285,6,6,CACTTCCTAAACAAAGGCGA,0,2800887
ompRp1,0.14285714285714285,6,6,CACTGGAATACGCATCGTGT,0,2781292
ompRp1,0.14285714285714285,6,6,CACTGATGTCACGTTAGGAT,0,2821219
ompRp1,0.14285714285714285,6,6,CACTATCACAAGTTCCATTT,0,2786770
ompRp1,0.14285714285714285,6,6,CACGTTTCCGTCAAGACCAG,0,2771569
ompRp1,0.14285714285714285,6,6,CACGTAAGCTCAACCGGCAT,0,2818527
ompRp1,0.14285714285714285,6,6,CACGTAAACGGGGTGGCTTT,0,2768614
ompRp1,0.14285714285714285,6,6,CACGGTCCTTGACGTTGCAA,0,2802836
ompRp1,0.14285714285714285,6,6,CACGGAGAGCGGAACAGAAA,0,2808226
ompRp1,0.14285714285714285,6,6,CACGGAAGGAGAAAAAGAGC,0,2805342
ompRp1,0.14285714285714285,6,6,CACGCTCACGTGGCCGCAGT,0,2784020
ompRp1,0.14285714285714285,6,6,CACATGTAATACCGTTTCTA,0,2782158
ompRp1,0.14285714285714285,6,6,CACAGTGGGAGATCATTATG,0,2767223
ompRp1,0.14285714285714285,6,6,CACAGGCGTAATGGACGGTC,0,2818249
ompRp1,0.14285714285714285,6,6,CAATTGTGGTGGGGAGGGCA,0,2805116
ompRp1,0.14285714285714285,6,6,CAATGGTCTACATAGTGCTA,0,2814596
ompRp1,0.14285714285714285,6,6,CAATCAGGACCCTCACACTA,0,2824603
ompRp1,0.14285714285714285,6,6,CAATACCCACGCTTTGTAAT,0,2768301
ompRp1,0.14285714285714285,6,6,CAAGTGTGGCTCCAGTGATC,0,2767208
ompRp1,0.14285714285714285,6,6,CAAGTGACGTGGAAAAAACA,0,2812029
ompRp1,0.14285714285714285,6,6,CAAGTCACTCCCTATATTAA,0,2796077
ompRp1,0.14285714285714285,6,6,CAAGGGTTGAGGCCTTGCCG,0,2822696
ompRp1,0.14285714285714285,6,6,CAAGCGGGTCGGACTATCCA,0,2803743
ompRp1,0.14285714285714285,6,6,CAACGGTTACTGATAGCGAT,0,2796013
ompRp1,0.14285714285714285,6,6,CAAATGACTCGTGGCTGAGT,0,2771874
ompRp1,0.14285714285714285,6,6,CAAACTGCTTCCACGGTTCC,0,2794260
ompRp1,0.14285714285714285,6,6,ATTTTTTTTCGAAATACCGA,0,2766811
ompRp1,0.14285714285714285,6,6,ATTTTGTATCCGGAGCCCTC,0,2800362
ompRp1,0.14285714285714285,6,6,ATTGGTAAGTGTAGCGTGTT,0,2768920
ompRp1,0.14285714285714285,6,6,ATTGGACGGAGCTGGAAGCG,0,2810480
ompRp1,0.14285714285714285,6,6,ATTGCAAAGTAGAACCGCCA,0,2796444
ompRp1,0.14285714285714285,6,6,ATTCCTGAACACATCCCATC,0,2798998
ompRp1,0.14285714285714285,6,6,ATTATATCAGTCGTAAAACC,0,2783671
ompRp1,0.14285714285714285,6,6,ATTACTTAGCAGTGACGGTG,0,2793352
ompRp1,0.14285714285714285,6,6,ATTACTGTTAAGCTAGTGTA,0,2797579
ompRp1,0.14285714285714285,6,6,ATTAACGAGACAGGATCTTC,0,2769128
ompRp1,0.14285714285714285,6,6,ATTAAATTGAGGCCCCGGTG,0,2769523
ompRp1,0.14285714285714285,6,6,ATGTTGGAACAATTGTTCGG,0,2798647
ompRp1,0.14285714285714285,6,6,ATGTGGAGCATGGGCTGTAC,0,2769705
ompRp1,0.14285714285714285,6,6,ATGTGCCAATTGTTTCTTCA,0,2813946
ompRp1,0.14285714285714285,6,6,ATGGCGATGCTCCAGCACCT,0,2805317
ompRp1,0.14285714285714285,6,6,ATGCTTTGCGATTTCATTTT,0,2775204
ompRp1,0.14285714285714285,6,6,ATGCGTGCTTCGAAGGTATC,0,2783086
ompRp1,0.14285714285714285,6,6,ATGCATGGTAACGGTCCCGA,0,2802943
ompRp1,0.14285714285714285,6,6,ATGCATCTATATGAGGTCGT,0,2803781
ompRp1,0.14285714285714285,6,6,ATGATTAGCCACTGCTCTGG,0,2793688
ompRp1,0.14285714285714285,6,6,ATGAGCTTTCGGCTACGTCG,0,2781199
ompRp1,0.14285714285714285,6,6,ATGACCGAGTTACATACGGG,0,2812090
ompRp1,0.14285714285714285,6,6,ATGACACCGAGTCCATACGC,0,2801224
ompRp1,0.14285714285714285,6,6,ATCTTCAGAACAGTGGGTAA,0,2819009
ompRp1,0.14285714285714285,6,6,ATCTGGGAAGCCCAGCAGGT,0,2780293
ompRp1,0.14285714285714285,6,6,ATCTGAGGTGACCACTCACA,0,2800664
ompRp1,0.14285714285714285,6,6,ATCGAACTCCGACTCCCACA,0,2804134
ompRp1,0.14285714285714285,6,6,ATCCTGGGGAGGTACCATAG,0,2818600
ompRp1,0.14285714285714285,6,6,ATCCCGTGCATAGTCACAAT,0,2808871
ompRp1,0.14285714285714285,6,6,ATCCATGCAGCGTAGGCGGA,0,2777848
ompRp1,0.14285714285714285,6,6,ATCATTAGATAAAAGGGACG,0,2807963
ompRp1,0.14285714285714285,6,6,ATCAGCGCCGTGGTAGCTCT,0,2823101
ompRp1,0.14285714285714285,6,6,ATCACCTTTTTTGTGGTCTG,0,2794748
ompRp1,0.14285714285714285,6,6,ATATTAGACATGGATGACTA,0,2789276
ompRp1,0.14285714285714285,6,6,ATATGTAAAAGGAGTCGGTG,0,2777271
ompRp1,0.14285714285714285,6,6,ATATCGAATAAGCTGATTTT,0,2815754
ompRp1,0.14285714285714285,6,6,ATATAATACGTCGGATGCGG,0,2805297
ompRp1,0.14285714285714285,6,6,ATACCCGCCTTTGCTTGCTG,0,2775732
ompRp1,0.14285714285714285,6,6,ATACATGTCGATTCTACAAT,0,2791240
ompRp1,0.14285714285714285,6,6,ATACACTGGCACAACTTAGA,0,2790949
ompRp1,0.14285714285714285,6,6,ATACAAAACGAAATTCTGAT,0,2785055
ompRp1,0.14285714285714285,6,6,ATAATGTAACGGAAATCCGT,0,2768515
ompRp1,0.14285714285714285,6,6,ATAATGGAATTGTTTCTACT,0,2821636
ompRp1,0.14285714285714285,6,6,ATAATGCTCTCAGAAGTAGT,0,2801853
ompRp1,0.14285714285714285,6,6,AGTTTCGGGGTGCCGGATGC,0,2767714
ompRp1,0.14285714285714285,6,6,AGTTTCAAGGGTTTCGCTTT,0,2819827
ompRp1,0.14285714285714285,6,6,AGTTGGTATCTTACGGCATC,0,2780865
ompRp1,0.14285714285714285,6,6,AGTTCCTGTAAGACTCCGTA,0,2804731
ompRp1,0.14285714285714285,6,6,AGTGTTTTACATTAGAAGGC,0,2790568
ompRp1,0.14285714285714285,6,6,AGTGTGGCCCGTACTGGTCT,0,2800041
ompRp1,0.14285714285714285,6,6,AGTGTCTCGTTTGACCGGTC,0,2791397
ompRp1,0.14285714285714285,6,6,AGTGACTCCACGCCATCTTG,0,2786465
ompRp1,0.14285714285714285,6,6,AGTCTCGGAACCTCTCCACT,0,2768080
ompRp1,0.14285714285714285,6,6,AGTCTAGCACGTACAGTCTG,0,2769860
ompRp1,0.14285714285714285,6,6,AGTCGAGCACTCAACAAAAT,0,2785172
ompRp1,0.14285714285714285,6,6,AGTCCCACTTACAGATTACA,0,2785725
ompRp1,0.14285714285714285,6,6,AGTCCACCAAACGTTAATGC,0,2809770
ompRp1,0.14285714285714285,6,6,AGTCATGCAGAAGGAACTCA,0,2772922
ompRp1,0.14285714285714285,6,6,AGTCACGCCCGCGTCGGGGT,0,2793048
ompRp1,0.14285714285714285,6,6,AGTAGTGCTTGTTTCCGGCA,0,2816048
ompRp1,0.14285714285714285,6,6,AGTAATAGGGCAGATGCGAG,0,2810262
ompRp1,0.14285714285714285,6,6,AGTAAGGGGGCGGTCCTTCT,0,2812026
ompRp1,0.14285714285714285,6,6,AGGTTTTGCATCGGGTATCG,0,2790104
ompRp1,0.14285714285714285,6,6,AGGTTTACGCCCTTGGAGAT,0,2791355
ompRp1,0.14285714285714285,6,6,AGGTACGAAAGCTAGTAGTG,0,2783605
ompRp1,0.14285714285714285,6,6,AGGGGTCGCCAAGGATGGAC,0,2772086
ompRp1,0.14285714285714285,6,6,AGGGGGCCTGTATTAAGATG,0,2816348
ompRp1,0.14285714285714285,6,6,AGGGCGAAGGTGCCATTACC,0,2820584
ompRp1,0.14285714285714285,6,6,AGGCCTAATTGGTTAATGTA,0,2805248
ompRp1,0.14285714285714285,6,6,AGGCATCCCTAGTTCATCAA,0,2786366
ompRp1,0.14285714285714285,6,6,AGGATGCTTACGGCCATAGG,0,2772095
ompRp1,0.14285714285714285,6,6,AGGAGCACTCGGTTGCTCCC,0,2780252
ompRp1,0.14285714285714285,6,6,AGCTTCTATGTGTGTCGAGG,0,2821372
ompRp1,0.14285714285714285,6,6,AGCTGTATTCACTAAGTAGT,0,2766560
ompRp1,0.14285714285714285,6,6,AGCGTCCATATTTTCGGACT,0,2792117
ompRp1,0.14285714285714285,6,6,AGCGGTTATGCGGGCTGGCC,0,2814987
ompRp1,0.14285714285714285,6,6,AGCGACCCGGTGAAAGTTGG,0,2811926
ompRp1,0.14285714285714285,6,6,AGCCGCCAAAGGCACGTTAC,0,2784528
ompRp1,0.14285714285714285,6,6,AGCCCGTCTGGATACTGAAA,0,2777800
ompRp1,0.14285714285714285,6,6,AGCCCAGCTCTTAGTTTTCC,0,2810082
ompRp1,0.14285714285714285,6,6,AGCCAGCATCGCGGGTCATT,0,2782320
ompRp1,0.14285714285714285,6,6,AGCCAAAACTTCAGCTACCT,0,2784377
ompRp1,0.14285714285714285,6,6,AGCATTGTTATATTAAACAT,0,2765456
ompRp1,0.14285714285714285,6,6,AGCATTATCTGTCCCCCGCT,0,2792193
ompRp1,0.14285714285714285,6,6,AGCAGGCCGAAAAGAAGAGC,0,2786100
ompRp1,0.14285714285714285,6,6,AGCACCCCAACCGCGAGTGA,0,2809909
ompRp1,0.14285714285714285,6,6,AGATCAAGTATTCAGTAAGA,0,2765902
ompRp1,0.14285714285714285,6,6,AGAGTTAGGGGTAAGTTAAC,0,2794496
ompRp1,0.14285714285714285,6,6,AGAGTACTCGTCAACTGCGT,0,2786571
ompRp1,0.14285714285714285,6,6,AGAGGTAGATATGACGTCAC,0,2816719
ompRp1,0.14285714285714285,6,6,AGAGCCGCTCGTTATTTTAA,0,2810578
ompRp1,0.14285714285714285,6,6,AGAGATATTCGAACGGGCAG,0,2793625
ompRp1,0.14285714285714285,6,6,AGAGAGGCCATGGCCGCTTT,0,2790819
ompRp1,0.14285714285714285,6,6,AGAGACTATACCGCCTCCAG,0,2790950
ompRp1,0.14285714285714285,6,6,AGAGAAGGCGAAAGTACGTC,0,2820076
ompRp1,0.14285714285714285,6,6,AGACGTTGTTAAGATCAATG,0,2797447
ompRp1,0.14285714285714285,6,6,AGACGGCCCGTCATCGACCC,0,2799729
ompRp1,0.14285714285714285,6,6,AGACCTAAAATCGTACTGGG,0,2821280
ompRp1,0.14285714285714285,6,6,AGAATTTCGGGCCTATTCGA,0,2766675
ompRp1,0.14285714285714285,6,6,AGAATTAGGAGTATGGAGAT,0,2785369
ompRp1,0.14285714285714285,6,6,AGAACTAAGGATGATAAATT,0,2793157
ompRp1,0.14285714285714285,6,6,AGAACCATATACAACATGTT,0,2802008
ompRp1,0.14285714285714285,6,6,AGAAATTAAGCCAGTGTAGA,0,2804312
ompRp1,0.14285714285714285,6,6,ACTTTATTTAAAATTCTAAG,0,2792973
ompRp1,0.14285714285714285,6,6,ACTTACCATGCGTATTTAGA,0,2799120
ompRp1,0.14285714285714285,6,6,ACTGGTAAACATAGATTAAC,0,2806872
ompRp1,0.14285714285714285,6,6,ACTGGGAATGTGAACATAGC,0,2796359
ompRp1,0.14285714285714285,6,6,ACTGATGGCACATAAGTAGC,0,2809704
ompRp1,0.14285714285714285,6,6,ACTCGGTTTTATAACGCCTT,0,2786182
ompRp1,0.14285714285714285,6,6,ACTCAACAAATGATAGCCGA,0,2782140
ompRp1,0.14285714285714285,6,6,ACTCAAACCTGTGGGAGAAA,0,2786865
ompRp1,0.14285714285714285,6,6,ACTACGGAGTATTAGTTCAA,0,2808033
ompRp1,0.14285714285714285,6,6,ACGTTAAAACGGACACGTCA,0,2816039
ompRp1,0.14285714285714285,6,6,ACGTGCAGATCCGTCAAATG,0,2816992
ompRp1,0.14285714285714285,6,6,ACGTCTCGGATTCCGTACAG,0,2782550
ompRp1,0.14285714285714285,6,6,ACGGTGAATTAAGCCCGGGG,0,2786533
ompRp1,0.14285714285714285,6,6,ACGGGGCAGGACAATCATTT,0,2786224
ompRp1,0.14285714285714285,6,6,ACGGATGTTAAAAATGCAGA,0,2790944
ompRp1,0.14285714285714285,6,6,ACGCTATACACACTGCGGTA,0,2768775
ompRp1,0.14285714285714285,6,6,ACGCGCTAGCAAGCGGTGAA,0,2783382
ompRp1,0.14285714285714285,6,6,ACGCACGTTTCATGTCAAGT,0,2802944
ompRp1,0.14285714285714285,6,6,ACGATTTCAAAGCGAAATGA,0,2792443
ompRp1,0.14285714285714285,6,6,ACGACCGTCGCGGCTAATGA,0,2811364
ompRp1,0.14285714285714285,6,6,ACGAAGTTTGTAGGGTAGTG,0,2768969
ompRp1,0.14285714285714285,6,6,ACGAAAGGCGCCGCAAACTG,0,2777215
ompRp1,0.14285714285714285,6,6,ACCTTCCGCACAGGTACACA,0,2782287
ompRp1,0.14285714285714285,6,6,ACCTGGATCGTTCACAGAAG,0,2807199
ompRp1,0.14285714285714285,6,6,ACCTGCGATGCGAAGCCACG,0,2796672
ompRp1,0.14285714285714285,6,6,ACCTCTGCGCTGTGACAACC,0,2794617
ompRp1,0.14285714285714285,6,6,ACCTCAGGTTGATTGATGTA,0,2782299
ompRp1,0.14285714285714285,6,6,ACCGGCCTCGTCCTTCCAGA,0,2809549
ompRp1,0.14285714285714285,6,6,ACCGGAGCGCGTTACCTTAT,0,2797038
ompRp1,0.14285714285714285,6,6,ACCCTAGTTTAGGAGGGCCA,0,2790525
ompRp1,0.14285714285714285,6,6,ACCCGAGTCACGGGTGCGGT,0,2770087
ompRp1,0.14285714285714285,6,6,ACCCCTCCTGACTAAATAAG,0,2767736
ompRp1,0.14285714285714285,6,6,ACCCAACTGGCTAAGTCCGC,0,2816852
ompRp1,0.14285714285714285,6,6,ACATGTACTTCTCACCTTGT,0,2793110
ompRp1,0.14285714285714285,6,6,ACATGCCGGTTCCTGGTTAC,0,2776369
ompRp1,0.14285714285714285,6,6,ACATATCTTCGGTCCGTCAT,0,2810959
ompRp1,0.14285714285714285,6,6,ACATACGTCCAGTTCAGGTC,0,2795200
ompRp1,0.14285714285714285,6,6,ACAGTTGATTACGCCAAATA,0,2769602
ompRp1,0.14285714285714285,6,6,ACAGGTAGTGATACAGCAAA,0,2812360
ompRp1,0.14285714285714285,6,6,ACAGGGGACTCCATTTAATG,0,2805917
ompRp1,0.14285714285714285,6,6,ACAGGCGCAAGCAATCGGGA,0,2808633
ompRp1,0.14285714285714285,6,6,ACAGCTCTAAGGTTCGCTGT,0,2796992
ompRp1,0.14285714285714285,6,6,ACAGCTCGGGAGCGAGACTA,0,2808380
ompRp1,0.14285714285714285,6,6,ACAGCTAGGAACATTCAATA,0,2797032
ompRp1,0.14285714285714285,6,6,ACAGAAATGGCGTGAGCTAA,0,2775596
ompRp1,0.14285714285714285,6,6,ACACTGAGGTTTAGGGGGTG,0,2783349
ompRp1,0.14285714285714285,6,6,ACACAGACTCCCATTGCTAT,0,2773659
ompRp1,0.14285714285714285,6,6,ACAACTCCAACGAGGGTAAA,0,2781006
ompRp1,0.14285714285714285,6,6,ACAACCCGCCCCGTTGCTAA,0,2788100
ompRp1,0.14285714285714285,6,6,AATTCGAACATATACCCCGC,0,2794098
ompRp1,0.14285714285714285,6,6,AATTAGTTATATGTCAGGGA,0,2797125
ompRp1,0.14285714285714285,6,6,AATTAATTCTGGTTGGATGA,0,2817366
ompRp1,0.14285714285714285,6,6,AATGTTCCACCATCTTCGTG,0,2792114
ompRp1,0.14285714285714285,6,6,AATGTGAGTCCGCTAAGCCC,0,2770106
ompRp1,0.14285714285714285,6,6,AATGTGACGCATCCTGGAAC,0,2802738
ompRp1,0.14285714285714285,6,6,AATGTATTAGTCCTGGTGCG,0,2798256
ompRp1,0.14285714285714285,6,6,AATGGCGGTCGTCCAACAAT,0,2808503
ompRp1,0.14285714285714285,6,6,AATGCCTATCTTATGCGTGG,0,2814078
ompRp1,0.14285714285714285,6,6,AATCTATATCATCACCCAAC,0,2815766
ompRp1,0.14285714285714285,6,6,AATCGGCCCGATTAGATTCT,0,2770636
ompRp1,0.14285714285714285,6,6,AATCCGTGAGCATAAACCCC,0,2777323
ompRp1,0.14285714285714285,6,6,AATCCATGTGAGTTTTGTTT,0,2811933
ompRp1,0.14285714285714285,6,6,AATCCACGCAACGTCCGATA,0,2816087
ompRp1,0.14285714285714285,6,6,AATCAGGGCGTATTCTCTTG,0,2813800
ompRp1,0.14285714285714285,6,6,AATAGGCTAGCTAGTTTAAT,0,2788938
ompRp1,0.14285714285714285,6,6,AATAGAGGGTAAGTTTCGAA,0,2816430
ompRp1,0.14285714285714285,6,6,AAGTGGCGTACTTACGTTGC,0,2820242
ompRp1,0.14285714285714285,6,6,AAGTCGGTGCTCGTCACATG,0,2812181
ompRp1,0.14285714285714285,6,6,AAGTAACACGATTCTAATCA,0,2770945
ompRp1,0.14285714285714285,6,6,AAGGTGGCGGTCGTGACGCA,0,2817894
ompRp1,0.14285714285714285,6,6,AAGGGAGATTAGAGAAACGT,0,2804168
ompRp1,0.14285714285714285,6,6,AAGGACTAAAGGAGCGGCCT,0,2794602
ompRp1,0.14285714285714285,6,6,AAGGACCGAGAAATGACTCA,0,2821501
ompRp1,0.14285714285714285,6,6,AAGCTTCGAAACGTGGTGTC,0,2798052
ompRp1,0.14285714285714285,6,6,AAGCGAACCGTACCCTGGAT,0,2818796
ompRp1,0.14285714285714285,6,6,AAGCCGTCGATTCAGCCGTA,0,2770957
ompRp1,0.14285714285714285,6,6,AAGCCCGGTATTGCACGTAC,0,2808384
ompRp1,0.14285714285714285,6,6,AAGATGAAGGCCTGATTTCG,0,2777983
ompRp1,0.14285714285714285,6,6,AAGAGGACTAAAACCCACGC,0,2766823
ompRp1,0.14285714285714285,6,6,AAGACCAGGGGATATGGCGA,0,2783244
ompRp1,0.14285714285714285,6,6,AACTTGGCCTCCAAGCCTGG,0,2818438
ompRp1,0.14285714285714285,6,6,AACTACACCAAATAATTAAT,0,2817892
ompRp1,0.14285714285714285,6,6,AACGTAACGTACACCTCGGT,0,2806115
ompRp1,0.14285714285714285,6,6,AACGGGCTGCTTAGAGGACC,0,2773140
ompRp1,0.14285714285714285,6,6,AACGGATCAATTCATTGATA,0,2800468
ompRp1,0.14285714285714285,6,6,AACGCCTTCCTACTATAAAG,0,2815877
ompRp1,0.14285714285714285,6,6,AACGCAATGACTGCGGGATG,0,2809236
ompRp1,0.14285714285714285,6,6,AACGAGCGCAGATATCCACA,0,2801495
ompRp1,0.14285714285714285,6,6,AACCTGATTTGTTCAGGCAG,0,2772566
ompRp1,0.14285714285714285,6,6,AACATTCCCACTTCGGGTAC,0,2802911
ompRp1,0.14285714285714285,6,6,AACAGCTCGGCTCCGCTTTC,0,2788044
ompRp1,0.14285714285714285,6,6,AACACTCGGCCACGGGAGTC,0,2787648
ompRp1,0.14285714285714285,6,6,AACACGATTAGCGGTTCTCC,0,2765474
ompRp1,0.14285714285714285,6,6,AACACAATAGGTGTCTAAGG,0,2775836
ompRp1,0.14285714285714285,6,6,AACAAATCCACAATAGTCTC,0,2791292
ompRp1,0.14285714285714285,6,6,AAATTCCGATTGGTAATCAA,0,2773102
ompRp1,0.14285714285714285,6,6,AAATTAGCGCCGTGACGGCC,0,2781979
ompRp1,0.14285714285714285,6,6,AAATTACCGCTCTCAAGGCA,0,2817458
ompRp1,0.14285714285714285,6,6,AAATCCACAGAGGCACTTGG,0,2788840
ompRp1,0.14285714285714285,6,6,AAATAGTCTCTCATTTGGTC,0,2773211
ompRp1,0.14285714285714285,6,6,AAATACGGGATCTACATACT,0,2820465
ompRp1,0.14285714285714285,6,6,AAAGCGAATGCCCTGAGCGA,0,2821575
ompRp1,0.14285714285714285,6,6,AAAATTTTCGTGATGTCAGT,0,2777734
ompRp1,0.14285714285714285,6,6,AAAATTTATAGAAGCCCGTT,0,2782625
ompRp1,0.14285714285714285,6,6,AAAATATTCCGGCTTGTAAT,0,2797901
ompRp1,0.14285714285714285,6,6,AAAACTGGTAGTTTCAGATT,0,2769158
ompRp1,0.14285714285714285,6,6,AAAAAGGGCGGGGATGGTGC,0,2768121
ompRp1,0.14285714285714285,6,6,AAAAAATCGGTTTTACAAAA,0,2778938
ompRp1,0.16666666666666666,5,5,TTTTTTTGCATCAGCTGGCA,0,2797282
ompRp1,0.16666666666666666,5,5,TTTTTTAGATTGGAATTTCC,0,2781335
ompRp1,0.16666666666666666,5,5,TTTTTAGCAAATATCATCTG,0,2797210
ompRp1,0.16666666666666666,5,5,TTTGGTAACGAGTCCTGCCA,0,2799675
ompRp1,0.16666666666666666,5,5,TTTGGATCGATCTTAAGTTA,0,2794367
ompRp1,0.16666666666666666,5,5,TTTGGACCGAGCCGCGAACA,0,2783687
ompRp1,0.16666666666666666,5,5,TTTGCTTGGATGTAGGGGCA,0,2796667
ompRp1,0.16666666666666666,5,5,TTTGATAAATTCTGGAGCGT,0,2771303
ompRp1,0.16666666666666666,5,5,TTTGAGTGTTCCATATGAGA,0,2822316
ompRp1,0.16666666666666666,5,5,TTTCTGCTCACGCGTTTACT,0,2773448
ompRp1,0.16666666666666666,5,5,TTTCGTAACAAGCCGCTGCA,0,2803136
ompRp1,0.16666666666666666,5,5,TTTCGGGGCCTGGACAAAGT,0,2785175
ompRp1,0.16666666666666666,5,5,TTTCGGCGGATGGTATTCGT,0,2781924
ompRp1,0.16666666666666666,5,5,TTTCGGACACCTGCCAGGTA,0,2784630
ompRp1,0.16666666666666666,5,5,TTTCGAAATTCGGCACTCGG,0,2824428
ompRp1,0.16666666666666666,5,5,TTTCCTGACCTCATTTATTT,0,2812548
ompRp1,0.16666666666666666,5,5,TTTCAGTGTGGAGCATGCAG,0,2784896
ompRp1,0.16666666666666666,5,5,TTTCAGCTAGTATGCGTAAC,0,2813709
ompRp1,0.16666666666666666,5,5,TTTCAATGTGTCCACCACAT,0,2791662
ompRp1,0.16666666666666666,5,5,TTTATGACAAGGGTCATAAC,0,2806362
ompRp1,0.16666666666666666,5,5,TTTATATGGCAGTCCTAGTG,0,2784974
ompRp1,0.16666666666666666,5,5,TTTAGGCCAAACAGGCATTT,0,2767757
ompRp1,0.16666666666666666,5,5,TTTAGGAGTTAAGTGGGGCA,0,2779280
ompRp1,0.16666666666666666,5,5,TTTACGTAACCTGGAACGTG,0,2775487
ompRp1,0.16666666666666666,5,5,TTTAATATAAACCAGTTGAA,0,2823114
ompRp1,0.16666666666666666,5,5,TTTAAACATGAAGTGGGACT,0,2792068
ompRp1,0.16666666666666666,5,5,TTGTGAGCAACGGTACTAGC,0,2783419
ompRp1,0.16666666666666666,5,5,TTGTCCTGATCCTTAGACGC,0,2772641
ompRp1,0.16666666666666666,5,5,TTGTAGGTTGTAGAGGATGG,0,2786211
ompRp1,0.16666666666666666,5,5,TTGCGATCTGTAGTATACGA,0,2800667
ompRp1,0.16666666666666666,5,5,TTGCCTGTTCCAAGACCCAA,0,2778604
ompRp1,0.16666666666666666,5,5,TTGCCGGAGAGTCTGCATCT,0,2782608
ompRp1,0.16666666666666666,5,5,TTGATTGCTCACGGTAGATT,0,2797027
ompRp1,0.16666666666666666,5,5,TTGACCGAGACTACTCTATA,0,2806968
ompRp1,0.16666666666666666,5,5,TTGAAACATCACGAAAGTAA,0,2775374
ompRp1,0.16666666666666666,5,5,TTCTTGCCCCAATTGGGTGG,0,2808171
ompRp1,0.16666666666666666,5,5,TTCTTCTACTCTACAATTGG,0,2771372
ompRp1,0.16666666666666666,5,5,TTCTGACTTACAGAGGGAGC,0,2767931
ompRp1,0.16666666666666666,5,5,TTCTCGGCGTGTAGCGGTTT,0,2794018
ompRp1,0.16666666666666666,5,5,TTCTAGGCGTTGTGTGCACT,0,2786251
ompRp1,0.16666666666666666,5,5,TTCGGTTCGATACGTTCTCC,0,2793865
ompRp1,0.16666666666666666,5,5,TTCGGTGTCGAGGGTCACTA,0,2777939
ompRp1,0.16666666666666666,5,5,TTCGGGCTTGAACCGACCGG,0,2778943
ompRp1,0.16666666666666666,5,5,TTCGCCGAACAACTCCTTTA,0,2768530
ompRp1,0.16666666666666666,5,5,TTCGATAATTATACGGCATT,0,2792880
ompRp1,0.16666666666666666,5,5,TTCGAGAGGGATTCGTTACT,0,2823394
ompRp1,0.16666666666666666,5,5,TTCGACCGACTGACAGCGCT,0,2781919
ompRp1,0.16666666666666666,5,5,TTCGAAGACGCGCGTGAGCC,0,2772997
ompRp1,0.16666666666666666,5,5,TTCCTAGGCGCGAGCAGCTA,0,2793832
ompRp1,0.16666666666666666,5,5,TTCATTGGCGTGTGTAGTTT,0,2815975
ompRp1,0.16666666666666666,5,5,TTCAGCATATCGTACATTGA,0,2807056
ompRp1,0.16666666666666666,5,5,TTCAGAGTATCGTCGCGGAG,0,2791591
ompRp1,0.16666666666666666,5,5,TTCAATATGGCTTGTATTGA,0,2816901
ompRp1,0.16666666666666666,5,5,TTCAACGTCTTTGGGGCGTC,0,2807014
ompRp1,0.16666666666666666,5,5,TTATTTTAGTCTGGTGTCAT,0,2820867
ompRp1,0.16666666666666666,5,5,TTATTAACAGCAAATCCCGG,0,2806227
ompRp1,0.16666666666666666,5,5,TTATGAGACCATCGCAGCGA,0,2809285
ompRp1,0.16666666666666666,5,5,TTATAATCGTTGGCTACACC,0,2816351
ompRp1,0.16666666666666666,5,5,TTAGATCCAAGGGACTCCCA,0,2801440
ompRp1,0.16666666666666666,5,5,TTACCTGACGCTAGTCGCTT,0,2787668
ompRp1,0.16666666666666666,5,5,TTACAGGCGATCGACCTCGC,0,2807627
ompRp1,0.16666666666666666,5,5,TTACACGGATGGAAAATCTA,0,2814243
ompRp1,0.16666666666666666,5,5,TTAATCCGTTCTTACGCGCT,0,2767918
ompRp1,0.16666666666666666,5,5,TTAATACCCGCTATGGTGCG,0,2771068
ompRp1,0.16666666666666666,5,5,TTAAGTTTCTTCATCAAACG,0,2806476
ompRp1,0.16666666666666666,5,5,TGTTCCTACTCAATTGCTTA,0,2816277
ompRp1,0.16666666666666666,5,5,TGTTCACTTATAGTAGTGAG,0,2790216
ompRp1,0.16666666666666666,5,5,TGTTACATAGTTCGGATAGG,0,2790592
ompRp1,0.16666666666666666,5,5,TGTTAACCAATACCATACGT,0,2805421
ompRp1,0.16666666666666666,5,5,TGTGGTTCAATATAAAAGGG,0,2806768
ompRp1,0.16666666666666666,5,5,TGTGGGCCAGCGTTGTCACT,0,2791196
ompRp1,0.16666666666666666,5,5,TGTGGCAGGAGGATCCAGGT,0,2769069
ompRp1,0.16666666666666666,5,5,TGTGCTTCTCAAGGCGTTTA,0,2795574
ompRp1,0.16666666666666666,5,5,TGTGCGAGCACTCTCAGGGC,0,2765449
ompRp1,0.16666666666666666,5,5,TGTCGTCCTGATCGAGCGGA,0,2784957
ompRp1,0.16666666666666666,5,5,TGTCCAAACAAATATAACTA,0,2821492
ompRp1,0.16666666666666666,5,5,TGTATTAGATCGGGTCATCA,0,2779529
ompRp1,0.16666666666666666,5,5,TGTATCTGGATAGTCAGAAT,0,2773022
ompRp1,0.16666666666666666,5,5,TGTATCGTACTACAAATCTT,0,2773353
ompRp1,0.16666666666666666,5,5,TGGTTTGTGTGGCAGCATCC,0,2780115
ompRp1,0.16666666666666666,5,5,TGGTTTATATGTGTAGAGAA,0,2823012
ompRp1,0.16666666666666666,5,5,TGGTGAAATCAGTGGTAAGG,0,2792867
ompRp1,0.16666666666666666,5,5,TGGTCCTCTTCCAGGGTATC,0,2791940
ompRp1,0.16666666666666666,5,5,TGGTATGACGACTGCATAAA,0,2806508
ompRp1,0.16666666666666666,5,5,TGGTATCGATGACCTTTCAA,0,2783663
ompRp1,0.16666666666666666,5,5,TGGGTTTGTAGGCCCCAAAT,0,2809035
ompRp1,0.16666666666666666,5,5,TGGGTGCAATCGGAACAATG,0,2813908
ompRp1,0.16666666666666666,5,5,TGGGGTTGTGCACGTTAATG,0,2774948
ompRp1,0.16666666666666666,5,5,TGGGGGTCATTGCCCAGAGG,0,2822689
ompRp1,0.16666666666666666,5,5,TGGGCTATTGCTGTTCCAGT,0,2793739
ompRp1,0.16666666666666666,5,5,TGGGCGGGCGGTGAAACAGT,0,2820264
ompRp1,0.16666666666666666,5,5,TGGGATCATACTCGGGTTTG,0,2781376
ompRp1,0.16666666666666666,5,5,TGGGAGTACTGGCCGCATGT,0,2807408
ompRp1,0.16666666666666666,5,5,TGGGAGTAAGTCAGATGCGT,0,2785628
ompRp1,0.16666666666666666,5,5,TGGCTGTAGTTCCCCTACAT,0,2806972
ompRp1,0.16666666666666666,5,5,TGGCTGCGGCCTGTACATAT,0,2790118
ompRp1,0.16666666666666666,5,5,TGGCGTCACGCCCCTCATAA,0,2810800
ompRp1,0.16666666666666666,5,5,TGGCCCCGTAACCTGTGCCG,0,2796892
ompRp1,0.16666666666666666,5,5,TGGCCAGATCTATGAGTTAT,0,2788854
ompRp1,0.16666666666666666,5,5,TGGCACCTCCGTGCGTACAA,0,2775780
ompRp1,0.16666666666666666,5,5,TGGCAAACGATTCAAGGCTG,0,2770903
ompRp1,0.16666666666666666,5,5,TGGATGCACGAAATTGGCGA,0,2797851
ompRp1,0.16666666666666666,5,5,TGGATCATTATGCGGCCATT,0,2802496
ompRp1,0.16666666666666666,5,5,TGGAGGGACAAAATTGGAAT,0,2815037
ompRp1,0.16666666666666666,5,5,TGGAGCAATCATCCCCCCGT,0,2776262
ompRp1,0.16666666666666666,5,5,TGCTTGTACATGTTGTATAA,0,2773090
ompRp1,0.16666666666666666,5,5,TGCTTCCTTTTGCCTTGTGT,0,2822201
ompRp1,0.16666666666666666,5,5,TGCTCCCCACCACATTCCAT,0,2805903
ompRp1,0.16666666666666666,5,5,TGCTAGGTGAATAATGCTAT,0,2816607
ompRp1,0.16666666666666666,5,5,TGCGTTTCAGGGATTACGTC,0,2772062
ompRp1,0.16666666666666666,5,5,TGCGTTGTTCCACGATCGTT,0,2822423
ompRp1,0.16666666666666666,5,5,TGCGGTATTGGTGGTCTCAG,0,2811202
ompRp1,0.16666666666666666,5,5,TGCGGCGATCATTAGTTCTC,0,2798791
ompRp1,0.16666666666666666,5,5,TGCGCAGACCTTGCCGTACC,0,2804302
ompRp1,0.16666666666666666,5,5,TGCGCACCTCTCATTCAGAT,0,2793272
ompRp1,0.16666666666666666,5,5,TGCCTCCCGCTCTAGTTCCG,0,2799766
ompRp1,0.16666666666666666,5,5,TGCCTACATCCGCCTTGTTT,0,2797018
ompRp1,0.16666666666666666,5,5,TGCCGTCCCTAATGGCGCAC,0,2792613
ompRp1,0.16666666666666666,5,5,TGCCAGTCGGTAACTTACCT,0,2802205
ompRp1,0.16666666666666666,5,5,TGCATCGCGGCCTAGAGCCT,0,2818948
ompRp1,0.16666666666666666,5,5,TGCAGAACTGTCCTGGCTTG,0,2777540
ompRp1,0.16666666666666666,5,5,TGATTTCACCACACACGGAA,0,2780158
ompRp1,0.16666666666666666,5,5,TGATGCTCATTGCGTGAAAC,0,2816417
ompRp1,0.16666666666666666,5,5,TGATGATTAGTCGAATCCAC,0,2766435
ompRp1,0.16666666666666666,5,5,TGATAACATCGACCTCTATA,0,2817135
ompRp1,0.16666666666666666,5,5,TGAGTTGTTCTTGCCTTGCC,0,2799229
ompRp1,0.16666666666666666,5,5,TGAGTCGAACACACTTTCAC,0,2801438
ompRp1,0.16666666666666666,5,5,TGAGCGAAGGGCTTGGAATT,0,2799094
ompRp1,0.16666666666666666,5,5,TGACTTCTGTTTATACGAGG,0,2796468
ompRp1,0.16666666666666666,5,5,TGACTGCTTGATCTACGCAA,0,2809099
ompRp1,0.16666666666666666,5,5,TGAACCTCGCGGTCTAAGTA,0,2779404
ompRp1,0.16666666666666666,5,5,TGAACAACAATTTATCACTA,0,2795611
ompRp1,0.16666666666666666,5,5,TGAAAGACGCAGGAGACTAG,0,2823653
ompRp1,0.16666666666666666,5,5,TCTTTGTCGGTTCTCCGGAA,0,2784080
ompRp1,0.16666666666666666,5,5,TCTTGTTCAGCGTAGAGTAC,0,2773443
ompRp1,0.16666666666666666,5,5,TCTTAAGACGGGTTTAATAC,0,2797778
ompRp1,0.16666666666666666,5,5,TCTGTCTGTATGGATAACGA,0,2791280
ompRp1,0.16666666666666666,5,5,TCTGTCTCAGGGCTTTGGGA,0,2796830
ompRp1,0.16666666666666666,5,5,TCTGGCGGGTTGATTATGAT,0,2808470
ompRp1,0.16666666666666666,5,5,TCTGATGCACGCGCTCCCTC,0,2766590
ompRp1,0.16666666666666666,5,5,TCTCTTCCACACGACCTATG,0,2822919
ompRp1,0.16666666666666666,5,5,TCTCTGTGCCTCATGCGCTT,0,2771356
ompRp1,0.16666666666666666,5,5,TCTCTGAGTAGAAATGGCGC,0,2812222
ompRp1,0.16666666666666666,5,5,TCTCGATAATCGGGGTACTA,0,2798457
ompRp1,0.16666666666666666,5,5,TCTCGAGGCGCGCGGTCGGA,0,2820702
ompRp1,0.16666666666666666,5,5,TCTCCGAGCAGGTCAGTAAT,0,2804159
ompRp1,0.16666666666666666,5,5,TCTCCCTTGGACTAACCCTT,0,2808223
ompRp1,0.16666666666666666,5,5,TCTAGGCACCTTGTCAGGAC,0,2816349
ompRp1,0.16666666666666666,5,5,TCTAGCTCCCGTGCTCGTCG,0,2806955
ompRp1,0.16666666666666666,5,5,TCTAGACCTGCCATAAAGGA,0,2794426
ompRp1,0.16666666666666666,5,5,TCTACTAAAACACTCGAGAG,0,2810228
ompRp1,0.16666666666666666,5,5,TCTAATGTCTTTGTCGGGTA,0,2804373
ompRp1,0.16666666666666666,5,5,TCTAAAGACGTGAGCACGGC,0,2808806
ompRp1,0.16666666666666666,5,5,TCGTTCTAATACCGCTGGGG,0,2806548
ompRp1,0.16666666666666666,5,5,TCGTGTGGGTCCGCATGCGT,0,2810225
ompRp1,0.16666666666666666,5,5,TCGTCGAGCGACCACATGGA,0,2804781
ompRp1,0.16666666666666666,5,5,TCGTAATTTAGTGGCGCCCT,0,2772234
ompRp1,0.16666666666666666,5,5,TCGGTTGCGGCAATTTCGTC,0,2778193
ompRp1,0.16666666666666666,5,5,TCGGTATCGGGAAGACAGCC,0,2766314
ompRp1,0.16666666666666666,5,5,TCGGGTTTTGTGCGAGATAT,0,2807017
ompRp1,0.16666666666666666,5,5,TCGGGAACCAGAGATCCTAT,0,2777796
ompRp1,0.16666666666666666,5,5,TCGGCGTCATGTGTCCTGTC,0,2810015
ompRp1,0.16666666666666666,5,5,TCGGCCGTGGCGGAGCAGAC,0,2780734
ompRp1,0.16666666666666666,5,5,TCGGACACAAGGTTTCAAGG,0,2788522
ompRp1,0.16666666666666666,5,5,TCGGAAAGTACCCCCGGCAT,0,2810527
ompRp1,0.16666666666666666,5,5,TCGCGTGTGCGGTGTTGTCC,0,2786943
ompRp1,0.16666666666666666,5,5,TCGCGGTTCACGACACGATG,0,2769651
ompRp1,0.16666666666666666,5,5,TCGCGGGACAAAACTAATAT,0,2799657
ompRp1,0.16666666666666666,5,5,TCGCCGAGAAGGATAATCTG,0,2777696
ompRp1,0.16666666666666666,5,5,TCGCAGACCGATTAATTCCT,0,2813322
ompRp1,0.16666666666666666,5,5,TCGAGATTCTGGCTGTGTGG,0,2815256
ompRp1,0.16666666666666666,5,5,TCGAAAGCGGGACGCAGCGC,0,2776700
ompRp1,0.16666666666666666,5,5,TCCTGGATTTATGACATACG,0,2777592
ompRp1,0.16666666666666666,5,5,TCCTGCTTGAGGCATTTCTT,0,2817994
ompRp1,0.16666666666666666,5,5,TCCTGCCATTGTCGTAGTAA,0,2818875
ompRp1,0.16666666666666666,5,5,TCCTGATGTGAAATTGTCGC,0,2779794
ompRp1,0.16666666666666666,5,5,TCCGTGGTCTTGGGAAGGTT,0,2792264
ompRp1,0.16666666666666666,5,5,TCCGTACCAAAAAGCGATTA,0,2803558
ompRp1,0.16666666666666666,5,5,TCCGCACGGGGGTACGCATC,0,2812787
ompRp1,0.16666666666666666,5,5,TCCGAGATAGGAGCTCGTCT,0,2766532
ompRp1,0.16666666666666666,5,5,TCCCTGAATACGAGACTTTC,0,2821587
ompRp1,0.16666666666666666,5,5,TCCCCTGGCCTGTCAAAAAA,0,2793616
ompRp1,0.16666666666666666,5,5,TCCCCGCGATCGACCCCGAG,0,2791845
ompRp1,0.16666666666666666,5,5,TCCCATCCATGTTAGGCGTG,0,2805630
ompRp1,0.16666666666666666,5,5,TCCCAACGACCCGGTAGCGT,0,2814548
ompRp1,0.16666666666666666,5,5,TCCATTAGGTCATTACGGAT,0,2817206
ompRp1,0.16666666666666666,5,5,TCCATCGTAGAGCCGTATTT,0,2766470
ompRp1,0.16666666666666666,5,5,TCCAGGTCGGATTGAATACC,0,2769813
ompRp1,0.16666666666666666,5,5,TCCAGCACTTTCGCCAACCG,0,2771804
ompRp1,0.16666666666666666,5,5,TCCACAAGAATTCTTCAGTA,0,2769631
ompRp1,0.16666666666666666,5,5,TCCAAGGGGTACATAAGCGA,0,2775419
ompRp1,0.16666666666666666,5,5,TCATTAGAACGGTGTCTATT,0,2821467
ompRp1,0.16666666666666666,5,5,TCATTAATCCTTCGACCCGT,0,2806097
ompRp1,0.16666666666666666,5,5,TCATGCTCCGGTGAATACTG,0,2787028
ompRp1,0.16666666666666666,5,5,TCATGCCAACTGTGGGGGTA,0,2774604
ompRp1,0.16666666666666666,5,5,TCATAGGGGGTGTTTCGAAT,0,2799255
ompRp1,0.16666666666666666,5,5,TCATAAACGAATTATGACCA,0,2778361
ompRp1,0.16666666666666666,5,5,TCAGGAGGCGGTAGTCAAGC,0,2808613
ompRp1,0.16666666666666666,5,5,TCAGAAGGTCCCAGTGCCTC,0,2801378
ompRp1,0.16666666666666666,5,5,TCACTTCGCTTTTGAACTGT,0,2821612
ompRp1,0.16666666666666666,5,5,TCACTGCGCAAATAAGTTTT,0,2822521
ompRp1,0.16666666666666666,5,5,TCACGTTATAGACGGTTTCG,0,2781399
ompRp1,0.16666666666666666,5,5,TCAAGCTCATCTATTTTCGG,0,2798536
ompRp1,0.16666666666666666,5,5,TCAAACAGACGTTAGCCGCC,0,2767060
ompRp1,0.16666666666666666,5,5,TATTGCGGATTTCGTGCTGT,0,2817328
ompRp1,0.16666666666666666,5,5,TATTCCCCCTTAGTATTGTT,0,2790968
ompRp1,0.16666666666666666,5,5,TATTCCACGGGATCATGGTT,0,2806637
ompRp1,0.16666666666666666,5,5,TATTAGTTATGTTTACCGGT,0,2795057
ompRp1,0.16666666666666666,5,5,TATTAGCGCCCTGGGTATCT,0,2799477
ompRp1,0.16666666666666666,5,5,TATGGGCGTTATTAGGTTGC,0,2770513
ompRp1,0.16666666666666666,5,5,TATCTCAAGAATCGGACAGT,0,2810379
ompRp1,0.16666666666666666,5,5,TATCGACACGGGGCAGGGAC,0,2817365
ompRp1,0.16666666666666666,5,5,TATCATCCATGATATATCTA,0,2776858
ompRp1,0.16666666666666666,5,5,TATAGTGAACATACTAAGGA,0,2776078
ompRp1,0.16666666666666666,5,5,TATAGGTTGAGCAGAATTCG,0,2813860
ompRp1,0.16666666666666666,5,5,TATACTCAATATTGGTGGTG,0,2792636
ompRp1,0.16666666666666666,5,5,TATAACGTCCTGCTGTGCGC,0,2776255
ompRp1,0.16666666666666666,5,5,TAGGTAGCGAGCCCAAACGA,0,2824023
ompRp1,0.16666666666666666,5,5,TAGGGACCCAACAGTGGTGT,0,2815337
ompRp1,0.16666666666666666,5,5,TAGGCATTAAGATCCTCAAG,0,2796282
ompRp1,0.16666666666666666,5,5,TAGGAGTCGTCAGTGTGCGA,0,2781781
ompRp1,0.16666666666666666,5,5,TAGCCTATCCACAACCTCCA,0,2815704
ompRp1,0.16666666666666666,5,5,TAGCCATGTTTGAATACCAC,0,2818529
ompRp1,0.16666666666666666,5,5,TAGCAGGAGAGGCCAGCGTT,0,2818910
ompRp1,0.16666666666666666,5,5,TAGCAAAGCGCGGCAATTGG,0,2811069
ompRp1,0.16666666666666666,5,5,TAGATACTGTATGGTGCAAG,0,2780824
ompRp1,0.16666666666666666,5,5,TAGACGGAGCGGGGTCGGTT,0,2789255
ompRp1,0.16666666666666666,5,5,TAGAAGTCACAGCCTCGGCA,0,2774892
ompRp1,0.16666666666666666,5,5,TACTGTCAGTCTCGCCCGCT,0,2808168
ompRp1,0.16666666666666666,5,5,TACTCGGGGCCTCGCGTTTC,0,2776574
ompRp1,0.16666666666666666,5,5,TACGTTTGCAGCCCGGATCA,0,2815340
ompRp1,0.16666666666666666,5,5,TACGCTACACAATCAAATCG,0,2797364
ompRp1,0.16666666666666666,5,5,TACGAGCACCTCCAAGATTA,0,2814754
ompRp1,0.16666666666666666,5,5,TACGAAGAGTCCATTGCAGT,0,2776402
ompRp1,0.16666666666666666,5,5,TACCGTGCTTCGTTTAAAGA,0,2791457
ompRp1,0.16666666666666666,5,5,TACCCTGTGTAGGTTAGGGA,0,2806283
ompRp1,0.16666666666666666,5,5,TACCCGAGTAAAGCTTTTCA,0,2775699
ompRp1,0.16666666666666666,5,5,TACCAGAGTCAAGTGTGGTT,0,2768880
ompRp1,0.16666666666666666,5,5,TACAGATGCGGCCGCACGAA,0,2820358
ompRp1,0.16666666666666666,5,5,TACACTCTGGATAAGGCACG,0,2774534
ompRp1,0.16666666666666666,5,5,TACAACTTCGGAACACTCAT,0,2805417
ompRp1,0.16666666666666666,5,5,TACAACTTCGCTGCCCCTAC,0,2785634
ompRp1,0.16666666666666666,5,5,TAATTGAGGTAGTACTTTGC,0,2821919
ompRp1,0.16666666666666666,5,5,TAATGAGGTTAGTCCGTGAG,0,2802937
ompRp1,0.16666666666666666,5,5,TAATCTGTTTGTGCATCTGA,0,2783776
ompRp1,0.16666666666666666,5,5,TAATCAGTCTCCCTGTGTCG,0,2796729
ompRp1,0.16666666666666666,5,5,TAATAGGAACGTAACCGGGT,0,2804269
ompRp1,0.16666666666666666,5,5,TAATACCCGAAAGCGGTGGC,0,2781783
ompRp1,0.16666666666666666,5,5,TAAGTGATGGCTGGTCGTCT,0,2823734
ompRp1,0.16666666666666666,5,5,TAAGTCTAAAAGGTTCTTCC,0,2810583
ompRp1,0.16666666666666666,5,5,TAAGTAACTAAATAGGGAAG,0,2773004
ompRp1,0.16666666666666666,5,5,TAAGCGAATCATCTTAGTTC,0,2806715
ompRp1,0.16666666666666666,5,5,TAAGATATGTCAGATCAGCC,0,2822580
ompRp1,0.16666666666666666,5,5,TAAGAAGGTCGTAAGCGACT,0,2786176
ompRp1,0.16666666666666666,5,5,TAACTCTCCGCACACGTAAG,0,2781823
ompRp1,0.16666666666666666,5,5,TAACGCCCCATCCTTGTGGT,0,2779548
ompRp1,0.16666666666666666,5,5,TAACAGCGGCCGCTGGCTAT,0,2766478
ompRp1,0.16666666666666666,5,5,TAAATCTAAACCGCTCGCCC,0,2787416
ompRp1,0.16666666666666666,5,5,TAAAGGGGGGAGATAGCTCG,0,2785510
ompRp1,0.16666666666666666,5,5,TAAAGCTTGCGACGATGTGA,0,2777423
ompRp1,0.16666666666666666,5,5,TAAACCTACCAAGTACATGC,0,2819456
ompRp1,0.16666666666666666,5,5,TAAACCCAGTTCAGGAAACA,0,2782605
ompRp1,0.16666666666666666,5,5,TAAAAAGGGACATCGCCAAC,0,2782399
ompRp1,0.16666666666666666,5,5,GTTTGCTGTCCCAATAGTTG,0,2791235
ompRp1,0.16666666666666666,5,5,GTTTAAGGATCTACGAACGT,0,2811268
ompRp1,0.16666666666666666,5,5,GTTGGGGGACACCCGCCTAA,0,2823477
ompRp1,0.16666666666666666,5,5,GTTGCACCTCCAGTCCCCTT,0,2777977
ompRp1,0.16666666666666666,5,5,GTTGAAAAGATTGGCTACAA,0,2800023
ompRp1,0.16666666666666666,5,5,GTTCTCGCGGTCATTATTAA,0,2812337
ompRp1,0.16666666666666666,5,5,GTTCACGTACCCTCCAACGC,0,2789902
ompRp1,0.16666666666666666,5,5,GTTCACAGATGTCATAATCA,0,2777492
ompRp1,0.16666666666666666,5,5,GTTATGCGGAGTGTCGGCCT,0,2812028
ompRp1,0.16666666666666666,5,5,GTTATCAAGACTTCTGTGAG,0,2822558
ompRp1,0.16666666666666666,5,5,GTTAGTCACCTTGGGTCGTT,0,2809816
ompRp1,0.16666666666666666,5,5,GTTAGTAAATACTCGACAGG,0,2786768
ompRp1,0.16666666666666666,5,5,GTTAGGTACACGGTGCCTCC,0,2781595
ompRp1,0.16666666666666666,5,5,GTTAGAAGACCTAGTGTAAA,0,2801722
ompRp1,0.16666666666666666,5,5,GTTACCTACCTTACGTCGTC,0,2820034
ompRp1,0.16666666666666666,5,5,GTTACACGTTTAACTACGCC,0,2799031
ompRp1,0.16666666666666666,5,5,GTTAAGGTGCCCGTTCGCAT,0,2772226
ompRp1,0.16666666666666666,5,5,GTTAAGATAGGAGCGTAAGT,0,2791759
ompRp1,0.16666666666666666,5,5,GTGTTTGACAACTTCCAGAG,0,2810216
ompRp1,0.16666666666666666,5,5,GTGTGTAGGTAGTTAGCAGC,0,2795833
ompRp1,0.16666666666666666,5,5,GTGTCTTAGCATGGTATGCC,0,2767862
ompRp1,0.16666666666666666,5,5,GTGGTGTGTGTTGCAGAAGC,0,2806631
ompRp1,0.16666666666666666,5,5,GTGGGGTTTATTCCATATGG,0,2816903
ompRp1,0.16666666666666666,5,5,GTGGCTTGGGAGCTAGTAGC,0,2824173
ompRp1,0.16666666666666666,5,5,GTGGATGCGGTCCATGGACT,0,2782944
ompRp1,0.16666666666666666,5,5,GTGCAAATTTTCAACTGGTA,0,2800825
ompRp1,0.16666666666666666,5,5,GTGATGCGTATGCGTCTAGG,0,2795668
ompRp1,0.16666666666666666,5,5,GTGATAGGATTTAGTAAACG,0,2774713
ompRp1,0.16666666666666666,5,5,GTGACGCGTTCCTAAATGTC,0,2818963
ompRp1,0.16666666666666666,5,5,GTGACCTTGGATCGAAACCA,0,2765777
ompRp1,0.16666666666666666,5,5,GTGACAGATATCAGTGCGGC,0,2813352
ompRp1,0.16666666666666666,5,5,GTGAATATAGCGTAAACCAA,0,2813702
ompRp1,0.16666666666666666,5,5,GTGAAAATTGGACATTTTTA,0,2789899
ompRp1,0.16666666666666666,5,5,GTCTTTCAGGTCCCCATAAG,0,2768563
ompRp1,0.16666666666666666,5,5,GTCTCCAATTGGTTGTGGGC,0,2794905
ompRp1,0.16666666666666666,5,5,GTCTATCCAAGGGTGCCTTG,0,2777495
ompRp1,0.16666666666666666,5,5,GTCTAGGTACTCCGCAGGAC,0,2784325
ompRp1,0.16666666666666666,5,5,GTCTAGCGACTAGGTCTTTG,0,2807070
ompRp1,0.16666666666666666,5,5,GTCGGTTAGCTTTGAAGCAG,0,2776830
ompRp1,0.16666666666666666,5,5,GTCGGGGCATGTCATTGAGT,0,2775593
ompRp1,0.16666666666666666,5,5,GTCGGGCCTCGCTACACCCG,0,2770972
ompRp1,0.16666666666666666,5,5,GTCGCCAATGCTAGCCCGTA,0,2785573
ompRp1,0.16666666666666666,5,5,GTCGAACTTTCATACTATCT,0,2796523
ompRp1,0.16666666666666666,5,5,GTCCTAAACCGTGTAGGAAA,0,2797421
ompRp1,0.16666666666666666,5,5,GTCCGTTCAGCTATAATTCA,0,2811865
ompRp1,0.16666666666666666,5,5,GTCCAGCGAGCCGTTTTTCC,0,2787228
ompRp1,0.16666666666666666,5,5,GTCATGGTATCTTATTCGCG,0,2801055
ompRp1,0.16666666666666666,5,5,GTCAGGTCTAGACCTCGATT,0,2789345
ompRp1,0.16666666666666666,5,5,GTCACATCGTCCGAGAGGGT,0,2805611
ompRp1,0.16666666666666666,5,5,GTCAACCATCTCATCAGCTG,0,2811577
ompRp1,0.16666666666666666,5,5,GTATTGCCACACGGCGCCCA,0,2800744
ompRp1,0.16666666666666666,5,5,GTATTCTCTTATGTGGGTAG,0,2796431
ompRp1,0.16666666666666666,5,5,GTATGTCTGACGCATTCAAC,0,2816450
ompRp1,0.16666666666666666,5,5,GTATGGTCCCGACACCGCCA,0,2814871
ompRp1,0.16666666666666666,5,5,GTATGACTTTGCCGTCTGCG,0,2808541
ompRp1,0.16666666666666666,5,5,GTAGTGTTGGTGGAGACGGA,0,2817593
ompRp1,0.16666666666666666,5,5,GTAGTGTGTGGTCAATGGGA,0,2812796
ompRp1,0.16666666666666666,5,5,GTAGTAAGCCTTCAGTTACC,0,2775945
ompRp1,0.16666666666666666,5,5,GTAGGGGGGGAATCGCAGAA,0,2803524
ompRp1,0.16666666666666666,5,5,GTAGGGGGAACGCACTTTCG,0,2790189
ompRp1,0.16666666666666666,5,5,GTAGGGATCAATCGCACGAA,0,2811735
ompRp1,0.16666666666666666,5,5,GTAGCATGGCTTAACGCCAG,0,2813504
ompRp1,0.16666666666666666,5,5,GTACTGTCTAAACAATGCAT,0,2778255
ompRp1,0.16666666666666666,5,5,GTACGGAGTATGTCAAGCTT,0,2794731
ompRp1,0.16666666666666666,5,5,GTACGCGGGTCTGGAGAAAC,0,2767275
ompRp1,0.16666666666666666,5,5,GTAATTATCTGTCAGCAAAG,0,2795884
ompRp1,0.16666666666666666,5,5,GTAAAACTTGGTCGTTGCTT,0,2824648
ompRp1,0.16666666666666666,5,5,GGTTATGAGTCATATGGGTA,0,2815411
ompRp1,0.16666666666666666,5,5,GGTGGAATGAAGCATAGCTT,0,2804729
ompRp1,0.16666666666666666,5,5,GGTGCGTGAAGAGATTGCCG,0,2774966
ompRp1,0.16666666666666666,5,5,GGTGCCGAGGCCGGTAAGAT,0,2771152
ompRp1,0.16666666666666666,5,5,GGTGCATGCGTCCGGGCCAC,0,2788129
ompRp1,0.16666666666666666,5,5,GGTCGCGGATGGCCCCCACT,0,2798548
ompRp1,0.16666666666666666,5,5,GGTCCAGGGAGGCGTACCAA,0,2773008
ompRp1,0.16666666666666666,5,5,GGTCACGTAACCCCTCGGGG,0,2797836
ompRp1,0.16666666666666666,5,5,GGTATCCCGCAAGCAGGGTC,0,2788178
ompRp1,0.16666666666666666,5,5,GGTAGGGTGTTTGGAAGACG,0,2801018
ompRp1,0.16666666666666666,5,5,GGTAGCGCCGGAAACTCCAG,0,2777506
ompRp1,0.16666666666666666,5,5,GGTACAAGTACTACCGCGAC,0,2791126
ompRp1,0.16666666666666666,5,5,GGGTTCAATCTTGTAACGGT,0,2791853
ompRp1,0.16666666666666666,5,5,GGGTCCCCGGGTCTGAAGCT,0,2790218
ompRp1,0.16666666666666666,5,5,GGGTATAATGGCTACCAGAG,0,2784391
ompRp1,0.16666666666666666,5,5,GGGTAGTGAATCTCTGCAGT,0,2816941
ompRp1,0.16666666666666666,5,5,GGGGTTATGTGAGTCTCGAA,0,2793897
ompRp1,0.16666666666666666,5,5,GGGGTCCGTAACCACGTTGT,0,2806749
ompRp1,0.16666666666666666,5,5,GGGGTCAATAGTTCATGCAG,0,2798322
ompRp1,0.16666666666666666,5,5,GGGGGCTAGACGTTTCATGT,0,2806226
ompRp1,0.16666666666666666,5,5,GGGGGCGAGCAGAGGAGCTT,0,2813834
ompRp1,0.16666666666666666,5,5,GGGGGAGCAAAGCCTCGCCA,0,2799626
ompRp1,0.16666666666666666,5,5,GGGGCTAAATGCCCATGATG,0,2800640
ompRp1,0.16666666666666666,5,5,GGGGCACCAGTATGTAGCGT,0,2772117
ompRp1,0.16666666666666666,5,5,GGGGATAGCTTAGAGACAAG,0,2770674
ompRp1,0.16666666666666666,5,5,GGGCTGGATAGTGAACGTAT,0,2810698
ompRp1,0.16666666666666666,5,5,GGGCACGAGGTTTCAGGAAA,0,2793904
ompRp1,0.16666666666666666,5,5,GGGATTTGGTCCACTCCCTA,0,2805390
ompRp1,0.16666666666666666,5,5,GGGATGACAGGAGTGTGAGA,0,2811899
ompRp1,0.16666666666666666,5,5,GGGAGTCTGGTTTATGAATA,0,2788448
ompRp1,0.16666666666666666,5,5,GGGAGGTGTTGTACAGTGAA,0,2805841
ompRp1,0.16666666666666666,5,5,GGGAGGCAAAACATTAAATG,0,2816260
ompRp1,0.16666666666666666,5,5,GGCTTGGACATTAGGTTATA,0,2771297
ompRp1,0.16666666666666666,5,5,GGCTGGTTCGTACTGGGAAA,0,2778520
ompRp1,0.16666666666666666,5,5,GGCTGGCTTTGTGCACCTAG,0,2767615
ompRp1,0.16666666666666666,5,5,GGCTGCGCGGGCCGATGAAT,0,2783615
ompRp1,0.16666666666666666,5,5,GGCTGAGTCAGTAGCACTGC,0,2792265
ompRp1,0.16666666666666666,5,5,GGCTCGTATCTCATAATCGG,0,2770528
ompRp1,0.16666666666666666,5,5,GGCTACCACCTAGGCCTAGG,0,2773422
ompRp1,0.16666666666666666,5,5,GGCGTTGTACAAATAGGGCG,0,2811057
ompRp1,0.16666666666666666,5,5,GGCGTGGTCGGAGTGCCTGT,0,2784414
ompRp1,0.16666666666666666,5,5,GGCGGGTGCTTGGAAATTGG,0,2800738
ompRp1,0.16666666666666666,5,5,GGCGGCTCTAGAGCCTTTAG,0,2769382
ompRp1,0.16666666666666666,5,5,GGCGCCTCTTTTCGAGGCTC,0,2798164
ompRp1,0.16666666666666666,5,5,GGCGACCTGAAGCATTCGAA,0,2793509
ompRp1,0.16666666666666666,5,5,GGCCTGGCAGTAGTGTACTT,0,2775781
ompRp1,0.16666666666666666,5,5,GGCCTCTAGGCTATATCGGA,0,2809706
ompRp1,0.16666666666666666,5,5,GGCCGTCATCAGATCTGACT,0,2766557
ompRp1,0.16666666666666666,5,5,GGCCCAGGAGACAGTTTTTT,0,2823003
ompRp1,0.16666666666666666,5,5,GGCCACCGGCTATTTTCTTT,0,2809933
ompRp1,0.16666666666666666,5,5,GGCATGTCAGGCAATACGAA,0,2767540
ompRp1,0.16666666666666666,5,5,GGCAGGGGAGTACACACTCC,0,2795252
ompRp1,0.16666666666666666,5,5,GGCACCGTGTTAAGCGTAGC,0,2784022
ompRp1,0.16666666666666666,5,5,GGCAATGCGAGCCTATCTTT,0,2811793
ompRp1,0.16666666666666666,5,5,GGCAAGTATGAAGCTTATAT,0,2803285
ompRp1,0.16666666666666666,5,5,GGCAACCTATCTGATGTGAC,0,2801578
ompRp1,0.16666666666666666,5,5,GGATTTCAGTCGGAGGTTTA,0,2772144
ompRp1,0.16666666666666666,5,5,GGATCGTCGTTATGTACCAT,0,2779473
ompRp1,0.16666666666666666,5,5,GGATCCCAAACGGAGTTCGC,0,2769353
ompRp1,0.16666666666666666,5,5,GGAGAGTCAAACTGCATGAC,0,2788533
ompRp1,0.16666666666666666,5,5,GGACTGCGATTGATACTGCC,0,2785635
ompRp1,0.16666666666666666,5,5,GGACTAAGGCAAGGGAGAAC,0,2815145
ompRp1,0.16666666666666666,5,5,GGACGGGTAACTGAAGTTTC,0,2796175
ompRp1,0.16666666666666666,5,5,GGACGGAACTTCACAACGAT,0,2796032
ompRp1,0.16666666666666666,5,5,GGACGACAACTAGAACTGGC,0,2821318
ompRp1,0.16666666666666666,5,5,GGACCGGGTTCCGGTTCATA,0,2824221
ompRp1,0.16666666666666666,5,5,GGACAGTAGCCCGTGAGGGT,0,2793817
ompRp1,0.16666666666666666,5,5,GGAAATTCCTTTTGGTTACT,0,2823751
ompRp1,0.16666666666666666,5,5,GCTTGATAGCTCTCGGCTGG,0,2796362
ompRp1,0.16666666666666666,5,5,GCTTCTGCTAACGCAGTAAC,0,2810821
ompRp1,0.16666666666666666,5,5,GCTTCGCCACCTTGCATCAA,0,2796257
ompRp1,0.16666666666666666,5,5,GCTTCGATTTCGGTGTGTAT,0,2797414
ompRp1,0.16666666666666666,5,5,GCTTATATTCGTCAAAAGCG,0,2798171
ompRp1,0.16666666666666666,5,5,GCTGTGAATTAGTGTGGGCG,0,2782242
ompRp1,0.16666666666666666,5,5,GCTGGGAGAGTTTACCCCGC,0,2797002
ompRp1,0.16666666666666666,5,5,GCTGCTGGTTAGGCCAGCTG,0,2768055
ompRp1,0.16666666666666666,5,5,GCTCTAGACCCCGTGGTCCA,0,2799615
ompRp1,0.16666666666666666,5,5,GCTCTAATATAGGAACCCGT,0,2802373
ompRp1,0.16666666666666666,5,5,GCTCCTTCGATTCCGCTGCT,0,2806307
ompRp1,0.16666666666666666,5,5,GCTCCTGGCCCATTGGCCTC,0,2811507
ompRp1,0.16666666666666666,5,5,GCTCCCAGTATATCCCACTC,0,2812388
ompRp1,0.16666666666666666,5,5,GCTAGTGGCCCACGGCGTCA,0,2799947
ompRp1,0.16666666666666666,5,5,GCTAGGACGCTACTCGTCAT,0,2796217
ompRp1,0.16666666666666666,5,5,GCTAGCGTCACTTCCGGCCG,0,2800348
ompRp1,0.16666666666666666,5,5,GCTACACAGCCACTCCTAGT,0,2775731
ompRp1,0.16666666666666666,5,5,GCGTTGAAGGTGAATTGCGA,0,2766073
ompRp1,0.16666666666666666,5,5,GCGTTCTAGGTGCTTCGTTA,0,2776750
ompRp1,0.16666666666666666,5,5,GCGTTCAGATTAAGACGAAG,0,2807444
ompRp1,0.16666666666666666,5,5,GCGTTATCCGTGTCCTGAGC,0,2781023
ompRp1,0.16666666666666666,5,5,GCGTGGGTTGCGTTTTACAC,0,2810437
ompRp1,0.16666666666666666,5,5,GCGGTCTTACAACAGCTAGA,0,2794336
ompRp1,0.16666666666666666,5,5,GCGGTATTCCTTTCGGCGAC,0,2817374
ompRp1,0.16666666666666666,5,5,GCGGTATCTCCATACGCCAG,0,2766412
ompRp1,0.16666666666666666,5,5,GCGGGGTCATCACAGATCTG,0,2791137
ompRp1,0.16666666666666666,5,5,GCGGGAATTCGTGCGGAATA,0,2795472
ompRp1,0.16666666666666666,5,5,GCGCCGAGCGAGCTATGGTT,0,2769292
ompRp1,0.16666666666666666,5,5,GCGCCGAGCACAGATGTGAG,0,2820858
ompRp1,0.16666666666666666,5,5,GCGACGGCTTCCCTAGGCGG,0,2815898
ompRp1,0.16666666666666666,5,5,GCGACGACGCAGCAAGGCAT,0,2774734
ompRp1,0.16666666666666666,5,5,GCGACATGATTAGTCCTTAG,0,2767521
ompRp1,0.16666666666666666,5,5,GCCTTTCAGGCTTGCGTCCG,0,2800502
ompRp1,0.16666666666666666,5,5,GCCTCACTTCGCTCTGGGTG,0,2812839
ompRp1,0.16666666666666666,5,5,GCCTAATCATTAGTAATCGG,0,2775442
ompRp1,0.16666666666666666,5,5,GCCGTCCGCAAGCATATTAT,0,2815483
ompRp1,0.16666666666666666,5,5,GCCGTACGAGTTAATGACAA,0,2786584
ompRp1,0.16666666666666666,5,5,GCCGGAACGTGGGGCTCTTT,0,2801024
ompRp1,0.16666666666666666,5,5,GCCGACCGGATGGTCAAAAC,0,2795561
ompRp1,0.16666666666666666,5,5,GCCCTCATGTGTATTCCCCC,0,2789584
ompRp1,0.16666666666666666,5,5,GCCCCAACGGGGAAAGCACT,0,2785209
ompRp1,0.16666666666666666,5,5,GCCATGGCCAAATAACGTTC,0,2818633
ompRp1,0.16666666666666666,5,5,GCCAGTTAGCTGTCTCACCC,0,2779670
ompRp1,0.16666666666666666,5,5,GCCAGTGCCCATCTACTCGG,0,2806878
ompRp1,0.16666666666666666,5,5,GCCAGTATAATTTGACTGAA,0,2821565
ompRp1,0.16666666666666666,5,5,GCCAGGGTTCAGGGTGTTCT,0,2795792
ompRp1,0.16666666666666666,5,5,GCCACTAGAACCTTTTGTCG,0,2824423
ompRp1,0.16666666666666666,5,5,GCCACGGGCTTACTGCGTGT,0,2772900
ompRp1,0.16666666666666666,5,5,GCCAAGCGGCTTCGGACTAG,0,2806722
ompRp1,0.16666666666666666,5,5,GCCAAGCCCATTCTTATCAT,0,2779681
ompRp1,0.16666666666666666,5,5,GCCAACAAGGTACGTAAGAG,0,2778561
ompRp1,0.16666666666666666,5,5,GCATTCCTAGTGCCTGGTTA,0,2787795
ompRp1,0.16666666666666666,5,5,GCATGATTCGACCTGGTTGA,0,2774415
ompRp1,0.16666666666666666,5,5,GCATGAGTCCCGGCAAAGTC,0,2808334
ompRp1,0.16666666666666666,5,5,GCATAGTCTCTCATATTTAA,0,2778448
ompRp1,0.16666666666666666,5,5,GCATAGACCATCTAAGATAT,0,2821620
ompRp1,0.16666666666666666,5,5,GCACGGGTTGACATGAAAAT,0,2813560
ompRp1,0.16666666666666666,5,5,GCACCGATCCAACGACTGAC,0,2789247
ompRp1,0.16666666666666666,5,5,GCACAGCTTTCGGCGGGACT,0,2792149
ompRp1,0.16666666666666666,5,5,GCAATGCCAGGCGGGCTTCT,0,2815370
ompRp1,0.16666666666666666,5,5,GCAATAGATTAAGGGAAACT,0,2813149
ompRp1,0.16666666666666666,5,5,GCAAGCAGGCAGTCATACCA,0,2795288
ompRp1,0.16666666666666666,5,5,GCAAATAAGCAGCGTCGCCA,0,2789879
ompRp1,0.16666666666666666,5,5,GCAAAGAACAAGTGAGCTTT,0,2781096
ompRp1,0.16666666666666666,5,5,GATTTAATCACCTGATGTGT,0,2768239
ompRp1,0.16666666666666666,5,5,GATTGAGAACCGCGTCCTAT,0,2804369
ompRp1,0.16666666666666666,5,5,GATTCCGGAATGCTTATTTG,0,2788610
ompRp1,0.16666666666666666,5,5,GATTCCCCAGGGTTGCAATA,0,2802300
ompRp1,0.16666666666666666,5,5,GATTCACCCCATAATCTGAT,0,2783655
ompRp1,0.16666666666666666,5,5,GATTAGGGCGATAATTTGTG,0,2795052
ompRp1,0.16666666666666666,5,5,GATTACCGTAAGGAGAATGC,0,2801927
ompRp1,0.16666666666666666,5,5,GATGTACCCGGTCGAAATTT,0,2814447
ompRp1,0.16666666666666666,5,5,GATGGTCACCGGAACAAATA,0,2823981
ompRp1,0.16666666666666666,5,5,GATGGGTAAGGTAATGCGCG,0,2816929
ompRp1,0.16666666666666666,5,5,GATGCGAATCCTTGGAATGA,0,2818480
ompRp1,0.16666666666666666,5,5,GATCCAAAAGCCCCCCCGTA,0,2785659
ompRp1,0.16666666666666666,5,5,GATATGAGCTCGTCAACTTG,0,2820191
ompRp1,0.16666666666666666,5,5,GATAGATTGGATACACAACT,0,2790419
ompRp1,0.16666666666666666,5,5,GATACCCGCTGGCATATTGA,0,2783809
ompRp1,0.16666666666666666,5,5,GAGTTTCATGTTGTGGCATC,0,2817268
ompRp1,0.16666666666666666,5,5,GAGTGTTTTCCGTTTGGACC,0,2799863
ompRp1,0.16666666666666666,5,5,GAGTCTTCCGACTTATAGGC,0,2788907
ompRp1,0.16666666666666666,5,5,GAGTCGCCTGGACAGGTTGT,0,2813580
ompRp1,0.16666666666666666,5,5,GAGTACGCAACATCTCGTAT,0,2817724
ompRp1,0.16666666666666666,5,5,GAGGTGTAACAACAATTGGA,0,2772734
ompRp1,0.16666666666666666,5,5,GAGGGGGGGCTAGATCACGT,0,2769428
ompRp1,0.16666666666666666,5,5,GAGGCGCACAGGGGGATTCG,0,2821330
ompRp1,0.16666666666666666,5,5,GAGGCCCTGAAGATCCTGCA,0,2819198
ompRp1,0.16666666666666666,5,5,GAGGAGGAGTGGTCCAGACC,0,2794339
ompRp1,0.16666666666666666,5,5,GAGGAATTGCACATTTCGGA,0,2805209
ompRp1,0.16666666666666666,5,5,GAGGAATGCTCCGGTCGCCG,0,2766604
ompRp1,0.16666666666666666,5,5,GAGCTTGAAGCCTGAGCCGA,0,2778225
ompRp1,0.16666666666666666,5,5,GAGCTCTAGTTTCCAGAGCG,0,2776292
ompRp1,0.16666666666666666,5,5,GAGCTATGGGCCTGCAAGTC,0,2768550
ompRp1,0.16666666666666666,5,5,GAGCTACTTCTGTGAATATG,0,2786662
ompRp1,0.16666666666666666,5,5,GAGCCGCACGAACAGGCCGT,0,2801820
ompRp1,0.16666666666666666,5,5,GAGACCTAGCAGGTCATAGA,0,2777244
ompRp1,0.16666666666666666,5,5,GAGAACTTTAACTTGGATAC,0,2794888
ompRp1,0.16666666666666666,5,5,GAGAAAAGCGCGCGAACCTT,0,2780772
ompRp1,0.16666666666666666,5,5,GACTTGCTAGGTAGACTATG,0,2787041
ompRp1,0.16666666666666666,5,5,GACTTATAGCGACGTTGACT,0,2791748
ompRp1,0.16666666666666666,5,5,GACTGCAGTGGGGCACCAAA,0,2804893
ompRp1,0.16666666666666666,5,5,GACTGATGCTCTAGGACCAG,0,2782818
ompRp1,0.16666666666666666,5,5,GACTGAAACTTAGTTTGTAC,0,2787132
ompRp1,0.16666666666666666,5,5,GACTATTAAAGGTTACGCTC,0,2767416
ompRp1,0.16666666666666666,5,5,GACTAGGGGCTCCGATTTGG,0,2819724
ompRp1,0.16666666666666666,5,5,GACTAACTAGCTGAAATGGA,0,2817010
ompRp1,0.16666666666666666,5,5,GACGTGATCATCTTCGGCGT,0,2766441
ompRp1,0.16666666666666666,5,5,GACAGTCCGGGAACATCAAT,0,2791359
ompRp1,0.16666666666666666,5,5,GACAGCGTGAAAATCGAGAG,0,2779900
ompRp1,0.16666666666666666,5,5,GACACTCTCCGGATTCCCAC,0,2809445
ompRp1,0.16666666666666666,5,5,GACACCTTACGGGCAGGTGA,0,2813451
ompRp1,0.16666666666666666,5,5,GAATGACCCAGGATGGACGG,0,2807505
ompRp1,0.16666666666666666,5,5,GAATGAAAAATCCGGAAACT,0,2767376
ompRp1,0.16666666666666666,5,5,GAATCCACAAGGCTATAAGA,0,2811950
ompRp1,0.16666666666666666,5,5,GAATCATTTCCGAATAAAGA,0,2808524
ompRp1,0.16666666666666666,5,5,GAATCATCTGCCTGCTGTGT,0,2816899
ompRp1,0.16666666666666666,5,5,GAATAATCTATAAGTAAGAT,0,2776918
ompRp1,0.16666666666666666,5,5,GAATAAAAGAGTTGCGATCG,0,2778377
ompRp1,0.16666666666666666,5,5,GAAGTCCGGGAGACGGTCAC,0,2810207
ompRp1,0.16666666666666666,5,5,GAAGTCAAAGTTTTAAGCGT,0,2810369
ompRp1,0.16666666666666666,5,5,GAAGCTAGCCAAATGGCGTA,0,2770409
ompRp1,0.16666666666666666,5,5,GAAGCGCATTATGAATTAAG,0,2765981
ompRp1,0.16666666666666666,5,5,GAAGCCAGGGTCCAAACGAT,0,2771003
ompRp1,0.16666666666666666,5,5,GAACTCTCATATACCGAGGG,0,2813204
ompRp1,0.16666666666666666,5,5,GAACGCACATTGAGCTGGCA,0,2802769
ompRp1,0.16666666666666666,5,5,GAACCGCATTGATGCTATAC,0,2802660
ompRp1,0.16666666666666666,5,5,GAACAAATTGGACTGATCGC,0,2818531
ompRp1,0.16666666666666666,5,5,GAAACTGCTTGCAACGGAGC,0,2796906
ompRp1,0.16666666666666666,5,5,GAAACCTAGGCAGAGGGCGT,0,2824042
ompRp1,0.16666666666666666,5,5,GAAACCCCCAACTTGAACGA,0,2821374
ompRp1,0.16666666666666666,5,5,GAAACACCCGCGGCGATCAG,0,2816700
ompRp1,0.16666666666666666,5,5,CTTTTGTATGCCTAGGCTGT,0,2802312
ompRp1,0.16666666666666666,5,5,CTTTTGCCACGGGCGTAGAG,0,2799392
ompRp1,0.16666666666666666,5,5,CTTTTGATACTCCACGGATC,0,2810313
ompRp1,0.16666666666666666,5,5,CTTTTACATCGCTTGCCGAC,0,2798820
ompRp1,0.16666666666666666,5,5,CTTTGTTGATACCACAGTGA,0,2788357
ompRp1,0.16666666666666666,5,5,CTTTCTGGTCATACAAGAGG,0,2798838
ompRp1,0.16666666666666666,5,5,CTTTCGTCCGTGTCATAAGC,0,2787194
ompRp1,0.16666666666666666,5,5,CTTTCCTTCCACCGGCTAAA,0,2767257
ompRp1,0.16666666666666666,5,5,CTTTCACGTGCATCCAGTGA,0,2790080
ompRp1,0.16666666666666666,5,5,CTTTAATGCGCTATATATAC,0,2808992
ompRp1,0.16666666666666666,5,5,CTTGTCTTGCATGTTTTATG,0,2779315
ompRp1,0.16666666666666666,5,5,CTTGTATGACTACCGGACTG,0,2795502
ompRp1,0.16666666666666666,5,5,CTTGCTAAGTTGAGACAGGA,0,2791318
ompRp1,0.16666666666666666,5,5,CTTGCGCATGCCGGGTCGTT,0,2766628
ompRp1,0.16666666666666666,5,5,CTTCTCAAAGCCGTATGGCC,0,2812179
ompRp1,0.16666666666666666,5,5,CTTCATCGCGAGTCTGATGG,0,2820821
ompRp1,0.16666666666666666,5,5,CTTCAAGAAATACTTGCCAA,0,2796650
ompRp1,0.16666666666666666,5,5,CTTAGTTACCACGGGTCAAT,0,2791886
ompRp1,0.16666666666666666,5,5,CTTAGGGGCATTTACCCATG,0,2819371
ompRp1,0.16666666666666666,5,5,CTTACTTGTTCTCTACGGCT,0,2800853
ompRp1,0.16666666666666666,5,5,CTTACCGCAGCCCGGTGTAG,0,2776322
ompRp1,0.16666666666666666,5,5,CTTAATGCAGCACTGTGCCA,0,2807079
ompRp1,0.16666666666666666,5,5,CTTAACAGTGGGTATACCCA,0,2790096
ompRp1,0.16666666666666666,5,5,CTGTTAGAGAGACCCTTGCC,0,2799988
ompRp1,0.16666666666666666,5,5,CTGTGGCGGCAATCTGCAAT,0,2819673
ompRp1,0.16666666666666666,5,5,CTGGTCCCCTACTTCTCATA,0,2779421
ompRp1,0.16666666666666666,5,5,CTGGTAGAGGGTTCTCGGTA,0,2775354
ompRp1,0.16666666666666666,5,5,CTGGGGAACACCCAATTCTC,0,2800383
ompRp1,0.16666666666666666,5,5,CTGGGAAGCATTCAGTTCCC,0,2818295
ompRp1,0.16666666666666666,5,5,CTGGCATTGGTCGTCACGAC,0,2791936
ompRp1,0.16666666666666666,5,5,CTGGCAAGCTTGCCGCATGG,0,2813975
ompRp1,0.16666666666666666,5,5,CTGCAGACACCCGTCAAACC,0,2784811
ompRp1,0.16666666666666666,5,5,CTGCAATCAGGTCCCCATTA,0,2810160
ompRp1,0.16666666666666666,5,5,CTGATGAGAGGGACGGCTTC,0,2781261
ompRp1,0.16666666666666666,5,5,CTGATGACAGAGCAAATCAC,0,2809523
ompRp1,0.16666666666666666,5,5,CTGAGCGTTCTTGAAATCCC,0,2777931
ompRp1,0.16666666666666666,5,5,CTGACATCACGCAGTCCTAC,0,2816463
ompRp1,0.16666666666666666,5,5,CTGAACGCGTTTCCATAGAA,0,2820015
ompRp1,0.16666666666666666,5,5,CTCTTCCTGGCATGCATATA,0,2773923
ompRp1,0.16666666666666666,5,5,CTCTGGCCAAACGGATTTCA,0,2784820
ompRp1,0.16666666666666666,5,5,CTCTGGATGTGGATTAATTT,0,2768649
ompRp1,0.16666666666666666,5,5,CTCTGAAGAGAGCAGAAGAT,0,2805236
ompRp1,0.16666666666666666,5,5,CTCTCGTATGGAGCGGCTAT,0,2769630
ompRp1,0.16666666666666666,5,5,CTCTCGGTAGATTTAGCAAG,0,2820751
ompRp1,0.16666666666666666,5,5,CTCTAGAGGGCCATCGGGAT,0,2795313
ompRp1,0.16666666666666666,5,5,CTCTACTCGGTGAGGTTCCC,0,2772845
ompRp1,0.16666666666666666,5,5,CTCGTGCGGGACTGAATGAC,0,2768869
ompRp1,0.16666666666666666,5,5,CTCGTCGCCGTAGGCATAGG,0,2782775
ompRp1,0.16666666666666666,5,5,CTCGGTTTGATTTTTCCTAC,0,2769247
ompRp1,0.16666666666666666,5,5,CTCGGTAGACCGTCGCAGTG,0,2813669
ompRp1,0.16666666666666666,5,5,CTCGCTCCTGTATGCAGGAT,0,2807845
ompRp1,0.16666666666666666,5,5,CTCGCACGCAGGATACCATT,0,2808474
ompRp1,0.16666666666666666,5,5,CTCGAAGGGGTTTTAGTTCC,0,2806448
ompRp1,0.16666666666666666,5,5,CTCGAAGGAATTAAATCCAT,0,2767741
ompRp1,0.16666666666666666,5,5,CTCCTGCGACCGGTTAAGGC,0,2793900
ompRp1,0.16666666666666666,5,5,CTCCGTGGGGTCTTGTCTGG,0,2815214
ompRp1,0.16666666666666666,5,5,CTCCGTAACTTGCGGCCCTT,0,2800750
ompRp1,0.16666666666666666,5,5,CTCCCCGATTAAAAAGTGCA,0,2766993
ompRp1,0.16666666666666666,5,5,CTCCCAAGGGAGGCTTGGCT,0,2821559
ompRp1,0.16666666666666666,5,5,CTCCATTGACAATAATATGG,0,2780048
ompRp1,0.16666666666666666,5,5,CTCAGTGTAGTAAACGAAGA,0,2808395
ompRp1,0.16666666666666666,5,5,CTCAGAATGTGGTTTACACA,0,2792473
ompRp1,0.16666666666666666,5,5,CTCACCCTTTGTTCATTTAA,0,2772813
ompRp1,0.16666666666666666,5,5,CTCACCAAAGGATGAGCGGG,0,2818338
ompRp1,0.16666666666666666,5,5,CTCAACCGACGGTTCAGGTT,0,2767026
ompRp1,0.16666666666666666,5,5,CTCAAAGAGGATGGAAGCAT,0,2772460
ompRp1,0.16666666666666666,5,5,CTATTCTTAGGAAAGTAGGT,0,2787424
ompRp1,0.16666666666666666,5,5,CTATGCATATAGGACAGATT,0,2804420
ompRp1,0.16666666666666666,5,5,CTATCGCTCCTGCGGTAAGA,0,2773609
ompRp1,0.16666666666666666,5,5,CTATCAACGACACTCGGCTG,0,2799503
ompRp1,0.16666666666666666,5,5,CTATACCTTCCACGCCGTCC,0,2810640
ompRp1,0.16666666666666666,5,5,CTAGTTCTATATTTATAATA,0,2788294
ompRp1,0.16666666666666666,5,5,CTAGGTTAGAGAAGACACAG,0,2771385
ompRp1,0.16666666666666666,5,5,CTAGGCATCACATTGTACAG,0,2801131
ompRp1,0.16666666666666666,5,5,CTAGCGCGCGAGTGGACGCT,0,2776493
ompRp1,0.16666666666666666,5,5,CTAGAGAACGCAGAAACATG,0,2801926
ompRp1,0.16666666666666666,5,5,CTACCTTCTCCCGCGCCCAT,0,2775698
ompRp1,0.16666666666666666,5,5,CTACCTCGCGGTGAGGCTCC,0,2807506
ompRp1,0.16666666666666666,5,5,CTACCGGGCCGTGATTCTAA,0,2811578
ompRp1,0.16666666666666666,5,5,CTACATTCATAGTGAGGTTG,0,2795690
ompRp1,0.16666666666666666,5,5,CTAATAACGTGATACATGAG,0,2820931
ompRp1,0.16666666666666666,5,5,CTAAGTTTAGCCATCTAAGA,0,2775043
ompRp1,0.16666666666666666,5,5,CTAACGGTCCACATTCACCA,0,2799235
ompRp1,0.16666666666666666,5,5,CTAAAGGGGTAAGTCCGCTC,0,2783525
ompRp1,0.16666666666666666,5,5,CTAAAATGCCAAATGGCATG,0,2811869
ompRp1,0.16666666666666666,5,5,CTAAAACTTGACAACGCATG,0,2821324
ompRp1,0.16666666666666666,5,5,CGTTTTGATCTGCGGACCTT,0,2781330
ompRp1,0.16666666666666666,5,5,CGTTGTTACACGGACACTTT,0,2816114
ompRp1,0.16666666666666666,5,5,CGTTGGATCCGGTTTTTCCG,0,2788140
ompRp1,0.16666666666666666,5,5,CGTTGCCATGCTGATTCTGC,0,2783829
ompRp1,0.16666666666666666,5,5,CGTTCGTCTAGGTACGCTTC,0,2765400
ompRp1,0.16666666666666666,5,5,CGTTCCGAACCTGGAGTCCA,0,2776812
ompRp1,0.16666666666666666,5,5,CGTTATGGCTCCTGGCTGAA,0,2792484
ompRp1,0.16666666666666666,5,5,CGTTAGAGGCTTTCGTTGGG,0,2813927
ompRp1,0.16666666666666666,5,5,CGTGGGGTTGTGCTTAATGC,0,2768450
ompRp1,0.16666666666666666,5,5,CGTGATCTTGACTTTTTAGT,0,2786427
ompRp1,0.16666666666666666,5,5,CGTCTAGGGACGTGAGGTAC,0,2819828
ompRp1,0.16666666666666666,5,5,CGTCGGTGCCTATTAGAGGG,0,2818921
ompRp1,0.16666666666666666,5,5,CGTCCTTGGCGGTAAGCGGA,0,2811712
ompRp1,0.16666666666666666,5,5,CGTCCGTACGGATCTCCGCG,0,2771744
ompRp1,0.16666666666666666,5,5,CGTCCATGCGTATTCGGTTT,0,2800060
ompRp1,0.16666666666666666,5,5,CGTCCAGCTTAGTGACGCGT,0,2816137
ompRp1,0.16666666666666666,5,5,CGTCCACAAGTGATCCCGTA,0,2772892
ompRp1,0.16666666666666666,5,5,CGTCCAACTTTCCTAGGGCA,0,2789113
ompRp1,0.16666666666666666,5,5,CGTCAGGGAAGTTTAATACT,0,2817553
ompRp1,0.16666666666666666,5,5,CGTCAGAAGGTATGACGGAT,0,2806011
ompRp1,0.16666666666666666,5,5,CGTATATCGCTATACGTGGT,0,2804978
ompRp1,0.16666666666666666,5,5,CGTAGTAAGACGTTGTTCAC,0,2771642
ompRp1,0.16666666666666666,5,5,CGTAGTAACGGTGAACAATC,0,2793314
ompRp1,0.16666666666666666,5,5,CGTACTGGATGTCCGTGATT,0,2773088
ompRp1,0.16666666666666666,5,5,CGTACGCATACCGGGACATA,0,2805958
ompRp1,0.16666666666666666,5,5,CGTAAGTGACCACCACGAAA,0,2786585
ompRp1,0.16666666666666666,5,5,CGGTGCCTGCTGATACGGTT,0,2791251
ompRp1,0.16666666666666666,5,5,CGGTGCATTCGGAGCTGTAC,0,2801884
ompRp1,0.16666666666666666,5,5,CGGTCAGGTTGCTGGAGACG,0,2790414
ompRp1,0.16666666666666666,5,5,CGGTCACGGGACAAGAAAGT,0,2781093
ompRp1,0.16666666666666666,5,5,CGGTCAATAAATAACTAGCT,0,2805794
ompRp1,0.16666666666666666,5,5,CGGTCAAACGAATTTGATCT,0,2793890
ompRp1,0.16666666666666666,5,5,CGGTAGTAGTATTACTGGGC,0,2774845
ompRp1,0.16666666666666666,5,5,CGGTACATTAGGATTCAACA,0,2790448
ompRp1,0.16666666666666666,5,5,CGGGGATAATGCGATCCAAT,0,2814407
ompRp1,0.16666666666666666,5,5,CGGGCACAAATTCGACCTAT,0,2817367
ompRp1,0.16666666666666666,5,5,CGGCGTAGTCATTGGTAGTA,0,2784262
ompRp1,0.16666666666666666,5,5,CGGCCGCGGCGCACTCTATT,0,2795581
ompRp1,0.16666666666666666,5,5,CGGCCACTAACTCAGCCGTA,0,2788101
ompRp1,0.16666666666666666,5,5,CGGCATGGGACGGAGTAAAG,0,2809586
ompRp1,0.16666666666666666,5,5,CGGCAGTTAGGTCGTCCGCA,0,2820878
ompRp1,0.16666666666666666,5,5,CGGCAGTACGCCGGATCCGT,0,2800305
ompRp1,0.16666666666666666,5,5,CGGCACATTGTATCAGTCTT,0,2780280
ompRp1,0.16666666666666666,5,5,CGGCAAACTCGAACGTATAT,0,2788598
ompRp1,0.16666666666666666,5,5,CGGAGGGCGGTTAAAGATGG,0,2787059
ompRp1,0.16666666666666666,5,5,CGGAGGAGGGCGGCATGTGA,0,2820196
ompRp1,0.16666666666666666,5,5,CGGAGCCACTGGCCATTTTT,0,2797026
ompRp1,0.16666666666666666,5,5,CGGACACATGGCACAGGAGT,0,2818006
ompRp1,0.16666666666666666,5,5,CGGAAGGGCCAGTGGCGCGT,0,2766659
ompRp1,0.16666666666666666,5,5,CGGAACACTGTCCCTTCTCA,0,2816230
ompRp1,0.16666666666666666,5,5,CGCTTGGGCAAAAGACTACT,0,2815678
ompRp1,0.16666666666666666,5,5,CGCTTGCGGCGCGTCGATAG,0,2781592
ompRp1,0.16666666666666666,5,5,CGCTGTATATTAGTAGCATG,0,2775113
ompRp1,0.16666666666666666,5,5,CGCTCGCAGTTGAGTTGATT,0,2781990
ompRp1,0.16666666666666666,5,5,CGCTACGGTTGCAATATTGT,0,2799011
ompRp1,0.16666666666666666,5,5,CGCTACCCTGGCGAGGATAC,0,2803978
ompRp1,0.16666666666666666,5,5,CGCGTTCCCTAGAACCGGTC,0,2818657
ompRp1,0.16666666666666666,5,5,CGCGTGCCAACGTTATTCGT,0,2803562
ompRp1,0.16666666666666666,5,5,CGCGTCAGACATGTCAGATC,0,2817945
ompRp1,0.16666666666666666,5,5,CGCGTAGATCACAAGGCTTT,0,2815551
ompRp1,0.16666666666666666,5,5,CGCGTACTAACGGCTCGCAT,0,2817893
ompRp1,0.16666666666666666,5,5,CGCGGCGGCTCCGGTCGTTA,0,2816838
ompRp1,0.16666666666666666,5,5,CGCGGAACGCTCCTAATGTA,0,2824520
ompRp1,0.16666666666666666,5,5,CGCGCTCCGAATACAAAAGC,0,2788360
ompRp1,0.16666666666666666,5,5,CGCGCCGCTCGGTGGGATGA,0,2791958
ompRp1,0.16666666666666666,5,5,CGCGCATTCATACACTTTTG,0,2773387
ompRp1,0.16666666666666666,5,5,CGCGAATTGGTACTTGCATT,0,2804344
ompRp1,0.16666666666666666,5,5,CGCCTTAATCAGCGTCGAAT,0,2815516
ompRp1,0.16666666666666666,5,5,CGCCCACCGGCCACTGGTAT,0,2769912
ompRp1,0.16666666666666666,5,5,CGCCCACACAAGAATAAAGG,0,2823602
ompRp1,0.16666666666666666,5,5,CGCCATTCTCTACCCCACTA,0,2779405
ompRp1,0.16666666666666666,5,5,CGCCACTATCTTACCGCACA,0,2796256
ompRp1,0.16666666666666666,5,5,CGCCAAGGTATAATCTCAGG,0,2820186
ompRp1,0.16666666666666666,5,5,CGCATAGACAAGGTTTTGCG,0,2809334
ompRp1,0.16666666666666666,5,5,CGCAGTGGTGCAACAACAGT,0,2771921
ompRp1,0.16666666666666666,5,5,CGATGTACCGGCGTGGCATG,0,2769251
ompRp1,0.16666666666666666,5,5,CGATGGGCCATGGCCAAGGT,0,2774530
ompRp1,0.16666666666666666,5,5,CGATCTCCGTTGAAACTATT,0,2815770
ompRp1,0.16666666666666666,5,5,CGATCGGGCGCGTTGAAAGC,0,2783111
ompRp1,0.16666666666666666,5,5,CGATCAGCAAGTCTTAGGTC,0,2775779
ompRp1,0.16666666666666666,5,5,CGATCACTATTTACCTTAGT,0,2786806
ompRp1,0.16666666666666666,5,5,CGATACGAGGTTAGATCACA,0,2797805
ompRp1,0.16666666666666666,5,5,CGAGGAATTAACTAAAAAGC,0,2795185
ompRp1,0.16666666666666666,5,5,CGAGCTGTGTGAAACTTAGC,0,2820221
ompRp1,0.16666666666666666,5,5,CGAGATGGTTACCCAAGAAA,0,2777621
ompRp1,0.16666666666666666,5,5,CGAGATAAGCATTTTCCTGG,0,2812463
ompRp1,0.16666666666666666,5,5,CGACTTCCAGCGTTCGATTG,0,2766072
ompRp1,0.16666666666666666,5,5,CGACGTCTCAATACTAGATC,0,2786982
ompRp1,0.16666666666666666,5,5,CGACGTATACGTTGAGACTA,0,2822874
ompRp1,0.16666666666666666,5,5,CGACAGACGAGCAGCCCGGT,0,2785037
ompRp1,0.16666666666666666,5,5,CGAATTTGGAGCGGAGAAAA,0,2811216
ompRp1,0.16666666666666666,5,5,CGAAGGTCCATCGGCTCGTG,0,2819291
ompRp1,0.16666666666666666,5,5,CGAACATATTAGCGAAGTTC,0,2772447
ompRp1,0.16666666666666666,5,5,CGAAACGTTACCCTGGTAAT,0,2785229
ompRp1,0.16666666666666666,5,5,CCTTTTTCGTTTTAACAGCA,0,2772501
ompRp1,0.16666666666666666,5,5,CCTTAGCACGTATGACGGCA,0,2794500
ompRp1,0.16666666666666666,5,5,CCTGTGTCTCGACGCAGATG,0,2770512
ompRp1,0.16666666666666666,5,5,CCTGTGGCATAGGAGTCGGT,0,2775295
ompRp1,0.16666666666666666,5,5,CCTGGGCCTTGCCGCTGTTA,0,2775899
ompRp1,0.16666666666666666,5,5,CCTGGCATTGTGCGACCGCT,0,2802374
ompRp1,0.16666666666666666,5,5,CCTGCGCATCAACAGGGGCT,0,2809994
ompRp1,0.16666666666666666,5,5,CCTGCCGCAGCTTCAGTGTG,0,2810444
ompRp1,0.16666666666666666,5,5,CCTGAGCAACATAGGCCACA,0,2801642
ompRp1,0.16666666666666666,5,5,CCTGACTGGTTTATATTGGG,0,2805690
ompRp1,0.16666666666666666,5,5,CCTGACTATTCATGGAGGTG,0,2785213
ompRp1,0.16666666666666666,5,5,CCTGAAGACGCGGGTAATAA,0,2812748
ompRp1,0.16666666666666666,5,5,CCTCTTGTATAATGGAACAG,0,2805028
ompRp1,0.16666666666666666,5,5,CCTCTTATGTGTGTCGAGCC,0,2799185
ompRp1,0.16666666666666666,5,5,CCTCTGTGTCATGTAAGGTA,0,2814170
ompRp1,0.16666666666666666,5,5,CCTCTCACAGGGCAGATGGG,0,2787947
ompRp1,0.16666666666666666,5,5,CCTCGCTTTTTTTGACACTG,0,2807409
ompRp1,0.16666666666666666,5,5,CCTCGCCACGGGTTATGACC,0,2810250
ompRp1,0.16666666666666666,5,5,CCTCCGGCCAATGTAGGCAA,0,2808304
ompRp1,0.16666666666666666,5,5,CCTCCATTACAAGTACGCAG,0,2812841
ompRp1,0.16666666666666666,5,5,CCTCAGAACTGTGGAAGAGA,0,2821340
ompRp1,0.16666666666666666,5,5,CCTATTCTGGAGACTGTTGG,0,2808690
ompRp1,0.16666666666666666,5,5,CCTATTCACCTGCGCTTAAA,0,2781019
ompRp1,0.16666666666666666,5,5,CCTATCCCCGAAAATAGATA,0,2821434
ompRp1,0.16666666666666666,5,5,CCTAAGAGTTGCCCTACTCG,0,2782387
ompRp1,0.16666666666666666,5,5,CCGTTTTGCCTTTATGACTG,0,2811176
ompRp1,0.16666666666666666,5,5,CCGTTGAAAACCACTGATGA,0,2778360
ompRp1,0.16666666666666666,5,5,CCGTGGCTTATTGTTATAAG,0,2815242
ompRp1,0.16666666666666666,5,5,CCGTGCTTGACGTTTGGGGA,0,2794102
ompRp1,0.16666666666666666,5,5,CCGTGCATCTTTAGATCATA,0,2768633
ompRp1,0.16666666666666666,5,5,CCGTCTACATATCATTCCAT,0,2823550
ompRp1,0.16666666666666666,5,5,CCGTATGCTCCTGTTAGATA,0,2787746
ompRp1,0.16666666666666666,5,5,CCGTATAAGAGGGCTTTGCG,0,2796386
ompRp1,0.16666666666666666,5,5,CCGTAATTGATGAGTTAACT,0,2798898
ompRp1,0.16666666666666666,5,5,CCGTAATCTAATGGATGGAT,0,2817843
ompRp1,0.16666666666666666,5,5,CCGTAAATCGATGAAGCCTC,0,2786778
ompRp1,0.16666666666666666,5,5,CCGGTTATCTCAATTCTCGA,0,2791233
ompRp1,0.16666666666666666,5,5,CCGGTGTGGACATCAATGTA,0,2810184
ompRp1,0.16666666666666666,5,5,CCGGTATTGACCGTATGCTA,0,2794237
ompRp1,0.16666666666666666,5,5,CCGGTAACCACGTACTCTAC,0,2813582
ompRp1,0.16666666666666666,5,5,CCGGGGAGGTTAACTACTGC,0,2780656
ompRp1,0.16666666666666666,5,5,CCGGGGAGGAAACATGCCTA,0,2807304
ompRp1,0.16666666666666666,5,5,CCGGGCCGCGAGGGGGGAAA,0,2818481
ompRp1,0.16666666666666666,5,5,CCGGCCTGAAACACTTGGCC,0,2820881
ompRp1,0.16666666666666666,5,5,CCGGCCTCGGTGTTTTTGGA,0,2818849
ompRp1,0.16666666666666666,5,5,CCGGCATCCTACTATGAGAC,0,2819869
ompRp1,0.16666666666666666,5,5,CCGCTTTCAGGGCTTTCAGC,0,2817069
ompRp1,0.16666666666666666,5,5,CCGCGTGATCCCTCATGGCC,0,2815419
ompRp1,0.16666666666666666,5,5,CCGCGAGCAAAATTAATAGT,0,2819453
ompRp1,0.16666666666666666,5,5,CCGCCCGCTCAGACTTTGAA,0,2789752
ompRp1,0.16666666666666666,5,5,CCGCCCAATGTTATAAACAG,0,2779604
ompRp1,0.16666666666666666,5,5,CCGCCCAACGACCTTCGGTT,0,2791450
ompRp1,0.16666666666666666,5,5,CCGCACCCTGAATGTGCGCG,0,2805217
ompRp1,0.16666666666666666,5,5,CCGATTCCGACGATTAAGAC,0,2813699
ompRp1,0.16666666666666666,5,5,CCGAATCCTTCCCAGACGCT,0,2776684
ompRp1,0.16666666666666666,5,5,CCGAAGGAACGTTGTATCAT,0,2805546
ompRp1,0.16666666666666666,5,5,CCCTTCATGCCAAGCAGGGG,0,2797720
ompRp1,0.16666666666666666,5,5,CCCGTTCGACGTGTTGCCGG,0,2801544
ompRp1,0.16666666666666666,5,5,CCCGTAAGAGGGTAGCTAGT,0,2794541
ompRp1,0.16666666666666666,5,5,CCCGGGTGCGGCCGAACTTT,0,2766061
ompRp1,0.16666666666666666,5,5,CCCGGGCTCCGTACCTATGA,0,2792336
ompRp1,0.16666666666666666,5,5,CCCGCTATGGTCTCGGGAAG,0,2824029
ompRp1,0.16666666666666666,5,5,CCCGCCTGGGTGACTTGCGA,0,2795049
ompRp1,0.16666666666666666,5,5,CCCGAGCCAATGCCATGAGT,0,2824252
ompRp1,0.16666666666666666,5,5,CCCGAGACCAACTGGGGCAT,0,2823735
ompRp1,0.16666666666666666,5,5,CCCGAATACATAATATAGGA,0,2796524
ompRp1,0.16666666666666666,5,5,CCCCTGGACGGGTACAACGT,0,2820067
ompRp1,0.16666666666666666,5,5,CCCCTAAAGGGACCGCCAAT,0,2801405
ompRp1,0.16666666666666666,5,5,CCCCCCGCAATATGGGGTGT,0,2814030
ompRp1,0.16666666666666666,5,5,CCCCCATTTGAGGTATCAAC,0,2789317
ompRp1,0.16666666666666666,5,5,CCCCAACAGTATCCGAATCT,0,2805292
ompRp1,0.16666666666666666,5,5,CCCATTCCTGACTTGTAGGC,0,2811943
ompRp1,0.16666666666666666,5,5,CCCATGACCTGGTATGTAAA,0,2799538
ompRp1,0.16666666666666666,5,5,CCCATCCACAAACAGAGCCT,0,2785984
ompRp1,0.16666666666666666,5,5,CCCATAGCAATCACTCAAGA,0,2822257
ompRp1,0.16666666666666666,5,5,CCCAAAATTCCAGAGAGTCC,0,2766964
ompRp1,0.16666666666666666,5,5,CCATCATGCAGTGGACCACT,0,2795623
ompRp1,0.16666666666666666,5,5,CCAGTACGTAGTTCATCAAA,0,2792837
ompRp1,0.16666666666666666,5,5,CCAGTACCTGTGTTGGCGCA,0,2773048
ompRp1,0.16666666666666666,5,5,CCAGGGGGACGTGCTTGTTC,0,2778038
ompRp1,0.16666666666666666,5,5,CCAGGGCGAAATGACCTCCC,0,2791030
ompRp1,0.16666666666666666,5,5,CCAGGAATTATCGGTATCGT,0,2777237
ompRp1,0.16666666666666666,5,5,CCAGCAAGTTTCTGAACGAA,0,2821917
ompRp1,0.16666666666666666,5,5,CCACTGGAGTTAGTAATACG,0,2787279
ompRp1,0.16666666666666666,5,5,CCACGGAGCGAATCTGAGAC,0,2774544
ompRp1,0.16666666666666666,5,5,CCACGATCATAGTTGTTGGT,0,2794289
ompRp1,0.16666666666666666,5,5,CCACCGGCAGCAATTGGCTG,0,2774965
ompRp1,0.16666666666666666,5,5,CCACCCCGCCTGACCAACAA,0,2778374
ompRp1,0.16666666666666666,5,5,CCAATCTCCTCAGCGCGAGG,0,2805703
ompRp1,0.16666666666666666,5,5,CCAATAACGCCCGCGCAGCG,0,2805765
ompRp1,0.16666666666666666,5,5,CCAACCTACGCGACTGCCAG,0,2820874
ompRp1,0.16666666666666666,5,5,CCAACAGCACTGAACCAACG,0,2819494
ompRp1,0.16666666666666666,5,5,CCAACACTGATTCTCTATCA,0,2818818
ompRp1,0.16666666666666666,5,5,CCAAAGCTGGTGCCCACAAA,0,2801556
ompRp1,0.16666666666666666,5,5,CCAAAACCTGGGAATCCACA,0,2778129
ompRp1,0.16666666666666666,5,5,CATTTGCTCAGAGTTCAGCA,0,2784199
ompRp1,0.16666666666666666,5,5,CATTACGCACTCTCCATTAA,0,2784223
ompRp1,0.16666666666666666,5,5,CATTAATGGGGACCTGCGAC,0,2814635
ompRp1,0.16666666666666666,5,5,CATGTCTCCTTGCACTTCAA,0,2793253
ompRp1,0.16666666666666666,5,5,CATGGGAGTAACATCTTCAT,0,2821034
ompRp1,0.16666666666666666,5,5,CATCTGTAAACATTGGCTCA,0,2793254
ompRp1,0.16666666666666666,5,5,CATCGTAACCCGGACTTAGA,0,2802002
ompRp1,0.16666666666666666,5,5,CATCGGCCAATGACTGACCA,0,2809007
ompRp1,0.16666666666666666,5,5,CATCGATTGCTAAGGATGGT,0,2766540
ompRp1,0.16666666666666666,5,5,CATCGAAAGCACTGGATTTG,0,2802179
ompRp1,0.16666666666666666,5,5,CATCACAACAGGCTCTCTAT,0,2802069
ompRp1,0.16666666666666666,5,5,CATATGCTAGCTGTCGGGGT,0,2799432
ompRp1,0.16666666666666666,5,5,CATATAAACAGGAAGACAAT,0,2796016
ompRp1,0.16666666666666666,5,5,CATAGTCATCGTTGATTGCA,0,2795258
ompRp1,0.16666666666666666,5,5,CATAGGTATGTACATACCTT,0,2779520
ompRp1,0.16666666666666666,5,5,CATAGATTCATGATTCGTGT,0,2807369
ompRp1,0.16666666666666666,5,5,CATACGCGAACGGTTGTATG,0,2815112
ompRp1,0.16666666666666666,5,5,CATAACATGATAACAGACCA,0,2772088
ompRp1,0.16666666666666666,5,5,CATAAAGGATCATAAAAGAA,0,2821970
ompRp1,0.16666666666666666,5,5,CAGTTGCTTGTCTATGTTTT,0,2784451
ompRp1,0.16666666666666666,5,5,CAGTGTGGTTCCTTAACAGA,0,2787994
ompRp1,0.16666666666666666,5,5,CAGTGGGACTAGCGGGTACA,0,2824493
ompRp1,0.16666666666666666,5,5,CAGTCGGGGTACCTTTCTAG,0,2809403
ompRp1,0.16666666666666666,5,5,CAGTCGCATAATGATTTGCG,0,2775547
ompRp1,0.16666666666666666,5,5,CAGTCGAATGCGACGCACGT,0,2777108
ompRp1,0.16666666666666666,5,5,CAGTCCTGAATGGATTGGGA,0,2806657
ompRp1,0.16666666666666666,5,5,CAGGTCGATCTTTTAACGGA,0,2789152
ompRp1,0.16666666666666666,5,5,CAGGTCCACAAATATAAGTA,0,2784073
ompRp1,0.16666666666666666,5,5,CAGGTCAACGCGCGGGGCCC,0,2800552
ompRp1,0.16666666666666666,5,5,CAGGGTGGCTACATCACCTT,0,2765940
ompRp1,0.16666666666666666,5,5,CAGGGCTGGCCGCGCGGCAG,0,2786667
ompRp1,0.16666666666666666,5,5,CAGGGATGACAGAGTCGCAG,0,2821133
ompRp1,0.16666666666666666,5,5,CAGCCGGAACCGTCGGATCG,0,2820542
ompRp1,0.16666666666666666,5,5,CAGCCGCCTTAGAGGCGGTA,0,2793262
ompRp1,0.16666666666666666,5,5,CAGCATGCCAGCTCACTCGC,0,2808224
ompRp1,0.16666666666666666,5,5,CAGCACGACTCCCCTAACGC,0,2788078
ompRp1,0.16666666666666666,5,5,CAGCACCCCCCATCTGCTTT,0,2781529
ompRp1,0.16666666666666666,5,5,CAGATCACGGACAGGACCGG,0,2765740
ompRp1,0.16666666666666666,5,5,CAGAGGCTTTCAATTCAAGC,0,2801308
ompRp1,0.16666666666666666,5,5,CAGAGCGCACGGTTGGCCCT,0,2778658
ompRp1,0.16666666666666666,5,5,CAGACGCGGATAACAGGGAC,0,2812505
ompRp1,0.16666666666666666,5,5,CAGACGATGCCGGTATGGGG,0,2771772
ompRp1,0.16666666666666666,5,5,CACTTCTCTGAGATCGGGTT,0,2773839
ompRp1,0.16666666666666666,5,5,CACTTCCACAGCTAGAGTGT,0,2780589
ompRp1,0.16666666666666666,5,5,CACGTAGTGTTGCCGGCTCG,0,2804463
ompRp1,0.16666666666666666,5,5,CACGGTAGGTGGAATCGTGC,0,2797683
ompRp1,0.16666666666666666,5,5,CACGCTGTCTGCAACTTGCC,0,2803089
ompRp1,0.16666666666666666,5,5,CACGACTATATTTCCCATCG,0,2767985
ompRp1,0.16666666666666666,5,5,CACGAACGAGAGGGATCTCA,0,2781617
ompRp1,0.16666666666666666,5,5,CACCGTTCATCTGAGATGGT,0,2794736
ompRp1,0.16666666666666666,5,5,CACATTCTTTCGAGACTAAT,0,2822623
ompRp1,0.16666666666666666,5,5,CACATTAAACGGACACCCCT,0,2782039
ompRp1,0.16666666666666666,5,5,CACAGTCACATTATGCGTCC,0,2809172
ompRp1,0.16666666666666666,5,5,CACAGGCTACGTAGATACTT,0,2772655
ompRp1,0.16666666666666666,5,5,CACAAACGGTACCCATAGGA,0,2766731
ompRp1,0.16666666666666666,5,5,CAATTGTTACGTGGCTCCCT,0,2786240
ompRp1,0.16666666666666666,5,5,CAATCGTCCGCGCAGCGTTC,0,2807292
ompRp1,0.16666666666666666,5,5,CAAGTTATACTAAGAGCGCA,0,2813059
ompRp1,0.16666666666666666,5,5,CAAGCTGGTATCACTCCATA,0,2805650
ompRp1,0.16666666666666666,5,5,CAAGCCTGTGTCCTGGATGT,0,2822163
ompRp1,0.16666666666666666,5,5,CAAGCAATGTTTACTTGCGT,0,2811672
ompRp1,0.16666666666666666,5,5,CAACTGGGGTGTATGGGCCT,0,2801376
ompRp1,0.16666666666666666,5,5,CAACGTCGGGCTAGCTCTAG,0,2800585
ompRp1,0.16666666666666666,5,5,CAACCTTAGTCTTCAGCATG,0,2785215
ompRp1,0.16666666666666666,5,5,CAACCATAATTCTCGATTAC,0,2819433
ompRp1,0.16666666666666666,5,5,CAACATAGAAGCGCCCTCGG,0,2785396
ompRp1,0.16666666666666666,5,5,CAACACAAATCCGGGCGCCT,0,2784612
ompRp1,0.16666666666666666,5,5,CAACAACCTTAATTAGTCAT,0,2822050
ompRp1,0.16666666666666666,5,5,CAACAAATAAGTCCGTGGAA,0,2773103
ompRp1,0.16666666666666666,5,5,CAAATTCTACGATTGTACGT,0,2805060
ompRp1,0.16666666666666666,5,5,CAAATGTTAGAATATCCCTT,0,2811467
ompRp1,0.16666666666666666,5,5,ATTTTGTGGTATTCGCTGAA,0,2804754
ompRp1,0.16666666666666666,5,5,ATTTGACTAGGTAACGGAGT,0,2765699
ompRp1,0.16666666666666666,5,5,ATTTATTGTAACATTCTATC,0,2799693
ompRp1,0.16666666666666666,5,5,ATTGTGACGATCGGGCTGCA,0,2796860
ompRp1,0.16666666666666666,5,5,ATTGTAATCATATCACTGGA,0,2810113
ompRp1,0.16666666666666666,5,5,ATTGGGTTGTTTCGGCCGTG,0,2777562
ompRp1,0.16666666666666666,5,5,ATTGGCACGGGTAAACGGAT,0,2808907
ompRp1,0.16666666666666666,5,5,ATTCTGTTAACGCGATTCAT,0,2813098
ompRp1,0.16666666666666666,5,5,ATTCTGGTTTTGACGCGGTT,0,2769900
ompRp1,0.16666666666666666,5,5,ATTCTATCGCCGCCAGGGGA,0,2781689
ompRp1,0.16666666666666666,5,5,ATTCTAGTCGATGCATACTC,0,2797766
ompRp1,0.16666666666666666,5,5,ATTCGTTAGATTGGTGGTCT,0,2810271
ompRp1,0.16666666666666666,5,5,ATTCGTGCGGACATTGATTA,0,2814091
ompRp1,0.16666666666666666,5,5,ATTCGTCCATCATGCAGCAA,0,2779955
ompRp1,0.16666666666666666,5,5,ATTCGTACAAGACGGAGCGC,0,2799231
ompRp1,0.16666666666666666,5,5,ATTCGGCAGCGCCTCTAGTC,0,2766225
ompRp1,0.16666666666666666,5,5,ATTCGCGCGACATCGGCTAA,0,2824469
ompRp1,0.16666666666666666,5,5,ATTCAATCGGAAGGTTCCTG,0,2788614
ompRp1,0.16666666666666666,5,5,ATTCAAGACCGTCGAATGTT,0,2799403
ompRp1,0.16666666666666666,5,5,ATTATATCCGGCGACCTCCA,0,2782897
ompRp1,0.16666666666666666,5,5,ATTATAGATGTGAGAGTTAT,0,2769433
ompRp1,0.16666666666666666,5,5,ATTAGCGTATACATCGTGCT,0,2816452
ompRp1,0.16666666666666666,5,5,ATTACCTGACCCCCAAAAGT,0,2778986
ompRp1,0.16666666666666666,5,5,ATTACAGGAAGCAACGAAGT,0,2811896
ompRp1,0.16666666666666666,5,5,ATTAACGCTGCACCACGGCA,0,2817482
ompRp1,0.16666666666666666,5,5,ATGTTTTCGAAGCAGGATAG,0,2813247
ompRp1,0.16666666666666666,5,5,ATGTCTGTTTTAACTCGTTA,0,2785183
ompRp1,0.16666666666666666,5,5,ATGTCACCATGTGCGGTACT,0,2815264
ompRp1,0.16666666666666666,5,5,ATGTAATCATCACACGGACA,0,2819531
ompRp1,0.16666666666666666,5,5,ATGGTTCTGGTAGCGTAAAC,0,2824334
ompRp1,0.16666666666666666,5,5,ATGGTATCGGGGACGCTAAC,0,2772768
ompRp1,0.16666666666666666,5,5,ATGGTAGATTTGCATGGCCT,0,2801620
ompRp1,0.16666666666666666,5,5,ATGGTACCTTGGTGTGACAT,0,2776180
ompRp1,0.16666666666666666,5,5,ATGGCAACGCTGTGAGAGTA,0,2798663
ompRp1,0.16666666666666666,5,5,ATGGCAAACGGATGCAAAGG,0,2810094
ompRp1,0.16666666666666666,5,5,ATGGACGATTGTCATTTAGA,0,2789511
ompRp1,0.16666666666666666,5,5,ATGCTTTGAGATAGGAAAAG,0,2818194
ompRp1,0.16666666666666666,5,5,ATGCTATCTTATGCCCCGGA,0,2806470
ompRp1,0.16666666666666666,5,5,ATGCGCTCCAGGGTACCAGA,0,2817001
ompRp1,0.16666666666666666,5,5,ATGCCACCCCGCTCGACCCA,0,2800948
ompRp1,0.16666666666666666,5,5,ATGCAAGTGGACATCAGTCT,0,2816716
ompRp1,0.16666666666666666,5,5,ATGATCCGGGATGCAAGCTC,0,2766468
ompRp1,0.16666666666666666,5,5,ATGAGGTGGATGCCAAAGTT,0,2804497
ompRp1,0.16666666666666666,5,5,ATGACGTGGCCATCGTCATA,0,2810021
ompRp1,0.16666666666666666,5,5,ATGACACCAGCCCAGCATCA,0,2769905
ompRp1,0.16666666666666666,5,5,ATGAATTAGAGATGGTAGAC,0,2822041
ompRp1,0.16666666666666666,5,5,ATGAAGTGTTAGTTCTCGCC,0,2798356
ompRp1,0.16666666666666666,5,5,ATCTTGGGAATTCTCCTTTT,0,2773817
ompRp1,0.16666666666666666,5,5,ATCTTACATTATTGCTCAAA,0,2786862
ompRp1,0.16666666666666666,5,5,ATCTGCGGAGACTTCGCTTG,0,2817574
ompRp1,0.16666666666666666,5,5,ATCTCTACTTTGGAGTGTAA,0,2774661
ompRp1,0.16666666666666666,5,5,ATCTATATCGCACCGGTCTA,0,2772222
ompRp1,0.16666666666666666,5,5,ATCTAGTAGAGAGCCACATC,0,2809350
ompRp1,0.16666666666666666,5,5,ATCTAACACGTGTAGCGACC,0,2820845
ompRp1,0.16666666666666666,5,5,ATCGTTGGCCCCGGCTCCAT,0,2820130
ompRp1,0.16666666666666666,5,5,ATCGGGTGAGATTCCTTTAC,0,2814181
ompRp1,0.16666666666666666,5,5,ATCGCCTACGGGCGGTCGCT,0,2785480
ompRp1,0.16666666666666666,5,5,ATCGACGCACGTGTAGTCTC,0,2788349
ompRp1,0.16666666666666666,5,5,ATCGACCTCGGTCCCAGGGT,0,2805207
ompRp1,0.16666666666666666,5,5,ATCCGTGTATAGGTATCCCT,0,2798993
ompRp1,0.16666666666666666,5,5,ATCCGAGGTGACGATGGGAA,0,2805728
ompRp1,0.16666666666666666,5,5,ATCCCCGGTCCGGTTAGCCG,0,2807725
ompRp1,0.16666666666666666,5,5,ATCCAACCGCGCATATGCAA,0,2790275
ompRp1,0.16666666666666666,5,5,ATCACGCGAAATTCGGTTAA,0,2797666
ompRp1,0.16666666666666666,5,5,ATCACGAAGAAGCGATTTTC,0,2773289
ompRp1,0.16666666666666666,5,5,ATCAATCGGCCACCATCACG,0,2766862
ompRp1,0.16666666666666666,5,5,ATCAAGTTATCTGGTGATGG,0,2819883
ompRp1,0.16666666666666666,5,5,ATCAAAAGACCGTAAGACTT,0,2795218
ompRp1,0.16666666666666666,5,5,ATATTGCTAGAACTATACTT,0,2795247
ompRp1,0.16666666666666666,5,5,ATATTCGAGCGACGGACAGT,0,2780532
ompRp1,0.16666666666666666,5,5,ATATTATGCACAAATCTACT,0,2814504
ompRp1,0.16666666666666666,5,5,ATATGACAACCCGAGAGCAA,0,2809041
ompRp1,0.16666666666666666,5,5,ATATCTGCAGTAGGCCAGGG,0,2786107
ompRp1,0.16666666666666666,5,5,ATATCGGGTTCCACTTGTTT,0,2770827
ompRp1,0.16666666666666666,5,5,ATATCACGTTGTGCCACCAC,0,2782504
ompRp1,0.16666666666666666,5,5,ATATCACGGCATAAGCGTTG,0,2824715
ompRp1,0.16666666666666666,5,5,ATATAGAATGAATGTGACAC,0,2768310
ompRp1,0.16666666666666666,5,5,ATAGTGCTCCGGGTTGACCT,0,2787198
ompRp1,0.16666666666666666,5,5,ATAGGTCGTGGTGCCGGTAT,0,2810398
ompRp1,0.16666666666666666,5,5,ATAGGGTGTGTGTCGCCCCG,0,2782566
ompRp1,0.16666666666666666,5,5,ATAGGCCGGCGATTAGACCA,0,2778144
ompRp1,0.16666666666666666,5,5,ATAGGATGGGCTAAACAATT,0,2800661
ompRp1,0.16666666666666666,5,5,ATACGTCCGCGCAACGTGCT,0,2796748
ompRp1,0.16666666666666666,5,5,ATACGTCCCGAAATGCAACT,0,2788471
ompRp1,0.16666666666666666,5,5,ATACCTTGTTCTCCGATGTG,0,2779880
ompRp1,0.16666666666666666,5,5,ATACCGCGGAAAGCACACGC,0,2774738
ompRp1,0.16666666666666666,5,5,ATACATCCATCCGAGTTTTC,0,2769483
ompRp1,0.16666666666666666,5,5,ATACAGTTCATCTGGTATCA,0,2789804
ompRp1,0.16666666666666666,5,5,ATACACAGCCTTCATCGAGG,0,2824283
ompRp1,0.16666666666666666,5,5,ATACAAAACTTCTTCTGTTC,0,2788345
ompRp1,0.16666666666666666,5,5,ATAATTGACCTCCACAATGC,0,2819348
ompRp1,0.16666666666666666,5,5,ATAATACGTGCATTGCATGA,0,2785110
ompRp1,0.16666666666666666,5,5,ATAAGCCGCCCCCACACTGT,0,2780171
ompRp1,0.16666666666666666,5,5,ATAAGAGCGCGAAAGCCCGT,0,2771917
ompRp1,0.16666666666666666,5,5,ATAAGACGAATCCCGTGTCA,0,2800805
ompRp1,0.16666666666666666,5,5,ATAACTGTGTGTACAGCCAG,0,2792958
ompRp1,0.16666666666666666,5,5,ATAAAATCCCATCTTACGGA,0,2805597
ompRp1,0.16666666666666666,5,5,AGTTTCGCGATCGCGTACGG,0,2823171
ompRp1,0.16666666666666666,5,5,AGTTTCAAGGGCAGCGTACG,0,2767499
ompRp1,0.16666666666666666,5,5,AGTTGTTGCGGGACAACAAA,0,2810637
ompRp1,0.16666666666666666,5,5,AGTTGTCAAGCGCGCTGTCA,0,2782888
ompRp1,0.16666666666666666,5,5,AGTTCTTGCGGCCTTCTATA,0,2770052
ompRp1,0.16666666666666666,5,5,AGTTAAGTGCGCGTACGGAC,0,2809369
ompRp1,0.16666666666666666,5,5,AGTGGTGGTAGTTGGTTCTT,0,2766418
ompRp1,0.16666666666666666,5,5,AGTGGTATTAGGCGAAAGGC,0,2817798
ompRp1,0.16666666666666666,5,5,AGTGGTAGTAAGCGCAAAAG,0,2779733
ompRp1,0.16666666666666666,5,5,AGTGGCGACGTTTAAGCCTA,0,2812088
ompRp1,0.16666666666666666,5,5,AGTGATGCGCGAGCTGCTAG,0,2768423
ompRp1,0.16666666666666666,5,5,AGTGAACGGGTGGCACTCGA,0,2807235
ompRp1,0.16666666666666666,5,5,AGTCGGTACAGGTGAACGTA,0,2771718
ompRp1,0.16666666666666666,5,5,AGTCGGGGGGTATTAGCGAA,0,2789350
ompRp1,0.16666666666666666,5,5,AGTCAGGTTCTCCATGTTAT,0,2800918
ompRp1,0.16666666666666666,5,5,AGTCAACTACCCAGCTATCA,0,2817670
ompRp1,0.16666666666666666,5,5,AGTACCATTCTCCGGCTGTA,0,2775245
ompRp1,0.16666666666666666,5,5,AGTAAGCCCTTCGGACTTCG,0,2769013
ompRp1,0.16666666666666666,5,5,AGGTTCGCTGATCGACGTCA,0,2796266
ompRp1,0.16666666666666666,5,5,AGGTTAACTTATATCATCAC,0,2818561
ompRp1,0.16666666666666666,5,5,AGGTGGTGCATGATACTACA,0,2770484
ompRp1,0.16666666666666666,5,5,AGGTGGAGACCTTGTTAGGC,0,2813874
ompRp1,0.16666666666666666,5,5,AGGTGATGCACATGGTAGAA,0,2808194
ompRp1,0.16666666666666666,5,5,AGGTCTTCCGCTCCCGAGAC,0,2809554
ompRp1,0.16666666666666666,5,5,AGGTAGGACGCCCCCCATAG,0,2787313
ompRp1,0.16666666666666666,5,5,AGGGTCGGACTAACCTCCAT,0,2770975
ompRp1,0.16666666666666666,5,5,AGGGTCCCTTTTCTCGAATT,0,2789015
ompRp1,0.16666666666666666,5,5,AGGGCTGAACGAAACTGCCG,0,2802348
ompRp1,0.16666666666666666,5,5,AGGGCGGGACCTGACTCACA,0,2786872
ompRp1,0.16666666666666666,5,5,AGGCTAAAGACGGGTCCAAT,0,2823658
ompRp1,0.16666666666666666,5,5,AGGCGAGCTTAACCGGCGAC,0,2771056
ompRp1,0.16666666666666666,5,5,AGGCGACAAACCGTTAAAGC,0,2793350
ompRp1,0.16666666666666666,5,5,AGGCGAATTAAACCGCTGGG,0,2776372
ompRp1,0.16666666666666666,5,5,AGGCATACCATATACTCAGT,0,2779686
ompRp1,0.16666666666666666,5,5,AGGATTTGGCTTGATGTTAC,0,2771724
ompRp1,0.16666666666666666,5,5,AGGAGCAGTGGCATTCAAGA,0,2787778
ompRp1,0.16666666666666666,5,5,AGGACTGGGCGGCGCACTAA,0,2782653
ompRp1,0.16666666666666666,5,5,AGGACGGGTGGCCTGGCTCG,0,2769623
ompRp1,0.16666666666666666,5,5,AGGACGGCACTCTATTTAAA,0,2766944
ompRp1,0.16666666666666666,5,5,AGCTTTGTTGTGAGCTAGCT,0,2804375
ompRp1,0.16666666666666666,5,5,AGCTTGGCATCAACCTATAA,0,2801484
ompRp1,0.16666666666666666,5,5,AGCTTGCAGTGCATGGACAC,0,2803318
ompRp1,0.16666666666666666,5,5,AGCTTCAAGCAAGTCGTCGC,0,2812929
ompRp1,0.16666666666666666,5,5,AGCTTAGAAAATGTCCCAGG,0,2796972
ompRp1,0.16666666666666666,5,5,AGCTGGTGAAACCGACGGCC,0,2782397
ompRp1,0.16666666666666666,5,5,AGCTAAGTAATCTTCTGATC,0,2807892
ompRp1,0.16666666666666666,5,5,AGCTAAATGCATTGTGTCTG,0,2765262
ompRp1,0.16666666666666666,5,5,AGCGGGATTAACGGGAAAGG,0,2784360
ompRp1,0.16666666666666666,5,5,AGCGGATTGCAGTTAGGATC,0,2789136
ompRp1,0.16666666666666666,5,5,AGCGGACGCTTCGACGATTC,0,2775213
ompRp1,0.16666666666666666,5,5,AGCCTGACCACGTGTTAACC,0,2812823
ompRp1,0.16666666666666666,5,5,AGCCTACTCCATCCAACAAT,0,2768207
ompRp1,0.16666666666666666,5,5,AGCCGGTTTGACGCGTATAC,0,2799595
ompRp1,0.16666666666666666,5,5,AGCCGGCGCGGCTTAAAGCT,0,2785872
ompRp1,0.16666666666666666,5,5,AGCCGGATAAGCGACTTTAT,0,2801036
ompRp1,0.16666666666666666,5,5,AGCCGAGCCATATCCCCACC,0,2785636
ompRp1,0.16666666666666666,5,5,AGCCCGGTGAAAGCTAACAT,0,2816061
ompRp1,0.16666666666666666,5,5,AGCCAAATTGATGTATGGGG,0,2787082
ompRp1,0.16666666666666666,5,5,AGCACTCAGAAAAATGAGAC,0,2769406
ompRp1,0.16666666666666666,5,5,AGCACCCTCGACCACTTCAG,0,2790935
ompRp1,0.16666666666666666,5,5,AGCACCATAGGCAGAGAACC,0,2813457
ompRp1,0.16666666666666666,5,5,AGCACATTTAAGGACTCGGA,0,2770190
ompRp1,0.16666666666666666,5,5,AGCACACTCTCTTTCCGGTC,0,2768733
ompRp1,0.16666666666666666,5,5,AGATTGGCCACGAGTTAGGG,0,2779884
ompRp1,0.16666666666666666,5,5,AGATGAATCTGGCCCGTTTT,0,2787065
ompRp1,0.16666666666666666,5,5,AGATCGATCGGAGTCTATCC,0,2822954
ompRp1,0.16666666666666666,5,5,AGATACCATTATACGAACGC,0,2768082
ompRp1,0.16666666666666666,5,5,AGAGTGGGGCGAGATCTCGA,0,2781840
ompRp1,0.16666666666666666,5,5,AGAGTCTGCTAAGTCTTGCA,0,2797146
ompRp1,0.16666666666666666,5,5,AGAGTATGTCCGGGCTCCAG,0,2799083
ompRp1,0.16666666666666666,5,5,AGAGGTTTGAGTTACCGACT,0,2815552
ompRp1,0.16666666666666666,5,5,AGAGCATATATCCGATACTG,0,2785107
ompRp1,0.16666666666666666,5,5,AGACGGGTTGTGGTGACATG,0,2766599
ompRp1,0.16666666666666666,5,5,AGACCTCGGAGTTATGTGAC,0,2811160
ompRp1,0.16666666666666666,5,5,AGACCTCCAAATACCAGCAA,0,2811740
ompRp1,0.16666666666666666,5,5,AGACCGAAATGGGCAGACTT,0,2786843
ompRp1,0.16666666666666666,5,5,AGACCCAAGCCGGAACTAGA,0,2783869
ompRp1,0.16666666666666666,5,5,AGACACCATGACTGACTTTT,0,2824518
ompRp1,0.16666666666666666,5,5,AGAATTACAAATGACTTAAT,0,2801959
ompRp1,0.16666666666666666,5,5,AGAACTGGGCAAGCTGGGAC,0,2768367
ompRp1,0.16666666666666666,5,5,AGAACACAATGCGACAGTCG,0,2786391
ompRp1,0.16666666666666666,5,5,ACTTGCGCGCATCTATTGTC,0,2813536
ompRp1,0.16666666666666666,5,5,ACTTAGTAGGTGGGAACAAT,0,2784882
ompRp1,0.16666666666666666,5,5,ACTGGTAGTCATTCGTACGT,0,2774678
ompRp1,0.16666666666666666,5,5,ACTGGCGATTAGTGTCTTCC,0,2791314
ompRp1,0.16666666666666666,5,5,ACTGCCTGGGTAGGGAAATC,0,2794016
ompRp1,0.16666666666666666,5,5,ACTGCATACAGCTCCTTTTT,0,2776662
ompRp1,0.16666666666666666,5,5,ACTCTTGGGTAAAAAACATC,0,2816085
ompRp1,0.16666666666666666,5,5,ACTCGGACCTACCCATCTCA,0,2817685
ompRp1,0.16666666666666666,5,5,ACTCAGTATACAGTGCAATG,0,2777434
ompRp1,0.16666666666666666,5,5,ACTCACTGAGATATTCAGTC,0,2788145
ompRp1,0.16666666666666666,5,5,ACTATTACTTACTGACGTAA,0,2821167
ompRp1,0.16666666666666666,5,5,ACTAGCGTTAGGAGATCTTA,0,2766502
ompRp1,0.16666666666666666,5,5,ACTACGTGATTCACTGAGTT,0,2774988
ompRp1,0.16666666666666666,5,5,ACGTGTAGTACGTTCGTCTC,0,2781052
ompRp1,0.16666666666666666,5,5,ACGTCAAGTCAATTGCATTG,0,2786053
ompRp1,0.16666666666666666,5,5,ACGTATGGCGCCTAAGAAAT,0,2803386
ompRp1,0.16666666666666666,5,5,ACGGTGTATTCCTCGATCAA,0,2790710
ompRp1,0.16666666666666666,5,5,ACGGGATCTAGGGTCGCCGG,0,2778253
ompRp1,0.16666666666666666,5,5,ACGGGACACTGCTATCACTT,0,2796111
ompRp1,0.16666666666666666,5,5,ACGGCTTGTTTGGAGGTTGT,0,2803571
ompRp1,0.16666666666666666,5,5,ACGGCCCGTTGGTAGGAAGA,0,2806803
ompRp1,0.16666666666666666,5,5,ACGGCAGTGCAGGCAGCGCT,0,2784196
ompRp1,0.16666666666666666,5,5,ACGCTTTTTGAACTGCCCTT,0,2774350
ompRp1,0.16666666666666666,5,5,ACGCGTGGTCACCTCGCCTT,0,2803465
ompRp1,0.16666666666666666,5,5,ACGCGTGACTTGTAAGACTC,0,2812431
ompRp1,0.16666666666666666,5,5,ACGCCCTATTAAGATGAGGT,0,2803693
ompRp1,0.16666666666666666,5,5,ACGCAAAGGTCATTACTGGT,0,2809213
ompRp1,0.16666666666666666,5,5,ACGATATCCGAACACTAATT,0,2766785
ompRp1,0.16666666666666666,5,5,ACGAGATACTGCGCGTAGCC,0,2770917
ompRp1,0.16666666666666666,5,5,ACGACTATACCTCGTCTATC,0,2784901
ompRp1,0.16666666666666666,5,5,ACGAAAGGTGGGTAATACCA,0,2773047
ompRp1,0.16666666666666666,5,5,ACCTTAGCGCTTCTGTTCCA,0,2797350
ompRp1,0.16666666666666666,5,5,ACCTGTTTAAGACATCGCAT,0,2805943
ompRp1,0.16666666666666666,5,5,ACCTGGTTCATAATGCTGAA,0,2804031
ompRp1,0.16666666666666666,5,5,ACCTCTCTTCCGGGAGTTCT,0,2796100
ompRp1,0.16666666666666666,5,5,ACCTCCGTGAGTTAGTGGGT,0,2786940
ompRp1,0.16666666666666666,5,5,ACCGTCGATAATAGGTTAGG,0,2774602
ompRp1,0.16666666666666666,5,5,ACCGTAGATGAGCGGACGCT,0,2791324
ompRp1,0.16666666666666666,5,5,ACCGTACACGTTCCACGTGA,0,2781111
ompRp1,0.16666666666666666,5,5,ACCGGTATCCCGTGCTTAGA,0,2788431
ompRp1,0.16666666666666666,5,5,ACCGGTATACGCGTTTCGAG,0,2795164
ompRp1,0.16666666666666666,5,5,ACCGGGGCACTGATTAACCG,0,2822816
ompRp1,0.16666666666666666,5,5,ACCGGAGTTGGTGGTACAGG,0,2809855
ompRp1,0.16666666666666666,5,5,ACCCTAGGGGGGCGATCCTT,0,2791391
ompRp1,0.16666666666666666,5,5,ACCCGCATACAAAGAGCCCG,0,2810767
ompRp1,0.16666666666666666,5,5,ACCCAGGCCTGAGTTCTGCG,0,2767903
ompRp1,0.16666666666666666,5,5,ACCATCAACCTGCTGATGAT,0,2788244
ompRp1,0.16666666666666666,5,5,ACCATACGGTAGCCCCATTC,0,2793953
ompRp1,0.16666666666666666,5,5,ACATTTGTAGCCCCTGGTCA,0,2810847
ompRp1,0.16666666666666666,5,5,ACATGATTACAAGATATATG,0,2793265
ompRp1,0.16666666666666666,5,5,ACATCCGATATGGCCCAGAC,0,2819757
ompRp1,0.16666666666666666,5,5,ACAGTTGTAGCCACCGAAGA,0,2783090
ompRp1,0.16666666666666666,5,5,ACAGATGGTAGTGCAGGTAA,0,2774838
ompRp1,0.16666666666666666,5,5,ACAGACGAACATGTGATGAA,0,2798399
ompRp1,0.16666666666666666,5,5,ACACTTTAGAACTTAGGATG,0,2818231
ompRp1,0.16666666666666666,5,5,ACACGCGGGCACTAGCCAAT,0,2824666
ompRp1,0.16666666666666666,5,5,ACACCGGACAAGAATAAAAA,0,2816032
ompRp1,0.16666666666666666,5,5,ACACATCAGAGCCGAGTCCT,0,2817169
ompRp1,0.16666666666666666,5,5,ACACAAAAATAGGCCAATAT,0,2767518
ompRp1,0.16666666666666666,5,5,ACAATGTGTGCTACGCGTGC,0,2813409
ompRp1,0.16666666666666666,5,5,ACAATCTGGACTAGATGGAA,0,2788000
ompRp1,0.16666666666666666,5,5,ACAATATCACCGACAGCACG,0,2787119
ompRp1,0.16666666666666666,5,5,ACAAGCTATGATTACAGACA,0,2814343
ompRp1,0.16666666666666666,5,5,ACAAACGGCGTGATAGCGCA,0,2803191
ompRp1,0.16666666666666666,5,5,AATTTTTCTCGCATGATCCA,0,2784103
ompRp1,0.16666666666666666,5,5,AATTTTATTCCTGCTAAAAT,0,2783067
ompRp1,0.16666666666666666,5,5,AATTTCCCTAGCAGGAATAC,0,2818267
ompRp1,0.16666666666666666,5,5,AATTTACTGTCAGAGGATTA,0,2768453
ompRp1,0.16666666666666666,5,5,AATTGTTCTTCGCTATCCGA,0,2803898
ompRp1,0.16666666666666666,5,5,AATTAGTACTCTCGATGTCT,0,2790783
ompRp1,0.16666666666666666,5,5,AATTACCGTCACACTCGCAC,0,2776343
ompRp1,0.16666666666666666,5,5,AATGTCCTGTTAAGCACTAC,0,2802431
ompRp1,0.16666666666666666,5,5,AATGGTTTTGCCCACCGAGC,0,2805337
ompRp1,0.16666666666666666,5,5,AATGGGGCGCGTCAGTCAAG,0,2816415
ompRp1,0.16666666666666666,5,5,AATGGGACGAACCGCCAGAG,0,2790446
ompRp1,0.16666666666666666,5,5,AATGGAGAGAGCCTCTGCAT,0,2819370
ompRp1,0.16666666666666666,5,5,AATGCGGCGCCTGTGTAATG,0,2791396
ompRp1,0.16666666666666666,5,5,AATCATGCGCTTACGCGGCG,0,2803681
ompRp1,0.16666666666666666,5,5,AATATTGCAGTGGAGCGGTA,0,2822878
ompRp1,0.16666666666666666,5,5,AATATGGGACGCGGGACATC,0,2769781
ompRp1,0.16666666666666666,5,5,AATATCACTGCCCGTCATCG,0,2824446
ompRp1,0.16666666666666666,5,5,AATACTCTTCATTCGCGGCT,0,2797145
ompRp1,0.16666666666666666,5,5,AATAACGGACATGCAAGCCA,0,2778482
ompRp1,0.16666666666666666,5,5,AAGTTGAACGACACCTTCCT,0,2799060
ompRp1,0.16666666666666666,5,5,AAGTTCAGGCTTCTAGCTGC,0,2818640
ompRp1,0.16666666666666666,5,5,AAGTGGATATGGTGCGACCA,0,2782614
ompRp1,0.16666666666666666,5,5,AAGTCCGCAGAGTACCGGGC,0,2776496
ompRp1,0.16666666666666666,5,5,AAGTCCAGCATTTCATAGTT,0,2777178
ompRp1,0.16666666666666666,5,5,AAGTATCTGGTGGCAAGTTC,0,2785891
ompRp1,0.16666666666666666,5,5,AAGGTTTACTCAAGGAGTAG,0,2789748
ompRp1,0.16666666666666666,5,5,AAGGGGGCTGACTCGACGGT,0,2790164
ompRp1,0.16666666666666666,5,5,AAGGGGCTGCATCGGTGTAC,0,2777267
ompRp1,0.16666666666666666,5,5,AAGGGCACACGACCACGACT,0,2819292
ompRp1,0.16666666666666666,5,5,AAGGAGCCAGATTTCGAACA,0,2800914
ompRp1,0.16666666666666666,5,5,AAGCTTAAAGAAGGGATAAA,0,2823132
ompRp1,0.16666666666666666,5,5,AAGCTCCGTAGGTATCGCAA,0,2787732
ompRp1,0.16666666666666666,5,5,AAGCGTCAACGAATTTGCAA,0,2778445
ompRp1,0.16666666666666666,5,5,AAGCCTTGACTGCCTGACGT,0,2774852
ompRp1,0.16666666666666666,5,5,AAGCAGTGCGCGGCCACGGC,0,2795622
ompRp1,0.16666666666666666,5,5,AAGCAGCATTGAATTTAAGG,0,2774964
ompRp1,0.16666666666666666,5,5,AAGCAGACTGCGAACGAGAC,0,2785923
ompRp1,0.16666666666666666,5,5,AAGATTTGCCGATTATATAG,0,2775494
ompRp1,0.16666666666666666,5,5,AAGATCGGGAACTTAACACC,0,2817993
ompRp1,0.16666666666666666,5,5,AAGAACCCACTCTGGTGGAT,0,2783597
ompRp1,0.16666666666666666,5,5,AACTTCAATTATGCTAGCCA,0,2773081
ompRp1,0.16666666666666666,5,5,AACTGCTTTAACCCGTGAGT,0,2801491
ompRp1,0.16666666666666666,5,5,AACTCCAATTTCATGCGTGG,0,2813278
ompRp1,0.16666666666666666,5,5,AACTAGGAGGTATTTGATCG,0,2797942
ompRp1,0.16666666666666666,5,5,AACGGGGATATCCAGCGCGC,0,2771637
ompRp1,0.16666666666666666,5,5,AACGCTCATGCCAAGCATGC,0,2772871
ompRp1,0.16666666666666666,5,5,AACGATCGCCTTAGACTAGA,0,2821386
ompRp1,0.16666666666666666,5,5,AACGATCATTAGAGATAGTG,0,2770971
ompRp1,0.16666666666666666,5,5,AACGAGTGATGTCCTGGCTC,0,2779798
ompRp1,0.16666666666666666,5,5,AACGACGTGGTGTACGATCA,0,2807478
ompRp1,0.16666666666666666,5,5,AACCTATATTTTACAGCCAC,0,2765532
ompRp1,0.16666666666666666,5,5,AACCGAGGCAGAATCCACAA,0,2783539
ompRp1,0.16666666666666666,5,5,AACCCTTTACGACTATCTGC,0,2803946
ompRp1,0.16666666666666666,5,5,AACCCGCCGGGCCGACGATG,0,2821158
ompRp1,0.16666666666666666,5,5,AACATGGCGGCGGGGTCTAT,0,2790265
ompRp1,0.16666666666666666,5,5,AACAGTCCTAACCCGAGAGG,0,2819218
ompRp1,0.16666666666666666,5,5,AACAGTAAAGTGAAACAACG,0,2771304
ompRp1,0.16666666666666666,5,5,AACAGCAGTGCTGCAATTGA,0,2777219
ompRp1,0.16666666666666666,5,5,AACACGTGTAAACATTGGGA,0,2785519
ompRp1,0.16666666666666666,5,5,AACACGGGTTTTATCGCGAG,0,2803919
ompRp1,0.16666666666666666,5,5,AACAATAGGACTGGGGTCGT,0,2777032
ompRp1,0.16666666666666666,5,5,AAATTCAGGGTGGAATTTAC,0,2776784
ompRp1,0.16666666666666666,5,5,AAAGTTACTTATCTCTAAAC,0,2788034
ompRp1,0.16666666666666666,5,5,AAAGCCCGACTGTGTAGGAT,0,2797783
ompRp1,0.16666666666666666,5,5,AAAGATATTAAACACCAAAG,0,2779831
ompRp1,0.16666666666666666,5,5,AAAGACAAGCATTCGAGAAT,0,2821136
ompRp1,0.16666666666666666,5,5,AAACTGACGGTGCCACGCAA,0,2775783
ompRp1,0.16666666666666666,5,5,AAACGATCCTGGGGCACCTC,0,2822285
ompRp1,0.16666666666666666,5,5,AAACGAGATGTGTACTTTAA,0,2776065
ompRp1,0.16666666666666666,5,5,AAACCTTCAGAGGCTCTCTG,0,2798170
ompRp1,0.16666666666666666,5,5,AAACCAGTGGTGTACAGCAT,0,2783533
ompRp1,0.16666666666666666,5,5,AAACAGCAGTTGATTGCTTG,0,2821785
ompRp1,0.16666666666666666,5,5,AAACACTTGTGGTTTTATCT,0,2801559
ompRp1,0.16666666666666666,5,5,AAACAATGTAGGGGATGGAT,0,2808093
ompRp1,0.16666666666666666,5,5,AAAAGTCACATAAATTTAAA,0,2810481
ompRp1,0.16666666666666666,5,5,AAAACTCAGTCGCTCGTCGA,0,2789214
ompRp1,0.2,4,4,TTTTTGCACAGCCACAGAGT,0,2816580
ompRp1,0.2,4,4,TTTTTCTTAAGATGCGACTC,0,2804379
ompRp1,0.2,4,4,TTTTGAAAAGCCGCCGCTGT,0,2804357
ompRp1,0.2,4,4,TTTTAGTTGTATTGAGTAGG,0,2784522
ompRp1,0.2,4,4,TTTGTCCAGGTATTAGGTAA,0,2765481
ompRp1,0.2,4,4,TTTGTCAATTAAATCAGTCT,0,2807119
ompRp1,0.2,4,4,TTTGGTCCCCGCGCAATCTG,0,2813928
ompRp1,0.2,4,4,TTTGCAACTACCCACTGCAT,0,2799285
ompRp1,0.2,4,4,TTTGATCGGACCCGGTTATA,0,2800554
ompRp1,0.2,4,4,TTTGAAACCCTCTTAGGATT,0,2807663
ompRp1,0.2,4,4,TTTCTCGCGTACTCGTTTAG,0,2816155
ompRp1,0.2,4,4,TTTCTCCGACATTATGCTCA,0,2786114
ompRp1,0.2,4,4,TTTCGCCTGCTCCGGTCGCG,0,2787743
ompRp1,0.2,4,4,TTTCGAGACATGTCACGCGG,0,2776910
ompRp1,0.2,4,4,TTTCCTCGTTGTCGAGTGCT,0,2807302
ompRp1,0.2,4,4,TTTCATCGGCGAGTTACACT,0,2811321
ompRp1,0.2,4,4,TTTCAAGGTTACTAAGCGAT,0,2799019
ompRp1,0.2,4,4,TTTATTTTCTCATACGAAGG,0,2782722
ompRp1,0.2,4,4,TTTAGGATACATGAAAGGGA,0,2796221
ompRp1,0.2,4,4,TTTAGCAGGGCGGCGCTCAT,0,2773250
ompRp1,0.2,4,4,TTTACTATAGCCCAAAGGCT,0,2792474
ompRp1,0.2,4,4,TTTACGTATCGCGCACACGC,0,2815032
ompRp1,0.2,4,4,TTTAAGGTAGACCAGATAAC,0,2789342
ompRp1,0.2,4,4,TTGTTCGGGTGCTCCTAGGC,0,2812260
ompRp1,0.2,4,4,TTGTTCGCGGACGGATAGAC,0,2805490
ompRp1,0.2,4,4,TTGTCTGCCTTAATATCCGT,0,2808300
ompRp1,0.2,4,4,TTGTCTGCACCGAGGTACTT,0,2775247
ompRp1,0.2,4,4,TTGTCTAGGCGGCGGGAACC,0,2806480
ompRp1,0.2,4,4,TTGTCTAATATGGGGGGCAA,0,2822797
ompRp1,0.2,4,4,TTGTCAGCAGATAGGGCATA,0,2772553
ompRp1,0.2,4,4,TTGTCAAGTGCCATTTGCGA,0,2771459
ompRp1,0.2,4,4,TTGTAGGTCCAAGGGGCTCC,0,2786988
ompRp1,0.2,4,4,TTGTACTCTTTGCTTTTGGC,0,2824093
ompRp1,0.2,4,4,TTGGGCGCTTCACCTCCACA,0,2777075
ompRp1,0.2,4,4,TTGGGAAGCGGGGCAACCTC,0,2795359
ompRp1,0.2,4,4,TTGGCCGTACGCCAGTGGGT,0,2800687
ompRp1,0.2,4,4,TTGGCCGGCCATATGCGAAT,0,2775906
ompRp1,0.2,4,4,TTGCTGGCGGGAAGGAAAAA,0,2797622
ompRp1,0.2,4,4,TTGCGTAACTGCCAGCATTC,0,2765877
ompRp1,0.2,4,4,TTGCGGATGGGCCTGAAAGG,0,2777985
ompRp1,0.2,4,4,TTGCGGAGTAGCCCATTAAG,0,2790099
ompRp1,0.2,4,4,TTGCGCACTCGAGGTCGGTG,0,2824038
ompRp1,0.2,4,4,TTGCGACCCATTGCGGGAAA,0,2800278
ompRp1,0.2,4,4,TTGCAGTCGTCCCTTTATAC,0,2798527
ompRp1,0.2,4,4,TTGCACGTCGGATTTTAGCG,0,2781741
ompRp1,0.2,4,4,TTGCAAAAAGAGCGTTCGCG,0,2815922
ompRp1,0.2,4,4,TTGATGTGTTATTAGGTTTT,0,2822383
ompRp1,0.2,4,4,TTGATCTATACGTCTTAGGT,0,2795446
ompRp1,0.2,4,4,TTGATCCATTGCCCGTAACT,0,2771324
ompRp1,0.2,4,4,TTGAGCGCTGGGTAGATGCA,0,2806668
ompRp1,0.2,4,4,TTGAATTTATTTAGAGTTAG,0,2770474
ompRp1,0.2,4,4,TTGAATGTTTCCGCGCCACA,0,2783291
ompRp1,0.2,4,4,TTGAATGCTAGCCGCCAACG,0,2804424
ompRp1,0.2,4,4,TTCTTCTACGGTTCTCCAGC,0,2767815
ompRp1,0.2,4,4,TTCTCGTCTCATCGTTCTTC,0,2818965
ompRp1,0.2,4,4,TTCTCCTATATCACCAGTAT,0,2784571
ompRp1,0.2,4,4,TTCGTGCCTAAAGCACACTT,0,2807293
ompRp1,0.2,4,4,TTCGGTTCGGCCATTTACTC,0,2801998
ompRp1,0.2,4,4,TTCGGGACTTGGCCAACGTC,0,2797465
ompRp1,0.2,4,4,TTCGGCAGTTGCTCTGCCTG,0,2805706
ompRp1,0.2,4,4,TTCGGAACCTTAGGGTCAGA,0,2813446
ompRp1,0.2,4,4,TTCGCTTCACTCGCGGGCCG,0,2793780
ompRp1,0.2,4,4,TTCGCCAGGTTTGTAGTGGT,0,2801802
ompRp1,0.2,4,4,TTCCTGAGCGTTCCTTGGCT,0,2811745
ompRp1,0.2,4,4,TTCCTCCCATCGTTTTTCGT,0,2767117
ompRp1,0.2,4,4,TTCCGGATGTCTCTGTGCGA,0,2779314
ompRp1,0.2,4,4,TTCCCCCAATACTCTATCGC,0,2772600
ompRp1,0.2,4,4,TTCCAAAATTATACCCGGAT,0,2797846
ompRp1,0.2,4,4,TTCAAAGCTTTCGGGCGCAA,0,2788108
ompRp1,0.2,4,4,TTATTGATCTTACACGAGCT,0,2821278
ompRp1,0.2,4,4,TTATGATCTCTCGCTCCTGA,0,2786841
ompRp1,0.2,4,4,TTATAGTCGTACAAGCTTGT,0,2771555
ompRp1,0.2,4,4,TTATAAAGGGCTGTACCTTA,0,2811366
ompRp1,0.2,4,4,TTAGTGGACGCTGGAAAATA,0,2813578
ompRp1,0.2,4,4,TTAGTACAGATGAGACCCGC,0,2780029
ompRp1,0.2,4,4,TTAGTAACTATGAAGAAGAA,0,2768071
ompRp1,0.2,4,4,TTAGGACACGATATTACAGA,0,2805885
ompRp1,0.2,4,4,TTAGGAAACGCGCCGTGGTT,0,2794760
ompRp1,0.2,4,4,TTAGCTTAATAGACGAGAGA,0,2774609
ompRp1,0.2,4,4,TTAGCGTCTAACCTCTAGAC,0,2821884
ompRp1,0.2,4,4,TTACTTGTTTTCCGCCAGGG,0,2820474
ompRp1,0.2,4,4,TTACTTCACGTAGCGCGTCC,0,2790867
ompRp1,0.2,4,4,TTACTGGACCTTTGGCGTGT,0,2818433
ompRp1,0.2,4,4,TTACATTCTCTAGAACGAGC,0,2807938
ompRp1,0.2,4,4,TTACATTAGGGGCGAAACGG,0,2806202
ompRp1,0.2,4,4,TTACAATGCAAACCTTATGC,0,2780907
ompRp1,0.2,4,4,TTACAAATTGTGTTGTTCCC,0,2770227
ompRp1,0.2,4,4,TTAATCGGCACTCGGTGCTC,0,2769850
ompRp1,0.2,4,4,TTAAGTTACTAATTTTCCAG,0,2781447
ompRp1,0.2,4,4,TTAACTGGCAGTCCACAATC,0,2824761
ompRp1,0.2,4,4,TTAACTCATCGAGAGGACCA,0,2798253
ompRp1,0.2,4,4,TTAACATAGCCGAATGTATC,0,2789561
ompRp1,0.2,4,4,TTAAAATATGAGGAGAATGG,0,2786471
ompRp1,0.2,4,4,TGTTTTTGCACACGTGGTAC,0,2820477
ompRp1,0.2,4,4,TGTTTATGTTACGGCGGCGT,0,2793680
ompRp1,0.2,4,4,TGTTTAAATGAAGTGCTAAA,0,2798692
ompRp1,0.2,4,4,TGTTGGGTTAGAAGGCAATA,0,2808232
ompRp1,0.2,4,4,TGTTGCTATGATTTTGGTGC,0,2821915
ompRp1,0.2,4,4,TGTTAAGAATAGTCTAGGCG,0,2815279
ompRp1,0.2,4,4,TGTGCGCTCCTGTGCTACGG,0,2802236
ompRp1,0.2,4,4,TGTGCACGTGTTTCGGACAA,0,2765467
ompRp1,0.2,4,4,TGTCGGAAAGGAATCCGGAA,0,2787425
ompRp1,0.2,4,4,TGTCGCTAGTCATACTTAGC,0,2804349
ompRp1,0.2,4,4,TGTCGAGATCTGGGCCGGCC,0,2786497
ompRp1,0.2,4,4,TGTCCGCCCCGGTTTATTTG,0,2810128
ompRp1,0.2,4,4,TGTCCCATGGTGGTTGCAGG,0,2796654
ompRp1,0.2,4,4,TGTCATCTGGGATTTGTCCC,0,2820214
ompRp1,0.2,4,4,TGTCATAACTGATTTCAAAA,0,2806096
ompRp1,0.2,4,4,TGTATCTACACCTTGATTTC,0,2770355
ompRp1,0.2,4,4,TGTAGACGCGGAAGAACACA,0,2790322
ompRp1,0.2,4,4,TGTAATCTAGCTACGGTGGC,0,2786094
ompRp1,0.2,4,4,TGTAACAGGCCGCGGTGCGT,0,2789399
ompRp1,0.2,4,4,TGGTTCTCACTGCGTCTATA,0,2814619
ompRp1,0.2,4,4,TGGTTAGGGGCCAACAGTTA,0,2806314
ompRp1,0.2,4,4,TGGTTAAGAGTTTACGGACA,0,2770493
ompRp1,0.2,4,4,TGGTGGGGCGATCCAACCCT,0,2822823
ompRp1,0.2,4,4,TGGTCCGTAAGGCTGAAGGA,0,2814618
ompRp1,0.2,4,4,TGGTCCACTGGCTTAAGGCC,0,2767326
ompRp1,0.2,4,4,TGGTCATGACGGGACGTGCG,0,2791257
ompRp1,0.2,4,4,TGGTACTCACGCCTTCGTGT,0,2789433
ompRp1,0.2,4,4,TGGGTAACGGATCACTATAA,0,2768123
ompRp1,0.2,4,4,TGGGGTGCCTGTTACTGGAG,0,2793030
ompRp1,0.2,4,4,TGGCTACGCCCGCCACGCGG,0,2805121
ompRp1,0.2,4,4,TGGCGGTCCTTGATCTCAAA,0,2782834
ompRp1,0.2,4,4,TGGCGAGTAGCAATAGCGGT,0,2773434
ompRp1,0.2,4,4,TGGATTGCATAACGGCTATA,0,2772540
ompRp1,0.2,4,4,TGGAAGGGCAAGCACGGGGT,0,2790091
ompRp1,0.2,4,4,TGGAACAGCTGGGCGCGACT,0,2810051
ompRp1,0.2,4,4,TGCTATCGTTTATTGGAGGT,0,2821801
ompRp1,0.2,4,4,TGCGTGCTAGGTGCACCTAG,0,2811163
ompRp1,0.2,4,4,TGCGGGGTCCCGTATGTAAT,0,2789624
ompRp1,0.2,4,4,TGCGGACAGGCTGAATGAGA,0,2797374
ompRp1,0.2,4,4,TGCGAGGTGTGGGCTTTTGT,0,2777831
ompRp1,0.2,4,4,TGCGAGACCTGGTGGACATC,0,2810934
ompRp1,0.2,4,4,TGCGAGAAAATGCGGCAGAC,0,2813879
ompRp1,0.2,4,4,TGCGAAGCTGTGACGCAAGA,0,2795958
ompRp1,0.2,4,4,TGCGAAGCCGAAGTGTACAC,0,2769363
ompRp1,0.2,4,4,TGCCGTAATCCATATACAGT,0,2778102
ompRp1,0.2,4,4,TGCCCGACGTTGACTGTTGT,0,2812678
ompRp1,0.2,4,4,TGCCCATACGCGTACTTCCT,0,2768556
ompRp1,0.2,4,4,TGCCCATACCTCCGTTCCAG,0,2821722
ompRp1,0.2,4,4,TGCCACACCCTTTTACCGAA,0,2811253
ompRp1,0.2,4,4,TGCCACAATGAAAAAGATTT,0,2788098
ompRp1,0.2,4,4,TGCAGCTTAGAGACCCCGCA,0,2778357
ompRp1,0.2,4,4,TGCAGCCTTGGGCCTCAAAA,0,2792382
ompRp1,0.2,4,4,TGCACGAATAACACCCTACC,0,2813372
ompRp1,0.2,4,4,TGATGAAAGCCGAAGTCGCG,0,2805351
ompRp1,0.2,4,4,TGATCAGCTCGTTGCTTAAA,0,2815414
ompRp1,0.2,4,4,TGATACACAAATCACTTCGC,0,2806287
ompRp1,0.2,4,4,TGAGTGGCCACGAGGAGCGT,0,2788691
ompRp1,0.2,4,4,TGAGTGCGGACTACAATAAA,0,2770061
ompRp1,0.2,4,4,TGAGGACCACAGGCATCAGT,0,2814598
ompRp1,0.2,4,4,TGAGAGACACATGTGAGATC,0,2822406
ompRp1,0.2,4,4,TGACTTTCATAAGTCTCTCA,0,2766559
ompRp1,0.2,4,4,TGACTTGAGCCCGTATGTAT,0,2803739
ompRp1,0.2,4,4,TGACTGCGTAGGAAGCGCAA,0,2809329
ompRp1,0.2,4,4,TGACGTGATCATAAATTCGT,0,2775736
ompRp1,0.2,4,4,TGACACTGTAGAGCCCATCC,0,2815559
ompRp1,0.2,4,4,TGAATCTGATTAGGGTGGGG,0,2794620
ompRp1,0.2,4,4,TGAAGCGACAGGCAGGTGTA,0,2790664
ompRp1,0.2,4,4,TGAACTTTCTGGGGTGCACG,0,2824474
ompRp1,0.2,4,4,TGAACAGGCGTGTTTGGGCT,0,2781097
ompRp1,0.2,4,4,TGAACACCTCATCCTAGATG,0,2802599
ompRp1,0.2,4,4,TGAAATCGAACTAAACTTGG,0,2766133
ompRp1,0.2,4,4,TGAAAGTGTTATGAGGCGTG,0,2795023
ompRp1,0.2,4,4,TCTTTGTGTCGTAAAAGGCC,0,2776590
ompRp1,0.2,4,4,TCTTTGCTATACGAAGGTGC,0,2793516
ompRp1,0.2,4,4,TCTTTACTTAGTCCCGCTAT,0,2793497
ompRp1,0.2,4,4,TCTTGGAGCACCATAAAAAG,0,2780830
ompRp1,0.2,4,4,TCTTGGAAAGCGTAGCTCGA,0,2805244
ompRp1,0.2,4,4,TCTGTACCATCCGAAACGAT,0,2787548
ompRp1,0.2,4,4,TCTGGAGTCGCTCACGTTTT,0,2811650
ompRp1,0.2,4,4,TCTGGAATGGGGAATATAAT,0,2773701
ompRp1,0.2,4,4,TCTGCTGTGCAGTGGTGGTT,0,2824250
ompRp1,0.2,4,4,TCTGCCCCATACCTGTCTTT,0,2816391
ompRp1,0.2,4,4,TCTGCAGACCCCCGGAAGTA,0,2786871
ompRp1,0.2,4,4,TCTGAGTTCACCGATATGAA,0,2799823
ompRp1,0.2,4,4,TCTCATACTCTACTCTGAGG,0,2817884
ompRp1,0.2,4,4,TCTCAAGCACAAATGCACGT,0,2769364
ompRp1,0.2,4,4,TCTCAACCTCTAGTCTAAAA,0,2818129
ompRp1,0.2,4,4,TCTACTCCCTTTGCAAAACG,0,2773128
ompRp1,0.2,4,4,TCTACGGGGGAAACCACCAC,0,2800514
ompRp1,0.2,4,4,TCTACATGTGCTCGCTACAG,0,2783442
ompRp1,0.2,4,4,TCTAAGCTAGGAGGATCGAA,0,2801870
ompRp1,0.2,4,4,TCTAACGGTCCCGTCACCTA,0,2802708
ompRp1,0.2,4,4,TCGTGGCAGGTACTGGGGTA,0,2774663
ompRp1,0.2,4,4,TCGTCGGAATGTGTATACTA,0,2803622
ompRp1,0.2,4,4,TCGTATATGAACCAATTTTG,0,2814153
ompRp1,0.2,4,4,TCGTAGATTTGAACCGTAGA,0,2799521
ompRp1,0.2,4,4,TCGTAAGATGCAATTCCCAA,0,2813456
ompRp1,0.2,4,4,TCGGGTAGATCAGCCATACG,0,2819783
ompRp1,0.2,4,4,TCGGGCAACCTTTTGAACAG,0,2798653
ompRp1,0.2,4,4,TCGGATCTGCCATCTTAACT,0,2811294
ompRp1,0.2,4,4,TCGGAATGCGGCGACCACAG,0,2798958
ompRp1,0.2,4,4,TCGCTTAGGCGCCGTTTCAG,0,2802000
ompRp1,0.2,4,4,TCGCTAGTATCGGCTACATA,0,2820169
ompRp1,0.2,4,4,TCGCGCCTATGGCACGGACA,0,2804473
ompRp1,0.2,4,4,TCGCCATACGTACGGCGTCT,0,2805515
ompRp1,0.2,4,4,TCGCAAAAAGTCGGCTCAAA,0,2793863
ompRp1,0.2,4,4,TCGATTTAATCTACCTAGAT,0,2778041
ompRp1,0.2,4,4,TCGATGCAACTTTTAGTATC,0,2770779
ompRp1,0.2,4,4,TCGATAGCATCTTGTGTAGG,0,2773437
ompRp1,0.2,4,4,TCGAGTGCCAACGTGCCTGT,0,2800674
ompRp1,0.2,4,4,TCGACTTTCAAAAACGATCC,0,2778223
ompRp1,0.2,4,4,TCGAAAGGGTAGATTGGTGA,0,2775290
ompRp1,0.2,4,4,TCCTCATGGTCAAAGGTGCG,0,2786784
ompRp1,0.2,4,4,TCCTCAGCTTTGGGTGCAGG,0,2805059
ompRp1,0.2,4,4,TCCTAGGCCGTACGGCGGGT,0,2767383
ompRp1,0.2,4,4,TCCTAACTATCTATAGGGCA,0,2766872
ompRp1,0.2,4,4,TCCGTGCAGACTCAGCTCAA,0,2814340
ompRp1,0.2,4,4,TCCGCTCTCGGTACAATGTG,0,2820003
ompRp1,0.2,4,4,TCCGCCTTCGTAGGAACAAG,0,2811986
ompRp1,0.2,4,4,TCCGCACCGAAATATCCTGT,0,2789268
ompRp1,0.2,4,4,TCCGAAGTGGCGTACCCGTC,0,2815118
ompRp1,0.2,4,4,TCCCTGTTGTCGGGTGTTGA,0,2801029
ompRp1,0.2,4,4,TCCCTATCTCCCAAAGACAG,0,2813185
ompRp1,0.2,4,4,TCCCACGTGCGCATGGCTTG,0,2787426
ompRp1,0.2,4,4,TCCCACCGCAAGTACGAGAC,0,2770245
ompRp1,0.2,4,4,TCCCACAAATCGTCAGAACC,0,2810765
ompRp1,0.2,4,4,TCCAACCTTGCGTCTTGTCA,0,2805754
ompRp1,0.2,4,4,TCCAACCCGGAGATCTGGCG,0,2789096
ompRp1,0.2,4,4,TCATGACAGTCGATTACAAA,0,2810584
ompRp1,0.2,4,4,TCATCTGCAGCCTTCGCTGC,0,2824088
ompRp1,0.2,4,4,TCATCATAGGGTACCTCGCC,0,2803460
ompRp1,0.2,4,4,TCATAGGCCTTCCCGCCAAA,0,2777312
ompRp1,0.2,4,4,TCAGTTAGTTCGCGCCCTAC,0,2786913
ompRp1,0.2,4,4,TCAGTCACGTTGTAGAAGAG,0,2815270
ompRp1,0.2,4,4,TCAGGGGTTGCGTTAACACT,0,2771599
ompRp1,0.2,4,4,TCAGCTGTTTAAGGTGTATT,0,2812470
ompRp1,0.2,4,4,TCAGCTCTGAATGAAGCCCA,0,2784536
ompRp1,0.2,4,4,TCAGCGTTTCACCCATTTAG,0,2806151
ompRp1,0.2,4,4,TCAGAAGTTGAGAGACCCAC,0,2816419
ompRp1,0.2,4,4,TCAGAAGGGAAGTACCTTCG,0,2772925
ompRp1,0.2,4,4,TCAGAACATATCTTAAACAA,0,2819704
ompRp1,0.2,4,4,TCACTGGTATCGCGACAGGA,0,2798935
ompRp1,0.2,4,4,TCACCTCTAGCGTGCGGTAG,0,2816516
ompRp1,0.2,4,4,TCACCGCACCGCATGATTGC,0,2804809
ompRp1,0.2,4,4,TCACAAGTAGCCCACCAATT,0,2790905
ompRp1,0.2,4,4,TCAAGGGGATGGGGAGCACG,0,2812939
ompRp1,0.2,4,4,TCAAGCGGCTGGGCAGGACG,0,2808548
ompRp1,0.2,4,4,TCAAGAGAAGGTCGATCGGT,0,2788578
ompRp1,0.2,4,4,TCAACGACTCGACGATTCCT,0,2790354
ompRp1,0.2,4,4,TCAACAATAAAATACGTGTG,0,2796800
ompRp1,0.2,4,4,TCAAACTAGAGAGGCGTGAC,0,2805249
ompRp1,0.2,4,4,TATTTCGTCATCTGCTAGAA,0,2816221
ompRp1,0.2,4,4,TATTGACTCACTGGCTTTGC,0,2804755
ompRp1,0.2,4,4,TATTCCACCCGCGGCGTATC,0,2806510
ompRp1,0.2,4,4,TATTATGCGTGCCTCAAGCT,0,2789388
ompRp1,0.2,4,4,TATTATACGTAGACTGTCCG,0,2814369
ompRp1,0.2,4,4,TATGTGGAGGGTCGGCCTCT,0,2767424
ompRp1,0.2,4,4,TATGTAGAGATCTGCGGGTC,0,2809325
ompRp1,0.2,4,4,TATGCGCATAGACTTTATAT,0,2768419
ompRp1,0.2,4,4,TATGATTCCGTAGATACCTT,0,2808923
ompRp1,0.2,4,4,TATGAGCGTGATCACTGGCT,0,2766000
ompRp1,0.2,4,4,TATCCGGGGACCTATTTCCA,0,2819195
ompRp1,0.2,4,4,TATCACGTGGCTGGTATTTG,0,2768225
ompRp1,0.2,4,4,TATCAATAAAGTCCGCCGCT,0,2793730
ompRp1,0.2,4,4,TATAGAATATCTAGAGCCTC,0,2811078
ompRp1,0.2,4,4,TATACGCCTCTCGGACTCCC,0,2779418
ompRp1,0.2,4,4,TATACGAATGAAAGCCCGGC,0,2813472
ompRp1,0.2,4,4,TATACCGGGATCAGACACGA,0,2812273
ompRp1,0.2,4,4,TATAAGTTCAGCCGGATTTA,0,2783445
ompRp1,0.2,4,4,TATAACCTGTAATAGCGAGG,0,2780802
ompRp1,0.2,4,4,TATAAAAAATACTAGCAGTG,0,2807271
ompRp1,0.2,4,4,TAGGTCGTAGTAATGCGCTC,0,2796020
ompRp1,0.2,4,4,TAGGGCGGTGGGTATTCTAT,0,2809767
ompRp1,0.2,4,4,TAGGACATGCGCGATACAGA,0,2801361
ompRp1,0.2,4,4,TAGCTTTAAGCGGCCTCTCA,0,2797919
ompRp1,0.2,4,4,TAGCTGTACTCAGAAACCTC,0,2799046
ompRp1,0.2,4,4,TAGCGTCTCCGAAGGGTGGT,0,2818118
ompRp1,0.2,4,4,TAGCGTAAAGCGTCAGACTG,0,2798381
ompRp1,0.2,4,4,TAGCCGTAATCTTGTGGTGG,0,2776429
ompRp1,0.2,4,4,TAGCCATCAAGCTCAAGAAT,0,2824303
ompRp1,0.2,4,4,TAGCAAACAGTCATAAGTGC,0,2783624
ompRp1,0.2,4,4,TAGATGACGTGTGAGTACCA,0,2769440
ompRp1,0.2,4,4,TAGAGCATAAGAATAAAAAT,0,2770473
ompRp1,0.2,4,4,TAGAGAGCCCCCTCCGGACT,0,2799464
ompRp1,0.2,4,4,TAGAGACCGTCAGACCATCC,0,2796101
ompRp1,0.2,4,4,TAGAGAACCTCATTCTGAAT,0,2779047
ompRp1,0.2,4,4,TACTGGGGCGCACCCAAGGG,0,2821086
ompRp1,0.2,4,4,TACTCAACATCTCCGTTGGG,0,2775605
ompRp1,0.2,4,4,TACGTGGTTGGCTTGCAAAA,0,2778828
ompRp1,0.2,4,4,TACGCCTGTATTGCTACTGG,0,2791157
ompRp1,0.2,4,4,TACGAGGTCGCGACCTATGC,0,2797541
ompRp1,0.2,4,4,TACCGGGTCCTAGAGTAGAA,0,2800061
ompRp1,0.2,4,4,TACCCGTTCCAAACTCTCCC,0,2800698
ompRp1,0.2,4,4,TACCAGCCCTTCGTAGCTTG,0,2819016
ompRp1,0.2,4,4,TACCACAAAGAGCATAAGGA,0,2797260
ompRp1,0.2,4,4,TACAGTGTCCAGGATTCGAC,0,2796105
ompRp1,0.2,4,4,TACAGGTGATCCAACGCTCA,0,2788608
ompRp1,0.2,4,4,TACAGGGGAATAGGATACAT,0,2790193
ompRp1,0.2,4,4,TACACTGATGATGTCATCCT,0,2806906
ompRp1,0.2,4,4,TACAATTGATTCATTTTTAG,0,2818896
ompRp1,0.2,4,4,TACAAGGCCAGACGCGAAGG,0,2800135
ompRp1,0.2,4,4,TAATGATCGTCGAACTAGAT,0,2791587
ompRp1,0.2,4,4,TAATATCTAATCCTTACTAT,0,2776311
ompRp1,0.2,4,4,TAAGCAGGTGGTTGTATGCC,0,2784086
ompRp1,0.2,4,4,TAAGCAGGCCAGCCGTCCAG,0,2813808
ompRp1,0.2,4,4,TAACTGTAGCTAACGAAATA,0,2824478
ompRp1,0.2,4,4,TAACGGCTAGAGAGGAAACT,0,2819885
ompRp1,0.2,4,4,TAACGATGTCTCATTGATTG,0,2791249
ompRp1,0.2,4,4,TAACAGTTGACAAAAAAGAA,0,2798742
ompRp1,0.2,4,4,TAACAGACGTTGCTAAGGGC,0,2817695
ompRp1,0.2,4,4,TAAATCGATTGCGAGGAGGC,0,2777754
ompRp1,0.2,4,4,TAAACGGGGGTCATGCAGTG,0,2813649
ompRp1,0.2,4,4,GTTTTTTGGCGGTGTTCATC,0,2769855
ompRp1,0.2,4,4,GTTTTTGGATGCTGGACGCA,0,2818956
ompRp1,0.2,4,4,GTTTGCACTGCTCCCAACGC,0,2785511
ompRp1,0.2,4,4,GTTTGATACTGGTCGTTGTA,0,2768923
ompRp1,0.2,4,4,GTTTCTAAGCGGTTCGAAAT,0,2789004
ompRp1,0.2,4,4,GTTTATCGTCAACGTTATAC,0,2777550
ompRp1,0.2,4,4,GTTTAGTGGTCCTGACTGCT,0,2798348
ompRp1,0.2,4,4,GTTTAGCTCCCTCGCCAAGG,0,2780805
ompRp1,0.2,4,4,GTTTACGCTGGCCCCCGGCG,0,2770237
ompRp1,0.2,4,4,GTTGTACCCGGCGTAGGTAC,0,2818731
ompRp1,0.2,4,4,GTTGGTTACTGATTCAACTT,0,2784250
ompRp1,0.2,4,4,GTTGGTGTAGTACGGAAAGA,0,2811897
ompRp1,0.2,4,4,GTTGGTAAAATATCTTATCA,0,2818918
ompRp1,0.2,4,4,GTTGGAACTATAAACACGCA,0,2779091
ompRp1,0.2,4,4,GTTGCCCCTTATGACGATTG,0,2787298
ompRp1,0.2,4,4,GTTGATTCGTCGTGATTTTT,0,2775147
ompRp1,0.2,4,4,GTTCTTATCCAAGATGGAGT,0,2765604
ompRp1,0.2,4,4,GTTCTCTCCGATTGGGCGTC,0,2787688
ompRp1,0.2,4,4,GTTCGTTGTGCGCCGCATCG,0,2796659
ompRp1,0.2,4,4,GTTCGGGTATGCATGGTGTT,0,2790863
ompRp1,0.2,4,4,GTTCCAGCTGTTTCACACTT,0,2790797
ompRp1,0.2,4,4,GTTCACGCGTGTTCTCACCT,0,2792326
ompRp1,0.2,4,4,GTTAGTTAAATTCCGGGTTG,0,2801880
ompRp1,0.2,4,4,GTTAGGATTGATTATCATGA,0,2810206
ompRp1,0.2,4,4,GTTACGACAGGCTGAAATGA,0,2793974
ompRp1,0.2,4,4,GTTAAACCAGCGGCGATGTT,0,2784132
ompRp1,0.2,4,4,GTGTTCGCCTGATTCTACTA,0,2795205
ompRp1,0.2,4,4,GTGTGTTGTTTTATTCAGAT,0,2792094
ompRp1,0.2,4,4,GTGTGTCAAACGAGACACGA,0,2769323
ompRp1,0.2,4,4,GTGTGTACAGTCAAAATGGG,0,2774154
ompRp1,0.2,4,4,GTGTCTTCAGCGGCAACGGT,0,2809573
ompRp1,0.2,4,4,GTGTCGAATCGCGTCTCTTC,0,2794519
ompRp1,0.2,4,4,GTGTATGGGACATCCACCGT,0,2821093
ompRp1,0.2,4,4,GTGTATCGGTCGAAGGATGA,0,2820962
ompRp1,0.2,4,4,GTGGTGAAAATTGTGTTCTT,0,2797196
ompRp1,0.2,4,4,GTGGTCTTCGGAGACCCATA,0,2772219
ompRp1,0.2,4,4,GTGGGTAGTTGTCGGAGGAG,0,2777863
ompRp1,0.2,4,4,GTGGGAACGCAGGGTTATAG,0,2788414
ompRp1,0.2,4,4,GTGGCTGCTCTGGAACAATT,0,2822347
ompRp1,0.2,4,4,GTGGCATCCCTGTATCCAAC,0,2807219
ompRp1,0.2,4,4,GTGGATGTCGAATGTGTACA,0,2822554
ompRp1,0.2,4,4,GTGGATATGACCAGCTGCGA,0,2811211
ompRp1,0.2,4,4,GTGGAGGTATAACCTGGGAC,0,2792287
ompRp1,0.2,4,4,GTGCTCATCGAGCCGGTGAA,0,2779488
ompRp1,0.2,4,4,GTGCGATCGCCTTGGGCTTT,0,2777316
ompRp1,0.2,4,4,GTGCCTCGATGTCCCAACAT,0,2796470
ompRp1,0.2,4,4,GTGCATTGACCCGGTTGTTC,0,2777720
ompRp1,0.2,4,4,GTGATGATGGCTCACTAGAG,0,2802434
ompRp1,0.2,4,4,GTGATATGACTGAGTACCCA,0,2792617
ompRp1,0.2,4,4,GTGATAAACGGCGCAATTCA,0,2803145
ompRp1,0.2,4,4,GTGAGGGTCTTGGGGCTATG,0,2810802
ompRp1,0.2,4,4,GTGACGCAACCGAATGCTTC,0,2804143
ompRp1,0.2,4,4,GTGACAATCTCGCGACTTAC,0,2798349
ompRp1,0.2,4,4,GTGAATTGCCGGCGACCAGC,0,2823922
ompRp1,0.2,4,4,GTGAATAAGTTTGATTGCGC,0,2782977
ompRp1,0.2,4,4,GTCTTCCACTCCTGCGTAAA,0,2786880
ompRp1,0.2,4,4,GTCGTGGCCTATTCACGTTA,0,2768977
ompRp1,0.2,4,4,GTCGTAGTTCGATGGAAGGG,0,2781647
ompRp1,0.2,4,4,GTCGGTTTATACGTGATAAG,0,2816383
ompRp1,0.2,4,4,GTCGGTGCATTGGATACTCG,0,2771783
ompRp1,0.2,4,4,GTCGCGTCGAGGCCACGTCC,0,2771867
ompRp1,0.2,4,4,GTCGAGGTGGAGGCATGGCC,0,2804741
ompRp1,0.2,4,4,GTCGACTACAGTACTGGGTA,0,2787911
ompRp1,0.2,4,4,GTCGAATGTTCGAAACGGAT,0,2780959
ompRp1,0.2,4,4,GTCCGGTACGATTTTTGGAA,0,2790400
ompRp1,0.2,4,4,GTCCGACATACGCCGCGTAT,0,2794732
ompRp1,0.2,4,4,GTCCCGCGGCGACGTTTGGA,0,2782698
ompRp1,0.2,4,4,GTCCATACTGGACTACACGC,0,2810245
ompRp1,0.2,4,4,GTCCAGGGACCTTTATATGG,0,2803517
ompRp1,0.2,4,4,GTCCAGAAGTAGGTGCATTC,0,2771415
ompRp1,0.2,4,4,GTCCAAGGCAGTTCTCAAGG,0,2801545
ompRp1,0.2,4,4,GTCCAACGGATACTGTTATT,0,2781083
ompRp1,0.2,4,4,GTCATGAAGATTAACATCTG,0,2767249
ompRp1,0.2,4,4,GTCAGCGCCGCGGCTTCGCG,0,2772510
ompRp1,0.2,4,4,GTCACGGGCGTAGTGCGCGT,0,2793233
ompRp1,0.2,4,4,GTCACCCGTTGAGGACTATA,0,2814628
ompRp1,0.2,4,4,GTCACCCCCAAATGCATATT,0,2820666
ompRp1,0.2,4,4,GTCAAATCCTACGTAAAAAA,0,2786352
ompRp1,0.2,4,4,GTCAAAGGAGCGGTCCTTTC,0,2808594
ompRp1,0.2,4,4,GTATGGATCCTACCCGGATG,0,2777975
ompRp1,0.2,4,4,GTATCGGATGCTTCGAAGTA,0,2774789
ompRp1,0.2,4,4,GTATAGGTCGTGTTTATTAA,0,2799096
ompRp1,0.2,4,4,GTAGTTTGCGCTACAATGTA,0,2777379
ompRp1,0.2,4,4,GTAGGGAAGGCGCTAACACA,0,2781159
ompRp1,0.2,4,4,GTAGGCAAATGCCTCTTTGA,0,2802282
ompRp1,0.2,4,4,GTAGCTCGGATTCGGGGAAG,0,2822559
ompRp1,0.2,4,4,GTAGCAACTGCCCCGGGCTG,0,2800584
ompRp1,0.2,4,4,GTAGATATTCGCTCAAGAGA,0,2811867
ompRp1,0.2,4,4,GTAGAGAGTCCAAGGTCTTG,0,2775952
ompRp1,0.2,4,4,GTAGACGGGGCTACGTCTTT,0,2794939
ompRp1,0.2,4,4,GTAGACGGATGTATTGTGGG,0,2773212
ompRp1,0.2,4,4,GTACTTACCAACCATGACCC,0,2803685
ompRp1,0.2,4,4,GTACGTAGGAGGAATTGCTC,0,2808427
ompRp1,0.2,4,4,GTACGGACAGAGGTACCGTG,0,2767212
ompRp1,0.2,4,4,GTACACCGCCAAACATAGGG,0,2778995
ompRp1,0.2,4,4,GTAATTTTGGGAGACTCACG,0,2820971
ompRp1,0.2,4,4,GTAATTCGGCCGAGTAATTG,0,2774664
ompRp1,0.2,4,4,GTAATGATTGCAGAGATCGC,0,2814720
ompRp1,0.2,4,4,GTAACGTGGTCAGAACACTG,0,2785882
ompRp1,0.2,4,4,GTAACCTGATCTGCGATGCG,0,2791107
ompRp1,0.2,4,4,GGTTTTTTGTGTTATTAGAT,0,2804906
ompRp1,0.2,4,4,GGTTTTCTCTAGGTTTCAGA,0,2768765
ompRp1,0.2,4,4,GGTTTCGAGGCATCACGTAC,0,2821277
ompRp1,0.2,4,4,GGTTGACTGGCTATCAAGCC,0,2796225
ompRp1,0.2,4,4,GGTTCGGCGCCCAATAACTC,0,2776089
ompRp1,0.2,4,4,GGTTCGAGCTCAGAGAACAA,0,2819369
ompRp1,0.2,4,4,GGTGTATCGAGCTGAGTTAT,0,2814257
ompRp1,0.2,4,4,GGTGATAAGTAATATCGAGT,0,2777373
ompRp1,0.2,4,4,GGTGACGAGAAGCGGACATA,0,2777072
ompRp1,0.2,4,4,GGTCTGTACGTGTTTCAGTT,0,2794415
ompRp1,0.2,4,4,GGTCTGAAGCAGGGCGCCAA,0,2816659
ompRp1,0.2,4,4,GGTCTATCCGCAGGACCAAA,0,2782875
ompRp1,0.2,4,4,GGTCGCAGCGCGGGGTACAC,0,2820710
ompRp1,0.2,4,4,GGTCCATTGAGTGGCCACAC,0,2805240
ompRp1,0.2,4,4,GGTCATGAGGAGATGGAGCC,0,2770441
ompRp1,0.2,4,4,GGTCACGTTCAGAGATTGCC,0,2770862
ompRp1,0.2,4,4,GGTATCGTCCGCGTGTGCTT,0,2800263
ompRp1,0.2,4,4,GGTAGCATGTGCTTGATACA,0,2785212
ompRp1,0.2,4,4,GGTACGGCATTAAGTCCGTT,0,2790951
ompRp1,0.2,4,4,GGTACCGAAAGTTTGGATAT,0,2807279
ompRp1,0.2,4,4,GGTAAACGATGTTGAGACTA,0,2820359
ompRp1,0.2,4,4,GGGTTTCATTTTTGTGAACT,0,2784105
ompRp1,0.2,4,4,GGGTTGTAGCCAATAAAGGT,0,2806801
ompRp1,0.2,4,4,GGGTTCGTACGCGGACTCAA,0,2767421
ompRp1,0.2,4,4,GGGTGGGTCCGCTCACCCAG,0,2778992
ompRp1,0.2,4,4,GGGTAAGTCCACGCCGATCT,0,2817499
ompRp1,0.2,4,4,GGGGTTTGTTACATAAGTGC,0,2785574
ompRp1,0.2,4,4,GGGGGTTAGACGTCCGTGCC,0,2805270
ompRp1,0.2,4,4,GGGGGTGTAAAGCAAGGAAG,0,2808959
ompRp1,0.2,4,4,GGGGGGACACTAGCACGAAC,0,2777551
ompRp1,0.2,4,4,GGGGGCCGTGATTTAAGGTA,0,2816794
ompRp1,0.2,4,4,GGGGCTCTAAGTCCCGCTGA,0,2811050
ompRp1,0.2,4,4,GGGCTCGGACAGTCTGCTGT,0,2809189
ompRp1,0.2,4,4,GGGCCACCAGTATCAGGAAA,0,2782123
ompRp1,0.2,4,4,GGGCATTCCGTGTTGTGACA,0,2792803
ompRp1,0.2,4,4,GGGATATTACACCTTCTACC,0,2778145
ompRp1,0.2,4,4,GGGACGCTGTTCTCGGGGTG,0,2788871
ompRp1,0.2,4,4,GGGACACACAAGGATGGGGG,0,2787491
ompRp1,0.2,4,4,GGGAATTACGAATCTAATAG,0,2820515
ompRp1,0.2,4,4,GGGAAAGGGGGGACATCACG,0,2777544
ompRp1,0.2,4,4,GGGAAACCAGCTTTGGATCT,0,2792346
ompRp1,0.2,4,4,GGCTGGCACGAGAAACATAG,0,2770622
ompRp1,0.2,4,4,GGCTGCCGTTAACGTGCGAT,0,2780020
ompRp1,0.2,4,4,GGCTGATCGCGTTCCCCGGC,0,2767657
ompRp1,0.2,4,4,GGCTGAGCGAGGTTAGGACT,0,2801645
ompRp1,0.2,4,4,GGCTCTTTGACATTGAGAGT,0,2773462
ompRp1,0.2,4,4,GGCTCGCCACTCTGAACCTA,0,2768837
ompRp1,0.2,4,4,GGCTCAAAACACGGCGAGTA,0,2770222
ompRp1,0.2,4,4,GGCTAGATCCGTGTATCGAA,0,2806863
ompRp1,0.2,4,4,GGCTACGCGGCCGGCGTCCC,0,2823130
ompRp1,0.2,4,4,GGCTAAGGTTATGGTCTCTA,0,2781845
ompRp1,0.2,4,4,GGCTAAGGCGGATGCTGTGC,0,2780330
ompRp1,0.2,4,4,GGCGTGTACGATGGGCTGGG,0,2815557
ompRp1,0.2,4,4,GGCGTGGGCAGTTAACTGGA,0,2769672
ompRp1,0.2,4,4,GGCGTAGTGGATTTAGGTTG,0,2776038
ompRp1,0.2,4,4,GGCGCGGCAAGAAAGGCCAA,0,2793653
ompRp1,0.2,4,4,GGCGCGACGAGATCCAATTT,0,2773512
ompRp1,0.2,4,4,GGCGCAAACATGACTAAAAT,0,2797882
ompRp1,0.2,4,4,GGCGAGGCTAACGTAGATCG,0,2775250
ompRp1,0.2,4,4,GGCGAAGTCTCTTCTGTACC,0,2812745
ompRp1,0.2,4,4,GGCCTAGGTAGAGTAGACGT,0,2818076
ompRp1,0.2,4,4,GGCCGGATATTAGGTCAAGG,0,2802559
ompRp1,0.2,4,4,GGCCCTTAGGTATCAGACAC,0,2800748
ompRp1,0.2,4,4,GGCCCATCACATTACAACGA,0,2824188
ompRp1,0.2,4,4,GGCCCACTAGAGACTTACTG,0,2817841
ompRp1,0.2,4,4,GGCCCACCTGGTGCTTTAGC,0,2790073
ompRp1,0.2,4,4,GGCCATGTGACTCTGGGGTT,0,2798521
ompRp1,0.2,4,4,GGCATGAGGAACACTTGGGT,0,2770678
ompRp1,0.2,4,4,GGCACCCTGTTCCCTCCTTC,0,2795988
ompRp1,0.2,4,4,GGCAACCGAGTACAACCGGG,0,2777463
ompRp1,0.2,4,4,GGATTATGCGGGAGGTATAT,0,2812785
ompRp1,0.2,4,4,GGATGTCTTGTTTTTAGGTG,0,2769620
ompRp1,0.2,4,4,GGATGGCCGGGATGCACTAG,0,2790677
ompRp1,0.2,4,4,GGATGCGCTAAGCGATCTGT,0,2821551
ompRp1,0.2,4,4,GGATGCGCGACCGGACCCCC,0,2799304
ompRp1,0.2,4,4,GGATCGTAAGCATGTGTCAT,0,2800902
ompRp1,0.2,4,4,GGATCCCGGTGCGATTTGCG,0,2798123
ompRp1,0.2,4,4,GGATATGTGACTAATAAGGA,0,2776897
ompRp1,0.2,4,4,GGATATCCGTGCGCTGCCGT,0,2787060
ompRp1,0.2,4,4,GGATAGTCCGGTTCCCCGGT,0,2775598
ompRp1,0.2,4,4,GGAGTTCTTCCGTGGTGGTT,0,2789807
ompRp1,0.2,4,4,GGAGTCGTCAGCTGGAAGCT,0,2815791
ompRp1,0.2,4,4,GGAGTCCGCGTGTGCATGGT,0,2769489
ompRp1,0.2,4,4,GGAGTCAGATAAGAACAAAG,0,2808643
ompRp1,0.2,4,4,GGAGGCGCCATGTTTTGACC,0,2804016
ompRp1,0.2,4,4,GGAGACAGGACCCCGTATAG,0,2790575
ompRp1,0.2,4,4,GGACTTTAAAGTCCTCCTGT,0,2821968
ompRp1,0.2,4,4,GGACTTGTCTTTCGTTCTTG,0,2794092
ompRp1,0.2,4,4,GGACTGGCGGACATAACGAA,0,2784943
ompRp1,0.2,4,4,GGACTCTCAGTAACACAGGT,0,2790029
ompRp1,0.2,4,4,GGACCGGGGCCTCAACCTAA,0,2821276
ompRp1,0.2,4,4,GGACCGATGTACAAGGTTGG,0,2802458
ompRp1,0.2,4,4,GGACCCCCGATATTTTCCTG,0,2769834
ompRp1,0.2,4,4,GGACCAAATGCTATTACCCT,0,2804916
ompRp1,0.2,4,4,GGACAGATCACTTAACATGC,0,2821154
ompRp1,0.2,4,4,GGAATTGACTACTTAATCTA,0,2818642
ompRp1,0.2,4,4,GGAATGTGGCGCTTTTTTGG,0,2815550
ompRp1,0.2,4,4,GGAATGATTCCTCTCGTACG,0,2805450
ompRp1,0.2,4,4,GGAAGGACTGCGATCGGGAG,0,2790005
ompRp1,0.2,4,4,GGAACATATCGTCGTCTGAT,0,2796083
ompRp1,0.2,4,4,GGAACAAATGTGTACGCAAA,0,2779615
ompRp1,0.2,4,4,GGAAACCAAAGTTGGACTGA,0,2780334
ompRp1,0.2,4,4,GCTTTGTGGCACGATTTACT,0,2822943
ompRp1,0.2,4,4,GCTTGAGTGCAAAACTCACA,0,2813916
ompRp1,0.2,4,4,GCTTCACTTAGCACCGGGCG,0,2791701
ompRp1,0.2,4,4,GCTTATTTCAGGGGGGATTT,0,2784182
ompRp1,0.2,4,4,GCTTATGGAGCGTCCTGCAG,0,2799801
ompRp1,0.2,4,4,GCTTAGACATGTGATACGAT,0,2775089
ompRp1,0.2,4,4,GCTGTCTGGAAAAGCTCTGA,0,2822162
ompRp1,0.2,4,4,GCTGTCGCTTCAAGATGCTG,0,2768700
ompRp1,0.2,4,4,GCTGGTAGAACCATTACCTT,0,2820625
ompRp1,0.2,4,4,GCTGCACAAACGATAGCAAT,0,2822020
ompRp1,0.2,4,4,GCTCTCGCCAACCAGCGACC,0,2795684
ompRp1,0.2,4,4,GCTCGTTAAACCCAGTTCAC,0,2805707
ompRp1,0.2,4,4,GCTCGTGTTCCAGTTTCTCG,0,2776523
ompRp1,0.2,4,4,GCTCGGTCCTTCTGTGGGAT,0,2782006
ompRp1,0.2,4,4,GCTCGCTCACTAATTTAGTG,0,2775702
ompRp1,0.2,4,4,GCTCGCGCGAATACGTGAAC,0,2792347
ompRp1,0.2,4,4,GCTCGCAGAGGAGGGGTTGT,0,2793359
ompRp1,0.2,4,4,GCTCGATGGCGGCAAAGAAG,0,2806382
ompRp1,0.2,4,4,GCTCGAGTTAGCGGTCCACT,0,2773700
ompRp1,0.2,4,4,GCTCCGGGTACAAAGTCTAA,0,2796388
ompRp1,0.2,4,4,GCTCCGAAGTCAAGCTGAAC,0,2821814
ompRp1,0.2,4,4,GCTCCACCTTTAGCTATCTT,0,2769118
ompRp1,0.2,4,4,GCTCAGTATTTGGTATAATG,0,2784259
ompRp1,0.2,4,4,GCTAGGAGCTAAGGTGGAAG,0,2801977
ompRp1,0.2,4,4,GCTACGCATTCAGGCTTGGC,0,2814641
ompRp1,0.2,4,4,GCGTTTGACATCCGAACCAA,0,2794226
ompRp1,0.2,4,4,GCGTTGTTGAATTTTACTTA,0,2771061
ompRp1,0.2,4,4,GCGTTACAAGCCGAGGAGAC,0,2793164
ompRp1,0.2,4,4,GCGTCTACTGACGGTTTTTC,0,2817426
ompRp1,0.2,4,4,GCGTCAGCAATCGATTGGTC,0,2804698
ompRp1,0.2,4,4,GCGTACAAGTACCGTGGACC,0,2801956
ompRp1,0.2,4,4,GCGGTCTAGCGTCGCTCTAC,0,2807585
ompRp1,0.2,4,4,GCGGGTATGGGTGTCTTCAT,0,2814107
ompRp1,0.2,4,4,GCGGGAACTCTCGGGATTAT,0,2806473
ompRp1,0.2,4,4,GCGGCTATATTTCAACGACA,0,2775317
ompRp1,0.2,4,4,GCGCTTATATTTCGTACTCT,0,2798530
ompRp1,0.2,4,4,GCGCTAGTTACGGACATCCT,0,2784176
ompRp1,0.2,4,4,GCGCCTAGCCCGTAGGAAAA,0,2765993
ompRp1,0.2,4,4,GCGCCGGATTACCGGACTCG,0,2771483
ompRp1,0.2,4,4,GCGCATCTTAGCTGCGCGAA,0,2798013
ompRp1,0.2,4,4,GCGCAACGTCTTCTAATTAA,0,2771014
ompRp1,0.2,4,4,GCGATTTGACGTATGAGTGT,0,2796511
ompRp1,0.2,4,4,GCGATCAAGCACTTGGCTTC,0,2778081
ompRp1,0.2,4,4,GCGAGCGTAGCAAGGACTGC,0,2818962
ompRp1,0.2,4,4,GCGACGCGTGGGATTGGGGA,0,2788218
ompRp1,0.2,4,4,GCGAAGGTGAACGGATTTTG,0,2773761
ompRp1,0.2,4,4,GCCTTGGTTAGGAACGTGTA,0,2776037
ompRp1,0.2,4,4,GCCTTCCCCCACACAGTAAT,0,2770714
ompRp1,0.2,4,4,GCCTCCTATATTAGGCCTCA,0,2773747
ompRp1,0.2,4,4,GCCTACGTTGTGGAAGCCAC,0,2816346
ompRp1,0.2,4,4,GCCTAATCAAAAACATCGGG,0,2815059
ompRp1,0.2,4,4,GCCTAATATTGAACGCAATT,0,2766538
ompRp1,0.2,4,4,GCCGGCGGCTATTGGCGGAG,0,2773610
ompRp1,0.2,4,4,GCCGGAAATACTTATCTCGT,0,2790743
ompRp1,0.2,4,4,GCCGCGTTAGTTGGGACACA,0,2804261
ompRp1,0.2,4,4,GCCCTTAGAGAACTGAGGGT,0,2812386
ompRp1,0.2,4,4,GCCCGTCCGCTGTGACGGTT,0,2818603
ompRp1,0.2,4,4,GCCCGTAATCATATTGTGAT,0,2783824
ompRp1,0.2,4,4,GCCCGGCTTAAAGCAGGTTT,0,2792508
ompRp1,0.2,4,4,GCCCGCAGTGGCTTTACAAT,0,2810409
ompRp1,0.2,4,4,GCCCCCATCTTACGTATCAT,0,2824030
ompRp1,0.2,4,4,GCCCAGCCTTAGGCCCGCAG,0,2808723
ompRp1,0.2,4,4,GCCCACTACTGAAATGACAA,0,2811498
ompRp1,0.2,4,4,GCCAGTTGCAACGTCGCTTA,0,2822642
ompRp1,0.2,4,4,GCCAGTCCTCCAGAGTCGTC,0,2800158
ompRp1,0.2,4,4,GCCAGGCCTAGAGATCCAGC,0,2783532
ompRp1,0.2,4,4,GCCACGAAATGCCTCACTTA,0,2790745
ompRp1,0.2,4,4,GCCACCGACCCTTTCCCGCT,0,2814783
ompRp1,0.2,4,4,GCCACACCACGCATCCGGAT,0,2770909
ompRp1,0.2,4,4,GCATTACTGGTGGTAGGTAG,0,2774357
ompRp1,0.2,4,4,GCATTAATCCCGAGGATGCA,0,2778142
ompRp1,0.2,4,4,GCATCGTCCCGAAGGCGCTA,0,2811613
ompRp1,0.2,4,4,GCAGTTACTACATCGTCCTT,0,2805451
ompRp1,0.2,4,4,GCAGTCATTTTAGACGGTAT,0,2793344
ompRp1,0.2,4,4,GCAGGGATAACTGGTAGGCT,0,2807221
ompRp1,0.2,4,4,GCAGCCCCGTTCATATTATA,0,2814491
ompRp1,0.2,4,4,GCAGAGAACTATTGTTACGA,0,2816724
ompRp1,0.2,4,4,GCACTATTCAGCCGCGTTAA,0,2770369
ompRp1,0.2,4,4,GCACCAATACTTGAATGTAC,0,2790352
ompRp1,0.2,4,4,GCAATTCAAACTCATCAGCC,0,2813797
ompRp1,0.2,4,4,GCAATGGAAGCTCAAGCCGA,0,2817018
ompRp1,0.2,4,4,GCAAGCTGTGGACCAAAGGA,0,2810098
ompRp1,0.2,4,4,GCAAGAAGTTTGTTAGACGG,0,2770866
ompRp1,0.2,4,4,GCAACCATGCACGTGCGAGT,0,2781407
ompRp1,0.2,4,4,GCAAAACCCTTGTGTCCGCT,0,2818184
ompRp1,0.2,4,4,GATTTTCAACTCATTCACAG,0,2809722
ompRp1,0.2,4,4,GATTTCGTCCTTAAGGGCTT,0,2808955
ompRp1,0.2,4,4,GATTGTAAGATAAACGCTTC,0,2772022
ompRp1,0.2,4,4,GATTCGTTGGTGATGCACGA,0,2822618
ompRp1,0.2,4,4,GATTCGGTGGCTGCGGATCT,0,2793295
ompRp1,0.2,4,4,GATGTTGCTTTGTTACACAC,0,2766448
ompRp1,0.2,4,4,GATGTCAGATACGAGGCTAC,0,2784614
ompRp1,0.2,4,4,GATGGTCTAGTGAGGTCTTG,0,2774983
ompRp1,0.2,4,4,GATGGGCTAACCGATAAAGC,0,2766739
ompRp1,0.2,4,4,GATGCTACACGGCATAGAGG,0,2798697
ompRp1,0.2,4,4,GATGCACCAGACGTCGAGGA,0,2790515
ompRp1,0.2,4,4,GATGAGGTATTATCTGTGAG,0,2794680
ompRp1,0.2,4,4,GATCGGGTGTCTTCTGGCCC,0,2800749
ompRp1,0.2,4,4,GATCCTGCTGGCAATACCTT,0,2775466
ompRp1,0.2,4,4,GATCAGGCCTTTTGCTTGCT,0,2817471
ompRp1,0.2,4,4,GATCAGATACAGAGTTCGTT,0,2802574
ompRp1,0.2,4,4,GATACCTAGCGCTGGTGTGA,0,2773783
ompRp1,0.2,4,4,GATAATTTGATAAGTCAGCC,0,2775229
ompRp1,0.2,4,4,GATAATGCGTGAGCGGAGCT,0,2771333
ompRp1,0.2,4,4,GAGTTCGGACGTGGTCGTAG,0,2803064
ompRp1,0.2,4,4,GAGTTCCGAAACCAGACATA,0,2791947
ompRp1,0.2,4,4,GAGTGAGGCGAATACTTCAT,0,2784693
ompRp1,0.2,4,4,GAGTCTAACATCGGTCCTAA,0,2797349
ompRp1,0.2,4,4,GAGTCCGACCTGATGAATTA,0,2783723
ompRp1,0.2,4,4,GAGGTAGTTTAGCATTTGGA,0,2789905
ompRp1,0.2,4,4,GAGGGCGATCCCAGGACTCA,0,2783122
ompRp1,0.2,4,4,GAGGGCCAATCGTCGGCGGG,0,2790982
ompRp1,0.2,4,4,GAGGGACTAAAATCTTTCGT,0,2798790
ompRp1,0.2,4,4,GAGGCCTGTTTTGTACGTGA,0,2805261
ompRp1,0.2,4,4,GAGGCCAGCAGTTAGGCCGT,0,2805633
ompRp1,0.2,4,4,GAGGATTTCGTGTTAGATGA,0,2770057
ompRp1,0.2,4,4,GAGGAGCTAAGAAGGCTCCA,0,2814308
ompRp1,0.2,4,4,GAGCTTTCCCCCACATAAAA,0,2776103
ompRp1,0.2,4,4,GAGCTCGATAATACATATAC,0,2766661
ompRp1,0.2,4,4,GAGCCTCTTAATTTAAACCC,0,2781345
ompRp1,0.2,4,4,GAGCCGAACGTTTCGTTCAT,0,2805441
ompRp1,0.2,4,4,GAGCCATCTAGAGTGCTTAA,0,2770308
ompRp1,0.2,4,4,GAGATCGCGAGGCATGGTCT,0,2800623
ompRp1,0.2,4,4,GAGAGGGGCCAGCGATCTAT,0,2798049
ompRp1,0.2,4,4,GAGAGCCTTGGTCCACTGGC,0,2804723
ompRp1,0.2,4,4,GAGAGAGGATGGGGTTGCCA,0,2792497
ompRp1,0.2,4,4,GAGACCATTCTCTTATATCT,0,2769622
ompRp1,0.2,4,4,GAGAAATATACAGCAATATG,0,2802930
ompRp1,0.2,4,4,GAGAAACAGGTTAGTTCTTC,0,2798228
ompRp1,0.2,4,4,GACTTCCTTGTCAAATGACG,0,2817747
ompRp1,0.2,4,4,GACTTATCGGACCCATCTTC,0,2788524
ompRp1,0.2,4,4,GACTATACAGTTCGTCATTT,0,2781734
ompRp1,0.2,4,4,GACTACTACCAAAGGAGGAA,0,2821489
ompRp1,0.2,4,4,GACTAACTTTGTACGTGTTT,0,2774193
ompRp1,0.2,4,4,GACGTATTCAAAGGTAAGGG,0,2804664
ompRp1,0.2,4,4,GACGTACAGCGATGATGCTC,0,2773093
ompRp1,0.2,4,4,GACGGATACATCCGCATCAG,0,2800466
ompRp1,0.2,4,4,GACGCACTGCAAGCTTTTAA,0,2822133
ompRp1,0.2,4,4,GACCTAGTGATTGATAAACA,0,2775472
ompRp1,0.2,4,4,GACCGTTGGCTTTAGGCTCT,0,2798193
ompRp1,0.2,4,4,GACCGTCTCGGAACCTCGAT,0,2798904
ompRp1,0.2,4,4,GACCGGTCTATCGCCCGACC,0,2800392
ompRp1,0.2,4,4,GACCGCCTGCATGGGGACGG,0,2791118
ompRp1,0.2,4,4,GACCCAGGCTCAGCCTTTGG,0,2796780
ompRp1,0.2,4,4,GACCAAGCGGAATATACAGA,0,2810857
ompRp1,0.2,4,4,GACATAAGCATGATATTATG,0,2789947
ompRp1,0.2,4,4,GACAGATCATCAGGAGTCAG,0,2778419
ompRp1,0.2,4,4,GAATGAACGGGGTCGTCACT,0,2823549
ompRp1,0.2,4,4,GAATCTGACCGCGATTGGGT,0,2819049
ompRp1,0.2,4,4,GAATCATCTTGACTTGGGAC,0,2820310
ompRp1,0.2,4,4,GAAGGAGGGCAAGACACACC,0,2799082
ompRp1,0.2,4,4,GAAGGACGGTGTACTAGCGT,0,2801501
ompRp1,0.2,4,4,GAAGCGCATATTCACGCGAG,0,2782932
ompRp1,0.2,4,4,GAACTGGAGTGCCTATATCC,0,2777069
ompRp1,0.2,4,4,GAACTCATGCCACACCGACC,0,2796993
ompRp1,0.2,4,4,GAACTAAATAGGGATTGGCT,0,2794775
ompRp1,0.2,4,4,GAACGTCTTATGGAGATAAG,0,2804230
ompRp1,0.2,4,4,GAACGCGTTCGACGCCAATC,0,2815189
ompRp1,0.2,4,4,GAACGCCACTTACCGGGATC,0,2809620
ompRp1,0.2,4,4,GAACCCTAGGCGTGATTAGC,0,2787587
ompRp1,0.2,4,4,GAACAGATGTCTGCTTGTCG,0,2768526
ompRp1,0.2,4,4,GAAACTTATCATTAGGGGCA,0,2803838
ompRp1,0.2,4,4,GAAAAGTGAGGAAACGCTTG,0,2796475
ompRp1,0.2,4,4,CTTTTTGGAGTCACCCGGGA,0,2812269
ompRp1,0.2,4,4,CTTTGTATCGTCGGTTATAG,0,2778146
ompRp1,0.2,4,4,CTTTCATGCCAAGGATAAGG,0,2820628
ompRp1,0.2,4,4,CTTTATTAATGATATGGCTT,0,2806512
ompRp1,0.2,4,4,CTTTAGTTCGAGTCGCCATA,0,2783361
ompRp1,0.2,4,4,CTTGTCTATGAGTCCCTGAT,0,2817583
ompRp1,0.2,4,4,CTTGGCGTCGTCGGTTATAG,0,2816682
ompRp1,0.2,4,4,CTTGGCGGTATAAAATGCGC,0,2774247
ompRp1,0.2,4,4,CTTGGACCAGTTGACCGTCA,0,2802621
ompRp1,0.2,4,4,CTTGCACGGAAAGAATCACC,0,2810895
ompRp1,0.2,4,4,CTTCTTATTGCCGGCTTCCC,0,2765696
ompRp1,0.2,4,4,CTTCTGGCAATAGCGTACAC,0,2777700
ompRp1,0.2,4,4,CTTCGCGACGGCTCCCAGGA,0,2806380
ompRp1,0.2,4,4,CTTCGAAGCGGAGTCTGGCC,0,2818378
ompRp1,0.2,4,4,CTTCCGTTAGAACTTTTAAT,0,2781086
ompRp1,0.2,4,4,CTTCATTACGAAGCGGCTAT,0,2786575
ompRp1,0.2,4,4,CTTCATCTTTACTACCGTAT,0,2807569
ompRp1,0.2,4,4,CTTCAATTCGAAGAAGCGTT,0,2821623
ompRp1,0.2,4,4,CTTCAATCGACATTATAAGC,0,2786423
ompRp1,0.2,4,4,CTTATGTAGCTTGTTTTAAT,0,2798517
ompRp1,0.2,4,4,CTTATGGGTAACTTAATCGG,0,2778321
ompRp1,0.2,4,4,CTTATGACAGCGCCATCTAA,0,2772474
ompRp1,0.2,4,4,CTTAGCTTAGTCAGGAGGAC,0,2770417
ompRp1,0.2,4,4,CTTAGCGAGTGAGTCCGTTG,0,2804395
ompRp1,0.2,4,4,CTTACACTGTGTCTCTATTG,0,2765690
ompRp1,0.2,4,4,CTTAATGCATTGTGTTCTCA,0,2806880
ompRp1,0.2,4,4,CTGTTCCGGGAGGTTATCTT,0,2808302
ompRp1,0.2,4,4,CTGTTACACCGTAAACCCTA,0,2796605
ompRp1,0.2,4,4,CTGTGGGTCTGAGTTGGTGA,0,2803655
ompRp1,0.2,4,4,CTGTGGCGAATCGCCCCTAT,0,2783822
ompRp1,0.2,4,4,CTGTGCCGCGAGGGAGGCTA,0,2779479
ompRp1,0.2,4,4,CTGTCGAAAGCATATTGACT,0,2809544
ompRp1,0.2,4,4,CTGTCCTAAGGGGGCCAAAA,0,2778131
ompRp1,0.2,4,4,CTGTCACAATAATAGACCAT,0,2819368
ompRp1,0.2,4,4,CTGGTTCCTAACCCGCTGTA,0,2807294
ompRp1,0.2,4,4,CTGGGGCTATTGGTGGGATC,0,2781098
ompRp1,0.2,4,4,CTGGCGGTGCGACACTAGAG,0,2776080
ompRp1,0.2,4,4,CTGGCCGGAAGCATAAGACA,0,2775829
ompRp1,0.2,4,4,CTGGCAGCCAATACGTATAT,0,2783761
ompRp1,0.2,4,4,CTGGCAATATTATTGACCTA,0,2813605
ompRp1,0.2,4,4,CTGGAATAAATCCTTGCCAA,0,2802001
ompRp1,0.2,4,4,CTGCGTTACAGATTCGTGTG,0,2789114
ompRp1,0.2,4,4,CTGCATCAAAGACACTGCTA,0,2776511
ompRp1,0.2,4,4,CTGCAGTACCGGAGAGTTCC,0,2780118
ompRp1,0.2,4,4,CTGATCAGTCACTTGTCTTT,0,2804464
ompRp1,0.2,4,4,CTGACCGTTCGGACGTATCC,0,2811643
ompRp1,0.2,4,4,CTGAAGTACGATCGGTCGGC,0,2816422
ompRp1,0.2,4,4,CTGAACCGTAATTACGAAGC,0,2795114
ompRp1,0.2,4,4,CTGAACCGCTGCTGTGCTAC,0,2767409
ompRp1,0.2,4,4,CTGAAATATTTTGCCTAGCC,0,2785764
ompRp1,0.2,4,4,CTCTTGAATGCACTTAACTA,0,2798590
ompRp1,0.2,4,4,CTCTGCTATAGAGCGATTTG,0,2767562
ompRp1,0.2,4,4,CTCGTTCGTCATCAGCTCGT,0,2809664
ompRp1,0.2,4,4,CTCGTTCGGGCCTCACAGCG,0,2802308
ompRp1,0.2,4,4,CTCGTACATCATCGGTGCCT,0,2809820
ompRp1,0.2,4,4,CTCGCGTGATTGGACCCCCT,0,2774435
ompRp1,0.2,4,4,CTCGCCACAACGTTTTTGGT,0,2816088
ompRp1,0.2,4,4,CTCCGGCTCGACCATAGGCG,0,2819892
ompRp1,0.2,4,4,CTCCCCTGTCTTGATATCAC,0,2782925
ompRp1,0.2,4,4,CTCATTGCACAAGGTCCAGA,0,2785445
ompRp1,0.2,4,4,CTCAGGACTTCTAGGAAGTT,0,2795107
ompRp1,0.2,4,4,CTCACACGCGCATTGAGTCA,0,2771742
ompRp1,0.2,4,4,CTCAATTACTCAGTCAACGG,0,2813936
ompRp1,0.2,4,4,CTCAACCGCCAATGCAGAAG,0,2780812
ompRp1,0.2,4,4,CTCAAAGGGGCTGGCGCCTC,0,2767616
ompRp1,0.2,4,4,CTATTCAAACGCTTCCGGGG,0,2823962
ompRp1,0.2,4,4,CTATGCAAGTCAGACAACGG,0,2816360
ompRp1,0.2,4,4,CTATGATTTGGAGATCCCCA,0,2816597
ompRp1,0.2,4,4,CTATGAAGGCCCGTCGCTGC,0,2777389
ompRp1,0.2,4,4,CTATCGAGAGCTTCTCTGTT,0,2799438
ompRp1,0.2,4,4,CTATCCGTTGGCATCATCCC,0,2772223
ompRp1,0.2,4,4,CTATATGTAGAGTGGAGATG,0,2802201
ompRp1,0.2,4,4,CTATACCAATGGCAAAGATA,0,2808592
ompRp1,0.2,4,4,CTAGGTATAACTCAAGAGTT,0,2812471
ompRp1,0.2,4,4,CTAGGCTTCCGTACCACAAT,0,2765383
ompRp1,0.2,4,4,CTAGGCATCTGATACTGCTG,0,2773043
ompRp1,0.2,4,4,CTAGCGTAACAGATCGGATG,0,2807204
ompRp1,0.2,4,4,CTAATTGGATCGTAGAGCAA,0,2807208
ompRp1,0.2,4,4,CTAATGACGAAGTTGGTGAT,0,2812992
ompRp1,0.2,4,4,CTAATATCAACTTGCGACAA,0,2776585
ompRp1,0.2,4,4,CTAAGCTTATCCTGCGGCTG,0,2812737
ompRp1,0.2,4,4,CTAACGTATAGGCTGGAACT,0,2788057
ompRp1,0.2,4,4,CGTTGAACACGAGTATGGGT,0,2771573
ompRp1,0.2,4,4,CGTTCCCAGGCCTAAAGTCA,0,2773873
ompRp1,0.2,4,4,CGTTACTGATCTAAATGAAA,0,2789157
ompRp1,0.2,4,4,CGTGGGCTGCTGTTATTCTG,0,2820647
ompRp1,0.2,4,4,CGTGGGCTAGGGACATTAGT,0,2809578
ompRp1,0.2,4,4,CGTGGCTCCTTTGGAGGCGT,0,2768037
ompRp1,0.2,4,4,CGTGGATTAGTCCGATCTTG,0,2811011
ompRp1,0.2,4,4,CGTGAAGGTCAAAGTTCCCC,0,2802938
ompRp1,0.2,4,4,CGTGAAAGATCAAGGACAAT,0,2783584
ompRp1,0.2,4,4,CGTCTTTTCTTACTGCCCGA,0,2792646
ompRp1,0.2,4,4,CGTCTTTACAAGCGACTAAG,0,2785193
ompRp1,0.2,4,4,CGTCTTGACCCAGTAAACGA,0,2769951
ompRp1,0.2,4,4,CGTCGTCCGAGAGATAGTTA,0,2781914
ompRp1,0.2,4,4,CGTCCTAGCGGTAACTTTCC,0,2803139
ompRp1,0.2,4,4,CGTCCCGGGCTGCTCTGTTC,0,2797203
ompRp1,0.2,4,4,CGTATGGTCGGTATGTCTTC,0,2794612
ompRp1,0.2,4,4,CGTATCGGAGATGAACGATG,0,2788324
ompRp1,0.2,4,4,CGTATCAGGAAGTGCCCCCT,0,2782328
ompRp1,0.2,4,4,CGTATAAGCGACTTGGTCCA,0,2793059
ompRp1,0.2,4,4,CGGTTGGATCGATCTAGTCT,0,2766520
ompRp1,0.2,4,4,CGGTTGCGTGCTTTGCAAAA,0,2765368
ompRp1,0.2,4,4,CGGTGTCGCGGACGATACTG,0,2817081
ompRp1,0.2,4,4,CGGTGCATGCTCGCATATCT,0,2796387
ompRp1,0.2,4,4,CGGTGCACAAAGTCTAAACA,0,2797918
ompRp1,0.2,4,4,CGGTATGGGAATTTGATATA,0,2810863
ompRp1,0.2,4,4,CGGTATCGGTTCGCCTCCGA,0,2765865
ompRp1,0.2,4,4,CGGTAGAATCCGCGAAACTG,0,2802216
ompRp1,0.2,4,4,CGGGCTGTCCTCCCCTTGCA,0,2799885
ompRp1,0.2,4,4,CGGGCCGTGAAAGAGGCTTG,0,2780996
ompRp1,0.2,4,4,CGGGCATGCGCACATACGAC,0,2791769
ompRp1,0.2,4,4,CGGGAGTCCTATGCAAGCAG,0,2771112
ompRp1,0.2,4,4,CGGGAGGCGTGAACCGTTTC,0,2791082
ompRp1,0.2,4,4,CGGGACAAGGTTTCAGTTGA,0,2802605
ompRp1,0.2,4,4,CGGGAATTGCGTGAATCATA,0,2819588
ompRp1,0.2,4,4,CGGCTTGAGTTTTAGGCGGC,0,2814990
ompRp1,0.2,4,4,CGGCTGTACGTGTGGCACCG,0,2815500
ompRp1,0.2,4,4,CGGCTACCGTTTTTGTACAC,0,2787341
ompRp1,0.2,4,4,CGGCTAATGCGTGTTCAGGG,0,2770155
ompRp1,0.2,4,4,CGGCGGGAACACTGGCGAGT,0,2801744
ompRp1,0.2,4,4,CGGCGGCCTACGATTCTTTA,0,2816295
ompRp1,0.2,4,4,CGGCCCAGGCCTGGGAAAAC,0,2812385
ompRp1,0.2,4,4,CGGCCAGCTACAACCGATTC,0,2796263
ompRp1,0.2,4,4,CGGCCAAGTGTTGCCTTATT,0,2808298
ompRp1,0.2,4,4,CGGCACAATCCGGGAAGTGC,0,2783389
ompRp1,0.2,4,4,CGGCAAAGGATTAAGAAGGA,0,2803512
ompRp1,0.2,4,4,CGGATAACTCACGGCTAAGT,0,2768018
ompRp1,0.2,4,4,CGGAGCCACTGACACAATCA,0,2782089
ompRp1,0.2,4,4,CGGAGAAGGGTCAGCGGTGT,0,2819819
ompRp1,0.2,4,4,CGGACCTATCGGGTGGGAAC,0,2778268
ompRp1,0.2,4,4,CGCTCTTTCCGAGGACATGC,0,2799763
ompRp1,0.2,4,4,CGCTAATTCGCACATATGCA,0,2814790
ompRp1,0.2,4,4,CGCTAACTCTTGTGTAAGCT,0,2768552
ompRp1,0.2,4,4,CGCGTATTTGAATTGGTTGG,0,2770514
ompRp1,0.2,4,4,CGCGTATGAATAAGTCTAAT,0,2785799
ompRp1,0.2,4,4,CGCGTAGAAAATAAGGCTTC,0,2790937
ompRp1,0.2,4,4,CGCGGGCTAGAATCCCGGAC,0,2793682
ompRp1,0.2,4,4,CGCGCGCCAAGTGGCGTTAC,0,2785473
ompRp1,0.2,4,4,CGCCTGGAACTTAGACGGGA,0,2787266
ompRp1,0.2,4,4,CGCCGCAGAGCCGTAGCAGC,0,2784991
ompRp1,0.2,4,4,CGCCCGTCGTCGGTCGGACC,0,2810343
ompRp1,0.2,4,4,CGCCACTTAGCTACTGCGTC,0,2802641
ompRp1,0.2,4,4,CGCCAACATTATCGTATGTG,0,2817587
ompRp1,0.2,4,4,CGCATCGCTGACAATATAAT,0,2792088
ompRp1,0.2,4,4,CGCATCCAGTCTACCACTGA,0,2795353
ompRp1,0.2,4,4,CGCAGGGGTTGCAGTATGCT,0,2824595
ompRp1,0.2,4,4,CGCAGAGTATGTTGGAGCAT,0,2776916
ompRp1,0.2,4,4,CGCACTCGCGTCTCCAAAAG,0,2805871
ompRp1,0.2,4,4,CGCACTCGAAGAGAATAGTA,0,2779359
ompRp1,0.2,4,4,CGCACAGAGAGATTACAGAT,0,2812742
ompRp1,0.2,4,4,CGATTTTTCACTTCCGAGAA,0,2772289
ompRp1,0.2,4,4,CGATTTAAAGTCGCAAGCTG,0,2777004
ompRp1,0.2,4,4,CGATGTAATGCCACCGTTTA,0,2813167
ompRp1,0.2,4,4,CGATGCTCTACACCAGCGGT,0,2806482
ompRp1,0.2,4,4,CGATCTGCACGCCGTTCCTG,0,2767636
ompRp1,0.2,4,4,CGATCTCACCCGCACTCGGT,0,2812920
ompRp1,0.2,4,4,CGATATACACGATTCAGCTG,0,2791458
ompRp1,0.2,4,4,CGATAGATTACTTTCAGCAC,0,2816262
ompRp1,0.2,4,4,CGAGTTCCTCCGCCCCTCGT,0,2789598
ompRp1,0.2,4,4,CGAGTGGTCATTCTGGGGCT,0,2766144
ompRp1,0.2,4,4,CGAGTATGTTCGGACTATAT,0,2821879
ompRp1,0.2,4,4,CGAGCGGTATTCATGCCGTT,0,2773694
ompRp1,0.2,4,4,CGAGCAGTAGAATTCCGCAA,0,2795228
ompRp1,0.2,4,4,CGAGAAAACCTGTTGGCGGG,0,2801581
ompRp1,0.2,4,4,CGACGGCACATCTCGGTACT,0,2794291
ompRp1,0.2,4,4,CGACGCGGGGGTTCAATCGA,0,2824183
ompRp1,0.2,4,4,CGACGCAAAGCTTTCGTGTT,0,2774116
ompRp1,0.2,4,4,CGACAGAAGTGAATGGATAT,0,2812822
ompRp1,0.2,4,4,CGACACCGCTCCGTTATAGC,0,2815302
ompRp1,0.2,4,4,CGAATGGGCTTAAGCGCAGA,0,2804015
ompRp1,0.2,4,4,CGAATCTATCGCCCGCTCGT,0,2811021
ompRp1,0.2,4,4,CGAACCCGCTGCATTGCGGT,0,2807220
ompRp1,0.2,4,4,CGAAAAGGCGAGAAGCAGAA,0,2820084
ompRp1,0.2,4,4,CCTTTGGTCACCTCGTATGC,0,2796141
ompRp1,0.2,4,4,CCTTTGGATGGACGGAACAT,0,2773293
ompRp1,0.2,4,4,CCTTTCCGGTAAGTGAGGCC,0,2782859
ompRp1,0.2,4,4,CCTTGTTTTGCGCACCTTAC,0,2790679
ompRp1,0.2,4,4,CCTTCTGGTAGAGGGTAGCT,0,2795616
ompRp1,0.2,4,4,CCTTCGCTGGCAGCGGCTTT,0,2766662
ompRp1,0.2,4,4,CCTTCCCGGATATCTAATGA,0,2824427
ompRp1,0.2,4,4,CCTTATGCACCAGGCCTGCT,0,2805221
ompRp1,0.2,4,4,CCTTAGTGTTAGGTAATCTA,0,2780332
ompRp1,0.2,4,4,CCTGTGTAATGACACGGTGG,0,2798906
ompRp1,0.2,4,4,CCTGGTCAATCACCTCGTCG,0,2791780
ompRp1,0.2,4,4,CCTGCGAGCACTAACGCGGC,0,2821300
ompRp1,0.2,4,4,CCTGCCGCTACTGGATACTA,0,2805025
ompRp1,0.2,4,4,CCTGAGCTCAGCAAATCGTA,0,2803850
ompRp1,0.2,4,4,CCTCCCCGCAAACGCACCTA,0,2808825
ompRp1,0.2,4,4,CCTCATTGCCGCGCATACCA,0,2767869
ompRp1,0.2,4,4,CCTCAAGGCATACATCGATG,0,2788590
ompRp1,0.2,4,4,CCTATGTTAGGATATCTCTA,0,2773195
ompRp1,0.2,4,4,CCTAGTTTTGGATGTCGATG,0,2815501
ompRp1,0.2,4,4,CCTACTGCTCGTGTTGAACG,0,2811019
ompRp1,0.2,4,4,CCTAACGATGTTCCCACTCC,0,2821338
ompRp1,0.2,4,4,CCGTTTTTGCTTGCCACGCC,0,2793199
ompRp1,0.2,4,4,CCGTTGTATGGTACACCTGG,0,2800643
ompRp1,0.2,4,4,CCGTTCACTGTCGGAACCCC,0,2778941
ompRp1,0.2,4,4,CCGTGCGCGGGGTCCTTCCG,0,2772412
ompRp1,0.2,4,4,CCGTATCATGGCCGGAAAGT,0,2802997
ompRp1,0.2,4,4,CCGTACAGGTAACATATCGA,0,2792434
ompRp1,0.2,4,4,CCGGGCGAAGACGGTGATGA,0,2787183
ompRp1,0.2,4,4,CCGGGCCTAAGCGGGGAGCG,0,2788355
ompRp1,0.2,4,4,CCGGCAGTAGCGCGCTGTCT,0,2816712
ompRp1,0.2,4,4,CCGCTGCGTAACATCTCTGA,0,2800133
ompRp1,0.2,4,4,CCGCAGGTCTTTTCCTGTTA,0,2768366
ompRp1,0.2,4,4,CCGCAACGAACATAGGAGAG,0,2799583
ompRp1,0.2,4,4,CCGATCTCCCTCGTCGGATA,0,2787863
ompRp1,0.2,4,4,CCGAGTGTCCGGGGAAGATT,0,2810590
ompRp1,0.2,4,4,CCGAAAACTGGCCTTGGTGC,0,2775094
ompRp1,0.2,4,4,CCCTTATCCAATAAATCTCG,0,2821407
ompRp1,0.2,4,4,CCCTGTGTATTTTTATGGCT,0,2801096
ompRp1,0.2,4,4,CCCTGGCCTACGCATTTACA,0,2819480
ompRp1,0.2,4,4,CCCTGCGACTATAAAGTCCT,0,2810526
ompRp1,0.2,4,4,CCCTCGGACCGTTGATTCTG,0,2787541
ompRp1,0.2,4,4,CCCGTGCGACACTGAACCTA,0,2821190
ompRp1,0.2,4,4,CCCGGGTCTTGACAGCGTCA,0,2777502
ompRp1,0.2,4,4,CCCGGCGCCAACCGATCTCG,0,2806186
ompRp1,0.2,4,4,CCCGGCCATAGTGATACACA,0,2811167
ompRp1,0.2,4,4,CCCGCTTCGCTTCTCGGGAA,0,2808828
ompRp1,0.2,4,4,CCCGATCGAGCATGGGATCA,0,2774681
ompRp1,0.2,4,4,CCCGATACTCCAGGGGACTA,0,2780497
ompRp1,0.2,4,4,CCCGAAGTAAAAAGGCAGGT,0,2812706
ompRp1,0.2,4,4,CCCGAAATCCGTCTTTTACG,0,2809960
ompRp1,0.2,4,4,CCCCTCCACTCGGGTGGAGT,0,2766295
ompRp1,0.2,4,4,CCCCTAGGGACCTCTAAACG,0,2768981
ompRp1,0.2,4,4,CCCCGATCGTCCGCTTTTTT,0,2779537
ompRp1,0.2,4,4,CCCCCCGTTGACATAACAGT,0,2796181
ompRp1,0.2,4,4,CCCATCCCCAGGTGGTGTGG,0,2807182
ompRp1,0.2,4,4,CCCATAGTGATCGCGCGACA,0,2765546
ompRp1,0.2,4,4,CCCAAGGTCACGTGTACGAT,0,2767373
ompRp1,0.2,4,4,CCATTCCATGTGCACCTGTT,0,2797406
ompRp1,0.2,4,4,CCATTATGCCCAACCCTTAT,0,2791445
ompRp1,0.2,4,4,CCATTAGAAACAAGTGGGGG,0,2790647
ompRp1,0.2,4,4,CCATGGAGAGCGTCTTGGCA,0,2806519
ompRp1,0.2,4,4,CCATCAGCCTTATAAACGGG,0,2765510
ompRp1,0.2,4,4,CCATCAACGAGGAGGTTTCA,0,2781579
ompRp1,0.2,4,4,CCATAGGTGCTGCACTGTAA,0,2794230
ompRp1,0.2,4,4,CCATAGGGAAGGAGAGTGTG,0,2770466
ompRp1,0.2,4,4,CCAGTCGGCACTCGAAAAAC,0,2799189
ompRp1,0.2,4,4,CCAGGCTAACCTGTCATGTC,0,2813422
ompRp1,0.2,4,4,CCAGCTAAAATTCAGAACCC,0,2796593
ompRp1,0.2,4,4,CCAGAGCAAAATGGTTATAG,0,2799672
ompRp1,0.2,4,4,CCACTGCTTCGAGGCCGGCG,0,2786415
ompRp1,0.2,4,4,CCACGGTATACATCGCCGGC,0,2801925
ompRp1,0.2,4,4,CCACCGGGATCTACAGTAGT,0,2823657
ompRp1,0.2,4,4,CCACACGGAAAGAGTGGGAC,0,2815566
ompRp1,0.2,4,4,CCAATTTGGATTTAAGTGGG,0,2792609
ompRp1,0.2,4,4,CCAAGGGCTTAGTCTAATAA,0,2767910
ompRp1,0.2,4,4,CCAAGCCCATGCACTTCATC,0,2811456
ompRp1,0.2,4,4,CCAAATACTGGCTCAAGCCA,0,2772073
ompRp1,0.2,4,4,CCAAAGATGGAAGTCAAATG,0,2824228
ompRp1,0.2,4,4,CATTTGTAACTTTAGTCCTC,0,2769910
ompRp1,0.2,4,4,CATTTCTCTGCGTCTGTTTT,0,2772470
ompRp1,0.2,4,4,CATTCAGCATCTATGAGGAA,0,2796292
ompRp1,0.2,4,4,CATTATGAGCCATCTACATA,0,2810186
ompRp1,0.2,4,4,CATTATCGCAAAGTGCGAAT,0,2800826
ompRp1,0.2,4,4,CATGTTCACCGTGGCGCGCA,0,2771588
ompRp1,0.2,4,4,CATGGGTGTAAATGTGTTGT,0,2781141
ompRp1,0.2,4,4,CATGAGGCGCGGCAATCAAA,0,2793836
ompRp1,0.2,4,4,CATCTACGTGTGGGCGTAAT,0,2798194
ompRp1,0.2,4,4,CATCGGTGTGCAGTGCCATG,0,2792075
ompRp1,0.2,4,4,CATCGGACGCAAGTGATGTT,0,2801932
ompRp1,0.2,4,4,CATCGGAATTACAATGGGGG,0,2811764
ompRp1,0.2,4,4,CATCCGAATCAAGACAAGTT,0,2778764
ompRp1,0.2,4,4,CATCAGGGGCCATAAGGAGA,0,2792308
ompRp1,0.2,4,4,CATCACGCTCCTTGGTTTAA,0,2813685
ompRp1,0.2,4,4,CATATAAATTAGAAACTTGT,0,2801335
ompRp1,0.2,4,4,CATAGTTCACGCGCCGAGCA,0,2788188
ompRp1,0.2,4,4,CATAGACCGTAGGTACAAGC,0,2786498
ompRp1,0.2,4,4,CATACTTACACTACGGCCTT,0,2800337
ompRp1,0.2,4,4,CATACGTGCAGAGCCAACAA,0,2796261
ompRp1,0.2,4,4,CATACGACCGTGGGTTAACA,0,2780358
ompRp1,0.2,4,4,CATAAACATTGCACTCCGCA,0,2809833
ompRp1,0.2,4,4,CAGTTGGTCCAACGATAAAA,0,2769788
ompRp1,0.2,4,4,CAGTTGACCTGAACGACAAC,0,2785365
ompRp1,0.2,4,4,CAGTGCCAAATTACGGATAC,0,2800505
ompRp1,0.2,4,4,CAGTCCAGCATGGCTCACTT,0,2792551
ompRp1,0.2,4,4,CAGTCCACTCGGTGGTTGGA,0,2787431
ompRp1,0.2,4,4,CAGGTTGCCACGGCCACAGA,0,2779165
ompRp1,0.2,4,4,CAGGTCTATCCTCGCGGACT,0,2809395
ompRp1,0.2,4,4,CAGGCTGTTTGTGACGTGGT,0,2802739
ompRp1,0.2,4,4,CAGGCCATGTGAGACGTCGC,0,2823564
ompRp1,0.2,4,4,CAGGATCATAGTTGTACTTA,0,2806329
ompRp1,0.2,4,4,CAGCGGTATGGGGTTTATTT,0,2806037
ompRp1,0.2,4,4,CAGCGAACTGTATTCATATG,0,2824579
ompRp1,0.2,4,4,CAGCCTTACGTTTGACTATC,0,2770005
ompRp1,0.2,4,4,CAGCCCCGGCCTGTCTGTTG,0,2820178
ompRp1,0.2,4,4,CAGACTTGCGTTTAACAGCT,0,2792168
ompRp1,0.2,4,4,CAGACCCATTTATGATTGGT,0,2817306
ompRp1,0.2,4,4,CAGAAAACATTTACTTCTAC,0,2800097
ompRp1,0.2,4,4,CACTTTATGGGAGGTTCGTA,0,2803378
ompRp1,0.2,4,4,CACTTCTCGGCTATGTAGTC,0,2785517
ompRp1,0.2,4,4,CACTTAGTGTTCGGACCCAA,0,2776355
ompRp1,0.2,4,4,CACTGGCGGTTCTTTTGGCG,0,2815473
ompRp1,0.2,4,4,CACTCTCCTACAAGGTCGAT,0,2817265
ompRp1,0.2,4,4,CACTCGGTGCTATGTCATAT,0,2802488
ompRp1,0.2,4,4,CACTCCCGGGTTTCGAGGGT,0,2802290
ompRp1,0.2,4,4,CACGGGGACACGAGTAGCTG,0,2794839
ompRp1,0.2,4,4,CACGCGCGCGTGGGTACGGG,0,2784807
ompRp1,0.2,4,4,CACGCCTTAAGGTAATGGGT,0,2807336
ompRp1,0.2,4,4,CACGAGACGGGCCATTTTCA,0,2770638
ompRp1,0.2,4,4,CACCTCAAACGTAGTTGGAG,0,2808481
ompRp1,0.2,4,4,CACCCTGTTGTCTTACAGGT,0,2778324
ompRp1,0.2,4,4,CACCCGAGAATATAGAGCTT,0,2792849
ompRp1,0.2,4,4,CACCACATTCTTGGGCCTAG,0,2773543
ompRp1,0.2,4,4,CACATGAAGATCGGTTTTGG,0,2816747
ompRp1,0.2,4,4,CACATCAGAGTGCGAATCCA,0,2799407
ompRp1,0.2,4,4,CACATAGGCGCCACACCTTG,0,2768836
ompRp1,0.2,4,4,CACAGATCGGTATGTGGTAT,0,2774020
ompRp1,0.2,4,4,CACACCGCCATTGTGGACCT,0,2800058
ompRp1,0.2,4,4,CAATCTTCAGAGCTTTCGAG,0,2765890
ompRp1,0.2,4,4,CAATCGCAAACCTGAGGGGT,0,2822727
ompRp1,0.2,4,4,CAAGGGCTTAACATGGCTTG,0,2776393
ompRp1,0.2,4,4,CAACGTTTTTTGAGATCCAG,0,2822751
ompRp1,0.2,4,4,CAACGCTGGTACGGTCGGGA,0,2805778
ompRp1,0.2,4,4,CAACCGATGATTCTGTATGG,0,2771953
ompRp1,0.2,4,4,CAACATGTTGGGCTCGGGCG,0,2811766
ompRp1,0.2,4,4,CAAAGGCGTCCGCCGGAGCA,0,2781601
ompRp1,0.2,4,4,CAAAGGAACGTCAAGGCTCA,0,2805357
ompRp1,0.2,4,4,CAAAGACGAGGCTCCGTTAG,0,2780680
ompRp1,0.2,4,4,CAAACGTAGGGATCTTGTCG,0,2778589
ompRp1,0.2,4,4,CAAAAGAACGACTGGCGTAG,0,2808609
ompRp1,0.2,4,4,CAAAACTAAGGCTAAAGAGT,0,2795457
ompRp1,0.2,4,4,ATTTTAGCACATGGATACTA,0,2788618
ompRp1,0.2,4,4,ATTTGTCGTGTAAGGGTATC,0,2818542
ompRp1,0.2,4,4,ATTTGTAAAGTTGAGGAGCA,0,2818791
ompRp1,0.2,4,4,ATTTGGGTCTTATTATGGTG,0,2814675
ompRp1,0.2,4,4,ATTTCTCAAACGGATTCTAT,0,2791836
ompRp1,0.2,4,4,ATTTCGCGGGCGGCGCCCGC,0,2777192
ompRp1,0.2,4,4,ATTTCCTCGTAAATTCTTTT,0,2797522
ompRp1,0.2,4,4,ATTTCCGACTGTATCCGATA,0,2791406
ompRp1,0.2,4,4,ATTTATGAAAAACGGCCTAA,0,2805453
ompRp1,0.2,4,4,ATTTACAGTACAGACGTGCC,0,2769494
ompRp1,0.2,4,4,ATTTAAGGCGGCAGTGTGAA,0,2790838
ompRp1,0.2,4,4,ATTGGACACGACGAGCGATG,0,2803101
ompRp1,0.2,4,4,ATTGCTAATCTGTACGCAAA,0,2803805
ompRp1,0.2,4,4,ATTCGTCCTCTACTCGTACA,0,2785537
ompRp1,0.2,4,4,ATTCCTGCTCATCATGTCCA,0,2781779
ompRp1,0.2,4,4,ATTCCTCACTTGACGACCTA,0,2821301
ompRp1,0.2,4,4,ATTATCATGGTATCCTACAA,0,2781643
ompRp1,0.2,4,4,ATTATCATAATCCAAACCTA,0,2807023
ompRp1,0.2,4,4,ATTAGTCACCTAGCGGGACT,0,2778664
ompRp1,0.2,4,4,ATTAGCTAAAACTCAAGGGA,0,2822946
ompRp1,0.2,4,4,ATTACGATGGTTAATTCGAC,0,2783331
ompRp1,0.2,4,4,ATTACCTCCATCAGCCTCTG,0,2803505
ompRp1,0.2,4,4,ATTAAGGCGATTCCGGCAAC,0,2794557
ompRp1,0.2,4,4,ATTAACTTACATGGGCGGTA,0,2777314
ompRp1,0.2,4,4,ATTAACGGATATTGACCGGG,0,2779235
ompRp1,0.2,4,4,ATGTTTATTCGAGGGGAAGG,0,2798095
ompRp1,0.2,4,4,ATGTGGCCGACTTAGCACAA,0,2767203
ompRp1,0.2,4,4,ATGTGACAAAACCCTGCGGC,0,2807194
ompRp1,0.2,4,4,ATGTCGGAACCGCGTATGGG,0,2819788
ompRp1,0.2,4,4,ATGTATGAAGCGCTATAGGG,0,2785686
ompRp1,0.2,4,4,ATGTAGGGCTGAGACTTAAT,0,2822378
ompRp1,0.2,4,4,ATGTAATGCCGGCCTACATA,0,2824135
ompRp1,0.2,4,4,ATGGGTCTAACGGAACACAT,0,2817121
ompRp1,0.2,4,4,ATGGGACCCAATGTGCTGAA,0,2791083
ompRp1,0.2,4,4,ATGGCTCGCGCACTCCGCTG,0,2806268
ompRp1,0.2,4,4,ATGGCCGAGATTCGGTATTA,0,2789711
ompRp1,0.2,4,4,ATGGCAGGTGGTTAGCATGT,0,2770551
ompRp1,0.2,4,4,ATGGAAGCCAGTCCAGAGAG,0,2795404
ompRp1,0.2,4,4,ATGCCTTTCTGTATCACACA,0,2814151
ompRp1,0.2,4,4,ATGCCCGATGGGTGCCTATA,0,2815889
ompRp1,0.2,4,4,ATGCATGGGTATTTAATCGT,0,2800327
ompRp1,0.2,4,4,ATGCACACATACTCAAGCTC,0,2818251
ompRp1,0.2,4,4,ATGCAACGCCCAGCAGATCC,0,2801441
ompRp1,0.2,4,4,ATGAGCTATTAGTTGAGGTG,0,2790143
ompRp1,0.2,4,4,ATGAGATAACATTGACACCC,0,2778048
ompRp1,0.2,4,4,ATGAGAGTAACTTCAGTCGG,0,2802860
ompRp1,0.2,4,4,ATGACTTCATACTGATTCCG,0,2816980
ompRp1,0.2,4,4,ATCTTAATTACTTGTGTGTT,0,2792871
ompRp1,0.2,4,4,ATCTGCGAAAAGGACTTGTG,0,2791124
ompRp1,0.2,4,4,ATCTGATCCAATTTTGAGAC,0,2813094
ompRp1,0.2,4,4,ATCTGATAACGCAGTTTAAA,0,2778685
ompRp1,0.2,4,4,ATCTCAGCGAAGTATAGTCA,0,2797878
ompRp1,0.2,4,4,ATCTATGCCTGTCTTGATAA,0,2796368
ompRp1,0.2,4,4,ATCTACCAATTCACATGGAT,0,2820039
ompRp1,0.2,4,4,ATCGTCGTGTTTCAAGAACG,0,2769149
ompRp1,0.2,4,4,ATCGTACCATCGTTCGGACG,0,2797725
ompRp1,0.2,4,4,ATCGTAAACGCGGGGATATT,0,2770587
ompRp1,0.2,4,4,ATCGGGCTGGAAAGATAAAT,0,2810260
ompRp1,0.2,4,4,ATCGCTATTAAAACGTAATT,0,2765303
ompRp1,0.2,4,4,ATCGCGAGGAAGACACGGCC,0,2808271
ompRp1,0.2,4,4,ATCCTTTCCCTTTGTGAGCG,0,2804480
ompRp1,0.2,4,4,ATCCTCGCAAGGAAGGCATG,0,2821690
ompRp1,0.2,4,4,ATCCTACACGGCGAAAAGCA,0,2819176
ompRp1,0.2,4,4,ATCCTAAAGCGTACTCTTCC,0,2816038
ompRp1,0.2,4,4,ATCCGAGGAATAGCATGCTG,0,2813828
ompRp1,0.2,4,4,ATCATCCCGAGACTGGAGTA,0,2804298
ompRp1,0.2,4,4,ATCAGTGGGGCGGAGAAACT,0,2804557
ompRp1,0.2,4,4,ATCACTATCTTCCCTACAAT,0,2799256
ompRp1,0.2,4,4,ATCACCAGCCGACATGAGGC,0,2805803
ompRp1,0.2,4,4,ATATTGTGGTCGTCGCGAGA,0,2824570
ompRp1,0.2,4,4,ATATTAGTCTCGCCCTTAAG,0,2818552
ompRp1,0.2,4,4,ATATGGTGCGGGATGAACCA,0,2805065
ompRp1,0.2,4,4,ATATGGGTACAGACCGTTGC,0,2807945
ompRp1,0.2,4,4,ATAGTTTTAGTCCTCTACCT,0,2787343
ompRp1,0.2,4,4,ATAGAGGTTGATTTTACGCC,0,2790993
ompRp1,0.2,4,4,ATAGACATTGAGGAGGCGGT,0,2770634
ompRp1,0.2,4,4,ATACATCGGGTCATGGCGGG,0,2783908
ompRp1,0.2,4,4,ATACACCCAATCCCTCCACT,0,2789984
ompRp1,0.2,4,4,ATACACAGAGCTAGTTAGAA,0,2812826
ompRp1,0.2,4,4,ATAATTGCCGGCAGACTGGC,0,2776978
ompRp1,0.2,4,4,ATAAGTACACTCCAAGGATA,0,2802882
ompRp1,0.2,4,4,ATAACGGTGGCCTATCGGTG,0,2789816
ompRp1,0.2,4,4,ATAACGACTAGATGACGAAA,0,2783079
ompRp1,0.2,4,4,ATAACGAACCGGGAAAGGCT,0,2808537
ompRp1,0.2,4,4,ATAACCTGCGTCCGATTTGG,0,2822060
ompRp1,0.2,4,4,ATAAATTGTGACCAATCTGT,0,2800937
ompRp1,0.2,4,4,ATAAAGGGGATTTCTCGGAT,0,2795294
ompRp1,0.2,4,4,AGTTGACGTGGGGAGTCCCT,0,2815204
ompRp1,0.2,4,4,AGTTCTACGGTAATGGCGTA,0,2771497
ompRp1,0.2,4,4,AGTTATCAATTGTAGTTCAG,0,2770509
ompRp1,0.2,4,4,AGTTACATAGGCAAAGCGGG,0,2816033
ompRp1,0.2,4,4,AGTGGGCTCGACCTAGGAGT,0,2815854
ompRp1,0.2,4,4,AGTGGCTTTTGCGTTCGTGA,0,2799728
ompRp1,0.2,4,4,AGTGCTGTGGAAGAGGAGGA,0,2785637
ompRp1,0.2,4,4,AGTGCTATCCACCGCTCGGT,0,2776620
ompRp1,0.2,4,4,AGTGATATTGTGATGGATGG,0,2805172
ompRp1,0.2,4,4,AGTGAAGTTCCTCGGTATGA,0,2814310
ompRp1,0.2,4,4,AGTCGCTAGTAGAGCGAGAG,0,2794449
ompRp1,0.2,4,4,AGTCCTACGGTGGGGACATA,0,2779207
ompRp1,0.2,4,4,AGTCCGCTGAGTGGTCGAGC,0,2811969
ompRp1,0.2,4,4,AGTCATAATGGGGCGACGTA,0,2786163
ompRp1,0.2,4,4,AGTCAGGATGGACTTATCCA,0,2809121
ompRp1,0.2,4,4,AGTATAGTTGACAGTTTTCC,0,2803015
ompRp1,0.2,4,4,AGGTTGAATAGATTGGAGTC,0,2806648
ompRp1,0.2,4,4,AGGTTCGGGTACCGTGGAAG,0,2789068
ompRp1,0.2,4,4,AGGTTACCGCCGTGCAGGTT,0,2766092
ompRp1,0.2,4,4,AGGTGTACTTACTGAATCGG,0,2778049
ompRp1,0.2,4,4,AGGTCTTGAGAAGCTGCACA,0,2806281
ompRp1,0.2,4,4,AGGTATACAGAAGACCGCCC,0,2822699
ompRp1,0.2,4,4,AGGGTTCTTCTACTAATGGT,0,2803155
ompRp1,0.2,4,4,AGGGGAATAGGACGCCCGCA,0,2800590
ompRp1,0.2,4,4,AGGGCTAGATCAGTACTTCC,0,2773943
ompRp1,0.2,4,4,AGGGCGATCTCCCAATGTGT,0,2766665
ompRp1,0.2,4,4,AGGGCAACACGGATCTTCCA,0,2815610
ompRp1,0.2,4,4,AGGGAATTAATCTTTCTTTA,0,2781079
ompRp1,0.2,4,4,AGGCTGAAGGCCACTGGTAG,0,2783346
ompRp1,0.2,4,4,AGGCGATACAGTACGTCTAG,0,2769641
ompRp1,0.2,4,4,AGGCCTGAAACGTGCAGAAT,0,2818263
ompRp1,0.2,4,4,AGGCAAGACCTGACTACGGT,0,2772733
ompRp1,0.2,4,4,AGGATGCAATGCTTCGTGTA,0,2766886
ompRp1,0.2,4,4,AGGAACGCCGCCTCGAGGTT,0,2807218
ompRp1,0.2,4,4,AGCTCTTGTATTCTGGATGC,0,2785145
ompRp1,0.2,4,4,AGCTCTTCCTAACTCCTTCT,0,2770224
ompRp1,0.2,4,4,AGCTCTACTCCGGCCCGGTA,0,2775225
ompRp1,0.2,4,4,AGCTCGGGTCGGGACATTAA,0,2814879
ompRp1,0.2,4,4,AGCTCCAAACTGTGGGTTTG,0,2771206
ompRp1,0.2,4,4,AGCTAAACTTGATAACAGTG,0,2784504
ompRp1,0.2,4,4,AGCGTTGCCGGTTGTTTAAT,0,2803453
ompRp1,0.2,4,4,AGCGTGTAACTACTGGCACT,0,2783422
ompRp1,0.2,4,4,AGCGTGCGAAATTACCTCAC,0,2774851
ompRp1,0.2,4,4,AGCGTCTGGGGAGGAATAAG,0,2767687
ompRp1,0.2,4,4,AGCGGGCTCTAAGGGGATCA,0,2816523
ompRp1,0.2,4,4,AGCGGCGCCCTTCTGATAAT,0,2791112
ompRp1,0.2,4,4,AGCGCGGGCCACACAACTAA,0,2808485
ompRp1,0.2,4,4,AGCCTGCTAACGGGGTAAGG,0,2806436
ompRp1,0.2,4,4,AGCCGCAGGTTCTGGGACCC,0,2789175
ompRp1,0.2,4,4,AGCCAGTAGGGTCTTTACTA,0,2772462
ompRp1,0.2,4,4,AGCATCACGGAGAGCTAACC,0,2800411
ompRp1,0.2,4,4,AGCAGTGATACGTCCCTCGG,0,2771419
ompRp1,0.2,4,4,AGCAGGAAGGGATAGTTCCG,0,2816176
ompRp1,0.2,4,4,AGCAAGTCCGTGAGACGTCC,0,2802053
ompRp1,0.2,4,4,AGATTCAATGGGGTAAATGC,0,2781826
ompRp1,0.2,4,4,AGATGTTCCCGCGTAGCTGT,0,2820805
ompRp1,0.2,4,4,AGATGTGAGACTTGGAACGA,0,2771124
ompRp1,0.2,4,4,AGATCCTAGTCCCAATATAG,0,2794553
ompRp1,0.2,4,4,AGATAGCTGGCGAGGAGGCG,0,2807291
ompRp1,0.2,4,4,AGATACAATCCCGACCGTGT,0,2812794
ompRp1,0.2,4,4,AGAGTTCTTTAGGACCTTTT,0,2806118
ompRp1,0.2,4,4,AGAGTAAAAGATAGGGGAAG,0,2765327
ompRp1,0.2,4,4,AGAGGGACCTAGGAGTACTT,0,2804719
ompRp1,0.2,4,4,AGAGCTTAGCGTTGACATAG,0,2769192
ompRp1,0.2,4,4,AGACTGTGCAAGGGGGTATT,0,2768230
ompRp1,0.2,4,4,AGACTGGTATGATTGAGGAT,0,2801811
ompRp1,0.2,4,4,AGACGCACACCCGAATTCAT,0,2822940
ompRp1,0.2,4,4,AGACCTTCCCCCAGGTCATA,0,2809500
ompRp1,0.2,4,4,AGACCGTAGTTGCTTCATTG,0,2786908
ompRp1,0.2,4,4,AGACACGCATAGGGGGTATA,0,2820042
ompRp1,0.2,4,4,AGAATCAGAGAATTTGTCTC,0,2776664
ompRp1,0.2,4,4,AGAATACTCTCGATTCGGCA,0,2765626
ompRp1,0.2,4,4,AGAAGCCGCATGAACGTATA,0,2776925
ompRp1,0.2,4,4,AGAACCACCTGGGGCTTCCT,0,2777238
ompRp1,0.2,4,4,AGAACATATACATCGCTGGA,0,2775908
ompRp1,0.2,4,4,AGAAAGGAGTTCGCTAGGGC,0,2778272
ompRp1,0.2,4,4,AGAAAAGTAGTCGAAGTCAC,0,2808331
ompRp1,0.2,4,4,AGAAAAAGACAATCGATGAA,0,2785944
ompRp1,0.2,4,4,ACTTTCTAGACCTGTGCAGA,0,2808409
ompRp1,0.2,4,4,ACTTGTGCTCGACCATCGAT,0,2818490
ompRp1,0.2,4,4,ACTTGCATCGAGCCCCCCAT,0,2788860
ompRp1,0.2,4,4,ACTTCCACAGCTCGCCGCAG,0,2768448
ompRp1,0.2,4,4,ACTTCATGGCACCCAAGTAT,0,2797624
ompRp1,0.2,4,4,ACTTATTAACATTATGTAGA,0,2801129
ompRp1,0.2,4,4,ACTTAACACCGAGCTAGCTG,0,2816456
ompRp1,0.2,4,4,ACTTAAACGCGTTCTTTAAG,0,2789438
ompRp1,0.2,4,4,ACTGTTAGGACCTAGCTCGG,0,2789878
ompRp1,0.2,4,4,ACTGTGTAAAAGTTAATTAA,0,2789985
ompRp1,0.2,4,4,ACTGTATAGCTTAAATCGCT,0,2795755
ompRp1,0.2,4,4,ACTGGTCATTACACGCAGTG,0,2822718
ompRp1,0.2,4,4,ACTGGGTGGCCTTAAAAATA,0,2809233
ompRp1,0.2,4,4,ACTGCTGCGAAGACCAATTG,0,2779524
ompRp1,0.2,4,4,ACTCTCGTGAGAGTGTTGAT,0,2807474
ompRp1,0.2,4,4,ACTCCTACTTTTCAAGGTAG,0,2824025
ompRp1,0.2,4,4,ACTAGCAGCGGAAAGCGCAT,0,2786896
ompRp1,0.2,4,4,ACTACTGCTAGAGTCTTCTT,0,2793458
ompRp1,0.2,4,4,ACGTTTTATGTATACGCACT,0,2780274
ompRp1,0.2,4,4,ACGTTGTCTGTTCCTGGGCA,0,2812446
ompRp1,0.2,4,4,ACGTGGGAATTCCATACTGA,0,2786911
ompRp1,0.2,4,4,ACGTCTACAGCCAAAGAGTT,0,2786183
ompRp1,0.2,4,4,ACGTCCAGAAGGCTCCGGTC,0,2816855
ompRp1,0.2,4,4,ACGTCCAAATTATCCATATC,0,2779150
ompRp1,0.2,4,4,ACGTCAGGTTGGTCAGTTGG,0,2790815
ompRp1,0.2,4,4,ACGTAGTCATAGGGATCCAG,0,2786469
ompRp1,0.2,4,4,ACGTACCAACTAAGCCCCAG,0,2793518
ompRp1,0.2,4,4,ACGGTAGGCATGCTCCGTAT,0,2771959
ompRp1,0.2,4,4,ACGGTAAAAGGCGAGGGAGT,0,2789101
ompRp1,0.2,4,4,ACGGGTGGTTCAGTCAGGGG,0,2799853
ompRp1,0.2,4,4,ACGGGGATACCTGATCATCT,0,2778998
ompRp1,0.2,4,4,ACGGGAGCCAGTAGAATAAG,0,2813546
ompRp1,0.2,4,4,ACGGCAGTCGTTATTATTGT,0,2797307
ompRp1,0.2,4,4,ACGGCACGTGCGGGATGTAA,0,2823295
ompRp1,0.2,4,4,ACGGACTTTTTTCCGGAAGG,0,2784529
ompRp1,0.2,4,4,ACGGACGTCGAAATTTAACA,0,2797576
ompRp1,0.2,4,4,ACGCTGAAAACATTTAGATA,0,2800815
ompRp1,0.2,4,4,ACGCCTAGAAACAATTTCAA,0,2779202
ompRp1,0.2,4,4,ACGCCGGTTCACATGACGTA,0,2815887
ompRp1,0.2,4,4,ACGCCGGTAAAGTACAGACT,0,2794558
ompRp1,0.2,4,4,ACGCCATTTCTATCGGTAAG,0,2798351
ompRp1,0.2,4,4,ACGCAATTCGTTAAACCTAG,0,2786613
ompRp1,0.2,4,4,ACGATTTAGCGTAAGCTAAT,0,2806045
ompRp1,0.2,4,4,ACGATGAGTGCCCCCTGGCG,0,2805732
ompRp1,0.2,4,4,ACGATAGTAGCTTAGACGCA,0,2780801
ompRp1,0.2,4,4,ACGAATGTGTACTGGTTGCC,0,2789903
ompRp1,0.2,4,4,ACGAAGCTTTGGCCAGGGGT,0,2800189
ompRp1,0.2,4,4,ACGAAGCAGTACTCCGAATT,0,2798960
ompRp1,0.2,4,4,ACCTGCGGTCATTCTAGGGT,0,2769854
ompRp1,0.2,4,4,ACCTGAGCGGTCGATGTCGC,0,2777220
ompRp1,0.2,4,4,ACCTGAGACCACGTCAGGGT,0,2771511
ompRp1,0.2,4,4,ACCGAACTGCATTTACGTTA,0,2765646
ompRp1,0.2,4,4,ACCGAAACCCGTCCCTCCAT,0,2821530
ompRp1,0.2,4,4,ACCCTCGCCAGTATGGCAGC,0,2775877
ompRp1,0.2,4,4,ACCCCACACGGTGCCTGAAA,0,2789909
ompRp1,0.2,4,4,ACCAATAGCCGTAATCATCC,0,2821464
ompRp1,0.2,4,4,ACCAAGTTCCCATTCAGCGT,0,2787406
ompRp1,0.2,4,4,ACCAAGAGGAAGTGAGTACA,0,2773658
ompRp1,0.2,4,4,ACCAACCACACAGGCGAATT,0,2774348
ompRp1,0.2,4,4,ACATTCGAATGTATAGCGCA,0,2766353
ompRp1,0.2,4,4,ACATCGGCACTACTAAAGCT,0,2769399
ompRp1,0.2,4,4,ACATCCTCAGAGTGGTCTTA,0,2797244
ompRp1,0.2,4,4,ACATCCCGTCCCGCATCTAT,0,2799456
ompRp1,0.2,4,4,ACAGGAGTTCGAGCCTATAC,0,2802854
ompRp1,0.2,4,4,ACAGCGTCATGCACCAGAGG,0,2779088
ompRp1,0.2,4,4,ACAGATCAAAAGCCTCGGCG,0,2815692
ompRp1,0.2,4,4,ACAGATACACGCGCCAGAGT,0,2765282
ompRp1,0.2,4,4,ACAGAGATGGTCTGAGACAT,0,2768661
ompRp1,0.2,4,4,ACAGACCCGCTATGACCCCC,0,2766362
ompRp1,0.2,4,4,ACACTCGCTCCTGTTACAGG,0,2777008
ompRp1,0.2,4,4,ACACTAGGAAATTACTTGTC,0,2771712
ompRp1,0.2,4,4,ACACGTTCCGATCAACCGTA,0,2788630
ompRp1,0.2,4,4,ACACGGGCAAGCTGCAGGGT,0,2796129
ompRp1,0.2,4,4,ACACGAAAGTCCGCGAAACC,0,2797084
ompRp1,0.2,4,4,ACACCAAAGGCATTGTCAAT,0,2820653
ompRp1,0.2,4,4,ACACATGTGTACCCAAACTC,0,2776663
ompRp1,0.2,4,4,ACAAGTCACGGCACGCCTCT,0,2789213
ompRp1,0.2,4,4,ACAACCAGTACTCCATTGGG,0,2792505
ompRp1,0.2,4,4,ACAAACATTCCGAGTACAGT,0,2791595
ompRp1,0.2,4,4,ACAAACAAATTGCCGTCCCA,0,2776692
ompRp1,0.2,4,4,AATTTAACCCTAGGGTGGAT,0,2786877
ompRp1,0.2,4,4,AATTGTTCTTTCCCGTTAAT,0,2805083
ompRp1,0.2,4,4,AATTGATAATTCCGGCAGTT,0,2768806
ompRp1,0.2,4,4,AATTCTGTACTGCAAATCTG,0,2786986
ompRp1,0.2,4,4,AATTCTGACATGGAGGTGCT,0,2771639
ompRp1,0.2,4,4,AATTCCCCGGTTGTGATGAT,0,2778553
ompRp1,0.2,4,4,AATTATAAAAAATCAGGAAG,0,2798970
ompRp1,0.2,4,4,AATTAATCGGGAACTAGGTA,0,2771355
ompRp1,0.2,4,4,AATTAATACCACGCCTCTCG,0,2812472
ompRp1,0.2,4,4,AATGTCCGCCTCTAGCAGAG,0,2796177
ompRp1,0.2,4,4,AATGTCAATTCGTTTCGCGG,0,2782247
ompRp1,0.2,4,4,AATGCTACTTGGTTCTATCC,0,2776565
ompRp1,0.2,4,4,AATGCCAATTGGAGTCTCAT,0,2770235
ompRp1,0.2,4,4,AATGAAGGGAACGTACATTG,0,2809853
ompRp1,0.2,4,4,AATCTGACGAATAAAGTGGA,0,2768370
ompRp1,0.2,4,4,AATCGCGGATGGGAGTGTGC,0,2818170
ompRp1,0.2,4,4,AATATCCGAGGCCAGATGTA,0,2802390
ompRp1,0.2,4,4,AATAGGTACAGTCCAAACAC,0,2816515
ompRp1,0.2,4,4,AATAGCGCTCCTGTTTAAGG,0,2793103
ompRp1,0.2,4,4,AATACTTATAAGCTATTTGG,0,2791009
ompRp1,0.2,4,4,AAGTGTTGACCGTAGTCGCA,0,2822555
ompRp1,0.2,4,4,AAGTGTACACAGTCTGGGTT,0,2792569
ompRp1,0.2,4,4,AAGTGTAAGTGTGTATCGCT,0,2815201
ompRp1,0.2,4,4,AAGGTTAAGCGACCGTTGAA,0,2792433
ompRp1,0.2,4,4,AAGGGTTGCGGTCCATGCCA,0,2809345
ompRp1,0.2,4,4,AAGGGGAGTTTTTACTACAC,0,2814075
ompRp1,0.2,4,4,AAGGGCACCGCCTCAAATTT,0,2803807
ompRp1,0.2,4,4,AAGGGCAACATTGATTACAT,0,2822135
ompRp1,0.2,4,4,AAGGGAATGTCTTCGTACGA,0,2822318
ompRp1,0.2,4,4,AAGGGAAAAGACCCCACATT,0,2813171
ompRp1,0.2,4,4,AAGGCACGGGCTACGTCAGA,0,2819056
ompRp1,0.2,4,4,AAGGAATACGTTTCCAGCAT,0,2784039
ompRp1,0.2,4,4,AAGGAAAGAAGGGGGAACTA,0,2790830
ompRp1,0.2,4,4,AAGCTCACATAGGCCTGAAT,0,2801059
ompRp1,0.2,4,4,AAGCTCAACGCCATACTTTC,0,2788470
ompRp1,0.2,4,4,AAGCGCGGTCTTCAGCTCCT,0,2789292
ompRp1,0.2,4,4,AAGCGCGAAATGCGATACAT,0,2775085
ompRp1,0.2,4,4,AAGCCGACAAACCCTGAAAC,0,2800063
ompRp1,0.2,4,4,AAGCCCTTCGGTGCGCTGAG,0,2790093
ompRp1,0.2,4,4,AAGCAGAGTGGCGAGTGGGG,0,2777903
ompRp1,0.2,4,4,AAGCACACGGGCACCTAAGA,0,2804044
ompRp1,0.2,4,4,AAGATATACTTGTTCTTTCG,0,2785843
ompRp1,0.2,4,4,AAGAGGTCGTGGATCAGTTT,0,2785439
ompRp1,0.2,4,4,AAGACGCAACAATTAGTTCC,0,2797991
ompRp1,0.2,4,4,AAGAAACTCGGGGATATTAT,0,2820977
ompRp1,0.2,4,4,AACTTAGCACATAATGCCTT,0,2781583
ompRp1,0.2,4,4,AACTCTTAGGCCCCTTCAAT,0,2775336
ompRp1,0.2,4,4,AACGTCACACTCACGTACGT,0,2798508
ompRp1,0.2,4,4,AACGGAGGGGACGATTGCCA,0,2774766
ompRp1,0.2,4,4,AACGAGCACACCGCCTACAT,0,2814822
ompRp1,0.2,4,4,AACGAAACGGTCATTACCAA,0,2792328
ompRp1,0.2,4,4,AACCGCCCTAATTTAGCCAT,0,2807577
ompRp1,0.2,4,4,AACCCAGGATCATGGTCTTT,0,2809054
ompRp1,0.2,4,4,AACCATTTCATTAGGCTCTT,0,2773763
ompRp1,0.2,4,4,AACCAGATAGAGCATCGGAC,0,2779240
ompRp1,0.2,4,4,AACATACTTATAAACTGCCT,0,2769808
ompRp1,0.2,4,4,AACATACACGACTCGGGCCA,0,2779942
ompRp1,0.2,4,4,AACAGCGATAAGCGTATCTT,0,2823091
ompRp1,0.2,4,4,AACACGTGAATATCCTAGTT,0,2797477
ompRp1,0.2,4,4,AACAAGGATTCAGTCACGGG,0,2824384
ompRp1,0.2,4,4,AACAAAATTTTAGAGTCAGA,0,2822499
ompRp1,0.2,4,4,AAATTTGGAATGGCAACACT,0,2782209
ompRp1,0.2,4,4,AAATTCTTGGCACGGGTTTG,0,2782160
ompRp1,0.2,4,4,AAATGTTTTAGATTGCAGAG,0,2777441
ompRp1,0.2,4,4,AAATGTGACGTAGTAGTCAT,0,2811517
ompRp1,0.2,4,4,AAATGGCACGACGTATTTCA,0,2805543
ompRp1,0.2,4,4,AAATCGGAGATTTGCCGGCC,0,2812581
ompRp1,0.2,4,4,AAATCGCAACCCTGCTTGTG,0,2776222
ompRp1,0.2,4,4,AAATCCCACTAGCACAAGTC,0,2805480
ompRp1,0.2,4,4,AAATATGCTATAGTGCAGTT,0,2783089
ompRp1,0.2,4,4,AAATACCGCTTCATAGTACT,0,2773144
ompRp1,0.2,4,4,AAAGGTGGAACATAGATGAT,0,2799726
ompRp1,0.2,4,4,AAAGGCGCAGCTTTTGCACC,0,2778636
ompRp1,0.2,4,4,AAAGCTGGAGTTAAACCCCC,0,2797747
ompRp1,0.2,4,4,AAACGCGTCATCCTTAAGTC,0,2765772
ompRp1,0.2,4,4,AAACACAATTACATTGAGGC,0,2766812
ompRp1,0.2,4,4,AAAATCCCGTGATTTCCTTG,0,2772194
ompRp1,0.2,4,4,AAAATCAGCTGGCGCGACCA,0,2802687
ompRp1,0.2,4,4,AAAAGTGTCCGGCACCGCGC,0,2782396
ompRp1,0.2,4,4,AAAAGAAGATGTAAAGATGG,0,2824158
ompRp1,0.2,4,4,AAAACCGCCCCGGTAATTTG,0,2815349
ompRp1,0.2,4,4,AAAAAGCTCAAGCGGAGAAA,0,2778040
ompRp1,0.25,3,3,TTTTTGGCTGCCTACGATCA,0,2782657
ompRp1,0.25,3,3,TTTTTGATCTTCCCGCTCCA,0,2784242
ompRp1,0.25,3,3,TTTTGAGCATGAGACGGTCA,0,2803518
ompRp1,0.25,3,3,TTTTGACGTGGGAGCCAACT,0,2793545
ompRp1,0.25,3,3,TTTTACGCACGTGCTCTGCA,0,2785165
ompRp1,0.25,3,3,TTTTAACGACACATTACAAA,0,2821166
ompRp1,0.25,3,3,TTTTAACAGAAGCCGCCCAC,0,2802228
ompRp1,0.25,3,3,TTTGTTGCGTCGGCGCATGT,0,2815993
ompRp1,0.25,3,3,TTTGTAATAATTAACTCTGG,0,2820020
ompRp1,0.25,3,3,TTTGGTCTCCACCCGGTGTC,0,2813595
ompRp1,0.25,3,3,TTTGGCGCTTCGGGTTAGTA,0,2781519
ompRp1,0.25,3,3,TTTGGACCGCGTAAGAAGAA,0,2784537
ompRp1,0.25,3,3,TTTGCCATCTCTTCCATTTC,0,2791893
ompRp1,0.25,3,3,TTTGATAGTTGTTTACTTGT,0,2772349
ompRp1,0.25,3,3,TTTGAACAAATGCCAGATGC,0,2791491
ompRp1,0.25,3,3,TTTCGGCTGGGGGTTTCCTG,0,2784603
ompRp1,0.25,3,3,TTTCCGTGTGCTCGGGAAGG,0,2777026
ompRp1,0.25,3,3,TTTCCATTAATTAATGACGT,0,2767123
ompRp1,0.25,3,3,TTTCATCGTAGGATCTGTTG,0,2789151
ompRp1,0.25,3,3,TTTCAGGGCGGGTTTGAGGA,0,2771829
ompRp1,0.25,3,3,TTTCACAAGGCTTGACGAGA,0,2810880
ompRp1,0.25,3,3,TTTCAATTAAGCTGCCTCGG,0,2807430
ompRp1,0.25,3,3,TTTATGGCATGGGCCGCAAT,0,2797578
ompRp1,0.25,3,3,TTTAGTGCCTACTGTCAACT,0,2800345
ompRp1,0.25,3,3,TTTAGGGCGCGTGTGGTAGG,0,2783468
ompRp1,0.25,3,3,TTTAGCAAGGCATGGACGGA,0,2776677
ompRp1,0.25,3,3,TTTACAGGTATAGATGACAG,0,2813210
ompRp1,0.25,3,3,TTTACACGTACCTGCTGAAT,0,2811234
ompRp1,0.25,3,3,TTTAAATAAGCAATCGGCGT,0,2765956
ompRp1,0.25,3,3,TTGTTTAGGTATTACCTTAC,0,2802727
ompRp1,0.25,3,3,TTGTTCGCGGTAGCTTCGTC,0,2769317
ompRp1,0.25,3,3,TTGTTACGTCGCAACGGAGT,0,2802958
ompRp1,0.25,3,3,TTGTGCACAGTTGTCGTCAA,0,2800857
ompRp1,0.25,3,3,TTGTCATCTACCGAGTACGT,0,2807557
ompRp1,0.25,3,3,TTGTAGATCGTCGCAACCGT,0,2787436
ompRp1,0.25,3,3,TTGGTCAGTTTCTACAGGTG,0,2787196
ompRp1,0.25,3,3,TTGGGTGAGACAGAGTACGT,0,2789283
ompRp1,0.25,3,3,TTGGGGAGCTTCAGCACTTA,0,2776265
ompRp1,0.25,3,3,TTGGCTATGGCTCCTTTGAA,0,2777476
ompRp1,0.25,3,3,TTGGCGTGATCTGGGACCCA,0,2800791
ompRp1,0.25,3,3,TTGCTGAATTCAGCTGAAGT,0,2815932
ompRp1,0.25,3,3,TTGCTCCCAGCCGGGACTGA,0,2781371
ompRp1,0.25,3,3,TTGCGCTAAGTCGGAGCATG,0,2784166
ompRp1,0.25,3,3,TTGCGCCTTAGAGCTACGCT,0,2822325
ompRp1,0.25,3,3,TTGCCCTTTGCAATGAGTAC,0,2810229
ompRp1,0.25,3,3,TTGCATACTGTCAAAGGGCG,0,2808453
ompRp1,0.25,3,3,TTGCAATCTTAGCGGATGTA,0,2782116
ompRp1,0.25,3,3,TTGATAGGATTTAGAGAGCA,0,2808706
ompRp1,0.25,3,3,TTGAGGCACCGATAACGCGG,0,2780775
ompRp1,0.25,3,3,TTGAGGCACAGCGCATGACA,0,2813047
ompRp1,0.25,3,3,TTGAGAGGCATCAACGAGGT,0,2815458
ompRp1,0.25,3,3,TTGAACTATCTTAGGCGGGC,0,2820863
ompRp1,0.25,3,3,TTCTTTAGACACAAGACATT,0,2809776
ompRp1,0.25,3,3,TTCTTCGGCGCCTACTGCCT,0,2774939
ompRp1,0.25,3,3,TTCTATCGAAGGTCAACCTA,0,2816458
ompRp1,0.25,3,3,TTCGTTTTCATGACGGAAGT,0,2772131
ompRp1,0.25,3,3,TTCGTTTAGAACATCAATCC,0,2788816
ompRp1,0.25,3,3,TTCGTTCAAGAACTGTTGCC,0,2807522
ompRp1,0.25,3,3,TTCGTGGGCGAGACCACCTC,0,2795920
ompRp1,0.25,3,3,TTCGGTCGTGTAACTAGAGA,0,2808953
ompRp1,0.25,3,3,TTCGGTCGATTCCTGAACCT,0,2822939
ompRp1,0.25,3,3,TTCGGTATAGTCCGGCTAAG,0,2803060
ompRp1,0.25,3,3,TTCGGCGTGGTCATATTGGT,0,2823925
ompRp1,0.25,3,3,TTCGGAATCTCTTAGGAACA,0,2791476
ompRp1,0.25,3,3,TTCGCTATAGACTCTCGAGA,0,2790671
ompRp1,0.25,3,3,TTCGATGTTAGAGCTACACT,0,2786394
ompRp1,0.25,3,3,TTCCTCCCGCCTGCCTATAA,0,2767604
ompRp1,0.25,3,3,TTCCTCAGAGTCGAAGTCGG,0,2778334
ompRp1,0.25,3,3,TTCCGTCTCACGTCATCGGG,0,2787729
ompRp1,0.25,3,3,TTCCGAATGTTTAAAGTCGT,0,2817047
ompRp1,0.25,3,3,TTCCCCCAGTGGGGGTGGCA,0,2775640
ompRp1,0.25,3,3,TTCCATCGATACACGAAAAA,0,2819841
ompRp1,0.25,3,3,TTCCAGTGTCGCCCCGGAAT,0,2791173
ompRp1,0.25,3,3,TTCATTGAAAGAAGTTTAGA,0,2794528
ompRp1,0.25,3,3,TTCATGCTTCTGGGCACATA,0,2805235
ompRp1,0.25,3,3,TTCATACCCTCCGCTGTTTT,0,2778012
ompRp1,0.25,3,3,TTCAGTACGTTCTAGCTAGC,0,2813256
ompRp1,0.25,3,3,TTCACCAGTGTACTGATCGA,0,2812123
ompRp1,0.25,3,3,TTCAATGCTACACGCAGAGC,0,2820058
ompRp1,0.25,3,3,TTCAAAGTGGCCGCTCTAAT,0,2805927
ompRp1,0.25,3,3,TTATTGGCTCATCGGTGGTG,0,2783499
ompRp1,0.25,3,3,TTATTCACTGTGAGCAGTGT,0,2791357
ompRp1,0.25,3,3,TTATTCACTGACGTAGACCG,0,2820148
ompRp1,0.25,3,3,TTATCTGTCCCCAATCACAA,0,2801647
ompRp1,0.25,3,3,TTATATTACTCTCCAGCATG,0,2778602
ompRp1,0.25,3,3,TTATAAGTTCAAGTAGATAA,0,2812421
ompRp1,0.25,3,3,TTATAACGCGAGCAAATCCT,0,2783131
ompRp1,0.25,3,3,TTAGGTGTCCTAGTATAGGG,0,2787990
ompRp1,0.25,3,3,TTAGGAGTGGATGTATATTG,0,2793703
ompRp1,0.25,3,3,TTAGGAGCTCAACCCCAGGC,0,2790532
ompRp1,0.25,3,3,TTAGCATTCGCGAGTTGAAT,0,2796143
ompRp1,0.25,3,3,TTAGATCTACGGTGGGCAGA,0,2803206
ompRp1,0.25,3,3,TTAGAGAGTACAAGGCGGGC,0,2786371
ompRp1,0.25,3,3,TTAGACTAATGTTGAAAATT,0,2789148
ompRp1,0.25,3,3,TTAGACGGAAATCCTCATAT,0,2824016
ompRp1,0.25,3,3,TTACTAGCGAGAATCGCTTC,0,2821643
ompRp1,0.25,3,3,TTACGATGGTTTTACCCCCT,0,2778320
ompRp1,0.25,3,3,TTACCTGCCGGCTCATTTGT,0,2795418
ompRp1,0.25,3,3,TTACCCCCCGGACTTGATTC,0,2790248
ompRp1,0.25,3,3,TTACATGTCGCGTTAAGCGG,0,2781368
ompRp1,0.25,3,3,TTACATGGAACTTTAACGGA,0,2813007
ompRp1,0.25,3,3,TTACAGTTTAGTCTGTCACG,0,2817556
ompRp1,0.25,3,3,TTAATTCTCGTAGGATGGCA,0,2817460
ompRp1,0.25,3,3,TTAATGGTTACGGAGACGAC,0,2817376
ompRp1,0.25,3,3,TTAACACGGATCCGGCAAGT,0,2817582
ompRp1,0.25,3,3,TTAAATAATGACACGCGGTA,0,2787885
ompRp1,0.25,3,3,TTAAAATGTAATCCAATAGT,0,2818321
ompRp1,0.25,3,3,TTAAAAGTGAAAGCGGGCGA,0,2813811
ompRp1,0.25,3,3,TGTTTAACCTTGCTAAAGAT,0,2811028
ompRp1,0.25,3,3,TGTTGTTGCTAGAAGGGTCG,0,2815966
ompRp1,0.25,3,3,TGTTGGCTTACAAAAGGAGG,0,2796428
ompRp1,0.25,3,3,TGTTACGACATACAGGGGAA,0,2800202
ompRp1,0.25,3,3,TGTTAATGGTTAGGCTGGCG,0,2775744
ompRp1,0.25,3,3,TGTGTGAAGGGTATCAATAC,0,2805272
ompRp1,0.25,3,3,TGTGGCCATTGAGTCCATAC,0,2822846
ompRp1,0.25,3,3,TGTGCGAATAACTCGGTATC,0,2768823
ompRp1,0.25,3,3,TGTGCATACAAGATTAAATG,0,2790940
ompRp1,0.25,3,3,TGTGCAAGACTCGGTAGTAA,0,2823779
ompRp1,0.25,3,3,TGTCTTCTAACAGACGCAAT,0,2773416
ompRp1,0.25,3,3,TGTCGTATGACCATTAACCA,0,2802040
ompRp1,0.25,3,3,TGTCCGGGCGGCGGGTCTTA,0,2812953
ompRp1,0.25,3,3,TGTCAACAAGCGCGTGGGGT,0,2811417
ompRp1,0.25,3,3,TGTATCATCTAGAACCTCCC,0,2768828
ompRp1,0.25,3,3,TGTAGTTTGTAATAAACTGA,0,2769520
ompRp1,0.25,3,3,TGTAGTAAAACTGCCTCCGT,0,2790252
ompRp1,0.25,3,3,TGTAGGGAGAATAATGGACT,0,2787448
ompRp1,0.25,3,3,TGTACATTATGTCTAAGACT,0,2790225
ompRp1,0.25,3,3,TGTAATCCGCTAGATCAACC,0,2789203
ompRp1,0.25,3,3,TGGTCTGAGGTTGTGCACTG,0,2813449
ompRp1,0.25,3,3,TGGTCTGACACACTATCTCC,0,2793525
ompRp1,0.25,3,3,TGGTCTCCATGTAATGAGTG,0,2782777
ompRp1,0.25,3,3,TGGTCTACGCGCCGGCCGGA,0,2823254
ompRp1,0.25,3,3,TGGTCGCCATAGGGTGGGAA,0,2785568
ompRp1,0.25,3,3,TGGTAGACTACGCGGGCAGA,0,2795610
ompRp1,0.25,3,3,TGGGTAGAAAGCCTTGACAA,0,2781885
ompRp1,0.25,3,3,TGGGGACCAAAGGTTGTCAG,0,2797710
ompRp1,0.25,3,3,TGGGGAACTCTTTGCCGTAG,0,2820259
ompRp1,0.25,3,3,TGGGCTGTTCGTATTAACGA,0,2793561
ompRp1,0.25,3,3,TGGCTCGTGGTGGAATCTAA,0,2802324
ompRp1,0.25,3,3,TGGCTCCTCTAAGCGAGGTG,0,2810291
ompRp1,0.25,3,3,TGGCTATTAGGCCCTCTGAG,0,2767552
ompRp1,0.25,3,3,TGGCGTAAGGGTGCCGCGAT,0,2782371
ompRp1,0.25,3,3,TGGCGAGCAGGTTTCAAATT,0,2816429
ompRp1,0.25,3,3,TGGCATCGGCCGACTCGTCA,0,2769748
ompRp1,0.25,3,3,TGGAGTGATGCGACTCGGCA,0,2770480
ompRp1,0.25,3,3,TGGAGCTGACGCTAGCGGTA,0,2805819
ompRp1,0.25,3,3,TGGAGCCCACTCGACCCGTC,0,2816177
ompRp1,0.25,3,3,TGGACTCTGTCGCAGGCGCA,0,2780963
ompRp1,0.25,3,3,TGGACCTAACCCCATTAGCA,0,2818788
ompRp1,0.25,3,3,TGGACACAATTTCCGATTAG,0,2806165
ompRp1,0.25,3,3,TGGAATGGGAGAAGGCTCTA,0,2795168
ompRp1,0.25,3,3,TGGAATGATTTGGTCAGTAG,0,2774137
ompRp1,0.25,3,3,TGGAACCTCGTTCGGGACAT,0,2808176
ompRp1,0.25,3,3,TGGAACAGGTTTGAATCGAT,0,2778154
ompRp1,0.25,3,3,TGCTTCACACTACCCGGTGG,0,2796750
ompRp1,0.25,3,3,TGCTGCATTCCCTGGAAAAC,0,2799665
ompRp1,0.25,3,3,TGCTCGTTTTAGCCATCATT,0,2816779
ompRp1,0.25,3,3,TGCTCCCGGTTAACTAACCC,0,2807509
ompRp1,0.25,3,3,TGCTCCCCCGTGCAAGTGTA,0,2765965
ompRp1,0.25,3,3,TGCTAGCCAACGAGCTGCGT,0,2821380
ompRp1,0.25,3,3,TGCTACCGGCGGCCAGGCTC,0,2809674
ompRp1,0.25,3,3,TGCCTGCTCCCGGTTGTTAA,0,2818850
ompRp1,0.25,3,3,TGCCTCACTGGAAATGGCTT,0,2771543
ompRp1,0.25,3,3,TGCCGGGGTCGGTTAAGCCA,0,2778269
ompRp1,0.25,3,3,TGCCAGCAGCTCCAACAGTG,0,2799287
ompRp1,0.25,3,3,TGCCACTTTTCGAACCAATC,0,2813674
ompRp1,0.25,3,3,TGCCACGCCATTACAAGTTA,0,2790348
ompRp1,0.25,3,3,TGCATTAGTCGCGTCTTAAA,0,2765719
ompRp1,0.25,3,3,TGCATTACCAGTTGACCCTG,0,2804260
ompRp1,0.25,3,3,TGCATGTTGATCGACTTGAT,0,2799221
ompRp1,0.25,3,3,TGCATCCAACCTTTACTGTA,0,2769278
ompRp1,0.25,3,3,TGCATAGCCCCACAGACCTC,0,2787864
ompRp1,0.25,3,3,TGCAGTAATGCAATGTTTGT,0,2823334
ompRp1,0.25,3,3,TGCAGAAACCCGATCACGCT,0,2779452
ompRp1,0.25,3,3,TGCACGAATATCGACTTCGA,0,2795432
ompRp1,0.25,3,3,TGCAACGTTGGTAACACAGA,0,2768882
ompRp1,0.25,3,3,TGCAAAACCAAACCCACCGG,0,2797264
ompRp1,0.25,3,3,TGATTGCAGATGCACGGAAC,0,2808875
ompRp1,0.25,3,3,TGATTGATCCCTCCGAGCCG,0,2774500
ompRp1,0.25,3,3,TGATCACGGCGCCGCCGAGA,0,2804252
ompRp1,0.25,3,3,TGATATGTGCGCAGTTCCGC,0,2780552
ompRp1,0.25,3,3,TGAGGGACGAGCAATTGTTC,0,2809015
ompRp1,0.25,3,3,TGAGGCTGCGCGTCCCTAAT,0,2816007
ompRp1,0.25,3,3,TGAGCGCACGCTTGCTTGAC,0,2765952
ompRp1,0.25,3,3,TGAGCCTGGAAAAGAATAAG,0,2795020
ompRp1,0.25,3,3,TGAGCCACATGATCTGCGTA,0,2774149
ompRp1,0.25,3,3,TGAGACTAGCGGCTCGGTTT,0,2811824
ompRp1,0.25,3,3,TGAGAACCCCCCTAAATGTC,0,2794770
ompRp1,0.25,3,3,TGACTTGAGGATCTCGGGAC,0,2772883
ompRp1,0.25,3,3,TGACTGAGAGACACACGGTG,0,2804766
ompRp1,0.25,3,3,TGACTATGGCGTCAAGGAGC,0,2818524
ompRp1,0.25,3,3,TGACGGTGTTAGACTGGATC,0,2766429
ompRp1,0.25,3,3,TGACGACTAATTGAGACACG,0,2787235
ompRp1,0.25,3,3,TGACCTTTAAGTGGGCTTCA,0,2816420
ompRp1,0.25,3,3,TGACACCCATCTGTGACTTG,0,2765722
ompRp1,0.25,3,3,TGAATTGGCGAAGATTTACG,0,2808736
ompRp1,0.25,3,3,TGAAGGGCTTTTTTGGGCGC,0,2815386
ompRp1,0.25,3,3,TGAAGCCGTCAGGGCTGTCC,0,2799228
ompRp1,0.25,3,3,TGAAGCCGACGTAATGCGAT,0,2765352
ompRp1,0.25,3,3,TGAAGACCCCGGTCCTGTGG,0,2796326
ompRp1,0.25,3,3,TGAACCTTCCTAATCTCTGG,0,2770372
ompRp1,0.25,3,3,TGAACCGTGGCCTCTGATGC,0,2780301
ompRp1,0.25,3,3,TGAACCGTATCGTATAGGGA,0,2801188
ompRp1,0.25,3,3,TGAAAGGTCCGTGCGGTAAA,0,2811446
ompRp1,0.25,3,3,TGAAAATTGCTCATAGCGGG,0,2796414
ompRp1,0.25,3,3,TCTTGTGACTGCGAGAGACA,0,2785295
ompRp1,0.25,3,3,TCTTGAGCCATTCTAAGCAA,0,2791870
ompRp1,0.25,3,3,TCTTCGAGGGCATCAGTTTC,0,2795165
ompRp1,0.25,3,3,TCTTCCCTGATCTACATCGT,0,2815633
ompRp1,0.25,3,3,TCTTAGTATCTCAGGTCAGA,0,2795626
ompRp1,0.25,3,3,TCTGGGCTTTAGTTCTCGTT,0,2787585
ompRp1,0.25,3,3,TCTGGCGATAAATCGTTAAG,0,2800647
ompRp1,0.25,3,3,TCTGCTACCACTGCGTTTGG,0,2777905
ompRp1,0.25,3,3,TCTGCAGAAAGTCTGGTTTC,0,2784014
ompRp1,0.25,3,3,TCTGATACAACTCGAGGCGA,0,2798784
ompRp1,0.25,3,3,TCTGAGGGTAGGTAGATTAA,0,2788358
ompRp1,0.25,3,3,TCTGAGGCTGAAGCAACGGG,0,2776845
ompRp1,0.25,3,3,TCTCTATAGTGTCTATTGTA,0,2810753
ompRp1,0.25,3,3,TCTCGACGTTGCTTGCATCA,0,2795430
ompRp1,0.25,3,3,TCTCCTATTAGGCCTATTTT,0,2814183
ompRp1,0.25,3,3,TCTCCGCGTATATTGCAAGC,0,2765419
ompRp1,0.25,3,3,TCTCAGGTTTTTAGACAGTT,0,2809438
ompRp1,0.25,3,3,TCTATCGATAGTTTATTCAA,0,2801480
ompRp1,0.25,3,3,TCTATCCAATATCCGTGTTG,0,2796639
ompRp1,0.25,3,3,TCTATAACCATCGACATTGG,0,2818010
ompRp1,0.25,3,3,TCTATAACAGGAACACTTGT,0,2796732
ompRp1,0.25,3,3,TCTAGTGCCATCTATTGTTC,0,2797419
ompRp1,0.25,3,3,TCTAGGTAATTGTGTTGGAC,0,2770294
ompRp1,0.25,3,3,TCTAGAGTTACAAGCATCCT,0,2806982
ompRp1,0.25,3,3,TCTAATCAATGGCGTAGACG,0,2777009
ompRp1,0.25,3,3,TCGTTAGACCCCTAGGGAGT,0,2769445
ompRp1,0.25,3,3,TCGTGGAGCTGCATCTTGAT,0,2819945
ompRp1,0.25,3,3,TCGTGGAAGTTTTTGTGTTA,0,2815757
ompRp1,0.25,3,3,TCGTGCTGCGTGAATATCCT,0,2777976
ompRp1,0.25,3,3,TCGTGAGGTTAGTAATCTTA,0,2824714
ompRp1,0.25,3,3,TCGTCGTCGTTAAGAGGACC,0,2789162
ompRp1,0.25,3,3,TCGTCATATCGAAGGTGTTT,0,2810695
ompRp1,0.25,3,3,TCGTAATCAAATTATAGCAA,0,2819178
ompRp1,0.25,3,3,TCGGTTGGCGTTAAAACTAC,0,2800024
ompRp1,0.25,3,3,TCGGTTGCATCAGAAGAACA,0,2803763
ompRp1,0.25,3,3,TCGGTCGTCGCCCGAACGTG,0,2765868
ompRp1,0.25,3,3,TCGGTCGGGGTCGAAAATCA,0,2794749
ompRp1,0.25,3,3,TCGGGCGTCATCCCACGTCG,0,2796234
ompRp1,0.25,3,3,TCGGCACCGGGTCTATCTAG,0,2798617
ompRp1,0.25,3,3,TCGCGGAAGTGTAGAAGAGG,0,2810060
ompRp1,0.25,3,3,TCGCGCGTCCCTACGGATCA,0,2793772
ompRp1,0.25,3,3,TCGCGCGGTCAAATGGTCAC,0,2789775
ompRp1,0.25,3,3,TCGCACGGACTAGAGTGAGG,0,2787281
ompRp1,0.25,3,3,TCGATGGTTTTAATCGTCGG,0,2810862
ompRp1,0.25,3,3,TCGATAGCTGCCAGTGGAGC,0,2778139
ompRp1,0.25,3,3,TCGAGTACTGGTAACGAGTG,0,2806469
ompRp1,0.25,3,3,TCGAGGCACTCGTGATCAGA,0,2808222
ompRp1,0.25,3,3,TCGAAGCGGCACTTTAACGC,0,2823205
ompRp1,0.25,3,3,TCCTTTAGGGCACAGCTATC,0,2824103
ompRp1,0.25,3,3,TCCTTCTGTCAAGGTAAGGT,0,2765493
ompRp1,0.25,3,3,TCCTGCGGGTCTCTCTGGAG,0,2807847
ompRp1,0.25,3,3,TCCTGAGGTTATCCCTTGAG,0,2784640
ompRp1,0.25,3,3,TCCTGAAGATCTGGTTGGTT,0,2812734
ompRp1,0.25,3,3,TCCTCCGGTATATGATACGT,0,2818995
ompRp1,0.25,3,3,TCCTACGGGGGTCTCGTTCA,0,2792394
ompRp1,0.25,3,3,TCCGGCAAGCTCTAGAAGTG,0,2797190
ompRp1,0.25,3,3,TCCGATCAAGGAGCTCCCTT,0,2765694
ompRp1,0.25,3,3,TCCCTTTGGTTATACTATAG,0,2792014
ompRp1,0.25,3,3,TCCCTTTCCTAGGTATGAAA,0,2791058
ompRp1,0.25,3,3,TCCCGTACGACTATCCTGTG,0,2797664
ompRp1,0.25,3,3,TCCCGATTTTTCCAAATCGG,0,2790427
ompRp1,0.25,3,3,TCCCGATAACGTGAACTCTA,0,2782660
ompRp1,0.25,3,3,TCCCCGCGCCCAGTAGAGGA,0,2815300
ompRp1,0.25,3,3,TCCCCAGGCGGTGCAATCGT,0,2773606
ompRp1,0.25,3,3,TCCCACCACCAGTGTTAAGT,0,2796011
ompRp1,0.25,3,3,TCCATGGGGGAAGGAGCGCC,0,2787718
ompRp1,0.25,3,3,TCCATGATTTTTTCTTAGCG,0,2779806
ompRp1,0.25,3,3,TCCAGTGCGACGTCAATTAG,0,2811213
ompRp1,0.25,3,3,TCCAGGTTTTGGCTCGATCC,0,2776069
ompRp1,0.25,3,3,TCCAGACGGGTGACTTCTTA,0,2773256
ompRp1,0.25,3,3,TCCAACGTAGCACAGGTGGT,0,2783366
ompRp1,0.25,3,3,TCATTCTATGACAACCTGTT,0,2782878
ompRp1,0.25,3,3,TCATGCTATACTGCAGCGTT,0,2795315
ompRp1,0.25,3,3,TCATATTCGCGTTACATTTA,0,2802244
ompRp1,0.25,3,3,TCATATGTTCTCCACGGCTA,0,2769246
ompRp1,0.25,3,3,TCATAGCGATCGTGCAATAG,0,2805212
ompRp1,0.25,3,3,TCAGTTCCTAACTTCTGCGT,0,2822639
ompRp1,0.25,3,3,TCAGTGTGGGCTCATTTGCT,0,2788579
ompRp1,0.25,3,3,TCAGGCTTCGATACAGCGCG,0,2790906
ompRp1,0.25,3,3,TCAGAGATTTTTGCAGCGTC,0,2781736
ompRp1,0.25,3,3,TCACTGCCATACAGTAATCC,0,2771201
ompRp1,0.25,3,3,TCACTGAGGTCCGTCTATTT,0,2771322
ompRp1,0.25,3,3,TCACTGAGACCCTGAAACTT,0,2767174
ompRp1,0.25,3,3,TCACCATGCCTCCGCATTAT,0,2824693
ompRp1,0.25,3,3,TCACAACTAACATAGGCGGG,0,2782213
ompRp1,0.25,3,3,TCAATAATATCCCTCGGTGG,0,2802776
ompRp1,0.25,3,3,TCAACTGTTCGAGTTTATGA,0,2814319
ompRp1,0.25,3,3,TCAACGGGTGCTAAGGAGCT,0,2788968
ompRp1,0.25,3,3,TCAACCAGACATGCGGGAGA,0,2786630
ompRp1,0.25,3,3,TCAAATTGTTAGAAGGTCTC,0,2816489
ompRp1,0.25,3,3,TATTTTTCGTGATTGAATTC,0,2807495
ompRp1,0.25,3,3,TATTTAGACTAAGTAGCACA,0,2805165
ompRp1,0.25,3,3,TATTACGTAAATCGGTCCCA,0,2814333
ompRp1,0.25,3,3,TATGGGGCGACGCAAACTCT,0,2805142
ompRp1,0.25,3,3,TATGCCATCCGAACAGCGAT,0,2802128
ompRp1,0.25,3,3,TATGATTGTACTCACGGGAT,0,2790614
ompRp1,0.25,3,3,TATCTGTGATCCAAGGAAAT,0,2810843
ompRp1,0.25,3,3,TATCGCTCGGCCCGGGCTGC,0,2798866
ompRp1,0.25,3,3,TATCGCAGAAAGAATGTTTT,0,2786882
ompRp1,0.25,3,3,TATCCAATAACACACATGAG,0,2810670
ompRp1,0.25,3,3,TATATGTTCGCTAACATTGA,0,2800775
ompRp1,0.25,3,3,TATATGGCGTATTTGGGGTC,0,2770516
ompRp1,0.25,3,3,TATATGAGAAGTTATCAATT,0,2766786
ompRp1,0.25,3,3,TATAGGGCAACCTGCGCGCA,0,2773535
ompRp1,0.25,3,3,TATAGGGATGAATACGGTTA,0,2801933
ompRp1,0.25,3,3,TATACTGAAGCAGCAGGAGG,0,2787069
ompRp1,0.25,3,3,TAGGTTTACACCTATGGTGT,0,2786715
ompRp1,0.25,3,3,TAGGTTATTAAACTACCACA,0,2781189
ompRp1,0.25,3,3,TAGGTTACCAGATCACGGTC,0,2787793
ompRp1,0.25,3,3,TAGGTACCCACGAGAGGATC,0,2766596
ompRp1,0.25,3,3,TAGGACATAGGCTATGAGGC,0,2807940
ompRp1,0.25,3,3,TAGGAAACTGAGCCGCGGTA,0,2791279
ompRp1,0.25,3,3,TAGCCCAGGGACGCTTTGAA,0,2822635
ompRp1,0.25,3,3,TAGCCATACGGTTCTATAAT,0,2818959
ompRp1,0.25,3,3,TAGCATTACGATGTGCTCCT,0,2784403
ompRp1,0.25,3,3,TAGCAATCGCAGGGGAACTA,0,2769141
ompRp1,0.25,3,3,TAGATCGAGGAAACTGCCCA,0,2797107
ompRp1,0.25,3,3,TAGATCATCACTTGATAAGG,0,2784563
ompRp1,0.25,3,3,TAGAGGGGAATATTGGTACT,0,2818525
ompRp1,0.25,3,3,TAGACGAGAGTTCCACAACG,0,2815665
ompRp1,0.25,3,3,TAGACGACCAGTTGGGAGAT,0,2803664
ompRp1,0.25,3,3,TAGACCGGCCCGGTTGTCTA,0,2803657
ompRp1,0.25,3,3,TAGACCCGAGATGGTTGGCT,0,2808091
ompRp1,0.25,3,3,TAGACCAGAGCAACCGCTTA,0,2779795
ompRp1,0.25,3,3,TAGAAAGTATGCACGCGAGC,0,2784068
ompRp1,0.25,3,3,TACTTTTACGGATGCTGTTC,0,2812404
ompRp1,0.25,3,3,TACTTAAATTACACGAGTTT,0,2796405
ompRp1,0.25,3,3,TACTGGCCGACTAAGCCATC,0,2766101
ompRp1,0.25,3,3,TACTCTCATAAGGCATAGGG,0,2796187
ompRp1,0.25,3,3,TACTCCTGGCGTACAATGTA,0,2819042
ompRp1,0.25,3,3,TACGTGCAAATACCATCTGC,0,2782055
ompRp1,0.25,3,3,TACGTCAGGGAAACTCGGGT,0,2804461
ompRp1,0.25,3,3,TACGTACCATTACACGGCAG,0,2797070
ompRp1,0.25,3,3,TACGGCCGGGAGGATGTGGT,0,2822170
ompRp1,0.25,3,3,TACGGATGACGATTAGCTAC,0,2787407
ompRp1,0.25,3,3,TACGAGTTTAGTGGGTGTAT,0,2785508
ompRp1,0.25,3,3,TACGACGGAGCCAACTCAGA,0,2798395
ompRp1,0.25,3,3,TACCTTGGAGAGCTGAAGTG,0,2804402
ompRp1,0.25,3,3,TACCGTACCAGCGTCGCCGC,0,2815348
ompRp1,0.25,3,3,TACCGGCCACGGGGATCGCC,0,2791756
ompRp1,0.25,3,3,TACCAATTGCGCGTCTTTAC,0,2821871
ompRp1,0.25,3,3,TACAGGTCAACTGTGTTTGG,0,2804911
ompRp1,0.25,3,3,TACAGCGGGCCAAGAGGAAA,0,2785144
ompRp1,0.25,3,3,TACACTTGCGGGACAGGCAT,0,2765629
ompRp1,0.25,3,3,TACACAGAACACTGTCCGGG,0,2767594
ompRp1,0.25,3,3,TACAATTATCGGTTATTGCA,0,2807247
ompRp1,0.25,3,3,TACAACACGTATCAAGAGTT,0,2801936
ompRp1,0.25,3,3,TAATTGAAACTCGTCATAGT,0,2813687
ompRp1,0.25,3,3,TAATGTTTATCGCTTGATGC,0,2809125
ompRp1,0.25,3,3,TAATGACGAAGTTCCATGCC,0,2793613
ompRp1,0.25,3,3,TAATATAACTTGGCTAGTTA,0,2785514
ompRp1,0.25,3,3,TAAGGGTGCCTCATTGCTGC,0,2795324
ompRp1,0.25,3,3,TAAGCCTTCTCAGCCATACA,0,2809305
ompRp1,0.25,3,3,TAAGCCGCACCCACACGATG,0,2807501
ompRp1,0.25,3,3,TAAGATTGTTGAACAGGATC,0,2804954
ompRp1,0.25,3,3,TAAGATTCCCCGACATTTAA,0,2807594
ompRp1,0.25,3,3,TAAGAACAAAGTCGGGGTGG,0,2803137
ompRp1,0.25,3,3,TAACTGTCCACGATAATTAC,0,2775047
ompRp1,0.25,3,3,TAACGTCCCCGAGGCATTCA,0,2784942
ompRp1,0.25,3,3,TAACAGGAGTATCCCACCGT,0,2775602
ompRp1,0.25,3,3,TAAATGTCGCCCAGATAGGA,0,2813041
ompRp1,0.25,3,3,TAAATGGTTTCGCATCACAA,0,2782686
ompRp1,0.25,3,3,TAAATCGCGTACACCTGATC,0,2807728
ompRp1,0.25,3,3,TAAAGGGTGTGAACATATTC,0,2798012
ompRp1,0.25,3,3,TAAAGGGGCGGTGGACGCCG,0,2795476
ompRp1,0.25,3,3,TAAACAATGGCGGCCCCGGA,0,2775338
ompRp1,0.25,3,3,TAAACAATCCCTGGTTTGGG,0,2766989
ompRp1,0.25,3,3,GTTTGAACCGGTTGCCGTCT,0,2814785
ompRp1,0.25,3,3,GTTTCTTTTGAAGCGGGGCT,0,2772476
ompRp1,0.25,3,3,GTTTCATCCATAGGCATACT,0,2790550
ompRp1,0.25,3,3,GTTTCAACTGCAAGGGGTCG,0,2782836
ompRp1,0.25,3,3,GTTTCAAATGGGTTTTACGG,0,2806309
ompRp1,0.25,3,3,GTTTAGTGTGGGTCGGAGTC,0,2790185
ompRp1,0.25,3,3,GTTTAGGACTCAGCTATTAG,0,2790580
ompRp1,0.25,3,3,GTTTAGCTTCCTGTCTTCCG,0,2773507
ompRp1,0.25,3,3,GTTGTCATCCTCACCGTTGG,0,2810579
ompRp1,0.25,3,3,GTTGTATATGCAGCCATCGC,0,2781618
ompRp1,0.25,3,3,GTTGGGAGGAAGGATCCATC,0,2792379
ompRp1,0.25,3,3,GTTGGCGTGTGAGACCCGGA,0,2787699
ompRp1,0.25,3,3,GTTGCGCACAAGTACTGGAC,0,2822519
ompRp1,0.25,3,3,GTTCTGGTCGATTCGCCCCG,0,2771244
ompRp1,0.25,3,3,GTTCTGGATTGGAAAATATT,0,2769257
ompRp1,0.25,3,3,GTTCGAGTATCTGATTCCAG,0,2812087
ompRp1,0.25,3,3,GTTCCTTGAGCATAGAATGC,0,2816820
ompRp1,0.25,3,3,GTTCCACGACGTGAATACGA,0,2821406
ompRp1,0.25,3,3,GTTCACATCGGACCAGTCCA,0,2781084
ompRp1,0.25,3,3,GTTCAACTTACAGATGTTGT,0,2795483
ompRp1,0.25,3,3,GTTAGGAACGGCGTGTTAGT,0,2817207
ompRp1,0.25,3,3,GTTAATAAGCGCCCAGCGGC,0,2804856
ompRp1,0.25,3,3,GTTAAGCGAGTGAGTCGGGA,0,2774516
ompRp1,0.25,3,3,GTGTGTATCCCGTGTCCAGC,0,2775681
ompRp1,0.25,3,3,GTGTGGCTCCCGATCTGCAA,0,2777631
ompRp1,0.25,3,3,GTGTCGCGGAACCCTTCCTA,0,2817732
ompRp1,0.25,3,3,GTGTCCTTAGTTCGGCTCGA,0,2811341
ompRp1,0.25,3,3,GTGTATGCATAACCGAACCG,0,2790931
ompRp1,0.25,3,3,GTGTAGATGAAGGGTGCAGT,0,2805460
ompRp1,0.25,3,3,GTGTACTGTCTAACCCTCTT,0,2779584
ompRp1,0.25,3,3,GTGGTGTTCATAACAACCAG,0,2823569
ompRp1,0.25,3,3,GTGGTGTATTGGGTTTGCGC,0,2797346
ompRp1,0.25,3,3,GTGGTAAGTTTGGGGCTGAC,0,2789783
ompRp1,0.25,3,3,GTGGGGCTTCTTTAGTCGAA,0,2767504
ompRp1,0.25,3,3,GTGGCGAAAATAGGGCACTT,0,2796966
ompRp1,0.25,3,3,GTGGCCATCATAATTTGGCG,0,2780289
ompRp1,0.25,3,3,GTGGAATCGAAGACCACTCA,0,2812177
ompRp1,0.25,3,3,GTGGAAACTGATATGGCGGT,0,2803778
ompRp1,0.25,3,3,GTGCTACCCTCGGGCGTATT,0,2810479
ompRp1,0.25,3,3,GTGCGGGCTCGTGTGTTCGG,0,2808614
ompRp1,0.25,3,3,GTGCGCCCCAACCAGCTTGG,0,2783953
ompRp1,0.25,3,3,GTGCGATCCGTTCTGCAAAG,0,2781144
ompRp1,0.25,3,3,GTGCACGAGCAAGAATCTTT,0,2817321
ompRp1,0.25,3,3,GTGCAAGTCTGTATGAAAGC,0,2789336
ompRp1,0.25,3,3,GTGATTGGACTGGTCTAATG,0,2768114
ompRp1,0.25,3,3,GTGACGCATAGCGACCGATC,0,2811863
ompRp1,0.25,3,3,GTGACCGTTCATTCATCGAG,0,2792917
ompRp1,0.25,3,3,GTGACCATGAGAGGGGCTCG,0,2810969
ompRp1,0.25,3,3,GTGACCAGCTGTCCACACCA,0,2794896
ompRp1,0.25,3,3,GTGAAGCGACTGGGACAACT,0,2812720
ompRp1,0.25,3,3,GTGAAACGTGTGCCAATGAA,0,2809860
ompRp1,0.25,3,3,GTCTTGAGGTCATTTCCGGA,0,2787256
ompRp1,0.25,3,3,GTCTGGAAAGGCGTGTTGTA,0,2794675
ompRp1,0.25,3,3,GTCTGCGTAGAGCGCTTGTG,0,2811444
ompRp1,0.25,3,3,GTCTCCCCTATCCTAGGAAA,0,2796930
ompRp1,0.25,3,3,GTCTCACGCGTGGTATGCGT,0,2783409
ompRp1,0.25,3,3,GTCTATTCCTACGCGACCAA,0,2805494
ompRp1,0.25,3,3,GTCTAGACTGCCTAGGTAGC,0,2781684
ompRp1,0.25,3,3,GTCTACAGAAGAATCGTCCC,0,2813375
ompRp1,0.25,3,3,GTCTAATGGTCTCCCAGAAA,0,2793895
ompRp1,0.25,3,3,GTCGTATTTGAATTGCTCCC,0,2796034
ompRp1,0.25,3,3,GTCGTAAAAAAATGTGGTGG,0,2800266
ompRp1,0.25,3,3,GTCGGTGGGCGCCGTCCCCC,0,2810439
ompRp1,0.25,3,3,GTCGGTCTAATTTAGAGAGC,0,2779406
ompRp1,0.25,3,3,GTCGGCGTAGAACTCGACCG,0,2790210
ompRp1,0.25,3,3,GTCGGACGTGGGTTGACCTA,0,2798542
ompRp1,0.25,3,3,GTCGCCTCGGCATTCTTTCA,0,2790762
ompRp1,0.25,3,3,GTCCTTGTGGATGTGTCATG,0,2773243
ompRp1,0.25,3,3,GTCCTGAACACCCCACATGT,0,2789744
ompRp1,0.25,3,3,GTCCGTGCCACCCGTTGACA,0,2803782
ompRp1,0.25,3,3,GTCCGTCACTAACGCATACT,0,2823156
ompRp1,0.25,3,3,GTCCGACCTGGCAAGGCCTA,0,2807394
ompRp1,0.25,3,3,GTCCGACACTGCGGCAGGGT,0,2767374
ompRp1,0.25,3,3,GTCCGAACTCTCAGCCGCGA,0,2795892
ompRp1,0.25,3,3,GTCCGAACAATGTTAATTGT,0,2819979
ompRp1,0.25,3,3,GTCCAGTCGGGAACTAGAGG,0,2771848
ompRp1,0.25,3,3,GTCCACTCCCGCGGTGAATA,0,2796675
ompRp1,0.25,3,3,GTCCACGTCATATGTGTTGG,0,2796854
ompRp1,0.25,3,3,GTCCACGGCAGCATGGACAA,0,2769126
ompRp1,0.25,3,3,GTCAGGTATAATCTACGGCT,0,2772563
ompRp1,0.25,3,3,GTCAGACCTTTGTAAGCGGC,0,2773628
ompRp1,0.25,3,3,GTCACGGCCGGTTCGGAGGA,0,2811324
ompRp1,0.25,3,3,GTCACATGGTAATGATGGCC,0,2815689
ompRp1,0.25,3,3,GTCAAGGTCCGGGATGCGGT,0,2814878
ompRp1,0.25,3,3,GTCAAATGTTTGCTGTTTTC,0,2800662
ompRp1,0.25,3,3,GTATTTTTACTTATGTCAGG,0,2776285
ompRp1,0.25,3,3,GTATTGGTGACGTAAGGGTC,0,2767789
ompRp1,0.25,3,3,GTATTGGAGAGATTGGCTTT,0,2767486
ompRp1,0.25,3,3,GTATGGCACCGGTGAAATTA,0,2812749
ompRp1,0.25,3,3,GTATGCTACGGATAAACTAA,0,2800142
ompRp1,0.25,3,3,GTATGAAATCCGATATACAG,0,2777542
ompRp1,0.25,3,3,GTATCACTTGGTTCAGCCTT,0,2784521
ompRp1,0.25,3,3,GTATATTTGCGAGCCACAAT,0,2795544
ompRp1,0.25,3,3,GTATATTTCAGGGCAGACAG,0,2766414
ompRp1,0.25,3,3,GTATACTCTCTAGAAATCAC,0,2792952
ompRp1,0.25,3,3,GTAGGTAGGGGGTGCAGCTG,0,2807420
ompRp1,0.25,3,3,GTAGGTAAGGCTTCTCTGGA,0,2774378
ompRp1,0.25,3,3,GTAGGGCATCGACTAGGAGC,0,2784641
ompRp1,0.25,3,3,GTAGGCGCTTGTTAACTGTG,0,2782692
ompRp1,0.25,3,3,GTAGCTGTAGGGGCGCTGGT,0,2824367
ompRp1,0.25,3,3,GTAGAACTCCGCCGACAAGA,0,2773870
ompRp1,0.25,3,3,GTACTGGGCTTTTCGTGACT,0,2792633
ompRp1,0.25,3,3,GTACCGCCGCAGCGTGACGA,0,2807156
ompRp1,0.25,3,3,GTACATGTAGAGATTTCTGT,0,2777898
ompRp1,0.25,3,3,GTACACGGGATGGAGATTTG,0,2785863
ompRp1,0.25,3,3,GTACAACGTTCCAGGTCGTA,0,2811479
ompRp1,0.25,3,3,GTAATGAGCTACATCCCGGA,0,2813118
ompRp1,0.25,3,3,GTAATGAAACGGCGGCATCG,0,2793260
ompRp1,0.25,3,3,GTAAGGTACCAGCTAATTTG,0,2784076
ompRp1,0.25,3,3,GTAAGCCTAAGGCACCGGGA,0,2821923
ompRp1,0.25,3,3,GTAAGACGATAGCGTCCTCC,0,2806420
ompRp1,0.25,3,3,GTAACATGGTATTTTCAGTC,0,2820273
ompRp1,0.25,3,3,GTAAATCTGCCTTCAGCATT,0,2776819
ompRp1,0.25,3,3,GTAAACCTCGGTGTGTTACA,0,2801846
ompRp1,0.25,3,3,GTAAAATGCCAACTCTTTGA,0,2799594
ompRp1,0.25,3,3,GGTTTTGACCGACGCATGAG,0,2792844
ompRp1,0.25,3,3,GGTTTGTCGAACGTGGATTA,0,2776564
ompRp1,0.25,3,3,GGTTGAACTGCCGGCGCAAT,0,2806484
ompRp1,0.25,3,3,GGTTCATTTTGGGCATATGC,0,2767873
ompRp1,0.25,3,3,GGTTCATACCGTCAGCCTTC,0,2782832
ompRp1,0.25,3,3,GGTTATGGGCTTACGAGCAA,0,2809191
ompRp1,0.25,3,3,GGTTAGTAACAAAGCGAGAG,0,2816863
ompRp1,0.25,3,3,GGTTACAGTGATACTCTTAC,0,2767330
ompRp1,0.25,3,3,GGTGTCACTCCCGTCCCAGC,0,2788418
ompRp1,0.25,3,3,GGTGGGGGTTGGTAAAGACA,0,2821883
ompRp1,0.25,3,3,GGTGGCACGATTGAATCCAT,0,2815916
ompRp1,0.25,3,3,GGTGAGAAAACGGGGGGAAC,0,2818236
ompRp1,0.25,3,3,GGTCTGCGTCGGTCGGTCCA,0,2777866
ompRp1,0.25,3,3,GGTCTGCACGGTAAGCGGAA,0,2793985
ompRp1,0.25,3,3,GGTCTAGTCCTCTGTCGTGC,0,2778414
ompRp1,0.25,3,3,GGTCTAGATTAGGGCCACGG,0,2786380
ompRp1,0.25,3,3,GGTCGGCATCTGTGTCATCT,0,2779682
ompRp1,0.25,3,3,GGTCGGATAAATCTTTTGTT,0,2819174
ompRp1,0.25,3,3,GGTCGGAAATACTGCCGGTC,0,2794880
ompRp1,0.25,3,3,GGTCGCCCGTTTACGTGGAA,0,2775545
ompRp1,0.25,3,3,GGTCCCGTATAGCAAAGGCT,0,2806209
ompRp1,0.25,3,3,GGTAGGCGGTCGGGATTAGT,0,2776749
ompRp1,0.25,3,3,GGTAGGAGATCCAAGCGTAA,0,2803100
ompRp1,0.25,3,3,GGTACAAGAGCAGAGGGGGT,0,2778367
ompRp1,0.25,3,3,GGTAATCCTCACAGTGGGTT,0,2765975
ompRp1,0.25,3,3,GGTAACGCAGGCAGTTTGGA,0,2801677
ompRp1,0.25,3,3,GGGTTGGAATGTAGCGCATC,0,2807287
ompRp1,0.25,3,3,GGGTTCCCGTCATGTTCCGG,0,2805068
ompRp1,0.25,3,3,GGGTTAGGATGAGCCTATCG,0,2806960
ompRp1,0.25,3,3,GGGTCGGTAGAGGGTTACCA,0,2787731
ompRp1,0.25,3,3,GGGTACTACTATGCCGAAAT,0,2819765
ompRp1,0.25,3,3,GGGTACCGGTGCCTTTTTGT,0,2779864
ompRp1,0.25,3,3,GGGGTAGCCCGATGGCCGTG,0,2779768
ompRp1,0.25,3,3,GGGGGTGGACCGTCTACGAC,0,2766334
ompRp1,0.25,3,3,GGGGGCTCTTTTTGAAGTAC,0,2778247
ompRp1,0.25,3,3,GGGGGATTTAAGAGCTAGAA,0,2792918
ompRp1,0.25,3,3,GGGGGACAATTTTTACCACC,0,2809872
ompRp1,0.25,3,3,GGGGGAATTCCCTAAGGCGC,0,2821717
ompRp1,0.25,3,3,GGGGCGGCGGCGAGATTCTT,0,2790908
ompRp1,0.25,3,3,GGGGAGATTACTTTTCGCTT,0,2782129
ompRp1,0.25,3,3,GGGGACAAAAGGATAATCGT,0,2813159
ompRp1,0.25,3,3,GGGCTTTGATTTCGTATGAC,0,2785781
ompRp1,0.25,3,3,GGGCTTCCGGTGTGGTTGAT,0,2821438
ompRp1,0.25,3,3,GGGCTGCGCGCGGCCCCCTT,0,2802475
ompRp1,0.25,3,3,GGGCTCGGTCTATTGTGGAA,0,2804739
ompRp1,0.25,3,3,GGGCGTGGCAATCGTGTGCT,0,2813196
ompRp1,0.25,3,3,GGGCGGAATTGTCAAGCCAG,0,2812379
ompRp1,0.25,3,3,GGGCCTTACAACGGAAAAAA,0,2770668
ompRp1,0.25,3,3,GGGCCGTCACTTTGGATAGA,0,2780237
ompRp1,0.25,3,3,GGGATTACACGGCTGTTTAG,0,2823932
ompRp1,0.25,3,3,GGGATGTTACTCGTACACTC,0,2766715
ompRp1,0.25,3,3,GGGATGGAGCTCAACGCATC,0,2795597
ompRp1,0.25,3,3,GGGATGAATGTTTGTTTCCA,0,2787774
ompRp1,0.25,3,3,GGGATCCATGGGCCATCAAA,0,2810861
ompRp1,0.25,3,3,GGGAGTTGGGACAGGGCTAA,0,2779311
ompRp1,0.25,3,3,GGGACGTAGAGCCCCATATG,0,2794030
ompRp1,0.25,3,3,GGGACATATGGCCGGTCCCA,0,2785476
ompRp1,0.25,3,3,GGGAAGTGCTAGACGTGAGC,0,2769152
ompRp1,0.25,3,3,GGGAAGTCCGGAATCAATGC,0,2781998
ompRp1,0.25,3,3,GGGAAGCAGTAATAGTTCTT,0,2769284
ompRp1,0.25,3,3,GGGAACAACTGCCGAGCAGT,0,2823176
ompRp1,0.25,3,3,GGCTTCCCCGTTCTGAAATG,0,2792212
ompRp1,0.25,3,3,GGCTGTACCACTGTCTGTAA,0,2783585
ompRp1,0.25,3,3,GGCTCTAAGCGTCGCGGGGA,0,2776688
ompRp1,0.25,3,3,GGCTCAGTGATGGTTAGTGC,0,2774057
ompRp1,0.25,3,3,GGCTAATCTTCCGGTAAGCA,0,2788207
ompRp1,0.25,3,3,GGCTAAGAAAAGGATCCAGC,0,2773110
ompRp1,0.25,3,3,GGCGTTTGGCATGAGTCATG,0,2800624
ompRp1,0.25,3,3,GGCGTGCCACCAGACCGTGC,0,2807295
ompRp1,0.25,3,3,GGCGTCTATCCTCAAAAAAA,0,2796552
ompRp1,0.25,3,3,GGCGTATGTCGTCTTTAAAT,0,2811532
ompRp1,0.25,3,3,GGCGGCGGTGCAATATACTA,0,2794606
ompRp1,0.25,3,3,GGCGGCGACTAGCGGAGGTT,0,2807752
ompRp1,0.25,3,3,GGCGGCATTGACAATAAATA,0,2773641
ompRp1,0.25,3,3,GGCGCGGCAAGCGTAGTGGG,0,2796736
ompRp1,0.25,3,3,GGCGCACGTTATAGCACCTA,0,2782851
ompRp1,0.25,3,3,GGCGCAATAGTCGAGCCGCT,0,2775110
ompRp1,0.25,3,3,GGCCGTTACTCCACGAAATA,0,2801322
ompRp1,0.25,3,3,GGCCGGCCTTAGTTCATGAA,0,2786108
ompRp1,0.25,3,3,GGCCAAAGCGCGTGCTTCAG,0,2767246
ompRp1,0.25,3,3,GGCATTGCCTGGCGGCACCT,0,2822758
ompRp1,0.25,3,3,GGCATTCTAGTAGGTGAGTG,0,2824072
ompRp1,0.25,3,3,GGCATCGTGGTCTTCGCGTC,0,2779229
ompRp1,0.25,3,3,GGCAGTTTAACAATCGGCCC,0,2774384
ompRp1,0.25,3,3,GGCAGCATTCCGAACTAGAT,0,2811376
ompRp1,0.25,3,3,GGCACGGCGGGGTGACAGAC,0,2770864
ompRp1,0.25,3,3,GGCACAGAGACATTGAAAAG,0,2821767
ompRp1,0.25,3,3,GGCAACATACTCAGTGTTAA,0,2800817
ompRp1,0.25,3,3,GGATGGTCAACAACTGTTCA,0,2799539
ompRp1,0.25,3,3,GGATCACCATCGGTTCGGCG,0,2805929
ompRp1,0.25,3,3,GGATCAATCACGAGGTGTTT,0,2795885
ompRp1,0.25,3,3,GGATATGGCAGCAGCCGACT,0,2774607
ompRp1,0.25,3,3,GGATATAGGTAGATTGGTGC,0,2817192
ompRp1,0.25,3,3,GGATAGGCTGATAGAATATG,0,2768593
ompRp1,0.25,3,3,GGATACTTTGCATGGATGCA,0,2782574
ompRp1,0.25,3,3,GGATAAAGATCCTATTACGT,0,2806614
ompRp1,0.25,3,3,GGATAAACTAAGGTCTCTAG,0,2796843
ompRp1,0.25,3,3,GGAGGGCGGTTTTCGATGCC,0,2804704
ompRp1,0.25,3,3,GGAGGCTTATCTAGGCGGCT,0,2796807
ompRp1,0.25,3,3,GGAGGATAAAAAACTTGGAG,0,2765501
ompRp1,0.25,3,3,GGAGGAGGTCGGCGGGGAAG,0,2802500
ompRp1,0.25,3,3,GGAGCTGACACTGTGCCGTA,0,2776864
ompRp1,0.25,3,3,GGAGATCCCTGTGCCGGTCT,0,2789176
ompRp1,0.25,3,3,GGAGAGGAGCACGGTCTGAA,0,2807684
ompRp1,0.25,3,3,GGACTTGTTCTTTGGTCCTG,0,2817842
ompRp1,0.25,3,3,GGACTGTTGGGCCATGAGAT,0,2814676
ompRp1,0.25,3,3,GGACGTCAACCAAGGGTAGC,0,2813303
ompRp1,0.25,3,3,GGACGGTCATTTGTGGTAAT,0,2823232
ompRp1,0.25,3,3,GGACGCGATCTCTAATAGAC,0,2767426
ompRp1,0.25,3,3,GGACCTACCTAAGCCGCAAA,0,2815725
ompRp1,0.25,3,3,GGACCGCACTGTATTTTGCA,0,2823967
ompRp1,0.25,3,3,GGACCGAAACTGTTCCGTCT,0,2820736
ompRp1,0.25,3,3,GGAATCTCAGTCGGCCCAGA,0,2774492
ompRp1,0.25,3,3,GGAATAGGCTCCAATCCGCT,0,2779533
ompRp1,0.25,3,3,GGAAGGCCGCGAGGCGACCA,0,2777996
ompRp1,0.25,3,3,GGAAGACTCAGCTCAGCTGT,0,2788585
ompRp1,0.25,3,3,GGAAGAAGCGGACTAATGTG,0,2782505
ompRp1,0.25,3,3,GGAACCTCCACTTTCACAGG,0,2772582
ompRp1,0.25,3,3,GGAAAGAATCTTAAAATAGT,0,2824216
ompRp1,0.25,3,3,GGAAACGTTTCAGCGGAGTG,0,2792667
ompRp1,0.25,3,3,GGAAACCGACTATGAATTAA,0,2821955
ompRp1,0.25,3,3,GGAAAAACGTCATGTGAGGC,0,2790812
ompRp1,0.25,3,3,GCTTTCACCGCTAGAGGCCT,0,2812937
ompRp1,0.25,3,3,GCTTGTCTATCGCTGCGAGT,0,2808116
ompRp1,0.25,3,3,GCTTGCGCTATGCCCGAGAT,0,2817462
ompRp1,0.25,3,3,GCTTCTTTAATTTCATCGGT,0,2812239
ompRp1,0.25,3,3,GCTTCAGACGCAGCCTTGTC,0,2793790
ompRp1,0.25,3,3,GCTTATCAAAGCTGGTTGTG,0,2783800
ompRp1,0.25,3,3,GCTTAGTGGGGACGTTGGGT,0,2797036
ompRp1,0.25,3,3,GCTTAGGTTATGGATGCATC,0,2773184
ompRp1,0.25,3,3,GCTTACGCAAGCGACCGCGA,0,2786458
ompRp1,0.25,3,3,GCTTAAACTCAGTCTCCACA,0,2766669
ompRp1,0.25,3,3,GCTGTTGAATTGTATCACGG,0,2792010
ompRp1,0.25,3,3,GCTGTGTCAGTAAGTGCAAC,0,2792297
ompRp1,0.25,3,3,GCTGTCCGCAACTTTGGTGG,0,2780326
ompRp1,0.25,3,3,GCTGGCGGTCTTGCCGTGGA,0,2798752
ompRp1,0.25,3,3,GCTGCGCTGTAGCCTTCAGA,0,2824077
ompRp1,0.25,3,3,GCTGCATAATCTTTATATGT,0,2810524
ompRp1,0.25,3,3,GCTCGCGCAAGGTTTGGCTT,0,2782906
ompRp1,0.25,3,3,GCTCCTGAAGAGTCATTGAA,0,2785685
ompRp1,0.25,3,3,GCTCCAGTGAGCATCAGGCA,0,2801867
ompRp1,0.25,3,3,GCTCAGCTGGTTGTTGGGTC,0,2804746
ompRp1,0.25,3,3,GCTCAGAAGCAATGCGCCGT,0,2821580
ompRp1,0.25,3,3,GCTATGGCTGTAACGGGGTC,0,2781403
ompRp1,0.25,3,3,GCTAGTGGACCTTAAAACTT,0,2805332
ompRp1,0.25,3,3,GCTAGGTTACACCGACTCGT,0,2793787
ompRp1,0.25,3,3,GCTAGGCTACGCGTACACCT,0,2782690
ompRp1,0.25,3,3,GCTAGGAAAGGGGTGGTCGA,0,2807933
ompRp1,0.25,3,3,GCTACGATCTTCCAATACTC,0,2791162
ompRp1,0.25,3,3,GCTACCGTCTAAGTTAGTTA,0,2797972
ompRp1,0.25,3,3,GCGTTGGATTGACTCTACAG,0,2799502
ompRp1,0.25,3,3,GCGTTAAGTAAGGTCCACGG,0,2807375
ompRp1,0.25,3,3,GCGTGAACTTATACGAAGCG,0,2769073
ompRp1,0.25,3,3,GCGTCGCGCTACGGATTCAA,0,2766279
ompRp1,0.25,3,3,GCGTCAGCCGCGTGGGACTC,0,2800105
ompRp1,0.25,3,3,GCGTACCATAGGCGGCGCTA,0,2774533
ompRp1,0.25,3,3,GCGGTAGCTCCAGGTCACCA,0,2797530
ompRp1,0.25,3,3,GCGGGTGTTTCGTCATTGTG,0,2789123
ompRp1,0.25,3,3,GCGGGTATTAAAGCCGTGTT,0,2822905
ompRp1,0.25,3,3,GCGGGGCGTTGGGTTTGAGT,0,2810345
ompRp1,0.25,3,3,GCGGGGCCGATACCATTAAT,0,2820885
ompRp1,0.25,3,3,GCGGGCCAGAGTTTGCATAA,0,2804567
ompRp1,0.25,3,3,GCGGCAGGTCGTCGATAAAT,0,2775700
ompRp1,0.25,3,3,GCGGATCGTTCTTTAATGCT,0,2795207
ompRp1,0.25,3,3,GCGCGTATAGGCAAGTTGCC,0,2767633
ompRp1,0.25,3,3,GCGCATTGGATATATTATTC,0,2793394
ompRp1,0.25,3,3,GCGCATGTTCGAAAGCTGAT,0,2772049
ompRp1,0.25,3,3,GCGCAGAGCGCATATTAGGC,0,2808772
ompRp1,0.25,3,3,GCGCACCAGGGTTCAAGAGT,0,2787698
ompRp1,0.25,3,3,GCGATGTATCGTTTTGTCAG,0,2820984
ompRp1,0.25,3,3,GCGATCGGGTCTAAGTCCCC,0,2784336
ompRp1,0.25,3,3,GCGATCCGGGATCGTAAAAG,0,2823117
ompRp1,0.25,3,3,GCGATATCAACCTTATTTGT,0,2788609
ompRp1,0.25,3,3,GCGAGCCTGGAATTGCGGGT,0,2823979
ompRp1,0.25,3,3,GCGACCTCGACAACGTAAAG,0,2797884
ompRp1,0.25,3,3,GCGACAGCTTGTGACGGTAA,0,2773922
ompRp1,0.25,3,3,GCGAAGTTCTGGTCCACGAG,0,2798648
ompRp1,0.25,3,3,GCCTTGTAGGTAGTGAATTG,0,2801538
ompRp1,0.25,3,3,GCCTTGGCAGTGGCTTCGGC,0,2784994
ompRp1,0.25,3,3,GCCTTGGAGGTAACCTTTAT,0,2782260
ompRp1,0.25,3,3,GCCTTCCCCAGAAGGTTTAA,0,2790168
ompRp1,0.25,3,3,GCCTTACGTCGGATGGTTTC,0,2782551
ompRp1,0.25,3,3,GCCTGTACAGAACGTCTAGA,0,2788050
ompRp1,0.25,3,3,GCCTCCGCGTTATGAGGGCT,0,2820009
ompRp1,0.25,3,3,GCCTCCAGCCATTAGCATCT,0,2787619
ompRp1,0.25,3,3,GCCTCCACGGATAACGAGAC,0,2770291
ompRp1,0.25,3,3,GCCTACGGGATTGATGATGG,0,2785994
ompRp1,0.25,3,3,GCCGTGTGGCAGTGATCAGC,0,2818626
ompRp1,0.25,3,3,GCCGGCAGCTGAAGCAGTGT,0,2784648
ompRp1,0.25,3,3,GCCGCGCCTTTTTTTGTCGC,0,2795709
ompRp1,0.25,3,3,GCCGACTTAACGAGCTCATT,0,2766054
ompRp1,0.25,3,3,GCCGAATACCTCTGGCGGCC,0,2779932
ompRp1,0.25,3,3,GCCCTTCAATAATGATTTAA,0,2807481
ompRp1,0.25,3,3,GCCCTATTGTCATGACGTGC,0,2813172
ompRp1,0.25,3,3,GCCCGTAAATACGAAATGTC,0,2782788
ompRp1,0.25,3,3,GCCCGGTGGGGGTGATTCGT,0,2818024
ompRp1,0.25,3,3,GCCCCGGACTTCGATTCCCT,0,2766345
ompRp1,0.25,3,3,GCCCATCTAAGTGCACGGAG,0,2814493
ompRp1,0.25,3,3,GCCCACTCTACCAATGATAT,0,2789685
ompRp1,0.25,3,3,GCCATGCGGATTAAAATTCC,0,2805593
ompRp1,0.25,3,3,GCCATCGGCTAATACCCGCA,0,2770946
ompRp1,0.25,3,3,GCCATCCCCCGATCTTGGAC,0,2769464
ompRp1,0.25,3,3,GCCATCAACTGAGTCGTCAA,0,2772268
ompRp1,0.25,3,3,GCCAGTTACGTTCAGAAAGC,0,2801009
ompRp1,0.25,3,3,GCCACCTTTGTGGAAATAAC,0,2805763
ompRp1,0.25,3,3,GCCAAGGTCAGACTTGGCCT,0,2769359
ompRp1,0.25,3,3,GCCAAGAAAATCAATGAGTA,0,2823203
ompRp1,0.25,3,3,GCCAACGGGACCTGCTTAAG,0,2812484
ompRp1,0.25,3,3,GCCAACGAAACCTTTATTAC,0,2776865
ompRp1,0.25,3,3,GCATTGACACGGCGCTTTTG,0,2801155
ompRp1,0.25,3,3,GCATGTATAGGGATTCGCTC,0,2790866
ompRp1,0.25,3,3,GCATCGAGACTCCAGAGGTC,0,2786870
ompRp1,0.25,3,3,GCATCATTTGAGCTGAAAGT,0,2766060
ompRp1,0.25,3,3,GCATAGTCTATACCCAGTGG,0,2815445
ompRp1,0.25,3,3,GCAGTCGGGAGCACCGGGAC,0,2768349
ompRp1,0.25,3,3,GCAGCCTCAGGGTAGTTAGA,0,2768707
ompRp1,0.25,3,3,GCAGATGTGAGGACCAGGAG,0,2822400
ompRp1,0.25,3,3,GCAGAATGGCGATGTCAAAG,0,2823583
ompRp1,0.25,3,3,GCAGAAAGCAGGTGAGCTTC,0,2777755
ompRp1,0.25,3,3,GCACTAAGGTCGGCATGGGA,0,2775581
ompRp1,0.25,3,3,GCACGGCAAGCGTACGAAGA,0,2803994
ompRp1,0.25,3,3,GCACGAAAAAGGTTGAGTAA,0,2778029
ompRp1,0.25,3,3,GCACCAAGTGCATAGGTTCG,0,2796410
ompRp1,0.25,3,3,GCACACGGGGTGAAAGTGTG,0,2793388
ompRp1,0.25,3,3,GCAATTGAACGAGAAGGTGG,0,2775206
ompRp1,0.25,3,3,GCAATACCCTTGCCTTCAGA,0,2816175
ompRp1,0.25,3,3,GCAAGAGAACATTCGGGAAC,0,2767227
ompRp1,0.25,3,3,GCAACAGACTGTACGTAACG,0,2782895
ompRp1,0.25,3,3,GATTTGTATTTCAGCTAGTT,0,2767801
ompRp1,0.25,3,3,GATTTGAATGCTGGTATTAA,0,2773804
ompRp1,0.25,3,3,GATTTCCAGACTCACCCATC,0,2813576
ompRp1,0.25,3,3,GATTTATGGCGCAGTGATAG,0,2782381
ompRp1,0.25,3,3,GATTGCCTGATCGGGCCTAG,0,2769985
ompRp1,0.25,3,3,GATTGAGCAAGGTAAGGTCA,0,2794416
ompRp1,0.25,3,3,GATTAGGGCTAAAGTAGAAA,0,2796622
ompRp1,0.25,3,3,GATTACACCGACTAAGGTGG,0,2803649
ompRp1,0.25,3,3,GATGTGATGAAAGAGTACGT,0,2803956
ompRp1,0.25,3,3,GATGGTTAAACGTACGGGCT,0,2775758
ompRp1,0.25,3,3,GATGGCCCGTAGACAATGCC,0,2798265
ompRp1,0.25,3,3,GATGCACGCTACAAACATGC,0,2790648
ompRp1,0.25,3,3,GATGAATAAAATAGCGACTG,0,2774756
ompRp1,0.25,3,3,GATCTGGGTGATTCTTACCG,0,2769534
ompRp1,0.25,3,3,GATCTCGCCTAGCTTGAACT,0,2771447
ompRp1,0.25,3,3,GATCGGCAGCTCATGACTAC,0,2803215
ompRp1,0.25,3,3,GATCGGAGTGATGGCGCTGT,0,2822217
ompRp1,0.25,3,3,GATCGGAGGCTCCAGCCGTT,0,2770552
ompRp1,0.25,3,3,GATCCGCAACTGCCATGGTC,0,2805999
ompRp1,0.25,3,3,GATCAACTTATTGTCAGTGA,0,2773549
ompRp1,0.25,3,3,GATAGCTCGCGGTCTGTGTG,0,2793878
ompRp1,0.25,3,3,GATAGAACTGGCGATATTAA,0,2801618
ompRp1,0.25,3,3,GATAGAAAAAGTGATGCCCA,0,2821426
ompRp1,0.25,3,3,GATACCAATCCGTACAGAAT,0,2798643
ompRp1,0.25,3,3,GAGTTGCCCGAGTGACCCGT,0,2812136
ompRp1,0.25,3,3,GAGTTCGTTCCTTGGATCCG,0,2812715
ompRp1,0.25,3,3,GAGTGTTATTGATGTCCCTG,0,2781972
ompRp1,0.25,3,3,GAGTGTGCGTGCTATATGAT,0,2804152
ompRp1,0.25,3,3,GAGTGTCGTTGGATTCATCC,0,2772908
ompRp1,0.25,3,3,GAGTGATATGGTCCCTACTA,0,2784894
ompRp1,0.25,3,3,GAGTCGCGGGACATTTGTAT,0,2783907
ompRp1,0.25,3,3,GAGTCCGGAACACAGGTAGG,0,2766921
ompRp1,0.25,3,3,GAGTCACAACGCGGGTCTGC,0,2773824
ompRp1,0.25,3,3,GAGTATCTGCCCCGAATGAA,0,2770633
ompRp1,0.25,3,3,GAGTAGGCTTTACACATTTC,0,2777494
ompRp1,0.25,3,3,GAGTACCAATGCACCCGGGT,0,2774097
ompRp1,0.25,3,3,GAGTAATAATTAAATAAGAG,0,2804020
ompRp1,0.25,3,3,GAGTAACCATTGGGTTGTCT,0,2770287
ompRp1,0.25,3,3,GAGGGTCCTAGGCCGATCTC,0,2798842
ompRp1,0.25,3,3,GAGGGTCACGTAGTGGTGAG,0,2795779
ompRp1,0.25,3,3,GAGGCTGGTGCCTCTCAAAG,0,2817570
ompRp1,0.25,3,3,GAGGCGTATCTCTCAAGGAC,0,2787386
ompRp1,0.25,3,3,GAGGCGGATGGAGCATAAGT,0,2809130
ompRp1,0.25,3,3,GAGGCGCCCACTTGGGTGCG,0,2806798
ompRp1,0.25,3,3,GAGGCCTAGTGTATTTGTAT,0,2769715
ompRp1,0.25,3,3,GAGGAGAACGAGCCGCAGTA,0,2798817
ompRp1,0.25,3,3,GAGCTTGTTTAGAGAGGGCA,0,2777119
ompRp1,0.25,3,3,GAGCGTGGGTTGTGGCTCAC,0,2800757
ompRp1,0.25,3,3,GAGCGCCACGCAGAGGGGCG,0,2765878
ompRp1,0.25,3,3,GAGCATTTTGCGCACCGCTT,0,2810738
ompRp1,0.25,3,3,GAGCATGCCACAGCGTGATT,0,2793158
ompRp1,0.25,3,3,GAGCATAACTCGATTCTTAG,0,2766298
ompRp1,0.25,3,3,GAGCACCTGGGACATTCATA,0,2772834
ompRp1,0.25,3,3,GAGATGGATGGCTGGGCACA,0,2780940
ompRp1,0.25,3,3,GAGATCCCGACGGCGTCTGT,0,2787231
ompRp1,0.25,3,3,GAGAGTCCAAACATTCAAAT,0,2797119
ompRp1,0.25,3,3,GAGAGGTATGCGGAACACGA,0,2790617
ompRp1,0.25,3,3,GAGAGGCGGACTGGGGCAGA,0,2814266
ompRp1,0.25,3,3,GAGACCGAAGCAACACAGGG,0,2813272
ompRp1,0.25,3,3,GACTTCTGGCTAACTCTGTG,0,2768131
ompRp1,0.25,3,3,GACTGGGTTGTGTCTACTCA,0,2788833
ompRp1,0.25,3,3,GACGGTGTACTAGAATCCAT,0,2799946
ompRp1,0.25,3,3,GACGGGAGATTGCCCTATGT,0,2797345
ompRp1,0.25,3,3,GACGGCCCAGTGGTCTGAGT,0,2821382
ompRp1,0.25,3,3,GACGCTGTGTGAGGCCCGGG,0,2794901
ompRp1,0.25,3,3,GACGATCTCATATCAGAGAC,0,2794808
ompRp1,0.25,3,3,GACCTAGCTGTGTCTGTGTA,0,2769139
ompRp1,0.25,3,3,GACCGAGGTGTGGTCACCGG,0,2765525
ompRp1,0.25,3,3,GACCCCCCCTGACACTATAA,0,2777174
ompRp1,0.25,3,3,GACCATTCTTGGTTCAGGCA,0,2816960
ompRp1,0.25,3,3,GACCACAGGGGATGTATAAG,0,2807850
ompRp1,0.25,3,3,GACATAGATCGTCCGAGTGG,0,2778816
ompRp1,0.25,3,3,GACATAACGGCAACAATATG,0,2789979
ompRp1,0.25,3,3,GACACTCCGCGAGATGCTTT,0,2821337
ompRp1,0.25,3,3,GACACAATTGCAGCGTCGGG,0,2791608
ompRp1,0.25,3,3,GACAATTGGTAAGGCCGTAT,0,2801911
ompRp1,0.25,3,3,GACAAGCGAGTGATAGGCTC,0,2768768
ompRp1,0.25,3,3,GACAACAGTCACTAAGATTT,0,2816833
ompRp1,0.25,3,3,GAATGCCGGCGGGTACCGGG,0,2782569
ompRp1,0.25,3,3,GAATAGGCGAGCTCGGCATC,0,2772826
ompRp1,0.25,3,3,GAAGTGTGGGTTGAAATGTT,0,2822526
ompRp1,0.25,3,3,GAAGGCACAGCTATGTGTTG,0,2766781
ompRp1,0.25,3,3,GAACGTGCGCCCGATGTGGG,0,2789525
ompRp1,0.25,3,3,GAACGCCAATCAAGAACAAT,0,2809582
ompRp1,0.25,3,3,GAACGAACGCGTGGTGAACC,0,2786508
ompRp1,0.25,3,3,GAACCGCGTAACAAGGAAGA,0,2789419
ompRp1,0.25,3,3,GAACCAATTAACTCAGAGCC,0,2791518
ompRp1,0.25,3,3,GAACACTAGAAACACACCCT,0,2818003
ompRp1,0.25,3,3,GAAAGAAGGAGACGATCGAT,0,2801311
ompRp1,0.25,3,3,GAAAAGCAGATAGACACGGG,0,2801219
ompRp1,0.25,3,3,CTTTTCTTGTCAAATCCTTC,0,2819577
ompRp1,0.25,3,3,CTTTTCGCAATGGGCTTAGG,0,2798248
ompRp1,0.25,3,3,CTTTTAAATGCAACATTAAT,0,2783844
ompRp1,0.25,3,3,CTTTGTGGGTCGTCAGTTCA,0,2791171
ompRp1,0.25,3,3,CTTTACCGAGTGGCTCGCCC,0,2773954
ompRp1,0.25,3,3,CTTTAAACATCTAGTTTGCC,0,2819695
ompRp1,0.25,3,3,CTTGTTGATTTGGCTATCAT,0,2775651
ompRp1,0.25,3,3,CTTGTTCCATTCGGGGAGGC,0,2770715
ompRp1,0.25,3,3,CTTGTCGAGCATTCGAAAGG,0,2809601
ompRp1,0.25,3,3,CTTGTAGGCTTAATCATTGA,0,2782102
ompRp1,0.25,3,3,CTTGGCGTGTCCTCTCAAAT,0,2806969
ompRp1,0.25,3,3,CTTGGCGGGTAAAATTTAAA,0,2800517
ompRp1,0.25,3,3,CTTGCTAAAGCTCGTGACGT,0,2781538
ompRp1,0.25,3,3,CTTGAGACTCTTAGCTAGGT,0,2778220
ompRp1,0.25,3,3,CTTGAATGTATGTGTTTCAA,0,2778337
ompRp1,0.25,3,3,CTTCTTGAGGGCTTCAGAAC,0,2816488
ompRp1,0.25,3,3,CTTCTGTGAGCAAATATTCT,0,2795204
ompRp1,0.25,3,3,CTTCTGAATCGACTCAGCTG,0,2769427
ompRp1,0.25,3,3,CTTCTCGATCGTTCCTATTA,0,2773176
ompRp1,0.25,3,3,CTTCGTGTCGGGATAAGCCC,0,2773170
ompRp1,0.25,3,3,CTTCGCATCACACCCGATAT,0,2800441
ompRp1,0.25,3,3,CTTCAGCGGAGTCTCTAGAT,0,2769559
ompRp1,0.25,3,3,CTTCACGCGTACGAGATTCC,0,2812194
ompRp1,0.25,3,3,CTTCAATGGATCTTTTATTC,0,2774712
ompRp1,0.25,3,3,CTTCAAAGTTCTTGTAAGTC,0,2775252
ompRp1,0.25,3,3,CTTATGTCAGAGGACGCTGT,0,2781792
ompRp1,0.25,3,3,CTTAGTGGGAATCTTGCTGT,0,2774659
ompRp1,0.25,3,3,CTTAGCCATTCCCAAAACAC,0,2809931
ompRp1,0.25,3,3,CTTACTACATGAACCTGCCT,0,2815675
ompRp1,0.25,3,3,CTGTTGCAACTACGAACACT,0,2779427
ompRp1,0.25,3,3,CTGTTAGGCGTGACTTGACT,0,2802491
ompRp1,0.25,3,3,CTGTGTTTTCAGAAATGATA,0,2820945
ompRp1,0.25,3,3,CTGTGGCAGGGTACCAAGTT,0,2799911
ompRp1,0.25,3,3,CTGTCTGATGGGTGGTCCGC,0,2774346
ompRp1,0.25,3,3,CTGTATCGCCCGCGATACGG,0,2770136
ompRp1,0.25,3,3,CTGTATCAACCTCGTGGTCA,0,2806252
ompRp1,0.25,3,3,CTGTACTCCTGCCCTTGTGC,0,2776264
ompRp1,0.25,3,3,CTGTAAACGCGTAGGCGAAG,0,2778827
ompRp1,0.25,3,3,CTGGTCTACCGACAGAGAAC,0,2767385
ompRp1,0.25,3,3,CTGGTCATTGGAATTACCAT,0,2771160
ompRp1,0.25,3,3,CTGGTCACCCTGGTGAGAGG,0,2795213
ompRp1,0.25,3,3,CTGGTATGATCGCTAGGATA,0,2804981
ompRp1,0.25,3,3,CTGGCGAGCAACTTGGTGTC,0,2808119
ompRp1,0.25,3,3,CTGGCGACGTTGAAATCACC,0,2773910
ompRp1,0.25,3,3,CTGGACTGGAGACGGTATGT,0,2788035
ompRp1,0.25,3,3,CTGCTCTCGAAAGCACTCGT,0,2783986
ompRp1,0.25,3,3,CTGCGGTTAGTCTGACAACA,0,2783968
ompRp1,0.25,3,3,CTGCGGCTGCGTGTTTTACT,0,2797438
ompRp1,0.25,3,3,CTGCGCCGCCCACATCGCAA,0,2785848
ompRp1,0.25,3,3,CTGCCGGATTCTGGGCTAAT,0,2823141
ompRp1,0.25,3,3,CTGCCACATGACCCGGGGAG,0,2795630
ompRp1,0.25,3,3,CTGCAAATTGACAAGCGTTG,0,2817737
ompRp1,0.25,3,3,CTGATCGGTTCTTATGAATG,0,2785185
ompRp1,0.25,3,3,CTGACGCAAAACTGACGTCT,0,2780107
ompRp1,0.25,3,3,CTGACCGGCGCCTGCGAGTG,0,2767472
ompRp1,0.25,3,3,CTGACAGCCGATGCCAGAAG,0,2795171
ompRp1,0.25,3,3,CTGAACGTAGCTAGACTAAG,0,2803775
ompRp1,0.25,3,3,CTCTTGGCTTCGAATTAATC,0,2813724
ompRp1,0.25,3,3,CTCTTGCAGTGAACTAAACT,0,2774360
ompRp1,0.25,3,3,CTCTTCATCCAATGATAGCT,0,2770529
ompRp1,0.25,3,3,CTCTGCAATTCGAAGGCACA,0,2814397
ompRp1,0.25,3,3,CTCTGATAGGACCGCTAGTT,0,2807954
ompRp1,0.25,3,3,CTCTGAACCCTCGGGGGAAA,0,2774999
ompRp1,0.25,3,3,CTCTCCTGGTCACCTCGAAC,0,2809914
ompRp1,0.25,3,3,CTCTCCCGTGGAGGTGGTTC,0,2823613
ompRp1,0.25,3,3,CTCTCCAGTGGATTGGATCT,0,2805501
ompRp1,0.25,3,3,CTCTCACTAGAATGCCAGCT,0,2806799
ompRp1,0.25,3,3,CTCTACCGGGCACAGGGAAC,0,2795006
ompRp1,0.25,3,3,CTCGTGGCTGTTTAGCGTAT,0,2769864
ompRp1,0.25,3,3,CTCGGTGTGGAAGATTTGAA,0,2793230
ompRp1,0.25,3,3,CTCGGTGAAACCGGTCTGGC,0,2765812
ompRp1,0.25,3,3,CTCGGCCACACCAAACCTAG,0,2780430
ompRp1,0.25,3,3,CTCGGAAAAATTGTTGAGTA,0,2817402
ompRp1,0.25,3,3,CTCGCCTATACCGAGGTAAC,0,2795280
ompRp1,0.25,3,3,CTCGCATCTGGGTTGTCTAT,0,2805631
ompRp1,0.25,3,3,CTCGACACGGGATGGCGTTA,0,2784778
ompRp1,0.25,3,3,CTCCGTTCGCGCATTAAGAG,0,2778526
ompRp1,0.25,3,3,CTCCGCCAGTCGGGCGCGCT,0,2766425
ompRp1,0.25,3,3,CTCCGATATTAGTCATGTTA,0,2811018
ompRp1,0.25,3,3,CTCCGATAACCCAATTCTCG,0,2819408
ompRp1,0.25,3,3,CTCCCCAGGCCCATATATGT,0,2812611
ompRp1,0.25,3,3,CTCCCATCAACCGTAGGTAA,0,2766795
ompRp1,0.25,3,3,CTCCAATGTGTCGAACTGTT,0,2774667
ompRp1,0.25,3,3,CTCATGTGTTAGAGGCACAA,0,2816697
ompRp1,0.25,3,3,CTCATCCACGCGGCCCCTCC,0,2792793
ompRp1,0.25,3,3,CTCACTGCTGGCGTCGAGGA,0,2798186
ompRp1,0.25,3,3,CTCACCTGATTCGGTGCCGC,0,2796145
ompRp1,0.25,3,3,CTCACCGATGACATATTCTT,0,2802089
ompRp1,0.25,3,3,CTCACAATCAGATCATACAA,0,2819173
ompRp1,0.25,3,3,CTCAATGCTCCATGGGAAAA,0,2783177
ompRp1,0.25,3,3,CTCAAGGGGGGAGCTTTGAC,0,2785471
ompRp1,0.25,3,3,CTCAAATCTAACAGCAGGCT,0,2808738
ompRp1,0.25,3,3,CTATTTCCGCTCCGATATGT,0,2822104
ompRp1,0.25,3,3,CTATTTCAATCCTCAAAGTT,0,2819484
ompRp1,0.25,3,3,CTATTAGCTGGGTTTTGTCC,0,2798830
ompRp1,0.25,3,3,CTATGGTTGTCTCGGGTTGC,0,2820849
ompRp1,0.25,3,3,CTATGGCCTATACGAATTAG,0,2785461
ompRp1,0.25,3,3,CTATGGCATGTGTCTCCAGA,0,2797493
ompRp1,0.25,3,3,CTATGCCTACAGTTTGAGCA,0,2782930
ompRp1,0.25,3,3,CTATAGTCGTCTGCGCAGAG,0,2780548
ompRp1,0.25,3,3,CTATAGACCGGTGGCGCCAG,0,2801488
ompRp1,0.25,3,3,CTATACACTGCGTGTCCTCC,0,2772879
ompRp1,0.25,3,3,CTATAAGAATATCATTTCGG,0,2771025
ompRp1,0.25,3,3,CTAGTTCAGCTACGATTGGA,0,2767067
ompRp1,0.25,3,3,CTAGGTATCATCACCCTCGC,0,2800164
ompRp1,0.25,3,3,CTAGGCAGCATCGCACGATT,0,2812781
ompRp1,0.25,3,3,CTAGGACCGATAGGAATCTT,0,2803949
ompRp1,0.25,3,3,CTAGCGCGGGGGATTGTCTA,0,2814311
ompRp1,0.25,3,3,CTAGCCCGAGTCGTCGTAGT,0,2788199
ompRp1,0.25,3,3,CTAGCATTTAGAACTACAAG,0,2807022
ompRp1,0.25,3,3,CTAGACCTCACATCAGTCTG,0,2814853
ompRp1,0.25,3,3,CTAGAATCGGTTTAATACAA,0,2793845
ompRp1,0.25,3,3,CTACTTTCATCAAGCGTTCA,0,2775518
ompRp1,0.25,3,3,CTACTTGCTTCGGGACTGGC,0,2766552
ompRp1,0.25,3,3,CTACTCCCCAGCATATCTGT,0,2810347
ompRp1,0.25,3,3,CTACGGGCTACATTTCGTGC,0,2790222
ompRp1,0.25,3,3,CTACGAAGGTCATGATATGA,0,2785566
ompRp1,0.25,3,3,CTACCGGGGTAATTAATCGG,0,2808231
ompRp1,0.25,3,3,CTACAGTTTAATCCCGAAGT,0,2807320
ompRp1,0.25,3,3,CTACAGACCGGTAACCACTG,0,2821495
ompRp1,0.25,3,3,CTACACCCTTTTTCGGACAG,0,2767836
ompRp1,0.25,3,3,CTAATGGAAGCGTTAGCCTT,0,2808050
ompRp1,0.25,3,3,CTAAGGGGATACCCGCGAGA,0,2781620
ompRp1,0.25,3,3,CTAAGGGAGGCATCCATCCT,0,2799804
ompRp1,0.25,3,3,CTAAGAGACACAGGGAATAG,0,2773291
ompRp1,0.25,3,3,CTAACAGGATGTAGGCAAGT,0,2806769
ompRp1,0.25,3,3,CGTTTTATCCCCGGAACGCC,0,2822916
ompRp1,0.25,3,3,CGTTTTAATACTGTTAACGG,0,2770716
ompRp1,0.25,3,3,CGTTTGTCAGACCGCGCTTA,0,2817103
ompRp1,0.25,3,3,CGTTTGCACCAATTCGTGGA,0,2799597
ompRp1,0.25,3,3,CGTTGGTACTTAATTGCACT,0,2805531
ompRp1,0.25,3,3,CGTTGCTCGTGACTTATTTG,0,2785242
ompRp1,0.25,3,3,CGTTGATGTATAGAAATAGA,0,2768067
ompRp1,0.25,3,3,CGTTCGGGTCATCGGCCCGA,0,2770688
ompRp1,0.25,3,3,CGTTCGAGGCAACCTTTTCA,0,2816445
ompRp1,0.25,3,3,CGTTCCCGCGCCTTACGTGG,0,2765903
ompRp1,0.25,3,3,CGTTAAAAATACCGCAAACT,0,2792120
ompRp1,0.25,3,3,CGTGTGAAGTGTGGGGAAGT,0,2788983
ompRp1,0.25,3,3,CGTGGGCTTCGTTGCCCGTA,0,2806305
ompRp1,0.25,3,3,CGTGGAAATTGTTTTGAGAC,0,2806164
ompRp1,0.25,3,3,CGTGCCTACGAGAACACGGA,0,2788628
ompRp1,0.25,3,3,CGTGATGCCAGGAACAAAGC,0,2768304
ompRp1,0.25,3,3,CGTGAGTTATGACGATGTTG,0,2801719
ompRp1,0.25,3,3,CGTGACTAATCTTATCACGG,0,2799791
ompRp1,0.25,3,3,CGTCTGATCCATGGGGCTTG,0,2774972
ompRp1,0.25,3,3,CGTCTCACAATGTGCCCCGG,0,2801104
ompRp1,0.25,3,3,CGTCGTAACCTTAGACACAA,0,2786093
ompRp1,0.25,3,3,CGTCGATATCTGTCTTTGGT,0,2772153
ompRp1,0.25,3,3,CGTCCTGGTGACATTCGCTA,0,2816868
ompRp1,0.25,3,3,CGTCCTCCTACCCAGCGGGG,0,2801537
ompRp1,0.25,3,3,CGTCCTCACAGGGACAAATC,0,2814363
ompRp1,0.25,3,3,CGTCCGAAGAAGCAAGATAC,0,2820914
ompRp1,0.25,3,3,CGTCCAGCTAGCTGCATCTG,0,2815686
ompRp1,0.25,3,3,CGTCATCTTTCTAAGAAGGG,0,2791999
ompRp1,0.25,3,3,CGTCAGTTGAGAGCCTTCCG,0,2788109
ompRp1,0.25,3,3,CGTCACAAGCAATTGGATAC,0,2819224
ompRp1,0.25,3,3,CGTATATATTGTTTCAAGCA,0,2807853
ompRp1,0.25,3,3,CGTAGTATGCCTTGTAATCG,0,2793577
ompRp1,0.25,3,3,CGTAGGGGCAATTTACGCTT,0,2778896
ompRp1,0.25,3,3,CGTACTATTCTTAGTAATCG,0,2798066
ompRp1,0.25,3,3,CGTACGCGTTCTGAAGATAC,0,2807729
ompRp1,0.25,3,3,CGTACATACTTGTGCCGTGG,0,2805735
ompRp1,0.25,3,3,CGTAAGTATTATATTCGCCG,0,2789922
ompRp1,0.25,3,3,CGTAAAACTTTACCAATGAG,0,2800555
ompRp1,0.25,3,3,CGGTTGTGTATGAGTTGCCA,0,2806921
ompRp1,0.25,3,3,CGGTTCTCCCTGTAGAACTA,0,2785948
ompRp1,0.25,3,3,CGGTTCGAGGACCTGCCTTT,0,2795761
ompRp1,0.25,3,3,CGGTGGGTCGCCACGCCGGC,0,2820308
ompRp1,0.25,3,3,CGGTGGGGGGTCAACCTGCC,0,2796169
ompRp1,0.25,3,3,CGGTGCTACGGTGTCCACTA,0,2795897
ompRp1,0.25,3,3,CGGTGAGATTGAAAGGCTCT,0,2812147
ompRp1,0.25,3,3,CGGTCGTGGCTGTAAGTATC,0,2789997
ompRp1,0.25,3,3,CGGTCCAGAGAATCCGTGTC,0,2817005
ompRp1,0.25,3,3,CGGTCAGAAGCACATCTGCG,0,2789012
ompRp1,0.25,3,3,CGGTATCGGATAAGTGCACA,0,2777747
ompRp1,0.25,3,3,CGGTACTCGTGTTGCGAAAC,0,2785989
ompRp1,0.25,3,3,CGGGTTCATAGGAGGCACAG,0,2791377
ompRp1,0.25,3,3,CGGGTAACATCCCAACTGGA,0,2789000
ompRp1,0.25,3,3,CGGGGTAAAGATACTGGGTT,0,2793696
ompRp1,0.25,3,3,CGGGCGATCTCATCTTCATT,0,2776911
ompRp1,0.25,3,3,CGGGAGGACGTCGGCCAAGT,0,2798484
ompRp1,0.25,3,3,CGGGACCAGCGGATCCTACC,0,2786873
ompRp1,0.25,3,3,CGGCTGGTCAACCGCCACAG,0,2781104
ompRp1,0.25,3,3,CGGCTATGAATTGCGTAATG,0,2791657
ompRp1,0.25,3,3,CGGCGTCTAGTTGAATGGTT,0,2777124
ompRp1,0.25,3,3,CGGCGTCCGGTCTATCGCGA,0,2807207
ompRp1,0.25,3,3,CGGCGTCCCGCGTTAAATAT,0,2813795
ompRp1,0.25,3,3,CGGCGCATTGGATCGCCATG,0,2784050
ompRp1,0.25,3,3,CGGCCTTCCGTTTTCAGTGT,0,2779622
ompRp1,0.25,3,3,CGGCAGTCGGGCAAGTTGGA,0,2802481
ompRp1,0.25,3,3,CGGCAAAGATCTAGGGTATG,0,2797340
ompRp1,0.25,3,3,CGGATATTGTACATTCGTCA,0,2781553
ompRp1,0.25,3,3,CGGAGTGTCGCGGGCAATAC,0,2807601
ompRp1,0.25,3,3,CGGAGAATAAACTACGTTTA,0,2794746
ompRp1,0.25,3,3,CGGACGGACCACCACCGACC,0,2774464
ompRp1,0.25,3,3,CGGACAATATTGCGACACGC,0,2810019
ompRp1,0.25,3,3,CGCTTTATACTTATTCTTAC,0,2775816
ompRp1,0.25,3,3,CGCTTCTATCGCTATGTGAA,0,2794820
ompRp1,0.25,3,3,CGCTGCGGCACCGAACTTCA,0,2780609
ompRp1,0.25,3,3,CGCTCTATTATTGCCGGCTC,0,2782426
ompRp1,0.25,3,3,CGCTCGTCGGCCCGGTCTGT,0,2792585
ompRp1,0.25,3,3,CGCTATGAGCACATGCTATA,0,2793633
ompRp1,0.25,3,3,CGCGGATTCCAACCGTGGGG,0,2809509
ompRp1,0.25,3,3,CGCGCAACAGTATATAGTGC,0,2791065
ompRp1,0.25,3,3,CGCGACTAAATTGTCCAGAA,0,2801046
ompRp1,0.25,3,3,CGCCTGAGTTACTCGATAAA,0,2809923
ompRp1,0.25,3,3,CGCCTATTTCATGCACAACG,0,2794101
ompRp1,0.25,3,3,CGCCTATTAGGTAGCTAGAG,0,2799649
ompRp1,0.25,3,3,CGCCGACCTTTACTAATATA,0,2767697
ompRp1,0.25,3,3,CGCCATGGTTGTACGAGTAC,0,2778070
ompRp1,0.25,3,3,CGCCAGGCCATCAGAGCATC,0,2818612
ompRp1,0.25,3,3,CGCATTTCTCAGTGTACATA,0,2766283
ompRp1,0.25,3,3,CGCATGAGGATACAAGTTAG,0,2776960
ompRp1,0.25,3,3,CGCAGGAGAGGCTCCCAATG,0,2769792
ompRp1,0.25,3,3,CGCAATTCTCTCATGTGGAC,0,2772999
ompRp1,0.25,3,3,CGCAACACAGCGGCGCGGAA,0,2803503
ompRp1,0.25,3,3,CGATTTCACCACGGCCTCCA,0,2801640
ompRp1,0.25,3,3,CGATGGTGTTTGGCACAACT,0,2818465
ompRp1,0.25,3,3,CGATACCGCGCGCATCTTAT,0,2816325
ompRp1,0.25,3,3,CGAGTTTTGCAGATCTAGCT,0,2790898
ompRp1,0.25,3,3,CGAGTTGGTCCGGCTCATGC,0,2814621
ompRp1,0.25,3,3,CGAGTGAACGGGCTGGTAGA,0,2806450
ompRp1,0.25,3,3,CGAGCGTCTGGGGCGCAAAA,0,2815994
ompRp1,0.25,3,3,CGACTGATGTAGTGAAATGT,0,2779528
ompRp1,0.25,3,3,CGACTCCAAGACCCAAGCAT,0,2774839
ompRp1,0.25,3,3,CGACTCACCGCGACCGTTTA,0,2807761
ompRp1,0.25,3,3,CGACGGTCCAGAGCCGTCAA,0,2802887
ompRp1,0.25,3,3,CGACGCATCTTGCAGACTTG,0,2800503
ompRp1,0.25,3,3,CGACCGGTCCTGGTACAGGT,0,2769501
ompRp1,0.25,3,3,CGACCCACACCTAGACCGGC,0,2812272
ompRp1,0.25,3,3,CGACAGGTAAGATTTTCATG,0,2781496
ompRp1,0.25,3,3,CGAATTTTAACGACAAAAGG,0,2798336
ompRp1,0.25,3,3,CGAACTTCGTAGGTACCCAG,0,2822224
ompRp1,0.25,3,3,CGAACGTGAGAATTAATTTC,0,2782451
ompRp1,0.25,3,3,CGAACAGAGTTCTTGGCTGA,0,2786594
ompRp1,0.25,3,3,CGAAATTGAGGGACGCACAT,0,2792217
ompRp1,0.25,3,3,CGAAAGTCCTCAGATCCGAC,0,2787787
ompRp1,0.25,3,3,CGAAACGTCAGTCTCATCAA,0,2806355
ompRp1,0.25,3,3,CGAAAAGATTTCGCTGAAAG,0,2818776
ompRp1,0.25,3,3,CCTTTGGTTGCAACTTAGAG,0,2787687
ompRp1,0.25,3,3,CCTTTCCACCCCCGATTCGA,0,2787071
ompRp1,0.25,3,3,CCTTTAGTCGATTTTGAGTA,0,2790791
ompRp1,0.25,3,3,CCTTCACACGCCCTAAGCTC,0,2813810
ompRp1,0.25,3,3,CCTTACCCCATAGGTAAGGA,0,2802399
ompRp1,0.25,3,3,CCTGTACTTTAGCATCAATG,0,2790831
ompRp1,0.25,3,3,CCTGTAATTCAGTCGTTAAA,0,2788638
ompRp1,0.25,3,3,CCTGGAGGGAAGAGAGCTTC,0,2817278
ompRp1,0.25,3,3,CCTGCGTAGAACTGCGGTAA,0,2788903
ompRp1,0.25,3,3,CCTCTTACTCGTTACCGATC,0,2783082
ompRp1,0.25,3,3,CCTCTCCCGGTCCTGTGGCG,0,2803513
ompRp1,0.25,3,3,CCTCGATCGGGTGCTGCCTA,0,2790608
ompRp1,0.25,3,3,CCTCCTGCCACGCAGAATAT,0,2783596
ompRp1,0.25,3,3,CCTCCCGGTACTGTCTGAGC,0,2782648
ompRp1,0.25,3,3,CCTCAAACGGATGTTACATG,0,2799478
ompRp1,0.25,3,3,CCTATTGTCAAAAGTCTATG,0,2766796
ompRp1,0.25,3,3,CCTATTCCGGGCGCCACACA,0,2779575
ompRp1,0.25,3,3,CCTATGTTTCCTAGCTGGAC,0,2802105
ompRp1,0.25,3,3,CCTAGGACTGGCGCTACTTG,0,2767837
ompRp1,0.25,3,3,CCTACCTCATGAGATAGCTT,0,2819850
ompRp1,0.25,3,3,CCTACAATTCAGTTTCATAT,0,2807929
ompRp1,0.25,3,3,CCTAATTTCACGTTGAGCTG,0,2795365
ompRp1,0.25,3,3,CCTAATGCGGACAACCGTAA,0,2798165
ompRp1,0.25,3,3,CCTAAACTGACCTACTCTCA,0,2823752
ompRp1,0.25,3,3,CCGTTGGACTTGTACCGAAG,0,2774741
ompRp1,0.25,3,3,CCGTTGCAGAACGGGTTAAT,0,2824410
ompRp1,0.25,3,3,CCGTGCGTGTTTATGGTTCC,0,2772015
ompRp1,0.25,3,3,CCGTCGGCACCGCAGACACA,0,2773510
ompRp1,0.25,3,3,CCGTACGGGCACGGTAGGAA,0,2777070
ompRp1,0.25,3,3,CCGGTTCGGACTACCGCATC,0,2774745
ompRp1,0.25,3,3,CCGGTTCCACCGCACAGTTC,0,2766148
ompRp1,0.25,3,3,CCGGTCTGCTACCGACCTCT,0,2816389
ompRp1,0.25,3,3,CCGGTAGCATCCAAGATCTC,0,2795008
ompRp1,0.25,3,3,CCGGAATGTTTACGCTTGCT,0,2775422
ompRp1,0.25,3,3,CCGCGTAACCAGTTAACCCC,0,2772440
ompRp1,0.25,3,3,CCGCCAGGCGCACTATTGGC,0,2771671
ompRp1,0.25,3,3,CCGCAGTGTAGTCTAAGCCA,0,2793697
ompRp1,0.25,3,3,CCGCAGTGTAACCGTACTTG,0,2770003
ompRp1,0.25,3,3,CCGATACTCTCTCTAACGCG,0,2820344
ompRp1,0.25,3,3,CCGAGGCGTACTGTAAAAGT,0,2787905
ompRp1,0.25,3,3,CCGAAGCGTGTGGCCTTCAC,0,2787901
ompRp1,0.25,3,3,CCGAAATTGGTCTGCAACGG,0,2775705
ompRp1,0.25,3,3,CCCTTGCATCACCCCAGATA,0,2790880
ompRp1,0.25,3,3,CCCTTCATAAGCTCCCTCTT,0,2766950
ompRp1,0.25,3,3,CCCTGTAGGCCCTGGCATGC,0,2770871
ompRp1,0.25,3,3,CCCTGGCTGTGAGCCCCCTG,0,2802622
ompRp1,0.25,3,3,CCCTGATGCCTCTTACGGTA,0,2789383
ompRp1,0.25,3,3,CCCTGATCAAGTGTTTGACT,0,2818298
ompRp1,0.25,3,3,CCCTCGCGTCACCCGAGAAT,0,2792677
ompRp1,0.25,3,3,CCCTCCGACCATAGACTCAG,0,2798988
ompRp1,0.25,3,3,CCCTCACTCCTAGAGAGTGC,0,2803826
ompRp1,0.25,3,3,CCCTCACTATGGCTTCACAC,0,2816519
ompRp1,0.25,3,3,CCCTAGCGGCAAATGAACGC,0,2773401
ompRp1,0.25,3,3,CCCTACAACGTTTAAATCAA,0,2822407
ompRp1,0.25,3,3,CCCGTTTGTAACAGTTGCAA,0,2803672
ompRp1,0.25,3,3,CCCGTTACCAGGCCGTCATG,0,2776259
ompRp1,0.25,3,3,CCCGTCACCGAGTGTGATGT,0,2782507
ompRp1,0.25,3,3,CCCGGTTACGTTAGTCAACA,0,2783902
ompRp1,0.25,3,3,CCCGGTGTGCTTGTCGGGCT,0,2813543
ompRp1,0.25,3,3,CCCGGTGCCCACGGTTTTTC,0,2819613
ompRp1,0.25,3,3,CCCGCTGCAGCTCCTTTAAT,0,2791375
ompRp1,0.25,3,3,CCCGCTGAATGGCCACACGT,0,2823975
ompRp1,0.25,3,3,CCCGCAGCAGCACTATTGGA,0,2781822
ompRp1,0.25,3,3,CCCGCACACGTTACCGAACG,0,2795757
ompRp1,0.25,3,3,CCCGAGCTTGAGGTTCTTGA,0,2799115
ompRp1,0.25,3,3,CCCGACGCGCAACGGCGCCA,0,2820926
ompRp1,0.25,3,3,CCCCTGTCAGCTTAGGTTCT,0,2773967
ompRp1,0.25,3,3,CCCCTGGGCATTCCGAAGGA,0,2776409
ompRp1,0.25,3,3,CCCCGGGTGCAGACGGACCT,0,2796231
ompRp1,0.25,3,3,CCCCGGCACGCTAACCCGTC,0,2820483
ompRp1,0.25,3,3,CCCCGCGGGTAGTAAGCAGG,0,2786974
ompRp1,0.25,3,3,CCCCATCACATCGTCAGGAT,0,2791678
ompRp1,0.25,3,3,CCCCACTTATCGTTAGCGGA,0,2820662
ompRp1,0.25,3,3,CCCCACAGAATCCCTCGAAT,0,2822458
ompRp1,0.25,3,3,CCCATTGTCGGGGAAGGTGG,0,2765922
ompRp1,0.25,3,3,CCCATTGCATAGAAATGCCA,0,2786945
ompRp1,0.25,3,3,CCCATTACATTATTCAATAG,0,2823264
ompRp1,0.25,3,3,CCCATGAAGCGCTCATACTT,0,2770012
ompRp1,0.25,3,3,CCCAGTTGACGGCCCGGGAG,0,2773882
ompRp1,0.25,3,3,CCCACAAGCAGTCTCGCATA,0,2781800
ompRp1,0.25,3,3,CCCAAGCATCACCTAAAACG,0,2772404
ompRp1,0.25,3,3,CCCAACAGCTGGAAATAGTG,0,2774197
ompRp1,0.25,3,3,CCATTCTTCGTGTGATGCAT,0,2800516
ompRp1,0.25,3,3,CCATTAGCATGCCCTAAAAG,0,2806234
ompRp1,0.25,3,3,CCATGAGTATGTTTGTGTGA,0,2789795
ompRp1,0.25,3,3,CCATCGTCCGATCTGCGCTT,0,2786092
ompRp1,0.25,3,3,CCATATGCTTCCTGAGAGAG,0,2786428
ompRp1,0.25,3,3,CCAGTGAGTGTGGATTGTCT,0,2768221
ompRp1,0.25,3,3,CCAGTCGAGACATCAAACGC,0,2803886
ompRp1,0.25,3,3,CCAGGTAGATTGATCGCTGA,0,2784013
ompRp1,0.25,3,3,CCAGGCCCTTACGTTCGTAG,0,2821529
ompRp1,0.25,3,3,CCAGCTCAGAACCATAAAGT,0,2788692
ompRp1,0.25,3,3,CCAGCGTAGGCGGAGAGCTG,0,2786857
ompRp1,0.25,3,3,CCAGATGCTTTGGGGAGCGC,0,2790391
ompRp1,0.25,3,3,CCAGATCCCTTAAGAGCTAG,0,2809095
ompRp1,0.25,3,3,CCAGAGGGGTACGTAACTAG,0,2806809
ompRp1,0.25,3,3,CCAGACGTACAAGCATAATC,0,2815111
ompRp1,0.25,3,3,CCAGAAGCCCGGCGGGAGAC,0,2775775
ompRp1,0.25,3,3,CCACTAGAAACGGATGTGAG,0,2771583
ompRp1,0.25,3,3,CCACGAGGCATTTCGCAATA,0,2794068
ompRp1,0.25,3,3,CCACGAATCTTCGTTCTCAC,0,2794774
ompRp1,0.25,3,3,CCACCCTAGGTCAGAGTTAA,0,2817890
ompRp1,0.25,3,3,CCACAGTTTTACGCGAGAGG,0,2775942
ompRp1,0.25,3,3,CCACACTCATGCTTAAGCCA,0,2818189
ompRp1,0.25,3,3,CCAATGACTCCCGGATCAAT,0,2801212
ompRp1,0.25,3,3,CCAATAACGCGGCGCATGTG,0,2768217
ompRp1,0.25,3,3,CCAAGAGCGGACTTTGGACT,0,2797876
ompRp1,0.25,3,3,CATTTCACCCTGGAACCGCA,0,2803580
ompRp1,0.25,3,3,CATTGTTTCTAGGGTCGCTG,0,2787314
ompRp1,0.25,3,3,CATTGTTAGAGGAACGACTG,0,2785580
ompRp1,0.25,3,3,CATTCGTCCAACACGAGTTA,0,2767505
ompRp1,0.25,3,3,CATTATTCGGACGCGGCAAC,0,2810093
ompRp1,0.25,3,3,CATTATATAGAAGGTCTATT,0,2775246
ompRp1,0.25,3,3,CATTAGTCCGGGCTAGTTGT,0,2819914
ompRp1,0.25,3,3,CATTAGCGAACCATACGCAA,0,2785620
ompRp1,0.25,3,3,CATTAAACACCCCTTAGACA,0,2780583
ompRp1,0.25,3,3,CATGTGGTCTGAAGTGCGTC,0,2777163
ompRp1,0.25,3,3,CATGGTCCTACGATGACCAT,0,2797782
ompRp1,0.25,3,3,CATGGATCCTGCATACACTG,0,2773771
ompRp1,0.25,3,3,CATGCCTGACCTAGGAACAA,0,2774722
ompRp1,0.25,3,3,CATGCATGGCTTCGCTGCGA,0,2823542
ompRp1,0.25,3,3,CATGACCTCGAATAGGGTCT,0,2814012
ompRp1,0.25,3,3,CATGAATACGGCCCAATTGC,0,2771852
ompRp1,0.25,3,3,CATCTGTCCCGGTGCCCCGG,0,2816037
ompRp1,0.25,3,3,CATCGGCTCGCGTGAGAGGT,0,2792818
ompRp1,0.25,3,3,CATCGCTTGTAAGGGGTTGC,0,2802532
ompRp1,0.25,3,3,CATATTACAGCACCAATGAT,0,2787966
ompRp1,0.25,3,3,CATATGTAAGGTGCGTATAG,0,2799864
ompRp1,0.25,3,3,CATATCCCGGTAAGCCGTCG,0,2793472
ompRp1,0.25,3,3,CATAGTAAGACACCTAATCC,0,2820605
ompRp1,0.25,3,3,CATAGAGTATGGGCACTGGG,0,2791402
ompRp1,0.25,3,3,CATACACGGTTGGCATAATG,0,2818241
ompRp1,0.25,3,3,CATAACATGTGATCACAGTA,0,2800845
ompRp1,0.25,3,3,CAGTTTTGAGCCATACCTTA,0,2818242
ompRp1,0.25,3,3,CAGTTGAACTAACGTGCTGT,0,2798100
ompRp1,0.25,3,3,CAGTTCTTGCTACGTCGGCA,0,2802074
ompRp1,0.25,3,3,CAGTTCCTTGGTCCACAAAG,0,2776850
ompRp1,0.25,3,3,CAGTGTCCACTCGACGTCTT,0,2791693
ompRp1,0.25,3,3,CAGTGCTCTTCATCCTGTTA,0,2815940
ompRp1,0.25,3,3,CAGTGAGCGAGTTCGAATAC,0,2792977
ompRp1,0.25,3,3,CAGTCCACATATTAGATCCA,0,2765553
ompRp1,0.25,3,3,CAGTAGCTCCCAGCGTGCTG,0,2789224
ompRp1,0.25,3,3,CAGTACGTGGGCCTTGTGAA,0,2800697
ompRp1,0.25,3,3,CAGGTAGATATGAGTTTCAC,0,2786587
ompRp1,0.25,3,3,CAGGTACCGACGAGCGCGAA,0,2811009
ompRp1,0.25,3,3,CAGGGTGAGAGTTCTCTGAA,0,2811621
ompRp1,0.25,3,3,CAGGGTCTGTGGTGCCGCAA,0,2790417
ompRp1,0.25,3,3,CAGGGTAGGAACTGGTAAGC,0,2805810
ompRp1,0.25,3,3,CAGGCCTTTCCCGATAGCCG,0,2816518
ompRp1,0.25,3,3,CAGGAGGGCCTACCCTGTGA,0,2779002
ompRp1,0.25,3,3,CAGCTCCACCTAGCTAGAGC,0,2799813
ompRp1,0.25,3,3,CAGCGGCTTATACAAAAGCC,0,2812347
ompRp1,0.25,3,3,CAGCGGCTAAGATCTTAACC,0,2816715
ompRp1,0.25,3,3,CAGCGGCGGGCTTCAGTAAG,0,2800071
ompRp1,0.25,3,3,CAGCCTTTTCTACCCTAAAT,0,2806754
ompRp1,0.25,3,3,CAGCCAATTCCTGATTATCC,0,2779149
ompRp1,0.25,3,3,CAGCATTTATCACTGCAGGA,0,2775767
ompRp1,0.25,3,3,CAGCATGGATCTTCGTACTT,0,2820172
ompRp1,0.25,3,3,CAGATCGTAGAGGCCATTTA,0,2821176
ompRp1,0.25,3,3,CAGACAACTACCACCGATAC,0,2768561
ompRp1,0.25,3,3,CAGAATACAGGTGGTCATAA,0,2792337
ompRp1,0.25,3,3,CAGAATAACCGTGGGTGATA,0,2768056
ompRp1,0.25,3,3,CAGAAGCTTTAAGTATCTGA,0,2779683
ompRp1,0.25,3,3,CAGAAAGAACCAGTACCACG,0,2766290
ompRp1,0.25,3,3,CACTTTCACCCTTCTGCAAA,0,2775257
ompRp1,0.25,3,3,CACTTTACGTTAGAGGGGAT,0,2800917
ompRp1,0.25,3,3,CACTGATCGCCTCGAATACG,0,2809352
ompRp1,0.25,3,3,CACTCAATCTTAAAACTGTA,0,2808053
ompRp1,0.25,3,3,CACTACTGTTAGCCATCGAA,0,2774846
ompRp1,0.25,3,3,CACGTTTCGCGTGTTATCGT,0,2798565
ompRp1,0.25,3,3,CACGTATGGGAAAGTGATAA,0,2791663
ompRp1,0.25,3,3,CACGGTCTCCTATCGCGTTG,0,2790666
ompRp1,0.25,3,3,CACGGCTAGTAGACCAGTTT,0,2795832
ompRp1,0.25,3,3,CACGCTGAGTGTATTAGTTA,0,2804367
ompRp1,0.25,3,3,CACGCGCGCACCACCGATGC,0,2781879
ompRp1,0.25,3,3,CACGACGTATTTTTTATTTG,0,2785465
ompRp1,0.25,3,3,CACCTACCCGGTGTATTTTA,0,2816012
ompRp1,0.25,3,3,CACCGGTTATAATGACAAGC,0,2798497
ompRp1,0.25,3,3,CACCCAGGTGGGCGGGGAGT,0,2776867
ompRp1,0.25,3,3,CACCCAGGGACGTATGAAGA,0,2813672
ompRp1,0.25,3,3,CACCAAGGGGGTCTTTCGCA,0,2819454
ompRp1,0.25,3,3,CACATGTGCCGCCAGCGCTT,0,2765465
ompRp1,0.25,3,3,CACATCAAACATTAAAGATG,0,2806223
ompRp1,0.25,3,3,CACATATAGCCTGCCTCCCT,0,2770273
ompRp1,0.25,3,3,CACAGACTCAACGCTCGTTC,0,2778112
ompRp1,0.25,3,3,CACACGACCTCCCATAGACA,0,2798900
ompRp1,0.25,3,3,CACAAAATAAGGACGCGCCC,0,2817547
ompRp1,0.25,3,3,CAATGGGGGCGCATGCGACT,0,2782931
ompRp1,0.25,3,3,CAATCGTGTATCGCTCCATG,0,2777199
ompRp1,0.25,3,3,CAATATTTTCCACAAGGGAT,0,2807771
ompRp1,0.25,3,3,CAATAGACCAGCTCCCGATG,0,2788914
ompRp1,0.25,3,3,CAAGTGTTGTAGTTGTCAGC,0,2783387
ompRp1,0.25,3,3,CAAGTCTCCGTCCCCGGATT,0,2821902
ompRp1,0.25,3,3,CAAGCGTACCGTCTGTACAC,0,2815233
ompRp1,0.25,3,3,CAAGCGTAATTCACAAAACT,0,2771697
ompRp1,0.25,3,3,CAAGCGGCTGCCCGCACTCC,0,2814218
ompRp1,0.25,3,3,CAAGCAGGACCATCATCCGG,0,2769468
ompRp1,0.25,3,3,CAAGAAGTAAGGGCGGCAAT,0,2806485
ompRp1,0.25,3,3,CAACTTCAAGAGGAGTCTAA,0,2813011
ompRp1,0.25,3,3,CAACTGGGTAAGAGCGAATG,0,2789574
ompRp1,0.25,3,3,CAACTAGACGACTTCATATG,0,2804745
ompRp1,0.25,3,3,CAACGGTCAGATTTGGGTAT,0,2823253
ompRp1,0.25,3,3,CAACGCGGTAGTTCACAGGA,0,2785650
ompRp1,0.25,3,3,CAACATGCTTTTACAAAAAA,0,2822149
ompRp1,0.25,3,3,CAAATCTAGACGTAAGCACA,0,2814960
ompRp1,0.25,3,3,CAAAGTTTCTTTTTGGTTGC,0,2818724
ompRp1,0.25,3,3,CAAAATAATACGCCCTGAGG,0,2808957
ompRp1,0.25,3,3,ATTTTCAACCAATAAATCAC,0,2768753
ompRp1,0.25,3,3,ATTTGGTTCCTTGGCTGGGG,0,2816720
ompRp1,0.25,3,3,ATTTGAATACGAACTACAGT,0,2767517
ompRp1,0.25,3,3,ATTTCTAAGCGCAATGGTAT,0,2768030
ompRp1,0.25,3,3,ATTTCCTTGAACGGTGACAG,0,2780905
ompRp1,0.25,3,3,ATTTCAGCAGATCAAATCCA,0,2777274
ompRp1,0.25,3,3,ATTTAGCAGATAGATGGATC,0,2786090
ompRp1,0.25,3,3,ATTTAATATTAGGGTTATGC,0,2795412
ompRp1,0.25,3,3,ATTGTTTTCTTCATAATAGT,0,2765477
ompRp1,0.25,3,3,ATTGTGGAGAGAAACGACGG,0,2781554
ompRp1,0.25,3,3,ATTGTCATATTGGTATCCCC,0,2811303
ompRp1,0.25,3,3,ATTGGTGTGAACTATGCAGG,0,2773562
ompRp1,0.25,3,3,ATTGGTCACCGGAGTTTCCC,0,2819750
ompRp1,0.25,3,3,ATTGGGTCCGTCGCGGACGT,0,2815447
ompRp1,0.25,3,3,ATTGGGCACCCGGGAATATA,0,2783052
ompRp1,0.25,3,3,ATTGGATTAGTGATCAACGT,0,2790433
ompRp1,0.25,3,3,ATTGCGTGTAAAACCGCGGT,0,2778899
ompRp1,0.25,3,3,ATTGCCTGTGACGCCGTAGC,0,2807952
ompRp1,0.25,3,3,ATTGCATTTTACGAGTCTTG,0,2818044
ompRp1,0.25,3,3,ATTGATCTAATTAGGCTAGC,0,2802802
ompRp1,0.25,3,3,ATTGAGGATTCCGGTGTAGG,0,2805173
ompRp1,0.25,3,3,ATTCTTACGTGCTGGCAGCA,0,2776218
ompRp1,0.25,3,3,ATTCTGAGAAGTCCGTAAAC,0,2783854
ompRp1,0.25,3,3,ATTCTCCTTACGACGACCAG,0,2787342
ompRp1,0.25,3,3,ATTCTAATCGGAGCGTGCAA,0,2803924
ompRp1,0.25,3,3,ATTCTAAGAAGTACCCCATG,0,2784332
ompRp1,0.25,3,3,ATTCGTGCTAAATGTCCGTG,0,2823713
ompRp1,0.25,3,3,ATTCGTACTTTAAACCCAGC,0,2767646
ompRp1,0.25,3,3,ATTCCGGTGTTTGACAGAAT,0,2792734
ompRp1,0.25,3,3,ATTCACCCGGCGGTCGCGGT,0,2824517
ompRp1,0.25,3,3,ATTATTTTGAGCCATGGTAA,0,2773297
ompRp1,0.25,3,3,ATTATGATATCGTGTCGGGA,0,2773594
ompRp1,0.25,3,3,ATTATCGGTATTAATCTATT,0,2781993
ompRp1,0.25,3,3,ATTAGCTGGGGGTGTGGGAC,0,2777111
ompRp1,0.25,3,3,ATTAGCGGCACATACGTGAA,0,2782085
ompRp1,0.25,3,3,ATTAGAATGTTCTCCCGCAA,0,2790138
ompRp1,0.25,3,3,ATTACCCGCGCTACTGAGGT,0,2777439
ompRp1,0.25,3,3,ATTAATAAATTACCGGTTGG,0,2799983
ompRp1,0.25,3,3,ATTAAGTAGTGGGTTGACTG,0,2802562
ompRp1,0.25,3,3,ATTAAGAGTCGTAGGTTCAC,0,2777622
ompRp1,0.25,3,3,ATTAACCGCGCGAGCTGTAT,0,2769012
ompRp1,0.25,3,3,ATGTGTGAGCTCCACCCATC,0,2766209
ompRp1,0.25,3,3,ATGTCTAAAGAGACGCTCAC,0,2779434
ompRp1,0.25,3,3,ATGTAAAACTCGGGTATCGC,0,2790794
ompRp1,0.25,3,3,ATGGTTTGATTCCGGTTGGC,0,2774016
ompRp1,0.25,3,3,ATGGTCTCCGTGATTCCAGG,0,2792113
ompRp1,0.25,3,3,ATGGTATGCGTCACTAACCT,0,2792784
ompRp1,0.25,3,3,ATGGGTTAGTGACTTTGCTT,0,2799327
ompRp1,0.25,3,3,ATGGGGTACATATCTACCCA,0,2770448
ompRp1,0.25,3,3,ATGGGGATAAACGTCGACGG,0,2797743
ompRp1,0.25,3,3,ATGGGGAGAACGTCACGCAA,0,2807988
ompRp1,0.25,3,3,ATGGGCTCCGATGTTCATAT,0,2821148
ompRp1,0.25,3,3,ATGGGCGGGTTGAGGAGAGT,0,2772842
ompRp1,0.25,3,3,ATGGGCAGGTGGTCCTAGGA,0,2796227
ompRp1,0.25,3,3,ATGGGATTAGTCACTCCATG,0,2823427
ompRp1,0.25,3,3,ATGGGATAAGCCCAGTAGTA,0,2796986
ompRp1,0.25,3,3,ATGGGAATAATTTGTCGTGG,0,2812530
ompRp1,0.25,3,3,ATGGCTGCCCTAAGATAGCA,0,2797039
ompRp1,0.25,3,3,ATGGCCCATTAAGGAACTTC,0,2772656
ompRp1,0.25,3,3,ATGCTATCACTTCTCGGTTA,0,2799065
ompRp1,0.25,3,3,ATGCGTCGTTCGGAAACTAT,0,2801004
ompRp1,0.25,3,3,ATGCGTATCTTCCTTCCGAT,0,2814105
ompRp1,0.25,3,3,ATGATGGTAGCGTTGCTTTG,0,2791243
ompRp1,0.25,3,3,ATGATATTTGTCAAATTTCC,0,2803211
ompRp1,0.25,3,3,ATCTTGGCCTCCCGCACAAA,0,2811605
ompRp1,0.25,3,3,ATCTTGACGCAACACAGCTT,0,2811835
ompRp1,0.25,3,3,ATCTTCAGGGGTGTTCGTTG,0,2799135
ompRp1,0.25,3,3,ATCTGCGCCAACCGGTCTCC,0,2794932
ompRp1,0.25,3,3,ATCTCCAAGATAGGCCGGAC,0,2823605
ompRp1,0.25,3,3,ATCGTGCTAGAGTGCGATGA,0,2806748
ompRp1,0.25,3,3,ATCGTGAACTTGCGGGTAGT,0,2780572
ompRp1,0.25,3,3,ATCGGGTTATAGCAAGTGTT,0,2770440
ompRp1,0.25,3,3,ATCGGGGACGTGTATACTAT,0,2771677
ompRp1,0.25,3,3,ATCGGATATCATTTCAGTAT,0,2765748
ompRp1,0.25,3,3,ATCGCCAATTCGCTGCCCCC,0,2808260
ompRp1,0.25,3,3,ATCGAATGACCTTTACGGAA,0,2786677
ompRp1,0.25,3,3,ATCCTTTGGGTTTTGTACGG,0,2771314
ompRp1,0.25,3,3,ATCCTGGATTTGCTCGGAGA,0,2814024
ompRp1,0.25,3,3,ATCCTGCAGAACGACAGCGT,0,2779717
ompRp1,0.25,3,3,ATCCTCCTGTCACCTTTGAT,0,2780057
ompRp1,0.25,3,3,ATCCTCCATACGGTCTCTAC,0,2773603
ompRp1,0.25,3,3,ATCCGTGACTAAGTAGAGGG,0,2809708
ompRp1,0.25,3,3,ATCCGGGACTTGAGAGATGA,0,2822927
ompRp1,0.25,3,3,ATCCATGATAACCTGAATCA,0,2787913
ompRp1,0.25,3,3,ATCCAGCCCCTTCAGTGTGT,0,2766900
ompRp1,0.25,3,3,ATCATACTCGGCCCTGACGA,0,2820274
ompRp1,0.25,3,3,ATCAGAAGTTTGTCAGAACA,0,2816154
ompRp1,0.25,3,3,ATCACGAGAACCGGGTAAGG,0,2782005
ompRp1,0.25,3,3,ATCACATAGACGCTATCTTT,0,2787047
ompRp1,0.25,3,3,ATCACATAACGCGTCGTTCT,0,2811579
ompRp1,0.25,3,3,ATCACAGACCTTGGTGCTGT,0,2779492
ompRp1,0.25,3,3,ATCAACTTAGAACCTCGTCC,0,2786177
ompRp1,0.25,3,3,ATCAACCCAACTAAATTCAT,0,2793175
ompRp1,0.25,3,3,ATATTTGCGCCTACACATGG,0,2813254
ompRp1,0.25,3,3,ATATGTCGATCCTTAAGTTC,0,2824530
ompRp1,0.25,3,3,ATATGTACGATAAAGCAGAA,0,2784858
ompRp1,0.25,3,3,ATATGGGATCCAAATGGGGT,0,2814195
ompRp1,0.25,3,3,ATATATATAGAGCCCGTAAC,0,2797073
ompRp1,0.25,3,3,ATATAGGGACAATGTACAGT,0,2813421
ompRp1,0.25,3,3,ATATACTGCCTTAGCAATAG,0,2778789
ompRp1,0.25,3,3,ATAGTGCGGCCTAAAGCTGG,0,2770586
ompRp1,0.25,3,3,ATAGGCTTCAGGGGTAAACT,0,2795181
ompRp1,0.25,3,3,ATACTTTTCGCAAGGGCGGT,0,2797902
ompRp1,0.25,3,3,ATACTTTTACGTACGCAACA,0,2796824
ompRp1,0.25,3,3,ATACTGCTGCTATGTGCACC,0,2766539
ompRp1,0.25,3,3,ATACTCGTCGGCAAAGTCAA,0,2766139
ompRp1,0.25,3,3,ATACGGGTTTGACCCCCAGA,0,2803732
ompRp1,0.25,3,3,ATACGCGCTAGTCTACTCGC,0,2809326
ompRp1,0.25,3,3,ATACCCAAGATGAGGCAGGC,0,2779946
ompRp1,0.25,3,3,ATACATCCGCCATGTAACAC,0,2817212
ompRp1,0.25,3,3,ATACATAGAGCGTTGGACGG,0,2787912
ompRp1,0.25,3,3,ATACACCTCGATGGCTTCAT,0,2798026
ompRp1,0.25,3,3,ATAATATGGCAGATTCAAAA,0,2783634
ompRp1,0.25,3,3,ATAAGTATTGCTTCCGTGGC,0,2822452
ompRp1,0.25,3,3,ATAAGCCCCTAAGCTATATC,0,2821789
ompRp1,0.25,3,3,ATAACACGGCTAAATCATCA,0,2768839
ompRp1,0.25,3,3,ATAAAGTTCACGCTTGGACC,0,2797789
ompRp1,0.25,3,3,AGTTTCTTTTACTAATGAGG,0,2816090
ompRp1,0.25,3,3,AGTTGGCGTTGAGAGTGTAA,0,2823764
ompRp1,0.25,3,3,AGTTGGATCGCACTAAAATA,0,2804820
ompRp1,0.25,3,3,AGTTCTTTGCATGGTCTCCC,0,2779402
ompRp1,0.25,3,3,AGTTCTTATGACCCGTGTCA,0,2780819
ompRp1,0.25,3,3,AGTTCATATCAGCGCTGCCT,0,2823444
ompRp1,0.25,3,3,AGTTATATCATTAACCAGGC,0,2782835
ompRp1,0.25,3,3,AGTTAGAGACACTGTCGTTA,0,2814741
ompRp1,0.25,3,3,AGTTACAACTTTAGTTGAGT,0,2769457
ompRp1,0.25,3,3,AGTTAATGAACACTCAGCTG,0,2805210
ompRp1,0.25,3,3,AGTTAATCGGCTAAAACGAC,0,2809878
ompRp1,0.25,3,3,AGTGTCCCCGGGCATTCAAT,0,2790813
ompRp1,0.25,3,3,AGTGTCCAAACGGGTAGATC,0,2784069
ompRp1,0.25,3,3,AGTGGTTAGGGATTGCGTCC,0,2780906
ompRp1,0.25,3,3,AGTGGGCAAGTAGCGACTGA,0,2810937
ompRp1,0.25,3,3,AGTGGAGACGTGAAGGTTTG,0,2788675
ompRp1,0.25,3,3,AGTGGAATAGCGTATTCTCG,0,2823872
ompRp1,0.25,3,3,AGTGCTTTTCACTGCGGCTG,0,2792632
ompRp1,0.25,3,3,AGTGCTTCTCATTTGCCGTT,0,2778712
ompRp1,0.25,3,3,AGTGCTGCAGTCCTTTGTGT,0,2803863
ompRp1,0.25,3,3,AGTGCGGTGATAAGTGTGGA,0,2767105
ompRp1,0.25,3,3,AGTGCGGTCTAGCTAAAGCC,0,2777674
ompRp1,0.25,3,3,AGTGCGCCGAACCGTTTCAG,0,2766885
ompRp1,0.25,3,3,AGTGCGAGGACGGTGCTAGA,0,2822794
ompRp1,0.25,3,3,AGTGCCAGAGGATTGGAAAC,0,2811940
ompRp1,0.25,3,3,AGTGAGTGCAGAACAAGGCC,0,2781054
ompRp1,0.25,3,3,AGTGACCACGGCCCCCATAC,0,2819452
ompRp1,0.25,3,3,AGTGAATACTTTTGTCGTTA,0,2805067
ompRp1,0.25,3,3,AGTCTGTGGGCGCGACTTCT,0,2792817
ompRp1,0.25,3,3,AGTCGGCGATAAGAAACTCC,0,2765405
ompRp1,0.25,3,3,AGTCCTGTCCTTTCCCTCGT,0,2775649
ompRp1,0.25,3,3,AGTCCTGGCGTACTAGGTTG,0,2805246
ompRp1,0.25,3,3,AGTAGAGCTTTTAGCGTGAA,0,2782296
ompRp1,0.25,3,3,AGTACACTTACAATCCTACC,0,2813103
ompRp1,0.25,3,3,AGTAAATGTCACCCGACCGT,0,2820879
ompRp1,0.25,3,3,AGGTTCGATACCCGAGGACA,0,2791117
ompRp1,0.25,3,3,AGGTTAATAGGGATCCCCCC,0,2797240
ompRp1,0.25,3,3,AGGTGGGTGGGGGTTCCTGG,0,2804026
ompRp1,0.25,3,3,AGGTCTGAGCCGGGTTAATG,0,2824696
ompRp1,0.25,3,3,AGGTCCAGACTTTGCTGGTA,0,2778354
ompRp1,0.25,3,3,AGGTATCATAATAGGGTTGA,0,2823199
ompRp1,0.25,3,3,AGGGCGGATTATGCCTCGTC,0,2785462
ompRp1,0.25,3,3,AGGGCGACTGGCTATGGGAC,0,2777013
ompRp1,0.25,3,3,AGGGCAGATCGACATGGCAG,0,2818439
ompRp1,0.25,3,3,AGGGATCTACCGCCAACGTT,0,2810762
ompRp1,0.25,3,3,AGGGAACTTCATGTGTTGCT,0,2814526
ompRp1,0.25,3,3,AGGCTGTGTCCCGTGGATAC,0,2793240
ompRp1,0.25,3,3,AGGCTGGATCTGACGTGATC,0,2771638
ompRp1,0.25,3,3,AGGCTGGAGTACTTAATATA,0,2799666
ompRp1,0.25,3,3,AGGCGAGAGCCCAGGAACGT,0,2770221
ompRp1,0.25,3,3,AGGCCCGAACAATGTAAACT,0,2823755
ompRp1,0.25,3,3,AGGCATGTCGTGAGAGGAGT,0,2797927
ompRp1,0.25,3,3,AGGCATGCGCGGGGAACTCC,0,2783832
ompRp1,0.25,3,3,AGGACTTCACGTGCATTACT,0,2797646
ompRp1,0.25,3,3,AGGACCAGTCATTGATGTGG,0,2766137
ompRp1,0.25,3,3,AGGAAGGCTGGTCCCCTGTC,0,2803682
ompRp1,0.25,3,3,AGGAAGATAATTTGAAGATT,0,2783528
ompRp1,0.25,3,3,AGGAAAGTTAGGGGACCTTT,0,2786377
ompRp1,0.25,3,3,AGGAAAGACGAACCGGGGAT,0,2794009
ompRp1,0.25,3,3,AGCTTTTCATTGGTAATCGT,0,2814848
ompRp1,0.25,3,3,AGCTTTCCGGTGGACCTCAA,0,2795053
ompRp1,0.25,3,3,AGCTTATAAGTAGTGATGCA,0,2771350
ompRp1,0.25,3,3,AGCTGTGAATAGCATACCGT,0,2787334
ompRp1,0.25,3,3,AGCTGTCCCTAGGTCGCGGT,0,2812215
ompRp1,0.25,3,3,AGCTCCGATACCCCCTTATG,0,2803885
ompRp1,0.25,3,3,AGCTCAAGAGCCGGACTCTA,0,2776614
ompRp1,0.25,3,3,AGCTACCCGACCGCCCATTG,0,2806145
ompRp1,0.25,3,3,AGCGTTAGATCGTGCCGAAA,0,2814582
ompRp1,0.25,3,3,AGCGTATCTCGGCTGCCAGA,0,2769531
ompRp1,0.25,3,3,AGCGGGTATATTAGGGCATA,0,2820690
ompRp1,0.25,3,3,AGCGCTGTAAACATTTGCTG,0,2798325
ompRp1,0.25,3,3,AGCGCCACCAGTTTCTCGCA,0,2806219
ompRp1,0.25,3,3,AGCGCAGCCGCGCGTTTGGG,0,2814461
ompRp1,0.25,3,3,AGCGATGTAAAGAGAGCTCA,0,2775221
ompRp1,0.25,3,3,AGCCTCTGGGATTAGTAATG,0,2816204
ompRp1,0.25,3,3,AGCCTAGACACCCCTCCCAG,0,2766517
ompRp1,0.25,3,3,AGCCCTGGAATTAGGATGAT,0,2796110
ompRp1,0.25,3,3,AGCCCCGATAAGACGTGCCA,0,2814516
ompRp1,0.25,3,3,AGCCCATCCTTGGGAGTGGT,0,2800108
ompRp1,0.25,3,3,AGCATCCCCACCGACGTCGT,0,2820641
ompRp1,0.25,3,3,AGCAGTCCTGCAACAGCAGT,0,2811117
ompRp1,0.25,3,3,AGCAGAGCCTACCAGTCGTC,0,2774133
ompRp1,0.25,3,3,AGCACGTCTTACCGGGCCTA,0,2772254
ompRp1,0.25,3,3,AGCACGTCGGACTGATTCGT,0,2815735
ompRp1,0.25,3,3,AGCACGGCGCGAGGGCGAAT,0,2787180
ompRp1,0.25,3,3,AGCACGGATACGAATATGAG,0,2786104
ompRp1,0.25,3,3,AGCACAATGTGGTAGATCAG,0,2823163
ompRp1,0.25,3,3,AGCAAGAGTCCGTAGAACAA,0,2807551
ompRp1,0.25,3,3,AGATTGCCTGCACCACCGTT,0,2766684
ompRp1,0.25,3,3,AGATTATTTCCGCTTCGATA,0,2796783
ompRp1,0.25,3,3,AGATTACAAGTGAGGCAGTT,0,2796776
ompRp1,0.25,3,3,AGATTAACGCGGCGTGACCT,0,2767548
ompRp1,0.25,3,3,AGATGCTGTGCGTCCAGTTT,0,2766056
ompRp1,0.25,3,3,AGATGCTGCCATCCAGTGTG,0,2819579
ompRp1,0.25,3,3,AGATGACTCCAATATCGCTG,0,2800166
ompRp1,0.25,3,3,AGATCTGACTGCCTTGCGAG,0,2814066
ompRp1,0.25,3,3,AGATCTATAAATATTTGCTG,0,2824035
ompRp1,0.25,3,3,AGATCGTAGACATGGAGACG,0,2800933
ompRp1,0.25,3,3,AGATCGGTTTACCTAGGTCC,0,2790247
ompRp1,0.25,3,3,AGATCGGCTCGTTTATTTCT,0,2770371
ompRp1,0.25,3,3,AGATCAGAAGCCCTACACGG,0,2818833
ompRp1,0.25,3,3,AGATAAAGATCCCGGGTGGT,0,2778763
ompRp1,0.25,3,3,AGAGTTCGGTAGCATCTGAG,0,2780277
ompRp1,0.25,3,3,AGAGTGGTGACACAGTCCAT,0,2803353
ompRp1,0.25,3,3,AGAGTCTCTGAGGGAAGCAT,0,2823031
ompRp1,0.25,3,3,AGAGTCACAGCGGCCCTCTC,0,2799239
ompRp1,0.25,3,3,AGAGGCTTTCAAGGGCGGCT,0,2811704
ompRp1,0.25,3,3,AGAGGCTGGTCTCAGACAGT,0,2810404
ompRp1,0.25,3,3,AGAGGAGTTGGGTTGAACAA,0,2786815
ompRp1,0.25,3,3,AGAGCCTGGCGGTCACCCCC,0,2811781
ompRp1,0.25,3,3,AGAGCATCACGCATGAGTGG,0,2821855
ompRp1,0.25,3,3,AGAGATATGCCTGGAAACCT,0,2804141
ompRp1,0.25,3,3,AGAGACTTTGGGGCGACACT,0,2814019
ompRp1,0.25,3,3,AGACTTTCAAATATAGAACG,0,2814350
ompRp1,0.25,3,3,AGACTTTACAAGAATACTAA,0,2784780
ompRp1,0.25,3,3,AGACTTGCCCAGACGAAGAG,0,2791914
ompRp1,0.25,3,3,AGACTTCACTTCCCTAAGTC,0,2767395
ompRp1,0.25,3,3,AGACTGTGCTACACATGAAA,0,2804360
ompRp1,0.25,3,3,AGACCGTCAAACGAGGTAGA,0,2815532
ompRp1,0.25,3,3,AGACCCTCAGGCATGAGATG,0,2794773
ompRp1,0.25,3,3,AGACACTCTGACATCCGGTC,0,2821060
ompRp1,0.25,3,3,AGAATTGTCCGCTCCACCGT,0,2807146
ompRp1,0.25,3,3,AGAATTACTCATGTAACGAC,0,2768034
ompRp1,0.25,3,3,AGAATGAATAGGAGCGTTTA,0,2785393
ompRp1,0.25,3,3,AGAATCTGTCGCTAGGTGGT,0,2808672
ompRp1,0.25,3,3,AGAAGCCGTGTATCGACGGA,0,2806009
ompRp1,0.25,3,3,AGAAGAGCGACCAGTTCTCT,0,2814304
ompRp1,0.25,3,3,AGAACGATACCTACGCCAGT,0,2773517
ompRp1,0.25,3,3,AGAAATTTAGCTGGCATAGC,0,2804726
ompRp1,0.25,3,3,ACTTTTCATGCATCCCGGGA,0,2809161
ompRp1,0.25,3,3,ACTTCCTCATTGGCCAAGCG,0,2815835
ompRp1,0.25,3,3,ACTTCCTAACATGCTCTCTG,0,2784999
ompRp1,0.25,3,3,ACTTCAGTTCTTATACAGGG,0,2821439
ompRp1,0.25,3,3,ACTGTTTTTCCAGGATTCTG,0,2799343
ompRp1,0.25,3,3,ACTGTTGAATCTTACACAGA,0,2787174
ompRp1,0.25,3,3,ACTGGGCTACGGACCGGCAG,0,2785550
ompRp1,0.25,3,3,ACTGCGTGTTGCTTGATATG,0,2822199
ompRp1,0.25,3,3,ACTGCCACCCGGATTCACTG,0,2790653
ompRp1,0.25,3,3,ACTGACTTGTTCAGTTAACG,0,2787101
ompRp1,0.25,3,3,ACTGAATATCGGGAACAACG,0,2797871
ompRp1,0.25,3,3,ACTGAATAACGGCGTTCTCG,0,2794239
ompRp1,0.25,3,3,ACTCTATGGGGGGGGCACTA,0,2771351
ompRp1,0.25,3,3,ACTCGCTTCGATTACATCAA,0,2774929
ompRp1,0.25,3,3,ACTCGCGGTCAGGGGCAGGG,0,2799609
ompRp1,0.25,3,3,ACTCAAATATCGTGGTTTGA,0,2789482
ompRp1,0.25,3,3,ACTATCTTAGTCCAGGAGGT,0,2770669
ompRp1,0.25,3,3,ACTATCACGGGATCTCGAGT,0,2805729
ompRp1,0.25,3,3,ACTATATTGAGGTCATCCGA,0,2765311
ompRp1,0.25,3,3,ACTAGGTTAAACCGGGGTCT,0,2783637
ompRp1,0.25,3,3,ACTAGCAATAATTTCAGACT,0,2808590
ompRp1,0.25,3,3,ACGTTTCCGGGGTTTCGTCT,0,2789204
ompRp1,0.25,3,3,ACGTGTTGGTGATGTAGTAA,0,2799677
ompRp1,0.25,3,3,ACGTGAGAACAGCGTTAGCG,0,2766634
ompRp1,0.25,3,3,ACGTGAAGAACGGGGAGTGT,0,2784646
ompRp1,0.25,3,3,ACGTAGGTCCAGGTAGACCT,0,2822560
ompRp1,0.25,3,3,ACGTACCGGGTGGGTCATAA,0,2815379
ompRp1,0.25,3,3,ACGGTGTGCGATAGAGGCGG,0,2770351
ompRp1,0.25,3,3,ACGGTCGCGACACGTGAGAG,0,2792189
ompRp1,0.25,3,3,ACGGTCCTAACACTTCAGAC,0,2775417
ompRp1,0.25,3,3,ACGGTACAACTCGTACGACT,0,2786395
ompRp1,0.25,3,3,ACGGGTGGTATTTAAACCCC,0,2802852
ompRp1,0.25,3,3,ACGGGTCAAACCATGGCGTA,0,2820793
ompRp1,0.25,3,3,ACGGCTGTTACGAACGCTAG,0,2808150
ompRp1,0.25,3,3,ACGGACTTGGATTCAGTACG,0,2786464
ompRp1,0.25,3,3,ACGCTCGATGCACGCAGTAT,0,2809173
ompRp1,0.25,3,3,ACGCGGGAACTTTGCTAGGG,0,2783710
ompRp1,0.25,3,3,ACGCGCGCTATACTGATTAC,0,2769252
ompRp1,0.25,3,3,ACGCGCGCCACGTTGCGCTA,0,2810394
ompRp1,0.25,3,3,ACGCGAATTTAGGGCATGTC,0,2809670
ompRp1,0.25,3,3,ACGCCTCTAGGCATCTGACT,0,2790806
ompRp1,0.25,3,3,ACGATTCCAGCTCGGGCCAC,0,2765749
ompRp1,0.25,3,3,ACGATCCTGTAAGTCCCATA,0,2807839
ompRp1,0.25,3,3,ACGAGGTGCAACCATTGATG,0,2786570
ompRp1,0.25,3,3,ACGAGGCAGACTTAAGCGGG,0,2792391
ompRp1,0.25,3,3,ACGAGAACTAGGGGTTTCAT,0,2814073
ompRp1,0.25,3,3,ACGACGGAGGTTCCGAAGTA,0,2775768
ompRp1,0.25,3,3,ACGACGAGGCATAGCATGAA,0,2816831
ompRp1,0.25,3,3,ACGACACCTTCGACAATCGT,0,2822252
ompRp1,0.25,3,3,ACGAATTGTAGGACTATCCT,0,2819593
ompRp1,0.25,3,3,ACCTTGCTAATAAGTCCAAT,0,2800204
ompRp1,0.25,3,3,ACCTGTATGATACGTGTCGC,0,2769389
ompRp1,0.25,3,3,ACCTGACTGTGGAACACGAA,0,2812735
ompRp1,0.25,3,3,ACCTGACGCCAAAATAGGCG,0,2795122
ompRp1,0.25,3,3,ACCTAGATGAGCATACGGGA,0,2774285
ompRp1,0.25,3,3,ACCTAGAGGATCCGCAGCAA,0,2802544
ompRp1,0.25,3,3,ACCTACAGTCAAAGGGCACC,0,2796107
ompRp1,0.25,3,3,ACCTAACTTCCGCCATTGCT,0,2813312
ompRp1,0.25,3,3,ACCTAACATAAGCTAACACT,0,2778786
ompRp1,0.25,3,3,ACCGGACAGTCTGCGGGGAC,0,2812377
ompRp1,0.25,3,3,ACCGGAAGGAGTGTCTGTGA,0,2772848
ompRp1,0.25,3,3,ACCGCTGCTCTAAATGATCT,0,2768128
ompRp1,0.25,3,3,ACCCTGAGTCGATTGGTTAA,0,2789031
ompRp1,0.25,3,3,ACCCTATCATTTATTGGACA,0,2767259
ompRp1,0.25,3,3,ACCCCTCGTTAGAGTTCACG,0,2775809
ompRp1,0.25,3,3,ACCCCGTTCGCCAAAATGTG,0,2789990
ompRp1,0.25,3,3,ACCCCCACCAGGTGCCCCAA,0,2818123
ompRp1,0.25,3,3,ACCATTTCGGGATATCTGAT,0,2785139
ompRp1,0.25,3,3,ACCATCGTGCCCTGGGTGTG,0,2808882
ompRp1,0.25,3,3,ACCAGTCAGATCGTTGGCCC,0,2804133
ompRp1,0.25,3,3,ACCAACGTAAGGTCATCATT,0,2823964
ompRp1,0.25,3,3,ACATTCTGGGTTGATAGGTT,0,2787157
ompRp1,0.25,3,3,ACATCCCACAAATTCGGTAG,0,2823670
ompRp1,0.25,3,3,ACATCAGGATTCTGCGGGGA,0,2767062
ompRp1,0.25,3,3,ACATAGCTCTATAGGAGATG,0,2800565
ompRp1,0.25,3,3,ACAGTTTCAGAATGAAGGAG,0,2803511
ompRp1,0.25,3,3,ACAGTCGTATACAGCGCTGG,0,2811143
ompRp1,0.25,3,3,ACAGGGGTAGCGGCAAGCGC,0,2803135
ompRp1,0.25,3,3,ACAGCCGCCGGCGTAGTTGT,0,2793440
ompRp1,0.25,3,3,ACAGATTTCTTGGCTTAGAA,0,2808937
ompRp1,0.25,3,3,ACAGAGCGCGCATCAAATTC,0,2772137
ompRp1,0.25,3,3,ACACTTTACTCATTCTTCGC,0,2810771
ompRp1,0.25,3,3,ACACTTCATATCATTTCGGT,0,2822999
ompRp1,0.25,3,3,ACACTTCATAGCGTTGGCGA,0,2821224
ompRp1,0.25,3,3,ACACTCATTGGGTTGTTTAC,0,2770849
ompRp1,0.25,3,3,ACACGTAAACTTGAGATAAT,0,2771202
ompRp1,0.25,3,3,ACACGGTCCTATAAACTCGG,0,2765420
ompRp1,0.25,3,3,ACACCCTGTGGTCACGGGAC,0,2808674
ompRp1,0.25,3,3,ACACCAAAGTAGCTTGAGCC,0,2772599
ompRp1,0.25,3,3,ACACACCGCTTTCAGGTCAA,0,2773000
ompRp1,0.25,3,3,ACACACACATACGAGTCGAT,0,2786761
ompRp1,0.25,3,3,ACAATACCTCGCGAGCGTGT,0,2804164
ompRp1,0.25,3,3,ACAAGTTCTACCCTTCCGAC,0,2792570
ompRp1,0.25,3,3,ACAACCTCGGGCGAGCCATG,0,2771955
ompRp1,0.25,3,3,ACAAAGTGGCATGTGCGGCT,0,2795734
ompRp1,0.25,3,3,AATTTAGTTGTCTCATTGCT,0,2784429
ompRp1,0.25,3,3,AATTGTGATATACTTAACCG,0,2789704
ompRp1,0.25,3,3,AATTGGTCGGAATGAACTAG,0,2817606
ompRp1,0.25,3,3,AATTGATCGGAGTACCGCTA,0,2805358
ompRp1,0.25,3,3,AATTGACGGCGATTCGTTCA,0,2797287
ompRp1,0.25,3,3,AATTGACGATACGCGACGGA,0,2816370
ompRp1,0.25,3,3,AATTATTCGGAGTTAAGGAA,0,2769028
ompRp1,0.25,3,3,AATGGCTTGTGGGTGGCCCC,0,2769830
ompRp1,0.25,3,3,AATGGATGTGTGCAAACTAA,0,2765273
ompRp1,0.25,3,3,AATGGATATATACGCGACGC,0,2822132
ompRp1,0.25,3,3,AATGCTGAGACACGTAGGGG,0,2821377
ompRp1,0.25,3,3,AATGCCTCGACCGGGGCTAG,0,2810091
ompRp1,0.25,3,3,AATGCATCACGCTGGCTACC,0,2781585
ompRp1,0.25,3,3,AATGCAGCGTGACACATGGT,0,2791942
ompRp1,0.25,3,3,AATCTTCTAGCTTACTAGAC,0,2794525
ompRp1,0.25,3,3,AATCGGTGGTGGTGTACAAA,0,2776145
ompRp1,0.25,3,3,AATCGGAGATCCAGGTGTGT,0,2823699
ompRp1,0.25,3,3,AATCGCAGTGAGACTGCGCT,0,2779493
ompRp1,0.25,3,3,AATCCCTTTTGTTGTGGGGA,0,2798267
ompRp1,0.25,3,3,AATCCATGCACGGTACCGTA,0,2787797
ompRp1,0.25,3,3,AATCATCGGCTTAAAACCTG,0,2803694
ompRp1,0.25,3,3,AATCAGGTGACGCACTCTCT,0,2788292
ompRp1,0.25,3,3,AATCACTTACGGACTTGCGT,0,2798189
ompRp1,0.25,3,3,AATATTGAAAATCTAACGAC,0,2789078
ompRp1,0.25,3,3,AATATCCGCCCCGAAACGTG,0,2792666
ompRp1,0.25,3,3,AATAGGAATATGTTAAGAAG,0,2782846
ompRp1,0.25,3,3,AATAGAGAGCTTAGTGCGTC,0,2794323
ompRp1,0.25,3,3,AATACGGTGGTAGAAATAGG,0,2820901
ompRp1,0.25,3,3,AATAATATGGACACGGAGAG,0,2783158
ompRp1,0.25,3,3,AATAAGATTGCACGCCGGAT,0,2816698
ompRp1,0.25,3,3,AATAAAGTGGTTATACAGCA,0,2798320
ompRp1,0.25,3,3,AAGTTTGGCTGACAGCACTA,0,2793021
ompRp1,0.25,3,3,AAGTTTAGAGTCTATTCGTG,0,2779420
ompRp1,0.25,3,3,AAGTTGGACCGCCAAGCGTT,0,2798887
ompRp1,0.25,3,3,AAGTGTCAAGCTTTACTGTT,0,2768090
ompRp1,0.25,3,3,AAGTGGTTGCAGTTAGTAGC,0,2800841
ompRp1,0.25,3,3,AAGTGAGGGCATCGAAGCGG,0,2817209
ompRp1,0.25,3,3,AAGTGAGGAATAATCGTGGT,0,2815561
ompRp1,0.25,3,3,AAGTCTTTCGTGTGGTCGTA,0,2814044
ompRp1,0.25,3,3,AAGTCTTCAGTGTTAATCCA,0,2768769
ompRp1,0.25,3,3,AAGTCCTCTGCGAGAGTACG,0,2780110
ompRp1,0.25,3,3,AAGTAGCCCTTAACGAGGTA,0,2769777
ompRp1,0.25,3,3,AAGGTTACGTAATACGACCC,0,2786384
ompRp1,0.25,3,3,AAGGTGGTCTTATGTGGATA,0,2789907
ompRp1,0.25,3,3,AAGGTGAGTAGTGCCGCAGG,0,2821212
ompRp1,0.25,3,3,AAGGTAGGAGAGAAAGAGCG,0,2769742
ompRp1,0.25,3,3,AAGGGTTATCGGGGGACCAG,0,2770010
ompRp1,0.25,3,3,AAGGGGATCCAGTTCCATGA,0,2783773
ompRp1,0.25,3,3,AAGGGCTTGCAGGGGGAAGT,0,2785771
ompRp1,0.25,3,3,AAGGGCCGATCCAGCGAGGC,0,2808799
ompRp1,0.25,3,3,AAGGGCCACATCTCAGTTGT,0,2788864
ompRp1,0.25,3,3,AAGGCGGCGAGACGCCCGAG,0,2782001
ompRp1,0.25,3,3,AAGGCGGCCGCGGCAGACTA,0,2769522
ompRp1,0.25,3,3,AAGGCGGAAAAACCCGGTCG,0,2788003
ompRp1,0.25,3,3,AAGGACTTTGCCCTCGAAAG,0,2800099
ompRp1,0.25,3,3,AAGCTCAGGTTGCCAAAGAA,0,2812361
ompRp1,0.25,3,3,AAGCGTTGAGAGACACTATA,0,2801656
ompRp1,0.25,3,3,AAGCGTTATGAGTGTCGGGC,0,2793937
ompRp1,0.25,3,3,AAGCGGGTTTCTCATCGGAC,0,2784552
ompRp1,0.25,3,3,AAGCGGCGATGTTACAAGCA,0,2804703
ompRp1,0.25,3,3,AAGCGCATGAAACTCGGTGT,0,2811516
ompRp1,0.25,3,3,AAGCCGTCTTTACTCTACCA,0,2795067
ompRp1,0.25,3,3,AAGCCCCAAAGATGTGCCAG,0,2820179
ompRp1,0.25,3,3,AAGCAAGCAGACCTCTGATC,0,2787586
ompRp1,0.25,3,3,AAGATGACTCCTGCAGTATG,0,2781827
ompRp1,0.25,3,3,AAGATAGTGTAGACTTCTGC,0,2811536
ompRp1,0.25,3,3,AAGAAGCCCGCCGGCTGGGT,0,2784376
ompRp1,0.25,3,3,AAGAAATCCCTGTCTAAAGT,0,2781163
ompRp1,0.25,3,3,AACTGCCGCTCCGCATCGGT,0,2794537
ompRp1,0.25,3,3,AACTAAGACCTAGGGGGCAT,0,2821960
ompRp1,0.25,3,3,AACGTGTGGCCGCGCATACA,0,2793502
ompRp1,0.25,3,3,AACGTACTCGTAATAAGGGG,0,2815304
ompRp1,0.25,3,3,AACGGTTGAACTGTCGAAAC,0,2791319
ompRp1,0.25,3,3,AACGCTGCAGGATTCGACTG,0,2822669
ompRp1,0.25,3,3,AACGCATTCAAGATTTCGTT,0,2815567
ompRp1,0.25,3,3,AACGAACCCTGTTGATGGAC,0,2794958
ompRp1,0.25,3,3,AACCTTGAATTTGGGTAGGA,0,2768140
ompRp1,0.25,3,3,AACCTCTTCGATTCCATTTT,0,2800319
ompRp1,0.25,3,3,AACCCGCACCGGTACCCCTG,0,2791473
ompRp1,0.25,3,3,AACCACCTGCAGTCTGTCCG,0,2800622
ompRp1,0.25,3,3,AACCAAACTGGAAGATAGGG,0,2769527
ompRp1,0.25,3,3,AACATGAACAAGTGCCGCAA,0,2789603
ompRp1,0.25,3,3,AACATCACTCAGGGCATAAA,0,2808169
ompRp1,0.25,3,3,AACAGGGGTGTGCATCGTAT,0,2807597
ompRp1,0.25,3,3,AACACTCTGGCACCACATCT,0,2776284
ompRp1,0.25,3,3,AACAATGATGCGAGTTCTTG,0,2774561
ompRp1,0.25,3,3,AACAAAAAAAGGCTGCCGTC,0,2810766
ompRp1,0.25,3,3,AAATTTCCGGGAAAAATCCG,0,2775661
ompRp1,0.25,3,3,AAATGGGCGACACAAAGTAT,0,2812798
ompRp1,0.25,3,3,AAATCCTTCGTGCGTTGGTA,0,2776320
ompRp1,0.25,3,3,AAATCCGTCTCAGCCATGAA,0,2769072
ompRp1,0.25,3,3,AAATCCAGCGCACCTTCGCC,0,2806716
ompRp1,0.25,3,3,AAATAGGTTAATGGTATATA,0,2798354
ompRp1,0.25,3,3,AAATAATGAACCGACCTCTC,0,2785472
ompRp1,0.25,3,3,AAATAATAGACCGTCCTACG,0,2811233
ompRp1,0.25,3,3,AAAGTTGCTTCCGAAGGTGC,0,2767681
ompRp1,0.25,3,3,AAAGTCGTTGTTTATCAACT,0,2766943
ompRp1,0.25,3,3,AAAGGCTTCATACGGCTATT,0,2816091
ompRp1,0.25,3,3,AAAGGCTATTTATGACAGCT,0,2812316
ompRp1,0.25,3,3,AAAGGCGCATGTCTACGTAG,0,2789936
ompRp1,0.25,3,3,AAAGCGGTATAAGTGTCAAG,0,2824243
ompRp1,0.25,3,3,AAAGATTAACTTCTAATAAA,0,2809215
ompRp1,0.25,3,3,AAAGAACACGTAACGGTACC,0,2801720
ompRp1,0.25,3,3,AAACTGTCTCTGTACAAGGA,0,2772507
ompRp1,0.25,3,3,AAACCCAAAGGGCGACCCAG,0,2794662
ompRp1,0.25,3,3,AAACCATAGCAACTAGACCC,0,2771539
ompRp1,0.25,3,3,AAACATTTTTTTATCTATGA,0,2782467
ompRp1,0.25,3,3,AAACAGGTCCCCGTGTCTCT,0,2806087
ompRp1,0.25,3,3,AAAATTGAGGGGCCATGTTC,0,2806596
ompRp1,0.25,3,3,AAAATATAGTTTTATAGGGA,0,2817161
ompRp1,0.25,3,3,AAAATAAAGCTTGGGACGGT,0,2807468
ompRp1,0.25,3,3,AAAAGTAGTTAATTCAATTC,0,2822644
ompRp1,0.25,3,3,AAAAGCTTGCAGAGAACGCA,0,2798331
ompRp1,0.25,3,3,AAAAGCTTCTATACTTCTCC,0,2810550
ompRp1,0.25,3,3,AAAAGCATATAGCCCATAAT,0,2795245
ompRp1,0.25,3,3,AAAACGTAATATCAACACTT,0,2783527
ompRp1,0.25,3,3,AAAAAGTGGGTACTAAGTAC,0,2796563
ompRp1,0.25,3,3,AAAAACGATCAGGTCCTTCA,0,2783229
ompRp1,0.3333333333333333,2,2,TTTTTTCTGACGACAAAGAT,0,2768070
ompRp1,0.3333333333333333,2,2,TTTTTTAGTGCTACCATCTC,0,2816788
ompRp1,0.3333333333333333,2,2,TTTTTTAGAAAGTGCCGAGG,0,2817424
ompRp1,0.3333333333333333,2,2,TTTTTGTACAGACAGATCGC,0,2773558
ompRp1,0.3333333333333333,2,2,TTTTTGCTCGTTTGTGTGAA,0,2822496
ompRp1,0.3333333333333333,2,2,TTTTTGATTCTTTCGAGTCC,0,2783443
ompRp1,0.3333333333333333,2,2,TTTTGTGGATTGTGTGAAGT,0,2799533
ompRp1,0.3333333333333333,2,2,TTTTGAGCCCAGAGGCATGG,0,2792077
ompRp1,0.3333333333333333,2,2,TTTTCTTTGCCATTTCGCGG,0,2822187
ompRp1,0.3333333333333333,2,2,TTTTCGGATTGCGCATCCAA,0,2806864
ompRp1,0.3333333333333333,2,2,TTTTCACCAACACTGCGATC,0,2794133
ompRp1,0.3333333333333333,2,2,TTTTATTCTTCCTGATGGCC,0,2769754
ompRp1,0.3333333333333333,2,2,TTTTATGCTCAAATACTTTG,0,2785569
ompRp1,0.3333333333333333,2,2,TTTGGGGTAACGTACGTGGA,0,2809083
ompRp1,0.3333333333333333,2,2,TTTGGCATAAGGAATTAAGG,0,2775589
ompRp1,0.3333333333333333,2,2,TTTGGAGCGTGATTGTGTCC,0,2787562
ompRp1,0.3333333333333333,2,2,TTTGCTCAAATTATTATAGG,0,2817122
ompRp1,0.3333333333333333,2,2,TTTGCCCTAATTCAAAGTGG,0,2772808
ompRp1,0.3333333333333333,2,2,TTTGCCAGGTCAACAGAGTG,0,2818821
ompRp1,0.3333333333333333,2,2,TTTGCATATAGTAACCGACA,0,2785043
ompRp1,0.3333333333333333,2,2,TTTGACCACTAATGGGAGCG,0,2811988
ompRp1,0.3333333333333333,2,2,TTTCTAAAGTGGTTCACAAA,0,2816428
ompRp1,0.3333333333333333,2,2,TTTATGGGTAGGCTGATCCC,0,2806876
ompRp1,0.3333333333333333,2,2,TTTATAAAATGGCAGACGGG,0,2784714
ompRp1,0.3333333333333333,2,2,TTTAGTCTCTCATATAGTAC,0,2816544
ompRp1,0.3333333333333333,2,2,TTTAGAGGCAGCTCCCCCTT,0,2810089
ompRp1,0.3333333333333333,2,2,TTTACGGGTAGGCCCCTATC,0,2770096
ompRp1,0.3333333333333333,2,2,TTTAAGTCATCTTTTCTCGA,0,2796006
ompRp1,0.3333333333333333,2,2,TTTAAGGCGTGAGGAGATCA,0,2803523
ompRp1,0.3333333333333333,2,2,TTTAACTTAAACCAACATCT,0,2823543
ompRp1,0.3333333333333333,2,2,TTGTTTCCTCAGCCCGAAGT,0,2795925
ompRp1,0.3333333333333333,2,2,TTGTTTCAGCGTCATTTTTA,0,2806384
ompRp1,0.3333333333333333,2,2,TTGTTGTTCTGTAGATGTAT,0,2786006
ompRp1,0.3333333333333333,2,2,TTGTTGCCCCTGCTGGGTTG,0,2814688
ompRp1,0.3333333333333333,2,2,TTGTTAGAATAGAAAGCCGA,0,2824769
ompRp1,0.3333333333333333,2,2,TTGTGGGCTTAGGAGAGGAT,0,2777396
ompRp1,0.3333333333333333,2,2,TTGTGGCAAGCAGTTGTCAT,0,2775421
ompRp1,0.3333333333333333,2,2,TTGTCCGAGGATATTTCCAG,0,2788678
ompRp1,0.3333333333333333,2,2,TTGTCAGAGAGTGTGGCGGG,0,2793208
ompRp1,0.3333333333333333,2,2,TTGTCAGACCGTGCTTAGGG,0,2813079
ompRp1,0.3333333333333333,2,2,TTGTATCGGCGTTCTAAGTA,0,2809742
ompRp1,0.3333333333333333,2,2,TTGTAGATCGGGGCCTTTCT,0,2803068
ompRp1,0.3333333333333333,2,2,TTGGTGAGGAATAGCACAGC,0,2816231
ompRp1,0.3333333333333333,2,2,TTGGGTTCGGTCAATGCACG,0,2803266
ompRp1,0.3333333333333333,2,2,TTGGGTCAGGATAGCGTCAT,0,2812818
ompRp1,0.3333333333333333,2,2,TTGGGTATTATAGGGCGTGA,0,2789815
ompRp1,0.3333333333333333,2,2,TTGGGGTTACCCGACGGTAT,0,2816303
ompRp1,0.3333333333333333,2,2,TTGGGGTCAGCGTGACTCGA,0,2796039
ompRp1,0.3333333333333333,2,2,TTGGGCCATACCGAGTCTTT,0,2783581
ompRp1,0.3333333333333333,2,2,TTGGGAGCTCGGGGGATGCG,0,2796834
ompRp1,0.3333333333333333,2,2,TTGGCACTGGGCTGCCACTT,0,2817172
ompRp1,0.3333333333333333,2,2,TTGGAGGGGGCGGTCGCCGC,0,2804629
ompRp1,0.3333333333333333,2,2,TTGCTTGCGGACGACATTTC,0,2788332
ompRp1,0.3333333333333333,2,2,TTGCTGACCAGCGCAATTTA,0,2775646
ompRp1,0.3333333333333333,2,2,TTGCTCCCGCTCAAAGATAC,0,2785570
ompRp1,0.3333333333333333,2,2,TTGCTAAGAGCCACTGGTTT,0,2799627
ompRp1,0.3333333333333333,2,2,TTGCGCCACCTCGCGCGTGA,0,2796526
ompRp1,0.3333333333333333,2,2,TTGCGCATATCTCTAACCGC,0,2771668
ompRp1,0.3333333333333333,2,2,TTGCGCACTGATATTGGGAG,0,2803143
ompRp1,0.3333333333333333,2,2,TTGCGAGGTACAGTGGCGTG,0,2813572
ompRp1,0.3333333333333333,2,2,TTGCCGACTTCAGTTTAGTA,0,2786546
ompRp1,0.3333333333333333,2,2,TTGCCAGTGGAAAACGGAGT,0,2803849
ompRp1,0.3333333333333333,2,2,TTGCATGTACCTAGAACTCA,0,2783080
ompRp1,0.3333333333333333,2,2,TTGCACATGAGGCAATCTCT,0,2773255
ompRp1,0.3333333333333333,2,2,TTGAGGGGGTCGTCAGAGTA,0,2823921
ompRp1,0.3333333333333333,2,2,TTGAGGCACTTTGGTAAGCA,0,2776328
ompRp1,0.3333333333333333,2,2,TTGACTGGGTTCATAGCTAG,0,2805553
ompRp1,0.3333333333333333,2,2,TTGACCTGACATTTAAAGCA,0,2804966
ompRp1,0.3333333333333333,2,2,TTGACATGATATGTCATGAA,0,2774735
ompRp1,0.3333333333333333,2,2,TTGACAGGAATTAATAATGG,0,2815728
ompRp1,0.3333333333333333,2,2,TTGAAGATACAGATGCCTAA,0,2786191
ompRp1,0.3333333333333333,2,2,TTGAACTGGGATGGGGTCTC,0,2779714
ompRp1,0.3333333333333333,2,2,TTCTTGCAAAACGGCGGATG,0,2797532
ompRp1,0.3333333333333333,2,2,TTCTGCCGTATTGTGCATAT,0,2787477
ompRp1,0.3333333333333333,2,2,TTCTCGCGACTCGGCCTCCA,0,2771320
ompRp1,0.3333333333333333,2,2,TTCTCATTCATGACCTACAA,0,2821285
ompRp1,0.3333333333333333,2,2,TTCTAGTAAAGGACACCATG,0,2789827
ompRp1,0.3333333333333333,2,2,TTCTACGCATTAAGCAAGCC,0,2820094
ompRp1,0.3333333333333333,2,2,TTCGTTGTGAATATCACCAA,0,2799882
ompRp1,0.3333333333333333,2,2,TTCGTGCAGCCGAATAGTCC,0,2801750
ompRp1,0.3333333333333333,2,2,TTCGTGCAACTGTCCAGGCA,0,2803984
ompRp1,0.3333333333333333,2,2,TTCGTATTTACGGTCTTACG,0,2795189
ompRp1,0.3333333333333333,2,2,TTCGTAACATCCGCATTATA,0,2774610
ompRp1,0.3333333333333333,2,2,TTCGGTCCCCAATGGTACCG,0,2815628
ompRp1,0.3333333333333333,2,2,TTCGGTCAGAGCCTACAGGA,0,2791200
ompRp1,0.3333333333333333,2,2,TTCGGGTAGAACACGCACTG,0,2811343
ompRp1,0.3333333333333333,2,2,TTCGCTCACGTGGTTGAAGG,0,2773137
ompRp1,0.3333333333333333,2,2,TTCGCCCCTACAAGCATCCC,0,2783771
ompRp1,0.3333333333333333,2,2,TTCGACGGCACCGTGCTATG,0,2813039
ompRp1,0.3333333333333333,2,2,TTCGAAAGTCCACTGGCGCT,0,2808884
ompRp1,0.3333333333333333,2,2,TTCCTGTTCACGTCGCGTTC,0,2811870
ompRp1,0.3333333333333333,2,2,TTCCTGTAGAGCCCGGGGGG,0,2783105
ompRp1,0.3333333333333333,2,2,TTCCTCCGGCAACCGGACAC,0,2793885
ompRp1,0.3333333333333333,2,2,TTCCTACCTTCTTCTGTATA,0,2780834
ompRp1,0.3333333333333333,2,2,TTCCGGACAGGGTTTATCTC,0,2817291
ompRp1,0.3333333333333333,2,2,TTCCGCACGTTACTACAACC,0,2821969
ompRp1,0.3333333333333333,2,2,TTCCCGTAGCCAGAGAGTCC,0,2789014
ompRp1,0.3333333333333333,2,2,TTCCCGGGGTGAGTGACGGC,0,2808350
ompRp1,0.3333333333333333,2,2,TTCCCGAAAAGTGTCCGATA,0,2770519
ompRp1,0.3333333333333333,2,2,TTCCCCTCCCGCCCATTGAT,0,2805615
ompRp1,0.3333333333333333,2,2,TTCCAGACTAATACAGCGCG,0,2807462
ompRp1,0.3333333333333333,2,2,TTCCACTAATACAAGGTGAC,0,2805772
ompRp1,0.3333333333333333,2,2,TTCCACAGCAGAACTCAGTT,0,2810461
ompRp1,0.3333333333333333,2,2,TTCATTAGTTATCGCCAATC,0,2779526
ompRp1,0.3333333333333333,2,2,TTCATGGTGTTGGTCTCGCT,0,2772996
ompRp1,0.3333333333333333,2,2,TTCATGATGGTACGCTGAGG,0,2814418
ompRp1,0.3333333333333333,2,2,TTCATCAGTTTGTAACAAGT,0,2773925
ompRp1,0.3333333333333333,2,2,TTCAGCTGATGGCTTTTTTC,0,2804233
ompRp1,0.3333333333333333,2,2,TTCAGCTACAAACTGAACTC,0,2791370
ompRp1,0.3333333333333333,2,2,TTCAGAAGTCGGCATTTGAA,0,2822676
ompRp1,0.3333333333333333,2,2,TTCACTCCGGGACGGGCTAT,0,2790807
ompRp1,0.3333333333333333,2,2,TTCACGTTCATCAGCATGAG,0,2789513
ompRp1,0.3333333333333333,2,2,TTCAAAAATAGTCGATCCCA,0,2816448
ompRp1,0.3333333333333333,2,2,TTATTCATCGCTCTAACCTA,0,2800909
ompRp1,0.3333333333333333,2,2,TTATGCTTGGCCCCACTGAC,0,2814261
ompRp1,0.3333333333333333,2,2,TTATGATGAGTCCAGTTTAG,0,2821719
ompRp1,0.3333333333333333,2,2,TTATGAAACATACACGAATT,0,2803484
ompRp1,0.3333333333333333,2,2,TTATCATGCATTTTCGGGCG,0,2795278
ompRp1,0.3333333333333333,2,2,TTATAGGCCATTGCGAGGAC,0,2820001
ompRp1,0.3333333333333333,2,2,TTAGTACACTGAGGGGCCGC,0,2772407
ompRp1,0.3333333333333333,2,2,TTAGGCTTAAATGATAAACC,0,2777315
ompRp1,0.3333333333333333,2,2,TTAGCAACCCGGTACCCACG,0,2786033
ompRp1,0.3333333333333333,2,2,TTAGAATGTGGGTTTGCCAA,0,2820598
ompRp1,0.3333333333333333,2,2,TTAATTGCAAGAGCCAGGCT,0,2810666
ompRp1,0.3333333333333333,2,2,TTAATGTGTCTCCGATGCCC,0,2765822
ompRp1,0.3333333333333333,2,2,TTAATCAGTGGTAGTGGGAA,0,2815948
ompRp1,0.3333333333333333,2,2,TTAATAGTGTGGAGGCAGCT,0,2799122
ompRp1,0.3333333333333333,2,2,TTAAGGTCGTAAGTACATTC,0,2786805
ompRp1,0.3333333333333333,2,2,TTAAGCGGTTGGCTGGTAGT,0,2786781
ompRp1,0.3333333333333333,2,2,TTAAGCGATTAGTCAGCAGA,0,2785703
ompRp1,0.3333333333333333,2,2,TTAACTCATGGGGATTTTAC,0,2813615
ompRp1,0.3333333333333333,2,2,TTAAACGGGGAATTGACCGC,0,2805681
ompRp1,0.3333333333333333,2,2,TGTTTTTAGCGTTCACGTTC,0,2795357
ompRp1,0.3333333333333333,2,2,TGTTTCGTCCCTCGGATAGC,0,2797412
ompRp1,0.3333333333333333,2,2,TGTTTACAGATCTAGGCGCC,0,2791704
ompRp1,0.3333333333333333,2,2,TGTTCACTACACCACATTAT,0,2793847
ompRp1,0.3333333333333333,2,2,TGTTAATTAATTTATGACTT,0,2818273
ompRp1,0.3333333333333333,2,2,TGTGTCGTGATGGGACTAGA,0,2794517
ompRp1,0.3333333333333333,2,2,TGTGTATAGTCCTTTGTCAC,0,2791290
ompRp1,0.3333333333333333,2,2,TGTGTAGGAACCTTCCTAAG,0,2774317
ompRp1,0.3333333333333333,2,2,TGTGTACTTTCAGAAAACGA,0,2776549
ompRp1,0.3333333333333333,2,2,TGTGGTATTCCAGTTGGGTG,0,2813440
ompRp1,0.3333333333333333,2,2,TGTGGGCCTGGAAGAGAATG,0,2802114
ompRp1,0.3333333333333333,2,2,TGTGGCTACGTCCTGGAAGG,0,2770592
ompRp1,0.3333333333333333,2,2,TGTGGCCAGTCAGGCCCCTC,0,2805626
ompRp1,0.3333333333333333,2,2,TGTGGAACCGCGCGGTGACC,0,2774978
ompRp1,0.3333333333333333,2,2,TGTGCTTATCGTCATATATA,0,2815655
ompRp1,0.3333333333333333,2,2,TGTGATGCGACTTCGACGCT,0,2817107
ompRp1,0.3333333333333333,2,2,TGTGAGATATTTATGTAGCG,0,2815301
ompRp1,0.3333333333333333,2,2,TGTGACCTGACACGGTTGAT,0,2803374
ompRp1,0.3333333333333333,2,2,TGTGAACGGGTGCGAGTCAG,0,2770820
ompRp1,0.3333333333333333,2,2,TGTCTTGTCCATGTACAGAA,0,2812417
ompRp1,0.3333333333333333,2,2,TGTCTTCACAGGTCATATTA,0,2791645
ompRp1,0.3333333333333333,2,2,TGTCTCTATATAGGATCGGG,0,2798941
ompRp1,0.3333333333333333,2,2,TGTCGGAGATCCCGGCGTTC,0,2817833
ompRp1,0.3333333333333333,2,2,TGTCGCAGTGCTGAAATTTA,0,2774073
ompRp1,0.3333333333333333,2,2,TGTCCTATCGTCAGTTTGGG,0,2769205
ompRp1,0.3333333333333333,2,2,TGTCCGCGCTAATCGAGGTC,0,2789328
ompRp1,0.3333333333333333,2,2,TGTCCGAGGATACTGCTCCA,0,2767280
ompRp1,0.3333333333333333,2,2,TGTCAGAGATACCTCTGAAT,0,2798447
ompRp1,0.3333333333333333,2,2,TGTCACAATTCACAGGATGA,0,2774882
ompRp1,0.3333333333333333,2,2,TGTACGCGGAGTGTATCGGG,0,2810158
ompRp1,0.3333333333333333,2,2,TGTACCATATGCAAGCGAGC,0,2780128
ompRp1,0.3333333333333333,2,2,TGTAACAGAGCTTTCGCTAT,0,2783700
ompRp1,0.3333333333333333,2,2,TGTAAAGGTCCATCTCACCA,0,2788873
ompRp1,0.3333333333333333,2,2,TGGTTTTAAAGGCTTATGCA,0,2781135
ompRp1,0.3333333333333333,2,2,TGGTTCGAGCTAATTAGAGT,0,2786095
ompRp1,0.3333333333333333,2,2,TGGTTAGTGTATTTAACTCC,0,2768598
ompRp1,0.3333333333333333,2,2,TGGTGTGTTAGGCTGGAAAA,0,2790842
ompRp1,0.3333333333333333,2,2,TGGTGGGCGGTAGAATGAAT,0,2778615
ompRp1,0.3333333333333333,2,2,TGGTCTCCTAGAGCGAAGTC,0,2812473
ompRp1,0.3333333333333333,2,2,TGGTCTCATCCGGGGGCGGG,0,2787921
ompRp1,0.3333333333333333,2,2,TGGTCCTGTGTTCGAGCCGT,0,2804665
ompRp1,0.3333333333333333,2,2,TGGTCCCAGCCAGGCCAAAG,0,2778887
ompRp1,0.3333333333333333,2,2,TGGTCCACGAATCTGTTGGG,0,2782352
ompRp1,0.3333333333333333,2,2,TGGTAGGCATTCCCGGCACT,0,2781560
ompRp1,0.3333333333333333,2,2,TGGGGTTGGGGGCCGCCAAA,0,2768527
ompRp1,0.3333333333333333,2,2,TGGGGCAGTTCAGACATGTA,0,2817589
ompRp1,0.3333333333333333,2,2,TGGGCGATACCAAACCAGAG,0,2775400
ompRp1,0.3333333333333333,2,2,TGGGATATTGCTTTGGCTGT,0,2777475
ompRp1,0.3333333333333333,2,2,TGGGACATAGGTATAGGCCA,0,2779162
ompRp1,0.3333333333333333,2,2,TGGCTTGGGCTAAAGAATGT,0,2801497
ompRp1,0.3333333333333333,2,2,TGGCTTCTTTTTCACTGTCA,0,2779266
ompRp1,0.3333333333333333,2,2,TGGCTGCGGGTATCCAACGG,0,2789404
ompRp1,0.3333333333333333,2,2,TGGCTAGTGTGTTTTACGCA,0,2821704
ompRp1,0.3333333333333333,2,2,TGGCGTTCTTTAAATCAGTC,0,2815881
ompRp1,0.3333333333333333,2,2,TGGCGGTTCTTTGGCTACGC,0,2809849
ompRp1,0.3333333333333333,2,2,TGGCGGAACATGATGTTCCA,0,2776863
ompRp1,0.3333333333333333,2,2,TGGCGCTCCCAAACCGTGTT,0,2792517
ompRp1,0.3333333333333333,2,2,TGGCGCAACCTCTTGCAAAT,0,2789205
ompRp1,0.3333333333333333,2,2,TGGCGATTCACTTCCCCGAC,0,2765313
ompRp1,0.3333333333333333,2,2,TGGCGACCTAAGTAGCAATC,0,2767003
ompRp1,0.3333333333333333,2,2,TGGCACTACTCTATCAATTC,0,2798172
ompRp1,0.3333333333333333,2,2,TGGCAAGATCATTGGACTTG,0,2782709
ompRp1,0.3333333333333333,2,2,TGGCAACGTCTGACCAGATG,0,2790801
ompRp1,0.3333333333333333,2,2,TGGACGGATCCGTGAAGTTT,0,2808371
ompRp1,0.3333333333333333,2,2,TGGACGGAGGGACTCTGTTG,0,2814941
ompRp1,0.3333333333333333,2,2,TGGAATTCGTGTTCCGTGCT,0,2779647
ompRp1,0.3333333333333333,2,2,TGGAAGGGACGTGTATTAGC,0,2781077
ompRp1,0.3333333333333333,2,2,TGGAAGGCATTCAGGGAAAG,0,2809749
ompRp1,0.3333333333333333,2,2,TGGAACAGCAAGCCTCGTCT,0,2795436
ompRp1,0.3333333333333333,2,2,TGCTTTATCAATAGGGTTCC,0,2784787
ompRp1,0.3333333333333333,2,2,TGCTTGCGCAATCGCCTTAT,0,2781107
ompRp1,0.3333333333333333,2,2,TGCTTGAGGTCACAATCACG,0,2783021
ompRp1,0.3333333333333333,2,2,TGCTCTGAAAGGGTACCTTT,0,2767695
ompRp1,0.3333333333333333,2,2,TGCTAGATGCCTGATTACTA,0,2771349
ompRp1,0.3333333333333333,2,2,TGCTAATCGGGACCCTACGA,0,2774205
ompRp1,0.3333333333333333,2,2,TGCTAATACGTAAGACGATA,0,2782012
ompRp1,0.3333333333333333,2,2,TGCTAACTGTTGGGTGAGGA,0,2810557
ompRp1,0.3333333333333333,2,2,TGCGTGTAAGCGCGCGTTCC,0,2814507
ompRp1,0.3333333333333333,2,2,TGCGTGGCGCGGGTCGAATA,0,2821425
ompRp1,0.3333333333333333,2,2,TGCGTGCCGCTTCCATAGAG,0,2814993
ompRp1,0.3333333333333333,2,2,TGCGTCAGCTGGAGTAACCT,0,2772392
ompRp1,0.3333333333333333,2,2,TGCGTATTCACCGCTGCGCC,0,2803095
ompRp1,0.3333333333333333,2,2,TGCGGTATTGTCCTGGTCAT,0,2811709
ompRp1,0.3333333333333333,2,2,TGCGGAGGACCGCGGACAGA,0,2769873
ompRp1,0.3333333333333333,2,2,TGCGCAATCAGTCAAGCATT,0,2803654
ompRp1,0.3333333333333333,2,2,TGCCTTGTGTTAATGAAATC,0,2821398
ompRp1,0.3333333333333333,2,2,TGCCTCACTTCGTTACTCGA,0,2789033
ompRp1,0.3333333333333333,2,2,TGCCGTCGTTATTGGCTCCC,0,2805647
ompRp1,0.3333333333333333,2,2,TGCCGATAATCGGTCGAAAG,0,2812521
ompRp1,0.3333333333333333,2,2,TGCCGACGCCGGTGAACGAT,0,2784156
ompRp1,0.3333333333333333,2,2,TGCCGACCCCCGGTCCCTTC,0,2780730
ompRp1,0.3333333333333333,2,2,TGCCCTTGGAGAGTAGTACA,0,2770163
ompRp1,0.3333333333333333,2,2,TGCCATATCAATTTTGTCTC,0,2813261
ompRp1,0.3333333333333333,2,2,TGCCAAATGAACGAGGCAAG,0,2800429
ompRp1,0.3333333333333333,2,2,TGCATGGGGCCACTGTGGAT,0,2767304
ompRp1,0.3333333333333333,2,2,TGCATGCGTCCTTACTTATT,0,2792067
ompRp1,0.3333333333333333,2,2,TGCAGGGATAAGGATACAAA,0,2797110
ompRp1,0.3333333333333333,2,2,TGCAGATTGGACGATGCTTG,0,2802585
ompRp1,0.3333333333333333,2,2,TGCACCTAGTCTATCTTGAA,0,2772058
ompRp1,0.3333333333333333,2,2,TGCACCCAAACATCTCGATA,0,2791057
ompRp1,0.3333333333333333,2,2,TGATTTGTGCATAAAGTTTT,0,2784165
ompRp1,0.3333333333333333,2,2,TGATTGCCTCCTGACGAGTG,0,2780335
ompRp1,0.3333333333333333,2,2,TGATTGATACCGGAGTTATA,0,2803816
ompRp1,0.3333333333333333,2,2,TGATTATGGTCTTCCTGAGT,0,2774708
ompRp1,0.3333333333333333,2,2,TGATGGAGAAGGGTTTAGAG,0,2775140
ompRp1,0.3333333333333333,2,2,TGATCTCGATGTTGATAAAG,0,2797069
ompRp1,0.3333333333333333,2,2,TGATCTAAAACAGTCACACT,0,2777630
ompRp1,0.3333333333333333,2,2,TGATATGACTTGAATGTATA,0,2788481
ompRp1,0.3333333333333333,2,2,TGATATAGGCTAAACACGGT,0,2776364
ompRp1,0.3333333333333333,2,2,TGATAAGCGCCTAGTTACGA,0,2771308
ompRp1,0.3333333333333333,2,2,TGAGGGCTGACGTGTAAAAC,0,2810721
ompRp1,0.3333333333333333,2,2,TGAGCGCCAGGTTCGCACGA,0,2799710
ompRp1,0.3333333333333333,2,2,TGAGACGCATGTGTGCTATT,0,2777270
ompRp1,0.3333333333333333,2,2,TGAGACGCAGACTCTACAGC,0,2824298
ompRp1,0.3333333333333333,2,2,TGAGAACAGATCTCAACGGG,0,2780374
ompRp1,0.3333333333333333,2,2,TGACTGCCGTGTTCGTTTAT,0,2823337
ompRp1,0.3333333333333333,2,2,TGACTCTTACGGGGTAGACA,0,2807593
ompRp1,0.3333333333333333,2,2,TGACGTGCCTCCAGATATGT,0,2819842
ompRp1,0.3333333333333333,2,2,TGACGTGAACCTGGTACAAG,0,2798825
ompRp1,0.3333333333333333,2,2,TGACGGCCTACCAACTCGGT,0,2820791
ompRp1,0.3333333333333333,2,2,TGACCGTCAGGGCTTATAAT,0,2784507
ompRp1,0.3333333333333333,2,2,TGACAGGATGATACCTTAGG,0,2770541
ompRp1,0.3333333333333333,2,2,TGAAGGCAACGGCTTGATTA,0,2785038
ompRp1,0.3333333333333333,2,2,TGAACCGTCGCTAGGGCAAC,0,2774805
ompRp1,0.3333333333333333,2,2,TGAAAAACCGGTGTTGCACA,0,2802084
ompRp1,0.3333333333333333,2,2,TCTTTACTTACATGCTCTTC,0,2798038
ompRp1,0.3333333333333333,2,2,TCTTTAACGATGGCGCTCGG,0,2793929
ompRp1,0.3333333333333333,2,2,TCTTCTTCTGCGCTAATGAA,0,2801694
ompRp1,0.3333333333333333,2,2,TCTTCGCCAGTATCTTCAAC,0,2808279
ompRp1,0.3333333333333333,2,2,TCTTCCTGTGAAAGTAATGC,0,2802235
ompRp1,0.3333333333333333,2,2,TCTTAAGGGGCTAAAGCACT,0,2790654
ompRp1,0.3333333333333333,2,2,TCTGTTTTCATAGTCCAAAT,0,2786547
ompRp1,0.3333333333333333,2,2,TCTGTCAGCATGTGGTTACG,0,2797416
ompRp1,0.3333333333333333,2,2,TCTGGTTTACGATTTCTCGG,0,2785697
ompRp1,0.3333333333333333,2,2,TCTGGTGAGACTGCGAAAGT,0,2779569
ompRp1,0.3333333333333333,2,2,TCTGGCTTCTCACGCCGCCT,0,2777657
ompRp1,0.3333333333333333,2,2,TCTGCGATCCTGTGTACGCC,0,2779676
ompRp1,0.3333333333333333,2,2,TCTGATGGGCTACGTGTGTT,0,2776827
ompRp1,0.3333333333333333,2,2,TCTGAGTATCAAACCTGAAA,0,2809163
ompRp1,0.3333333333333333,2,2,TCTGAGCAAAATTTTAGATC,0,2770103
ompRp1,0.3333333333333333,2,2,TCTCTTACCGAGCAGACCGC,0,2819533
ompRp1,0.3333333333333333,2,2,TCTCTGCCTGGAAGGTTTCG,0,2804228
ompRp1,0.3333333333333333,2,2,TCTCTCCAGGGAGCAGAAAC,0,2817332
ompRp1,0.3333333333333333,2,2,TCTCTACGCGGCAGTGTAAG,0,2816182
ompRp1,0.3333333333333333,2,2,TCTCGTTAGTGAACGTCGTA,0,2774953
ompRp1,0.3333333333333333,2,2,TCTCGTCCGGCCTTGCAATC,0,2777019
ompRp1,0.3333333333333333,2,2,TCTCCGCGTTTTTAGCGTTT,0,2817387
ompRp1,0.3333333333333333,2,2,TCTCCGCCACTAGGGACCTT,0,2775867
ompRp1,0.3333333333333333,2,2,TCTCCCTGAAGTTCGTCCCC,0,2816952
ompRp1,0.3333333333333333,2,2,TCTCCACTTAAGCCTCGGCC,0,2799148
ompRp1,0.3333333333333333,2,2,TCTCAGACAACGGGGCTCAA,0,2823559
ompRp1,0.3333333333333333,2,2,TCTCACTTAGGGATTACATA,0,2809624
ompRp1,0.3333333333333333,2,2,TCTCAATCCGGCAGGCCGAG,0,2774861
ompRp1,0.3333333333333333,2,2,TCTATCCCGGTGGTCGCTTC,0,2810123
ompRp1,0.3333333333333333,2,2,TCTATACGAAATTGTTAACA,0,2809338
ompRp1,0.3333333333333333,2,2,TCTAGGCAAATCTGTTAATA,0,2773649
ompRp1,0.3333333333333333,2,2,TCTAGCGTCCATTACAAATG,0,2807983
ompRp1,0.3333333333333333,2,2,TCTAGAAGCGGAATATAACA,0,2765402
ompRp1,0.3333333333333333,2,2,TCTACTGCCTACGAGCAAAA,0,2813671
ompRp1,0.3333333333333333,2,2,TCTACGCGGCTCCTTTGTGG,0,2787785
ompRp1,0.3333333333333333,2,2,TCTAACAGATCACGCACGAA,0,2772333
ompRp1,0.3333333333333333,2,2,TCTAAAGGCCACGCAGCAAA,0,2794858
ompRp1,0.3333333333333333,2,2,TCTAAAACCGGGCTTCCCGT,0,2769539
ompRp1,0.3333333333333333,2,2,TCGTTTCCACTACCTCGGTT,0,2790131
ompRp1,0.3333333333333333,2,2,TCGTCTTTGACCAGGTAATT,0,2788103
ompRp1,0.3333333333333333,2,2,TCGTCGCTAGATCGGACCGT,0,2780353
ompRp1,0.3333333333333333,2,2,TCGTCCCGAATGTACGATAT,0,2771381
ompRp1,0.3333333333333333,2,2,TCGGTGGGGGCGTGGATACA,0,2789437
ompRp1,0.3333333333333333,2,2,TCGGTCCAAAGTGGAGGGTT,0,2795061
ompRp1,0.3333333333333333,2,2,TCGGGGATCACGCGTTTCAA,0,2794890
ompRp1,0.3333333333333333,2,2,TCGGGCATGGCAGTAGGCTC,0,2790491
ompRp1,0.3333333333333333,2,2,TCGGGATAGATTTTGCTGGG,0,2809084
ompRp1,0.3333333333333333,2,2,TCGGCTACAGACTCTAAAAA,0,2785401
ompRp1,0.3333333333333333,2,2,TCGGCGCGACACGGGCTCCC,0,2806401
ompRp1,0.3333333333333333,2,2,TCGGCCTGCCACTTGCCTCA,0,2821573
ompRp1,0.3333333333333333,2,2,TCGGCCAACATTAAGAAGAG,0,2819495
ompRp1,0.3333333333333333,2,2,TCGGAGCAGCCACCACGTTG,0,2801228
ompRp1,0.3333333333333333,2,2,TCGGACACATGCTCTCTGCC,0,2770042
ompRp1,0.3333333333333333,2,2,TCGGAATAAGTTGGCGTGAC,0,2822508
ompRp1,0.3333333333333333,2,2,TCGCTGACTCTTTTAGATAG,0,2803646
ompRp1,0.3333333333333333,2,2,TCGCTCTGCAGGGGTTTAGT,0,2802414
ompRp1,0.3333333333333333,2,2,TCGCGTAGAGTGATCAGACA,0,2784727
ompRp1,0.3333333333333333,2,2,TCGCGTAATACGAGCCTCCC,0,2767128
ompRp1,0.3333333333333333,2,2,TCGCGGGTTCCCGTATATTT,0,2766667
ompRp1,0.3333333333333333,2,2,TCGCCTCCAGTCTTATAATG,0,2766449
ompRp1,0.3333333333333333,2,2,TCGCCCATTATGACTGTACC,0,2808103
ompRp1,0.3333333333333333,2,2,TCGCCACTAATGTAGTACAC,0,2780433
ompRp1,0.3333333333333333,2,2,TCGCAGACAGGAGGATACTG,0,2809496
ompRp1,0.3333333333333333,2,2,TCGATTACGGAATCTAGCGA,0,2799770
ompRp1,0.3333333333333333,2,2,TCGATGTAGATCGGCTGGCA,0,2789825
ompRp1,0.3333333333333333,2,2,TCGATCGCAACATCTTTAGA,0,2817704
ompRp1,0.3333333333333333,2,2,TCGATATTACGTCTCGTTTT,0,2793934
ompRp1,0.3333333333333333,2,2,TCGACAATCGGCGATCCAAA,0,2767526
ompRp1,0.3333333333333333,2,2,TCGAAGGTATCCCACGCATG,0,2779553
ompRp1,0.3333333333333333,2,2,TCCTTGGCTTCGGTGGTTCA,0,2774081
ompRp1,0.3333333333333333,2,2,TCCTCGTGCTATAGCGTATA,0,2779350
ompRp1,0.3333333333333333,2,2,TCCTCGGGAATCCAGAATTA,0,2817623
ompRp1,0.3333333333333333,2,2,TCCTCCGCAGCCACCGCCAA,0,2818019
ompRp1,0.3333333333333333,2,2,TCCTATCCGCTGAAATTAAT,0,2785484
ompRp1,0.3333333333333333,2,2,TCCTAACCTAAGAACGTCGT,0,2813719
ompRp1,0.3333333333333333,2,2,TCCGTTTCCATTGAAATATT,0,2782830
ompRp1,0.3333333333333333,2,2,TCCGTTCGCTACCTAGTTAA,0,2819776
ompRp1,0.3333333333333333,2,2,TCCGTGCTTTACGCGCGCAA,0,2812962
ompRp1,0.3333333333333333,2,2,TCCGTCAGGGTACCACAGGA,0,2812617
ompRp1,0.3333333333333333,2,2,TCCGGTACGCCCCCGTGTCT,0,2807299
ompRp1,0.3333333333333333,2,2,TCCGGAGTGTACCACCACGT,0,2791773
ompRp1,0.3333333333333333,2,2,TCCGCCGCTCCTGCTAGCTT,0,2787538
ompRp1,0.3333333333333333,2,2,TCCGCCCATCACAAGAGGCT,0,2784761
ompRp1,0.3333333333333333,2,2,TCCGATTTCGTCATCCCTCC,0,2774769
ompRp1,0.3333333333333333,2,2,TCCGATGAGCATTTCGAGGT,0,2791609
ompRp1,0.3333333333333333,2,2,TCCGACGCAACTGGATTCGC,0,2780924
ompRp1,0.3333333333333333,2,2,TCCGAAGCACCAATGGCGCC,0,2803437
ompRp1,0.3333333333333333,2,2,TCCCTACCCACAGCGTGATT,0,2765682
ompRp1,0.3333333333333333,2,2,TCCCGCAAGTGCATAACGCG,0,2812311
ompRp1,0.3333333333333333,2,2,TCCCGAAAAGGTCTGCTATG,0,2810013
ompRp1,0.3333333333333333,2,2,TCCCATGGTCATGCGCGGAG,0,2802535
ompRp1,0.3333333333333333,2,2,TCCCAATACGTCTAACCGCC,0,2782400
ompRp1,0.3333333333333333,2,2,TCCATGTTTAACGCGTATAA,0,2810061
ompRp1,0.3333333333333333,2,2,TCCATCGCAGATGTTGGGAT,0,2811761
ompRp1,0.3333333333333333,2,2,TCCATAGATCATAAGACAAT,0,2823802
ompRp1,0.3333333333333333,2,2,TCCAGTACGGCCCTGTTATA,0,2788325
ompRp1,0.3333333333333333,2,2,TCCAGGTATGTACACGCGTC,0,2804969
ompRp1,0.3333333333333333,2,2,TCCAGCCCCTTATGTATCAC,0,2785467
ompRp1,0.3333333333333333,2,2,TCATGTCTTATTTATCGAGA,0,2796900
ompRp1,0.3333333333333333,2,2,TCATGAACGCATAAAACAAT,0,2790602
ompRp1,0.3333333333333333,2,2,TCATATTGTATACTCTCTTT,0,2817860
ompRp1,0.3333333333333333,2,2,TCAGGTGGCAGGTATCGGGA,0,2821090
ompRp1,0.3333333333333333,2,2,TCAGATTTGTGTTATACGCT,0,2780106
ompRp1,0.3333333333333333,2,2,TCACTCTTCGCACTTACAGT,0,2801554
ompRp1,0.3333333333333333,2,2,TCACGTGGCAATGGCAGCGG,0,2789849
ompRp1,0.3333333333333333,2,2,TCACGGTGACTGCTGGTTCG,0,2821648
ompRp1,0.3333333333333333,2,2,TCACGCCGGGTGTACTATGC,0,2807701
ompRp1,0.3333333333333333,2,2,TCACACTTGGAAACTCGTAT,0,2768049
ompRp1,0.3333333333333333,2,2,TCACACTTGAAGGTACCCTA,0,2782904
ompRp1,0.3333333333333333,2,2,TCAATCACACCAGGGGAAAC,0,2816441
ompRp1,0.3333333333333333,2,2,TCAAGTAAGCCATTACTCTA,0,2798023
ompRp1,0.3333333333333333,2,2,TCAAGGTGCGTTAGGAAGTA,0,2819437
ompRp1,0.3333333333333333,2,2,TCAAGCGTTGCTAACGTACG,0,2814519
ompRp1,0.3333333333333333,2,2,TCAACTGGGCGTTTAAGTAT,0,2803362
ompRp1,0.3333333333333333,2,2,TCAACGGACTGGCGACACAA,0,2810364
ompRp1,0.3333333333333333,2,2,TCAACATAAATCTAAAAAAT,0,2770914
ompRp1,0.3333333333333333,2,2,TCAACAGAAGTCTGCGATGC,0,2815076
ompRp1,0.3333333333333333,2,2,TCAAACTAGGATCTAGAGAT,0,2795059
ompRp1,0.3333333333333333,2,2,TCAAACACCTGATACCAAGA,0,2814334
ompRp1,0.3333333333333333,2,2,TCAAAAATTCTTACCTTCAA,0,2805320
ompRp1,0.3333333333333333,2,2,TATTTTCATCGAGGGCCAGA,0,2779352
ompRp1,0.3333333333333333,2,2,TATTTGGTTCGGAGACCTTG,0,2773898
ompRp1,0.3333333333333333,2,2,TATTTCGGCAATTTAAGCTC,0,2783436
ompRp1,0.3333333333333333,2,2,TATTTCGAGCGACCCGGCAC,0,2793466
ompRp1,0.3333333333333333,2,2,TATTTAATCCACACCATTAG,0,2766328
ompRp1,0.3333333333333333,2,2,TATTGCCGATCCTTTAGTCA,0,2816433
ompRp1,0.3333333333333333,2,2,TATTGATTGCGCGGATAAAT,0,2778736
ompRp1,0.3333333333333333,2,2,TATTGATGTCCTAAACAGGG,0,2793856
ompRp1,0.3333333333333333,2,2,TATTGAGACGCTCGTATATA,0,2817128
ompRp1,0.3333333333333333,2,2,TATTGAAGCGCGGTGTGCTA,0,2793978
ompRp1,0.3333333333333333,2,2,TATTGAAACGCCGTTTAGTC,0,2782086
ompRp1,0.3333333333333333,2,2,TATTCGCGAGGCCACATCGC,0,2808269
ompRp1,0.3333333333333333,2,2,TATTAGGACCGCGAAACCTT,0,2805160
ompRp1,0.3333333333333333,2,2,TATTACCTTTCTATTGCATG,0,2811299
ompRp1,0.3333333333333333,2,2,TATTAAACTTGGCTCAAAAC,0,2812317
ompRp1,0.3333333333333333,2,2,TATTAAAATAGTTAATTCGC,0,2773579
ompRp1,0.3333333333333333,2,2,TATGTTTCGTGCTGGGGTGT,0,2770732
ompRp1,0.3333333333333333,2,2,TATGTTCTCCGTCCGCCGAC,0,2770379
ompRp1,0.3333333333333333,2,2,TATGTCTATCGAGTAGTGAG,0,2812672
ompRp1,0.3333333333333333,2,2,TATGTCCACCCTAGCACTCA,0,2787667
ompRp1,0.3333333333333333,2,2,TATGGTCATCTACGGGGGAC,0,2808303
ompRp1,0.3333333333333333,2,2,TATGGTAGAGCTGTTGAGGG,0,2775617
ompRp1,0.3333333333333333,2,2,TATGGATCACTTCTCTGGTT,0,2769485
ompRp1,0.3333333333333333,2,2,TATGGAAAAGCTTGCACGAA,0,2815404
ompRp1,0.3333333333333333,2,2,TATGCTACACTGTAGCGTAT,0,2783110
ompRp1,0.3333333333333333,2,2,TATGCCCGGGAGCCCAGATT,0,2775805
ompRp1,0.3333333333333333,2,2,TATGAGTTTGGTCATTTCGA,0,2784162
ompRp1,0.3333333333333333,2,2,TATGAAGTGCGCCATAAAAT,0,2818701
ompRp1,0.3333333333333333,2,2,TATCTTACACGCTCTCCCAG,0,2797242
ompRp1,0.3333333333333333,2,2,TATCGATCGCTTCGGCAGGT,0,2796481
ompRp1,0.3333333333333333,2,2,TATCCTTTGACACTCTAGAC,0,2810081
ompRp1,0.3333333333333333,2,2,TATCCGTAAGTCATAGGGAG,0,2780323
ompRp1,0.3333333333333333,2,2,TATCCGGGGGGTTAGGTGAG,0,2801448
ompRp1,0.3333333333333333,2,2,TATACTCGATATTTGGGTCA,0,2818484
ompRp1,0.3333333333333333,2,2,TATACCACTTTGAATTCCTT,0,2820737
ompRp1,0.3333333333333333,2,2,TATAATAAGTACTCTAGCCA,0,2770699
ompRp1,0.3333333333333333,2,2,TATAAGTTGCAACGATCCAA,0,2796267
ompRp1,0.3333333333333333,2,2,TATAACGGCGGGATTTCTGG,0,2796848
ompRp1,0.3333333333333333,2,2,TATAAATGTCGTTCTCGCGC,0,2774877
ompRp1,0.3333333333333333,2,2,TATAAAATCGTGAGGGGTAG,0,2823754
ompRp1,0.3333333333333333,2,2,TAGTCTTGGGACAGGGGTGT,0,2804455
ompRp1,0.3333333333333333,2,2,TAGGTTGCGTGTAGGAGTCG,0,2809625
ompRp1,0.3333333333333333,2,2,TAGGTGAGGTAAAGACCTGG,0,2810641
ompRp1,0.3333333333333333,2,2,TAGGTGAACGGTTGCGGCGA,0,2822223
ompRp1,0.3333333333333333,2,2,TAGGTATGCGGAGATCAAAG,0,2792232
ompRp1,0.3333333333333333,2,2,TAGGGTTTCTGGCATCATTG,0,2769332
ompRp1,0.3333333333333333,2,2,TAGGGGTTTTGTTGGAAGTT,0,2810742
ompRp1,0.3333333333333333,2,2,TAGGGGGTCGCTGGAGATCC,0,2813774
ompRp1,0.3333333333333333,2,2,TAGGGCAGAAAGTGTTAGAT,0,2808220
ompRp1,0.3333333333333333,2,2,TAGGACTTGCACGGACCCGA,0,2771318
ompRp1,0.3333333333333333,2,2,TAGGACAATTAATCGCAATG,0,2805996
ompRp1,0.3333333333333333,2,2,TAGCTTCCGGAGTTTTTGCC,0,2795964
ompRp1,0.3333333333333333,2,2,TAGCTTCACATCGTGGGCTA,0,2768191
ompRp1,0.3333333333333333,2,2,TAGCTGTGCAGCCCGCGAAT,0,2767335
ompRp1,0.3333333333333333,2,2,TAGCTCAGTGCTTGCAGGAA,0,2771422
ompRp1,0.3333333333333333,2,2,TAGCTATAGTTTATTTCTAA,0,2818598
ompRp1,0.3333333333333333,2,2,TAGCGGCATGCTTCTAAAAA,0,2773177
ompRp1,0.3333333333333333,2,2,TAGCCGGAGGGACCGTAGCA,0,2767430
ompRp1,0.3333333333333333,2,2,TAGCAAACACTATATGCGTC,0,2801329
ompRp1,0.3333333333333333,2,2,TAGATTATCGTGTGAGGACA,0,2822579
ompRp1,0.3333333333333333,2,2,TAGATGGTGGGCTGAATATG,0,2785319
ompRp1,0.3333333333333333,2,2,TAGATATGTACGATTGTATA,0,2796394
ompRp1,0.3333333333333333,2,2,TAGAGTCTTATTAGGCGATA,0,2778777
ompRp1,0.3333333333333333,2,2,TAGAGCAGTTACTGGGCGCT,0,2769820
ompRp1,0.3333333333333333,2,2,TAGAGATCCTGAATGCACGC,0,2820361
ompRp1,0.3333333333333333,2,2,TAGAAGCCGAATAACATTCC,0,2778181
ompRp1,0.3333333333333333,2,2,TAGAACTCGCGGGGCGTGCA,0,2823058
ompRp1,0.3333333333333333,2,2,TAGAAAGCAAGCGCCGACTG,0,2822974
ompRp1,0.3333333333333333,2,2,TACTTGGTTTAATAAGTTTA,0,2802602
ompRp1,0.3333333333333333,2,2,TACTTCGTAGGGTCAGATTA,0,2822315
ompRp1,0.3333333333333333,2,2,TACTTCAGTGTGCTTATGTC,0,2820539
ompRp1,0.3333333333333333,2,2,TACTTAGACTAGGCGCTTTG,0,2789877
ompRp1,0.3333333333333333,2,2,TACTGTCGGGAGCATAGCCT,0,2822490
ompRp1,0.3333333333333333,2,2,TACTGTCGAGGGAAATACGC,0,2786631
ompRp1,0.3333333333333333,2,2,TACTAGGCATATACATTCCA,0,2808108
ompRp1,0.3333333333333333,2,2,TACTAGACCATAGGTGGACG,0,2772433
ompRp1,0.3333333333333333,2,2,TACTAAAGTAAGAGGTGGGA,0,2807139
ompRp1,0.3333333333333333,2,2,TACGTTTACCAATTGTTATG,0,2808930
ompRp1,0.3333333333333333,2,2,TACGTCTTGCTGCGCTTAAT,0,2774037
ompRp1,0.3333333333333333,2,2,TACGCTATTGCTCCCCCCTC,0,2792976
ompRp1,0.3333333333333333,2,2,TACGCGCTTCCTCGGCAATT,0,2817801
ompRp1,0.3333333333333333,2,2,TACGCCAGAATCGGTACCGA,0,2784382
ompRp1,0.3333333333333333,2,2,TACGCATGAAAGAGACGGCG,0,2781087
ompRp1,0.3333333333333333,2,2,TACGCAACTTTCGAGACACG,0,2794688
ompRp1,0.3333333333333333,2,2,TACGAGGATTGGCATCCGAA,0,2812670
ompRp1,0.3333333333333333,2,2,TACCTTGCTGGGCCCCTGGT,0,2790989
ompRp1,0.3333333333333333,2,2,TACCTTAACCGAGTGACGCT,0,2795415
ompRp1,0.3333333333333333,2,2,TACCTCAATTAACGCTGCAA,0,2823723
ompRp1,0.3333333333333333,2,2,TACCTAAACCTTAAGGACGG,0,2816948
ompRp1,0.3333333333333333,2,2,TACCGGAGCGTTACAGGGAC,0,2784327
ompRp1,0.3333333333333333,2,2,TACCGCTCGTCCTAAAGGAC,0,2793111
ompRp1,0.3333333333333333,2,2,TACCCCGAGGGTGTCTGCTA,0,2783858
ompRp1,0.3333333333333333,2,2,TACCAGGTTTGGCGGGGCCT,0,2821669
ompRp1,0.3333333333333333,2,2,TACCACCATCTATTAAGCGC,0,2799844
ompRp1,0.3333333333333333,2,2,TACCAATGGACTGTCACACT,0,2794622
ompRp1,0.3333333333333333,2,2,TACATTTCAGGTGGAAGCCT,0,2816057
ompRp1,0.3333333333333333,2,2,TACATTGTGAATACGTGGCT,0,2813742
ompRp1,0.3333333333333333,2,2,TACATTCCGAACCGTTAGAA,0,2784234
ompRp1,0.3333333333333333,2,2,TACAGGCGCATATGGTCTAT,0,2782853
ompRp1,0.3333333333333333,2,2,TACAGCGCTGTATTTGGCGC,0,2783287
ompRp1,0.3333333333333333,2,2,TACAATGCCAATACCGTTGG,0,2790607
ompRp1,0.3333333333333333,2,2,TACAAAGTTATAATGCAAAA,0,2797249
ompRp1,0.3333333333333333,2,2,TAATTTATCCTGGGGCAGAG,0,2804291
ompRp1,0.3333333333333333,2,2,TAATTCTGACGCCACTTCTT,0,2803092
ompRp1,0.3333333333333333,2,2,TAATTATCCGGAGCTCCATG,0,2798506
ompRp1,0.3333333333333333,2,2,TAATTAAACGTCCGAGACAA,0,2780377
ompRp1,0.3333333333333333,2,2,TAATGTGGGTCATTTCGACA,0,2789156
ompRp1,0.3333333333333333,2,2,TAATGTCGGTAGCGTGATAC,0,2823330
ompRp1,0.3333333333333333,2,2,TAATGGAGTTCTCGTCCCGC,0,2804246
ompRp1,0.3333333333333333,2,2,TAATGCTTTGTTAGCGTTGT,0,2795739
ompRp1,0.3333333333333333,2,2,TAATCTCGATGTGCAGTTCC,0,2813553
ompRp1,0.3333333333333333,2,2,TAATCTATAATACCGTTACT,0,2808021
ompRp1,0.3333333333333333,2,2,TAATATGAATGGATAATTAC,0,2777702
ompRp1,0.3333333333333333,2,2,TAATAGATGAGCCGCGATCG,0,2797174
ompRp1,0.3333333333333333,2,2,TAAGGTCTCACTTTTTCCAT,0,2803243
ompRp1,0.3333333333333333,2,2,TAACTAACCTCTAGTCTATA,0,2821152
ompRp1,0.3333333333333333,2,2,TAACGTGACGATGCAAGTAT,0,2802945
ompRp1,0.3333333333333333,2,2,TAACGATAGAACAATATGTT,0,2821671
ompRp1,0.3333333333333333,2,2,TAACGAGGTACAGGTGAGAT,0,2817190
ompRp1,0.3333333333333333,2,2,TAACCTCCGACATATACAAT,0,2783612
ompRp1,0.3333333333333333,2,2,TAACCGTCGGATTATAGTGG,0,2805592
ompRp1,0.3333333333333333,2,2,TAAAGGACTAAGAATATTAC,0,2802321
ompRp1,0.3333333333333333,2,2,TAAAGCTGTTGGCAATTCAC,0,2784885
ompRp1,0.3333333333333333,2,2,TAAACGTAAGATGACCCGGC,0,2815042
ompRp1,0.3333333333333333,2,2,TAAACCGCTCGACAACGGCT,0,2778861
ompRp1,0.3333333333333333,2,2,TAAAATCTAAGGTCGAAATA,0,2816502
ompRp1,0.3333333333333333,2,2,TAAAATCGCATGAACAATTA,0,2816440
ompRp1,0.3333333333333333,2,2,TAAAATAACTCGTAGGTAAA,0,2787836
ompRp1,0.3333333333333333,2,2,TAAAAGGAATACGCACTCGA,0,2767512
ompRp1,0.3333333333333333,2,2,GTTTTTGTACTGGCATAACA,0,2768309
ompRp1,0.3333333333333333,2,2,GTTTTCCTGGTACCCTGATC,0,2823743
ompRp1,0.3333333333333333,2,2,GTTTGGAGCTGGTCTGATGT,0,2770787
ompRp1,0.3333333333333333,2,2,GTTTGGAAGATAGCGCGAGT,0,2801548
ompRp1,0.3333333333333333,2,2,GTTTGCTGCTCCTACGACGT,0,2803041
ompRp1,0.3333333333333333,2,2,GTTTGCGCAGAGTGATGGTT,0,2783466
ompRp1,0.3333333333333333,2,2,GTTTCGAAATATGACACGAT,0,2793704
ompRp1,0.3333333333333333,2,2,GTTTCCCCGCAAGTCCACGT,0,2769884
ompRp1,0.3333333333333333,2,2,GTTTCAGTAATACGGATGTT,0,2786699
ompRp1,0.3333333333333333,2,2,GTTGTATACCTAGGGATAAG,0,2778518
ompRp1,0.3333333333333333,2,2,GTTGGTTCATTCACGCCCCG,0,2810395
ompRp1,0.3333333333333333,2,2,GTTGGTCACGTCGTCCTTCA,0,2766689
ompRp1,0.3333333333333333,2,2,GTTGGGGGGATCGCAGCAGA,0,2774446
ompRp1,0.3333333333333333,2,2,GTTGGGAATAGAACACTATA,0,2776673
ompRp1,0.3333333333333333,2,2,GTTGCAAGAGATAAGTGTGA,0,2811074
ompRp1,0.3333333333333333,2,2,GTTGAATAAGAGCGAGGGTG,0,2775559
ompRp1,0.3333333333333333,2,2,GTTGAAAACGGAATACCGTT,0,2797643
ompRp1,0.3333333333333333,2,2,GTTCGTTGGTGAAGGCATAT,0,2801563
ompRp1,0.3333333333333333,2,2,GTTCGCGCCCGTCGCGATGA,0,2791472
ompRp1,0.3333333333333333,2,2,GTTCCGAGTTACGGGTCGTC,0,2821150
ompRp1,0.3333333333333333,2,2,GTTCACGATGCAACCCACTG,0,2765560
ompRp1,0.3333333333333333,2,2,GTTATTTGCAAGAACGAATA,0,2813411
ompRp1,0.3333333333333333,2,2,GTTATTTGAGGACTTACCCA,0,2768050
ompRp1,0.3333333333333333,2,2,GTTATTGATTTACCCACCAT,0,2779673
ompRp1,0.3333333333333333,2,2,GTTATACCAAACCAGCCAAC,0,2771542
ompRp1,0.3333333333333333,2,2,GTTATACAGATCTCCTTTCT,0,2777370
ompRp1,0.3333333333333333,2,2,GTTAGCTTCTGACCGTACAT,0,2767291
ompRp1,0.3333333333333333,2,2,GTTAGCCATTACCGATCGCC,0,2784239
ompRp1,0.3333333333333333,2,2,GTTAGAGCAGCACGGTCTAC,0,2792615
ompRp1,0.3333333333333333,2,2,GTTACTTCACACGCATCCAG,0,2766610
ompRp1,0.3333333333333333,2,2,GTTACTCGGGAATTACAGAA,0,2805022
ompRp1,0.3333333333333333,2,2,GTTACGTCGGGGTCCCGGCT,0,2798358
ompRp1,0.3333333333333333,2,2,GTTACCAACAAATCGGGGCT,0,2798097
ompRp1,0.3333333333333333,2,2,GTTACATAGACATCTGAAAC,0,2806310
ompRp1,0.3333333333333333,2,2,GTTAATACGATAGTGTGCAA,0,2769216
ompRp1,0.3333333333333333,2,2,GTTAAGAGTCAAAGTTGCAA,0,2777186
ompRp1,0.3333333333333333,2,2,GTTAACGTGATACTGCGCTT,0,2796322
ompRp1,0.3333333333333333,2,2,GTGTTCATTCTTGTGCTGGT,0,2789794
ompRp1,0.3333333333333333,2,2,GTGTGGCGGATAAAAAGACG,0,2770123
ompRp1,0.3333333333333333,2,2,GTGTGCTTCTCACAGCCGGT,0,2798491
ompRp1,0.3333333333333333,2,2,GTGTGAGTTAACATTAGCTC,0,2781031
ompRp1,0.3333333333333333,2,2,GTGTGACGGGTTTTGCAGCT,0,2800344
ompRp1,0.3333333333333333,2,2,GTGTCGAATCGAACGAGGCG,0,2788538
ompRp1,0.3333333333333333,2,2,GTGGTATAGGGTAAGTAGGG,0,2806605
ompRp1,0.3333333333333333,2,2,GTGGGTGCGCTTGCACGGGC,0,2804262
ompRp1,0.3333333333333333,2,2,GTGGGTCTGCGTATTCCGAG,0,2769124
ompRp1,0.3333333333333333,2,2,GTGGGGGCGTCACGCCCCAC,0,2822942
ompRp1,0.3333333333333333,2,2,GTGGGGCGAGAGCATGACAA,0,2804668
ompRp1,0.3333333333333333,2,2,GTGGGGAGTCGTAAACTCTG,0,2801877
ompRp1,0.3333333333333333,2,2,GTGGGGAACCGCCGTTAGTG,0,2775604
ompRp1,0.3333333333333333,2,2,GTGGGCTCAAGCGACGTATT,0,2807472
ompRp1,0.3333333333333333,2,2,GTGGGAAGGTCGAGAGGAGG,0,2810053
ompRp1,0.3333333333333333,2,2,GTGGGAACACGGGCTGGCTG,0,2771163
ompRp1,0.3333333333333333,2,2,GTGGCTTGCTTCTGGTCGAT,0,2817143
ompRp1,0.3333333333333333,2,2,GTGGCTATGCCCCTGAGGCC,0,2780356
ompRp1,0.3333333333333333,2,2,GTGGCCTCGTGTGCAAACTA,0,2793235
ompRp1,0.3333333333333333,2,2,GTGGCCTCAAGCCTGGATTT,0,2786441
ompRp1,0.3333333333333333,2,2,GTGGCCTAAGAAGCGATTGA,0,2809399
ompRp1,0.3333333333333333,2,2,GTGGAACATTTGAAGGGGGG,0,2776182
ompRp1,0.3333333333333333,2,2,GTGCTTTTATGACCCCTTAT,0,2783670
ompRp1,0.3333333333333333,2,2,GTGCTTCTACCATCTCAACA,0,2779678
ompRp1,0.3333333333333333,2,2,GTGCGGTCTCAAAGAGCGGC,0,2788191
ompRp1,0.3333333333333333,2,2,GTGCGCGGAATAGAGCGAAG,0,2783852
ompRp1,0.3333333333333333,2,2,GTGCGAAATTGAGTAAAATC,0,2772063
ompRp1,0.3333333333333333,2,2,GTGCCTGTGGTCCGTAAAAG,0,2778653
ompRp1,0.3333333333333333,2,2,GTGCCGAGTGCCCATCAGCT,0,2772389
ompRp1,0.3333333333333333,2,2,GTGCCCGTTTGATTTGTTTA,0,2809823
ompRp1,0.3333333333333333,2,2,GTGCCACTGGCAGTTCGTTT,0,2773089
ompRp1,0.3333333333333333,2,2,GTGCCAAAGCCACCCCGGTC,0,2778889
ompRp1,0.3333333333333333,2,2,GTGATAGCAACATTCGGTGA,0,2782461
ompRp1,0.3333333333333333,2,2,GTGAGCTAAGGAAGTGTATC,0,2777627
ompRp1,0.3333333333333333,2,2,GTGAGCCACCTTAAAATTAT,0,2780105
ompRp1,0.3333333333333333,2,2,GTGAGATACAATACGGTAGG,0,2795260
ompRp1,0.3333333333333333,2,2,GTGACAGTATGCGGTTACTA,0,2797165
ompRp1,0.3333333333333333,2,2,GTGAATTAACCGGGTACTTT,0,2775369
ompRp1,0.3333333333333333,2,2,GTGAACTCTGTATATGTCTG,0,2783187
ompRp1,0.3333333333333333,2,2,GTCTTTGGTGTCAGTAGATT,0,2772331
ompRp1,0.3333333333333333,2,2,GTCTTGGTGTGTCTGGACAG,0,2789809
ompRp1,0.3333333333333333,2,2,GTCTTGCACGTTCGTCTAGA,0,2789266
ompRp1,0.3333333333333333,2,2,GTCTTCCAATCGCGGGGTAA,0,2766240
ompRp1,0.3333333333333333,2,2,GTCTTCAGGGTAGTAGAAGC,0,2823157
ompRp1,0.3333333333333333,2,2,GTCTCTATATGAGGTCTGAT,0,2776922
ompRp1,0.3333333333333333,2,2,GTCTCCTTGCCCTATCGGTA,0,2790798
ompRp1,0.3333333333333333,2,2,GTCTCAGCGTTGCATGCTAC,0,2803769
ompRp1,0.3333333333333333,2,2,GTCTAGAAGTGACAGCGAGG,0,2816538
ompRp1,0.3333333333333333,2,2,GTCTAAGGCTCGCGGATGGA,0,2778245
ompRp1,0.3333333333333333,2,2,GTCTAAGCAATGTGTCGCCG,0,2781634
ompRp1,0.3333333333333333,2,2,GTCGCAGGCAATCCCGGCTC,0,2798787
ompRp1,0.3333333333333333,2,2,GTCGCACAGTAGCCGCTATT,0,2799137
ompRp1,0.3333333333333333,2,2,GTCGATTCCGATATCAAAGG,0,2807471
ompRp1,0.3333333333333333,2,2,GTCGATCGATCTAAAAAATA,0,2797637
ompRp1,0.3333333333333333,2,2,GTCGAGCTAGTAATTCAGCT,0,2824106
ompRp1,0.3333333333333333,2,2,GTCGAAGCCAACGCTTGTTA,0,2777774
ompRp1,0.3333333333333333,2,2,GTCGAAGACTCGTTAGAGAT,0,2797745
ompRp1,0.3333333333333333,2,2,GTCGAACAGCAGCTGTTTCA,0,2768202
ompRp1,0.3333333333333333,2,2,GTCCGTGCATACAAATCGGT,0,2781336
ompRp1,0.3333333333333333,2,2,GTCCCTGAGAAAGGCGCGAG,0,2774717
ompRp1,0.3333333333333333,2,2,GTCCCTACCGGCGACAGGTA,0,2783083
ompRp1,0.3333333333333333,2,2,GTCCAGAATGTAGTTACGCT,0,2807437
ompRp1,0.3333333333333333,2,2,GTCCAACAAGACCCCTGTGC,0,2797261
ompRp1,0.3333333333333333,2,2,GTCCAAAATTTTTCTTTCAT,0,2809257
ompRp1,0.3333333333333333,2,2,GTCATTGACGGGCCATCTTG,0,2799506
ompRp1,0.3333333333333333,2,2,GTCAGTATTAGCAAAAAACC,0,2775865
ompRp1,0.3333333333333333,2,2,GTCAGTAACTATATACTAAC,0,2782521
ompRp1,0.3333333333333333,2,2,GTCAGCATAGGTGGCTTAGG,0,2810243
ompRp1,0.3333333333333333,2,2,GTCAGAGTCATAGTTGGGAT,0,2797838
ompRp1,0.3333333333333333,2,2,GTCAATGGCCAGAGTAGGTA,0,2771246
ompRp1,0.3333333333333333,2,2,GTCAATCTTGCGCATCCACG,0,2804592
ompRp1,0.3333333333333333,2,2,GTCAAGCATATCGATACATT,0,2783091
ompRp1,0.3333333333333333,2,2,GTCAAACATCCGGTACTGAA,0,2801315
ompRp1,0.3333333333333333,2,2,GTATTACGTCGTCAGACAGC,0,2812189
ompRp1,0.3333333333333333,2,2,GTATTAAAAACTCGATGTAT,0,2796473
ompRp1,0.3333333333333333,2,2,GTATGTGCTTCTAGTCCTCA,0,2819864
ompRp1,0.3333333333333333,2,2,GTATGGTAGGGGCTCCCGTC,0,2794034
ompRp1,0.3333333333333333,2,2,GTATCTACTAAGGATGAATC,0,2797765
ompRp1,0.3333333333333333,2,2,GTATATCCATTTGTTTGGTT,0,2809827
ompRp1,0.3333333333333333,2,2,GTATATAGCGTTTCGTTGAG,0,2802595
ompRp1,0.3333333333333333,2,2,GTATAGAGTTACAACCAGGG,0,2798955
ompRp1,0.3333333333333333,2,2,GTATACTGAAAATGGGGTGT,0,2766006
ompRp1,0.3333333333333333,2,2,GTATACGACGTACACTCTCT,0,2770350
ompRp1,0.3333333333333333,2,2,GTATAAATAAGTGCGCCTAG,0,2775397
ompRp1,0.3333333333333333,2,2,GTAGGGATTATCCTTTGAAA,0,2792670
ompRp1,0.3333333333333333,2,2,GTAGGCCGTGGCACCGAGCA,0,2782133
ompRp1,0.3333333333333333,2,2,GTAGGCATCCGCATTGAACC,0,2801686
ompRp1,0.3333333333333333,2,2,GTAGCTGACCACCCTGGTCA,0,2772687
ompRp1,0.3333333333333333,2,2,GTAGAGGCGTGCCAACGCTC,0,2809661
ompRp1,0.3333333333333333,2,2,GTAGAGCCACAAGCTTGTCC,0,2780221
ompRp1,0.3333333333333333,2,2,GTACGTGGATTTGGCATTAG,0,2814270
ompRp1,0.3333333333333333,2,2,GTACGGAGGTCTCCACTTGT,0,2772237
ompRp1,0.3333333333333333,2,2,GTACGATATAGTGGAAACTT,0,2773706
ompRp1,0.3333333333333333,2,2,GTACCTGTTCGTTTGCTGAC,0,2783740
ompRp1,0.3333333333333333,2,2,GTACCACGATCTGAGTGATG,0,2796778
ompRp1,0.3333333333333333,2,2,GTACACCGCCTAACCAGCGA,0,2787620
ompRp1,0.3333333333333333,2,2,GTAATCTACTTCGGTTGAGG,0,2777601
ompRp1,0.3333333333333333,2,2,GTAATCGGCCGGTGGACAAT,0,2811059
ompRp1,0.3333333333333333,2,2,GTAAGTGCTGCCTGTTTACC,0,2801762
ompRp1,0.3333333333333333,2,2,GTAACGGGGGAGGGTCATCC,0,2802584
ompRp1,0.3333333333333333,2,2,GTAACGGACGCAAGACCTAA,0,2781926
ompRp1,0.3333333333333333,2,2,GTAAAGGGTCCACCGCTTAT,0,2820644
ompRp1,0.3333333333333333,2,2,GTAAACGTGTATAGAGATTA,0,2779227
ompRp1,0.3333333333333333,2,2,GTAAACACAACAACTCTAAA,0,2789468
ompRp1,0.3333333333333333,2,2,GTAAACAATCACTTTGGTAG,0,2768655
ompRp1,0.3333333333333333,2,2,GTAAAAAAACTGTATGCTTT,0,2823812
ompRp1,0.3333333333333333,2,2,GGTTGTGGTGGCGCTAACTA,0,2770540
ompRp1,0.3333333333333333,2,2,GGTTGTGGGAGGACATCAAA,0,2819991
ompRp1,0.3333333333333333,2,2,GGTTCCTTCTTTCGCTCTGA,0,2787056
ompRp1,0.3333333333333333,2,2,GGTTCCGGTTATTTCGAACA,0,2791234
ompRp1,0.3333333333333333,2,2,GGTTCCAGCGGGTAGGTGGA,0,2777722
ompRp1,0.3333333333333333,2,2,GGTTCAGGGATCCAAAAGTG,0,2820462
ompRp1,0.3333333333333333,2,2,GGTTAGGGGCCGGTGGTCCC,0,2785834
ompRp1,0.3333333333333333,2,2,GGTGTTTTGAATTTCGGATG,0,2822147
ompRp1,0.3333333333333333,2,2,GGTGTCGGCAATATTTGGCG,0,2778964
ompRp1,0.3333333333333333,2,2,GGTGTCGCCGCTGACAATCT,0,2809135
ompRp1,0.3333333333333333,2,2,GGTGGGGCAACACGTCAAAC,0,2797403
ompRp1,0.3333333333333333,2,2,GGTGGGCCGACCTTCCCGTC,0,2816821
ompRp1,0.3333333333333333,2,2,GGTGGATGTTCCACAACCGT,0,2802384
ompRp1,0.3333333333333333,2,2,GGTGGACTAAGGCTTCGTGG,0,2808827
ompRp1,0.3333333333333333,2,2,GGTGATCATTGGCGCAGCTC,0,2781948
ompRp1,0.3333333333333333,2,2,GGTGAGCATCCCGGCAGCAA,0,2771786
ompRp1,0.3333333333333333,2,2,GGTCTGCCGGGATTAGACCC,0,2815254
ompRp1,0.3333333333333333,2,2,GGTCTCAGTTGCCCCAGAGA,0,2793783
ompRp1,0.3333333333333333,2,2,GGTCGTGGAGCAATCGTGAT,0,2798696
ompRp1,0.3333333333333333,2,2,GGTCGCCCATTAATGCTCTA,0,2792683
ompRp1,0.3333333333333333,2,2,GGTCGCACGGAATAGTAGCG,0,2771114
ompRp1,0.3333333333333333,2,2,GGTCACGTGGTAGGAATGTT,0,2794605
ompRp1,0.3333333333333333,2,2,GGTCAACCGTGGGAGGATGT,0,2820227
ompRp1,0.3333333333333333,2,2,GGTATAGACAGGGAGATACA,0,2818884
ompRp1,0.3333333333333333,2,2,GGTACTTGCTTGCTTAGACG,0,2818865
ompRp1,0.3333333333333333,2,2,GGTACAGCAACCTGTCAAGG,0,2790593
ompRp1,0.3333333333333333,2,2,GGTAACACTAGGCACCAGGC,0,2811310
ompRp1,0.3333333333333333,2,2,GGGTTTGTGTCGCCAGCCTG,0,2791706
ompRp1,0.3333333333333333,2,2,GGGTTTGAGATAGGGTTGAG,0,2790085
ompRp1,0.3333333333333333,2,2,GGGTTGCGCACCACTATCCA,0,2792780
ompRp1,0.3333333333333333,2,2,GGGTTAGCGTCATCCGACGT,0,2824477
ompRp1,0.3333333333333333,2,2,GGGTGTTTTACCCATCAAAG,0,2792816
ompRp1,0.3333333333333333,2,2,GGGTGATGAATTCGATAACT,0,2793920
ompRp1,0.3333333333333333,2,2,GGGTCTGTCTGGTAGGGCAA,0,2768536
ompRp1,0.3333333333333333,2,2,GGGTCTAAAGAAGGTGTGCG,0,2800969
ompRp1,0.3333333333333333,2,2,GGGTCGCAGAACGGCGGATT,0,2795787
ompRp1,0.3333333333333333,2,2,GGGTCCACATTCGCTAGATG,0,2820348
ompRp1,0.3333333333333333,2,2,GGGTCAGCATTCCGAGTTGA,0,2765977
ompRp1,0.3333333333333333,2,2,GGGTATCACGCCATATAGTT,0,2772434
ompRp1,0.3333333333333333,2,2,GGGTAGCCCGACTGTAGACA,0,2823339
ompRp1,0.3333333333333333,2,2,GGGGTTTGACTTGTTAATTT,0,2799590
ompRp1,0.3333333333333333,2,2,GGGGTGTCGCGGACGACAAC,0,2770184
ompRp1,0.3333333333333333,2,2,GGGGTCGATCTCACCGTTAG,0,2791048
ompRp1,0.3333333333333333,2,2,GGGGGGCAGGTTGGGCTAAT,0,2781954
ompRp1,0.3333333333333333,2,2,GGGGGCTCGGGTCACTAAAT,0,2809237
ompRp1,0.3333333333333333,2,2,GGGGCGGATGGGTTTAGAAA,0,2813150
ompRp1,0.3333333333333333,2,2,GGGGCATTCTACGCTGAGTT,0,2786831
ompRp1,0.3333333333333333,2,2,GGGGCATGGCCGAAGCTACA,0,2768759
ompRp1,0.3333333333333333,2,2,GGGGATTGAGTGTGAGTAGT,0,2819400
ompRp1,0.3333333333333333,2,2,GGGGAGTGCACCAATCGGCG,0,2782694
ompRp1,0.3333333333333333,2,2,GGGGAATCAAGTGAATTCGA,0,2811300
ompRp1,0.3333333333333333,2,2,GGGGAATACCTGCAGATCTA,0,2802129
ompRp1,0.3333333333333333,2,2,GGGCTTAGGTTATGCCTTAT,0,2803396
ompRp1,0.3333333333333333,2,2,GGGCTGGGCCAATAACCCTT,0,2813205
ompRp1,0.3333333333333333,2,2,GGGCGCATGCGGTCTGGACA,0,2798795
ompRp1,0.3333333333333333,2,2,GGGCGAAACGTCGGTGGTTT,0,2815602
ompRp1,0.3333333333333333,2,2,GGGCCTCAACAGATCCCTCT,0,2766305
ompRp1,0.3333333333333333,2,2,GGGCCGACTAATTTCACGCA,0,2796853
ompRp1,0.3333333333333333,2,2,GGGCCACTACGTTGTATACC,0,2785933
ompRp1,0.3333333333333333,2,2,GGGCCACCCTATTTACTGTA,0,2778684
ompRp1,0.3333333333333333,2,2,GGGCCACAGTTGATCTGACT,0,2786080
ompRp1,0.3333333333333333,2,2,GGGCAGCAGTGTAAGGCCAT,0,2801996
ompRp1,0.3333333333333333,2,2,GGGCAACATTCGCTAACCCG,0,2801685
ompRp1,0.3333333333333333,2,2,GGGCAAAATAATCTGGTAAG,0,2797047
ompRp1,0.3333333333333333,2,2,GGGATTTCCGTCGTCCATGC,0,2790418
ompRp1,0.3333333333333333,2,2,GGGATCGTAAGCGACGATGT,0,2794329
ompRp1,0.3333333333333333,2,2,GGGAGGGGCCGTTAAAGGTG,0,2796188
ompRp1,0.3333333333333333,2,2,GGGAGAACCCAGATGCTCCC,0,2799897
ompRp1,0.3333333333333333,2,2,GGGACTTATAAATGTCAATC,0,2777752
ompRp1,0.3333333333333333,2,2,GGGACGGTAGAATTGAAAGT,0,2802423
ompRp1,0.3333333333333333,2,2,GGGACGCATGGTCCGTCAAC,0,2795995
ompRp1,0.3333333333333333,2,2,GGGAATCCGGAGTACAGTTT,0,2795815
ompRp1,0.3333333333333333,2,2,GGGAAGCGCGGCACATAAAC,0,2811071
ompRp1,0.3333333333333333,2,2,GGGAACGCGGGCAAGGAGGT,0,2779696
ompRp1,0.3333333333333333,2,2,GGGAACGACGCTGGCGAGAT,0,2772542
ompRp1,0.3333333333333333,2,2,GGCTTTATGGTTGCCGCGTT,0,2777080
ompRp1,0.3333333333333333,2,2,GGCTTTAAAGACTAGGCATG,0,2804789
ompRp1,0.3333333333333333,2,2,GGCTTCATTTGTCTGACGAT,0,2794554
ompRp1,0.3333333333333333,2,2,GGCTAACTTGTGTATGTCAC,0,2776777
ompRp1,0.3333333333333333,2,2,GGCGTTCTCTCGGAACATGA,0,2820899
ompRp1,0.3333333333333333,2,2,GGCGTTACTCATTTTACCCA,0,2793932
ompRp1,0.3333333333333333,2,2,GGCGTGCCATTGAGTGAGTG,0,2788865
ompRp1,0.3333333333333333,2,2,GGCGTCAACGTAGCGATTCT,0,2803584
ompRp1,0.3333333333333333,2,2,GGCGGCGCTGACCTAACGCG,0,2815959
ompRp1,0.3333333333333333,2,2,GGCGGCGATTAGGCCGGTTA,0,2768638
ompRp1,0.3333333333333333,2,2,GGCGCTGTGTAATTTTGTCA,0,2766458
ompRp1,0.3333333333333333,2,2,GGCGACAGGATAATGGTTAC,0,2770311
ompRp1,0.3333333333333333,2,2,GGCCTCCCTAACTGCCTCGG,0,2783028
ompRp1,0.3333333333333333,2,2,GGCCTAGGAGCGACTTAAAC,0,2811450
ompRp1,0.3333333333333333,2,2,GGCCCTCAGATATGCATAAA,0,2807765
ompRp1,0.3333333333333333,2,2,GGCCCTACAGCTCTTTTTAT,0,2803616
ompRp1,0.3333333333333333,2,2,GGCCCGATAAATCGATGTAG,0,2772050
ompRp1,0.3333333333333333,2,2,GGCCCCTCACATCTGGGACT,0,2783758
ompRp1,0.3333333333333333,2,2,GGCCCACGGTATCGGAGTTC,0,2780993
ompRp1,0.3333333333333333,2,2,GGCCATTGTTCAATACAGAG,0,2776495
ompRp1,0.3333333333333333,2,2,GGCCAGTTGTAGATCGGAAC,0,2806793
ompRp1,0.3333333333333333,2,2,GGCATTGGATCAGTGTTAGA,0,2797752
ompRp1,0.3333333333333333,2,2,GGCATTGCACCACTCTATCC,0,2779281
ompRp1,0.3333333333333333,2,2,GGCAGGTACGGCAGGAAAGT,0,2819401
ompRp1,0.3333333333333333,2,2,GGCAGGGTACAGCTGAGGTA,0,2787387
ompRp1,0.3333333333333333,2,2,GGCAGGGCTGCCCGGGGGAT,0,2796302
ompRp1,0.3333333333333333,2,2,GGCAGGCCACTGGCTGAGGC,0,2773436
ompRp1,0.3333333333333333,2,2,GGCAGGACAGAGGTGGACCT,0,2799712
ompRp1,0.3333333333333333,2,2,GGCAGATTTTCGACTAAAAT,0,2770839
ompRp1,0.3333333333333333,2,2,GGCACTGGTTAACTTCCCGG,0,2777371
ompRp1,0.3333333333333333,2,2,GGCACGACTCAGGTCGCGAT,0,2816019
ompRp1,0.3333333333333333,2,2,GGCACCTCGTCGGTCTTATG,0,2768335
ompRp1,0.3333333333333333,2,2,GGCACAGGTTCTTGGTATCG,0,2781281
ompRp1,0.3333333333333333,2,2,GGCACAACGGTACTGATAAA,0,2783133
ompRp1,0.3333333333333333,2,2,GGCAATCGCGGTGCCAAGTC,0,2787891
ompRp1,0.3333333333333333,2,2,GGATTGTATCTTAAAGTAGA,0,2791443
ompRp1,0.3333333333333333,2,2,GGATTGGGAGATGGATTCTA,0,2767323
ompRp1,0.3333333333333333,2,2,GGATTAAACACTCGAGCTGA,0,2823957
ompRp1,0.3333333333333333,2,2,GGATGGAGTTAGGGGTCCCT,0,2799113
ompRp1,0.3333333333333333,2,2,GGATATGGAACTGTCCGGCA,0,2791115
ompRp1,0.3333333333333333,2,2,GGATATCCCTCACGGCGGTT,0,2772852
ompRp1,0.3333333333333333,2,2,GGATATCCCTACCCCTTTTG,0,2781446
ompRp1,0.3333333333333333,2,2,GGATAGCTAGTTCGTACGGC,0,2790991
ompRp1,0.3333333333333333,2,2,GGAGTTTTCGGATTAGCTTA,0,2782553
ompRp1,0.3333333333333333,2,2,GGAGTTAGCAACACGACGAT,0,2793648
ompRp1,0.3333333333333333,2,2,GGAGTAAACAATTGAGCACA,0,2799493
ompRp1,0.3333333333333333,2,2,GGAGGTCCCATACGCTAAAC,0,2801306
ompRp1,0.3333333333333333,2,2,GGAGGACGTGGTATCTAGGC,0,2809310
ompRp1,0.3333333333333333,2,2,GGAGCTGGCGGCGGAAAAAA,0,2815657
ompRp1,0.3333333333333333,2,2,GGAGCGGGTTCTTTCAATGT,0,2795306
ompRp1,0.3333333333333333,2,2,GGAGCCTCCGCGACGATACC,0,2820231
ompRp1,0.3333333333333333,2,2,GGACGTCAGGGAAATGGTGT,0,2822100
ompRp1,0.3333333333333333,2,2,GGACGGTACCATAGGCCTGG,0,2766543
ompRp1,0.3333333333333333,2,2,GGACGCCTCCACCTAGCCGG,0,2824257
ompRp1,0.3333333333333333,2,2,GGACGCCCCGCTTTTGGTAA,0,2789478
ompRp1,0.3333333333333333,2,2,GGACGACCCAAATTCCCTGC,0,2801695
ompRp1,0.3333333333333333,2,2,GGACCAGAGCATAGCTCCGT,0,2795454
ompRp1,0.3333333333333333,2,2,GGACATACTCCTCAGGACCC,0,2795878
ompRp1,0.3333333333333333,2,2,GGACACTACGCATGTAAATT,0,2806399
ompRp1,0.3333333333333333,2,2,GGACACATGATGGGAACGGA,0,2778683
ompRp1,0.3333333333333333,2,2,GGACACACGGTGGGTCTGCG,0,2808012
ompRp1,0.3333333333333333,2,2,GGAATTCGGTTCGTGATTTA,0,2814033
ompRp1,0.3333333333333333,2,2,GGAAGGGGCGCGCTAGCGCA,0,2778856
ompRp1,0.3333333333333333,2,2,GGAAGGGGATTACCATTGGC,0,2798211
ompRp1,0.3333333333333333,2,2,GGAACGGACATGGCGATATA,0,2801560
ompRp1,0.3333333333333333,2,2,GGAACACATTGGGGGCAAAG,0,2799499
ompRp1,0.3333333333333333,2,2,GGAACAAAGTCGGGCGAGCA,0,2766664
ompRp1,0.3333333333333333,2,2,GGAAAAGGCAGTCAAACGGG,0,2803192
ompRp1,0.3333333333333333,2,2,GCTTTGCAGCTTGTCAATAC,0,2788680
ompRp1,0.3333333333333333,2,2,GCTTTCGCAGCCAAGTTGAT,0,2805638
ompRp1,0.3333333333333333,2,2,GCTTTAACAGTATTCCTCTG,0,2783718
ompRp1,0.3333333333333333,2,2,GCTTGGGGAATCGGGGTCAA,0,2821596
ompRp1,0.3333333333333333,2,2,GCTTCTTCTGGAGCCGTATG,0,2823770
ompRp1,0.3333333333333333,2,2,GCTTCGGCAGCAGACACAAT,0,2802677
ompRp1,0.3333333333333333,2,2,GCTTCGATCGGCTTGCCACG,0,2821206
ompRp1,0.3333333333333333,2,2,GCTTCCTTGTAGCGTAGTGT,0,2787038
ompRp1,0.3333333333333333,2,2,GCTTCCCCCGACGGACATGG,0,2792833
ompRp1,0.3333333333333333,2,2,GCTTCACATCGAGAGAAAGA,0,2813032
ompRp1,0.3333333333333333,2,2,GCTGTGACAGTGGTTACGTG,0,2779590
ompRp1,0.3333333333333333,2,2,GCTGTACGGTTATTGGCCAT,0,2772154
ompRp1,0.3333333333333333,2,2,GCTGGTCGGCCGACTATTTT,0,2820071
ompRp1,0.3333333333333333,2,2,GCTGGACGGTTAATATAATC,0,2797995
ompRp1,0.3333333333333333,2,2,GCTGCCCCCGGTTGGTGAAA,0,2782096
ompRp1,0.3333333333333333,2,2,GCTGATGCACGCCTCGACTC,0,2777868
ompRp1,0.3333333333333333,2,2,GCTGATCGGAGTCATCAAGC,0,2805740
ompRp1,0.3333333333333333,2,2,GCTCTTTAACTGGAAATACG,0,2802329
ompRp1,0.3333333333333333,2,2,GCTCTGCCAGCTTCGGCGCG,0,2816524
ompRp1,0.3333333333333333,2,2,GCTCTACCGCGGCCTGTATG,0,2766446
ompRp1,0.3333333333333333,2,2,GCTCGGACGCGCTCATGGTG,0,2780966
ompRp1,0.3333333333333333,2,2,GCTCGCGGTGGATTTAACCT,0,2771597
ompRp1,0.3333333333333333,2,2,GCTCCCTTTTATATACAGCA,0,2789146
ompRp1,0.3333333333333333,2,2,GCTCAGGCTGGCGCCGTGCT,0,2779299
ompRp1,0.3333333333333333,2,2,GCTCAAGACCGTACTTCGAG,0,2778882
ompRp1,0.3333333333333333,2,2,GCTCAACGACGGGCGGTAAT,0,2768099
ompRp1,0.3333333333333333,2,2,GCTATCTTAAGCTGCGCCAA,0,2790133
ompRp1,0.3333333333333333,2,2,GCTATCAATCTAATGATTGA,0,2787185
ompRp1,0.3333333333333333,2,2,GCTATATGGACCCATTGGTA,0,2797025
ompRp1,0.3333333333333333,2,2,GCTATAAGCCTGGACACGAA,0,2819332
ompRp1,0.3333333333333333,2,2,GCTAGCGGTGCGCTAGTCGG,0,2783755
ompRp1,0.3333333333333333,2,2,GCTACGAACTTACATCGTCT,0,2791884
ompRp1,0.3333333333333333,2,2,GCGTTGGCTATCGAGCTGGG,0,2820540
ompRp1,0.3333333333333333,2,2,GCGTTACGCGGACGTGAAAG,0,2811539
ompRp1,0.3333333333333333,2,2,GCGTCTTCTTTGCAGAACAT,0,2820000
ompRp1,0.3333333333333333,2,2,GCGTCTACGGGGATTCGAAG,0,2767216
ompRp1,0.3333333333333333,2,2,GCGTATTCACGAGGTCCCAT,0,2776810
ompRp1,0.3333333333333333,2,2,GCGTATCTATTTCTTACCGT,0,2796782
ompRp1,0.3333333333333333,2,2,GCGGTCCTGATGCCCGCATA,0,2811083
ompRp1,0.3333333333333333,2,2,GCGGTCCCAAGCAGATGGAA,0,2799018
ompRp1,0.3333333333333333,2,2,GCGGCTTCGGGCGGATTTTC,0,2821503
ompRp1,0.3333333333333333,2,2,GCGGCGATGGTGAACTGTTA,0,2811722
ompRp1,0.3333333333333333,2,2,GCGGCCCCCGAAAGTCGCTG,0,2784122
ompRp1,0.3333333333333333,2,2,GCGGCAGGGAACCTGAATGA,0,2795361
ompRp1,0.3333333333333333,2,2,GCGGAGAGACTCAATGGAAG,0,2819036
ompRp1,0.3333333333333333,2,2,GCGGAATGCGCGAGGCTTGG,0,2812203
ompRp1,0.3333333333333333,2,2,GCGCTCGTGGATACACGTGA,0,2781930
ompRp1,0.3333333333333333,2,2,GCGCTCCGAAACCAGGTTGG,0,2777735
ompRp1,0.3333333333333333,2,2,GCGCTATGGTCGTTACCCGC,0,2794119
ompRp1,0.3333333333333333,2,2,GCGCGGGCAGGCCAAACTCT,0,2782970
ompRp1,0.3333333333333333,2,2,GCGCGAGGAACGTATATATC,0,2789013
ompRp1,0.3333333333333333,2,2,GCGCCCCAAGGAATGCCAAC,0,2774985
ompRp1,0.3333333333333333,2,2,GCGCCCAATTAAGAAAAGTA,0,2778571
ompRp1,0.3333333333333333,2,2,GCGCAGTCCACTCACGAAGC,0,2814306
ompRp1,0.3333333333333333,2,2,GCGCAGACATGACCGTAGGA,0,2793177
ompRp1,0.3333333333333333,2,2,GCGCACTCTATGGTACTTGA,0,2820670
ompRp1,0.3333333333333333,2,2,GCGATTGCGGGTACGAGCGC,0,2814031
ompRp1,0.3333333333333333,2,2,GCGATCACGTGTTGCCATCG,0,2772585
ompRp1,0.3333333333333333,2,2,GCGAGCGACCCAGTCAGGGG,0,2816987
ompRp1,0.3333333333333333,2,2,GCGACTCTGTGTGTCGCGCA,0,2817442
ompRp1,0.3333333333333333,2,2,GCGACTCGGCTTTAGGTAGG,0,2816279
ompRp1,0.3333333333333333,2,2,GCGACGCCTAAGTGCTGTGT,0,2788477
ompRp1,0.3333333333333333,2,2,GCGACGAAAACACTACGGCA,0,2783747
ompRp1,0.3333333333333333,2,2,GCGAAGGCTTGTCGAATGGT,0,2796754
ompRp1,0.3333333333333333,2,2,GCCTTTCGGCTGCCTTGACA,0,2766859
ompRp1,0.3333333333333333,2,2,GCCTTTATAGAATGTTTCTA,0,2809093
ompRp1,0.3333333333333333,2,2,GCCTTGCCCATATTTTAAAC,0,2783889
ompRp1,0.3333333333333333,2,2,GCCTTCGTACGCAGGTTCAT,0,2813344
ompRp1,0.3333333333333333,2,2,GCCTGTAGACAGCAAGGTCA,0,2802763
ompRp1,0.3333333333333333,2,2,GCCTGTAAACTAGGAATATA,0,2812235
ompRp1,0.3333333333333333,2,2,GCCTGCTCATAGAGCGAAGT,0,2809912
ompRp1,0.3333333333333333,2,2,GCCTCTGGTATCAGAGCTGG,0,2773345
ompRp1,0.3333333333333333,2,2,GCCTCTATTAGGGTACCTCC,0,2816635
ompRp1,0.3333333333333333,2,2,GCCTCAGCCTTTACCCTAGG,0,2771769
ompRp1,0.3333333333333333,2,2,GCCTATTCGTCCCTTGTCAA,0,2812815
ompRp1,0.3333333333333333,2,2,GCCTAGAGAAGACTGAAACA,0,2779792
ompRp1,0.3333333333333333,2,2,GCCGTTACGGGTGCCACTTG,0,2798271
ompRp1,0.3333333333333333,2,2,GCCGTCCACATTAGCTCGTT,0,2823084
ompRp1,0.3333333333333333,2,2,GCCGGGGGCCTTCATCCAAC,0,2791330
ompRp1,0.3333333333333333,2,2,GCCGGAGTAAACGTGTTTAT,0,2783645
ompRp1,0.3333333333333333,2,2,GCCGCTTTCTGCTAAAGTGT,0,2786484
ompRp1,0.3333333333333333,2,2,GCCGCCGAATTCGTCCTGTA,0,2821569
ompRp1,0.3333333333333333,2,2,GCCGCCATCAATGGATTCAT,0,2768711
ompRp1,0.3333333333333333,2,2,GCCGAGACCACGGCGTTTAT,0,2773219
ompRp1,0.3333333333333333,2,2,GCCGAATTGCAACTCGAAAT,0,2768878
ompRp1,0.3333333333333333,2,2,GCCCTGTCTCACTAGGATTT,0,2817702
ompRp1,0.3333333333333333,2,2,GCCCTAGTGTACGTGAGTAC,0,2795693
ompRp1,0.3333333333333333,2,2,GCCCGGCGCGATGAGTCATA,0,2800206
ompRp1,0.3333333333333333,2,2,GCCCGAGAGTCGCAGATGTG,0,2805452
ompRp1,0.3333333333333333,2,2,GCCCCTCGTTTCCAATTTCA,0,2771127
ompRp1,0.3333333333333333,2,2,GCCCCCTAGTCCTACCGGTG,0,2776251
ompRp1,0.3333333333333333,2,2,GCCCATCGGCCTAGGAACGC,0,2805171
ompRp1,0.3333333333333333,2,2,GCCCAGATAGCGTGCCGAAA,0,2823249
ompRp1,0.3333333333333333,2,2,GCCCACGACGCAATAAAGGG,0,2801803
ompRp1,0.3333333333333333,2,2,GCCATTTTAACGGAAAGCGG,0,2765541
ompRp1,0.3333333333333333,2,2,GCCATGTATAATGGGACCTA,0,2780723
ompRp1,0.3333333333333333,2,2,GCCAGCCTCGTATCACGGCT,0,2809635
ompRp1,0.3333333333333333,2,2,GCCACGGCACATCGGTCAAC,0,2799850
ompRp1,0.3333333333333333,2,2,GCCACGCGGCCCGTCCCGCT,0,2788293
ompRp1,0.3333333333333333,2,2,GCCACGCGGACCGTACCCTC,0,2796258
ompRp1,0.3333333333333333,2,2,GCCAATCACGTCTAATAGAA,0,2790845
ompRp1,0.3333333333333333,2,2,GCATTTAGCGTATGACCGCT,0,2802313
ompRp1,0.3333333333333333,2,2,GCATTAAATAGCGGAGTTTC,0,2776685
ompRp1,0.3333333333333333,2,2,GCATGAGCCTCACTCCTGTA,0,2780146
ompRp1,0.3333333333333333,2,2,GCATCGACGTCATATGGGGA,0,2801617
ompRp1,0.3333333333333333,2,2,GCATATGCTCACCAATTATT,0,2779441
ompRp1,0.3333333333333333,2,2,GCAGTTAGGAGGTTCGGCAA,0,2794635
ompRp1,0.3333333333333333,2,2,GCAGTGTACAGACCAGCCCA,0,2797629
ompRp1,0.3333333333333333,2,2,GCAGGGTTCAGATCTCACTG,0,2814467
ompRp1,0.3333333333333333,2,2,GCAGCCGTTACGTTTGGGAT,0,2807842
ompRp1,0.3333333333333333,2,2,GCAGCCGCTGAGGCCTATTT,0,2810040
ompRp1,0.3333333333333333,2,2,GCAGAGATCATTATCTGATC,0,2792960
ompRp1,0.3333333333333333,2,2,GCAGACCCAAGTGTGGTAAC,0,2819878
ompRp1,0.3333333333333333,2,2,GCACTGGTACGGAACTACAC,0,2770651
ompRp1,0.3333333333333333,2,2,GCACGTGCCATGCTTGAAAA,0,2769634
ompRp1,0.3333333333333333,2,2,GCACGTAGAGCCGGGGCCAA,0,2800062
ompRp1,0.3333333333333333,2,2,GCACGAACCCGTCCCGAGGG,0,2790528
ompRp1,0.3333333333333333,2,2,GCACCAAGACTTACCTATCA,0,2783936
ompRp1,0.3333333333333333,2,2,GCACACCCACCCGTTGACTC,0,2810903
ompRp1,0.3333333333333333,2,2,GCAAGCGTTAACATCCCCTC,0,2788295
ompRp1,0.3333333333333333,2,2,GCAACGACCGAGGTTTAGCG,0,2771733
ompRp1,0.3333333333333333,2,2,GCAACAAATTCACGACAACA,0,2775108
ompRp1,0.3333333333333333,2,2,GATTTTAGATCACAAATAGA,0,2821050
ompRp1,0.3333333333333333,2,2,GATTTAAGCGTGTTATTAGG,0,2796788
ompRp1,0.3333333333333333,2,2,GATTGGTGCAGAGCAACCCC,0,2803190
ompRp1,0.3333333333333333,2,2,GATTGGGACGGGGCGAGGTA,0,2816634
ompRp1,0.3333333333333333,2,2,GATTCGACATTCGCATGCTA,0,2767925
ompRp1,0.3333333333333333,2,2,GATTCCTCATGCTAAAGTCT,0,2815209
ompRp1,0.3333333333333333,2,2,GATTCATTACACGCTGGCGT,0,2769760
ompRp1,0.3333333333333333,2,2,GATTCATGACACCCTTGAGT,0,2808610
ompRp1,0.3333333333333333,2,2,GATTCATGAAGTTCCTGTAT,0,2815165
ompRp1,0.3333333333333333,2,2,GATTAACATGCGCAATTGGG,0,2802881
ompRp1,0.3333333333333333,2,2,GATGGGCAGCCCAATCGCAT,0,2790730
ompRp1,0.3333333333333333,2,2,GATGGCCTTTTACGCTCGAC,0,2766923
ompRp1,0.3333333333333333,2,2,GATGCTCGACTTATTGTTGT,0,2772411
ompRp1,0.3333333333333333,2,2,GATGCCAACTCGATCTTTGT,0,2792515
ompRp1,0.3333333333333333,2,2,GATGAGTCATGGGGCAACGG,0,2820530
ompRp1,0.3333333333333333,2,2,GATCTTTTGCTTAGCTAAAG,0,2790632
ompRp1,0.3333333333333333,2,2,GATCTTGGTTAAGGCATTAT,0,2796080
ompRp1,0.3333333333333333,2,2,GATCTTACTGCGTTCGGTTG,0,2774554
ompRp1,0.3333333333333333,2,2,GATCGGAAATCGTAATATTT,0,2823865
ompRp1,0.3333333333333333,2,2,GATCGCTGGCATTGTTGAGA,0,2787273
ompRp1,0.3333333333333333,2,2,GATCGAACACCGTTAATTCA,0,2821867
ompRp1,0.3333333333333333,2,2,GATCCTTAGCTGACCACCAA,0,2791169
ompRp1,0.3333333333333333,2,2,GATCCATTCATCTTCTTCTA,0,2798669
ompRp1,0.3333333333333333,2,2,GATCCATGAGATGTTCTTAA,0,2765734
ompRp1,0.3333333333333333,2,2,GATCCACAATGAAGATCGCT,0,2805814
ompRp1,0.3333333333333333,2,2,GATCAGGGATAAAGGCCGCG,0,2808262
ompRp1,0.3333333333333333,2,2,GATATGGGTGGGCTTACGGG,0,2781763
ompRp1,0.3333333333333333,2,2,GATAGGGTTATTTCGTGGCT,0,2823255
ompRp1,0.3333333333333333,2,2,GATAGATACTCCTGGGACAC,0,2774928
ompRp1,0.3333333333333333,2,2,GATACGCTAGGGAGGGCCTG,0,2784816
ompRp1,0.3333333333333333,2,2,GATACCTACGCCGCTCTGAT,0,2817020
ompRp1,0.3333333333333333,2,2,GATACATACGCTTGCGACCA,0,2766233
ompRp1,0.3333333333333333,2,2,GATAATTGAGGACGGGTGTT,0,2800035
ompRp1,0.3333333333333333,2,2,GATAAGTTTGCTTTTAAAAT,0,2821770
ompRp1,0.3333333333333333,2,2,GATAAGTACATAAATAAAGG,0,2808985
ompRp1,0.3333333333333333,2,2,GATAAGACATGGAAAGGTCG,0,2780228
ompRp1,0.3333333333333333,2,2,GATAACACTTCTGGACTTCA,0,2793104
ompRp1,0.3333333333333333,2,2,GATAAAGATCCAGGGGCTGC,0,2802380
ompRp1,0.3333333333333333,2,2,GAGTTTCAGGCACGTGCCAC,0,2821130
ompRp1,0.3333333333333333,2,2,GAGTTCGGCTTCCCGTCTGA,0,2818526
ompRp1,0.3333333333333333,2,2,GAGTGTCATCTTGCCGTGCA,0,2778323
ompRp1,0.3333333333333333,2,2,GAGTGGTGCCATCCATAACG,0,2808180
ompRp1,0.3333333333333333,2,2,GAGTGGCCCGTCCAGTTAGG,0,2777762
ompRp1,0.3333333333333333,2,2,GAGTCCGCCAAATTCGGTGG,0,2817916
ompRp1,0.3333333333333333,2,2,GAGGTCCGATGGATTTTGCT,0,2771344
ompRp1,0.3333333333333333,2,2,GAGGGTTATAGGTTTTTTCA,0,2809956
ompRp1,0.3333333333333333,2,2,GAGGGTCCAGTTGCGTCGGT,0,2793637
ompRp1,0.3333333333333333,2,2,GAGGGGGGCTTAAGAAAATA,0,2785869
ompRp1,0.3333333333333333,2,2,GAGGGGGGCCAATGAAATAT,0,2770549
ompRp1,0.3333333333333333,2,2,GAGGGCGCACACAGCTCTTC,0,2784540
ompRp1,0.3333333333333333,2,2,GAGGCTAAGGAGTAGCAGAT,0,2824134
ompRp1,0.3333333333333333,2,2,GAGGCACATAAAGTGCCATT,0,2795563
ompRp1,0.3333333333333333,2,2,GAGCTTTCTCATGTGTAGTC,0,2774347
ompRp1,0.3333333333333333,2,2,GAGCTCGATTGGAAGCGGTA,0,2800968
ompRp1,0.3333333333333333,2,2,GAGCTATGCGCTTTGGGACC,0,2776492
ompRp1,0.3333333333333333,2,2,GAGCTATACTCGCAACTCCC,0,2778732
ompRp1,0.3333333333333333,2,2,GAGCGTAGGGCCTCAGGAGC,0,2809217
ompRp1,0.3333333333333333,2,2,GAGCGGCTGACTCCAATACC,0,2766724
ompRp1,0.3333333333333333,2,2,GAGCGCAGGTCTAATACCCA,0,2780333
ompRp1,0.3333333333333333,2,2,GAGCGAAGTCCGTGTGGCAA,0,2788104
ompRp1,0.3333333333333333,2,2,GAGCCTTCGATCGATAAGGG,0,2787008
ompRp1,0.3333333333333333,2,2,GAGCCGAGGTGCCCGCCGTT,0,2802678
ompRp1,0.3333333333333333,2,2,GAGCATTAAAGATCTCGATT,0,2797247
ompRp1,0.3333333333333333,2,2,GAGCAGGGCCTATAATCTGA,0,2774265
ompRp1,0.3333333333333333,2,2,GAGCAGCGTTTAGTATGATT,0,2821486
ompRp1,0.3333333333333333,2,2,GAGCAGCGCCGGCAGCGACC,0,2775007
ompRp1,0.3333333333333333,2,2,GAGCACAGAGATTCACTTCG,0,2814458
ompRp1,0.3333333333333333,2,2,GAGCAACGCGTACAGTGGAA,0,2768992
ompRp1,0.3333333333333333,2,2,GAGATCTGGTTGTGGAAATA,0,2800138
ompRp1,0.3333333333333333,2,2,GAGAGGGTTGAAAATAGCAA,0,2780533
ompRp1,0.3333333333333333,2,2,GAGAGCATGGAGAAGCACCC,0,2777089
ompRp1,0.3333333333333333,2,2,GAGACTATATTGCTAACGGT,0,2779194
ompRp1,0.3333333333333333,2,2,GAGACGCTACGAAAATATAT,0,2802436
ompRp1,0.3333333333333333,2,2,GAGAAATCGCAAATTGAAAC,0,2794787
ompRp1,0.3333333333333333,2,2,GACTTTTCTCCCTGGTTGAC,0,2765354
ompRp1,0.3333333333333333,2,2,GACTTAACCATTGATTACCC,0,2800588
ompRp1,0.3333333333333333,2,2,GACTCTGGTATTATCCAGGA,0,2781494
ompRp1,0.3333333333333333,2,2,GACTCTCGCGTTGCCCTGTC,0,2782043
ompRp1,0.3333333333333333,2,2,GACTCACAAAACGGCGTGCA,0,2819210
ompRp1,0.3333333333333333,2,2,GACTACGTCGCAGGTTGATT,0,2790570
ompRp1,0.3333333333333333,2,2,GACTAAGATTCGCTGGTAGA,0,2820676
ompRp1,0.3333333333333333,2,2,GACGATCATGTCTCATCCTT,0,2801169
ompRp1,0.3333333333333333,2,2,GACGAGTGAATTCCATCAGT,0,2781810
ompRp1,0.3333333333333333,2,2,GACGAGAACAGTCACGTTGC,0,2765476
ompRp1,0.3333333333333333,2,2,GACCTTTTTTGAAGTGAGAA,0,2812116
ompRp1,0.3333333333333333,2,2,GACCTTTGGCGACATGGCTT,0,2803935
ompRp1,0.3333333333333333,2,2,GACCTCAGTGACCGAGCCGC,0,2819077
ompRp1,0.3333333333333333,2,2,GACCGGTAGGGACACTTGTT,0,2767297
ompRp1,0.3333333333333333,2,2,GACCGACCTTTAGCGTTCCC,0,2781042
ompRp1,0.3333333333333333,2,2,GACCCAGCATTAAATGATTC,0,2820613
ompRp1,0.3333333333333333,2,2,GACCACTTGCAGACGTCCAG,0,2814857
ompRp1,0.3333333333333333,2,2,GACATTGCGCATAGTAGGAT,0,2782531
ompRp1,0.3333333333333333,2,2,GACAGGAGCATTCTACTCAA,0,2771178
ompRp1,0.3333333333333333,2,2,GACAGACTTTTTGAAAACGC,0,2791155
ompRp1,0.3333333333333333,2,2,GACACGAATCATGTTAGTAC,0,2787515
ompRp1,0.3333333333333333,2,2,GACAACATAGTTTGCCGTTG,0,2767739
ompRp1,0.3333333333333333,2,2,GAATTGTGTACTCAGCGCGT,0,2766169
ompRp1,0.3333333333333333,2,2,GAATTCGCTGGGCGCAAGGC,0,2794134
ompRp1,0.3333333333333333,2,2,GAATTACACTATGTCGTGCG,0,2778949
ompRp1,0.3333333333333333,2,2,GAATGGTAAGTAACGCGTTA,0,2818479
ompRp1,0.3333333333333333,2,2,GAATCTGACGATCGGTAAGG,0,2789134
ompRp1,0.3333333333333333,2,2,GAATCCGTAACTAAAAGGAA,0,2781147
ompRp1,0.3333333333333333,2,2,GAATCCGGAGTACAGATGAG,0,2813600
ompRp1,0.3333333333333333,2,2,GAATAAGCAATCCGGGTTGG,0,2812821
ompRp1,0.3333333333333333,2,2,GAATAAATAGGGATGCGGAC,0,2799650
ompRp1,0.3333333333333333,2,2,GAAGTGGATCTTTGACTCCT,0,2787286
ompRp1,0.3333333333333333,2,2,GAAGGCAATAGTTATTAGGA,0,2811126
ompRp1,0.3333333333333333,2,2,GAAGCGGTAAGCATTGATGA,0,2808948
ompRp1,0.3333333333333333,2,2,GAAGCGGCTTTTGGTTGGTG,0,2813434
ompRp1,0.3333333333333333,2,2,GAAGATCTTCACGTTTTATG,0,2798689
ompRp1,0.3333333333333333,2,2,GAAGACTATACTTCATTCCC,0,2788385
ompRp1,0.3333333333333333,2,2,GAACTCTAACTCCCGGTGCA,0,2773755
ompRp1,0.3333333333333333,2,2,GAACTCGTATTAGCATCAAG,0,2785866
ompRp1,0.3333333333333333,2,2,GAACCTCTGTGAGAGAGCTT,0,2816125
ompRp1,0.3333333333333333,2,2,GAACATCCCCGAACGCCGGC,0,2793748
ompRp1,0.3333333333333333,2,2,GAACACAGGTTGTATTAGTC,0,2807354
ompRp1,0.3333333333333333,2,2,GAAAGTGTCTCGTTCGCGAA,0,2786099
ompRp1,0.3333333333333333,2,2,GAAAGTGGTAAATGTTACGA,0,2824099
ompRp1,0.3333333333333333,2,2,GAAAGTAGTAACCGTGTGCC,0,2770048
ompRp1,0.3333333333333333,2,2,GAAAGGCGTTAAAGGCAATA,0,2823428
ompRp1,0.3333333333333333,2,2,GAAAGCTCTTTTCTATTATA,0,2791913
ompRp1,0.3333333333333333,2,2,GAAAGCGTGTGGGCACTTGT,0,2792429
ompRp1,0.3333333333333333,2,2,GAAACGGCACGTTCGGAGCT,0,2816614
ompRp1,0.3333333333333333,2,2,GAAAAGAAGAGAGAGCCCTT,0,2821084
ompRp1,0.3333333333333333,2,2,CTTTTACCAAAGGGAGTAAC,0,2820862
ompRp1,0.3333333333333333,2,2,CTTTTAAACGTGTGACGAGC,0,2776536
ompRp1,0.3333333333333333,2,2,CTTTCTCATCATCGTTCGCA,0,2781449
ompRp1,0.3333333333333333,2,2,CTTTATGAACAGTGGGAACG,0,2810254
ompRp1,0.3333333333333333,2,2,CTTTAGACAACTGTTCGTGC,0,2768040
ompRp1,0.3333333333333333,2,2,CTTTACCGGCCCCAGTCCAA,0,2812858
ompRp1,0.3333333333333333,2,2,CTTGTTTAACTTCGAGCAGA,0,2812633
ompRp1,0.3333333333333333,2,2,CTTGTGTCTATATAGGGTGA,0,2791842
ompRp1,0.3333333333333333,2,2,CTTGTACGGACTCTTGCTTG,0,2775577
ompRp1,0.3333333333333333,2,2,CTTGGGTATCTTGATAGAGA,0,2804716
ompRp1,0.3333333333333333,2,2,CTTGGCTTCGGAAGGAAGTT,0,2817185
ompRp1,0.3333333333333333,2,2,CTTGCGCATGTCGAATGCGC,0,2817282
ompRp1,0.3333333333333333,2,2,CTTGATGATCGCCGCGAATT,0,2788444
ompRp1,0.3333333333333333,2,2,CTTGAATGAGGTCTGTTTTC,0,2823362
ompRp1,0.3333333333333333,2,2,CTTGAAACCTTACTAGACTG,0,2773753
ompRp1,0.3333333333333333,2,2,CTTCTCCTCTAACATATATC,0,2788783
ompRp1,0.3333333333333333,2,2,CTTCTCCCCTACGCTTAGGT,0,2776627
ompRp1,0.3333333333333333,2,2,CTTCTATCAACGCTAAGACT,0,2793007
ompRp1,0.3333333333333333,2,2,CTTCGTCCCGTTATTAGATC,0,2792418
ompRp1,0.3333333333333333,2,2,CTTCGCACCCCGCGAGACGG,0,2771890
ompRp1,0.3333333333333333,2,2,CTTCCTTCAGATTTATTCGA,0,2788925
ompRp1,0.3333333333333333,2,2,CTTCCAGTGCACGCTGTGAT,0,2775682
ompRp1,0.3333333333333333,2,2,CTTCCAGATAGATTCGGCTG,0,2779699
ompRp1,0.3333333333333333,2,2,CTTCAAAAGTAGTTGGCTCA,0,2816630
ompRp1,0.3333333333333333,2,2,CTTATCCGACGACTTAGATA,0,2793884
ompRp1,0.3333333333333333,2,2,CTTAGTCTGTAATGCAAGTT,0,2785778
ompRp1,0.3333333333333333,2,2,CTTACTGGTCAACCGTTATG,0,2785907
ompRp1,0.3333333333333333,2,2,CTTACAAACCCCAGAATGAG,0,2767071
ompRp1,0.3333333333333333,2,2,CTTAACTGGCGGCCATAGCG,0,2770219
ompRp1,0.3333333333333333,2,2,CTGTTGCGAGTTTTCAGATA,0,2799667
ompRp1,0.3333333333333333,2,2,CTGTTCGCACCGTCTCAACA,0,2789241
ompRp1,0.3333333333333333,2,2,CTGTTCCGTCAGATGCGACA,0,2769165
ompRp1,0.3333333333333333,2,2,CTGTGGGGAAGACATCAGAC,0,2819522
ompRp1,0.3333333333333333,2,2,CTGTGCGATACGGCATACTC,0,2771433
ompRp1,0.3333333333333333,2,2,CTGTGAGCGCCCTGCCGGTA,0,2804757
ompRp1,0.3333333333333333,2,2,CTGTCTATCACTACTGTAAG,0,2794872
ompRp1,0.3333333333333333,2,2,CTGTCGCTCCGTCCATCTGT,0,2778163
ompRp1,0.3333333333333333,2,2,CTGTCGCCCAGGACCAAGCA,0,2777255
ompRp1,0.3333333333333333,2,2,CTGTCAGGCACACGTACAGC,0,2780488
ompRp1,0.3333333333333333,2,2,CTGGTTGTGGGAGCAGAGAA,0,2778640
ompRp1,0.3333333333333333,2,2,CTGGTGACCGCCTCAAGTTG,0,2796182
ompRp1,0.3333333333333333,2,2,CTGGTAAGTCATAGCCCGAT,0,2812306
ompRp1,0.3333333333333333,2,2,CTGGCTTAGATTTATGTTCA,0,2788711
ompRp1,0.3333333333333333,2,2,CTGGATCGCACAAGACGTGG,0,2819513
ompRp1,0.3333333333333333,2,2,CTGGAGGCGCGATCGCCTTG,0,2813182
ompRp1,0.3333333333333333,2,2,CTGGACTATTACATTGGAGG,0,2807236
ompRp1,0.3333333333333333,2,2,CTGCTAAAGAAGTGGGGCTC,0,2789229
ompRp1,0.3333333333333333,2,2,CTGCGCCATTTAGTTCTAGT,0,2801084
ompRp1,0.3333333333333333,2,2,CTGCGACACGCGCACTTGTG,0,2806333
ompRp1,0.3333333333333333,2,2,CTGCCCACGAGAGCAATGAA,0,2812891
ompRp1,0.3333333333333333,2,2,CTGCCACTGGTGGGCCTCTA,0,2812423
ompRp1,0.3333333333333333,2,2,CTGCCACGGAAGATGTACGG,0,2815208
ompRp1,0.3333333333333333,2,2,CTGCAGACCAATCGGCGTCC,0,2801124
ompRp1,0.3333333333333333,2,2,CTGCAATTGGTTTTGACAGA,0,2781525
ompRp1,0.3333333333333333,2,2,CTGAGGATCTGGCTTACTCA,0,2810877
ompRp1,0.3333333333333333,2,2,CTGAGGAAATAGGGGCCCAT,0,2809101
ompRp1,0.3333333333333333,2,2,CTGACGCACCATCCGTAGCA,0,2778760
ompRp1,0.3333333333333333,2,2,CTGACGAGAAGTACCCCCGT,0,2775774
ompRp1,0.3333333333333333,2,2,CTGAAAGACTATGTATTTTA,0,2798507
ompRp1,0.3333333333333333,2,2,CTCTGAGAGATAGGGCGGAT,0,2798107
ompRp1,0.3333333333333333,2,2,CTCTACCGTCAAGTCTACCA,0,2821885
ompRp1,0.3333333333333333,2,2,CTCGTTGAGGGGAGACGCAA,0,2778895
ompRp1,0.3333333333333333,2,2,CTCGGCCCCGAAGCTAGTCA,0,2790682
ompRp1,0.3333333333333333,2,2,CTCGCTCCCACTTAAGAGTG,0,2779063
ompRp1,0.3333333333333333,2,2,CTCGCACCGTGGGGAAGGCC,0,2784253
ompRp1,0.3333333333333333,2,2,CTCGATTGACGGGCTTCCAG,0,2788266
ompRp1,0.3333333333333333,2,2,CTCGATGACGCGTCCCTTTA,0,2813412
ompRp1,0.3333333333333333,2,2,CTCGAGCTTCAATCAACTCT,0,2807811
ompRp1,0.3333333333333333,2,2,CTCGAGCTGTCCGCTAAATC,0,2808786
ompRp1,0.3333333333333333,2,2,CTCGAATGGTGGTCGGATGA,0,2823087
ompRp1,0.3333333333333333,2,2,CTCCTAGTCGCAAGGCCACA,0,2817127
ompRp1,0.3333333333333333,2,2,CTCCGTATAGGACGGTCAAT,0,2813143
ompRp1,0.3333333333333333,2,2,CTCCGGTGTCGCAGTCGGTG,0,2809436
ompRp1,0.3333333333333333,2,2,CTCCGCATCTCAACGGAGCG,0,2794154
ompRp1,0.3333333333333333,2,2,CTCCCTATTTGCCTGTGAAG,0,2809039
ompRp1,0.3333333333333333,2,2,CTCCCGGTCCCGAGGACGAT,0,2792605
ompRp1,0.3333333333333333,2,2,CTCCCGGCCATTTTAATCTG,0,2765357
ompRp1,0.3333333333333333,2,2,CTCCCGGAGACTGTCACGTC,0,2788491
ompRp1,0.3333333333333333,2,2,CTCCCACAGAAGCCGGTAGG,0,2824337
ompRp1,0.3333333333333333,2,2,CTCATTGTTGTGAACAACCA,0,2790158
ompRp1,0.3333333333333333,2,2,CTCATTCGAGTTTTTTGTAC,0,2771806
ompRp1,0.3333333333333333,2,2,CTCATCGGGACTTTCAGTGC,0,2791095
ompRp1,0.3333333333333333,2,2,CTCATCCACCACAGGCTATG,0,2781182
ompRp1,0.3333333333333333,2,2,CTCATCAGGGAGAGGCTGAG,0,2770953
ompRp1,0.3333333333333333,2,2,CTCAGCTGTTAGCAGTCCAC,0,2770179
ompRp1,0.3333333333333333,2,2,CTCAGCTCGTAGAAAAGTGG,0,2812989
ompRp1,0.3333333333333333,2,2,CTCAAGGGGGGCTCGGAGCG,0,2803589
ompRp1,0.3333333333333333,2,2,CTATTTAATGCTCCCGGACC,0,2811898
ompRp1,0.3333333333333333,2,2,CTATGCCCGGGGTGCCCCTA,0,2766928
ompRp1,0.3333333333333333,2,2,CTATGCAAAGTTGTTATCGG,0,2808235
ompRp1,0.3333333333333333,2,2,CTATGATCTATCGAGCGCTC,0,2778686
ompRp1,0.3333333333333333,2,2,CTATCCTGTATTTAGAGGGT,0,2805255
ompRp1,0.3333333333333333,2,2,CTATCAGCCTTCGGCACACG,0,2786837
ompRp1,0.3333333333333333,2,2,CTATAATCAGAAGCATTACT,0,2775035
ompRp1,0.3333333333333333,2,2,CTAGTTTCAGTTTACCCATT,0,2811908
ompRp1,0.3333333333333333,2,2,CTAGTCCTAAATTTTGGGCA,0,2795667
ompRp1,0.3333333333333333,2,2,CTAGGTCATTAAGCCAGCGT,0,2774261
ompRp1,0.3333333333333333,2,2,CTAGGGACGGTAAGTTGCAA,0,2788099
ompRp1,0.3333333333333333,2,2,CTAGCTGTTGAACGTGCACT,0,2769455
ompRp1,0.3333333333333333,2,2,CTAGCCGCCTGTGTGCCGGT,0,2783341
ompRp1,0.3333333333333333,2,2,CTAGAAGACATGAAGTCGTG,0,2807540
ompRp1,0.3333333333333333,2,2,CTAGAAAATCGGTTCTGGCT,0,2805391
ompRp1,0.3333333333333333,2,2,CTACTTCTCAGATGCTGGTG,0,2783704
ompRp1,0.3333333333333333,2,2,CTACTACCGTTTTGTGTGTG,0,2792704
ompRp1,0.3333333333333333,2,2,CTACGTTCATGATTGAGAAG,0,2800690
ompRp1,0.3333333333333333,2,2,CTACATGTTTAGTACAGGGC,0,2778572
ompRp1,0.3333333333333333,2,2,CTACAGACTGACCGTTCGAG,0,2772150
ompRp1,0.3333333333333333,2,2,CTAATTGGTCTTCTTCGTAA,0,2801721
ompRp1,0.3333333333333333,2,2,CTAATCACTCCGCGGCAATC,0,2822653
ompRp1,0.3333333333333333,2,2,CTAAATTTGACGGGCTGTGT,0,2816595
ompRp1,0.3333333333333333,2,2,CTAAATAGTTAGGATTATAA,0,2789802
ompRp1,0.3333333333333333,2,2,CGTTTTCTTATTGTTGCTCA,0,2767245
ompRp1,0.3333333333333333,2,2,CGTTTGGGGGTGGATAACCA,0,2787005
ompRp1,0.3333333333333333,2,2,CGTTTAGCACGTTGTTTGTA,0,2803188
ompRp1,0.3333333333333333,2,2,CGTTTAGACACGCACATCTC,0,2781953
ompRp1,0.3333333333333333,2,2,CGTTGTTGGTAACGCTGAGT,0,2779215
ompRp1,0.3333333333333333,2,2,CGTTGGATCCAGCGACGTGG,0,2810365
ompRp1,0.3333333333333333,2,2,CGTTGATGGTGGTGTATTAA,0,2801512
ompRp1,0.3333333333333333,2,2,CGTTCTAGACTCCCCCCCAC,0,2800439
ompRp1,0.3333333333333333,2,2,CGTTCCCAGTGTTGCAATTA,0,2802480
ompRp1,0.3333333333333333,2,2,CGTTCATTCCCTTTCGGATT,0,2767833
ompRp1,0.3333333333333333,2,2,CGTTCATATAGATGAGAGCT,0,2777037
ompRp1,0.3333333333333333,2,2,CGTTATACCAGTAGACTACA,0,2804841
ompRp1,0.3333333333333333,2,2,CGTTAATATGTGCTGGTGTG,0,2766717
ompRp1,0.3333333333333333,2,2,CGTTAATATAATCTTGGCGC,0,2797279
ompRp1,0.3333333333333333,2,2,CGTGTTTGGCCTTGGGTAAA,0,2775672
ompRp1,0.3333333333333333,2,2,CGTGTTGAGACATCGCCATG,0,2800659
ompRp1,0.3333333333333333,2,2,CGTGTTGACTCAAGTAACTG,0,2789641
ompRp1,0.3333333333333333,2,2,CGTGTGTCTCAGATCTATAG,0,2775308
ompRp1,0.3333333333333333,2,2,CGTGATAGATGTAGGTATTA,0,2813213
ompRp1,0.3333333333333333,2,2,CGTGATACCATATGTAGTTT,0,2820316
ompRp1,0.3333333333333333,2,2,CGTGACCGACTGAGCACAAC,0,2815617
ompRp1,0.3333333333333333,2,2,CGTCTTTGATCTGGGGCTTT,0,2798047
ompRp1,0.3333333333333333,2,2,CGTCTTTATGGTACCATCTT,0,2816850
ompRp1,0.3333333333333333,2,2,CGTCTCTACATTGGTAAGTA,0,2767709
ompRp1,0.3333333333333333,2,2,CGTCTATGAATAAATATAAC,0,2800916
ompRp1,0.3333333333333333,2,2,CGTCGCCGCGGCGTTAGCGA,0,2797754
ompRp1,0.3333333333333333,2,2,CGTCCATGTAAGCCGCGGCA,0,2773491
ompRp1,0.3333333333333333,2,2,CGTCCAGTCTGAGCGTCTTA,0,2810548
ompRp1,0.3333333333333333,2,2,CGTCCACGCCCCTGATGCAG,0,2812832
ompRp1,0.3333333333333333,2,2,CGTCAGAGGGCCGTTCCGGG,0,2795108
ompRp1,0.3333333333333333,2,2,CGTATTGTCCGTGGATTAAT,0,2785101
ompRp1,0.3333333333333333,2,2,CGTATCTCGACGGTGTGGTG,0,2820461
ompRp1,0.3333333333333333,2,2,CGTATATGAGTCCCGCATGT,0,2780281
ompRp1,0.3333333333333333,2,2,CGTAGAATCGTTAGGATACC,0,2781489
ompRp1,0.3333333333333333,2,2,CGTACCGAGCTGGCACGGGG,0,2781558
ompRp1,0.3333333333333333,2,2,CGTACCGAGATGGGTTAGTA,0,2803227
ompRp1,0.3333333333333333,2,2,CGTAATACCCTTGAATGGCT,0,2783779
ompRp1,0.3333333333333333,2,2,CGTAAGCCGGAAGTACTGCA,0,2774389
ompRp1,0.3333333333333333,2,2,CGTAACTGGGTTTGGGCATA,0,2793769
ompRp1,0.3333333333333333,2,2,CGTAACGGAGAGGTCAATTT,0,2822388
ompRp1,0.3333333333333333,2,2,CGTAAAGAACAAAAGGATCT,0,2801950
ompRp1,0.3333333333333333,2,2,CGGTTTTGATAGTATTCTTA,0,2807912
ompRp1,0.3333333333333333,2,2,CGGTTTGTACTGTCCGAACT,0,2823893
ompRp1,0.3333333333333333,2,2,CGGTTGCTGTCAAGCCCTGA,0,2780713
ompRp1,0.3333333333333333,2,2,CGGTCAGGTACTACTAACAG,0,2818817
ompRp1,0.3333333333333333,2,2,CGGTCACTTAAATTTTCCTC,0,2766887
ompRp1,0.3333333333333333,2,2,CGGTATGAGGACGTGCGTTG,0,2814314
ompRp1,0.3333333333333333,2,2,CGGTAGAGTTTCCACGGTGT,0,2820317
ompRp1,0.3333333333333333,2,2,CGGTACAACCGGTAGCAGTT,0,2807726
ompRp1,0.3333333333333333,2,2,CGGGTGTGCGCAAGCGTTAA,0,2789223
ompRp1,0.3333333333333333,2,2,CGGGTGGGGGTCCTCCTCTA,0,2768250
ompRp1,0.3333333333333333,2,2,CGGGGCTAAAACTAGCTGGT,0,2807389
ompRp1,0.3333333333333333,2,2,CGGGCTCCAATCAGGACCGT,0,2799874
ompRp1,0.3333333333333333,2,2,CGGGCGGTGCGGACGGTTCG,0,2809078
ompRp1,0.3333333333333333,2,2,CGGGCCGATGATGTAGTTCA,0,2789382
ompRp1,0.3333333333333333,2,2,CGGGCATTCGGGAAGTAGCC,0,2803478
ompRp1,0.3333333333333333,2,2,CGGGCAGCAGAGAGCGAATG,0,2813891
ompRp1,0.3333333333333333,2,2,CGGGATTCGAGCCTTCGCGC,0,2791301
ompRp1,0.3333333333333333,2,2,CGGGATGGCTAATACAAAAG,0,2817275
ompRp1,0.3333333333333333,2,2,CGGGATATCATTCGTTTTAC,0,2802253
ompRp1,0.3333333333333333,2,2,CGGGATAACCTGGGAGGAGT,0,2793843
ompRp1,0.3333333333333333,2,2,CGGGAGAAGGAACAGGAGCC,0,2797787
ompRp1,0.3333333333333333,2,2,CGGCTTAATGTATGTTGTTG,0,2777906
ompRp1,0.3333333333333333,2,2,CGGCTGGCAGTGCGGGGTGT,0,2814873
ompRp1,0.3333333333333333,2,2,CGGCTCCGTAGTGATGGTGC,0,2799331
ompRp1,0.3333333333333333,2,2,CGGCGGTGACCGGAGAAATC,0,2785541
ompRp1,0.3333333333333333,2,2,CGGCGGCATGAAGGAGTCTA,0,2779587
ompRp1,0.3333333333333333,2,2,CGGCATGCCCTAAAGCGTTA,0,2796555
ompRp1,0.3333333333333333,2,2,CGGCATGATGGTCCTCATGA,0,2780122
ompRp1,0.3333333333333333,2,2,CGGCATAGAAGGACGAGGCA,0,2766028
ompRp1,0.3333333333333333,2,2,CGGCAGTCACCACACGGAGG,0,2787818
ompRp1,0.3333333333333333,2,2,CGGCAATAGTCAAGTGGATG,0,2819360
ompRp1,0.3333333333333333,2,2,CGGATGGGTATATCGTACTC,0,2813589
ompRp1,0.3333333333333333,2,2,CGGATCTAGCATCCGAGGAG,0,2776500
ompRp1,0.3333333333333333,2,2,CGGATCCCCACGCAATGTCA,0,2824325
ompRp1,0.3333333333333333,2,2,CGGATATGGTATAGTTTGAA,0,2808915
ompRp1,0.3333333333333333,2,2,CGGATAGGACTAATCTAACC,0,2795510
ompRp1,0.3333333333333333,2,2,CGGATAGCCGGCCACGAGAT,0,2819293
ompRp1,0.3333333333333333,2,2,CGGAGGTATACCCACGCAAT,0,2799205
ompRp1,0.3333333333333333,2,2,CGGAGAATACACCCTTCGAG,0,2802566
ompRp1,0.3333333333333333,2,2,CGGACGGTCACTAATGGGTC,0,2814744
ompRp1,0.3333333333333333,2,2,CGGACAACGCAAGGCGAGTA,0,2787385
ompRp1,0.3333333333333333,2,2,CGGAAGGGAACAGTTGACCA,0,2810733
ompRp1,0.3333333333333333,2,2,CGGAAGATAGGAGAATATCC,0,2786656
ompRp1,0.3333333333333333,2,2,CGCTTGGTGCCAACAGATAA,0,2781171
ompRp1,0.3333333333333333,2,2,CGCTTCTCCTATCTTTCATG,0,2799924
ompRp1,0.3333333333333333,2,2,CGCTTCAGTAACACATCGGC,0,2779991
ompRp1,0.3333333333333333,2,2,CGCTTACTGGCGGCTAAAAT,0,2809494
ompRp1,0.3333333333333333,2,2,CGCTTAATGCGAATCACGCC,0,2766713
ompRp1,0.3333333333333333,2,2,CGCTGTGACGATGTCCTCCC,0,2803776
ompRp1,0.3333333333333333,2,2,CGCTGAAAGAGTGCACGAAG,0,2812341
ompRp1,0.3333333333333333,2,2,CGCTCTCGACGACTAAGTAT,0,2801081
ompRp1,0.3333333333333333,2,2,CGCTCAAGCACTTAGAGTTT,0,2799530
ompRp1,0.3333333333333333,2,2,CGCTATAGTGCTTTGGGGTC,0,2777560
ompRp1,0.3333333333333333,2,2,CGCTAGGCCATACCCGCGAC,0,2804165
ompRp1,0.3333333333333333,2,2,CGCTACGCACAGTATTCGGG,0,2776258
ompRp1,0.3333333333333333,2,2,CGCTAATCAGGTGTTTCTTG,0,2791852
ompRp1,0.3333333333333333,2,2,CGCGTTCAGACGTAGACGGG,0,2794019
ompRp1,0.3333333333333333,2,2,CGCGTGATACCAGGTAAAAC,0,2772605
ompRp1,0.3333333333333333,2,2,CGCGGTGCTTGGCCGGTCAG,0,2799938
ompRp1,0.3333333333333333,2,2,CGCGGCAGTATGCCAAGTAG,0,2797663
ompRp1,0.3333333333333333,2,2,CGCGGATTTGGCGCCGGGGA,0,2817131
ompRp1,0.3333333333333333,2,2,CGCGGATATCAACCCCACTC,0,2783914
ompRp1,0.3333333333333333,2,2,CGCGCTTCCTCCCATAACCA,0,2766409
ompRp1,0.3333333333333333,2,2,CGCGCGTGGTACAATTTTCG,0,2779243
ompRp1,0.3333333333333333,2,2,CGCGCCTTACGCGGCTTAAG,0,2799676
ompRp1,0.3333333333333333,2,2,CGCGAGCGGCGGGTTCGGTC,0,2811975
ompRp1,0.3333333333333333,2,2,CGCGAGAAGTACAGGGGGAG,0,2806353
ompRp1,0.3333333333333333,2,2,CGCGAATTGGACTATGACTG,0,2805179
ompRp1,0.3333333333333333,2,2,CGCCTGGCTTACATGGCCGG,0,2797198
ompRp1,0.3333333333333333,2,2,CGCCTATTAAAAAAATTGGG,0,2768368
ompRp1,0.3333333333333333,2,2,CGCCTAGGACAGTGGAGTAC,0,2783029
ompRp1,0.3333333333333333,2,2,CGCCGTCCGGCTTGCAGGAT,0,2800510
ompRp1,0.3333333333333333,2,2,CGCCGATATGAGTAATATCG,0,2810675
ompRp1,0.3333333333333333,2,2,CGCCCTTAGTGGTTAAGTTA,0,2812058
ompRp1,0.3333333333333333,2,2,CGCCCGCCCGTCGGCCGAAC,0,2768380
ompRp1,0.3333333333333333,2,2,CGCCCCCCTCGGATAGAGCA,0,2801953
ompRp1,0.3333333333333333,2,2,CGCCAGCAAATCGGCCAACA,0,2815511
ompRp1,0.3333333333333333,2,2,CGCATACTCACAGCCGGTGG,0,2782886
ompRp1,0.3333333333333333,2,2,CGCAGGCGGAAGCCTACAGG,0,2782291
ompRp1,0.3333333333333333,2,2,CGCAATCTGCCGTCTACGCT,0,2779477
ompRp1,0.3333333333333333,2,2,CGCAATATCAATGGGTAGCA,0,2782014
ompRp1,0.3333333333333333,2,2,CGCAACAATTTACATAATTT,0,2810787
ompRp1,0.3333333333333333,2,2,CGATTCGGGGCATGGTCTGC,0,2781865
ompRp1,0.3333333333333333,2,2,CGATTCATGATTCGCTGGTT,0,2813049
ompRp1,0.3333333333333333,2,2,CGATGTACTTAAATAGAACA,0,2815795
ompRp1,0.3333333333333333,2,2,CGATGGACATTCTTGGCGAT,0,2808268
ompRp1,0.3333333333333333,2,2,CGATGACTTCGTTCAAGGCA,0,2779611
ompRp1,0.3333333333333333,2,2,CGATCTTATGTCCCGGCCAT,0,2805324
ompRp1,0.3333333333333333,2,2,CGATCTGCCGCATGTCCCTC,0,2766516
ompRp1,0.3333333333333333,2,2,CGATCGGCGACGCGTGCGAC,0,2821523
ompRp1,0.3333333333333333,2,2,CGATCAGAATGTCTGTTGAG,0,2813014
ompRp1,0.3333333333333333,2,2,CGATACGTTCTCATGAGTGG,0,2796040
ompRp1,0.3333333333333333,2,2,CGATACGCCATTTGGCCCTC,0,2787323
ompRp1,0.3333333333333333,2,2,CGATAATTAATGCCCCGTTG,0,2780817
ompRp1,0.3333333333333333,2,2,CGAGTGGATGGGAAGCTAGT,0,2822219
ompRp1,0.3333333333333333,2,2,CGAGGGGACCCCCCCAGTCA,0,2794784
ompRp1,0.3333333333333333,2,2,CGAGGCGCTCTCGCTACTAG,0,2789630
ompRp1,0.3333333333333333,2,2,CGAGCCTAAACAATTTGACA,0,2809218
ompRp1,0.3333333333333333,2,2,CGAGACCTATTGCCCTTGTG,0,2819749
ompRp1,0.3333333333333333,2,2,CGAGACCGGTGCGTTCATGT,0,2821760
ompRp1,0.3333333333333333,2,2,CGACTTACATTCCTTGGAAA,0,2784678
ompRp1,0.3333333333333333,2,2,CGACTGCTGTCGGATTCGTG,0,2823886
ompRp1,0.3333333333333333,2,2,CGACGTAGGAGTAAGCACGG,0,2821701
ompRp1,0.3333333333333333,2,2,CGACGCAATCAAGCAGCAGG,0,2769789
ompRp1,0.3333333333333333,2,2,CGACCTGCCAGCATATATGA,0,2808276
ompRp1,0.3333333333333333,2,2,CGACCGGTCGCTACTAAACA,0,2814112
ompRp1,0.3333333333333333,2,2,CGACCGCTACATCTTTCTCA,0,2775090
ompRp1,0.3333333333333333,2,2,CGACCAACCACTCGAGGCCT,0,2773749
ompRp1,0.3333333333333333,2,2,CGACAGGAGAGTACCGACAA,0,2781175
ompRp1,0.3333333333333333,2,2,CGAATGGTCATCAGGCAATA,0,2822099
ompRp1,0.3333333333333333,2,2,CGAATGGCCAGACATTCAAC,0,2810620
ompRp1,0.3333333333333333,2,2,CGAAGTTGGTAGCACTTTGT,0,2819118
ompRp1,0.3333333333333333,2,2,CGAAGTAGCATCGACGAGAC,0,2791407
ompRp1,0.3333333333333333,2,2,CGAAGGAGACGAGTAAGGAT,0,2794962
ompRp1,0.3333333333333333,2,2,CGAAGCAGGGTAGAAAGATT,0,2788159
ompRp1,0.3333333333333333,2,2,CGAAGATCAAATCTGGTGTG,0,2782850
ompRp1,0.3333333333333333,2,2,CGAAGAAGTTCAGCCTTTAC,0,2780243
ompRp1,0.3333333333333333,2,2,CGAACGCCGTGGATTAAGAG,0,2804799
ompRp1,0.3333333333333333,2,2,CGAACCTGAATGAGTGATCA,0,2801691
ompRp1,0.3333333333333333,2,2,CGAACCCGTGACAAAAGTTT,0,2815257
ompRp1,0.3333333333333333,2,2,CGAAAGCGTAATACCACTAC,0,2780103
ompRp1,0.3333333333333333,2,2,CGAAACAGCCCGGTTTGCAT,0,2822704
ompRp1,0.3333333333333333,2,2,CCTTTAGGATAAGTTCCACT,0,2800814
ompRp1,0.3333333333333333,2,2,CCTTGGATAATTATGTCCGG,0,2775894
ompRp1,0.3333333333333333,2,2,CCTTGACTCAGTCTGATCTG,0,2800212
ompRp1,0.3333333333333333,2,2,CCTTCCTTAGGGCAAGGTCT,0,2793347
ompRp1,0.3333333333333333,2,2,CCTTAACGTTCCCACATCAA,0,2814530
ompRp1,0.3333333333333333,2,2,CCTGTGTTCTCAACCTAGGC,0,2819752
ompRp1,0.3333333333333333,2,2,CCTGTGTCTTAAGTTGGGAA,0,2782470
ompRp1,0.3333333333333333,2,2,CCTGCTATTCTCTAAATCGC,0,2766395
ompRp1,0.3333333333333333,2,2,CCTGCGGACCACATCTGCAA,0,2804890
ompRp1,0.3333333333333333,2,2,CCTGAGACCTCGCCAGTTTT,0,2820842
ompRp1,0.3333333333333333,2,2,CCTGACGTTCCCGGAACGGT,0,2820722
ompRp1,0.3333333333333333,2,2,CCTGAATTAACAATGTACCA,0,2772127
ompRp1,0.3333333333333333,2,2,CCTGAAGGACTCACGTACGG,0,2770812
ompRp1,0.3333333333333333,2,2,CCTCTTTCGGCCGAAAAAAC,0,2796581
ompRp1,0.3333333333333333,2,2,CCTCTCATGCGGGACCTTAG,0,2781053
ompRp1,0.3333333333333333,2,2,CCTCGATAGGAAGATCTCTC,0,2803671
ompRp1,0.3333333333333333,2,2,CCTCGAATCTCGTAAGTTCA,0,2795956
ompRp1,0.3333333333333333,2,2,CCTCCTTTACCTATGTCACA,0,2810978
ompRp1,0.3333333333333333,2,2,CCTAGTTACGGTCGCCAGGT,0,2814267
ompRp1,0.3333333333333333,2,2,CCTAGTGCCATGTATGTAAA,0,2777555
ompRp1,0.3333333333333333,2,2,CCTAGTGAGTTGAAATAAAA,0,2794600
ompRp1,0.3333333333333333,2,2,CCTACGCGGTCTTACGAAAA,0,2780804
ompRp1,0.3333333333333333,2,2,CCTAAGGCCAACTTCTATTC,0,2790241
ompRp1,0.3333333333333333,2,2,CCGTTTGCGCAACCACCCAA,0,2792304
ompRp1,0.3333333333333333,2,2,CCGTTCTATGGTCTCGGATT,0,2803166
ompRp1,0.3333333333333333,2,2,CCGTTCAGAAAAGCGGGAAG,0,2803204
ompRp1,0.3333333333333333,2,2,CCGTGCGGCAGTGCGCTATG,0,2793266
ompRp1,0.3333333333333333,2,2,CCGTGAATTGGCCCTTTCCA,0,2784309
ompRp1,0.3333333333333333,2,2,CCGTCGTCTGTTTGGACGGC,0,2818636
ompRp1,0.3333333333333333,2,2,CCGTCCAGCTGTGCGTGCCG,0,2776567
ompRp1,0.3333333333333333,2,2,CCGTATGTGAATGGAACCTT,0,2787595
ompRp1,0.3333333333333333,2,2,CCGTACCGAAACTGTGGAAA,0,2812292
ompRp1,0.3333333333333333,2,2,CCGGTATTCGAAGAGGCAGA,0,2811644
ompRp1,0.3333333333333333,2,2,CCGGGTGACAAAGCTCTCTC,0,2808493
ompRp1,0.3333333333333333,2,2,CCGGGCAGCCTGGATCCTTG,0,2823298
ompRp1,0.3333333333333333,2,2,CCGGGAGAACGGGTATGAAC,0,2800148
ompRp1,0.3333333333333333,2,2,CCGGGACGGACACAAGTCTA,0,2818332
ompRp1,0.3333333333333333,2,2,CCGGCATGGTCACCGAAAGG,0,2797889
ompRp1,0.3333333333333333,2,2,CCGGCATAAGGGTTATTGCG,0,2767921
ompRp1,0.3333333333333333,2,2,CCGGATGGCACCTACCCCCC,0,2775814
ompRp1,0.3333333333333333,2,2,CCGGAGCAAACATGGGAATA,0,2795130
ompRp1,0.3333333333333333,2,2,CCGGACAGTACGATAAGACT,0,2775526
ompRp1,0.3333333333333333,2,2,CCGGACACTACTGTATGCGC,0,2799017
ompRp1,0.3333333333333333,2,2,CCGGAATCATCGGTCATGTT,0,2776294
ompRp1,0.3333333333333333,2,2,CCGCTGTGCTAAGATGCGGA,0,2802219
ompRp1,0.3333333333333333,2,2,CCGCGGGAGGTGGCTCATCG,0,2773062
ompRp1,0.3333333333333333,2,2,CCGCGCGGAGAAAGGAGTCA,0,2779271
ompRp1,0.3333333333333333,2,2,CCGCCTCAACTCGGAGTAAT,0,2787841
ompRp1,0.3333333333333333,2,2,CCGCCGAGCATGTGGCTGTA,0,2815763
ompRp1,0.3333333333333333,2,2,CCGCAAAGTTTTTGATTTGA,0,2778660
ompRp1,0.3333333333333333,2,2,CCGATGGGGCACTCCGTGGT,0,2792097
ompRp1,0.3333333333333333,2,2,CCGATCCATTGTGTTGCCTC,0,2787490
ompRp1,0.3333333333333333,2,2,CCGATATGGTTCCTCGGCCA,0,2771978
ompRp1,0.3333333333333333,2,2,CCGATAACCTACGTTATGCA,0,2795711
ompRp1,0.3333333333333333,2,2,CCGATAAACTTCTACGGCAT,0,2795756
ompRp1,0.3333333333333333,2,2,CCGAGTTCCAATTGGGCCTG,0,2797378
ompRp1,0.3333333333333333,2,2,CCGAGTAGTACAACGGTCGT,0,2779941
ompRp1,0.3333333333333333,2,2,CCGAGTACGCGCTGACTTAG,0,2783610
ompRp1,0.3333333333333333,2,2,CCGAGGCGTTAGCCCCAGAC,0,2805159
ompRp1,0.3333333333333333,2,2,CCGAGCACCGGCAATTCAGA,0,2788296
ompRp1,0.3333333333333333,2,2,CCGACGTACTCGCTGAACGA,0,2824346
ompRp1,0.3333333333333333,2,2,CCGACACCATGTGAGCCGAA,0,2784871
ompRp1,0.3333333333333333,2,2,CCGAATTTGAAACAACACTA,0,2768704
ompRp1,0.3333333333333333,2,2,CCGAACCATTGACGGGCGGA,0,2812582
ompRp1,0.3333333333333333,2,2,CCCTTTTAGAGAGGCCCGGC,0,2793196
ompRp1,0.3333333333333333,2,2,CCCTTTCGCAAGAACTCAAT,0,2784830
ompRp1,0.3333333333333333,2,2,CCCTGCGATCATTTACCGTA,0,2765990
ompRp1,0.3333333333333333,2,2,CCCTACCTTGTGAGGGTTCG,0,2784576
ompRp1,0.3333333333333333,2,2,CCCGTGACTACAAACCAGCT,0,2782754
ompRp1,0.3333333333333333,2,2,CCCGGTTAATATGATGCTAG,0,2767685
ompRp1,0.3333333333333333,2,2,CCCGGGGATATAGGATGATT,0,2804399
ompRp1,0.3333333333333333,2,2,CCCGGGACGACTATTCATTT,0,2767585
ompRp1,0.3333333333333333,2,2,CCCGCTGTCTTAGTGCGTGT,0,2817995
ompRp1,0.3333333333333333,2,2,CCCGCCTCCGTAGTCTCGGA,0,2774442
ompRp1,0.3333333333333333,2,2,CCCGCCGATACGTGCAGGTA,0,2795408
ompRp1,0.3333333333333333,2,2,CCCGAGGCTTTGGTGATATT,0,2786549
ompRp1,0.3333333333333333,2,2,CCCGAGGCTGCATCAGAGTG,0,2802166
ompRp1,0.3333333333333333,2,2,CCCGAATGGAGGGCAGAGTA,0,2771495
ompRp1,0.3333333333333333,2,2,CCCCTCGTCATAAAAGCAAA,0,2771484
ompRp1,0.3333333333333333,2,2,CCCCGTGCCACGATCTAAGA,0,2807096
ompRp1,0.3333333333333333,2,2,CCCCGCACTAACAAGGGTTC,0,2811064
ompRp1,0.3333333333333333,2,2,CCCCCCCGCGTGGACACTGT,0,2812941
ompRp1,0.3333333333333333,2,2,CCCCCCAAAGACACAATTGC,0,2801550
ompRp1,0.3333333333333333,2,2,CCCCACTTGCTTCCGTGTAT,0,2771527
ompRp1,0.3333333333333333,2,2,CCCATGGCACTCACTCACTT,0,2820336
ompRp1,0.3333333333333333,2,2,CCCAGTGCAGGATGGCTTGA,0,2806065
ompRp1,0.3333333333333333,2,2,CCCAGGAACGAGGAGTTTCC,0,2803142
ompRp1,0.3333333333333333,2,2,CCCACTCAAGCCTGGCGTGT,0,2767539
ompRp1,0.3333333333333333,2,2,CCCACGAGTCGCCCCCGGTG,0,2800940
ompRp1,0.3333333333333333,2,2,CCCACAGCTCTGACGAGATA,0,2823929
ompRp1,0.3333333333333333,2,2,CCATTATACTCACTACGCCA,0,2812605
ompRp1,0.3333333333333333,2,2,CCATGTCAACGCAGTCGCAT,0,2801423
ompRp1,0.3333333333333333,2,2,CCATATCGGGAGAGTTACTA,0,2784134
ompRp1,0.3333333333333333,2,2,CCATAGGCTGTGGCGTCACT,0,2813443
ompRp1,0.3333333333333333,2,2,CCATAAAAACCACTAAAGCT,0,2786249
ompRp1,0.3333333333333333,2,2,CCAGTGTTAAGTAGAGGTAT,0,2804494
ompRp1,0.3333333333333333,2,2,CCAGGTTATGCTCTTGGCAC,0,2767368
ompRp1,0.3333333333333333,2,2,CCAGATTGGAATTAGAGAAT,0,2783231
ompRp1,0.3333333333333333,2,2,CCAGACGTCATCATTCTGCA,0,2791373
ompRp1,0.3333333333333333,2,2,CCACTGGTATTCGACGAATC,0,2767502
ompRp1,0.3333333333333333,2,2,CCACGTTTCGGTTTATCTAA,0,2805934
ompRp1,0.3333333333333333,2,2,CCACGCCTGTAGTCGAGGGT,0,2822582
ompRp1,0.3333333333333333,2,2,CCACCTTCCGTTGACCCGAG,0,2784860
ompRp1,0.3333333333333333,2,2,CCACCCAGGCATGGTCTTTT,0,2795645
ompRp1,0.3333333333333333,2,2,CCACATTAGCCCAGCACAGA,0,2821836
ompRp1,0.3333333333333333,2,2,CCACATGAATCGAAGATATC,0,2822027
ompRp1,0.3333333333333333,2,2,CCACAAGGAGCGTTTAAATC,0,2819482
ompRp1,0.3333333333333333,2,2,CCAATTTCATTTTAAAAATG,0,2780043
ompRp1,0.3333333333333333,2,2,CCAATAGGTGAACTGGACGC,0,2804390
ompRp1,0.3333333333333333,2,2,CCAATACGGTCCAATAGTTT,0,2799482
ompRp1,0.3333333333333333,2,2,CCAAGCCTTTGCGGCCATAC,0,2793214
ompRp1,0.3333333333333333,2,2,CCAAGCCTGGCTGATTTCCA,0,2779617
ompRp1,0.3333333333333333,2,2,CCAAGATAGTCTCCTATAGG,0,2802984
ompRp1,0.3333333333333333,2,2,CCAACCTGGCACTGTGGCCT,0,2780651
ompRp1,0.3333333333333333,2,2,CCAACCGGCCGGTCGCGTTA,0,2770000
ompRp1,0.3333333333333333,2,2,CCAACATGATTATAAACCCA,0,2777418
ompRp1,0.3333333333333333,2,2,CCAACAGGGAACCCGACCAT,0,2820208
ompRp1,0.3333333333333333,2,2,CCAACACAGTCGGGAGCAAC,0,2779278
ompRp1,0.3333333333333333,2,2,CCAAAGACAGCAGAACTTCG,0,2810103
ompRp1,0.3333333333333333,2,2,CATTTCGTTTTGTAACTGTA,0,2796236
ompRp1,0.3333333333333333,2,2,CATTGTGGTCTGATCTATCA,0,2820864
ompRp1,0.3333333333333333,2,2,CATTGGGACGGGTCAGCTCG,0,2777843
ompRp1,0.3333333333333333,2,2,CATTCCTCCAGTTGATGCGA,0,2765663
ompRp1,0.3333333333333333,2,2,CATTCCAACGGCTCTATAAC,0,2792022
ompRp1,0.3333333333333333,2,2,CATTACCGATGACACCGCCT,0,2818765
ompRp1,0.3333333333333333,2,2,CATTACCCGAGGGTCTTAGA,0,2815461
ompRp1,0.3333333333333333,2,2,CATGTTACCCAGTGGTGCGC,0,2790583
ompRp1,0.3333333333333333,2,2,CATGTCGGAACCGCTCGGAC,0,2798585
ompRp1,0.3333333333333333,2,2,CATGTACGCGATACCGAATG,0,2788839
ompRp1,0.3333333333333333,2,2,CATGTACCACGCTCCTCTGT,0,2814212
ompRp1,0.3333333333333333,2,2,CATGGTGATACAATGGAACG,0,2811493
ompRp1,0.3333333333333333,2,2,CATGGTAAACCGGCATGACC,0,2774822
ompRp1,0.3333333333333333,2,2,CATGGCTTCTGCCAGCAAGT,0,2787099
ompRp1,0.3333333333333333,2,2,CATGGCCTTACTCAGGCTCA,0,2799085
ompRp1,0.3333333333333333,2,2,CATGCGTTATAAAACTCCTT,0,2773541
ompRp1,0.3333333333333333,2,2,CATGCGCGCTAGAGCCAGTA,0,2813852
ompRp1,0.3333333333333333,2,2,CATGAGGGCTGAATTCACGG,0,2800219
ompRp1,0.3333333333333333,2,2,CATCTCGGGCCTGCGAAGGG,0,2767787
ompRp1,0.3333333333333333,2,2,CATCTACGCGTATGCCCATG,0,2803520
ompRp1,0.3333333333333333,2,2,CATCGCTTCCGCGTTGCCTA,0,2819129
ompRp1,0.3333333333333333,2,2,CATCGCATGGGTTACACCCG,0,2796268
ompRp1,0.3333333333333333,2,2,CATCCTCGGCAGTGTTCAAA,0,2782062
ompRp1,0.3333333333333333,2,2,CATCCCAGCAAAACGTGGCT,0,2795753
ompRp1,0.3333333333333333,2,2,CATCATGGCGGTACCCGCCA,0,2789126
ompRp1,0.3333333333333333,2,2,CATCAATGGCCTCGGACTCC,0,2791063
ompRp1,0.3333333333333333,2,2,CATATTATTGAGAATAACTG,0,2795982
ompRp1,0.3333333333333333,2,2,CATAGAGAATTAAGTTGTGG,0,2818187
ompRp1,0.3333333333333333,2,2,CATACCCAGGTGCTAAAAGG,0,2809736
ompRp1,0.3333333333333333,2,2,CATACATCCCGTAGCGGCCA,0,2813244
ompRp1,0.3333333333333333,2,2,CAGTTCCAAGTCATTCCGCT,0,2812122
ompRp1,0.3333333333333333,2,2,CAGTGCCTTGATTTTGGACA,0,2789933
ompRp1,0.3333333333333333,2,2,CAGTCGCTCGGTCATCTGAG,0,2769932
ompRp1,0.3333333333333333,2,2,CAGGTTTGCCTTTGTACCCT,0,2771365
ompRp1,0.3333333333333333,2,2,CAGGTGATTGGTCAGGGCCC,0,2812657
ompRp1,0.3333333333333333,2,2,CAGGTCTGAGCGCAGTTGAG,0,2791264
ompRp1,0.3333333333333333,2,2,CAGGGGTTTGAGCCTCCTTG,0,2789028
ompRp1,0.3333333333333333,2,2,CAGGGCATCCACCTTCCGTG,0,2788329
ompRp1,0.3333333333333333,2,2,CAGGCTAAGCCGAAAGGACG,0,2765607
ompRp1,0.3333333333333333,2,2,CAGGCGCGCGAGTTTATTGT,0,2771605
ompRp1,0.3333333333333333,2,2,CAGGATTATTGTCTTGGACT,0,2802421
ompRp1,0.3333333333333333,2,2,CAGGAAGATACATGTAAGGA,0,2782771
ompRp1,0.3333333333333333,2,2,CAGGAACGGTGCTAAGCAAG,0,2805087
ompRp1,0.3333333333333333,2,2,CAGGAAACGTTCGCTTTGTA,0,2821172
ompRp1,0.3333333333333333,2,2,CAGCTGTTAACTATTCCGTT,0,2798361
ompRp1,0.3333333333333333,2,2,CAGCGAAACACTGGATCGTT,0,2817859
ompRp1,0.3333333333333333,2,2,CAGCCGCTTCGGCTATAGTT,0,2813941
ompRp1,0.3333333333333333,2,2,CAGCCAGTTCTCTCCGTTCC,0,2818026
ompRp1,0.3333333333333333,2,2,CAGCCACAGGTACGGTGGAC,0,2781777
ompRp1,0.3333333333333333,2,2,CAGATTCCCCCTAATTTTGT,0,2780489
ompRp1,0.3333333333333333,2,2,CAGATGCATTGATATGTGTT,0,2817349
ompRp1,0.3333333333333333,2,2,CAGATAGTCTATCTTCAAGG,0,2773221
ompRp1,0.3333333333333333,2,2,CAGAGTGAGAGGCCTTTATT,0,2820548
ompRp1,0.3333333333333333,2,2,CAGAGGATTCAAGTTTACAT,0,2784248
ompRp1,0.3333333333333333,2,2,CAGAGCGTATAAGATTCCTC,0,2812418
ompRp1,0.3333333333333333,2,2,CAGACTGGCCGTGTTGTTGT,0,2781693
ompRp1,0.3333333333333333,2,2,CAGACGCGTCGGTCGGACAC,0,2768243
ompRp1,0.3333333333333333,2,2,CAGAAGCGGGACCCAACCAA,0,2788126
ompRp1,0.3333333333333333,2,2,CACTTTGTTTAGTTGTAGGG,0,2768083
ompRp1,0.3333333333333333,2,2,CACTTGCTACTCTGGCCATA,0,2782644
ompRp1,0.3333333333333333,2,2,CACTTCGAATTTTGAGTAGT,0,2783977
ompRp1,0.3333333333333333,2,2,CACTGTCAGATATAGGTACT,0,2789379
ompRp1,0.3333333333333333,2,2,CACTGTATCATCTGGGGGCG,0,2802877
ompRp1,0.3333333333333333,2,2,CACTGCTGTCCGCGACATCC,0,2780643
ompRp1,0.3333333333333333,2,2,CACTCGAACTAGGACCTTCT,0,2791851
ompRp1,0.3333333333333333,2,2,CACTCATAGACCAACAAGTG,0,2809606
ompRp1,0.3333333333333333,2,2,CACTCAACCATACGAAATCG,0,2787570
ompRp1,0.3333333333333333,2,2,CACTAGCGGGCCACCTTTCA,0,2824743
ompRp1,0.3333333333333333,2,2,CACGTATCCACGCACCATGT,0,2791956
ompRp1,0.3333333333333333,2,2,CACGACGGTATCTTATCGAT,0,2769904
ompRp1,0.3333333333333333,2,2,CACGAATGTTGTAGTCGTTA,0,2786068
ompRp1,0.3333333333333333,2,2,CACGAATGTTGACGTCTCTA,0,2784956
ompRp1,0.3333333333333333,2,2,CACCTCCAACTAATACTTGA,0,2807231
ompRp1,0.3333333333333333,2,2,CACCTCACCTAAAGCTCGTT,0,2787733
ompRp1,0.3333333333333333,2,2,CACCGTATCACCAATACATA,0,2769971
ompRp1,0.3333333333333333,2,2,CACCGGCGCCGAGGATAGTG,0,2792584
ompRp1,0.3333333333333333,2,2,CACCCCCAGGCATTATCTAT,0,2777311
ompRp1,0.3333333333333333,2,2,CACCATTGATTGAAGCGCGT,0,2818570
ompRp1,0.3333333333333333,2,2,CACCACGTGAAGTTCAGCAG,0,2812186
ompRp1,0.3333333333333333,2,2,CACCACGGCAAGGGCATCCT,0,2823204
ompRp1,0.3333333333333333,2,2,CACCAATTTCACGTTTCACT,0,2765566
ompRp1,0.3333333333333333,2,2,CACATTCCCCGTAATAACTG,0,2798974
ompRp1,0.3333333333333333,2,2,CACATGATTTCGATGGTTTT,0,2816203
ompRp1,0.3333333333333333,2,2,CACATCGAACTCTCCAGCAA,0,2765558
ompRp1,0.3333333333333333,2,2,CACACTCCTTTCGTGCGCTC,0,2814320
ompRp1,0.3333333333333333,2,2,CACAATTCATTCTTTTAAGG,0,2806756
ompRp1,0.3333333333333333,2,2,CACAACTCTCTAAAAGCTTT,0,2817391
ompRp1,0.3333333333333333,2,2,CACAAAGACCATAAGAGGTT,0,2818428
ompRp1,0.3333333333333333,2,2,CAATTTCCTCCAAAAGCCTG,0,2812422
ompRp1,0.3333333333333333,2,2,CAATGTGCGCAAAAATGTCT,0,2804925
ompRp1,0.3333333333333333,2,2,CAATGAATCCAGCACCTCAC,0,2809764
ompRp1,0.3333333333333333,2,2,CAATCGCCAACGATCAAGCC,0,2789634
ompRp1,0.3333333333333333,2,2,CAATCATGTAACTCCTTCGG,0,2810362
ompRp1,0.3333333333333333,2,2,CAATCATCTGCCAAGTGTAC,0,2786149
ompRp1,0.3333333333333333,2,2,CAATACAGAGCATATTTCGA,0,2816699
ompRp1,0.3333333333333333,2,2,CAAGTGTTGTCAGGCACCTC,0,2807679
ompRp1,0.3333333333333333,2,2,CAAGTGTGGTTGCATATTGG,0,2766750
ompRp1,0.3333333333333333,2,2,CAAGGTCAGGCGGGATTATG,0,2782359
ompRp1,0.3333333333333333,2,2,CAAGGCTTGATTGAGAGATT,0,2766712
ompRp1,0.3333333333333333,2,2,CAAGGCTGGTTAGAGGACTC,0,2776762
ompRp1,0.3333333333333333,2,2,CAAGGCGCCCGCGCCCATAG,0,2787673
ompRp1,0.3333333333333333,2,2,CAAGGAGAGTTGGTCCAAAT,0,2770279
ompRp1,0.3333333333333333,2,2,CAAGCGGACTCGCCTAAGTA,0,2785986
ompRp1,0.3333333333333333,2,2,CAAGCGCGTCGTCAGAAGCC,0,2797410
ompRp1,0.3333333333333333,2,2,CAAGCAGAACTGCCCCGTGT,0,2815549
ompRp1,0.3333333333333333,2,2,CAAGATTTTGCCACTGTTAC,0,2777962
ompRp1,0.3333333333333333,2,2,CAAGATATAACAACGACTCA,0,2765550
ompRp1,0.3333333333333333,2,2,CAAGAAGGGCAAAGTAGGAT,0,2792369
ompRp1,0.3333333333333333,2,2,CAACTGCTAAAAACAGGGTC,0,2793026
ompRp1,0.3333333333333333,2,2,CAACGGATAAATACCGGACA,0,2794521
ompRp1,0.3333333333333333,2,2,CAACGGAGCTAACCAGCGTA,0,2820524
ompRp1,0.3333333333333333,2,2,CAACGAGCTCGAATCCACGC,0,2820866
ompRp1,0.3333333333333333,2,2,CAACGAGAATCGTTGGTCTT,0,2787948
ompRp1,0.3333333333333333,2,2,CAACGAAGAGTGCGGGGATT,0,2823617
ompRp1,0.3333333333333333,2,2,CAACCTGGATAGCGACACCC,0,2801817
ompRp1,0.3333333333333333,2,2,CAACCTAAGCGGCATCGCAT,0,2784572
ompRp1,0.3333333333333333,2,2,CAACCTAACGTTGTGGGGTG,0,2775935
ompRp1,0.3333333333333333,2,2,CAACAAACGGGACTCACTTC,0,2801127
ompRp1,0.3333333333333333,2,2,CAAATGGGAAGGTATGGGGA,0,2814777
ompRp1,0.3333333333333333,2,2,CAAATGGAGTTGTTCGCCCT,0,2767968
ompRp1,0.3333333333333333,2,2,CAAATGCCAAGCCTTCCTTT,0,2803756
ompRp1,0.3333333333333333,2,2,CAAATAACTGGGAGGATCGT,0,2788429
ompRp1,0.3333333333333333,2,2,CAAAGAGGGGGACTTCAAAG,0,2797304
ompRp1,0.3333333333333333,2,2,CAAACTTATAACTCATTTTG,0,2811965
ompRp1,0.3333333333333333,2,2,CAAACCGGAGCGTTACAACA,0,2817672
ompRp1,0.3333333333333333,2,2,CAAACATGCTGTCCTGTTGT,0,2783538
ompRp1,0.3333333333333333,2,2,CAAAATTCTGTATGCTAGCT,0,2801479
ompRp1,0.3333333333333333,2,2,CAAAAGTAATATCCCCGCCC,0,2822753
ompRp1,0.3333333333333333,2,2,ATTTTTTGTTTCCTCGCGTC,0,2771802
ompRp1,0.3333333333333333,2,2,ATTTTTTCAAATCAGAATCT,0,2782471
ompRp1,0.3333333333333333,2,2,ATTTTTGTCCGTCTGGCGTT,0,2789439
ompRp1,0.3333333333333333,2,2,ATTTTTATTATCCGAGTGTG,0,2821484
ompRp1,0.3333333333333333,2,2,ATTTTGTCTCAGTCTTCGCA,0,2784383
ompRp1,0.3333333333333333,2,2,ATTTTGGCATGATACGGGTA,0,2815427
ompRp1,0.3333333333333333,2,2,ATTTTCGAAGGTCAAGGGTC,0,2811598
ompRp1,0.3333333333333333,2,2,ATTTGGCTGTTGAGGCAGTC,0,2818290
ompRp1,0.3333333333333333,2,2,ATTTGAAGGGAGGGCAAATA,0,2809680
ompRp1,0.3333333333333333,2,2,ATTTCTGGGTTGATGACTAT,0,2821739
ompRp1,0.3333333333333333,2,2,ATTTCATGATATTACCATTC,0,2811879
ompRp1,0.3333333333333333,2,2,ATTTCACGGGGAGCCTAAGG,0,2793666
ompRp1,0.3333333333333333,2,2,ATTGTGGCATGAAAGTGCCC,0,2791032
ompRp1,0.3333333333333333,2,2,ATTGTCAAGGATCCCCAGCA,0,2771532
ompRp1,0.3333333333333333,2,2,ATTGTAACTGTCAGAGCCAC,0,2812308
ompRp1,0.3333333333333333,2,2,ATTGGGTGGGTCATTTTTTC,0,2801614
ompRp1,0.3333333333333333,2,2,ATTGGGAATATGACGTTCGA,0,2802916
ompRp1,0.3333333333333333,2,2,ATTGGCCCAGTCGGGCAATA,0,2797286
ompRp1,0.3333333333333333,2,2,ATTGCGGGTTAGTATTCGAT,0,2796103
ompRp1,0.3333333333333333,2,2,ATTGATGACTGGACCTTTCA,0,2807880
ompRp1,0.3333333333333333,2,2,ATTCTTTGGCCAGGAACGCC,0,2795429
ompRp1,0.3333333333333333,2,2,ATTCTTCTGTTATTCAACTA,0,2803661
ompRp1,0.3333333333333333,2,2,ATTCTCGCTGTGAGCAGCAA,0,2785357
ompRp1,0.3333333333333333,2,2,ATTCTCCGTAATGGTGATTT,0,2788348
ompRp1,0.3333333333333333,2,2,ATTCTAAGCCCTAGTTGTGT,0,2785238
ompRp1,0.3333333333333333,2,2,ATTCGGCGACGAGTTCATTA,0,2806005
ompRp1,0.3333333333333333,2,2,ATTCGCAGCGCTGGCGAGAG,0,2804372
ompRp1,0.3333333333333333,2,2,ATTCCGCGTCATAGTAGGAA,0,2810864
ompRp1,0.3333333333333333,2,2,ATTCCCGTGTGGCCATGACA,0,2774213
ompRp1,0.3333333333333333,2,2,ATTCATTGAATACGAGTGAG,0,2781412
ompRp1,0.3333333333333333,2,2,ATTCAGGACACGCCATTAGC,0,2795048
ompRp1,0.3333333333333333,2,2,ATTCAGCGAGTTGAGGGTTC,0,2778202
ompRp1,0.3333333333333333,2,2,ATTATTATTTTTAATGAACT,0,2793209
ompRp1,0.3333333333333333,2,2,ATTATATTTTAAAGATCAAC,0,2805576
ompRp1,0.3333333333333333,2,2,ATTATAGACCGGCCGGTAGG,0,2778073
ompRp1,0.3333333333333333,2,2,ATTAGTGCCTGGGCCGGACT,0,2766813
ompRp1,0.3333333333333333,2,2,ATTAGACAGGGCAAAGAGCC,0,2776783
ompRp1,0.3333333333333333,2,2,ATTACCAGACAAGACGAATC,0,2793200
ompRp1,0.3333333333333333,2,2,ATTACAAACCGAGATGAGCA,0,2777233
ompRp1,0.3333333333333333,2,2,ATTAAGTGCATCAAGTTAGT,0,2777464
ompRp1,0.3333333333333333,2,2,ATGTTGTAAGTGCTTTGAAT,0,2774730
ompRp1,0.3333333333333333,2,2,ATGTTGATGAGCCCATAGGT,0,2818336
ompRp1,0.3333333333333333,2,2,ATGTTAAACCGCTCGTGAAT,0,2788157
ompRp1,0.3333333333333333,2,2,ATGTCGCATTTGATTAGGCT,0,2816797
ompRp1,0.3333333333333333,2,2,ATGTCCTACCCCAGTTCGAC,0,2815110
ompRp1,0.3333333333333333,2,2,ATGTACGAACGCATGGCCTA,0,2772436
ompRp1,0.3333333333333333,2,2,ATGGTAGTTAAGCCAAGCAA,0,2775248
ompRp1,0.3333333333333333,2,2,ATGGGTAAGATCAAGGGACG,0,2824270
ompRp1,0.3333333333333333,2,2,ATGGGGAGAGGATAGTCTAT,0,2777499
ompRp1,0.3333333333333333,2,2,ATGGGACGTGCAGCACGTCC,0,2817407
ompRp1,0.3333333333333333,2,2,ATGGCGAACTATGGATGTTA,0,2810602
ompRp1,0.3333333333333333,2,2,ATGGCCGACTTCTGCACTAC,0,2789318
ompRp1,0.3333333333333333,2,2,ATGCGTCGTGGCTTCGGTTG,0,2784359
ompRp1,0.3333333333333333,2,2,ATGCGTCCCCTTGGATGTGA,0,2797660
ompRp1,0.3333333333333333,2,2,ATGCGCAGCCTGGGGGATGC,0,2806997
ompRp1,0.3333333333333333,2,2,ATGCGACCGACTTTGCCTAT,0,2813844
ompRp1,0.3333333333333333,2,2,ATGCCTGTACTCAGTAAAAG,0,2820145
ompRp1,0.3333333333333333,2,2,ATGCCCTCGTGTGTTCTCAT,0,2794396
ompRp1,0.3333333333333333,2,2,ATGCATCACAGAGGAACGCA,0,2798555
ompRp1,0.3333333333333333,2,2,ATGCAGTACAAGAAGGTCGT,0,2818384
ompRp1,0.3333333333333333,2,2,ATGCACTTAATTTCGAAGGT,0,2818958
ompRp1,0.3333333333333333,2,2,ATGATTCCCAACTAAAAGTG,0,2818217
ompRp1,0.3333333333333333,2,2,ATGATGCGTTCCCATAGCGG,0,2807374
ompRp1,0.3333333333333333,2,2,ATGAGTAAATGTTAAGGCCT,0,2802947
ompRp1,0.3333333333333333,2,2,ATGAGGACAAAGACGTACAG,0,2789187
ompRp1,0.3333333333333333,2,2,ATGACGTTGACCTGGTGCTA,0,2783835
ompRp1,0.3333333333333333,2,2,ATGAATCTTGATGTCCCAAA,0,2795093
ompRp1,0.3333333333333333,2,2,ATGAAGTCTGTAATGTCTCG,0,2778555
ompRp1,0.3333333333333333,2,2,ATCTGAACGTAATAGACATA,0,2803507
ompRp1,0.3333333333333333,2,2,ATCTCTTTTCACGTCGTTGA,0,2776062
ompRp1,0.3333333333333333,2,2,ATCTCTCGTGATAGGCATTA,0,2800409
ompRp1,0.3333333333333333,2,2,ATCTCTATGGGCGGGGACTG,0,2776022
ompRp1,0.3333333333333333,2,2,ATCTCGCCCCCCGAGTGTAT,0,2801652
ompRp1,0.3333333333333333,2,2,ATCTATCGGGTACAGGCGAC,0,2805224
ompRp1,0.3333333333333333,2,2,ATCTACTGACCCTCGATTTT,0,2801878
ompRp1,0.3333333333333333,2,2,ATCTAACCGTTGTTGTATGA,0,2791652
ompRp1,0.3333333333333333,2,2,ATCGTGCGCACCAGTAGCGA,0,2806822
ompRp1,0.3333333333333333,2,2,ATCGTCTGTAATATAAATCG,0,2811354
ompRp1,0.3333333333333333,2,2,ATCGTCCCAAGGGAGTACCA,0,2774143
ompRp1,0.3333333333333333,2,2,ATCGGTCCGAGATCCAAGCC,0,2794613
ompRp1,0.3333333333333333,2,2,ATCGCCTTATGGGTTTGGGG,0,2772508
ompRp1,0.3333333333333333,2,2,ATCGACGGCGCGGACGTTTA,0,2809001
ompRp1,0.3333333333333333,2,2,ATCCTTAGAGGGTGTTCGGA,0,2799436
ompRp1,0.3333333333333333,2,2,ATCCTCTAGGCGGATCCGAA,0,2808814
ompRp1,0.3333333333333333,2,2,ATCCTCGTCTTGACATTGGT,0,2807917
ompRp1,0.3333333333333333,2,2,ATCCTACGCACGAAACCTCG,0,2785536
ompRp1,0.3333333333333333,2,2,ATCCCTATATGGTTCAGAAA,0,2803203
ompRp1,0.3333333333333333,2,2,ATCCCGTGGGCCAGGCCCGT,0,2774899
ompRp1,0.3333333333333333,2,2,ATCCATAAAGTTTAGTGCGA,0,2783354
ompRp1,0.3333333333333333,2,2,ATCCAGCTCGGATGGCGTTT,0,2788819
ompRp1,0.3333333333333333,2,2,ATCCACGCCGGGCCAAATAC,0,2819709
ompRp1,0.3333333333333333,2,2,ATCATGGCGACAATGAGCGG,0,2819755
ompRp1,0.3333333333333333,2,2,ATCAGTCTTAATGAGGGGGA,0,2809497
ompRp1,0.3333333333333333,2,2,ATCAGGGTACGCGAGACTTT,0,2769856
ompRp1,0.3333333333333333,2,2,ATCAGAAGGGGGCTTACATC,0,2802718
ompRp1,0.3333333333333333,2,2,ATCACTCGGTCTCAGCGAAT,0,2785940
ompRp1,0.3333333333333333,2,2,ATCACGGTTGCTACAGGGCA,0,2811584
ompRp1,0.3333333333333333,2,2,ATCACCGCGGTTATCTCCAT,0,2813528
ompRp1,0.3333333333333333,2,2,ATCACAACGGAAGTGCCGTC,0,2819692
ompRp1,0.3333333333333333,2,2,ATCAACGATAGGACGGTCTA,0,2773555
ompRp1,0.3333333333333333,2,2,ATCAAAGTAGGGATCTCGGG,0,2785752
ompRp1,0.3333333333333333,2,2,ATATTTGCGGATCCACCTCG,0,2801580
ompRp1,0.3333333333333333,2,2,ATATTGTACACATCGAGCTT,0,2803262
ompRp1,0.3333333333333333,2,2,ATATGTTCGAACAGGGAAGT,0,2815619
ompRp1,0.3333333333333333,2,2,ATATGGTATCCACTGGCGAC,0,2788285
ompRp1,0.3333333333333333,2,2,ATATGGCATAGTGCGTGGGA,0,2795025
ompRp1,0.3333333333333333,2,2,ATATGCAGGTGTTAATAACA,0,2784117
ompRp1,0.3333333333333333,2,2,ATATCTATAGAGCACGCTCG,0,2806971
ompRp1,0.3333333333333333,2,2,ATATCCCCTTCTGGTTCAGT,0,2789718
ompRp1,0.3333333333333333,2,2,ATATCACGCCTGACCGAAAA,0,2792663
ompRp1,0.3333333333333333,2,2,ATATAGATCTTCTGAGGTTT,0,2780954
ompRp1,0.3333333333333333,2,2,ATATAAGCTCGTATTCTTGG,0,2778911
ompRp1,0.3333333333333333,2,2,ATATAACGGGTTCTGACTAA,0,2811157
ompRp1,0.3333333333333333,2,2,ATATAAAACTTGGGCGAGAC,0,2790009
ompRp1,0.3333333333333333,2,2,ATAGTTTCGGATGCCCGACA,0,2780641
ompRp1,0.3333333333333333,2,2,ATAGTTAAACCATCACTTAG,0,2785287
ompRp1,0.3333333333333333,2,2,ATAGTAAATCGGGTTCCATA,0,2813876
ompRp1,0.3333333333333333,2,2,ATAGGTCCCCGGGCAGGTTA,0,2795745
ompRp1,0.3333333333333333,2,2,ATAGGGCGTACGCGCCACGT,0,2809414
ompRp1,0.3333333333333333,2,2,ATAGCTCCGTAATTGTATTG,0,2786504
ompRp1,0.3333333333333333,2,2,ATAGCTAGTGGTCCGGTGAA,0,2815036
ompRp1,0.3333333333333333,2,2,ATAGCCTTACGGAGCACATC,0,2817098
ompRp1,0.3333333333333333,2,2,ATAGCCCGAACTATCCGTCG,0,2802088
ompRp1,0.3333333333333333,2,2,ATAGCAGAGGATTAATGTGT,0,2783845
ompRp1,0.3333333333333333,2,2,ATAGAGTTAAGCTTGTTTCA,0,2768360
ompRp1,0.3333333333333333,2,2,ATAGAAGCGCGTTCCGGCCG,0,2781215
ompRp1,0.3333333333333333,2,2,ATACTGTTAGTAAATCGCTT,0,2790017
ompRp1,0.3333333333333333,2,2,ATACGTGTGTCAAAATTGAC,0,2820622
ompRp1,0.3333333333333333,2,2,ATACGTGCATTATCCCCCTG,0,2807646
ompRp1,0.3333333333333333,2,2,ATACGCACGAGACAAGACTA,0,2814927
ompRp1,0.3333333333333333,2,2,ATACCTATGCTATGAAGAGC,0,2793507
ompRp1,0.3333333333333333,2,2,ATACCCGTAATGTGTAGACC,0,2765897
ompRp1,0.3333333333333333,2,2,ATACCAGCAGGATAGTTTGG,0,2819581
ompRp1,0.3333333333333333,2,2,ATACATTAAATATCATCTCC,0,2810125
ompRp1,0.3333333333333333,2,2,ATACATAAGCAAATCTCCTG,0,2777425
ompRp1,0.3333333333333333,2,2,ATACAGTACTCGAATGCTGT,0,2808204
ompRp1,0.3333333333333333,2,2,ATAATGCTTTATACCGTAGA,0,2780769
ompRp1,0.3333333333333333,2,2,ATAATCCGAAAGAGGAATGT,0,2819083
ompRp1,0.3333333333333333,2,2,ATAATACATATATCAAGCCT,0,2773696
ompRp1,0.3333333333333333,2,2,ATAAGGGAGTATTCACATAA,0,2821818
ompRp1,0.3333333333333333,2,2,ATAACGTTGTGGGGTCACGC,0,2817241
ompRp1,0.3333333333333333,2,2,ATAACAGCCTTATTGCTTTC,0,2818407
ompRp1,0.3333333333333333,2,2,ATAAACATCAACTTGAATTA,0,2771500
ompRp1,0.3333333333333333,2,2,AGTTTTTTGTGAGGGTCTAC,0,2817631
ompRp1,0.3333333333333333,2,2,AGTTTTGGCATCGAGGCCAT,0,2821171
ompRp1,0.3333333333333333,2,2,AGTTTGTAGGCGCGAAACTT,0,2822994
ompRp1,0.3333333333333333,2,2,AGTTTGCCCCCCCCCGCACT,0,2797577
ompRp1,0.3333333333333333,2,2,AGTTGGTAGCCACGAACGAC,0,2798090
ompRp1,0.3333333333333333,2,2,AGTTCCGTTATGACAGGCCC,0,2798615
ompRp1,0.3333333333333333,2,2,AGTTCCGCTACAACGCATGC,0,2814614
ompRp1,0.3333333333333333,2,2,AGTTAGTTAAAGGACGGGCT,0,2801325
ompRp1,0.3333333333333333,2,2,AGTTAACTGCTGAGGTCCAG,0,2785690
ompRp1,0.3333333333333333,2,2,AGTGTTCCATATAATATTGT,0,2773427
ompRp1,0.3333333333333333,2,2,AGTGTGGTCATGTACGCTTA,0,2793228
ompRp1,0.3333333333333333,2,2,AGTGGGCAATAGGACGACCA,0,2788042
ompRp1,0.3333333333333333,2,2,AGTGCATCACGATACAAGCC,0,2778444
ompRp1,0.3333333333333333,2,2,AGTGAGGCGCGCAGTTCGGG,0,2792823
ompRp1,0.3333333333333333,2,2,AGTGAGATTATTTTCTTACT,0,2769048
ompRp1,0.3333333333333333,2,2,AGTGACACTGCGAGCCACAG,0,2779698
ompRp1,0.3333333333333333,2,2,AGTCTTTTTCAGCTAGTTTG,0,2779066
ompRp1,0.3333333333333333,2,2,AGTCTCGAGATGATCTAGGT,0,2811369
ompRp1,0.3333333333333333,2,2,AGTCGGTCAGTGTGCGTCAT,0,2803980
ompRp1,0.3333333333333333,2,2,AGTCGAATGAGTTTTCATGT,0,2816036
ompRp1,0.3333333333333333,2,2,AGTCCAGGGCGATGTCCGAT,0,2783401
ompRp1,0.3333333333333333,2,2,AGTCAAAGGACTAGACAACC,0,2783506
ompRp1,0.3333333333333333,2,2,AGTATATAGTGCCGCACCAG,0,2786098
ompRp1,0.3333333333333333,2,2,AGTATAATCTATCCGAGGGC,0,2791119
ompRp1,0.3333333333333333,2,2,AGTAGGCGTTATACACAAGT,0,2794666
ompRp1,0.3333333333333333,2,2,AGTAGATGACTATATGTTTG,0,2787226
ompRp1,0.3333333333333333,2,2,AGTAGATCTTGGCCCTGTTA,0,2775343
ompRp1,0.3333333333333333,2,2,AGTAGAAGTTACTTTGGCAG,0,2817905
ompRp1,0.3333333333333333,2,2,AGTACCCAAGGAAGAGGGCG,0,2772509
ompRp1,0.3333333333333333,2,2,AGTACCAGATTATGGGGCAG,0,2769022
ompRp1,0.3333333333333333,2,2,AGTAAGAAGTGGATAATGCC,0,2790988
ompRp1,0.3333333333333333,2,2,AGTAAATGCTAACTCAGTCT,0,2783957
ompRp1,0.3333333333333333,2,2,AGGTTTTAGCGAGAAGCACA,0,2822947
ompRp1,0.3333333333333333,2,2,AGGTTGCCGCAATTGAATTA,0,2795414
ompRp1,0.3333333333333333,2,2,AGGTTAATTCGAACGGCCGA,0,2787168
ompRp1,0.3333333333333333,2,2,AGGTTAAAATACGTTAGGCG,0,2802644
ompRp1,0.3333333333333333,2,2,AGGTGCAACGAACTTGGACG,0,2774660
ompRp1,0.3333333333333333,2,2,AGGTGAGCATACGCGTGTTT,0,2809127
ompRp1,0.3333333333333333,2,2,AGGTGAAAGTAACTCTGGTG,0,2771179
ompRp1,0.3333333333333333,2,2,AGGTCGTTCAAGTTAGAATA,0,2765739
ompRp1,0.3333333333333333,2,2,AGGTCGGTGTCTTAGTCAGT,0,2782346
ompRp1,0.3333333333333333,2,2,AGGGTTCCTCGGTTACAACT,0,2803476
ompRp1,0.3333333333333333,2,2,AGGGTTATCCGGTATAAGCC,0,2792915
ompRp1,0.3333333333333333,2,2,AGGGTGGTGGTCACACTTGG,0,2776739
ompRp1,0.3333333333333333,2,2,AGGGTATATCCAGTGGTTCC,0,2823759
ompRp1,0.3333333333333333,2,2,AGGGGTAGAACTGGATGGAA,0,2765279
ompRp1,0.3333333333333333,2,2,AGGGGTACTCGTGGTGCAAG,0,2813251
ompRp1,0.3333333333333333,2,2,AGGGGCCGGTGTGTCATTTG,0,2787887
ompRp1,0.3333333333333333,2,2,AGGGGCCAAAACGGGGCAAT,0,2813164
ompRp1,0.3333333333333333,2,2,AGGGCTAGTCATCGACCATT,0,2820565
ompRp1,0.3333333333333333,2,2,AGGGCCACGTTTAATTGTCC,0,2820170
ompRp1,0.3333333333333333,2,2,AGGGCATATTAGAGCTAGGC,0,2769114
ompRp1,0.3333333333333333,2,2,AGGCTTTGCACCCAACCATG,0,2780470
ompRp1,0.3333333333333333,2,2,AGGCTTCCGGGTACGCGGTT,0,2811198
ompRp1,0.3333333333333333,2,2,AGGCTATGTGTGCATAGCCT,0,2822625
ompRp1,0.3333333333333333,2,2,AGGCCATACACGTAAATTCC,0,2791142
ompRp1,0.3333333333333333,2,2,AGGCACCGCTCTGCCCGTCG,0,2789805
ompRp1,0.3333333333333333,2,2,AGGCAATAACTCCCGACAGA,0,2773584
ompRp1,0.3333333333333333,2,2,AGGCAAGTCTCCGAAGAGTG,0,2803195
ompRp1,0.3333333333333333,2,2,AGGATATGCTCAGCCTCGCG,0,2807496
ompRp1,0.3333333333333333,2,2,AGGATACTCTCGTCCGCTAT,0,2773611
ompRp1,0.3333333333333333,2,2,AGGATACGGGTTCGGATGTT,0,2805558
ompRp1,0.3333333333333333,2,2,AGGAGTTAATGGGCGGAGGA,0,2769157
ompRp1,0.3333333333333333,2,2,AGGAGCGTACACGGTCTATA,0,2818012
ompRp1,0.3333333333333333,2,2,AGGAGCGAGCTACCTCTGAC,0,2773671
ompRp1,0.3333333333333333,2,2,AGGAGCACCGAAAAGTGTAG,0,2794529
ompRp1,0.3333333333333333,2,2,AGGAAGGTACTCATCGTAAG,0,2769891
ompRp1,0.3333333333333333,2,2,AGGAACATGTGGTTGCGCGG,0,2823775
ompRp1,0.3333333333333333,2,2,AGCTCCTATGTTAACGGGTT,0,2817469
ompRp1,0.3333333333333333,2,2,AGCTCCCTATTTTACATCCC,0,2816153
ompRp1,0.3333333333333333,2,2,AGCTACTAGAACTAGAATCC,0,2770342
ompRp1,0.3333333333333333,2,2,AGCTACTAAAGCTTAACTCC,0,2788370
ompRp1,0.3333333333333333,2,2,AGCTACCAGTGGTAAATCGC,0,2787838
ompRp1,0.3333333333333333,2,2,AGCGTGTGTTGGTTTGTGAA,0,2774313
ompRp1,0.3333333333333333,2,2,AGCGTCTGCGGCCTAGAGCG,0,2797707
ompRp1,0.3333333333333333,2,2,AGCGTCGATTTGTATTTCTT,0,2789575
ompRp1,0.3333333333333333,2,2,AGCGTAACGTACCCTTCTTT,0,2792329
ompRp1,0.3333333333333333,2,2,AGCGGGAATGGCGCATTCAC,0,2788162
ompRp1,0.3333333333333333,2,2,AGCGGCGAATATCTACCAAA,0,2790702
ompRp1,0.3333333333333333,2,2,AGCGCCTGTCCTAATAAGTA,0,2788582
ompRp1,0.3333333333333333,2,2,AGCGATCTTTTGAGCGCCTA,0,2797594
ompRp1,0.3333333333333333,2,2,AGCGATCACTCTTCTCTTAT,0,2801682
ompRp1,0.3333333333333333,2,2,AGCCTCGATAACAAGGACCT,0,2808665
ompRp1,0.3333333333333333,2,2,AGCCGTACAGTCAAATACAC,0,2807592
ompRp1,0.3333333333333333,2,2,AGCCGCAGTACGCGGGGAAC,0,2791322
ompRp1,0.3333333333333333,2,2,AGCCCTTTGGGTCCCAAACC,0,2800731
ompRp1,0.3333333333333333,2,2,AGCCCTTGGTTAAGATAATC,0,2801481
ompRp1,0.3333333333333333,2,2,AGCCATGGGGGGTGTGTATT,0,2810095
ompRp1,0.3333333333333333,2,2,AGCCACTGATCTATAATGAG,0,2792199
ompRp1,0.3333333333333333,2,2,AGCCAACGTAACTGCGATAG,0,2823125
ompRp1,0.3333333333333333,2,2,AGCATGGACTAAGAAAACTA,0,2809574
ompRp1,0.3333333333333333,2,2,AGCATCACGAGTTCCTGCAT,0,2793443
ompRp1,0.3333333333333333,2,2,AGCATATATCCGTATGGGTA,0,2809348
ompRp1,0.3333333333333333,2,2,AGCATAAGTAACGTAGAACC,0,2784680
ompRp1,0.3333333333333333,2,2,AGCAGTCCGCAAATGTCGCG,0,2793205
ompRp1,0.3333333333333333,2,2,AGCAGAGCTGGTCTAAGTGA,0,2769954
ompRp1,0.3333333333333333,2,2,AGCACTGAAGAAGGGTTTGC,0,2788240
ompRp1,0.3333333333333333,2,2,AGCACTCAACAGCTAGGGAC,0,2799764
ompRp1,0.3333333333333333,2,2,AGCACATTGATCGCGAGTTT,0,2786292
ompRp1,0.3333333333333333,2,2,AGATTGGGCGCGATGATGTA,0,2782902
ompRp1,0.3333333333333333,2,2,AGATGGCCATAGAAGCCGGT,0,2786519
ompRp1,0.3333333333333333,2,2,AGATATGCCTCATCGGATTA,0,2824586
ompRp1,0.3333333333333333,2,2,AGATAGAACCGACGCTTACG,0,2797887
ompRp1,0.3333333333333333,2,2,AGATACCCAGGCCAGCAGAG,0,2770590
ompRp1,0.3333333333333333,2,2,AGAGGGGTAATTAGGATCGT,0,2772580
ompRp1,0.3333333333333333,2,2,AGAGGGAACTAACTCGTACT,0,2798394
ompRp1,0.3333333333333333,2,2,AGAGGACGTAGTAGATGGTT,0,2784201
ompRp1,0.3333333333333333,2,2,AGAGCTGCACGGGGGATGGA,0,2781731
ompRp1,0.3333333333333333,2,2,AGAGATGAGAAAATCGCGGT,0,2801903
ompRp1,0.3333333333333333,2,2,AGAGAGGGATGTCCAACGTT,0,2814694
ompRp1,0.3333333333333333,2,2,AGAGAGCGGTTAGATATATA,0,2788696
ompRp1,0.3333333333333333,2,2,AGAGACTGTGAGAACAACGT,0,2820187
ompRp1,0.3333333333333333,2,2,AGAGACCGTTAACGGTAGTG,0,2792876
ompRp1,0.3333333333333333,2,2,AGAGACAGGCAGAACCTCGT,0,2767371
ompRp1,0.3333333333333333,2,2,AGAGAAGGGGTGACCTTAAC,0,2807438
ompRp1,0.3333333333333333,2,2,AGACTGAGAGGTGCGTAATG,0,2778950
ompRp1,0.3333333333333333,2,2,AGACTCGGAAGAGCTTACAA,0,2783961
ompRp1,0.3333333333333333,2,2,AGACTCCCTCCGTAACGGGC,0,2799999
ompRp1,0.3333333333333333,2,2,AGACTAGAGTGAAGTCTTGT,0,2767525
ompRp1,0.3333333333333333,2,2,AGACAGCAACACGTGTGCGA,0,2779260
ompRp1,0.3333333333333333,2,2,AGACACAACGTCGAAGATAC,0,2794789
ompRp1,0.3333333333333333,2,2,AGACAATAAACCAACATCCT,0,2798534
ompRp1,0.3333333333333333,2,2,AGAATGGGCAGGAATCAGCT,0,2786712
ompRp1,0.3333333333333333,2,2,AGAATCCGAGATCTAACCAT,0,2807289
ompRp1,0.3333333333333333,2,2,AGAATAAGTCCTGGGGTACA,0,2811153
ompRp1,0.3333333333333333,2,2,AGAAGAACAATTGTCTCCGG,0,2821091
ompRp1,0.3333333333333333,2,2,AGAACGTACATAGTATGCCC,0,2783269
ompRp1,0.3333333333333333,2,2,AGAACGACGCGATATACTCC,0,2813016
ompRp1,0.3333333333333333,2,2,AGAAATTAGTGACGCCGGCT,0,2807134
ompRp1,0.3333333333333333,2,2,ACTTGGTTCAGATTGACTTG,0,2817777
ompRp1,0.3333333333333333,2,2,ACTTGATCGGAGAGGACCCC,0,2808562
ompRp1,0.3333333333333333,2,2,ACTTCGACACCCGAAACTGG,0,2790651
ompRp1,0.3333333333333333,2,2,ACTTCCTACCAGACCTACAG,0,2771060
ompRp1,0.3333333333333333,2,2,ACTTCCGCATCTCTATCTTG,0,2781584
ompRp1,0.3333333333333333,2,2,ACTTCCCCCCTTGATGACAT,0,2783480
ompRp1,0.3333333333333333,2,2,ACTTAGCCCCGGTTTCGAAA,0,2786361
ompRp1,0.3333333333333333,2,2,ACTGTTTTCAGGTTTGGTCC,0,2783945
ompRp1,0.3333333333333333,2,2,ACTGTAGGGGTTCCGAATCC,0,2805247
ompRp1,0.3333333333333333,2,2,ACTGGCCGACACCAGCGCAG,0,2809963
ompRp1,0.3333333333333333,2,2,ACTGGATCTAGGAGCTTGTT,0,2793271
ompRp1,0.3333333333333333,2,2,ACTGGAACTAGGCTGCTACG,0,2822249
ompRp1,0.3333333333333333,2,2,ACTGCGGCATACGGGTCCAT,0,2783388
ompRp1,0.3333333333333333,2,2,ACTCTCTCAAATTGGAGAGA,0,2771873
ompRp1,0.3333333333333333,2,2,ACTCTAGAGTCCAGTCTTCG,0,2766473
ompRp1,0.3333333333333333,2,2,ACTCGTGAGGAAATTTCATT,0,2803420
ompRp1,0.3333333333333333,2,2,ACTCGTGAAGAAAAAATGGA,0,2816086
ompRp1,0.3333333333333333,2,2,ACTCGATGTGGAAAGGGACT,0,2771113
ompRp1,0.3333333333333333,2,2,ACTCGATACCAGATTTCGGT,0,2769288
ompRp1,0.3333333333333333,2,2,ACTCGAGTCCTTCGCTCATG,0,2795835
ompRp1,0.3333333333333333,2,2,ACTCCGACTCGGGTATGAGA,0,2765605
ompRp1,0.3333333333333333,2,2,ACTCAGTTGTGGACCTCCCA,0,2775128
ompRp1,0.3333333333333333,2,2,ACTCAGAGAGGTCTCCTTTT,0,2783537
ompRp1,0.3333333333333333,2,2,ACTCACTTCACGCCGATAGA,0,2804062
ompRp1,0.3333333333333333,2,2,ACTCAAGTGACGATTCAGCC,0,2817379
ompRp1,0.3333333333333333,2,2,ACTATGTCTTCATTTTCCTT,0,2800819
ompRp1,0.3333333333333333,2,2,ACTAGAAGGCTGCTGCTCCT,0,2823729
ompRp1,0.3333333333333333,2,2,ACTACGCGCCAGACTATGTT,0,2772375
ompRp1,0.3333333333333333,2,2,ACTACGCCCCCTTAAGATGG,0,2782007
ompRp1,0.3333333333333333,2,2,ACTAACGGGGTTTTTCACCT,0,2772010
ompRp1,0.3333333333333333,2,2,ACGTTGAGACTAGAAAGGAT,0,2798076
ompRp1,0.3333333333333333,2,2,ACGTTCTTAAAAGTGAAGAG,0,2807052
ompRp1,0.3333333333333333,2,2,ACGTGTATCTGAGCAGCGAT,0,2766318
ompRp1,0.3333333333333333,2,2,ACGTGCTTGCTTAGCGGAGC,0,2807942
ompRp1,0.3333333333333333,2,2,ACGTCTGATAAGGATTCACC,0,2807240
ompRp1,0.3333333333333333,2,2,ACGTCTAGGACAGGTTGGAG,0,2793619
ompRp1,0.3333333333333333,2,2,ACGTCCTTCGAATCTAGAGG,0,2789616
ompRp1,0.3333333333333333,2,2,ACGTCCTTAGTTGCCCGTGG,0,2798016
ompRp1,0.3333333333333333,2,2,ACGTATGTAGCTGGGATAGA,0,2789628
ompRp1,0.3333333333333333,2,2,ACGTACCCTCCCCAATCGCC,0,2809598
ompRp1,0.3333333333333333,2,2,ACGTAAGTAGTGGTGTGATA,0,2801690
ompRp1,0.3333333333333333,2,2,ACGGTCCATCCGCAAAAGTA,0,2795060
ompRp1,0.3333333333333333,2,2,ACGGGGCGAGTCTCTAACGT,0,2820608
ompRp1,0.3333333333333333,2,2,ACGGCGATGGACTTTGATCA,0,2784220
ompRp1,0.3333333333333333,2,2,ACGGCCGCGCCAATAAAACA,0,2784756
ompRp1,0.3333333333333333,2,2,ACGGATTATTGCACTATAGG,0,2823558
ompRp1,0.3333333333333333,2,2,ACGGACGAACCACCAGAAAT,0,2780074
ompRp1,0.3333333333333333,2,2,ACGGAATTCTGGGTCATATT,0,2811864
ompRp1,0.3333333333333333,2,2,ACGCTAGCCCGCACAACACA,0,2796799
ompRp1,0.3333333333333333,2,2,ACGCCCGAAAATTATTCTTT,0,2818381
ompRp1,0.3333333333333333,2,2,ACGCCATAATCACACTCGGC,0,2780613
ompRp1,0.3333333333333333,2,2,ACGCATTTGCAAAACTGGTA,0,2806539
ompRp1,0.3333333333333333,2,2,ACGCAGGAACTTTGTAAACT,0,2815851
ompRp1,0.3333333333333333,2,2,ACGAGCTAGTGTAATCTGAC,0,2804294
ompRp1,0.3333333333333333,2,2,ACGAGCGCTGTGCGATACGC,0,2823324
ompRp1,0.3333333333333333,2,2,ACGAATAGTGACGATTCGAC,0,2792313
ompRp1,0.3333333333333333,2,2,ACGAACTGACGTCATGTGAT,0,2802800
ompRp1,0.3333333333333333,2,2,ACCTTGCATCGGACATCAAT,0,2766744
ompRp1,0.3333333333333333,2,2,ACCTTATGCCTTGGGTCACA,0,2804593
ompRp1,0.3333333333333333,2,2,ACCTCTGTGGTCGTGGTTTT,0,2767120
ompRp1,0.3333333333333333,2,2,ACCTCTATGGATTGACGCAT,0,2778576
ompRp1,0.3333333333333333,2,2,ACCTAGTTCTCCGTACATCT,0,2801146
ompRp1,0.3333333333333333,2,2,ACCGTTACGCTATAAGCACC,0,2795845
ompRp1,0.3333333333333333,2,2,ACCGGCTCAGTGGGCACTCC,0,2800729
ompRp1,0.3333333333333333,2,2,ACCGCCAGTCTTTAGAGTAT,0,2800174
ompRp1,0.3333333333333333,2,2,ACCGATACACGTAATAAACA,0,2813258
ompRp1,0.3333333333333333,2,2,ACCGAGTTATGGTGATTCCG,0,2781161
ompRp1,0.3333333333333333,2,2,ACCGAGGAATCTAGGATCGG,0,2822562
ompRp1,0.3333333333333333,2,2,ACCCTTGATAAGTTAGAATG,0,2817276
ompRp1,0.3333333333333333,2,2,ACCCTGTTACGTTATGTCTC,0,2798797
ompRp1,0.3333333333333333,2,2,ACCCGGTCGCGAGGCAACCC,0,2817965
ompRp1,0.3333333333333333,2,2,ACCCGGTAGGGTCTTCGTGT,0,2793851
ompRp1,0.3333333333333333,2,2,ACCCGCGACCGGTGGTACCA,0,2822602
ompRp1,0.3333333333333333,2,2,ACCCGACTGAATTGGCGGCT,0,2796569
ompRp1,0.3333333333333333,2,2,ACCCCCGAAATCAAGGGTTC,0,2775297
ompRp1,0.3333333333333333,2,2,ACCCCCAGACGTGTGACCGA,0,2766838
ompRp1,0.3333333333333333,2,2,ACCCAGGTCGCTACTTTAAC,0,2818860
ompRp1,0.3333333333333333,2,2,ACCCAGCTGGTGTCCTGAAG,0,2794743
ompRp1,0.3333333333333333,2,2,ACCATGCCGCCCACTGGAGC,0,2806036
ompRp1,0.3333333333333333,2,2,ACCATGCAAGGTGAATACGG,0,2799584
ompRp1,0.3333333333333333,2,2,ACCAGTTTGGCAACTGTGTA,0,2791045
ompRp1,0.3333333333333333,2,2,ACCAGTGTTGCATAAGCGGG,0,2823343
ompRp1,0.3333333333333333,2,2,ACCACTCAATTAGACCAGAT,0,2793136
ompRp1,0.3333333333333333,2,2,ACCACAGGTTTCAAGCTCCA,0,2792103
ompRp1,0.3333333333333333,2,2,ACCACACTCAGAGCTGCTTA,0,2776404
ompRp1,0.3333333333333333,2,2,ACATTTGCAGAGGGCCTACG,0,2788450
ompRp1,0.3333333333333333,2,2,ACATTGTCGTACGGGCTAAA,0,2806483
ompRp1,0.3333333333333333,2,2,ACATTCCATTGGTTCTACTC,0,2818863
ompRp1,0.3333333333333333,2,2,ACATTATATAGGACATGCTG,0,2793562
ompRp1,0.3333333333333333,2,2,ACATGTCTGGTTATCCTGTG,0,2805074
ompRp1,0.3333333333333333,2,2,ACATGGGATCTCGGCGGAAT,0,2800057
ompRp1,0.3333333333333333,2,2,ACATGGATTATCTCTTCCTA,0,2772511
ompRp1,0.3333333333333333,2,2,ACATGCTCCGCTATGTGTTA,0,2816869
ompRp1,0.3333333333333333,2,2,ACATGCAGGCCCTTTTCACA,0,2800700
ompRp1,0.3333333333333333,2,2,ACATCACTGTCTAAAGACGC,0,2798732
ompRp1,0.3333333333333333,2,2,ACATATAGTTATCCCAACAT,0,2787179
ompRp1,0.3333333333333333,2,2,ACATAGTTATAAAAGACGTG,0,2773046
ompRp1,0.3333333333333333,2,2,ACATAAATCGCGTTGTGCCG,0,2774944
ompRp1,0.3333333333333333,2,2,ACAGTTAGACCTCTCACGTA,0,2797320
ompRp1,0.3333333333333333,2,2,ACAGTGCTTATTTGGATCTT,0,2805648
ompRp1,0.3333333333333333,2,2,ACAGTGCCCTCGGTCCCGAG,0,2814565
ompRp1,0.3333333333333333,2,2,ACAGTAGGTTCTTCCACGGT,0,2777856
ompRp1,0.3333333333333333,2,2,ACAGTACCAGTATTTTCCCA,0,2767369
ompRp1,0.3333333333333333,2,2,ACAGGCTTGAGAAAACGTCA,0,2799457
ompRp1,0.3333333333333333,2,2,ACAGGCCCAAAGTAGCCGAT,0,2775478
ompRp1,0.3333333333333333,2,2,ACAGGACGGACCCTCTCCGA,0,2780581
ompRp1,0.3333333333333333,2,2,ACAGCCAGTCTCAGCACGTG,0,2787592
ompRp1,0.3333333333333333,2,2,ACAGCATGTTACAATAGATG,0,2777765
ompRp1,0.3333333333333333,2,2,ACAGCACGGTCCCTCCTGTA,0,2792107
ompRp1,0.3333333333333333,2,2,ACAGAGTTCTAGGCCATCAT,0,2811560
ompRp1,0.3333333333333333,2,2,ACAGAGACCGGTTCCGGCGG,0,2797079
ompRp1,0.3333333333333333,2,2,ACAGACTGACGCTCTGAAAT,0,2772340
ompRp1,0.3333333333333333,2,2,ACAGAAGCTTCTTATCTTTT,0,2809629
ompRp1,0.3333333333333333,2,2,ACACTTATGCTGACTCTATG,0,2799575
ompRp1,0.3333333333333333,2,2,ACACGGATTGATCCAAAATT,0,2783657
ompRp1,0.3333333333333333,2,2,ACACGACGCGATGGGATGGC,0,2769831
ompRp1,0.3333333333333333,2,2,ACACCGGTCACGACCTGTCA,0,2771541
ompRp1,0.3333333333333333,2,2,ACACCCGTCATGGTCACATG,0,2774034
ompRp1,0.3333333333333333,2,2,ACACATGGGACATATGTATT,0,2802211
ompRp1,0.3333333333333333,2,2,ACACACCTTTGGTTCTGCTC,0,2803915
ompRp1,0.3333333333333333,2,2,ACACAAACAAAGTGCTTGTA,0,2781937
ompRp1,0.3333333333333333,2,2,ACAATGATTGAGTTCGTCAA,0,2806760
ompRp1,0.3333333333333333,2,2,ACAATCGCGTAGTTCCTCAA,0,2802426
ompRp1,0.3333333333333333,2,2,ACAATACTCATGCCCCCGGG,0,2820632
ompRp1,0.3333333333333333,2,2,ACAAGTTTAAATCTGGTGCT,0,2770829
ompRp1,0.3333333333333333,2,2,ACAAGGTCAGCGAAATGTTT,0,2787495
ompRp1,0.3333333333333333,2,2,ACAACGTAGCAAAGGTTATA,0,2775488
ompRp1,0.3333333333333333,2,2,ACAACCAGTTGTCGGAAAAG,0,2766419
ompRp1,0.3333333333333333,2,2,AATTGTGCGACAAGAGCTCA,0,2776041
ompRp1,0.3333333333333333,2,2,AATTGTCTTTGGTCGCGGTT,0,2779944
ompRp1,0.3333333333333333,2,2,AATTGCATACGGTTGCCGTG,0,2823005
ompRp1,0.3333333333333333,2,2,AATTCGGATGGAGCAAATTG,0,2785769
ompRp1,0.3333333333333333,2,2,AATTCCTTGTTTCTTTGCCG,0,2806962
ompRp1,0.3333333333333333,2,2,AATTCATATGAGTACGGCTT,0,2772652
ompRp1,0.3333333333333333,2,2,AATTATCTCGATGGCGGTGA,0,2790278
ompRp1,0.3333333333333333,2,2,AATGTTGGTCGTAGCCCGCA,0,2775955
ompRp1,0.3333333333333333,2,2,AATGTGGCTTCGCGGCAATA,0,2771444
ompRp1,0.3333333333333333,2,2,AATGTGCATAGCCAAAATGA,0,2781787
ompRp1,0.3333333333333333,2,2,AATGTGAGCTTCTTCATTTT,0,2784763
ompRp1,0.3333333333333333,2,2,AATGGCTGTCTCCTAGTGCT,0,2768866
ompRp1,0.3333333333333333,2,2,AATGCTCGCCCGGTGCATCG,0,2804226
ompRp1,0.3333333333333333,2,2,AATGCTCATCACCCGCCTCG,0,2821754
ompRp1,0.3333333333333333,2,2,AATGCTCAGGGTGGGCAGGC,0,2771369
ompRp1,0.3333333333333333,2,2,AATGCTATAAAATGATCTGA,0,2795119
ompRp1,0.3333333333333333,2,2,AATGCCACAAAGATACCAGA,0,2790742
ompRp1,0.3333333333333333,2,2,AATGACTACTCCTCTTATTT,0,2802826
ompRp1,0.3333333333333333,2,2,AATGAATCCCATGAGATCAA,0,2788211
ompRp1,0.3333333333333333,2,2,AATGAAATGAGATTGACGCG,0,2794202
ompRp1,0.3333333333333333,2,2,AATCTTTTGCTTCGTGGGTT,0,2799445
ompRp1,0.3333333333333333,2,2,AATCGCTCCGACTCCGGAGA,0,2808032
ompRp1,0.3333333333333333,2,2,AATCCCCTGATCGCGACGGC,0,2803189
ompRp1,0.3333333333333333,2,2,AATCATAGCAGGGTAGCGGA,0,2810936
ompRp1,0.3333333333333333,2,2,AATCAGACCTGAGTGTTGTT,0,2810400
ompRp1,0.3333333333333333,2,2,AATCACTTACCCGTCATTAA,0,2795578
ompRp1,0.3333333333333333,2,2,AATCAACCCCCTTTGTTGGT,0,2815166
ompRp1,0.3333333333333333,2,2,AATATTGTGCCTGTATGTAT,0,2820877
ompRp1,0.3333333333333333,2,2,AATATTGGTTGCGGAGTAAC,0,2814715
ompRp1,0.3333333333333333,2,2,AATATGATCGTGAGGTAGCC,0,2782652
ompRp1,0.3333333333333333,2,2,AATATCAAGGGTGGGCTGAT,0,2768555
ompRp1,0.3333333333333333,2,2,AATATACCTGGACCTGAAAG,0,2812380
ompRp1,0.3333333333333333,2,2,AATAGGTCGCAGTTCCGTGT,0,2815347
ompRp1,0.3333333333333333,2,2,AATAGGGTCACGCCCGGCAA,0,2783283
ompRp1,0.3333333333333333,2,2,AATAGGGGTGTCAGGCAAAC,0,2787612
ompRp1,0.3333333333333333,2,2,AATAGGCTCAGAGTTGGTGT,0,2804014
ompRp1,0.3333333333333333,2,2,AATAGACTTCGCCACAGAGA,0,2788161
ompRp1,0.3333333333333333,2,2,AATACCCCCGCGTACTCAAG,0,2815273
ompRp1,0.3333333333333333,2,2,AATACCCACGCTCTGAGTTC,0,2805505
ompRp1,0.3333333333333333,2,2,AATACAAGATCTTTTGTACA,0,2765989
ompRp1,0.3333333333333333,2,2,AAGTGTAACCTCACGTTTGT,0,2769919
ompRp1,0.3333333333333333,2,2,AAGTGGCACTAGGGTCCCCA,0,2780254
ompRp1,0.3333333333333333,2,2,AAGTGAACTCCGGGCGGGTG,0,2778942
ompRp1,0.3333333333333333,2,2,AAGTCGAGGAGCGGAGACGT,0,2800075
ompRp1,0.3333333333333333,2,2,AAGTATGGCGACTCATTTAT,0,2816449
ompRp1,0.3333333333333333,2,2,AAGGTCGTGTGTCCCATGGA,0,2823478
ompRp1,0.3333333333333333,2,2,AAGGTAAACAGTGAGCGTAA,0,2781417
ompRp1,0.3333333333333333,2,2,AAGGGCGTAAGCCTAGGTGC,0,2789449
ompRp1,0.3333333333333333,2,2,AAGGATAGCGACCCCGTTGT,0,2803138
ompRp1,0.3333333333333333,2,2,AAGCTTATGCTATTGATATA,0,2815790
ompRp1,0.3333333333333333,2,2,AAGCTGTCCCATTTACATGA,0,2792035
ompRp1,0.3333333333333333,2,2,AAGCTCGTATGTGCTTGTCA,0,2771295
ompRp1,0.3333333333333333,2,2,AAGCTAGCCATCACGGTATG,0,2787749
ompRp1,0.3333333333333333,2,2,AAGCGTCCGCTAGGAGCAAA,0,2811934
ompRp1,0.3333333333333333,2,2,AAGCGATGCTACGTTTATCA,0,2819575
ompRp1,0.3333333333333333,2,2,AAGCGAAATATAAGAGTCTT,0,2780764
ompRp1,0.3333333333333333,2,2,AAGCCGTTGACAAGTTGGCC,0,2777468
ompRp1,0.3333333333333333,2,2,AAGCATCAAAGCTGATACGC,0,2824408
ompRp1,0.3333333333333333,2,2,AAGCAGCGGAAGACCCGCGT,0,2791541
ompRp1,0.3333333333333333,2,2,AAGATGACCCCTTTTTATAT,0,2786678
ompRp1,0.3333333333333333,2,2,AAGATCTGGCCCACAAAAGG,0,2813233
ompRp1,0.3333333333333333,2,2,AAGATCCGCCGTGAGAGGAA,0,2796691
ompRp1,0.3333333333333333,2,2,AAGAGTATTTAGTCACGGCT,0,2775253
ompRp1,0.3333333333333333,2,2,AAGAGTACCGAGGTAATACA,0,2808039
ompRp1,0.3333333333333333,2,2,AAGAGGATCTCTAGTTGACA,0,2824048
ompRp1,0.3333333333333333,2,2,AAGAGCATCAGGATGCTGTG,0,2777541
ompRp1,0.3333333333333333,2,2,AAGACGTGAGCTATGTCTTT,0,2794571
ompRp1,0.3333333333333333,2,2,AAGACGCAACGTGAGTGGGC,0,2783227
ompRp1,0.3333333333333333,2,2,AAGAAGCGGTCACCGATAGT,0,2819977
ompRp1,0.3333333333333333,2,2,AACTTTTCAGGAGAGTTCCA,0,2786867
ompRp1,0.3333333333333333,2,2,AACTTCTTCGTGTGAATGAT,0,2783129
ompRp1,0.3333333333333333,2,2,AACTTAAGCTTATTTTTGAC,0,2820929
ompRp1,0.3333333333333333,2,2,AACTCGCCTGAGAAACCCCC,0,2789620
ompRp1,0.3333333333333333,2,2,AACTATCACAGGAGATAAGC,0,2778855
ompRp1,0.3333333333333333,2,2,AACGTTCGGGACGGATCTCA,0,2811551
ompRp1,0.3333333333333333,2,2,AACGTATTCAACCTTACTCC,0,2774488
ompRp1,0.3333333333333333,2,2,AACGGCTCAGCGACCTCAAT,0,2820844
ompRp1,0.3333333333333333,2,2,AACGCCAGTCCTTCGGACTT,0,2766373
ompRp1,0.3333333333333333,2,2,AACGCATACGAGAAGCGTCA,0,2819620
ompRp1,0.3333333333333333,2,2,AACGCACTTATCGAGATGGA,0,2775468
ompRp1,0.3333333333333333,2,2,AACGATCCAAGCCTGGAGGA,0,2787723
ompRp1,0.3333333333333333,2,2,AACGAGGATACGCGGGTCTT,0,2781268
ompRp1,0.3333333333333333,2,2,AACGAACAATACAACTATTG,0,2770630
ompRp1,0.3333333333333333,2,2,AACGAAAGTTCACGCTTAAG,0,2823340
ompRp1,0.3333333333333333,2,2,AACCTATAATGCGTTGGTGC,0,2815092
ompRp1,0.3333333333333333,2,2,AACCTAAAGTTAAGGGCACT,0,2786771
ompRp1,0.3333333333333333,2,2,AACCGTTTTTCGATTAAGTT,0,2793793
ompRp1,0.3333333333333333,2,2,AACCGTTAGCGGTTCCTGTG,0,2807652
ompRp1,0.3333333333333333,2,2,AACCGGTGAACGATCGCTGA,0,2785222
ompRp1,0.3333333333333333,2,2,AACCCGTGTCTTTGAGCTTG,0,2817805
ompRp1,0.3333333333333333,2,2,AACCCCGACTCGACTTTGCG,0,2806590
ompRp1,0.3333333333333333,2,2,AACCCCCAGTTATAAGTAGA,0,2807542
ompRp1,0.3333333333333333,2,2,AACCCAGGCCTAGGTATAAT,0,2768469
ompRp1,0.3333333333333333,2,2,AACCAGTTGCCTCTCACAGG,0,2779577
ompRp1,0.3333333333333333,2,2,AACCAGTTACTACTATTCAA,0,2802608
ompRp1,0.3333333333333333,2,2,AACCACCCGCGACCGCCCCT,0,2783699
ompRp1,0.3333333333333333,2,2,AACCAAATCACGCCCTTGCT,0,2765915
ompRp1,0.3333333333333333,2,2,AACCAAACCCATTAAGCTAA,0,2794110
ompRp1,0.3333333333333333,2,2,AACATTTGTTGTCCGTCGGC,0,2774349
ompRp1,0.3333333333333333,2,2,AACATCGAAAAGGCCGCGGG,0,2796703
ompRp1,0.3333333333333333,2,2,AACATACGGGGGGAAGGCCT,0,2820626
ompRp1,0.3333333333333333,2,2,AACATAACAGGCCTTTTCAA,0,2807671
ompRp1,0.3333333333333333,2,2,AACAGTCAACGATCGCCGCG,0,2810893
ompRp1,0.3333333333333333,2,2,AACACTGGGATCACCAGCAT,0,2820081
ompRp1,0.3333333333333333,2,2,AACACCCGAGGGAATTTCCT,0,2773564
ompRp1,0.3333333333333333,2,2,AACAATTGCCACCATCGGAC,0,2790850
ompRp1,0.3333333333333333,2,2,AACAAGGTTCACCGTCGCTT,0,2817021
ompRp1,0.3333333333333333,2,2,AAATTTTTGAGACAAATGCA,0,2772079
ompRp1,0.3333333333333333,2,2,AAATTTGCGCAGGAATTAGT,0,2803578
ompRp1,0.3333333333333333,2,2,AAATTAGAGAGATAGGGGGG,0,2793735
ompRp1,0.3333333333333333,2,2,AAATGGCCATCTGAGGGTTC,0,2816785
ompRp1,0.3333333333333333,2,2,AAATGGCAAGCGAGACCCCA,0,2789576
ompRp1,0.3333333333333333,2,2,AAATGCAGATCACACGTCCC,0,2783923
ompRp1,0.3333333333333333,2,2,AAATATTTAAAATATTTATG,0,2802669
ompRp1,0.3333333333333333,2,2,AAATATACCACTTTGTGTCA,0,2785440
ompRp1,0.3333333333333333,2,2,AAATACCTCGAACTAACGTA,0,2793939
ompRp1,0.3333333333333333,2,2,AAATAATAATGTACCCTGAC,0,2770755
ompRp1,0.3333333333333333,2,2,AAAGTAGTCTTCGTGTGGTT,0,2780452
ompRp1,0.3333333333333333,2,2,AAAGTAGTATATGGTCATAG,0,2774424
ompRp1,0.3333333333333333,2,2,AAAGCTGTCAAGTATATACA,0,2770040
ompRp1,0.3333333333333333,2,2,AAAGCTGGTTAGAATCTCGA,0,2789286
ompRp1,0.3333333333333333,2,2,AAAGCTAAACCAGATGTTGA,0,2793652
ompRp1,0.3333333333333333,2,2,AAAGCCACATAGAATCCCCA,0,2800557
ompRp1,0.3333333333333333,2,2,AAAGATATGCTGGTTCTATG,0,2810630
ompRp1,0.3333333333333333,2,2,AAACGTGTTTTCGAGAAGCC,0,2782210
ompRp1,0.3333333333333333,2,2,AAACGTGATACATTATGCGT,0,2768025
ompRp1,0.3333333333333333,2,2,AAACGGACTAGCGTGAGCGC,0,2810005
ompRp1,0.3333333333333333,2,2,AAACGATTGGAATAGAGGGG,0,2790282
ompRp1,0.3333333333333333,2,2,AAACCTGTCTGTTTACCTCG,0,2776591
ompRp1,0.3333333333333333,2,2,AAACCACAGGTCCCCCCTTG,0,2779302
ompRp1,0.3333333333333333,2,2,AAACACCGGCAAGACCCCAC,0,2818125
ompRp1,0.3333333333333333,2,2,AAAATTACCGTTTCCTTGCC,0,2789092
ompRp1,0.3333333333333333,2,2,AAAATGACCAGTTCGTGTAG,0,2805293
ompRp1,0.3333333333333333,2,2,AAAATCGCAACCCGTATGGC,0,2815045
ompRp1,0.3333333333333333,2,2,AAAAGTAACGACGTTCTTAT,0,2777808
ompRp1,0.3333333333333333,2,2,AAAAGCCTAAGGTGAGGAAG,0,2774974
ompRp1,0.3333333333333333,2,2,AAAAGATTCAAGTGTGGTGG,0,2779592
ompRp1,0.3333333333333333,2,2,AAAAATACATGGGTTACCTT,0,2814092
ompRp1,0.3333333333333333,2,2,AAAAAGCAGGATGGAAAGCT,0,2783137
ompRp1,0.5,1,1,TTTTTTAGTTGAGTTAATTG,0,2814355
ompRp1,0.5,1,1,TTTTTGATTCTCTGCAACGG,0,2779748
ompRp1,0.5,1,1,TTTTTATAATTCGGAGGTCT,0,2800684
ompRp1,0.5,1,1,TTTTTACCATCCTCTCGTCA,0,2817126
ompRp1,0.5,1,1,TTTTGGTCAGTCTAAGCGGG,0,2800830
ompRp1,0.5,1,1,TTTTGGCCTGCTTCGGCGAG,0,2816186
ompRp1,0.5,1,1,TTTTGGCAGAAGAAATCGTA,0,2770743
ompRp1,0.5,1,1,TTTTATCGGAGTATGCACAA,0,2769079
ompRp1,0.5,1,1,TTTTATAGAAACAACTTCTC,0,2774361
ompRp1,0.5,1,1,TTTTAGTGGACAAGGCTCCT,0,2789003
ompRp1,0.5,1,1,TTTTAGCCGACACAGTAGTG,0,2802079
ompRp1,0.5,1,1,TTTGTTGGTGTCTTTAGCGG,0,2814650
ompRp1,0.5,1,1,TTTGTGTCGCTCTCAAGATA,0,2822752
ompRp1,0.5,1,1,TTTGTAGCGGTCATTACACT,0,2767712
ompRp1,0.5,1,1,TTTGGTCTTCGGTAATTGCA,0,2767474
ompRp1,0.5,1,1,TTTGGTACGTCAACCTGGTC,0,2811830
ompRp1,0.5,1,1,TTTGGCAATATATTCTTAAA,0,2783345
ompRp1,0.5,1,1,TTTGGAGGTAAAGAGGCGAA,0,2806293
ompRp1,0.5,1,1,TTTGGACCGACTCAGGGCCC,0,2814982
ompRp1,0.5,1,1,TTTGCTCGCCCCAGGCTTTC,0,2818246
ompRp1,0.5,1,1,TTTGCGTAGATACATCTCCA,0,2775144
ompRp1,0.5,1,1,TTTGCCAAGCTATAGTCGGT,0,2806147
ompRp1,0.5,1,1,TTTGAATAAGGCGTCACACT,0,2811557
ompRp1,0.5,1,1,TTTCTGTGTCTTCGCAGAAA,0,2772505
ompRp1,0.5,1,1,TTTCTACGGATATCCCCGTT,0,2790258
ompRp1,0.5,1,1,TTTCGTGTGCGAGTGGTTCT,0,2821989
ompRp1,0.5,1,1,TTTCGGTCTATGCACGGGAT,0,2766864
ompRp1,0.5,1,1,TTTCGGACTTACCTGCACAT,0,2796725
ompRp1,0.5,1,1,TTTCGCTAGCTAAGCGGCCT,0,2810933
ompRp1,0.5,1,1,TTTCGCGTCCCGCCTACGCG,0,2778052
ompRp1,0.5,1,1,TTTCGAGCAAAATGGTTACT,0,2781738
ompRp1,0.5,1,1,TTTCCGTGTCCCGTGGGAGG,0,2785040
ompRp1,0.5,1,1,TTTCCCTCAACTGGCTTAAG,0,2817480
ompRp1,0.5,1,1,TTTCCCTAAGTCATGTTTTG,0,2805298
ompRp1,0.5,1,1,TTTATTCATCGTCTTCGTAC,0,2769558
ompRp1,0.5,1,1,TTTATCTCTTTTATATGGAG,0,2810153
ompRp1,0.5,1,1,TTTATACGGGGTGCTATTTA,0,2804780
ompRp1,0.5,1,1,TTTAGGGGGGATTCGGTCAA,0,2768232
ompRp1,0.5,1,1,TTTAGATTACGACCGTGCGT,0,2805840
ompRp1,0.5,1,1,TTTAGAGTATACAAGAAGGA,0,2807055
ompRp1,0.5,1,1,TTTACCCACAAGCCGACATA,0,2806627
ompRp1,0.5,1,1,TTTACAGGTTCATAGGCCAT,0,2767904
ompRp1,0.5,1,1,TTTACAATATATCGTATGCG,0,2796173
ompRp1,0.5,1,1,TTTAATCATCAATTGTGACA,0,2807432
ompRp1,0.5,1,1,TTTAAATCACAAGCCATTGT,0,2800663
ompRp1,0.5,1,1,TTGTTTTACTTGAGTAGTAA,0,2773258
ompRp1,0.5,1,1,TTGTTGTAAGTTCCAGGCAG,0,2803077
ompRp1,0.5,1,1,TTGTTCTAGACCGCATTCAG,0,2791436
ompRp1,0.5,1,1,TTGTTCGGGATAATCAGGGA,0,2813197
ompRp1,0.5,1,1,TTGTTCAACTAAACCCTTGA,0,2810126
ompRp1,0.5,1,1,TTGTGTCCACATTCCGCCCG,0,2803829
ompRp1,0.5,1,1,TTGTGGGCTGACTATAGGCG,0,2769415
ompRp1,0.5,1,1,TTGTGCAGGTCGGATGAAGA,0,2788320
ompRp1,0.5,1,1,TTGTGACAGATATTTAAGTC,0,2819085
ompRp1,0.5,1,1,TTGTGAATAGGTACCATACG,0,2808591
ompRp1,0.5,1,1,TTGTCTGATGGTTTGAAGGT,0,2803012
ompRp1,0.5,1,1,TTGTCGTAGGCCGCGACTGT,0,2796609
ompRp1,0.5,1,1,TTGTAGACCAGACCGAACAT,0,2780761
ompRp1,0.5,1,1,TTGTACTATCTAAGCGTGGA,0,2810333
ompRp1,0.5,1,1,TTGTACGACAGCGGTATAAC,0,2784267
ompRp1,0.5,1,1,TTGGTGCTGCGGCCATGGCT,0,2766985
ompRp1,0.5,1,1,TTGGTCTATCATGCAGATGG,0,2772817
ompRp1,0.5,1,1,TTGGTCATGTAAGGAAATGA,0,2800415
ompRp1,0.5,1,1,TTGGTCAATTAGGGCAGGGG,0,2794283
ompRp1,0.5,1,1,TTGGGCACTTTCTCAGTAAA,0,2787076
ompRp1,0.5,1,1,TTGGCTCCTAAGTTATCGAA,0,2822594
ompRp1,0.5,1,1,TTGGCGCGGTACACCAGCAC,0,2775656
ompRp1,0.5,1,1,TTGGCCAGACTGAGCCTTTA,0,2803983
ompRp1,0.5,1,1,TTGGCACTCGTTTAATAAGT,0,2780167
ompRp1,0.5,1,1,TTGGATGGGAGGAGTGGTTT,0,2816461
ompRp1,0.5,1,1,TTGGATATATCAAGGCGGGA,0,2793248
ompRp1,0.5,1,1,TTGGAATAAGAATCAGAAAA,0,2776167
ompRp1,0.5,1,1,TTGCGTGCGACTCCAGCCAT,0,2785758
ompRp1,0.5,1,1,TTGCGAACGGTTTGCGAGAG,0,2769604
ompRp1,0.5,1,1,TTGCCTACACCCGTTCTCTT,0,2784287
ompRp1,0.5,1,1,TTGCCCTACTGGGACTGTTA,0,2809848
ompRp1,0.5,1,1,TTGCAGCACAGCCCCACTTC,0,2806475
ompRp1,0.5,1,1,TTGATTGAAGTCTGTTTTAG,0,2774855
ompRp1,0.5,1,1,TTGATTCTTTCTGACTGGGA,0,2769213
ompRp1,0.5,1,1,TTGATTCAGAGTTGCACGTG,0,2820519
ompRp1,0.5,1,1,TTGAGTGTTCGACGCTACGC,0,2815635
ompRp1,0.5,1,1,TTGACGGAGCCGTGGAAAGA,0,2824770
ompRp1,0.5,1,1,TTGACCGCGGCATGAAATAA,0,2773052
ompRp1,0.5,1,1,TTGACACCTCACGGCTACTG,0,2793628
ompRp1,0.5,1,1,TTGAACTTCCACCGGGTATA,0,2769519
ompRp1,0.5,1,1,TTCTTTTTGGGCAGTTGGGT,0,2793683
ompRp1,0.5,1,1,TTCTTTTATAAGAGATCCGT,0,2796768
ompRp1,0.5,1,1,TTCTTGATCGGAGAACGTTC,0,2824153
ompRp1,0.5,1,1,TTCTGTTCTCACTAGGCGCT,0,2817962
ompRp1,0.5,1,1,TTCTGCCAGATCACAGAAAC,0,2770111
ompRp1,0.5,1,1,TTCTGACCACTGAACACGAT,0,2803953
ompRp1,0.5,1,1,TTCTCTTGGTGGGGGTCCAA,0,2776185
ompRp1,0.5,1,1,TTCTCAAAATGGGAGGATAG,0,2822052
ompRp1,0.5,1,1,TTCTATCTTCCCGCTAAGTA,0,2774354
ompRp1,0.5,1,1,TTCTAGATTTAATATACTAC,0,2766316
ompRp1,0.5,1,1,TTCGTGACCGCGTTCAGTGT,0,2812381
ompRp1,0.5,1,1,TTCGTGACAATACGGGGTAA,0,2803830
ompRp1,0.5,1,1,TTCGTCGGTTTGGCATAAAA,0,2779539
ompRp1,0.5,1,1,TTCGTAGCGCTGGTAAAAGG,0,2774312
ompRp1,0.5,1,1,TTCGGTTTAGCATAAATGCT,0,2772811
ompRp1,0.5,1,1,TTCGGAGAGAACCATTGCCG,0,2780762
ompRp1,0.5,1,1,TTCGGAAAATTTTGTAAGGT,0,2779894
ompRp1,0.5,1,1,TTCGATTTCAAAAATTCAGT,0,2783944
ompRp1,0.5,1,1,TTCGAGTATATAGGCTGGTA,0,2767966
ompRp1,0.5,1,1,TTCGAGACTCCCGTTGAAAG,0,2802017
ompRp1,0.5,1,1,TTCGACGTTTCCGGACGACG,0,2824086
ompRp1,0.5,1,1,TTCGACCGTAGGTCCTGGAC,0,2794248
ompRp1,0.5,1,1,TTCGACAAAAAAGGCTAGGC,0,2819635
ompRp1,0.5,1,1,TTCCTTTTTATCAACTGAGG,0,2804736
ompRp1,0.5,1,1,TTCCTGGGGTAGCTATATGT,0,2805184
ompRp1,0.5,1,1,TTCCTCTAGGTGACAGCTGG,0,2791209
ompRp1,0.5,1,1,TTCCTAACAAGGCCTTGGCT,0,2800586
ompRp1,0.5,1,1,TTCCGTGCAAGGTTGGTGCA,0,2800112
ompRp1,0.5,1,1,TTCCGTCATGTCTCGGCTCC,0,2769546
ompRp1,0.5,1,1,TTCCGCAGTTCTTCGTATCT,0,2792655
ompRp1,0.5,1,1,TTCCGATCAAAGGAAGCTTA,0,2792166
ompRp1,0.5,1,1,TTCCGAAGTTTATTCGGCGA,0,2787393
ompRp1,0.5,1,1,TTCCCGGCGCACCTCTGTGG,0,2767541
ompRp1,0.5,1,1,TTCCCGATGATGGCCCCCCA,0,2810290
ompRp1,0.5,1,1,TTCCCCGCGACAAGTACGTA,0,2780291
ompRp1,0.5,1,1,TTCCAGGACATACTGGTTCA,0,2793857
ompRp1,0.5,1,1,TTCCAATTTGCGGAGCGTAA,0,2795659
ompRp1,0.5,1,1,TTCATGCAGAAGTTCGAAGG,0,2787606
ompRp1,0.5,1,1,TTCATGAACAAGGCGCCCTC,0,2773305
ompRp1,0.5,1,1,TTCATCTCGCTCTGGCCTGG,0,2797385
ompRp1,0.5,1,1,TTCAGTGCTTATGCCCCGGG,0,2795532
ompRp1,0.5,1,1,TTCAGCCCACCCCTCCTGTG,0,2805296
ompRp1,0.5,1,1,TTCAGCCATTATTCGAATAT,0,2823905
ompRp1,0.5,1,1,TTCAGCATATATGGAGCCTT,0,2775418
ompRp1,0.5,1,1,TTCACTGAACTCTGGAGTCG,0,2793259
ompRp1,0.5,1,1,TTCACCTTGAACAACTCACG,0,2784580
ompRp1,0.5,1,1,TTCACAGCTTGGTCAAGTAA,0,2821516
ompRp1,0.5,1,1,TTCACACTGTCAGCGGTCAA,0,2809344
ompRp1,0.5,1,1,TTCAATCGAAAGCTCTCAAG,0,2770413
ompRp1,0.5,1,1,TTCAAGTAGGTTAAAGAGTC,0,2802170
ompRp1,0.5,1,1,TTCAACGCTGTGGACAAGCT,0,2809079
ompRp1,0.5,1,1,TTCAACCTTGGCGGCGTGAT,0,2820939
ompRp1,0.5,1,1,TTCAAAGCGGGGCGGATTTA,0,2799263
ompRp1,0.5,1,1,TTATTTGACGAGCAGTTTTG,0,2817406
ompRp1,0.5,1,1,TTATTTAATCAGTTGGTAAA,0,2785288
ompRp1,0.5,1,1,TTATTGGCGAAGCCATGTCC,0,2786697
ompRp1,0.5,1,1,TTATTCACCCCGGGGGGAAT,0,2781794
ompRp1,0.5,1,1,TTATTAGTTGGATGTCCTCT,0,2784090
ompRp1,0.5,1,1,TTATTAGAGGTATCACCCCT,0,2806472
ompRp1,0.5,1,1,TTATGAGCTCAACCATCATG,0,2818628
ompRp1,0.5,1,1,TTATCTTCTAAGCCTAGTCC,0,2792921
ompRp1,0.5,1,1,TTATCTGGGCAGAGTCTTAG,0,2771749
ompRp1,0.5,1,1,TTATCGGCTTACTGCACCAA,0,2781687
ompRp1,0.5,1,1,TTATCGAGCGAGCTTGGCCA,0,2784358
ompRp1,0.5,1,1,TTATCAGCGTATCTCTTCCA,0,2805326
ompRp1,0.5,1,1,TTAGTGGCTGAACGGAGCTA,0,2766814
ompRp1,0.5,1,1,TTAGTGCGCTTGTCTAATTA,0,2766374
ompRp1,0.5,1,1,TTAGTGAGTCTGAGCACGCA,0,2814371
ompRp1,0.5,1,1,TTAGTGAGGTGCGAGGAAAT,0,2818240
ompRp1,0.5,1,1,TTAGGGGGATGACCTGGATT,0,2792492
ompRp1,0.5,1,1,TTAGGATGTGAGGGACAGGT,0,2799297
ompRp1,0.5,1,1,TTAGGATCGCCCCGGTCTGT,0,2788612
ompRp1,0.5,1,1,TTAGGAAGCGGGAGCCTGGA,0,2767614
ompRp1,0.5,1,1,TTAGCACAAAGTTTTTGCAT,0,2815245
ompRp1,0.5,1,1,TTAGAGTACATGGTCATTAT,0,2820698
ompRp1,0.5,1,1,TTAGACACATCTGCGATCAT,0,2793258
ompRp1,0.5,1,1,TTACTTGAAGGATCACGGTA,0,2787134
ompRp1,0.5,1,1,TTACTTCGTTTCTATGCCAG,0,2795973
ompRp1,0.5,1,1,TTACTGGTCGCATGTAAGAG,0,2781482
ompRp1,0.5,1,1,TTACTGAGTCTAGTGGGGGT,0,2816706
ompRp1,0.5,1,1,TTACTCCTTGGGGCACTGGC,0,2791363
ompRp1,0.5,1,1,TTACTCCGACAACTATTCAC,0,2804670
ompRp1,0.5,1,1,TTACTAATATTTGCGTAGCA,0,2808866
ompRp1,0.5,1,1,TTACGGAGGCAGCGGTATTA,0,2815965
ompRp1,0.5,1,1,TTACGGACGAGTGGACTCAC,0,2779687
ompRp1,0.5,1,1,TTACGCTGAGTCTCCGCCTG,0,2808929
ompRp1,0.5,1,1,TTACGATTCAAAAGGGTGGC,0,2805744
ompRp1,0.5,1,1,TTACCGTGGGATGCTTATCA,0,2778687
ompRp1,0.5,1,1,TTACCGTGACATCTGGGAAC,0,2809910
ompRp1,0.5,1,1,TTACCAGAAACGAGCAGCGC,0,2790573
ompRp1,0.5,1,1,TTACATTGGCAGGATTCCAA,0,2788430
ompRp1,0.5,1,1,TTACAGTATCGCAAGGCTGC,0,2815831
ompRp1,0.5,1,1,TTACAGACAAGTGAGGCAGG,0,2781196
ompRp1,0.5,1,1,TTACAAGCTGCGCACGTGTC,0,2784869
ompRp1,0.5,1,1,TTAATTTTTCGGTTTGGTGA,0,2787033
ompRp1,0.5,1,1,TTAATGTCAACCCATGTTGA,0,2811980
ompRp1,0.5,1,1,TTAATGGCCGCCATTCGATA,0,2768610
ompRp1,0.5,1,1,TTAATCAGTTTCCTAACCGT,0,2778593
ompRp1,0.5,1,1,TTAATAGTTGGAGCAATGTT,0,2794417
ompRp1,0.5,1,1,TTAAGAGATTGTCCGCACGG,0,2771125
ompRp1,0.5,1,1,TTAACGCGTAACAAGGCGGG,0,2819818
ompRp1,0.5,1,1,TTAACGCAGGGACGGAGCCC,0,2808601
ompRp1,0.5,1,1,TTAAATGTGCTAAGCGGCCG,0,2813056
ompRp1,0.5,1,1,TTAAACGAAAAGTGCTGGCT,0,2782409
ompRp1,0.5,1,1,TGTTTTGGGTCAACATACTC,0,2789294
ompRp1,0.5,1,1,TGTTTATCCGGCGTACGTAA,0,2766099
ompRp1,0.5,1,1,TGTTGGTCCTAACTCCGATT,0,2782901
ompRp1,0.5,1,1,TGTTGGGCAGCGCCGAGAAT,0,2819018
ompRp1,0.5,1,1,TGTTGGAGACGGTTACAAAT,0,2787848
ompRp1,0.5,1,1,TGTTGCAATTTGGCTTTTCC,0,2787283
ompRp1,0.5,1,1,TGTTCTCGCTAATGCTAGAT,0,2797799
ompRp1,0.5,1,1,TGTTCGTGCCAGTCGCTTGA,0,2824687
ompRp1,0.5,1,1,TGTTCAGCGACTGTGTGCAA,0,2818190
ompRp1,0.5,1,1,TGTTCACTATATTACGTCGT,0,2803103
ompRp1,0.5,1,1,TGTGTTCTCGGGTCAGCCTA,0,2788073
ompRp1,0.5,1,1,TGTGTGAATACCGCTTTGCT,0,2791047
ompRp1,0.5,1,1,TGTGTCTAGTATATTGCGGG,0,2777623
ompRp1,0.5,1,1,TGTGGAGGGAAACGTCTCGG,0,2818079
ompRp1,0.5,1,1,TGTGGAGCTATATCATGAGG,0,2782884
ompRp1,0.5,1,1,TGTGCTTCGGCGATGGAACT,0,2799605
ompRp1,0.5,1,1,TGTGCTCCATACGCCCTAGT,0,2804083
ompRp1,0.5,1,1,TGTGCGGTCACGTGAGACGA,0,2811190
ompRp1,0.5,1,1,TGTGCGAGTATGTTTAGTCA,0,2808030
ompRp1,0.5,1,1,TGTGCGAGGTTCCCGGTTTA,0,2790958
ompRp1,0.5,1,1,TGTGCCTATCGGCACCCCAA,0,2794561
ompRp1,0.5,1,1,TGTGCCCGGCCTGTCGGGCA,0,2818424
ompRp1,0.5,1,1,TGTGAGGCCTCGGGTCTAAA,0,2820334
ompRp1,0.5,1,1,TGTGACCCGAGGTATTGTAC,0,2804137
ompRp1,0.5,1,1,TGTGAAATTAAACCTGAAAG,0,2803031
ompRp1,0.5,1,1,TGTCGGGAGTGCCGCGGCTT,0,2776861
ompRp1,0.5,1,1,TGTCGGATCGCAACTTCCAA,0,2811818
ompRp1,0.5,1,1,TGTCGCGCTGGCCTGGGGAA,0,2807103
ompRp1,0.5,1,1,TGTCGCGACAAATCTCGATT,0,2769452
ompRp1,0.5,1,1,TGTCGAGAATCTCCCGATCA,0,2817032
ompRp1,0.5,1,1,TGTCCGCGTAAGATAACCGG,0,2806444
ompRp1,0.5,1,1,TGTCATGGTCAATCTATGAG,0,2802349
ompRp1,0.5,1,1,TGTCATCACTTAATCAGACC,0,2797580
ompRp1,0.5,1,1,TGTCATCACGAAGTCTAGGA,0,2801483
ompRp1,0.5,1,1,TGTCACTCGCTGGCATGTCA,0,2794147
ompRp1,0.5,1,1,TGTCAACTTGTGGACCCTTA,0,2776698
ompRp1,0.5,1,1,TGTCAACGACGAACCAAAGG,0,2768193
ompRp1,0.5,1,1,TGTATTTTGCAGAAATTGTT,0,2770247
ompRp1,0.5,1,1,TGTATTACGTACAGCGTGAA,0,2800418
ompRp1,0.5,1,1,TGTATGATGGACCGGTGCCG,0,2818294
ompRp1,0.5,1,1,TGTAGCTCTATGAACAGTTC,0,2796078
ompRp1,0.5,1,1,TGTACTCACCATTTGTGGAT,0,2781228
ompRp1,0.5,1,1,TGTACCTGGGAACGGCGGCT,0,2822222
ompRp1,0.5,1,1,TGTACAACCGCAGAACCCCA,0,2788632
ompRp1,0.5,1,1,TGTAATCAAAGATAGATTTC,0,2769458
ompRp1,0.5,1,1,TGTAAGCATGGTTGGACAAA,0,2772602
ompRp1,0.5,1,1,TGGTTGTGCAACGAGGACTG,0,2777223
ompRp1,0.5,1,1,TGGTTGCGGGAGGGCCTCAG,0,2822263
ompRp1,0.5,1,1,TGGTTCCCGTTCTCAGCGTA,0,2781017
ompRp1,0.5,1,1,TGGTGCATGCTCTATAACTG,0,2788625
ompRp1,0.5,1,1,TGGTCGGGGCACAAGGAAGT,0,2794287
ompRp1,0.5,1,1,TGGTCCGGGCAATCACTAAC,0,2819978
ompRp1,0.5,1,1,TGGTATTTTTCGGGACAATT,0,2821343
ompRp1,0.5,1,1,TGGTAGGGGTCCCGATGTGT,0,2797225
ompRp1,0.5,1,1,TGGTAGCACAGAGGACCCGT,0,2823874
ompRp1,0.5,1,1,TGGTACGTATAGAAGGCGTA,0,2802552
ompRp1,0.5,1,1,TGGTAACCCCACGGCCTTGA,0,2791547
ompRp1,0.5,1,1,TGGGTGGGAACTAATCGCGC,0,2782052
ompRp1,0.5,1,1,TGGGTATTTTGAGCACACTG,0,2817654
ompRp1,0.5,1,1,TGGGGTGCTTACCTGATTGG,0,2785007
ompRp1,0.5,1,1,TGGGGGTCTTTGGGCCAAAC,0,2802541
ompRp1,0.5,1,1,TGGGGCGGCGTCCCGAGATA,0,2780917
ompRp1,0.5,1,1,TGGGGCGAACATAAATACAT,0,2823336
ompRp1,0.5,1,1,TGGGCTCGTTACATCTTTCA,0,2802157
ompRp1,0.5,1,1,TGGGCATTAAGCCTCAGTCT,0,2765751
ompRp1,0.5,1,1,TGGGACTTGACAAAAAGTGT,0,2793256
ompRp1,0.5,1,1,TGGGACCTGTGCACAGTTGA,0,2770234
ompRp1,0.5,1,1,TGGGAAAAGGCGCTTGAAGA,0,2802259
ompRp1,0.5,1,1,TGGCTCTCGTCAATTAGTGC,0,2797839
ompRp1,0.5,1,1,TGGCTAACGTCTCCTTGAGG,0,2771963
ompRp1,0.5,1,1,TGGCGGGGAACAGACTAAGC,0,2797082
ompRp1,0.5,1,1,TGGCGGAGCGGACATCTAAT,0,2789094
ompRp1,0.5,1,1,TGGCGCTCTGGTGGGGGTTA,0,2769687
ompRp1,0.5,1,1,TGGCGCCTTCGGTAATCGGG,0,2805168
ompRp1,0.5,1,1,TGGCGCACACATCAGAAGTA,0,2800587
ompRp1,0.5,1,1,TGGCGAGGGTGATTAAAAGC,0,2789219
ompRp1,0.5,1,1,TGGCGACATTTGCGGAGTAC,0,2805195
ompRp1,0.5,1,1,TGGCCTTCACGGCCAGGCTT,0,2814651
ompRp1,0.5,1,1,TGGCCTCGATGTACGTCATG,0,2818478
ompRp1,0.5,1,1,TGGCCCTAAAACTTACAGCA,0,2813972
ompRp1,0.5,1,1,TGGCCCATCATAGTATCGCG,0,2781028
ompRp1,0.5,1,1,TGGCCACCCGAAGCTTTTGA,0,2795663
ompRp1,0.5,1,1,TGGCATCGCCTTACATTCCT,0,2807286
ompRp1,0.5,1,1,TGGCAGCGACGGCTGGAGCG,0,2813679
ompRp1,0.5,1,1,TGGCAGATTTAATTGTGGGG,0,2770850
ompRp1,0.5,1,1,TGGCAAGTGGATAATATAAT,0,2782193
ompRp1,0.5,1,1,TGGCAAGAAAGCCCTTATAG,0,2771549
ompRp1,0.5,1,1,TGGCAAATTAGGAACACAGA,0,2778042
ompRp1,0.5,1,1,TGGATTAATGTGTTCGACCG,0,2772699
ompRp1,0.5,1,1,TGGATGGGACCGGTGACCCG,0,2788117
ompRp1,0.5,1,1,TGGAGTAAACCCTATATATC,0,2813511
ompRp1,0.5,1,1,TGGAGGCCTGATGGGATAAC,0,2794903
ompRp1,0.5,1,1,TGGAGCTTCCGTTAATGCGA,0,2774132
ompRp1,0.5,1,1,TGGACATACTACAACAGTGA,0,2768539
ompRp1,0.5,1,1,TGGACAGTGACAGCTAACCA,0,2776436
ompRp1,0.5,1,1,TGCTTGCCCCGGGATCTTGC,0,2790277
ompRp1,0.5,1,1,TGCTTCGCCCAATCCATCTG,0,2819354
ompRp1,0.5,1,1,TGCTTACCGAGGAAACGAGT,0,2805328
ompRp1,0.5,1,1,TGCTGTGCGAGGCAAAATAG,0,2801830
ompRp1,0.5,1,1,TGCTGGTGGGCACAATAGCA,0,2798578
ompRp1,0.5,1,1,TGCTGATCCTGTGGTATAAT,0,2787176
ompRp1,0.5,1,1,TGCTATGCGGTTTAAACAAA,0,2799339
ompRp1,0.5,1,1,TGCTAGTAGTTCAAGCAAAT,0,2808790
ompRp1,0.5,1,1,TGCTAAGATGGCGCTTGGTT,0,2816480
ompRp1,0.5,1,1,TGCTAAAAGATTAACAGCAA,0,2816950
ompRp1,0.5,1,1,TGCGTTTACTATTATAATAC,0,2807806
ompRp1,0.5,1,1,TGCGTATCGTCCCAATGGCC,0,2821675
ompRp1,0.5,1,1,TGCGTAGGGGCATACACGCA,0,2807690
ompRp1,0.5,1,1,TGCGTACCACGCTAAAAGCC,0,2803062
ompRp1,0.5,1,1,TGCGGTGTTCGTAATTACAA,0,2782591
ompRp1,0.5,1,1,TGCGGGATTCGCAGATCGTT,0,2818902
ompRp1,0.5,1,1,TGCGGGAGAATAGAATCTTC,0,2811583
ompRp1,0.5,1,1,TGCGGCATGGCGTAGCTGTT,0,2788580
ompRp1,0.5,1,1,TGCGCGTGTCTAGAACACGA,0,2815800
ompRp1,0.5,1,1,TGCGACTACATGAAGCGGTA,0,2771423
ompRp1,0.5,1,1,TGCCTTACCTAGTATCTCTT,0,2803389
ompRp1,0.5,1,1,TGCCTCTAAACCGGCGTGAA,0,2772877
ompRp1,0.5,1,1,TGCCGAAATACGCGTGTGTG,0,2785352
ompRp1,0.5,1,1,TGCCCGGATCAGAACACGTT,0,2799356
ompRp1,0.5,1,1,TGCCCGGAGCCCATCGGTAG,0,2793585
ompRp1,0.5,1,1,TGCCCGCTGAAGTGGAGCCA,0,2810994
ompRp1,0.5,1,1,TGCCCCCGACGCATGGGCTG,0,2782554
ompRp1,0.5,1,1,TGCCATTGTGTGAAGTTTCG,0,2779793
ompRp1,0.5,1,1,TGCCAGGTTGTTCGGATAGA,0,2818382
ompRp1,0.5,1,1,TGCCAGCGCCTAACCCCTTA,0,2821245
ompRp1,0.5,1,1,TGCCACTTTCCAATCGCAAC,0,2771123
ompRp1,0.5,1,1,TGCATTCGCTCATACGCTTT,0,2814503
ompRp1,0.5,1,1,TGCATTACCGGTTTACAGGG,0,2806379
ompRp1,0.5,1,1,TGCATGCACCGATCCCAGCC,0,2782433
ompRp1,0.5,1,1,TGCATATAGTAGTCGTCGGC,0,2794885
ompRp1,0.5,1,1,TGCATAACTTTCGAAATCCT,0,2824040
ompRp1,0.5,1,1,TGCAGGTACCTTGAACTACG,0,2772106
ompRp1,0.5,1,1,TGCAGCATGACGTGTGAAAT,0,2784066
ompRp1,0.5,1,1,TGCAGCAATGCAGTTCCACG,0,2806643
ompRp1,0.5,1,1,TGCACAGTCATCCGGTATGA,0,2787232
ompRp1,0.5,1,1,TGCAATTGATCAGGATGGGT,0,2800858
ompRp1,0.5,1,1,TGCAACGGCTAAAGGGGTAA,0,2794807
ompRp1,0.5,1,1,TGATTTGATCGAGCTTAAGA,0,2798739
ompRp1,0.5,1,1,TGATTTCGTATCCGCACAAA,0,2775009
ompRp1,0.5,1,1,TGATTTCGAATGGGATTCCG,0,2766837
ompRp1,0.5,1,1,TGATTCCGCGAGATCAATGC,0,2778985
ompRp1,0.5,1,1,TGATGTTCGGGCATATGAGA,0,2781114
ompRp1,0.5,1,1,TGATGTCGTTTACGTTAGTG,0,2784436
ompRp1,0.5,1,1,TGATGCATGGGGAACCCTCT,0,2824724
ompRp1,0.5,1,1,TGATGACCAGACCGAAGATT,0,2772156
ompRp1,0.5,1,1,TGATGAATGGGATGTATTCG,0,2790497
ompRp1,0.5,1,1,TGATGAATACAGCACTTCAT,0,2771943
ompRp1,0.5,1,1,TGATCTGCGTCGGTGACATG,0,2784981
ompRp1,0.5,1,1,TGATCGCTTGTCCTCAGGAC,0,2812241
ompRp1,0.5,1,1,TGATCGAAACCTGAGGGACA,0,2810758
ompRp1,0.5,1,1,TGATATTGTTCGCTTAAACA,0,2785696
ompRp1,0.5,1,1,TGATATTATACGCGGTCCTC,0,2796356
ompRp1,0.5,1,1,TGATAATTGCTCTCCGACAT,0,2811281
ompRp1,0.5,1,1,TGATAAAAGCTTAGCGGTGA,0,2788253
ompRp1,0.5,1,1,TGAGTTTACCATGTCCTTCT,0,2785395
ompRp1,0.5,1,1,TGAGTTGCGTGGCTTAGCAC,0,2809513
ompRp1,0.5,1,1,TGAGTGGGACATTCGGACCT,0,2821487
ompRp1,0.5,1,1,TGAGTCGCACCTCGATCCCT,0,2772277
ompRp1,0.5,1,1,TGAGGTGCATTTCCAGTAGT,0,2767559
ompRp1,0.5,1,1,TGAGGAGGAATTCACCCGAG,0,2780649
ompRp1,0.5,1,1,TGAGCTAATTCCAGAGCACC,0,2795296
ompRp1,0.5,1,1,TGAGCCTTGCCTGTGGTTAA,0,2818696
ompRp1,0.5,1,1,TGAGCATAGACCTGCCACCT,0,2767495
ompRp1,0.5,1,1,TGAGATAAACCTAGCCCCCC,0,2799903
ompRp1,0.5,1,1,TGAGACTGTGGTCCGGGGCA,0,2809340
ompRp1,0.5,1,1,TGAGAACATGTACCACACAA,0,2774194
ompRp1,0.5,1,1,TGACTAGGAGTAGAGTCAGT,0,2801487
ompRp1,0.5,1,1,TGACTAACCAGAATTTTGCC,0,2824074
ompRp1,0.5,1,1,TGACGTTATACGATTATTCA,0,2820665
ompRp1,0.5,1,1,TGACAGCTATCGTCCTATCC,0,2785046
ompRp1,0.5,1,1,TGACACTGACGCTTTATTTC,0,2783384
ompRp1,0.5,1,1,TGAATGCAATAGTATCCGCA,0,2815647
ompRp1,0.5,1,1,TGAATACTGTGTGCGTCTTT,0,2806630
ompRp1,0.5,1,1,TGAAGACTTTAGGAGATTGA,0,2791316
ompRp1,0.5,1,1,TGAAAGGAATCATGATGTCA,0,2791385
ompRp1,0.5,1,1,TGAAACTTGTCCCCCTGATT,0,2789743
ompRp1,0.5,1,1,TCTTTTCGTCTGGTCGATTA,0,2806187
ompRp1,0.5,1,1,TCTTTAAGTGTATCTAGGGA,0,2788996
ompRp1,0.5,1,1,TCTTGGATAAGGGATGACGT,0,2819985
ompRp1,0.5,1,1,TCTTGCATAGGGACCGTCTA,0,2815261
ompRp1,0.5,1,1,TCTTGACCAAACTTTTTACT,0,2786039
ompRp1,0.5,1,1,TCTTCTCTTATGCCTTACTT,0,2782053
ompRp1,0.5,1,1,TCTTCTCTGATTTCAAAATT,0,2791246
ompRp1,0.5,1,1,TCTTCGGTCATAGCTCTCAT,0,2822615
ompRp1,0.5,1,1,TCTTCGGCCGGGAAAGTACT,0,2789691
ompRp1,0.5,1,1,TCTTATGTCATATTTTCTGC,0,2792980
ompRp1,0.5,1,1,TCTGGGTCACTCGGAAATGG,0,2821916
ompRp1,0.5,1,1,TCTGGGATTGAAACTGCGGC,0,2796357
ompRp1,0.5,1,1,TCTGGCTCAGGATGATGTTG,0,2774737
ompRp1,0.5,1,1,TCTGGCCGGAGGGAATGCGT,0,2776398
ompRp1,0.5,1,1,TCTGGCCCTGGCGATGTATG,0,2774493
ompRp1,0.5,1,1,TCTGGCAATACACAACTTCT,0,2788990
ompRp1,0.5,1,1,TCTGGAAATTATACTGTCTA,0,2768144
ompRp1,0.5,1,1,TCTGACGGTGTCAGTATACC,0,2804074
ompRp1,0.5,1,1,TCTCTTTTGGTCACGCCATT,0,2782938
ompRp1,0.5,1,1,TCTCTTACATAAGGGCCGTA,0,2780394
ompRp1,0.5,1,1,TCTCTTAAGATAGGGTGAAA,0,2805045
ompRp1,0.5,1,1,TCTCGTCACGAGCATCGACT,0,2788823
ompRp1,0.5,1,1,TCTCGGCACTGCTCACCAGG,0,2770548
ompRp1,0.5,1,1,TCTCCAGATTTTAACACGCA,0,2767590
ompRp1,0.5,1,1,TCTCCACGGCACATGGGTTA,0,2815606
ompRp1,0.5,1,1,TCTCAATTGCGTATCTTATT,0,2813125
ompRp1,0.5,1,1,TCTATTCTCTCTGGAGAGTC,0,2778484
ompRp1,0.5,1,1,TCTAGTAGATCGCGGGGTTA,0,2795193
ompRp1,0.5,1,1,TCTAGGTTCGCGCTATATGT,0,2819999
ompRp1,0.5,1,1,TCTAGAGAGAACGCCGTATA,0,2769600
ompRp1,0.5,1,1,TCTACCGGGGCGATTAGCAT,0,2767130
ompRp1,0.5,1,1,TCTACCAATTTGGTAGCACT,0,2817465
ompRp1,0.5,1,1,TCTACAAGCACCGCCTATAT,0,2798180
ompRp1,0.5,1,1,TCGTTTTGGGACCCGGTCTG,0,2813497
ompRp1,0.5,1,1,TCGTTTTGACTATATTTCCA,0,2811710
ompRp1,0.5,1,1,TCGTTGTGACGGAAGACTTT,0,2819862
ompRp1,0.5,1,1,TCGTTGAAGTTGCACAGGCG,0,2806552
ompRp1,0.5,1,1,TCGTGTGTCCGTTAGTGAAA,0,2785392
ompRp1,0.5,1,1,TCGTGGCCCGGTTAGAACGT,0,2809200
ompRp1,0.5,1,1,TCGTGCCCACGTCCAATTTT,0,2814502
ompRp1,0.5,1,1,TCGTGCAGGAAGCGTAGTCG,0,2789481
ompRp1,0.5,1,1,TCGTCGTAGGGAGCGCGCTG,0,2820834
ompRp1,0.5,1,1,TCGTCAATCAATCCATCTCT,0,2824540
ompRp1,0.5,1,1,TCGTAGTCGCCTTGCGAGTG,0,2823251
ompRp1,0.5,1,1,TCGTACTTCCTGTATGCAAA,0,2796978
ompRp1,0.5,1,1,TCGTAACACATGTGGTGTGT,0,2815928
ompRp1,0.5,1,1,TCGGTCCCGTGTCTGATGGG,0,2777705
ompRp1,0.5,1,1,TCGGTAAGTGATAGCGCGAG,0,2786468
ompRp1,0.5,1,1,TCGGGTAATCTAGCCCGTCC,0,2823547
ompRp1,0.5,1,1,TCGGGGCACTAATACAAAAC,0,2815183
ompRp1,0.5,1,1,TCGGGGATGTAATTGGTTCT,0,2807767
ompRp1,0.5,1,1,TCGGGAGACCGATGTTGCTA,0,2798746
ompRp1,0.5,1,1,TCGGGACGAAATTAACGTAT,0,2819726
ompRp1,0.5,1,1,TCGGCTCGGCGACCTCACCA,0,2786680
ompRp1,0.5,1,1,TCGGCCCTTTGGGCCACCCG,0,2808417
ompRp1,0.5,1,1,TCGGAGGGGCATCGCCCCCC,0,2789303
ompRp1,0.5,1,1,TCGGAATCAGTTACGGCGGT,0,2806558
ompRp1,0.5,1,1,TCGCTTACCGCTCGGATGCG,0,2788958
ompRp1,0.5,1,1,TCGCGGTTGAAAATCGGGGA,0,2766815
ompRp1,0.5,1,1,TCGCGGGATTTAGGTGATAG,0,2773155
ompRp1,0.5,1,1,TCGCCATAGTTCCGATGTAT,0,2807232
ompRp1,0.5,1,1,TCGCCAAGGTGTCCCTGTAT,0,2805124
ompRp1,0.5,1,1,TCGCATCCAATAGTATGACA,0,2806907
ompRp1,0.5,1,1,TCGCACAAGTTTTGTAAGAG,0,2819122
ompRp1,0.5,1,1,TCGATTGAATTTCCAGGAGT,0,2822051
ompRp1,0.5,1,1,TCGATAGTCACCATCGCATC,0,2768428
ompRp1,0.5,1,1,TCGAGGGAGTACCAACAGTC,0,2809654
ompRp1,0.5,1,1,TCGACGGACTCCACGAATGC,0,2772075
ompRp1,0.5,1,1,TCGAAGGGGGCTCCACCACT,0,2784343
ompRp1,0.5,1,1,TCGAACGCGCGCTGCTAGAG,0,2823900
ompRp1,0.5,1,1,TCGAAAATGCCTGTGAGCGG,0,2768226
ompRp1,0.5,1,1,TCGAAAACTTTTGTATCATA,0,2809984
ompRp1,0.5,1,1,TCCTTTTTGCCCCAGATCGA,0,2772199
ompRp1,0.5,1,1,TCCTTTCCTGACAACAGCGT,0,2807554
ompRp1,0.5,1,1,TCCTTGACATCACGCTATGC,0,2796777
ompRp1,0.5,1,1,TCCTTCTTATGCATGGGGCT,0,2776817
ompRp1,0.5,1,1,TCCTGTGGTGAGAGGGGCTT,0,2809361
ompRp1,0.5,1,1,TCCTGTAGCAATAGTTTGGT,0,2765729
ompRp1,0.5,1,1,TCCTGGAACGCGACAGAATG,0,2795651
ompRp1,0.5,1,1,TCCTGCGTGGTGCCTGGTGA,0,2766816
ompRp1,0.5,1,1,TCCTGATGCCAATTCTGTAT,0,2819450
ompRp1,0.5,1,1,TCCTATTGGACCAATGAGAC,0,2797939
ompRp1,0.5,1,1,TCCTATAGTCTGTACTAATG,0,2812564
ompRp1,0.5,1,1,TCCTAATCAAACTGTCTATG,0,2813896
ompRp1,0.5,1,1,TCCTAACCTCAAATACAGTA,0,2769319
ompRp1,0.5,1,1,TCCGTGGTTACGGACTTCGG,0,2804267
ompRp1,0.5,1,1,TCCGTCCAAAAGGGCACTTT,0,2814050
ompRp1,0.5,1,1,TCCGGTTAATGGGAACGTAC,0,2765412
ompRp1,0.5,1,1,TCCGGTTAAAAGCACCCCCC,0,2788782
ompRp1,0.5,1,1,TCCGGGGTACCCGTGCGAGG,0,2824045
ompRp1,0.5,1,1,TCCGGCGCTTTTGGATTGAG,0,2792358
ompRp1,0.5,1,1,TCCGCTTAGTTAACAAAACG,0,2801421
ompRp1,0.5,1,1,TCCGCTTAGATCCTCGGATC,0,2787293
ompRp1,0.5,1,1,TCCGCGATCGAATGGAAACG,0,2808458
ompRp1,0.5,1,1,TCCGCACCGCACGGGCTGGG,0,2802090
ompRp1,0.5,1,1,TCCGACTTGGCCCATTGCAC,0,2821707
ompRp1,0.5,1,1,TCCGACCCGGCGAAGTGAGA,0,2778141
ompRp1,0.5,1,1,TCCCTTGGGGGTGCCCTACT,0,2798206
ompRp1,0.5,1,1,TCCCGGATATCGATTAGGTA,0,2824287
ompRp1,0.5,1,1,TCCCCCTGATTCCCTACTGA,0,2810785
ompRp1,0.5,1,1,TCCCCCTATATGCTCAGTGG,0,2804100
ompRp1,0.5,1,1,TCCCACAGGAGCGCAACTTC,0,2816749
ompRp1,0.5,1,1,TCCATTAGGCTGATCTCCGC,0,2801944
ompRp1,0.5,1,1,TCCAGTGACTCCGTACGATC,0,2767771
ompRp1,0.5,1,1,TCCAGGTAATTTGTGGGCTT,0,2779484
ompRp1,0.5,1,1,TCCAGCCCAGGTTGCGTAGT,0,2800855
ompRp1,0.5,1,1,TCCAGACGTAATTGGTGCTA,0,2789022
ompRp1,0.5,1,1,TCCACTAGGTGTTAACGCGT,0,2812759
ompRp1,0.5,1,1,TCCACGCCGTATCAGGCGGA,0,2803251
ompRp1,0.5,1,1,TCCACCTGATGCTAGGTTTT,0,2800905
ompRp1,0.5,1,1,TCCAATTCTTATGGAAATAC,0,2768647
ompRp1,0.5,1,1,TCCAATTAATAAAATACCAG,0,2773964
ompRp1,0.5,1,1,TCCAATGTTTGAGGCTACAG,0,2778878
ompRp1,0.5,1,1,TCCAAGGTGGATCAGATAAA,0,2791034
ompRp1,0.5,1,1,TCCAAGCAGTTCGTAGGGTA,0,2789833
ompRp1,0.5,1,1,TCATTTGCGAGAATATGGGC,0,2816896
ompRp1,0.5,1,1,TCATTTCAAGGGGAATAAGC,0,2780321
ompRp1,0.5,1,1,TCATTATCACCGTTGGACAT,0,2824647
ompRp1,0.5,1,1,TCATTACGTGAGACATCGTG,0,2798867
ompRp1,0.5,1,1,TCATGGTACCTTGGAATTCG,0,2816864
ompRp1,0.5,1,1,TCATGCTTTCGGGGACTTTT,0,2783165
ompRp1,0.5,1,1,TCATGCGCGCAGCCCAGTGT,0,2777021
ompRp1,0.5,1,1,TCATCGAACGTTATTCATCC,0,2769089
ompRp1,0.5,1,1,TCATCGAAAATCGCAAGGTC,0,2800676
ompRp1,0.5,1,1,TCATCCGACTACGACTGGCC,0,2812930
ompRp1,0.5,1,1,TCATCCGACGCATCTTGCGA,0,2796260
ompRp1,0.5,1,1,TCATCCCGAAATCCAGAGAC,0,2771616
ompRp1,0.5,1,1,TCATCACGGCCCAGACGTCT,0,2779571
ompRp1,0.5,1,1,TCATAGTCGTTGTTACATCG,0,2810377
ompRp1,0.5,1,1,TCATACACCGCCCAAGTTTC,0,2790494
ompRp1,0.5,1,1,TCAGTGGCAATCCAGCCGGA,0,2776613
ompRp1,0.5,1,1,TCAGTCCAACTAAGGCGCTT,0,2801485
ompRp1,0.5,1,1,TCAGTACGACCGAGCTTTCA,0,2779364
ompRp1,0.5,1,1,TCAGTAATTTCGATGAATAT,0,2791653
ompRp1,0.5,1,1,TCAGGTCCTTCGATATCTTA,0,2789272
ompRp1,0.5,1,1,TCAGGCAACAAAGTTGTTAG,0,2809489
ompRp1,0.5,1,1,TCAGCGGCTCGGTCCTAGAC,0,2822443
ompRp1,0.5,1,1,TCAGCAGTGCTCCGGATTGG,0,2813715
ompRp1,0.5,1,1,TCAGCAGCAGAAATTAATAA,0,2791930
ompRp1,0.5,1,1,TCAGAGACCGTTGTGCGAGA,0,2793992
ompRp1,0.5,1,1,TCAGACATGGTATAGCTCGC,0,2804645
ompRp1,0.5,1,1,TCAGACAGCGCATCGATGGT,0,2776829
ompRp1,0.5,1,1,TCAGAAATTAGGATTCGGGG,0,2811829
ompRp1,0.5,1,1,TCACGTTGTTGAAACACAGC,0,2774456
ompRp1,0.5,1,1,TCACGCAGCCATTGTCTTTT,0,2810982
ompRp1,0.5,1,1,TCACCACAGGTCGCAAGCCA,0,2781867
ompRp1,0.5,1,1,TCACAGATTCGGATACGCCT,0,2774680
ompRp1,0.5,1,1,TCACAATGTGCATTACCAGC,0,2807164
ompRp1,0.5,1,1,TCACAACCAGGTTTGTTGGC,0,2815248
ompRp1,0.5,1,1,TCAATATGACGAATAGGATG,0,2812046
ompRp1,0.5,1,1,TCAAGCGGTGGAATGCGAAA,0,2795849
ompRp1,0.5,1,1,TCAACTTCCCACATGAATAG,0,2816144
ompRp1,0.5,1,1,TCAACCTAGGATCGAAGATT,0,2806661
ompRp1,0.5,1,1,TCAACCGGTGAGAAATGCGC,0,2824529
ompRp1,0.5,1,1,TCAACATGTTTTTTGAGCCT,0,2765349
ompRp1,0.5,1,1,TCAAAAACGCAAATCAGGCC,0,2787607
ompRp1,0.5,1,1,TATTTTTCTTATGCAACCAT,0,2770445
ompRp1,0.5,1,1,TATTTCGTGGTTCGTTTACA,0,2816889
ompRp1,0.5,1,1,TATTTCCGTCTACCGAGTTA,0,2806272
ompRp1,0.5,1,1,TATTGATTACAACGCTCATT,0,2808627
ompRp1,0.5,1,1,TATTCTCACGTTGGCCGAAT,0,2779992
ompRp1,0.5,1,1,TATTCAAGTTTGCGCCACAC,0,2771548
ompRp1,0.5,1,1,TATTAGCGACTATTGTGACG,0,2799411
ompRp1,0.5,1,1,TATTACAGTCGTAGTCGTAT,0,2784582
ompRp1,0.5,1,1,TATGTCACGAAGGCTACGCA,0,2805015
ompRp1,0.5,1,1,TATGGTGTCGCCCTTCGGTA,0,2813371
ompRp1,0.5,1,1,TATGGCTGAAGGCTGATAAA,0,2816934
ompRp1,0.5,1,1,TATGGAGCCATTTTGCGGCA,0,2815595
ompRp1,0.5,1,1,TATGGAAAGGGTTCAATGTT,0,2775464
ompRp1,0.5,1,1,TATGCTCTATGCAGCGCAAT,0,2798281
ompRp1,0.5,1,1,TATGCCTGCGGCACGGCGAG,0,2794796
ompRp1,0.5,1,1,TATGCCGGTCAAGCCCAGTC,0,2765815
ompRp1,0.5,1,1,TATGACAGATTAAATCAAAT,0,2818239
ompRp1,0.5,1,1,TATCTTTTTTCGGTACTATG,0,2798441
ompRp1,0.5,1,1,TATCTACTCGAACCACTTGG,0,2767477
ompRp1,0.5,1,1,TATCGTTGCCCCTTATTAAA,0,2796274
ompRp1,0.5,1,1,TATCGGCCGAGGCGGCCAGG,0,2765342
ompRp1,0.5,1,1,TATCCCTCTACTTAGAGGGT,0,2798020
ompRp1,0.5,1,1,TATATTCGCATGTCTCAGGG,0,2815945
ompRp1,0.5,1,1,TATATGTTATACCATCTCCT,0,2823923
ompRp1,0.5,1,1,TATAGTCCTCAAATGATACA,0,2811404
ompRp1,0.5,1,1,TATAGGCCTCGTATGTATGT,0,2778646
ompRp1,0.5,1,1,TATAGCGTACATATGTTAGT,0,2775331
ompRp1,0.5,1,1,TATACGGTTAGCTGCACTGT,0,2809089
ompRp1,0.5,1,1,TATACAGCGCAGAGCTGCAT,0,2816288
ompRp1,0.5,1,1,TATAATTTGAGGCGGCTTCT,0,2796806
ompRp1,0.5,1,1,TATAATTTGAAATCCTTAAT,0,2772065
ompRp1,0.5,1,1,TATAAGGTTGGCCCCGATAT,0,2824005
ompRp1,0.5,1,1,TATAAATTTTTCGTAGTACG,0,2810927
ompRp1,0.5,1,1,TATAAATGTGAAGTATTTGA,0,2787880
ompRp1,0.5,1,1,TAGTGGTGGTCCTCTTCTCG,0,2811843
ompRp1,0.5,1,1,TAGTGCTTGGAAATGCTTAT,0,2822658
ompRp1,0.5,1,1,TAGGTCTTGATCCTTTCGTG,0,2778567
ompRp1,0.5,1,1,TAGGTCTGTGGTTCTTGGAG,0,2815963
ompRp1,0.5,1,1,TAGGTCTCGGAGCGCCTCAA,0,2797548
ompRp1,0.5,1,1,TAGGTCCGGCCTAGCACGTT,0,2795386
ompRp1,0.5,1,1,TAGGTATAGAGAGCAGTGTA,0,2780451
ompRp1,0.5,1,1,TAGGTAGCAATCGTACAGAA,0,2796218
ompRp1,0.5,1,1,TAGGGTTTGGGAGAGTTCTT,0,2788233
ompRp1,0.5,1,1,TAGGGCTGTTCGGGGCTTTA,0,2810367
ompRp1,0.5,1,1,TAGGGACTTGGGTGGTTTTG,0,2793594
ompRp1,0.5,1,1,TAGGCTGCTGCGCAATGACC,0,2814419
ompRp1,0.5,1,1,TAGGCCAGATTGCACTCGTA,0,2823462
ompRp1,0.5,1,1,TAGGCAGACAACAATGGCTT,0,2795713
ompRp1,0.5,1,1,TAGGATGGGCCGATTTTTGT,0,2794208
ompRp1,0.5,1,1,TAGGATGGGACGAGACAGCG,0,2767220
ompRp1,0.5,1,1,TAGGATGCCCTCAAAGCACA,0,2778246
ompRp1,0.5,1,1,TAGGATCCTGGGGGTTGAGC,0,2804979
ompRp1,0.5,1,1,TAGGAATTTACTGATAGAGA,0,2768308
ompRp1,0.5,1,1,TAGCTGGGGGGCGAGCTTAG,0,2797831
ompRp1,0.5,1,1,TAGCTGGACGGTTTATTGGT,0,2814076
ompRp1,0.5,1,1,TAGCTAAGTCCTACGTTAGT,0,2797140
ompRp1,0.5,1,1,TAGCGGCCCATTTTATTGGA,0,2779116
ompRp1,0.5,1,1,TAGCGGATCCGACTCACATA,0,2801037
ompRp1,0.5,1,1,TAGCCGTGTCATGGCGACGT,0,2772299
ompRp1,0.5,1,1,TAGCCCAGATTTACGCAACT,0,2813741
ompRp1,0.5,1,1,TAGCATCTCGGGAGATTGTC,0,2794632
ompRp1,0.5,1,1,TAGCATAGCCTGGGGGCGCT,0,2779483
ompRp1,0.5,1,1,TAGCACCGTAGTGCACGCTT,0,2798050
ompRp1,0.5,1,1,TAGATCATGGTACCTTACAT,0,2787957
ompRp1,0.5,1,1,TAGAGCTCGCCGTCAGGATC,0,2813912
ompRp1,0.5,1,1,TAGAGAGGAGTCGAGCAGAA,0,2788210
ompRp1,0.5,1,1,TAGACGCACCGTAGATGATT,0,2811993
ompRp1,0.5,1,1,TAGACCTAACGAAGTTATGC,0,2793373
ompRp1,0.5,1,1,TAGAACGTCGATCCATGATC,0,2778517
ompRp1,0.5,1,1,TACTTGTGATCTGTTCCTTC,0,2805608
ompRp1,0.5,1,1,TACTCTATATATGAAGTCCA,0,2809777
ompRp1,0.5,1,1,TACTCGTGCCATGAGTCGCA,0,2772697
ompRp1,0.5,1,1,TACTCCGGGGGGGGCTTGGA,0,2781586
ompRp1,0.5,1,1,TACTCAAGGTTCCTTAACAA,0,2774362
ompRp1,0.5,1,1,TACGTTTTGCGGGGTAGTCG,0,2819171
ompRp1,0.5,1,1,TACGTTACGTCTGAAGGAGG,0,2790680
ompRp1,0.5,1,1,TACGTGCGACGCTCCAACAA,0,2775136
ompRp1,0.5,1,1,TACGTCTGGTGCAATTCTGA,0,2812975
ompRp1,0.5,1,1,TACGTCAGACCTCTCTAGAG,0,2816927
ompRp1,0.5,1,1,TACGTACCATTGGGCTTAGT,0,2799965
ompRp1,0.5,1,1,TACGTAAGTACATTGAGCAT,0,2799629
ompRp1,0.5,1,1,TACGGTTGCCCCAAAACTGG,0,2822472
ompRp1,0.5,1,1,TACGGTAGATCAGTCATTGT,0,2780448
ompRp1,0.5,1,1,TACGGGGGATGCTTTGACCG,0,2792288
ompRp1,0.5,1,1,TACGGGGACCAACCCTCCAG,0,2788574
ompRp1,0.5,1,1,TACGGCGCAACAACATTGAC,0,2780150
ompRp1,0.5,1,1,TACGCCGTTTGTGCTGGTAA,0,2804090
ompRp1,0.5,1,1,TACGCAGTTTCCTAATGATT,0,2777107
ompRp1,0.5,1,1,TACGATTCTCCGCCCTAGTT,0,2772027
ompRp1,0.5,1,1,TACGACGCGACTCTAGACTG,0,2794709
ompRp1,0.5,1,1,TACGAACACCAGCCTAAATG,0,2768348
ompRp1,0.5,1,1,TACCGTGCGCAACGCGGTGT,0,2822461
ompRp1,0.5,1,1,TACCGTCCATGATTGCGCTA,0,2796144
ompRp1,0.5,1,1,TACCGGGCCGTGCGGACCTG,0,2801314
ompRp1,0.5,1,1,TACCGAGCTGCTTGAATCAA,0,2809266
ompRp1,0.5,1,1,TACCCCAAGAATAATACGGG,0,2795434
ompRp1,0.5,1,1,TACCCAGCTTCGGCCCACGG,0,2820481
ompRp1,0.5,1,1,TACCCAGAAAGCACGCAAAG,0,2820149
ompRp1,0.5,1,1,TACCCACTCAATTATTCCAC,0,2779192
ompRp1,0.5,1,1,TACCATTGGTCCGATACGGC,0,2771864
ompRp1,0.5,1,1,TACCAGGTTGGAGTTCGGGA,0,2804853
ompRp1,0.5,1,1,TACCAGATAGTAAGGACCGG,0,2789485
ompRp1,0.5,1,1,TACCACGCTTTCCTAGGCCA,0,2817344
ompRp1,0.5,1,1,TACCAAGGAGGTTAATGGAT,0,2804641
ompRp1,0.5,1,1,TACATTGGTTGAGAGATCTT,0,2768026
ompRp1,0.5,1,1,TACAGTTGACTATAGAGCAT,0,2800222
ompRp1,0.5,1,1,TACAGTCACGAAGATTGGAT,0,2813243
ompRp1,0.5,1,1,TACAGGCTTGGATACTTAAT,0,2815888
ompRp1,0.5,1,1,TACACGTTGAGCGCCGAAAG,0,2793908
ompRp1,0.5,1,1,TACACGATGCCCGTACCTCA,0,2776853
ompRp1,0.5,1,1,TAATTTCCCTGCGAAGTCCC,0,2805316
ompRp1,0.5,1,1,TAATGGACCGCGGCACCGAG,0,2766143
ompRp1,0.5,1,1,TAATGCTGCATCCTGGATCT,0,2796391
ompRp1,0.5,1,1,TAATGCCGGGTTCGACTTCC,0,2771761
ompRp1,0.5,1,1,TAATGATATGCAGGGCCCTA,0,2773716
ompRp1,0.5,1,1,TAATGAGGAATTGACGGCCT,0,2779387
ompRp1,0.5,1,1,TAATCTGCATCTTAGAGCAT,0,2806945
ompRp1,0.5,1,1,TAATATACAGTGCATAAGCA,0,2798294
ompRp1,0.5,1,1,TAATAATACTCATTCTTAAC,0,2803093
ompRp1,0.5,1,1,TAAGTTAATAACTAGCTAAT,0,2771162
ompRp1,0.5,1,1,TAAGTCATGGACTTTTCATT,0,2785947
ompRp1,0.5,1,1,TAAGTATCAAAAAGGTGAGA,0,2821604
ompRp1,0.5,1,1,TAAGGGTCAGTAAACCGCGT,0,2797409
ompRp1,0.5,1,1,TAAGGCTAATGAAACTCGCG,0,2816129
ompRp1,0.5,1,1,TAAGGCGTGAGTCCGAGCAG,0,2820997
ompRp1,0.5,1,1,TAAGGCGTCTGTAGTCTTTA,0,2775585
ompRp1,0.5,1,1,TAAGGATGCGAAACCTTATG,0,2811332
ompRp1,0.5,1,1,TAAGCATCGACGGTTCTTTG,0,2765616
ompRp1,0.5,1,1,TAACTTTTCCGGGCTGGCGG,0,2784517
ompRp1,0.5,1,1,TAACTGGCTAACCGATCTCT,0,2797794
ompRp1,0.5,1,1,TAACTGGAGTTTGGTTGCGC,0,2805516
ompRp1,0.5,1,1,TAACTCAGGTCTCATCCGGG,0,2813391
ompRp1,0.5,1,1,TAACTAGTGGTGCCTCTTGT,0,2790587
ompRp1,0.5,1,1,TAACGTTGTAGGTTAAAGGT,0,2788710
ompRp1,0.5,1,1,TAACGGTCTGGCTCGTTGCC,0,2789104
ompRp1,0.5,1,1,TAACGCGGAGCATGGATTCT,0,2766085
ompRp1,0.5,1,1,TAACCTATACATTATTGGTC,0,2810159
ompRp1,0.5,1,1,TAACCAGGAGTCTCTTTCCC,0,2811737
ompRp1,0.5,1,1,TAACAGTTAACGTAGACTTA,0,2792216
ompRp1,0.5,1,1,TAACAGAGATCTCACGAGGA,0,2786502
ompRp1,0.5,1,1,TAAATTAAGGCAATCTGAGA,0,2814895
ompRp1,0.5,1,1,TAAATGCATATGTTGTTGCG,0,2819684
ompRp1,0.5,1,1,TAAAGGCCAGTACACGCGGT,0,2773874
ompRp1,0.5,1,1,TAAAGATCGCATTGCGATGG,0,2805341
ompRp1,0.5,1,1,TAAAATTTCATGGAGCGGGA,0,2809389
ompRp1,0.5,1,1,TAAAAGGGCATAGATTGTTA,0,2818652
ompRp1,0.5,1,1,TAAAACCCTTCAAAAGTTTA,0,2771607
ompRp1,0.5,1,1,TAAAAATGGCGCAACACCGA,0,2814639
ompRp1,0.5,1,1,GTTTTTCGCCTCATTGTGCC,0,2815420
ompRp1,0.5,1,1,GTTTTTAGTAAGGATGGATT,0,2814230
ompRp1,0.5,1,1,GTTTTGTGTCATGTTGGATA,0,2824330
ompRp1,0.5,1,1,GTTTTACGTCTTCTTGGTTC,0,2814551
ompRp1,0.5,1,1,GTTTTAAAGCTCTTGTAACG,0,2777033
ompRp1,0.5,1,1,GTTTGACTTGGGTAGTGACT,0,2807504
ompRp1,0.5,1,1,GTTTCATTAGCAAGGTTACT,0,2808137
ompRp1,0.5,1,1,GTTTCAGGACTTCGAGTGCG,0,2801457
ompRp1,0.5,1,1,GTTTCAAGCGGGGCAGCGTG,0,2800758
ompRp1,0.5,1,1,GTTGTGACAATCTATAATGG,0,2797569
ompRp1,0.5,1,1,GTTGTCGCGAAATGGGACTA,0,2774539
ompRp1,0.5,1,1,GTTGGCTCACAACTAAAGCC,0,2768234
ompRp1,0.5,1,1,GTTGCAGACCGTGCCCCGGC,0,2787481
ompRp1,0.5,1,1,GTTGCAAAGCTCCTACAGTG,0,2766384
ompRp1,0.5,1,1,GTTGACTTGGAGCAGCGGGT,0,2771453
ompRp1,0.5,1,1,GTTGACCGGACACCTCGTTA,0,2789556
ompRp1,0.5,1,1,GTTGAACATATCTATAAAGG,0,2794021
ompRp1,0.5,1,1,GTTCTTGCTTATGCGTTATT,0,2769862
ompRp1,0.5,1,1,GTTCGCACGTGTTAGAGTCT,0,2782506
ompRp1,0.5,1,1,GTTCGAATATTACGCTGGGG,0,2792832
ompRp1,0.5,1,1,GTTCCTATCTAGGCGAGGCC,0,2818344
ompRp1,0.5,1,1,GTTCCGCCACGATAATGTTT,0,2776158
ompRp1,0.5,1,1,GTTCCCCCGGAATTTAGATT,0,2778996
ompRp1,0.5,1,1,GTTCCAGATTGTTTGCGAGT,0,2813324
ompRp1,0.5,1,1,GTTCATGGAACCTAATTGGG,0,2816773
ompRp1,0.5,1,1,GTTATTCTGTGTACAAGGAG,0,2782261
ompRp1,0.5,1,1,GTTATTCACCGGGATTTTTC,0,2823796
ompRp1,0.5,1,1,GTTATTATACCTATACAGCC,0,2799286
ompRp1,0.5,1,1,GTTATGAGTGCGGTACTGCA,0,2813070
ompRp1,0.5,1,1,GTTATCGACAGATGTTCACC,0,2766194
ompRp1,0.5,1,1,GTTAGTACTAGGCAGAGAAA,0,2780495
ompRp1,0.5,1,1,GTTAGGGCGAGTAAACCCTT,0,2785124
ompRp1,0.5,1,1,GTTAGCGCACTACCACAAAT,0,2797248
ompRp1,0.5,1,1,GTTAGCCCTTTTTACCCGGC,0,2813691
ompRp1,0.5,1,1,GTTACTACTGCCCCGGAAAG,0,2789993
ompRp1,0.5,1,1,GTTACGCGTCACCTAGCCGT,0,2787590
ompRp1,0.5,1,1,GTTACAGGTGAATAGGTGGG,0,2792611
ompRp1,0.5,1,1,GTTACACCTTTCGTCTGGTA,0,2782392
ompRp1,0.5,1,1,GTTAAGGAATCGAACCGCGC,0,2772078
ompRp1,0.5,1,1,GTTAACTGACATTTTGGATC,0,2800214
ompRp1,0.5,1,1,GTTAACGACGTGCTCCTTGT,0,2792372
ompRp1,0.5,1,1,GTTAACAGAGTCTGATAGCC,0,2810059
ompRp1,0.5,1,1,GTTAAACGATGCATACCGCA,0,2769961
ompRp1,0.5,1,1,GTGTTTTTCCGGCTTTCAAG,0,2781923
ompRp1,0.5,1,1,GTGTTACGCGTATACACTAT,0,2784639
ompRp1,0.5,1,1,GTGTTAACTTCCACGCATTA,0,2772885
ompRp1,0.5,1,1,GTGTTAAATATCCAGTTGGC,0,2822483
ompRp1,0.5,1,1,GTGTGTGACTCAGCCCACGA,0,2804555
ompRp1,0.5,1,1,GTGTGATATCCGGGAGTCAT,0,2805361
ompRp1,0.5,1,1,GTGTCTGATATTCTGTAAGA,0,2794568
ompRp1,0.5,1,1,GTGTCTAATAGATACGGCAT,0,2803276
ompRp1,0.5,1,1,GTGTCGTCCACGGCATGTAC,0,2811929
ompRp1,0.5,1,1,GTGTCCGCGCGTCCTCGTAA,0,2821347
ompRp1,0.5,1,1,GTGTCATTGAAGATTGTATC,0,2813447
ompRp1,0.5,1,1,GTGTCATCATAGGTTTGCGG,0,2796717
ompRp1,0.5,1,1,GTGTAGCGTATTGCGAATGG,0,2789586
ompRp1,0.5,1,1,GTGTAGAACCCCTCTGTGGT,0,2785871
ompRp1,0.5,1,1,GTGTACGCTGAAAGAATGAG,0,2770249
ompRp1,0.5,1,1,GTGTAAAGTGGTGATGTGGA,0,2773879
ompRp1,0.5,1,1,GTGGTGTCTCTTTCTAGTCA,0,2807457
ompRp1,0.5,1,1,GTGGTGGCCGCATTGCCCGG,0,2823724
ompRp1,0.5,1,1,GTGGTCCACGTGTTCGAGCA,0,2786749
ompRp1,0.5,1,1,GTGGGTGGATGGAAGGGGAG,0,2806400
ompRp1,0.5,1,1,GTGGGGTCGGTGATTGTTGA,0,2794044
ompRp1,0.5,1,1,GTGGGGCCGACCCCCTAAAC,0,2815487
ompRp1,0.5,1,1,GTGGGGAAGTGGGACGGTTA,0,2817541
ompRp1,0.5,1,1,GTGGGAACCGTAACGGAGGA,0,2797215
ompRp1,0.5,1,1,GTGGCCGTGTCAGGAATTAA,0,2775103
ompRp1,0.5,1,1,GTGGCAATGTTGGTCGACTC,0,2772451
ompRp1,0.5,1,1,GTGGATATGTTTCGAGCAGT,0,2776820
ompRp1,0.5,1,1,GTGGACAACGGCAATTTTGA,0,2786222
ompRp1,0.5,1,1,GTGCTTGCGGTATATCCATG,0,2819942
ompRp1,0.5,1,1,GTGCTTCGTAGTAGGTAATA,0,2802383
ompRp1,0.5,1,1,GTGCTGAAGGCTGTGCACTT,0,2821563
ompRp1,0.5,1,1,GTGCTCCTATGGGTAGATAC,0,2810509
ompRp1,0.5,1,1,GTGCTCCATAAATAGGGCTC,0,2785420
ompRp1,0.5,1,1,GTGCTCAGTACGCCTCCCCA,0,2783980
ompRp1,0.5,1,1,GTGCTACGGTACATCGAGGC,0,2806873
ompRp1,0.5,1,1,GTGCTACCTACCGGTCCATT,0,2806981
ompRp1,0.5,1,1,GTGCGTTTTAGTGTGCCACC,0,2804416
ompRp1,0.5,1,1,GTGCGTCACGGGCGCGGCAT,0,2815591
ompRp1,0.5,1,1,GTGCGGTGCGTGTTGACCCG,0,2791967
ompRp1,0.5,1,1,GTGCGGTGATGGGCCACAGT,0,2781874
ompRp1,0.5,1,1,GTGCGGGGACTTTAGAGGCA,0,2806991
ompRp1,0.5,1,1,GTGCCTTAGGAAGAATGCTA,0,2794207
ompRp1,0.5,1,1,GTGCCGACACCAAACGGCCG,0,2807490
ompRp1,0.5,1,1,GTGCCCTATTGACTGGATAG,0,2806438
ompRp1,0.5,1,1,GTGCCATCCGAATGGCTGTC,0,2767871
ompRp1,0.5,1,1,GTGCCATAATACATCAGAGG,0,2766722
ompRp1,0.5,1,1,GTGCCACGAGGATGCCCACG,0,2773613
ompRp1,0.5,1,1,GTGCATTCATATTAGGTCTG,0,2780619
ompRp1,0.5,1,1,GTGCATGGATTAGGAGTTCG,0,2815041
ompRp1,0.5,1,1,GTGCACAATGAAGACTAATC,0,2811308
ompRp1,0.5,1,1,GTGCAATGCCCGTAGTGGTA,0,2771907
ompRp1,0.5,1,1,GTGATGGTGTCAATCGCTCC,0,2790790
ompRp1,0.5,1,1,GTGATGCATTAATGAAACAG,0,2805818
ompRp1,0.5,1,1,GTGATGAAATGAGTTGTGAA,0,2771805
ompRp1,0.5,1,1,GTGATCTCTGTCATACCTCT,0,2794200
ompRp1,0.5,1,1,GTGATATCCGGGTGCCTGGG,0,2802492
ompRp1,0.5,1,1,GTGAGGTACTCCGCAGGAGG,0,2766231
ompRp1,0.5,1,1,GTGAGGTAAGTTTATGTAGG,0,2784707
ompRp1,0.5,1,1,GTGAGGGTTACCAACGGGCA,0,2812624
ompRp1,0.5,1,1,GTGAGGATTTGGGATTCAAA,0,2808208
ompRp1,0.5,1,1,GTGAGCATTTGGAGAGAGGC,0,2798540
ompRp1,0.5,1,1,GTGACGTCGGGACCACAGGA,0,2788396
ompRp1,0.5,1,1,GTGACCCGACCGCGTAGAAT,0,2819660
ompRp1,0.5,1,1,GTGACACGACAGCTTAACAA,0,2774634
ompRp1,0.5,1,1,GTGACACAGAAGGCTATGCT,0,2768442
ompRp1,0.5,1,1,GTGAAGTGTCCCAGACTGGG,0,2784564
ompRp1,0.5,1,1,GTGAAAGCGCATCTAGCGCA,0,2800325
ompRp1,0.5,1,1,GTGAAACCTAAAGTTACCCA,0,2813522
ompRp1,0.5,1,1,GTCTTTTACTTATTATAACT,0,2802707
ompRp1,0.5,1,1,GTCTTGTGCATATCTCACTT,0,2790918
ompRp1,0.5,1,1,GTCTTAGGCTCTACCAGTGA,0,2776880
ompRp1,0.5,1,1,GTCTTACACAGAATGGAGTG,0,2812921
ompRp1,0.5,1,1,GTCTGGTGGATGTGTACTAC,0,2796931
ompRp1,0.5,1,1,GTCTGGTCTATCATCAGCGC,0,2786336
ompRp1,0.5,1,1,GTCTGGGATGACCGAGTCTA,0,2811701
ompRp1,0.5,1,1,GTCTGCGATTATTTAAGCGT,0,2809784
ompRp1,0.5,1,1,GTCTCGTGTATGACCGGATA,0,2782423
ompRp1,0.5,1,1,GTCTCCTCCCCTGGTCAAGA,0,2819459
ompRp1,0.5,1,1,GTCTCCGGACTGATACCAGA,0,2820928
ompRp1,0.5,1,1,GTCTAAGATCCGCAGTATTT,0,2809239
ompRp1,0.5,1,1,GTCGTAATCTAATTCTAAAT,0,2804701
ompRp1,0.5,1,1,GTCGCCGTCTTTCATGCTGG,0,2796443
ompRp1,0.5,1,1,GTCGCCATGTATGGTCCTAA,0,2798319
ompRp1,0.5,1,1,GTCGCACATCAAAGTAACAT,0,2780117
ompRp1,0.5,1,1,GTCGAGCGTACACGGCACAA,0,2782327
ompRp1,0.5,1,1,GTCGAGAAGAACGTTCCTAA,0,2773913
ompRp1,0.5,1,1,GTCGAAGTCCGCGACATGAC,0,2776117
ompRp1,0.5,1,1,GTCCCTGTGTGTACAGAATT,0,2788393
ompRp1,0.5,1,1,GTCCCCTAGCCTCGATGCAC,0,2775953
ompRp1,0.5,1,1,GTCCCAGCGGGCAACGCTTC,0,2810205
ompRp1,0.5,1,1,GTCCATGCATGCCGAGTCAC,0,2769432
ompRp1,0.5,1,1,GTCCAATGCGTAACCCACGT,0,2767786
ompRp1,0.5,1,1,GTCCAAAGACGAGGACCAAC,0,2810278
ompRp1,0.5,1,1,GTCATTGCCCCGTGGGTCAG,0,2784947
ompRp1,0.5,1,1,GTCATTAGACAAATACGACT,0,2773112
ompRp1,0.5,1,1,GTCATGGCAAGAGTATGACC,0,2805684
ompRp1,0.5,1,1,GTCATGGATAGCATTGTATA,0,2821897
ompRp1,0.5,1,1,GTCATATTAGTATGGAAGAT,0,2771126
ompRp1,0.5,1,1,GTCATAGTGCATTGAAAGCA,0,2775296
ompRp1,0.5,1,1,GTCATAGGACAGCACTGACG,0,2785701
ompRp1,0.5,1,1,GTCATAGACGCTAGCATGGA,0,2824363
ompRp1,0.5,1,1,GTCAGTACTTTATTGGAATA,0,2790652
ompRp1,0.5,1,1,GTCAGGGTACAACGTAAAAT,0,2815380
ompRp1,0.5,1,1,GTCAGGGCGGCTGCTTCCAA,0,2791133
ompRp1,0.5,1,1,GTCAGCCTGATTTAAACCAG,0,2809129
ompRp1,0.5,1,1,GTCAGACCGGAAGGTGCGAG,0,2778061
ompRp1,0.5,1,1,GTCACTCTATCAGGACCATG,0,2821511
ompRp1,0.5,1,1,GTCAATGTCATGGTACTATG,0,2798702
ompRp1,0.5,1,1,GTCAACTGGTAATAAACTTT,0,2799097
ompRp1,0.5,1,1,GTATTTGTCGTAAAAAACTA,0,2799723
ompRp1,0.5,1,1,GTATTGGGTCATAGTTAATA,0,2782670
ompRp1,0.5,1,1,GTATTGGGGGGGGTTATGAG,0,2801118
ompRp1,0.5,1,1,GTATTCGTCTGCCCGCGGGA,0,2820146
ompRp1,0.5,1,1,GTATGTCTGCTTACTGTTTT,0,2782967
ompRp1,0.5,1,1,GTATCTTAGGAAGTTCGTAG,0,2785203
ompRp1,0.5,1,1,GTATCTGGACCTACGTGGGC,0,2788785
ompRp1,0.5,1,1,GTATACGAACGAGGCCCCTT,0,2812216
ompRp1,0.5,1,1,GTAGTATCGCCGCATGGATA,0,2818301
ompRp1,0.5,1,1,GTAGTAGCGGGCGTCCGAGT,0,2781955
ompRp1,0.5,1,1,GTAGTACCATACTACGAAAA,0,2769526
ompRp1,0.5,1,1,GTAGGTTTTAGGGCGACTCT,0,2787482
ompRp1,0.5,1,1,GTAGGTTTGGGTAGGACCCC,0,2775101
ompRp1,0.5,1,1,GTAGGTGCTGGCAATTGCCC,0,2804471
ompRp1,0.5,1,1,GTAGGGCTCGGTCCTCCATT,0,2817693
ompRp1,0.5,1,1,GTAGGAGGGACCGCGTGCCG,0,2776571
ompRp1,0.5,1,1,GTAGGACCGGGACTATATTC,0,2795603
ompRp1,0.5,1,1,GTAGGAATCGACAGCAGAGC,0,2822588
ompRp1,0.5,1,1,GTAGCCCGACCGATACCGAA,0,2809540
ompRp1,0.5,1,1,GTAGACATGATGTTAATGAC,0,2786811
ompRp1,0.5,1,1,GTAGACAAATCCATGGCCAC,0,2777268
ompRp1,0.5,1,1,GTACTCTCTCAGAGTATGGC,0,2767995
ompRp1,0.5,1,1,GTACTCCTCCCAGAAATGTA,0,2788245
ompRp1,0.5,1,1,GTACATCTGGGTCAAACGTG,0,2790752
ompRp1,0.5,1,1,GTACATATGCATAGATGTCC,0,2824424
ompRp1,0.5,1,1,GTACAAAACCCAGGCAAGCA,0,2791078
ompRp1,0.5,1,1,GTAATCTAAGTGCGAGAAAT,0,2817967
ompRp1,0.5,1,1,GTAAGCGTAGGTCTCTAAAT,0,2782568
ompRp1,0.5,1,1,GTAACTTTAGCCGAGCTCTC,0,2803331
ompRp1,0.5,1,1,GTAACCCATACTGTGCACCC,0,2820938
ompRp1,0.5,1,1,GTAAATTTATGCTCCTCATA,0,2768861
ompRp1,0.5,1,1,GTAAAGACGATCCGGGACCC,0,2804155
ompRp1,0.5,1,1,GTAAACCTACGTCCGGGACA,0,2774256
ompRp1,0.5,1,1,GGTTTCACGCGCCCATGTGG,0,2799625
ompRp1,0.5,1,1,GGTTTATCGCATGTTGACCT,0,2765840
ompRp1,0.5,1,1,GGTTGACACTTACGGGGACG,0,2786503
ompRp1,0.5,1,1,GGTTCTAGGACCGTGGATAG,0,2785327
ompRp1,0.5,1,1,GGTTCCTTCAATTATATGTC,0,2806228
ompRp1,0.5,1,1,GGTTCCGGCAGCTCCCTGCG,0,2806278
ompRp1,0.5,1,1,GGTTCCAAGATGCAACCAGC,0,2790049
ompRp1,0.5,1,1,GGTTATTGTCTTAATCAAAC,0,2775258
ompRp1,0.5,1,1,GGTGTGCTACGCCGGTTCAA,0,2821373
ompRp1,0.5,1,1,GGTGTGATCCGTCGGGCTGT,0,2807387
ompRp1,0.5,1,1,GGTGTACGTACGTGGACCCC,0,2822054
ompRp1,0.5,1,1,GGTGGTCAGCGCAACCTCGA,0,2815698
ompRp1,0.5,1,1,GGTGGTAGGGGAATCCTCGT,0,2776114
ompRp1,0.5,1,1,GGTGGCAATAGAACCATAAA,0,2775436
ompRp1,0.5,1,1,GGTGGATTAAGCAGGAACTT,0,2775688
ompRp1,0.5,1,1,GGTGGACACTGTGGACTCCT,0,2813255
ompRp1,0.5,1,1,GGTGCAGCGGTCTGATGTAA,0,2821858
ompRp1,0.5,1,1,GGTGCACCATGCCGGTACGG,0,2812677
ompRp1,0.5,1,1,GGTGATTGCGTCGAGGTGCA,0,2784590
ompRp1,0.5,1,1,GGTGATGGGGCGGTAAACGA,0,2770907
ompRp1,0.5,1,1,GGTGATAGCATACCTAAGTG,0,2811769
ompRp1,0.5,1,1,GGTGACAGTTCGGGAGTTTC,0,2765614
ompRp1,0.5,1,1,GGTGACAAGTCTTTCAGTAA,0,2770383
ompRp1,0.5,1,1,GGTCTTCCGATGTTGGAACT,0,2810722
ompRp1,0.5,1,1,GGTCTGCACGACCGGTTCGA,0,2817364
ompRp1,0.5,1,1,GGTCTCGTTTGTAGTTTGAC,0,2779054
ompRp1,0.5,1,1,GGTCTCATGCGTGCTTGTCA,0,2807722
ompRp1,0.5,1,1,GGTCGGAGTACACAGTCGGA,0,2770783
ompRp1,0.5,1,1,GGTCGCTAAAGCCTCCTAAG,0,2778535
ompRp1,0.5,1,1,GGTCGCCCGGTCTATAAGAA,0,2810452
ompRp1,0.5,1,1,GGTCCCCGTAACAAAAAGTA,0,2788321
ompRp1,0.5,1,1,GGTCCAGTGATTACTTAACA,0,2821788
ompRp1,0.5,1,1,GGTCATGTATTGGATTTCTA,0,2822844
ompRp1,0.5,1,1,GGTCATCTTTCTAAGAAGGG,0,2792056
ompRp1,0.5,1,1,GGTCAGCGAGACTCAAGAAT,0,2792895
ompRp1,0.5,1,1,GGTCAGACTTGGCGGGACGC,0,2819521
ompRp1,0.5,1,1,GGTATTAGTTTTTTGAACCG,0,2788791
ompRp1,0.5,1,1,GGTATGTAGCTTAAATAATC,0,2819491
ompRp1,0.5,1,1,GGTATCGTGTTAGGCCATCC,0,2817271
ompRp1,0.5,1,1,GGTATCGGGTATGCTCCTGG,0,2813862
ompRp1,0.5,1,1,GGTATCAAAAGTCGCGCAGA,0,2812221
ompRp1,0.5,1,1,GGTAGAGGCCAATGCGACAT,0,2784100
ompRp1,0.5,1,1,GGTAGACAGTGACAAGTATT,0,2793573
ompRp1,0.5,1,1,GGTACGTAATTCGTGTACCC,0,2783590
ompRp1,0.5,1,1,GGTACAGGCCCACATGAATC,0,2778149
ompRp1,0.5,1,1,GGTACACGAATGATCGAAGG,0,2793784
ompRp1,0.5,1,1,GGTACACAGCTATGTTATTT,0,2820073
ompRp1,0.5,1,1,GGTAAGATGGAACAACGTTC,0,2788234
ompRp1,0.5,1,1,GGTAACGATTTGCCCTTGGC,0,2820439
ompRp1,0.5,1,1,GGGTTTTCCATCCCTGCCCA,0,2797393
ompRp1,0.5,1,1,GGGTTGTTTCCTAGGGGCGT,0,2823517
ompRp1,0.5,1,1,GGGTTGGCGTGGGTCGCGAC,0,2778004
ompRp1,0.5,1,1,GGGTTGCGATGGTCGAGTGG,0,2770966
ompRp1,0.5,1,1,GGGTTGCCAAAGTTGCGGTG,0,2785321
ompRp1,0.5,1,1,GGGTTCATATCCCAGGTATC,0,2779221
ompRp1,0.5,1,1,GGGTTAAGTTCGGTAGTTGG,0,2805520
ompRp1,0.5,1,1,GGGTTAACTGAGTAATGGCG,0,2769450
ompRp1,0.5,1,1,GGGTGTTTGTCCGCCACAAT,0,2770411
ompRp1,0.5,1,1,GGGTCGGAACTTACGGGCCA,0,2773834
ompRp1,0.5,1,1,GGGTCGCGAGTAGAGACTGG,0,2791798
ompRp1,0.5,1,1,GGGTAGTGTTAAATGGATAC,0,2792105
ompRp1,0.5,1,1,GGGTAGAGCTTCGAGGGGCT,0,2780914
ompRp1,0.5,1,1,GGGTACGCGGAACCCGCGCT,0,2817079
ompRp1,0.5,1,1,GGGTAAGTTGACGCTTAAAA,0,2789821
ompRp1,0.5,1,1,GGGTAAGAAGTCCAGGATTC,0,2766463
ompRp1,0.5,1,1,GGGGTTGTATACACCGCAGG,0,2812945
ompRp1,0.5,1,1,GGGGTTGAACGTTCTCCTGT,0,2816152
ompRp1,0.5,1,1,GGGGTCTCGGGTTCGGATGA,0,2795441
ompRp1,0.5,1,1,GGGGTCTCAATCGACGTCCA,0,2788920
ompRp1,0.5,1,1,GGGGTCGCGTGTACCCGATG,0,2789275
ompRp1,0.5,1,1,GGGGTCCGCTGCCTTCCGGG,0,2785056
ompRp1,0.5,1,1,GGGGGTGCCATCCTATCCCT,0,2815960
ompRp1,0.5,1,1,GGGGGCTTCATTGTGTCGTG,0,2801999
ompRp1,0.5,1,1,GGGGCGCACCCGATCCGTAT,0,2788507
ompRp1,0.5,1,1,GGGGCGAGAGGGTTTCACCC,0,2775936
ompRp1,0.5,1,1,GGGGCATGCTCAGTATAAGT,0,2807209
ompRp1,0.5,1,1,GGGGAGCGTAGGCATGTCAC,0,2771501
ompRp1,0.5,1,1,GGGCTGGTGCACAACGGCGG,0,2808759
ompRp1,0.5,1,1,GGGCGCTTTATATTATGTCC,0,2770272
ompRp1,0.5,1,1,GGGCGCGGCCAGCACTCTCC,0,2801444
ompRp1,0.5,1,1,GGGCGCAGGAGTTGTGTACT,0,2822359
ompRp1,0.5,1,1,GGGCGACATCTGTTCAGTCC,0,2819420
ompRp1,0.5,1,1,GGGCCTACAAACGCATTCCC,0,2801102
ompRp1,0.5,1,1,GGGCCGCTGGCCAGTGAGCG,0,2823187
ompRp1,0.5,1,1,GGGCAGTCAGCGACTTCTAA,0,2810812
ompRp1,0.5,1,1,GGGCAGCTTTGAAAGGAAAC,0,2781497
ompRp1,0.5,1,1,GGGCAGCAAACGTGCAAATG,0,2787271
ompRp1,0.5,1,1,GGGATTCTTAGCTTTGGAGA,0,2823181
ompRp1,0.5,1,1,GGGATTCATCTGTGGCGTTG,0,2789256
ompRp1,0.5,1,1,GGGATCAGGCCGTTAATCAT,0,2812190
ompRp1,0.5,1,1,GGGAGTGCCCCTCTTCCCGG,0,2807081
ompRp1,0.5,1,1,GGGAGTCCGAAAGGCCGGTT,0,2816858
ompRp1,0.5,1,1,GGGAGGTTTCAAGTGCAAGT,0,2783015
ompRp1,0.5,1,1,GGGAGGGGAACGGTAACGCG,0,2784422
ompRp1,0.5,1,1,GGGAGATAAGGACTTGCAAT,0,2809275
ompRp1,0.5,1,1,GGGAGACACAGGGTAACAGG,0,2792957
ompRp1,0.5,1,1,GGGACTCCGGTGCTACCCTA,0,2781934
ompRp1,0.5,1,1,GGGACGTTCGTTCACTGTCA,0,2808040
ompRp1,0.5,1,1,GGGACGGATTAGGTCGCCTC,0,2816953
ompRp1,0.5,1,1,GGGACCTTCAACGATGTGAT,0,2810989
ompRp1,0.5,1,1,GGGACATTGTGTCGGCCGAC,0,2774859
ompRp1,0.5,1,1,GGGACATACCGAGACGCTCT,0,2765648
ompRp1,0.5,1,1,GGGAATATATCCAGAATTAA,0,2793565
ompRp1,0.5,1,1,GGGAAGGTTCAACTTGGGGA,0,2801091
ompRp1,0.5,1,1,GGGAAGCGAGGCCAGTGACT,0,2770066
ompRp1,0.5,1,1,GGGAACATGAAAACATGCTA,0,2815339
ompRp1,0.5,1,1,GGCTGTCTGGAAACTAAAGC,0,2776220
ompRp1,0.5,1,1,GGCTGGTCTCTTGGATGTCG,0,2770255
ompRp1,0.5,1,1,GGCTGCTGACTTACTTTCAC,0,2768190
ompRp1,0.5,1,1,GGCTGAGTCTGGGGTACTTT,0,2820366
ompRp1,0.5,1,1,GGCTATAATCACCGGGGCCG,0,2787500
ompRp1,0.5,1,1,GGCGTAGTACTTGAGTTTGG,0,2800442
ompRp1,0.5,1,1,GGCGGGTTTCCGAGGTTTGA,0,2807862
ompRp1,0.5,1,1,GGCGGGTATTCCATCCAACG,0,2783364
ompRp1,0.5,1,1,GGCGGGCTGTAGAGCTTCGT,0,2819686
ompRp1,0.5,1,1,GGCGCGGAGTGGCTTCCATG,0,2771091
ompRp1,0.5,1,1,GGCGCGCCTGGGGGACTTAT,0,2819849
ompRp1,0.5,1,1,GGCGCCGACGGTTGCGCTCA,0,2774894
ompRp1,0.5,1,1,GGCGATAACACCCATAAACC,0,2776710
ompRp1,0.5,1,1,GGCGAGTCAAGTATAACAGG,0,2769271
ompRp1,0.5,1,1,GGCGAGGGACAACCACGATA,0,2788904
ompRp1,0.5,1,1,GGCGAGCTGCCGTTCGTTAG,0,2802294
ompRp1,0.5,1,1,GGCCTGGAGAAGCTTGCAAT,0,2792427
ompRp1,0.5,1,1,GGCCTATCAATTGAATGCCT,0,2774246
ompRp1,0.5,1,1,GGCCGTATATAATATAAGTC,0,2816639
ompRp1,0.5,1,1,GGCCGGGCCGCCTATTACAT,0,2793722
ompRp1,0.5,1,1,GGCCGCTCCTCCTCACTCTT,0,2768954
ompRp1,0.5,1,1,GGCCATTCGGCCGTAGACAC,0,2785223
ompRp1,0.5,1,1,GGCCACGCCCCCGGCCTGCC,0,2785717
ompRp1,0.5,1,1,GGCCAACGGTGGTCGCGTAT,0,2799679
ompRp1,0.5,1,1,GGCCAAAGAACTGTAGCTGC,0,2823541
ompRp1,0.5,1,1,GGCATCATGATAGGAGTGGG,0,2794020
ompRp1,0.5,1,1,GGCAGGATAGGGTACGTGTG,0,2815486
ompRp1,0.5,1,1,GGCACCATTAAGGGTTTGAT,0,2803248
ompRp1,0.5,1,1,GGATTATTCCCATCGTCGCC,0,2822506
ompRp1,0.5,1,1,GGATGGGTTGTTCAGACTCC,0,2790413
ompRp1,0.5,1,1,GGATGGGGCTTCATTGTTTT,0,2766173
ompRp1,0.5,1,1,GGATCGCGCATCAGGTACCG,0,2783433
ompRp1,0.5,1,1,GGATCACCCCCAATTGACCC,0,2782770
ompRp1,0.5,1,1,GGAGTTCTCCTCATCGGAGT,0,2778627
ompRp1,0.5,1,1,GGAGTGGTTTCTAAGACTGA,0,2798758
ompRp1,0.5,1,1,GGAGTCGATCTGCACATGCG,0,2767686
ompRp1,0.5,1,1,GGAGTCATAAAAGCTAAGTT,0,2770038
ompRp1,0.5,1,1,GGAGTATACGCATGACGTTC,0,2812084
ompRp1,0.5,1,1,GGAGTAAGGATTTATGTTTC,0,2783941
ompRp1,0.5,1,1,GGAGGGCTTGTGGGAACGTA,0,2788330
ompRp1,0.5,1,1,GGAGCGAAATACGGTTAGGG,0,2817281
ompRp1,0.5,1,1,GGAGAGTAGGCTCCCTTATC,0,2797391
ompRp1,0.5,1,1,GGACTTTATTCCCGGTTACC,0,2795413
ompRp1,0.5,1,1,GGACTTAGGTGTTCTATTGG,0,2817898
ompRp1,0.5,1,1,GGACTGAAAGATATCCTCAA,0,2815734
ompRp1,0.5,1,1,GGACTCAGGGTGGAAAAAGT,0,2794838
ompRp1,0.5,1,1,GGACGTAGCGTGCCAGAGCA,0,2785622
ompRp1,0.5,1,1,GGACGGTACCATAGGCCAGG,0,2766584
ompRp1,0.5,1,1,GGACGCCCTTATAATATGTC,0,2778741
ompRp1,0.5,1,1,GGACCGGTATAAGGTGTGGT,0,2813861
ompRp1,0.5,1,1,GGACCAACAAGGCTTAACCA,0,2782437
ompRp1,0.5,1,1,GGACATCACCTTTGCGGAAA,0,2787753
ompRp1,0.5,1,1,GGACAGTGGCTTGGCAACGA,0,2765551
ompRp1,0.5,1,1,GGACAGGGAATATTGTTTTC,0,2772762
ompRp1,0.5,1,1,GGACAGGAATACCGTCAGGA,0,2797798
ompRp1,0.5,1,1,GGACACAGCCCTGTCTACCT,0,2814168
ompRp1,0.5,1,1,GGAATCCGTACCGCTTGGTG,0,2808787
ompRp1,0.5,1,1,GGAATCACAGGCCTCTCACT,0,2770960
ompRp1,0.5,1,1,GGAAGGTTGACTCAAAAGTG,0,2816739
ompRp1,0.5,1,1,GGAAGGGCTTTGAACAATGG,0,2810489
ompRp1,0.5,1,1,GGAAGGAAGTCCATTCCAGG,0,2794302
ompRp1,0.5,1,1,GGAACTTGCCTCAGACTGGC,0,2769328
ompRp1,0.5,1,1,GGAACGGGGATTTTCTTGCC,0,2817673
ompRp1,0.5,1,1,GGAACGCAGTACAGAAGACT,0,2798616
ompRp1,0.5,1,1,GGAACCTTACTGCCGAAGCA,0,2796746
ompRp1,0.5,1,1,GGAAAGCGAGCCGCCTAGGC,0,2800978
ompRp1,0.5,1,1,GGAAAAGAGACATTCCGTCT,0,2792926
ompRp1,0.5,1,1,GGAAAACGGTCTTAGGATCT,0,2801265
ompRp1,0.5,1,1,GCTTTCCTCGATGGTAAGCC,0,2769800
ompRp1,0.5,1,1,GCTTCCATCAAATTGATGTA,0,2792860
ompRp1,0.5,1,1,GCTTATGGTCCAAGTGATAT,0,2773871
ompRp1,0.5,1,1,GCTTAGCGAGTGCCGATCAA,0,2771692
ompRp1,0.5,1,1,GCTTAGCCATCGTATGCTTA,0,2796553
ompRp1,0.5,1,1,GCTTACGCAACCGGAGACTC,0,2797523
ompRp1,0.5,1,1,GCTTAACTAATGTCCTGGGT,0,2788009
ompRp1,0.5,1,1,GCTGTGCGATTTCCCACCGG,0,2786937
ompRp1,0.5,1,1,GCTGTGCCGTCATCTAGCTC,0,2810672
ompRp1,0.5,1,1,GCTGTGCACCCGTGTAGCGG,0,2809185
ompRp1,0.5,1,1,GCTGTATGGACCACGCGTAG,0,2781577
ompRp1,0.5,1,1,GCTGGGATGTAAACAAAAAC,0,2819201
ompRp1,0.5,1,1,GCTGGCTGGATTATCGTAAC,0,2786946
ompRp1,0.5,1,1,GCTGGCGAACGGATGCACTT,0,2777554
ompRp1,0.5,1,1,GCTGACCGGCTTCGCGTAAC,0,2800944
ompRp1,0.5,1,1,GCTGACCCGTGAGAGTCGAA,0,2776639
ompRp1,0.5,1,1,GCTCTAATGCGAACCTATAG,0,2773446
ompRp1,0.5,1,1,GCTCGTTAATGACCCAGATA,0,2776193
ompRp1,0.5,1,1,GCTCGGGTGCAATCAAACAT,0,2780957
ompRp1,0.5,1,1,GCTCGACAGCGAAATGACCT,0,2810285
ompRp1,0.5,1,1,GCTCCTCAACTTCCTCGTGT,0,2779254
ompRp1,0.5,1,1,GCTCCGTTCCATCGGCCATG,0,2796604
ompRp1,0.5,1,1,GCTCCCCCTTGAGAGCACTG,0,2796484
ompRp1,0.5,1,1,GCTCCAAATGGGCCAACCGG,0,2810408
ompRp1,0.5,1,1,GCTCATTCTTAGAATTGCAG,0,2793957
ompRp1,0.5,1,1,GCTATTTCTATATGGGAGCT,0,2776385
ompRp1,0.5,1,1,GCTATACTAGCGGGGGACGG,0,2806200
ompRp1,0.5,1,1,GCTATAACCCGAAGGTACCT,0,2802982
ompRp1,0.5,1,1,GCTACTGAGTTGGTTAGAAT,0,2782978
ompRp1,0.5,1,1,GCTACCAGTAAAACGAATCT,0,2786881
ompRp1,0.5,1,1,GCTACCAATGTAACTGCCAG,0,2769285
ompRp1,0.5,1,1,GCTAAGCGGCAAAGGGGCAT,0,2779619
ompRp1,0.5,1,1,GCTAAGATGAGGGTTAGGAC,0,2786474
ompRp1,0.5,1,1,GCTAACATGGGTGGACAGTT,0,2792782
ompRp1,0.5,1,1,GCTAAATTTGCTCCAATATC,0,2765389
ompRp1,0.5,1,1,GCTAAATGGCACCCGTTCAC,0,2789588
ompRp1,0.5,1,1,GCTAAATAATCTGCCTTAGT,0,2794791
ompRp1,0.5,1,1,GCGTTGGTCTCGCCAAGACG,0,2799773
ompRp1,0.5,1,1,GCGTTATTTGGTGGCACTGT,0,2787726
ompRp1,0.5,1,1,GCGTGCTGAAGCTAGCTGCG,0,2811828
ompRp1,0.5,1,1,GCGTCGGGGGAACCTCCTAA,0,2765920
ompRp1,0.5,1,1,GCGTCCTCGTAGTTACGGCT,0,2800650
ompRp1,0.5,1,1,GCGTCCCCAGAGGGCAGCTA,0,2781050
ompRp1,0.5,1,1,GCGTCACTTGTCTCGATGAA,0,2785079
ompRp1,0.5,1,1,GCGTATATTTTCGTGGCCTA,0,2775033
ompRp1,0.5,1,1,GCGTAGCGTGAGGAGTCTCA,0,2822056
ompRp1,0.5,1,1,GCGTACCGGGATCCCGCCAT,0,2782620
ompRp1,0.5,1,1,GCGTACAGGCCGAGTGGGCG,0,2807859
ompRp1,0.5,1,1,GCGTAATAAATAGGTCGCTT,0,2823655
ompRp1,0.5,1,1,GCGGTTTTAGTCCGATTAAA,0,2787336
ompRp1,0.5,1,1,GCGGTTGTCTGAGAAAGAGC,0,2798808
ompRp1,0.5,1,1,GCGGTCAATCGAACGTATTA,0,2788790
ompRp1,0.5,1,1,GCGGGCAACGCAGGGCTCTC,0,2821009
ompRp1,0.5,1,1,GCGGCGTTGGCCGAGTGGGG,0,2803158
ompRp1,0.5,1,1,GCGGCGGGACGACATCATTG,0,2789746
ompRp1,0.5,1,1,GCGGCCTCACCAGTGGTCTC,0,2821978
ompRp1,0.5,1,1,GCGGATCTAAATCCGTAGGG,0,2795558
ompRp1,0.5,1,1,GCGGACGCTCTGACTCTTGA,0,2808868
ompRp1,0.5,1,1,GCGCTTTGGACGAGCCGATT,0,2823637
ompRp1,0.5,1,1,GCGCTAGTACTTCGTGATAT,0,2822895
ompRp1,0.5,1,1,GCGCTACCTGTAGGAAGACT,0,2773025
ompRp1,0.5,1,1,GCGCTAATATGTTGCGTGCA,0,2811608
ompRp1,0.5,1,1,GCGCGCATTATCTGGTAAGA,0,2778115
ompRp1,0.5,1,1,GCGCCGAGGGTAAGGGTGTG,0,2803091
ompRp1,0.5,1,1,GCGCACTTACAGTCTGACGA,0,2796734
ompRp1,0.5,1,1,GCGATTGCCTCGAGGCCAGC,0,2810514
ompRp1,0.5,1,1,GCGATTCCACCCTGGATGCT,0,2776031
ompRp1,0.5,1,1,GCGATGTTTCGCTATCGGCT,0,2802528
ompRp1,0.5,1,1,GCGATATTGCTATTGGGTTT,0,2797147
ompRp1,0.5,1,1,GCGATATCGCAGACCCCACA,0,2790916
ompRp1,0.5,1,1,GCGAGCGAAACTTAACGGGC,0,2799429
ompRp1,0.5,1,1,GCGACGTTCGCAGATATTAA,0,2767760
ompRp1,0.5,1,1,GCGACGATTGTGTTCCATTC,0,2780872
ompRp1,0.5,1,1,GCGACCCAAATTCCAGGAAG,0,2779489
ompRp1,0.5,1,1,GCGAAGCGTAATATGGACTA,0,2784968
ompRp1,0.5,1,1,GCGAAGATAAAGGGGCGGGG,0,2818787
ompRp1,0.5,1,1,GCGAAAGGCGAGAATATCCC,0,2801889
ompRp1,0.5,1,1,GCGAAACAGGACGCCGATGG,0,2766903
ompRp1,0.5,1,1,GCCTGCTAGTCAAGCCGAGT,0,2803577
ompRp1,0.5,1,1,GCCTGACTGAACACACGCCT,0,2823143
ompRp1,0.5,1,1,GCCTCTCACAGAGCTCATGT,0,2777035
ompRp1,0.5,1,1,GCCTCGGTCCGACCGCGAGT,0,2805552
ompRp1,0.5,1,1,GCCTCGGAGTAATTAGGAAT,0,2771425
ompRp1,0.5,1,1,GCCTCGCTTTACAGTCCTTA,0,2811388
ompRp1,0.5,1,1,GCCTCACAATAATCTCCCAT,0,2787691
ompRp1,0.5,1,1,GCCTCAAGATCCATACTAAG,0,2780811
ompRp1,0.5,1,1,GCCTAGTTCCAGCGGAGTGG,0,2775142
ompRp1,0.5,1,1,GCCGTGTATTGACACGTTAG,0,2808881
ompRp1,0.5,1,1,GCCGTATTGGTGCCCAACCT,0,2824136
ompRp1,0.5,1,1,GCCGATTGCATGCAAAGTGT,0,2805075
ompRp1,0.5,1,1,GCCGATCAATATGGCTGTTT,0,2784511
ompRp1,0.5,1,1,GCCGATAGCCAAGTCACCTG,0,2776411
ompRp1,0.5,1,1,GCCGAGGCTGAGCCCCAAGT,0,2809975
ompRp1,0.5,1,1,GCCGAATTCATAAAGGCTTA,0,2813675
ompRp1,0.5,1,1,GCCGAAATGTAGTGCTGTTC,0,2773774
ompRp1,0.5,1,1,GCCCTGTTTTAGTACAGTGC,0,2812033
ompRp1,0.5,1,1,GCCCTGACTCGGCGGGAGCA,0,2797289
ompRp1,0.5,1,1,GCCCTCGCTGTGAGATATGC,0,2800308
ompRp1,0.5,1,1,GCCCGGTTTCCCTGTCTTCC,0,2812094
ompRp1,0.5,1,1,GCCCCTGTTGGGTGCTCCGT,0,2817976
ompRp1,0.5,1,1,GCCCCTGCGATCCATAACAG,0,2816770
ompRp1,0.5,1,1,GCCCCGAGTATGCTAGGGCA,0,2776299
ompRp1,0.5,1,1,GCCCCCATTTGGGTCCTCAG,0,2823476
ompRp1,0.5,1,1,GCCCACCCTGGCAGTCCGCA,0,2808434
ompRp1,0.5,1,1,GCCATTGACAACCTCGGGCT,0,2796599
ompRp1,0.5,1,1,GCCATCATGTCCAGGAATTA,0,2813770
ompRp1,0.5,1,1,GCCAGTAAAGATTTTCTAAC,0,2782695
ompRp1,0.5,1,1,GCCACTTCATGCGATGGCTT,0,2770068
ompRp1,0.5,1,1,GCCACGGGTGTTTAACCGGG,0,2821427
ompRp1,0.5,1,1,GCCACCTGAGCAGCTTACGA,0,2820601
ompRp1,0.5,1,1,GCCAATCTGCCATACGGCGG,0,2809096
ompRp1,0.5,1,1,GCATTGCGAAGATGACGTGG,0,2792607
ompRp1,0.5,1,1,GCATGTGGTTCCTTCTACGT,0,2794135
ompRp1,0.5,1,1,GCATGTATATGTGGGTGAGT,0,2786008
ompRp1,0.5,1,1,GCATGGTCCACAGCCACAGC,0,2820447
ompRp1,0.5,1,1,GCATGGCCTGTCGGATTGCA,0,2802912
ompRp1,0.5,1,1,GCATGCTATTGGGAACGTTA,0,2815146
ompRp1,0.5,1,1,GCATCTCTCTTCCAATCGGC,0,2780994
ompRp1,0.5,1,1,GCATCGTCGCGTTGTAAGGT,0,2792029
ompRp1,0.5,1,1,GCATATGTCTTTGACGAAAG,0,2807397
ompRp1,0.5,1,1,GCATAGCCGTCCGTTGGGTC,0,2794899
ompRp1,0.5,1,1,GCATAAGATCTGACGCCTAA,0,2821982
ompRp1,0.5,1,1,GCAGTAGCTATACTTCATCT,0,2799417
ompRp1,0.5,1,1,GCAGGTCCCGACTACTATGG,0,2814746
ompRp1,0.5,1,1,GCAGGTAGCTGATACCATCC,0,2814358
ompRp1,0.5,1,1,GCAGGGTACCATGGATGGCG,0,2813932
ompRp1,0.5,1,1,GCAGGCTTGCAGCGTACAGA,0,2817834
ompRp1,0.5,1,1,GCAGGATGGTTCTTACTCTA,0,2781725
ompRp1,0.5,1,1,GCAGCTGACCGTGCCCTCGC,0,2815931
ompRp1,0.5,1,1,GCAGCGTTCCACCGAGTTCA,0,2765636
ompRp1,0.5,1,1,GCAGCATGGCGGCATTTGTA,0,2801395
ompRp1,0.5,1,1,GCAGCAGCCTCTAAGTTATC,0,2785443
ompRp1,0.5,1,1,GCAGCAATCTATCGTACCAA,0,2820338
ompRp1,0.5,1,1,GCAGACTAATCATGTCCTGC,0,2812819
ompRp1,0.5,1,1,GCAGACCGTTAGCCAGCGCG,0,2818060
ompRp1,0.5,1,1,GCAGACCCCGTGGATTGGGG,0,2766245
ompRp1,0.5,1,1,GCAGAACTTGTTTGAGCACC,0,2798327
ompRp1,0.5,1,1,GCACTGGCCAAAACGAATCT,0,2817414
ompRp1,0.5,1,1,GCACTAGGAGAGCCGTTCTT,0,2806116
ompRp1,0.5,1,1,GCACGTTACTCAGATATTGT,0,2805513
ompRp1,0.5,1,1,GCACGCAGTCTTTTCCATTA,0,2791612
ompRp1,0.5,1,1,GCACCGCAAAGGGCGTTCTC,0,2804023
ompRp1,0.5,1,1,GCACCAGTGCACTGGAGAAT,0,2822681
ompRp1,0.5,1,1,GCACAGTGGGCCATAAGCGA,0,2810334
ompRp1,0.5,1,1,GCACAGCATCTAAACGCTAA,0,2789077
ompRp1,0.5,1,1,GCAATTTTAGCTAGTTGGTC,0,2786804
ompRp1,0.5,1,1,GCAATTCGGAGCCGTTTGGA,0,2819699
ompRp1,0.5,1,1,GCAATGCGGTTGGAGGGTAT,0,2815638
ompRp1,0.5,1,1,GCAATCGAATGTCGGTCGGC,0,2819624
ompRp1,0.5,1,1,GCAAGTCAGCACTAGGTATA,0,2820248
ompRp1,0.5,1,1,GCAAGGGCCAGTAATGTTAC,0,2797771
ompRp1,0.5,1,1,GCAACCTGCGTGGTTTCAAG,0,2802988
ompRp1,0.5,1,1,GCAACCAGCCAGGGTGAGAA,0,2775520
ompRp1,0.5,1,1,GCAACAGCTCGCAGATATTG,0,2813864
ompRp1,0.5,1,1,GCAAATTGTCTCCCTAACTT,0,2821854
ompRp1,0.5,1,1,GCAAACTTGCTACTGATGTC,0,2796747
ompRp1,0.5,1,1,GCAAACGGTATGCTAACGGC,0,2802391
ompRp1,0.5,1,1,GATTGTTTATTTGGGATCAC,0,2822520
ompRp1,0.5,1,1,GATTGTTCTTTTGAGGCCAT,0,2817545
ompRp1,0.5,1,1,GATTGTGGTAAGATAGAACT,0,2783861
ompRp1,0.5,1,1,GATTGGCACCGGGGCAATAG,0,2765516
ompRp1,0.5,1,1,GATTATTTTGGTCCTTTATG,0,2809839
ompRp1,0.5,1,1,GATTATAGGAGCACTGGTCG,0,2768734
ompRp1,0.5,1,1,GATTACTTTGTGGTGGTCGG,0,2802124
ompRp1,0.5,1,1,GATTACATGCAGTGACGATC,0,2808577
ompRp1,0.5,1,1,GATGTTGGGATTTGATGGAT,0,2765608
ompRp1,0.5,1,1,GATGGGCGTCCTTTTCTCAA,0,2802239
ompRp1,0.5,1,1,GATGGCCGCCCCCACGGGGC,0,2775643
ompRp1,0.5,1,1,GATGCTTGGGATAAAGAGTG,0,2784855
ompRp1,0.5,1,1,GATGCCAAACGTTAAATATG,0,2771779
ompRp1,0.5,1,1,GATGCATGCGCGCACCGTAC,0,2770840
ompRp1,0.5,1,1,GATGCAAGTAACAGCTTACG,0,2790741
ompRp1,0.5,1,1,GATGAGAACTGGCCGTCGTA,0,2809097
ompRp1,0.5,1,1,GATCTTAATTGGGCGACTGA,0,2818659
ompRp1,0.5,1,1,GATCTAGTGAGATGGATTTA,0,2799788
ompRp1,0.5,1,1,GATCTAGCCGTGGCAGCCTG,0,2801724
ompRp1,0.5,1,1,GATCGCTTTGGAGGTACGTA,0,2796427
ompRp1,0.5,1,1,GATCGAGGAACGTTCCGGAG,0,2803198
ompRp1,0.5,1,1,GATCATCTGCAGTAAAAGAA,0,2773065
ompRp1,0.5,1,1,GATCAGACTAATATGTCTCA,0,2776177
ompRp1,0.5,1,1,GATCAACTCCCCAGCCCATT,0,2772732
ompRp1,0.5,1,1,GATCAACAACTCTAAATGCT,0,2803210
ompRp1,0.5,1,1,GATATCCTGGAAGTCGTTTC,0,2789007
ompRp1,0.5,1,1,GATATACGGCAACGACGACA,0,2782786
ompRp1,0.5,1,1,GATAGGTAGTCTTAATTAAA,0,2767728
ompRp1,0.5,1,1,GATAATAATTCGCTGCTTGC,0,2803250
ompRp1,0.5,1,1,GATAACTATAAAGTAGCGCT,0,2767340
ompRp1,0.5,1,1,GAGTTGCCCTTCATGACGGT,0,2799338
ompRp1,0.5,1,1,GAGTGTCCTAATATTGCACA,0,2783094
ompRp1,0.5,1,1,GAGTGGATTAGATACCGGGG,0,2803947
ompRp1,0.5,1,1,GAGTGGAAATTTTTGGGTGG,0,2824318
ompRp1,0.5,1,1,GAGTGCTGGAGAACGTCTCA,0,2816240
ompRp1,0.5,1,1,GAGTCGGGTTACTTAGGCGA,0,2824141
ompRp1,0.5,1,1,GAGTCGCTTGTGAATGGAGA,0,2812022
ompRp1,0.5,1,1,GAGTATTGATCAGAAGTGTA,0,2774004
ompRp1,0.5,1,1,GAGTAAGGGGTAGTTGAAAC,0,2807372
ompRp1,0.5,1,1,GAGGGTGATAGGTTCAATTT,0,2817216
ompRp1,0.5,1,1,GAGGCGTTATATTGCTATCG,0,2797669
ompRp1,0.5,1,1,GAGGCGGGATGCTTTGGGTG,0,2817923
ompRp1,0.5,1,1,GAGGCCCCGCGGGGGGTCCT,0,2801602
ompRp1,0.5,1,1,GAGGATGGCTTCTCCCAGAA,0,2815474
ompRp1,0.5,1,1,GAGGATCCTTCTAACAGGGG,0,2778947
ompRp1,0.5,1,1,GAGGAGAGCCTAAGGTTCAG,0,2790934
ompRp1,0.5,1,1,GAGCTTTGGCATGGGCTTCT,0,2804836
ompRp1,0.5,1,1,GAGCTTGCTTCGGTAGAGGT,0,2816865
ompRp1,0.5,1,1,GAGCTGTGCTCGACACTTTA,0,2769761
ompRp1,0.5,1,1,GAGCGTATTCTAGTAACCAG,0,2793894
ompRp1,0.5,1,1,GAGCGGCCTTGTTAGTGATT,0,2784116
ompRp1,0.5,1,1,GAGCGCCCTTGCAAACGAGG,0,2801111
ompRp1,0.5,1,1,GAGCGCACGACCTAGGCGTA,0,2824344
ompRp1,0.5,1,1,GAGCCATACCATCTCACCTA,0,2765954
ompRp1,0.5,1,1,GAGCATGACCACGCCGGTCA,0,2783032
ompRp1,0.5,1,1,GAGCATATTACCATTCCCCC,0,2787389
ompRp1,0.5,1,1,GAGCATAGTCGCTATGTATG,0,2797840
ompRp1,0.5,1,1,GAGCAGTAAGGTGCTATCAA,0,2816849
ompRp1,0.5,1,1,GAGCACCGGTAATACCGGAC,0,2821015
ompRp1,0.5,1,1,GAGATGTCCCGTACGAGGTG,0,2795930
ompRp1,0.5,1,1,GAGATACAGGTTTAGACGTT,0,2778879
ompRp1,0.5,1,1,GAGAGACGGTGAGAGAGTAA,0,2820405
ompRp1,0.5,1,1,GAGACATCGGTCACCGGAGG,0,2799527
ompRp1,0.5,1,1,GAGACAAGCCCAGTGCCGTA,0,2797756
ompRp1,0.5,1,1,GACTTTGCGGGCGATAGTAG,0,2780298
ompRp1,0.5,1,1,GACTTGTACGTGCATCCGAG,0,2808186
ompRp1,0.5,1,1,GACTTAAGCTCAAGCATGAT,0,2816446
ompRp1,0.5,1,1,GACTGTCCCGCACCTCAGTA,0,2805154
ompRp1,0.5,1,1,GACTGTACGATCGTTGCAGG,0,2791669
ompRp1,0.5,1,1,GACTGGATTTACGGGTAAAG,0,2767115
ompRp1,0.5,1,1,GACTGAGACCGGTAGACTAA,0,2766681
ompRp1,0.5,1,1,GACTGAAGACGTCGTAGGTG,0,2772170
ompRp1,0.5,1,1,GACTCGGCGCGAAAATATCC,0,2790468
ompRp1,0.5,1,1,GACTATGGAATGCACCAGGC,0,2768508
ompRp1,0.5,1,1,GACTAAATGTTTGATCTATC,0,2790308
ompRp1,0.5,1,1,GACGTTCTAAGAGATCCAGA,0,2807524
ompRp1,0.5,1,1,GACGGTGTGGGTTAATGAGT,0,2814566
ompRp1,0.5,1,1,GACGGTCGCCACGGCGTTTC,0,2818862
ompRp1,0.5,1,1,GACGGCGGACTCGTATAACC,0,2781485
ompRp1,0.5,1,1,GACGGACGACTTTCGTTGCA,0,2806261
ompRp1,0.5,1,1,GACGGAAGCCAATCAGGGGA,0,2817639
ompRp1,0.5,1,1,GACGCAGGGGCTGGCCAGGG,0,2802630
ompRp1,0.5,1,1,GACGCAGGAATTGGTGCATC,0,2800527
ompRp1,0.5,1,1,GACGCAATAAAATCGGGAGC,0,2785648
ompRp1,0.5,1,1,GACGATGTAAGACCCGTTGC,0,2817867
ompRp1,0.5,1,1,GACCTTTTCATGCCTGGGTA,0,2798266
ompRp1,0.5,1,1,GACCGGTATTGTCCCCTTCT,0,2799061
ompRp1,0.5,1,1,GACCGGGTTTCCACACTCTG,0,2818698
ompRp1,0.5,1,1,GACCGATGATAATGCGCGCG,0,2799340
ompRp1,0.5,1,1,GACCCGTGTGTAGATTGGGT,0,2803058
ompRp1,0.5,1,1,GACCAGGGCATACTCGGCCA,0,2781680
ompRp1,0.5,1,1,GACCAACAGGGCACAATGGT,0,2768512
ompRp1,0.5,1,1,GACATTTCCCAGAAAAGCCT,0,2788592
ompRp1,0.5,1,1,GACATGTTATCGCATAGGCA,0,2808913
ompRp1,0.5,1,1,GACATGATTGAGGGCCTAAG,0,2812613
ompRp1,0.5,1,1,GACATATCCTGGATACACCA,0,2823548
ompRp1,0.5,1,1,GACATACGAATGCTACCTAC,0,2822256
ompRp1,0.5,1,1,GACACGGCACCCAACGTGAA,0,2800702
ompRp1,0.5,1,1,GACACCTCGTTGTCATCATC,0,2779209
ompRp1,0.5,1,1,GACACCACATCCGACAGCGG,0,2789201
ompRp1,0.5,1,1,GACACATTGCGTTGAAATAA,0,2808596
ompRp1,0.5,1,1,GACACATGACATACTACTGA,0,2806363
ompRp1,0.5,1,1,GACAACGCTGTGAATTGAAA,0,2799087
ompRp1,0.5,1,1,GACAACCTTTTGTCAGTCAT,0,2808228
ompRp1,0.5,1,1,GACAACAAGGGCGCCACGCA,0,2771231
ompRp1,0.5,1,1,GAATTTGTTCACCAAAGGAC,0,2798314
ompRp1,0.5,1,1,GAATGGGCGTGAACGGGGGT,0,2816939
ompRp1,0.5,1,1,GAATGGATCAGTACGGCCAA,0,2811136
ompRp1,0.5,1,1,GAATGAAACTCCCATTTCGT,0,2821494
ompRp1,0.5,1,1,GAATCTGAGATGGACATTCG,0,2797968
ompRp1,0.5,1,1,GAATCGGCCCAAGAATAGGA,0,2783439
ompRp1,0.5,1,1,GAATCAAAGCCGCCGGTGGT,0,2767699
ompRp1,0.5,1,1,GAATATCGTGCTGTTAGGAG,0,2779976
ompRp1,0.5,1,1,GAATAATAGTACCCACGGTA,0,2780066
ompRp1,0.5,1,1,GAATAACCGGAGTGGTGCTT,0,2779862
ompRp1,0.5,1,1,GAATAAATTAGGAATAGATC,0,2813127
ompRp1,0.5,1,1,GAATAAAGTTTGGATCAACA,0,2801050
ompRp1,0.5,1,1,GAAGTTGCACAACCGGCATC,0,2769556
ompRp1,0.5,1,1,GAAGTGGTATGAATGAGAAA,0,2798494
ompRp1,0.5,1,1,GAAGGGTAGTTAAATCCACG,0,2788181
ompRp1,0.5,1,1,GAAGGCCGCCCCTCGGCCAC,0,2771468
ompRp1,0.5,1,1,GAAGCGTGAGATGTATAGGT,0,2822607
ompRp1,0.5,1,1,GAAGCCCTCGCGGTGCACAA,0,2771628
ompRp1,0.5,1,1,GAAGCAGTACATTCAGGCGT,0,2779769
ompRp1,0.5,1,1,GAAGATTGTCTTGACCTGTC,0,2815317
ompRp1,0.5,1,1,GAAGATACGTATTGCTCATG,0,2813859
ompRp1,0.5,1,1,GAAGAGAGCCCCGAGTAAGC,0,2809610
ompRp1,0.5,1,1,GAAGACTTGTTCTGCTCGAC,0,2807944
ompRp1,0.5,1,1,GAAGACCATCAGATTGTCAG,0,2812625
ompRp1,0.5,1,1,GAACTACCCTTTATAGCCTG,0,2769269
ompRp1,0.5,1,1,GAACGTCCAGGCGGTCACGC,0,2783911
ompRp1,0.5,1,1,GAACGGTCTCCACCATGGCA,0,2808989
ompRp1,0.5,1,1,GAACGCGTCAGCCTAGCGGA,0,2803314
ompRp1,0.5,1,1,GAACGCCCTGTCGCTAGTTT,0,2822084
ompRp1,0.5,1,1,GAACCGTTAGGGCGCTAGCA,0,2795805
ompRp1,0.5,1,1,GAACCAGTGGCTACCTCTCA,0,2808632
ompRp1,0.5,1,1,GAACATTCAACTGCGCATAT,0,2814029
ompRp1,0.5,1,1,GAACAGTCATCCATCCCGCG,0,2775940
ompRp1,0.5,1,1,GAAATGTGAGTTCTCTTTCC,0,2777660
ompRp1,0.5,1,1,GAAATGTAACACCTGAAGAT,0,2797621
ompRp1,0.5,1,1,GAAATACAGTTGCAAAGTTC,0,2824156
ompRp1,0.5,1,1,GAAATAACGTCCGGGTCAAG,0,2773799
ompRp1,0.5,1,1,GAAATAACCCGCCGGTCTTG,0,2775655
ompRp1,0.5,1,1,GAAAGAAAGAAGCGCTCTAG,0,2800111
ompRp1,0.5,1,1,GAAACTTTCATAAGTCGAAC,0,2798741
ompRp1,0.5,1,1,GAAACTGATACAGTAGGCGA,0,2806095
ompRp1,0.5,1,1,GAAACCAGTCGGTTCAAGCG,0,2776042
ompRp1,0.5,1,1,GAAAATGCTGGTGCGAATAC,0,2775434
ompRp1,0.5,1,1,GAAAATCCATTCGAATGAAC,0,2798130
ompRp1,0.5,1,1,CTTTTTTCATTATCACAGCA,0,2788935
ompRp1,0.5,1,1,CTTTTACTTGTAGAATCTGG,0,2796127
ompRp1,0.5,1,1,CTTTGTTTGGTCACCGTCTA,0,2775930
ompRp1,0.5,1,1,CTTTGCTAGTCAGGTAGTAA,0,2774513
ompRp1,0.5,1,1,CTTTGACCGATATGACATTC,0,2794139
ompRp1,0.5,1,1,CTTTCAGCTTTGTGGGCTTA,0,2783316
ompRp1,0.5,1,1,CTTTCACTGATGCGGTCCGG,0,2811400
ompRp1,0.5,1,1,CTTTCAATTACGCATCGTGA,0,2810083
ompRp1,0.5,1,1,CTTTATGGTTGGACACCCCA,0,2818491
ompRp1,0.5,1,1,CTTTATCACGACGTGGCTAT,0,2783857
ompRp1,0.5,1,1,CTTTAGGGGCAGAGGCCCTC,0,2820998
ompRp1,0.5,1,1,CTTTACTTGCGGACGACTGC,0,2823970
ompRp1,0.5,1,1,CTTTACCAGTAGAGTAGAAT,0,2775324
ompRp1,0.5,1,1,CTTTACATTGAACATGCGAC,0,2767055
ompRp1,0.5,1,1,CTTTACACTCAACGTATAAA,0,2821913
ompRp1,0.5,1,1,CTTTAAACCCGTAGGGAGGA,0,2805961
ompRp1,0.5,1,1,CTTGTGTTGTTGCGGGTGAT,0,2823198
ompRp1,0.5,1,1,CTTGTGCTACAATCCCTTCA,0,2809717
ompRp1,0.5,1,1,CTTGTCATCCGCGTTAATCT,0,2823037
ompRp1,0.5,1,1,CTTGTAGACAGAAAACCTTC,0,2777067
ompRp1,0.5,1,1,CTTGTACAGGTATCACCATG,0,2807800
ompRp1,0.5,1,1,CTTGTAAGACATCATATTAA,0,2805651
ompRp1,0.5,1,1,CTTGGTTTTCAGAGCCCTAA,0,2803689
ompRp1,0.5,1,1,CTTGGGAGCTGATCCGATCA,0,2802868
ompRp1,0.5,1,1,CTTGGCTATGGCTGTGGTAC,0,2816928
ompRp1,0.5,1,1,CTTGGCCGGGTAATCCACGG,0,2818793
ompRp1,0.5,1,1,CTTGCTCTGAAGTAGTCTGG,0,2781876
ompRp1,0.5,1,1,CTTGCCCGTTTTATGGTTGG,0,2818907
ompRp1,0.5,1,1,CTTGCATGTTGAGTTGGATC,0,2816664
ompRp1,0.5,1,1,CTTGCAGCTTCGGTCATTAG,0,2792987
ompRp1,0.5,1,1,CTTGATAGTGAACCGGTGTA,0,2797606
ompRp1,0.5,1,1,CTTGAGAAGGGATGACGCAA,0,2767133
ompRp1,0.5,1,1,CTTGACATATAAACGTCAAA,0,2818532
ompRp1,0.5,1,1,CTTGAATTATTGGTACTGGA,0,2801047
ompRp1,0.5,1,1,CTTGAAGCAATAAGTAATTG,0,2818457
ompRp1,0.5,1,1,CTTGAACTACATGCTAAGGT,0,2805319
ompRp1,0.5,1,1,CTTCTCGTCCTACGATCGGA,0,2779231
ompRp1,0.5,1,1,CTTCTACTATAATTATGGAT,0,2794616
ompRp1,0.5,1,1,CTTCGGATATAATATGTGCC,0,2775654
ompRp1,0.5,1,1,CTTCCGAGGACATTCGATTG,0,2770054
ompRp1,0.5,1,1,CTTCCAGGTTGGTATTACGA,0,2776913
ompRp1,0.5,1,1,CTTATAGTGTTTTTCATGTG,0,2785516
ompRp1,0.5,1,1,CTTATACTCCGGTATTGTAC,0,2817773
ompRp1,0.5,1,1,CTTAGTGGTGCGCATATTCA,0,2815829
ompRp1,0.5,1,1,CTTAGGACTGTGAGATGACA,0,2797712
ompRp1,0.5,1,1,CTTAGCTCCCGAGGCGCGTC,0,2779704
ompRp1,0.5,1,1,CTTACTCGTTTGGTGACTAC,0,2800253
ompRp1,0.5,1,1,CTTACAGGCATCAAGAGGGA,0,2801184
ompRp1,0.5,1,1,CTTACACAGAGTGAAGTCCA,0,2807154
ompRp1,0.5,1,1,CTTAATAGAACCCTGCATAT,0,2791193
ompRp1,0.5,1,1,CTTAAGCTCGCCCGTATCGT,0,2803309
ompRp1,0.5,1,1,CTTAACCCCGTCCTCGTATG,0,2820216
ompRp1,0.5,1,1,CTGTTTTAGGCGTAGTCGCA,0,2812376
ompRp1,0.5,1,1,CTGTTTCGGTTCAATTGGTT,0,2816657
ompRp1,0.5,1,1,CTGTTCGCAATCCCTGGCAT,0,2794992
ompRp1,0.5,1,1,CTGTTCAAAATAGGTAGGTT,0,2773619
ompRp1,0.5,1,1,CTGTTACCCCGCGACGCCAT,0,2822292
ompRp1,0.5,1,1,CTGTGGCCAGAAAGGCAATT,0,2799871
ompRp1,0.5,1,1,CTGTGGCAAAGCGCAGGAGC,0,2799548
ompRp1,0.5,1,1,CTGTGCTTGGGGGTAGGGAA,0,2774774
ompRp1,0.5,1,1,CTGTCTACGGAAGTGTATTG,0,2822302
ompRp1,0.5,1,1,CTGTCCTCACTACAGGGGGG,0,2809863
ompRp1,0.5,1,1,CTGTAGCGTACCATGGCACG,0,2770223
ompRp1,0.5,1,1,CTGGTTCAGCTTTCTTAGCT,0,2772182
ompRp1,0.5,1,1,CTGGTTAAGCATGATCTTGG,0,2822877
ompRp1,0.5,1,1,CTGGTGGCCATTTATATGTG,0,2803436
ompRp1,0.5,1,1,CTGGTCCATACCTACAGATA,0,2819319
ompRp1,0.5,1,1,CTGGGGTTCTAGCTGTATTC,0,2788866
ompRp1,0.5,1,1,CTGGGGGTTGTTGTGACCAA,0,2789424
ompRp1,0.5,1,1,CTGGGCTATGGGGAACGGCA,0,2807774
ompRp1,0.5,1,1,CTGGGCAGTCAGCTTGAGAG,0,2805424
ompRp1,0.5,1,1,CTGGCCCGCCAGGACGGAAA,0,2768338
ompRp1,0.5,1,1,CTGGCATCCTACTGTGTAGA,0,2782635
ompRp1,0.5,1,1,CTGGCACCCTGAGAATATGA,0,2799183
ompRp1,0.5,1,1,CTGGCAAGGCACACTCTCTG,0,2819882
ompRp1,0.5,1,1,CTGGCAAACTCGACCCGTAA,0,2777218
ompRp1,0.5,1,1,CTGGAGCGCCACGGTACTCC,0,2809009
ompRp1,0.5,1,1,CTGCTTGTAACATGAGAAGG,0,2768135
ompRp1,0.5,1,1,CTGCTGCAATGTTAAGATGG,0,2824014
ompRp1,0.5,1,1,CTGCTATGTAAGCCGAGAAA,0,2781133
ompRp1,0.5,1,1,CTGCTAGGCTAGCGCGAAAA,0,2797160
ompRp1,0.5,1,1,CTGCGTTGGGAGGACGTTAC,0,2784111
ompRp1,0.5,1,1,CTGCGGCGCCTCGAAACGGG,0,2793833
ompRp1,0.5,1,1,CTGCGCGCGTGTCTGTTTAT,0,2778689
ompRp1,0.5,1,1,CTGCGCCTTCAGAAGCCAAC,0,2791894
ompRp1,0.5,1,1,CTGCGAGGGGATCCCGTTCG,0,2823862
ompRp1,0.5,1,1,CTGCCCCTTGGCCACTGAGA,0,2769592
ompRp1,0.5,1,1,CTGCCAGGGAGAGACACGCG,0,2770389
ompRp1,0.5,1,1,CTGCATAGGCGCTCTAACTA,0,2791757
ompRp1,0.5,1,1,CTGCAACCTATTCGTGACTT,0,2817248
ompRp1,0.5,1,1,CTGATGCATGGATCCCGTTG,0,2793515
ompRp1,0.5,1,1,CTGAGTTAATATGATATATT,0,2811309
ompRp1,0.5,1,1,CTGAGCGTCCCATAAACATT,0,2791338
ompRp1,0.5,1,1,CTGACATCCTCGATACAGTC,0,2793711
ompRp1,0.5,1,1,CTGACACGAGTCACTCTGTA,0,2823663
ompRp1,0.5,1,1,CTGAACGTAGCTTTAAAAAA,0,2776318
ompRp1,0.5,1,1,CTCTTTGGACCCTAATGGTA,0,2779055
ompRp1,0.5,1,1,CTCTTGTTTATCATCGCTCG,0,2809441
ompRp1,0.5,1,1,CTCTTCTTGGCGAGCGAGAG,0,2815075
ompRp1,0.5,1,1,CTCTTCGGCTCCCAGATCAA,0,2807567
ompRp1,0.5,1,1,CTCTTAAGTTTGTGCGATGT,0,2791321
ompRp1,0.5,1,1,CTCTGGTCGCCCCCCTTATT,0,2777359
ompRp1,0.5,1,1,CTCTGGCCCAAGAGACGAGT,0,2812027
ompRp1,0.5,1,1,CTCTGCTTCACTCGTAATGG,0,2778563
ompRp1,0.5,1,1,CTCTCTCTGACTAGCGGCAG,0,2773061
ompRp1,0.5,1,1,CTCTCGGCGTTCTTAAGACT,0,2819262
ompRp1,0.5,1,1,CTCTCGCTAGACACCACGCA,0,2768811
ompRp1,0.5,1,1,CTCTCGAACACTCGCCTCTA,0,2797620
ompRp1,0.5,1,1,CTCTCAAGCAAACTTAGGGT,0,2788016
ompRp1,0.5,1,1,CTCTATTGGATTATGCACAC,0,2802828
ompRp1,0.5,1,1,CTCTAGGCACTCGGCGTCTC,0,2814697
ompRp1,0.5,1,1,CTCTAGCGATACCCCGTTCG,0,2805953
ompRp1,0.5,1,1,CTCTAGATCCTACAGATCAT,0,2820197
ompRp1,0.5,1,1,CTCGTGCGCAAGTATGGGTA,0,2819073
ompRp1,0.5,1,1,CTCGGTGATTTCATTGCACA,0,2809785
ompRp1,0.5,1,1,CTCGGTCAATGACGTTAAGC,0,2793658
ompRp1,0.5,1,1,CTCGGCTGGATTACCTCCAA,0,2776165
ompRp1,0.5,1,1,CTCGGCTGGAGTTAACGTTT,0,2817397
ompRp1,0.5,1,1,CTCGGCCGGCAAGGAGTGCG,0,2780245
ompRp1,0.5,1,1,CTCGGCAATGTTGGTCGGCC,0,2804343
ompRp1,0.5,1,1,CTCGGAGCGCGTCATATATT,0,2787054
ompRp1,0.5,1,1,CTCGCTAATCGAGTTACAGT,0,2818905
ompRp1,0.5,1,1,CTCGCGTAGGGTGCGATATG,0,2775387
ompRp1,0.5,1,1,CTCGCGCTCCGGGATCAGCA,0,2786102
ompRp1,0.5,1,1,CTCGCATACACTGAACGGGA,0,2818799
ompRp1,0.5,1,1,CTCGATTTGATAACATGGTC,0,2807277
ompRp1,0.5,1,1,CTCGAGCGTAAAGTCATTAA,0,2784463
ompRp1,0.5,1,1,CTCCTTGCAAGTGTTGAGAG,0,2771120
ompRp1,0.5,1,1,CTCCGTCATAATTCCGCGGC,0,2785405
ompRp1,0.5,1,1,CTCCCTCCTACGGTTGGTGT,0,2765431
ompRp1,0.5,1,1,CTCCCGTATGGAAAGCAGCT,0,2814259
ompRp1,0.5,1,1,CTCCATCTTCAGGTTGGTTA,0,2770686
ompRp1,0.5,1,1,CTCCACTCGGGTTGACTGCC,0,2775150
ompRp1,0.5,1,1,CTCCAATCTACCACGGGACA,0,2802338
ompRp1,0.5,1,1,CTCATTACGACGAGACCGTC,0,2794534
ompRp1,0.5,1,1,CTCATACAACCGCCTGATTT,0,2819289
ompRp1,0.5,1,1,CTCAGCCTCTAATTTGTGGT,0,2773559
ompRp1,0.5,1,1,CTCAGCCGAAGTAGCGGCTG,0,2774902
ompRp1,0.5,1,1,CTCACTGAAGTCGTAATCAC,0,2816641
ompRp1,0.5,1,1,CTCACGACGGTTGGACGGGC,0,2769615
ompRp1,0.5,1,1,CTATTGTTCAGGGAGGGCGT,0,2777265
ompRp1,0.5,1,1,CTATTGCAGCGGCCTGTAGC,0,2818709
ompRp1,0.5,1,1,CTATTAGTCAATGCACCACT,0,2776212
ompRp1,0.5,1,1,CTATTACTGGACCCAAGATT,0,2773404
ompRp1,0.5,1,1,CTATGGGAATCCCCCCGGTC,0,2774695
ompRp1,0.5,1,1,CTATGCGTCTAGCGTTCATA,0,2771522
ompRp1,0.5,1,1,CTATGCACGGGACCCTGAGC,0,2798482
ompRp1,0.5,1,1,CTATCTATATTATCCTCAAT,0,2782837
ompRp1,0.5,1,1,CTATCGGCTGGATACCGCGC,0,2814263
ompRp1,0.5,1,1,CTATCACACCGATGTTGGCA,0,2804012
ompRp1,0.5,1,1,CTATATTTTAATTTTATCGT,0,2805571
ompRp1,0.5,1,1,CTATACTGCATCGGTTGGGA,0,2824249
ompRp1,0.5,1,1,CTATACCTTCCAACATGCCA,0,2813263
ompRp1,0.5,1,1,CTATACAAAGATTAAGAGAG,0,2824339
ompRp1,0.5,1,1,CTAGTTAACTATATGACTTT,0,2786576
ompRp1,0.5,1,1,CTAGTCGAACGTCGGACGGG,0,2791847
ompRp1,0.5,1,1,CTAGTAATCGTTAGAGGTCT,0,2819616
ompRp1,0.5,1,1,CTAGGTTTTTCAATGACACT,0,2810844
ompRp1,0.5,1,1,CTAGGCTATAGTCCCTGTTC,0,2767119
ompRp1,0.5,1,1,CTAGGATGTCTGCCCTAATT,0,2770695
ompRp1,0.5,1,1,CTAGGATGATGGGCACCTCG,0,2810846
ompRp1,0.5,1,1,CTAGCTCCGACGATCAAACT,0,2813012
ompRp1,0.5,1,1,CTAGCTACATGGCATTGGAT,0,2812424
ompRp1,0.5,1,1,CTAGCGGCCGCAACCCAGCG,0,2786167
ompRp1,0.5,1,1,CTAGCCTCACCCACGAAGAT,0,2805773
ompRp1,0.5,1,1,CTAGCCAGTGGGCAATTCTC,0,2805527
ompRp1,0.5,1,1,CTAGCATTCACAAATGCTGA,0,2780046
ompRp1,0.5,1,1,CTAGAGAGCGTATGGTGAAG,0,2781363
ompRp1,0.5,1,1,CTACTGCCATTCAGAGTCAC,0,2779374
ompRp1,0.5,1,1,CTACTAGCATCTCGATTTCC,0,2817199
ompRp1,0.5,1,1,CTACTAGATCGAAGTTCCTG,0,2785832
ompRp1,0.5,1,1,CTACGAGGTAGCATTATCCT,0,2814510
ompRp1,0.5,1,1,CTACGAATGTGAAAGTTACT,0,2809604
ompRp1,0.5,1,1,CTACATGACATAATCCGACA,0,2777363
ompRp1,0.5,1,1,CTACAAGAGCTATTTGCATT,0,2774380
ompRp1,0.5,1,1,CTAATTTCGACGATTAGAGC,0,2767506
ompRp1,0.5,1,1,CTAATTAAGCTGCGTGTAAT,0,2770359
ompRp1,0.5,1,1,CTAATAGACGTACTTGCCAA,0,2812161
ompRp1,0.5,1,1,CTAATACCACGGTTCTGAAC,0,2787278
ompRp1,0.5,1,1,CTAATAACCTAGATAGCTGA,0,2821243
ompRp1,0.5,1,1,CTAAGTAGTTCTATCATGAT,0,2781118
ompRp1,0.5,1,1,CTAAGGACGATTACACACTG,0,2796478
ompRp1,0.5,1,1,CTAAGAAAACTCGTCTGGTT,0,2815749
ompRp1,0.5,1,1,CTAACCCCAACCCGGCTATG,0,2808720
ompRp1,0.5,1,1,CTAACATAGTTTCGGCTTGA,0,2786147
ompRp1,0.5,1,1,CTAAAGGTTGTAAGCTATGG,0,2769435
ompRp1,0.5,1,1,CTAAAGGGCTCTCTCCAAGC,0,2804025
ompRp1,0.5,1,1,CGTTTTTTCCGGTGGGGACA,0,2804561
ompRp1,0.5,1,1,CGTTTCCCAGAAACAGTAAA,0,2780561
ompRp1,0.5,1,1,CGTTGCATGTCGTGCCTTTG,0,2802498
ompRp1,0.5,1,1,CGTTGAGTATGGGACATATG,0,2798073
ompRp1,0.5,1,1,CGTTCGAGACGAACCGCGTC,0,2786907
ompRp1,0.5,1,1,CGTTCCTTTAACGAAAGGAT,0,2819256
ompRp1,0.5,1,1,CGTTCCTTCAATTATATGTC,0,2806220
ompRp1,0.5,1,1,CGTTCATTGAGTGTAAGTTA,0,2789322
ompRp1,0.5,1,1,CGTTATTGAAACTACTTCTC,0,2783076
ompRp1,0.5,1,1,CGTTAGAGAGTTTGTCGCAG,0,2765930
ompRp1,0.5,1,1,CGTTAAATCCTACCGATTAG,0,2802125
ompRp1,0.5,1,1,CGTGTTTCGGCCAAAGCGAC,0,2818906
ompRp1,0.5,1,1,CGTGTCGCACTTCCAGCTGC,0,2779896
ompRp1,0.5,1,1,CGTGTCCTCAGAGGGTACTA,0,2798167
ompRp1,0.5,1,1,CGTGTACCTCCGTGGCACTT,0,2790357
ompRp1,0.5,1,1,CGTGGTTTTGCCGATGGGGA,0,2814743
ompRp1,0.5,1,1,CGTGGTGTATGATACTGGCC,0,2810661
ompRp1,0.5,1,1,CGTGGTGCACAGTGGATTCT,0,2821397
ompRp1,0.5,1,1,CGTGGGCGCGGCCAGAATGC,0,2774481
ompRp1,0.5,1,1,CGTGGGCACTCCCTGATGTT,0,2812282
ompRp1,0.5,1,1,CGTGCATGGTCGCGGCCTGG,0,2769814
ompRp1,0.5,1,1,CGTGAGCATTGACATTAGTG,0,2806370
ompRp1,0.5,1,1,CGTCTTAGGCGTTAAGTGGT,0,2774131
ompRp1,0.5,1,1,CGTCTGTTGTTATGAAGAGT,0,2811787
ompRp1,0.5,1,1,CGTCTCGGGCTTGGTCGACT,0,2809614
ompRp1,0.5,1,1,CGTCTAGTAATGGGCCTGCG,0,2777486
ompRp1,0.5,1,1,CGTCTAGCTCATAGATCCGT,0,2781662
ompRp1,0.5,1,1,CGTCTACTGATTATACATTT,0,2799987
ompRp1,0.5,1,1,CGTCGTGCTCATTGGGAAGC,0,2821223
ompRp1,0.5,1,1,CGTCGGGTAGGGTTGTGGAA,0,2809256
ompRp1,0.5,1,1,CGTCGGCTGGCAATCTCCGT,0,2795889
ompRp1,0.5,1,1,CGTCGCTATGTGGATTGTGT,0,2812433
ompRp1,0.5,1,1,CGTCCAGGTAGGAGGTTCGG,0,2790069
ompRp1,0.5,1,1,CGTATGTCGCTAGATTCGTG,0,2782511
ompRp1,0.5,1,1,CGTATGGTTTTCCACTCCAG,0,2785735
ompRp1,0.5,1,1,CGTATGGTGCGCTGCATTAA,0,2801175
ompRp1,0.5,1,1,CGTAGAGCCACCATGATAAC,0,2783237
ompRp1,0.5,1,1,CGTACTAATGGGAACATTAC,0,2798273
ompRp1,0.5,1,1,CGTACGTGAGCCGAGCCGGG,0,2783625
ompRp1,0.5,1,1,CGTACGCATTGAATAGGGGT,0,2796163
ompRp1,0.5,1,1,CGTACCCGAACGGCCTGCAG,0,2789191
ompRp1,0.5,1,1,CGTACACCCCGCGTTCCTCG,0,2790961
ompRp1,0.5,1,1,CGGTTTGTGGCAATCCACAT,0,2773323
ompRp1,0.5,1,1,CGGTTTAGTACAGTGAGCTG,0,2780908
ompRp1,0.5,1,1,CGGTGTTCAGGACGAACGCG,0,2811278
ompRp1,0.5,1,1,CGGTGGCGCATCGGATTGGC,0,2790781
ompRp1,0.5,1,1,CGGTGATGTTAATTCGACAG,0,2792371
ompRp1,0.5,1,1,CGGTCTTGAGTAAGAAACGG,0,2797704
ompRp1,0.5,1,1,CGGTCGCAATGCGACAAATA,0,2790299
ompRp1,0.5,1,1,CGGTCCATTTCATGATCGTA,0,2774263
ompRp1,0.5,1,1,CGGTATGCTAACTGAGGGTT,0,2780092
ompRp1,0.5,1,1,CGGTACGGCTTCATTCACTC,0,2797705
ompRp1,0.5,1,1,CGGGTTTTTGATTTCTCGAC,0,2822757
ompRp1,0.5,1,1,CGGGTTACCTGAGGCCGACT,0,2772259
ompRp1,0.5,1,1,CGGGGGTACTCTTGTTATAG,0,2784854
ompRp1,0.5,1,1,CGGGGCCATCCGATTATGGT,0,2783633
ompRp1,0.5,1,1,CGGGGCATTCAGTCTGCATG,0,2795314
ompRp1,0.5,1,1,CGGGGAGTGTTGGTGGCTAC,0,2814465
ompRp1,0.5,1,1,CGGGGACGGTTGTTCGCGGG,0,2809568
ompRp1,0.5,1,1,CGGGCTTTCCGAAACCGCGA,0,2769597
ompRp1,0.5,1,1,CGGGCTATGCTCGGTGTTGC,0,2812030
ompRp1,0.5,1,1,CGGGCCGGAGGAGCTAGCCT,0,2817792
ompRp1,0.5,1,1,CGGGCCAGCCCTAGTTGGCC,0,2781911
ompRp1,0.5,1,1,CGGGCAGTTGGCGGTTCGAT,0,2770915
ompRp1,0.5,1,1,CGGGCACCATTAGGCTAAGC,0,2772221
ompRp1,0.5,1,1,CGGGATGGTGTAGATACACA,0,2812837
ompRp1,0.5,1,1,CGGGAGTGCTCAAATCTCTT,0,2776997
ompRp1,0.5,1,1,CGGGAGCTCACAGCCTTGCT,0,2769649
ompRp1,0.5,1,1,CGGGACAAAGCTGGGTGAAT,0,2802696
ompRp1,0.5,1,1,CGGGAATCCGAGCCGTGGCA,0,2811282
ompRp1,0.5,1,1,CGGGAAAGGTAGAAAATCTT,0,2819490
ompRp1,0.5,1,1,CGGCTTTTCAAGTCCAGTAG,0,2814013
ompRp1,0.5,1,1,CGGCTTCCATACGCATCTGT,0,2781622
ompRp1,0.5,1,1,CGGCTTACCACTGCGATGTC,0,2789749
ompRp1,0.5,1,1,CGGCTCAACGTACACGTAAC,0,2810966
ompRp1,0.5,1,1,CGGCGGCTTCTCCCTTCTCA,0,2794543
ompRp1,0.5,1,1,CGGCGCCGAGCGAGTCGCAA,0,2788876
ompRp1,0.5,1,1,CGGCCTGCGTAACCCACTTG,0,2779859
ompRp1,0.5,1,1,CGGCCGCGGTCACATATAAC,0,2797245
ompRp1,0.5,1,1,CGGCCGAAGCCGGTAATGGG,0,2796392
ompRp1,0.5,1,1,CGGCCCCATTCCGTTACGAG,0,2802402
ompRp1,0.5,1,1,CGGCCACAGGCTGGTTAGTT,0,2824117
ompRp1,0.5,1,1,CGGCATTGGTCAATACCGTA,0,2792568
ompRp1,0.5,1,1,CGGCAGTCACACATTCTTAT,0,2782058
ompRp1,0.5,1,1,CGGCACTGCGGTAGGCAGGT,0,2780387
ompRp1,0.5,1,1,CGGATTGGGGGTCGGGGATA,0,2768679
ompRp1,0.5,1,1,CGGATGCTCACACACTTCGC,0,2780177
ompRp1,0.5,1,1,CGGATGATTCTCTGTTCTCA,0,2804950
ompRp1,0.5,1,1,CGGATAGAGAGGTATGCTCC,0,2786948
ompRp1,0.5,1,1,CGGATACAGAGTCATTCTTA,0,2806479
ompRp1,0.5,1,1,CGGAGTTAACGGCCGTGAGC,0,2775933
ompRp1,0.5,1,1,CGGAGGGTAGCAAAAGTGTC,0,2798938
ompRp1,0.5,1,1,CGGAGAGTCGGACCGGCGAA,0,2766597
ompRp1,0.5,1,1,CGGACTTATTGGCAGTAGGA,0,2817573
ompRp1,0.5,1,1,CGGACCAGTAGGCTAACAGA,0,2818030
ompRp1,0.5,1,1,CGGACAGTCATAGTCTGTCA,0,2820229
ompRp1,0.5,1,1,CGGAACGTCGGCGAAACAGT,0,2815593
ompRp1,0.5,1,1,CGCTTTGTGTATGTACGACC,0,2772841
ompRp1,0.5,1,1,CGCTTTGCCTAACGGGCTTT,0,2815267
ompRp1,0.5,1,1,CGCTGCTTGCAGCTGTCTTG,0,2805303
ompRp1,0.5,1,1,CGCTACGCAGAAAAATCTCA,0,2795966
ompRp1,0.5,1,1,CGCTAAGTAGGAGGTGTGAC,0,2810453
ompRp1,0.5,1,1,CGCGTACGTACTCGGATCCT,0,2769995
ompRp1,0.5,1,1,CGCGTAATCCCCATGAGCCA,0,2783778
ompRp1,0.5,1,1,CGCGTAAACTTCTTGACATC,0,2782458
ompRp1,0.5,1,1,CGCGGGTAATAATGGGCTTG,0,2772953
ompRp1,0.5,1,1,CGCGGATAATTTTAAAGCAA,0,2803988
ompRp1,0.5,1,1,CGCGGAAATGTTACCAATTA,0,2803096
ompRp1,0.5,1,1,CGCGATGTACTAAAAGGATG,0,2786817
ompRp1,0.5,1,1,CGCGAGGATGCTATCAGCTA,0,2813868
ompRp1,0.5,1,1,CGCGAAGAACGCAAGTAGCA,0,2809360
ompRp1,0.5,1,1,CGCCGTCGATAGTTTGGCAA,0,2821926
ompRp1,0.5,1,1,CGCCGGGACACACTAACAAT,0,2821144
ompRp1,0.5,1,1,CGCCGGCCATCCCCCAAATC,0,2795203
ompRp1,0.5,1,1,CGCCCGGCGTATCTACGTCG,0,2773637
ompRp1,0.5,1,1,CGCCCCCTACAGTAGCGAAT,0,2812762
ompRp1,0.5,1,1,CGCCCACCGCGGGCTCTTGC,0,2810027
ompRp1,0.5,1,1,CGCCATTTTCGTCAAGTCCG,0,2791135
ompRp1,0.5,1,1,CGCATTGCACTGTGCAAACG,0,2792709
ompRp1,0.5,1,1,CGCATCCCCTCACGATCATG,0,2824662
ompRp1,0.5,1,1,CGCATATGGATCCGGTGGCG,0,2767683
ompRp1,0.5,1,1,CGCATACACGAGGCGCGGAC,0,2789323
ompRp1,0.5,1,1,CGCAGGACTGTGGCGTAATG,0,2803603
ompRp1,0.5,1,1,CGCAGGACAGTGTGACGCCC,0,2803388
ompRp1,0.5,1,1,CGCACTCCTTCAGGCCAGGG,0,2795825
ompRp1,0.5,1,1,CGCACTAAGCAATTGATGCT,0,2784258
ompRp1,0.5,1,1,CGCAATTCTAGCTATCGGTC,0,2775430
ompRp1,0.5,1,1,CGCAATTCCGGGAGTATAAT,0,2821168
ompRp1,0.5,1,1,CGCAATCAAGTCTGACCCTA,0,2769320
ompRp1,0.5,1,1,CGCAAGATATGGTGCACACC,0,2823758
ompRp1,0.5,1,1,CGCAACGGGCCGCTTGGGGG,0,2812168
ompRp1,0.5,1,1,CGCAAAGCACATCGGAGGTC,0,2799334
ompRp1,0.5,1,1,CGATTTCCGGGCAACGGTGG,0,2800559
ompRp1,0.5,1,1,CGATTTCCACAAGCTTAATA,0,2802709
ompRp1,0.5,1,1,CGATTTACCGATCCTTTAGT,0,2780435
ompRp1,0.5,1,1,CGATTTAACTGCCAGCAAGC,0,2781223
ompRp1,0.5,1,1,CGATTGTCCCGGCGTTATGC,0,2815828
ompRp1,0.5,1,1,CGATTGAATATGAGACGTTA,0,2789822
ompRp1,0.5,1,1,CGATGGCTATTTCTAGGCTA,0,2791494
ompRp1,0.5,1,1,CGATGACGTTCCGTGGCGAC,0,2798646
ompRp1,0.5,1,1,CGATGAAGCGAGAATTAATT,0,2774686
ompRp1,0.5,1,1,CGATCCGGGCAGTACCTCAA,0,2821949
ompRp1,0.5,1,1,CGATAGATGTATGGAGGCTT,0,2771813
ompRp1,0.5,1,1,CGATAACTTAATAGAATTCT,0,2776540
ompRp1,0.5,1,1,CGAGTGATAGGACCACCGAG,0,2802486
ompRp1,0.5,1,1,CGAGCTACAAATCTGTAATT,0,2783925
ompRp1,0.5,1,1,CGAGCGTTTGAGTTTTAGAC,0,2766515
ompRp1,0.5,1,1,CGAGCGTCGATCCCGAAAGT,0,2805739
ompRp1,0.5,1,1,CGAGCGCACATCGTTCCAAG,0,2811370
ompRp1,0.5,1,1,CGAGATTTTGAGTCGCTGCT,0,2813356
ompRp1,0.5,1,1,CGAGATTGTGGTGGTTGGTC,0,2782736
ompRp1,0.5,1,1,CGAGATTCATTGGTATTCGA,0,2815796
ompRp1,0.5,1,1,CGAGATCGCTTGCTGGATTC,0,2801499
ompRp1,0.5,1,1,CGAGAGTCTGAGAGAGTTTA,0,2770256
ompRp1,0.5,1,1,CGAGACGCTCGCAACTTTCA,0,2805141
ompRp1,0.5,1,1,CGAGAACGAGTGGGCAGCGC,0,2808111
ompRp1,0.5,1,1,CGACTAATCTGACCATCTAT,0,2798657
ompRp1,0.5,1,1,CGACTAACACAGCCGTTGGG,0,2783794
ompRp1,0.5,1,1,CGACGTTAGTCCAGTAGCCG,0,2786559
ompRp1,0.5,1,1,CGACGTGCGTGTTGCTAAAG,0,2791890
ompRp1,0.5,1,1,CGACGGTACAGAGATTAGTC,0,2799424
ompRp1,0.5,1,1,CGACGGCCTAATAAAGGTCA,0,2801492
ompRp1,0.5,1,1,CGACCATTTGGGCTTAGTAC,0,2824348
ompRp1,0.5,1,1,CGACCATCAAAGCGGTTGCA,0,2797343
ompRp1,0.5,1,1,CGACATGAAAGGTTGTGCTT,0,2803317
ompRp1,0.5,1,1,CGACACCTTCTTAATTTGTC,0,2778650
ompRp1,0.5,1,1,CGAATGAAATCTCTCTAGCA,0,2807015
ompRp1,0.5,1,1,CGAATCGAGCTTACACGTCC,0,2772082
ompRp1,0.5,1,1,CGAAGGTGCCCGGGTCAACA,0,2820650
ompRp1,0.5,1,1,CGAACTGGATTAGGTTGTAT,0,2766437
ompRp1,0.5,1,1,CGAACTCCAAAAGCTCCTCA,0,2802697
ompRp1,0.5,1,1,CGAACCCACAGACACGTGCA,0,2777036
ompRp1,0.5,1,1,CGAACCAAGTTTAAGACCCT,0,2821959
ompRp1,0.5,1,1,CGAACAAGCCTACCTCACGG,0,2791517
ompRp1,0.5,1,1,CGAAATCACGCATGAAGCGA,0,2789149
ompRp1,0.5,1,1,CGAAAGGGGACCGGTATAGG,0,2784493
ompRp1,0.5,1,1,CGAAACTTCACGTCCGCCCT,0,2805757
ompRp1,0.5,1,1,CCTTTATTTTATGCGCCGCT,0,2792713
ompRp1,0.5,1,1,CCTTTATAAATACTACTGTT,0,2786816
ompRp1,0.5,1,1,CCTTGTACGCTCTGGAACGC,0,2768826
ompRp1,0.5,1,1,CCTTGGACCCTATCCAAGTA,0,2804782
ompRp1,0.5,1,1,CCTTGACCATTGGCTAAGAA,0,2819538
ompRp1,0.5,1,1,CCTTCTCCTAAGAAGGCACG,0,2794911
ompRp1,0.5,1,1,CCTTCCTTAGTTACCTGAGA,0,2787319
ompRp1,0.5,1,1,CCTTCATTACTTTCGGCTCC,0,2811790
ompRp1,0.5,1,1,CCTTCAATTGACTTTTTGGT,0,2817312
ompRp1,0.5,1,1,CCTTAAAACGTCCTGACGTA,0,2816202
ompRp1,0.5,1,1,CCTGGTTAATTTGCGGACAG,0,2785913
ompRp1,0.5,1,1,CCTGGTCGTAGCGTAAACAG,0,2777378
ompRp1,0.5,1,1,CCTGGGGTTGGTAACGTGTG,0,2798402
ompRp1,0.5,1,1,CCTGGGCCTCAGTAGTTGTC,0,2806027
ompRp1,0.5,1,1,CCTGGGAGGTGGGAGTAAGT,0,2814377
ompRp1,0.5,1,1,CCTGCGGTAGCATTAGTTCT,0,2817525
ompRp1,0.5,1,1,CCTGCGGGACGCACATGAAA,0,2812127
ompRp1,0.5,1,1,CCTGCGCGTTATCATAAAGA,0,2812722
ompRp1,0.5,1,1,CCTGACCCTTGTATACCAGC,0,2771237
ompRp1,0.5,1,1,CCTCTTGGAGTGATGCATTA,0,2776998
ompRp1,0.5,1,1,CCTCTTCAGTACGAAGAATG,0,2788573
ompRp1,0.5,1,1,CCTCGTCTCAAGTTTGTATT,0,2767916
ompRp1,0.5,1,1,CCTCGTATTATGATGTGGTT,0,2809869
ompRp1,0.5,1,1,CCTCGCAGCCTACGAAACAT,0,2789069
ompRp1,0.5,1,1,CCTCCTAGGCGAGTCCCACA,0,2801208
ompRp1,0.5,1,1,CCTCCGTGGTCCACGGTATT,0,2817537
ompRp1,0.5,1,1,CCTCCGCCCCAGTGCACCTA,0,2809289
ompRp1,0.5,1,1,CCTCCGCAAGTGACCGGTCC,0,2816264
ompRp1,0.5,1,1,CCTCAGTAAAGAGTGTCAAG,0,2766626
ompRp1,0.5,1,1,CCTCAGGTAGATCCTTGCCA,0,2796112
ompRp1,0.5,1,1,CCTCACCTAATTTTGAAAAC,0,2821822
ompRp1,0.5,1,1,CCTCAAACTATTGCCGATGG,0,2814487
ompRp1,0.5,1,1,CCTATTCATATTGGCGAGAC,0,2817256
ompRp1,0.5,1,1,CCTATGCACGCACGGGAGAT,0,2776273
ompRp1,0.5,1,1,CCTATCTTGTGCTTTGATCC,0,2814942
ompRp1,0.5,1,1,CCTATAGTTTTTGATGGCGT,0,2810540
ompRp1,0.5,1,1,CCTATACCCTATCCTACAAC,0,2789100
ompRp1,0.5,1,1,CCTAGTTTGTTGGCTGGACC,0,2788784
ompRp1,0.5,1,1,CCTAGTTCACAGAAACTTCC,0,2815558
ompRp1,0.5,1,1,CCTAGTGAAGTGAATATCCC,0,2818658
ompRp1,0.5,1,1,CCTACGTACTCTACCTCGGA,0,2810261
ompRp1,0.5,1,1,CCTACCATTCCCTTGCACAG,0,2784406
ompRp1,0.5,1,1,CCTACCAAGGCCCGGCTCTT,0,2788113
ompRp1,0.5,1,1,CCTAATGGCATCCTTTAATT,0,2767221
ompRp1,0.5,1,1,CCTAAGAACCGCGCCCGTGA,0,2780493
ompRp1,0.5,1,1,CCTAACGAAGAACACGGCGA,0,2776446
ompRp1,0.5,1,1,CCGTTTTTCTATTTGCTTGC,0,2808074
ompRp1,0.5,1,1,CCGTTTCACAACATGACATG,0,2768551
ompRp1,0.5,1,1,CCGTTTATCCTCGGAAAATG,0,2800569
ompRp1,0.5,1,1,CCGTGTCTGTGAGTGGATAG,0,2785290
ompRp1,0.5,1,1,CCGTGGCGGAGGTTACCAGT,0,2779607
ompRp1,0.5,1,1,CCGTGGCAGGCCGCCTCCTG,0,2795591
ompRp1,0.5,1,1,CCGTGCGATGATACTTTGTC,0,2766005
ompRp1,0.5,1,1,CCGTCTGCCGAGCGTCAAAT,0,2778140
ompRp1,0.5,1,1,CCGTAGTCACGTCAGATGCT,0,2799471
ompRp1,0.5,1,1,CCGTACCTCGGCCTGTCCTG,0,2774482
ompRp1,0.5,1,1,CCGTAATTCACGGCACCACC,0,2784096
ompRp1,0.5,1,1,CCGTAAATTTGAACACTTCT,0,2808951
ompRp1,0.5,1,1,CCGGTTGAGTACACCGGACA,0,2776980
ompRp1,0.5,1,1,CCGGTGACCGATATTTGTTC,0,2824585
ompRp1,0.5,1,1,CCGGGTTGGGCCATAGACTA,0,2801320
ompRp1,0.5,1,1,CCGGGTCTGCTCACCAGCGG,0,2806789
ompRp1,0.5,1,1,CCGGGCTGGTGTGAGGCTTG,0,2798694
ompRp1,0.5,1,1,CCGGGCAGGCTAACAGATCG,0,2814005
ompRp1,0.5,1,1,CCGGCTTTCACATATAAGAC,0,2818509
ompRp1,0.5,1,1,CCGGCGATACTGTTTGACTG,0,2767790
ompRp1,0.5,1,1,CCGGCCTTCCGAGGTTTGTA,0,2771481
ompRp1,0.5,1,1,CCGGCCATAACGGGTTATAT,0,2765468
ompRp1,0.5,1,1,CCGGAATTGAATGAGACGTC,0,2771877
ompRp1,0.5,1,1,CCGCTGGCGGCAGACGGCCG,0,2802784
ompRp1,0.5,1,1,CCGCTCGACTCGGCAATCAG,0,2781931
ompRp1,0.5,1,1,CCGCTAACCCAACAATTTCC,0,2774662
ompRp1,0.5,1,1,CCGCGGATTACATTTAAGTT,0,2776927
ompRp1,0.5,1,1,CCGCGCTATTTCTGTCATGT,0,2823901
ompRp1,0.5,1,1,CCGCCGTCAAAAGCGTACAA,0,2769303
ompRp1,0.5,1,1,CCGCCGATTTCCTCTTGCGA,0,2791793
ompRp1,0.5,1,1,CCGCAGAATTCACAACGGCC,0,2817072
ompRp1,0.5,1,1,CCGCACAGCTTCAGATTTTA,0,2808511
ompRp1,0.5,1,1,CCGATTGCGTATTGACATAC,0,2804453
ompRp1,0.5,1,1,CCGAGTCTAAGGAAGTGGGG,0,2772286
ompRp1,0.5,1,1,CCGAGTAGCATGAAACTTTT,0,2777699
ompRp1,0.5,1,1,CCGAGGTTCAGGTGCTGGGG,0,2790625
ompRp1,0.5,1,1,CCGAGGCTGATATGCAACCG,0,2777162
ompRp1,0.5,1,1,CCGAGAAACAAGCCCCTTGT,0,2785727
ompRp1,0.5,1,1,CCGACGCTGAGCGCTCCTAC,0,2800059
ompRp1,0.5,1,1,CCGACCGGGGCTCATATGAG,0,2788036
ompRp1,0.5,1,1,CCGACATACAGCAAATTCAC,0,2799681
ompRp1,0.5,1,1,CCGAATCCGCACTCAATCCG,0,2809107
ompRp1,0.5,1,1,CCGAATACGGTACAACTTGT,0,2805636
ompRp1,0.5,1,1,CCGAACGGTGCGACAACGGA,0,2788487
ompRp1,0.5,1,1,CCCTTTTGCTACTGACATAG,0,2811599
ompRp1,0.5,1,1,CCCTTGCTCAAGACGGCTGC,0,2798656
ompRp1,0.5,1,1,CCCTTAAGGCCTGTCAGAAG,0,2815306
ompRp1,0.5,1,1,CCCTGTGTTGACTCGTATTT,0,2820836
ompRp1,0.5,1,1,CCCTGTGCGGGGCACCGATC,0,2794165
ompRp1,0.5,1,1,CCCTGCCCTAGAAGGTGGTA,0,2821740
ompRp1,0.5,1,1,CCCTGCCCCAGACATGCCCC,0,2797377
ompRp1,0.5,1,1,CCCTCTCATGTACCACAGTT,0,2799483
ompRp1,0.5,1,1,CCCTCGTCTTGTAGGGCTTG,0,2799175
ompRp1,0.5,1,1,CCCTCGTCGCCGTTATTTCA,0,2823376
ompRp1,0.5,1,1,CCCTCGATCGTACATGTGGA,0,2780101
ompRp1,0.5,1,1,CCCTCCCAGGGCGGGATCAG,0,2807987
ompRp1,0.5,1,1,CCCTATTGTATGATCATATT,0,2785293
ompRp1,0.5,1,1,CCCTATAAATATAGGTACTG,0,2778626
ompRp1,0.5,1,1,CCCTAGTCACTTATCGATCA,0,2773550
ompRp1,0.5,1,1,CCCTAAAGTCATAGTTTATT,0,2809437
ompRp1,0.5,1,1,CCCGTTGGATCAAGGAGTGT,0,2781847
ompRp1,0.5,1,1,CCCGTGGTTAAGTGTCTAGA,0,2803772
ompRp1,0.5,1,1,CCCGTATAGATTGCCGCCAT,0,2775420
ompRp1,0.5,1,1,CCCGGTCGAGCCCGGCCGTA,0,2790663
ompRp1,0.5,1,1,CCCGGCAGTGTCCTGGCGGG,0,2802951
ompRp1,0.5,1,1,CCCGGAAGTTCACAGATTAG,0,2799748
ompRp1,0.5,1,1,CCCGCTTGCTCGGGAAAACC,0,2775191
ompRp1,0.5,1,1,CCCGCGCATTCTTTGAAGCG,0,2787129
ompRp1,0.5,1,1,CCCCTCATCTCAACGAACGA,0,2801938
ompRp1,0.5,1,1,CCCCTAGGACTATGTAGCGA,0,2803867
ompRp1,0.5,1,1,CCCCGTCTGATACGATCTTG,0,2807013
ompRp1,0.5,1,1,CCCCGTAAAAACATCCATAG,0,2802575
ompRp1,0.5,1,1,CCCCGCGCGTACTATTGCCT,0,2779870
ompRp1,0.5,1,1,CCCCGCCTCAGGTAGGCGTT,0,2805768
ompRp1,0.5,1,1,CCCCCTGCACCCAGCATAGT,0,2792106
ompRp1,0.5,1,1,CCCCCACAACATCGAGTAAT,0,2777306
ompRp1,0.5,1,1,CCCCCAAATCTCATAAGGGC,0,2820171
ompRp1,0.5,1,1,CCCCAGTGCGCCGAGGCTCT,0,2817992
ompRp1,0.5,1,1,CCCCACGATGACCTGCCAGT,0,2773159
ompRp1,0.5,1,1,CCCCACACCCGTCGTGTCCA,0,2796235
ompRp1,0.5,1,1,CCCATTGGCCAGTCTGGTAA,0,2768425
ompRp1,0.5,1,1,CCCATTGGACTATATCGCCT,0,2819888
ompRp1,0.5,1,1,CCCATTCAATTATCCGAGTC,0,2773528
ompRp1,0.5,1,1,CCCATGTATCGCGTTACCAG,0,2786378
ompRp1,0.5,1,1,CCCATCGCCATTACTGTCAA,0,2786732
ompRp1,0.5,1,1,CCCAGACACCTATCTGCGTC,0,2806021
ompRp1,0.5,1,1,CCCACGACTACAATGCCAGT,0,2805435
ompRp1,0.5,1,1,CCCAATGGACACACATGGCG,0,2793073
ompRp1,0.5,1,1,CCCAATCTTGCTTGGCAACG,0,2769384
ompRp1,0.5,1,1,CCCAAGCGGGAAGCCTTGGG,0,2823443
ompRp1,0.5,1,1,CCCAACTGCGGGCCTTCTTG,0,2768228
ompRp1,0.5,1,1,CCATTTATTTCTTATATGTC,0,2765905
ompRp1,0.5,1,1,CCATTGTTTGACGGGGGCAC,0,2802633
ompRp1,0.5,1,1,CCATTGGTTTTACACGCCGT,0,2786302
ompRp1,0.5,1,1,CCATTGCGAACGGGTGGTTG,0,2783593
ompRp1,0.5,1,1,CCATGTTTAGGTGGCACAGC,0,2774606
ompRp1,0.5,1,1,CCATGCTTATCGACCTAAAG,0,2820414
ompRp1,0.5,1,1,CCATGCCCCGTTCCGGGCAG,0,2820270
ompRp1,0.5,1,1,CCATGATGCCTTAACCTGCA,0,2784294
ompRp1,0.5,1,1,CCATGAACTAAATTGTACGC,0,2770345
ompRp1,0.5,1,1,CCATCGGGTTCAAAGGCATT,0,2792984
ompRp1,0.5,1,1,CCATCGAGTCACAGGGTGGC,0,2780991
ompRp1,0.5,1,1,CCATCATTTACCGTTATTGA,0,2821886
ompRp1,0.5,1,1,CCATAGTTCAGGAGAAGGGG,0,2794461
ompRp1,0.5,1,1,CCATAACCTGCGAACAGCCG,0,2795678
ompRp1,0.5,1,1,CCAGTGACCTCGAAACAAAC,0,2808641
ompRp1,0.5,1,1,CCAGTCGATCGTTTTGGACA,0,2779345
ompRp1,0.5,1,1,CCAGTAACACAAGCGGCCGA,0,2770808
ompRp1,0.5,1,1,CCAGGCTCGAGGATTTGCGT,0,2767744
ompRp1,0.5,1,1,CCAGGACGTACGACGCTGCT,0,2805139
ompRp1,0.5,1,1,CCAGCTGGGGTTTTGGCAGA,0,2777160
ompRp1,0.5,1,1,CCAGCCTGGAGTATAACATG,0,2810436
ompRp1,0.5,1,1,CCAGATTATAGGGCTACCCC,0,2804299
ompRp1,0.5,1,1,CCAGAAGCTGCCAGCAAGTT,0,2812699
ompRp1,0.5,1,1,CCAGAAGACCACAGAGCATC,0,2771862
ompRp1,0.5,1,1,CCACTCTACCCGCGTATTCG,0,2781636
ompRp1,0.5,1,1,CCACTCGGGACACGAAAGTG,0,2806783
ompRp1,0.5,1,1,CCACTATAGTATAGAAAGCT,0,2783277
ompRp1,0.5,1,1,CCACGCTGAGCAAGCCAAGA,0,2792649
ompRp1,0.5,1,1,CCACGCTAAGAAAACCCTGC,0,2795172
ompRp1,0.5,1,1,CCACGAGCCGTAGTTGGACC,0,2776342
ompRp1,0.5,1,1,CCACGAACGGCCAAATTACT,0,2783256
ompRp1,0.5,1,1,CCACCGCTCCTTTAAGCAGC,0,2800489
ompRp1,0.5,1,1,CCACCCCTCGCGAATCTGAG,0,2823706
ompRp1,0.5,1,1,CCACACTAGGTTACACTGTT,0,2810054
ompRp1,0.5,1,1,CCACACCCCTCCGCTAGCAA,0,2803702
ompRp1,0.5,1,1,CCAATGTTTTGATCGGAAGT,0,2809858
ompRp1,0.5,1,1,CCAATGTATTTTGTGGCATG,0,2812464
ompRp1,0.5,1,1,CCAAGGTACGCATAGACCGC,0,2768173
ompRp1,0.5,1,1,CCAAGGCCAAATATGCACAG,0,2808377
ompRp1,0.5,1,1,CCAAGATTCCCTGGTGCTGC,0,2816632
ompRp1,0.5,1,1,CCAACTAGAAGTGGCTTATC,0,2789238
ompRp1,0.5,1,1,CCAACGACCGACAGTAAAAG,0,2813602
ompRp1,0.5,1,1,CCAAATGCACGTCATGCTTA,0,2807034
ompRp1,0.5,1,1,CCAAACTGGTGCCGTGGACT,0,2770280
ompRp1,0.5,1,1,CCAAACGTTGTTGGACCGCG,0,2776152
ompRp1,0.5,1,1,CATTTTCAATGCGCCGCGTA,0,2777152
ompRp1,0.5,1,1,CATTTCTCCGACACAGCGCT,0,2789986
ompRp1,0.5,1,1,CATTTACCTAACAATTTATG,0,2775386
ompRp1,0.5,1,1,CATTTAAATATGCATAATGA,0,2790520
ompRp1,0.5,1,1,CATTGTGAAGAGGCTCTACT,0,2776365
ompRp1,0.5,1,1,CATTGGGTAGTGAGAGGAGA,0,2769196
ompRp1,0.5,1,1,CATTCGATGTTTCGGCTGGG,0,2780397
ompRp1,0.5,1,1,CATTAGAATGAGGCCGAATG,0,2785237
ompRp1,0.5,1,1,CATTAACATCGAGCTGATAG,0,2808203
ompRp1,0.5,1,1,CATGTTTAATCATCCCGTGG,0,2806325
ompRp1,0.5,1,1,CATGTGTCTCGGATCGGCCA,0,2787061
ompRp1,0.5,1,1,CATGTGTATTAGTTAAATGC,0,2804689
ompRp1,0.5,1,1,CATGTCGATGCAACTTTCCT,0,2805254
ompRp1,0.5,1,1,CATGTATGGCGGACACCAAG,0,2779407
ompRp1,0.5,1,1,CATGGTTACTGCGGGCACAG,0,2821163
ompRp1,0.5,1,1,CATGGTCTGCATTGTTTGCG,0,2793063
ompRp1,0.5,1,1,CATGGTATGTTCCTAGTTGG,0,2778018
ompRp1,0.5,1,1,CATGGGGATCAGGGAAATAC,0,2814417
ompRp1,0.5,1,1,CATGGAGACGTGAAAAGTCT,0,2768686
ompRp1,0.5,1,1,CATGCTCTTCATCCCCAGGC,0,2814253
ompRp1,0.5,1,1,CATGACGAAGAATGGGATCG,0,2813378
ompRp1,0.5,1,1,CATGAACGGCACCAGAGCTA,0,2819311
ompRp1,0.5,1,1,CATGAAAGAAACCCAACAAT,0,2814776
ompRp1,0.5,1,1,CATCTTAGGAGTCTCATTTT,0,2786476
ompRp1,0.5,1,1,CATCGTTAGACAGCATCTAC,0,2797308
ompRp1,0.5,1,1,CATCGGTGGGCTGTGCCTAA,0,2782986
ompRp1,0.5,1,1,CATCGGGGGGAGAATGTGAT,0,2784387
ompRp1,0.5,1,1,CATCCAGTCCAGAACACTTC,0,2799210
ompRp1,0.5,1,1,CATCCACCGGAGTCAGCTCT,0,2822665
ompRp1,0.5,1,1,CATCATCAGTTAAGGACCGA,0,2823145
ompRp1,0.5,1,1,CATCAGTGTCAAGATACGAT,0,2796663
ompRp1,0.5,1,1,CATCAAGCGCGGATTGGTTC,0,2815191
ompRp1,0.5,1,1,CATATGGTAAGGTATATCAT,0,2778387
ompRp1,0.5,1,1,CATATGACCCCACTATCCCA,0,2796300
ompRp1,0.5,1,1,CATATCGTAGATCCCTGTTA,0,2813507
ompRp1,0.5,1,1,CATATCACTCTATTATTAAG,0,2790054
ompRp1,0.5,1,1,CATATAGCAATAAATAGGCT,0,2786694
ompRp1,0.5,1,1,CATAGTAAGGAAAAGTCCGA,0,2799409
ompRp1,0.5,1,1,CATAGGTGGTGGAGTAGCTT,0,2802325
ompRp1,0.5,1,1,CATAGGGATTCATTCTATAG,0,2787446
ompRp1,0.5,1,1,CATAGCCTAGATCACCTTGG,0,2768935
ompRp1,0.5,1,1,CATACTCCGCTGGTCCACAC,0,2783929
ompRp1,0.5,1,1,CATACTCAAAACTGTCACTT,0,2815190
ompRp1,0.5,1,1,CATACGGAGGAAGACACGTA,0,2768932
ompRp1,0.5,1,1,CATACCCATACGACAAGTCT,0,2775676
ompRp1,0.5,1,1,CATACATGCCACGAAAGATT,0,2808161
ompRp1,0.5,1,1,CATAATGTTCCGAAGATCAT,0,2776859
ompRp1,0.5,1,1,CATAAGAACCTATTTGAGCC,0,2814823
ompRp1,0.5,1,1,CAGTTTGCTGAACCAGTCGC,0,2798681
ompRp1,0.5,1,1,CAGTTTCTACAAAGCCCAGA,0,2796616
ompRp1,0.5,1,1,CAGTTCGAGCTATGCAAAAC,0,2794453
ompRp1,0.5,1,1,CAGTGGTCATTTAATAGATA,0,2798178
ompRp1,0.5,1,1,CAGTGGGGGCTGGTCCCGTT,0,2765470
ompRp1,0.5,1,1,CAGTGGAGGAGGTTGCGGCC,0,2818632
ompRp1,0.5,1,1,CAGTGCCTCTCTGCCGATTC,0,2782882
ompRp1,0.5,1,1,CAGTCGGCCGATTGTGACAG,0,2803659
ompRp1,0.5,1,1,CAGTCCGAAGGGCACGTTTA,0,2785444
ompRp1,0.5,1,1,CAGTAAGGTCAAGTTACACC,0,2766867
ompRp1,0.5,1,1,CAGGTTGGGCAAACACGACG,0,2778575
ompRp1,0.5,1,1,CAGGTCAGACGAAAGAAGGT,0,2822688
ompRp1,0.5,1,1,CAGGTCACTTAGATTCTCCG,0,2823935
ompRp1,0.5,1,1,CAGGTATGCCTGATCCGGAA,0,2796026
ompRp1,0.5,1,1,CAGGGTGGTTCGCCTAAATA,0,2800799
ompRp1,0.5,1,1,CAGGGTGCTGTGCTATGTGC,0,2779788
ompRp1,0.5,1,1,CAGGGTGAAGGCGTGGATCG,0,2793663
ompRp1,0.5,1,1,CAGGGTATGACGGCATTTGA,0,2808833
ompRp1,0.5,1,1,CAGGGTACGTATTTCAGTGC,0,2769434
ompRp1,0.5,1,1,CAGGGCACGGCCTCCCTCAA,0,2790125
ompRp1,0.5,1,1,CAGGGAGCCGCACCTGCTCC,0,2787672
ompRp1,0.5,1,1,CAGGGAAACACTTGCGCTGT,0,2819683
ompRp1,0.5,1,1,CAGGCTTGAACCAAAACGGC,0,2781631
ompRp1,0.5,1,1,CAGGCATAAAAGTTGGGTAG,0,2781627
ompRp1,0.5,1,1,CAGGCAGGCTATTGTGGGAT,0,2811668
ompRp1,0.5,1,1,CAGGCACCGTTGGAACGAAC,0,2786693
ompRp1,0.5,1,1,CAGGATTCGGCCCGACCTCC,0,2776920
ompRp1,0.5,1,1,CAGGACTGGCGCGACACTGT,0,2768386
ompRp1,0.5,1,1,CAGGAAGCTTCGAGAGGTAC,0,2798061
ompRp1,0.5,1,1,CAGGAACCAAAGTGCGCCCA,0,2820865
ompRp1,0.5,1,1,CAGCTTCTTGTAGTATGTGA,0,2768629
ompRp1,0.5,1,1,CAGCTGAGCAATACACACTT,0,2778701
ompRp1,0.5,1,1,CAGCGTCTGGACACTGGTAC,0,2806385
ompRp1,0.5,1,1,CAGCGTCTCTTGCAGCTCGA,0,2819135
ompRp1,0.5,1,1,CAGCGGACCCGAATGGACTA,0,2812507
ompRp1,0.5,1,1,CAGCCTTGTCGTAACCGGCA,0,2816173
ompRp1,0.5,1,1,CAGCCGGTTTCATTTATAAG,0,2822609
ompRp1,0.5,1,1,CAGCCATTCGCCCTAGGGGC,0,2802798
ompRp1,0.5,1,1,CAGCACTTTCTCGGCTCAGC,0,2799720
ompRp1,0.5,1,1,CAGCACTCCTGTGTCGTGTA,0,2814047
ompRp1,0.5,1,1,CAGATCGGCGCGGGTGTTCT,0,2791052
ompRp1,0.5,1,1,CAGATCCTCAGCGACGTACT,0,2818411
ompRp1,0.5,1,1,CAGATCCAAGCGTACCGGCG,0,2808791
ompRp1,0.5,1,1,CAGAGGCGTTACAGGAGCTC,0,2783820
ompRp1,0.5,1,1,CAGACTCGTATTATTTTGAT,0,2812276
ompRp1,0.5,1,1,CAGACGGCGGTGTAATCGTC,0,2823418
ompRp1,0.5,1,1,CAGACGGCATGCAGGCAGCT,0,2803734
ompRp1,0.5,1,1,CAGACGCCTCTCTCTCGTTA,0,2774886
ompRp1,0.5,1,1,CAGACACGGGAATGAGATAT,0,2821931
ompRp1,0.5,1,1,CAGACAACCTGCTGTCTTAT,0,2800408
ompRp1,0.5,1,1,CAGAATTAAGGTCGGATTAA,0,2815649
ompRp1,0.5,1,1,CAGAAAACTGAATCTTCGAA,0,2814994
ompRp1,0.5,1,1,CACTGGCATCAGCTAACCTG,0,2821483
ompRp1,0.5,1,1,CACTCTCGGTCATCGACATT,0,2784625
ompRp1,0.5,1,1,CACTATGGAAAATGTTTTAT,0,2800883
ompRp1,0.5,1,1,CACTAGCTCTCTTCTTTGGC,0,2814560
ompRp1,0.5,1,1,CACTACTCCTTGCAATCAAA,0,2786957
ompRp1,0.5,1,1,CACGTGCTGTGCTATATGGA,0,2821510
ompRp1,0.5,1,1,CACGTCACTTACCGCGTATA,0,2782976
ompRp1,0.5,1,1,CACGTACTATCCGAGTCCTT,0,2788333
ompRp1,0.5,1,1,CACGTACCGTATCGCGGGCA,0,2803803
ompRp1,0.5,1,1,CACGGTTATAAAAAAAGCTG,0,2814839
ompRp1,0.5,1,1,CACGGTTAACCCTCTGACGT,0,2781198
ompRp1,0.5,1,1,CACGGGGCCGCCCAAGGACA,0,2776672
ompRp1,0.5,1,1,CACGGGGCCACCCAAGGACA,0,2776697
ompRp1,0.5,1,1,CACGGCGTCCTGATATGTCT,0,2791822
ompRp1,0.5,1,1,CACGGCCTACTGCTTGTGTA,0,2812148
ompRp1,0.5,1,1,CACGGAGATCTACGGTCTAC,0,2787780
ompRp1,0.5,1,1,CACGCTCAATAGCTTGAACT,0,2786348
ompRp1,0.5,1,1,CACGCTATTGGGTTCGGGGT,0,2814899
ompRp1,0.5,1,1,CACGCGTATCAATGAATCTC,0,2822793
ompRp1,0.5,1,1,CACGCCATTATTAGACAGCC,0,2772769
ompRp1,0.5,1,1,CACGAGCGCAGCCTGGTCGA,0,2802891
ompRp1,0.5,1,1,CACCTGGGTTACCGAAGTAG,0,2784980
ompRp1,0.5,1,1,CACCTGCGGTATCCTATCGA,0,2772787
ompRp1,0.5,1,1,CACCGGGCCATGTGTCCACG,0,2802712
ompRp1,0.5,1,1,CACCCGATTGTAGTTCAAGG,0,2801848
ompRp1,0.5,1,1,CACCCATTCTCGTACCCTTC,0,2794361
ompRp1,0.5,1,1,CACCACTCTGGGTCGTCGAA,0,2811695
ompRp1,0.5,1,1,CACCACCGGCATAGAACTTT,0,2780453
ompRp1,0.5,1,1,CACCACCAAGGATCGTGGTT,0,2768703
ompRp1,0.5,1,1,CACCAAGCTGGGGCTTATCA,0,2782940
ompRp1,0.5,1,1,CACCAAGAAGTTCTGTAGTA,0,2802412
ompRp1,0.5,1,1,CACATGTGCCACTGTAATGG,0,2821558
ompRp1,0.5,1,1,CACATCTCATCAAATGAAAA,0,2817244
ompRp1,0.5,1,1,CACATACCAAGGAACTCTAG,0,2799893
ompRp1,0.5,1,1,CACAGTCTTGTAGTGTCCCC,0,2765821
ompRp1,0.5,1,1,CACAGTATCGCTCAGCGGCC,0,2814946
ompRp1,0.5,1,1,CACAGACCATTTCTCGAGGT,0,2771722
ompRp1,0.5,1,1,CACAATGTCACTCAAGGGCA,0,2798127
ompRp1,0.5,1,1,CACAATCGAGCGACGCGATC,0,2773955
ompRp1,0.5,1,1,CACAAGTTATGACTGTATAG,0,2771310
ompRp1,0.5,1,1,CACAAAGGGCAAAGGACTAC,0,2767967
ompRp1,0.5,1,1,CAATTGCAAAATAATCATAA,0,2790353
ompRp1,0.5,1,1,CAATGTATCCCAACGAAACA,0,2804217
ompRp1,0.5,1,1,CAATGATAATAGCGCCGGAC,0,2780657
ompRp1,0.5,1,1,CAATCTTGGATGTCAATAGA,0,2774815
ompRp1,0.5,1,1,CAATCCTTCAGGACCTTTGA,0,2769633
ompRp1,0.5,1,1,CAATCCCGCAATTTTAAGCT,0,2773981
ompRp1,0.5,1,1,CAATCAAACACTGGACTTGT,0,2779833
ompRp1,0.5,1,1,CAATATAGCCATATTCCTGA,0,2801902
ompRp1,0.5,1,1,CAATATAAGGCCGGATGATC,0,2785497
ompRp1,0.5,1,1,CAAGGCGTTAAAGCGTGCCC,0,2809081
ompRp1,0.5,1,1,CAAGCTAGAAAAGGGCTCCA,0,2770194
ompRp1,0.5,1,1,CAAGATTAACGACCATCAAA,0,2775662
ompRp1,0.5,1,1,CAAGATGGCTGGACTCGCAG,0,2768416
ompRp1,0.5,1,1,CAAGATCTGCCTGCATTATT,0,2812658
ompRp1,0.5,1,1,CAAGAGTGCGATCACAGTCG,0,2803019
ompRp1,0.5,1,1,CAACTCCTTAGTCTATTGAT,0,2809333
ompRp1,0.5,1,1,CAACGGGGAGACTGTTCGCT,0,2800556
ompRp1,0.5,1,1,CAACCTGGGTGAGAAGCGTT,0,2792494
ompRp1,0.5,1,1,CAACCTGGACATGACAGGCA,0,2770857
ompRp1,0.5,1,1,CAACCGCCGTTTCATCCAAG,0,2814984
ompRp1,0.5,1,1,CAACCCAAGTGCGTCTTCGG,0,2775576
ompRp1,0.5,1,1,CAACATTGTTAGTACATCGG,0,2793243
ompRp1,0.5,1,1,CAAATCTATATAAGGTAAGT,0,2808145
ompRp1,0.5,1,1,CAAACAATTATGACGCTAGG,0,2786728
ompRp1,0.5,1,1,CAAACAAAAGTTGCGTTACA,0,2821139
ompRp1,0.5,1,1,ATTTTCTTAGACAGTGGGTC,0,2765700
ompRp1,0.5,1,1,ATTTTAGTCAAAGCAACGGA,0,2771036
ompRp1,0.5,1,1,ATTTGGTATTGCTCCGAACG,0,2766777
ompRp1,0.5,1,1,ATTTGGGCAGAGTTGGGCAA,0,2771648
ompRp1,0.5,1,1,ATTTGCACGTGGGAAATTTG,0,2812159
ompRp1,0.5,1,1,ATTTGCACCGTCACGCTTTA,0,2787789
ompRp1,0.5,1,1,ATTTGAAGAACAGGTCCGAT,0,2797487
ompRp1,0.5,1,1,ATTTCTGCGAGAAAGCATAT,0,2767979
ompRp1,0.5,1,1,ATTTCCATGACTCGCACTGA,0,2798444
ompRp1,0.5,1,1,ATTTAGACCGGCCGGTCTAA,0,2801057
ompRp1,0.5,1,1,ATTTACTTCCTTTCATTCCA,0,2792951
ompRp1,0.5,1,1,ATTTACGGGGAGTCCAACAA,0,2792452
ompRp1,0.5,1,1,ATTTAATGCGTGGCTGCCAC,0,2797468
ompRp1,0.5,1,1,ATTTAATCAGGGGCCTAACA,0,2785846
ompRp1,0.5,1,1,ATTTAAGAGGGAAGTTACCC,0,2772543
ompRp1,0.5,1,1,ATTGTATGCATACCCTCGGC,0,2824003
ompRp1,0.5,1,1,ATTGGCTGGACATTATTAAC,0,2810932
ompRp1,0.5,1,1,ATTGCGGACGTACCGTGGAC,0,2778491
ompRp1,0.5,1,1,ATTGAGGGGACCTGTGAAAC,0,2815603
ompRp1,0.5,1,1,ATTGAGAGCGTTCGTTACCT,0,2786540
ompRp1,0.5,1,1,ATTGAGAAGTTCTCTTAATT,0,2818694
ompRp1,0.5,1,1,ATTGACCTTGAGCACGAAAT,0,2803567
ompRp1,0.5,1,1,ATTCTTTGCGTAGCATTCGC,0,2773891
ompRp1,0.5,1,1,ATTCTGCTGTTGATTCTCTA,0,2816151
ompRp1,0.5,1,1,ATTCGGGCTGTAAACCATTG,0,2811665
ompRp1,0.5,1,1,ATTCGCTCGGATCGACGACT,0,2778355
ompRp1,0.5,1,1,ATTCGAGGCACCGCCTTTTC,0,2786597
ompRp1,0.5,1,1,ATTCGAACTTTGTGAGCAGC,0,2774244
ompRp1,0.5,1,1,ATTCCTTTCAATTTAGTGTT,0,2797080
ompRp1,0.5,1,1,ATTCCTCAAGCACATATTGC,0,2792647
ompRp1,0.5,1,1,ATTCCCCAAGCCGTCTATCC,0,2814622
ompRp1,0.5,1,1,ATTCCCACTAACTATTTATC,0,2791366
ompRp1,0.5,1,1,ATTCAAGACTGGGAGTTTGC,0,2805938
ompRp1,0.5,1,1,ATTCAACAAGCAGCGTCCCG,0,2799922
ompRp1,0.5,1,1,ATTATCTAACAGGTGGTTTC,0,2778668
ompRp1,0.5,1,1,ATTAGTGGGGATTCGACAGG,0,2823355
ompRp1,0.5,1,1,ATTAGGTGTCCCCTGCTGTT,0,2778085
ompRp1,0.5,1,1,ATTAGCCCTAAGAAAAATCA,0,2786807
ompRp1,0.5,1,1,ATTAGCATATTGATTCTGAA,0,2787429
ompRp1,0.5,1,1,ATTAGCATAGCACTGAACAT,0,2810090
ompRp1,0.5,1,1,ATTAGACTGACGTCAGAAGT,0,2783627
ompRp1,0.5,1,1,ATTACGACGGCGGAGAGTAT,0,2800217
ompRp1,0.5,1,1,ATTACACCAAAGAGTTCCGG,0,2803690
ompRp1,0.5,1,1,ATTAATTCATCTTAGACGAG,0,2778782
ompRp1,0.5,1,1,ATTAATCGTTTATTAATCCA,0,2808072
ompRp1,0.5,1,1,ATTAAGTAGGTCCGTATACA,0,2812391
ompRp1,0.5,1,1,ATTAACCCTTTTCTGACGCG,0,2805959
ompRp1,0.5,1,1,ATTAACCATATCAGAGAAGC,0,2780998
ompRp1,0.5,1,1,ATTAACATCCTCCCGTCAAT,0,2816274
ompRp1,0.5,1,1,ATTAAACAGTTTAGTTAGTG,0,2775054
ompRp1,0.5,1,1,ATGTTCCGAACGGAAATTGA,0,2771307
ompRp1,0.5,1,1,ATGTTATCTTCGTCGCTGGG,0,2797895
ompRp1,0.5,1,1,ATGTTAAGTGGGTACGCTCT,0,2821769
ompRp1,0.5,1,1,ATGTGCAGACATCTGGTCGC,0,2807893
ompRp1,0.5,1,1,ATGTATTTATAGGTACTTGC,0,2789638
ompRp1,0.5,1,1,ATGTAGCTGGATGGGACTTA,0,2812980
ompRp1,0.5,1,1,ATGTACTCGAGTAAAAGTGT,0,2821249
ompRp1,0.5,1,1,ATGTACTACGCCAGCACTGC,0,2787430
ompRp1,0.5,1,1,ATGTACGGAAGAGCACTCCC,0,2810097
ompRp1,0.5,1,1,ATGTAATTAAGTTCGGGAGG,0,2794580
ompRp1,0.5,1,1,ATGTAAACCTTCGTCCACTC,0,2808691
ompRp1,0.5,1,1,ATGGTTTGGGTTCGGCTATC,0,2785914
ompRp1,0.5,1,1,ATGGTTGCACCCCCGACGAA,0,2806069
ompRp1,0.5,1,1,ATGGTGGCGTCTCGTATCGA,0,2796901
ompRp1,0.5,1,1,ATGGGTGGATTCGAGGTAAA,0,2778182
ompRp1,0.5,1,1,ATGGGGCGAGATCGAGAGAT,0,2794348
ompRp1,0.5,1,1,ATGGGGAAATTTCTCAATGG,0,2794447
ompRp1,0.5,1,1,ATGGGAAGATTTACTGCTAC,0,2795326
ompRp1,0.5,1,1,ATGGCTGATCCTGCTTCTTA,0,2776263
ompRp1,0.5,1,1,ATGGCAGGAAGCTTGGTTAC,0,2817484
ompRp1,0.5,1,1,ATGGCAAATTGGTACCACGG,0,2812689
ompRp1,0.5,1,1,ATGCTCATTCCGGTAATATG,0,2778421
ompRp1,0.5,1,1,ATGCGTGTTACGGCTTACGG,0,2771139
ompRp1,0.5,1,1,ATGCGGCCTCGTTCTACCAT,0,2810139
ompRp1,0.5,1,1,ATGCGCCCAGGTGTACGCCT,0,2786574
ompRp1,0.5,1,1,ATGCGAGGGATAGCGATGAA,0,2795932
ompRp1,0.5,1,1,ATGCGAAGGAATGGTAATGT,0,2816043
ompRp1,0.5,1,1,ATGCCTTATGTTAGACAACC,0,2782313
ompRp1,0.5,1,1,ATGCCCAGGCAAGATACGGA,0,2798622
ompRp1,0.5,1,1,ATGCCATAGGCGGCCGTTAG,0,2774755
ompRp1,0.5,1,1,ATGCCAGGTTGATTATCACA,0,2795175
ompRp1,0.5,1,1,ATGCAGGAAAAACGGCGTCG,0,2806242
ompRp1,0.5,1,1,ATGCACTTTCATGCCCGCCT,0,2810581
ompRp1,0.5,1,1,ATGCAAGTTCGTTATCTGCA,0,2822774
ompRp1,0.5,1,1,ATGCAAGTCTCATGTACGGT,0,2766091
ompRp1,0.5,1,1,ATGATATTAGGCTTTCTATC,0,2802594
ompRp1,0.5,1,1,ATGAGCAGCTTTGAGATAGC,0,2781576
ompRp1,0.5,1,1,ATGAGAACTGTAGAGTGAAA,0,2824285
ompRp1,0.5,1,1,ATGACGCGCAACGCCGCAAT,0,2790787
ompRp1,0.5,1,1,ATGACGAATTGTGCATTCAT,0,2818219
ompRp1,0.5,1,1,ATGACATGGCCTTGTCAGTT,0,2782934
ompRp1,0.5,1,1,ATGAATGTTGTGAGCAGGGC,0,2791785
ompRp1,0.5,1,1,ATGAACGTGTAATTTTCTGC,0,2818686
ompRp1,0.5,1,1,ATGAACGCGCCTTCCTACGA,0,2768877
ompRp1,0.5,1,1,ATCTTGAGAGTATTAGTGCA,0,2785398
ompRp1,0.5,1,1,ATCTTCCGGTACCTTTGTCC,0,2818932
ompRp1,0.5,1,1,ATCTTCACTATGCGTCTGTA,0,2796743
ompRp1,0.5,1,1,ATCTGTCTGGATACATGGGA,0,2808662
ompRp1,0.5,1,1,ATCTGGGCCATGAAACCGGT,0,2803835
ompRp1,0.5,1,1,ATCTGCGCTACTGCATGAGG,0,2810431
ompRp1,0.5,1,1,ATCTGCCGTATATATCACTG,0,2770105
ompRp1,0.5,1,1,ATCTGCAAGCGCTGCGTCAC,0,2790948
ompRp1,0.5,1,1,ATCTGACACGCTCGATAGAC,0,2803228
ompRp1,0.5,1,1,ATCTCTCCGCAAGACTCGGT,0,2766972
ompRp1,0.5,1,1,ATCTCTACACAGTGTTTGTC,0,2802340
ompRp1,0.5,1,1,ATCTCGTGCACATCCGTTGT,0,2805779
ompRp1,0.5,1,1,ATCTCGGCCATGAATGTCTT,0,2775242
ompRp1,0.5,1,1,ATCTCAAGTCTTGCATCTAC,0,2785625
ompRp1,0.5,1,1,ATCTATATATTGTGGAACGA,0,2805906
ompRp1,0.5,1,1,ATCTAGCTGCAAACAGTTAG,0,2818858
ompRp1,0.5,1,1,ATCTACGAAAACGGTTGCAT,0,2786961
ompRp1,0.5,1,1,ATCGTTGTCAGGTTGGGCTC,0,2770998
ompRp1,0.5,1,1,ATCGTAGGGGACTGCAGGCA,0,2795131
ompRp1,0.5,1,1,ATCGGTGAACAAATCCGATC,0,2796554
ompRp1,0.5,1,1,ATCGGCTAGTTCGAAGATCG,0,2822627
ompRp1,0.5,1,1,ATCGGCATACTAGACAAGAG,0,2783893
ompRp1,0.5,1,1,ATCGCCGCCGCCAAAACGTC,0,2795919
ompRp1,0.5,1,1,ATCGCAACTTAGTTGACCAA,0,2801632
ompRp1,0.5,1,1,ATCGACTGTAGGCTATGTTG,0,2815205
ompRp1,0.5,1,1,ATCGACTGAGACCTTCGTGT,0,2803486
ompRp1,0.5,1,1,ATCCTTACAAGGCGGCTCGG,0,2770682
ompRp1,0.5,1,1,ATCCTCCACTAAGTTCTAAT,0,2815902
ompRp1,0.5,1,1,ATCCTATTACACCTATGAGA,0,2819867
ompRp1,0.5,1,1,ATCCTAAGAGCTACTCGCCG,0,2782774
ompRp1,0.5,1,1,ATCCGTACCGGTGCTTGATG,0,2787445
ompRp1,0.5,1,1,ATCCGGCAGGGAGTTACGCG,0,2768867
ompRp1,0.5,1,1,ATCCGAGTTTGTAAAGGGAC,0,2780300
ompRp1,0.5,1,1,ATCCCTGAACGACAAGCGTG,0,2810219
ompRp1,0.5,1,1,ATCCCGGGCAGACGGGGGGT,0,2795876
ompRp1,0.5,1,1,ATCCCCAAAATTGAGTCGGA,0,2789200
ompRp1,0.5,1,1,ATCCATGTGGATTGCGAGCA,0,2814182
ompRp1,0.5,1,1,ATCCAGCGTGTCGTATTGAA,0,2824509
ompRp1,0.5,1,1,ATCCACCATGATCCAATGTT,0,2796088
ompRp1,0.5,1,1,ATCATTGATTCCCCAGTATA,0,2788530
ompRp1,0.5,1,1,ATCATTCGAACTCAACTGCC,0,2799975
ompRp1,0.5,1,1,ATCATGAGGGAGCGAAGCGT,0,2778418
ompRp1,0.5,1,1,ATCATCGCGGCAACTCCCGG,0,2789926
ompRp1,0.5,1,1,ATCATCCATTCATTCCCTTG,0,2821611
ompRp1,0.5,1,1,ATCATAAGTTAGTGTTGACC,0,2813114
ompRp1,0.5,1,1,ATCAGTGATTTCATAAATAC,0,2804102
ompRp1,0.5,1,1,ATCAGGTTGGACCGGGTTGT,0,2776742
ompRp1,0.5,1,1,ATCAGGTGAGCTAACGGGGA,0,2787943
ompRp1,0.5,1,1,ATCAGCGTTGAACAGTGTAA,0,2810241
ompRp1,0.5,1,1,ATCAGAACACAATCCGTTTT,0,2811365
ompRp1,0.5,1,1,ATCACTGCTGTATACATGTA,0,2812101
ompRp1,0.5,1,1,ATCACGGGCGTATACGCAGG,0,2783289
ompRp1,0.5,1,1,ATCAATCTCGTTCCTAGAGG,0,2805322
ompRp1,0.5,1,1,ATCAATAGTCCACGGTTCTT,0,2768477
ompRp1,0.5,1,1,ATATTTAAGTTATGTGGGCT,0,2817076
ompRp1,0.5,1,1,ATATTCTGCTATTCACCGAC,0,2818922
ompRp1,0.5,1,1,ATATGGTCTCTCGTACCCTC,0,2789390
ompRp1,0.5,1,1,ATATGGGTACCGGCAGGAAG,0,2794116
ompRp1,0.5,1,1,ATATGCTCTGGTCGCTACGT,0,2781008
ompRp1,0.5,1,1,ATATGACGGATATATTGCGA,0,2775002
ompRp1,0.5,1,1,ATATGAATATCTTTTTAGAA,0,2780800
ompRp1,0.5,1,1,ATATCCATACTTGATAACCA,0,2784109
ompRp1,0.5,1,1,ATATCCACGCGACCCTTAAG,0,2774975
ompRp1,0.5,1,1,ATATAAGAGTAAGGGCCTAG,0,2766315
ompRp1,0.5,1,1,ATAGTGGCGTCCAAGGGGGT,0,2805426
ompRp1,0.5,1,1,ATAGTGCTTGCAGTTACTGT,0,2813491
ompRp1,0.5,1,1,ATAGTACAGTGGGATGTATG,0,2786969
ompRp1,0.5,1,1,ATAGGGCCGCAGATCAATTT,0,2783243
ompRp1,0.5,1,1,ATAGCTCAAAATAATCAATG,0,2794840
ompRp1,0.5,1,1,ATAGCATTATCCGGCTAAAG,0,2779934
ompRp1,0.5,1,1,ATAGCAGAATGCGGTGGAGC,0,2784652
ompRp1,0.5,1,1,ATAGATGGGATAAAACTCAT,0,2791073
ompRp1,0.5,1,1,ATAGAGAGATCTAAGGATAG,0,2806144
ompRp1,0.5,1,1,ATACTTTGGTCGGGGCCCCT,0,2807543
ompRp1,0.5,1,1,ATACTGCAAACCTGGGCAAA,0,2779761
ompRp1,0.5,1,1,ATACTGAAAGATAGGGGCGA,0,2769804
ompRp1,0.5,1,1,ATACTCGTAATATTAAGTGC,0,2800856
ompRp1,0.5,1,1,ATACTCCGATCCATCTGAAA,0,2793982
ompRp1,0.5,1,1,ATACGGCGGGTTGCTAAATT,0,2807054
ompRp1,0.5,1,1,ATACGCATGGTTGGAAAGGT,0,2815089
ompRp1,0.5,1,1,ATACGACTACGTTCCGTGTC,0,2814443
ompRp1,0.5,1,1,ATACCGGCGGTTTGCGGCTG,0,2822304
ompRp1,0.5,1,1,ATACCACTAAATAGCACGCA,0,2772247
ompRp1,0.5,1,1,ATACATGCTTCGTAGCACAT,0,2772696
ompRp1,0.5,1,1,ATACAGGGATTTTTGAGGCA,0,2779834
ompRp1,0.5,1,1,ATACAGGCTACGGATTATGA,0,2768172
ompRp1,0.5,1,1,ATACAGCCCTCGGGCTCACT,0,2773909
ompRp1,0.5,1,1,ATACACTGGCCCTGAGCCTT,0,2788915
ompRp1,0.5,1,1,ATAATTGGTAAACAAGTGAT,0,2796220
ompRp1,0.5,1,1,ATAATGATTGGCATGACCAC,0,2809795
ompRp1,0.5,1,1,ATAAGTATCCAAGATGCCTG,0,2774168
ompRp1,0.5,1,1,ATAACGGAGACCTCAGGCCT,0,2820658
ompRp1,0.5,1,1,ATAACAAAACTATCATTGGT,0,2772855
ompRp1,0.5,1,1,ATAAATTGCCAACCGGTAGA,0,2805774
ompRp1,0.5,1,1,ATAAATATGCGAGGGATAAA,0,2790368
ompRp1,0.5,1,1,ATAAAGTTCAGTTTGTAGGT,0,2819598
ompRp1,0.5,1,1,AGTTTTTTCTTTGCTGGCGT,0,2793615
ompRp1,0.5,1,1,AGTTTTTCCCTTGGGTTGGC,0,2820975
ompRp1,0.5,1,1,AGTTTGCGTGCGCCCGTCTG,0,2798153
ompRp1,0.5,1,1,AGTTTCCGTACACGGAAATA,0,2774631
ompRp1,0.5,1,1,AGTTGTTTTAATGAAAGGAT,0,2788617
ompRp1,0.5,1,1,AGTTGTTACCCAGGTGTCAT,0,2809446
ompRp1,0.5,1,1,AGTTGAACCGACTACGTTCT,0,2785232
ompRp1,0.5,1,1,AGTTCTCGACCTGGATCGAT,0,2785964
ompRp1,0.5,1,1,AGTTCCTCCCGAGGTGATTA,0,2815825
ompRp1,0.5,1,1,AGTTCATCCCATGATTCGTC,0,2772403
ompRp1,0.5,1,1,AGTTCAGTAAATTTGAGGAC,0,2769749
ompRp1,0.5,1,1,AGTTACACCTTGGGACAGGA,0,2816631
ompRp1,0.5,1,1,AGTGTTGGGTTTAGGTTTTG,0,2819497
ompRp1,0.5,1,1,AGTGTTCATCACTCTTACAA,0,2766442
ompRp1,0.5,1,1,AGTGTGGTCTAACGCGGATT,0,2806794
ompRp1,0.5,1,1,AGTGTGGGATTCGATTGGTG,0,2811698
ompRp1,0.5,1,1,AGTGTCGCTAGACTAGATTT,0,2767945
ompRp1,0.5,1,1,AGTGGGGATTATCACAAGCT,0,2770882
ompRp1,0.5,1,1,AGTGGCCAGAGACCGTCGTA,0,2818416
ompRp1,0.5,1,1,AGTGGAACTGCGATAATATT,0,2788249
ompRp1,0.5,1,1,AGTGCTGGGGCAACATGACA,0,2804851
ompRp1,0.5,1,1,AGTGCGCGCTAAAACCGTGT,0,2811460
ompRp1,0.5,1,1,AGTGATACCGTGGATTTATA,0,2785366
ompRp1,0.5,1,1,AGTGAGCGATCTACGTCATA,0,2796943
ompRp1,0.5,1,1,AGTGACTTGAGCGGAGCTAA,0,2817596
ompRp1,0.5,1,1,AGTCTCGTCCCGTCTCAGTG,0,2793975
ompRp1,0.5,1,1,AGTCTATTAGTCTTGACCTG,0,2816454
ompRp1,0.5,1,1,AGTCTATCTCCGCAAAGTTT,0,2803471
ompRp1,0.5,1,1,AGTCTACGGGGGCTCCGGAT,0,2778262
ompRp1,0.5,1,1,AGTCGTACCGCCCATACTGA,0,2821053
ompRp1,0.5,1,1,AGTCGTACCCGGAAGCCATG,0,2811871
ompRp1,0.5,1,1,AGTCGGTTCCTGCTTGCGCA,0,2818593
ompRp1,0.5,1,1,AGTCGGCTCGCCCTTAACAG,0,2790626
ompRp1,0.5,1,1,AGTCCTCGAATTTTCACTCT,0,2783041
ompRp1,0.5,1,1,AGTCCCGCAATGCAACGATC,0,2791787
ompRp1,0.5,1,1,AGTCCCAACGCGCAGTGCGA,0,2771028
ompRp1,0.5,1,1,AGTCCAGGCTAAATAGTAGG,0,2818792
ompRp1,0.5,1,1,AGTCCAGGATCTTCGTTGCA,0,2784814
ompRp1,0.5,1,1,AGTCCACGGCGCAAGCCTAG,0,2817938
ompRp1,0.5,1,1,AGTCCACACTATCGAAAGAA,0,2819351
ompRp1,0.5,1,1,AGTCATTCTAACAGTGGGTG,0,2789845
ompRp1,0.5,1,1,AGTCAGAGTCGCTATGTGAG,0,2816658
ompRp1,0.5,1,1,AGTATTTCTAAAGAGTCTCT,0,2787280
ompRp1,0.5,1,1,AGTAGTAGGAGATCATAATA,0,2787950
ompRp1,0.5,1,1,AGTAGCATGTTCGTTTGAAG,0,2773054
ompRp1,0.5,1,1,AGTAGACAATTGCGCTGTTT,0,2780232
ompRp1,0.5,1,1,AGTAAGTTTCGTACTGCGTG,0,2766518
ompRp1,0.5,1,1,AGGTTTGCACAACATCCCCC,0,2813473
ompRp1,0.5,1,1,AGGTTGACTGCCTGTCAAAC,0,2800734
ompRp1,0.5,1,1,AGGTTCTAGCACGAAACATA,0,2788874
ompRp1,0.5,1,1,AGGTTCCATAGCATTGGTGT,0,2780595
ompRp1,0.5,1,1,AGGTTACCTAGTTTCAGACA,0,2786062
ompRp1,0.5,1,1,AGGTTACAGAAATGTTTAAT,0,2798687
ompRp1,0.5,1,1,AGGTTACAATTGGCTGGTGC,0,2804634
ompRp1,0.5,1,1,AGGTGCTCATCTAGTCCAGT,0,2809126
ompRp1,0.5,1,1,AGGTGATGTGGTAGTTCTCT,0,2821647
ompRp1,0.5,1,1,AGGTGAAACCACTTGTTGTG,0,2793986
ompRp1,0.5,1,1,AGGTCCCCAACACTACCATC,0,2781975
ompRp1,0.5,1,1,AGGTCCATCTCGAGAAAGCC,0,2805547
ompRp1,0.5,1,1,AGGTATGTAAGTTTAATAAT,0,2766202
ompRp1,0.5,1,1,AGGTACTCAGAGTCAAGGCA,0,2776186
ompRp1,0.5,1,1,AGGTACGCGGTACCCGGGTG,0,2782735
ompRp1,0.5,1,1,AGGTAATTCCTGAAGTACGA,0,2803555
ompRp1,0.5,1,1,AGGGTTTAGCCTCGCAGAGA,0,2811442
ompRp1,0.5,1,1,AGGGTTCCTGCTGTCAAGAC,0,2786645
ompRp1,0.5,1,1,AGGGTTAAAAACAAGCCAGC,0,2769019
ompRp1,0.5,1,1,AGGGTCTCAGTGTTAATGCC,0,2801003
ompRp1,0.5,1,1,AGGGTAGAGATGTAACTATT,0,2814351
ompRp1,0.5,1,1,AGGGTACGGTAAACAGTAGG,0,2809221
ompRp1,0.5,1,1,AGGGGTGCCGATAGTGGTGT,0,2793182
ompRp1,0.5,1,1,AGGGGTACACATATCCCAGC,0,2823625
ompRp1,0.5,1,1,AGGGGGCGAACGATTTATGT,0,2821668
ompRp1,0.5,1,1,AGGGGATTCGAGCCCTACGT,0,2785874
ompRp1,0.5,1,1,AGGGGACACCGCGGCGCAGT,0,2767602
ompRp1,0.5,1,1,AGGGCGAACGAAGGCGGCGC,0,2796366
ompRp1,0.5,1,1,AGGGCGAACAGTGAGTGGAA,0,2767500
ompRp1,0.5,1,1,AGGGCAGCGCTACAACAATT,0,2824390
ompRp1,0.5,1,1,AGGGACTCACCGATTAACTC,0,2775528
ompRp1,0.5,1,1,AGGGAATATATCCTAGTCTA,0,2824753
ompRp1,0.5,1,1,AGGGAAGCCTCTGCAAACCC,0,2772120
ompRp1,0.5,1,1,AGGCTTGCTTCGGATCAAGT,0,2815990
ompRp1,0.5,1,1,AGGCTTCGAACAATTTGTAG,0,2776986
ompRp1,0.5,1,1,AGGCTTCATAAGCCTTTGTC,0,2772353
ompRp1,0.5,1,1,AGGCGGTTAGTGGGACCTGT,0,2785812
ompRp1,0.5,1,1,AGGCGCGTACCAGTCCTGAA,0,2820606
ompRp1,0.5,1,1,AGGCGCAGCATCAGCTTGGA,0,2767341
ompRp1,0.5,1,1,AGGCGCAAGAATCGATTTGT,0,2771908
ompRp1,0.5,1,1,AGGCCGCGTACTTCGGATTA,0,2783280
ompRp1,0.5,1,1,AGGCCAGGCTGTCTCTGCCG,0,2768735
ompRp1,0.5,1,1,AGGCATAGACCTGTCTCCGT,0,2815247
ompRp1,0.5,1,1,AGGCAAAGTGCCCTCTGAGG,0,2774448
ompRp1,0.5,1,1,AGGATGTAAAATTTCTCAGC,0,2770129
ompRp1,0.5,1,1,AGGATCGTCGGCACCTAAAA,0,2766325
ompRp1,0.5,1,1,AGGAGGCTGATGGGGTTTCT,0,2781273
ompRp1,0.5,1,1,AGGAGGACACATTTTTTCGT,0,2797880
ompRp1,0.5,1,1,AGGAGCTTTGGGTTTACTTG,0,2811545
ompRp1,0.5,1,1,AGGAGCGTTTAACCGTAAAC,0,2815425
ompRp1,0.5,1,1,AGGAGCAGCTATGGCGTATG,0,2776504
ompRp1,0.5,1,1,AGGAGATCAGTGAAGGCTGA,0,2769051
ompRp1,0.5,1,1,AGGAGATAAGGGTGTACCCA,0,2806942
ompRp1,0.5,1,1,AGGAGAGGGGTTTACTAAGT,0,2802721
ompRp1,0.5,1,1,AGGACAACATAAGATTGAGA,0,2784331
ompRp1,0.5,1,1,AGGAAGCACAAGGCTTTTCT,0,2768743
ompRp1,0.5,1,1,AGGAAATGTTTGATCTGGAG,0,2815268
ompRp1,0.5,1,1,AGCTTGACTTTGAATGTGTT,0,2816510
ompRp1,0.5,1,1,AGCTTATGTGCTCTGGACTC,0,2783235
ompRp1,0.5,1,1,AGCTTACAAGAAGCCAGTCC,0,2812807
ompRp1,0.5,1,1,AGCTGTGCGGCTCCAAGCTT,0,2801757
ompRp1,0.5,1,1,AGCTGCTTGCCCTAACGGGC,0,2794294
ompRp1,0.5,1,1,AGCTGCAGAAATCCTGCATC,0,2797427
ompRp1,0.5,1,1,AGCTGATCTAGCTAACTCAA,0,2803448
ompRp1,0.5,1,1,AGCTACGTTATTCTCGTGAA,0,2809570
ompRp1,0.5,1,1,AGCGTTCACAAGGAGTAACC,0,2784102
ompRp1,0.5,1,1,AGCGTCTCGCAAAAGAATGA,0,2774319
ompRp1,0.5,1,1,AGCGGTTGCCTATAATAAGG,0,2800655
ompRp1,0.5,1,1,AGCGGTGCGCGTGGGTGTCC,0,2776541
ompRp1,0.5,1,1,AGCGGGAAGTTGCCTTTCAT,0,2789309
ompRp1,0.5,1,1,AGCGGCGCGCGTTGTTAATC,0,2811808
ompRp1,0.5,1,1,AGCGGCCTAGAATGCGTCCA,0,2802503
ompRp1,0.5,1,1,AGCGCGGAGCTCGTCGTAGC,0,2783186
ompRp1,0.5,1,1,AGCGCCGACGTCGTCTACTC,0,2802046
ompRp1,0.5,1,1,AGCGATTTCAGCCAAGTTGC,0,2796321
ompRp1,0.5,1,1,AGCGATGCGAGGCCCGGCGT,0,2821286
ompRp1,0.5,1,1,AGCGAATTTCACGGCGCGTG,0,2794924
ompRp1,0.5,1,1,AGCGAAACCCAAAGTGCTAG,0,2775219
ompRp1,0.5,1,1,AGCCGTCCACGTACGCCGGA,0,2783905
ompRp1,0.5,1,1,AGCCGGTATAGGCTCGGTCT,0,2814068
ompRp1,0.5,1,1,AGCCGCGCGCTAATTCTGCG,0,2778369
ompRp1,0.5,1,1,AGCCGATGGCGCAAGGGATT,0,2803716
ompRp1,0.5,1,1,AGCCGAGTAGGTAGGTCGGT,0,2773601
ompRp1,0.5,1,1,AGCCCGCAACTGGGTATTTG,0,2818138
ompRp1,0.5,1,1,AGCCCGAATCATGTGACGGG,0,2801611
ompRp1,0.5,1,1,AGCCAGTTTCGGTTGCTAGG,0,2771513
ompRp1,0.5,1,1,AGCCACTTACATCCCGGATC,0,2805183
ompRp1,0.5,1,1,AGCCAAATTCAGCAATCGTG,0,2819352
ompRp1,0.5,1,1,AGCATTGGCTCCCCTTACCA,0,2803777
ompRp1,0.5,1,1,AGCATCGTATTGGTCAGTCA,0,2803600
ompRp1,0.5,1,1,AGCATCCATAGAATTTTCTG,0,2818616
ompRp1,0.5,1,1,AGCATACAATCTGCCCCGCA,0,2820116
ompRp1,0.5,1,1,AGCAGTAACGCACTGCCAGT,0,2804549
ompRp1,0.5,1,1,AGCACTAAGTAAGCTTTATA,0,2824360
ompRp1,0.5,1,1,AGCAACTAGCAATGGTTATA,0,2815709
ompRp1,0.5,1,1,AGATGGGTATGGGGCAATTT,0,2799247
ompRp1,0.5,1,1,AGATGGCCTGCACCCATATC,0,2785941
ompRp1,0.5,1,1,AGATGAGGTTTGCTGAACTA,0,2782725
ompRp1,0.5,1,1,AGATCGGGCGCTATTGAAGG,0,2811544
ompRp1,0.5,1,1,AGATCGCTAGAGCACATTTC,0,2808824
ompRp1,0.5,1,1,AGATCCGAGCACTTGGGTGA,0,2811148
ompRp1,0.5,1,1,AGATAGTTAAGGGCACTGAG,0,2804544
ompRp1,0.5,1,1,AGAGTCTCATCACGAGGTTC,0,2807518
ompRp1,0.5,1,1,AGAGGTTATACGGGGCCGGC,0,2767274
ompRp1,0.5,1,1,AGAGGGCATTGGTCGCAGTT,0,2798651
ompRp1,0.5,1,1,AGAGGGACGTATATTTTGTG,0,2791626
ompRp1,0.5,1,1,AGAGGCTCCAGATTTTAAAG,0,2798309
ompRp1,0.5,1,1,AGAGGCGTGCCTGCGTGTGG,0,2769287
ompRp1,0.5,1,1,AGAGGCAGGTCAACCAACAA,0,2821022
ompRp1,0.5,1,1,AGAGGAACTGAAAGCAATTC,0,2778271
ompRp1,0.5,1,1,AGAGCTCTTTCCAACGTAAT,0,2812892
ompRp1,0.5,1,1,AGAGCGGGCACAATTAGCAA,0,2783175
ompRp1,0.5,1,1,AGAGCCAGGAATTTCACAGA,0,2813700
ompRp1,0.5,1,1,AGAGCATTTGCAGTCATGGT,0,2790239
ompRp1,0.5,1,1,AGAGATAATACCCCGGAGTG,0,2817680
ompRp1,0.5,1,1,AGACTTGTTTACCGAAATGC,0,2795056
ompRp1,0.5,1,1,AGACTTAAGCGTTAAGTATA,0,2777988
ompRp1,0.5,1,1,AGACGGGCGAGGCAAGGGAA,0,2807276
ompRp1,0.5,1,1,AGACGGCTAGACGTTACGGT,0,2803037
ompRp1,0.5,1,1,AGACGATCTATACGTGGTCA,0,2800302
ompRp1,0.5,1,1,AGACCTGCGATCGAGAATCG,0,2814586
ompRp1,0.5,1,1,AGACCGGGGTACACGCGCGG,0,2808336
ompRp1,0.5,1,1,AGACATGTGGCATCAGAGAA,0,2797453
ompRp1,0.5,1,1,AGACAACTCGGTCCATTGGA,0,2802367
ompRp1,0.5,1,1,AGACAACGCTTGTGATGTTC,0,2822834
ompRp1,0.5,1,1,AGAATCTTCCAGGCTGCCAG,0,2788540
ompRp1,0.5,1,1,AGAATCCATGCTAATGTCGG,0,2791778
ompRp1,0.5,1,1,AGAAGTTAGAGTGGTGAATT,0,2785545
ompRp1,0.5,1,1,AGAAGCGCTTATTTATTCAT,0,2796342
ompRp1,0.5,1,1,AGAAGCCCCCAATAATCTCC,0,2786740
ompRp1,0.5,1,1,AGAAGATCTCCCGTTGTCCT,0,2809448
ompRp1,0.5,1,1,AGAAGACGAAAGCACGACAG,0,2786369
ompRp1,0.5,1,1,AGAACTTCTCATCTTTTTCC,0,2783035
ompRp1,0.5,1,1,AGAACCGACCGATGTAAACA,0,2823403
ompRp1,0.5,1,1,AGAACCAGTGGACGCGTTGC,0,2779890
ompRp1,0.5,1,1,AGAACAGGTAGTTCATCTGA,0,2814698
ompRp1,0.5,1,1,AGAAATGATCGTTTTCAGTT,0,2775764
ompRp1,0.5,1,1,AGAAAGCATATGACGTGGAA,0,2808993
ompRp1,0.5,1,1,AGAAACTTTGAAAGTTATGG,0,2810725
ompRp1,0.5,1,1,AGAAAATGCGTCCCCATCCT,0,2787923
ompRp1,0.5,1,1,AGAAAAGCGCTAACCGGGAC,0,2819736
ompRp1,0.5,1,1,AGAAAACAAAAAGGCACGGG,0,2802274
ompRp1,0.5,1,1,ACTTTTTCTACCAGAATATT,0,2783686
ompRp1,0.5,1,1,ACTTTTGATATAATTCCAAT,0,2802530
ompRp1,0.5,1,1,ACTTTTATCTTCCAAGAGCC,0,2817627
ompRp1,0.5,1,1,ACTTTTAGAACTTGGGCGTA,0,2802387
ompRp1,0.5,1,1,ACTTTACCATGCGGTTATAG,0,2776192
ompRp1,0.5,1,1,ACTTTAAATCCATCGTGGTT,0,2808839
ompRp1,0.5,1,1,ACTTGGTCGTCTACTCGTTT,0,2818867
ompRp1,0.5,1,1,ACTTGCGGTAACGTCAGGTC,0,2774818
ompRp1,0.5,1,1,ACTTCTCATCCCTACCGACT,0,2799169
ompRp1,0.5,1,1,ACTTCGCCTGGCCGAGGACA,0,2821170
ompRp1,0.5,1,1,ACTTCCCAACAAATTCCATA,0,2774409
ompRp1,0.5,1,1,ACTTCAGCGGGATACCAGGC,0,2789261
ompRp1,0.5,1,1,ACTTACAACGGGAGAATCTC,0,2774891
ompRp1,0.5,1,1,ACTGTGGTTGGTTAACAATT,0,2810142
ompRp1,0.5,1,1,ACTGTGATCAATTTTAGGCC,0,2793361
ompRp1,0.5,1,1,ACTGTCAGGCCATTATCTAT,0,2784047
ompRp1,0.5,1,1,ACTGGAAACCCCCAGTTTCT,0,2768631
ompRp1,0.5,1,1,ACTGCTGACATTGGTCTGTT,0,2779982
ompRp1,0.5,1,1,ACTGCGGGTCTTTATCGGTC,0,2798624
ompRp1,0.5,1,1,ACTGCGAGGCCGATACGGGC,0,2806460
ompRp1,0.5,1,1,ACTGATGTTTAGGTCCTAAT,0,2781210
ompRp1,0.5,1,1,ACTGATGCTGCTTCATCGTG,0,2783322
ompRp1,0.5,1,1,ACTGACCTCGACAGAGCGCT,0,2785189
ompRp1,0.5,1,1,ACTGACAAAGTTTGCTTGTA,0,2776252
ompRp1,0.5,1,1,ACTGAATACTGGGAAATTGC,0,2766330
ompRp1,0.5,1,1,ACTCTGATTATATTCATCAC,0,2768137
ompRp1,0.5,1,1,ACTCTCCACCGTTTGCGAAT,0,2823398
ompRp1,0.5,1,1,ACTCGTAAATAAGCAAAGCC,0,2772303
ompRp1,0.5,1,1,ACTCGCTTCCTCAGGATCGA,0,2774558
ompRp1,0.5,1,1,ACTCGCCCACGTGCGGTGGA,0,2809590
ompRp1,0.5,1,1,ACTCCTGGAGATGACGCTCT,0,2794410
ompRp1,0.5,1,1,ACTCCTACCTTGCGCGAATA,0,2805599
ompRp1,0.5,1,1,ACTCCGGGAGAGTTAGTAGT,0,2802979
ompRp1,0.5,1,1,ACTCATCGTCATATTTGTTA,0,2771685
ompRp1,0.5,1,1,ACTCATCCCGTTTGTTGGCC,0,2809621
ompRp1,0.5,1,1,ACTCACCAGAACTTCTTGCG,0,2785228
ompRp1,0.5,1,1,ACTATTCAAGGCCCTTGAGA,0,2777029
ompRp1,0.5,1,1,ACTATACTGCTCCGCTTATA,0,2814285
ompRp1,0.5,1,1,ACTAGGGCCACGTCTCCACA,0,2792348
ompRp1,0.5,1,1,ACTAGATACCGATCAATATA,0,2774532
ompRp1,0.5,1,1,ACTACGTCAATTGATGGGAG,0,2790142
ompRp1,0.5,1,1,ACTACGATGGTAGTAGTGCG,0,2802723
ompRp1,0.5,1,1,ACTAACTGGACGATATTAAG,0,2804146
ompRp1,0.5,1,1,ACGTTTTCGCTCCTCAGGGT,0,2774518
ompRp1,0.5,1,1,ACGTTGTCCATATTCAGCTT,0,2791459
ompRp1,0.5,1,1,ACGTTCGGGGTTCGGACTCT,0,2782852
ompRp1,0.5,1,1,ACGTTAGGAGCATGTACAGT,0,2772619
ompRp1,0.5,1,1,ACGTGCTAATCTGAGATTAA,0,2786748
ompRp1,0.5,1,1,ACGTCTGTTAGATTACTCGA,0,2783991
ompRp1,0.5,1,1,ACGTCTGTGGATGATGCGCC,0,2779346
ompRp1,0.5,1,1,ACGTCCAGTCGTATTGATCC,0,2772081
ompRp1,0.5,1,1,ACGTACATCTTTACCAGCCA,0,2784055
ompRp1,0.5,1,1,ACGGTCTGGGTGTAGTGTGC,0,2804543
ompRp1,0.5,1,1,ACGGTCTGAGATAGTGTCCC,0,2794229
ompRp1,0.5,1,1,ACGGTCTCGCGAACACGCTA,0,2786228
ompRp1,0.5,1,1,ACGGTAGGATAGCAAGGCGC,0,2794686
ompRp1,0.5,1,1,ACGGGGGGTGGAAAAGGGGG,0,2791068
ompRp1,0.5,1,1,ACGGGGCATGGACAGGGTCA,0,2792132
ompRp1,0.5,1,1,ACGGGCGACGTCACCCACCA,0,2791167
ompRp1,0.5,1,1,ACGGCGATTAGGGGTTGAGG,0,2821481
ompRp1,0.5,1,1,ACGGCAAGCGGTATTAGCGA,0,2773312
ompRp1,0.5,1,1,ACGGATGAGCAATAAAGTTA,0,2800467
ompRp1,0.5,1,1,ACGGAGCCCAGTCGAGAGTC,0,2777039
ompRp1,0.5,1,1,ACGGACATTTTACTGCACGA,0,2780841
ompRp1,0.5,1,1,ACGCTGGTCGCTGCCGATCG,0,2814951
ompRp1,0.5,1,1,ACGCTGCGGTCGGCACGACG,0,2793506
ompRp1,0.5,1,1,ACGCGTCCAATCACGCGGTG,0,2801809
ompRp1,0.5,1,1,ACGCGGATGCTCCAATGATC,0,2821244
ompRp1,0.5,1,1,ACGCGCGAAGTTCGAAGATT,0,2811989
ompRp1,0.5,1,1,ACGCGCCCAAGGGCTACAAC,0,2812857
ompRp1,0.5,1,1,ACGCGCATTTCTTCCTAATC,0,2766107
ompRp1,0.5,1,1,ACGCGCACACCCCGAATTGG,0,2813444
ompRp1,0.5,1,1,ACGCGACCACAAACGGGAAG,0,2811219
ompRp1,0.5,1,1,ACGCCTCTCCTCACTGTAAC,0,2809867
ompRp1,0.5,1,1,ACGCCTAGTATTCCCGTGCA,0,2771782
ompRp1,0.5,1,1,ACGCCGCACGATATGAGCAA,0,2770419
ompRp1,0.5,1,1,ACGCCATGAATAAACCGGTT,0,2808551
ompRp1,0.5,1,1,ACGATGATCAGAAGCAGCTC,0,2787434
ompRp1,0.5,1,1,ACGATAGCTGCTCAAATAAC,0,2797940
ompRp1,0.5,1,1,ACGAGCTTTCTGGATTTCTC,0,2769025
ompRp1,0.5,1,1,ACGACTCCCTTATCAAGTTC,0,2772993
ompRp1,0.5,1,1,ACGACTCCACGCGGAGTGTT,0,2781632
ompRp1,0.5,1,1,ACGACTATTGCAACTCCGCA,0,2784251
ompRp1,0.5,1,1,ACGACCTGAACTATGTTAGT,0,2803347
ompRp1,0.5,1,1,ACGACCCACGGCACCCCCGC,0,2768126
ompRp1,0.5,1,1,ACGACACGCACCAAGGACTT,0,2768651
ompRp1,0.5,1,1,ACGAAGTGAACGTACGATGC,0,2810064
ompRp1,0.5,1,1,ACCTTTGTTGCACAGCAAAC,0,2788859
ompRp1,0.5,1,1,ACCTTCTCTAATCACAGTGG,0,2789532
ompRp1,0.5,1,1,ACCTTCGATGGCATCTCCAT,0,2805747
ompRp1,0.5,1,1,ACCTTCATAGTAGAATCGGT,0,2807856
ompRp1,0.5,1,1,ACCTTATCATGTGGCATGGC,0,2789703
ompRp1,0.5,1,1,ACCTGTTGCCGTGAATGGCA,0,2786190
ompRp1,0.5,1,1,ACCTGGCGCGAATATGCGAA,0,2800604
ompRp1,0.5,1,1,ACCTGCATTTCGCTCTTGAA,0,2811149
ompRp1,0.5,1,1,ACCTGCATCCGAAGTCCAGA,0,2769706
ompRp1,0.5,1,1,ACCTGAATATGCGTAGAATA,0,2823834
ompRp1,0.5,1,1,ACCTACCGGGCGTCGCGTTA,0,2796402
ompRp1,0.5,1,1,ACCGTCTATCTGGCTGGGCT,0,2808201
ompRp1,0.5,1,1,ACCGTCTAAACCTTTGTGCT,0,2788143
ompRp1,0.5,1,1,ACCGGAGGCAAGTGGGTAAC,0,2773736
ompRp1,0.5,1,1,ACCGCGGTAGGTGATGGTTG,0,2770230
ompRp1,0.5,1,1,ACCGCGATTTCTATCTGACC,0,2798913
ompRp1,0.5,1,1,ACCGCCGTCATGTGGCCTTA,0,2771578
ompRp1,0.5,1,1,ACCGCAACTGGCCGCCCATC,0,2809852
ompRp1,0.5,1,1,ACCGAACGTGTCACTTTGCG,0,2783339
ompRp1,0.5,1,1,ACCCTCTCAAAAAAACCAAA,0,2772981
ompRp1,0.5,1,1,ACCCTCGTAACGTTGCAGGC,0,2767592
ompRp1,0.5,1,1,ACCCTACGCCGCCGATTTAA,0,2803451
ompRp1,0.5,1,1,ACCCGTTTGCGTCTTCTCCT,0,2767527
ompRp1,0.5,1,1,ACCCGTGGTTGACAATAGCT,0,2790234
ompRp1,0.5,1,1,ACCCGGGGCAAGCACACTAC,0,2802533
ompRp1,0.5,1,1,ACCCGGGGACTTGCGAGCGC,0,2814018
ompRp1,0.5,1,1,ACCCGCCTCGGAGAGCCACA,0,2782827
ompRp1,0.5,1,1,ACCCCCGTTTTCAGAAACAC,0,2804040
ompRp1,0.5,1,1,ACCCATATATCGGCCTAGGC,0,2790206
ompRp1,0.5,1,1,ACCCAAGTTATGCAAGCCAT,0,2820113
ompRp1,0.5,1,1,ACCATGAAGTATATGTTTAG,0,2812567
ompRp1,0.5,1,1,ACCATCGGCTTTTCTCCGTT,0,2804748
ompRp1,0.5,1,1,ACCATAGAGAGCTATCGGCA,0,2817297
ompRp1,0.5,1,1,ACCATACTCAGGGGTTTCGA,0,2789945
ompRp1,0.5,1,1,ACCAGCATCCGGCCATAGGA,0,2804063
ompRp1,0.5,1,1,ACCACTGGACGAAGTACTTT,0,2765869
ompRp1,0.5,1,1,ACCACGTTGACTTTCCCCGA,0,2776112
ompRp1,0.5,1,1,ACCAAATGGATTGTGTGGTG,0,2799901
ompRp1,0.5,1,1,ACATTTTCATATAGAGATAT,0,2787609
ompRp1,0.5,1,1,ACATTATACTGAACGGGAGT,0,2803482
ompRp1,0.5,1,1,ACATGGGTTAAATACATAGT,0,2811269
ompRp1,0.5,1,1,ACATGAGCGCATCTCACGCT,0,2799292
ompRp1,0.5,1,1,ACATAGTTCATTAGTCCTTG,0,2777979
ompRp1,0.5,1,1,ACATAGCATCTGGGACGCCC,0,2776633
ompRp1,0.5,1,1,ACATAGCAGGTGCAAAAGCG,0,2808560
ompRp1,0.5,1,1,ACAGTTGTTCTACTCGCCTG,0,2786058
ompRp1,0.5,1,1,ACAGTAGTTGTTAATCCATC,0,2813008
ompRp1,0.5,1,1,ACAGCTCAAGTGGGCCATTG,0,2781269
ompRp1,0.5,1,1,ACAGCTAGAGCCGGACCGGG,0,2815381
ompRp1,0.5,1,1,ACAGCTACCATAGCACCACT,0,2799775
ompRp1,0.5,1,1,ACAGCGAACCCTTTCACGGC,0,2824495
ompRp1,0.5,1,1,ACAGCATGCGGGATTTGCGT,0,2797781
ompRp1,0.5,1,1,ACAGATCGTTTGCTATTTCA,0,2817543
ompRp1,0.5,1,1,ACACTTCGAGTGCGTAAAAA,0,2781749
ompRp1,0.5,1,1,ACACTCCGCGTTAAGCGGTT,0,2768744
ompRp1,0.5,1,1,ACACGGTTGGAGCTTACGAC,0,2806041
ompRp1,0.5,1,1,ACACGCGTTGCTGAAGGGCA,0,2820898
ompRp1,0.5,1,1,ACACGCCGGTCCCCGTCAGC,0,2803410
ompRp1,0.5,1,1,ACACGCCCCTGAAGATAGAT,0,2800879
ompRp1,0.5,1,1,ACACCCGGAGAGGACCGACA,0,2788153
ompRp1,0.5,1,1,ACACAGAATCCGGTTCAGTG,0,2809475
ompRp1,0.5,1,1,ACAATGGCTGGGCGGCCAGG,0,2787197
ompRp1,0.5,1,1,ACAATGCTGGAAGGGGTTAC,0,2777791
ompRp1,0.5,1,1,ACAATGACGGACATGACTTG,0,2792342
ompRp1,0.5,1,1,ACAATAGAAAAGAGCGTGAG,0,2818994
ompRp1,0.5,1,1,ACAATAAATTCTGCCGTGGC,0,2816242
ompRp1,0.5,1,1,ACAATAAATGATCACCTCTC,0,2768824
ompRp1,0.5,1,1,ACAAGTGAAAACTTCTACGA,0,2765745
ompRp1,0.5,1,1,ACAACTATGTTCTTTAATGC,0,2778783
ompRp1,0.5,1,1,ACAACGCCGCGGCAAGATTG,0,2806413
ompRp1,0.5,1,1,ACAACCAGGCTCTGTTCATT,0,2821941
ompRp1,0.5,1,1,ACAACAGACGCGCCGGGAGA,0,2781747
ompRp1,0.5,1,1,ACAAATCAGATTATGTATCA,0,2799944
ompRp1,0.5,1,1,ACAAAAGAGTAGACCCGGGT,0,2780100
ompRp1,0.5,1,1,ACAAAAACCTACGGCTTTAT,0,2776747
ompRp1,0.5,1,1,AATTTGTACCCGCTTCAAGG,0,2824274
ompRp1,0.5,1,1,AATTTGAAATGTCATGACAT,0,2798753
ompRp1,0.5,1,1,AATTTCATGCGCCCCCATCC,0,2794769
ompRp1,0.5,1,1,AATTTAATCTCAGCAAGTCA,0,2780421
ompRp1,0.5,1,1,AATTTAACCCCTGTATTGAT,0,2786672
ompRp1,0.5,1,1,AATTTAAACTTACTACGATC,0,2767599
ompRp1,0.5,1,1,AATTGTTCGGCTACGAGATA,0,2817354
ompRp1,0.5,1,1,AATTGCCTGTCGGGGCCTTT,0,2772116
ompRp1,0.5,1,1,AATTAGCTGCAGAGACGGGA,0,2810734
ompRp1,0.5,1,1,AATGTGGCCAAGGCGAACTC,0,2786457
ompRp1,0.5,1,1,AATGTCATAGGAAACAGCAT,0,2803394
ompRp1,0.5,1,1,AATGGTTGCAGAATAGTGTG,0,2772298
ompRp1,0.5,1,1,AATGGCAGTCTTTTCGTGTT,0,2806653
ompRp1,0.5,1,1,AATGGCAAGTTGGTGAAAGA,0,2813250
ompRp1,0.5,1,1,AATGGACATCGTTATTCAGG,0,2792016
ompRp1,0.5,1,1,AATGCTTCCCTGGAGAGTGT,0,2785732
ompRp1,0.5,1,1,AATGCGGATTGTTGTTATCA,0,2808431
ompRp1,0.5,1,1,AATGATGTTTCGTTGGATCC,0,2806083
ompRp1,0.5,1,1,AATGACGCAATCCCAAATAT,0,2813805
ompRp1,0.5,1,1,AATCTTCGGCTGTGTCTGGA,0,2814788
ompRp1,0.5,1,1,AATCTGCGCAAGCTATTAGA,0,2795512
ompRp1,0.5,1,1,AATCTGAAAACACTAAGCAA,0,2777716
ompRp1,0.5,1,1,AATCTACCTACAGTAAGGTT,0,2789412
ompRp1,0.5,1,1,AATCTAACAGTACTTGATCA,0,2810255
ompRp1,0.5,1,1,AATCGTTGTCGGCGAAGCGG,0,2818502
ompRp1,0.5,1,1,AATCGGAGACGCGCCCGGTC,0,2803363
ompRp1,0.5,1,1,AATCGGAATCCTCAGACTAG,0,2794131
ompRp1,0.5,1,1,AATCCTAAATGGCTCTCACG,0,2791868
ompRp1,0.5,1,1,AATCCGGTTCAAAGTGACTG,0,2794103
ompRp1,0.5,1,1,AATCCCTGAATCTCAAGTAT,0,2812830
ompRp1,0.5,1,1,AATCATGGTGCCTCATGAAG,0,2819263
ompRp1,0.5,1,1,AATCATGGGCTGATGGGCGA,0,2777606
ompRp1,0.5,1,1,AATCAGGGCTGGGGATTGAG,0,2784011
ompRp1,0.5,1,1,AATCACGATCCGAGGTTTAA,0,2784015
ompRp1,0.5,1,1,AATATCGGAGAGTAGACGCT,0,2776707
ompRp1,0.5,1,1,AATATCCCTTCATTCATGGC,0,2774916
ompRp1,0.5,1,1,AATATAGGTTCACGCAGATT,0,2824513
ompRp1,0.5,1,1,AATAGGCCGGCCGAGGTGTA,0,2785936
ompRp1,0.5,1,1,AATAGGAGCAGGGTGATTTG,0,2777200
ompRp1,0.5,1,1,AATAGCCAACCGTTAAGCTC,0,2821342
ompRp1,0.5,1,1,AATACCGAAAAAAGGGGTTG,0,2769493
ompRp1,0.5,1,1,AATAATGTGTGTCCCCGCAT,0,2793686
ompRp1,0.5,1,1,AATAATATAGAAGTAATACT,0,2767391
ompRp1,0.5,1,1,AATAAATTCGAGATTCGCAT,0,2813424
ompRp1,0.5,1,1,AATAAATACTATGGGGGGTA,0,2767773
ompRp1,0.5,1,1,AAGTTTGCGTGGAGCCACTG,0,2784753
ompRp1,0.5,1,1,AAGTGTAGCGTCGGCGGGTA,0,2814627
ompRp1,0.5,1,1,AAGTGCTTGGTAGCACTCAA,0,2786684
ompRp1,0.5,1,1,AAGTGCATGAGTCTCTCAGC,0,2813541
ompRp1,0.5,1,1,AAGTGACGCCGAGAGTCACG,0,2794360
ompRp1,0.5,1,1,AAGTCCTATAGTGCTGGAAG,0,2768480
ompRp1,0.5,1,1,AAGTCAGAACAATACCGCTG,0,2785170
ompRp1,0.5,1,1,AAGTCAAGTACGTTTAGGGT,0,2765575
ompRp1,0.5,1,1,AAGTATTAACCGGGGTACCT,0,2766955
ompRp1,0.5,1,1,AAGTATGTTGTCCCAACTTC,0,2788733
ompRp1,0.5,1,1,AAGTATGAGTATGGGCGAGC,0,2771243
ompRp1,0.5,1,1,AAGTAGAGCCTTAACGGCTC,0,2781209
ompRp1,0.5,1,1,AAGTACTAGCAAGCCAGTAA,0,2809716
ompRp1,0.5,1,1,AAGGTTGCGGACTGCGAGTA,0,2810506
ompRp1,0.5,1,1,AAGGTCAGACGAGGCTCAGT,0,2785442
ompRp1,0.5,1,1,AAGGTATTCCTTCCCCCGAT,0,2801016
ompRp1,0.5,1,1,AAGGTAGTTACATGTAAAGA,0,2803468
ompRp1,0.5,1,1,AAGGGTGACAAATGATATCT,0,2802368
ompRp1,0.5,1,1,AAGGGATTCATGTTGTTCCG,0,2775544
ompRp1,0.5,1,1,AAGGGATACCCGAGCCTGCA,0,2811312
ompRp1,0.5,1,1,AAGGCTCACAATATGGAAAC,0,2801929
ompRp1,0.5,1,1,AAGGCTAAAGAAGCTTTGTG,0,2785437
ompRp1,0.5,1,1,AAGGCAATGAGTCCCAAGAA,0,2796433
ompRp1,0.5,1,1,AAGGAGCACCATTGTGTTCA,0,2780155
ompRp1,0.5,1,1,AAGGAGAAAATGCACCGTAA,0,2799163
ompRp1,0.5,1,1,AAGGAAACCATGGATGACAT,0,2808952
ompRp1,0.5,1,1,AAGCTTGCATCCGGAAACAC,0,2820503
ompRp1,0.5,1,1,AAGCTAAGGTATATCGATCC,0,2824369
ompRp1,0.5,1,1,AAGCTAACGAGTCTTCCAAT,0,2768236
ompRp1,0.5,1,1,AAGCGTATTCTGAAGCTAGC,0,2808264
ompRp1,0.5,1,1,AAGCGGTTCGATGATTTCGT,0,2775024
ompRp1,0.5,1,1,AAGCGATTAATAAACGCGGT,0,2797500
ompRp1,0.5,1,1,AAGCCATCACGGGCTTAGAG,0,2805918
ompRp1,0.5,1,1,AAGCCAAGTAGTTTTATTCC,0,2789121
ompRp1,0.5,1,1,AAGATTAGTGCGTTAGCAGA,0,2799639
ompRp1,0.5,1,1,AAGAGGTCAAACCCCATTCT,0,2787332
ompRp1,0.5,1,1,AAGAGGCGGGTACGAAGAGA,0,2782555
ompRp1,0.5,1,1,AAGAGGCACAGAAGGTCCCT,0,2766753
ompRp1,0.5,1,1,AAGAGCCAAATAAGTATCAA,0,2784043
ompRp1,0.5,1,1,AAGAGAGCCCGCCGTGAAAA,0,2770310
ompRp1,0.5,1,1,AAGACCTTTATGGGTCTGCT,0,2805545
ompRp1,0.5,1,1,AAGACACCGCTCACAAACTA,0,2793408
ompRp1,0.5,1,1,AAGAATAGTGCTAACCGACA,0,2765328
ompRp1,0.5,1,1,AAGAAGCGGCTTGGCCCGCT,0,2769960
ompRp1,0.5,1,1,AAGAAGAACTTACAGCCCGG,0,2796726
ompRp1,0.5,1,1,AAGAACATTTTTCGCGACAT,0,2803065
ompRp1,0.5,1,1,AAGAAATATTCGGCGGTACA,0,2803559
ompRp1,0.5,1,1,AAGAAAGAATGTCAGGGCTT,0,2778745
ompRp1,0.5,1,1,AACTTTTTACTAGGCTTGGG,0,2790861
ompRp1,0.5,1,1,AACTTTAGGCTACGCTAAGA,0,2817535
ompRp1,0.5,1,1,AACTTACGCTGGTACGTACT,0,2817156
ompRp1,0.5,1,1,AACTGTCGGTTGATGACACA,0,2787573
ompRp1,0.5,1,1,AACTGGGACTCACTCCGCGG,0,2810002
ompRp1,0.5,1,1,AACTGGGAATGATGGAAGCG,0,2782641
ompRp1,0.5,1,1,AACTGCAGTATAGTGTCCTG,0,2797651
ompRp1,0.5,1,1,AACTCGCACTTTTTACTTCA,0,2794682
ompRp1,0.5,1,1,AACTATTTATAGGGTCGTAA,0,2769061
ompRp1,0.5,1,1,AACGTTTCAACCAGTTATCG,0,2797583
ompRp1,0.5,1,1,AACGTTGGAAGTCCGAAGGC,0,2789312
ompRp1,0.5,1,1,AACGTTAATATTTGCAAACG,0,2768873
ompRp1,0.5,1,1,AACGTAGGTTTCAGCTCAGC,0,2771950
ompRp1,0.5,1,1,AACGGTCGAGCGCCACTTTT,0,2785140
ompRp1,0.5,1,1,AACGGGGGGTACTGTCCATG,0,2785404
ompRp1,0.5,1,1,AACGGGGAGGAGCGCTGCTT,0,2800401
ompRp1,0.5,1,1,AACGGAGAATAGTCCTCGTG,0,2817540
ompRp1,0.5,1,1,AACGGAATCATCACGGAAGC,0,2769969
ompRp1,0.5,1,1,AACGGAACCGACAGGCTGGA,0,2783258
ompRp1,0.5,1,1,AACGCTTGTGGGTGTGAATG,0,2797877
ompRp1,0.5,1,1,AACGATTATTATCGGCCCAA,0,2806658
ompRp1,0.5,1,1,AACGATTATTAACTCGTCAA,0,2810085
ompRp1,0.5,1,1,AACGAGGTGTATGATCCTAG,0,2793831
ompRp1,0.5,1,1,AACGAGGCCGCCCTTTCGAT,0,2806085
ompRp1,0.5,1,1,AACGACAGAGATTGAGAATA,0,2787356
ompRp1,0.5,1,1,AACGAAGTTCCCAGATATGC,0,2807964
ompRp1,0.5,1,1,AACCTTATTCACCAATTCTC,0,2808544
ompRp1,0.5,1,1,AACCTCAGGCAATACGAATA,0,2819922
ompRp1,0.5,1,1,AACCGCTTGCTTTCGTGCCT,0,2807499
ompRp1,0.5,1,1,AACCGCTGTTTTGCGTCGTG,0,2816727
ompRp1,0.5,1,1,AACCCTTAAGCCGTCTGTGA,0,2790402
ompRp1,0.5,1,1,AACCCGAGTTCCCCTACTCC,0,2824388
ompRp1,0.5,1,1,AACCATATCGTCGTATCAAG,0,2795926
ompRp1,0.5,1,1,AACCAGATAGGTCATTGGGT,0,2785879
ompRp1,0.5,1,1,AACCACGTCCGTTCTACTTA,0,2794375
ompRp1,0.5,1,1,AACCAACGGAAGCTGCCTGA,0,2773304
ompRp1,0.5,1,1,AACATGGCCGTGTAATGGGT,0,2822697
ompRp1,0.5,1,1,AACATGCTATTCGGATTCAT,0,2815062
ompRp1,0.5,1,1,AACATCAAGCTAAGCTCTGC,0,2817919
ompRp1,0.5,1,1,AACAGTTTACCAATGGTGAT,0,2791365
ompRp1,0.5,1,1,AACAGTGCGACTTTTGAAAC,0,2799982
ompRp1,0.5,1,1,AACAGTCTCTGCAATCAGCA,0,2820900
ompRp1,0.5,1,1,AACAGGGGTCCTACAAACCT,0,2823301
ompRp1,0.5,1,1,AACAGGGAGTAGTTAGGGAC,0,2821043
ompRp1,0.5,1,1,AACACGCGCTCAGTATTTCC,0,2812663
ompRp1,0.5,1,1,AACACCGTCAATGCACCATG,0,2807590
ompRp1,0.5,1,1,AAATTGTCAACAGAGTCGTA,0,2807200
ompRp1,0.5,1,1,AAATTACAACAGGGCTAGGC,0,2816169
ompRp1,0.5,1,1,AAATGTGCCGAGGCGAGGAT,0,2779815
ompRp1,0.5,1,1,AAATGGCTGGTAGTGCCTAG,0,2788992
ompRp1,0.5,1,1,AAATGGCGCACGGTGTGCGT,0,2806192
ompRp1,0.5,1,1,AAATCATGTCGGTCTATATA,0,2770492
ompRp1,0.5,1,1,AAATATTCCGACCGGGGCCA,0,2783932
ompRp1,0.5,1,1,AAATAATCGCAAGATCACCT,0,2779228
ompRp1,0.5,1,1,AAATAAATATGGCCAGCAAT,0,2806916
ompRp1,0.5,1,1,AAAGTGGGCTCACGCAAGAG,0,2807025
ompRp1,0.5,1,1,AAAGTGACTGTTATTCAAAT,0,2772257
ompRp1,0.5,1,1,AAAGTCGATACAGAGTTTTC,0,2780588
ompRp1,0.5,1,1,AAAGTCCAACGCGATGTGTT,0,2823260
ompRp1,0.5,1,1,AAAGGCGTTCACAAGACCCT,0,2802218
ompRp1,0.5,1,1,AAAGGATCCGTAGTTGCGGT,0,2823074
ompRp1,0.5,1,1,AAAGCCAGTGTTCATTTTTA,0,2806833
ompRp1,0.5,1,1,AAAGACAGGAGATCCTAGGA,0,2766048
ompRp1,0.5,1,1,AAAGAAGTTCTGGGCATGGC,0,2824522
ompRp1,0.5,1,1,AAACTTTTGCTCTTTCAGTC,0,2818487
ompRp1,0.5,1,1,AAACTTTTAAGGGCTACCAT,0,2800032
ompRp1,0.5,1,1,AAACTCGTGTAAGAAATTCT,0,2814904
ompRp1,0.5,1,1,AAACTACTCACATTTAGAAG,0,2790095
ompRp1,0.5,1,1,AAACGCATACCCGAGGTTAT,0,2788382
ompRp1,0.5,1,1,AAACGCAGGCGTGGTCTAAT,0,2797312
ompRp1,0.5,1,1,AAACGACATCATAACAATGA,0,2770670
ompRp1,0.5,1,1,AAACCGGCATGGTGGACGGC,0,2798456
ompRp1,0.5,1,1,AAACCCAGCCTAGATCAGTA,0,2782002
ompRp1,0.5,1,1,AAACATTAAGCTTTTACATT,0,2779151
ompRp1,0.5,1,1,AAAATATATGAGTGGTTAGG,0,2783958
ompRp1,0.5,1,1,AAAAGTCCATGCGTATATTT,0,2801373
ompRp1,0.5,1,1,AAAAGTAAGGAAGTGGATAC,0,2819309
ompRp1,0.5,1,1,AAAAGGATTCGTAGGTACTT,0,2817412
ompRp1,0.5,1,1,AAAACCTACTCGTAGGAGCA,0,2805806
ompRp1,0.5,1,1,AAAACCCTCTGGACGAGCCC,0,2774976
ompRp1,0.5,1,1,AAAACATAAACTCCGGGCGA,0,2818410
ompRp1,0.5,1,1,AAAAAAAAATGGCAAAGTTT,0,2782281
ompRp1,336.0,335,0,CATCATGTCCAGGGAAAAGG,335,2788556
ompRp1,231.0,230,0,TAGCCTGTTCGCATAGGAGT,230,2814482
ompRp1,196.0,195,0,ATATCTAGTTTGACAGAATA,195,2801593
ompRp1,190.0,189,0,ACAACTCTGGGCAATACCCA,189,2784789
ompRp1,187.0,186,0,GGCCCCAGTCCCGCGGATTA,186,2823827
ompRp1,183.0,182,0,CCTGGGTCAGTGGCTCTAGA,182,2789270
ompRp1,181.0,180,0,GGATTCCTACCGGAGGGGGG,180,2765285
ompRp1,178.0,177,0,GGCGTTTTCACTTGCACTCT,177,2796157
ompRp1,176.0,175,0,AGTTAACATAAGATAACTAT,175,2771845
ompRp1,173.0,172,0,CTTAAACATACGACAGCTGG,172,2776805
ompRp1,172.0,171,0,CAGGGCTTCTACGGTGGACC,171,2779050
ompRp1,170.0,169,0,AGTAATTACATTCTTCAAAG,169,2792366
ompRp1,169.0,168,0,ATGAAGGGCTTCCGGGTTGT,168,2773109
ompRp1,167.0,166,0,TCAGGCAGCCCGTAACCTGC,166,2785414
ompRp1,167.0,166,0,CACATTGTTGAACAGATAAT,166,2772264
ompRp1,166.0,165,0,GCTCCGGTTCCCTTAATCGC,165,2790579
ompRp1,164.0,163,0,ACACGCGTTTATAGTCAGGA,163,2801379
ompRp1,160.0,159,0,AATAGTCCCCTTACGCATAA,159,2781927
ompRp1,159.0,158,0,TTCCCGCGTGGCGCAAGCTG,158,2772296
ompRp1,158.0,157,0,CGCAAAACCTTCATCCATAC,157,2787918
ompRp1,147.0,146,0,GAGACCGGCTCGATACCGAT,146,2777410
ompRp1,147.0,146,0,CTAAGGCCGGCTAACAACCC,146,2820156
ompRp1,145.0,144,0,GTACACATGTCCCTGACACA,144,2799687
ompRp1,145.0,144,0,ACCCAGGAATGGACTGATTT,144,2823828
ompRp1,142.0,141,0,AGTCCCAAATGGTGAACTGC,141,2811694
ompRp1,138.0,137,0,AAGAGATGTCACATTCCACG,137,2810621
ompRp1,137.0,136,0,CTATGAATGTCCTGCCCTAA,136,2776325
ompRp1,131.0,130,0,GACGTGCCCGGTAGAGGGGG,130,2784032
ompRp1,127.0,126,0,TAGGCGGAGACTTATTAGAG,126,2787822
ompRp1,127.0,126,0,ACCCGCAGTCACAACCCCAT,126,2774255
ompRp1,125.0,124,0,TTCGTCCCAGCGGAGTTATT,124,2779023
ompRp1,124.0,123,0,ATTGCGTGGCGGAACCTACC,123,2802212
ompRp1,122.0,121,0,GGAGGGCGCCGGCGCGTGTA,121,2817074
ompRp1,116.0,115,0,CGTATATGGCCGGTATCCAA,115,2768657
ompRp1,115.0,114,0,TCCTATCGGAAAAACCGGCC,114,2805770
ompRp1,114.0,113,0,CTAAAGACTTTCTCAGCTTT,113,2772007
ompRp1,111.0,110,0,GCGGTAGCAGATTGAACTGC,110,2777961
ompRp1,111.0,110,0,CTTGCGCCTACCGCTGTGAC,110,2778586
ompRp1,109.0,108,0,CCGGTGAAGTGGAGTTTCCT,108,2800200
ompRp1,107.0,106,0,CTATTGGCCCTTCCAATGTT,106,2814950
ompRp1,103.0,102,0,TATTCTTACGGATACGGGCT,102,2783402
ompRp1,100.0,99,0,CGCTGGATCTGGGTTGACAG,99,2792167
ompRp1,97.0,96,0,TCAGTCATGGTGAATCCAAA,96,2768673
ompRp1,93.0,92,0,CTCTGTCGTTTCTCGACAAT,92,2818223
ompRp1,93.0,92,0,ATGGCCTGCGGTGTGAATAG,92,2804522
ompRp1,93.0,92,0,AGGCAACGTTCGCGCCCCTC,92,2818699
ompRp1,91.0,90,0,GTTATAGCGTCTTACAAACC,90,2816757
ompRp1,86.0,85,0,ATCTGCGGGACGGACCATCC,85,2767742
ompRp1,83.0,82,0,AGGGTACCATAGCTTTTGAG,82,2799993
ompRp1,80.0,79,0,CGACGTTCAACGGCTCCATT,79,2777188
ompRp1,80.0,79,0,ACATATGAGCATTTTCACCT,79,2810115
ompRp1,79.0,78,0,TCCAACTATCCTCTCCTTTT,78,2796739
ompRp1,79.0,78,0,AGCATATGCTTTAGGCTCGT,78,2778380
ompRp1,77.0,76,0,GTACTGTTGAGCTTCGCGGC,76,2778191
ompRp1,76.0,75,0,AGTTTTTGGCCTTTCAGGAA,75,2768023
ompRp1,74.0,73,0,TTTCGCGCGCACTCCCCATG,73,2810543
ompRp1,72.0,71,0,TCTTTCTAGTACGTAAGGAT,71,2779131
ompRp1,72.0,71,0,GGGGTTCCCCACTTTGGCCT,71,2769609
ompRp1,71.0,70,0,GGCAATTCTGGGTACTTAGT,70,2770595
ompRp1,70.0,69,0,AAGCGTTCGCGCTTCATTAA,69,2803154
ompRp1,69.0,68,0,TTCAGTTTACGCACAGAGTT,68,2801324
ompRp1,67.0,66,0,TATGACATACCACGCACCAC,66,2766282
ompRp1,67.0,66,0,GAGTTACCTCGGAGTGAAGG,66,2796244
ompRp1,61.0,60,0,AAGCTGGATGAACTAGAACG,60,2803560
ompRp1,60.0,59,0,CACTAAGGTGTCTCCAATCC,59,2813666
ompRp1,59.0,58,0,TTATGATTGGCTGTCGTCTG,58,2787952
ompRp1,59.0,58,0,CGGGCTACTCATATGGTTCA,58,2821514
ompRp1,58.0,57,0,GCTAAGATGTTGTCCGCGCA,57,2786915
ompRp1,58.0,57,0,CCGCCCTGGACCGGCCTCGC,57,2808104
ompRp1,58.0,57,0,CATGTATTGGGCCAAAAAGG,57,2801727
ompRp1,58.0,57,0,ACTTGCCGTGGGTCACAAAA,57,2788425
ompRp1,57.0,56,0,GAACTCCTCGCGTGATCCCT,56,2785876
ompRp1,56.0,55,0,GTTGGGACCTCAGAACTTGG,55,2770579
ompRp1,54.0,53,0,AGCGTGTTTCTGAACGGCTC,53,2787953
ompRp1,53.0,52,0,ACTTAGAAGATGGCTCCCTA,52,2794285
ompRp1,52.0,51,0,AACACATCGTGAGGTTTCAA,51,2817688
ompRp1,51.0,50,0,TTTTAAGTTGCCCTTCACCC,50,2793505
ompRp1,51.0,50,0,CGGATGTGGTACTATCCGCC,50,2769636
ompRp1,51.0,50,0,CGCACTGGTCGTCGTTCAGT,50,2809521
ompRp1,50.0,49,0,ACTCCGAGTCACGGATAAAG,49,2788436
ompRp1,48.0,47,0,AGCAAACAGAACAAGTTAGC,47,2808730
ompRp1,47.0,46,0,AGACTGCGGGACGAGGGGGT,46,2820876
ompRp1,43.0,42,0,CGCAAATTCCCGATGAGTGA,42,2803495
ompRp1,42.0,41,0,TAGGCGGGGGACCTCGTCCT,41,2815477
ompRp1,41.0,40,0,CTTACGTAGTTCTTAATCCC,40,2781962
ompRp1,40.0,39,0,CTCAGCTCGGCGTCGTGCTC,39,2765773
ompRp1,40.0,39,0,ACTTTGTGACTCCCCCGCTA,39,2818310
ompRp1,39.0,38,0,AGGCATTACACAAACTAGAT,38,2800398
ompRp1,39.0,38,0,ACCTGCAATCGTACGTCCGA,38,2810214
ompRp1,38.0,37,0,CAACTAAACGGACAAGGTTA,37,2816984
ompRp1,37.0,36,0,GACCGCTTCGGCCTTCGGAT,36,2785386
ompRp1,37.0,36,0,CTTCCCGATCATGACAGTAA,36,2779923
ompRp1,37.0,36,0,CTAGATGTCGATCCAAGTTT,36,2771129
ompRp1,36.0,35,0,TGCACGCGATCGCGAATCGG,35,2790437
ompRp1,36.0,35,0,GGGCTAAAGCTGTGGTGCTA,35,2815199
ompRp1,36.0,35,0,AACGCCGAAGACGCATTTCC,35,2768688
ompRp1,34.0,33,0,TTTTTCGGCATGGATCAAGA,33,2790347
ompRp1,29.0,28,0,TCCCCTATGCAACGGGGCTA,28,2775878
ompRp1,29.0,28,0,GAATCAGGCCATAAGGGATG,28,2806650
ompRp1,29.0,28,0,AATCTGCCACTCCGCCCGGT,28,2817936
ompRp1,28.0,27,0,CAGCTACTTACTACGCCTCC,27,2816633
ompRp1,28.0,27,0,AACATGCTTAGCACTTAAAG,27,2773438
ompRp1,27.0,26,0,GCCCAACCCTACGAGACCTG,26,2807642
ompRp1,27.0,26,0,CTTAGGAAGCAATGGGCAAG,26,2819988
ompRp1,25.0,24,0,GTTCGCAACATAGGTTGGCG,24,2823414
ompRp1,24.0,23,0,TGTATGACGCTATTCTTTTG,23,2813271
ompRp1,24.0,23,0,AAGCAACAGGAATGGGAGAC,23,2774104
ompRp1,23.0,22,0,TTGTTTTCAGTTTAAGACTT,22,2777553
ompRp1,23.0,22,0,TTAGCAAAAAGTTCGTAGCT,22,2807431
ompRp1,23.0,22,0,TCTTATAGGTGTTTCAAGCC,22,2807583
ompRp1,23.0,22,0,GCGGCGGCTAAGGCAGTTTT,22,2770680
ompRp1,23.0,22,0,AGAGGCGATTTTGGGAACAG,22,2766892
ompRp1,20.0,19,0,CATGTTCACGTTGTGGACAC,19,2806941
ompRp1,19.0,18,0,CCGGGTTACCGATTTGGTGA,18,2803889
ompRp1,19.0,18,0,CCGACCAGGCGTTGCCTGCG,18,2794452
ompRp1,18.0,17,0,CGATCTGGCCGAGTGGGATA,17,2795394
ompRp1,18.0,17,0,CACATAGGCAACCGTCCTGA,17,2775034
ompRp1,17.0,16,0,TTACTAAAGTGGTTAAATCC,16,2817070
ompRp1,16.0,15,0,CACCCGTTCGTGTGAGCTCA,15,2797479
ompRp1,16.0,15,0,AACCTATAAACCGGTGCATC,15,2780771
ompRp1,15.0,14,0,ATTTATCACGCCAGAGCCGT,14,2771966
ompRp1,13.0,12,0,TCGTTGTCATGATGGGGACC,12,2772703
ompRp1,12.0,11,0,TTACTGTAACCGAGCGTATG,11,2767858
ompRp1,10.0,9,0,CGTCCTGACTGGTTACACCA,9,2782329
ompRp1,10.0,9,0,CGCTTTGCGCTCGTTCCACA,9,2798952
ompRp1,10.0,9,0,AAGTTGTGAACTTCGCAATA,9,2807795
ompRp1,8.0,7,0,TCTCCCTCGGTACCATACCT,7,2799777
ompRp1,8.0,7,0,GTTGATGCTTTTTATGACCT,7,2781251
ompRp1,8.0,7,0,GAGACAAATTCCCCGGGCGA,7,2813280
ompRp1,7.0,6,0,TCATTGCACGATCTCCCCTT,6,2784857
ompRp1,7.0,6,0,CAATAATTGGATGGCCGGCG,6,2802693
ompRp1,6.0,5,0,GCCCAGGGCCTGCCTCCGTA,5,2772792
ompRp1,6.0,5,0,CTTGTTAGTCACGACTCCTT,5,2766317
ompRp1,5.0,4,0,TTCCGAAGCTTCTTGGGTAG,4,2779111
ompRp1,5.0,4,0,TGCCTTGCCTGCCCCGCGTG,4,2794735
ompRp1,4.0,3,0,TGGATGCGAGCTCAAGACAT,3,2787214
ompRp1,4.0,3,0,TGCTTGTAGGGGGTAGGTCC,3,2809463
ompRp1,4.0,3,0,TCCGTCTATCTAATCCAGAT,3,2780969
ompRp1,4.0,3,0,GCGTCTCTCCTCCATCCACA,3,2774135
ompRp1,3.0,2,0,TTGGGCTTGTAAGCGGTGGA,2,2819845
ompRp1,3.0,2,0,TTATCGGCGAGCGTATCTGT,2,2769699
ompRp1,3.0,2,0,TGGCATTGGCTTTTTAGCGT,2,2818950
ompRp1,3.0,2,0,TAGAAGCATAATCATAGCCG,2,2795166
ompRp1,3.0,2,0,GCGTAGAGACCGTTGAACGT,2,2795455
ompRp1,3.0,2,0,GCATCGGAAAAATAGCGATA,2,2778700
ompRp1,3.0,2,0,CTCATGTCACGACCCATACT,2,2810917
ompRp1,3.0,2,0,CGGGTGTTATCGCCCTCGTC,2,2779736
ompRp1,3.0,2,0,CATTCGTCGCGGTGTGTAAG,2,2785678
ompRp1,3.0,2,0,ATGGAAGTATGGTCTAAACT,2,2765277
ompRp1,3.0,2,0,ACGGAGCCCGGGAGGTGATT,2,2806919
ompRp1,3.0,2,0,ACGCTGCCCAAGTATTGGCC,2,2792071
ompRp1,2.0,1,0,TTTTGCAGGTCTGGTACGAG,1,2821948
ompRp1,2.0,1,0,TTGTTCAATTCTAGAAAAAC,1,2799485
ompRp1,2.0,1,0,TTGACTGCGTATACCTCGGG,1,2792259
ompRp1,2.0,1,0,TGTTTGCGTTCCGTGCTCCT,1,2823958
ompRp1,2.0,1,0,TGGAGATGTCTGGCGACATA,1,2816447
ompRp1,2.0,1,0,TCTTTACTACATGAGAATGC,1,2800481
ompRp1,2.0,1,0,TCGTACGCAGGGAACTTCCG,1,2792932
ompRp1,2.0,1,0,TCATCTTCCATTTTGTAACG,1,2801565
ompRp1,2.0,1,0,TAGGGTAGACACTCAGGGTA,1,2812960
ompRp1,2.0,1,0,GTTGTAGAATTCGGGGGTGA,1,2810532
ompRp1,2.0,1,0,GTGCCATTGTTAACTTCCCC,1,2783630
ompRp1,2.0,1,0,GTCCGCGAGCCACTTACAAG,1,2807927
ompRp1,2.0,1,0,GGTGAAGTCGAAAATGGCGC,1,2815977
ompRp1,2.0,1,0,GGGAGGGGAAGTTTCCGCCC,1,2777110
ompRp1,2.0,1,0,GGACAGAGCCGTTCATATTA,1,2818667
ompRp1,2.0,1,0,GCTAAGTAGCAAACTAAGTT,1,2783026
ompRp1,2.0,1,0,GCTAAGGACAAGTCTCTTGT,1,2792786
ompRp1,2.0,1,0,GCGTCTTTCGTTTCAGTTGA,1,2797928
ompRp1,2.0,1,0,GCGCGTACAGATCCATTAAT,1,2773057
ompRp1,2.0,1,0,GCCAGGGACTCGTAGAGAAT,1,2790990
ompRp1,2.0,1,0,GCAGCAGACCTGTTTTTTGG,1,2804728
ompRp1,2.0,1,0,GATATCGACCAGCCGGGACC,1,2765707
ompRp1,2.0,1,0,GAATTGCAATGTCCGGGAAA,1,2816991
ompRp1,2.0,1,0,GAATCAAGGCGCTCGGAATA,1,2806985
ompRp1,2.0,1,0,CTTTAACAGGTGAAACTGTA,1,2806171
ompRp1,2.0,1,0,CTGTCTAGATGACATCGTCC,1,2789308
ompRp1,2.0,1,0,CTCGAATCCGCAGTATCAGT,1,2772597
ompRp1,2.0,1,0,CTCCGGGCATCAGGGATCGA,1,2781984
ompRp1,2.0,1,0,CTATGATGGGCGTGGTCCTT,1,2775218
ompRp1,2.0,1,0,CTACCAATATTCCATGCGGT,1,2766238
ompRp1,2.0,1,0,CGTCAGGTGAGGCTAACTTT,1,2804510
ompRp1,2.0,1,0,CGCGCTGACGGGTATCGATA,1,2774621
ompRp1,2.0,1,0,CGCACTGCTGGCGGGGGAGC,1,2808739
ompRp1,2.0,1,0,CGCAATTGGCATGATGTCGT,1,2823196
ompRp1,2.0,1,0,CCTCGTTTAGTAATGCTATT,1,2802957
ompRp1,2.0,1,0,CCTACGCTTACGTTCTGTAG,1,2790398
ompRp1,2.0,1,0,CCGAGGAAGCGCCTATTCAT,1,2786953
ompRp1,2.0,1,0,CCCTCAGATTTTCGGTTATT,1,2802679
ompRp1,2.0,1,0,CCCGTGCTCAAGTGTGGTAT,1,2821221
ompRp1,2.0,1,0,CCCGCTTGTGTTACCGCTTT,1,2795372
ompRp1,2.0,1,0,CATACTAACAACATTTGAGA,1,2819967
ompRp1,2.0,1,0,CAGTGACTAACTTACGGTAT,1,2817045
ompRp1,2.0,1,0,CAGCCGTAGGGTTCACCCGT,1,2790873
ompRp1,2.0,1,0,CAACTACCGGGGGCGAGAGC,1,2803834
ompRp1,2.0,1,0,ATGCTTTTTTACATAATATG,1,2785468
ompRp1,2.0,1,0,ATGCACTAAGAATCTCGTAA,1,2809456
ompRp1,2.0,1,0,ATGCAATTCTTTACATTCAT,1,2808165
ompRp1,2.0,1,0,ATGAGCCTGGAAAAACAGGT,1,2792674
ompRp1,2.0,1,0,ATAGACGCGCATCCCTGGGA,1,2778756
ompRp1,2.0,1,0,ATACAGCCTAACGTCGTTTC,1,2789873
ompRp1,2.0,1,0,ATAAGCCTCGACTACTACTA,1,2824180
ompRp1,2.0,1,0,AGTGACCTGCGCGAGTTTCG,1,2810189
ompRp1,2.0,1,0,AGTCTGCAAGCATGACGGAA,1,2794296
ompRp1,2.0,1,0,AGGTGATGCTAGCATATTAT,1,2804418
ompRp1,2.0,1,0,AGCGCACTCATTCGTACCAT,1,2794827
ompRp1,2.0,1,0,AGAGGCTCAAATGTCCATTT,1,2809805
ompRp1,2.0,1,0,ACGTCCTCGGCCGGTCGTCT,1,2790148
ompRp1,2.0,1,0,ACGCACTGCGGCGACAGGGG,1,2775163
ompRp1,2.0,1,0,ACGAGTGCAGGTGGGTCTAC,1,2797540
ompRp1,2.0,1,0,ACCCGGACGTACGAATAATA,1,2805396
ompRp1,2.0,1,0,ACCATCTAGCCCATATTTGT,1,2798259
ompRp1,2.0,1,0,AATTCCCAAGTGCCAAATTA,1,2773138
ompRp1,2.0,1,0,AATACATGGCAATACGACGA,1,2771233
ompRp1,2.0,1,0,AAGTTCACATCAGGACGTCT,1,2815947
ompRp1,2.0,1,0,AAGGGCGGCATTTCCTTCCC,1,2778105
ompRp1,2.0,1,0,AAGCGGGAAGCTCTTGAGTG,1,2783413
ompRp1,2.0,1,0,AACTCCCAGAAGAGGGGATT,1,2773990
ompRp1,2.0,1,0,AAATCGATCCCCGATGTGAA,1,2815995
