name,relative_counts,ct,ct_0,barcode,ct_1,barcode_ind
furpa,0.7861635220125787,850,476,TACCGACATGCAAAATGACA,374,1346229
furpa,0.10897435897435898,171,155,CTCAAGCGTAGGTACCATAG,16,1271922
furpa,0.8513513513513513,272,147,GTGCGCATTTCAGGCTCTTT,125,1272733
furpa,0.06015037593984962,139,132,CACGGTATGATACTTGCTTA,7,1282478
furpa,0.15267175572519084,149,130,CCAGTGGGTAGCGTTAATTG,19,1308652
furpa,1.5625,326,127,TGTTGAACGAGGTTCTAATG,199,1293037
furpa,0.4406779661016949,168,117,ATTACGTGTTTTGATCGTGA,51,1317749
furpa,0.05309734513274336,117,112,AGGCACACCAACAGCGCTCG,5,1277398
furpa,0.42,140,99,GAGGTGCTGACACTCGCATG,41,1271983
furpa,0.56,154,99,CAACAGAGACTGTGTATGAT,55,1313578
furpa,1.1145833333333333,201,95,CCTGACGTGGGATGCCTTAA,106,1272265
furpa,1.1578947368421053,203,94,TTGCCAACTTATCGATCGTG,109,1282363
furpa,0.6702127659574468,155,93,TCTGCTCTGCAAATAGGTCC,62,1350774
furpa,0.3978494623655914,128,92,GGCTACGCCCAAAAGTTCAT,36,1274857
furpa,7.391304347826087,770,91,ACCGGATGCACGTGACTTTC,679,1288383
furpa,2.50561797752809,310,88,GCTATTTGAAAGCGTATTCT,222,1282146
furpa,0.022727272727272728,88,87,CTAGCATACGCAGAGAGGTA,1,1289770
furpa,0.7701149425287356,152,86,AGAGTCGTAGGCACAGCGAG,66,1311925
furpa,1.6352941176470588,222,84,ATGCGGTAACATATGGGTTG,138,1356315
furpa,0.3493975903614458,110,82,CATTTACGCATCGGGATAGG,28,1278485
furpa,1.0625,163,79,CTGTATTACCTCAGGCCCTG,84,1344492
furpa,0.9875,157,79,ATAACGTTGCCGCCCCGTGT,78,1287019
furpa,0.27848101265822783,99,78,GCAAAGGATTGTCAGCCCCT,21,1291887
furpa,0.5949367088607594,124,78,ACTGTTCGGCTCTCCATAGT,46,1330573
furpa,1.0384615384615385,157,77,TCGCGTACATCCTAAACCCT,80,1284309
furpa,1.0389610389610389,155,76,GGTTCATTCCCGGATTTTGA,79,1289595
furpa,0.05263157894736842,78,75,GAAATGTGGTTGGCTGATGA,3,1329132
furpa,0.5131578947368421,113,75,ATTCCAACTTCAAGACTGCC,38,1294050
furpa,1.0810810810810811,152,73,TACCCGAACGAATGGATAAT,79,1356893
furpa,0.04054054054054054,75,73,ACTCCTCAGCGATCCTGCAG,2,1334602
furpa,1.6849315068493151,194,72,TGGACGTGCAACGAACCCTT,122,1342985
furpa,0.041666666666666664,73,71,TAGGGGATCGACGTTCCAGT,2,1347358
furpa,0.4722222222222222,104,71,GCATATTCTAAGCCCATCCC,33,1290965
furpa,0.8055555555555556,128,71,CTCTTCACGTTGGAACCGAA,57,1311848
furpa,1.4444444444444444,174,71,CGGCGTAAATTCATCTTCTT,103,1338879
furpa,0.2916666666666667,91,71,ATTAACCACCAAAGCCAGGC,20,1281014
furpa,0.4027777777777778,99,71,ATATTAAATGGCCGTCACGT,28,1284135
furpa,1.6056338028169015,183,70,TCCAAAGGTATAAACCTCAA,113,1298461
furpa,0.5211267605633803,106,70,CCCTTTGAACCGTTAACTTG,36,1312889
furpa,1.0142857142857142,139,69,TGATGTGGTAGGTGGCAGGT,70,1317221
furpa,1.3428571428571427,162,69,GTAGATACCATCAATTTGAT,93,1328018
furpa,1.2714285714285714,157,69,GGGGAGTGGTTATCAGTCGT,88,1332948
furpa,0.02857142857142857,70,69,CTAGGGTGAAATTCCCTGCA,1,1312427
furpa,0.15714285714285714,79,69,CGATGTCTATTTGTTGGACT,10,1345014
furpa,1.565217391304348,175,68,TACCTCGCGGACCTGAGATA,107,1305630
furpa,1.4202898550724639,165,68,AAGAGCCGACTCTCAGTCAG,97,1278407
furpa,0.14705882352941177,76,67,TGCCGTAAAGGACGCAAGTA,9,1275778
furpa,0.04411764705882353,69,67,GGGGGTAGTAAGTATAGTGA,2,1273739
furpa,0.6029411764705882,107,67,CTGGGATCACGAATGGTGCA,40,1297842
furpa,1.3823529411764706,160,67,AATTCATGCAGCGCGAGGGC,93,1347418
furpa,0.45588235294117646,97,67,AACGGTAATTTGGTGTATAG,30,1271647
furpa,0.835820895522388,121,66,TGACCCATCAAAGAAATGTT,55,1284757
furpa,0.4626865671641791,96,66,GAAACCGCAGATTGCTCGTG,30,1287794
furpa,0.05970149253731343,69,66,CCCGATACTTTCGGTTGCTC,3,1283773
furpa,1.0895522388059702,138,66,ACGGGAGGGTTTCAGGAAGT,72,1318085
furpa,0.08955223880597014,71,66,AAACATATAGCAGACAGAAC,5,1294389
furpa,2.090909090909091,202,65,GATAGAGACCCGTCTCGTCT,137,1326444
furpa,0.42424242424242425,92,65,CCACTTCTGTGAGCACTAGC,27,1294769
furpa,0.045454545454545456,67,65,ATTTCAAAGTAGTAGATGCT,2,1330524
furpa,0.5846153846153846,101,64,TAGGTACTCACTGGGTGTTA,37,1304028
furpa,0.16923076923076924,74,64,GGAAAGTTAAGACCGTGTGC,10,1286822
furpa,7.846153846153846,573,64,GACTAGCGCTTCCGCAGAGT,509,1281879
furpa,0.49230769230769234,95,64,CAACACAGTGCGTTGTAAGA,31,1281585
furpa,0.6875,106,63,TGATGGGGTTCACAAACAGT,43,1346145
furpa,2.640625,231,63,TCCACATGATCTTGCACGGG,168,1321264
furpa,0.03125,64,63,GTGAGAAACCCCTGAACTTG,1,1277399
furpa,0.2698412698412698,78,62,TGAAGGGGTCCAACATAGAT,16,1308596
furpa,0.23809523809523808,76,62,TCTGGCTAATGGCCCTTGCG,14,1336458
furpa,0.36507936507936506,84,62,CCCTGGTCCCACCCGTGTGT,22,1298070
furpa,0.031746031746031744,63,62,CCAGATCATAGAGCGAAGAT,1,1316894
furpa,1.0476190476190477,127,62,AGTATGGTGAACTCAGGTCG,65,1271280
furpa,0.03225806451612903,62,61,CGCGCAATAGCTTATTTCTA,1,1274997
furpa,3.4262295081967213,268,60,TATTGAATCGTTCGGAAATC,208,1280313
furpa,0.04918032786885246,62,60,GGGTTCCGTAGGTATACGAG,2,1272968
furpa,6.262295081967213,441,60,CGCAGCAGGCTTAGACGAGT,381,1290098
furpa,1.1967213114754098,132,60,CCGGACTGTATCAGGCGTGT,72,1274244
furpa,0.04918032786885246,62,60,ATTAAAGTATTTGTCAGGCG,2,1281706
furpa,3.737704918032787,287,60,AGGGCCATCAAAGAACGATT,227,1340273
furpa,0.36065573770491804,81,60,AGAAGGGCAGGGTTAATGCT,21,1352811
furpa,1.7377049180327868,165,60,AAGGAACGACCGCCGGAGGT,105,1301147
furpa,1.4833333333333334,147,59,TTATGCAGTCCACTTACTTT,88,1336124
furpa,0.35,79,59,GTCCGTCGAAGTAGATAGCT,20,1323382
furpa,0.7,100,59,GGCTTATGTACTAATCTAGC,41,1356371
furpa,1.1166666666666667,125,59,CTCGGTCACCTGGCGTTTCT,66,1317788
furpa,0.25,73,59,CCTCGCGGGATTCTAGACCC,14,1272185
furpa,0.48333333333333334,87,59,CCGGGGGGGCCTTTTCAGCA,28,1274315
furpa,1.0338983050847457,118,58,GGGCTGGAAGGACACTTTAA,60,1272318
furpa,0.6779661016949152,97,58,GGAAGCTGGAGCGTTGTCAC,39,1348305
furpa,0.05084745762711865,60,58,CTGAGTCGCCGAGCCTGCTC,2,1273530
furpa,0.7288135593220338,100,58,CTGACCACAGTTCAGACGAA,42,1297894
furpa,0.288135593220339,74,58,ACGCGAAGATATCGCCTTAC,16,1273597
furpa,0.03389830508474576,59,58,ACGACTATATGATCTGCAGT,1,1273672
furpa,1.2033898305084745,128,58,ACATCGCGCCTTGGATAGGT,70,1293112
furpa,0.034482758620689655,58,57,TCCGATTTGCACACTCCGTT,1,1304508
furpa,1.0689655172413792,118,57,GAACCTGGGAGTCCTGTCAG,61,1301182
furpa,1.1551724137931034,123,57,CGGTTCTTCCGAGGACTTCG,66,1271990
furpa,0.7931034482758621,102,57,AGAATGTTGCCACATCCAGC,45,1346350
furpa,0.43859649122807015,80,56,TTGAACTTAACTGTGGATAT,24,1308963
furpa,1.6140350877192982,147,56,TATGGCGGACGGGGTTATTA,91,1323803
furpa,0.45614035087719296,81,56,TACAGTTCTACTAGGGCCTG,25,1331407
furpa,2.767857142857143,209,55,TTCTGTTTAGTACTCTGTCA,154,1315468
furpa,0.7678571428571429,97,55,TTAGTTGAGATCTAACAAAT,42,1337352
furpa,1.0535714285714286,113,55,TTAATACACTCTCAACAGAT,58,1323083
furpa,0.125,61,55,TCACGCAGCGGTTCGGACAA,6,1274790
furpa,2.1607142857142856,175,55,GCTGTACCTACGTGTGTAGC,120,1313878
furpa,0.07142857142857142,58,55,GAATAGTAGAATAGTGACAG,3,1275915
furpa,1.4464285714285714,135,55,CATTTCTATTTGTATAAACG,80,1309003
furpa,0.9107142857142857,105,55,CATTCGCTAGGATTTATTTA,50,1343559
furpa,0.42857142857142855,78,55,ATCGTGCTTGCAACCGATTG,23,1274084
furpa,1.4285714285714286,134,55,ATACTAGAGGATGTACCTTG,79,1334334
furpa,0.9818181818181818,107,54,TTTCGGTAATCATAGTCGGA,53,1344114
furpa,0.5454545454545454,83,54,TGGCTCTATCCTCCGATCCC,29,1306146
furpa,0.45454545454545453,78,54,TGGACAGTTGACCGTCCTCG,24,1349800
furpa,1.4727272727272727,134,54,GTCAAGACTAGGCGCGTCAC,80,1345308
furpa,0.45454545454545453,78,54,GTAACAAAGATCCCCAGGCT,24,1274128
furpa,0.12727272727272726,60,54,CATGCGGGGAGTGTATCGAG,6,1320867
furpa,2.8545454545454545,210,54,ATTCCGACTTGCAACGCAGA,156,1343646
furpa,1.0,108,54,ACAGTGACAGTTGTGCGGAT,54,1272302
furpa,0.5370370370370371,81,53,TTTCCAGTTCTCAACCCCTA,28,1273508
furpa,0.7592592592592593,93,53,TTGGTATAGCAAACATCACA,40,1328562
furpa,1.4074074074074074,128,53,GTTAACCCCATGCAAACTAA,75,1273532
furpa,0.5555555555555556,82,53,GGTTAGCCGCCTTTGAATAT,29,1314107
furpa,1.8518518518518519,152,53,GGGTTGACAACTTCATCACA,99,1315581
furpa,0.6666666666666666,88,53,GCTTAGCAAGACAGTATCCG,35,1275649
furpa,2.8333333333333335,205,53,CTGCAGCGCCGGGATACGAG,152,1272066
furpa,0.5925925925925926,84,53,CGGAGTACGACCGCTGATCT,31,1317223
furpa,0.5555555555555556,82,53,CGATATGCATTGAGTGCCGT,29,1298975
furpa,0.7037037037037037,90,53,CCACGACTCATAGGTATTGT,37,1333580
furpa,0.18518518518518517,62,53,CAGCCAAATCACGTCGTAAT,9,1278491
furpa,1.3148148148148149,123,53,ATGCACGATCTTTGTCTGCT,70,1356918
furpa,0.7735849056603774,92,52,GGGTGCCTGCGGTCAAAGCA,40,1320056
furpa,6.018867924528302,370,52,GCATGGTGCCACCGCTAGGT,318,1352731
furpa,0.8301886792452831,95,52,CCGAGGGCCGGTCTGCAAAT,43,1335501
furpa,1.9245283018867925,153,52,CCAGTGGCCGAGATCTCCCC,101,1310091
furpa,1.4339622641509433,127,52,AGAGCAGGCACGACTCTAGT,75,1324234
furpa,2.9056603773584904,205,52,AATACAATAGTTTTCCTGGT,153,1325367
furpa,1.6603773584905661,139,52,AACGGTGTTAACCGTTGGGA,87,1277738
furpa,2.4038461538461537,175,51,GTTGAGACTATGCAGGACTT,124,1281539
furpa,0.2692307692307692,64,51,GTCATAGCGTATGGAGAATG,13,1346238
furpa,0.5961538461538461,81,51,GATCCGTTAAGATAAGGGGT,30,1306584
furpa,0.9423076923076923,99,51,GACATAACGATGGATGTATA,48,1277039
furpa,0.19230769230769232,60,51,CTTAGTACCGTGTTGAACTC,9,1273182
furpa,0.6923076923076923,86,51,CTCTTTATTTTTCATAAGGT,35,1340965
furpa,0.5192307692307693,77,51,ATCAGCGCAATACTTAACCT,26,1309653
furpa,0.057692307692307696,53,51,ACTGGATGGGATGCCGTCAC,2,1328809
furpa,0.29411764705882354,64,50,TTTACAGTTCCGGGTCGCGG,14,1320492
furpa,2.0392156862745097,153,50,TCCAAGCCGGATTACGGTAT,103,1287670
furpa,1.2745098039215685,114,50,TCACTTTACACCATCTCGTT,64,1338661
furpa,1.196078431372549,110,50,TATCTCCGCGCTCCGGCACA,60,1315314
furpa,0.6862745098039216,84,50,TATACATTTTGTCGCACCTC,34,1321449
furpa,1.7450980392156863,138,50,GGGTCCGGAGAGGGCCAGTA,88,1279848
furpa,0.7647058823529411,88,50,GCCGTATGACTCCTATGCAT,38,1273515
furpa,1.1764705882352942,109,50,GCATTAGCAATTATTCGATT,59,1340110
furpa,0.37254901960784315,68,50,CGCAATAAGGTGCGCAGATT,18,1310787
furpa,0.1568627450980392,57,50,CCAGGACCATATTGCACCCA,7,1282869
furpa,0.17647058823529413,58,50,ATGTTGGAAAGTATTTAGAA,8,1312086
furpa,0.5686274509803921,78,50,ATGGAGGGTACTATTGCACT,28,1287650
furpa,0.4117647058823529,70,50,AGGGCCGCTTCGCTGCCCCA,20,1290875
furpa,0.7450980392156863,87,50,AGGCGGCACGCGGACTGGTT,37,1318099
furpa,0.45098039215686275,72,50,AGGCCAGGGGACAGTCCTTT,22,1346743
furpa,0.0392156862745098,51,50,ACTACATCCGATTGTTAACT,1,1305051
furpa,0.62,79,49,TCAACCCGGGAGCCGGAACA,30,1271774
furpa,0.68,82,49,TACTACGAGATTTTAGTTCT,33,1293030
furpa,0.98,97,49,GAGGATCGTGGTTCCAGGAT,48,1316404
furpa,4.92,294,49,CTGTGGTGAACTGGTGGAAT,245,1294096
furpa,0.12,54,49,CTATTGCATCAAGAACGCCT,5,1350151
furpa,1.64,130,49,CATTCGTGCGGTTTATGTTC,81,1273600
furpa,0.18,57,49,CAGTCGCGTGTCTAATGCGT,8,1286875
furpa,0.82,89,49,ATAGTCGGGTGATGTTGCTA,40,1332636
furpa,0.04,50,49,AGTCTCTGCATATTCTAATG,1,1321206
furpa,0.6,78,49,AGGAGAGTAAACACTGGGAA,29,1274624
furpa,0.42857142857142855,68,48,TTAGTGCCAAGAAGGTCGTC,20,1352152
furpa,0.061224489795918366,50,48,TCTCTCTCTTCACATTATAT,2,1315773
furpa,0.1836734693877551,56,48,TATACGGTTACTTCTCAGAT,8,1277030
furpa,0.9183673469387755,92,48,TAGTTTGTCCAGTGCCAAGG,44,1281640
furpa,2.4489795918367347,167,48,GTCAATAAGTACTCCTATAT,119,1296736
furpa,0.04081632653061224,49,48,GATCCTCGAGGGATACGCCG,1,1346843
furpa,0.40816326530612246,67,48,CGAAATGCTACAAGTCTGCT,19,1330391
furpa,0.7551020408163265,84,48,CAGCTAAAGGGTACCCAGAT,36,1355288
furpa,0.4897959183673469,71,48,AGGTAGATAACGCACAGCAG,23,1290456
furpa,1.2040816326530612,106,48,AATCAATCGGCCGACGGCAG,58,1301032
furpa,0.0625,49,47,TGCCTTCCGTACGAAGCTGA,2,1346421
furpa,0.5833333333333334,74,47,GCCCTGCCTAGTCACATGGT,27,1319429
furpa,0.5,70,47,GCCACCCGGCAAGGACATCG,23,1278639
furpa,0.041666666666666664,48,47,GAAAGGGTTTATGTGCTTGT,1,1291616
furpa,0.4166666666666667,66,47,CTCTCTTGGCAGTACTGGAT,19,1272187
furpa,1.4791666666666667,117,47,CTCCGATTCATCGGTGCTCA,70,1330661
furpa,0.041666666666666664,48,47,CGCGTATGTAATAGCTAGCT,1,1287741
furpa,0.08333333333333333,50,47,CGCCGGTACAGTATCTATAT,3,1304952
furpa,0.041666666666666664,48,47,CCCACAGCCCACACTTAAAT,1,1277481
furpa,2.1458333333333335,149,47,CCATGCTTGTTGCTAATTGT,102,1345779
furpa,5.229166666666667,297,47,CATATGGGTTATCGCCGTAT,250,1331465
furpa,0.25,58,47,CACAGATACCCTCAGACTGG,11,1328923
furpa,1.1458333333333333,101,47,ATCTGTACAGATCGAAGTGT,54,1282503
furpa,1.0833333333333333,98,47,ATAGTTGACCTTAATGTTTA,51,1282679
furpa,3.625,220,47,ACCTTGTGAGACTAAGTCTC,173,1300909
furpa,3.6595744680851063,217,46,TGGATAGGCTTATGTCCTAT,171,1280314
furpa,1.0212765957446808,93,46,TCTTTAAGTGGCTATAGTCG,47,1311498
furpa,0.9574468085106383,90,46,TCTTGCAAGGAAAGATTATG,44,1333761
furpa,0.19148936170212766,54,46,GTGGCCCGTACAAATTATTC,8,1274245
furpa,1.1063829787234043,97,46,GAGGTGTTGGTCTCCTACGG,51,1339684
furpa,4.638297872340425,263,46,GAATCACGTCCCTTTACGCG,217,1313987
furpa,0.5531914893617021,71,46,CTAGTATCGGGAACCTCCGT,25,1291873
furpa,1.2765957446808511,105,46,CCGCCTTATATGACTAACCA,59,1271715
furpa,1.3404255319148937,108,46,CCAACTGGGCTCCCACGGCT,62,1302438
furpa,0.3191489361702128,60,46,CATTGCTCGGCATCCTGTAT,14,1327135
furpa,0.14893617021276595,52,46,ACGCTGGCGTGGCGTATACG,6,1347836
furpa,0.6382978723404256,75,46,AAGCAAGCCGCTCGACCCAG,29,1336771
furpa,0.6956521739130435,76,45,TTTGGTACCGGTACTGAGAC,31,1295478
furpa,6.608695652173913,348,45,GGAGTGACCGATCATGCCAT,303,1313310
furpa,0.4782608695652174,66,45,CTGTATACTCATTACAGATG,21,1289592
furpa,0.10869565217391304,49,45,CTGCGAAGTTCAGTCCAAAG,4,1292380
furpa,0.9782608695652174,89,45,CGGGCGGTCTTAACGTCCAG,44,1306504
furpa,0.782608695652174,80,45,CACGGCTAACTTCTGACCCC,35,1292113
furpa,0.7608695652173914,79,45,CACGCGGTCCACCGGGGAGT,34,1318819
furpa,0.7608695652173914,79,45,ACTTTTAATCTGGTCTTCCG,34,1276174
furpa,1.0,90,45,AATGCATGATTCCCACCTAG,45,1303617
furpa,0.8260869565217391,82,45,AAATGCTGTCGTCGTCCCCC,37,1279360
furpa,0.9777777777777777,87,44,TGTAATGGATGGCTCGCACT,43,1299281
furpa,0.7555555555555555,77,44,TGCGTCAGCCAAGACGCATT,33,1315646
furpa,1.4222222222222223,107,44,TATTTCATACGTTGGAGTCT,63,1321561
furpa,0.06666666666666667,46,44,GCACTGCGTATAGTGCAAAC,2,1282598
furpa,1.1555555555555554,95,44,CTCTGTCTATTGGCTTATGG,51,1352290
furpa,0.3333333333333333,58,44,CGGTTTGTCAACGACCTGTT,14,1332598
furpa,2.7777777777777777,168,44,CCTGCCTTTAGGGGAGGGGG,124,1291664
furpa,0.6666666666666666,73,44,CACCTCGCCTCGACTCTTGA,29,1342694
furpa,0.4666666666666667,64,44,CAAACAGAAATATTCGGATT,20,1288327
furpa,4.2,232,44,AGGGTAGAGAATGCAGCCAC,188,1273072
furpa,1.4222222222222223,107,44,AAGGGTGTCAGCTGTTCAAC,63,1347248
furpa,0.7333333333333333,76,44,AAGCTTTACGTACTGCGGGT,32,1281503
furpa,0.6818181818181818,72,43,TGCGAGTCCCTGTAACATCT,29,1277486
furpa,0.11363636363636363,47,43,GTACACCAAATAGCGAAAAC,4,1331145
furpa,3.4318181818181817,193,43,GGTATTCAATCCGCCTCCAT,150,1276359
furpa,1.6818181818181819,116,43,GCATCATTATACGCGAATAA,73,1273977
furpa,0.7954545454545454,77,43,GACTGAGACGCACCTCAGGT,34,1333096
furpa,0.5909090909090909,68,43,GAAGACATTCTCGCGACACT,25,1326686
furpa,0.22727272727272727,52,43,CTCGCCTGTCGTGCGCATAT,9,1332475
furpa,0.045454545454545456,44,43,CGGTGTCTCCGGAGGCATTA,1,1301712
furpa,0.29545454545454547,55,43,CGCCGCCAGTTAGAACACCT,12,1345746
furpa,1.9090909090909092,126,43,CAGGACTTTGAAAGGCATAT,83,1282145
furpa,0.5454545454545454,66,43,CAACTAAAACTCTGCGGTCA,23,1289594
furpa,2.2954545454545454,143,43,ACGTCGAGACACATACCAGT,100,1345715
furpa,0.09090909090909091,46,43,ACCATCATGCACTCATGGAC,3,1307987
furpa,0.5909090909090909,68,43,AAACATGGGTTAAGGCTAGC,25,1321395
furpa,4.883720930232558,251,42,TTGCCTGGCTCTCAATCGGT,209,1338833
furpa,0.3488372093023256,56,42,TTGACAGCGAAGTCTATAAG,14,1357649
furpa,1.255813953488372,95,42,TTCGAGATTAAGGCTTCTGT,53,1309706
furpa,0.9302325581395349,81,42,TTAGCGAGATCACTGGGACA,39,1344009
furpa,1.3488372093023255,99,42,TGGAATGGAGGAGGTCTCTG,57,1278640
furpa,1.0465116279069768,86,42,TCTCTAGCCGGGCCTGACGA,44,1352332
furpa,0.27906976744186046,53,42,TCTCATGAGACGCGAGGAAT,11,1299851
furpa,0.13953488372093023,47,42,GTTTAAGACCTAGATTGGGT,5,1289664
furpa,0.06976744186046512,44,42,GTAGATAGGTTCGCGCTTCG,2,1294232
furpa,0.9069767441860465,80,42,GCGCGGAAATATCTCAGCGC,38,1349387
furpa,0.18604651162790697,49,42,GAGTTGACTTTCATCTTAAC,7,1341179
furpa,3.5348837209302326,193,42,CTGTCGAAGCAATCTTTAGT,151,1308835
furpa,1.1162790697674418,89,42,CGGCCCTCACGGAATAGGAA,47,1294768
furpa,0.9534883720930233,82,42,CGCGTAGACCGTTCAGTCGG,40,1281504
furpa,0.8372093023255814,77,42,CGCCTTCGTTCTGTACCTGG,35,1329726
furpa,1.0232558139534884,85,42,CAAAATTGATTCATAATGAT,43,1335793
furpa,0.046511627906976744,43,42,ATCCGCAGCTAAGATTAGTG,1,1277479
furpa,2.4186046511627906,145,42,ACTTATAGTTCCCTAACTCT,103,1320037
furpa,0.35714285714285715,55,41,TTCTGGATAGCATATTCTAG,14,1308422
furpa,0.47619047619047616,60,41,TTCCTCTCTGGTCGCGAACT,19,1299579
furpa,1.4761904761904763,102,41,TTCAGCTTCTAATTCACCGC,61,1313757
furpa,2.1666666666666665,131,41,TTACATGGGTAGCGGCATAT,90,1344324
furpa,2.4761904761904763,144,41,TGCCGTATGCATCATTTGCG,103,1309592
furpa,0.5476190476190477,63,41,TCTGAGTAGATAAGGATGAT,22,1343247
furpa,0.11904761904761904,45,41,TCGCCTGGTCGCATATAGGA,4,1285686
furpa,0.047619047619047616,42,41,TAATATCGTAACGCCAGACT,1,1283374
furpa,1.619047619047619,108,41,GCCAGTGATTGGGGGTCCGT,67,1317080
furpa,0.38095238095238093,56,41,CTACCTGAAATGAATTGCAG,15,1278964
furpa,0.21428571428571427,49,41,CTAATCGTTGCAGTGAATGC,8,1307922
furpa,0.5952380952380952,65,41,CGTTTAACGACGCCGAGCGA,24,1294817
furpa,1.1428571428571428,88,41,CGTCCTGGCTGAATATGTCT,47,1278755
furpa,0.8809523809523809,77,41,CGCCTCGCCACTTGTTCGTT,36,1297177
furpa,0.09523809523809523,44,41,ATATATGCTGCATAGCACAT,3,1285900
furpa,0.14285714285714285,46,41,AGTGCGTTTGACAGCCAGAA,5,1336453
furpa,0.09523809523809523,44,41,AGGCACGTATACCCAAGTGC,3,1317357
furpa,0.11904761904761904,45,41,AGATAGGGCGTACAGGTATT,4,1325612
furpa,1.2619047619047619,93,41,AGACCCCAACGGTAATATGT,52,1311458
furpa,0.23809523809523808,50,41,ACCGTAGGCGCCGGGCATCG,9,1329943
furpa,0.14285714285714285,46,41,AATTATATAGCGCGCGAACA,5,1350858
furpa,0.9523809523809523,80,41,AATACTTGAAAGTTGGGCTC,39,1302814
furpa,0.19047619047619047,48,41,AACAGTCGAGGGGTCATTAA,7,1313314
furpa,1.5853658536585367,104,40,TTCGGGACCTTATCAGCGAT,64,1296962
furpa,1.7804878048780488,112,40,TCAGATCGGTTACTCGAAGT,72,1345468
furpa,0.9512195121951219,78,40,GTGTCCGACCGCAGCAAGTG,38,1304340
furpa,0.14634146341463414,45,40,GTGCTAGCGAGATTATTGAT,5,1314902
furpa,1.4390243902439024,98,40,GGTAATCGACAACAATGCGT,58,1331522
furpa,0.34146341463414637,53,40,GGGTGCGAGGGGTAGGTTCA,13,1299521
furpa,1.2926829268292683,92,40,GGATTTGTGACCGCCGTCAA,52,1288967
furpa,0.6097560975609756,64,40,GGATCCTCTTCCTTGTCTGA,24,1305024
furpa,0.14634146341463414,45,40,GGATACGCGACATTTACTTT,5,1288866
furpa,1.0731707317073171,83,40,GGACAATACTGGGTGATGGG,43,1341016
furpa,1.2195121951219512,89,40,GCGGCTAGGCGGCCTTGGCC,49,1301358
furpa,0.04878048780487805,41,40,GCGCCATCTGCCACTGATGT,1,1330463
furpa,0.8048780487804879,72,40,GCGACTGGGCTTCCAACCCT,32,1272898
furpa,0.04878048780487805,41,40,GAGCCCTCAGTAAAGGTGAG,1,1297418
furpa,0.8048780487804879,72,40,CGTATCAAGTGTAGCTGGCC,32,1295129
furpa,1.5609756097560976,103,40,CGTACGCCTCGACAGCTACC,63,1326749
furpa,0.07317073170731707,42,40,CGGTGCGGGCTGTCACCATT,2,1274088
furpa,1.4634146341463414,99,40,CGGCACCTAGTATTGAGAAA,59,1275651
furpa,0.0975609756097561,43,40,CGCGTGCCGTCTTTTACATT,3,1337208
furpa,0.4146341463414634,56,40,CCCCTAGTAGAAACAGAGAT,16,1281713
furpa,6.682926829268292,313,40,CCATCCGAAACGTATACACT,273,1275575
furpa,0.0975609756097561,43,40,CAACTGGGTTGGTGTAGCTA,3,1337897
furpa,0.07317073170731707,42,40,ATGGTACGTCGTCGGCTAGT,2,1332904
furpa,0.4878048780487805,59,40,ATCAGCGGTTCAAGTCACAT,19,1294799
furpa,2.658536585365854,148,40,AGCAGCCCATTTGTATGTCT,108,1316762
furpa,0.9512195121951219,78,40,AAATGAGTGACCACGCACCC,38,1348372
furpa,3.125,163,39,TGTTGTTCGAGGCCTCTGAG,124,1313311
furpa,4.325,211,39,TGGTCTGTCTAGGTACCGGA,172,1288801
furpa,0.925,75,39,TCTCTTGGAGGTAAGTTAGT,36,1297084
furpa,1.2,86,39,TACCATTCTATGGTTCCCTC,47,1311024
furpa,0.85,72,39,TAAATAAGCCGCTCATCGCT,33,1276759
furpa,2.025,119,39,GTGGGGTCCTCCTTTTTTTT,80,1327242
furpa,1.375,93,39,GTCTTCCAGAGAGGCGAAGA,54,1326739
furpa,1.525,99,39,GTACGTTTTAACTGACGTCT,60,1341022
furpa,0.775,69,39,GGATGCGTTCTGGATATCAT,30,1271714
furpa,0.4,54,39,GGAGTCGCTCAACGGACTTT,15,1276876
furpa,3.95,196,39,GCCTAGCGGTGAGATTTCCT,157,1291554
furpa,0.675,65,39,GCCCGATCCTTGTGGGGGCT,26,1306405
furpa,0.325,51,39,GCAGATACGGGGGTCTACAA,12,1285462
furpa,0.975,77,39,CTAACGTATCGCGGGCAAAG,38,1286412
furpa,0.125,43,39,CCTACCACTTTGGCCTATTA,4,1282817
furpa,1.575,101,39,CCGTGGTTTGGGAACGGAAC,62,1342427
furpa,7.15,324,39,CAACTTCGTCCGGATAAGCA,285,1304064
furpa,0.95,76,39,ATACGTGTCCCACGTTCCTT,37,1276361
furpa,0.45,56,39,AGTGGGCCATGTAGACTTCA,17,1323673
furpa,2.85,152,39,AGTATTCTTCAGATTACACC,113,1297043
furpa,0.725,67,39,AGGGCCAATACTGCGGTCCT,28,1313071
furpa,0.225,47,39,AGCGGAGGCAAAGTCCGGAT,8,1276920
furpa,0.05,40,39,AGACCCACAGGGCGTCGTGA,1,1301120
furpa,0.4,54,39,ACGCCGAGGTGCGAACAGAA,15,1271494
furpa,2.475,137,39,AATTGCAAACAATAACTCTG,98,1336081
furpa,2.45,136,39,AAGGATCCGGAATGAGCCGC,97,1290894
furpa,1.2,86,39,AAAGTTGAGGCAATGAATGC,47,1313758
furpa,0.1,42,39,AAAAGCAACAGGGTGAGTGA,3,1292227
furpa,0.125,43,39,AAAACTTTGGCTCCGCGAAT,4,1283411
furpa,0.2564102564102564,47,38,TTGGCTTACACACACCGACA,9,1336816
furpa,0.41025641025641024,53,38,TTCCATGACGATAGGGCCTA,15,1310233
furpa,1.1282051282051282,81,38,TGTAGGTCAGGATAGCGTCG,43,1278911
furpa,0.23076923076923078,46,38,TGATATACTTTAGATTTCTT,8,1334181
furpa,1.0,76,38,TCTACCTCGCTGTCAATGGT,38,1279363
furpa,0.05128205128205128,39,38,GTCATAACCGGGGGCCAAGC,1,1276105
furpa,0.1794871794871795,44,38,GGGATTTTTGTCAAGCTGAT,6,1299292
furpa,0.1794871794871795,44,38,GGCGATGCCTGCGAGCGAGG,6,1317479
furpa,0.05128205128205128,39,38,GGAACCGGCCATGCGACAAG,1,1293221
furpa,0.15384615384615385,43,38,GAGATAGATCCGCGGGAGAG,5,1299613
furpa,1.205128205128205,84,38,GACGCTAATTCGGCGTTACT,46,1321855
furpa,0.3333333333333333,50,38,GACAGCCTCAACGGTATCTA,12,1314208
furpa,1.1794871794871795,83,38,CTGGAGGCCATGTCGGAGCA,45,1293431
furpa,3.2051282051282053,162,38,CTCAGCACGTCTCGCCTCAC,124,1307170
furpa,1.3846153846153846,91,38,CCACGTGACATTTGCTGCTC,53,1299000
furpa,1.9230769230769231,112,38,CATGCGGCTGAGTTGTCGTA,74,1320572
furpa,0.46153846153846156,55,38,CACAGTGACTGGCGTTACAG,17,1289404
furpa,1.4871794871794872,95,38,ATATCAGCCCGTCCCTGTGG,57,1279171
furpa,0.05128205128205128,39,38,AGTATAACTGTTATTCGAAT,1,1354709
furpa,0.8461538461538461,70,38,AGAGCCCGTCCAAGAGCATT,32,1314472
furpa,0.8461538461538461,70,38,ACTGGCTAATAGCTAAACAG,32,1275577
furpa,0.10256410256410256,41,38,ACGAAGGTAGGTTGTTGTCA,3,1357277
furpa,0.5641025641025641,59,38,ACCAGTTATGGGTGACCGCA,21,1317603
furpa,0.41025641025641024,53,38,AATAAGAACACTGGACATGT,15,1304293
furpa,2.923076923076923,151,38,AAGACGCAGGGAACTATGTA,113,1297082
furpa,0.20512820512820512,45,38,AACATCCGTCCAAGAAGAAA,7,1285463
furpa,0.05128205128205128,39,38,AAAAATAGGTTGCATTGTAT,1,1307776
furpa,4.973684210526316,225,37,TTTGTCGTAAGAGCACACGA,188,1280172
furpa,0.7631578947368421,65,37,TTGTACAAGGCGGCGTGGTT,28,1283112
furpa,1.105263157894737,78,37,TTATAAACGTGCGAATAGCG,41,1290401
furpa,0.5526315789473685,57,37,TGGGGCGGACTCAGATTTAT,20,1292668
furpa,0.5,55,37,TATGTAGGGGTACCCGCTAT,18,1293366
furpa,0.07894736842105263,39,37,GTGTAGCGTATAACAGTTGG,2,1278266
furpa,2.710526315789474,139,37,GTCCTGGGAGAGTTTCAGAC,102,1330210
furpa,11.31578947368421,466,37,GGCCCTAGCGCCGAAAGATT,429,1277187
furpa,0.42105263157894735,52,37,GGAGTATCCCGCCTCGATCT,15,1281786
furpa,0.47368421052631576,54,37,GCAGACAGCCGTGTTAGGCA,17,1354764
furpa,0.47368421052631576,54,37,GATCGTCGAGCCTATGTATA,17,1304606
furpa,0.23684210526315788,45,37,GAGGTAGGTCGGACATAGCT,8,1282686
furpa,0.7894736842105263,66,37,GAACGTCCAAGATGCAGCCG,29,1298229
furpa,0.5,55,37,CTGGGCGGTAGCGGGTGATG,18,1314826
furpa,0.7894736842105263,66,37,CTCTCGCCTTCTTACGGTGT,29,1300728
furpa,0.05263157894736842,38,37,CTCTAAAGGGCCGCACACAG,1,1321778
furpa,0.07894736842105263,39,37,CTAGTCACACTGGCGCTTTG,2,1303281
furpa,0.07894736842105263,39,37,CGTGTGTTCCAAGAATACGG,2,1299100
furpa,0.15789473684210525,42,37,CGGTCTCCGAGGCTTCGCTT,5,1333321
furpa,0.15789473684210525,42,37,CGCGGCGAACTGCCCCAATC,5,1295198
furpa,1.0526315789473684,76,37,CGCATTGTCCAGAGGGTTGA,39,1354244
furpa,2.1578947368421053,118,37,CGAGATCGAAAGCATAGATT,81,1284809
furpa,0.9210526315789473,71,37,CGACAGTATGCTTAGCTTCG,34,1290677
furpa,0.5263157894736842,56,37,CCTTAACTTCGTTGTTTCGG,19,1312080
furpa,0.15789473684210525,42,37,CCGATTTAGAGACTTGGTCT,5,1348600
furpa,0.9736842105263158,73,37,CAATCACCAACATCGAAACA,36,1279294
furpa,0.8947368421052632,70,37,ATGGTTTCTTACTTCCCGCT,33,1346597
furpa,0.7368421052631579,64,37,ATAAGACCCGAAGACTTTGG,27,1332090
furpa,0.5526315789473685,57,37,AGCTGTATTCTTAGACCTGT,20,1357014
furpa,1.3421052631578947,87,37,ACGTCGTTGTCCGGAAACAT,50,1287104
furpa,0.6842105263157895,62,37,ACGACTTGGGACGCTAGATG,25,1273674
furpa,2.1578947368421053,118,37,AATCCGGCAAGCGGCCTCCC,81,1308309
furpa,0.7027027027027027,61,36,TTGGCGACACGCATTCATTC,25,1275188
furpa,0.05405405405405406,37,36,TGGTTGGGTCTGGACGGCCC,1,1282072
furpa,0.8108108108108109,65,36,TGCCATAGTGACTGGCATCG,29,1276106
furpa,0.24324324324324326,44,36,TGAGTAAATTCAGATTCTGT,8,1301040
furpa,0.4864864864864865,53,36,TCTTTCTATGGTATCTTGAG,17,1303958
furpa,0.7027027027027027,61,36,TCTTGAGCGGGGTCGGCCAG,25,1276976
furpa,2.027027027027027,110,36,TCAGGCAGTAAGAGTGTGGT,74,1343878
furpa,0.05405405405405406,37,36,TCAAGTCTGTCGATGGTTCT,1,1322354
furpa,1.054054054054054,74,36,GTTGGGCTTACATGGAAGCA,38,1352117
furpa,2.6216216216216215,132,36,GTGTAAACGATTGTTCAGGT,96,1336252
furpa,1.7837837837837838,101,36,GTAGTAGGTAGACGGTACGG,65,1299520
furpa,0.8918918918918919,68,36,GGGCATGATCCTGAAGCCGA,32,1306694
furpa,0.40540540540540543,50,36,GCGTTACCGGATAGCCAACA,14,1277543
furpa,0.08108108108108109,38,36,GCCTGAACTGCACTGTAAGT,2,1354261
furpa,1.1081081081081081,76,36,GCCGAAAGCGCTCCATAAGA,40,1308281
furpa,1.1891891891891893,79,36,GAATGGGAGAAGTATAGCGA,43,1273372
furpa,1.945945945945946,107,36,GAAGTCCTATGCGCCTTCCA,71,1329487
furpa,0.21621621621621623,43,36,CTTACACTTTTTTCCAAGTG,7,1276996
furpa,0.32432432432432434,47,36,CTAGTGCCGAGGTAAGGGTT,11,1337824
furpa,0.7027027027027027,61,36,CGTTGCTTAGGGTGACTAAG,25,1291489
furpa,2.054054054054054,111,36,CGGGTTCGTGCTGAGTAGAA,75,1278561
furpa,0.4594594594594595,52,36,CGGGTCGCCTCAATGCAGGA,16,1308489
furpa,0.6216216216216216,58,36,CGGAGCCTCGTGGTATGATT,22,1289290
furpa,0.05405405405405406,37,36,CGATTAACTTCTACTGTTCA,1,1282691
furpa,2.135135135135135,114,36,CGACGCCTGAGTAGCACAGC,78,1328361
furpa,3.4594594594594597,163,36,CGAATGCCGTGCACATTGCA,127,1336067
furpa,0.05405405405405406,37,36,CCGGTTATGGCGCTATCCAG,1,1347005
furpa,0.8108108108108109,65,36,CCCACGCGGTAACCGGTTCA,29,1349118
furpa,0.2972972972972973,46,36,CAACGTTTAGACACGGATCC,10,1305274
furpa,11.54054054054054,462,36,AGTAATTTCGTCAGAGCATG,426,1347008
furpa,1.054054054054054,74,36,AGGGCTTTCTCTACAGCAGA,38,1302018
furpa,1.5135135135135136,91,36,AGGCACCGGCCCACGCGAAA,55,1284252
furpa,0.8108108108108109,65,36,AGAAGACGCTCGTAACCTGG,29,1311161
furpa,0.1891891891891892,42,36,AATAGTTTGATGGATCTGAC,6,1284818
furpa,0.3783783783783784,49,36,AAGGCAGGTAAGAAAATAAA,13,1313755
furpa,1.5675675675675675,93,36,AAGCAGCGAGCATCCATCCG,57,1325566
furpa,0.35135135135135137,48,36,AAGAGATGAAATCGACTATA,12,1277483
furpa,1.6756756756756757,97,36,AACTATTTCGCGGTTGAGTG,61,1343662
furpa,2.5,124,35,TTCCTGGATTCTCTCCTCTG,89,1315309
furpa,1.3611111111111112,83,35,TGTGTCTCTACCCGGCTCGG,48,1291597
furpa,1.9166666666666667,103,35,TGCTACTATCTGCGTAAGCT,68,1334488
furpa,0.1388888888888889,39,35,TGCCTTCATGGGCTAGGTAT,4,1300784
furpa,0.5277777777777778,53,35,TCCGGCTAGAGACTTCCGGT,18,1344621
furpa,0.6666666666666666,58,35,TCCCGTTCTCTACGCGCTCA,23,1334532
furpa,2.2777777777777777,116,35,TATGGACCTCAGCAAGGATC,81,1283375
furpa,0.8055555555555556,63,35,TACATTTGAACTTCAGGCCC,28,1342042
furpa,1.1111111111111112,74,35,GTTGTAACATAACACGCATA,39,1304475
furpa,0.16666666666666666,40,35,GTCAAGGTAATTGGACAGAG,5,1309598
furpa,0.1111111111111111,38,35,GTATGCCGGTAAGTCCAGAG,3,1292150
furpa,0.3611111111111111,47,35,GGGTTCGTCCAATCTCGATC,12,1289765
furpa,0.4166666666666667,49,35,GGGGACAAAGATGTCTCAGA,14,1277952
furpa,0.19444444444444445,41,35,GGCCAGATGGTCATTCCAGA,6,1275579
furpa,4.527777777777778,197,35,GGCAGGTGGTTATACAAGAC,162,1344043
furpa,0.05555555555555555,36,35,GGATACGCGGCACAGTGCCG,1,1334406
furpa,2.0,106,35,GCTCCTACGCACTTGCCGAA,71,1305242
furpa,0.08333333333333333,37,35,GCCTTGCCAATAAGGGGAAA,2,1309106
furpa,1.2222222222222223,78,35,GCACGCTAACATTTAGGGAA,43,1290189
furpa,0.7777777777777778,62,35,GAGATAAGGTCATCATGCTA,27,1296293
furpa,0.8055555555555556,63,35,CGTGCACCGTAGGGAGGGAG,28,1292602
furpa,1.0555555555555556,72,35,CGTGATGACAAGCGCTAAAA,37,1290700
furpa,0.9444444444444444,68,35,CGCACCCGGCCTGGTCGTAC,33,1295985
furpa,0.7777777777777778,62,35,CGACGGTTTAGCAGGGACAG,27,1317281
furpa,1.1388888888888888,75,35,CGACCTAGTCCCCAGGGGTT,40,1301706
furpa,1.8611111111111112,101,35,CACCGGCTACTGCCCATAAA,66,1308209
furpa,0.1388888888888889,39,35,ATTAGACGGATACCAAATGG,4,1329606
furpa,0.25,43,35,ATTAAAGAACGACACGGTGT,8,1324675
furpa,1.2777777777777777,80,35,ATATGCTGACCCAGTTACCC,45,1301562
furpa,0.05555555555555555,36,35,AGGGGGCTGGTGGCATAGCT,1,1331832
furpa,1.8333333333333333,100,35,AGCCGAGAAGTTGGTTACGA,65,1315417
furpa,2.5277777777777777,125,35,ACTCATGCCGAGATGCACGG,90,1285902
furpa,0.6666666666666666,58,35,AATGGTATGTAAACAACGGA,23,1351521
furpa,0.6388888888888888,57,35,AATAGTTTCCCAGAGTGTTA,22,1322416
furpa,0.5428571428571428,52,34,TTGTGGGCCTGCGAGTGCAT,18,1315370
furpa,0.4857142857142857,50,34,TTCAGCGTGTTTGTTGTGCG,16,1317280
furpa,0.9142857142857143,65,34,TTAGCACAATGCCCTGGGAT,31,1354512
furpa,2.057142857142857,105,34,TGTTTCGTTATAGCTCCCCA,71,1284174
furpa,0.8285714285714286,62,34,TGCTCCCAACACGTCTCTCA,28,1293028
furpa,0.5428571428571428,52,34,TGCGATGGCAATTTATTGGT,18,1287245
furpa,4.8,201,34,TCTCCCCTATAGGCCCACAT,167,1271216
furpa,0.05714285714285714,35,34,TCCGGCTTCCGGAACAGGCT,1,1325543
furpa,1.0857142857142856,71,34,TCACCGGGCGTTGTCTTTGT,37,1285630
furpa,0.5428571428571428,52,34,GTGGGAGACGTGTGTTTTCA,18,1286638
furpa,1.9142857142857144,100,34,GTATTTGCGTCAATGATTGG,66,1311802
furpa,0.05714285714285714,35,34,GTAGCAGCATGCCCATCTCA,1,1278973
furpa,0.11428571428571428,37,34,GTAACAGCTTCGTCTCAGTA,3,1291759
furpa,0.4,47,34,GGTTGTCCCATGGGATTTTA,13,1279249
furpa,0.42857142857142855,48,34,GGGAGCCCCATGAAAAAAAT,14,1334234
furpa,1.0571428571428572,70,34,GCTGGCTTCACTCAAATTAT,36,1285635
furpa,0.7714285714285715,60,34,GCTCCTCCTGCAGCCTTGTA,26,1301915
furpa,0.05714285714285714,35,34,GCTACGCCGAAGTAAATGGG,1,1324771
furpa,0.08571428571428572,36,34,GCAGTTAAAGACCAGTCAAG,2,1286286
furpa,0.7142857142857143,58,34,CTGGACGAGAGAGTTAATGG,24,1321255
furpa,1.1714285714285715,74,34,CTGCGTCAATGAAGGGCACT,40,1318732
furpa,1.6285714285714286,90,34,CTGCCTTCACGGAAACCATG,56,1275871
furpa,0.05714285714285714,35,34,CTATGGTAGCAACCGTGTGT,1,1273675
furpa,0.4,47,34,CGTCCCACAACGTACAACGC,13,1294994
furpa,2.1142857142857143,107,34,CGAATGACTTGAGATCCTTA,73,1291555
furpa,1.6285714285714286,90,34,CCTGTGTACGAGTGTTCAAT,56,1321971
furpa,1.1142857142857143,72,34,CCAGTTCATCCTTTGCTTGC,38,1329155
furpa,1.0571428571428572,70,34,CAGATCTCATTAAAAGTCTT,36,1331622
furpa,1.0,68,34,CAATTTCAAAAGCGATTCGT,34,1332306
furpa,3.8857142857142857,169,34,CAAGGGGCGCCTCAGCGCGG,135,1331520
furpa,1.0571428571428572,70,34,CAACAGCACGCCCCTCATTA,36,1314207
furpa,2.3714285714285714,116,34,AGCTCTTATCCTCCCCGGAT,82,1348789
furpa,2.085714285714286,106,34,AGCAGGCCATCGCGAAAGAA,72,1278267
furpa,0.34285714285714286,45,34,ACTGGATGTGACAACCACTG,11,1304449
furpa,0.3142857142857143,44,34,ACGGTGATCTTCTGCGGAGA,10,1298813
furpa,0.42857142857142855,48,34,AAGTTTATATCTTAGGTTTT,14,1316949
furpa,0.3142857142857143,44,34,AAGGCTCAAGGCCGACACAA,10,1299288
furpa,1.2058823529411764,73,33,TTTCAACAGCTTGACGAAAG,40,1306078
furpa,6.411764705882353,250,33,TGTGGATCTCCTATGACTTC,217,1312683
furpa,2.235294117647059,108,33,TGGTCTCGGCTAAAAGGAAA,75,1294087
furpa,1.5588235294117647,85,33,TGATTGTGTTTGCCACTAGC,52,1302688
furpa,0.17647058823529413,38,33,TCCCTGCTAATCTTAATTAG,5,1283947
furpa,1.0294117647058822,67,33,TCATTTCCGTTTATGAATGA,34,1296290
furpa,0.058823529411764705,34,33,TCAGGCCTAGCTATTGCCAG,1,1284008
furpa,1.2058823529411764,73,33,TATTCAGGTTGATATCGGCG,40,1326650
furpa,1.411764705882353,80,33,TATACGGTATTGATATTACA,47,1339623
furpa,1.2352941176470589,74,33,TAGACAGGGCTTCTCTACAT,41,1299476
furpa,0.4117647058823529,46,33,TACATCCGCTGTTGTCCAAA,13,1304432
furpa,2.0,100,33,GTGACATGATTAACTCAATA,67,1320336
furpa,1.3529411764705883,78,33,GTCCTATGCCGTATTCGAAA,45,1313336
furpa,1.7352941176470589,91,33,GTACTCGCATAGGCCGTACA,58,1276225
furpa,0.35294117647058826,44,33,GGCTCGGGAGGCAGCAAGTA,11,1295619
furpa,0.11764705882352941,36,33,GGAGGGAAGACGATTCCGTA,3,1325289
furpa,0.7647058823529411,58,33,GCTTAGGACCACGCACCGTG,25,1334460
furpa,0.29411764705882354,42,33,GCTAAGAAGACGACCGAGAG,9,1327967
furpa,0.058823529411764705,34,33,GCATATCCCTCGCTCAGTTT,1,1337294
furpa,1.4411764705882353,81,33,GCAGGATTACAACGTAAATT,48,1289401
furpa,1.088235294117647,69,33,GCACTTATATGCTCTGCACA,36,1279280
furpa,0.5588235294117647,51,33,GAGATTTGTACTTCCAGAAC,18,1297918
furpa,0.5588235294117647,51,33,GACCGTCTCGGGGTAACACT,18,1299905
furpa,0.8235294117647058,60,33,GAAACAGCGTAGGCTAACAG,27,1308356
furpa,1.2941176470588236,76,33,CTCGCACGCTGGGTTACTAC,43,1305683
furpa,0.058823529411764705,34,33,CGGCTCCCCATGGCATCCCG,1,1354085
furpa,0.6470588235294118,54,33,CGGCCATATGAGTGTGTATG,21,1287930
furpa,1.8823529411764706,96,33,CGGACCTCGGTACATGGGAA,63,1279875
furpa,1.5294117647058822,84,33,CGCCTGTATGAGACATATAT,51,1345146
furpa,3.5,151,33,CCGGCACTGAATGTGAAAAA,118,1280142
furpa,0.7352941176470589,57,33,CCGAGGTTAGTGCACCTACA,24,1334292
furpa,0.47058823529411764,48,33,CCAAGCGGGGGTGGAGTATA,15,1280497
furpa,0.058823529411764705,34,33,CATTAGAAGCCGGATCCACA,1,1272225
furpa,11.588235294117647,426,33,CAGGCACAGCAGTTAGTCCA,393,1280512
furpa,2.8823529411764706,130,33,CAGCTCACTTTACTGACTCA,97,1278770
furpa,0.7352941176470589,57,33,CAGCATCAGTGTATATGTAG,24,1313097
furpa,0.058823529411764705,34,33,CACCATGAGCACAACTTTCG,1,1305687
furpa,0.058823529411764705,34,33,CAATTACTTGTAGAATGTAA,1,1284012
furpa,0.14705882352941177,37,33,ATGCTTGTGCACGAGTAGTG,4,1300775
furpa,1.1470588235294117,71,33,ATACGAGGCTTTAATCTGAC,38,1334245
furpa,0.5882352941176471,52,33,AGATGCCACCTTAAGCAAAG,19,1337381
furpa,6.411764705882353,250,33,ACAACCGTGTCCTGAAGTGC,217,1286030
furpa,0.8823529411764706,62,33,AATTGTTGTTAGGAGTTGCA,29,1328030
furpa,0.7878787878787878,57,32,TTTTTCGGCTCGGCCTGAGA,25,1298521
furpa,1.5151515151515151,81,32,TTCTAAGTGTTGGGATACGT,49,1276572
furpa,1.6363636363636365,85,32,TGGCGCTAGTCATTACATAC,53,1289013
furpa,3.121212121212121,134,32,TGCCCGGTGCGGTTCAGCTG,102,1335193
furpa,2.757575757575758,122,32,TGACATGGGCAGCCCTCACA,90,1353004
furpa,1.2121212121212122,71,32,TCGCCCAAATGAGCTCACCA,39,1329852
furpa,0.24242424242424243,39,32,TCGACGGTGAGTATTACTGT,7,1293433
furpa,0.7272727272727273,55,32,TCCGCGGGGACCCACCAAGA,23,1277480
furpa,0.3939393939393939,44,32,TCCACCCATCGTTAGGGTAT,12,1304498
furpa,0.5757575757575758,50,32,TCAAGAGTACCGGGCGCATT,18,1307437
furpa,0.9393939393939394,62,32,TCAACCCTTAGGCAAGCCTG,30,1316922
furpa,0.3939393939393939,44,32,TAGACAGTGAACCGGCCTGT,12,1295613
furpa,0.3939393939393939,44,32,TACGAGCCTATAGACCGCGA,12,1320599
furpa,1.4848484848484849,80,32,TAACGAATAGCTTCATACGG,48,1334039
furpa,2.0303030303030303,98,32,GTTCTGCTACTTCTCCTTGT,66,1277598
furpa,3.0606060606060606,132,32,GTTCGCCAGGAAACTCGGTG,100,1305817
furpa,0.09090909090909091,34,32,GGCACTTCGCTTTGTAAGAG,2,1342775
furpa,3.757575757575758,155,32,GCTTATTAAAGGCCTTATAG,123,1283196
furpa,0.6363636363636364,52,32,GCGGGTTCGATGGGACGACA,20,1315864
furpa,1.2727272727272727,73,32,GCCCGACCACTTTAGGTCCA,41,1274924
furpa,0.06060606060606061,33,32,GATTCATTATTGTTTCTTTC,1,1288863
furpa,0.6666666666666666,53,32,GAAGGACTTCCCGGCTGAGT,21,1353174
furpa,0.30303030303030304,41,32,CTCGTAGGCTAGCAGATTCT,9,1339741
furpa,2.0606060606060606,99,32,CGGGGATCAATTGCTGCAAC,67,1324238
furpa,1.3636363636363635,76,32,CGGACGCCACAGCAGGGGAC,44,1308867
furpa,0.7878787878787878,57,32,CGATCAATTCTCAGTTATGT,25,1280025
furpa,0.06060606060606061,33,32,CGAATGGGGCTTCTCGGCAT,1,1280830
furpa,0.18181818181818182,37,32,CGAAGTCGGCGAGCTCCATG,5,1312423
furpa,0.12121212121212122,35,32,CCTTCTGGTGATCCAATGCA,3,1344659
furpa,0.42424242424242425,45,32,CCTGGCGAGAACCAGTTGCA,13,1334235
furpa,8.030303030303031,296,32,CAGTAATTACTGTCTGCAAG,264,1345310
furpa,0.7575757575757576,56,32,CAGCCGTACCCTATCAGCTT,24,1287150
furpa,2.9696969696969697,129,32,CACAACAGGTTCATGCCCAT,97,1299961
furpa,1.9696969696969697,96,32,ATTACGCCTGTGTAATACTC,64,1276527
furpa,1.121212121212121,68,32,ATATCGCCGAGTGGATAATG,36,1313164
furpa,2.212121212121212,104,32,ATACTGAACCTTGCTTAAGT,72,1292906
furpa,1.1515151515151516,69,32,AGTCGTTCCCGTCAACCTAC,37,1285199
furpa,0.06060606060606061,33,32,AGGACGCTTCCAGCTCTTAG,1,1326387
furpa,2.8484848484848486,125,32,AGCCTTGATTCGATTTAATT,93,1355969
furpa,0.06060606060606061,33,32,AGCCCAAGTCCGTTAAAGTG,1,1320048
furpa,0.3939393939393939,44,32,AGAGATCTGCTTCGTATACG,12,1353916
furpa,0.06060606060606061,33,32,AGAATAATTTGCTGTCCGTT,1,1282021
furpa,0.7575757575757576,56,32,ACCGATTATCCTCAATGATG,24,1346436
furpa,0.6666666666666666,53,32,AATTCGACCTGTTAGGGGGG,21,1330005
furpa,0.12121212121212122,35,32,AAGGTGAACGATTCAAAATT,3,1274494
furpa,1.0303030303030303,65,32,AACCTTTCCCCGCCACCTTC,33,1306221
furpa,0.696969696969697,54,32,AACCTAATGCACCATAGACG,22,1274131
furpa,0.71875,53,31,TTTGTTGGGTAGTACCCAAT,22,1321050
furpa,0.5,46,31,TTGTCTGGGTTGGCGGGGTT,15,1292593
furpa,4.0,158,31,TTGCTGTGGCGTTACACACT,127,1295938
furpa,0.1875,36,31,TGTATTGACCAAAGCCACAG,5,1337293
furpa,0.25,38,31,TGCAGCGCTACCTTCCTCAA,7,1275916
furpa,1.34375,73,31,TGAAGGGCATGACACGCTCT,42,1348892
furpa,0.90625,59,31,TCTGTAGTCCAGACGTTAAT,28,1355664
furpa,8.71875,309,31,TCTACGTCGAGTCCCGCAGC,278,1311548
furpa,0.71875,53,31,TCGTGTAATCGGGGTTAATG,22,1354763
furpa,0.65625,51,31,TCGTCATGTGGTTCGGCCTA,20,1286816
furpa,0.0625,32,31,TCGGAACCAACCTGATAAGT,1,1291403
furpa,3.5,142,31,TCCTCATCCACTCGCGCTCT,111,1343403
furpa,0.34375,41,31,TCCACCTTGTATCCATCCAA,10,1315183
furpa,1.5,78,31,TAGGTCGGATCACTCGTGTA,47,1276917
furpa,1.34375,73,31,TACAAAAAACCACCACTACA,42,1320278
furpa,1.3125,72,31,TAATCTTCGATTCACCCTCG,41,1281092
furpa,8.25,294,31,TAAGTATGTGACATCGCAAG,263,1279440
furpa,0.5,46,31,GTGTTTCAAATGGTTGCTGA,15,1310698
furpa,0.5625,48,31,GTGTCTGGCAAACAGGGCGA,17,1293485
furpa,2.96875,125,31,GGTTCGACTTCGCGGGTACA,94,1320129
furpa,0.0625,32,31,GCACAAAAGAAACTTAAGTC,1,1340070
furpa,2.375,106,31,GCAAGGATGAACCTTAAAGG,75,1284519
furpa,1.46875,77,31,GCAACCTAGCCGGTAGAGAG,46,1349223
furpa,0.34375,41,31,GATGAGAACGAATCCTACCT,10,1276226
furpa,2.65625,115,31,GAACAAAGGTTGTTCTTGCT,84,1274398
furpa,0.25,38,31,CTTTTTGTGTTATTCACCAG,7,1349789
furpa,0.375,42,31,CTTATTGCGACTCCAGACCA,11,1347623
furpa,0.96875,61,31,CTGGGCACAAGGCTCATCGG,30,1305698
furpa,0.53125,47,31,CTCAAAACTGTCACAAGCAT,16,1282929
furpa,0.0625,32,31,CTAACTCAGGCCTACAAGCT,1,1344347
furpa,0.28125,39,31,CGCCGCGAGATACTAAAGTA,8,1279357
furpa,0.5625,48,31,CGACGGAAACTGTGACTTAT,17,1354288
furpa,0.5625,48,31,CCTTAGCCTCCCATAGCAAA,17,1323531
furpa,5.625,210,31,CCCGGTTAGGACTTTCCCCA,179,1309987
furpa,2.65625,115,31,CCCCCGCTGACTTGTGCGGA,84,1340821
furpa,1.125,66,31,CCACTATTCATTTCCATAGA,35,1277186
furpa,1.09375,65,31,CCACCTCGATGTCACAGAAA,34,1279026
furpa,0.5625,48,31,CAGGGAGGCGTTATATTCTG,17,1319181
furpa,1.4375,76,31,CAATCGGACTTTATTTCGCT,45,1292024
furpa,0.21875,37,31,CAACTAGGATTCCGTGCGAA,6,1344493
furpa,0.8125,56,31,ATTCGGGACTGTCAGACCAT,25,1341362
furpa,0.0625,32,31,ATGGGCTTCCATTTGGGCCA,1,1326699
furpa,0.78125,55,31,ATGCGAGCACCTATACAATA,24,1319770
furpa,0.71875,53,31,ATGAGCGCGGTGAATCGAGT,22,1316939
furpa,0.71875,53,31,ATATGGTACATCCGTCAATA,22,1291879
furpa,0.375,42,31,ATACTCCTCCAACTAGACAC,11,1272812
furpa,0.3125,40,31,ATAAGGCTCAAAAAATTCCA,9,1312985
furpa,0.1875,36,31,AGAGTTGCAGGTCAAGCCTT,5,1347367
furpa,0.59375,49,31,AGAGGCTATTAAGGCGGTAT,18,1333871
furpa,0.5625,48,31,AGACTCAGATGGGCACGCCC,17,1279523
furpa,1.6875,84,31,ACTCGGTAAGTGCCCCAAGT,53,1355352
furpa,1.78125,87,31,ACTAGGATGGCAGTTGGCAT,56,1341824
furpa,1.15625,67,31,ACGGCTCCTAAGCGCTTGAT,36,1283061
furpa,2.15625,99,31,AAGTCGCAGCGGGGCTCGAG,68,1353968
furpa,1.0,62,31,AACTATTAGCGTCTGGGTGG,31,1350472
furpa,0.59375,49,31,AACGGGTTCCCAGGCTAAGA,18,1296224
furpa,2.9375,124,31,AACGCATCGTTCATAAAATG,93,1334335
furpa,0.40625,43,31,AAAGTCTTGTTAGTATGTTA,12,1310743
furpa,0.53125,47,31,AAAGAGGACAAGCGGGCAAT,16,1345881
furpa,0.875,58,31,AAAAATAGCGTGAGCCGGGA,27,1311808
furpa,0.6774193548387096,50,30,TTTGATCCCTAGCCTGGTTT,20,1272969
furpa,0.06451612903225806,31,30,TTTAAGGGAGGGCACGAAGA,1,1278029
furpa,1.064516129032258,62,30,TTGACGTTTTACCGTGACAC,32,1326106
furpa,0.12903225806451613,33,30,TTCGCAAATTATATAATTAA,3,1345999
furpa,6.806451612903226,240,30,TGTCATCCCAGTAGGCAGCA,210,1271323
furpa,1.3548387096774193,71,30,TGCCGATGTGACGGGTATAC,41,1350674
furpa,0.5161290322580645,45,30,TCTCGACGCCTTGAATGTTT,15,1282444
furpa,4.354838709677419,164,30,TATCGGCTGTATGATTAGCT,134,1292670
furpa,1.2258064516129032,67,30,TATAGGACGACGCCGCAAGT,37,1305209
furpa,0.16129032258064516,34,30,TAACCAATATGCTTCACAGT,4,1311018
furpa,1.903225806451613,88,30,TAAACACGCGGTATGAAAGC,58,1337490
furpa,0.6774193548387096,50,30,GTTGCATCTCTCCTGTGTAC,20,1291074
furpa,0.41935483870967744,42,30,GTTAGCAAACCAGGACTTTA,12,1277331
furpa,0.06451612903225806,31,30,GTCGCGGGCTCACACACGAC,1,1318260
furpa,1.2580645161290323,68,30,GTATGACCTAGACTTGTATT,38,1325439
furpa,0.06451612903225806,31,30,GGGTAGAATAAATTGACGTA,1,1339404
furpa,0.3548387096774194,40,30,GGGCCACTTTCCTGTGCCTC,10,1350011
furpa,0.7096774193548387,51,30,GGAAGTGCGAAAGCACAACT,21,1322204
furpa,0.3225806451612903,39,30,GCGGGTCGTGCGGTACGGGT,9,1275444
furpa,0.12903225806451613,33,30,GCGCTGATTGTTGGCTCTGG,3,1329707
furpa,0.7741935483870968,53,30,GCGCGTCGACTTAAGTTCAC,23,1319905
furpa,0.9032258064516129,57,30,GAGTCCGTGTCCGGCATGGT,27,1343404
furpa,0.9354838709677419,58,30,GAGGTGTGGCGACATATGTC,28,1276613
furpa,0.5483870967741935,46,30,GAGATGTAGCAAATGCACCG,16,1280440
furpa,0.1935483870967742,35,30,GAGAGCGGCGGATGGTGCAA,5,1327266
furpa,0.06451612903225806,31,30,GACCGTTAGCGGGTTGGAAG,1,1337501
furpa,0.12903225806451613,33,30,GAACTCGTCAGCTGTAGGAA,3,1295612
furpa,0.12903225806451613,33,30,GAAATATCCGGAGGGCTATT,3,1295852
furpa,0.0967741935483871,32,30,CTTAGCGAGGGACTGTGCAT,2,1325378
furpa,0.0967741935483871,32,30,CTGTACGTCGTGCGCGGTAT,2,1285458
furpa,1.096774193548387,63,30,CTAGCATCTTCGGCTCTCGC,33,1280008
furpa,1.1935483870967742,66,30,CGTCGGTCCATGTACATACA,36,1298326
furpa,0.3548387096774194,40,30,CGTAAACCCTGCGTGTTACA,10,1299902
furpa,1.967741935483871,90,30,CGCTTCAGATCCTGGTGCGG,60,1306406
furpa,0.8064516129032258,54,30,CGCGGGCGCAGCCGTAGATA,24,1286467
furpa,0.3548387096774194,40,30,CGATACTTGGACTCAAGGGG,10,1298922
furpa,5.096774193548387,187,30,CCATGTTGATAATATTTCCA,157,1281885
furpa,0.45161290322580644,43,30,CCATCGTTTAACCGTACAAC,13,1340963
furpa,0.16129032258064516,34,30,CATCGGGGGGCCTGGGGCCA,4,1283377
furpa,0.0967741935483871,32,30,CATCGCCCCGGGCGGTTCTC,2,1341187
furpa,0.1935483870967742,35,30,ATCGAGTCTTGGTGTACGGT,5,1311694
furpa,2.4516129032258065,105,30,ATCAGACTAGCTTGATCTAA,75,1318957
furpa,0.25806451612903225,37,30,ATATCGGCTCTAGGTCTATA,7,1339689
furpa,0.6129032258064516,48,30,ATATATGCAGCCCCGTGAGA,18,1329008
furpa,0.7419354838709677,52,30,ATACTCGCCACGAAACATCT,22,1350050
furpa,0.3225806451612903,39,30,ATAAAGTAGGCACTCAGCTC,9,1339621
furpa,0.45161290322580644,43,30,AGTGATCCTAGCCTAGTTAA,13,1303857
furpa,0.7741935483870968,53,30,AGACTGGCAGCCACTACCAT,23,1334454
furpa,0.22580645161290322,36,30,AGAACACTACGACCCCCGCC,6,1305685
furpa,0.8064516129032258,54,30,ACTGTAAATTAGGGGTACAA,24,1288100
furpa,0.06451612903225806,31,30,ACTGGTGAGTCGTGACTCCC,1,1322027
furpa,2.225806451612903,98,30,ACTCCTGGTCGAGAGCGCAT,68,1313534
furpa,0.45161290322580644,43,30,ACGGTACATCGCCTCCCGAT,13,1351568
furpa,0.0967741935483871,32,30,ACCGGGTCCAACATGGCATG,2,1346901
furpa,0.06451612903225806,31,30,ACCGCCTGCGTACGGGATAA,1,1281235
furpa,0.3870967741935484,41,30,ACATGAGGTAACGGGGTCGG,11,1293578
furpa,0.6774193548387096,50,30,AATTAATTAGGTAAGAGGCA,20,1315571
furpa,0.7096774193548387,51,30,AAAATGACTTGGAATTTTTA,21,1310747
furpa,2.3666666666666667,99,29,TTTCTTTGGATTGAACTCGT,70,1322246
furpa,0.23333333333333334,35,29,TTTCCGTGATAAATGTTAGT,6,1285232
furpa,2.933333333333333,116,29,TTCTCTTAACACCAAGTATA,87,1306685
furpa,0.8666666666666667,54,29,TTCAAGAAAGCCACATATTC,25,1343286
furpa,1.8666666666666667,84,29,TTACTCTCAGAGCTACTACA,55,1338846
furpa,0.7666666666666667,51,29,TTAAGGGTCCCACTGTCGGG,22,1293434
furpa,0.9,55,29,TGAAGACACTGAACTTGTGT,26,1303505
furpa,2.6,106,29,TCTTATTGCCTGTTAATTGT,77,1281053
furpa,1.1333333333333333,62,29,TCTGGTACAGTTGAACTCGG,33,1299903
furpa,1.3666666666666667,69,29,TCCCAAGCGTCCCGTACAGC,40,1356061
furpa,0.26666666666666666,36,29,TCCACATACAAATATCCGTG,7,1354690
furpa,0.6333333333333333,47,29,TCATACATACACATGTTGCA,18,1312980
furpa,0.23333333333333334,35,29,TAGCTTGAATCCTGGCACTA,6,1333018
furpa,1.6333333333333333,77,29,TAGCATTTTTAAGGGTTCTG,48,1285464
furpa,0.8333333333333334,53,29,GTTAAAGATTATTTAGCGTT,24,1271924
furpa,0.5333333333333333,44,29,GTGTCAAGGCTCCTTCACCA,15,1271967
furpa,1.1333333333333333,62,29,GTCCATGCGGGGGAACCGGC,33,1307478
furpa,1.5666666666666667,75,29,GTCACATACCTATGTTCTGT,46,1299222
furpa,2.933333333333333,116,29,GGTGAAGAGTTTCTCATGGA,87,1275932
furpa,0.3,37,29,GGGTTGTGCGCGATATATTC,8,1293836
furpa,0.1,31,29,GGCATTGATAACGAGCATTT,2,1315664
furpa,1.4333333333333333,71,29,GGAATCATACGCGGCGGTAA,42,1318567
furpa,1.0333333333333334,59,29,GCTTTGGAATCACGGGGCTA,30,1271787
furpa,0.5,43,29,GCTGCCTCTGATCCTGATGG,14,1330082
furpa,1.0,58,29,GCTGACCGGAGTTGGGCACT,29,1287935
furpa,1.0,58,29,GCCTTTACGATCCGCATAAT,29,1293397
furpa,0.06666666666666667,30,29,GCCCGATTGTCTTGTGACAT,1,1277265
furpa,0.2,34,29,GCACGATGGTCCCTATAGGA,5,1279307
furpa,10.366666666666667,339,29,GCAAGAGCGAGTTAGGCATC,310,1291558
furpa,0.23333333333333334,35,29,GATGAGTGGACGGAACACAA,6,1283320
furpa,2.3666666666666667,99,29,GAGTAAAGCTGCGGAATGTA,70,1280141
furpa,2.4,100,29,CTTGAAACCGGCCTGCGACT,71,1315364
furpa,2.1666666666666665,93,29,CTTAAGCTGAAGCCGAAGTA,64,1291029
furpa,1.5666666666666667,75,29,CTGTAGGAACCGGACTAATT,46,1352288
furpa,0.8666666666666667,54,29,CTCACACCCCATCCGCGTAG,25,1318388
furpa,0.06666666666666667,30,29,CTATCGGTAGAATAGTTCTG,1,1329250
furpa,1.5333333333333334,74,29,CTACCACACTCCTGGGTCCG,45,1333105
furpa,0.5,43,29,CGTTCGTAGGGGTCGTCGGT,14,1347589
furpa,0.26666666666666666,36,29,CGGCGGAAACATGCTTAAGA,7,1319332
furpa,1.9333333333333333,86,29,CGGAGGCATGGGATTTCCTA,57,1340614
furpa,0.9333333333333333,56,29,CGCCTCACAATAAGACCGCG,27,1285460
furpa,0.13333333333333333,32,29,CCGGGCATTGGGAATGATAG,3,1275789
furpa,2.5,103,29,CCGACGGTGTTTAGTGGATG,74,1273712
furpa,1.5,73,29,CATTGGTCGTGTTAACGTGT,44,1350955
furpa,1.5666666666666667,75,29,CATGTAACAATGATTTTAGC,46,1296283
furpa,1.0666666666666667,60,29,CAGTTGTCAGCACTCCGTGT,31,1280829
furpa,0.9333333333333333,56,29,CACTCGCATCACGGCGGCGA,27,1347871
furpa,0.06666666666666667,30,29,CACTCCCCTTCTGGGGAACT,1,1315033
furpa,0.6333333333333333,47,29,CAATACATACTACAGTGTGC,18,1341047
furpa,0.06666666666666667,30,29,CAAGCGGACCCATCGAATCT,1,1287984
furpa,0.13333333333333333,32,29,ATGCTGCGAGAGCGCCATGA,3,1310590
furpa,0.7,49,29,ATGAAGGGGCGTAACGTCCT,20,1349840
furpa,0.2,34,29,AGTAGAGAATTGCGCAACCT,5,1348782
furpa,0.06666666666666667,30,29,AGGTTAGCGGGCGAGCGCCT,1,1338595
furpa,4.7,169,29,AGGGATATTGGGGTTCCTCG,140,1295445
furpa,0.13333333333333333,32,29,AGGCGAGGCTCGAATGAATT,3,1303118
furpa,1.2,64,29,AGCTCGCCTGGAACGGACAA,35,1348379
furpa,1.3333333333333333,68,29,AGCGGTGCATGCAAAAAGGT,39,1317161
furpa,0.5666666666666667,45,29,AGCGGTAAAGGCAGAGACTT,16,1280697
furpa,0.06666666666666667,30,29,AGCCTAGAAAACTTCCTAAC,1,1286203
furpa,1.3,67,29,AGCCTAATAATTTGAGTCAG,38,1318352
furpa,1.3,67,29,ACTTTCCACCGCTTTACGGC,38,1334038
furpa,0.5,43,29,ACTTAGGTTCCTCGTTGTAG,14,1348768
furpa,0.6333333333333333,47,29,ACCACAGCCGTGGCTGCGTG,18,1336199
furpa,0.8,52,29,AATTTTAAACACGCGTATGC,23,1297952
furpa,0.9333333333333333,56,29,AACCGCCGGCGATAGGGCAC,27,1292916
furpa,0.1724137931034483,32,28,TTTTCACGGAAGCATCGAGA,4,1286295
furpa,1.1379310344827587,60,28,TTTCATTGCTTGGTTTCTGT,32,1327028
furpa,0.27586206896551724,35,28,TTGGGGAAGACTTCTGTCTT,7,1318184
furpa,0.06896551724137931,29,28,TTGCACTGTATTGAGCGAGA,1,1291874
furpa,0.5517241379310345,43,28,TTCGGACATATAACCGACGC,15,1342941
furpa,2.6206896551724137,103,28,TGGTCACATGTTCCACTACT,75,1347479
furpa,2.8275862068965516,109,28,TGATAGTATCTGATCTGCCT,81,1340692
furpa,1.1724137931034482,61,28,TGAGTAGCTGCATGTGTCTC,33,1276970
furpa,0.10344827586206896,30,28,TCTTTAAGTTCCGGAACTTA,2,1285908
furpa,3.2758620689655173,122,28,TCTGTCGGTCGATCTCGGCT,94,1341363
furpa,2.1379310344827585,89,28,TCGATCTTGTGCTTACAGGC,61,1276354
furpa,0.06896551724137931,29,28,TCGAATCCGAGATCTAAACC,1,1280261
furpa,0.6206896551724138,45,28,TCACATAAGTTTGGTTACCG,17,1307120
furpa,0.10344827586206896,30,28,TAGCGGCTCGTTAAGCGCCA,2,1276997
furpa,4.103448275862069,146,28,TACTCAACAATACACGCCCT,118,1303700
furpa,0.13793103448275862,31,28,TAATGAGAATTGTAAGACTA,3,1330111
furpa,0.896551724137931,53,28,TAACTCGTCGATGGGCCGAA,25,1293215
furpa,0.5517241379310345,43,28,GTTTCGCCAGGCATAACCGG,15,1313802
furpa,4.0344827586206895,144,28,GTGCTCCTCTGTTAAACGCT,116,1325844
furpa,0.7931034482758621,50,28,GGTTGTTCGTATCTTTGGAA,22,1285911
furpa,0.06896551724137931,29,28,GGTCAAGATGCCTGCCTTAC,1,1305078
furpa,0.13793103448275862,31,28,GGCTGGAAAAGTATTTATCT,3,1324443
furpa,1.2758620689655173,64,28,GGCCGACGCAAATCATAACG,36,1275856
furpa,0.06896551724137931,29,28,GGAGGTTGGCACCGTAACAC,1,1346594
furpa,1.3793103448275863,67,28,GGACGTGAGCTGGTAGAATT,39,1276222
furpa,1.793103448275862,79,28,GCTATTTACGAAATCCGAGT,51,1311023
furpa,0.3793103448275862,38,28,GCGTTTAACGAACCCGCAGA,10,1289151
furpa,0.3103448275862069,36,28,GCATTTCGACCTCTGTGCGA,8,1279653
furpa,0.27586206896551724,35,28,GCACTATATGCATGACGGTT,7,1282436
furpa,3.103448275862069,117,28,GAGCACAGTTCTCTTCAAGT,89,1308784
furpa,0.3448275862068966,37,28,GACCCAGTCAGCAGCTTGAA,9,1303614
furpa,0.06896551724137931,29,28,CTGTATGTACAATATGTTCC,1,1276640
furpa,4.275862068965517,151,28,CTGATCACAGTCCGTCACTC,123,1333665
furpa,2.206896551724138,91,28,CTCCACCTCTCGTGTAGGAT,63,1348670
furpa,0.6551724137931034,46,28,CTCAGAATTGTACCGTATCT,18,1296853
furpa,0.10344827586206896,30,28,CGTGAATATGGCGCGGCGCC,2,1317022
furpa,1.793103448275862,79,28,CGTCACTGAACGCTGTCGTT,51,1330902
furpa,1.206896551724138,62,28,CGTAATTTGGTGCACTAGAT,34,1351250
furpa,1.4137931034482758,68,28,CGGAGCGTATCGAGGGACGA,40,1308114
furpa,1.6551724137931034,75,28,CCTTCAAGGTGCCTGCGTCG,47,1295448
furpa,0.5862068965517241,44,28,CCGGTGGGGACTACAAGAGG,16,1287094
furpa,0.9310344827586207,54,28,CCCGATTAATGTAGAGTAGT,26,1330336
furpa,0.3448275862068966,37,28,CCAACAGAGCCACATGTGGA,9,1285230
furpa,0.8620689655172413,52,28,ATTTGGTTGGATTTAGGATT,24,1314058
furpa,1.6896551724137931,76,28,ATGCGTGGTGTTATATCTAG,48,1299285
furpa,1.5862068965517242,73,28,ATGATCATCTACTCAGCTGG,45,1302321
furpa,2.2758620689655173,93,28,ATATAATCAGCACGGAGCCC,65,1300108
furpa,0.20689655172413793,33,28,ATAGTTTGCAGGTCTCTAAA,5,1313090
furpa,0.6206896551724138,45,28,AGTGTCTTCAATTCTTTCGT,17,1317414
furpa,1.8275862068965518,80,28,AGTGGTACCGCATAGGGGCA,52,1296412
furpa,0.896551724137931,53,28,AGTATTACCCGACGAACCCT,25,1277258
furpa,0.13793103448275862,31,28,AGGTCGGACACCGGGCTCTC,3,1353298
furpa,2.7241379310344827,106,28,AGGTACGGGCCTATTGCCTG,78,1311083
furpa,0.06896551724137931,29,28,AGGAGGAGGCTCGAAGCTAG,1,1307168
furpa,0.6896551724137931,47,28,AGAGGATTAAGCTGTTGTTA,19,1273907
furpa,0.8620689655172413,52,28,ACTTACAGCCGAGTCATATC,24,1342383
furpa,1.1724137931034482,61,28,ACCGGGTTCTACTTTTCGAA,33,1354766
furpa,1.4827586206896552,70,28,AAGTTTGCAGGAGGTCACGA,42,1284877
furpa,1.3448275862068966,66,28,AAGGGAAGCGTCGGGACCAC,38,1275350
furpa,2.8620689655172415,110,28,AAGGATGGGGGAATTTTAAG,82,1319629
furpa,0.5517241379310345,43,28,AAGCTCTCGGATTCACACTG,15,1292790
furpa,3.4827586206896552,128,28,AACGGTGTGACAGACAATTT,100,1292046
furpa,0.6896551724137931,47,28,AAACGCTGTCATCCGCGGAA,19,1314204
furpa,1.5517241379310345,72,28,AAACATGGCCAGCACAGGTA,44,1335134
furpa,0.35714285714285715,36,27,TTGTCATAGATGAATAGGTA,9,1341408
furpa,0.7142857142857143,46,27,TTGCGCTATTAATGCATCCG,19,1325528
furpa,0.07142857142857142,28,27,TTATGCTTTGCTGATGCGGA,1,1291729
furpa,1.8214285714285714,77,27,TGTGGATTATTGACACTTGC,50,1302686
furpa,0.07142857142857142,28,27,TGGTAAGTCGGCTCAATACT,1,1318918
furpa,0.4642857142857143,39,27,TGCCTGACGGAGGCCAGCTT,12,1323814
furpa,1.2857142857142858,62,27,TGCCAGTCATGCGGGCTGTG,35,1293978
furpa,0.07142857142857142,28,27,TGCAGAGTCAGCTTGTCCGT,1,1308846
furpa,1.1428571428571428,58,27,TGAAGATCTCAAGTGATATT,31,1296739
furpa,2.2857142857142856,90,27,TCGCCAATGAGTCAGACTGA,63,1331915
furpa,0.75,47,27,TCCGTATGTCTTGACGGATT,20,1291470
furpa,1.0714285714285714,56,27,TCCCGGGGGCTTCTAGATAA,29,1348603
furpa,0.7857142857142857,48,27,TCCCGACTAGAGAGACCAAG,21,1319825
furpa,8.607142857142858,267,27,TACTTCCGCACACCGGTTCT,240,1348036
furpa,1.0714285714285714,56,27,TACCCTCCCAAACGCAATAG,29,1299529
furpa,0.17857142857142858,31,27,TAAAATCCTTGACGGTCACT,4,1328641
furpa,1.5357142857142858,69,27,GTTTTCCGACCTACTGGTGA,42,1287393
furpa,0.7857142857142857,48,27,GTTCCTTCGATGCAGCGTAT,21,1298374
furpa,1.3571428571428572,64,27,GTTAAGGGCTGTCTTCATTC,37,1330385
furpa,0.35714285714285715,36,27,GTGTTTCTGTCTGAAGTGCT,9,1312139
furpa,0.7857142857142857,48,27,GTGCAGTGGTTTGCGCTTAC,21,1345790
furpa,1.1071428571428572,57,27,GTCGTTGGCGGGGCGGCAAA,30,1271541
furpa,0.25,33,27,GTCGAGACTTGCTTAGCGCC,6,1290172
furpa,0.6428571428571429,44,27,GGCGGAATGTGGACCACGGT,17,1335598
furpa,0.42857142857142855,38,27,GCTGGCGTCGGAGAATACGC,11,1296004
furpa,0.07142857142857142,28,27,GCTAGGGCTCGGCCTGAAGG,1,1272145
furpa,0.07142857142857142,28,27,GCGGATTTTCAGTTATCTGC,1,1309468
furpa,0.10714285714285714,29,27,GCCGCCAGACCGTTGACGGG,2,1324373
furpa,0.7857142857142857,48,27,GCCAGCGGCTAGGCCAATCA,21,1333654
furpa,1.5,68,27,GCATCATGCGAGGTCACTTC,41,1334399
furpa,0.21428571428571427,32,27,GAGAGGATCTCCAAACAGGA,5,1314233
furpa,1.0714285714285714,56,27,GACGCACGTCAAACTTCATC,29,1312624
furpa,5.928571428571429,192,27,GACCCTGCCACCTGATGCCC,165,1353135
furpa,1.75,75,27,GAATCCATGATGGGCAATTT,48,1280970
furpa,0.8214285714285714,49,27,CTTTGGGACTCATCATCGAT,22,1292590
furpa,1.2142857142857142,60,27,CTTGCTCTATGGGGAGTCGC,33,1327214
furpa,5.0,166,27,CTTCAAACAGTCAACGTACT,139,1326421
furpa,1.0357142857142858,55,27,CTGTGTGACCAGCAGCCTTA,28,1320232
furpa,9.428571428571429,290,27,CTCCCGCGAGCACCATGTGA,263,1277294
furpa,0.25,33,27,CTCCATCGTCAGCGCATAGT,6,1295049
furpa,0.10714285714285714,29,27,CTATAGTCCGTGCCCACCAA,2,1292210
furpa,0.07142857142857142,28,27,CTAATTTGTAATTGGGACTT,1,1313768
furpa,0.07142857142857142,28,27,CTAAACCCGCCGCAAGGAAC,1,1357439
furpa,0.07142857142857142,28,27,CGGTGAACGAAAATGCTTTC,1,1349534
furpa,1.1071428571428572,57,27,CGGTAGCGCGTATTACCATT,30,1336558
furpa,2.0,82,27,CGGAGCTAACTCTTTCAGAC,55,1288102
furpa,0.6428571428571429,44,27,CGCCATACCTCTTCCTGCCC,17,1303979
furpa,1.8928571428571428,79,27,CGCCACTGCAGGTCAGGGCA,52,1324187
furpa,0.39285714285714285,37,27,CGCATCGGTCGATTCCATGC,10,1277061
furpa,0.8571428571428571,50,27,CCTGCGCCGGCCCAAACCTT,23,1319027
furpa,0.07142857142857142,28,27,CCGTTTTGGGATAAAATACG,1,1299122
furpa,0.07142857142857142,28,27,CCGCATCATTACCGAAGTGT,1,1317637
furpa,0.07142857142857142,28,27,CCCCGTCACCACTGTCTCAC,1,1300580
furpa,0.35714285714285715,36,27,CCATGGACCAAATATGCCTA,9,1282753
furpa,3.3214285714285716,119,27,CCATAGCTCAGACCATCATT,92,1314752
furpa,1.0714285714285714,56,27,CCAAGAAGAGTGGAGTATCA,29,1336268
furpa,0.35714285714285715,36,27,CAGATTCAGCTAGACATGTA,9,1323725
furpa,1.9285714285714286,80,27,CACGGCAGTAGTTGAGCGTC,53,1293946
furpa,0.4642857142857143,39,27,ATTGGTGGCGTCGATGGATG,12,1308310
furpa,0.07142857142857142,28,27,ATTAGGGCGCAGCCCGGCTA,1,1298477
furpa,0.07142857142857142,28,27,ATGGTTAGGACATGGTATTC,1,1301484
furpa,0.75,47,27,ATATTCTTCGAGTTTAAGCA,20,1347779
furpa,2.5714285714285716,98,27,AGGGCCGAGCTTAGCATTAG,71,1315852
furpa,2.107142857142857,85,27,AGGCGCACGCAAGGCAGCCA,58,1351846
furpa,1.6785714285714286,73,27,AGCGCCGTCCCTATTGTTGG,46,1272317
furpa,0.10714285714285714,29,27,AGCAGCCCAGGACATAATGG,2,1278168
furpa,1.2142857142857142,60,27,AGCAGACGCGTAAGACCATA,33,1282457
furpa,1.4642857142857142,67,27,ACTTGTCGTCAGTGGCTGCC,40,1279809
furpa,0.25,33,27,ACGTAACAGAGCTATCAAAG,6,1331654
furpa,0.9285714285714286,52,27,ACGAGAAAATCTCGGTTTTA,25,1275590
furpa,0.7142857142857143,46,27,ACAATGTATCACAGACCTAC,19,1272164
furpa,0.7142857142857143,46,27,AATATAAATCTCACTGTGGC,19,1289397
furpa,3.1785714285714284,115,27,AACGCAGTATATCACGCCGA,88,1284943
furpa,2.185185185185185,84,26,TTTGCCCCATTGTATCGGTT,58,1301563
furpa,0.7037037037037037,44,26,TTGGTTCGTGCAACAAGCCA,18,1308916
furpa,1.2962962962962963,60,26,TTCGGGGAAGTGTCAACTTT,34,1321334
furpa,8.814814814814815,263,26,TGTGAAGAAGGACCGTCACA,237,1290106
furpa,1.9259259259259258,77,26,TGTATTAGTCTTCCTCGTTA,51,1333971
furpa,1.5925925925925926,68,26,TGTAGATATGCGGGGCCGCA,42,1288202
furpa,2.3703703703703702,89,26,TGGCTTCATGCCGTTTCCGA,63,1278216
furpa,1.0,52,26,TGCCATGTATCCCGTCTTTA,26,1292002
furpa,2.2222222222222223,85,26,TCTAACTGTGGACTAAGCAT,59,1357113
furpa,0.07407407407407407,27,26,TCGGCTTCTATCACGGACCA,1,1296416
furpa,0.8888888888888888,49,26,TCATCAACTGCATGGGTCAA,23,1316128
furpa,0.9259259259259259,50,26,TCAAGGATGCCACCCGCTTC,24,1308307
furpa,1.6296296296296295,69,26,TCAAAATGATATGAGTAACA,43,1292714
furpa,0.8148148148148148,47,26,TATTTAAGGTGGCTTTTGCA,21,1276749
furpa,0.07407407407407407,27,26,TATATGTTTGAGAAAGGGCA,1,1352213
furpa,1.7037037037037037,71,26,TATATGACCCCTCCGAACGA,45,1275710
furpa,0.07407407407407407,27,26,TAGGCGCGATGTGCAATCCT,1,1286996
furpa,0.07407407407407407,27,26,TACTTCTCGAAGCTAGGTAA,1,1321187
furpa,1.0740740740740742,54,26,TAATTGTTTCAATTTTACTT,28,1291934
furpa,0.2222222222222222,31,26,TAATGGGGTCTCACGGCTGG,5,1317097
furpa,2.185185185185185,84,26,GTTGAGACAGGCGCCATCAA,58,1278765
furpa,0.5185185185185185,39,26,GTCCATCGTCCGGCGGGATC,13,1298144
furpa,0.3333333333333333,34,26,GTAAGGTAACACTGTTTCTG,8,1273510
furpa,1.1851851851851851,57,26,GGTGTAGTTCCCGTTGACAT,31,1289252
furpa,0.4444444444444444,37,26,GGTGCCTCCCCTGATTTTTG,11,1305256
furpa,0.07407407407407407,27,26,GGTCACACGTTTCGATATAT,1,1349664
furpa,1.5185185185185186,66,26,GGTATTTGGGGGCGTCTAAA,40,1356531
furpa,0.5555555555555556,40,26,GGTATGTCTCGAGGGCAGCA,14,1350580
furpa,1.5185185185185186,66,26,GGGGTGATCGGATGGAGTCT,40,1305943
furpa,0.6296296296296297,42,26,GGCTGAAGATTTCGTTCTGA,16,1296684
furpa,1.1851851851851851,57,26,GGCGCCAGCACCCCGAGCGT,31,1311842
furpa,1.0,52,26,GGCAATTCATCGTCATTTAA,26,1338047
furpa,0.37037037037037035,35,26,GGAATGAGCGCCCGCAAAAT,9,1277747
furpa,1.4814814814814814,65,26,GGAAGTTCCGGGTTTAGGAT,39,1295451
furpa,0.07407407407407407,27,26,GCTGCGTTTTGATGTTAAGG,1,1308769
furpa,0.9629629629629629,51,26,GCTCTGTTAATGCTTCTGTG,25,1318595
furpa,0.48148148148148145,38,26,GCTATTAACATCATTCCTGG,12,1288966
furpa,0.4074074074074074,36,26,GCGGGGTTGCAACTCCATAA,10,1282432
furpa,0.14814814814814814,29,26,GCATCTGTCTCGGATCGTAC,3,1343192
furpa,0.4074074074074074,36,26,GCACGCACACCCGATGTTGC,10,1343925
furpa,0.9629629629629629,51,26,GCACGAAGAGGCGGACATCT,25,1340113
furpa,2.0,79,26,GATGTCGCTGACCTTTCTCT,53,1277022
furpa,1.6296296296296295,69,26,GATGGTGGGAGGGTATATCA,43,1273872
furpa,1.4074074074074074,63,26,GATCTCCATGCCGACGTTAC,37,1279998
furpa,2.6666666666666665,97,26,GATACTTTGCAATACAATAC,71,1272584
furpa,1.5555555555555556,67,26,GAGAATGAAACTACCAGGGC,41,1328289
furpa,1.7777777777777777,73,26,CTGTCGCCCTGGTCATTCAG,47,1290150
furpa,1.1851851851851851,57,26,CTGCGGGTCGAGTGGAGGTA,31,1335157
furpa,0.48148148148148145,38,26,CTGATGGCGCTTTGCCGATA,12,1339314
furpa,0.8518518518518519,48,26,CTAATACAAGTTATCGGTTT,22,1305405
furpa,1.7407407407407407,72,26,CGGTCCACGAGAGGGTCATT,46,1277677
furpa,1.7037037037037037,71,26,CGGCGACCCGGAGCCAGAAA,45,1354460
furpa,2.740740740740741,99,26,CGGCACAAGGTATCTTTTTA,73,1316673
furpa,0.1111111111111111,28,26,CGCTACCATACCCGCACTGC,2,1298330
furpa,1.2592592592592593,59,26,CCTTTGTGTATCTCATTACA,33,1330124
furpa,0.7407407407407407,45,26,CCTTGCAGGACAGTCTGGGG,19,1343834
furpa,0.8888888888888888,49,26,CCTTGAGAACCCGCTCCGTT,23,1346186
furpa,0.9629629629629629,51,26,CCTAGTAAGCATTGGCTAGC,25,1320640
furpa,2.888888888888889,103,26,CCAAGGGCGTTGGACCTACT,77,1341021
furpa,2.2962962962962963,87,26,CATGGGAATAATGTAAGACA,61,1281604
furpa,0.5555555555555556,40,26,CAGGTCCCACTATAACTGTG,14,1351972
furpa,2.5185185185185186,93,26,CACCGGCACCGAATTACGTT,67,1308060
furpa,0.7407407407407407,45,26,CACCAGGTGTTTACAGGAAG,19,1281949
furpa,2.4074074074074074,90,26,ATTTGGTTACGGCGCTTTTA,64,1345415
furpa,1.0740740740740742,54,26,ATGGCGGCGCACAATAGGAT,28,1279221
furpa,1.037037037037037,53,26,ATGGAATGCGAGGAGCAGGA,27,1306134
furpa,0.9629629629629629,51,26,ATGCCACAAGCAAGAAACCT,25,1311876
furpa,2.925925925925926,104,26,ATGAGTGTGGCTGGACGAGT,78,1278780
furpa,0.2962962962962963,33,26,ATAATCTCTATCTTACCGGG,7,1306348
furpa,1.6296296296296295,69,26,AGGAGGACTCAGGAAAGGAG,43,1283615
furpa,0.1111111111111111,28,26,AGCTGAACTCGCGTGTAGTT,2,1308122
furpa,1.962962962962963,78,26,AGAGTCTCATGGGGGAGCTA,52,1328301
furpa,1.2962962962962963,60,26,AGAGTCCGGCGGAGGCGTTA,34,1284173
furpa,0.5185185185185185,39,26,AGACGTGTAACTGAGTTGTT,13,1336828
furpa,0.07407407407407407,27,26,ACTAGAGGGGTATGGTCTTA,1,1332541
furpa,1.5555555555555556,67,26,ACATATGCACCGGCGAATTT,41,1294787
furpa,1.1851851851851851,57,26,ACAGAATAACCGAGCAACAA,31,1281525
furpa,0.9259259259259259,50,26,AATCTAGAATCGCACATGGT,24,1284865
furpa,0.07407407407407407,27,26,AAGGCACGGAAACTTCGGTC,1,1294877
furpa,0.07407407407407407,27,26,AAGGATTACCACACGCTTTG,1,1331986
furpa,0.07407407407407407,27,26,AAGGAAGTCAGGGCTAATGT,1,1300408
furpa,0.2222222222222222,31,26,AAGCTACTGCAAGGCTCTCT,5,1312764
furpa,0.14814814814814814,29,26,AACATTTCCTGCGAAAGGAG,3,1317287
furpa,0.7037037037037037,44,26,AAAGGGGGGCTCGGTTCCCA,18,1287655
furpa,0.25925925925925924,32,26,AAAAGTTGCCTAGGGGGGGG,6,1286752
furpa,0.11538461538461539,27,25,TTTTGTTTCAAGACACCCTC,2,1328076
furpa,4.076923076923077,130,25,TTAAGTCTGCCGCGCGGGGT,105,1349017
furpa,1.0,50,25,TGTGGGATAATCAGTCTTCG,25,1292996
furpa,3.8076923076923075,123,25,TGTGGCAGCAACCGTTGGTC,98,1347345
furpa,3.9615384615384617,127,25,TGCGCAGGCTAATGCTCTGG,102,1302442
furpa,0.7307692307692307,43,25,TCGTGCGCGGGAACCCGTTT,18,1320632
furpa,0.38461538461538464,34,25,TCGCCACGAGTTACTTAACA,9,1325053
furpa,0.46153846153846156,36,25,TCCACGCGTGTCAACTGGCG,11,1299293
furpa,0.07692307692307693,26,25,TCAGTTATCTCGCGCAAAGC,1,1310246
furpa,1.1538461538461537,54,25,TCAGATGGGTTGTCTATGCC,29,1327882
furpa,0.9230769230769231,48,25,TACTCCTCGACGGTCGTTGC,23,1324597
furpa,1.2692307692307692,57,25,TAACCTGGGCTACGAGTCAT,32,1328760
furpa,1.0769230769230769,52,25,GTTTGGGCGATATCGCAATT,27,1277808
furpa,0.07692307692307693,26,25,GTTCTCTATCTGGTACTTTC,1,1347717
furpa,0.3076923076923077,32,25,GTATTGTCCCTACGCAGTAT,7,1280021
furpa,4.8076923076923075,149,25,GTAACGGAAGACTCGACCGA,124,1286754
furpa,1.9615384615384615,75,25,GGGCGTAGATTCCAGATTTG,50,1291550
furpa,0.7692307692307693,44,25,GGGACGGCGAGTACTCCGGT,19,1336949
furpa,0.7692307692307693,44,25,GGAGACGAGTACGGGCGAGT,19,1273604
furpa,0.07692307692307693,26,25,GGACTCTTAGCAGGAGCGTA,1,1354061
furpa,0.07692307692307693,26,25,GGAATAAGTATCATGGGATC,1,1290671
furpa,0.46153846153846156,36,25,GCGCTGCAAGGAACATAATA,11,1311079
furpa,0.07692307692307693,26,25,GCCTTTCGGGGTGGGGTATT,1,1292231
furpa,0.07692307692307693,26,25,GCCGGTCGAGTATGAGATTA,1,1315871
furpa,0.7692307692307693,44,25,GCCCAATTGACGTGTACAGG,19,1298378
furpa,0.6923076923076923,42,25,GCAAAATTCGACTCTACGAG,17,1330656
furpa,2.5,89,25,GATGTGCGCGATGCACAATG,64,1289953
furpa,0.15384615384615385,28,25,GAGGTTCCAATGGCACAATG,3,1320638
furpa,0.23076923076923078,30,25,GAGGCTTCCTCCCATCCATG,5,1283705
furpa,0.07692307692307693,26,25,GACCAGAAGGTTCACCTTGC,1,1350334
furpa,1.0,50,25,GAATTCAGAACTGATGCGTT,25,1342468
furpa,1.0,50,25,GAACCAGCTATGGCATGAAA,25,1273484
furpa,1.0,50,25,CTTGATAATGCTGCATGTTG,25,1327664
furpa,2.1923076923076925,81,25,CTTACAATCAGAAAACCTCT,56,1353860
furpa,2.0384615384615383,77,25,CTCGTCATACAATCGCACAT,52,1290676
furpa,2.1538461538461537,80,25,CTCGGTTGATTACGTTTTAC,55,1287742
furpa,0.19230769230769232,29,25,CTCAGGCGTTATGGAGCCTT,4,1317557
furpa,1.1153846153846154,53,25,CGTCAGCGCGAGGTCAAAAT,28,1296678
furpa,0.07692307692307693,26,25,CGGACCTTTTCCACCTGCGG,1,1277189
furpa,1.4230769230769231,61,25,CGGACCATCAGCGACCAATG,36,1352338
furpa,1.8846153846153846,73,25,CGCAGCCGCGCTAGGCTCGT,48,1317091
furpa,0.9230769230769231,48,25,CGAGAGTCGATCATCCAGTA,23,1352450
furpa,1.0769230769230769,52,25,CGAAACATGATACATTAGAA,27,1308428
furpa,0.6153846153846154,40,25,CCTATCGAAGGACACGCGAT,15,1294460
furpa,0.7692307692307693,44,25,CCTAGATACTATGCCCCCAT,19,1337522
furpa,0.11538461538461539,27,25,CATCGTACTACCTACGTCTA,2,1298510
furpa,0.07692307692307693,26,25,CAACGTGGGCACTCAAGTTC,1,1286507
furpa,1.8846153846153846,73,25,CAAAAAGCCCAAACGGAATA,48,1273071
furpa,1.8076923076923077,71,25,ATGTTAACTGGCGAAGCATG,46,1350658
furpa,0.46153846153846156,36,25,ATGCGTTTACCGGTTTCGAT,11,1322994
furpa,2.230769230769231,82,25,ATGAGGCCTCACACGTCAAA,57,1291016
furpa,0.46153846153846156,36,25,ATCACGGCGCTAGTCGGAGT,11,1344329
furpa,2.730769230769231,95,25,ATCAATTGTTCGTTGACGAC,70,1301838
furpa,0.2692307692307692,31,25,ATACTGGGTCCACCCATCAA,6,1308687
furpa,1.6153846153846154,66,25,ATACAAAAGTGTTGGAGTTG,41,1329667
furpa,0.3076923076923077,32,25,AGTCTAGTTTCGATGTATAA,7,1285102
furpa,0.15384615384615385,28,25,AGGTTGGTTACATCGGATAT,3,1295569
furpa,1.6153846153846154,66,25,AGGGAGCTGTCTACGTAGAA,41,1296685
furpa,2.5384615384615383,90,25,AGCAGGTAAACAATCGCGGT,65,1272794
furpa,0.5769230769230769,39,25,ACTAAATGGAATGCATCGAT,14,1313635
furpa,12.73076923076923,355,25,ACACGACAGTACCCTGTAGA,330,1271327
furpa,0.9615384615384616,49,25,ACAAGTTGAGCGTGGACCTC,24,1280575
furpa,0.3076923076923077,32,25,AATCGTCACAGATGCTCCTG,7,1310666
furpa,2.076923076923077,78,25,AATACCCTTGACCCAAAGCT,53,1304798
furpa,3.576923076923077,117,25,AAGATAGGTTGCTAATTTCA,92,1277544
furpa,0.5769230769230769,39,25,AACTGGTTGTTATTTCAGCA,14,1289659
furpa,1.5769230769230769,65,25,AACCTTCTTCTACAACGCGT,40,1303456
furpa,0.23076923076923078,30,25,AACCGGCTTCGCGGGTGTTA,5,1280835
furpa,1.44,59,24,TTTGCCGTTTCATCGTACAT,35,1302138
furpa,1.52,61,24,TTTCGGATCTTTATCATTCA,37,1280691
furpa,2.0,73,24,TTGTGGCACAACTGGAATGT,49,1310397
furpa,1.04,49,24,TTGTAACGGAATTGAAACAG,25,1305306
furpa,0.96,47,24,TTCTCAACAAGGGGCTTGGC,23,1279045
furpa,0.2,28,24,TTCTATCTGCAGTTGAAGCA,4,1324292
furpa,0.08,25,24,TTACTAAGCCTGATTGCTTC,1,1332250
furpa,0.08,25,24,TGTTAGGTCCGGAGCGTGTA,1,1341989
furpa,0.44,34,24,TGTGGCAACTGGCATGACTC,10,1274002
furpa,0.84,44,24,TGTCTGTGGCCAGAGAGGTG,20,1293216
furpa,0.08,25,24,TGGTGCCCGCTTGTGGTGGG,1,1278194
furpa,1.68,65,24,TGGTCGAAGACGTCCACAAC,41,1281984
furpa,0.44,34,24,TGGCGTAGCCAAGTGCTCCC,10,1335575
furpa,4.16,127,24,TGCTTCTCAAGATACAGTAA,103,1284949
furpa,3.16,102,24,TGCGTAATCTAGGGACGCGT,78,1281709
furpa,1.8,68,24,TGATCCTGATGTTGTTCACA,44,1288096
furpa,1.32,56,24,TGAGATGCGGACGGTTTGCG,32,1294824
furpa,0.28,30,24,TGAACCAATCTGTCAAAGGT,6,1294526
furpa,1.88,70,24,TCGTTATTCAAATGAGCGTA,46,1314140
furpa,0.08,25,24,TCGTAGTCAGCTTGGGATCT,1,1310912
furpa,0.08,25,24,TCGGCTTGAAATTGCAGGAC,1,1313135
furpa,3.76,117,24,TCGCTGATGCCACTGTACAG,93,1351466
furpa,2.56,87,24,TCGAATATACCGCACACGTC,63,1277403
furpa,2.88,95,24,TCCGTGGTAATTGCCTTGCG,71,1271860
furpa,0.2,28,24,TCATGGAATGCTATGCAGAG,4,1271989
furpa,5.64,164,24,TCAGTTCAGCTAATTGAGAG,140,1285424
furpa,1.48,60,24,TATCCGTTCGCCAATCGACT,36,1284533
furpa,0.08,25,24,TATCCGCCCGATTGTGCCTA,1,1309725
furpa,1.64,64,24,TAGCCTAGGCGGGGGCGCCA,40,1351220
furpa,0.36,32,24,TAGAAACATAGATGCATTAA,8,1307746
furpa,1.6,63,24,GTTCTACGCGTTGGTAAATA,39,1300620
furpa,4.16,127,24,GTGTCCGGTGTCCGTTCACT,103,1337811
furpa,0.88,45,24,GTGGGCCACGTAGCCCAGAG,21,1298011
furpa,1.6,63,24,GTCGGTATGAAGATGTTCAA,39,1307357
furpa,0.08,25,24,GTCCCACTCTGCAGAGTGCA,1,1287571
furpa,3.92,121,24,GTCAAGAGGTACAAACACGA,97,1323401
furpa,0.4,33,24,GTAGTATGGAGGAGATGCCG,9,1343519
furpa,0.4,33,24,GTAGCCTAGACCGAGACTAG,9,1286931
furpa,1.04,49,24,GTACGGGGTTGCTAAGAGCG,25,1311360
furpa,1.52,61,24,GGTATGGCCTCTTTGGAGAG,37,1277989
furpa,2.96,97,24,GGGACTTCGGTGTTTTATTT,73,1271177
furpa,0.28,30,24,GGCCTTAGAGCAAGGAGAAG,6,1282188
furpa,0.28,30,24,GGAGTTTGACAATAGAGCGT,6,1279630
furpa,0.84,44,24,GCTTGTTCCAAGAGAAACGT,20,1286230
furpa,1.2,53,24,GCTTGAGCTAGTGCGACCTA,29,1330858
furpa,3.08,100,24,GCTGTTTACTTTCTCGCCTA,76,1316472
furpa,0.76,42,24,GCTGAAAGCACAGGTCCCCT,18,1276943
furpa,0.2,28,24,GCTAGCATTTTATCATCCTC,4,1354982
furpa,0.12,26,24,GCTAATAGCCGATAGGTTTC,2,1337380
furpa,1.32,56,24,GCGGACCGTCTCATACTTAC,32,1338912
furpa,9.32,256,24,GCCACAGATGGCTCATGCTA,232,1321489
furpa,0.88,45,24,GATGGTACGTAATTGAGCGA,21,1308704
furpa,0.28,30,24,GACTCGTTACCAGGCGAGCG,6,1276989
furpa,1.08,50,24,GACGGACCCTGCCCTGACGG,26,1346561
furpa,0.2,28,24,GAAACCCAGCCCTTTACTAC,4,1305633
furpa,1.12,51,24,GAAAATGTGGGTTATTCGCT,27,1273828
furpa,4.76,142,24,CTTGGTCGTACGCTTGACCT,118,1284639
furpa,0.76,42,24,CTTACGGTCTAGGGAGTGGA,18,1310468
furpa,2.4,83,24,CTGGCTTGCCCCCGGGATCT,59,1347017
furpa,1.16,52,24,CTCTTTATTGCCCTCAGCGC,28,1297025
furpa,4.0,123,24,CTCCCAGGTTATTACACCGA,99,1313724
furpa,0.72,41,24,CTATGCCGCTCCCTAAGGGC,17,1290943
furpa,0.16,27,24,CGTTCTTCATACCGTGACTC,3,1314751
furpa,0.52,36,24,CGTAGTCTCTGAAGTCTGGT,12,1350016
furpa,0.52,36,24,CGGGTGGCCTGTTTTATTAG,12,1346202
furpa,1.4,58,24,CGGGCTAAGGGGTACTTAAA,34,1331926
furpa,1.0,48,24,CGGCCTGCATCTAAGGCAGA,24,1300421
furpa,1.8,68,24,CGGCCGCCAGTTTCGTCTTG,44,1273183
furpa,38.04,974,24,CGGCACATGGGAAGTCGGAT,950,1275692
furpa,4.56,137,24,CGGAACTTCCTTATCGCCGG,113,1295616
furpa,2.08,75,24,CGATATATTGCGCGGATACT,51,1295561
furpa,0.44,34,24,CGAAGGGAGATTCATCGTCA,10,1302729
furpa,4.68,140,24,CGAACAAGAAGGAGGTCTGT,116,1311811
furpa,0.84,44,24,CCTATTTATACCAGTCAGCA,20,1340636
furpa,0.12,26,24,CCTATAAATGCGATGAAAAA,2,1293367
furpa,0.08,25,24,CCGCTAATAAGTTTGATTTG,1,1297930
furpa,1.36,57,24,CCCCCAATTAACCACTGATC,33,1275300
furpa,0.2,28,24,CCAAAAATCCACGCGGCCTA,4,1345944
furpa,4.28,130,24,CATCATGCTGCACGCAACCA,106,1296998
furpa,2.8,93,24,CATAAAGCGTTGGCTAAATG,69,1280669
furpa,1.04,49,24,CAGCTAGGTCATTTTCTTTA,25,1290675
furpa,0.24,29,24,CACACGCACCACATCTATTT,5,1279522
furpa,0.84,44,24,CACAAGGGTTAGAGTATCGT,20,1298760
furpa,1.0,48,24,CAATTAAAACCGCATCGTTA,24,1317487
furpa,2.4,83,24,CAATAACCCAGAGGCCGAGA,59,1356536
furpa,0.24,29,24,ATGCTACGGGTAGGGAGTAC,5,1294135
furpa,0.08,25,24,ATCGTCGGCTCGACCATTGC,1,1342697
furpa,1.4,58,24,ATCGCCACTAAAGAGGAATT,34,1306967
furpa,0.08,25,24,ATCGACAGGTATTTGGAGCT,1,1346905
furpa,0.44,34,24,ATAATACTAAATCCGCCCCA,10,1293625
furpa,0.76,42,24,AGTCTGCATCGGAACCGCAG,18,1275705
furpa,0.32,31,24,AGGTTGATAGGTGCGCTACA,7,1286671
furpa,0.36,32,24,AGGAAGGTATTTACGCAGTT,8,1344779
furpa,0.68,40,24,ACGTATCATGGCTATTCAGC,16,1287154
furpa,1.04,49,24,ACCGTCAGGGCACACATTAG,25,1272798
furpa,0.08,25,24,ACCCAAGTTATTTACGGCCA,1,1318994
furpa,1.24,54,24,ACATCGCTTCTAAACGGGAC,30,1336353
furpa,0.24,29,24,ACAGGGTGCGTTTAGGTAAC,5,1332064
furpa,7.2,203,24,ACAGATTCGCGAGCTGCATC,179,1313701
furpa,1.72,66,24,AATGGGACAGTAGCGTAGTA,42,1289629
furpa,14.52,386,24,AAGTATTGCCTGTTGTCTGT,362,1326450
furpa,0.88,45,24,AACGATCCCGATGTTCACTC,21,1335569
furpa,4.92,146,24,AAAGCGTGGGCTTTTGGGGA,122,1299099
furpa,0.9583333333333334,45,23,TTTCCATGGGTTGCGGAGCA,22,1316893
furpa,1.2916666666666667,53,23,TTGTTGAAGTCCGCTCTGCA,30,1314899
furpa,0.2916666666666667,29,23,TTGGCACGACGTATGCCGTA,6,1291064
furpa,0.9166666666666666,44,23,TTGGAAGGCTAATAATACAT,21,1306421
furpa,0.08333333333333333,24,23,TTGCTCTCGTCGAGAGATAA,1,1290239
furpa,1.375,55,23,TTGAGTTTGGTCACTTCTCC,32,1290039
furpa,1.7083333333333333,63,23,TTCTAGTGCACAGGGTACGA,40,1310599
furpa,5.291666666666667,149,23,TTCGTGGGTTCGTGGTCGGC,126,1323402
furpa,0.7083333333333334,39,23,TGTGACTGCGGAGTCATATG,16,1339102
furpa,1.5833333333333333,60,23,TGTAAAACGGGGCCTACCCT,37,1337500
furpa,6.416666666666667,176,23,TGGTGCTAACTGAACACCAT,153,1339307
furpa,0.375,31,23,TGGTCTTGTGCAGTAGATAA,8,1321160
furpa,0.08333333333333333,24,23,TGGCTCACATGGGAAAACAT,1,1346012
furpa,1.2083333333333333,51,23,TGCGCGGCATTTTTGGGCGC,28,1322295
furpa,3.125,97,23,TGCACTCTTCTATTTTTAGA,74,1296227
furpa,1.6666666666666667,62,23,TGAATGAGGAGCCGACCGGT,39,1345296
furpa,2.6666666666666665,86,23,TGAAACTCTCATGTCTGCGA,63,1335101
furpa,0.08333333333333333,24,23,TCTTCTTATTCACAAAGCTT,1,1281808
furpa,0.5416666666666666,35,23,TCTTATCGCTAGCATGTGAC,12,1352900
furpa,2.25,76,23,TCTCTCTGAACACTGATCCC,53,1334793
furpa,0.375,31,23,TCTCGTTCTAAGGCCACGAA,8,1313185
furpa,1.4166666666666667,56,23,TCGTAGGCTACTGGGACCGT,33,1331342
furpa,0.08333333333333333,24,23,TCAACACAATGTTTTGCAGG,1,1294478
furpa,1.3333333333333333,54,23,TATTACCCGTATAAGAAAGA,31,1329255
furpa,0.4166666666666667,32,23,TATCGCCTATAAACGGGGAA,9,1337285
furpa,0.7083333333333334,39,23,TAGCTCGTGATACGTTACCC,16,1306866
furpa,0.2916666666666667,29,23,TAAGTCCTGGTTTCTGCTAA,6,1331105
furpa,2.4166666666666665,80,23,TAACGGTTCCGGAGGTGTTG,57,1326968
furpa,0.08333333333333333,24,23,GTGTCTCAGGATAGTACTGT,1,1341481
furpa,1.6666666666666667,62,23,GTGGGTGAAGTCTTGCCCGG,39,1293369
furpa,2.4583333333333335,81,23,GTGCTATATGACCTCAGATC,58,1284884
furpa,4.208333333333333,123,23,GTGCGATCTTATGAATACCA,100,1312984
furpa,1.4166666666666667,56,23,GTCTACAGCGATGTCGGATA,33,1278178
furpa,0.8333333333333334,42,23,GGGTCAAATCCCTTGCAGAT,19,1282701
furpa,0.08333333333333333,24,23,GGGGTTGGAACTTTAGGAAA,1,1283170
furpa,0.5833333333333334,36,23,GGGGGTAGGTACTTATTGGG,13,1336779
furpa,0.2916666666666667,29,23,GGGGATGATCCGTGTAGAAC,6,1344553
furpa,0.375,31,23,GGCGCACCCAAGAGACACCG,8,1348893
furpa,1.25,52,23,GGAGTCTGCCGACAACCCGA,29,1356766
furpa,0.08333333333333333,24,23,GGACAGACGGTAAGACCACA,1,1289148
furpa,0.7083333333333334,39,23,GCTGCTTGCTAGCATGTTGC,16,1295453
furpa,1.3333333333333333,54,23,GCGCTACACAGCATGATGAC,31,1311644
furpa,0.08333333333333333,24,23,GCCGGCCGTAGGATTGCGAT,1,1284082
furpa,3.9166666666666665,116,23,GCCATAGGCAACATGAGGTA,93,1305079
furpa,2.2083333333333335,75,23,GCAGTTTGTAGAGTGGCGAG,52,1333468
furpa,0.375,31,23,GCAGGGTCCGGGGATGGGCT,8,1335202
furpa,0.08333333333333333,24,23,GATATATGGGACCGAAGAAG,1,1284292
furpa,4.25,124,23,GACTACAGGGTTACTCTAAA,101,1307523
furpa,0.08333333333333333,24,23,GAAGCCCACGTGTACTCTGC,1,1308897
furpa,1.9583333333333333,69,23,GAACCATTCGTAATCTCGAA,46,1334537
furpa,0.375,31,23,CTTGGGTTAGCCAACGCGTT,8,1346966
furpa,0.7083333333333334,39,23,CTTGATTTGATATTAACGTT,16,1289398
furpa,0.08333333333333333,24,23,CTTCTGAAGATCGGCGCTTT,1,1315898
furpa,0.4166666666666667,32,23,CTTATCTGAAGAAGGGCAGG,9,1350342
furpa,0.7083333333333334,39,23,CTGCAAAGGTGCGTCGACGG,16,1288384
furpa,0.2916666666666667,29,23,CTCGAAAGCATTACTCGGCT,6,1317654
furpa,1.0833333333333333,48,23,CTCACACCCTTATCCTTCGT,25,1283294
furpa,0.125,25,23,CTATGGGGATAGATCATAGC,2,1318912
furpa,2.0833333333333335,72,23,CTAGCAGGTTTGGCAAACCA,49,1337239
furpa,2.875,91,23,CGTTTGTCTAGCAACGGGTT,68,1318924
furpa,0.125,25,23,CGTTCTTTTCATTTGCTGGA,2,1349765
furpa,0.16666666666666666,26,23,CGTGCAATCGGCTAGCGGTT,3,1297761
furpa,0.4583333333333333,33,23,CGTACAATTACAGCCTCTAC,10,1341733
furpa,3.5,106,23,CGGGGGCTTCCCAAGGGCGA,83,1345801
furpa,3.4166666666666665,104,23,CGGCTTGACGTTGCTTAATT,81,1354914
furpa,0.875,43,23,CGGCAGGCGTGCCGGGTGCA,20,1281509
furpa,0.16666666666666666,26,23,CGGATTATACGCTACGTGAG,3,1302187
furpa,0.375,31,23,CGGAGAGACTAGGCGGAATC,8,1300223
furpa,6.416666666666667,176,23,CGGACATGTCAGTCCGCGTG,153,1271331
furpa,1.3333333333333333,54,23,CGCGGGTAGGCCTTCACCAC,31,1325847
furpa,0.125,25,23,CGAGTTTATGCCCACGTATT,2,1312887
furpa,1.375,55,23,CGAGAGAAAGCAATCCCGGC,32,1311197
furpa,1.125,49,23,CCTGGCACGCGCGTATACCT,26,1316271
furpa,0.9166666666666666,44,23,CCTGATCGGCCTCAGTCTCA,21,1314814
furpa,1.75,64,23,CCGAGGTCAAGCTTTCTGCG,41,1346644
furpa,0.125,25,23,CCCTATTAGGAGGTGCCCAG,2,1341406
furpa,0.4583333333333333,33,23,CCAGGGGAACAAATCCTCTC,10,1315372
furpa,0.2916666666666667,29,23,CATGCGGGGGCTCGGCAACA,6,1302751
furpa,0.08333333333333333,24,23,CATCCGTCATAGGGAATCTC,1,1324059
furpa,1.8333333333333333,66,23,CAGAAACTGGTTTCTAACCC,43,1351383
furpa,0.375,31,23,CACGTCAGCCGTGCCCGAAC,8,1304369
furpa,0.3333333333333333,30,23,CAAGGTTATGACTGGTAGTA,7,1331369
furpa,2.7916666666666665,89,23,ATTGCAACATTTCTCTCCAG,66,1310220
furpa,5.166666666666667,146,23,ATTCTAAGTTGAGTTTACCT,123,1272444
furpa,0.125,25,23,ATTATACACAGATTCCGCTC,2,1297086
furpa,0.08333333333333333,24,23,ATGTGTAAAGCCAGGATCAG,1,1336160
furpa,0.25,28,23,ATGTAGAGTCCAAGAATTCG,5,1298875
furpa,0.08333333333333333,24,23,ATGTAATGTTAAGCTTGGGG,1,1350645
furpa,1.125,49,23,ATGGAAGGTGCGTAAGCAAA,26,1317848
furpa,0.08333333333333333,24,23,ATGACCATCGAAAACTACAC,1,1289104
furpa,1.5833333333333333,60,23,ATCGAGGGGAAGTTTATAAG,37,1328358
furpa,0.3333333333333333,30,23,ATATGCTCCCTAGAATGCGC,7,1287886
furpa,1.625,61,23,AGTCACGGAGATGAGAGGAT,38,1329110
furpa,4.5,130,23,AGGCATATCTTCACCGGGCG,107,1280320
furpa,0.25,28,23,AGGATCCCCTCGCTCCTTTA,5,1334980
furpa,0.08333333333333333,24,23,AGGACTCATTGCAGAGATGC,1,1329446
furpa,2.375,79,23,AGCCTATAGGGCAATCGTTG,56,1324759
furpa,2.25,76,23,AGCAAACTTTCGGCTTCAAT,53,1334533
furpa,1.5,58,23,AGATGTATTTGGGTTTAGGT,35,1288469
furpa,0.6666666666666666,38,23,AGACTGCTTATACCTTTGTG,15,1306281
furpa,0.08333333333333333,24,23,ACTGAAAACGGTTATAGGAC,1,1354249
furpa,1.25,52,23,ACGTACATGAAGCGAATTCG,29,1301254
furpa,0.4166666666666667,32,23,ACGACCGTCCAACGGCGTAA,9,1346766
furpa,0.4583333333333333,33,23,ACCGTCCGGTACTTAACGTG,10,1350055
furpa,0.9583333333333334,45,23,ACCGCTCGGTACTGTCCAGG,22,1298868
furpa,0.3333333333333333,30,23,ACATTCCCGGGATTTAACTT,7,1287809
furpa,2.4166666666666665,80,23,ACAGTGCCGCAGATTTATGG,57,1351345
furpa,0.5416666666666666,35,23,ACAGCCTTGGCGCGGTAGGC,12,1281366
furpa,4.958333333333333,141,23,ACACCTCGTCGAACGGCATA,118,1328652
furpa,0.4583333333333333,33,23,ACAATCCTCCTCGCAATCGC,10,1273032
furpa,1.0833333333333333,48,23,AATCACGGGGAGCCGCCAAC,25,1330330
furpa,0.08333333333333333,24,23,AATCAAGAACGAGTGGCTAC,1,1352498
furpa,0.5,34,23,AAGTCGGCGAGTCCTGGGAT,11,1312895
furpa,11.291666666666666,293,23,AAGGTTCACAAAGCAGACCG,270,1295657
furpa,2.4583333333333335,81,23,AAAGAGCGCACTAGGAAACC,58,1277597
furpa,0.08695652173913043,23,22,TTTGCTGCGTCGAGGTTAAT,1,1279633
furpa,1.9565217391304348,66,22,TTGTTAACATTAATTTTTAC,44,1335024
furpa,1.173913043478261,48,22,TTGCGTTAATAGCGAATAAC,26,1354895
furpa,1.434782608695652,54,22,TTGAGTTACCGCAAAGAGAG,32,1336948
furpa,0.2608695652173913,27,22,TTAAGATATATCGGGATGTG,5,1311704
furpa,1.3043478260869565,51,22,TGGGCAGTACGAAGCGGAAG,29,1288670
furpa,4.826086956521739,132,22,TGCGTAATTCAGAACAAGCT,110,1330048
furpa,5.260869565217392,142,22,TGCGCACTCGGGACAATTCT,120,1296904
furpa,1.565217391304348,57,22,TGATCACGGTGAAACGCTCT,35,1277668
furpa,3.608695652173913,104,22,TGAATTACCTATCACCCCAA,82,1277256
furpa,1.1304347826086956,47,22,TCTGGTGACGCCGTAGCCCC,25,1291121
furpa,0.08695652173913043,23,22,TCGCAAGAGTCAAAGACACT,1,1290966
furpa,2.5217391304347827,79,22,TCCCACTCGGTCGCGTCCTC,57,1290038
furpa,3.5652173913043477,103,22,TCCCAAGGTAAATGTCCCGT,81,1341024
furpa,0.17391304347826086,25,22,TATTGGTTTTACGGGAGTAG,3,1275864
furpa,0.34782608695652173,29,22,TATTCTGCTAGGGAATTAGG,7,1351964
furpa,0.21739130434782608,26,22,TATCTAAGGGCATAGATAAA,4,1313990
furpa,1.391304347826087,53,22,TAGAGCCTTATGTCACGTTT,31,1328308
furpa,0.5217391304347826,33,22,TACGTTAGCTCTAGAGTTTA,11,1310344
furpa,2.391304347826087,76,22,TACGGACACAGAATGCACGT,54,1322260
furpa,0.21739130434782608,26,22,TACCGTCCTGTAATTCCCCA,4,1296229
furpa,1.6521739130434783,59,22,TAATGACCAAGCTGTAAAAT,37,1305561
furpa,4.086956521739131,115,22,GTTAGGGTTGTGAAACGCCT,93,1289899
furpa,1.0869565217391304,46,22,GTGGTATCTTTCGCGGCCGG,24,1331164
furpa,0.6086956521739131,35,22,GTGAAGGTCTAACGATTTGT,13,1332462
furpa,2.130434782608696,70,22,GTCTGTACGCGGGTAGCTAC,48,1329597
furpa,0.30434782608695654,28,22,GTCCGGGAAGGCGCAATTGT,6,1284765
furpa,1.3478260869565217,52,22,GTCAAGGGGGCTGGCCACGG,30,1311553
furpa,0.21739130434782608,26,22,GTACGGGACAATGTGTTTTG,4,1354316
furpa,0.2608695652173913,27,22,GTAAGCGTGGTGAGGCGCGT,5,1299383
furpa,0.30434782608695654,28,22,GGTTCCGATTGGCTTCTTTG,6,1295012
furpa,4.695652173913044,129,22,GGTTCCCCAGGAAAACTTGA,107,1345299
furpa,1.6956521739130435,60,22,GGTGTTTTGAAGTGGCCTCC,38,1279285
furpa,1.8695652173913044,64,22,GGGTGTGTTAGGTGTAATGC,42,1327124
furpa,0.9565217391304348,43,22,GGGTGTGTGAGGATCGGGTA,21,1273673
furpa,1.608695652173913,58,22,GGGCGCACCCGGGACCAGTT,36,1297633
furpa,2.739130434782609,84,22,GGCCCAACCAGGAACAAAAA,62,1284607
furpa,3.347826086956522,98,22,GGACTTGGAACATTGATTAG,76,1325959
furpa,2.1739130434782608,71,22,GGAAGTGTCGGTGGGCAAGT,49,1335783
furpa,3.739130434782609,107,22,GGAACTGGTAGCCACGTTTC,85,1302522
furpa,3.0434782608695654,91,22,GCTTTCAATACTAACATGTC,69,1288455
furpa,1.565217391304348,57,22,GCTGGCCTCGAATCACTGGC,35,1302645
furpa,2.652173913043478,82,22,GCGTTGAGGAGCGCCGCTCG,60,1316764
furpa,3.0,90,22,GCGGTACGAACAAATTGCCC,68,1326420
furpa,0.08695652173913043,23,22,GCCTTACTCCACTAGGCGCA,1,1299640
furpa,0.8260869565217391,40,22,GCCCTCTAACGCGTCACAAT,18,1353434
furpa,0.08695652173913043,23,22,GCACTTGGGTGAACTTAGGT,1,1313637
furpa,1.0434782608695652,45,22,GCAATGCGCTTGATCGAGCT,23,1312687
furpa,0.5217391304347826,33,22,GATCCAATAGCTTGTATATA,11,1308958
furpa,0.5652173913043478,34,22,GATAGATGCCGTACATGGCC,12,1297536
furpa,1.7391304347826086,61,22,GACGCGACCCCTCTTAGGAT,39,1297572
furpa,0.08695652173913043,23,22,GACCTAGTCTACCTATAGGG,1,1356009
furpa,0.6086956521739131,35,22,GACCATTACAAAAGCTCGGT,13,1350056
furpa,1.5217391304347827,56,22,GACCAAGTTAGCGGGTAAAG,34,1331051
furpa,0.782608695652174,39,22,GAAGTCAAGGCGGCCCGAGA,17,1286817
furpa,0.5652173913043478,34,22,CTGTCCCCGTAGCTCCCGCA,12,1309284
furpa,0.391304347826087,30,22,CTCTCGTCACTCAGGTGCAT,8,1294095
furpa,1.0869565217391304,46,22,CTAGATATGGAGATCAACCT,24,1329273
furpa,2.0434782608695654,68,22,CGTTAGTTGGCTACTCATAT,46,1278852
furpa,2.347826086956522,75,22,CGTATGCTTCTGGCGGCCAA,53,1297938
furpa,1.9130434782608696,65,22,CGTACGCATAAGCCTAGCAT,43,1282743
furpa,0.782608695652174,39,22,CGGTTGCTGTACCGCTTCTT,17,1337232
furpa,1.7826086956521738,62,22,CGGTATGGCGAAATTCAACA,40,1295544
furpa,2.5217391304347827,79,22,CGCTTTCAACGTTTCGAACT,57,1311861
furpa,0.13043478260869565,24,22,CGCCAAGGGTCGCTTTATAT,2,1289800
furpa,5.260869565217392,142,22,CGATGTTGACCATTTAGGTT,120,1321480
furpa,1.0,44,22,CGAGGTCCGTGACCTTAATG,22,1307999
furpa,1.826086956521739,63,22,CGACTGCACACTCCCAGTGC,41,1318613
furpa,1.7391304347826086,61,22,CCTTTTTGTAGGCCAATTGT,39,1276754
furpa,3.0869565217391304,92,22,CCGTTTAGAGTAAAATGACA,70,1276303
furpa,7.086956521739131,184,22,CCAGGGGGTTGTCCAGTGAA,162,1290027
furpa,1.434782608695652,54,22,CCAACCTCTCATGTGGCGGA,32,1327154
furpa,0.17391304347826086,25,22,CATGCCTGGGGAGCAGATAT,3,1347456
furpa,0.2608695652173913,27,22,CAGTGTATTGTCCAACATGC,5,1345716
furpa,0.9130434782608695,42,22,CACACTGTCTTAAGCATGAT,20,1336351
furpa,0.08695652173913043,23,22,ATTTCGTGCATGACTCAATG,1,1278704
furpa,1.4782608695652173,55,22,ATTGTCAGCTGGGGCAGGAG,33,1325056
furpa,2.0434782608695654,68,22,ATTGGACCTATTTACAAGAT,46,1284472
furpa,0.13043478260869565,24,22,ATTATTAGGGGCAGAGGGAT,2,1341323
furpa,0.6956521739130435,37,22,ATCGGAAGAGACTGACCAGC,15,1298376
furpa,0.5217391304347826,33,22,ATCGCTAGCTAGCACTCATG,11,1304203
furpa,1.3043478260869565,51,22,ATAGACCTTATTGCTAAATG,29,1293269
furpa,1.434782608695652,54,22,ATACCGTGGGTGAACCTCGT,32,1291354
furpa,1.565217391304348,57,22,AGTGGGATGTGTAATTATAA,35,1345691
furpa,0.9130434782608695,42,22,AGTCACCAGGATACCCACAT,20,1318620
furpa,1.1304347826086956,47,22,AGTATGCACTATTAATTTTA,25,1280081
furpa,2.391304347826087,76,22,AGGTACTCTGTTCAGGGATG,54,1349796
furpa,0.9130434782608695,42,22,AGGTACCTAGGTACATTGCT,20,1346355
furpa,0.9565217391304348,43,22,AGCGAGGGGCTGGTTGCATT,21,1271934
furpa,0.391304347826087,30,22,AGCCTATAGCTTAAAACTGC,8,1342111
furpa,1.1304347826086956,47,22,AGCATGGTACTCCCGAGAAT,25,1282304
furpa,4.478260869565218,124,22,AGATCATCCTCCGCTTTCGT,102,1283168
furpa,1.6521739130434783,59,22,AGAGCGGTAGTTAAATGTAA,37,1339867
furpa,2.391304347826087,76,22,ACTTTGAGCAGCAGCCCTTT,54,1301615
furpa,0.08695652173913043,23,22,ACTATCCCTCCCTTTGGCTA,1,1353914
furpa,0.2608695652173913,27,22,ACTAAGGTAGAGGCAACTGT,5,1291229
furpa,0.13043478260869565,24,22,ACGGCCAAAGGAACGTCATG,2,1289435
furpa,0.13043478260869565,24,22,ACGATTCCATTGTATGCGTG,2,1355120
furpa,1.826086956521739,63,22,ACGACATATTGCATGAGACA,41,1352919
furpa,3.0434782608695654,91,22,ACCTGGGAATCAAAAGCGTG,69,1312625
furpa,0.30434782608695654,28,22,ACCGCTCACGTGTGAGCGCC,6,1287032
furpa,2.782608695652174,85,22,ACCGACCAGCTTCGGCCCGT,63,1284673
furpa,1.391304347826087,53,22,ACCAGCTGTCTACGCCGGAT,31,1290513
furpa,0.5217391304347826,33,22,ACAATCCTACTTGCTCGCCA,11,1347718
furpa,2.9130434782608696,88,22,ACAAAGTCCCACGATGCAAT,66,1338500
furpa,1.4782608695652173,55,22,AATACACCCATAGTACGATA,33,1332303
furpa,0.5217391304347826,33,22,AAGATTACTCAGTCAAAGCC,11,1296060
furpa,0.13043478260869565,24,22,AACTGCTCGGCAAACTATAC,2,1338517
furpa,0.08695652173913043,23,22,AAAGGTCAATTTGAGAACCC,1,1298542
furpa,0.30434782608695654,28,22,AAAGGACGGCGTCACGAATA,6,1289550
furpa,3.4347826086956523,100,22,AAACAACGACGGAGCATTGA,78,1334350
furpa,0.3181818181818182,27,21,TTTTAAAGGGTATGTGGAAG,6,1316405
furpa,0.8636363636363636,39,21,TTGAGGCCATCGTAAAGGAC,18,1317234
furpa,1.3636363636363635,50,21,TTCTCATGCCCGACCTCGCA,29,1301038
furpa,1.5454545454545454,54,21,TTCACAGCATGCTGTGCAAT,33,1331900
furpa,1.1363636363636365,45,21,TTCAAAATGAGTTAGGATCA,24,1343930
furpa,0.7272727272727273,36,21,TTATTCCTGCTGTGGTCACA,15,1294872
furpa,0.3181818181818182,27,21,TTAGGGCCAGTCAGGCTTGT,6,1290772
furpa,0.09090909090909091,22,21,TTAATCCGGAAGGCCCTGAA,1,1292805
furpa,0.9090909090909091,40,21,TGTTTGTCGGGAAGCCTGCA,19,1345984
furpa,1.7272727272727273,58,21,TGTACCTTTCCCTAAAAGTT,37,1310604
furpa,1.5,53,21,TGGCTAAAATTGTCGGAGGG,32,1326521
furpa,0.45454545454545453,30,21,TGGACACCACTATTTTATCT,9,1282509
furpa,2.772727272727273,81,21,TGCTCTCGGTTGTAGATTCG,60,1306752
furpa,0.3181818181818182,27,21,TGCGTGGGTATTCATTCCTC,6,1296546
furpa,2.0,64,21,TGCATACAGAAGCGCATACA,43,1277744
furpa,0.13636363636363635,23,21,TGACCGTTTACCTGTCAGGA,2,1271531
furpa,0.5,31,21,TGACACGGGGACCGCCAGGT,10,1294702
furpa,0.18181818181818182,24,21,TCTTTGGCCTCTTGTGCGTC,3,1307749
furpa,0.13636363636363635,23,21,TCTTGCATTAATTGGACAGA,2,1284402
furpa,13.136363636363637,309,21,TCTTCGCCCTGGTTAAGGTG,288,1353595
furpa,0.13636363636363635,23,21,TCTAGAGGCTTATCCTTACA,2,1302126
furpa,0.13636363636363635,23,21,TCTACCTATGTGCTTATCGT,2,1298004
furpa,0.6363636363636364,34,21,TCGCGGGGGCTGCCCGGTTT,13,1348321
furpa,0.09090909090909091,22,21,TCGCCTCTCGAGATATCGAC,1,1279516
furpa,2.5,75,21,TCCCGCCTAGCTTGTCAGCC,54,1276384
furpa,1.2272727272727273,47,21,TCACAGGGTCTGACAAGGTC,26,1273528
furpa,0.18181818181818182,24,21,TCACACCAATCCATTATGAA,3,1289437
furpa,0.36363636363636365,28,21,TAGATGTATTCCCTCTGTCA,7,1319101
furpa,1.9545454545454546,63,21,TAATTGGGTGACATCATCAA,42,1276664
furpa,0.09090909090909091,22,21,TAATTGCATGTAATAGACTA,1,1338583
furpa,1.0909090909090908,44,21,TAAGTTTTCACAGATCGAGA,23,1286143
furpa,0.6818181818181818,35,21,TAACGACAAAAGGGTTTAGA,14,1333346
furpa,1.4090909090909092,51,21,TAAAGTCAAGAGCGTCGCTA,30,1323784
furpa,0.09090909090909091,22,21,GTTATTAACCTACTAGGGTG,1,1275243
furpa,0.09090909090909091,22,21,GTGTCTGAGGTTTCTTACCG,1,1345395
furpa,4.136363636363637,111,21,GTGGATCATGCTTGTACACG,90,1273951
furpa,3.1818181818181817,90,21,GTGCGATGTCAGGGTAGCTT,69,1273890
furpa,1.3181818181818181,49,21,GTCTTTCTAAAAGGGCGCGT,28,1325014
furpa,0.36363636363636365,28,21,GTCTCGAGGGGACAGGACGC,7,1285014
furpa,0.7727272727272727,37,21,GTACAAAGTACCCATTACCT,16,1329897
furpa,7.636363636363637,188,21,GTAATGGCTCTAATTCAGTG,167,1311997
furpa,0.3181818181818182,27,21,GTAATCCAGGGAAACGCATT,6,1304665
furpa,0.7727272727272727,37,21,GGTTTCGCGTTGTTCGATCG,16,1338175
furpa,1.7727272727272727,59,21,GGTTGGGAAAACTGCCCCGA,38,1354002
furpa,0.13636363636363635,23,21,GGTCTTGAGAAACTTACGAT,2,1298447
furpa,0.09090909090909091,22,21,GGGGGGTCCAGCCCTTTAAA,1,1341178
furpa,0.3181818181818182,27,21,GGATATCGGACGGGTATGCT,6,1349830
furpa,1.0909090909090908,44,21,GGAGACCACATGATGGATGG,23,1293761
furpa,1.1818181818181819,46,21,GCTTGGCGGACAAGACCCAT,25,1307594
furpa,0.5454545454545454,32,21,GCTGGGCCGCTGTAGGACGT,11,1300968
furpa,1.3181818181818181,49,21,GCGTCGTAACATACTTAGAA,28,1324440
furpa,3.6818181818181817,101,21,GCGACTACGCGTGGCGTCCA,80,1278309
furpa,0.7272727272727273,36,21,GCGAAATCCGGTGCGTCAAA,15,1305688
furpa,1.1818181818181819,46,21,GCCTGCACATAGTATCCGTC,25,1350897
furpa,1.2727272727272727,48,21,GCCGCTGCCTCATGATACGT,27,1313092
furpa,1.5,53,21,GCCAGGCGTAGTCACAGTAG,32,1298823
furpa,0.5909090909090909,33,21,GCATAAGCAGGAAGTCTTTT,12,1278545
furpa,1.3181818181818181,49,21,GAGGTATCCACGACATCGAA,28,1313723
furpa,2.590909090909091,77,21,GAGACCACTTATCGTTTGGG,56,1296121
furpa,0.09090909090909091,22,21,GAACGCCCATTGTTATGTCA,1,1340712
furpa,0.9090909090909091,40,21,GAACACTGAGGAGCCAATCG,19,1297709
furpa,0.13636363636363635,23,21,GAACAAGTTGATAAAGATAG,2,1291798
furpa,2.1818181818181817,68,21,CTTCTCTCTCGATCGTCCCG,47,1287991
furpa,0.13636363636363635,23,21,CTTACGGCCAGCGGTCCTCA,2,1300213
furpa,0.09090909090909091,22,21,CTGCGGATTGCGCAATCAGT,1,1313251
furpa,0.13636363636363635,23,21,CTGCCCAGGGAGATGGACGA,2,1295611
furpa,2.0,64,21,CTCGCGCATGGATAGTGTAC,43,1302834
furpa,1.0,42,21,CTCCCCTCGCAATAAAGTGT,21,1339872
furpa,1.1818181818181819,46,21,CTCAGGCAATGATCGCTGAA,25,1284334
furpa,4.863636363636363,127,21,CTATGCCTACCACGGAAAAT,106,1341463
furpa,1.5,53,21,CTACTTCCCAACCCACAACT,32,1285645
furpa,0.8181818181818182,38,21,CTAAGGGGCACGAGATGTAT,17,1276040
furpa,0.13636363636363635,23,21,CTAAGGCCGTATCCTTGCCA,2,1324698
furpa,18.045454545454547,417,21,CGTTTGTGTGGTGCCCGGAC,396,1319585
furpa,0.13636363636363635,23,21,CGTTCCCTCGTCCATTGTCG,2,1323467
furpa,2.272727272727273,70,21,CGTGATGTGTTTCTTGCTCT,49,1287091
furpa,0.5909090909090909,33,21,CGTAAAAGTTTGATGAGGAG,12,1289710
furpa,5.545454545454546,142,21,CGGTTTCTTGAATGTCGATA,121,1351381
furpa,0.3181818181818182,27,21,CGGTTGAGTTAACCCAAAAA,6,1324680
furpa,4.045454545454546,109,21,CGGTCTGTGCCACGAGCAGT,88,1304558
furpa,1.2727272727272727,48,21,CGATGGAAATGTCCAAAGAA,27,1334540
furpa,1.8181818181818181,60,21,CGAGCGAATTCGGGAGTGCT,39,1304337
furpa,1.0909090909090908,44,21,CGACCATTCTGCATAGTCAC,23,1324232
furpa,3.8636363636363638,105,21,CCTCTGTACCTCAAACTACA,84,1320136
furpa,0.4090909090909091,29,21,CCTATTGGCCCGCCGACAGG,8,1287000
furpa,2.0,64,21,CCATGAGGAGTTATACTGCT,43,1301997
furpa,1.0454545454545454,43,21,CCACGATTAACTTGAGATCG,22,1316455
furpa,0.09090909090909091,22,21,CCAAGGCTACTGGTGACGTT,1,1317974
furpa,0.6818181818181818,35,21,CATTAATCTGTGTACGGTTA,14,1349321
furpa,0.6363636363636364,34,21,CAGTCATGGACCCCTAGCGT,13,1332547
furpa,0.9545454545454546,41,21,CAGCGTGGTCATCTTTTCTA,20,1357712
furpa,0.8636363636363636,39,21,CACGGTCCTCTCTCCCTCAG,18,1274365
furpa,0.6363636363636364,34,21,CAATTCACATGGGAGTAGAG,13,1299015
furpa,2.1363636363636362,67,21,CAACTGCCCGGCATAGGTTC,46,1288220
furpa,7.363636363636363,182,21,CAACGTCACCTTCACTAATG,161,1273426
furpa,0.6818181818181818,35,21,ATTTAGCACCTTCATAGCCT,14,1324779
furpa,0.18181818181818182,24,21,ATGGGCCGCGCTAACCTGCA,3,1302225
furpa,2.0,64,21,ATGCGAGTGGACGTTGATGG,43,1299237
furpa,1.3636363636363635,50,21,ATCCATTCGTCGAGTGCTGT,29,1344725
furpa,0.3181818181818182,27,21,ATCAGGACGTCATACCAAGT,6,1305312
furpa,5.636363636363637,144,21,ATACGGCACAAGCAAAAGGA,123,1291562
furpa,0.9545454545454546,41,21,ATACGCGCGACCTTGTCCCA,20,1314817
furpa,0.6363636363636364,34,21,AGGGTTTGCACGACAGAAGG,13,1303191
furpa,0.18181818181818182,24,21,AATCTGCTATGATGAGGTTC,3,1316071
furpa,12.727272727272727,300,21,AATCTCGCTCCTGTGTGTCG,279,1319593
furpa,1.2727272727272727,48,21,AATATTGGCAGTACCGCTGC,27,1274462
furpa,2.1363636363636362,67,21,AATAGCGGCGCATGATGGAT,46,1356067
furpa,0.13636363636363635,23,21,AATAACCGCTAAAGCGCGGG,2,1314281
furpa,1.5,53,21,AACTAAATCTGGCGGATAGA,32,1335459
furpa,1.5454545454545454,54,21,AACATGGTCGTGTTCGTAAG,33,1297103
furpa,1.5,53,21,AACATCTCCGGTGCCCTAAA,32,1321272
furpa,6.545454545454546,164,21,AAAGAGCGCAGGGGGTTCAA,143,1323403
furpa,0.2727272727272727,26,21,AAAACCGGTAGGTGAGGAGA,5,1328021
furpa,0.2857142857142857,25,20,TTTGTTGTTAGCTGTTTTTT,5,1306688
furpa,2.1904761904761907,65,20,TTTCACGTCAGGCCGACACT,45,1296747
furpa,4.523809523809524,114,20,TTGGCTTATCCTCGATCTGG,94,1338743
furpa,4.666666666666667,117,20,TTGCGGAATACACTTAGACC,97,1331025
furpa,2.380952380952381,69,20,TTGCCTTCCCGGTTTACAAC,49,1335226
furpa,0.09523809523809523,21,20,TTGAGAGATCGGACTGTGTA,1,1351335
furpa,0.38095238095238093,27,20,TTCTAAGTAATTTGTGGCTT,7,1344628
furpa,1.5238095238095237,51,20,TTATCTAATTTCCTATCGGA,31,1298435
furpa,5.857142857142857,142,20,TTATCGGGTTGCCGGAATCT,122,1283610
furpa,0.09523809523809523,21,20,TTACCTCACTTTGTACACCC,1,1289014
furpa,0.6190476190476191,32,20,TTAAGGTGGATTCTCACGCT,12,1329105
furpa,0.5714285714285714,31,20,TGTTGTGTAGTTAGGTTGTC,11,1325161
furpa,0.2857142857142857,25,20,TGTTGAACAGCCCGTTTGCT,5,1316130
furpa,1.5714285714285714,52,20,TGGGTGATTGCTGCAGTTCC,32,1284100
furpa,3.0,82,20,TGGCTAATGCTAAGGACATA,62,1311448
furpa,3.1904761904761907,86,20,TGGAGATCGGCGTGTGCAGC,66,1323416
furpa,0.47619047619047616,29,20,TGAATGCAATTCATTATAAA,9,1299643
furpa,2.380952380952381,69,20,TCTTAGTAATGTTACATTCG,49,1304429
furpa,0.47619047619047616,29,20,TCTGGATGCACGATTATACA,9,1274759
furpa,1.2380952380952381,45,20,TCTCCGTGTATCGGTTCGAA,25,1317638
furpa,1.9047619047619047,59,20,TCGTATTGCTATATTAGAGA,39,1331924
furpa,2.761904761904762,77,20,TCGGTTTGTGTACCGGCCCA,57,1332608
furpa,0.14285714285714285,22,20,TCAAGCAAATCATCCGCGCA,2,1323658
furpa,0.7619047619047619,35,20,TATCAAAGCCTTAGAAGGAT,15,1318678
furpa,2.0476190476190474,62,20,TAGTAGACTGGAATTCGGTG,42,1276552
furpa,1.9523809523809523,60,20,TAGGCTCCTAGCCGTCGGAA,40,1303271
furpa,1.0476190476190477,41,20,TACTTGCGCAAGATCGGCAA,21,1344371
furpa,0.47619047619047616,29,20,TACTAGATCCCTAAGTAGCT,9,1351627
furpa,0.09523809523809523,21,20,TACGCTGGATTCGACACGAA,1,1317784
furpa,0.2857142857142857,25,20,TACAGCACAAGGGGGCAATA,5,1292611
furpa,0.09523809523809523,21,20,TAATCTGACAAAGTGGCACG,1,1290462
furpa,0.9523809523809523,39,20,TAATCGCAAGGCTCCAGCTG,19,1339465
furpa,0.09523809523809523,21,20,TAAGCGGGTCTTCTAGAAAT,1,1309332
furpa,2.7142857142857144,76,20,GTGGACGTGATTGTCTTGTT,56,1301480
furpa,2.4761904761904763,71,20,GTACTTTCGATCCCTCCATT,51,1280278
furpa,2.5714285714285716,73,20,GTAACATGGCTCTAGGTCTC,53,1306771
furpa,1.380952380952381,48,20,GGGTAGGAACCATTAGCTCC,28,1282082
furpa,2.0476190476190474,62,20,GGGGGTATATATACGACTCA,42,1305756
furpa,1.1904761904761905,44,20,GGGGCTAGGGGGTATTGCCC,24,1349803
furpa,0.3333333333333333,26,20,GGGCTGCTTAGTGGGCGGTA,6,1342269
furpa,0.14285714285714285,22,20,GGGAGACTTCGCACTTCATA,2,1292784
furpa,1.0952380952380953,42,20,GGGAAAGTCTAATCGATACT,22,1331557
furpa,2.0,61,20,GGCTTAAAAATACACCCACT,41,1335766
furpa,0.8095238095238095,36,20,GGCTCAATAGTGAAATTTGA,16,1309916
furpa,0.38095238095238093,27,20,GGCAGGCATGCGCGCGCACA,7,1274587
furpa,0.09523809523809523,21,20,GGATGTACACGAAGACATGT,1,1314818
furpa,6.904761904761905,164,20,GGAGCTCGATAGAGAATGTT,144,1280140
furpa,0.9047619047619048,38,20,GCTATTCTGATGATCAAAGA,18,1323027
furpa,1.9047619047619047,59,20,GCGCTTAGTAACTGAACAAA,39,1325663
furpa,0.3333333333333333,26,20,GCGCTGCGAGATTAAGCGCA,6,1288450
furpa,0.09523809523809523,21,20,GCGAGACACCAAGGGTGTCA,1,1304796
furpa,0.7619047619047619,35,20,GCGACGTGGTGTTCTGGAGA,15,1299274
furpa,0.19047619047619047,23,20,GCCGTGGCGAGCCCGACATG,3,1276899
furpa,0.2857142857142857,25,20,GCCCTTGGCCTAGCCAACAG,5,1324067
furpa,4.714285714285714,118,20,GCAATGTTCGACCCTAATAC,98,1275528
furpa,2.6666666666666665,75,20,GCAAAAGTGTACTAAGCAGG,55,1324230
furpa,0.09523809523809523,21,20,GATTGGACAGATCGTCGTAT,1,1284547
furpa,2.3333333333333335,68,20,GATTCCTCGGGCGGTCGAAT,48,1281645
furpa,4.904761904761905,122,20,GATACTTATCGCTCTTCCCC,102,1276301
furpa,1.7142857142857142,55,20,GAGGCGTGACGGATCTATTC,35,1323219
furpa,0.09523809523809523,21,20,GAGGAGTACTTGGGAAAAAT,1,1347007
furpa,0.7142857142857143,34,20,GAGCCCACAGAGTTCACGTT,14,1294331
furpa,1.1904761904761905,44,20,GACGCATTGAATCATGGGGT,24,1283601
furpa,0.6666666666666666,33,20,GACCTCTTATCATAGCGAGG,13,1289016
furpa,0.09523809523809523,21,20,GACCTCGTTTATTTCTTTCA,1,1282071
furpa,1.9523809523809523,60,20,GACATATGTTTGTCTTATGC,40,1326245
furpa,0.09523809523809523,21,20,GACACCGGGTTCTTACGTCG,1,1291092
furpa,1.0476190476190477,41,20,GAAAAACTCGCGTGCGCGTA,21,1282779
furpa,3.619047619047619,95,20,CTTCGACCCAGCGCCTTATG,75,1354810
furpa,0.8571428571428571,37,20,CTGGACCCTCCATTGTCCGT,17,1325353
furpa,0.09523809523809523,21,20,CTCGGTTACCGATCCATGGG,1,1354805
furpa,1.0,40,20,CTCCATCTCGAGCCGATCTG,20,1284413
furpa,1.8571428571428572,58,20,CTCAACGTTCACTTGGGTGA,38,1319757
furpa,1.4285714285714286,49,20,CTACATTGAGCTTCATGGGT,29,1286287
furpa,1.5238095238095237,51,20,CTAACGTCGTATCCTAGCCT,31,1304656
furpa,1.4285714285714286,49,20,CGTTGGCGGACGGGTATTAC,29,1324678
furpa,0.2857142857142857,25,20,CGTAACATAGAGTGGGTCCA,5,1357275
furpa,1.1904761904761905,44,20,CGGTTTGACATATTGTTCAT,24,1278495
furpa,3.5238095238095237,93,20,CGGTTGCGTTGAGTGTGGCA,73,1336006
furpa,3.4761904761904763,92,20,CGGGGAACGAGCTGCACTAC,72,1283875
furpa,1.0476190476190477,41,20,CGGGAGGAATAGGCCCATCT,21,1357626
furpa,0.7142857142857143,34,20,CGGGACGCATCATTCGGTAA,14,1315807
furpa,1.2380952380952381,45,20,CGGCTGATTCCCAGCAGGTA,25,1277850
furpa,0.09523809523809523,21,20,CGCTATCGGAAGTAAGGAGA,1,1306611
furpa,0.09523809523809523,21,20,CGAGTGGATCAAGTATGCCG,1,1295990
furpa,0.5714285714285714,31,20,CGAGGTGGGGGATGTCGCAT,11,1275942
furpa,1.3333333333333333,47,20,CCTGTCGGACGCTCATAGGA,27,1284642
furpa,1.5238095238095237,51,20,CCTGCCATTTTCATTGATAT,31,1331144
furpa,1.0476190476190477,41,20,CCTATTTCTCATGGAACGAG,21,1281528
furpa,1.4285714285714286,49,20,CCGTCCACCTGTGCTGTGCC,29,1337283
furpa,0.5238095238095238,30,20,CCGGGTCCGACTTCCAAGAG,10,1311803
furpa,2.142857142857143,64,20,CCCGTATCGTTGGGGATCGC,44,1349655
furpa,0.3333333333333333,26,20,CCATAGCGATTTCTTACGTA,6,1276066
furpa,0.09523809523809523,21,20,CCAACTGATGGAGCGGATTG,1,1346977
furpa,0.9523809523809523,39,20,CATTTTACCTTCAGTGCCAT,19,1341181
furpa,3.761904761904762,98,20,CATGTGCAGATACTGCTGCC,78,1315476
furpa,7.761904761904762,182,20,CATCATAAATCCGGTGCGAA,162,1333611
furpa,2.0,61,20,CATATGTCTAAGTGGGTCAG,41,1305156
furpa,0.6666666666666666,33,20,CAGTTGACCCCTCGAGATGT,13,1341735
furpa,0.09523809523809523,21,20,CAGGGCGACGTGTTCGCTTG,1,1327123
furpa,0.38095238095238093,27,20,CACAGATACACAACCCCTTA,7,1319978
furpa,1.1428571428571428,43,20,CAATAGAGTGTAATTGCTCG,23,1286904
furpa,0.09523809523809523,21,20,ATTTTGGTTTGTTGGATAAT,1,1343946
furpa,0.8095238095238095,36,20,ATTTAGGGCAGCCATATCGT,16,1290668
furpa,0.14285714285714285,22,20,ATTCTACTCACCTAGAAAGC,2,1337166
furpa,1.5238095238095237,51,20,ATTAGGCATGTCAAGGCCCA,31,1275574
furpa,0.5238095238095238,30,20,ATGTGGTATTCTTTACCCAG,10,1324357
furpa,0.9047619047619048,38,20,ATGTGGAGTTGTGCTTGGGG,18,1324075
furpa,1.0476190476190477,41,20,ATGTATGTGGGTATCCCATG,21,1291458
furpa,0.7619047619047619,35,20,ATGTAGGGTAAAATGGCGAC,15,1296900
furpa,3.5714285714285716,94,20,ATCGCATGCACGTCTGATGT,74,1304112
furpa,1.0952380952380953,42,20,ATCCAAGAGTTTGAGAGTTC,22,1277846
furpa,0.2857142857142857,25,20,ATCATCAAGGGGAAACCCTA,5,1333322
furpa,5.428571428571429,133,20,ATATCGCATCGCCGTAACGG,113,1311755
furpa,0.5714285714285714,31,20,ATATAAACCTGAATACCTAC,11,1316459
furpa,1.2857142857142858,46,20,ATACGAGGATTGCGTACCTG,26,1299768
furpa,0.5238095238095238,30,20,AGGTAGAGCGCATGAACCAT,10,1343731
furpa,0.5714285714285714,31,20,AGGGGACCGCTTTCTTTGCG,11,1297733
furpa,1.0,40,20,AGCGAGCTTTGTTAACAGGT,20,1277600
furpa,1.3333333333333333,47,20,AGCCCGCCTCCGTGGGGGTC,27,1311365
furpa,1.7619047619047619,56,20,AGATGAAAGCAATTTCAAGG,36,1313427
furpa,1.0476190476190477,41,20,AGATCGTTACTTCCCATGCG,21,1282870
furpa,1.7142857142857142,55,20,AGATCACTACTCATCCTTAA,35,1285992
furpa,4.857142857142857,121,20,AGAGGAAACCGCATTTGGGA,101,1311432
furpa,0.9047619047619048,38,20,ACGATCCCATTCGGACATGT,18,1300860
furpa,0.3333333333333333,26,20,ACCATGGTGCAACTTATGAG,6,1280362
furpa,1.5238095238095237,51,20,ACCAAAGGGGCATTAGTCCA,31,1337072
furpa,0.7619047619047619,35,20,ACAGGAATACAGATGGACCT,15,1306596
furpa,0.5714285714285714,31,20,ACACGTCGTCTAGGTTCTCT,11,1306500
furpa,1.619047619047619,53,20,ACACAGTTATCTGCCATGCT,33,1309521
furpa,0.5714285714285714,31,20,AATGTCCGGGTCTATGTCCA,11,1339695
furpa,0.7142857142857143,34,20,AATCGTACGCGGTCACCCCT,14,1356667
furpa,1.8095238095238095,57,20,AATATTTCCCGACGGGACCT,37,1335682
furpa,1.5238095238095237,51,20,AAGCGTTGAGAGAGCGCAGA,31,1352499
furpa,1.5714285714285714,52,20,AACGGTCATGGGCAGTTGGG,32,1330001
furpa,1.3333333333333333,47,20,AAAGATGGGTGACTTTATTA,27,1349361
furpa,1.5238095238095237,51,20,AAACGTTCCACGTTGATACG,31,1314103
furpa,4.380952380952381,111,20,AAAATTGCGAACGCTGTCGT,91,1281898
furpa,0.3333333333333333,26,20,AAAACATATTAGAAACCAAG,6,1323815
furpa,0.1,20,19,TTTCAAGGGATGGCTCTTGG,1,1324889
furpa,2.85,75,19,TTGCAAGAATGGGTGTGACT,56,1326332
furpa,0.4,26,19,TTGATCGGCCCCATACAACC,7,1276410
furpa,0.15,21,19,TTGAAGGGCCAAATTGAGAG,2,1298500
furpa,4.3,104,19,TTCAGGAATATCCCAGTTAG,85,1284255
furpa,0.35,25,19,TTCAACGCTATAACGTAACT,6,1303008
furpa,2.75,73,19,TTAGATTAACAACGTTGTTC,54,1274996
furpa,2.75,73,19,TGTTAAGCAAACTTGTAGAT,54,1344095
furpa,1.75,53,19,TGTATAAACGTGCCTTCTAC,34,1279678
furpa,0.15,21,19,TGGTGGAGGCCCCCGTTATA,2,1348308
furpa,0.75,33,19,TGGCATTGCTCTTTTACTGT,14,1289359
furpa,0.6,30,19,TGGAGGGCGCAATGTCCGGT,11,1301932
furpa,3.0,78,19,TGCGGGAGATCCTGATGTGA,59,1312575
furpa,1.75,53,19,TGAACCGTTCATGGGGATGG,34,1331002
furpa,0.1,20,19,TGAACCACTCGGGCGAAGGA,1,1303858
furpa,2.35,65,19,TCTGCTATAGCTTATTCCAC,46,1350420
furpa,0.75,33,19,TCTCGGAACGCAAATCATCA,14,1328983
furpa,5.65,131,19,TCGTTAGCACTTTGTCTTCA,112,1328232
furpa,0.1,20,19,TCGAAAGTCAGCCCGTGTTG,1,1334249
furpa,2.85,75,19,TCCTCTCGTTTCAGCCGAGC,56,1283270
furpa,0.15,21,19,TCATAAGTTATTAACCTGAT,2,1296838
furpa,0.75,33,19,TCATAACTCGAGTACCAATT,14,1288394
furpa,2.0,58,19,TCAGACACGTCACATTTAAA,39,1276107
furpa,0.9,36,19,TCACAAGGGTCGGGAGAGAC,17,1285910
furpa,1.2,42,19,TAGTACGGTTTTGTTTGCAA,23,1289147
furpa,1.0,38,19,TAGGGTGCGTCAGGAAATCC,19,1276611
furpa,1.6,50,19,TAGCGTTTACATTCATTTCC,31,1338801
furpa,0.15,21,19,TAGCGAATCGACGCTACACC,2,1327322
furpa,1.55,49,19,TAGAGCTGGTGTCTTGGACA,30,1315645
furpa,1.25,43,19,TACATAGGCGAATCCATTCT,24,1309107
furpa,1.75,53,19,TACAATTGATTTTAGTCCGC,34,1295935
furpa,0.3,24,19,TAATCAGTCATTTGGAAGGT,5,1282687
furpa,0.9,36,19,TAAGACACGCTCCCGGGAAG,17,1285685
furpa,1.8,54,19,GTTCGCAGAATCTGGGAGCA,35,1337593
furpa,9.8,214,19,GTGGGACCCGGGTCCGTAGA,195,1285661
furpa,1.1,40,19,GTCTTTGCAGCCATTAAGTA,21,1346184
furpa,9.75,213,19,GTCGAGTGGTATTAGTCTCC,194,1280336
furpa,0.5,28,19,GTCCCCCGTCCCGGCTGAGG,9,1339477
furpa,0.75,33,19,GTACCGTTTCGCGGCTACAC,14,1313707
furpa,8.55,189,19,GGTCGTTGAATAGTTATCAG,170,1330908
furpa,0.5,28,19,GGGTTCAGAGTGGGAACACT,9,1338760
furpa,1.95,57,19,GGGGATATACCAGTTAAATT,38,1296839
furpa,0.15,21,19,GGGAAGTACAGCTCTGGCTC,2,1281277
furpa,0.95,37,19,GGACAGCAGTCATTGAATTG,18,1347028
furpa,9.0,198,19,GGAAACGCGTCGCCTAGGCG,179,1285474
furpa,2.4,66,19,GCTTAGGATAAGCGACGTAG,47,1310157
furpa,0.9,36,19,GCTCCAGAATCCGCGTGATC,17,1323293
furpa,9.55,209,19,GCGGTGTTTGGGAAGCTCAT,190,1330158
furpa,0.8,34,19,GCGGGGTTTGCCCAGGGCGA,15,1347061
furpa,1.2,42,19,GCGGCATGAGCCTAGTGGGA,23,1299530
furpa,1.25,43,19,GCGATAGTTTTTTCCATTAA,24,1275648
furpa,0.7,32,19,GCACGTCGAGGCAGACGTTT,13,1275237
furpa,0.1,20,19,GCAATAGTCGGCTGGCCTGC,1,1275644
furpa,0.25,23,19,GATGCACGCGGAGAAGACAC,4,1273636
furpa,0.1,20,19,GATCTGCATGCGGCAGATGT,1,1343532
furpa,4.25,103,19,GAGAGCTTGGAGCATGGTTC,84,1323360
furpa,1.1,40,19,GACGTCCACGGGCGCACCAT,21,1342428
furpa,1.55,49,19,GACAGCGCACTGAGCCAGAT,30,1299065
furpa,0.75,33,19,GAATATCGCTTTTTCATATG,14,1343572
furpa,1.65,51,19,GAACGGAATCGCCCATGTAG,32,1308479
furpa,2.15,61,19,GAAACACGGGAGAATGTCAA,42,1309104
furpa,1.85,55,19,CTTTGCCCGACGTGAGCCAC,36,1299957
furpa,0.6,30,19,CTTTGAGCTGAGACAGAACC,11,1331973
furpa,1.2,42,19,CTTCCTAATTTCTACCGGTA,23,1320998
furpa,0.15,21,19,CTGTATAAGATCGAAAGGTG,2,1325946
furpa,0.1,20,19,CTGGAGCGATACGTATCGCA,1,1274327
furpa,0.4,26,19,CTCTTGCTCCTAGGTTACTA,7,1288008
furpa,2.05,59,19,CTCGGTAGAGAACCGAGTAA,40,1329284
furpa,1.05,39,19,CTCGGGGAATTTTGACATAA,20,1316319
furpa,1.55,49,19,CTCGATCTAGAATCTGAAAG,30,1291184
furpa,0.4,26,19,CTATCGCGGTCAGATCTTCC,7,1312902
furpa,10.2,222,19,CTAATCTGCCAGAAAAACTC,203,1276665
furpa,1.95,57,19,CGTTATATCGAGGAATCACA,38,1284175
furpa,2.1,60,19,CGTGGGATCTATCGAGCAGG,41,1340924
furpa,1.2,42,19,CGTATTGGGTGGGTGAGGAT,23,1293725
furpa,0.25,23,19,CGGCTCCCCTTATGTTTGGA,4,1350578
furpa,0.1,20,19,CGGATGCGCGTGTAAATACC,1,1285488
furpa,1.95,57,19,CGCACCAAGCCACATGCGAT,38,1342635
furpa,1.2,42,19,CGAGCCGACTTCCAAAAGGA,23,1349930
furpa,0.15,21,19,CGAGAGTTCGTTACGATGTA,2,1321052
furpa,0.5,28,19,CGAACGGTGGCTACCTTCCA,9,1281059
furpa,1.1,40,19,CCTGTCTGCTGGGAGTACAA,21,1325055
furpa,2.5,68,19,CCTCCGAATCCGCCGCATGC,49,1278268
furpa,1.95,57,19,CCGGCCGAGCCTTGCCGGCT,38,1340211
furpa,2.95,77,19,CCCTTAATCCTTATGCACGA,58,1312277
furpa,1.25,43,19,CCATTCCTACCAGCTACGAT,24,1285258
furpa,12.7,272,19,CCAATGGGATGGATACGGAG,253,1319561
furpa,3.85,95,19,CATAAGGGCCAGAGAAACTC,76,1300037
furpa,0.8,34,19,CAGCAACCGGCCATGGAGGA,15,1352387
furpa,3.4,86,19,CACTGTCAGTTCTCTATTAA,67,1328325
furpa,2.55,69,19,CACGCGGACCACTGGTACAA,50,1336090
furpa,0.1,20,19,CACGAGCGATCCAATACCAG,1,1349176
furpa,1.45,47,19,CACCTGAGCCAGTATCGTCC,28,1294716
furpa,1.2,42,19,CACCGTCACGTGGTCGCACT,23,1304586
furpa,0.1,20,19,CACAGACGTGTTATCCCAGT,1,1280745
furpa,5.25,123,19,ATTTGTGCCGGTCGTAGATT,104,1290786
furpa,1.1,40,19,ATTGGTAATCTAGCCCTGTC,21,1272808
furpa,0.55,29,19,ATTCTGTGAGCTTGTTGGCA,10,1354040
furpa,0.1,20,19,ATGCTGGTTTTCTGATTGCA,1,1316380
furpa,1.9,56,19,ATGCGATCAGATAGGCGCCA,37,1337284
furpa,2.05,59,19,ATGAGCGTCCTGCCATACAA,40,1334344
furpa,1.55,49,19,ATCTGCGTTCCCATCACACA,30,1279934
furpa,1.7,52,19,ATCTCCTGTGCTGGGAACGA,33,1279450
furpa,1.1,40,19,ATCATATCGCTAGCAGTCCT,21,1324570
furpa,5.35,125,19,ATAGCAGGGACCAAAGACGC,106,1307535
furpa,0.55,29,19,ATACTATTGGGTAAAAATTC,10,1278559
furpa,0.2,22,19,ATACTACGAGTAAGGAGCTA,3,1324500
furpa,9.95,217,19,AGTTGCTAGCCGATCAGATT,198,1331788
furpa,2.3,64,19,AGTGAGCCAATTCCTCCGCT,45,1271175
furpa,2.05,59,19,AGTATAAAACCCTACTAAGA,40,1315247
furpa,2.6,70,19,AGTAGGCGTGAGCCTAGTGT,51,1351341
furpa,2.4,66,19,AGGTACTCGTATTACTCCCA,47,1342438
furpa,2.35,65,19,AGAGTATCCTGGAAATAGTC,46,1341832
furpa,4.05,99,19,AGACAACCAGACCTCCGGCA,80,1330058
furpa,1.1,40,19,ACTGCTGCCTGGGTGCTAAT,21,1274793
furpa,0.8,34,19,ACTGCCAAAGAGAACTCCAA,15,1343542
furpa,0.7,32,19,ACTCTAACGCGCAAATTGTA,13,1290992
furpa,0.1,20,19,ACTCCAAATCGACGGAATCG,1,1279876
furpa,1.6,50,19,ACTATGGATTCGGCTGCGCG,31,1276367
furpa,0.1,20,19,ACGTTAGTCGGGGCAGTTGA,1,1272590
furpa,4.65,111,19,ACGTCTAATATGGTGCTATT,92,1279029
furpa,0.1,20,19,ACGCTCGATGTTACAGTACG,1,1303790
furpa,0.3,24,19,ACGCGTCAATGTATTGGTGC,5,1306976
furpa,0.5,28,19,ACGAGAAATCCAAGGGGCCT,9,1305734
furpa,0.5,28,19,ACCCCTAGGCTGCGAGAATC,9,1280934
furpa,3.6,90,19,ACCAGGAGAGGCGGGACGCC,71,1290013
furpa,0.15,21,19,ACATGATCCTTTAAGACAGA,2,1314688
furpa,1.8,54,19,ACATAACGGAAAACAGCTAG,35,1336666
furpa,2.35,65,19,ACAGGTCGGAGATGTCGTCC,46,1296439
furpa,0.5,28,19,ACACTGCACAGTATGACTCT,9,1284760
furpa,1.65,51,19,AATGAACGGTGAATCCTGTT,32,1290314
furpa,0.5,28,19,AAGCATGCATGGTATTGCAT,9,1298575
furpa,2.05,59,19,AACGGTTTGTGGAATGCATG,40,1272502
furpa,0.5,28,19,AACGCTTGGTGACGCTGACG,9,1349478
furpa,1.5789473684210527,47,18,TTTTTTTCCTAGAGGCAAGA,29,1337346
furpa,0.47368421052631576,26,18,TTTTGTTTGTCCCAAAGGTC,8,1326438
furpa,1.736842105263158,50,18,TTTGGGCAGACCGACGTGCA,32,1323469
furpa,1.368421052631579,43,18,TTTAGTCCGCTTAAGGGACT,25,1304497
furpa,2.0526315789473686,56,18,TTCTCCGAAATTGAAATACG,38,1323800
furpa,3.3157894736842106,80,18,TTCCATCACTATCGGCCCGG,62,1291661
furpa,2.210526315789474,59,18,TTATCTTCCGCGGTGCCACT,41,1298824
furpa,0.15789473684210525,20,18,TTAGCTCTATTGGCCGGATG,2,1306777
furpa,1.263157894736842,41,18,TTAAAGAATCGAATCTCAAG,23,1280909
furpa,0.10526315789473684,19,18,TGTGTGGAATGCGGCGCTCT,1,1345589
furpa,0.6842105263157895,30,18,TGTGGTTTCCTCGCCCGCCC,12,1350598
furpa,2.0,55,18,TGTGATACCGGTTGGCACAG,37,1286364
furpa,10.105263157894736,209,18,TGGGAGCGTTTTGAGTGGTA,191,1329270
furpa,3.263157894736842,79,18,TGGGAAGCATTCGGGATTTT,61,1321477
furpa,0.15789473684210525,20,18,TGCTTTGACCCAGCGGTTTT,2,1302065
furpa,6.842105263157895,147,18,TGCGTGAGTGTATTTCTATA,129,1310975
furpa,0.21052631578947367,21,18,TGCAGCCGGTTCTTTAAGAA,3,1284473
furpa,0.6842105263157895,30,18,TGCAAGTGAACAGAGTTTGG,12,1341933
furpa,0.42105263157894735,25,18,TGATGCCGTACCATCATGTT,7,1345563
furpa,0.15789473684210525,20,18,TGATGCCACGCAGTAAGGGC,2,1303573
furpa,1.4210526315789473,44,18,TGATAGACGCGGCGTGTGTG,26,1294560
furpa,0.10526315789473684,19,18,TCTTGCTCCATAGAAATCTG,1,1305240
furpa,0.10526315789473684,19,18,TCTTGCAAAGAACTTTGTCC,1,1316147
furpa,0.7368421052631579,31,18,TCTGATCGTATTTTTCCATT,13,1330940
furpa,4.7894736842105265,108,18,TCTCGTTAATACAAGGAGGG,90,1335995
furpa,1.263157894736842,41,18,TCGCCGCCCCTCACTATGCT,23,1349794
furpa,1.0526315789473684,37,18,TCCGTTGAGGAAGTAGACCC,19,1334935
furpa,0.6842105263157895,30,18,TCAGATCTCACCAGCTCATA,12,1335683
furpa,0.10526315789473684,19,18,TATGCATTGTTGTGGAGTAT,1,1280101
furpa,0.10526315789473684,19,18,TATCAAATAGCGCGCACCCT,1,1308411
furpa,4.947368421052632,111,18,TATACCCTGCGACAGTAAGC,93,1338745
furpa,0.2631578947368421,22,18,TATACCAGGTTGCGCGATGC,4,1352076
furpa,0.10526315789473684,19,18,TAGAACCCTATAGACTGCCG,1,1319141
furpa,0.15789473684210525,20,18,TACTGTACAAGTCTGACTCC,2,1273908
furpa,0.10526315789473684,19,18,TACGCGAGCATGACCAACAA,1,1353064
furpa,0.8947368421052632,34,18,TACCGACCCGATACCGCACT,16,1346696
furpa,0.10526315789473684,19,18,TACAGTCGCCAACCACAGCT,1,1341834
furpa,1.0526315789473684,37,18,TAAGGAGGCCTCAGTCGTCC,19,1283772
furpa,1.0526315789473684,37,18,TAAGCGTATTCGAAAACAAT,19,1354056
furpa,0.15789473684210525,20,18,TAACGTCAAACGGGCCAGGT,2,1354443
furpa,0.5263157894736842,27,18,GTTGGTGCGAATATGTGTTG,9,1303866
furpa,0.42105263157894735,25,18,GTTGACTTTCCTTTTCGGAC,7,1308290
furpa,5.842105263157895,128,18,GTTATGCTGAGGGTAGTTGC,110,1298637
furpa,1.631578947368421,48,18,GTTACTTCAACTCTTTTTCG,30,1291588
furpa,0.10526315789473684,19,18,GTGTAAGCCTCGGTCGAAGT,1,1345013
furpa,1.3157894736842106,42,18,GTGGCAACGCATTCTGGAGT,24,1324240
furpa,0.9473684210526315,35,18,GTGCATGAATGCTCTTGAAA,17,1304960
furpa,7.421052631578948,158,18,GTCTTGTCCTTCGCACGTTT,140,1336982
furpa,6.0,131,18,GTATCGGTCTATCCAAAAAC,113,1311078
furpa,1.368421052631579,43,18,GTAGTTGTATGAATCATATC,25,1295568
furpa,2.1052631578947367,57,18,GTAGATGTTCTTCGGACCAT,39,1341694
furpa,0.15789473684210525,20,18,GTACGCAAAGGGGTGACAGT,2,1289220
furpa,1.4736842105263157,45,18,GTACATCCCTGGTGTCGGAT,27,1302817
furpa,0.2631578947368421,22,18,GGTTTGTGCCCTACCAAGAC,4,1319480
furpa,2.1052631578947367,57,18,GGTTGACTTTAGTCGGGAAG,39,1335196
furpa,1.0,36,18,GGTTCCAGCGATTGGTTCTA,18,1351444
furpa,2.1578947368421053,58,18,GGTGTGACCATCATGCAGTG,40,1339131
furpa,1.6842105263157894,49,18,GGTGACTGCTTGTGCATCTT,31,1355753
furpa,0.8421052631578947,33,18,GGGGTAGGTTGGGATACGAT,15,1347632
furpa,0.3157894736842105,23,18,GGGGAACGCAGGGGAGAAGG,5,1325661
furpa,0.10526315789473684,19,18,GGGCCATATTCTACAGGCAA,1,1284445
furpa,2.1052631578947367,57,18,GGCTACCGACCGGAATCTTA,39,1276239
furpa,0.21052631578947367,21,18,GGCCTCTACAGGATACTAGC,3,1288270
furpa,0.10526315789473684,19,18,GGCAGAAAACTGATAAAATA,1,1288745
furpa,3.1052631578947367,76,18,GGAGACCCATCAAATTTAAA,58,1327887
furpa,1.0526315789473684,37,18,GGAAAGCGGCGAGGGCAACT,19,1335796
furpa,0.10526315789473684,19,18,GCTTATCTCCACATAGCGTC,1,1286389
furpa,0.21052631578947367,21,18,GCTTAGGCAGCAATCTTTCA,3,1303967
furpa,0.631578947368421,29,18,GCTGTAGTCTTTAGTCCTGT,11,1356975
furpa,0.15789473684210525,20,18,GCTCGTTCGTAGCGGTCTTG,2,1321411
furpa,0.15789473684210525,20,18,GCTACGAGTGTGGATAACGG,2,1309481
furpa,0.8947368421052632,34,18,GCGTAGTTCAGACTCCGCTT,16,1273075
furpa,1.263157894736842,41,18,GCCGCCTGTTAAGAGCGCGC,23,1282697
furpa,0.9473684210526315,35,18,GCCCAACGCGAGTGTCACTG,17,1308284
furpa,0.8947368421052632,34,18,GCCAGGTAAGTACCGCTATA,16,1330672
furpa,1.631578947368421,48,18,GCAATCCCGATTGCGGTGTA,30,1312237
furpa,0.6842105263157895,30,18,GATTAGTTTAAGCGCGGGCA,12,1279716
furpa,0.10526315789473684,19,18,GAGTTCGGTAACCAATTCGG,1,1297999
furpa,2.3157894736842106,61,18,GAGTACCGGCGCGGAACTCT,43,1278598
furpa,0.5789473684210527,28,18,GAGATTTTGGATGGTAGACA,10,1349067
furpa,1.894736842105263,53,18,GAGATTCAGGCTTGTCACGC,35,1285002
furpa,0.9473684210526315,35,18,GACTTGTGAATCAGGTTATA,17,1307375
furpa,0.5789473684210527,28,18,GACCCTCCGCGATACGCAAT,10,1283069
furpa,0.10526315789473684,19,18,GACATGTAACTGCCTACCAG,1,1299197
furpa,3.4210526315789473,82,18,GACATCCCGTCTCAATTCAG,64,1303566
furpa,0.10526315789473684,19,18,GACAGGGTTCATGTCGTCAG,1,1279027
furpa,0.7894736842105263,32,18,GAATACATCGCGAAAGGTTG,14,1355864
furpa,2.1578947368421053,58,18,GAAGTTCGAGTGCACTCCGT,40,1314755
furpa,1.1578947368421053,39,18,CTTGCTGTCGAAACTACTCC,21,1280458
furpa,0.2631578947368421,22,18,CTGTGCACAGTACCATTCCG,4,1319776
furpa,2.3157894736842106,61,18,CTGGACCTACCGCCGGGTGT,43,1277358
furpa,1.3157894736842106,42,18,CTCTGGTTCGTATATAAAAG,24,1276228
furpa,0.8421052631578947,33,18,CTCGTATCACGATAGCCCGA,15,1292752
furpa,0.15789473684210525,20,18,CTACCTAAGGAACAACGGAT,2,1312484
furpa,0.10526315789473684,19,18,CTACCCGGGCGCAAGGTGGA,1,1303117
furpa,2.5789473684210527,66,18,CGTGTACACGGAAACAAGCA,48,1305273
furpa,1.2105263157894737,40,18,CGTGAGAGCGGCACGTCCGT,22,1346081
furpa,1.105263157894737,38,18,CGTACGCTCAGCGCTGGCAG,20,1341240
furpa,0.10526315789473684,19,18,CGTACACCAAGTTATGTAGC,1,1283962
furpa,1.5263157894736843,46,18,CGGTTAAAAAGTCTCGGGAA,28,1339306
furpa,1.8421052631578947,52,18,CGGTGTGCACAGTTGTTAAT,34,1352212
furpa,0.10526315789473684,19,18,CGGTGTCAATAGCCATTTAC,1,1283795
furpa,3.6315789473684212,86,18,CGGCCCGATAAAAGATTGAT,68,1288527
furpa,0.10526315789473684,19,18,CGGATATCACACTAACGGAA,1,1282683
furpa,0.47368421052631576,26,18,CGCTCAAGAATTTTCTTGTC,8,1307524
furpa,0.3684210526315789,24,18,CGAGCATGTCCAGAGTATGA,6,1357041
furpa,0.5789473684210527,28,18,CGACTCGGTTAGGGGAAGAG,10,1330049
furpa,0.7894736842105263,32,18,CGACCTCCCTCGGTGGATTT,14,1294410
furpa,0.10526315789473684,19,18,CCTTCCCTAAGAATGTGTGA,1,1349198
furpa,1.0526315789473684,37,18,CCTCAGTCACCCCCACTAGA,19,1288018
furpa,0.3684210526315789,24,18,CCTAGGCGAGAAGGGTCACT,6,1344387
furpa,0.8947368421052632,34,18,CCTAGAGGGACATCGAAATA,16,1331676
furpa,5.0,112,18,CCGTGATAAAGGGCGACGCG,94,1328031
furpa,0.42105263157894735,25,18,CCGTAGGTTCCCGTTAGGGC,7,1349986
furpa,2.6315789473684212,67,18,CCGGGAAAATCAGGTGTAAG,49,1301622
furpa,0.7894736842105263,32,18,CCGCTCTACGAAGAAGTCTA,14,1284259
furpa,1.263157894736842,41,18,CCGCGGGTCTTCAGCTTCCC,23,1345305
furpa,4.368421052631579,100,18,CCGATAGTGAGGTGGTCGCG,82,1272858
furpa,7.526315789473684,160,18,CCCAGGTGTCACGTGTCGTT,142,1273073
furpa,0.10526315789473684,19,18,CATTTTTCTGTGGAGCGGCC,1,1321726
furpa,2.3684210526315788,62,18,CATTGGAATCTGGAAGGAGC,44,1276373
furpa,0.10526315789473684,19,18,CATTCAGTCATATTTCTATG,1,1332850
furpa,0.10526315789473684,19,18,CATGCTTGGATAGACATTAA,1,1356226
furpa,0.21052631578947367,21,18,CATCCTCACTAAAATGCGCT,3,1345854
furpa,0.10526315789473684,19,18,CATCCGTGTGACAACCCGGG,1,1281395
furpa,1.7894736842105263,51,18,CAGTAGGACACGAAGTTTAC,33,1340258
furpa,0.10526315789473684,19,18,CAGGTTATGACAAAGGCCGA,1,1303051
furpa,0.10526315789473684,19,18,CAGGGCTCTTTCATTTCATG,1,1322546
furpa,3.8421052631578947,90,18,CAGATCTAGTTGTCTCACAG,72,1325964
furpa,0.3684210526315789,24,18,CAGATCGGGCTGTGGAATCC,6,1328359
furpa,0.10526315789473684,19,18,CAGACCCAGGGAGGTACTAT,1,1301617
furpa,0.10526315789473684,19,18,CACTTCCAGAGCGAACATCA,1,1271984
furpa,1.736842105263158,50,18,CACGGGGTACTTCATATCAG,32,1351646
furpa,0.10526315789473684,19,18,CACACCGAAATCGAAATTTT,1,1287885
furpa,0.10526315789473684,19,18,CAACTGTGAGGGAACTCAGC,1,1352954
furpa,2.9473684210526314,73,18,CAACAATGGTACGGAATTTA,55,1334056
furpa,0.3684210526315789,24,18,CAAATTCGTGACCATCAAGA,6,1283448
furpa,0.5789473684210527,28,18,CAAACCGAAATTTAGTGTAT,10,1352710
furpa,0.9473684210526315,35,18,CAAACCCAAAGCACTCGAGT,17,1302996
furpa,0.3684210526315789,24,18,ATTCCAGGCCATACGCAGCG,6,1338789
furpa,2.5789473684210527,66,18,ATACATCACTATGAGTACAG,48,1354562
furpa,3.6315789473684212,86,18,ATAACTCTTATATCCCTGCA,68,1300072
furpa,1.7894736842105263,51,18,ATAACGTGATCTTTCGGAGT,33,1294995
furpa,0.3684210526315789,24,18,AGGCTCTGGTTTCCTATGTA,6,1341830
furpa,0.10526315789473684,19,18,AGGAACATTTCCTGTTCCCA,1,1335517
furpa,0.7368421052631579,31,18,AGCTAGAGTCTTGTTGCGAT,13,1338974
furpa,1.4210526315789473,44,18,AGCGCCATAGTTGTTTTTTA,26,1279178
furpa,3.0526315789473686,75,18,AGCCGTACCGAGCTGAAGTG,57,1341354
furpa,0.3157894736842105,23,18,AGCCCTCCATTGATTATTCA,5,1348527
furpa,1.263157894736842,41,18,AGAGTATAATTCGCCTTTAC,23,1303970
furpa,1.4210526315789473,44,18,AGACTGTGTCAGACGATAAC,26,1279364
furpa,2.526315789473684,65,18,AGACAGCCCTTGGGCGTACA,47,1304233
furpa,3.263157894736842,79,18,ACTTCGTTGGTCCCTAAGCT,61,1271332
furpa,0.10526315789473684,19,18,ACGCGTAGTACACATCCGGC,1,1311513
furpa,0.9473684210526315,35,18,ACGCGGCGGCCAATCCTAGA,17,1278130
furpa,0.21052631578947367,21,18,ACCTTCGGCTGGACAATACA,3,1337826
furpa,5.0,112,18,ACAGCTTAAAGCTATAGGTT,94,1296984
furpa,0.10526315789473684,19,18,ACAGAAGCCCTGTGTAAGTG,1,1306741
furpa,3.1052631578947367,76,18,AATTACCTAAACAGCAATGG,58,1311358
furpa,0.47368421052631576,26,18,AAGGCACAACGAGATAGGGT,8,1348774
furpa,2.5789473684210527,66,18,AAGAGCTGAAGATATAGGTA,48,1305368
furpa,0.8421052631578947,33,18,AAGAAATTGCCAGGGATTTT,15,1345126
furpa,0.2631578947368421,22,18,AACTACCACGCAGCACTAGA,4,1276223
furpa,4.421052631578948,101,18,AACGCCCCATGGTACTGTGT,83,1307667
furpa,4.421052631578948,101,18,AACCCCCGGAGCCTGGACGA,83,1317168
furpa,1.4736842105263157,45,18,AACAGAGACTGATTGTAAGA,27,1282696
furpa,1.368421052631579,43,18,AACAAGGCCCTGAGTTCACT,25,1301268
furpa,0.21052631578947367,21,18,AAAGTGTGATTAAGGTACAC,3,1276424
furpa,0.8888888888888888,32,17,TTTTATGGTCGGCTCGGGGT,15,1302586
furpa,2.0,52,17,TTTGGTGCCGGCTTCCTGCA,35,1320648
furpa,2.2777777777777777,57,17,TTTCCGCTGTTGGATCCTTC,40,1281973
furpa,0.1111111111111111,18,17,TTCAGGCAATAAGATGAGGA,1,1324125
furpa,0.1111111111111111,18,17,TTATCCGCACCTATTAGCGT,1,1276123
furpa,0.1111111111111111,18,17,TTAACATAAGCTCGAGGTGT,1,1321597
furpa,8.61111111111111,171,17,TGTCAATTGAGATCTCCCTA,154,1287654
furpa,0.3888888888888889,23,17,TGGTTTTTCAACACAAGGGG,6,1278760
furpa,0.1111111111111111,18,17,TGGGGGTAAGAAGTCGCTGG,1,1286327
furpa,4.444444444444445,96,17,TGGCTCGCCCCAGCAGTATC,79,1334052
furpa,0.6111111111111112,27,17,TGGCGCTACGGAGCAACTCC,10,1280193
furpa,3.1666666666666665,73,17,TGGCAAACCAATGGTGTGCA,56,1308848
furpa,10.222222222222221,200,17,TGCTTCGGGGGTATCGTGGA,183,1311574
furpa,0.3888888888888889,23,17,TGCTATACATGTAGTGGCAA,6,1290892
furpa,0.1111111111111111,18,17,TGCGTGTGAGCAGTCTGATG,1,1279609
furpa,6.0,124,17,TGCGCCCCGCTTGACAGAAA,107,1292442
furpa,1.7222222222222223,47,17,TGCGCAACTGTTTAGTGAGG,30,1324112
furpa,0.2222222222222222,20,17,TGCGATTATCTTTTAATAGG,3,1298027
furpa,0.2777777777777778,21,17,TGCAAGCGATCTTTCTGAAT,4,1300466
furpa,2.7777777777777777,66,17,TGAGTGGATATGACGGTGCC,49,1309215
furpa,0.1111111111111111,18,17,TCTTAGTGCGCTCTAAACCT,1,1294600
furpa,3.6666666666666665,82,17,TCTAGGTAACACATGTGCAG,65,1307892
furpa,0.2222222222222222,20,17,TCTAGGCGGCGCTCACGAGC,3,1304604
furpa,0.5555555555555556,26,17,TCTAAAAGCGTAAACAAGGT,9,1332403
furpa,3.388888888888889,77,17,TCCCGTAGTTCGAGGTCCAT,60,1291481
furpa,1.6666666666666667,46,17,TCCCGCAGTACGCCGCAGGC,29,1354057
furpa,0.1111111111111111,18,17,TCCACCCGATATCTCTTATG,1,1304192
furpa,1.1666666666666667,37,17,TCCAATCGGCGTAACATATT,20,1341191
furpa,1.5,43,17,TCAGATAGGTCTATGGGTAC,26,1349260
furpa,0.7222222222222222,29,17,TCACTCCAAAGTCCAAATCT,12,1271289
furpa,2.7777777777777777,66,17,TCACGGCCTCCTAAGCCGTT,49,1316524
furpa,0.4444444444444444,24,17,TCAATGTCATCAAGAATGAC,7,1332012
furpa,1.5555555555555556,44,17,TATTTAACGGCCCGCGCTAC,27,1292527
furpa,0.3333333333333333,22,17,TATGTTCTGCGGGTCCTATA,5,1341823
furpa,2.7777777777777777,66,17,TATGATAATTAGTGGTTCCA,49,1326428
furpa,0.1111111111111111,18,17,TAGGCGTAATTGTAGTATGC,1,1290653
furpa,0.5555555555555556,26,17,TAGCTACGGTCGTCGGTGGT,9,1317522
furpa,1.2777777777777777,39,17,TAGACGACGAAGACTCGGAG,22,1306515
furpa,2.111111111111111,54,17,TACTTTCTTGGCAGAGCTTC,37,1293947
furpa,1.0,34,17,TACTTGGGGGCTTAGGGAAC,17,1324194
furpa,5.111111111111111,108,17,TACCATCGAGTGTGTGGTTA,91,1338485
furpa,0.8888888888888888,32,17,TACAACTTGAACGTTATCCT,15,1339942
furpa,1.1111111111111112,36,17,TAATGGCTGTTGTAATCTTA,19,1291799
furpa,0.16666666666666666,19,17,TAAGCACACCAAGGCCCTGG,2,1310897
furpa,1.0,34,17,GTTGTAGACCTAGTGTTACC,17,1277095
furpa,0.16666666666666666,19,17,GTGTAATTAGGAGAGTGGTC,2,1303473
furpa,6.944444444444445,141,17,GTGGGACTCAGACTCCACCA,124,1288218
furpa,0.6111111111111112,27,17,GTGGCCATGCTGGAGTGGCA,10,1339295
furpa,0.16666666666666666,19,17,GTCTGTAACCCTTATAGTAG,2,1284590
furpa,1.6666666666666667,46,17,GTCGTCACGTATAAATTTGT,29,1332783
furpa,7.166666666666667,145,17,GTACCGCAGTAATAGGGCTT,128,1329485
furpa,1.0555555555555556,35,17,GTACACGTTTGAGGCTACGA,18,1336122
furpa,0.7222222222222222,29,17,GGTTCATTCCAAGTCGTGTG,12,1288195
furpa,2.111111111111111,54,17,GGTTAGGAGCGATTAGACTT,37,1335105
furpa,0.1111111111111111,18,17,GGTATCGAGATAGCCTGGCT,1,1304035
furpa,4.777777777777778,102,17,GGTACAGCGGAAAAGTTTTA,85,1331792
furpa,0.7777777777777778,30,17,GGCTGTAGTTATGTGTAAAA,13,1305360
furpa,1.1111111111111112,36,17,GGCTGCGGGAATTAGGAACA,19,1295059
furpa,0.6111111111111112,27,17,GGCCATAAAAGTATAGAGTG,10,1316702
furpa,0.1111111111111111,18,17,GGATGATCGACCGCACAACG,1,1318610
furpa,1.3888888888888888,41,17,GGAGTGAGCAGGGCCTCGAG,24,1311525
furpa,3.8333333333333335,85,17,GGACGGTTACTACAGGGTCG,68,1296972
furpa,2.2222222222222223,56,17,GGAATGCATGTAGACTCAGC,39,1327885
furpa,1.0,34,17,GGAAAAGGCGGAAGGATTTA,17,1303181
furpa,0.4444444444444444,24,17,GCTCGGTTACGGTATCCATT,7,1299950
furpa,1.4444444444444444,42,17,GCCTTTCCCGCATCAGCACG,25,1278929
furpa,2.388888888888889,59,17,GCCGTGTGACAGAGCTAAAA,42,1280155
furpa,0.1111111111111111,18,17,GCCCTTTCAAAGAGACGCCT,1,1294677
furpa,1.7777777777777777,48,17,GCCCTAGGCGAGTGATCTAT,31,1272340
furpa,0.1111111111111111,18,17,GCATGATACTTCCATGGGGA,1,1315920
furpa,0.4444444444444444,24,17,GCATCTGGATTGTCCATCTC,7,1298835
furpa,1.1666666666666667,37,17,GCACAGGTATTCATGTTCTA,20,1304552
furpa,0.4444444444444444,24,17,GATGGCCATAATTTCGCACT,7,1295723
furpa,1.1666666666666667,37,17,GATGCAGGTATTTATAGAAG,20,1332778
furpa,0.1111111111111111,18,17,GATACTGAGGTTCGATGTTC,1,1275240
furpa,0.5,25,17,GAGCCGATGCAGGGTGGGCA,8,1328442
furpa,4.444444444444445,96,17,GAGACTGGCCTATACGAATC,79,1327324
furpa,0.8333333333333334,31,17,GACTAGCAACACTTATGTAA,14,1272901
furpa,1.8333333333333333,49,17,GAATCCGTATGCCATTACCG,32,1306598
furpa,1.2777777777777777,39,17,GAATAAACTGTCTAATTCTT,22,1289023
furpa,0.1111111111111111,18,17,GAAGCTGGTCTGTCCCCTAT,1,1356982
furpa,3.3333333333333335,76,17,GAAGACCGAGATAGTACTAC,59,1284839
furpa,1.4444444444444444,42,17,GAACGACCAGTGCATTTGAG,25,1309991
furpa,1.2777777777777777,39,17,CTTGTGTTGTAGTTTGTTGG,22,1314964
furpa,0.5555555555555556,26,17,CTTGAACACTCGACGTTGCC,9,1305298
furpa,1.9444444444444444,51,17,CTTATGCTTGTTTTGTACAT,34,1289606
furpa,0.9444444444444444,33,17,CTGGTTGGAGATAAGGCGAA,16,1280260
furpa,0.1111111111111111,18,17,CTGCGGTATCGATTTGAAGG,1,1305253
furpa,2.2222222222222223,56,17,CTGCGAAATGGGTCAAGTAA,39,1323657
furpa,8.11111111111111,162,17,CTCTCATCCCAGCGGTTAGT,145,1321007
furpa,0.7777777777777778,30,17,CTCCTAGGATCTCAGAAGGT,13,1335205
furpa,2.9444444444444446,69,17,CTCCGATGTTGTGGAATCCT,52,1337875
furpa,0.3888888888888889,23,17,CTATCGATATTCACGTAGTA,6,1325079
furpa,1.7222222222222223,47,17,CTATCACGCCAACTGGGACA,30,1292378
furpa,3.111111111111111,72,17,CTAGATATTGGTAAACTTAG,55,1276879
furpa,2.0,52,17,CTAAGGCCTAACCGGTTCCA,35,1281510
furpa,0.3333333333333333,22,17,CGGGGATTCCAAAGGCCCTA,5,1291817
furpa,2.1666666666666665,55,17,CGGATCCAACTACTCGCCAA,38,1325065
furpa,0.16666666666666666,19,17,CGGAAAAATCTGTACAGGGC,2,1352457
furpa,0.1111111111111111,18,17,CCTTTGGTGGCATGCATAAG,1,1349654
furpa,1.9444444444444444,51,17,CCTCGGGCGCTTCGTAGATC,34,1337577
furpa,2.0,52,17,CCTCAACATCATGGTACTTC,35,1299349
furpa,1.3888888888888888,41,17,CCGGCAGAAGGGTTAAGCTC,24,1334140
furpa,0.5555555555555556,26,17,CCCTTTCGCCGGCCTACTGG,9,1296764
furpa,0.1111111111111111,18,17,CCCAATTCTACTAGCGATAG,1,1317567
furpa,5.166666666666667,109,17,CCAGGGGACCAACGAGCGAA,92,1340841
furpa,0.9444444444444444,33,17,CCACCCGCGATCAACTCCGA,16,1322367
furpa,1.8333333333333333,49,17,CCAACACTTGGGAACTATCA,32,1335100
furpa,0.16666666666666666,19,17,CATGAAAACAGAGACTGGGT,2,1276994
furpa,0.8333333333333334,31,17,CAGTTAGTAGGTGAGTCCGA,14,1293763
furpa,0.7777777777777778,30,17,CAGGCAGAGAGCTACGGTTA,13,1278597
furpa,0.5555555555555556,26,17,CAGCTGGTCGTATTGGGAAG,9,1325294
furpa,0.4444444444444444,24,17,CACTGCCTAAGGGTACGGGA,7,1281515
furpa,15.944444444444445,303,17,CACGGTTCTTCTTGTCGGCA,286,1312538
furpa,0.7777777777777778,30,17,CACGGCGCCACGAGGCGAGA,13,1338118
furpa,0.1111111111111111,18,17,CACCCAGTATATGAGGGGAT,1,1334984
furpa,8.722222222222221,173,17,CACCACGGAGTGCTACGCTC,156,1329517
furpa,0.4444444444444444,24,17,CAACAGGGGACTGGATGCAT,7,1286997
furpa,1.7777777777777777,48,17,ATTTTACCAGACAAGCAAGG,31,1357447
furpa,0.1111111111111111,18,17,ATTGGACGCTTACCCCCATT,1,1349572
furpa,0.6666666666666666,28,17,ATTCTACGTCTAACGAAGGG,11,1331408
furpa,1.4444444444444444,42,17,ATTAGTCTAAAGCATTCAGA,25,1281327
furpa,1.3333333333333333,40,17,ATTAAAACGGGCTTAATGGA,23,1322077
furpa,0.7222222222222222,29,17,ATGCTAGGCGAGGCACTAGA,12,1313717
furpa,1.8333333333333333,49,17,ATGACGTGCTAAATAACCAA,32,1330112
furpa,0.7777777777777778,30,17,ATATTCCAATCACGGCCCAT,13,1283888
furpa,1.0,34,17,ATATGTGGAGGATTATTGGC,17,1298206
furpa,3.4444444444444446,78,17,AGTCACAAGGGGTCCTTCGT,61,1331029
furpa,1.9444444444444444,51,17,AGGGACGATTTCTGTATTCA,34,1305631
furpa,0.1111111111111111,18,17,AGGCAGTACACCGTGCTCGA,1,1286178
furpa,1.6111111111111112,45,17,AGGACCATACCTAACTCGAA,28,1352945
furpa,0.7777777777777778,30,17,AGCTCAAACACCAGGCTAAC,13,1323669
furpa,0.16666666666666666,19,17,AGCCTAGCAACGCTCAACTC,2,1290529
furpa,0.3888888888888889,23,17,AGCCGGACATGTATGCAAGT,6,1301830
furpa,0.6111111111111112,27,17,AGCCATCAGTCTGGCAAAAA,10,1294705
furpa,0.5,25,17,AGCAGCGTAAGGCGTCGCGC,8,1311511
furpa,0.1111111111111111,18,17,AGACTCGGACGATCATTTTT,1,1305569
furpa,1.1111111111111112,36,17,ACTTTTATAAACCTACATTA,19,1350702
furpa,0.5,25,17,ACTGGGCACTGGCGCATCAC,8,1319026
furpa,2.8333333333333335,67,17,ACTACGAAACTTTGGGGGCT,50,1333457
furpa,0.1111111111111111,18,17,ACTAACAGTATGTGCCGCTA,1,1271623
furpa,0.7222222222222222,29,17,ACGGGTACATTAGCAGCCTT,12,1314624
furpa,0.3333333333333333,22,17,ACGGGGACCATCACATACAT,5,1342276
furpa,1.1111111111111112,36,17,ACGGGAGGGCCTCGACCGCT,19,1315091
furpa,2.5555555555555554,62,17,ACGAGACCAATGTTAAGGCT,45,1314933
furpa,0.1111111111111111,18,17,ACCGATTAACTAGCCGTGGT,1,1293497
furpa,0.5555555555555556,26,17,ACCACACTGATAGCTATGCA,9,1282879
furpa,0.2777777777777778,21,17,ACACAGTGCTCCGCACCAGA,4,1298769
furpa,1.1666666666666667,37,17,ACAATGCAAGCCCGCCGTGT,20,1280002
furpa,1.0,34,17,AATTCGCGCCTAAGCATTTA,17,1300484
furpa,1.5,43,17,AATCTGTCAGAATGAACGTA,26,1345736
furpa,3.2222222222222223,74,17,AATCAGAGTATTGTGATATG,57,1281877
furpa,1.6666666666666667,46,17,AATCACTCCAGAAGCGACGC,29,1331358
furpa,2.5,61,17,AATATTTGCATTGGGTTTAC,44,1280755
furpa,3.611111111111111,81,17,AATAAGTCACGCAACGACTA,64,1351578
furpa,3.1666666666666665,73,17,AAGTCTTGTAAATTCTCTTC,56,1288396
furpa,2.111111111111111,54,17,AAGTCACCAGGCCGGAACGC,37,1290240
furpa,0.3333333333333333,22,17,AAGGAGTATTTTATCTCCAA,5,1325799
furpa,1.8333333333333333,49,17,AAGCCGGTCTGGGTGCTGTA,32,1295425
furpa,2.611111111111111,63,17,AAGATAGTGTGGACATCCAT,46,1311712
furpa,1.5,43,17,AAATCCGCGCCGTAAGTGGA,26,1324210
furpa,0.3333333333333333,22,17,AAACGAGGTTGCTAACACAT,5,1314246
furpa,0.3333333333333333,22,17,AAACCGAACTTCTCCTCGAC,5,1299189
furpa,1.5555555555555556,44,17,AAAACGGCGCGGGCCAGCCC,27,1281400
furpa,0.8823529411764706,30,16,TTTCTAATATGGGACTTCTC,14,1331081
furpa,0.6470588235294118,26,16,TTTATGGAGCGAGATTCGGC,10,1337014
furpa,0.8235294117647058,29,16,TTCTAAAGCCGGTGTCATTA,13,1328647
furpa,1.5294117647058822,41,16,TTCCGAACTAATCTAATACT,25,1334154
furpa,0.11764705882352941,17,16,TTCCCTGTGCGGCGAAGAAA,1,1333328
furpa,2.764705882352941,62,16,TTCATTTCGGTTGCAGCTTG,46,1283546
furpa,1.9411764705882353,48,16,TTCATAATATAATCCGCAGC,32,1288330
furpa,1.8823529411764706,47,16,TTAAGCATCCGGGGAGAGTC,31,1271665
furpa,1.1176470588235294,34,16,TGTTGTCCGGGTCGGAGAGA,18,1322157
furpa,3.764705882352941,79,16,TGTTAGCTTCAGGAAGACCA,63,1341040
furpa,1.9411764705882353,48,16,TGTTAGCTTACCTGAAGCGT,32,1326826
furpa,1.1176470588235294,34,16,TGTGTTTTGCACAACTACTG,18,1350589
furpa,2.6470588235294117,60,16,TGTGTATGAGCTAGATTAGC,44,1332862
furpa,0.23529411764705882,19,16,TGTGAAGTGTGGGATCGAAA,3,1329847
furpa,0.11764705882352941,17,16,TGTCTGAGATTTGGTTCGGT,1,1302283
furpa,1.0,32,16,TGGTAGGCGCTCGAACAGCG,16,1296738
furpa,0.17647058823529413,18,16,TGGGTTACTATCACTGGGAT,2,1282893
furpa,0.11764705882352941,17,16,TGGGACAAGCAATACTACCT,1,1324563
furpa,0.11764705882352941,17,16,TGGCCTACACAGGTTGTGAA,1,1294699
furpa,0.17647058823529413,18,16,TGGACCCTTAGAATTGCTGC,2,1331757
furpa,5.0588235294117645,101,16,TGCGAGACTCTTAGTTTGTT,85,1304910
furpa,6.470588235294118,125,16,TGCCTTAGCTCCTAAGTGAC,109,1305299
furpa,2.4705882352941178,57,16,TCTGGGTACACAAAGAATGG,41,1290439
furpa,2.1176470588235294,51,16,TCTCTGGCAGTTCTTTGGGT,35,1307824
furpa,1.2941176470588236,37,16,TCGTGCCGTTACGAGTGTGA,21,1288460
furpa,0.23529411764705882,19,16,TCGGGGACGAGCTCGCGCAG,3,1320269
furpa,0.23529411764705882,19,16,TCGGCTGCGCTTTGTCATCG,3,1314372
furpa,0.47058823529411764,23,16,TCGGCCATTATCGAAGGTCA,7,1323523
furpa,3.4705882352941178,74,16,TCGAGACAAATTGTTGGCGT,58,1317542
furpa,0.6470588235294118,26,16,TCCAGAGCAATAAGTTGGAA,10,1356582
furpa,1.1764705882352942,35,16,TCCAGAAATAATAGCCTGTA,19,1271717
furpa,0.7058823529411765,27,16,TCCACCGACAACGAGGGTAG,11,1274863
furpa,0.11764705882352941,17,16,TCCAATAGTTGAGGCCAACA,1,1275200
furpa,1.7058823529411764,44,16,TCAACCTGCTCTATCGGTGA,28,1318909
furpa,2.0,49,16,TATGTTACAGATGGCACAAG,33,1329599
furpa,1.6470588235294117,43,16,TATCCCAGTATGTCTTCCGC,27,1335342
furpa,1.0,32,16,TATCATGCATCCAAGCCCAC,16,1343340
furpa,0.29411764705882354,20,16,TATAGTACACTTCAGGTCAG,4,1312721
furpa,1.2941176470588236,37,16,TAGCGTCTTCCACAATCGGC,21,1290769
furpa,0.4117647058823529,22,16,TAGCAGCATATGTTGCGCCA,6,1347459
furpa,1.7058823529411764,44,16,TAGACAGCGACACGGGTTCG,28,1335419
furpa,2.1176470588235294,51,16,TACTGTTGCAGGTTTTACAT,35,1279578
furpa,3.176470588235294,69,16,TACTGTTCGCGCTATTCGCA,53,1290032
furpa,1.7647058823529411,45,16,TACTCTCCGCCAGGGGTGAT,29,1296246
furpa,1.6470588235294117,43,16,TACCAAGAGCGCACGCCCGT,27,1308018
furpa,2.176470588235294,52,16,TAAAGGCGCGAGCCGAGCGC,36,1316093
furpa,4.588235294117647,93,16,TAAAATCTTTATACTTTGGG,77,1351262
furpa,0.4117647058823529,22,16,TAAAACTTGCTACGGGTCGT,6,1273979
furpa,4.352941176470588,89,16,TAAAACGCGAGGCATTTGCT,73,1331530
furpa,1.7647058823529411,45,16,TAAAACAGACGAGTCTCCAA,29,1275182
furpa,0.8823529411764706,30,16,GTTTAGTCGCGTTCGCGAAT,14,1318769
furpa,0.29411764705882354,20,16,GTTCTGAAAACTCTATTAAT,4,1329504
furpa,0.17647058823529413,18,16,GTTAGCGCAACGACAGGCAA,2,1312947
furpa,2.6470588235294117,60,16,GTGGACCGGTATGGCAAAAC,44,1287338
furpa,0.11764705882352941,17,16,GTGCTACAATAATGCCGAGC,1,1289794
furpa,0.17647058823529413,18,16,GTCTTCGGCCTGATCCCAGG,2,1329094
furpa,0.29411764705882354,20,16,GTCTCTAACTGGGGGACCGT,4,1285034
furpa,0.29411764705882354,20,16,GTCTAACCTCAATCTCGAGC,4,1297102
furpa,0.7058823529411765,27,16,GTATTCCGCTCCATCGCCCC,11,1334480
furpa,0.6470588235294118,26,16,GTATATTATGTAAGGTTTTC,10,1301327
furpa,0.4117647058823529,22,16,GGTCTGCGGATAAAGTAGAT,6,1297101
furpa,1.4705882352941178,40,16,GGTACGGAGCGGGCACTGCA,24,1347176
furpa,0.11764705882352941,17,16,GGTAACCTTCAAGGCGGTGA,1,1338832
furpa,2.235294117647059,53,16,GGGTGGTCCTCAGTAAAGAA,37,1313426
furpa,1.2352941176470589,36,16,GGGTCTGGGACCATTATAAG,20,1280508
furpa,7.705882352941177,146,16,GGGTAACAAGGCTGGGGATT,130,1315363
furpa,0.17647058823529413,18,16,GGGGGCTTTACATATGAGCC,2,1329779
furpa,0.7647058823529411,28,16,GGCCGATCGGCTAGACGTTT,12,1293387
furpa,1.1764705882352942,35,16,GGCACAAATCGAAACGCCAT,19,1307222
furpa,2.4705882352941178,57,16,GGATGTGTGTAATTGCAGAA,41,1306751
furpa,2.823529411764706,63,16,GGATAACGGATAGTTCACCC,47,1342131
furpa,1.411764705882353,39,16,GCTTCCGCGTGCCCCCTTGA,23,1301431
furpa,1.6470588235294117,43,16,GCTGTAACCGTCTTTAGACT,27,1278761
furpa,0.7647058823529411,28,16,GCGCAACTCCTGCGGTGTGA,12,1313642
furpa,1.1764705882352942,35,16,GCGCAAACAGTAAATACCGC,19,1348035
furpa,0.8235294117647058,29,16,GCGAGCTACGTTGAACAGAA,13,1289957
furpa,11.0,202,16,GCCTTTCTTGGTGCCAAACA,186,1328159
furpa,0.5294117647058824,24,16,GCCGTGCGAAGCTCCGAATC,8,1344930
furpa,0.5882352941176471,25,16,GCCAACCGAGTCTGGATTGT,9,1319187
furpa,1.588235294117647,42,16,GCATACTATTGAGTAATATT,26,1296917
furpa,0.17647058823529413,18,16,GCACCCATAGATCGTAAGGC,2,1284006
furpa,3.0,66,16,GATTGTTCACCCACCCGGGA,50,1313805
furpa,1.6470588235294117,43,16,GATTCGGCGATTCCGATAGT,27,1318751
furpa,7.0,134,16,GATGTTGCGGTTGAAAAGGA,118,1271808
furpa,0.4117647058823529,22,16,GATCCATGGTGGCGCACGGT,6,1281738
furpa,2.176470588235294,52,16,GAGTATGAGAATGGGTTTCT,36,1299648
furpa,0.11764705882352941,17,16,GAGCTGGGATCCACCTACTG,1,1313063
furpa,1.6470588235294117,43,16,GACTGTGAAGCCTTGTGTGT,27,1287782
furpa,0.11764705882352941,17,16,GACTCACCTCCCGCGCGACT,1,1341495
furpa,2.764705882352941,62,16,GACGAAAAGTAGGAGAAATC,46,1349567
furpa,1.2941176470588236,37,16,GACCACCTTCGTCGAATGAC,21,1306810
furpa,2.8823529411764706,64,16,CTTTTTCGGTGTAGGACGCA,48,1332266
furpa,5.0,100,16,CTTTCACATCCTTTTGGACA,84,1300910
furpa,0.7647058823529411,28,16,CTTAGATTCCGTTGTCGCGT,12,1329717
furpa,17.0,304,16,CTGTGTACTACTTCCGTACA,288,1311449
furpa,2.8823529411764706,64,16,CTGTCGAACTCGGACTGTAG,48,1294091
furpa,1.0,32,16,CTGTAGTGAGCACCGCCCTG,16,1319946
furpa,7.411764705882353,141,16,CTGGTCAGTTTGCAGGCACT,125,1306754
furpa,2.235294117647059,53,16,CTGGCGTGAGTCCCTTATCA,37,1286033
furpa,2.588235294117647,59,16,CTGGAGCCCGTCTTCACAAG,43,1306985
furpa,1.8235294117647058,46,16,CTGCCAATCCGTCAACACAT,30,1303787
furpa,3.6470588235294117,77,16,CTGACTTCGCGTCATCCCCA,61,1357039
furpa,0.5882352941176471,25,16,CTCGTTTCGCGTCTGTCACA,9,1309977
furpa,4.764705882352941,96,16,CTCCTCTTCCGCCCGCTGTT,80,1317789
furpa,0.9411764705882353,31,16,CTCCTACATATCGCGGGGCT,15,1278552
furpa,1.588235294117647,42,16,CTCCAGAGGGGAGCTTCACC,26,1349938
furpa,0.17647058823529413,18,16,CTCCAATTGGGGGATATCCC,2,1282373
furpa,2.8823529411764706,64,16,CTAATGAACCAATACGCGAC,48,1333109
furpa,0.29411764705882354,20,16,CTAAGTTTGTTTGTAAGATA,4,1338282
furpa,4.235294117647059,87,16,CTAAATCGGGTCATGGAGCG,71,1336959
furpa,6.470588235294118,125,16,CGTTTCGGAGACTCCATGCG,109,1311431
furpa,0.9411764705882353,31,16,CGTGAACGCTCGGCGCAAAA,15,1284003
furpa,1.8235294117647058,46,16,CGTCGCTCAGGATGTACAGT,30,1351484
furpa,0.35294117647058826,21,16,CGTATTGATCAAGTCATTGT,5,1348551
furpa,0.17647058823529413,18,16,CGTATTCGTACATCAATGTG,2,1280584
furpa,3.3529411764705883,72,16,CGGTTGCAGAAAGGTACCAG,56,1316453
furpa,2.3529411764705883,55,16,CGGGCGCACGCGTTAGATCT,39,1355484
furpa,1.3529411764705883,38,16,CGGGCACCGCAAGACACATC,22,1285656
furpa,2.8823529411764706,64,16,CGGGACCAAGAATGTCAGTA,48,1291988
furpa,2.176470588235294,52,16,CGGGAACGCTGCCATGTTCT,36,1303789
furpa,0.17647058823529413,18,16,CGGAATTTTGTACGCTGACT,2,1292345
furpa,0.11764705882352941,17,16,CGCTCTACAATGGGACTATA,1,1327884
furpa,1.2941176470588236,37,16,CGCACCAGTATAACGATTAG,21,1337095
furpa,2.176470588235294,52,16,CGAGGGGTCTAACGAAAGGT,36,1334171
furpa,0.11764705882352941,17,16,CGACCTCATGTGAGTTTCTG,1,1314056
furpa,1.5294117647058822,41,16,CGAATGCTGACGTGTGCGTA,25,1317255
furpa,1.5294117647058822,41,16,CCTGGCCCCGAACACCAACT,25,1342380
furpa,1.2941176470588236,37,16,CCTCTCCGTGCCTCTTAGTT,21,1277669
furpa,0.29411764705882354,20,16,CCTCCACCAAGTGTGGCCTT,4,1285742
furpa,1.411764705882353,39,16,CCTAGCCGAACGCTGGTTTC,23,1330357
furpa,5.470588235294118,108,16,CCGATTGGATCAGGTAAAAG,92,1273838
furpa,0.7647058823529411,28,16,CCCGATCATCATTCAGATCG,12,1341822
furpa,0.6470588235294118,26,16,CCCCCAGGTATACTATTGCG,10,1339789
furpa,1.0,32,16,CCCACTACGGCTGTACAAGT,16,1321762
furpa,1.2941176470588236,37,16,CCCAAGATAGGTCTGTTAGT,21,1273160
furpa,3.235294117647059,70,16,CCATGACGGTAGTGAGTTAC,54,1288353
furpa,0.11764705882352941,17,16,CATCAGACAGTTGTCCCCAA,1,1317873
furpa,0.8823529411764706,30,16,CAGGGGACATCGCACATCAG,14,1276532
furpa,1.7647058823529411,45,16,CAGCGAGTGCCATGTAAGCG,29,1318152
furpa,2.6470588235294117,60,16,CACTTGGCTTCTGACACGGT,44,1319099
furpa,0.17647058823529413,18,16,CACTGGGAGATAGTAACCAC,2,1330502
furpa,0.11764705882352941,17,16,CACTAGGTTGACGAGGTGTG,1,1301205
furpa,0.7647058823529411,28,16,CAATAACGTCTCTTCCAGTT,12,1309883
furpa,4.9411764705882355,99,16,CAAGATATAGGCGACCTCAA,83,1319635
furpa,13.941176470588236,252,16,CAAGAAGCTGGAAGCCTACT,236,1298097
furpa,0.29411764705882354,20,16,CAAATTCTACTCGGGCTGAA,4,1323743
furpa,0.23529411764705882,19,16,CAAAACTAAGTAAGTCTTCA,3,1353316
furpa,1.411764705882353,39,16,ATTGGTGGTATATGTGTCTG,23,1278109
furpa,0.11764705882352941,17,16,ATTAGTTGTACATGCGTGTG,1,1303122
furpa,0.9411764705882353,31,16,ATTACTCGACACTATAGGAC,15,1308005
furpa,0.11764705882352941,17,16,ATGGTTGAGGGAATCGAAAA,1,1280890
furpa,0.23529411764705882,19,16,ATGCTGAACACTGTACCTGC,3,1329573
furpa,2.176470588235294,52,16,ATGAAGTAGACTCCCCGCGA,36,1294070
furpa,2.176470588235294,52,16,ATCGGTATCCGGGGATCGTT,36,1332782
furpa,0.8235294117647058,29,16,ATCCTCATCCTCTAAATGGC,13,1349411
furpa,2.235294117647059,53,16,ATATTACTATGTGAATTCCC,37,1340548
furpa,0.11764705882352941,17,16,ATAGACTTTTGGACTCCAGC,1,1343873
furpa,1.1176470588235294,34,16,ATACATGTCTCCGTTACAAC,18,1317152
furpa,1.3529411764705883,38,16,AGTGTGGTTCAAATCCTCAA,22,1291813
furpa,1.0,32,16,AGTGTGCTAGTCAGCTGCTC,16,1333669
furpa,2.4705882352941178,57,16,AGTATTTCTACCATCCGTTT,41,1316255
furpa,5.705882352941177,112,16,AGTAGCCTACCCTTCGAACA,96,1311747
furpa,1.0,32,16,AGGTGGGTCGAGTTTTGAAA,16,1311988
furpa,2.0588235294117645,50,16,AGGTGCGTTGGTTGGTCTGC,34,1297666
furpa,2.2941176470588234,54,16,AGGCGGGGGGTGAAGGTAGT,38,1320434
furpa,1.8823529411764706,47,16,AGGATTGCAAGCCATGGTTA,31,1339978
furpa,1.5294117647058822,41,16,AGGATCCGGCATCTGGTACA,25,1286758
furpa,0.29411764705882354,20,16,AGGAATGTCACTAAGGTCCT,4,1311648
furpa,0.4117647058823529,22,16,AGCGGTCCAGATTCGATGCA,6,1273626
furpa,0.6470588235294118,26,16,AGCGAGCTACGTCTGGGTAT,10,1284761
furpa,0.8235294117647058,29,16,AGCCCCGCTGTACAAGGTTA,13,1296295
furpa,0.7647058823529411,28,16,AGCAAGTGCAATTCATTTAA,12,1291989
furpa,3.5294117647058822,75,16,AGAGGTAGTCTAGCTCATCG,59,1272599
furpa,2.823529411764706,63,16,AGACATTAGCTCCCACATAC,47,1304832
furpa,1.0588235294117647,33,16,ACTTATCGCGGGACCATCGT,17,1272807
furpa,2.176470588235294,52,16,ACTGTACCCTATCTTTCAGT,36,1316406
furpa,3.764705882352941,79,16,ACTCTGATCCCGAGGCCGGG,63,1331364
furpa,1.5294117647058822,41,16,ACTCGGAGGCCATCGTACGT,25,1271507
furpa,0.23529411764705882,19,16,ACTCATGGGGGTATCATCAG,3,1288907
furpa,1.411764705882353,39,16,ACGGTGCGCCGGAGTCCGTA,23,1326060
furpa,0.4117647058823529,22,16,ACGGGATGAAACTCATGGGG,6,1331838
furpa,2.588235294117647,59,16,ACGGCCGCGTCATTAGGGTG,43,1298863
furpa,0.5294117647058824,24,16,ACCGGTATGAGGAGTGTTTC,8,1322271
furpa,1.4705882352941178,40,16,ACATGGGTATGTTCAAACCA,24,1320172
furpa,3.0588235294117645,67,16,ACAAGAATGCCGGCAACTGT,51,1346091
furpa,0.35294117647058826,21,16,AATATGTTGTTCGAGGAAAG,5,1296692
furpa,19.0,338,16,AAGGATACTCCGGATTGCAA,322,1324687
furpa,0.9411764705882353,31,16,AAGCGGAAACCCATTTGCCG,15,1306586
furpa,0.17647058823529413,18,16,AACGTTGATATTGGTGATTA,2,1291462
furpa,4.294117647058823,88,16,AACACGAGATATAATGTACA,72,1299224
furpa,7.529411764705882,143,16,AAATGCATCCTACCATGGAC,127,1312672
furpa,0.23529411764705882,19,16,AAATCTAGTGAACTCGGGGA,3,1349020
furpa,0.11764705882352941,17,16,AAACCAAACTCGGCTTGCCA,1,1277413
furpa,0.9411764705882353,31,16,AAAACGTGTCGAGGGTTTCG,15,1302914
furpa,0.7058823529411765,27,16,AAAACAAACATTTGAGAAGC,11,1344622
furpa,0.35294117647058826,21,16,AAAAACTCGGTTATAATAAT,5,1274093
furpa,0.5625,23,15,TTTTTTGCCTGAGCTAATAC,8,1309271
furpa,1.625,40,15,TTTTTCCCTTCTGCTTACCT,25,1282512
furpa,0.375,20,15,TTTTGGCAGCCGGAAAGTTA,5,1302124
furpa,0.125,16,15,TTTTGCGGTAGTGTGGGCAG,1,1344996
furpa,0.25,18,15,TTTGGTCTATACCGCTATCT,3,1321290
furpa,0.125,16,15,TTTGAGCAATAAGCCGCACA,1,1315025
furpa,1.1875,33,15,TTTCGCCCAGGATGAAATTA,18,1335865
furpa,1.5625,39,15,TTTCAGCACGTACGTGTGCA,24,1337580
furpa,4.1875,81,15,TTTAGTCGGTGGCACGGGCT,66,1275602
furpa,0.1875,17,15,TTGTTTTCCCAGTCATTCGT,2,1284010
furpa,1.8125,43,15,TTGTTGAATGCGGAACACTG,28,1344928
furpa,1.8125,43,15,TTGTGTGAGAGTTGGACTTG,28,1350905
furpa,0.125,16,15,TTGTCAAGTTGGCTAGGAAA,1,1284551
furpa,0.125,16,15,TTGTAGCTGTCGAAATGGAC,1,1287931
furpa,0.4375,21,15,TTGGCTATACTCGCTGCTAT,6,1313094
furpa,2.75,58,15,TTGACGTCGTACTCAGGCTG,43,1338094
furpa,0.125,16,15,TTGACCGATCGTTCCTCAAT,1,1276185
furpa,2.125,48,15,TTCTGTGCAATGCCTGGGAG,33,1309082
furpa,2.1875,49,15,TTCGGTAGGGTTGTAATGGG,34,1338553
furpa,0.25,18,15,TTCGACAATACCGCCGTGTG,3,1277042
furpa,3.25,66,15,TTCGAATTTCACCCCTGTCG,51,1322087
furpa,3.75,74,15,TTCCGTATGCGGGTCCCAGG,59,1331205
furpa,1.3125,35,15,TTCACCCCGTATGTCATCAA,20,1305821
furpa,7.625,136,15,TTCACCAGCCGCAATGCAGG,121,1273424
furpa,3.0,62,15,TTCAAGGGAACAAGAAGACC,47,1288473
furpa,0.125,16,15,TTAATCTTGAACGGTTGAAT,1,1324673
furpa,0.1875,17,15,TTAAGAAGATTTAGCGTCCT,2,1293245
furpa,0.125,16,15,TGTTTTACTGGCCGGGTCAC,1,1297584
furpa,2.125,48,15,TGGTGGGTCTCTATACGACT,33,1311851
furpa,0.125,16,15,TGGGAATATGATATTTAAAA,1,1290063
furpa,4.0,78,15,TGCTCTTAGGCGCCAGACGG,63,1274701
furpa,3.9375,77,15,TGCTCTTAGCCCACTCGGCT,62,1294606
furpa,0.625,24,15,TGCGGTGGAGCGCACATGAG,9,1353476
furpa,0.3125,19,15,TGCGGGATATCGCACCTCGA,4,1298313
furpa,0.875,28,15,TGCCGTAGATTTAGGGGGCG,13,1328022
furpa,0.125,16,15,TGATTTTGGTAGTGAAACGT,1,1278542
furpa,2.0,46,15,TGATCATCGCATTCATCAAA,31,1283713
furpa,1.3125,35,15,TGAGAGCTAATTACAATGTA,20,1285403
furpa,1.5625,39,15,TCTACGTCGATCCACGCCGG,24,1306874
furpa,0.8125,27,15,TCTAACTCTTTCGGTTTTTG,12,1297895
furpa,9.125,160,15,TCGCTTAAATTTGTATGTTT,145,1306593
furpa,1.4375,37,15,TCGAATGAAACGTCCAACTT,22,1345714
furpa,0.125,16,15,TCCCCGGCAAACGTCAGACA,1,1332676
furpa,1.4375,37,15,TCCCAGCGCCTCTGCATGTT,22,1287864
furpa,0.1875,17,15,TATGGTCGGTGGAGTTTCAG,2,1345548
furpa,0.25,18,15,TATGGGGCTGCATGGACAGG,3,1336260
furpa,1.875,44,15,TATGCCATCCAAACCTCTGT,29,1294892
furpa,0.125,16,15,TATGCAAGGCGGAGTTAATT,1,1323340
furpa,0.5,22,15,TATAGCATGAACATGTCCCG,7,1302748
furpa,0.9375,29,15,TAGGCGTATCGCGGGAAGCC,14,1352172
furpa,3.0625,63,15,TACTTAGGCTCCGTTACGAG,48,1317041
furpa,2.875,60,15,TACGAACCACTCCCGGCAGA,45,1315333
furpa,0.125,16,15,TACCTGCGATTGACCGAGTG,1,1353969
furpa,0.125,16,15,TAAACCTCGGATCTCTAAGT,1,1313608
furpa,2.0,46,15,TAAAAGCGCGGCCTTTTTCC,31,1355863
furpa,2.25,50,15,GTTGCTTAAGTCCCGAACTC,35,1341775
furpa,1.5625,39,15,GTTCGAGATCTACATGAGTA,24,1274722
furpa,4.25,82,15,GTTCAGATGTGTTCGCGGAA,67,1274481
furpa,2.1875,49,15,GTTATGGGTATTTTCTTTTA,34,1325781
furpa,0.625,24,15,GTGTGTTCACCTCGTTCTAG,9,1318031
furpa,1.4375,37,15,GTGTCCTTATAAACCGGATC,22,1331347
furpa,1.8125,43,15,GTGTATCTCAGTATGGAATC,28,1279243
furpa,0.1875,17,15,GTGGTCCACGCGCGTTGTGG,2,1307744
furpa,1.5625,39,15,GTGGTACGGTCGTGGATCCA,24,1352125
furpa,3.0,62,15,GTGCTGTGGTTGGTATCTAA,47,1345252
furpa,4.3125,83,15,GTCTTAAATACAGTCACGCC,68,1316947
furpa,1.5625,39,15,GTCTGCCCCGTATTGGTGCC,24,1290413
furpa,2.75,58,15,GTCGGTATTCGCAGCTGTGC,43,1356644
furpa,0.125,16,15,GTCGAATTGTCATAGGATAA,1,1314265
furpa,0.125,16,15,GTATAGCTTGAATGTGGTTC,1,1285119
furpa,0.375,20,15,GTACGATTCACCCATTAGCC,5,1314214
furpa,0.125,16,15,GTACCACGTTCTGGTAGCAA,1,1312358
furpa,0.6875,25,15,GTACAAGTTAAGATTGGTCA,10,1291358
furpa,1.4375,37,15,GTAAAAACCCTATGCATCTT,22,1334053
furpa,3.5625,71,15,GGTTGCTCGGACATGCTACA,56,1318191
furpa,10.9375,189,15,GGTGTCCTTCTCGCGAACCA,174,1331971
furpa,2.125,48,15,GGTGAGCTAGCAATGGTCAC,33,1346085
furpa,1.0625,31,15,GGTCATTCCCCAAAGGAATA,16,1309601
furpa,1.4375,37,15,GGTATTGGCTATGTCCGGCA,22,1287340
furpa,3.0625,63,15,GGGTATGTAAACAATGCAGG,48,1302650
furpa,0.4375,21,15,GGGCTGAGATCACGGTTCCG,6,1355651
furpa,7.1875,129,15,GGGCTCGTCTCCTCATAACC,114,1283608
furpa,0.1875,17,15,GGGCTAACTCACGTTGGATG,2,1356308
furpa,4.0625,79,15,GGCTGCCCCCACCGACAGTA,64,1317156
furpa,1.4375,37,15,GGCATATTGCACTGCAGCTT,22,1286963
furpa,0.125,16,15,GGATACAGTGCCGGCTCTAC,1,1304066
furpa,0.125,16,15,GGACTTAACGGCACTGGGTT,1,1272679
furpa,0.5625,23,15,GCTTTTCGAGGTCAGACAGA,8,1312941
furpa,1.5,38,15,GCTCATGTTAGTCCCTGAGA,23,1286753
furpa,0.125,16,15,GCTAGAACCAATACGGAAAG,1,1345039
furpa,0.375,20,15,GCTACAAAAATAGAGTCTAT,5,1319833
furpa,0.75,26,15,GCGTTAACTCAGGGCTCACA,11,1310284
furpa,0.4375,21,15,GCGGTTCGGCACGCTTTCTG,6,1287932
furpa,1.8125,43,15,GCGGATATAGCAATCTGTAA,28,1287651
furpa,0.25,18,15,GCCGGCGCTACATCTAAAAT,3,1300338
furpa,0.625,24,15,GCCGGCAGTACCCACATCTG,9,1275247
furpa,2.0625,47,15,GCCCTTTAATAATGTTTGTG,32,1281758
furpa,1.875,44,15,GCCCTGAGCTTTCTCTCTTC,29,1301835
furpa,2.125,48,15,GCATTGCTCATTATAAAGAA,33,1347131
furpa,0.375,20,15,GCAGCGGAGGTTCGTTTTCC,5,1354688
furpa,1.625,40,15,GCAGACGTGTACAAATCCTC,25,1330302
furpa,0.4375,21,15,GCACGAGTTGAGTAGCATCA,6,1279051
furpa,0.9375,29,15,GATGAACATAGCCCGACACC,14,1319832
furpa,0.1875,17,15,GATCCGACCGCTCGTAAGCC,2,1342059
furpa,1.625,40,15,GATATAAAGGTGAATATTCA,25,1341254
furpa,0.9375,29,15,GAGGGATTAAAGGCTAGGTA,14,1322802
furpa,0.5,22,15,GAGCTGAACTCTTTGCTTGT,7,1298578
furpa,0.125,16,15,GAGACTAAGCTTGGTTTTTC,1,1303861
furpa,5.0,94,15,GACTGCACTGTGATCCAGCT,79,1324780
furpa,1.75,42,15,GACTACTACCGATATGACGC,27,1307112
furpa,1.5,38,15,GACGTATGGTTTACCTGACT,23,1294354
furpa,1.6875,41,15,GACCTGACTGGCAGGTGACA,26,1334032
furpa,1.75,42,15,GACCTCACTATGGCATAGAG,27,1273242
furpa,4.3125,83,15,GACCGGTTTTTCTCAGCGAC,68,1323400
furpa,2.0,46,15,GACCCGATGAGATTCCACTG,31,1302662
furpa,3.6875,73,15,GACCCACTATGTGACTCCGG,58,1349846
furpa,0.625,24,15,GACAGCCCATGTACCGTGCT,9,1297492
furpa,0.875,28,15,GAATGATTAGACAACGAAGG,13,1323714
furpa,2.1875,49,15,GAAGCATCGGAAATATAAGA,34,1304378
furpa,1.0625,31,15,GAAATAGACACTCAAGTCGT,16,1309125
furpa,3.125,64,15,CTTATGGCCCCTTGCTGTGA,49,1340302
furpa,2.0,46,15,CTGTTGGGTTAGAGCACTCT,31,1320130
furpa,6.875,124,15,CTGTTCCTAGGCGAGAAGCC,109,1300071
furpa,0.625,24,15,CTGGTCGATTCGAACACCAA,9,1297051
furpa,0.125,16,15,CTGCCAATTAAATGGATGAC,1,1288593
furpa,0.5,22,15,CTGCAATCCACATCCAGCCT,7,1297708
furpa,0.4375,21,15,CTCTTTAGTCTTATAATGCA,6,1309010
furpa,3.1875,65,15,CTCAATTGGTATCGACACAT,50,1328118
furpa,4.1875,81,15,CTAACGTTGTCGTCGGTCCA,66,1328133
furpa,1.875,44,15,CGTGTCCGTAATGCGCCAGG,29,1315469
furpa,1.6875,41,15,CGTGCTGATTGACCGGGGCT,26,1319575
furpa,0.125,16,15,CGTATCGATGCCTGATCTAC,1,1350508
furpa,1.5,38,15,CGTAGTCGCCGGCTAAGTGC,23,1324239
furpa,2.1875,49,15,CGTAAGAGCGTGTGGCTCCT,34,1283619
furpa,3.25,66,15,CGGTTGGTTAGTCCGTGGGT,51,1318954
furpa,4.0,78,15,CGGACGCTGGCAAAATGTTT,63,1275994
furpa,1.375,36,15,CGCCGGCTGGGCTTGCCTTC,21,1345266
furpa,0.1875,17,15,CGATTAGCGGAAACGGGCTT,2,1354441
furpa,2.9375,61,15,CGAGTCTCTGCTTGAAGTGG,46,1325906
furpa,2.125,48,15,CGACCTGTCGGAAAGGCCAT,33,1334301
furpa,1.0,30,15,CCTATTAGGTAAAACTGGTG,15,1325001
furpa,0.125,16,15,CCGTCCCTAGAAGTCTGGTT,1,1329425
furpa,0.4375,21,15,CCGGGTTATGAGACATTTAG,6,1347987
furpa,12.5,214,15,CCGCCACAGAAAATTGGTAT,199,1323915
furpa,0.3125,19,15,CCCTTGTTCCTTCGTTAAGG,4,1336715
furpa,0.3125,19,15,CCCTCCTTTTCTATGTAACA,4,1325249
furpa,0.375,20,15,CCCGGAATGTGCGACGTTGA,5,1328721
furpa,2.0625,47,15,CCCCGGAGCTTTCTTGTCGA,32,1288098
furpa,0.125,16,15,CCATCTCCCGCACCATGATG,1,1351320
furpa,1.625,40,15,CCATAGGATGCAAATATTTT,25,1345125
furpa,0.125,16,15,CCAGCGCTAGCCAAGTAACC,1,1338376
furpa,0.125,16,15,CCACTTCCATCTCAAGCCAT,1,1354324
furpa,2.5625,55,15,CCACGAGGCAGACGCCTTAT,40,1348751
furpa,2.5,54,15,CCACAGTGGTTAGGGCGACA,39,1287506
furpa,0.75,26,15,CATTGTAGGCTCAACCTCGA,11,1321164
furpa,0.875,28,15,CATGTGGGAGTCACCGTGGA,13,1290159
furpa,0.75,26,15,CAGTTAGCCACACAACACGA,11,1274496
furpa,1.5625,39,15,CAGGTACGAACCCCCCAACA,24,1281570
furpa,0.125,16,15,CAGCGCGGGGATAGCTGCTC,1,1349490
furpa,0.125,16,15,CAGACTGTGTGGGCGGAAGT,1,1330207
furpa,0.9375,29,15,CACTGTGTACCCGGTAACCT,14,1316375
furpa,1.125,32,15,CACTATATGTAATCTACGTA,17,1302835
furpa,1.4375,37,15,CACCTTGGACCCCACGCTTG,22,1319100
furpa,1.4375,37,15,CACCGTTATTGTAGCGGAGT,22,1285118
furpa,0.5625,23,15,CACCGGTCCCTGCTGTGGCA,8,1287169
furpa,3.125,64,15,CACAGCACGCTCATACCCTG,49,1281322
furpa,0.1875,17,15,CAATCAAATCCGCCCATAAT,2,1336263
furpa,0.875,28,15,CAATAGCGTTCACGGTCTCG,13,1308904
furpa,0.4375,21,15,CAAGACCCTAAGTCATTCTT,6,1303451
furpa,0.5625,23,15,CAAATATCCATCATGGTGTC,8,1317546
furpa,1.5,38,15,ATTTGCCCACAACGGGACAG,23,1340532
furpa,0.6875,25,15,ATTGTTGGGTGTGTTGTTGG,10,1279856
furpa,1.5,38,15,ATTCGGGAGAGGACAGAGTT,23,1342354
furpa,2.5625,55,15,ATGGGACGTGGATGGTGACG,40,1317554
furpa,0.9375,29,15,ATGCCACGGAATGCCACGGC,14,1292184
furpa,2.875,60,15,ATGAGTGTGCGTAGTGTCTC,45,1301356
furpa,0.1875,17,15,ATGAATCGCAGGCTTCGCCC,2,1305040
furpa,0.1875,17,15,ATCTGCAATGGTTTCCCATC,2,1330012
furpa,4.0625,79,15,ATCGCACGAATAAGTAAGAC,64,1357799
furpa,0.5,22,15,ATCATTCCTGGATCCGTTAA,7,1343049
furpa,0.1875,17,15,ATCAGGTGGAAACAAGATTC,2,1306339
furpa,2.25,50,15,ATAGCGAACGTGGTTTTACA,35,1330117
furpa,1.75,42,15,ATAACGCCAGTATTGCAAAA,27,1299619
furpa,0.125,16,15,AGTTCAACTCGTACCTATCA,1,1349256
furpa,2.125,48,15,AGGCTTCGCACGTGACATGT,33,1337903
furpa,1.4375,37,15,AGGAGGAAGGGGGGCTCACA,22,1287078
furpa,2.375,52,15,AGCTCACCGATATTACTCCC,37,1312939
furpa,0.625,24,15,AGCGGCGGGCGCTAGGTGAA,9,1323148
furpa,0.375,20,15,AGCCGGATATTGTGGTCTCT,5,1319104
furpa,1.125,32,15,AGCCAGTACACAGTACGAAA,17,1298589
furpa,1.5,38,15,ACTGTAGGTCATATCAGAAC,23,1316193
furpa,3.3125,67,15,ACGTACAACTTTACCGGCCA,52,1341074
furpa,2.8125,59,15,ACGGATTGTACTCTGAGTCC,44,1341315
furpa,1.0,30,15,ACGACCCTCTAAGGTATGTG,15,1348011
furpa,0.375,20,15,ACGAACTCGCTCTAAGCAAA,5,1330572
furpa,0.9375,29,15,ACCTTAGTAGGTATGAAGTG,14,1336556
furpa,2.6875,57,15,ACCTGACCTCGGTCGGATGT,42,1282886
furpa,0.75,26,15,ACCATATAACGTCAGTAAAG,11,1299656
furpa,0.125,16,15,ACAAGGGTAGTGATTATCTA,1,1320917
furpa,2.875,60,15,ACAAAGGTGGTCGTGGCAGA,45,1275605
furpa,0.1875,17,15,AATGTAGTGGCCCCGTCCGA,2,1343571
furpa,0.125,16,15,AATAGCGTGTGAATGAATCG,1,1292367
furpa,0.125,16,15,AAGTCGAAATTCTTTATCTT,1,1308765
furpa,1.5625,39,15,AAGCATTGTCAGGGCTTTCT,24,1349971
furpa,0.9375,29,15,AAGACGGTATTATGGAACAA,14,1353881
furpa,1.9375,45,15,AACTGCCATTGGTCTATGGT,30,1318529
furpa,0.1875,17,15,AACTCTCTTTTCTATGGATG,2,1301149
furpa,0.1875,17,15,AACGCCCCGTCACTTCCATC,2,1286582
furpa,2.75,58,15,AACAGTCTGAGGCCAGGCAT,43,1334680
furpa,2.5,54,15,AAAGGGCGACTAGAAGTACA,39,1353579
furpa,4.4375,85,15,AAACCGAAGTCCGCCCTCCG,70,1295957
furpa,0.6666666666666666,23,14,TTTTTTGCCCCTACCCTAAC,9,1346717
furpa,0.6666666666666666,23,14,TTTTGATTAAGTGTTCTTGA,9,1327037
furpa,0.3333333333333333,18,14,TTTTCTAATACTAGAGGGAA,4,1283592
furpa,17.6,277,14,TTTGGGCAGGGACCGGCGGA,263,1336881
furpa,0.4,19,14,TTTACAGTCTTGATGGTACC,5,1335319
furpa,0.2,16,14,TTTAAGCCCGGGGGTACAAC,2,1355069
furpa,2.6666666666666665,53,14,TTGTCAAAGCCACGAAAGGC,39,1273598
furpa,32.4,499,14,TTGGCAAGGTGGGGGCGCCC,485,1273441
furpa,5.266666666666667,92,14,TTGCGCTTGATGTCCGCCCC,78,1288867
furpa,0.5333333333333333,21,14,TTCTCCTGCCTTGACTGCCT,7,1337211
furpa,2.7333333333333334,54,14,TTCGAGTGTAGCCAGAGCAG,40,1273428
furpa,2.0,43,14,TTCAAGCGGTTAGAAGCGGA,29,1334908
furpa,3.2666666666666666,62,14,TTATACAACTTGCGCCCCTA,48,1292682
furpa,0.8,25,14,TTAGAGCTGCGTCTCTCCAT,11,1289408
furpa,0.8666666666666667,26,14,TTAATCACCCTGGAGGAAGA,12,1314885
furpa,1.0,28,14,TGTGATCTAACTTCTGTCAT,14,1351420
furpa,2.2666666666666666,47,14,TGTCGAGCAACTCATTCGGC,33,1354176
furpa,1.0666666666666667,29,14,TGTCATTTGGGCACAATAAG,15,1334121
furpa,0.9333333333333333,27,14,TGGTTGGTTGTGGCCGATCT,13,1314822
furpa,5.0,88,14,TGGGTTTTTTGGTGCCCTCA,74,1350265
furpa,4.0,73,14,TGGCGGTAACCAATTGGTGG,59,1281948
furpa,2.8666666666666667,56,14,TGGAAGAGCGAGGGAGATGA,42,1337584
furpa,1.0,28,14,TGCTGTGTATTCGAGTCCTC,14,1318036
furpa,0.13333333333333333,15,14,TGCAACTCTATCGCTCTTTT,1,1322630
furpa,2.0,43,14,TGACGTGCGAACGGAAAAAT,29,1336251
furpa,0.3333333333333333,18,14,TCTTTGCCGGGGAGTTCACA,4,1330052
furpa,3.1333333333333333,60,14,TCGGTATTTAACGGGCCAAA,46,1320918
furpa,0.6,22,14,TCGGCCGGACATATGGCGCC,8,1332913
furpa,0.13333333333333333,15,14,TCGCGAGTGATATGAGTCTG,1,1329012
furpa,1.7333333333333334,39,14,TCCGTTTCTGGCAGCACACC,25,1309000
furpa,1.8,40,14,TCCGTGATCAACCGCCTACA,26,1293029
furpa,1.8,40,14,TCCGGGCCATGTCAGTTCGT,26,1306712
furpa,0.8666666666666667,26,14,TCCAGGTCGGACCAACATGG,12,1280967
furpa,3.4,64,14,TCAATTTAAGAGGTATAAAC,50,1308854
furpa,2.1333333333333333,45,14,TATTCGCGGTGCTGTCCCGA,31,1299384
furpa,1.5333333333333334,36,14,TATTAGAAACGAATAGATGT,22,1287681
furpa,0.13333333333333333,15,14,TATGCGGACGCCACGTACTG,1,1281279
furpa,1.0,28,14,TATCAACGGGTTTGGGCTAG,14,1313934
furpa,1.0,28,14,TATAGTATAGAATTGACCTG,14,1279974
furpa,0.6666666666666666,23,14,TAGGTTCGTAGTTGTGGTGG,9,1325436
furpa,7.466666666666667,125,14,TAGCTAACCAAAAGTTCCCC,111,1326324
furpa,0.3333333333333333,18,14,TAGAAGACGGGAACCTAGAC,4,1289832
furpa,0.9333333333333333,27,14,TACTGAAGCGCGTAGAACGT,13,1281894
furpa,3.2666666666666666,62,14,TACTATGAGGAACGCTTAAA,48,1299587
furpa,0.8,25,14,TAATTGCGAATCATGGTGTT,11,1319224
furpa,0.26666666666666666,17,14,TAATCTGCACACCTACGATG,3,1283521
furpa,2.066666666666667,44,14,GTTTGCGGTGGCATAGGAAC,30,1327966
furpa,0.6,22,14,GTTGTGCATCCGTCCGTGTC,8,1305131
furpa,0.13333333333333333,15,14,GTTGGGCGCATATGTCGGAC,1,1324168
furpa,0.6666666666666666,23,14,GTTCGACGGTGAACCCGTGA,9,1334100
furpa,1.0666666666666667,29,14,GTTATGTATTGGAGCTATGG,15,1348113
furpa,0.13333333333333333,15,14,GTTACCCACACGTGCTCGTT,1,1296119
furpa,0.8,25,14,GTTAATCTTGAAGGGGGAGT,11,1325851
furpa,3.0,58,14,GTGTTTTCATAACAGGACGC,44,1349495
furpa,1.6666666666666667,38,14,GTGTAACAGAGGAAACGGAG,24,1324179
furpa,0.8666666666666667,26,14,GTGGCGTTGCACTTTGCGTA,12,1294632
furpa,0.2,16,14,GTGGCCGTGCTGCGTAGGGT,2,1321359
furpa,0.2,16,14,GTGCTCGCATTACCGGTAGA,2,1285769
furpa,0.4,19,14,GTGCTAGGCAGGTGGCATCT,5,1331393
furpa,13.533333333333333,216,14,GTGATGACTAGGGCCAAACC,202,1295153
furpa,4.2,76,14,GTGAGATGATGTAAGACGGA,62,1328164
furpa,0.3333333333333333,18,14,GTCTCCTGAGAGAGGGCTGA,4,1319128
furpa,1.5333333333333334,36,14,GTCGAAGGCGCGACATCAGT,22,1329850
furpa,2.8666666666666667,56,14,GTCCATATGAGCTACCGTTC,42,1321194
furpa,1.4666666666666666,35,14,GTCCAGAGGTACTTTGCGAG,21,1326905
furpa,0.9333333333333333,27,14,GTCCAGACCTTGTCAGCAGA,13,1348734
furpa,3.3333333333333335,63,14,GTATTCAGCGCGAAACGCAA,49,1285380
furpa,0.13333333333333333,15,14,GTATCTGTTCTATGAACCAT,1,1311281
furpa,1.2,31,14,GTATCACATCGCGTCAAATC,17,1284015
furpa,0.4666666666666667,20,14,GTATATTCGACTTTCTGACT,6,1287579
furpa,0.4,19,14,GTAGGGAGGGGGTTCATGTG,5,1332673
furpa,0.4,19,14,GTAACTCTCTAGGCGGGGAA,5,1299646
furpa,1.1333333333333333,30,14,GGTTTAGCGTCCCGCCGCGA,16,1278940
furpa,1.6666666666666667,38,14,GGTGTCTTATGCAGATGTTT,24,1321482
furpa,1.0,28,14,GGTGGGACTTTACGCTCTAT,14,1291422
furpa,2.933333333333333,57,14,GGTCTCGCAGCGGCCGAGCC,43,1295540
furpa,2.8666666666666667,56,14,GGTCGCAGCCGGGAGTAAAA,42,1328150
furpa,0.2,16,14,GGTCACACGGGCACCTGCCC,2,1319658
furpa,0.2,16,14,GGTAGTCCACAAGAACTGGA,2,1309474
furpa,0.6,22,14,GGTAGCTCTGTAGTCAACAG,8,1329492
furpa,2.2666666666666666,47,14,GGTACTGTAAAACAGCCACT,33,1338435
furpa,1.7333333333333334,39,14,GGGTCTTACCAGCGGAACAT,25,1345275
furpa,0.13333333333333333,15,14,GGGCGGGCACCGGACCTAAT,1,1301702
furpa,0.8666666666666667,26,14,GGGACCCCTTTGCGCTCATG,12,1311835
furpa,4.333333333333333,78,14,GGCATGCCTACTCGACTCTG,64,1357017
furpa,0.13333333333333333,15,14,GGCACCAGTCTAGCCCCTGT,1,1319272
furpa,0.4666666666666667,20,14,GGATAGCAGTATCCTTAGTA,6,1288020
furpa,0.3333333333333333,18,14,GGAACATCTGGGTCGGCTCC,4,1307230
furpa,0.6,22,14,GGAAAATGCGTATAATCATA,8,1275371
furpa,2.1333333333333333,45,14,GCTTGTGGTCAGTCTCCTAA,31,1340580
furpa,0.9333333333333333,27,14,GCTCCCTCGTTAGGTCGAGG,13,1321064
furpa,0.4666666666666667,20,14,GCTAACCGGCGTACGCGTAT,6,1301701
furpa,2.066666666666667,44,14,GCGTTTGCCACTAAGAGTCC,30,1330994
furpa,8.066666666666666,134,14,GCCCAGTGGTAAATATACAT,120,1279030
furpa,0.13333333333333333,15,14,GCCATGGGACTTTAACCGTA,1,1277336
furpa,0.26666666666666666,17,14,GCCATGAAATCTTTATTTCT,3,1332906
furpa,2.933333333333333,57,14,GCCACAACAGTTCAACGGCT,43,1321166
furpa,0.8666666666666667,26,14,GCATCCATATACAGCTTTTT,12,1334195
furpa,5.933333333333334,102,14,GCATATCGGCGGACCCCCTA,88,1296816
furpa,1.2666666666666666,32,14,GCAGGCATATGTATCATTGG,18,1327212
furpa,0.8666666666666667,26,14,GCACCGGGCTGTGTGCGTCA,12,1296541
furpa,0.2,16,14,GCAATACCCGGAAGTCTGCG,2,1356284
furpa,0.13333333333333333,15,14,GATGCGTGCGTGCTGTGAAT,1,1278129
furpa,0.8,25,14,GATGCCTGGCGGCTTGCTGG,11,1280494
furpa,8.466666666666667,140,14,GATCGGTAGTTTCTGTCTAG,126,1327399
furpa,0.2,16,14,GATAATCGCAGTTTGTGCCA,2,1344402
furpa,1.6666666666666667,38,14,GAGTCTTAAGCCTGGTCTAT,24,1304930
furpa,5.266666666666667,92,14,GAGTAATGAGCTACGCATGA,78,1317636
furpa,3.1333333333333333,60,14,GAGATTCTCTTGTCCCATCT,46,1331004
furpa,1.5333333333333334,36,14,GAGACAAGCGGCGAGGTGCC,22,1312005
furpa,2.2,46,14,GACTATCCCGCTTGGAAGGA,32,1336840
furpa,0.2,16,14,GACTAAGGAAAGGGCCTCTG,2,1271181
furpa,0.13333333333333333,15,14,GACGTCACAGTCATATTCGT,1,1278202
furpa,0.4666666666666667,20,14,GACATCACACGCGAGATATT,6,1271425
furpa,5.933333333333334,102,14,GAAGCTAGCATCGTTAGAAC,88,1320135
furpa,0.26666666666666666,17,14,CTTGTCGGAAGCTGGCGCGC,3,1315863
furpa,0.2,16,14,CTTATGGAAGTCCCATAAAA,2,1286781
furpa,1.0666666666666667,29,14,CTGCTGGCGGACACCACGAT,15,1315858
furpa,0.13333333333333333,15,14,CTGAATTGTTGATAACTCCC,1,1284546
furpa,2.466666666666667,50,14,CTCGGAATGTACAACTTATT,36,1321976
furpa,0.13333333333333333,15,14,CTCGCACGACACGCAGCAAA,1,1281888
furpa,3.6,67,14,CTCATCTCGCCGACACAACC,53,1353380
furpa,0.8666666666666667,26,14,CTCAGGGCTCGGGAGTGTCA,12,1299546
furpa,0.13333333333333333,15,14,CTCAGAAGTGCTGTGCGCAT,1,1321758
furpa,1.2,31,14,CTAGTTCCGACCCTCCATTG,17,1275937
furpa,1.6666666666666667,38,14,CTAGTGGAAGGACGTTAATA,24,1320780
furpa,0.8666666666666667,26,14,CTAGTCAACCGAATAAAACA,12,1327284
furpa,0.2,16,14,CTAGAAGTCAGGATTGTTCT,2,1294933
furpa,4.4,79,14,CGTCTGTGGGTACGCATTTA,65,1283373
furpa,0.2,16,14,CGGGTCGGTATCTGCAGTTA,2,1279283
furpa,0.2,16,14,CGCTTACTGTATATACGCTT,2,1333577
furpa,1.2666666666666666,32,14,CGCCTAACAGGAAGGAATGG,18,1310335
furpa,0.8666666666666667,26,14,CGAGGCAAGCCCCAGCGCAT,12,1352085
furpa,0.26666666666666666,17,14,CGACGATACGGTGTGTTTTT,3,1298146
furpa,3.933333333333333,72,14,CGAAAGTGAGAGTTCGTTTT,58,1346611
furpa,0.6666666666666666,23,14,CGAAAACGATCATAGGGAGT,9,1321966
furpa,0.13333333333333333,15,14,CCTTTGTGTCAACCACAGGT,1,1320043
furpa,0.7333333333333333,24,14,CCTGTCGAGTCTTTGATCTA,10,1336069
furpa,0.13333333333333333,15,14,CCTCATGCTTCTCCCACATG,1,1333758
furpa,0.13333333333333333,15,14,CCTAATACGGTTGTCGGAGC,1,1300070
furpa,0.6,22,14,CCGTACTTTCACCCTGCGTA,8,1324922
furpa,0.2,16,14,CCGGAAGAGCACCACCGTCA,2,1274623
furpa,2.466666666666667,50,14,CCGCTTAAGCAAAAATACGA,36,1315313
furpa,2.933333333333333,57,14,CCCTAACACTTCCGTTTAGG,43,1315271
furpa,0.7333333333333333,24,14,CCCGTTGCTGCAATGAAAGT,10,1323037
furpa,4.0,73,14,CCCGACTTCGAACCATAACG,59,1298009
furpa,6.0,103,14,CCCGACGATTGGCACTCAAC,89,1341232
furpa,3.6666666666666665,68,14,CCCCGGTACGTGCCAAGATA,54,1335236
furpa,3.8666666666666667,71,14,CCCATCAGGCATTTGGAAAA,57,1311693
furpa,1.6666666666666667,38,14,CCATACGTATGGAGGTCACA,24,1282032
furpa,3.2666666666666666,62,14,CCACGTCTAAGCTATCCGCT,48,1293765
furpa,1.3333333333333333,33,14,CCACCTAGTTGCGAGGCGTT,19,1324284
furpa,2.6,52,14,CCAACCAGCTATCGCCCCAT,38,1288410
furpa,0.13333333333333333,15,14,CATAAGACTGTTGATACGGC,1,1331770
furpa,0.6666666666666666,23,14,CAGTATTATTTGCTGTTAGT,9,1343300
furpa,1.0,28,14,CAGTATTACTCTGACACCCT,14,1337238
furpa,1.2666666666666666,32,14,CAGGGCTTTTAATCCTTGAG,18,1346130
furpa,0.13333333333333333,15,14,CAGCTCCAATGACTGGTATG,1,1320734
furpa,0.13333333333333333,15,14,CAGCTATAGGAAATCCCCTT,1,1286902
furpa,0.6666666666666666,23,14,CAGCGCATCACCAACTATCT,9,1341842
furpa,5.066666666666666,89,14,CAGCAATATAGTACATAAAT,75,1330993
furpa,3.8,70,14,CACGATTTCGACAGCTCACG,56,1354808
furpa,0.9333333333333333,27,14,CACCTTCATCTGTCACGGCC,13,1297097
furpa,0.8666666666666667,26,14,CACCCAAGACGAACGCAATA,12,1331727
furpa,0.13333333333333333,15,14,CAATTTGACCCCATAACCGG,1,1281409
furpa,0.8,25,14,CAATGTCAACTCATTCGCTG,11,1332569
furpa,1.9333333333333333,42,14,CAACGGCTATTAGTGGGTGC,28,1291797
furpa,0.2,16,14,CAACAGCGAGCGCTCTAGTG,2,1292958
furpa,1.4666666666666666,35,14,CAACAGACCTAGATGACTCT,21,1349330
furpa,12.533333333333333,201,14,CAACAAGTCCGGCCATGTAA,187,1304919
furpa,0.2,16,14,CAAAATGCGGTAGCCACTGT,2,1296288
furpa,1.6,37,14,ATTCCCACACTAGGGCACGT,23,1301952
furpa,2.8,55,14,ATTCATCCGCGGCTGTGGTC,41,1331473
furpa,0.9333333333333333,27,14,ATTATGCAAGGAAATCCACG,13,1352134
furpa,2.7333333333333334,54,14,ATGGAAGCCCCGAGCTGCCA,40,1289405
furpa,3.0,58,14,ATGGAACTGGTCGTCCTTGT,44,1344322
furpa,0.5333333333333333,21,14,ATGAGGGACGTTTTGGCGAA,7,1298821
furpa,3.066666666666667,59,14,ATCGCGTCGGTGGTGGCGGG,45,1292706
furpa,1.0,28,14,ATCGAATGCTTTACAAGGGA,14,1284773
furpa,2.7333333333333334,54,14,ATATTCCATACAATGCTCCT,40,1334112
furpa,3.066666666666667,59,14,ATAAGTAGACCACTGTACGT,45,1328656
furpa,3.7333333333333334,69,14,ATAAATCACCAGGAAGTAAG,55,1323930
furpa,0.13333333333333333,15,14,AGTTGGTACGTGTAGTAACC,1,1331079
furpa,0.26666666666666666,17,14,AGTCGGTGGAAGGGCAGAGT,3,1304428
furpa,4.4,79,14,AGTATTCCGGTTTACCGACT,65,1279105
furpa,0.6,22,14,AGGTTTACAGCGTTATACCG,8,1355635
furpa,1.5333333333333334,36,14,AGGTTCTATCTTGCTATCGT,22,1277298
furpa,0.6666666666666666,23,14,AGGTCATCCGTCTCTAAGGC,9,1293576
furpa,0.8,25,14,AGGGTTGGAAGATTGATATA,11,1293185
furpa,1.4666666666666666,35,14,AGGATTGGAGATTGTTCCCA,21,1332875
furpa,0.6666666666666666,23,14,AGGATACCTCTCCCGGTTTT,9,1288974
furpa,0.6666666666666666,23,14,AGCGTCCTTGACGTGTAGCA,9,1316517
furpa,1.0,28,14,AGCGCAAACATTAGGTATAT,14,1324287
furpa,0.7333333333333333,24,14,ACTCCTTGTCACTTGGCAAC,10,1329787
furpa,2.2666666666666666,47,14,ACTCCACTCTCTAGTGATTA,33,1343642
furpa,2.0,43,14,ACTACGGGCGGACGCACAGG,29,1309402
furpa,1.7333333333333334,39,14,ACGTTAGACGAGCTCATCCA,25,1329598
furpa,0.8,25,14,ACGTCGTGTGGCTAAAATTA,11,1290043
furpa,0.13333333333333333,15,14,ACGCTAGTGAATCCGGGTGG,1,1278489
furpa,0.2,16,14,ACGAAGTGTGCGGCACCATG,2,1352077
furpa,0.5333333333333333,21,14,ACGAAAATTGATCAAATGCT,7,1325908
furpa,2.4,49,14,ACCTTCGTAATGTTTATCTA,35,1346010
furpa,0.13333333333333333,15,14,ACCGTGTGGATGAATGGTAC,1,1293994
furpa,4.4,79,14,ACCGGAAACCATTTAAAATG,65,1317975
furpa,0.13333333333333333,15,14,ACCGAAAATCCAACGTCGGT,1,1276973
furpa,3.0,58,14,ACCCTAGGATCAAGCGTTTT,44,1323085
furpa,2.933333333333333,57,14,ACCAGAATATAGGTGAGAGG,43,1302784
furpa,1.5333333333333334,36,14,ACATTCTCCTGTGCTCTCGC,22,1327531
furpa,0.13333333333333333,15,14,ACATGTGCAGAAGCGTCTAG,1,1322849
furpa,1.1333333333333333,30,14,ACAGCTCCTCTACCAGACTT,16,1354542
furpa,1.3333333333333333,33,14,AATCGCAACAGAGCGGATGA,19,1279305
furpa,0.4666666666666667,20,14,AATAACCGCCTGTGAGTCTA,6,1335341
furpa,4.333333333333333,78,14,AAGTATAGCTCCCTATTCAA,64,1312709
furpa,0.6,22,14,AAGGCTGGCGATCGATTTAG,8,1277421
furpa,0.2,16,14,AAGATGATGGATGTTAGCAT,2,1287080
furpa,2.6666666666666665,53,14,AACTTCTTTCAGTCTAAAGG,39,1338079
furpa,0.4,19,14,AAATCCGGCACTGTTTACAA,5,1291754
furpa,3.533333333333333,66,14,AAAGCACGCAACACATTGAA,52,1276632
furpa,2.2666666666666666,47,14,AAAGATCCTGTCTGATCGAA,33,1317026
furpa,3.8,70,14,AAACTGGCGGGTCGTCGAGT,56,1324581
furpa,1.3333333333333333,33,14,AAACCTAGTGGCAGCCAAAA,19,1308556
furpa,0.42857142857142855,18,13,TTTTTCCCCTGCTTGCGCTA,5,1281842
furpa,0.35714285714285715,17,13,TTTTTATCCCGGACCCACCA,4,1280276
furpa,11.642857142857142,175,13,TTTCTGTTTACGACCGAGAC,162,1280577
furpa,0.8571428571428571,24,13,TTTATTGAAGTAAGACTTCA,11,1356770
furpa,0.21428571428571427,15,13,TTTAGCTACCAATAGGGGTA,2,1349336
furpa,0.21428571428571427,15,13,TTTAGCAAGGGGATCAGTTC,2,1300089
furpa,3.142857142857143,56,13,TTGTATTACATAACCCAGCA,43,1337815
furpa,2.857142857142857,52,13,TTGGCCCTACTGCAAGTGTA,39,1352341
furpa,2.7142857142857144,50,13,TTCGTTTTCTATTTGTTATA,37,1293500
furpa,2.5714285714285716,48,13,TTCAGTTGAGGACGGGCACA,35,1326392
furpa,2.9285714285714284,53,13,TTATTTGGAACTGAACACGT,40,1304288
furpa,0.14285714285714285,14,13,TTATTGCCTATTGAAATCAA,1,1294251
furpa,5.642857142857143,91,13,TTAGGTATTGATTAACTTCA,78,1314628
furpa,5.642857142857143,91,13,TTAGCATAACCAGGTAGGGC,78,1271865
furpa,0.7142857142857143,22,13,TTACCCCTAATCTAAAGAAA,9,1312989
furpa,0.5,19,13,TTACAGGTCAGGGCGCGGGT,6,1331697
furpa,5.642857142857143,91,13,TGTTGCCCGGGACTTTATTA,78,1296942
furpa,0.42857142857142855,18,13,TGTGGTGAAAGACAGGGTTC,5,1343870
furpa,0.14285714285714285,14,13,TGTGGCCCCTAAAAGCGGGA,1,1340228
furpa,1.3571428571428572,31,13,TGTACCCGGACGAACCTGGC,18,1295134
furpa,1.5,33,13,TGTAATTATATAAGACGTAA,20,1328364
furpa,6.285714285714286,100,13,TGTAATACAACTATCGCCCA,87,1273233
furpa,0.42857142857142855,18,13,TGGTTGCTGGATAATTAGCT,5,1312618
furpa,2.2142857142857144,43,13,TGGGAGGAGCATGAATCCAA,30,1276531
furpa,1.4285714285714286,32,13,TGGCGGTCAGATGGCCCACT,19,1329076
furpa,4.5,75,13,TGGCAAGGTAAGTCACATCG,62,1320448
furpa,2.0714285714285716,41,13,TGGCAAAATTTGTAACAGCG,28,1326453
furpa,1.3571428571428572,31,13,TGGAGTCAGGAACCACTGGC,18,1298045
furpa,3.357142857142857,59,13,TGGACCGCCAGATCGTGCTA,46,1301495
furpa,0.14285714285714285,14,13,TGGAATCGACGACGTTTATG,1,1308894
furpa,0.7142857142857143,22,13,TGCCAGTGATGAGCAAGGCG,9,1322887
furpa,0.5,19,13,TGATCATACGCTGCGTAGAG,6,1314411
furpa,2.5714285714285716,48,13,TGAGGTTACGGGGCAACAAA,35,1341441
furpa,0.14285714285714285,14,13,TGACAGACTGACACCTCCTT,1,1353049
furpa,8.928571428571429,137,13,TGAACGCTGCGCGATCCGAT,124,1312893
furpa,3.5,61,13,TGAACATTCAATGTTTATCA,48,1336224
furpa,0.2857142857142857,16,13,TCTTTATTACCAAGGAGGGT,3,1349391
furpa,0.14285714285714285,14,13,TCTTCTGGGTCCGTACGACA,1,1352947
furpa,4.857142857142857,80,13,TCTCCATTAGGCTCGATCTT,67,1318102
furpa,2.857142857142857,52,13,TCGTTCGAGGCCGCTCTACG,39,1276112
furpa,1.0714285714285714,27,13,TCGAGTAGTTAAACCCCCAA,14,1304938
furpa,2.0,40,13,TCCCTTGACAGCATTCGCAT,27,1332307
furpa,0.21428571428571427,15,13,TATTAGTAGCGGGCACGCCT,2,1338830
furpa,1.4285714285714286,32,13,TATGTGTGGCTCTCTAAGGG,19,1323349
furpa,0.9285714285714286,25,13,TAGGCAACATTCCTTACGCC,12,1273353
furpa,0.35714285714285715,17,13,TAGCGGCCTGAATAATAGCC,4,1351623
furpa,9.071428571428571,139,13,TAGCCGAAACGCATCTAAAC,126,1310977
furpa,4.928571428571429,81,13,TACTTCACATCACGGTAGAC,68,1345480
furpa,0.35714285714285715,17,13,TACTTATAGTCAATGGGGGT,4,1320574
furpa,0.6428571428571429,21,13,TACGGATTTAGGGCGACTCA,8,1287792
furpa,2.0714285714285716,41,13,TACCTGACACACATTAATAC,28,1279111
furpa,2.0714285714285716,41,13,TACCATGCGTAGTCATCGTA,28,1310890
furpa,2.642857142857143,49,13,TAATTATTACCGCGATACTG,36,1307016
furpa,0.6428571428571429,21,13,TAATCGCTCAATGTCATACT,8,1334174
furpa,2.857142857142857,52,13,TAATCCCCGTCTTCACGTGG,39,1355928
furpa,0.2857142857142857,16,13,TAACACGGTGCAAGCTCTGA,3,1308616
furpa,0.8571428571428571,24,13,GTTTCACACTAGCCCCACTA,11,1319111
furpa,0.35714285714285715,17,13,GTTAGACAGCTGCCCCATAC,4,1299402
furpa,0.14285714285714285,14,13,GTTAAATGCGAGGACTTAGT,1,1343284
furpa,1.3571428571428572,31,13,GTGTTCAGGTCTATGCGAAA,18,1275591
furpa,2.5,47,13,GTGGCGTATTGATGGAGGGA,34,1324381
furpa,1.0714285714285714,27,13,GTGAAACGGTCGAATGTTCG,14,1275984
furpa,0.42857142857142855,18,13,GTATGATAATATCACGGGAA,5,1273882
furpa,2.5714285714285716,48,13,GTATACGGCAGGAGCGCGGC,35,1352386
furpa,2.7857142857142856,51,13,GTACCTGTGATAATACCGGG,38,1300855
furpa,0.5,19,13,GTAATTGCCTAAAGATAAAA,6,1334997
furpa,1.3571428571428572,31,13,GGTGTTAGATTACTCTGCCA,18,1292105
furpa,0.14285714285714285,14,13,GGTGGTTTGAATACATCCAC,1,1301429
furpa,0.14285714285714285,14,13,GGTGATTGTCCTCTTAAGGT,1,1292153
furpa,1.7142857142857142,36,13,GGTCCGGGACCCCAATCCAG,23,1324055
furpa,1.4285714285714286,32,13,GGTATATCGTCCGTGTAAGC,19,1301153
furpa,4.357142857142857,73,13,GGGTGCAATAGTGTACGCGC,60,1288400
furpa,3.5,61,13,GGGTCATTGGATATAGCGCT,48,1333100
furpa,0.14285714285714285,14,13,GGGGCACAAAGTTCCAGGGT,1,1339194
furpa,1.0,26,13,GGGCTCACTCTCTCCAAGAG,13,1325525
furpa,0.14285714285714285,14,13,GGGATAAGCCAAAGGAGCTG,1,1285828
furpa,3.7142857142857144,64,13,GGGAGTTGGCGCATTTTCTT,51,1349119
furpa,0.35714285714285715,17,13,GGGACCTAAGTTTTTATCCT,4,1291519
furpa,1.0,26,13,GGCTCCCATAGTTGAGGGTG,13,1288599
furpa,2.7142857142857144,50,13,GGCGTATGACCCTCTGGTCC,37,1291556
furpa,1.7142857142857142,36,13,GGCCTCCTACTTGACCATCG,23,1312164
furpa,1.3571428571428572,31,13,GGCCGCCTTTCATTACGGAT,18,1281541
furpa,1.0714285714285714,27,13,GGCAGATTCTTTGTAGAACA,14,1340506
furpa,1.9285714285714286,39,13,GGCACGTATACTGAGAAGGA,26,1354879
furpa,3.0,54,13,GGACCCAGACTCAGAATCTT,41,1311571
furpa,3.642857142857143,63,13,GGAAAAGGAGCACGTCAAAT,50,1342129
furpa,1.5714285714285714,34,13,GCTGCAACCCCTCTGTGAGT,21,1304181
furpa,1.0,26,13,GCTCGGGCTGCCATGCGGGG,13,1276427
furpa,2.0714285714285716,41,13,GCTCGGCGCACCGATGCCGC,28,1291199
furpa,0.14285714285714285,14,13,GCGGAGGTTTTGGCTATGAA,1,1327036
furpa,3.0,54,13,GCGATCCTAGGGCTTTGATC,41,1284658
furpa,1.8571428571428572,38,13,GCCTTCCGGTCATCCCTGGT,25,1278551
furpa,0.8571428571428571,24,13,GCCATGTCCAGCCTACCAAC,11,1346300
furpa,0.14285714285714285,14,13,GCCAGCACTAGGAGCCACAA,1,1292420
furpa,1.4285714285714286,32,13,GCCAATGGTTAAATAAGATC,19,1308486
furpa,1.1428571428571428,28,13,GCATGACGCGGGGTAGGGTA,15,1348177
furpa,3.857142857142857,66,13,GCATATATGGGACTCTACTG,53,1291282
furpa,0.7142857142857143,22,13,GCATAGGATCAAAACCCCCA,9,1337379
furpa,1.8571428571428572,38,13,GCAGGCCCGTGGCACACCTA,25,1355426
furpa,3.642857142857143,63,13,GCACGTCGTGGGTAGCTAAT,50,1288477
furpa,2.2142857142857144,43,13,GCACGGACCACTATGAGCAG,30,1281115
furpa,0.2857142857142857,16,13,GCAAATAACGTAATTTTTGA,3,1282193
furpa,1.3571428571428572,31,13,GATTCGTTGCCTCCTACATG,18,1294538
furpa,2.5,47,13,GATGTAAGTGGCCTATTTAC,34,1321860
furpa,1.4285714285714286,32,13,GATACCATGGGTTATATAAC,19,1303364
furpa,0.5,19,13,GAGCGAGAATTCCGGCGGCA,6,1297669
furpa,0.14285714285714285,14,13,GAGACTAGATCTGATCTCTA,1,1283708
furpa,0.7142857142857143,22,13,GACGGCGAGCCATGGTTATC,9,1313387
furpa,1.8571428571428572,38,13,GACGCTAGGGATGACTGCCA,25,1321684
furpa,0.14285714285714285,14,13,GACACGTAGGTTACTGTGGC,1,1320249
furpa,1.5714285714285714,34,13,GAATGGGTGGCGTCTTTCCT,21,1332445
furpa,0.8571428571428571,24,13,GAATAAACGACTGTACCGGA,11,1306968
furpa,1.9285714285714286,39,13,GAAGAAGGCCACACACTGTC,26,1350614
furpa,1.2142857142857142,29,13,GAACAGGCTCCGGTTTAGAG,16,1297843
furpa,11.428571428571429,172,13,GAAAAGATCACGACGACTGT,159,1304899
furpa,2.142857142857143,42,13,CTTTACTTCGATTATACAAA,29,1333458
furpa,0.14285714285714285,14,13,CTTTACCATGCCAATGTCAT,1,1271784
furpa,4.357142857142857,73,13,CTTAACACGACCATGCACAT,60,1271866
furpa,2.5,47,13,CTGGTAGGGTTATGGTGTTC,34,1295641
furpa,2.9285714285714284,53,13,CTGGCGCTGGGACAAGGTAT,40,1302918
furpa,0.14285714285714285,14,13,CTGGAGGTCGGACGGTATAT,1,1329093
furpa,0.5,19,13,CTGCACGTCGCAGGGGGTTT,6,1338081
furpa,0.9285714285714286,25,13,CTGATCGCCAGCTCTCCCAG,12,1306698
furpa,2.4285714285714284,46,13,CTGAAGCAGGCTATTAGCAT,33,1337383
furpa,1.3571428571428572,31,13,CTCTACGCACAAGGATTCAC,18,1354471
furpa,0.9285714285714286,25,13,CTCGCTCACGCGCCGAAATT,12,1357216
furpa,2.142857142857143,42,13,CTCCTTAAGAACCGACGGGT,29,1330008
furpa,0.14285714285714285,14,13,CTCCTCCGTCATCTTGGGTT,1,1283543
furpa,11.428571428571429,172,13,CTCCGTAGCAATCTGATTCG,159,1288200
furpa,1.9285714285714286,39,13,CTCCATTTAGTAAAGCGCCT,26,1342294
furpa,2.357142857142857,45,13,CTCACTTTAAGTAGTGCTTT,32,1281013
furpa,0.14285714285714285,14,13,CTCAACCTCTGTCTGGTTAA,1,1354670
furpa,0.9285714285714286,25,13,CTATGCTGCTGGCATTACGA,12,1328753
furpa,5.714285714285714,92,13,CTATCTTGGAAAGCGGCCCA,79,1308840
furpa,0.2857142857142857,16,13,CTAGCTGTGATCCCTGAGTT,3,1306690
furpa,1.9285714285714286,39,13,CTACTTTTCTTTCCATTAGT,26,1314373
furpa,2.5,47,13,CGTATATCTGATAATGGAAA,34,1288150
furpa,2.2857142857142856,44,13,CGGTTCTACCCGGGATTGAA,31,1322385
furpa,2.0,40,13,CGGCGCATGGGGACCTGGTT,27,1320229
furpa,2.642857142857143,49,13,CGGATAACGTTGAGGTGACA,36,1289184
furpa,2.2142857142857144,43,13,CGCTTCGGTATAAGGCTAAC,30,1286594
furpa,1.9285714285714286,39,13,CGCTATTAAGCAGTATTTTT,26,1292333
furpa,0.42857142857142855,18,13,CGCTAATCGAGGATCCTAGG,5,1334990
furpa,2.9285714285714284,53,13,CGCGTATGTGGTTACGACAA,40,1293220
furpa,1.0714285714285714,27,13,CGCAGTGGAGGTCGTAGTTG,14,1324297
furpa,1.3571428571428572,31,13,CGATATGCAGCGGTAGGTCC,18,1330219
furpa,0.9285714285714286,25,13,CGAGTCACAGAACACAACGA,12,1280268
furpa,3.5714285714285716,62,13,CGAGAGCAAGCTTCCCTTTT,49,1311501
furpa,0.5714285714285714,20,13,CCTCAGTTTGCCATATCGCC,7,1319478
furpa,6.214285714285714,99,13,CCTCAGGCGGTAGCCTAGGG,86,1343523
furpa,1.0,26,13,CCTATTCCGTTGACAGTAGT,13,1339974
furpa,0.35714285714285715,17,13,CCGTATGGGAACGAGGTTTT,4,1346657
furpa,0.6428571428571429,21,13,CCGGTTAATCCGGGGGTATA,8,1356493
furpa,0.2857142857142857,16,13,CCGGCCATGCGGCGAGAGGG,3,1340766
furpa,2.142857142857143,42,13,CCGAACTATTATCCCGGGAT,29,1290848
furpa,3.2857142857142856,58,13,CCCTTCCAGGTGGGGCTACA,45,1285377
furpa,1.0714285714285714,27,13,CCCGTCAAGAGGTCTGAGAT,14,1297032
furpa,7.214285714285714,113,13,CCCGGATAAGATGTATCCCT,100,1273391
furpa,4.071428571428571,69,13,CCCCGCGAGCCCGTTGGGAG,56,1278036
furpa,1.9285714285714286,39,13,CCCACATCATTTGATCCGCA,26,1324253
furpa,2.857142857142857,52,13,CCATACTTAGAACCGAATGT,39,1309195
furpa,0.14285714285714285,14,13,CCAGGAGCATGCTTTTTCAT,1,1336121
furpa,0.14285714285714285,14,13,CCAGAAGCGCAGTCGGAGGG,1,1310600
furpa,0.14285714285714285,14,13,CCACAGTGGCGAGCGTCACT,1,1341320
furpa,0.14285714285714285,14,13,CATTATGCGTGTCTGAAAGT,1,1357137
furpa,6.857142857142857,108,13,CATGCACTGTTAGTTGCTCT,95,1287463
furpa,0.21428571428571427,15,13,CAGCGGCCGCGGCTATGTAT,2,1315109
furpa,2.4285714285714284,46,13,CACTCATGAGAAGGAAGCGT,33,1296686
furpa,0.21428571428571427,15,13,CACGTGGCTGAAGGATTGTG,2,1274741
furpa,0.14285714285714285,14,13,CACCCCTAGGCGAGCAATCA,1,1275504
furpa,2.642857142857143,49,13,CACCACATGTATACTCAAAA,36,1327272
furpa,2.857142857142857,52,13,CACAGGCACAGGTGCTGTAC,39,1340383
furpa,0.7142857142857143,22,13,CAATCCGGCCTTCTTCAATT,9,1353849
furpa,1.0,26,13,CAAGTGACGGTGAATGCAGT,13,1311995
furpa,2.5714285714285716,48,13,CAAGTATATGCGGTTAAAAG,35,1284381
furpa,1.7142857142857142,36,13,CAAAGGGAGGTACGTATCCA,23,1313808
furpa,1.2142857142857142,29,13,CAAAACGAAAAGTCATGTAA,16,1281188
furpa,0.35714285714285715,17,13,ATTATAAGGCGGATTCAAAT,4,1312142
furpa,7.714285714285714,120,13,ATTACAATGCGTTCATTGAC,107,1299365
furpa,0.6428571428571429,21,13,ATGTCGTGTGTCTGTAAAAC,8,1314234
furpa,0.2857142857142857,16,13,ATGTCAACAGAATTAAGTCA,3,1329945
furpa,2.5714285714285716,48,13,ATGGTAATTTGGTTTCTGGT,35,1329859
furpa,1.7142857142857142,36,13,ATGGCAGCGAATGGACTAAA,23,1305321
furpa,2.642857142857143,49,13,ATGATAGGGCCGAGTAATAC,36,1292376
furpa,0.14285714285714285,14,13,ATCTGTATCCGCAGAGGCCT,1,1354842
furpa,2.7857142857142856,51,13,ATCTATCACTAGCTGATCTT,38,1310967
furpa,2.857142857142857,52,13,ATCGTCCCAGCAGAGTGCGA,39,1303567
furpa,0.8571428571428571,24,13,ATCATCCTTAGCTAGATATC,11,1327615
furpa,0.6428571428571429,21,13,ATCACCCTATCATCTCGCGA,8,1333224
furpa,0.21428571428571427,15,13,ATATAGAAATGCTATCACTC,2,1282776
furpa,1.4285714285714286,32,13,ATAGTAAGCTCTTTCCATGG,19,1313663
furpa,0.7142857142857143,22,13,ATAGCTTGCGTTGCGAGTGT,9,1316327
furpa,5.357142857142857,87,13,ATACGCACTCTAGATCAATG,74,1303872
furpa,2.0,40,13,ATACCTAGGATCTTAGAAGA,27,1323592
furpa,1.0,26,13,ATACCCTCGTCCGACGAGGA,13,1321724
furpa,0.35714285714285715,17,13,AGTTGGGGGTCAGAAGATAG,4,1343893
furpa,0.5,19,13,AGTTCATACCCCCGGTTTCA,6,1321974
furpa,3.4285714285714284,60,13,AGTCTAAGTACATTCAGAGT,47,1276298
furpa,0.21428571428571427,15,13,AGGTACCTTGAAAGAATGGA,2,1351838
furpa,2.7142857142857144,50,13,AGGGGCAGTGTTCAGAGGCA,37,1336084
furpa,4.142857142857143,70,13,AGGCATGTTGTTGGCGCGGG,57,1276916
furpa,3.9285714285714284,67,13,AGGAGCGTCACAACCAATTG,54,1330114
furpa,2.4285714285714284,46,13,AGCTTTCGCCCAAGTAATAA,33,1306419
furpa,0.42857142857142855,18,13,AGCTGACCGATCTCCACCGC,5,1300599
furpa,0.14285714285714285,14,13,AGCTCAAGCAGTGCATGATC,1,1271991
furpa,2.2857142857142856,44,13,AGCGGTTGCAACCTATCGGC,31,1274445
furpa,1.6428571428571428,35,13,AGCGCTTATGCGTCCAGAAT,22,1288161
furpa,5.285714285714286,86,13,AGCCTGTAAAAAGAATGGCT,73,1320119
furpa,1.2857142857142858,30,13,AGCAAGGCGCGGTGGTGATC,17,1337017
furpa,0.35714285714285715,17,13,AGAGTCAAAGCTACTTCCAC,4,1325973
furpa,3.142857142857143,56,13,AGAGCAACTCAACTAAATAA,43,1334462
furpa,3.357142857142857,59,13,AGACCCGATTATATGGGCCT,46,1283900
furpa,0.5714285714285714,20,13,AGAACCGCAGGTGTCACTTA,7,1285368
furpa,1.7142857142857142,36,13,ACGTTGCTGATCTGCTAGCT,23,1295143
furpa,5.0,82,13,ACGTGCGACAGTGCGAGATA,69,1300194
furpa,0.9285714285714286,25,13,ACGTCATGCCAAAGTTCACA,12,1317994
furpa,2.142857142857143,42,13,ACGGGCTTTGTCACTGCTTA,29,1334025
furpa,0.14285714285714285,14,13,ACGGATCTCGAGGAGTGCAT,1,1319446
furpa,1.0,26,13,ACGCTCATTAGATCACAGAA,13,1300155
furpa,3.9285714285714284,67,13,ACGCGTAACTTTCCGTTGTA,54,1339136
furpa,0.14285714285714285,14,13,ACGCAATGTGTCAGAGGTCT,1,1277970
furpa,1.7857142857142858,37,13,ACCCCTCTAGACTCAGTCAG,24,1291547
furpa,3.142857142857143,56,13,ACCCCGTGGGAAAACTAAGA,43,1304797
furpa,0.14285714285714285,14,13,ACCCCCTGCACGGGGCAACT,1,1308552
furpa,5.857142857142857,94,13,ACCCACCGGAAGGGAACACT,81,1285023
furpa,0.2857142857142857,16,13,ACCAGCCCTGCCAAACTAAC,3,1279935
furpa,0.35714285714285715,17,13,ACATCCTAAAAAGTCGTCGG,4,1288576
furpa,1.6428571428571428,35,13,ACAGGTGAGTATAGCTCCGA,22,1293534
furpa,19.071428571428573,279,13,ACAGGTACCCACGTACTAAG,266,1326551
furpa,2.142857142857143,42,13,ACACCCTCCATGCACATGTT,29,1341442
furpa,3.7142857142857144,64,13,ACAATGAAACAACACATAAT,51,1316528
furpa,0.42857142857142855,18,13,AATTGCTTGGGCCTGCCGCA,5,1355638
furpa,1.8571428571428572,38,13,AATGTGAAAGGGAGCAGGAC,25,1335574
furpa,2.0714285714285716,41,13,AATCTGCGCGGCGCGCGTAT,28,1310470
furpa,1.7857142857142858,37,13,AATAGGTTGTGTGGAATCGC,24,1330073
furpa,0.14285714285714285,14,13,AAGCGTTAGCAGCGACATTT,1,1285916
furpa,0.2857142857142857,16,13,AAGATGGTGTTAGAGAGTCT,3,1323676
furpa,1.0714285714285714,27,13,AACTGCGCTTGTGCAGCAGC,14,1308563
furpa,2.357142857142857,45,13,AACCAGCAGGTAGAATATTG,32,1334351
furpa,1.7142857142857142,36,13,AAAGTACTGACCACGTTTAC,23,1289959
furpa,1.4285714285714286,32,13,AAAGGGTCAATAGTCTGTTA,19,1293854
furpa,1.7142857142857142,36,13,AAAGCCTTAGTCAGCCCAGA,23,1311366
furpa,1.0714285714285714,27,13,AAACTCTCGGTAGGCTGGAT,14,1305842
furpa,1.2307692307692308,27,12,TTTTTCTACTCAGCAGGGGT,15,1338130
furpa,2.3076923076923075,41,12,TTTTACGGTGGTTAGAGCGA,29,1322265
furpa,0.15384615384615385,13,12,TTTCTGTGGAAAGGCCGAGT,1,1294300
furpa,0.6923076923076923,20,12,TTTCCTGGCGTACGTAATGT,8,1309007
furpa,0.15384615384615385,13,12,TTGTTCAAGACCAACAACAA,1,1318131
furpa,1.3076923076923077,28,12,TTGGTGATCCCCACAATCAT,16,1306591
furpa,11.692307692307692,163,12,TTGGGTTCGGAACACAAGCC,151,1295644
furpa,1.8461538461538463,35,12,TTCGTCAACTACGCACCATT,23,1348332
furpa,0.3076923076923077,15,12,TTCGACGGTGCGAATTCGGG,3,1296981
furpa,1.5384615384615385,31,12,TTATAGGAAAGGCTAGCGGA,19,1338972
furpa,0.9230769230769231,23,12,TTACTATAGTGTCAATGTGC,11,1315275
furpa,0.8461538461538461,22,12,TTAAAAAGCAATGCAGAGTC,10,1311064
furpa,0.15384615384615385,13,12,TGTTACGTATTTGGAGGTCT,1,1304456
furpa,0.15384615384615385,13,12,TGTCGCCAGAGTGATGGATC,1,1355853
furpa,3.076923076923077,51,12,TGTACACGCAGGTCGAAATT,39,1346451
furpa,6.846153846153846,100,12,TGGTCGTTCCCTAAGAAACT,88,1278762
furpa,2.3076923076923075,41,12,TGGCGGTTGGAAAAGCTATT,29,1309287
furpa,4.153846153846154,65,12,TGGACTCTACAAGTACGTGA,53,1295817
furpa,2.0,37,12,TGCTCGACTCACGACGAAAG,25,1343108
furpa,2.6153846153846154,45,12,TGCTAGTAAGATTCAGGCAT,33,1341334
furpa,1.7692307692307692,34,12,TGCATGGAGTTGTGGTCGCA,22,1303615
furpa,2.230769230769231,40,12,TGCAGATGGAAATGGTCAAC,28,1335085
furpa,1.2307692307692308,27,12,TGCAATCCGAACATGCCGTA,15,1289204
furpa,1.7692307692307692,34,12,TGATTCAGTAGTGTTGGCGA,22,1279199
furpa,1.0769230769230769,25,12,TGAGCATGCGGAGCTTTCAA,13,1282319
furpa,4.384615384615385,68,12,TGACAGTAAAGCTTGGTGTG,56,1316460
furpa,0.15384615384615385,13,12,TCTTCTGTAAGTGAGACAAA,1,1337361
furpa,0.5384615384615384,18,12,TCTGCGTTTGATGTTGTCAT,6,1327568
furpa,0.15384615384615385,13,12,TCTCCGAGCGCGGATTCCTC,1,1299430
furpa,11.615384615384615,162,12,TCTACCGCAGATCGATGATC,150,1320142
furpa,2.230769230769231,40,12,TCGGTTGGCATATGGCGGTT,28,1319631
furpa,3.3846153846153846,55,12,TCGGTTCTCACAGCACTGAT,43,1290310
furpa,0.15384615384615385,13,12,TCGGTCCGCGGGCAATCGGT,1,1326082
furpa,4.461538461538462,69,12,TCGGAATTTCATAACTTCGT,57,1343514
furpa,1.3846153846153846,29,12,TCGCAGGGAGGGGATCAAAC,17,1331202
furpa,5.6923076923076925,85,12,TCGACGCACGTTGCTTCATT,73,1335997
furpa,3.923076923076923,62,12,TCGAAGTTTCACAAGTTGTT,50,1308933
furpa,2.0,37,12,TCCGGCTTCGTATAGGCGTA,25,1291142
furpa,0.3076923076923077,15,12,TCCCCTACTACAATTCGACA,3,1334701
furpa,2.230769230769231,40,12,TCCCCCTCCGACGGGTAGTG,28,1329248
furpa,1.3846153846153846,29,12,TCCCACTCGGTGGGAGCTTA,17,1307595
furpa,0.6153846153846154,19,12,TCCATCTCAACGAGCAAAAA,7,1295850
furpa,0.23076923076923078,14,12,TCCACTCGTGGCACGCACAA,2,1293788
furpa,3.8461538461538463,61,12,TCATGTCTCGTCAGAGCCCT,49,1351249
furpa,2.076923076923077,38,12,TCATCAGCTAGGCTAGGATT,26,1305365
furpa,1.1538461538461537,26,12,TCACCCAGCGGACTGCAAAG,14,1279641
furpa,0.15384615384615385,13,12,TCACCACATTGGATGTCTGA,1,1318770
furpa,11.307692307692308,158,12,TCAATAACTGATCGGCCGGG,146,1288390
furpa,1.0769230769230769,25,12,TATTTGGCATAGTTAAAATG,13,1280370
furpa,2.8461538461538463,48,12,TATTCCGGGATAAACAGTTG,36,1290358
furpa,1.2307692307692308,27,12,TATTCACGCGTATTACGGTA,15,1271886
furpa,2.076923076923077,38,12,TAGACGGCAGCGTTCTCACC,26,1317540
furpa,1.6153846153846154,32,12,TACGCCTTCGTTTTTAATTC,20,1275917
furpa,1.3076923076923077,28,12,TACGAAGAGTCTCTAACGTT,16,1334381
furpa,0.15384615384615385,13,12,TAATTCAGATGGAACTCGGG,1,1331156
furpa,5.769230769230769,86,12,TAAGCACCGGTAACCCATTA,74,1275376
furpa,0.15384615384615385,13,12,TAACCTAATTCGCTATTTCT,1,1320038
furpa,3.3076923076923075,54,12,TAACAGATGCTTTGATAGTT,42,1334244
furpa,1.5384615384615385,31,12,TAAATCTAGATCGCATATGT,19,1335531
furpa,3.3846153846153846,55,12,TAAACGGGGCCATTGGACTC,43,1291805
furpa,0.6153846153846154,19,12,GTTGTATGGCATTACCGTTT,7,1317608
furpa,6.461538461538462,95,12,GTGGGCCTTAGAAGCGCCCT,83,1334679
furpa,4.076923076923077,64,12,GTGAGGGACGGACCGCCTTC,52,1273614
furpa,1.0769230769230769,25,12,GTGAGACGGATCTGACGACT,13,1315376
furpa,0.46153846153846156,17,12,GTGACGCGGTAGCGATGTGG,5,1277756
furpa,1.0,24,12,GTCTCCGGTATGTAGTGAGG,12,1284727
furpa,0.15384615384615385,13,12,GTCGGTGGTTTGAGCAATTT,1,1273859
furpa,0.38461538461538464,16,12,GTATCCCTGTTAGCACTTGA,4,1283781
furpa,1.4615384615384615,30,12,GTAGCAGACTGGGTTCCCCA,18,1316061
furpa,3.076923076923077,51,12,GTAAGGCGGGAGTTCCTCCT,39,1324488
furpa,0.23076923076923078,14,12,GGTCGCCGCCGGTGAAGCCA,2,1305082
furpa,1.9230769230769231,36,12,GGTATAGCGTGGGTCAGTGA,24,1344777
furpa,0.15384615384615385,13,12,GGGTGTTTTACGGTTACGAT,1,1280823
furpa,0.6923076923076923,20,12,GGGGGAAATGGCCCCTGCTG,8,1295628
furpa,2.8461538461538463,48,12,GGCTATGTTCCCACCTAGTA,36,1272589
furpa,7.538461538461538,109,12,GGCGTTCGTGTATAGGACTC,97,1333612
furpa,2.923076923076923,49,12,GGCGAAATCGCTATTAGGAC,37,1273081
furpa,0.15384615384615385,13,12,GGCCGATACTAACAACAGTA,1,1297095
furpa,0.15384615384615385,13,12,GGCCCAATAACCACCATGAT,1,1354674
furpa,2.0,37,12,GGCAGCACCAGAAGACCAAC,25,1291201
furpa,1.8461538461538463,35,12,GGATGTTTCTCGTCTGCGCT,23,1343190
furpa,0.15384615384615385,13,12,GGAGGGGATTCCTATCATTG,1,1329292
furpa,1.0,24,12,GCTTGTACTTTTCCAATCTT,12,1356738
furpa,1.5384615384615385,31,12,GCTTCTACGGTCGAGGGGCT,19,1340910
furpa,14.923076923076923,205,12,GCTGCGGTAGGCTGCATCAG,193,1311578
furpa,4.076923076923077,64,12,GCTATGTTACACGTATCGCT,52,1323629
furpa,0.46153846153846156,17,12,GCTACTGACGCTTCACACTG,5,1316745
furpa,1.3076923076923077,28,12,GCGTTTGCAGACCATTTCAA,16,1277407
furpa,1.0769230769230769,25,12,GCGTGAGCGTTACTGGCATT,13,1322040
furpa,2.3846153846153846,42,12,GCGGACAACCTGTCATACTG,30,1273830
furpa,1.6153846153846154,32,12,GCGCTCTGTATGCAAGCGGA,20,1274129
furpa,1.8461538461538463,35,12,GCGATCCAATAAAAGCAGAG,23,1273181
furpa,1.6923076923076923,33,12,GCGACCTAGATTTCAGACGC,21,1337661
furpa,1.0769230769230769,25,12,GCGACAGCGGGACATAGACA,13,1336070
furpa,0.23076923076923078,14,12,GCCTGACCCATGGCGGCAGT,2,1321298
furpa,0.46153846153846156,17,12,GCCGTTCCTCGTCGTGTTTG,5,1303823
furpa,1.6923076923076923,33,12,GCCGTGGGGATGCTAACCTG,21,1289777
furpa,2.8461538461538463,48,12,GCCCGCATGCACTTAATTTT,36,1338519
furpa,2.3076923076923075,41,12,GCCCACATTTGTATATCTAT,29,1272303
furpa,1.1538461538461537,26,12,GCCATTTCAATATAACCAAA,14,1294090
furpa,1.4615384615384615,30,12,GCCAAATGCGGAACTCCTTC,18,1280433
furpa,9.0,128,12,GCCAAAAAGCGATCTATATC,116,1355856
furpa,5.923076923076923,88,12,GCATTGTCAGAGTAATCATG,76,1279982
furpa,1.2307692307692308,27,12,GCATCTGGCCAGTGATGGGA,15,1318864
furpa,1.0,24,12,GCATCTATAAGAAGGCATGT,12,1316900
furpa,0.6923076923076923,20,12,GCAGTTAAAACAAGCCCCAG,8,1277659
furpa,1.5384615384615385,31,12,GCAGTGCGTACTTCCCTGGC,19,1331518
furpa,3.769230769230769,60,12,GCACGGCGATCGGAGTTCGT,48,1299926
furpa,4.538461538461538,70,12,GCACATGCACTAGCCTGAGG,58,1292587
furpa,0.15384615384615385,13,12,GCAACTAACTACGTTCACAT,1,1290874
furpa,0.46153846153846156,17,12,GCAACGGACCGTAGGGTACA,5,1289958
furpa,3.6153846153846154,58,12,GCAACATTGCTAAGGGGACA,46,1325226
furpa,5.384615384615385,81,12,GATGCTGTAGGTCTCCTGAG,69,1282970
furpa,0.38461538461538464,16,12,GATATAACAGGTGCTTCGAT,4,1279033
furpa,5.846153846153846,87,12,GAGTCGGATTTCGGGCTGCA,75,1301461
furpa,0.23076923076923078,14,12,GAGGGCGTCCTAGGTAAAGT,2,1347362
furpa,3.230769230769231,53,12,GAGCCACGTGGGGCCGATCT,41,1320120
furpa,0.6153846153846154,19,12,GAGACATGTAGGATGGTAGC,7,1306794
furpa,3.0,50,12,GACTTACCGTTTGAGCGAGC,38,1278660
furpa,0.15384615384615385,13,12,GACTTAAGGGTAAGAGTGGC,1,1344573
furpa,0.9230769230769231,23,12,GACTATGGAACATGTTGGGA,11,1310534
furpa,8.846153846153847,126,12,GACCGGCAGGCACAGGGAGC,114,1271859
furpa,0.15384615384615385,13,12,GACAGGGCAAAGCGGGATGT,1,1295137
furpa,3.6153846153846154,58,12,GAATCCTGTGATGCTCACAT,46,1333410
furpa,1.6153846153846154,32,12,GAACTGAGTAGAGGCTGGAA,20,1297100
furpa,0.38461538461538464,16,12,GAACTATAACCCCAGTTCGT,4,1298585
furpa,0.38461538461538464,16,12,CTTCGTTTTAGAGCTGCTGG,4,1298159
furpa,2.8461538461538463,48,12,CTTCCTCTGCAGTACCAGGT,36,1285461
furpa,1.1538461538461537,26,12,CTTATCGGCGTTGAGTTCCA,14,1293574
furpa,2.6153846153846154,45,12,CTTAATGACCCGTCAGCTTA,33,1279513
furpa,2.4615384615384617,43,12,CTGTTGGTACGGTGTTGATT,31,1340487
furpa,1.0,24,12,CTGGGTCCTTCTTGGAATTC,12,1325017
furpa,0.15384615384615385,13,12,CTGCTTGTGCAGTGATAGTC,1,1287870
furpa,1.6153846153846154,32,12,CTGCGTGTGAACCCGGCGGG,20,1288598
furpa,0.46153846153846156,17,12,CTGCGAGTTGGATTGTTAAC,5,1311711
furpa,1.3076923076923077,28,12,CTCTTCTGTATAGATATATA,16,1352951
furpa,2.4615384615384617,43,12,CTCTTACGGGAGAGTTGGAC,31,1303407
furpa,0.9230769230769231,23,12,CTCTCAGAAAGCTCGCTAAG,11,1281166
furpa,2.923076923076923,49,12,CTCCTAAGAGTGTAACGTCT,37,1290715
furpa,2.076923076923077,38,12,CTCCCTAGCTGTGCGTCGCC,26,1343105
furpa,2.1538461538461537,39,12,CTCCAAAGCGACACGAAGTT,27,1345132
furpa,0.46153846153846156,17,12,CTCATAGTCTCTGTGGTTCA,5,1294700
furpa,2.8461538461538463,48,12,CTCACTTCCGCTATGCTCTT,36,1326599
furpa,1.8461538461538463,35,12,CTCACAGGGCTAAGGCGTAC,23,1336641
furpa,2.0,37,12,CTAGGTATGCCACTTTCCTA,25,1322560
furpa,4.0,63,12,CTACCAACACTCGTACACTC,51,1331969
furpa,4.769230769230769,73,12,CTAAGCTTAGGCTTCTTTAC,61,1301266
furpa,0.15384615384615385,13,12,CGTTGATATGGGTGTAAGAA,1,1328100
furpa,3.230769230769231,53,12,CGTTATTGGGGGGGCTACAA,41,1355812
furpa,1.0769230769230769,25,12,CGTTAATTGGGCGAAGGCGT,13,1280498
furpa,7.0,102,12,CGTGCTCCGTTTAGAATAGA,90,1339305
furpa,1.0,24,12,CGTGCCGGTCAAGTTGAGTG,12,1324842
furpa,0.5384615384615384,18,12,CGTGAGCTATACAACGCGTT,6,1332694
furpa,0.15384615384615385,13,12,CGTAATGTCATTTAAAATGG,1,1288531
furpa,2.6923076923076925,46,12,CGGTTCAACAAGAGGAGAAG,34,1297767
furpa,0.7692307692307693,21,12,CGGGTATAATGCAGTATTTT,9,1337521
furpa,1.3846153846153846,29,12,CGGCTTACTGTTTGGATAAA,17,1312243
furpa,2.1538461538461537,39,12,CGCTATCGTCAGGGCGCTAC,27,1324956
furpa,2.3846153846153846,42,12,CGCGCGTTGGGCCGCATCAT,30,1320227
furpa,2.230769230769231,40,12,CGCCATGGTGGGCCTCCGTT,28,1283593
furpa,3.230769230769231,53,12,CGCAACAATTAAAGGCAAGA,41,1284342
furpa,0.8461538461538461,22,12,CGATTTGGAACAAACATCTA,10,1329267
furpa,1.5384615384615385,31,12,CGAGGGCGATATACCAGATG,19,1352788
furpa,8.923076923076923,127,12,CGACCCACGAAGCGCTGGTT,115,1325845
furpa,1.6153846153846154,32,12,CCTCTATGATTTTCGTGTAG,20,1273994
furpa,2.230769230769231,40,12,CCTACCATGCGCACCAGGGT,28,1318616
furpa,0.9230769230769231,23,12,CCGTAAGACAGTTCATTGCT,11,1331307
furpa,0.3076923076923077,15,12,CCGCGGCGTACGGCTCTGGG,3,1273374
furpa,2.3076923076923075,41,12,CCCTCCCTCTATCGCGCGTG,29,1306228
furpa,3.6153846153846154,58,12,CCCGGCGGATTCCTCCGAAG,46,1272111
furpa,1.3076923076923077,28,12,CCCGAATTGTTCCCGTCCTG,16,1293332
furpa,6.923076923076923,101,12,CCCCTTTCAACAAATAGTCC,89,1278754
furpa,0.3076923076923077,15,12,CCCCTAATCTAAAATAGAAC,3,1296907
furpa,3.769230769230769,60,12,CCCCGTTGTGGAATTTAGGG,48,1344270
furpa,10.0,141,12,CCATGCAAGTCCCATCTTGA,129,1347026
furpa,0.15384615384615385,13,12,CCAGATCGTATCAGAAGCCG,1,1305080
furpa,2.1538461538461537,39,12,CCACCGTCTCGCATTGGGAA,27,1289019
furpa,0.15384615384615385,13,12,CCAAGCAGCAGCCTTCTTCA,1,1323979
furpa,0.15384615384615385,13,12,CATTTCTAGGTCGGTAGATT,1,1281187
furpa,0.5384615384615384,18,12,CATTTCGGTACCATCTAGCC,6,1318266
furpa,0.6153846153846154,19,12,CATCATATCCAAACGCCTAG,7,1357120
furpa,2.0,37,12,CATCACAGGCTAGGACTCCT,25,1297350
furpa,0.15384615384615385,13,12,CAGTTCTGATAGATGGTGAG,1,1285237
furpa,4.230769230769231,66,12,CAGTAGTTGGGGTCGAGATC,54,1321283
furpa,0.5384615384615384,18,12,CAGCCAGGACAGATAGATCA,6,1300083
furpa,2.0,37,12,CAGACAGGATTCTACGACAC,25,1327888
furpa,1.3846153846153846,29,12,CACTCAGGTATGAGGAAGTA,17,1330041
furpa,2.3076923076923075,41,12,CACGCCGCCGCCGCCAGACA,29,1296740
furpa,2.1538461538461537,39,12,CACCTGAAGCAATGGCGTAT,27,1312850
furpa,0.23076923076923078,14,12,CACCAGTCACCGCGTACTTG,2,1343196
furpa,0.3076923076923077,15,12,CACCACGCGGCATTAAGCGT,3,1300105
furpa,0.46153846153846156,17,12,CACATAGCCCCTCGATGCCC,5,1325111
furpa,1.3846153846153846,29,12,CAATTGCATTTGTAGCATTG,17,1283973
furpa,1.9230769230769231,36,12,CAAGTTAGAAAGTAACCCCA,24,1276577
furpa,0.38461538461538464,16,12,CAACACGGTGGAACTTATGG,4,1330398
furpa,4.615384615384615,71,12,CAAAAAGGACCATTCGAAAA,59,1328589
furpa,3.6153846153846154,58,12,ATTCATCTTAGCGAACGCGG,46,1291832
furpa,1.0,24,12,ATTACAGCAGTCCAATGCGT,12,1294123
furpa,2.4615384615384617,43,12,ATGTTACCCCTCCTTACGTT,31,1296230
furpa,6.230769230769231,92,12,ATGTAAAAGTTACATATTCT,80,1350886
furpa,0.7692307692307693,21,12,ATCTGAACGGGATTGCTTAA,9,1298113
furpa,0.15384615384615385,13,12,ATCCGCGTGACTGGTATTGT,1,1279186
furpa,0.6153846153846154,19,12,ATCCCATTATGGTTCGACAT,7,1348784
furpa,2.6153846153846154,45,12,ATCATTTTTCTTTGCCAAGC,33,1304964
furpa,3.769230769230769,60,12,ATACCGTTTTGTATCGTTCC,48,1341440
furpa,0.15384615384615385,13,12,ATAAAACGTCTACAACGTCC,1,1337873
furpa,0.6153846153846154,19,12,AGTTCTATTAGCAGTTCATT,7,1288421
furpa,1.8461538461538463,35,12,AGTGGGCCTTGGGCAATCAG,23,1313116
furpa,0.23076923076923078,14,12,AGTCCAAGTCCTCAGCGTCT,2,1322353
furpa,12.076923076923077,168,12,AGTCAAGACGTGGCTAGCAA,156,1330211
furpa,3.5384615384615383,57,12,AGGTAGTCACTGATGCTACT,45,1343711
furpa,2.6153846153846154,45,12,AGGTAATTTCGCGTCCAACT,33,1323478
furpa,3.1538461538461537,52,12,AGGGTAATTGTGTGTAATTA,40,1284458
furpa,1.0769230769230769,25,12,AGGGGAAGCATCACGGATTT,13,1347863
furpa,2.0,37,12,AGGGAGCAAAACTGCGTGAA,25,1294844
furpa,0.9230769230769231,23,12,AGGATTAAGCCACACAGCCC,11,1283782
furpa,0.6153846153846154,19,12,AGGAGCGGCTATGCACCGTT,7,1339357
furpa,0.15384615384615385,13,12,AGCTTTTGTACGCTAAGTAA,1,1282934
furpa,1.8461538461538463,35,12,AGCTTTCACGAGTTCGCAGT,23,1356287
furpa,0.6923076923076923,20,12,AGCTTGGACAATTGGGGATG,8,1333472
furpa,5.230769230769231,79,12,AGCTTCTCTCTATTTGTCCT,67,1306397
furpa,0.8461538461538461,22,12,AGCTTAATTGTCTACAATAC,10,1343214
furpa,2.3846153846153846,42,12,AGCGCGGTACTGTCGGAGGG,30,1291313
furpa,1.0,24,12,AGCCTTGTCATGAACATGAA,12,1344204
furpa,0.15384615384615385,13,12,AGCCCTGCGTAGACCTAAGA,1,1310346
furpa,2.3076923076923075,41,12,AGATGTGGTCGGATGTTCTA,29,1354639
furpa,0.23076923076923078,14,12,ACTGGTTTACAGTTCAACGT,2,1313709
furpa,3.5384615384615383,57,12,ACGTTCCGTGAGAGTCGATA,45,1352873
furpa,3.3846153846153846,55,12,ACGTCACTAAGGATGAGATA,43,1290028
furpa,3.0,50,12,ACGGTGGGCGCGCAGACTCG,38,1289834
furpa,0.15384615384615385,13,12,ACGGAATACCGCCTAGAAGT,1,1357319
furpa,4.076923076923077,64,12,ACCGCTTACGCTCACTGAGT,52,1331330
furpa,3.1538461538461537,52,12,ACCCGTTTCCATGGTATAAC,40,1320118
furpa,5.461538461538462,82,12,ACCACAAGACCCTGCATAAT,70,1354282
furpa,0.3076923076923077,15,12,ACAGGTGATTGAAACCATGT,3,1352991
furpa,0.46153846153846156,17,12,ACAGCTCTAGGGTACGTATT,5,1279723
furpa,0.23076923076923078,14,12,ACAGCCGTCTAAGTGTGATC,2,1287863
furpa,2.769230769230769,47,12,ACAGAAAGATGAATAGCTTC,35,1273294
furpa,0.3076923076923077,15,12,AATTCTGTGCATACGTGAAA,3,1287207
furpa,4.230769230769231,66,12,AATGCCGCCTCCGGTGAGCA,54,1348575
furpa,1.6153846153846154,32,12,AATCTTCATCGCTTGAGACA,20,1309280
furpa,0.6923076923076923,20,12,AATAGACTCCTATAGTTGGG,8,1297179
furpa,2.3846153846153846,42,12,AAGTCACGTACGGTCGGAGG,30,1299526
furpa,0.6153846153846154,19,12,AAGGACGTAAAAGTCATCAT,7,1294468
furpa,0.6923076923076923,20,12,AAGCTCCCTAATAGAGTGGG,8,1349390
furpa,5.615384615384615,84,12,AAGCGCAGCTACTCACGGAA,72,1326347
furpa,0.15384615384615385,13,12,AAGCCATAACGCCACATTGT,1,1298080
furpa,0.23076923076923078,14,12,AAGATTGTGTAATATTCAAA,2,1321562
furpa,0.15384615384615385,13,12,AACTTGGGATACAGGACTGA,1,1302928
furpa,0.15384615384615385,13,12,AACTCTATAATTCACGCGTC,1,1287990
furpa,3.6923076923076925,59,12,AAACGGGCGGAATAAAGTTA,47,1300854
furpa,2.3333333333333335,38,11,TTTTCTCCTCGGTTCACCAG,27,1271857
furpa,1.9166666666666667,33,11,TTTGGATGAATTAACCCGAA,22,1291376
furpa,4.0,58,11,TTTGCAGCACGTACGAATCT,47,1327904
furpa,0.6666666666666666,18,11,TTTCGTCATGAGGGTGAGGA,7,1309330
furpa,4.166666666666667,60,11,TTGGTTGCAGCATGCGCTCT,49,1325261
furpa,1.8333333333333333,32,11,TTGGGGACTAGAGCAGATGA,21,1292695
furpa,0.6666666666666666,18,11,TTGCGGGAATCCCGATGTTC,7,1312981
furpa,0.5,16,11,TTGCCTACGGAGGGGCCGGC,5,1348476
furpa,1.9166666666666667,33,11,TTGACGTTGCCCCATTGTGC,22,1310270
furpa,6.166666666666667,84,11,TTGACATGGACCGAACATCG,73,1283226
furpa,1.4166666666666667,27,11,TTGAATTATCCGGGGCTTAT,16,1288005
furpa,0.6666666666666666,18,11,TTGAATGGGCTTTAGCATAA,7,1343015
furpa,3.6666666666666665,54,11,TTCTGCTCGAGGATCGCCTC,43,1292379
furpa,1.75,31,11,TTCTGCCAGATCACATATAG,20,1325934
furpa,1.1666666666666667,24,11,TTCGCTAATCGGGCGCCCGA,13,1312559
furpa,5.0,70,11,TTATGTGCCTCGAGAGCACC,59,1355620
furpa,0.75,19,11,TTAGTGGCCACCATCGCGCC,8,1272910
furpa,0.16666666666666666,12,11,TTAACGGCATTACGGGGTCT,1,1305950
furpa,1.3333333333333333,26,11,TGTGGTGAAACTAGCCGCAA,15,1318836
furpa,2.25,37,11,TGTCTAGCTCACAGGAGGTC,26,1308966
furpa,2.4166666666666665,39,11,TGTCCGGTGGTGTCCAGCCC,28,1271815
furpa,2.8333333333333335,44,11,TGTCAGTGTCAATTCCGGAC,33,1325572
furpa,0.8333333333333334,20,11,TGGCGTTGCATTGCACTGCC,9,1305639
furpa,0.16666666666666666,12,11,TGGAGGTGCCATTAATGTGA,1,1292428
furpa,0.5,16,11,TGCTTAGTGACTACCACATG,5,1279867
furpa,2.5833333333333335,41,11,TGCGTACGCAAATGACAAAG,30,1321626
furpa,0.16666666666666666,12,11,TGCATATTGACTATCGGGGG,1,1324672
furpa,1.25,25,11,TGCAGCAAAAGATCAATGCT,14,1356526
furpa,5.083333333333333,71,11,TGCAGAGACGGAGGGAGATC,60,1278756
furpa,0.3333333333333333,14,11,TGATAAACCGTTTTCTCGAT,3,1313064
furpa,3.0,46,11,TGACTGGGTCAGAAAGAGAA,35,1279222
furpa,2.25,37,11,TGACGACGATTTCCCACGTG,26,1314631
furpa,0.25,13,11,TCTGAGGTTCAGGGTGCCTT,2,1342162
furpa,3.4166666666666665,51,11,TCTCGCAAAGCCGAAGTAGT,40,1320463
furpa,0.9166666666666666,21,11,TCTCCGTCCGGCGAGTTTAT,10,1337057
furpa,7.25,97,11,TCGTGTTTGTTTGCTTATTT,86,1338747
furpa,0.16666666666666666,12,11,TCGGCGGCACCTATTAACGG,1,1315477
furpa,1.75,31,11,TCGGATGTTCCTGCCCATTC,20,1312994
furpa,1.75,31,11,TCGGAAGCAAGTTGATTACG,20,1322253
furpa,2.0833333333333335,35,11,TCGACTACAACATATACCGC,24,1351427
furpa,3.75,55,11,TCCTTATACGCCCGTCTTAG,44,1357330
furpa,0.16666666666666666,12,11,TCCCTGTGACGACCGGTGGA,1,1271671
furpa,0.16666666666666666,12,11,TCCATACCCAAGGTGAATTG,1,1305176
furpa,13.0,166,11,TCCAGCGGTGTTCAGGACTA,155,1325917
furpa,0.16666666666666666,12,11,TCATCTGAATATTAGAGTGA,1,1315246
furpa,3.0833333333333335,47,11,TCATACGGGTGCAAGCCCTG,36,1285844
furpa,1.9166666666666667,33,11,TCAATGAAGCGCTGTTAAAT,22,1318100
furpa,3.9166666666666665,57,11,TATTGCACGCTCCGTAACTT,46,1295808
furpa,5.5,76,11,TATGTGGGCGGAAACCGGTT,65,1295620
furpa,1.1666666666666667,24,11,TATGGTCGGCTGTGCCCACG,13,1322684
furpa,4.333333333333333,62,11,TATGCAGATGCGTGTTTAAG,51,1341248
furpa,3.3333333333333335,50,11,TATGAGCGTCAGTTCAATGA,39,1277450
furpa,2.5833333333333335,41,11,TAGGAAACCCCGGGCGTGTA,30,1326859
furpa,1.5,28,11,TAGCTATAGGTCTCAAGGTG,17,1298911
furpa,1.75,31,11,TAGCCCCAACCTCCCTACAA,20,1285178
furpa,1.25,25,11,TAGAGGGATTCTTTAGTCCC,14,1293785
furpa,2.8333333333333335,44,11,TACTTGCTGGGTTGGGGAAA,33,1276678
furpa,0.4166666666666667,15,11,TACTTACGCTGGTCAAGTCA,4,1324840
furpa,0.6666666666666666,18,11,TACTGATCATAGCTTCGCGG,7,1312779
furpa,0.3333333333333333,14,11,TACTCTTTTGCTTTTACAAT,3,1293282
furpa,1.8333333333333333,32,11,TACCAACCGGATTAGTAAAA,21,1300202
furpa,4.333333333333333,62,11,TACACCATTGTTAAGCTGAT,51,1338484
furpa,7.5,100,11,TAATAAGGTACCTGGACCCC,89,1322595
furpa,0.16666666666666666,12,11,TAAAATCTCGCTGCCGACTC,1,1315031
furpa,3.0,46,11,GTTTAACACCAAAGTTATAC,35,1275070
furpa,2.0,34,11,GTTGTTATTTGCACCGAACT,23,1292521
furpa,0.9166666666666666,21,11,GTTGTGGTTGCGTCCTTATC,10,1294710
furpa,0.5833333333333334,17,11,GTTGGGTGCGGCGAAGGGGT,6,1276330
furpa,0.8333333333333334,20,11,GTTCTACCGACAGGGCCGAG,9,1309743
furpa,0.75,19,11,GTTCCAAACTTGTGCCGAAT,8,1328649
furpa,0.16666666666666666,12,11,GTTACAGAATAGTCGAAAAG,1,1304955
furpa,1.75,31,11,GTTAAGGGTACTTCTCGCTT,20,1305081
furpa,6.416666666666667,87,11,GTGTGGATCAAGCCATCCCA,76,1320458
furpa,30.25,373,11,GTGGCTAGCCGGTAGAAATA,362,1288223
furpa,0.3333333333333333,14,11,GTGCGTGGACTCGTGACCGG,3,1320643
furpa,2.3333333333333335,38,11,GTGCATAGCTGACATCCAGT,27,1289316
furpa,1.3333333333333333,26,11,GTGAGATTACTCTATTTTAC,15,1287468
furpa,0.8333333333333334,20,11,GTCTGCAAAAATATCTTGTT,9,1307232
furpa,0.9166666666666666,21,11,GTCTCACGTAAGATTTAATC,10,1329428
furpa,1.1666666666666667,24,11,GTCTACCAGTAGGTTTAGAT,13,1336088
furpa,8.916666666666666,117,11,GTCGGGGGATGGACGTTTGG,106,1287450
furpa,2.8333333333333335,44,11,GTCGATTACACAGCGGGTAC,33,1301190
furpa,1.5833333333333333,29,11,GTCCGCTGTTTCTGGAAAAC,18,1347175
furpa,0.5833333333333334,17,11,GTCAGTACGCAGCCGTAATG,6,1309914
furpa,8.416666666666666,111,11,GTCAATATCTGGAGTGACCG,100,1328362
furpa,4.166666666666667,60,11,GTATTAAAATCTTAACGGGA,49,1351573
furpa,4.916666666666667,69,11,GTAACTTAACCGTGTTATGT,58,1328020
furpa,1.0,22,11,GGTGTTTTACATTGTCGATA,11,1274520
furpa,2.3333333333333335,38,11,GGTGTGGACAGCCGATCGGT,27,1353971
furpa,1.1666666666666667,24,11,GGTACTCGCAGGATCTTTAA,13,1332557
furpa,9.25,121,11,GGGTATTGCATGTTCCGGTA,110,1278767
furpa,0.4166666666666667,15,11,GGGTACAGACGTGAATGAAT,4,1293058
furpa,3.0,46,11,GGGCAAGTTTAAATCAACCT,35,1347184
furpa,1.6666666666666667,30,11,GGGAGATGAACTCGGTCGCC,19,1335857
furpa,4.666666666666667,66,11,GGCCTGATTTGGGTTGGCCC,55,1336988
furpa,0.8333333333333334,20,11,GGCCTCCGTAACGCTACTCC,9,1327623
furpa,1.8333333333333333,32,11,GGCCGTGGTCGCTTTAGGAT,21,1312714
furpa,0.8333333333333334,20,11,GGATTACAGATCCGATAACA,9,1324925
furpa,0.9166666666666666,21,11,GGACTTCTGTAAGACTGGAA,10,1302193
furpa,3.3333333333333335,50,11,GGACCTCGCTGGATCCGACT,39,1316515
furpa,4.25,61,11,GCTCAAAGTACGTGACTTTA,50,1283848
furpa,1.4166666666666667,27,11,GCTATTCTAGAAAAAAATGG,16,1280772
furpa,6.333333333333333,86,11,GCTATAACCGAGGCAATCAC,75,1287602
furpa,1.8333333333333333,32,11,GCTAGGGAACTGAATCGTGT,21,1322152
furpa,5.833333333333333,80,11,GCTACGCCATAGCGATTATA,69,1287441
furpa,5.833333333333333,80,11,GCGTCCCGGTAGTAACACGT,69,1328294
furpa,6.833333333333333,92,11,GCCTTTTACGTGCGGTCTAC,81,1298827
furpa,2.75,43,11,GCCTTCTCATTAGCGTGTAA,32,1284486
furpa,3.5,52,11,GCCGCGCCCGGCTTCGGCTA,41,1303908
furpa,1.25,25,11,GCCCCTAGCGACGGCTGACT,14,1306133
furpa,2.1666666666666665,36,11,GCCCACTCGCTCTCACGAAT,25,1281727
furpa,0.16666666666666666,12,11,GCCAACATTGGCTCTCTTTG,1,1274736
furpa,4.833333333333333,68,11,GCATGCCCCCACGCTCACAT,57,1296456
furpa,4.166666666666667,60,11,GCAGATCAGCAGTGCGATGT,49,1285097
furpa,3.4166666666666665,51,11,GCACGAAATAGCAACTCGGA,40,1329728
furpa,1.0833333333333333,23,11,GCAAAACTTTTAATTCGTGC,12,1310301
furpa,0.9166666666666666,21,11,GCAAAAACGAGAGAGGACGT,10,1290062
furpa,4.0,58,11,GATTGCTCGGGAATCAACCC,47,1300331
furpa,3.25,49,11,GATCTCGCGGGGAAATGAAT,38,1346476
furpa,9.666666666666666,126,11,GATACTCTCTTAGTTCCCGC,115,1333460
furpa,1.6666666666666667,30,11,GAGTGGGAGTCGATCCGTTA,19,1312391
furpa,4.25,61,11,GAGCGGCTGGGAAGCCGGCT,50,1280505
furpa,7.416666666666667,99,11,GAGCAAATGACCGAGCATCT,88,1311615
furpa,0.16666666666666666,12,11,GAGATATCAATTCGTGCTTA,1,1328178
furpa,3.5,52,11,GAGAAAAGCCGACTGTAAAT,41,1279108
furpa,1.25,25,11,GACTTGCAAGACAACATTAT,14,1271937
furpa,1.5833333333333333,29,11,GACCGTCTGTACGGGCTTGT,18,1275599
furpa,1.0833333333333333,23,11,GAATCGTCACCGACCTCTGG,12,1354855
furpa,0.75,19,11,GAATAGGCCTTTTCGGTCCT,8,1338102
furpa,0.75,19,11,GAATAGCGGAGATCTTAAGG,8,1328023
furpa,3.0,46,11,GAAGCCACTGTTGCATCGAG,35,1351049
furpa,3.25,49,11,GAAGAGCTTACGATTAGAGA,38,1338439
furpa,0.16666666666666666,12,11,GAACTCGAAGTCTTAGCGTT,1,1319686
furpa,4.083333333333333,59,11,GAACTCCGTAGTGGTAATCT,48,1328257
furpa,1.3333333333333333,26,11,CTTTGCGGGTGCCTCTGAAA,15,1306969
furpa,2.25,37,11,CTTATGTTTAAGATTCTGAT,26,1283632
furpa,2.5833333333333335,41,11,CTTATATCGCCTCGGGCACT,30,1334010
furpa,2.5,40,11,CTGGGAGCTTAGACTTTGAG,29,1349173
furpa,2.3333333333333335,38,11,CTGGCTATAGATTGTGGCAT,27,1331925
furpa,2.5833333333333335,41,11,CTGGCCAACCTTTTGGTCTT,30,1310023
furpa,1.5833333333333333,29,11,CTGGAAATGCCCGTCAGCTG,18,1333614
furpa,7.666666666666667,102,11,CTGCTTCCATGGATGGCCTT,91,1349476
furpa,0.6666666666666666,18,11,CTGACAGGTATAAAATATCT,7,1343890
furpa,2.9166666666666665,45,11,CTCGCCCAACCAGAAACGTG,34,1278806
furpa,2.6666666666666665,42,11,CTCCCCTCTAGGTAGTGATG,31,1291456
furpa,5.5,76,11,CTCAGATGACAGCAGAACTG,65,1347344
furpa,2.0833333333333335,35,11,CTATAGAGGCGATTAGTGAG,24,1292920
furpa,2.0,34,11,CTACCAGAGATCATCGCAGG,23,1345298
furpa,0.3333333333333333,14,11,CTAATCTGTAGGTTTTATGT,3,1306363
furpa,1.5,28,11,CGTGGGGCATTGGACACACT,17,1273331
furpa,0.25,13,11,CGTACGCGTGACGTGAGGCA,2,1290964
furpa,1.8333333333333333,32,11,CGGTCATTTATTTCATGGCT,21,1328847
furpa,3.8333333333333335,56,11,CGGGATCCGTTGGGGCCAAT,45,1312560
furpa,0.4166666666666667,15,11,CGGCAAGGGAGGAGACTGAG,4,1319563
furpa,0.16666666666666666,12,11,CGGATCCGCATTTGGTCGGT,1,1356747
furpa,3.1666666666666665,48,11,CGGAGGTCTGCGTCATCAGG,37,1339894
furpa,4.416666666666667,63,11,CGCTGAATCCTGGGGAGTGC,52,1324204
furpa,1.1666666666666667,24,11,CGCTCCGGGGCAACCACCTG,13,1309144
furpa,2.5833333333333335,41,11,CGCTCATGAAGTCTTGATGT,30,1330538
furpa,2.25,37,11,CGCGAGCTTTGGGACTGGAC,26,1271772
furpa,0.16666666666666666,12,11,CGCCTCTATTGCACGGCTCG,1,1274858
furpa,0.5,16,11,CGCCATGAAGGGTTTGAGAC,5,1328773
furpa,2.5,40,11,CGAGTGCCCATTTATAGCTG,29,1336094
furpa,0.16666666666666666,12,11,CGAGCGCGTGTTGCGGCGTG,1,1279353
furpa,2.75,43,11,CGAGCCCGTACGTCTAACCG,32,1306093
furpa,0.75,19,11,CGAGATCCGCATGGTGTCAC,8,1275364
furpa,2.3333333333333335,38,11,CGAATGGAAAAGTTTGCGAG,27,1288447
furpa,0.6666666666666666,18,11,CGAATACCTCAGGTGACTAA,7,1302084
furpa,0.9166666666666666,21,11,CCTTGCGTTCTTTACGACGG,10,1296588
furpa,2.0833333333333335,35,11,CCTGGGAGTGAGTATAAAGA,24,1304327
furpa,4.333333333333333,62,11,CCTAGACTGTTATCCATGTC,51,1299422
furpa,12.666666666666666,162,11,CCGTCGATGAAGTCTCACGA,151,1354433
furpa,7.833333333333333,104,11,CCGTATAGTCGCCCAATAAC,93,1271379
furpa,0.16666666666666666,12,11,CCGCACATGGGATCATTGTA,1,1291299
furpa,1.5833333333333333,29,11,CCCGAAGATATTAATATGGA,18,1292919
furpa,4.083333333333333,59,11,CCCCGGGTATTGAAGGTTGT,48,1349481
furpa,3.6666666666666665,54,11,CCCAGCAGGGCTTCTTCACA,43,1339262
furpa,0.16666666666666666,12,11,CCCACTTTACGGGGGGCGTT,1,1271682
furpa,1.75,31,11,CCCAAAGCCAACAGCGGTCC,20,1298162
furpa,0.16666666666666666,12,11,CCACGTAAAATCGACTTTAA,1,1343429
furpa,0.4166666666666667,15,11,CCAAGAGCGACGGTGTGCGC,4,1281792
furpa,0.16666666666666666,12,11,CATTTATGCGGGGATGGCCC,1,1289596
furpa,2.25,37,11,CATTGTGCATATGTTAGAGC,26,1333023
furpa,0.16666666666666666,12,11,CATTATCCGGTATATCTCTC,1,1318484
furpa,0.5,16,11,CATGTCATTCCATGCACGTT,5,1280994
furpa,3.6666666666666665,54,11,CATGCAACATCCCTAGGAGA,43,1320349
furpa,1.75,31,11,CATGACGCTAAGTAAGCCAC,20,1290852
furpa,0.8333333333333334,20,11,CATAATTGTGTTTGGTTCAG,9,1301698
furpa,0.75,19,11,CAGTGTTAGAGTATTTTGAT,8,1291367
furpa,0.4166666666666667,15,11,CAGTGTCCGTGTAGACCTAT,4,1333262
furpa,0.3333333333333333,14,11,CAGTGGCCCCCGAGCACTCG,3,1352782
furpa,5.833333333333333,80,11,CAGTAGGTTATCTGGGTATA,69,1298761
furpa,3.0,46,11,CAGGTGATGGACACTGCTCA,35,1275873
furpa,2.9166666666666665,45,11,CAGCTTGATGCCAGGGAATC,34,1308788
furpa,3.0,46,11,CAGACCAACGAATTTAGGGC,35,1309995
furpa,1.25,25,11,CACGGGGCGAACGAAGGGTC,14,1313827
furpa,0.16666666666666666,12,11,CACCGACCGAGGAGGGCCGT,1,1297574
furpa,1.8333333333333333,32,11,CACAGGCACTATCACTCAAC,21,1343518
furpa,0.6666666666666666,18,11,CAAGTACAGCTCTACTCTTG,7,1357065
furpa,0.16666666666666666,12,11,CAAGCAACCCGGCACGCCGC,1,1310131
furpa,3.3333333333333335,50,11,CAACATATCAATTCACCTCT,39,1323090
furpa,2.0833333333333335,35,11,ATTTGCATCTACCCTCAGCA,24,1278412
furpa,5.333333333333333,74,11,ATTTCGGCGTGACTGAGTAA,63,1295607
furpa,0.16666666666666666,12,11,ATTTCGCTACACAGTATTTG,1,1343087
furpa,1.0,22,11,ATTTACTGACATAAATACGG,11,1285221
furpa,4.0,58,11,ATTATCTCTACGCTGATGGA,47,1307653
furpa,0.16666666666666666,12,11,ATGTGTTGGAGCGTACATCT,1,1353146
furpa,1.5,28,11,ATGTGTATGTATTGGGTACC,17,1317811
furpa,4.666666666666667,66,11,ATGTAAAATTACTGCAAAAT,55,1273829
furpa,3.4166666666666665,51,11,ATGCTACGCAGTTATCTTAC,40,1271580
furpa,3.0833333333333335,47,11,ATCGGCCGATAACGGCGTGC,36,1271501
furpa,1.9166666666666667,33,11,ATCCCCTGCTTCGGAGACAC,22,1336740
furpa,2.1666666666666665,36,11,ATCATCAAGGGAGCGATATG,25,1288560
furpa,3.9166666666666665,57,11,ATATCCTGAAGAACCTTCGT,46,1320687
furpa,0.25,13,11,ATAGCAGAGCCGGCTGACTT,2,1329431
furpa,4.583333333333333,65,11,ATAGCACTGGGCCTTTCTTT,54,1280980
furpa,2.75,43,11,ATACTACATCGCAGCATGGC,32,1351340
furpa,0.4166666666666667,15,11,ATACGACGCAGTGATTTGTT,4,1344963
furpa,0.16666666666666666,12,11,AGTGCCAGCGGCGGCCGCAG,1,1333404
furpa,2.25,37,11,AGGTGTTACCGTTTGGGACG,26,1305459
furpa,3.1666666666666665,48,11,AGGTGGATACCAGCTCAGAG,37,1288458
furpa,1.0833333333333333,23,11,AGGCTCGCACCGACAAATAA,12,1284717
furpa,3.3333333333333335,50,11,AGGCCGGTTGCCGTGGCCTC,39,1321104
furpa,0.25,13,11,AGGAAGAGGTAAGGAAAGGA,2,1302946
furpa,0.16666666666666666,12,11,AGCTCATCTGTGGGACAACC,1,1354777
furpa,0.5833333333333334,17,11,AGCCCGCGAAGAAACTTCCG,6,1309147
furpa,0.4166666666666667,15,11,AGCCAGCCTGTGTATCCGGG,4,1276926
furpa,2.5833333333333335,41,11,AGCAGTTTTCGGTACACGAG,30,1340555
furpa,2.4166666666666665,39,11,AGCACCTCTGGTTGCGGCGC,28,1340974
furpa,0.16666666666666666,12,11,AGATTCCGGGTGGGCGTCGG,1,1283942
furpa,9.833333333333334,128,11,AGACGGGGACACTACCACGC,117,1325839
furpa,1.75,31,11,AGACAGCGACGGTTGATGGG,20,1293611
furpa,2.25,37,11,AGAAAACCTCCTAACAGCCG,26,1295937
furpa,1.9166666666666667,33,11,ACTTCCTGCGGTTACGGTGA,22,1333161
furpa,3.8333333333333335,56,11,ACTATGTGATGACAATGCGA,45,1312946
furpa,2.1666666666666665,36,11,ACTACTTACTATGGATGGGG,25,1352992
furpa,0.8333333333333334,20,11,ACTAACTGGGAGCCAGGGTG,9,1287813
furpa,0.9166666666666666,21,11,ACGTCAATCCCAACCTCGAC,10,1300172
furpa,1.25,25,11,ACGTATTCCGAACATTTCGA,14,1351415
furpa,4.333333333333333,62,11,ACGGAGCCTTAGGCATTCGA,51,1283683
furpa,5.833333333333333,80,11,ACGCTTCCCCTCGACATAGC,69,1308999
furpa,0.16666666666666666,12,11,ACGCCCAGTCTGTCGGGGGC,1,1310884
furpa,1.0,22,11,ACGATGACTTTGAACTCAGG,11,1290517
furpa,0.16666666666666666,12,11,ACCGTTTTGAAAGCAGGACA,1,1301256
furpa,1.4166666666666667,27,11,ACCGGATAACACTTTCGAGT,16,1302732
furpa,2.8333333333333335,44,11,ACCGCGGCAACTCTCCAGCA,33,1275349
furpa,2.9166666666666665,45,11,ACCGCCCACCTGCAAAATCT,34,1327949
furpa,0.9166666666666666,21,11,ACCCGATGGTATTGTTCCCA,10,1308148
furpa,0.25,13,11,ACCCCTTTCATTCCTCTCAG,2,1272971
furpa,2.0,34,11,ACCCAGTAGACCACTCGAAA,23,1326381
furpa,0.5833333333333334,17,11,ACATCGTACTAATGTTATAC,6,1290969
furpa,0.9166666666666666,21,11,ACATACACTCGGCGACATCG,10,1309350
furpa,3.25,49,11,ACACAACTTATGCAAATTTT,38,1311573
furpa,2.6666666666666665,42,11,ACAAATTTAGAAGAGCCACG,31,1296735
furpa,1.5833333333333333,29,11,AATTTCCTTTATAGCTGGCC,18,1345537
furpa,0.16666666666666666,12,11,AATGTACTACAGTGCAGGTG,1,1284023
furpa,4.0,58,11,AATGGACTTGGCGTCATTGT,47,1323081
furpa,0.16666666666666666,12,11,AATCCTTTCTCTGAGTAAGA,1,1331101
furpa,0.16666666666666666,12,11,AAGTCTTGTGTCATCCCGGC,1,1296568
furpa,0.75,19,11,AAGTAGGAGTGAATTAGTAA,8,1291296
furpa,2.8333333333333335,44,11,AACTCCTAGGTCCAATTGCC,33,1317158
furpa,2.25,37,11,AACTATATTTGCGTAAGTAC,26,1336561
furpa,2.6666666666666665,42,11,AAACGCTTGCGTTAATAATT,31,1345895
furpa,3.0833333333333335,47,11,AAACGAGCGCGGTAGTCCTT,36,1291148
furpa,0.8333333333333334,20,11,AAACCACTGCAAGATTAAGA,9,1293879
furpa,1.0,22,11,AAAATTCGGAGTCGTTCCAT,11,1325416
furpa,0.9166666666666666,21,11,AAAATGCGGGCCATATTCTC,10,1272215
furpa,0.5833333333333334,17,11,AAAAGCCGATCAATTTTTCA,6,1337255
furpa,0.4166666666666667,15,11,AAAACAACCGGCCCGGCCAT,4,1310556
furpa,0.45454545454545453,14,10,TTTTCGTCTTTTAAGCTAAA,4,1302539
furpa,1.1818181818181819,22,10,TTTGTGGGTACAGTGTTTAT,12,1328231
furpa,0.2727272727272727,12,10,TTTGTATAACGTGATCGAAG,2,1326053
furpa,4.2727272727272725,56,10,TTTGAGACAATGCTCCGTCG,46,1302691
furpa,1.1818181818181819,22,10,TTTCTTAATTGACTATCTAT,12,1351655
furpa,3.6363636363636362,49,10,TTTCTCGTGTGTCTATCCGG,39,1291356
furpa,4.545454545454546,59,10,TTTCCACCCGTTGAAAGTCT,49,1324184
furpa,9.181818181818182,110,10,TTGTCTTAGCCCTCCGGGTC,100,1285170
furpa,11.818181818181818,139,10,TTGGTCGTCACGTTCTTAGA,129,1331471
furpa,0.9090909090909091,19,10,TTGGAACACACGGGTATCGA,9,1333879
furpa,0.5454545454545454,15,10,TTGAGGTATTGCAACAGTGA,5,1333471
furpa,2.090909090909091,32,10,TTGAATCGGAGCACAATAGT,22,1326426
furpa,9.272727272727273,111,10,TTCTTATAGGCGGGACGTGA,101,1320125
furpa,0.18181818181818182,11,10,TTCTGACAAGTATGTGTTTA,1,1347506
furpa,1.4545454545454546,25,10,TTCGGCTTAAAGATCGTATA,15,1301847
furpa,0.8181818181818182,18,10,TTCGCAGCATGCAATTACCA,8,1306401
furpa,1.0,20,10,TTCCTAAGAAATCACACAAT,10,1301864
furpa,2.3636363636363638,35,10,TTCCCTTGGACGGTATATCT,25,1322165
furpa,3.1818181818181817,44,10,TTATCTTAGTAAGCCAACAT,34,1333459
furpa,0.18181818181818182,11,10,TTAGTTCACGATGTGGCATC,1,1328383
furpa,0.2727272727272727,12,10,TTACCCATTACGCTATATTG,2,1292111
furpa,0.6363636363636364,16,10,TTAATGTGCTGCTACTATGG,6,1319974
furpa,1.0,20,10,TTAAAGATGAACGTTGAAAC,10,1278863
furpa,0.18181818181818182,11,10,TGTTATCAGGACACCAACGA,1,1340747
furpa,0.7272727272727273,17,10,TGTGGTTTAAAAATTGCGGC,7,1302344
furpa,5.909090909090909,74,10,TGTCCACGTTGGGGAGCCAA,64,1273856
furpa,6.909090909090909,85,10,TGTCAGGTCGAAGACTCATG,75,1345726
furpa,0.18181818181818182,11,10,TGGGCGTACAGTGGAATGCC,1,1291051
furpa,2.727272727272727,39,10,TGGCTAGCAATGGTTCCACC,29,1294472
furpa,2.8181818181818183,40,10,TGGCGTTTATCAAGTGATTA,30,1283169
furpa,0.18181818181818182,11,10,TGGCCCACGCGGTGGATTGA,1,1286683
furpa,0.36363636363636365,13,10,TGCTTAAGGTTGGTATTACA,3,1312711
furpa,0.18181818181818182,11,10,TGCTGTCGGGAAACCGTCTT,1,1302512
furpa,0.6363636363636364,16,10,TGCTCGTCAACTGTATCAGC,6,1321779
furpa,2.727272727272727,39,10,TGCTCGAATTTGCGGTAAAA,29,1345408
furpa,4.0,53,10,TGCGCCCACGAGGTGTGGTC,43,1344244
furpa,0.2727272727272727,12,10,TGCCAGTCCCCGGCCGACGT,2,1284306
furpa,0.18181818181818182,11,10,TGCCACATTGCGTATAGGCA,1,1289239
furpa,0.2727272727272727,12,10,TGCACAACAACTATTGTCTC,2,1305458
furpa,1.5454545454545454,26,10,TGATGAGTGGCTCAAAGCAT,16,1340834
furpa,0.7272727272727273,17,10,TGAGGGCCAGGATATACGTA,7,1341036
furpa,2.727272727272727,39,10,TGAGAAATCACGTGACGAAG,29,1308326
furpa,1.0,20,10,TGACGTAGAATAGTACTCCA,10,1320987
furpa,1.0909090909090908,21,10,TGAATCCTGAATCCAGATAG,11,1281263
furpa,1.3636363636363635,24,10,TGAAAAAGTGCCGGTCCACT,14,1274636
furpa,1.9090909090909092,30,10,TCTGGCGAATTAAAGCGTTG,20,1295138
furpa,2.4545454545454546,36,10,TCTCACATCAAAATATAATG,26,1329519
furpa,0.2727272727272727,12,10,TCGTTAACGGCCGCGTTGAT,2,1339285
furpa,0.7272727272727273,17,10,TCGGTAAGTCCATAAGTTGA,7,1276236
furpa,0.8181818181818182,18,10,TCGGCAACGGACGGTGAATT,8,1275239
furpa,2.6363636363636362,38,10,TCGCTAGGAAGCGAACGGAA,28,1350491
furpa,0.18181818181818182,11,10,TCGCGCTATGACCTCAGTCT,1,1343904
furpa,0.18181818181818182,11,10,TCGCGACCCTAAACACCAAC,1,1279220
furpa,3.6363636363636362,49,10,TCGAGAGGGTTAAAGTAGAG,39,1289514
furpa,1.0,20,10,TCCGATACACCCCATCGAAC,10,1335864
furpa,0.18181818181818182,11,10,TCACGCCCCGAATGTGCGCC,1,1280168
furpa,1.5454545454545454,26,10,TCACACAGTTAGAGACCCAT,16,1307671
furpa,0.18181818181818182,11,10,TCAATATCGAAGTAAAGGTT,1,1316332
furpa,0.18181818181818182,11,10,TCAACACTTCTATATACCTA,1,1281352
furpa,1.5454545454545454,26,10,TCAAAGGGTACTCCGAAACC,16,1296643
furpa,0.9090909090909091,19,10,TATTTGAATAGGAGCCGGCG,9,1353480
furpa,7.0,86,10,TAGGGTCTGACGACTTAGAA,76,1296452
furpa,0.6363636363636364,16,10,TAGGGGTCCTGTTAACACCT,6,1280464
furpa,1.9090909090909092,30,10,TAGGAACGATCTCACAGCAT,20,1281555
furpa,10.272727272727273,122,10,TAGCGGGTCTTATGTCACGT,112,1317159
furpa,3.727272727272727,50,10,TAGACGTCCTGTGTCGTTCC,40,1355211
furpa,1.2727272727272727,23,10,TACTGCTATCGACAGGAAAC,13,1332635
furpa,1.0909090909090908,21,10,TACAGGTCTCCATAATTAAT,11,1277652
furpa,0.45454545454545453,14,10,TACACCGGCGTCCGTACAGA,4,1288921
furpa,3.6363636363636362,49,10,TAAGTTAATGAATCCGGACA,39,1304161
furpa,2.5454545454545454,37,10,TAAGCACATGGTCCGACTCT,27,1272801
furpa,2.272727272727273,34,10,GTTTGGGCGGTAAGCGCGGA,24,1347013
furpa,2.8181818181818183,40,10,GTGTTCTAACCAGCTCCACG,30,1343594
furpa,1.5454545454545454,26,10,GTGTCATCATATTTCACCGC,16,1303438
furpa,1.3636363636363635,24,10,GTGGTTGCGTGCGTACGCAT,14,1311736
furpa,3.8181818181818183,51,10,GTGCCCACCATATCCATGCC,41,1290075
furpa,0.18181818181818182,11,10,GTGAGTATACGGTACCCGAC,1,1317248
furpa,3.8181818181818183,51,10,GTGACCTCTAGTAATTCACA,41,1347098
furpa,0.18181818181818182,11,10,GTCGCGGCTGTATAGATGAA,1,1329163
furpa,1.0909090909090908,21,10,GTCCTAGCCTGATGCTCTCA,11,1340453
furpa,1.8181818181818181,29,10,GTCCACCCAGTAACGATCAG,19,1291688
furpa,0.18181818181818182,11,10,GTATCATATGATTACGTAAC,1,1298327
furpa,4.636363636363637,60,10,GTATCAGATGTCCTCATAAT,50,1345877
furpa,1.8181818181818181,29,10,GTAGGCCCAGTTTCGCGCAA,19,1339423
furpa,2.727272727272727,39,10,GTAGGAACTCGGCGAGGCGA,29,1347702
furpa,0.9090909090909091,19,10,GTAGCAGGGTCATTTTTGCA,9,1328662
furpa,2.1818181818181817,33,10,GTAAAGCTAGGGACCATCGA,23,1318037
furpa,1.8181818181818181,29,10,GGTCTGCGGTCTGCAGGCTA,19,1340295
furpa,4.090909090909091,54,10,GGTACTTTTTCCAAGCAGTC,44,1276470
furpa,0.18181818181818182,11,10,GGTACGGACCGAAACGGAAT,1,1279131
furpa,6.454545454545454,80,10,GGTAACTGTTTTTCCCCTAC,70,1348783
furpa,1.1818181818181819,22,10,GGGTATGAATAATAATGGCT,12,1278915
furpa,0.7272727272727273,17,10,GGGTAAATGCAAAGAGGCTG,7,1336021
furpa,0.36363636363636365,13,10,GGGGTTCTACAGAAGAAATT,3,1276713
furpa,4.0,53,10,GGGCAAACAGGCGTCATTTA,43,1320140
furpa,1.9090909090909092,30,10,GGGATCGTCGTGAGAGCATT,20,1349047
furpa,0.36363636363636365,13,10,GGGACTCGTAAACAGTGTCC,3,1310382
furpa,0.18181818181818182,11,10,GGGACCCAGAAGCCATCGGG,1,1353246
furpa,2.727272727272727,39,10,GGGAACCTGGCATAAGTGTG,29,1345762
furpa,0.18181818181818182,11,10,GGCTCTGACACCCTTTCGGG,1,1305210
furpa,0.2727272727272727,12,10,GGCGTTAATCAGCTTTGACG,2,1289839
furpa,3.272727272727273,45,10,GGCCTCACGTAAAGGTAATG,35,1332181
furpa,0.36363636363636365,13,10,GGCCAGGTATGATCAACGAC,3,1350531
furpa,1.2727272727272727,23,10,GGATGAATCTGCCATTCTGC,13,1310229
furpa,0.6363636363636364,16,10,GGAGAAACTGGCAATTTGGT,6,1327726
furpa,5.7272727272727275,72,10,GGACTGGCTTCTAACCTAGT,62,1356673
furpa,3.1818181818181817,44,10,GGAACCAACCTTAGTTCAGT,34,1337493
furpa,0.18181818181818182,11,10,GGAAAAGCGAACATAAGCTA,1,1302059
furpa,0.7272727272727273,17,10,GCTTGAAGGCGCTCTTATTA,7,1313456
furpa,3.909090909090909,52,10,GCTGCCTGAGATCGGATCGA,42,1296947
furpa,1.0909090909090908,21,10,GCTAGTGATGAGACCTGCGC,11,1277557
furpa,1.2727272727272727,23,10,GCTACTGACGTCGTATGTGA,13,1323636
furpa,0.8181818181818182,18,10,GCGCATAATAACAAGTGCGA,8,1346178
furpa,1.3636363636363635,24,10,GCGACATGGAGATGTGAGGG,14,1316258
furpa,5.7272727272727275,72,10,GCGAACGCATCATGGTCCAT,62,1310332
furpa,1.0,20,10,GCGAAAATAGCGCCGCGTTG,10,1344320
furpa,1.7272727272727273,28,10,GCCTTGAATCTGCGCAGCGC,18,1318256
furpa,1.8181818181818181,29,10,GCCTTCAGGGTTTCACGGTC,19,1283670
furpa,3.0,42,10,GCCTCGTAATTCAGGTCAGG,32,1275099
furpa,0.5454545454545454,15,10,GCCCTTGGACCGTCACTTTT,5,1325712
furpa,1.3636363636363635,24,10,GCCACACTCCTTCTCGGGCG,14,1310120
furpa,6.0,75,10,GCAGCGTGCAAGCTGGCGTT,65,1297104
furpa,4.0,53,10,GCAATATCCGTCACTGCCCG,43,1320426
furpa,0.5454545454545454,15,10,GCAAGACAGGTAGACAAGAA,5,1308866
furpa,0.2727272727272727,12,10,GCAAATAAGATATCGATGTT,2,1289738
furpa,1.1818181818181819,22,10,GCAAAGCGGGTAGCGAAGTT,12,1345192
furpa,4.909090909090909,63,10,GCAAAAGTAATCAGTAGTTA,53,1350483
furpa,0.18181818181818182,11,10,GATTTCCATAATTTTGTGTT,1,1339983
furpa,2.6363636363636362,38,10,GATTGGGGAAAGTCACAGCC,28,1310230
furpa,3.727272727272727,50,10,GATTGCGGAATATTTGGAAA,40,1309012
furpa,4.454545454545454,58,10,GATGGTTCATCCTCATGTGG,48,1336569
furpa,2.727272727272727,39,10,GATGAGGATAGTGGTCCTTA,29,1354192
furpa,9.363636363636363,112,10,GATCGAGCTTACTGATCCCA,102,1335233
furpa,1.9090909090909092,30,10,GATAACCATTGCAGGTCTGT,20,1316825
furpa,8.0,97,10,GAGTCGTTGTGAGATGTTTT,87,1341738
furpa,4.090909090909091,54,10,GAGGTCGTCCCCCTGGCCGG,44,1346664
furpa,11.272727272727273,133,10,GAGGGCTGCACATTGTACGG,123,1279437
furpa,5.090909090909091,65,10,GAGATTCAATTTGCGCTCAT,55,1302929
furpa,2.8181818181818183,40,10,GAGAATGTCGATTACTTGAT,30,1339703
furpa,3.727272727272727,50,10,GAGAAACTCGCTACGGGGCG,40,1340576
furpa,0.2727272727272727,12,10,GACTAATTCGTGCTACCCTG,2,1347298
furpa,3.090909090909091,43,10,GACGCGACGGACAGCAACTA,33,1293445
furpa,0.18181818181818182,11,10,GAAGCCGACGTGATTATGGT,1,1347785
furpa,2.272727272727273,34,10,GAAGCACACAGTGTACAGTT,24,1297060
furpa,3.0,42,10,GAACCGCAAAGTGATTTCAC,32,1312385
furpa,1.1818181818181819,22,10,CTTTGTTGGTTGAGAATGTC,12,1311357
furpa,1.6363636363636365,27,10,CTTTCGACGGTACTCTATTC,17,1336827
furpa,0.2727272727272727,12,10,CTTGGTACAAGTCGCAGTCA,2,1302800
furpa,1.5454545454545454,26,10,CTTAGGTGTACACCCTTGTG,16,1277137
furpa,4.454545454545454,58,10,CTGTTCTGGCTTTTTGACCT,48,1328369
furpa,0.45454545454545453,14,10,CTGTACGGACCATACAGATG,4,1339896
furpa,1.5454545454545454,26,10,CTGGGCCAAACATGATAAGG,16,1309640
furpa,4.545454545454546,59,10,CTGCGCAACTAGGGCAGTAG,49,1304957
furpa,3.4545454545454546,47,10,CTGCCCCTGCTCAGCAATTG,37,1335989
furpa,2.4545454545454546,36,10,CTCTGTACGCGGGTTCCCAA,26,1296925
furpa,0.2727272727272727,12,10,CTCTGACAGGAGGCCTGGCC,2,1350290
furpa,0.18181818181818182,11,10,CTCTCAGCGTAGTTCCTAAG,1,1316261
furpa,6.545454545454546,81,10,CTCTCAAGGCTGATATGCAG,71,1352561
furpa,4.909090909090909,63,10,CTCTAGTCGGGTATCTTTTT,53,1283788
furpa,4.545454545454546,59,10,CTCCACACTGACGCGCCGGT,49,1310410
furpa,1.8181818181818181,29,10,CTCAGGGCGGATGGTCCTAC,19,1320158
furpa,1.3636363636363635,24,10,CTCAATGAATCTATAAGGTC,14,1309943
furpa,0.7272727272727273,17,10,CTCAAATGTAGAAAGATCTA,7,1301036
furpa,0.18181818181818182,11,10,CTATTGGGACGTAGTCCCCC,1,1307765
furpa,0.18181818181818182,11,10,CTATTCTATGTGATAGTTTG,1,1294065
furpa,4.909090909090909,63,10,CTATGACTAATATCGGCCCG,53,1313302
furpa,0.5454545454545454,15,10,CTATATGGCGGTGTCAACGG,5,1318511
furpa,2.8181818181818183,40,10,CTATATGATGGATTGCTTAG,30,1282265
furpa,0.2727272727272727,12,10,CTAGGCGCATCTTTGATGGA,2,1293650
furpa,1.3636363636363635,24,10,CTAGCCTCGATTTAGTGACT,14,1273606
furpa,1.6363636363636365,27,10,CTACTGGACCCGCGGGAGAT,17,1338884
furpa,0.2727272727272727,12,10,CTAACGAATTTATCATTTAC,2,1346079
furpa,0.18181818181818182,11,10,CGTTGGCCTTGTTTACAGTG,1,1331111
furpa,1.0,20,10,CGTTCAACATCAGTTTAGGT,10,1307459
furpa,1.7272727272727273,28,10,CGTGCGCTGATTTACATCGG,18,1315569
furpa,5.909090909090909,74,10,CGTCGTGCGTGTAATACCCT,64,1342989
furpa,1.0,20,10,CGGTTCTTGCACTATCTTTG,10,1286791
furpa,13.636363636363637,159,10,CGGGACCCCCCTTTGACGCG,149,1312556
furpa,0.6363636363636364,16,10,CGGCGGCTTTACTTAAAAAA,6,1294256
furpa,1.4545454545454546,25,10,CGGCACCGGACCATACTCGA,15,1278795
furpa,2.4545454545454546,36,10,CGCTGTGCTCCTGGCATGCG,26,1313479
furpa,0.2727272727272727,12,10,CGCTCTTAGTCACTGCGTAT,2,1295484
furpa,2.727272727272727,39,10,CGCGTCTAGTCGTAATTCCC,29,1356492
furpa,0.18181818181818182,11,10,CGCGCTCCACTGGAATCCTG,1,1357711
furpa,1.6363636363636365,27,10,CGCCTGACATTTGTAATGGA,17,1308317
furpa,0.2727272727272727,12,10,CGCCTATCAATTGAATCAAG,2,1321404
furpa,5.454545454545454,69,10,CGCCCAATCGTTCCAGGATG,59,1344727
furpa,13.727272727272727,160,10,CGCCATGGGTGCCTATCATT,150,1309612
furpa,3.727272727272727,50,10,CGCAGTACAGGGTCGTCTTA,40,1357284
furpa,1.1818181818181819,22,10,CGCAATTAGAACTGTCGGGC,12,1307522
furpa,3.272727272727273,45,10,CGATCTGTCTCCAGACACTC,35,1319281
furpa,2.272727272727273,34,10,CGATCGACTACAGACCGTGC,24,1345661
furpa,0.18181818181818182,11,10,CGATCATTCTAGTCGGCTCA,1,1323350
furpa,2.4545454545454546,36,10,CGAGAAGGTGTCAACTCGTT,26,1304155
furpa,0.18181818181818182,11,10,CGACAAATGCGCGTGGAGCT,1,1310585
furpa,1.0909090909090908,21,10,CGAATTGAGGCTCTTCAGAT,11,1349262
furpa,5.0,64,10,CGAAGAAAGATAGAGCACAG,54,1312734
furpa,0.36363636363636365,13,10,CGAACGAGATTGAGGCTCCT,3,1291815
furpa,1.9090909090909092,30,10,CGAAATCGGCTACTGTCTTT,20,1316212
furpa,4.090909090909091,54,10,CCTTGCCGGGCAATTTTCGA,44,1327820
furpa,1.1818181818181819,22,10,CCTGAGTATGAAACGCTAGT,12,1273291
furpa,5.454545454545454,69,10,CCTCGTTAGTTAATATAGGA,59,1334037
furpa,0.7272727272727273,17,10,CCTACCCTTTCCTATGGGCA,7,1283376
furpa,0.18181818181818182,11,10,CCGTTCATTGTCTTAATGGT,1,1326724
furpa,2.0,31,10,CCGCTTCTTCAGCTGATCTA,21,1279370
furpa,3.909090909090909,52,10,CCGCTCCCCCGGGATTAAGT,42,1319634
furpa,1.1818181818181819,22,10,CCGCGGGACAGTGAGTGCAA,12,1323932
furpa,3.090909090909091,43,10,CCGCAAGACTTGTTGAATAT,33,1355361
furpa,3.4545454545454546,47,10,CCGAAACGGTATAGCACGGG,37,1272519
furpa,2.4545454545454546,36,10,CCCTTGAGTGAGTGGTTTCC,26,1334377
furpa,10.090909090909092,120,10,CCCGACATTCGGGCTCCATC,110,1344731
furpa,1.1818181818181819,22,10,CCATCTCTTCCTACCGGATT,12,1338529
furpa,0.2727272727272727,12,10,CCACTTGACTTGTCAGGCGA,2,1321492
furpa,9.545454545454545,114,10,CATTCAAGGCGGAGCTGCCT,104,1353282
furpa,0.2727272727272727,12,10,CATCGCTGTAATACCTCCTG,2,1290717
furpa,3.3636363636363638,46,10,CATCGCACCACGGATCAACT,36,1326213
furpa,2.727272727272727,39,10,CATCACCCGATCTCGGTATT,29,1273817
furpa,5.818181818181818,73,10,CATCAATCGCTCGAGATTCC,63,1354881
furpa,0.5454545454545454,15,10,CAGGGATTAACAACTTAGAA,5,1289809
furpa,2.727272727272727,39,10,CAGACTCATATGTGTTGTCT,29,1323661
furpa,4.7272727272727275,61,10,CACTCCTCACCTCGGGCAAC,51,1315851
furpa,6.090909090909091,76,10,CACTCCGGCACGGCCTTAGC,66,1285834
furpa,0.18181818181818182,11,10,CACGGGACCTTGATCCATCA,1,1345363
furpa,4.454545454545454,58,10,CAACGACGGACTTCCTGAGC,48,1320321
furpa,1.6363636363636365,27,10,CAACAGTACGTCAGTGACCA,17,1319123
furpa,1.6363636363636365,27,10,ATTTGGCTTACTAGTGTGAT,17,1330205
furpa,2.272727272727273,34,10,ATTTAACCAGTCGTCATTTA,24,1347824
furpa,1.7272727272727273,28,10,ATTGAAATCGGCCTTCGTCG,18,1304901
furpa,5.818181818181818,73,10,ATTCTTAGCTCACGAGTGTA,63,1331345
furpa,2.272727272727273,34,10,ATTCTACCTCTGGAGTGAAC,24,1296677
furpa,2.4545454545454546,36,10,ATTCCGCTTAGCGCAACTCA,26,1294530
furpa,2.0,31,10,ATTCAGTTTGAGTTACAGCT,21,1272524
furpa,1.5454545454545454,26,10,ATTATGAGACGACACAGATA,16,1336452
furpa,0.7272727272727273,17,10,ATTAGTGGTACTGATCAACG,7,1289766
furpa,2.0,31,10,ATGTCGGATACATGCCGAGG,21,1306708
furpa,0.36363636363636365,13,10,ATGTCCCCGCACGTTCCTGT,3,1335784
furpa,0.18181818181818182,11,10,ATGTAACGGCTCAATTAAAA,1,1288103
furpa,4.090909090909091,54,10,ATGGCTGGCAATTTAACATT,44,1327914
furpa,3.3636363636363638,46,10,ATGCGGCGGGGTGGTATTCA,36,1345199
furpa,2.6363636363636362,38,10,ATGAGGCAATGTTAGACCAA,28,1337223
furpa,7.7272727272727275,94,10,ATCTGGTATGAGGCACCTTG,84,1349660
furpa,5.545454545454546,70,10,ATCGTGGCGGTAGTGTCGGG,60,1312189
furpa,3.909090909090909,52,10,ATCGATCAAATGAGGGCCCT,42,1303557
furpa,13.0,152,10,ATCCGTCACATACGATGGTG,142,1307609
furpa,0.2727272727272727,12,10,ATCCCTATATAAGAAAATTG,2,1271184
furpa,2.727272727272727,39,10,ATAGTACATTTTGGAGTAAT,29,1306213
furpa,4.454545454545454,58,10,ATACAGCATAGATCGTGTCT,48,1325798
furpa,0.9090909090909091,19,10,AGTTGCGGCCTTCTCTGCAA,9,1328079
furpa,1.9090909090909092,30,10,AGTTGAAGAGCCTGGAACTC,20,1357656
furpa,1.0909090909090908,21,10,AGTAATCTGCACACGCGGGA,11,1273429
furpa,0.6363636363636364,16,10,AGGTTCTGTATTAAGAGAAC,6,1276683
furpa,0.7272727272727273,17,10,AGGCCCGCACAGCAACGGAT,7,1306886
furpa,1.0,20,10,AGGCATCATCGTGAACAAGT,10,1350921
furpa,0.18181818181818182,11,10,AGGACTAGGCAGTATTGGCT,1,1279082
furpa,2.1818181818181817,33,10,AGGACTAGCCTGCTACAGTT,23,1318716
furpa,0.8181818181818182,18,10,AGGACCTGAACCGAATTGGA,8,1343025
furpa,2.4545454545454546,36,10,AGGAACGAACGTGGACACTT,26,1329261
furpa,2.8181818181818183,40,10,AGCTTAGCCATCTCTGGAAT,30,1301001
furpa,1.0,20,10,AGCGCCGTCCACCACACTGC,10,1354202
furpa,4.090909090909091,54,10,AGATGTACTCAAGTGAACAT,44,1357412
furpa,1.3636363636363635,24,10,AGAGATTGGACTAAGTGCTG,14,1313992
furpa,3.909090909090909,52,10,AGACCGCGGAATGCTGCAAT,42,1333546
furpa,2.0,31,10,AGACAGAAGGGGTTAAGTTA,21,1311552
furpa,0.2727272727272727,12,10,AGAACGTACGAGGTTATATG,2,1343048
furpa,2.5454545454545454,37,10,ACTGGACTTCGTTATATCAA,27,1328360
furpa,0.6363636363636364,16,10,ACTGATTTTAGTGATGACTA,6,1291731
furpa,1.9090909090909092,30,10,ACTCGAGCGTCTGATGCGGT,20,1297040
furpa,4.0,53,10,ACTCAGGCCCGAACCGGAAA,43,1302525
furpa,1.3636363636363635,24,10,ACTATCCAAAATCAAGGCAA,14,1283890
furpa,2.727272727272727,39,10,ACGGGGGAGGACACACAGGT,29,1279406
furpa,0.2727272727272727,12,10,ACGATTACGATCAACCTGGG,2,1333735
furpa,0.8181818181818182,18,10,ACGACAAACATGCCAGGTAC,8,1333412
furpa,0.18181818181818182,11,10,ACCTATGTCAATATGTTACA,1,1344603
furpa,0.5454545454545454,15,10,ACCGGTTAATTCTGAGGACA,5,1307663
furpa,1.6363636363636365,27,10,ACCGGTACCCGGTAGAGGCT,17,1313163
furpa,2.909090909090909,41,10,ACCGGCGAATCCGCCAATAT,31,1317415
furpa,2.3636363636363638,35,10,ACCCCCACAATATTTGCTGC,25,1273906
furpa,3.727272727272727,50,10,ACCAGTGGGCTTAAGAGGCG,40,1277038
furpa,1.3636363636363635,24,10,ACATAAGTACCCCTTTCTCC,14,1271680
furpa,0.45454545454545453,14,10,ACAGGACCTGCTTAAGTTAT,4,1328653
furpa,0.18181818181818182,11,10,ACAAGGCATCTATTCCTTTG,1,1297388
furpa,0.18181818181818182,11,10,ACAAGCCGCGTGGGTCGGGC,1,1272290
furpa,5.454545454545454,69,10,AATTGCTCGTTTACAGACCC,59,1299252
furpa,0.9090909090909091,19,10,AATTGAGCTCACCGTCCAGC,9,1312156
furpa,1.7272727272727273,28,10,AATTCAGGTTATTGGGTACT,18,1281650
furpa,1.2727272727272727,23,10,AATCCTAGCACGTACCATGT,13,1340907
furpa,0.36363636363636365,13,10,AATCACCAAGAGCATCTCCT,3,1284470
furpa,37.45454545454545,421,10,AATCAACAGTCGGAGACGAT,411,1326425
furpa,4.818181818181818,62,10,AATAACGCGCAATAGATCTA,52,1288243
furpa,3.4545454545454546,47,10,AAGTTTCTTGAAACTTGACG,37,1351054
furpa,0.18181818181818182,11,10,AAGTTGCACAAGTAATGTTG,1,1294143
furpa,0.2727272727272727,12,10,AAGTTCGCGGGTACACAGTT,2,1337013
furpa,0.18181818181818182,11,10,AAGGTATGTACGGTGCCCAG,1,1352567
furpa,2.4545454545454546,36,10,AAGGCAGGGTTCCCAGTGTA,26,1285091
furpa,4.909090909090909,63,10,AAGATTATCGATATGACCGC,53,1281055
furpa,5.454545454545454,69,10,AAGATGTCATGCCTCGATCC,59,1303804
furpa,0.7272727272727273,17,10,AACGTTGAGGCCCGCGCGGC,7,1310598
furpa,3.3636363636363638,46,10,AACGTCGTCATCTTCAAAAG,36,1354273
furpa,1.8181818181818181,29,10,AACGGCCTGAGTGTGCGAGT,19,1321403
furpa,0.7272727272727273,17,10,AACGCTTGATTTCGGGGGTA,7,1272200
furpa,0.5454545454545454,15,10,AACATGGAATCTCATATATT,5,1276229
furpa,2.272727272727273,34,10,AAATCAGTGCATAAAGGTTC,24,1281531
furpa,2.909090909090909,41,10,AAAGGTCGGAGTTCCCTGCA,31,1315434
furpa,1.1818181818181819,22,10,AAACTTATGGACACCGACGG,12,1344054
furpa,0.18181818181818182,11,10,AAACAGAGTTTTCAATGCCT,1,1271455
furpa,3.1818181818181817,44,10,AAACACCATCCGTATACAGA,34,1317188
furpa,2.272727272727273,34,10,AAACACCAGTTCCTGGAGGT,24,1298527
furpa,0.5454545454545454,15,10,AAAATCTCTTTAACCTCAGG,5,1314121
furpa,2.7,35,9,TTTTGCGCCTTGGTTGCCCC,26,1321720
furpa,2.7,35,9,TTTTCAGAGGAGGTACAGTA,26,1317747
furpa,11.9,127,9,TTTTATGTAGGGATTTTCAT,118,1332078
furpa,1.4,22,9,TTTCCCAGCAAAAAATGTCA,13,1328158
furpa,2.9,37,9,TTTAGGTGCCACTACGACAT,28,1288233
furpa,13.2,140,9,TTGCGCTAGTGGTATGATTG,131,1342347
furpa,2.2,30,9,TTGCAGTACACCTGTATTAT,21,1313323
furpa,4.1,49,9,TTCTCTTCGGAACCTAAGCT,40,1331417
furpa,3.3,41,9,TTCAAGGGGCTCTCAGCAGG,32,1345087
furpa,0.9,17,9,TTCAAATCCTCAGATTGACA,8,1323139
furpa,1.8,26,9,TTATTCACAGGCAATATTGA,17,1300743
furpa,0.2,10,9,TTAGACCACATTCGTAGCTA,1,1325482
furpa,2.0,28,9,TTACGTGCTTAGCTAGAGCC,19,1291990
furpa,1.0,18,9,TTACCGATCTGCGCGTACTG,9,1302552
furpa,9.1,99,9,TTACACGCTGGCTGTACGGC,90,1314059
furpa,4.5,53,9,TTAAACTGAACTCGCCATCT,44,1354383
furpa,1.5,23,9,TGTGTATCCCTCTCTGCTTC,14,1294945
furpa,0.2,10,9,TGTGACGATAGGATGGGAGT,1,1356681
furpa,2.5,33,9,TGTCTCTCTCGGGTTCCCGA,24,1318917
furpa,2.3,31,9,TGTAGAGTCAGACTCCGTCT,22,1289902
furpa,17.3,181,9,TGGGTCCTGATTTCGACGTC,172,1277293
furpa,2.3,31,9,TGGATGGGGCGGATGGGCGG,22,1322471
furpa,1.5,23,9,TGGAGTATTTGATAGGGGCA,14,1304024
furpa,4.3,51,9,TGGAGAGCAGAGTGCTCGTA,42,1323414
furpa,0.6,14,9,TGCCACACGCAAGGTCAACT,5,1315402
furpa,0.3,11,9,TGATTTACGGTGATTATCGC,2,1341825
furpa,1.2,20,9,TGACTTACCGCGCATATCTG,11,1334161
furpa,0.8,16,9,TGACTCTAGAACGGCTCACA,7,1291181
furpa,2.2,30,9,TGAAATCTCCCAGATAGGTA,21,1291028
furpa,0.9,17,9,TCTTTTCCCTTTAGGGTTCA,8,1336563
furpa,0.3,11,9,TCTTTACTCTTCTAAACTTT,2,1348728
furpa,0.3,11,9,TCTTGTTCGATCGAAATCTA,2,1329610
furpa,0.7,15,9,TCTTGAGCGGCGCTTTGGAA,6,1276177
furpa,0.8,16,9,TCTTAGAGTTAGATTCGGCA,7,1322999
furpa,3.7,45,9,TCTGTTCGCGTGATCGACCA,36,1283707
furpa,0.2,10,9,TCTGCGAGCGCAGTCAGAAC,1,1306140
furpa,1.1,19,9,TCTGCCTATGCAACGTAGTC,10,1347177
furpa,3.4,42,9,TCTCATCCGAGCCATGATGA,33,1319342
furpa,0.4,12,9,TCTATGCCCCGGGGGACCCA,3,1317292
furpa,1.0,18,9,TCGTTCTGAAAGTCTGCACT,9,1281424
furpa,6.7,75,9,TCGGGCTAATCTGATAAGAA,66,1347665
furpa,0.4,12,9,TCGCAACTGAAACCCACGGT,3,1307796
furpa,0.2,10,9,TCCTCCTATCATGTTCGGGT,1,1273514
furpa,1.9,27,9,TCCGTTCACGCTTCCGATCG,18,1320860
furpa,1.5,23,9,TCCAGGCACAAGCTTAGGTA,14,1291285
furpa,0.2,10,9,TCCAGAACTTCTCCTTTGTT,1,1309064
furpa,0.8,16,9,TCAGTACGGGGCTGGTTTAG,7,1272113
furpa,1.9,27,9,TCACGGCGGCTTGGCTTTAA,18,1304183
furpa,5.0,58,9,TCACAGTGCTACTAGACCGA,49,1317983
furpa,1.8,26,9,TCACACTGAGCATTAAACAC,17,1355365
furpa,1.3,21,9,TCAACTCGTACCTCGAAATA,12,1324089
furpa,4.7,55,9,TATTCTAACCTACATGGAGC,46,1282836
furpa,0.5,13,9,TATCATATGCGACAACTTTA,4,1328380
furpa,0.6,14,9,TATCATAAGTTTACGCGGCC,5,1311377
furpa,1.4,22,9,TATAGAACATTGGGTAATTC,13,1298391
furpa,0.4,12,9,TATACCATGTACTTCATTGT,3,1307418
furpa,0.2,10,9,TATAAGGCGTTAAGGTCGCT,1,1357755
furpa,0.7,15,9,TAGTTAAACGAAACGGTGGG,6,1337644
furpa,0.8,16,9,TAGTGTCTCTTTCATATCTT,7,1332689
furpa,2.4,32,9,TAGGTTCGGAATTATCAGGC,23,1343575
furpa,7.7,85,9,TAGCATTTAGAAGTAGTCCT,76,1321086
furpa,2.3,31,9,TAGATTAGCTGGCCGGGGGT,22,1324461
furpa,2.8,36,9,TACTTAGCTGCCGGGGGATA,27,1278860
furpa,2.4,32,9,TACTGAGGGCGGATCAATCT,23,1299271
furpa,2.8,36,9,TACGTTTTCACCAGATTGGC,27,1311705
furpa,6.8,76,9,TACGGTAATACAGAACTTTG,67,1314000
furpa,1.8,26,9,TACGCCAGGTACTACGCCCT,17,1274177
furpa,4.5,53,9,TACCTTTCAATTTACGCCGC,44,1314228
furpa,0.2,10,9,TACATGGTGTGAGGACGAAT,1,1312710
furpa,7.8,86,9,TACATGCACATATATTTATT,77,1283638
furpa,0.6,14,9,TAATACCTTGCGTGTAGCCT,5,1277201
furpa,0.2,10,9,TAAAGGTTCTCGTGTTATCA,1,1294085
furpa,0.2,10,9,GTTTTGAGTTCTGAGGTCTG,1,1329538
furpa,3.3,41,9,GTTGCTTCACCCGTTACGCC,32,1288397
furpa,0.2,10,9,GTTCGGTTTGTTTTACCAGT,1,1303792
furpa,0.4,12,9,GTTCAAACTGAAGCCAGTAT,3,1287009
furpa,0.3,11,9,GTTATATCCAGATTTAGCCA,2,1309336
furpa,0.4,12,9,GTGTACGTTCTCGACTGTGA,3,1347906
furpa,1.6,24,9,GTCCCCACCACTCCAAGAGT,15,1297569
furpa,0.2,10,9,GTCCCACCTATAGCAACCAT,1,1335516
furpa,1.0,18,9,GTCAAGATCACTCTGGGAGC,9,1275868
furpa,4.7,55,9,GTCAAACAGTTTGTCTCCGT,46,1336996
furpa,0.3,11,9,GTATTATCCGAGTTTCCGCA,2,1291838
furpa,3.1,39,9,GTAGTAATTTTCGGTTGCCT,30,1327403
furpa,6.0,68,9,GTACTGATACATACTACGAC,59,1292100
furpa,3.4,42,9,GTACGTTCAACCGACCAACA,33,1281512
furpa,0.2,10,9,GTACGTATAATCGCCCACAG,1,1321716
furpa,0.3,11,9,GTACGACAGATATCCCCAAT,2,1337654
furpa,3.4,42,9,GTAACCGGTCGTGCATGGGT,33,1319145
furpa,0.7,15,9,GGTGGTATAAAAACCAGTCA,6,1284827
furpa,2.3,31,9,GGTCGGCGCGGATTTTTCGA,22,1277748
furpa,0.8,16,9,GGGTGTAATTCGAAGAGATT,7,1286231
furpa,1.7,25,9,GGGTAGGAAGACCCGCCGAT,16,1291801
furpa,1.1,19,9,GGGTAAATAATGTCGCCGTG,10,1284954
furpa,3.6,44,9,GGGGTAGGTGCTCCCGAAGG,35,1300537
furpa,0.3,11,9,GGGCTTTACCCTGGTCAACA,2,1294765
furpa,2.4,32,9,GGGCTGGTCCTTCGCATGTT,23,1299385
furpa,5.2,60,9,GGGCTACCTGACGAAAGATA,51,1320149
furpa,10.6,114,9,GGGCCTGACGCTGGACAATC,105,1290090
furpa,4.9,57,9,GGGCACGCAGCACTTATGAA,48,1271343
furpa,3.6,44,9,GGGAGGGTTTGAATCCACCA,35,1339589
furpa,0.5,13,9,GGGAGGCCTATTTGATATAC,4,1276826
furpa,14.0,148,9,GGGAGAGCGCTTCGAGGATC,139,1298103
furpa,5.8,66,9,GGCTTGATGTTATCGGGCTA,57,1327369
furpa,1.3,21,9,GGCCAAAAAAAGACAATAAT,12,1310026
furpa,0.3,11,9,GGCAGGGTGTGCCTCCTTAC,2,1298615
furpa,2.7,35,9,GGCAACCGCGGGGGACGGCG,26,1314042
furpa,2.7,35,9,GGAGCGTCAGCCCCTACATT,26,1332119
furpa,0.2,10,9,GGACGGAAGCGGGGGCGTTA,1,1329427
furpa,4.4,52,9,GGAATATCCGGGCCGATGAC,43,1281270
furpa,0.4,12,9,GGAACCGTAGTCAGGGTTGC,3,1296458
furpa,2.9,37,9,GGAACAGAAGCATAATGATT,28,1309575
furpa,0.3,11,9,GCTGTCATCTTCAGATACAT,2,1343741
furpa,5.5,63,9,GCTGGTATGTGTTGTGTAGA,54,1355391
furpa,5.2,60,9,GCTGGCCTCAGTTAAAATCG,51,1305655
furpa,0.2,10,9,GCTATGAAGTTAGTACAGCT,1,1339200
furpa,1.1,19,9,GCTATAGGAGGTCGGCCTAA,10,1314821
furpa,0.2,10,9,GCGTCCTGTACAGCTTTTGT,1,1300430
furpa,1.7,25,9,GCGGTCTTTCCGTCAACCCG,16,1341797
furpa,4.2,50,9,GCGCTAGTTAGATCCGCGGA,41,1309117
furpa,0.2,10,9,GCCGTACTGGTTTATCCGAT,1,1332606
furpa,0.2,10,9,GCCGGCCGCTGTGTATAGAG,1,1319695
furpa,1.8,26,9,GCCCATTAAAGCACAGCCCG,17,1313607
furpa,7.2,80,9,GCCCATCCCTACGAAGCAAT,71,1272602
furpa,0.2,10,9,GCCACGGTGTGAACTGGTGA,1,1327778
furpa,10.5,113,9,GCATCTCCAGTTGTAATTAC,104,1278075
furpa,7.1,79,9,GCAGGTTATCCGTAATTCTG,70,1279028
furpa,1.1,19,9,GCACAATGGCTCAGACTACT,10,1318456
furpa,4.0,48,9,GATTTGTTCCCGTAATGGCT,39,1307672
furpa,0.7,15,9,GATTACTCGCCTTAAGTTCA,6,1311518
furpa,0.5,13,9,GATCAGGCTGCGGGACTTGG,4,1324757
furpa,5.6,64,9,GAGTTGCACTATTGTACGAT,55,1350501
furpa,0.2,10,9,GAGTCCATTAGAAAATGTAT,1,1315038
furpa,0.2,10,9,GAGGGCTTGGCAGACACGTC,1,1297796
furpa,2.0,28,9,GAGATAAATTACATACAGGT,19,1304114
furpa,1.6,24,9,GAGAGGTATAATAGTCGGCG,15,1298777
furpa,2.3,31,9,GAGACATAAGGGGGATGATA,22,1314625
furpa,1.2,20,9,GAGAAGGGAATTCTGTTCGG,11,1355430
furpa,1.5,23,9,GACCCTAAGGGGATGGACGG,14,1299228
furpa,4.2,50,9,GACCACCTCCTGGGTGCACG,41,1286647
furpa,1.1,19,9,GACCACCCAATCCGCTCGAT,10,1346732
furpa,2.7,35,9,GACATCCCCGTCCTGATTCA,26,1319570
furpa,0.4,12,9,GAACACGGCTGGCCTCGATA,3,1344544
furpa,2.7,35,9,GAAATCAGGCGTCAGCCAAT,26,1321885
furpa,2.7,35,9,GAAATACCGTTAGTCTCGCT,26,1351999
furpa,0.6,14,9,CTTTCGTGATTAGTACGCCC,5,1316634
furpa,5.5,63,9,CTTTAAGTTTGGAGGCAGTA,54,1306749
furpa,2.0,28,9,CTTAGCCTTCTTCGTATTTT,19,1346528
furpa,4.2,50,9,CTGCTGTAAGCCTCGGTAGT,41,1286151
furpa,2.1,29,9,CTGCTGCATTAAGTTTCCAA,20,1327210
furpa,0.4,12,9,CTGCCCAGTTGCCCTCCGTC,3,1293303
furpa,15.8,166,9,CTGAGCCAACGCAGAGGCTT,157,1318801
furpa,1.2,20,9,CTCTTCCGCCCACCTTTTGC,11,1352897
furpa,0.4,12,9,CTCTGAATAAATTCGTATTA,3,1276182
furpa,0.2,10,9,CTCGGATATATGGCCCCCTG,1,1284893
furpa,0.6,14,9,CTAGCACATGTATATTTTAT,5,1310976
furpa,2.5,33,9,CTACCTATCGTAGACTTGCG,24,1279191
furpa,1.1,19,9,CTAACGTTAATGGCCTTATG,10,1344722
furpa,3.6,44,9,CTAAAAATGCCGTCCCTTTT,35,1288265
furpa,1.5,23,9,CGTCGAGCATGAGGCCTCGT,14,1326568
furpa,7.3,81,9,CGTAGCAATAGTATTTGTTA,72,1273427
furpa,0.7,15,9,CGTAACCCTCTGCTGGCCTA,6,1300875
furpa,1.2,20,9,CGGTTAGCTGGCGCGTCCTA,11,1323399
furpa,1.6,24,9,CGGTAGTCAGGCGTTTGGCG,15,1345552
furpa,2.6,34,9,CGGGTCATTAGATTTTAGGG,25,1277769
furpa,1.5,23,9,CGGGGGACGTCCCAATTCCT,14,1272824
furpa,1.0,18,9,CGGGCTCCCAACTTAGCGAT,9,1305221
furpa,4.0,48,9,CGGGCGGTGGTCTGACACCT,39,1297565
furpa,3.2,40,9,CGGGCACTCGATATTGTTCC,31,1304907
furpa,3.4,42,9,CGGATTGGTCTAAGAAGGGC,33,1318087
furpa,0.6,14,9,CGGATGTGGGGAATGGAGGG,5,1297518
furpa,1.5,23,9,CGGAACTGGCGTGGCCTGCA,14,1357239
furpa,0.2,10,9,CGCGTGACCATTCCAAGGCT,1,1306877
furpa,3.3,41,9,CGCGCCTCTATGTTCAAATA,32,1317865
furpa,1.2,20,9,CGCCTTCTGACGGATGATAG,11,1336267
furpa,3.5,43,9,CGCCGTCGGTGGTGCCCCCT,34,1279115
furpa,0.3,11,9,CGCCGTATTAGTCCAATGTT,2,1296112
furpa,0.5,13,9,CGCCCAAGGCGTATGAAAGA,4,1290151
furpa,2.3,31,9,CGCAGGGTACGGCAGCGGCA,22,1356901
furpa,5.8,66,9,CGATATATCTACGACGCGGT,57,1311716
furpa,1.9,27,9,CGAGAAAGAATCACGCTTTC,18,1278566
furpa,4.1,49,9,CGACTCGAGCCCAAAGTGGC,40,1298398
furpa,1.3,21,9,CGAAGGGGCGCACCACTTGA,12,1319313
furpa,0.9,17,9,CGAAGGATCGACTGCTGACG,8,1356507
furpa,0.5,13,9,CCTTTTGCAACACACGGCGT,4,1280702
furpa,0.2,10,9,CCTTTGCGGGGGGTCCATAA,1,1329976
furpa,1.9,27,9,CCTTGATTTCTGCAGCGCAA,18,1273840
furpa,1.5,23,9,CCTTCTGCTTCCCCGGAGTA,14,1317242
furpa,0.5,13,9,CCTTACAGTACTAGCTGCAT,4,1329319
furpa,5.4,62,9,CCTGGAACACTTAGCTGAGG,53,1277193
furpa,0.3,11,9,CCTGACTTGTATTCTCATCC,2,1309342
furpa,2.0,28,9,CCTCTAGCTCCGATGGGACT,19,1314437
furpa,0.4,12,9,CCTCATGAAGTGGTTGAATC,3,1332927
furpa,0.2,10,9,CCTCAAGCCGTGCTTTAATT,1,1335346
furpa,9.5,103,9,CCTACTGATATTGAGTCGAT,94,1312565
furpa,1.3,21,9,CCGTTCTTGACAGGACGTAA,12,1276510
furpa,1.6,24,9,CCGGTCCTGTGCCAGATGCG,15,1325617
furpa,4.7,55,9,CCGGCCTGTTCACCCATCAA,46,1321185
furpa,2.3,31,9,CCGGCATCTCACAAGAACCC,22,1355232
furpa,16.8,176,9,CCGACGGAAGAGGCATCGAC,167,1327412
furpa,6.6,74,9,CCCGTTTATGCTTTACACGA,65,1335996
furpa,4.9,57,9,CCCGGCCATCGTAGGCACAC,48,1328352
furpa,4.0,48,9,CCCCCTCGAATATGTTTAAT,39,1277611
furpa,2.1,29,9,CCCACATAAGGTGAGCCGAG,20,1350856
furpa,1.6,24,9,CCATTCCAATCCTCCAAGAT,15,1301767
furpa,1.6,24,9,CCATCAATGGAACCACCGCA,15,1345760
furpa,0.2,10,9,CCAGTGATTTCCCCTCGGAC,1,1355355
furpa,2.9,37,9,CCAGCCGACCTCAGGTTCTC,28,1345868
furpa,1.4,22,9,CCACGTACGGCTGTTCGCTA,13,1300917
furpa,15.2,160,9,CCACCTTACAGGGTCTTATG,151,1285379
furpa,3.2,40,9,CATTAGTGTCGGGCGAGGCG,31,1287695
furpa,5.6,64,9,CATGCGGTTTCTGCGCAAAT,55,1348675
furpa,0.3,11,9,CATGCACAGGTGGATGGGAT,2,1326967
furpa,3.7,45,9,CATGAATGGATTCCCCGCCT,36,1351586
furpa,3.2,40,9,CAGTCTGTGCTGTTCCGCCA,31,1298570
furpa,3.4,42,9,CAGGCGATGACGAGCTTTGT,33,1322375
furpa,0.8,16,9,CAGAGGCTGAAAATTCCCAT,7,1323348
furpa,4.0,48,9,CAGAGGCCGTGAATCAGGTT,39,1331950
furpa,0.2,10,9,CACCGTGATACCACTTAGAA,1,1317805
furpa,6.3,71,9,CACCCGGTATAAGACGCGCA,62,1308206
furpa,2.3,31,9,CACATCTGTAAGAGTGGCTT,22,1318534
furpa,0.2,10,9,CAATGCTAGATGGGACTTCA,1,1324363
furpa,1.2,20,9,CAATATTTACGCAACAGCAG,11,1300548
furpa,2.3,31,9,CAACTCTATTTATGTGCCAG,22,1315782
furpa,1.3,21,9,ATTGGCCACTTGTAGTGCTA,12,1311994
furpa,1.9,27,9,ATTCGAATGGCTGTTAGGGT,18,1311090
furpa,0.6,14,9,ATTCCGTGTTCATGGGTCCC,5,1286243
furpa,3.6,44,9,ATTATACTAGGCGTAATCGA,35,1285278
furpa,0.6,14,9,ATTAAGCCGGGACTGCCTGC,5,1273873
furpa,3.5,43,9,ATGTTCCCAATTTGTGATTT,34,1348671
furpa,0.4,12,9,ATGTGTAAGACGTTTCTCTG,3,1293489
furpa,0.2,10,9,ATGGTGTCAAACCGGCTACA,1,1281982
furpa,0.3,11,9,ATGAAACCGAATAGGTCTGC,2,1340287
furpa,0.3,11,9,ATCGGCTCCTCGACTTCGGT,2,1334683
furpa,2.8,36,9,ATCCGACCACAGTCTCTGTG,27,1349615
furpa,0.2,10,9,ATATGGGCTGGCGTCGCAGA,1,1311676
furpa,0.9,17,9,ATAGGATAGGCTTGTTCCAG,8,1272918
furpa,4.0,48,9,ATAGACGCGCCATGTCAGCA,39,1286246
furpa,2.1,29,9,ATACTTTAGTAAACTTCGAC,20,1328705
furpa,2.0,28,9,ATACCAGTATTATCATTGGT,19,1348640
furpa,2.3,31,9,ATAATAAATAGCGTTTACCA,22,1280387
furpa,0.2,10,9,ATAAATGACAGGGATGCCTA,1,1328831
furpa,0.7,15,9,AGTTGCACTCAGGAACTACC,6,1337496
furpa,0.5,13,9,AGTGTATCAAGTGGGATTAC,4,1313444
furpa,3.2,40,9,AGTGGTCCGAGGCAGTGGAC,31,1334031
furpa,9.3,101,9,AGTGCCATATCTGCTTGAAA,92,1329489
furpa,3.6,44,9,AGTCAGACAGAGGGGGGCTT,35,1341955
furpa,0.5,13,9,AGGGTGAGGACTGGGGTATT,4,1335873
furpa,1.2,20,9,AGGGTCTACGCATGGTGCTG,11,1330580
furpa,2.1,29,9,AGGGGAATTGCATAAAGGTG,20,1278256
furpa,2.1,29,9,AGGAAAGGGCCGACGTAGAT,20,1301522
furpa,0.8,16,9,AGCTTCGTGCGGCTCATATG,7,1288389
furpa,0.2,10,9,AGCTTCCGCCAGGTCATCTC,1,1289156
furpa,5.1,59,9,AGACACCCCCTAGATATGAT,50,1306747
furpa,0.6,14,9,AGAATAAGTCCTAGAAGAAA,5,1355964
furpa,2.2,30,9,ACTTTGAGGGTTAAAAACGT,21,1321263
furpa,7.7,85,9,ACTTGATCCCGTTGTCAGGT,76,1286043
furpa,3.1,39,9,ACTGGGGGCGATCCGGCGCA,30,1318035
furpa,3.8,46,9,ACTGCCAGGTGACTCGACAT,37,1353465
furpa,0.5,13,9,ACTCGTCTTGAGTTCGGTCT,4,1327747
furpa,1.5,23,9,ACTCAGACGCGTGTGCCGAG,14,1337697
furpa,4.6,54,9,ACTATTTTGGCTGCCTTCGC,45,1337315
furpa,0.3,11,9,ACTAGGAGGTCTTAATTTGG,2,1310742
furpa,1.7,25,9,ACTAGCCTCCCAGTATCAGA,16,1335521
furpa,3.1,39,9,ACGTACTCACGTAGGGCCAT,30,1290242
furpa,1.6,24,9,ACGGCCTCTTCTTGAACTCT,15,1347909
furpa,1.2,20,9,ACGGCATGGCTGTCCATGCG,11,1300597
furpa,4.7,55,9,ACGATAACGGGTCACAAGGT,46,1273885
furpa,2.8,36,9,ACCTTTCATGACCTAGGGAA,27,1316812
furpa,1.9,27,9,ACCCTATAGATAGCCATATT,18,1294754
furpa,1.2,20,9,ACATGGAGGCGAGTATCAAA,11,1289022
furpa,0.2,10,9,ACAGTGGTCATATCTGTAGG,1,1275607
furpa,0.7,15,9,ACAGCCTATCTATGTCCCTT,6,1326382
furpa,0.3,11,9,ACACCCGGTCTGCGATTGCT,2,1336100
furpa,5.1,59,9,ACACACACATCCGGAAGCTT,50,1275086
furpa,0.2,10,9,ACAAGGACAACCACCTAAAT,1,1280940
furpa,6.5,73,9,AATTATGAGCAAAAACAATG,64,1316479
furpa,5.5,63,9,AATGGTCTGCAAAACCAGGC,54,1309990
furpa,0.7,15,9,AATGGGATTCTCTTTCACAG,6,1303879
furpa,1.2,20,9,AATCGCTATTCGTCATCAAT,11,1354816
furpa,0.6,14,9,AAGTGGCCGTTGGTAAGCCA,5,1283177
furpa,4.2,50,9,AAGTGAATGGGGCATACAAA,41,1286111
furpa,0.2,10,9,AAGTCCACCCGCTGTCCTCT,1,1342429
furpa,0.2,10,9,AAGGCAGAGAAAGGGTTGCG,1,1305493
furpa,0.4,12,9,AAGCCTGTCGCTAGTGACTG,3,1279625
furpa,12.1,129,9,AAGAACCCCATCAGGGTTAA,120,1354307
furpa,5.9,67,9,AACTGTACACTGATGGTTAT,58,1306686
furpa,2.5,33,9,AACGTTCTGTATTATTCGCT,24,1312264
furpa,8.5,93,9,AACGACCTTCAGGGGTAGCG,84,1342364
furpa,3.2,40,9,AACCGATGGTCCAGTCTTTG,31,1342040
furpa,2.7,35,9,AACAGATTTTGCGCTAGTAC,26,1313620
furpa,3.1,39,9,AAAGACATTACATGCCATTG,30,1315850
furpa,1.7,25,9,AAAATCCTGTAGCGCGTAGG,16,1298550
furpa,4.3,51,9,AAAAACTTTGGCCACAACCG,42,1323132
furpa,0.2222222222222222,9,8,TTTCTCGACTTGCTGACTTA,1,1340076
furpa,6.888888888888889,69,8,TTTCATCGTAAACTCCACAG,61,1350675
furpa,0.2222222222222222,9,8,TTTCAGTCTACTCATCCTAG,1,1294393
furpa,1.7777777777777777,23,8,TTTCAGTAGTACTTATTCGA,15,1289849
furpa,4.888888888888889,51,8,TTTACGAACGTGTCAGTTCG,43,1306340
furpa,3.111111111111111,35,8,TTGTCTAAAGGTAACAAAAG,27,1296751
furpa,0.2222222222222222,9,8,TTGTCGGGAGTGGTCTTAAA,1,1347719
furpa,9.88888888888889,96,8,TTGTCAACCGTCCAGTTAAT,88,1320343
furpa,0.7777777777777778,14,8,TTGTAGTTGCCCGAACCGTT,6,1296379
furpa,1.1111111111111112,17,8,TTGGGATGCTTATTACTCTG,9,1299611
furpa,3.5555555555555554,39,8,TTGGATTGTTGTTGCCATTA,31,1288386
furpa,1.0,16,8,TTGATAGTCAGGCAAAGTTT,8,1327098
furpa,0.4444444444444444,11,8,TTCGAGCAGGGTCTATGAGT,3,1311430
furpa,7.777777777777778,77,8,TTCCGTAGAACTACATGGGG,69,1311560
furpa,0.5555555555555556,12,8,TTCCAGCTCCCTAGTTCAAC,4,1353296
furpa,9.333333333333334,91,8,TTATTGTGCACAGAATTTCT,83,1347015
furpa,1.0,16,8,TTATGCATTGTCACACCCGT,8,1308274
furpa,0.2222222222222222,9,8,TTAATCGGATAGCAACCAGC,1,1323470
furpa,0.2222222222222222,9,8,TTAAGGTTATCGGCTAAGCC,1,1312719
furpa,2.2222222222222223,27,8,TTAAGCGTAAGTCTTTCTTA,19,1274640
furpa,0.2222222222222222,9,8,TGTTATCTAATGACCACTCA,1,1335016
furpa,3.111111111111111,35,8,TGTCACTTGCTCCGGGGCGT,27,1299230
furpa,3.6666666666666665,40,8,TGTAGGTAGCCCATACGGAA,32,1342104
furpa,2.5555555555555554,30,8,TGTACTATCCCGGTTCGCCC,22,1275885
furpa,3.4444444444444446,38,8,TGTACGAACACATTCTCCGT,30,1355321
furpa,0.4444444444444444,11,8,TGTACACGATTACTAGGCTA,3,1313009
furpa,1.3333333333333333,19,8,TGTAAGAACGGTAAGGGCGA,11,1284946
furpa,0.4444444444444444,11,8,TGGGACCCGTATGTTGGACC,3,1335900
furpa,0.4444444444444444,11,8,TGGGACAAGATATCGATATG,3,1357035
furpa,4.888888888888889,51,8,TGGCCTTTTAGTTGCCACTG,43,1290183
furpa,0.2222222222222222,9,8,TGGCCGACCGCTAGAACTCT,1,1355642
furpa,0.2222222222222222,9,8,TGGATCTTGTGTCCTAGGGT,1,1351482
furpa,1.7777777777777777,23,8,TGGATACTATCGGACCGCAA,15,1354073
furpa,0.2222222222222222,9,8,TGCTTCGGGGGAGTGAATTC,1,1356528
furpa,1.0,16,8,TGCTCCCCGAAACGGTGCGA,8,1316635
furpa,0.2222222222222222,9,8,TGCGCCATGCCTTTCTGTGG,1,1318568
furpa,0.7777777777777778,14,8,TGCGAGAATGCATTGAAGGT,6,1344931
furpa,5.666666666666667,58,8,TGCGACTCTATACAACATTC,50,1357250
furpa,8.333333333333334,82,8,TGCCGCACCCACTGGGGCGT,74,1308211
furpa,1.3333333333333333,19,8,TGCCGAGATCATTGGCGAAT,11,1312723
furpa,4.333333333333333,46,8,TGCAGGGCTTTGTGTATATG,38,1294086
furpa,0.8888888888888888,15,8,TGCACCGCGAGAGTGCGCTA,7,1334705
furpa,0.2222222222222222,9,8,TGCACAGAAACATTGGGATT,1,1276264
furpa,6.222222222222222,63,8,TGATTGGCCGAGAGGTAGAC,55,1303180
furpa,4.888888888888889,51,8,TGAGCGTAACCTCCCCCGAA,43,1349978
furpa,3.111111111111111,35,8,TGACCGCGTTAGTACTTGGA,27,1302454
furpa,1.3333333333333333,19,8,TGAATTTCCTACACGATAAG,11,1338640
furpa,0.3333333333333333,10,8,TGAAGCAGGGGCGCTGTACA,2,1315422
furpa,4.555555555555555,48,8,TGAACCGCCGCCCAGGCAAC,40,1308064
furpa,2.3333333333333335,28,8,TCTTCAAAATTCCTAATACA,20,1304834
furpa,4.444444444444445,47,8,TCTGGGACCAGCCGACGCTA,39,1354553
furpa,4.0,43,8,TCTCGACAGCATAGTACCAG,35,1320123
furpa,2.3333333333333335,28,8,TCGTGGATAGGACAGGCTTA,20,1285117
furpa,8.222222222222221,81,8,TCGTGCAACCGGGCGACGCA,73,1308224
furpa,6.666666666666667,67,8,TCGGTTCGACCGTCGGGATA,59,1305162
furpa,1.0,16,8,TCGGCTAAGCCATATGGGCA,8,1327225
furpa,0.4444444444444444,11,8,TCGCCGGAGTATAAAAATCT,3,1287083
furpa,2.4444444444444446,29,8,TCGCCGCCCTGTAGTAACAG,21,1319655
furpa,0.2222222222222222,9,8,TCGCAGCCCTGTCCGCTCTC,1,1301645
furpa,2.4444444444444446,29,8,TCGATCGTAATGCTCATATA,21,1316098
furpa,3.6666666666666665,40,8,TCGACGGCTCACACGTCCAA,32,1294623
furpa,2.888888888888889,33,8,TCCTCTTGACGTTCACTGTT,25,1271681
furpa,12.555555555555555,120,8,TCCTCACCCTATCGGTATAA,112,1336885
furpa,1.4444444444444444,20,8,TCCCTTGTGACCCTATACTC,12,1285042
furpa,0.6666666666666666,13,8,TCCCGCCTGCCTAAAAGGCC,5,1343680
furpa,3.888888888888889,42,8,TCCCGACGTTGGATATTATA,34,1340536
furpa,2.111111111111111,26,8,TCCAAAAGCACGTGACTACA,18,1295950
furpa,4.444444444444445,47,8,TCATTAATGGACGGGGGGTC,39,1323948
furpa,1.6666666666666667,22,8,TCATCTCCCCCTCTAGGGTC,14,1344435
furpa,0.2222222222222222,9,8,TCATACACGGCACCATGCGA,1,1306622
furpa,7.777777777777778,77,8,TCAGGGGCAAGTGACCGTGA,69,1345018
furpa,5.111111111111111,53,8,TCAGGCAGGATCGAGCATCT,45,1327894
furpa,14.777777777777779,140,8,TCAGCGCTTAAACTACTGAC,132,1284944
furpa,2.3333333333333335,28,8,TCACACAGCTTAACCAGGCA,20,1328365
furpa,0.2222222222222222,9,8,TCAAAATGCAAGCTGGCCCT,1,1326602
furpa,3.888888888888889,42,8,TATGTGACGTCCTCGCTTAC,34,1272741
furpa,2.5555555555555554,30,8,TATCGAGACGGTTCTACTGA,22,1278378
furpa,5.666666666666667,58,8,TAGCGACTGATCTCGTACCC,50,1319179
furpa,1.0,16,8,TAGCCTAGCAACGAAAATCA,8,1288839
furpa,5.222222222222222,54,8,TAGATGACGCGTAGTACCAT,46,1292120
furpa,3.0,34,8,TACTCCTTGCTGCCGGATTG,26,1332921
furpa,2.0,25,8,TACGTCAACAGAAGTGATAA,17,1291328
furpa,6.777777777777778,68,8,TACGGATTAGCCAATTCTAC,60,1316370
furpa,1.0,16,8,TACGCTTAACAACTTGAAGT,8,1285096
furpa,2.2222222222222223,27,8,TACCCACCCCTGTTAGTAAG,19,1346700
furpa,0.2222222222222222,9,8,TAATCATGCAAAAACCCCAG,1,1341611
furpa,2.3333333333333335,28,8,TAAGTTCCAGAAGAAGGCGT,20,1338122
furpa,3.7777777777777777,41,8,TAAGCACGTGTTCCGCGACT,33,1313764
furpa,0.2222222222222222,9,8,TAACTTTTATGCGATAGAGA,1,1283591
furpa,4.111111111111111,44,8,TAACCGTATCTCTATCACGA,36,1321440
furpa,1.2222222222222223,18,8,TAAAGATTATAGCCGGGTCC,10,1291626
furpa,4.222222222222222,45,8,GTTTCCTGCGACCCGGATAG,37,1285961
furpa,7.111111111111111,71,8,GTTGGGCTAGAAGGGACCAT,63,1306398
furpa,0.3333333333333333,10,8,GTTCGCTCTCGAAAAGATTG,2,1291804
furpa,1.4444444444444444,20,8,GTTCGCTCAAAATTAATGGG,12,1353073
furpa,0.2222222222222222,9,8,GTTCGCACCCGATAGGGCAA,1,1321985
furpa,5.0,52,8,GTTCACCGTGCAGCCTATCA,44,1309893
furpa,1.6666666666666667,22,8,GTTATTGAGGACAATGCATC,14,1300079
furpa,0.7777777777777778,14,8,GTTACTGTTCCTTTGACATA,6,1348769
furpa,2.3333333333333335,28,8,GTGTTAGGTTCGATCGTGTA,20,1277740
furpa,5.222222222222222,54,8,GTGTCGGTGTTCCATAGCGC,46,1277219
furpa,0.8888888888888888,15,8,GTGGTTCAATCTTTTGAAGA,7,1339069
furpa,3.5555555555555554,39,8,GTGGGTACACGGGCACCCTG,31,1308372
furpa,15.333333333333334,145,8,GTGGCCCTGTACGTACCATT,137,1290035
furpa,1.8888888888888888,24,8,GTGGAGGCTAGGAGGCTGTC,16,1301057
furpa,7.111111111111111,71,8,GTGCCCCCCGGATGGATTAC,63,1277196
furpa,9.444444444444445,92,8,GTGAGTTAACAGCTATACTT,84,1352599
furpa,5.666666666666667,58,8,GTGAACTAGGTGGGAGGACT,50,1330684
furpa,1.5555555555555556,21,8,GTCTGGTACCATCCGTTCCT,13,1338628
furpa,2.111111111111111,26,8,GTCTCCGCGTGCTGTTCGTA,18,1345123
furpa,2.2222222222222223,27,8,GTCTATTGAGCCACACCTCA,19,1326338
furpa,4.777777777777778,50,8,GTCTAACTGGGACGCGTTAA,42,1304836
furpa,0.2222222222222222,9,8,GTCGTTACACTCGGACACGG,1,1344986
furpa,0.2222222222222222,9,8,GTCCTGTGCATGCACCAGAA,1,1333075
furpa,0.2222222222222222,9,8,GTCCATTCGCAAACTCCTCA,1,1322758
furpa,2.4444444444444446,29,8,GTCATATTAAACGCTTCTGA,21,1278927
furpa,1.6666666666666667,22,8,GTCAGGAGCGTCGGGTGGTA,14,1289205
furpa,0.3333333333333333,10,8,GTCACAGGCTTGGTGAGGTT,2,1281463
furpa,1.1111111111111112,17,8,GTCAATGATTGCTGGTTCAA,9,1327556
furpa,3.5555555555555554,39,8,GTCAATAACAACCACTGTGG,31,1307128
furpa,2.2222222222222223,27,8,GTAGGAGGGGGTTAAAACTT,19,1352497
furpa,1.1111111111111112,17,8,GTACGTCCATGGCCCGCGCT,9,1297583
furpa,3.4444444444444446,38,8,GGTTCTCAGGACTTCGAGCA,30,1290826
furpa,0.2222222222222222,9,8,GGTGTCCTAACGACCAATAA,1,1276033
furpa,3.0,34,8,GGTGCCTGTGCTGAGTTTAT,26,1340240
furpa,1.4444444444444444,20,8,GGTGCACTTACTCGGTTAAA,12,1348562
furpa,0.4444444444444444,11,8,GGTATGGTTCTCGTCTATTA,3,1310481
furpa,4.111111111111111,44,8,GGGTTAAAGTTAGTGCTCCA,36,1332443
furpa,3.5555555555555554,39,8,GGGTCTACGGCTCCAGTGGT,31,1275535
furpa,4.333333333333333,46,8,GGGGTCCAATGCCTGCTTAC,38,1349269
furpa,0.2222222222222222,9,8,GGGGTAAATGAATCAAGTTT,1,1344923
furpa,3.888888888888889,42,8,GGGACTCCCCCGACGGATAC,34,1300760
furpa,0.5555555555555556,12,8,GGCTCCGAAGTTCTCGAGCT,4,1303506
furpa,1.6666666666666667,22,8,GGCGCAGTGTCTATATGAAA,14,1319780
furpa,11.555555555555555,111,8,GGCCTTGTCAAGCGAACCAA,103,1328241
furpa,0.4444444444444444,11,8,GGCCCGATAGGTTGTTCAGT,3,1313761
furpa,0.2222222222222222,9,8,GGCAGCCAGGATCACGCCAA,1,1313963
furpa,1.7777777777777777,23,8,GGATCATGACGTCTTCTTGA,15,1291809
furpa,2.4444444444444446,29,8,GGAGAAAGTCTGCATCCGTT,21,1310056
furpa,0.5555555555555556,12,8,GGAAGCTCGGATCTACCTAC,4,1331293
furpa,0.4444444444444444,11,8,GCTTGTGGGGGTTGTATCAT,3,1316789
furpa,0.2222222222222222,9,8,GCTGTACTCGAATAGGCCAC,1,1329098
furpa,4.0,43,8,GCTGGCTTACGATCACCTTG,35,1320647
furpa,1.2222222222222223,18,8,GCTGCGAGACCTAGTGGCTT,10,1331921
furpa,2.111111111111111,26,8,GCTAATTTGCCGGATTCCGT,18,1287464
furpa,2.0,25,8,GCGTAGAAAACCCATACGCT,17,1329805
furpa,0.2222222222222222,9,8,GCGGGGAGGTCTTCGTTATT,1,1274869
furpa,2.7777777777777777,32,8,GCGGCAGCCACTCGATAAAC,24,1275497
furpa,0.2222222222222222,9,8,GCGCGCCTAACACGATCTTC,1,1337647
furpa,0.3333333333333333,10,8,GCGACAGAACGTTTGGCTGA,2,1355807
furpa,4.111111111111111,44,8,GCGAATGACGTCCACCTCGA,36,1351766
furpa,0.2222222222222222,9,8,GCCGGTCAAGTGAGTAAAAG,1,1316520
furpa,0.3333333333333333,10,8,GCCGAACCCTATTATCACAA,2,1354490
furpa,1.0,16,8,GCCAAACGAAACCGTCATGT,8,1349120
furpa,1.4444444444444444,20,8,GCATCGGCGAATGCAAGCGA,12,1352974
furpa,0.7777777777777778,14,8,GCATCCATAATTAGAGTAAA,6,1308370
furpa,0.4444444444444444,11,8,GCAGTTTGCATGGTCCCCTT,3,1296226
furpa,5.666666666666667,58,8,GCAGGGATGACATAGGACTC,50,1288016
furpa,0.8888888888888888,15,8,GCACCAAGGGATGTGTGAGG,7,1340057
furpa,0.2222222222222222,9,8,GCACATCGGGTACAGCTCGC,1,1303600
furpa,2.0,25,8,GATGCAGGCCAAGGAGGGAC,17,1278217
furpa,0.2222222222222222,9,8,GATGAAAGGGAAGGTGCTTT,1,1335114
furpa,4.444444444444445,47,8,GATAGTCCACCAGCGGATCT,39,1331070
furpa,0.3333333333333333,10,8,GATACGCCGCAGCTTCAACA,2,1304499
furpa,0.3333333333333333,10,8,GATACCTTACAACTATCCTT,2,1343705
furpa,3.888888888888889,42,8,GAGGATACGACCTAATGTAA,34,1294207
furpa,2.0,25,8,GAGGAGGCTTAGGTCGCGCT,17,1333858
furpa,0.2222222222222222,9,8,GAGCTCACATCGTAGTGTAA,1,1344605
furpa,2.3333333333333335,28,8,GAGCATTACAACTGAGCCCT,20,1303815
furpa,0.2222222222222222,9,8,GAGACCGGTCGGGCCGTGAT,1,1321789
furpa,1.0,16,8,GAGACACGTGAGTTCGACTT,8,1330618
furpa,2.111111111111111,26,8,GACTGCCCACGGGTGTACTG,18,1273401
furpa,6.222222222222222,63,8,GACTCGCAAGGGTAATTTGC,55,1288453
furpa,0.2222222222222222,9,8,GACGCCATGAGACTCCTTAA,1,1281411
furpa,3.3333333333333335,37,8,GACCCTGGGGGTCACGCTCT,29,1281269
furpa,7.333333333333333,73,8,GACCCTAGGCGCTGGGCTAA,65,1326554
furpa,5.111111111111111,53,8,GACCCGTTAAGTATGTGGTG,45,1305568
furpa,3.2222222222222223,36,8,GACATTGACTGTGCTTCCAT,28,1292215
furpa,12.777777777777779,122,8,GACAAACTACAACTCAACCC,114,1304905
furpa,0.2222222222222222,9,8,GAATTAGGAATGTTCTTAAC,1,1284933
furpa,1.5555555555555556,21,8,GAATGGCTGTATTAGATCCC,13,1302204
furpa,0.7777777777777778,14,8,GAACCTTAAGCTCTCAGGTC,6,1334208
furpa,1.3333333333333333,19,8,GAACCTATGGGACTTGCTAG,11,1315774
furpa,2.0,25,8,GAAATTAGCTGACCAGGCCT,17,1344541
furpa,4.0,43,8,CTTTCCTTCAGTAGAACGGG,35,1336128
furpa,1.6666666666666667,22,8,CTTGGCTCATCCTGAATTCT,14,1295638
furpa,0.2222222222222222,9,8,CTTAAATGAGTACTCGGTCG,1,1354250
furpa,1.3333333333333333,19,8,CTGGCACACTATCCCTAGCA,11,1291515
furpa,5.777777777777778,59,8,CTGCGAATGGACGTAGATAG,51,1336624
furpa,1.6666666666666667,22,8,CTCGTCATCTGAGTTGATAA,14,1354473
furpa,1.7777777777777777,23,8,CTCGCGCCAAAATCTGGAAA,15,1333093
furpa,2.6666666666666665,31,8,CTCGATGCAACAGTCTACAC,23,1344871
furpa,3.2222222222222223,36,8,CTCATAATCATAAGAGTCCT,28,1293453
furpa,0.4444444444444444,11,8,CTCAGGCAACACATGCGAAA,3,1338060
furpa,1.3333333333333333,19,8,CTCACGTCCTGATCGGCAAC,11,1299104
furpa,2.111111111111111,26,8,CTCACGACCTCCGCTAATGA,18,1305153
furpa,9.0,88,8,CTCAAGAGGACGGGGCGAAT,80,1311276
furpa,1.7777777777777777,23,8,CTATGGAGGCGAGTCGGGGT,15,1273135
furpa,2.111111111111111,26,8,CTAGTCTAAGTAACCAACCG,18,1339278
furpa,3.888888888888889,42,8,CTAGGTGTGCCACAGGCACA,34,1330645
furpa,1.0,16,8,CTAGCCGGTATCCTGCTAAG,8,1294718
furpa,2.2222222222222223,27,8,CTAGAAGGCAGAATCCCACG,19,1329245
furpa,2.0,25,8,CTACAGAGGGTGCCGCGGGT,17,1273074
furpa,2.4444444444444446,29,8,CTAATCTTGTGTTCTGGGGT,21,1351198
furpa,0.2222222222222222,9,8,CTAACGTTGAAGAGGTAAGG,1,1332310
furpa,12.222222222222221,117,8,CTAAACAAAGTAGTTTTCCT,109,1350301
furpa,2.4444444444444446,29,8,CGTTTAATTGCCAATTGACC,21,1307188
furpa,2.2222222222222223,27,8,CGTTCCACAAGCGGGTCAGA,19,1302867
furpa,5.666666666666667,58,8,CGTTATTGTCACGGTGCCGG,50,1339349
furpa,5.444444444444445,56,8,CGTTAGGCCGAAGTTTGCTC,48,1286711
furpa,0.4444444444444444,11,8,CGTGTTAAACAACGTTTATC,3,1319689
furpa,0.2222222222222222,9,8,CGTGTGAAAAGGAACCACAA,1,1290029
furpa,1.1111111111111112,17,8,CGTCCTCATTGCCCTCAAAT,9,1299925
furpa,0.5555555555555556,12,8,CGGTTGTTCGTGAGAGACGA,4,1343561
furpa,1.1111111111111112,17,8,CGGGTTTAATTCATACTGAA,9,1286168
furpa,2.888888888888889,33,8,CGGGGGACAGCCGTCCGGCG,25,1327634
furpa,0.2222222222222222,9,8,CGGGCGATTCCATAAAGATG,1,1339205
furpa,15.444444444444445,146,8,CGGCTCCACTTAGGTAATGC,138,1320443
furpa,8.555555555555555,84,8,CGGCCCGAGCTGTTTCCTCC,76,1349010
furpa,0.3333333333333333,10,8,CGGCAATCGCTATATTCTTC,2,1280832
furpa,5.0,52,8,CGGCAAAGTGGCAGGGCGCG,44,1283296
furpa,0.2222222222222222,9,8,CGGATGTGTGTCCGCCGCGA,1,1342990
furpa,3.6666666666666665,40,8,CGCTTATTAGGCGCGCTGGT,32,1354191
furpa,0.2222222222222222,9,8,CGCTCGCATCGTTAGAGAAT,1,1272104
furpa,4.444444444444445,47,8,CGCCTCCACAAGGACCTGCA,39,1337365
furpa,12.777777777777779,122,8,CGCCCTTTGCGACAGTGGTT,114,1284942
furpa,0.6666666666666666,13,8,CGCATATTGTGGGGCCTTAG,5,1330142
furpa,0.2222222222222222,9,8,CGATCCGCGTCGGTATCGTT,1,1340480
furpa,2.0,25,8,CGAGTTAGGATCCACATGTA,17,1326240
furpa,0.2222222222222222,9,8,CGAGGTATACGTAGATCTTA,1,1285565
furpa,0.5555555555555556,12,8,CGACCTCGGGCTAGTGATAC,4,1337411
furpa,3.7777777777777777,41,8,CGACCCACGGACCGCGCCCT,33,1328617
furpa,6.888888888888889,69,8,CCTTGCAACGCGGCCTGAAC,61,1308766
furpa,0.3333333333333333,10,8,CCTTCGTTGACTTGCTATCA,2,1303176
furpa,0.2222222222222222,9,8,CCGTTTTCCCAGAGGGAGCA,1,1276445
furpa,5.666666666666667,58,8,CCGTGGAGCAGGCTTCGTAT,50,1299465
furpa,2.0,25,8,CCGGGTTCTGCTTTCCGCGT,17,1314871
furpa,3.6666666666666665,40,8,CCGGGCCGTCGCTGGGCAAT,32,1312762
furpa,5.555555555555555,57,8,CCGAGCCAAAGCCGTGCCTC,49,1272921
furpa,2.111111111111111,26,8,CCCTTGGCCGCACCAGCTAT,18,1301286
furpa,5.111111111111111,53,8,CCCTTGCCGGCCTTCGGAGC,45,1316260
furpa,16.77777777777778,158,8,CCCTTGAAGTTAGACCCGAT,150,1307007
furpa,0.7777777777777778,14,8,CCATTTTCACGTCCGGCTAG,6,1313883
furpa,2.888888888888889,33,8,CCATTGACGTGATCAGAATG,25,1328505
furpa,0.3333333333333333,10,8,CCATGGTAACTTCTTATCAC,2,1282482
furpa,11.333333333333334,109,8,CCATCGGATACCTTGCAGAT,101,1320167
furpa,3.0,34,8,CCATACCGATTCGACTGTGA,26,1339034
furpa,7.111111111111111,71,8,CCAGGTGACTCCTAGCTTTC,63,1351597
furpa,3.4444444444444446,38,8,CCAGGATAAGAACTTCGTAA,30,1311002
furpa,1.8888888888888888,24,8,CCAGACTGCAATCGACCCGG,16,1286104
furpa,3.888888888888889,42,8,CCAGACGAATTTTACGCCAG,34,1312983
furpa,3.111111111111111,35,8,CCACTTCTTAAGCGCTGGGC,27,1290149
furpa,3.3333333333333335,37,8,CCACAATAGTAATCGTGAAG,29,1309948
furpa,0.2222222222222222,9,8,CCAATGCCTACGTCAGCCAT,1,1343122
furpa,9.222222222222221,90,8,CCAACAATCTCTTCGCTTAA,82,1328244
furpa,0.2222222222222222,9,8,CATTTTTACTAGAATCTTAT,1,1321547
furpa,1.3333333333333333,19,8,CATTTGAGCGTTCGTTTGAG,11,1274523
furpa,4.0,43,8,CATTGGCCCTCGGAAACTCC,35,1327625
furpa,1.5555555555555556,21,8,CATTAAGCGATGGGCAAGTG,13,1326194
furpa,0.7777777777777778,14,8,CATCCATTCTGGAGTGCATG,6,1297928
furpa,0.4444444444444444,11,8,CATAAGATTGTTATTCAGAG,3,1347198
furpa,1.1111111111111112,17,8,CAGGGGGTTATTTTCGGTGA,9,1308362
furpa,1.3333333333333333,19,8,CAGGCTGGTACCGGCCTTTA,11,1356083
furpa,0.7777777777777778,14,8,CAGACGACTCGTGTACTCAT,6,1352502
furpa,0.3333333333333333,10,8,CACTCCAGAGTTGGTCCGGC,2,1327889
furpa,0.2222222222222222,9,8,CACTCAACGGTGGTGTCCTT,1,1337891
furpa,1.0,16,8,CACGTACGGTATCATTCCGT,8,1326429
furpa,4.111111111111111,44,8,CACATAGTACTCACAGGGAT,36,1348606
furpa,1.0,16,8,CAATATTCAGCGCGCTCAAG,8,1291662
furpa,2.3333333333333335,28,8,CAATAGTGTAGTTCCGTCCG,20,1295131
furpa,0.2222222222222222,9,8,CAAGTCTGAGCAGGTCGTGG,1,1316743
furpa,0.8888888888888888,15,8,CAAGTAATCCCGCTTGATTA,7,1319330
furpa,0.2222222222222222,9,8,CAAGGAGGCTGTTTCAGAAT,1,1273980
furpa,2.7777777777777777,32,8,CAAGCGCGTCAGGTCGCGGT,24,1325054
furpa,4.666666666666667,49,8,CAACCCGTGAGCCGGCCAGG,41,1333147
furpa,2.6666666666666665,31,8,CAAAAATAGTAGTCCCGCTC,23,1296432
furpa,3.2222222222222223,36,8,ATTTTCATTATCCTCACGCG,28,1336581
furpa,0.2222222222222222,9,8,ATTGTCCGCTAAACATACTA,1,1279623
furpa,4.888888888888889,51,8,ATTGAGTGCCAAGCCCGTGC,43,1326552
furpa,5.444444444444445,56,8,ATTCGTACTTTATTTAACGG,48,1292801
furpa,2.2222222222222223,27,8,ATTCGCTCGAGAGTTTGCAT,19,1295450
furpa,0.5555555555555556,12,8,ATTCGCGGGACGGTTCGTGT,4,1283617
furpa,2.2222222222222223,27,8,ATTCCCGTTCATACGGATTG,19,1330649
furpa,1.4444444444444444,20,8,ATGTAGGGTTTCTGCAATCG,12,1297763
furpa,4.333333333333333,46,8,ATGGCTTGGTGTCAGTTGTC,38,1343663
furpa,2.111111111111111,26,8,ATGCGCTTAGGTCCGCCACT,18,1304074
furpa,2.111111111111111,26,8,ATGCAAGAGTTCGCCCTGAA,18,1345902
furpa,7.444444444444445,74,8,ATCGGGAACGTATCCCTGGG,66,1280640
furpa,1.3333333333333333,19,8,ATCGAGTGCGCAGAGATAAT,11,1274136
furpa,3.7777777777777777,41,8,ATCCTTTCGCTGCTATGGAA,33,1292858
furpa,9.777777777777779,95,8,ATCCTAGCTCGATCCTGCTT,87,1281884
furpa,0.6666666666666666,13,8,ATCCCACCAGTTTATGACGG,5,1342476
furpa,2.6666666666666665,31,8,ATCCAGCGTACTTCTGGAAG,23,1294162
furpa,0.2222222222222222,9,8,ATCATGTCGGTACTAATCAA,1,1294134
furpa,0.5555555555555556,12,8,ATCACCTGCTGGTAAGCCAC,4,1284142
furpa,2.4444444444444446,29,8,ATAGTTCACGTATTCTCACG,21,1338638
furpa,4.555555555555555,48,8,ATACCGGACGCGGTTCGAGG,40,1284176
furpa,1.5555555555555556,21,8,ATAAGTGGTGCACCGTTATT,13,1302865
furpa,10.666666666666666,103,8,AGTTGAGGTCGCATATATTA,95,1321332
furpa,3.111111111111111,35,8,AGTACCGAGCAGCAGATGTG,27,1307227
furpa,0.8888888888888888,15,8,AGGTCCCAGTGCGAGTTTCC,7,1305841
furpa,0.6666666666666666,13,8,AGGTCAAAACTTGCCGTTAT,5,1281891
furpa,0.4444444444444444,11,8,AGGGGATATAGTTTCGTTCC,3,1271718
furpa,0.2222222222222222,9,8,AGGCTGCTAAGAAGTGAACA,1,1289900
furpa,3.3333333333333335,37,8,AGGATGGGTCATCCGAGGCC,29,1334910
furpa,0.2222222222222222,9,8,AGGAAGAGAGTCCATATTTA,1,1349284
furpa,6.222222222222222,63,8,AGCTTGTTGACTCTGTCGCT,55,1277986
furpa,6.444444444444445,65,8,AGCGCTCTATGTTCACATTC,57,1281986
furpa,3.7777777777777777,41,8,AGCCGATATTAGCGACCTGG,33,1304923
furpa,2.6666666666666665,31,8,AGCCCCTTACGGCTGAGTGG,23,1271215
furpa,2.0,25,8,AGCCCCCGCTGAATCCCTGA,17,1331982
furpa,0.3333333333333333,10,8,AGCAGCCATAAATATCACTT,2,1298555
furpa,4.222222222222222,45,8,AGCAAGTAGAGTTAGGGGTT,37,1328233
furpa,0.3333333333333333,10,8,AGATGATTTTTGTATTAACG,2,1305304
furpa,6.888888888888889,69,8,AGATCTAATGCCACCGCATG,61,1307006
furpa,1.2222222222222223,18,8,AGATCAACTCTCTGTGCAAA,10,1303582
furpa,0.2222222222222222,9,8,AGATACCTAGCAAAATTATA,1,1353498
furpa,0.5555555555555556,12,8,ACTGCTCTAATTGACCAATT,4,1299290
furpa,3.4444444444444446,38,8,ACTCTGGTTGTTTAAGCCCT,30,1338985
furpa,2.0,25,8,ACTCTCCAGCAACCACGTTG,17,1312676
furpa,0.2222222222222222,9,8,ACTCGCATCGTGCGGACAGG,1,1307689
furpa,2.2222222222222223,27,8,ACTCCTCTTTTGATTAATTT,19,1321351
furpa,8.444444444444445,83,8,ACTCCCATCGATAGCCATGT,75,1295746
furpa,5.666666666666667,58,8,ACTATGACGGGAACATACGG,50,1321875
furpa,1.6666666666666667,22,8,ACTACATAGCGGACTCTCAA,14,1332170
furpa,0.2222222222222222,9,8,ACGTCAACAACTAGGCTTGC,1,1353984
furpa,1.4444444444444444,20,8,ACGGAGCGGATTTTGATCCT,12,1338478
furpa,4.111111111111111,44,8,ACGCATTCTCTCCGGGTTGA,36,1336152
furpa,2.4444444444444446,29,8,ACGCAACCGCTACTGAGCTG,21,1282871
furpa,3.4444444444444446,38,8,ACGATCAAATTGGGAAAAAA,30,1292770
furpa,5.888888888888889,60,8,ACGAGGGCAGCCGCAATAGA,52,1343569
furpa,0.2222222222222222,9,8,ACCTAGGGGGTTCTCGGGCG,1,1324998
furpa,6.555555555555555,66,8,ACCGGTCAATTTGCTAGAAA,58,1327618
furpa,8.11111111111111,80,8,ACCGCCGTGCATGAGGGACT,72,1354280
furpa,0.2222222222222222,9,8,ACCGATCTTCTGGCAAGACT,1,1285518
furpa,3.888888888888889,42,8,ACCCTTTCTGTCGCAGATCT,34,1352046
furpa,2.3333333333333335,28,8,ACCCTTCCTCTAGTGGCTTA,20,1275001
furpa,0.3333333333333333,10,8,ACATCGAGTCAAATCGGCGT,2,1319426
furpa,1.3333333333333333,19,8,ACACAGCCTCTCATGCTGCT,11,1293647
furpa,4.555555555555555,48,8,ACAACGAGCGTTTTTCTGTG,40,1303890
furpa,0.7777777777777778,14,8,AATTTAATCATATGGTATCA,6,1282840
furpa,4.0,43,8,AATGCGATAAATGCTGAAGT,35,1327890
furpa,3.888888888888889,42,8,AATGCAACGCGAACTAGATA,34,1319565
furpa,6.111111111111111,62,8,AATCACTAGGGGCGAGTATG,54,1349538
furpa,1.3333333333333333,19,8,AATCAATTCTCAAGCACGTT,11,1278172
furpa,1.3333333333333333,19,8,AATACGTGATTTTTTTTGCA,11,1350529
furpa,0.2222222222222222,9,8,AATACGGATAAAGATTTAGG,1,1308369
furpa,1.3333333333333333,19,8,AATAATACAAAGCGAGCCGA,11,1318996
furpa,4.888888888888889,51,8,AAGTTGCTCAGTCAATTTAA,43,1291800
furpa,1.0,16,8,AAGTCTCCCCTAGCCTAATC,8,1321627
furpa,5.222222222222222,54,8,AAGCCTACTTACGTCCTATC,46,1314906
furpa,3.4444444444444446,38,8,AAGAAATAGCAGGAATTCGT,30,1308455
furpa,2.888888888888889,33,8,AACGGGTCCCCAACGGCTAT,25,1354599
furpa,1.8888888888888888,24,8,AACGGGCCTATGCGGCTGTT,16,1318518
furpa,0.8888888888888888,15,8,AACGGAGTGCCATCCACAAG,7,1309763
furpa,5.444444444444445,56,8,AACGAGAGTGCGGATATCCT,48,1306498
furpa,3.2222222222222223,36,8,AACCGCATGCGTACCGGATG,28,1297813
furpa,1.7777777777777777,23,8,AACAGAGCTTAGTAGTGTGT,15,1285231
furpa,3.5555555555555554,39,8,AAATTCCTGAGCATGGAACT,31,1292004
furpa,0.7777777777777778,14,8,AAATCAGCGGGTAGCCCCGG,6,1290273
furpa,0.2222222222222222,9,8,AAACGATCCGGTGTCCCATA,1,1347840
furpa,2.2222222222222223,27,8,AAACAAGAATAGACCCGTCC,19,1339163
furpa,0.2222222222222222,9,8,AAAAGCGAGCGTTATTGTAA,1,1309294
furpa,0.375,9,7,TTTTTCCGGGTTGAACCGCT,2,1349587
furpa,3.25,32,7,TTTGAGCAAAGAAATCACGT,25,1335500
furpa,1.375,17,7,TTTCATAAGCGAGTATATGC,10,1284964
furpa,2.875,29,7,TTTAGGACTGGCCATCAAAA,22,1350258
furpa,0.25,8,7,TTTAATCACTTCGCTTCAAT,1,1320646
furpa,1.875,21,7,TTGAATAATCACTAAATTTC,14,1309015
furpa,1.375,17,7,TTCTTTGAGCGCGTCTCCGG,10,1313165
furpa,0.875,13,7,TTCTAATGCTGGTTGGTCAG,6,1346642
furpa,0.25,8,7,TTCGTAGGGGTGTCGATTGT,1,1274112
furpa,3.125,31,7,TTCGTACCTAGGGCACCGAA,24,1321401
furpa,2.625,27,7,TTCGATTTTAATAATGATAA,20,1279290
furpa,3.75,36,7,TTCCTGATGGATAGGCGCCA,29,1277194
furpa,2.625,27,7,TTCCGTAGCCATTAAGCACT,20,1352510
furpa,5.25,48,7,TTCAGGACGGTCTTCTTTCA,41,1344038
furpa,2.875,29,7,TTATACCTTCCAACGTGCTT,22,1323729
furpa,1.0,14,7,TTAGCTTCATACGTGATGGG,7,1274928
furpa,8.875,77,7,TTACTACCTTATGATTTTCG,70,1349839
furpa,2.75,28,7,TTACGGACACCATAAGGACC,21,1330115
furpa,3.75,36,7,TTACAACCTGCTACTGGTAT,29,1279539
furpa,0.25,8,7,TTAATTTGGCGCTTATTAAT,1,1344007
furpa,1.375,17,7,TGTTCTGTTGGGGAGCGCTG,10,1347864
furpa,0.25,8,7,TGTGGTTGTACACGCGAGAC,1,1315579
furpa,0.75,12,7,TGTGATTAACACCATAGTTT,5,1285093
furpa,10.5,90,7,TGTCGGTATCCAGACCGGAT,83,1271869
furpa,2.0,22,7,TGTAACACTCTCGTGAACAA,15,1323343
furpa,2.5,26,7,TGGTGGCCCCAGACGATGCA,19,1344418
furpa,2.0,22,7,TGGTAAATTACCTGTCACGT,15,1283206
furpa,4.75,44,7,TGGGTACGCGCTGCTCCGTG,37,1343356
furpa,0.375,9,7,TGGCGCTACTTTGTCGTCAA,2,1320208
furpa,6.0,54,7,TGGACTCGGCACAGTAAATA,47,1354565
furpa,2.25,24,7,TGGAAATGTTAATGAGAGGT,17,1309413
furpa,0.25,8,7,TGCCTTACGCTGTCATGAGA,1,1325427
furpa,0.75,12,7,TGCCGCATGATTTCCCCAAA,5,1277581
furpa,4.75,44,7,TGCAATTCTCTTTTTGATGC,37,1322524
furpa,2.375,25,7,TGATTGACCTCGCGCTCACC,18,1348835
furpa,0.875,13,7,TGATTCTTATACAAACTTGC,6,1293358
furpa,0.25,8,7,TGATCCAGATCTATATGCGA,1,1332457
furpa,0.625,11,7,TGAGATATACAAATCCTGGG,4,1301243
furpa,4.75,44,7,TGACCAAGGGCGCCTGTAGA,37,1328017
furpa,0.625,11,7,TGAACGGGATATATCCTGCT,4,1281271
furpa,5.625,51,7,TCTTGACCTCTGCGCATAGC,44,1278917
furpa,0.5,10,7,TCTGATGCAGCCTCAACCTC,3,1311570
furpa,6.0,54,7,TCTGAAGACAGTTCCTCATG,47,1344020
furpa,0.25,8,7,TCTCTCGTTTCATGATGCGA,1,1311174
furpa,0.25,8,7,TCTATCGGCTGCAGCTGGTA,1,1288183
furpa,0.875,13,7,TCGTTCATATAGATGGACGC,6,1290201
furpa,5.875,53,7,TCGTGCGGAGCTCTGCGGAC,46,1327934
furpa,0.375,9,7,TCGTATGACGGAATCCATGC,2,1293857
furpa,4.75,44,7,TCGGGCCGGTTCATCCAAGG,37,1355952
furpa,5.125,47,7,TCGGGCCGCTACACAAGGGA,40,1347343
furpa,0.25,8,7,TCGCAGCTAATCAAATACCA,1,1299460
furpa,3.875,37,7,TCGAGAACGTAGTAATCGGA,30,1274321
furpa,3.375,33,7,TCGAATTATCATATCGGCCA,26,1335692
furpa,1.125,15,7,TCCTAACGACGGTAGTCTTT,8,1309885
furpa,1.5,18,7,TCCCGGAGCACCTCCGCTGA,11,1341020
furpa,6.25,56,7,TCCCACCTCCCAGGGACGTA,49,1297730
furpa,1.5,18,7,TCCATTGGTCAGATCTGAAA,11,1322435
furpa,0.25,8,7,TCCAGAACTCGCGCCCAGAT,1,1307544
furpa,2.875,29,7,TCATACACCCAATAATACAT,22,1304867
furpa,0.5,10,7,TCAGGGTGCAGGTTCGGTTA,3,1288120
furpa,3.625,35,7,TCACTCCCTGTGCTCTCGTA,28,1338049
furpa,3.0,30,7,TCACATACCCAGTTCTTATT,23,1309123
furpa,3.25,32,7,TCAAAGGAGGTTCAACATGC,25,1324888
furpa,8.375,73,7,TATTTCACGCTGTTCATCTA,66,1279439
furpa,2.875,29,7,TATTGGGTGCGCTTAGATCG,22,1273301
furpa,1.75,20,7,TATTCGATCTTAGGATGACT,13,1279463
furpa,0.75,12,7,TATTACCGCAAAAAGCCCCT,5,1292722
furpa,2.375,25,7,TATGGTTACAGATCGAACAG,18,1351491
furpa,2.25,24,7,TATGCGGAGCACCGAATCGT,17,1346339
furpa,6.875,61,7,TATATGCAGATTATGGTAGA,54,1327710
furpa,11.875,101,7,TAGGACGGTTCCTAGTACCT,94,1325850
furpa,4.625,43,7,TAGCTTCCGTCTTACGATCG,36,1315622
furpa,0.25,8,7,TAGCCAGATAAGAACATACT,1,1273558
furpa,0.25,8,7,TAGACTCGTCCGGTCGCCAT,1,1323594
furpa,1.75,20,7,TACTGAGAGATAGAGTTGTT,13,1352173
furpa,10.625,91,7,TACGAATGACGAAAATGTGA,84,1340483
furpa,3.625,35,7,TACCTGAAAGAATGTGACCT,28,1286517
furpa,2.25,24,7,TACCATCGAGTTTCACCATA,17,1315586
furpa,17.25,144,7,TACACTGAAGGTAGGAAACG,137,1336602
furpa,6.25,56,7,TACAATCGCGTGAAAACGAT,49,1334826
furpa,1.75,20,7,TAACTTACGCAGCATAGTGT,13,1294019
furpa,0.25,8,7,TAACGGCACTAAGTGAAGAA,1,1318832
furpa,1.375,17,7,TAACGGACAGGGGCAGTCAA,10,1295149
furpa,1.875,21,7,TAACGCTAAGGACCTGCAGA,14,1341820
furpa,3.75,36,7,TAACAGTGATGATCCGATCG,29,1312424
furpa,0.875,13,7,TAAAGTCGGAATCGATCCAG,6,1313062
furpa,1.125,15,7,TAAAGGTACGGTGCCACGGC,8,1308126
furpa,2.5,26,7,TAAAGGGTCCGGTCGTCCTA,19,1329791
furpa,3.5,34,7,TAAAATCTAATGGGCCAGGA,27,1273425
furpa,1.125,15,7,GTTTGGTTGCGCTTCCCAGA,8,1274860
furpa,2.25,24,7,GTTTCCCTTTTGAGTTAGTG,17,1285186
furpa,2.625,27,7,GTTCCGAGGGGCGGAGCCCC,20,1277655
furpa,7.625,67,7,GTTCAGTCAGGCGGCAGCTC,60,1307181
furpa,6.125,55,7,GTTACTTGTTCGCTTAGATT,48,1324783
furpa,4.875,45,7,GTGTTTGACTTGCATATTTA,38,1323967
furpa,5.0,46,7,GTGTGCCCTGAACTACAGCA,39,1300814
furpa,13.0,110,7,GTGGGACGGTCCAGCTCCGC,103,1325067
furpa,2.625,27,7,GTGGCACGGATCCTCGTGGT,20,1310160
furpa,5.125,47,7,GTGGACGTGCGCATGGATCG,40,1322993
furpa,0.25,8,7,GTGATAGCCTGCATCAGGCC,1,1348469
furpa,6.625,59,7,GTCACGCGACCGAATCCTTA,52,1293521
furpa,2.375,25,7,GTCACGACTTACCTGCTATA,18,1279112
furpa,3.125,31,7,GTCAATGGGATGAAGTGGAC,24,1308770
furpa,1.0,14,7,GTATTTGACATCCTTCCGGT,7,1301081
furpa,0.25,8,7,GTATGGGAGCCACATGAAGC,1,1301103
furpa,4.375,41,7,GTATGGATAAAAATCTGCAA,34,1279118
furpa,1.75,20,7,GTATCACATAGTCCTTGTCT,13,1320530
furpa,2.375,25,7,GTAGTAACCTTCCCTGCCAA,18,1299718
furpa,0.75,12,7,GTAGGGAACGAGAAGGACAG,5,1285993
furpa,1.125,15,7,GTACTTGTGATATTGCATTT,8,1307591
furpa,3.0,30,7,GTACAGCATCTCCTATCTTA,23,1319038
furpa,6.0,54,7,GTAATGAGAGGGTGTAGACT,47,1327921
furpa,2.25,24,7,GGTTTTCGTACATTTCTCCA,17,1337010
furpa,0.25,8,7,GGTGATTAGCTTGGAGCAGC,1,1323441
furpa,3.5,34,7,GGTACCGGTAGGCATGGTGC,27,1295975
furpa,0.75,12,7,GGGTTTAGTCATGGGGCCGG,5,1323627
furpa,2.25,24,7,GGGTCTAGTTGCGCTTTGCC,17,1322690
furpa,1.875,21,7,GGGTAGAGATCGGGGATTTA,14,1303496
furpa,1.5,18,7,GGGGAGGTAGTCCTCCGGCA,11,1273293
furpa,4.75,44,7,GGGCAACCCCCTCTTAAAGA,37,1315471
furpa,2.125,23,7,GGGACTGAACGTTTATTGTA,16,1318393
furpa,0.75,12,7,GGCTAGTCAGTGTAAGGAAA,5,1338882
furpa,1.625,19,7,GGCATATGGAATGGAACAAC,12,1297294
furpa,0.625,11,7,GGATGCCGGAGCTTCTTGAT,4,1354503
furpa,1.25,16,7,GGAGTCGCGGTGCATACCTG,9,1326950
furpa,11.875,101,7,GGAGCTGGAGAGGGCATCTG,94,1322566
furpa,0.5,10,7,GCTTATTGATGCGTTAGCTG,3,1276829
furpa,6.25,56,7,GCTTAGGATCCGTGTGATAA,49,1339269
furpa,0.625,11,7,GCTGTTGCGCGGACTGGAGA,4,1281446
furpa,0.75,12,7,GCTCCCGTGCATGGTGGACA,5,1283314
furpa,1.25,16,7,GCTCCCCCTGAGATCAAATT,9,1325388
furpa,0.25,8,7,GCTCCATGGATAAATGCCAC,1,1297948
furpa,1.75,20,7,GCTAGGCTTCACAAGAGATT,13,1347733
furpa,3.25,32,7,GCGTGTCAGGGATCCCGAAC,25,1344306
furpa,3.5,34,7,GCGTCGTCCGTATATCCGTG,27,1288277
furpa,1.0,14,7,GCGTCCCGCGCCCGGGCCCA,7,1295905
furpa,0.75,12,7,GCGGGAGGACAACCCGTTTA,5,1315053
furpa,3.75,36,7,GCGGCCTCATTCAAGGTTCT,29,1307741
furpa,0.5,10,7,GCGGAAAGCTCCTACATAGT,3,1289206
furpa,0.625,11,7,GCGCGTATATTTACAGTACC,4,1331819
furpa,4.0,38,7,GCGCACCATTAATTGCGTGT,31,1273919
furpa,1.875,21,7,GCGAGATACTCAGGTCTTGT,14,1353388
furpa,13.75,116,7,GCCGTAGGGCCGTCATTTTC,109,1325837
furpa,3.375,33,7,GCCGGCAAGATGGTCTGTAC,26,1271822
furpa,2.75,28,7,GCCCACTACTCTGAACGTGT,21,1323908
furpa,1.0,14,7,GCCAGGTCGGCTTTGCTCCG,7,1341987
furpa,1.5,18,7,GCCAGCCATCGGGCATGCCT,11,1344321
furpa,1.125,15,7,GCATGCAATTCCAAAGCGTG,8,1352335
furpa,3.0,30,7,GCAGGTAGACAAGTAGAGTG,23,1308598
furpa,1.75,20,7,GCAGCTAGCTTAGGCGGTTT,13,1331933
furpa,3.0,30,7,GCAGCGTAATGGATACAGTT,23,1296235
furpa,6.0,54,7,GCACGATTACAGGTTGACAG,47,1315323
furpa,1.5,18,7,GATTGGGGTCGTGCTACGCT,11,1296338
furpa,2.375,25,7,GATTCGTAGATCTGAGGATG,18,1287092
furpa,3.0,30,7,GATCGAACCTTGCCGGAGGG,23,1292229
furpa,0.25,8,7,GATAACATTCAATGACGGCT,1,1272594
furpa,3.0,30,7,GATAAAGGACGTCACTATGT,23,1318053
furpa,1.375,17,7,GAGTAGTTGACTCCTCAATA,10,1271899
furpa,3.625,35,7,GAGGGCCGCCCCTATCGTAA,28,1319719
furpa,0.5,10,7,GAGGCGGGACAAATATTGTG,3,1299849
furpa,4.375,41,7,GAGGATATGGAAACCAAGCA,34,1340219
furpa,4.25,40,7,GAGCAGTACGGATGACACCT,33,1339470
furpa,2.375,25,7,GAGATGTAACGTTGAAGTCA,18,1349503
furpa,4.125,39,7,GAGAGTCACCCTGCGCGTTC,32,1334504
furpa,2.0,22,7,GAGACCGATGTTCTACAACA,15,1291020
furpa,0.375,9,7,GACTGCTTATGCTGCGGAAG,2,1334939
furpa,3.25,32,7,GACTCGGAGACAACCGTTCA,25,1272904
furpa,4.125,39,7,GACGTTACCGAACTATCGGA,32,1314425
furpa,0.25,8,7,GACCTGGGAAAGGGTAGTAA,1,1273184
furpa,0.25,8,7,GACCGGGCCAATCGTTAGGC,1,1286365
furpa,1.625,19,7,GACCCGCGTCGTCGCACGCA,12,1289403
furpa,4.375,41,7,GACAGCTCGAGGTCTTGCTT,34,1349666
furpa,0.75,12,7,GACAGATTATATTCCTTATG,5,1316110
furpa,4.25,40,7,GACACGGTCGGTATCGCTAA,33,1312936
furpa,0.25,8,7,GAAGGACATACATATGGGCT,1,1347469
furpa,0.75,12,7,GAAACGCGGCCCTCGAACCG,5,1339207
furpa,0.25,8,7,CTTTAGTGGGGGGGTTCAAC,1,1348094
furpa,0.5,10,7,CTTAAGCGTACCACTGCGAA,3,1272073
furpa,2.625,27,7,CTTAACTCTCAAAGAACTCT,20,1307928
furpa,5.0,46,7,CTGTACTCCTCATGTTGCGA,39,1309555
furpa,7.375,65,7,CTGAGGCGTCAAAGCAGTCA,58,1327374
furpa,5.625,51,7,CTGAAGATTGTCCTTGAGCC,44,1309910
furpa,16.375,137,7,CTGAACCAGTTCCATCGATG,130,1341018
furpa,0.75,12,7,CTCTTATGTTGACCTTATCA,5,1281018
furpa,7.125,63,7,CTCTGCTCCTCGAAAGTTTA,56,1320438
furpa,1.75,20,7,CTCTAGGGCAACATGAACAC,13,1312944
furpa,0.25,8,7,CTCGATCGAGCTGCCTCAGT,1,1303646
furpa,3.375,33,7,CTCGAGAACTACGGCGCGAT,26,1334686
furpa,1.5,18,7,CTCCTCCGTACGTAAACAGT,11,1346963
furpa,4.25,40,7,CTCCCTGCGCGTATGGACTT,33,1315450
furpa,1.625,19,7,CTCATAGTGTGATGGAAAGA,12,1285177
furpa,1.0,14,7,CTCACGGTGTCTTAGTTCGG,7,1331619
furpa,6.875,61,7,CTCACGCTAAGCTCTTAACA,54,1283116
furpa,8.5,74,7,CTATCTGAAATGAGTCCAGG,67,1280144
furpa,3.0,30,7,CTATCCCAAGTACTCACGTC,23,1339976
furpa,1.0,14,7,CTATATTCGAAAACGAAGGA,7,1339609
furpa,0.625,11,7,CTAGTTCGGATAAGCACGTG,4,1336265
furpa,6.25,56,7,CTAGACTCAGGCGCGGATGG,49,1317550
furpa,0.25,8,7,CTACTGGCACTCCTAAGCGC,1,1334157
furpa,0.875,13,7,CTAACGGAATGGATAGTCCA,6,1324587
furpa,7.375,65,7,CGTTTTCTCGCCAGCTTGTT,58,1312486
furpa,1.0,14,7,CGTGTGCATAATTACAGAGT,7,1354152
furpa,0.25,8,7,CGTGGGTTTAGGGGCTTTTT,1,1306915
furpa,2.5,26,7,CGTGCCTCCTACTGTGGGAG,19,1287653
furpa,0.75,12,7,CGTGCCGGCCAGCCTGGCCG,5,1322808
furpa,0.5,10,7,CGTCGTGTTGTCTGCAAGGA,3,1320506
furpa,2.5,26,7,CGTCCGTCCGGGCGAAGGCC,19,1293603
furpa,21.25,176,7,CGTCCACCTCCATGAGGCCA,169,1287435
furpa,0.25,8,7,CGTAGGCATGTAGACTACAT,1,1306910
furpa,1.125,15,7,CGGTTTTACCGTCTCAGATC,8,1316755
furpa,2.5,26,7,CGGTTCGCCTCAATAGACAG,19,1291309
furpa,0.375,9,7,CGGGTTGTATCTGTCATTCT,2,1297423
furpa,6.25,56,7,CGGCTGTGAGTTGGAACTCA,49,1273446
furpa,0.25,8,7,CGGAGGATCAATTTGTTGTC,1,1291211
furpa,0.25,8,7,CGGACAGAGTAGAGATGCTT,1,1273124
furpa,3.875,37,7,CGCTGACTATCCTTTCAAGT,30,1344505
furpa,3.0,30,7,CGCTCCTGAGCCAGGACTGT,23,1322396
furpa,0.875,13,7,CGCGGATTATCCGTTACGCC,6,1273373
furpa,0.25,8,7,CGCGCTATAGAGAGTAGAGT,1,1288762
furpa,3.875,37,7,CGCGCCCGCAAAATAGTGCT,30,1278318
furpa,0.25,8,7,CGCGATCTAGCGGTTCTCAG,1,1345254
furpa,4.125,39,7,CGCCCGTTTGCAGATTAGTA,32,1300228
furpa,8.125,71,7,CGATAGAGTACCGAGACATG,64,1308641
furpa,4.125,39,7,CGACTCAGCTAAACACCGTG,32,1312782
furpa,0.25,8,7,CGAACCGCTAAGCTGAACAG,1,1309072
furpa,1.25,16,7,CGAAACCTATGAGTCCAGGT,9,1321717
furpa,3.5,34,7,CCTTCGATATAGTCAGTCCA,27,1301150
furpa,0.25,8,7,CCTTCAAGCGTTCTCTTTCC,1,1287253
furpa,0.25,8,7,CCTGTAGGGTGTTTCCGTGA,1,1302003
furpa,0.25,8,7,CCTGGAGGGTGGTTTCCGCG,1,1339347
furpa,2.625,27,7,CCTCTAAGGGTTACGTGATC,20,1283117
furpa,0.875,13,7,CCTCGTCCGCCCATTAGCCA,6,1288388
furpa,5.375,49,7,CCTCCAAATCTCGCCAACAA,42,1322355
furpa,0.25,8,7,CCTATAATTGGCGAGGTACG,1,1345304
furpa,1.5,18,7,CCTAGCGGAATTTACGTTTT,11,1302523
furpa,2.375,25,7,CCGTCCGATTCTCTCTGGCT,18,1290418
furpa,0.25,8,7,CCGTCAAGGACCACCATAGG,1,1311073
furpa,0.625,11,7,CCGTATTTTACAAGTTACAT,4,1278356
furpa,1.25,16,7,CCGGGCATTCCCGGTTGCAG,9,1289150
furpa,2.25,24,7,CCGCTGCTATCAGGATAACC,17,1309410
furpa,0.25,8,7,CCGCTGACACGCACCCATGG,1,1335066
furpa,4.0,38,7,CCGCGTCGTATGTCAGCTGT,31,1295650
furpa,3.5,34,7,CCGAGCAAAGATCGGCAGGT,27,1278247
furpa,0.25,8,7,CCGAATATGATACCATGAAG,1,1271649
furpa,3.375,33,7,CCCTCATTTTGGGTTGGAAT,26,1339744
furpa,2.75,28,7,CCCGAATACCTGTTGGACTG,21,1346956
furpa,3.5,34,7,CCCCGTACTCTATAGCTAGG,27,1324411
furpa,4.625,43,7,CCCCGGGGGATAGGGCGGGA,36,1318667
furpa,2.25,24,7,CCATAATATAAAGGTTTCCA,17,1325152
furpa,0.375,9,7,CCAGCTTTTACCGTCAATAA,2,1295944
furpa,21.125,175,7,CCACCTTATAGCCGTTAGAA,168,1278323
furpa,0.375,9,7,CCAAACGACGGAATTCCTGT,2,1338597
furpa,0.5,10,7,CATTCAATGTATGTCCTATC,3,1310476
furpa,2.125,23,7,CATGGACATGCCTTAATGAT,16,1313765
furpa,14.0,118,7,CATATTAAGGTTAGTGCCGA,111,1291317
furpa,2.625,27,7,CATAGGGAAGGGGTATCTAA,20,1334461
furpa,2.375,25,7,CAGTTATTGTCTGCCCAAAC,18,1306865
furpa,0.625,11,7,CAGTCAGGGCGTTGAAACAC,4,1298671
furpa,2.25,24,7,CAGGTGGAGGAGTACTAAGT,17,1329259
furpa,3.625,35,7,CAGGGTAGGGCTCAAAGTCC,28,1288993
furpa,8.375,73,7,CAGGAGTACATAGGGTTGGT,66,1338474
furpa,6.0,54,7,CACTCCTGGATAACTGGAAC,47,1354332
furpa,11.0,94,7,CACTCACCAAATGTCTGGAT,87,1271872
furpa,2.75,28,7,CACGGCCATCATCATTTTTC,21,1328155
furpa,1.375,17,7,CACGATGCGTCCACATTGTC,10,1335899
furpa,2.0,22,7,CACGAGATGGCGGCCATGGC,15,1296345
furpa,2.125,23,7,CACCAAAAACAATAGGTTCA,16,1332849
furpa,2.875,29,7,CACAGTATTTGATCCTACAC,22,1296118
furpa,0.25,8,7,CACAAGTGAACCGTCCCTGC,1,1297396
furpa,0.25,8,7,CACAAGAATGGCATAAATCA,1,1279907
furpa,0.25,8,7,CAATGACGAGGGTTTACAAC,1,1327527
furpa,7.875,69,7,CAATCACGGTCGTTGCGATT,62,1328287
furpa,0.375,9,7,CAAGTAAGGCAAGGCGTTAG,2,1299353
furpa,0.25,8,7,CAAGCACATGGTTTGTTCTT,1,1306497
furpa,5.125,47,7,CAAGACACTGTGTTCGAGCC,40,1328179
furpa,1.125,15,7,CAACGGCGCGTTGGTTGGGA,8,1300279
furpa,3.0,30,7,CAACGCTTTTATGAGGACGT,23,1301999
furpa,4.5,42,7,CAACGATTAGATCTAAACAT,35,1301319
furpa,2.5,26,7,CAACATGCGATGTCAACCAC,19,1327459
furpa,4.125,39,7,CAAACGCTAGCATACCCATA,32,1319578
furpa,1.625,19,7,CAAACATCTACGTACTTTCT,12,1312940
furpa,8.625,75,7,CAAACAACAACCGAAACCTA,68,1328262
furpa,6.75,60,7,CAAAACCGAGGTCTCAATTA,53,1341944
furpa,0.25,8,7,ATTTTATGCCCGTGAGGTGA,1,1290775
furpa,0.875,13,7,ATTTCTAGGTCAATATACGG,6,1275508
furpa,4.25,40,7,ATTTCCAATGTTTAGGACCT,33,1279080
furpa,1.125,15,7,ATTTCAGGCTATTAATATCG,8,1311446
furpa,1.625,19,7,ATTCGGAACTAACAGAGATT,12,1287581
furpa,2.375,25,7,ATTCCGCTGATGTACGAGGA,18,1310892
furpa,0.75,12,7,ATTAGCTGAATGCTAAACAA,5,1323412
furpa,1.25,16,7,ATTAATTTATACGTCGTCCT,9,1330521
furpa,2.375,25,7,ATTAATCCGTGGCACCGGCA,18,1281940
furpa,0.875,13,7,ATTAAGGTGACTGCCATTAA,6,1339132
furpa,0.5,10,7,ATGTGAACCAGGTGTGTTTG,3,1287188
furpa,6.5,58,7,ATGTCTTGTGACCAGGCCGG,51,1356675
furpa,0.625,11,7,ATGTCCTGGGAGGATGCTCT,4,1287750
furpa,0.5,10,7,ATGGGCAAGTATATTTTACT,3,1327349
furpa,0.625,11,7,ATGGAGCATGAGATTGTTGC,4,1335792
furpa,6.625,59,7,ATGCGGGTCTGCCATTCATG,52,1326427
furpa,1.375,17,7,ATGCCAATTGACGAAGCGCT,10,1306536
furpa,2.5,26,7,ATGATTGGCATGCCCGGTAC,19,1357352
furpa,0.5,10,7,ATGATAAAGCTTGGATTTGG,3,1284208
furpa,7.625,67,7,ATGAGCTGCTACCGCGGTAT,60,1289304
furpa,6.5,58,7,ATCTGTGCTCCCCCAACAGG,51,1297134
furpa,4.0,38,7,ATCTGCGACACCCGCGAATA,31,1328175
furpa,3.25,32,7,ATCGAACACGTTACCGACTT,25,1305824
furpa,6.625,59,7,ATCCTAGATTTTATTTACGC,52,1325836
furpa,1.375,17,7,ATCACTGGAATGCAGCGAAG,10,1288493
furpa,0.25,8,7,ATCAATTATTATTCAAAACC,1,1317438
furpa,0.25,8,7,ATAGTCTGGACCGCTTACTT,1,1294339
furpa,1.875,21,7,ATACCCGTAGAATAATTGCA,14,1287101
furpa,1.0,14,7,AGTTCGCGGGACCAGCCAGG,7,1321989
furpa,0.25,8,7,AGTTAGACCAGTCAATCAAT,1,1335797
furpa,0.25,8,7,AGTGGCTAATAGTGGTAAGC,1,1325758
furpa,4.25,40,7,AGTGAATTTCGGAGATGGAT,33,1336259
furpa,1.625,19,7,AGTATTGAGCAAGGAAACGA,12,1317698
furpa,0.5,10,7,AGTACGACACAGCGTGCCTG,3,1311363
furpa,0.25,8,7,AGTAAGCGGCATAGAGTAGG,1,1315262
furpa,1.5,18,7,AGTAACCCTAGCACAAACCT,11,1345333
furpa,3.125,31,7,AGGCTTTAGCGCTACTCGGA,24,1283055
furpa,2.375,25,7,AGGCGAATCACTGTATGTGA,18,1276687
furpa,0.25,8,7,AGGACCTAACACTACCTCGA,1,1288814
furpa,1.0,14,7,AGCTATACGATCGGAACCGA,7,1313705
furpa,5.875,53,7,AGCGGTGGGGAGGAAGGACG,46,1324592
furpa,0.625,11,7,AGCGGGGCGTTGCCGAAAGG,4,1302456
furpa,4.875,45,7,AGCAGGCAGGACGCCCATCT,38,1292044
furpa,2.625,27,7,AGCAACTCTACTAAGCTGGC,20,1344797
furpa,0.375,9,7,AGATTTTAAGTCTGGATAAT,2,1289822
furpa,1.375,17,7,AGATACCTTCTGTTGTGAGC,10,1296366
furpa,0.5,10,7,AGAGTTCGCACACCGTTCCT,3,1328243
furpa,0.875,13,7,AGAGTCCTGGTAACCTGTGC,6,1319343
furpa,1.25,16,7,AGAGGTGCCTCTCGAGTTTC,9,1296587
furpa,3.125,31,7,AGAGCGGGCCAAGACCTTGT,24,1271393
furpa,0.25,8,7,AGAGACTATTTGTAATAACA,1,1305696
furpa,10.0,86,7,AGACGGATCACACAAGGGTA,79,1334050
furpa,2.75,28,7,AGACATACCTTACTCTCCAA,21,1328498
furpa,7.125,63,7,AGAAGTAGTAGGAAAGCCCG,56,1328250
furpa,8.375,73,7,ACTGGGCTAGGACTCAAGCA,66,1316532
furpa,1.125,15,7,ACTCCAGTTTATACGGTGAC,8,1327437
furpa,0.375,9,7,ACGGTGGCCCTGTGCGGGAG,2,1272552
furpa,0.375,9,7,ACGGGCTTAGATCTGCAATC,2,1332843
furpa,1.875,21,7,ACGGCCTCGGTTAGCAAGTA,14,1331499
furpa,7.375,65,7,ACGGAGAGGAAAAAACCGTG,58,1346234
furpa,1.625,19,7,ACGATCAACCTCGTGGGCTC,12,1330991
furpa,2.875,29,7,ACGAATCGTACTTAGTAACG,22,1307134
furpa,1.375,17,7,ACGAATAAGATTAGAAATGC,10,1350454
furpa,1.75,20,7,ACCTGAATGTATCAACTCGC,13,1352041
furpa,0.375,9,7,ACCGGAATTCGCGGCCCGGG,2,1299981
furpa,4.75,44,7,ACCAACCTTGGATCACGGGA,37,1354633
furpa,0.875,13,7,ACATGTGCGTGAGTGCCCGC,6,1325726
furpa,5.25,48,7,ACATGCACCTGGGCTTGGGT,41,1318958
furpa,0.25,8,7,ACATCCCCCGAGTGTCCAGG,1,1327385
furpa,0.625,11,7,ACATCCAGTGGTGAGTGCGA,4,1309475
furpa,2.625,27,7,ACATAGGCCGCCTAGCAACG,20,1309415
furpa,7.75,68,7,ACAGCTATCGTTCATGTCTA,61,1285090
furpa,3.125,31,7,ACAGCGAGCATTCAAATGAG,24,1282190
furpa,15.75,132,7,ACACAGGTTAATGCTCGGGA,125,1355124
furpa,3.0,30,7,AATTTACGATTCCGGACTAA,23,1281170
furpa,3.75,36,7,AATTGGGGGAGTAACATATG,29,1300074
furpa,0.375,9,7,AATTGCCACAATATTTAGCT,2,1319559
furpa,8.5,74,7,AATGATATGATCAGTCTTAT,67,1297522
furpa,7.25,64,7,AATGACTTCCGCTTTATTTT,57,1285236
furpa,0.875,13,7,AATCGGTATCCGTCCTAGCA,6,1273430
furpa,0.625,11,7,AATAAAACGCCACTATAACT,4,1284139
furpa,3.625,35,7,AAGTTCTCTGGGTTTTCTGA,28,1338048
furpa,2.625,27,7,AAGCAGAGGCTCACAGGTGA,20,1287371
furpa,1.0,14,7,AACTAAGTCGATCTTACCAT,7,1333986
furpa,1.25,16,7,AACGGACATCCCGGGCTTCC,9,1285744
furpa,7.0,62,7,AACCGGCGAAATGATGCCTT,55,1325064
furpa,2.25,24,7,AACATTCGCGCGTGGCCCAC,17,1355648
furpa,3.75,36,7,AACAGTGTCTGGGCCGCCCC,29,1276840
furpa,4.375,41,7,AACAGCAGGTCAAATAGGAA,34,1291278
furpa,0.25,8,7,AAATCGGCGTACTCGGGGTG,1,1349251
furpa,0.25,8,7,AAATATAATCGGCTTCGATT,1,1340911
furpa,0.25,8,7,AAAGTTCAACTTCGGCATGT,1,1298019
furpa,0.5,10,7,AAAGCCACGGGTTGAAGATT,3,1309537
furpa,3.75,36,7,AAAGCAGTGATCCCGATCGT,29,1284217
furpa,1.5,18,7,AAACCTGTCTCGATGCTAAA,11,1301956
furpa,0.25,8,7,AAACCAACCCTGCCTCCCAG,1,1277402
furpa,0.2857142857142857,7,6,TTTTAATGCGGTGGGTGCAT,1,1299730
furpa,0.2857142857142857,7,6,TTTCACTCGACCCACGGCAT,1,1342994
furpa,0.42857142857142855,8,6,TTTATATATGGGTTATTAAC,2,1315445
furpa,5.428571428571429,43,6,TTTAAGTTCCTCCTGACGTG,37,1306697
furpa,0.42857142857142855,8,6,TTGTTACCCGTGTTCGCGCA,2,1324521
furpa,0.7142857142857143,10,6,TTGTAACAAATTGTCCTAAA,4,1314815
furpa,10.571428571428571,79,6,TTGGGGACCAACCGTCGATG,73,1316403
furpa,3.2857142857142856,28,6,TTGCCTGTCGAGGAAGACGG,22,1330767
furpa,2.2857142857142856,21,6,TTGAGGCACCTCAAACTGGC,15,1333331
furpa,0.5714285714285714,9,6,TTGACAAGCGACATCGAAGT,3,1319693
furpa,1.7142857142857142,17,6,TTCTTTCGCTACGGGTAGGC,11,1338272
furpa,0.7142857142857143,10,6,TTCTCCCGAGAGGGACGGCC,4,1304081
furpa,1.1428571428571428,13,6,TTCCGGTCGTTGATAGGTAT,7,1295499
furpa,0.2857142857142857,7,6,TTCCCCTTTGGTTTAACTTA,1,1273920
furpa,0.2857142857142857,7,6,TTATTAAAACCCTCGTCGTA,1,1329864
furpa,1.0,12,6,TTAGGGGGCGCCAGGGAATT,6,1303592
furpa,0.8571428571428571,11,6,TTAGGGATTTGCAATGATTT,5,1276686
furpa,0.7142857142857143,10,6,TTAGGGAGGTCTATACGAAG,4,1351203
furpa,0.42857142857142855,8,6,TTAGCCTGAGGCGTCTGACT,2,1274414
furpa,3.857142857142857,32,6,TTACGTTCTGGTAATGCTTG,26,1288451
furpa,0.2857142857142857,7,6,TTACGGTTTGAGATTCGCGG,1,1298001
furpa,6.0,47,6,TTACCACCGCAGGAGTTCCC,41,1306407
furpa,1.1428571428571428,13,6,TTAATCTCCAAAGGCGCTGC,7,1301048
furpa,0.5714285714285714,9,6,TGTTGTCTAAACGACGGCGA,3,1289233
furpa,0.5714285714285714,9,6,TGTTGACTGAGAAATTTCCC,3,1316060
furpa,3.5714285714285716,30,6,TGTTCAGATGCCCCGACGCG,24,1278771
furpa,8.857142857142858,67,6,TGTGGACGTACCAGGCGGCT,61,1311627
furpa,6.142857142857143,48,6,TGTCGATCGTTTATCCGTTC,42,1297090
furpa,23.857142857142858,172,6,TGTCCGACCCCCCTGAGTGC,166,1344242
furpa,3.4285714285714284,29,6,TGGTGCTGAAATAGCAGCTC,23,1339615
furpa,1.2857142857142858,14,6,TGGTCCGTGTTCTTATTGTA,8,1271412
furpa,2.0,19,6,TGGGTAATGTAATCGCATCA,13,1333115
furpa,0.2857142857142857,7,6,TGGGGATTGAGCCACTATGT,1,1318654
furpa,4.857142857142857,39,6,TGGCTCGGGACTGACCGTGG,33,1344016
furpa,0.42857142857142855,8,6,TGGCCTCTTGCTATTCAAAT,2,1283496
furpa,1.2857142857142858,14,6,TGGCCTCACGTGCGGCTACG,8,1281078
furpa,3.2857142857142856,28,6,TGGCCCATTAGTTTGTTACA,22,1321072
furpa,2.2857142857142856,21,6,TGGATTCCACTTAAAATAAA,15,1325223
furpa,0.8571428571428571,11,6,TGGATGTGGTTTCGTACAAT,5,1293944
furpa,2.5714285714285716,23,6,TGGATCCGTTTAACGGAGGA,17,1304383
furpa,9.285714285714286,70,6,TGGACCCGGAGTGTTCCCGG,64,1323916
furpa,3.2857142857142856,28,6,TGGACACGATTGGGATCGCA,22,1335199
furpa,4.857142857142857,39,6,TGCTAATGTGCCCCCGAGCT,33,1354376
furpa,1.4285714285714286,15,6,TGCTAAGGTTGAAGCGGATA,9,1296461
furpa,1.8571428571428572,18,6,TGCGGCTCGTAAGCCCTATA,12,1274195
furpa,3.2857142857142856,28,6,TGCATTTACGAGTTCAGGAC,22,1316373
furpa,0.42857142857142855,8,6,TGCAAGACACTAACAGAAAA,2,1278428
furpa,1.2857142857142858,14,6,TGCAAAAGGTGATGGACTCC,8,1281878
furpa,2.5714285714285716,23,6,TGAAACACTTTGGCCTTCCA,17,1313893
furpa,4.0,33,6,TCTGTCAATAAGTACGAAAA,27,1328818
furpa,0.42857142857142855,8,6,TCTGATTGATCCATACGGCA,2,1272106
furpa,1.1428571428571428,13,6,TCTCAGACGGTATCAAAAGT,7,1347837
furpa,0.2857142857142857,7,6,TCGTTACAGGCGTCTTACTT,1,1339763
furpa,4.428571428571429,36,6,TCGTGTCTTGGCTTCATTGC,30,1347197
furpa,0.2857142857142857,7,6,TCGTGAAAAGAAACATCAGA,1,1335026
furpa,10.142857142857142,76,6,TCGGCACACTCTTATGTCAC,70,1298475
furpa,5.714285714285714,45,6,TCGGAGTAATGGCTCTAACA,39,1278410
furpa,0.42857142857142855,8,6,TCGAGGGGGGAAGCAGCGAA,2,1299291
furpa,1.5714285714285714,16,6,TCGAACAGCCTCGGTAATAC,10,1296550
furpa,2.857142857142857,25,6,TCCTTTGGCCACGCAATGTA,19,1309028
furpa,4.571428571428571,37,6,TCCGGTTTGCTCTTACGATT,31,1312173
furpa,4.285714285714286,35,6,TCCCTAGAGCAGGTGAATCG,29,1302340
furpa,0.42857142857142855,8,6,TCCCCTAGTCGGAGCCCGGA,2,1296232
furpa,10.571428571428571,79,6,TCCCACGGAGAAGAATTGGG,73,1281534
furpa,2.4285714285714284,22,6,TCATGGTGCCCATGCTTATA,16,1315244
furpa,2.7142857142857144,24,6,TCATCTAAAGCAAACCGCGA,18,1276670
furpa,3.142857142857143,27,6,TCATAGTCATGTTCCACGGT,21,1344014
furpa,1.5714285714285714,16,6,TCAGCTCGCTACCGTTGAGT,10,1306601
furpa,1.8571428571428572,18,6,TCACCATCCGGGAGTTTGGA,12,1274284
furpa,3.142857142857143,27,6,TCAACGAGAAGGGTCCACCC,21,1336953
furpa,3.7142857142857144,31,6,TCAAAAGCTCTGGCTACCAA,25,1295056
furpa,5.285714285714286,42,6,TATCTTGACCACAGCATACA,36,1328349
furpa,5.428571428571429,43,6,TATCGAACCTAGCACGGTAC,37,1283232
furpa,3.0,26,6,TATAGTGACCCCCCGGATTA,20,1298620
furpa,0.2857142857142857,7,6,TAGTTCTTGTTAATATAGAT,1,1279452
furpa,0.2857142857142857,7,6,TAGGAAAGGACAGACCCGTA,1,1303054
furpa,2.857142857142857,25,6,TAGCTCAGCACGCAGGATTA,19,1311205
furpa,1.7142857142857142,17,6,TAGACACTTTAGGATTGATG,11,1356742
furpa,1.5714285714285714,16,6,TACGTGCCTGCCCTTCCGGC,10,1327801
furpa,8.571428571428571,65,6,TACGGTACACTCAAGGTGGA,59,1343401
furpa,8.714285714285714,66,6,TACGCGCAAGGGTCTGCGGT,60,1272193
furpa,0.2857142857142857,7,6,TACCACCTCTTACGTCCGTT,1,1280378
furpa,3.142857142857143,27,6,TAATGAAGAATCGAACCCGT,21,1307639
furpa,0.7142857142857143,10,6,TAAATTGATACCAAGCCGAG,4,1289488
furpa,0.2857142857142857,7,6,TAAATACAGATTCAATCTCG,1,1305305
furpa,5.142857142857143,41,6,TAAACTCAGATGATGGAGTC,35,1355913
furpa,1.5714285714285714,16,6,GTTTGAGTCTTCCATGACGT,10,1347188
furpa,8.714285714285714,66,6,GTTTACTAGCGTCAACCTGT,60,1278411
furpa,1.1428571428571428,13,6,GTTTACGGTGGCATACGTCA,7,1298158
furpa,1.2857142857142858,14,6,GTTGAGGGGGGATAACCTGA,8,1352466
furpa,3.5714285714285716,30,6,GTTCTCACGACACTATCACC,24,1304466
furpa,3.142857142857143,27,6,GTTCCGTGGCAAACCGTCCT,21,1356490
furpa,0.2857142857142857,7,6,GTTAGTGGGCCGAGGCTTTC,1,1337759
furpa,0.2857142857142857,7,6,GTTAAAAGACATGTCAGGTC,1,1344922
furpa,4.714285714285714,38,6,GTGTTGCCGCAACTATTTAT,32,1313327
furpa,0.5714285714285714,9,6,GTGTGGGAGTAACTTACTTA,3,1328393
furpa,5.142857142857143,41,6,GTGTGCTACGGGGGTGGTGA,35,1278956
furpa,2.0,19,6,GTGGTCCCTGTAGGAACCGA,13,1299223
furpa,11.285714285714286,84,6,GTGGGGTTTTTTGGACACCT,78,1284811
furpa,0.2857142857142857,7,6,GTGGAAGCGCATCAGTTAAG,1,1271930
furpa,7.714285714285714,59,6,GTGCTTATAGGTACAGCCCC,53,1295041
furpa,4.857142857142857,39,6,GTGCTAATACATCTCCTTCG,33,1319312
furpa,0.8571428571428571,11,6,GTCGCAACAGTGAATTGGGA,5,1283570
furpa,1.5714285714285714,16,6,GTCCTATAAGGGAAGGGATT,10,1313209
furpa,1.8571428571428572,18,6,GTCCGTGATAAGAATGCTTC,12,1320495
furpa,1.1428571428571428,13,6,GTCCGCTGCCTTGGGAACGT,7,1291755
furpa,7.428571428571429,57,6,GTCCCCCCTAGGATGACAGG,51,1285378
furpa,2.142857142857143,20,6,GTCCCAAGTGTGGGTTTTGG,14,1295156
furpa,3.2857142857142856,28,6,GTAACTTACCCAGTTTGCTA,22,1294258
furpa,2.2857142857142856,21,6,GGTTGCAGTTGGTTATCTCA,15,1308810
furpa,1.8571428571428572,18,6,GGTTAAGACGGATCAGGAAG,12,1356601
furpa,0.5714285714285714,9,6,GGTGCGGCGATTCCGATCAA,3,1307601
furpa,0.5714285714285714,9,6,GGTGCCTAATTCAGTCATGA,3,1328823
furpa,2.7142857142857144,24,6,GGTGCCACCGCGGTTCTTGG,18,1336232
furpa,2.0,19,6,GGTCGCACCTGGGCCTAGAA,13,1345534
furpa,5.0,40,6,GGGTTTGTTCATTTAAGCCA,34,1315726
furpa,0.7142857142857143,10,6,GGGTCAAGCGGTAAGATTGT,4,1303893
furpa,2.7142857142857144,24,6,GGGGTAAATAAGTAATTTAC,18,1301034
furpa,0.42857142857142855,8,6,GGGGTAAACAATGTCGCTTG,2,1351389
furpa,4.857142857142857,39,6,GGGGGCGTAGTGAACACGAG,33,1313722
furpa,0.2857142857142857,7,6,GGGCGTGTTCCTAGAATGAG,1,1294551
furpa,0.2857142857142857,7,6,GGGCACTCAATCTTTGGACT,1,1282930
furpa,2.142857142857143,20,6,GGGATGGGCGGCAAGTATTC,14,1291819
furpa,2.857142857142857,25,6,GGGAAGGTGTAATACAGCGA,19,1281289
furpa,0.5714285714285714,9,6,GGGAACGTACATCACCACGG,3,1339464
furpa,0.2857142857142857,7,6,GGCTGAGAGCACCTCATTGC,1,1354647
furpa,0.2857142857142857,7,6,GGCGAGCGGAACCTAACGTT,1,1273192
furpa,4.714285714285714,38,6,GGCCCTATTATCTGGCGATG,32,1339104
furpa,6.714285714285714,52,6,GGCAGTGGCAAGATACGTTT,46,1291592
furpa,0.2857142857142857,7,6,GGCAAAAAAAGAAACCACCC,1,1315000
furpa,2.0,19,6,GGATGAACCTGTACCTCTCC,13,1320500
furpa,4.0,33,6,GGATCGTCACGTGAAATAAA,27,1275721
furpa,4.285714285714286,35,6,GGATAGAAGGGAACCAGTAG,29,1278602
furpa,4.142857142857143,34,6,GGAGGGTTGGGCTTGGTTAT,28,1287404
furpa,0.7142857142857143,10,6,GGAGGACACTAGGATCGAAA,4,1298279
furpa,7.285714285714286,56,6,GGACTGCTCCTGGATAGGTA,50,1309158
furpa,1.2857142857142858,14,6,GGACTGACTGATGGGACTTT,8,1301375
furpa,12.428571428571429,92,6,GGACGGTCACGGCGTCTTGA,86,1303863
furpa,0.2857142857142857,7,6,GGACGACGTTACGTTCGAGT,1,1271533
furpa,0.2857142857142857,7,6,GCTTCCTTGTGGGGCCTGCT,1,1320124
furpa,0.2857142857142857,7,6,GCTGTAAGTTTTAAATGACA,1,1292022
furpa,2.5714285714285716,23,6,GCTGCTCCAAGGCTCATAGA,17,1349656
furpa,3.0,26,6,GCTGATCCGGAGAGATTCAG,20,1311950
furpa,0.7142857142857143,10,6,GCTAAGATGGCCATAGCAGA,4,1351733
furpa,0.5714285714285714,9,6,GCTAAAGAGTCTGCGCATCT,3,1329304
furpa,3.0,26,6,GCGTGCGGGAAGGAGTGCCG,20,1295367
furpa,1.1428571428571428,13,6,GCGTCGAGCCCCAATGGATC,7,1311364
furpa,5.571428571428571,44,6,GCGTCATGGTGAAATATGCT,38,1350599
furpa,0.42857142857142855,8,6,GCGCCGGGTTTAGCAGCGGG,2,1320511
furpa,1.5714285714285714,16,6,GCCTGCGTATGACGTTCCAG,10,1284564
furpa,0.2857142857142857,7,6,GCCGGTCTAGGGGACGACCA,1,1291811
furpa,21.142857142857142,153,6,GCCGATGGTTAGTCTCACAG,147,1285408
furpa,3.0,26,6,GCCGAGCGTGACTAAGATAT,20,1304850
furpa,11.428571428571429,85,6,GCCCTGATCGGAAGTAGCCC,79,1334047
furpa,1.1428571428571428,13,6,GCCCCTTCGGGGCGAACACA,7,1322637
furpa,0.2857142857142857,7,6,GCCCACGACTTGTCTGGGGT,1,1276287
furpa,0.2857142857142857,7,6,GCCAGGTAAGGCCGCCAAAA,1,1278987
furpa,2.857142857142857,25,6,GCACTCCATTCTAGAATTGC,19,1305629
furpa,3.5714285714285716,30,6,GCAATTCCTAGACCAGATCT,24,1351957
furpa,0.42857142857142855,8,6,GATTTTCCACGTGGTGCACT,2,1288915
furpa,2.0,19,6,GATGTTAACGATGGAGAATA,13,1302448
furpa,0.5714285714285714,9,6,GATGAGGATCTGGTAACGAA,3,1287167
furpa,0.42857142857142855,8,6,GATCTCTGCCTTTCACCATG,2,1312971
furpa,0.2857142857142857,7,6,GAGTTATTGTTAGGGCGAGG,1,1357162
furpa,16.571428571428573,121,6,GAGGGGCATGGCAGGGTCTG,115,1354320
furpa,0.2857142857142857,7,6,GAGGGCATTTCTATGCTCTT,1,1324080
furpa,17.857142857142858,130,6,GAGCTCAGACGTGCAGAAAT,124,1281913
furpa,1.0,12,6,GACTGCCCGCCACGTTTATT,6,1294448
furpa,2.4285714285714284,22,6,GACTGATCATAAAATGACTC,16,1329931
furpa,3.0,26,6,GACTATCCGTAAACTGCCGT,20,1311436
furpa,5.285714285714286,42,6,GACGAGAATTTGGACGGTAT,36,1290782
furpa,0.2857142857142857,7,6,GACCTGGTGTGCTCCTGCAG,1,1325376
furpa,6.142857142857143,48,6,GACCTGGACAAAACCTCACA,42,1293575
furpa,2.4285714285714284,22,6,GACAGGTCTGATTCGGGGCG,16,1271782
furpa,1.1428571428571428,13,6,GACACGGTATGGACAAAGAT,7,1331972
furpa,0.42857142857142855,8,6,GAATTTAACGCCGGTTCAAA,2,1357049
furpa,4.857142857142857,39,6,GAATCGAGGGCTTTTGTTCC,33,1338779
furpa,6.0,47,6,GAATATAGCCAGCCGATCTG,41,1340314
furpa,0.2857142857142857,7,6,GAAAGTGTCACGGCCAGAAC,1,1347374
furpa,2.5714285714285716,23,6,CTTTGTCTTTCGACGTCTAT,17,1272212
furpa,5.142857142857143,41,6,CTTGTATCATCGTGCTTTCT,35,1300953
furpa,2.142857142857143,20,6,CTTGGGGGGTAACGTCATTT,14,1330060
furpa,4.142857142857143,34,6,CTTGACTCAGGCTCAAATTG,28,1331980
furpa,0.2857142857142857,7,6,CTTCGATACGATCCAGCGGT,1,1320901
furpa,0.2857142857142857,7,6,CTTATTTATCGTCGCAAGGG,1,1337605
furpa,6.714285714285714,52,6,CTTACACCGTTTCCGAGTAC,46,1278777
furpa,0.8571428571428571,11,6,CTTAATCTGTCCGGCTTGAC,5,1304549
furpa,3.0,26,6,CTGTGAGGGGAAGGTCAGAG,20,1355234
furpa,3.0,26,6,CTGTATCGAAATAGCCCCCT,20,1281323
furpa,1.8571428571428572,18,6,CTGCCGGTCCACACACCTGC,12,1297425
furpa,0.8571428571428571,11,6,CTGCAGCACATCTCCCGTGT,5,1274573
furpa,1.4285714285714286,15,6,CTGATCAGGTTCGGGAGGTT,9,1346078
furpa,10.428571428571429,78,6,CTCTAACCCTGTCATTTGGC,72,1276696
furpa,1.0,12,6,CTCGAATTTGTTGTCGATTA,6,1326202
furpa,2.4285714285714284,22,6,CTCCTGCAAGTCTAAGTCTT,16,1314218
furpa,1.0,12,6,CTCCGCTAGAACAGCCGAGG,6,1328624
furpa,6.714285714285714,52,6,CTCCCGAAAACGAGGCCAAG,46,1279325
furpa,8.714285714285714,66,6,CTCCACCATATCGCTTCCAA,60,1332079
furpa,0.2857142857142857,7,6,CTCCAAGCTCCTAAGGTCTT,1,1283566
furpa,8.571428571428571,65,6,CTATTCCGCTGAGAATCATG,59,1306764
furpa,1.7142857142857142,17,6,CTATGTCGCTGGTTGTCCCT,11,1348699
furpa,1.0,12,6,CTATGGCCACGATCATTTAT,6,1332902
furpa,10.428571428571429,78,6,CTATCGGATTGTGCTTGTCT,72,1345730
furpa,7.857142857142857,60,6,CTAGGCCGTAGTGAATAAGC,54,1283161
furpa,8.0,61,6,CTACGTGGAAAGTACCGGTA,55,1306965
furpa,2.5714285714285716,23,6,CTACCCAATACTGGCGGGAT,17,1297089
furpa,0.5714285714285714,9,6,CTACATTGGGGCGGAAGATG,3,1354820
furpa,2.4285714285714284,22,6,CTAATATGTCAGTTAGCTTA,16,1333899
furpa,6.285714285714286,49,6,CTAAGGCGCCTGCTTTTTGC,43,1318455
furpa,2.857142857142857,25,6,CTAAAATATCGCGCGGAAGA,19,1356072
furpa,0.8571428571428571,11,6,CGTTTCCGGAATAGAGTTAG,5,1336774
furpa,2.0,19,6,CGTGGCGCCCATTGACCAGT,13,1301842
furpa,9.857142857142858,74,6,CGTCATTTTCGGCCACGGGA,68,1303383
furpa,1.0,12,6,CGTAGATGCGGTATATCCGG,6,1334367
furpa,1.2857142857142858,14,6,CGGGCTCCTAAGTCTGCTTT,8,1313702
furpa,1.8571428571428572,18,6,CGGGAATATAAACTTGTTAG,12,1313078
furpa,6.857142857142857,53,6,CGGATTGAACGCAACTTACA,47,1357510
furpa,1.4285714285714286,15,6,CGGAGTTACTTGGACTCTTG,9,1351593
furpa,6.142857142857143,48,6,CGCTGTAGAACGCTGAATCG,42,1286818
furpa,4.571428571428571,37,6,CGCTGATTTGATTAACTTCG,31,1294486
furpa,2.0,19,6,CGCGTAGATTCGGTAAACAG,13,1276732
furpa,1.0,12,6,CGCGGGCTGCCCGCGTATGA,6,1284203
furpa,4.285714285714286,35,6,CGCGGAGTTAATGGTAATGC,29,1277223
furpa,0.5714285714285714,9,6,CGCAGAGGTGTGCGGCGGGA,3,1351074
furpa,1.1428571428571428,13,6,CGCAAGTCTTATAATCGGCG,7,1330135
furpa,0.2857142857142857,7,6,CGATATCGCATGCGGCAGGC,1,1276539
furpa,1.1428571428571428,13,6,CGATAGAGTCAAATGAGACT,7,1279512
furpa,5.285714285714286,42,6,CGATAATCGCCCGTCTTGTG,36,1330051
furpa,2.0,19,6,CGAGTGGTCTTTAACGAAAT,13,1324768
furpa,17.0,124,6,CGAGTCCGCAGTGGCAAACT,118,1318740
furpa,6.142857142857143,48,6,CGAGGAACGTTGTCACCTCG,42,1353310
furpa,0.2857142857142857,7,6,CGACACGGTTCTGATTACTC,1,1317869
furpa,0.2857142857142857,7,6,CGAATGTGCTGCAATGCAAT,1,1287446
furpa,3.2857142857142856,28,6,CGAACCCGGGACTTGAACAT,22,1274545
furpa,2.4285714285714284,22,6,CCTTACGTGCATTTTCTACT,16,1322992
furpa,2.4285714285714284,22,6,CCTGTGACGTGTCCAGGGTT,16,1280235
furpa,4.142857142857143,34,6,CCTGATTCACCGTGTGCGCT,28,1296459
furpa,5.428571428571429,43,6,CCTATGGCGCTCGATTTGGA,37,1301328
furpa,3.5714285714285716,30,6,CCTAGGGCATGTGCGTCCCC,24,1346461
furpa,4.0,33,6,CCGTTAATGGATCTATTATA,27,1328333
furpa,5.0,40,6,CCGGACTTATGGGTTACACA,34,1346658
furpa,0.2857142857142857,7,6,CCGCTTTACGGGAGGCATCA,1,1345297
furpa,7.428571428571429,57,6,CCGCTGGGACCGGAAGAGAT,51,1302878
furpa,3.7142857142857144,31,6,CCGCATAGCTACGGAGTTAT,25,1283775
furpa,5.714285714285714,45,6,CCGAGCTGGTAAGTACTGGA,39,1320704
furpa,0.8571428571428571,11,6,CCGAGATGTCGGAAAGCGGC,5,1278418
furpa,0.2857142857142857,7,6,CCGACATCCCGCATCACTGT,1,1297902
furpa,4.714285714285714,38,6,CCGAAACGCCGTATTTAACG,32,1282149
furpa,0.8571428571428571,11,6,CCCTTGGTCTACGACACCTG,5,1301072
furpa,5.428571428571429,43,6,CCCTTGAGAAGGCGAAAACG,37,1353181
furpa,1.8571428571428572,18,6,CCCTCCTGCATGAGGCCACT,12,1349832
furpa,6.0,47,6,CCCGTGCTTCTAAGCCGAGC,41,1314290
furpa,5.285714285714286,42,6,CCCGCGACGAGATTCCTTTT,36,1284191
furpa,4.285714285714286,35,6,CCCCCTTAACCCAACAGGAT,29,1343935
furpa,4.285714285714286,35,6,CCATGGACAAGGGTGTTTGA,29,1324932
furpa,8.571428571428571,65,6,CCATAAAAGGGATTCATGTG,59,1306621
furpa,5.571428571428571,44,6,CCAGTTTTTGTCTGCTGCCC,38,1271340
furpa,8.857142857142858,67,6,CCACTTCGACCCGAAAACAC,61,1345294
furpa,0.2857142857142857,7,6,CCACTTACAAATCTTGACGA,1,1279281
furpa,25.0,180,6,CCACTCAGAACTGGACCGGA,174,1327379
furpa,0.2857142857142857,7,6,CCACGTTCTGCGGGATGTCT,1,1317166
furpa,0.42857142857142855,8,6,CCACCCGTAATCGCAAAGAT,2,1279674
furpa,4.857142857142857,39,6,CCAAGGCAGGCGCGAAACAA,33,1336396
furpa,3.142857142857143,27,6,CATTTGTTTGCGTACATAAT,21,1290092
furpa,26.571428571428573,191,6,CATTCGCTCTTGCTTTAGGA,185,1288245
furpa,0.5714285714285714,9,6,CATTATAGGCCTTGCATACA,3,1325239
furpa,3.7142857142857144,31,6,CATGCTCTGGGCTCCCATTA,25,1293682
furpa,5.857142857142857,46,6,CATGAACATGGTGCGTGACT,40,1340193
furpa,4.428571428571429,36,6,CATGAAAACAGCACGTAAAT,30,1341325
furpa,2.0,19,6,CATCCAGATCTCATCTAGGT,13,1295688
furpa,5.142857142857143,41,6,CATCCACAGAAATGGGGACT,35,1288097
furpa,1.7142857142857142,17,6,CATAACAAATGGTGCCAGTA,11,1311926
furpa,2.4285714285714284,22,6,CAGTTACTCCTCCGTAATTA,16,1315723
furpa,1.1428571428571428,13,6,CAGTAGCCCGGAGCCCAAAA,7,1303182
furpa,6.428571428571429,50,6,CAGGCACCTTAGCACGTCTA,44,1275708
furpa,0.7142857142857143,10,6,CAGCGCACGGAATGTGTAGA,4,1351388
furpa,12.0,89,6,CAGCCCGCGACGAGGTTTAA,83,1292667
furpa,6.428571428571429,50,6,CAGAGGTCCCCACTCTGAAA,44,1273043
furpa,3.0,26,6,CAGACTAGGGCCACGATATG,20,1279938
furpa,1.2857142857142858,14,6,CAGACAGGTTGCTAGCGTAT,8,1324172
furpa,6.0,47,6,CAGAAGCCGGCCACGGGTGG,41,1351251
furpa,2.857142857142857,25,6,CAGAAAGAAGCACAACCCTA,19,1291991
furpa,6.857142857142857,53,6,CACGAGTCTAGAGGTGCAGT,47,1300218
furpa,2.5714285714285716,23,6,CACCCTCTTAGCGCCGTACG,17,1284971
furpa,4.0,33,6,CACAGGGTTCAACAACAATG,27,1302090
furpa,9.571428571428571,72,6,CACAAGCGTTTTTACCGTCT,66,1283222
furpa,1.8571428571428572,18,6,CAATCTCGTGAAGTTGTTGC,12,1320337
furpa,2.4285714285714284,22,6,CAATCGAGTGACCGGTGGTT,16,1348786
furpa,0.42857142857142855,8,6,CAAGGCCGGTTCGATAGACA,2,1299468
furpa,1.4285714285714286,15,6,CAACATCGTCGTTATTCCCT,9,1321507
furpa,6.142857142857143,48,6,CAAATTTCTGTTCTGACCTA,42,1340216
furpa,5.857142857142857,46,6,CAAAGTCCATGGAAACACGC,40,1296850
furpa,0.8571428571428571,11,6,CAAAGACGCAGTTGGGGGCG,5,1302823
furpa,3.0,26,6,ATTTTTCCACAGAAAGGAGA,20,1290267
furpa,0.2857142857142857,7,6,ATTTGATTACAGGCCGGGGC,1,1341236
furpa,0.2857142857142857,7,6,ATTGTGGCGTACGTTTTGCC,1,1304437
furpa,8.714285714285714,66,6,ATTCGAGGACCGTCCGATTT,60,1281063
furpa,0.2857142857142857,7,6,ATTCCCGCTGCGTTTAGTGA,1,1350862
furpa,1.2857142857142858,14,6,ATTACATGTTACTCGACGTG,8,1328575
furpa,0.8571428571428571,11,6,ATGTTTAGTCATCACCTACG,5,1321863
furpa,2.4285714285714284,22,6,ATGTTCCGACATTCGCATGC,16,1341998
furpa,4.285714285714286,35,6,ATGTTATGGAAGGGCGTACC,29,1272797
furpa,1.1428571428571428,13,6,ATGTATGGCTACATGCCTCG,7,1282365
furpa,5.714285714285714,45,6,ATGGTGCATGTAGAGTGGTA,39,1309896
furpa,0.5714285714285714,9,6,ATGCATGGAAGTCTCAAACG,3,1300894
furpa,2.142857142857143,20,6,ATGCAGGAGGCTTCGAAAGC,14,1352593
furpa,2.0,19,6,ATGAGAAAAGAGGAAATACG,13,1309274
furpa,6.571428571428571,51,6,ATCTGCGCTCCTATATTACG,45,1284331
furpa,0.7142857142857143,10,6,ATCTCACGGAGGTGCGGGAT,4,1328461
furpa,2.142857142857143,20,6,ATCGGTTTGGCCGGTTTCCT,14,1327617
furpa,7.142857142857143,55,6,ATCGCCCGACGTCCAATGGA,49,1289715
furpa,3.7142857142857144,31,6,ATCCGGTGATCCGTGTTATA,25,1355432
furpa,4.714285714285714,38,6,ATCAGCCTGGTATAAGTCGC,32,1312357
furpa,0.2857142857142857,7,6,ATATGGTAACGGAATTCTCC,1,1322289
furpa,4.857142857142857,39,6,ATATGGCGCGCGGCGCGTGA,33,1274431
furpa,1.4285714285714286,15,6,ATATCCAGCTCGTTACGCTT,9,1334068
furpa,1.1428571428571428,13,6,ATAGTGTCAATACAAGGCCC,7,1342548
furpa,2.0,19,6,ATACGCCAAATACAAAAGTA,13,1280501
furpa,2.0,19,6,ATAACTCAGGTCAATTCGGG,13,1274323
furpa,2.0,19,6,AGTTGTGCTGTGTTGATGTT,13,1312722
furpa,0.2857142857142857,7,6,AGTTCGGAGGCATCGTGGAC,1,1329161
furpa,3.5714285714285716,30,6,AGTTCGGACTATAGTCTCCC,24,1291875
furpa,2.857142857142857,25,6,AGTGTTCCGTGCAGGCCACG,19,1329109
furpa,2.4285714285714284,22,6,AGTGCTATGAGTCCCGGTTT,16,1311229
furpa,4.142857142857143,34,6,AGTCGCAACATGTACAATCT,28,1343226
furpa,4.0,33,6,AGGTCGTTAGGGCACATTCT,27,1328618
furpa,22.571428571428573,163,6,AGGGACCTCGGGATTACCTC,157,1346095
furpa,0.2857142857142857,7,6,AGGCCGGGGCTGTTAGAGCA,1,1354911
furpa,0.2857142857142857,7,6,AGGAGGCTGCCGTTGGTTCG,1,1275924
furpa,2.142857142857143,20,6,AGCGGCTTCCATACTAGAGG,14,1314391
furpa,0.7142857142857143,10,6,AGCCCGAAAATGTAAATTCC,4,1300990
furpa,0.42857142857142855,8,6,AGCATTGAGATTTTGACTTT,2,1342120
furpa,1.8571428571428572,18,6,AGATCCCCGTTTTCAGTTAC,12,1300593
furpa,4.428571428571429,36,6,AGATCAATAAATAACACTCA,30,1316395
furpa,7.714285714285714,59,6,AGAAATACTACGCTAAGAAC,53,1304296
furpa,1.0,12,6,ACTTTTGATAGGCCAAAGAT,6,1356856
furpa,8.428571428571429,64,6,ACTTTGAAAAGAATGAACTT,58,1327401
furpa,1.2857142857142858,14,6,ACTGGAAGGGGCGCTTCGGA,8,1338085
furpa,5.428571428571429,43,6,ACGTTTAGGGCGCCGAGTGT,37,1285399
furpa,0.5714285714285714,9,6,ACGTTAAACCAAACATCGAC,3,1309334
furpa,1.1428571428571428,13,6,ACGTGGAAAGAGCCATGTGG,7,1353058
furpa,0.2857142857142857,7,6,ACGTCCGTTTCAGTAGGGAT,1,1344050
furpa,3.2857142857142856,28,6,ACGGTGCTCCTGATCGTTGG,22,1298093
furpa,2.142857142857143,20,6,ACGCGGTTGTTTATGGGCAA,14,1324716
furpa,5.857142857142857,46,6,ACGCACTGATTGTCTTGTAC,40,1318106
furpa,0.2857142857142857,7,6,ACCTGGGAAGTCAGGGTATG,1,1329758
furpa,1.5714285714285714,16,6,ACCTGAGTATGGACTGGTTC,10,1278793
furpa,5.571428571428571,44,6,ACCGTCCTCGGTCTTCTAAT,38,1272923
furpa,3.5714285714285716,30,6,ACCGCTGGGCTGACCCCACC,24,1338695
furpa,1.7142857142857142,17,6,ACCGATTGGGCACGTCTCGT,11,1271719
furpa,1.2857142857142858,14,6,ACCAGCTGTCCCCCATGATG,8,1299429
furpa,5.285714285714286,42,6,ACCAACTAAAGGCCAGGCGT,36,1351777
furpa,6.714285714285714,52,6,ACATCCGTTATCATTCCGTC,46,1273751
furpa,5.857142857142857,46,6,ACAGTGCGCTATTATAGCCA,40,1328366
furpa,0.42857142857142855,8,6,ACACATTGCGACAGTACCCA,2,1309891
furpa,1.1428571428571428,13,6,ACACAGTCTAGCTCATTACC,7,1287442
furpa,4.142857142857143,34,6,AATGGGGATTTTCGGGTCTG,28,1290781
furpa,1.5714285714285714,16,6,AATGGATTGGACACGTCCGT,10,1312372
furpa,0.2857142857142857,7,6,AATCATCGGAAAGAAACAAA,1,1339196
furpa,0.2857142857142857,7,6,AATATGCGGGCTCCAGTGGA,1,1323858
furpa,24.428571428571427,176,6,AAGTGAGCGTATCAGGCGCG,170,1285639
furpa,0.2857142857142857,7,6,AAGTCTCACGGTAGGGAATA,1,1334051
furpa,9.857142857142858,74,6,AAGTCGGAAACAGGCGTATC,68,1353745
furpa,10.571428571428571,79,6,AAGTCGCGTCGGCATCTTGT,73,1332824
furpa,7.571428571428571,58,6,AAGTCACTGCGGACGTCAGC,52,1303313
furpa,5.428571428571429,43,6,AAGTAAGGTAAACCGACCTC,37,1315516
furpa,0.2857142857142857,7,6,AAGAGAACCGTCGAAGCGGC,1,1276314
furpa,0.2857142857142857,7,6,AAGACCCGAAGCTGCTTATT,1,1353466
furpa,5.0,40,6,AACTTTCCTTGTGGAAAAAT,34,1284674
furpa,3.4285714285714284,29,6,AACTAGAGCCTTTTTAACTG,23,1319023
furpa,0.5714285714285714,9,6,AACACGAGCGGTCTAGGCAA,3,1325898
furpa,5.571428571428571,44,6,AAAGTGGCAGAGGGGTATCG,38,1295627
furpa,5.857142857142857,46,6,AAAGTAAACCACTCCTATCC,40,1282872
furpa,8.142857142857142,62,6,AAACCCGATCCGTTCCCAGC,56,1286520
furpa,0.42857142857142855,8,6,AAAAGAAAAGGTGATCGAAA,2,1336753
furpa,4.857142857142857,39,6,AAAACTCCATTCAATCCCAG,33,1356311
furpa,5.142857142857143,41,6,AAAAATTATCTCGTTCAATG,35,1295309
furpa,2.3333333333333335,18,5,TTTGCGTGAATAGCACTACA,13,1352167
furpa,1.1666666666666667,11,5,TTGTTAAGTATTCGCCGCGC,6,1280058
furpa,1.0,10,5,TTGCACTCCGTCTTTAATAA,5,1292282
furpa,1.5,13,5,TTGACTTAAGTACGAAGACG,8,1279056
furpa,4.333333333333333,30,5,TTGACGTCACCGGTAAGGTA,25,1333674
furpa,10.666666666666666,68,5,TTGACGGAGACTATCCATAG,63,1283230
furpa,1.8333333333333333,15,5,TTCTGAGGAGTCTTGGGGGT,10,1323941
furpa,0.8333333333333334,9,5,TTCTCTTTGCATGTTATTTG,4,1306814
furpa,52.333333333333336,318,5,TTCGGAGGAGCCCTAACCGG,313,1336064
furpa,0.3333333333333333,6,5,TTCGCCCTCATTCCGGTTCT,1,1288272
furpa,4.0,28,5,TTCCTATCCTGTCAGCTCCT,23,1282532
furpa,16.5,103,5,TTCATACCTGCGTGTTATGT,98,1296349
furpa,9.333333333333334,60,5,TTCAGTCTATCAAAGTCATC,55,1310162
furpa,9.0,58,5,TTATAATGCAAGTGATCACC,53,1311815
furpa,2.3333333333333335,18,5,TTAGTTTGCCGAATCATGGG,13,1300518
furpa,4.5,31,5,TTAGGTCTCCGCTCAGGGTC,26,1288308
furpa,0.5,7,5,TTACCGTGTTTCTGTGGTAG,2,1308280
furpa,4.166666666666667,29,5,TTAAATTTATGACACGGGTT,24,1271339
furpa,5.666666666666667,38,5,TGTTCTCCGCTACACTTCTC,33,1289185
furpa,0.3333333333333333,6,5,TGTTATCTATGAATTTGAAA,1,1288725
furpa,6.166666666666667,41,5,TGTGTTTATTCCGACTGGAG,36,1347536
furpa,6.666666666666667,44,5,TGTCGGGTGGATTGGAACTA,39,1291190
furpa,6.5,43,5,TGTCACTAACAATTGCGTCC,38,1297631
furpa,10.666666666666666,68,5,TGTACAGGGCTATTTAGGGT,63,1272609
furpa,0.3333333333333333,6,5,TGGTGGCATACAGTCGCTTT,1,1294231
furpa,7.5,49,5,TGGTACGCTCCGACGTTTCC,44,1289491
furpa,0.5,7,5,TGGTACCGGAGTCCGTAGCC,2,1325737
furpa,0.6666666666666666,8,5,TGGCTGTTAACAGATTCCGG,3,1288530
furpa,3.3333333333333335,24,5,TGGCGGCGGTGGATACCCCA,19,1287628
furpa,5.666666666666667,38,5,TGGCATGAACGTGCACCACA,33,1325963
furpa,0.3333333333333333,6,5,TGGATGTTTAGGTCGTCAAC,1,1318614
furpa,8.666666666666666,56,5,TGGAGGATCCTCGCCGACGC,51,1282147
furpa,7.833333333333333,51,5,TGCTTTCCGGGGGGACTCTC,46,1345789
furpa,1.5,13,5,TGCTTCCGTGCAACGAACTC,8,1288538
furpa,1.3333333333333333,12,5,TGCGTCTAAGTCGTCCTTAT,7,1335791
furpa,3.6666666666666665,26,5,TGCGGGGAGAGCGAGTTTTT,21,1282909
furpa,0.8333333333333334,9,5,TGCGCACCAGGCCAATCAGC,4,1356423
furpa,1.6666666666666667,14,5,TGCCTTTGTGCAGTTTCGCG,9,1317543
furpa,2.5,19,5,TGCCTAGGATGATGAAAGTG,14,1302192
furpa,0.5,7,5,TGCCGCCTCATAATTTTCTC,2,1288913
furpa,0.5,7,5,TGCCCAGATCAGTTCACGTA,2,1288834
furpa,7.333333333333333,48,5,TGCCAAACAGGTAGGGGACG,43,1319698
furpa,6.833333333333333,45,5,TGCAGTGAGTGCGAAGTGGA,40,1293784
furpa,22.833333333333332,141,5,TGATAGATGGTGCCACACTA,136,1302461
furpa,0.3333333333333333,6,5,TGAGGCTTAGGACATCTCAG,1,1271354
furpa,35.166666666666664,215,5,TGAGGCCGGACCCGGATTTA,210,1327408
furpa,1.1666666666666667,11,5,TGAATGCTAGGATTTGACTC,6,1348278
furpa,9.5,61,5,TGAAGCGCCGGCCACCATAC,56,1302022
furpa,3.3333333333333335,24,5,TCTGACAAAAGGCGGGATCA,19,1326560
furpa,10.0,64,5,TCTCACACTTTTGGACCGCC,59,1276357
furpa,9.0,58,5,TCTACCAGCGTTGAGATTAC,53,1285389
furpa,7.166666666666667,47,5,TCGTCATGTGGACGTTCCTG,42,1283676
furpa,1.1666666666666667,11,5,TCGTAGGCACCAATCAAGGT,6,1307996
furpa,10.666666666666666,68,5,TCGGTTTAACCAATTTTGCA,63,1307921
furpa,1.8333333333333333,15,5,TCGGGTAGAAAAGTCATGTT,10,1296903
furpa,6.833333333333333,45,5,TCGGACTGCCATCAATCCAC,40,1290573
furpa,3.3333333333333335,24,5,TCGCTCTAAAAAATGCGAGT,19,1304997
furpa,1.8333333333333333,15,5,TCCTCAAAGGACGTTTGTTA,10,1343820
furpa,3.0,22,5,TCCGTCCCGCTCTCATGACT,17,1310049
furpa,10.333333333333334,66,5,TCCGCCTTGGATCCTCGGGG,61,1296361
furpa,0.3333333333333333,6,5,TCCATGCAGCTATTCAAGGG,1,1286500
furpa,9.166666666666666,59,5,TCCACACTGGCGTAGTAACT,54,1320325
furpa,2.5,19,5,TCATTGGTATAGGCACAACA,14,1342251
furpa,2.0,16,5,TCATGCGTGTGGCCCCATCT,11,1352103
furpa,1.3333333333333333,12,5,TCACAGGGGCTCGTGGGTTA,7,1314034
furpa,4.666666666666667,32,5,TCAAGGCGCAATGTTAAGGT,27,1327802
furpa,0.5,7,5,TCAACCTTAGTGGCTTAGTA,2,1331846
furpa,6.833333333333333,45,5,TATTTCCAACTTGGTGTGGG,40,1310115
furpa,2.3333333333333335,18,5,TATGTTGCGTCCCCAGCTCG,13,1330881
furpa,1.8333333333333333,15,5,TATGTCTTTCGTTTTAAAGA,10,1282941
furpa,3.3333333333333335,24,5,TATGGGTAACAACAGTAAGA,19,1304916
furpa,0.3333333333333333,6,5,TATCGCAAGTTGGGTTCCAG,1,1306223
furpa,1.6666666666666667,14,5,TATATAAGAAGCCGGGCCGA,9,1293373
furpa,0.5,7,5,TAGGTCTGCCTATATCAATA,2,1315961
furpa,2.1666666666666665,17,5,TAGCGTCATATTCGGTAGGA,12,1332485
furpa,0.3333333333333333,6,5,TAGCGGAGTCGTCACCTGCT,1,1339629
furpa,2.0,16,5,TAGAGGTTAAGTTGTAGTTC,11,1344199
furpa,0.3333333333333333,6,5,TACTTGAGATCTCGTGAAGG,1,1308481
furpa,0.3333333333333333,6,5,TACGCGCGACTGCATCATAA,1,1288533
furpa,8.333333333333334,54,5,TACCCTACAGAGTAGCAACC,49,1281083
furpa,6.0,40,5,TACAAGCCGCAAACAATGTG,35,1353023
furpa,1.8333333333333333,15,5,TAATCTCGGTACGTGTGCAT,10,1287498
furpa,1.1666666666666667,11,5,TAATCGAAAAGAGTCAGCAG,6,1323366
furpa,5.5,37,5,TAATAGACTACCATTCTTAG,32,1320191
furpa,0.3333333333333333,6,5,TAACTGGGAGCAGAGCGTAC,1,1299108
furpa,5.0,34,5,TAACACTCATTACCTTCACC,29,1344966
furpa,9.833333333333334,63,5,TAACACGTGAAGAGTTCGAC,58,1341239
furpa,2.1666666666666665,17,5,GTTGGCCGGAGAGGAACTAC,12,1345953
furpa,5.666666666666667,38,5,GTTGCCTCAACAAAGCAGAA,33,1333372
furpa,5.333333333333333,36,5,GTTCATTCCCCTATTGCTAT,31,1300237
furpa,2.6666666666666665,20,5,GTTAGAAAAAGCAGGCTTTT,15,1339613
furpa,3.5,25,5,GTGGTGTCATGGGCCGATCA,20,1320015
furpa,9.166666666666666,59,5,GTGGTCAAGCCGTCCAATAC,54,1319479
furpa,3.1666666666666665,23,5,GTGCCTCCAAATCGGGAATG,18,1336281
furpa,0.3333333333333333,6,5,GTGAGGAAGCTCCAGTGTAG,1,1313993
furpa,47.666666666666664,290,5,GTCTGGGTTTACAAGGGTCA,285,1333624
furpa,4.166666666666667,29,5,GTCTACGGCAGGAAGGCTCA,24,1278779
furpa,2.6666666666666665,20,5,GTCTACAGAGACCACGGAAC,15,1326504
furpa,4.5,31,5,GTCGTCCCGTATCTATGAAG,26,1285416
furpa,2.6666666666666665,20,5,GTCGTAAGGCATACTCGTCC,15,1294146
furpa,19.166666666666668,119,5,GTCCTGGCCCCACTTGCAGT,114,1353583
furpa,1.5,13,5,GTCCTGCCCCACAATGGGAC,8,1294136
furpa,4.5,31,5,GTCCTAGGTCTCTACATTCC,26,1279543
furpa,0.3333333333333333,6,5,GTCCCTCTACAGGTTTGGAA,1,1294328
furpa,1.6666666666666667,14,5,GTCCCCGCTAAGCTGTTCCT,9,1291883
furpa,1.0,10,5,GTCAGAAGAGAGACGGCAGG,5,1279299
furpa,0.3333333333333333,6,5,GTATGGTTTTCGCGGAATAT,1,1322876
furpa,4.333333333333333,30,5,GTAGAGCTCCATTGTTCGGG,25,1283810
furpa,32.833333333333336,201,5,GTAGACTTTTGTACGAGACA,196,1288406
furpa,4.5,31,5,GTACTCGTCTGCCACCGGAC,26,1302450
furpa,1.8333333333333333,15,5,GTACTATATGGTGGGTATTC,10,1350642
furpa,0.3333333333333333,6,5,GTAAGAAGGCTTGTCCTTTG,1,1321335
furpa,2.8333333333333335,21,5,GTAAAGCCGGGGAGGGGATA,16,1341604
furpa,13.666666666666666,86,5,GTAAAGAACGCTTCGGCAAG,81,1315560
furpa,1.5,13,5,GGTGCACCTCGTCTGTTAAG,8,1277856
furpa,4.166666666666667,29,5,GGTGAAGAGCATCGAGTACT,24,1295000
furpa,2.6666666666666665,20,5,GGTCTCTTGGTCCGTCTAGG,15,1312637
furpa,2.0,16,5,GGTAGAGCTCCAATCATTGA,11,1291609
furpa,0.5,7,5,GGTACGTAAAAGGACATTCC,2,1277490
furpa,0.5,7,5,GGGTTCTGCGCCAAATCATC,2,1295615
furpa,3.0,22,5,GGGTAATTCTAAATGGGATA,17,1330754
furpa,1.3333333333333333,12,5,GGGGGGTCCATCTAGCATGG,7,1275016
furpa,1.1666666666666667,11,5,GGGGGGATGCTCGTAACGGT,6,1315553
furpa,5.5,37,5,GGGCTACCGCTAACCCAAGA,32,1351380
furpa,6.333333333333333,42,5,GGCGTGTACGGGGTGGAACG,37,1326058
furpa,3.5,25,5,GGCGAGCGACATACCTTCAC,20,1326325
furpa,8.833333333333334,57,5,GGCCCCCAGCAAGAGTCCCA,52,1351196
furpa,0.3333333333333333,6,5,GGCAGGTGGAAAGGTATGCA,1,1272501
furpa,0.6666666666666666,8,5,GGCAGATGGTATACGGGGAT,3,1309143
furpa,4.166666666666667,29,5,GGCACGGCAATTTTCATGTG,24,1281506
furpa,7.0,46,5,GGACAGGTAGCACAGTGGTT,41,1279955
furpa,0.3333333333333333,6,5,GGACAGAGCGGAGGCAGGGA,1,1346707
furpa,18.833333333333332,117,5,GGAAGAGGCTCTAGGTCGTA,112,1347339
furpa,3.0,22,5,GCTTCATGATGCAACTCAGC,17,1357508
furpa,3.1666666666666665,23,5,GCTATGCTGCCACTTACACT,18,1318476
furpa,2.0,16,5,GCGTTGTTGAAGTCCAATCT,11,1301993
furpa,4.833333333333333,33,5,GCGGGCACGAGACAGGGAAG,28,1353619
furpa,0.3333333333333333,6,5,GCCGGCTCTGAGCTCATCAG,1,1276981
furpa,3.0,22,5,GCCGAACTCCCAAGGCACAT,17,1355917
furpa,0.8333333333333334,9,5,GCCCGGAAACGTCTCTTCCT,4,1306556
furpa,7.166666666666667,47,5,GCCACTCTCGCGAGAGTCAC,42,1310706
furpa,3.1666666666666665,23,5,GCATGCATCGTCTCCTTTTT,18,1292285
furpa,3.1666666666666665,23,5,GCAGGACGGAAGGTCCCACT,18,1347331
furpa,2.1666666666666665,17,5,GCACCGTGCGGCTTAATATC,12,1356527
furpa,3.1666666666666665,23,5,GCACCGGTTCCTCCGTAGGT,18,1300168
furpa,8.666666666666666,56,5,GATTTGCAGAGTCGCGATTA,51,1291803
furpa,0.3333333333333333,6,5,GATGGAAGAGTCCGGATAGG,1,1301858
furpa,6.333333333333333,42,5,GATGCAAGACCGTGGGCTGG,37,1318768
furpa,0.5,7,5,GATAGTTAAGGCGTCTACTG,2,1328049
furpa,5.0,34,5,GAGTCAGGCGGGCGATACAC,29,1295336
furpa,4.166666666666667,29,5,GAGTAGCGTATCTCGGTTTG,24,1308895
furpa,4.5,31,5,GAGGCGTGCTACCGGCCATA,26,1344348
furpa,3.0,22,5,GAGGAGGGTATTGCTTCGAT,17,1324356
furpa,2.1666666666666665,17,5,GAGGACCGGTGTTGAATGGA,12,1299522
furpa,0.3333333333333333,6,5,GAGCGTCATGGTCCGTATTA,1,1353386
furpa,6.5,43,5,GAGCCCTGCGAAGTATGGAT,38,1342366
furpa,0.3333333333333333,6,5,GAGCCCCCCCCTATGCACTA,1,1276880
furpa,0.3333333333333333,6,5,GAGCAGATTCTCTATGGGTG,1,1314116
furpa,0.3333333333333333,6,5,GACTCGCCAAAGGCTATCAA,1,1294414
furpa,0.5,7,5,GACAGAGGACGTTGTCGGTA,2,1347796
furpa,2.8333333333333335,21,5,GAATAGGTCTCCTGGGCCAT,16,1356478
furpa,0.6666666666666666,8,5,GAACTGAGGGCAGTGCTCAA,3,1336218
furpa,6.333333333333333,42,5,GAACGGTTCCGTACCTTTAG,37,1343207
furpa,19.0,118,5,CTTTTGGGTATGGCGCCGAG,113,1306718
furpa,13.0,82,5,CTTTCCACAATCACTGGGAT,77,1350410
furpa,2.6666666666666665,20,5,CTTTAATGGGGTCCATAGAG,15,1336065
furpa,9.333333333333334,60,5,CTTGTAATTGCCAAGAACAT,55,1347355
furpa,1.8333333333333333,15,5,CTTGGGGTCGGTCAGCTCGT,10,1348300
furpa,0.5,7,5,CTTGACCGAGGGTGGGTCAC,2,1275523
furpa,8.166666666666666,53,5,CTTCGATGTGCTGTAGACCT,48,1324722
furpa,3.6666666666666665,26,5,CTTCACTGGACTGCATGTAT,21,1357109
furpa,0.3333333333333333,6,5,CTTATTAGGCGTCGTTATTC,1,1284258
furpa,21.5,133,5,CTGTCACTCTTGTCCCCTAA,128,1336097
furpa,0.3333333333333333,6,5,CTGGTAAAGTGCTCCGCCTC,1,1287160
furpa,6.333333333333333,42,5,CTGGGACTCGACTTCGTCAG,37,1286298
furpa,6.5,43,5,CTGGCTCAATGCTTTCAGCA,38,1317202
furpa,2.1666666666666665,17,5,CTGCGGATGAGTTTCAGGGA,12,1281791
furpa,5.333333333333333,36,5,CTGCCGTGCACGTAACTGCG,31,1356535
furpa,3.6666666666666665,26,5,CTGATGAGAGTCGAGGATTT,21,1351065
furpa,3.5,25,5,CTCTAATAGAATTAGGCATC,20,1348975
furpa,5.333333333333333,36,5,CTCGTCATCCCGGCGGAGCA,31,1308700
furpa,5.0,34,5,CTCGGATGTACACATTATCA,29,1278419
furpa,0.3333333333333333,6,5,CTCGACCAGGTCGGCGGGAG,1,1311277
furpa,3.1666666666666665,23,5,CTCCCCAGCTAGGACACCCG,18,1297059
furpa,0.3333333333333333,6,5,CTCATCAGGCTAATCGCGAG,1,1344146
furpa,1.0,10,5,CTCAGGCCCCAAGCGTCTTG,5,1290157
furpa,22.333333333333332,138,5,CTATTTCATCGGCGTCCCGC,133,1326488
furpa,0.3333333333333333,6,5,CTATTAGGTCATTAGATAGC,1,1347240
furpa,3.5,25,5,CTATCCTTCCGACCGAGCCC,20,1325484
furpa,1.6666666666666667,14,5,CTATCAAGCCTTTGACGATT,9,1307740
furpa,39.166666666666664,239,5,CTATCAAATTCTTTTAGTAC,234,1327922
furpa,1.5,13,5,CTAGTCTCTTGGGTGCCGGC,8,1295455
furpa,10.0,64,5,CTAGAGAGGGAAGAGTCTCG,59,1275938
furpa,7.666666666666667,50,5,CGTTCCCGAGTGCGTACTCA,45,1279492
furpa,3.5,25,5,CGTTCAGATCGTGATGCCAC,20,1304909
furpa,1.8333333333333333,15,5,CGTGGTTTCATTGGAATCGT,10,1315504
furpa,5.833333333333333,39,5,CGTGGCGGACCAACATAATA,34,1281880
furpa,1.3333333333333333,12,5,CGTGCCTTGGTAGGCCCTGT,7,1347774
furpa,5.833333333333333,39,5,CGTAGTTATCTGCGCCTCCA,34,1345295
furpa,0.3333333333333333,6,5,CGTAATGACTCCTGCTAAAC,1,1353331
furpa,4.5,31,5,CGGGTGTGCTTGGCGCTACA,26,1335992
furpa,3.0,22,5,CGGGTAGGGATACGCGGTCC,17,1338914
furpa,0.6666666666666666,8,5,CGGGGGAGGCTCGAAATAAG,3,1308273
furpa,0.8333333333333334,9,5,CGGGCATATGTGGTTTGGGA,4,1309181
furpa,2.5,19,5,CGGGCAGCATCAAACAGTTA,14,1343675
furpa,2.3333333333333335,18,5,CGGCGCCTGGTATCATAACT,13,1352901
furpa,6.333333333333333,42,5,CGGAGGTTATGGGTGTGCGA,37,1336910
furpa,5.166666666666667,35,5,CGCGTGGTAGTGCTTTACAC,30,1351297
furpa,0.3333333333333333,6,5,CGCCTAGCCGTCCACGGAGC,1,1314909
furpa,7.5,49,5,CGCCTAACATCGGGATAGCG,44,1311462
furpa,9.333333333333334,60,5,CGAGAGGATATTGTTAACAA,55,1300916
furpa,3.3333333333333335,24,5,CGACCACACTCAATACCTTT,19,1327738
furpa,3.0,22,5,CGAATCTAATGGGTGCGAAC,17,1293043
furpa,10.0,64,5,CCTTGGCGCATCACCACGAG,59,1354327
furpa,1.6666666666666667,14,5,CCTGGTGCTCTGTCGGCTCG,9,1278914
furpa,3.1666666666666665,23,5,CCTGCCGTACATTACTAGGA,18,1330561
furpa,0.3333333333333333,6,5,CCTCGGAGCTCGCGTTAGCG,1,1277354
furpa,5.166666666666667,35,5,CCGTTGTGGTCCCAGTGCGG,30,1321978
furpa,13.833333333333334,87,5,CCGTACTAAACGAGTGCAAT,82,1281882
furpa,0.3333333333333333,6,5,CCGTAAAGGTTGCGAGCAGG,1,1337756
furpa,0.5,7,5,CCGGTCTCACGCTTCCACGC,2,1343579
furpa,3.5,25,5,CCGGGACGAGGATCCCACCT,20,1337413
furpa,3.3333333333333335,24,5,CCGCATCGTTATACTCTAGA,19,1304863
furpa,1.5,13,5,CCCTTTTGTGACTTACTGCC,8,1284659
furpa,2.0,16,5,CCCGGGTGAAAGGCCGGGTG,11,1288209
furpa,3.3333333333333335,24,5,CCCCTAATGGCCACGAGAAA,19,1274301
furpa,0.5,7,5,CCCAGACTTACTTTATGGGC,2,1276277
furpa,2.6666666666666665,20,5,CCCAAAATAGGGGACCGGCG,15,1304125
furpa,8.166666666666666,53,5,CCATCACCTGACTAGCACCT,48,1310167
furpa,2.1666666666666665,17,5,CCAGGCTACCAGTCGGGATT,12,1272511
furpa,8.666666666666666,56,5,CCAGCTGCACAAAAACACCA,51,1302874
furpa,0.6666666666666666,8,5,CCAGAGCGCCGTGTATCCCG,3,1327035
furpa,3.6666666666666665,26,5,CCACACTCCGACCGGTCACA,21,1303794
furpa,1.5,13,5,CCAATCACGGGACAGCCTCC,8,1351813
furpa,5.833333333333333,39,5,CATGTTCGGTCGGTTATGTT,34,1317641
furpa,3.5,25,5,CATGGTGGCCTGTGAAATTA,20,1273700
furpa,7.666666666666667,50,5,CATGATATTCAGCGGTCGCA,45,1303699
furpa,0.8333333333333334,9,5,CATCTCGCAGACCTAATTGC,4,1330412
furpa,1.3333333333333333,12,5,CATCGGATGCTTGTGGCGGC,7,1348512
furpa,4.333333333333333,30,5,CATCCTACGCAGGGAGACGA,25,1291992
furpa,5.833333333333333,39,5,CATATCACTCAGATTAAACG,34,1338087
furpa,3.1666666666666665,23,5,CATAGTATCTCATGAAATCA,18,1309165
furpa,3.0,22,5,CATACTACCTTTCCTAACAT,17,1345327
furpa,1.6666666666666667,14,5,CATACCTGGAAGTATATTAG,9,1287942
furpa,0.6666666666666666,8,5,CAGGGGCGAGGTTTTCCTGC,3,1333637
furpa,0.8333333333333334,9,5,CAGGGCAGATATCAGATCGG,4,1295941
furpa,11.166666666666666,71,5,CAGGCCGACCGCCTTACGAA,66,1324692
furpa,9.666666666666666,62,5,CAGGAGCGTGGTCGCGCAAC,57,1304906
furpa,4.166666666666667,29,5,CAGCGTCTTATACGATGTCT,24,1351566
furpa,7.166666666666667,47,5,CAGCGACGTGTAAAAATCTT,42,1341579
furpa,1.6666666666666667,14,5,CAGCAATACGAAGTACCTGT,9,1290099
furpa,1.1666666666666667,11,5,CAGAATGGCATATAGAAGAA,6,1300266
furpa,2.1666666666666665,17,5,CAGAAGAATTACCGGACCCA,12,1327650
furpa,10.166666666666666,65,5,CACTGAACCGTCGTAGTTCA,60,1307027
furpa,5.0,34,5,CACCGTACTTTGTCCAACGT,29,1353357
furpa,2.1666666666666665,17,5,CACCATTCCCGGATGGGCAA,12,1324164
furpa,6.666666666666667,44,5,CACAATCCGCTCCCGCATAG,39,1330430
furpa,5.166666666666667,35,5,CAAGTGGTCGGGTTGGAGGA,30,1286153
furpa,0.3333333333333333,6,5,CAACCTGTGTTTGTGCACAT,1,1295205
furpa,0.5,7,5,CAAAGTTCGCCCATGTCAGC,2,1310165
furpa,8.5,55,5,CAAAGGTATAACGGGTTCGT,50,1299447
furpa,0.5,7,5,CAAACGGCATACGCAAGTGA,2,1315379
furpa,0.5,7,5,CAAAAACATAAAGATAGTAC,2,1302259
furpa,1.8333333333333333,15,5,ATTTGTCGTATGTTTAAATG,10,1275020
furpa,2.3333333333333335,18,5,ATTTGCGATATATGCGGTCA,13,1321198
furpa,2.6666666666666665,20,5,ATTCAGACCTAAATCACGGA,15,1302393
furpa,4.5,31,5,ATTAGAAATTTAAGGTATTT,26,1336258
furpa,2.0,16,5,ATGTATCCTTGGCGAGGGGG,11,1320606
furpa,0.3333333333333333,6,5,ATGGCTATTCGTAGCGGTTC,1,1308891
furpa,1.0,10,5,ATGCTGGTACCATACGGGCT,5,1352534
furpa,1.1666666666666667,11,5,ATGCTCAGCGTGGGAGCTGA,6,1354627
furpa,0.5,7,5,ATGCGTCTGGTACTATCATT,2,1341241
furpa,1.6666666666666667,14,5,ATGATCGGAATATGTACAGG,9,1348634
furpa,2.5,19,5,ATGATAGGGACTTGACGACA,14,1290065
furpa,2.5,19,5,ATGAACTTGACTTTGGTCCC,14,1276918
furpa,0.3333333333333333,6,5,ATCTCATGACATACGCTAAT,1,1338291
furpa,2.1666666666666665,17,5,ATCTAATGAGCCTCACGCGC,12,1344564
furpa,4.5,31,5,ATCGTTTGTTAATGGGTATT,26,1351451
furpa,14.0,88,5,ATCGGAGGTATCGCGCGCTA,83,1302142
furpa,11.166666666666666,71,5,ATCCGATAGAAACCCGGAAT,66,1303286
furpa,6.5,43,5,ATCCCCGGTATCAGTCTTGC,38,1344836
furpa,2.0,16,5,ATCATTTGTCGTATTTATGT,11,1348964
furpa,0.3333333333333333,6,5,ATCATGATCATCAAAGACGT,1,1332174
furpa,0.3333333333333333,6,5,ATATTGATTACTGATCCGAG,1,1306678
furpa,6.0,40,5,ATATTACCGCTCACAGGGTA,35,1280591
furpa,2.6666666666666665,20,5,ATAGGGATAAAAACATGCTA,15,1302222
furpa,1.0,10,5,ATAGGAGGGTGGTAACGCGT,5,1272072
furpa,3.6666666666666665,26,5,AGTGTGTTGCGCGTACGAGT,21,1279293
furpa,8.0,52,5,AGTGGTTAGTTTTGTCCCCC,47,1345466
furpa,4.5,31,5,AGTCCCTCATTGAAGGTCTA,26,1315904
furpa,5.0,34,5,AGTACATGGCGCCACCTTGT,29,1348969
furpa,0.3333333333333333,6,5,AGGTTATCGGGTCAAGATCT,1,1271281
furpa,2.8333333333333335,21,5,AGGTGGGCATCCGAGTAGTC,16,1311598
furpa,2.5,19,5,AGGGACATTCCGTGGTTACT,14,1311080
furpa,5.5,37,5,AGGCGAAGTCTTCGATCTCC,32,1336136
furpa,0.3333333333333333,6,5,AGGCCGTCCAGAGCGAAAGA,1,1346059
furpa,6.166666666666667,41,5,AGGATAGAAAATGGGTAGAG,36,1295128
furpa,6.5,43,5,AGCTCCACGTCACTAACACC,38,1300856
furpa,0.5,7,5,AGCTAAGCGGTGCCTTGACA,2,1340575
furpa,10.5,67,5,AGCGCCCACAATCAGGTCGA,62,1333108
furpa,1.1666666666666667,11,5,AGCCACTATAAAAAGGTGCT,6,1329497
furpa,6.833333333333333,45,5,AGCATACGCCCCCAGTTAGA,40,1307299
furpa,0.8333333333333334,9,5,AGATGTAAGTGAAGATAAAA,4,1294533
furpa,7.666666666666667,50,5,AGATGGCTTTCAGATGGTAA,45,1286159
furpa,6.0,40,5,AGAGCCCCAATCGTTTACGA,35,1271334
furpa,20.666666666666668,128,5,AGACCTTAACGTCAAAATCA,123,1320993
furpa,2.5,19,5,AGACCTGGAATACGAGTTCA,14,1273440
furpa,0.3333333333333333,6,5,AGACCGAAGTTATCAACGGC,1,1356373
furpa,2.1666666666666665,17,5,AGACACTAAGTTGGCAGAGC,12,1348726
furpa,0.6666666666666666,8,5,AGACACCGGTATCCTTCCCT,3,1340656
furpa,0.3333333333333333,6,5,ACTTGGTTGAGACCTTGAAT,1,1354311
furpa,0.8333333333333334,9,5,ACTTACTCTAAAAGACTTAG,4,1298817
furpa,2.6666666666666665,20,5,ACTTACGGCACTTGTGGGAT,15,1296066
furpa,0.3333333333333333,6,5,ACTTAATTTCATGCTATGAG,1,1305516
furpa,0.3333333333333333,6,5,ACTGAAAGGGTTAACGGAAA,1,1317740
furpa,0.6666666666666666,8,5,ACTCTCATCTGGCACATTCC,3,1273060
furpa,5.833333333333333,39,5,ACGTACGAAAAATGAAAAAG,34,1312578
furpa,3.8333333333333335,27,5,ACGGAACCGATGATAAATAA,22,1344285
furpa,4.666666666666667,32,5,ACGCAGGAGCGACAGTTCCG,27,1355393
furpa,0.3333333333333333,6,5,ACGATTGCATCGGTACCTCT,1,1301433
furpa,3.1666666666666665,23,5,ACGATCATTTATTACAAGGT,18,1307603
furpa,1.5,13,5,ACGAACCGTGTTTGTAGGCT,8,1348868
furpa,6.5,43,5,ACCTGCCGTTCACGCGAACA,38,1281194
furpa,1.6666666666666667,14,5,ACCTAGAAGGCTGACCGACC,9,1344918
furpa,6.5,43,5,ACCCTGCCTCAGACGGTTGA,38,1274634
furpa,1.0,10,5,ACCCCATGCAATCATACATT,5,1311672
furpa,3.6666666666666665,26,5,ACCATTCCCGCACTTGCCCT,21,1349754
furpa,1.6666666666666667,14,5,ACATTTGGAGCACCGCAAGA,9,1283844
furpa,0.3333333333333333,6,5,ACATTCCATTCCGATGTTGG,1,1338939
furpa,0.3333333333333333,6,5,ACATCTTAACCACGCCGGGA,1,1346614
furpa,1.8333333333333333,15,5,ACATAGTCGAAAAGGGCGCC,10,1283603
furpa,2.1666666666666665,17,5,ACAGTGATTTTCATTGGGCA,12,1272903
furpa,2.5,19,5,ACAGGAGAGGGGGGCGTCCT,14,1343704
furpa,1.3333333333333333,12,5,ACAGAGAATATCTCGTGGGT,7,1282480
furpa,0.3333333333333333,6,5,ACACTGAGATACAGACGGAG,1,1312000
furpa,6.333333333333333,42,5,ACACCGAACTCAGCGGACAA,37,1271186
furpa,1.1666666666666667,11,5,ACACATCCGAGTAGGGAGGG,6,1274797
furpa,0.3333333333333333,6,5,ACACACTTCGAGACGGGGCT,1,1299351
furpa,10.166666666666666,65,5,ACAATCACGCAAACCCTGTA,60,1339081
furpa,1.3333333333333333,12,5,ACAAGCTCCGGATGCGGGAA,7,1291833
furpa,1.6666666666666667,14,5,AATTGGCCAGCAGCGTCCCG,9,1356074
furpa,6.833333333333333,45,5,AATTGAAGCTTGCCCATTGA,40,1297384
furpa,46.666666666666664,284,5,AATGTGGCCTCGGGATGTAC,279,1275694
furpa,3.8333333333333335,27,5,AAGTCCCGCCGGGCGCAGGA,22,1302266
furpa,1.5,13,5,AAGTATAACGGCGCTTCCTT,8,1344005
furpa,3.0,22,5,AAGAGATACCGACCCCTTGA,17,1351493
furpa,9.333333333333334,60,5,AACTTTCATCAACAATTCTA,55,1307258
furpa,0.3333333333333333,6,5,AACTTCTCTACAGTTTTCAA,1,1352791
furpa,8.333333333333334,54,5,AACTGAGGCTTGACACTTTC,49,1316763
furpa,0.6666666666666666,8,5,AACTCGGGTCTTTGGGGCCT,3,1325089
furpa,4.5,31,5,AACGGTATCCCTTTTCGGTC,26,1325087
furpa,9.0,58,5,AACGAATTGAGTACAACTCG,53,1354309
furpa,0.5,7,5,AACCGTTTAAACTACACCGA,2,1330863
furpa,5.0,34,5,AACCATTAAGGTTACATCTA,29,1291316
furpa,0.3333333333333333,6,5,AACACGGAGGGCAACAAGAT,1,1329732
furpa,5.833333333333333,39,5,AAATTTGGTACTACTATTAG,34,1333057
furpa,1.6666666666666667,14,5,AAATCCCGGTAATCCCAACT,9,1276788
furpa,17.5,109,5,AAATATGATCCCTTCCTGTT,104,1301065
furpa,0.5,7,5,AAAGGTCACTACTCCCTATG,2,1339256
furpa,0.8333333333333334,9,5,AAAGCAAATTCCCGAGACAA,4,1299498
furpa,2.0,16,5,AAAGATTGCCATGCGATTCC,11,1273199
furpa,4.5,31,5,AAACTGGAAATAAAAGAGGT,26,1308386
furpa,1.0,10,5,AAACGGACGAAATGGAGGGC,5,1322765
furpa,3.1666666666666665,23,5,AAACGACTCAAACTGCCGAT,18,1297192
furpa,4.5,31,5,AAAATTCCGCAAGTGTACTC,26,1300732
furpa,0.3333333333333333,6,5,AAAATAAACGTTCCACACAT,1,1332167
furpa,1.2,9,4,TTTTCTACAAATACGAAGAC,5,1331258
furpa,0.6,6,4,TTTGTTATGTTAGCGTGGCT,2,1305366
furpa,0.4,5,4,TTTGCCATACAAGAGGCTTC,1,1272356
furpa,1.8,12,4,TTTCTACCTCAGAATCTCGC,8,1295382
furpa,5.6,31,4,TTTCGGAGACTACATAGACC,27,1326975
furpa,0.4,5,4,TTTCCAGTACTAGGCTATCT,1,1302533
furpa,1.4,10,4,TTTCCAACACTGAGAGTGTG,6,1285419
furpa,6.2,34,4,TTTACCGGCGTTCAGTGTCT,30,1313879
furpa,0.4,5,4,TTGTTCCCCAGGCAACTGTC,1,1310391
furpa,4.2,24,4,TTGTAAGGGATGAAACTGTT,20,1285385
furpa,0.4,5,4,TTGGTTATAGGGTGGTAGAT,1,1348494
furpa,3.6,21,4,TTGGACGCGTCCCAGTCGGG,17,1306928
furpa,0.4,5,4,TTGCTGACCTCCTAACTTGT,1,1292755
furpa,4.2,24,4,TTGCGGTCCAACCTCGCGGA,20,1336206
furpa,13.4,70,4,TTGCATTAGCTAATCCAGTT,66,1349502
furpa,10.8,57,4,TTGAGCGCGTGAAGCCTGCC,53,1291937
furpa,6.0,33,4,TTGACGGAGCTTTTCTGAAT,29,1333513
furpa,8.4,45,4,TTCTCAGATGTGCACTCGTG,41,1272499
furpa,45.4,230,4,TTCTCACATCATATTGGGTA,226,1295673
furpa,0.8,7,4,TTCTACAATCACCCGCCGAA,3,1311821
furpa,7.2,39,4,TTCGTTAGTACTATGGTTGT,35,1349835
furpa,1.2,9,4,TTCGTGCCACGGTAGCGTCC,5,1336773
furpa,16.6,86,4,TTCGGGACAGGAGGCAGTCG,82,1340286
furpa,11.2,59,4,TTCGCAGGTGGGCGCCAATA,55,1328165
furpa,4.4,25,4,TTCGAATCGGTGATGGGTAT,21,1288536
furpa,6.0,33,4,TTCAGGATATTATCAAGTCT,29,1334622
furpa,1.4,10,4,TTAGGGATAGGGAGCTCTGC,6,1300596
furpa,1.4,10,4,TTAGAGTACCTCTTCCAGTA,6,1290068
furpa,12.4,65,4,TTAATTGCAAATAACGCCGT,61,1307019
furpa,0.4,5,4,TGTTATATGCCAAAAACAAC,1,1330540
furpa,6.0,33,4,TGTTAGAATTTTGGAAAACC,29,1284455
furpa,1.2,9,4,TGTGTTGCCGTAAGCTAGTT,5,1302006
furpa,5.4,30,4,TGTGTGCAGTCGCTTTTATC,26,1292753
furpa,2.2,14,4,TGTGTCATAGGTAAGCTGCG,10,1305582
furpa,0.6,6,4,TGTGCGGAACCGCCAGTGAG,2,1345742
furpa,2.8,17,4,TGTGCATGAGCAGTACCAAC,13,1344813
furpa,1.2,9,4,TGTCAACACATTTCCAGCCC,5,1328715
furpa,76.2,384,4,TGTATTGTAACGATACGCAA,380,1326472
furpa,0.4,5,4,TGTACCGGGAAAGCCAAGCG,1,1296428
furpa,3.8,22,4,TGGTTGAGGTAGGACCGAAA,18,1281181
furpa,0.4,5,4,TGGTAGACGAGAGTCATCTA,1,1335922
furpa,0.4,5,4,TGGGGTACAGTGCGCGTTTT,1,1325515
furpa,3.0,18,4,TGGATAATGGGCTCCAAAGG,14,1345318
furpa,4.8,27,4,TGGACTAAATAAGAAAACTC,23,1324254
furpa,0.4,5,4,TGGACACCTTTGGGAGTTAT,1,1310037
furpa,6.6,36,4,TGGAACTACTCGCATTCAGA,32,1272286
furpa,10.2,54,4,TGCTGATTGTGATCGCTGGT,50,1332281
furpa,3.2,19,4,TGCTGAGAGCTCGCCTTCGT,15,1318527
furpa,4.4,25,4,TGCTAGCTGTATGTCGAACT,21,1339633
furpa,16.2,84,4,TGCGTTGACGCCTGTGAAGG,80,1323233
furpa,1.6,11,4,TGCGGTCGTTTCATTCGCAA,7,1317418
furpa,6.6,36,4,TGCGGGTGTAAAAGGGGTAG,32,1336254
furpa,1.4,10,4,TGCGCCCCGGGGTCATGAGC,6,1327436
furpa,0.8,7,4,TGCATCCGTAATAGATTTTA,3,1356647
furpa,0.4,5,4,TGATCGTTGGCCGTACATAT,1,1323220
furpa,0.4,5,4,TGAGGTCTGACGGGTGGCAG,1,1294605
furpa,0.8,7,4,TGACTTATATGCCGAGGAAG,3,1311697
furpa,3.8,22,4,TGACGAAAAAGCCCACAGAC,18,1341478
furpa,3.0,18,4,TGAATCGTTGCTAGTAACCT,14,1344792
furpa,0.4,5,4,TGAAGTATCTCGGAGGTATT,1,1330225
furpa,0.4,5,4,TGAACAGGTTCGTGAGAGTT,1,1355703
furpa,3.0,18,4,TGAAATATCCATATCGGACT,14,1302341
furpa,4.2,24,4,TGAAACAATGTCAGAATAAT,20,1278140
furpa,0.4,5,4,TCTTCAATTAGCGGAAAAGA,1,1332206
furpa,9.6,51,4,TCTTACATCCCTTACTTGTA,47,1291687
furpa,9.6,51,4,TCTGTAGTTCGAGTCTTCTA,47,1273461
furpa,8.4,45,4,TCTCGGTGGCGGACAACGAT,41,1290050
furpa,8.4,45,4,TCTCAGCCAAGGGACTAGAT,41,1319704
furpa,9.4,50,4,TCTAGACCTTGCGAAAGTGA,46,1327893
furpa,9.2,49,4,TCTAAACGCTGGGGTCTCTT,45,1337748
furpa,11.2,59,4,TCGTTGGTGCTCAGGCCGAG,55,1311611
furpa,1.2,9,4,TCGGCGGGGACAATGTAGTA,5,1278182
furpa,0.4,5,4,TCGGAGTTCGAGGAAGGCCC,1,1357219
furpa,8.6,46,4,TCGCTTCCGTTTCATATACT,42,1299567
furpa,3.0,18,4,TCGCGCACCTAGTCCTTTTT,14,1300777
furpa,10.4,55,4,TCGCAGAAAGGCAGCAATGC,51,1317785
furpa,6.0,33,4,TCGAGTCCCACGTGTGACTG,29,1353855
furpa,2.6,16,4,TCCTTAATCAACAGCGGTCC,12,1332936
furpa,10.0,53,4,TCCCGAGTATTCCAACATTA,49,1289542
furpa,3.6,21,4,TCCCGAACAAAATTCAACCA,17,1287525
furpa,7.4,40,4,TCCCCCGCGCTGAAAATTTG,36,1298329
furpa,0.8,7,4,TCCAGTCCTATAAATGTGGT,3,1291548
furpa,9.2,49,4,TCCACTGGCCATAGCACAGA,45,1284652
furpa,1.4,10,4,TCCAAGTTCTGTTCTTGAGA,6,1329674
furpa,5.8,32,4,TCAGTGGAGATAAACTCCTC,28,1305494
furpa,1.8,12,4,TCAGAGGACCCGGAGTTTTA,8,1325778
furpa,5.6,31,4,TCACGAAGGCACTCGTTCTT,27,1299728
furpa,0.4,5,4,TCACCGGGAGGTTTGTTTCA,1,1316483
furpa,0.4,5,4,TCACCATGGCTCTAGCTTCT,1,1283120
furpa,11.4,60,4,TCACACTCGTCTAGTAGAGT,56,1272503
furpa,4.0,23,4,TCACAAAAGCTTTAACTCTG,19,1278017
furpa,6.2,34,4,TCAAGTGGGGCACAAGTACT,30,1352322
furpa,5.0,28,4,TCAAACGCCAAGGCACACTC,24,1327109
furpa,7.2,39,4,TATTGGACAGTTTTGGTACA,35,1332066
furpa,0.4,5,4,TATTCGCCCACAAAGTGCCA,1,1319271
furpa,7.0,38,4,TATCAGCTGTTGAAAGTATT,34,1333230
furpa,6.4,35,4,TATAGCTACTTAGATGTTTT,31,1297049
furpa,5.4,30,4,TATACGCAACGATTGACCAT,26,1300004
furpa,8.6,46,4,TAGCTTCGCCCGGTACCGAT,42,1308709
furpa,14.6,76,4,TAGCGTGGGTTGTGTCCACT,72,1348760
furpa,13.6,71,4,TAGATTGGGCGGAATCGCAT,67,1353640
furpa,2.0,13,4,TAGATTAATTCGTCCTCACG,9,1283329
furpa,0.4,5,4,TAGACCTGAAGCGCAGACCT,1,1341689
furpa,3.0,18,4,TAGACATTTGCCTACACCAT,14,1345748
furpa,1.4,10,4,TACTGCCAAATCCTATGAGA,6,1279332
furpa,6.8,37,4,TACGGCGGCATGACTAGAGC,33,1335111
furpa,0.6,6,4,TACCACGCAGCCGGCACCTC,2,1315519
furpa,5.0,28,4,TACACATCTCCTCTGGGTCA,24,1357069
furpa,7.0,38,4,TAATGTGCAGTGAGCGGTCC,34,1315776
furpa,0.4,5,4,TAACATCGAGTTCCCGCAGG,1,1355231
furpa,1.0,8,4,TAAATAAAATTCGCACCACC,4,1275414
furpa,1.4,10,4,TAAACCTTGACGAGGGGCTA,6,1291944
furpa,8.4,45,4,GTTTTCACTGTGTCTAGGGC,41,1290411
furpa,5.8,32,4,GTTTGTGCCTGTTGGCCACG,28,1286488
furpa,2.0,13,4,GTTAGAAGAAGACATTATCT,9,1352394
furpa,3.6,21,4,GTTACGGGGTTCAGTACTTG,17,1343277
furpa,10.2,54,4,GTTAAAAGCCTTCAGAAATG,50,1280688
furpa,3.4,20,4,GTGTTTCAGGCTCTTCCGAC,16,1294277
furpa,18.4,95,4,GTGTTCTCGGCACAAGACTG,91,1311695
furpa,0.4,5,4,GTGTTACCCGATTACAGTTC,1,1294417
furpa,1.0,8,4,GTGGTCTGAGATTCGCGACA,4,1309611
furpa,2.8,17,4,GTGGGTCGGACCCCCTCTCC,13,1285561
furpa,0.6,6,4,GTGGACGAAATGTCGCTAGT,2,1280585
furpa,6.4,35,4,GTGCTGCGCGTGTGCAGATA,31,1273909
furpa,5.8,32,4,GTGCGTTCTGTGGTAGTGCA,28,1291802
furpa,19.4,100,4,GTGCAATCATGGGGTGCGGG,96,1327429
furpa,1.2,9,4,GTGCAATACGGCCCACTTAT,5,1337300
furpa,3.8,22,4,GTGAGCTGACCAGATTATCA,18,1337579
furpa,11.8,62,4,GTCTAGCTCACATTGCCCAC,58,1344247
furpa,13.8,72,4,GTCGCAGTTTATTCCCGCGC,68,1303028
furpa,10.2,54,4,GTCGATCTGCGGTTAAATCA,50,1284638
furpa,3.4,20,4,GTCCGGACGTATATAGTGTC,16,1337634
furpa,0.4,5,4,GTCATACTTGGTAGAGACAT,1,1287499
furpa,1.0,8,4,GTCACTTGTGAGTGGTGAGG,4,1305353
furpa,0.4,5,4,GTATGTCAAATTTTATTTAA,1,1279462
furpa,0.8,7,4,GTAGGCAGGTTCGTAGAAGT,3,1329552
furpa,0.8,7,4,GTAGAGCAGCGGATTTCGTA,3,1325019
furpa,0.4,5,4,GTACGGTTTTGCGATTTCAA,1,1311871
furpa,7.4,40,4,GTACGAGATAAAACTCGGTA,36,1291695
furpa,4.0,23,4,GTACCCCAAGTGATGACGCT,19,1305155
furpa,0.6,6,4,GTACCAACGCGAGACGTCGT,2,1302864
furpa,2.2,14,4,GTACATCGACCGTAGTGGGA,10,1328373
furpa,4.4,25,4,GTAATCCGACATATTCGCAA,21,1290056
furpa,15.2,79,4,GTAAAATGACTGAGCGCTCG,75,1288811
furpa,3.2,19,4,GGTTTTGTATGGAAGAGGAG,15,1289858
furpa,2.8,17,4,GGTTTTAAGGAAGGATCCGT,13,1323652
furpa,0.4,5,4,GGTTTGCTTAGGGCCATTTG,1,1289260
furpa,4.6,26,4,GGTTCTTGGTTGGGCTATCG,22,1283133
furpa,4.0,23,4,GGTTCTTCCAAATCCGGTGG,19,1281976
furpa,23.6,121,4,GGTGGGCGCGGCACCTTCAG,117,1334687
furpa,22.8,117,4,GGTGCAGAATTGGCGAGTGC,113,1328368
furpa,6.0,33,4,GGTCGTCCGCCTGGATTAGG,29,1331839
furpa,15.8,82,4,GGTCCTTTCTAGCTTTAGGG,78,1308836
furpa,0.4,5,4,GGTCCGATTGGGGGGCCTAG,1,1281595
furpa,11.0,58,4,GGTCAGGCGGAGTCTTTCGT,54,1295610
furpa,1.0,8,4,GGTATCATGCCTAAGTGAAA,4,1311116
furpa,1.4,10,4,GGTAGTTAATCGTCAAAACC,6,1331121
furpa,12.2,64,4,GGTACGAAACTTGTATAAGA,60,1347243
furpa,0.8,7,4,GGGTGAGGGGAATAATGAGA,3,1317023
furpa,1.8,12,4,GGGTCGATGTTCCCGTACTT,8,1313762
furpa,5.0,28,4,GGGGTCTGAATTGGTTTAAG,24,1301759
furpa,8.4,45,4,GGGGTAGTATTCGACTAAAG,41,1341576
furpa,6.2,34,4,GGGGCTCTGTGAATTAGATG,30,1312658
furpa,1.8,12,4,GGGCTGGCGCCTAGACAGTA,8,1338633
furpa,5.4,30,4,GGGAATGTTTCGCCGAAGTC,26,1309629
furpa,9.2,49,4,GGGAAGGGACACCGATGTTG,45,1340715
furpa,3.0,18,4,GGCTTAAAACTCAATACGAG,14,1271940
furpa,7.8,42,4,GGCGCAATTACACCTTTTAT,38,1287724
furpa,4.2,24,4,GGCCTGCCAACTAATTTGAC,20,1350758
furpa,5.2,29,4,GGCATGGACGGTAACCATTC,25,1280452
furpa,7.6,41,4,GGCACTTAGTCTTATCAAGG,37,1345908
furpa,5.4,30,4,GGCACGGCACATTCAGAACC,26,1276533
furpa,1.6,11,4,GGAGAAGATACTGTCTCTCA,7,1299225
furpa,8.6,46,4,GGACGATCAGGCGGGCCGGG,42,1335860
furpa,6.4,35,4,GGACAGACAGCAGTGGAATT,31,1328197
furpa,3.0,18,4,GGAATGGAGCGTTGCGCCAG,14,1280840
furpa,0.4,5,4,GGAAGTTAGAGAATTTTCGA,1,1320911
furpa,4.0,23,4,GCTACACATTTTTCGCAGAA,19,1342352
furpa,1.2,9,4,GCGTTGTGGCCCATATGCTG,5,1296170
furpa,2.4,15,4,GCGTATGCCAAGTTGGGCGA,11,1327380
furpa,3.8,22,4,GCGGCCCTCTCCTGGGGTGA,18,1327111
furpa,3.8,22,4,GCGCTACGCTTTAGGGATCT,18,1331478
furpa,1.8,12,4,GCGCGCCTACCGGATACATA,8,1345137
furpa,0.6,6,4,GCCTCGCGCACCCAGTCGCA,2,1307386
furpa,2.6,16,4,GCATTTTCTTTAGCTAAAAC,12,1325468
furpa,6.2,34,4,GCATGGCCAAACATACTCTC,30,1324671
furpa,0.4,5,4,GCATGGAAGCTTCTCGTGGG,1,1351404
furpa,8.8,47,4,GCAGTGGGGTACACGGTGTA,43,1312773
furpa,5.6,31,4,GCACTAAAAAGAGTGCGCTG,27,1334873
furpa,1.8,12,4,GCAATAAGGACTAATCTCAT,8,1297178
furpa,0.6,6,4,GCAAGCTGCTTCAAACCCTT,2,1341328
furpa,12.4,65,4,GATTTTTCGCCTTCAACAAG,61,1319642
furpa,1.4,10,4,GATTGGCGTGTAGGGGTGGA,6,1342173
furpa,10.0,53,4,GATTGGATTTTCAGTGACTT,49,1281502
furpa,3.8,22,4,GATGAACTCTAAATGCTTCT,18,1353578
furpa,4.6,26,4,GATCCTATCGTTCTTAAAAT,22,1329634
furpa,0.4,5,4,GATCAAGGGAGTGCCGGAGC,1,1355293
furpa,48.6,246,4,GAGTAATCACACCACCGCGT,242,1285404
furpa,0.4,5,4,GAGTAACTCTCTTCGTCCAT,1,1350284
furpa,8.4,45,4,GAGGTGGGATCCACTTAAAT,41,1302820
furpa,7.2,39,4,GAGCTTAATTTCCTATTCTA,35,1275319
furpa,7.6,41,4,GAGATTCGGGGCAGAATTAG,37,1289919
furpa,4.6,26,4,GAGACTGCATGGCGTGTTGT,22,1332545
furpa,1.0,8,4,GAGACATTACGGGCCAGGAA,4,1293844
furpa,21.0,108,4,GACTGGCTCAGATGCATTGT,104,1292468
furpa,1.2,9,4,GACGTCGAAATAAACGGAAG,5,1333110
furpa,1.2,9,4,GACCCCCGTGGGGCTGGTTC,5,1340433
furpa,4.6,26,4,GACCAGGACATCCTGCTTTG,22,1308414
furpa,3.4,20,4,GACATGCTTCGCGAAGCTTG,16,1356854
furpa,9.8,52,4,GACATAGTGGCGGTAACCAA,48,1288217
furpa,4.2,24,4,GACAGTGAGGACGCTCACTG,20,1306633
furpa,0.4,5,4,GAATATAATAGAATAGTGGG,1,1323354
furpa,12.8,67,4,GAAGTTTCGCCGATTCTGTC,63,1332058
furpa,6.4,35,4,GAACTAAGCAGACGGACCAC,31,1315731
furpa,10.4,55,4,CTTTTAAAAGGTGCGGCGAA,51,1349790
furpa,7.6,41,4,CTTTGTCGCCGGATCTGGTT,37,1309034
furpa,7.6,41,4,CTTTCAAACTCGATTCATAG,37,1344281
furpa,16.6,86,4,CTTGGGGCAGACCGACCCGT,82,1299420
furpa,0.4,5,4,CTTCCAGTGCTCCCGGGTCA,1,1356617
furpa,1.4,10,4,CTTCAAGTATCAAGAAACCG,6,1328596
furpa,6.4,35,4,CTTATGGCCCTATTCATCCC,31,1330358
furpa,0.4,5,4,CTTATATTTAGAGCATGAAC,1,1337809
furpa,17.4,90,4,CTTACCATAGTCACGCAGCC,86,1320354
furpa,0.4,5,4,CTTAACACAAGCCAGTCGCA,1,1346446
furpa,6.6,36,4,CTGTTACATTGCGCGAGTAA,32,1313703
furpa,15.6,81,4,CTGTGCACGCGGTCCCTTTC,77,1345769
furpa,32.8,167,4,CTGTCTAGAGAATTCGATCG,163,1283600
furpa,1.8,12,4,CTGAAAACTGGTCCGATGTA,8,1354750
furpa,14.6,76,4,CTCTGGGATCCGATAAGATC,72,1308426
furpa,9.6,51,4,CTCTCTAGGAGGATGGATGT,47,1334467
furpa,0.4,5,4,CTCTCCTTCGTAGTGAACGC,1,1340866
furpa,7.8,42,4,CTCTCAGAATAATAAGAGAT,38,1276320
furpa,2.2,14,4,CTCTATCGACGTAAGCTCAT,10,1347913
furpa,2.8,17,4,CTCGGGTAATTATCCCCTCC,13,1296809
furpa,0.4,5,4,CTCGACAGGATACGTCAAGC,1,1353751
furpa,0.4,5,4,CTCAACGATCCCGCGGCCCC,1,1272717
furpa,11.0,58,4,CTATTACACAGCATAGGGTG,54,1357324
furpa,5.0,28,4,CTATGAGTAAGACCTGTACA,24,1345302
furpa,0.4,5,4,CTATCCTCGGAAGGCGGAAC,1,1342889
furpa,1.6,11,4,CTAGTTTCAGTCGTACAAAG,7,1356491
furpa,10.2,54,4,CTAGTCAAAAACAGTAGTGA,50,1309604
furpa,9.2,49,4,CTAATCACCGTAGAGACTTC,45,1343517
furpa,0.8,7,4,CTAACCCCCGACTTGTGCCG,3,1342439
furpa,5.8,32,4,CGTTTAGCGGAATTACTTAG,28,1349044
furpa,7.4,40,4,CGTCGGGAATTTGGGTCTCA,36,1333949
furpa,5.0,28,4,CGTAGGAGGGGCATAGTGGA,24,1281876
furpa,8.8,47,4,CGTACCCGCTATGACCTGGC,43,1271598
furpa,0.4,5,4,CGGCGGCCTCTATGTTAAAT,1,1301439
furpa,15.8,82,4,CGGCGCATATCCTCTAGCGC,78,1274355
furpa,0.6,6,4,CGGCATCAGGGTTACAGAAC,2,1325502
furpa,2.8,17,4,CGGATAAGCTTCACCGGCAA,13,1348023
furpa,1.0,8,4,CGCTCTATACCACGGATGGC,4,1291836
furpa,0.8,7,4,CGCTCGGGCATGTCGGGTAT,3,1284953
furpa,0.6,6,4,CGCGAGCACGTATATTCACA,2,1271292
furpa,5.8,32,4,CGCCGACGTGTTAGACACTC,28,1308865
furpa,0.4,5,4,CGCAAGAACTCTACGTGTGT,1,1295377
furpa,1.2,9,4,CGATCGAATGCTGGCGGGTA,5,1292779
furpa,5.4,30,4,CGATAGAATCGCTCAGTTTG,26,1281916
furpa,2.2,14,4,CGATAAGTTCGTACCGTTAA,10,1286432
furpa,3.8,22,4,CGAGGTACCGCCCCGAGGGT,18,1312109
furpa,1.2,9,4,CGACTTCTAAAAGCATCCGT,5,1284320
furpa,4.6,26,4,CGACGCCCTTCGAGATCTGA,22,1355358
furpa,2.4,15,4,CGACAGTCCTCCAAGCCATG,11,1286444
furpa,10.0,53,4,CGAAGCCTTACCGACGGATA,49,1339319
furpa,0.4,5,4,CGAAGAAACTCACGAACGCA,1,1346082
furpa,3.6,21,4,CGAACTTGTCAAAAAATATC,17,1338013
furpa,1.6,11,4,CCTGTAAATAGTATCCAACC,7,1329739
furpa,11.2,59,4,CCTGCAGAGGCCTGCACTAG,55,1336293
furpa,16.0,83,4,CCTGATTTCGCGCCATAATG,79,1273714
furpa,1.0,8,4,CCTCTTGTGGAACGCGTAGG,4,1354776
furpa,3.6,21,4,CCTCTTAAATAGAATCGTTT,17,1275780
furpa,2.6,16,4,CCTCTAGGCAATGTCGTCTT,12,1271325
furpa,2.0,13,4,CCTCCAGGCATCAGCACCTC,9,1324808
furpa,1.8,12,4,CCTCAGGGGGACGCCGGGAT,8,1274010
furpa,8.0,43,4,CCTAGGTGTTCATGTCGAAC,39,1323923
furpa,6.0,33,4,CCTACAAACATGGGTTTAAT,29,1285903
furpa,5.0,28,4,CCGTGCGCAAATTCATGTTT,24,1330680
furpa,0.6,6,4,CCGTACGTTTACGAAACCGA,2,1295047
furpa,3.6,21,4,CCGGTCCGGTTTAATGCGGT,17,1280546
furpa,1.4,10,4,CCGGTATAGAGCTCATAAAG,6,1314127
furpa,4.8,27,4,CCGGCTTGGGAAATCCTGGG,23,1348133
furpa,2.6,16,4,CCGCTAGGGTCACATCCGGT,12,1354886
furpa,3.8,22,4,CCGATCCGGCGAGGTCGCCA,18,1279046
furpa,4.0,23,4,CCCTTAGATTCTTCGGGGGT,19,1275506
furpa,7.4,40,4,CCCGTGAAGGGCTGTCGTTA,36,1280631
furpa,6.6,36,4,CCCGACTCCGTTAGGACCTA,32,1357420
furpa,0.4,5,4,CCCCTTACTCGGGAAAATAT,1,1334734
furpa,1.4,10,4,CCCCCCGTGAAATAGGCACA,6,1320994
furpa,0.4,5,4,CCCACATGCGCGTGCGTCCA,1,1291206
furpa,24.2,124,4,CCATGGTACGACCTTCCTGA,120,1348988
furpa,3.8,22,4,CCATGGCATATCCATCCTAA,18,1333253
furpa,6.8,37,4,CCACCTAATAAAGCGCCTGC,33,1327309
furpa,17.0,88,4,CCAAGAAATCATGTTAACCT,84,1326550
furpa,3.0,18,4,CATTTTTATGGGTTGGCTTC,14,1272961
furpa,0.4,5,4,CATTTTCGCAACTCAGCTTA,1,1324702
furpa,13.2,69,4,CATTGAGGAAGGAGCTCTCT,65,1312677
furpa,6.8,37,4,CATTATATAAACCTGCATAC,33,1289667
furpa,1.6,11,4,CATGTTTAAGCGGGACACAC,7,1336002
furpa,8.4,45,4,CATGTATGAATCCTCTGGCC,41,1326394
furpa,9.0,48,4,CATGGCAACATTGCTAACGT,44,1271781
furpa,19.4,100,4,CATGGAACTATGCGACAAGC,96,1308217
furpa,1.6,11,4,CATGCTGCTGCAGCGCCCTT,7,1328708
furpa,6.6,36,4,CATGCCAACGCACTGGCATA,32,1298845
furpa,0.4,5,4,CATAGCTGTACGATGTATAA,1,1345418
furpa,14.8,77,4,CAGTGTTTGAGTCATAATTA,73,1320121
furpa,2.8,17,4,CAGTGTCCTAGACTAATCCC,13,1319185
furpa,4.8,27,4,CAGTGACAGGGCGACTTGTT,23,1281432
furpa,3.6,21,4,CAGTCTTTCTTATGGACGAT,17,1311923
furpa,17.4,90,4,CAGGCTGCAATCTACAGTTC,86,1323084
furpa,5.0,28,4,CAGGAATGTTTATGATTATC,24,1325094
furpa,5.8,32,4,CAGCAACTACCTACCACTCA,28,1284736
furpa,3.0,18,4,CAGATCTGTTTGCAGCACGG,14,1342625
furpa,4.4,25,4,CAGACGTCTCCTTTCAGCGG,21,1301417
furpa,0.8,7,4,CACTACAATATTTTGCAAAG,3,1315584
furpa,9.0,48,4,CACTAATGACACTCCCGTAT,44,1310715
furpa,5.0,28,4,CACCGTGGGTTCTCCGTCTT,24,1324715
furpa,5.8,32,4,CACCCGCTCGAATTCAAGTC,28,1278850
furpa,9.8,52,4,CACAATTTGGTACGAGAGCA,48,1335257
furpa,4.2,24,4,CAATAGACGTGTGCGCCTGG,20,1301195
furpa,0.4,5,4,CAAGGTGGCTCGTTCCCCAC,1,1281467
furpa,2.8,17,4,CAAGGGTCCTCCACCCTCAC,13,1327668
furpa,1.8,12,4,CAAGCACACGCTGTGATAAG,8,1306844
furpa,3.6,21,4,ATTTTTCTGTTCTTAAACAA,17,1290071
furpa,2.0,13,4,ATTCGAAGGTCGGGTCGTCT,9,1328367
furpa,4.0,23,4,ATTACGTTATATGTATAAAT,19,1321429
furpa,0.4,5,4,ATGTTATTTTGTTTCGAAGA,1,1347371
furpa,2.8,17,4,ATGGTTGCGCCCAAAATAAG,13,1355533
furpa,4.6,26,4,ATGGCGATCTCACAACCGAA,22,1317817
furpa,4.0,23,4,ATGGCATACACGTATGTATT,19,1321354
furpa,2.0,13,4,ATGCTAATGTATATACTGTA,9,1354171
furpa,4.2,24,4,ATGACCCCTCAGTAGAACCG,20,1344609
furpa,9.4,50,4,ATCTCCTTCAGCCAATCCCA,46,1306403
furpa,3.4,20,4,ATCGTATATCCTCAGCGATT,16,1272521
furpa,11.6,61,4,ATCGTACCGCCAAATGCTTC,57,1319653
furpa,2.2,14,4,ATCGGTTTCCCGAGTGTCGT,10,1309046
furpa,3.4,20,4,ATCGCCCCTAGTGCGGTGAG,16,1294407
furpa,4.4,25,4,ATCGCATCAATCCATAACAT,21,1319632
furpa,7.2,39,4,ATCGAGTAATACGCCATCAC,35,1277510
furpa,0.4,5,4,ATCCGGTTTGTTTTAAATGT,1,1311859
furpa,12.8,67,4,ATCCCCCCGCATCTCATGTT,63,1349675
furpa,3.6,21,4,ATCAAGGGGTTCCGGCGTGT,17,1282324
furpa,6.6,36,4,ATCAAGCACAAGCATATATA,32,1349115
furpa,1.2,9,4,ATCAACTTCGAGCCACGCGG,5,1279044
furpa,4.2,24,4,ATATCGCTTGCTGGTGATGA,20,1306679
furpa,5.0,28,4,ATATAATGTGGTGGCGCTCT,24,1279083
furpa,3.6,21,4,ATATAAACGAATAGGTAGGA,17,1312675
furpa,1.2,9,4,ATAGTTATACCAGATCGCTC,5,1324927
furpa,2.8,17,4,ATAGATTCGGCCCGAGGCAG,13,1310164
furpa,7.8,42,4,ATACGGAATGTTCTGATCAA,38,1315998
furpa,0.4,5,4,ATACGCTGCGCGCCAGATAG,1,1274205
furpa,4.2,24,4,ATAACGACGCCATGGTTCTT,20,1349086
furpa,9.0,48,4,AGTTTACCCAAGCTGATCGA,44,1285386
furpa,0.4,5,4,AGTTGCTACCTGTCCGGACC,1,1274062
furpa,9.6,51,4,AGTGCATCTCGCATTTGCCG,47,1332449
furpa,14.0,73,4,AGTGCAGTACTCCTCTTAGT,69,1284991
furpa,4.0,23,4,AGTGCAGGAGAATATGTACC,19,1357401
furpa,10.0,53,4,AGTCCATACCAAAATCTTGC,49,1348070
furpa,8.0,43,4,AGTCACGTCCAACAGGGATT,39,1349677
furpa,7.6,41,4,AGTATACGCTGGTGTCAGGC,37,1353537
furpa,3.0,18,4,AGGTGGTGCTGTTCCGCCGT,14,1337498
furpa,8.0,43,4,AGGTCATGCTCGAACCCTGT,39,1295580
furpa,7.8,42,4,AGGTATGGGAAGATCTACAT,38,1304554
furpa,0.6,6,4,AGGGTTCTATAGTATGTGGC,2,1285840
furpa,0.4,5,4,AGGGCTAACGACATCGGAGA,1,1288034
furpa,3.8,22,4,AGGGATAATGCTAGGGGGTC,18,1281919
furpa,3.6,21,4,AGGGACCACGGAATCGTTTA,17,1331259
furpa,3.8,22,4,AGGCTACTGGCAGTCCAACT,18,1275145
furpa,1.0,8,4,AGGCGAGCCACACTGTCTCG,4,1279798
furpa,10.4,55,4,AGGATGGCCCAGTGCCAGGA,51,1280348
furpa,8.6,46,4,AGGACTGCTTCAGTTATTGC,42,1306484
furpa,7.6,41,4,AGCTTCAACTGCCTCAAGCG,37,1311034
furpa,7.6,41,4,AGCTTACTCACACTAACGTC,37,1340967
furpa,0.6,6,4,AGCTTAAAGGACAATATCCC,2,1281968
furpa,4.0,23,4,AGCTCTACATAGGAGTCGCG,19,1354432
furpa,0.4,5,4,AGCGGTCACACGACTTGTGT,1,1285633
furpa,0.4,5,4,AGCGCGTATCTGTACCGTCG,1,1273846
furpa,2.2,14,4,AGCGCAGCTGGGAGGTCCAG,10,1320105
furpa,5.8,32,4,AGCCGTAGTCACGAGTCCCA,28,1346570
furpa,5.0,28,4,AGCACTTTTAAGGCTAAACG,24,1356745
furpa,6.4,35,4,AGATCCAGGCGGGTTCGCAG,31,1275042
furpa,3.4,20,4,AGATAGGAAACTGCTGTTTG,16,1320686
furpa,1.4,10,4,AGAGCGTGGTGGCGTTTCCG,6,1319481
furpa,14.0,73,4,AGAGCCCAGAATTCCAGAAG,69,1321341
furpa,5.2,29,4,AGAGATACTACTCTTATTGC,25,1288971
furpa,9.2,49,4,AGACTGACCATCATTCTACT,45,1291221
furpa,1.8,12,4,AGACCTGCCATATGCATTTG,8,1276785
furpa,0.8,7,4,AGACCGTGCACTCTCGGTGC,3,1325890
furpa,1.2,9,4,AGACATTTGTTTTAGACGGG,5,1338146
furpa,2.4,15,4,AGACAATGCAGTGCTGCGGG,11,1354239
furpa,8.4,45,4,AGAATGACGGCGGCCTCTAA,41,1333979
furpa,19.2,99,4,AGAACTTGCAGAGAAAAAAG,95,1348983
furpa,3.0,18,4,ACTTGATAGGTTCTCCCTCA,14,1351230
furpa,3.4,20,4,ACTCGCCCATGGCACGCGCA,16,1315632
furpa,0.4,5,4,ACTCGAATGTGGCCCCTACC,1,1347963
furpa,3.2,19,4,ACTATGCCGATTCCGTTATA,15,1287644
furpa,2.6,16,4,ACGCGCGGCCAGCCACTCGG,12,1276124
furpa,0.4,5,4,ACGCATCTCTAGGCGAACCA,1,1306808
furpa,1.2,9,4,ACCTTTTCAGATACATGTTG,5,1290133
furpa,4.4,25,4,ACCTGCATTGCAACTACTTT,21,1317552
furpa,2.4,15,4,ACCGTTGCCGATTGCCTGAA,11,1315427
furpa,10.8,57,4,ACCGCGTGGGCATCCGAGAC,53,1277299
furpa,0.6,6,4,ACCGCAGAGGAAATAGCCGA,2,1336426
furpa,4.2,24,4,ACCCAGCTCTATAAAGGTGT,20,1340709
furpa,9.6,51,4,ACCAGCAGCTTTTCTGACAA,47,1302482
furpa,2.0,13,4,ACCACTTCGGGTTACGGGGT,9,1335219
furpa,12.4,65,4,ACATTACTGGATTCCAGCGG,61,1283682
furpa,2.8,17,4,ACAGAGGCAGAACGTAAGGA,13,1286152
furpa,6.2,34,4,ACAGAAATACACTTGTCATC,30,1348793
furpa,2.0,13,4,ACACCGGATGGTGAAATTAG,9,1314976
furpa,12.8,67,4,ACACCCTGGTGGCGGGGGGC,63,1283825
furpa,3.6,21,4,ACAAAATCCGTTCTAGGCAT,17,1298781
furpa,1.0,8,4,AATTTTTTAACTTAGGGTAT,4,1354453
furpa,1.6,11,4,AATTCAGGCACATTTTGGGT,7,1278789
furpa,13.4,70,4,AATGATCTAATGATAACCTC,66,1341453
furpa,1.8,12,4,AATCGGGGGACAAAGGGCTT,8,1307329
furpa,2.6,16,4,AATCGAGCCTACGGTCACAA,12,1278548
furpa,0.6,6,4,AATATGAAGATCACGTTGAC,2,1327811
furpa,15.8,82,4,AATACTTCGCGCCAATGTGG,78,1311115
furpa,2.8,17,4,AATACTGGCCCTGGTCCGTC,13,1308791
furpa,7.4,40,4,AATAAGGTTCGCCAAACTAA,36,1313951
furpa,3.6,21,4,AATAAGCTTTGAAGTGCGTA,17,1344241
furpa,8.8,47,4,AAGTTGTTGACGATGTGTCT,43,1278764
furpa,0.8,7,4,AAGGTACTCACGTGAGCGAA,3,1272455
furpa,2.0,13,4,AAGCGACGCAACTGAAGTCA,9,1355627
furpa,3.2,19,4,AAGAAGGTTCACACGGAGGC,15,1302133
furpa,5.4,30,4,AACTTTGTTGATCGTAGTTT,26,1274493
furpa,1.6,11,4,AACTCGCTGAGAGAGAAGAA,7,1351899
furpa,2.2,14,4,AACGGATAGAATATTGACAA,10,1296238
furpa,5.0,28,4,AACCAAAAGCATCCGGTCCA,24,1287247
furpa,2.0,13,4,AACATTCACCAGTGCGTCAC,9,1298567
furpa,3.6,21,4,AACATGGTGGGCACATAGAA,17,1312085
furpa,0.4,5,4,AAATGTGCACCGGTACATTG,1,1315522
furpa,3.6,21,4,AAAGGGGAATACTCTAAATG,17,1331270
furpa,0.4,5,4,AAAGGAGCTACCGAGAGCCC,1,1301148
furpa,0.4,5,4,AAACTGGCGTGGTGTAGTAC,1,1323499
furpa,6.0,33,4,AAACTACTCCGAAATTTTCT,29,1335158
furpa,7.6,41,4,AAACGGATACGCAACCGAGA,37,1283157
furpa,2.2,14,4,AAAATTGTTTGCCGCATCGG,10,1286578
furpa,4.6,26,4,AAAAGGAGAGTCTCGTAGAT,22,1316630
furpa,2.4,15,4,AAAACTCTCTCGGGGATGCC,11,1281085
furpa,6.25,27,3,TTTTCTCAACCGGATAGTAC,24,1336150
furpa,2.25,11,3,TTTTCCCATCACATTACTCA,8,1278177
furpa,0.5,4,3,TTTGGTCCTACGTATGCCGA,1,1333234
furpa,1.75,9,3,TTTCGAGATGGTACATAAAC,6,1333502
furpa,9.0,38,3,TTTAATAACCCACACCCTCC,35,1280858
furpa,10.75,45,3,TTTAAGGGGCCTGGGCTAAT,42,1323732
furpa,6.0,26,3,TTTAAAGAAATGTCGCTTGA,23,1342391
furpa,2.25,11,3,TTGTGTAGTTATCTAGTGTA,8,1284725
furpa,5.75,25,3,TTGGTCAGAAATATGGACTA,22,1337233
furpa,4.25,19,3,TTGGGCCTCCTGTAAGATAT,16,1314338
furpa,1.25,7,3,TTGGCTCAACCCATTAGGGG,4,1347189
furpa,3.25,15,3,TTGCTCATAAAAGACGTTTT,12,1323667
furpa,7.25,31,3,TTGATGTCCCTGTCCTGCCT,28,1295159
furpa,12.5,52,3,TTGAGATCAAAATTGTCGAG,49,1326448
furpa,14.25,59,3,TTGACTGGTAAACAGAACCC,56,1305835
furpa,3.25,15,3,TTCTCTGGCTGAAGCTTACA,12,1284963
furpa,5.5,24,3,TTCGCCGCTTAGTACTACCT,21,1287267
furpa,0.5,4,3,TTATTACTTGCCTCATTTGA,1,1304719
furpa,7.0,30,3,TTAGGGGGCCCCTATGGGAT,27,1291311
furpa,4.25,19,3,TTACATGCAAGGACTGAAGA,16,1337612
furpa,1.5,8,3,TTAACTCGCGGCGCTTACTT,5,1308551
furpa,3.25,15,3,TGTTACGCCGATATTCCCAG,12,1304946
furpa,8.75,37,3,TGTGTATTTCGACCGTGCTG,34,1286708
furpa,9.75,41,3,TGTCTTTGCCTGTCGTTCTG,38,1329556
furpa,7.5,32,3,TGTCTGCGTTACCCTGCGTG,29,1312566
furpa,1.75,9,3,TGTCATAAGGGTTTGGCAAA,6,1322290
furpa,11.5,48,3,TGGTCGGATACTGGAATTTC,45,1293708
furpa,0.5,4,3,TGGTAAAGCCAACGAGTCGT,1,1347086
furpa,0.5,4,3,TGGCCACAGTTACCCGTCCT,1,1298754
furpa,2.75,13,3,TGGAAGTACAGACTTGCCCC,10,1285036
furpa,9.75,41,3,TGCTTTACTGGAGTACTTTT,38,1332261
furpa,6.0,26,3,TGCTACCACACCTTACTTAC,23,1337832
furpa,0.5,4,3,TGCTAAGGAGTCCCGCGGAC,1,1319840
furpa,4.75,21,3,TGCGATAATAGAGTATAGCC,18,1306616
furpa,18.0,74,3,TGCGAAGTTTCCAGTCTGAT,71,1312537
furpa,6.0,26,3,TGCATGCTCCTTAACTTTAC,23,1335266
furpa,1.25,7,3,TGCAAATACTCTCAGGAATG,4,1300188
furpa,4.75,21,3,TGAGGATGGGACTGATTGGC,18,1290105
furpa,0.75,5,3,TGAGAACATGGGATGAGCTA,2,1301399
furpa,2.0,10,3,TGACGGCGGCTTGTGATCAG,7,1321257
furpa,0.5,4,3,TGACATATAACGCATAAGAA,1,1353757
furpa,7.0,30,3,TGAACTTAGCCCTTAACGTT,27,1345757
furpa,9.5,40,3,TGAACTAGAGCTCCGTGTGT,37,1322294
furpa,8.5,36,3,TCTTCGTATACCGCGACAAC,33,1288267
furpa,4.0,18,3,TCTGTCAATATTTTTCGGTG,15,1354300
furpa,1.75,9,3,TCTCGGTTGGTTTTGCGAGA,6,1272219
furpa,0.75,5,3,TCTATTCCGTGATGACATCT,2,1293973
furpa,8.75,37,3,TCTAATTTCCCGGGGAGGCT,34,1298545
furpa,0.5,4,3,TCTAAATAAGAGGCATTCGT,1,1337822
furpa,2.75,13,3,TCGTAGGGACCCTCGTCCCT,10,1321267
furpa,6.5,28,3,TCGGGCGCTTTACCTGCAGT,25,1349022
furpa,0.75,5,3,TCGCGGCAGTAGTAAGGGTC,2,1343971
furpa,8.25,35,3,TCGCAGTCGCTATACATGAC,32,1283507
furpa,9.0,38,3,TCGACCCCCGAAGCCTCAGA,35,1336780
furpa,2.0,10,3,TCCTAACGTAATGGCTTAGG,7,1308597
furpa,4.75,21,3,TCCGATCAGCGCAATACGAG,18,1310482
furpa,4.75,21,3,TCCCTTCTTGCGAAAGCAAA,18,1318261
furpa,4.5,20,3,TCCCGCCATAGGTGTGAAGG,17,1318877
furpa,23.5,96,3,TCCAGTGGTTAAAAGTCACT,93,1334567
furpa,2.0,10,3,TCATGGATTATGATCCCTCT,7,1283227
furpa,1.25,7,3,TCATCTATGACGACGCTCAG,4,1320436
furpa,0.5,4,3,TCATATTGTTGGGTTAGCCA,1,1316827
furpa,10.25,43,3,TCACGGGTAGCTCGTCTGGA,40,1314299
furpa,10.5,44,3,TCACGCTTGAGCAAGACTCA,41,1342166
furpa,1.75,9,3,TCACGCCCCCCATGAAGTTC,6,1271326
furpa,28.75,117,3,TCACCTTTAAGTTACGCGTG,114,1305358
furpa,6.0,26,3,TCAATATGGCCCATCGTGCT,23,1331007
furpa,2.0,10,3,TCAAGGGATTGTACAATAGT,7,1290809
furpa,2.25,11,3,TATTGTTCTGATTAGGCGAT,8,1332397
furpa,10.0,42,3,TATTGAAACGGCGGAACGAC,39,1295604
furpa,2.25,11,3,TATGTGGACAATTATGCCGC,8,1350263
furpa,1.5,8,3,TATCATGTTCGCGCCTGTAC,5,1344454
furpa,4.0,18,3,TATATTGGGAGTCTTACTTG,15,1308033
furpa,3.75,17,3,TAGGGTCTGCCAAGTCGGTG,14,1342167
furpa,1.0,6,3,TACTCAAAAAAGATCGTGTA,3,1296492
furpa,4.25,19,3,TACGTACCTTATTGCGGCGT,16,1290103
furpa,0.5,4,3,TACCTCCATGGACACATGCG,1,1339907
furpa,6.0,26,3,TACCGATTGAACTCGAACAA,23,1302191
furpa,5.25,23,3,TACCCTCTGGGAGTTGTGTA,20,1302495
furpa,1.25,7,3,TACCCAGGAATCTAGGAAAA,4,1310790
furpa,1.5,8,3,TACACGCGCAATTGGTCTCG,5,1295662
furpa,8.25,35,3,TACACACATGTCTGGGGGAA,32,1307608
furpa,1.0,6,3,TAATGAAGGGAAAGGGTGTA,3,1305302
furpa,1.5,8,3,TAAGGTAGTGAACGCTATTA,5,1279926
furpa,5.5,24,3,TAAGGTAACGTACCACGGGT,21,1289173
furpa,16.5,68,3,TAAGCTCGATGTCGGGCTGT,65,1354882
furpa,0.5,4,3,TAACAGGGTCCTGCCAAGAA,1,1344344
furpa,7.0,30,3,TAAAGCCAGCTTCTAATAGA,27,1276009
furpa,5.5,24,3,TAAACGTTAGTTATGATTCC,21,1311698
furpa,21.5,88,3,GTTTTTGCGCGCATTAATGG,85,1343425
furpa,0.5,4,3,GTTTGAAAAATAGACCGTGA,1,1306114
furpa,6.0,26,3,GTTCCGATTCTTCGGCCAAT,23,1327955
furpa,0.5,4,3,GTTCAGGCTGATTTCGGGCA,1,1289468
furpa,6.75,29,3,GTTATGGCTGTTAGTAATGG,26,1353193
furpa,3.5,16,3,GTTAGAGTCCACGTCCCGTT,13,1334722
furpa,18.0,74,3,GTTACAGCGGAAACTCATAT,71,1345668
furpa,3.75,17,3,GTGTAGCACTCGTCTAATGG,14,1335218
furpa,0.5,4,3,GTGTAAGAGGCTACTTGCCT,1,1311657
furpa,5.25,23,3,GTGGGCAGGCAGGTTTGCTT,20,1276675
furpa,7.5,32,3,GTGCTTAGTGATAACACGTA,29,1296130
furpa,0.75,5,3,GTGCTGGGGTTCGTTCCTAC,2,1309992
furpa,0.5,4,3,GTGCGGGTCGAGCCTATAAC,1,1336495
furpa,2.25,11,3,GTGACGTTCTCCCATTTGGA,8,1292546
furpa,0.75,5,3,GTGACCCGTACTCAGTGACA,2,1284956
furpa,1.25,7,3,GTCTTCGGTCGGTAACCCTA,4,1289676
furpa,11.25,47,3,GTCTCACGACCAACAGTACT,44,1348605
furpa,19.5,80,3,GTCGCCTATTTTCAGGCTGG,77,1296418
furpa,9.5,40,3,GTCATCGATTGATGCTATAC,37,1318092
furpa,7.5,32,3,GTATTTGGATAAGTGCAACT,29,1304611
furpa,2.0,10,3,GTATGTTTAATTCACTTTCT,7,1281647
furpa,10.25,43,3,GTATACCATGAGCTTTATTT,40,1332785
furpa,0.5,4,3,GTATACAGCAGATCACGTGT,1,1338209
furpa,0.5,4,3,GTAGTAGATCATTTCCATGG,1,1314796
furpa,0.5,4,3,GTAATAGCCAGCAAAAGGAC,1,1331579
furpa,2.25,11,3,GTAAATCTTGTTCTTCGTAC,8,1314569
furpa,0.5,4,3,GTAAAAAACCTGAACATCAT,1,1271609
furpa,2.75,13,3,GGTTAGGTACGGACCTCTGG,10,1355054
furpa,6.5,28,3,GGTTAGGAACACCCTGGTCT,25,1281799
furpa,3.75,17,3,GGTGCCCCGGGCAGCCCATT,14,1342834
furpa,4.75,21,3,GGTCTCACGAGGGTTGAGCG,18,1295130
furpa,2.25,11,3,GGTCGTACGACGTGTCATGG,8,1274555
furpa,0.5,4,3,GGTAGGCCTTGAGCTGACGA,1,1303391
furpa,6.25,27,3,GGTAGACCGCATATGTGCCT,24,1338887
furpa,0.75,5,3,GGGTTTAGCTTCAACTTTAA,2,1293015
furpa,3.0,14,3,GGGTCTATCATTCTTGGGGG,11,1319381
furpa,0.5,4,3,GGGGGGCTCCTGCACCGTAT,1,1319824
furpa,13.0,54,3,GGGCTATCCTACTTACGAAG,51,1328332
furpa,6.0,26,3,GGGCATTCCGTCATCTCGAT,23,1286192
furpa,17.25,71,3,GGCTCATTCAACTGGGCTCC,68,1331481
furpa,16.5,68,3,GGCCTGCGGTAAGCGAACAT,65,1322251
furpa,7.5,32,3,GGCCATCCAGAATGACGACT,29,1275445
furpa,0.5,4,3,GGCAAGGTTGACGAGTGCGC,1,1286363
furpa,0.5,4,3,GGCAACTTTCCCAATAGTCT,1,1296821
furpa,0.5,4,3,GGAGAGGACAAAGAGTTATA,1,1328203
furpa,0.5,4,3,GGACTTGACTCGAGGTAACT,1,1306210
furpa,11.0,46,3,GGACTCCATTCGAGTTGTAG,43,1330032
furpa,15.0,62,3,GGACCAGTGCGCATTCTCCG,59,1308277
furpa,1.0,6,3,GGAAGTGTCGATAAAGTTGT,3,1345186
furpa,5.75,25,3,GCTTCGAAGTCAAGCTCGAT,22,1329545
furpa,32.0,130,3,GCTCTTGGTAAAAGTTACAT,127,1327886
furpa,1.75,9,3,GCTCTACGCCAGGGCTTGTG,6,1292825
furpa,13.25,55,3,GCTCGATGGGCCGCCAGATT,52,1288438
furpa,16.0,66,3,GCTCCCAGTTCGGCTATTCT,63,1281881
furpa,4.0,18,3,GCTCACGAATTCTAGGTTAC,15,1297898
furpa,7.25,31,3,GCTATGTTATATTCTTGATT,28,1313338
furpa,4.0,18,3,GCTAGTGCGCGCTGCGGTAT,15,1309023
furpa,0.75,5,3,GCTACTCCTTTACCTACCTT,2,1330870
furpa,8.0,34,3,GCGTTTATTGATTTTTTAAT,31,1311088
furpa,4.25,19,3,GCGTGTTTGAATCTCAGTAC,16,1338153
furpa,3.5,16,3,GCGTAACGTGCCCATGCGGT,13,1340213
furpa,3.75,17,3,GCGGGGGAATGGTGCCGGGT,14,1338083
furpa,6.5,28,3,GCGGCCTCCTGCATGCGGAG,25,1291569
furpa,11.0,46,3,GCGCTTCATTGAATAGGCAT,43,1338518
furpa,10.25,43,3,GCGATGCATATGCTCACAGT,40,1278859
furpa,38.5,156,3,GCGAGCGGACTTGGGCGAGA,153,1288446
furpa,9.25,39,3,GCCTGTGCCACAATCGCCGG,36,1321488
furpa,4.0,18,3,GCCGGAAATCGGGCTTAGTG,15,1338176
furpa,14.25,59,3,GCCGACTGTAACGCGCCCGG,56,1309710
furpa,1.0,6,3,GCCCATATGCTTGTGCATTA,3,1321858
furpa,11.25,47,3,GCATGCTCTGAAATCGTGAA,44,1277930
furpa,15.0,62,3,GCATAACCCTTCTGGCACCC,59,1320464
furpa,11.5,48,3,GCACTACTATCGCTTCATTG,45,1284257
furpa,5.75,25,3,GCACGGGAGGGGACATCCTA,22,1296128
furpa,8.75,37,3,GATTCGTTAGCGTTATTATC,34,1318417
furpa,5.25,23,3,GATGGAGCTATCCGTCGTTG,20,1333686
furpa,2.0,10,3,GATCTGGCGGACTCTTGCCC,7,1306585
furpa,4.75,21,3,GATCCTGAGCGTTCACTGCT,18,1341588
furpa,0.5,4,3,GATCCACTCCATAACTAAAC,1,1300303
furpa,1.5,8,3,GATAAATGGTCTCGTCGGAT,5,1331795
furpa,0.5,4,3,GAGGTTAATAAGGACAAGTA,1,1276587
furpa,0.5,4,3,GACGAGGGTGACGGCCTTTT,1,1292761
furpa,6.75,29,3,GACCGTCGTACGGTATTTAC,26,1305865
furpa,7.25,31,3,GACCCGTTTCGCGCAAAGAT,28,1289913
furpa,5.0,22,3,GACACCATGTGTAGCCACTT,19,1327630
furpa,8.25,35,3,GAAGGATAACTGACGTGCCA,32,1336977
furpa,14.75,61,3,GAAGACTTAAATGGGCGCGA,58,1317849
furpa,7.5,32,3,GAAGAAGCGCTATAGATAAG,29,1355634
furpa,1.25,7,3,GAACGGACGTCCTAAACGAT,4,1307975
furpa,1.5,8,3,GAACCCATAACATGGCTCTA,5,1324231
furpa,18.75,77,3,GAACAGAGTCAGGATACTAC,74,1339611
furpa,11.25,47,3,GAAACTCGGGAAGATCTGTA,44,1349257
furpa,7.0,30,3,CTTTTCTGATTTGGCCCTAT,27,1301162
furpa,2.0,10,3,CTTGTCGGTTAACTAACCAA,7,1325677
furpa,4.25,19,3,CTTCCGGACATAGGAAGCAG,16,1316162
furpa,1.25,7,3,CTTCAGGGTATTAATTTATA,4,1339766
furpa,4.5,20,3,CTTATTAACACCGCAGGGGA,17,1299724
furpa,16.25,67,3,CTGTGACCATACCCTATTGG,64,1356583
furpa,4.25,19,3,CTGTCGCGGGCGTTTGCTCC,16,1341331
furpa,5.5,24,3,CTGGTTCTATAGGGATGGGG,21,1341270
furpa,0.5,4,3,CTGGTGATCCTGGGCTGCCC,1,1297188
furpa,2.25,11,3,CTGGATGAGGAAGCTAGTTG,8,1305938
furpa,5.75,25,3,CTGCGTCTAATCACAAAAAG,22,1339259
furpa,16.75,69,3,CTGCGAAAGATAGATTCCAT,66,1336952
furpa,8.0,34,3,CTGCCTGGCCCCCCATCTGA,31,1338883
furpa,1.5,8,3,CTGCCCCGGCGATCGGAGTA,5,1294655
furpa,1.75,9,3,CTGACGGCAAATCTTGTATA,6,1276889
furpa,9.5,40,3,CTGACAAAGACGAAGCAAAA,37,1349281
furpa,5.0,22,3,CTGAAACCGCTTCCGCCCGA,19,1295909
furpa,7.0,30,3,CTCTCATCAACGGCTACTAG,27,1346106
furpa,11.5,48,3,CTCGGCTGTACACCATGCCA,45,1312720
furpa,4.5,20,3,CTCCAATTGTAATAAAGCCT,17,1334238
furpa,7.25,31,3,CTCCAAGCCGGAGTTAGGGA,28,1312713
furpa,1.75,9,3,CTCATTGTGAACATCATCAC,6,1286032
furpa,31.25,127,3,CTCAGCCTGCTCACAAACGA,124,1306706
furpa,5.5,24,3,CTCACTTGCCCCCAGACGAG,21,1320751
furpa,3.25,15,3,CTATGAAGAATGTACAGGAT,12,1332409
furpa,0.5,4,3,CTAGGCGCGTTTCAGGATCT,1,1352744
furpa,0.5,4,3,CTAGCGATGCCAGAAGTCGT,1,1290041
furpa,7.75,33,3,CTAGATGTACGGCCGCTTGT,30,1312571
furpa,5.25,23,3,CTACTGTTGTACGACGTAAC,20,1296367
furpa,0.5,4,3,CTACAAACCGTCTGCGGTTA,1,1342971
furpa,0.5,4,3,CTAACTTGTCAATGAGCGCT,1,1324450
furpa,1.75,9,3,CGTTGTGAGATGGATTGTGG,6,1304120
furpa,3.25,15,3,CGTTGTCTGGGGCGCTGCTA,12,1348664
furpa,6.0,26,3,CGTTCGCACAGATGGGGTCT,23,1291292
furpa,7.25,31,3,CGTTAGGTCGTACCCTAAAG,28,1328881
furpa,0.75,5,3,CGTTAAACTGCGAACAAGAG,2,1349573
furpa,2.0,10,3,CGTGTATCAATGCCCTCTCT,7,1320476
furpa,2.0,10,3,CGTGGGATCCCTATATAATT,7,1281985
furpa,1.0,6,3,CGTGACCAATGTAGGTGCTC,3,1352087
furpa,4.0,18,3,CGTCTAAAGTCCCTTGGGCA,15,1349389
furpa,2.75,13,3,CGTCCTAGAATGTACCCACA,10,1344566
furpa,0.75,5,3,CGTATTTCGACAGTTAAGTG,2,1325779
furpa,4.0,18,3,CGTAACAATGGCGGGCTGTC,15,1331175
furpa,9.5,40,3,CGGTGTAATCCCCGAATTAT,37,1337392
furpa,7.5,32,3,CGGTGGAGCATTTGGCGGTA,29,1325783
furpa,6.0,26,3,CGGTGCTTTTTTCGGTACAC,23,1298337
furpa,0.5,4,3,CGGTGAAAGCATAAGCGCCG,1,1322957
furpa,2.75,13,3,CGGTCCATCTGTACGCCGAC,10,1303865
furpa,17.75,73,3,CGGGTAGTGACTCCACGTTT,70,1330215
furpa,1.5,8,3,CGGGTAGAGCCTACTAACAC,5,1337018
furpa,2.75,13,3,CGGCTATGCCAAGATGACGC,10,1328658
furpa,2.5,12,3,CGGCGCTGAATTACCGGGGG,9,1353861
furpa,3.5,16,3,CGGCAGACCAGTTCCCTACA,13,1325786
furpa,6.0,26,3,CGGATCCACCTTTATACGGT,23,1292019
furpa,10.0,42,3,CGGAGGTCGTGTGCGTCGAC,39,1306493
furpa,1.0,6,3,CGCTTCTATTCTTCTCATGA,3,1345479
furpa,2.25,11,3,CGCTGGAAGTGGTCAACTAG,8,1333644
furpa,7.5,32,3,CGCTCTAACGCGGATCGGTG,29,1326327
furpa,5.5,24,3,CGCGTCGGAATTCTTTCATG,21,1325530
furpa,3.75,17,3,CGCGGTTTTATAGGCGCCGC,14,1290114
furpa,1.5,8,3,CGCCTCTGGAACAGGGCGCT,5,1337492
furpa,7.75,33,3,CGCCCGTGTCATTCGTTCGT,30,1321871
furpa,3.75,17,3,CGCAGAGCCATCCTGTTAGA,14,1314903
furpa,0.75,5,3,CGAGGGCTGAAGCGAGTGTA,2,1320429
furpa,4.5,20,3,CGACGATAGAGCCGTACGCA,17,1294669
furpa,15.0,62,3,CGAATGTTGTCGTAAGAGGT,59,1331148
furpa,7.5,32,3,CGAAATGGCTGTGAATAGGA,29,1321504
furpa,1.0,6,3,CCTGATTTCGGCCCACTGTG,3,1310191
furpa,0.5,4,3,CCTGAATCTCCAGACGACAG,1,1327199
furpa,5.0,22,3,CCTATCATTGTTAACATTAG,19,1324245
furpa,8.25,35,3,CCGTTTCCCTACACTGACTG,32,1292369
furpa,11.75,49,3,CCGTGGATAGCTCTCTAAAT,46,1327800
furpa,0.5,4,3,CCGTCATAATATGTATGAGC,1,1327060
furpa,2.5,12,3,CCGTCAATGGTGTGCGCGCT,9,1318576
furpa,2.25,11,3,CCGTAAGCTGGTCTCTAAGT,8,1284539
furpa,0.75,5,3,CCGCGCCAGGTTAGTACCCT,2,1303719
furpa,51.0,206,3,CCGCCACGCCCCATCCACTA,203,1315412
furpa,21.0,86,3,CCGCATTGATCACTCCAAGC,83,1288204
furpa,9.5,40,3,CCGCAGTGCTCGTCCAACTT,37,1281234
furpa,19.0,78,3,CCCTAAGATTAGTATCCCGT,75,1336880
furpa,2.25,11,3,CCCGATTTGGTTTGGACGTG,8,1301998
furpa,0.75,5,3,CCCGAGCTGGGCACCCCAGG,2,1277778
furpa,5.25,23,3,CCCGAATAGGCCGGGGCAGG,20,1278251
furpa,12.75,53,3,CCCGAAGGGGGGTGAATAGC,50,1286348
furpa,16.25,67,3,CCCCCGTTAAGCCTTTGTTC,64,1304069
furpa,4.25,19,3,CCCATTGTATCGGCGCAGAT,16,1276902
furpa,7.25,31,3,CCCAATGCGTTCGAAGTTAA,28,1335826
furpa,3.0,14,3,CCATTCAGGAAGCGGCGGAA,11,1281333
furpa,7.75,33,3,CCATGGTGCGGAAACGGGGC,30,1356487
furpa,0.75,5,3,CCATATTCTTATTGATGTTA,2,1281238
furpa,14.25,59,3,CCATACAGAGCACACCGGCG,56,1282891
furpa,22.0,90,3,CCACTTTGCTACAACTCGAG,87,1336066
furpa,12.5,52,3,CCACCAAAGTGAAGCACAAT,49,1306973
furpa,0.5,4,3,CCACAATCTAGGTCTCGTAC,1,1303917
furpa,0.5,4,3,CCAATGATGATGCCTAAGTT,1,1337289
furpa,0.5,4,3,CCAAATGACGACAGGGTCTC,1,1311442
furpa,1.0,6,3,CATTGGTGCCAACACGCTTG,3,1320180
furpa,0.75,5,3,CATTGATGCATGCGGGGAGC,2,1334250
furpa,0.5,4,3,CATGGCAGTAGAAGGATACA,1,1311935
furpa,0.5,4,3,CATGGCAGGTGCCGACTCTC,1,1280615
furpa,6.0,26,3,CATGACCAAGGACGAGTAGA,23,1355707
furpa,8.75,37,3,CATCAGAAATAAGGTTCTCT,34,1348116
furpa,12.75,53,3,CATATAAACGATCCGTGCAA,50,1281054
furpa,2.25,11,3,CATACGATAGTGGAGTTCGG,8,1306064
furpa,15.0,62,3,CAGTCCAGGCGTAAAGACGT,59,1271970
furpa,0.5,4,3,CAGGTCTAATATTCATATCG,1,1303276
furpa,1.5,8,3,CAGCGCGGTTATTAATCTTC,5,1336865
furpa,3.5,16,3,CAGCGATGTAGCTATAGCGG,13,1272342
furpa,6.0,26,3,CAGCCTCGTTCATTAGACCA,23,1353642
furpa,2.25,11,3,CAGCCGTTTAGTCGTGTGTG,8,1298209
furpa,1.0,6,3,CAGCCCCAGATGCCCGAACG,3,1320975
furpa,9.0,38,3,CAGACAGCTACCTATTTTGT,35,1322703
furpa,2.75,13,3,CACTAGCCCTAGATGCCCCT,10,1284983
furpa,6.25,27,3,CACCTCGCACCACGAAAACC,24,1309886
furpa,0.5,4,3,CACCGGTCACGAATTACCAT,1,1311661
furpa,4.0,18,3,CACCCGCAAGAAGAGTCCCG,15,1324464
furpa,22.25,91,3,CACAAACGTAGCGCAAATGA,88,1313704
furpa,8.5,36,3,CAATTTGCAGTAAAGGATGA,33,1334273
furpa,9.25,39,3,CAATTCGCTAGCCGTTGCGT,36,1280302
furpa,2.5,12,3,CAATATCGTTAAAAAGTAAC,9,1331844
furpa,3.5,16,3,CAAGTGGATAGGAACAGCCG,13,1286156
furpa,4.75,21,3,CAAGCTGGATCAACAACGAC,18,1322095
furpa,6.25,27,3,CAACCCTTCTCTGATTCTGG,24,1310675
furpa,7.5,32,3,CAAAGTCATCCCCTTTCTGT,29,1272074
furpa,7.0,30,3,CAAAATTTTGCCTGCCTTCG,27,1330664
furpa,10.0,42,3,CAAAAAACTTAGACCCCGGC,39,1275987
furpa,0.5,4,3,ATTTTAGCTCAAGAGCAACC,1,1328447
furpa,1.0,6,3,ATTTGTCTGAATCGCGTCCG,3,1327920
furpa,4.0,18,3,ATTTAATTCTCCTCTATTAG,15,1318977
furpa,2.25,11,3,ATTGTTGTCACACCATGGAT,8,1312703
furpa,19.25,79,3,ATTGGGGATGAATATGCCCT,76,1304411
furpa,7.5,32,3,ATTAGCGGTGTAATTTAAAC,29,1288403
furpa,1.25,7,3,ATTAAGGCAAGAAAGTGTAT,4,1354242
furpa,2.5,12,3,ATGTACACTAGAAGACTCGG,9,1326262
furpa,3.5,16,3,ATGGCACAGTGCGGACCACG,13,1343350
furpa,13.25,55,3,ATGGAGAAGGTAAACAACGT,52,1287455
furpa,15.25,63,3,ATGCAGCACTCTTAGGTAAA,60,1324970
furpa,1.75,9,3,ATGCACGAAAACGATTAGAA,6,1351953
furpa,1.25,7,3,ATGCAAGCAGTACAACAGCA,4,1287796
furpa,2.0,10,3,ATGATGAAGCGAGCCATACA,7,1293076
furpa,3.25,15,3,ATGAGCGTACCCATGTTCAC,12,1325563
furpa,1.75,9,3,ATGACGCGGATTGGAGTGAT,6,1325856
furpa,14.75,61,3,ATCCGATCGGAGGAATGGGG,58,1308272
furpa,0.5,4,3,ATCCGACTATCCTAGCGACT,1,1324085
furpa,2.0,10,3,ATATGAGGTTCAGTTCTTAG,7,1325002
furpa,3.75,17,3,ATATCGTCGGGATCGTTTTA,14,1351968
furpa,15.0,62,3,ATATCGAACGCGTACAAATC,59,1331833
furpa,6.0,26,3,ATAGGTACCGGGTTGTCTTA,23,1288809
furpa,3.5,16,3,ATAGCGTGAGAGCAAGTAGC,13,1333462
furpa,3.0,14,3,ATAGATCATTGCGAGTCATA,11,1299595
furpa,2.25,11,3,ATACTGGTAATATAGCGATG,8,1281508
furpa,4.25,19,3,ATACGGCCTGCCGAATTAAA,16,1296593
furpa,0.5,4,3,ATACACTCACAACTGCGAAG,1,1329486
furpa,1.75,9,3,ATAATCAAAGTGTGGGACCC,6,1276748
furpa,0.5,4,3,ATAAGTCTCATTCCAAGGTT,1,1293388
furpa,12.0,50,3,ATAAGCTCCGGCGAAAGGCT,47,1285375
furpa,2.5,12,3,AGTGTAGTGTACTCTATCCA,9,1340792
furpa,1.5,8,3,AGTGGGTTTTCGCATCTGGT,5,1355815
furpa,21.0,86,3,AGTGGCCCTCAGCTCCCTAT,83,1321910
furpa,1.25,7,3,AGTGCGCCGGGCTGTGTGAA,4,1295145
furpa,8.0,34,3,AGTGAGAATTACTTTCTTCT,31,1308964
furpa,1.0,6,3,AGTCCTGACCTCTGCTTCTA,3,1285926
furpa,4.25,19,3,AGTCACAATTAGACTAACCC,16,1304936
furpa,1.25,7,3,AGTAGTTCCCAGTGGGGGTC,4,1308587
furpa,6.25,27,3,AGTACAAGGTATCATCACAA,24,1272202
furpa,7.0,30,3,AGGTTATTTTAGCGCTTGTT,27,1351257
furpa,1.75,9,3,AGGGAGGCGTGTTGTCTAAG,6,1326238
furpa,0.75,5,3,AGGGACTTGGAGGATGCTCA,2,1328246
furpa,9.25,39,3,AGGACACGGGGAGGCGTATC,36,1354334
furpa,10.75,45,3,AGCTTAGGTACCCCGTCTGG,42,1325180
furpa,9.5,40,3,AGCTATGAGCCGGTACCGAC,37,1307226
furpa,0.5,4,3,AGCTACGACGTGGCTTGTGA,1,1322010
furpa,21.25,87,3,AGCTACATAGGAGAAATAGA,84,1290093
furpa,6.5,28,3,AGCCTTGCTGGTTTCCCAGG,25,1275097
furpa,2.5,12,3,AGCCGGCTACCTCTCGCTCA,9,1310667
furpa,4.0,18,3,AGCCGACTTTACATAGGGGA,15,1345187
furpa,0.5,4,3,AGCATAGATCACGTACCGTG,1,1346953
furpa,6.0,26,3,AGCAACCGGGTTGAAAAACG,23,1277934
furpa,3.75,17,3,AGATCGTTCTAGGGAGCGAG,14,1306693
furpa,0.5,4,3,AGAGGAACAGTCGGTCAGGT,1,1349814
furpa,6.25,27,3,AGAGCGAAATGATTGCCACC,24,1353177
furpa,0.75,5,3,AGAGAGACTTGCCAATGAAA,2,1318631
furpa,1.75,9,3,AGACTACATACTGCCCACGT,6,1288274
furpa,4.25,19,3,AGACCTCTTGGCCCGGTAGC,16,1316744
furpa,12.0,50,3,AGACAACGTTGCTTATCGCG,47,1293951
furpa,6.25,27,3,AGAAGCTAACGGTCAAACAT,24,1350947
furpa,1.0,6,3,ACTTCACTTGCGAACAGTCC,3,1356549
furpa,1.0,6,3,ACTGGTGGTGAGAGGCGAGA,3,1294930
furpa,2.5,12,3,ACTGATATAAGGCGCAAGGC,9,1304193
furpa,1.75,9,3,ACTCCTGACACTCTGGAAAG,6,1339583
furpa,4.25,19,3,ACGTCGTAGTCGCCTGTACA,16,1340124
furpa,21.0,86,3,ACGGGAGTAGCGTAGAATAG,83,1313767
furpa,8.75,37,3,ACGGCGTGTCTGTTTCGGAT,34,1302350
furpa,0.5,4,3,ACGGCGCCCACCAGCTCCCT,1,1295449
furpa,3.75,17,3,ACGCCGTATGTGCGTCCATT,14,1349691
furpa,5.5,24,3,ACGAGCAGTGATAGCTGGCC,21,1331808
furpa,19.5,80,3,ACCGACGAGAATGCGCGAGA,77,1355702
furpa,4.0,18,3,ACCCTAAGCCTTATTTGGCC,15,1307788
furpa,9.75,41,3,ACCCGGTAATCCGGCAAAAA,38,1297092
furpa,0.75,5,3,ACCCGGGAAGGTGGGCCGCA,2,1326136
furpa,0.5,4,3,ACCCCTGTCTTAGGACTGAA,1,1278600
furpa,7.75,33,3,ACCCCAGGACCCATGCAATA,30,1324541
furpa,4.25,19,3,ACCCACAGGTGGGGACACGA,16,1286047
furpa,24.0,98,3,ACCAGCTCTCCGGTGGGCGA,95,1299421
furpa,10.5,44,3,ACCAAGCCACGTATAATCTC,41,1311625
furpa,0.75,5,3,ACATTCAATCGATGCATATG,2,1306483
furpa,2.0,10,3,ACATTACTCCTCGTTGTTAT,7,1329521
furpa,4.0,18,3,ACATCTGTCAGAAAAGAGGT,15,1354884
furpa,5.75,25,3,ACAGTGATAACATTTCGATT,22,1345034
furpa,3.25,15,3,ACAGGTTGCGAACCGCGGTA,12,1322116
furpa,7.5,32,3,ACAGCCTTCTGAAGGCACTC,29,1290941
furpa,4.25,19,3,ACAGAGACTGTAGGGTAACA,16,1280887
furpa,6.0,26,3,ACAATGCTGACTCCCCCCAA,23,1320168
furpa,6.25,27,3,ACAAGTAAACTCATTGTCGT,24,1332115
furpa,0.75,5,3,ACAACTTTTTGGCGGCCGTG,2,1330240
furpa,16.0,66,3,AATTCGCACGATCCCGCTAG,63,1314635
furpa,7.5,32,3,AATTATGTCCCAGGGGCTGA,29,1281030
furpa,1.25,7,3,AATTAAATCAAGGTCCTCGC,4,1301035
furpa,3.5,16,3,AATGTAGCAGCTGCCTCGGA,13,1314295
furpa,3.75,17,3,AATGGTTTAAAGTTCCATTT,14,1308712
furpa,4.5,20,3,AATGCCAATGTAATACAGTG,17,1275302
furpa,3.25,15,3,AATGACTCATTAACGAACCA,12,1347287
furpa,0.5,4,3,AATCGCCTTTATCTCTACAA,1,1300162
furpa,7.75,33,3,AATCCTCTAGCTGGAGGGTT,30,1315578
furpa,13.5,56,3,AATCAAGAAGGAGGCGTCTG,53,1350212
furpa,5.0,22,3,AAGTGATTCGAGAAGATGAT,19,1350644
furpa,4.0,18,3,AAGCGTGGAAGCCCCCCTCT,15,1350898
furpa,0.5,4,3,AAGCCGGCCAAAAGTATGGC,1,1344391
furpa,4.0,18,3,AAGACGACTCAGGTGTCATT,15,1282276
furpa,16.25,67,3,AACTCTAGACTCTCGCAACT,64,1349461
furpa,2.75,13,3,AACGGGATCGCGCAATCGCT,10,1341941
furpa,12.0,50,3,AACGCTTGGACCTAGTTGGG,47,1350127
furpa,1.5,8,3,AACCTGAAAACTGTGCGCGG,5,1297642
furpa,1.75,9,3,AACCTATTTTGGACTGGGGA,6,1341581
furpa,24.0,98,3,AACCGGCAGTAACAATAGTG,95,1351774
furpa,1.75,9,3,AACCCTGCTGAATCAATTAG,6,1352061
furpa,0.5,4,3,AACCAGTAACCCACATAAGT,1,1280190
furpa,0.75,5,3,AACCACTTTGGTTATGTGTC,2,1347643
furpa,7.75,33,3,AACATTGCTGCTGGTCATTA,30,1337395
furpa,14.75,61,3,AACAGTGAGAAAAGCTTTAC,58,1304078
furpa,1.0,6,3,AAATTTTGCTTGGACCCAAT,3,1290034
furpa,3.5,16,3,AAAGTATCCTTCTGCTGTGA,13,1349007
furpa,1.25,7,3,AAAGATTGGTAAATCACTCC,4,1335786
furpa,1.25,7,3,AAAGAGGTGCACACAAGGAA,4,1287662
furpa,2.75,13,3,AAAGAGGTGACCCCGCCCGG,10,1330920
furpa,0.5,4,3,AAAGAGGCAGGTCGCGCAAA,1,1282272
furpa,0.5,4,3,AAACGCCACGAATAACCATA,1,1326853
furpa,0.6666666666666666,3,2,TTTTTGTGTACCGGGGGTGT,1,1280756
furpa,2.0,7,2,TTTTATCGGCCGGACGGTAT,5,1352570
furpa,2.0,7,2,TTTTACATGTTGCGGTGCAG,5,1357016
furpa,18.666666666666668,57,2,TTTGTGATCAATGCTACCAC,55,1305373
furpa,10.0,31,2,TTTGCAAAATTTAACGACTG,29,1355273
furpa,0.6666666666666666,3,2,TTTCCGGAGAAGGGTTACCA,1,1320496
furpa,8.333333333333334,26,2,TTTAGGTCGCACAGGTGGAG,24,1305372
furpa,5.333333333333333,17,2,TTTAATAGAAATGCATCGGT,15,1296415
furpa,10.666666666666666,33,2,TTGTTTTCTACCGTACGATA,31,1330149
furpa,7.0,22,2,TTGGGGACCCTTGTGTGGAG,20,1334341
furpa,2.3333333333333335,8,2,TTGGGAACCCTTTCCTCGGG,6,1303370
furpa,1.6666666666666667,6,2,TTGGACCGCTGGGGTTCGGA,4,1300277
furpa,5.666666666666667,18,2,TTGATAGCTAAAGTCTTTTT,16,1321407
furpa,1.6666666666666667,6,2,TTGACACAGTTATCTAGCCA,4,1338103
furpa,2.3333333333333335,8,2,TTCTCAAGTCCCAATAGAAC,6,1317645
furpa,0.6666666666666666,3,2,TTCGTACCTCAGTGGCGACA,1,1274432
furpa,20.666666666666668,63,2,TTCGGGTGTCGGTCATTCAG,61,1279505
furpa,2.6666666666666665,9,2,TTCGAGATGGAATACGAGTC,7,1277268
furpa,6.666666666666667,21,2,TTCCTAAATGTTAGCAGTAA,19,1332685
furpa,0.6666666666666666,3,2,TTCATCTTGCGCTTTTTACC,1,1331614
furpa,1.0,4,2,TTCACCGAGGAATCTGAAGT,2,1335262
furpa,4.333333333333333,14,2,TTATTTTTGAAGTACTATGA,12,1283041
furpa,4.0,13,2,TTATTTAATTGTTCCGCAAA,11,1274403
furpa,13.0,40,2,TTATTAACATGTTTTAGGCC,38,1308646
furpa,11.666666666666666,36,2,TTATCCCTGAATGTTCCAGG,34,1338120
furpa,7.0,22,2,TTAGTCTGGGTAAGCCGCTA,20,1316962
furpa,1.0,4,2,TTACTTAGTCTATAGGGTCT,2,1324633
furpa,8.333333333333334,26,2,TTACTGGCGGTGGAGTAGTT,24,1352407
furpa,16.0,49,2,TTACAAGCTATCAGCGGGGC,47,1354287
furpa,1.3333333333333333,5,2,TTAATTTGTGCTCATAGAAC,3,1340257
furpa,0.6666666666666666,3,2,TTAAATGGAAAAGCAGCAAA,1,1349859
furpa,9.0,28,2,TGTTGGCACTTCAGGTTCAC,26,1277545
furpa,7.0,22,2,TGTTCGCCGAGTACGACCAA,20,1273763
furpa,12.333333333333334,38,2,TGTGCGCGACAGAGGCCTCA,36,1320919
furpa,0.6666666666666666,3,2,TGTCTTAGCTGACGAGAAAG,1,1314599
furpa,14.666666666666666,45,2,TGTAGATCAGGTATCTCAAA,43,1276262
furpa,25.666666666666668,78,2,TGGTTCGGTAAACTTGGCAG,76,1311439
furpa,3.6666666666666665,12,2,TGGTCTTTAGCCCAAGGGCC,10,1348397
furpa,6.666666666666667,21,2,TGGTCAGAACGGTCCACGGG,19,1357536
furpa,4.666666666666667,15,2,TGGTACGCTTGAGGCTATTG,13,1338983
furpa,22.333333333333332,68,2,TGGGTCGGAAGGAATTAAAT,66,1297788
furpa,20.0,61,2,TGGGAAGCCGTCCGGTAGAC,59,1281922
furpa,4.0,13,2,TGGCGCGTTTGTGCTGACCC,11,1332093
furpa,9.0,28,2,TGGAGGTTACATCGTGGGTT,26,1306823
furpa,8.666666666666666,27,2,TGCGAGTGTTTAGAGTGGAT,25,1332959
furpa,0.6666666666666666,3,2,TGCGAGCACCTATGACCGGG,1,1328821
furpa,2.0,7,2,TGCCTAGATTGGGGCTAAGA,5,1334374
furpa,0.6666666666666666,3,2,TGCAGTCCTTGTAGTCGCAA,1,1289087
furpa,4.0,13,2,TGATTGAAAGTGGTATACCA,11,1332682
furpa,2.3333333333333335,8,2,TGAGAGGCCCTCCTTCCATG,6,1271548
furpa,0.6666666666666666,3,2,TGACTATGGCACGACTACAG,1,1287457
furpa,15.666666666666666,48,2,TGACGTAAAGCTTGGTACCC,46,1356338
furpa,0.6666666666666666,3,2,TCTCTATAACCTCGCAGTCC,1,1330906
furpa,7.666666666666667,24,2,TCTCGCCTCGACATTCAGGA,22,1273802
furpa,26.333333333333332,80,2,TCTATGCTGCGATTCCCTAA,78,1288284
furpa,10.333333333333334,32,2,TCTAGGTGTGAATGTTTGCA,30,1272149
furpa,3.3333333333333335,11,2,TCGTTTGGGCACCGTATCTG,9,1344873
furpa,1.0,4,2,TCGTTAAGTAGTACCACCTG,2,1323931
furpa,19.0,58,2,TCGTATGCAGGGGAGTCCAG,56,1274276
furpa,3.0,10,2,TCGTATAGAATTCGTACCAT,8,1309397
furpa,7.666666666666667,24,2,TCGGTTTGCACCCTGTATAT,22,1354213
furpa,10.666666666666666,33,2,TCGGTCCAACTCTACGGGTC,31,1343270
furpa,5.333333333333333,17,2,TCGCTTCAAAAATGTCAGAG,15,1276814
furpa,10.666666666666666,33,2,TCGCGCCTGCGACACGAGAT,31,1348181
furpa,11.0,34,2,TCCTGCAAAGGAACGGAACT,32,1340665
furpa,6.333333333333333,20,2,TCCTCTCTGTCATTACTAGC,18,1325852
furpa,3.6666666666666665,12,2,TCCGTCTTCAGCTTGTCCAC,10,1299713
furpa,11.333333333333334,35,2,TCCGAGTTTAGTGTCGCCCC,33,1333456
furpa,9.333333333333334,29,2,TCACCTCAGACTGCCCGCTG,27,1327933
furpa,24.666666666666668,75,2,TCAATGTGGGTCCTGAGTCT,73,1340121
furpa,5.333333333333333,17,2,TCAAGTACCTGAATGCTAGA,15,1321396
furpa,7.666666666666667,24,2,TCAACTTCCTTGCTGACGTC,22,1312935
furpa,29.666666666666668,90,2,TCAACTCCTCGGCCTGAGAA,88,1347181
furpa,33.333333333333336,101,2,TCAACAACAGGTGTCGTTAC,99,1322252
furpa,14.0,43,2,TATTATGTGTGCGTCTCGTC,41,1294197
furpa,2.3333333333333335,8,2,TATGTGTCCTCCCGGGAAAT,6,1356366
furpa,0.6666666666666666,3,2,TATGTCCTACGAAGTCGCGA,1,1318949
furpa,0.6666666666666666,3,2,TATGCTAGGAGGAAAGGATC,1,1338946
furpa,4.0,13,2,TATGACCCACTGCGGACCTC,11,1310135
furpa,8.333333333333334,26,2,TATGAAGGAGCTGCCCCTCC,24,1279197
furpa,1.3333333333333333,5,2,TATCGTTCCGTCGGAAGCGT,3,1295642
furpa,4.0,13,2,TATATCTTGGTAGATTAGAG,11,1318088
furpa,1.6666666666666667,6,2,TAGGGGCATTTGGGCTCTAA,4,1272116
furpa,2.0,7,2,TAGGCTCAGTGATGTCCCGG,5,1286369
furpa,1.0,4,2,TAGGACGAGTTGCTGGTCCT,2,1348071
furpa,11.666666666666666,36,2,TACTTCTCATTATAAGCAAG,34,1326113
furpa,0.6666666666666666,3,2,TACGGTGGTTCAACGGTCTT,1,1309124
furpa,6.333333333333333,20,2,TACAGTAATCAGCGAAAAAA,18,1350679
furpa,5.666666666666667,18,2,TAATGTACCGTCTGGATCCA,16,1271876
furpa,5.0,16,2,TAATCAAGCGCCCTTCTTTT,14,1322405
furpa,3.3333333333333335,11,2,TAAGCGCCAGGAGGCACACG,9,1339241
furpa,14.333333333333334,44,2,TAAGAGCGTGGGCAGACGCA,42,1308776
furpa,8.333333333333334,26,2,TAAGACGTGAGGCGTATTCA,24,1272497
furpa,0.6666666666666666,3,2,TAAAATCCCCGATTGGACCT,1,1339469
furpa,1.0,4,2,GTTGCGTCAGCGAGCGACAT,2,1280528
furpa,1.3333333333333333,5,2,GTTGATAGGTCTGGGGTAAA,3,1286209
furpa,7.0,22,2,GTTCTTTTCGAGACAGCTTT,20,1345719
furpa,5.333333333333333,17,2,GTTCCACCGTCAGACTTGAA,15,1281931
furpa,3.0,10,2,GTTCAAGCTATGAGCGTCAT,8,1277925
furpa,1.0,4,2,GTTAGCAAACTGAGGCGGTG,2,1337391
furpa,11.333333333333334,35,2,GTTACTCGGGCACGGGACCC,33,1305825
furpa,15.333333333333334,47,2,GTTACGGGAGTCTTAGAGCG,45,1320682
furpa,41.666666666666664,126,2,GTGTTGCTGAGAGTCCGGTC,124,1277295
furpa,13.0,40,2,GTGTTCTTGCGGTAGGTGAA,38,1354883
furpa,0.6666666666666666,3,2,GTGTAGGACACTCATGAACA,1,1301799
furpa,0.6666666666666666,3,2,GTGGTCCCTATCGCGGTTTA,1,1338436
furpa,12.666666666666666,39,2,GTGGGCATCGGCCGATAGAA,37,1351382
furpa,4.0,13,2,GTGCTTTAAAGGAAAGTGAT,11,1286760
furpa,17.666666666666668,54,2,GTGCGCTTCGACACGCATCA,52,1324255
furpa,3.3333333333333335,11,2,GTGCACACTCCGTCCCTTCG,9,1324941
furpa,10.666666666666666,33,2,GTGAGGAGATTGTGGGGTAC,31,1335736
furpa,8.0,25,2,GTCTGACGGGTAGTCAGTAA,23,1328878
furpa,1.0,4,2,GTCTAACGATCTGCCATCGG,2,1344773
furpa,2.6666666666666665,9,2,GTCGGATGTCGGGGACGCCA,7,1303891
furpa,0.6666666666666666,3,2,GTCGCGCCTAGCGTTACGTG,1,1352119
furpa,0.6666666666666666,3,2,GTCCTCGTGCGCACCGCGTA,1,1312774
furpa,13.666666666666666,42,2,GTCCGAAGCATATGGCCGAT,40,1299072
furpa,11.333333333333334,35,2,GTCATTTGACATCTTCTGGG,33,1339866
furpa,23.333333333333332,71,2,GTCAAATAGCCAGTACGGAA,69,1331014
furpa,1.3333333333333333,5,2,GTACGCTAGATCACAGACCT,3,1288928
furpa,11.666666666666666,36,2,GTACGCCTGTGTAGTAATTA,34,1311554
furpa,3.3333333333333335,11,2,GGTGTGGTCGGTCACGGTAA,9,1354284
furpa,22.0,67,2,GGTGTACGGCTTTACAGCAA,65,1326437
furpa,11.333333333333334,35,2,GGTGCGCTGTGGACCGATCG,33,1331303
furpa,6.0,19,2,GGTGCATTTTTGCGACGGGA,17,1284955
furpa,23.333333333333332,71,2,GGTGACCGACCGAGTTCTTC,69,1307602
furpa,17.666666666666668,54,2,GGTCTTAATTGCAAGTCCCA,52,1329498
furpa,3.0,10,2,GGTACTTATGCTATTAATGG,8,1308927
furpa,7.0,22,2,GGGTATGGGACAGTCTGACG,20,1326234
furpa,0.6666666666666666,3,2,GGGTAGCGGCTTCCCTAGAC,1,1319942
furpa,3.0,10,2,GGGGCCATCTCTAAGCATTC,8,1308275
furpa,15.666666666666666,48,2,GGGGATAAAGCGGTAACTAC,46,1343949
furpa,2.0,7,2,GGGCTCGTGGTACAGGTGCT,5,1314485
furpa,1.0,4,2,GGGCGTGCACACAATGCCAT,2,1287518
furpa,5.666666666666667,18,2,GGGCCGGGAGAGCCCAGTAT,16,1355569
furpa,10.0,31,2,GGGACTCTCGACTCACGCTA,29,1281325
furpa,1.0,4,2,GGGAAGATCGGCAACTTTTA,2,1330789
furpa,12.333333333333334,38,2,GGCTAGAGATTGTAGGCCTT,36,1347062
furpa,9.0,28,2,GGCTAAGTATGTATATGATG,26,1322219
furpa,1.0,4,2,GGCCTGTCTGGTAATATTGT,2,1287001
furpa,8.666666666666666,27,2,GGCCAGGTTATCCAGACATG,25,1306990
furpa,2.6666666666666665,9,2,GGCCACAAAGTGCGTGTGCA,7,1305826
furpa,7.666666666666667,24,2,GGCAGCTGGACCCGTCACCG,22,1340936
furpa,5.666666666666667,18,2,GGCAATAATCCTGGCTCTGT,16,1328229
furpa,0.6666666666666666,3,2,GGCAAGCAAGGAGGCAAGAT,1,1271794
furpa,11.333333333333334,35,2,GGCAAAGCGAAAACGTGTAG,33,1295617
furpa,15.666666666666666,48,2,GGATTTCCACTAAAAAGCCC,46,1327410
furpa,0.6666666666666666,3,2,GGATCGGTAACATTCCAAGG,1,1278051
furpa,13.666666666666666,42,2,GGATAGCGTTTAGTGAACTG,40,1318775
furpa,9.0,28,2,GGAGGCAGTTCGTAACCTCT,26,1355626
furpa,2.6666666666666665,9,2,GGACGAAAGCACGCTTCATT,7,1316569
furpa,12.0,37,2,GGAATGTTTTTAGTCCGAAA,35,1343009
furpa,6.0,19,2,GCTTTTGGTTCTCCGCAACA,17,1283598
furpa,6.333333333333333,20,2,GCTGAGTAAGAAAGCGCTGA,18,1354303
furpa,15.0,46,2,GCTCCTCATTGACGACCTTT,44,1347653
furpa,4.666666666666667,15,2,GCTAGTCCCCCTTACCTTTT,13,1317250
furpa,29.0,88,2,GCGTGCGTTGGATGTGGTGG,86,1276538
furpa,0.6666666666666666,3,2,GCGTGCAAAGAGCTCTATCA,1,1283332
furpa,22.0,67,2,GCGCAGTTGTACGTCAACGT,65,1283704
furpa,2.0,7,2,GCCATACCGTATTCGCGTCA,5,1287574
furpa,7.0,22,2,GCCACATTCAGGATTGTACA,20,1306627
furpa,1.3333333333333333,5,2,GCCAAATAAGAGTTCTCCGC,3,1357622
furpa,0.6666666666666666,3,2,GCATTATCCGTCTCTCTACG,1,1281427
furpa,11.0,34,2,GCATCTCTGTGAGAGGGGTG,32,1309052
furpa,4.0,13,2,GCAGGGGAAACGATAGCAAA,11,1333937
furpa,0.6666666666666666,3,2,GCAGCGATAGCGTGAAATGG,1,1328234
furpa,1.3333333333333333,5,2,GCAACTCAGATGCCCGGGAG,3,1298207
furpa,4.333333333333333,14,2,GATTTTGGTGATGAGATGGT,12,1313775
furpa,6.666666666666667,21,2,GATTGTTGTTTTGGTACCTA,19,1281581
furpa,6.0,19,2,GATTAGGCTATGTTCCTAGA,17,1333099
furpa,18.0,55,2,GATTAATGGTCGCAAGGATC,53,1319549
furpa,3.3333333333333335,11,2,GATGCGAAGTTGACTCACAT,9,1325754
furpa,10.666666666666666,33,2,GATCGCCTCGTCGTCTGCTC,31,1315418
furpa,3.3333333333333335,11,2,GATAATCAATATAGAGTGGG,9,1288293
furpa,14.333333333333334,44,2,GATAAAGTGGGAGTAACACT,42,1288607
furpa,7.333333333333333,23,2,GAGTTGCCCTACCGGCTTCC,21,1341653
furpa,1.6666666666666667,6,2,GAGGGAGTACGGCGAGTCAT,4,1331221
furpa,6.666666666666667,21,2,GAGATATGCCTCGATACGAG,19,1292681
furpa,10.0,31,2,GAGAGAATCACACCCAAGTG,29,1280325
furpa,8.666666666666666,27,2,GACTTCGTGTCGACATGTGA,25,1327898
furpa,10.333333333333334,32,2,GACTGCGGGAGTCCTCTGCC,30,1309196
furpa,11.666666666666666,36,2,GACTCTCGAGGGTTGGCTAT,34,1306748
furpa,1.3333333333333333,5,2,GACTCGAGTCGCGCTCAAGA,3,1283141
furpa,11.333333333333334,35,2,GACGTGCTGGAAGATGCTCA,33,1355515
furpa,5.333333333333333,17,2,GACGTAATGGGCCATCTGCT,15,1344144
furpa,8.333333333333334,26,2,GACGGGAAACCGAGGCCTTT,24,1279647
furpa,11.0,34,2,GACGCGCCAAGAACCCGGTA,32,1314220
furpa,0.6666666666666666,3,2,GACGATTGAATCGCACGCTT,1,1348183
furpa,21.666666666666668,66,2,GACCTGGCTTCTGTGTCTGT,64,1278328
furpa,8.0,25,2,GACCACCAATGCAGAAATAA,23,1288203
furpa,7.333333333333333,23,2,GACACTGGTTCAGTACGGTT,21,1340272
furpa,1.6666666666666667,6,2,GAATTCCGCTGTTATAATAA,4,1293950
furpa,4.0,13,2,GAATACACCTAGGCTAGTCC,11,1301334
furpa,14.666666666666666,45,2,GAAGAGACATTGGGATTTTC,43,1271776
furpa,10.0,31,2,GAACCTTTGCGAAGGTCGTC,29,1283728
furpa,2.0,7,2,GAACCGACACCACAACATAC,5,1352877
furpa,1.6666666666666667,6,2,GAACATGTGCCGTCACTCGC,4,1287507
furpa,9.0,28,2,GAACATGTATATATATGTTT,26,1298909
furpa,1.0,4,2,GAAACCGTTCGCTTGCTCTT,2,1328320
furpa,0.6666666666666666,3,2,CTTTAGCAAGGTTGTCTTAA,1,1279743
furpa,1.0,4,2,CTTGTTCCGGTTCGGGGCAT,2,1280627
furpa,11.666666666666666,36,2,CTTACCGCCGGGACCACGCA,34,1343850
furpa,17.333333333333332,53,2,CTGTTTGCCCGAGGGGCCAA,51,1318483
furpa,4.0,13,2,CTGTTTCCGCCAAGATATGT,11,1320023
furpa,1.0,4,2,CTGGGTACTAGGTAAGCCAT,2,1288457
furpa,4.666666666666667,15,2,CTGGCGACATAGTTTTGGAG,13,1321611
furpa,20.666666666666668,63,2,CTGGAAAACTACTTAACCTC,61,1276559
furpa,1.0,4,2,CTGAGGTGGAGACTCATGTG,2,1311715
furpa,4.0,13,2,CTGACCCATGGGGAACGTCT,11,1276302
furpa,9.333333333333334,29,2,CTCTACTCTAGGTTAATCGA,27,1351347
furpa,21.666666666666668,66,2,CTCGTGTAGAAACTCGGACG,64,1311117
furpa,1.3333333333333333,5,2,CTCGGTCCCGCCCTCTTGTG,3,1277264
furpa,10.666666666666666,33,2,CTCGCGATGACCTTACGGCA,31,1320357
furpa,6.333333333333333,20,2,CTCGCACTAAAACCCCCACA,18,1271424
furpa,4.0,13,2,CTCCGTTGGAGACTTGTGTA,11,1300787
furpa,3.3333333333333335,11,2,CTCCATGGTCCATCTTCAAA,9,1297223
furpa,0.6666666666666666,3,2,CTCCATAAAGGCAGTTAATA,1,1325770
furpa,18.333333333333332,56,2,CTCAGAGTCTTCAAAGACTG,54,1283527
furpa,7.0,22,2,CTCAACGTTATTCTAGTAGA,20,1334101
furpa,29.0,88,2,CTAGTCATACACATGCGGAT,86,1345407
furpa,47.0,142,2,CTACGGGGTCACTCCCAAAG,140,1277563
furpa,0.6666666666666666,3,2,CTACAGTGATCCATGGCTCA,1,1303467
furpa,3.0,10,2,CTAACTTGAATGAAAATTGA,8,1355133
furpa,27.333333333333332,83,2,CTAAATCTAGAGTCAACCCC,81,1286908
furpa,8.666666666666666,27,2,CGTTAATGTAAGGGACATTC,25,1299436
furpa,0.6666666666666666,3,2,CGTGTCGTGTTGTTCAGTCT,1,1271958
furpa,8.0,25,2,CGTGCCTCCTCTATTATCCG,23,1295004
furpa,3.3333333333333335,11,2,CGTCTTAGATCTAGGTGCTT,9,1347010
furpa,30.666666666666668,93,2,CGTATCAGCCCTCTCTCCGC,91,1279441
furpa,10.0,31,2,CGTAGACACCGTCTTCATTA,29,1335771
furpa,0.6666666666666666,3,2,CGGTTTACCTTAATAGAAGT,1,1280040
furpa,3.3333333333333335,11,2,CGGTAAAAGAGGGGATAAAT,9,1346454
furpa,2.3333333333333335,8,2,CGGGATTAATCATCAAATAA,6,1337812
furpa,16.0,49,2,CGGCTCTGACCAATACGATA,47,1287716
furpa,20.333333333333332,62,2,CGGCGAATAACGCGACTTTG,60,1334349
furpa,10.333333333333334,32,2,CGGCCCACGGAGACCAGCGG,30,1345471
furpa,2.3333333333333335,8,2,CGGCACGGAGGCTAGTTGGT,6,1348530
furpa,0.6666666666666666,3,2,CGCGGAAAAGATGGAATGCT,1,1281517
furpa,4.333333333333333,14,2,CGCGCGTGCCTCATTTAGCC,12,1286146
furpa,1.3333333333333333,5,2,CGCGAGTCCGAAGATAATAA,3,1307923
furpa,0.6666666666666666,3,2,CGCCTCCCAGGACTGCTTTA,1,1324594
furpa,16.666666666666668,51,2,CGCAGGCTATGGGACCGCAG,49,1320525
furpa,0.6666666666666666,3,2,CGCAACCGTAGGGAAGAGTC,1,1280205
furpa,1.0,4,2,CGAGGTCAGTACGAACGTTC,2,1350528
furpa,15.0,46,2,CGAGGCAGTAGTGAATGGTG,44,1296542
furpa,5.666666666666667,18,2,CGAGAATCATGGCACGAATG,16,1288443
furpa,5.333333333333333,17,2,CGACTCGAGGGCTCACATCT,15,1310719
furpa,1.3333333333333333,5,2,CGACAGATATCGTTGATGGA,3,1352164
furpa,1.0,4,2,CGACAATCGTTTTTACAACG,2,1274264
furpa,7.333333333333333,23,2,CCTTCCAGCGATATTGGATG,21,1336958
furpa,5.0,16,2,CCTTAGTGGGACATATGATG,14,1320652
furpa,1.3333333333333333,5,2,CCTTACCCTGATTCTCAGGT,3,1337799
furpa,5.666666666666667,18,2,CCGTTATCTGGCGACAGGAC,16,1310020
furpa,5.333333333333333,17,2,CCGTGAAGACTGTTGTCTGG,15,1310586
furpa,1.0,4,2,CCGTCCTGCTTTGAATCTAA,2,1285620
furpa,8.666666666666666,27,2,CCGTATAATCCGCCCCAGGT,25,1344607
furpa,3.3333333333333335,11,2,CCGGGTAAATAACATCTATA,9,1327108
furpa,0.6666666666666666,3,2,CCGGCGGGAGTTCGATGCCT,1,1312098
furpa,2.3333333333333335,8,2,CCGGCACGCATGTCAGTCCC,6,1320351
furpa,0.6666666666666666,3,2,CCGCCCCCAAGCATTTCAGT,1,1311559
furpa,5.0,16,2,CCCTCATGAAACTGCGCTTT,14,1291587
furpa,13.333333333333334,41,2,CCCTATGTTACGAACACGTT,39,1304008
furpa,14.333333333333334,44,2,CCCGAAACTGCCGAAATAGG,42,1348571
furpa,6.0,19,2,CCCCTACTTCATTGAGTGAC,17,1306750
furpa,3.0,10,2,CCCCAACCGATACTTGGTTA,8,1346560
furpa,0.6666666666666666,3,2,CCCAGAAATTGCTCTCTTTA,1,1337288
furpa,2.6666666666666665,9,2,CCCAAAGCCGCGGAGTCAGA,7,1332279
furpa,10.0,31,2,CCCAAAAAACAGTGACTCAG,29,1320264
furpa,3.3333333333333335,11,2,CCAGTTCTGGGTCTTGTCTC,9,1317944
furpa,15.666666666666666,48,2,CCACGATCCGCTGTTCTTCG,46,1335867
furpa,2.6666666666666665,9,2,CATTTTGTTTTCTAGTGGAT,7,1277927
furpa,6.666666666666667,21,2,CATGTTGGCAGTGCCGGTAT,19,1329278
furpa,4.0,13,2,CATGTTCATGGCCGATTCCT,11,1293577
furpa,5.666666666666667,18,2,CATGCCATGGTGCCAATCGT,16,1328265
furpa,14.0,43,2,CATCTGATAGTAACAGACGT,41,1275031
furpa,6.666666666666667,21,2,CAGGATATGCGCGCGGTATA,19,1329265
furpa,7.333333333333333,23,2,CAGGAATAAGTCCAGCTATA,21,1351226
furpa,9.666666666666666,30,2,CAGCGTATTTTTGATAAGTA,28,1351238
furpa,2.3333333333333335,8,2,CAGCGGGCTTCTTGTTCTCG,6,1277297
furpa,2.0,7,2,CAGCGAAACATCTTCGTATT,5,1292012
furpa,5.0,16,2,CAGCCCAGTGAGGGCTTAGA,14,1348176
furpa,0.6666666666666666,3,2,CAGACTCAATACCCACTGCC,1,1336954
furpa,14.333333333333334,44,2,CACTTGAGGGGATTCTTCGT,42,1323422
furpa,8.666666666666666,27,2,CACTCCTGCGCGGAGAGTGC,25,1353065
furpa,11.0,34,2,CACGTAATAATTTTGCGAAG,32,1325841
furpa,8.0,25,2,CACGCCTTGCGGAGGCTGGT,23,1339072
furpa,3.3333333333333335,11,2,CAATTCAGTTCTTCTAGATA,9,1275929
furpa,1.0,4,2,CAAGTAGAAGTGATACTAGA,2,1309108
furpa,0.6666666666666666,3,2,CAAGGAAACCCTGCACTGCC,1,1331525
furpa,18.666666666666668,57,2,CAAGCGGGTACACTGTTAGC,55,1312582
furpa,1.6666666666666667,6,2,CAACAGTAGCGGTTCGTACT,4,1298720
furpa,11.333333333333334,35,2,CAAATCATCTCACGGTGTAA,33,1274372
furpa,2.3333333333333335,8,2,ATTTGCGGACTATAGGTTAA,6,1357322
furpa,6.666666666666667,21,2,ATTGTGGGTAGGTTAAGCAA,19,1341513
furpa,10.333333333333334,32,2,ATTGTGCCGCCGTCCAGCCA,30,1305642
furpa,12.666666666666666,39,2,ATTGGAGCACGAAAGAAAGG,37,1337386
furpa,8.666666666666666,27,2,ATTGAGGCAAGTTTCAGGCG,25,1277891
furpa,3.6666666666666665,12,2,ATTGAATACGATTATCTCGG,10,1295395
furpa,9.666666666666666,30,2,ATTCTGACTGGCGAGGCTTG,28,1311199
furpa,0.6666666666666666,3,2,ATTCGGACTTCGGTAAGAAT,1,1305062
furpa,12.333333333333334,38,2,ATTCGCCACACATGGAGACA,36,1352556
furpa,1.0,4,2,ATTATTCGGTCGTACAGCCA,2,1335103
furpa,3.6666666666666665,12,2,ATTAGTGGACAATCGATGAC,10,1274134
furpa,10.0,31,2,ATGTTTGCCAGATGAGTTTT,29,1322572
furpa,0.6666666666666666,3,2,ATGTCATGAGGCCCGTCTAG,1,1352818
furpa,16.666666666666668,51,2,ATGCGAGGGTAGTCTGGGAC,49,1299525
furpa,4.0,13,2,ATGCCTGGAACTGAGTGCTG,11,1275427
furpa,0.6666666666666666,3,2,ATGAGTCGAGGAGACACTTT,1,1291748
furpa,1.6666666666666667,6,2,ATCTCAGGGTGCCAGCTGTG,4,1274000
furpa,5.333333333333333,17,2,ATCGGGATGTCATACAGCGT,15,1311271
furpa,6.333333333333333,20,2,ATCCTGACTAACTTAGAGGT,18,1306439
furpa,3.6666666666666665,12,2,ATCCGCACGGATGTAAGGCT,10,1349829
furpa,0.6666666666666666,3,2,ATCATAAGGCAATTAGCCCT,1,1331789
furpa,3.0,10,2,ATCAGTAGTGCGATTCTGTG,8,1286164
furpa,23.333333333333332,71,2,ATCAGGCAAATTGACTGGTG,69,1271371
furpa,3.6666666666666665,12,2,ATCAAGTTAGGCAACACGAC,10,1320341
furpa,9.0,28,2,ATATTTCGGGGGAACATCCT,26,1284662
furpa,4.0,13,2,ATATAGCTCAGGATCTCACA,11,1350427
furpa,7.0,22,2,ATAGTTCTAAAGGTGAGCCT,20,1329511
furpa,8.0,25,2,ATAGGGTAATGCCTGTTTAA,23,1306271
furpa,9.0,28,2,ATAGAGTATTCCCGGTAAGC,26,1320984
furpa,0.6666666666666666,3,2,ATAATCGAACCAATGAATGT,1,1334463
furpa,1.0,4,2,ATAAAACGACGCCTGGCCTT,2,1315135
furpa,0.6666666666666666,3,2,AGTTAGGGTGTTCCGCATAA,1,1293507
furpa,7.0,22,2,AGTGCCCAAGTCAAGTCGGA,20,1290321
furpa,35.0,106,2,AGTAAGTACCAGTGGCGAAA,104,1323413
furpa,17.333333333333332,53,2,AGGTACGCCAGAAGTATTGC,51,1310408
furpa,1.0,4,2,AGGTAAGTGTTGTTAGACAT,2,1283295
furpa,5.333333333333333,17,2,AGGGGTCATATGTCGTGGTA,15,1290749
furpa,3.6666666666666665,12,2,AGGGGTATTCGTTTTCGGTC,10,1350010
furpa,17.0,52,2,AGGGCCTAAAGGGCAACTCT,50,1321340
furpa,7.666666666666667,24,2,AGGCGCGGCGCGCAATAAGG,22,1282822
furpa,9.666666666666666,30,2,AGGATTGGATCTGAACTGCC,28,1336979
furpa,2.0,7,2,AGGATAATTTTTACTATCCT,5,1331160
furpa,2.6666666666666665,9,2,AGGACCGGTGGCAGGCTCCT,7,1323446
furpa,3.3333333333333335,11,2,AGGACAGTAGATCGTCGGGA,9,1329757
furpa,1.0,4,2,AGCTTCCTCTGTGCTCTTAT,2,1352235
furpa,13.0,40,2,AGCTCGGGTTTGGATCCCTA,38,1337581
furpa,7.333333333333333,23,2,AGCACGGCGGCAGTTAAGAT,21,1276961
furpa,19.0,58,2,AGCAAAGGTTTTTACTCATG,56,1328331
furpa,0.6666666666666666,3,2,AGAGGGAATGAAACCTGCGC,1,1347389
furpa,10.333333333333334,32,2,AGAGCGACTGATCTCAAGAT,30,1283956
furpa,4.0,13,2,AGACGAACTATGTACAATCT,11,1280263
furpa,9.0,28,2,AGAAACCGTGACGTCTGCTC,26,1330650
furpa,4.666666666666667,15,2,ACTTCGTACACAGCCCGTGT,13,1337213
furpa,4.333333333333333,14,2,ACTTCGGTATAAAGGCGGTA,12,1285721
furpa,5.333333333333333,17,2,ACTGGTGAATATAGCATGAC,15,1331332
furpa,15.666666666666666,48,2,ACTGAGCTGTTATGCACGTC,46,1334045
furpa,2.6666666666666665,9,2,ACTAGAAAGATCCAGATGCG,7,1302444
furpa,7.666666666666667,24,2,ACGTGCCGGTGTATTGGATA,22,1271476
furpa,0.6666666666666666,3,2,ACGTGCAAGCAATCGCTCAA,1,1344760
furpa,9.333333333333334,29,2,ACGTACGTAAGTCGTGGAAC,27,1275361
furpa,4.666666666666667,15,2,ACGGAATCGCGGATGTTGGT,13,1283352
furpa,5.666666666666667,18,2,ACGCTTAAAGGGCTTTGAAC,16,1296561
furpa,16.0,49,2,ACGCAAATATGGCGGCCCCA,47,1303706
furpa,5.666666666666667,18,2,ACGAATTTGTTCAAAAAGAT,16,1313322
furpa,0.6666666666666666,3,2,ACGAATTGTAGTGACATACA,1,1355119
furpa,16.0,49,2,ACGAAGCCCTCGCCGTCTTA,47,1313516
furpa,4.666666666666667,15,2,ACCTGTCCTTCATTTCGGGA,13,1354283
furpa,0.6666666666666666,3,2,ACCTCAACGCTGTAGCTTCT,1,1295399
furpa,0.6666666666666666,3,2,ACCGTAGGGATTAGCGCTTA,1,1284878
furpa,0.6666666666666666,3,2,ACCCCATTGTTAAGGAGACC,1,1286359
furpa,14.0,43,2,ACCCATTAAAACCTCACCGG,41,1286353
furpa,5.666666666666667,18,2,ACCAGCTTATGGGAGCACCT,16,1346201
furpa,0.6666666666666666,3,2,ACCACAAGTTCGTCGTATGG,1,1294999
furpa,12.333333333333334,38,2,ACATTCTTCAAGCACTGGCG,36,1323449
furpa,43.0,130,2,ACATGTAACCATGCGCAAGT,128,1309989
furpa,41.333333333333336,125,2,ACAGTGGGACGCCACACAAG,123,1326561
furpa,31.0,94,2,ACAGGGATTTCCTTCCCCAA,92,1280272
furpa,0.6666666666666666,3,2,ACACCTATGAATCTGTCACA,1,1299955
furpa,10.0,31,2,ACACCCCCTGTGTGTATAGG,29,1310237
furpa,3.6666666666666665,12,2,ACAATATCCAATTAGTATCG,10,1316784
furpa,2.0,7,2,ACAACGTGGAGCTCGTGTAT,5,1289686
furpa,10.0,31,2,ACAAACCCATCGGGTGGAAC,29,1274179
furpa,8.666666666666666,27,2,AATTCATGCTTCCTAGTGCT,25,1341369
furpa,19.0,58,2,AATCGAACCGATTTTGACCT,56,1330255
furpa,3.3333333333333335,11,2,AATCAGCCATAAGTAGCATA,9,1291467
furpa,0.6666666666666666,3,2,AATACGAGTAAGTGGACTTG,1,1281174
furpa,7.333333333333333,23,2,AAGTCCGGTTTCGGTTTGAA,21,1274261
furpa,2.0,7,2,AAGGTGAAACGAGTAACCCA,5,1332830
furpa,12.333333333333334,38,2,AAGATCGCCTCTAATTGTAG,36,1273102
furpa,27.666666666666668,84,2,AAGACTGCCGCAAGTCACTT,82,1280339
furpa,2.0,7,2,AAGACCAGCTGGAGGCAGTA,5,1287542
furpa,5.333333333333333,17,2,AAGACAGAAGTAGAAAAATA,15,1344463
furpa,0.6666666666666666,3,2,AACCTGGGACGCGGTCGAGT,1,1311486
furpa,0.6666666666666666,3,2,AACCCTAAGCACCAACAAGG,1,1308723
furpa,12.0,37,2,AACCCGAAACGTTTATTGAT,35,1294972
furpa,2.0,7,2,AACCAGTGAATCATGCAGGA,5,1334342
furpa,18.666666666666668,57,2,AACCAGGCCTGGGTGCAGGA,55,1348902
furpa,4.666666666666667,15,2,AACCAACTGGAGGATGGCTG,13,1307520
furpa,2.3333333333333335,8,2,AACAGGACCGTCCAGGAGTT,6,1289143
furpa,13.0,40,2,AACAGACAACTACTAGACCG,38,1357404
furpa,8.0,25,2,AACACCGAGCATGTGCCCTT,23,1291023
furpa,0.6666666666666666,3,2,AACAAGCGGTCCGGCGAGAG,1,1325086
furpa,1.0,4,2,AAATGTGGCTCCGCGGGCGG,2,1347090
furpa,4.333333333333333,14,2,AAACTGGCGCCCGCTCCAAT,12,1331157
furpa,15.0,46,2,AAACGCCAGTAACACAAATC,44,1341025
furpa,25.0,76,2,AAACGAGACCGGCTGGTAGC,74,1319949
furpa,5.666666666666667,18,2,AAACCTCGTTCACATTAGAC,16,1306085
furpa,2.6666666666666665,9,2,AAAACACCTCTAATACAAGC,7,1325777
furpa,0.6666666666666666,3,2,AAAAAGCTACCCATAATCGA,1,1328389
furpa,1.6666666666666667,6,2,AAAAAATGCGGGAGGGAAGG,4,1351967
furpa,3.0,6,1,TTTTTCTTCTTATGTAACTC,5,1278385
furpa,4.0,8,1,TTTGTTAAGTGGATCTATTT,7,1272909
furpa,15.0,30,1,TTTGGCGAAATGCCCTGAAA,29,1343664
furpa,22.0,44,1,TTGTGTGCGAGGTAGTTAAT,43,1343851
furpa,17.5,35,1,TTGGTCGCCCGAGCAGAGGT,34,1322256
furpa,2.0,4,1,TTGCTCCGAGAGCGGGTCAT,3,1318095
furpa,40.0,80,1,TTGCGTACACGTGCATTGTA,79,1345474
furpa,18.5,37,1,TTGCCCTTCCTAGTCTCGTG,36,1290208
furpa,1.0,2,1,TTGATCTGTGACCTGGCCTC,1,1307827
furpa,1.0,2,1,TTGAATCTCCACTTCCCCCT,1,1296987
furpa,15.5,31,1,TTCTTTTCGATGCAAACTGC,30,1344254
furpa,13.0,26,1,TTCTTCTGATTGCAAGTTCA,25,1331263
furpa,24.5,49,1,TTCTTACTGGCACCATTCCA,48,1278783
furpa,6.0,12,1,TTCTCACCCGGTTCGACACT,11,1340161
furpa,39.5,79,1,TTCTATACACAAACTTCGGA,78,1286182
furpa,4.0,8,1,TTCGTTTCATTTAATTCCTA,7,1335798
furpa,23.5,47,1,TTCGTATCAGGGGATTAACG,46,1330992
furpa,4.0,8,1,TTCGTAAACCAGCGTGTATT,7,1306723
furpa,10.0,20,1,TTCGACGGCTCCACAAGAAG,19,1315818
furpa,7.5,15,1,TTCCTTCTCCGTTTTTTTCT,14,1304992
furpa,12.0,24,1,TTCAAAGCGAACCTGTGAGC,23,1320493
furpa,4.0,8,1,TTATCGATCAAACGGGGCCT,7,1322938
furpa,1.5,3,1,TTATAATTTGTCACTAATGC,2,1280582
furpa,4.5,9,1,TTAGTTATGTGGGATTGGCT,8,1287437
furpa,10.0,20,1,TTAGGATGTCAAGTGTGAAC,19,1275453
furpa,11.0,22,1,TTACGAAGGAATTAGACACA,21,1327376
furpa,1.0,2,1,TTACAGGTTCTAGACGTTGT,1,1351223
furpa,8.5,17,1,TTAATTTCTCAGTATTGTAA,16,1286061
furpa,18.0,36,1,TTAATTGAAGATTCGTCAAC,35,1311330
furpa,1.0,2,1,TTAAGCGGCTGATGAGTAGG,1,1337237
furpa,2.5,5,1,TGTTACGTAGGAACACTCAA,4,1356474
furpa,10.0,20,1,TGTGTGCGGCCTAGGGAACA,19,1344788
furpa,11.5,23,1,TGTGGTTCGGCCCGTGAAAT,22,1323322
furpa,28.5,57,1,TGTGCAAACGAATGACCACT,56,1284384
furpa,17.0,34,1,TGTGAAGGGTCAGACCTCCT,33,1271389
furpa,11.0,22,1,TGTATTATCCGAAGCAGCGG,21,1292948
furpa,1.0,2,1,TGTATCTGGAGAAACGGCCC,1,1355357
furpa,23.0,46,1,TGGAGGACATGCTCCTTGCG,45,1288344
furpa,15.0,30,1,TGGACGCTAGGCTGGGAAGA,29,1294268
furpa,11.5,23,1,TGGAAAGAATTCTCAGAGCA,22,1281933
furpa,66.5,133,1,TGCTTTTCCGTCGTTCGAAA,132,1306789
furpa,1.0,2,1,TGCTTCATTGGGGCCGCTAG,1,1300800
furpa,1.0,2,1,TGCTAGTGTGCACTCGGATA,1,1274870
furpa,21.0,42,1,TGCGATGTTGCCGGTGGACC,41,1355948
furpa,24.5,49,1,TGCCGGGCGTCCTACGTACG,48,1295376
furpa,14.0,28,1,TGCCCAGGCCCTGCATCCAA,27,1298382
furpa,12.0,24,1,TGCAGAGCTTTGTAACCAGA,23,1307532
furpa,1.0,2,1,TGCACATCATCATTGTACGA,1,1273509
furpa,14.5,29,1,TGATACTCAGGAACACTAGC,28,1290153
furpa,21.0,42,1,TGAGTCATTGCGGCCTACTG,41,1275576
furpa,21.0,42,1,TGAGGCCGACTAGATGCAGA,41,1315580
furpa,18.0,36,1,TGAGGATAGCAACGATGAGT,35,1331013
furpa,1.0,2,1,TGAGCAAACATAGCTCTCCA,1,1320383
furpa,44.5,89,1,TGACACGCAACTATCTGGAG,88,1296757
furpa,17.0,34,1,TCTTTGCCAGTTGGGGGCGG,33,1349867
furpa,3.5,7,1,TCTTGAGAAAGGGTTCAGGG,6,1325996
furpa,6.0,12,1,TCTGTACTAATCTATAGATC,11,1291402
furpa,1.0,2,1,TCTGGGTCCAGTTCGAAAAT,1,1328626
furpa,10.5,21,1,TCTGGCCCGTTTGTAATCTT,20,1347705
furpa,9.0,18,1,TCTCTACGGTAATGAAAGAT,17,1340912
furpa,1.5,3,1,TCTCGGTTCGGCCGTTTCCT,2,1272606
furpa,1.0,2,1,TCTACTGTTGTGAGAGCCCG,1,1292980
furpa,1.5,3,1,TCTAATTAGAACCATTTCCT,2,1346962
furpa,20.0,40,1,TCGTTTGATCGCCTACACCA,39,1306753
furpa,7.0,14,1,TCGTTGCTTTTGCTGGACGT,13,1336435
furpa,1.5,3,1,TCGTGTGGTCTGAAGATAGT,2,1302009
furpa,8.5,17,1,TCGTCCAGGTGCTAAATAAC,16,1348267
furpa,1.0,2,1,TCGGTCTAAGAATGTCCCCA,1,1347102
furpa,14.5,29,1,TCGGCCAGGTTCCGGAGGGC,28,1284813
furpa,5.5,11,1,TCGGACAGCGATTAAGCCAC,10,1291054
furpa,1.0,2,1,TCGCTTTCCATACCATGATG,1,1354514
furpa,4.0,8,1,TCGCGCTCATTATATGGTCC,7,1333980
furpa,19.0,38,1,TCGATAAGTCCTAGTATTCG,37,1332790
furpa,4.5,9,1,TCGAGACCAGACTTGGCGGA,8,1301784
furpa,11.5,23,1,TCGACCAAGGCCGGGAAGAG,22,1357252
furpa,7.5,15,1,TCCTTACACCGCCGCTTTCC,14,1322763
furpa,20.0,40,1,TCCTCGGCCATGAAGACACG,39,1353867
furpa,7.0,14,1,TCCGAAAGCGCTGAACACAA,13,1343684
furpa,16.5,33,1,TCCAGCTCGGCCCGGTTACA,32,1285891
furpa,1.5,3,1,TCCACTCCAGGTTAACTAGG,2,1354515
furpa,1.0,2,1,TCCACGAAGGGGGCATGAGG,1,1298812
furpa,21.5,43,1,TCAGTTCTCTGCCCTCATCA,42,1335195
furpa,8.5,17,1,TCAGTGTGGTGTCATTCGAT,16,1356871
furpa,7.0,14,1,TCAGGGACTTTGAAGTTCCA,13,1303392
furpa,21.5,43,1,TCAGCTCTAGTTTCCTAGAC,42,1345917
furpa,10.0,20,1,TCAACTCATTTACCATATCG,19,1273949
furpa,1.5,3,1,TCAACGTGAGGACTAAGCAG,2,1291557
furpa,26.5,53,1,TCAACCGTGTTCCGTGGGTG,52,1323436
furpa,2.5,5,1,TCAAATTTCCCCCTTGCTCT,4,1317423
furpa,7.5,15,1,TCAAATGTAATGCGCTGCGT,14,1327275
furpa,8.5,17,1,TATTTGACATACGAATATCG,16,1356608
furpa,25.5,51,1,TATTCCTAGTTCCGCCTTTC,50,1345545
furpa,20.5,41,1,TATGCGCCCGCCAAATTCGG,40,1330755
furpa,1.5,3,1,TATCATGAATACCCATGCCC,2,1309071
furpa,1.5,3,1,TATCAGCATGCTGGCCTAAA,2,1305332
furpa,1.0,2,1,TAGGCCCGCTACTCTACGTC,1,1285625
furpa,3.5,7,1,TAGGCACACGAAAATGCTCG,6,1310031
furpa,41.5,83,1,TAGGCAACGTTCTCACCAGG,82,1278060
furpa,30.5,61,1,TAGGATAGCTCGCGGACGAA,60,1331003
furpa,15.5,31,1,TACTAAACGCAGCGAGTTGT,30,1326088
furpa,17.5,35,1,TACGTCGTCCGTAAAGACAA,34,1343047
furpa,3.0,6,1,TACGGGTGTCTTTTCCGGCA,5,1333504
furpa,17.5,35,1,TACGGGTAGTGCCGGCGCAT,34,1281453
furpa,9.5,19,1,TACCGTTTTGACACATGAGG,18,1328275
furpa,1.5,3,1,TAATTTCGAGGCACCTTGAA,2,1350259
furpa,7.5,15,1,TAAGCGGGGTAGAGCCGAGG,14,1294208
furpa,65.5,131,1,TAAGAAATTCATCTTGGCAA,130,1272505
furpa,1.5,3,1,TAACGTTGCCGCGATCTGTA,2,1327910
furpa,2.0,4,1,TAACGTGCCGGATGGCAGGT,3,1329019
furpa,16.5,33,1,TAACCTTTATGTGGTCGGGA,32,1275328
furpa,9.0,18,1,GTTTGTGAAACGTTCCCTCC,17,1328225
furpa,47.5,95,1,GTTTGGGTGCTGTACAATGA,94,1288205
furpa,6.5,13,1,GTTTAATTTAAATGGAGTCA,12,1296305
furpa,9.5,19,1,GTTGCCACACCTACAGGCTT,18,1325846
furpa,8.0,16,1,GTTCTTTAGTAAATGAAGGA,15,1314571
furpa,5.5,11,1,GTTCCTATGCGAGGAGGAAC,10,1321475
furpa,9.5,19,1,GTTAAGCAATTCCATAGTAT,18,1287496
furpa,50.0,100,1,GTGTTAGCCAACAGTGTCAA,99,1324652
furpa,16.0,32,1,GTGCCCGAGCAGGATACAAG,31,1296815
furpa,1.0,2,1,GTGCACTGCGACTTGCATAT,1,1346646
furpa,7.0,14,1,GTCTGTGCCATCAATCGTAC,13,1299346
furpa,14.5,29,1,GTCGCCCTCTCCGGCCCCAT,28,1352289
furpa,23.0,46,1,GTCCATTAAGGCATAATTGT,45,1318797
furpa,21.0,42,1,GTATGTGTCCTTTCACCCGG,41,1354978
furpa,17.5,35,1,GTATGGCGGAGTATATCCGG,34,1314079
furpa,5.0,10,1,GTATAATGAGGGTTAGCGCA,9,1298215
furpa,39.0,78,1,GTAGTCGTCATTATTGTGCC,77,1327892
furpa,17.0,34,1,GTAGTCCGACGGCACGCAGC,33,1302224
furpa,12.5,25,1,GTAGGTGGTGGCTTGGGTCC,24,1334983
furpa,5.0,10,1,GTAGGGCTTCGCTATCGACC,9,1319602
furpa,13.5,27,1,GTAGCCAGAGCAAGGTTGAG,26,1324444
furpa,25.0,50,1,GTACTCCGGCAGATGGCACG,49,1352751
furpa,4.5,9,1,GTACGGCAAGAGTCAACGAT,8,1277921
furpa,5.5,11,1,GTACCTTGCGACTTAGGGCG,10,1353144
furpa,2.5,5,1,GGTTGTACCTCATCTGGCAG,4,1302201
furpa,9.0,18,1,GGTTGATCAGCATTGGGGTG,17,1297598
furpa,1.0,2,1,GGTGGGTCCGGTATTCATTA,1,1331333
furpa,11.0,22,1,GGTGGAGGCGATCTATCGCT,21,1316266
furpa,8.0,16,1,GGTGCTGGTGGTGAGTTTGC,15,1332494
furpa,11.5,23,1,GGTCCGAGGCCAGGGTCCCC,22,1276528
furpa,1.0,2,1,GGTCATATTTAAATTACTGC,1,1338650
furpa,1.5,3,1,GGTAGGTAGTTTGGCAGTCC,2,1291665
furpa,8.0,16,1,GGTACGCTTCATCTGAGGCT,15,1294457
furpa,1.0,2,1,GGTACGCAGGTGAAACGGAA,1,1279933
furpa,13.0,26,1,GGGGGCTGGGCGAAAACATA,25,1286205
furpa,46.0,92,1,GGGGGCGCCCTCATAGTAGA,91,1309895
furpa,11.0,22,1,GGGGAGCCGTGTGTTACAAT,21,1301280
furpa,8.0,16,1,GGGCTTCTAGTAGGCGACTT,15,1271194
furpa,23.5,47,1,GGGCTTACATGCGGTAGGCA,46,1277209
furpa,7.0,14,1,GGGCCTAACCCTCATATTAG,13,1328306
furpa,1.0,2,1,GGGCAGTTCTTGTAGTACTA,1,1320825
furpa,14.5,29,1,GGGACGCCTTAGACTATATT,28,1347930
furpa,2.0,4,1,GGGACATGCGCAGCCTTCGG,3,1272817
furpa,11.5,23,1,GGCTTAGCCTTTAGTGGGAT,22,1326802
furpa,7.5,15,1,GGCTCCGAAAAACGATAGGT,14,1299541
furpa,1.5,3,1,GGCGTATGAACCAGTGTCCC,2,1271793
furpa,17.0,34,1,GGCGGCTAGCAGGACAGAAC,33,1325421
furpa,1.5,3,1,GGCCCGTCGTTACGGTAGAG,2,1291744
furpa,25.5,51,1,GGATGCCACTATTCTCTTCT,50,1339221
furpa,1.0,2,1,GGAGGCCGGAAAGAGTATGC,1,1330658
furpa,8.0,16,1,GGACTTATTATTACAGATTG,15,1334041
furpa,15.5,31,1,GGAATACATTGCACTATAGA,30,1300824
furpa,5.0,10,1,GGAAGGGACAGATTCGTTGC,9,1294924
furpa,33.0,66,1,GGAAAAGCAAAGCACTAGCC,65,1314568
furpa,11.0,22,1,GCTTTGAGCTGTCCAGCCGA,21,1306486
furpa,11.0,22,1,GCTTGCATGTCCTACACCAA,21,1353329
furpa,7.0,14,1,GCTGGCATCGCCTTAGTCAT,13,1312671
furpa,12.5,25,1,GCTACCTCCGGCATACATTC,24,1296937
furpa,5.0,10,1,GCTAAACCATGTTATCTAAA,9,1314440
furpa,19.0,38,1,GCGCGGTGCGCGCTTGGGGG,37,1342277
furpa,16.5,33,1,GCGCGACTCCCGTAATCTCA,32,1352100
furpa,15.5,31,1,GCGCCCTCAAATGCAGCACC,30,1294341
furpa,11.0,22,1,GCGAGAATTTAGATTGCTCT,21,1323419
furpa,10.5,21,1,GCGACAGACCGTCGGTACTT,20,1344240
furpa,13.5,27,1,GCCGCTCTACGCCTGGTACT,26,1340396
furpa,8.5,17,1,GCCGACGTTATTTGAGGCAA,16,1323679
furpa,14.5,29,1,GCCCTACTGGTTTGAAATCG,28,1321715
furpa,9.5,19,1,GCCCGTGTCGTGCTAGACAC,18,1302693
furpa,19.0,38,1,GCCCCTACCGTAACTGATCT,37,1352094
furpa,24.0,48,1,GCCAGCCAAAATAGGCCAAT,47,1300333
furpa,12.5,25,1,GCCACTACGACTCTTGGGTG,24,1324436
furpa,1.0,2,1,GCATAACGAACGCTCGCAGG,1,1330084
furpa,1.0,2,1,GCAGGCAGATCCTGAGCCTC,1,1320342
furpa,1.5,3,1,GCAGCCGCTTGCGTGATATT,2,1316525
furpa,1.0,2,1,GCACTGACTTGTCTGGCGGA,1,1303499
furpa,16.0,32,1,GCACCTTGTTTGGACTCTCC,31,1313959
furpa,4.0,8,1,GCACCCGTACAGCGACTAAT,7,1295834
furpa,11.5,23,1,GCACACGAGGCCTCCACTAT,22,1348998
furpa,4.5,9,1,GCACAAGCATTAGTGCAGTT,8,1275351
furpa,8.5,17,1,GCAATTCCCGGTGATCCAAC,16,1286215
furpa,31.5,63,1,GCAAAGGCAGGTGTGTGAAG,62,1311707
furpa,7.5,15,1,GATACCTACCGGGCAGCCAA,14,1331335
furpa,5.0,10,1,GAGTGGGCACCAGGTTGAGT,9,1278406
furpa,1.0,2,1,GAGTCGTAACTGTCACAGAA,1,1307821
furpa,15.0,30,1,GAGCGTTCGCTGTAATCGCC,29,1311238
furpa,8.0,16,1,GAGCGTTAAAGACTCCATTA,15,1340646
furpa,1.0,2,1,GAGCGCCTATGGCATGGGTT,1,1278236
furpa,1.0,2,1,GAGAGTGGACTGTGATCGTG,1,1328546
furpa,22.0,44,1,GAGACACTTTCGCCGAAGGG,43,1326569
furpa,14.5,29,1,GACTTATGTGATTAAGCGTG,28,1275584
furpa,16.0,32,1,GACTCGGCTGCCCCTCAGGT,31,1323411
furpa,1.5,3,1,GACGCTCATTTCATTTACTT,2,1345679
furpa,1.0,2,1,GACCATACGCAGATTTGTAA,1,1319731
furpa,1.0,2,1,GACAGCTTAACCATCGGTTA,1,1275587
furpa,13.0,26,1,GACAGAATACCCTTGGTTGC,25,1336133
furpa,5.5,11,1,GACAAGGGTTTGGCGGGCCA,10,1293957
furpa,21.5,43,1,GAATCAGCTGATATTGACTA,42,1352598
furpa,8.5,17,1,GAATATTGAGGACAGCACCA,16,1290991
furpa,10.0,20,1,GAAGGTCGCTGCAAGCTTTT,19,1348436
furpa,10.0,20,1,GAACCGATGCTACGAGATAC,19,1286144
furpa,4.0,8,1,GAAAGGACTGCATGTTATGG,7,1333487
furpa,8.0,16,1,GAAAGCTTGTACGGTGTACT,15,1341282
furpa,5.0,10,1,CTTCCGCGTTCATGGAGGGA,9,1341637
furpa,9.5,19,1,CTTCAGCGGTGTTGCAACGA,18,1356621
furpa,2.5,5,1,CTTATTCATTTCCATACATC,4,1290420
furpa,1.0,2,1,CTTACGCGACCGCCTGGTGT,1,1315866
furpa,4.0,8,1,CTTACGCCCACAACGTCCCT,7,1299226
furpa,9.5,19,1,CTTACCTGGATGTTTCAGCA,18,1286381
furpa,3.5,7,1,CTGTTCGGCTCCGTTCACCT,6,1321739
furpa,21.5,43,1,CTGTCAGCAAGGTAGCCCGA,42,1299431
furpa,1.0,2,1,CTGTAGGTCCGAGAGGCGGT,1,1281833
furpa,2.0,4,1,CTGGTTTTGGCAGATGTAAG,3,1333461
furpa,1.0,2,1,CTGGTTGTAGGCGATAGTCA,1,1300286
furpa,6.5,13,1,CTGGGGTAAGCCGAACGTCC,12,1327219
furpa,4.0,8,1,CTGCCGATGTCTATATTCCA,7,1347336
furpa,5.0,10,1,CTGCCACCGAGTCTCCGCAT,9,1327302
furpa,20.5,41,1,CTGCAATTTACCGATATAAG,40,1329849
furpa,6.0,12,1,CTCTCTCCTTATTTTCGTTA,11,1336071
furpa,1.0,2,1,CTCGGCAGGCGCTGATAATA,1,1337269
furpa,4.0,8,1,CTCGGATCGTTTTATCGCTG,7,1342703
furpa,3.0,6,1,CTCCAAATATGGGTCGCGTA,5,1348481
furpa,25.0,50,1,CTCATATGATCGTATGCGGC,49,1285381
furpa,6.5,13,1,CTCACTATGTGGCAGGTATC,12,1292149
furpa,1.5,3,1,CTCAAGGGGATTTATTCAAA,2,1340381
furpa,3.5,7,1,CTATTCAAGTCCGTTGACCC,6,1341487
furpa,27.0,54,1,CTATGAGTCATATCGGAGAT,53,1356679
furpa,9.0,18,1,CTACGTATGTCATACATGTC,17,1280306
furpa,10.0,20,1,CTACAGTAAGATCGGTGTAT,19,1285417
furpa,13.5,27,1,CGTTCCGAGGGCCTGCGCGG,26,1332320
furpa,5.0,10,1,CGTTCACGGTAAGGATTCGA,9,1333284
furpa,1.0,2,1,CGTTATTAAATTCTCGACGG,1,1291768
furpa,1.5,3,1,CGTGAATATAGCATGCTATC,2,1280709
furpa,5.0,10,1,CGTCTGGCTCGAGGCCGTGA,9,1320494
furpa,1.0,2,1,CGTCTACTTAGTATAGTCCC,1,1278311
furpa,18.0,36,1,CGTCTAAGCAGAAACAATTT,35,1296368
furpa,46.0,92,1,CGTCACGAAACGGGGTCCCT,91,1306756
furpa,1.5,3,1,CGTATAGATCCGCTACCTCC,2,1316513
furpa,29.0,58,1,CGTAGCGCTGTCAACGTTAA,57,1284278
furpa,8.0,16,1,CGTACTATTCAATCGCTTTG,15,1325576
furpa,6.0,12,1,CGTAAACACTTTGGTTATGA,11,1271785
furpa,1.0,2,1,CGGTTCTGACTCGTCAATAG,1,1331301
furpa,5.0,10,1,CGGTCTGTAGTTCAGCGAAT,9,1296351
furpa,7.0,14,1,CGGGCACGATCTTGGGCATC,13,1341517
furpa,5.0,10,1,CGGGACCGGATTTCCAGTAG,9,1275612
furpa,17.0,34,1,CGGCCTTATATGCAATGCCA,33,1325745
furpa,42.0,84,1,CGGACGGGCCTTTTGCCAAA,83,1334070
furpa,4.5,9,1,CGGAAGTTCAGTATACTCAT,8,1321645
furpa,1.5,3,1,CGCTTTCGCCGATAGTGTGG,2,1332924
furpa,1.0,2,1,CGCTGGGCAGCGGCAGTAAG,1,1320423
furpa,20.5,41,1,CGCTGCACATATAGTTGCTT,40,1274343
furpa,1.0,2,1,CGCCTTTCGATGGCCGGGCA,1,1307127
furpa,17.0,34,1,CGCCTAATTGGGAGACCTGT,33,1313000
furpa,51.5,103,1,CGCCGGACCAAGCCCGAACA,102,1308205
furpa,1.0,2,1,CGCCATAGTCGGGAAAAGAG,1,1272134
furpa,7.5,15,1,CGCAGTACAGTCTGAATACT,14,1340929
furpa,13.0,26,1,CGCACACTAGCTGCGGTGCC,25,1332789
furpa,34.5,69,1,CGACTCATTCGTGTCTCGTT,68,1303469
furpa,1.5,3,1,CGACTAGGAGGCTAACTTCT,2,1324982
furpa,1.0,2,1,CGACCCTACATTGTGTTTCT,1,1338276
furpa,3.5,7,1,CGACAGGTTCCAATAAACGA,6,1324294
furpa,10.0,20,1,CGAATCAGTAGGAGACATAC,19,1323926
furpa,6.5,13,1,CCTGCTGAGAAATGTATCTC,12,1288215
furpa,15.5,31,1,CCTCTCTGTCACAGCCACAG,30,1326242
furpa,16.5,33,1,CCTATTCACGACTTTAGATT,32,1327695
furpa,31.0,62,1,CCGTTATCAGTGTTATAGAA,61,1308747
furpa,7.5,15,1,CCGGTATTAGGACTTTGACG,14,1312123
furpa,1.0,2,1,CCGGTACTGGCCCCACGTTC,1,1325987
furpa,14.0,28,1,CCGCGCCGCTATAAGCCCTG,27,1350979
furpa,2.5,5,1,CCGATGCGAGTTCAGCAATA,4,1281921
furpa,16.0,32,1,CCGAGGGCGCGGGTCATCTA,31,1302547
furpa,35.5,71,1,CCGAGAGCGTATAATTGAAA,70,1272210
furpa,23.0,46,1,CCCTGACCCGACTCCGTCTA,45,1292986
furpa,43.0,86,1,CCCTCTCTGTACTGTCATAA,85,1313309
furpa,5.5,11,1,CCCGCTTTTGTCGTCATTCG,10,1324596
furpa,4.5,9,1,CCCGCGTGAACGCACCCCAG,8,1354344
furpa,10.5,21,1,CCCGCCCGGGCTGGCGAAAA,20,1331798
furpa,6.5,13,1,CCCCCGGCCCTCCATGTTTT,12,1278801
furpa,19.0,38,1,CCCAAGTATCTGCATACTTA,37,1291362
furpa,18.0,36,1,CCCAACAAGGGTCACCTGGT,35,1325238
furpa,40.5,81,1,CCATGTTATCATGTACTTTC,80,1299073
furpa,2.0,4,1,CCAGCTACCTAGACGGCTAC,3,1355662
furpa,12.0,24,1,CCAGAGCTGGGCGGGTTTCA,23,1354217
furpa,20.5,41,1,CCACTATCCCCGACGACCCC,40,1291807
furpa,41.5,83,1,CCACGAGGACGTACACTCTG,82,1331800
furpa,3.0,6,1,CCACCCGCGCGCGCGTTAGC,5,1354452
furpa,33.5,67,1,CCAAGTCTCTGATACTTAAC,66,1286766
furpa,16.5,33,1,CCAAGAACCGTATATGTGCT,32,1287264
furpa,24.5,49,1,CATTCGACGGCAGTCTTTCT,48,1349657
furpa,12.5,25,1,CATTCACCGTCCAACGCGAG,24,1322465
furpa,36.5,73,1,CATTACTGACACCTCCTTGA,72,1354880
furpa,8.5,17,1,CATGTTTCTCCCCATAGTGC,16,1281430
furpa,9.0,18,1,CATGTTGCATGGCAGGTTAG,17,1280184
furpa,1.0,2,1,CATGACCGGGAGAGTCAACA,1,1288214
furpa,10.5,21,1,CAGGCGCACCGGGACAGATT,20,1348970
furpa,57.5,115,1,CAGGCCATCGGAGTGAACCT,114,1312545
furpa,6.5,13,1,CAGATGAATTTACTATTATA,12,1273237
furpa,11.0,22,1,CACTGATACGTCTCGCACTA,21,1347299
furpa,16.5,33,1,CACGCGCAATCTCTTATGTA,32,1351399
furpa,32.5,65,1,CACGCACCCACATTCCACGT,64,1302791
furpa,1.0,2,1,CACGAACGACCCTTGCAATA,1,1320160
furpa,13.0,26,1,CACCCGGAGGCCGGACTGGA,25,1297304
furpa,1.0,2,1,CACAGGGTGGAGAGTCCGAC,1,1306153
furpa,10.0,20,1,CAATAGTATAGCCAATAATA,19,1271328
furpa,9.5,19,1,CAATAACTTTACGAGTGATT,18,1339899
furpa,1.5,3,1,CAATAAATGACCTATACCCT,2,1275250
furpa,63.5,127,1,CAAGCGTTCGCATTCCCATA,126,1286349
furpa,52.0,104,1,CAACTAGTGTATAGATTTGA,103,1287451
furpa,1.0,2,1,CAACTAATAGGTAGATCTCT,1,1348041
furpa,1.0,2,1,CAACGACCGTCGAGTGTCAC,1,1272004
furpa,33.0,66,1,CAACGAACTCCAACGACATA,65,1334339
furpa,11.0,22,1,CAACCTATCCGGGGGTCTTT,21,1334681
furpa,2.0,4,1,CAAAGTTTGGGCCGTGGAAT,3,1334427
furpa,1.0,2,1,ATTTTTTTTCGCGCGATTTC,1,1344793
furpa,10.5,21,1,ATTTCCAAATGATGGCCATC,20,1337600
furpa,1.0,2,1,ATTTACGCCATAGGATCCGT,1,1320583
furpa,14.5,29,1,ATTGTGCTTCTACTGGGACC,28,1303019
furpa,22.5,45,1,ATTGTAGAGCCGCGAGACAC,44,1317207
furpa,17.0,34,1,ATTGGCGATCAGAGACTAGG,33,1273109
furpa,7.5,15,1,ATTGCGCGTCGGGCATGGTT,14,1346003
furpa,1.5,3,1,ATTCGTTTATCAATGTTGTA,2,1317320
furpa,12.5,25,1,ATGTTTTGGGTTTGAGCTTT,24,1289558
furpa,18.5,37,1,ATGTGTGACGTGACTCGATT,36,1332787
furpa,2.0,4,1,ATGGTGTCGCGCCACAATGA,3,1296741
furpa,7.0,14,1,ATGGCGGAGTTTCTCCGATA,13,1333026
furpa,13.5,27,1,ATGGACTAATCTGGAAGACC,26,1302156
furpa,1.0,2,1,ATGCTTTTTGTGCCGCAAGA,1,1339697
furpa,1.0,2,1,ATGCTCACGTTTGTGGAACC,1,1324229
furpa,7.0,14,1,ATGATTGGTTTCTAGAGCCC,13,1339664
furpa,10.0,20,1,ATGATTATATAAAGTGGGTC,19,1296438
furpa,44.0,88,1,ATGAGAGAAAAGTGCACTAG,87,1348971
furpa,1.5,3,1,ATGACGTTACACATAACCCA,2,1341136
furpa,13.0,26,1,ATCTTGTGTAGCGATGGTAG,25,1346110
furpa,1.0,2,1,ATCTTGCACGGCGGTATAAT,1,1295093
furpa,31.0,62,1,ATCTGGGGTATAAGTGGTGA,61,1337111
furpa,5.0,10,1,ATCTGCCGCGGCAGAATAAC,9,1314203
furpa,11.5,23,1,ATCTCGGTCCTATGCATAGA,22,1307760
furpa,6.5,13,1,ATCTAGGCCAACCGAAAAGG,12,1328865
furpa,14.5,29,1,ATCTAATCGTTAACCCTGGA,28,1294148
furpa,3.0,6,1,ATCGAAGGCCGTGATATGCC,5,1341012
furpa,3.5,7,1,ATCCGTCTGGGTATACATCC,6,1331493
furpa,45.0,90,1,ATCCCCTGGTGCGAGGGTTC,89,1311597
furpa,12.5,25,1,ATATTACGCGTTGCGACCAC,24,1285382
furpa,22.0,44,1,ATAGAAAAGTTGAACACGCT,43,1335750
furpa,6.5,13,1,ATACCACCGTTCGGGATCCC,12,1302447
furpa,12.0,24,1,ATAATCTCGGTCAGAGCAAA,23,1279438
furpa,4.5,9,1,ATAACCGTATAGAACGACCC,8,1330951
furpa,18.5,37,1,AGTTGGTGGAGAACTATCGG,36,1280923
furpa,11.0,22,1,AGTTGGGTTAGCGAGAAACA,21,1347011
furpa,4.0,8,1,AGTTCGCCCCAAATAAGGAC,7,1279719
furpa,1.5,3,1,AGTTATAGGACCGGCAACGT,2,1310132
furpa,7.0,14,1,AGTGTTGCTAGTTCATCATT,13,1323683
furpa,4.5,9,1,AGTGTTATGTACTGCAGATC,8,1332199
furpa,6.5,13,1,AGTGCGCGTTACATTGGCCT,12,1341535
furpa,2.5,5,1,AGTATTTTACGACACGGGGG,4,1297239
furpa,2.5,5,1,AGGTCAAAAGTAATCGGGTG,4,1317046
furpa,2.5,5,1,AGGGCTAGTATCGTTTTGAT,4,1346309
furpa,19.5,39,1,AGGGCGGCGAGTCACCTGTG,38,1291669
furpa,1.5,3,1,AGGGCCGAAGCGAGTATATT,2,1320607
furpa,10.5,21,1,AGGCTTCTGGGCTTGGACTT,20,1319025
furpa,36.5,73,1,AGGCTCTTACAATATTTCGA,72,1325794
furpa,1.0,2,1,AGGCCACGAGTTGATTTTGC,1,1330208
furpa,17.0,34,1,AGGCACCACGAGACAACATG,33,1298129
furpa,2.0,4,1,AGGATACGGTGTGGTCACAG,3,1345465
furpa,21.0,42,1,AGGACCCTGACCGCTAATTC,41,1348990
furpa,1.0,2,1,AGCTTTGTCATCAAAGGTAG,1,1303859
furpa,37.5,75,1,AGCTCTAATTTCGGTCTATC,74,1283606
furpa,11.5,23,1,AGCTCGTAACAATTTAGAAC,22,1334516
furpa,7.5,15,1,AGCTACACTGTCACCTGGTG,14,1333698
furpa,4.5,9,1,AGCGCATGGCACGTTTTACA,8,1307009
furpa,5.0,10,1,AGCGAAGAGGGTTTTCTCAT,9,1342506
furpa,10.0,20,1,AGCCTCGAACTTTTAATGTG,19,1345899
furpa,39.0,78,1,AGCCGGACCCGCGAGGAATC,77,1322215
furpa,8.5,17,1,AGCAGAACACGGGTGGCTTA,16,1315939
furpa,19.5,39,1,AGATCTGAATCACCAGGCAA,38,1286088
furpa,1.5,3,1,AGATAGGTTGTGTAAAAACA,2,1332440
furpa,1.0,2,1,AGAGGTAAGTCTTTGGTCTG,1,1277094
furpa,8.0,16,1,AGACTTGAGTGTGTAGCCAC,15,1344008
furpa,1.5,3,1,AGACACAGTGCGGGAGGGAT,2,1350094
furpa,13.5,27,1,ACTTAATGATAGCATCATTT,26,1307610
furpa,7.0,14,1,ACTGGGAGTGGCTACGTTGC,13,1350577
furpa,2.0,4,1,ACTGATTAGGCATCCGGAAC,3,1303011
furpa,21.0,42,1,ACTCTTCGGATCTCCGATGA,41,1325870
furpa,1.0,2,1,ACTCGTCACTCCAGAGGCCT,1,1283192
furpa,9.0,18,1,ACTCATAGGATAGATGATCT,17,1280259
furpa,9.0,18,1,ACTCACCTCATAGTGCATAT,17,1344021
furpa,1.0,2,1,ACTACGCCCTGATATGATTG,1,1301933
furpa,18.0,36,1,ACGTGTTCGGTGTAAAACGA,35,1332467
furpa,4.5,9,1,ACGGTTGCATTTTAAGTTAG,8,1324724
furpa,2.0,4,1,ACGGCCGTTGACGTGAAGGT,3,1342140
furpa,1.0,2,1,ACGGCATAAGATCGGCGACC,1,1291666
furpa,35.0,70,1,ACGGAATGGCAGGACATCCA,69,1288679
furpa,15.5,31,1,ACGATCTGGTGCCGCTGTAC,30,1295409
furpa,30.5,61,1,ACCTAGTTGGGTAGCTAATC,60,1320131
furpa,17.5,35,1,ACCGGGGAGGCTTAGCACGG,34,1335121
furpa,4.0,8,1,ACCGGAGCTTGGTTTGCGCA,7,1281082
furpa,3.5,7,1,ACCCAGATCGCAAAGTGGCA,6,1304113
furpa,4.5,9,1,ACCCACATTGACGTAACTCG,8,1316282
furpa,1.0,2,1,ACATTTTAACATTTCGGACT,1,1280147
furpa,37.5,75,1,ACATTACATTCGGGACGAAG,74,1311577
furpa,3.5,7,1,ACATGCCTCGATGATACGAA,6,1304235
furpa,2.5,5,1,ACATCGCTTTCAAAGTCCAT,4,1314764
furpa,5.5,11,1,ACAGGTACGGGACGTATGGT,10,1343193
furpa,1.5,3,1,ACAGCCATGAGCAACATCGT,2,1283715
furpa,22.0,44,1,ACAGAGATATGAGGTTGGCT,43,1315685
furpa,1.0,2,1,ACACGCTGTGAGTATGAACT,1,1289299
furpa,17.5,35,1,ACACGCGTGCCCGTTCGAAA,34,1352549
furpa,3.5,7,1,ACAATAGCGTTTGATTTTCA,6,1354470
furpa,25.0,50,1,ACAAGTGCGTCCAGCGTTAC,49,1325713
furpa,30.5,61,1,ACAACTGTATTGGAGGCCGC,60,1273088
furpa,2.5,5,1,ACAACAATCGTAAGAAACCC,4,1304835
furpa,17.0,34,1,ACAAAGCCCGCACAGGCGCA,33,1276692
furpa,38.5,77,1,ACAAAACCGGACTGGGGCGC,76,1332823
furpa,1.0,2,1,AATTTCCTATAGGGCGCTAA,1,1277584
furpa,4.0,8,1,AATTCCTTATCGTTCTTGGG,7,1297961
furpa,4.5,9,1,AATGTGCCGCATACATAGGT,8,1271359
furpa,10.5,21,1,AATGGAAAGCTCCGCGGGTA,20,1345457
furpa,7.5,15,1,AATCATGTCGATAGATATCC,14,1279787
furpa,9.5,19,1,AATCAAGAGTGGAGGCATGA,18,1283678
furpa,4.0,8,1,AATATTGACTTATTTTCTGC,7,1336772
furpa,37.0,74,1,AATAGGCGTCTACCGGCCCA,73,1284993
furpa,13.5,27,1,AAGTCTTAATCCGCTGATTG,26,1354587
furpa,7.0,14,1,AAGGTCGCAAAGCGCGCGAG,13,1273085
furpa,3.5,7,1,AAGGGTCAAGTTGTGTGTTA,6,1307182
furpa,1.0,2,1,AAGCGGACGCTTTATCAGCT,1,1318794
furpa,1.5,3,1,AAGCACACTGCTGCTAGGCT,2,1319808
furpa,1.0,2,1,AACTTGACCCAGGCCAGCAA,1,1309614
furpa,1.5,3,1,AACTGCCATAGCAACCATCC,2,1284985
furpa,4.0,8,1,AACGCCATTGACCGTCCCCA,7,1345523
furpa,5.5,11,1,AACCAAGGAGCCCGAGGCCA,10,1282883
furpa,13.5,27,1,AACATTGCATTATGCTTTAA,26,1277090
furpa,4.0,8,1,AACATATTGGCACATATGTT,7,1328205
furpa,2.5,5,1,AAATGTGTTCATAGTTCACC,4,1309018
furpa,1.0,2,1,AAATATGATAATTTATACGG,1,1309887
furpa,24.5,49,1,AAAGTCCAATAGCAGGACCT,48,1292103
furpa,5.0,10,1,AAAGGTGTGTCTCGCTGGCT,9,1320513
furpa,20.5,41,1,AAACTGCGGAATTGCTCTAG,40,1290096
furpa,19.0,38,1,AAACGCGGCGTGTATGTTGG,37,1320522
furpa,2.5,5,1,AAACATGCGCCGACAAGGAG,4,1318782
furpa,12.0,24,1,AAAATGAGTCTGGTTAGCTA,23,1345639
furpa,9.5,19,1,AAAAGTGCATATTACTGACC,18,1345835
furpa,0.008130081300813009,122,122,TTCTAGTATGTTCTAATCTG,0,1355013
furpa,0.011111111111111112,89,89,ACTGGCATCCCTAAATCACG,0,1325322
furpa,0.013157894736842105,75,75,GAAACCGAGCGGGTTAGTCA,0,1285737
furpa,0.013157894736842105,75,75,AATTTACCTGCCGCATCCCA,0,1349252
furpa,0.0136986301369863,72,72,GGATAGGCAATACCGTGGAT,0,1322648
furpa,0.013888888888888888,71,71,TTTGACCTAGGGAGGGCTGA,0,1274734
furpa,0.015625,63,63,TTCAGTTTGAGGTGGGGTGG,0,1346968
furpa,0.015625,63,63,TCGAAAATTTCTGCATGTGA,0,1278849
furpa,0.015625,63,63,ACCTCGCCACAACAAGAGGT,0,1345370
furpa,0.015873015873015872,62,62,GGCATTTCCGCTTGGGGTAA,0,1334120
furpa,0.016129032258064516,61,61,TTGCCATTGACACTGGAATT,0,1309327
furpa,0.01639344262295082,60,60,GGTCCAGTGCCTGGGTCTTC,0,1288727
furpa,0.016666666666666666,59,59,CATTCGGTACTGGCGCACGT,0,1272742
furpa,0.017543859649122806,56,56,TTTACACTAGAAGAGCGTCA,0,1294048
furpa,0.017543859649122806,56,56,GTAAAGCGCCGCTAAGTGGT,0,1295276
furpa,0.017543859649122806,56,56,GGAAATCCAGAGACTCCGAA,0,1302598
furpa,0.017543859649122806,56,56,ACTGGTGGCCTCGAGCTACA,0,1354190
furpa,0.01818181818181818,54,54,GCAAGCTCAGCGTACTTGGT,0,1272067
furpa,0.01818181818181818,54,54,CGCATGTTCATTAGCTCGGA,0,1341135
furpa,0.01818181818181818,54,54,CCTCTAGGAATCCGCCGTTT,0,1315883
furpa,0.01818181818181818,54,54,AACCAATGCACAAGAGCGAT,0,1284707
furpa,0.018867924528301886,52,52,AGAGCGTTGCAAGGGTATGT,0,1322011
furpa,0.018867924528301886,52,52,ACGAGCGGACACCGTCAAAG,0,1274957
furpa,0.019230769230769232,51,51,CAAGAACAGAGGCGGCACTA,0,1282024
furpa,0.019230769230769232,51,51,AGATACGGACTTGAGAGGTC,0,1278599
furpa,0.0196078431372549,50,50,GCGCCCCATACGCGCAAACA,0,1340768
furpa,0.02,49,49,CGATTACAGTAGGCAGCAAG,0,1310087
furpa,0.02040816326530612,48,48,GGCACGGTTGGCAGCCTGTA,0,1343530
furpa,0.02040816326530612,48,48,CTTTATGGGACAACTGCGTC,0,1313573
furpa,0.02040816326530612,48,48,CTCACCTTTCCTGTGAAGAG,0,1338044
furpa,0.02040816326530612,48,48,CGGGTGCTATCAGGTCATTA,0,1291191
furpa,0.02040816326530612,48,48,CCCAGTCACACTTAGCGCCA,0,1341557
furpa,0.02040816326530612,48,48,AGAGGCTTCTGAGGAGCAAG,0,1356309
furpa,0.020833333333333332,47,47,TTAGTTATTCGGCCAAAGGA,0,1326901
furpa,0.020833333333333332,47,47,CTACCATATCCGTCTTCAGT,0,1322169
furpa,0.020833333333333332,47,47,AGATAAGCGAATTTGAAGAC,0,1289402
furpa,0.02127659574468085,46,46,TATGTGCCATTGGCAATGAT,0,1274359
furpa,0.02127659574468085,46,46,TAGTCCGGCTACAACCATCA,0,1340370
furpa,0.02127659574468085,46,46,GTGAAGCAGTTCCTGCCCCA,0,1271987
furpa,0.02127659574468085,46,46,GTATCACCACCGTCTAATAC,0,1311008
furpa,0.02127659574468085,46,46,GCCTATCTAGCGCAGCGCGC,0,1282364
furpa,0.021739130434782608,45,45,ATGAAACTGCTGCTTGTAAT,0,1298469
furpa,0.022222222222222223,44,44,TTGGTGGTATTCCGGCAATT,0,1272891
furpa,0.022222222222222223,44,44,TTATAGCTTCCATACGCTTA,0,1324775
furpa,0.022222222222222223,44,44,TTACCTATGAGGCTCTAGTG,0,1283876
furpa,0.022222222222222223,44,44,TGCGGGCTGGACACCATAGT,0,1351661
furpa,0.022222222222222223,44,44,GTGGCCACTCTAGCTTTAGA,0,1323624
furpa,0.022222222222222223,44,44,GGCTCGAGGATGTTCATCCT,0,1291187
furpa,0.022222222222222223,44,44,CCCGTAAGGTGAACAAGTTG,0,1284000
furpa,0.022222222222222223,44,44,ACCGTTCCAGCGTTTTATAT,0,1294261
furpa,0.022222222222222223,44,44,AAATATTCTTGGGTCATAAC,0,1305939
furpa,0.022727272727272728,43,43,GCATTGAATAAATCGCCTTC,0,1319976
furpa,0.022727272727272728,43,43,CCCTCCGACGGTACGATTGT,0,1288590
furpa,0.022727272727272728,43,43,CAGGGGCTGTTAGCGCAAGT,0,1304978
furpa,0.022727272727272728,43,43,CACCGCTTATGAAACATGAT,0,1350867
furpa,0.022727272727272728,43,43,ACTACACTAGACAGGTGAGG,0,1291762
furpa,0.023255813953488372,42,42,TCGTGGTGTTAGTTGAAAAC,0,1275238
furpa,0.023255813953488372,42,42,TCAGGTATTGGGTGAGGAGT,0,1303360
furpa,0.023255813953488372,42,42,GGATATGTCCGATTTGCCTA,0,1350948
furpa,0.023255813953488372,42,42,GATCATTTTGCCGACGCCTA,0,1316676
furpa,0.023255813953488372,42,42,CTTACCGTCTAGAAAGCGTA,0,1287752
furpa,0.023255813953488372,42,42,CGTGGTAGACAAAAGACATA,0,1278965
furpa,0.023255813953488372,42,42,ACGGCAGAAATCATATATGT,0,1274791
furpa,0.023255813953488372,42,42,AAAGGATAGCGGCTTTTGAA,0,1276610
furpa,0.023809523809523808,41,41,GATCCGCGCGCGGCCGGTTC,0,1343358
furpa,0.023809523809523808,41,41,GAGTCAGGGCTCCGCCTATT,0,1335063
furpa,0.023809523809523808,41,41,CTTTAGAGGGGCAGGACCAC,0,1274194
furpa,0.023809523809523808,41,41,CCTCGAGTGTTTAGTATTCA,0,1346045
furpa,0.024390243902439025,40,40,TGGCTTGAAGCTCGGCAACA,0,1318034
furpa,0.024390243902439025,40,40,TACTACACCCCCGGCGAAGA,0,1293933
furpa,0.024390243902439025,40,40,GTCGTTGGTTCTCTATTGCT,0,1324060
furpa,0.024390243902439025,40,40,GTATCTCACGGTACATCCAT,0,1349505
furpa,0.024390243902439025,40,40,GTAGCGGAAACGCACTACAT,0,1309577
furpa,0.024390243902439025,40,40,GCGGGAACGTCTGTAGACTT,0,1334166
furpa,0.024390243902439025,40,40,CCATCGCGCGGTTGTATTCT,0,1290909
furpa,0.024390243902439025,40,40,CCACCTGTTGCCACACCCAC,0,1302199
furpa,0.024390243902439025,40,40,AAGGTTCGCCACTAAACTCA,0,1283001
furpa,0.025,39,39,TCTACATATCTAGAGGCGGA,0,1337757
furpa,0.025,39,39,TACGTTTTCCCTCTCGCGCG,0,1278607
furpa,0.025,39,39,TAAATAGACAGGCCACCAGA,0,1306653
furpa,0.025,39,39,GGTCAACACTCGCGATACAT,0,1311990
furpa,0.025,39,39,GGGTCGTGGCTGTTTCTCGA,0,1328597
furpa,0.025,39,39,CCATTTGGAATTCATAAGCT,0,1273189
furpa,0.025,39,39,CATATTGGGTACCTGGGCGA,0,1311147
furpa,0.025,39,39,ACCGGGAGGTATTCAACGCA,0,1353967
furpa,0.025,39,39,AAGCCACGCAGATCTCCTCA,0,1290511
furpa,0.02564102564102564,38,38,TTATACGTTTTATGCGAGAT,0,1288264
furpa,0.02564102564102564,38,38,TCAGTTAATAGTTTCACCAC,0,1285291
furpa,0.02564102564102564,38,38,TACTACCATCCCACTAACGT,0,1300396
furpa,0.02564102564102564,38,38,GCACCAAGGTCGATACAACG,0,1287688
furpa,0.02564102564102564,38,38,GATAAACGTCTGCGGAGATC,0,1315255
furpa,0.02564102564102564,38,38,CTGGTGTTCTAATCTACGTT,0,1314984
furpa,0.02564102564102564,38,38,CGTTCCCCTGAAGGTGGAGA,0,1271408
furpa,0.02564102564102564,38,38,CGTCAAGCTGGGCCACATCG,0,1285337
furpa,0.02564102564102564,38,38,AGGACCAAACGCCGGCTGGT,0,1342170
furpa,0.02564102564102564,38,38,ACCGAAGCTTGTGATCGACT,0,1333931
furpa,0.02564102564102564,38,38,ACACGCGCTTGGTTCTAAGT,0,1330574
furpa,0.02631578947368421,37,37,TTAGGACGTACGGTAATCCA,0,1280367
furpa,0.02631578947368421,37,37,TTAACCCAGCGTCCAGCCTC,0,1345387
furpa,0.02631578947368421,37,37,TGGCACTGCTTCGGACCTTA,0,1330267
furpa,0.02631578947368421,37,37,TGGAGGTCTCGGATATAAGT,0,1336887
furpa,0.02631578947368421,37,37,TCCACCCTGATGGAATGACA,0,1278975
furpa,0.02631578947368421,37,37,GTTATACACGAACGGGGTTG,0,1295279
furpa,0.02631578947368421,37,37,GGGTAGTATACTGCATACTT,0,1283348
furpa,0.02631578947368421,37,37,GCTGGCGTCTATAAGAGCAA,0,1317085
furpa,0.02631578947368421,37,37,GATTTGATCGGAAGCTTTGT,0,1315805
furpa,0.02631578947368421,37,37,GACATCTCGCTATGCGATGC,0,1296845
furpa,0.02631578947368421,37,37,ATCCATTGCATCACCTTTGA,0,1318457
furpa,0.02631578947368421,37,37,AGTCGCAGCTTTGACCAACA,0,1276812
furpa,0.02631578947368421,37,37,AGGCCACAAAATTATTTAGG,0,1274656
furpa,0.02631578947368421,37,37,AACGGCAAAGCGTATGAACA,0,1322683
furpa,0.02702702702702703,36,36,TTTGTTTGTAGAGCGAGGTT,0,1299778
furpa,0.02702702702702703,36,36,TTTCAGCTAAGCAGTGCAGT,0,1283737
furpa,0.02702702702702703,36,36,GTCCCGGTATCGTTACGCCG,0,1280742
furpa,0.02702702702702703,36,36,GAATTGTGCGCGCGAGTCCG,0,1290610
furpa,0.02702702702702703,36,36,CTCAGGCGTGTATAGGTGAA,0,1296796
furpa,0.02702702702702703,36,36,CGATGTATTTGCCTACTCTA,0,1288385
furpa,0.02702702702702703,36,36,CGACGGAAGTAGATCTAAAT,0,1328462
furpa,0.02702702702702703,36,36,AGCTTAACTCAGTTGGCGGT,0,1338431
furpa,0.02702702702702703,36,36,AGCGGTGCCTCACACGCTGC,0,1348056
furpa,0.027777777777777776,35,35,TTAGCTCCGATCACCCCTAG,0,1354069
furpa,0.027777777777777776,35,35,GTGAGGCGCCAAATATAGGT,0,1348431
furpa,0.027777777777777776,35,35,GGGTAAGACGGCCCGTAAGA,0,1311499
furpa,0.027777777777777776,35,35,GCAATCTCTCAGTCCTTCTT,0,1272654
furpa,0.027777777777777776,35,35,GATTCGTGCAGCTATCTGAT,0,1314404
furpa,0.027777777777777776,35,35,CGTTATGATAAATGCGAGAG,0,1307818
furpa,0.027777777777777776,35,35,CGGCTCGGTCTTTATAGGTT,0,1305740
furpa,0.027777777777777776,35,35,CGAATCGTAGGGCTTGGGAG,0,1282456
furpa,0.027777777777777776,35,35,CCCCGCGCAGGTTAGTTATA,0,1277849
furpa,0.027777777777777776,35,35,CCAGTCCTCGCCAGTGGACT,0,1291192
furpa,0.027777777777777776,35,35,AGTTGATTACGAGAGCCATG,0,1310287
furpa,0.027777777777777776,35,35,AGCCAGGCCCATGAGCGGGT,0,1272650
furpa,0.027777777777777776,35,35,ACTTCTATCGAATGGTACTG,0,1314225
furpa,0.027777777777777776,35,35,ACAATAAGCATTTTTCCTAT,0,1310217
furpa,0.02857142857142857,34,34,TTGGTACGTAAGGGAGATTT,0,1312431
furpa,0.02857142857142857,34,34,GTCGGTGAAGGCCGGAGTCT,0,1345653
furpa,0.02857142857142857,34,34,GTACCCCCGGGCGGGGTCAC,0,1308558
furpa,0.02857142857142857,34,34,GGTGCCTGCAGTTAGACCAT,0,1315993
furpa,0.02857142857142857,34,34,GGCCGCATGGGGGTCAACAC,0,1276448
furpa,0.02857142857142857,34,34,GCGTGCACACTCATAGCGCA,0,1355353
furpa,0.02857142857142857,34,34,GCGGTTCCGGGGAGGGGGGT,0,1304844
furpa,0.02857142857142857,34,34,CTGTCGTGGGATCCAACTAT,0,1289364
furpa,0.02857142857142857,34,34,CGTTGTAGCACAACGCAAGT,0,1323235
furpa,0.02857142857142857,34,34,CGAACAGGTTACGAGAGAGA,0,1292605
furpa,0.02857142857142857,34,34,CCCCGCAATGTTTCTAAGAG,0,1276609
furpa,0.02857142857142857,34,34,CCACCTTCAATTGAAACCAT,0,1291549
furpa,0.02857142857142857,34,34,CATTTTTTCATAGTTGTCGT,0,1347965
furpa,0.02857142857142857,34,34,CACACCCCACTTGGTTGGGT,0,1339408
furpa,0.02857142857142857,34,34,ATATACGCTGCATCCGGGAA,0,1328495
furpa,0.02857142857142857,34,34,ACTGACTTCCAAGCCACTTC,0,1272675
furpa,0.02857142857142857,34,34,AAGCCGCGTAAAAGGACAGA,0,1292526
furpa,0.029411764705882353,33,33,TTTCATCACAAAATATTTGA,0,1293295
furpa,0.029411764705882353,33,33,TTTAAGTTGGATGCCAGGAT,0,1353300
furpa,0.029411764705882353,33,33,TTATCCATTCGCTAGGATCT,0,1304063
furpa,0.029411764705882353,33,33,TGCGTGGTGTAAGGATGGTT,0,1302519
furpa,0.029411764705882353,33,33,TGCACGATACAGGAACCGGT,0,1301158
furpa,0.029411764705882353,33,33,TGATGGGCGTGCCTTCGGCA,0,1273178
furpa,0.029411764705882353,33,33,TATAAAAATCGTGTGAATAG,0,1305369
furpa,0.029411764705882353,33,33,GTGAGTTCGACACAGGTCTC,0,1341360
furpa,0.029411764705882353,33,33,GTATAATCCATGACGGTGCC,0,1284901
furpa,0.029411764705882353,33,33,GTAACTCAGGGACTTATCGA,0,1323878
furpa,0.029411764705882353,33,33,GGTCTTTTTGATGGTCTCCG,0,1287342
furpa,0.029411764705882353,33,33,GGCTCGGGGGTCCACTTACA,0,1309268
furpa,0.029411764705882353,33,33,GCTGGGCTTCGTAAATTTCA,0,1350149
furpa,0.029411764705882353,33,33,GCGTGCTAATGGCCAGAGGC,0,1288357
furpa,0.029411764705882353,33,33,GCGGGTCATGCAGTGTAATC,0,1287394
furpa,0.029411764705882353,33,33,GCGACTTATACGATGGCCTT,0,1308593
furpa,0.029411764705882353,33,33,GAGGTCGTCAAAGTCGATCA,0,1287927
furpa,0.029411764705882353,33,33,GAGATGGCCCTCGATAGGAG,0,1285619
furpa,0.029411764705882353,33,33,GACGATCGCACTAATATATC,0,1308131
furpa,0.029411764705882353,33,33,GACAGTATTGTGATGACAAG,0,1284002
furpa,0.029411764705882353,33,33,GAAAGGTTGCATTCACCGTG,0,1340639
furpa,0.029411764705882353,33,33,CGGCGGGGGAGAAAGCGTGA,0,1324286
furpa,0.029411764705882353,33,33,CCTGTCTCTCGTGGCGAAGA,0,1300458
furpa,0.029411764705882353,33,33,CCAGACGTAACTGGCAAATG,0,1357343
furpa,0.029411764705882353,33,33,CCAAATGACGATCTCTTTCG,0,1313574
furpa,0.029411764705882353,33,33,CAGTTACCGGTCTTGTGAAC,0,1306315
furpa,0.029411764705882353,33,33,CAGCGGTTGACAAGGTACTA,0,1297851
furpa,0.029411764705882353,33,33,ATGTTAAAATCATGCGGTAG,0,1301194
furpa,0.029411764705882353,33,33,ATGACTCAATGGTCGTTGGA,0,1341631
furpa,0.029411764705882353,33,33,AGGTCTCAATCTCTTTCGTT,0,1303714
furpa,0.029411764705882353,33,33,ACTGCATAACGCTGTGAACA,0,1310096
furpa,0.030303030303030304,32,32,TGAGTCTGACCTTTTATTCT,0,1332065
furpa,0.030303030303030304,32,32,TGACTGAATGCACATCCGGA,0,1311505
furpa,0.030303030303030304,32,32,TCGGTGGGTGGCACGGAGTT,0,1352357
furpa,0.030303030303030304,32,32,TCGCTACTATTCGCGCCAAG,0,1314549
furpa,0.030303030303030304,32,32,TCAGCCTACGCGCTGTTAAC,0,1344664
furpa,0.030303030303030304,32,32,TAATCTGCTTTCCGGAGGAC,0,1291997
furpa,0.030303030303030304,32,32,TAACGAGGTACTGGTGGTGG,0,1301571
furpa,0.030303030303030304,32,32,GTTAATAGGGATTTCTAGAC,0,1322426
furpa,0.030303030303030304,32,32,GTGGCGCCCCGGGTTAGTGT,0,1320631
furpa,0.030303030303030304,32,32,GTACTTACTATGGGGGGCCA,0,1333939
furpa,0.030303030303030304,32,32,GTAATGCGAGTCGTGCAAGG,0,1299057
furpa,0.030303030303030304,32,32,GGGTACCGTCAGTTTTACGA,0,1353324
furpa,0.030303030303030304,32,32,GGCCCAAGCAAGTGTAGATG,0,1323464
furpa,0.030303030303030304,32,32,GCGGTCCCGGTCCTTTGTCT,0,1330595
furpa,0.030303030303030304,32,32,GATTGGACAGCTGGGCAGGC,0,1330404
furpa,0.030303030303030304,32,32,GACAAACGCCAGCACACTTA,0,1302207
furpa,0.030303030303030304,32,32,CTGCTGGTGTACAATGACTA,0,1357715
furpa,0.030303030303030304,32,32,CTATTGTACTAATGTGGATG,0,1314213
furpa,0.030303030303030304,32,32,CCGGGCGAAGGCTGTCACTT,0,1292603
furpa,0.030303030303030304,32,32,CCCGGTGCCGATGAAAGGGG,0,1308642
furpa,0.030303030303030304,32,32,AATGTTAGCCGCCCCTTTTA,0,1304525
furpa,0.030303030303030304,32,32,AATCGCAGCTGATCATGACT,0,1293222
furpa,0.030303030303030304,32,32,AAGGGTAATCTTAAAACGTC,0,1309407
furpa,0.030303030303030304,32,32,AACGTATGATACGGACCCCA,0,1318477
furpa,0.03125,31,31,TAACAAGGCAAGTATCCGGT,0,1345040
furpa,0.03125,31,31,GTTCGGGGGGAGTTCCTGGA,0,1293217
furpa,0.03125,31,31,GTGTGGTGCGTTGAGTTCCA,0,1279414
furpa,0.03125,31,31,GTGATGGTGCTGCTTCGGGG,0,1271578
furpa,0.03125,31,31,GAGAGCATGACGTCATATAC,0,1343739
furpa,0.03125,31,31,GAATTAGCGTACGCTGAGTG,0,1324113
furpa,0.03125,31,31,GAAATAGACACCGAAAGAGA,0,1288095
furpa,0.03125,31,31,CTTGAGCTAGTTGCTTTGCG,0,1304350
furpa,0.03125,31,31,CTTAACTTGCGAAAGAAAGC,0,1321512
furpa,0.03125,31,31,CGACTTCGGCCGTGGCAAAA,0,1277760
furpa,0.03125,31,31,CCGTATAATCCTTGCGCTCT,0,1293842
furpa,0.03125,31,31,CCCGATTTTTTTCTAGGGCG,0,1350473
furpa,0.03125,31,31,CCCGAGATCGGAGGGTATGC,0,1353016
furpa,0.03125,31,31,CCCAGCGCGATGGATTGTGG,0,1314668
furpa,0.03125,31,31,ATGCCGTCAAAGGAAGGAAC,0,1341881
furpa,0.03125,31,31,ACAACGTGTGGTATCGTGAA,0,1298964
furpa,0.03125,31,31,AACTAAGGGGACGTACGCTA,0,1336891
furpa,0.03225806451612903,30,30,TTGTTTGTTATGTATCTTTT,0,1286576
furpa,0.03225806451612903,30,30,TTATCTCGAAACGGGGCAAG,0,1325907
furpa,0.03225806451612903,30,30,TGTGGCTTCGTAGGGTAGTA,0,1308768
furpa,0.03225806451612903,30,30,TGAGAGGTACAGTTTGTGAC,0,1276355
furpa,0.03225806451612903,30,30,TACCAGCTATCTCGACAGTA,0,1338899
furpa,0.03225806451612903,30,30,GTTTTAATGGCGGTCAAGGC,0,1315769
furpa,0.03225806451612903,30,30,GTGTAACTATATGGCTGCGC,0,1326098
furpa,0.03225806451612903,30,30,GTCGGTTTGGCAGACCAGGT,0,1301565
furpa,0.03225806451612903,30,30,GGTATTCTAGCCCACTTTTG,0,1323034
furpa,0.03225806451612903,30,30,GCCGACCATCTATGCTCAAT,0,1276971
furpa,0.03225806451612903,30,30,GCCCAGGGCTCAGCTCCGCT,0,1345845
furpa,0.03225806451612903,30,30,GATACCCTTTGTTGGTTCAC,0,1277996
furpa,0.03225806451612903,30,30,GAGCGGCGTGGAGAACGTGC,0,1295297
furpa,0.03225806451612903,30,30,GAGCCCCCAAATAGGGTTTA,0,1328645
furpa,0.03225806451612903,30,30,CTTGTACTACTCAATGGAAT,0,1296737
furpa,0.03225806451612903,30,30,CTTCCCACATTCGGGTTATA,0,1286970
furpa,0.03225806451612903,30,30,CTGGTCACGATGCTCATACA,0,1308650
furpa,0.03225806451612903,30,30,CTCCTGCTTTAGCTACGGGA,0,1298071
furpa,0.03225806451612903,30,30,CGGGATGGACCAGGAAATCC,0,1294121
furpa,0.03225806451612903,30,30,CGGCGAGTGCAGCTAGATCA,0,1271923
furpa,0.03225806451612903,30,30,CCAGATGCGCCCTCGTCCTG,0,1319103
furpa,0.03225806451612903,30,30,CACGAACAAACTCCCGCCAA,0,1271286
furpa,0.03225806451612903,30,30,ATGGTTTAGATTCAGTTCGT,0,1348373
furpa,0.03225806451612903,30,30,ATCGCAGGAGCCGCGATCCA,0,1327267
furpa,0.03225806451612903,30,30,ATCCACTCGATGGCATCTGT,0,1348772
furpa,0.03225806451612903,30,30,AGTCCTGCGCAGTCAAAGGA,0,1326524
furpa,0.03225806451612903,30,30,AGGATGATCGATGGAGCTGG,0,1348557
furpa,0.03225806451612903,30,30,AGCCGATGCGGCCAGAACTT,0,1324108
furpa,0.03225806451612903,30,30,AAGGGGGGGCCGTTGGGGTT,0,1331831
furpa,0.03225806451612903,30,30,AACGGACGGATAACTCGTAC,0,1276443
furpa,0.03333333333333333,29,29,TTTGTAGCATAGATCGACAA,0,1287986
furpa,0.03333333333333333,29,29,TGGAATCGATGGAGTCGTCT,0,1273358
furpa,0.03333333333333333,29,29,TGCTCGTCATCCGGTGCGAT,0,1325018
furpa,0.03333333333333333,29,29,TCTGGTTGAGGTGCGTGGAA,0,1280064
furpa,0.03333333333333333,29,29,TCGAGCGCCAAATGCAAGAA,0,1356919
furpa,0.03333333333333333,29,29,TAGAAGTCGGCTATTGGGTG,0,1315028
furpa,0.03333333333333333,29,29,TACAAAATAATCGTATTTCT,0,1339180
furpa,0.03333333333333333,29,29,GTCACGCGTGGTCGCGGTAA,0,1339817
furpa,0.03333333333333333,29,29,GGGTTCACTGCTCACTAGTA,0,1291355
furpa,0.03333333333333333,29,29,GGGAGGCTTTAACGGGAGAG,0,1293011
furpa,0.03333333333333333,29,29,GGCGAAGACATGTGGTGATT,0,1325216
furpa,0.03333333333333333,29,29,GCCTCAGGTGACTTCTTATC,0,1323551
furpa,0.03333333333333333,29,29,GCCCTGTCCAGACTACATGT,0,1323110
furpa,0.03333333333333333,29,29,GATCGCTTATCACGTCAAGA,0,1304994
furpa,0.03333333333333333,29,29,GAGTCGCTACTCTGTGCATT,0,1282855
furpa,0.03333333333333333,29,29,GAGAAGCCGATCGAAAGCTT,0,1274572
furpa,0.03333333333333333,29,29,GACCTTGACGCATTTAACCT,0,1337234
furpa,0.03333333333333333,29,29,GAAGGTGGAGACACTGCGCC,0,1272125
furpa,0.03333333333333333,29,29,CTTGGGTTTCTGGACCGGTC,0,1348170
furpa,0.03333333333333333,29,29,CTTACATCCGACGCACAGTG,0,1352343
furpa,0.03333333333333333,29,29,CTGGGCTTCGGAGGTACCCA,0,1294698
furpa,0.03333333333333333,29,29,CTCACATGTCATAGAGAGCA,0,1345876
furpa,0.03333333333333333,29,29,CTATGGGCACAATACCTTGA,0,1311507
furpa,0.03333333333333333,29,29,CGCATACATACTCGTAGGGA,0,1309270
furpa,0.03333333333333333,29,29,CGAGTAACTGGCACCACTCC,0,1300104
furpa,0.03333333333333333,29,29,CGAGAACCCAAATATAGGAG,0,1318125
furpa,0.03333333333333333,29,29,CCCGTCGGCGGCTGGCTACT,0,1314283
furpa,0.03333333333333333,29,29,CCCGACCCACCGACGCAAAG,0,1333153
furpa,0.03333333333333333,29,29,CCCACAACTTATAGTGTCTA,0,1323031
furpa,0.03333333333333333,29,29,CAGCCTGGAACCATCCCCGG,0,1300268
furpa,0.03333333333333333,29,29,ATTTTCACTCCCTACTGAAA,0,1340528
furpa,0.03333333333333333,29,29,ATTGGTGTAATAGTGATCAT,0,1344608
furpa,0.03333333333333333,29,29,ATTAATCTAACGCCTAAAGC,0,1315896
furpa,0.03333333333333333,29,29,AGGGATAGCACGCGCCTGCC,0,1282189
furpa,0.03333333333333333,29,29,AGCCATTCGCACGCCGGGAG,0,1284471
furpa,0.03333333333333333,29,29,AGCCAATCCGACGCAATCAC,0,1293002
furpa,0.03333333333333333,29,29,ACATGAAGTGTACCGTTCAT,0,1297777
furpa,0.03333333333333333,29,29,ACACTCTAGAACTATAGAAA,0,1289088
furpa,0.03333333333333333,29,29,AATTCAACTGAGCTCTCGTA,0,1287151
furpa,0.034482758620689655,28,28,TTGACCGACCGGCGGGCGTC,0,1278135
furpa,0.034482758620689655,28,28,TTCGCGTGTATTACGACTTG,0,1315034
furpa,0.034482758620689655,28,28,TGGCCCGATCTGGGCCAGGC,0,1295606
furpa,0.034482758620689655,28,28,TGCTGCAGCAGCAGTCTGCA,0,1318135
furpa,0.034482758620689655,28,28,TGACAATGTAGGTTGCCACT,0,1306341
furpa,0.034482758620689655,28,28,TCGTCAGCTAAAATTCTAGC,0,1311924
furpa,0.034482758620689655,28,28,TCCGAAACTGGTGTTACGTG,0,1288671
furpa,0.034482758620689655,28,28,TCAGTAAGATATGCCCACGT,0,1286783
furpa,0.034482758620689655,28,28,TACTATGTGGGCAGTCTAGT,0,1337230
furpa,0.034482758620689655,28,28,TACGGGAGGGATGTTCTTTG,0,1295310
furpa,0.034482758620689655,28,28,GTGCGCCGGTTAAAGGGTCA,0,1295044
furpa,0.034482758620689655,28,28,GTCTTAAGAGTTCTCGCATA,0,1282595
furpa,0.034482758620689655,28,28,GGGCCGTTTGCAACTCCCAA,0,1343147
furpa,0.034482758620689655,28,28,GCTCGCGTGAACGTCCTGCA,0,1312744
furpa,0.034482758620689655,28,28,GCAGTTCATAGCGGAGAAGT,0,1274068
furpa,0.034482758620689655,28,28,GCAACGGCATTGGGGCTTCC,0,1318343
furpa,0.034482758620689655,28,28,GATTATCGAGCCTAAAGTTA,0,1308204
furpa,0.034482758620689655,28,28,CTTTTTAAACCCTGTTTTAG,0,1278768
furpa,0.034482758620689655,28,28,CTGTCTCCCCGGGTCCAACA,0,1272334
furpa,0.034482758620689655,28,28,CTGGATTAGGCCCCGTGTAG,0,1349123
furpa,0.034482758620689655,28,28,CGTTATCAATAGTGCCTTAT,0,1349402
furpa,0.034482758620689655,28,28,CCGGAACGGTTGCGTGAGTT,0,1279511
furpa,0.034482758620689655,28,28,CCCGTTGGTTGCCTCATATT,0,1344833
furpa,0.034482758620689655,28,28,CCAATAACACGTCCGTTTTA,0,1334508
furpa,0.034482758620689655,28,28,CATTTAGAGTACGGTGACGC,0,1325392
furpa,0.034482758620689655,28,28,ATAAAGTATGTGCTCGCGCA,0,1332599
furpa,0.034482758620689655,28,28,AGCAGGCGCTTTAGTCTGTC,0,1289861
furpa,0.034482758620689655,28,28,ACGGGTCAAAGACCTGGTTG,0,1301207
furpa,0.034482758620689655,28,28,ACGACTAGCAAACATGAGCG,0,1271814
furpa,0.034482758620689655,28,28,ACCGCAGTCCCATCTTCCAG,0,1357606
furpa,0.034482758620689655,28,28,AAATATATTAGTGACTGCTA,0,1323098
furpa,0.03571428571428571,27,27,TTTGTGTTGCCTTCGCGCCA,0,1337076
furpa,0.03571428571428571,27,27,TGTTGAGCTAAGAAACCTAA,0,1319030
furpa,0.03571428571428571,27,27,TGGGTTGCAATAGAGAGATC,0,1348836
furpa,0.03571428571428571,27,27,TGGACCATTTGCTTGACACT,0,1336208
furpa,0.03571428571428571,27,27,TGCCGCTTGCTTCTTCTAAT,0,1355060
furpa,0.03571428571428571,27,27,TGATGATGTTACCCAGCTAA,0,1282504
furpa,0.03571428571428571,27,27,TGAGTCTCCGGACATGGCCT,0,1299766
furpa,0.03571428571428571,27,27,TCGCGCTAAAGCTTTCTCTC,0,1282684
furpa,0.03571428571428571,27,27,TCGCACTGCATATCACATTG,0,1322516
furpa,0.03571428571428571,27,27,TATTCGGTCGGGCCTTTCGT,0,1322702
furpa,0.03571428571428571,27,27,TATAGCTAAAGGGAGAACAT,0,1274399
furpa,0.03571428571428571,27,27,TACTTTAGTCCCTGATTTCC,0,1290472
furpa,0.03571428571428571,27,27,GTTATTAAGAAACAGACCTG,0,1300997
furpa,0.03571428571428571,27,27,GTCTAGCGGAGCATGGGTTT,0,1293113
furpa,0.03571428571428571,27,27,GTCATAATAAGTTAAGTAAG,0,1274316
furpa,0.03571428571428571,27,27,GGTGAATCCGTGTTCAACCA,0,1314113
furpa,0.03571428571428571,27,27,GGATTTGATGACGGAGTGCG,0,1308107
furpa,0.03571428571428571,27,27,GCGTAGCACTCGGCTATTAT,0,1272738
furpa,0.03571428571428571,27,27,GCGGAAATGATCCCCGTCAT,0,1316331
furpa,0.03571428571428571,27,27,GCAACTCCGTGGCAAGTGAA,0,1288831
furpa,0.03571428571428571,27,27,GAGCTCGTTACCTTGTGAAA,0,1298782
furpa,0.03571428571428571,27,27,GAGCGTAGAATATGCTTCCG,0,1317504
furpa,0.03571428571428571,27,27,GAAATGCGTAGCAGGTAACG,0,1273715
furpa,0.03571428571428571,27,27,CTGTAAAGCGGGGCAGTACA,0,1320900
furpa,0.03571428571428571,27,27,CTATGGGTTCTCGCAGGTTA,0,1337331
furpa,0.03571428571428571,27,27,CGGGGCCTCCATAACATGGT,0,1348184
furpa,0.03571428571428571,27,27,CGAGGAGCGACCCCTCGCTG,0,1328217
furpa,0.03571428571428571,27,27,CCTCTAGCAGCGTTTACTAG,0,1322688
furpa,0.03571428571428571,27,27,CCGAGTGTGGCTAGGGGATA,0,1328438
furpa,0.03571428571428571,27,27,CCACGAGGCTGAGTCTACAA,0,1295706
furpa,0.03571428571428571,27,27,CATGCTTGAGACGCGATCAT,0,1351676
furpa,0.03571428571428571,27,27,CAGGCATCACAATTGGGTAG,0,1328764
furpa,0.03571428571428571,27,27,CAGCTCTGCGGGGCTCGCGA,0,1351114
furpa,0.03571428571428571,27,27,CACGCGATTGCCTCGTGGCT,0,1289360
furpa,0.03571428571428571,27,27,CACGCCACCACTGCGGTTTC,0,1348906
furpa,0.03571428571428571,27,27,ATCGTTATAGAACGTGTGAA,0,1291119
furpa,0.03571428571428571,27,27,ATCGAGGAGATATGGCAAAC,0,1294926
furpa,0.03571428571428571,27,27,ACGGCCGTCTAAAACCGAGT,0,1316055
furpa,0.03571428571428571,27,27,ACCCAGTACATCATTTACCA,0,1313585
furpa,0.03571428571428571,27,27,ACATGTATCCACGGGACTGG,0,1289153
furpa,0.03571428571428571,27,27,AAGGAGCACGATCGCCCAAG,0,1289656
furpa,0.03571428571428571,27,27,AAAGTGCGGGTTAAGTGCGT,0,1332702
furpa,0.037037037037037035,26,26,TTTTGCATCACTGCAGCTAT,0,1325523
furpa,0.037037037037037035,26,26,TTGAGTTGTTGTTTGTGGTG,0,1308062
furpa,0.037037037037037035,26,26,TTCAAAGAATGCCTTGGTTC,0,1322167
furpa,0.037037037037037035,26,26,TGTTGTGAATGTGGAAGACG,0,1315570
furpa,0.037037037037037035,26,26,TGGGTTTATCAGCTGTACTT,0,1327110
furpa,0.037037037037037035,26,26,TGAGTATCGTGGCTGGGGGT,0,1338772
furpa,0.037037037037037035,26,26,TGACTGTGCGTTGGTCTGCT,0,1338943
furpa,0.037037037037037035,26,26,TCCCACATAGTACGTTTGGT,0,1315036
furpa,0.037037037037037035,26,26,TCCAAGGCATTCATAGATCA,0,1305233
furpa,0.037037037037037035,26,26,TATCTTGCGATGAGTTCAAG,0,1302917
furpa,0.037037037037037035,26,26,TACTCTGTCGCCGGTTATCT,0,1310116
furpa,0.037037037037037035,26,26,TACGTTCGGAGGCGAGAGTA,0,1308368
furpa,0.037037037037037035,26,26,TACACTGTCGAAAGATGGCC,0,1290427
furpa,0.037037037037037035,26,26,TACACTACTAACCAAGTATA,0,1294793
furpa,0.037037037037037035,26,26,TAAGCGCTCTTGCTGTGACC,0,1290670
furpa,0.037037037037037035,26,26,TAACCCTGTACACGTAGGGT,0,1296115
furpa,0.037037037037037035,26,26,GTTCCCCCACATAAATGACA,0,1334861
furpa,0.037037037037037035,26,26,GTTACCACAACTCACACACA,0,1318950
furpa,0.037037037037037035,26,26,GTGTAGCCGGACGCAGTCAG,0,1316379
furpa,0.037037037037037035,26,26,GTGCAAGGTGGAGGGCGACC,0,1289321
furpa,0.037037037037037035,26,26,GTCGTAGTTGAGAAGGGTTT,0,1349069
furpa,0.037037037037037035,26,26,GTCCTTGGCCTTGCTTCATC,0,1296065
furpa,0.037037037037037035,26,26,GTAGCGTTGTCCCCGGGTAT,0,1293285
furpa,0.037037037037037035,26,26,GGTTATGCTTCGTCTCTAGA,0,1312121
furpa,0.037037037037037035,26,26,GGTCTTCCGAACGGCGATCG,0,1297081
furpa,0.037037037037037035,26,26,GGGCTTGGGAATTTTAGAGT,0,1294790
furpa,0.037037037037037035,26,26,GGGCCTCTAGCTGAGTCGTC,0,1316588
furpa,0.037037037037037035,26,26,GGGCATCCGAGTCCGCTGCA,0,1333187
furpa,0.037037037037037035,26,26,GGCGTAAGTATGGGCATCAC,0,1351322
furpa,0.037037037037037035,26,26,GGCAAATGCAACCAGGCCCA,0,1323216
furpa,0.037037037037037035,26,26,GGACTTAACTATAGGGGTTT,0,1272443
furpa,0.037037037037037035,26,26,GCTCGGAGAATATAGGGTCC,0,1315524
furpa,0.037037037037037035,26,26,GCCGTAGATCGCCTGTTAGA,0,1274143
furpa,0.037037037037037035,26,26,GCCATGTTTGCATCAGGTTA,0,1355716
furpa,0.037037037037037035,26,26,GCACTGTGAGACATGCACCT,0,1280661
furpa,0.037037037037037035,26,26,GCACCCCGTCTGTCAAGTAA,0,1352855
furpa,0.037037037037037035,26,26,GATTGAGTTACAACGCGGAG,0,1320380
furpa,0.037037037037037035,26,26,CTTACGCACACCAATGATAC,0,1347982
furpa,0.037037037037037035,26,26,CTGACCTGACTAATGTCATA,0,1297099
furpa,0.037037037037037035,26,26,CTAAGCTACCCGCACGAATC,0,1307187
furpa,0.037037037037037035,26,26,CGTAAACCTTTCGGATAGTC,0,1318948
furpa,0.037037037037037035,26,26,CGCGTCCATGACTACAACAT,0,1342151
furpa,0.037037037037037035,26,26,CGAGCAACCAATCCCACTAA,0,1322358
furpa,0.037037037037037035,26,26,CGACAAGCTCTGCCGGTTCA,0,1347907
furpa,0.037037037037037035,26,26,CCGTTAGTATAGTATGGACC,0,1353700
furpa,0.037037037037037035,26,26,CCGCGCATTCTGAGGCTCAT,0,1352122
furpa,0.037037037037037035,26,26,CCATCGTGCTGAACTCACTC,0,1322883
furpa,0.037037037037037035,26,26,CCAGACCCATCACCGGTACA,0,1303712
furpa,0.037037037037037035,26,26,CATTCAATGTTGCGCATCGT,0,1305932
furpa,0.037037037037037035,26,26,CATGTTTGATCCCAGGCTTG,0,1278920
furpa,0.037037037037037035,26,26,CACCAGTCCCTGTGACTGGG,0,1289322
furpa,0.037037037037037035,26,26,CACACGTACGGGTTGCATAT,0,1355256
furpa,0.037037037037037035,26,26,CAATTGAGGTTGGCCTTGCT,0,1289427
furpa,0.037037037037037035,26,26,CAACCTCACGCAGGGTATTA,0,1309522
furpa,0.037037037037037035,26,26,ATTATCAAACTGACGCGGGA,0,1285683
furpa,0.037037037037037035,26,26,ATGTGGATTGGCTACCATCC,0,1273607
furpa,0.037037037037037035,26,26,ATGAAAGCACGGCACAGCAG,0,1312896
furpa,0.037037037037037035,26,26,ATCGCCTTACCGTTCTACTT,0,1294452
furpa,0.037037037037037035,26,26,AGTTGAGCCGCTCGAGTTCT,0,1285299
furpa,0.037037037037037035,26,26,AGTCTTGTTGGGTGGACCAA,0,1334727
furpa,0.037037037037037035,26,26,AGTCGGTACCCGGGTTTTAA,0,1304322
furpa,0.037037037037037035,26,26,AGTCATTTACTCACTCGTAG,0,1326389
furpa,0.037037037037037035,26,26,AGTAACACTACCCTGCGATG,0,1271542
furpa,0.037037037037037035,26,26,AGGACACGTACGGTCCACTT,0,1330344
furpa,0.037037037037037035,26,26,AGCTATTGAAGTTCGATATC,0,1330579
furpa,0.037037037037037035,26,26,AGAAGAATGTTTTCTATGGA,0,1297348
furpa,0.037037037037037035,26,26,ACGGCGCAGCAGCTCGGTTC,0,1344461
furpa,0.037037037037037035,26,26,ACCAGTGCTAGTCCGACGAT,0,1331935
furpa,0.037037037037037035,26,26,ACATAAGACCCTCCGACAAA,0,1314677
furpa,0.037037037037037035,26,26,ACAAAATACTTATTTCTATA,0,1300045
furpa,0.037037037037037035,26,26,AAACCGTTCAGGCACCGAAG,0,1325149
furpa,0.038461538461538464,25,25,TTTGAGCGCACCCGACGAAT,0,1303459
furpa,0.038461538461538464,25,25,TTACGGTTGTTGTAAGGCCT,0,1312525
furpa,0.038461538461538464,25,25,TGTCGGTTGCGGCAGCATAT,0,1318224
furpa,0.038461538461538464,25,25,TGTCACGCGGACTAGATCAA,0,1288040
furpa,0.038461538461538464,25,25,TGCGGACTTAACCTATCGAA,0,1283440
furpa,0.038461538461538464,25,25,TGCGCGAGTTCTGCCGAATT,0,1305861
furpa,0.038461538461538464,25,25,TGCAGGCGGATAGCAAGCGA,0,1301152
furpa,0.038461538461538464,25,25,TCTTAATGAAATCAAAGGGT,0,1325679
furpa,0.038461538461538464,25,25,TCAAATCACTAGTCTATAGG,0,1310668
furpa,0.038461538461538464,25,25,TATGTTTGTATCTCGGCAAT,0,1327976
furpa,0.038461538461538464,25,25,TATACGCAGCGGGAGCTCTT,0,1298377
furpa,0.038461538461538464,25,25,TACGTACTTCGTCCGTTGTT,0,1299060
furpa,0.038461538461538464,25,25,GTGACTGGAAGTAGTAGCAG,0,1278966
furpa,0.038461538461538464,25,25,GTGACAGTTCCTGTCTAGGG,0,1354638
furpa,0.038461538461538464,25,25,GTCGAAAACGCCGCGAGAAA,0,1318270
furpa,0.038461538461538464,25,25,GGTGAAGATGAAGACCATCG,0,1334653
furpa,0.038461538461538464,25,25,GGTAGGTAGTAATCCACGTG,0,1350530
furpa,0.038461538461538464,25,25,GGGTTGCCGGGGAGCCCAAT,0,1323530
furpa,0.038461538461538464,25,25,GGGTTAAGGCGGACCACCAC,0,1292675
furpa,0.038461538461538464,25,25,GGCGGGTCTGTTTGCGGACT,0,1335037
furpa,0.038461538461538464,25,25,GGCATACGAAGCGAACGTGC,0,1343951
furpa,0.038461538461538464,25,25,GCTCGATAGGATGTGATTAA,0,1290726
furpa,0.038461538461538464,25,25,GCGCGGGGATAGCGGCTTCA,0,1275562
furpa,0.038461538461538464,25,25,GCGCATGCGCTAACTGTACT,0,1322567
furpa,0.038461538461538464,25,25,GCCGCCATGGCCAATAGGCC,0,1323958
furpa,0.038461538461538464,25,25,GAGGCTCCTATACGGATCTG,0,1284172
furpa,0.038461538461538464,25,25,GAATAAGTATGAGACGTTTT,0,1333923
furpa,0.038461538461538464,25,25,GAACACCCCTGTAGGCCCTA,0,1294789
furpa,0.038461538461538464,25,25,CTTTCCGATCTTGCGTTATC,0,1331989
furpa,0.038461538461538464,25,25,CTTGTGGGTGCTGCATGATG,0,1332848
furpa,0.038461538461538464,25,25,CTTACGGAATATACATAATG,0,1284063
furpa,0.038461538461538464,25,25,CTGCTCACGCCGGCAGGCAG,0,1316938
furpa,0.038461538461538464,25,25,CTGATCATCTGTGCGTCGAT,0,1355494
furpa,0.038461538461538464,25,25,CTGAAGCCGCTCTCGCATGA,0,1321854
furpa,0.038461538461538464,25,25,CTCGACGGGAGGTTAAGCAT,0,1287039
furpa,0.038461538461538464,25,25,CTCACGTCTCTGACCGCTTA,0,1305548
furpa,0.038461538461538464,25,25,CTAGGAGTCTAAATCTCCAC,0,1343838
furpa,0.038461538461538464,25,25,CGTACCCCCCGGGTTGGGAA,0,1328295
furpa,0.038461538461538464,25,25,CGCTGTAACGGCACATTAGT,0,1354939
furpa,0.038461538461538464,25,25,CGAGGTCACCGTGCGTGTTA,0,1325286
furpa,0.038461538461538464,25,25,CGAGCGTCGTACGTCCAATA,0,1327039
furpa,0.038461538461538464,25,25,CCGATTGTTACCCTCACACA,0,1337291
furpa,0.038461538461538464,25,25,CATCGTTCTCATGTCATAAG,0,1313932
furpa,0.038461538461538464,25,25,CAGGTAGCGTTCTTATTGAA,0,1294235
furpa,0.038461538461538464,25,25,CAGCCTCACTAAACAGGCGC,0,1345307
furpa,0.038461538461538464,25,25,CAGAAGTTACAATTTAATCT,0,1344502
furpa,0.038461538461538464,25,25,CAAACTTTTATTCGGCGGAC,0,1280905
furpa,0.038461538461538464,25,25,AGTCGCGCGCCCCGGACAAC,0,1286468
furpa,0.038461538461538464,25,25,AGGTCGTATCCAGAGAATTA,0,1307472
furpa,0.038461538461538464,25,25,AGAAGCGCGAGCATTTTGCC,0,1299709
furpa,0.038461538461538464,25,25,ACTACGCTGACTGAACTCGT,0,1328989
furpa,0.038461538461538464,25,25,ACGGCTCAATGAGGTGTAAT,0,1274712
furpa,0.038461538461538464,25,25,ACACTAAACGGGCATGTCGT,0,1345086
furpa,0.038461538461538464,25,25,ACAATGCCAACGATTACAAT,0,1314666
furpa,0.038461538461538464,25,25,AATTGCTTCGAAGGTGAGTG,0,1297934
furpa,0.038461538461538464,25,25,AATCCTCAGCCAGTTGATGA,0,1335891
furpa,0.038461538461538464,25,25,AAGGGTCGGACCGGGATCTC,0,1315854
furpa,0.038461538461538464,25,25,AAGGGAGTAGTACATATCAA,0,1344441
furpa,0.038461538461538464,25,25,AAGCTCTCGACCTACCGGAG,0,1286477
furpa,0.038461538461538464,25,25,AAGCCCGCCTTAGACTCGGC,0,1354382
furpa,0.038461538461538464,25,25,AACCCCTCATCCCAAACTGG,0,1333922
furpa,0.04,24,24,TTTATAGGTCAGGTCGTACC,0,1298008
furpa,0.04,24,24,TTCTATCCAGATTTAAGTGA,0,1347139
furpa,0.04,24,24,TTCGTGTAACGTTAGCTCCC,0,1278431
furpa,0.04,24,24,TTAGGGGGACGCACGTAAGT,0,1341317
furpa,0.04,24,24,TGTCATAGCGGCTTCAGAGT,0,1306066
furpa,0.04,24,24,TGGGGGTGACCCCGATGAGG,0,1315661
furpa,0.04,24,24,TGGGACTTAATGCGATTATG,0,1276055
furpa,0.04,24,24,TGGCATCGAATTGGGAAAGT,0,1314488
furpa,0.04,24,24,TGCCGCCCTGTCCAAGAATT,0,1350964
furpa,0.04,24,24,TGACGGAGAGAATGACGTCT,0,1331204
furpa,0.04,24,24,TCTATGTCTGACAACTAAGC,0,1279413
furpa,0.04,24,24,TCGTTTAAGAAAAGAACCGA,0,1328620
furpa,0.04,24,24,TCGAACCATCGTTTTGGCAT,0,1345729
furpa,0.04,24,24,TCCAGATTGGGACAATCTGA,0,1283944
furpa,0.04,24,24,TCACAATGGCAACATGGTGA,0,1340426
furpa,0.04,24,24,TATTTTACCTGACATCGGCC,0,1343249
furpa,0.04,24,24,GTTTGCGACATGGTAACCCG,0,1282477
furpa,0.04,24,24,GTTTGACCAGGAGCAATATA,0,1330003
furpa,0.04,24,24,GTTTCAAGTCTAGCTGCTTA,0,1337932
furpa,0.04,24,24,GTTTAATTTCAAGGCGAACC,0,1332035
furpa,0.04,24,24,GTGGTGGTTAATTCCGACAC,0,1319640
furpa,0.04,24,24,GTCGCTTCGCTCTGGTGATT,0,1286820
furpa,0.04,24,24,GTATTACGATATGTAATTCA,0,1310814
furpa,0.04,24,24,GGTGTAGAGTTAATAAGGTT,0,1295828
furpa,0.04,24,24,GGTGCGAAATCCTTTAAAAT,0,1289962
furpa,0.04,24,24,GGTAAGCGGAGAGAGTGTGT,0,1335802
furpa,0.04,24,24,GGGTTCGTCCAAACCACGCA,0,1315397
furpa,0.04,24,24,GGGCACAGCGATTTATAATG,0,1274751
furpa,0.04,24,24,GGCGGCTTTCTTATTCTTGT,0,1281801
furpa,0.04,24,24,GGCGGAACTAGGGGCCTTTT,0,1342850
furpa,0.04,24,24,GGCGACGTTCGGCGAAGCTC,0,1322161
furpa,0.04,24,24,GCTGGGCCGTGAGTATAGCT,0,1291471
furpa,0.04,24,24,GCTCGTGCGACCGGGGATCG,0,1287504
furpa,0.04,24,24,GCTATCAAATACACGCCTCT,0,1295546
furpa,0.04,24,24,GCGAAAGCCAAACCATACGC,0,1329785
furpa,0.04,24,24,GCATGTGGGGAAGTTACCTG,0,1320854
furpa,0.04,24,24,GCACAGTTTAAATGGGCTGA,0,1313280
furpa,0.04,24,24,GAATAAGGACCTCATTGTGT,0,1294791
furpa,0.04,24,24,GAACCCGGTTCAAGCAAGGT,0,1346019
furpa,0.04,24,24,GAAACGCTTCGAAACGTCAC,0,1350576
furpa,0.04,24,24,CTGGCTAGCGGTCGCTGGTA,0,1346598
furpa,0.04,24,24,CTGAGGTTGCTCTTCGGGCA,0,1291629
furpa,0.04,24,24,CTACCATACATCCTCTCGGC,0,1324355
furpa,0.04,24,24,CGTGGCTTTGATATCTATAA,0,1300592
furpa,0.04,24,24,CGGGTAATGTTGTCCACCGT,0,1293623
furpa,0.04,24,24,CGGGATCGTTATGTTCGACT,0,1324365
furpa,0.04,24,24,CGCAGGTGGTGAATAATCTT,0,1295695
furpa,0.04,24,24,CGCAGGTCTGGATGGACACC,0,1339797
furpa,0.04,24,24,CGAGCGCTTCACAGCCTACT,0,1338116
furpa,0.04,24,24,CCACTTCTACGTGGTACGCA,0,1274193
furpa,0.04,24,24,CCAAAGCTGTTGCCTGTCGT,0,1335301
furpa,0.04,24,24,CATCTCAGAGGGGATGCACT,0,1342426
furpa,0.04,24,24,CACTCAAAAGCACTAGCAGC,0,1313070
furpa,0.04,24,24,CACGATCCGGTCCGAATAAT,0,1274092
furpa,0.04,24,24,CAATTTAAGACTGAGATCAC,0,1278486
furpa,0.04,24,24,CAAGGACGACAGACAATTTG,0,1294540
furpa,0.04,24,24,CAACTGAACGCCGTGTACCA,0,1276194
furpa,0.04,24,24,ATTGTACATACCTTAGTTTC,0,1284860
furpa,0.04,24,24,ATCTTCGTAGTCACCAAGAA,0,1349324
furpa,0.04,24,24,ATCCTGATGGCTAAGCCCTG,0,1313174
furpa,0.04,24,24,ATATGAGGCAGAGGTCTGCG,0,1320745
furpa,0.04,24,24,ATATCCGGGCTGATCTTAAA,0,1299908
furpa,0.04,24,24,AGCATTAATACGTAGGTGCA,0,1309717
furpa,0.04,24,24,AGACACTCATAGGACAGCGT,0,1303013
furpa,0.04,24,24,ACCGCAGACCTTTCCACGCA,0,1323582
furpa,0.04,24,24,ACCGACGATTCTCCACCTCT,0,1322773
furpa,0.04,24,24,ACCCTGAGGGTGACACTTCG,0,1292081
furpa,0.04,24,24,ACCCGCAAGATTGCCTCCCC,0,1339803
furpa,0.04,24,24,ACAAGTCAATAGTGTGGAAG,0,1287572
furpa,0.04,24,24,AAGGGGTGAGAAACACTCAT,0,1341366
furpa,0.04,24,24,AAATTCCCGATGCGGCACAT,0,1340204
furpa,0.041666666666666664,23,23,TTTTAGCGGGGCTTGTTGCG,0,1281328
furpa,0.041666666666666664,23,23,TTGAGTATCCAGAGGTAGAA,0,1327215
furpa,0.041666666666666664,23,23,TGGATATTGAGGAGTCGTTC,0,1290459
furpa,0.041666666666666664,23,23,TCTTCGTATCGCAATATGGT,0,1329741
furpa,0.041666666666666664,23,23,TCGTTGACCCGGACTATACG,0,1321286
furpa,0.041666666666666664,23,23,TCGATGTTGCTACCCTTGTT,0,1277752
furpa,0.041666666666666664,23,23,TCCGGGCAGTATCGTTATAG,0,1278638
furpa,0.041666666666666664,23,23,TCCCGACTACAGTACCCACT,0,1293716
furpa,0.041666666666666664,23,23,TCCATCCGCAGGGTCCAGTA,0,1315814
furpa,0.041666666666666664,23,23,TCAATCACTTGATGCCCCGC,0,1276624
furpa,0.041666666666666664,23,23,TATTTCTTGCGGGGGAGACA,0,1331397
furpa,0.041666666666666664,23,23,TAGCGCAAACTGGGAAGATG,0,1322706
furpa,0.041666666666666664,23,23,TAAATATTTCTTCTGACTGG,0,1319823
furpa,0.041666666666666664,23,23,GTGCGTTTACTCGATCGACC,0,1324353
furpa,0.041666666666666664,23,23,GTGCCCGTCCACTTATTCAT,0,1335361
furpa,0.041666666666666664,23,23,GTCTAAGGGATTTTTCCCCT,0,1325714
furpa,0.041666666666666664,23,23,GTAATTTGAGTGTGTAGCGT,0,1355746
furpa,0.041666666666666664,23,23,GGTGGCTGTATTGGACGCTA,0,1325992
furpa,0.041666666666666664,23,23,GGGCGAAAGTCTCAGGCCTT,0,1319567
furpa,0.041666666666666664,23,23,GGCTCCATGAAGAGTAAGTC,0,1326843
furpa,0.041666666666666664,23,23,GGATACCGGTGTCTCCGCAT,0,1357663
furpa,0.041666666666666664,23,23,GGAGCAAACCGAGTTCAACC,0,1340186
furpa,0.041666666666666664,23,23,GGACTTGCATACCCGTGGAT,0,1319427
furpa,0.041666666666666664,23,23,GCTTTTACGTAGAGCACGTT,0,1306870
furpa,0.041666666666666664,23,23,GCTTAAGGTCGCCGTCCTCG,0,1295285
furpa,0.041666666666666664,23,23,GCTCCCAGGTGTCCCAGGGC,0,1290368
furpa,0.041666666666666664,23,23,GCTATACGACGCGGGCATGC,0,1296033
furpa,0.041666666666666664,23,23,GCTAATGCCATCCCGGTATT,0,1347918
furpa,0.041666666666666664,23,23,GCGGCAAAAAGGTCGCTCCA,0,1299783
furpa,0.041666666666666664,23,23,GCGATTCTCGGGATGTCATT,0,1347627
furpa,0.041666666666666664,23,23,GCACGGGACGTTCTAAGGGA,0,1296899
furpa,0.041666666666666664,23,23,GATCCTATGCTTGCTGCATT,0,1339480
furpa,0.041666666666666664,23,23,GATACTTCGCCTCGCCGTTA,0,1324177
furpa,0.041666666666666664,23,23,CTTTAGCCATGGAGAGGGAT,0,1301851
furpa,0.041666666666666664,23,23,CTTGAATAGACGAAAAATTA,0,1318626
furpa,0.041666666666666664,23,23,CTTATTGGTAATCTACCATG,0,1272264
furpa,0.041666666666666664,23,23,CTCGCTATTTCGCAAAGAAG,0,1302923
furpa,0.041666666666666664,23,23,CTAGTATGGGTTTCTTGAGA,0,1283014
furpa,0.041666666666666664,23,23,CGTACAAACCATCAAAGTAG,0,1291560
furpa,0.041666666666666664,23,23,CGGGGACCGCCCTAGGTGAC,0,1339543
furpa,0.041666666666666664,23,23,CGCAAGAAACTGCTTCACTT,0,1302235
furpa,0.041666666666666664,23,23,CGACCGTTAATACATGCTTA,0,1316683
furpa,0.041666666666666664,23,23,CGAACGACCGTAGTGCTTGT,0,1325357
furpa,0.041666666666666664,23,23,CCTCTCGCTCCTATTAGTAA,0,1355563
furpa,0.041666666666666664,23,23,CCTCCGGACCTTGCGACGTC,0,1337942
furpa,0.041666666666666664,23,23,CCGTTACAGATATTTACTTT,0,1301935
furpa,0.041666666666666664,23,23,CCGTGCCCAGTCTCATCGAC,0,1302587
furpa,0.041666666666666664,23,23,CCGGTCCTTAGTCCACAGAG,0,1296453
furpa,0.041666666666666664,23,23,CCGCCGAGAGGACTTCAGAA,0,1348752
furpa,0.041666666666666664,23,23,CCCTTTCGTTGTTGCACGAA,0,1348269
furpa,0.041666666666666664,23,23,CCCATGATACACTGTCACTA,0,1289297
furpa,0.041666666666666664,23,23,CCAGCGATTGGGGCGACGGT,0,1317815
furpa,0.041666666666666664,23,23,CCAAAGGCGATATAAGTCCC,0,1292157
furpa,0.041666666666666664,23,23,CATCGAAGACCATTATGGAG,0,1343043
furpa,0.041666666666666664,23,23,CAGTAAACCCGTGGTGACTC,0,1307039
furpa,0.041666666666666664,23,23,CAATACAGAGCTTTGCGCGC,0,1316350
furpa,0.041666666666666664,23,23,CAAGTCTAGGCGGTATATCA,0,1306975
furpa,0.041666666666666664,23,23,CAACTGTGTTAGCGTCAGAA,0,1285020
furpa,0.041666666666666664,23,23,ATTTGCCGTGTCAGCTAAAC,0,1307286
furpa,0.041666666666666664,23,23,ATTAGGAATTCATAGGTAGA,0,1337351
furpa,0.041666666666666664,23,23,ATTAAAGCAAGGCACAGCAG,0,1341195
furpa,0.041666666666666664,23,23,ATGAGTTTGAGGCCGATATA,0,1323587
furpa,0.041666666666666664,23,23,ATCCCCCACTTGGGAGCCTC,0,1352271
furpa,0.041666666666666664,23,23,ATCCATTCCGTGTGTGGCAG,0,1344457
furpa,0.041666666666666664,23,23,AGGTCACATCCGCGGTTTGC,0,1305973
furpa,0.041666666666666664,23,23,AGGCAGCCCTTTGTCGGTAG,0,1279942
furpa,0.041666666666666664,23,23,AGCTTGCGGTCACCGGCCAC,0,1353609
furpa,0.041666666666666664,23,23,AGCCACGAACGAGTACCAAG,0,1324391
furpa,0.041666666666666664,23,23,ACTGCACTGTTCGAGGATAC,0,1349164
furpa,0.041666666666666664,23,23,ACGCTACGGCTAAGCTGCTT,0,1275781
furpa,0.041666666666666664,23,23,ACCGCTCTCAGAACGGCTAG,0,1343813
furpa,0.041666666666666664,23,23,ACCAAGCTTCAGAGGCTGAC,0,1339004
furpa,0.041666666666666664,23,23,ACAGGCAATCAGTCCCCAGA,0,1289209
furpa,0.041666666666666664,23,23,ACAAACGTCCCGTTGGGAAG,0,1293631
furpa,0.041666666666666664,23,23,AAGCTTGTGTGTTTTGAAAA,0,1274702
furpa,0.041666666666666664,23,23,AACCTGTTTTATCTTTCAAG,0,1272735
furpa,0.041666666666666664,23,23,AAATGGCGAAGGCTCTCCTA,0,1321799
furpa,0.041666666666666664,23,23,AAACTCTTGTGCTGAGATAG,0,1329166
furpa,0.041666666666666664,23,23,AAAAATGCCGCTTAGCTCGA,0,1327502
furpa,0.043478260869565216,22,22,TTGCTGCAGAAGGATGGTAG,0,1331207
furpa,0.043478260869565216,22,22,TTGCGTTCAGGGACAGCATT,0,1316695
furpa,0.043478260869565216,22,22,TTCAAAGACCGGAACGTTCG,0,1334152
furpa,0.043478260869565216,22,22,TGTTACCCGATGGCCCTAGC,0,1356830
furpa,0.043478260869565216,22,22,TGGGATCTTTTGATTATTCA,0,1320752
furpa,0.043478260869565216,22,22,TGCTGTGCACGTATACCGGT,0,1310349
furpa,0.043478260869565216,22,22,TCTTGCAGCTGTCCACGTAA,0,1318155
furpa,0.043478260869565216,22,22,TCTTACTTTGACTAATCTTC,0,1337075
furpa,0.043478260869565216,22,22,TCTGGGTTTATCCCTTAAAC,0,1326798
furpa,0.043478260869565216,22,22,TCGTATTCGAATCGTTGACA,0,1280879
furpa,0.043478260869565216,22,22,TCCCGGATACCACAGTACCT,0,1282949
furpa,0.043478260869565216,22,22,TATGAGTTCCCCGGCTAGCT,0,1290889
furpa,0.043478260869565216,22,22,TAGGCTTGGAATGTTTCTGG,0,1344542
furpa,0.043478260869565216,22,22,TAGCAATAACTGTCAAGGGG,0,1283462
furpa,0.043478260869565216,22,22,TACTCGGGGCTCCACGCTAA,0,1353524
furpa,0.043478260869565216,22,22,TACCATACTTTGAGCAGTCT,0,1309594
furpa,0.043478260869565216,22,22,TAAATTGGAGCGCGTTAGTT,0,1329301
furpa,0.043478260869565216,22,22,GTTGATAATATTAGGGGCAG,0,1311094
furpa,0.043478260869565216,22,22,GTTATGTGGTGGACACCAGT,0,1349584
furpa,0.043478260869565216,22,22,GTGGCGGCAACGAGAAGACC,0,1350678
furpa,0.043478260869565216,22,22,GTGGATCAAGCTATTTAATA,0,1281719
furpa,0.043478260869565216,22,22,GTCACTCCTTGCTCCGAAAG,0,1305844
furpa,0.043478260869565216,22,22,GGTTCGCGGGATCACTTGAA,0,1292399
furpa,0.043478260869565216,22,22,GGTCGTATGTGCACGCGTAC,0,1342123
furpa,0.043478260869565216,22,22,GGTCATCGACCCAACCCTTT,0,1324578
furpa,0.043478260869565216,22,22,GGGGCATCCTTAATGAAGTC,0,1273711
furpa,0.043478260869565216,22,22,GGGAAGGTGAACCACTATTA,0,1298908
furpa,0.043478260869565216,22,22,GGCACGATGGTAAATATCCT,0,1340111
furpa,0.043478260869565216,22,22,GGATGCTCTTAAGTAGAAGA,0,1350860
furpa,0.043478260869565216,22,22,GGATCGCAGCCTAAGCGTAT,0,1334417
furpa,0.043478260869565216,22,22,GGACTGCGCGGGGTTTTTCC,0,1288426
furpa,0.043478260869565216,22,22,GCTTTTAGCTAGATGTAGAC,0,1332912
furpa,0.043478260869565216,22,22,GCTTGGTTATGCGAACAGGA,0,1303245
furpa,0.043478260869565216,22,22,GCTAAGGGTGCTGTGTGAGA,0,1337440
furpa,0.043478260869565216,22,22,GCGGTTACCATGGCTCGAGA,0,1341324
furpa,0.043478260869565216,22,22,GCGATACTGCTCTGGATTAT,0,1284262
furpa,0.043478260869565216,22,22,GCCGCGGCGCCCTGCAGCTC,0,1301697
furpa,0.043478260869565216,22,22,GCATGGCGCCGGGCTTCGTT,0,1279225
furpa,0.043478260869565216,22,22,GCACCCAGTGGCCTAAATTA,0,1316398
furpa,0.043478260869565216,22,22,GCACCATCCATCCTGGTGGG,0,1322561
furpa,0.043478260869565216,22,22,GATTTGACGTTTTCAGATGG,0,1320272
furpa,0.043478260869565216,22,22,GATGAGAAGATAGGACGCTT,0,1301682
furpa,0.043478260869565216,22,22,GATCGGAATAGAGGTTGCCT,0,1296244
furpa,0.043478260869565216,22,22,GATAGAATGGAATAGTTCCC,0,1294516
furpa,0.043478260869565216,22,22,GAGGTGTCGCATGGCGACGG,0,1304250
furpa,0.043478260869565216,22,22,GAGGCTCTAGGGTCGCATAC,0,1276363
furpa,0.043478260869565216,22,22,GACGACGCTAACTTGCTCGA,0,1340129
furpa,0.043478260869565216,22,22,GAACGCACGTACACGATCAT,0,1284475
furpa,0.043478260869565216,22,22,CTCCTCCCCGGGTTTGGCAG,0,1338706
furpa,0.043478260869565216,22,22,CTAGAAACGCACTCTGTACC,0,1285320
furpa,0.043478260869565216,22,22,CGTCTATTATTGGGCAAATT,0,1272321
furpa,0.043478260869565216,22,22,CGTATCGAGCGAGTGACGAT,0,1350330
furpa,0.043478260869565216,22,22,CGTACTTTCGGATTCCGAAC,0,1284708
furpa,0.043478260869565216,22,22,CGGTAATCGATGAGGCGTCT,0,1287004
furpa,0.043478260869565216,22,22,CGGGATGTATTTACTGAATT,0,1352834
furpa,0.043478260869565216,22,22,CGCTTTTTTTCTGTTTCGGA,0,1286919
furpa,0.043478260869565216,22,22,CGCTCATGGCTTCTAAGGAA,0,1331521
furpa,0.043478260869565216,22,22,CGCGGGAGCCCGGACGGTAG,0,1311857
furpa,0.043478260869565216,22,22,CGCCGTGCCTTAGTCAGCCC,0,1347866
furpa,0.043478260869565216,22,22,CGATTCATCGCTATCCCTCG,0,1301704
furpa,0.043478260869565216,22,22,CCTGCTTAAGACGGTGAGAA,0,1320389
furpa,0.043478260869565216,22,22,CCGTTCGAGAGGTTGCGTGT,0,1353012
furpa,0.043478260869565216,22,22,CCGTTCATTCAAGTGGGCAT,0,1307769
furpa,0.043478260869565216,22,22,CCGCGCTCAGGGAAGGCAAC,0,1356021
furpa,0.043478260869565216,22,22,CCGACAGCGGCGTCTGATTT,0,1306314
furpa,0.043478260869565216,22,22,CCGAACCCGGTTACGAGAAG,0,1344280
furpa,0.043478260869565216,22,22,CCATTTAGCCAAACCAGTTA,0,1335616
furpa,0.043478260869565216,22,22,CCAAAAACCACCGCAGTACG,0,1319736
furpa,0.043478260869565216,22,22,CATACTAGCAGTTGGTACGA,0,1316633
furpa,0.043478260869565216,22,22,CAGTCCGGATGTGCGACAAT,0,1301616
furpa,0.043478260869565216,22,22,CACCCGCCTAAAACGAGACA,0,1305218
furpa,0.043478260869565216,22,22,CACCCCGCATATCGACCATG,0,1317301
furpa,0.043478260869565216,22,22,CACCAGAGTGTCTGTGACGT,0,1354572
furpa,0.043478260869565216,22,22,ATTGCGCAACCCTGTCTGCG,0,1352464
furpa,0.043478260869565216,22,22,ATTCGGATGGGCATCGTTGT,0,1276752
furpa,0.043478260869565216,22,22,ATGCAACTCCGTTAGCTAGT,0,1288699
furpa,0.043478260869565216,22,22,ATGACTGGCAGTGCGGCCTC,0,1317289
furpa,0.043478260869565216,22,22,ATCTTGGACGGCGTCACGCG,0,1285494
furpa,0.043478260869565216,22,22,ATCAGGCGGGGGTAGTTAAC,0,1277461
furpa,0.043478260869565216,22,22,ATATTGCCGCAACAGTCGAT,0,1305087
furpa,0.043478260869565216,22,22,ATATGGCGAGTTGCGGATTT,0,1309487
furpa,0.043478260869565216,22,22,ATACCTTAAGAAGTAACTGA,0,1302518
furpa,0.043478260869565216,22,22,AGTTCAGTTGTACCGTCGCG,0,1349916
furpa,0.043478260869565216,22,22,AGGGCTGCTGCGTAGACGCA,0,1311368
furpa,0.043478260869565216,22,22,AGCTGTCTGACTCTATTCGA,0,1318235
furpa,0.043478260869565216,22,22,AGCGCCCAATATAGCGTAGT,0,1342774
furpa,0.043478260869565216,22,22,AGATTCGACGTGCAAACTCC,0,1348179
furpa,0.043478260869565216,22,22,ACGGACCTACCGAGTCGGAC,0,1357205
furpa,0.043478260869565216,22,22,ACGAACCACTGCAATAGTTT,0,1348428
furpa,0.043478260869565216,22,22,ACCATTTTGAAAACGGCTTG,0,1293493
furpa,0.043478260869565216,22,22,ACCAGGTAAAAGTCATTCGC,0,1282039
furpa,0.043478260869565216,22,22,ACAATTGATGGTTTGCCCCT,0,1337415
furpa,0.043478260869565216,22,22,AAGTAAGGTGGGGTTCAATA,0,1283793
furpa,0.045454545454545456,21,21,TTTTCAAAGCCCGGAGGCAG,0,1344201
furpa,0.045454545454545456,21,21,TTTGATCAACTATTAAACTA,0,1282299
furpa,0.045454545454545456,21,21,TTTCCCCTTTATCAGATTCA,0,1290644
furpa,0.045454545454545456,21,21,TTTACCGACGAGACTATGGC,0,1351760
furpa,0.045454545454545456,21,21,TTCTACCACCCGAGGCGGTC,0,1357111
furpa,0.045454545454545456,21,21,TTCCACGTACTTGCCAAACT,0,1273603
furpa,0.045454545454545456,21,21,TTCATGGGCAAAGCGACACA,0,1305401
furpa,0.045454545454545456,21,21,TTACGGCACAAAAAATTTTC,0,1283442
furpa,0.045454545454545456,21,21,TGTTCTAGGCGTTTGATAGA,0,1350347
furpa,0.045454545454545456,21,21,TGTCGCGTCGCTCACTTATA,0,1309419
furpa,0.045454545454545456,21,21,TGGGAATCTCAGTTGGGGGT,0,1308490
furpa,0.045454545454545456,21,21,TGATTGTGTTTCTGTCTTCA,0,1328866
furpa,0.045454545454545456,21,21,TGAATAGCAAAGCAGAAATT,0,1294000
furpa,0.045454545454545456,21,21,TCTTAAGGCATACGCCAGCG,0,1322727
furpa,0.045454545454545456,21,21,TCTAAGGCCAGGAGGTCGTA,0,1319688
furpa,0.045454545454545456,21,21,TCTAACATTGTTTCCACAAC,0,1292999
furpa,0.045454545454545456,21,21,TCCGTCGTATGTATGCAGCT,0,1300288
furpa,0.045454545454545456,21,21,TCCGCGAGAAAAACATCGAC,0,1302968
furpa,0.045454545454545456,21,21,TCCGCGACCGTAGCCATGTT,0,1296840
furpa,0.045454545454545456,21,21,TCATGTTTACGGATCGTTGT,0,1325349
furpa,0.045454545454545456,21,21,TCATAAGGCTGTACTTAGCG,0,1326531
furpa,0.045454545454545456,21,21,TCACAAATAGCACCTTTGCC,0,1344167
furpa,0.045454545454545456,21,21,TCAATTTCACACACTATGGA,0,1338880
furpa,0.045454545454545456,21,21,TATGTAGACAAAGAGGACAG,0,1355444
furpa,0.045454545454545456,21,21,TATCCGTTCTATCTTCGTCA,0,1353254
furpa,0.045454545454545456,21,21,TATAGTCAACTCTACTGTGT,0,1313888
furpa,0.045454545454545456,21,21,TAGCCCACATTTGAACTAAT,0,1344846
furpa,0.045454545454545456,21,21,TAAACACACTAACGGCTTTT,0,1346362
furpa,0.045454545454545456,21,21,GTTTTCAGTTCCTCCTAAAC,0,1332360
furpa,0.045454545454545456,21,21,GTTGGGGTGGCCCGTGCAGA,0,1339934
furpa,0.045454545454545456,21,21,GTTCAGAGACGCTGAACGGA,0,1285741
furpa,0.045454545454545456,21,21,GTTAGATCAGGTCAAAGGCC,0,1284563
furpa,0.045454545454545456,21,21,GTGCAAGATACCTAATGAGT,0,1333403
furpa,0.045454545454545456,21,21,GTCTAGGTTAGGAAGGGTAA,0,1294611
furpa,0.045454545454545456,21,21,GTCGGAGGGGTCAGAAAGTC,0,1298626
furpa,0.045454545454545456,21,21,GTCACGTGGGAATCTTTTTC,0,1292296
furpa,0.045454545454545456,21,21,GTATGCGGATTTGGCCTTGC,0,1288356
furpa,0.045454545454545456,21,21,GTAGCAACGCTTGTCCCTAA,0,1286994
furpa,0.045454545454545456,21,21,GTACTTCGAGCTAGCTAGTT,0,1285031
furpa,0.045454545454545456,21,21,GTACGCGGACCTATGAAATT,0,1336356
furpa,0.045454545454545456,21,21,GTAAGTGAGCCAGAGCAAGC,0,1349296
furpa,0.045454545454545456,21,21,GGTGCCTTCCCACTGACCGA,0,1346947
furpa,0.045454545454545456,21,21,GGGAGTAGTATTCAGCTAAC,0,1321604
furpa,0.045454545454545456,21,21,GGCTGTCCCATTAGCCTATC,0,1332546
furpa,0.045454545454545456,21,21,GGAATGCCAGTCAATCGGCA,0,1278629
furpa,0.045454545454545456,21,21,GGAAAAAGCACCAGGACCTA,0,1321049
furpa,0.045454545454545456,21,21,GCTCGCGTACGTCTGAACCT,0,1346958
furpa,0.045454545454545456,21,21,GCGGTAGCGTGGATCGGCAT,0,1308834
furpa,0.045454545454545456,21,21,GCGCCTCGTTAACGCGGCCC,0,1336460
furpa,0.045454545454545456,21,21,GCATTTTAACGTTAACCGTT,0,1322505
furpa,0.045454545454545456,21,21,GCAGCGTGTTGTAGGCATGT,0,1339483
furpa,0.045454545454545456,21,21,GATCTCTATATGCATAGTTG,0,1326190
furpa,0.045454545454545456,21,21,GATCGCGGTATTGAACGATT,0,1299187
furpa,0.045454545454545456,21,21,GACGATAGGTACCAACGATA,0,1349541
furpa,0.045454545454545456,21,21,GAATGGACACATTCATCAAC,0,1348067
furpa,0.045454545454545456,21,21,GAAGCTCGTGTGAGTCTTAA,0,1314456
furpa,0.045454545454545456,21,21,GAACGCCCGACTCAAGGTAA,0,1342074
furpa,0.045454545454545456,21,21,GAACCTAAGTAATGCTACCT,0,1298968
furpa,0.045454545454545456,21,21,CTTCGCTAAATTACCATTTG,0,1281643
furpa,0.045454545454545456,21,21,CTTCAGAATCCTTATGATAA,0,1281641
furpa,0.045454545454545456,21,21,CTGTTAAATGGTGGACTGCT,0,1317240
furpa,0.045454545454545456,21,21,CTGGTACTGGGAGACAGGAA,0,1311280
furpa,0.045454545454545456,21,21,CTGCACTCCACGATTGGGTT,0,1301832
furpa,0.045454545454545456,21,21,CTCGGTCACGGTCCAGTGCT,0,1320639
furpa,0.045454545454545456,21,21,CTATTTTAGTTGACTCGTAC,0,1289221
furpa,0.045454545454545456,21,21,CTATCCTCGCCACATGGGTA,0,1299560
furpa,0.045454545454545456,21,21,CTACCTAGCTCTGTCACTGC,0,1320921
furpa,0.045454545454545456,21,21,CGTGTGTTTAGTTGTAACGT,0,1339428
furpa,0.045454545454545456,21,21,CGTGATCCCACTTCTCAATC,0,1306095
furpa,0.045454545454545456,21,21,CGTGATATTGGAATAGATCT,0,1304729
furpa,0.045454545454545456,21,21,CGTCGCTGTTACCGGGTCGG,0,1327113
furpa,0.045454545454545456,21,21,CGCTTAACCGCGGCTGTAAT,0,1328097
furpa,0.045454545454545456,21,21,CGCGCGTTCCAAATCGCTAT,0,1301169
furpa,0.045454545454545456,21,21,CGCCTCGGCCACATCACCCG,0,1312278
furpa,0.045454545454545456,21,21,CGACTCCTCGGGAATGAAAG,0,1314021
furpa,0.045454545454545456,21,21,CCTTCTAGGGTATCCGGGTG,0,1286697
furpa,0.045454545454545456,21,21,CCTTACATCAGTCGTTTCAC,0,1320060
furpa,0.045454545454545456,21,21,CCTGCGGTGTTTGGATGTAC,0,1333594
furpa,0.045454545454545456,21,21,CCTCCTTAGCGTGGGCACAT,0,1282531
furpa,0.045454545454545456,21,21,CCACGGGTGCGGAGTTGGGC,0,1296129
furpa,0.045454545454545456,21,21,CATTCTCATCGCATCCACTA,0,1347920
furpa,0.045454545454545456,21,21,CATTAGGGAGTATCGCGATT,0,1335510
furpa,0.045454545454545456,21,21,CATCTGGGGCTAGGTTTGAA,0,1317549
furpa,0.045454545454545456,21,21,CAGCCAGTTCATCGGCAGAG,0,1317563
furpa,0.045454545454545456,21,21,CACTGTATAGAGTGGAATGA,0,1283379
furpa,0.045454545454545456,21,21,CACTGGGCTGGACAACTAGA,0,1354017
furpa,0.045454545454545456,21,21,CACCGCGAACTTATTACCTC,0,1272331
furpa,0.045454545454545456,21,21,CAATACAAGGGTAGCGTATA,0,1354060
furpa,0.045454545454545456,21,21,CAACGCCTTGGATGCGTTAG,0,1276120
furpa,0.045454545454545456,21,21,ATTTCTTTTGCCTCGGCCCA,0,1353074
furpa,0.045454545454545456,21,21,ATGGCGGGCAAACAAAGACA,0,1313030
furpa,0.045454545454545456,21,21,ATCTGGAATTCGCGGTAAAA,0,1342436
furpa,0.045454545454545456,21,21,ATCGCTATGGGCGCCGATAT,0,1356828
furpa,0.045454545454545456,21,21,ATCATCCCCATAAGGGGTCG,0,1315649
furpa,0.045454545454545456,21,21,ATAGTTGGATTCCGCGTCTG,0,1287545
furpa,0.045454545454545456,21,21,ATAGGTACGCAGTGAATGGT,0,1303510
furpa,0.045454545454545456,21,21,ATAGCTGTATTAATAAATCT,0,1287277
furpa,0.045454545454545456,21,21,ATACACACACATGTTGCTGA,0,1307036
furpa,0.045454545454545456,21,21,ATAACGGCATGTGAACCACA,0,1331260
furpa,0.045454545454545456,21,21,AGTGGGGTGGCGCTCACGAT,0,1348429
furpa,0.045454545454545456,21,21,AGGTGGCGGGTCTTCGGAAC,0,1320576
furpa,0.045454545454545456,21,21,AGGGTAACACTAATAGGTCT,0,1334396
furpa,0.045454545454545456,21,21,AGGGCGGTGTTGAGAGACTT,0,1331843
furpa,0.045454545454545456,21,21,AGGCTGTTCGTGGTGATTAT,0,1312760
furpa,0.045454545454545456,21,21,AGGAACTTGACAAATTACAA,0,1300008
furpa,0.045454545454545456,21,21,AGCTGCTTTAGCGTCGGGCA,0,1347838
furpa,0.045454545454545456,21,21,AGATGCTACGCTTGTACGGT,0,1331327
furpa,0.045454545454545456,21,21,AGAATCGGGTCCAGATGCAG,0,1308069
furpa,0.045454545454545456,21,21,ACGGTTCGAGTAGATGTGAT,0,1305052
furpa,0.045454545454545456,21,21,ACGCGTACCCCAATACTTCT,0,1283438
furpa,0.045454545454545456,21,21,ACGAAGGGGACTCAGCTAGG,0,1328833
furpa,0.045454545454545456,21,21,ACCAATATTCTTATGCTCAC,0,1335976
furpa,0.045454545454545456,21,21,ACAAGCCCAGTAGATAGCAT,0,1341476
furpa,0.045454545454545456,21,21,AATTATAAGGATGTCCGCCG,0,1290520
furpa,0.045454545454545456,21,21,AAGGGGTTGGGTGGATGAGA,0,1355440
furpa,0.045454545454545456,21,21,AAGCGATAGCAGCGCTCCCA,0,1282950
furpa,0.045454545454545456,21,21,AAGAGTGCTGGCTGCGACGA,0,1331592
furpa,0.045454545454545456,21,21,AACTATAACTGGTGTTATTT,0,1336560
furpa,0.045454545454545456,21,21,AACAAATCGATGAAGCCGTC,0,1303235
furpa,0.047619047619047616,20,20,TTTGACAGAGGGTCTCTAGA,0,1296604
furpa,0.047619047619047616,20,20,TTGTTATCACTTGCCTCCGA,0,1355382
furpa,0.047619047619047616,20,20,TTGGGCCAACCGAGCTCGCC,0,1293139
furpa,0.047619047619047616,20,20,TTGCGTGGTTAATAGGAATG,0,1297646
furpa,0.047619047619047616,20,20,TTCTCCGAAGCCAAAGCCAA,0,1332523
furpa,0.047619047619047616,20,20,TTCGACGCAGGACTCTCGGA,0,1345612
furpa,0.047619047619047616,20,20,TTCCGCCGGCGACGGTGGTT,0,1303378
furpa,0.047619047619047616,20,20,TTATTGATAGTCACGCTGGT,0,1321170
furpa,0.047619047619047616,20,20,TTAGATGAGGTGGTATCCGA,0,1301206
furpa,0.047619047619047616,20,20,TGTTATGGAGGTTACTTCCT,0,1279194
furpa,0.047619047619047616,20,20,TGTGTAATGGCTTGCGGAGC,0,1308588
furpa,0.047619047619047616,20,20,TGTGCCCGAATCCATTGTTG,0,1328176
furpa,0.047619047619047616,20,20,TGTCTATATATTCGGTCATT,0,1303194
furpa,0.047619047619047616,20,20,TGTCGTCTACTCGTGATTTT,0,1344495
furpa,0.047619047619047616,20,20,TGGTATGCCGATGCACATGC,0,1277991
furpa,0.047619047619047616,20,20,TGGGAGTAGAGTTCCATATC,0,1279526
furpa,0.047619047619047616,20,20,TGGCAGACCCCCCTAGCCAG,0,1345900
furpa,0.047619047619047616,20,20,TGGAGATTCCAAAGGTCCTC,0,1353313
furpa,0.047619047619047616,20,20,TGCGCTAACAGCGTCCATGT,0,1277329
furpa,0.047619047619047616,20,20,TGCCATGTACGAATTTGAGA,0,1350983
furpa,0.047619047619047616,20,20,TGCATTCCTTAGTACTCAGT,0,1335396
furpa,0.047619047619047616,20,20,TCTTCATGCTTAGATTAAAA,0,1329262
furpa,0.047619047619047616,20,20,TCTGTTACGACCACACCTGG,0,1282813
furpa,0.047619047619047616,20,20,TCTCGGGAGCCAAGGTAAAT,0,1306065
furpa,0.047619047619047616,20,20,TCGTCAACACACCGCGAGGT,0,1277742
furpa,0.047619047619047616,20,20,TCGGGCCTATGAGTACTTAG,0,1279362
furpa,0.047619047619047616,20,20,TCCACGAGACCGGGGAGAGA,0,1287994
furpa,0.047619047619047616,20,20,TCAGGCAGCGAGCATACATC,0,1282094
furpa,0.047619047619047616,20,20,TCACAGACTGCCGCGTCCGT,0,1300986
furpa,0.047619047619047616,20,20,TATAGTGGTCCGGTAAAACC,0,1309520
furpa,0.047619047619047616,20,20,TATAGCAGTCGGCAGTCGTG,0,1311503
furpa,0.047619047619047616,20,20,TAGGTGCGTTCTCAACGATA,0,1315329
furpa,0.047619047619047616,20,20,TAGGGACTTGATTACAGCTT,0,1342875
furpa,0.047619047619047616,20,20,TAGCTAAAGGTTTACATATA,0,1351882
furpa,0.047619047619047616,20,20,TAAAGCCTCAGGGGCATAGA,0,1330657
furpa,0.047619047619047616,20,20,GTTGTAATAGCGGGAAATTA,0,1281249
furpa,0.047619047619047616,20,20,GTGGTTATCTTTGTCCGCGG,0,1345940
furpa,0.047619047619047616,20,20,GTGAGGTTAGAATATTTGTT,0,1289720
furpa,0.047619047619047616,20,20,GTCGACTCAAGTGACATGCG,0,1318084
furpa,0.047619047619047616,20,20,GTAACGAGCGCGTTCTACTG,0,1342707
furpa,0.047619047619047616,20,20,GGTGAATATTTCGTCCCATG,0,1354566
furpa,0.047619047619047616,20,20,GGGGGTACCATCTACAGTGT,0,1316680
furpa,0.047619047619047616,20,20,GGGCCTAAGGGTGCAAGCGT,0,1312821
furpa,0.047619047619047616,20,20,GGCTGTTTCTTCAAGTTTAA,0,1286415
furpa,0.047619047619047616,20,20,GGCGACCATCTTGGTGATTA,0,1345079
furpa,0.047619047619047616,20,20,GGCAGCATATCGTCGGGAAG,0,1287640
furpa,0.047619047619047616,20,20,GGATTGCTGCGTGATACCCG,0,1304913
furpa,0.047619047619047616,20,20,GCTTTGGCCGTATTTGCCGG,0,1307198
furpa,0.047619047619047616,20,20,GCTTTAGGTAGCCGAGGCGA,0,1299201
furpa,0.047619047619047616,20,20,GCTTCTTGTTCGTTAAGATG,0,1352258
furpa,0.047619047619047616,20,20,GCTGCCAGGGTGGGGACCTG,0,1275180
furpa,0.047619047619047616,20,20,GCGGTCAATGATCCCTAGTC,0,1296284
furpa,0.047619047619047616,20,20,GCCATATTAAATCGCCTCTT,0,1292281
furpa,0.047619047619047616,20,20,GCAACTCGATACACCTCGGG,0,1350413
furpa,0.047619047619047616,20,20,GCAACAGAATCGGTTAAGTA,0,1288285
furpa,0.047619047619047616,20,20,GATGAATTCCACACCTGGTC,0,1337591
furpa,0.047619047619047616,20,20,GACTGCAGTACGACTGGATT,0,1335957
furpa,0.047619047619047616,20,20,GACGTCAGGTCTAATGTTGT,0,1299180
furpa,0.047619047619047616,20,20,GAATGTTAGAACGCTTCGAG,0,1301031
furpa,0.047619047619047616,20,20,GAAGCTCTCTCGTAACTCCA,0,1340330
furpa,0.047619047619047616,20,20,GAAAGCTACCAGATCCAGTG,0,1271998
furpa,0.047619047619047616,20,20,CTTTATATAGGTTCAATTGC,0,1295058
furpa,0.047619047619047616,20,20,CTGTTGCCAAGTCGAGTTCA,0,1285901
furpa,0.047619047619047616,20,20,CTGTAGATGCGGGCAGCTAG,0,1292166
furpa,0.047619047619047616,20,20,CTGGGGGACGTCCGACCTTG,0,1280088
furpa,0.047619047619047616,20,20,CTGGAGGGCTATCGGTGTAG,0,1300212
furpa,0.047619047619047616,20,20,CTGCTGGTTCAAGCAATAGC,0,1291522
furpa,0.047619047619047616,20,20,CTCAACGCACCCGAGCGGCA,0,1346942
furpa,0.047619047619047616,20,20,CTACGAGCTCCAGCCGGCAG,0,1314009
furpa,0.047619047619047616,20,20,CGTTGACTCGCGCTCTATTG,0,1288364
furpa,0.047619047619047616,20,20,CGTTCTTACATGCTGCATTG,0,1275979
furpa,0.047619047619047616,20,20,CGTGACGGGCGAGCGATTCT,0,1284875
furpa,0.047619047619047616,20,20,CGGGCACTGCCTCCTGGAGC,0,1350733
furpa,0.047619047619047616,20,20,CGCGAAACGGTAGTCCCGTG,0,1325711
furpa,0.047619047619047616,20,20,CGCCCGATCTAAATTTCGGC,0,1327131
furpa,0.047619047619047616,20,20,CGCATGTCTGTTCTGGACTG,0,1293120
furpa,0.047619047619047616,20,20,CGAGGCCCTCGTGCTGACAT,0,1317696
furpa,0.047619047619047616,20,20,CGAGAGGAAGCTGGGCTCGG,0,1291409
furpa,0.047619047619047616,20,20,CGACGTTAGCGTCGTAGAAT,0,1329994
furpa,0.047619047619047616,20,20,CGACCATTCGTCACGCTTTG,0,1311934
furpa,0.047619047619047616,20,20,CCTTACTTTTTCTTTCGCTT,0,1280085
furpa,0.047619047619047616,20,20,CCTGTGTTAGTAGTACATCT,0,1282236
furpa,0.047619047619047616,20,20,CCTCGGAGTCGTCCCGTGCG,0,1349475
furpa,0.047619047619047616,20,20,CCTATCCGTTAGTGCGCCGG,0,1350893
furpa,0.047619047619047616,20,20,CCTACCAAGGGTAAGCTGCA,0,1343874
furpa,0.047619047619047616,20,20,CCTAACGCGTTAGCGCGATA,0,1310588
furpa,0.047619047619047616,20,20,CCGCGGCATGCGGAACGCAA,0,1341628
furpa,0.047619047619047616,20,20,CCCAGCAATTGCCGGTACAC,0,1293767
furpa,0.047619047619047616,20,20,CCCAACCCCATCCCTACGAC,0,1316333
furpa,0.047619047619047616,20,20,CCATGGCATGTCACGTGCGT,0,1272656
furpa,0.047619047619047616,20,20,CCATCTGAATGATTTTGCAT,0,1300912
furpa,0.047619047619047616,20,20,CCACATTTCTTATGCAATTA,0,1292905
furpa,0.047619047619047616,20,20,CATTTCGATGATCATAGGGT,0,1311039
furpa,0.047619047619047616,20,20,CATGGTGATACGAAAGTTTG,0,1343869
furpa,0.047619047619047616,20,20,CATCTAACGAGTGGATCGCA,0,1305931
furpa,0.047619047619047616,20,20,CATAGGGATTAATAAAGGGC,0,1280648
furpa,0.047619047619047616,20,20,CAGGGCGGCATGTAATAGCA,0,1275071
furpa,0.047619047619047616,20,20,CAGCTCGTGCTAAAGTGAGT,0,1353996
furpa,0.047619047619047616,20,20,CACTGGAAAAGTAGTGTGCT,0,1287995
furpa,0.047619047619047616,20,20,CACTAAGGCCTCCTTGCATC,0,1288961
furpa,0.047619047619047616,20,20,CACCACTTTCATCTCTCGCT,0,1332937
furpa,0.047619047619047616,20,20,CAATAGCGTCACGGAGGGGT,0,1308478
furpa,0.047619047619047616,20,20,ATTTGAAAGTTGGCCCCTCT,0,1310337
furpa,0.047619047619047616,20,20,ATTACTAAAAGAGGACGTTG,0,1290669
furpa,0.047619047619047616,20,20,ATGGTCGCTGTTGACCGTGC,0,1317222
furpa,0.047619047619047616,20,20,ATGCCGGTATAGTCCGGTGT,0,1357526
furpa,0.047619047619047616,20,20,ATCTTGCAACGGACAGGCCC,0,1319778
furpa,0.047619047619047616,20,20,ATCAGAGCGGCCGGAGCCAT,0,1352957
furpa,0.047619047619047616,20,20,AGTGATACCGTTGGTATGAT,0,1355279
furpa,0.047619047619047616,20,20,AGTCCCGTATAAGTAACCGG,0,1300929
furpa,0.047619047619047616,20,20,AGGGCGACGCGGCAGTGTCC,0,1298816
furpa,0.047619047619047616,20,20,AGGGAGACACTACGGACTAC,0,1314669
furpa,0.047619047619047616,20,20,AGGCATGTTCAGAAACCGGT,0,1318475
furpa,0.047619047619047616,20,20,AGGCAGGTCCGTGCACGCGG,0,1352591
furpa,0.047619047619047616,20,20,AGGAATCTTAATCTCAATCC,0,1278121
furpa,0.047619047619047616,20,20,AGCCTTCAGACTTCTATTGA,0,1286547
furpa,0.047619047619047616,20,20,AGCCTGCAAGTTATCGATTC,0,1318916
furpa,0.047619047619047616,20,20,AGCAAGCCTAAGCCTCTCGC,0,1283559
furpa,0.047619047619047616,20,20,ACGCGTGCGTAGGGAGCAGT,0,1326400
furpa,0.047619047619047616,20,20,ACCACGAGATAGTGAGACTC,0,1299347
furpa,0.047619047619047616,20,20,ACCAATGGGATCATCCCGGC,0,1337432
furpa,0.047619047619047616,20,20,ACAGCAAGGTCACAGTAAGA,0,1346790
furpa,0.047619047619047616,20,20,ACAATTTTTAAATATTCATA,0,1307781
furpa,0.047619047619047616,20,20,ACAAGATTAATACCCTGCAG,0,1336476
furpa,0.047619047619047616,20,20,AATATTCCAACCTTTTCTTA,0,1287007
furpa,0.047619047619047616,20,20,AAGTAGTGTAACAGTTAGAC,0,1299993
furpa,0.047619047619047616,20,20,AAGGAAGAGTGCCAAGTATC,0,1293545
furpa,0.047619047619047616,20,20,AAGCTCCGGACTCTTCCCCG,0,1329788
furpa,0.047619047619047616,20,20,AAGCATTCTGTCCAATTAGA,0,1326799
furpa,0.047619047619047616,20,20,AAGAGATGTTACCTCAGTTG,0,1277661
furpa,0.047619047619047616,20,20,AAGAACCCCAGTACCCCCAT,0,1295696
furpa,0.047619047619047616,20,20,AACTAGCATTAGAAACCAGT,0,1301950
furpa,0.047619047619047616,20,20,AACCTACATAGGTTGCTCAG,0,1315663
furpa,0.047619047619047616,20,20,AAAGGAACTCCTTGCGCTGC,0,1334777
furpa,0.047619047619047616,20,20,AAAATATCAGGGGACGGTCT,0,1347767
furpa,0.05,19,19,TTGGGCTGGAGAGAGCTCTT,0,1289551
furpa,0.05,19,19,TTGCTTGTCGGGTCCCGACA,0,1315369
furpa,0.05,19,19,TTGACTGGATCGTCCGTGAG,0,1328161
furpa,0.05,19,19,TTCTTACCGGCTCAACAGAG,0,1297762
furpa,0.05,19,19,TTCTCCCAGCTTAACTACTG,0,1346703
furpa,0.05,19,19,TTCTATACAAGTGTAAATAC,0,1303976
furpa,0.05,19,19,TTCCTTTTTACCGTGCACTA,0,1272102
furpa,0.05,19,19,TTCAGGGCACGATGCCCCAC,0,1281961
furpa,0.05,19,19,TTACCACGGCCTTTCACCAA,0,1321172
furpa,0.05,19,19,TGTTATGCAGTGGTTGACTC,0,1272103
furpa,0.05,19,19,TGTGGTTTTATTGGTCGCAG,0,1273177
furpa,0.05,19,19,TGGAGTATCCTGGACTTCGC,0,1278913
furpa,0.05,19,19,TGCTCTTCTGTCTAAGCAAT,0,1318981
furpa,0.05,19,19,TGCACGACATCAACGATCCT,0,1346018
furpa,0.05,19,19,TGAGGAACTTGTGGACTTGG,0,1309709
furpa,0.05,19,19,TGAACCGCCGCGGGGGTGTG,0,1273205
furpa,0.05,19,19,TCTTCATTGGAGGGGCCGTT,0,1347475
furpa,0.05,19,19,TCTGGGCGTTAGCAGCGGCT,0,1315507
furpa,0.05,19,19,TCTGCTGCACCAGGGCGAGC,0,1296797
furpa,0.05,19,19,TCTCTGGCCAAATACTTCAG,0,1337298
furpa,0.05,19,19,TCTCCAACTGCCGCCGCTGT,0,1331916
furpa,0.05,19,19,TCGTGCTAGACCTGTCATGC,0,1292402
furpa,0.05,19,19,TCGGAGTTCGTGGGTTATAC,0,1329952
furpa,0.05,19,19,TCGAGACAACTACGGAGATG,0,1314789
furpa,0.05,19,19,TCCATTAAAGAGTTACCTCG,0,1273677
furpa,0.05,19,19,TCCACATGTTGTAAGTCTTC,0,1289607
furpa,0.05,19,19,TCATAGCCAACCTGAATGTT,0,1292763
furpa,0.05,19,19,TCAGAGGCTACAATGATCCT,0,1343173
furpa,0.05,19,19,TCAACCACCGCAAACGGACT,0,1281015
furpa,0.05,19,19,TATTGTCAAAACGTGGGCAG,0,1309976
furpa,0.05,19,19,TATTCAGTGCCGATCTCTAC,0,1292045
furpa,0.05,19,19,TATGTGGCATCCGGACGAAT,0,1351125
furpa,0.05,19,19,TATCGTCTATCTGGACTGAC,0,1319910
furpa,0.05,19,19,TATACCGGGAATCACTATAT,0,1283961
furpa,0.05,19,19,TAGGATTTTTCCAGCGAACA,0,1306595
furpa,0.05,19,19,TACTTTTGTCAAAGGATAGA,0,1325665
furpa,0.05,19,19,TACTCAGCGGGTATTAGGAT,0,1318599
furpa,0.05,19,19,TACACGTTGTGAGACTCTTG,0,1316192
furpa,0.05,19,19,TAATTCGTTCAATGGCATGA,0,1306894
furpa,0.05,19,19,TAACAGGGCTATTCACTTTA,0,1292626
furpa,0.05,19,19,GTTTTGCCGTTTGCGATAAT,0,1316056
furpa,0.05,19,19,GTGGGGCCTTTGCACCGTGT,0,1313636
furpa,0.05,19,19,GTGGGCCTCGTGCTGCTTCA,0,1322949
furpa,0.05,19,19,GTGCTGGGATGCATTTGCTA,0,1330212
furpa,0.05,19,19,GTGCGTTTCCAATCGGGAGC,0,1271601
furpa,0.05,19,19,GTCTCAGGTTTGTTCACATA,0,1301438
furpa,0.05,19,19,GTCAATGTGTGTAGCAAGAG,0,1315097
furpa,0.05,19,19,GTATATGCAAAATATCAGGT,0,1296013
furpa,0.05,19,19,GTACTTCTCGCAGAGGGCTG,0,1339636
furpa,0.05,19,19,GGTTTCCTCACTTGACAGGG,0,1314035
furpa,0.05,19,19,GGGTCATGGTCCCTCTCGCG,0,1282896
furpa,0.05,19,19,GGGGTACGATAAAACCGATA,0,1341318
furpa,0.05,19,19,GGCTTGGCCCTCCGATCATT,0,1329716
furpa,0.05,19,19,GGCTGGACTCTGGTTTCAAT,0,1301624
furpa,0.05,19,19,GGCTACGCCCGCGAAGACTA,0,1282932
furpa,0.05,19,19,GGCGAGCCCCGAAACACAGT,0,1354075
furpa,0.05,19,19,GGATTATTCTTTTTTACGAA,0,1282900
furpa,0.05,19,19,GGAGTCTAACAACGCCTCTT,0,1328985
furpa,0.05,19,19,GGACATGACGAGCGTCTGTA,0,1294885
furpa,0.05,19,19,GCTTTCAAGCGAAAGCCCCA,0,1276644
furpa,0.05,19,19,GCTTGGTTCTCGGGGGGGAT,0,1354154
furpa,0.05,19,19,GCATGGGAGAGGTCCTAGCA,0,1323820
furpa,0.05,19,19,GATCACGACCCTTTCTAGTT,0,1322512
furpa,0.05,19,19,GATAACAGAATCAACTTCAG,0,1314370
furpa,0.05,19,19,GAGGTGAATCCCAGTTCGGC,0,1304509
furpa,0.05,19,19,GAGCACGCCTCACGTGTGAT,0,1346044
furpa,0.05,19,19,GACTTCAGATTTACTTATTA,0,1311952
furpa,0.05,19,19,GACGGCTTGGGTTTAAGTCC,0,1320239
furpa,0.05,19,19,GACCGGTTCTTTCCTCGTCT,0,1278264
furpa,0.05,19,19,GAATTACCCCGGACAGTCAG,0,1332415
furpa,0.05,19,19,GAAACGGTACCAAGCTCCTA,0,1300121
furpa,0.05,19,19,GAAACGACTTACAGCCCGAA,0,1317247
furpa,0.05,19,19,CTTTTATCAGTCTTGTATTT,0,1335062
furpa,0.05,19,19,CTTGGATTAGGTGTGAACTA,0,1303703
furpa,0.05,19,19,CTTGATAGGTAGTTGGCTCA,0,1282877
furpa,0.05,19,19,CTTATTTGCATATGTGTTGA,0,1347081
furpa,0.05,19,19,CTGTCAGGTCGGTTTGGCTT,0,1333739
furpa,0.05,19,19,CTGTAGACTCTATCGCGGAA,0,1349726
furpa,0.05,19,19,CTGCGTGTCCTGTCTACGCA,0,1331273
furpa,0.05,19,19,CTAGCTCCAGTTACAGATTC,0,1275975
furpa,0.05,19,19,CGTCTCAACCGGCCTGGAAG,0,1280753
furpa,0.05,19,19,CGGTCGTCGGACGGATCGCA,0,1288153
furpa,0.05,19,19,CGGCGCTCGACCCCCTGGGT,0,1329799
furpa,0.05,19,19,CGCTCCTTGTTGCCATTTTG,0,1320940
furpa,0.05,19,19,CGCCCTCATAGCGGGGACTA,0,1290794
furpa,0.05,19,19,CGCAGAATCGCACTGGGTCT,0,1276882
furpa,0.05,19,19,CGCACGGGTAAAGCATGATC,0,1312891
furpa,0.05,19,19,CGAGCCCGAGTGGCAGGTAA,0,1333097
furpa,0.05,19,19,CCTGGGTCGTAAGGACTTCG,0,1291155
furpa,0.05,19,19,CCGTTAACGGGCAAGCGATG,0,1318419
furpa,0.05,19,19,CCGGGTTGGCAGTTGCGACT,0,1293856
furpa,0.05,19,19,CCGGACGACAAAAGCTCTAA,0,1305876
furpa,0.05,19,19,CCGCGATAGAACAAAGGAGA,0,1307816
furpa,0.05,19,19,CCCTCAGGGTCCTGTTACTC,0,1326655
furpa,0.05,19,19,CCCTCACCCAATGGAAGTTT,0,1297501
furpa,0.05,19,19,CCCGAAAAGTTAAGTGTCCA,0,1354355
furpa,0.05,19,19,CCATAAGTAGGGAGAGTCAG,0,1288621
furpa,0.05,19,19,CCAGGGGCGCAGCTTGCTTA,0,1334236
furpa,0.05,19,19,CCACAGAGGTTACCAGCTCT,0,1311549
furpa,0.05,19,19,CATGGGAGAACTATCAGGTT,0,1349320
furpa,0.05,19,19,CATGAAGGTATCCCGGTATC,0,1342782
furpa,0.05,19,19,CATCGCCGTGGCGGACGACT,0,1336572
furpa,0.05,19,19,CATCGAAGGCAAAGCCAGTC,0,1325469
furpa,0.05,19,19,CAGTTAGGCGGCATAATTGC,0,1273267
furpa,0.05,19,19,CAGGCTGTCCCCTCTGGACG,0,1312089
furpa,0.05,19,19,CAGCCACAGATTTTAGTTTC,0,1353314
furpa,0.05,19,19,CACTGAATAAGCCGTGTCCT,0,1308160
furpa,0.05,19,19,CAAGAGTGTGTCTCTCGATG,0,1280369
furpa,0.05,19,19,ATTTTGTTATCTTCGCAATT,0,1315517
furpa,0.05,19,19,ATTTAGGGTTTAGAGTAAGG,0,1327169
furpa,0.05,19,19,ATTTAAATAGGAAGGTCTGC,0,1341855
furpa,0.05,19,19,ATTGGGATGCCGCCACTGTA,0,1327145
furpa,0.05,19,19,ATGGGGCCATCTATTCGGCC,0,1345874
furpa,0.05,19,19,ATGGATTTCCTAGCCCTTTG,0,1354694
furpa,0.05,19,19,ATGCTTAATCTGACGTTACG,0,1326966
furpa,0.05,19,19,ATGACGGAAGTGGACTAGGG,0,1310903
furpa,0.05,19,19,ATGAATGGTCAGATGTACAG,0,1328508
furpa,0.05,19,19,ATCTAGAAGAGTAGGTGCTA,0,1302010
furpa,0.05,19,19,ATCCGATTTCGTTATCGAGC,0,1349540
furpa,0.05,19,19,ATCCCCGTCAGCCGGCGCGC,0,1329275
furpa,0.05,19,19,ATCACTTGGGAGGGGGATAT,0,1313666
furpa,0.05,19,19,ATAGTACGCAATATCCTCCA,0,1321256
furpa,0.05,19,19,ATAGCTTTCGTCACGTTTGC,0,1277810
furpa,0.05,19,19,ATAGCTCGACGGGCCATGAC,0,1282742
furpa,0.05,19,19,ATACCGCATTTTGCTAGTTT,0,1348150
furpa,0.05,19,19,ATAATCCGACTCTGAATCCT,0,1276877
furpa,0.05,19,19,AGTATTTTAGTCTCGGGGCA,0,1301781
furpa,0.05,19,19,AGGCAAAAGCCATATTGGTC,0,1351498
furpa,0.05,19,19,AGGACATATCCTTGCCTGCG,0,1298439
furpa,0.05,19,19,AGCGCTATGGACGTGCACGT,0,1344932
furpa,0.05,19,19,AGCACGGAGGGGATACTGTT,0,1309748
furpa,0.05,19,19,ACTCTTTCAGGTCGCCTTTC,0,1274998
furpa,0.05,19,19,ACTCCACGGAGTATGAGAAT,0,1282435
furpa,0.05,19,19,ACGGCCGAAGTAGTGCTTCC,0,1317623
furpa,0.05,19,19,ACGGCCATATTGGATTGCTA,0,1309078
furpa,0.05,19,19,ACGCTGAGCTCCCCGGTCCC,0,1300805
furpa,0.05,19,19,ACCCTCTGCGTAACTCACGA,0,1301100
furpa,0.05,19,19,ACCCCGCAAAACCATCATGT,0,1314685
furpa,0.05,19,19,ACCACATGCATGGCATTGAA,0,1311761
furpa,0.05,19,19,ACCAAAAACTTCTTAAGTCA,0,1291682
furpa,0.05,19,19,ACATTTTTGCGGATGAGACT,0,1291135
furpa,0.05,19,19,AAGATTTTGAGATAAAGACA,0,1310275
furpa,0.05,19,19,AAGAAAACGCATACTCTCCT,0,1299305
furpa,0.05,19,19,AACTTATGTGGTTTTGGGAG,0,1309678
furpa,0.05,19,19,AACCTGCTTGGGGATTAAGT,0,1301013
furpa,0.05,19,19,AACCTACCGATCGGGACGTG,0,1302734
furpa,0.05,19,19,AAATATGCATTCGTGTGTCC,0,1304971
furpa,0.05,19,19,AAATAGCGAAACAGGAAAAC,0,1346004
furpa,0.05,19,19,AAAGGCGGCGAATAGGTGAC,0,1318387
furpa,0.05,19,19,AAAGATTGAGCGTCATGCGT,0,1333229
furpa,0.05,19,19,AAAGACAATGTCCTCTGTGG,0,1333515
furpa,0.05,19,19,AAACGTAGAATTTTTTTCTA,0,1293983
furpa,0.05263157894736842,18,18,TTTGTGGAAGCAGTGAGACC,0,1287860
furpa,0.05263157894736842,18,18,TTGTTAGGCTTTCTCTGTAA,0,1341231
furpa,0.05263157894736842,18,18,TTGCCTCATGATCGTCTAGA,0,1280775
furpa,0.05263157894736842,18,18,TTCGAGACACGATAACCAAA,0,1316776
furpa,0.05263157894736842,18,18,TTCATCGACCCGAGGTAGGA,0,1273978
furpa,0.05263157894736842,18,18,TTAATGAGCATCTTCATTAT,0,1331152
furpa,0.05263157894736842,18,18,TGTGAAGGGATATGCCGGAA,0,1304300
furpa,0.05263157894736842,18,18,TGTCGGCTTTGTTCTAGTCC,0,1305753
furpa,0.05263157894736842,18,18,TGTAACGTTGGTACCGGACC,0,1283075
furpa,0.05263157894736842,18,18,TGGAGGTTTTCTGCATACTT,0,1303524
furpa,0.05263157894736842,18,18,TGGACGCGCGCCATCATCTG,0,1313436
furpa,0.05263157894736842,18,18,TGGAAGGACGCACCGGGGTT,0,1321094
furpa,0.05263157894736842,18,18,TGCCTATCGCACGTATGCTG,0,1336515
furpa,0.05263157894736842,18,18,TGCCAGGGGTTTTCCTGTAG,0,1319333
furpa,0.05263157894736842,18,18,TGAATTAGTGAAAAGTTCCT,0,1342498
furpa,0.05263157894736842,18,18,TCTTTTTATAGGGACTGATG,0,1282300
furpa,0.05263157894736842,18,18,TCAAAGCCAGCTCCTCCGGG,0,1307680
furpa,0.05263157894736842,18,18,TATGATTCATAAGTAAAGCT,0,1286694
furpa,0.05263157894736842,18,18,TATAGAACCTTGGGATGACT,0,1311947
furpa,0.05263157894736842,18,18,TACTTTCCATTACGGCGTCG,0,1337758
furpa,0.05263157894736842,18,18,TACTGTAATGCTTAGGATTT,0,1349106
furpa,0.05263157894736842,18,18,TACCGATAAAAGGGCTCGGG,0,1274041
furpa,0.05263157894736842,18,18,TACATTTATTGCCAACTTGG,0,1357713
furpa,0.05263157894736842,18,18,TACATAGAGACACACACCTC,0,1293383
furpa,0.05263157894736842,18,18,TAACTGCAGAGACTTGTGAA,0,1290259
furpa,0.05263157894736842,18,18,TAACCACATCTGTAAGTACG,0,1357675
furpa,0.05263157894736842,18,18,GTGGGGCTTAACGTGTCTAT,0,1274042
furpa,0.05263157894736842,18,18,GTGCGCGCATTACACAGTAC,0,1294249
furpa,0.05263157894736842,18,18,GTCGGCATAAGGTCTCAATA,0,1295495
furpa,0.05263157894736842,18,18,GTCGCACAAACCAGAATCTA,0,1339979
furpa,0.05263157894736842,18,18,GTCAAGATGTGACGCTTTGT,0,1300393
furpa,0.05263157894736842,18,18,GTAGGCAGTATTGCGGGCGA,0,1285056
furpa,0.05263157894736842,18,18,GTAGACCGGCCGACTAACTA,0,1328408
furpa,0.05263157894736842,18,18,GGTTCCTGTCTGAGGGCTTT,0,1334742
furpa,0.05263157894736842,18,18,GGTCCCCTGCGGATTTCAAG,0,1347759
furpa,0.05263157894736842,18,18,GGGTCACTGCGCAAAGAGGG,0,1306552
furpa,0.05263157894736842,18,18,GGGTAGGCAACACTGTCGTT,0,1330399
furpa,0.05263157894736842,18,18,GGGATCGCATGGTTGAAAGC,0,1325141
furpa,0.05263157894736842,18,18,GGGAACACATGTGGGGCGTC,0,1327057
furpa,0.05263157894736842,18,18,GGCGCGATCCGTTAATCTCA,0,1320856
furpa,0.05263157894736842,18,18,GGATGAGGCATGCTAATTTC,0,1275446
furpa,0.05263157894736842,18,18,GGATCTGGGCTGAAGGTGTA,0,1339542
furpa,0.05263157894736842,18,18,GGATCAAGGTTCATTCGGAC,0,1352860
furpa,0.05263157894736842,18,18,GGAGGTCGTCTCAGCAAAGG,0,1343051
furpa,0.05263157894736842,18,18,GGAATGGCACAGGATACGAG,0,1301719
furpa,0.05263157894736842,18,18,GCTGTGGCGGCAACAGGCCA,0,1319502
furpa,0.05263157894736842,18,18,GCGTGTAGGATGATGTTGGA,0,1278609
furpa,0.05263157894736842,18,18,GCGCAGCCGAGTAGACGATT,0,1293130
furpa,0.05263157894736842,18,18,GCCGGCAGACATGCACGCTC,0,1343109
furpa,0.05263157894736842,18,18,GCCCGTGTGCAATCCCTTAA,0,1350033
furpa,0.05263157894736842,18,18,GCATCCGATCTTCCCATCCG,0,1277405
furpa,0.05263157894736842,18,18,GCACAAATGTCTCTTTGCTA,0,1284004
furpa,0.05263157894736842,18,18,GATCTGATATATTCCCGAGG,0,1282460
furpa,0.05263157894736842,18,18,GATCGGGCGTGCAATGTGCC,0,1272604
furpa,0.05263157894736842,18,18,GATCACTTATCAAAATGATA,0,1308440
furpa,0.05263157894736842,18,18,GATATATGTAGTTAAAGCCT,0,1298832
furpa,0.05263157894736842,18,18,GAGTGGCCTGCTTGTGACCC,0,1344610
furpa,0.05263157894736842,18,18,GAGGGACATAATGGAATTTG,0,1279665
furpa,0.05263157894736842,18,18,GAGAGCGCCAAATTCAGCGT,0,1285684
furpa,0.05263157894736842,18,18,GAACGCGGTACTTTAGCCGA,0,1316897
furpa,0.05263157894736842,18,18,CTTTACCTCTGCACGTGTTA,0,1347905
furpa,0.05263157894736842,18,18,CTTGCCAACAGCCTCATGCA,0,1354089
furpa,0.05263157894736842,18,18,CTTCGCGGGCGTAGGTGTGA,0,1316325
furpa,0.05263157894736842,18,18,CTTAGCCGCAACCTTGGCTT,0,1324640
furpa,0.05263157894736842,18,18,CTGGTAAGTGACCCGGGGGG,0,1283372
furpa,0.05263157894736842,18,18,CTGCAAGGAACACCTAAGTC,0,1309269
furpa,0.05263157894736842,18,18,CTCCATACTAAGGAATCGAT,0,1279586
furpa,0.05263157894736842,18,18,CTATAGCCTAACAGTCGGCA,0,1281712
furpa,0.05263157894736842,18,18,CTAGGTAGGTATGCAACAGA,0,1273680
furpa,0.05263157894736842,18,18,CTAGGACTATGAATCGAGTT,0,1347359
furpa,0.05263157894736842,18,18,CTAGCCTACAGTCACATTTG,0,1302873
furpa,0.05263157894736842,18,18,CTACGCGCACTCGATCATGG,0,1320684
furpa,0.05263157894736842,18,18,CGTTGCGTGTACCTAAGCTC,0,1298961
furpa,0.05263157894736842,18,18,CGTGTTAGATCCTGCTGGTT,0,1280383
furpa,0.05263157894736842,18,18,CGTAGATGCTCCAGTAATTA,0,1350582
furpa,0.05263157894736842,18,18,CGGTGGGCCCCTGCAGAGGA,0,1341723
furpa,0.05263157894736842,18,18,CGGGAAACCTGCGCCATGAA,0,1273519
furpa,0.05263157894736842,18,18,CGGATTGCGAGGCTTTATGC,0,1327490
furpa,0.05263157894736842,18,18,CGCGTACGCTCTACCGAGGT,0,1306023
furpa,0.05263157894736842,18,18,CGCCGGGTAAAGATTGGCTG,0,1338766
furpa,0.05263157894736842,18,18,CGCATAACCATCCGACACTC,0,1321356
furpa,0.05263157894736842,18,18,CGATCAATCGCACCGCTCAT,0,1319906
furpa,0.05263157894736842,18,18,CGACGCCAGCGCTGTCTATG,0,1317937
furpa,0.05263157894736842,18,18,CGACCCAACATTGAGGAGAT,0,1293630
furpa,0.05263157894736842,18,18,CCTGCATTGCATGTAGCCAT,0,1310210
furpa,0.05263157894736842,18,18,CCTGAATCCTTAGGTGGACC,0,1314054
furpa,0.05263157894736842,18,18,CCTCGTCACTTTTACTACGT,0,1355389
furpa,0.05263157894736842,18,18,CCTCGATCCCGGCATCCCGA,0,1279588
furpa,0.05263157894736842,18,18,CCTCACCCGACTGGCATCAT,0,1310751
furpa,0.05263157894736842,18,18,CCTACCGTGGAGGACAACCA,0,1295447
furpa,0.05263157894736842,18,18,CCGTCCAGTTTCCTTATGCA,0,1305410
furpa,0.05263157894736842,18,18,CCGGGCCAGTGAATCGGCAT,0,1329244
furpa,0.05263157894736842,18,18,CCGCTTGCCATTGGGCCTTA,0,1286650
furpa,0.05263157894736842,18,18,CCGCCCATTTACGCGGGCAT,0,1282964
furpa,0.05263157894736842,18,18,CCGACTATTGATACATTCTG,0,1319837
furpa,0.05263157894736842,18,18,CCCTTCCCATGGTGACAGGT,0,1304583
furpa,0.05263157894736842,18,18,CCACCGCCTGAATGCTGGAT,0,1346845
furpa,0.05263157894736842,18,18,CATGCTTGTATAACGGCGCT,0,1316343
furpa,0.05263157894736842,18,18,CATGAAGTCTGGCATCGTGT,0,1313167
furpa,0.05263157894736842,18,18,CATAGCGACCAAGTGCCGTG,0,1330708
furpa,0.05263157894736842,18,18,CATAAAGATCATTGTCATCT,0,1317074
furpa,0.05263157894736842,18,18,CAGGAATATTCGCTAGTAGT,0,1327675
furpa,0.05263157894736842,18,18,CACCGCCAGATAGTAGCTCG,0,1274064
furpa,0.05263157894736842,18,18,CACCCAGGGCCTGACGTTGG,0,1301355
furpa,0.05263157894736842,18,18,CACAGTCCTAATAGACCTAA,0,1309836
furpa,0.05263157894736842,18,18,CACAGAGAGACCGGCTTAAT,0,1331188
furpa,0.05263157894736842,18,18,CACAGACTGTGCGAGATGTC,0,1326533
furpa,0.05263157894736842,18,18,CAATCCATTAACTTTGGTAT,0,1294392
furpa,0.05263157894736842,18,18,CAACACAATGGTGACATCGA,0,1354628
furpa,0.05263157894736842,18,18,ATTTTAAGGGTTATGCATCA,0,1282744
furpa,0.05263157894736842,18,18,ATTCTTCTACGGCGGTGATA,0,1290460
furpa,0.05263157894736842,18,18,ATTAGATGGCATGGTGTTAC,0,1357618
furpa,0.05263157894736842,18,18,ATGCGTGGATGCGGCTAACT,0,1274859
furpa,0.05263157894736842,18,18,ATCTGTGTATGCTGTGAACT,0,1283298
furpa,0.05263157894736842,18,18,ATCCCGCGATGGTACATCTT,0,1350314
furpa,0.05263157894736842,18,18,ATAGAGTGTAACGGTAGACG,0,1333671
furpa,0.05263157894736842,18,18,AGTGGCTACCTGTGTAATTT,0,1335653
furpa,0.05263157894736842,18,18,AGTATGTGGAACATGGCGGT,0,1292935
furpa,0.05263157894736842,18,18,AGTATAGCTTAGATTCTAGT,0,1281293
furpa,0.05263157894736842,18,18,AGGTTTTACCAAAGTCTGAC,0,1322210
furpa,0.05263157894736842,18,18,AGGTCCGAGCAACATTTGTA,0,1280850
furpa,0.05263157894736842,18,18,AGGCCCTTTTACAGTCAGAG,0,1274231
furpa,0.05263157894736842,18,18,AGGAGCGATGATGGTCGAGG,0,1353191
furpa,0.05263157894736842,18,18,AGCGTCAGAGCTCACAAGAA,0,1276240
furpa,0.05263157894736842,18,18,AGCCCTATGGGAATGTAGTG,0,1281332
furpa,0.05263157894736842,18,18,AGCAACCTAAGCAAACGCAT,0,1355650
furpa,0.05263157894736842,18,18,AGCAACCAGTGTACAGTACA,0,1355261
furpa,0.05263157894736842,18,18,AGAGTTACCAGTGAGACGCT,0,1290622
furpa,0.05263157894736842,18,18,AGACTTTAATAGCGTCAATT,0,1310921
furpa,0.05263157894736842,18,18,AGACCATAACATTTCTTCAT,0,1312429
furpa,0.05263157894736842,18,18,AGAACCAATAGGGTGAAGGG,0,1324646
furpa,0.05263157894736842,18,18,ACTGGTGCATTTTTCTTGTA,0,1337279
furpa,0.05263157894736842,18,18,ACGGCGTGTGTTGGCCTGAA,0,1281886
furpa,0.05263157894736842,18,18,ACGCACCTAAGGCCGCACGC,0,1329600
furpa,0.05263157894736842,18,18,ACGACCGCTTATATCGGTAA,0,1311906
furpa,0.05263157894736842,18,18,ACGAATGAATTCAGTTCTGT,0,1293512
furpa,0.05263157894736842,18,18,ACGAATATTCGTGTCACCCT,0,1312829
furpa,0.05263157894736842,18,18,ACCCTAAATTGCAGATTGCT,0,1339403
furpa,0.05263157894736842,18,18,ACCCGTGCGGTTGCCCTTAA,0,1314060
furpa,0.05263157894736842,18,18,ACATGACACAAGATGGCAAC,0,1333423
furpa,0.05263157894736842,18,18,ACAGGCTCCCGAACATGGGA,0,1350698
furpa,0.05263157894736842,18,18,ACAGCATTGCGGACTACTAG,0,1288288
furpa,0.05263157894736842,18,18,AATTTTCAAGTAAGTAGATG,0,1335420
furpa,0.05263157894736842,18,18,AAGTTCCTGTCATCGCAGCC,0,1271723
furpa,0.05263157894736842,18,18,AAGTGGGAAGATCACTGTGG,0,1296019
furpa,0.05263157894736842,18,18,AACTCGTACCCAGCCCCATG,0,1279840
furpa,0.05263157894736842,18,18,AACCCAACAGACACCTGTGC,0,1316674
furpa,0.05263157894736842,18,18,AAATGGGACGTCCATACGCA,0,1305433
furpa,0.05263157894736842,18,18,AAATACTAAATACCGGTTAA,0,1336496
furpa,0.05263157894736842,18,18,AAAGTTACGCACGCGGAAGT,0,1272664
furpa,0.05263157894736842,18,18,AAAGGCAGTTAATGTGAACA,0,1309848
furpa,0.05263157894736842,18,18,AAAGCCGAGAGCTGACTAAC,0,1289896
furpa,0.05263157894736842,18,18,AAACTTCTAGGCACAAGCGA,0,1274188
furpa,0.05555555555555555,17,17,TTTGGTAGAGTGTAGGGGTC,0,1287671
furpa,0.05555555555555555,17,17,TTTGCGCTTCTTCCTGCGGA,0,1315092
furpa,0.05555555555555555,17,17,TTTCATTGCTCCGCGAAGTG,0,1340770
furpa,0.05555555555555555,17,17,TTTCACGCCGGGAGGCTGCA,0,1336568
furpa,0.05555555555555555,17,17,TTTACGCCCATTGCTTCTAA,0,1338881
furpa,0.05555555555555555,17,17,TTTAATAGCGGTTTCCGAGC,0,1300115
furpa,0.05555555555555555,17,17,TTGTTGTGGCTCTGGGTTTT,0,1284274
furpa,0.05555555555555555,17,17,TTGTCCGCCACAACGTCTGC,0,1305035
furpa,0.05555555555555555,17,17,TTGTCATCACAGCTGGTTGT,0,1272736
furpa,0.05555555555555555,17,17,TTGGACGGCTGGGCGCAGAC,0,1310169
furpa,0.05555555555555555,17,17,TTGGACCAGACCCATAAGTA,0,1323805
furpa,0.05555555555555555,17,17,TTCATAAGCGTTGAATACGA,0,1310738
furpa,0.05555555555555555,17,17,TTCAACCGTTTTGTGTAACC,0,1286037
furpa,0.05555555555555555,17,17,TTACAACTACCGGCGGGTAT,0,1340503
furpa,0.05555555555555555,17,17,TTAACTAAGAGCATCGGTTT,0,1274547
furpa,0.05555555555555555,17,17,TGTTGCCGATTAGGAGAGCT,0,1342432
furpa,0.05555555555555555,17,17,TGTATTGGACCACGTCTGCT,0,1284866
furpa,0.05555555555555555,17,17,TGTACCTCATGCTAGTAGCC,0,1341643
furpa,0.05555555555555555,17,17,TGGTAACTCCACCTGTGCAT,0,1311645
furpa,0.05555555555555555,17,17,TGGATCCTCACCAGAGATAT,0,1353001
furpa,0.05555555555555555,17,17,TGCGATAGCTCCTGTCGTGT,0,1317807
furpa,0.05555555555555555,17,17,TGCAGATCTGTAGGAGCTGA,0,1291627
furpa,0.05555555555555555,17,17,TGATCGACCAAAGGGAACAA,0,1277498
furpa,0.05555555555555555,17,17,TCGTCCTGACCTATAGTCTC,0,1287201
furpa,0.05555555555555555,17,17,TCCATGGGATTATTCGTTAA,0,1299528
furpa,0.05555555555555555,17,17,TCCAAGACTGAAGAGAGAAA,0,1282402
furpa,0.05555555555555555,17,17,TCATCCTGACTTTGGATGCA,0,1355029
furpa,0.05555555555555555,17,17,TCAATGGTCTCATGGCCTGC,0,1291179
furpa,0.05555555555555555,17,17,TATGCGCAAGGCGGTGAGAT,0,1310929
furpa,0.05555555555555555,17,17,TATCGTAAAAATTGTGTCGT,0,1338954
furpa,0.05555555555555555,17,17,TATCCGGGGAAATTCAGAAA,0,1342661
furpa,0.05555555555555555,17,17,TATAAACACCGAGTCCGAAG,0,1301611
furpa,0.05555555555555555,17,17,TAGCGTCTTATTTTCGGACC,0,1342452
furpa,0.05555555555555555,17,17,TAGCCAATGATAAATGGATG,0,1285466
furpa,0.05555555555555555,17,17,TACAGCTTTGAGCCAACATC,0,1283439
furpa,0.05555555555555555,17,17,TAATCTAGTTACGCGCTCCT,0,1312401
furpa,0.05555555555555555,17,17,TAAAGACTGTGGAAAAACGG,0,1318744
furpa,0.05555555555555555,17,17,GTTTCCGTGTCCAGGGTACG,0,1322468
furpa,0.05555555555555555,17,17,GTTGTCCAACGATGTCTGTG,0,1301482
furpa,0.05555555555555555,17,17,GTTGGGCTACAAGGCGGCCT,0,1275918
furpa,0.05555555555555555,17,17,GTTCAATATATTACTGCCAT,0,1286579
furpa,0.05555555555555555,17,17,GTTATAGAGTGCAGCTGTCA,0,1310691
furpa,0.05555555555555555,17,17,GTGTCGTTGGTCCTTGGAGG,0,1345676
furpa,0.05555555555555555,17,17,GTGGTTACTGGCAATTCAAC,0,1278077
furpa,0.05555555555555555,17,17,GTGGGAGCGGTTCATGCCTA,0,1325477
furpa,0.05555555555555555,17,17,GTGATTGTGTTGGTGCGGGA,0,1336607
furpa,0.05555555555555555,17,17,GTCATCTAGTCCTTGTGATG,0,1295703
furpa,0.05555555555555555,17,17,GTCAGAGACACTCTGTGCTA,0,1289785
furpa,0.05555555555555555,17,17,GTAATTTCCGTTTGCACAAT,0,1285549
furpa,0.05555555555555555,17,17,GGTTGGCTCGCACTGGGAGT,0,1289612
furpa,0.05555555555555555,17,17,GGTTCTGCTGGACATCACGG,0,1346118
furpa,0.05555555555555555,17,17,GGTCGTTACCCGTTCACGCA,0,1291276
furpa,0.05555555555555555,17,17,GGTCGTATAGAGTCTTAACA,0,1340478
furpa,0.05555555555555555,17,17,GGTCAAGCCAGGGTAGCAGC,0,1284319
furpa,0.05555555555555555,17,17,GGTAAGCGTTCACTTTCCAC,0,1298143
furpa,0.05555555555555555,17,17,GGGTGAACGCCCGGCGGCCC,0,1311274
furpa,0.05555555555555555,17,17,GGGGTCTCAAACTACAACAA,0,1339787
furpa,0.05555555555555555,17,17,GGCCGCTGATTGTGTGTGAA,0,1339996
furpa,0.05555555555555555,17,17,GGCCCGCTGAGGAACCTTAT,0,1342821
furpa,0.05555555555555555,17,17,GGATAAGCTCGATACAGGCA,0,1337934
furpa,0.05555555555555555,17,17,GGAATGTGAGCCTTTTAGGT,0,1316639
furpa,0.05555555555555555,17,17,GCTCCGGGACCCACGCCGGC,0,1343927
furpa,0.05555555555555555,17,17,GCTAAGTTGGAACAACTTCC,0,1331295
furpa,0.05555555555555555,17,17,GCGTTCTTCTCAACTCGCGA,0,1356266
furpa,0.05555555555555555,17,17,GCGCGTAGGTGGATCCCGGC,0,1299551
furpa,0.05555555555555555,17,17,GCGAGTCAGGTTCAGCCACG,0,1321737
furpa,0.05555555555555555,17,17,GCCCTACGGCGAGTAAAGGT,0,1293552
furpa,0.05555555555555555,17,17,GCCCGGGGACACCGGAGTTC,0,1343586
furpa,0.05555555555555555,17,17,GCCATGGTATGGGTTATCGT,0,1340321
furpa,0.05555555555555555,17,17,GCATTGACAGATGAAGTGTC,0,1340014
furpa,0.05555555555555555,17,17,GCAGTTCCGCTAAGGCTCTC,0,1312203
furpa,0.05555555555555555,17,17,GCAGGCAAGCATGCGTACAT,0,1326865
furpa,0.05555555555555555,17,17,GCAGAGGTCATCGAGTTACT,0,1291202
furpa,0.05555555555555555,17,17,GCACGGAGATGTGTTGAGTC,0,1330333
furpa,0.05555555555555555,17,17,GCAATAGCAAATTACGTCAA,0,1294129
furpa,0.05555555555555555,17,17,GATTTGTCCAGTTATTGTTG,0,1292304
furpa,0.05555555555555555,17,17,GAGTCTGCGCCCCTTCTTAT,0,1350052
furpa,0.05555555555555555,17,17,GAGCGTCCTGATGTCCAGAA,0,1329682
furpa,0.05555555555555555,17,17,GAGAGCTGATTTCGATAGGC,0,1292059
furpa,0.05555555555555555,17,17,GAGACAGGATGTGTGCCGCC,0,1334837
furpa,0.05555555555555555,17,17,GACTGTCTGGAGCGCATAAA,0,1310841
furpa,0.05555555555555555,17,17,GACGTTGTAGAACCTCTCGC,0,1345185
furpa,0.05555555555555555,17,17,GAAGAAGACCGGAATCAAGC,0,1338220
furpa,0.05555555555555555,17,17,CTTTCATGCTATAGATGCTA,0,1286673
furpa,0.05555555555555555,17,17,CTTTCAGCGATGGGCTTTGG,0,1319275
furpa,0.05555555555555555,17,17,CTGTCTTGAGTCGGGAATGC,0,1335025
furpa,0.05555555555555555,17,17,CTGTAGTTGCAGGGTCACAA,0,1296281
furpa,0.05555555555555555,17,17,CTGGGATCGGTACGAACAGG,0,1286819
furpa,0.05555555555555555,17,17,CTGAGTCATGTAATAGCTCT,0,1272688
furpa,0.05555555555555555,17,17,CTATGAACATGAGGTCTCGA,0,1306108
furpa,0.05555555555555555,17,17,CTACGGTCTCCAACTGCTTG,0,1295541
furpa,0.05555555555555555,17,17,CTAATTCCTACCGGCCTCAA,0,1330935
furpa,0.05555555555555555,17,17,CGTGGTCTTCGGAGTACCAA,0,1288113
furpa,0.05555555555555555,17,17,CGGGTACGAACATGTGCACA,0,1356475
furpa,0.05555555555555555,17,17,CGGGCTAACGAGTGATTCGG,0,1327176
furpa,0.05555555555555555,17,17,CGGGAAAGGTGCAAAGGACC,0,1346183
furpa,0.05555555555555555,17,17,CGGCGTGAATGCAATGGGCT,0,1301101
furpa,0.05555555555555555,17,17,CGGCGTCAACCCTGTCATCG,0,1312151
furpa,0.05555555555555555,17,17,CGGACTATATTTGGATCTGA,0,1307865
furpa,0.05555555555555555,17,17,CGGAATTTTTGGTTGAGTTC,0,1298634
furpa,0.05555555555555555,17,17,CGCTGAATAGTGCTTGCCTG,0,1306137
furpa,0.05555555555555555,17,17,CGCATGAACTGGGTTACTTT,0,1300794
furpa,0.05555555555555555,17,17,CGCAGTTCTTAGGTGAGGAG,0,1333235
furpa,0.05555555555555555,17,17,CGCAGCGGTAGATGGAGGTG,0,1357207
furpa,0.05555555555555555,17,17,CGCAAGCGGTAGTTAGCTCT,0,1351700
furpa,0.05555555555555555,17,17,CGACACTAATCAGGGCAAAA,0,1345259
furpa,0.05555555555555555,17,17,CCTTGTACGCTTGCTAGTGG,0,1299227
furpa,0.05555555555555555,17,17,CCTATAGATAAGAGTAGAAA,0,1350477
furpa,0.05555555555555555,17,17,CCTAGCAATGTAATCCGGTT,0,1286588
furpa,0.05555555555555555,17,17,CCGTTAATAGGCAAGAGTTC,0,1322813
furpa,0.05555555555555555,17,17,CCGTCGCAAGGGTACTGGAC,0,1281672
furpa,0.05555555555555555,17,17,CCGTAGTTTACGTGGGAGCT,0,1291024
furpa,0.05555555555555555,17,17,CCGTAGCCATATATCACGAT,0,1319022
furpa,0.05555555555555555,17,17,CCGCGTCAATCGCCCCATTC,0,1303151
furpa,0.05555555555555555,17,17,CCGCAAGGTTCTGCCTTGCA,0,1315808
furpa,0.05555555555555555,17,17,CCCGCCGGACGAGGTTGACC,0,1289767
furpa,0.05555555555555555,17,17,CCCAGGTATGAGAGTTTAGG,0,1273686
furpa,0.05555555555555555,17,17,CCCAGAGCATTATGCAAAAC,0,1343540
furpa,0.05555555555555555,17,17,CCCAACCCAAAAATTGTCAC,0,1285629
furpa,0.05555555555555555,17,17,CCATAGATTTGGGTGGCTTG,0,1340985
furpa,0.05555555555555555,17,17,CATGGTCAGAGAGCAGTAAC,0,1343039
furpa,0.05555555555555555,17,17,CATAATTGCATGCGGTTACA,0,1286606
furpa,0.05555555555555555,17,17,CAGGTGTTATTCATACTCAG,0,1317706
furpa,0.05555555555555555,17,17,CAGGTACTGCGGATAGGCTA,0,1333221
furpa,0.05555555555555555,17,17,CAGGGGCTGAAACCGTCAGT,0,1288816
furpa,0.05555555555555555,17,17,CAGGAGGAATGAGTCTGGGA,0,1274440
furpa,0.05555555555555555,17,17,CACGATGGTAATGCATTCCG,0,1277745
furpa,0.05555555555555555,17,17,CACCATGCGGGCTCCTGGTG,0,1280828
furpa,0.05555555555555555,17,17,CACCAAGCACAGAGATGTGA,0,1353455
furpa,0.05555555555555555,17,17,CAATACTGCGCTCTACACCA,0,1272596
furpa,0.05555555555555555,17,17,CAAGCTACAGAGTTATCTTG,0,1326042
furpa,0.05555555555555555,17,17,CAACTGGTTCCACTTCGACC,0,1320724
furpa,0.05555555555555555,17,17,CAACCGGCCAACCCGTCGTA,0,1278185
furpa,0.05555555555555555,17,17,CAAATGGCGCAAACCTCGCT,0,1336420
furpa,0.05555555555555555,17,17,ATTTGCCAGATAGTGTCCAA,0,1321780
furpa,0.05555555555555555,17,17,ATTGGATATGTTCTCCGCTA,0,1336214
furpa,0.05555555555555555,17,17,ATGGTACCGCATTGCTTAAT,0,1290844
furpa,0.05555555555555555,17,17,ATGCGTATAGTATTAGTTTA,0,1338827
furpa,0.05555555555555555,17,17,ATCTTAGAGGCTTGGCGTCC,0,1308640
furpa,0.05555555555555555,17,17,ATCGTAGGGCGCCCTGTCTG,0,1323816
furpa,0.05555555555555555,17,17,ATCCCCGAACGGAACAGAGG,0,1288813
furpa,0.05555555555555555,17,17,ATCCAACGACATACACTTAT,0,1285194
furpa,0.05555555555555555,17,17,ATACTTCCCGCCTCCGCAAC,0,1294643
furpa,0.05555555555555555,17,17,ATACGGCACAAGCAAAAGTA,0,1291553
furpa,0.05555555555555555,17,17,ATAACCATTTGGCCTCGAAA,0,1352192
furpa,0.05555555555555555,17,17,AGTGAGTAAGGGTGTCCGAC,0,1285824
furpa,0.05555555555555555,17,17,AGGTGGAGCCGAGACATGAT,0,1282330
furpa,0.05555555555555555,17,17,AGGTGACCGCCCATTGGGAA,0,1274819
furpa,0.05555555555555555,17,17,AGGAGCAATCATGTCCTAAT,0,1299287
furpa,0.05555555555555555,17,17,AGCCGCACTTGAAAAAGAAA,0,1336339
furpa,0.05555555555555555,17,17,AGCACTCAACAACATTCCAA,0,1306589
furpa,0.05555555555555555,17,17,AGATGAAGCACCTAGAGATG,0,1351483
furpa,0.05555555555555555,17,17,AGACAGTCCCTACGAGGTGA,0,1346554
furpa,0.05555555555555555,17,17,ACTTGACTTGGCACCACACC,0,1291913
furpa,0.05555555555555555,17,17,ACTTAGATTACACCCATATT,0,1284392
furpa,0.05555555555555555,17,17,ACTCTTACCCTCTCGGCGGG,0,1271928
furpa,0.05555555555555555,17,17,ACTCGCCTACTGGCCAGATC,0,1356114
furpa,0.05555555555555555,17,17,ACGTAGGGATAGAAAACCTT,0,1319754
furpa,0.05555555555555555,17,17,ACGCTAGGACGACGCGTCAT,0,1328457
furpa,0.05555555555555555,17,17,ACATTTCTCCGCATAATAAT,0,1338895
furpa,0.05555555555555555,17,17,ACAGGTAATGGGTTTGACTG,0,1294262
furpa,0.05555555555555555,17,17,AATGTTTCCATCCGCCCAAT,0,1308480
furpa,0.05555555555555555,17,17,AATCTCCGAGAGGCGAGCTT,0,1273021
furpa,0.05555555555555555,17,17,AAGCTAGCTAGTAGACTTAT,0,1295936
furpa,0.05555555555555555,17,17,AAGCACGTATTTCTTTTATT,0,1349533
furpa,0.05555555555555555,17,17,AACTCCAAACTATGCCAAGA,0,1316587
furpa,0.05555555555555555,17,17,AACGGGGGAAATGTCCAACT,0,1314597
furpa,0.05555555555555555,17,17,AACGAGATTTGCGTCTCCAA,0,1289546
furpa,0.05555555555555555,17,17,AACGACATGCATCCACAGTG,0,1286239
furpa,0.05555555555555555,17,17,AACGAACAAGTCGTTTCCAC,0,1313015
furpa,0.05555555555555555,17,17,AAATATTATTGAATGGATGC,0,1295701
furpa,0.05555555555555555,17,17,AAAGCGACGACCGCAACAAT,0,1354227
furpa,0.05555555555555555,17,17,AAAACGGCTTACGGGTCAAC,0,1287786
furpa,0.05555555555555555,17,17,AAAAAGGGATATGTCTACAG,0,1323509
furpa,0.058823529411764705,16,16,TTTTGTGACAGGGGCAATGG,0,1305418
furpa,0.058823529411764705,16,16,TTTTGCCTGCCAACATAGGT,0,1274508
furpa,0.058823529411764705,16,16,TTTGCGCAAATGACAGTTAC,0,1336876
furpa,0.058823529411764705,16,16,TTGGCGTGTCTGGATACCGC,0,1287084
furpa,0.058823529411764705,16,16,TTGCCGGGAAATTCTATCAT,0,1292831
furpa,0.058823529411764705,16,16,TTGAATGCCGCACATGTTCG,0,1287097
furpa,0.058823529411764705,16,16,TTCTCAATCAAGCCCAGCTT,0,1339933
furpa,0.058823529411764705,16,16,TTCTAATCGATTTCGATTAT,0,1279808
furpa,0.058823529411764705,16,16,TTCGTTTTAACGCATATTCG,0,1343130
furpa,0.058823529411764705,16,16,TTCGGGCCATGTCTTTCGCA,0,1346143
furpa,0.058823529411764705,16,16,TTATCATCCGTTTCTGAGTT,0,1334981
furpa,0.058823529411764705,16,16,TTAGCAATTTAGGTCTGACT,0,1298030
furpa,0.058823529411764705,16,16,TTACTTCATAGGGTTATATT,0,1304136
furpa,0.058823529411764705,16,16,TTACGCCGACGGGCGTGGTT,0,1279284
furpa,0.058823529411764705,16,16,TTACCGTCGTTATGGCGTCT,0,1296434
furpa,0.058823529411764705,16,16,TTAATTATTAATCGCCTATC,0,1333384
furpa,0.058823529411764705,16,16,TGTCGAATGCCGTTTCGTGC,0,1316903
furpa,0.058823529411764705,16,16,TGGTCAGTTCCTACAAAGAT,0,1273029
furpa,0.058823529411764705,16,16,TGGTAATCCCATGGCTGAAC,0,1322631
furpa,0.058823529411764705,16,16,TGGACTATATGTGACCAGGT,0,1272655
furpa,0.058823529411764705,16,16,TGCGATTCCTCCGATCTGAA,0,1317233
furpa,0.058823529411764705,16,16,TGAGAGTAACCCTGCATCTT,0,1311361
furpa,0.058823529411764705,16,16,TGACCTATGTTTACCATAAA,0,1307359
furpa,0.058823529411764705,16,16,TGACCCCCCGCAGACGTAAT,0,1321091
furpa,0.058823529411764705,16,16,TGAACTAAGTTTGTCCGACA,0,1343803
furpa,0.058823529411764705,16,16,TCTTGAGTCGGTGCCCTTGA,0,1341477
furpa,0.058823529411764705,16,16,TCTGAAATGGCGATCAAAGA,0,1293134
furpa,0.058823529411764705,16,16,TCTCTTGGCGATATGCTTTC,0,1348720
furpa,0.058823529411764705,16,16,TCGGGACACGTAGCGGATAG,0,1340718
furpa,0.058823529411764705,16,16,TCGCCGATATCCTAGTAACA,0,1293188
furpa,0.058823529411764705,16,16,TCGATGTAATGCTGTTAAAA,0,1346807
furpa,0.058823529411764705,16,16,TCCGGGTCAATTGCGGGATA,0,1320577
furpa,0.058823529411764705,16,16,TCCCGCGGCCGCGCAACTTA,0,1303240
furpa,0.058823529411764705,16,16,TCCATGGCGGGTGCCAGATA,0,1274929
furpa,0.058823529411764705,16,16,TCATAACGCTCTTCGTAGGA,0,1274253
furpa,0.058823529411764705,16,16,TCAGCATATTTTTCATTGAT,0,1303877
furpa,0.058823529411764705,16,16,TCACTACTCTCAATCGAATA,0,1285694
furpa,0.058823529411764705,16,16,TCACGGGGGGAACGATCATT,0,1290148
furpa,0.058823529411764705,16,16,TCAAAGGGTCTATGTTTCTA,0,1289467
furpa,0.058823529411764705,16,16,TATGGCTCTGCCTTATTCGC,0,1340423
furpa,0.058823529411764705,16,16,TATGCTTTACGCAAAGTGTC,0,1307176
furpa,0.058823529411764705,16,16,TATCTGTACCGGATTCGCAA,0,1329354
furpa,0.058823529411764705,16,16,TATAACTGCGCGGACCTCAT,0,1284657
furpa,0.058823529411764705,16,16,TAGTCTGGTCCATACGTGCT,0,1334127
furpa,0.058823529411764705,16,16,TAGGTACGCCATGTGATAAT,0,1292598
furpa,0.058823529411764705,16,16,TAGCTCAGCGCCCTACCGTC,0,1347586
furpa,0.058823529411764705,16,16,TAGACATCGTTAAATTTTAA,0,1326653
furpa,0.058823529411764705,16,16,TACTGTGGGATGGACGAACT,0,1286044
furpa,0.058823529411764705,16,16,TACGGGACCTCCACTCACGT,0,1319190
furpa,0.058823529411764705,16,16,TACACCATACAGTGCTTAGA,0,1297960
furpa,0.058823529411764705,16,16,TAACTGTCGAGAAAGCGTAG,0,1332610
furpa,0.058823529411764705,16,16,TAAATGCACCTCTGTTTAAC,0,1341841
furpa,0.058823529411764705,16,16,TAAAGGATTCAAGGCCCCCT,0,1288688
furpa,0.058823529411764705,16,16,TAAACTGTTGACGGTCGAAC,0,1291357
furpa,0.058823529411764705,16,16,GTTGGTGCTATAAACGAAAT,0,1339058
furpa,0.058823529411764705,16,16,GTGTTCGCAGATAATTTTCG,0,1315706
furpa,0.058823529411764705,16,16,GTGTACCCAGAGGCTGACCT,0,1355347
furpa,0.058823529411764705,16,16,GTGAGCGTCACACCAAATAA,0,1341113
furpa,0.058823529411764705,16,16,GTGACTCGGTCTCGCCTGTG,0,1349928
furpa,0.058823529411764705,16,16,GTCTGGGTGCGCTCCGGTTG,0,1290152
furpa,0.058823529411764705,16,16,GTCCGGGCGACAACGGAGGT,0,1297901
furpa,0.058823529411764705,16,16,GTCCAGTAGAGAGCCCACAT,0,1299002
furpa,0.058823529411764705,16,16,GTCATGGTCGGCTTAGTACT,0,1299297
furpa,0.058823529411764705,16,16,GTCAAGTGTTGGGCACGACC,0,1285899
furpa,0.058823529411764705,16,16,GTATAGGGGATGGGCAAATG,0,1327570
furpa,0.058823529411764705,16,16,GTAGCGCTCGGATAGGTGCC,0,1357789
furpa,0.058823529411764705,16,16,GTACCCCATATTACTACCAG,0,1349880
furpa,0.058823529411764705,16,16,GTAAGGGCAGACATTGTTTA,0,1349793
furpa,0.058823529411764705,16,16,GGTCCAGTGTAGGACAGCAC,0,1353429
furpa,0.058823529411764705,16,16,GGTATGGAATGGCTCCGGAG,0,1340535
furpa,0.058823529411764705,16,16,GGGGGCTTTTCAAGCTAGTG,0,1307659
furpa,0.058823529411764705,16,16,GGGCGTTGAGAGACGCAGAC,0,1290164
furpa,0.058823529411764705,16,16,GGGCATCAGTGCCCGTAACA,0,1275078
furpa,0.058823529411764705,16,16,GGGAGGTCTAAGCACAAGTT,0,1332448
furpa,0.058823529411764705,16,16,GGCCAACTTACCTCGAATTG,0,1354474
furpa,0.058823529411764705,16,16,GGCAGCCTTTTCAGTACCAA,0,1298273
furpa,0.058823529411764705,16,16,GGCAAGCCTGCCTATTAATA,0,1294152
furpa,0.058823529411764705,16,16,GGAGGCCCTCCAAATTCAAA,0,1322205
furpa,0.058823529411764705,16,16,GGACGTAGATAGAATATGCT,0,1329426
furpa,0.058823529411764705,16,16,GCTTTATGCGCAGGGTAGCA,0,1355534
furpa,0.058823529411764705,16,16,GCTTTAGGGTACGGGTCTTA,0,1312742
furpa,0.058823529411764705,16,16,GCTTGCACGTCAGTCATGAC,0,1352547
furpa,0.058823529411764705,16,16,GCTTATTCTTCGTCAACCAT,0,1348392
furpa,0.058823529411764705,16,16,GCTGCCCCCTAAGTACCTTG,0,1326114
furpa,0.058823529411764705,16,16,GCTGCAACAAGGTCGGCATG,0,1272099
furpa,0.058823529411764705,16,16,GCTCGCGGACCCGGTTTTCT,0,1283877
furpa,0.058823529411764705,16,16,GCGTAGGCAGCTTTTACGAA,0,1282611
furpa,0.058823529411764705,16,16,GCGGTTTTGGTGTCCACCGT,0,1306212
furpa,0.058823529411764705,16,16,GCCACTCGGACGACTATTCT,0,1306131
furpa,0.058823529411764705,16,16,GCCACGGTACGGATTGCCCA,0,1295472
furpa,0.058823529411764705,16,16,GCATTACACGCTGGGGTAAG,0,1328609
furpa,0.058823529411764705,16,16,GCAACCCAGTATTAGCCTTG,0,1314921
furpa,0.058823529411764705,16,16,GCAACAGACTGTTTATTATT,0,1275709
furpa,0.058823529411764705,16,16,GATTAGTCTGCCGGGATAGT,0,1349932
furpa,0.058823529411764705,16,16,GATTAACAGCTACCTGGGTA,0,1314912
furpa,0.058823529411764705,16,16,GATCAATCACCTATCTGCGT,0,1321519
furpa,0.058823529411764705,16,16,GAGTAGCACCGCCTGGGCCT,0,1285493
furpa,0.058823529411764705,16,16,GAGACAGGAATTCCGGAGTT,0,1330856
furpa,0.058823529411764705,16,16,GAGAATTAATCATCACTCTG,0,1326021
furpa,0.058823529411764705,16,16,GACCAGATTCCTAAGCAGCG,0,1333549
furpa,0.058823529411764705,16,16,GACAAATCCCCAATAACAAA,0,1272041
furpa,0.058823529411764705,16,16,GAACCACAATTGTTTAACTA,0,1290406
furpa,0.058823529411764705,16,16,GAAAGCTAACCCTCTCCATC,0,1332970
furpa,0.058823529411764705,16,16,GAAAGCGCTGCGCCTGTAGT,0,1279308
furpa,0.058823529411764705,16,16,GAAACTGTTGACTGAAAGTA,0,1337092
furpa,0.058823529411764705,16,16,CTTGTACTGAAGGAGGACCT,0,1305648
furpa,0.058823529411764705,16,16,CTTCTGCGATTCACAATGAC,0,1311392
furpa,0.058823529411764705,16,16,CTGGCTCCAGAGTTCCTTGC,0,1346530
furpa,0.058823529411764705,16,16,CTGCGCGACTCGTGTTCACG,0,1283256
furpa,0.058823529411764705,16,16,CTGACTTTCATGGTACGGCA,0,1324631
furpa,0.058823529411764705,16,16,CTGACGATCCTGTTGCTGAA,0,1356065
furpa,0.058823529411764705,16,16,CTGAAAGGTATCTAATCCAT,0,1285689
furpa,0.058823529411764705,16,16,CTCAGAGTTGGGAGTGGCGT,0,1314674
furpa,0.058823529411764705,16,16,CGTTGTCACTACTAAAAGAT,0,1357004
furpa,0.058823529411764705,16,16,CGTTAAGTTAAAGGTAGAGC,0,1354149
furpa,0.058823529411764705,16,16,CGTGATGGTTTAGGTGTGAT,0,1349806
furpa,0.058823529411764705,16,16,CGTCCACCTTGGTCAATAGA,0,1307743
furpa,0.058823529411764705,16,16,CGTAGGAATATTTTCCGCGG,0,1287081
furpa,0.058823529411764705,16,16,CGTAAGGGAATTTGAGTGGA,0,1311195
furpa,0.058823529411764705,16,16,CGGTTGCACGGTATCATATA,0,1336472
furpa,0.058823529411764705,16,16,CGGGAGGCCGCTCCCGTACT,0,1285459
furpa,0.058823529411764705,16,16,CGATTGGGGTGTTCTCGAGA,0,1341930
furpa,0.058823529411764705,16,16,CGATTCACCAGTTTATGACG,0,1349184
furpa,0.058823529411764705,16,16,CGACTCTTAACATGCGATGC,0,1286207
furpa,0.058823529411764705,16,16,CGACTCGCCACCGATCCACC,0,1300273
furpa,0.058823529411764705,16,16,CGACGTTCTGTGGTAGCTAT,0,1339261
furpa,0.058823529411764705,16,16,CCTTACTTCCGCCCGGCACC,0,1326041
furpa,0.058823529411764705,16,16,CCTGGGAGACAGGAGAGTTA,0,1326024
furpa,0.058823529411764705,16,16,CCTCGCCTCCCACCAGCGTG,0,1274502
furpa,0.058823529411764705,16,16,CCTATCTGTTCCTCAGCCTG,0,1275919
furpa,0.058823529411764705,16,16,CCGGCCATCAAAGTATCGAA,0,1286827
furpa,0.058823529411764705,16,16,CCGCTTTTCTTCAACAATTA,0,1280299
furpa,0.058823529411764705,16,16,CCCCCTAGGGCTATGACGCA,0,1339981
furpa,0.058823529411764705,16,16,CCATTCATACAAATATAACA,0,1336594
furpa,0.058823529411764705,16,16,CCATCACCGCGCTATAGACC,0,1340765
furpa,0.058823529411764705,16,16,CCATAGGTATCGTGTAGACC,0,1302098
furpa,0.058823529411764705,16,16,CATAACGAGTCAGCATGCGA,0,1340116
furpa,0.058823529411764705,16,16,CATAAACGGGCTCTATTTCT,0,1299916
furpa,0.058823529411764705,16,16,CAGATGTGGCTTTTCGCACC,0,1337430
furpa,0.058823529411764705,16,16,CAGACCTCGGGAGCGAGTCA,0,1301785
furpa,0.058823529411764705,16,16,CACTGCGCAAACGCGTTCCC,0,1355632
furpa,0.058823529411764705,16,16,CACTACGAAGAGCGAGTCCA,0,1332166
furpa,0.058823529411764705,16,16,CACGCCGTTAAAGCGGCTTA,0,1287341
furpa,0.058823529411764705,16,16,CACCATTTTTAATGAGAAGC,0,1344197
furpa,0.058823529411764705,16,16,CAATTCAAACTTGACAGAAG,0,1298672
furpa,0.058823529411764705,16,16,CAATCAGATGTCGCTGCTGT,0,1276666
furpa,0.058823529411764705,16,16,CAATAAACCCGGCCCTGCAG,0,1281407
furpa,0.058823529411764705,16,16,CAAGCGCACGTGTAGTCCTC,0,1323030
furpa,0.058823529411764705,16,16,ATTTTACCGGGTAATCTAGT,0,1301841
furpa,0.058823529411764705,16,16,ATTTGGGAAATAATTCTCCG,0,1341373
furpa,0.058823529411764705,16,16,ATTTCGATTCACGCATTTGA,0,1306059
furpa,0.058823529411764705,16,16,ATGTCGGGGGGGCAATGGCC,0,1301627
furpa,0.058823529411764705,16,16,ATGGGACTGTGTCTACCTGG,0,1271817
furpa,0.058823529411764705,16,16,ATGGCATACAATAGACCCAC,0,1308006
furpa,0.058823529411764705,16,16,ATGATGTAGCGGTAGGGGCT,0,1277255
furpa,0.058823529411764705,16,16,ATGACTTAACAAGTCAGATT,0,1349766
furpa,0.058823529411764705,16,16,ATCGTCATGACTGTATGCCG,0,1343294
furpa,0.058823529411764705,16,16,ATCGATCGCCTAAGGTAAGT,0,1278463
furpa,0.058823529411764705,16,16,ATCCGTAGTCAGGGGATCTA,0,1303504
furpa,0.058823529411764705,16,16,ATCCCGATTATCAGACCTAG,0,1298963
furpa,0.058823529411764705,16,16,ATAGGGCGCTTGTCTATCCA,0,1328226
furpa,0.058823529411764705,16,16,ATAGCACATGGCTTCGCCGG,0,1322376
furpa,0.058823529411764705,16,16,ATACCGGGGAGCCCGGGAAT,0,1281292
furpa,0.058823529411764705,16,16,ATAACACCGATGTTACTTTC,0,1348178
furpa,0.058823529411764705,16,16,ATAAAGGGGACAACTCGAAT,0,1289018
furpa,0.058823529411764705,16,16,AGTTTACACCGTAAAAACAT,0,1297568
furpa,0.058823529411764705,16,16,AGTTCCGTTCGAAAGGCCTA,0,1339883
furpa,0.058823529411764705,16,16,AGTCGGATGAACCGTCGTCG,0,1276368
furpa,0.058823529411764705,16,16,AGTCGCGGCGACCGCTGTTT,0,1315910
furpa,0.058823529411764705,16,16,AGGTGTTAACGACCTGCGGT,0,1338119
furpa,0.058823529411764705,16,16,AGGCCCCGATAGCAATCTAG,0,1288912
furpa,0.058823529411764705,16,16,AGCTACATCCAACCTACCAA,0,1292857
furpa,0.058823529411764705,16,16,AGCGAATGGTGTGGCTATAT,0,1301718
furpa,0.058823529411764705,16,16,AGCCGGCTGCTCGATATTCT,0,1318822
furpa,0.058823529411764705,16,16,AGCAACCTTGCCGGAATCAA,0,1328192
furpa,0.058823529411764705,16,16,AGAGTCCTTGTATACAGTTT,0,1285691
furpa,0.058823529411764705,16,16,AGAGAACTGCATTGCCGTGC,0,1355128
furpa,0.058823529411764705,16,16,AGACGGGGGGCAGTGCCTGA,0,1303401
furpa,0.058823529411764705,16,16,AGAACCAAATGGCGCTCTAT,0,1323135
furpa,0.058823529411764705,16,16,ACTTGCTACCTCGACCCTTA,0,1346438
furpa,0.058823529411764705,16,16,ACTTGATCAGAGTTCCGAGT,0,1317224
furpa,0.058823529411764705,16,16,ACTTATGCAATTGTCGGCTA,0,1348384
furpa,0.058823529411764705,16,16,ACTGTCCGCGCTTTCGAACA,0,1311006
furpa,0.058823529411764705,16,16,ACTCGAGTAAAGTTGGGCGG,0,1315428
furpa,0.058823529411764705,16,16,ACTCAGAACCGAGATGGTTA,0,1291180
furpa,0.058823529411764705,16,16,ACTCACGGTCGGGCTTTAGA,0,1349138
furpa,0.058823529411764705,16,16,ACGTCCTGTTTACTGGCTGT,0,1302434
furpa,0.058823529411764705,16,16,ACGGTGCGGATGCTTACAGT,0,1317326
furpa,0.058823529411764705,16,16,ACGGCTTCCAGATTTTCACT,0,1293255
furpa,0.058823529411764705,16,16,ACGCCTGGAACGACGCCCGG,0,1337874
furpa,0.058823529411764705,16,16,ACGCCTGAAGCCTTAGTTTT,0,1280749
furpa,0.058823529411764705,16,16,ACGCCAAATAAGCTGTAAAG,0,1273740
furpa,0.058823529411764705,16,16,ACGCAATTATAGTGTAGTCA,0,1342109
furpa,0.058823529411764705,16,16,ACCGTAGGCTTCGTAGTCTA,0,1321260
furpa,0.058823529411764705,16,16,ACCGCGCCAACATTGTGGAG,0,1332235
furpa,0.058823529411764705,16,16,ACCCAGCTCTGGGCGACGAA,0,1305109
furpa,0.058823529411764705,16,16,ACCATAAAAGCCCCACCCTG,0,1293496
furpa,0.058823529411764705,16,16,ACCACTGCAGTCAGCTCGAC,0,1299125
furpa,0.058823529411764705,16,16,ACCAATTGGGGTCGCTCAAG,0,1306664
furpa,0.058823529411764705,16,16,ACATGCCGCATCTTACGATC,0,1347974
furpa,0.058823529411764705,16,16,AATTTTTTCCCTTTTTTGCG,0,1290163
furpa,0.058823529411764705,16,16,AAGCCGCACACCTATCCAAC,0,1312078
furpa,0.058823529411764705,16,16,AAGACTGGACCTGCGTTTAG,0,1313166
furpa,0.058823529411764705,16,16,AACTGTCGGCAGGGGAGATA,0,1271543
furpa,0.058823529411764705,16,16,AAATAATGTGACGCACCTCG,0,1277345
furpa,0.058823529411764705,16,16,AAAGAAAGTGATAGATATTT,0,1297651
furpa,0.058823529411764705,16,16,AAACTTGATTAACTTGACGG,0,1292375
furpa,0.058823529411764705,16,16,AAACGGCGATAGCTCGCGGA,0,1352781
furpa,0.058823529411764705,16,16,AAACCCTTATTCTGCGTGAA,0,1292859
furpa,0.0625,15,15,TTTCGCCCCCCGGGCATTTG,0,1299182
furpa,0.0625,15,15,TTTCCGTACAGCACCTTTCA,0,1320538
furpa,0.0625,15,15,TTGTAGGGTTAGTCTTAAAG,0,1281416
furpa,0.0625,15,15,TTGGGCATTCTTTAGCGGGT,0,1332670
furpa,0.0625,15,15,TTGGAGCCGCGTCTCGATTA,0,1297512
furpa,0.0625,15,15,TTGATGGGCTTATTTTTCCC,0,1306061
furpa,0.0625,15,15,TTGACATGGCGCGGGGGATG,0,1289778
furpa,0.0625,15,15,TTGAAATCTAATGTAGAAGG,0,1279977
furpa,0.0625,15,15,TTCTCCCGGCGCAAGCTTCT,0,1329783
furpa,0.0625,15,15,TTCGTTCGTTTGACGAATCA,0,1326606
furpa,0.0625,15,15,TTCGCTGCGCTAGCCGATAC,0,1302944
furpa,0.0625,15,15,TTCCGAAAAACCCATAATAT,0,1343839
furpa,0.0625,15,15,TTCAGGTAATTCTAGGATTA,0,1325968
furpa,0.0625,15,15,TTATGCGACGTGGGACGAAA,0,1304301
furpa,0.0625,15,15,TTATAAATGATTGAGGTTTG,0,1346701
furpa,0.0625,15,15,TTAGTCCCCGAAAGCGTGTC,0,1308787
furpa,0.0625,15,15,TTACTGCTTGTGGTTTACGT,0,1312884
furpa,0.0625,15,15,TTACTAATAGTTTTGCGATC,0,1326496
furpa,0.0625,15,15,TTAACAATCAGTTCACCCAA,0,1332711
furpa,0.0625,15,15,TGTTCTATACCGTCGAGGCC,0,1272326
furpa,0.0625,15,15,TGTGTATATAGCACATGGGC,0,1339208
furpa,0.0625,15,15,TGTGGTCTTTATGGTTAATG,0,1297637
furpa,0.0625,15,15,TGTACTATGGTCGGCCTTAA,0,1301613
furpa,0.0625,15,15,TGGGGGTCTAGAACCCATAA,0,1344874
furpa,0.0625,15,15,TGGGCGACGACCTGCACGCG,0,1298583
furpa,0.0625,15,15,TGGGCAAGCATGCATTACTA,0,1325536
furpa,0.0625,15,15,TGGAACAATGCGTCCTGGAA,0,1352079
furpa,0.0625,15,15,TGCGGATTCTTTACACGACA,0,1279624
furpa,0.0625,15,15,TGATTGCCTCGAACCGATAG,0,1353523
furpa,0.0625,15,15,TGATTCGCATGTAAGGAAGT,0,1299995
furpa,0.0625,15,15,TGAGCCGTTAGTCAAAGACT,0,1302174
furpa,0.0625,15,15,TGACTGGCCAGCTCGAGCGA,0,1342157
furpa,0.0625,15,15,TGACTATTACGCAACCGGCA,0,1356933
furpa,0.0625,15,15,TCTTTGCCATGGGGCTGCTC,0,1321402
furpa,0.0625,15,15,TCTGGTAGATAAATTCATCA,0,1310665
furpa,0.0625,15,15,TCTGCGGAGTCCATCGGATG,0,1322569
furpa,0.0625,15,15,TCTGCCCGACAAAATCCAGA,0,1280377
furpa,0.0625,15,15,TCTCTCCTCGTTGATATCAG,0,1277567
furpa,0.0625,15,15,TCTCACGTGGATCAGTACCA,0,1329231
furpa,0.0625,15,15,TCGTAGCGGTATGTTCGCCA,0,1353500
furpa,0.0625,15,15,TCGGGACTTGTTAAGGTGTC,0,1334978
furpa,0.0625,15,15,TCGCGATGTATGAATGCGAT,0,1299770
furpa,0.0625,15,15,TCCTCCTGTGTGACGGCGAT,0,1300776
furpa,0.0625,15,15,TCCTCAACTTAAAATCGAGC,0,1348851
furpa,0.0625,15,15,TCCCGTGCCCGAAAAACCTT,0,1320584
furpa,0.0625,15,15,TCCCCCTCTCAGTGCCGTAG,0,1324504
furpa,0.0625,15,15,TCATTACATATGCAGTGGAT,0,1272115
furpa,0.0625,15,15,TCATAGGCCTCACCGCGAGC,0,1275810
furpa,0.0625,15,15,TCATACTACGCTGAAGTCCT,0,1337595
furpa,0.0625,15,15,TCAGTCTTTGTTTCCAGTTT,0,1294792
furpa,0.0625,15,15,TCAGTAGCGAAAGCCCCATT,0,1303624
furpa,0.0625,15,15,TCAGGTTAGTAGTCCAGTAC,0,1309417
furpa,0.0625,15,15,TCACGTTGTACAGTGGTGGA,0,1285593
furpa,0.0625,15,15,TCAAGTCCGCTCGTTGGAAT,0,1295480
furpa,0.0625,15,15,TATCCTCGGGGAGTGGTACA,0,1331402
furpa,0.0625,15,15,TATCCCTTACGTGGTCCTCC,0,1334604
furpa,0.0625,15,15,TATATAATCTCGAAGCAGGC,0,1284311
furpa,0.0625,15,15,TAGTTAGCACTCTCCGAATA,0,1340643
furpa,0.0625,15,15,TAGGGAGGGTTAGTCAAATT,0,1291457
furpa,0.0625,15,15,TAGGCCCCACCGCAGCGGGA,0,1297047
furpa,0.0625,15,15,TACTTTCGAAGTATGGCTAG,0,1338226
furpa,0.0625,15,15,TACTCATCAAACACGAGCGG,0,1300109
furpa,0.0625,15,15,TACGTACGTACTCGGATAAG,0,1328074
furpa,0.0625,15,15,TACGCCCGAGATCGCCAGTA,0,1286876
furpa,0.0625,15,15,TACACATAGGGACGTTGTAG,0,1277103
furpa,0.0625,15,15,TAAGCGAGTCAGCCCCCCAT,0,1290792
furpa,0.0625,15,15,TAAGCCCTAATGCACATTAT,0,1342467
furpa,0.0625,15,15,TAACATAACCAGCGCTAGCT,0,1313241
furpa,0.0625,15,15,TAAAGGGCTAAGAGCTACAG,0,1314280
furpa,0.0625,15,15,TAAACAACCCGGCATCATCT,0,1346344
furpa,0.0625,15,15,GTTGTACACCAGAACGGTGT,0,1283717
furpa,0.0625,15,15,GTTCGGCTCCAAAAAGCCGG,0,1310540
furpa,0.0625,15,15,GTTACTTGTACATAGTCGCA,0,1338437
furpa,0.0625,15,15,GTTACGGCAGCTCTGAGATC,0,1272653
furpa,0.0625,15,15,GTTAAGGGGAATAGATCCAA,0,1285351
furpa,0.0625,15,15,GTGTCTCTGGTAAAATTTAT,0,1311810
furpa,0.0625,15,15,GTGTCAGACCAAACACAAAG,0,1289496
furpa,0.0625,15,15,GTGCGCGTCCTGTGAGAGTG,0,1329895
furpa,0.0625,15,15,GTGAGGTGGCTCTGTCGTAA,0,1332930
furpa,0.0625,15,15,GTCTGTCGTACATACCATCC,0,1318279
furpa,0.0625,15,15,GTCGGTGTCTCACCAGCAGG,0,1324712
furpa,0.0625,15,15,GTCCCACAAGTGTGTTTGCA,0,1303937
furpa,0.0625,15,15,GTCCAGTTAGGTAGCCATCA,0,1326330
furpa,0.0625,15,15,GTCAGAAAGCATCACATGTC,0,1310241
furpa,0.0625,15,15,GTCACGGCCTGGCGCGTCAT,0,1303021
furpa,0.0625,15,15,GTATTTACCGTCCTCAAATC,0,1315856
furpa,0.0625,15,15,GTATGGCAAAGCCACAAAGA,0,1309860
furpa,0.0625,15,15,GTATCAGGTGGAAACCTGTG,0,1304594
furpa,0.0625,15,15,GTATAAGCACCGAAGCTGTT,0,1291089
furpa,0.0625,15,15,GTAGAGCGGAATTGGGTATC,0,1287756
furpa,0.0625,15,15,GTAATAAAAGCTCTCCCGAG,0,1337091
furpa,0.0625,15,15,GGTTCTTCGTCGAAGACAGC,0,1340177
furpa,0.0625,15,15,GGTTCGCCCGTCTATTCCCC,0,1326908
furpa,0.0625,15,15,GGTGTAATGTGATTGAGAAC,0,1353385
furpa,0.0625,15,15,GGTAACCGAGACCCTTTGAA,0,1311933
furpa,0.0625,15,15,GGGTCGTCCCTGTACACTGA,0,1343513
furpa,0.0625,15,15,GGGGGCAAATTTGAAAAGGT,0,1334821
furpa,0.0625,15,15,GGGAGGCTGACTCTGGTCTA,0,1313892
furpa,0.0625,15,15,GGCCTGACCTAAACTGAATA,0,1309272
furpa,0.0625,15,15,GGCAGGGCGAGCATACAATT,0,1314322
furpa,0.0625,15,15,GGATAGTAGAGAAATGGATT,0,1304263
furpa,0.0625,15,15,GGACGTGACCGTTTTGTAGT,0,1276614
furpa,0.0625,15,15,GGAATCTTGAGGAGGAGTGA,0,1341623
furpa,0.0625,15,15,GCTGGAGACCATGTCGGTAA,0,1289251
furpa,0.0625,15,15,GCTACTTGCTGCTTGTCGGT,0,1284785
furpa,0.0625,15,15,GCGTGTGAAGGGTGGCCTAT,0,1295791
furpa,0.0625,15,15,GCGGTTATATTCATTTTGAG,0,1328828
furpa,0.0625,15,15,GCGGTTACGGAATCCATGCG,0,1339792
furpa,0.0625,15,15,GCGGGCAAGTTTTGTCTATA,0,1339740
furpa,0.0625,15,15,GCGCCACATCCATAGGCAGA,0,1304434
furpa,0.0625,15,15,GCGAAGCCGGTCCCGCGACC,0,1290672
furpa,0.0625,15,15,GCGAACGCTGCGACAGGTCG,0,1351653
furpa,0.0625,15,15,GCCTTCCACCATAATAACGG,0,1281586
furpa,0.0625,15,15,GCCTGAATATTCAGGCAGTT,0,1323169
furpa,0.0625,15,15,GCCAAGCAGCGCATCTTAAT,0,1306491
furpa,0.0625,15,15,GCATCAAAGGGTTTAGTGTC,0,1314542
furpa,0.0625,15,15,GCAGCCATATTGTACCTACC,0,1289600
furpa,0.0625,15,15,GCACAGATCGATTGATACAG,0,1357617
furpa,0.0625,15,15,GATTAGGCTCTCTGGGTTCC,0,1309111
furpa,0.0625,15,15,GATGTTTATGAAATACTCAT,0,1301378
furpa,0.0625,15,15,GATATGCGGCTTCTTTCTAC,0,1352320
furpa,0.0625,15,15,GATACTCTCGAGGTTTCGGA,0,1306456
furpa,0.0625,15,15,GATACGGATGTGTAGGAGGT,0,1272649
furpa,0.0625,15,15,GAGGACAGCAACAAGGGTTA,0,1326358
furpa,0.0625,15,15,GAGCGTAAGGCAATCCACTT,0,1321092
furpa,0.0625,15,15,GAGCGGCAGCCGTAGAAAAC,0,1291942
furpa,0.0625,15,15,GAGACCGCTGGGAGCAAAGT,0,1303873
furpa,0.0625,15,15,GACGGACTGGAGGGAGCTGA,0,1285833
furpa,0.0625,15,15,GACGCTGGTATATCATGTGC,0,1294569
furpa,0.0625,15,15,GACCGTCACCCAGCGGATTT,0,1289498
furpa,0.0625,15,15,GAAGAAGGCTTGGTAGCATA,0,1280393
furpa,0.0625,15,15,GAAATTCACAGACGATAATC,0,1352475
furpa,0.0625,15,15,GAAAGAGTGAAACCGTCCAT,0,1332319
furpa,0.0625,15,15,CTTTTTCTAATCACGACAGG,0,1352129
furpa,0.0625,15,15,CTTTCTGCCAGTCTACTGAA,0,1334729
furpa,0.0625,15,15,CTTGCCTGGCCATAACTATT,0,1346337
furpa,0.0625,15,15,CTTCGGTTCGTGGATATCTC,0,1356708
furpa,0.0625,15,15,CTCTTTGATGTGGGAAACTT,0,1342713
furpa,0.0625,15,15,CTCTCACTTGCACGCCACGT,0,1309945
furpa,0.0625,15,15,CTCGTACGTAAACGCGCTTA,0,1302392
furpa,0.0625,15,15,CTCGCTTGGAGAGTTGCTCG,0,1298145
furpa,0.0625,15,15,CTCGCGTAGTATTAGAAAAC,0,1297973
furpa,0.0625,15,15,CTATGCGCCTATTCGTGTAC,0,1325156
furpa,0.0625,15,15,CGTCCTTGTGATGGTGCCTA,0,1275156
furpa,0.0625,15,15,CGTCCCCACATCCTGACATA,0,1309740
furpa,0.0625,15,15,CGTAGCGCTTGGCTATTCCC,0,1334468
furpa,0.0625,15,15,CGGTTCAGAGGGGTCACCCG,0,1278263
furpa,0.0625,15,15,CGGTCTCAGGAGTTCATGGC,0,1352405
furpa,0.0625,15,15,CGGGGAAAGCCGCGTCCTGG,0,1286869
furpa,0.0625,15,15,CGGGATGATTGGTCGCCCAT,0,1298153
furpa,0.0625,15,15,CGGCTTGGGCGTTGCAGATC,0,1283225
furpa,0.0625,15,15,CGGCTTAGAATTTCTACTGG,0,1320501
furpa,0.0625,15,15,CGGCGTAGACAAAACTTGTC,0,1337286
furpa,0.0625,15,15,CGGAGGGATTCCTCGTGTTT,0,1344620
furpa,0.0625,15,15,CGGACGTGAAGTGGGATCAG,0,1302726
furpa,0.0625,15,15,CGCTGTACTCCAAAGCGCAG,0,1310789
furpa,0.0625,15,15,CGCTGGTGTACCGACGCGTG,0,1296743
furpa,0.0625,15,15,CGCTGGATACGGGTAGGCAA,0,1308716
furpa,0.0625,15,15,CGCGGAATCTCTTATCGCCA,0,1287305
furpa,0.0625,15,15,CGCCGATACAGCACGCATCA,0,1294265
furpa,0.0625,15,15,CGCCCCGGCCGCCGAGCATA,0,1311642
furpa,0.0625,15,15,CGATTAGGTTGTTGTCTTCA,0,1320328
furpa,0.0625,15,15,CGATTACATGGTCCAGGGGT,0,1299945
furpa,0.0625,15,15,CGAGGCTCGAACCTTAGGAC,0,1298029
furpa,0.0625,15,15,CGAGGAGGCCTGAAGTTGGG,0,1349813
furpa,0.0625,15,15,CGACGGCTTTATGCACCGCC,0,1298857
furpa,0.0625,15,15,CGACGCCTCTGAAGGCGCGC,0,1312077
furpa,0.0625,15,15,CGAAATCGGAGGTCCGCGAC,0,1305244
furpa,0.0625,15,15,CCTGATTGAAGATGCTCGTA,0,1272323
furpa,0.0625,15,15,CCTCTACCGTTTTGAGAATA,0,1289375
furpa,0.0625,15,15,CCGTTCTCTCTTAACGGGTG,0,1311005
furpa,0.0625,15,15,CCGTGGCAGATCCACACTTG,0,1302627
furpa,0.0625,15,15,CCGACCCCGGAGGCGGCCTC,0,1287072
furpa,0.0625,15,15,CCCTTGAGGATTAAGTCTGG,0,1272121
furpa,0.0625,15,15,CCCTTGAACCATGTGGGGAA,0,1298334
furpa,0.0625,15,15,CCCGTGGGGAATACTTGAAC,0,1318965
furpa,0.0625,15,15,CCCGTGCATGGCCACATCAC,0,1347057
furpa,0.0625,15,15,CCCGGGATATACAAGCCTAC,0,1312892
furpa,0.0625,15,15,CCCCTGGTGCTACGGCACTG,0,1352557
furpa,0.0625,15,15,CCCCGACATTATAAGCAGTA,0,1274931
furpa,0.0625,15,15,CCCCATAACCGGGAGATTGA,0,1346524
furpa,0.0625,15,15,CCAATTTCCTACCCTGAAAC,0,1306323
furpa,0.0625,15,15,CATTGTTGACGACAGAAGTC,0,1294697
furpa,0.0625,15,15,CATTGCGTCAAGGTTTTTCA,0,1347663
furpa,0.0625,15,15,CATGCATGCAATCATTTGAT,0,1353652
furpa,0.0625,15,15,CATCACTCGTCACCGTGCTC,0,1307780
furpa,0.0625,15,15,CATCACGGCATCCTTTAATA,0,1283779
furpa,0.0625,15,15,CATAGGGACATTCGAATGAA,0,1296854
furpa,0.0625,15,15,CATAGAGACAATGGCACAAA,0,1338183
furpa,0.0625,15,15,CAGTCCGTTGCTTTCGTTTC,0,1319982
furpa,0.0625,15,15,CAGGCCAGGTTATTGACTCA,0,1279248
furpa,0.0625,15,15,CAGCCCTGCCTGAGCACGAC,0,1331266
furpa,0.0625,15,15,CAGCCCTCATTTACTTCGAG,0,1300685
furpa,0.0625,15,15,CAGAGTAAAGGGCTCCAGTG,0,1348309
furpa,0.0625,15,15,CAGACAAAACGCGCACGGGG,0,1334596
furpa,0.0625,15,15,CACGGCTAAGGTATCTATTT,0,1320659
furpa,0.0625,15,15,CACCATTCGTCGAACATTTA,0,1275442
furpa,0.0625,15,15,CAAGTAGCGGTCATACTGGG,0,1286036
furpa,0.0625,15,15,CAAGCCACAAGTTGGAGTTT,0,1316137
furpa,0.0625,15,15,ATGGTGGGACCGAGATAATA,0,1357750
furpa,0.0625,15,15,ATGGAGATAGGACCATGACA,0,1273656
furpa,0.0625,15,15,ATGCTGATTGCAATGTTTCG,0,1304286
furpa,0.0625,15,15,ATGAGCGTTGGAGGCTGGAT,0,1340446
furpa,0.0625,15,15,ATCTCGTGGGGTGACCGTCG,0,1295460
furpa,0.0625,15,15,ATCTAGCTCCTGCGGTAACT,0,1339562
furpa,0.0625,15,15,ATCGCCCCGGAACGGTGGCG,0,1322685
furpa,0.0625,15,15,ATCGATCCGACGAACGGTCT,0,1329011
furpa,0.0625,15,15,ATCCGACAGGCATAGTGTAG,0,1339868
furpa,0.0625,15,15,ATCAGCAAAATGAGCGGACT,0,1272472
furpa,0.0625,15,15,ATCAGATGGCGATTTTAGAT,0,1274945
furpa,0.0625,15,15,ATAGTATCCAAGGAATTGGC,0,1342820
furpa,0.0625,15,15,ATAATATTCGCCTTTGGGCG,0,1338756
furpa,0.0625,15,15,AGTTTTAGAAAATATGCTTG,0,1287665
furpa,0.0625,15,15,AGTTGTTGAAATACCGTCAT,0,1328509
furpa,0.0625,15,15,AGTCACTGGAACGTGTACCA,0,1351744
furpa,0.0625,15,15,AGTATATCACGGTGCTATAG,0,1336451
furpa,0.0625,15,15,AGTACGCGAATAGGTTGTTC,0,1277029
furpa,0.0625,15,15,AGTAAACTCCAGCTCTGGAG,0,1335410
furpa,0.0625,15,15,AGGTGCCTCTTCAAGTCCCG,0,1302815
furpa,0.0625,15,15,AGGTATGAGCGGAACTGTTG,0,1319280
furpa,0.0625,15,15,AGGATTACGCTAGCCCGAGT,0,1289614
furpa,0.0625,15,15,AGCTTCTGGGTATTGTTGGA,0,1298970
furpa,0.0625,15,15,AGCCTAGGTTTGCTCATAAG,0,1287807
furpa,0.0625,15,15,AGCCCAGCAGCAGAAGAAGC,0,1272157
furpa,0.0625,15,15,AGCCACACTCATGCATAGGG,0,1356921
furpa,0.0625,15,15,AGCAGGGACCAAGAGAACTG,0,1329542
furpa,0.0625,15,15,AGCACGTAGCTGTCCAGAAT,0,1322305
furpa,0.0625,15,15,AGATTACTCTAGGTACGCTT,0,1304673
furpa,0.0625,15,15,AGAACGCCCGACGGCATCAG,0,1290274
furpa,0.0625,15,15,ACTTTGGGAAGCAATGTTAA,0,1316322
furpa,0.0625,15,15,ACTCGTAGGATCGGGATCGA,0,1305899
furpa,0.0625,15,15,ACTCGGGACAAACGACACTT,0,1347262
furpa,0.0625,15,15,ACTCAAAATGTGCAGCCCTA,0,1318734
furpa,0.0625,15,15,ACCCTCCACTATTTAGCTAT,0,1299650
furpa,0.0625,15,15,ACCCCTACACTGTGTAAGAC,0,1330968
furpa,0.0625,15,15,ACCCACTCACATAGAGTCTT,0,1315714
furpa,0.0625,15,15,ACCATCTTCCGCCCGGCGAC,0,1324503
furpa,0.0625,15,15,ACAATGCATTTCGCCTCGGT,0,1318067
furpa,0.0625,15,15,AATTGCCGTTCGATCTGAGT,0,1324942
furpa,0.0625,15,15,AATTATCTGGAGACGGCCCG,0,1327971
furpa,0.0625,15,15,AATGATACATCAACAGTTAT,0,1300110
furpa,0.0625,15,15,AATCTGTCGGGCCTCTGACG,0,1348777
furpa,0.0625,15,15,AATAGTCACCCACGGTGATA,0,1329729
furpa,0.0625,15,15,AATAAGTGAAAGGCTCTGGA,0,1286695
furpa,0.0625,15,15,AATAAGCGCCTTGAAGAAAG,0,1272100
furpa,0.0625,15,15,AATAACAGATTTGCAATCAT,0,1348326
furpa,0.0625,15,15,AAGCTCCAGCAAGTTTTGAC,0,1335275
furpa,0.0625,15,15,AACTCCGTGCAAGGCCAGGT,0,1339309
furpa,0.0625,15,15,AACGCTGTACTCAGCGTGTG,0,1287359
furpa,0.0625,15,15,AACACCTGATCTAAGACGTC,0,1289774
furpa,0.0625,15,15,AAAGTCCTTGGACGAACTGC,0,1350750
furpa,0.0625,15,15,AAACCCGTAAGCACCTGGCC,0,1290687
furpa,0.06666666666666667,14,14,TTTTGCGGACCTACAAGGCT,0,1314915
furpa,0.06666666666666667,14,14,TTTCTAAGGAGTACACTAAA,0,1345724
furpa,0.06666666666666667,14,14,TTTCCATCGTTGGGGTCAAG,0,1323230
furpa,0.06666666666666667,14,14,TTTATGAAAGAGTCGTGCGA,0,1352611
furpa,0.06666666666666667,14,14,TTTATCTCGAGACTATAGAT,0,1290768
furpa,0.06666666666666667,14,14,TTGTTGACGGCAAGGTGGGA,0,1308078
furpa,0.06666666666666667,14,14,TTGGATGACCACTTCCAAGC,0,1333320
furpa,0.06666666666666667,14,14,TTGGAACGTACCTAGGTGTT,0,1338938
furpa,0.06666666666666667,14,14,TTCCTTATTAACAGGCTAAG,0,1338981
furpa,0.06666666666666667,14,14,TTCCTCACAGCACTGTCAAT,0,1342106
furpa,0.06666666666666667,14,14,TTCCGAACATGTACTTTTAA,0,1334160
furpa,0.06666666666666667,14,14,TTATTCTCTTTAGTCCCGGA,0,1286052
furpa,0.06666666666666667,14,14,TTAACACGTCGGTATCGGGA,0,1300436
furpa,0.06666666666666667,14,14,TGTTTGTACCAGGTGAAACC,0,1312831
furpa,0.06666666666666667,14,14,TGTTGAATGGTCATACACAG,0,1331222
furpa,0.06666666666666667,14,14,TGTTCAGGGCGCCTTGTCAT,0,1330517
furpa,0.06666666666666667,14,14,TGTGTGGAGCTCTACAAGTA,0,1318347
furpa,0.06666666666666667,14,14,TGTCCTGGTCTCAGACGATT,0,1328616
furpa,0.06666666666666667,14,14,TGTCCCGAGTTGGGTTCGGC,0,1301488
furpa,0.06666666666666667,14,14,TGTATATAATAGACGCTTGT,0,1290402
furpa,0.06666666666666667,14,14,TGGTTACTGAGGCTACGAGT,0,1342955
furpa,0.06666666666666667,14,14,TGGTATAGCAATTATGCGAC,0,1299632
furpa,0.06666666666666667,14,14,TGGATGTGGTGGTACAACGT,0,1318458
furpa,0.06666666666666667,14,14,TGGAATCCTCGTTATGCAAG,0,1331399
furpa,0.06666666666666667,14,14,TGCGGGTTGCGTAACACCAA,0,1300780
furpa,0.06666666666666667,14,14,TGCGCACACTAATCGGCGGG,0,1319351
furpa,0.06666666666666667,14,14,TGCCTGCCCCGTTAAGGAGT,0,1320529
furpa,0.06666666666666667,14,14,TGCCGCGGTGCAACCTAAAT,0,1303968
furpa,0.06666666666666667,14,14,TGATCTGTTACGTTAAAAGG,0,1325527
furpa,0.06666666666666667,14,14,TGAGGTCCAAAGAGACCCGT,0,1298865
furpa,0.06666666666666667,14,14,TGAGACGTGTCTGAAGAGAA,0,1306916
furpa,0.06666666666666667,14,14,TGACGTGAGCCTACGGCTCT,0,1332716
furpa,0.06666666666666667,14,14,TGACCTGAGCAAGTCTGCCT,0,1354569
furpa,0.06666666666666667,14,14,TGACCCGTGGGAGACGTTTT,0,1350966
furpa,0.06666666666666667,14,14,TGAAGGGACTTGGTTGTAGG,0,1295352
furpa,0.06666666666666667,14,14,TCTTTACGACCCCGCTGTGT,0,1274459
furpa,0.06666666666666667,14,14,TCTCGGAGTTCAGGTATGTG,0,1279169
furpa,0.06666666666666667,14,14,TCTCCCCGCCTCTTACCATC,0,1324816
furpa,0.06666666666666667,14,14,TCTCATCAGAAGCCAGGGAG,0,1300594
furpa,0.06666666666666667,14,14,TCTACCATGCAATAGCCATG,0,1313466
furpa,0.06666666666666667,14,14,TCGGTGCCTTTTGCAAGCTT,0,1280748
furpa,0.06666666666666667,14,14,TCGGGGTACTTGCGACGATC,0,1274142
furpa,0.06666666666666667,14,14,TCGGCAGAAGACTGAAAGAA,0,1310238
furpa,0.06666666666666667,14,14,TCGCGCTGGTCACAGATTTA,0,1287161
furpa,0.06666666666666667,14,14,TCCTTTTCTAACAGGTATGG,0,1284024
furpa,0.06666666666666667,14,14,TCCTAAAGCCCTCTAAGTCT,0,1274871
furpa,0.06666666666666667,14,14,TCCCACGTCCTCTGATAGAT,0,1344066
furpa,0.06666666666666667,14,14,TCCATGCTTCTAACCTAGAC,0,1347254
furpa,0.06666666666666667,14,14,TCATTTAGTAGACCCAAAGG,0,1318820
furpa,0.06666666666666667,14,14,TCATTAGCAATGAGACCTGT,0,1336242
furpa,0.06666666666666667,14,14,TCAGCTGGGTGTAGGATTAG,0,1281793
furpa,0.06666666666666667,14,14,TCAGAGGAGCATACCGTTCC,0,1299951
furpa,0.06666666666666667,14,14,TCACTGGACCGCGGACGAAA,0,1326819
furpa,0.06666666666666667,14,14,TCACACGCCGTTTGGGAGTG,0,1280671
furpa,0.06666666666666667,14,14,TATTTTTTCGAAGTCTCATA,0,1331632
furpa,0.06666666666666667,14,14,TATTAATCAATCAGCTACAT,0,1301272
furpa,0.06666666666666667,14,14,TATAACATGGAACAGCGCAT,0,1324635
furpa,0.06666666666666667,14,14,TAGGTTTACGGGGGAATGAT,0,1331923
furpa,0.06666666666666667,14,14,TAGGCGAGCATCCGTGTAAC,0,1289732
furpa,0.06666666666666667,14,14,TAGGATAGGGTGTCCGATGA,0,1308353
furpa,0.06666666666666667,14,14,TAGAGTCGGGGTGGTGAAGG,0,1277485
furpa,0.06666666666666667,14,14,TAGAATTTTGTAGTGTTTCA,0,1274464
furpa,0.06666666666666667,14,14,TACACCCGCAATGGCGCAAG,0,1282217
furpa,0.06666666666666667,14,14,TACAAGGCGAATTATGATCA,0,1301514
furpa,0.06666666666666667,14,14,TAATTCATTATAAGTCCTAG,0,1282750
furpa,0.06666666666666667,14,14,TAATGCTGTCAGTTAGGAAC,0,1318362
furpa,0.06666666666666667,14,14,TAACCTCTAAGGGACTAACA,0,1323272
furpa,0.06666666666666667,14,14,TAAAATTATTGCGTCGAATG,0,1321578
furpa,0.06666666666666667,14,14,GTTTCGGCTGAACATTAGAC,0,1278855
furpa,0.06666666666666667,14,14,GTTGATGTCAGCCCCATCAT,0,1294278
furpa,0.06666666666666667,14,14,GTTCATGGCATCGATAAAAG,0,1284624
furpa,0.06666666666666667,14,14,GTTACACGGCAAGCGCCGTA,0,1323889
furpa,0.06666666666666667,14,14,GTGTAGCGCAACTTAACGAA,0,1313889
furpa,0.06666666666666667,14,14,GTGGAGATAAATGCTTGCAA,0,1293505
furpa,0.06666666666666667,14,14,GTGCCGTGGCTTTTTTCATG,0,1271632
furpa,0.06666666666666667,14,14,GTGAGTTTACCAGTACAGTG,0,1284709
furpa,0.06666666666666667,14,14,GTGACATTCGGTAGTTTGGA,0,1278208
furpa,0.06666666666666667,14,14,GTGAATAAGGCTTGACGGGT,0,1339412
furpa,0.06666666666666667,14,14,GTCGTGCAAACGTGTGTTTT,0,1288751
furpa,0.06666666666666667,14,14,GTCGGTTCTGCTCAAACGCA,0,1283714
furpa,0.06666666666666667,14,14,GTCCCGATGGTACGATTAAC,0,1343567
furpa,0.06666666666666667,14,14,GTAGGTTGCTATCGGGAGAG,0,1335507
furpa,0.06666666666666667,14,14,GTACCTAGAACTGGCCTATC,0,1326373
furpa,0.06666666666666667,14,14,GTAATGTTATACAGCGTGGT,0,1323304
furpa,0.06666666666666667,14,14,GGTTTGGAACGTTTACCCCT,0,1271577
furpa,0.06666666666666667,14,14,GGTGAGGACATAATCGGTGA,0,1281337
furpa,0.06666666666666667,14,14,GGTCCCTTAGGCAATCCAAC,0,1332525
furpa,0.06666666666666667,14,14,GGTCAATGCCTAGGACGCTT,0,1322809
furpa,0.06666666666666667,14,14,GGTAATTTCAGGACCAACCG,0,1339255
furpa,0.06666666666666667,14,14,GGGTGAGTAGAGAGAAAATC,0,1301678
furpa,0.06666666666666667,14,14,GGGTCAGTGGCCCGCTTCTT,0,1304662
furpa,0.06666666666666667,14,14,GGGTAGGGCCACCCCGGGGC,0,1275913
furpa,0.06666666666666667,14,14,GGGGTTCCGGCATATGTCTC,0,1280504
furpa,0.06666666666666667,14,14,GGGGCTTTTAAGGTTTCGGG,0,1312334
furpa,0.06666666666666667,14,14,GGCTATGAGGGTCGTGTACT,0,1332312
furpa,0.06666666666666667,14,14,GGCGGGTTACGCAGTTTCCC,0,1323539
furpa,0.06666666666666667,14,14,GGCGGGGAAAGCTTCAAGTA,0,1278759
furpa,0.06666666666666667,14,14,GGCCCTACAACGGGAGTAGT,0,1284872
furpa,0.06666666666666667,14,14,GGAGACGCACCAAAAGGTGA,0,1331975
furpa,0.06666666666666667,14,14,GGACCACGGTTCTCGACCAG,0,1301626
furpa,0.06666666666666667,14,14,GGAATAATTAGGGGGCCTCA,0,1312820
furpa,0.06666666666666667,14,14,GGAACTGGGTCCAGGTTACG,0,1307293
furpa,0.06666666666666667,14,14,GGAAATACGTAGACCCGGAC,0,1313881
furpa,0.06666666666666667,14,14,GCTTGGTACCACGTGCTGGG,0,1280000
furpa,0.06666666666666667,14,14,GCTTCTCGGGGCCACTTGTT,0,1273041
furpa,0.06666666666666667,14,14,GCTTAAGCTGTACCACACAC,0,1291884
furpa,0.06666666666666667,14,14,GCTGCCCCAACTATATTATC,0,1338040
furpa,0.06666666666666667,14,14,GCTCTGGATAGTTCGAATGC,0,1299733
furpa,0.06666666666666667,14,14,GCTCCGGGCTGTCGGTAAGT,0,1332561
furpa,0.06666666666666667,14,14,GCTAAGTGACGGGGTAATAA,0,1300478
furpa,0.06666666666666667,14,14,GCGTCTGCGCTCGTGACCTC,0,1357359
furpa,0.06666666666666667,14,14,GCGTATATCAAAAGGTTCTG,0,1331880
furpa,0.06666666666666667,14,14,GCGCATCCCGTCGGCCGACT,0,1340451
furpa,0.06666666666666667,14,14,GCGCAGGCGCCGACCTGCAC,0,1343242
furpa,0.06666666666666667,14,14,GCGAGGCTAACTGACAGTAA,0,1338208
furpa,0.06666666666666667,14,14,GCCTCCGTTATAAGTAGGGT,0,1347581
furpa,0.06666666666666667,14,14,GCCGAATACGTGCTTCAAGC,0,1275652
furpa,0.06666666666666667,14,14,GCCCACGAATATAGAATTCA,0,1282116
furpa,0.06666666666666667,14,14,GCCATAGGTTATTGCTCAAA,0,1303932
furpa,0.06666666666666667,14,14,GCCAGTTGAAGTTATGGTAG,0,1319774
furpa,0.06666666666666667,14,14,GCATTAGTGTATCTAAGCTG,0,1346948
furpa,0.06666666666666667,14,14,GCATGAGACCGAGAGGAGAG,0,1299907
furpa,0.06666666666666667,14,14,GCATCGCGACCTGTCCAGCA,0,1305262
furpa,0.06666666666666667,14,14,GCAGGGTGTCCCGTGCATTT,0,1331642
furpa,0.06666666666666667,14,14,GCACGTGGGTAACTGGGAGT,0,1342734
furpa,0.06666666666666667,14,14,GCAATATTGGAATCAGCAAC,0,1324134
furpa,0.06666666666666667,14,14,GCAAAGTTTATGGCCTGTGA,0,1353038
furpa,0.06666666666666667,14,14,GATTAGACGTCTTATTTGTT,0,1278114
furpa,0.06666666666666667,14,14,GATGGTCTCCGGCGGTGACA,0,1355766
furpa,0.06666666666666667,14,14,GATGGCGGGGTTCCCTCGAT,0,1278493
furpa,0.06666666666666667,14,14,GATGATTAGAACTGTCAAAT,0,1276013
furpa,0.06666666666666667,14,14,GATCTGCATGCTGCGTCCTA,0,1335355
furpa,0.06666666666666667,14,14,GATCGGTGCTTCAGACCGTG,0,1302725
furpa,0.06666666666666667,14,14,GATCCTCGTTCTTCACTCAA,0,1340328
furpa,0.06666666666666667,14,14,GATCCGTAGAGGACATTGAC,0,1301515
furpa,0.06666666666666667,14,14,GAGACGGGGATGAGAAGTCT,0,1271648
furpa,0.06666666666666667,14,14,GACTTCAAGAATATGTGAAT,0,1332251
furpa,0.06666666666666667,14,14,GACACGCCAAACGTGGTAGG,0,1301612
furpa,0.06666666666666667,14,14,GAAGGGTATTAACGTGTCGG,0,1338888
furpa,0.06666666666666667,14,14,GAAGGGAACCACCTAGGTGT,0,1325222
furpa,0.06666666666666667,14,14,CTTGTACCGCGGGGTTATGT,0,1318753
furpa,0.06666666666666667,14,14,CTTGATACCGGGTGAGCGAC,0,1280434
furpa,0.06666666666666667,14,14,CTGTTTCTTGGAATTAAAAA,0,1326559
furpa,0.06666666666666667,14,14,CTGGTTATTCGGAACGGGAG,0,1275978
furpa,0.06666666666666667,14,14,CTGGGTACCTGAAAAAAGGT,0,1312633
furpa,0.06666666666666667,14,14,CTGCTTGGCATGGTACGGTC,0,1294009
furpa,0.06666666666666667,14,14,CTGCTAGCTAACCAGTGCCT,0,1273179
furpa,0.06666666666666667,14,14,CTGATGAGACCGGTTGGCGC,0,1280752
furpa,0.06666666666666667,14,14,CTGATCGGATGTGGGCGATT,0,1354975
furpa,0.06666666666666667,14,14,CTCTGGGAAGTGGCAGTTCA,0,1333807
furpa,0.06666666666666667,14,14,CTCTGGACACGAAAACGTAT,0,1334072
furpa,0.06666666666666667,14,14,CTAGCTTGTGAGCGCCGATG,0,1326737
furpa,0.06666666666666667,14,14,CTAGAGGGCTGTAGAACTCG,0,1336261
furpa,0.06666666666666667,14,14,CTAATTACCAGAACTTCAGT,0,1357087
furpa,0.06666666666666667,14,14,CTAATCACTCAGAATACTAA,0,1275783
furpa,0.06666666666666667,14,14,CGTTTGCCGTGGGGCAGGCT,0,1317510
furpa,0.06666666666666667,14,14,CGTTGGCACTTTTTCGCACT,0,1330897
furpa,0.06666666666666667,14,14,CGTTAACATAGTGTAATTAG,0,1300661
furpa,0.06666666666666667,14,14,CGTGGTTCTCATCCAAACCA,0,1279589
furpa,0.06666666666666667,14,14,CGTGGGGTTTTACGTGCAGT,0,1292586
furpa,0.06666666666666667,14,14,CGTGCCCAATCCCTGTGGAT,0,1338851
furpa,0.06666666666666667,14,14,CGTCTCGAGCCATCCGTAGT,0,1342046
furpa,0.06666666666666667,14,14,CGGTGAAGGAACCACTACGG,0,1276927
furpa,0.06666666666666667,14,14,CGGCAGCGAAAAAATGAGCT,0,1340523
furpa,0.06666666666666667,14,14,CGGAAGGCACTGTGGAAGAG,0,1338239
furpa,0.06666666666666667,14,14,CGCTGCATGGGATAGGTACC,0,1329089
furpa,0.06666666666666667,14,14,CGCGTGCCACACAGAACCAT,0,1274251
furpa,0.06666666666666667,14,14,CGCAGACGGAAGAGGCCGGG,0,1339043
furpa,0.06666666666666667,14,14,CGCACGACGCCGCCAAGGAC,0,1327673
furpa,0.06666666666666667,14,14,CGATGGTAAAGCGAAACGGA,0,1323015
furpa,0.06666666666666667,14,14,CGATCTGGGCTCAGGCGCCA,0,1348556
furpa,0.06666666666666667,14,14,CGATCCCCCACCGCGCCCAA,0,1345538
furpa,0.06666666666666667,14,14,CGAGTATTGTACAGGGATGA,0,1343789
furpa,0.06666666666666667,14,14,CGAGGTGCACCCGTCGGACA,0,1299386
furpa,0.06666666666666667,14,14,CGAGGTCCGAGGGGCTCGCT,0,1355883
furpa,0.06666666666666667,14,14,CGACCCCCGTCAATATATTA,0,1295375
furpa,0.06666666666666667,14,14,CGACAGCACCCCAAGTTTCT,0,1300292
furpa,0.06666666666666667,14,14,CGAAGTGCGATAATTTGGCG,0,1284902
furpa,0.06666666666666667,14,14,CCTTCCAACGCTAGACAAGG,0,1347429
furpa,0.06666666666666667,14,14,CCTGGACAGGATTAGGTTGA,0,1291552
furpa,0.06666666666666667,14,14,CCTACGGGCCACAATATGAA,0,1302263
furpa,0.06666666666666667,14,14,CCTACAGTTCTTGCAAGCAG,0,1300853
furpa,0.06666666666666667,14,14,CCGGTCACCTGAGAGTTTCC,0,1339482
furpa,0.06666666666666667,14,14,CCGGATGCGAGGTCCAGTAG,0,1331978
furpa,0.06666666666666667,14,14,CCGCTACCGGGGATACTGTT,0,1300796
furpa,0.06666666666666667,14,14,CCGCGCCTAATTTGTGAAGC,0,1321880
furpa,0.06666666666666667,14,14,CCCTTGTGCTATCCGTGTGG,0,1310685
furpa,0.06666666666666667,14,14,CCCGAAATGGCGAGTGTCCG,0,1318392
furpa,0.06666666666666667,14,14,CCCCCCGCCTCTATGTCTTC,0,1312758
furpa,0.06666666666666667,14,14,CCCATCTGGGTCAATCCGGC,0,1350211
furpa,0.06666666666666667,14,14,CCATGACAGCCTTCACATCA,0,1282944
furpa,0.06666666666666667,14,14,CCATCTGGTTCCTCTTTATC,0,1283908
furpa,0.06666666666666667,14,14,CCATCCCAGGTAGCAGGAAC,0,1319907
furpa,0.06666666666666667,14,14,CCAAGACGCGGGTAGTCTGC,0,1313887
furpa,0.06666666666666667,14,14,CATTCAGCGTGCTTATTCCG,0,1302093
furpa,0.06666666666666667,14,14,CATTACTCATCATTGACGTT,0,1309309
furpa,0.06666666666666667,14,14,CATGGCTCGACGATCATGCA,0,1327842
furpa,0.06666666666666667,14,14,CATGAAAGGTTCTTAGAAGC,0,1309118
furpa,0.06666666666666667,14,14,CATCCGGTACGATCTTCGTC,0,1290849
furpa,0.06666666666666667,14,14,CAGTTGAGTGAAAAGAGAAT,0,1299731
furpa,0.06666666666666667,14,14,CAGGGCCGATCCCTCCATCG,0,1330583
furpa,0.06666666666666667,14,14,CAGGGACGTCGAATGCCGAT,0,1336205
furpa,0.06666666666666667,14,14,CAGCCTTGGACTAACGCTGA,0,1339574
furpa,0.06666666666666667,14,14,CAGCCGCAATAAGCTTAGTG,0,1353655
furpa,0.06666666666666667,14,14,CACGGATCTAAGCGACGCGT,0,1322644
furpa,0.06666666666666667,14,14,CACATTTTATGCTCCCTCGG,0,1290203
furpa,0.06666666666666667,14,14,CACAGCTTTATTTCGGAAAA,0,1325632
furpa,0.06666666666666667,14,14,CAATAGGATTGCCGAGAGTG,0,1328154
furpa,0.06666666666666667,14,14,CAATACGTTACTGATAAATG,0,1304218
furpa,0.06666666666666667,14,14,CAACATGATCGGTGCGGTGT,0,1354304
furpa,0.06666666666666667,14,14,CAACAACGCCTCACGCCACG,0,1333989
furpa,0.06666666666666667,14,14,CAAACGACTTTAGAATCCTT,0,1309826
furpa,0.06666666666666667,14,14,ATTTTACAGAGGCGCGTGTA,0,1304282
furpa,0.06666666666666667,14,14,ATTTGGGTGCTTCCTATTTA,0,1344763
furpa,0.06666666666666667,14,14,ATTTCTTCGGGCCGACTCAA,0,1338445
furpa,0.06666666666666667,14,14,ATTGACACATCTCCTCTATA,0,1347419
furpa,0.06666666666666667,14,14,ATGTTACTGGGGTACACCGG,0,1353488
furpa,0.06666666666666667,14,14,ATGGGGGGTCAAGTGTCTTG,0,1308373
furpa,0.06666666666666667,14,14,ATCGGGGCATCCAATAGGAC,0,1331617
furpa,0.06666666666666667,14,14,ATCCGTGACTAGAGGACTCC,0,1314397
furpa,0.06666666666666667,14,14,ATCAGCTGAGCCTCGGACCG,0,1337305
furpa,0.06666666666666667,14,14,ATATTAGAAATTGCTAAATC,0,1271733
furpa,0.06666666666666667,14,14,ATATGTGCTTTTGACCGATG,0,1310878
furpa,0.06666666666666667,14,14,ATATAGTTAGCACTGGGCCT,0,1333323
furpa,0.06666666666666667,14,14,ATAGGCACAAGCACAATCGT,0,1344580
furpa,0.06666666666666667,14,14,ATACTCTCTAAGCTCAAGCC,0,1310636
furpa,0.06666666666666667,14,14,ATACTCTAAGACCTATACGT,0,1292483
furpa,0.06666666666666667,14,14,ATACGGAACTCTCGGAATCG,0,1290615
furpa,0.06666666666666667,14,14,ATACAAGAATTCTACGCAGT,0,1340827
furpa,0.06666666666666667,14,14,ATAAGGCCAGGGTCGGAAGT,0,1323542
furpa,0.06666666666666667,14,14,ATAACTTCACAGAAATGAGA,0,1293876
furpa,0.06666666666666667,14,14,AGTTTGCGCTTACACGAGCC,0,1308849
furpa,0.06666666666666667,14,14,AGTTCTAAAAATCACATCGC,0,1318114
furpa,0.06666666666666667,14,14,AGTCTGGTACCGCATACCAC,0,1351113
furpa,0.06666666666666667,14,14,AGGTACCTAACCACCCTCAA,0,1321265
furpa,0.06666666666666667,14,14,AGGGAGTTATCTAGGCCGCT,0,1278101
furpa,0.06666666666666667,14,14,AGGCTATACTAAAGTTATGG,0,1317115
furpa,0.06666666666666667,14,14,AGGCCTTCTACAACATGCTC,0,1350154
furpa,0.06666666666666667,14,14,AGGCCCATACCATAAGGGAA,0,1341510
furpa,0.06666666666666667,14,14,AGGATTACCCATGACTACGG,0,1334403
furpa,0.06666666666666667,14,14,AGGATGGTACTCCTGGATGT,0,1355755
furpa,0.06666666666666667,14,14,AGGACTTTTATTCGGCTGTA,0,1342665
furpa,0.06666666666666667,14,14,AGCTGCTACTGATTGCGACG,0,1284589
furpa,0.06666666666666667,14,14,AGCTCAGATTGGATCCGGGG,0,1323215
furpa,0.06666666666666667,14,14,AGCTACGGTTGCGTTGTAGT,0,1298479
furpa,0.06666666666666667,14,14,AGCGGATCTGTATCTTAGGT,0,1341889
furpa,0.06666666666666667,14,14,AGCATCCTACCCTAAGTGAA,0,1316320
furpa,0.06666666666666667,14,14,AGATGGCGCCTGTACTCCTC,0,1310788
furpa,0.06666666666666667,14,14,AGAGGACACAAGGCGTGGGA,0,1299767
furpa,0.06666666666666667,14,14,AGACGGAACTATCGTGCATT,0,1346381
furpa,0.06666666666666667,14,14,AGACCTGGACAAGGAAACCG,0,1300547
furpa,0.06666666666666667,14,14,AGACAAACACTTTCGGGTAT,0,1344964
furpa,0.06666666666666667,14,14,AGAAGCTCAACACGGCCGAA,0,1304314
furpa,0.06666666666666667,14,14,ACTTCAATTCACCATCAACC,0,1344221
furpa,0.06666666666666667,14,14,ACTATCAATCTCTGAACCCA,0,1289411
furpa,0.06666666666666667,14,14,ACGGTGTCGCACAGTGTAAT,0,1316458
furpa,0.06666666666666667,14,14,ACGGTCAGCAGAACTCACTA,0,1350092
furpa,0.06666666666666667,14,14,ACGACCTTCATCCATCAAGG,0,1308919
furpa,0.06666666666666667,14,14,ACGAATTGGTCAGATAATGC,0,1333886
furpa,0.06666666666666667,14,14,ACCTGTAGATTTGGGGCCAG,0,1317891
furpa,0.06666666666666667,14,14,ACCTCAAGGTGTAATCGCAG,0,1273685
furpa,0.06666666666666667,14,14,ACCGTCTCGCATGTTTCGTA,0,1288104
furpa,0.06666666666666667,14,14,ACCGGCAAAGTAGCACACTC,0,1297594
furpa,0.06666666666666667,14,14,ACCGAAGTGCCACAGAAAGA,0,1315093
furpa,0.06666666666666667,14,14,ACAGAGGTCAGGATGTAGTC,0,1312620
furpa,0.06666666666666667,14,14,ACAAAGCCCGCAGCTCCGCA,0,1348778
furpa,0.06666666666666667,14,14,AATTGCAAAACACTTATTGT,0,1319975
furpa,0.06666666666666667,14,14,AATGTACCCCGGCACCCGAA,0,1315171
furpa,0.06666666666666667,14,14,AATCGCTGGTTACGAGAAAG,0,1311700
furpa,0.06666666666666667,14,14,AATCCACCCTGAGTGGAATT,0,1356967
furpa,0.06666666666666667,14,14,AAGTCTTCGTCGGATGCCTA,0,1316982
furpa,0.06666666666666667,14,14,AAGGCGGATAGTCCGCTCCA,0,1308344
furpa,0.06666666666666667,14,14,AAGCGCTGCGGTAGGGGTAA,0,1314502
furpa,0.06666666666666667,14,14,AAGACCTTCGGGATTGCATT,0,1322818
furpa,0.06666666666666667,14,14,AACTCTAGAGGTTGATTCGA,0,1298675
furpa,0.06666666666666667,14,14,AACGATCATCGTAGGTCCGA,0,1290897
furpa,0.06666666666666667,14,14,AACAGGGACGTGTACGTATT,0,1347424
furpa,0.06666666666666667,14,14,AACACGGCTAGTCCTCTCAG,0,1309132
furpa,0.06666666666666667,14,14,AAATGAGCTATGCCTAGGCC,0,1274683
furpa,0.06666666666666667,14,14,AAAGGTTTATGCCCCGTGAG,0,1300165
furpa,0.06666666666666667,14,14,AAAGCCGCATCCGAGGGTAT,0,1336639
furpa,0.06666666666666667,14,14,AAAATCCCGGATCTGATACA,0,1307140
furpa,0.07142857142857142,13,13,TTTTGAGTGCGCCGTATCGA,0,1310670
furpa,0.07142857142857142,13,13,TTTTAGAACCCTCGTTCCGC,0,1304790
furpa,0.07142857142857142,13,13,TTTGCTCGGTGAAGGGTCTC,0,1283302
furpa,0.07142857142857142,13,13,TTTGCGTGATGACGCGCGAT,0,1295459
furpa,0.07142857142857142,13,13,TTTGCGTAAGAACCCAGAGC,0,1344455
furpa,0.07142857142857142,13,13,TTTGACGGGTGTGGAGGGCA,0,1282370
furpa,0.07142857142857142,13,13,TTTCCCGCAGTCGCTGGTTC,0,1338630
furpa,0.07142857142857142,13,13,TTTCAGGACAGGCGGCAGGG,0,1325302
furpa,0.07142857142857142,13,13,TTTACTGACAAAACTCGTAG,0,1318348
furpa,0.07142857142857142,13,13,TTTAAGTAACGGGTCACACC,0,1328075
furpa,0.07142857142857142,13,13,TTGTTGTGCCAGGATTATAA,0,1343776
furpa,0.07142857142857142,13,13,TTGTACTTTAGCATTTAAGG,0,1282965
furpa,0.07142857142857142,13,13,TTGGTGACTCCGCTGTTCAA,0,1345793
furpa,0.07142857142857142,13,13,TTGGGAAACGCCGAAGGGAT,0,1341935
furpa,0.07142857142857142,13,13,TTGGCGGTCCATACCATAAA,0,1279646
furpa,0.07142857142857142,13,13,TTGCTCTGAAAGTTGTGACT,0,1324311
furpa,0.07142857142857142,13,13,TTGCGCTTCAGCTTACTTCT,0,1356825
furpa,0.07142857142857142,13,13,TTGAGGTAAGAGACGACCAC,0,1286837
furpa,0.07142857142857142,13,13,TTCTGAAGGCTGTATAGCCC,0,1278655
furpa,0.07142857142857142,13,13,TTCGCCCCTCCGCAATTGAG,0,1346393
furpa,0.07142857142857142,13,13,TTCGACCTCAAGCCTATCGA,0,1337558
furpa,0.07142857142857142,13,13,TTCATACAGCGGCGTACCTG,0,1273019
furpa,0.07142857142857142,13,13,TTATCGACTTTTCCCGTAAT,0,1321508
furpa,0.07142857142857142,13,13,TTATATTAAAAGCAGCATTT,0,1335779
furpa,0.07142857142857142,13,13,TTAGGCGCCCTTGCCGCGTG,0,1352572
furpa,0.07142857142857142,13,13,TTAGCATATCTTCATTATCA,0,1273757
furpa,0.07142857142857142,13,13,TTAGCACAGTACGCACAAGG,0,1294335
furpa,0.07142857142857142,13,13,TTACGGTCCCGGACCAGGGA,0,1276924
furpa,0.07142857142857142,13,13,TTAAGGGCGGCAGGCCCTAG,0,1278775
furpa,0.07142857142857142,13,13,TGTTATGCCTTCAGTTTCGC,0,1335566
furpa,0.07142857142857142,13,13,TGTCACACTGTATCCAGTTC,0,1287003
furpa,0.07142857142857142,13,13,TGTACGGTATGCTATTCATG,0,1300662
furpa,0.07142857142857142,13,13,TGGTGTTTATGGGGCCTTCT,0,1282015
furpa,0.07142857142857142,13,13,TGGTCAATTAGCAGCGTTCC,0,1296253
furpa,0.07142857142857142,13,13,TGGTACGTGTCGCCAATGTC,0,1304318
furpa,0.07142857142857142,13,13,TGGCCCGAAAATATCAGACG,0,1357620
furpa,0.07142857142857142,13,13,TGGCCATTCGGTCGGCTGTG,0,1293448
furpa,0.07142857142857142,13,13,TGGATGAGGCATAGAGATTT,0,1327771
furpa,0.07142857142857142,13,13,TGGATACGGATCCCAAGTGA,0,1278650
furpa,0.07142857142857142,13,13,TGGACTGACGGTGAGGCCCA,0,1277827
furpa,0.07142857142857142,13,13,TGCCTCCCGAACATAATGGA,0,1331349
furpa,0.07142857142857142,13,13,TGCCAGAAACCACTGAGATG,0,1309004
furpa,0.07142857142857142,13,13,TGATTTGCTTGGATTTGACA,0,1324058
furpa,0.07142857142857142,13,13,TGAGATATAACGCGAAAACC,0,1347069
furpa,0.07142857142857142,13,13,TGACACTTGCCTAGTCCAAG,0,1286024
furpa,0.07142857142857142,13,13,TCTTTACACTTTCATATTGC,0,1296914
furpa,0.07142857142857142,13,13,TCTGTCCATCATGAGTGGGA,0,1294626
furpa,0.07142857142857142,13,13,TCTGTAAGGCATTTGTCCCC,0,1288641
furpa,0.07142857142857142,13,13,TCTCCCTTTCAAATTCGTTC,0,1284007
furpa,0.07142857142857142,13,13,TCTCCCCTTGCACGCGACTA,0,1320424
furpa,0.07142857142857142,13,13,TCTCACCCGACAAAGCCCGC,0,1343919
furpa,0.07142857142857142,13,13,TCGGTGGATTATTACGCCCA,0,1326126
furpa,0.07142857142857142,13,13,TCGGGTCACTGCGGAAATCA,0,1337765
furpa,0.07142857142857142,13,13,TCGCCAGTCATCGCTTTAAC,0,1287539
furpa,0.07142857142857142,13,13,TCGAGGGAGGGATGTAGGTA,0,1301437
furpa,0.07142857142857142,13,13,TCCTAGAAGGCGTTAGTTGA,0,1294132
furpa,0.07142857142857142,13,13,TCCGTCCTACGTGGACCCGT,0,1328083
furpa,0.07142857142857142,13,13,TCCGGGTTGGGTGAGCCTCC,0,1347266
furpa,0.07142857142857142,13,13,TCCGCTTGTGATTTATGTGG,0,1320870
furpa,0.07142857142857142,13,13,TCCGAGGCCGACCACGTCAT,0,1300387
furpa,0.07142857142857142,13,13,TCCGACGTTATGCACGCAGT,0,1301786
furpa,0.07142857142857142,13,13,TCCCTTAGGGATCTTAGTGG,0,1271724
furpa,0.07142857142857142,13,13,TCCCACTAGCTTGTGCAGTA,0,1303731
furpa,0.07142857142857142,13,13,TCCCAATACGGGTATCGTGT,0,1332396
furpa,0.07142857142857142,13,13,TCCAGGGAGGCGTGAGCGCA,0,1287718
furpa,0.07142857142857142,13,13,TCCAGAACTGTCCAACGATG,0,1276447
furpa,0.07142857142857142,13,13,TCAGTACCAAAGACCATTAC,0,1346549
furpa,0.07142857142857142,13,13,TCACTGACCGCAGCAGCGCC,0,1324893
furpa,0.07142857142857142,13,13,TCACCTCTACTTAGTGATAT,0,1327731
furpa,0.07142857142857142,13,13,TCAAATGCGACCAAGGGTAT,0,1337428
furpa,0.07142857142857142,13,13,TATGTGCTATACTTGTCTTT,0,1317086
furpa,0.07142857142857142,13,13,TATCCCTACCTTGGGGTTGA,0,1289367
furpa,0.07142857142857142,13,13,TATCAGTATTAATGCCAGAT,0,1282380
furpa,0.07142857142857142,13,13,TATAGTTACTTTGGTTCGTT,0,1301005
furpa,0.07142857142857142,13,13,TATACGACTATAGCTATAAG,0,1337973
furpa,0.07142857142857142,13,13,TAGGGGGGAAACCCCGGGAT,0,1274583
furpa,0.07142857142857142,13,13,TAGCGCGATTCTGGTGATCT,0,1313244
furpa,0.07142857142857142,13,13,TAGATCGACGCGTACTTCAG,0,1318285
furpa,0.07142857142857142,13,13,TAGACTACGGAACACAAGTA,0,1351197
furpa,0.07142857142857142,13,13,TACTGTCTCGAAGCCTCGAT,0,1342933
furpa,0.07142857142857142,13,13,TACTGGGCCGCAACAATCTA,0,1275790
furpa,0.07142857142857142,13,13,TACGGAGATTGAGGGAATAC,0,1283778
furpa,0.07142857142857142,13,13,TACGACCAGAATTGACAAGT,0,1346697
furpa,0.07142857142857142,13,13,TACGAATGCATTCTAGAGTT,0,1327867
furpa,0.07142857142857142,13,13,TACGAAAAGCAGTGGAGTCC,0,1294398
furpa,0.07142857142857142,13,13,TACCGTTTCTTGCGGCATGT,0,1342637
furpa,0.07142857142857142,13,13,TACCACTTGCCTGAAAGATT,0,1350889
furpa,0.07142857142857142,13,13,TACACGCTTCATTGCGATAT,0,1278758
furpa,0.07142857142857142,13,13,TACACCCGCGGAATGACTTC,0,1343042
furpa,0.07142857142857142,13,13,TAATCGTACGCGCACATTTA,0,1273513
furpa,0.07142857142857142,13,13,TAAGACTCTGTGATGTTTCA,0,1340179
furpa,0.07142857142857142,13,13,TAACGTTATCGGATACGGAT,0,1277990
furpa,0.07142857142857142,13,13,TAACACGTCCGTCAGGGGAT,0,1319551
furpa,0.07142857142857142,13,13,GTTTTGCCCCCGGGGGGATC,0,1293981
furpa,0.07142857142857142,13,13,GTTTTATTACCACACACCGA,0,1299636
furpa,0.07142857142857142,13,13,GTTTACGGAGAGGAGGTAGC,0,1278632
furpa,0.07142857142857142,13,13,GTTGGGCGCGCAACTCTCGA,0,1307985
furpa,0.07142857142857142,13,13,GTTCTCTCTGGCACCGACCG,0,1346858
furpa,0.07142857142857142,13,13,GTTAGTACCGCCATGATCTC,0,1306371
furpa,0.07142857142857142,13,13,GTTAGCCGGTATACAAATGT,0,1281675
furpa,0.07142857142857142,13,13,GTTAATGCACTAAGACGAGA,0,1337698
furpa,0.07142857142857142,13,13,GTTAAACATGAATAAGCCAC,0,1348407
furpa,0.07142857142857142,13,13,GTGTGGGTCACTACGCACTC,0,1356590
furpa,0.07142857142857142,13,13,GTGTCTGACAGCTCACCTGA,0,1340662
furpa,0.07142857142857142,13,13,GTGGGTGCTCTCCTTCGCAT,0,1316321
furpa,0.07142857142857142,13,13,GTGCCGAGCTGCTTTATGCT,0,1282315
furpa,0.07142857142857142,13,13,GTGCCACGATTCCCGGTTTA,0,1329062
furpa,0.07142857142857142,13,13,GTGATATGATCTCTCCGCAT,0,1324222
furpa,0.07142857142857142,13,13,GTGAGAAGATACATTAAAAT,0,1308482
furpa,0.07142857142857142,13,13,GTGAAGTGTTCACCCCCGCG,0,1345071
furpa,0.07142857142857142,13,13,GTCTCCCAGGTCTGTCCGCT,0,1342934
furpa,0.07142857142857142,13,13,GTCGTAAGGCACAGGTGGCC,0,1321751
furpa,0.07142857142857142,13,13,GTCGATACCCAGCATCGTAG,0,1300998
furpa,0.07142857142857142,13,13,GTCCGGCATTACCGCGTGCT,0,1339990
furpa,0.07142857142857142,13,13,GTCCGAGGATAGAACTCTCA,0,1314698
furpa,0.07142857142857142,13,13,GTCCACAATGGGACGTTATT,0,1318228
furpa,0.07142857142857142,13,13,GTCATAATAGGTCGGGCGAA,0,1350332
furpa,0.07142857142857142,13,13,GTCAACTACCTCTACCAGCC,0,1277857
furpa,0.07142857142857142,13,13,GTAGTATATGGGATGGGGGT,0,1285169
furpa,0.07142857142857142,13,13,GGTTTAGTGCACTGAACCGG,0,1326810
furpa,0.07142857142857142,13,13,GGTTGCTAGAACAAATTTAA,0,1346904
furpa,0.07142857142857142,13,13,GGTCGTTTAGGCCAGCTATC,0,1317095
furpa,0.07142857142857142,13,13,GGGCGCTACACAGTGTTGGT,0,1278057
furpa,0.07142857142857142,13,13,GGGCCGTTCTGGCTAGGAAG,0,1307372
furpa,0.07142857142857142,13,13,GGGATTATAGGAGTTCGCAA,0,1301845
furpa,0.07142857142857142,13,13,GGGATCCCATGCGAAGGTCT,0,1304794
furpa,0.07142857142857142,13,13,GGCGAATGTACTTCGGTGGA,0,1332602
furpa,0.07142857142857142,13,13,GGCCACTACAAGAACGAGAT,0,1343053
furpa,0.07142857142857142,13,13,GGCATACCCGTAAGATGTGA,0,1323368
furpa,0.07142857142857142,13,13,GGCAGTATTCTGTCATGAGG,0,1282606
furpa,0.07142857142857142,13,13,GGCACCCTGAGCACATTGTC,0,1318229
furpa,0.07142857142857142,13,13,GGCAATAGTTTCATGTCCCG,0,1321398
furpa,0.07142857142857142,13,13,GGATTACTACACGGTTCGCT,0,1333226
furpa,0.07142857142857142,13,13,GGATACCACTGGGAAGTTGA,0,1304212
furpa,0.07142857142857142,13,13,GGATAAGTTTCCCAGACGGC,0,1303376
furpa,0.07142857142857142,13,13,GGAGCTAACATCGGTTTTGG,0,1341636
furpa,0.07142857142857142,13,13,GGACGCACCTGCGGCTTGAA,0,1328588
furpa,0.07142857142857142,13,13,GGAAGCGAAGGGTTATGACG,0,1324690
furpa,0.07142857142857142,13,13,GGAACCTTAGCATTGGGCGC,0,1307660
furpa,0.07142857142857142,13,13,GCTTTAGCTGGTCCCCGGGG,0,1312283
furpa,0.07142857142857142,13,13,GCTCGTTAGCGGCCCGTTTA,0,1354390
furpa,0.07142857142857142,13,13,GCTAGCTATCGTCCGAGCTA,0,1277409
furpa,0.07142857142857142,13,13,GCTAATTCAGCTGGTGTGAC,0,1327969
furpa,0.07142857142857142,13,13,GCGGGTAAGGAATCGGGGAA,0,1284363
furpa,0.07142857142857142,13,13,GCCTAGAGTACGACCGACAG,0,1299876
furpa,0.07142857142857142,13,13,GCCTACGCAGGCGGATGCTT,0,1342699
furpa,0.07142857142857142,13,13,GCCGGACTAGCGTATTTGCG,0,1291079
furpa,0.07142857142857142,13,13,GCCATATCGGGAGGTTTGGG,0,1302786
furpa,0.07142857142857142,13,13,GCCAGCGCGAGGGTTTATGT,0,1293198
furpa,0.07142857142857142,13,13,GCATTCCTGTGTTCTGTCTG,0,1300265
furpa,0.07142857142857142,13,13,GCATATCTTAGTCTACAAGG,0,1320507
furpa,0.07142857142857142,13,13,GCATAGCCTGATCTAGTAAC,0,1283790
furpa,0.07142857142857142,13,13,GCAGCAGTTCATACACGTAT,0,1274198
furpa,0.07142857142857142,13,13,GCAGACTGAACCTGAATGCA,0,1275012
furpa,0.07142857142857142,13,13,GCACGCGGTCTAACATCCCT,0,1284062
furpa,0.07142857142857142,13,13,GCACAGGCCCCGAACCTATC,0,1341410
furpa,0.07142857142857142,13,13,GCAAGATTGCTCGACCACCT,0,1310121
furpa,0.07142857142857142,13,13,GATTGTATGCGCTTTCATTG,0,1276972
furpa,0.07142857142857142,13,13,GATTACTACAGCGACCTCGG,0,1298801
furpa,0.07142857142857142,13,13,GATGGAACGAGTTTCACGCG,0,1347576
furpa,0.07142857142857142,13,13,GATGCTCAAGAGCCAACGAA,0,1345802
furpa,0.07142857142857142,13,13,GATGCTAAGTCTCGGAAAGT,0,1320327
furpa,0.07142857142857142,13,13,GATATTGGCCGGGGGTTCAG,0,1284879
furpa,0.07142857142857142,13,13,GATAGCTAGTAGCGCTCTCA,0,1316495
furpa,0.07142857142857142,13,13,GATACCGGGCTCATAAATCA,0,1283498
furpa,0.07142857142857142,13,13,GAGTCTCTGGTCATCGTAGT,0,1286910
furpa,0.07142857142857142,13,13,GAGGGCGATACAGCGGCATT,0,1289740
furpa,0.07142857142857142,13,13,GAGCGGTGTGGCTGAATTAA,0,1322911
furpa,0.07142857142857142,13,13,GAGCAGGTGAATTCAGTGCC,0,1307130
furpa,0.07142857142857142,13,13,GAGCAACGGTGCGTTTAGGG,0,1274442
furpa,0.07142857142857142,13,13,GAGATACAGAGTCGGTTCTA,0,1324762
furpa,0.07142857142857142,13,13,GAGAAGCGTCAAGAACGGAC,0,1332864
furpa,0.07142857142857142,13,13,GACTGGTAGCGCGCTCCGAT,0,1299523
furpa,0.07142857142857142,13,13,GACGTGGGATCCTTCAAGAC,0,1320384
furpa,0.07142857142857142,13,13,GACCATTCGCGATCCAGCGT,0,1298913
furpa,0.07142857142857142,13,13,GACAGGTTGCGTTAGAACGA,0,1349494
furpa,0.07142857142857142,13,13,GAAGGTAACTTTTTCAGGTT,0,1294224
furpa,0.07142857142857142,13,13,GAAGCACATTCTCTAAAGTT,0,1281180
furpa,0.07142857142857142,13,13,GAACGCACGTTTGAAGTGGT,0,1304838
furpa,0.07142857142857142,13,13,GAACCACCAGTTACGTGTCT,0,1277492
furpa,0.07142857142857142,13,13,GAAATTGCTCGTATCCCGGC,0,1342082
furpa,0.07142857142857142,13,13,CTTTGATCCATGTTTGCCGG,0,1333957
furpa,0.07142857142857142,13,13,CTTCGGTTTTGAGAAAAGCT,0,1343336
furpa,0.07142857142857142,13,13,CTTCCACAAGGCACTTTGCG,0,1291226
furpa,0.07142857142857142,13,13,CTGTTTCCGGCCTACCGTGC,0,1310985
furpa,0.07142857142857142,13,13,CTGTTCAAAACAGCATCATT,0,1281036
furpa,0.07142857142857142,13,13,CTGTTAATTTTGACAGCGGG,0,1339769
furpa,0.07142857142857142,13,13,CTGGTTTAGACATCATCGGC,0,1299283
furpa,0.07142857142857142,13,13,CTGGTTGATTTTCTGTTCTA,0,1330703
furpa,0.07142857142857142,13,13,CTGGATGGGCCAAGGAAACG,0,1349446
furpa,0.07142857142857142,13,13,CTGCAATCCATGCAGGTGGA,0,1354924
furpa,0.07142857142857142,13,13,CTCGTCCCAGTGAAACATAC,0,1350406
furpa,0.07142857142857142,13,13,CTCGTCACTTAAAACGGGCC,0,1276646
furpa,0.07142857142857142,13,13,CTATTATGTCGGTTGGATAA,0,1335737
furpa,0.07142857142857142,13,13,CTAGCCTACCGGGGATGTGC,0,1281664
furpa,0.07142857142857142,13,13,CTACCGATTCCGTCTAAGAT,0,1356472
furpa,0.07142857142857142,13,13,CTAAGGTGCACATCACTGGA,0,1344227
furpa,0.07142857142857142,13,13,CTAACTCACAACGGATGCCT,0,1320910
furpa,0.07142857142857142,13,13,CTAAAGGATAACTGGTCATA,0,1347084
furpa,0.07142857142857142,13,13,CGTTCCTCGGGCCTCTATGT,0,1322041
furpa,0.07142857142857142,13,13,CGTTACCTTTACTGATTGCC,0,1272970
furpa,0.07142857142857142,13,13,CGTGTCTTTTGGAGACAAAC,0,1322872
furpa,0.07142857142857142,13,13,CGTGCCCTAAGATCGGAGTA,0,1314588
furpa,0.07142857142857142,13,13,CGTGATCGTGGGGTCTCAAT,0,1273232
furpa,0.07142857142857142,13,13,CGTCACCGAAACTATGCCCA,0,1303535
furpa,0.07142857142857142,13,13,CGTATTCCACTAATGGTTGC,0,1292055
furpa,0.07142857142857142,13,13,CGGTCGTGCCAAGGTAGCAG,0,1295053
furpa,0.07142857142857142,13,13,CGGGTGGACATCGGGAAACA,0,1319714
furpa,0.07142857142857142,13,13,CGCTTTAAACCAGCTAGTCC,0,1337596
furpa,0.07142857142857142,13,13,CGCTAGCCCGGCGAGTACGA,0,1330125
furpa,0.07142857142857142,13,13,CGCTAAGCTAGTAGAGCTCA,0,1332695
furpa,0.07142857142857142,13,13,CGCCTTGGTAACAATGGACT,0,1339555
furpa,0.07142857142857142,13,13,CGCCGAAATTACGTGGAATT,0,1303996
furpa,0.07142857142857142,13,13,CGCACGCGTTTATTCCGCAT,0,1308113
furpa,0.07142857142857142,13,13,CGCAAGCATTCCGTAGTTGC,0,1274097
furpa,0.07142857142857142,13,13,CGCAACAACGTCACAGTCCT,0,1325240
furpa,0.07142857142857142,13,13,CGAGCGGCCTCCACCTTATG,0,1271179
furpa,0.07142857142857142,13,13,CGAGCGCAGTTTCCGGGGCT,0,1351819
furpa,0.07142857142857142,13,13,CGAGAACAGATACTTGTTCT,0,1288595
furpa,0.07142857142857142,13,13,CGACTCATGAAATAGCCCCT,0,1340062
furpa,0.07142857142857142,13,13,CGACCGGAGCTGTAGCAAGA,0,1316328
furpa,0.07142857142857142,13,13,CCTTTTAGAATATTGCGCGA,0,1273093
furpa,0.07142857142857142,13,13,CCTTGTGTCAGACAGACAAT,0,1343071
furpa,0.07142857142857142,13,13,CCTGGTTAAAGACAGGTTTT,0,1316402
furpa,0.07142857142857142,13,13,CCTGCGCCAGCGTACCCGAG,0,1308702
furpa,0.07142857142857142,13,13,CCTGAGTCCACCACTCGGAT,0,1298167
furpa,0.07142857142857142,13,13,CCTCGTCGGGGGAACGTGAT,0,1312745
furpa,0.07142857142857142,13,13,CCGTCTAGGCTTTCGATGGT,0,1294880
furpa,0.07142857142857142,13,13,CCGTCATCCTACGCAGTCTG,0,1343564
furpa,0.07142857142857142,13,13,CCGCTCGACCCCCGCTCAAA,0,1329554
furpa,0.07142857142857142,13,13,CCGCGATCATAGAGCCTGAA,0,1346736
furpa,0.07142857142857142,13,13,CCGCCGTTCGGACCTTCTGT,0,1329908
furpa,0.07142857142857142,13,13,CCGCCGTAACCGTGCCGTAA,0,1287803
furpa,0.07142857142857142,13,13,CCGAGATCAAGGGGCCTCAC,0,1315473
furpa,0.07142857142857142,13,13,CCGACTAATAAGGTAAGACT,0,1341691
furpa,0.07142857142857142,13,13,CCCTTTGTGCGGAAAAGGAA,0,1310986
furpa,0.07142857142857142,13,13,CCCGGCTCAGGTATTGCGTC,0,1308606
furpa,0.07142857142857142,13,13,CCCGGATTGTGATGCAGAGT,0,1275028
furpa,0.07142857142857142,13,13,CCCCTTAATACATACCCCCA,0,1309420
furpa,0.07142857142857142,13,13,CCCCGTTGGCAGCGTTGTAA,0,1281291
furpa,0.07142857142857142,13,13,CCCATTGTTTCGCGTAACCA,0,1339053
furpa,0.07142857142857142,13,13,CCCATGCGTCCCCTCGCTCA,0,1322737
furpa,0.07142857142857142,13,13,CCCACCACACCGAAGTTGAG,0,1329243
furpa,0.07142857142857142,13,13,CCCAAAGGCGAAGGATCGGG,0,1310334
furpa,0.07142857142857142,13,13,CCAGGTAAATGCAAATATGT,0,1324760
furpa,0.07142857142857142,13,13,CCAGCTATCATCGAATTGGG,0,1332911
furpa,0.07142857142857142,13,13,CCAGAAGGGCTACCCCATGA,0,1285555
furpa,0.07142857142857142,13,13,CCAATGGGGGTGTCAAAGTG,0,1355578
furpa,0.07142857142857142,13,13,CCAACTCCCTCACAAGATCC,0,1304332
furpa,0.07142857142857142,13,13,CCAACGGCCAACATTCATTC,0,1290887
furpa,0.07142857142857142,13,13,CCAAACAACGAGCATGATTA,0,1310911
furpa,0.07142857142857142,13,13,CATTTACTTATTATTCTAGC,0,1355200
furpa,0.07142857142857142,13,13,CATTGCGTTCTTTGGAGTAT,0,1318522
furpa,0.07142857142857142,13,13,CATTGATTATGCTCAAGGTC,0,1325418
furpa,0.07142857142857142,13,13,CATTCCTAACGCGTCTTGTG,0,1328469
furpa,0.07142857142857142,13,13,CATATTCAGCAGGCAATAAG,0,1314201
furpa,0.07142857142857142,13,13,CATAACCTGACACATTTTCG,0,1286965
furpa,0.07142857142857142,13,13,CAGTCCGTCACAACTGTAAG,0,1286821
furpa,0.07142857142857142,13,13,CAGTAGCCTGTTCTAATTGG,0,1327587
furpa,0.07142857142857142,13,13,CAGGCGGATCCGCGACAATA,0,1313448
furpa,0.07142857142857142,13,13,CAGGCCCTGTACCTGCATCC,0,1278010
furpa,0.07142857142857142,13,13,CAGGAGTTAGTACGTGTGAC,0,1350956
furpa,0.07142857142857142,13,13,CAGGAAAAGCTGCGCCACAG,0,1301499
furpa,0.07142857142857142,13,13,CAGCGGGCTGTGACTCTCGA,0,1353308
furpa,0.07142857142857142,13,13,CAGCCCATCCGACGGCTAAA,0,1276050
furpa,0.07142857142857142,13,13,CACTTTGGTTAAAGGTTCAT,0,1341407
furpa,0.07142857142857142,13,13,CACTGTCGTAATTTGCAGAA,0,1282455
furpa,0.07142857142857142,13,13,CACTAAACTCGCGTCTCGAC,0,1285120
furpa,0.07142857142857142,13,13,CACCAAAGTTCGTGCCGCGG,0,1322871
furpa,0.07142857142857142,13,13,CAATGTTTTGCCGAAAGAAT,0,1273298
furpa,0.07142857142857142,13,13,CAACGCTGGTTTGAGGTGAG,0,1305491
furpa,0.07142857142857142,13,13,CAACAGAGGTAGCATTCGCA,0,1345122
furpa,0.07142857142857142,13,13,CAAATTATTTTGGCACCTCA,0,1341532
furpa,0.07142857142857142,13,13,CAAATAGCGGGCGTTTGTTC,0,1315475
furpa,0.07142857142857142,13,13,CAAACTCCTAGTCCTGACAA,0,1276083
furpa,0.07142857142857142,13,13,CAAAAACTAACAACGTCCAC,0,1300795
furpa,0.07142857142857142,13,13,ATTTCTATCCTAGCGGAGTA,0,1324512
furpa,0.07142857142857142,13,13,ATTGTGAGGGGACAAAAGTC,0,1297714
furpa,0.07142857142857142,13,13,ATTGTCGTGCCAAGTTTGGA,0,1357474
furpa,0.07142857142857142,13,13,ATTGAATCGCCGCATCGCAT,0,1317890
furpa,0.07142857142857142,13,13,ATTCGTTTGGAACTACGAGC,0,1327040
furpa,0.07142857142857142,13,13,ATTCGTTGAGCGTAGGCGGG,0,1334781
furpa,0.07142857142857142,13,13,ATTAGCTTCAAGAGGATCAA,0,1301262
furpa,0.07142857142857142,13,13,ATGGGTATCATGGTCTTCGT,0,1351834
furpa,0.07142857142857142,13,13,ATGGGCTCTAACTCTCCCGG,0,1337526
furpa,0.07142857142857142,13,13,ATGATAAAGTAGGTCCTGCA,0,1322532
furpa,0.07142857142857142,13,13,ATGAGAACTACTGTAACAAT,0,1285171
furpa,0.07142857142857142,13,13,ATCTGGGGGCTTGCTCGCCT,0,1317244
furpa,0.07142857142857142,13,13,ATCCTTTAGACCGGGCGGAT,0,1306132
furpa,0.07142857142857142,13,13,ATCAGTGGCGTACTTGTTAT,0,1355297
furpa,0.07142857142857142,13,13,ATCAGTGCAAAATGGACCCA,0,1350478
furpa,0.07142857142857142,13,13,ATCACAGTCGAGCAGGCGAA,0,1342110
furpa,0.07142857142857142,13,13,ATATGTAAGACAAGTGTGAA,0,1275368
furpa,0.07142857142857142,13,13,ATATGATAAGGAATACGAGA,0,1300984
furpa,0.07142857142857142,13,13,ATACTCACGACCGCCCCTCG,0,1284599
furpa,0.07142857142857142,13,13,ATACCTATGGGTACTTATCC,0,1299912
furpa,0.07142857142857142,13,13,ATAAACTAACTGCCTAGATT,0,1285817
furpa,0.07142857142857142,13,13,AGTTTGATCATGCCACCCCC,0,1311376
furpa,0.07142857142857142,13,13,AGTCTAACGGGGCTCAGTCG,0,1351712
furpa,0.07142857142857142,13,13,AGTCATTACCCATTAGGGTG,0,1345626
furpa,0.07142857142857142,13,13,AGTACATCGCAAAGTCGTAG,0,1345609
furpa,0.07142857142857142,13,13,AGTAAGTGGACGCGTATCGG,0,1314978
furpa,0.07142857142857142,13,13,AGGGGGAAATGAAAGGAAGG,0,1315582
furpa,0.07142857142857142,13,13,AGGCGTGACCATTCCTGGGG,0,1332980
furpa,0.07142857142857142,13,13,AGGAGTCCTGCATTCAAATT,0,1333022
furpa,0.07142857142857142,13,13,AGCTAGTTCAGGTGCATAAA,0,1292539
furpa,0.07142857142857142,13,13,AGCGTCGGGTGCAGGCAGCA,0,1356649
furpa,0.07142857142857142,13,13,AGCGAAAAGATAACAGCCGG,0,1294259
furpa,0.07142857142857142,13,13,AGCCCGGGACTTCACGTCTC,0,1310279
furpa,0.07142857142857142,13,13,AGCACAAGTAAAACCTCGGG,0,1322811
furpa,0.07142857142857142,13,13,AGATGGCATTAGCGGGGGCA,0,1311270
furpa,0.07142857142857142,13,13,AGACTGATACTACTTAATTA,0,1349400
furpa,0.07142857142857142,13,13,AGACGTCCGTCCAGGCATAA,0,1328572
furpa,0.07142857142857142,13,13,AGACCCAATCTTAGTCAACA,0,1313169
furpa,0.07142857142857142,13,13,AGAAAGAGGTTCAGTTACCA,0,1314596
furpa,0.07142857142857142,13,13,ACTTGCACCAGTGGGAGGTA,0,1314501
furpa,0.07142857142857142,13,13,ACTTCCGTTGATCCATATAG,0,1277613
furpa,0.07142857142857142,13,13,ACTTAACGGTCTTCACGCTT,0,1291479
furpa,0.07142857142857142,13,13,ACTCGGAAGAGCCCGATATC,0,1349914
furpa,0.07142857142857142,13,13,ACTCGCGCGTCCGATTACAT,0,1299938
furpa,0.07142857142857142,13,13,ACTCACCGGCCCGGTGCGCA,0,1277454
furpa,0.07142857142857142,13,13,ACTAGATGCGTTCGTTGAAT,0,1321168
furpa,0.07142857142857142,13,13,ACTAGACCCCGTGGCGCCCG,0,1327764
furpa,0.07142857142857142,13,13,ACGTGATAACACAGGCACGC,0,1284333
furpa,0.07142857142857142,13,13,ACGTCTGGACGCTGTGCGAA,0,1299847
furpa,0.07142857142857142,13,13,ACGGGACAAAATGGTCACGG,0,1342272
furpa,0.07142857142857142,13,13,ACGGCATAGATCTCAAGGCA,0,1342458
furpa,0.07142857142857142,13,13,ACGGAGTTAAGATTCATCAA,0,1341905
furpa,0.07142857142857142,13,13,ACGGACTTGGTTTTAGTTTT,0,1348686
furpa,0.07142857142857142,13,13,ACGCCTAGTCTTGCAGAATA,0,1333750
furpa,0.07142857142857142,13,13,ACGCCATGCGTGGATATCCG,0,1312079
furpa,0.07142857142857142,13,13,ACGCCAGGTACATGGTTTTT,0,1356689
furpa,0.07142857142857142,13,13,ACGCATTCGTGACAAGGTCA,0,1292032
furpa,0.07142857142857142,13,13,ACGCAGAGTAACCGCTCTCA,0,1300650
furpa,0.07142857142857142,13,13,ACCGTCCAATGCGTAATCTG,0,1353264
furpa,0.07142857142857142,13,13,ACCCTGGCACCAGAAGAAAA,0,1294518
furpa,0.07142857142857142,13,13,ACCCTCGATGAAACATTGTG,0,1331153
furpa,0.07142857142857142,13,13,ACATTTCATAGTTATCGAAA,0,1311652
furpa,0.07142857142857142,13,13,ACATGTCATGATTCGTGAGG,0,1332455
furpa,0.07142857142857142,13,13,ACAGCATTGTGCTCGCTAAA,0,1276910
furpa,0.07142857142857142,13,13,ACAATTGAGGTTTATAGCAT,0,1309338
furpa,0.07142857142857142,13,13,AATGTTACGTGTCGTAGCTA,0,1278421
furpa,0.07142857142857142,13,13,AATGGGTTTAGCCGAGCGTA,0,1275585
furpa,0.07142857142857142,13,13,AATGGCTGTACTGGGACGAG,0,1312732
furpa,0.07142857142857142,13,13,AATAGTTAAGCCCGTCCTGT,0,1356111
furpa,0.07142857142857142,13,13,AAGTTCTTTATGTCTGTCGC,0,1337312
furpa,0.07142857142857142,13,13,AAGTGTACACTTTTAGTATC,0,1298157
furpa,0.07142857142857142,13,13,AAGTGCCGGGCGACCTCATT,0,1322801
furpa,0.07142857142857142,13,13,AAGTAAATAGGGCGTCCCAT,0,1330783
furpa,0.07142857142857142,13,13,AAGGTCGGTTCGATCGGAGG,0,1287071
furpa,0.07142857142857142,13,13,AAGGGCTTTTTGGCGTATGT,0,1339313
furpa,0.07142857142857142,13,13,AAGCCGGAACTGTATTGCCC,0,1345306
furpa,0.07142857142857142,13,13,AAGCCCGGTGGGGGCTCCCA,0,1293838
furpa,0.07142857142857142,13,13,AAGAGATCAGATTCACTCCT,0,1290621
furpa,0.07142857142857142,13,13,AACTGCCGCAAGTGTACTGC,0,1312281
furpa,0.07142857142857142,13,13,AACTCCTTTGACCCGTCGTG,0,1278435
furpa,0.07142857142857142,13,13,AACGGTACGTTTTATAGCGC,0,1290416
furpa,0.07142857142857142,13,13,AACGCCTTTGAGCCAGAGCA,0,1298437
furpa,0.07142857142857142,13,13,AACCCAAGACCGCGATGTTT,0,1306921
furpa,0.07142857142857142,13,13,AAAGTTGGTCTATGCTAATT,0,1333526
furpa,0.07142857142857142,13,13,AAAATGGAAACTTGCGTGTT,0,1305731
furpa,0.07142857142857142,13,13,AAAATCGGCCGTCCGACGAT,0,1335858
furpa,0.07692307692307693,12,12,TTTGGCATATTCGGGGACAA,0,1355963
furpa,0.07692307692307693,12,12,TTTGCAACTTCATGTAAAAA,0,1336960
furpa,0.07692307692307693,12,12,TTTGAGGATGGGGCAGACGA,0,1306853
furpa,0.07692307692307693,12,12,TTTGAGCGTGAAATGACGGG,0,1346443
furpa,0.07692307692307693,12,12,TTTCGCTTTACGAACATCGC,0,1356422
furpa,0.07692307692307693,12,12,TTTATGCATATTTATAAGCG,0,1333928
furpa,0.07692307692307693,12,12,TTTAGTCAAGAATTGGTAAA,0,1348602
furpa,0.07692307692307693,12,12,TTGTCACCGTGAGACTTGCC,0,1319430
furpa,0.07692307692307693,12,12,TTGGTTTAGGCACTGGACTG,0,1354697
furpa,0.07692307692307693,12,12,TTGGTTTAAGTCATGCCATG,0,1291617
furpa,0.07692307692307693,12,12,TTGGAGCTAGGACTCGCGCT,0,1346842
furpa,0.07692307692307693,12,12,TTGCGCGATTCCTCGATTAT,0,1306136
furpa,0.07692307692307693,12,12,TTGCAGTAGAATGACTCTCT,0,1309057
furpa,0.07692307692307693,12,12,TTGAGGGGGCATTAGTGCCG,0,1329669
furpa,0.07692307692307693,12,12,TTCTTCTGTGTCCTGTCGGA,0,1351892
furpa,0.07692307692307693,12,12,TTCTAGATAGGTGGGGTATA,0,1278933
furpa,0.07692307692307693,12,12,TTCGAGGTTTCATTAGGGGG,0,1276844
furpa,0.07692307692307693,12,12,TTAGTCGGTTGGAATGGCAA,0,1354380
furpa,0.07692307692307693,12,12,TTAGGGGGGGGCGCAAGGTG,0,1333297
furpa,0.07692307692307693,12,12,TTAGCTTTTAGAAAGGGAAA,0,1325514
furpa,0.07692307692307693,12,12,TTAGCACGCAGTCATTAGCA,0,1328456
furpa,0.07692307692307693,12,12,TTAGAAAGTATTTCGCAAGA,0,1341288
furpa,0.07692307692307693,12,12,TTAATGTCCGAAATGCGCCT,0,1314967
furpa,0.07692307692307693,12,12,TTAAGGCGAGTGAAGCGGAT,0,1288163
furpa,0.07692307692307693,12,12,TTAACGTGTTGAATAGTTAT,0,1298478
furpa,0.07692307692307693,12,12,TGTTTATCGCACGCGGGAAT,0,1353047
furpa,0.07692307692307693,12,12,TGTGTTAATAGCGCCTAATC,0,1347178
furpa,0.07692307692307693,12,12,TGTGTCGTAGCCATGGGTGT,0,1322521
furpa,0.07692307692307693,12,12,TGTGGCCGTATGCACAGGCA,0,1333542
furpa,0.07692307692307693,12,12,TGTGAGGGGAACTAGGTCGT,0,1322590
furpa,0.07692307692307693,12,12,TGTCTGCATTCCCCCGTACT,0,1314839
furpa,0.07692307692307693,12,12,TGTCGGTAACACATCAGGTG,0,1344974
furpa,0.07692307692307693,12,12,TGGTGGAAACACATATTTGC,0,1273025
furpa,0.07692307692307693,12,12,TGGTCTCAGGCACTACCATT,0,1293636
furpa,0.07692307692307693,12,12,TGGTCATGAGTTTGCTGAGA,0,1275801
furpa,0.07692307692307693,12,12,TGGGGGCAGCGATGTCTGCA,0,1322800
furpa,0.07692307692307693,12,12,TGGGATGGAGGACTGCGTCG,0,1297927
furpa,0.07692307692307693,12,12,TGGCTTCACGCACGATCTCT,0,1339447
furpa,0.07692307692307693,12,12,TGGCGGGCATAGGATCATTA,0,1325371
furpa,0.07692307692307693,12,12,TGGCAACTTGGCCGCCCTAG,0,1292383
furpa,0.07692307692307693,12,12,TGGCAAAGGTCTATTGGGTT,0,1303623
furpa,0.07692307692307693,12,12,TGGAGGTAACCGATCGGGCT,0,1311785
furpa,0.07692307692307693,12,12,TGGAGCTGTGGGCCTAGTAG,0,1347594
furpa,0.07692307692307693,12,12,TGGAAAAAATTAGTCAGACA,0,1340755
furpa,0.07692307692307693,12,12,TGCTCTGTTGACAAAAAGGA,0,1344249
furpa,0.07692307692307693,12,12,TGCGCTTGAGAAAGGTCTTA,0,1303618
furpa,0.07692307692307693,12,12,TGCCCACAGGGCTGAGTGAT,0,1279618
furpa,0.07692307692307693,12,12,TGATTTTAGCGATCGATCAT,0,1347366
furpa,0.07692307692307693,12,12,TGATTGCTGCTACTCGCAGC,0,1272750
furpa,0.07692307692307693,12,12,TGACAGAAAGACGCCTAGAA,0,1272668
furpa,0.07692307692307693,12,12,TGAATGGTACAAGTTCTGGA,0,1353027
furpa,0.07692307692307693,12,12,TGAAGCCGGTCCTTAGAATG,0,1323973
furpa,0.07692307692307693,12,12,TGAAGAGGCCGAGAAATTGC,0,1350683
furpa,0.07692307692307693,12,12,TGAACAGAATCGCCACGAGG,0,1339552
furpa,0.07692307692307693,12,12,TCTGTCGTTATCCCTCAGGT,0,1305461
furpa,0.07692307692307693,12,12,TCTGGACGACGCTGACAGAT,0,1338058
furpa,0.07692307692307693,12,12,TCTCCTAGGGCGTGGTCCCG,0,1337382
furpa,0.07692307692307693,12,12,TCTATCATGAGATCGGGTAG,0,1287879
furpa,0.07692307692307693,12,12,TCGGTTCCACTCTGCAAACT,0,1339317
furpa,0.07692307692307693,12,12,TCGCTTTGCACTAGAATTCC,0,1327847
furpa,0.07692307692307693,12,12,TCGATACTTCCAAATGACGG,0,1325379
furpa,0.07692307692307693,12,12,TCCGGTCGTTGGTTTGGAAT,0,1333632
furpa,0.07692307692307693,12,12,TCCCTGGCTACCGCTGCACG,0,1273375
furpa,0.07692307692307693,12,12,TCCCGCTGAGAATATGACTA,0,1328808
furpa,0.07692307692307693,12,12,TCCACGGAGGTCTTCCTGCT,0,1339685
furpa,0.07692307692307693,12,12,TCATGCCCACGCTCCCCATG,0,1320545
furpa,0.07692307692307693,12,12,TCAGATTGTGGCGCGTCTCA,0,1339198
furpa,0.07692307692307693,12,12,TCAGAGAAGAATCATGAATT,0,1274729
furpa,0.07692307692307693,12,12,TCACAAGGGAGTGTTGGGGA,0,1303668
furpa,0.07692307692307693,12,12,TCAAGATAGGCGTTTAACCC,0,1319102
furpa,0.07692307692307693,12,12,TATTGTTATCAGCTTTTTAC,0,1338948
furpa,0.07692307692307693,12,12,TATGAGCGGTCCTAAACAGG,0,1287601
furpa,0.07692307692307693,12,12,TATCTCGATATCGTATATGT,0,1325394
furpa,0.07692307692307693,12,12,TATCTAAACACGTCATTGCA,0,1336557
furpa,0.07692307692307693,12,12,TATCCACAAGAACGCTGCAA,0,1348304
furpa,0.07692307692307693,12,12,TATAGGTTCATATCAGGAAT,0,1277648
furpa,0.07692307692307693,12,12,TATACATATTAATACCCATG,0,1324725
furpa,0.07692307692307693,12,12,TAGGCCACTACTGGAATGCT,0,1283800
furpa,0.07692307692307693,12,12,TAGAGAAGCACCAATGAGCT,0,1330966
furpa,0.07692307692307693,12,12,TACTCGGGCGCCGCCGCAAG,0,1271196
furpa,0.07692307692307693,12,12,TACTAAGTCTGGCCATCCAA,0,1342150
furpa,0.07692307692307693,12,12,TACCTTGTGTTCAGCTGTGG,0,1311307
furpa,0.07692307692307693,12,12,TACCTTAGCCATAGTATATG,0,1276895
furpa,0.07692307692307693,12,12,TACCTCCGGTGGTTTAGCGG,0,1307132
furpa,0.07692307692307693,12,12,TACCCCTGAAAAAAGGTCTC,0,1344631
furpa,0.07692307692307693,12,12,TACATACCGTTTAGGAAGTC,0,1315849
furpa,0.07692307692307693,12,12,TAACAAGCCGTAACTCAAAA,0,1308730
furpa,0.07692307692307693,12,12,TAAATTGCATTGTGCTCAGC,0,1329615
furpa,0.07692307692307693,12,12,TAAAGTAGGTTTAGCGACCA,0,1302927
furpa,0.07692307692307693,12,12,TAAAAGATTGCACACGTGGT,0,1333279
furpa,0.07692307692307693,12,12,GTTTTCGACCTCGCCTCTGA,0,1299631
furpa,0.07692307692307693,12,12,GTTTGCGATTTCCCCGGGGG,0,1315771
furpa,0.07692307692307693,12,12,GTTTGCCAGAACCCTCCCTT,0,1352948
furpa,0.07692307692307693,12,12,GTTTATCTGCTTCACTTCTG,0,1326022
furpa,0.07692307692307693,12,12,GTTGTCGTACTCACGTTCGA,0,1275102
furpa,0.07692307692307693,12,12,GTTGTACCTCTAGCGTCGAA,0,1271499
furpa,0.07692307692307693,12,12,GTTACGTATGGTCGCCGTTT,0,1297026
furpa,0.07692307692307693,12,12,GTGTTGGCGAGTTTACATAG,0,1288737
furpa,0.07692307692307693,12,12,GTGTGTAGGCAGGGATAGAG,0,1327329
furpa,0.07692307692307693,12,12,GTGTCGGCTAGAGAGCTCGA,0,1280647
furpa,0.07692307692307693,12,12,GTGTCCCCACTCCGGTTACA,0,1325160
furpa,0.07692307692307693,12,12,GTGGGTTGAGGACGGGAAGA,0,1276612
furpa,0.07692307692307693,12,12,GTGGGATTTACTCCGCTCAA,0,1318262
furpa,0.07692307692307693,12,12,GTGGCGGACAGCCATTACCT,0,1355867
furpa,0.07692307692307693,12,12,GTGGCCGTGGCTAAGAATCA,0,1318278
furpa,0.07692307692307693,12,12,GTGCGGCGATAGGATTTCTC,0,1355362
furpa,0.07692307692307693,12,12,GTGCGCGACCAGGGATATCT,0,1344195
furpa,0.07692307692307693,12,12,GTGCGCAGGGCAGACGGTCT,0,1278928
furpa,0.07692307692307693,12,12,GTGATTGATTGCTTTCTTTG,0,1328724
furpa,0.07692307692307693,12,12,GTGACCTAAAAACGACGCCA,0,1302897
furpa,0.07692307692307693,12,12,GTGAATGCCTCCCCGTAATC,0,1299539
furpa,0.07692307692307693,12,12,GTCTGTTAGTTCTTCGCCAG,0,1300622
furpa,0.07692307692307693,12,12,GTCTAGGCTGTAAACGTCAG,0,1316862
furpa,0.07692307692307693,12,12,GTCTACTCCCAGCTGCGTCA,0,1325237
furpa,0.07692307692307693,12,12,GTCGTCAGATGATATTGTAC,0,1280908
furpa,0.07692307692307693,12,12,GTCCTCAACCGGCAATCTTC,0,1290856
furpa,0.07692307692307693,12,12,GTAGATTATCAGTTGTAACC,0,1320803
furpa,0.07692307692307693,12,12,GTACGAGCAGATATCTGAAA,0,1284669
furpa,0.07692307692307693,12,12,GTACCAAACGAGCTCCCGCT,0,1356865
furpa,0.07692307692307693,12,12,GTAATCTCGATCAACGGTAA,0,1300577
furpa,0.07692307692307693,12,12,GTAATAGTGCTAACGTGCGG,0,1344445
furpa,0.07692307692307693,12,12,GTAAGACTCGCTCAGGCCTG,0,1295467
furpa,0.07692307692307693,12,12,GTAAATCGGGGGGAGGTGCG,0,1277549
furpa,0.07692307692307693,12,12,GGTTTGTGATAATTAACTAT,0,1288717
furpa,0.07692307692307693,12,12,GGTTGGCTAATCCGGAAGTA,0,1281526
furpa,0.07692307692307693,12,12,GGTTAATACTGCGTCGTAGT,0,1336344
furpa,0.07692307692307693,12,12,GGTGTCGATGGGACACCCTT,0,1324615
furpa,0.07692307692307693,12,12,GGTGAGATTGGCGTATTAGC,0,1282567
furpa,0.07692307692307693,12,12,GGTCTCCGGGTGGGTCCTCC,0,1356890
furpa,0.07692307692307693,12,12,GGTCGTTATTACAAATTTCT,0,1306797
furpa,0.07692307692307693,12,12,GGTCATGCGTATATCGTGAA,0,1293389
furpa,0.07692307692307693,12,12,GGTATTTTTTGCCATGGGGG,0,1350769
furpa,0.07692307692307693,12,12,GGTACTCTCATCTGACGATG,0,1353903
furpa,0.07692307692307693,12,12,GGTACATAATCGGGCACAGG,0,1293771
furpa,0.07692307692307693,12,12,GGGGCTACTATAATTGGTTG,0,1271621
furpa,0.07692307692307693,12,12,GGGATATTGTGGTATCCCTA,0,1302284
furpa,0.07692307692307693,12,12,GGGATACTGGCCCACATAGC,0,1290512
furpa,0.07692307692307693,12,12,GGGAGGGTGCATCTTCATCA,0,1302371
furpa,0.07692307692307693,12,12,GGCTATAAATAGATTGGCGC,0,1273238
furpa,0.07692307692307693,12,12,GGCCGAGACAGGTCAGCGAA,0,1315822
furpa,0.07692307692307693,12,12,GGCATGATGTCCGTATCTAC,0,1336565
furpa,0.07692307692307693,12,12,GGCAATCTTCGCCGAAAACG,0,1323622
furpa,0.07692307692307693,12,12,GGCAAGCCAGAGGGAGCATT,0,1345658
furpa,0.07692307692307693,12,12,GGCAACGGAATCGCGACATC,0,1332190
furpa,0.07692307692307693,12,12,GGAGAATAGACGAAGCATGT,0,1320000
furpa,0.07692307692307693,12,12,GGAACGCGTTCTTATACTCA,0,1326040
furpa,0.07692307692307693,12,12,GGAAAAAAAGTATTCGCAAC,0,1296346
furpa,0.07692307692307693,12,12,GCTTGCTAAGTGTTTTCGCC,0,1351652
furpa,0.07692307692307693,12,12,GCTGCGCGCACCTGACCGCC,0,1301564
furpa,0.07692307692307693,12,12,GCTCTTTCTTCGCTTTGACT,0,1294052
furpa,0.07692307692307693,12,12,GCTCTTGAAAACATGGCCGT,0,1281273
furpa,0.07692307692307693,12,12,GCTCGACCAACGAGCTGGCT,0,1282513
furpa,0.07692307692307693,12,12,GCTCATTACTCCTTACTATT,0,1355956
furpa,0.07692307692307693,12,12,GCTCAAGAGACCCCTGGAAA,0,1357796
furpa,0.07692307692307693,12,12,GCTAGTCTACGGCACCTTTG,0,1292672
furpa,0.07692307692307693,12,12,GCGTTTCGCTATCGAAGATC,0,1282073
furpa,0.07692307692307693,12,12,GCGGCCGTTGATTTAGGTTT,0,1334246
furpa,0.07692307692307693,12,12,GCGGCAGACCGGTACCTTAT,0,1310900
furpa,0.07692307692307693,12,12,GCGCTTTTAATTTGGCGACT,0,1339625
furpa,0.07692307692307693,12,12,GCGCTCCATTCGGCCTTTGC,0,1355195
furpa,0.07692307692307693,12,12,GCGCCCTCACATTTGAACCC,0,1344444
furpa,0.07692307692307693,12,12,GCGATCAAGAAAAGCGGAGA,0,1346185
furpa,0.07692307692307693,12,12,GCGAAGACCACGGGGTGTCA,0,1332074
furpa,0.07692307692307693,12,12,GCCGTCGGGCAGTATCGGAG,0,1299139
furpa,0.07692307692307693,12,12,GCCGGGTGATTTACCGACGG,0,1310592
furpa,0.07692307692307693,12,12,GCCGCAGCTCTCCGGCACAA,0,1325441
furpa,0.07692307692307693,12,12,GCCGATGAACCCACTGCGTA,0,1282882
furpa,0.07692307692307693,12,12,GCCCTCGTTTTCAGTGCAAA,0,1289673
furpa,0.07692307692307693,12,12,GCCATCATGGTGAGAAGAGT,0,1296150
furpa,0.07692307692307693,12,12,GCATGTACGGCGGGGTTCAT,0,1328592
furpa,0.07692307692307693,12,12,GCATCCTAAATGTTATTGGC,0,1285693
furpa,0.07692307692307693,12,12,GCAGGGTGAGCGAGTTAGAA,0,1341189
furpa,0.07692307692307693,12,12,GCACGGACGTTCAAGAAATT,0,1296110
furpa,0.07692307692307693,12,12,GCACGCCGACCTAAGTGTGC,0,1345722
furpa,0.07692307692307693,12,12,GCAATGATGAGGCCCCGTGT,0,1323004
furpa,0.07692307692307693,12,12,GATTTTTCTAAAAAGCTAGC,0,1274677
furpa,0.07692307692307693,12,12,GATTACACAGGACCTCTTGC,0,1297041
furpa,0.07692307692307693,12,12,GATTAAGTTACACCCTGCAG,0,1289216
furpa,0.07692307692307693,12,12,GATGATCGAGGCGAGTTGCC,0,1291891
furpa,0.07692307692307693,12,12,GATCTACGAAGTCTTTGCTT,0,1328035
furpa,0.07692307692307693,12,12,GATCGCCTCACAAGCGCCAT,0,1340606
furpa,0.07692307692307693,12,12,GATCCTTTCGTATTTCCTCA,0,1293852
furpa,0.07692307692307693,12,12,GATCACCCCCACCGCTCGTC,0,1346954
furpa,0.07692307692307693,12,12,GATAACTGAGATACGGATTG,0,1326623
furpa,0.07692307692307693,12,12,GAGGGGGCCAACTCACCTAG,0,1308355
furpa,0.07692307692307693,12,12,GAGGGAGATTAACCTGCAAC,0,1332974
furpa,0.07692307692307693,12,12,GAGGATGTTAATGAGGCTGT,0,1339114
furpa,0.07692307692307693,12,12,GAGCCAACCAGACCGGTTGT,0,1290407
furpa,0.07692307692307693,12,12,GAGAGCACAATTTATTCGCG,0,1306418
furpa,0.07692307692307693,12,12,GAGAAGGCATTGACGCACGC,0,1326135
furpa,0.07692307692307693,12,12,GACTTTCCGTTATTTTCGGA,0,1275355
furpa,0.07692307692307693,12,12,GACTTAAGTACCCAAATCCT,0,1324505
furpa,0.07692307692307693,12,12,GACGACGTGGTATCCGCTGT,0,1352078
furpa,0.07692307692307693,12,12,GACAGATCGCCGAAGTGGCA,0,1287600
furpa,0.07692307692307693,12,12,GAATAAATTGGTCGCTACTA,0,1326331
furpa,0.07692307692307693,12,12,GAAGTATTTAACCGGATCGT,0,1319368
furpa,0.07692307692307693,12,12,GAAGGTTACCGGTATTAGGA,0,1322481
furpa,0.07692307692307693,12,12,GAAGCATATTTATCAGGTGT,0,1330000
furpa,0.07692307692307693,12,12,GAACCTTGTCCACTCCATTA,0,1311576
furpa,0.07692307692307693,12,12,GAAAGGGTCTGAAAAACGTC,0,1311278
furpa,0.07692307692307693,12,12,CTTTTGTCCTTCCGTTGCAG,0,1350120
furpa,0.07692307692307693,12,12,CTTGGTTCAATCAGCCGCTC,0,1275088
furpa,0.07692307692307693,12,12,CTTGAGAATTGAAACGGGTG,0,1355354
furpa,0.07692307692307693,12,12,CTTCTGCTTAGAGATAAGTG,0,1334608
furpa,0.07692307692307693,12,12,CTTCGTGTCGGATAAGACTG,0,1306086
furpa,0.07692307692307693,12,12,CTTACTATCTAAGGTAGCGA,0,1290200
furpa,0.07692307692307693,12,12,CTGCTCTCTGGTCTATTCGA,0,1290645
furpa,0.07692307692307693,12,12,CTCTCTCTGCGCCCAACTAG,0,1271654
furpa,0.07692307692307693,12,12,CTCTCTACACTGATCCGCGG,0,1296804
furpa,0.07692307692307693,12,12,CTCTCGTTTCCCACGTGGTT,0,1317640
furpa,0.07692307692307693,12,12,CTCCTCATTAGGGAGCTGCT,0,1323171
furpa,0.07692307692307693,12,12,CTCACACAGTGAGATATTGC,0,1308007
furpa,0.07692307692307693,12,12,CTCAACGAGTCACTCGTTCA,0,1309482
furpa,0.07692307692307693,12,12,CTCAACGAGGCGCAAGGTCT,0,1282818
furpa,0.07692307692307693,12,12,CTAGATCGACGGGGGGGCGC,0,1283062
furpa,0.07692307692307693,12,12,CTACCAATGGAACCCCGTAA,0,1297369
furpa,0.07692307692307693,12,12,CTAATAATCCAAATTGAGGC,0,1274804
furpa,0.07692307692307693,12,12,CTAAACGATGTTCGTAGTTC,0,1289412
furpa,0.07692307692307693,12,12,CGTGTACAATCAATGCAAGT,0,1286577
furpa,0.07692307692307693,12,12,CGTGGCGCGGGGCGTACGTA,0,1344013
furpa,0.07692307692307693,12,12,CGGGGCGTCAGGCAAATTCA,0,1327569
furpa,0.07692307692307693,12,12,CGGCTGGGAACCAAATACTC,0,1356116
furpa,0.07692307692307693,12,12,CGGAGCAACGCGGGGCTGAC,0,1303799
furpa,0.07692307692307693,12,12,CGGAGACCGGGTTACGGCCC,0,1273231
furpa,0.07692307692307693,12,12,CGCTGAATCTCCCCCGTCAC,0,1356480
furpa,0.07692307692307693,12,12,CGCGTAATCTGTACGCCTCC,0,1355932
furpa,0.07692307692307693,12,12,CGCCCGAAGAGTAACGCAGT,0,1302064
furpa,0.07692307692307693,12,12,CGCCATAAACGACTGACACC,0,1326701
furpa,0.07692307692307693,12,12,CGCATTAGTGCCGTACCAAC,0,1320348
furpa,0.07692307692307693,12,12,CGATTAGAAATTCCCTTACA,0,1327115
furpa,0.07692307692307693,12,12,CGAGGTTAGGGGCATCGCAG,0,1305914
furpa,0.07692307692307693,12,12,CGAAACACGCAACACTTGGC,0,1326903
furpa,0.07692307692307693,12,12,CCTTTAGTTGAGGCAAGTGA,0,1342772
furpa,0.07692307692307693,12,12,CCTGGTGAGATGGAGGATGT,0,1306404
furpa,0.07692307692307693,12,12,CCTCATCGAGCTGAGAGAAT,0,1352191
furpa,0.07692307692307693,12,12,CCTCAGCATGAGGGCTCGGG,0,1296690
furpa,0.07692307692307693,12,12,CCTAGTTTGTTCATACCAGT,0,1322609
furpa,0.07692307692307693,12,12,CCTAGCACCTTATCTATCGA,0,1326102
furpa,0.07692307692307693,12,12,CCTAAGCACTGTTTCAGATG,0,1330952
furpa,0.07692307692307693,12,12,CCGTTGCGTGTAGCGTGGCC,0,1338217
furpa,0.07692307692307693,12,12,CCGTGCACTAGCAATGAAAT,0,1298912
furpa,0.07692307692307693,12,12,CCGGGCGAGATGTTGTTTGT,0,1351392
furpa,0.07692307692307693,12,12,CCGCCTCAGACTTGTCATTC,0,1355439
furpa,0.07692307692307693,12,12,CCGAATTTGGATCCGGTAAT,0,1327243
furpa,0.07692307692307693,12,12,CCCTGCCTGTCGTGTTTCAG,0,1275519
furpa,0.07692307692307693,12,12,CCCTCCGTTTTCAGCGTAGG,0,1340436
furpa,0.07692307692307693,12,12,CCCGGCTGCTAATCCGGCCT,0,1325214
furpa,0.07692307692307693,12,12,CCCCTTGGCCACTGCCAGGC,0,1283551
furpa,0.07692307692307693,12,12,CCCCTGCAAATGGTAAAGTA,0,1315024
furpa,0.07692307692307693,12,12,CCCCAACGTTAAGCGCTAAA,0,1297242
furpa,0.07692307692307693,12,12,CCCATTTACCTTGAGAGCTA,0,1288750
furpa,0.07692307692307693,12,12,CCCACCGCGCTTTCTGAGGC,0,1292799
furpa,0.07692307692307693,12,12,CCATGTTGCCTAGTACCGTA,0,1336820
furpa,0.07692307692307693,12,12,CCAGTTCACCAACGGTTTAA,0,1279234
furpa,0.07692307692307693,12,12,CCACTTTCTGTGAGTCAGGT,0,1344633
furpa,0.07692307692307693,12,12,CCACTAACGTCCCCAGCTTT,0,1346357
furpa,0.07692307692307693,12,12,CCACCGCGGGGTCGCGGAAT,0,1336667
furpa,0.07692307692307693,12,12,CCAACGTCGTTCTAAATCTT,0,1320579
furpa,0.07692307692307693,12,12,CATTGGAATAACTATCGCGT,0,1347420
furpa,0.07692307692307693,12,12,CATTCCTGATACAAGGAAAT,0,1334914
furpa,0.07692307692307693,12,12,CATTAATTCTAACTTGTTCC,0,1301982
furpa,0.07692307692307693,12,12,CATGCAATACTAAGGTACGG,0,1345262
furpa,0.07692307692307693,12,12,CATCTTTATCGTGGCGATGC,0,1293843
furpa,0.07692307692307693,12,12,CATCGTGTTTCGTGATAGGG,0,1333219
furpa,0.07692307692307693,12,12,CATCGACGCACCTAATAGGT,0,1331837
furpa,0.07692307692307693,12,12,CATCCCGTAAAGGCGTCGTG,0,1301774
furpa,0.07692307692307693,12,12,CATCATATACGTACGATAAG,0,1355508
furpa,0.07692307692307693,12,12,CATAGTTTAGCGTGCGCAGA,0,1291692
furpa,0.07692307692307693,12,12,CATAACACATGGACTGCAAC,0,1332124
furpa,0.07692307692307693,12,12,CAGGTTATATCCTCTACCGT,0,1277943
furpa,0.07692307692307693,12,12,CAGGGTCATGTTTGGCGGGG,0,1303702
furpa,0.07692307692307693,12,12,CAGAGTGAGTGCGTCACATT,0,1314825
furpa,0.07692307692307693,12,12,CAGACATCACCTCATACTAC,0,1293795
furpa,0.07692307692307693,12,12,CACTATGGAACGCTGAAGGA,0,1339995
furpa,0.07692307692307693,12,12,CACGGTCATAAAGTCCCTAT,0,1327180
furpa,0.07692307692307693,12,12,CACCTTTCGATGGCAAATTT,0,1337724
furpa,0.07692307692307693,12,12,CACCTTGCGTTTGATGTGTA,0,1344384
furpa,0.07692307692307693,12,12,CACCTAGAATAGAGGTACCA,0,1314384
furpa,0.07692307692307693,12,12,CACCGCCAGTGCGCTGGCTG,0,1327992
furpa,0.07692307692307693,12,12,CACCACCAGGTTACCCCCAC,0,1324171
furpa,0.07692307692307693,12,12,CACACTGGCACACGAGCGGG,0,1346929
furpa,0.07692307692307693,12,12,CACACAAACAATCAAGATGA,0,1299712
furpa,0.07692307692307693,12,12,CAATGTTGGCCTGAAGACAT,0,1340176
furpa,0.07692307692307693,12,12,CAATGTAAGTGTTCCGTGGT,0,1283269
furpa,0.07692307692307693,12,12,CAATATGCCTCCACGGGAAA,0,1325146
furpa,0.07692307692307693,12,12,CAAGTTGTAGATGTTACTGG,0,1283479
furpa,0.07692307692307693,12,12,CAACCTCGCATCTATTCCAT,0,1321534
furpa,0.07692307692307693,12,12,CAAACGAGGAGATAGCAATG,0,1271992
furpa,0.07692307692307693,12,12,CAAACCCGAAACTGATGGCT,0,1340973
furpa,0.07692307692307693,12,12,CAAACCAACAATTGAAGCGT,0,1271736
furpa,0.07692307692307693,12,12,ATTGGTAATCGATAGTAAGA,0,1338639
furpa,0.07692307692307693,12,12,ATTGGGAGAGGGCCGCTGTA,0,1337893
furpa,0.07692307692307693,12,12,ATTCTGTCATGAGTGGCCAG,0,1296813
furpa,0.07692307692307693,12,12,ATTCGGGTTACGAAATTGGG,0,1350513
furpa,0.07692307692307693,12,12,ATTCGCGCCTTCCCACTTTA,0,1352432
furpa,0.07692307692307693,12,12,ATTAATTGTATGGTCAAGAT,0,1274302
furpa,0.07692307692307693,12,12,ATTAAACGTAGGCTAGTCCC,0,1303142
furpa,0.07692307692307693,12,12,ATGTTGGCGTAGTCCATAAA,0,1328378
furpa,0.07692307692307693,12,12,ATGGGAACTCGGCCCGTCTT,0,1299103
furpa,0.07692307692307693,12,12,ATGGCGAGTGATGAAGCGCG,0,1276003
furpa,0.07692307692307693,12,12,ATGGCATGTCTACAGATACC,0,1310839
furpa,0.07692307692307693,12,12,ATGCTCTTCCATATACCATA,0,1332180
furpa,0.07692307692307693,12,12,ATGCGACCGTTCAGTGGATA,0,1311760
furpa,0.07692307692307693,12,12,ATGCCCGGGCCTGGCCTGAT,0,1295446
furpa,0.07692307692307693,12,12,ATGAGGGTCTATGTCATGAT,0,1316968
furpa,0.07692307692307693,12,12,ATGAGCGTGTGTGGGCACCT,0,1287040
furpa,0.07692307692307693,12,12,ATGACTTTCAGTTTTTGTTG,0,1322659
furpa,0.07692307692307693,12,12,ATGACTAGAAGTTCACCATT,0,1356543
furpa,0.07692307692307693,12,12,ATGAAACGTCGCCTTATTAC,0,1324366
furpa,0.07692307692307693,12,12,ATCTGGCGTTACGCGCGCCA,0,1321095
furpa,0.07692307692307693,12,12,ATCTGCGGAAAGGCGCGGTG,0,1317014
furpa,0.07692307692307693,12,12,ATCGAACCGGTACCTCGATG,0,1344627
furpa,0.07692307692307693,12,12,ATCAGTCAAATATAAGGCGG,0,1314309
furpa,0.07692307692307693,12,12,ATCAAAACTGGGGCCGCTTT,0,1289963
furpa,0.07692307692307693,12,12,ATAGGATCGTAGGGGAATGA,0,1352398
furpa,0.07692307692307693,12,12,ATAGCAGTGAGTCATCGTTG,0,1333809
furpa,0.07692307692307693,12,12,ATACGTTACGGGACTACGTT,0,1340769
furpa,0.07692307692307693,12,12,ATACGATATGTGCCCACGTT,0,1326556
furpa,0.07692307692307693,12,12,ATACCCTTTCTGTCCCCTTT,0,1326920
furpa,0.07692307692307693,12,12,ATAAGACGCTGTTAAACCAA,0,1314323
furpa,0.07692307692307693,12,12,AGTTTTGGTTCTTCGGTAAA,0,1298645
furpa,0.07692307692307693,12,12,AGTTGCGTGGTTATGCTTTA,0,1287904
furpa,0.07692307692307693,12,12,AGTTCCTCACTTCTCAGGGA,0,1335234
furpa,0.07692307692307693,12,12,AGTTATGGTGCTGTTGCAAC,0,1307872
furpa,0.07692307692307693,12,12,AGTCTGACAACACGTGCTGT,0,1342520
furpa,0.07692307692307693,12,12,AGTCCGTACAGCTCCGCTCC,0,1331472
furpa,0.07692307692307693,12,12,AGTCAACTGGGGAAGCTTCA,0,1277712
furpa,0.07692307692307693,12,12,AGTAGTGGGCCTCGCAAATA,0,1278652
furpa,0.07692307692307693,12,12,AGTAAAGATGCCTTCATGCA,0,1305026
furpa,0.07692307692307693,12,12,AGGGAGATGGGTGTAGGGCA,0,1310006
furpa,0.07692307692307693,12,12,AGGCAGGGCATGCAACGCAA,0,1296301
furpa,0.07692307692307693,12,12,AGGAAAGCTTGGTATGGGCT,0,1324639
furpa,0.07692307692307693,12,12,AGCTACGATAGAGGTCCAGG,0,1276674
furpa,0.07692307692307693,12,12,AGCGTAAGGTTAGCCGCAGT,0,1345309
furpa,0.07692307692307693,12,12,AGCGGATAAGGCACAACAGA,0,1283874
furpa,0.07692307692307693,12,12,AGCGCTGAGCGCAGATCCCG,0,1337159
furpa,0.07692307692307693,12,12,AGCCGCGTCAGCTATGTGTC,0,1355096
furpa,0.07692307692307693,12,12,AGCCGAAGCTGTGAATTGCC,0,1319718
furpa,0.07692307692307693,12,12,AGCCATCAGTGATGCATTGA,0,1286096
furpa,0.07692307692307693,12,12,AGATACATTCCACAATGCGC,0,1350053
furpa,0.07692307692307693,12,12,AGAGGCAGGCTAGCGGAGTT,0,1329441
furpa,0.07692307692307693,12,12,AGAGCATCGGAACAACGCTG,0,1334952
furpa,0.07692307692307693,12,12,AGAGAGCGCCGACTCCCGGA,0,1350902
furpa,0.07692307692307693,12,12,AGACCGCTGAACACGTAGCT,0,1272811
furpa,0.07692307692307693,12,12,ACTTCCAAGTATACATTCTC,0,1344845
furpa,0.07692307692307693,12,12,ACTGGAGTGCCATCTTCTGA,0,1290405
furpa,0.07692307692307693,12,12,ACTCGGAGAGGGACAGTTTC,0,1280361
furpa,0.07692307692307693,12,12,ACTCACTTCTCTCCAAACTC,0,1353484
furpa,0.07692307692307693,12,12,ACTACCACGTCTCGTCCAAC,0,1312239
furpa,0.07692307692307693,12,12,ACGTGTGCGATCGAGGATTC,0,1281785
furpa,0.07692307692307693,12,12,ACGTGAGCATCCGAGATTAA,0,1281781
furpa,0.07692307692307693,12,12,ACGTCTCACGTTGCGGCTAC,0,1356032
furpa,0.07692307692307693,12,12,ACGGGGATTCGATGCTCACG,0,1347417
furpa,0.07692307692307693,12,12,ACGGGATAACCTTACGATGT,0,1356592
furpa,0.07692307692307693,12,12,ACGACCTCTCTAAGGAACTA,0,1344390
furpa,0.07692307692307693,12,12,ACCGGCTGTGCCCCTAGAAT,0,1322333
furpa,0.07692307692307693,12,12,ACCATAGAGGCAGTAACTTG,0,1331970
furpa,0.07692307692307693,12,12,ACATTTGGGCGTAACGAGTT,0,1292306
furpa,0.07692307692307693,12,12,ACAGTTCGGAGCTTACGGGT,0,1334168
furpa,0.07692307692307693,12,12,ACAGTGGGTTGTCGTTGATT,0,1307597
furpa,0.07692307692307693,12,12,ACAGATGTTGGGATCCAACT,0,1287459
furpa,0.07692307692307693,12,12,ACACGACTGGGGCGCAGAGC,0,1316516
furpa,0.07692307692307693,12,12,ACAATCCGACGAAACAGTTT,0,1279602
furpa,0.07692307692307693,12,12,ACAAGGCCGGGAATTATCTG,0,1323191
furpa,0.07692307692307693,12,12,AAGTTCACCCTGGGAACAGT,0,1284710
furpa,0.07692307692307693,12,12,AAGTGTGAAGAAGACATCCG,0,1299911
furpa,0.07692307692307693,12,12,AAGTATCATAAGAGCGGTGT,0,1307360
furpa,0.07692307692307693,12,12,AAGGGTTATTTGCCGCACAG,0,1297083
furpa,0.07692307692307693,12,12,AAGGAGAGCCTTTAAATAAA,0,1284917
furpa,0.07692307692307693,12,12,AAGCCCATCGCTTCGATTTC,0,1322292
furpa,0.07692307692307693,12,12,AACTCGGGTTTCACGCCCCA,0,1325366
furpa,0.07692307692307693,12,12,AACTAGGAAACAGTCGATCT,0,1312003
furpa,0.07692307692307693,12,12,AACGTGCATCGCGTTCCCTT,0,1326305
furpa,0.07692307692307693,12,12,AACGGAAGCCGATAGTCCCG,0,1298719
furpa,0.07692307692307693,12,12,AACCGGCTAAGGACCAGCGT,0,1323035
furpa,0.07692307692307693,12,12,AACACGTATCTTTGGCACGT,0,1281182
furpa,0.07692307692307693,12,12,AAATAGTGTGACTTGTCCTC,0,1332277
furpa,0.07692307692307693,12,12,AAAGTGCGTTAGACACTCTA,0,1331987
furpa,0.07692307692307693,12,12,AAAGCATTGGTTTACGCTTC,0,1345693
furpa,0.07692307692307693,12,12,AAACAATAGGAAATCGCAGT,0,1352254
furpa,0.07692307692307693,12,12,AAAATGTCCTTTGTGGTAAC,0,1306150
furpa,0.07692307692307693,12,12,AAAACGAGCCCCGGGTCGGT,0,1294236
furpa,0.07692307692307693,12,12,AAAAAGATATTGAATTACGA,0,1340494
furpa,0.08333333333333333,11,11,TTTTGGTGACATATACGTGT,0,1271434
furpa,0.08333333333333333,11,11,TTTTCGCAGGCGATAGGAGC,0,1316823
furpa,0.08333333333333333,11,11,TTTTCGAACGGGAACTTGTC,0,1302644
furpa,0.08333333333333333,11,11,TTTGTTGGCGTAGCCATACC,0,1336077
furpa,0.08333333333333333,11,11,TTTGTAGCACTCGCGCATGC,0,1310276
furpa,0.08333333333333333,11,11,TTTGGTGGCGAAACACGATT,0,1339751
furpa,0.08333333333333333,11,11,TTTGGGGCGACTAGACCAAT,0,1341677
furpa,0.08333333333333333,11,11,TTTCCGCCGCCCGGTCTGGA,0,1298379
furpa,0.08333333333333333,11,11,TTTAGTTACGGACGGACGAA,0,1286676
furpa,0.08333333333333333,11,11,TTTACAATCGTGTGATCTTA,0,1301694
furpa,0.08333333333333333,11,11,TTTAAATTAATGAAGCAACA,0,1288589
furpa,0.08333333333333333,11,11,TTGTTGCATAACGTTTAAAG,0,1315647
furpa,0.08333333333333333,11,11,TTGTGTAAGCACTTTTATAT,0,1315922
furpa,0.08333333333333333,11,11,TTGTACTCAGAACAGCTGGT,0,1273022
furpa,0.08333333333333333,11,11,TTGGGGCACGTACGATTGAA,0,1308649
furpa,0.08333333333333333,11,11,TTGGGCGGAAACCGCGCAAT,0,1345377
furpa,0.08333333333333333,11,11,TTGGAAAGTGGGAGGGTTCT,0,1343296
furpa,0.08333333333333333,11,11,TTGCTGGCACAGGCCTGTAG,0,1298328
furpa,0.08333333333333333,11,11,TTGAGCCGTTGAGTCCATTA,0,1311852
furpa,0.08333333333333333,11,11,TTGACCGTACTGGGTCCGGC,0,1304982
furpa,0.08333333333333333,11,11,TTCGGTCTCGCTCAACGATC,0,1300983
furpa,0.08333333333333333,11,11,TTCGCCCAAATGCCTCGGTC,0,1290084
furpa,0.08333333333333333,11,11,TTCCGGGAGGGAGAATGTTT,0,1345098
furpa,0.08333333333333333,11,11,TTCACTAAGTAGTGGGCGCA,0,1272674
furpa,0.08333333333333333,11,11,TTATTAGGGCTGAGATCCAT,0,1283940
furpa,0.08333333333333333,11,11,TTATGTGGATCCTAATTACT,0,1322076
furpa,0.08333333333333333,11,11,TTATCTGGCACGCAATCAAT,0,1307864
furpa,0.08333333333333333,11,11,TTATCAACCGCTCACGCTCT,0,1328503
furpa,0.08333333333333333,11,11,TTAGTCATGAGTGTAGTATA,0,1357627
furpa,0.08333333333333333,11,11,TTAGCGCGTAGATCGCGTAA,0,1278073
furpa,0.08333333333333333,11,11,TTACTATGAGCACGAATTGT,0,1356999
furpa,0.08333333333333333,11,11,TTACAGTGGTACCGGCGCGG,0,1287988
furpa,0.08333333333333333,11,11,TTAAGTCTATAGTCGATTGC,0,1329159
furpa,0.08333333333333333,11,11,TGTTGTTCACTTGAGACTAA,0,1293126
furpa,0.08333333333333333,11,11,TGTTGAACACCGCGGTCATG,0,1312172
furpa,0.08333333333333333,11,11,TGTGTGGTCCCTCAGCGGCA,0,1323580
furpa,0.08333333333333333,11,11,TGTGAGGCAACTCGGCATTC,0,1348430
furpa,0.08333333333333333,11,11,TGTCCCGTCGTGAGGGCATA,0,1343410
furpa,0.08333333333333333,11,11,TGTCATTTCATAGAGTTCAG,0,1325162
furpa,0.08333333333333333,11,11,TGTCAGATCGCTCTTGTGGA,0,1326784
furpa,0.08333333333333333,11,11,TGTCACATTCAGTATAGAGC,0,1338383
furpa,0.08333333333333333,11,11,TGTATTTTCATTGGCGATGG,0,1347487
furpa,0.08333333333333333,11,11,TGTATTTTACTAGGGGGATA,0,1312685
furpa,0.08333333333333333,11,11,TGTATCGTCCGAGGTATTCA,0,1308561
furpa,0.08333333333333333,11,11,TGTAACTTTTATAATCAAAT,0,1314380
furpa,0.08333333333333333,11,11,TGGTGTCCCCCAGGATAGTG,0,1297932
furpa,0.08333333333333333,11,11,TGGTGGGCCGCCGCTCGATA,0,1334042
furpa,0.08333333333333333,11,11,TGGTAAGCACGGACGTGGCA,0,1274635
furpa,0.08333333333333333,11,11,TGGGTAATCTACTGACACGA,0,1332522
furpa,0.08333333333333333,11,11,TGGGCGTGAAAATAAGTCAT,0,1296311
furpa,0.08333333333333333,11,11,TGGCCGCGTGAATATCCTGC,0,1345559
furpa,0.08333333333333333,11,11,TGGCATTATTAGGAGCTTCA,0,1282093
furpa,0.08333333333333333,11,11,TGGAGGCTCCAGTGAGGTAT,0,1278416
furpa,0.08333333333333333,11,11,TGGAACTACTCGCATTCAGG,0,1272273
furpa,0.08333333333333333,11,11,TGGAAATTAAAGTAGGGTGT,0,1349224
furpa,0.08333333333333333,11,11,TGCTAATGGCGGGGCACAAA,0,1347604
furpa,0.08333333333333333,11,11,TGCTAACTAGATACGACGGT,0,1303102
furpa,0.08333333333333333,11,11,TGCGGGTCCAACCCAAGTCA,0,1325309
furpa,0.08333333333333333,11,11,TGCCGATTTCTGATCACTGG,0,1299917
furpa,0.08333333333333333,11,11,TGCCAGTCTGCTTACTTGGG,0,1318602
furpa,0.08333333333333333,11,11,TGCCACCGTGATTGGCCAGC,0,1278497
furpa,0.08333333333333333,11,11,TGCCAATCAGCAACACGGAG,0,1296856
furpa,0.08333333333333333,11,11,TGCATAAAAGGACTGCACGA,0,1316154
furpa,0.08333333333333333,11,11,TGCAGTCTAGGCACCTAATA,0,1334398
furpa,0.08333333333333333,11,11,TGCACGGCACCTTTTTATAG,0,1351963
furpa,0.08333333333333333,11,11,TGCACGCTCAGAATTATTCG,0,1352180
furpa,0.08333333333333333,11,11,TGAGTCTGGCTTATACAATT,0,1273912
furpa,0.08333333333333333,11,11,TGAGAATCGTACTAGCTATT,0,1314820
furpa,0.08333333333333333,11,11,TGACGAGGTGAACCATTCGA,0,1310793
furpa,0.08333333333333333,11,11,TGACCCGTCCTTGGTCTGAT,0,1293998
furpa,0.08333333333333333,11,11,TCTGGCCTGTTGGGGATCTA,0,1325519
furpa,0.08333333333333333,11,11,TCTGGCAGTTTCACTGAGCT,0,1280218
furpa,0.08333333333333333,11,11,TCTGCTAAGGAGGCCAACAC,0,1287396
furpa,0.08333333333333333,11,11,TCTGAAGCTCGATTACAGGC,0,1282761
furpa,0.08333333333333333,11,11,TCTCGCGTCTTCTGCTGGGA,0,1349197
furpa,0.08333333333333333,11,11,TCTACGGACATCATCTTTAA,0,1357238
furpa,0.08333333333333333,11,11,TCTAAGGGTTTATCCCGCGA,0,1287881
furpa,0.08333333333333333,11,11,TCGTTTGCTAGTATAATGAA,0,1324162
furpa,0.08333333333333333,11,11,TCGTCCTAGTAGCCCTTCTA,0,1357328
furpa,0.08333333333333333,11,11,TCGTATGTTATACCAACTGA,0,1333815
furpa,0.08333333333333333,11,11,TCGTACTGGACGAAGGGAGG,0,1314459
furpa,0.08333333333333333,11,11,TCGGGGATAGGTGTTAATCG,0,1342817
furpa,0.08333333333333333,11,11,TCGGGATGGCATGGAGTCGG,0,1284881
furpa,0.08333333333333333,11,11,TCGGCCTTAGTGCATGCTGC,0,1275087
furpa,0.08333333333333333,11,11,TCGCAGTTGGCGGCGGGGAA,0,1322299
furpa,0.08333333333333333,11,11,TCGATTCTTCGACGGGAACT,0,1328737
furpa,0.08333333333333333,11,11,TCGATTCCCCGCAGTCGAAA,0,1357020
furpa,0.08333333333333333,11,11,TCCTTCAACAGATTGTCATT,0,1349518
furpa,0.08333333333333333,11,11,TCCTGCGCTACCATGTAGAT,0,1333620
furpa,0.08333333333333333,11,11,TCCTAGTCGCGCGCAAGACG,0,1340080
furpa,0.08333333333333333,11,11,TCCGCAGTATCCTCTGAAAG,0,1344962
furpa,0.08333333333333333,11,11,TCCCGTTAATACTATGGTCT,0,1306080
furpa,0.08333333333333333,11,11,TCCACATCGCAAACTCCGCC,0,1292386
furpa,0.08333333333333333,11,11,TCATTAGCGTTAAGCTGGTA,0,1353584
furpa,0.08333333333333333,11,11,TCATTAAACAAGATGTTGTA,0,1325817
furpa,0.08333333333333333,11,11,TCATCACGATTTCTGCCCGA,0,1329252
furpa,0.08333333333333333,11,11,TCAGGATTGTTTCGGGTCAG,0,1333978
furpa,0.08333333333333333,11,11,TCAATGTTGAGGGACCAATG,0,1271318
furpa,0.08333333333333333,11,11,TCAAGTACCAGTAATATACG,0,1310154
furpa,0.08333333333333333,11,11,TATTTAGTCCGGGGTAAAAA,0,1296052
furpa,0.08333333333333333,11,11,TATCTGGCTCACGCAGGAGC,0,1316194
furpa,0.08333333333333333,11,11,TATCGTTAACAAATGGGTCC,0,1304000
furpa,0.08333333333333333,11,11,TATATGGCGCTCAGGGCGGA,0,1341508
furpa,0.08333333333333333,11,11,TATAGTTAGACGTCGAACCA,0,1328322
furpa,0.08333333333333333,11,11,TATAGTGGTTAGATCCAATC,0,1314717
furpa,0.08333333333333333,11,11,TATAACGCTTACCCAGGGAG,0,1310140
furpa,0.08333333333333333,11,11,TAGGCCTAATGCGATATGCT,0,1319761
furpa,0.08333333333333333,11,11,TAGCTCCTGAGTTAGCTACC,0,1274864
furpa,0.08333333333333333,11,11,TAGCCCGTTGGCCACCAGAT,0,1280521
furpa,0.08333333333333333,11,11,TAGAATGGTCGGCGTGGCAG,0,1299939
furpa,0.08333333333333333,11,11,TAGAAGCTCTCAGACCACGA,0,1355079
furpa,0.08333333333333333,11,11,TACTACACAATACCTAGAAG,0,1345093
furpa,0.08333333333333333,11,11,TACGGGGGCAGAACAATCGA,0,1280515
furpa,0.08333333333333333,11,11,TACGACTGGGACTCTACCAT,0,1346099
furpa,0.08333333333333333,11,11,TACCGGACTAAGACGGTCAC,0,1285293
furpa,0.08333333333333333,11,11,TACCGAATTTACAACGACGC,0,1319109
furpa,0.08333333333333333,11,11,TACACGCACTGGGTGGTATG,0,1302912
furpa,0.08333333333333333,11,11,TACACCTTCAGCGTGTTGGC,0,1284178
furpa,0.08333333333333333,11,11,TAATTTTAGCAGTACCCTCT,0,1333884
furpa,0.08333333333333333,11,11,TAATTAGCCTGGTCCTCGGG,0,1294151
furpa,0.08333333333333333,11,11,TAATGTTGAGGTATACACGG,0,1348908
furpa,0.08333333333333333,11,11,TAATAGAGGGAGCATGGCTT,0,1332915
furpa,0.08333333333333333,11,11,TAAGCGCGTAGGACCACACC,0,1322570
furpa,0.08333333333333333,11,11,GTTTGTCCCAATGGCTCCAG,0,1353150
furpa,0.08333333333333333,11,11,GTTGGGGTCGAAGGGGCTAA,0,1328593
furpa,0.08333333333333333,11,11,GTTAGACGGCATAATTATCA,0,1283978
furpa,0.08333333333333333,11,11,GTTAAAAAGCAATACGTCGC,0,1299582
furpa,0.08333333333333333,11,11,GTGTTAAGGGTGAACAAGTT,0,1281560
furpa,0.08333333333333333,11,11,GTGGGCTACACACCGCATTT,0,1355237
furpa,0.08333333333333333,11,11,GTGGCACTGTGTTACTACTC,0,1350228
furpa,0.08333333333333333,11,11,GTGCGAGTACTTCTAGAGTC,0,1331627
furpa,0.08333333333333333,11,11,GTGAGGGAATGCGCTGAAAA,0,1282937
furpa,0.08333333333333333,11,11,GTGAAAAGCCGGCCTCCTGA,0,1353718
furpa,0.08333333333333333,11,11,GTCGCACTTAGTACAGTGAT,0,1280220
furpa,0.08333333333333333,11,11,GTCGAGCTCGGGAAAGGCTA,0,1302883
furpa,0.08333333333333333,11,11,GTCAGCGGGCATTGCAGGAT,0,1271618
furpa,0.08333333333333333,11,11,GTCACCATTCGTAGTGGTTC,0,1288151
furpa,0.08333333333333333,11,11,GTATTGTCCTCTCCCCATGA,0,1318032
furpa,0.08333333333333333,11,11,GTAGGGCCAGGAGGGACCGG,0,1292629
furpa,0.08333333333333333,11,11,GTAGCGCGGAAGATTCCGGG,0,1327573
furpa,0.08333333333333333,11,11,GTACTACGACCTTAGGGAAC,0,1337098
furpa,0.08333333333333333,11,11,GGTTGTGTTGTCCCGAGGTC,0,1281814
furpa,0.08333333333333333,11,11,GGTTCATCGTGACAACCTTT,0,1331194
furpa,0.08333333333333333,11,11,GGTTCAACGGAGTCTACATA,0,1352987
furpa,0.08333333333333333,11,11,GGTGTTAAAAGTTGGTCGGC,0,1299361
furpa,0.08333333333333333,11,11,GGTGTGTTTACTCCGGCATC,0,1301943
furpa,0.08333333333333333,11,11,GGTGCATGCATCGAATGGGA,0,1280291
furpa,0.08333333333333333,11,11,GGTCTCGCGAATAGAAAAAC,0,1300463
furpa,0.08333333333333333,11,11,GGTCGAGAAAGTAAGCAATA,0,1337190
furpa,0.08333333333333333,11,11,GGTCCTTTTAACGCAGAACT,0,1342226
furpa,0.08333333333333333,11,11,GGTCCTGCTTGCGGTTGTGG,0,1309070
furpa,0.08333333333333333,11,11,GGTCACATTGCTTATATAAG,0,1314371
furpa,0.08333333333333333,11,11,GGTAAAGACGGGGCTACATC,0,1289300
furpa,0.08333333333333333,11,11,GGGTGGTAGGTGTAGTTAGA,0,1339561
furpa,0.08333333333333333,11,11,GGGTCGGTGCAGAGATGCTT,0,1337772
furpa,0.08333333333333333,11,11,GGGTCAAGAGTGGGAACAGA,0,1285700
furpa,0.08333333333333333,11,11,GGGGTTTCCCGGACTTAGAA,0,1275253
furpa,0.08333333333333333,11,11,GGGGGTTGGAGTAAGCCCAC,0,1296912
furpa,0.08333333333333333,11,11,GGGGCAAATGAACGGCTAAT,0,1276885
furpa,0.08333333333333333,11,11,GGGCTGGGAGGACCCGACGT,0,1290679
furpa,0.08333333333333333,11,11,GGGCGTATTAAATACCAGAG,0,1312890
furpa,0.08333333333333333,11,11,GGGCGGCTACCCTGAACGTG,0,1346369
furpa,0.08333333333333333,11,11,GGGCGGATGAATCAATAGGG,0,1283387
furpa,0.08333333333333333,11,11,GGGATCGGGGATCCCCAACC,0,1290400
furpa,0.08333333333333333,11,11,GGGACCGCCTGTGGACCGAA,0,1276227
furpa,0.08333333333333333,11,11,GGGAAGACTCACGCTTCGGG,0,1325060
furpa,0.08333333333333333,11,11,GGCGCGCTGGATGAATTGCC,0,1356927
furpa,0.08333333333333333,11,11,GGCCGCTGGTAACTGCCACG,0,1316942
furpa,0.08333333333333333,11,11,GGCCCGCCTGTATGCCATTG,0,1301996
furpa,0.08333333333333333,11,11,GGCCATCGGGCTATAGGAGC,0,1346305
furpa,0.08333333333333333,11,11,GGCAGTAAAGATTCCTAGTC,0,1346463
furpa,0.08333333333333333,11,11,GGCACAATTAGTTTGACACA,0,1290612
furpa,0.08333333333333333,11,11,GGAGAGCAATAAGGACGTCA,0,1352968
furpa,0.08333333333333333,11,11,GGACGTTGGTAACGCACGCA,0,1345025
furpa,0.08333333333333333,11,11,GGACGTACCAATTAGGTTCT,0,1320275
furpa,0.08333333333333333,11,11,GGACGGCGAAGTTATGCTAT,0,1281608
furpa,0.08333333333333333,11,11,GGAATTGGTAATCGTAAATC,0,1318593
furpa,0.08333333333333333,11,11,GGAAGAAATCGATTCATGAC,0,1328812
furpa,0.08333333333333333,11,11,GGAAAGTTCTTCAGCCATGT,0,1294449
furpa,0.08333333333333333,11,11,GCTTATACCAACGATACGCT,0,1312279
furpa,0.08333333333333333,11,11,GCTGTGAAACTTGAGAGAAC,0,1296255
furpa,0.08333333333333333,11,11,GCTCGAAGGCGAAGCTTGCA,0,1319428
furpa,0.08333333333333333,11,11,GCTCGAAAACTCTAAAAGAC,0,1296708
furpa,0.08333333333333333,11,11,GCTACGTCCCCTGTTGTACA,0,1297924
furpa,0.08333333333333333,11,11,GCGTCTGAGTCTATATACAT,0,1334188
furpa,0.08333333333333333,11,11,GCGGGTGTACCGCCAGAGCA,0,1356359
furpa,0.08333333333333333,11,11,GCGGGAACGTACTGATTTTA,0,1304723
furpa,0.08333333333333333,11,11,GCGCGTCTCCTAGAGGCAGG,0,1277513
furpa,0.08333333333333333,11,11,GCGCGAAGACAAGACAACGG,0,1319983
furpa,0.08333333333333333,11,11,GCCTGGGACGCCCATTGCGT,0,1287821
furpa,0.08333333333333333,11,11,GCCGTTATACTTTGTTCGTA,0,1275498
furpa,0.08333333333333333,11,11,GCCGCTTCTTATGGAGTTGA,0,1273520
furpa,0.08333333333333333,11,11,GCCCCTATATTTTGCGAATG,0,1305457
furpa,0.08333333333333333,11,11,GCATTAATCCCCAGCCAACA,0,1353303
furpa,0.08333333333333333,11,11,GCATAGTTTAAGTAATAGGA,0,1289172
furpa,0.08333333333333333,11,11,GCATACCATCCAGACATCCA,0,1354726
furpa,0.08333333333333333,11,11,GCAGTGCGCCCAAAGCTGAA,0,1324566
furpa,0.08333333333333333,11,11,GCAGTCTGTGACAAGAATCT,0,1354631
furpa,0.08333333333333333,11,11,GCAGATCAATCCTGATGTTT,0,1345687
furpa,0.08333333333333333,11,11,GCAGACTTTTCCCAGCCCAT,0,1282694
furpa,0.08333333333333333,11,11,GCAATAACTTTCGAGACGGT,0,1345713
furpa,0.08333333333333333,11,11,GCAAGTAAGACACTGAGGCT,0,1330673
furpa,0.08333333333333333,11,11,GCAACGCTCGGGTGATATTT,0,1341486
furpa,0.08333333333333333,11,11,GATTTATCCAGCCTGGATGA,0,1286098
furpa,0.08333333333333333,11,11,GATTGAGAATCACTCGTCCC,0,1310526
furpa,0.08333333333333333,11,11,GATCTTAAAACATGAGCATT,0,1304977
furpa,0.08333333333333333,11,11,GATACAACCCCAGGGGGTGA,0,1345740
furpa,0.08333333333333333,11,11,GATAATGCACCATTTAAAGG,0,1310749
furpa,0.08333333333333333,11,11,GATAAGACGAATGATCGGCA,0,1322216
furpa,0.08333333333333333,11,11,GAGTCAGCCCGATACGAGGT,0,1343932
furpa,0.08333333333333333,11,11,GAGTACACGGTGGGAGCCAG,0,1333861
furpa,0.08333333333333333,11,11,GAGTAATAGGCTCTGGGCTG,0,1351849
furpa,0.08333333333333333,11,11,GAGGGCAGCGACTCCCTCCA,0,1274340
furpa,0.08333333333333333,11,11,GAGGCACCAAACACTAAAGG,0,1344546
furpa,0.08333333333333333,11,11,GAGGAGCGAGCCCTTTAGGA,0,1286755
furpa,0.08333333333333333,11,11,GAGCTCCGGACGCCGTAGAG,0,1307531
furpa,0.08333333333333333,11,11,GACGTACGGTAGCTTGCTTT,0,1314287
furpa,0.08333333333333333,11,11,GACGAGTAAGTGTTATTGCA,0,1324536
furpa,0.08333333333333333,11,11,GACAGCCCGATAGGTACTGC,0,1324685
furpa,0.08333333333333333,11,11,GAAGTACGACGATGTAGCGA,0,1280959
furpa,0.08333333333333333,11,11,GAAGGCGCTTGTAGTTTCCG,0,1302604
furpa,0.08333333333333333,11,11,GAACTGAAATCTCGTTTTCT,0,1272747
furpa,0.08333333333333333,11,11,GAACTAAACATGTATAGAGG,0,1316324
furpa,0.08333333333333333,11,11,GAACGATGAGACTTCGAATA,0,1276705
furpa,0.08333333333333333,11,11,GAAACCGGTGCGGCTACTAT,0,1297450
furpa,0.08333333333333333,11,11,GAAACACACGGTTTTCATTA,0,1345073
furpa,0.08333333333333333,11,11,CTTTTCATACGAGCTACATC,0,1334125
furpa,0.08333333333333333,11,11,CTTTGGTCTCTGCTATTGTT,0,1347741
furpa,0.08333333333333333,11,11,CTTTCCACACAAAACGCAAC,0,1313976
furpa,0.08333333333333333,11,11,CTTTAGACTAGCTTTACCCC,0,1286267
furpa,0.08333333333333333,11,11,CTTTACTCAGCGTGTTGACA,0,1329254
furpa,0.08333333333333333,11,11,CTTGGTCGGAGACACCTGTA,0,1278494
furpa,0.08333333333333333,11,11,CTTGGGAGGTTTCTTGAGCG,0,1321111
furpa,0.08333333333333333,11,11,CTTGGCCTCCAGGTCCGGCT,0,1303555
furpa,0.08333333333333333,11,11,CTTGCATGCTTTACCCTCAA,0,1347980
furpa,0.08333333333333333,11,11,CTTGAGAAGGTTAATACGAT,0,1322647
furpa,0.08333333333333333,11,11,CTTCGAACAGACTGTATAAG,0,1322806
furpa,0.08333333333333333,11,11,CTTCACGACATGGGAACGTT,0,1356269
furpa,0.08333333333333333,11,11,CTGTTTCCGTGAACGCCACA,0,1345090
furpa,0.08333333333333333,11,11,CTGTGACGACGAGCCCTCAC,0,1274981
furpa,0.08333333333333333,11,11,CTGGCGAGTCTAAAATTGAA,0,1350992
furpa,0.08333333333333333,11,11,CTGGATCACATAATGAATTT,0,1273089
furpa,0.08333333333333333,11,11,CTGCGGCACCCAAACGTCAC,0,1347577
furpa,0.08333333333333333,11,11,CTGATGTTGCTGTGCAGGTA,0,1286437
furpa,0.08333333333333333,11,11,CTGAGGGGCAAGTCCCATTG,0,1319826
furpa,0.08333333333333333,11,11,CTGACACCCTCCTCGCGGCT,0,1350779
furpa,0.08333333333333333,11,11,CTGAATTCCACATGCGGACT,0,1356806
furpa,0.08333333333333333,11,11,CTGAAGAGCATAGAGGGCCA,0,1311956
furpa,0.08333333333333333,11,11,CTCTAGTCGGGGTACTCTCA,0,1294971
furpa,0.08333333333333333,11,11,CTCGTGTCGTGGTACACGAA,0,1331092
furpa,0.08333333333333333,11,11,CTCACGTGTATTGTTGAAGG,0,1353269
furpa,0.08333333333333333,11,11,CTATGTCTTCAGAGGACTGT,0,1306534
furpa,0.08333333333333333,11,11,CTATGGTCAGCGCTCCTGGA,0,1288673
furpa,0.08333333333333333,11,11,CTATACGATTGCACCACCAA,0,1282663
furpa,0.08333333333333333,11,11,CTATAATTGGAGACGTCCAT,0,1309742
furpa,0.08333333333333333,11,11,CTAGCCAGCTCAGCTCGGTG,0,1303883
furpa,0.08333333333333333,11,11,CTAGCAGATGGCCTTTTCTT,0,1284647
furpa,0.08333333333333333,11,11,CTAATTAGCTGGTAATACTC,0,1326631
furpa,0.08333333333333333,11,11,CTAAAACACAGGTATAAGTC,0,1303124
furpa,0.08333333333333333,11,11,CGTTATCGCGGAACCTGAGC,0,1291947
furpa,0.08333333333333333,11,11,CGTTAGTAGTAGGGTCCTTC,0,1326065
furpa,0.08333333333333333,11,11,CGTCGATATCGAAGGTACTA,0,1300116
furpa,0.08333333333333333,11,11,CGGTTTCTCGTTAACGGGTG,0,1352946
furpa,0.08333333333333333,11,11,CGGTTAACGTCGGCGTCGTC,0,1284819
furpa,0.08333333333333333,11,11,CGGTATCTGCGATCGCATGT,0,1342250
furpa,0.08333333333333333,11,11,CGGGTCGGGTGCTTAAGACT,0,1338842
furpa,0.08333333333333333,11,11,CGGGGGACTGTGGTCATCGT,0,1341202
furpa,0.08333333333333333,11,11,CGGGGAGAATTTTCGCATTA,0,1310739
furpa,0.08333333333333333,11,11,CGGGCGGTCGGGGGGTTCGT,0,1293330
furpa,0.08333333333333333,11,11,CGGGAAGGAATAGATTTGCC,0,1299381
furpa,0.08333333333333333,11,11,CGGCTCTTATACGTGGAAGG,0,1275262
furpa,0.08333333333333333,11,11,CGGCTAGTCGCCCCGCCGAC,0,1278766
furpa,0.08333333333333333,11,11,CGGCGTCTTCCGGAATAGAA,0,1313203
furpa,0.08333333333333333,11,11,CGGCAACTGTACATAAGTAC,0,1315895
furpa,0.08333333333333333,11,11,CGCGATGCACTCCTAAGTAT,0,1307488
furpa,0.08333333333333333,11,11,CGCCTAGATCCGTCATCGGG,0,1350885
furpa,0.08333333333333333,11,11,CGCACACAGAATCCATCGGT,0,1349089
furpa,0.08333333333333333,11,11,CGATGCTTAGTCCGCATCTA,0,1306869
furpa,0.08333333333333333,11,11,CGATATAGAGGCGGTCGCCT,0,1326236
furpa,0.08333333333333333,11,11,CGAGTGGCTTGGGTGCTGGG,0,1348128
furpa,0.08333333333333333,11,11,CGAGCGGCTCCCCGCGTACC,0,1343137
furpa,0.08333333333333333,11,11,CGACTTTACGACCGCCCCCT,0,1311696
furpa,0.08333333333333333,11,11,CGACTAGCCCGTCACTAGCA,0,1341880
furpa,0.08333333333333333,11,11,CGACAACTAACCGCCACCCA,0,1318531
furpa,0.08333333333333333,11,11,CGAAGACGCATCGATTAGCC,0,1301419
furpa,0.08333333333333333,11,11,CGAACCACAATCGTGACCGA,0,1281353
furpa,0.08333333333333333,11,11,CCTTAGGCGGCCGATTACCA,0,1330389
furpa,0.08333333333333333,11,11,CCTGGCGAATTCTTTGCGTC,0,1353927
furpa,0.08333333333333333,11,11,CCTGAATATGTTACCAGAAC,0,1343447
furpa,0.08333333333333333,11,11,CCGTAAGGCACACACTCAAC,0,1328864
furpa,0.08333333333333333,11,11,CCGGAGGAGGCGTTGAGTCT,0,1305944
furpa,0.08333333333333333,11,11,CCGCTTTTCAATTTGTTTGG,0,1353708
furpa,0.08333333333333333,11,11,CCGCCCCAGTGCGCGTTAAT,0,1281268
furpa,0.08333333333333333,11,11,CCGCATATGGCGGTCTCTGC,0,1349638
furpa,0.08333333333333333,11,11,CCGAATGTAAGCTACTTCTG,0,1273752
furpa,0.08333333333333333,11,11,CCCTTGAGCCCTAACTGACC,0,1345138
furpa,0.08333333333333333,11,11,CCCTCTTAGGGACCGTATGG,0,1346462
furpa,0.08333333333333333,11,11,CCCTCCGGTGTGAACCCGTT,0,1303738
furpa,0.08333333333333333,11,11,CCCTCATGACTTCCGAATTG,0,1330410
furpa,0.08333333333333333,11,11,CCCGGTTACAAAGCACTCTC,0,1324765
furpa,0.08333333333333333,11,11,CCCGCATCAGACGTATGGAA,0,1349837
furpa,0.08333333333333333,11,11,CCATTTCCCAGGAGGGATAG,0,1298828
furpa,0.08333333333333333,11,11,CCAGATTCCATGAGAATAAA,0,1345861
furpa,0.08333333333333333,11,11,CCAGATATATCTGATTATTT,0,1272652
furpa,0.08333333333333333,11,11,CCAGAGCATGAGGGTTAGTC,0,1290315
furpa,0.08333333333333333,11,11,CCAAAACAAGGGGATGCCCG,0,1310730
furpa,0.08333333333333333,11,11,CATGTGTCAAAGCTGAGCCC,0,1293144
furpa,0.08333333333333333,11,11,CATGTCTACAACGGAAAATG,0,1318253
furpa,0.08333333333333333,11,11,CATCTTGTGACTCTAATTCA,0,1310153
furpa,0.08333333333333333,11,11,CATCTGGCTACCGACTAGGC,0,1339032
furpa,0.08333333333333333,11,11,CATCCGTATAAGAGGCCAAA,0,1312934
furpa,0.08333333333333333,11,11,CATCAGTCGGCTTCGCGACA,0,1282185
furpa,0.08333333333333333,11,11,CATCAGCCATTTACTTGGTT,0,1327852
furpa,0.08333333333333333,11,11,CATAGCGCAGGTGTCGGCGT,0,1330277
furpa,0.08333333333333333,11,11,CAGTGGATCAACTGGGTCTA,0,1282746
furpa,0.08333333333333333,11,11,CAGTCTCGGGCTTACCAGGA,0,1279116
furpa,0.08333333333333333,11,11,CAGCCTTAACTCAGCGGGAA,0,1291641
furpa,0.08333333333333333,11,11,CAGCAGCCGACAATCTGTAC,0,1346198
furpa,0.08333333333333333,11,11,CAGAGTTTGACGGTAATGAT,0,1353366
furpa,0.08333333333333333,11,11,CAGACCGCAACGGGTGCCAA,0,1300538
furpa,0.08333333333333333,11,11,CAGAAGAATGGCCGTGAGAG,0,1277913
furpa,0.08333333333333333,11,11,CACTTCTAAATCGTCTAAAC,0,1337437
furpa,0.08333333333333333,11,11,CACTTAAGAGAGATCTCTCT,0,1356268
furpa,0.08333333333333333,11,11,CACTGGCGGCCACACTCGGT,0,1281264
furpa,0.08333333333333333,11,11,CACGGTTATGACAATCAGAT,0,1292800
furpa,0.08333333333333333,11,11,CACGATCAACGTTGGTAAGA,0,1286101
furpa,0.08333333333333333,11,11,CACCTGCCGATCCAACATCC,0,1344053
furpa,0.08333333333333333,11,11,CAATTTCGCCTCTTACAGTA,0,1301892
furpa,0.08333333333333333,11,11,CAATTTAAGAGTACGTATAA,0,1317724
furpa,0.08333333333333333,11,11,CAAGGTGTAAGTTGCTCATG,0,1293122
furpa,0.08333333333333333,11,11,CAAGGTAACCTCATAAAGTA,0,1299906
furpa,0.08333333333333333,11,11,CAAGCGGTTCCTGACATGTC,0,1315424
furpa,0.08333333333333333,11,11,CAAAGGCCATGCTGATGGCG,0,1308352
furpa,0.08333333333333333,11,11,ATTGATACGCCGGGCTTGTT,0,1328568
furpa,0.08333333333333333,11,11,ATGTGACGCCCGCTACATCA,0,1337393
furpa,0.08333333333333333,11,11,ATGTCGAATACGGGCGCACA,0,1339927
furpa,0.08333333333333333,11,11,ATGTCCCGCGCTCCTCATAA,0,1317077
furpa,0.08333333333333333,11,11,ATGGGTCATAGATAGCGCGG,0,1274936
furpa,0.08333333333333333,11,11,ATGGATGAATGGAATGATCC,0,1346347
furpa,0.08333333333333333,11,11,ATGCTACCAGCAAGCTCTGC,0,1307114
furpa,0.08333333333333333,11,11,ATGCGCTAATAGTCATTCGG,0,1320585
furpa,0.08333333333333333,11,11,ATGAGCGGTTACCGAACGGC,0,1319998
furpa,0.08333333333333333,11,11,ATGAACCCATCTCCGGCGCA,0,1282703
furpa,0.08333333333333333,11,11,ATGAACCACGCGTGGGCAAC,0,1273841
furpa,0.08333333333333333,11,11,ATCTGGTTGATGCAGTGGCT,0,1318826
furpa,0.08333333333333333,11,11,ATCTACCTAGACCGGTCTAA,0,1318990
furpa,0.08333333333333333,11,11,ATCGAGAGACGGGCAGGTAA,0,1348257
furpa,0.08333333333333333,11,11,ATCGAAGCTTCTGAACTCCT,0,1299944
furpa,0.08333333333333333,11,11,ATCCTCAGAGTGGTCTTCGT,0,1305533
furpa,0.08333333333333333,11,11,ATCCCGGATTGCTTCACGGT,0,1313713
furpa,0.08333333333333333,11,11,ATCCCCTCTCGTCGCGACTC,0,1305563
furpa,0.08333333333333333,11,11,ATCCAGGCGCTGCATTGCAT,0,1303020
furpa,0.08333333333333333,11,11,ATCAGTAGCCGGATGGTCTT,0,1328019
furpa,0.08333333333333333,11,11,ATCACTCTTCCCTACACGTA,0,1326195
furpa,0.08333333333333333,11,11,ATATACGCTCGGTACATCTT,0,1351588
furpa,0.08333333333333333,11,11,ATAGTTGTTTATTTTAGGAG,0,1338281
furpa,0.08333333333333333,11,11,ATAGCGTCGCCCCTATTATA,0,1295718
furpa,0.08333333333333333,11,11,ATACTGGTGCCGTATTCACC,0,1304196
furpa,0.08333333333333333,11,11,ATACACCCGGGATTCCTGCC,0,1324938
furpa,0.08333333333333333,11,11,AGTGACGCTGGTAGCGGGCG,0,1308094
furpa,0.08333333333333333,11,11,AGTCCCCTCTTCGAGACAGC,0,1319758
furpa,0.08333333333333333,11,11,AGTCATCTCGGCCAACGCAG,0,1271416
furpa,0.08333333333333333,11,11,AGTAAGAAGGTGTTTGGTGA,0,1336709
furpa,0.08333333333333333,11,11,AGGTGCACAATGAAAGGGCA,0,1333609
furpa,0.08333333333333333,11,11,AGGGCTCAGGTAAAACTCAG,0,1303023
furpa,0.08333333333333333,11,11,AGGGCTACAAGAAGGACCCA,0,1326711
furpa,0.08333333333333333,11,11,AGGGCGCCACAACGTACCGT,0,1329827
furpa,0.08333333333333333,11,11,AGGCTGCTGTTTTCAAGACA,0,1300042
furpa,0.08333333333333333,11,11,AGGCGTGGCACACAGGTAAT,0,1297298
furpa,0.08333333333333333,11,11,AGGCGGACGCCCTTAGATTC,0,1350469
furpa,0.08333333333333333,11,11,AGGCCAAAAATGGGCGTTTA,0,1319249
furpa,0.08333333333333333,11,11,AGGAAAATAAGGACTGGTCA,0,1321289
furpa,0.08333333333333333,11,11,AGCTATAGCTCCCCAATGGT,0,1318259
furpa,0.08333333333333333,11,11,AGCGCCTTCAAGGGGTCCGC,0,1287645
furpa,0.08333333333333333,11,11,AGCCGCTAGTATGAATTTGC,0,1297030
furpa,0.08333333333333333,11,11,AGCCCATGTCACCGCGGTTG,0,1272662
furpa,0.08333333333333333,11,11,AGCATTGATTAACACTTAGT,0,1282468
furpa,0.08333333333333333,11,11,AGCATGAGTACCTTGGCTTC,0,1304577
furpa,0.08333333333333333,11,11,AGCATATCGGGATCCACCCA,0,1324446
furpa,0.08333333333333333,11,11,AGCACGTGGAGGGGAACCTT,0,1293329
furpa,0.08333333333333333,11,11,AGCAAATGCCGCATCACGGA,0,1291365
furpa,0.08333333333333333,11,11,AGAGTTACGCAACCGGATGC,0,1293989
furpa,0.08333333333333333,11,11,AGAGAATTCGTCGCTCGTGA,0,1301276
furpa,0.08333333333333333,11,11,AGAGAATGTTCGGGGCGGTA,0,1301586
furpa,0.08333333333333333,11,11,AGAGAAATTCGGCCCAGGAA,0,1298717
furpa,0.08333333333333333,11,11,AGAATTAGAGCTTGAGCCAA,0,1339490
furpa,0.08333333333333333,11,11,ACTTTGTCGAAATTTTCATC,0,1278936
furpa,0.08333333333333333,11,11,ACTGGCGCGTCCCAAGGTCT,0,1334282
furpa,0.08333333333333333,11,11,ACTCGGGACCCCTAGAAGAA,0,1342818
furpa,0.08333333333333333,11,11,ACTCACCTTGCGCAGAGACC,0,1334254
furpa,0.08333333333333333,11,11,ACTAGGGCGAGCGTACGCCA,0,1298507
furpa,0.08333333333333333,11,11,ACTAGCCTAAGTTGGAAGCT,0,1344823
furpa,0.08333333333333333,11,11,ACTAACCCCAGGTTGAGTGT,0,1349168
furpa,0.08333333333333333,11,11,ACTAACATCCATGTTGTGAT,0,1347133
furpa,0.08333333333333333,11,11,ACGTTTCCGACACTTGGGAC,0,1309674
furpa,0.08333333333333333,11,11,ACGGTCTCTTGTACAGGCCT,0,1312009
furpa,0.08333333333333333,11,11,ACGGTCTACCGCCAACGGAA,0,1289717
furpa,0.08333333333333333,11,11,ACGGTCGCAGCGCGGCCAGT,0,1351155
furpa,0.08333333333333333,11,11,ACGGGTTTTCCGCCTGCAAG,0,1284937
furpa,0.08333333333333333,11,11,ACGGGCATGTATGCAGTTAT,0,1301790
furpa,0.08333333333333333,11,11,ACGCGCCATAGTTGGCTCTA,0,1338372
furpa,0.08333333333333333,11,11,ACGCACCCGCAACGGCGCGG,0,1318837
furpa,0.08333333333333333,11,11,ACCTGGCATGCTTGATTTAT,0,1338014
furpa,0.08333333333333333,11,11,ACCTAGTAACAGCTCTTTGC,0,1324307
furpa,0.08333333333333333,11,11,ACCATACATTTTACCCACCT,0,1325462
furpa,0.08333333333333333,11,11,ACCACAAGCATGGGGCTCGG,0,1274598
furpa,0.08333333333333333,11,11,ACCAAGGGGAAACTACCATA,0,1326399
furpa,0.08333333333333333,11,11,ACAGGCATTGACACTCGTTT,0,1286469
furpa,0.08333333333333333,11,11,ACAGCCCTTTCGTCCGGCCC,0,1344389
furpa,0.08333333333333333,11,11,ACAGATGAAGAGGATATGCT,0,1290614
furpa,0.08333333333333333,11,11,ACACTTCTCTAGGACTAACT,0,1302493
furpa,0.08333333333333333,11,11,ACACGCTCCAGAACGCCTCT,0,1303018
furpa,0.08333333333333333,11,11,ACACCCCGTGCGATCCAGTC,0,1348289
furpa,0.08333333333333333,11,11,ACAATCGTCACGGAGAGTAG,0,1289964
furpa,0.08333333333333333,11,11,ACAACGATTAGACGTCTCAC,0,1282075
furpa,0.08333333333333333,11,11,ACAAAAGCACCATCTACATG,0,1332721
furpa,0.08333333333333333,11,11,AATTATCAGGCTGATCAGCA,0,1274707
furpa,0.08333333333333333,11,11,AATGGGTGCAATCATAGTCC,0,1322635
furpa,0.08333333333333333,11,11,AATGACATAAACTTGGGTGG,0,1350197
furpa,0.08333333333333333,11,11,AATCTTACCAACAATAGCCC,0,1301888
furpa,0.08333333333333333,11,11,AATCGTGCGAGCACCGCAAA,0,1333921
furpa,0.08333333333333333,11,11,AATCCAAATTCCCTACTGGA,0,1340366
furpa,0.08333333333333333,11,11,AATATTAATTGCGCCGACCT,0,1299307
furpa,0.08333333333333333,11,11,AATAGAGATGCGAGTCGTAC,0,1303400
furpa,0.08333333333333333,11,11,AAGGTCAGGGGTCGATTTGG,0,1336951
furpa,0.08333333333333333,11,11,AAGGTAAGGTCCTTTTTATC,0,1301831
furpa,0.08333333333333333,11,11,AAGGGAGGCGCTTTTTTCTA,0,1340675
furpa,0.08333333333333333,11,11,AAGGCAGATGCAAAACAATT,0,1340365
furpa,0.08333333333333333,11,11,AAGCGGTGAGTATCATGCGA,0,1344153
furpa,0.08333333333333333,11,11,AAGCCGCCATACTTCCATTC,0,1296184
furpa,0.08333333333333333,11,11,AACTTTAGAGCAACCGTTCT,0,1334903
furpa,0.08333333333333333,11,11,AACTTAACGAAAGTAACTAT,0,1352080
furpa,0.08333333333333333,11,11,AACTGTTGTCTGCAATTGAA,0,1311928
furpa,0.08333333333333333,11,11,AACTGGATTGGTTGGGTAGG,0,1333119
furpa,0.08333333333333333,11,11,AACGTTTTCTCCATGTGTCA,0,1356733
furpa,0.08333333333333333,11,11,AACCGACACGCTGCTACGAG,0,1284576
furpa,0.08333333333333333,11,11,AACAGGTAACAGCTCCACTC,0,1295721
furpa,0.08333333333333333,11,11,AACACCGGTCTAGTTAATCT,0,1311936
furpa,0.08333333333333333,11,11,AAATATATCCGTCATCGTAT,0,1309913
furpa,0.08333333333333333,11,11,AAAGGCCACCGGCGGCTCGG,0,1278596
furpa,0.08333333333333333,11,11,AAACGCCGATGAATCCACTG,0,1308493
furpa,0.08333333333333333,11,11,AAAACGGGCTTGAAGGACAA,0,1340556
furpa,0.08333333333333333,11,11,AAAACGACACAGAGGCGTGC,0,1275288
furpa,0.08333333333333333,11,11,AAAACACGAATCTGATGAAG,0,1333519
furpa,0.09090909090909091,10,10,TTTTCTTTTTTTTTGCGCTA,0,1307519
furpa,0.09090909090909091,10,10,TTTTAGGTGGAAAGATCGGG,0,1281127
furpa,0.09090909090909091,10,10,TTTGAGTCTAGGGTTAGTAT,0,1296746
furpa,0.09090909090909091,10,10,TTTAGGGGGCACTTATATCA,0,1306168
furpa,0.09090909090909091,10,10,TTTAAAAGGCATGGGATATT,0,1297378
furpa,0.09090909090909091,10,10,TTGGTGTTTCAGTGCAATGT,0,1318239
furpa,0.09090909090909091,10,10,TTGCATAAACGTCATATAAA,0,1332408
furpa,0.09090909090909091,10,10,TTGCACCGTGGGGGTTATTG,0,1340067
furpa,0.09090909090909091,10,10,TTGAGTTGAATACAGGCGGA,0,1319374
furpa,0.09090909090909091,10,10,TTGAGGTTGGCAGACCGGCC,0,1327981
furpa,0.09090909090909091,10,10,TTGACTCCTGGCCCAATGGT,0,1293446
furpa,0.09090909090909091,10,10,TTGACGATAAAAGTGAGAAG,0,1316263
furpa,0.09090909090909091,10,10,TTCTCTATTTTCCGCGTAAC,0,1351787
furpa,0.09090909090909091,10,10,TTCTAGACGTGGGTTCTAAG,0,1353321
furpa,0.09090909090909091,10,10,TTCTAATGGCTTTGCGGCTT,0,1335351
furpa,0.09090909090909091,10,10,TTCGTTGTCCTTAGGCCACA,0,1356802
furpa,0.09090909090909091,10,10,TTCGCCTGTTGGGGGGGGAT,0,1326396
furpa,0.09090909090909091,10,10,TTCGATGTAGCACGTCTAAT,0,1275646
furpa,0.09090909090909091,10,10,TTCGATGCGGACAACTCACT,0,1321628
furpa,0.09090909090909091,10,10,TTCGAAAACTCCTACCGACA,0,1302180
furpa,0.09090909090909091,10,10,TTCATCCACAGCACGGCTGT,0,1323102
furpa,0.09090909090909091,10,10,TTCATCACGGGCATTATCCA,0,1349989
furpa,0.09090909090909091,10,10,TTCATATTTCGTGGCAGGGG,0,1352124
furpa,0.09090909090909091,10,10,TTCATAAGTATGAGAGTTCA,0,1325241
furpa,0.09090909090909091,10,10,TTAGTTTCACATTTTACCAC,0,1342698
furpa,0.09090909090909091,10,10,TTAGTGCGCACCTTTGGCCA,0,1311930
furpa,0.09090909090909091,10,10,TTAGTCACAAAGTCGTAGTA,0,1313890
furpa,0.09090909090909091,10,10,TTAGGTGCATAGATGTCTCG,0,1352709
furpa,0.09090909090909091,10,10,TTACTAAGTGCAGTAACTTA,0,1325122
furpa,0.09090909090909091,10,10,TTACCAGAATTCTATGCTAG,0,1352536
furpa,0.09090909090909091,10,10,TTAATTGTCTGGGTTTGATT,0,1313786
furpa,0.09090909090909091,10,10,TTAAAAGTTTTACGTATACC,0,1292241
furpa,0.09090909090909091,10,10,TTAAAAATCAAGATAGCCAT,0,1353919
furpa,0.09090909090909091,10,10,TGTTGTCTGATGCATTACCC,0,1304371
furpa,0.09090909090909091,10,10,TGTTCGACTAAAGCGAGAGA,0,1338515
furpa,0.09090909090909091,10,10,TGTTCGACCCGTGAGTCCCC,0,1342469
furpa,0.09090909090909091,10,10,TGTTAGATGCCTAAGGGTTA,0,1301939
furpa,0.09090909090909091,10,10,TGTTACAAGTGCTATACATT,0,1354582
furpa,0.09090909090909091,10,10,TGTGTCCAATCTGATCGGAT,0,1293510
furpa,0.09090909090909091,10,10,TGTACTTGGTACCGGAAGGA,0,1341752
furpa,0.09090909090909091,10,10,TGTACGCTGCCAATCAATGT,0,1318910
furpa,0.09090909090909091,10,10,TGGTTCGTGTTCACTGCGGC,0,1279172
furpa,0.09090909090909091,10,10,TGGTTCCCAGTCCATAGGTC,0,1344332
furpa,0.09090909090909091,10,10,TGGTTAGTTAATTAGATCAT,0,1355186
furpa,0.09090909090909091,10,10,TGGTTACATTCGTGGGGTGT,0,1321055
furpa,0.09090909090909091,10,10,TGGGGTACTCAGCGGAAGAG,0,1312381
furpa,0.09090909090909091,10,10,TGGGCTCTCAGGTTAAGCCT,0,1341499
furpa,0.09090909090909091,10,10,TGGGCGCGTGTGAGAGGTGA,0,1294329
furpa,0.09090909090909091,10,10,TGGCGTCGTTTATTAGGATT,0,1294230
furpa,0.09090909090909091,10,10,TGGCAGGCCCGGTGATAAAC,0,1339924
furpa,0.09090909090909091,10,10,TGGATTAAAGATGCGCAAGA,0,1294089
furpa,0.09090909090909091,10,10,TGGATAAACGGCCAAGCCAT,0,1318988
furpa,0.09090909090909091,10,10,TGGAGTGGGAAAGGTTACAT,0,1293580
furpa,0.09090909090909091,10,10,TGCTGGAGTGCCAAGTAACT,0,1302647
furpa,0.09090909090909091,10,10,TGCTGACGTTGACCTCGAAA,0,1271829
furpa,0.09090909090909091,10,10,TGCGTTAGTTAGCCATTGCG,0,1321408
furpa,0.09090909090909091,10,10,TGCGTGCACCCACCAATACA,0,1354840
furpa,0.09090909090909091,10,10,TGCGGTTCACTGGCCAGAGT,0,1345396
furpa,0.09090909090909091,10,10,TGCGGTATGGTCATGACGGT,0,1325478
furpa,0.09090909090909091,10,10,TGCGAGCCACCTCTATGCTT,0,1353294
furpa,0.09090909090909091,10,10,TGCCGGAGAAAGAATCGTCT,0,1323147
furpa,0.09090909090909091,10,10,TGCCACTTGGAGGGTGACGG,0,1300789
furpa,0.09090909090909091,10,10,TGCCAAATGTTTGTAAGGGA,0,1311500
furpa,0.09090909090909091,10,10,TGCAGTCACAATGAAGCGAT,0,1316335
furpa,0.09090909090909091,10,10,TGCAGTAAGACGCACAGGTG,0,1342826
furpa,0.09090909090909091,10,10,TGCAGGCCTTTCGTACCATC,0,1281364
furpa,0.09090909090909091,10,10,TGCACGAGCCACTGCGCTAT,0,1357478
furpa,0.09090909090909091,10,10,TGATCTTACCAGTATTGTAA,0,1330421
furpa,0.09090909090909091,10,10,TGAGGCGGCCGTGGTTGACA,0,1331742
furpa,0.09090909090909091,10,10,TGAGGATAATGGGCTTTGGA,0,1299534
furpa,0.09090909090909091,10,10,TGAGCGGGGTAAGTATATGG,0,1307989
furpa,0.09090909090909091,10,10,TGACAAAAATCCGGCAGTCA,0,1339551
furpa,0.09090909090909091,10,10,TGAATCACTCTGCAAGCGTC,0,1299965
furpa,0.09090909090909091,10,10,TGAAGAACTACTCCCTCTGA,0,1324788
furpa,0.09090909090909091,10,10,TGAACGTCTGACCGTGTCAA,0,1278137
furpa,0.09090909090909091,10,10,TGAACAGTTTCCTAATCCTG,0,1339572
furpa,0.09090909090909091,10,10,TGAACACAGGTCCTACCCGG,0,1306923
furpa,0.09090909090909091,10,10,TGAACAATGCATTAGTAGAT,0,1305684
furpa,0.09090909090909091,10,10,TCTTGGGTCGCTTTTGCGTG,0,1312540
furpa,0.09090909090909091,10,10,TCTTGCCACGTTAGCGAGTT,0,1344634
furpa,0.09090909090909091,10,10,TCTGATAGGGACCGTCCGCT,0,1297352
furpa,0.09090909090909091,10,10,TCTCAGCTCCTAGCGATCGT,0,1273198
furpa,0.09090909090909091,10,10,TCTAGTTACGTTATAGGGAC,0,1294396
furpa,0.09090909090909091,10,10,TCGGGGGGCTGCGGGGCCGA,0,1294541
furpa,0.09090909090909091,10,10,TCGGATCTGCAGTAAAAATC,0,1348335
furpa,0.09090909090909091,10,10,TCGGAACTTATCGATTCGTT,0,1330648
furpa,0.09090909090909091,10,10,TCGCTAACCATGATTTAGGA,0,1309738
furpa,0.09090909090909091,10,10,TCGACTTGGAGCCGGTGTGG,0,1286839
furpa,0.09090909090909091,10,10,TCGACAGGCCATAAATTGCT,0,1310528
furpa,0.09090909090909091,10,10,TCGAAGCGTACAAGGGCGAG,0,1328877
furpa,0.09090909090909091,10,10,TCCGCATACATACACTACCA,0,1346902
furpa,0.09090909090909091,10,10,TCCCCCCAAGCCAAGTACGC,0,1316442
furpa,0.09090909090909091,10,10,TCCATTCCTGGACCTTCGTA,0,1292373
furpa,0.09090909090909091,10,10,TCCAGACTATCCTAGGTACA,0,1309308
furpa,0.09090909090909091,10,10,TCCAAAGTCAAGCATGGGTC,0,1295214
furpa,0.09090909090909091,10,10,TCCAAAACTTAGCACCACAT,0,1341667
furpa,0.09090909090909091,10,10,TCATATTCGCACCCTGAGAT,0,1297420
furpa,0.09090909090909091,10,10,TCATACTTCCTGTGGTAATA,0,1284535
furpa,0.09090909090909091,10,10,TCATACCATCCAGTGTTTAC,0,1346617
furpa,0.09090909090909091,10,10,TCACGGACGCATAATCGACA,0,1351923
furpa,0.09090909090909091,10,10,TCACCTGAGGACTTGGTTAG,0,1301646
furpa,0.09090909090909091,10,10,TCAAGCTTCGTGCGCTCCTA,0,1301508
furpa,0.09090909090909091,10,10,TATTCGTGGGCCTGTACCGG,0,1309429
furpa,0.09090909090909091,10,10,TATTCCGTCCGTAAAGCTGA,0,1292292
furpa,0.09090909090909091,10,10,TATTATAACGATGGTTTGCC,0,1343835
furpa,0.09090909090909091,10,10,TATTAATCACCATTCAGCAA,0,1278582
furpa,0.09090909090909091,10,10,TATTAAGTGGCTAGAGAGAT,0,1340071
furpa,0.09090909090909091,10,10,TATAATTCTCCTGAATAGCA,0,1324573
furpa,0.09090909090909091,10,10,TAGGTCCTTCTTTGCGCTGC,0,1309114
furpa,0.09090909090909091,10,10,TAGGGTCATAACTCCAGGTA,0,1302122
furpa,0.09090909090909091,10,10,TAGGCTATAGTTCGGTTCCC,0,1306827
furpa,0.09090909090909091,10,10,TAGGATGGTTTAAGGAATAT,0,1347716
furpa,0.09090909090909091,10,10,TAGGAAGAACTTGTACGATG,0,1336264
furpa,0.09090909090909091,10,10,TAGCTAGGATGAGTGAGTCA,0,1337753
furpa,0.09090909090909091,10,10,TAGCGTGCGTACACTTTGTT,0,1337240
furpa,0.09090909090909091,10,10,TAGAGCAGCAATTGGACCCG,0,1320641
furpa,0.09090909090909091,10,10,TACGTTCTTGCGATAGTAAA,0,1341404
furpa,0.09090909090909091,10,10,TACGACATTACAGAGGTGAA,0,1310936
furpa,0.09090909090909091,10,10,TACGAACACGGCCAAAGCAA,0,1296547
furpa,0.09090909090909091,10,10,TACCTTACAGCGCCTAATGT,0,1357124
furpa,0.09090909090909091,10,10,TACAGTTGGGTTATCTTCGG,0,1282117
furpa,0.09090909090909091,10,10,TACAGTTCGGTACCGATCGC,0,1292259
furpa,0.09090909090909091,10,10,TACAGGAAAGGGGGAGTATC,0,1336818
furpa,0.09090909090909091,10,10,TAATGGGGCTAGTCTGTCTG,0,1274569
furpa,0.09090909090909091,10,10,TAAGTAACGACAAAGGGATG,0,1292057
furpa,0.09090909090909091,10,10,TAAGACCGTATTATCCGCAG,0,1302332
furpa,0.09090909090909091,10,10,TAACTACAGGTCACGCCGAA,0,1274529
furpa,0.09090909090909091,10,10,TAAATTTGATCGTGCCTAAG,0,1351775
furpa,0.09090909090909091,10,10,TAAAGCCGAGACGTACTTAA,0,1293913
furpa,0.09090909090909091,10,10,TAAACTTCCCACTCACTGAT,0,1341621
furpa,0.09090909090909091,10,10,TAAAAGAGCTTCTTATTCTG,0,1304231
furpa,0.09090909090909091,10,10,GTTTGGTTCGGTCCGTTGAA,0,1285832
furpa,0.09090909090909091,10,10,GTTTAGTTCTGACGAAACGT,0,1335466
furpa,0.09090909090909091,10,10,GTTTAGGGATATCCCATATA,0,1307574
furpa,0.09090909090909091,10,10,GTTTAGCCGGCTATCAGGGA,0,1334857
furpa,0.09090909090909091,10,10,GTTGCCTATGGTCCGCGACA,0,1285837
furpa,0.09090909090909091,10,10,GTTCGCTCAGATATCATATC,0,1321444
furpa,0.09090909090909091,10,10,GTTACGCTAAGGACGACTAC,0,1333198
furpa,0.09090909090909091,10,10,GTTACCCTGTTAAACGAGCG,0,1333742
furpa,0.09090909090909091,10,10,GTTAAGCCGAAACGAGGACT,0,1307830
furpa,0.09090909090909091,10,10,GTTAAGAGGTGGGTTGAGCA,0,1341818
furpa,0.09090909090909091,10,10,GTGTGAGCTTCTAAGAATAA,0,1276091
furpa,0.09090909090909091,10,10,GTGTCCCTCCATGGAAATGC,0,1317539
furpa,0.09090909090909091,10,10,GTGGAAACTCGAGAACGAAG,0,1315869
furpa,0.09090909090909091,10,10,GTGCGATCGCGGGGGCTACA,0,1324937
furpa,0.09090909090909091,10,10,GTGCCGCTGCCGCAAGAGGT,0,1293849
furpa,0.09090909090909091,10,10,GTGCATGGTCAGAAACGAGG,0,1275872
furpa,0.09090909090909091,10,10,GTGATATTAAGGAGGAAAAA,0,1279366
furpa,0.09090909090909091,10,10,GTCTGGCTGGGGGGGGTTAT,0,1349043
furpa,0.09090909090909091,10,10,GTCTATTGGAAGGTACCCCT,0,1331764
furpa,0.09090909090909091,10,10,GTCCGGAAGCCCTGGCGATT,0,1307237
furpa,0.09090909090909091,10,10,GTCCGAACTTGATCGGATTC,0,1335567
furpa,0.09090909090909091,10,10,GTCCAATCTGCCTTTATACA,0,1302125
furpa,0.09090909090909091,10,10,GTCATAGCGTAAATCGTTGG,0,1309597
furpa,0.09090909090909091,10,10,GTCAATTGGCTGAGCGCAAG,0,1289813
furpa,0.09090909090909091,10,10,GTCAATATTTCCACAGGGCT,0,1346907
furpa,0.09090909090909091,10,10,GTATGACGCGTCGCAGAAAT,0,1340082
furpa,0.09090909090909091,10,10,GTAGCCGCGTTTCCCAGGCT,0,1296749
furpa,0.09090909090909091,10,10,GTACCTATAAGGAGGTGTTT,0,1295514
furpa,0.09090909090909091,10,10,GTACAACAAACAGACTTTTT,0,1276473
furpa,0.09090909090909091,10,10,GTAATGTTTACCGCCACGGA,0,1350106
furpa,0.09090909090909091,10,10,GTAAGCTCTAAATCTCGACA,0,1285649
furpa,0.09090909090909091,10,10,GTAACAGCGCTCCGGGATTA,0,1277135
furpa,0.09090909090909091,10,10,GGTGCGGGGCACTGATTATA,0,1295371
furpa,0.09090909090909091,10,10,GGTCCTATACAGGAGCATTA,0,1326097
furpa,0.09090909090909091,10,10,GGTCCGGTAGACACTGTTCG,0,1279023
furpa,0.09090909090909091,10,10,GGTCCGAGCCTCTGGTGATA,0,1301209
furpa,0.09090909090909091,10,10,GGTCAGGGGAGATAAACGCA,0,1305394
furpa,0.09090909090909091,10,10,GGTCACGTAAGAGCTCTCCG,0,1276979
furpa,0.09090909090909091,10,10,GGTCAATGACTGCACTGCGA,0,1276681
furpa,0.09090909090909091,10,10,GGGTTTATATAAACAACGGC,0,1343975
furpa,0.09090909090909091,10,10,GGGGTTGTCGTATGGTCGCA,0,1335932
furpa,0.09090909090909091,10,10,GGGGAGCGCGCATAGGCCAG,0,1321969
furpa,0.09090909090909091,10,10,GGGCTTATGTTTCCAAGCGC,0,1278506
furpa,0.09090909090909091,10,10,GGGCTCCGCGCACCGTTAAG,0,1303356
furpa,0.09090909090909091,10,10,GGGCTCACATAGCGGACGTC,0,1283880
furpa,0.09090909090909091,10,10,GGGCGACCCAGTCACGGCTA,0,1303897
furpa,0.09090909090909091,10,10,GGGAGGGGGTCGATCCTCCA,0,1275716
furpa,0.09090909090909091,10,10,GGGAGGACAAATATGTTCGC,0,1344151
furpa,0.09090909090909091,10,10,GGGAGACCTACCTAGGGAAT,0,1298677
furpa,0.09090909090909091,10,10,GGGACTAAGGCATCTGACAG,0,1279849
furpa,0.09090909090909091,10,10,GGCTCATTCCAAAGTGGGGA,0,1310215
furpa,0.09090909090909091,10,10,GGCTAATGCGAACGTACATT,0,1282938
furpa,0.09090909090909091,10,10,GGCGGTCAGGCTCCATATAT,0,1329627
furpa,0.09090909090909091,10,10,GGCGGCGCAACTGCGCCAGC,0,1320450
furpa,0.09090909090909091,10,10,GGCGCCCCTATTGATCAGAG,0,1333249
furpa,0.09090909090909091,10,10,GGCACTGTATCGGTGGGTGT,0,1285708
furpa,0.09090909090909091,10,10,GGCAACCCCTAAATCCCTGC,0,1296831
furpa,0.09090909090909091,10,10,GGCAAATCGCGCAACATCAT,0,1308112
furpa,0.09090909090909091,10,10,GGATGCTGTTTCGGTTTTGA,0,1286485
furpa,0.09090909090909091,10,10,GGAGGTATTTCCTAGATTGT,0,1343645
furpa,0.09090909090909091,10,10,GGAGCGAGAACTTCACGAGT,0,1319769
furpa,0.09090909090909091,10,10,GGACGTGCTAAATCCTACTA,0,1274273
furpa,0.09090909090909091,10,10,GGAATGTCAAAATCATTATT,0,1296598
furpa,0.09090909090909091,10,10,GGAATGCCTATAGTTCGCAA,0,1342197
furpa,0.09090909090909091,10,10,GGAAGGGTGTACCCCCTAAA,0,1276453
furpa,0.09090909090909091,10,10,GGAAGCAGATACAAAACCAA,0,1279158
furpa,0.09090909090909091,10,10,GCTGGGGGGCTGTAACAATA,0,1287166
furpa,0.09090909090909091,10,10,GCTGCCCGTTGCCTATGAGT,0,1319901
furpa,0.09090909090909091,10,10,GCTCTCGCGATAGACGTGCC,0,1283545
furpa,0.09090909090909091,10,10,GCTAGCAATTTGAACGAGGG,0,1297945
furpa,0.09090909090909091,10,10,GCTAAAGACTAGACAACCGA,0,1303266
furpa,0.09090909090909091,10,10,GCGTTTCCAGCTAGCTCACT,0,1271659
furpa,0.09090909090909091,10,10,GCGTGGATCGGAGAATTAAC,0,1331979
furpa,0.09090909090909091,10,10,GCGTCACCCAAAATCGGGAG,0,1325900
furpa,0.09090909090909091,10,10,GCGGTAGATATGGCAGTGGG,0,1354058
furpa,0.09090909090909091,10,10,GCGGGGTTCTAGTTAATACA,0,1285770
furpa,0.09090909090909091,10,10,GCGCGACGCGAGGATACGCA,0,1308067
furpa,0.09090909090909091,10,10,GCGCCTCAATTGAAGTCGGA,0,1344049
furpa,0.09090909090909091,10,10,GCGATTCACAATCCCCGGAC,0,1320788
furpa,0.09090909090909091,10,10,GCGACCATTGATCTGCGGCT,0,1292261
furpa,0.09090909090909091,10,10,GCCTGCTCAACTCAACGCCA,0,1299580
furpa,0.09090909090909091,10,10,GCCTATGACTTCTATTGTAT,0,1326023
furpa,0.09090909090909091,10,10,GCCGGGGTTGACGGTAGAAC,0,1344872
furpa,0.09090909090909091,10,10,GCCCCCATAATCTCATGACC,0,1300285
furpa,0.09090909090909091,10,10,GCCAGGCTGCGTCTGTCTTA,0,1300472
furpa,0.09090909090909091,10,10,GCCAAACGGCATGTGCGTAC,0,1314131
furpa,0.09090909090909091,10,10,GCCAAACCGAAGCTCGGCCC,0,1352299
furpa,0.09090909090909091,10,10,GCAGCGTGAAACGATGCGTA,0,1347202
furpa,0.09090909090909091,10,10,GCAGCGGGCTGGGGTCATGT,0,1328292
furpa,0.09090909090909091,10,10,GCACCGCTTAAGAGCCAAAT,0,1303174
furpa,0.09090909090909091,10,10,GCACACTATACTGAGCATTG,0,1345024
furpa,0.09090909090909091,10,10,GCAAGTGGGGTGGGGCAGCG,0,1291516
furpa,0.09090909090909091,10,10,GATTGTTCAGGGGAGGGCAC,0,1290752
furpa,0.09090909090909091,10,10,GATTGCCACCTACGGCTGTG,0,1315210
furpa,0.09090909090909091,10,10,GATTGACTTCGGATATAATA,0,1355289
furpa,0.09090909090909091,10,10,GATGTATCTGAGTGTCGATC,0,1292601
furpa,0.09090909090909091,10,10,GATCTTCAACGAAATCAACC,0,1272319
furpa,0.09090909090909091,10,10,GATCTACCGCAAGGGATTAC,0,1326221
furpa,0.09090909090909091,10,10,GATCCTGTCCTGCGCATCAG,0,1337360
furpa,0.09090909090909091,10,10,GATAAGTTACTTAGTACTAT,0,1303190
furpa,0.09090909090909091,10,10,GATAACGACATCAGTTGTCA,0,1288736
furpa,0.09090909090909091,10,10,GATAAATCGGGTCTAATTAC,0,1312780
furpa,0.09090909090909091,10,10,GAGTGTGGGGCTCAAAGAAA,0,1327443
furpa,0.09090909090909091,10,10,GAGCGATCTTAGGCATTTTG,0,1272907
furpa,0.09090909090909091,10,10,GAGCAAACTTTCCACCGGCG,0,1292152
furpa,0.09090909090909091,10,10,GACGGGCTTCGAGGGGAGAA,0,1322629
furpa,0.09090909090909091,10,10,GACGCTCCGGACATGCGGGA,0,1299771
furpa,0.09090909090909091,10,10,GACGACTCAGCCTTTTCGCA,0,1354145
furpa,0.09090909090909091,10,10,GACGAAATGCTCCCGTAACG,0,1341899
furpa,0.09090909090909091,10,10,GACCCCGGTGACAAGGACCG,0,1302955
furpa,0.09090909090909091,10,10,GACATGTAGCTTGTGAGAGA,0,1348322
furpa,0.09090909090909091,10,10,GACACCTAGTTGCATCGGAG,0,1297266
furpa,0.09090909090909091,10,10,GACAATCATTAAGTGGAGGT,0,1324753
furpa,0.09090909090909091,10,10,GAATTTGCTATGTAGGCTAA,0,1314206
furpa,0.09090909090909091,10,10,GAATTGAGTTAACGGACGTT,0,1349179
furpa,0.09090909090909091,10,10,GAATTAGGAGGCCGTCTTCA,0,1279391
furpa,0.09090909090909091,10,10,GAATGTTCGGGTCTGAAGAG,0,1309396
furpa,0.09090909090909091,10,10,GAAGAGAAGCAGCGGGCGTA,0,1299810
furpa,0.09090909090909091,10,10,GAACTGGGGCTTGAAGATCC,0,1271190
furpa,0.09090909090909091,10,10,GAACGAGTGTTGCTGTTGGG,0,1285361
furpa,0.09090909090909091,10,10,GAAAGTGAAGCGAAGAGGAT,0,1317691
furpa,0.09090909090909091,10,10,GAAAGTAACCGGGAGCATCT,0,1298577
furpa,0.09090909090909091,10,10,GAAAGGAGTTATCTTGGCCA,0,1315182
furpa,0.09090909090909091,10,10,GAAAGATACCAGTCAAGTCT,0,1305475
furpa,0.09090909090909091,10,10,GAAAGAAGCCGTTACTTAAA,0,1299114
furpa,0.09090909090909091,10,10,GAAACTTCGAATTGCCGGTT,0,1315027
furpa,0.09090909090909091,10,10,GAAACATGGGGGCGATGTTC,0,1342730
furpa,0.09090909090909091,10,10,GAAACAACTGGGCAGGGGGA,0,1342706
furpa,0.09090909090909091,10,10,CTTTTTAGTTAAGTTCAGCG,0,1301325
furpa,0.09090909090909091,10,10,CTTTCTGCATGTTGCATGCT,0,1350176
furpa,0.09090909090909091,10,10,CTTTCACTTCTAGGAGCCGC,0,1306325
furpa,0.09090909090909091,10,10,CTTGTTAGGTGCGCCTAACC,0,1297354
furpa,0.09090909090909091,10,10,CTTGTAGATTGAATATTAAT,0,1308690
furpa,0.09090909090909091,10,10,CTTCCCGGAAGAGTGATTGA,0,1315341
furpa,0.09090909090909091,10,10,CTTAGAGCATCAGAACCACC,0,1313259
furpa,0.09090909090909091,10,10,CTTAATGACAGCCGTTCTTT,0,1351579
furpa,0.09090909090909091,10,10,CTTAACAGCGTGCGGAGGAT,0,1335328
furpa,0.09090909090909091,10,10,CTGTAGCAAGGGGTTGTGTC,0,1321527
furpa,0.09090909090909091,10,10,CTGGTGTCACATTTGCCAAT,0,1303287
furpa,0.09090909090909091,10,10,CTGGGGAGATCCGTCTCCCA,0,1294246
furpa,0.09090909090909091,10,10,CTGGATCAGTCCGCAATCTA,0,1307764
furpa,0.09090909090909091,10,10,CTGCTGCAAACCCTGGCATT,0,1354196
furpa,0.09090909090909091,10,10,CTGCTCTGCCTTGCGCGAGT,0,1329708
furpa,0.09090909090909091,10,10,CTGCGAGTCACGTCATGTAG,0,1281788
furpa,0.09090909090909091,10,10,CTGCAATATGCACAGGCTAA,0,1338125
furpa,0.09090909090909091,10,10,CTGCAAAATTGTGATCGGTT,0,1271651
furpa,0.09090909090909091,10,10,CTGATGGCTTCGGTTGGACT,0,1348811
furpa,0.09090909090909091,10,10,CTGAGTCTTCTGAATCGGTC,0,1289494
furpa,0.09090909090909091,10,10,CTGAGATGGTATGTTGTGGA,0,1310396
furpa,0.09090909090909091,10,10,CTGAGACTTAGTTTGACAGG,0,1330002
furpa,0.09090909090909091,10,10,CTGAAATGAGTCATCGGCTG,0,1291638
furpa,0.09090909090909091,10,10,CTCTGTGGGCGCCAGGGTTG,0,1355263
furpa,0.09090909090909091,10,10,CTCTGCTTGCATCTAAGAAG,0,1318535
furpa,0.09090909090909091,10,10,CTCTATTCCGCCAGAAAGCA,0,1275524
furpa,0.09090909090909091,10,10,CTCGGATTCTAGCGATAGAC,0,1336342
furpa,0.09090909090909091,10,10,CTCGGACCCTCAATGGTCGT,0,1354245
furpa,0.09090909090909091,10,10,CTCCGTGCCTATTTGTTGTT,0,1307202
furpa,0.09090909090909091,10,10,CTCCGGCTCCGGATTAAAGT,0,1282112
furpa,0.09090909090909091,10,10,CTCACGCCCGTTCAGATCTG,0,1297634
furpa,0.09090909090909091,10,10,CTATTACGTTTGCTTATCTG,0,1341680
furpa,0.09090909090909091,10,10,CTATCGGTCGGCGGCCTGAA,0,1350950
furpa,0.09090909090909091,10,10,CTAGCGGGGACAGGTTGGGA,0,1342527
furpa,0.09090909090909091,10,10,CTAGCCCGGCGCAATCTATC,0,1324682
furpa,0.09090909090909091,10,10,CTACTGATACCTATTGGCTG,0,1297904
furpa,0.09090909090909091,10,10,CTACTCTAACCGGTGCGAGT,0,1354072
furpa,0.09090909090909091,10,10,CTACGGGTGTTGCAGGTGAT,0,1296200
furpa,0.09090909090909091,10,10,CTACCAGTGGGGACCTCCAC,0,1297575
furpa,0.09090909090909091,10,10,CTACATTTGCGTGGTGGCCC,0,1337652
furpa,0.09090909090909091,10,10,CTAATCATCATGACGAGGCA,0,1297303
furpa,0.09090909090909091,10,10,CTAAGTTCTCTCCGTTGAAA,0,1293184
furpa,0.09090909090909091,10,10,CTAACTCCTTCCGTGTACGT,0,1327468
furpa,0.09090909090909091,10,10,CGTTTGTATGCCAGTTTAGT,0,1350822
furpa,0.09090909090909091,10,10,CGTTTATTGAGGTCTTCATT,0,1308117
furpa,0.09090909090909091,10,10,CGTTGCTGGTCAACGAGAAC,0,1333617
furpa,0.09090909090909091,10,10,CGTTCGCGCGTGCAGCGCCC,0,1275842
furpa,0.09090909090909091,10,10,CGTGCATATAATTAGACAAT,0,1312908
furpa,0.09090909090909091,10,10,CGTGATGCCGAGGGCTCGCA,0,1329350
furpa,0.09090909090909091,10,10,CGTGACCCGTCGCACTGACC,0,1288600
furpa,0.09090909090909091,10,10,CGTCTGCGCTGCGTGGGTTG,0,1286907
furpa,0.09090909090909091,10,10,CGTCTACTTACCGGAAGAGA,0,1342178
furpa,0.09090909090909091,10,10,CGTCCCATGTATGTAGGAAA,0,1314106
furpa,0.09090909090909091,10,10,CGTAGAAGTGTACAGTTTTC,0,1330269
furpa,0.09090909090909091,10,10,CGGTTTCATCTGCTTACGCA,0,1326670
furpa,0.09090909090909091,10,10,CGGTTCCGCGGCAGATCCCG,0,1335781
furpa,0.09090909090909091,10,10,CGGTTAAAGTATGACGCAGA,0,1298177
furpa,0.09090909090909091,10,10,CGGTGGAGCCAAACAGTATG,0,1273916
furpa,0.09090909090909091,10,10,CGGTGAAACCTGGGACAGCT,0,1306344
furpa,0.09090909090909091,10,10,CGGTCTGCAAAAAAAGTTTG,0,1326124
furpa,0.09090909090909091,10,10,CGGTAGATTGACTACGACAA,0,1311148
furpa,0.09090909090909091,10,10,CGGTACCTCAAGGATAAAAT,0,1290635
furpa,0.09090909090909091,10,10,CGGTAAGGGTCAGTGCTTAC,0,1354195
furpa,0.09090909090909091,10,10,CGGTAAATCATGGAGGGATT,0,1296061
furpa,0.09090909090909091,10,10,CGGGGGCGCTTCATCCGTGT,0,1298484
furpa,0.09090909090909091,10,10,CGGGCCGGGCGCACTAAGCA,0,1314119
furpa,0.09090909090909091,10,10,CGGCTGCGGGATTATGGAGT,0,1282850
furpa,0.09090909090909091,10,10,CGGCTCGGGCGTGGGGTGAA,0,1288827
furpa,0.09090909090909091,10,10,CGGCCAGATCCTAACACGGC,0,1292558
furpa,0.09090909090909091,10,10,CGGCAATGCGATGATGAGTG,0,1307300
furpa,0.09090909090909091,10,10,CGGAGGCATCTCGTGGAGAC,0,1310677
furpa,0.09090909090909091,10,10,CGGACCGCGTTCTTAACATT,0,1280446
furpa,0.09090909090909091,10,10,CGGACCAGATCGCGAGGGGT,0,1349681
furpa,0.09090909090909091,10,10,CGGAATGTCTTAAACGGGAA,0,1338937
furpa,0.09090909090909091,10,10,CGCTACATGGGAGCTGCAAA,0,1310456
furpa,0.09090909090909091,10,10,CGCGATTGCGCTACCGTTGA,0,1335108
furpa,0.09090909090909091,10,10,CGCCTTGACCGCAATGATCA,0,1324923
furpa,0.09090909090909091,10,10,CGCCCTTCACTACCATACTA,0,1342499
furpa,0.09090909090909091,10,10,CGCCATGATTAGATTCATTA,0,1336564
furpa,0.09090909090909091,10,10,CGCAAAGGAGTTTTGTTTTC,0,1282610
furpa,0.09090909090909091,10,10,CGATTACGTGTCGCTTGGAC,0,1339495
furpa,0.09090909090909091,10,10,CGATCGAGGAGTTCTTTAAC,0,1317015
furpa,0.09090909090909091,10,10,CGATCACTGTTGTCCACATT,0,1316138
furpa,0.09090909090909091,10,10,CGAGTAGGCCCTTCAGATGA,0,1349727
furpa,0.09090909090909091,10,10,CGAGGCATACTGCGCATATT,0,1339692
furpa,0.09090909090909091,10,10,CGACTTAGCCACAAAAGCCC,0,1274429
furpa,0.09090909090909091,10,10,CCTTGGATAAATCGCACTAG,0,1302755
furpa,0.09090909090909091,10,10,CCTGGTGCTCTGCACGGCTT,0,1311814
furpa,0.09090909090909091,10,10,CCTGCTGCGCGAGGATCGTG,0,1330213
furpa,0.09090909090909091,10,10,CCTCTTCGGTACTGTTCGCC,0,1335908
furpa,0.09090909090909091,10,10,CCTATGTTCTTCATGGTGAA,0,1292128
furpa,0.09090909090909091,10,10,CCTATGAACGGTGGGCACCA,0,1315187
furpa,0.09090909090909091,10,10,CCTATCACGGCCTACCCAGT,0,1288427
furpa,0.09090909090909091,10,10,CCGGTTTCTAGCTTGAATGA,0,1302335
furpa,0.09090909090909091,10,10,CCGGGCATGAACGTCGTTTG,0,1294408
furpa,0.09090909090909091,10,10,CCGGATACGATGACTCGGAT,0,1343612
furpa,0.09090909090909091,10,10,CCGATGGGTCGAATTAACCG,0,1343427
furpa,0.09090909090909091,10,10,CCGATACGCCCAAGTGGAGC,0,1277855
furpa,0.09090909090909091,10,10,CCGAAACGTTGGCGAGCGAA,0,1321701
furpa,0.09090909090909091,10,10,CCCTTTAATACGCGGAGGTC,0,1306603
furpa,0.09090909090909091,10,10,CCCTACATAAGGGATACGAC,0,1291840
furpa,0.09090909090909091,10,10,CCCCTATGATAACTTTGAGT,0,1294060
furpa,0.09090909090909091,10,10,CCCCAGGAAAGTAAAAATTT,0,1337892
furpa,0.09090909090909091,10,10,CCCAGGCGCAGAAGTATCGG,0,1343923
furpa,0.09090909090909091,10,10,CCCACGAGACAGAATGCCGA,0,1336775
furpa,0.09090909090909091,10,10,CCCAAGACAATGCAGGTTGT,0,1300790
furpa,0.09090909090909091,10,10,CCATTTATTACCATCCGATT,0,1273000
furpa,0.09090909090909091,10,10,CCATGACATCTATTGGAGTT,0,1290918
furpa,0.09090909090909091,10,10,CCAGGCGTACGATAAGAGTG,0,1280281
furpa,0.09090909090909091,10,10,CCACTTGTAGCGCAAGGGCT,0,1330735
furpa,0.09090909090909091,10,10,CCACCGTAGGATCGAGAGAT,0,1295226
furpa,0.09090909090909091,10,10,CCACCGACGCGGCAGATCGT,0,1308774
furpa,0.09090909090909091,10,10,CATTTGCTCGGCCCATTGGC,0,1308555
furpa,0.09090909090909091,10,10,CATTAAATTAAGTTTGCCCT,0,1306328
furpa,0.09090909090909091,10,10,CATGGCGAGAGGCCCTGGCT,0,1300681
furpa,0.09090909090909091,10,10,CATGGCCCTATTGGTGCTTA,0,1282638
furpa,0.09090909090909091,10,10,CATCTAGAGTAGTATTTGCT,0,1299716
furpa,0.09090909090909091,10,10,CATCCTTCAATACTTATCAA,0,1335077
furpa,0.09090909090909091,10,10,CAGTTATCATTCCCAGGTGC,0,1323487
furpa,0.09090909090909091,10,10,CAGTGGCATTGCTCAACAGA,0,1341578
furpa,0.09090909090909091,10,10,CAGGTCAGAGAGCATCTCGA,0,1322877
furpa,0.09090909090909091,10,10,CAGGGTTAAACCTACGCTAA,0,1282527
furpa,0.09090909090909091,10,10,CAGGGGCAGCCGGTAGATGT,0,1352798
furpa,0.09090909090909091,10,10,CAGGGGAACGGACAAAAGGG,0,1311932
furpa,0.09090909090909091,10,10,CAGATAGGTACCCGCATCAC,0,1349858
furpa,0.09090909090909091,10,10,CAGACGAGACGGTTCTCACG,0,1291737
furpa,0.09090909090909091,10,10,CACGGTTTTAGTTTATTGCA,0,1344728
furpa,0.09090909090909091,10,10,CACGGCATTAAAGGAGCCTG,0,1332585
furpa,0.09090909090909091,10,10,CACCGGAGATTTAATCGAGC,0,1292368
furpa,0.09090909090909091,10,10,CACCGCAAGAAAGGTAGTAA,0,1283768
furpa,0.09090909090909091,10,10,CACCCAAACGAAAATGGTAT,0,1282717
furpa,0.09090909090909091,10,10,CACATTCTTTGATGAAGACT,0,1324402
furpa,0.09090909090909091,10,10,CACAAAGACATAACAGCGGC,0,1291185
furpa,0.09090909090909091,10,10,CAATAGTTTACCCGCGTCGG,0,1286092
furpa,0.09090909090909091,10,10,CAAATAATTCCGGAAGTTCA,0,1343347
furpa,0.09090909090909091,10,10,ATTGTTGTTCTTCCGGACTC,0,1289824
furpa,0.09090909090909091,10,10,ATTGTTCTTCATCGACAGGC,0,1317634
furpa,0.09090909090909091,10,10,ATTGTAGTTTCTCAAAGAAG,0,1346418
furpa,0.09090909090909091,10,10,ATTGGGCGGTTGTTGTGTCC,0,1289208
furpa,0.09090909090909091,10,10,ATTCTAGCGATAGGCCGGGA,0,1324233
furpa,0.09090909090909091,10,10,ATTCCCCCGCATGTCCAGAT,0,1298078
furpa,0.09090909090909091,10,10,ATTCAGTAAGATTGCTCACA,0,1352446
furpa,0.09090909090909091,10,10,ATGGTCAGGCGGGCTAGAAC,0,1302127
furpa,0.09090909090909091,10,10,ATGGCCATAAAGAAAAGCCG,0,1329484
furpa,0.09090909090909091,10,10,ATGCGCACATGCACTGGTAC,0,1294128
furpa,0.09090909090909091,10,10,ATGCACCTTGGCTACCAGGT,0,1290166
furpa,0.09090909090909091,10,10,ATGAGCATCATGAGAGGTCT,0,1346663
furpa,0.09090909090909091,10,10,ATGAATGGTCCAATTCCAGG,0,1329017
furpa,0.09090909090909091,10,10,ATGAATAACAAAGAGCGCGC,0,1324057
furpa,0.09090909090909091,10,10,ATCTGCTAGGCTCGACTTCC,0,1340726
furpa,0.09090909090909091,10,10,ATCGGTGCAGAACGGCGGTA,0,1321224
furpa,0.09090909090909091,10,10,ATCGATCACTTGCAGCAGTG,0,1326801
furpa,0.09090909090909091,10,10,ATCGAAGGGGTAACACCATT,0,1325251
furpa,0.09090909090909091,10,10,ATCCTCTCTGACATGGAGTC,0,1350952
furpa,0.09090909090909091,10,10,ATCCTCCCCTATCAGACTAA,0,1271856
furpa,0.09090909090909091,10,10,ATCACCCCTACCAGAGATGT,0,1298442
furpa,0.09090909090909091,10,10,ATCAAGAAAGTGGCGGGGAC,0,1355586
furpa,0.09090909090909091,10,10,ATATTCCCAAGTGACCCCAC,0,1323989
furpa,0.09090909090909091,10,10,ATAGATTCTAAAATCCCCAG,0,1290984
furpa,0.09090909090909091,10,10,ATACTTTTCTTTGAAAAGTT,0,1302165
furpa,0.09090909090909091,10,10,ATACTCCGGATATATACGTT,0,1297707
furpa,0.09090909090909091,10,10,ATACGCGGGTTGTTTGCCCT,0,1326119
furpa,0.09090909090909091,10,10,ATACCTGAATGCCAGGACTT,0,1275215
furpa,0.09090909090909091,10,10,AGTTTGGCCCATCGCTTTGG,0,1340130
furpa,0.09090909090909091,10,10,AGTTTGCATATATTGGTTAT,0,1319139
furpa,0.09090909090909091,10,10,AGTTAGCCGAACCATCTAAT,0,1314077
furpa,0.09090909090909091,10,10,AGTTAGAGACCGGTTATGAC,0,1311159
furpa,0.09090909090909091,10,10,AGTGTGTTATCATGAGGCAG,0,1276894
furpa,0.09090909090909091,10,10,AGTGGGCAGGTCCAGTTGAC,0,1272920
furpa,0.09090909090909091,10,10,AGTGCGCAAGGATGTGTGTG,0,1325006
furpa,0.09090909090909091,10,10,AGTCGTTTACGGGATCTAGG,0,1294794
furpa,0.09090909090909091,10,10,AGTCGGATAGGTGGGGGCAT,0,1324866
furpa,0.09090909090909091,10,10,AGTCACGTTTGTCACTCACG,0,1327117
furpa,0.09090909090909091,10,10,AGTATTAGAAACGTCGTGTC,0,1302941
furpa,0.09090909090909091,10,10,AGTAACTGGTGCGCACCGTT,0,1272477
furpa,0.09090909090909091,10,10,AGTAACGTGCGTTAACATTG,0,1344602
furpa,0.09090909090909091,10,10,AGGTGTTTAGTCGAGGAGGT,0,1348665
furpa,0.09090909090909091,10,10,AGGTGATAAAACTGACCAAC,0,1295720
furpa,0.09090909090909091,10,10,AGGGTGAAAATGCACTTGTT,0,1335090
furpa,0.09090909090909091,10,10,AGGGGAAGGTAATCCCTACT,0,1353297
furpa,0.09090909090909091,10,10,AGGGAGGACCGACTTACTGT,0,1286107
furpa,0.09090909090909091,10,10,AGGACGGGATTGCCCCGATA,0,1301049
furpa,0.09090909090909091,10,10,AGCTGCGTACATACTGGGTT,0,1320855
furpa,0.09090909090909091,10,10,AGCTCAATAGAGTTGGACTT,0,1305245
furpa,0.09090909090909091,10,10,AGCGTCATTCCCGCACACTA,0,1336385
furpa,0.09090909090909091,10,10,AGCGCCGTTTAATGTTGATT,0,1282685
furpa,0.09090909090909091,10,10,AGCCAAACCGTTTGGTAGAG,0,1293845
furpa,0.09090909090909091,10,10,AGCAGACGGGGGTACCAATA,0,1331084
furpa,0.09090909090909091,10,10,AGCAACATTAATGGAGCCAG,0,1319755
furpa,0.09090909090909091,10,10,AGAGTGTAGCTTTTCGGCCC,0,1301383
furpa,0.09090909090909091,10,10,AGAGGAAGATCGAGTTATTT,0,1353302
furpa,0.09090909090909091,10,10,AGACGCAATTAAAGACAGCA,0,1317945
furpa,0.09090909090909091,10,10,AGAAGGATGGGGAGCATGCG,0,1291505
furpa,0.09090909090909091,10,10,AGAACGCTCAATGCTGGCCA,0,1281203
furpa,0.09090909090909091,10,10,ACTTATACAGCATAAGGCCA,0,1344604
furpa,0.09090909090909091,10,10,ACTGTCCTTGATTAGATGAA,0,1345798
furpa,0.09090909090909091,10,10,ACTGAATTTTATTTAATTGA,0,1350584
furpa,0.09090909090909091,10,10,ACTGAACTAGCGGTCGTCTG,0,1356533
furpa,0.09090909090909091,10,10,ACTCACGATGGACCCGGTAG,0,1271995
furpa,0.09090909090909091,10,10,ACTAATGGGTCACGGGGTTA,0,1288563
furpa,0.09090909090909091,10,10,ACGTTTGCTTCGCACGGGAT,0,1350742
furpa,0.09090909090909091,10,10,ACGTGTCATTGGATTTGCGG,0,1293597
furpa,0.09090909090909091,10,10,ACGGTTTGACCTTACAGCAT,0,1356485
furpa,0.09090909090909091,10,10,ACGGGACGACTATTCCCCGT,0,1304667
furpa,0.09090909090909091,10,10,ACGGCCGTAGGGAAACAGTT,0,1291912
furpa,0.09090909090909091,10,10,ACGCGCCAGATTAAACAGAG,0,1315724
furpa,0.09090909090909091,10,10,ACGATAGGCCCCTTCGGGGG,0,1290193
furpa,0.09090909090909091,10,10,ACGAATTCGGAGGTTGGAGT,0,1280216
furpa,0.09090909090909091,10,10,ACCTTTTGTATAACCCAAGA,0,1324448
furpa,0.09090909090909091,10,10,ACCTGTCAGGTTACCCGTGT,0,1276635
furpa,0.09090909090909091,10,10,ACCTAATCGAGACCGGGCGA,0,1323002
furpa,0.09090909090909091,10,10,ACCTAAGTATCGACGGTTCT,0,1323584
furpa,0.09090909090909091,10,10,ACCCGTGTGTGCCCATGGGT,0,1286815
furpa,0.09090909090909091,10,10,ACCCCACAATGTGTGCCCTA,0,1334979
furpa,0.09090909090909091,10,10,ACCCAGATCTCGCTATTCAG,0,1297659
furpa,0.09090909090909091,10,10,ACCATCCATATGGTCTAAAT,0,1331740
furpa,0.09090909090909091,10,10,ACCACAGGCTCAAGGGTGTG,0,1292234
furpa,0.09090909090909091,10,10,ACATTGCGGGGACATTCGGA,0,1336412
furpa,0.09090909090909091,10,10,ACAGGACCCGTAGCGTACCT,0,1294413
furpa,0.09090909090909091,10,10,ACAGCGTTCCGCTAGTGCGC,0,1343448
furpa,0.09090909090909091,10,10,ACACTCAGGTGACCCTTGTC,0,1303303
furpa,0.09090909090909091,10,10,ACAAGCCAGTCGTGCCGTCC,0,1299348
furpa,0.09090909090909091,10,10,ACAACCATCATTTCTTGCCA,0,1334782
furpa,0.09090909090909091,10,10,AATGGTGTGTGGCTAGCTAT,0,1342563
furpa,0.09090909090909091,10,10,AATGGACTCATCTGTATGGA,0,1342633
furpa,0.09090909090909091,10,10,AATGGACTAATATTTTGCGA,0,1325533
furpa,0.09090909090909091,10,10,AATGCCAGCTCCGTCGTAGA,0,1297300
furpa,0.09090909090909091,10,10,AATCCAAGTTGGTTTTGAGA,0,1356201
furpa,0.09090909090909091,10,10,AATATTGCACTAAGGTACTG,0,1291957
furpa,0.09090909090909091,10,10,AATAGAAACGTCATGCACTA,0,1345251
furpa,0.09090909090909091,10,10,AAGGGGTCATTCCTCAACAA,0,1284386
furpa,0.09090909090909091,10,10,AAGGGGCCCGGGGTGTATGT,0,1281601
furpa,0.09090909090909091,10,10,AAGGCAAGTGAGCTATCGTT,0,1284534
furpa,0.09090909090909091,10,10,AAGGAAGCCATCACTGCCTG,0,1276980
furpa,0.09090909090909091,10,10,AAGCTTTAGCGTCAACCTTC,0,1274183
furpa,0.09090909090909091,10,10,AAGCTTGTGTCAGCCTCCCA,0,1341725
furpa,0.09090909090909091,10,10,AAGCTCCTCGTAATTTGCCA,0,1298775
furpa,0.09090909090909091,10,10,AAGCTCACGCCCGCGCTCTA,0,1338950
furpa,0.09090909090909091,10,10,AAGCTAGTATGAGAACAACG,0,1338524
furpa,0.09090909090909091,10,10,AAGCGCGGTCTATGTTTCAT,0,1346891
furpa,0.09090909090909091,10,10,AAGCCCGGTCAGAACGTTGG,0,1332060
furpa,0.09090909090909091,10,10,AACTTTGTCCCCGCTCCCGG,0,1322121
furpa,0.09090909090909091,10,10,AACTCGCGTATTCAAATTTG,0,1282682
furpa,0.09090909090909091,10,10,AACTCCGCTACAAGATTTAT,0,1304280
furpa,0.09090909090909091,10,10,AACGACTACCCTGTACGTAT,0,1353299
furpa,0.09090909090909091,10,10,AACAGGCACATTGTTCACGA,0,1296107
furpa,0.09090909090909091,10,10,AACACGTTGGACATGTGCCC,0,1314901
furpa,0.09090909090909091,10,10,AACAAGGCGTATATATGGTA,0,1282103
furpa,0.09090909090909091,10,10,AAATCTTATCTAACTCGGGA,0,1288159
furpa,0.09090909090909091,10,10,AAATCGACTTGACCAATACT,0,1333325
furpa,0.09090909090909091,10,10,AAAGGTGCGTGTATTGTCCC,0,1287089
furpa,0.09090909090909091,10,10,AAAGGTGAAAGTCGAGCGAT,0,1333875
furpa,0.09090909090909091,10,10,AAAGGATCCGGCCCCGTTCT,0,1285471
furpa,0.09090909090909091,10,10,AAACTATAACGCATCATTGG,0,1333019
furpa,0.09090909090909091,10,10,AAAATTTAACCGAGAACAGC,0,1353580
furpa,0.09090909090909091,10,10,AAAAGCGGTGCTTTGCACAC,0,1278059
furpa,0.1,9,9,TTTTCGTGCCCATGGTAACG,0,1348579
furpa,0.1,9,9,TTTTCGGTGACCCAACCTGG,0,1319194
furpa,0.1,9,9,TTTTCAGACAGCTTTGAACC,0,1272266
furpa,0.1,9,9,TTTTACACTCGTCCAATCTA,0,1295080
furpa,0.1,9,9,TTTGTGCCGTGCTGACCGGT,0,1345637
furpa,0.1,9,9,TTTGCACTTTCTGTAACATC,0,1275507
furpa,0.1,9,9,TTTCCATGTCTTGAACCGAA,0,1338339
furpa,0.1,9,9,TTTCCAAATCGGTTGTCCAG,0,1272006
furpa,0.1,9,9,TTTATGGACGTATCTTGGTA,0,1340002
furpa,0.1,9,9,TTTACCTGCGTGCCTACGCG,0,1318179
furpa,0.1,9,9,TTGGTGCTGAATGTATTCAA,0,1326523
furpa,0.1,9,9,TTGGGTCCTTTTCGTACGGA,0,1273200
furpa,0.1,9,9,TTGGGCGTCTTCCCACCCGC,0,1320541
furpa,0.1,9,9,TTGGGCATCGTGAGGACGAA,0,1341194
furpa,0.1,9,9,TTGGAGTTTGATTTGGCGGG,0,1353997
furpa,0.1,9,9,TTGGAAATCACATATAGTAC,0,1271747
furpa,0.1,9,9,TTGCTTAATCCCATTTTCGC,0,1337885
furpa,0.1,9,9,TTGCTCACAACGTGCCGGCG,0,1316693
furpa,0.1,9,9,TTGATTAATGTTTCTTAGTA,0,1350634
furpa,0.1,9,9,TTGAAATGACTGTGCCCGGT,0,1325993
furpa,0.1,9,9,TTCTGTACCCACTTGGTACT,0,1334730
furpa,0.1,9,9,TTCTCGTGTTGTAAAGGCTG,0,1347772
furpa,0.1,9,9,TTCTATACAATTACAAGGTA,0,1333926
furpa,0.1,9,9,TTCGGAGAGCTAGCATAGCT,0,1349725
furpa,0.1,9,9,TTCGCGTATCGTGACGACCC,0,1293783
furpa,0.1,9,9,TTCAATCTTGGCCTTTCCGT,0,1282148
furpa,0.1,9,9,TTATGTTACGGAAGCGCAGA,0,1342195
furpa,0.1,9,9,TTATGGGGCCGGTCAATTCG,0,1344556
furpa,0.1,9,9,TTATGCGGTGTCTATTCGGT,0,1290046
furpa,0.1,9,9,TTATGCACCCGTAGAGCCAT,0,1315184
furpa,0.1,9,9,TTATCTTCAGTTGGTCTTTC,0,1293833
furpa,0.1,9,9,TTAGTGATTTCTATACAAAG,0,1323372
furpa,0.1,9,9,TTAGTCTTCAGCTTAGGGGA,0,1309766
furpa,0.1,9,9,TTAGGCAATAGTCCCCACTC,0,1294875
furpa,0.1,9,9,TTAGCCTACTGTAAAGTCAA,0,1277400
furpa,0.1,9,9,TTAGAACATCTGCTTGCGTG,0,1342265
furpa,0.1,9,9,TTAATTTCATAAAACCGGTC,0,1304265
furpa,0.1,9,9,TTAATCCGCACGCTAATGTC,0,1312854
furpa,0.1,9,9,TTAACCCTCTGGAAAAAGGT,0,1313306
furpa,0.1,9,9,TGTTTTTACGGTGCCGGGGG,0,1284767
furpa,0.1,9,9,TGTTTGAAATACGATATGGT,0,1316766
furpa,0.1,9,9,TGTTCAAAATTCCCTCCCAA,0,1352816
furpa,0.1,9,9,TGTTAGGGGTGCTTAATGTC,0,1323868
furpa,0.1,9,9,TGTTACTGGGGGGCGGGCCT,0,1319573
furpa,0.1,9,9,TGTGTACGGTTGGTGTAAAA,0,1354491
furpa,0.1,9,9,TGTCGAATAATGCACGTCAC,0,1310134
furpa,0.1,9,9,TGTCCATCTAGCTTCGGACG,0,1303363
furpa,0.1,9,9,TGTAGTACGTCAGTATCCTC,0,1285760
furpa,0.1,9,9,TGTACTAGGGGCTGGTACTA,0,1285687
furpa,0.1,9,9,TGGTATGCTTTGCCTCAAGA,0,1351000
furpa,0.1,9,9,TGGGTTTGTACGCGATAGGG,0,1301716
furpa,0.1,9,9,TGGGTCAGCAGTCTTAGAAA,0,1280529
furpa,0.1,9,9,TGGCGCGCCATTATCGGTTT,0,1272139
furpa,0.1,9,9,TGGCGAATCATCTACGGAAA,0,1302633
furpa,0.1,9,9,TGGATGATTTTGTCGGGGGG,0,1280201
furpa,0.1,9,9,TGGAGTTGTTTGTTATTGTG,0,1298971
furpa,0.1,9,9,TGGACTTCATGCTCCGCATT,0,1330093
furpa,0.1,9,9,TGGACCGACCTTAAATACTA,0,1333027
furpa,0.1,9,9,TGGAAGGTGCGAAATATCTC,0,1293671
furpa,0.1,9,9,TGGAAAACCTCCTCCTGAGA,0,1349868
furpa,0.1,9,9,TGCTGTGTCCAAACATATGT,0,1325071
furpa,0.1,9,9,TGCTCGTGTTTAGGGCGAGC,0,1353441
furpa,0.1,9,9,TGCTACATTATTACTCACCC,0,1346037
furpa,0.1,9,9,TGCCGACCGTATGGCAGCTA,0,1344560
furpa,0.1,9,9,TGCCACAATACGCCATCGAA,0,1315925
furpa,0.1,9,9,TGCATCCAGGCGTTCTTTCG,0,1301590
furpa,0.1,9,9,TGCAAAATGCACTATCCCAC,0,1302261
furpa,0.1,9,9,TGATTTTGTGCAGGGACCGG,0,1321068
furpa,0.1,9,9,TGATGGAAAAAAATGCAGGC,0,1293490
furpa,0.1,9,9,TGATATTCCGATATCAACAG,0,1280915
furpa,0.1,9,9,TGATAAACTCACAGCCGATT,0,1335596
furpa,0.1,9,9,TGAGGTTAAAGTCTGCCCAT,0,1315181
furpa,0.1,9,9,TGAGGAGTCCAAGACGGGTA,0,1353863
furpa,0.1,9,9,TGACAGAAACGGAAGCCATG,0,1277675
furpa,0.1,9,9,TGAATTCGTAATGTGCACTG,0,1335741
furpa,0.1,9,9,TGAATAGGATTATTAAGAGG,0,1279038
furpa,0.1,9,9,TGAATACTGAACTGCTAACG,0,1312749
furpa,0.1,9,9,TGAAGATAAAGGGGTGTTTC,0,1309198
furpa,0.1,9,9,TGAACTTCGTACAGGGCGAG,0,1294330
furpa,0.1,9,9,TGAACAGGCATTTTTGTCAG,0,1273844
furpa,0.1,9,9,TCTTCCAGGGAGCTCCGGTT,0,1334689
furpa,0.1,9,9,TCTGGGCTGTTGTCGTCCTC,0,1300911
furpa,0.1,9,9,TCTCGGGCTGTTTGGCCGAG,0,1305049
furpa,0.1,9,9,TCTCATTGTTTTGTGTCCAT,0,1354032
furpa,0.1,9,9,TCTATTGTAGTAGGGATGTT,0,1276982
furpa,0.1,9,9,TCGTTGTGTTCTCTGAGAAC,0,1323344
furpa,0.1,9,9,TCGTTGAAGGACTTTTGAGC,0,1307685
furpa,0.1,9,9,TCGGCGACAGTGCATTCGGT,0,1316203
furpa,0.1,9,9,TCGGACGGGCAGCGGCCCCG,0,1283297
furpa,0.1,9,9,TCGGACATCAACGAGTGACC,0,1292926
furpa,0.1,9,9,TCGCACGTGGGCTACTTTGA,0,1327164
furpa,0.1,9,9,TCGAGTACCCTTGACCGTAG,0,1283802
furpa,0.1,9,9,TCCTGGCGTGCAGAACAGCA,0,1317490
furpa,0.1,9,9,TCCTCTATCAGAAGGCTAAG,0,1300461
furpa,0.1,9,9,TCCCTGAGAGCCTCTGATAG,0,1303259
furpa,0.1,9,9,TCCCACAAGGAGGTGATGAA,0,1280865
furpa,0.1,9,9,TCCATGTAAATACGATCTAC,0,1304207
furpa,0.1,9,9,TCCACGTCGGAAGCATCTGT,0,1274943
furpa,0.1,9,9,TCCACAGGGGACGCCATATT,0,1353268
furpa,0.1,9,9,TCATGAACCCCTTCATAAGC,0,1324438
furpa,0.1,9,9,TCATCCGTTTAAAGTGCCAG,0,1300560
furpa,0.1,9,9,TCAGGTTCGAAACTGGGAGT,0,1347365
furpa,0.1,9,9,TCAGGCATGCCAAGCTTACA,0,1315123
furpa,0.1,9,9,TCAGCCTTGGCTAACTTATG,0,1325298
furpa,0.1,9,9,TCAGAATTCTGATACTTGAG,0,1332969
furpa,0.1,9,9,TCACTTTTGACTTAATGAGC,0,1288591
furpa,0.1,9,9,TCACCAGGTGTCTCATGCGG,0,1304032
furpa,0.1,9,9,TCAAGTCCGGTTTCGAGTAT,0,1323675
furpa,0.1,9,9,TCAAGAGATAGCTTGCGAGA,0,1284095
furpa,0.1,9,9,TCAACTTGGTACCACCCAGG,0,1288044
furpa,0.1,9,9,TCAAAGCGGCTATTAAATGC,0,1281346
furpa,0.1,9,9,TATTTGGGTATTAGATCAAG,0,1314423
furpa,0.1,9,9,TATTTGAGACCTGCTCCTGC,0,1285715
furpa,0.1,9,9,TATTCGGAAGATTTAACATA,0,1345667
furpa,0.1,9,9,TATTCGCAGTCTTTCGCGAA,0,1314584
furpa,0.1,9,9,TATTCGAGATAGTGTCCTGG,0,1299973
furpa,0.1,9,9,TATTAAAACACCAGGTTTTG,0,1283807
furpa,0.1,9,9,TATCACGGACCCTGCTGGAA,0,1321333
furpa,0.1,9,9,TATAACGACCGTGCGTTTGT,0,1354251
furpa,0.1,9,9,TAGGTGGTGGCTTGTTCCAA,0,1308215
furpa,0.1,9,9,TAGGGAGCGACTCACAAGGC,0,1275520
furpa,0.1,9,9,TAGGCCTGGATTCTCTCTAA,0,1329965
furpa,0.1,9,9,TAGCGTGTCCCAACTGAGGT,0,1316944
furpa,0.1,9,9,TACGCTTAAAGTAAGGGCCT,0,1356003
furpa,0.1,9,9,TACGCCAGGCATGCTTGGCT,0,1310510
furpa,0.1,9,9,TACCCTGCGCGCGCGATCAG,0,1319127
furpa,0.1,9,9,TACCAGCTCACCTCATAAAT,0,1328524
furpa,0.1,9,9,TAATCAGTAATGTCTAGGGT,0,1285475
furpa,0.1,9,9,TAACATAGGAGGATGACCAC,0,1349510
furpa,0.1,9,9,TAACATACGTGGGCATGTTC,0,1320916
furpa,0.1,9,9,TAACAGGAGCTATCTTAACC,0,1306879
furpa,0.1,9,9,TAACAACGTAAGCACTTATT,0,1313840
furpa,0.1,9,9,TAAATTAGAGCTTATCAGTC,0,1343810
furpa,0.1,9,9,TAAATGTCACGCTCTAATGA,0,1290633
furpa,0.1,9,9,TAAAGGTCACTGACAGATTC,0,1306525
furpa,0.1,9,9,GTTTTACAACGAATAAGCGG,0,1299552
furpa,0.1,9,9,GTTGGCAGATTTCGTCCATT,0,1353337
furpa,0.1,9,9,GTTGACGCCTTCCCAAAATA,0,1320066
furpa,0.1,9,9,GTTGAATTTGAAAGGAGCTG,0,1348520
furpa,0.1,9,9,GTTCTGGGCTGGACAAGGCA,0,1310601
furpa,0.1,9,9,GTGTTTGGACCCGGCGTAAT,0,1281782
furpa,0.1,9,9,GTGTACGCAGCCGCCCTAGA,0,1283029
furpa,0.1,9,9,GTGGTGAAATAGCCCACAAA,0,1301255
furpa,0.1,9,9,GTGGGTAGGCCCTAGAGAAT,0,1345141
furpa,0.1,9,9,GTGGATCCTTCGCGCGAAAA,0,1315903
furpa,0.1,9,9,GTGCCTTTTCCGGGGTAGCC,0,1316941
furpa,0.1,9,9,GTGCAACCGTGCATTTTGTC,0,1321400
furpa,0.1,9,9,GTGACTGCCCGGCAATGTCA,0,1323822
furpa,0.1,9,9,GTGAATACCGTTTTAAGCAT,0,1271309
furpa,0.1,9,9,GTGAAGGAGTTTGCTACAAT,0,1286511
furpa,0.1,9,9,GTCTGGTGTACGGGATTAGG,0,1350581
furpa,0.1,9,9,GTCTCTAAGTTCCCAGACTA,0,1324441
furpa,0.1,9,9,GTCTAACGAACTTTTACTTT,0,1340452
furpa,0.1,9,9,GTCTAAAGTATAGTTACAAT,0,1320868
furpa,0.1,9,9,GTCGTTCAGACCCGGTTGCT,0,1325982
furpa,0.1,9,9,GTCGTTAGCGCGCAGTATAT,0,1334840
furpa,0.1,9,9,GTCGTCGGTTGCGAAGTCTA,0,1302170
furpa,0.1,9,9,GTCGGGATGTGCTCAAGTTG,0,1284918
furpa,0.1,9,9,GTCGACTACGGACAACAGGC,0,1318404
furpa,0.1,9,9,GTCGAAGGTTAGTAATTGGT,0,1302555
furpa,0.1,9,9,GTCCTCGCGCACACACGCGT,0,1294133
furpa,0.1,9,9,GTCCCTAATTTGTACCAAAA,0,1273986
furpa,0.1,9,9,GTCCATTCGGTAGCGCCTCC,0,1288611
furpa,0.1,9,9,GTCATTTTGCTAAAGTCTGC,0,1333610
furpa,0.1,9,9,GTCATAAGGCGAAACCCGTG,0,1273239
furpa,0.1,9,9,GTCAAGGAAGGTTGTCAGGC,0,1311201
furpa,0.1,9,9,GTATCCCTTAGTTTGGGCAG,0,1275308
furpa,0.1,9,9,GTAGTGTTTGGGGTATGGTC,0,1294952
furpa,0.1,9,9,GTAGTCTTAAGCTCCAGATG,0,1337510
furpa,0.1,9,9,GTAGGTTCAGGTGCTGCACT,0,1329253
furpa,0.1,9,9,GTAGGCCCACGTGCGGCATG,0,1356348
furpa,0.1,9,9,GTAGATTATAGGGGCTGAAG,0,1286575
furpa,0.1,9,9,GTACACGGGGGATCAGTCCC,0,1335224
furpa,0.1,9,9,GTAATGTCCACAGTAAGCTG,0,1330731
furpa,0.1,9,9,GTAATATGGCCGGCATCTAT,0,1305818
furpa,0.1,9,9,GTAAGGAGGGCCGCTTGCCT,0,1332916
furpa,0.1,9,9,GGTTTAGCCACTTAAAATAT,0,1300663
furpa,0.1,9,9,GGTTCTTCATGACTGATTGT,0,1309842
furpa,0.1,9,9,GGTTCGATGTAAACCCCACT,0,1332023
furpa,0.1,9,9,GGTGGGATAGTTCGTCACCT,0,1332738
furpa,0.1,9,9,GGTGGAAAGGGCCATTGCGT,0,1287933
furpa,0.1,9,9,GGTGAACATAGGCGCTCTGA,0,1342593
furpa,0.1,9,9,GGTCTTCAAATTTCCTTATC,0,1309403
furpa,0.1,9,9,GGTCTAGGTGCAAGGCGTAT,0,1335362
furpa,0.1,9,9,GGTCGGTCCACATGTGACGT,0,1299936
furpa,0.1,9,9,GGTCCGAAGACATAGGCAAT,0,1276336
furpa,0.1,9,9,GGTCAGGGAATCTGCGCTTA,0,1279246
furpa,0.1,9,9,GGTCAGGCCGCGTGCTTTCA,0,1325364
furpa,0.1,9,9,GGTCAGAATTGATCATATAG,0,1309772
furpa,0.1,9,9,GGTAGTGCTCGCGATGTGCT,0,1337489
furpa,0.1,9,9,GGTACAAGATTTGGTTAGTC,0,1275499
furpa,0.1,9,9,GGGTTTCCGTCGATCTGAGG,0,1275412
furpa,0.1,9,9,GGGTGGGGTCCGAATATTCA,0,1301523
furpa,0.1,9,9,GGGTGACTACTAATATGTTA,0,1348201
furpa,0.1,9,9,GGGTCTACACTGTGCGTGTA,0,1315207
furpa,0.1,9,9,GGGGGTTTAGGAGCGGGGCT,0,1292709
furpa,0.1,9,9,GGGGGTCTGGTTGCACTGAG,0,1355976
furpa,0.1,9,9,GGGGGCATGTAAGCGTGCGG,0,1305612
furpa,0.1,9,9,GGGGCGGTGTCTGACTCTCT,0,1272358
furpa,0.1,9,9,GGGGCAGAATCGTCAAATGT,0,1298621
furpa,0.1,9,9,GGGGCACCACCAAATATAGA,0,1289503
furpa,0.1,9,9,GGGGATCCGCCTAGACCGCT,0,1352971
furpa,0.1,9,9,GGGCTGGACTAAAAGGTGTT,0,1291183
furpa,0.1,9,9,GGGCCGCACCGCACTCCTGG,0,1343903
furpa,0.1,9,9,GGGACCCCCATTTAGCTGAA,0,1355857
furpa,0.1,9,9,GGGAAGTCTGATATTATTCT,0,1304575
furpa,0.1,9,9,GGCTAGCACACTATATTGCC,0,1353070
furpa,0.1,9,9,GGCGTGTGATGCGTAGACTC,0,1324634
furpa,0.1,9,9,GGCGTGGCCGGTGCATAGGG,0,1289973
furpa,0.1,9,9,GGCGCCGCCCGCTTTGCAGC,0,1352333
furpa,0.1,9,9,GGCGCCACAATTACGAATTA,0,1341625
furpa,0.1,9,9,GGCGATCTTTCGCAAGGGAC,0,1327276
furpa,0.1,9,9,GGCGAGGTGTTACAAATAGC,0,1311927
furpa,0.1,9,9,GGCCTCGTCCCAGGTGAGGA,0,1295748
furpa,0.1,9,9,GGCCAGACAAAAGCATTCCG,0,1318495
furpa,0.1,9,9,GGCCACTCGCAGTGACTATC,0,1285905
furpa,0.1,9,9,GGCAGTTCTTGCAGTTAAAA,0,1333194
furpa,0.1,9,9,GGCACAACCTTTTTGAATAT,0,1317755
furpa,0.1,9,9,GGATTGTAGTCCGGTGCCCA,0,1291567
furpa,0.1,9,9,GGATGCGATCTATCTATGGA,0,1276816
furpa,0.1,9,9,GGATCAAGACCATTGCCCCG,0,1272322
furpa,0.1,9,9,GGAGGTCATATGTAGGGCAT,0,1277204
furpa,0.1,9,9,GGAGACGGTACCTCTGAATG,0,1310547
furpa,0.1,9,9,GGAGAATCAGACGACATGAA,0,1315660
furpa,0.1,9,9,GGACTTCTGCTGTCGTTTGG,0,1332844
furpa,0.1,9,9,GGACGTCACAGCTAAACCCC,0,1341344
furpa,0.1,9,9,GGACCTAGATACGTTGCCGT,0,1355793
furpa,0.1,9,9,GGACAGGCGAAATCTGTAGG,0,1320594
furpa,0.1,9,9,GGACAGATTGGCAAGGGTCA,0,1301675
furpa,0.1,9,9,GGAAGTCTGTATGTATATAT,0,1334599
furpa,0.1,9,9,GGAAGACCCGCTGATCATGA,0,1355274
furpa,0.1,9,9,GGAAATCACTCATCTTTGCC,0,1314996
furpa,0.1,9,9,GGAAAATGTAAGGGGTGCGA,0,1305402
furpa,0.1,9,9,GCTGTTATGCTTTAAGCCCC,0,1292101
furpa,0.1,9,9,GCTGTCCGTTTCCTCATATG,0,1284864
furpa,0.1,9,9,GCTGCTTAGTAATCGGGGGT,0,1334783
furpa,0.1,9,9,GCTGCGAAGCGCGGTCGGGT,0,1312245
furpa,0.1,9,9,GCTGAGGGGTCAGTGCTGAG,0,1342715
furpa,0.1,9,9,GCTCTTGCCCGGTCGTAATG,0,1326800
furpa,0.1,9,9,GCTCTTATTAACTCAACCTT,0,1277741
furpa,0.1,9,9,GCTCGTGCCTCGAAGCGACA,0,1294190
furpa,0.1,9,9,GCTCGCGATGGTCGGCGTAT,0,1327116
furpa,0.1,9,9,GCTCAGATTGGGATCGGGAA,0,1343217
furpa,0.1,9,9,GCTATTCGACCGTAGGTCTA,0,1276921
furpa,0.1,9,9,GCTAGCACGTTCAACGTCTC,0,1299793
furpa,0.1,9,9,GCTACAAATGGGTCGTACAG,0,1298202
furpa,0.1,9,9,GCTAAACGGGACTAGGGACC,0,1293948
furpa,0.1,9,9,GCGTTAGTTTGTCCACGGCC,0,1314493
furpa,0.1,9,9,GCGGGGATGGTAAAGAGGAC,0,1327129
furpa,0.1,9,9,GCGGCTTTACCAGTCGTCTT,0,1319973
furpa,0.1,9,9,GCGGCTAAGTTCTGGCGGTT,0,1330523
furpa,0.1,9,9,GCGGACCTGCATCACAGTGC,0,1354931
furpa,0.1,9,9,GCGCTAAATCCACGCGGTGT,0,1297045
furpa,0.1,9,9,GCGCCGAGGTTATTGCCTCG,0,1290846
furpa,0.1,9,9,GCGATCTGTACAGCACTGTA,0,1330588
furpa,0.1,9,9,GCGAGTCTAGAGGACACGGC,0,1316896
furpa,0.1,9,9,GCGAGGACCACCCGGCTACG,0,1330591
furpa,0.1,9,9,GCGACTATCACGTGTTCTCT,0,1271925
furpa,0.1,9,9,GCGACATTCTTCGCAAGGAC,0,1275154
furpa,0.1,9,9,GCGACAAGAGTTTTCGGACA,0,1349163
furpa,0.1,9,9,GCGAATGGGTAAACCGGATA,0,1272507
furpa,0.1,9,9,GCCTGCCTCCGGCTTGTGAT,0,1286429
furpa,0.1,9,9,GCCTCTAGCGCAGACATTTG,0,1345772
furpa,0.1,9,9,GCCTATCGCTCTCTGCCGCA,0,1281592
furpa,0.1,9,9,GCCTAATTCGTGCACCTTCC,0,1283969
furpa,0.1,9,9,GCCGTCAATATAATTGCCTA,0,1345635
furpa,0.1,9,9,GCCCAAAGTTGACACAAGCA,0,1324384
furpa,0.1,9,9,GCCAGGCCACCCATTCGGAA,0,1336207
furpa,0.1,9,9,GCCACGATTAAGGCAAATGG,0,1314284
furpa,0.1,9,9,GCCAAGCCGTAGTCACGAGA,0,1332095
furpa,0.1,9,9,GCATGTTTATAGCGGAATGC,0,1303868
furpa,0.1,9,9,GCATCTCTATTGGTGGTAAC,0,1275091
furpa,0.1,9,9,GCATCCACGCTGGTCTGTCA,0,1348149
furpa,0.1,9,9,GCAGTTCCTATACCCCCTCA,0,1327268
furpa,0.1,9,9,GCAGGTATGCGGTGGATCGG,0,1298073
furpa,0.1,9,9,GCAGCCGTAAAGCAGCCAGA,0,1331075
furpa,0.1,9,9,GCAGACAGGTCGTCCGGTCC,0,1308559
furpa,0.1,9,9,GCACTGTTAGTCGCGGGGCT,0,1292385
furpa,0.1,9,9,GCACTATATGCGTGGGTGCA,0,1348506
furpa,0.1,9,9,GCACACGACTCTCCGGTACC,0,1283068
furpa,0.1,9,9,GCACAAGCTCTGTATTAAAT,0,1330505
furpa,0.1,9,9,GCACAACAGTCATTTGGGCA,0,1333150
furpa,0.1,9,9,GCAATATAAGTCAATCGAAG,0,1274141
furpa,0.1,9,9,GCAACGGGGCGTAGGCGGAT,0,1272109
furpa,0.1,9,9,GATGGCGAATCAGTATCCTC,0,1323222
furpa,0.1,9,9,GATCTATCTCACGAATCTGG,0,1299675
furpa,0.1,9,9,GATCCGTGTCGAAGGACAAG,0,1286003
furpa,0.1,9,9,GATACGCGGCTGGCAAGCTT,0,1347722
furpa,0.1,9,9,GAGTTAAGACCGGACTCACG,0,1307480
furpa,0.1,9,9,GAGTGTCAGTTTTCTGCTAG,0,1334600
furpa,0.1,9,9,GAGTGGTGCATACGATGTGC,0,1301481
furpa,0.1,9,9,GAGTGACACCAACTAGAGAG,0,1312090
furpa,0.1,9,9,GAGTCCTACACAACATCAGG,0,1292108
furpa,0.1,9,9,GAGTACGTAGGGGGTTTGAA,0,1344720
furpa,0.1,9,9,GAGGTGCATTCGAAGCTAGT,0,1294827
furpa,0.1,9,9,GAGGGGCCCAAAAGTATGAC,0,1294351
furpa,0.1,9,9,GAGGGACATTGGGTCAAGCC,0,1332003
furpa,0.1,9,9,GAGCGATTTCGTCTAAACAC,0,1315810
furpa,0.1,9,9,GAGCAAGGTCGAAGGCATTT,0,1286966
furpa,0.1,9,9,GAGATACGATCGCATGGTAA,0,1297460
furpa,0.1,9,9,GAGAGGCTAGGGAAGCGCGC,0,1353085
furpa,0.1,9,9,GAGACATGTGTTCCATCCGT,0,1281951
furpa,0.1,9,9,GAGAAATTGGAGAAGGACCA,0,1337788
furpa,0.1,9,9,GACTGGGGGACTAGACGTTC,0,1293999
furpa,0.1,9,9,GACTCGATTGACCCAGCTTA,0,1274632
furpa,0.1,9,9,GACGTGGGGCCGGGATAAGC,0,1284591
furpa,0.1,9,9,GACGGGTTTGATGGGATGCA,0,1290440
furpa,0.1,9,9,GACGCCCAAGCTGGCGGTCA,0,1342928
furpa,0.1,9,9,GACGATAAGTATATGGGGGT,0,1315829
furpa,0.1,9,9,GACCTTATCTTGATGTTTGA,0,1321481
furpa,0.1,9,9,GACCGCGCGTAACTGGTCGG,0,1302740
furpa,0.1,9,9,GACCCTCTGAATTGGCTAAC,0,1300730
furpa,0.1,9,9,GACATGGAATCTAGTGGTGA,0,1314598
furpa,0.1,9,9,GAATTTGCACAGTGGCAGAT,0,1347421
furpa,0.1,9,9,GAATGCCAGGCTTATATCCG,0,1318397
furpa,0.1,9,9,GAATGCAACTTTCGCGTATC,0,1305362
furpa,0.1,9,9,GAATCTTCCAGAGATTATGA,0,1298285
furpa,0.1,9,9,GAATCGTGATGGGTCCACAA,0,1304739
furpa,0.1,9,9,GAAGCAAGTAAGACTCAGAG,0,1348386
furpa,0.1,9,9,GAAATTTACAGTAGCGATTA,0,1304503
furpa,0.1,9,9,GAAAGGGAAGTTAAAACGTA,0,1341726
furpa,0.1,9,9,CTTTCCCGGTATCCTTGATC,0,1311864
furpa,0.1,9,9,CTTTACTCGTTGCACGCAAC,0,1285557
furpa,0.1,9,9,CTTGGATACATATGGCTCCA,0,1349443
furpa,0.1,9,9,CTTGCCCCCGAATCCCCTGA,0,1328088
furpa,0.1,9,9,CTTGACAGGGTTAGATGGGT,0,1293633
furpa,0.1,9,9,CTTGAAGGTGAGGGCGGTCC,0,1345371
furpa,0.1,9,9,CTTAGTTGCCGGCAGGATCC,0,1292807
furpa,0.1,9,9,CTTAGCTGGACGTCTACTAT,0,1309659
furpa,0.1,9,9,CTTACGTTGAGGTGGACTCT,0,1303365
furpa,0.1,9,9,CTGTGGGACGTACATCAAAG,0,1320857
furpa,0.1,9,9,CTGTGCGCTACCACTTAGAA,0,1326839
furpa,0.1,9,9,CTGTCTAGGGGCGGGGCGCC,0,1293760
furpa,0.1,9,9,CTGGCGAATGCTAATCAGCA,0,1274725
furpa,0.1,9,9,CTGCGCCGTGCTCTGTGAAT,0,1329604
furpa,0.1,9,9,CTGCCCGAAATTTGTACGCC,0,1341460
furpa,0.1,9,9,CTGCAAAGTGTGGTCCTGCA,0,1296729
furpa,0.1,9,9,CTGATCAGGCGGAATTTGTA,0,1342223
furpa,0.1,9,9,CTCTTTAGGGTAATGTACAT,0,1343208
furpa,0.1,9,9,CTCTGTTTAGTCTCTATCGC,0,1325229
furpa,0.1,9,9,CTCTCGCTGCCCATGTGGTA,0,1355538
furpa,0.1,9,9,CTCTCCAAGTTCGCGAGCTT,0,1343115
furpa,0.1,9,9,CTCTACCTCGCTTTTTATCA,0,1344945
furpa,0.1,9,9,CTCCAAGGCGACACCGTGCG,0,1280156
furpa,0.1,9,9,CTCAGTTCACGCAAGGAGAC,0,1337499
furpa,0.1,9,9,CTCAGGTGGATTAGGTGGAT,0,1322689
furpa,0.1,9,9,CTCAATGCCATAGTACTCCT,0,1296852
furpa,0.1,9,9,CTCAATCGGTGACGGGGGAT,0,1293839
furpa,0.1,9,9,CTATTCAAGCCCAAAATAAG,0,1286586
furpa,0.1,9,9,CTATGACTTATCACTTGGAA,0,1328173
furpa,0.1,9,9,CTATAGATCAGCTCATGTAC,0,1353926
furpa,0.1,9,9,CTATACGAAGACTATTCTTC,0,1292062
furpa,0.1,9,9,CTAGCCTGCTGAATGTTGCT,0,1340816
furpa,0.1,9,9,CTAGACAAAGTCGGGTACAA,0,1288729
furpa,0.1,9,9,CTACGTCAGAGGCCCCCACT,0,1320770
furpa,0.1,9,9,CTACGATGCCCTACCACAAG,0,1283520
furpa,0.1,9,9,CTAAGGGCGGAGCGTAGCCT,0,1282040
furpa,0.1,9,9,CTAACTTTGAATGTGTTAAC,0,1293279
furpa,0.1,9,9,CGTTTTAGAGAAGTGCTCTG,0,1307836
furpa,0.1,9,9,CGTTTCAGATGTAATAGCCC,0,1303662
furpa,0.1,9,9,CGTTCGAAGAATCCGGCTAA,0,1300206
furpa,0.1,9,9,CGTGATGCGCCGGTAGGAGC,0,1321105
furpa,0.1,9,9,CGTGATGAGGTTAGGGTGCA,0,1343155
furpa,0.1,9,9,CGTCCTGTGGGATGACTAAT,0,1295302
furpa,0.1,9,9,CGTCCAATTGTATGCAAGAC,0,1273917
furpa,0.1,9,9,CGTCATTATGCGGATTATAA,0,1288057
furpa,0.1,9,9,CGTCATGGGTACGCACTACG,0,1338978
furpa,0.1,9,9,CGTATGATTTGTAACAGAGT,0,1348559
furpa,0.1,9,9,CGTAGTTCGGGCGCAACAAC,0,1273125
furpa,0.1,9,9,CGTACCGATGTAAAACAGAT,0,1329537
furpa,0.1,9,9,CGTAAGTTTAACCGCAGGCA,0,1276930
furpa,0.1,9,9,CGTAAAGTTATTATTATGAG,0,1300169
furpa,0.1,9,9,CGGTTAGGGGTAGAGTGGCT,0,1302942
furpa,0.1,9,9,CGGCCGCAAAACGTACTATC,0,1295780
furpa,0.1,9,9,CGGCCATGAGAGGAATTCGC,0,1310089
furpa,0.1,9,9,CGGCAGAGCAACGTGTTGCA,0,1299378
furpa,0.1,9,9,CGGCAACGTTTAGCAGCTCG,0,1296795
furpa,0.1,9,9,CGGATGAGTTGGCTAAACCA,0,1283729
furpa,0.1,9,9,CGGATCGGGATGAAACAAAA,0,1280397
furpa,0.1,9,9,CGCTCATAAACTGACACTTA,0,1302520
furpa,0.1,9,9,CGCTAGCTCGGCTTTCTTAG,0,1348393
furpa,0.1,9,9,CGCGTGCCGGACGTAGCTCA,0,1340790
furpa,0.1,9,9,CGCGTCCCTAGAGAATGAGT,0,1271655
furpa,0.1,9,9,CGCGGCTCTGGGTTTTACTT,0,1316780
furpa,0.1,9,9,CGCGCCATCTTGCAGGATAG,0,1299424
furpa,0.1,9,9,CGCGAAAGTCAGTAAGGTCA,0,1350039
furpa,0.1,9,9,CGCCTTTTGTCTAAAATAAG,0,1289971
furpa,0.1,9,9,CGCCCTGAGGGAAAAGCCGT,0,1314105
furpa,0.1,9,9,CGCCCATATTTGTGGTTTGA,0,1357378
furpa,0.1,9,9,CGCAGTTTAGGTCGCACTGC,0,1298480
furpa,0.1,9,9,CGCAGACGAGCTCATGGCGG,0,1326603
furpa,0.1,9,9,CGATGGCAGGTATTCCAGCG,0,1319641
furpa,0.1,9,9,CGAGTGTGTTTCGAGTTAAT,0,1302194
furpa,0.1,9,9,CGACTTTACTATTTAGGAGG,0,1329422
furpa,0.1,9,9,CGACAATCGACATGACGTTC,0,1315543
furpa,0.1,9,9,CGAAGTCAAGAAGATTGCAA,0,1276074
furpa,0.1,9,9,CGAAGGTACTGAAACGTTGT,0,1283709
furpa,0.1,9,9,CGAAAACGCTCGCCTGGACT,0,1313689
furpa,0.1,9,9,CCTTTCTGAGCTGTGGTATC,0,1336149
furpa,0.1,9,9,CCTTCAACAACTGGCCCTTC,0,1281970
furpa,0.1,9,9,CCTGTGCAGTACAATGGATC,0,1276313
furpa,0.1,9,9,CCTGGGGCACTAAGGAGACT,0,1276626
furpa,0.1,9,9,CCTCCTCCGTGAATGCGCGG,0,1277654
furpa,0.1,9,9,CCTCATAGAGGGCGACTCGA,0,1352176
furpa,0.1,9,9,CCTACGCACAGCGACCCGAT,0,1351837
furpa,0.1,9,9,CCGTACGCTGCTCGACTATT,0,1343285
furpa,0.1,9,9,CCGGGTACGCCACGGGAGTT,0,1342558
furpa,0.1,9,9,CCGGGGGGATCTGCGAGCGT,0,1330936
furpa,0.1,9,9,CCGGGAAATTCCTTTACGAC,0,1311722
furpa,0.1,9,9,CCGCCACACCCCCGTGGAGG,0,1300624
furpa,0.1,9,9,CCGACCTCTAGCGGAGCTCT,0,1344782
furpa,0.1,9,9,CCCTGTGCCCCCGAAGGATG,0,1357462
furpa,0.1,9,9,CCCTGAAGAGCAATGTTTAC,0,1283085
furpa,0.1,9,9,CCCTCAGGGGACGCGGCAAG,0,1336276
furpa,0.1,9,9,CCCTACTCTGATACACTTAT,0,1298231
furpa,0.1,9,9,CCCCTTTAGCACTTCGTGGC,0,1307774
furpa,0.1,9,9,CCCAATACTTAAGCCGAGTC,0,1330725
furpa,0.1,9,9,CCATTTGATTGCTGTGCGAG,0,1324263
furpa,0.1,9,9,CCATTGACATGCGAGCGAAG,0,1342709
furpa,0.1,9,9,CCATGTTTGCGCGGCTGATG,0,1295200
furpa,0.1,9,9,CCATCTGGGGAATGCGGAGA,0,1342443
furpa,0.1,9,9,CCAGGTTGGAGGGGTCTCCG,0,1292862
furpa,0.1,9,9,CCACCCGACGTTAATTCTCA,0,1304685
furpa,0.1,9,9,CCACAATTAACTGCGCCCGC,0,1357793
furpa,0.1,9,9,CCAATCACCAAATTGTCTCT,0,1298919
furpa,0.1,9,9,CCAAGTCCTTGATGCGGCGA,0,1352563
furpa,0.1,9,9,CCAAGGAATCGGCTATAGCA,0,1300924
furpa,0.1,9,9,CCAACTGTTGGTCTTACAGA,0,1292804
furpa,0.1,9,9,CATTGCACTAACTGAGTGTA,0,1332650
furpa,0.1,9,9,CATTGAGACGGTGCCCAATA,0,1316257
furpa,0.1,9,9,CATTAGAATCTTCAGGGACG,0,1276290
furpa,0.1,9,9,CATGTGAGTCGCAATCCCAA,0,1326229
furpa,0.1,9,9,CATGGCCCATTCATTATGAG,0,1354122
furpa,0.1,9,9,CATCTTTATAAGAAGGCTTG,0,1310025
furpa,0.1,9,9,CATATGGCACCACTGAGGTT,0,1331603
furpa,0.1,9,9,CATAGGGGCCACTACACGAG,0,1335151
furpa,0.1,9,9,CATACGACCATCGCGCGTTC,0,1311010
furpa,0.1,9,9,CATAATCAATATGCGGAGTT,0,1356424
furpa,0.1,9,9,CAGTTTATACGCGACATAAA,0,1295645
furpa,0.1,9,9,CAGTGGCGGGTATGGAGATT,0,1328595
furpa,0.1,9,9,CAGGTGGGCAGGCAAGGGGG,0,1331855
furpa,0.1,9,9,CAGGTCTTATACACTTAATG,0,1341203
furpa,0.1,9,9,CAGGGCGTTAGCTAGCTGCC,0,1277007
furpa,0.1,9,9,CAGGAGGGAATGGTCTCGGT,0,1333684
furpa,0.1,9,9,CAGGAGGACGATGGAAGATG,0,1311240
furpa,0.1,9,9,CAGCGGTGAAGTAGGACCGG,0,1306141
furpa,0.1,9,9,CAGATAGTAATCGTTACAAC,0,1347625
furpa,0.1,9,9,CAGACCCTTCTGACAAGGGG,0,1324509
furpa,0.1,9,9,CACTTATATAACAGTCAGCT,0,1333220
furpa,0.1,9,9,CACGTATAGGCTTAAAGCGA,0,1341238
furpa,0.1,9,9,CACGGAACGTTATGGTAGCA,0,1320544
furpa,0.1,9,9,CACGAGGTGACTTATCGTGT,0,1283455
furpa,0.1,9,9,CACCGCCCAAGGCTCGGTGA,0,1344496
furpa,0.1,9,9,CACCGACCTTAGGGTACCCA,0,1321410
furpa,0.1,9,9,CACAGGGCTTGCGAGGGATA,0,1290155
furpa,0.1,9,9,CACACGAGGGGGCTGGCATC,0,1355977
furpa,0.1,9,9,CAATGTCTCCTTACTATTAA,0,1280363
furpa,0.1,9,9,CAATGGGTGAGGAACGACCT,0,1303565
furpa,0.1,9,9,CAATAGCTAGTTTTGGCAAG,0,1293637
furpa,0.1,9,9,CAAGTCAAGACGTCCATTAC,0,1345317
furpa,0.1,9,9,CAAGGCGATAGCGTGGTCGC,0,1316225
furpa,0.1,9,9,CAAGGCACCCGGGTTATGTT,0,1316019
furpa,0.1,9,9,CAAGCCCATGCCGTCTAACG,0,1275395
furpa,0.1,9,9,CAAGACCTGCCTGTTCGAAA,0,1307527
furpa,0.1,9,9,CAACTGTTGACAAATGAATT,0,1280087
furpa,0.1,9,9,CAACCGCGTCACACGCGGCA,0,1310796
furpa,0.1,9,9,CAACCCAGTAGCCGGTGATA,0,1348775
furpa,0.1,9,9,ATTTCGATTCGGAGGACGGT,0,1284862
furpa,0.1,9,9,ATTTCGAGCCAGGTCGTGTT,0,1351890
furpa,0.1,9,9,ATTGTGCGGAAAAGAAGAGG,0,1351690
furpa,0.1,9,9,ATTGGATCGTAGTCAAATAA,0,1344340
furpa,0.1,9,9,ATTGGATAGCACTGGGGCCT,0,1322933
furpa,0.1,9,9,ATTGCCCTAAAATGTTCATT,0,1345808
furpa,0.1,9,9,ATTGCCCCTCAAAGAGGATT,0,1304216
furpa,0.1,9,9,ATTGAGACGGCAGGACAAAA,0,1297429
furpa,0.1,9,9,ATTGACTAGCGGTTGCGGCA,0,1275151
furpa,0.1,9,9,ATTCGTCGAAAGACCAGTTG,0,1310274
furpa,0.1,9,9,ATTAGGTTTGTGATCAAAAT,0,1348458
furpa,0.1,9,9,ATTAGCATAGAGCGACGCGC,0,1283946
furpa,0.1,9,9,ATTAATCTCAATGATGTTAA,0,1347185
furpa,0.1,9,9,ATGTTTCTCACTTAAGATAA,0,1304563
furpa,0.1,9,9,ATGTTCATGATAAAATGCTG,0,1285476
furpa,0.1,9,9,ATGTTAATTTGTTGGCCCTC,0,1281276
furpa,0.1,9,9,ATGTTAAGGCCCTATTGAAT,0,1332719
furpa,0.1,9,9,ATGGGACTGGTTCCATGAAT,0,1273137
furpa,0.1,9,9,ATGGAGATTCGAACGCTAAG,0,1322073
furpa,0.1,9,9,ATGCGGTCCCTGGGTTCCCT,0,1326832
furpa,0.1,9,9,ATGAGGATCACACTGGCTCT,0,1287936
furpa,0.1,9,9,ATGAGCTGATCTGTGCCTGT,0,1278175
furpa,0.1,9,9,ATGAATGGCGGCTATCCGAA,0,1337775
furpa,0.1,9,9,ATCTTGATTACATACTCAGT,0,1282378
furpa,0.1,9,9,ATCTCGTGCACAACGTGCAA,0,1285942
furpa,0.1,9,9,ATCTAAGCAGAGACTTGCTA,0,1316901
furpa,0.1,9,9,ATCTAAAGACCATAAGTCAC,0,1284409
furpa,0.1,9,9,ATCGTGCATTCGCTCCCTTG,0,1286823
furpa,0.1,9,9,ATCGTCTATTTTGTGGTTTG,0,1304202
furpa,0.1,9,9,ATCGTCAACACGCAGGGGGA,0,1290771
furpa,0.1,9,9,ATCGCTGACTGCCATAGGGT,0,1294760
furpa,0.1,9,9,ATCGCGCTTAAGGGGTAATA,0,1280904
furpa,0.1,9,9,ATCGCCCGTTTTTCCGGGAC,0,1341409
furpa,0.1,9,9,ATCCTTTAAGAGTGCGTCGT,0,1345249
furpa,0.1,9,9,ATCCTAACCTGGCATACCCA,0,1310171
furpa,0.1,9,9,ATCCGTCTAACACCAATAAC,0,1277406
furpa,0.1,9,9,ATCCGCACGAGGATACTAAG,0,1335225
furpa,0.1,9,9,ATCATCTAGTCTGACCAAGG,0,1309137
furpa,0.1,9,9,ATCAGACGGACGCCTTCGAG,0,1313933
furpa,0.1,9,9,ATCACGCAGGCTGACAATGG,0,1335990
furpa,0.1,9,9,ATATCTCGGGTGGAAGGTTA,0,1357118
furpa,0.1,9,9,ATAGCGGCTAAACATTCCGT,0,1300785
furpa,0.1,9,9,ATAATTAACTAAGCCTAGAC,0,1356980
furpa,0.1,9,9,ATAATCATGCTGGTGAATTG,0,1335977
furpa,0.1,9,9,ATAAGACTATCTGCGCGCAG,0,1315966
furpa,0.1,9,9,ATAACAGGCAAATTACACCT,0,1354371
furpa,0.1,9,9,AGTTTCTCATGTCTGTTCAT,0,1293990
furpa,0.1,9,9,AGTTTCCCACTATTCGACTT,0,1307362
furpa,0.1,9,9,AGTTACGATGACATGCACAT,0,1279000
furpa,0.1,9,9,AGTGTTGCTTCACGTTTTGG,0,1310713
furpa,0.1,9,9,AGTGGCTAACGCCAACGAGT,0,1300915
furpa,0.1,9,9,AGTGGACCTTGATCAAACGC,0,1328444
furpa,0.1,9,9,AGTGAGGGTTGTACCTGTAT,0,1281324
furpa,0.1,9,9,AGTCGCCCGATTTGCTTCCA,0,1329710
furpa,0.1,9,9,AGTCAGAAATACAGTTCAAA,0,1330375
furpa,0.1,9,9,AGTAGCACTTACGCGTGTTT,0,1288774
furpa,0.1,9,9,AGTAGAGCTAGCCCATCTAC,0,1338126
furpa,0.1,9,9,AGTAAATTGGAAAGCTGCTG,0,1340101
furpa,0.1,9,9,AGGTTAATGCATCTATTTGG,0,1302130
furpa,0.1,9,9,AGGTAATCAAGTTACGAACT,0,1316632
furpa,0.1,9,9,AGGGAGCGTTGCCTTAGAGA,0,1341084
furpa,0.1,9,9,AGGGAAAGCGTACCTCCGAA,0,1299854
furpa,0.1,9,9,AGGCGGCCCGGAGTTGGGTA,0,1310398
furpa,0.1,9,9,AGGCCCTCGATGGTACAATT,0,1272912
furpa,0.1,9,9,AGGATTGCGAGTCATCGGGT,0,1281399
furpa,0.1,9,9,AGGATAAGGTTGGGTAATCG,0,1319052
furpa,0.1,9,9,AGCTTAGGCGCTCTCGGCAA,0,1283074
furpa,0.1,9,9,AGCGCATGCTCTTGGGTCGG,0,1282887
furpa,0.1,9,9,AGCCCACCGGGTATCTGTGC,0,1348004
furpa,0.1,9,9,AGCATTAATTATAGTTCGAT,0,1298973
furpa,0.1,9,9,AGCATGCGATCAAGATCGTC,0,1341361
furpa,0.1,9,9,AGCAGAGGGTGTCAGACCGC,0,1285473
furpa,0.1,9,9,AGCACCGTGGGGTCGATGTT,0,1318842
furpa,0.1,9,9,AGATGGCTAGACAAAGCAGT,0,1276110
furpa,0.1,9,9,AGATGCTGGTCAGCCGTCTC,0,1274059
furpa,0.1,9,9,AGAGTCTTAAGTCCTACACA,0,1321687
furpa,0.1,9,9,AGAGGGATCAAGAGTTTGGC,0,1306180
furpa,0.1,9,9,AGAGACTCATGTAATAGACA,0,1323466
furpa,0.1,9,9,AGAGACAGACATTGGTTTCA,0,1286764
furpa,0.1,9,9,AGACTGGTTATGAACTATAC,0,1286746
furpa,0.1,9,9,AGACCGCGGTAGAATCATGC,0,1276254
furpa,0.1,9,9,AGACCCACGCAGGACATTTG,0,1321791
furpa,0.1,9,9,AGACAACTGAGGGTGGGTGT,0,1354207
furpa,0.1,9,9,ACTTCGTGTAATATGCACGT,0,1295284
furpa,0.1,9,9,ACTGTCATTCTACATTTCTC,0,1272108
furpa,0.1,9,9,ACTGAGAGGTTGAATTTCTT,0,1319497
furpa,0.1,9,9,ACTGACGACCATTAGGCCTT,0,1319860
furpa,0.1,9,9,ACTCGCCTAAACTTGCACCC,0,1309655
furpa,0.1,9,9,ACTCGAGTTTCACCTCTGCA,0,1349482
furpa,0.1,9,9,ACTCATTTGGAGTAAGTACC,0,1290917
furpa,0.1,9,9,ACTCAAACCACGCGGCTGTT,0,1340456
furpa,0.1,9,9,ACGTTCTATACTTGCACCGG,0,1287588
furpa,0.1,9,9,ACGTGGATCGCGGCACATTT,0,1346447
furpa,0.1,9,9,ACGTATATTTTAGCGTTAGT,0,1293432
furpa,0.1,9,9,ACGTACCGCTACTGTCTCGG,0,1327497
furpa,0.1,9,9,ACGGGTATACTTTAGCGTCA,0,1349011
furpa,0.1,9,9,ACGGGTAATGCATAGAGACC,0,1329020
furpa,0.1,9,9,ACGGGCCTCGTTTGCACTGA,0,1275867
furpa,0.1,9,9,ACGCTTCTTGCTTGTAGTCT,0,1347173
furpa,0.1,9,9,ACGCGTAATCATTCCTAGTA,0,1310989
furpa,0.1,9,9,ACGATGGTCTGTTACTGTTG,0,1343924
furpa,0.1,9,9,ACGAAACGGCCAGCGCACAC,0,1350807
furpa,0.1,9,9,ACCTAGAATGCGGGCAACAT,0,1315074
furpa,0.1,9,9,ACCGTTACTACCAAGTAACG,0,1332687
furpa,0.1,9,9,ACCGGGAGTCGCGACAGTAA,0,1326845
furpa,0.1,9,9,ACCGACAAGCACCCAACGGC,0,1305456
furpa,0.1,9,9,ACCCTTATATTCAAAAGGTT,0,1350665
furpa,0.1,9,9,ACCCGGGAGGAATATGGGTC,0,1282791
furpa,0.1,9,9,ACCAGAAGCCCTCGTTTTAT,0,1297882
furpa,0.1,9,9,ACCAATGTACATGGTGTACA,0,1274096
furpa,0.1,9,9,ACATAAAGATCAATGCAGAG,0,1333691
furpa,0.1,9,9,ACAGTTGTCTTGCTCCGATC,0,1338231
furpa,0.1,9,9,ACAGGGGGCGGAATTCTAGC,0,1305215
furpa,0.1,9,9,ACAGCCACTATGATGCTTGG,0,1314590
furpa,0.1,9,9,ACACGTATGTTACTGATCGG,0,1317792
furpa,0.1,9,9,ACACGACGCCGGGGGATCAC,0,1319844
furpa,0.1,9,9,ACACCGCAGCTGGGGGTGCA,0,1303500
furpa,0.1,9,9,ACACATATCCCTCAGGACCA,0,1356986
furpa,0.1,9,9,ACAAATATCGGTTTGTTCGG,0,1297424
furpa,0.1,9,9,AATTATAATCTGAATACAGC,0,1293663
furpa,0.1,9,9,AATGGCAAATTGTCTCTACA,0,1285233
furpa,0.1,9,9,AATGACTCAATCCCGGTCCT,0,1290444
furpa,0.1,9,9,AATGACCCATCTAGGGTAAT,0,1306399
furpa,0.1,9,9,AATGACACCTAGCTTGCCGT,0,1296138
furpa,0.1,9,9,AATGAAATATAGTACGGCTT,0,1274626
furpa,0.1,9,9,AATAGGATTTCTGAACCTGC,0,1296676
furpa,0.1,9,9,AATACCCCTGATTTGGTTCA,0,1356814
furpa,0.1,9,9,AATAACGCAAACGGGACAAC,0,1353993
furpa,0.1,9,9,AAGTGAGCCACTACATTAAA,0,1299839
furpa,0.1,9,9,AAGTATCCGGGTTATTGAAC,0,1297933
furpa,0.1,9,9,AAGGGGGGCTATTATTTCAA,0,1323471
furpa,0.1,9,9,AAGGATCGGCTCCGATTAGT,0,1307656
furpa,0.1,9,9,AAGCGTATAGTACATAGGAC,0,1314844
furpa,0.1,9,9,AAGCCGGAGGTAACCGTAGT,0,1353994
furpa,0.1,9,9,AAGCAGCGCGTGAGCCAAAG,0,1326334
furpa,0.1,9,9,AAGATTCGTACTTCCCGAGT,0,1316145
furpa,0.1,9,9,AACTCATGAGAATTATATTA,0,1282547
furpa,0.1,9,9,AACGGCTCACGCTATGTTGC,0,1317701
furpa,0.1,9,9,AACCGTACAATGTGCTGGGT,0,1356063
furpa,0.1,9,9,AACCAGTATTGTTAATCCCA,0,1320681
furpa,0.1,9,9,AAATTCAACTAAGAGTAATA,0,1346343
furpa,0.1,9,9,AAATTAGTCTGGCTACCAGT,0,1326063
furpa,0.1,9,9,AAAGTCAGTCTGCAGCGAAT,0,1338080
furpa,0.1,9,9,AAAGTAATGAAGTGGCTGAG,0,1357316
furpa,0.1,9,9,AAACTTTCCATCAAGTAAAA,0,1292060
furpa,0.1,9,9,AAACTTATAGTCGAAGAACG,0,1301086
furpa,0.1,9,9,AAACTCATGGGTTGCCCGCT,0,1328037
furpa,0.1,9,9,AAACGACGTGTGCAGGTGGC,0,1329472
furpa,0.1,9,9,AAACCGTAAGTCTTCCGGAT,0,1278219
furpa,0.1,9,9,AAACAGTGTTAACCCGCTGG,0,1306506
furpa,0.1,9,9,AAAAATTCTTATGGTCATTA,0,1351018
furpa,0.1111111111111111,8,8,TTTTGTCAGTAGGCTGCTTT,0,1336336
furpa,0.1111111111111111,8,8,TTTTGGTTATCGGGATTGGT,0,1279113
furpa,0.1111111111111111,8,8,TTTTCTACCTCGTTAATGAG,0,1272279
furpa,0.1111111111111111,8,8,TTTTATACGTACTAGGCAGG,0,1297087
furpa,0.1111111111111111,8,8,TTTTATACAGGTAAAGCAGA,0,1340371
furpa,0.1111111111111111,8,8,TTTGTTTGACTATACATTAT,0,1311171
furpa,0.1111111111111111,8,8,TTTGTTCACCCGGCCTGCAA,0,1328984
furpa,0.1111111111111111,8,8,TTTGGGGGAGTTCTGGGTGA,0,1325026
furpa,0.1111111111111111,8,8,TTTCATATGCTGAAGAGGTC,0,1308689
furpa,0.1111111111111111,8,8,TTGTTCTGTTTGCCGGATTT,0,1330688
furpa,0.1111111111111111,8,8,TTGTATGGCTGTGTTCCAGG,0,1335417
furpa,0.1111111111111111,8,8,TTGGTTTGTGTGTCCCCGTC,0,1298602
furpa,0.1111111111111111,8,8,TTGGGTCGAGCAGGCATCCC,0,1345656
furpa,0.1111111111111111,8,8,TTGGGACGTAGCCTGCTGTG,0,1338953
furpa,0.1111111111111111,8,8,TTGCTTTGCGGGGCGTTTAT,0,1273650
furpa,0.1111111111111111,8,8,TTGCACGTGGGATAATCCCT,0,1339874
furpa,0.1111111111111111,8,8,TTGACCCACTTGTCGTGATC,0,1277335
furpa,0.1111111111111111,8,8,TTGACAGTTAGTAGTTCGAT,0,1294985
furpa,0.1111111111111111,8,8,TTGAATCTCTAGCGCGCCGT,0,1308402
furpa,0.1111111111111111,8,8,TTGAAGGGTCGGACTGAAGT,0,1301843
furpa,0.1111111111111111,8,8,TTGAACAATCGACGGGTGGG,0,1273250
furpa,0.1111111111111111,8,8,TTCTGTGTAGTTAAAACCAC,0,1286615
furpa,0.1111111111111111,8,8,TTCTGACAGATAATATTAAC,0,1292230
furpa,0.1111111111111111,8,8,TTCTAGATCGAGTGGCGTAT,0,1356259
furpa,0.1111111111111111,8,8,TTCGTACCACTCATGGTGAG,0,1351069
furpa,0.1111111111111111,8,8,TTCGGTGAGGCGGGCGTTGA,0,1297883
furpa,0.1111111111111111,8,8,TTCGCTGCTCAATCCCGCTG,0,1315971
furpa,0.1111111111111111,8,8,TTCGCGTCAAGTTAGTATGT,0,1277418
furpa,0.1111111111111111,8,8,TTCCGCTTGCAATCTACCCT,0,1295238
furpa,0.1111111111111111,8,8,TTCATGAGATTCAAAATCTT,0,1286290
furpa,0.1111111111111111,8,8,TTCAGGATTGTGGCGACTGC,0,1341622
furpa,0.1111111111111111,8,8,TTATTTCACGACCTAACGTT,0,1277056
furpa,0.1111111111111111,8,8,TTATGTCGTGTGACCTTATG,0,1317884
furpa,0.1111111111111111,8,8,TTATCGGGGCGTACAGAGAA,0,1299670
furpa,0.1111111111111111,8,8,TTATCGCGAGTTTTTTTCTA,0,1349838
furpa,0.1111111111111111,8,8,TTATCCAATCCACCAATTAA,0,1278487
furpa,0.1111111111111111,8,8,TTAGGGAGTCGTGATTTGGG,0,1302083
furpa,0.1111111111111111,8,8,TTAGCTAATTACCCGCGGGT,0,1306479
furpa,0.1111111111111111,8,8,TTAGCCAATGTTTCGGAACC,0,1355423
furpa,0.1111111111111111,8,8,TTAGACCAATTCTATAGGCA,0,1300861
furpa,0.1111111111111111,8,8,TTACGGGATGATTTGAAACC,0,1305117
furpa,0.1111111111111111,8,8,TTACGGCAACACACATCAGT,0,1303025
furpa,0.1111111111111111,8,8,TTACGCGGGAGGATGCACAC,0,1338520
furpa,0.1111111111111111,8,8,TTACGAGAGTCCGAGCGCTA,0,1316684
furpa,0.1111111111111111,8,8,TTACCCTGATCTGGAGCGGT,0,1340539
furpa,0.1111111111111111,8,8,TTACAAAAAGGCGAGCGTTC,0,1295948
furpa,0.1111111111111111,8,8,TGTTTCTTTCCTCCGGCATG,0,1302333
furpa,0.1111111111111111,8,8,TGTTGTCCATCGGCGACCCT,0,1352221
furpa,0.1111111111111111,8,8,TGTTGTACGGGAAGGGGCGT,0,1282366
furpa,0.1111111111111111,8,8,TGTTCAGGCGGAAAGGCACG,0,1307292
furpa,0.1111111111111111,8,8,TGTTAGGCAACCGCTCCTGT,0,1324847
furpa,0.1111111111111111,8,8,TGTTAATGGCCGTCTGTAAG,0,1306171
furpa,0.1111111111111111,8,8,TGTGTTGGTGAAACCGAGAT,0,1351115
furpa,0.1111111111111111,8,8,TGTGTATATCCGCTGGACGT,0,1337448
furpa,0.1111111111111111,8,8,TGTCTGTTGTCGCTTTGCTC,0,1324115
furpa,0.1111111111111111,8,8,TGTCGCGTAGAAAAGGATCT,0,1296109
furpa,0.1111111111111111,8,8,TGTCCCCGCTTACGAAATAT,0,1300942
furpa,0.1111111111111111,8,8,TGTACTCGCTGGCCTGGGAA,0,1285483
furpa,0.1111111111111111,8,8,TGGTTTTGGAGTTAACTTGA,0,1346971
furpa,0.1111111111111111,8,8,TGGTGGAGTACGAGATCACT,0,1337518
furpa,0.1111111111111111,8,8,TGGTCGGTCTACGAAGGTCG,0,1273307
furpa,0.1111111111111111,8,8,TGGTCACAGATGGCTATTTT,0,1349945
furpa,0.1111111111111111,8,8,TGGTATCTTGGTAGACTGAC,0,1296843
furpa,0.1111111111111111,8,8,TGGGGCTTCCTTATACGTTA,0,1319028
furpa,0.1111111111111111,8,8,TGGGCTTACGGCGTCTAATA,0,1281646
furpa,0.1111111111111111,8,8,TGGGCCAGCCAGGGGCGGAT,0,1354241
furpa,0.1111111111111111,8,8,TGGGCCAAGCCGGGCTTGCT,0,1347854
furpa,0.1111111111111111,8,8,TGGGAGCCCGTTTGGTACGC,0,1279302
furpa,0.1111111111111111,8,8,TGGGAGAGGGGCAACTCGTA,0,1313170
furpa,0.1111111111111111,8,8,TGGCGGCGTACAGAGGAGAT,0,1287395
furpa,0.1111111111111111,8,8,TGGCCCGCCTCATCGTGAGA,0,1357236
furpa,0.1111111111111111,8,8,TGGCATAATCCGTTAATTAA,0,1345050
furpa,0.1111111111111111,8,8,TGGCACCAACTAACACGGCG,0,1308282
furpa,0.1111111111111111,8,8,TGGATGAGAACTTTTGGTTA,0,1290648
furpa,0.1111111111111111,8,8,TGGACTTGTTAAAAACCCAA,0,1354472
furpa,0.1111111111111111,8,8,TGCTTCCGGTCTAACGGAAT,0,1342963
furpa,0.1111111111111111,8,8,TGCTTCACGCCATTTTTGTG,0,1304605
furpa,0.1111111111111111,8,8,TGCTACAGAATTCCTAGGGC,0,1310703
furpa,0.1111111111111111,8,8,TGCGTTATCAGGGAGGATCT,0,1311659
furpa,0.1111111111111111,8,8,TGCCTCGGAAAGACCTCAAC,0,1343256
furpa,0.1111111111111111,8,8,TGCCGCCGAGCTAATGCGCT,0,1354078
furpa,0.1111111111111111,8,8,TGCCACTCGATGGAGTCGTT,0,1322427
furpa,0.1111111111111111,8,8,TGCCACGGCCGAGATAAGCA,0,1317959
furpa,0.1111111111111111,8,8,TGCACTTAGAAATCCAGTCT,0,1318231
furpa,0.1111111111111111,8,8,TGCACGTTGGCGAGGACGTT,0,1308438
furpa,0.1111111111111111,8,8,TGCACGTGTCGTGGAATTCT,0,1283494
furpa,0.1111111111111111,8,8,TGCACCGTTTAAGCACGCTA,0,1308604
furpa,0.1111111111111111,8,8,TGATTACTGAACCGGGTGTT,0,1330642
furpa,0.1111111111111111,8,8,TGATCGTACGCTTTTGAATT,0,1324181
furpa,0.1111111111111111,8,8,TGATACCCAGGTCCTTGACG,0,1305249
furpa,0.1111111111111111,8,8,TGAGTATACTGGCTTAGGTA,0,1351900
furpa,0.1111111111111111,8,8,TGAGATGACCTGCGTGAGAA,0,1326923
furpa,0.1111111111111111,8,8,TGACGTTCCACTCCAATGGA,0,1344665
furpa,0.1111111111111111,8,8,TGACCCTTAAGAGATACGCA,0,1278030
furpa,0.1111111111111111,8,8,TGAATTTGGGATGGTTAAAT,0,1310088
furpa,0.1111111111111111,8,8,TGAATGCATACGCATCCCTA,0,1272935
furpa,0.1111111111111111,8,8,TGAAATCCCTGATATTAGTC,0,1323256
furpa,0.1111111111111111,8,8,TGAAATCACATCCGGGCGAC,0,1315721
furpa,0.1111111111111111,8,8,TCTTTATCTGTGGGACCGAT,0,1346544
furpa,0.1111111111111111,8,8,TCTTCCCGGTATATGGGGTT,0,1284380
furpa,0.1111111111111111,8,8,TCTTACAGAGGGAGAGATTT,0,1334272
furpa,0.1111111111111111,8,8,TCTGGTGTTACAGTGTAGAT,0,1322459
furpa,0.1111111111111111,8,8,TCTGCTGGATACCGATCATG,0,1307798
furpa,0.1111111111111111,8,8,TCTGAATACACAGCGTAGCA,0,1355059
furpa,0.1111111111111111,8,8,TCTACAACGTATGCAGTGAA,0,1346972
furpa,0.1111111111111111,8,8,TCGTGCAAGAGTTGTGTCGT,0,1315180
furpa,0.1111111111111111,8,8,TCGTCATCCGTAATGTAGGA,0,1278610
furpa,0.1111111111111111,8,8,TCGGGTTGCCGTTTGAGGAA,0,1309749
furpa,0.1111111111111111,8,8,TCGGCTAGATAAGCTTTCAT,0,1346233
furpa,0.1111111111111111,8,8,TCGGAGGCACCTTCCCCTAT,0,1292933
furpa,0.1111111111111111,8,8,TCGCGCCTATAGGACAAGTC,0,1320581
furpa,0.1111111111111111,8,8,TCGCATCAGTGAGCAATTCC,0,1280912
furpa,0.1111111111111111,8,8,TCGCAGTAGGTATCCCGCGT,0,1300107
furpa,0.1111111111111111,8,8,TCGCAGACGTATGGTGCGAC,0,1315224
furpa,0.1111111111111111,8,8,TCGATTCATGTATGGTGCCA,0,1316394
furpa,0.1111111111111111,8,8,TCGAGGACCGGACTGCGGTT,0,1344868
furpa,0.1111111111111111,8,8,TCGAATTCTGTGCGAAAATC,0,1314898
furpa,0.1111111111111111,8,8,TCGAATGTCTGAAGCTTCAT,0,1346705
furpa,0.1111111111111111,8,8,TCCTGTCTTGTCGTTAGGCA,0,1276068
furpa,0.1111111111111111,8,8,TCCGGGGAAGCTTTGAGGCT,0,1335411
furpa,0.1111111111111111,8,8,TCCCGGATCGGAGGGGTATA,0,1307113
furpa,0.1111111111111111,8,8,TCCAGTCCATCAAAAAAGTA,0,1313248
furpa,0.1111111111111111,8,8,TCCAGGATCTTACTATTTCA,0,1339989
furpa,0.1111111111111111,8,8,TCCAGCAGGTAGGTCTGGTT,0,1349665
furpa,0.1111111111111111,8,8,TCCACAATAAGAGAGGTAAT,0,1274745
furpa,0.1111111111111111,8,8,TCCAAACCGTTTCACCACCG,0,1348109
furpa,0.1111111111111111,8,8,TCATGCTGGCGTCACGGTAA,0,1335093
furpa,0.1111111111111111,8,8,TCATCGACAGATTTATCCCA,0,1320665
furpa,0.1111111111111111,8,8,TCATATGACAAGGGTAATCG,0,1356095
furpa,0.1111111111111111,8,8,TCAGTCAGAGTGGAATGAGC,0,1273449
furpa,0.1111111111111111,8,8,TCAGTATACTGCCACCGATT,0,1307308
furpa,0.1111111111111111,8,8,TCACTCGCCGGTTCCAGGCA,0,1336143
furpa,0.1111111111111111,8,8,TCACGGGCTCCGTGCAGCTT,0,1346465
furpa,0.1111111111111111,8,8,TCACGCAAGGTTACAGCGGG,0,1302244
furpa,0.1111111111111111,8,8,TCACATCCCCTTACCCGTAC,0,1323218
furpa,0.1111111111111111,8,8,TCAATTGCGTCTTACTTGAC,0,1356584
furpa,0.1111111111111111,8,8,TCAACTGCTGTTGCGCGAGT,0,1327841
furpa,0.1111111111111111,8,8,TCAACTAACCCAGGTGCCAG,0,1340964
furpa,0.1111111111111111,8,8,TCAAATCCAGGGAGGGAAGT,0,1304920
furpa,0.1111111111111111,8,8,TCAAAGAAGCGTGTAGTCAA,0,1319687
furpa,0.1111111111111111,8,8,TCAAAACCGCAGCGATTTGA,0,1289175
furpa,0.1111111111111111,8,8,TATTTGTTGGCCTTGAGCGT,0,1329104
furpa,0.1111111111111111,8,8,TATTTGGAGAGTAATATCAC,0,1276491
furpa,0.1111111111111111,8,8,TATTGTTTGTATAGCAGTAC,0,1291225
furpa,0.1111111111111111,8,8,TATTGTAAAGTCACGTGAAA,0,1273144
furpa,0.1111111111111111,8,8,TATTGGGCGTAGTTTGCTGT,0,1313815
furpa,0.1111111111111111,8,8,TATTCCAGTTACGAGATAAA,0,1271299
furpa,0.1111111111111111,8,8,TATGTGCGCTGCGGGGATAT,0,1284065
furpa,0.1111111111111111,8,8,TATGTCTCGAGATCAAATCT,0,1285018
furpa,0.1111111111111111,8,8,TATGGGCTTTCCTTCGCATT,0,1353404
furpa,0.1111111111111111,8,8,TATGGAGTGTTACTAGGGGA,0,1271176
furpa,0.1111111111111111,8,8,TATCAGTGACACATATAATT,0,1278466
furpa,0.1111111111111111,8,8,TATAGGGTCCAAAGCCGTAA,0,1294574
furpa,0.1111111111111111,8,8,TATAGCTCGAAGCTTGGAAA,0,1356813
furpa,0.1111111111111111,8,8,TAGTGCCCGTTTGAGGAAGA,0,1290953
furpa,0.1111111111111111,8,8,TAGGACTTAGGTGACTACCA,0,1302670
furpa,0.1111111111111111,8,8,TAGCGCAACAGTGCTATCAA,0,1301336
furpa,0.1111111111111111,8,8,TAGCAAGTGGTGCTCAGAGA,0,1343929
furpa,0.1111111111111111,8,8,TAGATACCGCGTTCAAAAGG,0,1341635
furpa,0.1111111111111111,8,8,TACTTGGGGGCGAGTGTAGT,0,1319554
furpa,0.1111111111111111,8,8,TACTAACACCGGGGTGATTG,0,1329973
furpa,0.1111111111111111,8,8,TACGTCACGTATCCCCTATC,0,1339919
furpa,0.1111111111111111,8,8,TACGGCCATCTGTGTTCTAT,0,1275976
furpa,0.1111111111111111,8,8,TACGCTACTAAGTACTCGAG,0,1272288
furpa,0.1111111111111111,8,8,TACGACGACTACGTAAATAT,0,1356264
furpa,0.1111111111111111,8,8,TACCTGTACGGCTAGTCAAG,0,1278562
furpa,0.1111111111111111,8,8,TACCTCGCTCGCAACTCGTG,0,1345754
furpa,0.1111111111111111,8,8,TACAGCGTAGACACACGTAG,0,1286320
furpa,0.1111111111111111,8,8,TACACTGCGTGGCCGAGGTT,0,1334123
furpa,0.1111111111111111,8,8,TACAATGGGCGGATAAATCG,0,1316631
furpa,0.1111111111111111,8,8,TAATCAGGGGACTTCGGCCG,0,1311783
furpa,0.1111111111111111,8,8,TAATCAGCGAGGTGGGAGCA,0,1313648
furpa,0.1111111111111111,8,8,TAAGGACCGCCTGCCTACGC,0,1305030
furpa,0.1111111111111111,8,8,TAACGACCGGAGCTATTCTG,0,1288588
furpa,0.1111111111111111,8,8,TAACCGTTTTGGTTGGATGA,0,1354787
furpa,0.1111111111111111,8,8,TAAATTCAGCATATCGGCTG,0,1303071
furpa,0.1111111111111111,8,8,TAAATGTGTAACTGCTCCGG,0,1314495
furpa,0.1111111111111111,8,8,TAAATGGAGCTGAGCTCCTC,0,1284559
furpa,0.1111111111111111,8,8,TAAACCTGCTCTCGCGCATC,0,1319697
furpa,0.1111111111111111,8,8,GTTTTGTTCATAACTTCTCG,0,1313482
furpa,0.1111111111111111,8,8,GTTTTGATGGGATAAATAAG,0,1351305
furpa,0.1111111111111111,8,8,GTTTCCTGTTTTCCCCTTCC,0,1355564
furpa,0.1111111111111111,8,8,GTTTACCAGACTTCTTTATC,0,1310305
furpa,0.1111111111111111,8,8,GTTGACGACCGGAGTAGGCG,0,1282751
furpa,0.1111111111111111,8,8,GTTGACCGCGCTTCGGTAAT,0,1336404
furpa,0.1111111111111111,8,8,GTTCTCAGTTTTAACGTCAC,0,1335503
furpa,0.1111111111111111,8,8,GTTCGTGCGTATTTATTGCA,0,1317647
furpa,0.1111111111111111,8,8,GTTATCTTAGTTCACGAATG,0,1329014
furpa,0.1111111111111111,8,8,GTTAGCGCCGCCTAGGTAAT,0,1349337
furpa,0.1111111111111111,8,8,GTTACCAATTAGACTGGCTC,0,1322466
furpa,0.1111111111111111,8,8,GTGTTTATAGCAGGACGGAT,0,1294234
furpa,0.1111111111111111,8,8,GTGTTCTTTCATCGCATTAT,0,1307015
furpa,0.1111111111111111,8,8,GTGTTCGGCAGGTCATTGGG,0,1325615
furpa,0.1111111111111111,8,8,GTGTTAAACTAGAGATCAGA,0,1307530
furpa,0.1111111111111111,8,8,GTGTGTAGGACCATTTTTTA,0,1346353
furpa,0.1111111111111111,8,8,GTGTCTAAAGAGAATGAATG,0,1332442
furpa,0.1111111111111111,8,8,GTGTAACAGCCGCACGCTTG,0,1278197
furpa,0.1111111111111111,8,8,GTGGTTTCTAGTGGGAAGAT,0,1329169
furpa,0.1111111111111111,8,8,GTGGTATTTGATTGTGGAGA,0,1356669
furpa,0.1111111111111111,8,8,GTGGGGTGCATGTGTGACCA,0,1307420
furpa,0.1111111111111111,8,8,GTGGCGATTAAGGTTTCACA,0,1320044
furpa,0.1111111111111111,8,8,GTGCGCGGTACCCCGGCCAA,0,1326491
furpa,0.1111111111111111,8,8,GTGACCCGAATTGAAAGGCC,0,1290631
furpa,0.1111111111111111,8,8,GTCTTGAGTGCCATAGGTTG,0,1271936
furpa,0.1111111111111111,8,8,GTCTGGCATAGCGAGAATAA,0,1303323
furpa,0.1111111111111111,8,8,GTCTCGGGAAAAGAAATGCT,0,1288968
furpa,0.1111111111111111,8,8,GTCTAGCAGAAGTGGTGATC,0,1334913
furpa,0.1111111111111111,8,8,GTCTACTTAGCCCCCAGCTG,0,1303172
furpa,0.1111111111111111,8,8,GTCGTTCAAGAACGACTTTT,0,1274133
furpa,0.1111111111111111,8,8,GTCGCGGGCGTCTGATCGAT,0,1274085
furpa,0.1111111111111111,8,8,GTCCGGTCTTAGCGAACAGG,0,1294556
furpa,0.1111111111111111,8,8,GTCCGGATCGCATTGACCGT,0,1305898
furpa,0.1111111111111111,8,8,GTCCCCATGTACAGTACCCT,0,1325016
furpa,0.1111111111111111,8,8,GTCCAACCAAATCCGAGATG,0,1287659
furpa,0.1111111111111111,8,8,GTCATTTTGCGACTTTTGTA,0,1275197
furpa,0.1111111111111111,8,8,GTCATCATTAAACGTAGGAT,0,1291630
furpa,0.1111111111111111,8,8,GTCAGTGTCATTGTGGGGCG,0,1348787
furpa,0.1111111111111111,8,8,GTCACTATAACTGGATTCCG,0,1356819
furpa,0.1111111111111111,8,8,GTCAATGAGTGTAGGCGGGA,0,1328501
furpa,0.1111111111111111,8,8,GTATGGGCAACAGGCACAAC,0,1329903
furpa,0.1111111111111111,8,8,GTATCTAGGCACCTATACGT,0,1329740
furpa,0.1111111111111111,8,8,GTATCGCTGGGATTACGCGC,0,1348511
furpa,0.1111111111111111,8,8,GTATAGTTCTTCCTCGGTCG,0,1355051
furpa,0.1111111111111111,8,8,GTAGGTGGGAATGGTAAGAG,0,1342525
furpa,0.1111111111111111,8,8,GTAGGTGAGAGAAAGGCGAG,0,1352025
furpa,0.1111111111111111,8,8,GTACTGTAACACGGGGCTCC,0,1295457
furpa,0.1111111111111111,8,8,GTAAAGTGACCTGATGCTTC,0,1273221
furpa,0.1111111111111111,8,8,GGTTTGACATTGGCGCTCGT,0,1328353
furpa,0.1111111111111111,8,8,GGTTGAAAAGCGGGAATTGG,0,1286431
furpa,0.1111111111111111,8,8,GGTTCACCGCAGACTAGCGG,0,1307823
furpa,0.1111111111111111,8,8,GGTGGAGGGGTAAGTCAGAA,0,1306640
furpa,0.1111111111111111,8,8,GGTGCTGACGGTTGCGGGCA,0,1309596
furpa,0.1111111111111111,8,8,GGTCTGGCTTGACATTAGAT,0,1340728
furpa,0.1111111111111111,8,8,GGTCTAAAGATAGCCTCCGT,0,1341132
furpa,0.1111111111111111,8,8,GGTCGTGACTCGGAATTCGG,0,1320391
furpa,0.1111111111111111,8,8,GGTCCTCGATAGATGGATGC,0,1285559
furpa,0.1111111111111111,8,8,GGTCCCCTGGGGAACTCGAT,0,1288806
furpa,0.1111111111111111,8,8,GGTCAGGAGACCATACAGTA,0,1302334
furpa,0.1111111111111111,8,8,GGTAGGCAATACGTGTGCTT,0,1312027
furpa,0.1111111111111111,8,8,GGTAAGGTGCGGGGTCCAAA,0,1289492
furpa,0.1111111111111111,8,8,GGGTTTAACTTACCTTTGGT,0,1350958
furpa,0.1111111111111111,8,8,GGGTGTCCCTATGAGGGTAG,0,1290626
furpa,0.1111111111111111,8,8,GGGTCCAAAGTATCCGGTGT,0,1313966
furpa,0.1111111111111111,8,8,GGGTAAGAATATAGTTTTCA,0,1286271
furpa,0.1111111111111111,8,8,GGGGCTTAATCTTGTACCTT,0,1279855
furpa,0.1111111111111111,8,8,GGGGCATGCACCTACTAAGA,0,1340431
furpa,0.1111111111111111,8,8,GGGGCACAGTGCTGGGGTTT,0,1303465
furpa,0.1111111111111111,8,8,GGGGATGTGGCTAAATAACG,0,1332675
furpa,0.1111111111111111,8,8,GGGGAACCGGGTTGGGGCCA,0,1330386
furpa,0.1111111111111111,8,8,GGGGAAATCGCGCAGGATAT,0,1346965
furpa,0.1111111111111111,8,8,GGGCACAGTTGTTGTAGGTG,0,1303732
furpa,0.1111111111111111,8,8,GGGAGGTGTTGAAGCCGTTA,0,1338754
furpa,0.1111111111111111,8,8,GGGACTGTAATAAGCAAAAC,0,1325460
furpa,0.1111111111111111,8,8,GGCTTATCGTTCAACATGCC,0,1290793
furpa,0.1111111111111111,8,8,GGCTCCTCAAGTGGGTTCAT,0,1333604
furpa,0.1111111111111111,8,8,GGCGCATATAGGGCGTAAAT,0,1340114
furpa,0.1111111111111111,8,8,GGCCTCTACGAGACGCTTAT,0,1297890
furpa,0.1111111111111111,8,8,GGCCTCGGCACAAGACCCTT,0,1334841
furpa,0.1111111111111111,8,8,GGCCGGTTGTGGCCGAGGAA,0,1300595
furpa,0.1111111111111111,8,8,GGCCGCGGAGCCTCCAATAG,0,1282819
furpa,0.1111111111111111,8,8,GGCCCTGGCGGGACCAGGTC,0,1282507
furpa,0.1111111111111111,8,8,GGCCAGAATTGACGGTGATA,0,1271495
furpa,0.1111111111111111,8,8,GGCATCGCATCCCCTCGGAA,0,1272607
furpa,0.1111111111111111,8,8,GGCAGTGTAGACTCGGATAT,0,1290920
furpa,0.1111111111111111,8,8,GGCACGACTTATGGGCTTTT,0,1320818
furpa,0.1111111111111111,8,8,GGCAAGTACCCTAGTTCTGA,0,1339103
furpa,0.1111111111111111,8,8,GGCAAGCGTTGGAAGGCGGT,0,1343143
furpa,0.1111111111111111,8,8,GGCAACAGCTAGCGGGGCCA,0,1348057
furpa,0.1111111111111111,8,8,GGATTCGCAAGCGATATGAG,0,1354051
furpa,0.1111111111111111,8,8,GGATGCAAGAGTACTACCGG,0,1353494
furpa,0.1111111111111111,8,8,GGAGTTATATTCTCTAGCGG,0,1287866
furpa,0.1111111111111111,8,8,GGAGTGTATGGGTTGAGCCC,0,1348040
furpa,0.1111111111111111,8,8,GGAGGTCGGAGAAGCCTTCT,0,1280824
furpa,0.1111111111111111,8,8,GGAGGGTGCGAAATACTGAA,0,1298933
furpa,0.1111111111111111,8,8,GGAGGCAATGTCAAATGGAC,0,1310293
furpa,0.1111111111111111,8,8,GGAGCTCCTCCAGGTTAGCC,0,1335423
furpa,0.1111111111111111,8,8,GGACCTCTCGATTTGTTAGG,0,1304451
furpa,0.1111111111111111,8,8,GGACCTAAGAATGTATGTTC,0,1333589
furpa,0.1111111111111111,8,8,GGACCGCGGGCATCCTCACC,0,1351658
furpa,0.1111111111111111,8,8,GGACATGTTATCGATACGAT,0,1349253
furpa,0.1111111111111111,8,8,GGACACGGGCAGAACGTTCC,0,1351152
furpa,0.1111111111111111,8,8,GGAATATCAATCTATGGGCA,0,1300275
furpa,0.1111111111111111,8,8,GGAAGTCTCTTGGCTTCTTC,0,1293263
furpa,0.1111111111111111,8,8,GGAAGAGATTGTGCAAATGG,0,1344212
furpa,0.1111111111111111,8,8,GGAACCCATCTGGCATAAAA,0,1329346
furpa,0.1111111111111111,8,8,GCTTCTTGGTCTAGTCAAAA,0,1305807
furpa,0.1111111111111111,8,8,GCTTACGGGCATTCACGGAC,0,1291619
furpa,0.1111111111111111,8,8,GCTGTCAGAGTCATCTAATA,0,1275503
furpa,0.1111111111111111,8,8,GCTGAGAGAGCGTAGAGTAG,0,1297811
furpa,0.1111111111111111,8,8,GCTCTGAACGAGGGGTTGAA,0,1315161
furpa,0.1111111111111111,8,8,GCTCTCTCGACGTGTCGGCA,0,1314276
furpa,0.1111111111111111,8,8,GCTCTAACACCAGACCCACC,0,1321048
furpa,0.1111111111111111,8,8,GCTCGCCGCTAGAATGCTAG,0,1310251
furpa,0.1111111111111111,8,8,GCTCGACTGTGGTTATATTT,0,1316185
furpa,0.1111111111111111,8,8,GCTCACCCGTATGGTATTTC,0,1328758
furpa,0.1111111111111111,8,8,GCTATAGGTAACTCCCTTAT,0,1328081
furpa,0.1111111111111111,8,8,GCTAGTCACGGCGGCCCCCC,0,1288894
furpa,0.1111111111111111,8,8,GCTAAGAAGTACCGCAGGAC,0,1316814
furpa,0.1111111111111111,8,8,GCGTTGAGCACATCTAGCCT,0,1342453
furpa,0.1111111111111111,8,8,GCGTCTGAGCATGCTGATCT,0,1332304
furpa,0.1111111111111111,8,8,GCGTCAATGCCCTTATCTGC,0,1335751
furpa,0.1111111111111111,8,8,GCGTAAGAGGCCGAGGAGAT,0,1286702
furpa,0.1111111111111111,8,8,GCGGTTTAATATGTCAGGCA,0,1284712
furpa,0.1111111111111111,8,8,GCGGTATGCGTATAAGACAT,0,1314673
furpa,0.1111111111111111,8,8,GCGGGGGCTATCAGTAGGTC,0,1296744
furpa,0.1111111111111111,8,8,GCGCTGTAGCTTTAGCGTAA,0,1333370
furpa,0.1111111111111111,8,8,GCGCGCGTGACCCGCTGTAT,0,1349885
furpa,0.1111111111111111,8,8,GCGCGATGGCTACTACGTTG,0,1333715
furpa,0.1111111111111111,8,8,GCGCAAGAGACGAGAACATG,0,1312731
furpa,0.1111111111111111,8,8,GCCTCCGTTCACAACGTGGG,0,1337086
furpa,0.1111111111111111,8,8,GCCTACATCGGATCGCTGAA,0,1346661
furpa,0.1111111111111111,8,8,GCCGTTATACGTGGAAGTAG,0,1319915
furpa,0.1111111111111111,8,8,GCCCTTTAGACAAGACAGCA,0,1307750
furpa,0.1111111111111111,8,8,GCCCGTCCACGTAGCTACCT,0,1348916
furpa,0.1111111111111111,8,8,GCCCGGACAGTTGTCTGCGG,0,1304255
furpa,0.1111111111111111,8,8,GCCCGCGTTCATGGCTCAAT,0,1293997
furpa,0.1111111111111111,8,8,GCCCGCAACTTCAAGTGTTC,0,1298667
furpa,0.1111111111111111,8,8,GCCCCATACGTGTTCAGTCA,0,1352390
furpa,0.1111111111111111,8,8,GCCCAGGCTATGGCAAGCGT,0,1322836
furpa,0.1111111111111111,8,8,GCCATGGGTAAGGTACCCGC,0,1323882
furpa,0.1111111111111111,8,8,GCATTTAGGCGGGCTCCGTT,0,1294002
furpa,0.1111111111111111,8,8,GCATTGGAAGGCTGGTCACA,0,1329734
furpa,0.1111111111111111,8,8,GCATGCGAGCATAGCTAAAG,0,1288860
furpa,0.1111111111111111,8,8,GCATGCCGTTTGCATGGAGT,0,1318621
furpa,0.1111111111111111,8,8,GCATCCTCTGGGTCTATCAT,0,1284040
furpa,0.1111111111111111,8,8,GCAGAACTTCCACGAGTGGC,0,1298286
furpa,0.1111111111111111,8,8,GCAGAAATACCATGATGTCT,0,1317243
furpa,0.1111111111111111,8,8,GCACTTACTAACACGTGTGA,0,1277667
furpa,0.1111111111111111,8,8,GCACTCGAGGTCTGGGCTGA,0,1304305
furpa,0.1111111111111111,8,8,GCACGGCATCCAGCCGGATA,0,1353061
furpa,0.1111111111111111,8,8,GCACCTTTCACATAGGACCA,0,1319206
furpa,0.1111111111111111,8,8,GCAAGCTGTGCTTGGTTTGA,0,1292679
furpa,0.1111111111111111,8,8,GATTGTATGGGAGTGCGATT,0,1294519
furpa,0.1111111111111111,8,8,GATCGGGTCCCCCGCACGGG,0,1350811
furpa,0.1111111111111111,8,8,GATCGAGCAGGTCATAAGAG,0,1353257
furpa,0.1111111111111111,8,8,GATCCGTTTCCGTGAGCAGA,0,1333225
furpa,0.1111111111111111,8,8,GATCATGCAACGCATTGTTG,0,1306076
furpa,0.1111111111111111,8,8,GATAGCGACTAGAATTTGGA,0,1340205
furpa,0.1111111111111111,8,8,GATAGCCCGACTTGGGCGCA,0,1355428
furpa,0.1111111111111111,8,8,GAGTCGTCGATGACTCCGAC,0,1333775
furpa,0.1111111111111111,8,8,GAGGTTCCTAAATTCGCTGG,0,1329021
furpa,0.1111111111111111,8,8,GAGGGACTAACCAACAACGT,0,1275812
furpa,0.1111111111111111,8,8,GAGGGACAGCGGTATTGGTA,0,1324017
furpa,0.1111111111111111,8,8,GAGGACGCCTCTTTCTGCTT,0,1357308
furpa,0.1111111111111111,8,8,GAGCTATGGTTTAAAGTGTA,0,1275354
furpa,0.1111111111111111,8,8,GAGCGTAAATTCAGTGCGTC,0,1348216
furpa,0.1111111111111111,8,8,GAGCAGTGGCGTCGTCGCCA,0,1350736
furpa,0.1111111111111111,8,8,GAGACATCGCGCTGTCCAGG,0,1308775
furpa,0.1111111111111111,8,8,GACGTCTCGGCGCTGATACT,0,1326346
furpa,0.1111111111111111,8,8,GACGCGGCACTCCACTATGC,0,1339434
furpa,0.1111111111111111,8,8,GAATGCATGTCGATAAAGAT,0,1347734
furpa,0.1111111111111111,8,8,GAAGGGTTCTCATAGCTGTT,0,1321685
furpa,0.1111111111111111,8,8,GAAACCTATGTGAAATGGTC,0,1273287
furpa,0.1111111111111111,8,8,GAAAATCCCACATGCGAGTG,0,1340324
furpa,0.1111111111111111,8,8,GAAAACCTTTTGAAATCGAA,0,1297098
furpa,0.1111111111111111,8,8,CTTTCACACTGCAAACATAG,0,1337431
furpa,0.1111111111111111,8,8,CTTGGGCAGTTCGTGAGCCA,0,1283164
furpa,0.1111111111111111,8,8,CTTGGCCGATCCCGGAATAA,0,1291015
furpa,0.1111111111111111,8,8,CTTGATGAGCGGACGAACAA,0,1276329
furpa,0.1111111111111111,8,8,CTTCTCTCGCCTTTTAACAA,0,1322160
furpa,0.1111111111111111,8,8,CTTCCTTGATTAATTAAGGA,0,1324930
furpa,0.1111111111111111,8,8,CTTATTAAACCATTTGCCTA,0,1289319
furpa,0.1111111111111111,8,8,CTTATCCCATGTTGTCAAGG,0,1353250
furpa,0.1111111111111111,8,8,CTTAACATTTTGGAGAATTT,0,1327744
furpa,0.1111111111111111,8,8,CTGTCTCGCATTGGGGGTGT,0,1313645
furpa,0.1111111111111111,8,8,CTGTAGCCCGATCAGACGAC,0,1356734
furpa,0.1111111111111111,8,8,CTGGTTGTTCCAAGGGCGAT,0,1281428
furpa,0.1111111111111111,8,8,CTGGCAGTAGTTCCATTACA,0,1352239
furpa,0.1111111111111111,8,8,CTGCTCGAAATCGGAACAGG,0,1315917
furpa,0.1111111111111111,8,8,CTGCCATATGCGGGATAGGA,0,1292947
furpa,0.1111111111111111,8,8,CTGAACCTCTTAGTCCTTTG,0,1356676
furpa,0.1111111111111111,8,8,CTGAACCCAAAGGGCATCAG,0,1332406
furpa,0.1111111111111111,8,8,CTCTTGGTGGCTTGGATTTA,0,1350482
furpa,0.1111111111111111,8,8,CTCTGAGTGTGTACTCCGAA,0,1344304
furpa,0.1111111111111111,8,8,CTCTATGTTGACCTCAACAT,0,1352379
furpa,0.1111111111111111,8,8,CTCTATGGTCAGGTAAACGG,0,1355688
furpa,0.1111111111111111,8,8,CTCGGTTCGTAACTCGACAT,0,1340434
furpa,0.1111111111111111,8,8,CTCGGACTCGTGGTGATACG,0,1354066
furpa,0.1111111111111111,8,8,CTCGAAATGAGGGGTCCCGG,0,1330646
furpa,0.1111111111111111,8,8,CTCCTTTTCTATTTTTTGTA,0,1347249
furpa,0.1111111111111111,8,8,CTCCGCGACAACGGGTCACC,0,1323894
furpa,0.1111111111111111,8,8,CTCAAGGGAGGTAGGAACCA,0,1341507
furpa,0.1111111111111111,8,8,CTAGTCGCCGGTTTTAAAAA,0,1278794
furpa,0.1111111111111111,8,8,CTAGTAGGGACCCAGATCCA,0,1346248
furpa,0.1111111111111111,8,8,CTAGAGATATCTCGGTGTAG,0,1355491
furpa,0.1111111111111111,8,8,CTAGAATTCAGACGCCACAC,0,1281622
furpa,0.1111111111111111,8,8,CTACGTCGTAAGTTAGTTGA,0,1301235
furpa,0.1111111111111111,8,8,CTACGGTCCCGGCAAGGAGC,0,1335572
furpa,0.1111111111111111,8,8,CTAAGTTTCCACGCTAGGGA,0,1309963
furpa,0.1111111111111111,8,8,CTAAATAAGGCCAATGGATC,0,1284479
furpa,0.1111111111111111,8,8,CGTTTGGCGCTGTTAGGTCG,0,1356887
furpa,0.1111111111111111,8,8,CGTTCCATTTAGGGTCTGTA,0,1334088
furpa,0.1111111111111111,8,8,CGTTCATAGAAGGGCGTCCG,0,1340560
furpa,0.1111111111111111,8,8,CGTTCAGTACCATTGTGAGG,0,1310053
furpa,0.1111111111111111,8,8,CGTGTCGCAATCATGGTGGT,0,1310318
furpa,0.1111111111111111,8,8,CGTGTAACGGTCCAATCAAC,0,1340778
furpa,0.1111111111111111,8,8,CGTGGCATTGGAAGATGTAT,0,1341592
furpa,0.1111111111111111,8,8,CGTGCGTAGACTCGTCCCTA,0,1307980
furpa,0.1111111111111111,8,8,CGTCTATTCCGAAATGATCC,0,1302023
furpa,0.1111111111111111,8,8,CGTCGCAACTGCCGCCGTCT,0,1327166
furpa,0.1111111111111111,8,8,CGTCAGTCTGGGCGTTAGTC,0,1275786
furpa,0.1111111111111111,8,8,CGTATACTCTAAGCAGCAGC,0,1285815
furpa,0.1111111111111111,8,8,CGTAGGTCCTTCAACGTCGG,0,1309708
furpa,0.1111111111111111,8,8,CGTAATCTGATGCAAGCACC,0,1288007
furpa,0.1111111111111111,8,8,CGTAACGGGATAGGTTGTAG,0,1304991
furpa,0.1111111111111111,8,8,CGGTTGTGCGACCCGAGGGA,0,1352677
furpa,0.1111111111111111,8,8,CGGTGTGGGGGAGTAGACAG,0,1311894
furpa,0.1111111111111111,8,8,CGGGTTGTTAAGTGAAAATT,0,1300036
furpa,0.1111111111111111,8,8,CGGGGAGTTGATCCAGGTAG,0,1300550
furpa,0.1111111111111111,8,8,CGGGGACACCAGCCTTCACC,0,1342192
furpa,0.1111111111111111,8,8,CGGCATGGAAGGCTACGCCA,0,1330706
furpa,0.1111111111111111,8,8,CGGAGTACGATTGCTATCAG,0,1318629
furpa,0.1111111111111111,8,8,CGGAGATGTTATTCACCATA,0,1316602
furpa,0.1111111111111111,8,8,CGGACGTCCGAACATGGCGG,0,1310452
furpa,0.1111111111111111,8,8,CGGAAAACAGATTGACAAGT,0,1272740
furpa,0.1111111111111111,8,8,CGCTTCCCGCTGGCGTCACA,0,1325113
furpa,0.1111111111111111,8,8,CGCTTATCATTCCGACCGAA,0,1352166
furpa,0.1111111111111111,8,8,CGCTCAGCTCCTACCAGCTA,0,1341794
furpa,0.1111111111111111,8,8,CGCTCACTTGAACCAGTTTG,0,1313670
furpa,0.1111111111111111,8,8,CGCTAGAGGTAGACGTGTGG,0,1298893
furpa,0.1111111111111111,8,8,CGCGTCCAAGGGGGGGAAAA,0,1306195
furpa,0.1111111111111111,8,8,CGCGGTTGAGGTTGGCCTTA,0,1352507
furpa,0.1111111111111111,8,8,CGCGGATTTTGTCTAGTGTG,0,1284018
furpa,0.1111111111111111,8,8,CGCCTTACGTATGGGGGATT,0,1271497
furpa,0.1111111111111111,8,8,CGCCGCTACACTTGCAGCGA,0,1311286
furpa,0.1111111111111111,8,8,CGCCCGCAGAGAAGAGCACA,0,1279018
furpa,0.1111111111111111,8,8,CGCCAGGTTCTGGTCAAGGA,0,1316585
furpa,0.1111111111111111,8,8,CGCATCACCGTCCGCCTCTA,0,1346952
furpa,0.1111111111111111,8,8,CGCAGCTATTAAGTTCATAG,0,1326948
furpa,0.1111111111111111,8,8,CGCACTTCGGCATTCACTGA,0,1299987
furpa,0.1111111111111111,8,8,CGCACATCCCTGCTTTGAAT,0,1337314
furpa,0.1111111111111111,8,8,CGCAATTCCAGCTTCGGCAA,0,1274935
furpa,0.1111111111111111,8,8,CGCAAGCATCGCATTCGCTT,0,1308328
furpa,0.1111111111111111,8,8,CGATTTGTCATAATCCGGAG,0,1347411
furpa,0.1111111111111111,8,8,CGATTTGGCCCGGGTAGTAA,0,1344102
furpa,0.1111111111111111,8,8,CGATTACTTAGAGGGAGGAT,0,1348794
furpa,0.1111111111111111,8,8,CGAGTTGGATCGATACCGGC,0,1329015
furpa,0.1111111111111111,8,8,CGAGTGCAAAGAAGCACTGA,0,1315199
furpa,0.1111111111111111,8,8,CGAGGTTAAACGCAATTCAT,0,1316135
furpa,0.1111111111111111,8,8,CGAGGAGTAAGAGCGTTTTT,0,1350233
furpa,0.1111111111111111,8,8,CGAGCACAACCGGCGACCTT,0,1352795
furpa,0.1111111111111111,8,8,CGACTTCTCAGGACCGCCAC,0,1297774
furpa,0.1111111111111111,8,8,CGACCCCCCCCGGAGTGTCT,0,1319218
furpa,0.1111111111111111,8,8,CGACCATCATAGTTCTTAGT,0,1357133
furpa,0.1111111111111111,8,8,CGACCAACGAGAAAATCGTG,0,1353262
furpa,0.1111111111111111,8,8,CGACACGAATTAAGGGTATG,0,1317743
furpa,0.1111111111111111,8,8,CGACAATTCACATAGAATCG,0,1340710
furpa,0.1111111111111111,8,8,CGAATTAGAAGCTGCATGTG,0,1279581
furpa,0.1111111111111111,8,8,CGAAGGGGCGAACAATTCGA,0,1352548
furpa,0.1111111111111111,8,8,CGAAGGAAGTCTCTTGATAC,0,1280769
furpa,0.1111111111111111,8,8,CCTTTGGTATAGGGAGCCAA,0,1316169
furpa,0.1111111111111111,8,8,CCTTAGGGAGATAGACGTCT,0,1351263
furpa,0.1111111111111111,8,8,CCTTAGCGTCTTGCCGGGCT,0,1282884
furpa,0.1111111111111111,8,8,CCTGGAGTACTGGCCTTGCG,0,1337992
furpa,0.1111111111111111,8,8,CCTGCTACCCAACGGGCGAA,0,1296628
furpa,0.1111111111111111,8,8,CCTGCAAGGGTCATCTGTAA,0,1333408
furpa,0.1111111111111111,8,8,CCTGACGAAGTCATAGGCTC,0,1292284
furpa,0.1111111111111111,8,8,CCTCGTCACAGTGTGCTTGT,0,1290891
furpa,0.1111111111111111,8,8,CCTATACTAATGATGGTATC,0,1344743
furpa,0.1111111111111111,8,8,CCTAGGGCCAGCTAGGCATA,0,1300607
furpa,0.1111111111111111,8,8,CCTAAGGGGTCAAATAGCCA,0,1306488
furpa,0.1111111111111111,8,8,CCGGTTGTATCTCGCCAATA,0,1276075
furpa,0.1111111111111111,8,8,CCGGTGAGCGATCAGGCTTT,0,1273328
furpa,0.1111111111111111,8,8,CCGCGGTTCATCAATTCTTT,0,1342905
furpa,0.1111111111111111,8,8,CCGCGGATCTGAGATGGGCT,0,1284078
furpa,0.1111111111111111,8,8,CCGCATGCCACCCCGGCCAG,0,1328875
furpa,0.1111111111111111,8,8,CCCTTCGGTCGAACAATCTC,0,1343342
furpa,0.1111111111111111,8,8,CCCGGTGAAACTCCCCAGGA,0,1295851
furpa,0.1111111111111111,8,8,CCCGGCGGGCAACGTGCACT,0,1338344
furpa,0.1111111111111111,8,8,CCCGAGCTATTTCCTGACGC,0,1299153
furpa,0.1111111111111111,8,8,CCCCAGTTCTCCTGAATCTT,0,1352185
furpa,0.1111111111111111,8,8,CCCAACGGAGAGACGGATCG,0,1345827
furpa,0.1111111111111111,8,8,CCATTATGCCCGTCGCTCTT,0,1333205
furpa,0.1111111111111111,8,8,CCATCACAGTCCAAGAACAA,0,1349290
furpa,0.1111111111111111,8,8,CCAGCACAGGCATACGGATC,0,1278983
furpa,0.1111111111111111,8,8,CCACTGGGCAGATACATGTT,0,1277859
furpa,0.1111111111111111,8,8,CCACGTTAGGCCTAAATGAA,0,1347288
furpa,0.1111111111111111,8,8,CCACCGAGTCAGACACGCGA,0,1293441
furpa,0.1111111111111111,8,8,CCACATTTAACCGGCCCGAT,0,1321943
furpa,0.1111111111111111,8,8,CCACAATGGCCATCCCTAAA,0,1296808
furpa,0.1111111111111111,8,8,CATTTGAGTAAGGAGTCGCT,0,1287901
furpa,0.1111111111111111,8,8,CATGCTTTGAATTACTATAC,0,1280973
furpa,0.1111111111111111,8,8,CATGACGAGGCAGCCCCGCT,0,1347912
furpa,0.1111111111111111,8,8,CATCTACCAGTCCCCTGTCC,0,1316054
furpa,0.1111111111111111,8,8,CATCGCTAGGTGGGACACGC,0,1354293
furpa,0.1111111111111111,8,8,CATATGTCTGGCCAGAACGC,0,1343189
furpa,0.1111111111111111,8,8,CATACTCCATTATCAGGGGG,0,1295139
furpa,0.1111111111111111,8,8,CATAATCGGGGGTCCCCTCT,0,1294476
furpa,0.1111111111111111,8,8,CAGTCCAATTATGCGCACCG,0,1303424
furpa,0.1111111111111111,8,8,CAGGCGCCCCCCGCGGGCGG,0,1352183
furpa,0.1111111111111111,8,8,CAGGATGCTAGAGCCCTCCG,0,1298444
furpa,0.1111111111111111,8,8,CAGGACATATCCTCCGCGAC,0,1346699
furpa,0.1111111111111111,8,8,CAGCTGTGCAGCCAATATAT,0,1351945
furpa,0.1111111111111111,8,8,CAGCCTCTTGGCTACACGTC,0,1346976
furpa,0.1111111111111111,8,8,CAGATGTCGGTGTTTAAGAA,0,1314057
furpa,0.1111111111111111,8,8,CAGATACACGTTAAGTCTGT,0,1331275
furpa,0.1111111111111111,8,8,CAGAGGCGCGCAAATTTACC,0,1339066
furpa,0.1111111111111111,8,8,CAGAGGATATAAGTCATATG,0,1343278
furpa,0.1111111111111111,8,8,CAGAGACCCACCGCGCTTTT,0,1276111
furpa,0.1111111111111111,8,8,CACTTTTAACATCACAACAT,0,1292550
furpa,0.1111111111111111,8,8,CACGTGGTTATCCTCGCTGC,0,1357628
furpa,0.1111111111111111,8,8,CACGTGCTGCAACGCGATTA,0,1271833
furpa,0.1111111111111111,8,8,CACGGACCGCTCTAAGATAT,0,1335840
furpa,0.1111111111111111,8,8,CACCTACTCTAGCAAGTCAT,0,1275595
furpa,0.1111111111111111,8,8,CACCAGTGAAAATGATGGAA,0,1340915
furpa,0.1111111111111111,8,8,CACATGGTTACCCACTGGTG,0,1274792
furpa,0.1111111111111111,8,8,CACAGTCACTGGGCAAATTA,0,1342155
furpa,0.1111111111111111,8,8,CACAATCCCCCGAGAACGTG,0,1354692
furpa,0.1111111111111111,8,8,CAATTTTCAACAATTGGACT,0,1336615
furpa,0.1111111111111111,8,8,CAATATTCACATTTGCGTAC,0,1297779
furpa,0.1111111111111111,8,8,CAAGTTTTTAGTCATAACTT,0,1305847
furpa,0.1111111111111111,8,8,CAAGTCTCCGCCTTGGGCAT,0,1296940
furpa,0.1111111111111111,8,8,CAAGCTTGTTCATTTACGGA,0,1293710
furpa,0.1111111111111111,8,8,CAAGCCATCGCTTCGATTTC,0,1320411
furpa,0.1111111111111111,8,8,CAACTTCATTGGAATTGCCA,0,1312494
furpa,0.1111111111111111,8,8,CAACTCCCGGTGATCTAGAC,0,1332091
furpa,0.1111111111111111,8,8,CAACTATCCCCCCCGATCTA,0,1278351
furpa,0.1111111111111111,8,8,CAACGACTTATTCAAATAGT,0,1275079
furpa,0.1111111111111111,8,8,CAACATGGGCATAGGAATTC,0,1278503
furpa,0.1111111111111111,8,8,CAAATGGCCTCAACTCAGAA,0,1278924
furpa,0.1111111111111111,8,8,CAAATGAGTATGAGTCGCAA,0,1342810
furpa,0.1111111111111111,8,8,CAAAGGTGGACTAGGCAGAC,0,1335659
furpa,0.1111111111111111,8,8,CAAACTTTTGCGCCCTGATT,0,1314392
furpa,0.1111111111111111,8,8,ATTTTTAGTTTGTGCTCAGA,0,1323537
furpa,0.1111111111111111,8,8,ATTTGGCAGTCGTATTTCTT,0,1303199
furpa,0.1111111111111111,8,8,ATTTCCGTTGGTTGCAGTGG,0,1321171
furpa,0.1111111111111111,8,8,ATTTCCACAACAATATCTTA,0,1327974
furpa,0.1111111111111111,8,8,ATTTACCTATTCGCGCCCCA,0,1331917
furpa,0.1111111111111111,8,8,ATTGGGTTTGTATCCATACG,0,1292826
furpa,0.1111111111111111,8,8,ATTGGCTAATGCGTACCATA,0,1357261
furpa,0.1111111111111111,8,8,ATTCTTCGAAGGTGAGAGTC,0,1351199
furpa,0.1111111111111111,8,8,ATGTTTTCATTTGCCACGCC,0,1336201
furpa,0.1111111111111111,8,8,ATGTGGCGGACCATCGCATG,0,1311931
furpa,0.1111111111111111,8,8,ATGTGGAGGGGAGCATGTCA,0,1329440
furpa,0.1111111111111111,8,8,ATGTCTAGTTGTGAACCAGA,0,1305481
furpa,0.1111111111111111,8,8,ATGGATTGAACTAATCTACA,0,1341405
furpa,0.1111111111111111,8,8,ATGGATCTATTCTAGGCCCG,0,1336826
furpa,0.1111111111111111,8,8,ATGGACGGTTTATGTAGCAA,0,1290710
furpa,0.1111111111111111,8,8,ATGGAAACCTCTTTCATAAC,0,1328664
furpa,0.1111111111111111,8,8,ATGCGGTCATGCTGGGCTTT,0,1346596
furpa,0.1111111111111111,8,8,ATGCCATGTCCTATCTATAT,0,1336461
furpa,0.1111111111111111,8,8,ATGCCAGTTCGAATACAACA,0,1292127
furpa,0.1111111111111111,8,8,ATGACTGCCGCCTTTTAGAC,0,1317424
furpa,0.1111111111111111,8,8,ATGACGTATAGCTTTATCCA,0,1276933
furpa,0.1111111111111111,8,8,ATCGTTGCCGTATGGGGGAG,0,1277547
furpa,0.1111111111111111,8,8,ATCGTAGAGTTGATGCCCCG,0,1314462
furpa,0.1111111111111111,8,8,ATCGCGAACGAAGATGGCCT,0,1313935
furpa,0.1111111111111111,8,8,ATCGCCCTTCGAATCATCAT,0,1333950
furpa,0.1111111111111111,8,8,ATCGCAACGGGTCATAAAAT,0,1350537
furpa,0.1111111111111111,8,8,ATCGACCGCCTCTCGCGCGT,0,1352762
furpa,0.1111111111111111,8,8,ATCCTCACCCCTAAGGACGC,0,1295203
furpa,0.1111111111111111,8,8,ATCCTAGACCCACAGTTTAT,0,1328608
furpa,0.1111111111111111,8,8,ATCCCCGAGCCTCCTGCTAA,0,1336120
furpa,0.1111111111111111,8,8,ATCATCGGCAGGGTTAATAA,0,1348092
furpa,0.1111111111111111,8,8,ATCATCAGCACTAGCTTATA,0,1296932
furpa,0.1111111111111111,8,8,ATCAGTTTGCTGTCACTGCT,0,1298075
furpa,0.1111111111111111,8,8,ATCACACCAAGGAGTCCGGG,0,1285486
furpa,0.1111111111111111,8,8,ATATGTGAACCGTGTTTGGA,0,1276641
furpa,0.1111111111111111,8,8,ATAGTCGTTCATTGCTTCAT,0,1316115
furpa,0.1111111111111111,8,8,ATAGGGCAGTTAACAAGATT,0,1312158
furpa,0.1111111111111111,8,8,ATACGCTTCTATTCCGAATA,0,1299633
furpa,0.1111111111111111,8,8,ATACGCTTCGTAATTATGCT,0,1295295
furpa,0.1111111111111111,8,8,ATACGAGCTCAAATATTTCG,0,1317231
furpa,0.1111111111111111,8,8,ATACCCATCACGTACGGTGA,0,1284959
furpa,0.1111111111111111,8,8,ATACAGCCAAAGACGGGCAG,0,1356206
furpa,0.1111111111111111,8,8,ATACAATACTCTCGCGTGAT,0,1341940
furpa,0.1111111111111111,8,8,ATAATTGTTTCCCTTTCGTA,0,1338158
furpa,0.1111111111111111,8,8,ATAATGTTGCAAGTTCTACA,0,1305022
furpa,0.1111111111111111,8,8,ATAAAATTCGGTCACAACCA,0,1307711
furpa,0.1111111111111111,8,8,AGTTCCGATATACCCGAACC,0,1289163
furpa,0.1111111111111111,8,8,AGTTAGCCATGGCGCTCTGA,0,1336503
furpa,0.1111111111111111,8,8,AGTGTGGTCGCCAGAACCTC,0,1357112
furpa,0.1111111111111111,8,8,AGTGGGTCACTGAAAATACC,0,1311526
furpa,0.1111111111111111,8,8,AGTGGGCGCCACGGCCGAGT,0,1294154
furpa,0.1111111111111111,8,8,AGTCGGCCCACATATGAATA,0,1276545
furpa,0.1111111111111111,8,8,AGTCGCAGTCTTGTCAATTA,0,1306414
furpa,0.1111111111111111,8,8,AGTCCTTGTAGGTGCTTGGA,0,1294968
furpa,0.1111111111111111,8,8,AGTCCCTGAGGGTGGTCTAG,0,1323887
furpa,0.1111111111111111,8,8,AGTCATCATAGATGGGGCAT,0,1282704
furpa,0.1111111111111111,8,8,AGTATGTGCTTTTTACTATG,0,1280826
furpa,0.1111111111111111,8,8,AGTAGGTTGCGCGGTACTTG,0,1331763
furpa,0.1111111111111111,8,8,AGTAGACACGTACTCTGCAT,0,1328670
furpa,0.1111111111111111,8,8,AGGTCATGTTCTCAACGATA,0,1320763
furpa,0.1111111111111111,8,8,AGGGTTCGATTAACAATCGT,0,1299953
furpa,0.1111111111111111,8,8,AGGGCTGTAATCCTCGTTCG,0,1346108
furpa,0.1111111111111111,8,8,AGGGCCAGGATAGCGGCCGA,0,1310804
furpa,0.1111111111111111,8,8,AGGGCAGGGGCGCCCTACCA,0,1320065
furpa,0.1111111111111111,8,8,AGGCCTCACCTAAGGCGGGA,0,1292370
furpa,0.1111111111111111,8,8,AGGCCGGTTGCCTTAACATT,0,1332626
furpa,0.1111111111111111,8,8,AGGCCCCGACAGGAAAAATT,0,1298992
furpa,0.1111111111111111,8,8,AGGCCAGCTCGGCGCATTTT,0,1271985
furpa,0.1111111111111111,8,8,AGGACTTATTTAAATCCCAG,0,1323660
furpa,0.1111111111111111,8,8,AGCGAATGGATAACTCCGTT,0,1352375
furpa,0.1111111111111111,8,8,AGCCGCTCTCTAGCGGGAGT,0,1276209
furpa,0.1111111111111111,8,8,AGCCGCCAACAGGCTGATGC,0,1285997
furpa,0.1111111111111111,8,8,AGCCCATAACGAGAGGATGA,0,1319720
furpa,0.1111111111111111,8,8,AGCCAGTGGGTACATTACTT,0,1285827
furpa,0.1111111111111111,8,8,AGCCACGGTAATCCGGGCTG,0,1312623
furpa,0.1111111111111111,8,8,AGCCAAGGGGGTCAGTAGCT,0,1303262
furpa,0.1111111111111111,8,8,AGCAAGCCCACGATAAGTGT,0,1326522
furpa,0.1111111111111111,8,8,AGATTTGTGAGGACCAGGAA,0,1280598
furpa,0.1111111111111111,8,8,AGATGGCCTCGAGCGTACGG,0,1354021
furpa,0.1111111111111111,8,8,AGATCTGTCTTTACGTCTCA,0,1335512
furpa,0.1111111111111111,8,8,AGATCCGACCCTAGCGACCA,0,1339195
furpa,0.1111111111111111,8,8,AGAGCTGCTGCTTGTCTATA,0,1350549
furpa,0.1111111111111111,8,8,AGACCGCCCTGGAGTACTTT,0,1350424
furpa,0.1111111111111111,8,8,AGAAGGGCACTTAACAACGT,0,1311118
furpa,0.1111111111111111,8,8,AGAACATTTCTGTCAGTAAT,0,1324361
furpa,0.1111111111111111,8,8,ACTTTCTGGGTTTGCAGTGA,0,1333902
furpa,0.1111111111111111,8,8,ACTTTACCCCTTAGCTGGAG,0,1341421
furpa,0.1111111111111111,8,8,ACTTATCCGCATTCGGGGAT,0,1286689
furpa,0.1111111111111111,8,8,ACTGGCTGCGGTGGCTATTA,0,1329685
furpa,0.1111111111111111,8,8,ACTGAAGCTTGTAGTTAGGA,0,1271701
furpa,0.1111111111111111,8,8,ACTCTTTAGAATAAAACTGA,0,1337088
furpa,0.1111111111111111,8,8,ACTCGCCCGTCCCACATCCC,0,1306604
furpa,0.1111111111111111,8,8,ACGTTCGTCGTACAAGCCCA,0,1278362
furpa,0.1111111111111111,8,8,ACGTGCAGTGGGGCTCTTGA,0,1318193
furpa,0.1111111111111111,8,8,ACGTGATCATTTTTGGTGAG,0,1288862
furpa,0.1111111111111111,8,8,ACGGTCGAGTTCAACCGCGA,0,1302336
furpa,0.1111111111111111,8,8,ACGGTCCAATCGCGGTGCAG,0,1346039
furpa,0.1111111111111111,8,8,ACGGCTTCGGATCTGGTCAA,0,1303362
furpa,0.1111111111111111,8,8,ACGGCTATTAACAGTTCCGT,0,1354811
furpa,0.1111111111111111,8,8,ACGGCGGGTCGGGCACGGAG,0,1324166
furpa,0.1111111111111111,8,8,ACGGCCAGTCCTGGCTGGTT,0,1344732
furpa,0.1111111111111111,8,8,ACGATACAGCCACTCCCGGC,0,1316318
furpa,0.1111111111111111,8,8,ACGAGAGGCGTGGCAGGGAC,0,1294404
furpa,0.1111111111111111,8,8,ACGAGACGATGTGCATACAA,0,1278044
furpa,0.1111111111111111,8,8,ACCTGCGAATTATCGACGGT,0,1326643
furpa,0.1111111111111111,8,8,ACCTCGTCTGGGGGGGTGAA,0,1325250
furpa,0.1111111111111111,8,8,ACCTATGCTAGGCGTATAGG,0,1311213
furpa,0.1111111111111111,8,8,ACCGTCTTGATGGCTGGGGA,0,1337504
furpa,0.1111111111111111,8,8,ACCGGTTCTGGGCAGGGGGG,0,1289170
furpa,0.1111111111111111,8,8,ACCGATACCGGCGGTGAACC,0,1325905
furpa,0.1111111111111111,8,8,ACCGAGCAGTCTCAATTCAA,0,1338575
furpa,0.1111111111111111,8,8,ACCGACAAGCCCGATATTAT,0,1280405
furpa,0.1111111111111111,8,8,ACCCGTCCAGGGTGCTTCGG,0,1283964
furpa,0.1111111111111111,8,8,ACCCACGTCGGAGCCATGTC,0,1289829
furpa,0.1111111111111111,8,8,ACCCACGACGCGGGCATCGC,0,1320430
furpa,0.1111111111111111,8,8,ACCATGGAAAGACACTAGGT,0,1347486
furpa,0.1111111111111111,8,8,ACCATAATTCTTGATTTCTG,0,1307880
furpa,0.1111111111111111,8,8,ACCAGCGTCAACCTTTGCCT,0,1319477
furpa,0.1111111111111111,8,8,ACCAGAGAGACGGTCAGAAC,0,1357263
furpa,0.1111111111111111,8,8,ACATTCGTGTGCGGGGTCAC,0,1291075
furpa,0.1111111111111111,8,8,ACATGGTATGTTTTCAAACT,0,1347970
furpa,0.1111111111111111,8,8,ACATGAACAAACCTGTACAA,0,1304046
furpa,0.1111111111111111,8,8,ACATATTCTTCTGAACAGTC,0,1286145
furpa,0.1111111111111111,8,8,ACAGTAGGATTGTACCTGTA,0,1338313
furpa,0.1111111111111111,8,8,ACACTGATAAGGCAATCTAA,0,1343798
furpa,0.1111111111111111,8,8,ACACTCTTAAGCCTAAAGGA,0,1325457
furpa,0.1111111111111111,8,8,ACACCTGGTCGGATGCATAA,0,1327620
furpa,0.1111111111111111,8,8,ACACAGAGATGTCACGTAGA,0,1297657
furpa,0.1111111111111111,8,8,ACAATTTCGGCATGGCTTGC,0,1289419
furpa,0.1111111111111111,8,8,AATTGTGGAATAAGTTAGTT,0,1338636
furpa,0.1111111111111111,8,8,AATTGGGAGATACGTAGCCT,0,1332759
furpa,0.1111111111111111,8,8,AATTGATGTTAGTCCTGTAG,0,1334481
furpa,0.1111111111111111,8,8,AATTGAAACCTCAGATTACT,0,1351154
furpa,0.1111111111111111,8,8,AATGTACGAAATAATAGTGA,0,1302458
furpa,0.1111111111111111,8,8,AATGGACCGGGGCTAGCGCA,0,1278553
furpa,0.1111111111111111,8,8,AATGCCGCGAATACCTCTCA,0,1304610
furpa,0.1111111111111111,8,8,AATCGGTACATGCGCCTGCA,0,1315179
furpa,0.1111111111111111,8,8,AATCGAAGAATGGAAAATCC,0,1272631
furpa,0.1111111111111111,8,8,AATCCCGACGTTTAGGTGAT,0,1345596
furpa,0.1111111111111111,8,8,AATCCACACAGGAGACACTC,0,1292815
furpa,0.1111111111111111,8,8,AATCAGGTAGGGTTTTTCTA,0,1337665
furpa,0.1111111111111111,8,8,AATATGTAGTCCGCTTTTAG,0,1271204
furpa,0.1111111111111111,8,8,AATATAACGCCACTGACTTG,0,1348681
furpa,0.1111111111111111,8,8,AATAGAGTTAGGCTTATCCG,0,1295374
furpa,0.1111111111111111,8,8,AATACCGAGCGGGGGCGTCT,0,1337707
furpa,0.1111111111111111,8,8,AATAAGGAGGAGGGTGTAGC,0,1347257
furpa,0.1111111111111111,8,8,AATAAAGGATGGAGGTAGAT,0,1302058
furpa,0.1111111111111111,8,8,AAGTTCAATTCCGGAGAGGG,0,1336675
furpa,0.1111111111111111,8,8,AAGTGGCTGAGCATCACCTG,0,1290226
furpa,0.1111111111111111,8,8,AAGTGGACCGGAATTCGGTA,0,1282070
furpa,0.1111111111111111,8,8,AAGTCTGGCATGCCAGGGGT,0,1331701
furpa,0.1111111111111111,8,8,AAGTCGCGTGGGGGAAGGAC,0,1321730
furpa,0.1111111111111111,8,8,AAGTACTTTCCGCTGGAGGG,0,1272223
furpa,0.1111111111111111,8,8,AAGTACTTATTTCCAAGGCA,0,1337505
furpa,0.1111111111111111,8,8,AAGGTTGCGTTAGTTATCAG,0,1350532
furpa,0.1111111111111111,8,8,AAGGTATCAGAAGTGGGGAC,0,1323963
furpa,0.1111111111111111,8,8,AAGGGAGCAACTAAGGCACC,0,1291085
furpa,0.1111111111111111,8,8,AAGGAATTCTCATTAATTCT,0,1281022
furpa,0.1111111111111111,8,8,AAGCGGGGCAGCGGCTCCAC,0,1288342
furpa,0.1111111111111111,8,8,AAGCCGCGGCTGCTTATCTA,0,1282337
furpa,0.1111111111111111,8,8,AAGATTAAGTATACTTGATT,0,1315220
furpa,0.1111111111111111,8,8,AAGAGCGTATGGTAAAGATA,0,1283408
furpa,0.1111111111111111,8,8,AAGACGTCTGTCCGGATTAC,0,1315770
furpa,0.1111111111111111,8,8,AAGACGACAAACTATGCCGC,0,1348111
furpa,0.1111111111111111,8,8,AACTTCCCGGGCGGGGTTTC,0,1354374
furpa,0.1111111111111111,8,8,AACTTCAATATTATTGCGAA,0,1308169
furpa,0.1111111111111111,8,8,AACTCTGTGTACGCCCACTC,0,1313777
furpa,0.1111111111111111,8,8,AACTCCTCAGTTCCGTGTGG,0,1297395
furpa,0.1111111111111111,8,8,AACTACCGAATGTAGAGTCG,0,1324990
furpa,0.1111111111111111,8,8,AACGATCTCCATAATTGCCG,0,1277459
furpa,0.1111111111111111,8,8,AACCGGCTGAGGTGTGCAGG,0,1285478
furpa,0.1111111111111111,8,8,AACATTTATGAACGCAGTTT,0,1317298
furpa,0.1111111111111111,8,8,AACACACGCCATTTGTACTA,0,1320633
furpa,0.1111111111111111,8,8,AAAGCCCAGCTGGGTTCGTA,0,1317328
furpa,0.1111111111111111,8,8,AAACGTCGGGCATACGAGTA,0,1310033
furpa,0.1111111111111111,8,8,AAACGCGTACTCCCCTCAAC,0,1287748
furpa,0.1111111111111111,8,8,AAACGCGCACAACTCTTCGT,0,1352939
furpa,0.1111111111111111,8,8,AAACAGTCCAGTTTAGAGAC,0,1331523
furpa,0.1111111111111111,8,8,AAAAGTCGTAAGCCATGTGC,0,1305947
furpa,0.1111111111111111,8,8,AAAAGGCGCGAGATGCAGAA,0,1340486
furpa,0.1111111111111111,8,8,AAAACGAAGGCTTGTTTAGT,0,1303501
furpa,0.1111111111111111,8,8,AAAACCAGCTCCGTCGGGCA,0,1348318
furpa,0.1111111111111111,8,8,AAAAAGGCAATGCTTTGCCC,0,1355519
furpa,0.1111111111111111,8,8,AAAAAATCACGGACGTCCTA,0,1309955
furpa,0.125,7,7,TTTTTTCAGGGATCTGGACA,0,1319638
furpa,0.125,7,7,TTTTGCTGATTGCATTCGAA,0,1339897
furpa,0.125,7,7,TTTTCCGGGTCTCCGCAGGA,0,1353182
furpa,0.125,7,7,TTTGGTACAATTGGTGGTTA,0,1329474
furpa,0.125,7,7,TTTGAGGGAAACCCCAAACG,0,1290457
furpa,0.125,7,7,TTTCTTGGGCGAGTGTGTTT,0,1347311
furpa,0.125,7,7,TTTCTGTACCATCATCTGAT,0,1309832
furpa,0.125,7,7,TTTCCTATCTTGCCGCGAGC,0,1339930
furpa,0.125,7,7,TTTCCCTTTTAGTACTAAAG,0,1277552
furpa,0.125,7,7,TTTCACTTTAGATGACTGTA,0,1314595
furpa,0.125,7,7,TTTAGGAGCGGATTTTTGCA,0,1307424
furpa,0.125,7,7,TTTACGCCATGAACGCCACA,0,1281716
furpa,0.125,7,7,TTTACCGTCACAGGAGATGT,0,1282367
furpa,0.125,7,7,TTTACACTCCCTGGCATTAT,0,1315881
furpa,0.125,7,7,TTGTGTTCCACTCGCTGGAA,0,1334063
furpa,0.125,7,7,TTGTGTGCACTCCGTCCATA,0,1293000
furpa,0.125,7,7,TTGTGTACCTCAATAGTCTG,0,1279713
furpa,0.125,7,7,TTGTCAAGGGCCACCAAGGC,0,1334204
furpa,0.125,7,7,TTGTCAAGCAGCTCAACAAG,0,1305743
furpa,0.125,7,7,TTGGTATACCCGCGTCAATA,0,1313453
furpa,0.125,7,7,TTGGGGGAGCCTTTCAAAAG,0,1343752
furpa,0.125,7,7,TTGGGGAGAGTATGGTTACA,0,1347271
furpa,0.125,7,7,TTGGGAAGCGTCACTACTTC,0,1282434
furpa,0.125,7,7,TTGGACAGTCAAGGGGTTAA,0,1349931
furpa,0.125,7,7,TTGCGTCACATAGGAACTCT,0,1298236
furpa,0.125,7,7,TTGCGGTTCATCTCAATGCT,0,1310535
furpa,0.125,7,7,TTGCGACGAAGCACTGTTGG,0,1356370
furpa,0.125,7,7,TTGCCAATCAGGTGGTGGCC,0,1350919
furpa,0.125,7,7,TTGCCAACAATAAGCTCAGA,0,1322821
furpa,0.125,7,7,TTGAGACAGGGGGAAAGAAG,0,1287945
furpa,0.125,7,7,TTGACCTTCGTTAGTCGCTT,0,1335584
furpa,0.125,7,7,TTGAACTGCGTGCACCGGAC,0,1354700
furpa,0.125,7,7,TTCTGCAAGCCTTGACCAAG,0,1346910
furpa,0.125,7,7,TTCTCAAAAACATCGTAACA,0,1313326
furpa,0.125,7,7,TTCGTTAACTATTTAGGGTC,0,1285994
furpa,0.125,7,7,TTCGTGGAGGCCTTCCGAGA,0,1300465
furpa,0.125,7,7,TTCGTACAGCCGGGTTATGT,0,1335686
furpa,0.125,7,7,TTCGGGGTGAAACCTGCGCA,0,1323180
furpa,0.125,7,7,TTCGCGATCGCCGAACCTAA,0,1341386
furpa,0.125,7,7,TTCGAGAAATCTCGAGGAGG,0,1321901
furpa,0.125,7,7,TTCCGCATTTATTGTTGGGC,0,1291812
furpa,0.125,7,7,TTCCGCACTTGGGCGAGGGT,0,1305157
furpa,0.125,7,7,TTCCCGCACACCCGTAGGAC,0,1281917
furpa,0.125,7,7,TTCAAGTCTACGTTAGTACA,0,1351525
furpa,0.125,7,7,TTATGGGGTACACTCTTGGT,0,1279799
furpa,0.125,7,7,TTATGAGAGGATCTATCGAA,0,1316696
furpa,0.125,7,7,TTATCGTTTGAATTATTAAT,0,1287532
furpa,0.125,7,7,TTATCCCGTGTCGAGGTCTG,0,1340450
furpa,0.125,7,7,TTATAGTGCCAGAGAGTGGG,0,1314467
furpa,0.125,7,7,TTATAATTCAATCCTCAGGA,0,1315984
furpa,0.125,7,7,TTAGTGTGCCCCGTTAGTCC,0,1314466
furpa,0.125,7,7,TTAGTATCTCGGTGGCGGTT,0,1321178
furpa,0.125,7,7,TTACTGAAATGCCGGGCGAC,0,1307833
furpa,0.125,7,7,TTACGCAAGCGGCTGGATTC,0,1282945
furpa,0.125,7,7,TTACGAAACGTCTGATGCCG,0,1353695
furpa,0.125,7,7,TTACCCGCTGAATATGTCGT,0,1317689
furpa,0.125,7,7,TTACATACCGGACTGTCTGC,0,1321800
furpa,0.125,7,7,TTACAGGGTCCTGGAATATT,0,1297240
furpa,0.125,7,7,TTAAGGCGTTGTACTGTCAG,0,1330388
furpa,0.125,7,7,TTAAGGAAATCCCAGCGAGT,0,1339564
furpa,0.125,7,7,TTAAGCGCTTGAGCCACGTG,0,1328988
furpa,0.125,7,7,TTAACCTATACTTTTTTAAC,0,1282150
furpa,0.125,7,7,TTAAACGGAGCAAGTTTAAC,0,1333540
furpa,0.125,7,7,TTAAAAATGCTCGCAATAGT,0,1295470
furpa,0.125,7,7,TGTTTTTACCGTGGGTATTG,0,1356693
furpa,0.125,7,7,TGTTTCCTTTGGCGAGTACG,0,1278038
furpa,0.125,7,7,TGTTCATATAATCCCGACTC,0,1311359
furpa,0.125,7,7,TGTGTTTTCAATTGACAGCC,0,1280965
furpa,0.125,7,7,TGTGGAACCGGCACCACCAC,0,1280214
furpa,0.125,7,7,TGTGAACCGGGGAAGGCAAC,0,1320821
furpa,0.125,7,7,TGTCGCTGCCAACAATTCAT,0,1274181
furpa,0.125,7,7,TGTCCCACCCACCCTGTGCT,0,1326753
furpa,0.125,7,7,TGTCAGATTCGCGGAGCGCA,0,1302648
furpa,0.125,7,7,TGTACGTGGCCCGGGATACA,0,1303268
furpa,0.125,7,7,TGTACCTATCGCCACCTGAC,0,1348756
furpa,0.125,7,7,TGGTTAGGCGGGTGTTGCAG,0,1319337
furpa,0.125,7,7,TGGTCCCTTTCAGCATGAAT,0,1337565
furpa,0.125,7,7,TGGGAATTTTCTAAAACAGT,0,1351808
furpa,0.125,7,7,TGGCTGGGCGTAAGCTCGTA,0,1286470
furpa,0.125,7,7,TGGCTAACCCATTAGAGCGA,0,1279251
furpa,0.125,7,7,TGGCCAATCTTGCGTTCTTT,0,1294846
furpa,0.125,7,7,TGGCATTATCTCCTAGAAGT,0,1325492
furpa,0.125,7,7,TGGCACGATTTCTGTCCTCG,0,1301316
furpa,0.125,7,7,TGGATTGGGCGTCATAGATA,0,1351651
furpa,0.125,7,7,TGCTGTAAACATGTACTCAA,0,1336704
furpa,0.125,7,7,TGCTCAGCTATATTTCACGT,0,1284801
furpa,0.125,7,7,TGCGGCGGTGCAGTACAAAG,0,1346469
furpa,0.125,7,7,TGCAGCGTGTTTAGCTATCC,0,1317833
furpa,0.125,7,7,TGCACGGTACTCCATCTTAT,0,1350386
furpa,0.125,7,7,TGCAAGTCGTAATGACCTTC,0,1326128
furpa,0.125,7,7,TGATTGGGACACCTCCCCAC,0,1318210
furpa,0.125,7,7,TGATTCAGGTGCAGTTGAAA,0,1298076
furpa,0.125,7,7,TGATGTTGAGGCAGCGCAGG,0,1334197
furpa,0.125,7,7,TGATGTGCTCAGGATCAATC,0,1333532
furpa,0.125,7,7,TGATGACGTGAATCCCCCGT,0,1343201
furpa,0.125,7,7,TGATCACACAGGATTTCAGA,0,1334774
furpa,0.125,7,7,TGATATCCAAAGACACCATT,0,1284821
furpa,0.125,7,7,TGATATACTGACTAGAAGGC,0,1357029
furpa,0.125,7,7,TGAGTGACATTCACAAGTTG,0,1351507
furpa,0.125,7,7,TGAGTCGAAAACGCTACAAT,0,1331871
furpa,0.125,7,7,TGAGGGGCTCTTGCTCTATC,0,1277817
furpa,0.125,7,7,TGAGGCTGTACCTCAGGCTC,0,1347962
furpa,0.125,7,7,TGAGATAGCTTCCGAACCGA,0,1329203
furpa,0.125,7,7,TGAGAGGGGGCGTATAGAGC,0,1350203
furpa,0.125,7,7,TGAGACAGGACTCAAATGGT,0,1284871
furpa,0.125,7,7,TGAGAATTCTTGTAATCGAA,0,1298763
furpa,0.125,7,7,TGACTGACACGTTGGGTCCG,0,1301091
furpa,0.125,7,7,TGAAGGTGGTGCCTCTTGTC,0,1311506
furpa,0.125,7,7,TGAAGAGTCCCGTCTATCTT,0,1299625
furpa,0.125,7,7,TGAACGGGGTGATTGTACCT,0,1340642
furpa,0.125,7,7,TGAACAAGCAATATTTATGG,0,1357332
furpa,0.125,7,7,TCTTTACCCAAGCCTCTCGT,0,1341205
furpa,0.125,7,7,TCTGTGGAAACCACGCACAA,0,1336369
furpa,0.125,7,7,TCTGTCCCGTGCACACCGAA,0,1284536
furpa,0.125,7,7,TCTGTCCAAACGGGTTTCCT,0,1329120
furpa,0.125,7,7,TCTGAATCCAACCCGGGAGA,0,1297213
furpa,0.125,7,7,TCTGAAGGATAAATACGCTC,0,1343558
furpa,0.125,7,7,TCTCTAATGAAAATCCTCTT,0,1320284
furpa,0.125,7,7,TCTCGTCACAATCCAAGTCG,0,1307745
furpa,0.125,7,7,TCTCCGGGCGCTCATTTTTG,0,1295875
furpa,0.125,7,7,TCTAGCTCTGTCAGTGCGCT,0,1351083
furpa,0.125,7,7,TCTACTGTAACCCATACAGG,0,1295051
furpa,0.125,7,7,TCTACAGCAAGGCTTTGGGC,0,1342013
furpa,0.125,7,7,TCTAAGGACAAAGTTTACGA,0,1334240
furpa,0.125,7,7,TCTAACAATACTCGCGTATC,0,1314432
furpa,0.125,7,7,TCGTAAGTGGCTTTCCCGGA,0,1302937
furpa,0.125,7,7,TCGGGTCCGCAGCAAGAAGG,0,1350855
furpa,0.125,7,7,TCGGGAGAGGTTCTATGACA,0,1340364
furpa,0.125,7,7,TCGGCTTCTACTGACCAATT,0,1320983
furpa,0.125,7,7,TCGCTGAGTGCTATTCTCTT,0,1336343
furpa,0.125,7,7,TCGCGAACGCGGAAGCATTG,0,1347370
furpa,0.125,7,7,TCGATGGTAGGTAATGCTAT,0,1278897
furpa,0.125,7,7,TCGAGGTGGGCCGGAAGGAC,0,1337359
furpa,0.125,7,7,TCGAGCTGATTAAACGAGGA,0,1317482
furpa,0.125,7,7,TCGACCCTTTTAGTGGTCTA,0,1295286
furpa,0.125,7,7,TCGAATTATATGCGGCATAT,0,1298558
furpa,0.125,7,7,TCGAAAGCCATCTTCGGGTC,0,1293523
furpa,0.125,7,7,TCGAAAGAGCCTTGAAAAGC,0,1280295
furpa,0.125,7,7,TCCTTTAATGCGGATAGCAA,0,1298614
furpa,0.125,7,7,TCCTTAGTACCTTATAGAAG,0,1325139
furpa,0.125,7,7,TCCTCGTTCCATAGTCAGGA,0,1340003
furpa,0.125,7,7,TCCTCCGCGGTCCTTAGTAA,0,1338050
furpa,0.125,7,7,TCCTATAAATTGCCCCATTT,0,1335032
furpa,0.125,7,7,TCCGTTATTCCAACCGCGTT,0,1278113
furpa,0.125,7,7,TCCGGTGCCCGGTAAAAATA,0,1287865
furpa,0.125,7,7,TCCGCTATACCGGCAGACGG,0,1314007
furpa,0.125,7,7,TCCGACTCGCGTCAACGACT,0,1293766
furpa,0.125,7,7,TCCCGTACTCTAAGATCATG,0,1301260
furpa,0.125,7,7,TCCCGAAATCGGGGACCAAG,0,1324764
furpa,0.125,7,7,TCCCCCACCTTTTCTACAGT,0,1333293
furpa,0.125,7,7,TCCCAGCGGTGCGTGAAGGA,0,1289641
furpa,0.125,7,7,TCCCACCCCTGAAAGGAGGC,0,1342400
furpa,0.125,7,7,TCCAGTGTGAGTCCCACTCT,0,1322819
furpa,0.125,7,7,TCCACAGCGCATAAATTAGG,0,1300918
furpa,0.125,7,7,TCCACAATTTGCTTAGCCGC,0,1313393
furpa,0.125,7,7,TCATCATGTACTGGTCAGCA,0,1332987
furpa,0.125,7,7,TCATACGTATCGGACATCTG,0,1273676
furpa,0.125,7,7,TCAGTACGGTTGCAGGGGTT,0,1327339
furpa,0.125,7,7,TCAGGCTCGACCGCCCAATT,0,1344644
furpa,0.125,7,7,TCAGGCGTTGTTTGGACGCT,0,1308226
furpa,0.125,7,7,TCAGAGCGGAAATGACATTG,0,1295219
furpa,0.125,7,7,TCAGAGCGAATCGGCTCTAT,0,1295017
furpa,0.125,7,7,TCAGACCTAACGTCGGCCGC,0,1285623
furpa,0.125,7,7,TCACTCGGCTAAGTCTCCTG,0,1340000
furpa,0.125,7,7,TCACATGATCTCGCCATGCC,0,1334789
furpa,0.125,7,7,TCAACAGTTGTGTTCGTCGT,0,1290680
furpa,0.125,7,7,TATTCACTAGGGTTCCAATG,0,1330802
furpa,0.125,7,7,TATTATTACCGGTTCCAGCG,0,1353136
furpa,0.125,7,7,TATTACGCGACACGGGTGAG,0,1314896
furpa,0.125,7,7,TATGTTTGATTTTATATGCC,0,1339742
furpa,0.125,7,7,TATGGGCGCGGCGCCCATAC,0,1279049
furpa,0.125,7,7,TATGATAGTGCCACAAATGG,0,1290609
furpa,0.125,7,7,TATGAGAACAGCCACCGATC,0,1319717
furpa,0.125,7,7,TATGACGGAGCGGGGAGTTC,0,1314383
furpa,0.125,7,7,TATCTCCCGAGCACAATATT,0,1323246
furpa,0.125,7,7,TATCCGTTCGGGACACCGAA,0,1319200
furpa,0.125,7,7,TATCCCGAATCCCCGGAATT,0,1293290
furpa,0.125,7,7,TATATTTGCACACACCCATA,0,1356674
furpa,0.125,7,7,TATATATAAGTGAGGAATGC,0,1330353
furpa,0.125,7,7,TATATAAAAGTGGGAGACGG,0,1293097
furpa,0.125,7,7,TAGTGCCGTATTATAGCATA,0,1323812
furpa,0.125,7,7,TAGGTTCTGTCGGTGGGTAT,0,1289097
furpa,0.125,7,7,TAGGTATGAGTATTATCCAG,0,1297591
furpa,0.125,7,7,TAGGGTCTTATATGCATCAA,0,1274887
furpa,0.125,7,7,TAGGCTGACACTCGCTTGTG,0,1335152
furpa,0.125,7,7,TAGGCATCTTGTTAGATCAT,0,1278053
furpa,0.125,7,7,TAGCTACGCGCAGTGCACGC,0,1306412
furpa,0.125,7,7,TAGCGTCTGCCTCGAATGCA,0,1317758
furpa,0.125,7,7,TAGCAATGCCAAATTAACAG,0,1302024
furpa,0.125,7,7,TAGATTTTCGTTGAGCGAAT,0,1349318
furpa,0.125,7,7,TAGATACCATGGTTCATAGC,0,1290757
furpa,0.125,7,7,TAGAATTGCTCGCAAACAAC,0,1281060
furpa,0.125,7,7,TACTTCTAGCCACTTGTACT,0,1333127
furpa,0.125,7,7,TACTCGGTTTCGCTTGTAGT,0,1288676
furpa,0.125,7,7,TACTCATCCTCATCGTCGTG,0,1304443
furpa,0.125,7,7,TACGTGCTATCCATACGCCG,0,1309115
furpa,0.125,7,7,TACGGGGATTCACCCTTCTT,0,1320703
furpa,0.125,7,7,TACGCTCACCGGCCAAAAAT,0,1292771
furpa,0.125,7,7,TACCGGCTACGAAGAAATCC,0,1294020
furpa,0.125,7,7,TACCGGAAAACTCCGATTCC,0,1288282
furpa,0.125,7,7,TACCCTTGCGCAGGCCGTCG,0,1344866
furpa,0.125,7,7,TACAAGTCTGTACAGAAAAT,0,1336792
furpa,0.125,7,7,TAATGCTGGATCCCGTTTGT,0,1271874
furpa,0.125,7,7,TAATGCAGGTAGTCCTCGAG,0,1335344
furpa,0.125,7,7,TAATAGTTGCACCGGCAAAC,0,1315416
furpa,0.125,7,7,TAAGGTGAGCATTTATCAGG,0,1321786
furpa,0.125,7,7,TAAGGCTCAAACCTTCAGAG,0,1333167
furpa,0.125,7,7,TAAGCTGGTTAAGCGGGGAG,0,1284540
furpa,0.125,7,7,TAAGCCCTTAGTATTACATT,0,1288893
furpa,0.125,7,7,TAAGATTTCACTGAGGAGAG,0,1331284
furpa,0.125,7,7,TAAGAGTACTTGTACACACG,0,1344671
furpa,0.125,7,7,TAACGAGGCGTCGCTCTCAT,0,1277340
furpa,0.125,7,7,TAACCTACATATAGGAACCC,0,1325688
furpa,0.125,7,7,TAACAAGGTCACGGGTCATA,0,1320345
furpa,0.125,7,7,TAAATGTCAGATGTGAAATG,0,1334904
furpa,0.125,7,7,TAAATGGCTAAGGTGAACCC,0,1338214
furpa,0.125,7,7,TAAAGATAGGTCACACCTGT,0,1277796
furpa,0.125,7,7,GTTTAGCACTCGGTTCACAA,0,1313331
furpa,0.125,7,7,GTTGGGGTGCACGGCCTATG,0,1298541
furpa,0.125,7,7,GTTGATATCGAGCCCGCTTA,0,1312759
furpa,0.125,7,7,GTTGATACGCGTATTCCGCA,0,1297445
furpa,0.125,7,7,GTTCTCTGTAGTGCCTCTTA,0,1354378
furpa,0.125,7,7,GTTAATCCCGTTTTGAGAGA,0,1315734
furpa,0.125,7,7,GTGTGCCTCTCGAAGCGTGT,0,1346029
furpa,0.125,7,7,GTGGTGCGGGGGGGTCAGTT,0,1274008
furpa,0.125,7,7,GTGGGTTCTCGGTCCGAATG,0,1323097
furpa,0.125,7,7,GTGGGGACTGAAGTTAAATT,0,1347991
furpa,0.125,7,7,GTGGGAAGGACCTGGGGCTG,0,1322880
furpa,0.125,7,7,GTGCTGTACTCGCAAGGGGT,0,1333155
furpa,0.125,7,7,GTGCGTGTTGTTCAGGAACC,0,1312616
furpa,0.125,7,7,GTGCCGTCTTTCGTGGGCTC,0,1289225
furpa,0.125,7,7,GTGCAGCAAAGGGGTAGGCT,0,1281714
furpa,0.125,7,7,GTGATCTGTCCCCAAGTGGA,0,1302439
furpa,0.125,7,7,GTGAGTGATCGCCCTGGTTG,0,1301067
furpa,0.125,7,7,GTGAGAGGAGACTATTCTCA,0,1283317
furpa,0.125,7,7,GTGACGCGTTTCGGGCACCT,0,1336338
furpa,0.125,7,7,GTCTTGAAGGTGCCGGAATG,0,1315188
furpa,0.125,7,7,GTCTTATGGCTAATGGACAT,0,1353878
furpa,0.125,7,7,GTCTCCTATGTTCACTCGGC,0,1317494
furpa,0.125,7,7,GTCTAGCCGGGTAGCCGGTG,0,1293670
furpa,0.125,7,7,GTCGATCTTTTAGGATCAAG,0,1307903
furpa,0.125,7,7,GTCGATATGACTCGGCAGCA,0,1329856
furpa,0.125,7,7,GTCCGTGTGTCGAGGCATTT,0,1329398
furpa,0.125,7,7,GTCCATGAAATATTGGTCTT,0,1337721
furpa,0.125,7,7,GTCAGCGAAGTTTAAGGCGA,0,1354716
furpa,0.125,7,7,GTATGGGTTAACAGTCAAAC,0,1311179
furpa,0.125,7,7,GTATGAAGACTATCCAAGTA,0,1276315
furpa,0.125,7,7,GTATCATTCTTTAGGGGCGC,0,1351206
furpa,0.125,7,7,GTATATGAATGCACTTGAGC,0,1277099
furpa,0.125,7,7,GTAGTCTCTGTTCATCAGCA,0,1306667
furpa,0.125,7,7,GTAGTCATCGTTAGGCGATG,0,1348639
furpa,0.125,7,7,GTAGTACGGATAGTCTGCGG,0,1281272
furpa,0.125,7,7,GTAGCGGTGACGACTTGATA,0,1308898
furpa,0.125,7,7,GTAGCCGGACCCAAGCAATT,0,1285702
furpa,0.125,7,7,GTAGCACTATCAAATGCAAG,0,1332395
furpa,0.125,7,7,GTAGAGGAATAGCCGGTAGG,0,1352826
furpa,0.125,7,7,GTACTTGGGGCTGAAATGGT,0,1281893
furpa,0.125,7,7,GTACTCAATCTTTTGTAACT,0,1282046
furpa,0.125,7,7,GTACGGAGGTACAGGGGAAG,0,1346970
furpa,0.125,7,7,GTAATCTCCAATATGTCTCA,0,1316457
furpa,0.125,7,7,GTAAGCATGTTCAGGCGTAT,0,1356809
furpa,0.125,7,7,GTAACCTAGCCGGTAGCAGC,0,1314908
furpa,0.125,7,7,GTAAAATGAGAAAAATGTCA,0,1299594
furpa,0.125,7,7,GGTTTTGGAGAGCAAAGGTG,0,1346467
furpa,0.125,7,7,GGTTTGAATCCTGGAAGGCT,0,1288011
furpa,0.125,7,7,GGTTTCTCCAGACGGCCGAC,0,1271939
furpa,0.125,7,7,GGTTGATCCTCTCTCGCATG,0,1283746
furpa,0.125,7,7,GGTTCTTTGTTAGGATCTAG,0,1298517
furpa,0.125,7,7,GGTTCGATTGCTGATTCCTG,0,1274252
furpa,0.125,7,7,GGTTCATAGGAGAATCCACA,0,1276529
furpa,0.125,7,7,GGTTACTTGGTATACTCAGC,0,1281451
furpa,0.125,7,7,GGTGTGATGCATATGCTCGT,0,1345159
furpa,0.125,7,7,GGTGTAAAAAGCAATCCTAT,0,1351294
furpa,0.125,7,7,GGTGGTAGTACAGTCAACAC,0,1340360
furpa,0.125,7,7,GGTGCAGTGCCCGGGTAAGG,0,1337976
furpa,0.125,7,7,GGTGACCTGTTATTTGGATG,0,1313936
furpa,0.125,7,7,GGTGAACTCTGTCTAAACTG,0,1279705
furpa,0.125,7,7,GGTCGCCAGGCGTACTAGCA,0,1321859
furpa,0.125,7,7,GGTCCAATTCCGCGCGGTGT,0,1308364
furpa,0.125,7,7,GGTCATAGACGAAGGGAAAT,0,1323224
furpa,0.125,7,7,GGTCATAAATCGAACAGGTC,0,1322301
furpa,0.125,7,7,GGTATCTCGGGGTACACGTT,0,1285929
furpa,0.125,7,7,GGTATAGTCGCAGTCTGTTC,0,1284477
furpa,0.125,7,7,GGTAAGAGGACGAGTGTCAG,0,1292171
furpa,0.125,7,7,GGTAACGCCACGACGAATCC,0,1279109
furpa,0.125,7,7,GGGTTTCTGCCAGGGCCGTT,0,1281798
furpa,0.125,7,7,GGGTTTAGTGACATCGAGGG,0,1306145
furpa,0.125,7,7,GGGTCTTGTTGGATCGCCCT,0,1342727
furpa,0.125,7,7,GGGTCTCCCTTTGTGCATCA,0,1317703
furpa,0.125,7,7,GGGTAGAGTTGACTTCATTA,0,1284081
furpa,0.125,7,7,GGGTAATTATAGTGTATTTC,0,1287639
furpa,0.125,7,7,GGGGTATGAGTCTCTGTAAG,0,1344673
furpa,0.125,7,7,GGGGCAGAGCGTTACGGGTT,0,1339507
furpa,0.125,7,7,GGGGATCCCGGGTTGGGTTT,0,1333687
furpa,0.125,7,7,GGGGAGTAGATAAGCATTAT,0,1306232
furpa,0.125,7,7,GGGCTCATTAACCCTAAACC,0,1354177
furpa,0.125,7,7,GGGCGTTGACGCAACGTTTT,0,1350864
furpa,0.125,7,7,GGGCGTCAAATGCAGAAGGA,0,1300356
furpa,0.125,7,7,GGGCGGAGCGGGCCACTCTA,0,1345108
furpa,0.125,7,7,GGGCGCGGCCCTTTTATCTA,0,1322080
furpa,0.125,7,7,GGGCGCAGTGACCGATACCT,0,1280267
furpa,0.125,7,7,GGGCACACTCGGAGAACACC,0,1350088
furpa,0.125,7,7,GGGATCGCGAAATGGTCGCG,0,1302821
furpa,0.125,7,7,GGGAGGTCGCTCTTTTCTAA,0,1318440
furpa,0.125,7,7,GGGAGGAGTTTACACACAAA,0,1277043
furpa,0.125,7,7,GGCTTTATTACGCATGAGAG,0,1316195
furpa,0.125,7,7,GGCTGCTATCCCACCGAGTC,0,1291761
furpa,0.125,7,7,GGCTGCATCTCCCTAGTGTC,0,1290999
furpa,0.125,7,7,GGCTCGTCTTCGGTGGTACG,0,1288626
furpa,0.125,7,7,GGCTCCTTCGGCAGGAACGC,0,1320654
furpa,0.125,7,7,GGCTCCTTACTCGAATGTAA,0,1321681
furpa,0.125,7,7,GGCGTGGAGATGTCTGGTTT,0,1274507
furpa,0.125,7,7,GGCGGTCCTCGTTCGGTCCA,0,1301414
furpa,0.125,7,7,GGCGAGGTCAACAGCTGTCA,0,1325355
furpa,0.125,7,7,GGCCTTTCTGGCTATATGGC,0,1334486
furpa,0.125,7,7,GGCCCTCCTATAGACTGGGT,0,1307937
furpa,0.125,7,7,GGCCCGTCAATCAGATATCG,0,1332903
furpa,0.125,7,7,GGCCCACAGCCAGGCACTGC,0,1286860
furpa,0.125,7,7,GGCATATGAAGGCCCGGTCC,0,1323245
furpa,0.125,7,7,GGCATAGCGTTGTAAAAGCA,0,1349795
furpa,0.125,7,7,GGAGTTGCTACGTTTGGCCG,0,1323241
furpa,0.125,7,7,GGAGTCCGCCCGGGCCTGGT,0,1290779
furpa,0.125,7,7,GGAGGTCTGAACCAGTGTCA,0,1318830
furpa,0.125,7,7,GGAGGAGCTTATGACTTATT,0,1316898
furpa,0.125,7,7,GGACTTTTAAGTTTACTCGT,0,1320634
furpa,0.125,7,7,GGACGTTTAAGGACGCCGAT,0,1355879
furpa,0.125,7,7,GGACGGTACCCTCTACGAGG,0,1306156
furpa,0.125,7,7,GGACGCGAATAACATAAGTC,0,1278270
furpa,0.125,7,7,GGACCTTGATAACACTAGAC,0,1305021
furpa,0.125,7,7,GGACCCAGATGCGACGGACG,0,1351581
furpa,0.125,7,7,GGACAAACAAAAGAAGACAG,0,1336745
furpa,0.125,7,7,GGAATTGTACCCTCATGTAG,0,1280292
furpa,0.125,7,7,GGAATGAAGTCTTAACCTAT,0,1302866
furpa,0.125,7,7,GGAAGATAATAGACTGCAAC,0,1279611
furpa,0.125,7,7,GCTTTTCGGTGGGCCGTGTT,0,1335948
furpa,0.125,7,7,GCTGTTAGACCAACAAAGCG,0,1348761
furpa,0.125,7,7,GCTGTGTGTCATCTACTCAG,0,1347578
furpa,0.125,7,7,GCTGATCACGATACGTACTT,0,1305089
furpa,0.125,7,7,GCTGACAACCTGCAGTTTTT,0,1310092
furpa,0.125,7,7,GCTCGCCAGCGTTGATACGG,0,1283108
furpa,0.125,7,7,GCTCGAAAGCGGCCGAAATA,0,1346001
furpa,0.125,7,7,GCTCCTTGCAGAATATCCAT,0,1322074
furpa,0.125,7,7,GCTCAGACTAATGATCGCCG,0,1355437
furpa,0.125,7,7,GCTAATGGTTCGGTTCTTAA,0,1356421
furpa,0.125,7,7,GCGTGATTTGCAATCAACGA,0,1272127
furpa,0.125,7,7,GCGGTTCGTTCATATGGCGC,0,1301463
furpa,0.125,7,7,GCGGTGCGCACGCCGCCAAC,0,1328290
furpa,0.125,7,7,GCGGCGGCAGCTGGTTCTGA,0,1320755
furpa,0.125,7,7,GCGCTTTTCCTGCGAATACA,0,1331857
furpa,0.125,7,7,GCGCGTCCGCGGCTAGCGCA,0,1295676
furpa,0.125,7,7,GCGCGGCGAACCCCCGTCCC,0,1305460
furpa,0.125,7,7,GCGCGCTCGATGTAAAGTTA,0,1310700
furpa,0.125,7,7,GCGCCCGCTGCCCCGCACCA,0,1303649
furpa,0.125,7,7,GCGCCCACCGTAGGCAGGCC,0,1302554
furpa,0.125,7,7,GCGCCACTCTCGACGACTCG,0,1294636
furpa,0.125,7,7,GCGCATAGACGTACATCAAT,0,1299130
furpa,0.125,7,7,GCGAGGCTGGAGCGGTGAAA,0,1343487
furpa,0.125,7,7,GCGACAGCCTGCCGACGATC,0,1346712
furpa,0.125,7,7,GCGACAAGAGTCACACACCT,0,1276983
furpa,0.125,7,7,GCGAATCACAGCATTGTGTG,0,1278477
furpa,0.125,7,7,GCGAATAAGGATGATTCCAG,0,1349658
furpa,0.125,7,7,GCCGTGGGTTAGAGGCGACA,0,1312002
furpa,0.125,7,7,GCCGGGTGTTCGCACGTATT,0,1319110
furpa,0.125,7,7,GCCGCAGACGCCAGTGGTGT,0,1298576
furpa,0.125,7,7,GCCGATCGGTCCTGACCGCG,0,1310458
furpa,0.125,7,7,GCCCTTTGGAACCGTATTCA,0,1309112
furpa,0.125,7,7,GCCCGCTATGTCGCTTAGGT,0,1340372
furpa,0.125,7,7,GCCCGACCGTTGCATGGGGA,0,1291281
furpa,0.125,7,7,GCCCCTCTAATCAGTGTTCC,0,1288829
furpa,0.125,7,7,GCCCACCTTCCGAAAGGCAG,0,1349258
furpa,0.125,7,7,GCCATTCCTGGCGCGGCCAC,0,1315708
furpa,0.125,7,7,GCCATTAGATCCTTTAATTC,0,1314222
furpa,0.125,7,7,GCCAGCTGGAAGGGGACGAC,0,1286366
furpa,0.125,7,7,GCCAAGAACGCGCTAGCGGC,0,1317330
furpa,0.125,7,7,GCATAGACATCAACGGTCCT,0,1276206
furpa,0.125,7,7,GCAGTTGCGCATACTCGCGT,0,1355140
furpa,0.125,7,7,GCAGTAGACAGTATTACATC,0,1294756
furpa,0.125,7,7,GCAGGGTCTGGTTTAACGTA,0,1271868
furpa,0.125,7,7,GCAGGGGGCTACCCAGTGGT,0,1348574
furpa,0.125,7,7,GCAGCTGGTGATCCGTTCCA,0,1318870
furpa,0.125,7,7,GCAGAGCCGGCAACAGGGGG,0,1297593
furpa,0.125,7,7,GCACTCAAAAAGGTAGTGAA,0,1272203
furpa,0.125,7,7,GCACTATGGTGCCCTAGATA,0,1327988
furpa,0.125,7,7,GCAAGCGGTAATAAAGATTT,0,1274625
furpa,0.125,7,7,GCAACTATATAACGTACGCA,0,1323998
furpa,0.125,7,7,GCAAAGGGGTGGGATAGTTT,0,1355374
furpa,0.125,7,7,GATTCGGCAGCACGTACGCG,0,1331090
furpa,0.125,7,7,GATTACGATAGCCAAAAGTC,0,1343747
furpa,0.125,7,7,GATGAGGGTCGCTTCGAGCA,0,1354864
furpa,0.125,7,7,GATCTGACCTGTTAAGTGTC,0,1298291
furpa,0.125,7,7,GATCCAGTGGTACGAGGGAA,0,1331985
furpa,0.125,7,7,GATCAGGGCTGATGTCCTCG,0,1275982
furpa,0.125,7,7,GATCAAGGTGCCCCGAAAAA,0,1338755
furpa,0.125,7,7,GATATTTGATGACCGTATCT,0,1342884
furpa,0.125,7,7,GATATTTGACCTTAGACATA,0,1284248
furpa,0.125,7,7,GATACGTCGCCGTCGTTGAG,0,1307220
furpa,0.125,7,7,GAGTTTACGCCCCGACCCCA,0,1332454
furpa,0.125,7,7,GAGTCTCCTATTTCCCAATC,0,1323342
furpa,0.125,7,7,GAGTCTATATTTCGATTCAC,0,1336593
furpa,0.125,7,7,GAGTCGAATAGGTCCAGGTT,0,1351309
furpa,0.125,7,7,GAGGTAACCATGTTACGCGT,0,1323311
furpa,0.125,7,7,GAGGGGGGCATAGGATGGGT,0,1314003
furpa,0.125,7,7,GAGGGAGCCGCTTCGGCTGA,0,1356826
furpa,0.125,7,7,GAGGAAGGGTTAGCTGATAC,0,1339462
furpa,0.125,7,7,GAGCTGAATAGATTGCAGAG,0,1338659
furpa,0.125,7,7,GAGCTCCTATCCGCATTAGT,0,1279183
furpa,0.125,7,7,GAGCGATTGTTAAGTCGTCA,0,1282293
furpa,0.125,7,7,GAGCAGGATTCCCCGAGGGG,0,1341242
furpa,0.125,7,7,GAGCAATATATGGCCTTTCA,0,1356737
furpa,0.125,7,7,GAGATTGGAACTTTATAAAG,0,1306319
furpa,0.125,7,7,GAGATCATTAGGCGATAGTG,0,1337231
furpa,0.125,7,7,GAGAGTATGTGGTAGGTTGA,0,1332255
furpa,0.125,7,7,GAGAGGGAATGTGTGCGAAA,0,1353744
furpa,0.125,7,7,GAGAATCAGATACTTAGGCA,0,1345863
furpa,0.125,7,7,GAGAACGGTCTCCAGGTGGT,0,1308644
furpa,0.125,7,7,GACTGGTCACAGAGTTAGTG,0,1325074
furpa,0.125,7,7,GACTGGGAATTTTCTGAGCT,0,1306211
furpa,0.125,7,7,GACTGACTTGATTAACTTTG,0,1341185
furpa,0.125,7,7,GACTATGTTATGTTTTGGCC,0,1355929
furpa,0.125,7,7,GACTATGCGGGATGACAGGG,0,1340444
furpa,0.125,7,7,GACGGTACCCTCGGTCAGTC,0,1273235
furpa,0.125,7,7,GACGATGTGAGAATGTGGGT,0,1333798
furpa,0.125,7,7,GACCCAAATGGAGGAGATGT,0,1280079
furpa,0.125,7,7,GACCAACGGTGGCGTCAGGA,0,1306634
furpa,0.125,7,7,GACACAGGCGTTGGTTCGAA,0,1302690
furpa,0.125,7,7,GACAAGTGAATTATCGCGCT,0,1307828
furpa,0.125,7,7,GACAAACTCCGTAACGACAT,0,1286756
furpa,0.125,7,7,GAATTTGGGCGCACAGGTGA,0,1274544
furpa,0.125,7,7,GAATGCTGAGGGGTGAAATC,0,1279288
furpa,0.125,7,7,GAATCGGTTCATCGAATGGG,0,1307787
furpa,0.125,7,7,GAATAGCCTCATTGTTACTT,0,1275779
furpa,0.125,7,7,GAATACATTTTTGACGTCCC,0,1347063
furpa,0.125,7,7,GAAGTAGAAGCTTCTAGTCC,0,1292523
furpa,0.125,7,7,GAAGTAACGAGGTGGCAGCT,0,1277260
furpa,0.125,7,7,GAAGCCTTCTCGCCGCGTGT,0,1322094
furpa,0.125,7,7,GAAGATGTGGCAGCGGGAAA,0,1277432
furpa,0.125,7,7,GAAGATCAGCGGTATTGCGA,0,1275105
furpa,0.125,7,7,GAAGACTAGAGTAGATCCAA,0,1271496
furpa,0.125,7,7,GAACTACTTTAAAATGGTAT,0,1325923
furpa,0.125,7,7,GAACCATGAGCGGGAGGCGT,0,1309741
furpa,0.125,7,7,GAACCAGCGGTCAGTGGCTG,0,1297295
furpa,0.125,7,7,GAACAGGTTCAGGGGTAATG,0,1340831
furpa,0.125,7,7,GAAATGGCGGTCGGCTGGGG,0,1320497
furpa,0.125,7,7,GAAACCGGTTACCAAATCAT,0,1286214
furpa,0.125,7,7,GAAACCGGCTTGATAATATT,0,1274045
furpa,0.125,7,7,GAAAACTTAGCTAGCTTCGT,0,1331083
furpa,0.125,7,7,GAAAACATGGTGCGCAAGGT,0,1334692
furpa,0.125,7,7,CTTTTTACTAATAACAGTCG,0,1334307
furpa,0.125,7,7,CTTTTCATGAGGAGGGGGCG,0,1298152
furpa,0.125,7,7,CTTTGGTACGAGAACGGGAC,0,1284423
furpa,0.125,7,7,CTTTGGAACCAACGCAGGGT,0,1325287
furpa,0.125,7,7,CTTTCTTGACTTATTGAAAT,0,1291217
furpa,0.125,7,7,CTTTCTGCGGTTGATAACTA,0,1348356
furpa,0.125,7,7,CTTTCCGAATAGCAGAAACT,0,1320042
furpa,0.125,7,7,CTTGGGCTGGAATATGTAGA,0,1337015
furpa,0.125,7,7,CTTGCGTTAGGTAGACTTTT,0,1335460
furpa,0.125,7,7,CTTGACCAAAGTCCTGAACA,0,1339164
furpa,0.125,7,7,CTTCTACGACCCGTAAAGAT,0,1272737
furpa,0.125,7,7,CTTCGGCTTGTCGTATCACA,0,1335071
furpa,0.125,7,7,CTTCGCGGGCCTGGATTTTT,0,1307866
furpa,0.125,7,7,CTTCAGCCCCACTGCTGAAG,0,1344044
furpa,0.125,7,7,CTTCAAGCCCAGGTATATGT,0,1322843
furpa,0.125,7,7,CTTATAGGACCTTGCCAGCA,0,1276224
furpa,0.125,7,7,CTTAGGGACCTGTGTGCGTT,0,1290871
furpa,0.125,7,7,CTTAGAGATAGGGGTTTCCC,0,1282616
furpa,0.125,7,7,CTTACACAACGGTTTCATAT,0,1324510
furpa,0.125,7,7,CTTAAGTTGCTCGCGGAACG,0,1288864
furpa,0.125,7,7,CTGTCGCAGGTAGCGCGCGT,0,1321809
furpa,0.125,7,7,CTGTAGGGGACACTTACATA,0,1337403
furpa,0.125,7,7,CTGGTGTACTGGGCATACCG,0,1278413
furpa,0.125,7,7,CTGGTGGGCGCGGTCACAGC,0,1334619
furpa,0.125,7,7,CTGGTACTAAGGCAACGATT,0,1332163
furpa,0.125,7,7,CTGGGTAAATGGGGGCGTTA,0,1319382
furpa,0.125,7,7,CTGCGCTGTGAGTTACTACG,0,1316007
furpa,0.125,7,7,CTGCCCGAACTACCCAGCTA,0,1282845
furpa,0.125,7,7,CTGCACACAGCTAAACTTAC,0,1327973
furpa,0.125,7,7,CTGATAGAGTCGAGAGTGCT,0,1303053
furpa,0.125,7,7,CTGACGCCCTGGCTCCCATG,0,1280578
furpa,0.125,7,7,CTGACACGTGTCTAAAGCGA,0,1288468
furpa,0.125,7,7,CTGAATGCCCCCAACAAGAG,0,1339410
furpa,0.125,7,7,CTCTGGACATCGTATGGCCT,0,1307149
furpa,0.125,7,7,CTCGTGTGTGATACTCGGGG,0,1279663
furpa,0.125,7,7,CTCGGGACCGATATAGAATT,0,1316675
furpa,0.125,7,7,CTCGGCAGCCAGTCGGACAA,0,1296555
furpa,0.125,7,7,CTCCTGCAACCCGCGCATCA,0,1339546
furpa,0.125,7,7,CTCCGTGGCAGGCCTAGGTG,0,1330693
furpa,0.125,7,7,CTCCCAACGTTCCATGCTGT,0,1343439
furpa,0.125,7,7,CTCACGACTCCAGGGATCTG,0,1297232
furpa,0.125,7,7,CTATTGGCGCAACAAGGCGT,0,1302655
furpa,0.125,7,7,CTATGGAGTCAGACTGGAAA,0,1334605
furpa,0.125,7,7,CTATCGGTTTCCTCATACAC,0,1308483
furpa,0.125,7,7,CTATAATTAAATTGTGGGTT,0,1349883
furpa,0.125,7,7,CTAGTTACTCGAGGACAGTA,0,1348121
furpa,0.125,7,7,CTAGTGGTGCTACGTACACG,0,1342869
furpa,0.125,7,7,CTAGCAGAGGAATGTCGAAG,0,1347228
furpa,0.125,7,7,CTAGAGCGGGCGGACTGTAT,0,1336778
furpa,0.125,7,7,CTAGACCCACGCGACTACCA,0,1309784
furpa,0.125,7,7,CTACGCGTTTGAGAGAAGGA,0,1329518
furpa,0.125,7,7,CTACCGTGTGCAGCTGCTTA,0,1277764
furpa,0.125,7,7,CTACCGGAAAAAGTATGGCA,0,1318925
furpa,0.125,7,7,CTACCCCATTGACTACCGTA,0,1293712
furpa,0.125,7,7,CTACCAGAGGGCACGGCAAC,0,1355284
furpa,0.125,7,7,CTACAAGGTGTACCTGTCCA,0,1353180
furpa,0.125,7,7,CTAAGAAGCCGCGCCGCGCC,0,1333748
furpa,0.125,7,7,CTAAGAAAGAGATGTGCTTT,0,1319171
furpa,0.125,7,7,CTAAAAGCTGAGAGTGAGGC,0,1294327
furpa,0.125,7,7,CGTTTCACGGGTAGTAGGTC,0,1301354
furpa,0.125,7,7,CGTTGAGGCTTCGCCGTCGG,0,1321878
furpa,0.125,7,7,CGTTCTGAAGCTGAGGAGGT,0,1304436
furpa,0.125,7,7,CGTTCTACACATCCTGCGCC,0,1277690
furpa,0.125,7,7,CGTTATAAAGTTTTCGGCTG,0,1280906
furpa,0.125,7,7,CGTTACACGTTACTCCAGCA,0,1285296
furpa,0.125,7,7,CGTGTATACAAGTTAATAAT,0,1318390
furpa,0.125,7,7,CGTGCTAAAGGTAATCAGTT,0,1332070
furpa,0.125,7,7,CGTGACTGAATAAAGACGCC,0,1296189
furpa,0.125,7,7,CGTGAATAGCGAGGGGCACA,0,1295722
furpa,0.125,7,7,CGTCGTCAGCGCTGCGTGTT,0,1320126
furpa,0.125,7,7,CGTCGGAATTGGAGTAAGCT,0,1303553
furpa,0.125,7,7,CGTCAAGGCAATTGCGGCAG,0,1284661
furpa,0.125,7,7,CGTAGTTACGAAAAGTGAAG,0,1280513
furpa,0.125,7,7,CGTAGGTCCTTCCTGAAAGG,0,1345411
furpa,0.125,7,7,CGTAGGCAGACTCCAGAGAC,0,1278670
furpa,0.125,7,7,CGTAGCTACAACAAACCTCC,0,1340767
furpa,0.125,7,7,CGTAGAGGAACCTGCGGATG,0,1338132
furpa,0.125,7,7,CGTACATGGGCGAAGATCAT,0,1307178
furpa,0.125,7,7,CGTAATTAGATTTGCTTTAT,0,1356108
furpa,0.125,7,7,CGTAAAAAGGCAGTATCCAT,0,1340178
furpa,0.125,7,7,CGGTTTTTTACTTCTAGGGT,0,1356022
furpa,0.125,7,7,CGGTTATGGTGTCTGTAATA,0,1348743
furpa,0.125,7,7,CGGTATCTCTTGTTCTGCCA,0,1357155
furpa,0.125,7,7,CGGTAATCAGTAGAAACGCG,0,1271352
furpa,0.125,7,7,CGGGTATTTACATGGGGGAC,0,1301259
furpa,0.125,7,7,CGGGCACCGGTAAATCTTAT,0,1300054
furpa,0.125,7,7,CGGCAGCCCGGTTTTGCTTC,0,1348213
furpa,0.125,7,7,CGGATACTAAGGGTATGCGT,0,1346406
furpa,0.125,7,7,CGGAGAAGGGATATCGCCAA,0,1319856
furpa,0.125,7,7,CGGACAGGACCCGTGAGACA,0,1333094
furpa,0.125,7,7,CGCTTAGCGTTTTCCTTTGG,0,1331519
furpa,0.125,7,7,CGCTGGGGAGGCGGCCAATG,0,1310271
furpa,0.125,7,7,CGCTGCCTGCGAAAGGGTTA,0,1299584
furpa,0.125,7,7,CGCTGAGATAAGTGGTGCGC,0,1298856
furpa,0.125,7,7,CGCTATCCTTTGACGGGTAC,0,1312262
furpa,0.125,7,7,CGCTAGGTCTGAGGATTAAC,0,1314911
furpa,0.125,7,7,CGCTAAAAACAATGTTATAA,0,1335893
furpa,0.125,7,7,CGCGGTTGCGTTCTCGTTAT,0,1306072
furpa,0.125,7,7,CGCCTCGGACTCGGCGTAGT,0,1334921
furpa,0.125,7,7,CGCCGCTCGTGAGGAATTGA,0,1294998
furpa,0.125,7,7,CGCCGCTCCGATAAAAACCT,0,1344746
furpa,0.125,7,7,CGCCAATCTAGGCGATCGTG,0,1357509
furpa,0.125,7,7,CGCAGCCGAATCGTAGGGCA,0,1277226
furpa,0.125,7,7,CGCACAGGGGGTACTGCCCT,0,1321024
furpa,0.125,7,7,CGATTAATACAAACGGAAGT,0,1291877
furpa,0.125,7,7,CGATAGCCGTAACTGTCATT,0,1332521
furpa,0.125,7,7,CGAGTAACATGGGCCTGTGC,0,1355695
furpa,0.125,7,7,CGAGGTTATCGCATGGCCGT,0,1339538
furpa,0.125,7,7,CGAGATATGGTCGAATTAAT,0,1336210
furpa,0.125,7,7,CGACGGGTTTTGGAATGAGG,0,1322397
furpa,0.125,7,7,CGACCGCTGCTGTAAATGCA,0,1341996
furpa,0.125,7,7,CGACCCGACTGGACGCCACA,0,1285277
furpa,0.125,7,7,CGAAGTGTGAGCACTTTCAA,0,1347066
furpa,0.125,7,7,CGAAGGCCACCCCCCTATTA,0,1313989
furpa,0.125,7,7,CGAACGATAAGGCCGACGGC,0,1275784
furpa,0.125,7,7,CCTTTCTTCTATGAGGTCGG,0,1314005
furpa,0.125,7,7,CCTTTAAGGAGGTCTGCAAC,0,1281073
furpa,0.125,7,7,CCTTGGTCTAGTTTTGAATA,0,1272289
furpa,0.125,7,7,CCTTGCACAGCCCTCGGCGA,0,1283711
furpa,0.125,7,7,CCTTCTCTCCGGTTGGCGTC,0,1298713
furpa,0.125,7,7,CCTTATTGGCCCGCACGCTG,0,1330654
furpa,0.125,7,7,CCTTATGGGCATAGCGACCG,0,1300628
furpa,0.125,7,7,CCTTAGTTGACTATGCTGGT,0,1333033
furpa,0.125,7,7,CCTTAGCGACATGTGAGCGC,0,1283963
furpa,0.125,7,7,CCTTAGAGCACTTGCGTAGG,0,1343792
furpa,0.125,7,7,CCTTAAAGTGGCCTGCGGAC,0,1295176
furpa,0.125,7,7,CCTGTTAGTTCTGACTGTTA,0,1332981
furpa,0.125,7,7,CCTGTCCCGGACGCCTCGTG,0,1273913
furpa,0.125,7,7,CCTGCGTCCTAGGCCACATT,0,1339762
furpa,0.125,7,7,CCTCTGGTGTTAGAACAAAC,0,1319909
furpa,0.125,7,7,CCTCTATGTTGATCACCCCC,0,1290619
furpa,0.125,7,7,CCTCGTAGGTTCCAGAAGCC,0,1278851
furpa,0.125,7,7,CCTCGCTACCCATTGGTTCT,0,1316756
furpa,0.125,7,7,CCTCAAGAGTCCATAACGGC,0,1288970
furpa,0.125,7,7,CCTACTCGGACTCTGCGGGG,0,1293532
furpa,0.125,7,7,CCTAACAAGTTCCGCTCTAG,0,1294238
furpa,0.125,7,7,CCGTTCTGCCAACACTGGGA,0,1284356
furpa,0.125,7,7,CCGTTATTGTGTTACCTTTG,0,1288605
furpa,0.125,7,7,CCGTGGAGCATGCCCGCATC,0,1306494
furpa,0.125,7,7,CCGTGACCACCATATTAACG,0,1328814
furpa,0.125,7,7,CCGTAACAGCTGGGGATGAA,0,1304614
furpa,0.125,7,7,CCGGTGCTTTGGTAACGGAC,0,1304117
furpa,0.125,7,7,CCGGTGCTGTACTTCTAAGG,0,1323801
furpa,0.125,7,7,CCGGTAGCGGTCTCCACTAT,0,1339074
furpa,0.125,7,7,CCGGCAAGTACCATGGTGTT,0,1336253
furpa,0.125,7,7,CCGGACGGGCGAGTTCGTGG,0,1303330
furpa,0.125,7,7,CCGCTTAGGACAGGGAGATA,0,1309079
furpa,0.125,7,7,CCGCTGGCTTAACTAATAAC,0,1353369
furpa,0.125,7,7,CCGCTCTATCCAGATGTGTA,0,1300988
furpa,0.125,7,7,CCGCCGCTACGACTGCGGAT,0,1351988
furpa,0.125,7,7,CCGCCCCTTAATCGGGGTCT,0,1320052
furpa,0.125,7,7,CCGCCCACTATCAGCACGTA,0,1340488
furpa,0.125,7,7,CCGAGGGTTCGATTAAGCTA,0,1337861
furpa,0.125,7,7,CCGAATGACGTGAAGGCTCA,0,1306563
furpa,0.125,7,7,CCGAACGCTGTTTCCCTGAT,0,1338452
furpa,0.125,7,7,CCGAACGAAAGCAACGAGGT,0,1314017
furpa,0.125,7,7,CCGAAAGCCTGAAATCCTCA,0,1279039
furpa,0.125,7,7,CCCTTACTTCAGCGTATAGC,0,1356177
furpa,0.125,7,7,CCCTGTCTGGTTGACATATT,0,1333539
furpa,0.125,7,7,CCCTAGATATGGTAGCCCAA,0,1315747
furpa,0.125,7,7,CCCGCGGTGCGGGACGATTC,0,1349873
furpa,0.125,7,7,CCCCTTAAGGGGAGTAAATA,0,1298278
furpa,0.125,7,7,CCCCGAATCTTCTTTTTATC,0,1351057
furpa,0.125,7,7,CCCCATACCGACTGAGCCTG,0,1303307
furpa,0.125,7,7,CCCCAAGTATCGACAACGGA,0,1337814
furpa,0.125,7,7,CCCACTCTCTTTGATATTTT,0,1281209
furpa,0.125,7,7,CCCACGGTGGCCACATTAGT,0,1310978
furpa,0.125,7,7,CCCACAAGCCTTACAGGTGA,0,1286854
furpa,0.125,7,7,CCATTAGCTAACTGTAGGTC,0,1348808
furpa,0.125,7,7,CCATCTATTCGCAGAAAATA,0,1293288
furpa,0.125,7,7,CCATCAACAGGGTTCGGATA,0,1327308
furpa,0.125,7,7,CCATAGGACACTGAATGCCT,0,1303319
furpa,0.125,7,7,CCATAATCGCGGTCGCTAGA,0,1326877
furpa,0.125,7,7,CCAGTGGCCTGGGAGAAGTG,0,1351857
furpa,0.125,7,7,CCAGGTCTCTAGGCGTTGCG,0,1317863
furpa,0.125,7,7,CCAGGCGCGCTCTAAACTGA,0,1285339
furpa,0.125,7,7,CCAGGAGACAAGAGCGGCGT,0,1352269
furpa,0.125,7,7,CCAGCCATGGAGAACGGGGT,0,1306674
furpa,0.125,7,7,CCAGCAAACGGTTGCACAAC,0,1324688
furpa,0.125,7,7,CCACTTGCAACCTCTTCGTA,0,1304445
furpa,0.125,7,7,CCACGCACGCGGTATACCAT,0,1301934
furpa,0.125,7,7,CCACCGTAGATAAAGGGCGT,0,1336462
furpa,0.125,7,7,CCACCAAATACCGTTGTCAT,0,1316400
furpa,0.125,7,7,CCACACTGAATTTATAAGAT,0,1356040
furpa,0.125,7,7,CCAATGCCCGTAGCATCTTT,0,1332256
furpa,0.125,7,7,CCAAGCCGGGAACTGAGCCC,0,1295866
furpa,0.125,7,7,CCAAATCGAGCACTAACTCA,0,1338457
furpa,0.125,7,7,CCAAAAGGCTTACCGTTGTT,0,1289526
furpa,0.125,7,7,CATTGGTTGAATAGCCATTG,0,1298168
furpa,0.125,7,7,CATTCCGGCACCGCCCAGGG,0,1308648
furpa,0.125,7,7,CATGGACGCCAGTACCTCAT,0,1306035
furpa,0.125,7,7,CATGCTGCAAGCTCGCAGGG,0,1295084
furpa,0.125,7,7,CATGCGAGTGTACACTTCTA,0,1333168
furpa,0.125,7,7,CATGCATGAACAGCGGAGAT,0,1312306
furpa,0.125,7,7,CATGACATTCAATGATTTAA,0,1279727
furpa,0.125,7,7,CATCTTATTGCCCTGCACAT,0,1302322
furpa,0.125,7,7,CATCCGCATAAGGGACTCTG,0,1275921
furpa,0.125,7,7,CAGTCGGTAGAGGGTCCGGA,0,1272328
furpa,0.125,7,7,CAGTATGCGGAGTTTCACGT,0,1307795
furpa,0.125,7,7,CAGGTTGCCCCGTCGTTGTG,0,1336566
furpa,0.125,7,7,CAGGCGCGTAATATATGGAG,0,1302060
furpa,0.125,7,7,CAGCAAAACGTACAGAGTTT,0,1292581
furpa,0.125,7,7,CAGACTCCTGGGCACGAACA,0,1321364
furpa,0.125,7,7,CAGACGAGCGAGGGAGGATT,0,1289318
furpa,0.125,7,7,CAGAAAATGGTAGAGTCGTA,0,1271534
furpa,0.125,7,7,CACTGCAATCCTTACATTCT,0,1274866
furpa,0.125,7,7,CACTCGAGCGAGCTCCATTC,0,1284596
furpa,0.125,7,7,CACGGTAAATCCGTCGTCGG,0,1349189
furpa,0.125,7,7,CACAGTGTAAGCGGTGATCA,0,1274739
furpa,0.125,7,7,CACAATTAAAATTATCGCCC,0,1272336
furpa,0.125,7,7,CAATGCTGGTCGGTCACGGT,0,1349455
furpa,0.125,7,7,CAAGCTAATTGAGTCCAGAT,0,1285491
furpa,0.125,7,7,CAACTTTCTGACGGGATACT,0,1326930
furpa,0.125,7,7,CAACTGTTTACGGTTGGTAA,0,1340079
furpa,0.125,7,7,CAACTCGTACATCACAGACT,0,1273876
furpa,0.125,7,7,CAACTAATGCTGAGGTCAAT,0,1343355
furpa,0.125,7,7,CAACGTGGCAGGAAACCCTT,0,1276378
furpa,0.125,7,7,CAACGTCGCTGTGAAGCTAA,0,1271942
furpa,0.125,7,7,CAACGGTAGTGATTTTTTCC,0,1322476
furpa,0.125,7,7,CAACGGCTAAAAAACTTCGA,0,1313644
furpa,0.125,7,7,CAACGCACGTCCAATAGTGA,0,1349356
furpa,0.125,7,7,CAACCGGTCTAGGGGCACTA,0,1327323
furpa,0.125,7,7,CAACACAGTGATTTGAGGTG,0,1321413
furpa,0.125,7,7,CAAATTAACCGTAGAATTAA,0,1324064
furpa,0.125,7,7,CAAATACGCAATAGGCGGGG,0,1294599
furpa,0.125,7,7,CAAACGTAATTGATTCTGAC,0,1302585
furpa,0.125,7,7,ATTTTCCCTCGGGGGTAGTA,0,1294281
furpa,0.125,7,7,ATTTTACGTGTGCCAGAGTG,0,1325570
furpa,0.125,7,7,ATTTCCGGTGGTGTGAGGAG,0,1283118
furpa,0.125,7,7,ATTTAGTAATGCCAGTCCCA,0,1305027
furpa,0.125,7,7,ATTTAACGTCCGATCTCAGA,0,1308116
furpa,0.125,7,7,ATTGTGACCTCCTGGCTTCT,0,1287056
furpa,0.125,7,7,ATTGGTGAGGAAGTGATTGA,0,1338616
furpa,0.125,7,7,ATTGGATGCATGTGGCCGCG,0,1309146
furpa,0.125,7,7,ATTGCCCTCGCGAACGAGTT,0,1276689
furpa,0.125,7,7,ATTGAGACACGTATCTAAAG,0,1281728
furpa,0.125,7,7,ATTCCAGCATTGGGGTTTTA,0,1301391
furpa,0.125,7,7,ATTCATGCGTGGTTTATTCA,0,1317225
furpa,0.125,7,7,ATTCATACCCCGCGCAAGCC,0,1275717
furpa,0.125,7,7,ATTCACAAATACCTTCCATA,0,1289708
furpa,0.125,7,7,ATTATGCGCTACGGCACGTC,0,1290543
furpa,0.125,7,7,ATTAGATACCTTTCTTATAC,0,1287077
furpa,0.125,7,7,ATTAGACGTGTCAGTATATG,0,1293450
furpa,0.125,7,7,ATTACAGACAGCGGGCACCC,0,1350751
furpa,0.125,7,7,ATTAACGCGTTGAGTAGTAA,0,1277873
furpa,0.125,7,7,ATGTTACTCGGATGAGTCCT,0,1339461
furpa,0.125,7,7,ATGTGTCTGCCTTTCACGGT,0,1307881
furpa,0.125,7,7,ATGTGGCGGAATCGCATTTC,0,1315520
furpa,0.125,7,7,ATGGTACCGTCGCGGCGTGC,0,1275181
furpa,0.125,7,7,ATGGCGGGAGCTTCTTCGCC,0,1274025
furpa,0.125,7,7,ATGCTTAGGCATCGCGGTAG,0,1328640
furpa,0.125,7,7,ATGCTAGGTAGGTGGTGGGG,0,1357000
furpa,0.125,7,7,ATGCGATTTGCTAGGCCCGG,0,1297381
furpa,0.125,7,7,ATGCCCTGAGATAACCAAGG,0,1273549
furpa,0.125,7,7,ATGCATTTACGGTAAATGTT,0,1304185
furpa,0.125,7,7,ATGACATATTCGTAGGAAAG,0,1337041
furpa,0.125,7,7,ATGAAAGGATGTCCGTTGGC,0,1322768
furpa,0.125,7,7,ATCTTGGAGCCCTAATCGGG,0,1310472
furpa,0.125,7,7,ATCTTATTGGATTAGGGTGA,0,1295073
furpa,0.125,7,7,ATCGGTAAAAACTTTTTTAG,0,1317688
furpa,0.125,7,7,ATCGGGTTGGATGATAGCTA,0,1353712
furpa,0.125,7,7,ATCGATCAAGATTACTATTA,0,1312826
furpa,0.125,7,7,ATCCGACAAGTCTGGTGTAA,0,1325151
furpa,0.125,7,7,ATCATCTACAGAAGATATGC,0,1339440
furpa,0.125,7,7,ATCATAAACGCTGGCAAAGT,0,1356687
furpa,0.125,7,7,ATATTGTGATAGGGGCGCAT,0,1279330
furpa,0.125,7,7,ATATCCTCCATAGACATGTT,0,1348263
furpa,0.125,7,7,ATATCCACACACGATTCACT,0,1298716
furpa,0.125,7,7,ATATACTGCATAGTCTCACC,0,1351111
furpa,0.125,7,7,ATATACATACGTCTTGCGAG,0,1335227
furpa,0.125,7,7,ATAGTTGCACCCTCTCCCAA,0,1315052
furpa,0.125,7,7,ATAGTGCGAATCTACGTGGG,0,1332708
furpa,0.125,7,7,ATAGTCTCAATTCAGGCGTT,0,1324304
furpa,0.125,7,7,ATAGGGAATTAAGTCGCCAA,0,1337124
furpa,0.125,7,7,ATAGCTGGTAGATGCTCGAC,0,1295027
furpa,0.125,7,7,ATAGCGCCGTGACATGCATC,0,1317090
furpa,0.125,7,7,ATAGACAGGTCGTGAGGTTT,0,1332910
furpa,0.125,7,7,ATACTTTAAATTCCCGAGTA,0,1274982
furpa,0.125,7,7,ATACCCGGGACCAGGGGAGT,0,1342717
furpa,0.125,7,7,ATAATCCCGGGTTATCCTCA,0,1317874
furpa,0.125,7,7,ATAATATCGAATCGCCTCCC,0,1336203
furpa,0.125,7,7,ATAAGCACGGTCTTCACGTA,0,1298333
furpa,0.125,7,7,ATAAACGGAGGCAGGTTTCT,0,1292154
furpa,0.125,7,7,AGTTTGTCCGGCTTTGTGCG,0,1290316
furpa,0.125,7,7,AGTTCAAACGAAGTTATTGA,0,1349166
furpa,0.125,7,7,AGTTATTTATATTCCCCACA,0,1297627
furpa,0.125,7,7,AGTTATGATGATATCATGTA,0,1325702
furpa,0.125,7,7,AGTTAGATGCAACCTTCCTA,0,1313846
furpa,0.125,7,7,AGTGTATAGCTCACTTCTAC,0,1280601
furpa,0.125,7,7,AGTGGGCATTCCAGTGGACA,0,1334827
furpa,0.125,7,7,AGTGCCCCCGCGGTTGTAGT,0,1342929
furpa,0.125,7,7,AGTCCCGAGGGATCGGGACC,0,1285173
furpa,0.125,7,7,AGTCCATGATAATCGCCATC,0,1285987
furpa,0.125,7,7,AGTCAGCTTTTGTTTAGCCA,0,1273253
furpa,0.125,7,7,AGTATACTCGGCTCCGCGGT,0,1327666
furpa,0.125,7,7,AGTAACGGTGCCTCCTACCC,0,1299008
furpa,0.125,7,7,AGTAACGAGTTCAGCCCATG,0,1321557
furpa,0.125,7,7,AGGTGGTACTCAACACGCTT,0,1277114
furpa,0.125,7,7,AGGTGGAGGTTGGGTATTTG,0,1320680
furpa,0.125,7,7,AGGTCGGTTTGGTGACTTGA,0,1307558
furpa,0.125,7,7,AGGTAAGCGGTTTACCCCTC,0,1277252
furpa,0.125,7,7,AGGGTCTCAGAAGAGCGCAG,0,1302279
furpa,0.125,7,7,AGGGCGGTTATGGGAAGAAT,0,1288592
furpa,0.125,7,7,AGGGCCGCTACGCGGCCTTC,0,1274925
furpa,0.125,7,7,AGGGAGCGGTCGAGTTCAGG,0,1282713
furpa,0.125,7,7,AGGGAACCGAGAGTTTCTTT,0,1352531
furpa,0.125,7,7,AGGCGTTGCTTACTGTAGTT,0,1285479
furpa,0.125,7,7,AGGCGTCATTCTGTTGTGCC,0,1332613
furpa,0.125,7,7,AGGCCGCAGAACGAATACGG,0,1323901
furpa,0.125,7,7,AGGCAGATTACGTTAGGTAT,0,1315186
furpa,0.125,7,7,AGGCAGACCAGCATAAGGAT,0,1302792
furpa,0.125,7,7,AGGATAACACATGTGTCCTA,0,1353589
furpa,0.125,7,7,AGGAGGCGCAACCTGTGGAA,0,1293847
furpa,0.125,7,7,AGGAATTGTTTTCGAGCGAT,0,1298669
furpa,0.125,7,7,AGCTTCGACTGAGGAGGAGG,0,1298728
furpa,0.125,7,7,AGCTGTGGAGCCCGATACTC,0,1335988
furpa,0.125,7,7,AGCTCGGAAAGTATTCCGAA,0,1328796
furpa,0.125,7,7,AGCTATTGTCTAGGGAGGGA,0,1305940
furpa,0.125,7,7,AGCGTACCAATTATCGTTTG,0,1298465
furpa,0.125,7,7,AGCGTAAGAACTTCATTGAG,0,1287189
furpa,0.125,7,7,AGCGGGGAGTACGCCAATTG,0,1319209
furpa,0.125,7,7,AGCGGGACTCCTCACTGGTC,0,1346034
furpa,0.125,7,7,AGCGCGCTGTGTCAACTTTC,0,1321266
furpa,0.125,7,7,AGCGAGCCCGACTCATACGA,0,1275785
furpa,0.125,7,7,AGCATGGGGATCGTGTGGTC,0,1356929
furpa,0.125,7,7,AGCATAACTGTTTTGTTGAG,0,1305033
furpa,0.125,7,7,AGCAGTTTTGTAAGACTGCG,0,1324303
furpa,0.125,7,7,AGCAGACAACCATACACATC,0,1307986
furpa,0.125,7,7,AGCAGAAGTAGAGGTGATCA,0,1337325
furpa,0.125,7,7,AGCAACTTGCTGTTCATTAG,0,1343222
furpa,0.125,7,7,AGATACTTTTTGGTTTAATC,0,1330554
furpa,0.125,7,7,AGAGTTTACCGACCTTCTTG,0,1348218
furpa,0.125,7,7,AGAGTCTAGATCGAGGACGG,0,1337008
furpa,0.125,7,7,AGAGATCAGCTCCCTCATCC,0,1326914
furpa,0.125,7,7,AGAGAGTTTTCCTGCTTAGC,0,1286672
furpa,0.125,7,7,AGACCGACGTGTAGGCCGGG,0,1318233
furpa,0.125,7,7,AGACAGAGTACTTCTGAATC,0,1287425
furpa,0.125,7,7,AGACAAGCTTGTAATCAAGG,0,1351679
furpa,0.125,7,7,AGAATTTCGGTGTTGTAAGC,0,1280368
furpa,0.125,7,7,AGAAGAGTGGACATCGGCAA,0,1308926
furpa,0.125,7,7,AGAAAAGATTCATGCGCCCT,0,1349430
furpa,0.125,7,7,ACTTGTTAATCAAAATGGCC,0,1320866
furpa,0.125,7,7,ACTTGCTCGCAGCTAATTAA,0,1340926
furpa,0.125,7,7,ACTGTGTCCCCCCCTGGGAT,0,1337919
furpa,0.125,7,7,ACTGTCTATCAGGAAGCCAC,0,1285510
furpa,0.125,7,7,ACTGTAGTGACCCAGCAACA,0,1334405
furpa,0.125,7,7,ACTGGTTGTTCCCAGGTCAC,0,1307406
furpa,0.125,7,7,ACTGGGTCCAGGACGATCCG,0,1347258
furpa,0.125,7,7,ACTCTCGCCACGCCATAGGA,0,1350975
furpa,0.125,7,7,ACTCGCTTGGTGAGCGGGTG,0,1334180
furpa,0.125,7,7,ACTCCTATAGCTTAATATTA,0,1347914
furpa,0.125,7,7,ACTATAAAACTCGCTGTAGA,0,1273727
furpa,0.125,7,7,ACTAAGGGACACGCGGTATA,0,1291694
furpa,0.125,7,7,ACGTTGGGCACAACGAGTGA,0,1347489
furpa,0.125,7,7,ACGTGCCGCCCCTACCTTAC,0,1293896
furpa,0.125,7,7,ACGTACACACTGCTGTAATG,0,1310798
furpa,0.125,7,7,ACGGTGCGGCTAGCATTGTG,0,1290924
furpa,0.125,7,7,ACGGTGATCGGTGCACAAGG,0,1286233
furpa,0.125,7,7,ACGGCGAGACAGAAAAGGCA,0,1323389
furpa,0.125,7,7,ACGCTTGCCTCAGGAGTTGC,0,1274822
furpa,0.125,7,7,ACGCTTCTTAACTGTCGTCG,0,1329942
furpa,0.125,7,7,ACGCGCGGAACGCATAAAGA,0,1320456
furpa,0.125,7,7,ACGCCAGGCCGGTAAGGCGG,0,1286932
furpa,0.125,7,7,ACGATCGGCATAGGAGCTCG,0,1323798
furpa,0.125,7,7,ACGATACCGTAGCAACCCTG,0,1332672
furpa,0.125,7,7,ACCTTATTTTATGCGACATT,0,1344508
furpa,0.125,7,7,ACCTTATATGAGCGGGACCA,0,1311457
furpa,0.125,7,7,ACCTGCTCACCGGTGGACAG,0,1314622
furpa,0.125,7,7,ACCGGAGGCTCGCGTGCCTA,0,1333953
furpa,0.125,7,7,ACCGAGTATTTCGATTTCGT,0,1308802
furpa,0.125,7,7,ACCATCTAGGCCGTATACAT,0,1321324
furpa,0.125,7,7,ACCACCTTTTGAGCCCAATC,0,1350274
furpa,0.125,7,7,ACATTTTTGTTCTCCCCGCG,0,1291644
furpa,0.125,7,7,ACATTTGCACTAGATCAGGA,0,1339619
furpa,0.125,7,7,ACATTCCAGGGGGCACTGTA,0,1337308
furpa,0.125,7,7,ACATGTTGCCCGGGCTTATG,0,1278979
furpa,0.125,7,7,ACATGCCTCCCACAAAATCG,0,1300989
furpa,0.125,7,7,ACATCCCGACTCGGACTTGA,0,1347079
furpa,0.125,7,7,ACAGGTAACAAGCATGAGGA,0,1281349
furpa,0.125,7,7,ACAGATTCGCATCGCGGCCT,0,1308306
furpa,0.125,7,7,ACACCTCTAGCCACCCGAGG,0,1315572
furpa,0.125,7,7,ACACACTACTACATACTCTC,0,1341678
furpa,0.125,7,7,ACACAATACACATGGCGTAA,0,1290430
furpa,0.125,7,7,ACAAGTCCATAGGAAGTTTG,0,1352337
furpa,0.125,7,7,AATTTTTAGGTAGGTGTTGT,0,1307965
furpa,0.125,7,7,AATTTGGGCCGCGTAAAGGA,0,1304727
furpa,0.125,7,7,AATTGCTAAGACGCGGCTGA,0,1343292
furpa,0.125,7,7,AATGCGCGCACGATTATCTT,0,1342489
furpa,0.125,7,7,AATGAAAGTGGGTCCCCCCC,0,1303185
furpa,0.125,7,7,AATCTGACGCGGTTAGTCAG,0,1321874
furpa,0.125,7,7,AATCGTGATGGAATTTAACG,0,1350142
furpa,0.125,7,7,AATCGTAGGCCATGGCCGGT,0,1297011
furpa,0.125,7,7,AATCATCTATCATAAGCTCT,0,1283552
furpa,0.125,7,7,AATATGTGAAGGACAACAGG,0,1284185
furpa,0.125,7,7,AATAGGTGGGGCATGTGAAA,0,1283575
furpa,0.125,7,7,AATACTAAGTAAGGGAACCC,0,1321924
furpa,0.125,7,7,AATAATCGTGACCGAGGTGC,0,1272183
furpa,0.125,7,7,AATAAGTAAAGTTTGTGGGT,0,1287793
furpa,0.125,7,7,AAGTTCTTTGTATGCCCGTT,0,1333176
furpa,0.125,7,7,AAGTTCTACGGTGTGTCGTT,0,1349175
furpa,0.125,7,7,AAGTTCCCACAATTTCATTG,0,1329913
furpa,0.125,7,7,AAGTGTTGTCGGCATAGTGG,0,1327464
furpa,0.125,7,7,AAGTCCCGCAGGGAAATTGC,0,1310104
furpa,0.125,7,7,AAGTAATTGCCCAAAGCTAA,0,1287832
furpa,0.125,7,7,AAGGTTGAATGAATGCACTG,0,1322531
furpa,0.125,7,7,AAGGCCCATCTGTTAAGTCC,0,1296935
furpa,0.125,7,7,AAGAGTTCCTGGTGCTCACA,0,1294948
furpa,0.125,7,7,AAGAGTACCTCTTGAATCTC,0,1324015
furpa,0.125,7,7,AAGAGCTATGTAGATGTCAA,0,1323969
furpa,0.125,7,7,AAGACCGTCATGCGCTGGAG,0,1321493
furpa,0.125,7,7,AAGACCATAAGATAGCTGAT,0,1291776
furpa,0.125,7,7,AAGAATGTGACACCTTCTAC,0,1310607
furpa,0.125,7,7,AACTGCAATATTGGTTAAGT,0,1317894
furpa,0.125,7,7,AACTCGGATGGGTCTATCAA,0,1311845
furpa,0.125,7,7,AACTCGCTGCAAAATTGTGA,0,1289675
furpa,0.125,7,7,AACTCATTCGATTTGGGCCT,0,1316988
furpa,0.125,7,7,AACTCACACGATACTTGGGA,0,1320858
furpa,0.125,7,7,AACTAGGGCGACCCGCCAAC,0,1283066
furpa,0.125,7,7,AACTACGAGTGTAGTAAATA,0,1323833
furpa,0.125,7,7,AACGTCTAGTCGGGCGAACG,0,1305408
furpa,0.125,7,7,AACGGGCTGAGTATCAGGTG,0,1315189
furpa,0.125,7,7,AACGGACAGTGTTACTTTAT,0,1282105
furpa,0.125,7,7,AACGCGTGAAGAAGGGACCG,0,1321735
furpa,0.125,7,7,AACGCCACGCGTAATTTCCG,0,1328619
furpa,0.125,7,7,AACCTTTTCATACCCCAACA,0,1316224
furpa,0.125,7,7,AACCTTAGGCGTAAATCCTG,0,1291213
furpa,0.125,7,7,AACCTCGCAAGTCCGATCCC,0,1314700
furpa,0.125,7,7,AACCGAGCCCATTACTCGTG,0,1299256
furpa,0.125,7,7,AACCCTTATAATTTGCCAGG,0,1308829
furpa,0.125,7,7,AACCCGCGCCATCTGGACAA,0,1292291
furpa,0.125,7,7,AACCCGAGGACCTCCACGAA,0,1342880
furpa,0.125,7,7,AACCAAACTCCCTGAACGGC,0,1339035
furpa,0.125,7,7,AACATGCCCACAAAAAGTGT,0,1329842
furpa,0.125,7,7,AACAGGCAGAGTTATCGAAA,0,1339608
furpa,0.125,7,7,AACACTCCTCCTATTAGGGA,0,1281274
furpa,0.125,7,7,AACACCCGATATCTACTTAT,0,1320834
furpa,0.125,7,7,AACACCATCAGTACGTGTAT,0,1318487
furpa,0.125,7,7,AACAATGCCCAATCGCTTTG,0,1275592
furpa,0.125,7,7,AAATTTACCTCGACCAATCA,0,1299920
furpa,0.125,7,7,AAATCCTCGTTGAATTAATA,0,1293390
furpa,0.125,7,7,AAATATCAATTGGTACAACC,0,1280817
furpa,0.125,7,7,AAAGGGAGGGTTCCCACGCA,0,1349050
furpa,0.125,7,7,AAACGTTTAGTACAACGTCA,0,1336604
furpa,0.125,7,7,AAACGATCCGCTACGGCTAC,0,1314382
furpa,0.125,7,7,AAACCTCTGATGCCAGCTCG,0,1276064
furpa,0.125,7,7,AAACCCTGCCTTCCTATTGC,0,1285038
furpa,0.125,7,7,AAACCCGTTCTGGTGTCCCT,0,1287152
furpa,0.125,7,7,AAACACATACGCCAGAATGA,0,1339445
furpa,0.125,7,7,AAAATTAGAGTCCCTTAGCT,0,1297037
furpa,0.125,7,7,AAAAGTCTTGTCGGCCTTTC,0,1272671
furpa,0.125,7,7,AAAAGCCGTAGCGCATTCGA,0,1344692
furpa,0.125,7,7,AAAACGGTGACGGACTAATT,0,1332684
furpa,0.125,7,7,AAAAATATAATTGTTGCCAA,0,1338655
furpa,0.14285714285714285,6,6,TTTTTGGTGATTTGCAGCCG,0,1294618
furpa,0.14285714285714285,6,6,TTTTGGTTAGCAGAGGTGGA,0,1323828
furpa,0.14285714285714285,6,6,TTTTGCCACCGTGTCCTTGG,0,1300985
furpa,0.14285714285714285,6,6,TTTTCTGAGGTAAGTTCATG,0,1281587
furpa,0.14285714285714285,6,6,TTTTCGTTCGTGGGGCGTAC,0,1292326
furpa,0.14285714285714285,6,6,TTTTCGGTAACCAGAGGTAA,0,1294023
furpa,0.14285714285714285,6,6,TTTTAAGTCCGTTCTCTAAT,0,1343755
furpa,0.14285714285714285,6,6,TTTGTGTTTTTGGCACCGTA,0,1318577
furpa,0.14285714285714285,6,6,TTTGGAAGCGTGGATACTGC,0,1276537
furpa,0.14285714285714285,6,6,TTTGCCCCGCCGAAGCTTCT,0,1325966
furpa,0.14285714285714285,6,6,TTTGCACATCCTGGGAGAAG,0,1279323
furpa,0.14285714285714285,6,6,TTTGAAACGCAGTACATTGA,0,1280910
furpa,0.14285714285714285,6,6,TTTCGACTAAGTGACGCGCA,0,1287008
furpa,0.14285714285714285,6,6,TTTATCACACTCGTGACCCC,0,1293465
furpa,0.14285714285714285,6,6,TTTAGGGACGGCTTCGTTAT,0,1331170
furpa,0.14285714285714285,6,6,TTTAGCATCGCTCGTATCCA,0,1303270
furpa,0.14285714285714285,6,6,TTTACTGGAACACCCACTCT,0,1280202
furpa,0.14285714285714285,6,6,TTTACGGAGCCCCATTGTGA,0,1287400
furpa,0.14285714285714285,6,6,TTTACGCGCGCCTTATGAAG,0,1271422
furpa,0.14285714285714285,6,6,TTTAAATAGGCCCAGACCTT,0,1298289
furpa,0.14285714285714285,6,6,TTGTTTCGTAGAAACTGCTC,0,1349326
furpa,0.14285714285714285,6,6,TTGTTCGTCCCCAATCTACG,0,1344965
furpa,0.14285714285714285,6,6,TTGTTATGGCGGCTTCGTTA,0,1284643
furpa,0.14285714285714285,6,6,TTGTCTGCGGAAGAATCTGA,0,1279398
furpa,0.14285714285714285,6,6,TTGTATTGTGTTCCTTAATC,0,1325023
furpa,0.14285714285714285,6,6,TTGGTTCTGTGTTGACCATG,0,1302197
furpa,0.14285714285714285,6,6,TTGGTTACGAGTATGCAAGG,0,1297858
furpa,0.14285714285714285,6,6,TTGGGCAGACGGTCGAGAGT,0,1334043
furpa,0.14285714285714285,6,6,TTGGGATTTGCCGCGAGCGA,0,1321893
furpa,0.14285714285714285,6,6,TTGGCTGAGGGGCTAACTTC,0,1276452
furpa,0.14285714285714285,6,6,TTGGCGTCCGCAATGCTCAA,0,1355587
furpa,0.14285714285714285,6,6,TTGCGGCCCCTTGAAGTACT,0,1310531
furpa,0.14285714285714285,6,6,TTGCGGAGTACGCTAAGTCC,0,1331527
furpa,0.14285714285714285,6,6,TTGCCCTAGGCTAGAGCGGG,0,1344383
furpa,0.14285714285714285,6,6,TTGCAGAGTAAATGTTGGGA,0,1329090
furpa,0.14285714285714285,6,6,TTGAGTTCATTCTACATGAG,0,1287006
furpa,0.14285714285714285,6,6,TTGAGTCCCTGCTCCATAAA,0,1293982
furpa,0.14285714285714285,6,6,TTGACAAGGGACGGGCGAGC,0,1353367
furpa,0.14285714285714285,6,6,TTCTTTCGGAGACGTTGCCG,0,1295894
furpa,0.14285714285714285,6,6,TTCTTTCCTTAGTAGGTGAA,0,1283052
furpa,0.14285714285714285,6,6,TTCTTCAGGAGAGGACGGAC,0,1353443
furpa,0.14285714285714285,6,6,TTCTCTACAGTGCCTATGGT,0,1347088
furpa,0.14285714285714285,6,6,TTCTAAACCACAGACTGTAG,0,1308982
furpa,0.14285714285714285,6,6,TTCGCGGATCCAAGACGTTA,0,1340602
furpa,0.14285714285714285,6,6,TTCGCGAGAGTTCGCGAGCG,0,1277195
furpa,0.14285714285714285,6,6,TTCGATGGGTAGGAATAGCG,0,1290541
furpa,0.14285714285714285,6,6,TTCGAGCCACACGTCATCTA,0,1350497
furpa,0.14285714285714285,6,6,TTCCTTGGTGCATCGGATGA,0,1342879
furpa,0.14285714285714285,6,6,TTCCTCTTAGTGAGGTGCTT,0,1341027
furpa,0.14285714285714285,6,6,TTCCTCTATCGGACGCCATC,0,1321177
furpa,0.14285714285714285,6,6,TTCCTAAGTACCGCCACGAG,0,1296614
furpa,0.14285714285714285,6,6,TTCCTAACGTAAGCCCTAAT,0,1306964
furpa,0.14285714285714285,6,6,TTCCCGCTGTGTAGAACGAC,0,1304393
furpa,0.14285714285714285,6,6,TTCCCCAGGGCCGTGAGGGG,0,1331076
furpa,0.14285714285714285,6,6,TTCCATAGGGATGGCCGGGC,0,1286473
furpa,0.14285714285714285,6,6,TTCATGTGGGTGAGGCAGGT,0,1353522
furpa,0.14285714285714285,6,6,TTCAGCTTTTGGGACATGTT,0,1316345
furpa,0.14285714285714285,6,6,TTCAGCTTGAAGACCTCCTC,0,1325384
furpa,0.14285714285714285,6,6,TTCACGTTTACGCTCCATAC,0,1274599
furpa,0.14285714285714285,6,6,TTCACCTACGTTAAGAGACG,0,1273567
furpa,0.14285714285714285,6,6,TTCACAATCTACACTAGAAC,0,1302822
furpa,0.14285714285714285,6,6,TTCAAGAGGATCCCCGCATC,0,1286099
furpa,0.14285714285714285,6,6,TTATTTTTAACAGATGGACA,0,1339001
furpa,0.14285714285714285,6,6,TTATCGGGGCCTATCCATTC,0,1294491
furpa,0.14285714285714285,6,6,TTAGGGTGGGGTGGAACGGG,0,1344413
furpa,0.14285714285714285,6,6,TTAGCCTTATCTCTCAGCCA,0,1325537
furpa,0.14285714285714285,6,6,TTAGAGGCCCAGGACACCCT,0,1355024
furpa,0.14285714285714285,6,6,TTAGAGACGGTACATTTCCT,0,1350764
furpa,0.14285714285714285,6,6,TTACCCGATGCAGGTCCCAA,0,1342219
furpa,0.14285714285714285,6,6,TTACAATGGATGTGGTATGC,0,1319053
furpa,0.14285714285714285,6,6,TTAAGTCGTGTCGTGGGTAA,0,1286853
furpa,0.14285714285714285,6,6,TGTTATAAATATCAGGTTAA,0,1306162
furpa,0.14285714285714285,6,6,TGTGTATCCATTAGCGGAGA,0,1322498
furpa,0.14285714285714285,6,6,TGTGCCAACTTGTTTGTACG,0,1274938
furpa,0.14285714285714285,6,6,TGTGACATAAATCCTAACGT,0,1318598
furpa,0.14285714285714285,6,6,TGTCCCGTTTCTAGATAACA,0,1300341
furpa,0.14285714285714285,6,6,TGTATTCGGGTCAAATGCGC,0,1302967
furpa,0.14285714285714285,6,6,TGTAAGTCGATGTCCACGAC,0,1357249
furpa,0.14285714285714285,6,6,TGTAAGGGAGTCCGTCTTAC,0,1285631
furpa,0.14285714285714285,6,6,TGGTTCTCTGGTACTCGACT,0,1291284
furpa,0.14285714285714285,6,6,TGGTGACGTCCCACCCTTCA,0,1323965
furpa,0.14285714285714285,6,6,TGGTCACTGCTCGCGTTCCA,0,1349933
furpa,0.14285714285714285,6,6,TGGTCACTCGAACTACCCCA,0,1311434
furpa,0.14285714285714285,6,6,TGGTCACATCTCGACATTCT,0,1339806
furpa,0.14285714285714285,6,6,TGGTATGCTTAAATCCGTTT,0,1301711
furpa,0.14285714285714285,6,6,TGGTATCGCTAACGGGCACA,0,1325465
furpa,0.14285714285714285,6,6,TGGGTTAGATCCCTTTACCG,0,1323699
furpa,0.14285714285714285,6,6,TGGGAGGGGAGTATCATGCT,0,1298155
furpa,0.14285714285714285,6,6,TGGGACGAATGGAGCCTCCG,0,1285041
furpa,0.14285714285714285,6,6,TGGGACACGGCTTATACGCT,0,1289317
furpa,0.14285714285714285,6,6,TGGCCAGGTAGAACTGGCTT,0,1314458
furpa,0.14285714285714285,6,6,TGGCAGCGGGGTCGATGGTC,0,1271188
furpa,0.14285714285714285,6,6,TGGCACGACTAGCGCCGGTG,0,1290698
furpa,0.14285714285714285,6,6,TGGATGCAGCCATGAAACAA,0,1355257
furpa,0.14285714285714285,6,6,TGGATCGTACGGGTGGGTGG,0,1328750
furpa,0.14285714285714285,6,6,TGGATAAACGTCGACAAGAC,0,1318973
furpa,0.14285714285714285,6,6,TGGAATACGGCACACACCAC,0,1281088
furpa,0.14285714285714285,6,6,TGGAAGTCGTTGTACCGGCA,0,1277133
furpa,0.14285714285714285,6,6,TGGAACTCAGATTATCATCA,0,1311624
furpa,0.14285714285714285,6,6,TGCTTTAATGACAAGTGATA,0,1286050
furpa,0.14285714285714285,6,6,TGCGAGCTCGCCAAGGCAAG,0,1281783
furpa,0.14285714285714285,6,6,TGCCTACGTCTGTCGCAGTT,0,1277087
furpa,0.14285714285714285,6,6,TGCCCGGTACAATTCGATGT,0,1301352
furpa,0.14285714285714285,6,6,TGCATGTCTTAGGGTAGGCT,0,1307814
furpa,0.14285714285714285,6,6,TGCACACAAGTCATGCAGCG,0,1318600
furpa,0.14285714285714285,6,6,TGCAACTTAAATACTTAATA,0,1351688
furpa,0.14285714285714285,6,6,TGATTGTCAACTAGGTCGAG,0,1273456
furpa,0.14285714285714285,6,6,TGATTCTACGTAGGATCCGC,0,1306919
furpa,0.14285714285714285,6,6,TGATCGACCCGAAAACTGGG,0,1317302
furpa,0.14285714285714285,6,6,TGATCAATTTGATAGTGGTG,0,1306802
furpa,0.14285714285714285,6,6,TGAGTCTCGACGGTTATTGT,0,1295133
furpa,0.14285714285714285,6,6,TGAGCCAGTGATAGACCCCT,0,1290199
furpa,0.14285714285714285,6,6,TGACTTTGAACACCATGGCC,0,1316254
furpa,0.14285714285714285,6,6,TGACTGTTTTGCCCGAGTCA,0,1320822
furpa,0.14285714285714285,6,6,TGACGGCAAGCGATGTTCGC,0,1354696
furpa,0.14285714285714285,6,6,TGACAGATCTTTCGTAGATA,0,1320468
furpa,0.14285714285714285,6,6,TGAATCGGGTCCAGAATCGG,0,1298354
furpa,0.14285714285714285,6,6,TGAAGGAAGTGCTTGCTTCT,0,1332394
furpa,0.14285714285714285,6,6,TGAACATAGCGGTTAGCCAA,0,1355713
furpa,0.14285714285714285,6,6,TGAAATTGAACGACATCCCA,0,1302921
furpa,0.14285714285714285,6,6,TCTTTCTAAAATGAAGTCAA,0,1335600
furpa,0.14285714285714285,6,6,TCTTGCTTGTCTCGTAATTA,0,1289955
furpa,0.14285714285714285,6,6,TCTTGACATGGGTCTTCTTT,0,1294832
furpa,0.14285714285714285,6,6,TCTTCCTCAGGAATTTGGAG,0,1272827
furpa,0.14285714285714285,6,6,TCTTATGAGGTAATACCGAA,0,1311651
furpa,0.14285714285714285,6,6,TCTTACTAGAGCTGAAAAAG,0,1331862
furpa,0.14285714285714285,6,6,TCTTAAGTTATTCTTCATGG,0,1303862
furpa,0.14285714285714285,6,6,TCTGTTAATTTAAGAGAGAT,0,1319617
furpa,0.14285714285714285,6,6,TCTGCTTGAGAGTCGCGCTG,0,1342169
furpa,0.14285714285714285,6,6,TCTCTGGCACTATAGCTCAT,0,1318955
furpa,0.14285714285714285,6,6,TCTATACTGGTTTCCAATTT,0,1338941
furpa,0.14285714285714285,6,6,TCTAGGTTACGTGCCAATTG,0,1309988
furpa,0.14285714285714285,6,6,TCTAGAACGCATCGCGGTGG,0,1294399
furpa,0.14285714285714285,6,6,TCTACGTCTAAACGAGAAAT,0,1274705
furpa,0.14285714285714285,6,6,TCGTGGCCAACAGTTTCGTA,0,1313132
furpa,0.14285714285714285,6,6,TCGTATTGCCACACTGTACA,0,1317359
furpa,0.14285714285714285,6,6,TCGGTTGCCCAGGATGTTAG,0,1329609
furpa,0.14285714285714285,6,6,TCGGTATCACACAGTTTTTC,0,1308612
furpa,0.14285714285714285,6,6,TCGGCGTGTTAATCTGCTTA,0,1333326
furpa,0.14285714285714285,6,6,TCGGCCACGATTGCTTGACT,0,1309248
furpa,0.14285714285714285,6,6,TCGCGAGATCTAGTTAGACA,0,1310944
furpa,0.14285714285714285,6,6,TCGATGTTGCGCCCAATATA,0,1302605
furpa,0.14285714285714285,6,6,TCGATGGGGAGAGGCGTGTC,0,1273849
furpa,0.14285714285714285,6,6,TCGATCGCGTCAGCAGTATC,0,1276974
furpa,0.14285714285714285,6,6,TCGATCATGAGGAATGAGAC,0,1357720
furpa,0.14285714285714285,6,6,TCGATATTCATAAAGAAGCT,0,1346784
furpa,0.14285714285714285,6,6,TCGATAACATATTTACGCAA,0,1348073
furpa,0.14285714285714285,6,6,TCGAGGCCGTTGACCTGGAA,0,1286680
furpa,0.14285714285714285,6,6,TCGACGGGTGCGGTCCATAT,0,1348432
furpa,0.14285714285714285,6,6,TCGACGATATCGAGTCGAGT,0,1308870
furpa,0.14285714285714285,6,6,TCGACCCCGCCGGATTCGTA,0,1311699
furpa,0.14285714285714285,6,6,TCGACATTCGTTCCCTCAGA,0,1326596
furpa,0.14285714285714285,6,6,TCCTTCACATTCGCGGAAGC,0,1350808
furpa,0.14285714285714285,6,6,TCCTGCTCAAAGCCGTGGTC,0,1310913
furpa,0.14285714285714285,6,6,TCCTCCTGATGGGCACTGGG,0,1275076
furpa,0.14285714285714285,6,6,TCCTCCCTTGGAGGGCATAG,0,1330839
furpa,0.14285714285714285,6,6,TCCTATAACCCGCAGCCAGT,0,1272188
furpa,0.14285714285714285,6,6,TCCTAAAGGTTAGCAGAGGC,0,1349983
furpa,0.14285714285714285,6,6,TCCGTTTCTTATCTCCATAC,0,1303048
furpa,0.14285714285714285,6,6,TCCGTATTTGCGCTGAGTTA,0,1291137
furpa,0.14285714285714285,6,6,TCCGTACGTATTAAGTCCGT,0,1315926
furpa,0.14285714285714285,6,6,TCCGGGAAAAACGGAAGCTC,0,1330745
furpa,0.14285714285714285,6,6,TCCGGAGGAATGTTTTCTCC,0,1318055
furpa,0.14285714285714285,6,6,TCCGCCTCCAGTGGACCCGT,0,1277035
furpa,0.14285714285714285,6,6,TCCGATATAGCTCTGAACCG,0,1338940
furpa,0.14285714285714285,6,6,TCCGAGGTACACCGATCGAT,0,1276175
furpa,0.14285714285714285,6,6,TCCGACAGCGGTTTTCTCAC,0,1272496
furpa,0.14285714285714285,6,6,TCCCTAGCGCAAAGCCCATA,0,1356581
furpa,0.14285714285714285,6,6,TCCCGACATCGGGGTCACTT,0,1284314
furpa,0.14285714285714285,6,6,TCCCAACTGGGCACCTACAG,0,1343408
furpa,0.14285714285714285,6,6,TCATTTGGCCAGCACTTTGC,0,1296463
furpa,0.14285714285714285,6,6,TCATTCTATAACCGTACCGG,0,1273770
furpa,0.14285714285714285,6,6,TCATGGACGTATATCGGCGA,0,1315675
furpa,0.14285714285714285,6,6,TCATCTTGCGCTTCTATAGG,0,1347021
furpa,0.14285714285714285,6,6,TCATCCGGACTGGGTCTTCT,0,1325157
furpa,0.14285714285714285,6,6,TCAGGTGCGGAAGCACTTCA,0,1290070
furpa,0.14285714285714285,6,6,TCAGGGCGCAAAAGCCTGGA,0,1329421
furpa,0.14285714285714285,6,6,TCAGGCGCATAGAAATTCTG,0,1284177
furpa,0.14285714285714285,6,6,TCAGATTGTTGGCGACTTGG,0,1306001
furpa,0.14285714285714285,6,6,TCAGATGATGTGTTACGGTG,0,1355197
furpa,0.14285714285714285,6,6,TCACGGTTAACCGAAATAAG,0,1294243
furpa,0.14285714285714285,6,6,TCACGGTCGTTATCCACGAT,0,1316596
furpa,0.14285714285714285,6,6,TCACGGCCTGGGCTAAACGA,0,1308216
furpa,0.14285714285714285,6,6,TCACGCCTTTAGCCCGAATA,0,1341860
furpa,0.14285714285714285,6,6,TCACCTTTTTACATGTACAT,0,1293121
furpa,0.14285714285714285,6,6,TCACAGCGCATGCAAGGGTC,0,1272324
furpa,0.14285714285714285,6,6,TCACACGATGTTTCCACCGT,0,1276625
furpa,0.14285714285714285,6,6,TCAACGGTGGATTTTGTAAA,0,1289633
furpa,0.14285714285714285,6,6,TCAAAGCATCCAGTCTGGGT,0,1271189
furpa,0.14285714285714285,6,6,TCAAAAATGGTGCCTCCACA,0,1331022
furpa,0.14285714285714285,6,6,TATTGGAGCTCCCGTGTCAC,0,1315775
furpa,0.14285714285714285,6,6,TATTCTGTGTACATCGTCGG,0,1274449
furpa,0.14285714285714285,6,6,TATTCATTATGTAAATTTTT,0,1322034
furpa,0.14285714285714285,6,6,TATTAGGTACTCTGAGGATG,0,1313304
furpa,0.14285714285714285,6,6,TATTAGGCTTTCTTGTTTGT,0,1276481
furpa,0.14285714285714285,6,6,TATTAGCTGGAACGTGGCCC,0,1309189
furpa,0.14285714285714285,6,6,TATGTGGAGCGAGGTCATGG,0,1337607
furpa,0.14285714285714285,6,6,TATGCATCTGGTAATTCAAG,0,1310348
furpa,0.14285714285714285,6,6,TATCTCATAGTATTGGTTGC,0,1337716
furpa,0.14285714285714285,6,6,TATCCTTGGATTGCCGTCAG,0,1295707
furpa,0.14285714285714285,6,6,TATCAAGACATCGACCAGAG,0,1292318
furpa,0.14285714285714285,6,6,TATAATTCTGGTCTACAAAA,0,1302661
furpa,0.14285714285714285,6,6,TAGGTACTGTGTATCGTTGT,0,1273836
furpa,0.14285714285714285,6,6,TAGGCGCGTAATTTGTGTTT,0,1316478
furpa,0.14285714285714285,6,6,TAGGCACTCAAATTTTTCAG,0,1278110
furpa,0.14285714285714285,6,6,TAGCGGATATGTTTAGACGA,0,1330507
furpa,0.14285714285714285,6,6,TAGCAGCACCCAAGAACGTC,0,1296006
furpa,0.14285714285714285,6,6,TAGAGATACTCGTACCACCA,0,1286137
furpa,0.14285714285714285,6,6,TAGAAGATGCTGGGGAAGTT,0,1352724
furpa,0.14285714285714285,6,6,TACTGGAGCACACACGGGCA,0,1328832
furpa,0.14285714285714285,6,6,TACTATCAACTGACCTTAGA,0,1294193
furpa,0.14285714285714285,6,6,TACTATATAAGGGTTAGTTG,0,1274401
furpa,0.14285714285714285,6,6,TACGGGGGGCAGGTGTGTGC,0,1314682
furpa,0.14285714285714285,6,6,TACGGGGGCGCAACCGAGTC,0,1298530
furpa,0.14285714285714285,6,6,TACGGCCCATTACATGCCTT,0,1310530
furpa,0.14285714285714285,6,6,TACGGAAATTTAAAGTGCTG,0,1295289
furpa,0.14285714285714285,6,6,TACGAGTACTTTATGAGAAG,0,1339499
furpa,0.14285714285714285,6,6,TACAGGAAAACTATGGGTAC,0,1321672
furpa,0.14285714285714285,6,6,TACAGCGGTTTAGGCTCTTG,0,1338273
furpa,0.14285714285714285,6,6,TACAGCGGTATCACATAGAG,0,1302676
furpa,0.14285714285714285,6,6,TACACTCACTGGCAAAGTTG,0,1314663
furpa,0.14285714285714285,6,6,TACACGACCGCCTCGTACAT,0,1332984
furpa,0.14285714285714285,6,6,TACACAGTATCATGGCGAGT,0,1276292
furpa,0.14285714285714285,6,6,TAATTCATATGTTGTAAGGT,0,1287876
furpa,0.14285714285714285,6,6,TAATGTCCTTGGTATGCGAA,0,1324837
furpa,0.14285714285714285,6,6,TAATGCGTACAGACAGCGTA,0,1333810
furpa,0.14285714285714285,6,6,TAATCTCTTTCTTTACCGGA,0,1343001
furpa,0.14285714285714285,6,6,TAAGTTCCTCGTGCTCAAAT,0,1334457
furpa,0.14285714285714285,6,6,TAAGTAGCGTTAGGTGGCCT,0,1300804
furpa,0.14285714285714285,6,6,TAAGCTAACCTTTAAATCGT,0,1330059
furpa,0.14285714285714285,6,6,TAACTGTGCAGAAGTTCGGC,0,1339210
furpa,0.14285714285714285,6,6,TAACGTGTGGTCCCCTCACG,0,1274260
furpa,0.14285714285714285,6,6,TAACGTGCCCGTTAAGCCCG,0,1340514
furpa,0.14285714285714285,6,6,TAACGAATATTCTTGTATGT,0,1283345
furpa,0.14285714285714285,6,6,TAACCTGTCGTCGCGCGGGA,0,1285182
furpa,0.14285714285714285,6,6,TAACATGGTGATGTAGGGAA,0,1280191
furpa,0.14285714285714285,6,6,TAAATCACACCGTTGCTATG,0,1323359
furpa,0.14285714285714285,6,6,GTTTTAAAATGCTGTTAAGG,0,1287744
furpa,0.14285714285714285,6,6,GTTTCGCCAACGCTGTTTAC,0,1283774
furpa,0.14285714285714285,6,6,GTTTACCGATAGTTCGTGCG,0,1294005
furpa,0.14285714285714285,6,6,GTTGTTAATGTCATAAGATC,0,1320909
furpa,0.14285714285714285,6,6,GTTGGCTGCCTCTAAGACTA,0,1318188
furpa,0.14285714285714285,6,6,GTTGGCAGCCCGGGCGTACC,0,1308592
furpa,0.14285714285714285,6,6,GTTGCCATTCTGATCCTTCA,0,1350141
furpa,0.14285714285714285,6,6,GTTGAGTGCCTTAGTTCCGA,0,1334034
furpa,0.14285714285714285,6,6,GTTCGTTTTCTCCGTGAGTA,0,1287820
furpa,0.14285714285714285,6,6,GTTCGTCGCGAACTACACCA,0,1357302
furpa,0.14285714285714285,6,6,GTTCCTTTGATACGAGCTAC,0,1326341
furpa,0.14285714285714285,6,6,GTTCCCTGCGGAAGCATTGC,0,1315514
furpa,0.14285714285714285,6,6,GTTCATATGCGGTCCTAGGT,0,1278648
furpa,0.14285714285714285,6,6,GTTCAATAGCATACTCGTCA,0,1298702
furpa,0.14285714285714285,6,6,GTTATGGGCGCCTGACACCA,0,1303914
furpa,0.14285714285714285,6,6,GTTAGTTGATCCAGAAGACC,0,1314231
furpa,0.14285714285714285,6,6,GTTACTCGCACACACCTGTC,0,1306053
furpa,0.14285714285714285,6,6,GTTAATGAGTAGAATACACA,0,1319488
furpa,0.14285714285714285,6,6,GTTAAGTGTCAACCGGACGA,0,1299190
furpa,0.14285714285714285,6,6,GTGTTATTCGCGGTATGAAC,0,1356163
furpa,0.14285714285714285,6,6,GTGTTAGTTCACTAGGGACA,0,1328089
furpa,0.14285714285714285,6,6,GTGTGTCACACCTTCGGAGT,0,1348374
furpa,0.14285714285714285,6,6,GTGTCTATGGAGGCCATGGT,0,1279173
furpa,0.14285714285714285,6,6,GTGTCGTTCCTAGAGCCCGG,0,1291518
furpa,0.14285714285714285,6,6,GTGTCCACTTACTCACGGGA,0,1336489
furpa,0.14285714285714285,6,6,GTGGTCTATATAGCTGGAAA,0,1346293
furpa,0.14285714285714285,6,6,GTGGTCGGCGACATGCAGGC,0,1288160
furpa,0.14285714285714285,6,6,GTGGCTGTAGGATGAGCTAT,0,1339683
furpa,0.14285714285714285,6,6,GTGGAAGGCGCCATTCAACC,0,1355636
furpa,0.14285714285714285,6,6,GTGCTGAGATTTTAAGTGAT,0,1305409
furpa,0.14285714285714285,6,6,GTGCGGCATGAACATAAAGT,0,1324432
furpa,0.14285714285714285,6,6,GTGCCGGCAAGTTATTATCT,0,1311112
furpa,0.14285714285714285,6,6,GTGCCGGAGTGGGTGTCACT,0,1298840
furpa,0.14285714285714285,6,6,GTGCCGCGTTGCTCTGACGT,0,1356655
furpa,0.14285714285714285,6,6,GTCTGTCAGGGATGCGGTCG,0,1289917
furpa,0.14285714285714285,6,6,GTCTGCCCAGATGATGCGGA,0,1299554
furpa,0.14285714285714285,6,6,GTCTCGTGTCTGCGCCTCTG,0,1298571
furpa,0.14285714285714285,6,6,GTCTCCCGAAGGCCGGACGC,0,1306338
furpa,0.14285714285714285,6,6,GTCTAGAAAACCGCCGGTGT,0,1287432
furpa,0.14285714285714285,6,6,GTCGTTCGTATACTACGGGA,0,1336574
furpa,0.14285714285714285,6,6,GTCGTATGAAGTAGCCATTA,0,1305169
furpa,0.14285714285714285,6,6,GTCGGAAGAACTCCGTTTTA,0,1310118
furpa,0.14285714285714285,6,6,GTCGCTAATGGGCAACGCTG,0,1296592
furpa,0.14285714285714285,6,6,GTCCGGGGCCTCATATAGAT,0,1301700
furpa,0.14285714285714285,6,6,GTCCCTAGTTTCGCATGATA,0,1318966
furpa,0.14285714285714285,6,6,GTCATTCAGTTCCGCTCCAG,0,1299967
furpa,0.14285714285714285,6,6,GTCATCCGACCGTGCTTTTA,0,1336104
furpa,0.14285714285714285,6,6,GTCATAGAGTTTTTGCACCT,0,1315268
furpa,0.14285714285714285,6,6,GTCATACACTCGGTGATGCT,0,1355908
furpa,0.14285714285714285,6,6,GTCAAGCCTGGCTTGTAGCG,0,1313212
furpa,0.14285714285714285,6,6,GTCAAGACGGGAAGCAGGGA,0,1297926
furpa,0.14285714285714285,6,6,GTCAACTGGGTAGCTCGTAT,0,1281769
furpa,0.14285714285714285,6,6,GTATTCATAAGGGTAGATCA,0,1320761
furpa,0.14285714285714285,6,6,GTATTAGATAGTGTCGGTGT,0,1331219
furpa,0.14285714285714285,6,6,GTATGCAGGTTGGCCAAGCT,0,1349178
furpa,0.14285714285714285,6,6,GTATCCGGGGGACTAAAGTC,0,1305767
furpa,0.14285714285714285,6,6,GTATCAATCGGGAGAGGCGA,0,1343420
furpa,0.14285714285714285,6,6,GTATCAAGTGGAGTAGGTGT,0,1338526
furpa,0.14285714285714285,6,6,GTAGGGTGTGGCACCTGGTC,0,1308242
furpa,0.14285714285714285,6,6,GTAGCAGCTTACTACTCTGC,0,1293249
furpa,0.14285714285714285,6,6,GTAGCAGCAGCAACACTCCT,0,1346471
furpa,0.14285714285714285,6,6,GTAGATTGCTTAGAACATCC,0,1294755
furpa,0.14285714285714285,6,6,GTACTTGAATGGATAAGGTT,0,1354080
furpa,0.14285714285714285,6,6,GTACGTTGGCACCCTTGAGG,0,1286149
furpa,0.14285714285714285,6,6,GTACCTCGAGTTCTTCTATC,0,1330728
furpa,0.14285714285714285,6,6,GTACCGCGGTACGGTGGGGA,0,1321071
furpa,0.14285714285714285,6,6,GTACCCAGAAATATAAGTGC,0,1349577
furpa,0.14285714285714285,6,6,GTACCACTCTTAAAAAACGG,0,1286850
furpa,0.14285714285714285,6,6,GTACATAACGTTATCTGTCA,0,1323093
furpa,0.14285714285714285,6,6,GTAATTTGATCCACAGAAGT,0,1282881
furpa,0.14285714285714285,6,6,GTAATGGAGGGCAACTGGTT,0,1344618
furpa,0.14285714285714285,6,6,GTAATAGCAACGGCCAAACG,0,1357435
furpa,0.14285714285714285,6,6,GTAAGATGGTGAACGTTCGA,0,1296824
furpa,0.14285714285714285,6,6,GGTTTTGGCATCACCACTCA,0,1321895
furpa,0.14285714285714285,6,6,GGTTGATTAGAGGACTTAAT,0,1301657
furpa,0.14285714285714285,6,6,GGTTGACACCGGACAGGACA,0,1301853
furpa,0.14285714285714285,6,6,GGTTACCGAACTGAGGTTCC,0,1272124
furpa,0.14285714285714285,6,6,GGTGTATCATTAACCTGTGA,0,1340603
furpa,0.14285714285714285,6,6,GGTGGCACACACACTCGTCA,0,1321688
furpa,0.14285714285714285,6,6,GGTGCGGCCCTCGGCACGCT,0,1344730
furpa,0.14285714285714285,6,6,GGTGATTGGGCCGTCCACGG,0,1351657
furpa,0.14285714285714285,6,6,GGTCTTAGTCCTGCCACCGA,0,1338427
furpa,0.14285714285714285,6,6,GGTCCGTATCTCCTGCAGTT,0,1343652
furpa,0.14285714285714285,6,6,GGTCCGAATCCCTCCGTGGT,0,1274591
furpa,0.14285714285714285,6,6,GGTCACGACTTAATTAGGAT,0,1344404
furpa,0.14285714285714285,6,6,GGTATGTAGAGGAGCTCATT,0,1304716
furpa,0.14285714285714285,6,6,GGTATGACAGCAGGGTGAAT,0,1318721
furpa,0.14285714285714285,6,6,GGTATCTCAAGGTAGCATAT,0,1347290
furpa,0.14285714285714285,6,6,GGTATCCCGGGAATAGCTCG,0,1330395
furpa,0.14285714285714285,6,6,GGTAGTGCAGCCAACCGAAG,0,1327854
furpa,0.14285714285714285,6,6,GGGTTTTACGGCAGACTATT,0,1298630
furpa,0.14285714285714285,6,6,GGGTTCGCGCGAGTTCGTTT,0,1313816
furpa,0.14285714285714285,6,6,GGGTCGATCGGTCCACTAAT,0,1300992
furpa,0.14285714285714285,6,6,GGGTCGAGCGACTACCAATT,0,1301779
furpa,0.14285714285714285,6,6,GGGTCCTTCCCCGAGGCAAT,0,1357342
furpa,0.14285714285714285,6,6,GGGTCCTACGCGGCACGGAT,0,1284179
furpa,0.14285714285714285,6,6,GGGTCCGGCCGTTGGTGACG,0,1302129
furpa,0.14285714285714285,6,6,GGGTCATGAAGCCTGGGTGC,0,1280011
furpa,0.14285714285714285,6,6,GGGTCACAGAAAGAGTACAA,0,1281892
furpa,0.14285714285714285,6,6,GGGTATCAGCAAGTGAACCA,0,1345368
furpa,0.14285714285714285,6,6,GGGTAGGCCGCCAGGAGATG,0,1321906
furpa,0.14285714285714285,6,6,GGGTAGGCATACGACCGGCA,0,1271421
furpa,0.14285714285714285,6,6,GGGTACCATTGGGTGTCCAA,0,1323187
furpa,0.14285714285714285,6,6,GGGTACAGGTCCACTGGAGA,0,1335819
furpa,0.14285714285714285,6,6,GGGGTTGGCGTGCCTAAACA,0,1351675
furpa,0.14285714285714285,6,6,GGGGTACTACCGCAGGGTGT,0,1321357
furpa,0.14285714285714285,6,6,GGGGGGGTGACTATCAGGTG,0,1346684
furpa,0.14285714285714285,6,6,GGGGCTTAGAGTGGCCGTTT,0,1274646
furpa,0.14285714285714285,6,6,GGGGAGGAGCTGAACCCACG,0,1271370
furpa,0.14285714285714285,6,6,GGGGAATACCACTATTCACC,0,1337760
furpa,0.14285714285714285,6,6,GGGGAACCTTATAACAAAGG,0,1336134
furpa,0.14285714285714285,6,6,GGGCTGCGCTGCCACTAAGG,0,1338742
furpa,0.14285714285714285,6,6,GGGCTCGCTACGAACATTTG,0,1275083
furpa,0.14285714285714285,6,6,GGGCTACGTAGAGGCATATG,0,1271428
furpa,0.14285714285714285,6,6,GGGCGTCGGCGGGTCGCTCT,0,1331103
furpa,0.14285714285714285,6,6,GGGCGCGTAGCTACGGTAAG,0,1322083
furpa,0.14285714285714285,6,6,GGGCGACGGGATGCACCACC,0,1353140
furpa,0.14285714285714285,6,6,GGGCATTGGATCTCATAGAT,0,1310952
furpa,0.14285714285714285,6,6,GGGCATCATATCATCGATAG,0,1318104
furpa,0.14285714285714285,6,6,GGGCAAAGCAGGCCCGAGCG,0,1337114
furpa,0.14285714285714285,6,6,GGGATCCGATCAGACGCCGG,0,1297596
furpa,0.14285714285714285,6,6,GGGATCAACAGCCGGGTTCT,0,1297230
furpa,0.14285714285714285,6,6,GGGATAGATCAAGGCCGATC,0,1315934
furpa,0.14285714285714285,6,6,GGGAGTGTAAGTGCCATCAA,0,1357152
furpa,0.14285714285714285,6,6,GGCTTTTTTTCTGCCTATGG,0,1281341
furpa,0.14285714285714285,6,6,GGCTTCGCGCATGATTTTGG,0,1355125
furpa,0.14285714285714285,6,6,GGCTTACAGGTAAATTATGT,0,1284763
furpa,0.14285714285714285,6,6,GGCTATTGGTACGCTAGTAA,0,1352264
furpa,0.14285714285714285,6,6,GGCGTAACACATATTCGTTC,0,1323976
furpa,0.14285714285714285,6,6,GGCGCATTGGTATAAGAATA,0,1294061
furpa,0.14285714285714285,6,6,GGCGAGCTAGATAATCAGAT,0,1307898
furpa,0.14285714285714285,6,6,GGCCTCCCAGAACAATTCTC,0,1281350
furpa,0.14285714285714285,6,6,GGCCTCCAGCGACATTAAAA,0,1322677
furpa,0.14285714285714285,6,6,GGCCATCGCGCGGCGATTAT,0,1272915
furpa,0.14285714285714285,6,6,GGCCAGTAACGAGCGGCATT,0,1329747
furpa,0.14285714285714285,6,6,GGCATGTACCGAGGTCTTAT,0,1277262
furpa,0.14285714285714285,6,6,GGCAGTCCCGATCACGCGGG,0,1295099
furpa,0.14285714285714285,6,6,GGCAGGGGGTCCAACACGTC,0,1319335
furpa,0.14285714285714285,6,6,GGCACTGAGTTGATCCTTTG,0,1280044
furpa,0.14285714285714285,6,6,GGCACACGGGAACGCGCAGG,0,1299428
furpa,0.14285714285714285,6,6,GGCAAGTTGAACCGAGGGTC,0,1290295
furpa,0.14285714285714285,6,6,GGCAAACCGCCCCTTATCGG,0,1299720
furpa,0.14285714285714285,6,6,GGATTCGGGACAGGTCCTGG,0,1344632
furpa,0.14285714285714285,6,6,GGATGTGGTCGAGGTTAAAC,0,1281658
furpa,0.14285714285714285,6,6,GGATGCAGTCCTGATAGTGT,0,1295551
furpa,0.14285714285714285,6,6,GGATCTTTCAATCGATCACT,0,1273918
furpa,0.14285714285714285,6,6,GGATCATGAGATTCTCGTGC,0,1319759
furpa,0.14285714285714285,6,6,GGATATCCGACTACCCTTTT,0,1314484
furpa,0.14285714285714285,6,6,GGATAGTTATGAAGTACACT,0,1308228
furpa,0.14285714285714285,6,6,GGATAGATGGCAACGCCAGA,0,1284313
furpa,0.14285714285714285,6,6,GGAGGATGCTTACAGGACAT,0,1335256
furpa,0.14285714285714285,6,6,GGAGATTTTCTCCCGGTTGC,0,1301829
furpa,0.14285714285714285,6,6,GGAGATTCCAGAGATGCTAA,0,1285917
furpa,0.14285714285714285,6,6,GGAGAGCAGATGTGTCTCCT,0,1322848
furpa,0.14285714285714285,6,6,GGACGGAAATAGATGTGTCT,0,1354188
furpa,0.14285714285714285,6,6,GGACGAAGGGTCACTAGACA,0,1284740
furpa,0.14285714285714285,6,6,GGACCCCAAGTAAAGTTCAA,0,1301708
furpa,0.14285714285714285,6,6,GGAATATAGGTGAACATAAA,0,1290278
furpa,0.14285714285714285,6,6,GGAAGTGTAAAAAGTTGGAC,0,1327520
furpa,0.14285714285714285,6,6,GGAACGCACCACCGATCTCG,0,1316817
furpa,0.14285714285714285,6,6,GCTTGATTGTTGCAAAGATT,0,1307984
furpa,0.14285714285714285,6,6,GCTTAAGATCATACTTGACT,0,1350735
furpa,0.14285714285714285,6,6,GCTGGACCCCGAAATGTGCA,0,1334787
furpa,0.14285714285714285,6,6,GCTGCGTAATGTATATCTGG,0,1349128
furpa,0.14285714285714285,6,6,GCTGCCCTCGAACGAATCCA,0,1295816
furpa,0.14285714285714285,6,6,GCTGCATCGATTTTTCTCAG,0,1334598
furpa,0.14285714285714285,6,6,GCTGACGGGACTGCATGCAT,0,1310500
furpa,0.14285714285714285,6,6,GCTCGTAGGTTCGCCGCACG,0,1298281
furpa,0.14285714285714285,6,6,GCTCCAGGTCCGCGATGCCT,0,1312901
furpa,0.14285714285714285,6,6,GCTCAAACTGCAATATCACG,0,1350476
furpa,0.14285714285714285,6,6,GCTAGGAAGGACAGATCGGA,0,1334016
furpa,0.14285714285714285,6,6,GCTAGACATTGTTCGAGTGG,0,1327667
furpa,0.14285714285714285,6,6,GCTACCACCAAACCCTACTA,0,1354594
furpa,0.14285714285714285,6,6,GCTAATAGGACTGTAACGTA,0,1313450
furpa,0.14285714285714285,6,6,GCTAAGTTCAAAGTGCGATC,0,1289986
furpa,0.14285714285714285,6,6,GCGTTCGGTGCCGAGATGCA,0,1282194
furpa,0.14285714285714285,6,6,GCGTGTAGACAAAGGGGAGG,0,1340927
furpa,0.14285714285714285,6,6,GCGTAGACCTAGTGGACTGC,0,1271410
furpa,0.14285714285714285,6,6,GCGGTTCAGGGATTCTCGAA,0,1332905
furpa,0.14285714285714285,6,6,GCGGTCTCGAGCAGAGTTGT,0,1333443
furpa,0.14285714285714285,6,6,GCGGGGATTGCAGGACGCCG,0,1306217
furpa,0.14285714285714285,6,6,GCGGGACCAGGCTCCTGGGA,0,1298642
furpa,0.14285714285714285,6,6,GCGGCGCTGAAGGTAGATCG,0,1272799
furpa,0.14285714285714285,6,6,GCGGATCCGCTCTACCCAGT,0,1303446
furpa,0.14285714285714285,6,6,GCGCGACCGGATTTACCCGT,0,1313517
furpa,0.14285714285714285,6,6,GCGATCGCGCCATTTGCGCA,0,1287955
furpa,0.14285714285714285,6,6,GCGAGACCCCCACTCATCAC,0,1309535
furpa,0.14285714285714285,6,6,GCCTGCCTTGGATAGGAAGG,0,1347961
furpa,0.14285714285714285,6,6,GCCTGCATCTAGCACTGAGA,0,1353634
furpa,0.14285714285714285,6,6,GCCTCCCTACAAGCAGGGTC,0,1329162
furpa,0.14285714285714285,6,6,GCCTCCCAATTTGCGTGTAA,0,1325855
furpa,0.14285714285714285,6,6,GCCGTTGCACTGATTCCCCT,0,1316468
furpa,0.14285714285714285,6,6,GCCGTGCAATCCAGGATTCG,0,1300163
furpa,0.14285714285714285,6,6,GCCGTCTATGGTGCCACATC,0,1315667
furpa,0.14285714285714285,6,6,GCCGTATTATGGGCTCAAAC,0,1333681
furpa,0.14285714285714285,6,6,GCCGTAATAAACTAACTGAT,0,1321132
furpa,0.14285714285714285,6,6,GCCGGTGCATACGGTGTTCC,0,1336239
furpa,0.14285714285714285,6,6,GCCGGTACTTCGGGTAGATA,0,1276820
furpa,0.14285714285714285,6,6,GCCGCGAGGGTCTAGTGCGG,0,1299861
furpa,0.14285714285714285,6,6,GCCGCCTTTCGGTTTCATAG,0,1289751
furpa,0.14285714285714285,6,6,GCCCCTACGCATAAATTCCT,0,1351485
furpa,0.14285714285714285,6,6,GCCCCATCTAACTGCAAGTG,0,1283736
furpa,0.14285714285714285,6,6,GCCATTAGTCATGGACAATG,0,1276480
furpa,0.14285714285714285,6,6,GCCAGAAGCACGACGGCATC,0,1275598
furpa,0.14285714285714285,6,6,GCCACACCATGATCGGGCTT,0,1335345
furpa,0.14285714285714285,6,6,GCCACACCACTTCATTAGAA,0,1325029
furpa,0.14285714285714285,6,6,GCCAACGTTTCTCCTAGCAA,0,1354646
furpa,0.14285714285714285,6,6,GCATTTAAACACCGGTCGGG,0,1284277
furpa,0.14285714285714285,6,6,GCATGCATTCCGTGTAAGAC,0,1278546
furpa,0.14285714285714285,6,6,GCATCTGCTACTTTGGGCGC,0,1295287
furpa,0.14285714285714285,6,6,GCAGGGTTATCGCAGACACC,0,1287050
furpa,0.14285714285714285,6,6,GCAGGGCCAGTCATATATTT,0,1346365
furpa,0.14285714285714285,6,6,GCAGGCACGAGCTTCAAGAA,0,1273234
furpa,0.14285714285714285,6,6,GCAGCGATCCCATCTCGTTC,0,1355628
furpa,0.14285714285714285,6,6,GCAGAGGACGTCCTACGGCA,0,1322910
furpa,0.14285714285714285,6,6,GCACTAGAACGAAAGGGGGA,0,1273011
furpa,0.14285714285714285,6,6,GCACCCATCCCCCTGTGATG,0,1296698
furpa,0.14285714285714285,6,6,GCAATCCTAAGTGCTTCGGT,0,1287746
furpa,0.14285714285714285,6,6,GCAAGCCTTGAACGCACTGA,0,1335154
furpa,0.14285714285714285,6,6,GCAAGAGACGGGAGAGTAGT,0,1357329
furpa,0.14285714285714285,6,6,GCAACGCGAACATCTTTGAG,0,1287657
furpa,0.14285714285714285,6,6,GCAACCGGCTCCTTTACCTC,0,1321566
furpa,0.14285714285714285,6,6,GCAACCGGACATCGGAAATG,0,1302731
furpa,0.14285714285714285,6,6,GCAAATTTGGCGGGCTTACG,0,1344726
furpa,0.14285714285714285,6,6,GATTTACTCCGCCAACTATT,0,1353645
furpa,0.14285714285714285,6,6,GATTGGACGCAATGCTCTGC,0,1330326
furpa,0.14285714285714285,6,6,GATTCATGGTAGGCGTGAAC,0,1293466
furpa,0.14285714285714285,6,6,GATTATGGGTCCTTAGCTGA,0,1290898
furpa,0.14285714285714285,6,6,GATTAGACACTTCATTGGTA,0,1276188
furpa,0.14285714285714285,6,6,GATTAACAGCTGGCGGAACA,0,1305359
furpa,0.14285714285714285,6,6,GATGGGGGGTCTGGGTCACT,0,1314124
furpa,0.14285714285714285,6,6,GATGGGCAATCGCATGAAAT,0,1341682
furpa,0.14285714285714285,6,6,GATGCACGACGGTGTCTTAT,0,1298409
furpa,0.14285714285714285,6,6,GATCTTGTGCGTAGAGGTAC,0,1294340
furpa,0.14285714285714285,6,6,GATCGGAACCCTGCCGGCTG,0,1274744
furpa,0.14285714285714285,6,6,GATCCCGTCAAAAAGCAGTA,0,1312028
furpa,0.14285714285714285,6,6,GATCCAGTATCCAGCTGTAC,0,1340822
furpa,0.14285714285714285,6,6,GATCAGCGCAGGATGTCGGC,0,1301490
furpa,0.14285714285714285,6,6,GATCAGATTCCTAACCGGAA,0,1276932
furpa,0.14285714285714285,6,6,GATATGTTCTGGTCGCCCCT,0,1343229
furpa,0.14285714285714285,6,6,GATAGCCATGCAGGTATATT,0,1290058
furpa,0.14285714285714285,6,6,GATACGTGTAAAGCAGGGTA,0,1283550
furpa,0.14285714285714285,6,6,GATAAGTGAGATCGTCTCCA,0,1285960
furpa,0.14285714285714285,6,6,GATAAGTCTAAATCATCCGT,0,1317879
furpa,0.14285714285714285,6,6,GATAAAGAACGTAAGCCGAT,0,1293874
furpa,0.14285714285714285,6,6,GAGTCATTTAGGGCCGCGAT,0,1297908
furpa,0.14285714285714285,6,6,GAGTAGACCGTACCAGGCTT,0,1350411
furpa,0.14285714285714285,6,6,GAGTACTCTACTCCCCAGTG,0,1338711
furpa,0.14285714285714285,6,6,GAGGTTCTGCTTCCACATCT,0,1339280
furpa,0.14285714285714285,6,6,GAGGTTCCGGAGGTCTCCAT,0,1326834
furpa,0.14285714285714285,6,6,GAGGGATTGCATGGCAATGC,0,1297238
furpa,0.14285714285714285,6,6,GAGGCTCCTCAACCTATCAT,0,1315692
furpa,0.14285714285714285,6,6,GAGGCTCCACGTAAATGGTA,0,1280838
furpa,0.14285714285714285,6,6,GAGGCCTATATAAATCCAAC,0,1354563
furpa,0.14285714285714285,6,6,GAGGCCCATTCTTACGAACG,0,1315860
furpa,0.14285714285714285,6,6,GAGGCATCGGGGTATTTGCG,0,1322953
furpa,0.14285714285714285,6,6,GAGCTGTCCTGACTAACATG,0,1302816
furpa,0.14285714285714285,6,6,GAGCTACGTTGACGAAGGGA,0,1327628
furpa,0.14285714285714285,6,6,GAGCGTAAGATACATGTAGG,0,1317170
furpa,0.14285714285714285,6,6,GAGATCATAGAGCGCTGGGA,0,1357311
furpa,0.14285714285714285,6,6,GAGAGTTCCTCGAAGTCAAA,0,1325092
furpa,0.14285714285714285,6,6,GAGAGTGCCTACTCGCCTTT,0,1305739
furpa,0.14285714285714285,6,6,GAGAGGTCGAATAACGTCAG,0,1313638
furpa,0.14285714285714285,6,6,GAGACGTTAGGAGATGTGAG,0,1285884
furpa,0.14285714285714285,6,6,GACTTGCGGATGAAGCATTG,0,1321679
furpa,0.14285714285714285,6,6,GACTGTCCGTGTTCCTCCAT,0,1275927
furpa,0.14285714285714285,6,6,GACTGTCCAACTACGTGACA,0,1327296
furpa,0.14285714285714285,6,6,GACGTTTAAAGTCCTGGAGC,0,1346794
furpa,0.14285714285714285,6,6,GACGTAATAATGCGAAGTGT,0,1341434
furpa,0.14285714285714285,6,6,GACGGAACTGGTCAGTTGTA,0,1280750
furpa,0.14285714285714285,6,6,GACGAGGAAACGGTAGACTC,0,1355331
furpa,0.14285714285714285,6,6,GACCTTTCATACGTTATTTT,0,1331392
furpa,0.14285714285714285,6,6,GACCCTACCTCAACCCGTCT,0,1338218
furpa,0.14285714285714285,6,6,GACCAGTGCCCCGTGAGTGA,0,1351131
furpa,0.14285714285714285,6,6,GACCACCGGTGTCGGAGTTG,0,1305702
furpa,0.14285714285714285,6,6,GACATCGAAGTGACTGTATA,0,1303009
furpa,0.14285714285714285,6,6,GACAATCCATGTTTGCACAC,0,1301294
furpa,0.14285714285714285,6,6,GAATTGGGGGCACCTGCTAA,0,1306336
furpa,0.14285714285714285,6,6,GAATGCATTTGCGTTTCCGT,0,1294795
furpa,0.14285714285714285,6,6,GAATCGGGTTTTTGAGATTT,0,1318293
furpa,0.14285714285714285,6,6,GAATATCGGCAGGAATTGCC,0,1281094
furpa,0.14285714285714285,6,6,GAATAACCAAATAGCCACCC,0,1331449
furpa,0.14285714285714285,6,6,GAAGGCTCCGTGTTAAGCCA,0,1351109
furpa,0.14285714285714285,6,6,GAAGGCATTAGAACTCATAA,0,1298984
furpa,0.14285714285714285,6,6,GAAGCATGTGTGAGGTGCGG,0,1354718
furpa,0.14285714285714285,6,6,GAAGAAAAGACAATCGTTCC,0,1277638
furpa,0.14285714285714285,6,6,GAACTCGCGGAGATATCGGG,0,1292107
furpa,0.14285714285714285,6,6,GAACTAAAAGCCAGTTAGAA,0,1289909
furpa,0.14285714285714285,6,6,GAACGTACCAATGGTTCAAG,0,1339726
furpa,0.14285714285714285,6,6,GAACCTCCACCGGAACAGTG,0,1282931
furpa,0.14285714285714285,6,6,GAACCACAAGTCGCCTAGGA,0,1333232
furpa,0.14285714285714285,6,6,GAAAGAGATCAATCCAAACG,0,1305975
furpa,0.14285714285714285,6,6,GAAAGAATTGCTCCTGGCCT,0,1288001
furpa,0.14285714285714285,6,6,GAAACAGGACATATAGCGAG,0,1275753
furpa,0.14285714285714285,6,6,CTTTGAGCCATAAAATCTGT,0,1303929
furpa,0.14285714285714285,6,6,CTTTCGTAGCAATCCGGTGG,0,1331404
furpa,0.14285714285714285,6,6,CTTTATTACCACAATTCTGC,0,1308939
furpa,0.14285714285714285,6,6,CTTTAAGACTTAGTTTGTGG,0,1353536
furpa,0.14285714285714285,6,6,CTTGTTGTTAGATAGGACGG,0,1281097
furpa,0.14285714285714285,6,6,CTTGTCCGTCGCGAAGACCA,0,1313218
furpa,0.14285714285714285,6,6,CTTCGCGCTGGGATCATGTT,0,1342696
furpa,0.14285714285714285,6,6,CTTATGTTTGCGCTAGCGCC,0,1334771
furpa,0.14285714285714285,6,6,CTTATGTGAACTAAGGCGGG,0,1271740
furpa,0.14285714285714285,6,6,CTTAGCCCTAATACGGAAGT,0,1343144
furpa,0.14285714285714285,6,6,CTTACGTTGATGGGATCGGA,0,1295202
furpa,0.14285714285714285,6,6,CTTACATCTCTGAAAAATAA,0,1293487
furpa,0.14285714285714285,6,6,CTTAACACCAAAAGGATACC,0,1334797
furpa,0.14285714285714285,6,6,CTGTTAGATCCATGGCAATA,0,1293952
furpa,0.14285714285714285,6,6,CTGTGGTCTTACACATGTCC,0,1314849
furpa,0.14285714285714285,6,6,CTGTATTCCTCGCATAAGGG,0,1282947
furpa,0.14285714285714285,6,6,CTGGGTGAACCTCATTTGTC,0,1327148
furpa,0.14285714285714285,6,6,CTGGATGTGAGCTTCAACCT,0,1285921
furpa,0.14285714285714285,6,6,CTGCTGGGCGCAACGAGATC,0,1356609
furpa,0.14285714285714285,6,6,CTGCTCGTATTGGGTAGAGG,0,1273892
furpa,0.14285714285714285,6,6,CTGCTAAGTTTCTTTAGAAT,0,1311152
furpa,0.14285714285714285,6,6,CTGCCTCAAGTTTGGGCCAA,0,1340516
furpa,0.14285714285714285,6,6,CTGCATGATCTAGTTAGAAT,0,1321176
furpa,0.14285714285714285,6,6,CTGCATAGGACCCCAAACAC,0,1337923
furpa,0.14285714285714285,6,6,CTGCAATCTATGACAATTAC,0,1309022
furpa,0.14285714285714285,6,6,CTGATGGCTGGCACTCGACA,0,1300727
furpa,0.14285714285714285,6,6,CTGATCGCTGGGAAATCGCG,0,1296936
furpa,0.14285714285714285,6,6,CTGAGGGACCTCTGCGTTGG,0,1274980
furpa,0.14285714285714285,6,6,CTGAAGAGCGCCTCCAGCTT,0,1329881
furpa,0.14285714285714285,6,6,CTGAAGAATTGGTTCCGAGA,0,1298156
furpa,0.14285714285714285,6,6,CTCTGAGACATATTTATGCG,0,1353847
furpa,0.14285714285714285,6,6,CTCTCGACAGAAGCCCGCGG,0,1352996
furpa,0.14285714285714285,6,6,CTCGGTACGCAATACAGTAA,0,1280366
furpa,0.14285714285714285,6,6,CTCCTTACGGCCTTAATTGA,0,1288537
furpa,0.14285714285714285,6,6,CTCCCGGGCTGTTGGTGAAA,0,1275511
furpa,0.14285714285714285,6,6,CTCATCAAGATCAACGCTAT,0,1353851
furpa,0.14285714285714285,6,6,CTCACTGACCACATTTGTAT,0,1277758
furpa,0.14285714285714285,6,6,CTATGGGAGGGCTCCGTGCA,0,1355163
furpa,0.14285714285714285,6,6,CTATCCTGACACAACGGCCT,0,1303188
furpa,0.14285714285714285,6,6,CTATATGTATGAGAATGCAC,0,1274630
furpa,0.14285714285714285,6,6,CTATAAATTGGGACATTACA,0,1326902
furpa,0.14285714285714285,6,6,CTAGTGCTGATATCCCCAGT,0,1296156
furpa,0.14285714285714285,6,6,CTAGTCAGGGGTCCGAACCA,0,1354974
furpa,0.14285714285714285,6,6,CTAGTATGACTCGCGGGGGA,0,1283706
furpa,0.14285714285714285,6,6,CTAGTATCACTGTAGAAGAT,0,1272101
furpa,0.14285714285714285,6,6,CTAGTATAGAGACTCGGGTC,0,1300362
furpa,0.14285714285714285,6,6,CTAGGTTGAAGCGAGCAATC,0,1313939
furpa,0.14285714285714285,6,6,CTAGGGGCTTAACGGACTCA,0,1278712
furpa,0.14285714285714285,6,6,CTAGAGGGGCGGGCGTCTGA,0,1328356
furpa,0.14285714285714285,6,6,CTACTGGGGATTTGTCGCCA,0,1344755
furpa,0.14285714285714285,6,6,CTACTCCTGCAATGGTATGG,0,1310345
furpa,0.14285714285714285,6,6,CTACTACTCACCCCCGCCAG,0,1279703
furpa,0.14285714285714285,6,6,CTACGTGACCTACCAGGTTG,0,1277253
furpa,0.14285714285714285,6,6,CTACAAGAGTCGCCCATATG,0,1290320
furpa,0.14285714285714285,6,6,CTAAGTGGCACAAGTTTTCG,0,1302593
furpa,0.14285714285714285,6,6,CTAACTATATCTCACCGGCG,0,1330306
furpa,0.14285714285714285,6,6,CTAACGAGTCCAATGAGTAG,0,1291570
furpa,0.14285714285714285,6,6,CTAACAATCATTGAGCCGGC,0,1295488
furpa,0.14285714285714285,6,6,CGTTTTGAAGGAAATATAGA,0,1308487
furpa,0.14285714285714285,6,6,CGTTTCTGGACGAAACGATA,0,1336901
furpa,0.14285714285714285,6,6,CGTTGCTTATAGCTGTCCAA,0,1287509
furpa,0.14285714285714285,6,6,CGTTGCTGCGTGCGCAAGTT,0,1321339
furpa,0.14285714285714285,6,6,CGTTAGTTTGGCTCGGCGGA,0,1334281
furpa,0.14285714285714285,6,6,CGTTACGCTTGTGGATTGTC,0,1321693
furpa,0.14285714285714285,6,6,CGTGTATAAGATTCTCAGCC,0,1339788
furpa,0.14285714285714285,6,6,CGTGAGAACGCCGGACTCAG,0,1341192
furpa,0.14285714285714285,6,6,CGTGAAGCTGATCGGACTAG,0,1299538
furpa,0.14285714285714285,6,6,CGTCTCTTACTGCGCGATGC,0,1325233
furpa,0.14285714285714285,6,6,CGTCTCGATCCGGATATCCA,0,1298438
furpa,0.14285714285714285,6,6,CGTCTATTGTTTCAATTTAA,0,1346349
furpa,0.14285714285714285,6,6,CGTCGGTGTTGGTATTCGCT,0,1340042
furpa,0.14285714285714285,6,6,CGTCCTTGCCCACAGCGCGA,0,1329932
furpa,0.14285714285714285,6,6,CGTCCTTAAGGACGCTTGGA,0,1312619
furpa,0.14285714285714285,6,6,CGTCCTGAGTCCTCGCCTGT,0,1277515
furpa,0.14285714285714285,6,6,CGTCCCGATTTAAGGCCTGG,0,1307825
furpa,0.14285714285714285,6,6,CGTCCATGGCCTTGGAGCCA,0,1287365
furpa,0.14285714285714285,6,6,CGTCAAGGTAAGTTCACGTC,0,1282599
furpa,0.14285714285714285,6,6,CGTATTATTGCCCCGAGACA,0,1354506
furpa,0.14285714285714285,6,6,CGTAGTGGGCTAAACCAATT,0,1315059
furpa,0.14285714285714285,6,6,CGTACTGGGGCGGCAATCCA,0,1305510
furpa,0.14285714285714285,6,6,CGGTTCTTCACGAATGTTGA,0,1313391
furpa,0.14285714285714285,6,6,CGGTCCAGGGCTGCTAACCA,0,1339975
furpa,0.14285714285714285,6,6,CGGTAGTGATACTAAACCCC,0,1334548
furpa,0.14285714285714285,6,6,CGGTAAAAGACTAAGGGGGT,0,1287869
furpa,0.14285714285714285,6,6,CGGGCTGAACAGATTCACTC,0,1329605
furpa,0.14285714285714285,6,6,CGGGCTAACATTGGTGACAA,0,1313023
furpa,0.14285714285714285,6,6,CGGGCTAAATTTTGGCGATA,0,1296037
furpa,0.14285714285714285,6,6,CGGGCCGGCAAAGAGGAGTT,0,1341683
furpa,0.14285714285714285,6,6,CGGGCCGACAAGACCATGTA,0,1349791
furpa,0.14285714285714285,6,6,CGGCGAGCTGGACGTCAAAT,0,1280963
furpa,0.14285714285714285,6,6,CGGCCTGAGTGTGGGCTAGG,0,1352679
furpa,0.14285714285714285,6,6,CGGCCATGGTAGTAGTGATC,0,1300111
furpa,0.14285714285714285,6,6,CGGCAAGGCAAAGCGGTAGA,0,1326072
furpa,0.14285714285714285,6,6,CGGATTAACGAAAGAGATGG,0,1296844
furpa,0.14285714285714285,6,6,CGGAGTGTCAAACTGAATGG,0,1272132
furpa,0.14285714285714285,6,6,CGGACCTGATCACACAGACG,0,1327614
furpa,0.14285714285714285,6,6,CGCTTGGGTATATATGCAAT,0,1345379
furpa,0.14285714285714285,6,6,CGCTGCATTAACGAATTGAG,0,1282199
furpa,0.14285714285714285,6,6,CGCTCGTAAACTGGCTTCGT,0,1349552
furpa,0.14285714285714285,6,6,CGCTCCGTCACCACATCGTG,0,1316816
furpa,0.14285714285714285,6,6,CGCTAGGAGCGCGTGCAGGA,0,1279110
furpa,0.14285714285714285,6,6,CGCGGCACGCGTCCTGCACA,0,1337165
furpa,0.14285714285714285,6,6,CGCGCTGTCACAGGAGTCGT,0,1353192
furpa,0.14285714285714285,6,6,CGCGAGGACTCGACATTACA,0,1305403
furpa,0.14285714285714285,6,6,CGCGACTAGACAGTCGTCTT,0,1282615
furpa,0.14285714285714285,6,6,CGCCGCCTACACGTTGACGT,0,1274338
furpa,0.14285714285714285,6,6,CGCCAGTTAAGAAGCCAACG,0,1335602
furpa,0.14285714285714285,6,6,CGCCAGTCGGAAAAGTGCAT,0,1283607
furpa,0.14285714285714285,6,6,CGCCACGGCCCACTGACATG,0,1332847
furpa,0.14285714285714285,6,6,CGCAGGGAAAACCGAGAGGA,0,1302080
furpa,0.14285714285714285,6,6,CGCACTGCTTACAACAGCGT,0,1343738
furpa,0.14285714285714285,6,6,CGCACCTGCTAAAGCGTAAC,0,1324118
furpa,0.14285714285714285,6,6,CGCAAGTCACCCATGTTTGT,0,1272754
furpa,0.14285714285714285,6,6,CGCAAGCGATAAACGTCGAC,0,1338114
furpa,0.14285714285714285,6,6,CGCAAGACTCACAACAAAGG,0,1354189
furpa,0.14285714285714285,6,6,CGATTTGGTTGACAATTGAT,0,1301775
furpa,0.14285714285714285,6,6,CGAGTCATGTACGCGCTCGT,0,1353769
furpa,0.14285714285714285,6,6,CGAGTAGTTGTGCCAGGCCT,0,1341019
furpa,0.14285714285714285,6,6,CGAGTAATAAAATGGATAGT,0,1317893
furpa,0.14285714285714285,6,6,CGAGCAACGACCATACTTCA,0,1291493
furpa,0.14285714285714285,6,6,CGACGTATCTATTGACATAT,0,1305164
furpa,0.14285714285714285,6,6,CGACCTCGACGCCGAGGTGC,0,1331726
furpa,0.14285714285714285,6,6,CGACCGAATTCTTGTGTGAT,0,1353014
furpa,0.14285714285714285,6,6,CGACCCACGTCAGAATTGTA,0,1316797
furpa,0.14285714285714285,6,6,CGAACGATAACGACGTCAAG,0,1302601
furpa,0.14285714285714285,6,6,CCTTTAAAAATCGGGCCAGT,0,1278500
furpa,0.14285714285714285,6,6,CCTTCTCAGGTGCACAAGAT,0,1343335
furpa,0.14285714285714285,6,6,CCTTACTGCGCAGGACCCTA,0,1343732
furpa,0.14285714285714285,6,6,CCTTAAAACCCTTGCGGATC,0,1275656
furpa,0.14285714285714285,6,6,CCTGACTCTAGCTGCGTCGG,0,1337358
furpa,0.14285714285714285,6,6,CCTGACGCTGGAGGGAGTGC,0,1344663
furpa,0.14285714285714285,6,6,CCTCCGCAGGTTGTAGTGGG,0,1349673
furpa,0.14285714285714285,6,6,CCTCATGCAGTGCGCACCTG,0,1339350
furpa,0.14285714285714285,6,6,CCTCAGACTGAGGATGCTCA,0,1281035
furpa,0.14285714285714285,6,6,CCTCACCATGCTCAAGGTGT,0,1337436
furpa,0.14285714285714285,6,6,CCTATTTACCGGGGGAGGGT,0,1294965
furpa,0.14285714285714285,6,6,CCTATGTAATGGACCACATT,0,1292865
furpa,0.14285714285714285,6,6,CCTATGAACTTCGTTCTCGG,0,1326851
furpa,0.14285714285714285,6,6,CCTAGCGACATTTATTCACA,0,1299729
furpa,0.14285714285714285,6,6,CCTAGACGAGGTTATCATCT,0,1297638
furpa,0.14285714285714285,6,6,CCTACTTGCCATCCAATGAG,0,1355770
furpa,0.14285714285714285,6,6,CCTACGGTAGGCGATGGTCA,0,1301052
furpa,0.14285714285714285,6,6,CCTACCTTCTAGTATGAGCT,0,1281303
furpa,0.14285714285714285,6,6,CCGTTACTTTTTGGAGCGAT,0,1330886
furpa,0.14285714285714285,6,6,CCGTCCGCAAAACACGAATG,0,1356471
furpa,0.14285714285714285,6,6,CCGTCCCAAAACTACTTACA,0,1350775
furpa,0.14285714285714285,6,6,CCGTATATGGGACTTATGGG,0,1276870
furpa,0.14285714285714285,6,6,CCGGGACAAGTTTAATACGA,0,1276760
furpa,0.14285714285714285,6,6,CCGGCGATAGAGATCCAGTC,0,1276065
furpa,0.14285714285714285,6,6,CCGGATCTATAGTTTGTGAT,0,1332362
furpa,0.14285714285714285,6,6,CCGGACGAAAGTGATCGACT,0,1320039
furpa,0.14285714285714285,6,6,CCGCTTTCACACGTCTGGAG,0,1354166
furpa,0.14285714285714285,6,6,CCGCTGCAAACGAACGTTCA,0,1322882
furpa,0.14285714285714285,6,6,CCGCGTCTTCAACTTTGATA,0,1288145
furpa,0.14285714285714285,6,6,CCGCCTATTGAGGAGTCTCC,0,1317799
furpa,0.14285714285714285,6,6,CCGCCCAACGTGGATAAAAT,0,1310130
furpa,0.14285714285714285,6,6,CCGATGCACGTCACGTCCTT,0,1335153
furpa,0.14285714285714285,6,6,CCGATCATCTGTGGAACTCT,0,1325387
furpa,0.14285714285714285,6,6,CCGATATTCGCACTACTCGA,0,1334167
furpa,0.14285714285714285,6,6,CCGAGTTTCTATCGCGGCAG,0,1334905
furpa,0.14285714285714285,6,6,CCGACTAAAACTACCCAGAC,0,1343515
furpa,0.14285714285714285,6,6,CCGAATAGGGCATACCCTGA,0,1329357
furpa,0.14285714285714285,6,6,CCGAAGTAGGAGCTTTGACG,0,1334788
furpa,0.14285714285714285,6,6,CCGAAATAAAGCGTTCTATG,0,1328963
furpa,0.14285714285714285,6,6,CCCTTAGGCGTAATTCTTGA,0,1342622
furpa,0.14285714285714285,6,6,CCCTGTTGTTCCCTGGCTTG,0,1331595
furpa,0.14285714285714285,6,6,CCCTGGATATAGATAATTGG,0,1314348
furpa,0.14285714285714285,6,6,CCCTATCAGCAAGCTCGGTC,0,1307526
furpa,0.14285714285714285,6,6,CCCGTTTTATAGTATTTAAC,0,1324664
furpa,0.14285714285714285,6,6,CCCGTAGAAATTCCTAGCAT,0,1294127
furpa,0.14285714285714285,6,6,CCCGCACAACCTGCTATCGA,0,1344920
furpa,0.14285714285714285,6,6,CCCGAACCGTGAGACCACAG,0,1357586
furpa,0.14285714285714285,6,6,CCCCGATAGTCCTGGCTAAA,0,1331361
furpa,0.14285714285714285,6,6,CCCCCCGTGCGTTTCACTAT,0,1330526
furpa,0.14285714285714285,6,6,CCCATTTCGAGCGGGGCCTA,0,1321205
furpa,0.14285714285714285,6,6,CCCAGGTCACATCAACAGGG,0,1309767
furpa,0.14285714285714285,6,6,CCATTTGGGGCGTGGCTCCT,0,1351150
furpa,0.14285714285714285,6,6,CCATTTGCCCTTTTAGTTGT,0,1341728
furpa,0.14285714285714285,6,6,CCATTCAGTGTGTGGAACTT,0,1276823
furpa,0.14285714285714285,6,6,CCATGTGGCCCGGCTTTGGT,0,1354052
furpa,0.14285714285714285,6,6,CCATCCTTTGTAGATCTGGC,0,1355070
furpa,0.14285714285714285,6,6,CCATCCGTTTGCGTCGCGTT,0,1294609
furpa,0.14285714285714285,6,6,CCATAAAGGGACAGTGCCCT,0,1286913
furpa,0.14285714285714285,6,6,CCAGTTCTCATGAGGCCCCA,0,1287903
furpa,0.14285714285714285,6,6,CCAGTGGCCCAAGATTACTC,0,1336833
furpa,0.14285714285714285,6,6,CCAGGCTAAGTGGTCTCAAC,0,1286681
furpa,0.14285714285714285,6,6,CCAGCAGCTAATTATCAATT,0,1353265
furpa,0.14285714285714285,6,6,CCACTCTAGGGATAGGCTCT,0,1309747
furpa,0.14285714285714285,6,6,CCACGGCGGGCGTGTGTAAT,0,1316198
furpa,0.14285714285714285,6,6,CCACGGAAAGTGTAGTAGAG,0,1293219
furpa,0.14285714285714285,6,6,CCACATTCGGGAAGCGTAGT,0,1282895
furpa,0.14285714285714285,6,6,CCAATAGTGCTCGAGAACAG,0,1357650
furpa,0.14285714285714285,6,6,CCAAGCGCGTTATCCAAAAA,0,1276993
furpa,0.14285714285714285,6,6,CCAACCGCAATGGGCCTTGT,0,1335064
furpa,0.14285714285714285,6,6,CATTGTTCAGGTGAAGAATA,0,1344112
furpa,0.14285714285714285,6,6,CATTGTGTGTCAACCTGAGT,0,1307585
furpa,0.14285714285714285,6,6,CATTGCGCAAGCGTAGTAGC,0,1300782
furpa,0.14285714285714285,6,6,CATGTCCCTTGCGCTGTTTA,0,1297088
furpa,0.14285714285714285,6,6,CATGGAGTCGATCCGGGGCT,0,1345076
furpa,0.14285714285714285,6,6,CATGCTCGGCAAGGCGCTCC,0,1339431
furpa,0.14285714285714285,6,6,CATGACCAGTTCTTTCATAA,0,1353405
furpa,0.14285714285714285,6,6,CATCTTAATGTCTGTTGGCA,0,1318628
furpa,0.14285714285714285,6,6,CATCGCTATGAAAGGCAAGT,0,1339158
furpa,0.14285714285714285,6,6,CATCCGCATCGTGCGGTTGA,0,1305522
furpa,0.14285714285714285,6,6,CATAGATCGTGCGGGGAGCT,0,1282602
furpa,0.14285714285714285,6,6,CATAATCGTAGGGGACAATC,0,1273539
furpa,0.14285714285714285,6,6,CATAATAATATAGTACTTGT,0,1285132
furpa,0.14285714285714285,6,6,CAGTTCTGGAGAAAGCAGAT,0,1271931
furpa,0.14285714285714285,6,6,CAGTTAAGATCGCCTCGGAT,0,1302793
furpa,0.14285714285714285,6,6,CAGTGGTCTACGATGAACGC,0,1282120
furpa,0.14285714285714285,6,6,CAGTGACCGTGGATCTGGAC,0,1303368
furpa,0.14285714285714285,6,6,CAGTGACCCACCAGTTCGAT,0,1332285
furpa,0.14285714285714285,6,6,CAGTAATGTCCCGGTCACCC,0,1288768
furpa,0.14285714285714285,6,6,CAGTAATCACCTGGACGCTC,0,1353913
furpa,0.14285714285714285,6,6,CAGGGGCATGCTATCCAGGA,0,1301389
furpa,0.14285714285714285,6,6,CAGGGAATTCTGCAGGTGAT,0,1298695
furpa,0.14285714285714285,6,6,CAGGCGATGATTCCGGGACT,0,1342353
furpa,0.14285714285714285,6,6,CAGGACAGCATGCACAAGGG,0,1343696
furpa,0.14285714285714285,6,6,CAGCGCGAGCACATTGATCT,0,1301422
furpa,0.14285714285714285,6,6,CAGCCCCGCTAGTTCTGTTG,0,1301192
furpa,0.14285714285714285,6,6,CAGCACAACTACGGGGGAGG,0,1300734
furpa,0.14285714285714285,6,6,CAGATTAACAAAAGGGAACA,0,1292751
furpa,0.14285714285714285,6,6,CAGAGGCTGGTCCAGTCAGC,0,1342723
furpa,0.14285714285714285,6,6,CAGACTAGGTCCGGAACAAG,0,1345568
furpa,0.14285714285714285,6,6,CAGACGAGCTTCTCACATAG,0,1344157
furpa,0.14285714285714285,6,6,CAGAAAATCCGGTAGACGGG,0,1329735
furpa,0.14285714285714285,6,6,CACTGTAAGTCAACATCACG,0,1338751
furpa,0.14285714285714285,6,6,CACTGCCTCAGGGTAGGATC,0,1308119
furpa,0.14285714285714285,6,6,CACGTCCCTTTAGGACCTGC,0,1305995
furpa,0.14285714285714285,6,6,CACGAAGTGAACAAATCAGA,0,1301006
furpa,0.14285714285714285,6,6,CACGAAACGGGCTAAGTGCT,0,1347055
furpa,0.14285714285714285,6,6,CACCGTGAAGATGGGTGTGA,0,1275509
furpa,0.14285714285714285,6,6,CACCCTGGGAGGGCAGGGGG,0,1343700
furpa,0.14285714285714285,6,6,CACCCCTATGCTTGTGACTT,0,1313392
furpa,0.14285714285714285,6,6,CACCACCATTTTGAGTCGTG,0,1321344
furpa,0.14285714285714285,6,6,CACATCGCGGAAATTGCACT,0,1357438
furpa,0.14285714285714285,6,6,CACAGTGGGCTCGCACCTTG,0,1299710
furpa,0.14285714285714285,6,6,CACAGCATTACGCTATTCGG,0,1346702
furpa,0.14285714285714285,6,6,CACACATGCTGACTCAACCA,0,1355974
furpa,0.14285714285714285,6,6,CACAATCCCCCGAGTGGGCA,0,1354108
furpa,0.14285714285714285,6,6,CACAAACTGTCGAGTCGTAA,0,1334987
furpa,0.14285714285714285,6,6,CAATTTTATCAGCAAGCCGT,0,1340980
furpa,0.14285714285714285,6,6,CAATTTAACCCACCCACTAA,0,1293590
furpa,0.14285714285714285,6,6,CAATTGTTACATAGATCATG,0,1305159
furpa,0.14285714285714285,6,6,CAATGTTGTCGGTCTAAGCA,0,1296123
furpa,0.14285714285714285,6,6,CAATGTAGGGTCCTCTTAGT,0,1343081
furpa,0.14285714285714285,6,6,CAATGCACAGATGCCAGGGA,0,1330601
furpa,0.14285714285714285,6,6,CAATCCTGATTTGACGACAA,0,1297539
furpa,0.14285714285714285,6,6,CAATATACAGATAAGTTGGA,0,1308298
furpa,0.14285714285714285,6,6,CAATAGGAATTAATCGAACA,0,1355050
furpa,0.14285714285714285,6,6,CAAGTGAGATTGTCCCCATA,0,1307347
furpa,0.14285714285714285,6,6,CAAGGGCCATCACTTTGCAA,0,1272855
furpa,0.14285714285714285,6,6,CAACTCGATACAGAGTTACA,0,1336368
furpa,0.14285714285714285,6,6,CAACTCAAAGACGCCCACTC,0,1333584
furpa,0.14285714285714285,6,6,CAACGTAGCCACATGGCGTC,0,1336270
furpa,0.14285714285714285,6,6,CAACGCCCTTTACGGTTCTC,0,1305308
furpa,0.14285714285714285,6,6,CAACCTGCGACTCGGCGATT,0,1326919
furpa,0.14285714285714285,6,6,CAACCAAGGTTCGAGGGCAT,0,1312528
furpa,0.14285714285714285,6,6,CAACATCTGTACAGTGGGTA,0,1275787
furpa,0.14285714285714285,6,6,CAACATACGCCCCGCAAAGC,0,1338458
furpa,0.14285714285714285,6,6,CAACACGGAGGGTTCACAAT,0,1317926
furpa,0.14285714285714285,6,6,CAACAATAAAACCTATCCCG,0,1309473
furpa,0.14285714285714285,6,6,CAAACTGTTTGAATGCGACC,0,1298268
furpa,0.14285714285714285,6,6,CAAACCTGCATATGACGTAT,0,1314351
furpa,0.14285714285714285,6,6,ATTTGGACTGGAAACTCAAA,0,1331163
furpa,0.14285714285714285,6,6,ATTTGCTGCTACAAGTTGTG,0,1304847
furpa,0.14285714285714285,6,6,ATTTGATTCTTCACAACGGA,0,1277098
furpa,0.14285714285714285,6,6,ATTTAGGTATATTTCAAATA,0,1322039
furpa,0.14285714285714285,6,6,ATTGTTGTGTGCCAGAACAG,0,1326342
furpa,0.14285714285714285,6,6,ATTGGGGGAAACACTTTCTA,0,1332052
furpa,0.14285714285714285,6,6,ATTGGCATAGCGTTAACCTC,0,1318118
furpa,0.14285714285714285,6,6,ATTGCGGCTGTACGTGGGAG,0,1314422
furpa,0.14285714285714285,6,6,ATTGCGAAAAGGTATTAAAC,0,1317084
furpa,0.14285714285714285,6,6,ATTGCAATTAGGTCTTCAAG,0,1351261
furpa,0.14285714285714285,6,6,ATTGAGGTGTGGATTTTAAG,0,1317373
furpa,0.14285714285714285,6,6,ATTGAATGCAAGCATCATTG,0,1330065
furpa,0.14285714285714285,6,6,ATTGAATAGATGTGCCTGTA,0,1290288
furpa,0.14285714285714285,6,6,ATTCTGGACAGCAAATTGAT,0,1299137
furpa,0.14285714285714285,6,6,ATTCGTAAAATTGTTTTAGT,0,1345673
furpa,0.14285714285714285,6,6,ATTCGCTTGCCTGGGCTGGC,0,1339084
furpa,0.14285714285714285,6,6,ATTCGATTCAAATGTCTGTA,0,1306974
furpa,0.14285714285714285,6,6,ATTCCGGGTTCGGGCTGGAC,0,1294886
furpa,0.14285714285714285,6,6,ATTATGGCCCGGGGATCATG,0,1346773
furpa,0.14285714285714285,6,6,ATTATAGGCCAGGGCGGTGT,0,1278373
furpa,0.14285714285714285,6,6,ATTATAAGCTCACAGCGGAT,0,1327147
furpa,0.14285714285714285,6,6,ATTAGCCTCGGAGCGAAACT,0,1317752
furpa,0.14285714285714285,6,6,ATGTTAGTTCAAGTATATAT,0,1344394
furpa,0.14285714285714285,6,6,ATGTCGCCTTGGCTGGAATA,0,1347361
furpa,0.14285714285714285,6,6,ATGTCCATCCAACCGTATAA,0,1284863
furpa,0.14285714285714285,6,6,ATGTCAGAGGCGCTACAACC,0,1324774
furpa,0.14285714285714285,6,6,ATGGTGGCAGACTCTAAGTA,0,1305615
furpa,0.14285714285714285,6,6,ATGGTGAAACAACGGGGTAC,0,1351736
furpa,0.14285714285714285,6,6,ATGGGTCCACATGGCAGTCC,0,1277111
furpa,0.14285714285714285,6,6,ATGGGTATTCTGACGGCGTG,0,1352112
furpa,0.14285714285714285,6,6,ATGGCTGCGCAAGCCGACCC,0,1288800
furpa,0.14285714285714285,6,6,ATGGCTACGCGACCCTGCGA,0,1329009
furpa,0.14285714285714285,6,6,ATGCTCACTTGAGGAATTAG,0,1273914
furpa,0.14285714285714285,6,6,ATGCGGTTGAAGGATACCGT,0,1333518
furpa,0.14285714285714285,6,6,ATGCCCGCAGGGCACAGGTG,0,1323807
furpa,0.14285714285714285,6,6,ATGAGCTTGAACACTTTTGA,0,1350890
furpa,0.14285714285714285,6,6,ATGAGAAGCCTTTCTCCGAG,0,1293183
furpa,0.14285714285714285,6,6,ATGACCTAGCCTATGCGACC,0,1335853
furpa,0.14285714285714285,6,6,ATCTCACAGATCTTTAGTCA,0,1324632
furpa,0.14285714285714285,6,6,ATCTAGGTACTAAAACGCGA,0,1310901
furpa,0.14285714285714285,6,6,ATCTAAGCCTAGTTGCCCTT,0,1356010
furpa,0.14285714285714285,6,6,ATCGGTACGTCCCCGTACCG,0,1348107
furpa,0.14285714285714285,6,6,ATCGGTAACGTATAAACTTC,0,1312409
furpa,0.14285714285714285,6,6,ATCGGGTGCTAAGCCGCGGA,0,1275796
furpa,0.14285714285714285,6,6,ATCGGCACAGAGCCGGATGT,0,1342254
furpa,0.14285714285714285,6,6,ATCGCGTGCTCTCTAAACAC,0,1345549
furpa,0.14285714285714285,6,6,ATCGCGCGGGACAATTAACA,0,1274795
furpa,0.14285714285714285,6,6,ATCGCCAAGTCCCTTCTGCG,0,1303457
furpa,0.14285714285714285,6,6,ATCGCATGATGTATCTGTAC,0,1302689
furpa,0.14285714285714285,6,6,ATCCTGTATGTAAGTTGACC,0,1357615
furpa,0.14285714285714285,6,6,ATCCGGCAACGTGAATCCGT,0,1349926
furpa,0.14285714285714285,6,6,ATCCCTTCGACTCTATCGCA,0,1345805
furpa,0.14285714285714285,6,6,ATCCCTGACGCATCATCGCG,0,1281178
furpa,0.14285714285714285,6,6,ATCCCTATAACTTCCTGTGC,0,1339420
furpa,0.14285714285714285,6,6,ATCCCCTCATTCGTCACTAT,0,1287946
furpa,0.14285714285714285,6,6,ATCCCATGCTTGAGCAGAGG,0,1271777
furpa,0.14285714285714285,6,6,ATCCATTATGCGAGAACTAT,0,1285300
furpa,0.14285714285714285,6,6,ATCCAAAGGGAGCACTCATA,0,1305436
furpa,0.14285714285714285,6,6,ATCAAATACAGCATTATTCT,0,1271570
furpa,0.14285714285714285,6,6,ATATAGGGAGTTCTTGGTCC,0,1287618
furpa,0.14285714285714285,6,6,ATAGTTGTCTTCGGGTAGCG,0,1287753
furpa,0.14285714285714285,6,6,ATAGTCGTGGGTCTTCAGCA,0,1336497
furpa,0.14285714285714285,6,6,ATAGGACTACGATAACCCAC,0,1278116
furpa,0.14285714285714285,6,6,ATAGAAGGGAAGTGCTCTAG,0,1351608
furpa,0.14285714285714285,6,6,ATACTTACGCATAAACGGTA,0,1312549
furpa,0.14285714285714285,6,6,ATACGCCCCTACTCACTCTC,0,1312141
furpa,0.14285714285714285,6,6,ATACCTATTACGGACTATGC,0,1339567
furpa,0.14285714285714285,6,6,ATAATTCTCAAAGGGTCCTT,0,1301643
furpa,0.14285714285714285,6,6,ATAATGCCAACGCGTGGTCA,0,1357633
furpa,0.14285714285714285,6,6,ATAATCCGCTCGACTTTTGG,0,1338041
furpa,0.14285714285714285,6,6,ATAAGTATGTGTTTGAACTG,0,1354722
furpa,0.14285714285714285,6,6,ATAAACCAACGAGTGAATCC,0,1357114
furpa,0.14285714285714285,6,6,ATAAAAGGCCTACAGGGTAC,0,1290409
furpa,0.14285714285714285,6,6,AGTTTTGTAGTTCGTGGACT,0,1284304
furpa,0.14285714285714285,6,6,AGTTTCTTCGGGGCGATCGT,0,1321582
furpa,0.14285714285714285,6,6,AGTTGAGTGTGATACGATGT,0,1293985
furpa,0.14285714285714285,6,6,AGTTGACCCGGACCTCACTA,0,1307578
furpa,0.14285714285714285,6,6,AGTTCTCTCGCAGAGATTAC,0,1283163
furpa,0.14285714285714285,6,6,AGTTACAGCTCTTGTCACGA,0,1273879
furpa,0.14285714285714285,6,6,AGTGTTTCCCTCTCATTCGC,0,1343145
furpa,0.14285714285714285,6,6,AGTGTCAGTTGGTTGCCACT,0,1343366
furpa,0.14285714285714285,6,6,AGTGGGTGTGGTCCAAGTTT,0,1330970
furpa,0.14285714285714285,6,6,AGTGCTGTAGATCGGTGTGT,0,1326293
furpa,0.14285714285714285,6,6,AGTGCAAGATCATACACGCT,0,1287502
furpa,0.14285714285714285,6,6,AGTGCAACGCTGCTCCGGAA,0,1303878
furpa,0.14285714285714285,6,6,AGTGATTCTGAGATTATAGA,0,1311218
furpa,0.14285714285714285,6,6,AGTGAAGGGCCACTGAGAAT,0,1333064
furpa,0.14285714285714285,6,6,AGTCGGGCTGCATATTATTA,0,1304298
furpa,0.14285714285714285,6,6,AGTCGGAGATAAGTGCTTTA,0,1304664
furpa,0.14285714285714285,6,6,AGTCAGGTCTGCACTTCTCT,0,1341845
furpa,0.14285714285714285,6,6,AGTCAACGCGAAACGCTGTT,0,1273833
furpa,0.14285714285714285,6,6,AGTATAAATGTGAGAGTATC,0,1343333
furpa,0.14285714285714285,6,6,AGTAGTATGTTGCACTTTAG,0,1340319
furpa,0.14285714285714285,6,6,AGTAGGTAGGCTATAAGGAC,0,1313917
furpa,0.14285714285714285,6,6,AGTAAGTGATGGACCTCGAA,0,1353056
furpa,0.14285714285714285,6,6,AGTAAGGTAAATTGTGGAAT,0,1310234
furpa,0.14285714285714285,6,6,AGGTTAGAGGACAGGGGGCA,0,1284234
furpa,0.14285714285714285,6,6,AGGTGTAGCTGAGAACAATA,0,1301629
furpa,0.14285714285714285,6,6,AGGTCTTTCCGATTATTGTT,0,1293516
furpa,0.14285714285714285,6,6,AGGTCTTATGGTCCTAGTAC,0,1321740
furpa,0.14285714285714285,6,6,AGGTCGTAGATACCTGATGG,0,1344891
furpa,0.14285714285714285,6,6,AGGGGGTAAAGCACCGAGGT,0,1347820
furpa,0.14285714285714285,6,6,AGGGGCGGACTACACAATCA,0,1301638
furpa,0.14285714285714285,6,6,AGGGCTACTGAACACGTAAA,0,1311030
furpa,0.14285714285714285,6,6,AGGGCCAACGGACTTTGGAT,0,1332566
furpa,0.14285714285714285,6,6,AGGGAGCTAACGGTCCCTCA,0,1314676
furpa,0.14285714285714285,6,6,AGGCTTGCGATCCTTTGGTT,0,1279943
furpa,0.14285714285714285,6,6,AGGCTATCTGTGATTCTGGA,0,1305346
furpa,0.14285714285714285,6,6,AGGCCTAGGGCGTACAAAAG,0,1327112
furpa,0.14285714285714285,6,6,AGGCCCTTCCCCTGCTCTCC,0,1338086
furpa,0.14285714285714285,6,6,AGGATACGCCCGACACGGAG,0,1287577
furpa,0.14285714285714285,6,6,AGGAGTTACCTTTAGACATG,0,1310225
furpa,0.14285714285714285,6,6,AGGAGCTACTTAGTGGTAAA,0,1343031
furpa,0.14285714285714285,6,6,AGGACTGCGTGGGTCTAACT,0,1339264
furpa,0.14285714285714285,6,6,AGGACCTGGGTCTGTGGGGC,0,1319255
furpa,0.14285714285714285,6,6,AGGAAAGAGATTGTTGAAAA,0,1344092
furpa,0.14285714285714285,6,6,AGGAAAAGGTAAAATCATCA,0,1299438
furpa,0.14285714285714285,6,6,AGCTTAACCCATGAGTATTC,0,1324772
furpa,0.14285714285714285,6,6,AGCTCTTTACTTAGGCAGAT,0,1347843
furpa,0.14285714285714285,6,6,AGCTCTGGTTAGGGCCACAT,0,1284254
furpa,0.14285714285714285,6,6,AGCTCTGCGTGATAGCTCTC,0,1311517
furpa,0.14285714285714285,6,6,AGCTACACAGGATTATATTC,0,1279860
furpa,0.14285714285714285,6,6,AGCGTCCGTCTAGAAAGGAA,0,1322705
furpa,0.14285714285714285,6,6,AGCGGTAAATCTTAGCAAGA,0,1302531
furpa,0.14285714285714285,6,6,AGCGAACTACGCAGCCGAGG,0,1339631
furpa,0.14285714285714285,6,6,AGCCTCGTCCAATTTATCGT,0,1293995
furpa,0.14285714285714285,6,6,AGCCTACGTCGCGGACCGGG,0,1357320
furpa,0.14285714285714285,6,6,AGCCGGGTGAACAGACGAAA,0,1311292
furpa,0.14285714285714285,6,6,AGCCCGTTGGCAGCGTGTCG,0,1300334
furpa,0.14285714285714285,6,6,AGCCCCCATTCTGGCGCCAC,0,1342045
furpa,0.14285714285714285,6,6,AGCCCACGCATATTATCTTA,0,1321573
furpa,0.14285714285714285,6,6,AGCCACCAGTCCGCGGGGGT,0,1337433
furpa,0.14285714285714285,6,6,AGCCACACTACATAGGGGGA,0,1332315
furpa,0.14285714285714285,6,6,AGCCAACCCCTTTGTAACAG,0,1301623
furpa,0.14285714285714285,6,6,AGCATGAGCGATGTACTATA,0,1328643
furpa,0.14285714285714285,6,6,AGCAACGAACATTGTTACTG,0,1346840
furpa,0.14285714285714285,6,6,AGATTTATGTTGTGTTGTTT,0,1273765
furpa,0.14285714285714285,6,6,AGATGCTGGGCCAAGGAAAT,0,1292237
furpa,0.14285714285714285,6,6,AGATCCTCAGACTTGTCCTC,0,1284310
furpa,0.14285714285714285,6,6,AGATAATTCGGGAGCTATCT,0,1294531
furpa,0.14285714285714285,6,6,AGATAATGGAAGGGCATCCG,0,1309371
furpa,0.14285714285714285,6,6,AGAGGGAGGTTCCTCCACCT,0,1305351
furpa,0.14285714285714285,6,6,AGAGGCGGCTTGCTCAAAAC,0,1312776
furpa,0.14285714285714285,6,6,AGAGCCTAACGAGATCTACT,0,1324295
furpa,0.14285714285714285,6,6,AGAGCATTTTACGGAATATC,0,1338816
furpa,0.14285714285714285,6,6,AGAGAGTTTGACTTCCAACC,0,1292466
furpa,0.14285714285714285,6,6,AGAATTCTTCGGCGCCATCC,0,1324708
furpa,0.14285714285714285,6,6,AGAATTATAGTACCGCATCT,0,1356645
furpa,0.14285714285714285,6,6,AGAATCGCTGTACCCTCTCG,0,1303278
furpa,0.14285714285714285,6,6,AGAACTGTTATTGGGACATA,0,1303621
furpa,0.14285714285714285,6,6,AGAACCAACTGGGAAAACAG,0,1292640
furpa,0.14285714285714285,6,6,AGAAATAGTGTGCACACTAC,0,1346917
furpa,0.14285714285714285,6,6,AGAAAGAAGTACGGGCTTGG,0,1278496
furpa,0.14285714285714285,6,6,AGAAACACGAACTTTGGGAC,0,1274660
furpa,0.14285714285714285,6,6,ACTTTTAAGGAACCATATTG,0,1328744
furpa,0.14285714285714285,6,6,ACTTGTCGCTAGGGGGCTTA,0,1292300
furpa,0.14285714285714285,6,6,ACTTAGTATAAGAATTAATA,0,1337348
furpa,0.14285714285714285,6,6,ACTTAGGCGGTTTTTTAACA,0,1287527
furpa,0.14285714285714285,6,6,ACTGGGTGGGGCCAGACGGG,0,1272269
furpa,0.14285714285714285,6,6,ACTGAGGTCCTAACCGCGAT,0,1307323
furpa,0.14285714285714285,6,6,ACTGAGGGACACCTCGTGAA,0,1280375
furpa,0.14285714285714285,6,6,ACTCTCCGCTTATGTTAGTG,0,1337326
furpa,0.14285714285714285,6,6,ACTCGTGCAAATATCAGCCT,0,1311289
furpa,0.14285714285714285,6,6,ACTCGCGGCTATGTAGGATA,0,1309523
furpa,0.14285714285714285,6,6,ACTCCTTATAACGAAATGTT,0,1283006
furpa,0.14285714285714285,6,6,ACTCCGGATGATGAGGCTGC,0,1292727
furpa,0.14285714285714285,6,6,ACTATGGGAGGAACGGGCCA,0,1354973
furpa,0.14285714285714285,6,6,ACTAGATAGGGTGTGAAAGG,0,1295292
furpa,0.14285714285714285,6,6,ACTACCACCGAGACGAAACT,0,1314379
furpa,0.14285714285714285,6,6,ACGTTATGCTCTCTGACGCC,0,1304512
furpa,0.14285714285714285,6,6,ACGTGATGGGGACCTATCCC,0,1319105
furpa,0.14285714285714285,6,6,ACGTAGGTAGGAGACTCCCC,0,1296820
furpa,0.14285714285714285,6,6,ACGTAGGAAAATCTTGCAAG,0,1275352
furpa,0.14285714285714285,6,6,ACGGGGTCAAGCGCAGAGCT,0,1301257
furpa,0.14285714285714285,6,6,ACGGCCGATCGCGCCAAAAA,0,1292293
furpa,0.14285714285714285,6,6,ACGCTTATTCAGCGATGATT,0,1326073
furpa,0.14285714285714285,6,6,ACGCTCGTACTTAGAGGCCC,0,1293494
furpa,0.14285714285714285,6,6,ACGCGTCAAATAGGGATAAT,0,1289547
furpa,0.14285714285714285,6,6,ACGCGGCGAGAGGCGCTAGC,0,1324386
furpa,0.14285714285714285,6,6,ACGCCTTGTAAGAGACGGGA,0,1339219
furpa,0.14285714285714285,6,6,ACGCCTAGTACGATTGTTTA,0,1328525
furpa,0.14285714285714285,6,6,ACGCCCAGCTTGAGCTTGAA,0,1334081
furpa,0.14285714285714285,6,6,ACGCCAAAAGCCTCTCAAAC,0,1355915
furpa,0.14285714285714285,6,6,ACGATGGCATGCCTACTTCT,0,1294873
furpa,0.14285714285714285,6,6,ACGAGTCCTAGGCCTCTCAT,0,1348317
furpa,0.14285714285714285,6,6,ACGAGGCTTGAAACACAAAT,0,1323579
furpa,0.14285714285714285,6,6,ACGACGGGGCGCATCCGCTT,0,1301511
furpa,0.14285714285714285,6,6,ACGACCTCGCGCCTTAAACT,0,1280751
furpa,0.14285714285714285,6,6,ACGAAGGTCATCTGCAAGGA,0,1320050
furpa,0.14285714285714285,6,6,ACGAAGCTTTTTGTACAAGC,0,1344460
furpa,0.14285714285714285,6,6,ACCTTGATAAAGCTGGTATT,0,1286973
furpa,0.14285714285714285,6,6,ACCTGATCATGTTCACACGT,0,1272663
furpa,0.14285714285714285,6,6,ACCTATTGTTTGATCCGTTC,0,1291040
furpa,0.14285714285714285,6,6,ACCTAGAATTCGAAGTATTT,0,1354087
furpa,0.14285714285714285,6,6,ACCGTACAAATCCATATAGA,0,1306804
furpa,0.14285714285714285,6,6,ACCGTAATATGTGCGTACGG,0,1347845
furpa,0.14285714285714285,6,6,ACCGGGGGTCAGCCCAGTAA,0,1304872
furpa,0.14285714285714285,6,6,ACCGGCTCTTGACAGGAGGG,0,1280856
furpa,0.14285714285714285,6,6,ACCGCCAAAAATCACTCTTG,0,1315440
furpa,0.14285714285714285,6,6,ACCGACATTGTGCCAATCTC,0,1288597
furpa,0.14285714285714285,6,6,ACCCTTGTCGGACTCATTTA,0,1337817
furpa,0.14285714285714285,6,6,ACCCTCAAGCGATTCACACT,0,1337171
furpa,0.14285714285714285,6,6,ACCCGCATACCTCACATTTC,0,1357466
furpa,0.14285714285714285,6,6,ACCCCTGGCGAGTCGAGCAG,0,1300747
furpa,0.14285714285714285,6,6,ACCCATTTTTGAGAACTGTA,0,1322762
furpa,0.14285714285714285,6,6,ACCAGGGCGGGCTCATCGGC,0,1341559
furpa,0.14285714285714285,6,6,ACCAGATCTCGTCGCGTATA,0,1322517
furpa,0.14285714285714285,6,6,ACCACTTTGAGTCAATGGCC,0,1334158
furpa,0.14285714285714285,6,6,ACCACTGATATACTCGGGGG,0,1294155
furpa,0.14285714285714285,6,6,ACCACGCCTCCATTCTGGCT,0,1299652
furpa,0.14285714285714285,6,6,ACCACCGTAGGGTCGCTGCT,0,1290617
furpa,0.14285714285714285,6,6,ACATCTAAATTATGACCGCA,0,1354648
furpa,0.14285714285714285,6,6,ACAGTTGCATAGCGACATCA,0,1291139
furpa,0.14285714285714285,6,6,ACAGTCGTGTTCTCTACGTG,0,1325224
furpa,0.14285714285714285,6,6,ACAGTATTTCAGGTCGATGC,0,1280373
furpa,0.14285714285714285,6,6,ACAGCAATGCGGTAACATAT,0,1308096
furpa,0.14285714285714285,6,6,ACAGATTCCGTCTCCCGCTA,0,1274247
furpa,0.14285714285714285,6,6,ACAGAAGAGACGTTTACGAT,0,1350836
furpa,0.14285714285714285,6,6,ACACTTCCCTTGCTAGTGAT,0,1298062
furpa,0.14285714285714285,6,6,ACACTGTCATTCCTGTTGCA,0,1354765
furpa,0.14285714285714285,6,6,ACACCGCGACCCGAGGCAAC,0,1322470
furpa,0.14285714285714285,6,6,ACACCGATGTTATGCCCAGA,0,1306451
furpa,0.14285714285714285,6,6,ACAATGAACAGGCCCGGATG,0,1322494
furpa,0.14285714285714285,6,6,ACAATAGATTGGTGGTCTGG,0,1304624
furpa,0.14285714285714285,6,6,ACAATAAAGGGAGATTCGAA,0,1335697
furpa,0.14285714285714285,6,6,ACAAGTCGTGCCGTCCGGTC,0,1334766
furpa,0.14285714285714285,6,6,AATTTGTAGCCCATTAATTC,0,1288627
furpa,0.14285714285714285,6,6,AATTGTCGTAGGCTACATAC,0,1335577
furpa,0.14285714285714285,6,6,AATTCCCGAGGTCCCAGAGA,0,1341556
furpa,0.14285714285714285,6,6,AATTATGGGCTTGCGGGCTA,0,1306154
furpa,0.14285714285714285,6,6,AATTACTCGCAAGAACCGGA,0,1341479
furpa,0.14285714285714285,6,6,AATTAAGGGAGCAATGGGAT,0,1316990
furpa,0.14285714285714285,6,6,AATGTGCAGGCGGAGGTATG,0,1344565
furpa,0.14285714285714285,6,6,AATGGGTGTGAGGACGGCCA,0,1330934
furpa,0.14285714285714285,6,6,AATGCTTTAGAGAGAACTCG,0,1272268
furpa,0.14285714285714285,6,6,AATGAGTTGACGCCTTCGGG,0,1315492
furpa,0.14285714285714285,6,6,AATCAGCCTACTGTTAGCCA,0,1320335
furpa,0.14285714285714285,6,6,AATCAATTTGCTCTGGTGAC,0,1313646
furpa,0.14285714285714285,6,6,AATAGGGGGATGGCTAATTT,0,1309773
furpa,0.14285714285714285,6,6,AAGTTCTTTCGTCGCCGGCA,0,1301705
furpa,0.14285714285714285,6,6,AAGTTCGGCGACCCCGAGCC,0,1312506
furpa,0.14285714285714285,6,6,AAGTGAGTCGATTCTGCGGG,0,1346536
furpa,0.14285714285714285,6,6,AAGTCCGGCTTAAGAAATAC,0,1313432
furpa,0.14285714285714285,6,6,AAGTCCACAACATGGCACAA,0,1278346
furpa,0.14285714285714285,6,6,AAGGTTTGTAGGCAGTCCGT,0,1309495
furpa,0.14285714285714285,6,6,AAGGTTTGTAACATCTACTT,0,1287399
furpa,0.14285714285714285,6,6,AAGGGGCTCGAGTAGGTTAG,0,1308981
furpa,0.14285714285714285,6,6,AAGGCTCTTTACCGGCCTTG,0,1338043
furpa,0.14285714285714285,6,6,AAGGCAATCCAAGGTAATAA,0,1290556
furpa,0.14285714285714285,6,6,AAGCGACCGAGTGGTATTAG,0,1302920
furpa,0.14285714285714285,6,6,AAGACAGCACGAGTGACATA,0,1285266
furpa,0.14285714285714285,6,6,AAGAAAATTTGCCCTTGTAC,0,1310591
furpa,0.14285714285714285,6,6,AACTTGTGGGCTAGGGCACT,0,1333867
furpa,0.14285714285714285,6,6,AACTTGGATCATCAATAAGG,0,1316280
furpa,0.14285714285714285,6,6,AACGCAATCTAGGTGCCACA,0,1315311
furpa,0.14285714285714285,6,6,AACGAATTGAGGAGTAAGGG,0,1352249
furpa,0.14285714285714285,6,6,AACGAACTTGTCCGGCGAAA,0,1336040
furpa,0.14285714285714285,6,6,AACCTTGGGTTTTGAAGCCC,0,1332450
furpa,0.14285714285714285,6,6,AACCCTAGGAGAAATTAGAG,0,1352828
furpa,0.14285714285714285,6,6,AACAGTCCGGGATACGGATC,0,1301635
furpa,0.14285714285714285,6,6,AACACGTCAATTATCCGAGA,0,1319250
furpa,0.14285714285714285,6,6,AACAAACTCGCTCATGGCTT,0,1338741
furpa,0.14285714285714285,6,6,AAATTTGCCGTGGACGGCTG,0,1302924
furpa,0.14285714285714285,6,6,AAATTATCACGGGGGGTGCT,0,1354850
furpa,0.14285714285714285,6,6,AAATGATAGTGCTATCCGAA,0,1344203
furpa,0.14285714285714285,6,6,AAATCTCATTATGAGGAATG,0,1339898
furpa,0.14285714285714285,6,6,AAAGGGCTAAAAACGTTAAT,0,1272205
furpa,0.14285714285714285,6,6,AAAGCTTAAAAGTCTAGTGT,0,1272335
furpa,0.14285714285714285,6,6,AAACTTCAGGTACATAACTA,0,1335326
furpa,0.14285714285714285,6,6,AAACGCTCACCTTCCCTGTA,0,1289977
furpa,0.14285714285714285,6,6,AAACCTCGTAAACGGAAGGT,0,1345824
furpa,0.14285714285714285,6,6,AAAATTAGCGAATGTTCACA,0,1289668
furpa,0.16666666666666666,5,5,TTTTTAGGTCAGTTGCACGG,0,1284510
furpa,0.16666666666666666,5,5,TTTGTGGCTGAGCGGTCCAG,0,1281029
furpa,0.16666666666666666,5,5,TTTGTCTTAGATTCCGTTCT,0,1344011
furpa,0.16666666666666666,5,5,TTTGTCGGCGCCAAAACCAG,0,1332999
furpa,0.16666666666666666,5,5,TTTGTCGCGCATGGCCGTGT,0,1314991
furpa,0.16666666666666666,5,5,TTTGGTTTTTGTCCTTCTCG,0,1355747
furpa,0.16666666666666666,5,5,TTTGCTACCACGGAGAAACC,0,1316462
furpa,0.16666666666666666,5,5,TTTGATTAAGCAATTATTTT,0,1355370
furpa,0.16666666666666666,5,5,TTTGACAATTCATTGGAAAC,0,1285208
furpa,0.16666666666666666,5,5,TTTCTTGTGCATACTTGATC,0,1273024
furpa,0.16666666666666666,5,5,TTTCTTGCGCCCGAAAGTCT,0,1328481
furpa,0.16666666666666666,5,5,TTTCGTTAAGACCGTCTGGG,0,1290534
furpa,0.16666666666666666,5,5,TTTCGGTAGGTAGCTAAGTA,0,1310155
furpa,0.16666666666666666,5,5,TTTCCGCGAGGGGATTGTCA,0,1341685
furpa,0.16666666666666666,5,5,TTTCCCACTTTACAAGCCTC,0,1301204
furpa,0.16666666666666666,5,5,TTTCATTCGATCTCTCCGAA,0,1323811
furpa,0.16666666666666666,5,5,TTTCAGGTTTTGCTCCAAGG,0,1299963
furpa,0.16666666666666666,5,5,TTTCACAGCAAAAGCTGGCC,0,1300737
furpa,0.16666666666666666,5,5,TTTAGGTCCCCATGTTACAC,0,1297198
furpa,0.16666666666666666,5,5,TTTACGCGGTTCAAATACAT,0,1304985
furpa,0.16666666666666666,5,5,TTTACCCAGTAAGGCGAGCC,0,1331741
furpa,0.16666666666666666,5,5,TTTACAGAAGTACTATCTTT,0,1285334
furpa,0.16666666666666666,5,5,TTGTGAGGTACGAATAGTAT,0,1356977
furpa,0.16666666666666666,5,5,TTGTCTGATAGGACTCTGGT,0,1277958
furpa,0.16666666666666666,5,5,TTGTAGCTCCGATACATCGG,0,1280701
furpa,0.16666666666666666,5,5,TTGGTGGTGGCTGGAGTTCT,0,1313172
furpa,0.16666666666666666,5,5,TTGGTAAGAACTATAATTCG,0,1321186
furpa,0.16666666666666666,5,5,TTGGGTTAAACAGTTCAGTC,0,1276815
furpa,0.16666666666666666,5,5,TTGGGTCACGCATATTCCAT,0,1336743
furpa,0.16666666666666666,5,5,TTGGCTGAGGATCGGTGAAC,0,1344452
furpa,0.16666666666666666,5,5,TTGGCTCGTCAACGCTTCGC,0,1314016
furpa,0.16666666666666666,5,5,TTGGCGATCGACGGCGGTAT,0,1335367
furpa,0.16666666666666666,5,5,TTGGCCGCCCACCATGGGTC,0,1274546
furpa,0.16666666666666666,5,5,TTGGACGACCTAGCAACCGT,0,1319213
furpa,0.16666666666666666,5,5,TTGCTACGGCTTGGCGGTGA,0,1298934
furpa,0.16666666666666666,5,5,TTGCGCGGGGCGGTGAAAAG,0,1292464
furpa,0.16666666666666666,5,5,TTGCCCACCTGTAGGTTATT,0,1272199
furpa,0.16666666666666666,5,5,TTGCCAGATCCTGACTGCCG,0,1308710
furpa,0.16666666666666666,5,5,TTGATAGCTTCATGATCGCA,0,1329568
furpa,0.16666666666666666,5,5,TTGATAAAGTGCACCGACGT,0,1300380
furpa,0.16666666666666666,5,5,TTGAGGTGGCAAAACTAGAA,0,1294694
furpa,0.16666666666666666,5,5,TTGAGGATTTATGAGAAATG,0,1320915
furpa,0.16666666666666666,5,5,TTGACGGAAGCTTGTGGCCA,0,1280059
furpa,0.16666666666666666,5,5,TTGACAATCTTTGGTTGGTA,0,1353701
furpa,0.16666666666666666,5,5,TTCTCGCACGGTTGGCGTTT,0,1320280
furpa,0.16666666666666666,5,5,TTCTAGCGATCGTGAGGTTT,0,1343560
furpa,0.16666666666666666,5,5,TTCTACCGGCCTAGGGGAGG,0,1289257
furpa,0.16666666666666666,5,5,TTCGTGTGCACAGTTACTAC,0,1283402
furpa,0.16666666666666666,5,5,TTCGTGCAGGACTCCTTGGC,0,1340640
furpa,0.16666666666666666,5,5,TTCGCTTTTAGTTTTCGAGA,0,1285996
furpa,0.16666666666666666,5,5,TTCGAGTCTATCGCTATTGT,0,1321677
furpa,0.16666666666666666,5,5,TTCCTTCGGCTTCGGATATG,0,1342244
furpa,0.16666666666666666,5,5,TTCCGCTCGAACTCAATATT,0,1299009
furpa,0.16666666666666666,5,5,TTCCGCAGTCAAGTGATAAA,0,1303737
furpa,0.16666666666666666,5,5,TTCCGACACTGCCGGGACAA,0,1279468
furpa,0.16666666666666666,5,5,TTCATCGTCGGCAACGACCG,0,1273247
furpa,0.16666666666666666,5,5,TTCAGTCAGGCTCCTTGTCG,0,1335816
furpa,0.16666666666666666,5,5,TTCAGCTGATTGTGGTCTTC,0,1272191
furpa,0.16666666666666666,5,5,TTCAGATTCTGAGTGCATCA,0,1343175
furpa,0.16666666666666666,5,5,TTCAAGTAGTCAGAGGTTTT,0,1284182
furpa,0.16666666666666666,5,5,TTATGCTACACTAGATATAA,0,1351841
furpa,0.16666666666666666,5,5,TTATCGGTGGTCCGTTCAGA,0,1302885
furpa,0.16666666666666666,5,5,TTATCATCAACACGGTTTCA,0,1276756
furpa,0.16666666666666666,5,5,TTATCACATCATTCCGAAGG,0,1299450
furpa,0.16666666666666666,5,5,TTATAGGTTTAAGCTGTGAA,0,1273080
furpa,0.16666666666666666,5,5,TTAGTTGTAAGGTAAAGGTA,0,1306709
furpa,0.16666666666666666,5,5,TTAGGTTGCGTCTTAGCACA,0,1332932
furpa,0.16666666666666666,5,5,TTAGGGCGGATATCTACGTA,0,1317118
furpa,0.16666666666666666,5,5,TTAGGACCGGGGTCATGCGG,0,1337606
furpa,0.16666666666666666,5,5,TTAGCCAGGCTCCCATGGAA,0,1316456
furpa,0.16666666666666666,5,5,TTAGCAGCATGACCCTGGCG,0,1336219
furpa,0.16666666666666666,5,5,TTAGATTCCAGGGACCCCAG,0,1319992
furpa,0.16666666666666666,5,5,TTAGAGGGTCTGGTTTTGTT,0,1340131
furpa,0.16666666666666666,5,5,TTAGAGACGACAACGCTCAT,0,1278612
furpa,0.16666666666666666,5,5,TTACCAGCGATAGCAACTGG,0,1308051
furpa,0.16666666666666666,5,5,TTACCACTCGGTGTGAGGAA,0,1355640
furpa,0.16666666666666666,5,5,TTACATGTAGCGCGGTCTAA,0,1284867
furpa,0.16666666666666666,5,5,TTACACAACTGTCGTGTACT,0,1291280
furpa,0.16666666666666666,5,5,TTAATGGAAAGGCTTCCGGG,0,1304257
furpa,0.16666666666666666,5,5,TTAATGCGGCCTAGTATTGA,0,1275043
furpa,0.16666666666666666,5,5,TTAACCACGGGGCGAATACT,0,1306416
furpa,0.16666666666666666,5,5,TTAACATTGCATGATGATAA,0,1306612
furpa,0.16666666666666666,5,5,TGTTGGAACTTACTCGCTAC,0,1334124
furpa,0.16666666666666666,5,5,TGTTGCTATCGCTGCAGGTA,0,1316377
furpa,0.16666666666666666,5,5,TGTGTACTAGCTAACAGTCT,0,1335141
furpa,0.16666666666666666,5,5,TGTGGTACGTATAGTGGTAG,0,1293508
furpa,0.16666666666666666,5,5,TGTCGAGTCGATAGTTTTTC,0,1320330
furpa,0.16666666666666666,5,5,TGTCAGTTGACGATACTAGA,0,1322859
furpa,0.16666666666666666,5,5,TGTATCCGCGGTCAATGCCA,0,1297508
furpa,0.16666666666666666,5,5,TGTACGGCACGACCACTGCT,0,1350748
furpa,0.16666666666666666,5,5,TGGTGGGGTCTGCCATATAA,0,1321865
furpa,0.16666666666666666,5,5,TGGTCTTATTCAATAGGATG,0,1299289
furpa,0.16666666666666666,5,5,TGGTCGAGCCGAGCGGACGT,0,1346271
furpa,0.16666666666666666,5,5,TGGTAGCAGGCATGTGCATC,0,1322844
furpa,0.16666666666666666,5,5,TGGGTTGAAGGCTCGCAGGA,0,1315713
furpa,0.16666666666666666,5,5,TGGGTCTGGAACGTATATCG,0,1286710
furpa,0.16666666666666666,5,5,TGGGTATCCGGGTGGGCTTC,0,1293343
furpa,0.16666666666666666,5,5,TGGGCATGCGCGGGACTGCT,0,1288172
furpa,0.16666666666666666,5,5,TGGCGGTGTCAATTTGAATA,0,1319869
furpa,0.16666666666666666,5,5,TGGCCGTCAACCGAAGTGTC,0,1280743
furpa,0.16666666666666666,5,5,TGGCATAAGGGGCATCTGGT,0,1341865
furpa,0.16666666666666666,5,5,TGGCAGGCTTATAGGGATAG,0,1301833
furpa,0.16666666666666666,5,5,TGGCACTGATCTCGAGTATG,0,1297743
furpa,0.16666666666666666,5,5,TGGCACGCGTGCGTATTTAT,0,1277041
furpa,0.16666666666666666,5,5,TGGCAAAGATCGCGCAACAC,0,1279077
furpa,0.16666666666666666,5,5,TGGATTTGGCGCTTAGTTTG,0,1300672
furpa,0.16666666666666666,5,5,TGGATTGGGCACGAAGGGTC,0,1287369
furpa,0.16666666666666666,5,5,TGGATATAGTCTATAGAGAG,0,1354199
furpa,0.16666666666666666,5,5,TGGAGCAACCGTGGGGGCTA,0,1306927
furpa,0.16666666666666666,5,5,TGGACGACTTTTGACATGGT,0,1285761
furpa,0.16666666666666666,5,5,TGGACCTGTTAGAATAGGGA,0,1312490
furpa,0.16666666666666666,5,5,TGGACCCACATTTATAAAGT,0,1342500
furpa,0.16666666666666666,5,5,TGGACATGTTGGTAGACGGA,0,1285079
furpa,0.16666666666666666,5,5,TGGAACCCGGTCCCACTTGT,0,1338002
furpa,0.16666666666666666,5,5,TGGAACATATGGCAAGCTGG,0,1280105
furpa,0.16666666666666666,5,5,TGGAACAGACTTCGTGTGCT,0,1296910
furpa,0.16666666666666666,5,5,TGCTTTAAAAGGTGTTTAAT,0,1317253
furpa,0.16666666666666666,5,5,TGCTGTCAACGGATGGATCA,0,1321796
furpa,0.16666666666666666,5,5,TGCTGATTAGTTGACAAGAT,0,1327853
furpa,0.16666666666666666,5,5,TGCTCCCAACGTTATATGTA,0,1346237
furpa,0.16666666666666666,5,5,TGCTAATACCGAGGGTAACC,0,1356914
furpa,0.16666666666666666,5,5,TGCGGTGCCAAACGTATTCT,0,1299942
furpa,0.16666666666666666,5,5,TGCGGCGTGAAACTCGAATG,0,1343140
furpa,0.16666666666666666,5,5,TGCGGCATTAAGTAGGCGGA,0,1276300
furpa,0.16666666666666666,5,5,TGCCTCTCTCTTCTTATTCG,0,1300605
furpa,0.16666666666666666,5,5,TGCCTCAAGGCGTTCGAGTA,0,1346035
furpa,0.16666666666666666,5,5,TGCCGGTTGTACGCTCTAGT,0,1313435
furpa,0.16666666666666666,5,5,TGCCGGGCCGCCTAGCTCAA,0,1313818
furpa,0.16666666666666666,5,5,TGCCGGCGATCGCTTTGGCC,0,1286905
furpa,0.16666666666666666,5,5,TGCCGCGTTTGGTTTGATGC,0,1353848
furpa,0.16666666666666666,5,5,TGCCCCAGGCCACCAAGGAG,0,1280209
furpa,0.16666666666666666,5,5,TGCATTCCACGAAACACTAC,0,1323757
furpa,0.16666666666666666,5,5,TGCAGCCCGGTCTGAAAAAG,0,1284874
furpa,0.16666666666666666,5,5,TGCACCTATTCAAAAGATAT,0,1286838
furpa,0.16666666666666666,5,5,TGCACATTAGGGAGAGCTAC,0,1286240
furpa,0.16666666666666666,5,5,TGCAACATTCTTCATCAGGC,0,1347233
furpa,0.16666666666666666,5,5,TGATTTTGAGTGCACCACGT,0,1341719
furpa,0.16666666666666666,5,5,TGATTTCCGGGTCTCATCGT,0,1292431
furpa,0.16666666666666666,5,5,TGATGTATGCCTTAGAAACT,0,1340966
furpa,0.16666666666666666,5,5,TGATGAAGGCGCAACTGGAT,0,1330808
furpa,0.16666666666666666,5,5,TGATCGCTATGGAGGTGGAA,0,1291568
furpa,0.16666666666666666,5,5,TGATATCGGGGCCGCGCTGA,0,1308213
furpa,0.16666666666666666,5,5,TGATATAGAGCTTGCTAATT,0,1286998
furpa,0.16666666666666666,5,5,TGAGTTTACGAGCGGCGCGG,0,1340317
furpa,0.16666666666666666,5,5,TGAGTTGATACTATCCACCT,0,1287815
furpa,0.16666666666666666,5,5,TGAGTTAAGGTCGTTCTCCA,0,1289091
furpa,0.16666666666666666,5,5,TGAGTAAGCTTCCCAAGTTC,0,1307124
furpa,0.16666666666666666,5,5,TGAGGTTTTTAGGTAAGCGG,0,1292384
furpa,0.16666666666666666,5,5,TGAGGTCGTGCCGTACGCAG,0,1353857
furpa,0.16666666666666666,5,5,TGAGAGTTGTTCGAAACGGT,0,1318485
furpa,0.16666666666666666,5,5,TGACTTGTATCCGGGGCGGT,0,1295248
furpa,0.16666666666666666,5,5,TGACGACTGGGTTTTTAGGA,0,1277739
furpa,0.16666666666666666,5,5,TGACCTGCAGCATAAGAGAG,0,1331310
furpa,0.16666666666666666,5,5,TGACCCGTTCACCTATTGCC,0,1294993
furpa,0.16666666666666666,5,5,TGAATCTTGTATTACCGCGA,0,1338980
furpa,0.16666666666666666,5,5,TGAATCTATTCCCCATCATG,0,1317413
furpa,0.16666666666666666,5,5,TGAAGTTAGTTATTACAGTC,0,1308279
furpa,0.16666666666666666,5,5,TGAACTATTGTACGGCATCC,0,1324474
furpa,0.16666666666666666,5,5,TGAACGTAAATCCTGCCGCC,0,1282775
furpa,0.16666666666666666,5,5,TCTTGATTGGAGCGGAACTT,0,1312768
furpa,0.16666666666666666,5,5,TCTTGAGCTCTGACTGCGGG,0,1349591
furpa,0.16666666666666666,5,5,TCTGTTTTTATGGACATGCA,0,1310244
furpa,0.16666666666666666,5,5,TCTGCGGTTTGCGGCTCTGA,0,1334446
furpa,0.16666666666666666,5,5,TCTCGTGTCACAAATACACT,0,1353992
furpa,0.16666666666666666,5,5,TCTAGTAGATGGGATCGCTG,0,1287223
furpa,0.16666666666666666,5,5,TCTACATGCACGGTGTGGGG,0,1307239
furpa,0.16666666666666666,5,5,TCTAAGGTAGGTTGCCGGAA,0,1278041
furpa,0.16666666666666666,5,5,TCTAAGAGACATTCCCCCAT,0,1315952
furpa,0.16666666666666666,5,5,TCTAAGAAGATTTACTTTAT,0,1276231
furpa,0.16666666666666666,5,5,TCTAAACGGTATTCTATTGG,0,1335991
furpa,0.16666666666666666,5,5,TCGTTCGCATATTACGAGGA,0,1281605
furpa,0.16666666666666666,5,5,TCGTGTCGTATGAAACAGCG,0,1295373
furpa,0.16666666666666666,5,5,TCGTGCCTGAGTAGTCTACA,0,1286969
furpa,0.16666666666666666,5,5,TCGTAACAAGACTTGGTCTA,0,1336783
furpa,0.16666666666666666,5,5,TCGTAAATCAGGTGCCCATT,0,1324706
furpa,0.16666666666666666,5,5,TCGTAAAAGTTGGGCAAGAT,0,1330504
furpa,0.16666666666666666,5,5,TCGGTTAGACGTGACGGGTG,0,1314883
furpa,0.16666666666666666,5,5,TCGGTGGTGTGTGGACTTCG,0,1325197
furpa,0.16666666666666666,5,5,TCGGGTCTCATCAATACATG,0,1291095
furpa,0.16666666666666666,5,5,TCGGGGCGATTATGAGAATA,0,1313898
furpa,0.16666666666666666,5,5,TCGGGAATGATGTACGGTGA,0,1276183
furpa,0.16666666666666666,5,5,TCGCGGACTGCCTGGTTTAC,0,1323280
furpa,0.16666666666666666,5,5,TCGCGCTTCCGTACGACGAA,0,1330853
furpa,0.16666666666666666,5,5,TCGCGCAACTCCGCTTACAA,0,1303201
furpa,0.16666666666666666,5,5,TCGCCTTAATAGATTTTATT,0,1309075
furpa,0.16666666666666666,5,5,TCGCCCCAGCCTTGCTCGGC,0,1277746
furpa,0.16666666666666666,5,5,TCGATATAGTTACCGCTCTC,0,1295853
furpa,0.16666666666666666,5,5,TCGAGTAAAAAGGACTCGGC,0,1319442
furpa,0.16666666666666666,5,5,TCGACAGTTCCCCCGACAGA,0,1281362
furpa,0.16666666666666666,5,5,TCCTTTGTGAGTGTTTCAAT,0,1316518
furpa,0.16666666666666666,5,5,TCCTTATAGAGGGATTTTCG,0,1350653
furpa,0.16666666666666666,5,5,TCCTGAGCCGTCCCCAGAAC,0,1330785
furpa,0.16666666666666666,5,5,TCCTATCCACCGCATGCCGT,0,1342572
furpa,0.16666666666666666,5,5,TCCTAGGGCCTGAGGTATAG,0,1287868
furpa,0.16666666666666666,5,5,TCCGTGCACAACACGTGCGA,0,1309110
furpa,0.16666666666666666,5,5,TCCGGCACGTATCTCCAAAC,0,1318346
furpa,0.16666666666666666,5,5,TCCGCGGCAAAGTGTGGTCC,0,1344388
furpa,0.16666666666666666,5,5,TCCGCGCGCCTCTGAGCATG,0,1338052
furpa,0.16666666666666666,5,5,TCCGAATATCCTTTAGCGAC,0,1277430
furpa,0.16666666666666666,5,5,TCCCGGTATCACCAAGTTAT,0,1305497
furpa,0.16666666666666666,5,5,TCCATTGAGTTTTCGAAAGA,0,1333693
furpa,0.16666666666666666,5,5,TCCATGAAGTAAAGGTTAAG,0,1347934
furpa,0.16666666666666666,5,5,TCCAGTCATTTCTTGACCAG,0,1306394
furpa,0.16666666666666666,5,5,TCCAGGTAGTTACGCCGTGT,0,1346096
furpa,0.16666666666666666,5,5,TCCAGGTACGTCAGCTCCCC,0,1291303
furpa,0.16666666666666666,5,5,TCCAGGATATAGATATAGCT,0,1329351
furpa,0.16666666666666666,5,5,TCCAGCAGGTACGAAGTTAA,0,1291415
furpa,0.16666666666666666,5,5,TCCACGATTCAACCCATTTT,0,1330129
furpa,0.16666666666666666,5,5,TCCACCCGGCGCCTATACTC,0,1303905
furpa,0.16666666666666666,5,5,TCATTACCGGAACTTAGTTA,0,1284188
furpa,0.16666666666666666,5,5,TCATGTCATACGCTGTCCTG,0,1315951
furpa,0.16666666666666666,5,5,TCATGGCTTTAGGACGGGTT,0,1352911
furpa,0.16666666666666666,5,5,TCATCGCAAATCGTTTTGGT,0,1310497
furpa,0.16666666666666666,5,5,TCAGTTGCGCCTAACGGCCA,0,1327465
furpa,0.16666666666666666,5,5,TCAGTCTCCAGTCCAGCAGG,0,1307075
furpa,0.16666666666666666,5,5,TCAGTCGCCATTGCAGGCTT,0,1356127
furpa,0.16666666666666666,5,5,TCAGGGAAATAAATATGGTC,0,1280164
furpa,0.16666666666666666,5,5,TCAGCTGCTTTTTACCGTCG,0,1302596
furpa,0.16666666666666666,5,5,TCACTGCCGAACAAATGCTA,0,1350182
furpa,0.16666666666666666,5,5,TCACGCGGGCGATCCCGGAG,0,1338602
furpa,0.16666666666666666,5,5,TCAATGCGCCCCTCGGGGAG,0,1327935
furpa,0.16666666666666666,5,5,TCAATCTTAAATATCGATGC,0,1341657
furpa,0.16666666666666666,5,5,TCAAGGTGAACGGAGCACTA,0,1291098
furpa,0.16666666666666666,5,5,TCAAGCTGTCATTCGGATTT,0,1291204
furpa,0.16666666666666666,5,5,TCAACCATAACCAAGCCGTA,0,1347302
furpa,0.16666666666666666,5,5,TCAAATTATGACTACATTTC,0,1284541
furpa,0.16666666666666666,5,5,TCAAAACTTGGACATACTTA,0,1315257
furpa,0.16666666666666666,5,5,TATTTTTCGCATACGGCTAC,0,1308546
furpa,0.16666666666666666,5,5,TATTTACCTGGTCAGAGTGT,0,1282693
furpa,0.16666666666666666,5,5,TATTCTTGATACTAAAGTCA,0,1351898
furpa,0.16666666666666666,5,5,TATTCCTCACCAACACGTCG,0,1298511
furpa,0.16666666666666666,5,5,TATTAGCTGTTGACACGGGA,0,1301620
furpa,0.16666666666666666,5,5,TATTAACGCCAGTGCGGTAA,0,1311362
furpa,0.16666666666666666,5,5,TATGTGGCAGAGATCTGTCT,0,1273601
furpa,0.16666666666666666,5,5,TATGTCCTACGATATACGAC,0,1344289
furpa,0.16666666666666666,5,5,TATGGTAGGCTTGAGTCTGT,0,1322392
furpa,0.16666666666666666,5,5,TATGCTGGTGGCCATTGTGC,0,1351121
furpa,0.16666666666666666,5,5,TATGACGGAAGTGCTCCACA,0,1286094
furpa,0.16666666666666666,5,5,TATCTTTCATGCATAGAACG,0,1337701
furpa,0.16666666666666666,5,5,TATCGTTCGATACGTGAATG,0,1338223
furpa,0.16666666666666666,5,5,TATCGGTAGGGCTATGTAAC,0,1286487
furpa,0.16666666666666666,5,5,TATCGGCGGCGTAAGATACA,0,1281329
furpa,0.16666666666666666,5,5,TATATCCAGGTCTAAGCCGG,0,1350613
furpa,0.16666666666666666,5,5,TATATCAGTTACGGTATATT,0,1356204
furpa,0.16666666666666666,5,5,TATAGTACACCAACGCCAAC,0,1299102
furpa,0.16666666666666666,5,5,TATAGATGCGTGAGAGTCGA,0,1311992
furpa,0.16666666666666666,5,5,TAGGTACAGTTTTTAAGCGT,0,1340230
furpa,0.16666666666666666,5,5,TAGGGCCAAAAGCGTGATTT,0,1342827
furpa,0.16666666666666666,5,5,TAGGCTATTTGGCCGGATCG,0,1315780
furpa,0.16666666666666666,5,5,TAGGCGATGTATGGGCATCA,0,1342103
furpa,0.16666666666666666,5,5,TAGGCCGGTAGACGCATCCT,0,1306626
furpa,0.16666666666666666,5,5,TAGGCCAATGAAGATTTGTC,0,1333231
furpa,0.16666666666666666,5,5,TAGGAGAATAATGGTAACTA,0,1328468
furpa,0.16666666666666666,5,5,TAGCGCTTTATGTGGTCGCG,0,1329946
furpa,0.16666666666666666,5,5,TAGCAGGCGCCACGGTCGCA,0,1284848
furpa,0.16666666666666666,5,5,TAGAAGCTAAGCACGTGGAG,0,1295440
furpa,0.16666666666666666,5,5,TACTGGAACTGACGCACTTA,0,1291195
furpa,0.16666666666666666,5,5,TACTGATCGGTAGCGCAATC,0,1306166
furpa,0.16666666666666666,5,5,TACTCAACGCGTCTACCGAT,0,1272893
furpa,0.16666666666666666,5,5,TACGTTTTATGACCGCAGGA,0,1325420
furpa,0.16666666666666666,5,5,TACCTAGTATCCTGGTTATA,0,1339764
furpa,0.16666666666666666,5,5,TACCGACCGCGTATTAAAAA,0,1271183
furpa,0.16666666666666666,5,5,TACCCGCAGCGGTCGATTCA,0,1348758
furpa,0.16666666666666666,5,5,TACCAGTTAATTTACCGGCA,0,1286114
furpa,0.16666666666666666,5,5,TACATCATTGCCACGCGGGC,0,1296225
furpa,0.16666666666666666,5,5,TACATCACCAATCTGATGGT,0,1281056
furpa,0.16666666666666666,5,5,TACAGCAATGGTTTCGATTA,0,1293871
furpa,0.16666666666666666,5,5,TACACGATGTTCGGTCCTAA,0,1305649
furpa,0.16666666666666666,5,5,TACAAGCTTGAGCAACGGGT,0,1275060
furpa,0.16666666666666666,5,5,TACAAAGTATAGTGTACAAA,0,1299583
furpa,0.16666666666666666,5,5,TAATTGTACAATAGCCTAAG,0,1281899
furpa,0.16666666666666666,5,5,TAATTCGCTAATTCTTATTA,0,1288872
furpa,0.16666666666666666,5,5,TAATGTTAGGATTAAGAGTC,0,1299423
furpa,0.16666666666666666,5,5,TAATGTGAGTTGGTGCCCTT,0,1349342
furpa,0.16666666666666666,5,5,TAATCTTCACTGCCGGCGCT,0,1304681
furpa,0.16666666666666666,5,5,TAATCTGCCGCGTCCCCGCC,0,1304433
furpa,0.16666666666666666,5,5,TAATCTCCAGTAACCCTCCC,0,1272677
furpa,0.16666666666666666,5,5,TAATCCGACCGGCGAATGAC,0,1272854
furpa,0.16666666666666666,5,5,TAATATATGAATAACTCCAT,0,1308419
furpa,0.16666666666666666,5,5,TAAGGGACCTCTTTACGATC,0,1346152
furpa,0.16666666666666666,5,5,TAAGCTATATTAATAACCGT,0,1307713
furpa,0.16666666666666666,5,5,TAAGCCCCGTAGCTACCCAG,0,1290357
furpa,0.16666666666666666,5,5,TAAGCAGCTGACGCCGGCGA,0,1347056
furpa,0.16666666666666666,5,5,TAAGAAAATACGTTTCTATA,0,1338091
furpa,0.16666666666666666,5,5,TAACGACCACACAAAGGCAG,0,1326099
furpa,0.16666666666666666,5,5,TAAAGTCGTGGACATCTGTG,0,1329709
furpa,0.16666666666666666,5,5,TAAAGAAGTCAGACCTATTC,0,1324083
furpa,0.16666666666666666,5,5,TAAACCCAGATTAACATAAA,0,1287993
furpa,0.16666666666666666,5,5,TAAAAAGCTTACCGAGCACA,0,1289868
furpa,0.16666666666666666,5,5,GTTTTCCACGGCCCACCGCG,0,1275933
furpa,0.16666666666666666,5,5,GTTTTCAATCGACGATCAAC,0,1325529
furpa,0.16666666666666666,5,5,GTTTATCATGCTATACGTGA,0,1280381
furpa,0.16666666666666666,5,5,GTTGTTCTACTTCGGTGGTT,0,1275788
furpa,0.16666666666666666,5,5,GTTGTAAAGATACTCGTGCT,0,1307423
furpa,0.16666666666666666,5,5,GTTGGTATGGTTTCAGCGTC,0,1286165
furpa,0.16666666666666666,5,5,GTTGGGAAGGAGTTATGGTT,0,1281278
furpa,0.16666666666666666,5,5,GTTGCGGTCTGCCAGCCTTG,0,1357078
furpa,0.16666666666666666,5,5,GTTGAGACCCTGGTGGGACT,0,1302727
furpa,0.16666666666666666,5,5,GTTCTCAACACCAGCAGGAT,0,1310904
furpa,0.16666666666666666,5,5,GTTCGTTGTGTACTATATTA,0,1342808
furpa,0.16666666666666666,5,5,GTTCGTTCGATAGAGATTGT,0,1282758
furpa,0.16666666666666666,5,5,GTTCGGTGAGGAGTGACGGG,0,1281669
furpa,0.16666666666666666,5,5,GTTCCGGAGTGACTAAGCTA,0,1281923
furpa,0.16666666666666666,5,5,GTTCCGATTTTATGTGCCCA,0,1355433
furpa,0.16666666666666666,5,5,GTTCCGAGTTCCCATGTCAT,0,1294732
furpa,0.16666666666666666,5,5,GTTCCCCCAAACCGCAATTC,0,1352171
furpa,0.16666666666666666,5,5,GTTCCAACTAAAAAAAGCCT,0,1291474
furpa,0.16666666666666666,5,5,GTTAGTCCATGGACAGGATC,0,1329601
furpa,0.16666666666666666,5,5,GTTACAGCCTGGGCCTCGAT,0,1282026
furpa,0.16666666666666666,5,5,GTTAATTACGTTTAATTCCT,0,1332807
furpa,0.16666666666666666,5,5,GTGTGGTTTGGTAATCCCTG,0,1279911
furpa,0.16666666666666666,5,5,GTGTGCCACGCATGTAAGTA,0,1304799
furpa,0.16666666666666666,5,5,GTGTCGGGATCACGCGATTG,0,1326721
furpa,0.16666666666666666,5,5,GTGTCATTTCAGCGCTAATC,0,1296168
furpa,0.16666666666666666,5,5,GTGTCAATGGATCGTAGATC,0,1309545
furpa,0.16666666666666666,5,5,GTGTATCCTCATACGGGTTG,0,1294126
furpa,0.16666666666666666,5,5,GTGTACCGAGAATTCGCACA,0,1298554
furpa,0.16666666666666666,5,5,GTGTACATGCCCAGGGCGTA,0,1343012
furpa,0.16666666666666666,5,5,GTGGTTGCGGAGCGAGGTGA,0,1355031
furpa,0.16666666666666666,5,5,GTGGTAGCTGTCAACGCTGG,0,1353560
furpa,0.16666666666666666,5,5,GTGGGTGGAGGCTACTATTG,0,1342819
furpa,0.16666666666666666,5,5,GTGGGGCTGAACAGGAGGTA,0,1307991
furpa,0.16666666666666666,5,5,GTGGGGACGGCCCTGTAGGG,0,1356066
furpa,0.16666666666666666,5,5,GTGGGAGTCTGTCGTCCTTC,0,1345631
furpa,0.16666666666666666,5,5,GTGGCTATCGATAGAAAAGC,0,1302743
furpa,0.16666666666666666,5,5,GTGGCGGCAGCGAGATTCGT,0,1345303
furpa,0.16666666666666666,5,5,GTGGAATCCGGAAGTAGTTT,0,1331597
furpa,0.16666666666666666,5,5,GTGCTTCGGCTTATTTGGAT,0,1316913
furpa,0.16666666666666666,5,5,GTGCTCTGGGTAAAACGTGC,0,1279170
furpa,0.16666666666666666,5,5,GTGCTCAGGGTGCCTAATGC,0,1295792
furpa,0.16666666666666666,5,5,GTGCGGTTTTATAAGGGATT,0,1327245
furpa,0.16666666666666666,5,5,GTGCGCCTCGGCAAGCGAGG,0,1338608
furpa,0.16666666666666666,5,5,GTGCGCCGAGGTCAAGCACC,0,1297668
furpa,0.16666666666666666,5,5,GTGCCGAGGGGCATACTAAA,0,1342243
furpa,0.16666666666666666,5,5,GTGCCCCGAGATGAGCTATC,0,1349833
furpa,0.16666666666666666,5,5,GTGCATGGTAATATGCCTAG,0,1322639
furpa,0.16666666666666666,5,5,GTGCATGCTGGCCTCTCGTG,0,1353392
furpa,0.16666666666666666,5,5,GTGAGCTTTCACGATAAGTT,0,1338396
furpa,0.16666666666666666,5,5,GTCTTTTGTTGCGAGTATAG,0,1279791
furpa,0.16666666666666666,5,5,GTCTTTTGACGTTATTTGGG,0,1355872
furpa,0.16666666666666666,5,5,GTCGTTGCTTTATACCCAGG,0,1302938
furpa,0.16666666666666666,5,5,GTCGGTGCCCTTACGCGAAA,0,1294662
furpa,0.16666666666666666,5,5,GTCCTTCAGCACTCACTGTG,0,1278417
furpa,0.16666666666666666,5,5,GTCCTGGAGTGACGGTCCGG,0,1322086
furpa,0.16666666666666666,5,5,GTCCTCCGTTAAACGCCACC,0,1329306
furpa,0.16666666666666666,5,5,GTCCCACCGGGGGGGCGTCA,0,1302041
furpa,0.16666666666666666,5,5,GTCCAAGTCTCCTCGAAAGT,0,1324126
furpa,0.16666666666666666,5,5,GTCACTGATCCACTGGGCTG,0,1300087
furpa,0.16666666666666666,5,5,GTCACCGGGTTGGCCAATAA,0,1345867
furpa,0.16666666666666666,5,5,GTCAACGTGCAAGTTCAGAT,0,1355736
furpa,0.16666666666666666,5,5,GTATGAATTAAAATCCTATT,0,1350677
furpa,0.16666666666666666,5,5,GTATGAAGTCTCAAACAGCA,0,1352345
furpa,0.16666666666666666,5,5,GTAGTCTTGTAGGGGTGCAT,0,1284282
furpa,0.16666666666666666,5,5,GTAGTCATTGGCACGACCGG,0,1327985
furpa,0.16666666666666666,5,5,GTAGTAGATTCAAGGCGTAA,0,1320068
furpa,0.16666666666666666,5,5,GTAGGATACAAGCGTGCAGA,0,1349231
furpa,0.16666666666666666,5,5,GTAGACGCTTACAATGCTCG,0,1276821
furpa,0.16666666666666666,5,5,GTACGACTTCTTGCGTTGAT,0,1287515
furpa,0.16666666666666666,5,5,GTACCCATAGCAATCCTGTG,0,1335289
furpa,0.16666666666666666,5,5,GTACAGACTTGCATTATCGA,0,1277333
furpa,0.16666666666666666,5,5,GTACACGGGCAAGCAGCTGG,0,1351217
furpa,0.16666666666666666,5,5,GTACAAGCAGGCAAAGAGCT,0,1298591
furpa,0.16666666666666666,5,5,GTACAAAAAACGGCCTTTAA,0,1310879
furpa,0.16666666666666666,5,5,GTAAAGTTATGGGTCACGCT,0,1346529
furpa,0.16666666666666666,5,5,GTAAACAGCGCGGTGACCTC,0,1340590
furpa,0.16666666666666666,5,5,GTAAAATCGTGTGGCTGTAC,0,1311315
furpa,0.16666666666666666,5,5,GGTTTATATCCGTGCAAGGG,0,1271417
furpa,0.16666666666666666,5,5,GGTTGTCCCGAGGTGTTATA,0,1309409
furpa,0.16666666666666666,5,5,GGTTGGACTGGGCGAGAGTT,0,1315870
furpa,0.16666666666666666,5,5,GGTTCTTGTGGGGGACCATA,0,1284391
furpa,0.16666666666666666,5,5,GGTTCCTGTGGACAGCGGTA,0,1356431
furpa,0.16666666666666666,5,5,GGTTCCCAGCCCCTGGTCTT,0,1292600
furpa,0.16666666666666666,5,5,GGTTCAGCTTGTGCGTTGGA,0,1310290
furpa,0.16666666666666666,5,5,GGTTAAAGATCTTTCGCTTG,0,1346844
furpa,0.16666666666666666,5,5,GGTGTACTCAGAACATGGCA,0,1280379
furpa,0.16666666666666666,5,5,GGTGATCTGATTGCGGAGTG,0,1332813
furpa,0.16666666666666666,5,5,GGTGAGCGAGGGTTGGATGA,0,1321262
furpa,0.16666666666666666,5,5,GGTGACTACGGAGAATCTGC,0,1302747
furpa,0.16666666666666666,5,5,GGTCCAGAACTGACATGGGT,0,1307837
furpa,0.16666666666666666,5,5,GGTCACATAATAATGACCCT,0,1346227
furpa,0.16666666666666666,5,5,GGTATTCTGCCAGCGATTAA,0,1321126
furpa,0.16666666666666666,5,5,GGTATGCTTGTATGAGGGCT,0,1284719
furpa,0.16666666666666666,5,5,GGTAGGAGTTGATCGCAACA,0,1315015
furpa,0.16666666666666666,5,5,GGTACTTAGCTAGTGCCATG,0,1333932
furpa,0.16666666666666666,5,5,GGTACCTCTTCAGCAGCGGC,0,1307867
furpa,0.16666666666666666,5,5,GGGTTTCACGGGTACGTCCC,0,1280424
furpa,0.16666666666666666,5,5,GGGTTGATGCCGCCCTCCAA,0,1317056
furpa,0.16666666666666666,5,5,GGGTTAAGGTTAAGGAGACT,0,1281101
furpa,0.16666666666666666,5,5,GGGTGAACGTCACTCTATAA,0,1299069
furpa,0.16666666666666666,5,5,GGGTCCACCGTGCTAGATTG,0,1293754
furpa,0.16666666666666666,5,5,GGGGGTGCAATAGAATGAAC,0,1284924
furpa,0.16666666666666666,5,5,GGGGGTCCATAGTGTACACG,0,1292837
furpa,0.16666666666666666,5,5,GGGGGAACGCAATTTACCGT,0,1302091
furpa,0.16666666666666666,5,5,GGGGCTATATAGCTTGCTAC,0,1275658
furpa,0.16666666666666666,5,5,GGGGACGGGCGCTACACCAG,0,1288423
furpa,0.16666666666666666,5,5,GGGCTGGGGTGGAGGCTGAA,0,1294402
furpa,0.16666666666666666,5,5,GGGCGGTTCCCTAACGTGAG,0,1333068
furpa,0.16666666666666666,5,5,GGGCGGTATTTCGGCTGGAC,0,1346289
furpa,0.16666666666666666,5,5,GGGCGCATGTTCTCAAGGCG,0,1341679
furpa,0.16666666666666666,5,5,GGGCCTCTGCGGGGACCGTA,0,1317239
furpa,0.16666666666666666,5,5,GGGCCTACGGTCCAGTCTAG,0,1310074
furpa,0.16666666666666666,5,5,GGGCCATTCTCTTTGAGTCC,0,1345366
furpa,0.16666666666666666,5,5,GGGCCAGGCGAAGCCGGACG,0,1280282
furpa,0.16666666666666666,5,5,GGGAGTCCTGTGCCCTCAGG,0,1356149
furpa,0.16666666666666666,5,5,GGGACAATCGGTCATTAGGA,0,1321535
furpa,0.16666666666666666,5,5,GGCTTGGACACGGTTTCAGC,0,1274501
furpa,0.16666666666666666,5,5,GGCTCCGAGACACTTCGGCG,0,1315644
furpa,0.16666666666666666,5,5,GGCTAGCACATTAAGCATCG,0,1300908
furpa,0.16666666666666666,5,5,GGCGTCGCGGTTGTCATCGC,0,1305850
furpa,0.16666666666666666,5,5,GGCGGAGCAACAAGAGTTTA,0,1299982
furpa,0.16666666666666666,5,5,GGCGCTCAGTTAGTAATTGT,0,1334040
furpa,0.16666666666666666,5,5,GGCGCGCAGTACACAATGAT,0,1276308
furpa,0.16666666666666666,5,5,GGCCTTAGCTTATGACACAA,0,1325926
furpa,0.16666666666666666,5,5,GGCCACATCGTCCTGGGCGC,0,1281191
furpa,0.16666666666666666,5,5,GGCACGTTAGCGTACCCCGT,0,1328634
furpa,0.16666666666666666,5,5,GGCAATGCCTTACATTCAGT,0,1283544
furpa,0.16666666666666666,5,5,GGATGTAAGAAGATGGACAT,0,1324965
furpa,0.16666666666666666,5,5,GGATCTTAAGCGTTCATCTC,0,1282626
furpa,0.16666666666666666,5,5,GGATCGGCAATATTACGAGT,0,1295354
furpa,0.16666666666666666,5,5,GGATAGCTACTCTGTCGGTT,0,1326033
furpa,0.16666666666666666,5,5,GGAGGATGTGGCTGCAAGAA,0,1333524
furpa,0.16666666666666666,5,5,GGAGCTTAAGTTACTCCGGA,0,1320830
furpa,0.16666666666666666,5,5,GGACTTAAGAGTTATCTATT,0,1334948
furpa,0.16666666666666666,5,5,GGACTACACTATCCTATACA,0,1312157
furpa,0.16666666666666666,5,5,GGACCTTGCTACAAGAATGG,0,1344983
furpa,0.16666666666666666,5,5,GGACCTGGAGGTGCTGTCGC,0,1278132
furpa,0.16666666666666666,5,5,GGACCGTTATTGCGATATCG,0,1279626
furpa,0.16666666666666666,5,5,GGACCACGTAGGACCCGCGG,0,1310545
furpa,0.16666666666666666,5,5,GGACAGTTATAGGGACTCGC,0,1291739
furpa,0.16666666666666666,5,5,GGAATTTAGGTGTAGCGCCT,0,1324266
furpa,0.16666666666666666,5,5,GGAATTAAGAGCCGGCGGCA,0,1328741
furpa,0.16666666666666666,5,5,GGAAGTGAACAAGGCTGGTG,0,1287784
furpa,0.16666666666666666,5,5,GGAAGATGAGGTATAGAGCA,0,1307306
furpa,0.16666666666666666,5,5,GGAAGAACGAAGCGGTTCAT,0,1309745
furpa,0.16666666666666666,5,5,GCTTTTTCTTAGGAATTCAC,0,1328078
furpa,0.16666666666666666,5,5,GCTTCATGCAGGTAAGGGGG,0,1342446
furpa,0.16666666666666666,5,5,GCTGTCAACTGTGGATGTAT,0,1328559
furpa,0.16666666666666666,5,5,GCTGGTTCCCAGCTCGACGC,0,1289906
furpa,0.16666666666666666,5,5,GCTGGGTGAGTCTTTAGGAG,0,1349246
furpa,0.16666666666666666,5,5,GCTGGCACAAGTTAAAGCCG,0,1284679
furpa,0.16666666666666666,5,5,GCTGCGAAATTTATCAGTAG,0,1345686
furpa,0.16666666666666666,5,5,GCTGCATTGACCATAAGTGG,0,1296766
furpa,0.16666666666666666,5,5,GCTGAAATTCTCAAGGCTCC,0,1282201
furpa,0.16666666666666666,5,5,GCTCTTCGTGCGGCATCTTC,0,1280146
furpa,0.16666666666666666,5,5,GCTCTGGACTTGTCATGCTG,0,1342389
furpa,0.16666666666666666,5,5,GCTCTCTAAAAATAAACATT,0,1331580
furpa,0.16666666666666666,5,5,GCTCTCGGGTCCGTCTCATT,0,1317087
furpa,0.16666666666666666,5,5,GCTCGTTGATCGCAGCAACC,0,1299310
furpa,0.16666666666666666,5,5,GCTCGGAAAAGGTATGCATG,0,1315921
furpa,0.16666666666666666,5,5,GCTCCTTAGTACGGGTAAAG,0,1343127
furpa,0.16666666666666666,5,5,GCTCCACCTGGTAAGGCAGA,0,1350579
furpa,0.16666666666666666,5,5,GCTCATAGTAGTGTGCACAC,0,1303294
furpa,0.16666666666666666,5,5,GCTATGGCGCAACAAGTTTG,0,1271546
furpa,0.16666666666666666,5,5,GCTAGTGCCAGATGCGAATA,0,1349131
furpa,0.16666666666666666,5,5,GCGTCAATTACTCGGTATGG,0,1356550
furpa,0.16666666666666666,5,5,GCGGTTCGTTAGCTAGGACC,0,1337412
furpa,0.16666666666666666,5,5,GCGGTTCCGAGTCTCCTGGC,0,1310133
furpa,0.16666666666666666,5,5,GCGGAACACGTTCTGATGTA,0,1303395
furpa,0.16666666666666666,5,5,GCGCGCGACTCCAAGGTTCT,0,1303132
furpa,0.16666666666666666,5,5,GCGCACGTCCAATCTCAAAG,0,1308423
furpa,0.16666666666666666,5,5,GCGCACCATGGTGGGCAGTA,0,1294935
furpa,0.16666666666666666,5,5,GCGATCCTTCTTAATGGCAA,0,1296591
furpa,0.16666666666666666,5,5,GCGATAGTTTTCCCGGGGTA,0,1326111
furpa,0.16666666666666666,5,5,GCGAAGGAACAAGCACCCCA,0,1305379
furpa,0.16666666666666666,5,5,GCGAAACTACGGCATCATAC,0,1343914
furpa,0.16666666666666666,5,5,GCCTTGTGGCCGAGGCGGCC,0,1316094
furpa,0.16666666666666666,5,5,GCCTGGGATAAAGTTGCCCT,0,1352437
furpa,0.16666666666666666,5,5,GCCTGGCGAACAAAAGCCCA,0,1334805
furpa,0.16666666666666666,5,5,GCCTGATCACCAGCCTGAAC,0,1322154
furpa,0.16666666666666666,5,5,GCCTGAGTAGAATAGTTTGG,0,1352789
furpa,0.16666666666666666,5,5,GCCTGAGCGCTTATCTCAGT,0,1274184
furpa,0.16666666666666666,5,5,GCCTCCGAAACCCGATCATC,0,1326189
furpa,0.16666666666666666,5,5,GCCTCCAGCTCCATGTGAAT,0,1305271
furpa,0.16666666666666666,5,5,GCCTATTCGTCATGGTGCAT,0,1350909
furpa,0.16666666666666666,5,5,GCCTAATGATAGGGAGGCGA,0,1340832
furpa,0.16666666666666666,5,5,GCCGTTGAGTCGGAAACCTG,0,1356686
furpa,0.16666666666666666,5,5,GCCGGTGAAGTATCAGAGCG,0,1329380
furpa,0.16666666666666666,5,5,GCCGCTACGACACAAGCTTC,0,1303010
furpa,0.16666666666666666,5,5,GCCGCCCTATGAGTCGATAC,0,1353205
furpa,0.16666666666666666,5,5,GCCCTTTGTGTCGGCGACGG,0,1333303
furpa,0.16666666666666666,5,5,GCCCTTGATCTCACGGTACT,0,1343934
furpa,0.16666666666666666,5,5,GCCCATAGTTTGACCGGACT,0,1283957
furpa,0.16666666666666666,5,5,GCCATTTGCGTATTTATCCC,0,1355955
furpa,0.16666666666666666,5,5,GCCACCGTTAAACTAAACTT,0,1323581
furpa,0.16666666666666666,5,5,GCATTTTGCGAACTCGCAAA,0,1334852
furpa,0.16666666666666666,5,5,GCATTACGGTTCGTAAATCC,0,1292287
furpa,0.16666666666666666,5,5,GCATGTCCTCATCCGGATGA,0,1353252
furpa,0.16666666666666666,5,5,GCATGCAAAATTGTGGCTTA,0,1322759
furpa,0.16666666666666666,5,5,GCAGTCACAATGCATCTCAG,0,1279415
furpa,0.16666666666666666,5,5,GCAGGGCAATCCCGCCATGG,0,1341403
furpa,0.16666666666666666,5,5,GCACGACTATCGGGATCCAC,0,1308977
furpa,0.16666666666666666,5,5,GCACGAATCGTCAGTGATCA,0,1293197
furpa,0.16666666666666666,5,5,GCACCGAGACTCTCCCATAG,0,1305258
furpa,0.16666666666666666,5,5,GCACCAAGGTTAGAGCGACC,0,1342632
furpa,0.16666666666666666,5,5,GCAATGTAGATATGGGTAAT,0,1299481
furpa,0.16666666666666666,5,5,GCAATCCATACATCCCGTGA,0,1291949
furpa,0.16666666666666666,5,5,GCAACGTCGTGCACGTGCAG,0,1311623
furpa,0.16666666666666666,5,5,GCAACCTGAGCGGGACGAGG,0,1357512
furpa,0.16666666666666666,5,5,GCAACCTCCAGCCTCACACG,0,1343153
furpa,0.16666666666666666,5,5,GCAACAACCGCCACTCGCAA,0,1324372
furpa,0.16666666666666666,5,5,GCAAACTGGTTGAAAGTGGA,0,1310285
furpa,0.16666666666666666,5,5,GATTTCAGGGACAGTCTACT,0,1330602
furpa,0.16666666666666666,5,5,GATGTGCGTTGGAACCGGTA,0,1277653
furpa,0.16666666666666666,5,5,GATGTCTGAGTATATAAGGC,0,1275964
furpa,0.16666666666666666,5,5,GATGGTACTATTTCGTGAGA,0,1357518
furpa,0.16666666666666666,5,5,GATGGCACCGACTGATATGA,0,1292860
furpa,0.16666666666666666,5,5,GATGAGAGTAGGCAACTTTT,0,1327642
furpa,0.16666666666666666,5,5,GATGAAAGGGGCACGTGGTG,0,1274874
furpa,0.16666666666666666,5,5,GATCTTTCAAGGGCCTTTCT,0,1290403
furpa,0.16666666666666666,5,5,GATCCCAGTGATCTCGATCA,0,1318254
furpa,0.16666666666666666,5,5,GATCAGAGATAACGGGAGTT,0,1305212
furpa,0.16666666666666666,5,5,GATAGGGTATTTGGGCCAGC,0,1350747
furpa,0.16666666666666666,5,5,GATAGCATATCGCGAACCAA,0,1311074
furpa,0.16666666666666666,5,5,GATACAGGCGATTCAAGCGT,0,1316272
furpa,0.16666666666666666,5,5,GATAATCTAAAAAAATTTTT,0,1356547
furpa,0.16666666666666666,5,5,GATAAGGCTCGCGCCCGGCA,0,1287658
furpa,0.16666666666666666,5,5,GATAAGAAAGATGGATCCAT,0,1312612
furpa,0.16666666666666666,5,5,GAGTTACTCCAGCCTATTCG,0,1276051
furpa,0.16666666666666666,5,5,GAGTGTGGTCGCGATACCGT,0,1323749
furpa,0.16666666666666666,5,5,GAGTGAGCTTTTGTTGTCAG,0,1337032
furpa,0.16666666666666666,5,5,GAGTCTTCGAAATGTGGCCG,0,1317286
furpa,0.16666666666666666,5,5,GAGTATAGTCTTCTATAAAG,0,1277428
furpa,0.16666666666666666,5,5,GAGGTAGATCAGTAGTAGAC,0,1282823
furpa,0.16666666666666666,5,5,GAGGAATCATGGGAGCTGTG,0,1275077
furpa,0.16666666666666666,5,5,GAGCTCTAAGGACTTCCGCT,0,1288280
furpa,0.16666666666666666,5,5,GAGCGCTCTACAAGTTATGA,0,1285497
furpa,0.16666666666666666,5,5,GAGCGACCTCCTGGTATGGA,0,1355803
furpa,0.16666666666666666,5,5,GAGCCTCGATAGGCTGTATT,0,1292635
furpa,0.16666666666666666,5,5,GAGCACTCAGCACGCGTAGG,0,1314386
furpa,0.16666666666666666,5,5,GAGATGCCTCTAGGTCGTCA,0,1335606
furpa,0.16666666666666666,5,5,GAGATACGTATCGTCTAGTC,0,1276622
furpa,0.16666666666666666,5,5,GAGAGTCTCGGTCCGAACGT,0,1348434
furpa,0.16666666666666666,5,5,GAGAGCGCCTTGATAGCAAC,0,1337357
furpa,0.16666666666666666,5,5,GAGAGCATGGGTGTATTTTT,0,1275242
furpa,0.16666666666666666,5,5,GAGACCGAAGACGGTGGAGA,0,1322480
furpa,0.16666666666666666,5,5,GAGAAGGGGGCTGCTGGGCA,0,1301899
furpa,0.16666666666666666,5,5,GACTTTCGCTTTAAGTGCAT,0,1335415
furpa,0.16666666666666666,5,5,GACTTTAAAAATGGCCGTCT,0,1297251
furpa,0.16666666666666666,5,5,GACTTCACTGATTTACCAAT,0,1352538
furpa,0.16666666666666666,5,5,GACTGTTTTTCAACCTGTTA,0,1354854
furpa,0.16666666666666666,5,5,GACTGCTAAACCGGGCATAC,0,1304969
furpa,0.16666666666666666,5,5,GACTCGCACCTTATTGAAGC,0,1341766
furpa,0.16666666666666666,5,5,GACTATCTACGTGTTTTTCT,0,1287530
furpa,0.16666666666666666,5,5,GACTAGGTTACTGTTATTCT,0,1351146
furpa,0.16666666666666666,5,5,GACGTAAAATAGACTTTATG,0,1354286
furpa,0.16666666666666666,5,5,GACGGGGATAGTGAATGTGT,0,1309062
furpa,0.16666666666666666,5,5,GACGAAAATCCACACTACCT,0,1312392
furpa,0.16666666666666666,5,5,GACCTTAGGGACGGGGATAC,0,1287181
furpa,0.16666666666666666,5,5,GACCTCCACATACATAAAAG,0,1312238
furpa,0.16666666666666666,5,5,GACCGTACTAATCCGTAGGA,0,1348740
furpa,0.16666666666666666,5,5,GACCGGCGTGTAGGTTCAGA,0,1341208
furpa,0.16666666666666666,5,5,GACCGAGGCTTTCCGATTTT,0,1302325
furpa,0.16666666666666666,5,5,GACCCTCTGAACTTCTCCGT,0,1289102
furpa,0.16666666666666666,5,5,GACCCCGGTTTGCTCGATTG,0,1342986
furpa,0.16666666666666666,5,5,GACCACGAATCTATTAAGGC,0,1310702
furpa,0.16666666666666666,5,5,GACCAAGATCCTACGCATGA,0,1295749
furpa,0.16666666666666666,5,5,GACAATGCTGAAACTTTAAA,0,1294673
furpa,0.16666666666666666,5,5,GAATGTTACTGAACGCCCGA,0,1351887
furpa,0.16666666666666666,5,5,GAATGAAAGGCGTTGAATCG,0,1293410
furpa,0.16666666666666666,5,5,GAATCTTGGAGTTAAGACGT,0,1335504
furpa,0.16666666666666666,5,5,GAATCTTGCAACCCATCGCA,0,1324883
furpa,0.16666666666666666,5,5,GAATCATGACGTTTCGTGGG,0,1342932
furpa,0.16666666666666666,5,5,GAATAAAGCGCCGGAAAAGG,0,1296861
furpa,0.16666666666666666,5,5,GAAGTTTGGATAACACGGGT,0,1282311
furpa,0.16666666666666666,5,5,GAAGTGCTACGTTACGCGTT,0,1274282
furpa,0.16666666666666666,5,5,GAAGTAGCCTGATTCATGTG,0,1274434
furpa,0.16666666666666666,5,5,GAAGGCTCGATCAAGGTTAA,0,1279619
furpa,0.16666666666666666,5,5,GAAGGATGCGATCAACAGAC,0,1280784
furpa,0.16666666666666666,5,5,GAAGGACTAGCCGACGGACA,0,1345127
furpa,0.16666666666666666,5,5,GAACGCATTGGAATGTAGCC,0,1295618
furpa,0.16666666666666666,5,5,GAACCGTACAGTAATACGCT,0,1287503
furpa,0.16666666666666666,5,5,GAACAATCAAAGCGTGGTAT,0,1312827
furpa,0.16666666666666666,5,5,GAAATTTGGTCTTCTCGGGT,0,1350493
furpa,0.16666666666666666,5,5,GAAACCCAATCAAGTTTTAG,0,1319365
furpa,0.16666666666666666,5,5,GAAAACTACCCACGCTGAAT,0,1305048
furpa,0.16666666666666666,5,5,CTTTCTAAGATAAGGCGCAA,0,1318643
furpa,0.16666666666666666,5,5,CTTTCAAAAGAGTCAAACCG,0,1293012
furpa,0.16666666666666666,5,5,CTTTAGGCCGTGACATTTAT,0,1338310
furpa,0.16666666666666666,5,5,CTTTACTGTCTGCGACCTAC,0,1296759
furpa,0.16666666666666666,5,5,CTTGTTTCGTACCGAGCGCG,0,1348536
furpa,0.16666666666666666,5,5,CTTGTATGGTAAAGAAAGTC,0,1290184
furpa,0.16666666666666666,5,5,CTTGAATGGTCGATGTAAAT,0,1346957
furpa,0.16666666666666666,5,5,CTTCGTTGAGACAAGCCTAG,0,1336577
furpa,0.16666666666666666,5,5,CTTCCGGGGACTAGCTGTAA,0,1304900
furpa,0.16666666666666666,5,5,CTTCCGCGCAGGGCCTAAGA,0,1331599
furpa,0.16666666666666666,5,5,CTTCCAGTGACAGACCGAAT,0,1310611
furpa,0.16666666666666666,5,5,CTTCAGTATATTGGTGGAGC,0,1283186
furpa,0.16666666666666666,5,5,CTTCAAAGACCATGCCAACA,0,1282506
furpa,0.16666666666666666,5,5,CTTACGGTGTCTTTAAAATG,0,1353923
furpa,0.16666666666666666,5,5,CTTACCATTGAATGAGGAAT,0,1272906
furpa,0.16666666666666666,5,5,CTGTTGACAATTACTGCTTA,0,1356794
furpa,0.16666666666666666,5,5,CTGTCTATCTTACCACTTGT,0,1305431
furpa,0.16666666666666666,5,5,CTGTCATGCATTCGAACGGT,0,1315120
furpa,0.16666666666666666,5,5,CTGTAAGCAAATTCTGTGTT,0,1333998
furpa,0.16666666666666666,5,5,CTGGTTGATGTTGGGTATAC,0,1353139
furpa,0.16666666666666666,5,5,CTGGTTAATTCAGGATAGAA,0,1339411
furpa,0.16666666666666666,5,5,CTGGCTGTTAAATTTGTTAT,0,1352222
furpa,0.16666666666666666,5,5,CTGGCTGGGTACCGTCTGAT,0,1319932
furpa,0.16666666666666666,5,5,CTGGCCCAAGGGGCTTGATT,0,1301496
furpa,0.16666666666666666,5,5,CTGGAACGCAAAGGGCAATT,0,1281284
furpa,0.16666666666666666,5,5,CTGGAACCTTACCGAGATAT,0,1332420
furpa,0.16666666666666666,5,5,CTGCTTACCCACTATTTTGG,0,1295210
furpa,0.16666666666666666,5,5,CTGCTGCTCATCGAGCATTT,0,1281045
furpa,0.16666666666666666,5,5,CTGCGAAGGTCACTACTTCG,0,1320914
furpa,0.16666666666666666,5,5,CTGCCTGCGGGATCTTACCC,0,1280031
furpa,0.16666666666666666,5,5,CTGCCAGTCAGGAGGGACTG,0,1316372
furpa,0.16666666666666666,5,5,CTGCACTGCTCAGGATGCGT,0,1287398
furpa,0.16666666666666666,5,5,CTGCAAAAATCAAATCAGTT,0,1342286
furpa,0.16666666666666666,5,5,CTGATGTTCAAAGAACAGGG,0,1281338
furpa,0.16666666666666666,5,5,CTGATCATCCATTCCGCTGG,0,1356092
furpa,0.16666666666666666,5,5,CTGATAGATCCGTGATTGTG,0,1335518
furpa,0.16666666666666666,5,5,CTGACAAAGCGAAGTACCAC,0,1349808
furpa,0.16666666666666666,5,5,CTGAAGCCCACGTACGATTT,0,1320381
furpa,0.16666666666666666,5,5,CTCTTGGGAATATCGGTCGC,0,1335014
furpa,0.16666666666666666,5,5,CTCTTGGCGAGGCCGCGACG,0,1319024
furpa,0.16666666666666666,5,5,CTCTCCGATGCAGGATCGGC,0,1296612
furpa,0.16666666666666666,5,5,CTCTCCATAGCTCAGTGGGA,0,1289621
furpa,0.16666666666666666,5,5,CTCTAGTAGGGCTGAGAAGC,0,1330586
furpa,0.16666666666666666,5,5,CTCTACAGCTCTTACCGAGG,0,1289086
furpa,0.16666666666666666,5,5,CTCTAATCGTGTCTTTTAAT,0,1287607
furpa,0.16666666666666666,5,5,CTCGCCCCTTGTCTGACCCC,0,1313307
furpa,0.16666666666666666,5,5,CTCGACCGGCCCAGCTACGG,0,1318739
furpa,0.16666666666666666,5,5,CTCCTTGTGTATTACTGTTC,0,1338986
furpa,0.16666666666666666,5,5,CTCCGTGATAATGGCGTGTT,0,1286649
furpa,0.16666666666666666,5,5,CTCCGTATGGCTTCCCGATA,0,1314282
furpa,0.16666666666666666,5,5,CTCCGGCAAGGGGCGGTCCC,0,1300546
furpa,0.16666666666666666,5,5,CTCCGACAAGGGCTCTAGAC,0,1286289
furpa,0.16666666666666666,5,5,CTCAGCGCCTGCTTTAGAGC,0,1302452
furpa,0.16666666666666666,5,5,CTCAAGAAGCAGCTATAACG,0,1298436
furpa,0.16666666666666666,5,5,CTATTCAAGTCAGCCTCTGC,0,1352317
furpa,0.16666666666666666,5,5,CTATTAAAGGATCGCGTAGA,0,1283697
furpa,0.16666666666666666,5,5,CTATGCGTAAAACAGCCGTT,0,1309665
furpa,0.16666666666666666,5,5,CTATCTGAGGGTGCTAGAGA,0,1286112
furpa,0.16666666666666666,5,5,CTATCGGGAGTCCTTACAGA,0,1303119
furpa,0.16666666666666666,5,5,CTATCCCCCTGCCTAATAAT,0,1281950
furpa,0.16666666666666666,5,5,CTATAGGATTCGTGGCACTC,0,1321223
furpa,0.16666666666666666,5,5,CTATAACAGAATTGACTAGG,0,1346260
furpa,0.16666666666666666,5,5,CTAGTAAAGGCATTGTTTTC,0,1327908
furpa,0.16666666666666666,5,5,CTAGGTCCTGCTGTGGGCGT,0,1320292
furpa,0.16666666666666666,5,5,CTAGGTCATACGGCAGGGGT,0,1275500
furpa,0.16666666666666666,5,5,CTAGGGGTTTAGGAAAAGTG,0,1315682
furpa,0.16666666666666666,5,5,CTACGTGCGAGGTTTCTGGC,0,1335532
furpa,0.16666666666666666,5,5,CTACCGGTACATAACGGTCA,0,1356430
furpa,0.16666666666666666,5,5,CTACAGTAGGGTTTGCCACA,0,1279801
furpa,0.16666666666666666,5,5,CTAACCGGAGCAAGGCTGAC,0,1343966
furpa,0.16666666666666666,5,5,CTAACCAACCACTAGCCCTA,0,1284595
furpa,0.16666666666666666,5,5,CGTTTTCGGGATTAGCTAGG,0,1294798
furpa,0.16666666666666666,5,5,CGTTTTATGAGCTGCAGAGT,0,1354774
furpa,0.16666666666666666,5,5,CGTTGGGCTAGCTGCGGAAG,0,1324786
furpa,0.16666666666666666,5,5,CGTTATTTAATTGTATCGGC,0,1275094
furpa,0.16666666666666666,5,5,CGTTAGACCCTGGGACGTAG,0,1293803
furpa,0.16666666666666666,5,5,CGTGTCAGAGCTATCAAGGT,0,1271608
furpa,0.16666666666666666,5,5,CGTGGTTTTCGAAATATGGT,0,1311084
furpa,0.16666666666666666,5,5,CGTGGGCATGCACAAGGGTT,0,1321059
furpa,0.16666666666666666,5,5,CGTGCTGTGGGAGCGGAACA,0,1274653
furpa,0.16666666666666666,5,5,CGTGCTCCCGGCAAACATGG,0,1294800
furpa,0.16666666666666666,5,5,CGTCTAGCGAGTAGTTGCAT,0,1287948
furpa,0.16666666666666666,5,5,CGTCTACTTCTTGATTAAAA,0,1333377
furpa,0.16666666666666666,5,5,CGTCGGATCGAGAATAAAGC,0,1271450
furpa,0.16666666666666666,5,5,CGTCCCTGGTCGCGACGTAT,0,1340647
furpa,0.16666666666666666,5,5,CGTCCAGGGATGAAGTAGAT,0,1273526
furpa,0.16666666666666666,5,5,CGTATTCATCATGAAATGTA,0,1292206
furpa,0.16666666666666666,5,5,CGTATATGGGTGCCGCTGCC,0,1305686
furpa,0.16666666666666666,5,5,CGTAGTTTGGCGCGCTAAGG,0,1349613
furpa,0.16666666666666666,5,5,CGTACTAAACCGCTAGCGAA,0,1314551
furpa,0.16666666666666666,5,5,CGTACCCCTCAAGGTTGCCT,0,1300473
furpa,0.16666666666666666,5,5,CGTAACTTAAGTTTTTGGGA,0,1310673
furpa,0.16666666666666666,5,5,CGGTTTTCCCTACTCTATCA,0,1357158
furpa,0.16666666666666666,5,5,CGGTTGGGTGACTGTATTTG,0,1279320
furpa,0.16666666666666666,5,5,CGGTTCGAGCCAAGCCCTTT,0,1291577
furpa,0.16666666666666666,5,5,CGGTTAAGGCATCGAATCGT,0,1285239
furpa,0.16666666666666666,5,5,CGGTCGTCGGCTACCGTTCG,0,1276388
furpa,0.16666666666666666,5,5,CGGTAAGGCACCCATTTTAG,0,1356845
furpa,0.16666666666666666,5,5,CGGTAACGCAGGGCAGTCTA,0,1280542
furpa,0.16666666666666666,5,5,CGGGGCGTACGTCATTGGGA,0,1288672
furpa,0.16666666666666666,5,5,CGGGGCGAGCGCAACGCCTA,0,1289161
furpa,0.16666666666666666,5,5,CGGGGAAGAGCACATGTGTG,0,1297430
furpa,0.16666666666666666,5,5,CGGGCTGTGTACAGGTCACC,0,1289361
furpa,0.16666666666666666,5,5,CGGGCACTTGGTAGTGGTTG,0,1344298
furpa,0.16666666666666666,5,5,CGGCTGTGCCGTGACGCGGT,0,1353200
furpa,0.16666666666666666,5,5,CGGCGCACAACCGCCTATCT,0,1282210
furpa,0.16666666666666666,5,5,CGGCCACAACTACCTGTATT,0,1282308
furpa,0.16666666666666666,5,5,CGGATTTAAGTAGAGTCTAC,0,1347633
furpa,0.16666666666666666,5,5,CGGACCCCACGCACCAAGGT,0,1341731
furpa,0.16666666666666666,5,5,CGGACCACTGAGTGAAGTAC,0,1297579
furpa,0.16666666666666666,5,5,CGCTTGAAGGTCAAAGGTCG,0,1356123
furpa,0.16666666666666666,5,5,CGCTTCGTGATGACGTCGGT,0,1278234
furpa,0.16666666666666666,5,5,CGCTGGCGGGTTGCCGATTT,0,1309892
furpa,0.16666666666666666,5,5,CGCTCATTTGAGCGGTCTTC,0,1337189
furpa,0.16666666666666666,5,5,CGCTCAGCGTTCAACCTGGG,0,1299647
furpa,0.16666666666666666,5,5,CGCTCAAAGCGATGGCGAAG,0,1338382
furpa,0.16666666666666666,5,5,CGCTACTAACAGTTTGACAT,0,1344497
furpa,0.16666666666666666,5,5,CGCTAATTACCGTAAGGCTG,0,1286589
furpa,0.16666666666666666,5,5,CGCGTACGTTTGTAATTTGC,0,1303123
furpa,0.16666666666666666,5,5,CGCGTACCCAACTAGGGCGA,0,1324122
furpa,0.16666666666666666,5,5,CGCGGCGCCATAGTGACGGC,0,1343840
furpa,0.16666666666666666,5,5,CGCGCTGACGCTACGAGATC,0,1295545
furpa,0.16666666666666666,5,5,CGCGCGGTCAACAATTATCA,0,1308798
furpa,0.16666666666666666,5,5,CGCGAGATAGAAAAATGTTA,0,1309714
furpa,0.16666666666666666,5,5,CGCCGGGTATGATTATCGCT,0,1317125
furpa,0.16666666666666666,5,5,CGCCGCGATTCACCGTCCAC,0,1344245
furpa,0.16666666666666666,5,5,CGATGACGCCAGTGGTAGTA,0,1356439
furpa,0.16666666666666666,5,5,CGAGTTCTCATGTAAATCTT,0,1299872
furpa,0.16666666666666666,5,5,CGAGGTTTTGATAAAAAGCA,0,1276969
furpa,0.16666666666666666,5,5,CGAGATCGATCGTTATTAGA,0,1294962
furpa,0.16666666666666666,5,5,CGACTATGGTTTCTCAAGGG,0,1341932
furpa,0.16666666666666666,5,5,CGACTACCTGCGGCTCCAGA,0,1343604
furpa,0.16666666666666666,5,5,CGACGGGGCAGATGGGATTC,0,1342939
furpa,0.16666666666666666,5,5,CGACGCCCTCTGAGAGGCTG,0,1349021
furpa,0.16666666666666666,5,5,CGACGACTCCGTCATCAGCG,0,1339554
furpa,0.16666666666666666,5,5,CGACCCGAAACTTGACCCCG,0,1317742
furpa,0.16666666666666666,5,5,CGACCAGGATCCGCCAGGTT,0,1328094
furpa,0.16666666666666666,5,5,CGACACCGGCGACCCTATTT,0,1338893
furpa,0.16666666666666666,5,5,CGACAAACTCCTCAAGTAAT,0,1317076
furpa,0.16666666666666666,5,5,CGAATAACATATGCCCGCTA,0,1347014
furpa,0.16666666666666666,5,5,CGAAGCAGGCTAATGTTGTT,0,1326067
furpa,0.16666666666666666,5,5,CGAACCTGGGGGGGGAACAC,0,1300858
furpa,0.16666666666666666,5,5,CGAACAGTGTGTATCAGTGT,0,1330860
furpa,0.16666666666666666,5,5,CCTTTTTAGAGCCCCTCTCG,0,1319514
furpa,0.16666666666666666,5,5,CCTTGAGGCTCTCTGCGTAT,0,1305848
furpa,0.16666666666666666,5,5,CCTGGTCTCAGCTGACTTCG,0,1339931
furpa,0.16666666666666666,5,5,CCTGGTAGCATAAAGGGCTC,0,1347186
furpa,0.16666666666666666,5,5,CCTGCAATGGCGTATCCATG,0,1323358
furpa,0.16666666666666666,5,5,CCTGATCTCAAAAGGGTGCA,0,1313839
furpa,0.16666666666666666,5,5,CCTGACCAGTGTCCTGTATT,0,1321051
furpa,0.16666666666666666,5,5,CCTGAACTTGAATGTAGGCA,0,1326397
furpa,0.16666666666666666,5,5,CCTCACTGAAATATTACACT,0,1294496
furpa,0.16666666666666666,5,5,CCTCACCACGAACATCCGTG,0,1355630
furpa,0.16666666666666666,5,5,CCTATCGCTGAGCGTAGTTG,0,1311658
furpa,0.16666666666666666,5,5,CCTAGAATGCGCCGAGACGT,0,1353437
furpa,0.16666666666666666,5,5,CCTACTCGACCTTTAGGGTG,0,1289602
furpa,0.16666666666666666,5,5,CCTACAACCTCGACCTCGTA,0,1280160
furpa,0.16666666666666666,5,5,CCTAAGGGATTTGCCATCCA,0,1309671
furpa,0.16666666666666666,5,5,CCGTGAGTGACGAAAATCGC,0,1309831
furpa,0.16666666666666666,5,5,CCGTCTTCTCTCGGCCAGTA,0,1346176
furpa,0.16666666666666666,5,5,CCGGTTGCTGTCTTATAGTC,0,1297008
furpa,0.16666666666666666,5,5,CCGGTTCAGACGAGGTCCGT,0,1288002
furpa,0.16666666666666666,5,5,CCGGTGTAGTTAAAAGGGGA,0,1351605
furpa,0.16666666666666666,5,5,CCGGTATGGGCCTTCCGTCG,0,1349762
furpa,0.16666666666666666,5,5,CCGGTACACATGTGAGAAAA,0,1297925
furpa,0.16666666666666666,5,5,CCGGGAGTTCACAGGCCAGC,0,1332252
furpa,0.16666666666666666,5,5,CCGCGAGCGACCATAAGATC,0,1341836
furpa,0.16666666666666666,5,5,CCGCGACCAGTGGTACGACA,0,1299941
furpa,0.16666666666666666,5,5,CCGCAGGACGGGATGAGTTC,0,1340290
furpa,0.16666666666666666,5,5,CCGATGGGAGGGTGAGTCTT,0,1293644
furpa,0.16666666666666666,5,5,CCGATGACTACTCGGGACGA,0,1342736
furpa,0.16666666666666666,5,5,CCGATCCCGGGAACTTGAAT,0,1353084
furpa,0.16666666666666666,5,5,CCGATCATGGCCCTTGCTAA,0,1280380
furpa,0.16666666666666666,5,5,CCCTGTTTGAAAGGATAGTA,0,1335903
furpa,0.16666666666666666,5,5,CCCTGGCAGCAGTCATAGCG,0,1342574
furpa,0.16666666666666666,5,5,CCCTGCGACCAGGGACGTAA,0,1281606
furpa,0.16666666666666666,5,5,CCCTCCCGATCTTCGATGAT,0,1293440
furpa,0.16666666666666666,5,5,CCCTAAGAGGGATTGTCTGA,0,1345150
furpa,0.16666666666666666,5,5,CCCTAACTCACCTCACGTTA,0,1301717
furpa,0.16666666666666666,5,5,CCCGTTGGCATGCGCCATCC,0,1317544
furpa,0.16666666666666666,5,5,CCCGGCGCCTTTGCTACTCG,0,1283396
furpa,0.16666666666666666,5,5,CCCGGCGCCTTGTTCGCAGT,0,1315509
furpa,0.16666666666666666,5,5,CCCGAATATATATGCAGCAT,0,1329823
furpa,0.16666666666666666,5,5,CCCGAATACCCGGAGCGGTG,0,1300462
furpa,0.16666666666666666,5,5,CCCCTTTACCATAGGAGTAG,0,1333662
furpa,0.16666666666666666,5,5,CCCCGGTGTGCCATACGCTA,0,1344282
furpa,0.16666666666666666,5,5,CCCCGCTAATAAACTCCGCG,0,1305090
furpa,0.16666666666666666,5,5,CCCCGCAAAGGTGGCCAAAA,0,1349696
furpa,0.16666666666666666,5,5,CCCCCGTACCAGGGCAAATA,0,1275174
furpa,0.16666666666666666,5,5,CCCCCGCAAACGACCCTTAA,0,1353872
furpa,0.16666666666666666,5,5,CCCCCGAGTTTACATACAGA,0,1283187
furpa,0.16666666666666666,5,5,CCCCAGTTTTGGGATTTACT,0,1333894
furpa,0.16666666666666666,5,5,CCCCAGGTGTGGCGCCGATA,0,1290967
furpa,0.16666666666666666,5,5,CCCATATTGGAAAACGGACT,0,1333166
furpa,0.16666666666666666,5,5,CCCATACACAATGATCATTT,0,1280834
furpa,0.16666666666666666,5,5,CCCAGTTCCCATTGAAGGTC,0,1303203
furpa,0.16666666666666666,5,5,CCCAGTTCAGAGATTTAATG,0,1328651
furpa,0.16666666666666666,5,5,CCCACATGCTTGGGGCGAGA,0,1318297
furpa,0.16666666666666666,5,5,CCCAAAATGTCGCATTGGGA,0,1334330
furpa,0.16666666666666666,5,5,CCATGTATTACACAATTCCA,0,1352944
furpa,0.16666666666666666,5,5,CCATCCGTCGCCGGACCAAG,0,1306881
furpa,0.16666666666666666,5,5,CCATCAGCCCGTAGGTACAA,0,1322248
furpa,0.16666666666666666,5,5,CCATATAGGTAGAATCCAGC,0,1293646
furpa,0.16666666666666666,5,5,CCAGTTATATCCGCTCTGAA,0,1337651
furpa,0.16666666666666666,5,5,CCAGGTTTTTTACATTTGGC,0,1288535
furpa,0.16666666666666666,5,5,CCAGGCGTTCGTAGGTGATG,0,1303641
furpa,0.16666666666666666,5,5,CCAGAGTAACGTGGCAATAG,0,1301607
furpa,0.16666666666666666,5,5,CCAGACGAGTACAGTCATTG,0,1320955
furpa,0.16666666666666666,5,5,CCACGTGGGCAGTGCGACTA,0,1347150
furpa,0.16666666666666666,5,5,CCACGTAAATACTAGATACA,0,1292071
furpa,0.16666666666666666,5,5,CCACGAGTCCGGGTCATACT,0,1337268
furpa,0.16666666666666666,5,5,CCACGACTGGGAAGAGGCGT,0,1277444
furpa,0.16666666666666666,5,5,CCACCTTAGGGCTTATCTAC,0,1350498
furpa,0.16666666666666666,5,5,CCACAGGGGATCACAAATCA,0,1283694
furpa,0.16666666666666666,5,5,CCACACGATCAGTTGTGGGG,0,1331922
furpa,0.16666666666666666,5,5,CCAACGGTTGTCGGCAAGTA,0,1300203
furpa,0.16666666666666666,5,5,CATTTTTGACTCCCAGGTGG,0,1335172
furpa,0.16666666666666666,5,5,CATTTCCGATTCGTGCGTAG,0,1303497
furpa,0.16666666666666666,5,5,CATTGCACAAGTGCGGAGAT,0,1279893
furpa,0.16666666666666666,5,5,CATTAGGTCAAGAAGATTCT,0,1294938
furpa,0.16666666666666666,5,5,CATTACCGGGAAGAATAAGC,0,1311437
furpa,0.16666666666666666,5,5,CATTAACATGTGTTCCACGC,0,1296621
furpa,0.16666666666666666,5,5,CATGTAAGGGTGTTCATCGA,0,1281131
furpa,0.16666666666666666,5,5,CATGGCCGATATAGTGGATC,0,1278649
furpa,0.16666666666666666,5,5,CATGCTCATCGTGGTGGCTG,0,1350091
furpa,0.16666666666666666,5,5,CATGACTATTGTCTTTATCC,0,1340373
furpa,0.16666666666666666,5,5,CATGAAATAGGCTGACCGTA,0,1288674
furpa,0.16666666666666666,5,5,CATCGGGATTAGGCTATAAG,0,1342888
furpa,0.16666666666666666,5,5,CATCGCTATGAATCGGAAGA,0,1322858
furpa,0.16666666666666666,5,5,CATCGCCTTCTTGACCAGCC,0,1340534
furpa,0.16666666666666666,5,5,CATCCATGCTAAGCCCCTGT,0,1313523
furpa,0.16666666666666666,5,5,CATCACATCCACTTCTATTC,0,1335116
furpa,0.16666666666666666,5,5,CATAGACTAGCACTAATATA,0,1339998
furpa,0.16666666666666666,5,5,CATACGTCCCGTCGGGAGCT,0,1294696
furpa,0.16666666666666666,5,5,CATACGATCTAGGAACCTAC,0,1315707
furpa,0.16666666666666666,5,5,CATAATTAGCCGCGAAGCTA,0,1278342
furpa,0.16666666666666666,5,5,CATAATGGCATTGCACAGAG,0,1329720
furpa,0.16666666666666666,5,5,CATAAGAGAATACTCACAGA,0,1344975
furpa,0.16666666666666666,5,5,CAGTGGCCAGATGAATGTTC,0,1312451
furpa,0.16666666666666666,5,5,CAGTGGAAAGAGCTAATCCC,0,1280677
furpa,0.16666666666666666,5,5,CAGTGCTCGGCCGGCGCACA,0,1353306
furpa,0.16666666666666666,5,5,CAGTGCAGAAGCGCGTTGAT,0,1343885
furpa,0.16666666666666666,5,5,CAGTAGATGACAAAATTGAG,0,1305738
furpa,0.16666666666666666,5,5,CAGGGTGAGTCATACCGGTA,0,1343422
furpa,0.16666666666666666,5,5,CAGGGACAGTATCTCCGTCA,0,1333536
furpa,0.16666666666666666,5,5,CAGGCGTGACTGTTATGAAC,0,1356882
furpa,0.16666666666666666,5,5,CAGGATTCAGCTACCAGATT,0,1305907
furpa,0.16666666666666666,5,5,CAGCTGCGTCCACTAGCTGC,0,1343944
furpa,0.16666666666666666,5,5,CAGCTCCAATGCTTACTATT,0,1337626
furpa,0.16666666666666666,5,5,CAGCCTTTTGGAGACATAAT,0,1291995
furpa,0.16666666666666666,5,5,CAGCCTCCCACACCGGGGAC,0,1274950
furpa,0.16666666666666666,5,5,CAGCCCGATTGTGGAAAGTT,0,1293869
furpa,0.16666666666666666,5,5,CAGATGCCGCATACTAGACG,0,1297495
furpa,0.16666666666666666,5,5,CAGACCTCTGATTCATAGAA,0,1328084
furpa,0.16666666666666666,5,5,CAGAAGATGAGGAGTGGAGT,0,1279579
furpa,0.16666666666666666,5,5,CAGAAACGATCGGACCATGC,0,1331355
furpa,0.16666666666666666,5,5,CACTTCCGTTCTAGGATTCT,0,1292719
furpa,0.16666666666666666,5,5,CACTTCCCCCGCTCCGTTTT,0,1354586
furpa,0.16666666666666666,5,5,CACTCTAGTGGGGGTTTTAA,0,1326538
furpa,0.16666666666666666,5,5,CACTCGTGGATATTCGCGAG,0,1317237
furpa,0.16666666666666666,5,5,CACTCGCGTATCCTATACGC,0,1322729
furpa,0.16666666666666666,5,5,CACTATCTGAACGTAAACAG,0,1309503
furpa,0.16666666666666666,5,5,CACTAATATAAGGCTCGCAG,0,1287854
furpa,0.16666666666666666,5,5,CACGGTTTTGAACGGCAGCT,0,1355583
furpa,0.16666666666666666,5,5,CACGGTGCAAGAGTAAACTG,0,1276042
furpa,0.16666666666666666,5,5,CACGGTAGGCTGGTGGAGAC,0,1337643
furpa,0.16666666666666666,5,5,CACGGATCGCAGCTGCCATA,0,1310681
furpa,0.16666666666666666,5,5,CACGCACGTATTAGAAGATC,0,1283279
furpa,0.16666666666666666,5,5,CACCTCTCCGGCAGGCAGTC,0,1322359
furpa,0.16666666666666666,5,5,CACCGGTGATGAGAGGGGCA,0,1274371
furpa,0.16666666666666666,5,5,CACCCGCCGGCTCAGAAATC,0,1343677
furpa,0.16666666666666666,5,5,CACCAGCACCGCCCCTGTAT,0,1332361
furpa,0.16666666666666666,5,5,CACAGAGATCATGTGGGCCA,0,1271429
furpa,0.16666666666666666,5,5,CACAGAACGTAGTTATTTGG,0,1323226
furpa,0.16666666666666666,5,5,CACAATTGGGGTTAAGACAA,0,1316824
furpa,0.16666666666666666,5,5,CAATTGGACCATTCGTATGA,0,1348377
furpa,0.16666666666666666,5,5,CAAGGCCTCTTTTTCTATAT,0,1293034
furpa,0.16666666666666666,5,5,CAAGCGGTAAATCAGTATAG,0,1342255
furpa,0.16666666666666666,5,5,CAAGCGCATTGGTTACAGCA,0,1295871
furpa,0.16666666666666666,5,5,CAAGCCCACAGAAGTAAGCG,0,1306836
furpa,0.16666666666666666,5,5,CAAGATCCCTTACCCGGCGA,0,1334607
furpa,0.16666666666666666,5,5,CAACTTTCCAGTGTGTTACT,0,1275313
furpa,0.16666666666666666,5,5,CAACTGTGGCCTACCCACTT,0,1303630
furpa,0.16666666666666666,5,5,CAACCTATATCGGGGTTGTG,0,1273261
furpa,0.16666666666666666,5,5,CAACATAAGGGACTTTTGGA,0,1285405
furpa,0.16666666666666666,5,5,CAAATTACAGGAAGATCTGA,0,1308560
furpa,0.16666666666666666,5,5,CAAATCAAAGAGATGTAGCT,0,1287095
furpa,0.16666666666666666,5,5,CAAATACTAAGTAAAAATCG,0,1281330
furpa,0.16666666666666666,5,5,CAAAGGTGGCTCCGTCTAGC,0,1285376
furpa,0.16666666666666666,5,5,CAAAGGGGCGATTGCTTTCC,0,1338459
furpa,0.16666666666666666,5,5,CAAAGGGCCGTCACACAATT,0,1317236
furpa,0.16666666666666666,5,5,CAAACGGGGTATATACAGTT,0,1332609
furpa,0.16666666666666666,5,5,CAAACGGCCATACACGCCTG,0,1273037
furpa,0.16666666666666666,5,5,CAAAATATAGGTATGGAGGT,0,1319338
furpa,0.16666666666666666,5,5,CAAAAGTGTTGCCCAGCCGT,0,1316700
furpa,0.16666666666666666,5,5,CAAAAGCTGGCGACGCGGGA,0,1297126
furpa,0.16666666666666666,5,5,ATTTTGTATAGCAAGCGTTT,0,1284653
furpa,0.16666666666666666,5,5,ATTTGTTCGCTTCGCTTATG,0,1301995
furpa,0.16666666666666666,5,5,ATTTGCTATCTTTATCTGGC,0,1322107
furpa,0.16666666666666666,5,5,ATTTGACGGGTAATGAACAT,0,1347942
furpa,0.16666666666666666,5,5,ATTTCTCGTGCCCCCAGCGT,0,1356587
furpa,0.16666666666666666,5,5,ATTGTTCGTTAGAACTCTAG,0,1290530
furpa,0.16666666666666666,5,5,ATTGTCCGGACGGGATTTGA,0,1348672
furpa,0.16666666666666666,5,5,ATTGGGATTTGGGGCGGTTT,0,1295283
furpa,0.16666666666666666,5,5,ATTGGAATGCACGCTGTGCC,0,1309672
furpa,0.16666666666666666,5,5,ATTGATCGAGTTGCACACAA,0,1319034
furpa,0.16666666666666666,5,5,ATTGAACATTTAGTTAGAAT,0,1321526
furpa,0.16666666666666666,5,5,ATTCCGACTCTGAAAGGTAA,0,1344651
furpa,0.16666666666666666,5,5,ATTCAGGTCTACACAGTAAT,0,1292142
furpa,0.16666666666666666,5,5,ATTCACTAATGAATGTCTGT,0,1337982
furpa,0.16666666666666666,5,5,ATTCAACAAGTTCTTAGGGT,0,1337241
furpa,0.16666666666666666,5,5,ATTATTTGACAGGTGGACGA,0,1291561
furpa,0.16666666666666666,5,5,ATTATTGCATATCTCCTATA,0,1327006
furpa,0.16666666666666666,5,5,ATTAGGTAGGCGCCCGATTG,0,1304030
furpa,0.16666666666666666,5,5,ATTAGGGCTCCCTCGGTTAG,0,1353973
furpa,0.16666666666666666,5,5,ATTACCTAGGTTCGGATACG,0,1321502
furpa,0.16666666666666666,5,5,ATTAATAGCGACTCAGTATG,0,1352305
furpa,0.16666666666666666,5,5,ATTAACAAATGATCAAACTC,0,1306317
furpa,0.16666666666666666,5,5,ATGTTGGCCATATTACACGT,0,1339556
furpa,0.16666666666666666,5,5,ATGTGGTACTGGGCTTTGTG,0,1343528
furpa,0.16666666666666666,5,5,ATGTGCGGAAATAGGAAGAG,0,1315415
furpa,0.16666666666666666,5,5,ATGTAGTAGGACGACATTTT,0,1325614
furpa,0.16666666666666666,5,5,ATGGTTTCCCATCTTGTTCT,0,1296309
furpa,0.16666666666666666,5,5,ATGGTTGTGAGAGATCGGGA,0,1317339
furpa,0.16666666666666666,5,5,ATGGTGTCCAAGCGTTTCCT,0,1337528
furpa,0.16666666666666666,5,5,ATGGGTACCGCTCATCACTT,0,1322657
furpa,0.16666666666666666,5,5,ATGGGGGCGAACGATGTTAC,0,1336027
furpa,0.16666666666666666,5,5,ATGGGACATTGCTTCTTACG,0,1325456
furpa,0.16666666666666666,5,5,ATGGCAGAGGTCATCTCCGC,0,1277211
furpa,0.16666666666666666,5,5,ATGGATTGTGGCCAAGGTGC,0,1297270
furpa,0.16666666666666666,5,5,ATGGACGCTCCTTCTGTTAG,0,1347637
furpa,0.16666666666666666,5,5,ATGGAAAGGTAAGTCTGGGG,0,1279444
furpa,0.16666666666666666,5,5,ATGCTTACATCTGGCTGCAA,0,1299311
furpa,0.16666666666666666,5,5,ATGCTCCGGATTAGCTCCGC,0,1325461
furpa,0.16666666666666666,5,5,ATGCGGCTACTCAATTGGAG,0,1349753
furpa,0.16666666666666666,5,5,ATGCCTGAGAGGAGTTCGAC,0,1294612
furpa,0.16666666666666666,5,5,ATGCCTCGACTACGCACGAC,0,1355176
furpa,0.16666666666666666,5,5,ATGCAGCGTCGTTAGGGAGC,0,1339869
furpa,0.16666666666666666,5,5,ATGCAATATCCCCCCGCGCG,0,1294532
furpa,0.16666666666666666,5,5,ATGCAAGCTGGAGGGGGGCA,0,1283070
furpa,0.16666666666666666,5,5,ATGATTGTGGGCTCGGTGAT,0,1311207
furpa,0.16666666666666666,5,5,ATGAGCTAGAGCAAGATTTG,0,1327669
furpa,0.16666666666666666,5,5,ATGACGGTAGCTACAGCGAC,0,1299637
furpa,0.16666666666666666,5,5,ATGACCGTTTTGTCGTTAAC,0,1306092
furpa,0.16666666666666666,5,5,ATGACACGCGTACAAGGTGG,0,1332922
furpa,0.16666666666666666,5,5,ATGACAACTACCAACATGTA,0,1322812
furpa,0.16666666666666666,5,5,ATGAACTAATTTCACGAGGT,0,1288190
furpa,0.16666666666666666,5,5,ATGAACCCGACACGTCCGTA,0,1329594
furpa,0.16666666666666666,5,5,ATCTTGAAGAGGAGTTATGT,0,1348633
furpa,0.16666666666666666,5,5,ATCTCTGAGCTCGGGGACTT,0,1279851
furpa,0.16666666666666666,5,5,ATCTACCGAAAGGAAAAGCC,0,1324686
furpa,0.16666666666666666,5,5,ATCGTCATATGAAGGTGACA,0,1303888
furpa,0.16666666666666666,5,5,ATCGCTTTAGAACAATAAGA,0,1335215
furpa,0.16666666666666666,5,5,ATCGCTTTAACTCTTGGGTG,0,1348156
furpa,0.16666666666666666,5,5,ATCGCCTTGCACATGAGTTC,0,1294837
furpa,0.16666666666666666,5,5,ATCCTGACATGGCAACAAAC,0,1303189
furpa,0.16666666666666666,5,5,ATCCGCTGTGGGGTGAATCG,0,1339843
furpa,0.16666666666666666,5,5,ATCCGCAGGTGGTCTGTAAC,0,1289240
furpa,0.16666666666666666,5,5,ATCCCTACACAGTCCGTCGT,0,1279802
furpa,0.16666666666666666,5,5,ATCATTGTGAGAGGTACTGA,0,1350318
furpa,0.16666666666666666,5,5,ATCACGATCCCCGCGACTAG,0,1294617
furpa,0.16666666666666666,5,5,ATCACCGGATCATGCGCGCA,0,1308589
furpa,0.16666666666666666,5,5,ATCACACGCTGTCCGATAGG,0,1300540
furpa,0.16666666666666666,5,5,ATCACACCCTAACGGAGAGT,0,1304124
furpa,0.16666666666666666,5,5,ATCAATCCCATTCCTGGCGT,0,1301715
furpa,0.16666666666666666,5,5,ATCAATATCCACACTCGACC,0,1294693
furpa,0.16666666666666666,5,5,ATCAACTCTTCAGCGTAGGG,0,1317559
furpa,0.16666666666666666,5,5,ATATGTTGCCATACTGCGCC,0,1324417
furpa,0.16666666666666666,5,5,ATATGGGAGTTTAGGCTTTA,0,1281219
furpa,0.16666666666666666,5,5,ATATATCGCCAGGATTAAAC,0,1306917
furpa,0.16666666666666666,5,5,ATAGTAGGCTGAGTGCATCC,0,1277093
furpa,0.16666666666666666,5,5,ATAGGGCGAGAGTCTTGCTC,0,1328787
furpa,0.16666666666666666,5,5,ATAGCGTATTACCCTATTGC,0,1311009
furpa,0.16666666666666666,5,5,ATAGATAGAGGGTCGTCTTG,0,1285580
furpa,0.16666666666666666,5,5,ATACTTATTCCTATGTCGGT,0,1301144
furpa,0.16666666666666666,5,5,ATACGGTAGTCCCTATGTAA,0,1313813
furpa,0.16666666666666666,5,5,ATACGGGCGGTCCAGCTGGC,0,1304323
furpa,0.16666666666666666,5,5,ATACGGACAGGGTGTGTGTC,0,1326086
furpa,0.16666666666666666,5,5,ATACGACTACGAATCCAAAA,0,1355344
furpa,0.16666666666666666,5,5,ATACGAACTGGTGACGCGAG,0,1303964
furpa,0.16666666666666666,5,5,ATACATTCCTCATGTGCCGG,0,1355174
furpa,0.16666666666666666,5,5,ATACAGCATCTGAGTTGATA,0,1305634
furpa,0.16666666666666666,5,5,AGTTTATCTGAGTTCAATAT,0,1298515
furpa,0.16666666666666666,5,5,AGTTTAATTAAGAGGACCTT,0,1292756
furpa,0.16666666666666666,5,5,AGTTGTATAGATCTGTTAGA,0,1306776
furpa,0.16666666666666666,5,5,AGTTGATCGACCTGCGGGTA,0,1356209
furpa,0.16666666666666666,5,5,AGTTACTGGTGTCGGTACTA,0,1277088
furpa,0.16666666666666666,5,5,AGTGCTATCGAGCACGCGAG,0,1303616
furpa,0.16666666666666666,5,5,AGTGCGTATTTCGGGCCAAC,0,1298678
furpa,0.16666666666666666,5,5,AGTGACATGCGATACGGTAT,0,1334062
furpa,0.16666666666666666,5,5,AGTGAACTTCCAGCCGCATT,0,1344048
furpa,0.16666666666666666,5,5,AGTCTCTCCAAAGGGACCAA,0,1282481
furpa,0.16666666666666666,5,5,AGTCCCCATTGTGGTGGCGT,0,1273397
furpa,0.16666666666666666,5,5,AGTATTCGGAGATAAAACGG,0,1328504
furpa,0.16666666666666666,5,5,AGTAGTGGATATTATCCGTA,0,1295897
furpa,0.16666666666666666,5,5,AGTAGCAAGGCTAAGTTAGT,0,1315576
furpa,0.16666666666666666,5,5,AGTAAGCATCGTTTTAAAGG,0,1294852
furpa,0.16666666666666666,5,5,AGGTTTATGATCAAAGACAT,0,1343563
furpa,0.16666666666666666,5,5,AGGTTGATCTGAATTTAATG,0,1343126
furpa,0.16666666666666666,5,5,AGGTTGAAAGGTGACTACGG,0,1315945
furpa,0.16666666666666666,5,5,AGGTTACGAGAGCCAAACTA,0,1299380
furpa,0.16666666666666666,5,5,AGGTGTGTTAAGAACAGAAA,0,1307773
furpa,0.16666666666666666,5,5,AGGTGCCCCGCTGTGCTTAT,0,1328862
furpa,0.16666666666666666,5,5,AGGTCGGCTTAGAATCTGGT,0,1321107
furpa,0.16666666666666666,5,5,AGGTCACTGGTGTCATGGAT,0,1346839
furpa,0.16666666666666666,5,5,AGGTACCATGTCGTAGTTAA,0,1349888
furpa,0.16666666666666666,5,5,AGGGTGTTGACTATCGATCT,0,1273260
furpa,0.16666666666666666,5,5,AGGGTGAATCTCGTGTAGGA,0,1327585
furpa,0.16666666666666666,5,5,AGGGTCGTATATTGGGCCAA,0,1347230
furpa,0.16666666666666666,5,5,AGGGGTCGGGGCCAAGCGAT,0,1300339
furpa,0.16666666666666666,5,5,AGGGCGCATTCTAATGCTGT,0,1339802
furpa,0.16666666666666666,5,5,AGGGCATCGCCGACGCGTTA,0,1277200
furpa,0.16666666666666666,5,5,AGGCTAGAGGTTGCCTTGGA,0,1315740
furpa,0.16666666666666666,5,5,AGGCCAATATTACACCCGTC,0,1334534
furpa,0.16666666666666666,5,5,AGGCAGGCCAAGGACGCCTC,0,1325453
furpa,0.16666666666666666,5,5,AGGATTGACTGAAGGCTTTC,0,1287664
furpa,0.16666666666666666,5,5,AGGAGTTACCAGCTATTTTT,0,1334067
furpa,0.16666666666666666,5,5,AGGACCTTGGATAGTCCGAA,0,1308771
furpa,0.16666666666666666,5,5,AGGAAGTATTTGACCGATAG,0,1273927
furpa,0.16666666666666666,5,5,AGGAACTCTGACGGATATTG,0,1311939
furpa,0.16666666666666666,5,5,AGGAACAATACCTGGGCACC,0,1299392
furpa,0.16666666666666666,5,5,AGCTTTGAAGCCACAGGGAC,0,1330394
furpa,0.16666666666666666,5,5,AGCTCGACTACCACGCTAGG,0,1304560
furpa,0.16666666666666666,5,5,AGCTCCAGAATTGTGACTCA,0,1347464
furpa,0.16666666666666666,5,5,AGCGTGGGAGAGTGCTCCAA,0,1319143
furpa,0.16666666666666666,5,5,AGCGTAGGGCTTCGTAGATC,0,1285487
furpa,0.16666666666666666,5,5,AGCGGTTTAAACGTTAACAG,0,1295230
furpa,0.16666666666666666,5,5,AGCGGCGATGGTCCACCTTA,0,1279295
furpa,0.16666666666666666,5,5,AGCGGCCTCAAATGAAGGAA,0,1322906
furpa,0.16666666666666666,5,5,AGCCTAAATAACGTAATTAG,0,1338976
furpa,0.16666666666666666,5,5,AGCCCATTCGCCATTTGCTG,0,1305270
furpa,0.16666666666666666,5,5,AGCATTGACACATCAGAGCA,0,1311866
furpa,0.16666666666666666,5,5,AGCATTCTTCATGGTAAGGA,0,1308407
furpa,0.16666666666666666,5,5,AGCATTAGGCGTTCAGATGT,0,1318340
furpa,0.16666666666666666,5,5,AGCATGTCGTTTGGGCACAC,0,1278968
furpa,0.16666666666666666,5,5,AGCACTATCACATGGCCTGA,0,1339061
furpa,0.16666666666666666,5,5,AGCAATATATTGACGCTATT,0,1280013
furpa,0.16666666666666666,5,5,AGCAATACGATTCAGACATT,0,1271933
furpa,0.16666666666666666,5,5,AGATGTAGGGGACAGTCGGG,0,1340635
furpa,0.16666666666666666,5,5,AGATCTCGCATAGTCCCTGA,0,1352807
furpa,0.16666666666666666,5,5,AGATATCAACCCCATTCCGT,0,1279373
furpa,0.16666666666666666,5,5,AGATAACGCCGCGTATGCTA,0,1335998
furpa,0.16666666666666666,5,5,AGAGGTTAGACGAATGGCAC,0,1287501
furpa,0.16666666666666666,5,5,AGAGGTGATGCGGGTCAACT,0,1297268
furpa,0.16666666666666666,5,5,AGAGGATGTGATGTACGGAT,0,1286212
furpa,0.16666666666666666,5,5,AGAGAGACTGACGTGAGCAT,0,1288358
furpa,0.16666666666666666,5,5,AGACGTTTCTTAGAGGTCAT,0,1301534
furpa,0.16666666666666666,5,5,AGACGTTAGGTTCGCTCAAA,0,1305406
furpa,0.16666666666666666,5,5,AGACGTGTCGTAGTTAGACT,0,1302948
furpa,0.16666666666666666,5,5,AGAAGTGAGAGAGTGAGCCC,0,1292372
furpa,0.16666666666666666,5,5,AGAAAGTTTACATCTATCAT,0,1307695
furpa,0.16666666666666666,5,5,AGAAAAAAGGATATAAACAT,0,1290515
furpa,0.16666666666666666,5,5,ACTTTTATTGTGATCGTATT,0,1275484
furpa,0.16666666666666666,5,5,ACTTCTAAGGTTGAGTGGCC,0,1317692
furpa,0.16666666666666666,5,5,ACTTCCCCTAAGTCTGAAGT,0,1282546
furpa,0.16666666666666666,5,5,ACTTCAGCCAGGCGGTGCGC,0,1301802
furpa,0.16666666666666666,5,5,ACTTACTAGAATAGCGTTAG,0,1318153
furpa,0.16666666666666666,5,5,ACTTACATGGGGGGCGCGCA,0,1352052
furpa,0.16666666666666666,5,5,ACTGTCCTGTGCTGGACACC,0,1283909
furpa,0.16666666666666666,5,5,ACTGTCAACTGTCACAGGAT,0,1328607
furpa,0.16666666666666666,5,5,ACTGGGCTGCCCATACCACC,0,1323497
furpa,0.16666666666666666,5,5,ACTGGCGAATGCAGCGGTGC,0,1297158
furpa,0.16666666666666666,5,5,ACTGCTTGATGCACGAACTA,0,1352216
furpa,0.16666666666666666,5,5,ACTGCTCTCGAACGTGCGCC,0,1346706
furpa,0.16666666666666666,5,5,ACTGACCCTCCAGTGAGGGG,0,1343972
furpa,0.16666666666666666,5,5,ACTCTTGTTTGGTATTTCTT,0,1308485
furpa,0.16666666666666666,5,5,ACTCTGACGTCAGGAAACTA,0,1343006
furpa,0.16666666666666666,5,5,ACTCGGGTAGGGTAGTGCTA,0,1274539
furpa,0.16666666666666666,5,5,ACTCGCTACATATGATACGA,0,1310125
furpa,0.16666666666666666,5,5,ACTCGAGCGACGTAGATAGA,0,1328690
furpa,0.16666666666666666,5,5,ACTCCGGTTCGGGCGGCCGA,0,1276633
furpa,0.16666666666666666,5,5,ACTCCGCTGCCCGCCACCAC,0,1339266
furpa,0.16666666666666666,5,5,ACTCCCGACGACCGGTGTTC,0,1347454
furpa,0.16666666666666666,5,5,ACTCAGTCGCTTAACTATAC,0,1304628
furpa,0.16666666666666666,5,5,ACTCACACAATGGTTCGAAT,0,1356425
furpa,0.16666666666666666,5,5,ACTATCGCCCCGTCCCACTA,0,1355699
furpa,0.16666666666666666,5,5,ACTACGTAGCATAGTCATTT,0,1339288
furpa,0.16666666666666666,5,5,ACTAACGTCGGGCTTTCACC,0,1290064
furpa,0.16666666666666666,5,5,ACGTTGTACGTCGGTGATCT,0,1319929
furpa,0.16666666666666666,5,5,ACGTTCCGAATCTTCACAGA,0,1330578
furpa,0.16666666666666666,5,5,ACGTTACTCTTTATCCTTCC,0,1326100
furpa,0.16666666666666666,5,5,ACGTGGTACGCTTCCATTCA,0,1295608
furpa,0.16666666666666666,5,5,ACGTGCGCAGAACAAATCTA,0,1320270
furpa,0.16666666666666666,5,5,ACGTGAATATCTGGTGCGGT,0,1287048
furpa,0.16666666666666666,5,5,ACGTAATCACAGTGTCGGCA,0,1321337
furpa,0.16666666666666666,5,5,ACGGTATTGGTACTGGGAAG,0,1346440
furpa,0.16666666666666666,5,5,ACGGGGTATGGTATCAACGG,0,1329018
furpa,0.16666666666666666,5,5,ACGGGAAGGCCCACTATGGT,0,1316369
furpa,0.16666666666666666,5,5,ACGGCTGCAGCACTGGCGTT,0,1298914
furpa,0.16666666666666666,5,5,ACGGCAGCGCCGAACTTGCA,0,1328999
furpa,0.16666666666666666,5,5,ACGGATGCAATAGTTGAATA,0,1333053
furpa,0.16666666666666666,5,5,ACGGATGAGTGGCAGGGTGT,0,1302141
furpa,0.16666666666666666,5,5,ACGGATCAACTCGGCAAACT,0,1274052
furpa,0.16666666666666666,5,5,ACGCTACATGAAATCACAGG,0,1293491
furpa,0.16666666666666666,5,5,ACGCTAAGGAGTCCACCCAC,0,1308570
furpa,0.16666666666666666,5,5,ACGCGTCCGTCATATTGTGG,0,1290940
furpa,0.16666666666666666,5,5,ACGCGGAAAATCCTACAGCC,0,1346236
furpa,0.16666666666666666,5,5,ACGATCAAATCGGTCCGTTT,0,1314192
furpa,0.16666666666666666,5,5,ACGATACTGCCGGCGCATTC,0,1285195
furpa,0.16666666666666666,5,5,ACGAGACATCCCATGAACCT,0,1274933
furpa,0.16666666666666666,5,5,ACGACGCTTAGAACGTATTC,0,1329223
furpa,0.16666666666666666,5,5,ACGAAGTGGAAACAATTTGA,0,1274506
furpa,0.16666666666666666,5,5,ACCTCAAGACAGATTATGGA,0,1340069
furpa,0.16666666666666666,5,5,ACCTATGCACGGAAAGTTTC,0,1304129
furpa,0.16666666666666666,5,5,ACCGTCCTTGGTTACTCAGA,0,1303965
furpa,0.16666666666666666,5,5,ACCGGTTTTCATAGACGGAG,0,1309921
furpa,0.16666666666666666,5,5,ACCGCGCATGCGCGGATGTC,0,1281017
furpa,0.16666666666666666,5,5,ACCGCATGAATAATCTCATG,0,1355550
furpa,0.16666666666666666,5,5,ACCGCAGACTTTAGTAATCG,0,1308270
furpa,0.16666666666666666,5,5,ACCGACCATCTTACTGCACT,0,1303676
furpa,0.16666666666666666,5,5,ACCGAATGGAAACCCTTAGA,0,1343162
furpa,0.16666666666666666,5,5,ACCCTGGTCCCTATAGGGTG,0,1289070
furpa,0.16666666666666666,5,5,ACCCTGGGACTAGTAGGTCA,0,1339534
furpa,0.16666666666666666,5,5,ACCCTCAGCCCCACTTCACT,0,1314377
furpa,0.16666666666666666,5,5,ACCCGGGGCACAGTTTCTGA,0,1299313
furpa,0.16666666666666666,5,5,ACCCAGATATCGCGATGCGC,0,1288677
furpa,0.16666666666666666,5,5,ACCATAGAGAGACTCCGAAC,0,1351108
furpa,0.16666666666666666,5,5,ACCACCTTACGCTGCACGTT,0,1352188
furpa,0.16666666666666666,5,5,ACCAAAGGCGGGGTAGCTCT,0,1328927
furpa,0.16666666666666666,5,5,ACATTGTGTTGTTAACATTC,0,1355088
furpa,0.16666666666666666,5,5,ACATTGTCAGCGGTCAAATG,0,1328160
furpa,0.16666666666666666,5,5,ACATTCGCGTATATCACACT,0,1272964
furpa,0.16666666666666666,5,5,ACATGCTTGGGCTACGTCTA,0,1350585
furpa,0.16666666666666666,5,5,ACATCATGATACTATTGTAG,0,1337049
furpa,0.16666666666666666,5,5,ACATAAACTACTTGAAGGAA,0,1304163
furpa,0.16666666666666666,5,5,ACAGTAGTAACTGTTGGGCA,0,1303631
furpa,0.16666666666666666,5,5,ACAGGGGTTCACACCCCAAG,0,1297227
furpa,0.16666666666666666,5,5,ACAGCAAATGATGAATCCGA,0,1330203
furpa,0.16666666666666666,5,5,ACAGATGAATTGGACGTCTT,0,1289214
furpa,0.16666666666666666,5,5,ACAGAGATGAAACCGTACGA,0,1297036
furpa,0.16666666666666666,5,5,ACAGAAACATTAGTTTCAGA,0,1332742
furpa,0.16666666666666666,5,5,ACACGACTGGGGCGCCCAGG,0,1316512
furpa,0.16666666666666666,5,5,ACAAGTCTAGATCGTCCTGA,0,1357110
furpa,0.16666666666666666,5,5,ACAAGCAGAGATTATTACGA,0,1345386
furpa,0.16666666666666666,5,5,ACAACATGTTGCACGCGACA,0,1286171
furpa,0.16666666666666666,5,5,ACAAATGAAAACTATAGGGG,0,1353742
furpa,0.16666666666666666,5,5,ACAAAAGGATCCAGAATTAA,0,1310529
furpa,0.16666666666666666,5,5,AATTGTGTGCTTCGCCGCCA,0,1348561
furpa,0.16666666666666666,5,5,AATTGACGATCGTTTGATAT,0,1313793
furpa,0.16666666666666666,5,5,AATTCATAGGACTCCAACTT,0,1343370
furpa,0.16666666666666666,5,5,AATTACCTGACTCCTGCGTA,0,1308909
furpa,0.16666666666666666,5,5,AATGTCCTATGAAATGTATA,0,1354421
furpa,0.16666666666666666,5,5,AATGTCACCGGGGCCAATTC,0,1344698
furpa,0.16666666666666666,5,5,AATGCCTTTGTCTGATGACC,0,1294233
furpa,0.16666666666666666,5,5,AATGCAATAAGAGGAGATCC,0,1296113
furpa,0.16666666666666666,5,5,AATCAGGCATAAAAGGGCAG,0,1335956
furpa,0.16666666666666666,5,5,AATATTAATAGGCGCACGGC,0,1309768
furpa,0.16666666666666666,5,5,AATACGAGAATTTTTAGGAG,0,1322365
furpa,0.16666666666666666,5,5,AATACCGTGCAAGCTGGGCT,0,1351580
furpa,0.16666666666666666,5,5,AATACAGACCTCGTCCCAAT,0,1274109
furpa,0.16666666666666666,5,5,AATAATTATTGGGATAACAA,0,1292506
furpa,0.16666666666666666,5,5,AATAAGTATAGCGCTGGTTG,0,1287701
furpa,0.16666666666666666,5,5,AATAAGATTCAACGCGGTCA,0,1351768
furpa,0.16666666666666666,5,5,AATAACGCGCGGTCCGTAAT,0,1288596
furpa,0.16666666666666666,5,5,AAGTTGCGTGATAACCGCGA,0,1303985
furpa,0.16666666666666666,5,5,AAGTTGCCTATCGAAGTGCT,0,1294144
furpa,0.16666666666666666,5,5,AAGTGCGCCATTGCCGGGTT,0,1277031
furpa,0.16666666666666666,5,5,AAGTGCACTTTTCGGTGCCT,0,1280846
furpa,0.16666666666666666,5,5,AAGTCGAATTGGAACCAAGT,0,1296282
furpa,0.16666666666666666,5,5,AAGTACGATGAGGCATGTTC,0,1314754
furpa,0.16666666666666666,5,5,AAGGGGGTACCACCGCCTGG,0,1302188
furpa,0.16666666666666666,5,5,AAGGGACACAGCGTAGCAGA,0,1354246
furpa,0.16666666666666666,5,5,AAGGCGCCATCCTTTATTGT,0,1303295
furpa,0.16666666666666666,5,5,AAGGCGAGGACTACGATCCG,0,1346606
furpa,0.16666666666666666,5,5,AAGGCAGGGTGTCGTGTGTT,0,1328026
furpa,0.16666666666666666,5,5,AAGGAATTTAACCTTACTGG,0,1308645
furpa,0.16666666666666666,5,5,AAGCTATTTTCTGGCAGCGG,0,1320271
furpa,0.16666666666666666,5,5,AAGCTACCGCAACATATAGT,0,1277524
furpa,0.16666666666666666,5,5,AAGCGACGGGGAGCCGGCCC,0,1337046
furpa,0.16666666666666666,5,5,AAGCCAACTTGGAGATGGAC,0,1337407
furpa,0.16666666666666666,5,5,AAGAGTCCGCCGCTTGAGCA,0,1319795
furpa,0.16666666666666666,5,5,AAGAGGCTATGTGGATCTGA,0,1332634
furpa,0.16666666666666666,5,5,AAGAGGCGATTACTCGTGAA,0,1281331
furpa,0.16666666666666666,5,5,AAGACTGGAGGATATCGACT,0,1317920
furpa,0.16666666666666666,5,5,AACTTCCGGTTGCGGAGTCT,0,1325709
furpa,0.16666666666666666,5,5,AACTGGAGTACTGAGTATGA,0,1275118
furpa,0.16666666666666666,5,5,AACGTGGCCGATGCCCGGAG,0,1318206
furpa,0.16666666666666666,5,5,AACGGGCTGGATCCTGCTGG,0,1279300
furpa,0.16666666666666666,5,5,AACGGACGGTACGAGTGCTG,0,1312148
furpa,0.16666666666666666,5,5,AACGATAAAGTGAACTTCTC,0,1355679
furpa,0.16666666666666666,5,5,AACCTCTCCGGCTCTGCGGA,0,1330054
furpa,0.16666666666666666,5,5,AACCCCTTAGGGACTTACGT,0,1309620
furpa,0.16666666666666666,5,5,AACCATTTGTAGTTAATTAA,0,1302654
furpa,0.16666666666666666,5,5,AACAAAGTGCCTTTCGACGG,0,1275397
furpa,0.16666666666666666,5,5,AAATTATATAGTTTTAGTTA,0,1336685
furpa,0.16666666666666666,5,5,AAATGTATCTCTGTCGGCCA,0,1281287
furpa,0.16666666666666666,5,5,AAATGGCGAAACTCGAAGTC,0,1288000
furpa,0.16666666666666666,5,5,AAATGGAGTAGAATGTACAA,0,1356215
furpa,0.16666666666666666,5,5,AAATCGCTAGCTGGACAGGT,0,1318625
furpa,0.16666666666666666,5,5,AAAGTCAGAGGGAATCGGAT,0,1339639
furpa,0.16666666666666666,5,5,AAAGATAGCCAGTCCGGCTT,0,1340209
furpa,0.16666666666666666,5,5,AAACTGTGGTTATTTTGGCT,0,1287261
furpa,0.16666666666666666,5,5,AAAATTACGAGCACGACGTG,0,1338064
furpa,0.16666666666666666,5,5,AAAATACGCTAACTCGGGTG,0,1317981
furpa,0.16666666666666666,5,5,AAAAGGAAGAGTTGACGTCC,0,1326390
furpa,0.16666666666666666,5,5,AAAACTGTCCGTTATACCGA,0,1354313
furpa,0.16666666666666666,5,5,AAAAAGTTTGGTATCCGGGG,0,1314431
furpa,0.2,4,4,TTTTTGCAAGTCCCACGGTA,0,1300196
furpa,0.2,4,4,TTTTTCAGCGTTTCCAGAAA,0,1285264
furpa,0.2,4,4,TTTTTATTTCTGAGAAAGCT,0,1345092
furpa,0.2,4,4,TTTTGTCTGTACGGATTTCG,0,1279479
furpa,0.2,4,4,TTTTGCTAATTGCGAAATGG,0,1292426
furpa,0.2,4,4,TTTTGAGCGGTGGCGCCATT,0,1312670
furpa,0.2,4,4,TTTTGACGTGTCGTATTTGT,0,1289232
furpa,0.2,4,4,TTTTCTTTAATAGGATTGTC,0,1278705
furpa,0.2,4,4,TTTTCTCAACCTTGGCGCAG,0,1352102
furpa,0.2,4,4,TTTTACTACCACCATTAGTG,0,1275131
furpa,0.2,4,4,TTTTAATTGCATAAAAGCAC,0,1332257
furpa,0.2,4,4,TTTGTGTCCGAAAGTGAAAG,0,1325096
furpa,0.2,4,4,TTTGGCGGGCCGGGGGCTCT,0,1297185
furpa,0.2,4,4,TTTGGAAACCAGTCCCGGCG,0,1280316
furpa,0.2,4,4,TTTGATTTGAGCCGGAGCGA,0,1297434
furpa,0.2,4,4,TTTGATAGCAAGTACCAAAC,0,1345539
furpa,0.2,4,4,TTTGACAGGGGTCGAGAAGT,0,1278490
furpa,0.2,4,4,TTTCGTGCGCCACAATTTTA,0,1301577
furpa,0.2,4,4,TTTCGACGCAATAGCCGGAG,0,1337649
furpa,0.2,4,4,TTTCGAACTTTCGGAACGCC,0,1350428
furpa,0.2,4,4,TTTCCACCTAGCATCCAGCT,0,1347870
furpa,0.2,4,4,TTTCATACCCTCCCCACTCG,0,1323975
furpa,0.2,4,4,TTTCACAGCACCAGTGTTGT,0,1291429
furpa,0.2,4,4,TTTATTCTTTGTGTTTTTGA,0,1274812
furpa,0.2,4,4,TTTAGATATGTGTCTGTAAC,0,1346049
furpa,0.2,4,4,TTTACTCCGGCTGACGACAT,0,1303133
furpa,0.2,4,4,TTTACCTAATGGGCCACGGA,0,1289877
furpa,0.2,4,4,TTTAAGAGGTTAGGTTCCAA,0,1276503
furpa,0.2,4,4,TTTAACTACGCGAAGTTTGT,0,1299185
furpa,0.2,4,4,TTGTTGATTGCATGCCGGCG,0,1333746
furpa,0.2,4,4,TTGTCCATTCACCGGCTTGG,0,1324614
furpa,0.2,4,4,TTGTAGCTACGCCTAAGCCA,0,1285032
furpa,0.2,4,4,TTGGTTTAGTCAACAAAATC,0,1306509
furpa,0.2,4,4,TTGGTTCTGAACAGTGAGTG,0,1315241
furpa,0.2,4,4,TTGGTGTTGGCCACCGCTGC,0,1327351
furpa,0.2,4,4,TTGGTCCTTCCCGGTATCGT,0,1337023
furpa,0.2,4,4,TTGGTCAGATACGGGAGAGA,0,1320428
furpa,0.2,4,4,TTGGGTTCGGAGCCGTATTA,0,1275860
furpa,0.2,4,4,TTGGGGGTTCTCCTTACAGG,0,1286161
furpa,0.2,4,4,TTGGGCTCAAAGGACGCGCA,0,1319037
furpa,0.2,4,4,TTGGGCCTAAATCCAGCACC,0,1311107
furpa,0.2,4,4,TTGGGCATGAGAGCCCCTAA,0,1340097
furpa,0.2,4,4,TTGGCGAAACTTACAATTTT,0,1336573
furpa,0.2,4,4,TTGGCAGACGACTTGAAGGT,0,1303502
furpa,0.2,4,4,TTGGATTATAGTAATGGGGG,0,1322031
furpa,0.2,4,4,TTGGACATTTGTCCGTTAGG,0,1328623
furpa,0.2,4,4,TTGGACAGAATCACGTGCCG,0,1291373
furpa,0.2,4,4,TTGCTTACTTCGACGCATCA,0,1356317
furpa,0.2,4,4,TTGCCGTACTACGTAGTTGT,0,1297361
furpa,0.2,4,4,TTGCATAGTGGATTTGATCC,0,1349556
furpa,0.2,4,4,TTGCAAAAACAAGATCACCG,0,1295994
furpa,0.2,4,4,TTGATGTCCCATATCCCGCA,0,1283887
furpa,0.2,4,4,TTGATCTTCACTTCAAAGGG,0,1313443
furpa,0.2,4,4,TTGATCGCGTGCGCTCGGTC,0,1348324
furpa,0.2,4,4,TTGAGTGGGATATCGGAGTC,0,1316677
furpa,0.2,4,4,TTGACCATACATACAGTGCG,0,1281603
furpa,0.2,4,4,TTCTTCGTATGTTCACGTCT,0,1305864
furpa,0.2,4,4,TTCTGTAACTGGGCGCTAGA,0,1287157
furpa,0.2,4,4,TTCTGGCACGCTGAGAAATG,0,1294266
furpa,0.2,4,4,TTCTAGCTTACCCTAGGCCT,0,1300263
furpa,0.2,4,4,TTCTAGACACGGGATTGTTG,0,1303050
furpa,0.2,4,4,TTCGTTCGTGTCTACCTCAC,0,1340369
furpa,0.2,4,4,TTCGTCACTAATCGACTGGA,0,1323921
furpa,0.2,4,4,TTCGTAGTACAGAATTCCTT,0,1291361
furpa,0.2,4,4,TTCGGTACCAAGACCATCCG,0,1311646
furpa,0.2,4,4,TTCGCTACTAAATCGGGCGC,0,1279022
furpa,0.2,4,4,TTCGCGGCAGTTCTTACGAC,0,1319917
furpa,0.2,4,4,TTCGCGATGCTCTTCTTTCA,0,1320754
furpa,0.2,4,4,TTCGAATGACCCCCTCTGTA,0,1340527
furpa,0.2,4,4,TTCCGTTATACTTGTATTTC,0,1315153
furpa,0.2,4,4,TTCCCGCTGTAACTGATGGC,0,1301752
furpa,0.2,4,4,TTCCCCGGCGTCACGGTGAC,0,1283449
furpa,0.2,4,4,TTCATCACAATTCCTCGACC,0,1351304
furpa,0.2,4,4,TTCAGTAAAACAAATAGGTT,0,1304692
furpa,0.2,4,4,TTCAGCTCATATGGGGAGCT,0,1297844
furpa,0.2,4,4,TTCACCTCCGAAAATGGTCT,0,1295857
furpa,0.2,4,4,TTCACATACTGCGAGCCTAA,0,1273334
furpa,0.2,4,4,TTATTTCCGGCAATCTCTAT,0,1315819
furpa,0.2,4,4,TTATTGTGTATCAGGTGGGA,0,1298035
furpa,0.2,4,4,TTATTGTATTCAAAGACTGA,0,1327567
furpa,0.2,4,4,TTATTCGTCTGACGCGTGCT,0,1349359
furpa,0.2,4,4,TTATGCGGGGGACTGATTCA,0,1345301
furpa,0.2,4,4,TTATCCCCTCTCACGTTTCC,0,1286580
furpa,0.2,4,4,TTATAGGTAGTTAACTTTAC,0,1297031
furpa,0.2,4,4,TTATAGAACCACGCGGCTCA,0,1276557
furpa,0.2,4,4,TTATAAGCTCAGGCGCTTAT,0,1341219
furpa,0.2,4,4,TTAGTGCCGTGGTGTCTGGG,0,1317924
furpa,0.2,4,4,TTAGTATTTCTGGACTTACT,0,1353470
furpa,0.2,4,4,TTAGTATTGGAAATATTTGA,0,1324608
furpa,0.2,4,4,TTAGTATTCAAGGTGATGTC,0,1321889
furpa,0.2,4,4,TTAGCCTCCGGCGGGCTGTC,0,1309278
furpa,0.2,4,4,TTACTGTACTGAAGTGGAGG,0,1296688
furpa,0.2,4,4,TTACTACCAGTCATCGCAAG,0,1289956
furpa,0.2,4,4,TTACGGTACGGTGGCGATAG,0,1296169
furpa,0.2,4,4,TTACGACGAAGGGGTATCAG,0,1295456
furpa,0.2,4,4,TTACCCGGGTGTTGTTGATT,0,1328399
furpa,0.2,4,4,TTACCCCTTAGGGGTATGGT,0,1289930
furpa,0.2,4,4,TTACATCCCGCCCGAAGGTA,0,1348378
furpa,0.2,4,4,TTACAGTTAGTGAGACGTAT,0,1285780
furpa,0.2,4,4,TTACAGGCCCAGCGGAGGTC,0,1316351
furpa,0.2,4,4,TTACAAGGATGTGCGTTTAG,0,1324300
furpa,0.2,4,4,TTAATTCCTTCGGCGCTCGC,0,1280964
furpa,0.2,4,4,TTAATCTGCACTAGAAGTAC,0,1279959
furpa,0.2,4,4,TTAATATCCGATCCTCACAA,0,1335994
furpa,0.2,4,4,TTAAGTGACGTATACCCTGG,0,1271863
furpa,0.2,4,4,TTAAGCCGATCGATTTTGCC,0,1278601
furpa,0.2,4,4,TTAACGCGCCGGTGAAGGGT,0,1299196
furpa,0.2,4,4,TTAACGATAGAGTCGCGGTT,0,1287073
furpa,0.2,4,4,TTAACAGCCGCTCTTTATCA,0,1304620
furpa,0.2,4,4,TTAACAGACAGCAGACCATA,0,1342108
furpa,0.2,4,4,TTAAACCGTTGGCATGAGAG,0,1284066
furpa,0.2,4,4,TGTTTCCAAGGCGTGCTGGT,0,1295855
furpa,0.2,4,4,TGTTGCTTCAGGCGAAGCTT,0,1355185
furpa,0.2,4,4,TGTTCTCGCCGTGGCGCACT,0,1343110
furpa,0.2,4,4,TGTTCGCCGATCCTTATGCA,0,1342883
furpa,0.2,4,4,TGTTCGCCCGGGCACGCCAG,0,1293291
furpa,0.2,4,4,TGTTCGATCCCGCAGATAGG,0,1279324
furpa,0.2,4,4,TGTTCCTCTCTCAGGACCGT,0,1352032
furpa,0.2,4,4,TGTGGTAGGCACTGGGACAA,0,1284543
furpa,0.2,4,4,TGTGGGCGCATGAGTAGCCG,0,1291745
furpa,0.2,4,4,TGTGCAGTTGTACGCGGGCA,0,1350973
furpa,0.2,4,4,TGTGAGGAGTCAGGACGGAG,0,1348001
furpa,0.2,4,4,TGTCTCCCTGCCCATGGCCA,0,1356509
furpa,0.2,4,4,TGTCTAGTTTTGACATATGT,0,1316045
furpa,0.2,4,4,TGTCGTGGGCACACGCTGGA,0,1343875
furpa,0.2,4,4,TGTCGGTCCAGTTCCCTCAG,0,1315094
furpa,0.2,4,4,TGTCGGGTGAGAGCCTGTTT,0,1339399
furpa,0.2,4,4,TGTCGCTGCCTGGGTCAAGA,0,1298395
furpa,0.2,4,4,TGTCCTCGACGCTAGGTGGT,0,1355488
furpa,0.2,4,4,TGTCACAGCGAAACAAGAGT,0,1286309
furpa,0.2,4,4,TGTATTGTTAATCCACACGG,0,1338275
furpa,0.2,4,4,TGTATTACATATGAAAGGGC,0,1320774
furpa,0.2,4,4,TGTATCCTTTTTCATTTCGT,0,1292294
furpa,0.2,4,4,TGGTGCTAAAATATTCGCAA,0,1355825
furpa,0.2,4,4,TGGTCATCGAGAAGGATAGA,0,1294788
furpa,0.2,4,4,TGGTCAAGAGTAAGGTTTAT,0,1299434
furpa,0.2,4,4,TGGTATCGCTCCCCTAACGA,0,1341675
furpa,0.2,4,4,TGGTATACGTATCAGGGTCG,0,1282313
furpa,0.2,4,4,TGGTAGGCAGCTGTTGTCAG,0,1331559
furpa,0.2,4,4,TGGGTGATCGGGAAGTGTGA,0,1274525
furpa,0.2,4,4,TGGGTAGTGTATCTTCACGG,0,1332336
furpa,0.2,4,4,TGGGGTCAGAAGAGCTTTTC,0,1318772
furpa,0.2,4,4,TGGGGCTTCTAGAGCCACGG,0,1332901
furpa,0.2,4,4,TGGGGATGAGAGGTGTGGCC,0,1328991
furpa,0.2,4,4,TGGGGACTGTACATCTCGAC,0,1286981
furpa,0.2,4,4,TGGGCGGTGCGATGCGCAGT,0,1299029
furpa,0.2,4,4,TGGGACTGGGGAACGACCGC,0,1294057
furpa,0.2,4,4,TGGGACTAATTCCGAAGACT,0,1337742
furpa,0.2,4,4,TGGCTATAGTCAAGCGACCC,0,1335660
furpa,0.2,4,4,TGGCTAATGGGGATCTGCCA,0,1283234
furpa,0.2,4,4,TGGCGGGTTTAACAGCTCTC,0,1306216
furpa,0.2,4,4,TGGCGGGCTAACAGTTCTAC,0,1329167
furpa,0.2,4,4,TGGCCTCCAATTTGAAACAC,0,1283605
furpa,0.2,4,4,TGGCCGTGAACACATGTCTG,0,1336089
furpa,0.2,4,4,TGGATGCATAACTTAGTCTT,0,1356930
furpa,0.2,4,4,TGGAGTGCGAGTTGTTGACG,0,1351851
furpa,0.2,4,4,TGGAGGGACTGGTGACACTA,0,1310450
furpa,0.2,4,4,TGGAGCAATCAAGAGCGGGG,0,1275546
furpa,0.2,4,4,TGCTTGATTCAGTTCGGGGG,0,1282601
furpa,0.2,4,4,TGCTGCAAGCTGCCTTCCTT,0,1294522
furpa,0.2,4,4,TGCTGAGCCTACTGTACAAG,0,1296233
furpa,0.2,4,4,TGCTATTGGATACGTTAGCC,0,1285191
furpa,0.2,4,4,TGCTAGATGTCGGAAATTGA,0,1337733
furpa,0.2,4,4,TGCTACCCCGCTCACCTCTG,0,1328512
furpa,0.2,4,4,TGCTAAAACTTTTATTACGT,0,1289674
furpa,0.2,4,4,TGCGTCATGCAGCGACATAA,0,1320390
furpa,0.2,4,4,TGCGGGTTGTAATCTCTCGC,0,1353245
furpa,0.2,4,4,TGCGCTCTAGGAGAAGAATC,0,1320772
furpa,0.2,4,4,TGCGCATGCATGGTTAGGGC,0,1294405
furpa,0.2,4,4,TGCGCAATCGCATAATTACT,0,1320690
furpa,0.2,4,4,TGCCCAGTAAAGAAGTTCGG,0,1280587
furpa,0.2,4,4,TGCATTGGGCCGCACAGTAT,0,1294239
furpa,0.2,4,4,TGCATTCGCGGGGGGGTAAT,0,1295476
furpa,0.2,4,4,TGCAGGATCGGAGGGATGGA,0,1352220
furpa,0.2,4,4,TGCAAGAGCTGCCGATTCAG,0,1357662
furpa,0.2,4,4,TGCAAAGCAGACACTTCTGC,0,1297180
furpa,0.2,4,4,TGATTCAACTGAACGTCCTC,0,1347392
furpa,0.2,4,4,TGATCAGGTTCATCTTGCCA,0,1294064
furpa,0.2,4,4,TGATAACTCTTCATCGGCCT,0,1296600
furpa,0.2,4,4,TGAGGACTCTGCCCATGCGG,0,1310564
furpa,0.2,4,4,TGAGATAGGGATGGCCTGTT,0,1334509
furpa,0.2,4,4,TGACTTGTTTGACTCGCAAA,0,1289106
furpa,0.2,4,4,TGACGAGTAAGGTAACGGCC,0,1277191
furpa,0.2,4,4,TGACGAGGGCGCGAGGGAAG,0,1283121
furpa,0.2,4,4,TGACCTACCCGCATGCGTGA,0,1285938
furpa,0.2,4,4,TGACCCGGAAGATAGGTGAC,0,1347977
furpa,0.2,4,4,TGACCACAGCAACAGGTGGT,0,1332364
furpa,0.2,4,4,TGACAGGATCGATGACACCA,0,1287114
furpa,0.2,4,4,TGACACTTGCTTCATGTACT,0,1351697
furpa,0.2,4,4,TGACAAAGGCGACCGGCAAA,0,1349820
furpa,0.2,4,4,TGAATCGGAAGCGATTCAAG,0,1280019
furpa,0.2,4,4,TGAAATTAAGAGACACACAC,0,1287273
furpa,0.2,4,4,TGAAAGACAGTCGTCACTAT,0,1295209
furpa,0.2,4,4,TCTTTAGAAGCAAGCAGGAC,0,1296316
furpa,0.2,4,4,TCTTCAGAACTCGACACCAT,0,1289560
furpa,0.2,4,4,TCTTATCGTAGGGCTCGTAC,0,1274448
furpa,0.2,4,4,TCTTACTCGTTTGCAAGACT,0,1276059
furpa,0.2,4,4,TCTTAAGGGGTTCTGTTTAC,0,1326722
furpa,0.2,4,4,TCTTAAGAACCTTTTATGAT,0,1328302
furpa,0.2,4,4,TCTTAACGAAAGCAAGAGGA,0,1274814
furpa,0.2,4,4,TCTGTGAGCTTGTTGGCCTA,0,1284499
furpa,0.2,4,4,TCTGTGAACCGTCCGAGCAT,0,1316474
furpa,0.2,4,4,TCTGTAGGCAACGTAGCCAC,0,1349671
furpa,0.2,4,4,TCTGTAGAACTTGTGGGGCA,0,1322172
furpa,0.2,4,4,TCTGGTACCCTTGCCCGGGG,0,1349136
furpa,0.2,4,4,TCTGGGGTATACATGAGCCA,0,1314773
furpa,0.2,4,4,TCTGGGATCAAAGTGTTGTA,0,1294391
furpa,0.2,4,4,TCTGGAGGGTAAGCTCGTGA,0,1300403
furpa,0.2,4,4,TCTGCGTCCCGGAATCCCCT,0,1342089
furpa,0.2,4,4,TCTGCCTTCCCTATGGTCAA,0,1319019
furpa,0.2,4,4,TCTGCAAGCTCCGAGCGCAG,0,1272377
furpa,0.2,4,4,TCTGAGGATTTTTTACTAAG,0,1342420
furpa,0.2,4,4,TCTGACCATACCTGCCCATT,0,1354671
furpa,0.2,4,4,TCTCGTCTAAGTAACTCTCT,0,1285898
furpa,0.2,4,4,TCTCGATCGTTAGTCTCGAC,0,1277117
furpa,0.2,4,4,TCTCCGAGAGAAATCCATTT,0,1343580
furpa,0.2,4,4,TCTCCCCGCTTAAGGAAACA,0,1347292
furpa,0.2,4,4,TCTCCAGCTACCCGTCTCAG,0,1287558
furpa,0.2,4,4,TCTATTCGACGGTCCTACTA,0,1331974
furpa,0.2,4,4,TCTATCCAGGGCTAATGCCT,0,1290408
furpa,0.2,4,4,TCTAGGTCGTTCCCTGTAAG,0,1346345
furpa,0.2,4,4,TCTACTTGACGACGCCATTT,0,1353868
furpa,0.2,4,4,TCGTTTCCTCTATGGTTTAA,0,1312430
furpa,0.2,4,4,TCGTTGTAACAGTTTATTCA,0,1344521
furpa,0.2,4,4,TCGTGTCATTATGGGTAATT,0,1318406
furpa,0.2,4,4,TCGTGGGCGCTACACATTCC,0,1330131
furpa,0.2,4,4,TCGTCCACACCACACTACAC,0,1290694
furpa,0.2,4,4,TCGTCAACCTTTCTCCAATC,0,1272700
furpa,0.2,4,4,TCGTACGAAAGGCGGAAAGT,0,1290167
furpa,0.2,4,4,TCGGTCAGTTCTGGCCTAGC,0,1282198
furpa,0.2,4,4,TCGGGTACCCGCTATATAGT,0,1339181
furpa,0.2,4,4,TCGGCGAATTTGTACGCACC,0,1307380
furpa,0.2,4,4,TCGCTTTGGACAGCTCTGGG,0,1339688
furpa,0.2,4,4,TCGCTATTGACCGTCGAATA,0,1341879
furpa,0.2,4,4,TCGCGTATTCCGTCTGTTGT,0,1333375
furpa,0.2,4,4,TCGCGGAATGTGGGAAGTTC,0,1340597
furpa,0.2,4,4,TCGCGACGCTTTCGGCTGCC,0,1279585
furpa,0.2,4,4,TCGCCTTTACGTGTCGTCAG,0,1310799
furpa,0.2,4,4,TCGCCTTACTGCTAGCTGTC,0,1311326
furpa,0.2,4,4,TCGCCTACAACGGGTGGGTG,0,1272660
furpa,0.2,4,4,TCGCAAGGCGCAGGAGTACG,0,1318831
furpa,0.2,4,4,TCGATGTTTATATAAGAGAC,0,1283371
furpa,0.2,4,4,TCGACGGGTCTGACCGGACT,0,1289711
furpa,0.2,4,4,TCGACCCCCCGAATTGGTGC,0,1316831
furpa,0.2,4,4,TCGAATTCTGGAACTGCCAC,0,1345804
furpa,0.2,4,4,TCCTTTCCAAAGAGGGACGC,0,1281955
furpa,0.2,4,4,TCCTATACGAGATGTCTGTA,0,1283895
furpa,0.2,4,4,TCCTAACGCCGTAATTTGAC,0,1347208
furpa,0.2,4,4,TCCGGGGAGTCAAATTCTGA,0,1282501
furpa,0.2,4,4,TCCGGCTAAATACTCATGGA,0,1274524
furpa,0.2,4,4,TCCGCGTCAGATGCTGGTCA,0,1334988
furpa,0.2,4,4,TCCGAGAAGCGCTCGGTATA,0,1341665
furpa,0.2,4,4,TCCGAAGAGTGTCTTTAGCC,0,1319582
furpa,0.2,4,4,TCCCTTTGATTCACCGTAGT,0,1348504
furpa,0.2,4,4,TCCCTCTACGCTGCGGGTGC,0,1354976
furpa,0.2,4,4,TCCCCAAAGATTTCACTGAT,0,1348010
furpa,0.2,4,4,TCCACCTACATAGGTTCCAC,0,1344973
furpa,0.2,4,4,TCCACAGGAGCAGTCCGCTA,0,1289638
furpa,0.2,4,4,TCATTTGGAAGGCAGTGGTT,0,1281784
furpa,0.2,4,4,TCATTTCTGAGCTGCTTCTG,0,1319142
furpa,0.2,4,4,TCATTGATACCCGATCGTGC,0,1327286
furpa,0.2,4,4,TCATTCCTTATCAGCTATTG,0,1336592
furpa,0.2,4,4,TCATTCAGGCGACCTGGGCA,0,1307325
furpa,0.2,4,4,TCATTAGGCCTCTATGTGCG,0,1315648
furpa,0.2,4,4,TCATGGATTGTGGATAAGGT,0,1320582
furpa,0.2,4,4,TCATCTAGGGTGACATGAAT,0,1294140
furpa,0.2,4,4,TCATATCAGCTCGTCACGGT,0,1357487
furpa,0.2,4,4,TCATAGTTAGATGGGTATTT,0,1321195
furpa,0.2,4,4,TCAGTTCGCCCGACGTCTCT,0,1320882
furpa,0.2,4,4,TCAGTTCAACAGCTTACCAT,0,1274168
furpa,0.2,4,4,TCAGGAGCAGAATGGCCCCT,0,1312627
furpa,0.2,4,4,TCAGCGGGTAAAACAGTCTT,0,1312363
furpa,0.2,4,4,TCAGCCGGGAATCCAGATCT,0,1305783
furpa,0.2,4,4,TCACTGAGAAGGCGGACCTG,0,1315154
furpa,0.2,4,4,TCACTCCAGCAAAGCAGCCC,0,1306068
furpa,0.2,4,4,TCACGTGTGGAGACGGGGTA,0,1354197
furpa,0.2,4,4,TCACGTCTTCTACCTATTCA,0,1326500
furpa,0.2,4,4,TCACGGTTGCTCAGAACAGT,0,1289734
furpa,0.2,4,4,TCACCTTTCCAGATATCGCA,0,1334804
furpa,0.2,4,4,TCACCGCGGTGAGATGAAAA,0,1324070
furpa,0.2,4,4,TCACCGATTAATTGGGAATA,0,1321268
furpa,0.2,4,4,TCACCGATTAAAAGAGCTGG,0,1347215
furpa,0.2,4,4,TCAAGGGGGTCTGTGATGGA,0,1307537
furpa,0.2,4,4,TCAACGGTTTCGGAACTGCC,0,1280673
furpa,0.2,4,4,TCAACATCTATTTTGGTTTA,0,1287758
furpa,0.2,4,4,TCAAATTCGTAATCCATCTT,0,1281956
furpa,0.2,4,4,TATTTTTGCCAAACCGGTCA,0,1343660
furpa,0.2,4,4,TATTTTCGGCTGGACAACTA,0,1290532
furpa,0.2,4,4,TATTTCAGACTGTAAGTGCG,0,1342719
furpa,0.2,4,4,TATTGGAGTTGCTTGACGAC,0,1289972
furpa,0.2,4,4,TATTGATACTCACCAATTAG,0,1305017
furpa,0.2,4,4,TATTCCCGACCGACCTCTCA,0,1323722
furpa,0.2,4,4,TATTATTGAACTTCTGGGAG,0,1286264
furpa,0.2,4,4,TATTAACAATTGTCGGCCGT,0,1291492
furpa,0.2,4,4,TATGTGAAATGCTATATGGT,0,1287648
furpa,0.2,4,4,TATGTCGGTGGCGCTGTATG,0,1274178
furpa,0.2,4,4,TATGTAGCTCTGGTTTTTTA,0,1299379
furpa,0.2,4,4,TATGGTTCCGACTACCGGAT,0,1324228
furpa,0.2,4,4,TATGGCCACTTGCAATCTGC,0,1344834
furpa,0.2,4,4,TATGCCGGAACGTGCTAGGA,0,1330035
furpa,0.2,4,4,TATGAGGTACCGGTCCTCAA,0,1301840
furpa,0.2,4,4,TATCGGGCAGGATCGATTCT,0,1296245
furpa,0.2,4,4,TATCCGTCGCATTTAATGAG,0,1342186
furpa,0.2,4,4,TATCAGGTACAAGCGTCCAC,0,1279591
furpa,0.2,4,4,TATATACTAATCTTGAAGGT,0,1294881
furpa,0.2,4,4,TATAGTCTGCAAGATTGGGG,0,1274586
furpa,0.2,4,4,TATACGGAATGATGCTACCA,0,1341272
furpa,0.2,4,4,TATACGAGACTCTGGAGGGC,0,1356062
furpa,0.2,4,4,TATAATGTTGCCCGCGCAAC,0,1299486
furpa,0.2,4,4,TATAACCGCGCCAGGTCCCT,0,1297443
furpa,0.2,4,4,TATAAACCTCAACATGGCCA,0,1346228
furpa,0.2,4,4,TAGGGGAGTTTCCACAGCCG,0,1274504
furpa,0.2,4,4,TAGGGAGTGCTGTTGTCATG,0,1348702
furpa,0.2,4,4,TAGGCCAACAGACGGGATCT,0,1291360
furpa,0.2,4,4,TAGGAGAGCGTGGGTCTGAA,0,1300475
furpa,0.2,4,4,TAGGAATGCGCTCTCCGGTT,0,1285106
furpa,0.2,4,4,TAGCTTCATCAAACGAGACC,0,1344491
furpa,0.2,4,4,TAGCTTAACGGTAGCCTACA,0,1330224
furpa,0.2,4,4,TAGCTGCAGTAGTATTGAAC,0,1280588
furpa,0.2,4,4,TAGCTGCAGATACCCCCCGA,0,1356076
furpa,0.2,4,4,TAGCGCTTCAAACCATCAGT,0,1350965
furpa,0.2,4,4,TAGCGAATGGCTAGCGGGGT,0,1280837
furpa,0.2,4,4,TAGCGAACCGGTTTGAAACA,0,1331873
furpa,0.2,4,4,TAGCCGATCATAACGTATCA,0,1314667
furpa,0.2,4,4,TAGCACCCGGCAGACTGTGA,0,1324944
furpa,0.2,4,4,TAGACGCGCCTTAATCGCAG,0,1348810
furpa,0.2,4,4,TAGACGAACGCTGCGGGGTG,0,1311838
furpa,0.2,4,4,TAGAATAAGGTCGATATTTC,0,1318167
furpa,0.2,4,4,TAGAACTACAGTCCTTGGTC,0,1274438
furpa,0.2,4,4,TAGAACGTGGTTCTGTGAGC,0,1353464
furpa,0.2,4,4,TAGAAAGTATCTAAATGTCT,0,1299442
furpa,0.2,4,4,TAGAAACTTCGGGCTTTTTA,0,1351459
furpa,0.2,4,4,TAGAAAATGGCTGTGGTGTT,0,1352729
furpa,0.2,4,4,TACTGTGGTGGAACTACCGA,0,1293488
furpa,0.2,4,4,TACTGTCGGTTCACGTGTGT,0,1271864
furpa,0.2,4,4,TACTGGGCTTATAGTCAGAA,0,1275793
furpa,0.2,4,4,TACTGCTTAGCCGTTTCATG,0,1333184
furpa,0.2,4,4,TACTGACCATCTGGCTCGTG,0,1346889
furpa,0.2,4,4,TACTCAGATTCGGAAGAACT,0,1345571
furpa,0.2,4,4,TACTACTGTTCCGAGCGTCC,0,1335447
furpa,0.2,4,4,TACGTGGGCACTGATTATCA,0,1353724
furpa,0.2,4,4,TACGTGCTCTGAAGTGGGAA,0,1299134
furpa,0.2,4,4,TACGGATCTAGTACGCCGGG,0,1325374
furpa,0.2,4,4,TACGCCGCAACTGGTCCTCA,0,1283122
furpa,0.2,4,4,TACCTGTACTTGTATATTGC,0,1320323
furpa,0.2,4,4,TACCGGCCTGTAGAATCTCG,0,1271214
furpa,0.2,4,4,TACCCCTCGCGAGGCAATCA,0,1310239
furpa,0.2,4,4,TACATTTATCCATCAACATG,0,1271321
furpa,0.2,4,4,TACATTGATCGGAGTGCAGC,0,1273646
furpa,0.2,4,4,TACAAATTAGCCATCGGGCG,0,1348738
furpa,0.2,4,4,TAATTTGGCTTGCGAATCCA,0,1314253
furpa,0.2,4,4,TAATCTAAAGTTAAGTAGGG,0,1293300
furpa,0.2,4,4,TAATCATATCCCAGCAGTGG,0,1282605
furpa,0.2,4,4,TAATAATCTATCCCTGATGG,0,1351409
furpa,0.2,4,4,TAAGTCAACAGGCTGGAGCG,0,1339321
furpa,0.2,4,4,TAAGGTTAGCCAGCAGCTAA,0,1327136
furpa,0.2,4,4,TAAGGGCTATATCTCTTCAA,0,1316346
furpa,0.2,4,4,TAAGAATTTAATCGCCGACT,0,1336433
furpa,0.2,4,4,TAACTTGACCGTGAACCTAA,0,1353556
furpa,0.2,4,4,TAACTTCGGGTCTAACCAGC,0,1354046
furpa,0.2,4,4,TAACTGGTTCAGCCAGGGGG,0,1351167
furpa,0.2,4,4,TAACTGCTGGGGTTGCTGCG,0,1291586
furpa,0.2,4,4,TAACGTACTGCAGGTGACGG,0,1319519
furpa,0.2,4,4,TAACGACGCTGGTAGTGGCT,0,1282628
furpa,0.2,4,4,TAACGACGATCCACTCCTTT,0,1315204
furpa,0.2,4,4,TAACCCGGGTGAGAGTCGGA,0,1293447
furpa,0.2,4,4,TAACAGTCGGGTACATTATA,0,1294707
furpa,0.2,4,4,TAACACTTAGCTGAGCTGCT,0,1332991
furpa,0.2,4,4,TAACAATGGGATTAGAGGGT,0,1296307
furpa,0.2,4,4,TAAATTGCAATCGGACCAGG,0,1313470
furpa,0.2,4,4,TAAAGTGTCTTCGTGGAGCC,0,1282316
furpa,0.2,4,4,TAAAGTCTAAAGACCAAGGG,0,1308548
furpa,0.2,4,4,TAAAGGGGTGTCCCAGCGTT,0,1276884
furpa,0.2,4,4,TAAACGTGCAGTCCTTGTCC,0,1292957
furpa,0.2,4,4,TAAACGGAGAAGTATATACC,0,1311275
furpa,0.2,4,4,GTTTTGTCTATAAGGGTCTA,0,1316326
furpa,0.2,4,4,GTTTTACTTGGTCAATGTTC,0,1312596
furpa,0.2,4,4,GTTTGGGTTCGCAGAAGCTC,0,1352711
furpa,0.2,4,4,GTTTATAGGCTAGGGAAGAA,0,1357296
furpa,0.2,4,4,GTTGTTTGTGAATGCGGTAA,0,1342776
furpa,0.2,4,4,GTTGTTCAGACGGCCTGCTA,0,1276190
furpa,0.2,4,4,GTTGTCATACCAACTTATAT,0,1276517
furpa,0.2,4,4,GTTGGCATATATTGATGATA,0,1349988
furpa,0.2,4,4,GTTGCTGACAATACCGTGCT,0,1274964
furpa,0.2,4,4,GTTGCATCGAGTTTTGATGA,0,1352815
furpa,0.2,4,4,GTTGAGGAATTAATACTTCA,0,1334736
furpa,0.2,4,4,GTTGAAATGTTATCACTTGT,0,1281183
furpa,0.2,4,4,GTTCTTAGGTCCTCCGGCAA,0,1339634
furpa,0.2,4,4,GTTCTATTCCAAATGATCAT,0,1346950
furpa,0.2,4,4,GTTCGTTCGACACCACCCAA,0,1304027
furpa,0.2,4,4,GTTCGCCCCTAATGACATGG,0,1318142
furpa,0.2,4,4,GTTCACCTAATTACTAATCT,0,1271571
furpa,0.2,4,4,GTTAGTAGGTACCTCGTCTC,0,1302534
furpa,0.2,4,4,GTGTTGCGGTTTCAGAGACC,0,1274324
furpa,0.2,4,4,GTGTGTGGTTAAATATACAA,0,1292381
furpa,0.2,4,4,GTGTGGTCGCAACCAATGGA,0,1308591
furpa,0.2,4,4,GTGTGGAAAAGCAGGTTTTT,0,1273741
furpa,0.2,4,4,GTGTGCATTCCCGACAAGGT,0,1296927
furpa,0.2,4,4,GTGTCATACTCTCTGATCCG,0,1299784
furpa,0.2,4,4,GTGTAGGCGTACGGGATAAA,0,1315178
furpa,0.2,4,4,GTGTAAGCTGGCTAGCATTA,0,1307920
furpa,0.2,4,4,GTGGTACGGTTTGTGCCTGA,0,1305922
furpa,0.2,4,4,GTGGGATGAAGCAGCCAGAG,0,1329365
furpa,0.2,4,4,GTGGCTCGTTAGGGAAACAT,0,1288914
furpa,0.2,4,4,GTGCGCCGTAATCCTAGGGT,0,1284266
furpa,0.2,4,4,GTGCGAACAGAGCCCTTGGT,0,1276058
furpa,0.2,4,4,GTGCCGTAGTAGCAGGACCC,0,1296742
furpa,0.2,4,4,GTGCACCCGGGACTTAGTCA,0,1349589
furpa,0.2,4,4,GTGATAATTCTCTATCAAGG,0,1279864
furpa,0.2,4,4,GTGATAATGGACGACGGCCC,0,1349221
furpa,0.2,4,4,GTGAGGGTACGTAAGACGGT,0,1327216
furpa,0.2,4,4,GTGACTCTTCGGGCAAAATA,0,1273698
furpa,0.2,4,4,GTGACTACAGATTGTGGTGG,0,1330229
furpa,0.2,4,4,GTGAAATCAATCGTTAAATT,0,1347997
furpa,0.2,4,4,GTCTTCGGGGGATGGTCGCT,0,1325939
furpa,0.2,4,4,GTCTGTTAGTAAAGACATGA,0,1298402
furpa,0.2,4,4,GTCTGTGACATGCATGCCGC,0,1293302
furpa,0.2,4,4,GTCTGTCATGGCAGCGAGGT,0,1326916
furpa,0.2,4,4,GTCTGTAAGGTAACTATAGT,0,1348894
furpa,0.2,4,4,GTCTGGGTTCTAGCGCATCG,0,1333824
furpa,0.2,4,4,GTCTCTGTTCACAACTGCTA,0,1357165
furpa,0.2,4,4,GTCTCTGTGCCTTACTGGGA,0,1299058
furpa,0.2,4,4,GTCTCTCACAGACTGCTCAT,0,1320692
furpa,0.2,4,4,GTCTCGTGTAACCACGAGAG,0,1328273
furpa,0.2,4,4,GTCTCATGAGGAGGCCAGGC,0,1330204
furpa,0.2,4,4,GTCTATGAGTAAGTAGTTCT,0,1304648
furpa,0.2,4,4,GTCTACCAATGCGAATGCTT,0,1320677
furpa,0.2,4,4,GTCGTGTTTGGAGATAGGTA,0,1299388
furpa,0.2,4,4,GTCGTGTTAGTTGGAGCTGG,0,1313136
furpa,0.2,4,4,GTCGTCCGGGCATACAACAA,0,1328500
furpa,0.2,4,4,GTCGCCAGAAGTGCACTAGA,0,1349585
furpa,0.2,4,4,GTCGAGATTCGTTATGGCCA,0,1333257
furpa,0.2,4,4,GTCCGTTACTGAAGCATCAG,0,1297417
furpa,0.2,4,4,GTCCGATATAGACTCCGCTG,0,1306032
furpa,0.2,4,4,GTCCGAAGTTTACCCCGGTC,0,1290815
furpa,0.2,4,4,GTCCCATTGATCAAAAACCT,0,1345655
furpa,0.2,4,4,GTCCAACATTCTCCATCATA,0,1350984
furpa,0.2,4,4,GTCATTCATCGGGAGGAGGA,0,1283115
furpa,0.2,4,4,GTCATTACTCTGGTGACACC,0,1296871
furpa,0.2,4,4,GTCATCTATCGTTGACGACG,0,1308424
furpa,0.2,4,4,GTCATCGTAGATATGGATGT,0,1271341
furpa,0.2,4,4,GTCATCAATTATAGTAGGTT,0,1332168
furpa,0.2,4,4,GTCATAAGAATTTTGACCGA,0,1278893
furpa,0.2,4,4,GTCAGTCAGCGTTTCGATAG,0,1283554
furpa,0.2,4,4,GTCAGATGGAATTCGTATAT,0,1318664
furpa,0.2,4,4,GTCACGACAGCTAGTATGTA,0,1286977
furpa,0.2,4,4,GTCACATCGGGGAGGAACAA,0,1350162
furpa,0.2,4,4,GTCACAGAGTAAAGGCCATT,0,1338104
furpa,0.2,4,4,GTCACAAGAATCCAATCGGG,0,1287749
furpa,0.2,4,4,GTCACAACTTGAACAACCTG,0,1302643
furpa,0.2,4,4,GTCAACCGTAGAAATACGTT,0,1347790
furpa,0.2,4,4,GTCAAACGGTGAGAGATGTA,0,1294406
furpa,0.2,4,4,GTATGTTCCCTATCTAGGCT,0,1285763
furpa,0.2,4,4,GTATGCCTGCCGTTGCCTCT,0,1276767
furpa,0.2,4,4,GTATGCCACGCCACCAGGCT,0,1325144
furpa,0.2,4,4,GTATGCAGTGATTGTAGTGT,0,1303870
furpa,0.2,4,4,GTATCGGTAGTCGCCCATGG,0,1344719
furpa,0.2,4,4,GTATCACCGTATGTCTGCAA,0,1293651
furpa,0.2,4,4,GTATAGCGCGTCCGTGGGCG,0,1294401
furpa,0.2,4,4,GTAGTGGGAAATCGCAACCG,0,1325232
furpa,0.2,4,4,GTAGGGTGTCGCATAGATTT,0,1347484
furpa,0.2,4,4,GTAGGCAGACTACGTTCTAC,0,1310791
furpa,0.2,4,4,GTAGCCGTAGGGCTCAGACA,0,1275111
furpa,0.2,4,4,GTAGACTGAACTTTATACGG,0,1301566
furpa,0.2,4,4,GTACGCACGTCCCCTCGTGC,0,1351553
furpa,0.2,4,4,GTACGACCTAAGATGCAATT,0,1357318
furpa,0.2,4,4,GTACAGTAGTAGACGCGTGT,0,1320385
furpa,0.2,4,4,GTACACGTTGGGGTTAATGC,0,1316129
furpa,0.2,4,4,GTAATGGCTTCACCCCACTT,0,1328182
furpa,0.2,4,4,GTAATGAGCAGGTAAAGTTG,0,1331512
furpa,0.2,4,4,GTAATCGCTAGATGTACATA,0,1333947
furpa,0.2,4,4,GTAAGTCAATGGACGCAGAG,0,1327844
furpa,0.2,4,4,GTAAGCACTCTATCAGATCG,0,1335325
furpa,0.2,4,4,GGTTTCAGCACTCCTGGCCT,0,1286889
furpa,0.2,4,4,GGTTCTAATTTGCTCCAGTG,0,1321158
furpa,0.2,4,4,GGTTCGGGTCTCGAGCGACC,0,1323168
furpa,0.2,4,4,GGTTATAAGTGAACGCGCAT,0,1326652
furpa,0.2,4,4,GGTTAGTCCTTAGTGGGTGT,0,1317498
furpa,0.2,4,4,GGTGTTTTATGATTGCGCTG,0,1306911
furpa,0.2,4,4,GGTGTGCCGTAAAACTTACA,0,1336908
furpa,0.2,4,4,GGTGCTCCGTCTAGTTTAGG,0,1353709
furpa,0.2,4,4,GGTGATACGGATCCCCAAAG,0,1317030
furpa,0.2,4,4,GGTGAAGCGACAGGGGACTC,0,1287011
furpa,0.2,4,4,GGTCTGAACATTTAGCACTG,0,1352296
furpa,0.2,4,4,GGTCGGTAAGACTCAATGCT,0,1288351
furpa,0.2,4,4,GGTCCTGGGCGGAGTGAAGT,0,1332527
furpa,0.2,4,4,GGTCCAGTGCTGACGCAAAA,0,1355052
furpa,0.2,4,4,GGTAGATTATCTGTACTTAT,0,1299143
furpa,0.2,4,4,GGTACCCCGCCCCAGGAAAG,0,1278991
furpa,0.2,4,4,GGTACCCCCAGCGTATTTGT,0,1318017
furpa,0.2,4,4,GGTAAGTTGTTTTTCCGGAG,0,1281800
furpa,0.2,4,4,GGTAAGAGTTATGTGGGAGT,0,1326790
furpa,0.2,4,4,GGGTTTTGAGTATTCGAATT,0,1318525
furpa,0.2,4,4,GGGTTCTCCGTGTCACATAC,0,1326829
furpa,0.2,4,4,GGGTTCGTTTGCATATAGTT,0,1352244
furpa,0.2,4,4,GGGTTCATTCGCTTCGTTCA,0,1291501
furpa,0.2,4,4,GGGTGTCCCTGGTTGAAAGC,0,1323532
furpa,0.2,4,4,GGGTGCTCTGCGCAGTAACA,0,1337191
furpa,0.2,4,4,GGGTCAGTATGAAGTATTCA,0,1313897
furpa,0.2,4,4,GGGTATACCCTGTTCAGCAT,0,1328772
furpa,0.2,4,4,GGGTAGAGTAACGGTTGCCT,0,1347835
furpa,0.2,4,4,GGGTAAACGACCCCAATAAG,0,1283135
furpa,0.2,4,4,GGGGTAGGTCACCCTCCCAG,0,1325990
furpa,0.2,4,4,GGGGGGGTATTTTTGAGGCT,0,1324637
furpa,0.2,4,4,GGGGGCGTAGGGATTGGGAG,0,1305243
furpa,0.2,4,4,GGGGCATTGCGACTCTACGG,0,1274329
furpa,0.2,4,4,GGGGATTTGCAGGGAGAATT,0,1348142
furpa,0.2,4,4,GGGCTGCGTAGCCTCAATTC,0,1356155
furpa,0.2,4,4,GGGCTAGCTTTGGATCCATG,0,1323884
furpa,0.2,4,4,GGGCGTTCTGGTCTCCTTTT,0,1303024
furpa,0.2,4,4,GGGCCTCTGGTAGTTCAATC,0,1347846
furpa,0.2,4,4,GGGCCTATGATGGCAATCAG,0,1352808
furpa,0.2,4,4,GGGCAGGGATAATGTCAGCT,0,1283446
furpa,0.2,4,4,GGGAGTTTCTAAAGTGTCAA,0,1277086
furpa,0.2,4,4,GGGACTACATACGGGTTTAA,0,1278923
furpa,0.2,4,4,GGGAAGTCGCTGTGGCGATT,0,1318688
furpa,0.2,4,4,GGGAAACGATGGATCTTCCC,0,1313954
furpa,0.2,4,4,GGCTTGGGATTAGCGCCCCA,0,1325182
furpa,0.2,4,4,GGCTTATTACGAATACTCTC,0,1342552
furpa,0.2,4,4,GGCTCCAGCCCCGCCGAGGC,0,1334615
furpa,0.2,4,4,GGCTCAAAATTGTTAACGCC,0,1289213
furpa,0.2,4,4,GGCTAGCTAATATCTAAGTA,0,1330265
furpa,0.2,4,4,GGCTAACGTCACGTACCCTC,0,1330509
furpa,0.2,4,4,GGCGTTTCCACTAGCAAACC,0,1352735
furpa,0.2,4,4,GGCGTGACTGGATCAGGACC,0,1326658
furpa,0.2,4,4,GGCGTGACGACAACCCGATC,0,1308901
furpa,0.2,4,4,GGCGTCCTCCCATGTCCGAG,0,1333757
furpa,0.2,4,4,GGCGGCTCGAATGCGAAAGC,0,1324863
furpa,0.2,4,4,GGCGCTAGGAGATAACCTTA,0,1277809
furpa,0.2,4,4,GGCGCCTGGGCGATGTCATC,0,1314705
furpa,0.2,4,4,GGCGATTGGTCGTTGGGTAG,0,1352273
furpa,0.2,4,4,GGCCTTTGCAGCCGCAGAGC,0,1331593
furpa,0.2,4,4,GGCCTTGCAACAACCTTGCA,0,1271726
furpa,0.2,4,4,GGCCGGGTCTACACGTTTGG,0,1274173
furpa,0.2,4,4,GGCCGACATGTGAACCGACA,0,1272592
furpa,0.2,4,4,GGCCCCTCCACAGCGTAGGA,0,1308536
furpa,0.2,4,4,GGCCCATTCTGTCACAAGGT,0,1352170
furpa,0.2,4,4,GGCCAGGTTACGGGCGGCTA,0,1347422
furpa,0.2,4,4,GGCCAGGTCCTAATGTCAGT,0,1351453
furpa,0.2,4,4,GGCCAAGGATATTTACGATT,0,1336391
furpa,0.2,4,4,GGCATTAACCGTATGTCAGA,0,1347360
furpa,0.2,4,4,GGCACTTGGGGCCTCGGCGT,0,1345957
furpa,0.2,4,4,GGCAATCGGGCGACCTTTGC,0,1274565
furpa,0.2,4,4,GGCAAGACGACGTTGTGTAT,0,1306327
furpa,0.2,4,4,GGCAAATTCGAATAAGTGAT,0,1342009
furpa,0.2,4,4,GGATTTCCGTGCTTGTCGGA,0,1300600
furpa,0.2,4,4,GGATTCTATTATCGTCTGTT,0,1354579
furpa,0.2,4,4,GGATGTCTTATCCAGCTCTC,0,1287679
furpa,0.2,4,4,GGATGGTAATTTGGCTTGAC,0,1309546
furpa,0.2,4,4,GGATGGGCGCACAGACGGTC,0,1309949
furpa,0.2,4,4,GGATCGTTCCAACCTTCATA,0,1352640
furpa,0.2,4,4,GGATATGATAGTTGATCCAC,0,1341516
furpa,0.2,4,4,GGAGTTCAAAGAGTGCTCAG,0,1277290
furpa,0.2,4,4,GGAGGTTCAGTACGAGCCTA,0,1273943
furpa,0.2,4,4,GGAGGCGCCACATGGCCTCA,0,1282936
furpa,0.2,4,4,GGAGCTAAGTTTTGCAATAC,0,1357068
furpa,0.2,4,4,GGAGCAGGAGGAAGTCCGAC,0,1276928
furpa,0.2,4,4,GGAGACGCATTAAGTATTTA,0,1321496
furpa,0.2,4,4,GGAGACCGTCGATATGAAAT,0,1291965
furpa,0.2,4,4,GGACTTTAAGCGAAACCAGT,0,1343661
furpa,0.2,4,4,GGACTGGTGTGGGATGGGGC,0,1331180
furpa,0.2,4,4,GGACGTAAATACTCATAAGA,0,1357625
furpa,0.2,4,4,GGACCAATCTCGAAGACCCT,0,1330118
furpa,0.2,4,4,GGACAATGCGACGTATTAAA,0,1285482
furpa,0.2,4,4,GGAATCTCGACACTTCCATA,0,1293374
furpa,0.2,4,4,GGAAGACGCCCGCATGACGA,0,1330644
furpa,0.2,4,4,GGAACTACTCGGGAGTGAGG,0,1323773
furpa,0.2,4,4,GGAACTAAATCGGACAAGCA,0,1287804
furpa,0.2,4,4,GGAACGGCGGTTATGGTAAT,0,1302376
furpa,0.2,4,4,GGAACCATCGTTGAATGCTA,0,1354543
furpa,0.2,4,4,GGAACAACAAGCCTTCTGAA,0,1336024
furpa,0.2,4,4,GCTTTGTTAATGCTTGCGAT,0,1306903
furpa,0.2,4,4,GCTTTACCTGAGGAGACCGC,0,1350967
furpa,0.2,4,4,GCTTGGACACCGGGTTATGC,0,1339560
furpa,0.2,4,4,GCTTGCGCCCCCTAGACTCA,0,1310699
furpa,0.2,4,4,GCTTCGGTACGGGAGGCCTC,0,1351743
furpa,0.2,4,4,GCTTAGGCGACCTCGCGAAA,0,1343760
furpa,0.2,4,4,GCTGTACGTTTTAGAAAACG,0,1323593
furpa,0.2,4,4,GCTGCCGGGCGCCAGACCTC,0,1337866
furpa,0.2,4,4,GCTGAGCGAGTGTCAGGCGG,0,1323362
furpa,0.2,4,4,GCTCGGTTTGGAGGGCTGGG,0,1316354
furpa,0.2,4,4,GCTCGGTCAAAATATGTGGT,0,1339880
furpa,0.2,4,4,GCTCCCGGTTCCAATTGAGG,0,1330113
furpa,0.2,4,4,GCTATGAGGCATCACGTGCC,0,1354567
furpa,0.2,4,4,GCTAGTGTGGGAAGCTATCA,0,1319555
furpa,0.2,4,4,GCTAACGAGCGATACCTTAT,0,1356361
furpa,0.2,4,4,GCTAAATACTTCGTGTCCTG,0,1346354
furpa,0.2,4,4,GCGTTTGGCTGCCTCTTCGA,0,1333288
furpa,0.2,4,4,GCGTTCAAATGTGTAATAAA,0,1275628
furpa,0.2,4,4,GCGTGTGGGGAGTTCCGAAA,0,1332230
furpa,0.2,4,4,GCGTGTGCGTATGTGTAGTT,0,1308903
furpa,0.2,4,4,GCGTGAGTCTCGCCGCGAAT,0,1315099
furpa,0.2,4,4,GCGTCTGAGTACACCGCGGA,0,1303626
furpa,0.2,4,4,GCGTCAGTGCATACATAAAA,0,1343150
furpa,0.2,4,4,GCGTAGGAGGGGTTTTTATG,0,1340399
furpa,0.2,4,4,GCGTAACATATGCACGTGAA,0,1333196
furpa,0.2,4,4,GCGGTTGGCCGACCCGACTC,0,1281286
furpa,0.2,4,4,GCGGTGGTTCTAAGCTTACT,0,1297136
furpa,0.2,4,4,GCGGTCACTGACGCAGAGCC,0,1342442
furpa,0.2,4,4,GCGGATTCGGCAGCCGGATA,0,1299747
furpa,0.2,4,4,GCGCTTTTAAACGGAAAAGC,0,1272007
furpa,0.2,4,4,GCGCTTCATAGGGGTTATTC,0,1341687
furpa,0.2,4,4,GCGCGGTCCGCTACCACTGC,0,1348682
furpa,0.2,4,4,GCGCGAGGGGTACCAATGGA,0,1302203
furpa,0.2,4,4,GCGCCTCTGTGTCATGAGTT,0,1331073
furpa,0.2,4,4,GCGCCTCCGGGGCCAGCCAT,0,1329036
furpa,0.2,4,4,GCGCAATCCGCACATAAAGG,0,1322776
furpa,0.2,4,4,GCGCAATCCGAACTCTTTTT,0,1288690
furpa,0.2,4,4,GCGCAAGGACAATTGCATAT,0,1344328
furpa,0.2,4,4,GCGATGGCGTACTCTTATGC,0,1335280
furpa,0.2,4,4,GCGAGTGTCTATCTACGCCA,0,1317420
furpa,0.2,4,4,GCGAGCGCAATATCTGGGGG,0,1349489
furpa,0.2,4,4,GCGACCGGCGGTGATGATCA,0,1305733
furpa,0.2,4,4,GCGAAAGTTACCCAACAATA,0,1326969
furpa,0.2,4,4,GCGAAACTCGGAGCGCAATA,0,1284138
furpa,0.2,4,4,GCGAAAATTAACAGCTAGTT,0,1318325
furpa,0.2,4,4,GCCTTGGACGTCCGACATAA,0,1315240
furpa,0.2,4,4,GCCTTAAACTGGGGGTACTC,0,1277657
furpa,0.2,4,4,GCCTGTAATCTAATTGAGTA,0,1331428
furpa,0.2,4,4,GCCTATATAGGATCCATGAT,0,1326050
furpa,0.2,4,4,GCCTAAAAAGGGTCACTTGC,0,1281068
furpa,0.2,4,4,GCCGTTTGTATCTTTGTGAG,0,1311945
furpa,0.2,4,4,GCCGTTAATAGCGCTGCTGT,0,1331600
furpa,0.2,4,4,GCCGTGATGCACGGGACTAA,0,1285739
furpa,0.2,4,4,GCCGCAAGGAGCTGTGCGGT,0,1357084
furpa,0.2,4,4,GCCGACGCAGTTATAATTAT,0,1296811
furpa,0.2,4,4,GCCGAATCGATGTTGTCACC,0,1309654
furpa,0.2,4,4,GCCCGGCCCCTAGTTAGAAA,0,1334620
furpa,0.2,4,4,GCCCACGACTTGCTGCTTGT,0,1272177
furpa,0.2,4,4,GCCCAACGCAAAAGCCGAGA,0,1324763
furpa,0.2,4,4,GCCCAAATCGCTGCGTTCTT,0,1355012
furpa,0.2,4,4,GCCATGTGCACCACACGGAG,0,1332611
furpa,0.2,4,4,GCCAGTCGATTTCCCGTAGC,0,1327196
furpa,0.2,4,4,GCCACTGGAGCGGCAGGGAT,0,1340191
furpa,0.2,4,4,GCCACGCTGCTGGTGGCATA,0,1336337
furpa,0.2,4,4,GCCACGCATCACGTGAGGTA,0,1289441
furpa,0.2,4,4,GCCAAGGTTCATGCAAGACC,0,1274319
furpa,0.2,4,4,GCCAACCCGAACTACCGTAA,0,1300504
furpa,0.2,4,4,GCCAACAGGTTGTTCGTTGG,0,1304677
furpa,0.2,4,4,GCCAAATACTCGGCACGCAT,0,1307927
furpa,0.2,4,4,GCATTAGGAGGGGTCGGGAT,0,1331946
furpa,0.2,4,4,GCATTACGCCCAAGAAGATC,0,1315151
furpa,0.2,4,4,GCATGGCACGTTACTCGGTG,0,1297585
furpa,0.2,4,4,GCATCTCTGATGCTCTTGAA,0,1287811
furpa,0.2,4,4,GCATAGGTCCCGAGGTGCCT,0,1314715
furpa,0.2,4,4,GCATAAGATTGGATGTCATT,0,1289105
furpa,0.2,4,4,GCAGTTAATAAGACTATGGT,0,1331967
furpa,0.2,4,4,GCAGGTTCATTCTATGAGCC,0,1307421
furpa,0.2,4,4,GCAGGGATCGGGGAATTGTT,0,1288726
furpa,0.2,4,4,GCAGACTGAGGCGTTGGGGT,0,1357246
furpa,0.2,4,4,GCACTCACGAGCTCTCAGCA,0,1291080
furpa,0.2,4,4,GCACGGCGAGTACATTATTA,0,1277415
furpa,0.2,4,4,GCACGCTTCCGCACGCGGTC,0,1280094
furpa,0.2,4,4,GCACCACCTTGCTGATTCGT,0,1343837
furpa,0.2,4,4,GCACAGGACTCTCTAGGTGG,0,1330945
furpa,0.2,4,4,GCAATTGGTTTTGGTCACGT,0,1284676
furpa,0.2,4,4,GCAATACCCCCTACCGCTCT,0,1313074
furpa,0.2,4,4,GCAAGTTACAATGTCGAAGT,0,1332612
furpa,0.2,4,4,GCAACTTATTGGCTTGCCCT,0,1351883
furpa,0.2,4,4,GCAAATATGATTGGATCGTG,0,1299118
furpa,0.2,4,4,GATTTTCTTTTAACGGGGAT,0,1274575
furpa,0.2,4,4,GATTTGTCGGTTCGTTCATA,0,1288685
furpa,0.2,4,4,GATTTGATCTGAAATGTAGA,0,1348917
furpa,0.2,4,4,GATTGCGAAATCAGCGTAAG,0,1295576
furpa,0.2,4,4,GATTCTATATAAGGCTTCTC,0,1327572
furpa,0.2,4,4,GATTCGCCTCAGTCATGGGG,0,1304751
furpa,0.2,4,4,GATTCAACACGCTGCTAATT,0,1330119
furpa,0.2,4,4,GATGGCAGGACCCTACAATG,0,1351020
furpa,0.2,4,4,GATGGCAAAGCGCGTTGTAC,0,1274259
furpa,0.2,4,4,GATGCGGGTAGTGTTTTAGT,0,1297848
furpa,0.2,4,4,GATGCAAGGTTTAAGCAAAT,0,1325493
furpa,0.2,4,4,GATGACATATCATCAAAGGA,0,1295976
furpa,0.2,4,4,GATCCTTTGTGCCACGTTTG,0,1310416
furpa,0.2,4,4,GATCACTATTCGCCGTCTGG,0,1297117
furpa,0.2,4,4,GATATCGCCAGCGGCCCCAG,0,1356690
furpa,0.2,4,4,GATAGGTTGAGCTTCACAAT,0,1307333
furpa,0.2,4,4,GATAGGGTCAAAGCTAATGA,0,1318303
furpa,0.2,4,4,GATAGGCCTAAGACCCATAT,0,1319850
furpa,0.2,4,4,GATACGCCTGGGGCTGGGGG,0,1278877
furpa,0.2,4,4,GATAAGGAGTATACGCCCGA,0,1327451
furpa,0.2,4,4,GATAAGAACAGCTTCTGGGG,0,1330947
furpa,0.2,4,4,GAGTGACCAAGATCTTAAAT,0,1316062
furpa,0.2,4,4,GAGTCTTACTTCTTGCAAAC,0,1317228
furpa,0.2,4,4,GAGTCTTAATCATCACTGTT,0,1292390
furpa,0.2,4,4,GAGTCTGCCGAACTTGGGAT,0,1278720
furpa,0.2,4,4,GAGTCCCGAGTTCTGAATGC,0,1285192
furpa,0.2,4,4,GAGTCACTCCTAGCCCCAAC,0,1278919
furpa,0.2,4,4,GAGTAGTGAGTGTAACCCAA,0,1277816
furpa,0.2,4,4,GAGTACCGATTGACACAATT,0,1340440
furpa,0.2,4,4,GAGGTTCTCGGAATGCATGA,0,1342553
furpa,0.2,4,4,GAGGGGTATTCCTGGGTAAG,0,1318409
furpa,0.2,4,4,GAGGGCGTGGATGCATTGGT,0,1316277
furpa,0.2,4,4,GAGGCGTAACATCATGCTGG,0,1279659
furpa,0.2,4,4,GAGGAAACTCGCGCCCGTAA,0,1326115
furpa,0.2,4,4,GAGCTCTTCTTCGTCATATT,0,1308841
furpa,0.2,4,4,GAGCGGTTCCGAAACACTAG,0,1320693
furpa,0.2,4,4,GAGCGAGCACAATAGGATCA,0,1314828
furpa,0.2,4,4,GAGCCGTGCTAAATATCGGG,0,1299668
furpa,0.2,4,4,GAGCCCCGCATAATTGCTTC,0,1325290
furpa,0.2,4,4,GAGCACACTTTCCAGTCTCT,0,1323172
furpa,0.2,4,4,GAGATTGGACGTTTCCCCGC,0,1291706
furpa,0.2,4,4,GAGATCTATTTTTGACATTT,0,1336516
furpa,0.2,4,4,GAGAGTAATATAGCTGATGC,0,1313962
furpa,0.2,4,4,GAGACTTGCAACTTACCGCC,0,1278134
furpa,0.2,4,4,GAGACCGTGCAGTCTGCATA,0,1311444
furpa,0.2,4,4,GAGACCAGCGAGGAATCTAT,0,1278190
furpa,0.2,4,4,GAGAATAAATAACTGTAAGC,0,1307043
furpa,0.2,4,4,GACTTGAGAGTATTGGCATA,0,1349332
furpa,0.2,4,4,GACTTGAAATCGGACCGATC,0,1343830
furpa,0.2,4,4,GACTGGCCAGCAAACCTCGA,0,1310966
furpa,0.2,4,4,GACTGCTGGGTTATATATAT,0,1315042
furpa,0.2,4,4,GACTCTCGGCGGCCGAACTT,0,1309129
furpa,0.2,4,4,GACTCCATTCTCCCGCGCTC,0,1317809
furpa,0.2,4,4,GACTATCCAGGGTTCAGGAT,0,1322730
furpa,0.2,4,4,GACTACGTTCGAAAAATATG,0,1331731
furpa,0.2,4,4,GACTACGGACGTGATAGTAT,0,1354738
furpa,0.2,4,4,GACGGTAGTGCACCAATTAC,0,1274043
furpa,0.2,4,4,GACGGGAATTCGGCTACTCA,0,1333292
furpa,0.2,4,4,GACGGCTCCACGAAAGCGAG,0,1287155
furpa,0.2,4,4,GACGAAAAACATCTGGAGTT,0,1275758
furpa,0.2,4,4,GACCTCATCAAGGAAAGCTC,0,1340291
furpa,0.2,4,4,GACCGAGTATGCTAGTGTAA,0,1350505
furpa,0.2,4,4,GACCCTCTAACCCGAATAGG,0,1338463
furpa,0.2,4,4,GACCCGTAAGCCCAGCCAGA,0,1335652
furpa,0.2,4,4,GACCAAGATCACCAAGTAAG,0,1329151
furpa,0.2,4,4,GACAGCGCGATTTGAGGTAA,0,1301359
furpa,0.2,4,4,GACACGTCTCCTCGGTGTGG,0,1330575
furpa,0.2,4,4,GAATTATCGCTAGATGAACG,0,1300359
furpa,0.2,4,4,GAATGGATATGGTGTGATAA,0,1288868
furpa,0.2,4,4,GAATGAGCCCCGCCGTACAC,0,1303263
furpa,0.2,4,4,GAATCAAGCCGACCCAGTAC,0,1298818
furpa,0.2,4,4,GAATACAGCAGCTGTCTGGA,0,1279817
furpa,0.2,4,4,GAAGTTTTAAATTGCGATGG,0,1323879
furpa,0.2,4,4,GAAGTTGGTGACGTCCTAAT,0,1330327
furpa,0.2,4,4,GAAGTGCATTTTTGGTGTAA,0,1318423
furpa,0.2,4,4,GAAGCTGTCAGGACCGAGAT,0,1326186
furpa,0.2,4,4,GAAGCGAAAGTGTCGAATCG,0,1281408
furpa,0.2,4,4,GAAGCAACAGTGGCAGTGGC,0,1349416
furpa,0.2,4,4,GAAGACTGTTTAACTACGGG,0,1341262
furpa,0.2,4,4,GAACTCTGGTAAAGGGAGGA,0,1313321
furpa,0.2,4,4,GAACCCTCAGGCGAGCGCCG,0,1284153
furpa,0.2,4,4,GAACCCGCGAACGTTAACGG,0,1290674
furpa,0.2,4,4,GAAATGCTCCAGGGGCGGAC,0,1341079
furpa,0.2,4,4,GAAAACTCTGTTTATTGTTG,0,1342701
furpa,0.2,4,4,GAAAACTATGCAAATAAAAA,0,1274437
furpa,0.2,4,4,CTTTTTCGATGCTTATCGTA,0,1307245
furpa,0.2,4,4,CTTTGTTAACCGCATTCGAG,0,1346810
furpa,0.2,4,4,CTTTGAGGGACGGCGCCCTC,0,1335155
furpa,0.2,4,4,CTTTCTTGCGTCCTCAAGCC,0,1276191
furpa,0.2,4,4,CTTTCTGTGCGATAAGGGGG,0,1315396
furpa,0.2,4,4,CTTGTATCCCAGGCTACGCT,0,1319645
furpa,0.2,4,4,CTTGGACGTTCCTTCGGTCG,0,1314561
furpa,0.2,4,4,CTTGACCTGTTCCTTACCTT,0,1324507
furpa,0.2,4,4,CTTGAACATTTATGTTGGCA,0,1278269
furpa,0.2,4,4,CTTCTCGGCCCAGTACGATT,0,1291375
furpa,0.2,4,4,CTTCGAAGGCCGGACTTGGT,0,1320033
furpa,0.2,4,4,CTTCCGGGTACTGTAAATGT,0,1318424
furpa,0.2,4,4,CTTCCATCTACCGTTAGCAG,0,1318264
furpa,0.2,4,4,CTTATATGGCCATGGTAACG,0,1285465
furpa,0.2,4,4,CTTATAGCACAACCGATCAG,0,1324406
furpa,0.2,4,4,CTTACATTTTCATTGATACT,0,1280506
furpa,0.2,4,4,CTTAAGTTTTTCCTATATTT,0,1319359
furpa,0.2,4,4,CTTAAATTGAATACGCCGGC,0,1281223
furpa,0.2,4,4,CTGTTTTTTATGGGGAGCCC,0,1310709
furpa,0.2,4,4,CTGTTTTTACTCGCATTGCC,0,1285318
furpa,0.2,4,4,CTGTTTTATTTTCGATACTA,0,1313243
furpa,0.2,4,4,CTGTTTGTAGGTCCAGGTAA,0,1302072
furpa,0.2,4,4,CTGTTGTGAGTCGGTTGTGA,0,1312082
furpa,0.2,4,4,CTGTGTACCATGGTATGGGT,0,1350180
furpa,0.2,4,4,CTGTGTAATCCATGTTGGTG,0,1291893
furpa,0.2,4,4,CTGTGATGGCAACCGACTTT,0,1328024
furpa,0.2,4,4,CTGTCCGTATATTAGCACTA,0,1330585
furpa,0.2,4,4,CTGTCCAACACAAGACCCGT,0,1315404
furpa,0.2,4,4,CTGTATTCCGGTTGGACCGC,0,1347585
furpa,0.2,4,4,CTGTATTCAAGGATCCATGC,0,1318197
furpa,0.2,4,4,CTGTAATATTGGTGTTGTGG,0,1314664
furpa,0.2,4,4,CTGGTATCGGATCGTAAATA,0,1353082
furpa,0.2,4,4,CTGGTACCCGTCCTAGGTCG,0,1302703
furpa,0.2,4,4,CTGGAGGTTAGAGTTTTAGG,0,1346445
furpa,0.2,4,4,CTGGACACAGCGAGGAACAA,0,1329001
furpa,0.2,4,4,CTGCTGGATTATGGAATAGC,0,1292151
furpa,0.2,4,4,CTGCGTCGAACTGTGCCCAG,0,1278560
furpa,0.2,4,4,CTGCGGGACGACGACGAGAC,0,1274862
furpa,0.2,4,4,CTGCGCGACGCGCACAATGG,0,1302572
furpa,0.2,4,4,CTGCGCAGGATAAACACGGT,0,1302543
furpa,0.2,4,4,CTGCCTTAATCCTTTGCCGT,0,1288395
furpa,0.2,4,4,CTGCAAAACCGGCAGCATTT,0,1311475
furpa,0.2,4,4,CTGAGGACGGCTGGTGCACC,0,1336190
furpa,0.2,4,4,CTGACGTAACTTGAAAGATG,0,1319033
furpa,0.2,4,4,CTGACGCTCCCCTGAACGGG,0,1271527
furpa,0.2,4,4,CTGACAGCCCGATTGTCGGC,0,1319231
furpa,0.2,4,4,CTCTGGATGATATGCAAGAA,0,1336794
furpa,0.2,4,4,CTCTCTTCAGAATCTCCCTA,0,1320041
furpa,0.2,4,4,CTCTCTGACTTCCACCATAT,0,1333812
furpa,0.2,4,4,CTCTCCAACTGGAAAAAACC,0,1345958
furpa,0.2,4,4,CTCGTGTTGCGGTTGTTTCT,0,1271317
furpa,0.2,4,4,CTCGTATAATTGTTAATTAC,0,1333694
furpa,0.2,4,4,CTCGGAGTATTCTATTCGGA,0,1302445
furpa,0.2,4,4,CTCGGAAGATTGAGCACACA,0,1315666
furpa,0.2,4,4,CTCGCATCCGCGTCCCGTAT,0,1294941
furpa,0.2,4,4,CTCGCATAGAGAGCAAACTG,0,1286296
furpa,0.2,4,4,CTCGAACAAGGATGCGAGCA,0,1318952
furpa,0.2,4,4,CTCCTTTCCTTAAAGCTTAT,0,1324530
furpa,0.2,4,4,CTCCGCAGCCGCGTTGGCTA,0,1282306
furpa,0.2,4,4,CTCCCCCGACAGCTTCTATA,0,1297812
furpa,0.2,4,4,CTCCCAGTGTGTCCAATGCG,0,1290642
furpa,0.2,4,4,CTCCACTAGATAACCCACCT,0,1303206
furpa,0.2,4,4,CTCATCGGGGAACATATCAA,0,1302020
furpa,0.2,4,4,CTCAGGTAGATCGTAAGGAC,0,1350630
furpa,0.2,4,4,CTCACTCCCGGAGTGGGTAA,0,1280213
furpa,0.2,4,4,CTCAAAAGGGGTTATCCCTA,0,1336402
furpa,0.2,4,4,CTATTGATCGTAGACCATTA,0,1293851
furpa,0.2,4,4,CTATTGATAGCCCAGGGCAG,0,1300470
furpa,0.2,4,4,CTATCGCCTTCAATCCATGC,0,1337881
furpa,0.2,4,4,CTATCCTGTCGAGGGGTTGA,0,1289519
furpa,0.2,4,4,CTATCAAGGTAAGAGTTAAT,0,1348935
furpa,0.2,4,4,CTAGGTGAATACTGATCTAC,0,1331852
furpa,0.2,4,4,CTAGGGCACCGGGTGAGGCA,0,1297111
furpa,0.2,4,4,CTAGAAATAGCTACTCATGC,0,1288977
furpa,0.2,4,4,CTACTGAGAGTTGATACAAA,0,1349496
furpa,0.2,4,4,CTACTATGGACTCTCTTCTA,0,1344613
furpa,0.2,4,4,CTACGCCAGGGGGGCTTGTT,0,1271503
furpa,0.2,4,4,CTAATGAGGAAAATATCACC,0,1314592
furpa,0.2,4,4,CTAAGGTGGGAGACGGCATC,0,1343910
furpa,0.2,4,4,CTAAGGAGACTGCGAGTCCA,0,1343938
furpa,0.2,4,4,CTAACCCGTTTAGAGGGCAT,0,1277729
furpa,0.2,4,4,CTAACCATTATCGGGGATAG,0,1300991
furpa,0.2,4,4,CTAAACCCCTCACCCTGGCT,0,1345390
furpa,0.2,4,4,CGTTCAAGGTATAATCTGCA,0,1275936
furpa,0.2,4,4,CGTTATAAACTATCTCAACT,0,1324694
furpa,0.2,4,4,CGTGTTTTAGTAGCTGGGAA,0,1275934
furpa,0.2,4,4,CGTGTATCCAATCGTTCTTG,0,1333828
furpa,0.2,4,4,CGTGTAAGAAGACTACACGG,0,1311015
furpa,0.2,4,4,CGTGTAACTAGAAGTGTTGG,0,1355463
furpa,0.2,4,4,CGTGTAACCCAGGCTGTGGT,0,1312144
furpa,0.2,4,4,CGTGACTCAGGCGAGTGGAT,0,1345893
furpa,0.2,4,4,CGTCGAGGGAGGCTCGCAGT,0,1283568
furpa,0.2,4,4,CGTCCCAGGATGCCTTGGTT,0,1318694
furpa,0.2,4,4,CGTCCAGGCTATCCCGCACA,0,1316710
furpa,0.2,4,4,CGTCCAACTGGCCCTAATTG,0,1310937
furpa,0.2,4,4,CGTATCTGACAAACGCCATT,0,1327249
furpa,0.2,4,4,CGTAGGCTTAGGATTCCGGT,0,1306003
furpa,0.2,4,4,CGTAGACAATCAGGAGGACA,0,1311854
furpa,0.2,4,4,CGTACGGCACCAGAAAGTAG,0,1277190
furpa,0.2,4,4,CGTACCCTGCGCAGTTTATG,0,1282858
furpa,0.2,4,4,CGTAACGGACGCGGATTAGG,0,1296540
furpa,0.2,4,4,CGTAAAATTCCGGAAGTTTA,0,1296870
furpa,0.2,4,4,CGGTTCAACCTTCGTCCGGA,0,1350608
furpa,0.2,4,4,CGGTCTGCGGCGTTCAAAAC,0,1341119
furpa,0.2,4,4,CGGTCATATTCGGCACTTAC,0,1346720
furpa,0.2,4,4,CGGTAGTATACCTGACTGCC,0,1341755
furpa,0.2,4,4,CGGGCGGTACTCGGCATGGG,0,1309469
furpa,0.2,4,4,CGGGCACGTCTTACCTATCT,0,1352804
furpa,0.2,4,4,CGGGAGTGTTTCCAACACGG,0,1346472
furpa,0.2,4,4,CGGGAGTAGTCCGAGGCTAA,0,1335110
furpa,0.2,4,4,CGGGAGGTGGCGTAGAAGTA,0,1332986
furpa,0.2,4,4,CGGGACGATACGGCGGACGG,0,1357073
furpa,0.2,4,4,CGGCTAATCATCACGCGGGA,0,1289713
furpa,0.2,4,4,CGGCTAATAGGCCTCGGCTC,0,1335401
furpa,0.2,4,4,CGGCCATACCTGGTCTGACT,0,1333052
furpa,0.2,4,4,CGGCAATCTAGTTGACAATA,0,1334153
furpa,0.2,4,4,CGGATGTAAAGGGTGTCCGG,0,1326818
furpa,0.2,4,4,CGGATATTCAGGCTCGTCAG,0,1305498
furpa,0.2,4,4,CGGATAGGGGCATTCTCGAC,0,1284728
furpa,0.2,4,4,CGGAGGGTTCGGCGATGTAT,0,1355623
furpa,0.2,4,4,CGGACCCAGGGAAGGCCAGC,0,1335674
furpa,0.2,4,4,CGCTTAGGCCACTCCATATG,0,1308397
furpa,0.2,4,4,CGCTCATTAGTTTAAGGGCA,0,1286321
furpa,0.2,4,4,CGCTACCGTCCTCAGTCTAG,0,1296784
furpa,0.2,4,4,CGCGTATGTCGGGCTCCGTA,0,1340326
furpa,0.2,4,4,CGCGGAAGCGGAAAGCTGTT,0,1344411
furpa,0.2,4,4,CGCGCGGAAGTAAGTGCGAA,0,1297236
furpa,0.2,4,4,CGCGAGTCTCCTCGCCTCCT,0,1295869
furpa,0.2,4,4,CGCGAAGGGTCAAGATTTAC,0,1342138
furpa,0.2,4,4,CGCCTTCCCTAACTACTCGA,0,1301291
furpa,0.2,4,4,CGCCTGTTCCACTATGGCAT,0,1354326
furpa,0.2,4,4,CGCCTAGTGGATATCGGAAG,0,1294198
furpa,0.2,4,4,CGCATGTAGGCTCAACACTG,0,1352086
furpa,0.2,4,4,CGCACTTCACAACTTAGACA,0,1282747
furpa,0.2,4,4,CGCACTGTCAGGGTGGGAAG,0,1327190
furpa,0.2,4,4,CGCACGAATAGGTCTGAGCA,0,1298441
furpa,0.2,4,4,CGCAACCAGGGCTTGGGGAC,0,1307317
furpa,0.2,4,4,CGATGGGACATGTTCCTTTC,0,1285044
furpa,0.2,4,4,CGATAGCGGTAGATTCAGTT,0,1319953
furpa,0.2,4,4,CGATACGGATCAGCTTGAGT,0,1285846
furpa,0.2,4,4,CGAGTGTAAAAAGTAAGGTA,0,1309985
furpa,0.2,4,4,CGAGGACATAAGAGCCCTTT,0,1319118
furpa,0.2,4,4,CGAGATAACGGAAAGAAAAT,0,1339275
furpa,0.2,4,4,CGAGAGTTTATCAAGAAACG,0,1285753
furpa,0.2,4,4,CGACTTCCTATGTGGAGATC,0,1326298
furpa,0.2,4,4,CGACTTATTGGACCCAGCGA,0,1283109
furpa,0.2,4,4,CGACTGACCATTCATTGGCT,0,1278932
furpa,0.2,4,4,CGACCCCGATGATTTGAACG,0,1272744
furpa,0.2,4,4,CGAAGCCCGTTTGGGAGCTT,0,1355809
furpa,0.2,4,4,CGAAGAAACCGGCCAGGTAA,0,1356176
furpa,0.2,4,4,CGAACTCCATGCAGTGACCA,0,1325083
furpa,0.2,4,4,CGAACAACCCAAGCTACGAA,0,1281003
furpa,0.2,4,4,CGAAAGAGCCTAGAAAGCGT,0,1322855
furpa,0.2,4,4,CGAAAAGGGGGCGCAGGTTC,0,1322769
furpa,0.2,4,4,CCTTTTCCGGTGGCCTCGAT,0,1342435
furpa,0.2,4,4,CCTTTGGCCGCTTTGTTCGG,0,1309775
furpa,0.2,4,4,CCTTTCACTCGGGGTTGTAC,0,1292940
furpa,0.2,4,4,CCTTGCGAAAGTTATCTTTG,0,1323610
furpa,0.2,4,4,CCTTCCGTCATCAAGAGAAA,0,1336518
furpa,0.2,4,4,CCTTCAAGGATTTGTAACGT,0,1331082
furpa,0.2,4,4,CCTGTGGGCCTAACTCATAG,0,1314216
furpa,0.2,4,4,CCTGTCACATTGGAACATTT,0,1309780
furpa,0.2,4,4,CCTGGCGAGTCTTACGACCC,0,1313612
furpa,0.2,4,4,CCTGAATGTGGGTGGTCGTC,0,1330786
furpa,0.2,4,4,CCTCGTCCGTAGCATTCTTG,0,1304710
furpa,0.2,4,4,CCTCGATTGGTGTGTGCGTT,0,1331737
furpa,0.2,4,4,CCTCACCGGACTGAAGCCCA,0,1344046
furpa,0.2,4,4,CCTCAAACCAGTCTTCTGAC,0,1341634
furpa,0.2,4,4,CCTATAGCCGTCCCAGATCT,0,1293713
furpa,0.2,4,4,CCTATACATATAAGATCGGG,0,1318956
furpa,0.2,4,4,CCTAGTCCCGGCGGCGTAGT,0,1314600
furpa,0.2,4,4,CCTAGAAGCCATTGTGCACT,0,1348272
furpa,0.2,4,4,CCTACCCCACTTACTAAACT,0,1279262
furpa,0.2,4,4,CCGTTATTTGGCTTCTGACG,0,1287513
furpa,0.2,4,4,CCGTTAAGGATTTTGCTCTA,0,1348206
furpa,0.2,4,4,CCGTGTCCTTGATGCGAGCA,0,1319454
furpa,0.2,4,4,CCGTGGATCTCTTGCTATCC,0,1308850
furpa,0.2,4,4,CCGTGACGTTGAGTCCTCTC,0,1320783
furpa,0.2,4,4,CCGTCTTCCTAAGCATATTT,0,1338284
furpa,0.2,4,4,CCGTACTTTACCTTCATAGG,0,1307533
furpa,0.2,4,4,CCGTACTACATACCACGCGA,0,1295862
furpa,0.2,4,4,CCGTAAGTCTTGGAACCTGT,0,1321415
furpa,0.2,4,4,CCGGTCTCTACTTAAGAGGT,0,1318824
furpa,0.2,4,4,CCGGTATCTGTCTGCCGGAT,0,1309660
furpa,0.2,4,4,CCGGCGCCCTTTTACGGTTA,0,1344995
furpa,0.2,4,4,CCGGCATGTTGCTTGGCTGG,0,1337975
furpa,0.2,4,4,CCGGACTGGTTCAATGGGCG,0,1324501
furpa,0.2,4,4,CCGGAACGATGGTTACAAGA,0,1309556
furpa,0.2,4,4,CCGCGCGTAAGGCCCATGAA,0,1274364
furpa,0.2,4,4,CCGCGCCTGTTCTCGTTGCT,0,1314680
furpa,0.2,4,4,CCGCGAGCCAGGGGCGATTC,0,1316199
furpa,0.2,4,4,CCGCGAAAATGTCCAGTCTT,0,1339906
furpa,0.2,4,4,CCGCATCTCACACGGGTGTC,0,1290780
furpa,0.2,4,4,CCGCACGCCTGCCTTAGACT,0,1331391
furpa,0.2,4,4,CCGAGGTGTGTTGTCTCATG,0,1327172
furpa,0.2,4,4,CCGAGGGGTTCGGGGTAGTC,0,1281747
furpa,0.2,4,4,CCGAGATTCGCCCAGCCCTA,0,1290454
furpa,0.2,4,4,CCGAAAGGGCACTGCCCTGT,0,1295992
furpa,0.2,4,4,CCGAAACGGATTCGGAACTA,0,1291936
furpa,0.2,4,4,CCGAAAACTGGTGGACGTTC,0,1320145
furpa,0.2,4,4,CCCTATCTACTAGGGTTCGC,0,1337544
furpa,0.2,4,4,CCCGGCATAAACTGAGGATC,0,1320057
furpa,0.2,4,4,CCCGAGCCCCAAACTAGACT,0,1286031
furpa,0.2,4,4,CCCCTCTGTTACTTGGCCTT,0,1307135
furpa,0.2,4,4,CCCCTCGTGCCAGCTTATTT,0,1354706
furpa,0.2,4,4,CCCCCGGAATCTTCTACTAC,0,1314739
furpa,0.2,4,4,CCCCCGCGGTGCTGCCTGCG,0,1290162
furpa,0.2,4,4,CCCATAGTCCAAGGCGAAGG,0,1329536
furpa,0.2,4,4,CCCAGTTCGCATTAACTGCT,0,1297521
furpa,0.2,4,4,CCCAGCTCCATGTCCTAGAG,0,1291953
furpa,0.2,4,4,CCCAGCGGTGGCCGTAAAGG,0,1344323
furpa,0.2,4,4,CCCACGGGTGCGTGTAAAAC,0,1301881
furpa,0.2,4,4,CCCACGGGCGCCTTAGAGTC,0,1339980
furpa,0.2,4,4,CCCACATCCGGGTAAGCGGG,0,1321173
furpa,0.2,4,4,CCCAATCGATACGTGAGCAT,0,1284947
furpa,0.2,4,4,CCCAAGACCTAGCCGAGGGT,0,1354405
furpa,0.2,4,4,CCCAACTGACGTATGCTGTA,0,1285158
furpa,0.2,4,4,CCCAAAGGAGTCGAAAATAA,0,1291738
furpa,0.2,4,4,CCATGTCTCAGCGTGAGACA,0,1316218
furpa,0.2,4,4,CCATGGGGCGAAGGACATGT,0,1277143
furpa,0.2,4,4,CCATGAAGGGCCGAGTAGAG,0,1350490
furpa,0.2,4,4,CCATGAACGTTTTCGGGTAC,0,1344672
furpa,0.2,4,4,CCATCAATCTCTTTGTGGAT,0,1322445
furpa,0.2,4,4,CCAGTGTCCCTAGACGCTTA,0,1323028
furpa,0.2,4,4,CCAGTGGCCCGTGTATAGGG,0,1338781
furpa,0.2,4,4,CCAGGTCATGCATATAGAGG,0,1335582
furpa,0.2,4,4,CCAGGCCGCTTGTGTAGCTT,0,1305100
furpa,0.2,4,4,CCAGACAATTAGGGGGCAAT,0,1293858
furpa,0.2,4,4,CCACGTGTAGGCCGCCAGTC,0,1346111
furpa,0.2,4,4,CCACGATCATAGCTTGTCCT,0,1328184
furpa,0.2,4,4,CCACCTTAGAAGTAGGTTGA,0,1293047
furpa,0.2,4,4,CCACCTGGTCCCTTGTGGCC,0,1276257
furpa,0.2,4,4,CCACATTTGTCGCCTAAGTA,0,1278675
furpa,0.2,4,4,CCACACGATGGTTCACCAAA,0,1353970
furpa,0.2,4,4,CCAATTGCTTGTGACACTCC,0,1343416
furpa,0.2,4,4,CCAATGTTATCTTTTGGTCA,0,1341087
furpa,0.2,4,4,CCAATGGTATACACCTCGGG,0,1294977
furpa,0.2,4,4,CCAAGCACATACAGTGAGGA,0,1347260
furpa,0.2,4,4,CCAACTGGGTAGGGTAGATC,0,1283292
furpa,0.2,4,4,CCAAAGGAATCTAGATCTGT,0,1292822
furpa,0.2,4,4,CATTTGCTTCATTGGACTTA,0,1321479
furpa,0.2,4,4,CATTGGTCACCATGAACAGA,0,1297404
furpa,0.2,4,4,CATTAGTGACTCGCTTCAAC,0,1328092
furpa,0.2,4,4,CATGTCTCTACAGGCTGCAT,0,1301782
furpa,0.2,4,4,CATGCAAAACTTCACAGTGC,0,1313242
furpa,0.2,4,4,CATGAAGATTAAGATACTAA,0,1355694
furpa,0.2,4,4,CATCTAGGAGACTGCCCGGT,0,1345766
furpa,0.2,4,4,CATCCGCATTACTATTACAT,0,1316904
furpa,0.2,4,4,CATCCCAGACACCAGCAGCC,0,1329522
furpa,0.2,4,4,CATCACTATGAGACCTAGCA,0,1273983
furpa,0.2,4,4,CATATCGAGGGCTTAGCAGT,0,1273699
furpa,0.2,4,4,CATAGCTCGTCATGGTGGGT,0,1281862
furpa,0.2,4,4,CATAGATTCCCCCTTACGTG,0,1320702
furpa,0.2,4,4,CATACGGGCAGCAAGTGTTC,0,1317810
furpa,0.2,4,4,CATAAGCCGTGAAGAGATTA,0,1332907
furpa,0.2,4,4,CAGTTTTAGGTGCACGAAGA,0,1289966
furpa,0.2,4,4,CAGTTTGCACCAAGCTAATG,0,1337290
furpa,0.2,4,4,CAGTTAGTGCTTAAGAGAAC,0,1301648
furpa,0.2,4,4,CAGTGGCCGTCGCGAAAGTA,0,1302945
furpa,0.2,4,4,CAGTCTTCAGCTGGAACCGT,0,1320661
furpa,0.2,4,4,CAGTCATACAGTTCGGAGGT,0,1310407
furpa,0.2,4,4,CAGTAGTAGCGGTATATGGT,0,1274326
furpa,0.2,4,4,CAGTACGCGACGCTTTAAGT,0,1301885
furpa,0.2,4,4,CAGTACATTACGGATTCCAC,0,1329360
furpa,0.2,4,4,CAGTAATAGCCTACAAGTTA,0,1355290
furpa,0.2,4,4,CAGGGCTTCGAGCCGTCTGT,0,1282661
furpa,0.2,4,4,CAGGGCTTCCTGATACGCTA,0,1335901
furpa,0.2,4,4,CAGGATTTTAGTGCGATCGG,0,1301731
furpa,0.2,4,4,CAGCTGCTGCTAGCTCTAAT,0,1288969
furpa,0.2,4,4,CAGCTGCGAAATAGCCCTTT,0,1271878
furpa,0.2,4,4,CAGCGGCAGTACTGGTGTAG,0,1326918
furpa,0.2,4,4,CAGCAAGTGTTATACGGATG,0,1356077
furpa,0.2,4,4,CAGATTCTGAATGCGTGTAA,0,1307431
furpa,0.2,4,4,CAGATTCCTTTCAGTACGGG,0,1284934
furpa,0.2,4,4,CAGATGCGGCACTTTCCCGC,0,1272190
furpa,0.2,4,4,CAGATCTTGGGGAGGCATGT,0,1307173
furpa,0.2,4,4,CAGAGATGTTCCCAGCCGGC,0,1305957
furpa,0.2,4,4,CAGAATTAAGACGTTTGGTC,0,1341483
furpa,0.2,4,4,CACTTTCTTCATAGCAGGCA,0,1294122
furpa,0.2,4,4,CACTTTCAAGCTTGTCAAAT,0,1324569
furpa,0.2,4,4,CACTCTTTGGGTACCGGCCA,0,1311521
furpa,0.2,4,4,CACTCATGGAGTCCTGGTAT,0,1321269
furpa,0.2,4,4,CACTACAGTATCACGTATCA,0,1345828
furpa,0.2,4,4,CACGACAACGGGCGCGGTAT,0,1297113
furpa,0.2,4,4,CACCTTAGTGATAACAAATG,0,1353743
furpa,0.2,4,4,CACCGTGTTCGGGCCTGGAT,0,1351817
furpa,0.2,4,4,CACCCCATCAACTCGTGCGG,0,1286438
furpa,0.2,4,4,CACCATGTGGTTTGCGTCGT,0,1274631
furpa,0.2,4,4,CACCAAGGCGCGCAACCGAC,0,1342964
furpa,0.2,4,4,CACATTAGAGAGAGTCACTA,0,1341028
furpa,0.2,4,4,CACATCCCAGTTTTTACAGA,0,1305752
furpa,0.2,4,4,CACAGGGGTGCAAATTAGAC,0,1300044
furpa,0.2,4,4,CACAGGCGCCGATCAATCAC,0,1293980
furpa,0.2,4,4,CACAGCAAAAGGCGTCTCGA,0,1323465
furpa,0.2,4,4,CAATTAACGCGCCCTTGTCT,0,1274155
furpa,0.2,4,4,CAATGTAGTGGGTACTTACT,0,1329152
furpa,0.2,4,4,CAATGGTAGGCATGGCAGGA,0,1340774
furpa,0.2,4,4,CAATGGGGGACTCCCGTGCC,0,1290563
furpa,0.2,4,4,CAATGCCCTACCTTAACTCC,0,1275763
furpa,0.2,4,4,CAATCTCCCCAATCCTGGGT,0,1292934
furpa,0.2,4,4,CAATCAAAAGCGCAGGTCCC,0,1323434
furpa,0.2,4,4,CAATAGCCGACGAACTCAGC,0,1302217
furpa,0.2,4,4,CAATAAATGACGAGCACTGC,0,1271415
furpa,0.2,4,4,CAAGTAGGACTTCAATTGTA,0,1333596
furpa,0.2,4,4,CAAGGATCGGCGATGACTAT,0,1339458
furpa,0.2,4,4,CAAGCTGCCATCAGGGCGAA,0,1313675
furpa,0.2,4,4,CAAGCCTACGCAGGGGTCTT,0,1314834
furpa,0.2,4,4,CAAGATGTATGCGCAGCCTT,0,1327390
furpa,0.2,4,4,CAAGAAACCGTGTCGTGTCA,0,1284390
furpa,0.2,4,4,CAACTTAAGGCGTATCCGTT,0,1332854
furpa,0.2,4,4,CAACGCGGCGGGTGACAAGT,0,1309754
furpa,0.2,4,4,CAACCCGTCTCGTTGATGCT,0,1349558
furpa,0.2,4,4,CAACCCATAGTTGTTCGCCA,0,1350133
furpa,0.2,4,4,CAAATCTGAATCACATTCCC,0,1350651
furpa,0.2,4,4,CAAAGCGAGTGCAAAGTAGA,0,1350333
furpa,0.2,4,4,CAAAGACTTGACAATAAAGT,0,1294376
furpa,0.2,4,4,CAAACTTTCTTTCCGGTGTG,0,1332814
furpa,0.2,4,4,CAAAAGGACACAGGGTGTAT,0,1346979
furpa,0.2,4,4,ATTTTGACGCGATGTCGGGG,0,1352355
furpa,0.2,4,4,ATTTGGGGCACCCATCAGCA,0,1324681
furpa,0.2,4,4,ATTTGGGCCAAGTCTCCTTA,0,1274584
furpa,0.2,4,4,ATTTGACTCTAATAGCGGGA,0,1303389
furpa,0.2,4,4,ATTTCTTAAACGACAGTGGT,0,1306801
furpa,0.2,4,4,ATTTACGAACCGTGAGGTTA,0,1301930
furpa,0.2,4,4,ATTTACCACCATGGCAGAAA,0,1294925
furpa,0.2,4,4,ATTGTGTGTATCCGTTTCCA,0,1322364
furpa,0.2,4,4,ATTGTAAAGTCATGCCAGGC,0,1285441
furpa,0.2,4,4,ATTGGATTAAGTGCCAAATC,0,1351312
furpa,0.2,4,4,ATTGCGTCAGGTTGTTCGCC,0,1343209
furpa,0.2,4,4,ATTGCCTCTACGGACGTCAA,0,1277783
furpa,0.2,4,4,ATTGCAAATCGGTTTAATTT,0,1335430
furpa,0.2,4,4,ATTGAAGTGGCCGAGACTCT,0,1353478
furpa,0.2,4,4,ATTCTATTCTCGCTGATATC,0,1310102
furpa,0.2,4,4,ATTCCCATTATGCTGTTCTT,0,1313549
furpa,0.2,4,4,ATTAGCCCCGTTAAGGACGT,0,1275880
furpa,0.2,4,4,ATTAACGGTCGGAGATGGGG,0,1334409
furpa,0.2,4,4,ATGTTTTGGGCCTTTTTCGG,0,1322366
furpa,0.2,4,4,ATGTTAAATCTGAATATAGA,0,1341817
furpa,0.2,4,4,ATGTGTCCTTACTCGATGAA,0,1340377
furpa,0.2,4,4,ATGTCTGGGATCCTATACTA,0,1318255
furpa,0.2,4,4,ATGTCCTAGAACAAACCCCG,0,1303483
furpa,0.2,4,4,ATGTCCAGGTTGCGTTCAGC,0,1339109
furpa,0.2,4,4,ATGTAAGAGGGTACACATTT,0,1313801
furpa,0.2,4,4,ATGGTGCTCGCTATGAAAGA,0,1321761
furpa,0.2,4,4,ATGGTCCATCTAACTACCTA,0,1352792
furpa,0.2,4,4,ATGGTCCATAGACGCTCTCT,0,1348926
furpa,0.2,4,4,ATGGGTATTCTTCACACCTC,0,1319398
furpa,0.2,4,4,ATGGGACGGGGGAAGCAGGC,0,1296074
furpa,0.2,4,4,ATGGCAGACAGATACGTGCG,0,1275510
furpa,0.2,4,4,ATGGCACTTGTCATCATGGG,0,1355621
furpa,0.2,4,4,ATGGAAGACGGTAGCGTTGT,0,1309283
furpa,0.2,4,4,ATGCTTTCGTAGCCTATGAT,0,1281316
furpa,0.2,4,4,ATGCTCCGGAATTGAGATGT,0,1341146
furpa,0.2,4,4,ATGCTACGTAAATCATTCGG,0,1314986
furpa,0.2,4,4,ATGCACGGCGGTGCATGAGG,0,1308590
furpa,0.2,4,4,ATGATGCGCCGGACGGAGTC,0,1271673
furpa,0.2,4,4,ATGAGATTCGGTACCTATAC,0,1353629
furpa,0.2,4,4,ATGAAGTGCTGGACGATGGG,0,1298383
furpa,0.2,4,4,ATGAACCGGGGACGGCCAGA,0,1315420
furpa,0.2,4,4,ATCTTGCGCATTCATAGGCA,0,1279244
furpa,0.2,4,4,ATCTTCATGAGTAGTGACAG,0,1283223
furpa,0.2,4,4,ATCTTAGTGGAGTCAGACTC,0,1281701
furpa,0.2,4,4,ATCTGTCCCCTATGCAGAAT,0,1316484
furpa,0.2,4,4,ATCTGTAGCGTTAATGCTAT,0,1303509
furpa,0.2,4,4,ATCTATGATAATCGTCATTC,0,1348771
furpa,0.2,4,4,ATCGTTTCTCGATGGTGTTT,0,1284346
furpa,0.2,4,4,ATCGTTCCAGGAGCGTAGAC,0,1327344
furpa,0.2,4,4,ATCGTTCAAGTGGGGCGCTC,0,1274197
furpa,0.2,4,4,ATCGTCTTCGGCGGGACTAG,0,1306624
furpa,0.2,4,4,ATCGGGTGACAGGTCCATCG,0,1313915
furpa,0.2,4,4,ATCGGGGTCCGCACTCAGGG,0,1274883
furpa,0.2,4,4,ATCGCATAGGGCAGGGTCCG,0,1274685
furpa,0.2,4,4,ATCGAAAATAGATTCAACAG,0,1283891
furpa,0.2,4,4,ATCCTTACAACAATCTTTGG,0,1289114
furpa,0.2,4,4,ATCCTACTATTAGAACATCA,0,1350443
furpa,0.2,4,4,ATCCGTGTACTTGTTCTGCA,0,1315160
furpa,0.2,4,4,ATCCGCCGTCTACGTCATCA,0,1337657
furpa,0.2,4,4,ATCCGCATTGACGGGGAATA,0,1274499
furpa,0.2,4,4,ATCCCTCGCGTACACGGTTG,0,1321671
furpa,0.2,4,4,ATCCATTTGGAGCAACTAGC,0,1282320
furpa,0.2,4,4,ATCCAGTGGCGAAGAGCGTC,0,1347638
furpa,0.2,4,4,ATCCAGCATGGGCATTTCGT,0,1280958
furpa,0.2,4,4,ATCCACGTGGATGATACAAG,0,1323281
furpa,0.2,4,4,ATCATAAGTCGGGAATCCGG,0,1328804
furpa,0.2,4,4,ATCAGCACGGCCACCTTCCC,0,1288840
furpa,0.2,4,4,ATCAAGTGGTTTGCGGACTC,0,1322985
furpa,0.2,4,4,ATCAACCGAGGCAGGGGACT,0,1331983
furpa,0.2,4,4,ATATACCGCTAGAGTAGCCT,0,1319952
furpa,0.2,4,4,ATAGATTCTCTCTCGGGAAG,0,1343686
furpa,0.2,4,4,ATACTTTAGTCACCCCGTAA,0,1355278
furpa,0.2,4,4,ATACCGTCCGTTCTTGAAGG,0,1282332
furpa,0.2,4,4,ATACCACCCGCCATCGCTTG,0,1291141
furpa,0.2,4,4,ATACAGTGCAGTAGCGCCAG,0,1332769
furpa,0.2,4,4,ATAATGTATCGTCATACTCA,0,1356928
furpa,0.2,4,4,ATAATGGGTCCGTGCCTCCA,0,1309423
furpa,0.2,4,4,ATAATGAGTGGGGTGCCGAA,0,1296124
furpa,0.2,4,4,ATAAGTGTTACACGCAGCCC,0,1275797
furpa,0.2,4,4,ATAAGGAGGATAAGCGCGTA,0,1300479
furpa,0.2,4,4,ATAACTAAACGCTTATTCTA,0,1341982
furpa,0.2,4,4,ATAACGGAGTGTGAATGAAC,0,1306983
furpa,0.2,4,4,ATAAACGCTAAATCGAACTC,0,1335939
furpa,0.2,4,4,AGTTTTTCACCCGTTGGCGA,0,1352682
furpa,0.2,4,4,AGTTGACGTCGTGTCATCGC,0,1319696
furpa,0.2,4,4,AGTTCTATAAGGTGTGCATA,0,1342942
furpa,0.2,4,4,AGTTCCTCCGACGCTCTTCA,0,1284322
furpa,0.2,4,4,AGTTACATCTGCCTAACTAA,0,1309414
furpa,0.2,4,4,AGTTAAGTCAAGCACTCTTG,0,1336340
furpa,0.2,4,4,AGTGTGTGCGAGGTGCAGAA,0,1286481
furpa,0.2,4,4,AGTGATCGTCCGAGGAGATA,0,1273516
furpa,0.2,4,4,AGTGAGGAACCATCCTAGAC,0,1280027
furpa,0.2,4,4,AGTCTGTATGTGTGTTCGCG,0,1336215
furpa,0.2,4,4,AGTCTACAATCTTTCGCCAT,0,1332179
furpa,0.2,4,4,AGTCGTGGAAGGAATCGAAT,0,1304820
furpa,0.2,4,4,AGTCCTGGTCAGGCCCGTGT,0,1301621
furpa,0.2,4,4,AGTCCTACAGCAAGCTACGC,0,1279387
furpa,0.2,4,4,AGTCATTCAATAATCGATTC,0,1306943
furpa,0.2,4,4,AGTATGGAGTGGAACGGACA,0,1331728
furpa,0.2,4,4,AGTAGTAGGTAGGACGTAAG,0,1342781
furpa,0.2,4,4,AGTAGGCGGAAAGAGGCATC,0,1293287
furpa,0.2,4,4,AGTACATATGCTGGAGTTTG,0,1316330
furpa,0.2,4,4,AGGTTCGCCTCCCGGATCGT,0,1301794
furpa,0.2,4,4,AGGTTACAGGCTGCCTCAAC,0,1326408
furpa,0.2,4,4,AGGTGTTTTCAGCGGTGATT,0,1357353
furpa,0.2,4,4,AGGTCACTGAGCTGGGCCAA,0,1351996
furpa,0.2,4,4,AGGTATGTAGGGCGGCATAC,0,1299532
furpa,0.2,4,4,AGGTAATCGGATCGGACCTG,0,1296800
furpa,0.2,4,4,AGGGTCACTTGCTATCAAAA,0,1303437
furpa,0.2,4,4,AGGGTAGATAATTTATGCGG,0,1272651
furpa,0.2,4,4,AGGGGTTCAGCTCGGCTGAA,0,1283703
furpa,0.2,4,4,AGGGGTCTGCCTTGAATGGG,0,1275353
furpa,0.2,4,4,AGGGGATCCGCTAATCAATG,0,1343384
furpa,0.2,4,4,AGGGGACCTGACTCATACTT,0,1335360
furpa,0.2,4,4,AGGGGAAGGATCTGTCCATG,0,1303033
furpa,0.2,4,4,AGGGCATACGCATACAATAG,0,1349429
furpa,0.2,4,4,AGGCGTGGCTACGCTCCCAC,0,1284013
furpa,0.2,4,4,AGGCGCGTGTACGACTAGAT,0,1318474
furpa,0.2,4,4,AGGCCTATTCTGGAGGTGCT,0,1275791
furpa,0.2,4,4,AGGCCCGAATCATAAAGATC,0,1355584
furpa,0.2,4,4,AGGCCACCCGGTACATTACG,0,1353620
furpa,0.2,4,4,AGGCATCCTCAGGGGCAGCT,0,1338749
furpa,0.2,4,4,AGGCAGGCTAGAGTCCGGCC,0,1297931
furpa,0.2,4,4,AGGCAGCGCATCACCCGAAT,0,1297001
furpa,0.2,4,4,AGGATCTGAGCGCGCAGGTT,0,1284852
furpa,0.2,4,4,AGGACTGCTCGTCCCATCGT,0,1313211
furpa,0.2,4,4,AGGACTCAGGGTTAAGACGA,0,1285701
furpa,0.2,4,4,AGCTTTGGGAAGAAGTTCGT,0,1309205
furpa,0.2,4,4,AGCTGGGGGGGCATCAATGA,0,1272270
furpa,0.2,4,4,AGCTGCTCAGGTCCACGTCC,0,1288852
furpa,0.2,4,4,AGCTCCTCCGCGGTCGAACA,0,1309524
furpa,0.2,4,4,AGCTCCCGTTTCTGGGCTTA,0,1345844
furpa,0.2,4,4,AGCGTTCGAAGGCCACGATG,0,1353933
furpa,0.2,4,4,AGCGGATTATTTGAGGTTAG,0,1347164
furpa,0.2,4,4,AGCGCCAGATAGGTCGATAT,0,1273783
furpa,0.2,4,4,AGCGCATACCGCCATATTTT,0,1294663
furpa,0.2,4,4,AGCGCACCGTTCTTCCACAA,0,1315499
furpa,0.2,4,4,AGCGAGCGAGACATGATACC,0,1277343
furpa,0.2,4,4,AGCGAATGCGCACCACGTAG,0,1279101
furpa,0.2,4,4,AGCGAAGTCACCGGAGCTCG,0,1347725
furpa,0.2,4,4,AGCCTCTAGACATTTACAGT,0,1321602
furpa,0.2,4,4,AGCCGCAGTTCCTATGGTTT,0,1351202
furpa,0.2,4,4,AGCCCTTCCAGGGCTCAAAA,0,1310634
furpa,0.2,4,4,AGCCCCCTGATAATGAGTAA,0,1330577
furpa,0.2,4,4,AGCCATGAAAGCGGATCGTC,0,1300971
furpa,0.2,4,4,AGCCAGAAACGGGGCTATGT,0,1337009
furpa,0.2,4,4,AGCATTATAACGATTTATGT,0,1280926
furpa,0.2,4,4,AGCATTAGATGGTAAATGTC,0,1346548
furpa,0.2,4,4,AGCAGTCTCATAGCCGGATT,0,1328041
furpa,0.2,4,4,AGCAGGCAAAAGCCTTGATG,0,1329016
furpa,0.2,4,4,AGCAGGACGGTCTTGCCTTC,0,1307473
furpa,0.2,4,4,AGCACTTATTAAGAGTATGT,0,1309349
furpa,0.2,4,4,AGCACAAAACGACTTTCGAA,0,1299333
furpa,0.2,4,4,AGCAAGCATCTGACACGGGG,0,1316640
furpa,0.2,4,4,AGATTTGCCCATCCGCGCGG,0,1327288
furpa,0.2,4,4,AGATTACGCTATACCCGCAT,0,1288135
furpa,0.2,4,4,AGATGTTTGGTCGTCCGCTA,0,1310541
furpa,0.2,4,4,AGATGGTCACTGAACCAGTG,0,1311823
furpa,0.2,4,4,AGATGGGCAAACGCATGCCG,0,1297632
furpa,0.2,4,4,AGATGCAGATGACTCGTTTT,0,1348402
furpa,0.2,4,4,AGATCCGTGGTCAATGGGAT,0,1357136
furpa,0.2,4,4,AGATATAAGAGGCATTTCCT,0,1284033
furpa,0.2,4,4,AGATACAGCTAGTAAGCACT,0,1317925
furpa,0.2,4,4,AGATAACTGTAGGTGCCGGT,0,1305085
furpa,0.2,4,4,AGAGTCCGTTATATACAGCG,0,1327896
furpa,0.2,4,4,AGAGGTCACGAAACCGTATA,0,1293404
furpa,0.2,4,4,AGAGGTACTGTAAGGTATCT,0,1352535
furpa,0.2,4,4,AGAGCTATTTTTATCCGCTA,0,1349477
furpa,0.2,4,4,AGACTTTCGGTACTTGACGA,0,1293218
furpa,0.2,4,4,AGACGCAAGCACTAACTCAT,0,1297262
furpa,0.2,4,4,AGACCATAGAAGGTGGAATA,0,1288119
furpa,0.2,4,4,AGACAGGACAATTGAGGCTT,0,1301855
furpa,0.2,4,4,AGACAGCGTGCCGTACGATA,0,1333673
furpa,0.2,4,4,AGACACCCCTGGCTGGGTCA,0,1309153
furpa,0.2,4,4,AGAAGGGTAGTAAGAACCAA,0,1315381
furpa,0.2,4,4,AGAAGCGGTAATGTATGTGC,0,1289080
furpa,0.2,4,4,AGAACCGAGCTTTGTCATAA,0,1317501
furpa,0.2,4,4,AGAACACTATATGGAAGGAC,0,1295463
furpa,0.2,4,4,AGAAAATCGTGCGCATTCTA,0,1298098
furpa,0.2,4,4,ACTTTTCCCTTAAAGGCACT,0,1295022
furpa,0.2,4,4,ACTTTTAGGTAGCGAGAAAG,0,1312338
furpa,0.2,4,4,ACTTGGACAATCGCCCGCGA,0,1354539
furpa,0.2,4,4,ACTTCTTCTGGGGGGACGTC,0,1330166
furpa,0.2,4,4,ACTTCCCCAGAACTTACATT,0,1291890
furpa,0.2,4,4,ACTTAGATGCCTAGGCGTTC,0,1314115
furpa,0.2,4,4,ACTTAGACGGGCGCCACACA,0,1292452
furpa,0.2,4,4,ACTTACCGTTATACCGCGGT,0,1339536
furpa,0.2,4,4,ACTGCTCCGGCAGGGTAAAT,0,1302842
furpa,0.2,4,4,ACTGCGTAGCATCGATAGCT,0,1295397
furpa,0.2,4,4,ACTGCGGGTTCTTAGCCATC,0,1300133
furpa,0.2,4,4,ACTGCCATTGCTTACACATC,0,1303173
furpa,0.2,4,4,ACTCTATGGGCGGACTCCAG,0,1350560
furpa,0.2,4,4,ACTCACGGGAGTTTATGCAT,0,1345961
furpa,0.2,4,4,ACTATGACTCGGGGAGCCGC,0,1346000
furpa,0.2,4,4,ACTATCTGGTTGGTGTAGGC,0,1323056
furpa,0.2,4,4,ACTAGCTTGCGCCGGTTGCG,0,1315110
furpa,0.2,4,4,ACTAGATATGTACACAGCCG,0,1297376
furpa,0.2,4,4,ACTACATACACAGCAATAGG,0,1327965
furpa,0.2,4,4,ACTAATAGTCAGGTTTTGGG,0,1318038
furpa,0.2,4,4,ACGTTTCACTTGTCCTCCTG,0,1352447
furpa,0.2,4,4,ACGTTCGCCTTTTGCGTGCG,0,1271197
furpa,0.2,4,4,ACGTTCACATTAACCCCGAC,0,1282371
furpa,0.2,4,4,ACGTGATGTCATGTGCATCA,0,1330272
furpa,0.2,4,4,ACGTGAAGCGCATCTCCGTT,0,1297515
furpa,0.2,4,4,ACGTCGCGAGGTAAGTAATT,0,1321750
furpa,0.2,4,4,ACGTACTCTTTACGGACATT,0,1327913
furpa,0.2,4,4,ACGTACCGCCCAACCGTGCA,0,1272078
furpa,0.2,4,4,ACGGTTCCAAGCCCCTGAAC,0,1314816
furpa,0.2,4,4,ACGGGTGGGGAAATGTAGTC,0,1316486
furpa,0.2,4,4,ACGGGAAGATGTTTAAAGTC,0,1275730
furpa,0.2,4,4,ACGGACGGTAATGTTCCGTC,0,1291746
furpa,0.2,4,4,ACGGAAAATTCCATATCGGA,0,1322469
furpa,0.2,4,4,ACGCTGGAAACCCGGAGTGG,0,1348311
furpa,0.2,4,4,ACGCGTGATCACGGATAGCT,0,1279541
furpa,0.2,4,4,ACGCGAGCACGTTCGTAGGG,0,1327081
furpa,0.2,4,4,ACGCCTCGTTGACGCGGGGG,0,1304987
furpa,0.2,4,4,ACGCCCGGTCCCTCAAATAA,0,1326616
furpa,0.2,4,4,ACGCCCATGAAAAAGGACAT,0,1356484
furpa,0.2,4,4,ACGCAGGCCTGTCATCTACA,0,1275117
furpa,0.2,4,4,ACGCACTAAGGCTGCACGCT,0,1323094
furpa,0.2,4,4,ACGCACGTAGGAGGAAGTCT,0,1347631
furpa,0.2,4,4,ACGATCGTCATTGGAGACCC,0,1292207
furpa,0.2,4,4,ACGACTCCAAGGCTCCAAAA,0,1326017
furpa,0.2,4,4,ACGACTATTTTATAATGGTT,0,1277531
furpa,0.2,4,4,ACGAAAAGGTCCCTCCTGAG,0,1332173
furpa,0.2,4,4,ACCTTTGACGCGTCGCTGAT,0,1277821
furpa,0.2,4,4,ACCTTTCGACATGGAAACGT,0,1314477
furpa,0.2,4,4,ACCTTCCATACATAGTATAG,0,1307174
furpa,0.2,4,4,ACCTTATCTTTTTCTGCCTT,0,1327740
furpa,0.2,4,4,ACCTGGAAATCGCGCAGTTG,0,1287706
furpa,0.2,4,4,ACCTCACCCGCGACCCGGGG,0,1286319
furpa,0.2,4,4,ACCTAGTGTCCATCGGCGTG,0,1304979
furpa,0.2,4,4,ACCTAGAAGATGACCACGTG,0,1310027
furpa,0.2,4,4,ACCGTTCGTTACAGCTGTGC,0,1336235
furpa,0.2,4,4,ACCGTCGATGGGTGTGGGAA,0,1277822
furpa,0.2,4,4,ACCGTAGCTACACAAAACCG,0,1334456
furpa,0.2,4,4,ACCGGGGTGGTGCACACCTC,0,1324374
furpa,0.2,4,4,ACCGCCGCCATACTTGTGTC,0,1344540
furpa,0.2,4,4,ACCGACGCACGTACCCTGCA,0,1337507
furpa,0.2,4,4,ACCGACATTCCATCGAGGCC,0,1347995
furpa,0.2,4,4,ACCGACAGAGAATAGGAGGG,0,1326187
furpa,0.2,4,4,ACCCGGTTTTTGCTTCGGAT,0,1350892
furpa,0.2,4,4,ACCCGCACCCTCTGAGTCAC,0,1287351
furpa,0.2,4,4,ACCCCTTGTGTAACAGAATC,0,1282597
furpa,0.2,4,4,ACCCCGTTCTGCATCAGGGG,0,1318227
furpa,0.2,4,4,ACCCCCTATACCTGAATAAT,0,1298682
furpa,0.2,4,4,ACCCCCATCTCTCACCAACA,0,1274376
furpa,0.2,4,4,ACCATCACGCGTTAATAATT,0,1324170
furpa,0.2,4,4,ACCAGTACAAATTTACGACC,0,1300864
furpa,0.2,4,4,ACCACACGGCATCAATCTGT,0,1338750
furpa,0.2,4,4,ACATTTACATTGGAGTACTG,0,1353015
furpa,0.2,4,4,ACATTATACACTAGGATCAG,0,1283300
furpa,0.2,4,4,ACATTAAGATGGCTATTGCA,0,1303791
furpa,0.2,4,4,ACATGTGCGCGTACAGTCGT,0,1290123
furpa,0.2,4,4,ACATATCGGTTCGTCTGCAT,0,1334176
furpa,0.2,4,4,ACATACTGCTCGCACCTGTA,0,1313437
furpa,0.2,4,4,ACAGTACGTTGCCCTGCGGG,0,1295396
furpa,0.2,4,4,ACAGTACAATCAACCCACTC,0,1292619
furpa,0.2,4,4,ACAGCGCCATCCTTACGTAT,0,1290318
furpa,0.2,4,4,ACAGCCGGGTTGGCATTAAT,0,1348677
furpa,0.2,4,4,ACAGACGCGTAGGGTACCGA,0,1355999
furpa,0.2,4,4,ACACTGACAAAAGCTATACG,0,1353705
furpa,0.2,4,4,ACACTATCGCGTCTCCGACC,0,1272635
furpa,0.2,4,4,ACACGATCGGCTCTGGCTGA,0,1318089
furpa,0.2,4,4,ACACGACGGGGGGTCATGGG,0,1280848
furpa,0.2,4,4,ACACCTTGCAAGAGTTAAAT,0,1352564
furpa,0.2,4,4,ACACACTCCCTGGCCGGGTA,0,1338067
furpa,0.2,4,4,ACAATATAAATGTTAACGGT,0,1284644
furpa,0.2,4,4,ACAAGGTTTTATCTGACAGT,0,1320773
furpa,0.2,4,4,ACAAGCCCTCAATGAACAGA,0,1329424
furpa,0.2,4,4,ACAAGCAACCCTGTGGTAGT,0,1345869
furpa,0.2,4,4,ACAAGAAGTAGATGATAAAA,0,1341890
furpa,0.2,4,4,ACAAAGTAGGAGGCGTCAAT,0,1347721
furpa,0.2,4,4,ACAAACACACGATTTCTTAA,0,1292930
furpa,0.2,4,4,AATTTCATGTGACAATGTAA,0,1278729
furpa,0.2,4,4,AATTGTATGGCACTGCCGCG,0,1271385
furpa,0.2,4,4,AATTGCTTATAGCACACGCG,0,1326904
furpa,0.2,4,4,AATTGCTAACACATTGGATC,0,1331086
furpa,0.2,4,4,AATGTGCCTAACCGGCGGAA,0,1285644
furpa,0.2,4,4,AATGCGTGCAATGCTAAGTG,0,1299364
furpa,0.2,4,4,AATGCCTAGCTGCACAACAA,0,1331085
furpa,0.2,4,4,AATGCACTGCCAAGGGATGC,0,1314126
furpa,0.2,4,4,AATGCAATTATATCTTTGGT,0,1349663
furpa,0.2,4,4,AATCTGAGACTGCGTGGCAA,0,1327346
furpa,0.2,4,4,AATCTATCTGGAGGCGGTGT,0,1312825
furpa,0.2,4,4,AATCGTTAAAGGCAGTATGA,0,1340382
furpa,0.2,4,4,AATCGATCCGTAGCGAATCG,0,1271926
furpa,0.2,4,4,AATCACGTCTTTACGGGCCA,0,1296298
furpa,0.2,4,4,AATATTGGCCCAGAATTACC,0,1290575
furpa,0.2,4,4,AATAGTTGCAGGGGTTCGCG,0,1328992
furpa,0.2,4,4,AATAGTCCCCTCAAGCAACT,0,1339831
furpa,0.2,4,4,AATAGGCTAGAAAGAAATAC,0,1313296
furpa,0.2,4,4,AATAGAAAGGCCTGTCTTCG,0,1297293
furpa,0.2,4,4,AATAACATCTCAAGGGATGC,0,1299954
furpa,0.2,4,4,AAGTCGCTGAAGTAACCGTG,0,1329607
furpa,0.2,4,4,AAGTATCTCCAGGCTCGGCA,0,1343653
furpa,0.2,4,4,AAGTATAAAGATAGATGAGT,0,1311706
furpa,0.2,4,4,AAGGTTTGGAGGGTTACAAT,0,1314393
furpa,0.2,4,4,AAGGGTGCTTCGCAGCCATT,0,1333613
furpa,0.2,4,4,AAGGCTACCTCTATATAAGT,0,1338652
furpa,0.2,4,4,AAGGCAGGTTAATCCGATAC,0,1349539
furpa,0.2,4,4,AAGGCAGGCATCACGGGATA,0,1290482
furpa,0.2,4,4,AAGGACGTCCAAGACTTTCA,0,1334610
furpa,0.2,4,4,AAGCTTTAGCAAGATCCCGA,0,1334085
furpa,0.2,4,4,AAGCTGGATGGTGGTCCTCG,0,1335200
furpa,0.2,4,4,AAGCCCGATTCCCGGCGTCG,0,1286906
furpa,0.2,4,4,AAGCCCAAGTTGATCTCCTA,0,1343428
furpa,0.2,4,4,AAGCCAATTAGGTAACTAAC,0,1336277
furpa,0.2,4,4,AAGCATTGGATTATCATTAT,0,1347815
furpa,0.2,4,4,AAGCATGCTAAGAAAGTAAC,0,1334169
furpa,0.2,4,4,AAGATTATTAAATCCGCAGC,0,1345380
furpa,0.2,4,4,AAGACTGGATAGCTTAAGCA,0,1348829
furpa,0.2,4,4,AAGACAATATGACGAGGATC,0,1309006
furpa,0.2,4,4,AAGAAAGTGATCCAGTCCTA,0,1294346
furpa,0.2,4,4,AAGAAACGCGCGACTGGTTA,0,1324390
furpa,0.2,4,4,AAGAAAAAGCCGGAGTGATT,0,1311556
furpa,0.2,4,4,AACTTGTGCCACTATTAACC,0,1323505
furpa,0.2,4,4,AACTTGATTACTACCGGCAA,0,1339941
furpa,0.2,4,4,AACTGTATCGCTTACCCTTA,0,1279988
furpa,0.2,4,4,AACTATGTGACGAGTTATAT,0,1332223
furpa,0.2,4,4,AACGTGATTGTTCAGAATAC,0,1306924
furpa,0.2,4,4,AACGTAAAGGCGCGCGGCTT,0,1293897
furpa,0.2,4,4,AACCTCGTGTTGATCGGACC,0,1287012
furpa,0.2,4,4,AACCGCTAAGCGCGACAAAC,0,1303705
furpa,0.2,4,4,AACCACCCATTGCAACAAAT,0,1301751
furpa,0.2,4,4,AACATTATTGCATTGAAGCG,0,1277603
furpa,0.2,4,4,AACAGAGGGCGTCAAATAGC,0,1293307
furpa,0.2,4,4,AACAACGGACGTACGATTAG,0,1282655
furpa,0.2,4,4,AAATTTTCTGCGAGTAACTA,0,1295743
furpa,0.2,4,4,AAATGCAGCCTGAAACACAA,0,1288964
furpa,0.2,4,4,AAATGACATAGACAAGGCGG,0,1305930
furpa,0.2,4,4,AAATCCCAAACATTCTTATA,0,1277819
furpa,0.2,4,4,AAATATTGGGCATGAAGTAT,0,1322044
furpa,0.2,4,4,AAAGTAGAGCGGGTAAAGCT,0,1315342
furpa,0.2,4,4,AAAGGGAGCGCCATTGTTTG,0,1322124
furpa,0.2,4,4,AAAGGAGTGAACTCCAACCA,0,1321093
furpa,0.2,4,4,AAAGCTGGTTTGGTGATCTA,0,1305091
furpa,0.2,4,4,AAAGCAAGCTTGAGCCCGTT,0,1279789
furpa,0.2,4,4,AAAGATGCAGAGTGATTGGA,0,1344545
furpa,0.2,4,4,AAAGAGTGTATTGCAAAATA,0,1301063
furpa,0.2,4,4,AAAGAAATTGGGACTTAGTT,0,1284907
furpa,0.2,4,4,AAACTGTGTATTCTGTGATG,0,1309707
furpa,0.2,4,4,AAACGTCTTTAGGGCCTAAG,0,1319182
furpa,0.2,4,4,AAACCGCTAGGGATTTCTTG,0,1319783
furpa,0.2,4,4,AAACACCGATAGATCATGTT,0,1288930
furpa,0.2,4,4,AAAATAACCCCTATAGCACC,0,1306587
furpa,0.2,4,4,AAAAGTCTACACCACTTCTC,0,1300022
furpa,0.2,4,4,AAAAGCTTAAGAGTCTTAAT,0,1355725
furpa,0.2,4,4,AAAAGCATCGCGGGTATGAT,0,1307925
furpa,0.2,4,4,AAAAAGGAGCGGAGCCGGCA,0,1287172
furpa,0.2,4,4,AAAAAGATCTCGCCACAAGC,0,1309282
furpa,0.2,4,4,AAAAAGAAATGATAATTTAT,0,1331879
furpa,0.2,4,4,AAAAAAGGAGTGTAGCACGC,0,1325974
furpa,0.25,3,3,TTTTTGGGCCAATTAAGGTT,0,1271657
furpa,0.25,3,3,TTTTTAGGCGGGGCCGCGTT,0,1311643
furpa,0.25,3,3,TTTTGGAGACCAGCCGATCA,0,1293581
furpa,0.25,3,3,TTTTGCAACAACGCCAAATT,0,1335513
furpa,0.25,3,3,TTTTGACTCCGAGCCATGAT,0,1314066
furpa,0.25,3,3,TTTTGAAGGGATATTCATCG,0,1288666
furpa,0.25,3,3,TTTTCTTCGCTCAAAGGTGT,0,1357424
furpa,0.25,3,3,TTTTCTAACTGCACGGTAGA,0,1276639
furpa,0.25,3,3,TTTTCGGGTGTCCTTCGCCG,0,1276297
furpa,0.25,3,3,TTTTCGCAACATTTCCCTCA,0,1328027
furpa,0.25,3,3,TTTTCGAGTAGACAGCGTTA,0,1331968
furpa,0.25,3,3,TTTTATTGGAAACGCTTACG,0,1347780
furpa,0.25,3,3,TTTGTCTATGCCGGCAAAAT,0,1314123
furpa,0.25,3,3,TTTGCAGCCGTACGTTTGGC,0,1296991
furpa,0.25,3,3,TTTCTTCGGATGCCGACCGG,0,1299737
furpa,0.25,3,3,TTTCTGGTAAGATCAGTTTC,0,1290859
furpa,0.25,3,3,TTTCGTTGACGGCACACACG,0,1297957
furpa,0.25,3,3,TTTCGCCCCTATCTACTTGA,0,1328499
furpa,0.25,3,3,TTTCGCAGTTCTGAGGAGGA,0,1292298
furpa,0.25,3,3,TTTCATTCCGGGATAGAAAT,0,1276140
furpa,0.25,3,3,TTTATGGGGGAGAAGGGACA,0,1295469
furpa,0.25,3,3,TTTAGTTGTTTTTGAAATGA,0,1286674
furpa,0.25,3,3,TTTAGACGGAGAGAAAGGCA,0,1290851
furpa,0.25,3,3,TTTAACTTGCTCACGGCGAG,0,1325015
furpa,0.25,3,3,TTTAACGCGTCACCAGCTGC,0,1295986
furpa,0.25,3,3,TTTAAATTGGGATAGTATAA,0,1292998
furpa,0.25,3,3,TTTAAAGTAGCGGTGTTTCA,0,1304912
furpa,0.25,3,3,TTGTTCGGCACGCGTTAGGT,0,1310809
furpa,0.25,3,3,TTGTGAACATCTGTTCTTTG,0,1283319
furpa,0.25,3,3,TTGGTTACTTAAGGACGGTA,0,1319073
furpa,0.25,3,3,TTGGTCGCGACGTGGAACGA,0,1299772
furpa,0.25,3,3,TTGGTATCCCAGGAGAGACA,0,1346961
furpa,0.25,3,3,TTGGTACAACGCCTCCATGC,0,1272894
furpa,0.25,3,3,TTGGGTCTAGCCTCCGTATT,0,1290843
furpa,0.25,3,3,TTGGGTCAACCTCGACATGC,0,1273566
furpa,0.25,3,3,TTGGGGTCAGCGGAAACCTA,0,1293081
furpa,0.25,3,3,TTGGGACTATTCGGGCTGTT,0,1328591
furpa,0.25,3,3,TTGGGAAGAATTCCGCGTGA,0,1344446
furpa,0.25,3,3,TTGGCTGTCCGCGGTGTAAC,0,1314505
furpa,0.25,3,3,TTGGATTACAGGGGCCGCAC,0,1291127
furpa,0.25,3,3,TTGGATGTATGATGCTCCGT,0,1347994
furpa,0.25,3,3,TTGGACAATGGGCCATCGGC,0,1283087
furpa,0.25,3,3,TTGGACAACACTTCTAGTGT,0,1357543
furpa,0.25,3,3,TTGCTTGCCGGTCCAGTTAT,0,1274471
furpa,0.25,3,3,TTGCTGGTTCCGTCTACCAT,0,1308077
furpa,0.25,3,3,TTGCCCACTGAATGGCATCC,0,1348464
furpa,0.25,3,3,TTGCCATACCCACGCCCCCA,0,1305413
furpa,0.25,3,3,TTGCCAGGACAGGGCTAAAA,0,1297254
furpa,0.25,3,3,TTGCCAAGTCTCGCCAACTC,0,1341514
furpa,0.25,3,3,TTGCATCGGTTGAGAGATGT,0,1325785
furpa,0.25,3,3,TTGCAAGATCCATCATAACC,0,1315710
furpa,0.25,3,3,TTGATTGATTTTACAATCTC,0,1349410
furpa,0.25,3,3,TTGATGCACGCCCGCTAAGT,0,1292085
furpa,0.25,3,3,TTGAGCTTATCGGTGCCCCA,0,1307700
furpa,0.25,3,3,TTGACAATTCAGTAATGGCG,0,1291679
furpa,0.25,3,3,TTGAATCAGCTCTTGCTCCA,0,1333688
furpa,0.25,3,3,TTCTTGAAGTATTAATATTC,0,1295221
furpa,0.25,3,3,TTCTGTCTATGCAACCGCTG,0,1332942
furpa,0.25,3,3,TTCTGCTATCAATGCGTCTG,0,1318542
furpa,0.25,3,3,TTCTGCCCGCCTACTTTGTT,0,1298539
furpa,0.25,3,3,TTCTCTAAGTAGCGACTATT,0,1321546
furpa,0.25,3,3,TTCTCCTCGCGGACAGGCGT,0,1316340
furpa,0.25,3,3,TTCGTGTCCATCTACACGAC,0,1331436
furpa,0.25,3,3,TTCGTGCGATTCACCAACTT,0,1309827
furpa,0.25,3,3,TTCGTCTCTTGTCTCCAACC,0,1355784
furpa,0.25,3,3,TTCGTCCGGCGTACGAACGG,0,1303638
furpa,0.25,3,3,TTCGTAGAAGGCTGACAGAT,0,1344680
furpa,0.25,3,3,TTCGGTCCCCTTTATCGGCG,0,1277352
furpa,0.25,3,3,TTCGGTAAGGCCACAAGTGC,0,1345795
furpa,0.25,3,3,TTCGGGATGCTTCTACGTTA,0,1335243
furpa,0.25,3,3,TTCGGCGCTGGACAGCAAAG,0,1338140
furpa,0.25,3,3,TTCCGTGCAGAGCCTTACTC,0,1287164
furpa,0.25,3,3,TTCCCTCCATCAATGACATA,0,1291946
furpa,0.25,3,3,TTCCCGATTTCCACATACCG,0,1296810
furpa,0.25,3,3,TTCCCAACGATGTTAAAACA,0,1302949
furpa,0.25,3,3,TTCCAGTGAGGGCCAACAGG,0,1351535
furpa,0.25,3,3,TTCATAATGTGGAGTAAATT,0,1292130
furpa,0.25,3,3,TTCAGGGGTCATCGTTACTC,0,1346048
furpa,0.25,3,3,TTCAGCTCACATTTCGGGTG,0,1304513
furpa,0.25,3,3,TTCACGTCCACGCGCTTTAC,0,1352993
furpa,0.25,3,3,TTCACGTAGCGTACATCGGG,0,1328502
furpa,0.25,3,3,TTCACAGTAGGCAGGGCCTT,0,1328835
furpa,0.25,3,3,TTCAATTTGTCCGACGAGAG,0,1344345
furpa,0.25,3,3,TTCAATAGATGCCCACGTTC,0,1327163
furpa,0.25,3,3,TTCAAGGACCATATGAAACA,0,1320944
furpa,0.25,3,3,TTCAACGCTTTGCTAGGAGA,0,1307153
furpa,0.25,3,3,TTATTAATAAACTTGTTTGG,0,1336209
furpa,0.25,3,3,TTATGGCAACTTAATCATCA,0,1277852
furpa,0.25,3,3,TTATGGATGATCAGCGGAAG,0,1352864
furpa,0.25,3,3,TTATGCTGTGTTTTGATGCT,0,1355302
furpa,0.25,3,3,TTATATGCGTGGTGTACCAA,0,1324163
furpa,0.25,3,3,TTATAGTGGCCTCCACACGG,0,1294051
furpa,0.25,3,3,TTAGTTCGTGCTGCAATCTT,0,1336000
furpa,0.25,3,3,TTAGGCTACCCCTAAGTGTT,0,1281099
furpa,0.25,3,3,TTAGGATGGCGCGTTACAAT,0,1290693
furpa,0.25,3,3,TTAGCTGTCCGTATCTGTAA,0,1296523
furpa,0.25,3,3,TTAGAATTACGGCGAGAGTT,0,1324522
furpa,0.25,3,3,TTACTCGAATTTTATCTACT,0,1344097
furpa,0.25,3,3,TTACTCCAGTAGCCCGGTTG,0,1334823
furpa,0.25,3,3,TTACTAGGTAAATACATGTA,0,1349871
furpa,0.25,3,3,TTACGCTAGTTTTAATCCGA,0,1316006
furpa,0.25,3,3,TTACCTTAGAGCGAACAGCG,0,1278279
furpa,0.25,3,3,TTACACGGCCCGGTCCCGAT,0,1272914
furpa,0.25,3,3,TTACACGCCATACTTATGGT,0,1322948
furpa,0.25,3,3,TTACAAGGCCCTTGGCCGAG,0,1338997
furpa,0.25,3,3,TTAATGGCAGACACATTTCC,0,1313856
furpa,0.25,3,3,TTAATGAAGACAGTCAACGA,0,1271658
furpa,0.25,3,3,TTAAGTTGCATGTCACCGGA,0,1324367
furpa,0.25,3,3,TTAAGGCCCGTGAAGCGCAG,0,1277429
furpa,0.25,3,3,TTAAGGAGCAAGCGCCGTCA,0,1348779
furpa,0.25,3,3,TTAAGACGCATAAAACAACC,0,1353195
furpa,0.25,3,3,TTAACTCCACTTACTCAGTG,0,1332677
furpa,0.25,3,3,TGTTTCGTCCGACAGGCGTG,0,1335568
furpa,0.25,3,3,TGTTTAGTTCTAAACCTCTA,0,1298375
furpa,0.25,3,3,TGTTGCTAAAGTGTTCTTTC,0,1334794
furpa,0.25,3,3,TGTTATCGTTACGCCGAGTA,0,1346557
furpa,0.25,3,3,TGTGTATTATAATGTGAGAT,0,1344717
furpa,0.25,3,3,TGTGGTATAGCACCGCGACA,0,1293226
furpa,0.25,3,3,TGTGGGCTTCAATGTCTGTG,0,1277205
furpa,0.25,3,3,TGTGGGAATAGTCAAGAGTT,0,1289182
furpa,0.25,3,3,TGTGAGAATCACGCCGCTCT,0,1279271
furpa,0.25,3,3,TGTGAGAACTCATGAAGTTT,0,1336280
furpa,0.25,3,3,TGTCCTCTCGGCACGCACGA,0,1325630
furpa,0.25,3,3,TGTCACGTTGTCATATTAGC,0,1328880
furpa,0.25,3,3,TGTATTGTAATGTCAGCTCC,0,1315526
furpa,0.25,3,3,TGTATTATCGTGCGACGAGT,0,1296814
furpa,0.25,3,3,TGTATTAGGTTCCCCTTCCC,0,1297544
furpa,0.25,3,3,TGTAGTTTGCTGCAATTATA,0,1281904
furpa,0.25,3,3,TGTAGGGAACGATTCTCGTT,0,1306654
furpa,0.25,3,3,TGTAGCCGATCTTGGCGTCC,0,1342825
furpa,0.25,3,3,TGTAGCCCAGAGATAAGGCA,0,1282080
furpa,0.25,3,3,TGTACGGGGCGGCGTGGCGA,0,1303803
furpa,0.25,3,3,TGGTTCTTTAGCGCACCGGC,0,1337287
furpa,0.25,3,3,TGGTCTGCAATAGACTCAGT,0,1299962
furpa,0.25,3,3,TGGTCGTGGGGGGGAACACA,0,1304523
furpa,0.25,3,3,TGGTCCAACCGGAAATAGAG,0,1281656
furpa,0.25,3,3,TGGTAGCTAGTGCTAACTAC,0,1339841
furpa,0.25,3,3,TGGTAGAAGCTCGAGTCGCC,0,1319510
furpa,0.25,3,3,TGGTACTTGTATGTGATTGG,0,1322316
furpa,0.25,3,3,TGGTACAAGCAGGTGATGAC,0,1319401
furpa,0.25,3,3,TGGGTTATGGTAACCATAGG,0,1289455
furpa,0.25,3,3,TGGGTCCTGTGATCGGGCTT,0,1271285
furpa,0.25,3,3,TGGGGTTCTGAACCGTTCTC,0,1305709
furpa,0.25,3,3,TGGGGCGTTGTAACGAACTC,0,1306160
furpa,0.25,3,3,TGGGGCAGCTCAGGACTCCT,0,1348624
furpa,0.25,3,3,TGGGCTAGTTTTCATTTTCT,0,1284080
furpa,0.25,3,3,TGGGCATCGGGGGTCTGTAC,0,1304306
furpa,0.25,3,3,TGGGATTTGACGAGGCGAAG,0,1288987
furpa,0.25,3,3,TGGGATGTCGTCACATAGAG,0,1346704
furpa,0.25,3,3,TGGGAGCATACAGTATAAAT,0,1302915
furpa,0.25,3,3,TGGGAAGTGACCGAGCGGAA,0,1321315
furpa,0.25,3,3,TGGCGCAGCCGCTAGGGTCA,0,1318350
furpa,0.25,3,3,TGGCCGAGGGGGAGGTTTGG,0,1351160
furpa,0.25,3,3,TGGCACTTGGGGTCACGGTA,0,1316748
furpa,0.25,3,3,TGGCACATACTCCAACACAA,0,1299848
furpa,0.25,3,3,TGGATTGTATCAACTTCCAC,0,1315882
furpa,0.25,3,3,TGGATTGTAACTTTTCCTTT,0,1271751
furpa,0.25,3,3,TGGATTATTAAGATGTTGCT,0,1295947
furpa,0.25,3,3,TGGATTATCGGCGCGGAATG,0,1302595
furpa,0.25,3,3,TGGATAGTCCGTTAGTACAT,0,1341792
furpa,0.25,3,3,TGGAGGCGAAGGTAACCCCT,0,1328532
furpa,0.25,3,3,TGGAGGCACTCAGGGTGTAG,0,1325857
furpa,0.25,3,3,TGGAGAATACTTGGAAAGGC,0,1297571
furpa,0.25,3,3,TGGACTGGTAGTCGCAATAC,0,1288808
furpa,0.25,3,3,TGGACTCTATGTTTTAACCA,0,1307742
furpa,0.25,3,3,TGGACCTACCTCTACTGTTG,0,1342640
furpa,0.25,3,3,TGGAAGGGGTGAAGGTTGCC,0,1347264
furpa,0.25,3,3,TGCTGCTCGAACCTTCATAT,0,1356115
furpa,0.25,3,3,TGCTCTAAGGCAATCATGCT,0,1331354
furpa,0.25,3,3,TGCTCCAAGGACCCGTTCAG,0,1336335
furpa,0.25,3,3,TGCGTTGAGTTGTAGTGATT,0,1329543
furpa,0.25,3,3,TGCGTACCGTCGTTAATATG,0,1342460
furpa,0.25,3,3,TGCGTAAGGCGCTTGCTAGT,0,1316105
furpa,0.25,3,3,TGCGGAATTGCCCGGTGGCC,0,1314455
furpa,0.25,3,3,TGCGCTGTTGATATTGGTTC,0,1348439
furpa,0.25,3,3,TGCGCCTCAAGAATTGGAAA,0,1330788
furpa,0.25,3,3,TGCGCCGATGTGCATGCGCT,0,1272760
furpa,0.25,3,3,TGCGACGATACGCGCAGGTT,0,1276648
furpa,0.25,3,3,TGCGAACGGGTCCCGGACGG,0,1301580
furpa,0.25,3,3,TGCCGCCTGAAGTTCAAGCC,0,1332627
furpa,0.25,3,3,TGCCCGGTTCGTAGGTATTT,0,1332398
furpa,0.25,3,3,TGCCCCTGGGCCACGACCGT,0,1286105
furpa,0.25,3,3,TGCATATTAGCACTGTCCAA,0,1347136
furpa,0.25,3,3,TGCAGCCATCGTTCGGACTA,0,1327293
furpa,0.25,3,3,TGCAAATGCTACTAGCAGCC,0,1313947
furpa,0.25,3,3,TGATTCTTCTTCGGTAGATT,0,1307425
furpa,0.25,3,3,TGATCTAAGCTGCGACGAGG,0,1324074
furpa,0.25,3,3,TGATATGTCGGGTATGTACC,0,1334785
furpa,0.25,3,3,TGATAGCGTAACTGAGACAT,0,1282933
furpa,0.25,3,3,TGATAAAATTGCCGCCTCAA,0,1335687
furpa,0.25,3,3,TGAGGCTCAATGAACTGGTC,0,1334569
furpa,0.25,3,3,TGAGGCCAAAGTTGACGCCC,0,1308045
furpa,0.25,3,3,TGAGATATCCTGTACGGTGT,0,1345791
furpa,0.25,3,3,TGAGAGCGCAGGTCGTTTTC,0,1311157
furpa,0.25,3,3,TGAGAGACAGAGGCAGTGGG,0,1298364
furpa,0.25,3,3,TGACTGGGCTCGCCTGGCAT,0,1312450
furpa,0.25,3,3,TGACTGCACCGGTGTCAACG,0,1342382
furpa,0.25,3,3,TGACGTTTGTATCAGACGGG,0,1355869
furpa,0.25,3,3,TGACCCTGGTGAAAAAGCAG,0,1308378
furpa,0.25,3,3,TGACCAAGCAAGTCCCCCTA,0,1338441
furpa,0.25,3,3,TGACAGTGGGCAAGGAGAAT,0,1355285
furpa,0.25,3,3,TGACACTAGACCGCAGAGGA,0,1324700
furpa,0.25,3,3,TGAATTTGCGTGTCAACATC,0,1326070
furpa,0.25,3,3,TGAATCTATTACAAATTGAA,0,1294229
furpa,0.25,3,3,TGAAGGTCTGACCGTATGTG,0,1345194
furpa,0.25,3,3,TGAACGACAATGACGCCCCT,0,1308197
furpa,0.25,3,3,TGAAACCTCGATTGAACGTC,0,1312150
furpa,0.25,3,3,TGAAAATCCACGCCCTATAT,0,1356886
furpa,0.25,3,3,TCTTTCGTTCACCACAAGCA,0,1341819
furpa,0.25,3,3,TCTTTCCGGGCTCTTGGCAT,0,1353091
furpa,0.25,3,3,TCTTGGGCCACTGACCCACA,0,1288769
furpa,0.25,3,3,TCTTGGCATCTGCCGTCGCA,0,1334365
furpa,0.25,3,3,TCTTGCTCGAGCTGTTTCAG,0,1339758
furpa,0.25,3,3,TCTTCGTATCAACCCTTAGG,0,1292609
furpa,0.25,3,3,TCTTAGACGCATCCAGCGAT,0,1285240
furpa,0.25,3,3,TCTTAAGAAGCACTTCCAAG,0,1321763
furpa,0.25,3,3,TCTGTATCCCGGACCAACAC,0,1346906
furpa,0.25,3,3,TCTGTAGGGGTACCCATTAA,0,1339242
furpa,0.25,3,3,TCTGGTCACATTGCTGCCAT,0,1311746
furpa,0.25,3,3,TCTGGATCAAGCCGGACATA,0,1357428
furpa,0.25,3,3,TCTGCCGCATGCGAGCGGTT,0,1335789
furpa,0.25,3,3,TCTGCCAACAGATGAGTGTA,0,1287391
furpa,0.25,3,3,TCTGAAGCTATGGGCGAAGA,0,1347132
furpa,0.25,3,3,TCTCTGGTCGCTCTGTCGAA,0,1347542
furpa,0.25,3,3,TCTCTCGTCCACTGCGTATA,0,1289827
furpa,0.25,3,3,TCTCTCACCTATAGCGAAAG,0,1327282
furpa,0.25,3,3,TCTCTAGTTATGTGATTAGT,0,1273961
furpa,0.25,3,3,TCTATGCATTGCGGGGTTTG,0,1296851
furpa,0.25,3,3,TCTATACGTAGGAATTCGTG,0,1275251
furpa,0.25,3,3,TCTACATAAGCTACTGCACC,0,1298831
furpa,0.25,3,3,TCTAAACTTTATGGTCCGTC,0,1302947
furpa,0.25,3,3,TCGTTCTCAGAAAGTCCTCT,0,1313433
furpa,0.25,3,3,TCGTTCCTTCTGAACAATAG,0,1345579
furpa,0.25,3,3,TCGTTCCCTATGGCAATCTG,0,1345315
furpa,0.25,3,3,TCGTTCCCCTTCCCTGCTGG,0,1303727
furpa,0.25,3,3,TCGTGTTTGTTCCTTGTAGG,0,1304526
furpa,0.25,3,3,TCGTGAGAGCGTAGATCCGG,0,1304564
furpa,0.25,3,3,TCGTCTTTAGGTGAAAGTGA,0,1356668
furpa,0.25,3,3,TCGTACACGGTAGCGTTTAT,0,1344837
furpa,0.25,3,3,TCGTAAGCTTGCGGTATAGG,0,1337782
furpa,0.25,3,3,TCGGTTCTTAGGACAATGAA,0,1329715
furpa,0.25,3,3,TCGGGGGATCCATGGGTACT,0,1312485
furpa,0.25,3,3,TCGCTGGAACGACAGCGGTA,0,1332944
furpa,0.25,3,3,TCGCCGATGGTAACGTTTTG,0,1289089
furpa,0.25,3,3,TCGCAGTTGTCTGGGACCCC,0,1308132
furpa,0.25,3,3,TCGAGCTTGCTCCTGATAAT,0,1304387
furpa,0.25,3,3,TCGAGAACTAAGACTGGTTT,0,1354000
furpa,0.25,3,3,TCGAATGCTACCCCTAACTC,0,1329044
furpa,0.25,3,3,TCCTTCCCCAAGATGTCGCA,0,1310024
furpa,0.25,3,3,TCCTCGAAGCCTTATTTTCT,0,1294334
furpa,0.25,3,3,TCCTACCGAGGCCGCTCGCA,0,1344188
furpa,0.25,3,3,TCCTACAATAGCGGGCTGAG,0,1301264
furpa,0.25,3,3,TCCGTCCTATTGTACCGGGG,0,1338653
furpa,0.25,3,3,TCCGGAACTCGCTATCTCTA,0,1338144
furpa,0.25,3,3,TCCGCTTAGAGTGTCTCATG,0,1310117
furpa,0.25,3,3,TCCGCCTTGTTTCTGAACGG,0,1323291
furpa,0.25,3,3,TCCGAGGAAAGTTTCCCGAG,0,1331626
furpa,0.25,3,3,TCCGACAACTAAAGTTACGC,0,1336202
furpa,0.25,3,3,TCCCGTTTACCGGGGGTATC,0,1341505
furpa,0.25,3,3,TCCCGCAATGGAAGCGCAAT,0,1284570
furpa,0.25,3,3,TCCCCTCAAACTTCTGCTAT,0,1346264
furpa,0.25,3,3,TCCATTTTTCGTCCAGTCGG,0,1347890
furpa,0.25,3,3,TCCAGGTATGTGAAGGCGCG,0,1311929
furpa,0.25,3,3,TCCAGGCCGAGGCTAGATCT,0,1333098
furpa,0.25,3,3,TCCACTCATTAAAATTTGTT,0,1357587
furpa,0.25,3,3,TCCACTACAATGTTAACGAA,0,1284720
furpa,0.25,3,3,TCCAACGGTACGAGTTTAAG,0,1302281
furpa,0.25,3,3,TCATGGGTACGGTCAAGGCT,0,1289495
furpa,0.25,3,3,TCATGATATCACAACGCAGC,0,1294601
furpa,0.25,3,3,TCAGTCGAGAAATTGCTCGC,0,1313247
furpa,0.25,3,3,TCAGTCAGGATTATCCGAAG,0,1325574
furpa,0.25,3,3,TCAGTAGATCGAGATTAGCG,0,1318150
furpa,0.25,3,3,TCAGGGGACCTGTGGGAATC,0,1313358
furpa,0.25,3,3,TCAGGCTGACAACGTGTGCA,0,1305837
furpa,0.25,3,3,TCAGGAGTCTGTACAAATCG,0,1336330
furpa,0.25,3,3,TCAGGACCTTTAGCAGTAGT,0,1289015
furpa,0.25,3,3,TCAGCCCGCGCCGGAACTGT,0,1322016
furpa,0.25,3,3,TCAGATTGGTTACGTGACTA,0,1285333
furpa,0.25,3,3,TCAGAAGGGATTTACGCCGG,0,1315656
furpa,0.25,3,3,TCACTTCTCGAACGGAGGGT,0,1296012
furpa,0.25,3,3,TCACTAATCATTACTAACTT,0,1278784
furpa,0.25,3,3,TCACGTTGGGCTCCTATTTT,0,1281415
furpa,0.25,3,3,TCACGTATCGGTGCCAGAGC,0,1338562
furpa,0.25,3,3,TCACCGTACTCGTAGTTCAA,0,1314578
furpa,0.25,3,3,TCACCGATGCTGAACACGCC,0,1319552
furpa,0.25,3,3,TCACATTCAATCGCACTACT,0,1288561
furpa,0.25,3,3,TCAATCTGGGAGTCGAAATT,0,1273377
furpa,0.25,3,3,TCAATAGGCCGTAGCTCACT,0,1303887
furpa,0.25,3,3,TCAATAATGAGTTGCGCCAC,0,1300739
furpa,0.25,3,3,TCAAGCGTTCACAATTTGAA,0,1335398
furpa,0.25,3,3,TCAAGAAGAAGTGGCCTCAT,0,1305238
furpa,0.25,3,3,TCAACGGACATGAGGTACTC,0,1301368
furpa,0.25,3,3,TATTTGACTCATCGCAAACC,0,1354780
furpa,0.25,3,3,TATTTCCCACGCCAGAATAC,0,1280827
furpa,0.25,3,3,TATTGTAGGAAAGTCCGACC,0,1277452
furpa,0.25,3,3,TATTGATGCATATCCCGGGA,0,1303869
furpa,0.25,3,3,TATTCGGATTGTAGCAGGAT,0,1335508
furpa,0.25,3,3,TATTCAGGGAAGAGCCAACG,0,1324262
furpa,0.25,3,3,TATTCAGCAGGAAGAGGTGT,0,1357280
furpa,0.25,3,3,TATTAAGTGAATAGCTGTCA,0,1318690
furpa,0.25,3,3,TATTAAGGGCGTCAGGGGGG,0,1349799
furpa,0.25,3,3,TATTAAGCGGGCTCAGTTGC,0,1332697
furpa,0.25,3,3,TATTAAAGCATTAACGAAAC,0,1329920
furpa,0.25,3,3,TATGTTGAACTCAACTTCAA,0,1333391
furpa,0.25,3,3,TATGTGTCCAAGTCGCTATT,0,1349576
furpa,0.25,3,3,TATGTGGCTCCCCCGAACGG,0,1357254
furpa,0.25,3,3,TATGTCGGGGGGCCGTAGAG,0,1337080
furpa,0.25,3,3,TATGTAGTCGAAGGGTCCCG,0,1276415
furpa,0.25,3,3,TATGGCAACTATTGAGGACA,0,1335928
furpa,0.25,3,3,TATGCTTATTTGGCCGAACC,0,1275249
furpa,0.25,3,3,TATGCGCCTCAGCCGCAACT,0,1305327
furpa,0.25,3,3,TATGACAAAAGCGATCAAGT,0,1276464
furpa,0.25,3,3,TATCTTAGCCTATTAAGTGG,0,1280960
furpa,0.25,3,3,TATCTAAGTCATCGAGACAT,0,1347684
furpa,0.25,3,3,TATCGGGGTATCGAATAGGT,0,1325159
furpa,0.25,3,3,TATCCTTGAGTTACTACTGT,0,1314136
furpa,0.25,3,3,TATCCTGTGCGAAAATATAT,0,1293547
furpa,0.25,3,3,TATCCAGAGTTCCTGTAGTG,0,1300112
furpa,0.25,3,3,TATCATACAGCGGCGTAGTT,0,1330531
furpa,0.25,3,3,TATCAGGTAACCTTGGCGAG,0,1308136
furpa,0.25,3,3,TATCAGACAAGTCTCTTCGA,0,1315266
furpa,0.25,3,3,TATATTGAGTGTGGATGGTA,0,1321503
furpa,0.25,3,3,TATATCGGGGGGGGTTCTCT,0,1329288
furpa,0.25,3,3,TATAGGATAGAGTTGTAACA,0,1288171
furpa,0.25,3,3,TATAAGTACGGCCCTGCATT,0,1354929
furpa,0.25,3,3,TATAACAGCTTAGGTATTTT,0,1336020
furpa,0.25,3,3,TATAAATTGAAATCGGTAAG,0,1297635
furpa,0.25,3,3,TAGGTGCGAGCGATATCTAG,0,1355504
furpa,0.25,3,3,TAGGTATACTCACGACGCGT,0,1343280
furpa,0.25,3,3,TAGGGTGATCCAGGACTAAC,0,1301151
furpa,0.25,3,3,TAGGGTCTGCATTTACAATA,0,1354919
furpa,0.25,3,3,TAGGGGCCAAATCTCAACTA,0,1274511
furpa,0.25,3,3,TAGGGCTCTCCCAATTAGTA,0,1325622
furpa,0.25,3,3,TAGGGACACGACAAGTTCCT,0,1356153
furpa,0.25,3,3,TAGGCTATAGTTTGGAATTC,0,1283460
furpa,0.25,3,3,TAGGCCGGACGCTTGAGCAC,0,1279627
furpa,0.25,3,3,TAGGCAGGGCTGGGGGTCTA,0,1285564
furpa,0.25,3,3,TAGGACCCTGCGAACCTCCA,0,1357237
furpa,0.25,3,3,TAGGAAGCGACTAGCACAGT,0,1323170
furpa,0.25,3,3,TAGCTCCGGGATTTGCCTAG,0,1272820
furpa,0.25,3,3,TAGCGTGCACCTTGAAGTCA,0,1325174
furpa,0.25,3,3,TAGCGGTTCAGGTGCACTGA,0,1275303
furpa,0.25,3,3,TAGCGGCCGCGGCTCCCCTC,0,1340972
furpa,0.25,3,3,TAGCCGTGCCAAGTGGCGTC,0,1351267
furpa,0.25,3,3,TAGCATTTGCGATAGGTTTG,0,1295747
furpa,0.25,3,3,TAGCATGGGATAGGTCACAC,0,1299850
furpa,0.25,3,3,TAGCAGTGTAGCGTGACAAC,0,1317186
furpa,0.25,3,3,TAGCAGTCATACCCCTGCAG,0,1318847
furpa,0.25,3,3,TAGCAGGCCGCGTACACGCG,0,1306657
furpa,0.25,3,3,TAGACCGGCATTATAGAGTG,0,1317804
furpa,0.25,3,3,TAGAATCTGATCGCATGGTG,0,1293070
furpa,0.25,3,3,TAGAAGAATGGATAGTATGT,0,1298819
furpa,0.25,3,3,TACTTGGCAGATACCTATGA,0,1335603
furpa,0.25,3,3,TACTTCGCAGGAACTGTGGC,0,1289122
furpa,0.25,3,3,TACTGGAGTTATTCGGTTTC,0,1303279
furpa,0.25,3,3,TACTGAACTTACCTGACCGG,0,1293396
furpa,0.25,3,3,TACTCCCCGTGAGTACGGAC,0,1315944
furpa,0.25,3,3,TACTCATCGTCTTACGTTAA,0,1340593
furpa,0.25,3,3,TACTCATAAAGCATCGAATT,0,1311937
furpa,0.25,3,3,TACTACGCGGAAACCAAGAG,0,1313999
furpa,0.25,3,3,TACGTTGGAGCTCAGGAGGC,0,1296799
furpa,0.25,3,3,TACGTGTGCCGCTAGTCAGA,0,1276208
furpa,0.25,3,3,TACGTGCGTCATATGTCTAA,0,1291329
furpa,0.25,3,3,TACGTCGGGTTGTGTAAAAT,0,1310447
furpa,0.25,3,3,TACGTCCGCGGGCGGTCGGT,0,1326048
furpa,0.25,3,3,TACGTACCTCCGATTATTTC,0,1348826
furpa,0.25,3,3,TACCTTAACATTTTACGAAA,0,1313655
furpa,0.25,3,3,TACCCGGAGGTGTTTTGGTA,0,1288061
furpa,0.25,3,3,TACATTCAACTGGGTAAGCG,0,1290037
furpa,0.25,3,3,TACAGTCTCAGTAGATAAGA,0,1321336
furpa,0.25,3,3,TACAGCCTGCCCCAGTCTTA,0,1275578
furpa,0.25,3,3,TACAGCCTACCGCTGATGCG,0,1302657
furpa,0.25,3,3,TACACTCGAAACAGCACCTC,0,1300209
furpa,0.25,3,3,TACACGCGAATAGTGTGCAA,0,1353574
furpa,0.25,3,3,TACAATACTCGATAGCCATG,0,1271290
furpa,0.25,3,3,TAATTGTTACGTAGCCTGCA,0,1324447
furpa,0.25,3,3,TAATGAGGGCAGGCCCGATT,0,1353943
furpa,0.25,3,3,TAATCAACTTCTCATTTAGT,0,1323960
furpa,0.25,3,3,TAATATGTCGCTCGCGTACC,0,1318342
furpa,0.25,3,3,TAATATCGCGCAGCACTTGG,0,1343961
furpa,0.25,3,3,TAAGGCCTCCATAGTTTAGG,0,1350267
furpa,0.25,3,3,TAAGGAATTTATTTGCCAGT,0,1292255
furpa,0.25,3,3,TAAGCCTGCCACGAGTATCC,0,1274094
furpa,0.25,3,3,TAAGCCCAGACGCTAAGCAA,0,1342027
furpa,0.25,3,3,TAAGCCAACGGGGCACCGAC,0,1331847
furpa,0.25,3,3,TAAGCATATTGATCACCGCT,0,1350421
furpa,0.25,3,3,TAAGCAGGTTGGGAAAGAAG,0,1284580
furpa,0.25,3,3,TAAGACTTGTCATTTACATG,0,1276457
furpa,0.25,3,3,TAAGACACAGGCCTTTGATT,0,1296261
furpa,0.25,3,3,TAAGAATAAATGCGTCTCAA,0,1316519
furpa,0.25,3,3,TAACGAAAGCCAGTTAAGTT,0,1325877
furpa,0.25,3,3,TAACCAGAATCTCCACTACA,0,1299585
furpa,0.25,3,3,TAACAATATAGGACGCAGTA,0,1357321
furpa,0.25,3,3,TAACAAGGGTTTAGTGTCCT,0,1304374
furpa,0.25,3,3,TAACAAAAACTGTTACACCA,0,1283673
furpa,0.25,3,3,TAAAGTTAATATGGGCGACT,0,1316259
furpa,0.25,3,3,TAAAGGGATCACCTCTCTTT,0,1340427
furpa,0.25,3,3,TAAAGAGGAAACTTACATTT,0,1356883
furpa,0.25,3,3,TAAACTTCGCCGAACTATCG,0,1297567
furpa,0.25,3,3,TAAACAGAATGTCGTGACGC,0,1338227
furpa,0.25,3,3,TAAAACTACACGAAGCTTCA,0,1310222
furpa,0.25,3,3,TAAAACGGGAACAATTATTG,0,1279232
furpa,0.25,3,3,GTTTTACCGCTAAGTATCAG,0,1305171
furpa,0.25,3,3,GTTTGGGACGGCGACTCAGA,0,1335790
furpa,0.25,3,3,GTTTCGCTGTGTAGTTTGGT,0,1280961
furpa,0.25,3,3,GTTTCATCGAATTCGGATAA,0,1293280
furpa,0.25,3,3,GTTGTGCCGGCGTGTTCAAA,0,1318601
furpa,0.25,3,3,GTTGGTATCTGGAATGGCAG,0,1355058
furpa,0.25,3,3,GTTGGCGAAAACTTTAGTGT,0,1286323
furpa,0.25,3,3,GTTGGCCTCCATTCATCCAA,0,1311369
furpa,0.25,3,3,GTTGCCCAGCTATTCGAGCT,0,1281106
furpa,0.25,3,3,GTTGACATCGCCGTAGTCGT,0,1344670
furpa,0.25,3,3,GTTGAAGCCTCCACCTGCGT,0,1332722
furpa,0.25,3,3,GTTCTGTATTAGACTACGGT,0,1316063
furpa,0.25,3,3,GTTCTATACGACGGAGAGAC,0,1330408
furpa,0.25,3,3,GTTCGGTAATATTATACGTA,0,1298119
furpa,0.25,3,3,GTTCGATGTAGTGGTCGGCG,0,1346941
furpa,0.25,3,3,GTTCCGGTTCTGTGCTCGGG,0,1289764
furpa,0.25,3,3,GTTCCGCTTTGAGCATCCAG,0,1286842
furpa,0.25,3,3,GTTCCGAGACCCATTCCGAG,0,1272913
furpa,0.25,3,3,GTTCAACATGCGATTAGAAT,0,1274673
furpa,0.25,3,3,GTTATTCGCGCAGCTTTTTT,0,1302214
furpa,0.25,3,3,GTTAGCTACCACGTTGGCAT,0,1283710
furpa,0.25,3,3,GTTAGATCTTCTTCACATTA,0,1290404
furpa,0.25,3,3,GTTACTTTCTTCGGCAGGCA,0,1310740
furpa,0.25,3,3,GTTACGCAGACCAGCCGGTT,0,1297648
furpa,0.25,3,3,GTTACCGAACCGAATGTGAG,0,1307771
furpa,0.25,3,3,GTTACATCGTGAGCGAATAA,0,1295048
furpa,0.25,3,3,GTTAAGCACTAGCCCGTCTC,0,1351666
furpa,0.25,3,3,GTTAAAGCTGCTTATACACA,0,1302057
furpa,0.25,3,3,GTGTTCACAGCATTGCGTCT,0,1335663
furpa,0.25,3,3,GTGTGGTATGCTGTAAACAG,0,1347817
furpa,0.25,3,3,GTGTGACTTCGTGTTGTGGA,0,1289207
furpa,0.25,3,3,GTGTGAAAGCTATATGGGGC,0,1353424
furpa,0.25,3,3,GTGTCTCGTCGAACAGCCAA,0,1305335
furpa,0.25,3,3,GTGTAGGATTCTCAGTCCCT,0,1346478
furpa,0.25,3,3,GTGTACGGGTTCCTAGATCC,0,1290650
furpa,0.25,3,3,GTGTACCCGCGCCAGGAAGA,0,1275183
furpa,0.25,3,3,GTGGTTGAACTTACGTAGAA,0,1298335
furpa,0.25,3,3,GTGGGGCACAATAGCCCGCC,0,1322825
furpa,0.25,3,3,GTGGCGCAGTCTATAAACTG,0,1284969
furpa,0.25,3,3,GTGGAGCTACAGGCGGAGTG,0,1310999
furpa,0.25,3,3,GTGGACCTGGGTAACGGACT,0,1297433
furpa,0.25,3,3,GTGCTTGGGTCTTGACGGGG,0,1329116
furpa,0.25,3,3,GTGCTTAAATAATATCCAGT,0,1271411
furpa,0.25,3,3,GTGCTCTTAAATCGCCGCCA,0,1326624
furpa,0.25,3,3,GTGCGATGGTATTTGCTCGT,0,1349108
furpa,0.25,3,3,GTGCCGCCTTAAGTCGATTT,0,1342680
furpa,0.25,3,3,GTGATTGCGCTGTATATAGT,0,1293744
furpa,0.25,3,3,GTGAGCTCCCAACATCCATT,0,1273431
furpa,0.25,3,3,GTGACGGGTCTCATGGAACC,0,1278543
furpa,0.25,3,3,GTGACCTTGCAACGGTCAGG,0,1340651
furpa,0.25,3,3,GTGACCCGAGGTCATGATCC,0,1271661
furpa,0.25,3,3,GTGACAAACTAGTACAGTCC,0,1298579
furpa,0.25,3,3,GTGAAGTCTTAAAGCTATTA,0,1291955
furpa,0.25,3,3,GTGAACTTATACCCTACTTT,0,1330904
furpa,0.25,3,3,GTCTTATCGAGCATTAATAC,0,1347145
furpa,0.25,3,3,GTCTGGCAAGTCCGCAGTGC,0,1313995
furpa,0.25,3,3,GTCTCTGCCCGCCTACTACA,0,1313108
furpa,0.25,3,3,GTCTCCCCCGAATTTGAGGC,0,1313634
furpa,0.25,3,3,GTCTAGAAGTATCCTCAGAG,0,1343281
furpa,0.25,3,3,GTCTACTCCGACGGGAAGAG,0,1305179
furpa,0.25,3,3,GTCGTTAGATGATTTTGCGT,0,1279052
furpa,0.25,3,3,GTCGCTAGCTCACGAAAGAT,0,1335120
furpa,0.25,3,3,GTCGCGAAAGTCGATGGCAG,0,1356793
furpa,0.25,3,3,GTCGAATAAACCATCGATTG,0,1316336
furpa,0.25,3,3,GTCCTACATAATCAAGGTTA,0,1328298
furpa,0.25,3,3,GTCCGTCTTGAAAGAGATCG,0,1284758
furpa,0.25,3,3,GTCCGATGTAATATAGAATC,0,1338338
furpa,0.25,3,3,GTCCGAATGATGAAGGACGC,0,1325967
furpa,0.25,3,3,GTCCCCGATAACGAAATCTC,0,1289670
furpa,0.25,3,3,GTCATGGCGATTAGTAATGA,0,1355055
furpa,0.25,3,3,GTCATCTGGACATCTTGAAA,0,1294712
furpa,0.25,3,3,GTCATCCGATTGCCCTATAT,0,1292176
furpa,0.25,3,3,GTCAGTGAGCCGGGTCTTGT,0,1297269
furpa,0.25,3,3,GTCAGAGGCCCGGTGCAGCG,0,1320152
furpa,0.25,3,3,GTCACGGAGCATCCTGAGGT,0,1301019
furpa,0.25,3,3,GTCACCATTCTGTCGAATGA,0,1344890
furpa,0.25,3,3,GTATTTGACTTGACAACCGA,0,1325062
furpa,0.25,3,3,GTATTCCGGCTACATGTACA,0,1302063
furpa,0.25,3,3,GTATCGAGTCCATTGTTGGA,0,1294145
furpa,0.25,3,3,GTATATTCTGTGTTCTGTAA,0,1350489
furpa,0.25,3,3,GTATATTAAAAGTCCTGAAA,0,1327103
furpa,0.25,3,3,GTAGTGTTTGAGGGCACAAG,0,1340484
furpa,0.25,3,3,GTAGTGGCCAGGAGGATTGG,0,1297760
furpa,0.25,3,3,GTAGCTTCTCATCTGAGAGT,0,1324092
furpa,0.25,3,3,GTAGCCGAGCAGCATGGGAA,0,1304297
furpa,0.25,3,3,GTAGAACGAACGTGTAAATT,0,1349222
furpa,0.25,3,3,GTACTCGTTAGAGGAGTAGA,0,1273324
furpa,0.25,3,3,GTACGTACACGTCACATCGT,0,1291842
furpa,0.25,3,3,GTACCAACGTCAGACTCCCC,0,1296072
furpa,0.25,3,3,GTAATGGTCTGCTTTACGCG,0,1354198
furpa,0.25,3,3,GTAAGTTGACTAAGTCAGCG,0,1298269
furpa,0.25,3,3,GTAAGCTTGCAAACATCTGC,0,1290156
furpa,0.25,3,3,GTAAGACGTCGCGGACTATG,0,1345858
furpa,0.25,3,3,GTAACGTGCGGACACAAGCC,0,1352716
furpa,0.25,3,3,GTAAACTAGCAATACAACTA,0,1323440
furpa,0.25,3,3,GTAAACGGGTGCAACCATGA,0,1321636
furpa,0.25,3,3,GTAAACCATAGCTGTGGGAG,0,1356323
furpa,0.25,3,3,GGTTTGCATCTTTTCACCTA,0,1306174
furpa,0.25,3,3,GGTTTCCGGTGTGTAGTCTC,0,1347263
furpa,0.25,3,3,GGTTGCGTCACCTTCACCGC,0,1275007
furpa,0.25,3,3,GGTTGCAGCAGGGGCTTCGC,0,1350412
furpa,0.25,3,3,GGTTGAGTTAGGTGCACCAT,0,1293882
furpa,0.25,3,3,GGTTCTCAGAATCCTTTCGG,0,1276000
furpa,0.25,3,3,GGTTCGATCTTATTAGATGT,0,1331371
furpa,0.25,3,3,GGTTCCGGCCTTCCGTTCCT,0,1285253
furpa,0.25,3,3,GGTTCAGTAGGTCATGGATT,0,1321552
furpa,0.25,3,3,GGTTATGTCTGATATATGGC,0,1328510
furpa,0.25,3,3,GGTGGTCTAGTGAGAAGATA,0,1275205
furpa,0.25,3,3,GGTGGGGTTGCACACCAAAT,0,1330257
furpa,0.25,3,3,GGTGGCGGAGGCGTATCGGC,0,1288329
furpa,0.25,3,3,GGTGGAGGACGAGGCGAGAG,0,1351015
furpa,0.25,3,3,GGTGCTCAGCAAGTGGCTAA,0,1351965
furpa,0.25,3,3,GGTGCCTTAAAGAACGCCAG,0,1328386
furpa,0.25,3,3,GGTGCATGTGTCGTAAATGC,0,1350734
furpa,0.25,3,3,GGTGATCGAGGTATAGGCAT,0,1300127
furpa,0.25,3,3,GGTCTCGTGAAGCACGCATA,0,1305501
furpa,0.25,3,3,GGTCTCCAGGTAGCGTCATG,0,1353980
furpa,0.25,3,3,GGTCCTGGGTGTGGTCCGTG,0,1339681
furpa,0.25,3,3,GGTCATCGCAAAATGCACGT,0,1350422
furpa,0.25,3,3,GGTATAGAAGGAGTGCACAT,0,1352121
furpa,0.25,3,3,GGTAGTCATGGCGCACGAAA,0,1320861
furpa,0.25,3,3,GGTACATCCAACCGTCTCTA,0,1347657
furpa,0.25,3,3,GGTAACCTTACGTTCGCATG,0,1318222
furpa,0.25,3,3,GGGTTTCTAAGCACACGGTT,0,1319029
furpa,0.25,3,3,GGGTTAGGCCCCTAGCTACT,0,1285767
furpa,0.25,3,3,GGGTTACCAAGCTGAAAGCG,0,1343733
furpa,0.25,3,3,GGGTTACAACGGATGGTATG,0,1321575
furpa,0.25,3,3,GGGTGTTACCACCGACCATG,0,1349535
furpa,0.25,3,3,GGGTGGGGCGGGGATTCTGA,0,1311772
furpa,0.25,3,3,GGGTGCCCGCGTAGGTAGTA,0,1316521
furpa,0.25,3,3,GGGTGCCAGGCTTCAAATTC,0,1322850
furpa,0.25,3,3,GGGTGCAGTCTATATAACCA,0,1339487
furpa,0.25,3,3,GGGTCGCGTGACCGTCCCGT,0,1352145
furpa,0.25,3,3,GGGTCCCTTATTCCGCTACC,0,1328602
furpa,0.25,3,3,GGGTCCACAGCGCTGAACCT,0,1298764
furpa,0.25,3,3,GGGTCATCGTCAAACCCTTT,0,1324453
furpa,0.25,3,3,GGGTAAGTATTCCCTCTGTA,0,1306425
furpa,0.25,3,3,GGGGTGGCGGGAGGGATCCC,0,1344180
furpa,0.25,3,3,GGGGTGGATCGGGCCTCCGG,0,1339870
furpa,0.25,3,3,GGGGGTTTAAAGTAGCGGGT,0,1341511
furpa,0.25,3,3,GGGGGTTAAAACTCAACGAC,0,1308225
furpa,0.25,3,3,GGGGCTCACGACTTACGACG,0,1328086
furpa,0.25,3,3,GGGGCCGGTAACGAAACGGA,0,1303175
furpa,0.25,3,3,GGGGCATGGTGTGCACCCTT,0,1336250
furpa,0.25,3,3,GGGGAGGTGAAGTAATAACT,0,1331212
furpa,0.25,3,3,GGGCTAGCAGGAGGTAGGCC,0,1279298
furpa,0.25,3,3,GGGCGGCGAAGTCAGGTAAT,0,1275474
furpa,0.25,3,3,GGGCCGGCCCTCACGCTTTG,0,1313441
furpa,0.25,3,3,GGGCATATGGTTATTCGCCT,0,1293438
furpa,0.25,3,3,GGGCAGGGGTGTGTCTGAGG,0,1300610
furpa,0.25,3,3,GGGATATTTCCACCGTCTAA,0,1297419
furpa,0.25,3,3,GGGATAGAAAGGGCGTCGCT,0,1333066
furpa,0.25,3,3,GGGATACCCAGTACGTGTCA,0,1330427
furpa,0.25,3,3,GGGAGTCGGTGGACACGGAG,0,1315624
furpa,0.25,3,3,GGGAGGTTGTCTGAGACATG,0,1344385
furpa,0.25,3,3,GGGAGACCTGCGTGGTTAGC,0,1277743
furpa,0.25,3,3,GGGAGAACGCTTATTTACGT,0,1322388
furpa,0.25,3,3,GGGACGTGAAGTGTCTAATC,0,1282769
furpa,0.25,3,3,GGGACCGATGCGTCGGAAGC,0,1330810
furpa,0.25,3,3,GGGACACAGGCAAAATCCGC,0,1279617
furpa,0.25,3,3,GGGAACAAGTAGGCGGTGTC,0,1309331
furpa,0.25,3,3,GGGAAATCATATTAGTCAGG,0,1353375
furpa,0.25,3,3,GGCTTTGCCCCGAAAACGTA,0,1329035
furpa,0.25,3,3,GGCTGGCTGTATCGCTCTTC,0,1357347
furpa,0.25,3,3,GGCTGCGTTTCGTAGGTTCA,0,1357516
furpa,0.25,3,3,GGCTCTTGCCTAGAGGTTTA,0,1289032
furpa,0.25,3,3,GGCTCCAATGCACGATCTCA,0,1347315
furpa,0.25,3,3,GGCTAGCCTTCTACAGCAGT,0,1315122
furpa,0.25,3,3,GGCTACCCATTGCGTTGGTG,0,1319188
furpa,0.25,3,3,GGCTAATATGTACTCTAGAG,0,1297140
furpa,0.25,3,3,GGCTAACCTTCGAAGCGGTC,0,1277342
furpa,0.25,3,3,GGCGTTCCGGCACTTCTCGA,0,1336422
furpa,0.25,3,3,GGCGTGACGGGCCACAAGGT,0,1339888
furpa,0.25,3,3,GGCGTCTTTCCCAGATTTCG,0,1327365
furpa,0.25,3,3,GGCGGCGTATCGTAAGGATC,0,1275457
furpa,0.25,3,3,GGCGGCGGTTCACTAGTATG,0,1345082
furpa,0.25,3,3,GGCGGAGCACGACGTGCTGG,0,1344548
furpa,0.25,3,3,GGCGACTATTACTTGTCCGA,0,1352349
furpa,0.25,3,3,GGCGACACACAGGATAATAA,0,1319122
furpa,0.25,3,3,GGCCCAAAAGCTGCACCTGT,0,1276056
furpa,0.25,3,3,GGCCATTGGGGTCAATTTTG,0,1354206
furpa,0.25,3,3,GGCCAGAAGGTTGCCAATTA,0,1356847
furpa,0.25,3,3,GGCCAAGGGCGTATGAGGCC,0,1275203
furpa,0.25,3,3,GGCATTGGCCTCCTAGACCT,0,1333173
furpa,0.25,3,3,GGCATGATTGTGGCCAAACG,0,1332537
furpa,0.25,3,3,GGCACAAACCAAAGTCTGCT,0,1305251
furpa,0.25,3,3,GGCAAGCAGAGTGAATCTGT,0,1282825
furpa,0.25,3,3,GGCAACAAACACCTAGCTAA,0,1347445
furpa,0.25,3,3,GGATCTCAGTGATGCACGAG,0,1282755
furpa,0.25,3,3,GGATCCAACCGGCCGCTAGC,0,1322869
furpa,0.25,3,3,GGATAGACATTCATTTCTAC,0,1287791
furpa,0.25,3,3,GGATACGCGGAGCAGAACTT,0,1339419
furpa,0.25,3,3,GGAGTGTGGAAGGTAGACAT,0,1320836
furpa,0.25,3,3,GGAGCGCACGAGCGAGACTG,0,1284064
furpa,0.25,3,3,GGAGATGTATGGAGGGTAGA,0,1279639
furpa,0.25,3,3,GGAGATCTGGCATATGAGGA,0,1314332
furpa,0.25,3,3,GGAGACGTGCGGACTCGTAC,0,1306863
furpa,0.25,3,3,GGAGAAGACTTAGGTATAAG,0,1301265
furpa,0.25,3,3,GGACGGACCGCTCCAGATCA,0,1278986
furpa,0.25,3,3,GGACGAACGGCCACTTCGCC,0,1303923
furpa,0.25,3,3,GGAATTGTGGGCATGCGAAT,0,1339493
furpa,0.25,3,3,GGAATCACGAAGAGTGGAAA,0,1355828
furpa,0.25,3,3,GGAATCAATTCATCAGGCTT,0,1275956
furpa,0.25,3,3,GGAAGAACCGTAGACCCGTG,0,1307521
furpa,0.25,3,3,GGAAAGCCCTAGTTTTTCCG,0,1283304
furpa,0.25,3,3,GGAAACAACGGAGTTCGCGT,0,1334033
furpa,0.25,3,3,GCTTTCATCCCGCTCGCAAC,0,1305758
furpa,0.25,3,3,GCTTGTGCTTATAACGGCGT,0,1300335
furpa,0.25,3,3,GCTTGGAGTGTACCCAAACA,0,1328300
furpa,0.25,3,3,GCTTCGGGGGGTTTGGATGG,0,1308661
furpa,0.25,3,3,GCTTCGGGGACTTTAGACGA,0,1335688
furpa,0.25,3,3,GCTTCGCGCTACCCATGCGC,0,1343799
furpa,0.25,3,3,GCTTCCTCGTTAATGGGACC,0,1271607
furpa,0.25,3,3,GCTTATCTGCCGTCCCATCG,0,1276623
furpa,0.25,3,3,GCTTATCGCGCCATTTTGCA,0,1330400
furpa,0.25,3,3,GCTTATATTGGTCACCGAAA,0,1292469
furpa,0.25,3,3,GCTGTCTTATTCAGTCCAGG,0,1342047
furpa,0.25,3,3,GCTGTCGTTTGTAACGAGAG,0,1283814
furpa,0.25,3,3,GCTGGCCCACATCCTCCTCG,0,1329377
furpa,0.25,3,3,GCTGGATACGTTTAACAGGG,0,1330793
furpa,0.25,3,3,GCTGCGCTGATTGTGCTACA,0,1291049
furpa,0.25,3,3,GCTGACTCTTTCCCACCCCT,0,1272332
furpa,0.25,3,3,GCTCTCTCTTGGACTTCTTA,0,1306455
furpa,0.25,3,3,GCTCTATATCGGGCAAATCC,0,1327903
furpa,0.25,3,3,GCTCGGTTAGGAAGTATACA,0,1295854
furpa,0.25,3,3,GCTCGCGCAGTACCGAGGCA,0,1337181
furpa,0.25,3,3,GCTCCGATCCCACTATCAGA,0,1313134
furpa,0.25,3,3,GCTCATGTCGCGTATCGAGT,0,1309657
furpa,0.25,3,3,GCTCAGTGAGTATTCATGGA,0,1324957
furpa,0.25,3,3,GCTCACACGGTGATATCCCT,0,1274405
furpa,0.25,3,3,GCTATCTAGCACTTTGTTGA,0,1310939
furpa,0.25,3,3,GCTACCAAAACTGCCTGGAT,0,1338287
furpa,0.25,3,3,GCTAAGATATAGCACAAGCA,0,1273552
furpa,0.25,3,3,GCGTTGTACGATTATTTAGA,0,1313885
furpa,0.25,3,3,GCGTTCACTCCCGGGAACAT,0,1347834
furpa,0.25,3,3,GCGTTATACAGAAATCATAA,0,1297459
furpa,0.25,3,3,GCGTCGAGCGAGGCTATATA,0,1296352
furpa,0.25,3,3,GCGTCCGTAGAACGACTCTG,0,1295321
furpa,0.25,3,3,GCGTAGGCGTTGATCCTATC,0,1294206
furpa,0.25,3,3,GCGTACTGGTTGGTCGGGAT,0,1309602
furpa,0.25,3,3,GCGTAACCGAGGCGTTAGTA,0,1328080
furpa,0.25,3,3,GCGGTGGCAGTATCGATCCC,0,1284214
furpa,0.25,3,3,GCGGTCATGCGCCCTGATCG,0,1296697
furpa,0.25,3,3,GCGGGGGGAGTCGGACACGC,0,1348078
furpa,0.25,3,3,GCGGGGGAATTTTGGTCCCC,0,1285184
furpa,0.25,3,3,GCGGGCAACATTCGGGATAT,0,1272167
furpa,0.25,3,3,GCGGGAGTAAGGGTAGCCTA,0,1324289
furpa,0.25,3,3,GCGGAATCTCTCGGGTAGAA,0,1348339
furpa,0.25,3,3,GCGCTTGGAAAGAATCTCAC,0,1341936
furpa,0.25,3,3,GCGCTGCTGGTCTAATTATT,0,1337719
furpa,0.25,3,3,GCGCTCATCATACAAAGACA,0,1335999
furpa,0.25,3,3,GCGCGCGTGCGACTCAACAG,0,1323895
furpa,0.25,3,3,GCGCGATGAGCTAATCAGAG,0,1300781
furpa,0.25,3,3,GCGCGAGTGTCTTTTGGGGT,0,1288105
furpa,0.25,3,3,GCGCCGTGGCCGGATATGTG,0,1325829
furpa,0.25,3,3,GCGCCGGTACGGGTTCATCT,0,1316378
furpa,0.25,3,3,GCGCCGAGGACAGTACGGGT,0,1355141
furpa,0.25,3,3,GCGCCCAGACTCATTTCTGA,0,1332603
furpa,0.25,3,3,GCGATGTAAGCTTGAAAAAT,0,1297451
furpa,0.25,3,3,GCGAGTTAGGTGTATTTGCC,0,1291230
furpa,0.25,3,3,GCGAGAGGATTGTACCGGCC,0,1357588
furpa,0.25,3,3,GCGAGAAGGACTATAGGTAG,0,1315361
furpa,0.25,3,3,GCGACGGCGGGAAAAGACTT,0,1273382
furpa,0.25,3,3,GCGACGACAGTGATAGCTAG,0,1286938
furpa,0.25,3,3,GCGACCGGAGTACATGCGAA,0,1316607
furpa,0.25,3,3,GCGACCGAGTACCTTTATCC,0,1276063
furpa,0.25,3,3,GCGACAGGGCTCGGGTCTAG,0,1316084
furpa,0.25,3,3,GCGAATGCGGAAAGTCCGGT,0,1339239
furpa,0.25,3,3,GCCTTCTGACGATTGGAGTC,0,1357582
furpa,0.25,3,3,GCCTGGCCTAGTGGCTTATT,0,1344202
furpa,0.25,3,3,GCCTGCCGTAACAGTGTGAT,0,1325740
furpa,0.25,3,3,GCCTAGATTTATCGCCAAAG,0,1296939
furpa,0.25,3,3,GCCTACTTGCCCCACGTAGA,0,1309656
furpa,0.25,3,3,GCCGTGGGGAACTCCAAGTC,0,1290250
furpa,0.25,3,3,GCCGTGACCCCGTATTACTT,0,1344624
furpa,0.25,3,3,GCCGTAATCAGTACCGTAGA,0,1282243
furpa,0.25,3,3,GCCGGCTCCCTTGTGGTAAA,0,1295078
furpa,0.25,3,3,GCCGCGGGACGAGAGACCTA,0,1305178
furpa,0.25,3,3,GCCGCAGCCCTAGCATTTAC,0,1351343
furpa,0.25,3,3,GCCGATGACACGGGATTAAT,0,1298679
furpa,0.25,3,3,GCCCGTGCTGCGTACGGAGC,0,1343516
furpa,0.25,3,3,GCCCGTATCTTTGCTAAAAC,0,1318232
furpa,0.25,3,3,GCCCGGCTGTACCAAGTGTA,0,1277650
furpa,0.25,3,3,GCCCCCGTTCGGCGGAGACC,0,1311865
furpa,0.25,3,3,GCCCCAATAGTGGTGCATCC,0,1311040
furpa,0.25,3,3,GCCCAGTGCTGGGCCTTGCG,0,1318042
furpa,0.25,3,3,GCCCAATGGGGGTCCTCCTT,0,1327326
furpa,0.25,3,3,GCCAGCCGCTTGTATACGAT,0,1315806
furpa,0.25,3,3,GCCACGAACCGTACATTAAC,0,1310644
furpa,0.25,3,3,GCATGTTAGCACGTGGTGCA,0,1352434
furpa,0.25,3,3,GCATCCCCTGCATCCGAAGA,0,1355116
furpa,0.25,3,3,GCATAGTGCGAGCGGTTACG,0,1321704
furpa,0.25,3,3,GCATAGTAGGCCCTGAAAGC,0,1276668
furpa,0.25,3,3,GCATACTCGGGGTACGCGCT,0,1340921
furpa,0.25,3,3,GCATAAGTTGTTCAGGGTGT,0,1286751
furpa,0.25,3,3,GCAGGGACCGTGTCCGTGTC,0,1337717
furpa,0.25,3,3,GCAGCGAGTGGCACCGTCCT,0,1279599
furpa,0.25,3,3,GCAGCCTTAGATACGACGAA,0,1291954
furpa,0.25,3,3,GCAGCATCTGCGATGGATTC,0,1329525
furpa,0.25,3,3,GCAGCACAATTAACACTCCA,0,1329998
furpa,0.25,3,3,GCAGCAAGAAAATGCCGCGG,0,1314293
furpa,0.25,3,3,GCAGAAAGCCGACCGGGTCG,0,1343154
furpa,0.25,3,3,GCACTTAGCATGTTGGTTCC,0,1299651
furpa,0.25,3,3,GCACGTGTCTAACCTACTCG,0,1271947
furpa,0.25,3,3,GCACGTCATATATATGGACT,0,1276116
furpa,0.25,3,3,GCACCTACATACACTGTAAA,0,1341530
furpa,0.25,3,3,GCACATTCACTGCTGGGTCA,0,1286840
furpa,0.25,3,3,GCACATCGATTCGTTTTAAA,0,1333838
furpa,0.25,3,3,GCACAGCCTCGGGCCTCAGG,0,1321069
furpa,0.25,3,3,GCACAAAAGGTGCGCACTCG,0,1290305
furpa,0.25,3,3,GCAATATGCACGCTCAAAGC,0,1280196
furpa,0.25,3,3,GCAAGCGGTGCCTTTGAGTC,0,1335599
furpa,0.25,3,3,GCAAGACGACGTGCTTTATT,0,1287271
furpa,0.25,3,3,GCAACAAACACCGCTCGGTA,0,1312654
furpa,0.25,3,3,GCAAAGAATTCTAGTGAATC,0,1303196
furpa,0.25,3,3,GCAAACCGGCACGTTGATAA,0,1313643
furpa,0.25,3,3,GATTTTTTGCTCGTTAAGCA,0,1328871
furpa,0.25,3,3,GATTTAATCTACGTTTGCAG,0,1347972
furpa,0.25,3,3,GATTGCCTCTGGATGGGAAC,0,1339793
furpa,0.25,3,3,GATTCCTGGATCTGCGCGGG,0,1356005
furpa,0.25,3,3,GATTAGTGTCCTCTCAGTCA,0,1276451
furpa,0.25,3,3,GATGCGTACTATGGGTTATG,0,1310231
furpa,0.25,3,3,GATGATACCAAATCCCCTAG,0,1319498
furpa,0.25,3,3,GATGAGTATTACGAACGGAT,0,1293382
furpa,0.25,3,3,GATGACGGGGTACCAATTGA,0,1345611
furpa,0.25,3,3,GATGACCTTCTGGGGTAAGC,0,1350085
furpa,0.25,3,3,GATGACCGACCAGATGTGTG,0,1294713
furpa,0.25,3,3,GATGAATACTTTTCGTGTTT,0,1280007
furpa,0.25,3,3,GATCTTTGACTTGACAGGAG,0,1277453
furpa,0.25,3,3,GATCCATGCGATCACGGGAT,0,1283939
furpa,0.25,3,3,GATCCATCGAGAATTCGGAT,0,1288873
furpa,0.25,3,3,GATCCAAACCCTAGGCGCTT,0,1314454
furpa,0.25,3,3,GATCATCCCGCGCCTTAGGC,0,1322033
furpa,0.25,3,3,GATCAATCAGCAATGCATGG,0,1280519
furpa,0.25,3,3,GATCAACGGTAGGCCACATT,0,1275501
furpa,0.25,3,3,GATCAAATACTCCGGACCGT,0,1275122
furpa,0.25,3,3,GATATTAAATGACTACTCAA,0,1290776
furpa,0.25,3,3,GATATGGCGCGCGGTAGATA,0,1342862
furpa,0.25,3,3,GATACCCTAGGAGAACCAAT,0,1277118
furpa,0.25,3,3,GAGTTCCTGTATGACTTGTT,0,1296179
furpa,0.25,3,3,GAGTTATTACTGTGCGTAGT,0,1321722
furpa,0.25,3,3,GAGTGTTAAATTGAGAGGTT,0,1340978
furpa,0.25,3,3,GAGTGGCGATCTCAAGTTCG,0,1308974
furpa,0.25,3,3,GAGTGCCATCACTTTTAAAA,0,1339031
furpa,0.25,3,3,GAGTCCGGAACCTTCCGAGG,0,1318854
furpa,0.25,3,3,GAGTATCAACGACCTGCTAC,0,1348560
furpa,0.25,3,3,GAGTAGGCTCAATTGCGAGG,0,1307142
furpa,0.25,3,3,GAGGTTTGATCTCTATTAAA,0,1343463
furpa,0.25,3,3,GAGGGTTGCCAGGTGTTTCA,0,1291504
furpa,0.25,3,3,GAGGCTCCGCTGATTGTGCT,0,1282525
furpa,0.25,3,3,GAGGCGTGTAGTGGACTGTA,0,1310463
furpa,0.25,3,3,GAGCTGTTGTTCATTGATTA,0,1304763
furpa,0.25,3,3,GAGCTAGGGCCTCATAGCCA,0,1296879
furpa,0.25,3,3,GAGCCCGCCAAGCGTAATGG,0,1285157
furpa,0.25,3,3,GAGCCCATCAAGAACACTCT,0,1331566
furpa,0.25,3,3,GAGCATAGGACCGGTCGAGA,0,1338375
furpa,0.25,3,3,GAGCACTCACGTCTCGGAAA,0,1335422
furpa,0.25,3,3,GAGCACGGTCTGGTGATTCA,0,1320502
furpa,0.25,3,3,GAGCACGCATTACGACGCGA,0,1310043
furpa,0.25,3,3,GACTTTATCTAGATTATGAC,0,1333762
furpa,0.25,3,3,GACTTCACGCACATAAGCAG,0,1306230
furpa,0.25,3,3,GACTTAAACCTGCGTCGGGG,0,1339040
furpa,0.25,3,3,GACTGTCTACTGGTCGTCAG,0,1292011
furpa,0.25,3,3,GACTCGTGTCCCATTTCATT,0,1285831
furpa,0.25,3,3,GACTCGAACGTACAGGAGCG,0,1287075
furpa,0.25,3,3,GACTCCGAGCAATCCAGAAG,0,1275714
furpa,0.25,3,3,GACTATTGTTCCTGGTAAGG,0,1351168
furpa,0.25,3,3,GACGTGTACCCGATCGCCAA,0,1324740
furpa,0.25,3,3,GACGTGAGAGCTAGACATCT,0,1334506
furpa,0.25,3,3,GACGGTGGCGGTGCGACGGC,0,1316819
furpa,0.25,3,3,GACGCGTGGGGATTGAGCAA,0,1350095
furpa,0.25,3,3,GACCTGAATGGGCAAACTAG,0,1313181
furpa,0.25,3,3,GACCTACTGAGGTGGATTGA,0,1293533
furpa,0.25,3,3,GACCAGACACAAGTAGGTTA,0,1277988
furpa,0.25,3,3,GACAGCGGGTAGTACAGAGA,0,1299394
furpa,0.25,3,3,GACAGAAGCGCTCTTTGACC,0,1345684
furpa,0.25,3,3,GACACTCTGCTCGAAAGCCA,0,1272749
furpa,0.25,3,3,GACAATGTATTACCGACGTC,0,1295826
furpa,0.25,3,3,GACAATCGTTACCCGGTGGA,0,1330939
furpa,0.25,3,3,GACAACGGATTTGTCCTGCA,0,1339549
furpa,0.25,3,3,GAATTTATGATAACACGCAT,0,1298659
furpa,0.25,3,3,GAATTGGACTGGACTCCTAT,0,1355811
furpa,0.25,3,3,GAATTCCTCGTTCTCCGGAG,0,1325965
furpa,0.25,3,3,GAATGGGTACTAGCAGATTA,0,1284713
furpa,0.25,3,3,GAATGAGTGTGCCGGCTAGA,0,1292942
furpa,0.25,3,3,GAATGAAGGGTACTGCGCAA,0,1310451
furpa,0.25,3,3,GAAGTTTTTCCGATGGGGCA,0,1341624
furpa,0.25,3,3,GAAGTTTAATCGAACGGTCT,0,1328868
furpa,0.25,3,3,GAAGTCTGATGAGTATTAGC,0,1328119
furpa,0.25,3,3,GAAGTCTGAACCCGCGCGTC,0,1334155
furpa,0.25,3,3,GAAGGGTTCGTAGGCTATAG,0,1336605
furpa,0.25,3,3,GAAGGATTTTGGCTGTTCCT,0,1346576
furpa,0.25,3,3,GAAGCGCGGCAATCTGGTAT,0,1330732
furpa,0.25,3,3,GAAGCAATATGATTAACGCT,0,1301601
furpa,0.25,3,3,GAAGAACTTAGTTACTTCAA,0,1275707
furpa,0.25,3,3,GAAGAAATAGGCAACTGAGA,0,1305356
furpa,0.25,3,3,GAACTTGGAATTCGTGCGCA,0,1278554
furpa,0.25,3,3,GAACAGTTACAGTGCCGAAG,0,1307172
furpa,0.25,3,3,GAACAGCGGTGGCGAAAGGG,0,1333736
furpa,0.25,3,3,GAACAGCGGAATCGACCTCA,0,1311247
furpa,0.25,3,3,GAAATCGGTTCGTTCGGTTT,0,1332528
furpa,0.25,3,3,GAAAGGGGGCCGTCCTTCCG,0,1277101
furpa,0.25,3,3,CTTTGGGGTACCGTATTTCA,0,1283003
furpa,0.25,3,3,CTTTCTTTGGCAAAGTTGAA,0,1301083
furpa,0.25,3,3,CTTTCGTACCAAAGCTCTTT,0,1317735
furpa,0.25,3,3,CTTTCGACCTGTTAATACTG,0,1288761
furpa,0.25,3,3,CTTTCCTACCTCGTGTGGAG,0,1288980
furpa,0.25,3,3,CTTTAGTCTAAGGAAGACGA,0,1324793
furpa,0.25,3,3,CTTGTGTTAGTGGGTGGCTA,0,1284743
furpa,0.25,3,3,CTTGTGTGTGAGATGTACTA,0,1321203
furpa,0.25,3,3,CTTGTGATGTGTTGAGTAAT,0,1297482
furpa,0.25,3,3,CTTGTCTTTTACTGGATGAT,0,1291459
furpa,0.25,3,3,CTTGCCGGCTATGGCCTAGA,0,1318959
furpa,0.25,3,3,CTTGCCCAGTTATCAAGGGC,0,1352958
furpa,0.25,3,3,CTTCTTCTGCGCCCAGAGAG,0,1285578
furpa,0.25,3,3,CTTCTACCGTGACTCCTACG,0,1356319
furpa,0.25,3,3,CTTCGTAGCTGGATGCTTTA,0,1279514
furpa,0.25,3,3,CTTCGCGGGGAGGACCAGCT,0,1305326
furpa,0.25,3,3,CTTCCTGCCAACTGGGCGAC,0,1325466
furpa,0.25,3,3,CTTCCCAACCCCATAGTGGG,0,1319063
furpa,0.25,3,3,CTTCAATTTCGGGGAAGTCA,0,1338373
furpa,0.25,3,3,CTTATGTGGGTTCAGACGCG,0,1322563
furpa,0.25,3,3,CTTATGGCAAGTAGGGTTTG,0,1299537
furpa,0.25,3,3,CTTAGTTCGATGCCGACCCG,0,1330442
furpa,0.25,3,3,CTTAGCGGTGCGGTCACGGG,0,1349680
furpa,0.25,3,3,CTTACTCAGCGGTGACGATT,0,1348060
furpa,0.25,3,3,CTGTTGTTTTTCATTTACAC,0,1275596
furpa,0.25,3,3,CTGTTGTACGTGGTGCTGTA,0,1298535
furpa,0.25,3,3,CTGTTATATCCCCTAGGGTA,0,1290485
furpa,0.25,3,3,CTGTGTCAACATGGCAACGC,0,1333925
furpa,0.25,3,3,CTGTGGGCGTGTGCGCTCTG,0,1324434
furpa,0.25,3,3,CTGTCTGCAGTCACGGCAAG,0,1304317
furpa,0.25,3,3,CTGTACGCGCCACGTAAAGC,0,1273713
furpa,0.25,3,3,CTGGTTAAGTGTCGTACGGG,0,1328816
furpa,0.25,3,3,CTGGGTTAAAGGTGGGCTTT,0,1346915
furpa,0.25,3,3,CTGGGTACGCGCTTTGGAAT,0,1317279
furpa,0.25,3,3,CTGGCCACTTGTGTACTACT,0,1315195
furpa,0.25,3,3,CTGGAGAAAGTGCCGCGATG,0,1305903
furpa,0.25,3,3,CTGGAAAGGTAGCACGGGGC,0,1338748
furpa,0.25,3,3,CTGCTGCTGTTGTTAACAGT,0,1316273
furpa,0.25,3,3,CTGCGGGGGGTGTAATGGGT,0,1303296
furpa,0.25,3,3,CTGCGATCATATCTGTTCCC,0,1304234
furpa,0.25,3,3,CTGCCGGGGGATATGGTACA,0,1277328
furpa,0.25,3,3,CTGCCCGCTAAAGGTAAACT,0,1296137
furpa,0.25,3,3,CTGCATATAAGCACTACCTA,0,1286767
furpa,0.25,3,3,CTGCATACCGACTGTAAGCT,0,1353485
furpa,0.25,3,3,CTGATCCAAACTCTGGCGCA,0,1357331
furpa,0.25,3,3,CTGATACTGGTTCCCACTAC,0,1286110
furpa,0.25,3,3,CTGAGTCTAACATCACGAGC,0,1293478
furpa,0.25,3,3,CTGACCACATACGGCTTGGC,0,1310449
furpa,0.25,3,3,CTGAATTTTTCGTTAGTTGT,0,1277749
furpa,0.25,3,3,CTCTGTGAAAAAAGTAGTTT,0,1311215
furpa,0.25,3,3,CTCTGCGCCATTAGGCGGCT,0,1342800
furpa,0.25,3,3,CTCTGAGACCGTAATTACTG,0,1311017
furpa,0.25,3,3,CTCTGACTGAACGGTGCGTA,0,1337246
furpa,0.25,3,3,CTCTCTTCAGGACCGTCGAA,0,1276016
furpa,0.25,3,3,CTCTCTCGACGTTGCGTAAG,0,1338961
furpa,0.25,3,3,CTCTATGTCAAGTGGCGTGA,0,1311100
furpa,0.25,3,3,CTCTAAAAGGTCATCTCTAT,0,1357195
furpa,0.25,3,3,CTCGTCAGTAACCACTGGTA,0,1322012
furpa,0.25,3,3,CTCGTCAGGTGGAACTGGCT,0,1306098
furpa,0.25,3,3,CTCGGTACATTGCCAGAGAG,0,1319836
furpa,0.25,3,3,CTCGGGTTCGCGGCTATGTG,0,1321857
furpa,0.25,3,3,CTCGCGTACAAATAAGTTAA,0,1336883
furpa,0.25,3,3,CTCGCCGATTTCACGGTCTA,0,1299867
furpa,0.25,3,3,CTCGCAGATTATCACCCATA,0,1325112
furpa,0.25,3,3,CTCGACCCGGTTCCGAACAG,0,1280919
furpa,0.25,3,3,CTCCTGATGCCAGGGTACAT,0,1347470
furpa,0.25,3,3,CTCCGTACCACCGGTTGAAT,0,1294240
furpa,0.25,3,3,CTCCCGCCGTACAAATAGGC,0,1279582
furpa,0.25,3,3,CTCCACTCCATTAACAGGTC,0,1273609
furpa,0.25,3,3,CTCATGACAGTGATGAGCAA,0,1316522
furpa,0.25,3,3,CTCATATCATGCCCACAAGA,0,1318633
furpa,0.25,3,3,CTCAGGACCCCACCAAAGTC,0,1328761
furpa,0.25,3,3,CTCACTTTCAAGTGCCGATA,0,1299133
furpa,0.25,3,3,CTCACTTACACGAACGATAG,0,1277129
furpa,0.25,3,3,CTCACTCGCGCGGCCTTGCG,0,1297566
furpa,0.25,3,3,CTATTTGGCCCGCTGGTCCC,0,1348900
furpa,0.25,3,3,CTATGCGGCGCAGGTCAAAA,0,1331538
furpa,0.25,3,3,CTATCGTACAAGTTGAGGGC,0,1275813
furpa,0.25,3,3,CTAGCGTCCATGGGAGGGAA,0,1309340
furpa,0.25,3,3,CTAGCGTCATGTTGTACTCG,0,1300332
furpa,0.25,3,3,CTAGCCCTCTGCGTGTCTGA,0,1350204
furpa,0.25,3,3,CTAGCCACGGAGCAGACATG,0,1351007
furpa,0.25,3,3,CTAGATCATATTGGCTTGGC,0,1283432
furpa,0.25,3,3,CTAGATAAAGCCGATACCTC,0,1325132
furpa,0.25,3,3,CTACTTGTCTTTGGTAAGTC,0,1329995
furpa,0.25,3,3,CTACTACGCTCTTATTGTCG,0,1293867
furpa,0.25,3,3,CTACGGATACACGCTTAGGT,0,1310603
furpa,0.25,3,3,CTACGCTCGATGTACGATCA,0,1356495
furpa,0.25,3,3,CTACCGACATGTGCTAACGT,0,1276824
furpa,0.25,3,3,CTACAGTATAATCGCGATAG,0,1320117
furpa,0.25,3,3,CTACAATTCAAGTGACGCCG,0,1293128
furpa,0.25,3,3,CTAATTCAGCCTTTAAGGAA,0,1279287
furpa,0.25,3,3,CTAATGTCCGAGGGATCGTG,0,1352224
furpa,0.25,3,3,CTAATGCGGGGCTCCGCGAC,0,1321063
furpa,0.25,3,3,CTAATAGTCCAGTGAACTTG,0,1348729
furpa,0.25,3,3,CTAAGCCTACGGCAAAGATC,0,1346298
furpa,0.25,3,3,CTAAGATACCATGGCTCGCT,0,1325227
furpa,0.25,3,3,CTAACTTCGACCGTATTGGC,0,1307419
furpa,0.25,3,3,CTAACTGCGCTCACCCCTAG,0,1285490
furpa,0.25,3,3,CTAAAACTCAGTCGCTCAGT,0,1281625
furpa,0.25,3,3,CTAAAACAAAACTCTTAATT,0,1335723
furpa,0.25,3,3,CGTTTTTTTGGAAGGTTACG,0,1346589
furpa,0.25,3,3,CGTTGCTCGAAGTAGCTACC,0,1321963
furpa,0.25,3,3,CGTTCTTAATTCAAAGTAGA,0,1340132
furpa,0.25,3,3,CGTTCCTAGGCGATCAGGCG,0,1315148
furpa,0.25,3,3,CGTTCATTGCGTGAGCATCT,0,1349548
furpa,0.25,3,3,CGTTATAACCATGCGTACTG,0,1283924
furpa,0.25,3,3,CGTTATAAATTCACCCCACA,0,1332853
furpa,0.25,3,3,CGTTACCGCCCCCACCGACT,0,1282526
furpa,0.25,3,3,CGTTAATTCAAGGCAAATGT,0,1272454
furpa,0.25,3,3,CGTGTTGGTGTCATACCTGA,0,1302062
furpa,0.25,3,3,CGTGTGCCCCAATGGGCCGA,0,1288079
furpa,0.25,3,3,CGTCTGTTTGTCGCTAGACA,0,1293035
furpa,0.25,3,3,CGTCTCCTAGTTTCGGACTG,0,1295305
furpa,0.25,3,3,CGTCTAAATACTGATTAATC,0,1353526
furpa,0.25,3,3,CGTCGCAGTCCACTCGAGGG,0,1286049
furpa,0.25,3,3,CGTCGCAACACGAATCGCGT,0,1310596
furpa,0.25,3,3,CGTCATGTCGTGGCTCACAT,0,1290369
furpa,0.25,3,3,CGTCACTACGCCGCCATACC,0,1333069
furpa,0.25,3,3,CGTCAACCCTAAGGTCTAAA,0,1328448
furpa,0.25,3,3,CGTATTTAGGCAGACTAATC,0,1348387
furpa,0.25,3,3,CGTATGATTAGGTTCCGAAT,0,1355839
furpa,0.25,3,3,CGTATCGTAGGACAGCGCGA,0,1324370
furpa,0.25,3,3,CGTACGTTAGCCGCCTAGTA,0,1281020
furpa,0.25,3,3,CGTACGTCTTCGCCTTGCGT,0,1293194
furpa,0.25,3,3,CGTACGAAGCTCCTAGGTAG,0,1309746
furpa,0.25,3,3,CGTACATCTTCGGTGTGGAA,0,1284896
furpa,0.25,3,3,CGTAATTTTAGAATCTCCAC,0,1332365
furpa,0.25,3,3,CGTAATAAGATAAGGGTTCA,0,1334776
furpa,0.25,3,3,CGGTTTGGCTCTGGGTTATG,0,1293243
furpa,0.25,3,3,CGGTTTGGACACCTCATGCT,0,1276934
furpa,0.25,3,3,CGGTGTCTACGTGTCGCACG,0,1296993
furpa,0.25,3,3,CGGTGGATTACTCGTTGTTA,0,1346558
furpa,0.25,3,3,CGGTGAAACGGCTCTCAACT,0,1306112
furpa,0.25,3,3,CGGTCTTCATTGAGGGTGGT,0,1338317
furpa,0.25,3,3,CGGTCAGGTTCTTGAGAAGA,0,1297603
furpa,0.25,3,3,CGGTACAGTTGTGCTCCTGA,0,1271861
furpa,0.25,3,3,CGGTAAAGTCACATTCGGAA,0,1336076
furpa,0.25,3,3,CGGGTCATTGTTCCCAGCCG,0,1346351
furpa,0.25,3,3,CGGGGTCGGGGGAAAGGCTA,0,1338973
furpa,0.25,3,3,CGGGGGGGTACATGTAGTCA,0,1316506
furpa,0.25,3,3,CGGGGAGATCTCAACGCCAT,0,1277863
furpa,0.25,3,3,CGGGCTAGATGGCATGACGA,0,1317435
furpa,0.25,3,3,CGGGCGATCATCTCTTCGGA,0,1304137
furpa,0.25,3,3,CGGGCCCCATGATCGTTAAG,0,1326605
furpa,0.25,3,3,CGGGCAGTCCAGGACTCAAC,0,1303153
furpa,0.25,3,3,CGGGAGCCATCGCCCAGGTC,0,1288865
furpa,0.25,3,3,CGGCTTCGGGGGGACAAATC,0,1353706
furpa,0.25,3,3,CGGCTCTGCTACAGTACTAC,0,1354583
furpa,0.25,3,3,CGGCGCTCACGAGATCCCAA,0,1308603
furpa,0.25,3,3,CGGCCATATTGTCCTCGTCT,0,1292813
furpa,0.25,3,3,CGGCAAGTAATCACTACCAA,0,1315320
furpa,0.25,3,3,CGGATTGGTGATCGGTTAAG,0,1304556
furpa,0.25,3,3,CGGATTGGGAATATTATTTT,0,1327270
furpa,0.25,3,3,CGGAGTTTGGGGTTTCCGCA,0,1308063
furpa,0.25,3,3,CGGAGGACGGGTATACCAGG,0,1339642
furpa,0.25,3,3,CGGAGCACCGTTCGCGTAAA,0,1331257
furpa,0.25,3,3,CGGAGAGTCGTTCCTTAAAG,0,1318533
furpa,0.25,3,3,CGGAGAGACGGGAAATCTGT,0,1289856
furpa,0.25,3,3,CGGACCCCGTTTGAGTGCCA,0,1273553
furpa,0.25,3,3,CGGACAGGAAACCACCGGGA,0,1344804
furpa,0.25,3,3,CGCTTGCGTGCGATATACTA,0,1313672
furpa,0.25,3,3,CGCTTGAGATATATACACCA,0,1319329
furpa,0.25,3,3,CGCTTACTATGTCTTGCACC,0,1338572
furpa,0.25,3,3,CGCTGTTCTGATGTACCTCA,0,1280525
furpa,0.25,3,3,CGCTGCTCAGTCGTAGTGGG,0,1316352
furpa,0.25,3,3,CGCTCCGTACGCATAGGTTG,0,1277516
furpa,0.25,3,3,CGCTCACGGATGATCGACCA,0,1302339
furpa,0.25,3,3,CGCTACCCGACCCTAGAAAT,0,1345780
furpa,0.25,3,3,CGCTACAGAATCTACGTTTG,0,1343026
furpa,0.25,3,3,CGCTAATCGACGAATACTGC,0,1347039
furpa,0.25,3,3,CGCGTTTGCTGATCTCAAAC,0,1353154
furpa,0.25,3,3,CGCGTTCCGAGTCAAACATC,0,1344972
furpa,0.25,3,3,CGCGTGGCGACGAAGTTCTC,0,1322028
furpa,0.25,3,3,CGCGTGGACATGCCCAGAGT,0,1321199
furpa,0.25,3,3,CGCGTATCCCGAGGTCGTGT,0,1288554
furpa,0.25,3,3,CGCGGTTCGCGTTTTTGAAC,0,1316308
furpa,0.25,3,3,CGCGGCTTTACTCAGCGTAC,0,1313685
furpa,0.25,3,3,CGCGGCACCCCTGTACGCGC,0,1286645
furpa,0.25,3,3,CGCGCTTGCGAGCAAGGTTG,0,1314753
furpa,0.25,3,3,CGCGCTAAGAGCTGGAAAGG,0,1355424
furpa,0.25,3,3,CGCGCGACAGATCGTTGCTT,0,1277812
furpa,0.25,3,3,CGCCTTGATTACGGCCCAAG,0,1323307
furpa,0.25,3,3,CGCCCGACGGTCGAGCTCTG,0,1291168
furpa,0.25,3,3,CGCCCATCTTCGTTTGGATG,0,1311399
furpa,0.25,3,3,CGCAGGCTGGAACGTGTATT,0,1298000
furpa,0.25,3,3,CGCAGATAATTGCCAGCACA,0,1279361
furpa,0.25,3,3,CGCACGTATTTGCTACAAAT,0,1327007
furpa,0.25,3,3,CGCAAGGGTCCTCCATAGAG,0,1333813
furpa,0.25,3,3,CGCAACAGTCGGTCCTTATT,0,1283671
furpa,0.25,3,3,CGCAAAACTAGACGGGATGT,0,1290286
furpa,0.25,3,3,CGATTGGGCGTACGTTACCC,0,1294624
furpa,0.25,3,3,CGATTCATTCTATCTAAGTA,0,1303704
furpa,0.25,3,3,CGATTATTAAGTTTTCCGCA,0,1298627
furpa,0.25,3,3,CGATCGAGTGCTAGCACCCT,0,1302925
furpa,0.25,3,3,CGATCCTGGTGGACAGACTC,0,1303562
furpa,0.25,3,3,CGATCCGAGCCTTCGAATGA,0,1337731
furpa,0.25,3,3,CGATCCCCTGGTTGAATTGA,0,1317432
furpa,0.25,3,3,CGATCCCCTACGAAACAGGG,0,1350657
furpa,0.25,3,3,CGATCCATCTTCAATATGAG,0,1306179
furpa,0.25,3,3,CGAGTTCACTATGTGATATC,0,1339333
furpa,0.25,3,3,CGAGTCAGCTTTGTCGTTCA,0,1275462
furpa,0.25,3,3,CGAGGGTGAAGTTTTCCTGG,0,1331069
furpa,0.25,3,3,CGAGACCTGGTAGTGTTTCC,0,1271938
furpa,0.25,3,3,CGAGAACTCATCTCTTCCGG,0,1347928
furpa,0.25,3,3,CGACTGGGGTCTTCTAAGTT,0,1344925
furpa,0.25,3,3,CGACGTTCAATATGGAGGAC,0,1357315
furpa,0.25,3,3,CGACGCGATTTTTAATACCT,0,1284151
furpa,0.25,3,3,CGACGAGGCGCACTACTTCC,0,1336346
furpa,0.25,3,3,CGACGAGATAACCCAGTGGG,0,1345369
furpa,0.25,3,3,CGACACTGCTTGATAAGTAG,0,1308232
furpa,0.25,3,3,CGAATTAAAATCCTGGGTAT,0,1345075
furpa,0.25,3,3,CGAAGCGGAGTTCCTTTCCT,0,1346491
furpa,0.25,3,3,CGAACTGGGGCGCGTAGCGA,0,1347777
furpa,0.25,3,3,CGAAATTCGGGAACCGCAGG,0,1351955
furpa,0.25,3,3,CGAAAGGAGGAAGACATATA,0,1275835
furpa,0.25,3,3,CCTTTTACTGCGGCGTGTGG,0,1314417
furpa,0.25,3,3,CCTTTGGTCCGTATCAACCC,0,1351429
furpa,0.25,3,3,CCTTTGGCCAACATAGTTTT,0,1313182
furpa,0.25,3,3,CCTTTCATGGTAAGACAAAG,0,1299966
furpa,0.25,3,3,CCTTGTTGACCGGGCGCTAT,0,1331707
furpa,0.25,3,3,CCTTACGCCTTTCCCCTGAG,0,1352436
furpa,0.25,3,3,CCTGTGCGTCGCGATTATCA,0,1327269
furpa,0.25,3,3,CCTGTAGAGACTATATGTAA,0,1342704
furpa,0.25,3,3,CCTGGCTCCAGTCCTCGGCT,0,1295917
furpa,0.25,3,3,CCTGGCGAGTAGTCGCTTGG,0,1323621
furpa,0.25,3,3,CCTGCGGAAGAGGGGCCGTC,0,1280004
furpa,0.25,3,3,CCTGATATTCAGGGACCGGG,0,1356563
furpa,0.25,3,3,CCTGAACTTGTTAACTGGCA,0,1353463
furpa,0.25,3,3,CCTCTGAAATATCTCAACGA,0,1284549
furpa,0.25,3,3,CCTCTAGCGCGGGTTTGTTG,0,1291077
furpa,0.25,3,3,CCTCGCAACAATGAGAGTTA,0,1290976
furpa,0.25,3,3,CCTCATCGTCAACGCCTCTC,0,1345886
furpa,0.25,3,3,CCTCAGACCAACCGAGTTAT,0,1298301
furpa,0.25,3,3,CCTCACGATACTAAGCCTGA,0,1312174
furpa,0.25,3,3,CCTCAATTTCGAGAATCTTT,0,1334030
furpa,0.25,3,3,CCTATAGAGAACTGTTATGC,0,1307284
furpa,0.25,3,3,CCTACGCGTTCGGCTGCAAC,0,1354254
furpa,0.25,3,3,CCTACAGGGCCGGAAGCCTT,0,1341149
furpa,0.25,3,3,CCTAAATTATGGCGCGCTTT,0,1342387
furpa,0.25,3,3,CCGTTTAAGGATATTAGCTG,0,1309392
furpa,0.25,3,3,CCGTAGCATCCCGGGTCGGA,0,1342777
furpa,0.25,3,3,CCGGTGGGTTGTGGCTCCAA,0,1313213
furpa,0.25,3,3,CCGGCTCCAGGAAACTCTCA,0,1322620
furpa,0.25,3,3,CCGGCGGTCGGTTCTGTAAA,0,1320871
furpa,0.25,3,3,CCGGAGAGGCGGCGTCAACG,0,1320139
furpa,0.25,3,3,CCGCTCATCTCATAATTCAG,0,1334790
furpa,0.25,3,3,CCGCTAGATGAGATTCGGCG,0,1343628
furpa,0.25,3,3,CCGCGCCGCGGTGAGGGTGA,0,1311626
furpa,0.25,3,3,CCGCCACATTGTCAGGAGTT,0,1351025
furpa,0.25,3,3,CCGCAGTGTGCATACCATGG,0,1319380
furpa,0.25,3,3,CCGCAGGAGAAGGAGGAGTA,0,1283576
furpa,0.25,3,3,CCGCACTTCTATCATATGAC,0,1292891
furpa,0.25,3,3,CCGCAACCATGGGACCCTTT,0,1315249
furpa,0.25,3,3,CCGATGGACTGCCTAGAGAC,0,1279359
furpa,0.25,3,3,CCGATAGTGCACAGCTACCC,0,1344821
furpa,0.25,3,3,CCGACCTAACTTCCTAACAC,0,1305664
furpa,0.25,3,3,CCGACATAGTCAGATCTGCT,0,1325263
furpa,0.25,3,3,CCGAAATGACGGGGGCATCT,0,1343790
furpa,0.25,3,3,CCCTTGCGCTGGGTGCGCAT,0,1343793
furpa,0.25,3,3,CCCTTCTCTGGCTGTGACTG,0,1352578
furpa,0.25,3,3,CCCTGCTGGTCTGAGTCGCA,0,1315130
furpa,0.25,3,3,CCCTCCGAGGGTCTACATAT,0,1328134
furpa,0.25,3,3,CCCTCATGCCTCCAGAATAC,0,1280857
furpa,0.25,3,3,CCCTCACTCCGCTAAGAAGC,0,1293316
furpa,0.25,3,3,CCCTATTTTCTTTTATGGGG,0,1345747
furpa,0.25,3,3,CCCTATATCGGCAATAAAGT,0,1309343
furpa,0.25,3,3,CCCTAAGTGCGTAATGTCCA,0,1281089
furpa,0.25,3,3,CCCGTCATAGACCTACAATG,0,1337586
furpa,0.25,3,3,CCCGGTAGGATGATGCTGAT,0,1354400
furpa,0.25,3,3,CCCGCGATGCGGGAGGAGAA,0,1317551
furpa,0.25,3,3,CCCGCATATTCACTTATTAG,0,1326470
furpa,0.25,3,3,CCCGAATCCACCGTCTCTCG,0,1312491
furpa,0.25,3,3,CCCCTGATCATGGACAGATG,0,1318821
furpa,0.25,3,3,CCCCGTATTTACCCTAGAAG,0,1283954
furpa,0.25,3,3,CCCCCGGTGTGGGGTCATTG,0,1351505
furpa,0.25,3,3,CCCCCACTGCGGCACATGAC,0,1326656
furpa,0.25,3,3,CCCCAATCCAGCAACCTTAT,0,1290426
furpa,0.25,3,3,CCCATGGAGCTGCTACATGG,0,1315848
furpa,0.25,3,3,CCCAGTCCGATGTCCAACCC,0,1318608
furpa,0.25,3,3,CCCAGGTGGTCCCTGGTACT,0,1287656
furpa,0.25,3,3,CCCAGGTAACATGATTTGAA,0,1337888
furpa,0.25,3,3,CCCAGGCCCAGTTTTTGACC,0,1306876
furpa,0.25,3,3,CCCAGGATACGCGCAGCCTG,0,1298666
furpa,0.25,3,3,CCCAATTCTCCGAGCACGGG,0,1356860
furpa,0.25,3,3,CCCAAGCGTCAGTTTCACTT,0,1310714
furpa,0.25,3,3,CCCAACATACCTGGCGGAGG,0,1298220
furpa,0.25,3,3,CCCAACACTCACTAGAGTCT,0,1302329
furpa,0.25,3,3,CCATTTAGTATAACTCCTGC,0,1297937
furpa,0.25,3,3,CCATTCAAGGACAAAGGCAT,0,1272237
furpa,0.25,3,3,CCATGTGTGGCCGCGGAGGA,0,1352431
furpa,0.25,3,3,CCATGTACGTTTATGTGCGG,0,1341286
furpa,0.25,3,3,CCATGGGAACTCCGTGGAGG,0,1278501
furpa,0.25,3,3,CCATGCAGGAGAGGATACTG,0,1310430
furpa,0.25,3,3,CCATCCGACCGCGATGTTGC,0,1282651
furpa,0.25,3,3,CCATCAGGTAGTCGTACCTC,0,1357072
furpa,0.25,3,3,CCATATGCTCACGTGGCTGT,0,1276235
furpa,0.25,3,3,CCAGTACGGAAGGTGGATGG,0,1345749
furpa,0.25,3,3,CCAGGTAACAAGGTAAGTTC,0,1278867
furpa,0.25,3,3,CCAGGCGAAACGCGGACCAG,0,1285789
furpa,0.25,3,3,CCAGAATAATCTGTTTCGTT,0,1282440
furpa,0.25,3,3,CCACTACACCTCGTTGATTT,0,1280766
furpa,0.25,3,3,CCACGTTCACGGTACGATTC,0,1325390
furpa,0.25,3,3,CCACGAGTATCCCTATGAAC,0,1309634
furpa,0.25,3,3,CCACCGAAGCGTCACAGAAT,0,1276289
furpa,0.25,3,3,CCACCAATATCCGCCATAAC,0,1283264
furpa,0.25,3,3,CCACAAAGACGAAAGGGAGA,0,1353179
furpa,0.25,3,3,CCAATCACGAAGAAGTGCAG,0,1299746
furpa,0.25,3,3,CCAACTTACGTTGGAGCCCT,0,1299112
furpa,0.25,3,3,CCAAACCTTGCATCTAATGC,0,1356579
furpa,0.25,3,3,CCAAAAGTGCCAATGGCTGT,0,1349331
furpa,0.25,3,3,CATTTTGATGTTGCCAGGAA,0,1298815
furpa,0.25,3,3,CATTGGGGGGGAAAAACGGC,0,1339161
furpa,0.25,3,3,CATTCTTTCCGGGATCTAGA,0,1278118
furpa,0.25,3,3,CATTCTAGAGAGAGTCTGTG,0,1332041
furpa,0.25,3,3,CATTCCCCACTAGCCTGAAT,0,1288402
furpa,0.25,3,3,CATTCCACGTTTGAGAGTTT,0,1290480
furpa,0.25,3,3,CATTAGGATGTCGCAGACCA,0,1317847
furpa,0.25,3,3,CATGGTTCCCTATGTTTGGG,0,1282689
furpa,0.25,3,3,CATGGTCCAGTTTCTGTGTA,0,1301640
furpa,0.25,3,3,CATGGCCGGTCCAACATAAG,0,1336586
furpa,0.25,3,3,CATGCGTGACGAGATGACAG,0,1278315
furpa,0.25,3,3,CATCTACTGTTCATTAAGAC,0,1284542
furpa,0.25,3,3,CATCGAACGATCTTTACAGT,0,1295006
furpa,0.25,3,3,CATCCGTAAGAGGGGTATAC,0,1355914
furpa,0.25,3,3,CATCCCTGTGCATAGTGAGA,0,1337896
furpa,0.25,3,3,CATCCCGCCGGGTCGCCTAC,0,1309846
furpa,0.25,3,3,CATCCAGGATGCCAGATGCA,0,1274346
furpa,0.25,3,3,CATATTAGTGAGGGGCAAAC,0,1287889
furpa,0.25,3,3,CATATTAGGCTATCACCTGG,0,1273488
furpa,0.25,3,3,CATATGGGCACTAAATTACG,0,1352445
furpa,0.25,3,3,CATATATTAATTGCGTTAGG,0,1320988
furpa,0.25,3,3,CATAGTAGAAGTAAGGAAGA,0,1339101
furpa,0.25,3,3,CATACTCGTTCCCTCATCCG,0,1321457
furpa,0.25,3,3,CATACGGTTGAACTAAAGAG,0,1317690
furpa,0.25,3,3,CATAAGTATAGCAGAAGTCA,0,1288810
furpa,0.25,3,3,CAGTTTCCAGCTAGCGATTT,0,1312425
furpa,0.25,3,3,CAGTTGGCTCGGAGCCCCAT,0,1324412
furpa,0.25,3,3,CAGTTGGCCTCCAGTAAAAC,0,1334429
furpa,0.25,3,3,CAGTGGCCAGAAATAGGAGT,0,1354518
furpa,0.25,3,3,CAGTCGCCGGTAAACCCAAT,0,1328911
furpa,0.25,3,3,CAGTCGCCATGGGCGATGTA,0,1279282
furpa,0.25,3,3,CAGTCCCGTACGGAGGATCG,0,1299232
furpa,0.25,3,3,CAGTCCACATAAATGACGCA,0,1286863
furpa,0.25,3,3,CAGTAGGGTTACCTTTATCT,0,1335409
furpa,0.25,3,3,CAGTAGAGCCTAGGACGCGC,0,1282669
furpa,0.25,3,3,CAGGTTTGACCCCCCACTAT,0,1352801
furpa,0.25,3,3,CAGGTTGGATAATACATCAC,0,1274200
furpa,0.25,3,3,CAGGTTCCCTGGACTCGAAG,0,1339790
furpa,0.25,3,3,CAGGTGAACTCTTAATGGTA,0,1276999
furpa,0.25,3,3,CAGGGTCCCGCCATCGGCTA,0,1305421
furpa,0.25,3,3,CAGGGGGAAGCCAAAATGTA,0,1329153
furpa,0.25,3,3,CAGGGCCAAAAACCTCGCTA,0,1330903
furpa,0.25,3,3,CAGGGACACGATACAGTCGT,0,1287800
furpa,0.25,3,3,CAGGCTATCCTTATCGGCAG,0,1287344
furpa,0.25,3,3,CAGGCGCATGATGTGGGATG,0,1343346
furpa,0.25,3,3,CAGGCAATGGGGTTCCCTAG,0,1281734
furpa,0.25,3,3,CAGGAGGGGGCGCCCGGGAC,0,1356239
furpa,0.25,3,3,CAGGAATGAAGAGGCCCCTA,0,1293717
furpa,0.25,3,3,CAGCTTTAATGCTCTGTGAT,0,1338349
furpa,0.25,3,3,CAGCTCATCGCGAACGGGGG,0,1274473
furpa,0.25,3,3,CAGCTAGTCATCGGATATTG,0,1302002
furpa,0.25,3,3,CAGCGTATAGGAATCTCTCA,0,1319302
furpa,0.25,3,3,CAGCCGGTGCTGACGCGGTG,0,1342644
furpa,0.25,3,3,CAGCCCTTAGATGATTATTC,0,1343740
furpa,0.25,3,3,CAGCCATAATGCCCTTTCGA,0,1328330
furpa,0.25,3,3,CAGATTACTAGAGGCGACTT,0,1323569
furpa,0.25,3,3,CAGATTACGATGCGGAGGAC,0,1317984
furpa,0.25,3,3,CAGAGTACACAAAAACGACG,0,1343008
furpa,0.25,3,3,CAGAGCCAGTCCGTGATGAG,0,1356288
furpa,0.25,3,3,CAGAGACTTTTTCTGTGTAG,0,1309488
furpa,0.25,3,3,CAGACCCACGTCCCATTGAA,0,1299984
furpa,0.25,3,3,CAGACACTCGCCGGACCATG,0,1318290
furpa,0.25,3,3,CAGAATAAGGAGCTCATCGA,0,1352392
furpa,0.25,3,3,CAGAAGGAGTTATGTCCTTT,0,1355127
furpa,0.25,3,3,CAGAACTGAACTTTGATGAG,0,1281667
furpa,0.25,3,3,CAGAACTAGACCGCGTCCCA,0,1331078
furpa,0.25,3,3,CACTTCTTAATTCTGACCAA,0,1286856
furpa,0.25,3,3,CACTGGGAATGGCAAGTTTA,0,1335514
furpa,0.25,3,3,CACTGCACAAGAACACAGAT,0,1273550
furpa,0.25,3,3,CACTCCTTCCGAGCGTCGTT,0,1279079
furpa,0.25,3,3,CACTACAGCACTGCTTAGAA,0,1353479
furpa,0.25,3,3,CACGTTGTTCGCGACTCAAT,0,1276904
furpa,0.25,3,3,CACGGTCGTGAAGTGTGGCA,0,1320566
furpa,0.25,3,3,CACGGTATATTTGTTCGCTG,0,1287337
furpa,0.25,3,3,CACGGCGGTACGTAATAACA,0,1326808
furpa,0.25,3,3,CACGAGTAGGCACCCCTCCA,0,1349195
furpa,0.25,3,3,CACGACAACTAAGGCGCAAG,0,1340394
furpa,0.25,3,3,CACCTTGCGGAGTGTTATCC,0,1340780
furpa,0.25,3,3,CACCTGCAGTTTCGCGAGCT,0,1322334
furpa,0.25,3,3,CACCTAGACCTCAGCTCCTC,0,1273678
furpa,0.25,3,3,CACCATTGTCCAGTGGACCA,0,1327912
furpa,0.25,3,3,CACAGTACCTTAACAAAGCA,0,1275309
furpa,0.25,3,3,CACAGTAAGGTCGCGCCCCT,0,1305576
furpa,0.25,3,3,CACAGGGGAACCGTGGGTAG,0,1336463
furpa,0.25,3,3,CACAGGGATAACGCGCGGAT,0,1303846
furpa,0.25,3,3,CACAGCGGGCTTGGAACTGA,0,1315201
furpa,0.25,3,3,CACACGTCTTGCGACAGAAG,0,1317111
furpa,0.25,3,3,CACACCCACAGGCATGATTC,0,1321743
furpa,0.25,3,3,CACACCAGCCGAGGTACATG,0,1307115
furpa,0.25,3,3,CACAAAGGTCATGCTTACTA,0,1301968
furpa,0.25,3,3,CACAAACAGTTATGGTTAAT,0,1307340
furpa,0.25,3,3,CAATTTCGCAACGGATCAGT,0,1326710
furpa,0.25,3,3,CAATTGCTCTTCCGATTTGG,0,1272195
furpa,0.25,3,3,CAATGGCCAAGAGACTCGAA,0,1278007
furpa,0.25,3,3,CAATGGAATCGAGCATGTAT,0,1305742
furpa,0.25,3,3,CAATGCATTGCGCCCTATGT,0,1356797
furpa,0.25,3,3,CAATGATGGTATCAGCTCGA,0,1292160
furpa,0.25,3,3,CAATCTAGCGTCTTTTTTAT,0,1324400
furpa,0.25,3,3,CAATCCCATAAGCTCTCTTG,0,1287211
furpa,0.25,3,3,CAATATGGCTAGGCTGATAG,0,1304807
furpa,0.25,3,3,CAATAATGAGTACCTATCGC,0,1314463
furpa,0.25,3,3,CAAGTCTTTAATAGCCGGGA,0,1348058
furpa,0.25,3,3,CAAGTCAGTTGACAAAAATA,0,1277870
furpa,0.25,3,3,CAAGTATTGTTGCCCAGTCT,0,1275782
furpa,0.25,3,3,CAAGTATGTACGGCGTTAGT,0,1348047
furpa,0.25,3,3,CAAGGGTCCCAGGGCGGGTT,0,1314474
furpa,0.25,3,3,CAAGGATTCTTGTCATGCTA,0,1297664
furpa,0.25,3,3,CAAGACTCCCTTCAGTAGAT,0,1280462
furpa,0.25,3,3,CAAGACGGTGGCAGGGGCGC,0,1328757
furpa,0.25,3,3,CAACTTTGTGCATGGCGAAA,0,1290268
furpa,0.25,3,3,CAACTGTCGCACGGGAGCTA,0,1317519
furpa,0.25,3,3,CAACGGGTGGGCTGTCTAAA,0,1346562
furpa,0.25,3,3,CAACAGAGCTTTATGCTTGT,0,1318596
furpa,0.25,3,3,CAAATGATACGTGTTTGGCC,0,1282109
furpa,0.25,3,3,CAAAGAAGCGCAGGGATCAT,0,1351303
furpa,0.25,3,3,CAAACTTTGTGCCCATTCCT,0,1280364
furpa,0.25,3,3,CAAACGGGCCACTGGAGGCT,0,1278700
furpa,0.25,3,3,CAAACCGTGCCCACGCAGAT,0,1353003
furpa,0.25,3,3,CAAACAGGGCCTGTCATATG,0,1274157
furpa,0.25,3,3,CAAAATCACTCTTGGTGTGG,0,1278420
furpa,0.25,3,3,CAAAAGGCGGAATGCTTGGT,0,1286849
furpa,0.25,3,3,ATTTTTGATCTGTTCGGGAG,0,1282369
furpa,0.25,3,3,ATTTTTGAGGCTATTGGAGA,0,1318913
furpa,0.25,3,3,ATTTTTCAACATTGCTTTGA,0,1278969
furpa,0.25,3,3,ATTTTGTTTCCGTCGGCCCG,0,1281722
furpa,0.25,3,3,ATTTTGTTGGGGGGGCCATG,0,1286641
furpa,0.25,3,3,ATTTTATCGCGGGTTCGCCT,0,1305389
furpa,0.25,3,3,ATTTTAACAATATCGGGCTG,0,1283369
furpa,0.25,3,3,ATTTGTGGTCCGTGCATGTA,0,1328795
furpa,0.25,3,3,ATTTGATTTTGCGTTCTCGC,0,1275920
furpa,0.25,3,3,ATTTCATAGGGGAAATGAAA,0,1272525
furpa,0.25,3,3,ATTTATAACGTAAGGACCTA,0,1355673
furpa,0.25,3,3,ATTTAGATTCAGACAATTAA,0,1344135
furpa,0.25,3,3,ATTTACTTTGCTATCTGGGT,0,1354449
furpa,0.25,3,3,ATTTACTTCCGGAATGCACT,0,1320833
furpa,0.25,3,3,ATTGGGGAACTAGCCTGCAG,0,1294435
furpa,0.25,3,3,ATTGGACGTTGTCACATCTT,0,1284072
furpa,0.25,3,3,ATTGCTTAGTCAATACAGTT,0,1310086
furpa,0.25,3,3,ATTGACGCACCAGCGGGGAA,0,1333678
furpa,0.25,3,3,ATTCTGGTAGCAACGGGTTA,0,1293565
furpa,0.25,3,3,ATTCTCTACGCACCCAGCAG,0,1321656
furpa,0.25,3,3,ATTCGTGGGGCAAAATCCCA,0,1291938
furpa,0.25,3,3,ATTCGTGCAGAAAATTCAGA,0,1350369
furpa,0.25,3,3,ATTCGGGGCATTTTGTAGCG,0,1297946
furpa,0.25,3,3,ATTCGAGTGAATCCTTGGTC,0,1333520
furpa,0.25,3,3,ATTCCTGTTTTAGTTGTATA,0,1305647
furpa,0.25,3,3,ATTATTGACGCATATTGTTT,0,1319654
furpa,0.25,3,3,ATTATAGAAAAGCATTCTTG,0,1310446
furpa,0.25,3,3,ATTATACACCTATTAGTGCT,0,1329057
furpa,0.25,3,3,ATTACGTATAGCGTGTGTTT,0,1287153
furpa,0.25,3,3,ATTACGGGTTGAATCTAATT,0,1311405
furpa,0.25,3,3,ATTACGGAAGAATATTTTGA,0,1291414
furpa,0.25,3,3,ATTACGCGTCGTAATACAGA,0,1286304
furpa,0.25,3,3,ATTACCACTCGATAGGGCTC,0,1311273
furpa,0.25,3,3,ATTACACATAACACCGGATT,0,1301527
furpa,0.25,3,3,ATTAAGTCTTCCGACAGTGT,0,1327986
furpa,0.25,3,3,ATTAACTAAAAAAGCTCGGT,0,1323771
furpa,0.25,3,3,ATGTGGGCTGTACGGCGTCT,0,1312469
furpa,0.25,3,3,ATGTCTGCAATAGGGCCGGT,0,1306042
furpa,0.25,3,3,ATGTCTATGTTTGACACGGC,0,1293277
furpa,0.25,3,3,ATGTATCTTAATTTGGCAAG,0,1305590
furpa,0.25,3,3,ATGTAGAGCAGCCGCCTCAG,0,1343928
furpa,0.25,3,3,ATGGTGTAACTACCCCCCCA,0,1348718
furpa,0.25,3,3,ATGGGTTTCCCGGGCCATAG,0,1329727
furpa,0.25,3,3,ATGGCGTACGCACACTCGGA,0,1301166
furpa,0.25,3,3,ATGGCGAATCAACTGTATCC,0,1317827
furpa,0.25,3,3,ATGGCACGGGCCGTTGGGAT,0,1344585
furpa,0.25,3,3,ATGGCAAGCGACGAAGGGAG,0,1314215
furpa,0.25,3,3,ATGGAATGATGCAGATGATG,0,1301946
furpa,0.25,3,3,ATGGAAGAAAGTTAGATGAG,0,1301033
furpa,0.25,3,3,ATGCTTAGTTCGAGATGTGT,0,1282529
furpa,0.25,3,3,ATGCTTAGACCAGCTTAGCG,0,1332797
furpa,0.25,3,3,ATGCTCATTCCAGGGAGGTC,0,1296896
furpa,0.25,3,3,ATGCGTTGCTTCTCCTATGA,0,1294633
furpa,0.25,3,3,ATGCGCCGCGACGCACTGAG,0,1301161
furpa,0.25,3,3,ATGCATATGTCCAGGAAGGC,0,1293979
furpa,0.25,3,3,ATGCATATGAGCCGGGTTCT,0,1293160
furpa,0.25,3,3,ATGATTCCAGGCACAGTGCG,0,1350649
furpa,0.25,3,3,ATGATGGATGCTGTCGGATA,0,1289841
furpa,0.25,3,3,ATGAGGTGGCCAAAACATTT,0,1334184
furpa,0.25,3,3,ATGAAGCCGGGTCCGTGCTG,0,1311561
furpa,0.25,3,3,ATGAAAGTAACCAGTTTTTA,0,1299562
furpa,0.25,3,3,ATCTTTAATTCGAAACTTAA,0,1353546
furpa,0.25,3,3,ATCTGGTACTACGACACGTT,0,1305565
furpa,0.25,3,3,ATCTGCGTCTTTTTTAGTAT,0,1302591
furpa,0.25,3,3,ATCTCGTATCGTACCTGATA,0,1301583
furpa,0.25,3,3,ATCTAGTTGTAGAAGTTGCG,0,1327724
furpa,0.25,3,3,ATCGTTTCCTTTCACTCGGT,0,1347340
furpa,0.25,3,3,ATCGTGCTAGGGGCACCCAC,0,1306992
furpa,0.25,3,3,ATCGCTGAAAATGGATCAAA,0,1294706
furpa,0.25,3,3,ATCGCTCTCTCAAGGCAAAG,0,1288714
furpa,0.25,3,3,ATCGAGCTTGGCACCCGTTG,0,1327126
furpa,0.25,3,3,ATCCTGGGCCGACTATCGTA,0,1307509
furpa,0.25,3,3,ATCCTCATCGGCCATTAGCT,0,1326669
furpa,0.25,3,3,ATCCTCAAGATATGCCCTCA,0,1283158
furpa,0.25,3,3,ATCCGCATAGGGAAGCATCA,0,1299638
furpa,0.25,3,3,ATCCACGTTTCAAGTGCAAG,0,1320989
furpa,0.25,3,3,ATCATATCTGGCGTTTTCCA,0,1314968
furpa,0.25,3,3,ATCACTACATATGTGGTCTA,0,1281594
furpa,0.25,3,3,ATCACCTGGAGGTTGCTGTG,0,1316758
furpa,0.25,3,3,ATCACCTGACGGATACGCGA,0,1350446
furpa,0.25,3,3,ATCACAAAGGATAAGTACTC,0,1315981
furpa,0.25,3,3,ATCAATCAGTGACTATGATC,0,1284200
furpa,0.25,3,3,ATCAACGAGCCTCGTATGAG,0,1297189
furpa,0.25,3,3,ATCAAAAACGGTGGAGTGGA,0,1330128
furpa,0.25,3,3,ATATGCCTGGTCGTATGTCA,0,1294142
furpa,0.25,3,3,ATATGCATTAAACAACTTGA,0,1288744
furpa,0.25,3,3,ATATCACCGCATAGGAAGAG,0,1309200
furpa,0.25,3,3,ATATATCCAAGGCAGAGGTT,0,1292118
furpa,0.25,3,3,ATAGTATTAAATCATACTTG,0,1296911
furpa,0.25,3,3,ATAGTAGCCGGCGTTGGGTC,0,1318298
furpa,0.25,3,3,ATAGGCCACCGCTGGTGTTA,0,1298949
furpa,0.25,3,3,ATAGGCAAACGAAAATCAGC,0,1308547
furpa,0.25,3,3,ATAGGACGATCCCTCACTCG,0,1344629
furpa,0.25,3,3,ATAGCATTCACGCGCGAGTT,0,1305524
furpa,0.25,3,3,ATAGATGTGCAGGTAACGCT,0,1321149
furpa,0.25,3,3,ATACTTCACTGGCATGATAT,0,1272186
furpa,0.25,3,3,ATACTGGGCCGTAGCAGACT,0,1285019
furpa,0.25,3,3,ATACTGGACACACAAAATTT,0,1297956
furpa,0.25,3,3,ATACGAGACTCGCAGAGAGA,0,1297224
furpa,0.25,3,3,ATACCTTGTACACTCGCATT,0,1332260
furpa,0.25,3,3,ATACCAAGAAGCGCTCACCC,0,1341606
furpa,0.25,3,3,ATACACCCCACATAACTGCG,0,1354387
furpa,0.25,3,3,ATAATAGCAAAGTCATACTA,0,1352544
furpa,0.25,3,3,ATAACAGACCCGCTAGCTTG,0,1284268
furpa,0.25,3,3,ATAAAATTTCGCGCCGCCCG,0,1356450
furpa,0.25,3,3,AGTTTTGATGCTAGCATGGA,0,1344209
furpa,0.25,3,3,AGTTTCCAATAATCGTCACA,0,1348832
furpa,0.25,3,3,AGTTTAACACGATCATCTCT,0,1348215
furpa,0.25,3,3,AGTTGTAGTTGTGTGATCGC,0,1325303
furpa,0.25,3,3,AGTTCTTCAAGACCATCGGT,0,1333466
furpa,0.25,3,3,AGTTCATCCGGAAGCGGTTA,0,1344165
furpa,0.25,3,3,AGTTACGCAAAATGCTCGTA,0,1296545
furpa,0.25,3,3,AGTTAAATTTTGGTGCGATT,0,1340115
furpa,0.25,3,3,AGTGTTCGAATGAACGAAGT,0,1306409
furpa,0.25,3,3,AGTGTATAGTGGTAGCCATC,0,1313877
furpa,0.25,3,3,AGTGGTGAACAAAACTTCAG,0,1309794
furpa,0.25,3,3,AGTGGTCTAGCTCAGAGGGA,0,1353022
furpa,0.25,3,3,AGTGCCGGTTCCTCATAACG,0,1352336
furpa,0.25,3,3,AGTGATATTGTGGAGGCCAT,0,1308751
furpa,0.25,3,3,AGTGAGCAATTCCACTCCAG,0,1331206
furpa,0.25,3,3,AGTGACATCAGGGATCGTAA,0,1341278
furpa,0.25,3,3,AGTGAAGATCGAGGTATGAA,0,1276990
furpa,0.25,3,3,AGTCTTTGCCTTATCTGGGA,0,1320775
furpa,0.25,3,3,AGTCGGGAAATGAAACCAAT,0,1353372
furpa,0.25,3,3,AGTCGATGGGACCTTGAAGG,0,1273268
furpa,0.25,3,3,AGTCCGCGGGGATTGATAGG,0,1318742
furpa,0.25,3,3,AGTCATTACCCAACGAAATG,0,1294932
furpa,0.25,3,3,AGTCAGTGACACGCGAGTGG,0,1308134
furpa,0.25,3,3,AGTCAAAAAATATCTTCGAG,0,1343414
furpa,0.25,3,3,AGTATCCGACTAGGCCACGA,0,1271482
furpa,0.25,3,3,AGTAGTCACCAGTTTACAAT,0,1327611
furpa,0.25,3,3,AGTAGGTGCGTCCCCTGGAT,0,1280603
furpa,0.25,3,3,AGTACAAGTGTCAGAGGATC,0,1317369
furpa,0.25,3,3,AGTAACTCCTATATCTGAAG,0,1277987
furpa,0.25,3,3,AGGTTTGAATCGCGCCGTTA,0,1346552
furpa,0.25,3,3,AGGTTTCATGATTGCTCGGT,0,1334126
furpa,0.25,3,3,AGGTTGTTAAAAAGGCTAAA,0,1315928
furpa,0.25,3,3,AGGTTGGCGTGAGGTCTCTA,0,1333745
furpa,0.25,3,3,AGGTTACCTCTCCGCCCGTG,0,1342461
furpa,0.25,3,3,AGGTGTCCATTTGCGGCCCT,0,1293247
furpa,0.25,3,3,AGGTCGGAAATCCTTATGGG,0,1333619
furpa,0.25,3,3,AGGTCCTAGCCGGGTACCCC,0,1347720
furpa,0.25,3,3,AGGTAAGGCTTCATTAGATA,0,1279214
furpa,0.25,3,3,AGGTAACGGGCTAGCTAGAC,0,1293709
furpa,0.25,3,3,AGGGTTGACCGGGTTCGTTT,0,1348847
furpa,0.25,3,3,AGGGTCTGGGCAAAATCACG,0,1318132
furpa,0.25,3,3,AGGGTCTGACGTTTTTTAGT,0,1275706
furpa,0.25,3,3,AGGGGACAATTAAGAAGCAG,0,1313176
furpa,0.25,3,3,AGGGCTGCTTGAGAAAATTA,0,1302107
furpa,0.25,3,3,AGGGCGTAAGGGTGTCACGT,0,1304373
furpa,0.25,3,3,AGGGCGGTGCTCACATCAGA,0,1355295
furpa,0.25,3,3,AGGGCCGGAACTGCCTTAGG,0,1345822
furpa,0.25,3,3,AGGGCCACTAGACCGTCTCG,0,1301413
furpa,0.25,3,3,AGGGCACGGTGGAGGACGAT,0,1340189
furpa,0.25,3,3,AGGCGTTTGCTACGTCGTAG,0,1301628
furpa,0.25,3,3,AGGCCAGAACCGTCTAATAT,0,1283378
furpa,0.25,3,3,AGGCACTAAATATACCTTAA,0,1321089
furpa,0.25,3,3,AGGCAAATCGTATTGGGCTT,0,1332558
furpa,0.25,3,3,AGGATTGCTGGGGGGTTTGC,0,1289490
furpa,0.25,3,3,AGGATAGACTCGGTAGGGAC,0,1353060
furpa,0.25,3,3,AGGAGGGCCCTCGCATCTTA,0,1272987
furpa,0.25,3,3,AGGAACGATAATAGCTATTC,0,1298830
furpa,0.25,3,3,AGCTTTCACCTGGAGGGATA,0,1271809
furpa,0.25,3,3,AGCTTGCGCCGCGCACGTCC,0,1298204
furpa,0.25,3,3,AGCTTACGTTCTTATGACCA,0,1283410
furpa,0.25,3,3,AGCTGCTGCAACTTGCTTGT,0,1340274
furpa,0.25,3,3,AGCTGCCTGTATTTTGATTA,0,1291672
furpa,0.25,3,3,AGCTGAGCGTTCAACCCGTA,0,1331269
furpa,0.25,3,3,AGCTATAGGGTCATGCTACC,0,1279643
furpa,0.25,3,3,AGCTACGTAATGGAGGTCAA,0,1299107
furpa,0.25,3,3,AGCGTGACATTGCTGGTGAC,0,1345080
furpa,0.25,3,3,AGCGGTGCGGCTAGATCTAG,0,1274738
furpa,0.25,3,3,AGCGGACCGCAGCACCCAAT,0,1330859
furpa,0.25,3,3,AGCGCGCTTCACCTCGGTTC,0,1298732
furpa,0.25,3,3,AGCGCATTATGGTTATTATG,0,1304495
furpa,0.25,3,3,AGCGCACACTAGATCCCAAA,0,1275375
furpa,0.25,3,3,AGCGATTAGGCCGAGCAGTC,0,1330004
furpa,0.25,3,3,AGCGAGAGCCACACGGGTAT,0,1357211
furpa,0.25,3,3,AGCCTGCAGCCGGCAAGCAA,0,1282200
furpa,0.25,3,3,AGCCGGATTTGAGGCCCATC,0,1316742
furpa,0.25,3,3,AGCCGCGAACAAAGTACCCT,0,1311793
furpa,0.25,3,3,AGCCCTGCGCGCATGGGAAT,0,1279233
furpa,0.25,3,3,AGCCCATGGAGGTGTGCTGA,0,1346724
furpa,0.25,3,3,AGCCAGATCCTATTAGGCAA,0,1354806
furpa,0.25,3,3,AGCCAATTAACCCCTGATTT,0,1287887
furpa,0.25,3,3,AGCATCCCTCACGCCTGCGG,0,1303398
furpa,0.25,3,3,AGCATAGTACTTCGTCCGTC,0,1354098
furpa,0.25,3,3,AGCAGTCATACACGCAAGGC,0,1272806
furpa,0.25,3,3,AGCACTTAAACTCAGCCCGA,0,1324980
furpa,0.25,3,3,AGCACGTGTTACGTAACATA,0,1292456
furpa,0.25,3,3,AGCAATTGTTTACTGAACGT,0,1327055
furpa,0.25,3,3,AGATCTACTAACGCGCCTAA,0,1273681
furpa,0.25,3,3,AGATCGGATCCGGATCGAGA,0,1305116
furpa,0.25,3,3,AGATCCTCGTGTAGTCTTTC,0,1290683
furpa,0.25,3,3,AGATCAGGGTCCGTTGCGGG,0,1295045
furpa,0.25,3,3,AGATATACAAGATCCCAAAA,0,1287785
furpa,0.25,3,3,AGAGTATAAACTAATGCGTT,0,1305396
furpa,0.25,3,3,AGAGGTAACTTAGTATGCCC,0,1307243
furpa,0.25,3,3,AGAGGAGATCCGGCACCGTA,0,1322254
furpa,0.25,3,3,AGAGGAAGCGTGTACCCTGG,0,1324463
furpa,0.25,3,3,AGAGCTCTCGGCCTTGACAC,0,1328930
furpa,0.25,3,3,AGAGCTCCTCTGAAGTTGAC,0,1320154
furpa,0.25,3,3,AGAGATTAGCTCCGGCAGGA,0,1279936
furpa,0.25,3,3,AGAGATGCAGTAGCATAGGA,0,1324948
furpa,0.25,3,3,AGACTGGCGGTATTCGAAAG,0,1356688
furpa,0.25,3,3,AGACTCTCCAGTGGTTAGAT,0,1335394
furpa,0.25,3,3,AGACGTCTCACGGCGTGCGA,0,1350993
furpa,0.25,3,3,AGACGGGTTTACGTAAGCAA,0,1293834
furpa,0.25,3,3,AGACCGGCAATCGGATATGA,0,1326374
furpa,0.25,3,3,AGACCCTCAGTTTAAGTCGT,0,1338278
furpa,0.25,3,3,AGACCCACTGATGTACAGGC,0,1296348
furpa,0.25,3,3,AGACCATAGACAGTCTAGGA,0,1296248
furpa,0.25,3,3,AGAATCAACACTTTTCGAAC,0,1275248
furpa,0.25,3,3,AGAAGATTTATCGGGGGCTT,0,1341502
furpa,0.25,3,3,AGAAGAGCACCGAGCCATTC,0,1302772
furpa,0.25,3,3,AGAAATTTAAGAATTACTAC,0,1340063
furpa,0.25,3,3,AGAAATCGTGTGGCAACTTT,0,1300922
furpa,0.25,3,3,AGAAATAAGTTGATGCCCAT,0,1284794
furpa,0.25,3,3,AGAAAGCTTGTCACGACCTA,0,1282305
furpa,0.25,3,3,ACTTTGTGGTCAAGATCCGT,0,1303645
furpa,0.25,3,3,ACTTTGAAGTGAGCACGCTG,0,1341134
furpa,0.25,3,3,ACTTTCCTTTGCATTTAGTC,0,1325616
furpa,0.25,3,3,ACTTGGTAATTACACTGCCA,0,1316921
furpa,0.25,3,3,ACTTGGCCTACGGAAGCTGG,0,1299678
furpa,0.25,3,3,ACTTGAGCTAGAAACGTCGG,0,1289158
furpa,0.25,3,3,ACTTGACTCAATTGTGGAAC,0,1339409
furpa,0.25,3,3,ACTTCGGCGATCTTAATTGC,0,1334021
furpa,0.25,3,3,ACTGTTGACGCCACAATGTT,0,1303756
furpa,0.25,3,3,ACTGGGTCTTCTAGTGTCCA,0,1321058
furpa,0.25,3,3,ACTGGGTAACAACGTCAGGA,0,1333920
furpa,0.25,3,3,ACTGAGACTTCCCGGGTCCC,0,1294199
furpa,0.25,3,3,ACTGAAGCCTCGATTCAAGA,0,1326745
furpa,0.25,3,3,ACTCTTTAGTAGGTAGGAGC,0,1344968
furpa,0.25,3,3,ACTCGAGCAACCCACGATAA,0,1284988
furpa,0.25,3,3,ACTCCCACCCTACCTCAGCC,0,1305508
furpa,0.25,3,3,ACTCCAGTTTAAAAGGATCG,0,1324798
furpa,0.25,3,3,ACTCCAGACCTACGCGGCAA,0,1340012
furpa,0.25,3,3,ACTCATGGACAAGGGGGTTT,0,1308657
furpa,0.25,3,3,ACTCAAGTGGAGCTTTGGAG,0,1328825
furpa,0.25,3,3,ACTATCATCAGATCGCACTA,0,1309471
furpa,0.25,3,3,ACTAGCGTTCCGCGGCGGGC,0,1287514
furpa,0.25,3,3,ACTAGATACCCGGTACTAAG,0,1347769
furpa,0.25,3,3,ACTACTACAAAGTGACTATT,0,1329216
furpa,0.25,3,3,ACTACAACGGATGCACAATT,0,1302529
furpa,0.25,3,3,ACGTTTGGGCACCTTCAATA,0,1276847
furpa,0.25,3,3,ACGTTGGCCACTACTTATTG,0,1272208
furpa,0.25,3,3,ACGTTATACGCAGAGATAGG,0,1300405
furpa,0.25,3,3,ACGTGACGTACACTTGTTAG,0,1315655
furpa,0.25,3,3,ACGTCTTACTGGACCGTCTA,0,1338542
furpa,0.25,3,3,ACGTCGTTAAATCGGTCTTC,0,1357446
furpa,0.25,3,3,ACGTAGTATGATAGCAGCGA,0,1319918
furpa,0.25,3,3,ACGTAGGACGCTACCTCTTG,0,1350430
furpa,0.25,3,3,ACGTAATTGCCTCCAGCACA,0,1316752
furpa,0.25,3,3,ACGTAATCCATTGCGCTTCA,0,1302935
furpa,0.25,3,3,ACGGGACAGGGAAACACTGT,0,1277623
furpa,0.25,3,3,ACGGAGAGAGTCGCGGGCGA,0,1327121
furpa,0.25,3,3,ACGCTGCACATTGTTATAAC,0,1318466
furpa,0.25,3,3,ACGCCGGCGGTCCATCGGAC,0,1311647
furpa,0.25,3,3,ACGCATTAGTGGGCAGAACC,0,1327460
furpa,0.25,3,3,ACGATCCAGGCCGGCGAAGT,0,1288824
furpa,0.25,3,3,ACGATAGTGAGGGGTTGCTC,0,1278707
furpa,0.25,3,3,ACGAGTTGGGTTTGAAGCTG,0,1352095
furpa,0.25,3,3,ACGAGGTACGGACTGGCGGG,0,1347612
furpa,0.25,3,3,ACGAGGCGCTGGTTTGTAGG,0,1294937
furpa,0.25,3,3,ACGACTGTGCATTAAGTAAT,0,1320273
furpa,0.25,3,3,ACGACGGTGGCTGACCTATT,0,1328459
furpa,0.25,3,3,ACGACGACGTGGAGTTTGAA,0,1286989
furpa,0.25,3,3,ACCTTTGTACTGGTCACATA,0,1298580
furpa,0.25,3,3,ACCTTTAATTTTCTGCAGGC,0,1353598
furpa,0.25,3,3,ACCTCTAAAAGTAGTCAAGA,0,1342947
furpa,0.25,3,3,ACCTCGTCCCCACCGTGACA,0,1292007
furpa,0.25,3,3,ACCTCAGGCGGTCCCAGCAT,0,1297252
furpa,0.25,3,3,ACCTAGTCACGAGACAAACG,0,1305965
furpa,0.25,3,3,ACCTAGATGTAACACGTTAA,0,1295623
furpa,0.25,3,3,ACCGTCTCAATGAGGAATCT,0,1355300
furpa,0.25,3,3,ACCGGGGCAAACAGGAAAGT,0,1336918
furpa,0.25,3,3,ACCGCTACAGCAGGGTGGGC,0,1314110
furpa,0.25,3,3,ACCGCGTTACTACAGCATAA,0,1332965
furpa,0.25,3,3,ACCGCGGGCCATGAATGCCT,0,1277715
furpa,0.25,3,3,ACCGCCCGTTCTATATCGCG,0,1291865
furpa,0.25,3,3,ACCGAAGGAAAACGCTCGGC,0,1331010
furpa,0.25,3,3,ACCCAGACGCGCGCGTTTAC,0,1335281
furpa,0.25,3,3,ACCCACTCATATTGGCATTT,0,1347775
furpa,0.25,3,3,ACCATTCTAAGGGGAGTTAA,0,1303241
furpa,0.25,3,3,ACCATGGCCGCGGCATTATA,0,1300208
furpa,0.25,3,3,ACCATATCTCAGTGGCCAAG,0,1271537
furpa,0.25,3,3,ACCAGGACAGTGTAACGAGT,0,1343171
furpa,0.25,3,3,ACCAGAATAAGAAGGAGTGT,0,1278555
furpa,0.25,3,3,ACCACGGTCAACGGGCCTAC,0,1350018
furpa,0.25,3,3,ACCACGCTCTGTAGGTGCAT,0,1353606
furpa,0.25,3,3,ACCACAGAATTGATGTGAGC,0,1279390
furpa,0.25,3,3,ACCAATAATTTCTTAATGAT,0,1322846
furpa,0.25,3,3,ACATTTTGTCCAGCCATCAT,0,1312087
furpa,0.25,3,3,ACATTGGATTTTGCATTTGT,0,1341743
furpa,0.25,3,3,ACATGTGCGGTGAGTAGTGG,0,1328725
furpa,0.25,3,3,ACATGGGCGAAATCTTCTTC,0,1285829
furpa,0.25,3,3,ACATGCTAGTTAAGGCGCGT,0,1321934
furpa,0.25,3,3,ACATAGATGCGGACTACGAC,0,1313814
furpa,0.25,3,3,ACATAATGTCGTACTATCAA,0,1329861
furpa,0.25,3,3,ACAGTGTATAACGATTAAAA,0,1292202
furpa,0.25,3,3,ACAGTGCCCAAATCCAAGTT,0,1319914
furpa,0.25,3,3,ACAGTAAGGTCGTGCGCATT,0,1277414
furpa,0.25,3,3,ACAGGCTGGCAAACAGGAGC,0,1318129
furpa,0.25,3,3,ACAGACCGCTCAATAGTGCT,0,1347986
furpa,0.25,3,3,ACACGGGTTTCGTACCAGGT,0,1278049
furpa,0.25,3,3,ACACCGTGTTGACGTTCTAG,0,1347892
furpa,0.25,3,3,ACACAGGAGGGACACTGACA,0,1344917
furpa,0.25,3,3,ACACACATGAGAGTGCAAAG,0,1297277
furpa,0.25,3,3,ACAATTAAGAAGTCGCTCTG,0,1327980
furpa,0.25,3,3,ACAAGGTTTACTAGGCTGGA,0,1298833
furpa,0.25,3,3,ACAAGGTGCCCGTTTGAGAT,0,1356186
furpa,0.25,3,3,ACAAGCATACTTGTATAGAG,0,1316104
furpa,0.25,3,3,ACAAGATAGAAGTTGTTTTA,0,1315118
furpa,0.25,3,3,ACAAAGGGTGATCTTCAGAG,0,1318587
furpa,0.25,3,3,AATTTCATATTAGATGCCTG,0,1276478
furpa,0.25,3,3,AATTGTGGGACGCCTTCTGA,0,1351670
furpa,0.25,3,3,AATTCACATTCAGTCACTTA,0,1350391
furpa,0.25,3,3,AATTATGCGACTCTGTCGGG,0,1345151
furpa,0.25,3,3,AATTAGCCCTTTCTGTCACT,0,1322731
furpa,0.25,3,3,AATGTGTTAGTGGGAGCACA,0,1271202
furpa,0.25,3,3,AATGTCCGGGGTGTGAATGC,0,1289722
furpa,0.25,3,3,AATGCATGGCGGCTCTATCA,0,1339028
furpa,0.25,3,3,AATGATTCTGAGGATCTACA,0,1333666
furpa,0.25,3,3,AATGAGTAAACCCAACCTAT,0,1334779
furpa,0.25,3,3,AATCTTGACATCTATTTGAT,0,1272138
furpa,0.25,3,3,AATCTTACGGCCTGGCTAGT,0,1277864
furpa,0.25,3,3,AATCTCGCGGAGTAAACGCA,0,1313396
furpa,0.25,3,3,AATCTATGGAAGCCCTGCTA,0,1304502
furpa,0.25,3,3,AATCTACCCCGATACTTCCA,0,1304959
furpa,0.25,3,3,AATCGCTAATTCAGGATTCA,0,1340009
furpa,0.25,3,3,AATCGAGGGAACGAGGGTCC,0,1318498
furpa,0.25,3,3,AATCCGGCCAAATAAAACAT,0,1322356
furpa,0.25,3,3,AATCCCGGCATGGTCCTCAT,0,1320589
furpa,0.25,3,3,AATCCACATCAATGCTCCAT,0,1343339
furpa,0.25,3,3,AATCAGGTGACGGCCGAAAA,0,1317311
furpa,0.25,3,3,AATCACGCGAACCAGAAGTA,0,1271819
furpa,0.25,3,3,AATATTGGTGGGTATGACCG,0,1314109
furpa,0.25,3,3,AATAGCACATTCTCATACCT,0,1356995
furpa,0.25,3,3,AATACGACAATCGGATGAGG,0,1340975
furpa,0.25,3,3,AATAAACCGCGGCGCATGGC,0,1341077
furpa,0.25,3,3,AAGTTGTTAAGGGATTTTGT,0,1320051
furpa,0.25,3,3,AAGTTCTTCGGTAGCTGCGT,0,1314756
furpa,0.25,3,3,AAGTTCAGCCGAGAAGGATT,0,1277656
furpa,0.25,3,3,AAGTTAGTGGACCGGTTTTC,0,1286607
furpa,0.25,3,3,AAGTGACCGTTTTACGGTCT,0,1312707
furpa,0.25,3,3,AAGTGAATGTAGGGCGCTTG,0,1344098
furpa,0.25,3,3,AAGTCACCTGCCTCGGGTGC,0,1318926
furpa,0.25,3,3,AAGTCAACAAGAGCGAAAAC,0,1295390
furpa,0.25,3,3,AAGTAGCATCGGGGGCGAAG,0,1335936
furpa,0.25,3,3,AAGTAGAGTGCGGCGACTAA,0,1310208
furpa,0.25,3,3,AAGGTCCAAGGGATGTTAAT,0,1292051
furpa,0.25,3,3,AAGGTAGCTCAAGAACCAGC,0,1293119
furpa,0.25,3,3,AAGGGCACTCACCTTATGGG,0,1349870
furpa,0.25,3,3,AAGGCTTAAATGAGTTAAAG,0,1274074
furpa,0.25,3,3,AAGGCACCGTCCGTGGATGG,0,1310886
furpa,0.25,3,3,AAGGATAATTGTCAAGTCTA,0,1309172
furpa,0.25,3,3,AAGGAGCTCACGAACTCACG,0,1278644
furpa,0.25,3,3,AAGGAGATGCACAATGGTCT,0,1291846
furpa,0.25,3,3,AAGGACTCACGATGTCGGGT,0,1296094
furpa,0.25,3,3,AAGCGGCTCGTCGCCAGTTG,0,1351526
furpa,0.25,3,3,AAGCGCAACCGGGACACTTA,0,1307407
furpa,0.25,3,3,AAGCGATCGGTGGTTCCCGC,0,1347867
furpa,0.25,3,3,AAGCCATATCATGGCAATTA,0,1335126
furpa,0.25,3,3,AAGCACGCAATAGGAACCGA,0,1319244
furpa,0.25,3,3,AAGCACGATGTATCTCGGCG,0,1303382
furpa,0.25,3,3,AAGCAACCGAGATACGGCTA,0,1282170
furpa,0.25,3,3,AAGATGGCTTAACGAGGAAC,0,1329559
furpa,0.25,3,3,AAGAGTCAAAATTTTGGCAA,0,1283076
furpa,0.25,3,3,AAGAGCGGTACTGATGTCCT,0,1290212
furpa,0.25,3,3,AAGACTGTAGTGCCCAACTA,0,1354577
furpa,0.25,3,3,AAGACGGAGATACACCATAA,0,1350323
furpa,0.25,3,3,AAGACGATCGCTACTAGAAA,0,1339915
furpa,0.25,3,3,AAGACACTTACCCTACCACT,0,1292669
furpa,0.25,3,3,AAGAATACGAACAGTCAAAA,0,1340723
furpa,0.25,3,3,AACTGGTACTGTTGGAACGA,0,1285198
furpa,0.25,3,3,AACTCGCGTCATCACACGGA,0,1294614
furpa,0.25,3,3,AACTCATCACTGCTTGATAC,0,1318799
furpa,0.25,3,3,AACGTAACGCCTCGGACGGC,0,1336886
furpa,0.25,3,3,AACGGGAGAGTTCGCATAGG,0,1295572
furpa,0.25,3,3,AACGGAATATCTCGGGGAAG,0,1323761
furpa,0.25,3,3,AACGCTATGGCGGTTCTGAA,0,1286034
furpa,0.25,3,3,AACGCGCCACCAGTAGATAT,0,1340143
furpa,0.25,3,3,AACGCATTCGCGCCGCCGGA,0,1353702
furpa,0.25,3,3,AACGATTATATGGCTGGCTA,0,1324683
furpa,0.25,3,3,AACGAATCACCAGGTGACTT,0,1354062
furpa,0.25,3,3,AACCTCGGAATGGTTGGGGT,0,1323287
furpa,0.25,3,3,AACCGATTGGGTTCGTGTAT,0,1318420
furpa,0.25,3,3,AACCAGCAGGATTGCATGTG,0,1302288
furpa,0.25,3,3,AACATTATCAGGACATCCCC,0,1292904
furpa,0.25,3,3,AACACTTCAAAATACTCGTT,0,1350593
furpa,0.25,3,3,AACACCCTCCCCGGCCCTAA,0,1312830
furpa,0.25,3,3,AACAATAACTCAGTATCCCA,0,1349872
furpa,0.25,3,3,AACAAGTAATCCGTGGTTGT,0,1354388
furpa,0.25,3,3,AACAACTTTCGCCGAGCATG,0,1336894
furpa,0.25,3,3,AAATTTATAGGCGGTTGTGC,0,1319858
furpa,0.25,3,3,AAATGCAGACAGGAGGCTTA,0,1303134
furpa,0.25,3,3,AAATGAATCGAAAGCTCTCA,0,1319829
furpa,0.25,3,3,AAAGGTAATGTTTGGTAGCG,0,1294456
furpa,0.25,3,3,AAAGGCTCGAACTCCTTGCT,0,1313811
furpa,0.25,3,3,AAAGCAATCAGTCGTGCTCG,0,1330964
furpa,0.25,3,3,AAACAGTAGGAGACCTTTGG,0,1310226
furpa,0.25,3,3,AAAAGTAACAAAAACATTAC,0,1325662
furpa,0.25,3,3,AAAAGGGAGTTCAAACGCGA,0,1290888
furpa,0.25,3,3,AAAAGCGTTTTATATATCCT,0,1343512
furpa,0.25,3,3,AAAACGATACGCGAGGGAAG,0,1283172
furpa,0.25,3,3,AAAACAAGGACTGACATTAA,0,1281726
furpa,0.25,3,3,AAAAAGGGTCGTCCCCGGAC,0,1293281
furpa,0.25,3,3,AAAAAGGACGGTATCTTAGG,0,1326188
furpa,0.3333333333333333,2,2,TTTTTTTGGGTGCGCCCGTA,0,1315030
furpa,0.3333333333333333,2,2,TTTTTGTGCCGTGACCTTGG,0,1325717
furpa,0.3333333333333333,2,2,TTTTTCGATAGAATGTCAGA,0,1352088
furpa,0.3333333333333333,2,2,TTTTTAGCCGTTTAAAGGAC,0,1311290
furpa,0.3333333333333333,2,2,TTTTGGAGAGCTGCGTTATT,0,1354689
furpa,0.3333333333333333,2,2,TTTTCGCCAGAACGAAAGAG,0,1296967
furpa,0.3333333333333333,2,2,TTTTATATACCTCGCCCATG,0,1307254
furpa,0.3333333333333333,2,2,TTTTATAGTACTTGGGCTAT,0,1350462
furpa,0.3333333333333333,2,2,TTTTACTTTATTAGGGGTAC,0,1284776
furpa,0.3333333333333333,2,2,TTTGGCACACTTGCGGAAAG,0,1286413
furpa,0.3333333333333333,2,2,TTTGGAGTATTCTTCTGTAT,0,1284798
furpa,0.3333333333333333,2,2,TTTGGAACTGAGGCAAGACA,0,1320696
furpa,0.3333333333333333,2,2,TTTGCAATGCATCGAAAATA,0,1273026
furpa,0.3333333333333333,2,2,TTTGACCGCTCTTACGGTAG,0,1289529
furpa,0.3333333333333333,2,2,TTTGACAGAAGCGGTATCAC,0,1346455
furpa,0.3333333333333333,2,2,TTTGAAATTGTAGATACCAC,0,1284284
furpa,0.3333333333333333,2,2,TTTCGGGGTGCGGAATCAAA,0,1314210
furpa,0.3333333333333333,2,2,TTTCGGCACCAAGAGAGCCG,0,1307870
furpa,0.3333333333333333,2,2,TTTCGCCGGTCAGAGTTCAT,0,1338537
furpa,0.3333333333333333,2,2,TTTCCGATATACATTTATTC,0,1354451
furpa,0.3333333333333333,2,2,TTTCCAGTCCGTTGCTTACC,0,1346080
furpa,0.3333333333333333,2,2,TTTCCACGACTTTCAAGTGT,0,1301004
furpa,0.3333333333333333,2,2,TTTCAGGTGCGAATAGCGCA,0,1276755
furpa,0.3333333333333333,2,2,TTTCAGGCGGTGGGGGGGCG,0,1342636
furpa,0.3333333333333333,2,2,TTTATCGTTCCTACGCATTA,0,1353507
furpa,0.3333333333333333,2,2,TTTACTCTACGTATTCGAAC,0,1331517
furpa,0.3333333333333333,2,2,TTGTTTTCCCTAACCAGGTA,0,1335171
furpa,0.3333333333333333,2,2,TTGTTAGTTAGCTAATTCGA,0,1346738
furpa,0.3333333333333333,2,2,TTGTGACCAGATAGGGCGTG,0,1304388
furpa,0.3333333333333333,2,2,TTGTATAAGTCAACAGATTG,0,1304186
furpa,0.3333333333333333,2,2,TTGGTGCGGAACCTAACCGG,0,1323242
furpa,0.3333333333333333,2,2,TTGGTGAAAAATTGTCTCGT,0,1341952
furpa,0.3333333333333333,2,2,TTGGTCTTGCTACGTGGCCA,0,1353427
furpa,0.3333333333333333,2,2,TTGGTCCCGCCACGTCGGCC,0,1350185
furpa,0.3333333333333333,2,2,TTGGGTTTCACGAAGTTCCT,0,1277073
furpa,0.3333333333333333,2,2,TTGGGGCACGCAACCCTCAT,0,1331357
furpa,0.3333333333333333,2,2,TTGGCGGCGGGGTCCTAAAC,0,1304981
furpa,0.3333333333333333,2,2,TTGGATGTCTTCATCCAGTG,0,1354730
furpa,0.3333333333333333,2,2,TTGGATCTGATTCAGGCAAC,0,1350335
furpa,0.3333333333333333,2,2,TTGGACCCCCACGCTCGTTC,0,1281396
furpa,0.3333333333333333,2,2,TTGCTAGCGGACAGCAGACA,0,1302843
furpa,0.3333333333333333,2,2,TTGCGTGCCAGCTCTACGTG,0,1316170
furpa,0.3333333333333333,2,2,TTGCGCGTTTCACCCGGTGT,0,1293726
furpa,0.3333333333333333,2,2,TTGCGACGCCGAAAATCAAT,0,1349574
furpa,0.3333333333333333,2,2,TTGCGAATCGTCTAGCTAAA,0,1294598
furpa,0.3333333333333333,2,2,TTGCCTATAGCCGTTCCAAT,0,1322542
furpa,0.3333333333333333,2,2,TTGCCGAGGTTTCGCCTTGT,0,1349582
furpa,0.3333333333333333,2,2,TTGCCATATTATCACCCTTT,0,1335182
furpa,0.3333333333333333,2,2,TTGCCATAGAGTACTATTAT,0,1271208
furpa,0.3333333333333333,2,2,TTGCATGCGGTCACGGGCCT,0,1272775
furpa,0.3333333333333333,2,2,TTGCAGAATGGACCATCCTA,0,1317930
furpa,0.3333333333333333,2,2,TTGCACAGCGGCCTTCCCAA,0,1333562
furpa,0.3333333333333333,2,2,TTGCAAGGGCGTTTTTTCCG,0,1315421
furpa,0.3333333333333333,2,2,TTGATTTACTAATTCGTGAT,0,1337723
furpa,0.3333333333333333,2,2,TTGATAGCGAGGGAAATAGC,0,1319772
furpa,0.3333333333333333,2,2,TTGAGGCGAATATCTGTCTT,0,1289241
furpa,0.3333333333333333,2,2,TTGAGCATGCCGGGGATCGT,0,1312621
furpa,0.3333333333333333,2,2,TTGACTCTGTATTCGTTACA,0,1279790
furpa,0.3333333333333333,2,2,TTGACCACTTGGTCGTAACT,0,1317360
furpa,0.3333333333333333,2,2,TTGAATGGGTAAGCAGTCGG,0,1327244
furpa,0.3333333333333333,2,2,TTGAACGTTTTTTGCATCTG,0,1354752
furpa,0.3333333333333333,2,2,TTCTTTCAGGTGTCGCATAT,0,1326120
furpa,0.3333333333333333,2,2,TTCTTGAGGTTCCGGCTGAT,0,1315366
furpa,0.3333333333333333,2,2,TTCTTATATCTGGTCGGGAG,0,1320986
furpa,0.3333333333333333,2,2,TTCTTAGGGCCGTTCCTCAT,0,1282263
furpa,0.3333333333333333,2,2,TTCTGTAAAGGGGACGCGGG,0,1294244
furpa,0.3333333333333333,2,2,TTCTGCTACCCTTCGATTAT,0,1316422
furpa,0.3333333333333333,2,2,TTCGTCATTGTGTCGCTAAT,0,1300552
furpa,0.3333333333333333,2,2,TTCGGTTTGGGGCGAGCCAA,0,1344988
furpa,0.3333333333333333,2,2,TTCGGGACAACGGGGAGGAT,0,1288110
furpa,0.3333333333333333,2,2,TTCGCTTTTGCCGAGTTCCT,0,1294353
furpa,0.3333333333333333,2,2,TTCGCTAAGAAGCTTTGTAT,0,1294806
furpa,0.3333333333333333,2,2,TTCCTTTGGCCATCGTCATA,0,1349185
furpa,0.3333333333333333,2,2,TTCCTCCTCGGGCAGATTTT,0,1323741
furpa,0.3333333333333333,2,2,TTCCGCTACCGATGGTGACA,0,1312395
furpa,0.3333333333333333,2,2,TTCCCAATTAAGCGAGCTGT,0,1321274
furpa,0.3333333333333333,2,2,TTCATTCGCATTACCGAAGC,0,1311770
furpa,0.3333333333333333,2,2,TTCATTCAGTATTTACTTCT,0,1286493
furpa,0.3333333333333333,2,2,TTCATAATTTCGCTGGAAAC,0,1350684
furpa,0.3333333333333333,2,2,TTCAGGTGCCTCTGGCTATA,0,1336662
furpa,0.3333333333333333,2,2,TTCAGACATCTCCAAAATTG,0,1273874
furpa,0.3333333333333333,2,2,TTCAGAAGAAGGAGTTAATA,0,1343802
furpa,0.3333333333333333,2,2,TTCACGGTAAAGCAGAGTGT,0,1301948
furpa,0.3333333333333333,2,2,TTCAATTATTAACGCTGCTG,0,1283718
furpa,0.3333333333333333,2,2,TTCAATCAGGGTGTATCCCA,0,1289237
furpa,0.3333333333333333,2,2,TTCAATACTTGCCATGGAAA,0,1324801
furpa,0.3333333333333333,2,2,TTCAAGTATGCGGCAAGATA,0,1350689
furpa,0.3333333333333333,2,2,TTCAAGTATAAATAGCATCC,0,1277404
furpa,0.3333333333333333,2,2,TTCAAGCTACAGCTACGCCC,0,1321301
furpa,0.3333333333333333,2,2,TTATTGGTGTGCCAGTACGG,0,1344504
furpa,0.3333333333333333,2,2,TTATCAAGTTCTGACGTCAA,0,1290692
furpa,0.3333333333333333,2,2,TTATATCGGACAACGCAAGT,0,1314339
furpa,0.3333333333333333,2,2,TTATAGTCAAAGCTGAGAAT,0,1299019
furpa,0.3333333333333333,2,2,TTATACCATTACGGTCGATA,0,1312058
furpa,0.3333333333333333,2,2,TTAGTTTTACGGGCTGCCAA,0,1282196
furpa,0.3333333333333333,2,2,TTAGTTATGGGACCAAGTGA,0,1349798
furpa,0.3333333333333333,2,2,TTAGTGTGTTTATCTCGTGA,0,1283132
furpa,0.3333333333333333,2,2,TTAGTGTGGTCCTATAAACG,0,1318646
furpa,0.3333333333333333,2,2,TTAGGGAGATTTTCCTACGC,0,1286123
furpa,0.3333333333333333,2,2,TTAGCCTGTCTGCGGTACCA,0,1322338
furpa,0.3333333333333333,2,2,TTAGAGTGGTACACTGATCT,0,1273257
furpa,0.3333333333333333,2,2,TTAGACAGCTAAGCGGTCCC,0,1283725
furpa,0.3333333333333333,2,2,TTACGTTCTCACGTGCCCTG,0,1346505
furpa,0.3333333333333333,2,2,TTACGTAGAGTGTGGGCGAC,0,1351233
furpa,0.3333333333333333,2,2,TTACGAATAGGCCCTCTTGA,0,1300723
furpa,0.3333333333333333,2,2,TTACCGCTACGAGTAGACTG,0,1355844
furpa,0.3333333333333333,2,2,TTACACCGTTTGGAGTGCTG,0,1280921
furpa,0.3333333333333333,2,2,TTAATTAGGGGGGAGCTATC,0,1353703
furpa,0.3333333333333333,2,2,TTAATGCCGAAAGCTTTTAT,0,1339120
furpa,0.3333333333333333,2,2,TTAATCGATAACGCTTTTTT,0,1307877
furpa,0.3333333333333333,2,2,TTAAGGATTACGGGGGCCGG,0,1341991
furpa,0.3333333333333333,2,2,TTAACCATCAGCAACAATTA,0,1286601
furpa,0.3333333333333333,2,2,TGTTTTTACCGTTCTTGATT,0,1277259
furpa,0.3333333333333333,2,2,TGTTTGTCAGTGACTGGAAG,0,1293729
furpa,0.3333333333333333,2,2,TGTTTGCTACGGAGGCTGCT,0,1314486
furpa,0.3333333333333333,2,2,TGTTTGCCCCAGAATTGTCC,0,1346691
furpa,0.3333333333333333,2,2,TGTTTAGCGCGCTAATTGCT,0,1308149
furpa,0.3333333333333333,2,2,TGTTGTTTATACTAAGGGAG,0,1323186
furpa,0.3333333333333333,2,2,TGTTGCTCTCCTTGAGTCCT,0,1319738
furpa,0.3333333333333333,2,2,TGTTGCCGGCAGAGAGCAGC,0,1344993
furpa,0.3333333333333333,2,2,TGTTCTTGCGATCCAGTACG,0,1315479
furpa,0.3333333333333333,2,2,TGTTCGCCGAGGATGAGGAA,0,1324915
furpa,0.3333333333333333,2,2,TGTTATAGTATGGGTCGTTC,0,1349009
furpa,0.3333333333333333,2,2,TGTGTAGAGCTACTGCAAAC,0,1289660
furpa,0.3333333333333333,2,2,TGTGCATTCCCCGTATTCGA,0,1321215
furpa,0.3333333333333333,2,2,TGTGACGATCTGGTCCAAAG,0,1319486
furpa,0.3333333333333333,2,2,TGTCGGGTGATACATCATCC,0,1323489
furpa,0.3333333333333333,2,2,TGTCGCGAGAGCTTACCGAG,0,1307148
furpa,0.3333333333333333,2,2,TGTCGACACAAGATAATCAC,0,1309664
furpa,0.3333333333333333,2,2,TGTCCTCACGTGTATGGCGG,0,1314563
furpa,0.3333333333333333,2,2,TGTCCCAAATACAATTGCGT,0,1339160
furpa,0.3333333333333333,2,2,TGTCCAAGAATCTATTTGAC,0,1321169
furpa,0.3333333333333333,2,2,TGTCAGCCGTGGATCAGAGT,0,1352616
furpa,0.3333333333333333,2,2,TGTCAGAGAATGATGGGGGA,0,1277999
furpa,0.3333333333333333,2,2,TGTCAATGGTATTTATCGGT,0,1338778
furpa,0.3333333333333333,2,2,TGTATGCGCTTTTCAGACCG,0,1287940
furpa,0.3333333333333333,2,2,TGTAGCTAGCTCAAAATCAC,0,1284083
furpa,0.3333333333333333,2,2,TGTACGTGTGTGGACCTTTC,0,1331304
furpa,0.3333333333333333,2,2,TGTAATCCAACTTGTATCAT,0,1345420
furpa,0.3333333333333333,2,2,TGGTGTATGTTAACCCTCGT,0,1309527
furpa,0.3333333333333333,2,2,TGGTGGTCAGAAATCACTAT,0,1337016
furpa,0.3333333333333333,2,2,TGGTGGGACCCACTCTGCCT,0,1287576
furpa,0.3333333333333333,2,2,TGGTCTCATCTGGCCGCGAG,0,1313809
furpa,0.3333333333333333,2,2,TGGTATATTTAGGATATTGT,0,1326535
furpa,0.3333333333333333,2,2,TGGTACGCTGGTTACGTCAT,0,1310041
furpa,0.3333333333333333,2,2,TGGGTGAGCGCAACGACATG,0,1288927
furpa,0.3333333333333333,2,2,TGGGTAAGATACAAATCAAG,0,1341372
furpa,0.3333333333333333,2,2,TGGGGTATCAAATCAAATAA,0,1308421
furpa,0.3333333333333333,2,2,TGGGGAGCGCAACGATTAAT,0,1290246
furpa,0.3333333333333333,2,2,TGGGGAGCAATTTCGGTTAG,0,1303066
furpa,0.3333333333333333,2,2,TGGGGACGTTCTCTCCGGTA,0,1336308
furpa,0.3333333333333333,2,2,TGGGCATGAGACGTAGTCAT,0,1286522
furpa,0.3333333333333333,2,2,TGGGATCAGCCCGCTTGACT,0,1322814
furpa,0.3333333333333333,2,2,TGGGATACTAACAATTACTT,0,1277423
furpa,0.3333333333333333,2,2,TGGGACCCATGTTTGGGTTC,0,1322823
furpa,0.3333333333333333,2,2,TGGCGCGCCCACGAGCTCGC,0,1345988
furpa,0.3333333333333333,2,2,TGGCGAAACGCCCGACCCCC,0,1297942
furpa,0.3333333333333333,2,2,TGGCCTGGCTGGAGCAAATA,0,1296008
furpa,0.3333333333333333,2,2,TGGCCCTCCGCAATGGAGCA,0,1352859
furpa,0.3333333333333333,2,2,TGGCAATAGTTTCCCCACAG,0,1277021
furpa,0.3333333333333333,2,2,TGGCAAAGCGAAACGTTAGA,0,1352339
furpa,0.3333333333333333,2,2,TGGATGGTCACAGCTCCCGG,0,1290524
furpa,0.3333333333333333,2,2,TGGATGAAATCTCTTCTCAA,0,1353854
furpa,0.3333333333333333,2,2,TGGATCAATGCAGAGGTTGG,0,1322384
furpa,0.3333333333333333,2,2,TGGACCAGGGGTAAGCTTAT,0,1301927
furpa,0.3333333333333333,2,2,TGGACAATAAGTTCTCTTCT,0,1276534
furpa,0.3333333333333333,2,2,TGGAAATAGACCCTTGGGAC,0,1296841
furpa,0.3333333333333333,2,2,TGCTGCCCGCACATTCCACT,0,1342159
furpa,0.3333333333333333,2,2,TGCTCGAAAAATTGACCAAA,0,1327320
furpa,0.3333333333333333,2,2,TGCTAGCTAACTCGTTGGGA,0,1309533
furpa,0.3333333333333333,2,2,TGCGTTTCCGAGAGCCGGCC,0,1338757
furpa,0.3333333333333333,2,2,TGCGTTGCTTCCTGCATTAT,0,1287696
furpa,0.3333333333333333,2,2,TGCGTCGAGGAGGTCATTGT,0,1292271
furpa,0.3333333333333333,2,2,TGCGGTCTATCCTCTCTTTG,0,1312233
furpa,0.3333333333333333,2,2,TGCGGTACGGCCCATTGAAG,0,1305241
furpa,0.3333333333333333,2,2,TGCGGGGTCGAGCGCCTCTA,0,1308785
furpa,0.3333333333333333,2,2,TGCGATTAGTTCTACGGGTC,0,1348586
furpa,0.3333333333333333,2,2,TGCGAGGTGAAATAGCACGT,0,1344824
furpa,0.3333333333333333,2,2,TGCGACCCGAGACCAGGAGT,0,1283305
furpa,0.3333333333333333,2,2,TGCCTTTTTCTTACTGTATT,0,1306897
furpa,0.3333333333333333,2,2,TGCCTGTTGGCTGTTTTAAA,0,1306912
furpa,0.3333333333333333,2,2,TGCCTGGAATAATGCAACGA,0,1294652
furpa,0.3333333333333333,2,2,TGCCTATCGACTTGTATTGT,0,1283902
furpa,0.3333333333333333,2,2,TGCCGTCGGGGGCCACAACT,0,1321795
furpa,0.3333333333333333,2,2,TGCCGTCCTCTTGAGCAGAT,0,1309209
furpa,0.3333333333333333,2,2,TGCCCTGATCCGCCATACCT,0,1296702
furpa,0.3333333333333333,2,2,TGCCCGGTTGATAGCCATAG,0,1280974
furpa,0.3333333333333333,2,2,TGCCCAGTTGCCCTAAAGCT,0,1300928
furpa,0.3333333333333333,2,2,TGCCAGTATGGTAGTTTGGC,0,1292467
furpa,0.3333333333333333,2,2,TGCCACTAGGCACGCGGGCT,0,1307873
furpa,0.3333333333333333,2,2,TGCCAATACATGTACCGAAG,0,1349921
furpa,0.3333333333333333,2,2,TGCATTATTCTAGTTTTTAT,0,1273608
furpa,0.3333333333333333,2,2,TGCATCAAGTATGGCGCATC,0,1351707
furpa,0.3333333333333333,2,2,TGCACCTAAGATATTTTACT,0,1310401
furpa,0.3333333333333333,2,2,TGCACCGTTAGGTAACGCGT,0,1328115
furpa,0.3333333333333333,2,2,TGCAACCCCTGGGAGAGTAA,0,1287346
furpa,0.3333333333333333,2,2,TGATTTGGAATCATAAATCT,0,1337730
furpa,0.3333333333333333,2,2,TGATTTATTTGCGAACTGAG,0,1330266
furpa,0.3333333333333333,2,2,TGATTCTCAAAACCGTCCAG,0,1350137
furpa,0.3333333333333333,2,2,TGATTACAGATCTCGCAGCA,0,1307569
furpa,0.3333333333333333,2,2,TGATGACTCTGTGCTTGCGG,0,1338386
furpa,0.3333333333333333,2,2,TGATCAGTTCAAAAATACAG,0,1322694
furpa,0.3333333333333333,2,2,TGATCAAAACACTGGCTATA,0,1309946
furpa,0.3333333333333333,2,2,TGATATATGCCGCCATGACT,0,1272204
furpa,0.3333333333333333,2,2,TGAGTGCCATGGATGAATTT,0,1307146
furpa,0.3333333333333333,2,2,TGAGTAATGCATGTTCTGAA,0,1352680
furpa,0.3333333333333333,2,2,TGAGGTCTCCGCGGGCAGAG,0,1292119
furpa,0.3333333333333333,2,2,TGAGGTCGCGCCTCGTGTAA,0,1317896
furpa,0.3333333333333333,2,2,TGAGCACAAAGTCGCAATGA,0,1304661
furpa,0.3333333333333333,2,2,TGAGAGGCATGCCGCAAAGC,0,1312635
furpa,0.3333333333333333,2,2,TGACTTTCAATCTCGGTTGA,0,1337527
furpa,0.3333333333333333,2,2,TGACTGCAACGGCCGAGTAC,0,1322547
furpa,0.3333333333333333,2,2,TGACTATACGTTCCGGCTTG,0,1318464
furpa,0.3333333333333333,2,2,TGACTAGATCACCGCAGACT,0,1290533
furpa,0.3333333333333333,2,2,TGACGGCATGTCGAACATTT,0,1283048
furpa,0.3333333333333333,2,2,TGACGACTACATAGAAGTCC,0,1281739
furpa,0.3333333333333333,2,2,TGACAGGCTCCCCTAATTAG,0,1288548
furpa,0.3333333333333333,2,2,TGACAGAAATGTCACGCACG,0,1283322
furpa,0.3333333333333333,2,2,TGAAGAGAATCGGCGTACAC,0,1277658
furpa,0.3333333333333333,2,2,TGAACATTTCCACGGACGGG,0,1341945
furpa,0.3333333333333333,2,2,TGAAATGCTTAGTCTAACTC,0,1298246
furpa,0.3333333333333333,2,2,TGAAAAGCCTTGTCACCGAT,0,1320230
furpa,0.3333333333333333,2,2,TCTTTTTTTGGTGGCATCCA,0,1293486
furpa,0.3333333333333333,2,2,TCTTGTTGCTACTCGCTTAT,0,1284617
furpa,0.3333333333333333,2,2,TCTTGGTATTACCAAATGAA,0,1287284
furpa,0.3333333333333333,2,2,TCTTGCAATGCTAGTTTGGC,0,1293643
furpa,0.3333333333333333,2,2,TCTTCCCATCGGCGCCTCCA,0,1288312
furpa,0.3333333333333333,2,2,TCTTCCAGTTTCAGCAAAGG,0,1340220
furpa,0.3333333333333333,2,2,TCTTCAGTACGCGGGAGTGT,0,1302900
furpa,0.3333333333333333,2,2,TCTTAGATGAAACACTGCTT,0,1278335
furpa,0.3333333333333333,2,2,TCTGTGCGCGATCGTGCGCC,0,1301634
furpa,0.3333333333333333,2,2,TCTGTACCAGATGTTAAAAA,0,1355003
furpa,0.3333333333333333,2,2,TCTGGGTTCTAATAGTATTT,0,1279655
furpa,0.3333333333333333,2,2,TCTGGCACACGGTGTCTGGC,0,1298928
furpa,0.3333333333333333,2,2,TCTGGACAGACGATCGCCAC,0,1295574
furpa,0.3333333333333333,2,2,TCTGCTCTATTCTCCGGTTT,0,1317639
furpa,0.3333333333333333,2,2,TCTGCCTAGGAGTTTCGTTA,0,1297772
furpa,0.3333333333333333,2,2,TCTGCCAGAGGCTAGTCGGG,0,1302960
furpa,0.3333333333333333,2,2,TCTGATGGACCGGAGCTTTG,0,1319633
furpa,0.3333333333333333,2,2,TCTGACGTTACGTCGCACTT,0,1308996
furpa,0.3333333333333333,2,2,TCTCTTATATATTAGGATCA,0,1348508
furpa,0.3333333333333333,2,2,TCTCTGCGATTCGTATTGTA,0,1282505
furpa,0.3333333333333333,2,2,TCTCGTTCCCCAATTCAGAG,0,1294807
furpa,0.3333333333333333,2,2,TCTCGCCGTTCGCAACAACA,0,1354004
furpa,0.3333333333333333,2,2,TCTCCGGCAATTCACATTTG,0,1299559
furpa,0.3333333333333333,2,2,TCTCAGGCAAGAAACGGGCG,0,1319349
furpa,0.3333333333333333,2,2,TCTCACCATTACGTCCCTGG,0,1292228
furpa,0.3333333333333333,2,2,TCTATGCGAAAATATATAGG,0,1350815
furpa,0.3333333333333333,2,2,TCTAGTACGAGTGACACCCT,0,1286172
furpa,0.3333333333333333,2,2,TCTAGACTTCACCAAAGGTT,0,1333344
furpa,0.3333333333333333,2,2,TCTACTAACAAGTATATGTT,0,1317167
furpa,0.3333333333333333,2,2,TCTACATTCGCTTTCCGAGG,0,1289103
furpa,0.3333333333333333,2,2,TCTAATCCGCACAAACATCT,0,1297896
furpa,0.3333333333333333,2,2,TCTAATCCAATGTAATCTTT,0,1331803
furpa,0.3333333333333333,2,2,TCTAACCAGTTTCAAGTAAT,0,1290181
furpa,0.3333333333333333,2,2,TCTAAACGTGGGCAATAAAG,0,1305511
furpa,0.3333333333333333,2,2,TCGTTCCTCCGCTGATTGGT,0,1307593
furpa,0.3333333333333333,2,2,TCGTGTGTGATCAATGGTGT,0,1293141
furpa,0.3333333333333333,2,2,TCGTGTCGAGTACGCATTGA,0,1341506
furpa,0.3333333333333333,2,2,TCGTGGGCAGTCAGGGGGGA,0,1354225
furpa,0.3333333333333333,2,2,TCGTCTGAGGAGGCAGTCGC,0,1282464
furpa,0.3333333333333333,2,2,TCGTCGGATTTTGGAACCTG,0,1354570
furpa,0.3333333333333333,2,2,TCGTCGAGTATTGTAAGACA,0,1309679
furpa,0.3333333333333333,2,2,TCGGTGATTTTTTGATGAGT,0,1322263
furpa,0.3333333333333333,2,2,TCGGTCTCGTAATTCACCCG,0,1324852
furpa,0.3333333333333333,2,2,TCGGGTTTCAAACACTATGA,0,1339082
furpa,0.3333333333333333,2,2,TCGGGTGACTATTCGGAATA,0,1317456
furpa,0.3333333333333333,2,2,TCGGGTATACTGTGCAGTCT,0,1313492
furpa,0.3333333333333333,2,2,TCGGGGTTCCACCGCGAGGA,0,1276293
furpa,0.3333333333333333,2,2,TCGGGCGGATAAGCGTGTGC,0,1352856
furpa,0.3333333333333333,2,2,TCGGGCGGAGTATAGATCAG,0,1301197
furpa,0.3333333333333333,2,2,TCGGGCCGAATAATCCCTTA,0,1332532
furpa,0.3333333333333333,2,2,TCGGGAGATAACCAAAATAT,0,1317871
furpa,0.3333333333333333,2,2,TCGGCCATTACTCTGGGCTT,0,1320676
furpa,0.3333333333333333,2,2,TCGGACGACTCGCAGTGATA,0,1334685
furpa,0.3333333333333333,2,2,TCGCGTTGGTCAGACCGTAT,0,1353852
furpa,0.3333333333333333,2,2,TCGCGTCCATTCCTACGGAT,0,1314101
furpa,0.3333333333333333,2,2,TCGCGCTGAAAACGTTCCAC,0,1318611
furpa,0.3333333333333333,2,2,TCGCCGGGATAAATCGTTAG,0,1283394
furpa,0.3333333333333333,2,2,TCGCCCGCGCTAGGATACTG,0,1275472
furpa,0.3333333333333333,2,2,TCGATGCAATATATCGGGCA,0,1290732
furpa,0.3333333333333333,2,2,TCGATCGGGCAGTGACCAGC,0,1304450
furpa,0.3333333333333333,2,2,TCGAGATGTGTTTTAGCCGG,0,1303012
furpa,0.3333333333333333,2,2,TCGAATTCCATACAGATTTA,0,1315593
furpa,0.3333333333333333,2,2,TCCTTGGTAACGTTAGGTAA,0,1337977
furpa,0.3333333333333333,2,2,TCCTGTATCAGTGCTACAGT,0,1278055
furpa,0.3333333333333333,2,2,TCCTGGACCCAGGCTCTTCA,0,1319130
furpa,0.3333333333333333,2,2,TCCTCCCCCTATATGTTGCG,0,1345775
furpa,0.3333333333333333,2,2,TCCTAGGTTGTGTAGGAGAT,0,1355761
furpa,0.3333333333333333,2,2,TCCTAGCTTAAGAGTACATC,0,1308212
furpa,0.3333333333333333,2,2,TCCTAATTGGGCGGTGATGA,0,1348563
furpa,0.3333333333333333,2,2,TCCGTGCTATCTTACTTAAA,0,1320137
furpa,0.3333333333333333,2,2,TCCGTCTTTTCAGCTCGTTT,0,1277651
furpa,0.3333333333333333,2,2,TCCGTATCGAATACGTCTGT,0,1322084
furpa,0.3333333333333333,2,2,TCCGTAGCACGTATCCCTTC,0,1306438
furpa,0.3333333333333333,2,2,TCCGGAGGATTACGTGGCAA,0,1341753
furpa,0.3333333333333333,2,2,TCCGCTGGTAGCGTCCTCCT,0,1347190
furpa,0.3333333333333333,2,2,TCCGCCCGGTGCCGTTTTAC,0,1279550
furpa,0.3333333333333333,2,2,TCCCTGCCAGTCTGAATGGT,0,1340913
furpa,0.3333333333333333,2,2,TCCCTCATTACTGCCGGATT,0,1315508
furpa,0.3333333333333333,2,2,TCCCGGGAGGTATACAACGA,0,1316626
furpa,0.3333333333333333,2,2,TCCCCGCGATCGGGTACGTT,0,1357798
furpa,0.3333333333333333,2,2,TCCCCCTGCAAGCCCGTTCG,0,1351844
furpa,0.3333333333333333,2,2,TCCCCATCAGGAGACTCAAG,0,1287985
furpa,0.3333333333333333,2,2,TCCCATATCCTACTGATTCT,0,1293546
furpa,0.3333333333333333,2,2,TCCATCGTCTGACATCGCGA,0,1353263
furpa,0.3333333333333333,2,2,TCCATAGGTGGACGAATACC,0,1349388
furpa,0.3333333333333333,2,2,TCCAGGGGCTACATGGGGAA,0,1345625
furpa,0.3333333333333333,2,2,TCCAGATTTTGCGTAAGGTC,0,1299061
furpa,0.3333333333333333,2,2,TCCACTGTGCTTGTCATGGA,0,1350484
furpa,0.3333333333333333,2,2,TCATTTAGGTGTCACCGTGA,0,1310910
furpa,0.3333333333333333,2,2,TCATTCTTACTCCATTGGGT,0,1346419
furpa,0.3333333333333333,2,2,TCATGTTAAACTTGTCACAT,0,1322816
furpa,0.3333333333333333,2,2,TCATGTGCGCTGTGCAAATG,0,1303129
furpa,0.3333333333333333,2,2,TCATGGGGTAACGGTCGGTA,0,1343415
furpa,0.3333333333333333,2,2,TCAGTCAATGAATCGAAAGT,0,1272275
furpa,0.3333333333333333,2,2,TCAGTAGTGGATAGGATCGA,0,1291993
furpa,0.3333333333333333,2,2,TCAGGTGTTATAATGCGAAT,0,1316854
furpa,0.3333333333333333,2,2,TCAGGTGTAATGACTTGATA,0,1285548
furpa,0.3333333333333333,2,2,TCAGCATATAATACGTTGTT,0,1357530
furpa,0.3333333333333333,2,2,TCAGAGTGCTACTACGTATA,0,1283190
furpa,0.3333333333333333,2,2,TCAGACTTACCGATGAATGT,0,1282445
furpa,0.3333333333333333,2,2,TCACTTTCGAGGGATCGATT,0,1334906
furpa,0.3333333333333333,2,2,TCACGGGCTCGGCTCCATTA,0,1288345
furpa,0.3333333333333333,2,2,TCACCGCGCGAGGCCCCCCT,0,1331621
furpa,0.3333333333333333,2,2,TCACCCCGTCGCTCTTCATT,0,1285123
furpa,0.3333333333333333,2,2,TCAATCAACAGTTGTGTGCA,0,1301077
furpa,0.3333333333333333,2,2,TCAAGTGCGGGGTAACGCCG,0,1282019
furpa,0.3333333333333333,2,2,TCAAGTGAGCTGATAAAGCC,0,1319985
furpa,0.3333333333333333,2,2,TCAAGGGGCTTAGTGGTCAG,0,1353370
furpa,0.3333333333333333,2,2,TCAAGCGTTAGTAGGTACGG,0,1299490
furpa,0.3333333333333333,2,2,TCAACTGCACGGTACGTCGC,0,1336074
furpa,0.3333333333333333,2,2,TCAACTCTGAACAATAATGG,0,1326735
furpa,0.3333333333333333,2,2,TCAAAGACTTAATTGCGAGG,0,1285867
furpa,0.3333333333333333,2,2,TCAAACGCTTGAGTACTCAA,0,1328752
furpa,0.3333333333333333,2,2,TATTTGTTACGTAACCAGCA,0,1322699
furpa,0.3333333333333333,2,2,TATTTCTCAATCATCTATAT,0,1324392
furpa,0.3333333333333333,2,2,TATTGTTAGACCAAGAGCTA,0,1304973
furpa,0.3333333333333333,2,2,TATTGATCTCCGCAAAGCGT,0,1293880
furpa,0.3333333333333333,2,2,TATTGAATGCCATTTTTGAC,0,1342836
furpa,0.3333333333333333,2,2,TATTCTTCGACCCTATTTTA,0,1271605
furpa,0.3333333333333333,2,2,TATGTTGCTCTCGGGTTGAT,0,1312784
furpa,0.3333333333333333,2,2,TATGTCGATGTACACATTGA,0,1280972
furpa,0.3333333333333333,2,2,TATGTAGCCTTTATGCAATG,0,1328644
furpa,0.3333333333333333,2,2,TATGGTCGTGTACCCTAAAG,0,1280390
furpa,0.3333333333333333,2,2,TATGGTAGCAGGCAACTCTT,0,1311099
furpa,0.3333333333333333,2,2,TATGGACTCCGTAGATTCAA,0,1274517
furpa,0.3333333333333333,2,2,TATGCGCCCTCTGCGGAGAA,0,1319881
furpa,0.3333333333333333,2,2,TATGCCAGACTAGCTTGTAG,0,1339063
furpa,0.3333333333333333,2,2,TATGACCACGGTATCCTTTA,0,1341871
furpa,0.3333333333333333,2,2,TATCCATGCTTCTGATGACG,0,1315185
furpa,0.3333333333333333,2,2,TATCATCGGATGGCCACTCC,0,1291372
furpa,0.3333333333333333,2,2,TATCAGTACAAAAAGGCCGG,0,1305261
furpa,0.3333333333333333,2,2,TATCACCCACAGAAAAACCT,0,1285640
furpa,0.3333333333333333,2,2,TATATAAAATCAAGAGTGAA,0,1281516
furpa,0.3333333333333333,2,2,TATAGCGCACCCGGCGCCAC,0,1283073
furpa,0.3333333333333333,2,2,TATACTTATCGGGCTACCAA,0,1341872
furpa,0.3333333333333333,2,2,TATACATCCCTGGCATTCCG,0,1332972
furpa,0.3333333333333333,2,2,TATAAGGTTCGCGTAGTCAG,0,1338177
furpa,0.3333333333333333,2,2,TATAAATCTGGATAACGGGC,0,1316418
furpa,0.3333333333333333,2,2,TATAAACGTATGGTATTCCG,0,1324576
furpa,0.3333333333333333,2,2,TAGGTCCCTAGGTTTCATAG,0,1287028
furpa,0.3333333333333333,2,2,TAGGTCAGTTGGGGGCGATC,0,1317796
furpa,0.3333333333333333,2,2,TAGGTAGCAACTCAGCGCTC,0,1329516
furpa,0.3333333333333333,2,2,TAGGGTGCTCATGTAAACGA,0,1308151
furpa,0.3333333333333333,2,2,TAGGGTCGTTGCACGCCCGT,0,1345870
furpa,0.3333333333333333,2,2,TAGGGAGCAGCAACACTGGT,0,1278415
furpa,0.3333333333333333,2,2,TAGCTTGGATAGCGCACAGT,0,1282557
furpa,0.3333333333333333,2,2,TAGCTTCCCGGGTCTGTATG,0,1294804
furpa,0.3333333333333333,2,2,TAGCGTTTTACACGCTCCGA,0,1275665
furpa,0.3333333333333333,2,2,TAGCGGTTATCTTGGGAATA,0,1345735
furpa,0.3333333333333333,2,2,TAGCGGGTTACGCAACGTCC,0,1334340
furpa,0.3333333333333333,2,2,TAGCGCTGAATGTAAACAGG,0,1321825
furpa,0.3333333333333333,2,2,TAGATGTCCCCAAGCGAGTG,0,1352995
furpa,0.3333333333333333,2,2,TAGATGATCCGGCGGATTTG,0,1323723
furpa,0.3333333333333333,2,2,TAGATGACAAGTCACAACGT,0,1304803
furpa,0.3333333333333333,2,2,TAGATAGCCTGGTAACCAGC,0,1304208
furpa,0.3333333333333333,2,2,TAGATAGACATACTCGAAAG,0,1302687
furpa,0.3333333333333333,2,2,TACTTTCGATAGACGAGTAA,0,1341186
furpa,0.3333333333333333,2,2,TACTGTATAGGCAGTTTGGA,0,1332258
furpa,0.3333333333333333,2,2,TACTGTATACACTCGCGGTC,0,1344029
furpa,0.3333333333333333,2,2,TACTCCGGGCGAGTAGTCTC,0,1293246
furpa,0.3333333333333333,2,2,TACTATACTAAGTTTGATGG,0,1289970
furpa,0.3333333333333333,2,2,TACTAAACAGTACTGAGTAA,0,1323752
furpa,0.3333333333333333,2,2,TACGTTATATGGGCTGTAGT,0,1351796
furpa,0.3333333333333333,2,2,TACGTTAGGCCTGGCCGCGC,0,1286428
furpa,0.3333333333333333,2,2,TACGGATTAGTGGAAAAGTT,0,1281962
furpa,0.3333333333333333,2,2,TACGGAGTACGTGAAAGTTC,0,1354721
furpa,0.3333333333333333,2,2,TACGCCAAGCGATAGGGTGC,0,1285642
furpa,0.3333333333333333,2,2,TACCTGTGCTGAGACTAGGG,0,1288544
furpa,0.3333333333333333,2,2,TACCTCAATGAGAGTAAAAT,0,1317687
furpa,0.3333333333333333,2,2,TACCGGTGGCTCCTCACTAA,0,1287805
furpa,0.3333333333333333,2,2,TACCGGGACTAGAATTTCTT,0,1346065
furpa,0.3333333333333333,2,2,TACCGCCACTGGATTACCGA,0,1301787
furpa,0.3333333333333333,2,2,TACCGAAGTCACGTGCGGGG,0,1334404
furpa,0.3333333333333333,2,2,TACCCTCACACTGAGGTCGC,0,1273471
furpa,0.3333333333333333,2,2,TACATAGGCCTGCCTCCCCA,0,1292303
furpa,0.3333333333333333,2,2,TAATTGGCGAACCCGACTCC,0,1332526
furpa,0.3333333333333333,2,2,TAATTGAGGGGGGGAAACCT,0,1292925
furpa,0.3333333333333333,2,2,TAATTCTGGTATAGAGTCCT,0,1345581
furpa,0.3333333333333333,2,2,TAATGTCGGCAGACTTGCCA,0,1312622
furpa,0.3333333333333333,2,2,TAATGTCCATTGTACGCACG,0,1276125
furpa,0.3333333333333333,2,2,TAATGTAGGGAGGTATTCAT,0,1291885
furpa,0.3333333333333333,2,2,TAATGCGCTCTTTGCATACA,0,1324190
furpa,0.3333333333333333,2,2,TAATGCATGGTCCTCGTATA,0,1300084
furpa,0.3333333333333333,2,2,TAATGATCTCCGGGCCTGTA,0,1290469
furpa,0.3333333333333333,2,2,TAATCGATAAGCTTTGGCAA,0,1346949
furpa,0.3333333333333333,2,2,TAATCGACAGTCACATCAGA,0,1338168
furpa,0.3333333333333333,2,2,TAATACTACATAATCTACCA,0,1350057
furpa,0.3333333333333333,2,2,TAATACGTTAACAAAGCGAA,0,1307106
furpa,0.3333333333333333,2,2,TAAGTTGTGTTACAGCTCGC,0,1275618
furpa,0.3333333333333333,2,2,TAAGTTAAATGACGACGGCT,0,1347423
furpa,0.3333333333333333,2,2,TAAGTCGCAAGATAGACGCT,0,1329091
furpa,0.3333333333333333,2,2,TAAGGTCAGGGGAGGCACGA,0,1321276
furpa,0.3333333333333333,2,2,TAAGGAACTCTCTTTTTGAA,0,1328996
furpa,0.3333333333333333,2,2,TAAGGAAAGCTCTGTAGAAG,0,1272755
furpa,0.3333333333333333,2,2,TAAGCTATTCGGCTTTTTGG,0,1300467
furpa,0.3333333333333333,2,2,TAACGCTTTGAGTGTTATCC,0,1314324
furpa,0.3333333333333333,2,2,TAACCTCAACTTAAAATCGG,0,1283971
furpa,0.3333333333333333,2,2,TAACCAGGGTGGTCCCCAAA,0,1350261
furpa,0.3333333333333333,2,2,TAACATTCACCAGGGCAGTC,0,1299131
furpa,0.3333333333333333,2,2,TAAATTTGGGTACCTAACCA,0,1329963
furpa,0.3333333333333333,2,2,TAAATTAACCCTGGCAAAGT,0,1271589
furpa,0.3333333333333333,2,2,TAAATCAGACCTTGGGGTGC,0,1355271
furpa,0.3333333333333333,2,2,TAAAAGGGAGGGAAGGAGTT,0,1334251
furpa,0.3333333333333333,2,2,TAAAAGGAACCCGGCTTCCG,0,1319334
furpa,0.3333333333333333,2,2,TAAAACTGTGTGGCCAGGTA,0,1300423
furpa,0.3333333333333333,2,2,GTTTTTTCGTTCGGCGACAT,0,1278252
furpa,0.3333333333333333,2,2,GTTTTTGCTAGATCACAATG,0,1307390
furpa,0.3333333333333333,2,2,GTTTTCGAAGGCCCGTCAAA,0,1294961
furpa,0.3333333333333333,2,2,GTTTGGAGGATCGCGTGATA,0,1291039
furpa,0.3333333333333333,2,2,GTTTCGGACGTCAGGGCGCC,0,1277442
furpa,0.3333333333333333,2,2,GTTTATTGAATACCGCGAAC,0,1313267
furpa,0.3333333333333333,2,2,GTTTATACCCGCGTGCTGAA,0,1327528
furpa,0.3333333333333333,2,2,GTTTAATGAAATCTAGTGAC,0,1303634
furpa,0.3333333333333333,2,2,GTTGTTTTTTCAACGAGGAA,0,1302491
furpa,0.3333333333333333,2,2,GTTGTTGGCCTGCTAAGCGC,0,1304044
furpa,0.3333333333333333,2,2,GTTGTTCGGTGAGGCCTCAG,0,1353888
furpa,0.3333333333333333,2,2,GTTGTTCGCAAACTCGTGAT,0,1284256
furpa,0.3333333333333333,2,2,GTTGTGTTGTCGCTAGACAT,0,1350891
furpa,0.3333333333333333,2,2,GTTGTGTATTCAGACCTTCG,0,1336486
furpa,0.3333333333333333,2,2,GTTGTAAGCGTTATATCATT,0,1289493
furpa,0.3333333333333333,2,2,GTTGGTGGATTGCTACACCT,0,1283030
furpa,0.3333333333333333,2,2,GTTGGGGTTTCCGAGTGTCA,0,1337454
furpa,0.3333333333333333,2,2,GTTGGAGACCGTAACAATGC,0,1331077
furpa,0.3333333333333333,2,2,GTTGCCGTTAGTATCATTTT,0,1327428
furpa,0.3333333333333333,2,2,GTTGCCCGTACCCGTGGATT,0,1289960
furpa,0.3333333333333333,2,2,GTTGAATTGTACATTTGAGA,0,1346009
furpa,0.3333333333333333,2,2,GTTCTTTATTATTGCCATGT,0,1340716
furpa,0.3333333333333333,2,2,GTTCTACTCGATCGTCCTAA,0,1286420
furpa,0.3333333333333333,2,2,GTTCTACAAGTGTATAAACA,0,1333929
furpa,0.3333333333333333,2,2,GTTCCCCTCTTTACTCAAAG,0,1287888
furpa,0.3333333333333333,2,2,GTTCCATCCCCTAAGCATCC,0,1323140
furpa,0.3333333333333333,2,2,GTTCATATCGAAATCGTCTG,0,1303984
furpa,0.3333333333333333,2,2,GTTCAGCGATCCGGGTAACT,0,1312280
furpa,0.3333333333333333,2,2,GTTCACCCGCATCTAGTAGG,0,1318964
furpa,0.3333333333333333,2,2,GTTCAATTCGTTACGTAGCG,0,1342260
furpa,0.3333333333333333,2,2,GTTCAACTATTTTCACGTAT,0,1295107
furpa,0.3333333333333333,2,2,GTTAGTACGCGATTGCGAAA,0,1347046
furpa,0.3333333333333333,2,2,GTTACCTAACCCGGGTAGAA,0,1339051
furpa,0.3333333333333333,2,2,GTTACCGATCACTATAAAAG,0,1292538
furpa,0.3333333333333333,2,2,GTTACCATCATAGTAGAAAG,0,1278526
furpa,0.3333333333333333,2,2,GTTACAATTTGGCGCTATAC,0,1272833
furpa,0.3333333333333333,2,2,GTTAATGTCGGCGTGGTTAG,0,1314212
furpa,0.3333333333333333,2,2,GTTAATGGCTAGTTTGAAGA,0,1329899
furpa,0.3333333333333333,2,2,GTTAAGACATCCCCATATCT,0,1306724
furpa,0.3333333333333333,2,2,GTTAACTTTCACGGTGAAAG,0,1301121
furpa,0.3333333333333333,2,2,GTTAAATCAAACATTGCCTT,0,1336477
furpa,0.3333333333333333,2,2,GTGTTGTTCCCTAGCGAGTA,0,1280931
furpa,0.3333333333333333,2,2,GTGTTGGAGTATATTCACTT,0,1300677
furpa,0.3333333333333333,2,2,GTGTTCGTATGCCCTAAGTC,0,1353471
furpa,0.3333333333333333,2,2,GTGTGTTACAACACCTGGCC,0,1338982
furpa,0.3333333333333333,2,2,GTGTGTGTAGTAGTTCTTGG,0,1275597
furpa,0.3333333333333333,2,2,GTGTGCAATTGTTGAACAGA,0,1284494
furpa,0.3333333333333333,2,2,GTGTGATAATCAGGTAGGTA,0,1282184
furpa,0.3333333333333333,2,2,GTGTCAGATTCGTTCCGTAT,0,1296186
furpa,0.3333333333333333,2,2,GTGTCACACTAAATGGGTGT,0,1315943
furpa,0.3333333333333333,2,2,GTGGTGTGGCGTTATTTAAG,0,1333970
furpa,0.3333333333333333,2,2,GTGGTGGAATCTGGACCCGG,0,1307037
furpa,0.3333333333333333,2,2,GTGGGGCGCTCACAACAATT,0,1340833
furpa,0.3333333333333333,2,2,GTGGGCAGGGCATATCATAG,0,1294252
furpa,0.3333333333333333,2,2,GTGGGAGTCCTCTAAAACTT,0,1341321
furpa,0.3333333333333333,2,2,GTGGGAGATGCGAGGCGGTT,0,1311709
furpa,0.3333333333333333,2,2,GTGGCTGAATGAGTGAGCCT,0,1277757
furpa,0.3333333333333333,2,2,GTGGCTAATCAACAGCGCAG,0,1328824
furpa,0.3333333333333333,2,2,GTGGCCATAAGAGTTGCGGG,0,1278971
furpa,0.3333333333333333,2,2,GTGGATGTTACCCTGTTAAT,0,1346563
furpa,0.3333333333333333,2,2,GTGGATCGGAGGCGAATAAG,0,1276449
furpa,0.3333333333333333,2,2,GTGGATCAGCCGCAAGTGCG,0,1286778
furpa,0.3333333333333333,2,2,GTGGATATCTTGGAGTGGTT,0,1276655
furpa,0.3333333333333333,2,2,GTGGACGGGCTGCAGAGCAC,0,1310645
furpa,0.3333333333333333,2,2,GTGCTTGACAGGATACTAAT,0,1347342
furpa,0.3333333333333333,2,2,GTGCTCCCTTTGATAGACGT,0,1327770
furpa,0.3333333333333333,2,2,GTGCTATGTTCTTCCAGTCG,0,1340553
furpa,0.3333333333333333,2,2,GTGCGTCGTAGCAAGGTCAG,0,1285095
furpa,0.3333333333333333,2,2,GTGCGCCTGTTTGGAACAGG,0,1300394
furpa,0.3333333333333333,2,2,GTGCGCACTGCCGGTCGGAA,0,1340206
furpa,0.3333333333333333,2,2,GTGCCAATTCCCCATCAACT,0,1308433
furpa,0.3333333333333333,2,2,GTGCATGCTTGGCAAGTTTA,0,1286512
furpa,0.3333333333333333,2,2,GTGATTATTGATCACACGGA,0,1303874
furpa,0.3333333333333333,2,2,GTGATGCCGGACCACCGCCT,0,1322633
furpa,0.3333333333333333,2,2,GTGATGAATGGCGGTTAGAA,0,1275108
furpa,0.3333333333333333,2,2,GTGATATCAACGAGGTCAGT,0,1324903
furpa,0.3333333333333333,2,2,GTGATAACCAGTTGACACTC,0,1305632
furpa,0.3333333333333333,2,2,GTGAGTTATAGCGGCAAGTA,0,1301102
furpa,0.3333333333333333,2,2,GTGAGGCCCGTGCATAGAGA,0,1286479
furpa,0.3333333333333333,2,2,GTGACGTCTACGACTAGAGC,0,1309953
furpa,0.3333333333333333,2,2,GTGACCGTCGGACCGCCCCG,0,1288006
furpa,0.3333333333333333,2,2,GTCTTTGCGGCAGGGGATTC,0,1315670
furpa,0.3333333333333333,2,2,GTCTTTCCGTTAAATAATCA,0,1302746
furpa,0.3333333333333333,2,2,GTCTTTAGTCACAACCGTGG,0,1286374
furpa,0.3333333333333333,2,2,GTCTTTACCCACCACATGCA,0,1345725
furpa,0.3333333333333333,2,2,GTCTTGTATATCCCTTTGTC,0,1277097
furpa,0.3333333333333333,2,2,GTCTTGCTGTCAATGATCCT,0,1301456
furpa,0.3333333333333333,2,2,GTCTTAAATGGGGGAAACAA,0,1289679
furpa,0.3333333333333333,2,2,GTCTGGGAGAACAACACCTT,0,1282763
furpa,0.3333333333333333,2,2,GTCTCTTCAGGCATGCTCAG,0,1283557
furpa,0.3333333333333333,2,2,GTCGTGTTAAGTATGCAGAC,0,1294241
furpa,0.3333333333333333,2,2,GTCGTCCCGGCCGACTGAAA,0,1333043
furpa,0.3333333333333333,2,2,GTCGTATTGCAGGAGCATAT,0,1272276
furpa,0.3333333333333333,2,2,GTCGGTGTTGCGGTAATTGT,0,1319046
furpa,0.3333333333333333,2,2,GTCGCGCCATGGACGTAACG,0,1337828
furpa,0.3333333333333333,2,2,GTCGCCAATTGTAGATGCGA,0,1356036
furpa,0.3333333333333333,2,2,GTCGATGCTGCCAACTAAGA,0,1317613
furpa,0.3333333333333333,2,2,GTCGAGCTGCCGAGTCTGTC,0,1330019
furpa,0.3333333333333333,2,2,GTCGAAGGCCGTCAGTCTGA,0,1353892
furpa,0.3333333333333333,2,2,GTCCTCTTTGAAAGGGATAG,0,1303058
furpa,0.3333333333333333,2,2,GTCCTCGTGTTCTTAAGTTC,0,1327621
furpa,0.3333333333333333,2,2,GTCCGAGTGTAGTCATTGTT,0,1308382
furpa,0.3333333333333333,2,2,GTCCAGCCTGCCTATGGTGT,0,1312378
furpa,0.3333333333333333,2,2,GTCCAGACAGCCGTCGTGAC,0,1291559
furpa,0.3333333333333333,2,2,GTCCACGGGCATTGGCAGGG,0,1354063
furpa,0.3333333333333333,2,2,GTCATGCCGACTTATACAAG,0,1303856
furpa,0.3333333333333333,2,2,GTCATAATTACCTGTGAGAT,0,1271178
furpa,0.3333333333333333,2,2,GTCAGGACTCCACGATCAAG,0,1343442
furpa,0.3333333333333333,2,2,GTCAGCTTCCATTCCACACT,0,1328794
furpa,0.3333333333333333,2,2,GTCAGCCTCTGACACTCTTT,0,1284668
furpa,0.3333333333333333,2,2,GTCACTTTTTACACAGTTCG,0,1282045
furpa,0.3333333333333333,2,2,GTCACGCGTCGTGGCTAATA,0,1327743
furpa,0.3333333333333333,2,2,GTCACCCTACTTCATCTACA,0,1321397
furpa,0.3333333333333333,2,2,GTCACACGGCACTGTCTTAG,0,1309434
furpa,0.3333333333333333,2,2,GTCAAGCGAATGTTCTTGAT,0,1337705
furpa,0.3333333333333333,2,2,GTCAAGATAACGTCTCAAGC,0,1311869
furpa,0.3333333333333333,2,2,GTCAACGTCTACAACACCTT,0,1298401
furpa,0.3333333333333333,2,2,GTATTGCGTGAAACTATCTG,0,1311272
furpa,0.3333333333333333,2,2,GTATTGAGGGCAGCCATTGA,0,1324761
furpa,0.3333333333333333,2,2,GTATTGAAGGAAGCGTCAGT,0,1289531
furpa,0.3333333333333333,2,2,GTATTAACACTTGCCCCTTG,0,1285766
furpa,0.3333333333333333,2,2,GTATCTCGCCTATCCTGATT,0,1277001
furpa,0.3333333333333333,2,2,GTATCATTATTGAGTTCTGT,0,1305438
furpa,0.3333333333333333,2,2,GTATACAATTGGATCGGCCA,0,1320762
furpa,0.3333333333333333,2,2,GTAGTGACTAAAGATCGGTA,0,1274268
furpa,0.3333333333333333,2,2,GTAGGTCGAAGTTAGTCACC,0,1315096
furpa,0.3333333333333333,2,2,GTAGGTCCTTCGATCACTTT,0,1272665
furpa,0.3333333333333333,2,2,GTAGGGCACAACCACATTGT,0,1319184
furpa,0.3333333333333333,2,2,GTAGGCAGCGCGCACTGGGC,0,1319507
furpa,0.3333333333333333,2,2,GTACTTCACGGTCTGCACGG,0,1348105
furpa,0.3333333333333333,2,2,GTACTCTTTGGGCGGCACAC,0,1325627
furpa,0.3333333333333333,2,2,GTACTAGCCCATAGCCAATA,0,1306526
furpa,0.3333333333333333,2,2,GTACTAAACAACCGAGGTGA,0,1305175
furpa,0.3333333333333333,2,2,GTACGCCCATAACTGTCTAC,0,1309335
furpa,0.3333333333333333,2,2,GTACCTCTTCGCAGGACGTT,0,1311813
furpa,0.3333333333333333,2,2,GTACCGTGGATTCGGTTGAC,0,1354276
furpa,0.3333333333333333,2,2,GTACCGGTTCAGATCTTGAA,0,1296289
furpa,0.3333333333333333,2,2,GTACATAATCGCTGTTACCG,0,1275857
furpa,0.3333333333333333,2,2,GTACACGACCGAGAACTGCG,0,1333476
furpa,0.3333333333333333,2,2,GTAATATTTCGCAATAAGTC,0,1312384
furpa,0.3333333333333333,2,2,GTAAGTTTGTAAGGCTAGTC,0,1293899
furpa,0.3333333333333333,2,2,GTAAGTTGCTGCGGCCGAAC,0,1351909
furpa,0.3333333333333333,2,2,GTAAGAGGTGGTTCACTGAT,0,1305350
furpa,0.3333333333333333,2,2,GTAACGGCTTAGCGGTTTAT,0,1327525
furpa,0.3333333333333333,2,2,GTAAAAGCGCCTTGTGGTCT,0,1286259
furpa,0.3333333333333333,2,2,GGTTTCACCGTATGTTCCTT,0,1308651
furpa,0.3333333333333333,2,2,GGTTCGTTAATCTCTGGGCG,0,1296350
furpa,0.3333333333333333,2,2,GGTTCACGCTAGTTGGGAAT,0,1278925
furpa,0.3333333333333333,2,2,GGTTAGGACCCATGTGATAG,0,1324841
furpa,0.3333333333333333,2,2,GGTTAATGTCTTCAACGGTT,0,1348307
furpa,0.3333333333333333,2,2,GGTTAAAAGTTCACAGGTTA,0,1315956
furpa,0.3333333333333333,2,2,GGTGTCGGCCAATGGGTTAA,0,1344919
furpa,0.3333333333333333,2,2,GGTGTATATCGAAGGGCGGT,0,1307775
furpa,0.3333333333333333,2,2,GGTGTACGGAACGAACACCT,0,1314062
furpa,0.3333333333333333,2,2,GGTGGTTACAACATAACTAT,0,1344855
furpa,0.3333333333333333,2,2,GGTGGGAATCCTAGCTCTGA,0,1344073
furpa,0.3333333333333333,2,2,GGTGCACTATCTAGCGTGTA,0,1341651
furpa,0.3333333333333333,2,2,GGTGCACTATCCGGAGGCCA,0,1334866
furpa,0.3333333333333333,2,2,GGTCTTGGCGAGGCCATCTG,0,1329765
furpa,0.3333333333333333,2,2,GGTCTCTAAATCAGCAAGGT,0,1292110
furpa,0.3333333333333333,2,2,GGTCGTTACCATAGCATAAG,0,1309603
furpa,0.3333333333333333,2,2,GGTCCTCAAGTGACGTGGCT,0,1320074
furpa,0.3333333333333333,2,2,GGTCCCTGAATGTGGTCGAG,0,1312200
furpa,0.3333333333333333,2,2,GGTCCCCTACTTGTAATACC,0,1274752
furpa,0.3333333333333333,2,2,GGTCAAGAGAAGGTTTATCT,0,1289781
furpa,0.3333333333333333,2,2,GGTATCTGACCTTCTGCCGT,0,1355708
furpa,0.3333333333333333,2,2,GGTATCACCTAAAAGTAGCT,0,1312091
furpa,0.3333333333333333,2,2,GGTAGTGGGTGGCCATGGCA,0,1280145
furpa,0.3333333333333333,2,2,GGTAGTGCAATAGCAAGATT,0,1297497
furpa,0.3333333333333333,2,2,GGTACTTATCGCAAGTAATT,0,1287184
furpa,0.3333333333333333,2,2,GGTACAGCAGAGCGGGCGGA,0,1344724
furpa,0.3333333333333333,2,2,GGTACAACTGTTGTAGATGA,0,1298464
furpa,0.3333333333333333,2,2,GGTAAGGGGCGACAAAGGAG,0,1340252
furpa,0.3333333333333333,2,2,GGTAACAGGGTACTTTAGAC,0,1316692
furpa,0.3333333333333333,2,2,GGTAACACTCGTAATCTCAT,0,1336493
furpa,0.3333333333333333,2,2,GGGTTTGTTCTAGTACCACC,0,1295065
furpa,0.3333333333333333,2,2,GGGTTTATGTCGCAAACTAC,0,1296120
furpa,0.3333333333333333,2,2,GGGTTGCAAAGAGGCGGGGG,0,1292242
furpa,0.3333333333333333,2,2,GGGTTCGCCGGGTGGTGCAA,0,1338300
furpa,0.3333333333333333,2,2,GGGTTACCGCACAACTTATG,0,1316268
furpa,0.3333333333333333,2,2,GGGTTACCCCGAATTTTTAC,0,1298625
furpa,0.3333333333333333,2,2,GGGTGCCTCAAGGTAGGTCA,0,1345182
furpa,0.3333333333333333,2,2,GGGTCTGGCACAGACCACCT,0,1323623
furpa,0.3333333333333333,2,2,GGGTCCTTCGCCGAAAATAA,0,1317336
furpa,0.3333333333333333,2,2,GGGTCAGATGTATATCCCGG,0,1356777
furpa,0.3333333333333333,2,2,GGGTAGCACCTTATTGGAGA,0,1305039
furpa,0.3333333333333333,2,2,GGGGTAAATGTTGCGCCGTG,0,1317246
furpa,0.3333333333333333,2,2,GGGGGTTCAAACTCACTACT,0,1319913
furpa,0.3333333333333333,2,2,GGGGGTAGAATTCAAATAGT,0,1340730
furpa,0.3333333333333333,2,2,GGGGGGCCTCGCGTCACTAG,0,1342949
furpa,0.3333333333333333,2,2,GGGGGCGAGTACGCCCCGCA,0,1275997
furpa,0.3333333333333333,2,2,GGGGGCATGGTCTGTTGAAA,0,1295900
furpa,0.3333333333333333,2,2,GGGGAGTAGCCTAGCATGTT,0,1347020
furpa,0.3333333333333333,2,2,GGGGAGGACACTCCGATACG,0,1348721
furpa,0.3333333333333333,2,2,GGGGACTAGGCTAACTCGTC,0,1343574
furpa,0.3333333333333333,2,2,GGGCTGGTGTAGATGGAGTA,0,1355962
furpa,0.3333333333333333,2,2,GGGCGTAGATGGAGAGTGCA,0,1274735
furpa,0.3333333333333333,2,2,GGGCGGTCCAGGCGTATCAG,0,1293718
furpa,0.3333333333333333,2,2,GGGCGGGTGAGTAAGCGCTC,0,1312948
furpa,0.3333333333333333,2,2,GGGCGGGTGACTTTTTACCT,0,1282899
furpa,0.3333333333333333,2,2,GGGCGGAGTTAAAGTTAGAC,0,1287992
furpa,0.3333333333333333,2,2,GGGCGAGTTTTTACGTTAGC,0,1307483
furpa,0.3333333333333333,2,2,GGGCCTGTAGAATGCTGTCG,0,1290473
furpa,0.3333333333333333,2,2,GGGCCTGCTAATAACGTCGC,0,1275040
furpa,0.3333333333333333,2,2,GGGCATTTACCTCACTCAGG,0,1353596
furpa,0.3333333333333333,2,2,GGGCAGACTGCGTGCTAGGC,0,1323717
furpa,0.3333333333333333,2,2,GGGCACAACACTCGCCATTC,0,1319032
furpa,0.3333333333333333,2,2,GGGATATTTTTGGGCACTGC,0,1273451
furpa,0.3333333333333333,2,2,GGGAGTGCTCAGGGCGAGCG,0,1283558
furpa,0.3333333333333333,2,2,GGGAGACACAAAGAATTAAG,0,1333469
furpa,0.3333333333333333,2,2,GGGACGGGTTTTATGGAAAG,0,1317113
furpa,0.3333333333333333,2,2,GGGACCGGCTCTGACGGAAG,0,1272627
furpa,0.3333333333333333,2,2,GGGACAGCATCAATACCAGA,0,1320934
furpa,0.3333333333333333,2,2,GGGAACCGTCACATGTAAGA,0,1281614
furpa,0.3333333333333333,2,2,GGGAAAACGCCATCACTTAG,0,1331920
furpa,0.3333333333333333,2,2,GGCTTCAGCGCGCCTAAAGT,0,1291959
furpa,0.3333333333333333,2,2,GGCTGGGCGATCATGCCGGT,0,1278312
furpa,0.3333333333333333,2,2,GGCTGGCTATTAACCGGTCC,0,1273521
furpa,0.3333333333333333,2,2,GGCTGAGGGGCTTCACTTAA,0,1284961
furpa,0.3333333333333333,2,2,GGCTCGGGGTAGAAGATTCG,0,1321803
furpa,0.3333333333333333,2,2,GGCTACCTAGTGCACAGCCG,0,1318033
furpa,0.3333333333333333,2,2,GGCTAAGACACGTGAGTCAG,0,1276246
furpa,0.3333333333333333,2,2,GGCTAACCTGCAAGGGTTTT,0,1321798
furpa,0.3333333333333333,2,2,GGCGTGTGTTCCGCGCACAA,0,1324534
furpa,0.3333333333333333,2,2,GGCGTGGGGCATCTACGTCG,0,1355159
furpa,0.3333333333333333,2,2,GGCGGGAAGGACGCTTAATA,0,1280206
furpa,0.3333333333333333,2,2,GGCGGCTACGGACTACTCGC,0,1336723
furpa,0.3333333333333333,2,2,GGCGGACAAGTGGCCTTTCG,0,1295387
furpa,0.3333333333333333,2,2,GGCGCGTCTTTTCCTTGGAC,0,1315958
furpa,0.3333333333333333,2,2,GGCGCCGGCGCCTGAGTGCT,0,1347335
furpa,0.3333333333333333,2,2,GGCGATTTTACTGAAGATGG,0,1355122
furpa,0.3333333333333333,2,2,GGCGATTTCAGCGATCGAAA,0,1336909
furpa,0.3333333333333333,2,2,GGCGATGGTATAGGATGTAG,0,1326750
furpa,0.3333333333333333,2,2,GGCGATATTATGCGTGTAAG,0,1329901
furpa,0.3333333333333333,2,2,GGCGACGAGCAGCCCGCGGA,0,1285112
furpa,0.3333333333333333,2,2,GGCGACCCCAGATCAACACA,0,1314575
furpa,0.3333333333333333,2,2,GGCCTGGGCCATGGACGGGG,0,1326625
furpa,0.3333333333333333,2,2,GGCCTGACAGCAAAATGCTG,0,1319636
furpa,0.3333333333333333,2,2,GGCCTCTAGGGGTAATCAAC,0,1297449
furpa,0.3333333333333333,2,2,GGCCTAATCCGGGCGGTAGG,0,1289406
furpa,0.3333333333333333,2,2,GGCCTAACCTTGCTGGACAT,0,1297692
furpa,0.3333333333333333,2,2,GGCCGTTAGTTTGATCACCG,0,1312480
furpa,0.3333333333333333,2,2,GGCCGTTAGCTTTGGATATC,0,1309024
furpa,0.3333333333333333,2,2,GGCCGTCCGTTGAATTGCCC,0,1274413
furpa,0.3333333333333333,2,2,GGCCGGCAGCCTCAAATTGG,0,1273512
furpa,0.3333333333333333,2,2,GGCCAGACTGTTCAAGTGGT,0,1309356
furpa,0.3333333333333333,2,2,GGCATGAGTAGTCACATGGA,0,1357727
furpa,0.3333333333333333,2,2,GGCAGTTGCCAACAGGCACG,0,1340596
furpa,0.3333333333333333,2,2,GGCAGGGCGGTTTGTCCTCC,0,1343000
furpa,0.3333333333333333,2,2,GGCAGAGAGGTCAGGGGTAT,0,1329781
furpa,0.3333333333333333,2,2,GGCACTCCATAAGCGAATAT,0,1339607
furpa,0.3333333333333333,2,2,GGCACCGGCAAGCCCATTCG,0,1307017
furpa,0.3333333333333333,2,2,GGCAATTCACTAGATGGGGT,0,1342833
furpa,0.3333333333333333,2,2,GGCAAAATAGTCTATACAGG,0,1354724
furpa,0.3333333333333333,2,2,GGATTGAATATATACCGGAC,0,1301278
furpa,0.3333333333333333,2,2,GGATTCCCTTGCAACCTACC,0,1326101
furpa,0.3333333333333333,2,2,GGATTAGTAACCACCAACTT,0,1275450
furpa,0.3333333333333333,2,2,GGATTAGTAAAGGTACACCT,0,1302443
furpa,0.3333333333333333,2,2,GGATTACAACCGGCGAGGTA,0,1290463
furpa,0.3333333333333333,2,2,GGATGTCGAGGCGTACACAG,0,1328863
furpa,0.3333333333333333,2,2,GGATCAGTATGGCGCTCGAA,0,1356364
furpa,0.3333333333333333,2,2,GGATATGTTGTACCGGCACG,0,1319237
furpa,0.3333333333333333,2,2,GGATAGGTTAGGGTAAGAAC,0,1280264
furpa,0.3333333333333333,2,2,GGATAATCTAGTAGTATTTT,0,1275451
furpa,0.3333333333333333,2,2,GGAGTGGTATTGGAAGGCGA,0,1320386
furpa,0.3333333333333333,2,2,GGAGTGCATATTAGGTCCGA,0,1305467
furpa,0.3333333333333333,2,2,GGAGTAGGTAGCTTGTCAGA,0,1329256
furpa,0.3333333333333333,2,2,GGAGGTGTATTTCCCTGCGA,0,1291088
furpa,0.3333333333333333,2,2,GGAGGACACTCATTTCATAC,0,1290903
furpa,0.3333333333333333,2,2,GGAGCTGTCAACTCTGGAGA,0,1357310
furpa,0.3333333333333333,2,2,GGAGCGGTAGTCCATAAGGA,0,1342381
furpa,0.3333333333333333,2,2,GGAGCCTCGGCCGAGGGTGA,0,1341260
furpa,0.3333333333333333,2,2,GGAGCCACTTAGAAACTAGT,0,1326360
furpa,0.3333333333333333,2,2,GGAGAATACTCGACCTGCAG,0,1289541
furpa,0.3333333333333333,2,2,GGACTATGAATAGGAGGATT,0,1314895
furpa,0.3333333333333333,2,2,GGACCAAATGCCCGTGGCTG,0,1321639
furpa,0.3333333333333333,2,2,GGACATATCGACAGGCCGAT,0,1292377
furpa,0.3333333333333333,2,2,GGACAGAGCAGCTGTGAATA,0,1327737
furpa,0.3333333333333333,2,2,GGACACTGAAGGAGATTTAA,0,1310136
furpa,0.3333333333333333,2,2,GGACACACGTGGCGACAAAT,0,1326821
furpa,0.3333333333333333,2,2,GGACAACCGAGGGAACGAAA,0,1286254
furpa,0.3333333333333333,2,2,GGAAGGGCTGCTTGACTTCG,0,1341948
furpa,0.3333333333333333,2,2,GGAACCTTTGACTTGTTAAG,0,1291120
furpa,0.3333333333333333,2,2,GGAACCGATTGGCCAAATCA,0,1303269
furpa,0.3333333333333333,2,2,GGAAATGCGTCGGCGTGACA,0,1343719
furpa,0.3333333333333333,2,2,GGAAATAGATTTTAAATAGT,0,1333396
furpa,0.3333333333333333,2,2,GGAAAGAGACTCGATTATCA,0,1297370
furpa,0.3333333333333333,2,2,GGAAACTGTCGTGACCTACA,0,1320446
furpa,0.3333333333333333,2,2,GGAAACTCGCCAAGGACGGA,0,1357023
furpa,0.3333333333333333,2,2,GGAAAAGGTATGCCAGGGAT,0,1326803
furpa,0.3333333333333333,2,2,GCTTGTATTGGTACGCATCG,0,1274800
furpa,0.3333333333333333,2,2,GCTTAAATGAAAGCGTTGTA,0,1306157
furpa,0.3333333333333333,2,2,GCTGTCTGCATGAGGCGTGA,0,1280576
furpa,0.3333333333333333,2,2,GCTGGGCCTAATAGGATAGT,0,1295025
furpa,0.3333333333333333,2,2,GCTGCTATTTGGTATAGGTA,0,1355505
furpa,0.3333333333333333,2,2,GCTGACTGTATGACTTTTGA,0,1295042
furpa,0.3333333333333333,2,2,GCTGAATAAATAGGATCATT,0,1356691
furpa,0.3333333333333333,2,2,GCTCCCGTGACAATAACTTA,0,1316820
furpa,0.3333333333333333,2,2,GCTCACTTTGCATAAGTGCT,0,1315290
furpa,0.3333333333333333,2,2,GCTATTGGATCTACTAGAGA,0,1288482
furpa,0.3333333333333333,2,2,GCTATGAAGCACGCATTCTC,0,1313834
furpa,0.3333333333333333,2,2,GCTATCTGTAATAAAAGCCT,0,1282835
furpa,0.3333333333333333,2,2,GCTAGCTTGTCACTGAGTTT,0,1293168
furpa,0.3333333333333333,2,2,GCTAGCGGCTTACGTTTGAA,0,1289772
furpa,0.3333333333333333,2,2,GCTAGCCTGCGAAATCAAGT,0,1340325
furpa,0.3333333333333333,2,2,GCTACTACGGAGGGTACGAC,0,1333676
furpa,0.3333333333333333,2,2,GCTACCGAGCACCCCGTACG,0,1347964
furpa,0.3333333333333333,2,2,GCTACAGTGGTATCTCGATA,0,1275604
furpa,0.3333333333333333,2,2,GCTAAGAGTACAGGACACGC,0,1335230
furpa,0.3333333333333333,2,2,GCTAACGTAATGTGCCCCGA,0,1320134
furpa,0.3333333333333333,2,2,GCTAAAAAGGTGACCAGTCC,0,1314544
furpa,0.3333333333333333,2,2,GCGTTGGGCCGTAAGCGGTT,0,1291888
furpa,0.3333333333333333,2,2,GCGTGCACAGTAATCGTGTG,0,1307932
furpa,0.3333333333333333,2,2,GCGTCTCCAACATCAAAAAT,0,1300464
furpa,0.3333333333333333,2,2,GCGTCGCGGGCTATTCAGGG,0,1275526
furpa,0.3333333333333333,2,2,GCGTCACTGTCTGCACGCAG,0,1338892
furpa,0.3333333333333333,2,2,GCGTCAAGGGGCGACGATAG,0,1300613
furpa,0.3333333333333333,2,2,GCGTATGCGCGCACTAATCC,0,1329514
furpa,0.3333333333333333,2,2,GCGTAGGATTAATCCATTGT,0,1294228
furpa,0.3333333333333333,2,2,GCGTAAAGTAGTCCGAGAAT,0,1339908
furpa,0.3333333333333333,2,2,GCGGTCGTGGCTTTCTCTGC,0,1313227
furpa,0.3333333333333333,2,2,GCGGGTCGTCGGAGCAACCA,0,1357405
furpa,0.3333333333333333,2,2,GCGGGGCTCTGATAGCACCC,0,1318746
furpa,0.3333333333333333,2,2,GCGGGCAACGCCATGTAATT,0,1354877
furpa,0.3333333333333333,2,2,GCGGGATGGCATCATGGTTG,0,1344887
furpa,0.3333333333333333,2,2,GCGGCCCACACGGACTGAAT,0,1285517
furpa,0.3333333333333333,2,2,GCGGAATTCGTTGAGGTAAC,0,1288689
furpa,0.3333333333333333,2,2,GCGCTTCGCGATTGGTCTTG,0,1282207
furpa,0.3333333333333333,2,2,GCGCTGGCACGCTGCGCTGA,0,1279205
furpa,0.3333333333333333,2,2,GCGCTCGTACTTTGAGTCAG,0,1330941
furpa,0.3333333333333333,2,2,GCGCGGTCCTATGCTTACAC,0,1325540
furpa,0.3333333333333333,2,2,GCGCGGGGAGTGTGAGCGAC,0,1311386
furpa,0.3333333333333333,2,2,GCGCGATAGTTTCACCTGAA,0,1330662
furpa,0.3333333333333333,2,2,GCGCCCGGTACCATTGTAAT,0,1298837
furpa,0.3333333333333333,2,2,GCGCAGGGGAGGGGGAATAT,0,1355581
furpa,0.3333333333333333,2,2,GCGATTTAAATGGCACTAAA,0,1275194
furpa,0.3333333333333333,2,2,GCGATTGGACACTCACGTGT,0,1291072
furpa,0.3333333333333333,2,2,GCGACTTGTGTTATGGAGTT,0,1293370
furpa,0.3333333333333333,2,2,GCGACTCACGCCGCAGTCGT,0,1349328
furpa,0.3333333333333333,2,2,GCGACGGAACCCTGAATATT,0,1336125
furpa,0.3333333333333333,2,2,GCGACATGCTTTCCGACGGT,0,1353102
furpa,0.3333333333333333,2,2,GCGAATTGACCCGACTTGGG,0,1333597
furpa,0.3333333333333333,2,2,GCCTTTCGATTAGATGCGGC,0,1311703
furpa,0.3333333333333333,2,2,GCCTGGGTGTGTGGCTCATC,0,1278988
furpa,0.3333333333333333,2,2,GCCTGATGGGCGGGCCTTCA,0,1292310
furpa,0.3333333333333333,2,2,GCCTCCGCGCACGGCAGTGA,0,1347848
furpa,0.3333333333333333,2,2,GCCTAGCCGTCGGCGTGAGT,0,1312844
furpa,0.3333333333333333,2,2,GCCGTTACTGAAACGCAGAT,0,1342317
furpa,0.3333333333333333,2,2,GCCGTGGAGCAAATAATTCA,0,1306717
furpa,0.3333333333333333,2,2,GCCGTATGGCAATCTTAGGT,0,1344951
furpa,0.3333333333333333,2,2,GCCGCCATGGAGATCATATT,0,1298180
furpa,0.3333333333333333,2,2,GCCCGTGAGCACTAGCGGGA,0,1327686
furpa,0.3333333333333333,2,2,GCCCCTGTCCAGCTTGTTCC,0,1353947
furpa,0.3333333333333333,2,2,GCCCCCTTCCCACAGTTCGT,0,1345046
furpa,0.3333333333333333,2,2,GCCCCAGTGTAATCCGTAAT,0,1297478
furpa,0.3333333333333333,2,2,GCCCCAAATCGGAACCCATT,0,1300435
furpa,0.3333333333333333,2,2,GCCCACGGCACATCGATGGA,0,1285101
furpa,0.3333333333333333,2,2,GCCATGCAGAAACAAGAATT,0,1340969
furpa,0.3333333333333333,2,2,GCCATACCTGAACGGCGTGG,0,1300618
furpa,0.3333333333333333,2,2,GCCAGGGGGGAGACACGGCC,0,1289658
furpa,0.3333333333333333,2,2,GCCAGACAAACGGGGCAGCA,0,1290361
furpa,0.3333333333333333,2,2,GCCACCGATACGTTTAACGT,0,1291696
furpa,0.3333333333333333,2,2,GCATTCCATCGCAAGGTTCA,0,1343871
furpa,0.3333333333333333,2,2,GCATGAAACTCGACCCCCTG,0,1289912
furpa,0.3333333333333333,2,2,GCATATTTTTAGTTAACAAC,0,1303993
furpa,0.3333333333333333,2,2,GCAGGATTCGCCCAACGAGA,0,1344899
furpa,0.3333333333333333,2,2,GCAGCGTACTCCCATGCTGG,0,1353432
furpa,0.3333333333333333,2,2,GCAGCGACAGGATCTTGCGG,0,1321305
furpa,0.3333333333333333,2,2,GCAGAGTAGAAGTGCGCGTA,0,1294660
furpa,0.3333333333333333,2,2,GCAGAAAGGTCTGCGTTCCC,0,1354635
furpa,0.3333333333333333,2,2,GCACTGGCCTGCTTTATTTC,0,1282081
furpa,0.3333333333333333,2,2,GCACGTGCGGATCGTAAACT,0,1281123
furpa,0.3333333333333333,2,2,GCACGTATGAGGTCATTGAT,0,1331738
furpa,0.3333333333333333,2,2,GCACGAACACTTGGAGCGAG,0,1276057
furpa,0.3333333333333333,2,2,GCACCTTTACCGAGTGATTA,0,1332446
furpa,0.3333333333333333,2,2,GCACACATCCGTGAAATTCA,0,1349662
furpa,0.3333333333333333,2,2,GCAATTTTGTTATTCTCGAA,0,1273186
furpa,0.3333333333333333,2,2,GCAATCCGATGCGCTTGCAT,0,1293254
furpa,0.3333333333333333,2,2,GCAATAAACTCGATGTGATT,0,1299135
furpa,0.3333333333333333,2,2,GCAAGGGGTCGGCAGCGATT,0,1348496
furpa,0.3333333333333333,2,2,GCAAGCGAGGTCATACTACG,0,1313519
furpa,0.3333333333333333,2,2,GCAAGATCCGATTACCGGCT,0,1327140
furpa,0.3333333333333333,2,2,GCAACTCGAAATCTATGCGT,0,1312867
furpa,0.3333333333333333,2,2,GCAACGATTCGGCAAGATCG,0,1339438
furpa,0.3333333333333333,2,2,GCAACCGATGCACCTAACAC,0,1318735
furpa,0.3333333333333333,2,2,GCAACCACCCCAATCCACCT,0,1342376
furpa,0.3333333333333333,2,2,GCAACAGAAAGAAAGTCCCG,0,1273092
furpa,0.3333333333333333,2,2,GATTTCGCACGGAACAGGTC,0,1339662
furpa,0.3333333333333333,2,2,GATTCGTTACAAAAGAATTT,0,1335299
furpa,0.3333333333333333,2,2,GATGTGCTCAAGGTTCATTG,0,1278339
furpa,0.3333333333333333,2,2,GATGGCCGATATGTTATGGT,0,1284335
furpa,0.3333333333333333,2,2,GATGCTTACAAGCGGGACTC,0,1294521
furpa,0.3333333333333333,2,2,GATGCCCCGTTAGTAAGTAA,0,1318295
furpa,0.3333333333333333,2,2,GATGAGCTTCCACCCCCTGC,0,1274199
furpa,0.3333333333333333,2,2,GATGAACGCTCTATTCAATG,0,1344093
furpa,0.3333333333333333,2,2,GATCGAGAATGTCTGGGACA,0,1276711
furpa,0.3333333333333333,2,2,GATCATTAGTGATGATCGGA,0,1330782
furpa,0.3333333333333333,2,2,GATATGGTTTTGTTGCGGCA,0,1323128
furpa,0.3333333333333333,2,2,GATATCCGACTCTCTTCCCG,0,1334609
furpa,0.3333333333333333,2,2,GATACCGGGGCTAAACGATG,0,1275379
furpa,0.3333333333333333,2,2,GATACATAGTCGTCGAGTTA,0,1312366
furpa,0.3333333333333333,2,2,GATAATCTTCCCCGATACCC,0,1334269
furpa,0.3333333333333333,2,2,GATAAGACATTCGTGGCGTT,0,1326607
furpa,0.3333333333333333,2,2,GAGTTTGTAGGCGCTGGGGC,0,1307361
furpa,0.3333333333333333,2,2,GAGTGGAGTTTGCGAGCAAA,0,1278748
furpa,0.3333333333333333,2,2,GAGTACGCTTGACTCAGATC,0,1306689
furpa,0.3333333333333333,2,2,GAGTACCCCCTCGGAAAATC,0,1324767
furpa,0.3333333333333333,2,2,GAGTAAAATGTCCGATGTTT,0,1330023
furpa,0.3333333333333333,2,2,GAGGTTATCGTTTACAAGCA,0,1356436
furpa,0.3333333333333333,2,2,GAGGTGTACAGCCATCGTGA,0,1297866
furpa,0.3333333333333333,2,2,GAGGTCCGGTGGTGCGGCTC,0,1285098
furpa,0.3333333333333333,2,2,GAGGGTACAGACACCTCAGT,0,1274941
furpa,0.3333333333333333,2,2,GAGGGATGCCGATTCTGGTG,0,1278672
furpa,0.3333333333333333,2,2,GAGGGAATGTATAGATTTGA,0,1310404
furpa,0.3333333333333333,2,2,GAGGGAAAGCCTTCAGTGGA,0,1344785
furpa,0.3333333333333333,2,2,GAGGCAGGGGTTTCTCATGC,0,1292688
furpa,0.3333333333333333,2,2,GAGCTTCGGGCGGCGGACGG,0,1351556
furpa,0.3333333333333333,2,2,GAGCGTCTCGACCCGCGGGG,0,1325668
furpa,0.3333333333333333,2,2,GAGCGGGACTCAGGTAGCGC,0,1321781
furpa,0.3333333333333333,2,2,GAGCGATAGGCCTCAAGTCG,0,1354279
furpa,0.3333333333333333,2,2,GAGCCGGGGGCAGTTCTGCT,0,1282090
furpa,0.3333333333333333,2,2,GAGCCAAGGGTTCCGCGTCG,0,1319574
furpa,0.3333333333333333,2,2,GAGCCAACGTTTATATTCTA,0,1350296
furpa,0.3333333333333333,2,2,GAGCAGCCCTGCGCCATCGA,0,1343945
furpa,0.3333333333333333,2,2,GAGAGTCCGGGTATATTTTA,0,1288463
furpa,0.3333333333333333,2,2,GACTTGCGAGTGGCACTCCC,0,1275729
furpa,0.3333333333333333,2,2,GACTGGGTCATACTGGATCG,0,1310368
furpa,0.3333333333333333,2,2,GACTGGAATCCCTCGAGTCA,0,1315959
furpa,0.3333333333333333,2,2,GACTCTTTTCACGAGACACA,0,1334563
furpa,0.3333333333333333,2,2,GACTACCCCAACATATCTCA,0,1293115
furpa,0.3333333333333333,2,2,GACTAACATTGACCGCTCTC,0,1329013
furpa,0.3333333333333333,2,2,GACGGTTGTAGAAAGTCGCT,0,1285730
furpa,0.3333333333333333,2,2,GACGGTCGCCCCTGTTTCAG,0,1283882
furpa,0.3333333333333333,2,2,GACGGGCTCCGCCAGATCCA,0,1322562
furpa,0.3333333333333333,2,2,GACGCCGTGGGACTGCCATT,0,1315880
furpa,0.3333333333333333,2,2,GACGATGCCAATTTGGATGT,0,1298749
furpa,0.3333333333333333,2,2,GACGAATTCTTACGCTGATG,0,1275014
furpa,0.3333333333333333,2,2,GACCTTTATATGAACCGACA,0,1308221
furpa,0.3333333333333333,2,2,GACCTGTCACGGACTAGGGC,0,1287938
furpa,0.3333333333333333,2,2,GACCTCAAGGAATGACCTTG,0,1281720
furpa,0.3333333333333333,2,2,GACCGTCGTGTATGTCGGGA,0,1338703
furpa,0.3333333333333333,2,2,GACCGTCAACGAAATTTCGT,0,1298915
furpa,0.3333333333333333,2,2,GACCGCAATAATTAATTATT,0,1274314
furpa,0.3333333333333333,2,2,GACCGAAGCGTACGGCCGAG,0,1302277
furpa,0.3333333333333333,2,2,GACCCGCATGCCATAGATTA,0,1316245
furpa,0.3333333333333333,2,2,GACCAGCGTGGAACCAATTC,0,1300619
furpa,0.3333333333333333,2,2,GACATCGCAATTAGTCAGGG,0,1306252
furpa,0.3333333333333333,2,2,GACACGACAACTTGTCAGGT,0,1343197
furpa,0.3333333333333333,2,2,GACACCAGAGTATAATAGCT,0,1341015
furpa,0.3333333333333333,2,2,GACAAGCCCACCGGGGGTTT,0,1348054
furpa,0.3333333333333333,2,2,GAATTTTGATCACGGAGTGG,0,1310898
furpa,0.3333333333333333,2,2,GAATTTAGAGCCCATCACTC,0,1307221
furpa,0.3333333333333333,2,2,GAATTGTGAGTAGACACGGG,0,1311001
furpa,0.3333333333333333,2,2,GAATTGGAGCCTGATTCAGC,0,1338280
furpa,0.3333333333333333,2,2,GAATTATTACGGCCTCGCTT,0,1325036
furpa,0.3333333333333333,2,2,GAATGGCGGGATGCAGATCT,0,1272782
furpa,0.3333333333333333,2,2,GAATCCATTACTGACGAGGA,0,1336357
furpa,0.3333333333333333,2,2,GAATAGGGAGGTGGTGGAGG,0,1321633
furpa,0.3333333333333333,2,2,GAATACTGGCGATTTGCACG,0,1288155
furpa,0.3333333333333333,2,2,GAAGTTCGCATATTTCACGG,0,1282438
furpa,0.3333333333333333,2,2,GAAGTTCCATCTGTATCTTC,0,1284883
furpa,0.3333333333333333,2,2,GAAGTATCCTCTTCAAAAGG,0,1328945
furpa,0.3333333333333333,2,2,GAAGGATGCGATGGAGACCT,0,1309478
furpa,0.3333333333333333,2,2,GAAGCCCTATATCTGGCACA,0,1342847
furpa,0.3333333333333333,2,2,GAAGCAAGATACCGCGACTC,0,1286302
furpa,0.3333333333333333,2,2,GAAGACATCACTCCGGGGAG,0,1320863
furpa,0.3333333333333333,2,2,GAAGAACAAGTCTCAAAGAA,0,1348765
furpa,0.3333333333333333,2,2,GAACTCAAGTGATTACAGTA,0,1336664
furpa,0.3333333333333333,2,2,GAACTATGCCCGCATAAGCC,0,1278918
furpa,0.3333333333333333,2,2,GAACCGACTCAATCGTCGCA,0,1286263
furpa,0.3333333333333333,2,2,GAACATACATCGTGAAGCGA,0,1311523
furpa,0.3333333333333333,2,2,GAAATCTTTCAAGCGTACAT,0,1349334
furpa,0.3333333333333333,2,2,GAAAGGGAAAATGACCATTA,0,1333977
furpa,0.3333333333333333,2,2,GAAAGAGATCGGATGTTTGT,0,1350442
furpa,0.3333333333333333,2,2,GAAAGAACGAGAGAAACAGG,0,1277514
furpa,0.3333333333333333,2,2,GAAACTCAGTGGCATGCTCC,0,1315129
furpa,0.3333333333333333,2,2,GAAACACTCTGAGTCTCCCC,0,1345364
furpa,0.3333333333333333,2,2,GAAACAAACCCGAAATTGAT,0,1349845
furpa,0.3333333333333333,2,2,GAAAAAAATAGACTCTAGGT,0,1274120
furpa,0.3333333333333333,2,2,CTTTTTGCGCCTACAGAAGA,0,1286163
furpa,0.3333333333333333,2,2,CTTTTGTCGGTTCCGGTAAA,0,1291455
furpa,0.3333333333333333,2,2,CTTTGGTAGGCCACACGGGA,0,1304961
furpa,0.3333333333333333,2,2,CTTTGGCAGATGTTTGGATC,0,1294620
furpa,0.3333333333333333,2,2,CTTTGAAATGCGACTATTCG,0,1311155
furpa,0.3333333333333333,2,2,CTTTCTATCTTCATTAGAGC,0,1287660
furpa,0.3333333333333333,2,2,CTTTCACTACTTTGACCTAC,0,1356175
furpa,0.3333333333333333,2,2,CTTTATCAATACCTGACTCT,0,1287582
furpa,0.3333333333333333,2,2,CTTTAGTATGTTATAGTGCA,0,1276061
furpa,0.3333333333333333,2,2,CTTTACCGGAGGCCTATACA,0,1282343
furpa,0.3333333333333333,2,2,CTTTACCATTTTGGCCATAT,0,1286291
furpa,0.3333333333333333,2,2,CTTTAACGGTTTCCGGTCCT,0,1316856
furpa,0.3333333333333333,2,2,CTTGTTGGGATCGGTTCACA,0,1300040
furpa,0.3333333333333333,2,2,CTTGTGTCAAGGACATGATT,0,1310392
furpa,0.3333333333333333,2,2,CTTGGTTCGATGCTCCCACG,0,1297899
furpa,0.3333333333333333,2,2,CTTGGCAGCATCGCGTATAC,0,1309329
furpa,0.3333333333333333,2,2,CTTGGATATCTTGGTCAACT,0,1306004
furpa,0.3333333333333333,2,2,CTTGAGGTTTGAATCATTTA,0,1309120
furpa,0.3333333333333333,2,2,CTTGACCTAGGGTGACCCTA,0,1328840
furpa,0.3333333333333333,2,2,CTTCTTCGTCTTCCTTCACC,0,1328466
furpa,0.3333333333333333,2,2,CTTCGACCCTGTGCGTCCTG,0,1310748
furpa,0.3333333333333333,2,2,CTTCATGCATAGTGCATTCA,0,1337520
furpa,0.3333333333333333,2,2,CTTCAGTTTCAGGGAATCCC,0,1345652
furpa,0.3333333333333333,2,2,CTTATTACATAGAGATTGTT,0,1273747
furpa,0.3333333333333333,2,2,CTTATGGCGTTGCACCCCTC,0,1280799
furpa,0.3333333333333333,2,2,CTTATCTATTTGCAAATCTT,0,1318640
furpa,0.3333333333333333,2,2,CTTATCAATCGCTGTGCCGT,0,1336829
furpa,0.3333333333333333,2,2,CTTATATCGAAAAGTTAGAT,0,1309906
furpa,0.3333333333333333,2,2,CTTATACTGAGGTCCTCCTA,0,1291018
furpa,0.3333333333333333,2,2,CTTAGTGAGGGATCCCCTGC,0,1316202
furpa,0.3333333333333333,2,2,CTTACGGAGAAGTTATGAAG,0,1338070
furpa,0.3333333333333333,2,2,CTTACGAGTTGACTCCATTC,0,1298191
furpa,0.3333333333333333,2,2,CTTACCTTGTCGCACACGAC,0,1297186
furpa,0.3333333333333333,2,2,CTTAATGGCTTAGTTGCGGT,0,1285043
furpa,0.3333333333333333,2,2,CTTAAGCACTTCCCGAATGG,0,1326366
furpa,0.3333333333333333,2,2,CTTAACGTGGCGCGCGTCGT,0,1295347
furpa,0.3333333333333333,2,2,CTGTTGCACTGCCAGTGGGC,0,1353920
furpa,0.3333333333333333,2,2,CTGTTCTCTTGAGACTGTTC,0,1283308
furpa,0.3333333333333333,2,2,CTGTTATGTGCACGGAGGAC,0,1320047
furpa,0.3333333333333333,2,2,CTGTAAGCCTACGTTTATAA,0,1278772
furpa,0.3333333333333333,2,2,CTGGGTCTATCGCGGAAAAA,0,1301619
furpa,0.3333333333333333,2,2,CTGGGAGGCACACTCAGGGT,0,1345950
furpa,0.3333333333333333,2,2,CTGGCTTCGGGGCTCTTGGG,0,1308838
furpa,0.3333333333333333,2,2,CTGGCGGTATAGGTGTTCCA,0,1328151
furpa,0.3333333333333333,2,2,CTGGCCGACAAATCTAGAAG,0,1332967
furpa,0.3333333333333333,2,2,CTGGCACCGTCCACAGGTAT,0,1318915
furpa,0.3333333333333333,2,2,CTGGACATGGGAATGTTTTG,0,1302888
furpa,0.3333333333333333,2,2,CTGGAACTTTCGGCTCTACA,0,1356271
furpa,0.3333333333333333,2,2,CTGCGCCAGCTCCCCGCATG,0,1285707
furpa,0.3333333333333333,2,2,CTGCGCAGAGAGGTGCGAAT,0,1321995
furpa,0.3333333333333333,2,2,CTGCCCAGGCATGGCACCGT,0,1294125
furpa,0.3333333333333333,2,2,CTGCATGTTACTGTTATCGC,0,1325719
furpa,0.3333333333333333,2,2,CTGCACGCAGGCAACGATTA,0,1277443
furpa,0.3333333333333333,2,2,CTGATTTGATTTAAGCCAAC,0,1279795
furpa,0.3333333333333333,2,2,CTGAGCTCTGGTTGCATTCA,0,1314442
furpa,0.3333333333333333,2,2,CTGAGCCGAAGAAGATAGGA,0,1272593
furpa,0.3333333333333333,2,2,CTGAGACGTTTGTGATGACC,0,1350319
furpa,0.3333333333333333,2,2,CTGACAATCGTCGTTTGCCC,0,1287280
furpa,0.3333333333333333,2,2,CTGAATGTCGCTAAATAGAT,0,1349451
furpa,0.3333333333333333,2,2,CTCTTTCGTGAATTGGCCTA,0,1298002
furpa,0.3333333333333333,2,2,CTCTTCATAGGGGAGAAAAC,0,1276304
furpa,0.3333333333333333,2,2,CTCTGTTCATAGTGGCGCGG,0,1335414
furpa,0.3333333333333333,2,2,CTCTGAGCCCCAATGTGGCG,0,1328163
furpa,0.3333333333333333,2,2,CTCTCTTTGTAAGCTGTGCA,0,1276560
furpa,0.3333333333333333,2,2,CTCTCTCAACTACTCCGCTA,0,1311512
furpa,0.3333333333333333,2,2,CTCTCGAAATTAAGATGAGT,0,1305866
furpa,0.3333333333333333,2,2,CTCTCCTTATACCTCATCTC,0,1317831
furpa,0.3333333333333333,2,2,CTCTATCAAAGTGGAGGTAT,0,1290703
furpa,0.3333333333333333,2,2,CTCTACCATAGCCTTCCGGA,0,1302557
furpa,0.3333333333333333,2,2,CTCGTTGGATTAACGCAGGG,0,1273146
furpa,0.3333333333333333,2,2,CTCGTTCTTCGTAGGGGTTT,0,1278718
furpa,0.3333333333333333,2,2,CTCGTTAAAGTTAAGCGATT,0,1305952
furpa,0.3333333333333333,2,2,CTCGTCTGACGCTTGGACAT,0,1310674
furpa,0.3333333333333333,2,2,CTCGGGTTAGTCCATATGCA,0,1310028
furpa,0.3333333333333333,2,2,CTCGGCTCTGGGGAGTCGAG,0,1339416
furpa,0.3333333333333333,2,2,CTCGGCCAGCACCCCAGGCC,0,1317802
furpa,0.3333333333333333,2,2,CTCGCGGGCATCTTCCGCAT,0,1325720
furpa,0.3333333333333333,2,2,CTCGCCGTACTTAAGTTCGA,0,1305502
furpa,0.3333333333333333,2,2,CTCGATTGAAACTCAACTTA,0,1353395
furpa,0.3333333333333333,2,2,CTCGACAATCCCTCCGCTGC,0,1315441
furpa,0.3333333333333333,2,2,CTCGAAGTGCAGATTTTCCT,0,1310339
furpa,0.3333333333333333,2,2,CTCCTTGACGGGTCAACAAT,0,1298788
furpa,0.3333333333333333,2,2,CTCCTCGAATATACATACTT,0,1293634
furpa,0.3333333333333333,2,2,CTCCTCAGGGACCGCTGTAA,0,1318851
furpa,0.3333333333333333,2,2,CTCCGGTTTATAGACGGTCT,0,1282695
furpa,0.3333333333333333,2,2,CTCCGGACCCTGAAATTCCT,0,1341200
furpa,0.3333333333333333,2,2,CTCCGACTAGGCCGCTAGTC,0,1314221
furpa,0.3333333333333333,2,2,CTCCCTCTTGTTAAATATAA,0,1284711
furpa,0.3333333333333333,2,2,CTCCCCATTAAGTTAATAGA,0,1333158
furpa,0.3333333333333333,2,2,CTCCAGAGATCAAGGTCCCG,0,1308366
furpa,0.3333333333333333,2,2,CTCCACTTCCGTCAGCACTT,0,1311828
furpa,0.3333333333333333,2,2,CTCCAAAAAACCAACCCTAC,0,1274406
furpa,0.3333333333333333,2,2,CTCATTGTGGTGCTAGACCA,0,1294166
furpa,0.3333333333333333,2,2,CTCATTCTGGGCTTAGCTTG,0,1331992
furpa,0.3333333333333333,2,2,CTCAGTTCGGCGTTGCCGCT,0,1292760
furpa,0.3333333333333333,2,2,CTCACGCCACGAGGGGGAAA,0,1286361
furpa,0.3333333333333333,2,2,CTCACGAATGGACAACGTAA,0,1305454
furpa,0.3333333333333333,2,2,CTCACACCAGTAGAGCGTGT,0,1323492
furpa,0.3333333333333333,2,2,CTCAAGACTGCACGGAATGT,0,1311395
furpa,0.3333333333333333,2,2,CTATTTGCCACGTCGCTATC,0,1281403
furpa,0.3333333333333333,2,2,CTATTTACTGCGCGCACACG,0,1316123
furpa,0.3333333333333333,2,2,CTATTCGTTCTGTGAGAAGA,0,1342891
furpa,0.3333333333333333,2,2,CTATGTTATATTGTATGTTG,0,1353671
furpa,0.3333333333333333,2,2,CTATCTATTTTCATGAAGGT,0,1322934
furpa,0.3333333333333333,2,2,CTATCGTCAAGGGGAGCGAA,0,1308318
furpa,0.3333333333333333,2,2,CTATCGCAGGGAAATGAGAC,0,1356763
furpa,0.3333333333333333,2,2,CTATCCCGAAAGTCGGTCTG,0,1277520
furpa,0.3333333333333333,2,2,CTATCAGTGTATCGCGAGCC,0,1284861
furpa,0.3333333333333333,2,2,CTATCACCGAGTCAGCCTAT,0,1287953
furpa,0.3333333333333333,2,2,CTATATGCTATCACCACATC,0,1298272
furpa,0.3333333333333333,2,2,CTATAGAGTCGCGCATCCCT,0,1294451
furpa,0.3333333333333333,2,2,CTATAACTCGTCGAAATGCT,0,1308082
furpa,0.3333333333333333,2,2,CTATAACGCTGATTACAGGT,0,1355381
furpa,0.3333333333333333,2,2,CTATAACCCATCTCTCATCA,0,1305505
furpa,0.3333333333333333,2,2,CTAGTTTGCCCCAGAAAACG,0,1320447
furpa,0.3333333333333333,2,2,CTAGTGCCATCGCCGCTACT,0,1335452
furpa,0.3333333333333333,2,2,CTAGGTCTTGTCCGAGGAAA,0,1357758
furpa,0.3333333333333333,2,2,CTAGGGCACTATACATCGGA,0,1350753
furpa,0.3333333333333333,2,2,CTAGGATAGCCAGTTCTCCA,0,1330854
furpa,0.3333333333333333,2,2,CTAGCTTTGTTAGATATCTA,0,1283548
furpa,0.3333333333333333,2,2,CTAGCCGTCGTCGGCATAAT,0,1332607
furpa,0.3333333333333333,2,2,CTAGCCCGCGAATCTAAAAT,0,1282192
furpa,0.3333333333333333,2,2,CTAGATGTTGGGATAACTGT,0,1334842
furpa,0.3333333333333333,2,2,CTACTTTCCCAAAGCCATAT,0,1350327
furpa,0.3333333333333333,2,2,CTACTGCATGTGCTGACCGC,0,1335604
furpa,0.3333333333333333,2,2,CTACGTTCTGTTAGAACTAA,0,1330120
furpa,0.3333333333333333,2,2,CTACGGGCAATGTAATGGCC,0,1300166
furpa,0.3333333333333333,2,2,CTACGGCTCGTCAGATGACG,0,1341155
furpa,0.3333333333333333,2,2,CTACATGGGCCGATGCCGCA,0,1320431
furpa,0.3333333333333333,2,2,CTACACCCTTAACACCTATA,0,1278380
furpa,0.3333333333333333,2,2,CTACAAGGGGCTGGTACATT,0,1351437
furpa,0.3333333333333333,2,2,CTAATTATGTGATCGGTCTG,0,1325854
furpa,0.3333333333333333,2,2,CTAATGCAAAACCAAAAGAA,0,1288122
furpa,0.3333333333333333,2,2,CTAATCTTAGCAGTTCATTA,0,1285751
furpa,0.3333333333333333,2,2,CTAATACCGCGTTTGGTCTA,0,1302012
furpa,0.3333333333333333,2,2,CTAAGTTAAATGGCCGGTAA,0,1302707
furpa,0.3333333333333333,2,2,CTAAGCGAGGTCGTGCGCGT,0,1294939
furpa,0.3333333333333333,2,2,CTAACTATAGAAAACCGACG,0,1275075
furpa,0.3333333333333333,2,2,CTAACAGTCATTTTTATGGC,0,1280523
furpa,0.3333333333333333,2,2,CTAAATTACGTTGAAATATT,0,1332171
furpa,0.3333333333333333,2,2,CTAAACACAGGCTTCGTATA,0,1328238
furpa,0.3333333333333333,2,2,CGTTTTGGTAGCTCTCCCAT,0,1293860
furpa,0.3333333333333333,2,2,CGTTTGCGCAATATTCGTGA,0,1321193
furpa,0.3333333333333333,2,2,CGTTTCGAACTGGGATGCTC,0,1279041
furpa,0.3333333333333333,2,2,CGTTTATAAAACTCGGGAGG,0,1327897
furpa,0.3333333333333333,2,2,CGTTTAAACCAATTAGCCTG,0,1319572
furpa,0.3333333333333333,2,2,CGTTGTAGATGAGAGCGTGG,0,1305737
furpa,0.3333333333333333,2,2,CGTTGCGGCCTCGTTCGATC,0,1325735
furpa,0.3333333333333333,2,2,CGTTGAGCGAGGTTCAGCGC,0,1343337
furpa,0.3333333333333333,2,2,CGTTCGGTAGACTGTAATAA,0,1305265
furpa,0.3333333333333333,2,2,CGTTACCTTTAGTACTTGCG,0,1298960
furpa,0.3333333333333333,2,2,CGTGTTTGGGGATCATCAAT,0,1289234
furpa,0.3333333333333333,2,2,CGTGTCCCCCTGTATCGCTG,0,1323959
furpa,0.3333333333333333,2,2,CGTGGGTTTGGAAGAAGCGC,0,1348085
furpa,0.3333333333333333,2,2,CGTGGCTCCGTGGAGGACGC,0,1293598
furpa,0.3333333333333333,2,2,CGTGCCGTTCCTCCCCTGGG,0,1333049
furpa,0.3333333333333333,2,2,CGTGCAAGCGTGGGTCTCGT,0,1310882
furpa,0.3333333333333333,2,2,CGTGAGCCTATATGTACTAT,0,1308496
furpa,0.3333333333333333,2,2,CGTGACACGGTGAGCAGGAA,0,1298164
furpa,0.3333333333333333,2,2,CGTCTTCAAAGAATGTTGGT,0,1314095
furpa,0.3333333333333333,2,2,CGTCTGTGACGGGGGTAACA,0,1305246
furpa,0.3333333333333333,2,2,CGTCGTCGTAGCCAGGACGT,0,1332884
furpa,0.3333333333333333,2,2,CGTCCTGGCTTAAAACACGT,0,1286882
furpa,0.3333333333333333,2,2,CGTCCGTTAAAGCTCCAGTA,0,1308698
furpa,0.3333333333333333,2,2,CGTCAGTAGTCTCATGTAAG,0,1285058
furpa,0.3333333333333333,2,2,CGTCACTTTCGGCTATCACA,0,1342198
furpa,0.3333333333333333,2,2,CGTATTCGCACAAACGCATT,0,1334871
furpa,0.3333333333333333,2,2,CGTATAGTGCCGAGACGGAC,0,1320913
furpa,0.3333333333333333,2,2,CGTAGCCTGTATGGTCCCAT,0,1334397
furpa,0.3333333333333333,2,2,CGTACTATGCGCGTGAGACC,0,1291766
furpa,0.3333333333333333,2,2,CGTACCCCGCCAGGCGGACC,0,1300866
furpa,0.3333333333333333,2,2,CGTACATTCAATCTCAGTAG,0,1330999
furpa,0.3333333333333333,2,2,CGTAATAACATCTGATATTG,0,1357122
furpa,0.3333333333333333,2,2,CGTAAGGTGCATAGTATATG,0,1306205
furpa,0.3333333333333333,2,2,CGTAACGCTCTCTGGGGTTT,0,1351739
furpa,0.3333333333333333,2,2,CGTAAATCTTCAGTTATGCC,0,1275723
furpa,0.3333333333333333,2,2,CGTAAACGTATAGGGATCAA,0,1355436
furpa,0.3333333333333333,2,2,CGGTTGAGGGATAGCAGCCA,0,1303475
furpa,0.3333333333333333,2,2,CGGTTCATCGTATAAACAGG,0,1356015
furpa,0.3333333333333333,2,2,CGGTTACTTCCCGTGTCTAT,0,1289905
furpa,0.3333333333333333,2,2,CGGTGTCATGCAACGATAGC,0,1302074
furpa,0.3333333333333333,2,2,CGGTGCATGAACGGATGCCA,0,1322608
furpa,0.3333333333333333,2,2,CGGTCTATACATCAGCGGGT,0,1273605
furpa,0.3333333333333333,2,2,CGGTCGTAGAACCACGGTGA,0,1329812
furpa,0.3333333333333333,2,2,CGGTCCGGAGCGGCAGGTCG,0,1355810
furpa,0.3333333333333333,2,2,CGGTCCGACCCCGCTTGTCC,0,1313431
furpa,0.3333333333333333,2,2,CGGTCAGTCAAACGATTAAG,0,1336608
furpa,0.3333333333333333,2,2,CGGGGGGCGACGCATTCATC,0,1318612
furpa,0.3333333333333333,2,2,CGGGGCTAACCGGAACCCGC,0,1344475
furpa,0.3333333333333333,2,2,CGGGGCGATTCCCATAGAGA,0,1322990
furpa,0.3333333333333333,2,2,CGGGGAGAGTCACATTTTTT,0,1293068
furpa,0.3333333333333333,2,2,CGGGCGTATCTGGGGTGAGA,0,1273644
furpa,0.3333333333333333,2,2,CGGGCGGCCGCCTACTCCTC,0,1346147
furpa,0.3333333333333333,2,2,CGGGCCTGATCGCAGTATTG,0,1339312
furpa,0.3333333333333333,2,2,CGGGACAAACCGGTGTAGAA,0,1298800
furpa,0.3333333333333333,2,2,CGGCTTTAGGGAGTCCTTGG,0,1335563
furpa,0.3333333333333333,2,2,CGGCTGAATAGTATTAATTT,0,1325970
furpa,0.3333333333333333,2,2,CGGCGGTGAGTATCGGTGGT,0,1302265
furpa,0.3333333333333333,2,2,CGGCGGCCGTTAATGCTTAT,0,1354053
furpa,0.3333333333333333,2,2,CGGCGCCACTGGAGATTTAT,0,1288109
furpa,0.3333333333333333,2,2,CGGCGCATCTGCACAAGCAA,0,1349991
furpa,0.3333333333333333,2,2,CGGCGCATAGTCCACCCAAC,0,1314074
furpa,0.3333333333333333,2,2,CGGCGAATTTTCACTAAGGG,0,1319583
furpa,0.3333333333333333,2,2,CGGCAGTGCGTTGCGGCTAA,0,1329396
furpa,0.3333333333333333,2,2,CGGCAAGGGCTTGCCCACGC,0,1306175
furpa,0.3333333333333333,2,2,CGGATTTTTCCTGAGGGCAC,0,1357077
furpa,0.3333333333333333,2,2,CGGATGGTAGCACAAGACAT,0,1314337
furpa,0.3333333333333333,2,2,CGGAGTTGTGGGCATTTAAG,0,1297542
furpa,0.3333333333333333,2,2,CGGAGGTACTTACGAAGGGG,0,1290502
furpa,0.3333333333333333,2,2,CGGAGATTTCTAGCCCCTCT,0,1305755
furpa,0.3333333333333333,2,2,CGGAGACTCTGATTACAAGA,0,1328153
furpa,0.3333333333333333,2,2,CGGACGCTAGCGTGATTCAC,0,1322164
furpa,0.3333333333333333,2,2,CGGACAGTCCGATTCTCCTG,0,1337172
furpa,0.3333333333333333,2,2,CGCTCTGGGTTCGGCGGTTT,0,1338296
furpa,0.3333333333333333,2,2,CGCTCTACGATCTGTACAAC,0,1312149
furpa,0.3333333333333333,2,2,CGCTCCTTGAGAATCGAGGT,0,1341853
furpa,0.3333333333333333,2,2,CGCTAGTCATGTTCCTGGAG,0,1355846
furpa,0.3333333333333333,2,2,CGCTAGGTTGGGTGCGCCGA,0,1300052
furpa,0.3333333333333333,2,2,CGCGTGTGAACTAGGTGGTT,0,1303393
furpa,0.3333333333333333,2,2,CGCGTGGCCAGTGTTGCTAA,0,1279009
furpa,0.3333333333333333,2,2,CGCGTCCAACGTGGGTCTTT,0,1276310
furpa,0.3333333333333333,2,2,CGCGTAGGCTATGGGTCCCT,0,1353304
furpa,0.3333333333333333,2,2,CGCGGTATCCGGCGGACGGA,0,1347183
furpa,0.3333333333333333,2,2,CGCGCGGGCGGCATCTCAGA,0,1331200
furpa,0.3333333333333333,2,2,CGCGCCTCTCGTCGCATTTA,0,1293398
furpa,0.3333333333333333,2,2,CGCGATATCAATCATCAGTG,0,1353893
furpa,0.3333333333333333,2,2,CGCGAGTTGCGCCGGCTTTA,0,1317180
furpa,0.3333333333333333,2,2,CGCCTACCGGTAAACTTTGT,0,1355922
furpa,0.3333333333333333,2,2,CGCCGTATCCTAGCGGTTCT,0,1349268
furpa,0.3333333333333333,2,2,CGCCCGAGCGGAGACTGATT,0,1327608
furpa,0.3333333333333333,2,2,CGCCAGAAAGATGAACTATC,0,1318651
furpa,0.3333333333333333,2,2,CGCCACGATCATGTGGATTC,0,1319031
furpa,0.3333333333333333,2,2,CGCCAACCCTTTCATAGGCT,0,1289231
furpa,0.3333333333333333,2,2,CGCATGATCGGCGTTCTGTA,0,1326285
furpa,0.3333333333333333,2,2,CGCAACCCACGGATGCCTGG,0,1355343
furpa,0.3333333333333333,2,2,CGATTCCCCATAGACGTAGG,0,1273618
furpa,0.3333333333333333,2,2,CGATTAATCTCTGTGCACCT,0,1345440
furpa,0.3333333333333333,2,2,CGATGCGCTTGTATCAGAAG,0,1293889
furpa,0.3333333333333333,2,2,CGATGCAGGACAATATTCAG,0,1313797
furpa,0.3333333333333333,2,2,CGATCGCCCCAGATATCAGT,0,1331166
furpa,0.3333333333333333,2,2,CGATCCCCTGCTAGTACAAG,0,1324600
furpa,0.3333333333333333,2,2,CGATATCTAACTATTTAGTA,0,1318159
furpa,0.3333333333333333,2,2,CGAGTCTGGTAAGAACTATG,0,1314543
furpa,0.3333333333333333,2,2,CGAGTAGCTAGACTTATGTG,0,1332939
furpa,0.3333333333333333,2,2,CGAGGTTTACTTCTCTAGGA,0,1331836
furpa,0.3333333333333333,2,2,CGAGGTTCATGGTATCGTAG,0,1294822
furpa,0.3333333333333333,2,2,CGAGGTCGGCGCGTAAAAGC,0,1312602
furpa,0.3333333333333333,2,2,CGAGGGTTGGTATAGGCTTA,0,1328156
furpa,0.3333333333333333,2,2,CGAGGGTGGGAGGGATTGAT,0,1282528
furpa,0.3333333333333333,2,2,CGAGGCAAATCAACTGCATC,0,1275266
furpa,0.3333333333333333,2,2,CGAGGATACGTACACGTTCT,0,1285129
furpa,0.3333333333333333,2,2,CGAGCCCTATGGAGGGCCAG,0,1354507
furpa,0.3333333333333333,2,2,CGAGCCCGAATTAGTGGTGT,0,1319753
furpa,0.3333333333333333,2,2,CGAGATGTGTCGTTCCGGTG,0,1338991
furpa,0.3333333333333333,2,2,CGAGACGGAATAATGGCCGG,0,1351843
furpa,0.3333333333333333,2,2,CGACTTGGCCAGGCCTTAAC,0,1302576
furpa,0.3333333333333333,2,2,CGACTATAAACCCTTGGTGA,0,1348896
furpa,0.3333333333333333,2,2,CGACTAAGTTCGCTGGACCT,0,1326577
furpa,0.3333333333333333,2,2,CGACGTCATCCGGTAGCTCG,0,1315792
furpa,0.3333333333333333,2,2,CGACGAGGTCCATGATTCTT,0,1274015
furpa,0.3333333333333333,2,2,CGACCAGCCCGCCATGGGGT,0,1320578
furpa,0.3333333333333333,2,2,CGACCAAGATGTTCCGCTTT,0,1282077
furpa,0.3333333333333333,2,2,CGACAGACCGAGTACAAACT,0,1318823
furpa,0.3333333333333333,2,2,CGAATGGAGCGTGAGCTCCA,0,1353440
furpa,0.3333333333333333,2,2,CGAATCTGCTAGAGTTGGGG,0,1339116
furpa,0.3333333333333333,2,2,CGAAGGTATCCATGCGTAAG,0,1313988
furpa,0.3333333333333333,2,2,CGAAGGGAAAAGGAGGAAGT,0,1295454
furpa,0.3333333333333333,2,2,CGAAGAGAAAATGCGGTTAG,0,1337825
furpa,0.3333333333333333,2,2,CGAACTGGGTCGTCCCGCCC,0,1321523
furpa,0.3333333333333333,2,2,CGAACCGGCTAGGAGAGGGA,0,1302362
furpa,0.3333333333333333,2,2,CGAACAATACAGTAATGCGT,0,1288392
furpa,0.3333333333333333,2,2,CGAAATGCGTAAGGCAAGAA,0,1335283
furpa,0.3333333333333333,2,2,CCTTTGTCATTGTATACCTT,0,1323880
furpa,0.3333333333333333,2,2,CCTTTCTCTCCTCTGACCCA,0,1277484
furpa,0.3333333333333333,2,2,CCTTGGTGAGTTCTCGCTTT,0,1273669
furpa,0.3333333333333333,2,2,CCTTGCGGCCGCAGTCCCAC,0,1280764
furpa,0.3333333333333333,2,2,CCTTCTATATAGGTTCGGTA,0,1338645
furpa,0.3333333333333333,2,2,CCTTCAGATACTCCAGGATA,0,1339405
furpa,0.3333333333333333,2,2,CCTTATTAGATAAGAAGATA,0,1277494
furpa,0.3333333333333333,2,2,CCTTATGATCGAATGGTGCC,0,1307734
furpa,0.3333333333333333,2,2,CCTTAAGCGATGCGGATGTC,0,1288279
furpa,0.3333333333333333,2,2,CCTGTGATAAAATTTGAACA,0,1318523
furpa,0.3333333333333333,2,2,CCTGTGAGAGTGACAGCGTG,0,1316267
furpa,0.3333333333333333,2,2,CCTGTCCCCGGCTGACGACG,0,1316647
furpa,0.3333333333333333,2,2,CCTGGGTTGGTCTCCGTCTG,0,1303675
furpa,0.3333333333333333,2,2,CCTGGGCGTTGACGCCTGTG,0,1285144
furpa,0.3333333333333333,2,2,CCTGGCTTGAGCAGGTAGCA,0,1348897
furpa,0.3333333333333333,2,2,CCTGCACATCAGATATACAT,0,1320697
furpa,0.3333333333333333,2,2,CCTGAGGGAGGCCACGGTTG,0,1317941
furpa,0.3333333333333333,2,2,CCTGAAGCCACTGCATACGT,0,1355456
furpa,0.3333333333333333,2,2,CCTGAAACAGGCATCTCCCT,0,1353877
furpa,0.3333333333333333,2,2,CCTCTGCCGGCCGAGCCCAT,0,1309320
furpa,0.3333333333333333,2,2,CCTCTCGGGCACGAGTGTCA,0,1296256
furpa,0.3333333333333333,2,2,CCTCTCCGTAACCCAACGCT,0,1302540
furpa,0.3333333333333333,2,2,CCTCTATGCCGAATTAGATT,0,1280017
furpa,0.3333333333333333,2,2,CCTCGAACTAACTTTGAACA,0,1301440
furpa,0.3333333333333333,2,2,CCTCCAACAGAACTCCGGGG,0,1290566
furpa,0.3333333333333333,2,2,CCTCATTAACCCCACTTGTA,0,1317719
furpa,0.3333333333333333,2,2,CCTAGGGAGAGTTCTTGGAA,0,1346290
furpa,0.3333333333333333,2,2,CCTAGGCGGATTAATTGCCA,0,1326816
furpa,0.3333333333333333,2,2,CCTAGACTGGGGAAGTACTT,0,1285401
furpa,0.3333333333333333,2,2,CCTACCTTAACTGTGGTATG,0,1298147
furpa,0.3333333333333333,2,2,CCTAACGCAATTTTATTCCA,0,1319443
furpa,0.3333333333333333,2,2,CCGTTGGAGAACATCTTGGG,0,1314865
furpa,0.3333333333333333,2,2,CCGTTGCTGACGGTAGGCCA,0,1316645
furpa,0.3333333333333333,2,2,CCGTTCTTCCGATGGAGATC,0,1290417
furpa,0.3333333333333333,2,2,CCGTTCTTAAAGCGTCGGCA,0,1324490
furpa,0.3333333333333333,2,2,CCGTTCTGCGCGATCAATCT,0,1301211
furpa,0.3333333333333333,2,2,CCGTGTTTTCGGTACACGGT,0,1319035
furpa,0.3333333333333333,2,2,CCGTGAGTTTGAATATCTTC,0,1297770
furpa,0.3333333333333333,2,2,CCGTGACTGGTAGTCCTATA,0,1332198
furpa,0.3333333333333333,2,2,CCGTGAAGCTACGACTGACA,0,1301949
furpa,0.3333333333333333,2,2,CCGTCTAAAAACTTAACCCG,0,1328315
furpa,0.3333333333333333,2,2,CCGTCATTGTTTAGGACGTT,0,1304128
furpa,0.3333333333333333,2,2,CCGTATATTTAGGACAGAGG,0,1283590
furpa,0.3333333333333333,2,2,CCGTATACCGGTTCTCGCCT,0,1341639
furpa,0.3333333333333333,2,2,CCGTACGGCGCCTGTCATAT,0,1340772
furpa,0.3333333333333333,2,2,CCGGTTTCGCCGGGACGGGA,0,1320683
furpa,0.3333333333333333,2,2,CCGGTCTTCACCCGCTCAGA,0,1325981
furpa,0.3333333333333333,2,2,CCGGTATGCCGACGCTCGCC,0,1277032
furpa,0.3333333333333333,2,2,CCGGGGGGTGGTAAGGGCCG,0,1326211
furpa,0.3333333333333333,2,2,CCGGGCGGTGCTAGGTTCCA,0,1356834
furpa,0.3333333333333333,2,2,CCGGGCCATGTTTACTGCTG,0,1354651
furpa,0.3333333333333333,2,2,CCGGGAACTCCGGCCGGCAT,0,1272659
furpa,0.3333333333333333,2,2,CCGGCGTTATCAGCCTAAGT,0,1295719
furpa,0.3333333333333333,2,2,CCGGCCCGGCACTATGGGTT,0,1354082
furpa,0.3333333333333333,2,2,CCGGCAACTGCACAAAAGTA,0,1287861
furpa,0.3333333333333333,2,2,CCGGAGGACTGATCGGCCGG,0,1327016
furpa,0.3333333333333333,2,2,CCGGAATTGCGATGCAGCTC,0,1324309
furpa,0.3333333333333333,2,2,CCGCTTGGCCACATCTGGCC,0,1280382
furpa,0.3333333333333333,2,2,CCGCTTAAAGGCGCTGGAGT,0,1357241
furpa,0.3333333333333333,2,2,CCGCTAGCTATCCGTTTGCT,0,1338097
furpa,0.3333333333333333,2,2,CCGCTAATTGACAAAGTGTT,0,1275080
furpa,0.3333333333333333,2,2,CCGCGGGAAGCGATATGCAA,0,1330943
furpa,0.3333333333333333,2,2,CCGCGGATTAAGTCAGACCC,0,1332076
furpa,0.3333333333333333,2,2,CCGCCGTGGTGTGCCGCACG,0,1291433
furpa,0.3333333333333333,2,2,CCGCCGACATCTATCTCTAT,0,1283012
furpa,0.3333333333333333,2,2,CCGCCAGGACCATTAAGAGA,0,1353059
furpa,0.3333333333333333,2,2,CCGCATCACCATCGGGAACG,0,1327138
furpa,0.3333333333333333,2,2,CCGCAGATACAGTTCGTCTC,0,1290977
furpa,0.3333333333333333,2,2,CCGCACGAAGATCTGCCTAA,0,1324709
furpa,0.3333333333333333,2,2,CCGATTTGGGAGAATAACCA,0,1337720
furpa,0.3333333333333333,2,2,CCGATCTTTTCGTCATCCCA,0,1316228
furpa,0.3333333333333333,2,2,CCGATCGCATAAGATGCAAA,0,1330869
furpa,0.3333333333333333,2,2,CCGAGCTACTCATCTTATAC,0,1349339
furpa,0.3333333333333333,2,2,CCGACGTCATGCCTTGGGCA,0,1305102
furpa,0.3333333333333333,2,2,CCGAACTGAAAAAGATGGTC,0,1318105
furpa,0.3333333333333333,2,2,CCGAAACAGGTGTATTTACT,0,1352907
furpa,0.3333333333333333,2,2,CCCTTGAGGTATACAGGTCC,0,1294253
furpa,0.3333333333333333,2,2,CCCTTACGAGCGGGCAGGGG,0,1328751
furpa,0.3333333333333333,2,2,CCCTGTTCGCGGAGCGCTGA,0,1273825
furpa,0.3333333333333333,2,2,CCCTGCGTAGTAGGGCAATT,0,1325138
furpa,0.3333333333333333,2,2,CCCTCGATAGCGGTGCGAAC,0,1338346
furpa,0.3333333333333333,2,2,CCCTATTTACGGTGGCATTT,0,1299719
furpa,0.3333333333333333,2,2,CCCTAAGTCTAAGCCGTCCC,0,1325575
furpa,0.3333333333333333,2,2,CCCGTGAGATATAATTCGGT,0,1338117
furpa,0.3333333333333333,2,2,CCCGGTGGGGGCTCTGTTTA,0,1332400
furpa,0.3333333333333333,2,2,CCCGCATCTTGCCCAATATA,0,1298956
furpa,0.3333333333333333,2,2,CCCGCACTATGCTGGAAGAT,0,1326261
furpa,0.3333333333333333,2,2,CCCGATTGGGGCTGGCGTTC,0,1286587
furpa,0.3333333333333333,2,2,CCCGACTGTCACTAGAACTC,0,1333101
furpa,0.3333333333333333,2,2,CCCGAAAAACTTGATCACAC,0,1309345
furpa,0.3333333333333333,2,2,CCCCTGGTGCCCATAGCATA,0,1330328
furpa,0.3333333333333333,2,2,CCCCTATAGTGCCTTAGATT,0,1303969
furpa,0.3333333333333333,2,2,CCCCTAGCCTGGCGCACCAC,0,1350485
furpa,0.3333333333333333,2,2,CCCCGCGTATAATAAGTTCC,0,1304762
furpa,0.3333333333333333,2,2,CCCCGAGGAGTATTTTATTT,0,1295726
furpa,0.3333333333333333,2,2,CCCCCTTTCAACAGGTGCAG,0,1288583
furpa,0.3333333333333333,2,2,CCCCCCTACGTAAGGCAATT,0,1306991
furpa,0.3333333333333333,2,2,CCCCCCTAATATAGTATCCA,0,1292274
furpa,0.3333333333333333,2,2,CCCCACCTCTGGTAACGGCG,0,1352140
furpa,0.3333333333333333,2,2,CCCATGTTCAACATCCCATA,0,1330516
furpa,0.3333333333333333,2,2,CCCATAAGATCCCAAGCTCA,0,1353444
furpa,0.3333333333333333,2,2,CCCAGATATATTTTCGACGT,0,1324953
furpa,0.3333333333333333,2,2,CCCAGACACTTGGTTCAAGG,0,1292552
furpa,0.3333333333333333,2,2,CCCACTGACTATGCCGCCCC,0,1276706
furpa,0.3333333333333333,2,2,CCCACATAGTACCGCTAAAA,0,1306800
furpa,0.3333333333333333,2,2,CCCAATACGAGATTTTGGTA,0,1335847
furpa,0.3333333333333333,2,2,CCCAAGCCGGTTGACGATGT,0,1282208
furpa,0.3333333333333333,2,2,CCATGTGGGTTATGTGCACT,0,1353976
furpa,0.3333333333333333,2,2,CCATGGGCTATGGTTTTATA,0,1333302
furpa,0.3333333333333333,2,2,CCATCTGTGTCCCTATACAT,0,1280093
furpa,0.3333333333333333,2,2,CCATCTGGCGTTTTCAACCC,0,1347073
furpa,0.3333333333333333,2,2,CCATCTCGATTCTATGGTTC,0,1323324
furpa,0.3333333333333333,2,2,CCATCATGTTCCGGCCAGAT,0,1299299
furpa,0.3333333333333333,2,2,CCATCAATGCTTCGATATTG,0,1291591
furpa,0.3333333333333333,2,2,CCATAGGACTGAGGAAAATG,0,1329192
furpa,0.3333333333333333,2,2,CCAGTGATCTAATGCGCTAT,0,1290527
furpa,0.3333333333333333,2,2,CCAGGGCATTGTGGTGAATG,0,1347488
furpa,0.3333333333333333,2,2,CCAGCTCACGTTAACTCAGA,0,1331884
furpa,0.3333333333333333,2,2,CCAGCGGACGCGTTACATAC,0,1311691
furpa,0.3333333333333333,2,2,CCAGCATGCCTAAGCGCGGG,0,1340923
furpa,0.3333333333333333,2,2,CCAGAGTGTCACCTTTCAGA,0,1317266
furpa,0.3333333333333333,2,2,CCACTCTAATGAGTTCACGT,0,1303648
furpa,0.3333333333333333,2,2,CCACGTTTCGCCCCGCAGAC,0,1302169
furpa,0.3333333333333333,2,2,CCACGTTTAGGGCTGATCAC,0,1298226
furpa,0.3333333333333333,2,2,CCACGTAACTATTGTGTTTT,0,1357127
furpa,0.3333333333333333,2,2,CCACGGGCATGTGTCCATAT,0,1291387
furpa,0.3333333333333333,2,2,CCACGGCAGCGCCTCACTAA,0,1353249
furpa,0.3333333333333333,2,2,CCACGGAATTCGTTCAGGTT,0,1278586
furpa,0.3333333333333333,2,2,CCACCTGGTCTACAGGGGAA,0,1315537
furpa,0.3333333333333333,2,2,CCACCGTACCCACATGATAG,0,1279971
furpa,0.3333333333333333,2,2,CCACAGAAAGCTAGCGCGGC,0,1340320
furpa,0.3333333333333333,2,2,CCACACTGAAACCACCGATA,0,1351958
furpa,0.3333333333333333,2,2,CCACAAGATACACACTTGCC,0,1295306
furpa,0.3333333333333333,2,2,CCACAACCGGTTACTATTGA,0,1334829
furpa,0.3333333333333333,2,2,CCAATTCCCTGAGGACCGGT,0,1274679
furpa,0.3333333333333333,2,2,CCAATTAAAGAACTCAGTTT,0,1286251
furpa,0.3333333333333333,2,2,CCAATCTGACTCTTGCGGAC,0,1288994
furpa,0.3333333333333333,2,2,CCAAGTAACTCGAAGGTCGG,0,1331791
furpa,0.3333333333333333,2,2,CCAACATATATCGCTCTCTA,0,1280541
furpa,0.3333333333333333,2,2,CCAACACAGTAAGAAAATAC,0,1295586
furpa,0.3333333333333333,2,2,CCAAACAAGTCAGAAATCCT,0,1345564
furpa,0.3333333333333333,2,2,CATTTTCAAGAAGCTCATTA,0,1356838
furpa,0.3333333333333333,2,2,CATTTTACAGGTAGCATAAC,0,1340207
furpa,0.3333333333333333,2,2,CATTTCGGTGCAGGTTCAGC,0,1307831
furpa,0.3333333333333333,2,2,CATTTACGGAAAAATCCAGC,0,1283404
furpa,0.3333333333333333,2,2,CATTGTGAGGCGGATTCCCC,0,1293723
furpa,0.3333333333333333,2,2,CATTGACCGGGAGTGGTAGG,0,1273719
furpa,0.3333333333333333,2,2,CATTCTTTTGGTTACCGCGG,0,1356028
furpa,0.3333333333333333,2,2,CATTCATCCGGTTCAGTAGA,0,1284026
furpa,0.3333333333333333,2,2,CATTATCTAACCAATTCTTC,0,1352462
furpa,0.3333333333333333,2,2,CATGTCTAGACCCGGCAAAA,0,1327434
furpa,0.3333333333333333,2,2,CATGGCAATACCCGGTAAGG,0,1316131
furpa,0.3333333333333333,2,2,CATGCGAGTCATACAGAAAG,0,1331581
furpa,0.3333333333333333,2,2,CATGCACGGAATTTACCCCA,0,1344883
furpa,0.3333333333333333,2,2,CATCTGGCGGTACAAGGGGG,0,1338371
furpa,0.3333333333333333,2,2,CATCGTGCTCGGGCAAGGGT,0,1298704
furpa,0.3333333333333333,2,2,CATCGCCGGGGCTGAATGGG,0,1317154
furpa,0.3333333333333333,2,2,CATCCTTCAGCTCGATAGAA,0,1326292
furpa,0.3333333333333333,2,2,CATCCATTATAGTGGACCAC,0,1331532
furpa,0.3333333333333333,2,2,CATATTTAGGGTGTGCCTCA,0,1332730
furpa,0.3333333333333333,2,2,CATAGTACTCCCGGATCCTC,0,1314205
furpa,0.3333333333333333,2,2,CATAGGTGGTAAATGCACTT,0,1277215
furpa,0.3333333333333333,2,2,CATAGCGCGCTTCGGCCCGT,0,1317669
furpa,0.3333333333333333,2,2,CATAGATGTCCGTTTAGATA,0,1308137
furpa,0.3333333333333333,2,2,CATACGAGTCAAATCTTTCT,0,1333280
furpa,0.3333333333333333,2,2,CATACGAGCCTGACGGCATT,0,1284016
furpa,0.3333333333333333,2,2,CATAATCGAAACTGTCATGA,0,1300364
furpa,0.3333333333333333,2,2,CAGTTTTGTCATTTGGTACC,0,1323562
furpa,0.3333333333333333,2,2,CAGTTTGAGCGCCTGGGAGC,0,1273035
furpa,0.3333333333333333,2,2,CAGTTTAGACACACGCGTCT,0,1341462
furpa,0.3333333333333333,2,2,CAGTGCGGGCTCAATGTAGG,0,1341008
furpa,0.3333333333333333,2,2,CAGTAGGAGAGGTTCTACTT,0,1271745
furpa,0.3333333333333333,2,2,CAGGTTTGTGGTTCAGATGC,0,1297754
furpa,0.3333333333333333,2,2,CAGGTGGCGGGGGCGGCTGG,0,1278469
furpa,0.3333333333333333,2,2,CAGGTGCCGTCTTTTCTACC,0,1288918
furpa,0.3333333333333333,2,2,CAGGGTCATCCCGCGGTGAC,0,1351390
furpa,0.3333333333333333,2,2,CAGGGGTTTGGACACAATTC,0,1336964
furpa,0.3333333333333333,2,2,CAGGGAAACAAATTACACAA,0,1318932
furpa,0.3333333333333333,2,2,CAGGCTTCGCAGGATGCTGA,0,1301725
furpa,0.3333333333333333,2,2,CAGGCTACCTTGGTTTTCCT,0,1298380
furpa,0.3333333333333333,2,2,CAGGCGTTGGCTAATTGTAT,0,1272459
furpa,0.3333333333333333,2,2,CAGGCACCCCCGCTCACTCT,0,1325434
furpa,0.3333333333333333,2,2,CAGGATGATTTAGACAAGTC,0,1278272
furpa,0.3333333333333333,2,2,CAGGATCATGTGAGACGCAG,0,1319951
furpa,0.3333333333333333,2,2,CAGGACCGGGTGATGTTAAT,0,1301498
furpa,0.3333333333333333,2,2,CAGGACACGCGAAACAGACT,0,1304302
furpa,0.3333333333333333,2,2,CAGCGTTGCTTTACACTTTA,0,1299877
furpa,0.3333333333333333,2,2,CAGCGGGCATACTGACACAT,0,1305404
furpa,0.3333333333333333,2,2,CAGCGGATCGTTGGGGCAAC,0,1317583
furpa,0.3333333333333333,2,2,CAGCGATCCTGCCCGCAGTG,0,1301992
furpa,0.3333333333333333,2,2,CAGCCAAGATCTGGACTGGG,0,1305941
furpa,0.3333333333333333,2,2,CAGCACAATATCGTGTAATA,0,1288476
furpa,0.3333333333333333,2,2,CAGCAATTCGCGGGCATCAA,0,1341503
furpa,0.3333333333333333,2,2,CAGATTTGGACGTTAAGGTA,0,1302872
furpa,0.3333333333333333,2,2,CAGATTAGCGCAGGCCTGGC,0,1354158
furpa,0.3333333333333333,2,2,CAGATATGTTCCTTGCACGT,0,1281544
furpa,0.3333333333333333,2,2,CAGAGATCTCTACCGTGTTT,0,1311860
furpa,0.3333333333333333,2,2,CAGACGGTTTTTCAACCGCC,0,1277551
furpa,0.3333333333333333,2,2,CAGACGCAGCGATGAACTAT,0,1317429
furpa,0.3333333333333333,2,2,CAGACCGGCAGTTGTGTGGC,0,1319904
furpa,0.3333333333333333,2,2,CAGACAGGAACTGTTGATGA,0,1291876
furpa,0.3333333333333333,2,2,CAGAAGGTCGAACTAGCCAT,0,1347917
furpa,0.3333333333333333,2,2,CACTTTTTTAAATTGATTAT,0,1285914
furpa,0.3333333333333333,2,2,CACTTTTGTGTACCGGGCTT,0,1354653
furpa,0.3333333333333333,2,2,CACTTCCGTGCGTCTGCACT,0,1306799
furpa,0.3333333333333333,2,2,CACTTCATGCGATGGACAAA,0,1296448
furpa,0.3333333333333333,2,2,CACTGGAGTCTTGTCGTTTG,0,1308715
furpa,0.3333333333333333,2,2,CACTGACTGCACCCCTAAGG,0,1314285
furpa,0.3333333333333333,2,2,CACTCTCGGCATGATACCAA,0,1337495
furpa,0.3333333333333333,2,2,CACTCGTGCAACCTCTAAAA,0,1333151
furpa,0.3333333333333333,2,2,CACTCCCTTCCTTATTGTTA,0,1283684
furpa,0.3333333333333333,2,2,CACGTTAGAAGCCGTGTCCA,0,1293884
furpa,0.3333333333333333,2,2,CACGGTCAAGAGTCGGTGTG,0,1352840
furpa,0.3333333333333333,2,2,CACGGCAAAGGGTAATCGGT,0,1318275
furpa,0.3333333333333333,2,2,CACGCGCGCGACGGCAAAGT,0,1293008
furpa,0.3333333333333333,2,2,CACCTGGCGCCCATCATGGC,0,1307324
furpa,0.3333333333333333,2,2,CACCGGCGCTCTTCGTACAG,0,1305953
furpa,0.3333333333333333,2,2,CACCGCGCATTACCTGCGAT,0,1287025
furpa,0.3333333333333333,2,2,CACCCTGTTCATTTAATGAA,0,1317754
furpa,0.3333333333333333,2,2,CACCCTCGAGTTGCTTGTTC,0,1304551
furpa,0.3333333333333333,2,2,CACCCTAGATATCATGGGTT,0,1348834
furpa,0.3333333333333333,2,2,CACCCGCGGCCCGATTGCCG,0,1317524
furpa,0.3333333333333333,2,2,CACCCCCGCCTCCGCCGATA,0,1301237
furpa,0.3333333333333333,2,2,CACCATTGGGACGAGCTCGG,0,1301610
furpa,0.3333333333333333,2,2,CACCACCTCGAGGAGACAGA,0,1354148
furpa,0.3333333333333333,2,2,CACCAATTAATTTTTCCTGA,0,1336926
furpa,0.3333333333333333,2,2,CACATGCAAGCGCATGGTGG,0,1353563
furpa,0.3333333333333333,2,2,CACATCCCCACCGAGCCAGC,0,1292311
furpa,0.3333333333333333,2,2,CACATAAAGCCAGGCTGAAG,0,1286852
furpa,0.3333333333333333,2,2,CACAGTCTCTTCATCCGTCG,0,1319008
furpa,0.3333333333333333,2,2,CACAGGGCTACGATTGTCGC,0,1345864
furpa,0.3333333333333333,2,2,CACAGCCGTTAGAGGTCCTG,0,1318054
furpa,0.3333333333333333,2,2,CACACGAATTGTCCCGGAGA,0,1328545
furpa,0.3333333333333333,2,2,CACACAGGGGAGTGGGGCAC,0,1355431
furpa,0.3333333333333333,2,2,CAATTGTTACGTGGAAAAAG,0,1299634
furpa,0.3333333333333333,2,2,CAATTGCCGAACGCGAGCGT,0,1316485
furpa,0.3333333333333333,2,2,CAATTGATAGTTAGGAGGGG,0,1279796
furpa,0.3333333333333333,2,2,CAATTATGCAAGTCGTCTGC,0,1286995
furpa,0.3333333333333333,2,2,CAATGTTTACAGTATACGTA,0,1287941
furpa,0.3333333333333333,2,2,CAATGGCATCACTACCCTAG,0,1354200
furpa,0.3333333333333333,2,2,CAATCTACGTCCCTAAGATA,0,1275465
furpa,0.3333333333333333,2,2,CAATCCTCACCATAAATTAG,0,1302737
furpa,0.3333333333333333,2,2,CAATCATAACTATCAATTTA,0,1330145
furpa,0.3333333333333333,2,2,CAATATCTGCTGACAGGTCA,0,1305103
furpa,0.3333333333333333,2,2,CAAGTTTAGGCTCTAAGAGG,0,1285294
furpa,0.3333333333333333,2,2,CAAGTTTAACTTGTACCCAC,0,1331416
furpa,0.3333333333333333,2,2,CAAGTAATCGTGAGTCACCA,0,1301656
furpa,0.3333333333333333,2,2,CAAGGTCATCGTCTTCGGAT,0,1319534
furpa,0.3333333333333333,2,2,CAAGCCGGACCAGCACCTAA,0,1318465
furpa,0.3333333333333333,2,2,CAAGCATAGTTAGCAGGGCA,0,1317695
furpa,0.3333333333333333,2,2,CAAGCAGTTTAGCGACAATT,0,1280982
furpa,0.3333333333333333,2,2,CAAGACTCATTAAGCAGGAT,0,1327171
furpa,0.3333333333333333,2,2,CAACCTCTCAGCCGTGCCTG,0,1324269
furpa,0.3333333333333333,2,2,CAACAGGCAGCGGCTAGTTC,0,1323793
furpa,0.3333333333333333,2,2,CAACACTACCGGACGTCGAT,0,1299445
furpa,0.3333333333333333,2,2,CAACACACGGCGGTCCCCCT,0,1276383
furpa,0.3333333333333333,2,2,CAACACAACAAAGTATGTAG,0,1336793
furpa,0.3333333333333333,2,2,CAAAGCTTATGCACCTCGGG,0,1334934
furpa,0.3333333333333333,2,2,CAAAGCGAGCGTGGAACCTA,0,1344453
furpa,0.3333333333333333,2,2,CAAACATGAATTTAAGGGCT,0,1323611
furpa,0.3333333333333333,2,2,CAAACAGCGTTGCGTAGTTT,0,1279570
furpa,0.3333333333333333,2,2,CAAAACTCTTGGCCCTACCG,0,1281339
furpa,0.3333333333333333,2,2,ATTTTCATCGCTGTGACGTA,0,1340300
furpa,0.3333333333333333,2,2,ATTTTAGGCTGAAGCTGGCT,0,1310454
furpa,0.3333333333333333,2,2,ATTTGTTTCAATTATTTAGA,0,1336749
furpa,0.3333333333333333,2,2,ATTTGTCTCGCCTCCCAGGG,0,1342930
furpa,0.3333333333333333,2,2,ATTTGCATGAAACAGAGGAC,0,1325849
furpa,0.3333333333333333,2,2,ATTTGAGGATTTTTCTCTCC,0,1304227
furpa,0.3333333333333333,2,2,ATTTCGCCATCGGGACGAAC,0,1336997
furpa,0.3333333333333333,2,2,ATTTCCTGCCAAACTTGTAC,0,1351386
furpa,0.3333333333333333,2,2,ATTTCCGTACCGGTCGATCA,0,1277169
furpa,0.3333333333333333,2,2,ATTTCATGCTACCCGGTTGT,0,1291566
furpa,0.3333333333333333,2,2,ATTTCAAGCAGAACGGTAGA,0,1277261
furpa,0.3333333333333333,2,2,ATTTAGCGGGCCAGCATGCT,0,1340166
furpa,0.3333333333333333,2,2,ATTTAAATCGTGCCGATGAC,0,1340349
furpa,0.3333333333333333,2,2,ATTGTGATCCCGACAAAAAT,0,1346089
furpa,0.3333333333333333,2,2,ATTGTACCCCATAGTAGATT,0,1311875
furpa,0.3333333333333333,2,2,ATTGGGTCTGACGGGGGAAT,0,1292708
furpa,0.3333333333333333,2,2,ATTGGGATATCCGTCAGTAC,0,1307388
furpa,0.3333333333333333,2,2,ATTGGGACTGGCGAGGCGCT,0,1290170
furpa,0.3333333333333333,2,2,ATTGCTAGCGAAGCCCCCTG,0,1316761
furpa,0.3333333333333333,2,2,ATTGCCTATGTATGGTCGGT,0,1288060
furpa,0.3333333333333333,2,2,ATTGATGAATTTGTGTCTAA,0,1321972
furpa,0.3333333333333333,2,2,ATTCTGATGCCAGCTTATAT,0,1347108
furpa,0.3333333333333333,2,2,ATTCTATTCCGGTGCTCCCT,0,1325903
furpa,0.3333333333333333,2,2,ATTCGCGCCAATAGCGTCGC,0,1327495
furpa,0.3333333333333333,2,2,ATTCCGATCGTTAAGCTTAG,0,1307982
furpa,0.3333333333333333,2,2,ATTCCAGGTCATCAGCTTCG,0,1292588
furpa,0.3333333333333333,2,2,ATTCAGGGCGATTGAGTAAG,0,1274435
furpa,0.3333333333333333,2,2,ATTCACTTAACTACATTACG,0,1291895
furpa,0.3333333333333333,2,2,ATTCACCAGAGTCGGCGATA,0,1327014
furpa,0.3333333333333333,2,2,ATTATTAAACGCGCCAACGG,0,1302765
furpa,0.3333333333333333,2,2,ATTATGGCTTGCCTAAGTGT,0,1293451
furpa,0.3333333333333333,2,2,ATTAGCCCACCCAGAGGCTA,0,1303060
furpa,0.3333333333333333,2,2,ATTAGATAGAATACGGATAA,0,1340379
furpa,0.3333333333333333,2,2,ATTACTTGCGAAGCGATTTA,0,1330663
furpa,0.3333333333333333,2,2,ATTACGATGAAGTACTGGGG,0,1326660
furpa,0.3333333333333333,2,2,ATTAATACGACTGGGCATAA,0,1347787
furpa,0.3333333333333333,2,2,ATTAAGGGGTCACAACTGTG,0,1292766
furpa,0.3333333333333333,2,2,ATTAAAGTCTGGATATTAGG,0,1302603
furpa,0.3333333333333333,2,2,ATGTTTTAGACTCATTTCGG,0,1308376
furpa,0.3333333333333333,2,2,ATGTTGCATAGTTACCATAG,0,1289034
furpa,0.3333333333333333,2,2,ATGTTAAGTGGACCATGCGA,0,1309360
furpa,0.3333333333333333,2,2,ATGTGAGTGAGAGCCAACTA,0,1338629
furpa,0.3333333333333333,2,2,ATGTGAGGGGAAATTAGGCC,0,1274796
furpa,0.3333333333333333,2,2,ATGTGACGTGGATTCTTCTT,0,1316374
furpa,0.3333333333333333,2,2,ATGTCGGGCAGATTATAAAT,0,1351421
furpa,0.3333333333333333,2,2,ATGTCCTTTTGGCGTGCGTA,0,1277037
furpa,0.3333333333333333,2,2,ATGTCACAGTTATATAATGT,0,1309009
furpa,0.3333333333333333,2,2,ATGGTTTTGCTAGCGTAACT,0,1283597
furpa,0.3333333333333333,2,2,ATGGTTTTACGGTCTGGCTC,0,1309721
furpa,0.3333333333333333,2,2,ATGGTACGCATATTTAGACA,0,1301789
furpa,0.3333333333333333,2,2,ATGGCTTGTAGAATGGACAA,0,1284870
furpa,0.3333333333333333,2,2,ATGGCTCGGGCCTCCCATCC,0,1327248
furpa,0.3333333333333333,2,2,ATGGCGTTTGGAGTACCTCT,0,1331114
furpa,0.3333333333333333,2,2,ATGGCCCGATCCATTTTAGT,0,1306259
furpa,0.3333333333333333,2,2,ATGGCCAGCAGGAACACTTA,0,1328819
furpa,0.3333333333333333,2,2,ATGGCATAGGGATTGGTTTA,0,1322575
furpa,0.3333333333333333,2,2,ATGGCAAGTATACGGGCGGA,0,1317803
furpa,0.3333333333333333,2,2,ATGGATTGTTGTGTGTAGTA,0,1296761
furpa,0.3333333333333333,2,2,ATGGAAAACGCACTCCCGCT,0,1356368
furpa,0.3333333333333333,2,2,ATGCGTGGCGCGCCACACAT,0,1350312
furpa,0.3333333333333333,2,2,ATGCGTCAGAGTATCTCATA,0,1326813
furpa,0.3333333333333333,2,2,ATGCGGAGGCTTAGAAGACA,0,1351893
furpa,0.3333333333333333,2,2,ATGCCGCGCTTTCGGTAGAG,0,1355975
furpa,0.3333333333333333,2,2,ATGCCCTGATTATTCTGACA,0,1312903
furpa,0.3333333333333333,2,2,ATGCAGTACGACTATGATGG,0,1276272
furpa,0.3333333333333333,2,2,ATGCAACCAAAAAGCACGAG,0,1298927
furpa,0.3333333333333333,2,2,ATGATCGCTTAAATGTACGG,0,1346912
furpa,0.3333333333333333,2,2,ATGATAGTAGGGAATAACGA,0,1345909
furpa,0.3333333333333333,2,2,ATGAGTGGAACGGACACAAA,0,1316070
furpa,0.3333333333333333,2,2,ATGAGCTAGGCACACGCACA,0,1288612
furpa,0.3333333333333333,2,2,ATGACTCCCCAAAGGCAGAC,0,1275923
furpa,0.3333333333333333,2,2,ATGACCGACCGGTCAGGCGC,0,1318825
furpa,0.3333333333333333,2,2,ATGAATAAGAGCATAACTTG,0,1287162
furpa,0.3333333333333333,2,2,ATGAAGGAGACGGTCCCGAA,0,1276544
furpa,0.3333333333333333,2,2,ATGAACGTGGATACCCCTGG,0,1320864
furpa,0.3333333333333333,2,2,ATGAACCAGTCTCGCTTTAA,0,1284159
furpa,0.3333333333333333,2,2,ATGAAAGGGTTGGCTGTTCA,0,1353664
furpa,0.3333333333333333,2,2,ATGAAACCTCACAGCCGCTT,0,1299186
furpa,0.3333333333333333,2,2,ATCTTGGTGGCTGTCTCCCT,0,1351665
furpa,0.3333333333333333,2,2,ATCTGTGGCTACATTCGCCT,0,1326191
furpa,0.3333333333333333,2,2,ATCTGCCGGTACGCCTGTAT,0,1338225
furpa,0.3333333333333333,2,2,ATCTGATTCGCCGAGCGTGA,0,1334570
furpa,0.3333333333333333,2,2,ATCTCTTATGTTATTCCTAG,0,1350086
furpa,0.3333333333333333,2,2,ATCTCTGGGTTCTAGTGCAC,0,1283881
furpa,0.3333333333333333,2,2,ATCTCCCAAGGGGGTGGTGG,0,1299857
furpa,0.3333333333333333,2,2,ATCTCACGTATGCTGCGCGA,0,1313626
furpa,0.3333333333333333,2,2,ATCTACTGTCGCATACCCAT,0,1301382
furpa,0.3333333333333333,2,2,ATCTACGCGCTCGTAAAGTG,0,1286213
furpa,0.3333333333333333,2,2,ATCTAATAAGAACTGTGTAC,0,1326549
furpa,0.3333333333333333,2,2,ATCGTTAGCCTCGGGTTCGA,0,1318200
furpa,0.3333333333333333,2,2,ATCGTGAAATACGCTGATGC,0,1346084
furpa,0.3333333333333333,2,2,ATCGTAGGTTTGAGCAGAAA,0,1319732
furpa,0.3333333333333333,2,2,ATCGGGTGTCAAAAAGCGTG,0,1339798
furpa,0.3333333333333333,2,2,ATCGCGCCTTGCAACATTGA,0,1318242
furpa,0.3333333333333333,2,2,ATCGCACGGCAAATAAAGAG,0,1275922
furpa,0.3333333333333333,2,2,ATCGATATTGCTATATATAT,0,1328948
furpa,0.3333333333333333,2,2,ATCCTTCCAACAGCAATGTA,0,1275359
furpa,0.3333333333333333,2,2,ATCCTACACCGCAATATCGA,0,1290497
furpa,0.3333333333333333,2,2,ATCCGGCATTGGCCTTAGTC,0,1325664
furpa,0.3333333333333333,2,2,ATCCCTTCAGAGTAGGAGGG,0,1300820
furpa,0.3333333333333333,2,2,ATCCCTTACCCCCTGGCGAT,0,1298003
furpa,0.3333333333333333,2,2,ATCCCGCCGAGTCCGCACTT,0,1327352
furpa,0.3333333333333333,2,2,ATCCCAAGACAAACGCACTG,0,1335332
furpa,0.3333333333333333,2,2,ATCCATGCGGCCGCGAACAT,0,1355696
furpa,0.3333333333333333,2,2,ATCCAGGACGCGTGGCGTCC,0,1293720
furpa,0.3333333333333333,2,2,ATCCAGCGATGGAAGTACAA,0,1323039
furpa,0.3333333333333333,2,2,ATCCAGAATACCCCCATGCT,0,1311809
furpa,0.3333333333333333,2,2,ATCCACAATGCCCTATGTTA,0,1272843
furpa,0.3333333333333333,2,2,ATCATGAAAGGGAACACACG,0,1333873
furpa,0.3333333333333333,2,2,ATCAGGGGCACAGCGCATAA,0,1356325
furpa,0.3333333333333333,2,2,ATCAGGGAAATGGTATAGCG,0,1348750
furpa,0.3333333333333333,2,2,ATCAGGAAACAAGTGTTGAT,0,1340736
furpa,0.3333333333333333,2,2,ATCAGATTCCCTACCAGTGA,0,1280029
furpa,0.3333333333333333,2,2,ATCAAGGTTCATACTCGGGA,0,1300086
furpa,0.3333333333333333,2,2,ATCAAGCAAACGAGATTATG,0,1348725
furpa,0.3333333333333333,2,2,ATCAACGAATCACAGCCAGA,0,1285624
furpa,0.3333333333333333,2,2,ATCAAATCTTGACAAGTCCT,0,1278153
furpa,0.3333333333333333,2,2,ATCAAACAACCGACGGCCTA,0,1314553
furpa,0.3333333333333333,2,2,ATATGTATAGTATATTGGGT,0,1342344
furpa,0.3333333333333333,2,2,ATATGTAATATCCCTCGTTA,0,1353856
furpa,0.3333333333333333,2,2,ATATGCCGCCACGGTGTGTC,0,1340233
furpa,0.3333333333333333,2,2,ATATGCACTCTCACTTGTGC,0,1319566
furpa,0.3333333333333333,2,2,ATATCTCGGCCTAGATAGCG,0,1334137
furpa,0.3333333333333333,2,2,ATATCAGATGCAACCGGTCA,0,1300056
furpa,0.3333333333333333,2,2,ATATAATCTGGATCCCTCAC,0,1278336
furpa,0.3333333333333333,2,2,ATATAAGCAGGCCGCTCATG,0,1349878
furpa,0.3333333333333333,2,2,ATATAACTCGTTCGCGAGTT,0,1351432
furpa,0.3333333333333333,2,2,ATAGTTCCAGTGACATGGAG,0,1331606
furpa,0.3333333333333333,2,2,ATAGTAGAAAGTATGCAGGG,0,1342950
furpa,0.3333333333333333,2,2,ATAGGGTACTATGCATTCGT,0,1299683
furpa,0.3333333333333333,2,2,ATAGGCTAAAGTAAGGGAGC,0,1281612
furpa,0.3333333333333333,2,2,ATAGGCGTCTACTGCGAATT,0,1336570
furpa,0.3333333333333333,2,2,ATAGCTCAGAGGCCGGGTCC,0,1319532
furpa,0.3333333333333333,2,2,ATAGCGGGTTGCGTAGATCA,0,1293118
furpa,0.3333333333333333,2,2,ATAGCGGACTACCAATAGTT,0,1346602
furpa,0.3333333333333333,2,2,ATAGCGATCCGACCTAGTGT,0,1339577
furpa,0.3333333333333333,2,2,ATAGCCTGCTTCACGCTCAG,0,1351495
furpa,0.3333333333333333,2,2,ATAGATCTATGCCCGTTCCA,0,1314939
furpa,0.3333333333333333,2,2,ATACTGCAAGGTAGCTCCGT,0,1307236
furpa,0.3333333333333333,2,2,ATACGGTTGAGCTTTATCGG,0,1322262
furpa,0.3333333333333333,2,2,ATACGCGAACTAGTAGGTAT,0,1308436
furpa,0.3333333333333333,2,2,ATACGATCGGGAACTATTCT,0,1335350
furpa,0.3333333333333333,2,2,ATACCTGGACTTGTTGCGGT,0,1354091
furpa,0.3333333333333333,2,2,ATACCGATCCGACTTTACAG,0,1280248
furpa,0.3333333333333333,2,2,ATACCGAGCCTAGTGTATTA,0,1354630
furpa,0.3333333333333333,2,2,ATACCCGCGGGAGCCAGTTG,0,1274257
furpa,0.3333333333333333,2,2,ATACAGTTACACTATAGATC,0,1344002
furpa,0.3333333333333333,2,2,ATACAGACGGGTCGGGCATC,0,1312226
furpa,0.3333333333333333,2,2,ATACAATGTTGATAGGAATG,0,1286414
furpa,0.3333333333333333,2,2,ATAATTGGTAAGAGAGGATG,0,1302144
furpa,0.3333333333333333,2,2,ATAATTATCTTCAGATGCGA,0,1278972
furpa,0.3333333333333333,2,2,ATAATACTGTTGAGCGGCCC,0,1311550
furpa,0.3333333333333333,2,2,ATAAGTGCGCAATGGGGGGC,0,1311907
furpa,0.3333333333333333,2,2,ATAAGGTCATGCAAAGTGAT,0,1343142
furpa,0.3333333333333333,2,2,ATAAGGTAGTGGTGGTGCCA,0,1275448
furpa,0.3333333333333333,2,2,ATAAGGACAGGTTCGATTCT,0,1272544
furpa,0.3333333333333333,2,2,ATAACGAACGGACCTCGGAA,0,1277222
furpa,0.3333333333333333,2,2,ATAACAAGGGGTGCTGTGGA,0,1352532
furpa,0.3333333333333333,2,2,ATAAATACGCCTAAGACCTA,0,1303966
furpa,0.3333333333333333,2,2,ATAAAGTTCCAATCCGGTAA,0,1321792
furpa,0.3333333333333333,2,2,ATAAACGTTCAGTAGTTATA,0,1337488
furpa,0.3333333333333333,2,2,ATAAAATTTATATGTCAAAG,0,1332463
furpa,0.3333333333333333,2,2,AGTTTTGATTTTAGTAATAT,0,1333677
furpa,0.3333333333333333,2,2,AGTTTTAGCTTTGCTAGTAT,0,1341896
furpa,0.3333333333333333,2,2,AGTTTACAGGTGTGTATATT,0,1349865
furpa,0.3333333333333333,2,2,AGTTGGAAACGCTCTAGCGT,0,1292885
furpa,0.3333333333333333,2,2,AGTTGATGACCGCTGACTTC,0,1314794
furpa,0.3333333333333333,2,2,AGTTCCGAAGTTCAAGAGAA,0,1311590
furpa,0.3333333333333333,2,2,AGTTAACGCTCGATAAGACA,0,1286691
furpa,0.3333333333333333,2,2,AGTTAAAGGCGGAGGACCAT,0,1324976
furpa,0.3333333333333333,2,2,AGTGTGCGGCCTAGAGTAAC,0,1297493
furpa,0.3333333333333333,2,2,AGTGTCCCAAGAAGTACTCT,0,1303722
furpa,0.3333333333333333,2,2,AGTGGTGCGGCTGAAGGCGC,0,1289769
furpa,0.3333333333333333,2,2,AGTGGACTCCCAATGTGAAG,0,1332122
furpa,0.3333333333333333,2,2,AGTGCCAACACAAGTGCCCC,0,1355773
furpa,0.3333333333333333,2,2,AGTGCATTGCCAATGAACTT,0,1335969
furpa,0.3333333333333333,2,2,AGTGATGTAAGCTTTAGCTA,0,1354260
furpa,0.3333333333333333,2,2,AGTGAGCATCAGTGCTATAT,0,1294797
furpa,0.3333333333333333,2,2,AGTCTTACAACCGCGGTCGG,0,1305248
furpa,0.3333333333333333,2,2,AGTCGGAGAGAGCGGAATGG,0,1295806
furpa,0.3333333333333333,2,2,AGTCATGCTGTAATAAAGGG,0,1282812
furpa,0.3333333333333333,2,2,AGTCAGTAAAATAACCATTT,0,1338051
furpa,0.3333333333333333,2,2,AGTCAATGGAGGGGTTTGAG,0,1292307
furpa,0.3333333333333333,2,2,AGTATTGCCTTCCTTGCTGA,0,1310984
furpa,0.3333333333333333,2,2,AGTATTAGTATGTTTTGCCA,0,1325386
furpa,0.3333333333333333,2,2,AGTATATGATACTCCACTTC,0,1328093
furpa,0.3333333333333333,2,2,AGTAGGCAACGAGTGGTCCC,0,1290979
furpa,0.3333333333333333,2,2,AGTAGAGGCTGTAGTTACCT,0,1351845
furpa,0.3333333333333333,2,2,AGTACTTCTGCGGAAGGCCG,0,1345051
furpa,0.3333333333333333,2,2,AGTACTCCCGCAGCGAGATT,0,1345891
furpa,0.3333333333333333,2,2,AGTACGGGCCTTTGGATTCA,0,1353924
furpa,0.3333333333333333,2,2,AGTACAAAGGAATGCCCTCT,0,1349329
furpa,0.3333333333333333,2,2,AGTAAGAGGAGGCGTTCAAT,0,1356258
furpa,0.3333333333333333,2,2,AGGTTTCGACCTACCATTCT,0,1302380
furpa,0.3333333333333333,2,2,AGGTTCCGCGGCAAGCTGCT,0,1271551
furpa,0.3333333333333333,2,2,AGGTGGAAGATTTTGTCTAG,0,1330465
furpa,0.3333333333333333,2,2,AGGTCGGAGGCCACGACTGA,0,1342788
furpa,0.3333333333333333,2,2,AGGTCCTTTTAGTGAAGTAC,0,1297302
furpa,0.3333333333333333,2,2,AGGTCATGAGAGAGGCCACT,0,1274447
furpa,0.3333333333333333,2,2,AGGTACGCACCAGAATAGTC,0,1283974
furpa,0.3333333333333333,2,2,AGGTACCATCAGCAGAATAC,0,1286592
furpa,0.3333333333333333,2,2,AGGGTTCTACACTGCGCCGC,0,1335206
furpa,0.3333333333333333,2,2,AGGGTGAGGTAAGGAGTAAG,0,1350913
furpa,0.3333333333333333,2,2,AGGGTGAAGTGCTTACCGGC,0,1299744
furpa,0.3333333333333333,2,2,AGGGTGAAATTACCGCATTG,0,1275848
furpa,0.3333333333333333,2,2,AGGGTATAAAGCCAGCAAAA,0,1305691
furpa,0.3333333333333333,2,2,AGGGTAATCCATCTCGTGTT,0,1295713
furpa,0.3333333333333333,2,2,AGGGGTTTCGGTCGAATAGT,0,1335296
furpa,0.3333333333333333,2,2,AGGGGCTAGAAACACAACTC,0,1346175
furpa,0.3333333333333333,2,2,AGGGCTTTGAGGCAAGTCAT,0,1318276
furpa,0.3333333333333333,2,2,AGGGCTCAATACGTATTCTC,0,1304720
furpa,0.3333333333333333,2,2,AGGGCTATTGCAGCGCCTCG,0,1311007
furpa,0.3333333333333333,2,2,AGGGCCGGTCTTTATTGGAT,0,1338211
furpa,0.3333333333333333,2,2,AGGGACCGTCCATTGGTAAA,0,1351023
furpa,0.3333333333333333,2,2,AGGGAACGAGCGGCACAGCC,0,1331147
furpa,0.3333333333333333,2,2,AGGCTGTGGGATGCTATAGG,0,1282404
furpa,0.3333333333333333,2,2,AGGCTAGGGCAGGCAATCGT,0,1286370
furpa,0.3333333333333333,2,2,AGGCCGTATGGGTAGTGTTA,0,1331080
furpa,0.3333333333333333,2,2,AGGCCGGTTCCCGGCGTTCG,0,1293337
furpa,0.3333333333333333,2,2,AGGCCGCCAAGTCGAGCACT,0,1335685
furpa,0.3333333333333333,2,2,AGGCAACAAATTGGTGGTTT,0,1277660
furpa,0.3333333333333333,2,2,AGGATGGGATGGGATTGTAT,0,1323026
furpa,0.3333333333333333,2,2,AGGAGCGTAAAAGTGAGCGT,0,1285242
furpa,0.3333333333333333,2,2,AGGAGAGTGGGTCTTCATCG,0,1318622
furpa,0.3333333333333333,2,2,AGGACTCAGTTCCCGGGAAC,0,1351208
furpa,0.3333333333333333,2,2,AGGAATACAGTGAATGGCGT,0,1339745
furpa,0.3333333333333333,2,2,AGGAAGGGATTACCTCGCTA,0,1327858
furpa,0.3333333333333333,2,2,AGCTTAACGTCGCTGACTCA,0,1271672
furpa,0.3333333333333333,2,2,AGCTGTTTATTGCAAAGAAC,0,1295887
furpa,0.3333333333333333,2,2,AGCTGATGCTCGCCAACAAC,0,1284888
furpa,0.3333333333333333,2,2,AGCTCTAGGCATGCGCAGGT,0,1302940
furpa,0.3333333333333333,2,2,AGCTCGAGGGAGCGCCACTA,0,1303187
furpa,0.3333333333333333,2,2,AGCGTCCTGGCAAGGAAGGC,0,1335746
furpa,0.3333333333333333,2,2,AGCGGTTAATGATATGACGG,0,1307900
furpa,0.3333333333333333,2,2,AGCGGGATTTCATGCCGATG,0,1353110
furpa,0.3333333333333333,2,2,AGCGCTAATATTCTGGTTAT,0,1292476
furpa,0.3333333333333333,2,2,AGCGCGGTTCGGATGCACAG,0,1324525
furpa,0.3333333333333333,2,2,AGCGCCTCTTTAAGAAGGTA,0,1291078
furpa,0.3333333333333333,2,2,AGCGACTGCAAGACCTTCAA,0,1288355
furpa,0.3333333333333333,2,2,AGCGAACCGTTGTATCGCGT,0,1304397
furpa,0.3333333333333333,2,2,AGCGAAAGGCTGCAACGTTA,0,1291302
furpa,0.3333333333333333,2,2,AGCCTGCGCCTCAACGACAG,0,1342560
furpa,0.3333333333333333,2,2,AGCCGGCATATTATTTGCGT,0,1280675
furpa,0.3333333333333333,2,2,AGCCGAATTATCTCTTTTGT,0,1291224
furpa,0.3333333333333333,2,2,AGCCCTCAATTACGGCGAAA,0,1292768
furpa,0.3333333333333333,2,2,AGCCCGAACGCGACAGGTAT,0,1271191
furpa,0.3333333333333333,2,2,AGCATGACAACGGTGACTGT,0,1280374
furpa,0.3333333333333333,2,2,AGCATCTTTTAAGCGGGCGA,0,1313054
furpa,0.3333333333333333,2,2,AGCAGTGTCCCCGAAGTGTA,0,1274415
furpa,0.3333333333333333,2,2,AGCAGCTACCGTTCGCAAGT,0,1315045
furpa,0.3333333333333333,2,2,AGCAGCCGCTATGCCGCTGT,0,1321589
furpa,0.3333333333333333,2,2,AGCACCGCTTGTATGCCTCG,0,1337307
furpa,0.3333333333333333,2,2,AGCAATTAGAGCCACTTCTG,0,1330855
furpa,0.3333333333333333,2,2,AGCAATCGGATGTCTCACCT,0,1298715
furpa,0.3333333333333333,2,2,AGCAATCATCGCGGACCGCT,0,1297600
furpa,0.3333333333333333,2,2,AGCAAGGCTCAGGCTCCATG,0,1340857
furpa,0.3333333333333333,2,2,AGCAACCATTCTTAGATTTG,0,1357178
furpa,0.3333333333333333,2,2,AGCAAACATTATCCAGGCTG,0,1296572
furpa,0.3333333333333333,2,2,AGATTAACGTCCCTCGTTAG,0,1277889
furpa,0.3333333333333333,2,2,AGATTAACCATGGCACTCGT,0,1276495
furpa,0.3333333333333333,2,2,AGATCGGAGGCTCGTATAGC,0,1343511
furpa,0.3333333333333333,2,2,AGATCCACGGCACGCGGAAC,0,1336555
furpa,0.3333333333333333,2,2,AGATATGTCGAGTTCCCACT,0,1348933
furpa,0.3333333333333333,2,2,AGATACTAGAATCCCAAACA,0,1349062
furpa,0.3333333333333333,2,2,AGAGTTCCTTATAGGCGTAC,0,1315098
furpa,0.3333333333333333,2,2,AGAGTGAACTCTGTAGTTCC,0,1302015
furpa,0.3333333333333333,2,2,AGAGTAAGTCTGGTGTGGAC,0,1289867
furpa,0.3333333333333333,2,2,AGAGGGGGAAGGGGTTACCC,0,1275254
furpa,0.3333333333333333,2,2,AGAGGCATTCGGCGCAGCGC,0,1353098
furpa,0.3333333333333333,2,2,AGAGGCAATATCCCAGTCCC,0,1325354
furpa,0.3333333333333333,2,2,AGAGGATCGGAGGCCGTGGA,0,1349399
furpa,0.3333333333333333,2,2,AGAGAAGCAATCATGCGTAA,0,1293502
furpa,0.3333333333333333,2,2,AGACTGTCGCGGTTAAATGT,0,1300398
furpa,0.3333333333333333,2,2,AGACTGGAATTTTCTTGTAC,0,1324439
furpa,0.3333333333333333,2,2,AGACCTGGAAGAATCAATGA,0,1323238
furpa,0.3333333333333333,2,2,AGACCGGCCCGGTTAACCCG,0,1351806
furpa,0.3333333333333333,2,2,AGACAAGTAACAAGATTTGT,0,1299441
furpa,0.3333333333333333,2,2,AGAATGTTATTTTCCGGTTC,0,1339807
furpa,0.3333333333333333,2,2,AGAATGCTAGCTGCTTTCTG,0,1291732
furpa,0.3333333333333333,2,2,AGAAGGACAGGGGACCCGGA,0,1311378
furpa,0.3333333333333333,2,2,AGAAGCGGACAACATGCATT,0,1294884
furpa,0.3333333333333333,2,2,AGAAGCCGCAGTTAGGTGAG,0,1355741
furpa,0.3333333333333333,2,2,AGAAGATGTGGCGCGCCTCC,0,1318849
furpa,0.3333333333333333,2,2,AGAAGAGAAAAAGATCCCCC,0,1303298
furpa,0.3333333333333333,2,2,AGAAATGCCAGTCTGTAGGG,0,1343533
furpa,0.3333333333333333,2,2,AGAAAGGGGGACCTTCGTAA,0,1304674
furpa,0.3333333333333333,2,2,AGAAAACGCCCATAGCAGGG,0,1288617
furpa,0.3333333333333333,2,2,ACTTTGACTACGGACTTTTT,0,1312856
furpa,0.3333333333333333,2,2,ACTTTACACAGGACAGACGA,0,1279530
furpa,0.3333333333333333,2,2,ACTTGTGTTTACGCGCTTGC,0,1306343
furpa,0.3333333333333333,2,2,ACTTGTAGATAAGTACTCGC,0,1345017
furpa,0.3333333333333333,2,2,ACTTGTACCCTTTTGATGCA,0,1304119
furpa,0.3333333333333333,2,2,ACTTGGTAGGACAATTTCTG,0,1288029
furpa,0.3333333333333333,2,2,ACTTGCTGGATAATTCATGG,0,1341139
furpa,0.3333333333333333,2,2,ACTTGCGTTGTTTTAACCAT,0,1322089
furpa,0.3333333333333333,2,2,ACTTGCCTGCCGATCCTAGC,0,1273001
furpa,0.3333333333333333,2,2,ACTTCCTAATCAATTGTTAT,0,1298404
furpa,0.3333333333333333,2,2,ACTTATCCCTCACAGCGGCG,0,1318140
furpa,0.3333333333333333,2,2,ACTTATCATAAGTTAATTTC,0,1344852
furpa,0.3333333333333333,2,2,ACTTATAGTAGGTCAGGAAG,0,1272114
furpa,0.3333333333333333,2,2,ACTGTTTGTGGAGTTTCATG,0,1323760
furpa,0.3333333333333333,2,2,ACTGTCCGAAGCCAAGGTCC,0,1285470
furpa,0.3333333333333333,2,2,ACTGTATAGGGACGTAGATT,0,1337071
furpa,0.3333333333333333,2,2,ACTGGTTTCCAGCGAGAGAC,0,1333387
furpa,0.3333333333333333,2,2,ACTGGGACAGTGGCTCCCTC,0,1272825
furpa,0.3333333333333333,2,2,ACTGGCAGAGGATGCGAACA,0,1301862
furpa,0.3333333333333333,2,2,ACTGGATAGAAACAACTGCA,0,1324861
furpa,0.3333333333333333,2,2,ACTGGAATAGGTTGGCTGTA,0,1312542
furpa,0.3333333333333333,2,2,ACTGCTTGAACTGCTGGGGC,0,1291411
furpa,0.3333333333333333,2,2,ACTGATGGGAACCGTACCTT,0,1286707
furpa,0.3333333333333333,2,2,ACTCTGGAGTAATGAATCCC,0,1292764
furpa,0.3333333333333333,2,2,ACTCGTGGATCTCAGAAGAG,0,1283976
furpa,0.3333333333333333,2,2,ACTCCCAGGCTTTAGAAGTT,0,1353319
furpa,0.3333333333333333,2,2,ACTCCCAAGAGACTTTTATG,0,1277709
furpa,0.3333333333333333,2,2,ACTCATTTAGAAGGGCAGAG,0,1275095
furpa,0.3333333333333333,2,2,ACTCACTTGATCCTCTCGTT,0,1335048
furpa,0.3333333333333333,2,2,ACTCACCACTTGATCATTGG,0,1288146
furpa,0.3333333333333333,2,2,ACTATACTCTATTCTGACTC,0,1345930
furpa,0.3333333333333333,2,2,ACTATACGTCAGCAGCAGAA,0,1342297
furpa,0.3333333333333333,2,2,ACTAGGGAAAGGTACCGCGT,0,1333227
furpa,0.3333333333333333,2,2,ACTACTCCAGTTGATTCCCC,0,1311941
furpa,0.3333333333333333,2,2,ACTAATCTCAGGTATTTCAC,0,1328938
furpa,0.3333333333333333,2,2,ACTAAGGCTATGATTAACTT,0,1304688
furpa,0.3333333333333333,2,2,ACTAAGCCGTGACTCCTAAC,0,1320729
furpa,0.3333333333333333,2,2,ACTAACCGAGATGCGCGGGT,0,1295988
furpa,0.3333333333333333,2,2,ACTAAATTTATGGCACCAGT,0,1349107
furpa,0.3333333333333333,2,2,ACTAAATGTACTAGATGGTC,0,1271324
furpa,0.3333333333333333,2,2,ACGTTGACGGATATTGCCCT,0,1284204
furpa,0.3333333333333333,2,2,ACGTTAGGAGTATCCTCTAC,0,1304613
furpa,0.3333333333333333,2,2,ACGTGTGTACGGGACGCTAG,0,1329348
furpa,0.3333333333333333,2,2,ACGTGCCTATCTGGGACAAA,0,1298644
furpa,0.3333333333333333,2,2,ACGTGATCGTCTGTCCACCC,0,1275030
furpa,0.3333333333333333,2,2,ACGTCGGTTAGTCAGCGACT,0,1293004
furpa,0.3333333333333333,2,2,ACGTACATTCGGCGATCTAG,0,1297137
furpa,0.3333333333333333,2,2,ACGTAATGATTGACGACACA,0,1355114
furpa,0.3333333333333333,2,2,ACGGTGCCCATTACGTTTTC,0,1335291
furpa,0.3333333333333333,2,2,ACGGTCATTCAGTACGTTCT,0,1283160
furpa,0.3333333333333333,2,2,ACGGGTGATGCTCCGTACAG,0,1301587
furpa,0.3333333333333333,2,2,ACGGGTCCATGCATTTTTCT,0,1281335
furpa,0.3333333333333333,2,2,ACGGCCCACACCCTGGGAAT,0,1333808
furpa,0.3333333333333333,2,2,ACGGCAGGACTCTCCACACA,0,1347644
furpa,0.3333333333333333,2,2,ACGGAGTTTCTCCCAGAACA,0,1274495
furpa,0.3333333333333333,2,2,ACGGAATTTGCTCGCGTTCC,0,1277330
furpa,0.3333333333333333,2,2,ACGCGGTCATCATCGCGGAC,0,1310538
furpa,0.3333333333333333,2,2,ACGCGGGTTCGTATCATTAG,0,1355965
furpa,0.3333333333333333,2,2,ACGCGCCAAACTGTGCCTTT,0,1300043
furpa,0.3333333333333333,2,2,ACGCCTGAAGGGATCACAAA,0,1312153
furpa,0.3333333333333333,2,2,ACGCCGGTAGAGCTAAAGCT,0,1357488
furpa,0.3333333333333333,2,2,ACGCCCGCATTAATGCTTAT,0,1295098
furpa,0.3333333333333333,2,2,ACGCCAAGTACGAGTGGCAG,0,1312284
furpa,0.3333333333333333,2,2,ACGCAATTGGGCACCGTTCG,0,1334650
furpa,0.3333333333333333,2,2,ACGATAATTGTACGCCACCG,0,1282259
furpa,0.3333333333333333,2,2,ACGACGTGATCCTCGAAAAG,0,1345660
furpa,0.3333333333333333,2,2,ACGACGTAAATGTGATCGTG,0,1281298
furpa,0.3333333333333333,2,2,ACGACGGCGAGCGGAGTCTA,0,1332909
furpa,0.3333333333333333,2,2,ACGAATACGCTAGTGCCGAT,0,1289657
furpa,0.3333333333333333,2,2,ACGAACGTAAACTGTTGCCT,0,1338497
furpa,0.3333333333333333,2,2,ACCTCCGGAGCGGATACGGG,0,1299910
furpa,0.3333333333333333,2,2,ACCGTATTTATGTCCACGTA,0,1315977
furpa,0.3333333333333333,2,2,ACCGGTAAGGCATTAGAGGA,0,1295281
furpa,0.3333333333333333,2,2,ACCGGCTTTGTTGGTATAGC,0,1319108
furpa,0.3333333333333333,2,2,ACCGGCCGGGCAGTTATCAG,0,1284601
furpa,0.3333333333333333,2,2,ACCGGCCACATGGCACCGAT,0,1338906
furpa,0.3333333333333333,2,2,ACCGAGTCTGTGGGGTCAAG,0,1305504
furpa,0.3333333333333333,2,2,ACCGAACGAGCTCAGGCATT,0,1302802
furpa,0.3333333333333333,2,2,ACCCTGTTGCCGATGCATAG,0,1344398
furpa,0.3333333333333333,2,2,ACCCTGTATGTCGTAGCCAA,0,1318463
furpa,0.3333333333333333,2,2,ACCCTAGGCATGCAACAAAC,0,1329613
furpa,0.3333333333333333,2,2,ACCCGTTCCCGAAGTGAGCT,0,1341504
furpa,0.3333333333333333,2,2,ACCCGCTCGTGTCCCTGCAG,0,1323721
furpa,0.3333333333333333,2,2,ACCCGCCTTAGGGTGCACTG,0,1318776
furpa,0.3333333333333333,2,2,ACCCATCCGCTAGACATCAT,0,1316132
furpa,0.3333333333333333,2,2,ACCCAGACTTCAGGTTTTCG,0,1293142
furpa,0.3333333333333333,2,2,ACCCACGTGATAACCACTAA,0,1317961
furpa,0.3333333333333333,2,2,ACCCACCCGTACGTCCGCTT,0,1296882
furpa,0.3333333333333333,2,2,ACCATGTCGCAAATTCAAGA,0,1344835
furpa,0.3333333333333333,2,2,ACCATCCCGACAGGGATAAT,0,1347746
furpa,0.3333333333333333,2,2,ACCAGTCGTCGTCTCTCGGT,0,1275725
furpa,0.3333333333333333,2,2,ACCAGCGGATTGCGAGCCAT,0,1288884
furpa,0.3333333333333333,2,2,ACCAGCATGGTTCGTGCTTG,0,1272112
furpa,0.3333333333333333,2,2,ACCACAAGAGGGGCAGTTTT,0,1320307
furpa,0.3333333333333333,2,2,ACCAATCATCCGTGTGTCTT,0,1328464
furpa,0.3333333333333333,2,2,ACCAAACGTCCCCACTTGTC,0,1326805
furpa,0.3333333333333333,2,2,ACATTGTGCATATTCTGTGT,0,1299304
furpa,0.3333333333333333,2,2,ACATGTGATCCCTAAAGCTA,0,1285305
furpa,0.3333333333333333,2,2,ACATGTCGAACATCAACATT,0,1274087
furpa,0.3333333333333333,2,2,ACATGCCGAAATGTACATCT,0,1287939
furpa,0.3333333333333333,2,2,ACATCTGGTCTCATGGGATG,0,1271941
furpa,0.3333333333333333,2,2,ACATCGTCAGTATGAGTCTT,0,1341577
furpa,0.3333333333333333,2,2,ACATAACCGCAAGGTTAATT,0,1353809
furpa,0.3333333333333333,2,2,ACAGTGATGGCCCACCTTAT,0,1286653
furpa,0.3333333333333333,2,2,ACAGTCCCCGCAGGTAGACA,0,1340356
furpa,0.3333333333333333,2,2,ACAGGCGAAGTCGGTGGTAG,0,1296920
furpa,0.3333333333333333,2,2,ACAGCCTAAGTTGGAATCAA,0,1272818
furpa,0.3333333333333333,2,2,ACAGCCACCCCGCGTCTGTA,0,1273252
furpa,0.3333333333333333,2,2,ACAGCAAGCCTGGGACGCTA,0,1272068
furpa,0.3333333333333333,2,2,ACAGAGATACGCAGAGAGAG,0,1278791
furpa,0.3333333333333333,2,2,ACAGACACGTCTCCAGTTCG,0,1274760
furpa,0.3333333333333333,2,2,ACACTTTCAACAATCTGTAG,0,1323178
furpa,0.3333333333333333,2,2,ACACTCCGAGTACACGTCGA,0,1314977
furpa,0.3333333333333333,2,2,ACACGGAGTAACCTGGGCTT,0,1349133
furpa,0.3333333333333333,2,2,ACACGAGGAAATGTCATAAT,0,1292156
furpa,0.3333333333333333,2,2,ACACCGCTACCCCTACGCAT,0,1300826
furpa,0.3333333333333333,2,2,ACACCATGGCGCTTCAGGCA,0,1336282
furpa,0.3333333333333333,2,2,ACACAGGTCGGTTGCAAGGT,0,1327739
furpa,0.3333333333333333,2,2,ACACAGATTAGTAGGTGCAG,0,1289154
furpa,0.3333333333333333,2,2,ACACAACTTCATAGGTCGGC,0,1329999
furpa,0.3333333333333333,2,2,ACAATTTGAGTCAAGTTCGG,0,1354951
furpa,0.3333333333333333,2,2,ACAATTTAGATATCGACCAA,0,1346459
furpa,0.3333333333333333,2,2,ACAACTTCTATTGGCACCTG,0,1272681
furpa,0.3333333333333333,2,2,ACAACTCAAGCTGTCACACT,0,1354377
furpa,0.3333333333333333,2,2,AATTTTTTAAATTTTTTGTT,0,1322029
furpa,0.3333333333333333,2,2,AATTTTGCCCTCTGCTTTGC,0,1344876
furpa,0.3333333333333333,2,2,AATTTTCCATAGCTCAGCAG,0,1327742
furpa,0.3333333333333333,2,2,AATTTTCATGTGGAATCATT,0,1296025
furpa,0.3333333333333333,2,2,AATTTCGTGGTGTTTATTAA,0,1338260
furpa,0.3333333333333333,2,2,AATTCTTATTCACTGTCTGT,0,1311717
furpa,0.3333333333333333,2,2,AATTCCAGGTGTCCGGTCTG,0,1287646
furpa,0.3333333333333333,2,2,AATTATTTGACCACCTCTAA,0,1294826
furpa,0.3333333333333333,2,2,AATTAGTTTCGTTTAAGCCA,0,1344612
furpa,0.3333333333333333,2,2,AATTACTCTAGGGGAGCCGT,0,1310637
furpa,0.3333333333333333,2,2,AATGTTACGCTTGTACATGC,0,1271506
furpa,0.3333333333333333,2,2,AATGGCCTTCCAGCTGGTGT,0,1278439
furpa,0.3333333333333333,2,2,AATGGCCTTAATTTTGCGGT,0,1301003
furpa,0.3333333333333333,2,2,AATGGAGGCCCACGTAGCGG,0,1344776
furpa,0.3333333333333333,2,2,AATGCTTAACAGTAACTCTT,0,1297861
furpa,0.3333333333333333,2,2,AATGCTCGCCTCTCTATTCA,0,1330273
furpa,0.3333333333333333,2,2,AATGCCTAAGTAGGAGGATA,0,1273078
furpa,0.3333333333333333,2,2,AATGATGTGAGGGGGTAAGT,0,1298467
furpa,0.3333333333333333,2,2,AATCGTTACAGCTCACGTTG,0,1310811
furpa,0.3333333333333333,2,2,AATCCGTCCACAGCGGTAAG,0,1310794
furpa,0.3333333333333333,2,2,AATCCCATGAGCAGGGGGTT,0,1329905
furpa,0.3333333333333333,2,2,AATCCACGTGAAGCATTAGA,0,1335823
furpa,0.3333333333333333,2,2,AATCATGTCGCTCGAGATAT,0,1335434
furpa,0.3333333333333333,2,2,AATCACAAGCTCGACACCTC,0,1302701
furpa,0.3333333333333333,2,2,AATCAACCGCGCTCTAGGGC,0,1333512
furpa,0.3333333333333333,2,2,AATAGGGTTACCCGGGTCGG,0,1290685
furpa,0.3333333333333333,2,2,AATAGGAGCCTAGACAAGCC,0,1292102
furpa,0.3333333333333333,2,2,AATAGCGATTCGCGGCTTCT,0,1306495
furpa,0.3333333333333333,2,2,AATACTCCGGGTGCGAAACA,0,1272341
furpa,0.3333333333333333,2,2,AATAATCTTACAGATCATCA,0,1298106
furpa,0.3333333333333333,2,2,AAGTTTACCCTGAGTGTAAC,0,1312428
furpa,0.3333333333333333,2,2,AAGTTACGAACCGTGGAGAT,0,1347467
furpa,0.3333333333333333,2,2,AAGTTAATCAATCGTAGTAA,0,1288851
furpa,0.3333333333333333,2,2,AAGTGAGGCTACAAGATGCT,0,1302597
furpa,0.3333333333333333,2,2,AAGTGAGACGTTCGACAAAG,0,1353704
furpa,0.3333333333333333,2,2,AAGTCCAATCAGTACATCGG,0,1346533
furpa,0.3333333333333333,2,2,AAGTCACATTGCCTTCTTTG,0,1336938
furpa,0.3333333333333333,2,2,AAGTCAACCACGTAACGCGA,0,1316355
furpa,0.3333333333333333,2,2,AAGGGGTGGGGACCAGAGCG,0,1311422
furpa,0.3333333333333333,2,2,AAGGGATAGCTTCCAGTGGG,0,1350857
furpa,0.3333333333333333,2,2,AAGGCGGATTCCCGCCTGAA,0,1330861
furpa,0.3333333333333333,2,2,AAGGCCACCCCTAGGGGATA,0,1273989
furpa,0.3333333333333333,2,2,AAGGAGTCTTCCTGCGGGGG,0,1293033
furpa,0.3333333333333333,2,2,AAGGAGGACCAGCCGAGGTG,0,1286954
furpa,0.3333333333333333,2,2,AAGGACCGGGTATCCCCAGT,0,1306980
furpa,0.3333333333333333,2,2,AAGGAATGTAGGGTTGGACC,0,1319999
furpa,0.3333333333333333,2,2,AAGCTTAAACGCGCGGTGCT,0,1347650
furpa,0.3333333333333333,2,2,AAGCTGGTGCCGTCCGCCAA,0,1339800
furpa,0.3333333333333333,2,2,AAGCGTACTAAGTCCCGGCT,0,1316334
furpa,0.3333333333333333,2,2,AAGCGATTTTTTCAGCCAGA,0,1274886
furpa,0.3333333333333333,2,2,AAGCCTAGGTCTAGCCTCAC,0,1348270
furpa,0.3333333333333333,2,2,AAGCCATGTTGAGCACCTGC,0,1302807
furpa,0.3333333333333333,2,2,AAGCAGACAATGCTTTGATC,0,1291293
furpa,0.3333333333333333,2,2,AAGATCAAAAATCGAGGTCG,0,1298339
furpa,0.3333333333333333,2,2,AAGAGGCTGCCTGAGTTGAA,0,1277995
furpa,0.3333333333333333,2,2,AAGACTCAAAGGGCACATGC,0,1277458
furpa,0.3333333333333333,2,2,AAGACGCTACGCATGACTCA,0,1304734
furpa,0.3333333333333333,2,2,AAGACCGCGGATCAGTATAA,0,1349030
furpa,0.3333333333333333,2,2,AAGACAACCTGCCTTTCCAG,0,1286040
furpa,0.3333333333333333,2,2,AAGAATGGTCGGATATTCTG,0,1349828
furpa,0.3333333333333333,2,2,AACTTATCTCGCAACAAGGA,0,1332542
furpa,0.3333333333333333,2,2,AACTGTTCGACCTATATCCG,0,1294062
furpa,0.3333333333333333,2,2,AACTGGTCGTCTAGTTAGTT,0,1334835
furpa,0.3333333333333333,2,2,AACTGATGTAGCTAGAGGTA,0,1345385
furpa,0.3333333333333333,2,2,AACTGACGCGGCTCCGGCCA,0,1348475
furpa,0.3333333333333333,2,2,AACTGAACCACTTCAAGAGT,0,1310123
furpa,0.3333333333333333,2,2,AACGTTTGAGCTCATCGATA,0,1310283
furpa,0.3333333333333333,2,2,AACGTGTATTAGCGTACCGA,0,1282705
furpa,0.3333333333333333,2,2,AACGGTTTTCTGGTGACAAT,0,1311532
furpa,0.3333333333333333,2,2,AACGGTATTACTCCTTATTG,0,1296347
furpa,0.3333333333333333,2,2,AACGGGTGTTAAGTTGAGCC,0,1325753
furpa,0.3333333333333333,2,2,AACGGCATGGGCGGGGTCGT,0,1354505
furpa,0.3333333333333333,2,2,AACGCGCAGCCCCTGATTAG,0,1313640
furpa,0.3333333333333333,2,2,AACGCATGGCCATATTTCCC,0,1272673
furpa,0.3333333333333333,2,2,AACGATGGAGCCTCACTTTC,0,1339808
furpa,0.3333333333333333,2,2,AACGATGCCGAATTAACAGT,0,1274771
furpa,0.3333333333333333,2,2,AACGATACACGTCTCTTCAC,0,1295380
furpa,0.3333333333333333,2,2,AACGACATCCAACCCTGGAA,0,1294290
furpa,0.3333333333333333,2,2,AACGAATTTCTGAGTTTCAC,0,1301748
furpa,0.3333333333333333,2,2,AACGAACCTGCATATTGGTG,0,1344980
furpa,0.3333333333333333,2,2,AACGAACACTACGTCAACAA,0,1334697
furpa,0.3333333333333333,2,2,AACCGTATCCCGTCTTGGAG,0,1313880
furpa,0.3333333333333333,2,2,AACCATTTATTTTAAGTCAG,0,1298925
furpa,0.3333333333333333,2,2,AACCATCAGGATGCCGCTAT,0,1333044
furpa,0.3333333333333333,2,2,AACCATAACCCTCCGAGAAT,0,1357044
furpa,0.3333333333333333,2,2,AACCAGTCATCCCCATTCGT,0,1308448
furpa,0.3333333333333333,2,2,AACATCCATTGGGTGTCTGG,0,1278211
furpa,0.3333333333333333,2,2,AACAGGCGTTTGACCGAACC,0,1285481
furpa,0.3333333333333333,2,2,AACAGCGCGATATTAAGAGT,0,1291147
furpa,0.3333333333333333,2,2,AACAGAACCTGGCTCCATCG,0,1338765
furpa,0.3333333333333333,2,2,AACACTATGCAACAGGCCCT,0,1294319
furpa,0.3333333333333333,2,2,AACACGGAGCTTGCTGGCCT,0,1326949
furpa,0.3333333333333333,2,2,AACACCAGGTCGTGCCTCAC,0,1295885
furpa,0.3333333333333333,2,2,AACACCAGGCGGTCGCTGAT,0,1307164
furpa,0.3333333333333333,2,2,AAATTTGATAGGATCTAAGA,0,1324502
furpa,0.3333333333333333,2,2,AAATTCATTCATATAGATCC,0,1306063
furpa,0.3333333333333333,2,2,AAATGGTTTTTGACAATGCT,0,1346792
furpa,0.3333333333333333,2,2,AAATGGTTAGGCTGACTCTC,0,1323633
furpa,0.3333333333333333,2,2,AAATGCGCCGGTCCTCCACT,0,1314791
furpa,0.3333333333333333,2,2,AAATGCAAGCGGACGACCGT,0,1321510
furpa,0.3333333333333333,2,2,AAATGCAAAGATACAACACG,0,1328650
furpa,0.3333333333333333,2,2,AAATCTTCGCATATAGCAAA,0,1351592
furpa,0.3333333333333333,2,2,AAATCCTGCCTACGTTGCAT,0,1293454
furpa,0.3333333333333333,2,2,AAATCAGTAGTATCTCAGAG,0,1313647
furpa,0.3333333333333333,2,2,AAATATTAAACCAGCCATTG,0,1344207
furpa,0.3333333333333333,2,2,AAATAAGGGCATTCCGTGGC,0,1287401
furpa,0.3333333333333333,2,2,AAATAAGGCCCGGTCCATCA,0,1339671
furpa,0.3333333333333333,2,2,AAAGTTCCCATAAACATTGC,0,1340265
furpa,0.3333333333333333,2,2,AAAGTGATTTTAGGTCCATC,0,1357009
furpa,0.3333333333333333,2,2,AAAGGTCATGCCAATGCATT,0,1338479
furpa,0.3333333333333333,2,2,AAAGGACGACCTCACATCCC,0,1352291
furpa,0.3333333333333333,2,2,AAAGCGTAACACAGGCACCA,0,1314072
furpa,0.3333333333333333,2,2,AAAGCATAGTTGTAGTCGGA,0,1313531
furpa,0.3333333333333333,2,2,AAAGAGAACGTGGTCCCAGA,0,1289264
furpa,0.3333333333333333,2,2,AAAGACGCTGGCTTCTCGCA,0,1347795
furpa,0.3333333333333333,2,2,AAACTTTCCTGAGTTAGGAA,0,1340214
furpa,0.3333333333333333,2,2,AAACGTGTGCGCACTAATGC,0,1283395
furpa,0.3333333333333333,2,2,AAACGGTTGGGCGTGGAATT,0,1314329
furpa,0.3333333333333333,2,2,AAACCTCTGGAAGCGAATGC,0,1334499
furpa,0.3333333333333333,2,2,AAACCTATGGCTTCGGGGGT,0,1341110
furpa,0.3333333333333333,2,2,AAACCTATATCTCCGGATAC,0,1333877
furpa,0.3333333333333333,2,2,AAACCACCACATATACTGTC,0,1285121
furpa,0.3333333333333333,2,2,AAAAGGTGCACCTAGGCCCG,0,1305381
furpa,0.3333333333333333,2,2,AAAAGGTCCAAGAGGAGGGC,0,1312361
furpa,0.3333333333333333,2,2,AAAACTGTAATCTATGTAGC,0,1315046
furpa,0.3333333333333333,2,2,AAAACGATACGGCACTCGGT,0,1329345
furpa,0.3333333333333333,2,2,AAAAAGTTCAGCGATAGTAG,0,1324945
furpa,0.3333333333333333,2,2,AAAAAGGCATATTGGGGGCT,0,1273523
furpa,0.3333333333333333,2,2,AAAAAAGCTCAGGAGACGGA,0,1311393
furpa,0.5,1,1,TTTTTTTTAATTGCTTTGAG,0,1327231
furpa,0.5,1,1,TTTTTTTAAGTTGCAATATG,0,1308074
furpa,0.5,1,1,TTTTTTCTTTTCACACCCCA,0,1277216
furpa,0.5,1,1,TTTTTTACCATTATCTAAGA,0,1322732
furpa,0.5,1,1,TTTTTCTAAGTCGTTCTGGT,0,1353078
furpa,0.5,1,1,TTTTTACAATTTAAATTCAA,0,1299286
furpa,0.5,1,1,TTTTGTCTGCCGGGCTTCCT,0,1272329
furpa,0.5,1,1,TTTTCGTCTAACAAGAAGGA,0,1300671
furpa,0.5,1,1,TTTTCCTACATATAAGCCGA,0,1331853
furpa,0.5,1,1,TTTTCCGGCCACCTAACCAT,0,1336424
furpa,0.5,1,1,TTTTCCCCTATTGTCCTCTT,0,1312937
furpa,0.5,1,1,TTTTATTATGGTAGAGGGAC,0,1290312
furpa,0.5,1,1,TTTTATCGTGCCGTTATAAT,0,1344640
furpa,0.5,1,1,TTTTAGCCGACCCGTGGTGG,0,1310562
furpa,0.5,1,1,TTTGTTTCGCGTAACCGTTT,0,1354030
furpa,0.5,1,1,TTTGTTACAGGCGTTATGTG,0,1283049
furpa,0.5,1,1,TTTGTAACGGTATCTAAGAA,0,1323977
furpa,0.5,1,1,TTTGGTGGGTGAAGGGGTCT,0,1315405
furpa,0.5,1,1,TTTGGTCAAATGACTCGAAG,0,1304975
furpa,0.5,1,1,TTTGGCCTATCCGCGGTAAA,0,1287433
furpa,0.5,1,1,TTTGGATTGGTATGCGCGAA,0,1318630
furpa,0.5,1,1,TTTGAGGTGCACTGCAGAAA,0,1345322
furpa,0.5,1,1,TTTGAGAAACGCCGTCTCAG,0,1271536
furpa,0.5,1,1,TTTGAATGCTATAATCCGCA,0,1304173
furpa,0.5,1,1,TTTGAAATTGTCGTATAGGA,0,1336923
furpa,0.5,1,1,TTTCTTCAGCAGGGGGTCTA,0,1327274
furpa,0.5,1,1,TTTCTTAGACGAGGCCGTGG,0,1301230
furpa,0.5,1,1,TTTCTCCGTACGTCCACGTG,0,1353659
furpa,0.5,1,1,TTTCGGGAAAGGTCTCTGGT,0,1277091
furpa,0.5,1,1,TTTCGGAAGGTGAAAAGAGC,0,1343107
furpa,0.5,1,1,TTTCGCTGCATGCCTAGTCT,0,1305395
furpa,0.5,1,1,TTTCGCGCCTCATCCCACAA,0,1294428
furpa,0.5,1,1,TTTCGCCTTATCACCCAATT,0,1320826
furpa,0.5,1,1,TTTCGAGTGAGATAGAAAGG,0,1286475
furpa,0.5,1,1,TTTCCTGTGCAAGACCATAA,0,1326995
furpa,0.5,1,1,TTTCCCGAAATCACCGACGT,0,1339952
furpa,0.5,1,1,TTTCCCCCCGTTGCTTGGGG,0,1287170
furpa,0.5,1,1,TTTCCAGACGGTGGCTAGTG,0,1287449
furpa,0.5,1,1,TTTCAGCGCCGAGCCCCAGG,0,1306606
furpa,0.5,1,1,TTTCAATAATACGCACCCAT,0,1356165
furpa,0.5,1,1,TTTCAAGTACGTCGTCTGTA,0,1357282
furpa,0.5,1,1,TTTATTATGCGTTGGGTTAG,0,1290486
furpa,0.5,1,1,TTTATGGTGCGCTTAAGAGG,0,1275074
furpa,0.5,1,1,TTTATCGCATGCACCTTCTG,0,1272917
furpa,0.5,1,1,TTTATAAGATTTGGCAGATT,0,1277291
furpa,0.5,1,1,TTTATAAAACAATTAAGATG,0,1328455
furpa,0.5,1,1,TTTAGTATGTGATTATTAGA,0,1339166
furpa,0.5,1,1,TTTAGGGACGCAAAATTTTT,0,1338193
furpa,0.5,1,1,TTTAGATGCGGGCGTAGTTA,0,1318149
furpa,0.5,1,1,TTTACCCTGTTCTCCAAAGT,0,1294520
furpa,0.5,1,1,TTTACCAAGGATGTCTACCA,0,1288570
furpa,0.5,1,1,TTTAACTCTCGGTATAAATT,0,1328239
furpa,0.5,1,1,TTGTTCTGGGACTAGGGTCA,0,1337376
furpa,0.5,1,1,TTGTGGGGCGCCGTTAGGTT,0,1338594
furpa,0.5,1,1,TTGTGGATGCTCTTGTTTCA,0,1333039
furpa,0.5,1,1,TTGTGGACACAGCTATTGCA,0,1307084
furpa,0.5,1,1,TTGTGACTTAAAGTTCGAAT,0,1316972
furpa,0.5,1,1,TTGTCTTAGTGGAGAAATCC,0,1295246
furpa,0.5,1,1,TTGTCTAGTTAGTCGCGTAG,0,1334242
furpa,0.5,1,1,TTGTCCCGTCCCAGTGGGCT,0,1307365
furpa,0.5,1,1,TTGTCACTGGTACGCTCGTA,0,1319483
furpa,0.5,1,1,TTGTATTGTGTACGTCCAGT,0,1296043
furpa,0.5,1,1,TTGTAGCGCAGTCAGACCTT,0,1272506
furpa,0.5,1,1,TTGTACCAGTTTAGCTGGCC,0,1354289
furpa,0.5,1,1,TTGTAATCGGGCCAGGTTTC,0,1286041
furpa,0.5,1,1,TTGTAAGAGACTGTGATTAG,0,1310085
furpa,0.5,1,1,TTGGTGATCACATCGGTAGC,0,1293436
furpa,0.5,1,1,TTGGTACTCTCTTACGGGCG,0,1294571
furpa,0.5,1,1,TTGGGTGTCTTATACAGAAG,0,1289243
furpa,0.5,1,1,TTGGGGAGGTTGCAAAGACA,0,1303560
furpa,0.5,1,1,TTGGGCCTGGCACCAGGTTT,0,1318219
furpa,0.5,1,1,TTGGCCTCCGGCCTCCGGTT,0,1313098
furpa,0.5,1,1,TTGGATTGGTCGAAGTGTGC,0,1284605
furpa,0.5,1,1,TTGGACAGAATATATCCCGT,0,1282650
furpa,0.5,1,1,TTGGAAGATGAAGTATACGA,0,1314980
furpa,0.5,1,1,TTGGAAGACACTTGAAACAG,0,1335850
furpa,0.5,1,1,TTGCTCAAGGCCTAGCTCCC,0,1303063
furpa,0.5,1,1,TTGCGGTTCCCTGGACTTGG,0,1331088
furpa,0.5,1,1,TTGCGGGGCAGGGGGCGGTG,0,1322377
furpa,0.5,1,1,TTGCGCAACCGTTTACAGTA,0,1316159
furpa,0.5,1,1,TTGCCCTAGGAGCTAAAAGG,0,1324961
furpa,0.5,1,1,TTGCCCAACTGTGGGTGACT,0,1327613
furpa,0.5,1,1,TTGCATGATGTTGTCTGTTA,0,1289226
furpa,0.5,1,1,TTGCATATTCCGGAAGAGGA,0,1339130
furpa,0.5,1,1,TTGCACATGGGTGCCAATAA,0,1337309
furpa,0.5,1,1,TTGATTCTGGCCAACTCTAC,0,1342649
furpa,0.5,1,1,TTGATCGCTCCGGGAGTCAC,0,1352091
furpa,0.5,1,1,TTGATCCGTACAGCATATGA,0,1337183
furpa,0.5,1,1,TTGATAGGAGTGAATGCCCG,0,1337682
furpa,0.5,1,1,TTGATACACTCGATGTTCCT,0,1324947
furpa,0.5,1,1,TTGAGGTGACTATTCCATAA,0,1341090
furpa,0.5,1,1,TTGAGAGGACACTGTTGTTA,0,1312364
furpa,0.5,1,1,TTGACTCCGGGTTTGCGCCA,0,1274657
furpa,0.5,1,1,TTGACCTGGCAAAACGGCTG,0,1344498
furpa,0.5,1,1,TTGACACCTTTGTGGGCCTC,0,1272835
furpa,0.5,1,1,TTCTTGCCACTAGATAAGGC,0,1351156
furpa,0.5,1,1,TTCTTGAACGAAATTTGGTC,0,1306231
furpa,0.5,1,1,TTCTGTGCTTCTTAGTGGGA,0,1319797
furpa,0.5,1,1,TTCTGAGGGCTTCACATATC,0,1327846
furpa,0.5,1,1,TTCTCTCAGTGATGGTGTAC,0,1292073
furpa,0.5,1,1,TTCTATACGCTTATTATAGG,0,1352231
furpa,0.5,1,1,TTCTAGTAAGGCTACCGTTT,0,1293191
furpa,0.5,1,1,TTCTAGCTGTTGTGGGAATC,0,1345350
furpa,0.5,1,1,TTCTAGCTGGTCAATACCTA,0,1318144
furpa,0.5,1,1,TTCGTGGATGATACGAGCCC,0,1284021
furpa,0.5,1,1,TTCGTATCTTTTTGAAGGCT,0,1317422
furpa,0.5,1,1,TTCGGGTCCACTTGCGATGC,0,1351532
furpa,0.5,1,1,TTCGGATAAGTGCATCCATG,0,1313463
furpa,0.5,1,1,TTCGGAGCTAGATAGATCAA,0,1318403
furpa,0.5,1,1,TTCGCTGGCTGAATGGGTGA,0,1337797
furpa,0.5,1,1,TTCGCGCACAAGACCTTCCA,0,1297802
furpa,0.5,1,1,TTCGCGATGGTGCATCAGAG,0,1349234
furpa,0.5,1,1,TTCGCCCGGGATGCGCCTCT,0,1310029
furpa,0.5,1,1,TTCGCCCCTCATGGGAGAAC,0,1345042
furpa,0.5,1,1,TTCGCAGGGTATTAATACTT,0,1332367
furpa,0.5,1,1,TTCGACTTCGCAGGACGTGA,0,1329950
furpa,0.5,1,1,TTCGAAGAAATCCTTGGTAC,0,1325812
furpa,0.5,1,1,TTCGAACGACCCCTGCTTTT,0,1326827
furpa,0.5,1,1,TTCCTTGCATGTACGTGGGT,0,1272118
furpa,0.5,1,1,TTCCGTAATCACATGGGCCA,0,1311551
furpa,0.5,1,1,TTCCGGGGATAGGCTCGGAT,0,1291469
furpa,0.5,1,1,TTCCGGAACAAAGGTCTCTG,0,1299387
furpa,0.5,1,1,TTCCCGCGATACCCTAACGT,0,1347523
furpa,0.5,1,1,TTCCCAGCCCGGGAGAGGTT,0,1351162
furpa,0.5,1,1,TTCCAGTTATGGTGCGATAC,0,1309295
furpa,0.5,1,1,TTCCACATTAACTGTCAGTC,0,1300729
furpa,0.5,1,1,TTCCACATCGCAGTTGGGGG,0,1356128
furpa,0.5,1,1,TTCCAATTTGGCGCACGTTA,0,1343076
furpa,0.5,1,1,TTCCAATTACCTAGCTCGTA,0,1334898
furpa,0.5,1,1,TTCATCAAGCGTATCGGATG,0,1331094
furpa,0.5,1,1,TTCAGTTATAAAAATAGGGG,0,1307118
furpa,0.5,1,1,TTCAGGCAGTCTGATTCGTA,0,1336950
furpa,0.5,1,1,TTCAGATGAGAATACTATAG,0,1354504
furpa,0.5,1,1,TTCAGACTACGTTCGTCCCA,0,1335509
furpa,0.5,1,1,TTCACGTCGGATAAAAAGGA,0,1306758
furpa,0.5,1,1,TTCACCCCGGTACTCCTAGT,0,1293793
furpa,0.5,1,1,TTCACAGCCTGTACACTCGG,0,1281648
furpa,0.5,1,1,TTCACAAGAACACGTTTCCT,0,1347588
furpa,0.5,1,1,TTATTTTGTGTGGGTTTCGG,0,1309180
furpa,0.5,1,1,TTATTTATGCACTAAGACTG,0,1288311
furpa,0.5,1,1,TTATTGTTGCATGTCTCACC,0,1315253
furpa,0.5,1,1,TTATTCGGTGTAGAAGGAGT,0,1349088
furpa,0.5,1,1,TTATTCCGAATTTAGGATAT,0,1312167
furpa,0.5,1,1,TTATTATTGCAAAACTTTTT,0,1344506
furpa,0.5,1,1,TTATTAGTTCGCTGCGCCTA,0,1326875
furpa,0.5,1,1,TTATTAGATGCTGGTATCAG,0,1293582
furpa,0.5,1,1,TTATTAAGGAGCGCAATTGG,0,1342029
furpa,0.5,1,1,TTATTAACAGCTTAAGCGGA,0,1311789
furpa,0.5,1,1,TTATGGAGAGAGCTGTTTCC,0,1290523
furpa,0.5,1,1,TTATGATGTGCGACTTCTGA,0,1312055
furpa,0.5,1,1,TTATGAACTTCGATCACTAA,0,1295873
furpa,0.5,1,1,TTATATTAATAGTAGACTAC,0,1311509
furpa,0.5,1,1,TTATACTCCCTAGGAACCCG,0,1346307
furpa,0.5,1,1,TTATACCTACTATCTGTGAA,0,1354055
furpa,0.5,1,1,TTATACCGATGTTATAAATG,0,1341587
furpa,0.5,1,1,TTAGTTGCCTCACCAGACCG,0,1284553
furpa,0.5,1,1,TTAGTTCTCTCATCGCCTCT,0,1291212
furpa,0.5,1,1,TTAGTGGAGGTTGCAAATCT,0,1351735
furpa,0.5,1,1,TTAGTGCCTTCTTTTTATAA,0,1280844
furpa,0.5,1,1,TTAGTCGGTGAGATACCTTT,0,1323087
furpa,0.5,1,1,TTAGTCCTTTGGAATCCGGT,0,1308214
furpa,0.5,1,1,TTAGTATTGGTACACGTCTC,0,1314562
furpa,0.5,1,1,TTAGTACAAGCAAGCCGTAC,0,1305173
furpa,0.5,1,1,TTAGGTTGTCGTGTCCTTGC,0,1312068
furpa,0.5,1,1,TTAGGTATACCTGTATCTAG,0,1276564
furpa,0.5,1,1,TTAGGCACCCGGCAGAGTCA,0,1329625
furpa,0.5,1,1,TTAGCCGGACTGGTAAGCGG,0,1327978
furpa,0.5,1,1,TTAGCCCCCATAGTTTGGAG,0,1291465
furpa,0.5,1,1,TTAGATCTCCATTCCGAACT,0,1315523
furpa,0.5,1,1,TTAGACCGTACTTATATGTT,0,1303272
furpa,0.5,1,1,TTACTGGACTATTTCCACGT,0,1278854
furpa,0.5,1,1,TTACTCAATCATCAATTGTC,0,1323285
furpa,0.5,1,1,TTACTACCGTACGCAAGGCC,0,1306930
furpa,0.5,1,1,TTACCTAAAACTACCGCTGC,0,1340653
furpa,0.5,1,1,TTACATAAGTGTTGCAGCAT,0,1312081
furpa,0.5,1,1,TTACACTAGCGACGGGAAGC,0,1330009
furpa,0.5,1,1,TTACACTACAGATAGCACTA,0,1272234
furpa,0.5,1,1,TTACACGGGTATCGATAAAC,0,1296286
furpa,0.5,1,1,TTAATTCGGGCAGTGCGTTC,0,1334015
furpa,0.5,1,1,TTAATGGCGACCGCTACAAT,0,1327923
furpa,0.5,1,1,TTAATAAATTGGATATTCTT,0,1283495
furpa,0.5,1,1,TTAAGGTCTCCGGCGGATAA,0,1285587
furpa,0.5,1,1,TTAACGTGACTCACATTGGT,0,1290981
furpa,0.5,1,1,TTAACCCACTAGAATTATAA,0,1306220
furpa,0.5,1,1,TTAACAACTACTGCATCAGT,0,1315459
furpa,0.5,1,1,TTAAATCGCGTCCCATTTTC,0,1307885
furpa,0.5,1,1,TTAAACGTGGCATGGCCTCG,0,1305002
furpa,0.5,1,1,TGTTGTCGCTTCGCAGTAGT,0,1283797
furpa,0.5,1,1,TGTTCATACGAAGAATAGCG,0,1318874
furpa,0.5,1,1,TGTTAGAGATCGTCCAATGT,0,1337674
furpa,0.5,1,1,TGTTACCTTTCGATCACTAC,0,1293057
furpa,0.5,1,1,TGTGTCACACCCAATAAGCT,0,1303730
furpa,0.5,1,1,TGTGTAATTCGTCCCCCGGC,0,1354083
furpa,0.5,1,1,TGTGGTGCGCATGCGCATTC,0,1310536
furpa,0.5,1,1,TGTGGCTCACTCCAGTGCGG,0,1323804
furpa,0.5,1,1,TGTGGCTAATTTGGAGCATA,0,1351956
furpa,0.5,1,1,TGTGGCGATTTGAGCTCGAT,0,1293901
furpa,0.5,1,1,TGTGCTCTGTCACCCTCGTT,0,1276052
furpa,0.5,1,1,TGTGCGCGCGAAGCAAGCCT,0,1338994
furpa,0.5,1,1,TGTGCATAAACCTAGCTCCG,0,1330296
furpa,0.5,1,1,TGTGATCAACGGTAGATTCT,0,1318998
furpa,0.5,1,1,TGTGAGACATGTATAGCTAT,0,1349271
furpa,0.5,1,1,TGTCTGTAGGGCCTCGCGCG,0,1293873
furpa,0.5,1,1,TGTCTGGACCATGATCAGTA,0,1302000
furpa,0.5,1,1,TGTCTCCTAAAAAATACATC,0,1312541
furpa,0.5,1,1,TGTCGTAAATCCTTAGACTA,0,1321675
furpa,0.5,1,1,TGTCGATGGGTCCGTGCCGG,0,1271185
furpa,0.5,1,1,TGTCCGAAATGAAGGATATA,0,1350098
furpa,0.5,1,1,TGTCCCAATTTGAGAATGTT,0,1316144
furpa,0.5,1,1,TGTCATTTCGAGAGGTGATG,0,1290905
furpa,0.5,1,1,TGTCATTGTACCTCACCAAT,0,1331288
furpa,0.5,1,1,TGTCATAGCAATGAACAGCT,0,1347472
furpa,0.5,1,1,TGTCAGGCGTTTGTCGGGCT,0,1332322
furpa,0.5,1,1,TGTCAGCAATCTGCAGGCCT,0,1348645
furpa,0.5,1,1,TGTCACTCATCAGAGCAGCG,0,1333336
furpa,0.5,1,1,TGTCACACCGCCTCTCTGTC,0,1345410
furpa,0.5,1,1,TGTCAATCACAGTAGAATAA,0,1290624
furpa,0.5,1,1,TGTATGCCTTAGGCTCCTAG,0,1329158
furpa,0.5,1,1,TGTATAGTTGATTATGTCCT,0,1287754
furpa,0.5,1,1,TGTATACTCCCGTGCCGCGT,0,1308513
furpa,0.5,1,1,TGTAGGCGACGTCCTCACGG,0,1319702
furpa,0.5,1,1,TGTAGGAATTTTTAGGTTTG,0,1305948
furpa,0.5,1,1,TGTAGCCATGACCCCCGTGC,0,1350183
furpa,0.5,1,1,TGTACGGCGGGACTTGCCCT,0,1317787
furpa,0.5,1,1,TGTACGAATTCAACTGCAGT,0,1317417
furpa,0.5,1,1,TGTAATATACCCCGATCTCA,0,1348310
furpa,0.5,1,1,TGTAACTACTTCAAGTGGGT,0,1310519
furpa,0.5,1,1,TGTAACCAGGATCCGGAGAA,0,1290821
furpa,0.5,1,1,TGTAAAGTTCCGGCCCCCCG,0,1311091
furpa,0.5,1,1,TGGTTAGCCGGCCGGGATCA,0,1274809
furpa,0.5,1,1,TGGTGGAAGTGAGTCAGACA,0,1273602
furpa,0.5,1,1,TGGTGCCGCCGCAGAAGTGT,0,1301449
furpa,0.5,1,1,TGGTCGTTTAGCTGCCTTTT,0,1319903
furpa,0.5,1,1,TGGTCGCCCAGTGATCGATC,0,1304206
furpa,0.5,1,1,TGGTAGCGAAGGTTCCACGA,0,1306417
furpa,0.5,1,1,TGGGTTTTAAGGTACCGTGA,0,1304805
furpa,0.5,1,1,TGGGGGTCTAATTCTCTCGG,0,1274280
furpa,0.5,1,1,TGGGGCTTACCGCAACATGA,0,1320251
furpa,0.5,1,1,TGGGGAACGTGAGGGAAGGC,0,1294275
furpa,0.5,1,1,TGGGGAACGCACTTCTCATC,0,1345467
furpa,0.5,1,1,TGGGCGATACAACAAGATAC,0,1271510
furpa,0.5,1,1,TGGGCCTCTCGAAATTTTTT,0,1298587
furpa,0.5,1,1,TGGGCACCACACCAGTTTGC,0,1345734
furpa,0.5,1,1,TGGGAATGGGGGTTATCTTT,0,1298047
furpa,0.5,1,1,TGGCTTCCCCGAGGGGGGTT,0,1277337
furpa,0.5,1,1,TGGCTCTAGACGGTGCTAAC,0,1274896
furpa,0.5,1,1,TGGCTCGAGCATTTGTGCGA,0,1323405
furpa,0.5,1,1,TGGCGGTTGCGGCTACCGAG,0,1348081
furpa,0.5,1,1,TGGCGCAAAAGGGGCGCTTT,0,1303387
furpa,0.5,1,1,TGGCCTTTGTGAAATTCTGA,0,1293987
furpa,0.5,1,1,TGGCCGTTGAGAAATGGAGC,0,1296499
furpa,0.5,1,1,TGGCCGTAGAAGCTTTGAGA,0,1296228
furpa,0.5,1,1,TGGCCGCACCAACATTATGC,0,1332977
furpa,0.5,1,1,TGGCACTCTCGCACGGATTC,0,1333282
furpa,0.5,1,1,TGGCAAAGATAATTTATAAC,0,1334601
furpa,0.5,1,1,TGGATTAACTTAGTTCCATT,0,1326649
furpa,0.5,1,1,TGGATCCCTAGGCCAGATTG,0,1311819
furpa,0.5,1,1,TGGAGCTACCTCTTCTGGGA,0,1350227
furpa,0.5,1,1,TGGAGATGGTAGGACCCTGT,0,1287324
furpa,0.5,1,1,TGGAGAGTGGTGAAGATAGC,0,1340430
furpa,0.5,1,1,TGGACGGCTTGATCTACTTG,0,1319707
furpa,0.5,1,1,TGGACAGCTAGCCGTTAGTC,0,1317918
furpa,0.5,1,1,TGGAAGCAATTGTTCAAATC,0,1348841
furpa,0.5,1,1,TGCTTTCGGACATGCTGTGG,0,1333072
furpa,0.5,1,1,TGCTTGTATCATGCTTATGG,0,1284197
furpa,0.5,1,1,TGCTTCCCGGTAACCGCCCA,0,1281351
furpa,0.5,1,1,TGCTTCACGGATTTAAGAGC,0,1297220
furpa,0.5,1,1,TGCTGGAACAACACGAATCT,0,1332407
furpa,0.5,1,1,TGCTGAATACTTTGACAATA,0,1278857
furpa,0.5,1,1,TGCTCGATAAGGAGGCCTTA,0,1333997
furpa,0.5,1,1,TGCTCGACACGCTCTGCCTT,0,1287082
furpa,0.5,1,1,TGCTCAGGACGAAATTGTAG,0,1276014
furpa,0.5,1,1,TGCTAGTCATGTTGACCAGT,0,1314053
furpa,0.5,1,1,TGCTACTTTCAACTGGGGGA,0,1307484
furpa,0.5,1,1,TGCTACCGGGGACGATTCTC,0,1310746
furpa,0.5,1,1,TGCGTTCTACGGACTCGACA,0,1282458
furpa,0.5,1,1,TGCGTGATAGCCGACACGCA,0,1286548
furpa,0.5,1,1,TGCGGTACGCAAGGAGTATC,0,1326718
furpa,0.5,1,1,TGCGGCGACAACCTAGCGCG,0,1348770
furpa,0.5,1,1,TGCGCACAGAGACAGACACC,0,1288728
furpa,0.5,1,1,TGCCTGTCGAGAGTGTCGGA,0,1357228
furpa,0.5,1,1,TGCCTGGATCTTGAATCTTA,0,1336367
furpa,0.5,1,1,TGCCTCATCGTCGTCAGACC,0,1315923
furpa,0.5,1,1,TGCCCTTTTCTGCGACTCTG,0,1336924
furpa,0.5,1,1,TGCCCGGCACGTGGACGCCA,0,1353099
furpa,0.5,1,1,TGCCCGCGGTGCATCAATAA,0,1298384
furpa,0.5,1,1,TGCCCGACTAGGGTTGTTAT,0,1292104
furpa,0.5,1,1,TGCCATTCACTATGCGAACA,0,1327310
furpa,0.5,1,1,TGCCATGGAAACGCTGGCAG,0,1306366
furpa,0.5,1,1,TGCCAGAAGGTCGTACTACG,0,1314286
furpa,0.5,1,1,TGCCAATTAGGGTCTTAGGT,0,1301323
furpa,0.5,1,1,TGCCAACACATGGGCTGAGT,0,1334636
furpa,0.5,1,1,TGCATTTCTATCACGCTCTC,0,1298077
furpa,0.5,1,1,TGCATTCTAGATTCGATTCT,0,1300631
furpa,0.5,1,1,TGCATTCCTCGTTGTCCTCT,0,1343794
furpa,0.5,1,1,TGCATTCCCATTGAGATTGT,0,1337473
furpa,0.5,1,1,TGCATTCAAAAAACGGTAGT,0,1326019
furpa,0.5,1,1,TGCATGAGGTCATAAGCGCA,0,1322864
furpa,0.5,1,1,TGCAGTAATGTACCACGATA,0,1328185
furpa,0.5,1,1,TGCACGAGGCATCCAGAGCA,0,1350317
furpa,0.5,1,1,TGCACGAAATCCACGCTCAG,0,1321736
furpa,0.5,1,1,TGCAAGGGGGGTATGTCGCG,0,1350140
furpa,0.5,1,1,TGCAAAAACGGGACTTAATA,0,1341370
furpa,0.5,1,1,TGATTTAACTAGCGTGGTGA,0,1341882
furpa,0.5,1,1,TGATTGTCAATCGAAAACCG,0,1342643
furpa,0.5,1,1,TGATTCTGTATTCGTCTGAG,0,1305429
furpa,0.5,1,1,TGATTCATACATGAAATGCC,0,1303973
furpa,0.5,1,1,TGATTATCTCTCGCATACAT,0,1299639
furpa,0.5,1,1,TGATGATGGGCACGAGCAGC,0,1288759
furpa,0.5,1,1,TGATGACACATGAATGCATG,0,1313529
furpa,0.5,1,1,TGAGTCAAAGATGAGGTCTT,0,1301216
furpa,0.5,1,1,TGAGGTCTCAACGGGGGTTT,0,1297143
furpa,0.5,1,1,TGAGGGGTTATCTCCCGATA,0,1346341
furpa,0.5,1,1,TGAGGCATCACTGCGCCAGG,0,1329260
furpa,0.5,1,1,TGAGCAAAGCTTTATATTCA,0,1330348
furpa,0.5,1,1,TGAGATCTTGCGTTAGCATT,0,1316081
furpa,0.5,1,1,TGAGACCCCGCACCCCTGCC,0,1333385
furpa,0.5,1,1,TGAGAACCCTTAAGCGGCTA,0,1273121
furpa,0.5,1,1,TGACGTTAGGCGAATGCTTG,0,1303377
furpa,0.5,1,1,TGACGGTCAATACGAGAGAA,0,1291514
furpa,0.5,1,1,TGACGGGAGATGTGGGGCGA,0,1285298
furpa,0.5,1,1,TGACGGACTTCGAACCTCTT,0,1340065
furpa,0.5,1,1,TGACGCGGATTCACGCTCGT,0,1285033
furpa,0.5,1,1,TGACGCACTTGGTGCACGTT,0,1294203
furpa,0.5,1,1,TGACCCAGAACAGTTTATGG,0,1272695
furpa,0.5,1,1,TGACCAAAAGCTCTCTGGCA,0,1327751
furpa,0.5,1,1,TGACAAATAAGAGTGATTCT,0,1351211
furpa,0.5,1,1,TGAATTTACAATCTATATGT,0,1308283
furpa,0.5,1,1,TGAATGCCAGAACTCCCGAC,0,1331602
furpa,0.5,1,1,TGAATCGATCGCTGCGGCGA,0,1333034
furpa,0.5,1,1,TGAATCCGCAGGTGGTTCTA,0,1308363
furpa,0.5,1,1,TGAATAGCAGAGTTCCATTA,0,1329697
furpa,0.5,1,1,TGAAGGGTATTTTAAAGTCC,0,1296315
furpa,0.5,1,1,TGAAGCTCTAAAAATTTTCA,0,1342338
furpa,0.5,1,1,TGAACTTTAAAGGCAGGGTC,0,1335690
furpa,0.5,1,1,TGAACTGCGCAGCTTCGCAT,0,1290059
furpa,0.5,1,1,TGAAAGTGGCGGGGGCGGTT,0,1272759
furpa,0.5,1,1,TCTTTTAGAGTTGTAGGAAT,0,1284231
furpa,0.5,1,1,TCTTTGCATCGCAGGCTATG,0,1339230
furpa,0.5,1,1,TCTTGGGCTGGGTATAATTA,0,1294762
furpa,0.5,1,1,TCTTGGAGGCAACACGTACT,0,1288703
furpa,0.5,1,1,TCTTGATGTTATTCCCGTTA,0,1316191
furpa,0.5,1,1,TCTTGAGTCGCGCATTACAG,0,1310893
furpa,0.5,1,1,TCTTCGAGATACGACACCAG,0,1313596
furpa,0.5,1,1,TCTTAATATCCAAAATTCGG,0,1339159
furpa,0.5,1,1,TCTGGTACCAAATAGCGCAG,0,1330825
furpa,0.5,1,1,TCTGGAGGAAGTGGAACGCT,0,1342107
furpa,0.5,1,1,TCTGGACCATGGTGAAGAAG,0,1338619
furpa,0.5,1,1,TCTGGAAGGGACGGTAGAAC,0,1285820
furpa,0.5,1,1,TCTGGAAAAGCGGTCAGTGA,0,1349045
furpa,0.5,1,1,TCTGCTCGGTCGGCTTCCGC,0,1341050
furpa,0.5,1,1,TCTGATTGGATACTGGGGCA,0,1340500
furpa,0.5,1,1,TCTGACGTGGCACGTAGCGC,0,1296092
furpa,0.5,1,1,TCTGACGACTTGGCCTTTAG,0,1301837
furpa,0.5,1,1,TCTGAATACCAGAAATGTGG,0,1350575
furpa,0.5,1,1,TCTCTTACGGTCGTTTTAAT,0,1323282
furpa,0.5,1,1,TCTCTCGGCTGACCGACTCC,0,1307008
furpa,0.5,1,1,TCTCTCATAATACCAAAGCC,0,1300274
furpa,0.5,1,1,TCTCTAGGGGGGAAGACACC,0,1298988
furpa,0.5,1,1,TCTCGTGTGAACGTACACTA,0,1312567
furpa,0.5,1,1,TCTCGCACGAGTGTCTAGCG,0,1352949
furpa,0.5,1,1,TCTCGAATTTGAATAATGTA,0,1345008
furpa,0.5,1,1,TCTCCTCTCAAAAGCAATTC,0,1305374
furpa,0.5,1,1,TCTCCAGCCTGAAAGGATCT,0,1316638
furpa,0.5,1,1,TCTCATCGGGACATGCAAAG,0,1319289
furpa,0.5,1,1,TCTATTTCGTGATATGCTTC,0,1335237
furpa,0.5,1,1,TCTATTGCTGTCGCTACTAG,0,1342629
furpa,0.5,1,1,TCTATACTTTGGGCTTACTG,0,1345816
furpa,0.5,1,1,TCTAGCCGCTAGTAGGTAAT,0,1296000
furpa,0.5,1,1,TCTACTGAGTTTGCACAAAA,0,1344500
furpa,0.5,1,1,TCTACGCTTATCTCTAGATT,0,1293327
furpa,0.5,1,1,TCTAAGTCTCCCTGTGAGTG,0,1286972
furpa,0.5,1,1,TCTAAGTCGCGTTGCGTTGT,0,1294147
furpa,0.5,1,1,TCGTTGATGCTCGTCACTGA,0,1308859
furpa,0.5,1,1,TCGTGCAAAGTGCGTAGATG,0,1312898
furpa,0.5,1,1,TCGTATGAGTTTGAGTTCCC,0,1288707
furpa,0.5,1,1,TCGTATACCTTGGGAAGGCC,0,1352799
furpa,0.5,1,1,TCGTACGTGCTATTCTCCGG,0,1309139
furpa,0.5,1,1,TCGTACATTCAGGAGGGATC,0,1357190
furpa,0.5,1,1,TCGTAATTGGGGTCGCTAAG,0,1323583
furpa,0.5,1,1,TCGGTTGCCAGGTATATTAC,0,1318844
furpa,0.5,1,1,TCGGTGGCTTACTGTCTCCA,0,1301507
furpa,0.5,1,1,TCGGTCGCCAGAAAATATTG,0,1351911
furpa,0.5,1,1,TCGGTCACCATGTGCGCATC,0,1320908
furpa,0.5,1,1,TCGGGCGAAATCAGCAGGCT,0,1352003
furpa,0.5,1,1,TCGGGCAACGTTCGCAAAAA,0,1302698
furpa,0.5,1,1,TCGGGAATGCAATGGATGGT,0,1274566
furpa,0.5,1,1,TCGGGAACAAATCTCTATTA,0,1305280
furpa,0.5,1,1,TCGGCTCGGATCGGAAAAAC,0,1340756
furpa,0.5,1,1,TCGGCTAAGCTCTAGATAGC,0,1350749
furpa,0.5,1,1,TCGGCGAAGCGTTATGGAGG,0,1283562
furpa,0.5,1,1,TCGGCCACGCTGAGTGAATG,0,1271374
furpa,0.5,1,1,TCGGAGGCGCGGCCGATAGC,0,1355551
furpa,0.5,1,1,TCGGACGGAACGGAAGCGAG,0,1271219
furpa,0.5,1,1,TCGGACGAGCTTTATTTCAA,0,1331201
furpa,0.5,1,1,TCGCTTTCCCCGGGGGTGAA,0,1338664
furpa,0.5,1,1,TCGCGTTAAAACGACTTTAG,0,1340863
furpa,0.5,1,1,TCGCGCAGGGTTTATTGACG,0,1304546
furpa,0.5,1,1,TCGCCGGACTGTTTAACGGT,0,1297056
furpa,0.5,1,1,TCGCCCCAAGGTCGTGGGGA,0,1283560
furpa,0.5,1,1,TCGCATGCGTGTGTGCGTTT,0,1337218
furpa,0.5,1,1,TCGCACCGTATCTTCGCAAG,0,1315950
furpa,0.5,1,1,TCGCAAGGCCGGGCGCATTG,0,1304732
furpa,0.5,1,1,TCGATACATCAGATGGCCGT,0,1338568
furpa,0.5,1,1,TCGAGTTTTACAAGATATAA,0,1293943
furpa,0.5,1,1,TCGAGTTCCTGCAGCGGCTG,0,1282268
furpa,0.5,1,1,TCGAGTGGGCTGGTAACAAC,0,1332933
furpa,0.5,1,1,TCGAGTGCTGACTTACGAAG,0,1303855
furpa,0.5,1,1,TCGAGGTCCGGCTAATTTGT,0,1309633
furpa,0.5,1,1,TCGAGGGGGCTTGGCATTTG,0,1321696
furpa,0.5,1,1,TCGACGGGCTGAGAGCGAAA,0,1349637
furpa,0.5,1,1,TCGACGAAGTCCTATCCGCT,0,1340531
furpa,0.5,1,1,TCGACCTTTTAACCTTCCCT,0,1328883
furpa,0.5,1,1,TCGACCGACCACCCCGTTCC,0,1344400
furpa,0.5,1,1,TCGACCCCTTTTCTTGCTCT,0,1288529
furpa,0.5,1,1,TCGAATTGTACTTGCAGTTT,0,1322784
furpa,0.5,1,1,TCGAATGCATTGGGACATTA,0,1296421
furpa,0.5,1,1,TCCTTGGTTGGGGGTAATCC,0,1346292
furpa,0.5,1,1,TCCTCGTTATGAGTAGCCGA,0,1337458
furpa,0.5,1,1,TCCTATGCGTCTATACGGGT,0,1322860
furpa,0.5,1,1,TCCGTTCCCCCCTAATTTGA,0,1272822
furpa,0.5,1,1,TCCGTCGGACACAGCTGATT,0,1351204
furpa,0.5,1,1,TCCGGGTTTGTTTTGCTGTT,0,1342997
furpa,0.5,1,1,TCCGGGCAGGCTGCTGTCTG,0,1282670
furpa,0.5,1,1,TCCGGAGCTGGAGGTTCACC,0,1339904
furpa,0.5,1,1,TCCGGACTGTCTGTGGCTTA,0,1344943
furpa,0.5,1,1,TCCGCTTAGATGAACGACAT,0,1315900
furpa,0.5,1,1,TCCGCGTGGTACTCCACGGC,0,1285522
furpa,0.5,1,1,TCCGAGTACAGTATATCACT,0,1333218
furpa,0.5,1,1,TCCGAGGGGTTGTCGGCACC,0,1347455
furpa,0.5,1,1,TCCGAGAGCGTCGAGGGTGG,0,1316672
furpa,0.5,1,1,TCCGACAGGCAGATGGCTAT,0,1350740
furpa,0.5,1,1,TCCCTGTTGATTAGTTTCGA,0,1321220
furpa,0.5,1,1,TCCCGATTCACCTCTTCCGG,0,1308565
furpa,0.5,1,1,TCCCCTAGAAGGCGATACAA,0,1274419
furpa,0.5,1,1,TCCCCATGCATTACTCCCAA,0,1282013
furpa,0.5,1,1,TCCCCAGTGAGTCGGTGTCG,0,1276446
furpa,0.5,1,1,TCCCAGAATAAGAACCAGTT,0,1284137
furpa,0.5,1,1,TCCATTTTGGTATTGGACTC,0,1292317
furpa,0.5,1,1,TCCATGGTAAAGAATTAACA,0,1298900
furpa,0.5,1,1,TCCATCACTTCCGAACTTAA,0,1350951
furpa,0.5,1,1,TCCAGTTCTTACCGTTGCGG,0,1309954
furpa,0.5,1,1,TCCAGTGCCCTGGTCAGGGC,0,1336275
furpa,0.5,1,1,TCCAGGTCAGAGATCGGTGA,0,1273327
furpa,0.5,1,1,TCCAGGCTTGACGAAGTATA,0,1288615
furpa,0.5,1,1,TCCAGGACCCAACAAATCCA,0,1272804
furpa,0.5,1,1,TCCAGCCGTTGATCGCCTGA,0,1271653
furpa,0.5,1,1,TCCACGATTACGATCACCTA,0,1325033
furpa,0.5,1,1,TCCACCTTGCGGCTGGTGAT,0,1286227
furpa,0.5,1,1,TCCAATATCTTTTGGCATCA,0,1342634
furpa,0.5,1,1,TCATTTTGCGTGCTGATTTT,0,1301854
furpa,0.5,1,1,TCATTTCCTGGTACGCTGTG,0,1299899
furpa,0.5,1,1,TCATGTCTAGGGACGGATGC,0,1327881
furpa,0.5,1,1,TCATGGCATCGCCGAACAAT,0,1294014
furpa,0.5,1,1,TCATCTTGTTCTCGGCTCGT,0,1313091
furpa,0.5,1,1,TCATATAATAGCTTTCCCTC,0,1339977
furpa,0.5,1,1,TCAGTGGGATTTGTCTACGT,0,1292295
furpa,0.5,1,1,TCAGTGCTCCGGGCAGGTTG,0,1340234
furpa,0.5,1,1,TCAGTGACCTTTAGAATGCC,0,1284001
furpa,0.5,1,1,TCAGGGGGAAAAAGTCAGAG,0,1309782
furpa,0.5,1,1,TCAGCTTCGCCCTATCAAGA,0,1335076
furpa,0.5,1,1,TCAGCCTGACCAGCAGATGA,0,1291410
furpa,0.5,1,1,TCAGATCCGCACGCCCAATT,0,1311633
furpa,0.5,1,1,TCACTTTTTTGGTCCTCTAA,0,1281196
furpa,0.5,1,1,TCACTTGTGCGGAATTGAAA,0,1300932
furpa,0.5,1,1,TCACTGTGCACATCACGTAT,0,1322820
furpa,0.5,1,1,TCACTCTGAATTGCAGAAGA,0,1357423
furpa,0.5,1,1,TCACTAATCCTATGGTCGGT,0,1347865
furpa,0.5,1,1,TCACGTCAAGGGTCACGTGG,0,1279620
furpa,0.5,1,1,TCACGGGACGTATACCTCTA,0,1286180
furpa,0.5,1,1,TCACGGCTTGCCAAGGCAAC,0,1307884
furpa,0.5,1,1,TCACGCGCACTGGCCCCAAT,0,1307014
furpa,0.5,1,1,TCACCGGAGTAACGCGTGAC,0,1342712
furpa,0.5,1,1,TCACCAACCCGTACAGCCCA,0,1294542
furpa,0.5,1,1,TCACAAGTTCCTGCGTAAGC,0,1333042
furpa,0.5,1,1,TCACAAATGCGGAATCGCCC,0,1319325
furpa,0.5,1,1,TCAATGTATGCATCCTGTAA,0,1297398
furpa,0.5,1,1,TCAATATATAGGCCGGTGGA,0,1287703
furpa,0.5,1,1,TCAATAGTAACCATCATGAT,0,1345627
furpa,0.5,1,1,TCAAGTGGGAAATCTTGAAG,0,1273984
furpa,0.5,1,1,TCAAGTAGTAAGTTGCTCCG,0,1311371
furpa,0.5,1,1,TCAAGGGAGTATTGTCCTTA,0,1274922
furpa,0.5,1,1,TCAAGGCTTTCCGGGCGTTT,0,1290542
furpa,0.5,1,1,TCAACTTGGCCGATTCCCTG,0,1292624
furpa,0.5,1,1,TCAACTATCGCGCTCAACGA,0,1284192
furpa,0.5,1,1,TCAACGCAGAAGCGCCACCA,0,1353018
furpa,0.5,1,1,TCAACAATCACAATAACAAC,0,1301353
furpa,0.5,1,1,TCAAATGCGTCGTATATCAC,0,1343529
furpa,0.5,1,1,TATTTCTAATTGGGAGTGTA,0,1350058
furpa,0.5,1,1,TATTTAATGAATAGGCCGGT,0,1279656
furpa,0.5,1,1,TATTGGGGGCCATAGTTCTA,0,1306540
furpa,0.5,1,1,TATTGGGAGAAGAGAGGATA,0,1325641
furpa,0.5,1,1,TATTGAGCAGATCACGTCTC,0,1345820
furpa,0.5,1,1,TATTCTGTCATGCAGACAGG,0,1282424
furpa,0.5,1,1,TATTCCGCCAGGCAAATAGA,0,1279580
furpa,0.5,1,1,TATTCAAAATTATCAAATTT,0,1292917
furpa,0.5,1,1,TATTATTTCCCGTTCCGATG,0,1349973
furpa,0.5,1,1,TATGTTAGTTCCATTCGGTC,0,1302470
furpa,0.5,1,1,TATGTAGCCCGCATAAGCCC,0,1318083
furpa,0.5,1,1,TATGTACCAGGGTGTTTCGC,0,1290893
furpa,0.5,1,1,TATGGCGTGCTGTTCGGTTT,0,1314334
furpa,0.5,1,1,TATGCTTCAAGCCCGGGTCT,0,1330088
furpa,0.5,1,1,TATGCGTCAACGGGACAGAG,0,1301699
furpa,0.5,1,1,TATGCGGGTGCGAGGTTGCA,0,1319385
furpa,0.5,1,1,TATGCAGAGCAACAAGGTTG,0,1308708
furpa,0.5,1,1,TATGATAGAAGCACGTCTAC,0,1354247
furpa,0.5,1,1,TATGAGATACTTAAACTTGA,0,1287298
furpa,0.5,1,1,TATGACGCACAGGAGACCAG,0,1336166
furpa,0.5,1,1,TATGAATCAATCGTTAGGTA,0,1346669
furpa,0.5,1,1,TATCTGGGGACCCGCACGCG,0,1285972
furpa,0.5,1,1,TATCGTACAGCTGGCGTACA,0,1287505
furpa,0.5,1,1,TATCCTTTATGTCGGCGGTC,0,1291468
furpa,0.5,1,1,TATCCCTAGTGCACTTATTC,0,1313706
furpa,0.5,1,1,TATCCCGGGCGGGGCGACTT,0,1341686
furpa,0.5,1,1,TATCCAACGAGTCCACTATT,0,1320127
furpa,0.5,1,1,TATCAGCTCGCAGACAGGGC,0,1295997
furpa,0.5,1,1,TATATTATGTTGCCAACAGA,0,1313964
furpa,0.5,1,1,TATAGAACTGTACAAATGTT,0,1287021
furpa,0.5,1,1,TATACTATTGTGGCTAATCA,0,1317618
furpa,0.5,1,1,TATACCTAAATTGATGCTTG,0,1333554
furpa,0.5,1,1,TATAAACAACAATTTTGGTG,0,1338496
furpa,0.5,1,1,TAGTGGGCTTCATATGACTT,0,1313315
furpa,0.5,1,1,TAGTCAGTTTCGAGGTGTAG,0,1339171
furpa,0.5,1,1,TAGTAAAACGCAGTTGAGCA,0,1325915
furpa,0.5,1,1,TAGGTTCGCGTCCTAAAGCA,0,1335029
furpa,0.5,1,1,TAGGGGGAGGCCTGCAAATA,0,1352624
furpa,0.5,1,1,TAGGCGAGGGCGGTCGAAAC,0,1321940
furpa,0.5,1,1,TAGGAGGCCGTCGCCACACC,0,1349620
furpa,0.5,1,1,TAGGACTAGATGCGAATATC,0,1323631
furpa,0.5,1,1,TAGGACGCTAATGAAAAGAA,0,1275660
furpa,0.5,1,1,TAGCTCCGGGCGGACAAAGC,0,1309758
furpa,0.5,1,1,TAGCGGACTCAAGTTGATCT,0,1342168
furpa,0.5,1,1,TAGCGCCAATAGGGGCTTAC,0,1334428
furpa,0.5,1,1,TAGCCTCGAGTCGTTACAAG,0,1323659
furpa,0.5,1,1,TAGCCGATGAGAATTAAGAC,0,1327494
furpa,0.5,1,1,TAGCATCATTTTCTCTTGAG,0,1278812
furpa,0.5,1,1,TAGCACAATTTGGCCAGAAT,0,1306691
furpa,0.5,1,1,TAGATTATCCTGAGTACCAT,0,1311104
furpa,0.5,1,1,TAGAGTTTCAGGAATCCCCT,0,1293137
furpa,0.5,1,1,TAGAGTAGTAGGAGTGAGAA,0,1338632
furpa,0.5,1,1,TAGAGTAGCTCCCGTCTGAG,0,1322774
furpa,0.5,1,1,TAGAGGCCGGGGCCGGCTGA,0,1317714
furpa,0.5,1,1,TAGAGCGGCGGGGGCGACAC,0,1279538
furpa,0.5,1,1,TAGAGACGGTTTAACATGAG,0,1340243
furpa,0.5,1,1,TAGACTTCGGCCGTTCTATG,0,1356442
furpa,0.5,1,1,TAGACTGGATAGGTAGGGGA,0,1324537
furpa,0.5,1,1,TAGACGCTTCGGGGCCTAAT,0,1296172
furpa,0.5,1,1,TAGACGAATCTACGGTAAAG,0,1325860
furpa,0.5,1,1,TAGAACATGCAGGCCACACG,0,1352964
furpa,0.5,1,1,TACTTATCCAGGACCTCCGC,0,1284841
furpa,0.5,1,1,TACTTATACGAAAAGGCCTC,0,1310880
furpa,0.5,1,1,TACTTAGAGCTCCTGCTGCT,0,1355829
furpa,0.5,1,1,TACTGCGCTGCTCAGTTCCA,0,1321528
furpa,0.5,1,1,TACTGCATCACCACAGTTCA,0,1356148
furpa,0.5,1,1,TACTGACGGCGACTGTGGCA,0,1334661
furpa,0.5,1,1,TACTCGTCCACGCTCTCGAG,0,1352263
furpa,0.5,1,1,TACTCATCAGTTTATTTGAC,0,1277649
furpa,0.5,1,1,TACTAGTGTGGACCCACCCA,0,1301380
furpa,0.5,1,1,TACGTCGCGTCCGTCGTGGA,0,1287611
furpa,0.5,1,1,TACGTATCCAGGTCCCATGT,0,1333333
furpa,0.5,1,1,TACGTACCGCGATAGCATCA,0,1348727
furpa,0.5,1,1,TACGGTCACGCGTGTTAGCT,0,1291250
furpa,0.5,1,1,TACGGGCCATGGGACCATAC,0,1302234
furpa,0.5,1,1,TACGGCGTATATCTTCATTC,0,1284834
furpa,0.5,1,1,TACGCCTGCAACGCACTTGA,0,1336831
furpa,0.5,1,1,TACGCCGTGGCCGTTGGATA,0,1329025
furpa,0.5,1,1,TACCTTGGACGCGAGACTTT,0,1300665
furpa,0.5,1,1,TACCTGATCCACGAACAAGC,0,1310689
furpa,0.5,1,1,TACCGTTGTATCGTCTGGAC,0,1354499
furpa,0.5,1,1,TACCGTCGCAAGGTCTAATA,0,1322113
furpa,0.5,1,1,TACCGTAAGACCGACTGGAT,0,1299120
furpa,0.5,1,1,TACCGGCCAGAGCGCAGTCA,0,1337583
furpa,0.5,1,1,TACCCGGATATCCAAACGAA,0,1292129
furpa,0.5,1,1,TACCCCCCGGACGAACCGCC,0,1339948
furpa,0.5,1,1,TACCCAGATTCAATTTGTGT,0,1312106
furpa,0.5,1,1,TACCAGACACGTGACGATTC,0,1317480
furpa,0.5,1,1,TACCAAACGTCCCGAAGCCT,0,1349407
furpa,0.5,1,1,TACATTTATCATTTAGAGCC,0,1275186
furpa,0.5,1,1,TACAGACTCCATGTCTTGCG,0,1303503
furpa,0.5,1,1,TACACCCCGGTCCCCCTCAG,0,1330123
furpa,0.5,1,1,TACACATCTGCAGAAGCGCC,0,1328167
furpa,0.5,1,1,TACAACATGCGATGTAGTAG,0,1274764
furpa,0.5,1,1,TAATTCTCTGCCTGGGTTGT,0,1286378
furpa,0.5,1,1,TAATGTTCTTGTAAAAATGC,0,1275032
furpa,0.5,1,1,TAATGGGCGTGGGGTTAAGT,0,1329703
furpa,0.5,1,1,TAATCCAAGGTGTGCTTCTA,0,1344380
furpa,0.5,1,1,TAATCATGTAATAGCTAATA,0,1323228
furpa,0.5,1,1,TAATCAGGCACGCAAAATGT,0,1311872
furpa,0.5,1,1,TAATCAAAGCGTAATGAAAG,0,1280935
furpa,0.5,1,1,TAATATGATAGATAATGACC,0,1334809
furpa,0.5,1,1,TAAGTTGTCGCGTGGGCGCT,0,1312487
furpa,0.5,1,1,TAAGTGTTACTAAGCTCTCA,0,1343044
furpa,0.5,1,1,TAAGGAGAGGACTCTATGCA,0,1285835
furpa,0.5,1,1,TAAGCTTTACTATCAAGGGG,0,1332628
furpa,0.5,1,1,TAAGCGGCTGCCTAGGTGCA,0,1303103
furpa,0.5,1,1,TAAGCCCGACCCTCACCAAC,0,1338348
furpa,0.5,1,1,TAAGACAGAAGTTTATTGGG,0,1303371
furpa,0.5,1,1,TAAGAATAAACCAGGTTTAC,0,1289793
furpa,0.5,1,1,TAACGTGTTCTGTATTCCTA,0,1292448
furpa,0.5,1,1,TAACGCTACCGGTCACATGC,0,1340570
furpa,0.5,1,1,TAACGATTCTAGGCGGGAGT,0,1319269
furpa,0.5,1,1,TAACCCTAACGACGTCTTTA,0,1295609
furpa,0.5,1,1,TAACACGGTATCAACTCAAG,0,1324332
furpa,0.5,1,1,TAACAAGATACTTAGGCTTC,0,1351523
furpa,0.5,1,1,TAAATGGATAAGAAAATGTT,0,1278254
furpa,0.5,1,1,TAAATCAAATGTGCGGAGCA,0,1348292
furpa,0.5,1,1,TAAAGGGGCCAAAGATTTTT,0,1345800
furpa,0.5,1,1,TAAAAGTAAAACAATCATGA,0,1289665
furpa,0.5,1,1,TAAAACCGAGCCCGTATGTG,0,1304672
furpa,0.5,1,1,GTTTTGCCTCTGAGCAAGGG,0,1355735
furpa,0.5,1,1,GTTTGGTCGCCGTCGGTCAG,0,1333683
furpa,0.5,1,1,GTTTGGGATTGTACCAGGAC,0,1290978
furpa,0.5,1,1,GTTTGGGACCTTACGAGTAC,0,1298154
furpa,0.5,1,1,GTTTCGCAGTGGCCGTACCG,0,1278976
furpa,0.5,1,1,GTTTCACGCTTCCCATTGAC,0,1340059
furpa,0.5,1,1,GTTTAGCCAGATACTCGGAT,0,1347060
furpa,0.5,1,1,GTTTACGAAAGTTTTAGGTC,0,1318287
furpa,0.5,1,1,GTTGGAGTGGAGCAAAATGT,0,1323142
furpa,0.5,1,1,GTTGCTGTAAGGACTCGTCG,0,1321933
furpa,0.5,1,1,GTTGCGGCTTACACATATTG,0,1340481
furpa,0.5,1,1,GTTGCACCCTGCGCCCAAGG,0,1271716
furpa,0.5,1,1,GTTGAATGCCACTCGGTCTT,0,1322701
furpa,0.5,1,1,GTTGAAGACAGTTCCTCTGC,0,1346340
furpa,0.5,1,1,GTTCTGCTTCACGTATCTAA,0,1291697
furpa,0.5,1,1,GTTCTCCTCGGGGCGGCTAA,0,1281220
furpa,0.5,1,1,GTTCTATCATAAGCGAAAGG,0,1282222
furpa,0.5,1,1,GTTCGGCAGGGCTTATCCCG,0,1335349
furpa,0.5,1,1,GTTCGCCTTTAGGCGAAGGG,0,1354502
furpa,0.5,1,1,GTTCGCCTGGGCGTAAGAAT,0,1334177
furpa,0.5,1,1,GTTCCGCAGTTTATGTCAAT,0,1347179
furpa,0.5,1,1,GTTCATTGTACCCTTTTAGA,0,1348118
furpa,0.5,1,1,GTTCACTCCGTGTAGAGGAG,0,1287755
furpa,0.5,1,1,GTTATCACCGCAGACCAGAG,0,1316923
furpa,0.5,1,1,GTTAGTAATCTAACTCGGCC,0,1344879
furpa,0.5,1,1,GTTAGGATGTCTAGCGCCAA,0,1325988
furpa,0.5,1,1,GTTAGATATCCGTAAGATTG,0,1325459
furpa,0.5,1,1,GTTAGAATAGCATGAATATT,0,1281507
furpa,0.5,1,1,GTTAGAAAGGACAGGCGTTC,0,1352961
furpa,0.5,1,1,GTTACCGGGATAGGCTTTTG,0,1329657
furpa,0.5,1,1,GTTACACTCGGTATTGTTGA,0,1305849
furpa,0.5,1,1,GTTAATTTGGTTCGAACTAG,0,1324845
furpa,0.5,1,1,GTTAATGATAAGGGAACTGG,0,1336217
furpa,0.5,1,1,GTTAAATAAAGTTACCTAGT,0,1284952
furpa,0.5,1,1,GTGTTGGCGGCTGATTTTCA,0,1337349
furpa,0.5,1,1,GTGTTGCGTAGTACTAGACC,0,1319579
furpa,0.5,1,1,GTGTTCGACAACGACCGGAT,0,1297359
furpa,0.5,1,1,GTGTTAATCGCATGGGGTGG,0,1299355
furpa,0.5,1,1,GTGTGACGTAGCCATAAAGG,0,1352038
furpa,0.5,1,1,GTGTCTCCCATCTTCGAGTC,0,1328937
furpa,0.5,1,1,GTGTCGTTTAACATTGAGGG,0,1331796
furpa,0.5,1,1,GTGTCGTATATGTGCCCGCA,0,1279435
furpa,0.5,1,1,GTGTCGCAGTTGCGCACAAG,0,1283820
furpa,0.5,1,1,GTGTCAAGGACGTGTGGATC,0,1276896
furpa,0.5,1,1,GTGTAGAGCGACGAACACTA,0,1353391
furpa,0.5,1,1,GTGGTTGTCTGGTGACCCTC,0,1275809
furpa,0.5,1,1,GTGGTGAAAGACTTGTCTAT,0,1353623
furpa,0.5,1,1,GTGGGTAGTCACGGGGTGTT,0,1292181
furpa,0.5,1,1,GTGGGTAATTACTCCCGCAT,0,1313319
furpa,0.5,1,1,GTGGGGGTCTAAGCGGCAGA,0,1344205
furpa,0.5,1,1,GTGGGGGCGGACTGCAGAGG,0,1345553
furpa,0.5,1,1,GTGGGATCGTCATCAGGATA,0,1292050
furpa,0.5,1,1,GTGGGAGTGAACGGACAGTT,0,1321915
furpa,0.5,1,1,GTGGGACTGAAAGCAACCAG,0,1344284
furpa,0.5,1,1,GTGGCTGAACATGTAAACGG,0,1343745
furpa,0.5,1,1,GTGGCGTAGGGACGGTTCGC,0,1293579
furpa,0.5,1,1,GTGGCGGAAAGGAGAACCAG,0,1309029
furpa,0.5,1,1,GTGGCGACTCTATGTGGTGT,0,1322539
furpa,0.5,1,1,GTGGATGCACCGACTACATT,0,1312020
furpa,0.5,1,1,GTGGACTTCTCCTAACTATT,0,1350587
furpa,0.5,1,1,GTGGACGAGAAGCAAGCGAT,0,1290055
furpa,0.5,1,1,GTGGACATACGGACCCCGCG,0,1299342
furpa,0.5,1,1,GTGCTTGCAGCAAACCTCTA,0,1277698
furpa,0.5,1,1,GTGCTTCGCGGACTACCTGT,0,1293394
furpa,0.5,1,1,GTGCTGGCCGACCTGTACCA,0,1341234
furpa,0.5,1,1,GTGCTGAAACATCCACGCAC,0,1298790
furpa,0.5,1,1,GTGCTCCCCTAAGCGGTTAC,0,1282680
furpa,0.5,1,1,GTGCGGACTCTCAGTACGAG,0,1313177
furpa,0.5,1,1,GTGCGAGATAGGTTCCTGTC,0,1328288
furpa,0.5,1,1,GTGCCTAAGAGACGGGAATA,0,1293599
furpa,0.5,1,1,GTGCCCTTTATCAGGACGTC,0,1330354
furpa,0.5,1,1,GTGCCCAGGGAGGTAACCAC,0,1291831
furpa,0.5,1,1,GTGCATTTTGATCTCTCTTC,0,1276179
furpa,0.5,1,1,GTGCAGGCAATAATAGCAGA,0,1313886
furpa,0.5,1,1,GTGCAGATTCCTACTATGTT,0,1283050
furpa,0.5,1,1,GTGCAGAGGGTATGAATTCT,0,1335623
furpa,0.5,1,1,GTGCAACCCTCGTTTCGAGC,0,1295389
furpa,0.5,1,1,GTGATCCTCAACGCGATACT,0,1347992
furpa,0.5,1,1,GTGAGATGTCGCCAATGACT,0,1290033
furpa,0.5,1,1,GTGAGATACGGGAATGTCGG,0,1300683
furpa,0.5,1,1,GTGAGAACTGCTAAGCAGCG,0,1346235
furpa,0.5,1,1,GTGACACGGTTACGACGCCT,0,1345413
furpa,0.5,1,1,GTCTTTTCACTGCATCGATC,0,1312925
furpa,0.5,1,1,GTCTTTTAAAATACTTCTCA,0,1279488
furpa,0.5,1,1,GTCTTTGTAGTATTGTCAGT,0,1295626
furpa,0.5,1,1,GTCTTAAGCGGATACACGGA,0,1298946
furpa,0.5,1,1,GTCTGGTGACTCAGGGCCCA,0,1308727
furpa,0.5,1,1,GTCTGGTAGTCGTCTGTATG,0,1346848
furpa,0.5,1,1,GTCTGCCTGTCGATAATATA,0,1307328
furpa,0.5,1,1,GTCTGACCAGAGTACTAGCA,0,1312763
furpa,0.5,1,1,GTCTCGACCTGACTCGATTT,0,1290690
furpa,0.5,1,1,GTCTAGTTTATTTCGGTCAG,0,1341377
furpa,0.5,1,1,GTCTAGGGTTTAACACTTGT,0,1333528
furpa,0.5,1,1,GTCTACATACGGTTTCGGGG,0,1343833
furpa,0.5,1,1,GTCGTTTATGGGGGACAAGG,0,1304854
furpa,0.5,1,1,GTCGTTATGAGTTCCGGGTG,0,1305257
furpa,0.5,1,1,GTCGTCGATAGATAATTACC,0,1307666
furpa,0.5,1,1,GTCGGGACATTTAAAGGCCT,0,1297734
furpa,0.5,1,1,GTCGGATCAAACGAAATATC,0,1310813
furpa,0.5,1,1,GTCGCTGCACGTGGTCGGGA,0,1351123
furpa,0.5,1,1,GTCCTCGATGAATAATTATT,0,1294727
furpa,0.5,1,1,GTCCTAGGCCCTTATTAGGA,0,1322330
furpa,0.5,1,1,GTCCGGTATAGGTCTCTACT,0,1309039
furpa,0.5,1,1,GTCCCCTGAGGTTAGCCGCA,0,1332402
furpa,0.5,1,1,GTCCCCTCGCGATCTCGATA,0,1344271
furpa,0.5,1,1,GTCCACCTTTAACTGATCTA,0,1309366
furpa,0.5,1,1,GTCCAAGGGCCGAAATCGAT,0,1331994
furpa,0.5,1,1,GTCCAAAGTAAACAGTCCTC,0,1326661
furpa,0.5,1,1,GTCATTCGTCGTTATAAATA,0,1341633
furpa,0.5,1,1,GTCATTAAAGATTCCAATGT,0,1344977
furpa,0.5,1,1,GTCATGCCAGTTTGTTGTTG,0,1316774
furpa,0.5,1,1,GTCATCCTTAGCCGTAACCT,0,1342194
furpa,0.5,1,1,GTCATAAGTTCGAAACTTTG,0,1276922
furpa,0.5,1,1,GTCAATGAAGCGCAAATAGA,0,1279604
furpa,0.5,1,1,GTATTTCTCAGGTAACTTAT,0,1323262
furpa,0.5,1,1,GTATTTACGCGCTGCCCTGG,0,1282814
furpa,0.5,1,1,GTATTGCCCCCAAGGCCTTT,0,1320685
furpa,0.5,1,1,GTATTATAATCTGTCAATAC,0,1310400
furpa,0.5,1,1,GTATTAACTGAAAAAACATG,0,1343060
furpa,0.5,1,1,GTATGGTTCACTGGTCACGG,0,1285218
furpa,0.5,1,1,GTATGGCGAGTAACCAGATC,0,1325044
furpa,0.5,1,1,GTATGCAGAAAATAAGATAT,0,1291308
furpa,0.5,1,1,GTATGAGCTAATGTCCCGTA,0,1329622
furpa,0.5,1,1,GTATGACTGATGCTGGGATA,0,1333330
furpa,0.5,1,1,GTATCTGGCCCTAGCGTTCA,0,1319341
furpa,0.5,1,1,GTATCGCGTTTGGGACCGTA,0,1291730
furpa,0.5,1,1,GTATCCTTTCGAGCAGCCAG,0,1280954
furpa,0.5,1,1,GTATCCGGTCGCTGGAAGCC,0,1273445
furpa,0.5,1,1,GTATACGAGACGTCTAGTCT,0,1279180
furpa,0.5,1,1,GTAGTACCTTGCCCTCCATA,0,1318401
furpa,0.5,1,1,GTAGGTGGAATCTACGATAG,0,1343146
furpa,0.5,1,1,GTAGGGGACTTCGGCAATGT,0,1293585
furpa,0.5,1,1,GTAGGGAACAAGAAGGCCCT,0,1279474
furpa,0.5,1,1,GTAGCTTCACAATCTCGCAT,0,1324062
furpa,0.5,1,1,GTAGACATCGGAACTCCCTG,0,1281057
furpa,0.5,1,1,GTACTCTTCAACCGTCCAAT,0,1320184
furpa,0.5,1,1,GTACGCTGTACGATAAAACT,0,1356281
furpa,0.5,1,1,GTACGCCCGAGGATGCATGG,0,1344656
furpa,0.5,1,1,GTACGCATCCCTGGCATGCT,0,1312848
furpa,0.5,1,1,GTACCCAATCACATCATACC,0,1313756
furpa,0.5,1,1,GTACAACGCCATAGATCCTT,0,1282645
furpa,0.5,1,1,GTAATTTGTGCTCATATTGA,0,1304195
furpa,0.5,1,1,GTAATACGTAATACGTCCGT,0,1321099
furpa,0.5,1,1,GTAAGTACTTATCTCGGATG,0,1280802
furpa,0.5,1,1,GTAAGATTTAGGTCGCGACG,0,1320912
furpa,0.5,1,1,GTAACTTGTCGGGGCAGAAA,0,1326972
furpa,0.5,1,1,GTAACTATGCGGTATTGCTC,0,1304904
furpa,0.5,1,1,GTAACCTCGGCCCCGCGCTT,0,1341151
furpa,0.5,1,1,GTAACCTAATGTCCCTGCGT,0,1310573
furpa,0.5,1,1,GTAACAGCGAGGGAGGTATG,0,1287669
furpa,0.5,1,1,GTAAATACGTCCCATCCGGA,0,1347159
furpa,0.5,1,1,GTAAAAGCTGCGTCTCCAGC,0,1286635
furpa,0.5,1,1,GGTTTTTGATACAGCTAGCT,0,1286830
furpa,0.5,1,1,GGTTTGTGAAATCTCGGGCT,0,1328411
furpa,0.5,1,1,GGTTTGAGGTTCTCAGATGA,0,1328646
furpa,0.5,1,1,GGTTTCCACGCATTGGATAC,0,1271676
furpa,0.5,1,1,GGTTTAGTTCCGTGGCTTAT,0,1347628
furpa,0.5,1,1,GGTTGTCTTGTGTACCCTCT,0,1279651
furpa,0.5,1,1,GGTTGTAGGTGCGTGGATGT,0,1341364
furpa,0.5,1,1,GGTTGGTGCGTGATCACAAC,0,1329549
furpa,0.5,1,1,GGTTGCACGGGCTATCTGCT,0,1280779
furpa,0.5,1,1,GGTTGACACAATATGGTGAT,0,1333287
furpa,0.5,1,1,GGTTCTGCGTAAAGACGGCC,0,1304792
furpa,0.5,1,1,GGTTCGGCGGATGGCTGGCT,0,1318461
furpa,0.5,1,1,GGTTCGAAGATTGACCAACA,0,1354983
furpa,0.5,1,1,GGTTCAACCTCATGTGTTCG,0,1338752
furpa,0.5,1,1,GGTTATCTAGACCCCACAGA,0,1293586
furpa,0.5,1,1,GGTGTGTTCATCAATGTGCA,0,1293984
furpa,0.5,1,1,GGTGTAGGTCTTAGGTCCAC,0,1330292
furpa,0.5,1,1,GGTGGTTAATGTTCGTGCAT,0,1278642
furpa,0.5,1,1,GGTGGTGGATGTTGGTCGAG,0,1339719
furpa,0.5,1,1,GGTGGTGCGCTTTAGTTTAC,0,1283452
furpa,0.5,1,1,GGTGGGAGCTCTCCGAGATC,0,1343379
furpa,0.5,1,1,GGTGGCGTCACTATGATTCT,0,1330787
furpa,0.5,1,1,GGTGGACTTCTAACACATAG,0,1339999
furpa,0.5,1,1,GGTGGACTAGCCGCACTTGT,0,1271790
furpa,0.5,1,1,GGTGCTGACCAGGAGTTATC,0,1349669
furpa,0.5,1,1,GGTGCCCGGTACATCAGTAA,0,1328564
furpa,0.5,1,1,GGTGCCAGCGTTGGAGACCG,0,1322030
furpa,0.5,1,1,GGTGAAGTCTTTTTGAAACC,0,1343041
furpa,0.5,1,1,GGTCTATGATCAATTAGGCA,0,1323204
furpa,0.5,1,1,GGTCTATAGGACGCGGGGTC,0,1340378
furpa,0.5,1,1,GGTCTAGAATTTGTCCTATT,0,1326565
furpa,0.5,1,1,GGTCGGATCGCCTCGGGTCT,0,1276919
furpa,0.5,1,1,GGTCGATAACGACTAAGGTG,0,1291295
furpa,0.5,1,1,GGTCGAAGTTATGGATGCCG,0,1317715
furpa,0.5,1,1,GGTCCTGGGCAGTCCGGGAC,0,1320356
furpa,0.5,1,1,GGTCCTAATTCGTCTCGTCA,0,1277460
furpa,0.5,1,1,GGTCCGCTCTCGGCCCTTCC,0,1346623
furpa,0.5,1,1,GGTCCCCAATTGACAGGGTG,0,1284950
furpa,0.5,1,1,GGTCATTAGACTAAACTCCC,0,1322686
furpa,0.5,1,1,GGTCAGACTTCCCACGGTGC,0,1304122
furpa,0.5,1,1,GGTCAGACTGAGTGACCCAT,0,1276714
furpa,0.5,1,1,GGTCAAGTCCTAATACCATG,0,1303384
furpa,0.5,1,1,GGTATGGTGAATTACGTGCG,0,1300075
furpa,0.5,1,1,GGTATGGATCGCTTCAGGAA,0,1291394
furpa,0.5,1,1,GGTATGACAATTCAATAACA,0,1279132
furpa,0.5,1,1,GGTATAGCACGTGGTATCGT,0,1333314
furpa,0.5,1,1,GGTAGCCTCAATAGTGAGGT,0,1331113
furpa,0.5,1,1,GGTACAAGAAGGACGTCCCA,0,1356037
furpa,0.5,1,1,GGGTTTACATTGCGGTACGC,0,1307169
furpa,0.5,1,1,GGGTTGGTATTATTACTGAG,0,1338432
furpa,0.5,1,1,GGGTTGCGTGATCCGTATCA,0,1281909
furpa,0.5,1,1,GGGTTCAGAAGCCCACAGAT,0,1303186
furpa,0.5,1,1,GGGTTAACACTTATTGTCCC,0,1289707
furpa,0.5,1,1,GGGTCTAGGTGAAGCGCGGT,0,1272756
furpa,0.5,1,1,GGGTCGGCGACGTGTTACTG,0,1307758
furpa,0.5,1,1,GGGTCGCTGTACCCGATAAG,0,1304986
furpa,0.5,1,1,GGGTCCTTAAGTTAGTCTAT,0,1320226
furpa,0.5,1,1,GGGTCCCACGACCCAAAGTA,0,1355196
furpa,0.5,1,1,GGGTCAGAGCGAAGGGGCCT,0,1353474
furpa,0.5,1,1,GGGTACTCGCACTCGAAGAC,0,1325613
furpa,0.5,1,1,GGGTACGATCGCTATGTATA,0,1273933
furpa,0.5,1,1,GGGTAATTAATATTGCCCTC,0,1274816
furpa,0.5,1,1,GGGGTTTTCGTACCGATTCC,0,1342626
furpa,0.5,1,1,GGGGTGCTCTCGATCAATGT,0,1278813
furpa,0.5,1,1,GGGGGTTTAGGGGAATGACA,0,1328659
furpa,0.5,1,1,GGGGGTTGGAATACATCTCA,0,1274808
furpa,0.5,1,1,GGGGGGTACGAACTAGGGCG,0,1309530
furpa,0.5,1,1,GGGGGCTTTTACCTGTAAAC,0,1271720
furpa,0.5,1,1,GGGGGCGGAACGAGTATGGA,0,1288178
furpa,0.5,1,1,GGGGGCCGAAGCTCAGGCTG,0,1283113
furpa,0.5,1,1,GGGGGCCAAGAATCTTTGTC,0,1321368
furpa,0.5,1,1,GGGGGATCCACAATATGTGT,0,1283912
furpa,0.5,1,1,GGGGCGCATGAACTGCCGGA,0,1332321
furpa,0.5,1,1,GGGGCCGGTAGCTTAGTGAC,0,1338809
furpa,0.5,1,1,GGGGCCCGCTTACATTTTAT,0,1351490
furpa,0.5,1,1,GGGGCATGGGCTGTACTGGA,0,1321812
furpa,0.5,1,1,GGGGCATAACCATCAGATCG,0,1327044
furpa,0.5,1,1,GGGGATACCCGTATATGTGG,0,1330437
furpa,0.5,1,1,GGGGAACTAATTCTACCGGT,0,1283780
furpa,0.5,1,1,GGGCTCAAGCGATTTTTATC,0,1315382
furpa,0.5,1,1,GGGCGGGTGGAAAGGTTCAT,0,1284206
furpa,0.5,1,1,GGGCGCTGGTTTATCGTATC,0,1293192
furpa,0.5,1,1,GGGCGATGTCATTAACCGCC,0,1285809
furpa,0.5,1,1,GGGCGAGCGCGTCACATTTC,0,1292289
furpa,0.5,1,1,GGGCCTCGGCATAAGTGTGA,0,1313195
furpa,0.5,1,1,GGGCCTCCCATTTTCGTACC,0,1278706
furpa,0.5,1,1,GGGCCAGGCGTCCTGGCCCT,0,1285469
furpa,0.5,1,1,GGGCATTGATCACCGGCCGA,0,1333578
furpa,0.5,1,1,GGGCAATATGGGAAGGTAGA,0,1304669
furpa,0.5,1,1,GGGATCGCGGTTGTTATAAG,0,1354434
furpa,0.5,1,1,GGGAGGCCACAATAATCAAT,0,1335872
furpa,0.5,1,1,GGGAGCTCAAGACGTATTCC,0,1330022
furpa,0.5,1,1,GGGAGCACCTCGTTCGTGAG,0,1337646
furpa,0.5,1,1,GGGAGAGTTCGCATGCGAGT,0,1328569
furpa,0.5,1,1,GGGACTATCGCAGGGCAGAC,0,1284150
furpa,0.5,1,1,GGGACGGTGAGGGAGGTGAC,0,1328281
furpa,0.5,1,1,GGGACATTCTCGAATTCGTA,0,1318353
furpa,0.5,1,1,GGGACAAGGTAAGAGCGTGT,0,1313083
furpa,0.5,1,1,GGGACAACCTACGTAAGGCT,0,1339884
furpa,0.5,1,1,GGGAATGGCGCAGATGCAGA,0,1292238
furpa,0.5,1,1,GGGAAGAGGCGCTGCCAACA,0,1295204
furpa,0.5,1,1,GGGAACGACCCTTGACGCTA,0,1345741
furpa,0.5,1,1,GGCTTGCTTTCCGGCAGACA,0,1278557
furpa,0.5,1,1,GGCTGGTTCCTCTTTTCGGA,0,1345131
furpa,0.5,1,1,GGCTGGCCGAGTGAGGGTAT,0,1290847
furpa,0.5,1,1,GGCTGCACCCACGTGGACCC,0,1297139
furpa,0.5,1,1,GGCTCGTTATTTCGCTCAGG,0,1347971
furpa,0.5,1,1,GGCTCACGAAGGCCATCTTG,0,1284887
furpa,0.5,1,1,GGCTATTTTGCTCATCAGTT,0,1280215
furpa,0.5,1,1,GGCTATAAATAGTCGATAAC,0,1323361
furpa,0.5,1,1,GGCTAGTATGGGGTTAATGG,0,1294461
furpa,0.5,1,1,GGCTAGGAAGAACTGCACAA,0,1350289
furpa,0.5,1,1,GGCTACGTGGTATATCTCAG,0,1303673
furpa,0.5,1,1,GGCGTTAGGATAAGGTATCG,0,1281081
furpa,0.5,1,1,GGCGTACACGGTGTGCCACT,0,1332918
furpa,0.5,1,1,GGCGGTCGGATGACGAGACG,0,1314942
furpa,0.5,1,1,GGCGGGATATACAAGTGTCC,0,1332704
furpa,0.5,1,1,GGCGGGACTTTTACGGTGAA,0,1317350
furpa,0.5,1,1,GGCGCCTTCATTGACTTTTT,0,1342044
furpa,0.5,1,1,GGCGCCGGCACACGAAGTAA,0,1287260
furpa,0.5,1,1,GGCGATTGCTTGCTTCGATT,0,1325989
furpa,0.5,1,1,GGCGATGGACATAGGTGGCC,0,1351178
furpa,0.5,1,1,GGCGAGAAGCGGGTATTTTA,0,1273554
furpa,0.5,1,1,GGCGACCACACACGATATGC,0,1289780
furpa,0.5,1,1,GGCCTTTTTACTAAATTCAA,0,1322961
furpa,0.5,1,1,GGCCGTACTCCTTAATCCCT,0,1331865
furpa,0.5,1,1,GGCCGCCTGTAGCGGGGCTC,0,1279525
furpa,0.5,1,1,GGCCGATCTGGACATGCAAG,0,1285292
furpa,0.5,1,1,GGCCCTATATTACGGAAGGG,0,1302589
furpa,0.5,1,1,GGCCATGTCGATATCGGTAT,0,1332299
furpa,0.5,1,1,GGCCATACCGAGGTAATCTT,0,1328876
furpa,0.5,1,1,GGCCACGGGTGAGGTGCCGT,0,1279250
furpa,0.5,1,1,GGCATTCGAGGAGCTACAAT,0,1323559
furpa,0.5,1,1,GGCATTCCCCTACGGCCGTA,0,1337077
furpa,0.5,1,1,GGCATGATACCTTTAGGATT,0,1302342
furpa,0.5,1,1,GGCATCCACGCCCGTTGTCC,0,1315029
furpa,0.5,1,1,GGCAGTGGTGTGAATTTCAG,0,1312510
furpa,0.5,1,1,GGCAGCATTTAGCCAGTTGT,0,1305213
furpa,0.5,1,1,GGCACTCTAGACCCTTCGGC,0,1319379
furpa,0.5,1,1,GGCACGCTAAGGCCCAGATT,0,1313561
furpa,0.5,1,1,GGCACCGTATTGCTATCATA,0,1340719
furpa,0.5,1,1,GGCACCGCATCAGCGGCGGC,0,1281199
furpa,0.5,1,1,GGCACAGATATAACCTGTTA,0,1343749
furpa,0.5,1,1,GGCAAATTGCGCCAACAGCG,0,1356383
furpa,0.5,1,1,GGCAAATCGTCTCCAGATGA,0,1302771
furpa,0.5,1,1,GGCAAATCGTACCAGACCAA,0,1316746
furpa,0.5,1,1,GGCAAATCATTCAGGCTCTC,0,1302966
furpa,0.5,1,1,GGATTTTTAGATTTATGAAG,0,1336576
furpa,0.5,1,1,GGATTTAGTTCGTTGACAGT,0,1289295
furpa,0.5,1,1,GGATTCAGATAGCTCCGGTG,0,1336510
furpa,0.5,1,1,GGATTATAATTCGCTCAGGC,0,1320173
furpa,0.5,1,1,GGATTAGGTATCAATTCTGT,0,1311708
furpa,0.5,1,1,GGATTAGGGGTCCCGGGGCA,0,1294336
furpa,0.5,1,1,GGATGCAGGGAAACCAGGGG,0,1282127
furpa,0.5,1,1,GGATGATTCCACCAAAGTGC,0,1307035
furpa,0.5,1,1,GGATGAGAAATCGCGTAATG,0,1351962
furpa,0.5,1,1,GGATCTATTTGACCGCGTCT,0,1275152
furpa,0.5,1,1,GGATCTACGCATTTCAAAGC,0,1299105
furpa,0.5,1,1,GGATCGGCCACGAGCGTTTT,0,1309857
furpa,0.5,1,1,GGATCGCTGCAGAACATTAA,0,1287997
furpa,0.5,1,1,GGATCACTGCGACGCTCGGG,0,1353912
furpa,0.5,1,1,GGATAGACACGCCGCTTCTA,0,1339944
furpa,0.5,1,1,GGAGTTATAAAGGCTCCAAA,0,1305602
furpa,0.5,1,1,GGAGTGTTCCGTCGCTTCTC,0,1349444
furpa,0.5,1,1,GGAGTGCTTGTCGCTCTTAA,0,1312520
furpa,0.5,1,1,GGAGTCTCTGGGAAGAACGA,0,1305170
furpa,0.5,1,1,GGAGTCGCCATTCCGCGATA,0,1301421
furpa,0.5,1,1,GGAGTATACGACCCCTTTCG,0,1291667
furpa,0.5,1,1,GGAGGTGAGATGCCTGTATC,0,1334136
furpa,0.5,1,1,GGAGGTCAGGATGCTAGTAT,0,1301357
furpa,0.5,1,1,GGAGGCTCTAATCATCGAAG,0,1331620
furpa,0.5,1,1,GGAGGATCGCCCTCGCGTTG,0,1282095
furpa,0.5,1,1,GGAGCGGTAAGGCCTTATAA,0,1321979
furpa,0.5,1,1,GGAGCGGGCGCTTGCAGGTG,0,1317928
furpa,0.5,1,1,GGAGCGAGCTGCCTGTGATC,0,1311580
furpa,0.5,1,1,GGAGAGTTTGAGACGCTGTT,0,1294242
furpa,0.5,1,1,GGAGAATAAAAAGTTTTCAA,0,1298917
furpa,0.5,1,1,GGAGAAGTCCAGTCACAGGC,0,1279053
furpa,0.5,1,1,GGACTTCCTGGGACATTTGT,0,1337146
furpa,0.5,1,1,GGACGTTCCAAGCGGTGGAG,0,1335003
furpa,0.5,1,1,GGACGTGAAGGATATCCTTA,0,1341652
furpa,0.5,1,1,GGACGGGATACGATCAGAGA,0,1323881
furpa,0.5,1,1,GGACGCACGTGATGTCTGAT,0,1337884
furpa,0.5,1,1,GGACAGGGGTGGTTTACTGT,0,1305464
furpa,0.5,1,1,GGACACCCTGACCCTATCGA,0,1288664
furpa,0.5,1,1,GGAATTACATTCGTTCTAGT,0,1328463
furpa,0.5,1,1,GGAATCTTGTAAGTCTCCGC,0,1338596
furpa,0.5,1,1,GGAAATATAGGAAATGGTCA,0,1345263
furpa,0.5,1,1,GGAAAGCGAGGATTCCATAC,0,1284069
furpa,0.5,1,1,GCTTTGTGGAGATAGAGGAA,0,1329318
furpa,0.5,1,1,GCTTTCGGTTCCCTTTAATG,0,1307926
furpa,0.5,1,1,GCTTGGTTTCCCGGACCGGA,0,1323310
furpa,0.5,1,1,GCTTGGGCCTGGCTGACATC,0,1302189
furpa,0.5,1,1,GCTTGGCAATCTGGTAGACT,0,1324130
furpa,0.5,1,1,GCTTGATGACTCCACGCAGA,0,1285681
furpa,0.5,1,1,GCTTGACCTCAGGTCAGGGA,0,1320731
furpa,0.5,1,1,GCTTCCAGTCACGGCAGGCA,0,1348390
furpa,0.5,1,1,GCTTCCACGCTAGCGGTGTC,0,1354606
furpa,0.5,1,1,GCTTCACCGTTTCTAGTGGT,0,1347636
furpa,0.5,1,1,GCTTATTGGCGATTCGCTTG,0,1354353
furpa,0.5,1,1,GCTTAGTATATCAGATGTAC,0,1283125
furpa,0.5,1,1,GCTTAATTGGGGGTCCCATA,0,1301156
furpa,0.5,1,1,GCTGTTATTATCGAGGGCTA,0,1314341
furpa,0.5,1,1,GCTGTCCGTAAGACTTCGTT,0,1349450
furpa,0.5,1,1,GCTGGAGGGCATCCGTGCCA,0,1273023
furpa,0.5,1,1,GCTGCGAAACGAGTGCTTTT,0,1290431
furpa,0.5,1,1,GCTGCATAATACGAATGCGC,0,1315064
furpa,0.5,1,1,GCTGCACTGGTAGCGCTCGT,0,1336888
furpa,0.5,1,1,GCTGCAAGCCAGTGCATCTA,0,1300429
furpa,0.5,1,1,GCTGACTTGGCCCCTATAGA,0,1295208
furpa,0.5,1,1,GCTGAATCAAGTAGGACCGG,0,1287246
furpa,0.5,1,1,GCTCTTTAATCTCGCACCTG,0,1290419
furpa,0.5,1,1,GCTCTGTCTCTGACGAGTTA,0,1277449
furpa,0.5,1,1,GCTCTCTGGATTTAGGGATG,0,1323966
furpa,0.5,1,1,GCTCTCTAGTTGGCACGGTG,0,1304141
furpa,0.5,1,1,GCTCTCAAGTAACCTCCGGA,0,1355523
furpa,0.5,1,1,GCTCGTGGTCCTGCCACTGA,0,1348091
furpa,0.5,1,1,GCTCGTGATTGGAGGGTTGT,0,1343228
furpa,0.5,1,1,GCTCGGATGTGTCGTAGTAT,0,1275115
furpa,0.5,1,1,GCTCCATATATGAGATGGAT,0,1289908
furpa,0.5,1,1,GCTCACCCAACAATTGGCCA,0,1314108
furpa,0.5,1,1,GCTATTATTAGTCCTTCCAT,0,1329796
furpa,0.5,1,1,GCTATACAAGCTGTGAGTCT,0,1297573
furpa,0.5,1,1,GCTAGTTCGGCGGGGACCGG,0,1346479
furpa,0.5,1,1,GCTAGCTAATAAACCTGAGC,0,1310218
furpa,0.5,1,1,GCTACTGCCAATTGGAAATT,0,1300788
furpa,0.5,1,1,GCTACACAGCTACTTTGTAG,0,1326256
furpa,0.5,1,1,GCTAATGCGCCGCGTTGGCC,0,1319948
furpa,0.5,1,1,GCTAAAAGCACTCGTCGGTC,0,1339105
furpa,0.5,1,1,GCGTTTCCGTTTCCCCGTTC,0,1278125
furpa,0.5,1,1,GCGTTGACAAACCTAAATTT,0,1327038
furpa,0.5,1,1,GCGTTCATCCTGTGGCAGAG,0,1281343
furpa,0.5,1,1,GCGTGCTAGTCATGCAACCC,0,1298069
furpa,0.5,1,1,GCGTCTCTAGCACAAAGCTG,0,1344152
furpa,0.5,1,1,GCGGTCGAAAGCAGTGTAAG,0,1322156
furpa,0.5,1,1,GCGGGTTACCTTTTAAACGC,0,1335478
furpa,0.5,1,1,GCGGGCATGGTGCTGGATAG,0,1286162
furpa,0.5,1,1,GCGGGCAGTACTTTCAGCTT,0,1325091
furpa,0.5,1,1,GCGGGAATATGACCACTTGA,0,1303485
furpa,0.5,1,1,GCGGCTCTAGTTTTCATCTG,0,1303507
furpa,0.5,1,1,GCGGCTCGGGTGCTACACAA,0,1340782
furpa,0.5,1,1,GCGGCCAGGCCCTGATGATG,0,1332700
furpa,0.5,1,1,GCGGCACATTTTTGTAGCCC,0,1331818
furpa,0.5,1,1,GCGGATATCGGAGTTTGAAG,0,1283175
furpa,0.5,1,1,GCGGATAAGGGGTACGACTC,0,1290747
furpa,0.5,1,1,GCGGAAAGGTATACTTGGGA,0,1305163
furpa,0.5,1,1,GCGCTACAGCTCGATGTTAA,0,1293495
furpa,0.5,1,1,GCGCGGCAAACGCATGTTTA,0,1296866
furpa,0.5,1,1,GCGCGAAGTTTCCGAAAGAT,0,1302356
furpa,0.5,1,1,GCGCCTCATGTAGGGTGTAT,0,1317284
furpa,0.5,1,1,GCGCCCCAACAGGCGGTATT,0,1335102
furpa,0.5,1,1,GCGCCATTTCTGGGGTAACA,0,1323053
furpa,0.5,1,1,GCGCCACTACTCACAGGCAA,0,1342004
furpa,0.5,1,1,GCGCCACGATCTAGGGAAAG,0,1354403
furpa,0.5,1,1,GCGCATGCGGAGTGTCGGCA,0,1331350
furpa,0.5,1,1,GCGCACTGGCGGTCCCATAA,0,1353083
furpa,0.5,1,1,GCGATCCCGGCCCCTATCAG,0,1299879
furpa,0.5,1,1,GCGATCACGGGTTTAACTTG,0,1338770
furpa,0.5,1,1,GCGAGGCTTGACCGTCCAAC,0,1343734
furpa,0.5,1,1,GCGAGAGTAGCACACAGGAA,0,1293769
furpa,0.5,1,1,GCGACGTCTATGCAGCCGAC,0,1313395
furpa,0.5,1,1,GCGACGTAACGCTGGGTTTC,0,1289212
furpa,0.5,1,1,GCGACGGGTGTTATGGCGGT,0,1271779
furpa,0.5,1,1,GCGACGCATAGTGACTGCTA,0,1309534
furpa,0.5,1,1,GCGACGATATGACATAGATG,0,1331097
furpa,0.5,1,1,GCGACCTGTTTGATGCTTGA,0,1297771
furpa,0.5,1,1,GCGAATTCACAAATACTGAG,0,1338447
furpa,0.5,1,1,GCGAAAGATAACCCGCCCGA,0,1308461
furpa,0.5,1,1,GCCTTTGCGTTGGACGGATA,0,1343643
furpa,0.5,1,1,GCCTTTCTATCTACAGCTTT,0,1349923
furpa,0.5,1,1,GCCTTCTGCCCCCTTCATGT,0,1297784
furpa,0.5,1,1,GCCTCTGAATGAAGCGTGCA,0,1305417
furpa,0.5,1,1,GCCTCGTGATCACTGGGGCT,0,1290008
furpa,0.5,1,1,GCCTCGGAGTCCACGAGCAT,0,1325765
furpa,0.5,1,1,GCCTCCCTAGGACAGCAGGT,0,1336713
furpa,0.5,1,1,GCCTATAAACCTAGTCCCGA,0,1286222
furpa,0.5,1,1,GCCTACGTGGGGTTCCGCTC,0,1350917
furpa,0.5,1,1,GCCTAATGCTCCCGCTCATA,0,1296063
furpa,0.5,1,1,GCCGTTAACGGTCCTGGGGT,0,1274505
furpa,0.5,1,1,GCCGTGTTGAATAACCACTG,0,1272086
furpa,0.5,1,1,GCCGTCAGGCATCAGTCCCT,0,1286834
furpa,0.5,1,1,GCCGGTCTCATAGACACTGT,0,1320238
furpa,0.5,1,1,GCCGGGGTCATAAGATGGAC,0,1336485
furpa,0.5,1,1,GCCGGGAGGCAGTTCAAAGT,0,1313823
furpa,0.5,1,1,GCCGGCGGGTTTTCGATTGC,0,1317073
furpa,0.5,1,1,GCCGCTGGATTCGCAGGCTT,0,1285864
furpa,0.5,1,1,GCCGCGTTTCTCGTCCGACG,0,1327435
furpa,0.5,1,1,GCCGCGTGTTGGCGCAATAA,0,1357525
furpa,0.5,1,1,GCCGCCTTTGTGCTCTACGA,0,1292909
furpa,0.5,1,1,GCCGCAACTCGTACTAAAAA,0,1309680
furpa,0.5,1,1,GCCGAGCTTGAAGGCGACCT,0,1272277
furpa,0.5,1,1,GCCCTGGTCTCGTATGTTTA,0,1326613
furpa,0.5,1,1,GCCCTGGAGTTCGACAGGAT,0,1325021
furpa,0.5,1,1,GCCCTGCCGGTAGGGGCGCA,0,1351076
furpa,0.5,1,1,GCCCTGAATGTATCTAGTAT,0,1316690
furpa,0.5,1,1,GCCCTCCGGGGCTCCATAGT,0,1341416
furpa,0.5,1,1,GCCCGTTGGGTAAAATGTAA,0,1318660
furpa,0.5,1,1,GCCCGTGCCAATGAGCCACG,0,1324508
furpa,0.5,1,1,GCCCGGTAATCTGGAGTAAT,0,1334476
furpa,0.5,1,1,GCCCGCTTCGGGGGAGTGTC,0,1338654
furpa,0.5,1,1,GCCCCGATGCGAGACTCACA,0,1335681
furpa,0.5,1,1,GCCCATGTCTCACGCCCTTT,0,1298880
furpa,0.5,1,1,GCCCATCAATCTCTTACTTA,0,1274650
furpa,0.5,1,1,GCCCACGACTACACACACAC,0,1352128
furpa,0.5,1,1,GCCCACACCAATAGACTGAG,0,1328537
furpa,0.5,1,1,GCCCAAGTGGCGATAAGCAT,0,1314763
furpa,0.5,1,1,GCCATTCGGGACATGCTCAT,0,1340637
furpa,0.5,1,1,GCCATCTGGCCGCTCCCGGA,0,1335354
furpa,0.5,1,1,GCCAGACGCTTAACTATAAC,0,1347120
furpa,0.5,1,1,GCCACGGTCACTGGGTCACT,0,1318137
furpa,0.5,1,1,GCCAATGTGTGTCATACAAA,0,1345419
furpa,0.5,1,1,GCCAACGAGGCTTTGTTTCG,0,1311038
furpa,0.5,1,1,GCCAAAGTGCGCTGATCCTT,0,1345755
furpa,0.5,1,1,GCCAAACTATGCTCGAGCAC,0,1323533
furpa,0.5,1,1,GCCAAAAAACCCTTGGTGTA,0,1343258
furpa,0.5,1,1,GCATTTCCAGTGAAATACTT,0,1330062
furpa,0.5,1,1,GCATGCGAAGGCTCTCTCAA,0,1281588
furpa,0.5,1,1,GCATGCATACAGATGAATAT,0,1348513
furpa,0.5,1,1,GCATGACTTATGGCTGTGGC,0,1282627
furpa,0.5,1,1,GCATGACTCTCCCAGTCCCT,0,1336984
furpa,0.5,1,1,GCATCAGAGGCGACCAGTAG,0,1280907
furpa,0.5,1,1,GCATATTCAGTTTCGCAAAA,0,1273629
furpa,0.5,1,1,GCATAGCACTCGCCTACTAC,0,1295956
furpa,0.5,1,1,GCAGTTGAGGGGACCCTGTA,0,1340529
furpa,0.5,1,1,GCAGTTAATAAACAAAAGCA,0,1315954
furpa,0.5,1,1,GCAGTCTGGCTGTTGACCGA,0,1329918
furpa,0.5,1,1,GCAGGCGCGCTTTTGACCAC,0,1335334
furpa,0.5,1,1,GCAGATTCGAAGCTGCGCCA,0,1314940
furpa,0.5,1,1,GCAGATAATGGCCCTCCCTA,0,1355123
furpa,0.5,1,1,GCACTGTCTCTTAGTGGAGA,0,1311853
furpa,0.5,1,1,GCACTAGGTCATCAATCAGT,0,1345113
furpa,0.5,1,1,GCACTACGGTGACAGTTTAG,0,1277063
furpa,0.5,1,1,GCACGGTTATTTAGTATACG,0,1339902
furpa,0.5,1,1,GCACGGCTTTATTCTTCGAA,0,1330030
furpa,0.5,1,1,GCACGGCGTAGATCCCACAC,0,1357187
furpa,0.5,1,1,GCACGCGCTTCCACAAACCG,0,1331801
furpa,0.5,1,1,GCACCCGTAGCAAGCAGTGT,0,1313817
furpa,0.5,1,1,GCACCAACGGCGACTCAAAT,0,1339545
furpa,0.5,1,1,GCACATGGATGTGACTCGCT,0,1271807
furpa,0.5,1,1,GCACATGCACAACGGTCGTA,0,1332129
furpa,0.5,1,1,GCAATAGCAGCTCTGTTTTA,0,1309145
furpa,0.5,1,1,GCAAGTTAGCAGGGGATCCG,0,1276878
furpa,0.5,1,1,GCAAGTAACGAGCTCTTCCT,0,1341533
furpa,0.5,1,1,GCAAGCGCTAATCGTACGAC,0,1301994
furpa,0.5,1,1,GCAAGCCGCCGTATGTAATA,0,1308566
furpa,0.5,1,1,GCAAGCAACCAAGTATCACA,0,1327075
furpa,0.5,1,1,GCAACCGCGAACGATCTCAC,0,1331719
furpa,0.5,1,1,GCAAATTACACTTAAGCCGG,0,1326007
furpa,0.5,1,1,GCAAACCAACACGCTCCCGC,0,1317556
furpa,0.5,1,1,GATTTGCCGGACGTTCATCG,0,1294088
furpa,0.5,1,1,GATTTCACGCCTTACCCTTG,0,1344136
furpa,0.5,1,1,GATTTACACTAGCGAAGAGA,0,1325320
furpa,0.5,1,1,GATTGTACGCATCGTAAAGG,0,1325790
furpa,0.5,1,1,GATTGGTCTAACGAGTAACA,0,1327235
furpa,0.5,1,1,GATTGGATGACCTAACTCCA,0,1326822
furpa,0.5,1,1,GATTCGCGGTGTGATTTTGG,0,1284014
furpa,0.5,1,1,GATTCCACCACACCTAACGA,0,1339039
furpa,0.5,1,1,GATTCATAGTAAGAAGATTT,0,1274046
furpa,0.5,1,1,GATTCAGCTGAGTAAGCGTA,0,1305255
furpa,0.5,1,1,GATTATAAGGGATTCGGTTT,0,1301324
furpa,0.5,1,1,GATGTTCTGCGACGAGGATT,0,1306218
furpa,0.5,1,1,GATGTAATAATATCGATTCC,0,1317820
furpa,0.5,1,1,GATGGAATTTGCCGTATGTC,0,1308130
furpa,0.5,1,1,GATGCGGAAGGCTGCCCCCT,0,1324360
furpa,0.5,1,1,GATGCCGGTCAGGACCACGC,0,1275135
furpa,0.5,1,1,GATGCCCGTATGTGTGTGAA,0,1330011
furpa,0.5,1,1,GATGCAGAGTACACCCGATG,0,1335168
furpa,0.5,1,1,GATGAGTGGTCAGGTATTGT,0,1305096
furpa,0.5,1,1,GATGAGACACCCCACACTAC,0,1354844
furpa,0.5,1,1,GATCGTCGGGGTTATTAAAT,0,1350073
furpa,0.5,1,1,GATCGTAAGTTCACCCTGCA,0,1299722
furpa,0.5,1,1,GATCGGACGTGGGAGCTTCG,0,1294429
furpa,0.5,1,1,GATCGACTAACCGTAGTCCT,0,1308143
furpa,0.5,1,1,GATCCGGGTAGCTTTGGCCA,0,1277107
furpa,0.5,1,1,GATCCCTTCATCGTGGTGGC,0,1314918
furpa,0.5,1,1,GATCCATGCCTAGTCTGATT,0,1279768
furpa,0.5,1,1,GATCACCTGTTACGGAATCC,0,1303749
furpa,0.5,1,1,GATCACAGTCCGATCCATTT,0,1293190
furpa,0.5,1,1,GATCAATAATGCTCGATGCA,0,1320178
furpa,0.5,1,1,GATCAAGACGCTATGGGCCT,0,1316399
furpa,0.5,1,1,GATATGGTTAGCGTACGGGC,0,1346366
furpa,0.5,1,1,GATATCGGGAAGCACCATTA,0,1315974
furpa,0.5,1,1,GATAGTAAGTTGGTGGGACA,0,1279873
furpa,0.5,1,1,GATAGGGGAGCTACCAATTT,0,1309463
furpa,0.5,1,1,GATAGATCCAAGTGTAAATT,0,1283783
furpa,0.5,1,1,GATACGTCGAGCTATGTCCA,0,1314785
furpa,0.5,1,1,GATAAACTTTCTCATATCTC,0,1301394
furpa,0.5,1,1,GAGTTGGGTCGAGACAAACT,0,1279245
furpa,0.5,1,1,GAGTTGGCCAAGGCAGGTGC,0,1312102
furpa,0.5,1,1,GAGTTACCGGGCTATCTCAT,0,1303798
furpa,0.5,1,1,GAGTGTCACGCACCGTCTGA,0,1328906
furpa,0.5,1,1,GAGTGGGGAGCGAATTTACT,0,1296571
furpa,0.5,1,1,GAGTGGCACCTGTCCTTCCT,0,1328817
furpa,0.5,1,1,GAGTCTGCGCTAGGTCCCCT,0,1340244
furpa,0.5,1,1,GAGTCTCGCACATGTGCCGC,0,1341724
furpa,0.5,1,1,GAGTCGAACAACGAAGGGTA,0,1301908
furpa,0.5,1,1,GAGTCCTGTAGACCTAGGAT,0,1292547
furpa,0.5,1,1,GAGTCAAGGCCAGAGGATTC,0,1297905
furpa,0.5,1,1,GAGTAACGTCCTCATGGCGA,0,1345737
furpa,0.5,1,1,GAGGGTGAGTCGCATATGTC,0,1282948
furpa,0.5,1,1,GAGGGCCTATTTGCCAGAGA,0,1284849
furpa,0.5,1,1,GAGGGCATCGATATCAGACA,0,1301231
furpa,0.5,1,1,GAGGGAGAATCGCGAGGATC,0,1348514
furpa,0.5,1,1,GAGGCCGGCCTTGGAAGCGA,0,1285180
furpa,0.5,1,1,GAGGATTCGCCCCGAAGTAC,0,1277505
furpa,0.5,1,1,GAGCTGGAATTCAGGAACTT,0,1346508
furpa,0.5,1,1,GAGCGAGCAAAGTGGCTCCC,0,1341061
furpa,0.5,1,1,GAGCGAATAAGAGATCGTCT,0,1347140
furpa,0.5,1,1,GAGCATGGTCTCTCAGTACT,0,1332707
furpa,0.5,1,1,GAGCAGAGTTCCACATTACA,0,1325556
furpa,0.5,1,1,GAGCACTGAGGGAAATAAGC,0,1285653
furpa,0.5,1,1,GAGCAAGTAATGGTCTGTGG,0,1306692
furpa,0.5,1,1,GAGATTTTCGCTGGCATTTG,0,1305774
furpa,0.5,1,1,GAGATTTATAGCAAAGTAAA,0,1283434
furpa,0.5,1,1,GAGATGCGCTTCGGTGTAGT,0,1311637
furpa,0.5,1,1,GAGATCTGTAAGTGGTAAGC,0,1321564
furpa,0.5,1,1,GAGATAAATAACCTCGGTCC,0,1288328
furpa,0.5,1,1,GAGAGTGATAGATTTAGGGA,0,1320427
furpa,0.5,1,1,GAGAGTACTTAGAATCGTCC,0,1322449
furpa,0.5,1,1,GAGAGGGCCAATCTCGTGTG,0,1300482
furpa,0.5,1,1,GAGAGGGAGTAAGGTCATGT,0,1277753
furpa,0.5,1,1,GAGAGAACAAGTACCTCGAG,0,1328925
furpa,0.5,1,1,GAGACACCGTGTTGTGCGCA,0,1312904
furpa,0.5,1,1,GAGAATTGAATAGGCTAACG,0,1299661
furpa,0.5,1,1,GAGAACAGAAATTTGTACGA,0,1356970
furpa,0.5,1,1,GAGAAAAATAGTGGTCCTCA,0,1294112
furpa,0.5,1,1,GACTTGGAACGAGAAAGCCA,0,1278724
furpa,0.5,1,1,GACTTCGTGCATCTATAGAA,0,1333865
furpa,0.5,1,1,GACTTAGATCAGGTGTCAAT,0,1344514
furpa,0.5,1,1,GACTTACTTTGTAGGCTCCT,0,1321539
furpa,0.5,1,1,GACTGTCGTATACTTTAACA,0,1309525
furpa,0.5,1,1,GACTGTCAGTTGATCGACAA,0,1281505
furpa,0.5,1,1,GACTGGTTCACGAGCGGCAT,0,1326622
furpa,0.5,1,1,GACTGGGTTGTTTAAGTGTT,0,1287249
furpa,0.5,1,1,GACTGCACCGGGGATCCCTC,0,1299573
furpa,0.5,1,1,GACTCGCAAATAGTGAATAT,0,1278697
furpa,0.5,1,1,GACTCGACGTAATAGTGCTA,0,1277566
furpa,0.5,1,1,GACTATTACAAGAAGCCCGT,0,1303311
furpa,0.5,1,1,GACTAAAGATCTGTGACACT,0,1282699
furpa,0.5,1,1,GACGTTTAATACGCATATGC,0,1338429
furpa,0.5,1,1,GACGTTCCGGGAAACTGCTG,0,1338001
furpa,0.5,1,1,GACGTGTCGGGCGAGATACC,0,1294562
furpa,0.5,1,1,GACGTGTCACAGCTTGCAAT,0,1343948
furpa,0.5,1,1,GACGTAGACCCTTAATTCAA,0,1322166
furpa,0.5,1,1,GACGGTCTCTCATATTTGTC,0,1317642
furpa,0.5,1,1,GACGGGTCCTAAACGCCGTG,0,1343407
furpa,0.5,1,1,GACGGGCCAAATTCAATTCG,0,1317808
furpa,0.5,1,1,GACGGGAGCCGAACCCTTAA,0,1355425
furpa,0.5,1,1,GACGCATATTGGGAATTATT,0,1312084
furpa,0.5,1,1,GACGAGGTAATCATGTGGAC,0,1343106
furpa,0.5,1,1,GACCTTCGAGCTAAGTTTGC,0,1355126
furpa,0.5,1,1,GACCGTCAGCCATGATCCCT,0,1342043
furpa,0.5,1,1,GACCGGTAACGAGACAAGCG,0,1323480
furpa,0.5,1,1,GACCCGTCCACAGGCTCAGA,0,1339364
furpa,0.5,1,1,GACCCCTCACAAGGCGGGCG,0,1329996
furpa,0.5,1,1,GACCCAGTCCAGTAGCATTG,0,1296050
furpa,0.5,1,1,GACCAAGGGCGAACATTCAG,0,1357605
furpa,0.5,1,1,GACATTTCACCACGGCTGTT,0,1301073
furpa,0.5,1,1,GACATTTACGCATGGTATTT,0,1275634
furpa,0.5,1,1,GACATCGACTGCCGTCACGG,0,1279834
furpa,0.5,1,1,GACATACTGTCTCCTTTATA,0,1276671
furpa,0.5,1,1,GACAGAAGTGGGGGTCCTTG,0,1300207
furpa,0.5,1,1,GACACCCAATTCACCCCCCC,0,1352316
furpa,0.5,1,1,GACAATACCCACGGGCACGG,0,1294131
furpa,0.5,1,1,GACAAGTTCCGTGTATCGAG,0,1333965
furpa,0.5,1,1,GAATTAACATACATTTGGCG,0,1305798
furpa,0.5,1,1,GAATGTTTGAAGGTTTCGAC,0,1308371
furpa,0.5,1,1,GAATGAAAGTGTATCATGGC,0,1282302
furpa,0.5,1,1,GAATCTCGCCATCTTGAGAC,0,1299193
furpa,0.5,1,1,GAATCGATGTGAAAGCAGGA,0,1306590
furpa,0.5,1,1,GAATAGCGACGAAATGTTGT,0,1340212
furpa,0.5,1,1,GAATACAATATACTGGCACG,0,1334412
furpa,0.5,1,1,GAATAAGCTTATAAATTCCG,0,1338942
furpa,0.5,1,1,GAAGTGCAACCTGGCTTACT,0,1337907
furpa,0.5,1,1,GAAGTCTAATTCTTGTCAAA,0,1347873
furpa,0.5,1,1,GAAGTCCATGGGAAGCGAAC,0,1301343
furpa,0.5,1,1,GAAGTCATCAAGCGGGGCAA,0,1334356
furpa,0.5,1,1,GAAGGCTTATCAGTTAGTGT,0,1330541
furpa,0.5,1,1,GAAGCAAGCTAGAGGACAAT,0,1281355
furpa,0.5,1,1,GAAGATCCATGTCGGCTATT,0,1296148
furpa,0.5,1,1,GAAGAGGTAGGGAGAACCAC,0,1356684
furpa,0.5,1,1,GAAGAGCGCAGGACTAGGTG,0,1340061
furpa,0.5,1,1,GAAGAATTGCCGTACTTAAG,0,1345257
furpa,0.5,1,1,GAACGCTTGAGATAGGCGTA,0,1275304
furpa,0.5,1,1,GAACGAGGTTGATCCCAAAA,0,1353576
furpa,0.5,1,1,GAACGAACCGTCGAATAGGA,0,1322747
furpa,0.5,1,1,GAACGAACATAGGATATAAA,0,1351572
furpa,0.5,1,1,GAACACATGTGTGGTTTTGT,0,1285029
furpa,0.5,1,1,GAACAACGCTTGGCAATGTG,0,1333743
furpa,0.5,1,1,GAAATTTTACTCCATCGTGG,0,1349929
furpa,0.5,1,1,GAAATGCGTGACACGCCCTA,0,1314288
furpa,0.5,1,1,GAAATACCGGCATAGTGGAT,0,1314164
furpa,0.5,1,1,GAAAGTTCGGCAGACTCTAA,0,1278680
furpa,0.5,1,1,GAAAGTGGTTTTTTGGTTGG,0,1311826
furpa,0.5,1,1,GAAAAGTGAGTGTGAGGAAG,0,1352294
furpa,0.5,1,1,GAAAACGCGGCGTTAAACTT,0,1332092
furpa,0.5,1,1,GAAAAATAACCAGATTCAGT,0,1333140
furpa,0.5,1,1,GAAAAAGGAGTCTCTTTGAT,0,1301424
furpa,0.5,1,1,CTTTTGTTTGGTAGGTTAAC,0,1277961
furpa,0.5,1,1,CTTTTGAACGGATCCCATTC,0,1311701
furpa,0.5,1,1,CTTTTAGCCGTTAAACGATG,0,1326227
furpa,0.5,1,1,CTTTGGGGCATTACGTGGGG,0,1348676
furpa,0.5,1,1,CTTTGACACGGCAATTGACT,0,1294359
furpa,0.5,1,1,CTTTCGGTAATGTGGCTAGG,0,1303708
furpa,0.5,1,1,CTTTCCCGCGGGTCACGGCC,0,1311162
furpa,0.5,1,1,CTTTCATGTTAAACGTTTGC,0,1279954
furpa,0.5,1,1,CTTTATCGAAGAAACCGCAC,0,1283165
furpa,0.5,1,1,CTTTAGGTATACAAAAATAC,0,1325325
furpa,0.5,1,1,CTTTACCCGGTCGAGTCACC,0,1283493
furpa,0.5,1,1,CTTTACAGACTCGGTTCCTC,0,1277355
furpa,0.5,1,1,CTTTAATCATAGGGATCAGC,0,1319527
furpa,0.5,1,1,CTTGTTCACGTGACGTCAAC,0,1276180
furpa,0.5,1,1,CTTGGTGTCAGGCAAATGGA,0,1314574
furpa,0.5,1,1,CTTGGCGGGGCCACCTATCA,0,1346296
furpa,0.5,1,1,CTTGGCATTGTTTGTAATAT,0,1356682
furpa,0.5,1,1,CTTGCTATGCATTATTTATA,0,1320064
furpa,0.5,1,1,CTTGCCCGGGGCCATTCGGT,0,1304191
furpa,0.5,1,1,CTTGCCACGAGCTTGTTGGC,0,1316770
furpa,0.5,1,1,CTTGACCTCTGGGTAACCGA,0,1338127
furpa,0.5,1,1,CTTGAAAGCAATGGGATGAT,0,1277508
furpa,0.5,1,1,CTTCTGTACTCTGCTTGTGT,0,1293007
furpa,0.5,1,1,CTTCTGCTCGGTGGCCCGCA,0,1275107
furpa,0.5,1,1,CTTCTACGGCGTACTCTTGC,0,1304815
furpa,0.5,1,1,CTTCTACGGCGATCGGACAC,0,1300611
furpa,0.5,1,1,CTTCCGCATCATAATCGGCG,0,1290180
furpa,0.5,1,1,CTTCCCCGGTTCCCAGGGGT,0,1319524
furpa,0.5,1,1,CTTCCATTGCGCACGCCACG,0,1272939
furpa,0.5,1,1,CTTCCAGACGAGGTTTTCGC,0,1297050
furpa,0.5,1,1,CTTCACGAGGTATCTTCGAA,0,1292417
furpa,0.5,1,1,CTTCACAACCGTCTTCATGC,0,1319841
furpa,0.5,1,1,CTTATGGTAGATCCCATGAG,0,1337251
furpa,0.5,1,1,CTTATCGTCCCTTAGGGAGT,0,1321642
furpa,0.5,1,1,CTTATCCCGTTTGCTTTTAA,0,1351861
furpa,0.5,1,1,CTTAGGGGCTTATGTTTTGT,0,1309825
furpa,0.5,1,1,CTTACGTCTCTTGCACGGTC,0,1328574
furpa,0.5,1,1,CTTACGCTGGGACAGAATTC,0,1333160
furpa,0.5,1,1,CTTAAGGGTGTGATAAGCCC,0,1302546
furpa,0.5,1,1,CTTAAGCGCTATCCCAGACT,0,1298393
furpa,0.5,1,1,CTGTTTCCCTAGATAAAAGA,0,1309032
furpa,0.5,1,1,CTGTTTAGTAAGAATCACGG,0,1342877
furpa,0.5,1,1,CTGTTTAGCCACTACTAGGG,0,1312143
furpa,0.5,1,1,CTGTTCACTAGGCATGCCGT,0,1272089
furpa,0.5,1,1,CTGTTAGGATGGGTAGCTAC,0,1272122
furpa,0.5,1,1,CTGTTACCACTTGAAACGGT,0,1328530
furpa,0.5,1,1,CTGTGTAAGGTTCGCTTTCA,0,1343357
furpa,0.5,1,1,CTGTGCTAACAACTCGAGGC,0,1340432
furpa,0.5,1,1,CTGTGCATGCTTATTTGAAC,0,1343955
furpa,0.5,1,1,CTGTCTTCGGCAAGAGAATC,0,1282781
furpa,0.5,1,1,CTGTCTACTATCGCATACGC,0,1297906
furpa,0.5,1,1,CTGTCGTGGGAGTACTCTCC,0,1344101
furpa,0.5,1,1,CTGTCCTGCGAGTGCACGAG,0,1309691
furpa,0.5,1,1,CTGTCCGAGGCGGTCCTAGT,0,1337608
furpa,0.5,1,1,CTGTCCACCACGTAATTCAC,0,1295506
furpa,0.5,1,1,CTGTATGCGTCATGGCAGTG,0,1342851
furpa,0.5,1,1,CTGTACCTCGGCAACTAGGA,0,1304408
furpa,0.5,1,1,CTGTAAGGTTCGGTGCATCC,0,1308773
furpa,0.5,1,1,CTGTAAAAGGCCAACGGCTA,0,1275889
furpa,0.5,1,1,CTGGTCCGGCAACTGCAGAA,0,1287411
furpa,0.5,1,1,CTGGTACTAAGCTAGCCGTC,0,1339466
furpa,0.5,1,1,CTGGGTTTGTTGGTGGCGAA,0,1282714
furpa,0.5,1,1,CTGGGTCCGTGAATCTTTGG,0,1340182
furpa,0.5,1,1,CTGGGTCAGCGAGCGGAGGT,0,1275594
furpa,0.5,1,1,CTGGGGTCCCCTAGGTCCAC,0,1276358
furpa,0.5,1,1,CTGGGGTAAATAGGACTGAG,0,1294411
furpa,0.5,1,1,CTGGGCGGTCATACCGCTTG,0,1296922
furpa,0.5,1,1,CTGGGATTTTGGGTTCTATC,0,1278283
furpa,0.5,1,1,CTGGCAATTGACATAAGTTT,0,1297046
furpa,0.5,1,1,CTGGCAAAATGTTTGTAGAC,0,1327849
furpa,0.5,1,1,CTGGATTTTGAAGTGATCTT,0,1281069
furpa,0.5,1,1,CTGGAAGAAAAGATATCGCT,0,1302613
furpa,0.5,1,1,CTGCTGTCCCGTAATATCTC,0,1286545
furpa,0.5,1,1,CTGCTGGCAAGATTACATGA,0,1331495
furpa,0.5,1,1,CTGCTAACGACGTTCAAAGC,0,1305846
furpa,0.5,1,1,CTGCGCTACGGTGTTTTTAA,0,1346090
furpa,0.5,1,1,CTGCGCCCGCAAGTGACCGT,0,1332966
furpa,0.5,1,1,CTGCGAGCCAAAATAAGAGC,0,1316526
furpa,0.5,1,1,CTGCGACGTGCGTGTAACGG,0,1328867
furpa,0.5,1,1,CTGCGAATCCTATTTACGAA,0,1352455
furpa,0.5,1,1,CTGCATTGCGTTTCACACTT,0,1290277
furpa,0.5,1,1,CTGCACCCGACCTAGCCGCT,0,1309689
furpa,0.5,1,1,CTGCACCCAAGTAGCAGAGG,0,1320440
furpa,0.5,1,1,CTGCAAAAACCTCAAACTTA,0,1333421
furpa,0.5,1,1,CTGATTGGGTACCATGAGCC,0,1331150
furpa,0.5,1,1,CTGATGAGTGAAGAATGGCT,0,1356298
furpa,0.5,1,1,CTGATAATATATTTAAAACC,0,1332363
furpa,0.5,1,1,CTGAGTGATAGCTCTCGGTC,0,1339183
furpa,0.5,1,1,CTGACGGTACTGGTTCTCCG,0,1294557
furpa,0.5,1,1,CTGACATATCTTGGCCGCTT,0,1307782
furpa,0.5,1,1,CTGAATCTGGCCCAGGGCAT,0,1288985
furpa,0.5,1,1,CTGAACATAGCAAGGCGACT,0,1350652
furpa,0.5,1,1,CTCTTTGGCCAATCATCGGA,0,1349264
furpa,0.5,1,1,CTCTTTGCAAGGTGATGAGA,0,1293164
furpa,0.5,1,1,CTCTTGTGAGAAAAGTATTC,0,1288106
furpa,0.5,1,1,CTCTTCATCCGCGCTCCAGC,0,1310589
furpa,0.5,1,1,CTCTTCAGAGGACGGTGCCT,0,1335929
furpa,0.5,1,1,CTCTTCAAATTTATTAGGCC,0,1324291
furpa,0.5,1,1,CTCTGTGGACCAGTTGTCCC,0,1346745
furpa,0.5,1,1,CTCTGGATTTTCTACAGCCG,0,1310292
furpa,0.5,1,1,CTCTGAGCATGGAAATGTTG,0,1320673
furpa,0.5,1,1,CTCTGAAATTGAGAGTTTTG,0,1338587
furpa,0.5,1,1,CTCTCCGTTCCAGTTTCTCA,0,1349775
furpa,0.5,1,1,CTCTATTATAGATCACATGC,0,1289820
furpa,0.5,1,1,CTCTAGTATCGTCATAGTGC,0,1301591
furpa,0.5,1,1,CTCTACAGTAGTGAAGTAAT,0,1330865
furpa,0.5,1,1,CTCGTTAACTAGGACGGGGA,0,1312739
furpa,0.5,1,1,CTCGGTCCGTAATCGAGCAA,0,1311036
furpa,0.5,1,1,CTCGGGCTAGCGCCTTCCCC,0,1291209
furpa,0.5,1,1,CTCGGAGGGCTCTACAGAGT,0,1322097
furpa,0.5,1,1,CTCGCGGAAATGGCCGTACA,0,1349255
furpa,0.5,1,1,CTCGACTGATGCAGGGCTCG,0,1332655
furpa,0.5,1,1,CTCGAAAGTAATATCAACAC,0,1295778
furpa,0.5,1,1,CTCCTGTTAGGTGATCCTAC,0,1307041
furpa,0.5,1,1,CTCCTGGTGCAGACTGATAC,0,1274250
furpa,0.5,1,1,CTCCGTGAGCCCCGGACATG,0,1315545
furpa,0.5,1,1,CTCCGGAGCTATATATGCAG,0,1310584
furpa,0.5,1,1,CTCCGCGTGTGAGCTAGGGG,0,1279371
furpa,0.5,1,1,CTCCGCCGTCAGTGCTGGTC,0,1297943
furpa,0.5,1,1,CTCCGCATCCAGCTCGTTTA,0,1324943
furpa,0.5,1,1,CTCCGATTACAAGGGCACCG,0,1292576
furpa,0.5,1,1,CTCCCTCGTGACCTTGGTGG,0,1347129
furpa,0.5,1,1,CTCCCTCGGGCGCGTACTCC,0,1280855
furpa,0.5,1,1,CTCCCTCGGGAAATACAATA,0,1332227
furpa,0.5,1,1,CTCCCGATTGGAGGCGTTCC,0,1284631
furpa,0.5,1,1,CTCCATTACACCAACGATCA,0,1344499
furpa,0.5,1,1,CTCATTTAACAACCCCCAGG,0,1342385
furpa,0.5,1,1,CTCATTCCGATCCCGTAGTG,0,1275460
furpa,0.5,1,1,CTCATGCAGGGCGTGTTTGG,0,1273337
furpa,0.5,1,1,CTCATCTTATATCCTGCCCA,0,1293242
furpa,0.5,1,1,CTCAGCAGGTGGTCCCGGAC,0,1289989
furpa,0.5,1,1,CTCAGCAATCCCAATGCTAC,0,1345866
furpa,0.5,1,1,CTCACCTCATAGTTAGGGCG,0,1310949
furpa,0.5,1,1,CTCACAGATCATGCCAATCG,0,1285307
furpa,0.5,1,1,CTATTTCATTGCGGGTCGTT,0,1296951
furpa,0.5,1,1,CTATTTAAGATATCCACCTG,0,1351496
furpa,0.5,1,1,CTATTGTTCGCACCAAGCCC,0,1282085
furpa,0.5,1,1,CTATTGCGACTGAGCACGTG,0,1279961
furpa,0.5,1,1,CTATGCGGCTCTATGTAAAT,0,1327150
furpa,0.5,1,1,CTATGACACGGAAAGCCGGA,0,1308600
furpa,0.5,1,1,CTATCGGAGCGTCTCCTTAA,0,1280441
furpa,0.5,1,1,CTATAGCTAACGTCAAAAGA,0,1306428
furpa,0.5,1,1,CTATAAGGTACTCTCCAAAG,0,1323275
furpa,0.5,1,1,CTAGTTAGGAGAAGAGAAGT,0,1300914
furpa,0.5,1,1,CTAGTGGTTGTTTATCCCAT,0,1339126
furpa,0.5,1,1,CTAGGTTACAAAGGAATGTG,0,1317739
furpa,0.5,1,1,CTAGGTACCCATCTCCTTTA,0,1297471
furpa,0.5,1,1,CTAGGCGGACGGTAGAGGGT,0,1349547
furpa,0.5,1,1,CTAGGATGGGATAACGCTAC,0,1324205
furpa,0.5,1,1,CTAGGAGTGATTCTACCGGT,0,1280194
furpa,0.5,1,1,CTAGCTACTGTGCCGTCAGA,0,1341183
furpa,0.5,1,1,CTAGCGGTATGCGGTATTAT,0,1320970
furpa,0.5,1,1,CTAGCATTCTTGGATAGATG,0,1352181
furpa,0.5,1,1,CTAGAGTCGCGGAAGTACCT,0,1285506
furpa,0.5,1,1,CTACTAACCCATTTGGACGT,0,1324950
furpa,0.5,1,1,CTACGGTCGCTAATAAGAGC,0,1321585
furpa,0.5,1,1,CTACGGGAAAGAGGCGAGGA,0,1294124
furpa,0.5,1,1,CTACGCTCACCCAAACCAAC,0,1327982
furpa,0.5,1,1,CTACGCATAGGATTTTCGTA,0,1344045
furpa,0.5,1,1,CTACGAGGATCGAAGTCTTC,0,1319375
furpa,0.5,1,1,CTACGACCAAGGCAGCGTGT,0,1296071
furpa,0.5,1,1,CTACCACGACTCTCATCCGC,0,1322220
furpa,0.5,1,1,CTACCACCGCGACTTCTAGG,0,1288909
furpa,0.5,1,1,CTACATTTTCTCGTGGATGT,0,1339871
furpa,0.5,1,1,CTACAGTGGGCTGAGTCTGC,0,1345669
furpa,0.5,1,1,CTACAGGTCTCCGAAGCGCC,0,1276988
furpa,0.5,1,1,CTACAACCAGACAGACTTCT,0,1311323
furpa,0.5,1,1,CTAATTCATATGGTGGTACT,0,1280229
furpa,0.5,1,1,CTAATGGACCCATGTTACTT,0,1355449
furpa,0.5,1,1,CTAAGCGTAGGTATGTTACA,0,1302158
furpa,0.5,1,1,CTAAGCCAGGTGGGATACAA,0,1301039
furpa,0.5,1,1,CTAACGCGGCTGATTATTTA,0,1286179
furpa,0.5,1,1,CTAACATGCAGTATCTACCT,0,1341197
furpa,0.5,1,1,CGTTTGCTGTAAATTTAGAC,0,1319760
furpa,0.5,1,1,CGTTGGTTTGACTCCAGATG,0,1330226
furpa,0.5,1,1,CGTTGCTGCGTAGCAACCGA,0,1353175
furpa,0.5,1,1,CGTTCTCAGAATCCAGTAAT,0,1349922
furpa,0.5,1,1,CGTTCGATCTAATTTCTCAT,0,1313514
furpa,0.5,1,1,CGTTCCAGGGCGCTACGGCA,0,1338975
furpa,0.5,1,1,CGTTCATCCTCCCCCTAGAC,0,1320141
furpa,0.5,1,1,CGTTCAAGCTGTAGGATATG,0,1285740
furpa,0.5,1,1,CGTTATAGTTGAAGAAGGGT,0,1305747
furpa,0.5,1,1,CGTTAGGTGCTCACGTGGAG,0,1280499
furpa,0.5,1,1,CGTTAGGCATCATAGCGGAT,0,1298099
furpa,0.5,1,1,CGTTACGACCCTCCTACTTC,0,1283233
furpa,0.5,1,1,CGTTACCCGGAGAGAGTGCT,0,1352403
furpa,0.5,1,1,CGTGTCGGACCATGTTATAC,0,1294896
furpa,0.5,1,1,CGTGTAGACAAGTACGGAAT,0,1314340
furpa,0.5,1,1,CGTGGCGGGGGTCAAATCGC,0,1352135
furpa,0.5,1,1,CGTGGCAACTGGGCATGACT,0,1342057
furpa,0.5,1,1,CGTGGAGGACTCAACACTAT,0,1299817
furpa,0.5,1,1,CGTGCAGCGACGACATGAGC,0,1339211
furpa,0.5,1,1,CGTGAGTCAAAGAATTGGGC,0,1326824
furpa,0.5,1,1,CGTGAGAGTGCATAGGGCGG,0,1334252
furpa,0.5,1,1,CGTCTGGCCCACACCTGGCC,0,1301044
furpa,0.5,1,1,CGTCTCCTTCAATGTTTGGA,0,1316750
furpa,0.5,1,1,CGTCGTCTGACGGCAAACAC,0,1293509
furpa,0.5,1,1,CGTCGTCCAGGTAGCTGGAG,0,1317042
furpa,0.5,1,1,CGTCCTCAGACTTCAAAGAT,0,1323173
furpa,0.5,1,1,CGTCCGAGCGGTGGTTGAAG,0,1279706
furpa,0.5,1,1,CGTCCCGTTTTGTACTGGCG,0,1341031
furpa,0.5,1,1,CGTCCCGGCTTCGCTGCGCC,0,1342578
furpa,0.5,1,1,CGTCACTAAGTTTGTTCTCA,0,1354958
furpa,0.5,1,1,CGTCACGCATGAGGCAAACC,0,1280732
furpa,0.5,1,1,CGTATTGGGCGCCTCACTGG,0,1329712
furpa,0.5,1,1,CGTATGCCGCAGCTACACAT,0,1307444
furpa,0.5,1,1,CGTATATAGACGTTAGACTA,0,1285575
furpa,0.5,1,1,CGTAGTGGGTTCAACTTCTG,0,1341520
furpa,0.5,1,1,CGTAGGACTGCTGTCAAGTG,0,1327125
furpa,0.5,1,1,CGTACGTTTTTCGCTCTAAC,0,1293737
furpa,0.5,1,1,CGGTGGGAAGTCACTGCGAT,0,1271540
furpa,0.5,1,1,CGGTCAACCTTGGACACAGG,0,1347041
furpa,0.5,1,1,CGGTATGCACCATTCATTGT,0,1279314
furpa,0.5,1,1,CGGTAGTGATAATGTAACCC,0,1325350
furpa,0.5,1,1,CGGTAGGTGTTCGTGGAGCC,0,1276299
furpa,0.5,1,1,CGGTACCATCGTGATCCCCC,0,1290223
furpa,0.5,1,1,CGGTAATCCCCGATCGCCTT,0,1348328
furpa,0.5,1,1,CGGTAATAGCACCATTGGGA,0,1294544
furpa,0.5,1,1,CGGTAAAGGCCCTGTACTGT,0,1348845
furpa,0.5,1,1,CGGGTTCCTATCCTGGGGTC,0,1273118
furpa,0.5,1,1,CGGGTGTGTTTGGCGCAGAG,0,1277154
furpa,0.5,1,1,CGGGTCCGAGAGGAGGTCTG,0,1339815
furpa,0.5,1,1,CGGGGGACCTGTCTGTGCGA,0,1296236
furpa,0.5,1,1,CGGGGATCGCGGTCCAAGTC,0,1329700
furpa,0.5,1,1,CGGGCCGTTTTAATAGGTCT,0,1312108
furpa,0.5,1,1,CGGGCAGTAATGGGGTGATC,0,1297852
furpa,0.5,1,1,CGGGAGATGGTGCGGCGGCC,0,1317082
furpa,0.5,1,1,CGGGACGATTCGACTGTCTT,0,1308786
furpa,0.5,1,1,CGGCTTGTGGACACGCTTTG,0,1339791
furpa,0.5,1,1,CGGCTTATTAATTCGTTTTG,0,1317155
furpa,0.5,1,1,CGGCTGGACTCCTGGCATTA,0,1289043
furpa,0.5,1,1,CGGCTGAGGACTACCCCATC,0,1299067
furpa,0.5,1,1,CGGCTCTACGACAGGAGCGA,0,1343882
furpa,0.5,1,1,CGGCCACCAAGGCCTATAAG,0,1295429
furpa,0.5,1,1,CGGCATGCTAGACTCCACTC,0,1303558
furpa,0.5,1,1,CGGCAGCATTAATAAGAAGG,0,1323236
furpa,0.5,1,1,CGGCAAGCTTGTCGCTTTGT,0,1288931
furpa,0.5,1,1,CGGATTTGACCTTTGCGACG,0,1340739
furpa,0.5,1,1,CGGATTCGTAGGCGGCTTTA,0,1354640
furpa,0.5,1,1,CGGATGTCAGCAGCACATAG,0,1309395
furpa,0.5,1,1,CGGATGGTTGGATTTACAAC,0,1306798
furpa,0.5,1,1,CGGATGATTGAACTTTAGGC,0,1287999
furpa,0.5,1,1,CGGATATTCTGAGTCCTCGT,0,1325365
furpa,0.5,1,1,CGGATAATGCCATCTCGTCG,0,1284575
furpa,0.5,1,1,CGGAGCTAGTACACTAACTT,0,1340092
furpa,0.5,1,1,CGGAGACAGTGAACCAGGGG,0,1271741
furpa,0.5,1,1,CGGACTTTATTGCATCGCTA,0,1310931
furpa,0.5,1,1,CGGACCTCCTAGCTATGACC,0,1346944
furpa,0.5,1,1,CGGACCGAATGAAGGGTGCA,0,1313402
furpa,0.5,1,1,CGGACATTTTGACATGGATT,0,1332870
furpa,0.5,1,1,CGGACATCAACGCGCTTTTT,0,1308360
furpa,0.5,1,1,CGGACACCGCCCCAAACTGA,0,1275216
furpa,0.5,1,1,CGGAAGCATACGATACCACG,0,1286019
furpa,0.5,1,1,CGGAAATCTTCATGGTTTCA,0,1282235
furpa,0.5,1,1,CGGAAATCAATCGGGATTCC,0,1294738
furpa,0.5,1,1,CGCTTTGAGAAGTACAGCGT,0,1337764
furpa,0.5,1,1,CGCTTTAGTGCTGCCATTGG,0,1355269
furpa,0.5,1,1,CGCTTGTCTAAGCGGTGCAT,0,1275002
furpa,0.5,1,1,CGCTTCGACTGATAGGTATA,0,1276187
furpa,0.5,1,1,CGCTTAATTCAGGAGGCACT,0,1275461
furpa,0.5,1,1,CGCTGGTTGATGTATAAGGC,0,1298006
furpa,0.5,1,1,CGCTGGGCCTGAAGTGGGAG,0,1281756
furpa,0.5,1,1,CGCTGGATACTGAAGCAACT,0,1348857
furpa,0.5,1,1,CGCTGACCCGTTGTACGGTT,0,1350794
furpa,0.5,1,1,CGCTCGTAGCTAGGGTAAGT,0,1345328
furpa,0.5,1,1,CGCTCGGACTTCAACTTTCT,0,1272107
furpa,0.5,1,1,CGCTCCCGTGAAGGATCGCG,0,1280159
furpa,0.5,1,1,CGCTCACTTGCATATATTGT,0,1325117
furpa,0.5,1,1,CGCTATTGTTCAAATGTTCC,0,1332841
furpa,0.5,1,1,CGCTAGCCTGAGTCGAGGGT,0,1286528
furpa,0.5,1,1,CGCTACGGGTGGCTCGGTGA,0,1290867
furpa,0.5,1,1,CGCGTCGTCTCATAAAGGGT,0,1291255
furpa,0.5,1,1,CGCGGGTTTGACTGGGCAAT,0,1287790
furpa,0.5,1,1,CGCGGGGTGGTCGTCTCTCA,0,1278544
furpa,0.5,1,1,CGCGGCTGGGGCTTCGCCGT,0,1281016
furpa,0.5,1,1,CGCGGATTACTGTCCGGAAG,0,1276060
furpa,0.5,1,1,CGCGGAATCGCTGTTCGTAT,0,1318274
furpa,0.5,1,1,CGCGCTGAGATTATTTAACG,0,1282508
furpa,0.5,1,1,CGCGCGTGCGCATGTGATTC,0,1345615
furpa,0.5,1,1,CGCGAAACCACAATGCATGT,0,1288360
furpa,0.5,1,1,CGCCTGTGCATCGGACAACA,0,1272320
furpa,0.5,1,1,CGCCTCCGTAGATTCCAACG,0,1339573
furpa,0.5,1,1,CGCCTAAAGATGATGTGCCA,0,1306299
furpa,0.5,1,1,CGCCGTGATCTGATTACCGA,0,1272686
furpa,0.5,1,1,CGCCGGTATTTTTAGAAATC,0,1320982
furpa,0.5,1,1,CGCCATGGTTACCCCCATTT,0,1310445
furpa,0.5,1,1,CGCCATGGATTAGTGTGGCC,0,1295332
furpa,0.5,1,1,CGCCATATTTGTCCGGGCTA,0,1299806
furpa,0.5,1,1,CGCCAATGCATACCTCTGGT,0,1307207
furpa,0.5,1,1,CGCCAATATTTCGGTAGCGG,0,1291405
furpa,0.5,1,1,CGCCAACATTCAGATTCGAA,0,1300038
furpa,0.5,1,1,CGCATTTAAGATTGATTTTG,0,1330503
furpa,0.5,1,1,CGCATAATTAGGTAGACGGC,0,1327840
furpa,0.5,1,1,CGCAGTTCGTAGAGCGGCTA,0,1354269
furpa,0.5,1,1,CGCACGCCCCCCGAGCTCCC,0,1340279
furpa,0.5,1,1,CGCACCCCGGACTGGGTCCT,0,1311239
furpa,0.5,1,1,CGCACAAATAAGGCACAACC,0,1352962
furpa,0.5,1,1,CGCAACGCTCCATAGACATG,0,1321167
furpa,0.5,1,1,CGCAACGCGACTGATAGGTT,0,1336875
furpa,0.5,1,1,CGATTATAGTCCACGGAATA,0,1323857
furpa,0.5,1,1,CGATTAGACATTCAAATTGA,0,1294467
furpa,0.5,1,1,CGATGCTGAAGCGTCAAACG,0,1277357
furpa,0.5,1,1,CGATGACTCCGGGACAGGCT,0,1322313
furpa,0.5,1,1,CGATGACAACAGGGGGAAAA,0,1318951
furpa,0.5,1,1,CGATGAAAGTGAACCCCAAT,0,1338004
furpa,0.5,1,1,CGATCACCCAGTGTGTACCA,0,1311999
furpa,0.5,1,1,CGATATCGGTTGTTCGCCCT,0,1335338
furpa,0.5,1,1,CGATAGGGGAGTCCCGAGTC,0,1295702
furpa,0.5,1,1,CGATAGCCTGCGTAATGATC,0,1335620
furpa,0.5,1,1,CGATAATCACAATGTCTGGT,0,1286072
furpa,0.5,1,1,CGATAATAATAGGTTCGTAT,0,1306510
furpa,0.5,1,1,CGAGTGTAGTAAGTAGTAAA,0,1333305
furpa,0.5,1,1,CGAGTCCCAATCTCGATCAC,0,1318473
furpa,0.5,1,1,CGAGTAACATTTAAGTTCTG,0,1272281
furpa,0.5,1,1,CGAGGTGGATGTTCCTGGTA,0,1355240
furpa,0.5,1,1,CGAGGTGACCGATTGGGGTC,0,1294942
furpa,0.5,1,1,CGAGGGCACGCTGTCCCGAG,0,1272325
furpa,0.5,1,1,CGAGGCGATGGTGGAGAGCG,0,1272667
furpa,0.5,1,1,CGAGGATTTTAGGAATCTGG,0,1300399
furpa,0.5,1,1,CGAGCTAGCAGCGTTTCCGT,0,1316969
furpa,0.5,1,1,CGAGAGAGCCTTGCACGACC,0,1333672
furpa,0.5,1,1,CGAGAATGGTATTGACATTT,0,1352334
furpa,0.5,1,1,CGACTTGTTCTCTGCTACTT,0,1275008
furpa,0.5,1,1,CGACTTCGTTCTCTAAGAGG,0,1307499
furpa,0.5,1,1,CGACTGAATCTACACATGCT,0,1354979
furpa,0.5,1,1,CGACTCGCCTAATACCTATG,0,1301007
furpa,0.5,1,1,CGACTCCCAGTTGCCTGTTT,0,1286404
furpa,0.5,1,1,CGACTAGCCAGTGAGTATGT,0,1283131
furpa,0.5,1,1,CGACTAAACACCAAGTGCGT,0,1328631
furpa,0.5,1,1,CGACGCTTTCGACTCATTCT,0,1272217
furpa,0.5,1,1,CGACGAAATCCGGTAATGAC,0,1325422
furpa,0.5,1,1,CGACCTGAAATTGGTTCTCC,0,1339094
furpa,0.5,1,1,CGACCGGGCAGATGCATCCA,0,1301366
furpa,0.5,1,1,CGACCGGAGCCGCCTAAACA,0,1294757
furpa,0.5,1,1,CGACCCGTAGGCTTAGTGTA,0,1298918
furpa,0.5,1,1,CGACCCGCTAATCGAGGGCG,0,1349292
furpa,0.5,1,1,CGACCATTCGTTAGAAAATG,0,1307994
furpa,0.5,1,1,CGACCACCCCCGCGTTGCAG,0,1296828
furpa,0.5,1,1,CGACCAAGTACCATCTAGGG,0,1341953
furpa,0.5,1,1,CGACCAAGCTTGGCGGCCTG,0,1346553
furpa,0.5,1,1,CGACATAGCGTCGCCGGTTA,0,1333741
furpa,0.5,1,1,CGACACCTTGAACGGATGGC,0,1315905
furpa,0.5,1,1,CGACACCGCAGAGTCTTGAA,0,1292939
furpa,0.5,1,1,CGAATCTGCCGGCATACAGT,0,1286308
furpa,0.5,1,1,CGAATCTGCAGGAGACAAAA,0,1275661
furpa,0.5,1,1,CGAAGACGATCGGAGCACAA,0,1325499
furpa,0.5,1,1,CGAAGAATTATTGGGGGTCT,0,1275926
furpa,0.5,1,1,CGAACATTTTAAGTCGGCGC,0,1347601
furpa,0.5,1,1,CCTTTTGTATTCTGAGTGCT,0,1292949
furpa,0.5,1,1,CCTTTTGGGTTAGGTTTGCG,0,1290362
furpa,0.5,1,1,CCTTTTGCGTCCATCCGTTC,0,1291083
furpa,0.5,1,1,CCTTTGTTACGGTATGCTGT,0,1308187
furpa,0.5,1,1,CCTTTATAGAGCGTAACGAT,0,1286472
furpa,0.5,1,1,CCTTGTCTTATCTGCGACGA,0,1342641
furpa,0.5,1,1,CCTTGTCCTATAGTAGCCGG,0,1276442
furpa,0.5,1,1,CCTTGTACGTATGTCACATC,0,1319299
furpa,0.5,1,1,CCTTGGTAAGGGAGGCGGCA,0,1278074
furpa,0.5,1,1,CCTTGCACATTGGAAGGAGC,0,1286911
furpa,0.5,1,1,CCTTCGGTGATAAGGTGATA,0,1321867
furpa,0.5,1,1,CCTTCGATACCCATTATGCG,0,1320769
furpa,0.5,1,1,CCTTCCGGCCCCTTGCAACC,0,1287175
furpa,0.5,1,1,CCTTATTGATCGCTTCACTA,0,1288922
furpa,0.5,1,1,CCTTATCATTTATACTGATA,0,1346046
furpa,0.5,1,1,CCTTACTGCCAGGTGCACTG,0,1354074
furpa,0.5,1,1,CCTTACGGCGTTCATTTTCA,0,1317421
furpa,0.5,1,1,CCTTAAGATTCTCCTAGGAC,0,1319270
furpa,0.5,1,1,CCTGTCGGTTTCTTTAATCT,0,1288826
furpa,0.5,1,1,CCTGTAAGGGCCGTTTGGCT,0,1317264
furpa,0.5,1,1,CCTGGTAGCAGAAGAGCATC,0,1301226
furpa,0.5,1,1,CCTGGCCTTTACGATAGGGC,0,1334135
furpa,0.5,1,1,CCTGGCAAATACTTAACAGA,0,1322391
furpa,0.5,1,1,CCTGGAGCACCGATCGGAAA,0,1305307
furpa,0.5,1,1,CCTGGACTCAGGTCAGGAGT,0,1318130
furpa,0.5,1,1,CCTGGAAACCCTTTCATATG,0,1310022
furpa,0.5,1,1,CCTGCGTACCCTGCACCGAT,0,1316425
furpa,0.5,1,1,CCTGAGTCCTATAAGGGACA,0,1297589
furpa,0.5,1,1,CCTGAGACGAACTGCGTGCT,0,1325358
furpa,0.5,1,1,CCTGACGAGACTTTACAGGT,0,1309041
furpa,0.5,1,1,CCTGACAAGCCCATCAGAGG,0,1319764
furpa,0.5,1,1,CCTCTGTCCTTTCCACTACA,0,1304627
furpa,0.5,1,1,CCTCGCTCATGATAGTCATA,0,1325710
furpa,0.5,1,1,CCTCCTTTTGTCATTATTCT,0,1347655
furpa,0.5,1,1,CCTCCCGTCTTGGCGGCGTG,0,1276535
furpa,0.5,1,1,CCTCCCCACCTCCAGACTGT,0,1284092
furpa,0.5,1,1,CCTCCCAAAATATACCGCAA,0,1320016
furpa,0.5,1,1,CCTCCACTGTTTCCCACCAA,0,1326705
furpa,0.5,1,1,CCTCAAGAGTCTTTGGGGAC,0,1275583
furpa,0.5,1,1,CCTATGAACTTCCACGCGGT,0,1332845
furpa,0.5,1,1,CCTATACGAATTAGACAATT,0,1352118
furpa,0.5,1,1,CCTAGTGGGCACTGCATTGG,0,1288656
furpa,0.5,1,1,CCTAGAACTGATGGGACTTC,0,1333016
furpa,0.5,1,1,CCTACTCAGAAGATCAGCAA,0,1314012
furpa,0.5,1,1,CCTACGTTCGCCGATCGACA,0,1345811
furpa,0.5,1,1,CCTACCAAGTGATGCAACAG,0,1336694
furpa,0.5,1,1,CCTACAATATCTGCTGCACA,0,1275467
furpa,0.5,1,1,CCTAAGGCAATGGGATGATT,0,1303204
furpa,0.5,1,1,CCTAAGCTGGGCAGCATTAT,0,1352653
furpa,0.5,1,1,CCTAAACTCCCTTGAAGTGG,0,1299266
furpa,0.5,1,1,CCTAAAACGACCAGTTCTCA,0,1276114
furpa,0.5,1,1,CCGTTGCCATCGTCCTAAGG,0,1305214
furpa,0.5,1,1,CCGTTCGTTTTCAAAAACCA,0,1292115
furpa,0.5,1,1,CCGTGCGTCTTTGTCTAACT,0,1357499
furpa,0.5,1,1,CCGTCCCGGCTACTTGGCTT,0,1352959
furpa,0.5,1,1,CCGTAGGTACCTGGGTTACG,0,1330449
furpa,0.5,1,1,CCGTACTGGAGATTCATAGG,0,1273743
furpa,0.5,1,1,CCGGTTTGCAAGTATTAACT,0,1305751
furpa,0.5,1,1,CCGGTTATGTTTTTTACTGT,0,1338567
furpa,0.5,1,1,CCGGTCTTTCCATGCCCATC,0,1286186
furpa,0.5,1,1,CCGGTATTCTGCTATTTGTC,0,1331281
furpa,0.5,1,1,CCGGTAGGCTTGAACGTGGT,0,1355657
furpa,0.5,1,1,CCGGCCCCGATGTACTCAGC,0,1342951
furpa,0.5,1,1,CCGCGGCCCAGGGTAGCTAC,0,1333202
furpa,0.5,1,1,CCGCGGCATGGGTTGGAGGG,0,1311653
furpa,0.5,1,1,CCGCCTAGGCAAGTTCAATC,0,1294424
furpa,0.5,1,1,CCGCCGAGTTGTTAAGATTA,0,1318139
furpa,0.5,1,1,CCGCCAAGTGACACGCGAGT,0,1332366
furpa,0.5,1,1,CCGCATAAACAACCTTTTTC,0,1356001
furpa,0.5,1,1,CCGCAGGCTGAGATTTTACT,0,1328962
furpa,0.5,1,1,CCGCAGCTGTCGCGGTCAGG,0,1342236
furpa,0.5,1,1,CCGCAGAGAGCGGTCTTTGT,0,1297012
furpa,0.5,1,1,CCGCACTCGGATTAAGAGGC,0,1334363
furpa,0.5,1,1,CCGCAATAATCAATCTACTT,0,1273433
furpa,0.5,1,1,CCGAGGACCATAACGAACAC,0,1285540
furpa,0.5,1,1,CCGAGATGTCTTTCTATCTA,0,1335705
furpa,0.5,1,1,CCGAATTAGTATCCAAATGG,0,1275000
furpa,0.5,1,1,CCCTTGACTATCTCAAACTT,0,1323024
furpa,0.5,1,1,CCCTGGTATTGGTTTGTCAT,0,1297860
furpa,0.5,1,1,CCCTGGAGGGACTGGTCGCT,0,1313884
furpa,0.5,1,1,CCCTGGAGACAGGCGCTAAC,0,1295491
furpa,0.5,1,1,CCCTCGGCGTTGCCCCGTGC,0,1318351
furpa,0.5,1,1,CCCTATGTAGTAGAAAAGGG,0,1312694
furpa,0.5,1,1,CCCGTGTGGGTTATTCGCAG,0,1320314
furpa,0.5,1,1,CCCGTGCGCTTGATGTTCAT,0,1352745
furpa,0.5,1,1,CCCGGTGAAGCTTTATGCCG,0,1345682
furpa,0.5,1,1,CCCGGGTGAGTTCCAATGTA,0,1300278
furpa,0.5,1,1,CCCGGCCGGACACTATTGAA,0,1349438
furpa,0.5,1,1,CCCGCTTCACCCCTTGGCTT,0,1344780
furpa,0.5,1,1,CCCGCTGAGTAAGGAAACCA,0,1280020
furpa,0.5,1,1,CCCGCCGTAACTTTTTGGGA,0,1333521
furpa,0.5,1,1,CCCGATTCTCGCTACTGGTC,0,1306557
furpa,0.5,1,1,CCCGATAGGGTCAGGGGGGT,0,1327306
furpa,0.5,1,1,CCCGAGACGAGCGCACGATT,0,1324630
furpa,0.5,1,1,CCCCTATGTGCGTATATCCT,0,1281285
furpa,0.5,1,1,CCCCTACGGGTCACAACGGT,0,1336660
furpa,0.5,1,1,CCCCGTAAAAAAATAGTAAG,0,1302044
furpa,0.5,1,1,CCCCGGCTCGGCATTCTGAA,0,1354104
furpa,0.5,1,1,CCCCGAGTGGACCCGATGTG,0,1273256
furpa,0.5,1,1,CCCCCTGTGACATTATGCTC,0,1318623
furpa,0.5,1,1,CCCCCTGGGAGCAAACGTGA,0,1274571
furpa,0.5,1,1,CCCCCGCTAAGCTCAATACA,0,1295549
furpa,0.5,1,1,CCCCCATACGGATTCAGGGT,0,1324983
furpa,0.5,1,1,CCCCATCACCGTGCAGCTTT,0,1304187
furpa,0.5,1,1,CCCCAGGGTGTCCTTACTTT,0,1295364
furpa,0.5,1,1,CCCATTATTCCCATCAATTC,0,1352441
furpa,0.5,1,1,CCCAGAGTGCTTGTAATTAT,0,1354849
furpa,0.5,1,1,CCCACCCTCTCCCACTGTTA,0,1330671
furpa,0.5,1,1,CCCACATAGTATGCGGTCTC,0,1321432
furpa,0.5,1,1,CCCAAGACCTATGCCGTACC,0,1332632
furpa,0.5,1,1,CCCAACTCTAAGAGGGGGTG,0,1306331
furpa,0.5,1,1,CCCAACCCTCCCTTGGTTCA,0,1343593
furpa,0.5,1,1,CCCAAAGCAGTGGTAATTTA,0,1334535
furpa,0.5,1,1,CCATTTGGAAATTTAGGTAC,0,1272682
furpa,0.5,1,1,CCATTGACAGCGTGGCGTTA,0,1289429
furpa,0.5,1,1,CCATTCCGTACTCTTTATTC,0,1279760
furpa,0.5,1,1,CCATGTGGCAGGCCCGACGA,0,1278193
furpa,0.5,1,1,CCATCGGCAGGGTCGGCATC,0,1340638
furpa,0.5,1,1,CCATCGCTCCGTACTTTTCA,0,1282600
furpa,0.5,1,1,CCATAGTATGGGCTATGGCC,0,1340720
furpa,0.5,1,1,CCATAGTAACACATTCAATT,0,1341550
furpa,0.5,1,1,CCAGTCTAGTCCGGAGCTGC,0,1273877
furpa,0.5,1,1,CCAGTCCAGGGCGAATCGCG,0,1355233
furpa,0.5,1,1,CCAGGTCCGTTGAGGAGGCT,0,1303831
furpa,0.5,1,1,CCAGGGTGAGTAGGTAGTTC,0,1304213
furpa,0.5,1,1,CCAGGGGTGTCTTCCCAGGG,0,1278188
furpa,0.5,1,1,CCAGGCCATGTTTAGAGTAT,0,1291576
furpa,0.5,1,1,CCAGGCAAGACATCTAAGCT,0,1273453
furpa,0.5,1,1,CCAGCTAGAGGAGGGCTCAA,0,1274901
furpa,0.5,1,1,CCAGCTACGTCGCCGCTGAC,0,1315437
furpa,0.5,1,1,CCAGCTAATATCCTTAGTTA,0,1341986
furpa,0.5,1,1,CCAGCACTACACTTTTGTCT,0,1320985
furpa,0.5,1,1,CCAGAGGTCTTCGGCATCTG,0,1345646
furpa,0.5,1,1,CCACTGGAATACGCGATATG,0,1305043
furpa,0.5,1,1,CCACGTCCAGCCTCGCTGAT,0,1331277
furpa,0.5,1,1,CCACCCGCCAGTAGCGTGAT,0,1319499
furpa,0.5,1,1,CCACCAGGCCTGCACTCGGT,0,1313434
furpa,0.5,1,1,CCACATCGGACTCGCCATAC,0,1283391
furpa,0.5,1,1,CCACACCGTCGATCCTTTAA,0,1329668
furpa,0.5,1,1,CCAATTTTGGCCCCAACCGT,0,1283675
furpa,0.5,1,1,CCAATGCTCCATCAAGAGCA,0,1337491
furpa,0.5,1,1,CCAATCGAAGGAATTCCGGA,0,1292233
furpa,0.5,1,1,CCAATAGCGCATTAAGGCCT,0,1277593
furpa,0.5,1,1,CCAATAGATATCCGGAAGTA,0,1329596
furpa,0.5,1,1,CCAAGTTATACTCCGCAATT,0,1286210
furpa,0.5,1,1,CCAAGCTTCATAGGAACCCC,0,1337820
furpa,0.5,1,1,CCAAGCCCAGTTTGCGCGTC,0,1315601
furpa,0.5,1,1,CCAACTCTGCGCGTTCCAGG,0,1315013
furpa,0.5,1,1,CCAACTCCCAATAGAGGTCT,0,1325947
furpa,0.5,1,1,CCAACTAGACCCAGCTATGT,0,1280416
furpa,0.5,1,1,CCAACTACGTGGTTCTCCAG,0,1310277
furpa,0.5,1,1,CCAACGAGCATTTCTCTTAA,0,1327342
furpa,0.5,1,1,CCAACAGGTACCGTGAAAAA,0,1281724
furpa,0.5,1,1,CCAAAGCTGCATTTCGAGCG,0,1322315
furpa,0.5,1,1,CATTTGGAGCTACGTGGACC,0,1336003
furpa,0.5,1,1,CATTTGCGGACGTGAACACT,0,1329628
furpa,0.5,1,1,CATTTCGAGGGCCGGAACCA,0,1311011
furpa,0.5,1,1,CATTTAGCGCGGATAGTAGT,0,1316963
furpa,0.5,1,1,CATTGTGATTTCACCGGCTT,0,1332637
furpa,0.5,1,1,CATTACCTGGGCTTCGCCGG,0,1322632
furpa,0.5,1,1,CATTAACCTGGCCGCGTAGC,0,1289465
furpa,0.5,1,1,CATGTCGGGGCCTCACTACA,0,1279368
furpa,0.5,1,1,CATGTACGCAACCCTTCTGT,0,1319723
furpa,0.5,1,1,CATGTAAGGGACATTGACGC,0,1356046
furpa,0.5,1,1,CATGCGAGGGGCCGTGTTGC,0,1341423
furpa,0.5,1,1,CATGAGGTATTCGATGCAGC,0,1311805
furpa,0.5,1,1,CATGACGCTACTTTGTGACT,0,1290895
furpa,0.5,1,1,CATGAAAAGTCCTCTAACAA,0,1343283
furpa,0.5,1,1,CATCTGGTTAATGGCCTCTT,0,1348375
furpa,0.5,1,1,CATCTGGATGTGAAGAGTCT,0,1278488
furpa,0.5,1,1,CATCGGCTCTCAATCCAGCA,0,1333000
furpa,0.5,1,1,CATCCTTCAGACCATCCCAA,0,1356839
furpa,0.5,1,1,CATCCAGGCCATTGCAACTG,0,1272980
furpa,0.5,1,1,CATCATCCTAACAGAACATC,0,1331238
furpa,0.5,1,1,CATCACAGAGCCTCGGAGGC,0,1353054
furpa,0.5,1,1,CATCAACTTCGGATGCACCC,0,1337917
furpa,0.5,1,1,CATATTAGTCATGGGTGATT,0,1350188
furpa,0.5,1,1,CATATATCGCTGCACCGTTA,0,1322874
furpa,0.5,1,1,CATATAGTGAGTTTGGATAT,0,1276833
furpa,0.5,1,1,CATATACGACTATTTCGCAA,0,1289718
furpa,0.5,1,1,CATACTCGGGTCCCTCAAAA,0,1286924
furpa,0.5,1,1,CATACGACTACGTCGGGACT,0,1321066
furpa,0.5,1,1,CATACATTCCGTATAGTGAG,0,1354064
furpa,0.5,1,1,CATAATTTAGTTCTACGACT,0,1341596
furpa,0.5,1,1,CATAACCATAGTTCGAGATC,0,1276203
furpa,0.5,1,1,CATAAAGCTATAGAGAAGGG,0,1336815
furpa,0.5,1,1,CAGTTTGGACACGGGTGTGT,0,1280203
furpa,0.5,1,1,CAGTTACCGTAATACAAGCA,0,1333527
furpa,0.5,1,1,CAGTGGGTAGAAACTACGCC,0,1289709
furpa,0.5,1,1,CAGTCGAGATGATAGGCACC,0,1331042
furpa,0.5,1,1,CAGTAGGAGAGTCTCCACAC,0,1301707
furpa,0.5,1,1,CAGTAGCCGCAACGGTCTAC,0,1350617
furpa,0.5,1,1,CAGGTCCGCACATACCTGAC,0,1355066
furpa,0.5,1,1,CAGGTATCATTTATTTAAGA,0,1332282
furpa,0.5,1,1,CAGGTAGCAACTCGGGCCGG,0,1293314
furpa,0.5,1,1,CAGGGGCGGTGACGTAGTTT,0,1300813
furpa,0.5,1,1,CAGGGAGGCCAGAGTAAGTA,0,1304609
furpa,0.5,1,1,CAGGCGAGCACTGCATGGGT,0,1316196
furpa,0.5,1,1,CAGGCCGGGGTCGAATCATC,0,1292536
furpa,0.5,1,1,CAGGCATTCTGCTTATTCAA,0,1314593
furpa,0.5,1,1,CAGGCACCTATACGGCCCGA,0,1314449
furpa,0.5,1,1,CAGGAGTGCGGCCATCTGTT,0,1325578
furpa,0.5,1,1,CAGGAGATGTTTTGGCGAAA,0,1354598
furpa,0.5,1,1,CAGCTGTTCTTAACGAACGT,0,1320410
furpa,0.5,1,1,CAGCTGGGAGATAGACCGGA,0,1312987
furpa,0.5,1,1,CAGCTGGCTTTCACTGGTAT,0,1307382
furpa,0.5,1,1,CAGCTAGGAATGGCTTAGCT,0,1333946
furpa,0.5,1,1,CAGCGTGCGTTGAGCGGGAT,0,1323485
furpa,0.5,1,1,CAGCGGCTCATGTTCTCAGA,0,1305363
furpa,0.5,1,1,CAGCGGAGCCCTTTAACATC,0,1316967
furpa,0.5,1,1,CAGCGGAACCTCGGACAAGG,0,1318391
furpa,0.5,1,1,CAGCCTCTCAATGTATCCAT,0,1315930
furpa,0.5,1,1,CAGCCTCCCAAAAACAGGGG,0,1273082
furpa,0.5,1,1,CAGCATTTAGGGACATTCCA,0,1314268
furpa,0.5,1,1,CAGCATATGGGATAGCCTGT,0,1273202
furpa,0.5,1,1,CAGCAGTGAAGCATTGGCCA,0,1301459
furpa,0.5,1,1,CAGATCGGACGGCTGCATAC,0,1353260
furpa,0.5,1,1,CAGATAAGCCCAGGCTCTCT,0,1308532
furpa,0.5,1,1,CAGAGTTTCGTTGCAGGAGG,0,1328873
furpa,0.5,1,1,CAGAGAGATTCACGGGCCGA,0,1276818
furpa,0.5,1,1,CAGACGCCTGTACTGTACAG,0,1304071
furpa,0.5,1,1,CAGAAGGAGGTATGTCCATT,0,1350322
furpa,0.5,1,1,CAGAAACATAAGGATTACTA,0,1329804
furpa,0.5,1,1,CACTTCCAACGAATTTTGCG,0,1320175
furpa,0.5,1,1,CACTGTCTGCCCTTACGGCT,0,1297456
furpa,0.5,1,1,CACTGCTGTGCACAAAAGTG,0,1281651
furpa,0.5,1,1,CACTGCACGATTAAGGGTCC,0,1295822
furpa,0.5,1,1,CACTGAAATGAGCCTTTGTT,0,1353137
furpa,0.5,1,1,CACTCGTCAGCTTTAGACAC,0,1344104
furpa,0.5,1,1,CACTCCTGGGCAGGGGTCAT,0,1316590
furpa,0.5,1,1,CACTCCCGCATTATGCTACA,0,1278558
furpa,0.5,1,1,CACTATTATATAAGGCCCGA,0,1327394
furpa,0.5,1,1,CACTACAAGGCTACTGGCGG,0,1272895
furpa,0.5,1,1,CACGTGTGGGCACACTCCAA,0,1276121
furpa,0.5,1,1,CACGCTTAAACGACGACCAA,0,1351350
furpa,0.5,1,1,CACGCGGACGCTGGACATGT,0,1344309
furpa,0.5,1,1,CACGACAGACAGGGAGCTGA,0,1283621
furpa,0.5,1,1,CACGAACTATGCCCATTGCA,0,1345717
furpa,0.5,1,1,CACGAAAGGAAAGGCGCAGA,0,1294269
furpa,0.5,1,1,CACCTGGGGCTGTGCATCAC,0,1313312
furpa,0.5,1,1,CACCTGCGGTTCCGACGCAG,0,1276278
furpa,0.5,1,1,CACCGTCGGGGCTATTGGTG,0,1322213
furpa,0.5,1,1,CACCGGCGCAACCCTACTCA,0,1315589
furpa,0.5,1,1,CACCGCGATGCTCGTATGCT,0,1306239
furpa,0.5,1,1,CACCACTGTTATATTGATGT,0,1303801
furpa,0.5,1,1,CACATCTATGACGACGGTAA,0,1339238
furpa,0.5,1,1,CACAGGGCGACTGACATGCC,0,1284565
furpa,0.5,1,1,CACACGATGTGGTATGCAGG,0,1272680
furpa,0.5,1,1,CACACGAAGCATGGGTGCCG,0,1353531
furpa,0.5,1,1,CACACCTCTATATAGAGATA,0,1332164
furpa,0.5,1,1,CACACAAGTAGGACGTGATC,0,1298773
furpa,0.5,1,1,CACAATAGCCGGATAAAGAC,0,1306868
furpa,0.5,1,1,CACAAGGCGCTTTAAGAGCT,0,1320534
furpa,0.5,1,1,CACAACTCTGCGCTGGCAGC,0,1315598
furpa,0.5,1,1,CACAACACTGACGTGTTGCT,0,1356211
furpa,0.5,1,1,CACAAAATCAGCCCAAATTC,0,1330364
furpa,0.5,1,1,CAATTTCTATCGTGACCTGC,0,1324001
furpa,0.5,1,1,CAATTGTTGTCACCTGAGAC,0,1349517
furpa,0.5,1,1,CAATTCTACGAGCCTCGCAA,0,1335609
furpa,0.5,1,1,CAATTAAGTAAACTATGGGT,0,1310920
furpa,0.5,1,1,CAATGTCGGCTCGAGGACGC,0,1279451
furpa,0.5,1,1,CAATGCTAGTGCATTTGGTG,0,1317940
furpa,0.5,1,1,CAATGCGACGCTAAATTTAC,0,1323809
furpa,0.5,1,1,CAATGAGGACGCGGCGACAT,0,1279967
furpa,0.5,1,1,CAATGAGCACATTCAAATGT,0,1342055
furpa,0.5,1,1,CAATGAAAGGGCAACTGCAG,0,1301804
furpa,0.5,1,1,CAATCGAAGATTCATTCCTG,0,1327732
furpa,0.5,1,1,CAATCATCAGCGGTGCGCTA,0,1285016
furpa,0.5,1,1,CAATAATGGCTAGGCCAAGC,0,1353393
furpa,0.5,1,1,CAAGTGTCCCGCACGCAACA,0,1284360
furpa,0.5,1,1,CAAGTGGTTATTGCTCGCTG,0,1350515
furpa,0.5,1,1,CAAGTGGGGGACATAGCAAC,0,1277208
furpa,0.5,1,1,CAAGTACTGTGCCCGATAAG,0,1294990
furpa,0.5,1,1,CAAGGTTCAATCAGGATAGG,0,1308890
furpa,0.5,1,1,CAAGGGGAAGAGTCTTTGTG,0,1345622
furpa,0.5,1,1,CAAGGCCGTATTTAGAATAC,0,1341099
furpa,0.5,1,1,CAAGCTACGGTTTCCTGGCT,0,1304215
furpa,0.5,1,1,CAAGCGGGAGGAGCGTCACC,0,1303372
furpa,0.5,1,1,CAAGCGAGCCACATGTTGGA,0,1333455
furpa,0.5,1,1,CAAGCAGCAACGTTCCGCTA,0,1278145
furpa,0.5,1,1,CAAGACTACGGGTCATATTA,0,1277546
furpa,0.5,1,1,CAAGAATTTCCGAGCCAACT,0,1347199
furpa,0.5,1,1,CAAGAAAGGCTCCAGCAACA,0,1339478
furpa,0.5,1,1,CAACTTACTCTTTGTAGACT,0,1305154
furpa,0.5,1,1,CAACTCGTGCCATCCGCTCA,0,1313066
furpa,0.5,1,1,CAACTCCGGCAAACGGTCAA,0,1276530
furpa,0.5,1,1,CAACGTCTCTGCGAATCTAT,0,1310356
furpa,0.5,1,1,CAACGTCCTAGGGCTTACGC,0,1324928
furpa,0.5,1,1,CAACGGGTCCCCCACCGAAC,0,1345381
furpa,0.5,1,1,CAACGCTCTTGATGTAAATA,0,1330440
furpa,0.5,1,1,CAACGACTGAAGCGCGCTGC,0,1326289
furpa,0.5,1,1,CAACCTCAATTATCATAGGG,0,1347993
furpa,0.5,1,1,CAACCCTTGTTCGGGCGGTC,0,1279997
furpa,0.5,1,1,CAACCCGGTGTTAGCGTTGC,0,1341638
furpa,0.5,1,1,CAACAAATGGAGTCCATGAC,0,1286234
furpa,0.5,1,1,CAAATTCCTGCGAAACATTT,0,1295550
furpa,0.5,1,1,CAAATCGTGAGCGCCGGAAA,0,1293930
furpa,0.5,1,1,CAAATCAGTCCCTCATGGAA,0,1293087
furpa,0.5,1,1,CAAAGTGGCCGTTGAAACCC,0,1294905
furpa,0.5,1,1,CAAAGATCGGATGAAATCAC,0,1285159
furpa,0.5,1,1,CAAAGAGCGCCTTATAGTAT,0,1342050
furpa,0.5,1,1,CAAACCATGCCCCGGTGGGC,0,1340992
furpa,0.5,1,1,CAAAATTACAACTGGTGGGA,0,1350959
furpa,0.5,1,1,CAAAAGCTCCCACCCTGTTC,0,1318594
furpa,0.5,1,1,CAAAACTTGGCACTTTGGTT,0,1334552
furpa,0.5,1,1,CAAAACAACTGAGGTCCGTG,0,1333703
furpa,0.5,1,1,ATTTTTTTTATGCCTACACC,0,1339236
furpa,0.5,1,1,ATTTGGGTCTATGCCCATCA,0,1326118
furpa,0.5,1,1,ATTTGGCTACATTGTTTGGG,0,1278440
furpa,0.5,1,1,ATTTGCGACTGTAGCTTCGC,0,1293293
furpa,0.5,1,1,ATTTGACTCACAAGCATCAC,0,1324777
furpa,0.5,1,1,ATTTCAGACTTTTATATAGC,0,1280831
furpa,0.5,1,1,ATTTAGTCACCGACGAACTG,0,1329718
furpa,0.5,1,1,ATTTAGGATCCGCTTTGATC,0,1340227
furpa,0.5,1,1,ATTTAATCAGATCGGGTAAA,0,1332036
furpa,0.5,1,1,ATTTAAAGACTAAGCCTTGC,0,1320412
furpa,0.5,1,1,ATTGTTTTGGTACCATTCGC,0,1344447
furpa,0.5,1,1,ATTGTTTAGGAGTGATAAGG,0,1348723
furpa,0.5,1,1,ATTGTTAGAAATGGCGTACG,0,1307662
furpa,0.5,1,1,ATTGTGCTCTTTGCCGAGAA,0,1344164
furpa,0.5,1,1,ATTGGGTAATCAGAAGCCTT,0,1312368
furpa,0.5,1,1,ATTGCGAATGGGTTGAACGG,0,1322221
furpa,0.5,1,1,ATTGCCGACCCCCAGTAGCG,0,1335156
furpa,0.5,1,1,ATTGCAGTCGGCTGATATTA,0,1292631
furpa,0.5,1,1,ATTGATATCTACATTTCTTA,0,1305174
furpa,0.5,1,1,ATTGAGCTGCTGAGAAAGAA,0,1354138
furpa,0.5,1,1,ATTGAATGGTTGTTCGCTGT,0,1323982
furpa,0.5,1,1,ATTCTTGGATTGATAACAAT,0,1304638
furpa,0.5,1,1,ATTCTGAAGAACGGGATTAA,0,1324935
furpa,0.5,1,1,ATTCTCCTCTGTCAGGCGTA,0,1323970
furpa,0.5,1,1,ATTCTATCATGTGCCTTAGG,0,1317883
furpa,0.5,1,1,ATTCTAGTTTTGTTTAATTC,0,1285400
furpa,0.5,1,1,ATTCTACTTCAGGAACCCTT,0,1313804
furpa,0.5,1,1,ATTCGTTTTCCACCCCCCCG,0,1274861
furpa,0.5,1,1,ATTCGATGTATATGCTAGTT,0,1332328
furpa,0.5,1,1,ATTCGAGCTCATACACATCT,0,1286046
furpa,0.5,1,1,ATTCCTAATGGGGATCCCGC,0,1288478
furpa,0.5,1,1,ATTCCCGGTGCGTATCGGTC,0,1318691
furpa,0.5,1,1,ATTCCCATCAGCACATGCTG,0,1305316
furpa,0.5,1,1,ATTCAGGAGCTTAGAATTGA,0,1322573
furpa,0.5,1,1,ATTCACACTAACGAGGGGGT,0,1301533
furpa,0.5,1,1,ATTATGTCAACGATTATATT,0,1311763
furpa,0.5,1,1,ATTATCCACACACCTGCTGT,0,1352580
furpa,0.5,1,1,ATTATCAGCGTTGTCGTTAC,0,1326512
furpa,0.5,1,1,ATTATCAAATGTTGGAGCCA,0,1316244
furpa,0.5,1,1,ATTAGGCATACGCTGGGACG,0,1326823
furpa,0.5,1,1,ATTACGCATTGGTGTGTTCT,0,1310833
furpa,0.5,1,1,ATTACAGGGATAGTAAGGGT,0,1303663
furpa,0.5,1,1,ATTACACCGGTTGATGGAGA,0,1294628
furpa,0.5,1,1,ATTACAAGCCGAATGTTTTT,0,1355625
furpa,0.5,1,1,ATGTTCGCTACTCCCAGGCT,0,1333737
furpa,0.5,1,1,ATGTTCAGAGACAACACGTT,0,1328445
furpa,0.5,1,1,ATGTTCAACCGTTATCCCGT,0,1276247
furpa,0.5,1,1,ATGTTATATCTCTCGGGAAT,0,1304168
furpa,0.5,1,1,ATGTGTTTGACAACGGCTTG,0,1274209
furpa,0.5,1,1,ATGTGAGGGCGCCGGTCGAA,0,1349109
furpa,0.5,1,1,ATGTGAGCCCCGTCAGTAGG,0,1339606
furpa,0.5,1,1,ATGTGACTTACTTATGGGCG,0,1349951
furpa,0.5,1,1,ATGTCTCATTCCACCCGGAT,0,1291425
furpa,0.5,1,1,ATGTCCCAGTCATCGTTTTA,0,1291286
furpa,0.5,1,1,ATGTCCATGCAACCTCAGGC,0,1311942
furpa,0.5,1,1,ATGTCACATACCAGGTTGTG,0,1334019
furpa,0.5,1,1,ATGTATGTAATCTTTCTCCA,0,1323131
furpa,0.5,1,1,ATGTAATGGGATCACCAATG,0,1325760
furpa,0.5,1,1,ATGGTTCTCCCGAACTATCA,0,1342695
furpa,0.5,1,1,ATGGTGGGACCTTGCTCCCT,0,1315117
furpa,0.5,1,1,ATGGTCAGTACAGATTCCAC,0,1338642
furpa,0.5,1,1,ATGGTAGCGCTATGCAAGCA,0,1275663
furpa,0.5,1,1,ATGGGGGTGTAACTATGTTA,0,1335109
furpa,0.5,1,1,ATGGGGGACTGCGATCCGAT,0,1333647
furpa,0.5,1,1,ATGGGCGCTAACGAATTGTA,0,1278981
furpa,0.5,1,1,ATGGGAGTCGGGGGGCAGAC,0,1326772
furpa,0.5,1,1,ATGGGAACGAACATTGAGGG,0,1298779
furpa,0.5,1,1,ATGGCTTACCGAACGAATGT,0,1330795
furpa,0.5,1,1,ATGGCTTAAAGCGTACACTC,0,1288368
furpa,0.5,1,1,ATGGCCGCTAAAGCCCAGCA,0,1289268
furpa,0.5,1,1,ATGGCACGGTGGTTGGATCT,0,1298020
furpa,0.5,1,1,ATGGATTCCGCGTTATGCTC,0,1322920
furpa,0.5,1,1,ATGGACGTCACTAGAGTCTA,0,1343199
furpa,0.5,1,1,ATGCTTCTAACGGCTCTTTA,0,1292783
furpa,0.5,1,1,ATGCTTCATCCAATACGGTG,0,1339943
furpa,0.5,1,1,ATGCTATGAACTGAGCGATT,0,1289000
furpa,0.5,1,1,ATGCGTAATGCGCGGCGACG,0,1307751
furpa,0.5,1,1,ATGCGGTCCCGGGCAATAAC,0,1344869
furpa,0.5,1,1,ATGCGGCATTTAACTTGAGA,0,1280228
furpa,0.5,1,1,ATGCGCTTCGTGCTACTCGA,0,1290716
furpa,0.5,1,1,ATGCGCTCCGTTGCAATGGC,0,1326316
furpa,0.5,1,1,ATGCCGATGAATTGAGCGTA,0,1277048
furpa,0.5,1,1,ATGCCGACATAATAGGAATT,0,1356223
furpa,0.5,1,1,ATGCCAATGCAAACGAATTC,0,1293298
furpa,0.5,1,1,ATGCAGAGCAAGAGATGATG,0,1320698
furpa,0.5,1,1,ATGCAGAGATGCAAGTTAAA,0,1324735
furpa,0.5,1,1,ATGCACTAGGATGAGTGTGT,0,1334940
furpa,0.5,1,1,ATGCACCCAGGCTTACCATA,0,1314800
furpa,0.5,1,1,ATGATGTACTCAGGCATAAA,0,1317282
furpa,0.5,1,1,ATGATGCTGGGGCCGTCGCC,0,1307441
furpa,0.5,1,1,ATGATCTGTCGCGTTTTGCT,0,1296069
furpa,0.5,1,1,ATGATAATCATCGGGGGTAC,0,1338762
furpa,0.5,1,1,ATGAGGTTCTTCCACACGGT,0,1277274
furpa,0.5,1,1,ATGAGCGTCACCCGTTCCCG,0,1275712
furpa,0.5,1,1,ATGAGACTTACGTACTTTAG,0,1338387
furpa,0.5,1,1,ATGACTGAGGTACGGACCGT,0,1304204
furpa,0.5,1,1,ATGACTAACGGCTCTCATCG,0,1289821
furpa,0.5,1,1,ATGACGGAATCCTGGTAAGC,0,1329898
furpa,0.5,1,1,ATGACCGGGGTGGAGTTACA,0,1318161
furpa,0.5,1,1,ATGACCCGAAGTTGTCTTCC,0,1298826
furpa,0.5,1,1,ATGAAGCGACGGCTTCATTA,0,1353656
furpa,0.5,1,1,ATGAACCTGAGGGGCAGGCG,0,1351254
furpa,0.5,1,1,ATGAAAGTCTTAACTAGCGG,0,1332419
furpa,0.5,1,1,ATCTTTCTCAACGGAATGAA,0,1310304
furpa,0.5,1,1,ATCTTCGCCTAATGCAGTGG,0,1301582
furpa,0.5,1,1,ATCTTATTTGCCGTGACTAC,0,1307231
furpa,0.5,1,1,ATCTGTGACTTCGATGCCCA,0,1322035
furpa,0.5,1,1,ATCTGGGTGCCTATTCGAGC,0,1292449
furpa,0.5,1,1,ATCTCTCCTTTACCAGTAGA,0,1315674
furpa,0.5,1,1,ATCTCTACCGATCGCTCCTA,0,1313200
furpa,0.5,1,1,ATCTCGTCGATGATGCTTCT,0,1295241
furpa,0.5,1,1,ATCTACTGAGTGAGCCTCCT,0,1274458
furpa,0.5,1,1,ATCTACAGCCCCCACTCGGA,0,1313825
furpa,0.5,1,1,ATCTAAGCTGCTTGGAAGCA,0,1299642
furpa,0.5,1,1,ATCGTTAGAATACGTTTGTA,0,1292479
furpa,0.5,1,1,ATCGTGTGTATGGCCCTATT,0,1297867
furpa,0.5,1,1,ATCGTAGCATTCAAGCCTTC,0,1331616
furpa,0.5,1,1,ATCGTACAGTGCATCTACGA,0,1293866
furpa,0.5,1,1,ATCGGGTGCGCAACAGGCGA,0,1308693
furpa,0.5,1,1,ATCGGAGCGGCACCACCGAA,0,1345614
furpa,0.5,1,1,ATCGATGGTCAATTTCCTTT,0,1271409
furpa,0.5,1,1,ATCGATCAACGAGGTGCGCG,0,1339708
furpa,0.5,1,1,ATCGACGTCTAATGAGGGTT,0,1356162
furpa,0.5,1,1,ATCCTCCTCTATTGCTCACT,0,1289605
furpa,0.5,1,1,ATCCTCCTCGGCATTTCTTT,0,1319383
furpa,0.5,1,1,ATCCTAAGGTCTCCAAGTCA,0,1292589
furpa,0.5,1,1,ATCCTAACCGGTTCACATAG,0,1353697
furpa,0.5,1,1,ATCCGGTCCATTCCGCATGT,0,1342659
furpa,0.5,1,1,ATCCGGCCCGGTCCGCTTGT,0,1325192
furpa,0.5,1,1,ATCCGCTGCGCACAACTCTA,0,1319979
furpa,0.5,1,1,ATCCGATACGCAACGTTGGA,0,1337027
furpa,0.5,1,1,ATCCCTGCAGCTACGCTGGC,0,1345492
furpa,0.5,1,1,ATCCCACTCGTTCGGTGCCC,0,1311856
furpa,0.5,1,1,ATCCAGTTGCGCACCAAGCT,0,1326337
furpa,0.5,1,1,ATCCAAATTCTGTATCCATG,0,1325399
furpa,0.5,1,1,ATCCAAAGTTTGATCCGTCT,0,1302475
furpa,0.5,1,1,ATCATTCAGACGCCACTTGA,0,1332379
furpa,0.5,1,1,ATCATCTGATGTTCTGAAAG,0,1327337
furpa,0.5,1,1,ATCATCAACTCGAGTGGCCT,0,1293443
furpa,0.5,1,1,ATCATACTTTCCGTGCTGCT,0,1318339
furpa,0.5,1,1,ATCAGTGCTCAAGTATACTC,0,1311367
furpa,0.5,1,1,ATCACCTCATCGCTCCTTTT,0,1325621
furpa,0.5,1,1,ATCACCAGCCGGTGATCATT,0,1355097
furpa,0.5,1,1,ATCAATGTAAGTTAAGGTTC,0,1333299
furpa,0.5,1,1,ATCAATCGATTGGTCATTTG,0,1343113
furpa,0.5,1,1,ATCAAGAACACGGGAATTAA,0,1292061
furpa,0.5,1,1,ATCAACCGGCGTCAAGTCTT,0,1282377
furpa,0.5,1,1,ATCAACCCTTTATTCTATGA,0,1274973
furpa,0.5,1,1,ATCAAACTTCGTACGTATAT,0,1315334
furpa,0.5,1,1,ATCAAAATAATACAGCCTCG,0,1305160
furpa,0.5,1,1,ATATTTTCGACAGGTACATT,0,1313940
furpa,0.5,1,1,ATATTTCCGATGAGTTGGTC,0,1285584
furpa,0.5,1,1,ATATTGTTGACCCCATGGCC,0,1276616
furpa,0.5,1,1,ATATTCTTTATTATCTGCTG,0,1276940
furpa,0.5,1,1,ATATGTAGAAACGCCGGGGA,0,1302347
furpa,0.5,1,1,ATATGCTGTAATCAACAAGC,0,1288989
furpa,0.5,1,1,ATATGATGACATGACCGCTA,0,1314333
furpa,0.5,1,1,ATATGAGCGTAGTCCACAGT,0,1289259
furpa,0.5,1,1,ATATCTATCGGTTGGGATTA,0,1312410
furpa,0.5,1,1,ATATCCGTCCCCCCGAGTCC,0,1299918
furpa,0.5,1,1,ATATCCAACGATCTAGTCTA,0,1303461
furpa,0.5,1,1,ATATCACTCGGGGGTCGTAA,0,1326708
furpa,0.5,1,1,ATATAGGGATTCCGTACTTA,0,1302135
furpa,0.5,1,1,ATATACAATAAAGTCGCAAA,0,1349731
furpa,0.5,1,1,ATAGCGGCCCGTATGTAAAT,0,1347085
furpa,0.5,1,1,ATAGCAGTGGTTAATGACAC,0,1282649
furpa,0.5,1,1,ATAGCAAGACAAGACGACCT,0,1281521
furpa,0.5,1,1,ATAGAATTCGATAAATAAGA,0,1277908
furpa,0.5,1,1,ATACTCGTGAGCGCTAATGC,0,1343138
furpa,0.5,1,1,ATACGTAAATATACCTTTGG,0,1335300
furpa,0.5,1,1,ATACGGAGATGCTTTTAACC,0,1278031
furpa,0.5,1,1,ATACCACATGACAGCCCAAT,0,1345135
furpa,0.5,1,1,ATACATCGCTCCAGTTGGAT,0,1296806
furpa,0.5,1,1,ATACAGTAGGACGAATTGGG,0,1299796
furpa,0.5,1,1,ATACACATTAGAACTCCTGG,0,1339525
furpa,0.5,1,1,ATAATGTGGGGATCAACAAT,0,1278902
furpa,0.5,1,1,ATAATGAGGGTGGTCAAGCA,0,1354580
furpa,0.5,1,1,ATAATAAATAATTGCTTCTT,0,1340150
furpa,0.5,1,1,ATAAGTTAGCAAACTACGCT,0,1322514
furpa,0.5,1,1,ATAAGTGCCGATTAGACCGT,0,1302736
furpa,0.5,1,1,ATAAGTACTCATTTGTCTAT,0,1326125
furpa,0.5,1,1,ATAAGCGTAGCCATCTTAGG,0,1310464
furpa,0.5,1,1,ATAACTTTTGAGTATTGAGT,0,1313150
furpa,0.5,1,1,ATAACTCAGCCGGCGCTAAT,0,1322022
furpa,0.5,1,1,ATAACCCCCTAACTATTCCT,0,1308701
furpa,0.5,1,1,ATAAATCTAAAACGGGAAGT,0,1281345
furpa,0.5,1,1,ATAAATAGTGTTATGAACAA,0,1317483
furpa,0.5,1,1,ATAAAGCAGTGATCCTTGAT,0,1327512
furpa,0.5,1,1,ATAAACTCCGGCGAGTTCAT,0,1317765
furpa,0.5,1,1,ATAAACCTGCCTTGGGATCG,0,1329286
furpa,0.5,1,1,ATAAAAGTTCTACCTTACAT,0,1344123
furpa,0.5,1,1,ATAAAAGTAGGTGTCCCGAG,0,1355496
furpa,0.5,1,1,AGTTGTGAGCAACTTGAATA,0,1273945
furpa,0.5,1,1,AGTTGGTTTGATTGATCGAA,0,1283478
furpa,0.5,1,1,AGTTGCGACGCGCTTTGATA,0,1274611
furpa,0.5,1,1,AGTTCTGGATGCTGCTAATA,0,1301936
furpa,0.5,1,1,AGTTCCGGTGGTCGAAAGGT,0,1281412
furpa,0.5,1,1,AGTTATTAAGATGGTTGAGA,0,1288833
furpa,0.5,1,1,AGTTAGGTTTACGGTTTTAG,0,1346211
furpa,0.5,1,1,AGTTACCATAGTCTCAGTTA,0,1273310
furpa,0.5,1,1,AGTTACCAGTGTCCGAGGTC,0,1296639
furpa,0.5,1,1,AGTGTGTGAATGGCCCAAAA,0,1329534
furpa,0.5,1,1,AGTGTAGCAATATATTCCAG,0,1311455
furpa,0.5,1,1,AGTGGTTAAGGTGAATTTTG,0,1301164
furpa,0.5,1,1,AGTGGGCTTCACGCGAGATT,0,1274959
furpa,0.5,1,1,AGTGGCGTACAGTAGAGGTC,0,1329423
furpa,0.5,1,1,AGTGGCAGGAAATCTTGGAG,0,1286150
furpa,0.5,1,1,AGTGCGGCCTGGTACAACAA,0,1354483
furpa,0.5,1,1,AGTGCCCACTTCGTGCTTAG,0,1349917
furpa,0.5,1,1,AGTGCATTCGCAAGTCATCG,0,1313725
furpa,0.5,1,1,AGTGACGCTCCTGATCCGGA,0,1289914
furpa,0.5,1,1,AGTGACCTAACCACCTCCCC,0,1318395
furpa,0.5,1,1,AGTGAAAGATGGATCTTAAC,0,1281590
furpa,0.5,1,1,AGTCGTCTGAGACGACGTTA,0,1331565
furpa,0.5,1,1,AGTCGGTCACAGCACCGTGA,0,1319124
furpa,0.5,1,1,AGTCGCGAGGCTTGGATACA,0,1334536
furpa,0.5,1,1,AGTCGAAGTTGAGTCCTTGG,0,1356925
furpa,0.5,1,1,AGTCCGTGCCGCAGGCGGTC,0,1347572
furpa,0.5,1,1,AGTCCGTATTGATACATCAC,0,1294458
furpa,0.5,1,1,AGTCCGTATTCATAATAACA,0,1332699
furpa,0.5,1,1,AGTCCGACATGGGCTGCTGA,0,1335747
furpa,0.5,1,1,AGTCCCACCCTATTAAATGA,0,1348630
furpa,0.5,1,1,AGTCATGACTCAACAGTGGT,0,1282878
furpa,0.5,1,1,AGTCAGCTGAATGCACTGGC,0,1287831
furpa,0.5,1,1,AGTCAATACATCTCATGAGT,0,1280853
furpa,0.5,1,1,AGTATCCGGGGATAGGAGAC,0,1303379
furpa,0.5,1,1,AGTAGCGCGCGATGGGCTGC,0,1330121
furpa,0.5,1,1,AGTAGATTAAATGTGCCCAC,0,1353594
furpa,0.5,1,1,AGTACTCTTAAGTCTACAGG,0,1332182
furpa,0.5,1,1,AGTACTCCAAGACCTTTCAC,0,1321281
furpa,0.5,1,1,AGTACGCTCGGTGTTTCTTT,0,1276163
furpa,0.5,1,1,AGTACCTGATCATGTACTGA,0,1319639
furpa,0.5,1,1,AGTACCAGCACCAGCTCCGT,0,1332857
furpa,0.5,1,1,AGTAAGGGGCGGGAAAACTG,0,1291189
furpa,0.5,1,1,AGTAAGATTATTCATTCTAC,0,1315433
furpa,0.5,1,1,AGTAACCTCCCTGTCACTGG,0,1294501
furpa,0.5,1,1,AGTAAATGTCGGGATAACAA,0,1286269
furpa,0.5,1,1,AGGTTTGCAGCGTTGCGCAG,0,1326555
furpa,0.5,1,1,AGGTTGGAAGCGGCGCAGAG,0,1288784
furpa,0.5,1,1,AGGTTAAGTCCAGCGCCTCA,0,1328249
furpa,0.5,1,1,AGGTGTACTTGGGTCCACGT,0,1334647
furpa,0.5,1,1,AGGTGGATCGGCAGGAGAAC,0,1295064
furpa,0.5,1,1,AGGTGAGTGTTGGTGAATTT,0,1348460
furpa,0.5,1,1,AGGTGACGTCCAATGACATG,0,1316895
furpa,0.5,1,1,AGGTCTATTACTTTCGTCGC,0,1285816
furpa,0.5,1,1,AGGTCGTGGTAGCTTTACCA,0,1305264
furpa,0.5,1,1,AGGTACGTTGTGTTTAACTC,0,1331328
furpa,0.5,1,1,AGGTAAGGTCGTTAGCGCAG,0,1282011
furpa,0.5,1,1,AGGGTTACTTTCACAGCATC,0,1293665
furpa,0.5,1,1,AGGGTACCTTGCTAATTTAT,0,1309855
furpa,0.5,1,1,AGGGGGACTCTGCTTCAGTT,0,1292872
furpa,0.5,1,1,AGGGCTAGTCACAAAAATCG,0,1335821
furpa,0.5,1,1,AGGGCCTCGCAATTTACTCG,0,1317365
furpa,0.5,1,1,AGGGATGCGCTCCCGGAATC,0,1271994
furpa,0.5,1,1,AGGGAGGTCACGCTAGGCCG,0,1307010
furpa,0.5,1,1,AGGGACTGGCTATCTGGCTC,0,1286148
furpa,0.5,1,1,AGGGACGCGTGGAGTAGGGA,0,1314684
furpa,0.5,1,1,AGGCTTGGGGTAATGGCCTT,0,1325324
furpa,0.5,1,1,AGGCTTGGCATCAGTTGGGG,0,1329670
furpa,0.5,1,1,AGGCTACTTCATCAGTGAAA,0,1304386
furpa,0.5,1,1,AGGCGTTGCACTAATGACTA,0,1298345
furpa,0.5,1,1,AGGCGCACATCACTAAGTAC,0,1328806
furpa,0.5,1,1,AGGCCTTATCCCTACTCGAG,0,1311075
furpa,0.5,1,1,AGGCCTGGCTAAAAATGCAT,0,1329462
furpa,0.5,1,1,AGGCCGATAAGGGTTTTCCC,0,1294220
furpa,0.5,1,1,AGGCCAATGGGGCCTTAGTT,0,1274058
furpa,0.5,1,1,AGGCACGCGCAGCATATTTG,0,1317327
furpa,0.5,1,1,AGGATTTCGCGGGGGCCGAG,0,1279358
furpa,0.5,1,1,AGGATTTAGATGGCCATGTC,0,1280012
furpa,0.5,1,1,AGGATTGTGGACTCAGGGTC,0,1294709
furpa,0.5,1,1,AGGATTCTTCCTGAATTCGT,0,1322891
furpa,0.5,1,1,AGGATCCGGGTACACAGTTT,0,1324839
furpa,0.5,1,1,AGGATAGTGGGAAGGCCGCT,0,1297432
furpa,0.5,1,1,AGGAGTGATCGGTGACATTT,0,1351022
furpa,0.5,1,1,AGGAGTCAAGGCCGGGCGGA,0,1294484
furpa,0.5,1,1,AGGAGTAGGGTGAACGTATA,0,1300057
furpa,0.5,1,1,AGGAGGTCTATCATTCCTAG,0,1319771
furpa,0.5,1,1,AGGAGAAGTGGAACGACATT,0,1349810
furpa,0.5,1,1,AGGACTTCTTGCTCCCAACT,0,1305937
furpa,0.5,1,1,AGGACTGGTCACTAAGCTGG,0,1312557
furpa,0.5,1,1,AGGACAATGTGTTTTAGATC,0,1311287
furpa,0.5,1,1,AGCTTATGTGACCTAGGATC,0,1330462
furpa,0.5,1,1,AGCTTAAGTACGTGGTGAAA,0,1340820
furpa,0.5,1,1,AGCTGTGAGTAGTTATCAAG,0,1346608
furpa,0.5,1,1,AGCTGTAAGACAACCGGTAA,0,1345344
furpa,0.5,1,1,AGCTGCTTAATTAAGGTGTA,0,1290555
furpa,0.5,1,1,AGCTGACTGAAAGGGCTCCC,0,1343648
furpa,0.5,1,1,AGCTCTAATCTTTTATATTT,0,1293840
furpa,0.5,1,1,AGCTCGACACGCCCTATTAC,0,1351952
furpa,0.5,1,1,AGCTAGTGATTGTGTAGGGA,0,1293772
furpa,0.5,1,1,AGCTAGTAATCTCTATCTCG,0,1317979
furpa,0.5,1,1,AGCTAGAAAAGGAGGATAAA,0,1310723
furpa,0.5,1,1,AGCGTTCTGGGATATACCTT,0,1292299
furpa,0.5,1,1,AGCGTGGCGTAGTTTGGTGA,0,1303056
furpa,0.5,1,1,AGCGTGCAGGACACGACGCA,0,1291294
furpa,0.5,1,1,AGCGTCGCTATTGACTAGCA,0,1282325
furpa,0.5,1,1,AGCGTACTAAAACCAATTTA,0,1329987
furpa,0.5,1,1,AGCGGTGCAGAGATGAACAC,0,1330282
furpa,0.5,1,1,AGCGGGGGTGCGCGGGCGGC,0,1315202
furpa,0.5,1,1,AGCGGCTGGAGGTCCTTAAG,0,1314845
furpa,0.5,1,1,AGCGGAGCGATGCTGATCAC,0,1350260
furpa,0.5,1,1,AGCGGACGTATGGTAAGCGA,0,1271486
furpa,0.5,1,1,AGCGGACAGCCCCACGTCTT,0,1294656
furpa,0.5,1,1,AGCGAGTATTCTTAAGATAC,0,1336272
furpa,0.5,1,1,AGCCTGTTCGGCTACATACC,0,1321992
furpa,0.5,1,1,AGCCTGTCTTAGGCGTTTCC,0,1325995
furpa,0.5,1,1,AGCCGTTAACGATTCCGGGC,0,1287203
furpa,0.5,1,1,AGCCGGGACTTAAGCCTCTT,0,1288551
furpa,0.5,1,1,AGCCGACAGACTCACCTATT,0,1301882
furpa,0.5,1,1,AGCATTGACTGCATCTGGGA,0,1326435
furpa,0.5,1,1,AGCATGTTATCACAGTCTTG,0,1324647
furpa,0.5,1,1,AGCATGCACAGCTCGCTCAT,0,1338046
furpa,0.5,1,1,AGCATCCGATCATGCGACAT,0,1298149
furpa,0.5,1,1,AGCAGAGAGGTAACCAGGGA,0,1336975
furpa,0.5,1,1,AGCACGGTCTGGATAAGCAG,0,1273997
furpa,0.5,1,1,AGCAATAATTTGGAATAGAT,0,1289513
furpa,0.5,1,1,AGCAAGACTTGGTTGAGGAG,0,1344568
furpa,0.5,1,1,AGCAAAGTGTGCCTCGCAAA,0,1339332
furpa,0.5,1,1,AGCAAAGATTCATTGATGCA,0,1330694
furpa,0.5,1,1,AGATTAATTCGGCACAGTTA,0,1312379
furpa,0.5,1,1,AGATGTTCCAGTTACTCAAA,0,1331001
furpa,0.5,1,1,AGATGGGCGGCATCGGTTCG,0,1313461
furpa,0.5,1,1,AGATGCGTTAGGATAATGAT,0,1347499
furpa,0.5,1,1,AGATGCGGAGGCATTATCCA,0,1291618
furpa,0.5,1,1,AGATGAGTTATCACTGTGTG,0,1357144
furpa,0.5,1,1,AGATCTGCGTCGCCGGCGTT,0,1311964
furpa,0.5,1,1,AGATCCACTGGGTGTGACCC,0,1285747
furpa,0.5,1,1,AGATCATAACATGGGGCCAT,0,1298086
furpa,0.5,1,1,AGATAGAGATATGCGTCCGT,0,1344552
furpa,0.5,1,1,AGATACACAGTTGGAGCACT,0,1296642
furpa,0.5,1,1,AGAGTCTCGGCGGTCTTGCT,0,1324949
furpa,0.5,1,1,AGAGTAGCACACACCGTAAC,0,1318835
furpa,0.5,1,1,AGAGTACGAGGGTTCCAATG,0,1272517
furpa,0.5,1,1,AGAGGTTACTCGCAGGCGTA,0,1278174
furpa,0.5,1,1,AGAGGGACGGCCTAGGTTTG,0,1326181
furpa,0.5,1,1,AGAGGCAACCGGGGGTATCA,0,1275907
furpa,0.5,1,1,AGAGCGCTTACAACGTGACC,0,1282952
furpa,0.5,1,1,AGAGATATCCGCTCTTTTGG,0,1312296
furpa,0.5,1,1,AGAGAGTTTCCATTTGTGTG,0,1291406
furpa,0.5,1,1,AGAGAAGAGGGCAGCTTGGC,0,1325136
furpa,0.5,1,1,AGAGAACTGATATGTTGTCG,0,1274595
furpa,0.5,1,1,AGACTCTGGATTATGCTGCG,0,1296909
furpa,0.5,1,1,AGACTATAATTTGCGTGTTG,0,1345475
furpa,0.5,1,1,AGACCGCGGGTCATCGGGCA,0,1311408
furpa,0.5,1,1,AGACCATAGCTCGGGCCTGT,0,1296589
furpa,0.5,1,1,AGACATCTAGAATTTCCAAA,0,1323940
furpa,0.5,1,1,AGACATAGCCCTACTCCCAC,0,1280520
furpa,0.5,1,1,AGACAGTAGAGCAGACGGCA,0,1278735
furpa,0.5,1,1,AGACAGCATTATGGTCGCGG,0,1321002
furpa,0.5,1,1,AGACACACCATGGCAGTGAC,0,1341182
furpa,0.5,1,1,AGACAAGATCAACAGACACG,0,1305858
furpa,0.5,1,1,AGAATTGGAACGGCCCATGT,0,1285051
furpa,0.5,1,1,AGAATGGTTCACTGCTCAAC,0,1273910
furpa,0.5,1,1,AGAAGTCGCATCAAAGAGAA,0,1331613
furpa,0.5,1,1,AGAAGGTAACGCAAGCGTGG,0,1279042
furpa,0.5,1,1,AGAAGCGTAAGGGGTGCGAT,0,1348484
furpa,0.5,1,1,AGAACGCCCGCTGGACTTTG,0,1273175
furpa,0.5,1,1,AGAACCGGGTGGCTATCTTC,0,1316599
furpa,0.5,1,1,AGAACCGGCTGATCTCTTGA,0,1342628
furpa,0.5,1,1,AGAAAGGGGGGAGGAATCGG,0,1326689
furpa,0.5,1,1,AGAAACTGGGTAAGGGCGGC,0,1294802
furpa,0.5,1,1,ACTTTTTCGACCGTAAGTCC,0,1344794
furpa,0.5,1,1,ACTTTGGTTTAGATTGCATA,0,1272081
furpa,0.5,1,1,ACTTTGCCAGACGCCGATAA,0,1299871
furpa,0.5,1,1,ACTTTCGTGTAGAACCCAGG,0,1335960
furpa,0.5,1,1,ACTTGTATAGGCCTCAGGAA,0,1280721
furpa,0.5,1,1,ACTTGACGTCTGCTAGTGTT,0,1343089
furpa,0.5,1,1,ACTTCTACTGTGCGAGATCC,0,1294047
furpa,0.5,1,1,ACTTCGGTCCTTGAGAAACT,0,1328321
furpa,0.5,1,1,ACTTCGATAGCTGTCACATG,0,1292286
furpa,0.5,1,1,ACTTCCGGTAAGCTGCGATG,0,1273385
furpa,0.5,1,1,ACTTATGGTAGACACGCGTA,0,1314240
furpa,0.5,1,1,ACTTATATACTCGCTCTAGT,0,1355272
furpa,0.5,1,1,ACTTAGGTTTTGTGCCACAC,0,1321723
furpa,0.5,1,1,ACTTAACTTCACATAATAGC,0,1327041
furpa,0.5,1,1,ACTGTCAGCGAACTTTCCGT,0,1299673
furpa,0.5,1,1,ACTGGGTCGCGTAGTGATCC,0,1338493
furpa,0.5,1,1,ACTGGCGCGGCAGGCTCCGG,0,1299401
furpa,0.5,1,1,ACTGCTCACGGCGAAATACT,0,1299645
furpa,0.5,1,1,ACTGCGGGTTATAGGGCCAT,0,1332795
furpa,0.5,1,1,ACTGATGAAAACATCAATTA,0,1289336
furpa,0.5,1,1,ACTGATCTACGATCTGGCGG,0,1296354
furpa,0.5,1,1,ACTGAGCAACATGAGTCCCA,0,1282709
furpa,0.5,1,1,ACTCTGCGGGCACGAATATG,0,1353954
furpa,0.5,1,1,ACTCTGAATGCGTCGGCGAA,0,1348733
furpa,0.5,1,1,ACTCTCTTTTGGCCATACGA,0,1293342
furpa,0.5,1,1,ACTCGGGACAGGAGATAGAA,0,1316964
furpa,0.5,1,1,ACTCCAGTTAGCTCTCACCT,0,1305961
furpa,0.5,1,1,ACTCATTTCAAGCTTGCACT,0,1307528
furpa,0.5,1,1,ACTCACTTCGGAGGTCATGA,0,1328090
furpa,0.5,1,1,ACTCAAAGGCATCTGTAATT,0,1313340
furpa,0.5,1,1,ACTATGGACCGGTTCAATTG,0,1306244
furpa,0.5,1,1,ACTAGCCTGGCCACAGATCG,0,1331414
furpa,0.5,1,1,ACTAGCAATCGGGGGGCTGA,0,1285785
furpa,0.5,1,1,ACTACATAGCGGCAACTACT,0,1348334
furpa,0.5,1,1,ACTAAGCAGAGGTACTGAGG,0,1349628
furpa,0.5,1,1,ACTAACCACTGGTAGTCGCG,0,1314418
furpa,0.5,1,1,ACTAAAAGGCGTCTAGTGAG,0,1350159
furpa,0.5,1,1,ACGTTCGTATTCTATGCTTT,0,1279123
furpa,0.5,1,1,ACGTTAGATCGGCCAATATA,0,1329874
furpa,0.5,1,1,ACGTGTAATCACTTGGACTC,0,1323972
furpa,0.5,1,1,ACGTGGCTCATGAATCAGCT,0,1285434
furpa,0.5,1,1,ACGTGGCCCTGACTGTAACA,0,1288408
furpa,0.5,1,1,ACGTGGAATCTCCCGCGTTG,0,1323365
furpa,0.5,1,1,ACGTGACTGAGCTGGCCCTC,0,1279946
furpa,0.5,1,1,ACGTGAATTTCGGCAGACTC,0,1306780
furpa,0.5,1,1,ACGTCTTGACCAAGTTATCT,0,1285957
furpa,0.5,1,1,ACGTCACGAAGCAGATCCAC,0,1335160
furpa,0.5,1,1,ACGTCACCGCAATTTGCACC,0,1281967
furpa,0.5,1,1,ACGTATGTGCGCCGCGGAAC,0,1318553
furpa,0.5,1,1,ACGTATAATCCAGTAGCACA,0,1352356
furpa,0.5,1,1,ACGTACTAAGATTGGGGTGG,0,1331907
furpa,0.5,1,1,ACGTACCAGACTCGTCGTTT,0,1321873
furpa,0.5,1,1,ACGTAATGTGTTGTGGTCAG,0,1309149
furpa,0.5,1,1,ACGGTTGACCCAGCTCACTT,0,1275034
furpa,0.5,1,1,ACGGTAGATCCTCAGGCTTC,0,1281026
furpa,0.5,1,1,ACGGGGTGCCAACGACATTG,0,1332530
furpa,0.5,1,1,ACGGGCAGTTGCGACCGTAA,0,1327861
furpa,0.5,1,1,ACGGGAGCACTGTCTCGGTT,0,1348462
furpa,0.5,1,1,ACGGGACGCACTCGGGACTC,0,1338599
furpa,0.5,1,1,ACGGGAAGCGGTAGTACCAT,0,1341089
furpa,0.5,1,1,ACGGCACGAAAGTTCTCGTG,0,1277932
furpa,0.5,1,1,ACGGAGTCAGTTGGTTAGAC,0,1354516
furpa,0.5,1,1,ACGCTCAGGAGGCGCACTTT,0,1303348
furpa,0.5,1,1,ACGCGGGCTACTATACTAAG,0,1308223
furpa,0.5,1,1,ACGCCGAGTATTATGCGATA,0,1341108
furpa,0.5,1,1,ACGCCCGGTAAACAAGCGTC,0,1342645
furpa,0.5,1,1,ACGCCAGATGTTACAGGCCT,0,1313611
furpa,0.5,1,1,ACGCCACTGTTACCGGAGTA,0,1326029
furpa,0.5,1,1,ACGCATACCCTTCGTTAACG,0,1306313
furpa,0.5,1,1,ACGCAGGAGTACCAAATCGG,0,1356151
furpa,0.5,1,1,ACGATCCAATCGCGAGTCAG,0,1301857
furpa,0.5,1,1,ACGATCACATCTATACCCGT,0,1302449
furpa,0.5,1,1,ACGAGTTGCTAAAGGAGGTA,0,1353469
furpa,0.5,1,1,ACGAGTTAGCAATGGGGACG,0,1293504
furpa,0.5,1,1,ACGAGGTACTTGTTGAGCTA,0,1280148
furpa,0.5,1,1,ACGAGGCGAAGCGGGTCGAA,0,1273084
furpa,0.5,1,1,ACGACTAGATTTTGTTTGCG,0,1307228
furpa,0.5,1,1,ACGAATACAGGAGAAAGCCA,0,1324814
furpa,0.5,1,1,ACGAACTGCCCGTTCTCGAC,0,1303065
furpa,0.5,1,1,ACCTTTGTCGCTAACTGCTT,0,1273436
furpa,0.5,1,1,ACCTTTGGGCATCCGTAGGT,0,1345879
furpa,0.5,1,1,ACCTTGGGGAAATCTGTGCT,0,1271955
furpa,0.5,1,1,ACCTGTTGCTCTTGACGGGA,0,1347000
furpa,0.5,1,1,ACCTGGTAGAATAATACAAG,0,1316940
furpa,0.5,1,1,ACCTGGCCCGATAGCTCAGC,0,1336974
furpa,0.5,1,1,ACCTGCTTGACCATTAAACA,0,1309273
furpa,0.5,1,1,ACCTCTCGCGTTAGACAGCT,0,1309959
furpa,0.5,1,1,ACCTATTTCTGTATTACCCA,0,1332761
furpa,0.5,1,1,ACCGTCGAGGAGCGGTACAT,0,1309275
furpa,0.5,1,1,ACCGTAAAGCGTCCTGAATA,0,1328934
furpa,0.5,1,1,ACCGGGTCGTTTCCTAGGAC,0,1343117
furpa,0.5,1,1,ACCGGCTTTGAGACTTCTAG,0,1341642
furpa,0.5,1,1,ACCGCGTTGCATTACGGTAT,0,1277917
furpa,0.5,1,1,ACCGAGTATCACCCGAAGGT,0,1300933
furpa,0.5,1,1,ACCGAGGGCATGGTAGGCTT,0,1318415
furpa,0.5,1,1,ACCGACCGGCACTTGAAAAA,0,1357366
furpa,0.5,1,1,ACCCTCATCGCGCAGGATTG,0,1272201
furpa,0.5,1,1,ACCCTAAACGAGGGGCGCAA,0,1356384
furpa,0.5,1,1,ACCCGGTCTTAGCATCGTGC,0,1310461
furpa,0.5,1,1,ACCCGGACTAGCGGAACATA,0,1293461
furpa,0.5,1,1,ACCCGCACTTACTGGGTACC,0,1353151
furpa,0.5,1,1,ACCCCCTCCCCGATCCCATT,0,1356964
furpa,0.5,1,1,ACCCCCGTTGTTAAGCCCCT,0,1288428
furpa,0.5,1,1,ACCCCCCTCGGTGAGGTATT,0,1353055
furpa,0.5,1,1,ACCCATGCGCATGACAAATG,0,1319580
furpa,0.5,1,1,ACCCAATAGCGCTATGTTTG,0,1331874
furpa,0.5,1,1,ACCATTTCTGGCGATAAGTG,0,1356657
furpa,0.5,1,1,ACCATTGCATCGGTTAGACA,0,1340905
furpa,0.5,1,1,ACCAGGGCTGCGCCCAATAC,0,1279857
furpa,0.5,1,1,ACCAGGGACCGCCCAGGAGC,0,1334902
furpa,0.5,1,1,ACCAGATCACCCTACTCGAC,0,1273180
furpa,0.5,1,1,ACCACGTACCCCGAGGCGTG,0,1337311
furpa,0.5,1,1,ACCACGGGTCATCCGGCTCT,0,1281401
furpa,0.5,1,1,ACCACAAATAGATTGAACGA,0,1296675
furpa,0.5,1,1,ACCAACGCGGGTTTACGTCA,0,1298767
furpa,0.5,1,1,ACATGCGGATAAGCGGTTGC,0,1278701
furpa,0.5,1,1,ACATGAGGTGCAGAACCATA,0,1333790
furpa,0.5,1,1,ACATCGAGTAAGTACAGATT,0,1284145
furpa,0.5,1,1,ACATCCTCCATTAGTCAAGT,0,1353431
furpa,0.5,1,1,ACATCCACATCCATTCAGGC,0,1310826
furpa,0.5,1,1,ACATATGAGAATAAGGTGCC,0,1290691
furpa,0.5,1,1,ACATATCACAGGGCGAGGAG,0,1296921
furpa,0.5,1,1,ACATAGGGCTCCGGCCTCCT,0,1316597
furpa,0.5,1,1,ACATACCCCGGGTTCGGTTT,0,1340505
furpa,0.5,1,1,ACATAATATTGCCGGTGTCT,0,1332232
furpa,0.5,1,1,ACATAAGTTATCTTGTAGAC,0,1357159
furpa,0.5,1,1,ACATAACTGGTCCTTCGACC,0,1273865
furpa,0.5,1,1,ACAGTGCATCTATAGCGGCC,0,1298762
furpa,0.5,1,1,ACAGTCATGCTTTCACCGAG,0,1320695
furpa,0.5,1,1,ACAGGTCAGGATTCGTAGGA,0,1275386
furpa,0.5,1,1,ACAGGGGCTACGCCCCGGCG,0,1309661
furpa,0.5,1,1,ACAGGGAACCAGAACTGGTG,0,1326539
furpa,0.5,1,1,ACAGGCTTGCGGTTACGAGT,0,1307981
furpa,0.5,1,1,ACAGCGGGCTCGCCGCTACC,0,1311670
furpa,0.5,1,1,ACAGCGAGTCCCGGGGCGCA,0,1325626
furpa,0.5,1,1,ACAGATACGAAGAGCATTCG,0,1344754
furpa,0.5,1,1,ACAGAGTCTTAATGGTGAGT,0,1318074
furpa,0.5,1,1,ACAGACGGTTCAGAGAAGGT,0,1319490
furpa,0.5,1,1,ACACTTGCTCTGGTGTTACA,0,1349406
furpa,0.5,1,1,ACACTGTTCCCAATAAACTT,0,1274678
furpa,0.5,1,1,ACACTGCGGTTCGGACAGGG,0,1313759
furpa,0.5,1,1,ACACGTCATGGCGTCAGTCC,0,1316090
furpa,0.5,1,1,ACACGGGACCCAATGATTCT,0,1271862
furpa,0.5,1,1,ACACGCGAGACACAAATGCT,0,1325481
furpa,0.5,1,1,ACACGCCCGGTCGAACGCCA,0,1347587
furpa,0.5,1,1,ACACGATTTTTATTTGCAGA,0,1283253
furpa,0.5,1,1,ACACGACCCACTCCCACCTC,0,1292247
furpa,0.5,1,1,ACACCTTTCACCTGCTCCAC,0,1342091
furpa,0.5,1,1,ACACAGTCTTTCCTGTGATC,0,1310525
furpa,0.5,1,1,ACACAGTAAAAGTGCGGGTA,0,1344921
furpa,0.5,1,1,ACAATTGGCGAGAAATATAG,0,1274189
furpa,0.5,1,1,ACAATGTAGCTTAACTTGTG,0,1329619
furpa,0.5,1,1,ACAATCACTATGGATAAAGC,0,1274558
furpa,0.5,1,1,ACAAGTGGACTGTTTAGTTC,0,1283762
furpa,0.5,1,1,ACAAGGGCTTAGGACAATTC,0,1346254
furpa,0.5,1,1,ACAACGTATCTTGTACTATG,0,1334649
furpa,0.5,1,1,ACAACACGTAAGAAATCTAT,0,1347904
furpa,0.5,1,1,ACAAAGCTTTTGGGTTGTGA,0,1300660
furpa,0.5,1,1,AATTTTCGATTCGCATGAGA,0,1307936
furpa,0.5,1,1,AATTTGTTATAAATCGGATT,0,1295502
furpa,0.5,1,1,AATTTGGGGCGAATCTGGGA,0,1306254
furpa,0.5,1,1,AATTTAGTGACGGTGAGTTG,0,1309199
furpa,0.5,1,1,AATTGCCAATTATTGTATTC,0,1326016
furpa,0.5,1,1,AATTGATCATCTGTAAAGGA,0,1318093
furpa,0.5,1,1,AATTCTCCTGTGTCACCCCA,0,1275861
furpa,0.5,1,1,AATTCGCTTTTCCAATCAAT,0,1328581
furpa,0.5,1,1,AATTCCAGGGTTAAGTGAAC,0,1279518
furpa,0.5,1,1,AATTCATGTATCGGTCAGTA,0,1277385
furpa,0.5,1,1,AATTCATAGATGCGATGTGA,0,1350533
furpa,0.5,1,1,AATGTGTGCCGTATGCGGTC,0,1271349
furpa,0.5,1,1,AATGTGTCTGGGATTGCTTA,0,1354809
furpa,0.5,1,1,AATGTGGGCGGTGAGCGTAA,0,1316808
furpa,0.5,1,1,AATGTCGGGATATCCGTAGT,0,1290865
furpa,0.5,1,1,AATGGGGGTTCGCAGAGTGA,0,1324290
furpa,0.5,1,1,AATGGAGAGTACCAACCTAA,0,1297526
furpa,0.5,1,1,AATGCGACGCGTAGCTTGGA,0,1287683
furpa,0.5,1,1,AATGCACCCCCTTGGTGGCA,0,1290975
furpa,0.5,1,1,AATGATAAGCATGAGTACGG,0,1311564
furpa,0.5,1,1,AATGAGTATGTGGCGAGAAA,0,1294016
furpa,0.5,1,1,AATGACGCGTGGCAGGCCTG,0,1348000
furpa,0.5,1,1,AATCGTCTGCGACCCATAGT,0,1332805
furpa,0.5,1,1,AATCGCCCTCGACCAGCCGG,0,1311370
furpa,0.5,1,1,AATCCTGTTATCTCTCTTCC,0,1280442
furpa,0.5,1,1,AATCCCGCACAAAGCACCTC,0,1293826
furpa,0.5,1,1,AATCCCGAACCCAGTACGTC,0,1318798
furpa,0.5,1,1,AATCCCAATCGTTGGGCGGT,0,1349295
furpa,0.5,1,1,AATCAGGCCGATGAATAGGG,0,1289414
furpa,0.5,1,1,AATCAGCTAACTTAGCACAC,0,1309829
furpa,0.5,1,1,AATCACCTGACTATTCACCA,0,1320876
furpa,0.5,1,1,AATCAAGGTAAAAACGGGGA,0,1337699
furpa,0.5,1,1,AATATCATTTGCTGCAATTC,0,1320049
furpa,0.5,1,1,AATATAGCTCAAATTTGCCG,0,1306872
furpa,0.5,1,1,AATAGTATTCACCTCCTTGT,0,1355259
furpa,0.5,1,1,AATAGTAAGTCAGTGCTATA,0,1293656
furpa,0.5,1,1,AATAGCTTAGGAGGAAGTGC,0,1283897
furpa,0.5,1,1,AATAGCGGACAATTAAGCTT,0,1322696
furpa,0.5,1,1,AATACTTGTCCGTGGGATGG,0,1291408
furpa,0.5,1,1,AATACTATAATTGATTGTTT,0,1332570
furpa,0.5,1,1,AATAATGGTTGACGCGTGCT,0,1293117
furpa,0.5,1,1,AATAATAGTAAAGGGTCATT,0,1346676
furpa,0.5,1,1,AATAAACCGGTTTGGCCCGC,0,1280149
furpa,0.5,1,1,AAGTTTGGAGAAGCTAGATC,0,1286867
furpa,0.5,1,1,AAGTTTGCGGGCACATTATA,0,1356552
furpa,0.5,1,1,AAGTTAGTCTTGTGGAATGT,0,1347363
furpa,0.5,1,1,AAGTGGGGACGGGCGAGGAG,0,1298772
furpa,0.5,1,1,AAGTGGACAACACGAAGTTC,0,1301222
furpa,0.5,1,1,AAGTCTCACCGGTTACATAC,0,1350139
furpa,0.5,1,1,AAGTCCGCGGTATCCGGGAG,0,1315665
furpa,0.5,1,1,AAGTATGGTGAGCATCTTAT,0,1355053
furpa,0.5,1,1,AAGTACTCGAATCTTTTTTT,0,1330506
furpa,0.5,1,1,AAGGTTTGCGCCTGTAAGCC,0,1295989
furpa,0.5,1,1,AAGGGGTGCGCAGTGGGTAC,0,1311224
furpa,0.5,1,1,AAGGGGTCCATGGTTATGTT,0,1338677
furpa,0.5,1,1,AAGGGGACGCAGCTTCATGA,0,1275125
furpa,0.5,1,1,AAGGGCCATATGACTTTCTC,0,1343344
furpa,0.5,1,1,AAGGGACCATAAGGGTGATC,0,1286095
furpa,0.5,1,1,AAGGCTTTCGCAAGCGACTC,0,1344738
furpa,0.5,1,1,AAGGCGATGGACCTTCCGAG,0,1332077
furpa,0.5,1,1,AAGGCCCGTAATGATAACTG,0,1341140
furpa,0.5,1,1,AAGGCCCCCTCGCGGGCACA,0,1315957
furpa,0.5,1,1,AAGGCACGCCCGGCCTGAAG,0,1284136
furpa,0.5,1,1,AAGGCAAAAGTGCGCTCACC,0,1301014
furpa,0.5,1,1,AAGGATTTACCGGCATTGTG,0,1347591
furpa,0.5,1,1,AAGGATGAGAACTTCGTTTT,0,1325247
furpa,0.5,1,1,AAGGATAGCTGCTCTATGCA,0,1306505
furpa,0.5,1,1,AAGGATACACAGCATTTTGC,0,1277763
furpa,0.5,1,1,AAGGACGCCGAGGCCTGTAA,0,1347735
furpa,0.5,1,1,AAGGAAAACTAAAAGAGCGT,0,1307888
furpa,0.5,1,1,AAGCTCCTGGCTTGGCGAAG,0,1295212
furpa,0.5,1,1,AAGCTAGCTGGATAGGGAAT,0,1293612
furpa,0.5,1,1,AAGCGTCTATCCAGATACTA,0,1295280
furpa,0.5,1,1,AAGCGGGAAAATTTGGGATC,0,1271688
furpa,0.5,1,1,AAGCGGCCGCGATGATATTT,0,1314187
furpa,0.5,1,1,AAGCGCGTTCGGAGCAATAA,0,1323772
furpa,0.5,1,1,AAGCCATAAAGATCCCATGA,0,1347152
furpa,0.5,1,1,AAGCCAGACCACAACTCGCA,0,1302617
furpa,0.5,1,1,AAGATCTCACTCAGCCATTT,0,1325896
furpa,0.5,1,1,AAGATACCTGGTGATTAAGA,0,1288301
furpa,0.5,1,1,AAGAGTCAAGCATCCAGTCC,0,1286637
furpa,0.5,1,1,AAGAGGCGCAGTCCTGGACC,0,1293741
furpa,0.5,1,1,AAGAGCCCCTCCTGTATCCC,0,1343526
furpa,0.5,1,1,AAGAGCAGTACCCATCTCTT,0,1324379
furpa,0.5,1,1,AAGAGACTAAACGAAAAACC,0,1284031
furpa,0.5,1,1,AAGACAGAGTGGGCTTCTTG,0,1283465
furpa,0.5,1,1,AAGAATGGGACATCAAGTCA,0,1322764
furpa,0.5,1,1,AAGAACCTAAGATGCCGTAT,0,1349578
furpa,0.5,1,1,AACTGGGGACTTCTATTCTG,0,1316281
furpa,0.5,1,1,AACTGCCGGGTCTTCAATAT,0,1297048
furpa,0.5,1,1,AACTGCCCGCTCAAGACGCA,0,1346151
furpa,0.5,1,1,AACTGCCATACCGATCGCGG,0,1304379
furpa,0.5,1,1,AACTGAGGTGGCCGGTTCAG,0,1349586
furpa,0.5,1,1,AACTGACAAGCGATAGGATC,0,1289904
furpa,0.5,1,1,AACGTAGGTCAAAGCATGAT,0,1357705
furpa,0.5,1,1,AACGGGACAAGACAATGGGA,0,1272545
furpa,0.5,1,1,AACGGCGTTCGTTCAGAGCC,0,1301541
furpa,0.5,1,1,AACGCGGTTTGTAAGCAGTA,0,1350932
furpa,0.5,1,1,AACGATCTGTCCGGGACCGT,0,1318358
furpa,0.5,1,1,AACGAGGATGTAAAAAATTG,0,1347092
furpa,0.5,1,1,AACGAGACTGAGGCATGGGG,0,1303880
furpa,0.5,1,1,AACGAATGCGATGACTTCTG,0,1278703
furpa,0.5,1,1,AACCTGGCGTAGACGGCATC,0,1333811
furpa,0.5,1,1,AACCTCCACAGCTAAAATAG,0,1352953
furpa,0.5,1,1,AACCCTCTAAATACGTCTGT,0,1312235
furpa,0.5,1,1,AACCCAGGCGGATGTCCCGA,0,1320297
furpa,0.5,1,1,AACCAGGCATATACAGGCAT,0,1304039
furpa,0.5,1,1,AACATTTTTAAAGTAAGCCT,0,1314560
furpa,0.5,1,1,AACATTGTATAACGTTACGA,0,1292811
furpa,0.5,1,1,AACAGGTTGAACTAGAAATC,0,1344273
furpa,0.5,1,1,AACAGGGATTTCATCACGAC,0,1287252
furpa,0.5,1,1,AACAGCTGCTTTAAGTGTCT,0,1278635
furpa,0.5,1,1,AACACTGCTATGGCAGGCGG,0,1272194
furpa,0.5,1,1,AACACCGACGCTGTTTAGAC,0,1330425
furpa,0.5,1,1,AACACATCAGACGGCCAAAC,0,1307820
furpa,0.5,1,1,AACAATCTAGTGATTTACTT,0,1287533
furpa,0.5,1,1,AACAAGAGGACAAGCTTACA,0,1291261
furpa,0.5,1,1,AACAACCTATGCTGCCCACC,0,1323421
furpa,0.5,1,1,AACAAACTGTGCGACTTATT,0,1338222
furpa,0.5,1,1,AAATTTGCAGCGTTTCATCA,0,1328612
furpa,0.5,1,1,AAATTTCGATGGGTTGAACA,0,1278063
furpa,0.5,1,1,AAATTAGGGAAATATCTGCA,0,1306523
furpa,0.5,1,1,AAATGAGAGTGCCCTGATGC,0,1275768
furpa,0.5,1,1,AAATATCGCGTTTTACACAC,0,1290466
furpa,0.5,1,1,AAATAGGCTGTTATGCTCGG,0,1322387
furpa,0.5,1,1,AAATACGGCCCACTTATTTT,0,1350744
furpa,0.5,1,1,AAATACGGATGACGTAAAGC,0,1339986
furpa,0.5,1,1,AAAGTGCGAACTCTACTTAA,0,1335835
furpa,0.5,1,1,AAAGTAAGTTTGCCAAAAGC,0,1289056
furpa,0.5,1,1,AAAGGTCTGAGGGTGAACGG,0,1355854
furpa,0.5,1,1,AAAGGGGTAGTTACACGCCA,0,1321326
furpa,0.5,1,1,AAAGCGCTCGCTGAATGCAT,0,1293305
furpa,0.5,1,1,AAAGCCGTCTAGCAATGGTT,0,1298473
furpa,0.5,1,1,AAAGCAAATGTTGCCCTGTG,0,1353103
furpa,0.5,1,1,AAAGATGCGTTAGTATATCC,0,1301105
furpa,0.5,1,1,AAAGAATGGACAGGCATGAC,0,1292715
furpa,0.5,1,1,AAAGAAGCTCCAGTTGTCCT,0,1310705
furpa,0.5,1,1,AAAGAACTCTCCTCAAAGTT,0,1277113
furpa,0.5,1,1,AAACTTGATCGCTCACGGTC,0,1346943
furpa,0.5,1,1,AAACTCTGCAGTATGTCAGG,0,1330214
furpa,0.5,1,1,AAACTATTGCCCCAGTTGAG,0,1333435
furpa,0.5,1,1,AAACGGTTTATAGGGGAAGT,0,1336080
furpa,0.5,1,1,AAACGCGTTACACAGTCCAT,0,1279973
furpa,0.5,1,1,AAACGCGGTTCCCAAGGCAT,0,1285039
furpa,0.5,1,1,AAACCGCTACGCATCTTGCG,0,1283450
furpa,0.5,1,1,AAACCCACTTCTACATCCTT,0,1279417
furpa,0.5,1,1,AAACCAGTCACTTGGACAAC,0,1341280
furpa,0.5,1,1,AAACACTGGGGTGTGGTTAC,0,1314229
furpa,0.5,1,1,AAACAATCGACAAGTTCAGT,0,1290712
furpa,0.5,1,1,AAAATTCACCCACCAGAGTG,0,1350813
furpa,0.5,1,1,AAAATGTTAATTCCGTTCGG,0,1315901
furpa,0.5,1,1,AAAATATAGGCGAAACGCTC,0,1321914
furpa,0.5,1,1,AAAATAGCCGGTAATTACGA,0,1273087
furpa,0.5,1,1,AAAATACTGGCAAGAATTCC,0,1282303
furpa,0.5,1,1,AAAAGATTGGCAGCAAGAAG,0,1297280
furpa,0.5,1,1,AAAACGGCTGTGGGAAGTAT,0,1308595
furpa,0.5,1,1,AAAAAGAAGGCAGACACAGA,0,1347860
furpa,0.5,1,1,AAAAACGAAGATGAAGGACT,0,1338098
furpa,143.0,142,0,AGAGGGTGGGCCGCTAGCTC,142,1335241
furpa,138.0,137,0,GCATCCTCACATTCTGCTCA,137,1328228
furpa,105.0,104,0,GAGCGCCCTCGTGCTGTAGG,104,1349013
furpa,102.0,101,0,TGTTGATCATTCGATCTCCC,101,1350271
furpa,96.0,95,0,AAGATGTGGCAAGTGTCGTC,95,1325843
furpa,91.0,90,0,CAAGGTTGCGGACCGGCTGT,90,1349807
furpa,82.0,81,0,ACGGTGCAAGCCCTAATGAC,81,1328227
furpa,81.0,80,0,GATCGGTCTGTTTGATGCCG,80,1346430
furpa,81.0,80,0,CCCCTACCTGGCTAACATTG,80,1302849
furpa,79.0,78,0,GTGTGCCAGTAAATAAACGG,78,1334336
furpa,77.0,76,0,AACGTCGTTTCCTTAGCGAA,76,1325871
furpa,76.0,75,0,CCTAATCGATTGGCGCTGAC,75,1282901
furpa,73.0,72,0,TTACGCCACCGCTGATAGTG,72,1271386
furpa,70.0,69,0,CATACACCGGACGCGATCCT,69,1286201
furpa,70.0,69,0,ATCTCCAAAAGATTCAGCGG,69,1280319
furpa,69.0,68,0,TTTGGAGATGTATACGTCTC,68,1315592
furpa,68.0,67,0,GGAACTTCGTCTCAGTCCCA,67,1271406
furpa,67.0,66,0,TTTGCTAGGATGTGAGCCTG,66,1276975
furpa,67.0,66,0,CGTGGCGCGGTTTCAGTGGT,66,1326628
furpa,66.0,65,0,TCCTAACGAGGGCACTTAGA,65,1283596
furpa,66.0,65,0,CGTCCGTACAATCGATAGCA,65,1339325
furpa,65.0,64,0,TGTTTACTTGGTGAGGAATG,64,1293942
furpa,61.0,60,0,GATATTGCATCAAGGACCCT,60,1347025
furpa,61.0,60,0,CGTATAGTGTCTCCCTCTCA,60,1277060
furpa,61.0,60,0,CATATGAGACACCGGGCACA,60,1281990
furpa,59.0,58,0,GATACTGTTTGTAGGATTTA,58,1287643
furpa,58.0,57,0,TTGTAGGGAAGAGAGTAACA,57,1345926
furpa,58.0,57,0,TGTGCTCGAATTAGCAAATT,57,1324296
furpa,58.0,57,0,TCTTGTGCGGCTGTCAGCCA,57,1323420
furpa,58.0,57,0,TCCATAAAACATTCCCGCGC,57,1326422
furpa,58.0,57,0,CACGTATATTGCGGTTGCAT,57,1347160
furpa,57.0,56,0,GAATATACGAAAGTCGGTTG,56,1338135
furpa,57.0,56,0,ACGTTACTCGACCCCAAGAC,56,1291735
furpa,56.0,55,0,AGGTGTGACTGAGAGTTCTA,55,1312988
furpa,56.0,55,0,ACGTTTGGCTTCGCTGACGA,55,1277212
furpa,54.0,53,0,CATGTACACTCTCAGGCAAG,53,1299932
furpa,52.0,51,0,GAATGTCGGAATATCGGGAA,51,1357532
furpa,51.0,50,0,CGGGTGCCAACAACAACAAT,50,1331545
furpa,50.0,49,0,GATTTACTCAGTTACAGCAT,49,1290101
furpa,50.0,49,0,AGATTTTATCACGAGTTCTT,49,1334752
furpa,49.0,48,0,GGAATGAGCTCATCCGGTTC,48,1337323
furpa,49.0,48,0,AGTGGCGGCACGTAACGGTA,48,1304697
furpa,48.0,47,0,TTCGTTCAAAGGTAGGAGCT,47,1351435
furpa,48.0,47,0,GGGGCAAAAAAATCTGAGAC,47,1347289
furpa,48.0,47,0,GGCATGGTTAAAAAACGTAT,47,1302034
furpa,48.0,47,0,CTGCACAGCGGCCACAAGAC,47,1271604
furpa,48.0,47,0,CCATCAACCTTTTCCACGAC,47,1333048
furpa,48.0,47,0,ATCTCTGTGGGTCTAGAAGC,47,1326103
furpa,48.0,47,0,ACTAGCCGATCGAGGCTATA,47,1271336
furpa,48.0,47,0,ACGCGAGCCGACCTCATTAT,47,1354735
furpa,48.0,47,0,AATCCCTGTGTCCCTCTATG,47,1323654
furpa,47.0,46,0,CTGTCGCGGGGAGAAGCCTT,46,1330094
furpa,47.0,46,0,CTAGGTTGATGCGTGACTTT,46,1331534
furpa,47.0,46,0,CTACGTAGTCTCCTTCGGGT,46,1342356
furpa,47.0,46,0,ACGGCGGGCTAAAATGTCTG,46,1356541
furpa,47.0,46,0,ACACGGGGTGGTGAATAAAC,46,1328169
furpa,46.0,45,0,TGAGGGCCTGCTCCTGCAAG,45,1341793
furpa,46.0,45,0,CTTTCGGCAATCAAGAGCTG,45,1344243
furpa,46.0,45,0,CCTTGGGAATGTCCTAGAAT,45,1288237
furpa,45.0,44,0,CTCAATGCTGAATTGTGACT,44,1308542
furpa,45.0,44,0,AGATTGTACACGCTCACCAT,44,1321179
furpa,45.0,44,0,ACCTCAACGGTGGTCATGTT,44,1296356
furpa,44.0,43,0,TATCAAGGTAACGGTATTAT,43,1342666
furpa,44.0,43,0,GGGGCTATTGCTTGGGGAGG,43,1307238
furpa,44.0,43,0,CTGTCACCGCGCCTGGAGTG,43,1278310
furpa,43.0,42,0,GGCCACTCATCAAAGCTAAT,42,1351434
furpa,43.0,42,0,CTGCATCTAGCATGTACCTC,42,1348636
furpa,43.0,42,0,ACCGAAAGCCGTTACCTGTA,42,1344926
furpa,42.0,41,0,TGCCGTCAGACTAGCTTGAG,41,1303620
furpa,42.0,41,0,GCGAACCCTAGGATCGTAGG,41,1307177
furpa,42.0,41,0,GAGTCGGTTCTTTCACACGA,41,1323548
furpa,42.0,41,0,ATTAGGGCGGTTTAACGGCT,41,1349181
furpa,42.0,41,0,AGTGTCCGGGCACGATTTTC,41,1350272
furpa,42.0,41,0,AGAGTGAGATTAGGTGTACA,41,1325861
furpa,41.0,40,0,GTTCTTTGCAGGCGCCCTGC,40,1315575
furpa,41.0,40,0,GAAAAATACGTGGTAACGAA,40,1331479
furpa,41.0,40,0,AACCGCCTAGATTTGGTCGT,40,1308196
furpa,40.0,39,0,TTGACAGCTTCACAAAGTTC,39,1280270
furpa,40.0,39,0,TTCACTCCCGAACTGCCCTA,39,1331409
furpa,40.0,39,0,TCGAGTGGGAGAACTAGGTC,39,1307012
furpa,40.0,39,0,GCGTGGAATGAGGTGCGAGA,39,1336508
furpa,40.0,39,0,CCTAGTCATTTAACGCTGTG,39,1276010
furpa,40.0,39,0,AGGTTCAGGATCACAGGAAT,39,1322363
furpa,40.0,39,0,ACCTGTCCTACGCTAACGTT,39,1290247
furpa,39.0,38,0,TCAAAAAATGCGAGGGCAGG,38,1329711
furpa,39.0,38,0,ATGTCCGAGACGTAGACTTC,38,1271775
furpa,39.0,38,0,ATGACTGTGAGAAGACCACG,38,1331564
furpa,38.0,37,0,TGTCCTCATAGCGCGCCACC,37,1304376
furpa,38.0,37,0,GCGGCACCCCAGCATAGCAA,37,1306701
furpa,38.0,37,0,GCGGATCAGCCATTGAGCCA,37,1279669
furpa,38.0,37,0,CTACCAAGGGGTGCAAGATA,37,1307542
furpa,38.0,37,0,CCAACTATCTATCATAGAAG,37,1350298
furpa,38.0,37,0,AGGTAGATCAGAGAAGCGTG,37,1319564
furpa,37.0,36,0,TTCTCCCCATCTTGCGCGGC,36,1339661
furpa,37.0,36,0,TAGATGATACATGAATCGTC,36,1342193
furpa,37.0,36,0,CTACCTGCTTCACCGCTCTG,36,1341485
furpa,37.0,36,0,CGCCCTCCAGCGTCGTTAGA,36,1307186
furpa,37.0,36,0,AAATGCTTAGATACCGCTCC,36,1275516
furpa,36.0,35,0,TTTTATAACCATCGTGACTA,35,1328230
furpa,36.0,35,0,GCTCGGAAATCAAGGTCATA,35,1273850
furpa,36.0,35,0,CGATAGCCGTAAATTTAACG,35,1334965
furpa,36.0,35,0,AGTAATCAAGATCTTGACCA,35,1273455
furpa,35.0,34,0,TTTCGTGTGGTCCCAAGGGT,34,1276716
furpa,35.0,34,0,TTCACATGCTCAACGCTATA,34,1327391
furpa,35.0,34,0,TCGGTTGGGTGGGCTTGAGT,34,1327402
furpa,34.0,33,0,TCAGGGATGAATGGCAGGGA,33,1283274
furpa,34.0,33,0,GGCTTCAGATATATATAAAA,33,1306496
furpa,34.0,33,0,CTCTAGCAGAGTTTGCATAG,33,1325924
furpa,34.0,33,0,CGTGCGGAAATTCTATTAAA,33,1277034
furpa,34.0,33,0,CGACGGACCCACGTTTTTCC,33,1320771
furpa,34.0,33,0,CCGAGGCCCCGACAAGGTAT,33,1315679
furpa,34.0,33,0,CATGTACGCGTGGCGGGGAA,33,1340284
furpa,34.0,33,0,ATGACCAACCCCAGGTTTTT,33,1307874
furpa,33.0,32,0,TTCGATCCCCTATATCCGTG,32,1296748
furpa,33.0,32,0,TTACAGTTACAGGAGCCTAT,32,1340501
furpa,33.0,32,0,GTGCCAGGGGATCACGTAGG,32,1350458
furpa,33.0,32,0,GTACGGTAGAGGAGCACAAT,32,1289407
furpa,33.0,32,0,GGCCGGCAGGCGTATGAAAA,32,1280875
furpa,33.0,32,0,AGAGGCTATACTAGCCAGGG,32,1318007
furpa,33.0,32,0,AGACCCGAGAATCTCCCGAT,32,1307175
furpa,32.0,31,0,TGCCTGAGGTTCTAGCCACA,31,1331325
furpa,32.0,31,0,TCGCCAGTATTCAGCGTACC,31,1320322
furpa,32.0,31,0,GGGATACGACCAACGAGGTC,31,1276176
furpa,32.0,31,0,GCCCAGCTTACCACTGCCGG,31,1307301
furpa,32.0,31,0,AGGCGGTACACTGGTGTGGA,31,1279374
furpa,32.0,31,0,ACCCAATCCAAGCACATCAG,31,1314559
furpa,31.0,30,0,TCACGTAAGCTGCACCGCGA,30,1290110
furpa,31.0,30,0,GTAGAAAAGGTTCGGGTGCA,30,1335624
furpa,31.0,30,0,GCTTGCAACGACATGAGAGT,30,1281981
furpa,31.0,30,0,CGTAGTGCAAATGACGTCCT,30,1314638
furpa,31.0,30,0,CGACTTCCAGGTAGTGGTAA,30,1285439
furpa,31.0,30,0,CGACACATGAATAATTGTCT,30,1295014
furpa,31.0,30,0,ACCCCCATATTGGTCCTCAG,30,1357128
furpa,30.0,29,0,GGTAGTGGGACGTTTTCTGA,29,1281177
furpa,30.0,29,0,GGATAGGTCTGGTCTCCAAG,29,1352721
furpa,30.0,29,0,GATACGAAAATGATTGTGAA,29,1345889
furpa,30.0,29,0,CAGCTCCCGACCGGCATAGC,29,1273448
furpa,30.0,29,0,ATTCTTAATTTCGCAAAGTC,29,1283502
furpa,30.0,29,0,AGGGTTGGCCAAGAGATGTT,29,1329555
furpa,29.0,28,0,TCGCACAGTACCTCATCGTA,28,1354486
furpa,29.0,28,0,TCAGGTGTCTCGCTACAAGA,28,1342343
furpa,29.0,28,0,GTAACTTAAGTAGCTTTTGG,28,1322847
furpa,29.0,28,0,GGAAGGAATTGTAACCGCGG,28,1333975
furpa,28.0,27,0,TCCCACGTGACGCAGTTTGA,27,1322504
furpa,28.0,27,0,CGGTCTAGCTTCGGGATTGG,27,1315577
furpa,28.0,27,0,CCCGATAGGCAGTTTCACTC,27,1326110
furpa,28.0,27,0,CCCCTGGGGGATCTGTCGCA,27,1276549
furpa,28.0,27,0,CACTGAACAAGAGGTGCGAT,27,1328407
furpa,28.0,27,0,ACGTGTGTTCCGTCTACCCC,27,1295943
furpa,27.0,26,0,TCCGGTGGAGTTTCCTGGTA,26,1272530
furpa,27.0,26,0,GCCCTGAGCTCCTGGTACCG,26,1311702
furpa,27.0,26,0,GAATACGTGATCTGGACGTC,26,1283497
furpa,27.0,26,0,CTGGAAATACTAAATGACCT,26,1318046
furpa,27.0,26,0,CCTAAGGAAGGGCCTACTCC,26,1271347
furpa,27.0,26,0,CAAATCTGGTAATCGGTATT,26,1350949
furpa,27.0,26,0,ATGGGGTGTTTACTGGTCTA,26,1274461
furpa,27.0,26,0,ATGCCACACTAGCTTGACAT,26,1334098
furpa,27.0,26,0,AAGCAGATTCGACATAAACC,26,1326442
furpa,26.0,25,0,TTTAGTGCTTCGAATTAGTG,25,1314279
furpa,26.0,25,0,TCTTGGCTTAGTGCGATCGC,25,1285204
furpa,26.0,25,0,TACGTAAAGACCGTGGCCCT,25,1291312
furpa,26.0,25,0,TACAAAACTATGAGGTTTGA,25,1345484
furpa,26.0,25,0,GCTAAGGCGGAACCCCGCTG,25,1301834
furpa,26.0,25,0,GACTTTTCTCACCTCTAGCG,25,1285187
furpa,26.0,25,0,CGGTATATTTTGATGTGCAT,25,1334346
furpa,26.0,25,0,CCCACACCATTAGGAATTTG,25,1279434
furpa,26.0,25,0,AGCGGGCACCGGAGACTCTG,25,1276629
furpa,26.0,25,0,AGAGGTTCATGCCCGCAGTG,25,1343367
furpa,26.0,25,0,AGAGATCCTCACGCAACATC,25,1345577
furpa,26.0,25,0,ACTTTACGAATCTGCCCTAG,25,1357099
furpa,25.0,24,0,CTCTCAGTCACAGGAAAACA,24,1341249
furpa,25.0,24,0,CCCGGATCTGCCCCGATCTA,24,1283655
furpa,25.0,24,0,ATTCATGCATTCTTTCAAAA,24,1319571
furpa,25.0,24,0,AGGACCGACAATTTCAGTAT,24,1281090
furpa,25.0,24,0,ACAGCAGAGTGACAGAGTGT,24,1338773
furpa,24.0,23,0,TTCTATATCTACACTACTCT,23,1347045
furpa,24.0,23,0,GTGACTCGGTTGCTCTATAT,23,1277300
furpa,24.0,23,0,GTCTTGTTTTCCTCCAGTGG,23,1338475
furpa,24.0,23,0,GACAACAGAGTATACAACCC,23,1305856
furpa,24.0,23,0,CGGTCAGGCAGAATTCAAGG,23,1324442
furpa,24.0,23,0,CCTCAGGCGTGTTCCGACAT,23,1321456
furpa,24.0,23,0,AACGCGAGAGAGGGAGGCCT,23,1306437
furpa,24.0,23,0,AAATAATGGTACCTCTGTTA,23,1273611
furpa,23.0,22,0,TTGTTTCCCACCACCGGCTC,22,1285323
furpa,23.0,22,0,TTGCGGAAATAGAACCATCT,22,1323223
furpa,23.0,22,0,GAATTGTTGACTGGGCCCTG,22,1279786
furpa,23.0,22,0,CCAAACGTCTTGCGAGTTGA,22,1323417
furpa,23.0,22,0,CATGACCGAATGTACTCCCA,22,1274130
furpa,23.0,22,0,ATCGGGAACACTGCAAAAAG,22,1300807
furpa,23.0,22,0,AGGGAATTGGTGGCGGATGG,22,1273793
furpa,23.0,22,0,AATTCCACCGTTCAGGTACA,22,1333711
furpa,22.0,21,0,TCTACAGTAACTACTAATCC,21,1349869
furpa,22.0,21,0,TACGCCGCCGCGGTACGTGT,21,1336015
furpa,22.0,21,0,TAAATATTGACACGTTTTGG,21,1338901
furpa,22.0,21,0,GTCGTTTGTACAATCACAGA,21,1328168
furpa,22.0,21,0,GATAAACCTGTCTGCATAAG,21,1281095
furpa,22.0,21,0,GAGGGAATATATTGGGTTCA,21,1312605
furpa,22.0,21,0,GACCCCTATCTACGAACGGG,21,1333112
furpa,22.0,21,0,CTTCCTTCGTAGACAGGCAA,21,1336784
furpa,21.0,20,0,GGATTATTTCGATCTTAGTG,20,1327381
furpa,21.0,20,0,GCAATAAACAAGCCGGCCGT,20,1311594
furpa,21.0,20,0,CTTGTTAGGGCCAGGTAGCA,20,1288484
furpa,21.0,20,0,CCGGGCCAAGCGCTGAACAC,20,1277936
furpa,21.0,20,0,CACCGTCCACCTCGCGACAC,20,1352921
furpa,21.0,20,0,AGATATTATAATCATGTTGA,20,1334817
furpa,21.0,20,0,ACCAGGAGAGCAGCAGCAAA,20,1304392
furpa,20.0,19,0,TTTATTGTGTGGGCGCATAT,19,1319278
furpa,20.0,19,0,TGGTCAGCCCAGAACCCAAC,19,1282384
furpa,20.0,19,0,TCTGGTCCCATACGTCACTG,19,1354531
furpa,20.0,19,0,TCGGCCTTGAACGATTCCAG,19,1355697
furpa,20.0,19,0,GTGGATGGTCTTCACCGCCA,19,1296359
furpa,20.0,19,0,GTCTAATCATGGAGGAGGAA,19,1291571
furpa,20.0,19,0,GTCCTGGGCGTGGATATGCT,19,1277278
furpa,20.0,19,0,CGTGCCCTGAAGCTTGGATC,19,1328274
furpa,20.0,19,0,CAACGATCATGAAACTCTGA,19,1333627
furpa,20.0,19,0,AGACCACGTATGAACGGTGG,19,1293086
furpa,20.0,19,0,ACTGATGGGATGGCACATCA,19,1312459
furpa,20.0,19,0,ACGGGAGGTCGATTTTTTAC,19,1318787
furpa,20.0,19,0,ACGGATTCCGGCTAAATTAT,19,1286157
furpa,20.0,19,0,AATGGGCACAACGGACATAC,19,1273069
furpa,20.0,19,0,AACCCGATTGTACTAATTTC,19,1334338
furpa,20.0,19,0,AAACCCCCTCCTGATGCTAG,19,1279947
furpa,19.0,18,0,TTAGTTGCGCCCAGCGCAAC,18,1310336
furpa,19.0,18,0,TCGAATGGGCGTGTTTAACC,18,1336001
furpa,19.0,18,0,GCTCGCGGGTAGTCCCACAC,18,1304590
furpa,19.0,18,0,GCCCGACCGGATGCACCACA,18,1345535
furpa,19.0,18,0,AAGCAGTCTTCGGACATTCT,18,1281172
furpa,18.0,17,0,GTGTTATGGAATTGCAATAG,17,1293435
furpa,18.0,17,0,GGTATTCCGCCCCCAGGTTG,17,1286316
furpa,18.0,17,0,GGGCTGAGACGGTCGCCAGA,17,1298138
furpa,18.0,17,0,GCGGGGAGGTCGGAAGACAG,17,1271780
furpa,18.0,17,0,GATACGGTGCTAAGATGGTT,17,1355655
furpa,18.0,17,0,GAGATCAATACTCGCGATTG,17,1285046
furpa,18.0,17,0,CTAAGAAGCGACGAAGGGCG,17,1292928
furpa,18.0,17,0,CAGGTACTGCAAAGAATCAA,17,1315855
furpa,18.0,17,0,ATGCGTAGAGGAAGAGAGTC,17,1331326
furpa,18.0,17,0,AATGGGGGATATAGCCCTCG,17,1319919
furpa,18.0,17,0,AAGAGCGTCTCCTAGCCCGA,17,1325999
furpa,17.0,16,0,TTGTGGTTTTACTGTAGAGC,16,1336304
furpa,17.0,16,0,TGGCACGAATATCTTTGTTG,16,1315720
furpa,17.0,16,0,TGCGTGATTCTAATGAACAA,16,1274885
furpa,17.0,16,0,TATCCCTAGGGTGTGATAAA,16,1313715
furpa,17.0,16,0,TAGCAAGAGCATCTTCCTTC,16,1279107
furpa,17.0,16,0,CTAGTTGCATTCAACTAGGG,16,1320204
furpa,17.0,16,0,CGCGGGGGGACAAAATATAG,16,1321487
furpa,17.0,16,0,CCGACGACGCTCTCGAGGGA,16,1327612
furpa,17.0,16,0,ATTAGATCCAGCGCCGTTGC,16,1328108
furpa,17.0,16,0,ATAATCACAGCGAAAACGAA,16,1311450
furpa,17.0,16,0,AAGTAAAATGGTCGGAGACA,16,1356652
furpa,16.0,15,0,TCCTTTCATAACCTTCCTAG,15,1328668
furpa,16.0,15,0,GTTCTTCCAGATTACTCCCA,15,1328406
furpa,16.0,15,0,GTCAAGAGCCAAACATTGTC,15,1325073
furpa,16.0,15,0,GCACACTCCTTACTGACATG,15,1279050
furpa,16.0,15,0,CGAACACAGACTTATGATTA,15,1345000
furpa,16.0,15,0,CCACTGTTCGTCAATTTTGA,15,1323054
furpa,16.0,15,0,ATAATTAACAGTGATTGGTG,15,1310467
furpa,16.0,15,0,AGAAGAGAGTGATGCGGTCC,15,1356717
furpa,16.0,15,0,ACATATCGAAGGTGACGAGA,15,1328114
furpa,16.0,15,0,AAGATGGAGCCGCGTTGGGC,15,1336255
furpa,15.0,14,0,TTGCGTCCATTCGTCCTATG,14,1329893
furpa,15.0,14,0,GTACGCTCCAGAACATGAGA,14,1357019
furpa,15.0,14,0,GGGTGCCTGTTTGGGCTAGA,14,1306696
furpa,15.0,14,0,GCTTGGGGCAGAATCTAACT,14,1298617
furpa,15.0,14,0,GCGTCGATCCTTTATAAATA,14,1282665
furpa,15.0,14,0,GAAAGGTCATGAAACGTGTA,14,1278040
furpa,15.0,14,0,CGTGGTCAGCTCTTCTTCAA,14,1290122
furpa,15.0,14,0,CGCACCGTACTGGTCCGGCG,14,1354751
furpa,15.0,14,0,CACGTTACTATGTCCGCCCG,14,1291827
furpa,15.0,14,0,ATTTTTCAGATACCGTACTG,14,1291234
furpa,15.0,14,0,ATCTTTTGCGCCTCTGAACT,14,1295640
furpa,14.0,13,0,TTTCGTTCCCTCCTGATTTA,13,1273094
furpa,14.0,13,0,TTGTATCATAATATTTGCTC,13,1281062
furpa,14.0,13,0,TTCGCGACCGGTAGGGGGGG,13,1324954
furpa,14.0,13,0,TATAACTTACTGATCCGTTT,13,1278169
furpa,14.0,13,0,GCTTTAATAAGAACTTCCCC,13,1323744
furpa,14.0,13,0,GCTCGGGTCTCCTGGGCAAT,13,1342938
furpa,14.0,13,0,CTGCGTCGCAGCTTCCTTAT,13,1273437
furpa,14.0,13,0,CGAGTATCTGGGACGGACGG,13,1327577
furpa,14.0,13,0,CCGGATTACTACCTCATTGT,13,1319372
furpa,14.0,13,0,CCACCTGAGCCCGGCTCTCC,13,1311569
furpa,14.0,13,0,CAGACCCGATCGTCGTAACT,13,1293627
furpa,14.0,13,0,ATGGCCAGACCTGGTTTGGG,13,1316679
furpa,14.0,13,0,ACCCGGGCGCAAGTTCAGCC,13,1315597
furpa,14.0,13,0,AATGCTCGCGGTCCCAAGTT,13,1273236
furpa,13.0,12,0,TTTCAGTCACCGTGAAGAGG,12,1339318
furpa,13.0,12,0,TTCGCGTTCTTGCTGCATTC,12,1323443
furpa,13.0,12,0,TGTTATCATCCGTGGGAGTG,12,1280933
furpa,13.0,12,0,TATGGTTTTTAGTGTTTACC,12,1282715
furpa,13.0,12,0,GTCATGGGGCCACTGTGCGT,12,1291022
furpa,13.0,12,0,GGCCGTTCGAAGAAACAGAT,12,1322641
furpa,13.0,12,0,CGTCCTACATAATTCTTATT,12,1330050
furpa,13.0,12,0,CGGAGTCCGGGTCAGCACCA,12,1323225
furpa,13.0,12,0,CCCACGCAGGGCGGCGAGTC,12,1285688
furpa,13.0,12,0,CATCATAGAAATAAGGGTAG,12,1310232
furpa,13.0,12,0,ATAGACGCAAATTTGGGCGT,12,1309904
furpa,13.0,12,0,ACGGATTCCTGAGAATGATC,12,1356237
furpa,13.0,12,0,ACCAGGTCCGTCCGTCACAA,12,1281113
furpa,12.0,11,0,TTAACGGGATCGCAGCGAGG,11,1328277
furpa,12.0,11,0,TGTTAGGCTACAGCGCGGGC,11,1347742
furpa,12.0,11,0,GCCAATAAGTAGGCTGAATC,11,1345147
furpa,12.0,11,0,GAGAGACTCTGAATCATCGC,11,1328278
furpa,12.0,11,0,CTGGGCACAGCGATCCAAAT,11,1351425
furpa,12.0,11,0,CGTGGAGCGTTCCACTATTG,11,1290104
furpa,12.0,11,0,CCTACACCAACTGGGAAACG,11,1313518
furpa,12.0,11,0,CCCCCAATTTAATTCATCGA,11,1303338
furpa,12.0,11,0,CCACTAGAATGGCGTGGAAC,11,1326465
furpa,12.0,11,0,AGGGAACCTGGTGCTGTCTA,11,1280833
furpa,11.0,10,0,TTCACATAAGCTTAAGAGAT,10,1326278
furpa,11.0,10,0,TGTACCGATGTTCGTGCCCA,10,1280885
furpa,11.0,10,0,TGATTTTCGTCGAGGGGGTT,10,1300200
furpa,11.0,10,0,TCTTATTCATAGGAAGGTAC,10,1278949
furpa,11.0,10,0,TAGATCACACTTCGCAGCTA,10,1313792
furpa,11.0,10,0,GTAATTTCAGAGGTATCGCT,10,1346189
furpa,11.0,10,0,GGTCACCCTGGACGCTATTC,10,1334870
furpa,11.0,10,0,GCCATGATCCAGATCAGTAA,10,1299001
furpa,11.0,10,0,GCATTTTTACTACATAATAT,10,1314177
furpa,11.0,10,0,CGCACCACTGGATATATCGC,10,1272192
furpa,11.0,10,0,CCATTCCTAAAAGTTGTAGC,10,1340852
furpa,11.0,10,0,CAGTGACCCTAGCTGCTATA,10,1295404
furpa,11.0,10,0,ATTTTTGTTTTAGAAATATC,10,1287108
furpa,10.0,9,0,TTGCGAATAGAGTACATAAT,9,1311998
furpa,10.0,9,0,TGTTGTGACGGGTGCAACAA,9,1343279
furpa,10.0,9,0,TCTCCGCACACCATCCATTA,9,1352395
furpa,10.0,9,0,TCATGAGGGCGCGGGCGTTT,9,1302360
furpa,10.0,9,0,GTGGACGTTTACTAGCCTTA,9,1341365
furpa,10.0,9,0,GGGCTCTGGTTCGTCTAATA,9,1338977
furpa,10.0,9,0,GAATGCCCACTGAAAAAGAT,9,1285021
furpa,10.0,9,0,CGGACTACGGCACTTTCGCT,9,1287134
furpa,10.0,9,0,CCTAAGGTATGGCTTAGAAT,9,1335132
furpa,10.0,9,0,CCGTCAGGCAGGATCTTCGA,9,1290186
furpa,10.0,9,0,CCGGTGCAGCTGTTGCGCGC,9,1340567
furpa,10.0,9,0,ACTTTCATGCAGCGACTATA,9,1327236
furpa,10.0,9,0,ACAACACGGATACATGGGGA,9,1350313
furpa,10.0,9,0,AACCCGATGCTCCATTTTCG,9,1320360
furpa,9.0,8,0,TCAGAAAGGGATATTAAAGG,8,1294097
furpa,9.0,8,0,TATACGAGTAACAAATAGTG,8,1312551
furpa,9.0,8,0,CTCTCCGTGATAATGTGAGT,8,1304021
furpa,9.0,8,0,CCCGCATTGTAATACCTGAT,8,1305564
furpa,9.0,8,0,ATGCATATATTATCGATCCC,8,1312184
furpa,9.0,8,0,AGTACGGCTTCAAGGTCCCC,8,1293945
furpa,9.0,8,0,AGGGGTGGACGGCTATACGA,8,1304377
furpa,9.0,8,0,AGGATCCCGGTGCCCCCGTT,8,1312617
furpa,9.0,8,0,AGACATTAACGGTTGTGTAA,8,1290031
furpa,9.0,8,0,ACTTATGCGGCATGTTAGGG,8,1324610
furpa,9.0,8,0,ACAAGAGGTGATTAAATAAC,8,1338438
furpa,9.0,8,0,AACCCAGGAAAGACCTTCAG,8,1314092
furpa,8.0,7,0,TTTCCTACGACTTGCACGCC,7,1296763
furpa,8.0,7,0,TTGTGTATATTATTCCGAAG,7,1347580
furpa,8.0,7,0,TTGAGCGAGCTAGTACCAAG,7,1276897
furpa,8.0,7,0,TGTAATTCTCGTCTCAAATC,7,1290165
furpa,8.0,7,0,TAGCTGGAGCGTCTATCACC,7,1337906
furpa,8.0,7,0,TACGAGGATGGTATAATCGC,7,1321606
furpa,8.0,7,0,GTTGGGGGGGGGGCGCCAGG,7,1331799
furpa,8.0,7,0,GTCAGCAGAGTAGTCTTAAT,7,1289164
furpa,8.0,7,0,GTAGTCATAAGACGTTTCTT,7,1325380
furpa,8.0,7,0,GGGTGGCGCTTAGGACAGAA,7,1294397
furpa,8.0,7,0,GCTGGCCAACTCATTAGAGA,7,1312555
furpa,8.0,7,0,CGTGCGGCGCGTGGCAGCGT,7,1328171
furpa,8.0,7,0,CGCTCGCGGATCACACGGCC,7,1354252
furpa,8.0,7,0,CATCACGCGCCCCGTCTTTT,7,1347724
furpa,7.0,6,0,TGGGGCTCTTTTCATCAGGA,6,1323007
furpa,7.0,6,0,TGCCTGCGGGCATCTGAGGG,6,1322340
furpa,7.0,6,0,GTTTCGCGGAAGATCCCTTA,6,1329290
furpa,7.0,6,0,GACTTGGACGTTTGGACGAG,6,1341489
furpa,7.0,6,0,CTAAAGGAAGGGGGCTCCCT,6,1307045
furpa,7.0,6,0,CGTTCCTGTACGCCATTGAA,6,1320635
furpa,7.0,6,0,CCTATGGCTCGGAGTACTTA,6,1271684
furpa,7.0,6,0,CCTAGTTGCGCACGGTACTT,6,1277942
furpa,7.0,6,0,ATTAAGTAAATCTCTTAGAT,6,1318911
furpa,7.0,6,0,ATCTACGTGTCCGCGGGTCG,6,1279304
furpa,7.0,6,0,AGTCGGTATCATGAACTCAA,6,1288213
furpa,7.0,6,0,ACCAGTTAAACCAACACTTG,6,1315717
furpa,7.0,6,0,ACAACGAGAGCCATGAATTT,6,1338061
furpa,7.0,6,0,AATTGTCGAACAGGGACACA,6,1281663
furpa,7.0,6,0,AATCATTCGAAATCCCGAAG,6,1323643
furpa,7.0,6,0,AACGCCATCGTCTCTCAAAA,6,1288919
furpa,6.0,5,0,TTGGCAATCGACCCCCACCG,5,1307005
furpa,6.0,5,0,TTACCATGCGCAATGTCTCA,5,1345718
furpa,6.0,5,0,TATTATGATCTTGAGAATAA,5,1335983
furpa,6.0,5,0,GTAAGATACCCAGTTCAGCG,5,1296417
furpa,6.0,5,0,GCTTCATTGAAGGGGTCCTT,5,1272800
furpa,6.0,5,0,GATGTTTAGATTCACATCAA,5,1328240
furpa,6.0,5,0,CGCTATACTTATACAGAGCA,5,1306892
furpa,6.0,5,0,CCGTGACTCCCAGAGTATAC,5,1352505
furpa,6.0,5,0,CAAGAGTAGTGCGCAGCCTA,5,1305749
furpa,6.0,5,0,ACGCGCCCGACTGGTATAAT,5,1336085
furpa,6.0,5,0,ACACCGAAGTCGCGGGGTCT,5,1310010
furpa,6.0,5,0,AAGCACACACCACGTTAAGG,5,1283616
furpa,6.0,5,0,AACGCCTATAGAGTACATGA,5,1339616
furpa,6.0,5,0,AACATAATTCACGTGTTCCG,5,1297854
furpa,5.0,4,0,TTGGCAGCTTCTGAGACCGG,4,1350262
furpa,5.0,4,0,TGGCGGCATCCACATCCAAG,4,1339864
furpa,5.0,4,0,TCTTCCTGTTTGATTGTCTC,4,1282759
furpa,5.0,4,0,TCTCGCAGCTTCCTTCTTCC,4,1289509
furpa,5.0,4,0,TCATATCAAGGGTGTAAGGC,4,1308602
furpa,5.0,4,0,TCAAGTTCCCATCAGAGTCT,4,1282033
furpa,5.0,4,0,TAAGCCTATTTGTGGATATA,4,1326326
furpa,5.0,4,0,GTGTCTTTAAACGTGGAAAA,4,1281103
furpa,5.0,4,0,GTCGCCACATCTGACCTCAT,4,1339993
furpa,5.0,4,0,GGTTTCTATATGTCATGTAA,4,1275580
furpa,5.0,4,0,GCGGCGATTCTAACGAAGAA,4,1297706
furpa,5.0,4,0,GACAGTGTAATCCACTGAAC,4,1324769
furpa,5.0,4,0,GAAATTTGTGGCCAGATTGT,4,1275940
furpa,5.0,4,0,CTGTTCGGGCATTCAAAACT,4,1300337
furpa,5.0,4,0,CTCCCGGTGCTTCCCTATCT,4,1284992
furpa,5.0,4,0,CTCACTCCTTTTGCGGCTGT,4,1327924
furpa,5.0,4,0,ACTAGATTGAAGTTGGCCTT,4,1345383
furpa,5.0,4,0,AAACCGCCAACATAGAATAT,4,1279455
furpa,4.0,3,0,TTGTGTGAGAACTGTGCGCA,3,1307253
furpa,4.0,3,0,TTGGACGCGGTAGAACAGAT,3,1330209
furpa,4.0,3,0,TGCATGCGGGGTTGGCCATA,3,1354626
furpa,4.0,3,0,TGACATAGGTCAATATTCGG,3,1278233
furpa,4.0,3,0,TCTGTACCTTGTCCATATTA,3,1293863
furpa,4.0,3,0,TAATTATCTTGTGGTCGTAG,3,1318000
furpa,4.0,3,0,GTCTTCGTTAATGCGAGTGG,3,1330919
furpa,4.0,3,0,GGCTAATTCGCGGTTACTAG,3,1344386
furpa,4.0,3,0,GGCGCTGAGACGGTCGTCGC,3,1323731
furpa,4.0,3,0,GGAAAGTACCTGTCTGTATC,3,1340385
furpa,4.0,3,0,GCGGTCACCCTCCGGCTGTT,3,1288398
furpa,4.0,3,0,CTCTGATACGGGTTGCGATT,3,1279047
furpa,4.0,3,0,CTATTGTAAATAGCAGGGTT,3,1330409
furpa,4.0,3,0,CTAGATTCTTTAGTTTCGTC,3,1295543
furpa,4.0,3,0,CGGGCTAAGAGGCATGTCCT,3,1296548
furpa,4.0,3,0,CCCATTTGAAGCTCCCCTCT,3,1351839
furpa,4.0,3,0,CATTGCAAAGGTTACGTACG,3,1287641
furpa,4.0,3,0,CAGGATCTTAGGACTTTAGC,3,1327389
furpa,4.0,3,0,CACAGTCAACTGCTTTTAGT,3,1306489
furpa,4.0,3,0,CAAACTCTTCCTACGCCGAC,3,1325776
furpa,4.0,3,0,CAAACCTAATCACATACCAT,3,1305310
furpa,4.0,3,0,ATTGTCAGATGATCTAGAGG,3,1280676
furpa,4.0,3,0,ATTGACCATACTACCCCCCT,3,1309884
furpa,4.0,3,0,ATCTCAGTCTGCCTTCAACA,3,1297405
furpa,4.0,3,0,AGAATGTGTATTACCTCCCT,3,1333889
furpa,4.0,3,0,ACCGTGTTGTCGCTCCATTA,3,1337564
furpa,4.0,3,0,AACTAAAAGCGTCCAAATGT,3,1349266
furpa,4.0,3,0,AAACTTTGTCTGGCAACTTA,3,1298151
furpa,3.0,2,0,TTCACTAAACAAAGTCGCTC,2,1342550
furpa,3.0,2,0,TGGTACGCCGATTGGGTAGG,2,1291878
furpa,3.0,2,0,TGGACAATACATTTTCTGGA,2,1352123
furpa,3.0,2,0,TCATCCAGGTCAATTTAGAA,2,1335104
furpa,3.0,2,0,TATACGGAGCTGCAGCTATC,2,1339709
furpa,3.0,2,0,TAAGTATTTTGTTTGGTAAA,2,1337066
furpa,3.0,2,0,TAAGAATATGGTGAACCCCT,2,1308607
furpa,3.0,2,0,GTGAAAAACTCGACATTGAC,2,1329603
furpa,3.0,2,0,GTCAACCCCCCCCTTAACGG,2,1274176
furpa,3.0,2,0,GTATCGCAAGGTCGGGGGTT,2,1279742
furpa,3.0,2,0,GTATCCAAGCGTCACCTCCC,2,1289608
furpa,3.0,2,0,GGACATAATGGTTTAACAAA,2,1312727
furpa,3.0,2,0,GGAATAGTGCGGTTGCGAAT,2,1305643
furpa,3.0,2,0,GCCTTCCTTTTTACCTCAGA,2,1316536
furpa,3.0,2,0,GATGACGCACGCTTTGGGCT,2,1288804
furpa,3.0,2,0,GAAACTCCGGCCGGACGTTC,2,1351256
furpa,3.0,2,0,CTGCAGTCTACAGTCCGGTA,2,1316088
furpa,3.0,2,0,CTAGCGTATCTCGGCGGTCG,2,1320334
furpa,3.0,2,0,CTAAGCTTTCTAGGAATAGG,2,1336956
furpa,3.0,2,0,CGACATTGGTAACGCGACAC,2,1312163
furpa,3.0,2,0,CCGACTGTGGCAGGGAGAAA,2,1332368
furpa,3.0,2,0,CCCTCAATAGCGCGCAGGTC,2,1319606
furpa,3.0,2,0,CCAACCCTGGGTCCAGAAAT,2,1289180
furpa,3.0,2,0,CATCGTTACAAAGGGTCAAA,2,1304791
furpa,3.0,2,0,ATGTCATATCGTTCTTACCC,2,1317457
furpa,3.0,2,0,ATCGCATCGACGCGGACTAA,2,1274086
furpa,3.0,2,0,AGCTCGAAGGTATATCCGAG,2,1334320
furpa,3.0,2,0,ACGGAGCGTACTCCCAAGAT,2,1331031
furpa,3.0,2,0,AATGGCCCCCCCTCAAAGGA,2,1298203
furpa,3.0,2,0,AACTGTCCATTTGTTAGTTC,2,1353062
furpa,3.0,2,0,AAAACCCATGTCCCGTCGGC,2,1320046
furpa,2.0,1,0,TTTACAGATTTCTTTTAGGC,1,1309942
furpa,2.0,1,0,TTGGGAATCTCTCCTCTCTT,1,1289181
furpa,2.0,1,0,TTGATGTAGGGGCTCAAAGC,1,1298876
furpa,2.0,1,0,TTCATTGCGGCTGAAGGCGC,1,1340060
furpa,2.0,1,0,TTAGTCATAGCTAAGTGCTC,1,1302497
furpa,2.0,1,0,TGTTGTGTGCTAGCAGTCTT,1,1273142
furpa,2.0,1,0,TGCTAGCATTATCAGTCGTG,1,1312432
furpa,2.0,1,0,TGCGTAATGGCTAGTAGTGG,1,1293865
furpa,2.0,1,0,TGATTTGCAATCCTCCCTGG,1,1292937
furpa,2.0,1,0,TGATATCTCCGTTACGAACT,1,1353225
furpa,2.0,1,0,TGACATGTTTGAGCAATACT,1,1280590
furpa,2.0,1,0,TCTACACAGGTTAAACCCCC,1,1274248
furpa,2.0,1,0,TCTAAGCCCTGTACGTGGGA,1,1338332
furpa,2.0,1,0,TCGATGTTTGCTCAAAAGTG,1,1327730
furpa,2.0,1,0,TCCTTAATTGAGGCAACCTC,1,1349670
furpa,2.0,1,0,TCCGTTTACTGGAACTCAAC,1,1341251
furpa,2.0,1,0,TATGCGGTAGAGATGATCGT,1,1348108
furpa,2.0,1,0,TATACACTGCGCAATCGCAG,1,1277228
furpa,2.0,1,0,TAGCAAAAGTACTCTTTCGC,1,1356798
furpa,2.0,1,0,TACGAGCACTCGTGCCGGCG,1,1299314
furpa,2.0,1,0,TACGAACGGGGCGGCTAAAG,1,1350160
furpa,2.0,1,0,TACCATCTCGACGGAGTGTG,1,1351110
furpa,2.0,1,0,TAATGGTGGGAGAAGGGTTT,1,1279367
furpa,2.0,1,0,TAATCGCTCTCAATGATGGT,1,1305041
furpa,2.0,1,0,TAAGGAATCGATGTCATAGA,1,1341290
furpa,2.0,1,0,TAAATCTACAACCGCGTTGA,1,1304390
furpa,2.0,1,0,GTTCGCAAGGAAACTCGGTG,1,1305893
furpa,2.0,1,0,GTCTGCATCTTCACATTAAG,1,1343849
furpa,2.0,1,0,GTATAGGGTCCCCCGACAAA,1,1291277
furpa,2.0,1,0,GGTCGTTTAGGTCGTTTTCG,1,1302460
furpa,2.0,1,0,GGGTATATTCAACGAAACAC,1,1288501
furpa,2.0,1,0,GGGCGGAGACAGCGAGGGAG,1,1344246
furpa,2.0,1,0,GGATTAACCGATGGTTTGCA,1,1312673
furpa,2.0,1,0,GCTGTTCTGGGGGCCAACAT,1,1325904
furpa,2.0,1,0,GCGGTCGCGCCTCCTCGCGA,1,1342716
furpa,2.0,1,0,GCGGCGCTCATAGTCGTGTA,1,1319057
furpa,2.0,1,0,GCGATAGGGCAAAAAATATA,1,1310815
furpa,2.0,1,0,GCCATCAATCCTTCCAGTCT,1,1284417
furpa,2.0,1,0,GCAGGATTACAACGTAACTT,1,1289486
furpa,2.0,1,0,GATTAGACTGCAGTGATGTC,1,1284904
furpa,2.0,1,0,GATCAGCAAATGCTGTCTTT,1,1328269
furpa,2.0,1,0,GACGTGAAATACCTCAGTTT,1,1314774
furpa,2.0,1,0,GACGTCTCTCCTCCTAGTTA,1,1345959
furpa,2.0,1,0,GAAATCGTTCAAGGGTGGAG,1,1315574
furpa,2.0,1,0,CTGATTCGGCTGTGGGAAAT,1,1323590
furpa,2.0,1,0,CTCTGCAATACCGAGACGCT,1,1281124
furpa,2.0,1,0,CTCTCTTGAGCTAGACGTCG,1,1297373
furpa,2.0,1,0,CTACGCTGAGCAGTATAGGA,1,1279317
furpa,2.0,1,0,CGTCGTCGCGATCACGGCCG,1,1289610
furpa,2.0,1,0,CGTCGGTAACAGCCGCATTT,1,1333425
furpa,2.0,1,0,CGCGGCGTGGGACCCGATTT,1,1318839
furpa,2.0,1,0,CCTGTTTCTCCTTCCGACGA,1,1280683
furpa,2.0,1,0,CCGGCATGCGAAATGATAGT,1,1293228
furpa,2.0,1,0,CCGCTGTGGTCTGTTTTGTC,1,1347592
furpa,2.0,1,0,CATTTCGCGAGCCAACAGGC,1,1281653
furpa,2.0,1,0,CAGACCTCAACGGCTCCCCA,1,1284488
furpa,2.0,1,0,CACGCATGGCATTTAACGAG,1,1296805
furpa,2.0,1,0,CACATTTCTTGATCCCGGAA,1,1318389
furpa,2.0,1,0,CACAGACCGTATATGGAGGC,1,1330396
furpa,2.0,1,0,CAAGTCTCTCTCATGCTCAT,1,1326717
furpa,2.0,1,0,ATTGCGCCCTATTTTTGATT,1,1320990
furpa,2.0,1,0,ATTGATCCGAAAACAGCTTA,1,1295069
furpa,2.0,1,0,ATTGATAGGGGGTTTTTCTC,1,1307752
furpa,2.0,1,0,ATTAAGGTTACGGTTCTATA,1,1283952
furpa,2.0,1,0,ATGGCTGTGTGTGGGTTTTT,1,1329355
furpa,2.0,1,0,ATGCTTACACTACCTAGAAT,1,1317837
furpa,2.0,1,0,ATGCAGGGCTGCAGTATAGC,1,1320679
furpa,2.0,1,0,ATCTATCGTATACAGCCCTG,1,1313260
furpa,2.0,1,0,ATCACAGGAACTTTTAAGAC,1,1319173
furpa,2.0,1,0,AGTTGACGACGTTGGAACTT,1,1283307
furpa,2.0,1,0,AGTTGACCGCAACCAAGTCA,1,1312783
furpa,2.0,1,0,AGTTCGTGCACGTCACGGGC,1,1280913
furpa,2.0,1,0,AGTTCGGGGTACGCTTCTAT,1,1332339
furpa,2.0,1,0,AGGCGGCATTGAGTTTTCTC,1,1295782
furpa,2.0,1,0,AGGATACCTTGGGCGCCGAT,1,1307869
furpa,2.0,1,0,AGATTCCTAAGGGAACTTTA,1,1345196
furpa,2.0,1,0,AGATTCATTTATCGCGAAAA,1,1319592
furpa,2.0,1,0,ACTCGCCATAACGTAGTGTT,1,1311441
furpa,2.0,1,0,ACGTGGTTGACAGCCTCATC,1,1345012
furpa,2.0,1,0,ACGAGAAGGAGGCTACTGAC,1,1341048
furpa,2.0,1,0,AATTGTAACTTTTTAGAGGA,1,1275952
furpa,2.0,1,0,AACTCTAGATTAGAGGCACG,1,1273282
furpa,2.0,1,0,AACGTCTTATCAACATTAAG,1,1340906
furpa,2.0,1,0,AACGCCCCTCAAACAAACGG,1,1307504
furpa,2.0,1,0,AAAATTGTATTTATCGAGTA,1,1324619
