name,relative_counts,ct,ct_0,barcode,ct_1,barcode_ind
acrZp,137.30154142581887,143555,1037,TATGCCGACCATACCAAGCT,142518,410267
acrZp,3.0,162,40,GCCACGAACAGATTGTAAAG,122,409309
acrZp,17.928571428571427,263,13,GGTGACTCCCCAAATGTCTA,250,410692
acrZp,12.357142857142858,185,13,CCCCTAGCATTCCATACAAA,172,409396
acrZp,15.076923076923077,207,12,GTTTAATCTATCATTGGGCT,195,466128
acrZp,22.0,297,12,GGTTCCGTACCCGTTACGTT,285,416031
acrZp,9.692307692307692,137,12,CTGCCTACGAACTTAGGATT,125,437844
acrZp,10.615384615384615,149,12,CCTGGAGCATATAAGCTAAA,137,429526
acrZp,0.16666666666666666,12,11,TATCCGCCGTCTGGAACCTT,1,425356
acrZp,12.166666666666666,156,11,GTCCTAAGGTTACTCACAGG,145,449483
acrZp,0.16666666666666666,12,11,GTCCGAAGATTAATTCCAGT,1,413765
acrZp,150.83333333333334,1820,11,GGTTCGCGTGAAAGGCCGGA,1809,419665
acrZp,30.583333333333332,377,11,GAACTGGTTTTCGTGAATAT,366,441986
acrZp,0.16666666666666666,12,11,CTTTCACATGTCGATTCACA,1,408956
acrZp,5.833333333333333,80,11,CCGATTTCACTGTAGCGTTA,69,441625
acrZp,3.5833333333333335,53,11,AGTGGGGGTCTGCACGAGTA,42,413060
acrZp,0.18181818181818182,11,10,TCCACGACCTGCTTATGGGT,1,459421
acrZp,5.0,64,10,TACATACTTACTCTTACGAG,54,431628
acrZp,15.636363636363637,181,10,GTGTACAGACTCGAATAGCG,171,408796
acrZp,23.818181818181817,271,10,GATGAACGTGGTCTCCGGTG,261,450567
acrZp,0.36363636363636365,13,10,CCATTGCCGTATCACAGGGT,3,420916
acrZp,36.81818181818182,414,10,CCAAGTTGAAAAGGCACAAT,404,409048
acrZp,21.727272727272727,248,10,CAGTAATAACTGTGGGGTAT,238,409079
acrZp,0.18181818181818182,11,10,ATATACCAGGCCGGGCGAAC,1,439162
acrZp,0.18181818181818182,11,10,ACAATCCGTAATTGCGAGAT,1,448807
acrZp,6.5,73,9,TACTTGACGAGCGATGTAGT,64,438923
acrZp,15.8,166,9,GCAGAGGGGAATCTAGATTG,157,465420
acrZp,12.4,132,9,GATAGGACAACACAGTTCAA,123,424591
acrZp,6.6,74,9,CCTTAAATCTCAATCCGTGC,65,426228
acrZp,10.9,117,9,CCCGTTCGAGTGGTCTAGAT,108,410312
acrZp,16.3,171,9,AGCGAAGAGGCTGTAGCCAT,162,450877
acrZp,0.3,11,9,AGCCTTAGAAGGTGAAGTAT,2,411958
acrZp,0.2,10,9,ACGAGCAGCTAGGGTGCCCG,1,430208
acrZp,15.777777777777779,149,8,TGTAATGCTGGGATCGAAAG,141,443670
acrZp,0.2222222222222222,9,8,TCTCCTAAAGAACTTCATAG,1,450570
acrZp,14.0,133,8,TCGTACTGTACCGCAGTGAC,125,434251
acrZp,17.88888888888889,168,8,TATGTGTCTTGAGCACTCCA,160,422584
acrZp,10.666666666666666,103,8,TATGTGTAGAGATGAGTAGT,95,443413
acrZp,0.2222222222222222,9,8,GGGCGTGGATGAGTTCTCCC,1,419744
acrZp,0.2222222222222222,9,8,GATAGCACGGTCGAACTGTG,1,413293
acrZp,10.777777777777779,104,8,CTTTGACGCATCAGAGGCGG,96,412064
acrZp,0.2222222222222222,9,8,CGGTAGCTTGGGGGTCGGAT,1,419915
acrZp,17.88888888888889,168,8,CGACAACAGTTAGGTCTCGC,160,413496
acrZp,10.777777777777779,104,8,CATTTACTCTAACCTATCGA,96,453744
acrZp,18.11111111111111,170,8,CAGTGTCAGCTTAAATCTAG,162,410655
acrZp,46.0,421,8,ATGCTCATTCCGCAACTGTT,413,414351
acrZp,13.444444444444445,128,8,ATCGAGGTATCCTGCAGATC,120,464481
acrZp,0.2222222222222222,9,8,AGGGCGTAGCGAGGCTATTG,1,451238
acrZp,9.333333333333334,91,8,AGATGTACAGGAAGGCCGGT,83,435403
acrZp,18.25,152,7,TTGTCAGCTTTTTTTCGAGT,145,427232
acrZp,20.625,171,7,TGCACAATTATGTACCGGAC,164,418333
acrZp,25.75,212,7,TAGCTCCCACAATCTTAGTT,205,410358
acrZp,65.75,532,7,GTATACAGTAATTTTGATCT,525,420448
acrZp,9.5,82,7,GGCGCGATTAGCTGAATCCT,75,458429
acrZp,20.125,167,7,GACTGAGGTTGGTCGGATAG,160,417485
acrZp,37.125,303,7,GACCCTAGAGGATTTGCTTT,296,410336
acrZp,19.75,164,7,GAACAAAGTTATAACGACAA,157,418766
acrZp,29.875,245,7,CGTCTGCCAAGGCGAGAAGC,238,448908
acrZp,15.0,126,7,CGGCCCTGTTGTCCAGGGAC,119,465402
acrZp,30.125,247,7,CGCGTTGCCTATGTCAACAT,240,422708
acrZp,7.125,63,7,CCCCCCATGGGCAGTAATTA,56,464562
acrZp,20.75,172,7,CAGTGTAGACTAGCTCTGCA,165,409833
acrZp,0.25,8,7,CAGCATGGCCGAATTTTTAC,1,417243
acrZp,20.375,169,7,ATTAAGACCTCACCGAGCCT,162,420229
acrZp,6.875,61,7,ACTCAACCGGCGTATAGGAG,54,412113
acrZp,103.375,833,7,ACGGGGGACGACGAGCGGTC,826,436244
acrZp,6.75,60,7,ACCTTAAAATCGGATTCCAC,53,446756
acrZp,18.571428571428573,135,6,TTTTGATAGAGCTCTACGTC,129,450851
acrZp,0.42857142857142855,8,6,TTTGTAACCACGCTTGTGTC,2,452179
acrZp,0.2857142857142857,7,6,TTGGTTAACTATAAACTACG,1,431950
acrZp,9.285714285714286,70,6,TTGATGAGTAGCATTGACGA,64,437527
acrZp,0.2857142857142857,7,6,TGGACTGCTTCGGACACATC,1,449998
acrZp,5.142857142857143,41,6,TCTACCAGGACTACGACAAG,35,415861
acrZp,10.857142857142858,81,6,TCCAGCAAGTTGAGCCCACC,75,437510
acrZp,1.2857142857142858,14,6,TCATGTCGCACACTTCACAG,8,434190
acrZp,68.28571428571429,483,6,GTTCTGTACATGGGTACGAA,477,426678
acrZp,49.0,348,6,GTCATAGTCCGATGGTCTGA,342,447230
acrZp,43.714285714285715,311,6,GGTTCATAGCGGCAAATCAC,305,420329
acrZp,7.857142857142857,60,6,GGGCATGTTTTGCAAATAGT,54,426227
acrZp,0.2857142857142857,7,6,GGATGCGTACGAAGGAATCC,1,460740
acrZp,7.142857142857143,55,6,GCTGAATGGACCCCTACTAG,49,410505
acrZp,30.428571428571427,218,6,GCCATCGAGTCATACCAGGC,212,442869
acrZp,18.857142857142858,137,6,GCAACCTTTATCTTCCTTTT,131,417733
acrZp,0.2857142857142857,7,6,GATCCGCTTAATCATGGTGC,1,442581
acrZp,18.857142857142858,137,6,GAGATCGCTATATTGGCCGC,131,416414
acrZp,58.0,411,6,CTCTTGCGGAACTCAATTCC,405,447190
acrZp,19.571428571428573,142,6,CTAGATTTGGACAAATATCA,136,432635
acrZp,17.142857142857142,125,6,CTACCCCAGTCACTTCGTCA,119,409165
acrZp,33.0,236,6,CGCGATCAAACTTGGACGAT,230,422417
acrZp,35.57142857142857,254,6,CGAGCGCGATATTCTTTAAT,248,420869
acrZp,3.7142857142857144,31,6,CCGTGGATTGCTATACGGCC,25,455098
acrZp,15.285714285714286,112,6,CCCTACTATCGGCCTTCGAC,106,415243
acrZp,17.571428571428573,128,6,CCCGCACTAGGGAGTCCCAC,122,410612
acrZp,0.2857142857142857,7,6,CATGTTTTGGCCGCGAAGTT,1,439383
acrZp,9.714285714285714,73,6,CAGGCTCTATGCAGCAAATT,67,425591
acrZp,18.0,131,6,CACAGATCGTCTTGACCTAA,125,445635
acrZp,12.571428571428571,93,6,CAAGTTTAGCAACTGGAGTA,87,449272
acrZp,21.0,152,6,ATTAAACCGGGAGTTGTAAT,146,429831
acrZp,14.285714285714286,105,6,ATCTTTAAGAGTGTTTCTCA,99,447295
acrZp,37.857142857142854,270,6,ATAGAGTACGAATCAGCCGT,264,429065
acrZp,21.0,152,6,AGCGTGGAAGCGTCCCATGC,146,443938
acrZp,16.285714285714285,119,6,AGCCCAGGTCATTGGGAGAA,113,418476
acrZp,34.285714285714285,245,6,AGAAACGAACGCGCCGGATT,239,459937
acrZp,0.2857142857142857,7,6,ACCCGTATGCTCGACGGATC,1,454010
acrZp,0.2857142857142857,7,6,AAGCACATCCTTCCAAGGTT,1,427841
acrZp,28.666666666666668,176,5,TTCCGGAGCGTACTGGGCGG,171,465459
acrZp,22.666666666666668,140,5,TTCATGGCCGAATGAGCCTC,135,441651
acrZp,27.666666666666668,170,5,TTACTAGATTGACACTTCGA,165,454721
acrZp,33.666666666666664,206,5,TTAACTTCTTTACTATGTAG,201,416661
acrZp,0.3333333333333333,6,5,TGTTAAACCAGACCCGGGTG,1,450685
acrZp,25.666666666666668,158,5,TGGTTCCTGGCGTCCATAAA,153,419222
acrZp,0.5,7,5,TGGCTTGACAGCTCGGACTA,2,414814
acrZp,0.3333333333333333,6,5,TGCGATAATGGAACATCCTC,1,424898
acrZp,0.3333333333333333,6,5,TGCCTCAGCGAGATGAATAC,1,451400
acrZp,60.333333333333336,366,5,TGCCAAGATCGGTATAGAGT,361,443614
acrZp,15.333333333333334,96,5,TGATATCCTCCATAGGTGTT,91,444084
acrZp,8.666666666666666,56,5,TCTTTTATGGCCGTATGTCT,51,430727
acrZp,22.166666666666668,137,5,TCGAGGGATCCGCGTCAACC,132,418802
acrZp,27.5,169,5,TCCCTGGCGACAGACTACGT,164,423127
acrZp,12.333333333333334,78,5,TATACTTGAAGACCGGCGAC,73,444674
acrZp,3.8333333333333335,27,5,TAGCCCATGGCTGACCGGAT,22,450912
acrZp,0.6666666666666666,8,5,TACTGTATAGTGGTAATACG,3,459051
acrZp,20.166666666666668,125,5,TACTATGAGTTATCTGACTT,120,409551
acrZp,0.3333333333333333,6,5,TAAGCGAGTTTAGTAACCAA,1,425438
acrZp,6.333333333333333,42,5,GTTGACATCAGTAGGGAGCT,37,417799
acrZp,0.5,7,5,GTGTCGGATAGAACACTCCC,2,432924
acrZp,0.3333333333333333,6,5,GTGATCTCGGTGGTATCATC,1,436634
acrZp,0.3333333333333333,6,5,GTGAATACACCATCATTAAA,1,426983
acrZp,14.833333333333334,93,5,GGGGAACTAGAGAGAGGGCT,88,412693
acrZp,0.3333333333333333,6,5,GGCCGTTGGCGAGTTATGCA,1,433241
acrZp,13.833333333333334,87,5,GCTTTCTCGTGTCTAAGATT,82,428320
acrZp,0.3333333333333333,6,5,GCTGACGCGAGGGCCGTGCA,1,411492
acrZp,44.666666666666664,272,5,GCGCGCTTCGGGCCGAGGCA,267,423318
acrZp,29.833333333333332,183,5,GCAAGTTAGGTCAGAGCGAT,178,424582
acrZp,34.333333333333336,210,5,GATCCACTTTGGTGTCGGAT,205,410225
acrZp,0.3333333333333333,6,5,GATAGTTCGGCCACTTTCCA,1,416863
acrZp,18.166666666666668,113,5,GACCTAGGTCTCTTAGCTCC,108,424128
acrZp,23.833333333333332,147,5,GAATTTTCCCCCTTCACAAT,142,419316
acrZp,18.833333333333332,117,5,CTTGCTCTGATGGGAACGAT,112,464712
acrZp,29.0,178,5,CTTAGTCTTATTGCATTATT,173,448844
acrZp,22.833333333333332,141,5,CTAAGGGTGCGTCACAGATC,136,414291
acrZp,20.166666666666668,125,5,CGCAAGGGGTAGCATCCAGA,120,447435
acrZp,27.5,169,5,CGAGATAGAGCATGTGCAGT,164,409639
acrZp,21.166666666666668,131,5,CGAACGTCGGAACGTCGGTA,126,409754
acrZp,21.5,133,5,CCTGTAGACAATACATCGTG,128,439436
acrZp,27.0,166,5,CCGACAGACGTATGCACATT,161,441291
acrZp,0.3333333333333333,6,5,CCCGAAAGTCTGGGCATGAT,1,437215
acrZp,42.166666666666664,257,5,CCCCAGAGTAAGAAGGTACA,252,460972
acrZp,14.666666666666666,92,5,CATGGGAACCATTTCATTTA,87,415170
acrZp,0.3333333333333333,6,5,CAGTGACAGTGGTTCTTGTC,1,411572
acrZp,21.333333333333332,132,5,CAGCAAACAGGTATTGCGAG,127,465811
acrZp,11.833333333333334,75,5,CACATAGTCAGGTTAGACTA,70,462875
acrZp,0.3333333333333333,6,5,ATGAAGGTACTAGGAGGTTG,1,447467
acrZp,20.833333333333332,129,5,ATCCAATGTTGGGGTCTGGG,124,441070
acrZp,0.3333333333333333,6,5,ATAAGGGTATGGTGCGACGA,1,446558
acrZp,0.3333333333333333,6,5,AGTGGGATCAACAGACTTGT,1,437743
acrZp,125.33333333333333,756,5,AGTACCAAAATAAGAAGACT,751,427839
acrZp,6.833333333333333,45,5,AGGGAGCCACCCGGGCCTAA,40,422108
acrZp,0.3333333333333333,6,5,AGGCCGATTCGGCTGGTTCA,1,418762
acrZp,22.333333333333332,138,5,AGCGAGAGATATTCGAGTCA,133,414357
acrZp,0.3333333333333333,6,5,ACGGTCCCAGGTGAGCTTGC,1,458372
acrZp,22.833333333333332,141,5,ACGCTGTTTTTGAAAATATA,136,424119
acrZp,20.333333333333332,126,5,ACAACGAACCTGTCGTCGCA,121,426232
acrZp,2.6666666666666665,20,5,AATGGGTCAGCGTTTCCTGT,15,436095
acrZp,46.5,283,5,AATGCGGAAGAACTAAGTTA,278,433414
acrZp,45.333333333333336,276,5,AAGGGGATATTACGCGCAGT,271,409071
acrZp,12.0,76,5,AAGGGACGAAAATAAGAAAA,71,420005
acrZp,27.833333333333332,171,5,AAGCTCGTGCCCATTGCTAA,166,421693
acrZp,50.333333333333336,306,5,AAGACGGGTGGCCCCTTAGA,301,411146
acrZp,12.0,63,4,TTTTTAAAGATGCAGTACCG,59,418712
acrZp,26.0,133,4,TTGGCTTAACACAAGCTGAC,129,411223
acrZp,35.0,178,4,TTGCCATGTCGTTACGCAGA,174,459521
acrZp,54.8,277,4,TTAAATTACAGAAAGAACTT,273,459940
acrZp,21.2,109,4,TGTCTACTTAAGCCAAGTGT,105,419898
acrZp,24.8,127,4,TGTACAAAGAGACCCCAGAA,123,412932
acrZp,0.4,5,4,TGGTCCATAGGGCCAATCGA,1,460504
acrZp,39.0,198,4,TGCTCACGCGGCGGTAGCCC,194,415163
acrZp,29.0,148,4,TGCCGTGGCTGTACACAGGA,144,446351
acrZp,3.0,18,4,TCGTGCGCTTTGGGCCGTGT,14,450634
acrZp,30.6,156,4,TCGGGGTATGTATGTTTTTT,152,444613
acrZp,29.8,152,4,TCGATTAAAATGCATACAAT,148,443898
acrZp,0.6,6,4,TCGAGGACCGCTGGACTATT,2,427928
acrZp,30.2,154,4,TCAGCAGCGTGGCTGAGGAT,150,411519
acrZp,0.4,5,4,TCAGATCGGGACAATACTTA,1,452375
acrZp,10.2,54,4,TCAGAAAGGTACTTACGATA,50,448924
acrZp,47.6,241,4,TCACCAGGTATAATCTGGCT,237,409265
acrZp,67.4,340,4,TATCGTGATGCGTCCAGGCT,336,417887
acrZp,26.0,133,4,TATCCTCCCCTGTTTTGAAT,129,465763
acrZp,30.2,154,4,TATCCGACTGCTAACCAGCA,150,443902
acrZp,25.0,128,4,TATCACGTTCCTCTATGAGT,124,426740
acrZp,0.4,5,4,TATCAATGTTGATGACCGGG,1,437561
acrZp,29.0,148,4,TAGTATTAATTGTCATTCCC,144,435507
acrZp,22.0,113,4,TACGGCTGAAGCTTGAATAG,109,437520
acrZp,0.4,5,4,TACGCACGAACCGAGATGAG,1,442969
acrZp,53.8,272,4,TAATGGGTGCATGTAGTCAC,268,446395
acrZp,0.4,5,4,TAAGCATAGTTCACTGGACC,1,423371
acrZp,53.8,272,4,GTGTGAGTATGCAGGGCTAC,268,455880
acrZp,0.4,5,4,GTGTATTGCAATCGTGATCA,1,451358
acrZp,46.8,237,4,GTCCCTAGGCCTACGTAATT,233,417835
acrZp,26.8,137,4,GTAGGGGCTTCGCACGAGTT,133,454936
acrZp,26.2,134,4,GGTCACAATAATGATAAGGA,130,427149
acrZp,17.8,92,4,GGGGGATCGGTATGGAAACG,88,435904
acrZp,32.4,165,4,GGCTACCGGTAGGGTACCAT,161,416673
acrZp,0.4,5,4,GGCGCTGTTCGAACCGCGCA,1,423616
acrZp,3.4,20,4,GGCAGTGACTAAGGCGTAGT,16,461624
acrZp,25.8,132,4,GGAGTGATAGTATGCTCGTA,128,414316
acrZp,22.2,114,4,GGACTCAAAGCTGCAAGTTA,110,441134
acrZp,24.0,123,4,GGACATTCGGGCATCAAGCT,119,422712
acrZp,112.0,563,4,GCTTGGGCTGACGCCGCGCA,559,419322
acrZp,0.4,5,4,GCTGACACTTATGTGCCGAA,1,441216
acrZp,24.2,124,4,GCTAATATTTCCTTTACATA,120,440485
acrZp,0.4,5,4,GCGCCTCGAGCTTGTATCAG,1,430960
acrZp,1.0,8,4,GCGATTGGTACTCGATGTCG,4,441248
acrZp,106.4,535,4,GCCCGCCGACGTGTCTTGGA,531,434233
acrZp,0.4,5,4,GATTGGGGTAGGGTGACTGA,1,414773
acrZp,27.0,138,4,GAAGGAACGGTCTTCACCAG,134,446446
acrZp,25.0,128,4,CTTGGAATTTAGAGGCCTTT,124,460773
acrZp,0.4,5,4,CTCACGTTTAAACTCGGACG,1,429966
acrZp,22.0,113,4,CTATGTGGCTTAGCAGATTC,109,419499
acrZp,0.4,5,4,CGTTGGTCTGGGATTACCAT,1,464986
acrZp,0.4,5,4,CGTGGTCTGTTGCCCGTCCG,1,420222
acrZp,0.4,5,4,CGTACGTGATCTGTCCGTAG,1,440743
acrZp,0.4,5,4,CGGTGTGACGTTTTCACGTA,1,465516
acrZp,0.4,5,4,CGGTCAATGTATACGTTGTA,1,425268
acrZp,53.4,270,4,CGGGTCGGCCAGCCAGGGCG,266,461866
acrZp,30.2,154,4,CGGCCCGTGATCAGATCTGA,150,418632
acrZp,0.4,5,4,CGCTCCGGCCCATGGTCACT,1,433670
acrZp,54.8,277,4,CCATTCGTAGCTCTAGTCTA,273,459000
acrZp,0.8,7,4,CATTTGTAACCGGGGTCCCT,3,427926
acrZp,4.0,23,4,CAGGTTGGCATTAAGCTGCG,19,449949
acrZp,0.4,5,4,CAGCGAGTCTGCCGGATGTT,1,413459
acrZp,33.8,172,4,CACCGAGTCTTCTACCCATA,168,423581
acrZp,58.8,297,4,CAATGCGGATTTATGTTCTG,293,432185
acrZp,54.2,274,4,ATTTTTGTAGCCTGTGATCT,270,461377
acrZp,0.4,5,4,ATTTTCTGATAAATTTCATA,1,452482
acrZp,41.2,209,4,ATTTCCAATAGCACACGATC,205,421579
acrZp,30.8,157,4,ATTGTCGATCATTGTTCGTG,153,440798
acrZp,86.4,435,4,ATTCCGGCAAGGTGCCGCCC,431,410882
acrZp,13.0,68,4,ATCCTAAGAAGATGGTCACC,64,430165
acrZp,19.6,101,4,ATAATGCGTAGATTAAAAGC,97,420508
acrZp,48.0,243,4,ATAACTTTCTCACGTGCTGG,239,421914
acrZp,0.4,5,4,AGGGGTTCTCGAAAATCAAT,1,425098
acrZp,0.4,5,4,AGGGCCTTGAAGAACAGTGT,1,466462
acrZp,1.0,8,4,AGGAGGAAATAACGACCTGA,4,430976
acrZp,20.2,104,4,AGGACCTTTCCCGGTTAAGC,100,447598
acrZp,22.0,113,4,AGAGGAATCGGACCTCGCGA,109,410330
acrZp,0.4,5,4,ACGTTTATCGTTCCCGTTCA,1,442223
acrZp,57.2,289,4,ACGTTCATCTACAGCGGAGC,285,416202
acrZp,24.8,127,4,ACGGTGGGCGTCGTAAGGGT,123,462546
acrZp,107.0,538,4,ACGCCACCAAGAGCCACGAT,534,423683
acrZp,18.6,96,4,ACAATCTAGCGCGTTGACAG,92,425652
acrZp,27.4,140,4,AATGGTTGGCCTTTGAATTA,136,423555
acrZp,100.2,504,4,AATATAGAGTGAGACTCGGA,500,409434
acrZp,15.8,82,4,AACTTACGGCCTAAAAGTAC,78,466498
acrZp,18.0,93,4,AACGGGTTACTCCGTTAGTT,89,423455
acrZp,30.8,157,4,AACCGGGACAGTCCACACGT,153,465998
acrZp,28.6,146,4,AACCAAGCGGGTCTAGCAGT,142,433834
acrZp,0.5,4,3,TTTGTCGAGTTAAAACTCAG,1,408933
acrZp,30.25,123,3,TTTCCGTACATGTCCCTAGT,120,463887
acrZp,0.5,4,3,TTTAGGTGGCATGTGCCTTC,1,454718
acrZp,42.0,170,3,TTTAGATCGAGGTTAAGCGG,167,429631
acrZp,91.25,367,3,TTTAAAGAACGGTATTTAGG,364,428165
acrZp,52.0,210,3,TTGGAGTTTTGTGGGGTTAT,207,450535
acrZp,0.5,4,3,TTGGACTGGTGTGTGCGGTT,1,411164
acrZp,0.5,4,3,TTGCCATTCCGACTCGACGT,1,420579
acrZp,75.25,303,3,TTCACGCGATAGGACAGGTT,300,425566
acrZp,35.75,145,3,TTCAAGGCATTTGATGATCG,142,409707
acrZp,39.0,158,3,TTATCGGATCGGTGGTCTGT,155,445698
acrZp,0.5,4,3,TTACTATTGGAGTCCAGATT,1,439969
acrZp,35.5,144,3,TTACAGCGACTAGGGAGAGA,141,460101
acrZp,123.25,495,3,TGTAACGTCGCTTTAAGTGC,492,420006
acrZp,60.5,244,3,TGGCCAGGTTACGTAGGGAT,241,464893
acrZp,0.5,4,3,TGAGGAGTGGTTTGGGCTTT,1,432123
acrZp,38.0,154,3,TGAGAGGAAAGGGGATTTAG,151,427686
acrZp,0.5,4,3,TCTTTTATATCGGGAGTTTG,1,420258
acrZp,0.5,4,3,TCTGTCTTGACTCAATATTC,1,466905
acrZp,29.5,120,3,TCTGGTATAGTTTGGTCATA,117,445601
acrZp,0.5,4,3,TCTCAGCATAGAATACCTTG,1,436852
acrZp,0.5,4,3,TCTCAATCGTCAGTTCGGGG,1,458404
acrZp,0.5,4,3,TCGCGACTACATTCCGCGTG,1,457999
acrZp,88.0,354,3,TCGAAGTATACCTGGAAACC,351,436100
acrZp,2.25,11,3,TCCGAAAATTCGCCCGTTCG,8,416166
acrZp,26.5,108,3,TCATGCGCCAAGCCTGTCTC,105,458565
acrZp,35.25,143,3,TCAGTGTTGTTCCCGGGAAA,140,462701
acrZp,20.75,85,3,TCAGTAAGACGAAACGTCGG,82,411084
acrZp,0.5,4,3,TCAACCGCCGGCCGGGGGCT,1,413057
acrZp,0.5,4,3,TATGTGGGGTCTGCAGACAC,1,444622
acrZp,11.75,49,3,TATGATACGGCCTGTGATGA,46,424810
acrZp,31.0,126,3,TACCATACTTGTGCGTTATT,123,415302
acrZp,73.0,294,3,TAATAAGTCGTCTAAAGAGA,291,427840
acrZp,13.0,54,3,TAAAGAAAGCGGGCGGCTTT,51,437662
acrZp,54.0,218,3,GTTGTCCGGTCGAGCGATCC,215,452208
acrZp,0.5,4,3,GTTATTGCGAACCCACCGCA,1,459076
acrZp,171.75,689,3,GTGCGCACTCTGTGCGTAGT,686,413696
acrZp,0.5,4,3,GTGAAGGTGTAGCCTTCGGT,1,460397
acrZp,36.25,147,3,GTCTGGGACGTAGGCACATT,144,428480
acrZp,29.75,121,3,GTCTCAGACATCTTGGTTCC,118,411134
acrZp,55.25,223,3,GTCGCGGCTGCCGAATATTA,220,426557
acrZp,0.75,5,3,GTCCATAAATGTAAGCTTTT,2,426085
acrZp,0.5,4,3,GTAGGTTGCGCTTCTGAAAA,1,421721
acrZp,32.75,133,3,GTACTCCTGTGGTAAGATTC,130,415889
acrZp,0.5,4,3,GTACAAGTCCGCTCTCAAAT,1,416553
acrZp,84.5,340,3,GGTTAGTGTGCATTCGCGCT,337,454472
acrZp,0.5,4,3,GGTATGCTGTCGTCTGCTAT,1,427949
acrZp,41.0,166,3,GGGGGTGACTAGAACGGCGC,163,424971
acrZp,0.5,4,3,GGGGAGCTGTCAACGCCGGA,1,459893
acrZp,36.5,148,3,GGGCGCTGGTAACGTCGTCA,145,418108
acrZp,29.75,121,3,GGCCCACGTGAGCAAGGGAG,118,425394
acrZp,25.75,105,3,GGAGGGTCAGCGTTTCGATG,102,412247
acrZp,26.25,107,3,GCTGGGCACTTCATAGTGTT,104,446431
acrZp,42.25,171,3,GCTCCCCGATCGTTGTACTG,168,427875
acrZp,0.5,4,3,GCTAAACAATAAAACCAAGC,1,455913
acrZp,65.25,263,3,GCGTCAAGGGATTCCCGTTG,260,453820
acrZp,0.5,4,3,GCCGTATTCTCCTGCTGGTC,1,426318
acrZp,39.75,161,3,GCAGGGAGCCCGGCTAGGGG,158,447758
acrZp,34.25,139,3,GCAAATGCCGGCGCAAGCAT,136,439242
acrZp,30.5,124,3,GATCCGGGCTCAGCAATACA,121,457108
acrZp,16.25,67,3,GATACGCCAGTGGGAGTTGA,64,454992
acrZp,30.5,124,3,GAGAGTTGCTTTTCGAGACA,121,467231
acrZp,0.5,4,3,GACTCTGTAGTGTGATACAT,1,421373
acrZp,0.5,4,3,GACATCTACTGAATCTCTAG,1,424255
acrZp,13.25,55,3,GACATCCTGTATTCATTCCT,52,456500
acrZp,39.75,161,3,GAAGCAAGATGACTGAAGCA,158,432767
acrZp,35.25,143,3,GAAAATAGCGGGTAGGAGCT,140,427834
acrZp,18.5,76,3,CTTCATATGCAATACTACAG,73,461831
acrZp,22.75,93,3,CTTAGCTACGAAACTTGAAA,90,445136
acrZp,9.75,41,3,CTTAGAGGTGACGACAGACC,38,461787
acrZp,0.5,4,3,CTGTCGCGTACTTGATAGTT,1,446426
acrZp,24.0,98,3,CTGCGGTTTTTCAGAGAAAA,95,425799
acrZp,0.5,4,3,CTGACCGGAGTTTCCTGAGC,1,417095
acrZp,0.5,4,3,CTCTGGCGGATCAGGGTATT,1,410509
acrZp,40.75,165,3,CTCTGGAAATACGGCTGCGT,162,417158
acrZp,21.75,89,3,CTCTATTCCAATTAGGTGGT,86,435423
acrZp,17.0,70,3,CTCGTAGAGACAGTGGCCAC,67,437555
acrZp,66.75,269,3,CTCCTCTCTATGGCACTTCA,266,436381
acrZp,48.0,194,3,CTCCAGGGTCTAAACGAGTG,191,417629
acrZp,24.0,98,3,CTAGAACCTGAACACTACTC,95,423419
acrZp,25.25,103,3,CGTTAACTTCTGTCGAGATT,100,454907
acrZp,32.75,133,3,CGTGGAAGATTAAACTTTAT,130,423659
acrZp,338.25,1355,3,CGTCGAGGTATTCTAATTTT,1352,416201
acrZp,39.25,159,3,CGTAGATAGTTATCAGAGTA,156,409538
acrZp,75.5,304,3,CGTAAGGAGTGATTATTAAT,301,413977
acrZp,58.75,237,3,CGTAAGCTGACTGTAAGTTC,234,420237
acrZp,0.5,4,3,CGGGAGTTGAGGTAGGAATG,1,416342
acrZp,0.5,4,3,CGGAATACCCAAATATACAA,1,443557
acrZp,33.5,136,3,CGCGCGTCAACGCTCGCATC,133,414951
acrZp,0.5,4,3,CGACTTCGCAGGAAGTCTCT,1,434880
acrZp,24.0,98,3,CGAAATGAGATCGGGTCGGT,95,420879
acrZp,60.25,243,3,CCTCCCCTGTTTAGCCAGGT,240,453252
acrZp,28.0,114,3,CCCTTGTGCCGAGATTTGAT,111,410897
acrZp,0.5,4,3,CCCGGCCCTAACTGATTTAA,1,453742
acrZp,0.75,5,3,CCCACCTCGTTCGCGATGAG,2,454861
acrZp,47.5,192,3,CCATTACCTGTGCATGGTCA,189,442720
acrZp,45.75,185,3,CCATGATATTCGGCGAACAA,182,446005
acrZp,108.75,437,3,CCACGTGATTCTGTTCGAGG,434,454223
acrZp,0.5,4,3,CATTTTAGATCCCGACAAAA,1,411814
acrZp,0.5,4,3,CATGGGCGTAATTGCAGCCA,1,430726
acrZp,40.25,163,3,CATGGCTCAGACCTAATACT,160,431359
acrZp,1.0,6,3,CAGTTATTGCCTGTCATCAG,3,457480
acrZp,0.5,4,3,CAGGTGTGGGGATGTCTCCT,1,420093
acrZp,70.25,283,3,CAGGTCAGCGGTGCGTTCTC,280,419619
acrZp,36.25,147,3,CAGGAAAAAGTACCGGGTAG,144,464494
acrZp,31.75,129,3,CAGCTGTAGGTCTGCCCGGA,126,427118
acrZp,6.25,27,3,CACGGCCAGGGGTCTACGGC,24,446476
acrZp,55.25,223,3,CAAGTTATACGGATCGTCAA,220,419602
acrZp,57.25,231,3,ATGGCTCCTGGGAGTAACAA,228,419879
acrZp,0.5,4,3,ATGACATAATCGACCAAGAC,1,425414
acrZp,36.5,148,3,ATCTAAGCAAAGTTAGGGGA,145,418078
acrZp,66.75,269,3,ATAATAGGCTGCGATAAAAA,266,459297
acrZp,42.5,172,3,AGTAGTCATGAGTAAACACT,169,409953
acrZp,143.0,574,3,AGGTATTTGGCCGTTTAAAA,571,460279
acrZp,20.75,85,3,AGCCTGGAGTGCTCACGCAT,82,458269
acrZp,83.5,336,3,AGCATCACCGGTCGGTCGAT,333,432453
acrZp,37.25,151,3,AGCACACACCCTCGTTCATT,148,420197
acrZp,16.25,67,3,ACTGGTTTCTGCGCGTAATG,64,460305
acrZp,96.5,388,3,ACTGGGAAGGACACTACCTT,385,449626
acrZp,64.75,261,3,ACTACAATATTGCAAGAGGA,258,431773
acrZp,34.75,141,3,ACGTTATTCAGTACCTTGGG,138,453057
acrZp,0.75,5,3,ACGCAATAGCGCGCAGCTTG,2,411011
acrZp,245.5,984,3,ACCTCCAGTAGCGGTCCGTT,981,421640
acrZp,0.5,4,3,ACCTATGACAATCTCCATGT,1,461081
acrZp,21.75,89,3,ACCCCGTCGCAATCGCGACA,86,408863
acrZp,29.5,120,3,ACATTGGCCGGGCGATAGTA,117,422019
acrZp,68.25,275,3,ACATGTAGGGGACAAGGTGT,272,420165
acrZp,0.5,4,3,ACAGTTCCCAAATGCCTGCA,1,444614
acrZp,20.0,82,3,ACACTCGAGTGCCTAGGCAT,79,460825
acrZp,39.75,161,3,AATGCACTTTAGGCTTGGAC,158,413417
acrZp,32.25,131,3,AATGACCACAGTCACCGGAG,128,462635
acrZp,7.25,31,3,AATATGACCGGGCTTGTAAT,28,419714
acrZp,61.5,248,3,AATAGCGTTGACTGGGGTCG,245,449545
acrZp,42.0,170,3,AAGGGGGATGCGTGTTTCAT,167,412720
acrZp,263.0,1054,3,AAGGGACCAGTACGGACGCA,1051,452334
acrZp,29.25,119,3,AAGGAACGGTTCGGTAATAA,116,420231
acrZp,39.0,158,3,AAGATCGTCTTGTACAACAG,155,438962
acrZp,64.25,259,3,AACGCGCTCTTGCCCACCAT,256,455231
acrZp,33.0,134,3,AACATACCATTCGGGATCTG,131,442861
acrZp,0.75,5,3,AAAGCGTTATGGCGTCAACA,2,451007
acrZp,12.25,51,3,AAACGGCTCTGATTGAGTAT,48,435747
acrZp,94.0,283,2,TTTTGCCTGTCCTTAGTCGG,281,412449
acrZp,426.3333333333333,1280,2,TTTTCGAACTGTTATACGCT,1278,436597
acrZp,143.0,430,2,TTTCCCGCACTCCACGCTGG,428,459008
acrZp,0.6666666666666666,3,2,TTTAACTAACCTTGAGAACA,1,450816
acrZp,35.666666666666664,108,2,TTGTTCCTACTCGGCTCGTA,106,464135
acrZp,0.6666666666666666,3,2,TTGCGTCAGCCTTGGCTAGT,1,453743
acrZp,51.0,154,2,TTGCCTGGTTTACTGGGCTT,152,454073
acrZp,32.0,97,2,TTCTAGCAAGGTGCAGTGCG,95,456551
acrZp,18.666666666666668,57,2,TTCGCAATCGCCGTCACTAA,55,450821
acrZp,53.333333333333336,161,2,TTCCGCTCGTGGCGTTATGT,159,443091
acrZp,74.66666666666667,225,2,TTCAACCCGTTAGGTTAGGC,223,451420
acrZp,34.333333333333336,104,2,TTAGTTCAAATGTATGGTTC,102,458812
acrZp,47.666666666666664,144,2,TTAGGCCTAAATCGACCACT,142,462910
acrZp,60.666666666666664,183,2,TTAGGACAGGGTCCGGATCT,181,452044
acrZp,51.0,154,2,TTAGAGAATGTCATCTGCTG,152,457277
acrZp,54.333333333333336,164,2,TTAGAACAGTGCCCGGCTCG,162,440537
acrZp,1.3333333333333333,5,2,TTACGCAGGCAGTAGTAGAT,3,425339
acrZp,52.333333333333336,158,2,TTACCGTGAAGGGCGTGTTA,156,459895
acrZp,19.333333333333332,59,2,TTACCGGCGCCGAAAATTTT,57,427729
acrZp,44.0,133,2,TTACCACACCTGCCACACCA,131,415568
acrZp,0.6666666666666666,3,2,TTAAGGGTACATGTGTTCTT,1,429351
acrZp,49.666666666666664,150,2,TGTTTCCACCATCAAACTTA,148,439966
acrZp,0.6666666666666666,3,2,TGTGTTCTTTTTTTTACAAC,1,453997
acrZp,44.0,133,2,TGTGTATTCTACGCCGCAGC,131,426936
acrZp,1.3333333333333333,5,2,TGTGGGCTAATACACTTGAT,3,428693
acrZp,13.666666666666666,42,2,TGTGCAGGTGAAGCTTTAGA,40,460209
acrZp,0.6666666666666666,3,2,TGTCAGATGCGGAGTCAGCT,1,464164
acrZp,39.333333333333336,119,2,TGGTGGCCGAGTGCACTCTT,117,440703
acrZp,41.666666666666664,126,2,TGGTCCAAGCAGCTGTAATA,124,452341
acrZp,60.666666666666664,183,2,TGGTCATGTTGGCAAGACCC,181,414168
acrZp,0.6666666666666666,3,2,TGGGCAGGTGGAAACTCAAT,1,437731
acrZp,63.0,190,2,TGGCAGGTCTGTAGTGGACA,188,440311
acrZp,32.666666666666664,99,2,TGGCAAATCTATCACACCAT,97,412078
acrZp,0.6666666666666666,3,2,TGGATAATGGTTTCAATCGT,1,463932
acrZp,0.6666666666666666,3,2,TGCTTGCATCCCGCTATTTA,1,424000
acrZp,0.6666666666666666,3,2,TGCTGCCACGACGTAGGTAA,1,447552
acrZp,0.6666666666666666,3,2,TGCTCATGCGCGCACGTATT,1,467551
acrZp,34.333333333333336,104,2,TGATCTATTGTAACGATTCT,102,438935
acrZp,22.0,67,2,TGAGTTACGAGGTCGCCTAC,65,447396
acrZp,0.6666666666666666,3,2,TGAGAAACCTTCTGACAGGG,1,450332
acrZp,19.0,58,2,TGAAATAGGCGTATCAGCGA,56,466144
acrZp,316.0,949,2,TGAAACACGCAAGTATTGGT,947,414912
acrZp,162.33333333333334,488,2,TCTGGAGGCGATTTCGCGTA,486,409267
acrZp,52.0,157,2,TCGTGCTATCATACCACCTT,155,445933
acrZp,36.0,109,2,TCGGATGTCACACATATTGC,107,442761
acrZp,16.333333333333332,50,2,TCGCCGTTTTTTGGCCCACA,48,420616
acrZp,25.333333333333332,77,2,TCGAGGTAACGACGCCCGTG,75,418764
acrZp,24.0,73,2,TCCTGGTCCACCCCCCGCTT,71,453892
acrZp,55.0,166,2,TCCTCCCAAGTAACTTTGCC,164,450295
acrZp,15.333333333333334,47,2,TCCACGTCAAGGCAGGTGAA,45,458824
acrZp,74.33333333333333,224,2,TCAACTGGCTATTTTAAGGA,222,456318
acrZp,19.333333333333332,59,2,TATTGCGCAACAACTTTCTA,57,438154
acrZp,83.0,250,2,TATGTGTCGCTAGACGGATT,248,423021
acrZp,146.33333333333334,440,2,TATCTATCGTCGAAATATTA,438,426677
acrZp,136.33333333333334,410,2,TATATGCGTGAAAGGAAGGT,408,419058
acrZp,22.666666666666668,69,2,TATAGAACGGACCAAGCCCT,67,420618
acrZp,47.666666666666664,144,2,TAGCAAGGACAGAGCGGCAA,142,454582
acrZp,7.0,22,2,TACTGTTGGCACACCATCTA,20,430032
acrZp,38.333333333333336,116,2,TACTGATTTGCATGCACATG,114,440320
acrZp,17.666666666666668,54,2,TACTCACTGTAGCCAGACGT,52,434821
acrZp,37.333333333333336,113,2,TACGTTTAACTTAGCGGAAG,111,432458
acrZp,47.0,142,2,TACGCGATCCTCATTAGATA,140,449817
acrZp,0.6666666666666666,3,2,TACCGCTGTCCGTACACAAT,1,410466
acrZp,0.6666666666666666,3,2,TACCAAGATCTGAGTGGTCT,1,450093
acrZp,134.0,403,2,TAAGTCACGGGGCGGAGATG,401,460206
acrZp,52.666666666666664,159,2,TAAGTACACGTGGAGACCAG,157,446432
acrZp,37.0,112,2,TAAGCATTAGCAAGCACAGC,110,412066
acrZp,47.333333333333336,143,2,TAACTGAGTAAATGGGGCAA,141,443750
acrZp,23.333333333333332,71,2,TAACGGTTTTTTTACATAAA,69,431473
acrZp,49.666666666666664,150,2,TAAAATTGTTGTAATCGCAT,148,417693
acrZp,38.0,115,2,GTTTAATAGCCGGCCTGATA,113,409543
acrZp,51.0,154,2,GTTGTTTTCTATCAGTAGAA,152,452646
acrZp,51.666666666666664,156,2,GTTGGTAAAACGCTAGGTAT,154,409013
acrZp,34.333333333333336,104,2,GTTCGTCCTGGATTTTCTCC,102,427609
acrZp,13.333333333333334,41,2,GTTACGAGCTTCGAAATTAC,39,439934
acrZp,38.666666666666664,117,2,GTTAAAAGCGCTTACGAAGA,115,458308
acrZp,43.333333333333336,131,2,GTGTTACGCTTGAAATGACG,129,457010
acrZp,54.666666666666664,165,2,GTGCCAAGGTAGTGGCTATA,163,441409
acrZp,78.66666666666667,237,2,GTGCATGCCCAGCTCTTACA,235,454688
acrZp,0.6666666666666666,3,2,GTGCATATGAATGACGTCCG,1,410088
acrZp,0.6666666666666666,3,2,GTGATCTGTAAAAGAATTAT,1,414324
acrZp,13.0,40,2,GTGAGTAATGCTTATTGGTA,38,423813
acrZp,23.0,70,2,GTGAGATCACTATACATGGA,68,428319
acrZp,31.333333333333332,95,2,GTCTACCACAATCCCAGTTG,93,460990
acrZp,83.0,250,2,GTCGTGGATAGGGAGATAGA,248,457855
acrZp,0.6666666666666666,3,2,GTCGTAGGGTATGCGAAGAC,1,431232
acrZp,20.333333333333332,62,2,GTCGCGTCGAGCGTTACATA,60,448635
acrZp,57.0,172,2,GTCACAATATGATATACATA,170,421004
acrZp,42.666666666666664,129,2,GTATCAAAAGGGTTGTTGAA,127,438823
acrZp,52.333333333333336,158,2,GTATAGGGACAGGTTTACGT,156,450062
acrZp,47.333333333333336,143,2,GTAGCCCGAGTCGATAGGAA,141,437340
acrZp,111.0,334,2,GTAAAGGGCAGACAGTATGA,332,464932
acrZp,0.6666666666666666,3,2,GGTATTATATGGACCAGAAA,1,410434
acrZp,6.666666666666667,21,2,GGGGCACTGTACCTCTGATT,19,418805
acrZp,0.6666666666666666,3,2,GGGATCCGGAGACCTGGGGG,1,430666
acrZp,56.666666666666664,171,2,GGGAGCAAATAGTAATAATC,169,431811
acrZp,21.0,64,2,GGCTGAACCCACCTTACTCG,62,412121
acrZp,48.333333333333336,146,2,GGCGAGCAAGAACAGGACTT,144,455761
acrZp,273.3333333333333,821,2,GGCATGACACAGTTTTTGGG,819,444777
acrZp,0.6666666666666666,3,2,GGCAGCATGTTAACGTACTA,1,444353
acrZp,32.0,97,2,GGCAGATGTGAGTTAGAAAT,95,459784
acrZp,1.0,4,2,GGCACTCACTTGCCTCACTG,2,453769
acrZp,44.333333333333336,134,2,GGCACCCCTCTCGGAATTGC,132,454226
acrZp,0.6666666666666666,3,2,GGATTTGTAAAAGAATAATA,1,442392
acrZp,59.0,178,2,GGATTTCAACAGTTCATGAT,176,454138
acrZp,194.33333333333334,584,2,GGATGTTCACAGAAACTAAT,582,421580
acrZp,226.66666666666666,681,2,GGATATACGAGCGCATTCGG,679,460276
acrZp,2.3333333333333335,8,2,GGAGCCAACCTTCCATGAAG,6,445167
acrZp,0.6666666666666666,3,2,GGACTTGTGGCAGGAGAAAT,1,432257
acrZp,31.333333333333332,95,2,GGAAGTGATTTGTATGTCCT,93,433557
acrZp,1.3333333333333333,5,2,GCTTGCGATTTGCAGACCAA,3,427929
acrZp,133.66666666666666,402,2,GCTTGCAATGAGCTTAGATC,400,444775
acrZp,0.6666666666666666,3,2,GCTTGCAAATCAGGAACATT,1,456268
acrZp,48.333333333333336,146,2,GCTGATCGGGGCTCGGATTT,144,418983
acrZp,49.666666666666664,150,2,GCTAGGGACATCGAGGGTGC,148,417808
acrZp,0.6666666666666666,3,2,GCGTGATAGATTCCCCATAT,1,413505
acrZp,0.6666666666666666,3,2,GCGTCACTCCATCCTTGGCG,1,422973
acrZp,41.666666666666664,126,2,GCGTAGCAAAATGACCACAG,124,440150
acrZp,177.33333333333334,533,2,GCGGCGACGAATAGTCATGT,531,408798
acrZp,0.6666666666666666,3,2,GCGGAATGACTTATGCTACA,1,447629
acrZp,66.0,199,2,GCGAGGACCTTCCTCCCATA,197,453604
acrZp,80.66666666666667,243,2,GCCTTTTGTCGAGTAATCGT,241,428736
acrZp,53.333333333333336,161,2,GCCCGGCTATGCAAAAGGGT,159,461349
acrZp,0.6666666666666666,3,2,GCCAGTCCGAAAGAGACTCC,1,421714
acrZp,59.666666666666664,180,2,GCCAATTAGAAACAGTCGGA,178,423751
acrZp,0.6666666666666666,3,2,GCATCCCACGCGGATCAAAA,1,423842
acrZp,120.33333333333333,362,2,GCAATATTAGCCGTCTCAAT,360,428166
acrZp,35.333333333333336,107,2,GATGTGTTAAAGATGGCAAA,105,449235
acrZp,0.6666666666666666,3,2,GATGGGAAATTAAAGCGACT,1,423186
acrZp,46.666666666666664,141,2,GAGTGCATTTTAAAAATCCT,139,453389
acrZp,45.666666666666664,138,2,GAGGAGCCGTACCATAATTT,136,446765
acrZp,48.333333333333336,146,2,GAGAGGCGGGAGTTCATTTT,144,439501
acrZp,1.0,4,2,GAGAACTAATCCTCGACTGG,2,466535
acrZp,0.6666666666666666,3,2,GACTAGCACAGGACAAGGAC,1,416731
acrZp,36.0,109,2,GACGGCTGACTTTTTTCTTG,107,449047
acrZp,0.6666666666666666,3,2,GACCCTCCTGTTGCGGCTAT,1,432693
acrZp,61.333333333333336,185,2,GACCCTAGGCGAGAGTGGGT,183,416903
acrZp,0.6666666666666666,3,2,GAATGCCAGATCGCATAGAA,1,412940
acrZp,30.0,91,2,GAATCCACCTGATGACTTCT,89,448657
acrZp,163.66666666666666,492,2,GAATAGCAAGTAAGAGCCTA,490,452327
acrZp,216.0,649,2,GAACTCGTAGAAGTTCGAAT,647,445708
acrZp,84.33333333333333,254,2,CTTTGTATACCATGCTAGCT,252,426683
acrZp,39.0,118,2,CTTCCGTGTACCGACACTAT,116,422261
acrZp,0.6666666666666666,3,2,CTGTGTCTCATACTAGAGAA,1,417269
acrZp,70.33333333333333,212,2,CTGTCGCTAGCGGTCGCGCA,210,440301
acrZp,37.333333333333336,113,2,CTGTCAGGTACTCTAGTGAG,111,427381
acrZp,43.666666666666664,132,2,CTGGTAAGCTTGTGAGCCAG,130,420067
acrZp,0.6666666666666666,3,2,CTGCAAAGAGCGGGGGTCAT,1,465879
acrZp,117.0,352,2,CTGACACGCCTTCCTTGTCA,350,422844
acrZp,46.666666666666664,141,2,CTCTTCCCCTACTGGCCAAA,139,418957
acrZp,1.0,4,2,CTCGTCACTACTCGCGTCAC,2,453225
acrZp,32.666666666666664,99,2,CTCCGTACGCGTAGAGGTGT,97,460975
acrZp,120.33333333333333,362,2,CTATTCGTATGCCACAAAAA,360,455086
acrZp,1.0,4,2,CTAACTGGCAGCAGGCGCCC,2,421428
acrZp,0.6666666666666666,3,2,CTAAACTTAGAAGGACCCGA,1,424928
acrZp,49.666666666666664,150,2,CGTTTCAAGAAAACCCACAA,148,452961
acrZp,0.6666666666666666,3,2,CGTTGATACAGGGTTCACTG,1,412521
acrZp,0.6666666666666666,3,2,CGTTCTTACCAATCACCCTG,1,453655
acrZp,0.6666666666666666,3,2,CGTGGCCTAGATTCCTCGGC,1,439099
acrZp,172.66666666666666,519,2,CGTGCTCGGCCTAGGGACGC,517,456725
acrZp,179.33333333333334,539,2,CGTCCATTAGGGTCGAGCCA,537,417738
acrZp,303.6666666666667,912,2,CGTAGTACCCGCACTCGATG,910,418590
acrZp,18.333333333333332,56,2,CGGTTTGATACGGCGACACC,54,417122
acrZp,54.666666666666664,165,2,CGGTGGGATACAAGAAAGAA,163,438961
acrZp,49.0,148,2,CGGTGATAGCCTAATTCAAT,146,441413
acrZp,26.0,79,2,CGGTCAAAAATCTACCTCCA,77,445131
acrZp,165.0,496,2,CGGTAACGCCAGAGGTTTGA,494,465749
acrZp,94.66666666666667,285,2,CGGGGAAATGCCCTATCTGT,283,429613
acrZp,54.666666666666664,165,2,CGGGCACTGCACCAAGTGTT,163,418804
acrZp,89.0,268,2,CGGGCAACATACGGGACGTA,266,445008
acrZp,35.333333333333336,107,2,CGGCTGTGCCTCCACAAGTA,105,423440
acrZp,99.33333333333333,299,2,CGGCTGGCAGTGGAAACACA,297,423556
acrZp,7.0,22,2,CGGACCCTGAGTGATTGGCA,20,445890
acrZp,0.6666666666666666,3,2,CGCTTATGTGGGACGACGGG,1,461233
acrZp,44.666666666666664,135,2,CGCTCACCCAAGGGAGGGAG,133,453606
acrZp,154.66666666666666,465,2,CGCCTGCGGCCTCGTCGCAG,463,449918
acrZp,48.333333333333336,146,2,CGCATTTGGAGATTCCGAGA,144,413697
acrZp,286.6666666666667,861,2,CGAGTAGACGAGCGCGTAGC,859,461873
acrZp,47.666666666666664,144,2,CCTTAGAGGAACGGAAGTCG,142,417886
acrZp,26.666666666666668,81,2,CCTTAAGAAAGATCTCCACC,79,436379
acrZp,3.3333333333333335,11,2,CCTCTCCTACAGGTTAAATA,9,412941
acrZp,0.6666666666666666,3,2,CCTATACTCAAACTCCCTGG,1,457195
acrZp,0.6666666666666666,3,2,CCGTTCGTTGTGCCTAAATT,1,451120
acrZp,89.0,268,2,CCGTGTTCTTTACTACCCTT,266,426554
acrZp,44.0,133,2,CCGTATCGTTTCGTCCAAAC,131,447550
acrZp,64.0,193,2,CCGCTAGTTGACACTAAGGC,191,423688
acrZp,0.6666666666666666,3,2,CCGAGAGCTTGTAGTCGTAC,1,456964
acrZp,58.0,175,2,CCGAATCTCGTACATCCAAT,173,437345
acrZp,41.666666666666664,126,2,CCCGGTTTCAGGCAACGGCA,124,430368
acrZp,9.333333333333334,29,2,CCCAATTATGTCTAGATCCT,27,452094
acrZp,0.6666666666666666,3,2,CCCAACGAGGGGGAATGGAC,1,458402
acrZp,106.0,319,2,CCATTCTGTGTACCGAAAGG,317,421648
acrZp,44.333333333333336,134,2,CCAGGTTAGTTATGTACTAG,132,444150
acrZp,2.0,7,2,CCAGCCGGGATGCCTCATGG,5,409286
acrZp,0.6666666666666666,3,2,CCAAGGAGCACGCGGCGCCT,1,430732
acrZp,0.6666666666666666,3,2,CCAACCAGATCTGCAAAGCT,1,415743
acrZp,62.666666666666664,189,2,CCAAAGCCCCATGTGATGGT,187,409049
acrZp,36.666666666666664,111,2,CCAAACGCTTGAGCTATAGT,109,449923
acrZp,0.6666666666666666,3,2,CAGTACACGGGCATAGTCTA,1,411061
acrZp,26.0,79,2,CAGGGTCCATTCCTGGGTTT,77,418633
acrZp,55.333333333333336,167,2,CAGAATCCTGCGCATGGACT,165,419460
acrZp,132.66666666666666,399,2,CACGGCCACAAAAGCTAAGT,397,443711
acrZp,0.6666666666666666,3,2,CACCTATTCCTCACTAATGT,1,458831
acrZp,0.6666666666666666,3,2,CACCGGCCTTGTCGTCCTCA,1,435682
acrZp,43.333333333333336,131,2,CACAAAGGGTCTGGGGTAAT,129,416769
acrZp,127.33333333333333,383,2,CAAGCCACTAAGCATGGCTC,381,443414
acrZp,29.666666666666668,90,2,CAAATGACGCGCAATAATTA,88,445139
acrZp,43.0,130,2,CAAAAAAAGGGGATCCTCAG,128,416344
acrZp,44.666666666666664,135,2,ATTGTAAAGGCACACGGCGA,133,420518
acrZp,64.0,193,2,ATTCGTTCAGTCGTCAAGTA,191,449650
acrZp,35.666666666666664,108,2,ATGGGGTCTAGTTGGTGATA,106,442722
acrZp,88.66666666666667,267,2,ATGAGACGACGCTAGTACAT,265,463542
acrZp,4.333333333333333,14,2,ATGAAGTGACACATATCGAT,12,438372
acrZp,29.333333333333332,89,2,ATCGGCGGCGGGGCCGTGGA,87,452481
acrZp,0.6666666666666666,3,2,ATCGCTAATCATTGAGGCCA,1,413662
acrZp,0.6666666666666666,3,2,ATCAGCCCCCCGTCTTCGAA,1,422521
acrZp,71.66666666666667,216,2,ATATTGCGTACCACTGGTTT,214,429978
acrZp,42.0,127,2,ATATCAAGAAGCATTGAGAG,125,445004
acrZp,15.0,46,2,ATAAATTTGAAAGGATACGC,44,414687
acrZp,19.666666666666668,60,2,AGTTTAAATCTAGATCCCTT,58,427651
acrZp,46.666666666666664,141,2,AGTCGGGCCATCCTCCATCC,139,462170
acrZp,0.6666666666666666,3,2,AGTCGAAGGGGCATATCCTA,1,413255
acrZp,154.33333333333334,464,2,AGTCACATGGCCGAAGGGCC,462,431837
acrZp,0.6666666666666666,3,2,AGTACAAGGACGCCACCTGA,1,414851
acrZp,62.333333333333336,188,2,AGGTTGATGTGCGTTGATAT,186,417495
acrZp,0.6666666666666666,3,2,AGGTTCTAAGAGACGAGGCA,1,434289
acrZp,36.666666666666664,111,2,AGGTGATTATGTGTAATTTT,109,444044
acrZp,40.666666666666664,123,2,AGGTCCCGTCCCCGCAGTAG,121,410822
acrZp,20.666666666666668,63,2,AGGTCAACGGGCCAATATTA,61,429735
acrZp,0.6666666666666666,3,2,AGGCCGATTCAACCACTTGT,1,435338
acrZp,44.666666666666664,135,2,AGGACATAAGTACTTGTATG,133,459387
acrZp,0.6666666666666666,3,2,AGCGTGCTCAATTCATATGT,1,420295
acrZp,32.333333333333336,98,2,AGCGTGAGAGGTGTCCCTGG,96,423674
acrZp,0.6666666666666666,3,2,AGCGTACAAAACGTGTCCGG,1,453984
acrZp,51.0,154,2,AGCAATATTTACTTTCCAAG,152,420509
acrZp,31.333333333333332,95,2,AGATGGCGCGTGCACATCTG,93,412814
acrZp,47.666666666666664,144,2,AGATGACTGCGGATAACCTA,142,416722
acrZp,55.0,166,2,AGAGATCGTCTTCTTGCTAA,164,453176
acrZp,34.666666666666664,105,2,AGACGAACGTGCACCTCATT,103,460624
acrZp,0.6666666666666666,3,2,AGACCTAAGTCTCGTTAAGT,1,434055
acrZp,0.6666666666666666,3,2,AGAAGTGTCTTGGACGCGGT,1,420842
acrZp,0.6666666666666666,3,2,ACTTTCGAGTGTTAAGGTTG,1,462668
acrZp,81.66666666666667,246,2,ACTTGTCTACTATGTGTATT,244,413985
acrZp,85.66666666666667,258,2,ACTTCGAGCACTCGGCCAGC,256,465182
acrZp,36.333333333333336,110,2,ACTGGTCTCTGATTACCCCT,108,429793
acrZp,33.0,100,2,ACTGAATGTCCCGACACGGT,98,416215
acrZp,0.6666666666666666,3,2,ACTGAAGTCCGTTTGAGCTA,1,457400
acrZp,0.6666666666666666,3,2,ACTCTTTGACAGCAGTGCGT,1,436522
acrZp,8.0,25,2,ACTCCCTCCTTTTTTCGCTT,23,439327
acrZp,2.0,7,2,ACTCAGCCCTCGTAAATTTC,5,421841
acrZp,0.6666666666666666,3,2,ACGTTAGATCCATGATATCA,1,451084
acrZp,52.666666666666664,159,2,ACGCGCGATAAAGGATCCAT,157,461400
acrZp,190.66666666666666,573,2,ACGATTCATGCATCGGAATT,571,421020
acrZp,38.333333333333336,116,2,ACCTTGCTCTGTTGACCATT,114,446440
acrZp,0.6666666666666666,3,2,ACCTCGATAGTGAGTCTTAT,1,463935
acrZp,305.3333333333333,917,2,ACCGGTTGTCACACGTGTGA,915,444304
acrZp,54.666666666666664,165,2,ACCCAGCTGCCCATCGGCTG,163,437778
acrZp,36.666666666666664,111,2,ACATTAGTCTATTCGAGGAC,109,441550
acrZp,0.6666666666666666,3,2,ACATAGACGTCATTAATAAG,1,409026
acrZp,1.0,4,2,ACAATCATTCGTGATGGAGC,2,411771
acrZp,58.333333333333336,176,2,AATTACGGCAAACTTTCTGG,174,425318
acrZp,38.0,115,2,AATCCTCGGCTCGTTCGTAT,113,437792
acrZp,50.333333333333336,152,2,AAGTACCATGGATGGACTGT,150,420221
acrZp,13.0,40,2,AAGGGTTTCTAACCCTCTCT,38,410310
acrZp,34.333333333333336,104,2,AAGGCTCAAATGCACTCCGA,102,415335
acrZp,32.333333333333336,98,2,AAGCCGTGGTAACGTTGCGT,96,428346
acrZp,1.0,4,2,AACTGTATACAACTTCCGGA,2,434814
acrZp,27.333333333333332,83,2,AACCCAGAAGTCCGCATTAT,81,431066
acrZp,47.666666666666664,144,2,AACACAGAGCGCTGACCACA,142,435868
acrZp,36.333333333333336,110,2,AAATATTTCGACGAGCGGGT,108,466072
acrZp,122.0,367,2,AAACATCAGGAGTTAAGCAG,365,411517
acrZp,0.6666666666666666,3,2,AAACACAGTTTTGTGGTAGT,1,451684
acrZp,0.6666666666666666,3,2,AAAATAAAGCTTGATAGGCT,1,416368
acrZp,56.5,113,1,TTTTGAATAAATGAAATCAA,112,430142
acrZp,57.5,115,1,TTTTCAAAGTTACTTGAGCC,114,435439
acrZp,111.5,223,1,TTTTACGGCCCCGGTAACGA,222,417611
acrZp,70.0,140,1,TTTTACATGCGGGCCTGAAG,139,417360
acrZp,42.5,85,1,TTTGTGGGCTGAATTGCATG,84,444493
acrZp,1.0,2,1,TTTGTCCCGTGTATCTATCT,1,463488
acrZp,1.0,2,1,TTTCTTTACAGGTGGCACGT,1,448376
acrZp,182.0,364,1,TTTCCTTTTGCTGGCGACTG,363,453987
acrZp,51.5,103,1,TTTCAGGATATCAGAATTGT,102,462333
acrZp,103.0,206,1,TTTAATTCAGTGTAGGGAGA,205,443784
acrZp,69.0,138,1,TTGTCTTTCAATCATCGGTA,137,430111
acrZp,70.5,141,1,TTGTCGGAGGGATCTGCTAT,140,412596
acrZp,38.5,77,1,TTGTACGTCTCACAAAAGTT,76,433949
acrZp,182.5,365,1,TTGTACAGCAGTAGTGGCAT,364,429936
acrZp,52.0,104,1,TTGTAACGGCCCGCAACTAG,103,437247
acrZp,37.5,75,1,TTGGCCCGGGCAACTAAGAC,74,422246
acrZp,1.0,2,1,TTGGAATCCGAGAGTGGCAG,1,455037
acrZp,75.5,151,1,TTGCGGCTAGGCGGGCGGTC,150,444675
acrZp,58.5,117,1,TTGCCGGGCCTCTCAGCTAT,116,442719
acrZp,1.0,2,1,TTGCCACAGTGCTATGATCT,1,411138
acrZp,60.5,121,1,TTGAGCCACCAGTTCTCTCT,120,460318
acrZp,62.5,125,1,TTGACTGCGTCGTTAAGTTT,124,439419
acrZp,65.5,131,1,TTGACATAGCAATATTCAAA,130,413449
acrZp,1.5,3,1,TTCTGACGAATAGGACAGGA,2,466922
acrZp,50.5,101,1,TTCGGCCACTTTGTCTTTTT,100,429829
acrZp,33.0,66,1,TTCGATTCGAAGATGAGTTC,65,422687
acrZp,60.0,120,1,TTCGACTAGGGAGTGGTCCT,119,409752
acrZp,1.0,2,1,TTCCGTACAGACACTTCGGG,1,419017
acrZp,62.0,124,1,TTCCAAATCGTATTCTTTAT,123,414133
acrZp,58.0,116,1,TTCAGCGACGGCCCTCCAAC,115,423497
acrZp,140.5,281,1,TTCAGATCTTGGGGAAGGAA,280,465173
acrZp,41.0,82,1,TTCACGACGCCGCTCCGGTA,81,418376
acrZp,39.5,79,1,TTCACACTCGGATCCATTAC,78,426926
acrZp,1.0,2,1,TTAGCAACGCCATCACGGGG,1,433209
acrZp,1.0,2,1,TTAGAGCAGCCTATAGTTTT,1,441872
acrZp,1.5,3,1,TTACGTGCACGGCCGAGAAA,2,436585
acrZp,50.0,100,1,TTACGTATGGGGTGTACCAG,99,445166
acrZp,80.0,160,1,TTACCAGAATTGTTTCGTGT,159,413353
acrZp,1.0,2,1,TTAATTCGCTAATCTGGCCG,1,410876
acrZp,1.0,2,1,TTAAAGAGGGAACCTAAACG,1,411843
acrZp,177.0,354,1,TTAAACAGGGTTGGGCCGAT,353,447225
acrZp,56.0,112,1,TGTTTAACTACGTAGTAATA,111,440324
acrZp,79.5,159,1,TGTGTGAGCGCGGTCTTACA,158,447861
acrZp,71.0,142,1,TGTGCCCATGCAGATTGTAA,141,435931
acrZp,126.0,252,1,TGTCTCTAATCCAAGTACTT,251,427236
acrZp,68.0,136,1,TGTCCGACAGGCTCGTGATT,135,459443
acrZp,50.5,101,1,TGTCAGATGCTGTAAGTACC,100,417341
acrZp,131.0,262,1,TGTATGTGGATGTTAGTCTT,261,459128
acrZp,46.5,93,1,TGTATAGAATTCCAGTAAAA,92,414656
acrZp,39.0,78,1,TGTAGGCTAATGCCCAGAGA,77,430346
acrZp,823.0,1646,1,TGTAGGCGAGCGAACTCCCC,1645,413166
acrZp,37.5,75,1,TGGTTGCTTGAATATCTTAA,74,408824
acrZp,54.0,108,1,TGGTTCAAGCTAGGCCAGTC,107,410337
acrZp,117.5,235,1,TGGTATACGAGATTTTGTAT,234,462133
acrZp,20.5,41,1,TGGGCGGAAAGCCTAACGGT,40,422810
acrZp,39.0,78,1,TGGGATACGTTGCTGTAGGT,77,449912
acrZp,160.0,320,1,TGGGACCGCGGAACAATGGT,319,426700
acrZp,28.5,57,1,TGGCGCGGATGCCTCATTTC,56,446917
acrZp,63.5,127,1,TGGCGACCGCGACGGGCCGG,126,459276
acrZp,18.0,36,1,TGGCATGAAGCTGGGGACGT,35,453986
acrZp,59.0,118,1,TGGCATCTTGAACATTTAGA,117,414393
acrZp,82.0,164,1,TGGATAGTGACAACAGATGA,163,429861
acrZp,79.0,158,1,TGGAGTGCGACGGAGTAGAG,157,408753
acrZp,53.5,107,1,TGGACCGGGGAAGCCACACT,106,410270
acrZp,131.5,263,1,TGGAACGATAACGTTAGTCA,262,460941
acrZp,56.5,113,1,TGCGCGGAGTACAGGTTTTG,112,455884
acrZp,65.0,130,1,TGCCTGTCGCGCACGTGTTT,129,455580
acrZp,66.5,133,1,TGCACGTAAACTCGAACCAG,132,428882
acrZp,55.0,110,1,TGCAATATATTACTGCCAGG,109,418023
acrZp,1.0,2,1,TGAGGCTTTTACCGTGGGCT,1,421003
acrZp,1.5,3,1,TCTGTCTTTTTATAGTGCAG,2,435752
acrZp,79.5,159,1,TCTGAGCTTGGGCCGCACCG,158,441936
acrZp,1.5,3,1,TCTCAAACGAGCAGGACCGG,2,460441
acrZp,1.0,2,1,TCTAGAGTAACACACCGTGT,1,413896
acrZp,49.0,98,1,TCTACGGATCCTACAACTTA,97,432762
acrZp,1.5,3,1,TCGTTACGCAGGATCCTACG,2,437608
acrZp,154.5,309,1,TCGTGCAAACGTCAATACCT,308,413715
acrZp,65.0,130,1,TCGTGAACTACACTGGTAGG,129,411879
acrZp,1.0,2,1,TCGTCATTTGGTTGGACATG,1,440145
acrZp,239.0,478,1,TCGTATTATGCCACGGGAAC,477,448977
acrZp,32.0,64,1,TCGTATAGGTCCTGGCATGG,63,410341
acrZp,64.5,129,1,TCGTAGAGTGCCGGTGACAT,128,466775
acrZp,1.0,2,1,TCGGTTTATACCCCGGACTA,1,416356
acrZp,47.0,94,1,TCGGTCAATAGAAACGTTTC,93,424809
acrZp,1.0,2,1,TCGGGGGGTATCTGTCTACA,1,433331
acrZp,1.0,2,1,TCGGGGCGGGCATTTTCCAT,1,466767
acrZp,46.0,92,1,TCGGGGCATAGCTAAATATG,91,456100
acrZp,1.0,2,1,TCGGATATGCGGGATCATTC,1,448275
acrZp,44.0,88,1,TCGCGTAACCGCAAGATTGC,87,428188
acrZp,211.0,422,1,TCGCGAGCCTACCGCAATAG,421,440871
acrZp,138.5,277,1,TCGCCTCCGACTTTTACATG,276,425806
acrZp,1.5,3,1,TCGCCCGTCCCGATAGCGGG,2,451769
acrZp,149.0,298,1,TCGATTCGAAGAGCTCCTGA,297,427231
acrZp,1.0,2,1,TCGAGGCCCCCTACTGTCAG,1,431525
acrZp,30.5,61,1,TCGAAGATAGACTCTTAATC,60,460968
acrZp,66.0,132,1,TCCTTTTGTGGGTAGCTAAC,131,460010
acrZp,80.0,160,1,TCCTTCCCTCGAGTAGTTCG,159,426838
acrZp,65.5,131,1,TCCGCGCTTGCAGGTCTCGT,130,449387
acrZp,43.0,86,1,TCATTAGCTCGGATCATCAA,85,437512
acrZp,1.0,2,1,TCATTACAGCTGTAAAGCTT,1,443874
acrZp,73.5,147,1,TCATCGCCATTGCATGTTGA,146,432680
acrZp,48.5,97,1,TCATATCCGAGTTTTCGGAG,96,413792
acrZp,2.0,4,1,TCAAGGTAAGCCCGCGAAGT,3,419958
acrZp,57.5,115,1,TCAACGCAAAAACGAGGAGT,114,424030
acrZp,109.5,219,1,TATTGATTCTCTGGAAACGA,218,420640
acrZp,1.0,2,1,TATGCCGGCGCCGTTCTACT,1,451366
acrZp,81.5,163,1,TATGAGTACGATCACCACTT,162,456028
acrZp,63.5,127,1,TATCGCGTCTTGATAGAGAT,126,451703
acrZp,163.0,326,1,TATAGGGTTAAGCCTGTGTG,325,433236
acrZp,220.5,441,1,TATACGGAATTAATACGTAT,440,428389
acrZp,68.5,137,1,TAGGACCCCGAACACTGGTG,136,437244
acrZp,126.5,253,1,TAGCATCTTCCAAGTGGGGT,252,426048
acrZp,146.0,292,1,TAGCACCTCGTCTAGCAGAT,291,446429
acrZp,40.0,80,1,TAGACGATACCCAATGTAGT,79,417610
acrZp,25.0,50,1,TAGAAACTAGTGCCGCTAGG,49,440984
acrZp,37.0,74,1,TACTTGCGGTGACACTTCCT,73,419947
acrZp,130.5,261,1,TACTTACACTGCGATCGTGT,260,424771
acrZp,71.5,143,1,TACTAGCCATAGGGTCGGCT,142,417458
acrZp,45.5,91,1,TACGTATCCGCATTCTTCTT,90,432954
acrZp,182.5,365,1,TACGGTGAGAACGATCATCG,364,458513
acrZp,32.5,65,1,TACCAGTCATGGAGTGTTCT,64,412335
acrZp,1.0,2,1,TACAATTCCTGTGTGGGCGC,1,455669
acrZp,71.0,142,1,TAATTAAAAGCGCTTACGCT,141,461824
acrZp,1.5,3,1,TAATCTACCAGGGCAGCTTC,2,452320
acrZp,61.5,123,1,TAAGCCACTGTTTGCTTTAA,122,443866
acrZp,1.0,2,1,TAAGATTTAAGTATCAACAT,1,450322
acrZp,1.0,2,1,TAAGACTCGAGTCTCTGTTG,1,443718
acrZp,50.0,100,1,TAACTTTGCGACCGACCCTT,99,421596
acrZp,67.5,135,1,TAACGATTTCAGTCCTATGC,134,461838
acrZp,247.5,495,1,TAACCAACGCGTACGAAACG,494,408821
acrZp,62.0,124,1,TAACAAACCGCGCAAAGACT,123,435750
acrZp,64.0,128,1,TAAAATCGAGCAAGGCGGAA,127,418031
acrZp,56.5,113,1,GTTTGTTCAAATACCATCGA,112,447821
acrZp,43.0,86,1,GTTTCGTCATTTATCTAGGC,85,409357
acrZp,89.0,178,1,GTTTCATATTCAGTATTCCT,177,434603
acrZp,1.0,2,1,GTTGTTATAATACATTAACA,1,450210
acrZp,75.0,150,1,GTTGTGCAACACCGCTGTCC,149,438365
acrZp,59.0,118,1,GTTGGTTTGTGTGGGTAAAG,117,410859
acrZp,1.0,2,1,GTTGGTATTCGGTACAAATG,1,462468
acrZp,227.0,454,1,GTTGGCCCTGTTGACAGGCC,453,441630
acrZp,65.5,131,1,GTTCCGGCGGCGGCGTGCCA,130,437250
acrZp,70.0,140,1,GTGTCGTCCTGAGGCTGCGA,139,414013
acrZp,147.5,295,1,GTGTACACGTATTGGGTGTT,294,461604
acrZp,92.5,185,1,GTGGTATCCTGTGCCGGGCA,184,432425
acrZp,1.0,2,1,GTGGACGTGTGTTTTCGCTA,1,438721
acrZp,63.5,127,1,GTGCGTAGCACGGGTCGTTT,126,459516
acrZp,1.0,2,1,GTGCGGAAATCGGTACTATA,1,451487
acrZp,1.0,2,1,GTGAATATGATCTGAGACGC,1,414952
acrZp,1.0,2,1,GTGAACAGGGTGCTTATACT,1,427541
acrZp,1.0,2,1,GTCTGTGGGAGACTATGCAG,1,430024
acrZp,50.0,100,1,GTCGTATAGAAATCGCCCTT,99,464138
acrZp,37.0,74,1,GTCCAGTTCTGTGTAAGGAT,73,430214
acrZp,79.0,158,1,GTCCAAATTCGGGTACCCGA,157,467047
acrZp,71.0,142,1,GTCATTGCGGGCATAGACTA,141,465512
acrZp,82.0,164,1,GTCATACGGAAGTCTAGAGA,163,423443
acrZp,77.5,155,1,GTCACCAATCGCCAGTGCAA,154,435413
acrZp,1.0,2,1,GTATGCTAAGCGTAGATCTT,1,426394
acrZp,65.5,131,1,GTATCTTAAGATAGTAGAGA,130,440365
acrZp,1.0,2,1,GTATATCAATGCGGAGCGAT,1,431012
acrZp,2.5,5,1,GTACCCTAGCTCGGGGCAGG,4,441696
acrZp,137.0,274,1,GTACAGTTTCAGTCAAAGAT,273,434184
acrZp,53.5,107,1,GTAACGATCCAGGGGTTGGT,106,432766
acrZp,187.5,375,1,GGTCAATTGGAAACTCACGG,374,449528
acrZp,2.5,5,1,GGTACGTTAAACAGCTTTAG,4,426469
acrZp,91.5,183,1,GGGTGCGCTCTGTACTTTCT,182,453009
acrZp,60.5,121,1,GGGTCTTATTCGCGTCAACT,120,419400
acrZp,1.0,2,1,GGGGATGACACCTCAAAAGG,1,442903
acrZp,1.0,2,1,GGGAGTTAAAAAAGGACCCA,1,415610
acrZp,16.0,32,1,GGGAGGAGCATACTGCTCGT,31,428394
acrZp,73.5,147,1,GGCTTCTTACCTCGAGTCAT,146,431597
acrZp,65.5,131,1,GGCTGCAAAGACGGGTTAGT,130,452517
acrZp,69.5,139,1,GGCGGACTACCGCTAGCGCG,138,411694
acrZp,11.5,23,1,GGCCTGGGCTCGGCCTAAGT,22,422533
acrZp,77.0,154,1,GGCCTCTGGTCTGCCGGGAG,153,425041
acrZp,56.0,112,1,GGCCCATCAATCCTGATACC,111,421750
acrZp,26.0,52,1,GGCAGACAGGATGTTGTTCT,51,436705
acrZp,1.0,2,1,GGATGAGGTTTGGGACCGTT,1,450214
acrZp,1.5,3,1,GGATAATACCCACACAGGTA,2,423588
acrZp,64.5,129,1,GGACTTCCATTCCGCCGTGT,128,434193
acrZp,609.5,1219,1,GGACTATATCCAAATAAATC,1218,429619
acrZp,111.5,223,1,GCTTTTTCGTGTGTGTCCTT,222,453272
acrZp,64.5,129,1,GCTTAGACTGCACCATGGGG,128,429841
acrZp,63.0,126,1,GCTTAAGTATAGAATAGTGC,125,427382
acrZp,40.5,81,1,GCTGTGAATCACTGGTTCAA,80,413868
acrZp,1.5,3,1,GCTGGCCTCGCCGACCGAAT,2,440366
acrZp,125.5,251,1,GCTCTCTCCGATCATCGTCA,250,441293
acrZp,73.0,146,1,GCTCGTCTCGGTCAGGTTGT,145,420726
acrZp,1.5,3,1,GCTCGGTTCATGTCAGGGGG,2,429082
acrZp,62.0,124,1,GCTCGGGGTACAGGGCCGTA,123,450096
acrZp,52.0,104,1,GCTCAACGACAGACCGGATA,103,458321
acrZp,1.0,2,1,GCGGTCTGGGCGCCCATGCA,1,426931
acrZp,77.5,155,1,GCGGTCCAGGGTTAAGCTGC,154,414532
acrZp,79.0,158,1,GCGCTCGAACGTGTCAATGT,157,415319
acrZp,103.5,207,1,GCGCAAACATATTCATGGAA,206,467346
acrZp,70.5,141,1,GCGACGGAATTCTGCTTTCT,140,437362
acrZp,53.5,107,1,GCCTGGTGCAGGAGCGAACT,106,463256
acrZp,73.0,146,1,GCCTGCCCTACCGGGATAGG,145,423823
acrZp,40.0,80,1,GCCTACGTTTGACCCGGGGG,79,441586
acrZp,1.0,2,1,GCCTACGACGTACCAGTGGG,1,440736
acrZp,100.5,201,1,GCCTAATGCTAGAAAGCACA,200,413710
acrZp,363.0,726,1,GCCGCGAAACGCCCTACGGA,725,449534
acrZp,1.0,2,1,GCCCGGCTTCTGAAATCAAG,1,432412
acrZp,52.5,105,1,GCCAGCTGCTACCAGCTCAG,104,458236
acrZp,71.5,143,1,GCCAAGCGAGTGAATACACA,142,460093
acrZp,70.5,141,1,GCATGAGAATTGGGTCCGGG,140,451641
acrZp,1.5,3,1,GCATAAATGCGACTACGAAC,2,461743
acrZp,89.5,179,1,GCACTCAGGTAGGTTGTCTT,178,445348
acrZp,72.5,145,1,GCACGTTGTGGACGAGAGCC,144,414583
acrZp,58.0,116,1,GCAATTCGATCGTTCGGCGT,115,438989
acrZp,114.5,229,1,GATGTACGGTTACCAATTCG,228,415308
acrZp,59.5,119,1,GATGACCGTATTAGTCTCCA,118,460698
acrZp,91.5,183,1,GATCATTTGGCGCTTGTAAT,182,438792
acrZp,64.5,129,1,GATATCTTGATTAAAGACTC,128,418962
acrZp,40.5,81,1,GATAGGTACCTCCGAACCAG,80,420739
acrZp,55.0,110,1,GATAGCGCTTAACCACGAGA,109,466907
acrZp,1.5,3,1,GAGGGACATGCTTCTCATTT,2,459608
acrZp,1.0,2,1,GAGGAACGTTCGTTATCGGC,1,426197
acrZp,72.5,145,1,GAGGAAAGTAAGCGTCTATG,144,420621
acrZp,68.5,137,1,GAGCGTATATCTCGTGTAAC,136,455457
acrZp,1.0,2,1,GAGCGATAAGATAATGAAGG,1,418032
acrZp,1.5,3,1,GAGCGACGGTGATTTTCAAG,2,452377
acrZp,50.5,101,1,GAGATTATTACAAGCATTGT,100,416862
acrZp,276.0,552,1,GAGAGATGTAGGCCGTAACT,551,460278
acrZp,153.0,306,1,GAGAACTGCTTGTGTACAGA,305,451705
acrZp,153.5,307,1,GAGAAAAGACCGGCTGTATA,306,422107
acrZp,79.0,158,1,GACTACGGGAAGCGTCCTTG,157,460962
acrZp,72.5,145,1,GACGCGAGTCGCGATTCCCG,144,434099
acrZp,113.5,227,1,GACGATATTTGACTGTGCGG,226,445950
acrZp,76.5,153,1,GACCTCATGAGCCCGTTAGC,152,454636
acrZp,195.0,390,1,GACCCCGGGTCAAAACCTAC,389,446559
acrZp,1.0,2,1,GACCAGAGGCCCGGATTGCC,1,447905
acrZp,39.0,78,1,GACATATAGTAGCAGCACGC,77,420238
acrZp,1.0,2,1,GACAGTATAATATGGTCGAA,1,430624
acrZp,1.0,2,1,GACAGACCGCCCCAGGGGGG,1,454791
acrZp,1.0,2,1,GAATATTCTCACAAAGACCG,1,422544
acrZp,9.5,19,1,GAATACTGAATTTCTTGTTG,18,459320
acrZp,44.0,88,1,GAACGCGGTTGGAACAAAAA,87,463852
acrZp,69.0,138,1,GAAATCTAGCTTTTATCATT,137,465460
acrZp,66.5,133,1,CTTTCTTGTTAATATATGCA,132,446988
acrZp,26.5,53,1,CTTGTGCGCCAACCTCTCTA,52,460909
acrZp,253.0,506,1,CTTGTGCCAGGGAACAGCAT,505,429833
acrZp,1.0,2,1,CTTCCTTCCAGGGTCATGGA,1,448544
acrZp,1.0,2,1,CTTCAGCAGCAGGCCCTGGT,1,459609
acrZp,55.0,110,1,CTTATTTTAGGCTTGTATAG,109,443867
acrZp,65.5,131,1,CTTATCTCTGTATGTCGTTA,130,448058
acrZp,65.5,131,1,CTTAGAGGCCTAAAATCTGT,130,440307
acrZp,54.5,109,1,CTTAAAAGTTTCGCTCCGAC,108,433784
acrZp,145.5,291,1,CTGTCGTGTGCCCGTAAGAA,290,438954
acrZp,178.0,356,1,CTGTAAACCGTATCCTCCAT,355,441332
acrZp,1.0,2,1,CTGGGTTCATTAGTCTAATG,1,411326
acrZp,54.0,108,1,CTGGCATAGATCTCTACCTG,107,437952
acrZp,1.0,2,1,CTGGACCGATCAAAATTACA,1,433250
acrZp,150.0,300,1,CTGCTCACATTCGACGGTGA,299,430027
acrZp,1.0,2,1,CTGCTATCGAGACGTACGCG,1,442391
acrZp,88.0,176,1,CTGCGCGATACCCGATGCAA,175,447483
acrZp,18.5,37,1,CTGCCTTTCCTATCCAGGTG,36,460754
acrZp,14.0,28,1,CTGCACAGCCCCTCTCTGGT,27,411721
acrZp,1.0,2,1,CTGATCGAATAACCCAGTAA,1,421924
acrZp,13.0,26,1,CTCTTTCATACTCGGAAGCC,25,448729
acrZp,71.0,142,1,CTCTGCGAATCTAACGCTGA,141,464871
acrZp,29.0,58,1,CTCTCGCTCACTTTTAGGTC,57,459481
acrZp,66.0,132,1,CTCGTGATCAAGCTCGGAGG,131,433235
acrZp,70.5,141,1,CTCGGCGTCATGCAGAGTGC,140,462832
acrZp,144.0,288,1,CTCCCGCACAGCTGCCCACA,287,455188
acrZp,143.0,286,1,CTCCACGTTAACGTCGTTTG,285,443251
acrZp,1.0,2,1,CTCATGTAGAATAGTGTATT,1,408858
acrZp,1.0,2,1,CTCAGCGCGACAAGTGCCGG,1,410386
acrZp,1.0,2,1,CTCACGAGCTCAGACTCTAA,1,451443
acrZp,67.0,134,1,CTCAATATGAAGATGCGACT,133,443826
acrZp,34.0,68,1,CTCAAATTATTGTTTTTCTC,67,460841
acrZp,1.5,3,1,CTATACGGTGTGCTTGGGGA,2,433838
acrZp,1.0,2,1,CTAGAGGTTGATCAAAGGGT,1,458140
acrZp,59.0,118,1,CTAGAGAGGAAGCAATAGCT,117,409005
acrZp,20.5,41,1,CTACGTCTTTCTGACGGCGT,40,418059
acrZp,1.0,2,1,CTAAAGCACTTGTGGGAGCA,1,443558
acrZp,153.5,307,1,CGTTCTGTAACGTAATGTGA,306,420009
acrZp,55.0,110,1,CGTTATGAACTGGCGGCCTA,109,433159
acrZp,66.0,132,1,CGTTAGTGGCTTAAACTCCA,131,445268
acrZp,39.5,79,1,CGTGCTTTTGGGGGGCATAT,78,436621
acrZp,113.5,227,1,CGTCTCGACTTGAGAAATAC,226,443828
acrZp,50.5,101,1,CGTCCCGTGTTCAGGGTATA,100,412558
acrZp,1.0,2,1,CGTCCAACTGAGTAGGTTGG,1,456438
acrZp,36.5,73,1,CGTCAAAAGTGCGGTGTTTG,72,420619
acrZp,111.0,222,1,CGTATGGGAAGTGGGACATA,221,460961
acrZp,1.0,2,1,CGTAGGACTGGGCGTTATCA,1,435833
acrZp,1.0,2,1,CGGTTGTTGGCAGAATGAGC,1,425983
acrZp,1.0,2,1,CGGTAAATATTGAAGCCTAT,1,414954
acrZp,79.0,158,1,CGGGGTAGAGGGAGGACTAC,157,418060
acrZp,73.5,147,1,CGGGAACAACCTTGCAGGCA,146,417214
acrZp,284.5,569,1,CGGCAGTAAGTCTCGAGCCC,568,410011
acrZp,92.5,185,1,CGGAACCCGGCGAGGGAGGG,184,427384
acrZp,1.0,2,1,CGCTTGCCGCCGTAGACTTA,1,452868
acrZp,63.5,127,1,CGCTTCTAGCCGCCCACACA,126,414420
acrZp,180.0,360,1,CGCTCTCCTGTATTCGGCGG,359,452655
acrZp,34.0,68,1,CGCGTCAGTAAGAGTGGCAT,67,456760
acrZp,33.5,67,1,CGCGGGAGTCGCCGCGCTCT,66,464707
acrZp,1.0,2,1,CGCGGCACGCGGGCACTATG,1,450607
acrZp,66.0,132,1,CGCCGTGCCATTCCACCCGA,131,427790
acrZp,48.5,97,1,CGCAGCTGGCTTTCCCCGCA,96,460343
acrZp,39.0,78,1,CGCAGCTAGTCCTCTTTGTG,77,421064
acrZp,1.0,2,1,CGCAAATCGACGTATCGCTA,1,419399
acrZp,1.0,2,1,CGATTTGCCAGCCATACGGC,1,462116
acrZp,23.0,46,1,CGATTAAGGCGCAGCAGTAC,45,424645
acrZp,67.5,135,1,CGATGACCAAAAAATATTTG,134,458356
acrZp,61.5,123,1,CGATACTATTTTTCGTTCAC,122,412987
acrZp,64.5,129,1,CGAGGACTCTATGTTGTCAT,128,456675
acrZp,114.5,229,1,CGAGCCAACACGGCTATCGT,228,448955
acrZp,12.0,24,1,CGAGATTCAAGTCTCCACAG,23,453770
acrZp,42.5,85,1,CGAGACCGAGGAGATTACGG,84,435251
acrZp,79.5,159,1,CGACTAAGGGTGGCGTCTGT,158,446006
acrZp,71.0,142,1,CGACGGGTACACAGTAGCTT,141,422590
acrZp,46.0,92,1,CGACGCGCGTGGGAAGAATT,91,409001
acrZp,58.0,116,1,CGACGCCGAATAAATCGAAG,115,418878
acrZp,80.0,160,1,CGACATGGCCAGAGACGGCG,159,445760
acrZp,405.0,810,1,CGACAACTTCTGATGCTGTG,809,452625
acrZp,44.0,88,1,CGAAGCGATCGTCTCGGGAT,87,466119
acrZp,138.5,277,1,CGAACACGATTGCACATGCC,276,462218
acrZp,230.5,461,1,CGAAACGATATAAAGCTTAT,460,440975
acrZp,1.0,2,1,CGAAAATGGGGAAACTCGGA,1,413004
acrZp,1.0,2,1,CCTTTGGGGGGCCTGATAGC,1,433242
acrZp,1.0,2,1,CCTGTCCTTCGTGATGCGGA,1,441035
acrZp,51.0,102,1,CCTGGATCTAGCGGTAGTGT,101,435938
acrZp,59.0,118,1,CCTGCGGGATTAGGGATCCT,117,454545
acrZp,1.0,2,1,CCTATCGCAGTTATCGGGGA,1,436039
acrZp,1.0,2,1,CCTAGCGTGCTTTTAGAGTT,1,421851
acrZp,76.5,153,1,CCTACTTGCCTGGTGTGCCA,152,419320
acrZp,81.5,163,1,CCGTGTCCTCTAAGATGTCC,162,441077
acrZp,131.5,263,1,CCGTGCAATAATTCGCTATG,262,413173
acrZp,1.0,2,1,CCGTCCCCGGAAGTTCCAAA,1,455564
acrZp,1.0,2,1,CCGGGGAAAAGGGTCCGGTT,1,459888
acrZp,1.0,2,1,CCGGATACCAGTTCGGTCGG,1,436538
acrZp,72.5,145,1,CCGCAGCAGCTTGTTTAGAA,144,448465
acrZp,1.0,2,1,CCGACTAGACTTCCACGTGG,1,411799
acrZp,1.5,3,1,CCGAATACTTACATATCCGT,2,440456
acrZp,61.0,122,1,CCCGGCATATCATGACGGAA,121,458357
acrZp,36.0,72,1,CCCGGAAAGTGTTTAATGGC,71,427997
acrZp,2.0,4,1,CCCGCGTGGAGGGATCAGGG,3,437975
acrZp,63.5,127,1,CCCCTCGCAGTTTGAGAAGC,126,436632
acrZp,1.5,3,1,CCCCCTTGTGGACAACTGCA,2,428257
acrZp,1.0,2,1,CCCAGCCAAGCCTACACAGA,1,413301
acrZp,1.0,2,1,CCCAGAACAGCTCATGCCAG,1,436042
acrZp,654.5,1309,1,CCATCACAGGCTTCGCCATA,1308,439250
acrZp,1.0,2,1,CCAGTTTACCGCATTATGAT,1,420254
acrZp,1.0,2,1,CCAGGTTCTACGTAACTGAT,1,457363
acrZp,56.5,113,1,CCACTTACCGTCACTACACA,112,454225
acrZp,48.5,97,1,CCACTCTTAATTGTTACTAC,96,457866
acrZp,71.5,143,1,CCAATCATATTTTCCATGAC,142,440251
acrZp,162.0,324,1,CCAACTTGGTGAAGGATGGT,323,411552
acrZp,6.0,12,1,CCAACTTGACACCAGGGCTT,11,461409
acrZp,71.0,142,1,CCAACGTCGCGGATAATAGT,141,408801
acrZp,213.0,426,1,CATTCCTCTAACGACCAATA,425,451602
acrZp,105.5,211,1,CATTAGTAAAACATTAGAAC,210,419314
acrZp,146.5,293,1,CATGGTCCCCACAGCATACT,292,452541
acrZp,68.5,137,1,CATGAGATCAGAGAAATAGT,136,456443
acrZp,1.0,2,1,CATGAATATTCGCAGATTTC,1,462614
acrZp,1.0,2,1,CATCGAGGGAAGTGGTAGGC,1,442226
acrZp,1.0,2,1,CATCATCGCCTACCCGTGGG,1,410701
acrZp,65.5,131,1,CATATTTTGGTTATTAACGT,130,420024
acrZp,16.5,33,1,CAGTGCTCTCATATACTTTC,32,423460
acrZp,110.5,221,1,CAGCGCCTCATTAGCCCTGT,220,415296
acrZp,26.5,53,1,CAGATAACATGTGGTCCGTA,52,408803
acrZp,121.5,243,1,CAGACCCTGGGACTCTTAGA,242,410506
acrZp,1.0,2,1,CAGAATATACCAGAGAGCAT,1,443085
acrZp,64.0,128,1,CACTTGAAGACTGCTGACCT,127,456676
acrZp,43.0,86,1,CACTCCAATCAAGCTCTGGT,85,426691
acrZp,34.0,68,1,CACGTGTATCCACACAGCAG,67,460906
acrZp,87.0,174,1,CACCGAAAGCTGGTTATACT,173,434100
acrZp,63.5,127,1,CAATTGACTCTTTACCCCAC,126,421049
acrZp,1.5,3,1,CAATCTGAGTGGTACTAGCA,2,421267
acrZp,1.0,2,1,CAATCGCGGGCCTTTTTCCC,1,441745
acrZp,84.5,169,1,CAATCCTCCTTGGTGTTAGT,168,422383
acrZp,69.5,139,1,CAATATAGGGTTGGTACTAG,138,447224
acrZp,139.5,279,1,CAAGTCTGGGTCCTTATTTC,278,418482
acrZp,79.5,159,1,CAACGGTACTTAGTGGGACC,158,465473
acrZp,62.5,125,1,CAACAGACAGGGCGTCACGA,124,420978
acrZp,20.5,41,1,CAAACTTCGAGGTCAAACTT,40,438737
acrZp,1.0,2,1,CAAACTTATGTCCTAATTGG,1,422465
acrZp,14.0,28,1,ATTTTTCTGACTGCGTAGGA,27,438833
acrZp,276.5,553,1,ATTCCGTGAGAAATGTATGT,552,429625
acrZp,1.0,2,1,ATTACTATAAAAGTTATTGA,1,441334
acrZp,185.5,371,1,ATTAACGGCCACTTTTATTT,370,431575
acrZp,53.5,107,1,ATGTTTGACCGGAGAGTATA,106,420226
acrZp,1.5,3,1,ATGTGTGAGCATTGGAAATC,2,425984
acrZp,1.0,2,1,ATGTCCTCGGTTTCTAGCTC,1,427814
acrZp,262.0,524,1,ATGTACAATGGAAGGCGGCT,523,448107
acrZp,462.5,925,1,ATGGTTACATGCACATCGCT,924,413165
acrZp,29.0,58,1,ATGGGGGAATTTGGTATTTT,57,440087
acrZp,58.5,117,1,ATGGCATTAAGTGGAGCAAT,116,427795
acrZp,1.5,3,1,ATGCTGTAGGGAGATAGTGC,2,426839
acrZp,82.5,165,1,ATGCAGGTATCTTGCCTGGT,164,408818
acrZp,165.5,331,1,ATCTGCGCGCTTGACTGGAG,330,452627
acrZp,71.0,142,1,ATCGGGGGAGATTCGTATTT,141,464181
acrZp,1.0,2,1,ATCCGTATACGTAGCTGCAT,1,467278
acrZp,104.0,208,1,ATCCGCGACGTAGATGAAGG,207,466124
acrZp,58.5,117,1,ATCCACGCTACTGTATCGGT,116,418206
acrZp,33.0,66,1,ATCATAGGGGAGTCATCCTC,65,423444
acrZp,25.5,51,1,ATCATAGGAAGTGATATCTA,50,460919
acrZp,1.0,2,1,ATCACCTGCGGGTGCTTTGG,1,464904
acrZp,296.0,592,1,ATCAACTTTGAACTACCTCC,591,443426
acrZp,169.5,339,1,ATATGGTAGTTGCTGCCCCA,338,467058
acrZp,74.5,149,1,ATATGACTTTGGAAGGTTAT,148,452976
acrZp,1.0,2,1,ATAGCCCGCACTGTGAACAG,1,414473
acrZp,1.0,2,1,ATAGACCCAAAGTCGATCAT,1,418421
acrZp,116.5,233,1,ATAGAACGTACCAAATCCTC,232,462179
acrZp,397.5,795,1,ATACAGCCAAGGCCCTACGT,794,451706
acrZp,1.0,2,1,ATAATTCGGAAACTCACTGA,1,466734
acrZp,173.5,347,1,ATAACTATTTGTGATGTTGC,346,422259
acrZp,1.5,3,1,ATAAACCCGCGACTCTGTCG,2,412246
acrZp,22.5,45,1,AGTTGATGCTGAAGCGCATG,44,427801
acrZp,30.5,61,1,AGTTCGTGAGTACCCGAGTC,60,413666
acrZp,1.0,2,1,AGTGTTAGAATTATCAAGGA,1,409515
acrZp,187.0,374,1,AGTGGTTCTCCCACCGGCGA,373,427363
acrZp,60.5,121,1,AGTGAGGAGCACGGACTCAA,120,421748
acrZp,1.0,2,1,AGTGAACGCACGCCGAATAT,1,410184
acrZp,25.5,51,1,AGTCCAGAGAACTTTAAGAA,50,413103
acrZp,62.0,124,1,AGTAGATATGATCATCGTGT,123,421047
acrZp,277.5,555,1,AGTACGGATCCATTCCTTCC,554,459553
acrZp,68.5,137,1,AGTAACCTAACATTTAGTCA,136,462631
acrZp,74.0,148,1,AGTAAATTACCCCGTGCGAT,147,426585
acrZp,78.0,156,1,AGGTGGGAGGGGGTCCACAT,155,427846
acrZp,35.5,71,1,AGGCGAAGGAATGTCAATTC,70,457063
acrZp,1.0,2,1,AGGCATTACTGATGGGACGA,1,438889
acrZp,48.5,97,1,AGGCACCGGCCGAAAGCGAA,96,421600
acrZp,1.0,2,1,AGCTTTGCGCCATTTGGTGG,1,441118
acrZp,1.0,2,1,AGCGGGTAGCAACCGGAAGT,1,458828
acrZp,64.5,129,1,AGCGCTTCATGAATACAGTA,128,466117
acrZp,68.5,137,1,AGCGCGCAGCACGTATACTT,136,463720
acrZp,1.0,2,1,AGCGAATGGCCGAGTGCCAT,1,436452
acrZp,34.5,69,1,AGCCCTGCTTTGCATGCGAG,68,423864
acrZp,40.5,81,1,AGCCCATTCAGAACCCCTGT,80,439092
acrZp,136.0,272,1,AGCATGGCATTGACACTGAA,271,413066
acrZp,1.0,2,1,AGCATCGATATTTAAGAGCG,1,455859
acrZp,98.0,196,1,AGCAGGGTTTTGGGAGTTGA,195,433347
acrZp,69.0,138,1,AGCACTGGTATTTTGCTAGA,137,456750
acrZp,20.5,41,1,AGCACGTCGCCTTTCAGAGC,40,415211
acrZp,206.5,413,1,AGATCAATCAAAGGCGCTTA,412,418491
acrZp,38.5,77,1,AGAGTACTCATTAACACCGC,76,411646
acrZp,129.5,259,1,AGAGCGGCGAGGCACTCTCG,258,428390
acrZp,55.5,111,1,AGACGGCGCGCCCTTGACGT,110,424768
acrZp,1.0,2,1,AGAAGCCAACCGTGGTTAAG,1,413919
acrZp,1.0,2,1,AGAAACGTCTCTCCTGGCGA,1,421742
acrZp,71.0,142,1,ACTTGAGTCAGATGACCCTA,141,413761
acrZp,2.5,5,1,ACTCTAATGGGTATTCTCCT,4,430735
acrZp,56.5,113,1,ACTCCAGGCGTCATTTGAAT,112,408864
acrZp,1.0,2,1,ACGTTACCACCCAATATTCT,1,438608
acrZp,1.0,2,1,ACGTCCTCGAATACAAGTAA,1,431624
acrZp,71.0,142,1,ACGGTTGTCCAATTGGTCCT,141,426556
acrZp,101.0,202,1,ACGGGTCCCGGACGGCTTTA,201,462463
acrZp,271.5,543,1,ACGGAGTTCGGCAAGTTCGT,542,458987
acrZp,65.0,130,1,ACGCGCTCGGAGACAAGTTT,129,418700
acrZp,125.0,250,1,ACGCATCTCTTCGCACGCCC,249,420236
acrZp,12.5,25,1,ACGAAGAAGGATTCGTGCCG,24,415003
acrZp,37.0,74,1,ACCTCCTCGGAACCGACAGC,73,427638
acrZp,1.0,2,1,ACCGGGCAGAACAGATTTTA,1,447828
acrZp,67.5,135,1,ACCCCAGGCGTGGCTTAGAC,134,447246
acrZp,128.5,257,1,ACCATCGGAGTTCGATAGTC,256,414906
acrZp,1.0,2,1,ACCAGTTGGCCACTCGCTAA,1,430112
acrZp,1.0,2,1,ACCAGGGATAATAGAAACGG,1,411680
acrZp,76.0,152,1,ACATATAGGACCTCTTTTCA,151,411880
acrZp,156.0,312,1,ACAGGTCCGCGAGGTGCAGC,311,461815
acrZp,1.0,2,1,ACACTGGCGAGCAGGCACCT,1,455780
acrZp,72.0,144,1,ACACGTATATTAAATATCTG,143,445618
acrZp,48.5,97,1,ACACCGGGGGCTGCGCATAA,96,422121
acrZp,47.0,94,1,ACACAAATCACCCCTCCATA,93,460912
acrZp,52.5,105,1,ACAATGTGAGCATGACCCTG,104,428685
acrZp,79.0,158,1,AATTTCGCGAGCGCCTAGCA,157,432464
acrZp,1.0,2,1,AATTGTGGGCTAATGGCAAC,1,436550
acrZp,348.5,697,1,AATTGAGACGCCGGTTTTGC,696,420505
acrZp,68.0,136,1,AATGGGCTAGGTTGCCATCG,135,417227
acrZp,1.0,2,1,AATGACACGACTCCATGGCG,1,418448
acrZp,31.0,62,1,AATCCAGAACCTCGTATGCA,61,442874
acrZp,112.5,225,1,AATAGCTCCCGGTCCGTCCC,224,433114
acrZp,44.5,89,1,AATACCGCGCCAACTTCTCT,88,415213
acrZp,14.5,29,1,AAGTGCTTGCTCCACTTGAA,28,448626
acrZp,19.0,38,1,AAGGCTAACAGTATGAGATA,37,434087
acrZp,13.5,27,1,AAGCCAGCCTATCATTCGCG,26,430160
acrZp,1.0,2,1,AAGATCTAGACTGCATGTTA,1,461614
acrZp,83.5,167,1,AAGAGGGGATTGTGTCTCGC,166,431776
acrZp,1.0,2,1,AAGAGACGTTTTTTGCACGT,1,457098
acrZp,47.0,94,1,AAGACGCGACCGTCCCTTGT,93,410575
acrZp,95.0,190,1,AACTAAGCCACACCGGCATG,189,410057
acrZp,115.0,230,1,AACGTGGCATACGGGCTTCT,229,457998
acrZp,1.5,3,1,AACGCTGTCCAATCGTCCTG,2,425708
acrZp,32.5,65,1,AACCCCTGGGAGAGGGTATT,64,458989
acrZp,6.0,12,1,AAATCACGTCTGACTAGATT,11,447108
acrZp,1.0,2,1,AAATATGCTAACAACAACCG,1,456094
acrZp,1.0,2,1,AAAGTCCCCGCCTTCGACCG,1,421570
acrZp,1.0,2,1,AAACGCATTTTAAATACCAG,1,424541
acrZp,54.0,108,1,AAACAATGTATCATCCTTCG,107,459572
acrZp,62.5,125,1,AAAATAGTCGGGCGGCCCTG,124,440572
acrZp,1.0,2,1,AAAAGAGTCTCATATCGCGG,1,441406
acrZp,264.5,529,1,AAAAGACAGTAGATGTGCTA,528,420519
acrZp,65.5,131,1,AAAACGGCCCCCATTGTGCC,130,412826
acrZp,1.0,2,1,AAAACGATTTTGGATATGGG,1,443681
acrZp,0.05555555555555555,17,17,CCACTGTGAGTTGGCTATGG,0,462753
acrZp,0.0625,15,15,GGTAAGAAGGACGCCGCAAT,0,447926
acrZp,0.0625,15,15,CGTCTATAGAAATTGTATTT,0,418235
acrZp,0.07142857142857142,13,13,ACAAAGTGCACAGTATAAGT,0,454076
acrZp,0.07692307692307693,12,12,TCACCGGAACTGCTACTGTA,0,450797
acrZp,0.07692307692307693,12,12,TATACTTAAGGGACTAGGCC,0,421913
acrZp,0.07692307692307693,12,12,GAGGGAAACTGCCCTTGCTG,0,415614
acrZp,0.07692307692307693,12,12,CCAGGATGTCCGATGAGGTC,0,456971
acrZp,0.07692307692307693,12,12,AATACTCAGCCCCTGGCAAG,0,418440
acrZp,0.08333333333333333,11,11,TCTACTATACATTTCATCTG,0,455690
acrZp,0.08333333333333333,11,11,TACTAGCTGCCATGGCGGAA,0,458954
acrZp,0.08333333333333333,11,11,GTACCATACGTCTAGAGATC,0,409354
acrZp,0.08333333333333333,11,11,GGTGCCGGGAAGTACGTGGT,0,414736
acrZp,0.08333333333333333,11,11,CTTCGTATTATATTGCGGAT,0,429566
acrZp,0.08333333333333333,11,11,CTGATGCCACTAAGTACGTA,0,410774
acrZp,0.08333333333333333,11,11,ATGTTATCGAGGTGTGATGT,0,415150
acrZp,0.08333333333333333,11,11,AGGTTTATGCCTTTGGGCAA,0,431231
acrZp,0.09090909090909091,10,10,TTTCCTGGTGGCCCGATATC,0,421431
acrZp,0.09090909090909091,10,10,TAACGGTCCTACCGTGGATA,0,459595
acrZp,0.09090909090909091,10,10,GTGAGATAACTGTCTGGTTA,0,415898
acrZp,0.09090909090909091,10,10,ACGTGTCGAGAATTCCAGGA,0,416403
acrZp,0.09090909090909091,10,10,ACGCCCCTGCTCCCAACGGG,0,431817
acrZp,0.09090909090909091,10,10,AATAATTCTAATGCTCGAAC,0,422805
acrZp,0.1,9,9,TGAAAAGCTGATAAAAATCC,0,420392
acrZp,0.1,9,9,TCGGCGAACGGGCATCCTAA,0,411494
acrZp,0.1,9,9,TCCATCAACGACTAAGCACT,0,465852
acrZp,0.1,9,9,TATAGCTCGGTCTTGTTCTC,0,437691
acrZp,0.1,9,9,TAGCCTGTGGGCGATAGTGC,0,438662
acrZp,0.1,9,9,TAATTGTTAGATTCTTCGAT,0,412278
acrZp,0.1,9,9,GTCGCTGTGGGATCCCGCTA,0,414149
acrZp,0.1,9,9,GCTACCTGCAACAACAGCAA,0,463494
acrZp,0.1,9,9,GACCACAACAAGCTGGGTAA,0,460735
acrZp,0.1,9,9,CTGCTATTTACAACTTCTAC,0,445856
acrZp,0.1,9,9,CTAGATGTAGACGCCACGTT,0,453751
acrZp,0.1,9,9,CGGGAGAGAAAATAGTGGAC,0,420870
acrZp,0.1,9,9,CCGCCGCTTGATGACGTGTA,0,415893
acrZp,0.1,9,9,CAGTAACCCGACGGCGCAAA,0,465177
acrZp,0.1111111111111111,8,8,TGCGACGCCGTGGCTGGCAT,0,438633
acrZp,0.1111111111111111,8,8,TCTCAAATCGGATGAGGTTG,0,427597
acrZp,0.1111111111111111,8,8,TCCTAGTCCGGCGGGCAAGT,0,415903
acrZp,0.1111111111111111,8,8,TCCCAACCGGCATCAAGGTC,0,452437
acrZp,0.1111111111111111,8,8,TCCACATACTTCTTGTCTAT,0,409199
acrZp,0.1111111111111111,8,8,TAACAAGAACGGACAGTCAC,0,428038
acrZp,0.1111111111111111,8,8,GGGTCTCTGGATGATATGGG,0,408583
acrZp,0.1111111111111111,8,8,GGGCGTTGATGTCCACCTCA,0,432672
acrZp,0.1111111111111111,8,8,GGCTGACGCCGCATCTTCTT,0,427982
acrZp,0.1111111111111111,8,8,GCTTAGGAGGTTTGGAAAGT,0,431197
acrZp,0.1111111111111111,8,8,GAGCTCTAAGACGAAGTAGA,0,446322
acrZp,0.1111111111111111,8,8,CTCGTGCGGTGCAAACTAAT,0,419402
acrZp,0.1111111111111111,8,8,CTAGCACTCTGTCATCCGGT,0,445750
acrZp,0.1111111111111111,8,8,CGGTAAACGGCACGTTTTCA,0,443950
acrZp,0.1111111111111111,8,8,CGCCCCCCGCATCCGAAAGA,0,447347
acrZp,0.1111111111111111,8,8,CAGCTGTACAAGTGCGGAAT,0,414763
acrZp,0.1111111111111111,8,8,CACATCGTGGTCTTATTAAG,0,419315
acrZp,0.1111111111111111,8,8,CACAGTAACTTTGACATATT,0,436916
acrZp,0.1111111111111111,8,8,ATATCCACGTTTCTGGCTAA,0,437027
acrZp,0.1111111111111111,8,8,AGGTTACTGTGGATAAGCTC,0,411118
acrZp,0.1111111111111111,8,8,AGGGTGGTTGAGCAGTACAG,0,450100
acrZp,0.1111111111111111,8,8,AGAGTGATCAAAGAAGATTC,0,433539
acrZp,0.1111111111111111,8,8,AGAACTAACACCGCGGTTCG,0,442059
acrZp,0.1111111111111111,8,8,ACATAGATAGAGCACAGTCA,0,420092
acrZp,0.1111111111111111,8,8,AAGCCCAGGAGAAGCAAGTT,0,419546
acrZp,0.1111111111111111,8,8,AAGATATCGGCGCGTACACC,0,422069
acrZp,0.1111111111111111,8,8,AACGATGATTTTGTGCGGTT,0,426472
acrZp,0.1111111111111111,8,8,AAACTGACGCACGGTCGGCA,0,438016
acrZp,0.125,7,7,TTGTCCGATCTACCAGACGA,0,455961
acrZp,0.125,7,7,TTCTGAGCGGCATTCCAAAC,0,412827
acrZp,0.125,7,7,TTCCTAACTAGATCGATGCC,0,455424
acrZp,0.125,7,7,TGTTGGCCATCGTTCTAGTT,0,444008
acrZp,0.125,7,7,TGCGTGGTTTACGTGACCAC,0,455129
acrZp,0.125,7,7,TAAAGATTTTTGGATGTTAT,0,459286
acrZp,0.125,7,7,GTTTTCAGGAATAGTATAGT,0,453391
acrZp,0.125,7,7,GTGGGGTACCTGTCTTTTAA,0,422908
acrZp,0.125,7,7,GTCTTTTACGGGATGTGCAT,0,410516
acrZp,0.125,7,7,GTCTGCCGACTAACGTGATC,0,463936
acrZp,0.125,7,7,GTCGCATCTTTGTATGTAAA,0,434083
acrZp,0.125,7,7,GTAACGGTATCGCCGACGGC,0,412297
acrZp,0.125,7,7,GGTTCCACGCTGAATTGAGA,0,454913
acrZp,0.125,7,7,GGGTTGAATATGCAGTTTTA,0,426035
acrZp,0.125,7,7,GGGTACCGACCGGGGGCGAT,0,429894
acrZp,0.125,7,7,GGGGGATAAATTGGTCTAAA,0,451373
acrZp,0.125,7,7,GCTCAACAGGGGGAGCAACC,0,432220
acrZp,0.125,7,7,GCTACTGCTCATACGGCTCC,0,448714
acrZp,0.125,7,7,GCCCCCTCAGTCCGAACCAG,0,462892
acrZp,0.125,7,7,GATGAGCAGGGCGGCAGGGT,0,415913
acrZp,0.125,7,7,GAGGCCGTAACGGCTACGAC,0,408579
acrZp,0.125,7,7,GAATCGCGACAAGATGGATT,0,433825
acrZp,0.125,7,7,GAATCCTCGCCGGATCGCTT,0,455726
acrZp,0.125,7,7,CTTATATCTCTAGCGATTAA,0,409439
acrZp,0.125,7,7,CTCTCAGATGATATGTGGGA,0,424717
acrZp,0.125,7,7,CGGTACAAAAAATCCCAGGC,0,412166
acrZp,0.125,7,7,CGGGCGGCAGGGTTCTACGA,0,411963
acrZp,0.125,7,7,CGCTATTGAGTAGACAAGTA,0,462608
acrZp,0.125,7,7,CGAAATTAGTTTGTTCCTTC,0,410268
acrZp,0.125,7,7,CATTTTCAATGTGCCTGTAT,0,439598
acrZp,0.125,7,7,CATGCGTAGAGTGGTGCACG,0,414612
acrZp,0.125,7,7,CATCAGAGATAAGCTGTCAA,0,411018
acrZp,0.125,7,7,CATAAGCCTCGTTCCCCGAA,0,460170
acrZp,0.125,7,7,CAGAACCCGCTCTCCCAGGG,0,452998
acrZp,0.125,7,7,CAACGCGGCATCGTAGCTCT,0,428077
acrZp,0.125,7,7,ATGTTAAGTTCATAAGCTTG,0,430923
acrZp,0.125,7,7,ATACAAACTTCGGCTATACT,0,428405
acrZp,0.125,7,7,AGTAGTCCGATGCCGGGAGA,0,416626
acrZp,0.125,7,7,AGGTCTCGCGCCAGCAGAGT,0,409799
acrZp,0.125,7,7,AGGTAAACTCGCGGTGTTTT,0,411898
acrZp,0.125,7,7,AGCTTGACCAGCGGAGATCT,0,424158
acrZp,0.125,7,7,AGACGGCTCAATCCAAACGT,0,426040
acrZp,0.125,7,7,ACTGCCACTCCGCGTGCACC,0,428054
acrZp,0.125,7,7,ACGTATTTGGTGCGGTACGT,0,438376
acrZp,0.125,7,7,ACGCCGTTTCATGTCGGGCG,0,440600
acrZp,0.125,7,7,ACAACGGCGTGAAACTCTAT,0,409127
acrZp,0.125,7,7,AAGAGTTATTTGGCATGTGA,0,431934
acrZp,0.125,7,7,AACTCAATGGTCTACGGCGT,0,435607
acrZp,0.14285714285714285,6,6,TTTATGGTGAACAGGTCCTA,0,444471
acrZp,0.14285714285714285,6,6,TTTAATGGCTTAGAGGTTCT,0,458723
acrZp,0.14285714285714285,6,6,TTCGAGGACCTCTGTTTGCA,0,418692
acrZp,0.14285714285714285,6,6,TTCCGCCACGGGTGGAAATG,0,442967
acrZp,0.14285714285714285,6,6,TTAGTGTGATCAGATCAGCC,0,422904
acrZp,0.14285714285714285,6,6,TTAGCGGCGCGGGGCGTCCA,0,453227
acrZp,0.14285714285714285,6,6,TTACATGCTGGTATATGCGA,0,429788
acrZp,0.14285714285714285,6,6,TTACAAGGGGACTGGTAGAC,0,437130
acrZp,0.14285714285714285,6,6,TGGTTTAAGCGAATGAAAAC,0,412721
acrZp,0.14285714285714285,6,6,TGGTTCAGGGTAAATCGTTG,0,411490
acrZp,0.14285714285714285,6,6,TGGTAATAGCGCGGGGTTGG,0,440951
acrZp,0.14285714285714285,6,6,TGGATGTGATTTTAGGGCCA,0,423322
acrZp,0.14285714285714285,6,6,TGATTAATGACTGGCGAAAA,0,460216
acrZp,0.14285714285714285,6,6,TGAGACTAAGATACTTGTGT,0,461186
acrZp,0.14285714285714285,6,6,TCTGAATGCAAGGGCCTGAT,0,409778
acrZp,0.14285714285714285,6,6,TCGGTTAAAGCCCCTGGCAG,0,445189
acrZp,0.14285714285714285,6,6,TCGGGTACTGACGGGTCGTG,0,446847
acrZp,0.14285714285714285,6,6,TATGGGGTAGATGATAGTTC,0,418759
acrZp,0.14285714285714285,6,6,TACCGCTCACACCCGGTGCA,0,464894
acrZp,0.14285714285714285,6,6,TACACTCCGGTTAGGTAATT,0,410515
acrZp,0.14285714285714285,6,6,GTGTCTCGGACATGTGTTGC,0,459375
acrZp,0.14285714285714285,6,6,GTCGTCAAGCCGTTTTGGAG,0,440005
acrZp,0.14285714285714285,6,6,GTCCCCGACCATTTAGGTCT,0,421048
acrZp,0.14285714285714285,6,6,GTAGTCTAGAATCGCTCCGT,0,414868
acrZp,0.14285714285714285,6,6,GTACCACGCAAGGGCAGTTC,0,442733
acrZp,0.14285714285714285,6,6,GGTACTCGTAAGTCGAAACG,0,464035
acrZp,0.14285714285714285,6,6,GGGTCCGGAAACCAGCCCCG,0,433824
acrZp,0.14285714285714285,6,6,GGGGAAGATCGCTGGGGAGA,0,410378
acrZp,0.14285714285714285,6,6,GGCAATTCCTTGATGCACCA,0,430141
acrZp,0.14285714285714285,6,6,GCGTCAAATAAACCAACGTT,0,420571
acrZp,0.14285714285714285,6,6,GCGAGGCGACTCGGCGAGAT,0,455233
acrZp,0.14285714285714285,6,6,GCGACGTATACTGCAACTCG,0,419276
acrZp,0.14285714285714285,6,6,GCGACAATTGAGCTTCGAGA,0,414520
acrZp,0.14285714285714285,6,6,GCCGACACCCTGTTTAGCGC,0,452821
acrZp,0.14285714285714285,6,6,GCCCCGAATGGATGATCCAT,0,439278
acrZp,0.14285714285714285,6,6,GCACCAAGTAATCCACTTCA,0,440492
acrZp,0.14285714285714285,6,6,GAGACCTGACAATCGCAGGT,0,429873
acrZp,0.14285714285714285,6,6,GACTAGAAACCACTTATGAC,0,421968
acrZp,0.14285714285714285,6,6,GACCGCTTATGATCACCGGT,0,426738
acrZp,0.14285714285714285,6,6,GAAGGGGCTTCCTGTCACGT,0,430367
acrZp,0.14285714285714285,6,6,CTGGATAGCGTGAGTATTCA,0,411404
acrZp,0.14285714285714285,6,6,CTGCAAATTCCGTGGGCGTC,0,463054
acrZp,0.14285714285714285,6,6,CTCTTAAGGCTACATCACAT,0,442579
acrZp,0.14285714285714285,6,6,CTCCGTGTCGGATCGAACGA,0,449438
acrZp,0.14285714285714285,6,6,CTCCGGGTAATCAAGGAGTG,0,466822
acrZp,0.14285714285714285,6,6,CTACTTACCTACGATTCGGT,0,434470
acrZp,0.14285714285714285,6,6,CTACTGGACCGTCCGAATAA,0,447063
acrZp,0.14285714285714285,6,6,CGTACGTCCGAAGTATCCCT,0,415546
acrZp,0.14285714285714285,6,6,CGGCACTAACTTGGGCCTAC,0,448821
acrZp,0.14285714285714285,6,6,CGCATCCTTGGGATCCTCGA,0,447438
acrZp,0.14285714285714285,6,6,CGCACTTAATCTGTGTCATG,0,415836
acrZp,0.14285714285714285,6,6,CGAAAACTTAGGGCTACCAT,0,433290
acrZp,0.14285714285714285,6,6,CCTTGTCTGTTACGCCGGCT,0,411067
acrZp,0.14285714285714285,6,6,CCTCAGGTAAGAGTTGAAGC,0,421686
acrZp,0.14285714285714285,6,6,CCGGGCGGAAAAAGGAACCT,0,443827
acrZp,0.14285714285714285,6,6,CCGGCCCCTGGAGGCGGTGT,0,434202
acrZp,0.14285714285714285,6,6,CCGCGTTTTTATAAAATCGA,0,447608
acrZp,0.14285714285714285,6,6,CCCGGCACTAGATGGTGGGT,0,414131
acrZp,0.14285714285714285,6,6,CCCGATTAGTACCAGTACGG,0,445267
acrZp,0.14285714285714285,6,6,CATAAACTTGTGGGTCTGCG,0,429652
acrZp,0.14285714285714285,6,6,CAATCCCCGCGCCAGCCATT,0,418136
acrZp,0.14285714285714285,6,6,CAAAGAAATACTGTCTTCGA,0,412025
acrZp,0.14285714285714285,6,6,ATTGTTTCCCGGACGGAGCA,0,463303
acrZp,0.14285714285714285,6,6,ATTGAATGTAACCCCACCTG,0,438158
acrZp,0.14285714285714285,6,6,ATTCCTTGGATTGCTCCGAT,0,446950
acrZp,0.14285714285714285,6,6,ATGGCTCTACACGCCAGACA,0,433556
acrZp,0.14285714285714285,6,6,ATCTAACATGAGACCGCTCC,0,447896
acrZp,0.14285714285714285,6,6,ATATGATTGGAATGACCGAT,0,410875
acrZp,0.14285714285714285,6,6,ATATATACTCGGCACCCACT,0,414549
acrZp,0.14285714285714285,6,6,AGGCCAATCTCAGGTGAATT,0,436288
acrZp,0.14285714285714285,6,6,AGGATCTTTGGTTGGCATCT,0,412225
acrZp,0.14285714285714285,6,6,AGCCGGGAAAGCAGCACCGT,0,461792
acrZp,0.14285714285714285,6,6,AGACCTAAAAGGCAGGCATA,0,416379
acrZp,0.14285714285714285,6,6,ACTTGGCCCTGGTTCAGGTG,0,425082
acrZp,0.14285714285714285,6,6,ACTGAGGACTAGGGGCGTTG,0,413478
acrZp,0.14285714285714285,6,6,ACCTGGAGGTTCCGCCCCGT,0,460950
acrZp,0.14285714285714285,6,6,ACCCATAATAAACCTTTAAG,0,462501
acrZp,0.14285714285714285,6,6,AATGCAGCGCTAATACTCTA,0,448576
acrZp,0.14285714285714285,6,6,AACCGCAAGCGTGACGACCA,0,427898
acrZp,0.14285714285714285,6,6,AAATACCGGCTTAAAGTATA,0,424254
acrZp,0.16666666666666666,5,5,TTTGTAGATCTGATTTATAA,0,463046
acrZp,0.16666666666666666,5,5,TTTGAAGCAAGAAATGATTG,0,419857
acrZp,0.16666666666666666,5,5,TTTCAGAAAACGGAGACCAT,0,459915
acrZp,0.16666666666666666,5,5,TTTAACGGACTCAAGATGGT,0,465394
acrZp,0.16666666666666666,5,5,TTGGGGTGAGCAGGCTTCAA,0,415882
acrZp,0.16666666666666666,5,5,TTGGCCGAAATAACAACTGG,0,414526
acrZp,0.16666666666666666,5,5,TTGCAGCACAAAGATAATCG,0,412829
acrZp,0.16666666666666666,5,5,TTGAGTTAAAATATGTGGTC,0,420792
acrZp,0.16666666666666666,5,5,TTCTAAGTCACAACATGCGA,0,418592
acrZp,0.16666666666666666,5,5,TTCAATCTATGATACCGATA,0,430803
acrZp,0.16666666666666666,5,5,TTACTCTATTGGTGCGCGCG,0,411581
acrZp,0.16666666666666666,5,5,TTAATAAGTCAGCGATGAGC,0,417655
acrZp,0.16666666666666666,5,5,TGTTCATCATTGTCTGTAAC,0,436049
acrZp,0.16666666666666666,5,5,TGTCACTCAGGCCGCCAGGA,0,420150
acrZp,0.16666666666666666,5,5,TGTACTTGGGACGCCCGTCA,0,428537
acrZp,0.16666666666666666,5,5,TGGTTAGGCACAGATCCATG,0,457776
acrZp,0.16666666666666666,5,5,TGGCATGGTTTATAGACTGT,0,463034
acrZp,0.16666666666666666,5,5,TGCTTAATCTTCTATGGGAG,0,459426
acrZp,0.16666666666666666,5,5,TGCGTAATGGACTTTGGTAA,0,417188
acrZp,0.16666666666666666,5,5,TGCGGTCATCGCCGTCAGCC,0,436724
acrZp,0.16666666666666666,5,5,TGCGATCCAGGTACCGACCT,0,422314
acrZp,0.16666666666666666,5,5,TGCGAACTTCACACAAGTGA,0,423144
acrZp,0.16666666666666666,5,5,TGCCGTGGTTACCTGGGGAG,0,434298
acrZp,0.16666666666666666,5,5,TGCATTCCCCGATTGATACT,0,448533
acrZp,0.16666666666666666,5,5,TGCATCTCACTTCTCGCCCT,0,417946
acrZp,0.16666666666666666,5,5,TGCATCCAGGGAGTCAAGGC,0,423814
acrZp,0.16666666666666666,5,5,TGACAGACGCTTCGGTGACC,0,450013
acrZp,0.16666666666666666,5,5,TGAAGTCGCCAGCAAACTGC,0,433031
acrZp,0.16666666666666666,5,5,TCTTTCCAGGCTAAGTTTCG,0,413870
acrZp,0.16666666666666666,5,5,TCTTTATTGCAGAGGATCAT,0,411688
acrZp,0.16666666666666666,5,5,TCTAGGCCTTAGTGTAACAA,0,414449
acrZp,0.16666666666666666,5,5,TCGTGTGATGCGTCCGGACA,0,429900
acrZp,0.16666666666666666,5,5,TCGCGCCTTCTCATTAATGA,0,457004
acrZp,0.16666666666666666,5,5,TCCTCGCGGGATGTCTCGGT,0,438609
acrZp,0.16666666666666666,5,5,TCCGACAGATGATGATGCGA,0,412127
acrZp,0.16666666666666666,5,5,TCCACTACGGTGGTCACGCT,0,461111
acrZp,0.16666666666666666,5,5,TCATCTCTCCTGCGCTTGGC,0,440677
acrZp,0.16666666666666666,5,5,TCACCATCATGGACCAGTAG,0,436944
acrZp,0.16666666666666666,5,5,TATTTGGTCTCCTTTATCAT,0,433688
acrZp,0.16666666666666666,5,5,TATTGTGCACCGAGTAGAGA,0,441840
acrZp,0.16666666666666666,5,5,TATTCGACTCAACGGAACTT,0,440801
acrZp,0.16666666666666666,5,5,TAGAATAATCAGGGCGAAGG,0,457954
acrZp,0.16666666666666666,5,5,TACGGGACTCTGTGCATAAA,0,427174
acrZp,0.16666666666666666,5,5,TAATATACAACGGCCCATAA,0,446060
acrZp,0.16666666666666666,5,5,TAAGAATCGCGTTACGAGTA,0,414122
acrZp,0.16666666666666666,5,5,GTTTTCCTGGGAGCTGCTAC,0,429535
acrZp,0.16666666666666666,5,5,GTGTTCGTAATTCTTCCTAA,0,424979
acrZp,0.16666666666666666,5,5,GTGGGATTATCGGTGTCAAT,0,433683
acrZp,0.16666666666666666,5,5,GTGAGGTGGGATGAATGAGT,0,414023
acrZp,0.16666666666666666,5,5,GTCTGGCACATCCTACGAGA,0,456783
acrZp,0.16666666666666666,5,5,GTCTACATCGTTAGGTGCGT,0,433715
acrZp,0.16666666666666666,5,5,GTACTTCGCGGGGGCATAAT,0,451853
acrZp,0.16666666666666666,5,5,GTAAGGTAAGGTATCACCAC,0,439486
acrZp,0.16666666666666666,5,5,GGTCGGCCGTCGTCTACCCA,0,460960
acrZp,0.16666666666666666,5,5,GGGTGGGCTGGCCGAGTATC,0,441703
acrZp,0.16666666666666666,5,5,GGGTGCAGATGTCACGCGTC,0,418331
acrZp,0.16666666666666666,5,5,GGCTCATCGAGATCCAATCC,0,451627
acrZp,0.16666666666666666,5,5,GGCTAGTCAAATGGTTAGCA,0,457645
acrZp,0.16666666666666666,5,5,GGCGTCGATAAAATCGTCTG,0,446786
acrZp,0.16666666666666666,5,5,GGCGGGGCTAGAAATCGGCT,0,429204
acrZp,0.16666666666666666,5,5,GGCCTTGATAGTAGACAGGA,0,448852
acrZp,0.16666666666666666,5,5,GGCAGTCCGTTGATATCATG,0,439458
acrZp,0.16666666666666666,5,5,GGATGACCAAGGGATACGTT,0,418329
acrZp,0.16666666666666666,5,5,GCTTTCCAACGGTAAGACTG,0,427556
acrZp,0.16666666666666666,5,5,GCTCTGACGATGCAATGGAA,0,456797
acrZp,0.16666666666666666,5,5,GCTCGATTAAGGGATCGGAA,0,459796
acrZp,0.16666666666666666,5,5,GCTCAATAGAGACAGGCTGT,0,434537
acrZp,0.16666666666666666,5,5,GCGGTGCGACAGTTTTATGA,0,451408
acrZp,0.16666666666666666,5,5,GCGGCAATGCCTACATAGTC,0,455090
acrZp,0.16666666666666666,5,5,GCGGACGGGAGGCACACGAT,0,458711
acrZp,0.16666666666666666,5,5,GCCTAGAACCGCAATTTCTA,0,438953
acrZp,0.16666666666666666,5,5,GCCACCATATGAGCGGAGCC,0,426636
acrZp,0.16666666666666666,5,5,GCATTGTGTCATGGGTGAGG,0,462490
acrZp,0.16666666666666666,5,5,GCACTCTAATAAAGCAGTGC,0,464640
acrZp,0.16666666666666666,5,5,GCACGTATTGTAGCGAGGAG,0,445003
acrZp,0.16666666666666666,5,5,GCACACATTTGACAGTAACT,0,454790
acrZp,0.16666666666666666,5,5,GATGAGTGTCCAAAGGTCCT,0,451813
acrZp,0.16666666666666666,5,5,GATCCGTACCCGCCCCAACT,0,428864
acrZp,0.16666666666666666,5,5,GAGTTTGTCTGAAACCGCGA,0,464361
acrZp,0.16666666666666666,5,5,GAGTGACTGACCTTAATCAG,0,430651
acrZp,0.16666666666666666,5,5,GAGTCGGCTCACGTACAAAT,0,449796
acrZp,0.16666666666666666,5,5,GAGGGATATCATTATTTTTA,0,457503
acrZp,0.16666666666666666,5,5,GAGGAAGACGGCTTCGCGAT,0,422803
acrZp,0.16666666666666666,5,5,GAGCGTACACGTGCAAGTAC,0,457820
acrZp,0.16666666666666666,5,5,GACTCACTGCAGCCTCGGGA,0,460356
acrZp,0.16666666666666666,5,5,GAAGGTTTTATCGCCGTAAC,0,433943
acrZp,0.16666666666666666,5,5,CTTGGTCAGTTTTAGTTATG,0,461276
acrZp,0.16666666666666666,5,5,CTTGGGAGGTTGCCTAACTT,0,446094
acrZp,0.16666666666666666,5,5,CTTGCACCACCCCAGCTTTT,0,461438
acrZp,0.16666666666666666,5,5,CTTCACACGTACTGTATGAG,0,456364
acrZp,0.16666666666666666,5,5,CTTACAATCGGATAAACAGT,0,431499
acrZp,0.16666666666666666,5,5,CTCTCGCTGGTGAATCATAC,0,437220
acrZp,0.16666666666666666,5,5,CTAAGATAACCGGCCTAGCT,0,411650
acrZp,0.16666666666666666,5,5,CGTTTGTGTATCTTGAACCG,0,435492
acrZp,0.16666666666666666,5,5,CGTTACGCTCCAAACCGGAT,0,432410
acrZp,0.16666666666666666,5,5,CGTCATGCCTGAGTGCCCCC,0,462554
acrZp,0.16666666666666666,5,5,CGGTGAGGAGTTGTATACGG,0,414445
acrZp,0.16666666666666666,5,5,CGCTTTTAGTTTTGTTAACG,0,417957
acrZp,0.16666666666666666,5,5,CGCTGCGGGCGCCGACGCGT,0,425744
acrZp,0.16666666666666666,5,5,CGCTAGTGGGACGGAGACAC,0,433832
acrZp,0.16666666666666666,5,5,CGCGATTCGAAGGGGACTTG,0,424907
acrZp,0.16666666666666666,5,5,CGCGATCGGGCAGAGACAAG,0,438233
acrZp,0.16666666666666666,5,5,CGCCTGGAGTCAATATGCCA,0,457636
acrZp,0.16666666666666666,5,5,CGCAAATTGGGCGCGCGTTA,0,455641
acrZp,0.16666666666666666,5,5,CGAGCTCAGTACCAGTCGGA,0,438791
acrZp,0.16666666666666666,5,5,CGAATACGCGTGGCATATTT,0,411961
acrZp,0.16666666666666666,5,5,CCTGCCCTCAGTCCCGTCTT,0,441252
acrZp,0.16666666666666666,5,5,CCTGAGGTGATGGGCAAGTA,0,419892
acrZp,0.16666666666666666,5,5,CCGTGGTGCGACCGGGTGCT,0,465621
acrZp,0.16666666666666666,5,5,CCGCAGGTCCAGAGTACGCT,0,437040
acrZp,0.16666666666666666,5,5,CCCTATTCTCCCACTAATAC,0,426531
acrZp,0.16666666666666666,5,5,CCCCGCTTCGTAGCTGGGTT,0,442114
acrZp,0.16666666666666666,5,5,CCCCGCAAGGGGATCACAAA,0,443850
acrZp,0.16666666666666666,5,5,CCCCATCGGGGTTGTGGAAC,0,455413
acrZp,0.16666666666666666,5,5,CCATTGGGAAACCGGATGTG,0,430817
acrZp,0.16666666666666666,5,5,CCAGAAATGAAGATTCCGGA,0,419274
acrZp,0.16666666666666666,5,5,CCAAGCGGGCCTGGAAGTAA,0,418765
acrZp,0.16666666666666666,5,5,CCAACCGTTAGGAGTAGAGA,0,446173
acrZp,0.16666666666666666,5,5,CATCAGCTTTGAAAACCGGT,0,424980
acrZp,0.16666666666666666,5,5,CATAAAGCCCTATTCCAAGG,0,464459
acrZp,0.16666666666666666,5,5,CAGTCGCTGTATCGGCAAAT,0,412410
acrZp,0.16666666666666666,5,5,CAGGGAAACTATATAGAAAT,0,430874
acrZp,0.16666666666666666,5,5,CACAGTAGACCTCCCCGGTC,0,417783
acrZp,0.16666666666666666,5,5,CAAGCATTACGGGCCGTCTA,0,419012
acrZp,0.16666666666666666,5,5,CAAAGACTGTTGGGGCCGAT,0,429240
acrZp,0.16666666666666666,5,5,CAAAGAAAACACGGAAACTT,0,451737
acrZp,0.16666666666666666,5,5,ATTAGGCGTCACGACTCCTG,0,420778
acrZp,0.16666666666666666,5,5,ATGTCAAACGGGATGATCGA,0,440549
acrZp,0.16666666666666666,5,5,ATGCCGCGGTGTGGATGTCT,0,413711
acrZp,0.16666666666666666,5,5,ATCTCCGTGCCGAGGTAGGG,0,437344
acrZp,0.16666666666666666,5,5,ATCAGTCTTCGCAGCGTCCG,0,467639
acrZp,0.16666666666666666,5,5,ATCACTATGATTTACTCTTT,0,412165
acrZp,0.16666666666666666,5,5,ATCACGGAAAGGGCACGCGC,0,414972
acrZp,0.16666666666666666,5,5,ATAGTCTCCCCACATATAAA,0,459134
acrZp,0.16666666666666666,5,5,ATAGGGCACGGCACGGTGAT,0,440452
acrZp,0.16666666666666666,5,5,ATAGAGCCCAGTTGTCAATG,0,462248
acrZp,0.16666666666666666,5,5,ATAATCGTTCTTGAACTATA,0,433635
acrZp,0.16666666666666666,5,5,AGTTTCCTTCAGGTAGGTTT,0,415752
acrZp,0.16666666666666666,5,5,AGTTGTATGCGACGGAGCGG,0,410702
acrZp,0.16666666666666666,5,5,AGGGACTCGGGAGTTCGAAT,0,451422
acrZp,0.16666666666666666,5,5,AGCTCGTCGGATTACAGGCG,0,450126
acrZp,0.16666666666666666,5,5,AGATCGATCGTGGTTCTGGG,0,465318
acrZp,0.16666666666666666,5,5,AGAGCGATCGGTCATCTTAT,0,463643
acrZp,0.16666666666666666,5,5,ACTTAGTACCCGTCCGCTCT,0,421521
acrZp,0.16666666666666666,5,5,ACTGCTACCGAACACGTTCC,0,421716
acrZp,0.16666666666666666,5,5,ACTGCGACGAGTAAATCAGA,0,434666
acrZp,0.16666666666666666,5,5,ACTCGGTTTTATTTACGTGT,0,451975
acrZp,0.16666666666666666,5,5,ACGCGGCGGTAGGCTAGGAA,0,418061
acrZp,0.16666666666666666,5,5,ACGACGATCACCGTTTACGG,0,432553
acrZp,0.16666666666666666,5,5,ACCTACGGCACGCTCAGTTC,0,421476
acrZp,0.16666666666666666,5,5,ACATAGTGAGCGGGTAGACG,0,435007
acrZp,0.16666666666666666,5,5,ACAGGCACGTACTAACCCGC,0,453569
acrZp,0.16666666666666666,5,5,AAGCTTAGATCCTGTTGGTC,0,446544
acrZp,0.16666666666666666,5,5,AAGCTCAGCCGGAGGTCTCG,0,430232
acrZp,0.16666666666666666,5,5,AACGTAGCCAAATGATGTCA,0,413067
acrZp,0.16666666666666666,5,5,AACAGGTACTTAAAAAGACT,0,438014
acrZp,0.16666666666666666,5,5,AAAGATCTCTGCCATCGGAG,0,420620
acrZp,0.16666666666666666,5,5,AAACCGAGGCAGGGAATCAT,0,463446
acrZp,0.16666666666666666,5,5,AAAATCATATAAGAATTGTC,0,442514
acrZp,0.16666666666666666,5,5,AAAACGCGTCTAAAGTGCAG,0,432912
acrZp,0.2,4,4,TTTTGCTATCGACGGACATA,0,430626
acrZp,0.2,4,4,TTTTGAAGTGCATCTGATAG,0,422142
acrZp,0.2,4,4,TTTGCATTGCGTATCGATGA,0,452337
acrZp,0.2,4,4,TTTAGACTAAGACTATCCGC,0,451145
acrZp,0.2,4,4,TTGTGGTGTTTCTAGGCATA,0,458493
acrZp,0.2,4,4,TTGTGAGGAAGGACTGACAT,0,420584
acrZp,0.2,4,4,TTGGCTGTTCCGAGTGCTCC,0,458066
acrZp,0.2,4,4,TTCGAGTTCTATCACCTTAT,0,435827
acrZp,0.2,4,4,TTCCCCCTCATGTTCGAGCT,0,448666
acrZp,0.2,4,4,TTAGATTCGACCGGCTATAG,0,439455
acrZp,0.2,4,4,TTAGACGAAGAAGTTCAATA,0,446760
acrZp,0.2,4,4,TGTCTTCTTTAGGTGACGAA,0,449281
acrZp,0.2,4,4,TGTCGCTGCTAGCATGCGAG,0,439462
acrZp,0.2,4,4,TGTCCTTCAGAGATAAACGC,0,434973
acrZp,0.2,4,4,TGTACGCCGTATGCAAATTA,0,444795
acrZp,0.2,4,4,TGGGGTCTTCCGCAATAAGC,0,454798
acrZp,0.2,4,4,TGCTCTTCATGGACCGAGCT,0,429699
acrZp,0.2,4,4,TGCCAGGAAGTTACTAGATT,0,459675
acrZp,0.2,4,4,TGCACGGCAAGTTACTCCGC,0,463136
acrZp,0.2,4,4,TGATACCAGTATTGTCGATT,0,450300
acrZp,0.2,4,4,TGAAGTTTGGGCCTGGGGGC,0,455788
acrZp,0.2,4,4,TCTTGTGTCAGACGGCGGAA,0,458611
acrZp,0.2,4,4,TCTTGCGAACCTCCGTGGCC,0,411013
acrZp,0.2,4,4,TCTGGGTCCAGTCCAGGAGC,0,423323
acrZp,0.2,4,4,TCTGGATCACTTTTGTCGAA,0,417037
acrZp,0.2,4,4,TCTAGTGTAAACCGGATGGC,0,409877
acrZp,0.2,4,4,TCGGTAACATTTCCTACAAC,0,444786
acrZp,0.2,4,4,TCGCTGGCGCATGCTCCTGA,0,417954
acrZp,0.2,4,4,TCCGGGCTCCACTGACACCG,0,425131
acrZp,0.2,4,4,TCCGAGCTTAGACGGCACAT,0,456580
acrZp,0.2,4,4,TCCAGGGCTGCGCATTGTGA,0,454478
acrZp,0.2,4,4,TCATGAGAGGGCTTCGCGGA,0,419949
acrZp,0.2,4,4,TCATATCATGGCCGCAAGGA,0,427121
acrZp,0.2,4,4,TCAGCTTCTTAGTGTCGCAG,0,423652
acrZp,0.2,4,4,TCAGCCAAGCATAAATTCGA,0,463517
acrZp,0.2,4,4,TCACAATGTCCGCCGATACT,0,425734
acrZp,0.2,4,4,TATCAGAAGATGCGGTGTCC,0,429378
acrZp,0.2,4,4,TAGGGATCGCAAGCGTGAAC,0,412983
acrZp,0.2,4,4,TAGCTTCTGAAGCACGGAAT,0,447862
acrZp,0.2,4,4,TACTGCAAGTGCAAGTACTA,0,409607
acrZp,0.2,4,4,TACCAAAAGCATACATAGGG,0,417997
acrZp,0.2,4,4,TACAGCACGACGATTCTGTC,0,420806
acrZp,0.2,4,4,TAATCTACTACGTGGCAGGC,0,434027
acrZp,0.2,4,4,TAAGCTACCAATAGAAGCAA,0,447671
acrZp,0.2,4,4,TAACTTTACTCAATCGTTTT,0,415183
acrZp,0.2,4,4,TAAATCGTTGTCAGCTCTTA,0,451459
acrZp,0.2,4,4,TAAACGCCCTCAGCGGCTCC,0,452372
acrZp,0.2,4,4,GTTTCTGTATGCTGGTAGAT,0,465507
acrZp,0.2,4,4,GTTGTGATGGATCCTCAAGG,0,436247
acrZp,0.2,4,4,GTTGATATGTCGTGAAGACA,0,436857
acrZp,0.2,4,4,GTTCCAAAGTAGATGGCAGG,0,464194
acrZp,0.2,4,4,GTGGGACATATGCTCAAAGG,0,416250
acrZp,0.2,4,4,GTGGACACCATAACGAGGGG,0,447310
acrZp,0.2,4,4,GTGCAGCGGTCCCTAGATGG,0,433759
acrZp,0.2,4,4,GTGACTTAACACCGAGTAGT,0,436101
acrZp,0.2,4,4,GTCTCCAATATGCGTAACGC,0,446643
acrZp,0.2,4,4,GTCCGGAAGTAGACCCGCCC,0,440403
acrZp,0.2,4,4,GTCAAGCTGTTTGGAGAGTC,0,436968
acrZp,0.2,4,4,GTATGCTACGGTGACATGGC,0,443115
acrZp,0.2,4,4,GTACTGATGGGGGTAAAGAC,0,421478
acrZp,0.2,4,4,GTACGTTCTCTCAAGGCCGT,0,453702
acrZp,0.2,4,4,GTACCCGAGGAGCTTACTAA,0,417186
acrZp,0.2,4,4,GTAAACAGCACGTGCATCAA,0,426401
acrZp,0.2,4,4,GGTCGGACCCGGAAAGATAT,0,427059
acrZp,0.2,4,4,GGTCATGGCGGATATGTTTT,0,428418
acrZp,0.2,4,4,GGTAATGATAAGGGGGTTTA,0,457190
acrZp,0.2,4,4,GGGTTAGCCTCGTGTAGGGT,0,448459
acrZp,0.2,4,4,GGGTACGCCTGTCGCCGTGG,0,424020
acrZp,0.2,4,4,GGGGCGCCGGGTGACAGGAG,0,445803
acrZp,0.2,4,4,GGGGAGCGCTCCCTCGACTA,0,442577
acrZp,0.2,4,4,GGGAGATCCTGCGAGATAGC,0,428357
acrZp,0.2,4,4,GGCTATATCGGGAGTTGAGG,0,424680
acrZp,0.2,4,4,GGCGTAGGTGAATAGCCTAT,0,456747
acrZp,0.2,4,4,GGCAGCGAAACCAGCCCGTT,0,416243
acrZp,0.2,4,4,GGCAGCATCTCCTTTACACG,0,445758
acrZp,0.2,4,4,GGATTACTTTCGTTAGAGTG,0,444964
acrZp,0.2,4,4,GGATGGCATCATGGGAGAAT,0,452571
acrZp,0.2,4,4,GGACAGATTGATTATGCTAC,0,443946
acrZp,0.2,4,4,GGACACGCAGATGGTCTGCG,0,447474
acrZp,0.2,4,4,GCTGTTTGGTATACCAGTCT,0,439928
acrZp,0.2,4,4,GCTGCAACGGCAGGAGGCTA,0,437957
acrZp,0.2,4,4,GCTGAGAGACTGCCGTAATT,0,420905
acrZp,0.2,4,4,GCTGACACCAGTGTCCTGCT,0,466939
acrZp,0.2,4,4,GCTCGAACTCATACAAGATA,0,462657
acrZp,0.2,4,4,GCTACCTGTTAATAGTGGTG,0,456947
acrZp,0.2,4,4,GCTAATTGCCCAGGTCGAGT,0,456084
acrZp,0.2,4,4,GCGTGACCTTAGGCCTACGT,0,459545
acrZp,0.2,4,4,GCGTGAAGAAGATCGTGATC,0,417833
acrZp,0.2,4,4,GCGCTCCTAGCGTGGGCGTA,0,455237
acrZp,0.2,4,4,GCGCCAGTACGCAGGATCAT,0,432587
acrZp,0.2,4,4,GCGCAGTCTAGTACCTTAAC,0,440931
acrZp,0.2,4,4,GCGACTCACAAAACCAAGAA,0,426637
acrZp,0.2,4,4,GCGACGCTGTATCTGTCAGG,0,457307
acrZp,0.2,4,4,GCCTCCTGACAAGCATGTCC,0,415779
acrZp,0.2,4,4,GCCAGAGCGACACTCATCTG,0,425871
acrZp,0.2,4,4,GCCACCGGCTCACCGAGGCG,0,459795
acrZp,0.2,4,4,GCAGAGCAGAAGGTACAACT,0,460597
acrZp,0.2,4,4,GCACTGAAGAATACATAGTC,0,424712
acrZp,0.2,4,4,GCAAAGCCCAAGGGTTTCCG,0,458562
acrZp,0.2,4,4,GATGTGATCCCAAGTCCGCA,0,414920
acrZp,0.2,4,4,GAGTGTCGTACCTCTTGCAT,0,411403
acrZp,0.2,4,4,GAGTCATAGACGCGGGGTTC,0,444821
acrZp,0.2,4,4,GAGTACAGGGTACGGATAGG,0,423915
acrZp,0.2,4,4,GAGCGTCTACAATACTGAAA,0,455496
acrZp,0.2,4,4,GAGAGGAAACCATGCCCGGG,0,417615
acrZp,0.2,4,4,GAGACCTGCTCATGGATCTC,0,443492
acrZp,0.2,4,4,GAGACCGTGCGGGCTCAGGA,0,414027
acrZp,0.2,4,4,GACTACAGATCCAATCTGAT,0,418596
acrZp,0.2,4,4,GACCAAGACAAGAAAGATTC,0,442746
acrZp,0.2,4,4,GACATGCCTTCCCTTATCGA,0,451311
acrZp,0.2,4,4,GACATGATCTGGACATCCCC,0,435901
acrZp,0.2,4,4,GAATTCTTAACCAATTAAGT,0,416830
acrZp,0.2,4,4,GAAGGAGAGAGCTAGGAGCA,0,443121
acrZp,0.2,4,4,CTTTTATGTATATGGTGTTG,0,426562
acrZp,0.2,4,4,CTTGTCGGTGTACTTACCCG,0,423774
acrZp,0.2,4,4,CTTGGTCAACAAATTAGTTA,0,415745
acrZp,0.2,4,4,CTTGATAAGATAGTTAGTGG,0,457197
acrZp,0.2,4,4,CTTAGTGCTTGAATTGAATA,0,412407
acrZp,0.2,4,4,CTGTCTATCTTTGGTATCGT,0,463726
acrZp,0.2,4,4,CTGGTGGCCGGCAAACGTTG,0,425558
acrZp,0.2,4,4,CTGGCACAGGTAGCCTTTTA,0,425235
acrZp,0.2,4,4,CTGGATCCGCGCCTTAGCGG,0,462459
acrZp,0.2,4,4,CTGCTCTTAAGTTGGGAGAC,0,428912
acrZp,0.2,4,4,CTCTCGGCGGTACTTGATAC,0,416918
acrZp,0.2,4,4,CTCTACCGTTTGCCCGGCGC,0,426558
acrZp,0.2,4,4,CTCATACCTGGCTTTCTTGA,0,437359
acrZp,0.2,4,4,CTATTCATTGATGGCTGGGG,0,438429
acrZp,0.2,4,4,CTATTAGTCTTTTGGCCAAT,0,433322
acrZp,0.2,4,4,CTAGAGGCGAGCGTAAGCCA,0,457932
acrZp,0.2,4,4,CTAGAGCAGCTATATTGCTT,0,422116
acrZp,0.2,4,4,CTAAGGAGTGGGGAGTTCCG,0,447313
acrZp,0.2,4,4,CTAACGGAGCGAAGGGCTAT,0,419480
acrZp,0.2,4,4,CGTTGTATGCGCATTCGTTA,0,450956
acrZp,0.2,4,4,CGTTACGCAGGCAGTCGGCT,0,421788
acrZp,0.2,4,4,CGTGTCATCAGTTGTGTTGT,0,425549
acrZp,0.2,4,4,CGTGGGCTGACTGTAACATG,0,460133
acrZp,0.2,4,4,CGTCATAACGTTTCTGCGGT,0,438160
acrZp,0.2,4,4,CGTACTGCGCGCCCCTATGC,0,461989
acrZp,0.2,4,4,CGGTTCATAGGCGGGAATCT,0,454941
acrZp,0.2,4,4,CGGGTTCACGGCTTAAGACG,0,423238
acrZp,0.2,4,4,CGGCTACTTGAGACCTATGT,0,435665
acrZp,0.2,4,4,CGGCGTCCTTTCCGCTCACC,0,457439
acrZp,0.2,4,4,CGGATAATGCTCAGGAGATT,0,438021
acrZp,0.2,4,4,CGCGGTGCTCGCTTATAGAT,0,420138
acrZp,0.2,4,4,CGAGTAATGTCAGTCGCCTT,0,457767
acrZp,0.2,4,4,CGACACTACCAACCGTGTCA,0,457900
acrZp,0.2,4,4,CGAAGGTACTGGGGGCAACA,0,411645
acrZp,0.2,4,4,CCTGTTGACACCAAGCGAGG,0,413844
acrZp,0.2,4,4,CCTGTCAGCGAATCGGGAAC,0,410820
acrZp,0.2,4,4,CCTCGCCCGGGACGCTTCGG,0,448943
acrZp,0.2,4,4,CCTCATTAATGGTTTTGACA,0,446356
acrZp,0.2,4,4,CCGTTCAGTTTATGAGTCCC,0,450763
acrZp,0.2,4,4,CCGGAGTTGGTTCGTCGCAT,0,418770
acrZp,0.2,4,4,CCGCAGCCGAGGAGCTTAAG,0,408953
acrZp,0.2,4,4,CCGCACGATCAAGAGAACAA,0,460057
acrZp,0.2,4,4,CCGACCATTGCAATTACTGC,0,437305
acrZp,0.2,4,4,CCCGATAGTCTTTAATATCA,0,465100
acrZp,0.2,4,4,CCCGAGGACCCTTGCTCCTA,0,450421
acrZp,0.2,4,4,CCCCGCGGCTTCTAGCCCGT,0,423022
acrZp,0.2,4,4,CCCATCGTCGAGTGATTTCG,0,409470
acrZp,0.2,4,4,CCCAGAATAGAGGACGCTAA,0,434817
acrZp,0.2,4,4,CCATTGTCGCGTGGCGACCT,0,431911
acrZp,0.2,4,4,CCATTCTCTCGTAAGCCACT,0,432256
acrZp,0.2,4,4,CCATGAATAGTCAGGATGCG,0,428915
acrZp,0.2,4,4,CCATCGAGTCCTGCAAGACT,0,429527
acrZp,0.2,4,4,CCAAGTTAGCTCATACCAAG,0,442227
acrZp,0.2,4,4,CATCACTGGGTGCAAAACCG,0,457168
acrZp,0.2,4,4,CATATAGTCTAGGTGAGTGT,0,421676
acrZp,0.2,4,4,CATACTACAACGGCGGCGCT,0,444046
acrZp,0.2,4,4,CATACAGCGGAATGGCTGCG,0,417045
acrZp,0.2,4,4,CAGTTGGGCCTAAACGGCTT,0,408751
acrZp,0.2,4,4,CAGTCGTTAGGCGAAGCCGA,0,437045
acrZp,0.2,4,4,CAGGATTAGGGGTACACTTT,0,428875
acrZp,0.2,4,4,CAGGATATAAGTGTCCCTGC,0,416045
acrZp,0.2,4,4,CACCTCGTTCCACAATTATG,0,411386
acrZp,0.2,4,4,CACCCAGCGAGGGTTAATGC,0,415436
acrZp,0.2,4,4,CACACGCCTCGGTCTGGATA,0,418026
acrZp,0.2,4,4,CACACCTTGGCAGGGTTGAG,0,415912
acrZp,0.2,4,4,CACAATCCGGCATGGGGTGC,0,441918
acrZp,0.2,4,4,CACAACAGGAGGCGGAGGTC,0,454028
acrZp,0.2,4,4,CAATGCTCGTACTCGGAATG,0,444459
acrZp,0.2,4,4,CAAGCCTCTTTATGTGATGG,0,446722
acrZp,0.2,4,4,ATTTGACCGGGGGGTTTAAG,0,432637
acrZp,0.2,4,4,ATTTAAAGAATCGGTTACCA,0,433039
acrZp,0.2,4,4,ATTCCGCCTTTGTAATCTCT,0,438005
acrZp,0.2,4,4,ATGTAATACAGGATGGACAG,0,430605
acrZp,0.2,4,4,ATGGACGTTACTTCTGAAAG,0,442816
acrZp,0.2,4,4,ATGCACCTGGTACGACCAGA,0,463486
acrZp,0.2,4,4,ATGCAAGTTCAATAGACAGT,0,458907
acrZp,0.2,4,4,ATGAGTATCGCGCATTACAA,0,412050
acrZp,0.2,4,4,ATCTTCTGGTTACGTGCAGT,0,441336
acrZp,0.2,4,4,ATCTTAGCTTAAGCAGCATT,0,453140
acrZp,0.2,4,4,ATCTCCAGGAACCCACGTCA,0,465016
acrZp,0.2,4,4,ATCATTGGTTCGGTAACGAG,0,447338
acrZp,0.2,4,4,ATCAACTCACAATTAGTCAA,0,447289
acrZp,0.2,4,4,ATAGGGGACAGCCACTCCCC,0,448020
acrZp,0.2,4,4,ATAATGTACTTAACCAGTTC,0,432350
acrZp,0.2,4,4,ATAATGCACTGCATCGTGAT,0,414559
acrZp,0.2,4,4,AGTTCAACCAGGGCCGAGGA,0,428272
acrZp,0.2,4,4,AGTGGCGAGCTAACGATTCC,0,416621
acrZp,0.2,4,4,AGTGACATGGCCGGGCATAA,0,441032
acrZp,0.2,4,4,AGTCAAATCAAGGGCTGAAA,0,465022
acrZp,0.2,4,4,AGGTGGAATTAGAGTCCGCT,0,423105
acrZp,0.2,4,4,AGGCCTCGCCTCCTACTGGT,0,441905
acrZp,0.2,4,4,AGGAGACATAACTACCATGC,0,440822
acrZp,0.2,4,4,AGCCTAGATGGGCCGTTTAT,0,461535
acrZp,0.2,4,4,AGCCGGGTGATCATCGAAAG,0,440709
acrZp,0.2,4,4,AGATAAATCTTAGGTGGCAT,0,426298
acrZp,0.2,4,4,AGAGTAGGAGCAATGTGGGA,0,428870
acrZp,0.2,4,4,AGAACACTCTCAACTCGTAC,0,423737
acrZp,0.2,4,4,ACTTTACGGTAGTGGCTCAT,0,413763
acrZp,0.2,4,4,ACTGTGAACGCAGCTTGCTT,0,419851
acrZp,0.2,4,4,ACTGGATGGCCACATAGTCC,0,460169
acrZp,0.2,4,4,ACTGACCGGGGGAACCCGTT,0,440837
acrZp,0.2,4,4,ACTAATGAGCATGCACGGAT,0,435276
acrZp,0.2,4,4,ACGCTACTAGCTCACCTAGA,0,437721
acrZp,0.2,4,4,ACCTGTGTATCCAGGTGGCC,0,435537
acrZp,0.2,4,4,ACCTGATAGAGCGTACAGCC,0,451004
acrZp,0.2,4,4,ACCGGCCCCCCGTTAGTATT,0,461548
acrZp,0.2,4,4,ACCCTTGCAAACACGGAAAG,0,424964
acrZp,0.2,4,4,ACCATAGGGGATCAAACGTG,0,439319
acrZp,0.2,4,4,ACAGGGAGAGCAAACATGTA,0,422165
acrZp,0.2,4,4,ACAGAGGCCCGACTTTAAGG,0,420170
acrZp,0.2,4,4,ACAACTTGGGGTCCTGAGTT,0,431145
acrZp,0.2,4,4,AATTTTGTCTTCTAGTAGAA,0,429737
acrZp,0.2,4,4,AATGCCCCTAGATTGCGATA,0,410109
acrZp,0.2,4,4,AATCAGGGTGATATTAGACA,0,467281
acrZp,0.2,4,4,AAGTCTTAAATCGAGGTATG,0,454340
acrZp,0.2,4,4,AAGTCAGAGCTGTTCTAGTA,0,429066
acrZp,0.2,4,4,AAGATATGCGGAGAGTTAGG,0,414447
acrZp,0.2,4,4,AAGAGAAGCGTGCTTTTAGT,0,457914
acrZp,0.2,4,4,AAGACAACCTGCGGTGACCT,0,432153
acrZp,0.2,4,4,AAGAACAATCGCCGGGGACA,0,415188
acrZp,0.2,4,4,AACGAGGTTAGACAAGCAAA,0,449811
acrZp,0.2,4,4,AACCATTTTTAAGTGCTGTG,0,448564
acrZp,0.2,4,4,AACCAATGCCGGGACATTCG,0,457037
acrZp,0.2,4,4,AACAGTTGTATTTCGCACAT,0,432844
acrZp,0.2,4,4,AAAGCATCTACGCTGGCATG,0,442966
acrZp,0.2,4,4,AAAATTACAAAGGATAGGGT,0,457993
acrZp,0.25,3,3,TTTTGCAACAAGAACGCGGC,0,440670
acrZp,0.25,3,3,TTTTATTTATGGACTGAACA,0,415605
acrZp,0.25,3,3,TTTGTTTCCTTCTACGGTCA,0,455414
acrZp,0.25,3,3,TTTGCGACATAGCCTCTTTG,0,438922
acrZp,0.25,3,3,TTTCGATGCACTTGGGTAAC,0,433027
acrZp,0.25,3,3,TTTCAATAATGTTAGGAATC,0,431319
acrZp,0.25,3,3,TTTATCTCGTCTATAGCTTT,0,453295
acrZp,0.25,3,3,TTTAGTGTCCGAAAAGTTAT,0,435176
acrZp,0.25,3,3,TTTAAAGGGCTCTGGAATAA,0,431956
acrZp,0.25,3,3,TTGTTCGCGCGCTCTGTTAT,0,448390
acrZp,0.25,3,3,TTGTGGATCTGGGTTAAACA,0,459023
acrZp,0.25,3,3,TTGGTCTGGTATGCCCAGAT,0,424182
acrZp,0.25,3,3,TTGGACGTCCTTGTGTATGT,0,432398
acrZp,0.25,3,3,TTGCTAGGTAGAAACATACG,0,423215
acrZp,0.25,3,3,TTGCGGACATGTCGGATCTT,0,442988
acrZp,0.25,3,3,TTCTCAGTGGCTGTGGACCT,0,451015
acrZp,0.25,3,3,TTCTATTAGTTGTTTGTTGA,0,434701
acrZp,0.25,3,3,TTCTAGAAGCAATGTCATTA,0,466086
acrZp,0.25,3,3,TTCGTGCCGCCAAATTTGGA,0,416829
acrZp,0.25,3,3,TTCGCCCTCCACCGGTATCG,0,438866
acrZp,0.25,3,3,TTCGATTCGACGACTAACGG,0,414363
acrZp,0.25,3,3,TTCAAACTTCAGGAGGGGCT,0,463717
acrZp,0.25,3,3,TTATTCCGTCGATGCCGACT,0,447116
acrZp,0.25,3,3,TTAGATCTGTTTGTAAAGTC,0,445525
acrZp,0.25,3,3,TTACTTCTAAAGGACCCCGT,0,436948
acrZp,0.25,3,3,TTACAGTCTTAGGCTAGAGC,0,410826
acrZp,0.25,3,3,TTAAAGACTAGCTGATATGT,0,423750
acrZp,0.25,3,3,TGTTTCAGGATTTAAAATGG,0,459390
acrZp,0.25,3,3,TGTGCCCGAGCTTACGACGG,0,430592
acrZp,0.25,3,3,TGTGACCAGGAGCTCTGTGG,0,427738
acrZp,0.25,3,3,TGTCGGCAGATAAAGTTGGT,0,445761
acrZp,0.25,3,3,TGTCCCATAGTAGTGACCTG,0,448295
acrZp,0.25,3,3,TGTCAGAAAATCTCGCCCTA,0,414607
acrZp,0.25,3,3,TGGTGCATTGGATGTGGCGG,0,434259
acrZp,0.25,3,3,TGGTATTCCGCTGCACGTGT,0,415315
acrZp,0.25,3,3,TGGCGCCCGACGGGGCTAAT,0,452932
acrZp,0.25,3,3,TGGCCCTATGCTAGATACAA,0,422416
acrZp,0.25,3,3,TGGCAAAAGAGGAAACACAC,0,464037
acrZp,0.25,3,3,TGCTTTATGCCTGTGATGAA,0,433731
acrZp,0.25,3,3,TGCTAATGCAGGGAACCTAG,0,451600
acrZp,0.25,3,3,TGCGTCCCGGGAGACAGTCT,0,419270
acrZp,0.25,3,3,TGCGAAACAGGCCCGCGGAT,0,441296
acrZp,0.25,3,3,TGCCGGCGGTATATTTGACC,0,438561
acrZp,0.25,3,3,TGCCCCAGTAACAAGGGTTT,0,458663
acrZp,0.25,3,3,TGCCCACTAGGGTAGGCGAA,0,431291
acrZp,0.25,3,3,TGCCAGTCGGAGGTAGCTAT,0,418029
acrZp,0.25,3,3,TGATGTTCAGGCATGGACGA,0,460467
acrZp,0.25,3,3,TGAGCTCGGGCCTGGACTAT,0,425750
acrZp,0.25,3,3,TGAGATGATTGTCCATTGCA,0,453859
acrZp,0.25,3,3,TGAGAGAATTACAACTGAAC,0,442172
acrZp,0.25,3,3,TGACGTCCCAGAGCAAGCCC,0,456407
acrZp,0.25,3,3,TGACCAACCGGTGGATGCGC,0,448085
acrZp,0.25,3,3,TCTTGGGTGTCATATTTGTT,0,434076
acrZp,0.25,3,3,TCTTGCAATCTAGCCAACTC,0,416057
acrZp,0.25,3,3,TCTGTGGCAGTGGGAGCCAT,0,464101
acrZp,0.25,3,3,TCTGCTCTTCTGGGGGTTCT,0,411673
acrZp,0.25,3,3,TCTCGGTGTCACAGGTCAGA,0,419465
acrZp,0.25,3,3,TCTCAACTTCCTTTGATCTA,0,421307
acrZp,0.25,3,3,TCGGTCTAACCTTTGCAGTT,0,430055
acrZp,0.25,3,3,TCGGTCGCCCAGTTGTAGCG,0,421390
acrZp,0.25,3,3,TCGGGTAGATATGCAGCTGT,0,411901
acrZp,0.25,3,3,TCGGGGGTTTAGGCTAGTGA,0,435812
acrZp,0.25,3,3,TCGGGGGCCTCGGATGTGTC,0,412980
acrZp,0.25,3,3,TCGGGGACAATGGACTTTCC,0,426934
acrZp,0.25,3,3,TCGGCACGCACCCTATGAAT,0,419080
acrZp,0.25,3,3,TCGCCTCAGTTTGACAGACA,0,466935
acrZp,0.25,3,3,TCGACTCAAAGCCTAGATGT,0,451357
acrZp,0.25,3,3,TCCTGCAAGGGTCGCAAATC,0,416456
acrZp,0.25,3,3,TCCTCATCCCAAGGAAGAGA,0,442225
acrZp,0.25,3,3,TCCGCCGACGACAAGCCCTC,0,441588
acrZp,0.25,3,3,TCCCTGCGGGACCGAGATGT,0,446245
acrZp,0.25,3,3,TCCCCAGTTTTAGAATGCGT,0,439794
acrZp,0.25,3,3,TCCCAGGTGTGTTCACACGG,0,460747
acrZp,0.25,3,3,TCCAGGACCCGATAGTCAGT,0,457918
acrZp,0.25,3,3,TCAGGCCCCTACCTTTTACC,0,414858
acrZp,0.25,3,3,TCAGATTTAAAAGTCGAACT,0,415002
acrZp,0.25,3,3,TCAGAGCTGCGTACATGTGC,0,419269
acrZp,0.25,3,3,TCACGTTCGCGCATATTCCG,0,410090
acrZp,0.25,3,3,TCACGCTTTAATATACGTCT,0,454289
acrZp,0.25,3,3,TATGAATGGGTCCGCGTGAT,0,429353
acrZp,0.25,3,3,TATCGAACTCGCGAGGACCA,0,438605
acrZp,0.25,3,3,TATAGAGACTGAGCCCACTT,0,417240
acrZp,0.25,3,3,TAGATGTTTGGGAATTCACT,0,442393
acrZp,0.25,3,3,TAGATGGGTTGTTTCCGACG,0,463321
acrZp,0.25,3,3,TAGAGGCGATATAAGCAGTG,0,461127
acrZp,0.25,3,3,TAGACATGCGTAAGACTCGA,0,435502
acrZp,0.25,3,3,TACTTTCCGTATTCTCGTGG,0,446633
acrZp,0.25,3,3,TACTGCTCCCAGGAAAAATT,0,425439
acrZp,0.25,3,3,TACGTCACATTACACGTGCT,0,449741
acrZp,0.25,3,3,TACGGCCCCCAGCGTGGCGG,0,465398
acrZp,0.25,3,3,TACGCAGGTTCCTTAAATCA,0,435680
acrZp,0.25,3,3,TACCCCAGTAGTTGACTCAG,0,441548
acrZp,0.25,3,3,TACATACGTTACAGCTATGG,0,411327
acrZp,0.25,3,3,TACACTAAAGCGTCGGTGCC,0,414405
acrZp,0.25,3,3,TAATAATAACGGGATAAAAG,0,424536
acrZp,0.25,3,3,TAAGAGATAAACTAACAGTA,0,461478
acrZp,0.25,3,3,TAACAAGAGTACCTGCCTAA,0,427071
acrZp,0.25,3,3,TAAAGCGGTGACTGCAACAT,0,441528
acrZp,0.25,3,3,TAAACCGGAGCCCGGACGAT,0,452628
acrZp,0.25,3,3,GTTTGCCTGCTTCAGAGTTC,0,419407
acrZp,0.25,3,3,GTTTGCATTAGGCATGCCGC,0,456639
acrZp,0.25,3,3,GTTTCTAGCGCTGACGTCCG,0,462829
acrZp,0.25,3,3,GTTGCTTCTCAGGATTCATG,0,414561
acrZp,0.25,3,3,GTTGCATACGGAAACAGTCC,0,425179
acrZp,0.25,3,3,GTTCTCGTAAAGCGGGAACC,0,410884
acrZp,0.25,3,3,GTGTTCTATCAGTCACGCGC,0,466635
acrZp,0.25,3,3,GTGTTCATAGGGTTTTGGCA,0,409365
acrZp,0.25,3,3,GTGTATTAAACGTAGGTCTA,0,411840
acrZp,0.25,3,3,GTGGGTGCGGTTAATAAAGG,0,438890
acrZp,0.25,3,3,GTGGGCGTTAAAGGTATGCA,0,441457
acrZp,0.25,3,3,GTGCTCGATAGCCCAGTGAG,0,435129
acrZp,0.25,3,3,GTGATGGCATCACACATGCA,0,410823
acrZp,0.25,3,3,GTGATAGGCTCCTAATGATA,0,425413
acrZp,0.25,3,3,GTGAAGGTCACCATTGGGAA,0,439056
acrZp,0.25,3,3,GTCTCTCTTCCGGGGCTTAT,0,431679
acrZp,0.25,3,3,GTCTAAGTTGTGTCGTACGT,0,411892
acrZp,0.25,3,3,GTCGTTCAATTGGGTTCCCA,0,441755
acrZp,0.25,3,3,GTCCAGACCTTCTCCGGTCC,0,466385
acrZp,0.25,3,3,GTCAGGCCAGAGTTAGGCGT,0,430892
acrZp,0.25,3,3,GTCAGCTGAGTCCTAGAAAG,0,463747
acrZp,0.25,3,3,GTCAAGCCTAATGTCCCACT,0,419466
acrZp,0.25,3,3,GTACCAGAGGCGCACTCAGC,0,413294
acrZp,0.25,3,3,GTACAGGATGGCGCTTTATT,0,438457
acrZp,0.25,3,3,GTAAGAACGGCGGGTCGATT,0,434819
acrZp,0.25,3,3,GTAAAGCATGTAGAGCGTAA,0,431908
acrZp,0.25,3,3,GGTTTTCGCGTTTTCCGGCG,0,460466
acrZp,0.25,3,3,GGTGTTACGTTATTCGTGAT,0,419124
acrZp,0.25,3,3,GGTGGACCTCACTAGACAGG,0,434915
acrZp,0.25,3,3,GGTCTTGGATAAACATAACT,0,463008
acrZp,0.25,3,3,GGGTGCGCTGCTACTGGTGA,0,438318
acrZp,0.25,3,3,GGGTCAGTGCGACGCAAGCG,0,431205
acrZp,0.25,3,3,GGGTAAATGAACTAACTGCT,0,438423
acrZp,0.25,3,3,GGGGTTGTACACTATTAGAC,0,431373
acrZp,0.25,3,3,GGGGCACGCCGTGAAAATGT,0,452822
acrZp,0.25,3,3,GGGCTGGTAGCGAAAGGTGT,0,416547
acrZp,0.25,3,3,GGGCGGAAACGAGGATTAAA,0,465264
acrZp,0.25,3,3,GGGAGGATTGTTTGCGCCAT,0,417296
acrZp,0.25,3,3,GGGAATAGGCGTTAATCATA,0,438797
acrZp,0.25,3,3,GGCTTAGACGGTTATGTATC,0,421388
acrZp,0.25,3,3,GGCTCTGTGTTTTCGCTAGT,0,430209
acrZp,0.25,3,3,GGCGTACCAAGATTTCGTAC,0,460208
acrZp,0.25,3,3,GGCCGTGCGAGGTTGGCAAT,0,451166
acrZp,0.25,3,3,GGCCGTCCAACGCCAGGCCT,0,412823
acrZp,0.25,3,3,GGCCAATTCTCTAATGACAG,0,453149
acrZp,0.25,3,3,GGCATCTGTGGGTCCGAGAT,0,467470
acrZp,0.25,3,3,GGATGATGCGTTACGCTGAT,0,425164
acrZp,0.25,3,3,GGAGTGTGTAGTAAGGAATA,0,422492
acrZp,0.25,3,3,GGAGTCACCTGAGAGGTTCA,0,427986
acrZp,0.25,3,3,GGACCCAGGGCGCTCCGGTA,0,441335
acrZp,0.25,3,3,GCTCACGACAAACTGTCATA,0,418445
acrZp,0.25,3,3,GCTCAATCTTCCATCGCATT,0,409896
acrZp,0.25,3,3,GCTAGATGTGGCGCACGCAA,0,448476
acrZp,0.25,3,3,GCTACTTAAATCATGCCGCC,0,451444
acrZp,0.25,3,3,GCTACCGGCCGCAGGTCGTA,0,450303
acrZp,0.25,3,3,GCGGGTTTTTTAGCGTAGGA,0,437388
acrZp,0.25,3,3,GCGGGAGATTCAGGTCCAAT,0,449877
acrZp,0.25,3,3,GCGCTCGGGAGGTACTGAAG,0,411545
acrZp,0.25,3,3,GCGCCCAATAAGTGACCTGA,0,436356
acrZp,0.25,3,3,GCCTTTCTAGGGAGGGCGGG,0,416713
acrZp,0.25,3,3,GCCTGGGGTGGTGTGGATTA,0,422909
acrZp,0.25,3,3,GCCGTGGTCTCGGGCGCCCC,0,454156
acrZp,0.25,3,3,GCCCTGCCTCCTTTGGCTTA,0,438018
acrZp,0.25,3,3,GCCCTACATGGATTGTTCTT,0,423109
acrZp,0.25,3,3,GCCATTCCCATATTCGGCTA,0,432577
acrZp,0.25,3,3,GCCAGAGCCCATCTCGCGTT,0,444424
acrZp,0.25,3,3,GCATTCTAACTACTGCAGGT,0,418101
acrZp,0.25,3,3,GCATCCTACGCGTATGATGT,0,437910
acrZp,0.25,3,3,GCAGGCTGCCACAAGGACAA,0,414770
acrZp,0.25,3,3,GCAGGAGGTCAATGGGGAAC,0,461202
acrZp,0.25,3,3,GCACTGGCATCACATCGTTG,0,441983
acrZp,0.25,3,3,GCACGGTCAGCGGGGGTCAA,0,460241
acrZp,0.25,3,3,GCACACTATACTGACAGTCT,0,433920
acrZp,0.25,3,3,GCACAAATGCTTCGCGTGCA,0,414403
acrZp,0.25,3,3,GCAACAGTACCATTAGACCA,0,424378
acrZp,0.25,3,3,GCAACACGATGGATGAAGAC,0,423448
acrZp,0.25,3,3,GATGGCACAAGCCGCTTGTC,0,435933
acrZp,0.25,3,3,GATCGTTCATGCCGTTTAAC,0,435076
acrZp,0.25,3,3,GATACAGGTGTGGGTCAGAG,0,431640
acrZp,0.25,3,3,GAGTGTATAACTCGGGCACA,0,424125
acrZp,0.25,3,3,GAGGCCGGGCGTGATTGGTA,0,419973
acrZp,0.25,3,3,GAGGAAGCTAGAAGGGTGGG,0,457532
acrZp,0.25,3,3,GAGCTCAAATACGGCCATCA,0,411828
acrZp,0.25,3,3,GACTGTGTCTCTACGGTACG,0,445137
acrZp,0.25,3,3,GACGGAACCCGCATTTTTCC,0,463956
acrZp,0.25,3,3,GACGCAGGTCCAGACGATGG,0,411782
acrZp,0.25,3,3,GACCATTGTCAGTCATACAT,0,408610
acrZp,0.25,3,3,GACACCATAGGCGTTGACGA,0,448471
acrZp,0.25,3,3,GAATCGGGTTCGTCTCATGT,0,423909
acrZp,0.25,3,3,GAATAAGGTGGTTCTGTAGG,0,457862
acrZp,0.25,3,3,GAAGGTGTGAACCGGGTCTG,0,457146
acrZp,0.25,3,3,GAAGCGACTATAGATAGGGC,0,432556
acrZp,0.25,3,3,GAAATGGCACTATGCCACGG,0,431555
acrZp,0.25,3,3,GAAATCCCACTGAATTGCAT,0,432314
acrZp,0.25,3,3,CTTTTTTAGGATTTTTCGGA,0,425359
acrZp,0.25,3,3,CTTTGCTGTAAGTGGGTTTC,0,448959
acrZp,0.25,3,3,CTTTCGGAACCGGCTATATA,0,446412
acrZp,0.25,3,3,CTTTCCGTTGCATCGACTTC,0,423966
acrZp,0.25,3,3,CTTGTTCGCAAATTATCGTG,0,450340
acrZp,0.25,3,3,CTTGGATGCTGATAACGCGG,0,414404
acrZp,0.25,3,3,CTTGCGCAAGATATTCCCTG,0,443885
acrZp,0.25,3,3,CTTGCAGTTGCGAGTGATAA,0,440750
acrZp,0.25,3,3,CTTAGTGACCAGAACCTCAC,0,424422
acrZp,0.25,3,3,CTTACAGACTTACAGAATTA,0,437497
acrZp,0.25,3,3,CTGGGAAATCGTAATGTGGG,0,428462
acrZp,0.25,3,3,CTGGCCGGTGGTCGTCAGTC,0,436567
acrZp,0.25,3,3,CTGGAATCAGCCTTAGAAGT,0,425077
acrZp,0.25,3,3,CTGCATGTCGAACTTAAAGC,0,436983
acrZp,0.25,3,3,CTGATCTCACACGAGTACAG,0,440673
acrZp,0.25,3,3,CTGAGGAAAGGCTGGTAGGG,0,450911
acrZp,0.25,3,3,CTGAATTCCCTTTGCACTGA,0,426461
acrZp,0.25,3,3,CTCTGTACCGAGAGTTGTGC,0,427061
acrZp,0.25,3,3,CTCTAGGCATTATATACCTG,0,451685
acrZp,0.25,3,3,CTCGGCCGGGATGTTCCGTG,0,426604
acrZp,0.25,3,3,CTCGCGTGCCAATCATACGG,0,437431
acrZp,0.25,3,3,CTCCTCTGCCTAGGATCTCG,0,438421
acrZp,0.25,3,3,CTCCTAATCTCAAGCCATTC,0,450907
acrZp,0.25,3,3,CTCAAATATTAGGTTGGCTA,0,444992
acrZp,0.25,3,3,CTATGTTAGCCCGCGAGTGA,0,457145
acrZp,0.25,3,3,CTATGGCCCGAAGGCAGGTC,0,438887
acrZp,0.25,3,3,CTAGTGCCCATGTATGAGAG,0,416520
acrZp,0.25,3,3,CTAGGCCGCAGGAGCGAGGA,0,459763
acrZp,0.25,3,3,CTAGAGGATCGAAGTTATGG,0,438820
acrZp,0.25,3,3,CTACTGCTGCACGCGGCAAG,0,417864
acrZp,0.25,3,3,CTACCAGCTACTGGTATGGC,0,435126
acrZp,0.25,3,3,CTACATCCCGGAGGACTTGA,0,440494
acrZp,0.25,3,3,CTACAATGAAACCCGATCCC,0,455035
acrZp,0.25,3,3,CGTTTTAACGAGGTTTGGCA,0,462884
acrZp,0.25,3,3,CGTTTGTAATTTGCACGTTT,0,456602
acrZp,0.25,3,3,CGTTTGAGCTGGGCTATACA,0,438425
acrZp,0.25,3,3,CGTTCGGCTCGTCTGCGTGC,0,458270
acrZp,0.25,3,3,CGTTAGACATAGACACCCCC,0,422110
acrZp,0.25,3,3,CGTGGGGGAAGCTTTGGATG,0,433775
acrZp,0.25,3,3,CGGTTGTAGGTGAAATGCTG,0,440191
acrZp,0.25,3,3,CGGTCGGAGGGTTCCATCAT,0,436487
acrZp,0.25,3,3,CGGTCGCAACCGTTCCAAAT,0,440585
acrZp,0.25,3,3,CGGTCAAATCACAACCCAAC,0,419055
acrZp,0.25,3,3,CGGTAAGTACAAATAAAATT,0,438849
acrZp,0.25,3,3,CGGGTGCGGGTGCGTACGGT,0,431284
acrZp,0.25,3,3,CGGGTGAGCTCTTGATGCCC,0,423986
acrZp,0.25,3,3,CGGGGACTTTGCGCCTGTGG,0,448011
acrZp,0.25,3,3,CGGGCAGCATTCTAATTTGC,0,457154
acrZp,0.25,3,3,CGGCGCTCTTCGTGAGCGTC,0,463146
acrZp,0.25,3,3,CGGCCCGTACCCCGAAGCTA,0,420556
acrZp,0.25,3,3,CGGATAGTGTGTAAAATTAG,0,445506
acrZp,0.25,3,3,CGGAGTGGGTTGGCTGAAAG,0,454847
acrZp,0.25,3,3,CGCTGATGGGTCAAAAAGGT,0,433827
acrZp,0.25,3,3,CGCTGATATTAAGCCTATGG,0,430261
acrZp,0.25,3,3,CGCGCAATGGCGAATTATTT,0,456784
acrZp,0.25,3,3,CGCGAAGGGATGCAACAAAG,0,444686
acrZp,0.25,3,3,CGCCGACTCTAAGATTGATT,0,427978
acrZp,0.25,3,3,CGCCCCTGCCGCCAAAGGGA,0,445242
acrZp,0.25,3,3,CGCCATAATGTAGTATTGTC,0,443010
acrZp,0.25,3,3,CGCAGTCTCTTTGGGCTATA,0,445042
acrZp,0.25,3,3,CGCAGCGGAGGTAGCGATCA,0,436588
acrZp,0.25,3,3,CGCACGATCTTCCGTCGGAC,0,439540
acrZp,0.25,3,3,CGATGCGATTAACAGAGTGT,0,439386
acrZp,0.25,3,3,CGATATCATGTAGTGCTATA,0,440009
acrZp,0.25,3,3,CGAGTATCCAAGTGGAGCAA,0,463451
acrZp,0.25,3,3,CGAGGGTTAACTGAATTTGC,0,426266
acrZp,0.25,3,3,CGAGCACAGTGTCAAAATGC,0,413346
acrZp,0.25,3,3,CGACCGGGGTACCAAGTGTT,0,446371
acrZp,0.25,3,3,CGAATCAGAGCCGGAAGCGA,0,421271
acrZp,0.25,3,3,CGAAGTTTGCTAAAAGTCTC,0,421756
acrZp,0.25,3,3,CGAAGTCATGGGCTATACCT,0,409144
acrZp,0.25,3,3,CGAACTGCGACACTAAACCG,0,452183
acrZp,0.25,3,3,CGAAATCACGATTAAGTAAC,0,427942
acrZp,0.25,3,3,CGAAAATATCCACTGCCTAG,0,451628
acrZp,0.25,3,3,CCTTTGTCAGTATTCTAGCT,0,429934
acrZp,0.25,3,3,CCTTTAGCGTAGACAAGGTT,0,436464
acrZp,0.25,3,3,CCTTTAGCGAATGCAACTAG,0,449862
acrZp,0.25,3,3,CCTTGCGTTGGCGTAGTTGA,0,464313
acrZp,0.25,3,3,CCTTAGCAGAGCTTTGTCTC,0,440010
acrZp,0.25,3,3,CCTCAGCGTTAGTTTTGGAT,0,446637
acrZp,0.25,3,3,CCTACCCGCCTTTCCGGAGT,0,412683
acrZp,0.25,3,3,CCGTTCTTCCGTGAGACCAT,0,457128
acrZp,0.25,3,3,CCGTGCGGGAGGCAATGGTC,0,430254
acrZp,0.25,3,3,CCGTCTGGTGCGTAAGTTGT,0,454853
acrZp,0.25,3,3,CCGTACAAGTATGCTAGGTC,0,421909
acrZp,0.25,3,3,CCGGGCAGTCAGAGCTTTGA,0,446675
acrZp,0.25,3,3,CCGCTTAATGTCCAGTCTGG,0,426566
acrZp,0.25,3,3,CCGCTGACTTTTATCTTGTA,0,417263
acrZp,0.25,3,3,CCGCTAGATGATGAATTGCG,0,429888
acrZp,0.25,3,3,CCGCCGGTTCCAACGGAATC,0,416255
acrZp,0.25,3,3,CCGCCATTAACGTATATCCA,0,435248
acrZp,0.25,3,3,CCCTTCAAGGGTCTCGGAAC,0,443382
acrZp,0.25,3,3,CCCGTCCGTCTTTAGGAAAT,0,411122
acrZp,0.25,3,3,CCCGGTTCTGGGGTTCGCAA,0,435620
acrZp,0.25,3,3,CCCCTTGAGTGAGGTTTCCA,0,449133
acrZp,0.25,3,3,CCCAGTTGATCTTCGTCCCC,0,413110
acrZp,0.25,3,3,CCAGTCAAGAACAGTTCTGT,0,427389
acrZp,0.25,3,3,CCAGCGGCGAATATGGTACT,0,452469
acrZp,0.25,3,3,CCAGAGTAGTAATTCGCTCT,0,422255
acrZp,0.25,3,3,CCACCAGTGGCCCGAACAAG,0,437288
acrZp,0.25,3,3,CCACACGCAGTGCACTCGCC,0,408855
acrZp,0.25,3,3,CCAAGGGGCGGCGCCTACTC,0,443987
acrZp,0.25,3,3,CATTTGTACTATGGGGCAGG,0,430190
acrZp,0.25,3,3,CATTCTAATTCATGATGACG,0,454905
acrZp,0.25,3,3,CATTACGTGTGTGCGCTGAA,0,416098
acrZp,0.25,3,3,CATGTTGCCTCGGAATATAA,0,418976
acrZp,0.25,3,3,CATGGTTATGTGCGCAGAGA,0,428032
acrZp,0.25,3,3,CATGGGATGTGGGGTATTCA,0,456607
acrZp,0.25,3,3,CATACACGGCTGAAGAGTTG,0,434243
acrZp,0.25,3,3,CAGGCAAGATTTACTGAAAA,0,410454
acrZp,0.25,3,3,CAGCTTCGTAAGGGCTCTCT,0,428044
acrZp,0.25,3,3,CAGCGCCTGCACTAGCCCGT,0,442072
acrZp,0.25,3,3,CAGACTACCTCCCGGGCGAC,0,447442
acrZp,0.25,3,3,CACCCATCGGCACCTATGAA,0,419510
acrZp,0.25,3,3,CACAAGCAGATATCAGACCT,0,412192
acrZp,0.25,3,3,CACAACTTGTCAGCTGTTCC,0,463892
acrZp,0.25,3,3,CAATAAAGGTCTCTACATTT,0,420728
acrZp,0.25,3,3,CAAGTCCGCGGGGCAGGTCT,0,460160
acrZp,0.25,3,3,CAAGCAGCTGGGTCTATAGT,0,467741
acrZp,0.25,3,3,CAACGTATTTGGCTTTCGTA,0,408785
acrZp,0.25,3,3,CAACCAAGTTGGCTATAGGA,0,435064
acrZp,0.25,3,3,CAAACTGGAAGCGGGGGAAT,0,443525
acrZp,0.25,3,3,CAAACTATCGAGGGCGAGCA,0,448629
acrZp,0.25,3,3,CAAACAGCATGCCCGACAGC,0,426748
acrZp,0.25,3,3,CAAAACTTGTGAACTCGGCC,0,434983
acrZp,0.25,3,3,ATTTGGGGTCCACGGGGCCT,0,441448
acrZp,0.25,3,3,ATTTGGCCGCTACACGTATA,0,441833
acrZp,0.25,3,3,ATTGTCCAAACGTGACATAG,0,465008
acrZp,0.25,3,3,ATTGCATTCTTAGCATCAAG,0,443710
acrZp,0.25,3,3,ATTCTATACGTCGTTGAAGC,0,441789
acrZp,0.25,3,3,ATGTATTAGATTGCAGGTAG,0,417898
acrZp,0.25,3,3,ATGTAGCTACCAGCGCGTCA,0,409361
acrZp,0.25,3,3,ATGGGCTCTGACAGAAGAAG,0,459565
acrZp,0.25,3,3,ATGGCGGCGCTGAGCGATGC,0,439418
acrZp,0.25,3,3,ATGGCGCCCCGAGTAGCAGT,0,449952
acrZp,0.25,3,3,ATGCTAATCAGTGAACTCCA,0,415014
acrZp,0.25,3,3,ATGCATAAAACCACGTGCAG,0,427833
acrZp,0.25,3,3,ATGATAGAATCCACCTGAGT,0,442905
acrZp,0.25,3,3,ATCTTCTACGCAGGACGCAA,0,444012
acrZp,0.25,3,3,ATCTTCGGTCGTGAGCAGTT,0,434668
acrZp,0.25,3,3,ATCTGAGCCCCGCGACACCA,0,434369
acrZp,0.25,3,3,ATCTGACAAACTCGGGTATG,0,414766
acrZp,0.25,3,3,ATCGTTTGACCCGCGATAGA,0,409672
acrZp,0.25,3,3,ATCGCGTGATGTTCATAGTC,0,455153
acrZp,0.25,3,3,ATCGCAGCCCTATCCCCGAC,0,409542
acrZp,0.25,3,3,ATCCCTCGACGGGTATGGTG,0,417226
acrZp,0.25,3,3,ATCCCGGGCTATGTGACGGT,0,457149
acrZp,0.25,3,3,ATCCCCAAATGGTTAAGCCT,0,455417
acrZp,0.25,3,3,ATCATGAATCGCGTCACATA,0,422459
acrZp,0.25,3,3,ATCAGTGTCCTCTCGGACTA,0,440936
acrZp,0.25,3,3,ATCAGGGCAAAGGCGCATGA,0,439297
acrZp,0.25,3,3,ATATATGGACTACCTATCCA,0,412553
acrZp,0.25,3,3,ATATAGGATAGGGTAATGTG,0,466050
acrZp,0.25,3,3,ATAGAGCTTGCCAAGGATTC,0,440534
acrZp,0.25,3,3,ATACTGAATCAATGAAGTGA,0,427652
acrZp,0.25,3,3,ATACTCAGTCCATCGAATGT,0,462727
acrZp,0.25,3,3,ATACCGCCTGATCCTAGACA,0,443532
acrZp,0.25,3,3,ATAATTGGGGAGAGGCACTC,0,454473
acrZp,0.25,3,3,ATAAGGTAATAACATCTCGA,0,417585
acrZp,0.25,3,3,ATAAAGCCACGCACTCAGAA,0,451273
acrZp,0.25,3,3,AGTTTCGCTTCGACACATGT,0,434363
acrZp,0.25,3,3,AGTGTCGCTATCTTGGTTCG,0,425640
acrZp,0.25,3,3,AGTGGTCTGTGGTATTCCCC,0,434959
acrZp,0.25,3,3,AGTGCAAGTACTAATTTCCA,0,413295
acrZp,0.25,3,3,AGTCTCGCAGTGCACACCGG,0,410526
acrZp,0.25,3,3,AGTCGCATTTACCATTGCAT,0,440108
acrZp,0.25,3,3,AGTCGATCGGAACAACACAC,0,454805
acrZp,0.25,3,3,AGTAGTGAGCTGTGTTTTTC,0,446247
acrZp,0.25,3,3,AGGTTTTTTGTCTTGCCGCA,0,423938
acrZp,0.25,3,3,AGGTGCTGCACTGCCGCGCG,0,411642
acrZp,0.25,3,3,AGGTGCGACCTACGGCCGCC,0,456008
acrZp,0.25,3,3,AGGTCTACCAACGGCCTCCA,0,447837
acrZp,0.25,3,3,AGGTACCAGTTAGTCTGTTC,0,443045
acrZp,0.25,3,3,AGGGGGATATGGCAGTATTG,0,462204
acrZp,0.25,3,3,AGGGGCTAAAGATTTTATAC,0,419223
acrZp,0.25,3,3,AGGGCCGGCGTCCGCATCAT,0,456701
acrZp,0.25,3,3,AGGCTGTCTCTCTAAACTGA,0,426887
acrZp,0.25,3,3,AGGCTACTGGAGAAGACCAC,0,412783
acrZp,0.25,3,3,AGGCGTCCAGCCGCTCTCAA,0,426615
acrZp,0.25,3,3,AGGATGTGGCCATGGGGGCA,0,459414
acrZp,0.25,3,3,AGGATACATAAGACTAGAGA,0,421430
acrZp,0.25,3,3,AGCTGACAAGTGGCTATCGG,0,432871
acrZp,0.25,3,3,AGCGTCGAGGCACGACTCGA,0,444336
acrZp,0.25,3,3,AGCGGACCAGCAGTTCGGCG,0,452438
acrZp,0.25,3,3,AGCGCTTCATGAGCGATACC,0,418517
acrZp,0.25,3,3,AGCGCACGTGATGTTGTGAG,0,421455
acrZp,0.25,3,3,AGCGAAACGAAGTTAATTGA,0,450930
acrZp,0.25,3,3,AGCCTGCATACTTAAATAAG,0,439771
acrZp,0.25,3,3,AGCCTAGTCACTATCTGTGA,0,418504
acrZp,0.25,3,3,AGCCGCGCTCGGAGTACGGT,0,423886
acrZp,0.25,3,3,AGATGCGATTCTCCGATCTC,0,426989
acrZp,0.25,3,3,AGATAATAGGTTCGGTAAAT,0,458582
acrZp,0.25,3,3,AGAGGCGCAGTCTTAACACA,0,439595
acrZp,0.25,3,3,AGACGTCAGAAGAGGACACT,0,417044
acrZp,0.25,3,3,AGACATGTTATATAAGTCGG,0,456965
acrZp,0.25,3,3,AGACAGGGGAGGAAACGTCT,0,439129
acrZp,0.25,3,3,AGACAACAAGACCATTGTGT,0,426924
acrZp,0.25,3,3,AGAAACAAAAGTACAGCAAA,0,465323
acrZp,0.25,3,3,ACTGTACTTCATTAGCGCGG,0,426514
acrZp,0.25,3,3,ACTGATTAGCTAATACTTTA,0,413404
acrZp,0.25,3,3,ACTCATTGGAATAGCGGGTT,0,425181
acrZp,0.25,3,3,ACTAACCATCAACGCAATTC,0,457381
acrZp,0.25,3,3,ACGTTGGGACCTCGCTATTA,0,452699
acrZp,0.25,3,3,ACGTCTATAAGACCGTTTTT,0,438805
acrZp,0.25,3,3,ACGTCCGTGGGGCAAATTAG,0,428106
acrZp,0.25,3,3,ACGTCAGTGTGTCAAGACTG,0,453989
acrZp,0.25,3,3,ACGTACTTCTGCAAGAAAAC,0,419629
acrZp,0.25,3,3,ACGGTGGTTTGGTATCTTGT,0,458046
acrZp,0.25,3,3,ACGGGATCGAGAACTCATCG,0,411648
acrZp,0.25,3,3,ACGCGTAGCATAATGGCGTA,0,412879
acrZp,0.25,3,3,ACGCGATGAACTAATTCCGG,0,448463
acrZp,0.25,3,3,ACGCCAAGGGTTAAACTCTA,0,454190
acrZp,0.25,3,3,ACGAGTGTTGATCGCGCATA,0,424593
acrZp,0.25,3,3,ACGAGTAGAGGGCGAAATTG,0,434885
acrZp,0.25,3,3,ACGAACCGACTGGAATAAGG,0,435296
acrZp,0.25,3,3,ACCGTGGCCAATGAACCAAG,0,410114
acrZp,0.25,3,3,ACCGTCTTGGTATAAGTTTT,0,454800
acrZp,0.25,3,3,ACCCTTATCGAGGTGGAGCT,0,427337
acrZp,0.25,3,3,ACCCGTGAGATCGGGGGCAG,0,446790
acrZp,0.25,3,3,ACCCCGTGGGAAGGCAACAC,0,467052
acrZp,0.25,3,3,ACCCAGGAATTACCTTGTTG,0,448876
acrZp,0.25,3,3,ACCATGAATATCGATCGTCT,0,421355
acrZp,0.25,3,3,ACAGTCAATCAGACCCTGCC,0,447436
acrZp,0.25,3,3,ACACCTGAACTCCAGTCTAA,0,466706
acrZp,0.25,3,3,ACAAGTAACAATCCTCGTTT,0,412280
acrZp,0.25,3,3,ACAACTAAAAAGCTACGAAG,0,418268
acrZp,0.25,3,3,ACAAAATATAGAGGAGTCGC,0,440444
acrZp,0.25,3,3,AATGTGCAGGGACTCAAAAA,0,426319
acrZp,0.25,3,3,AATGGGAAAGGACAGTTGCT,0,423749
acrZp,0.25,3,3,AATCTGCTGGGCAGTTACCA,0,465730
acrZp,0.25,3,3,AATCGCGGCAACCTTTACCA,0,459025
acrZp,0.25,3,3,AATACGGCATTATCGCCGTT,0,421082
acrZp,0.25,3,3,AAGTGGCGTGCCCGATGGAT,0,454104
acrZp,0.25,3,3,AAGTGGCCGGGAGATGGCGT,0,423281
acrZp,0.25,3,3,AAGGTATTGGTTGAGAAAAA,0,434780
acrZp,0.25,3,3,AAGGGTGGACACGTCCTGCG,0,433597
acrZp,0.25,3,3,AAGCTTATAAAAAGTTAGCG,0,426448
acrZp,0.25,3,3,AAGCATAGTATCACGCACAA,0,458080
acrZp,0.25,3,3,AAGCAAATCCAGTAAGATAT,0,416036
acrZp,0.25,3,3,AAGAGACGTCGCGGGTCCTC,0,427878
acrZp,0.25,3,3,AAGAATGTTCTTATGAGCGC,0,426650
acrZp,0.25,3,3,AAGAATACTGAAGAGCTGAT,0,425646
acrZp,0.25,3,3,AAGAACGTATGACCCACGGG,0,411659
acrZp,0.25,3,3,AACTTTTTAATCCCTGTTTC,0,424769
acrZp,0.25,3,3,AACTTACCCAATAGATTTAA,0,450000
acrZp,0.25,3,3,AACTGTTCTCTCGTATGATG,0,417970
acrZp,0.25,3,3,AACTCTTAGATGGAGCTTAA,0,457806
acrZp,0.25,3,3,AACTCGAGGTCAGCAGGTCA,0,424360
acrZp,0.25,3,3,AACGGTTGTAAACATGGTGA,0,413063
acrZp,0.25,3,3,AACGCGCAGAATCAAGTCAT,0,450632
acrZp,0.25,3,3,AACCTAGCCCATGGGTTCTT,0,446866
acrZp,0.25,3,3,AACCCCTGTCACGGCAGTGA,0,463993
acrZp,0.25,3,3,AAATTTGGAACTCAAGCTAA,0,461839
acrZp,0.25,3,3,AAATGCAAGTAATACAGGCT,0,437752
acrZp,0.25,3,3,AAATCCGGAGCGTGTGTTGG,0,430617
acrZp,0.25,3,3,AAATAACCTGTCCGATAAGC,0,443687
acrZp,0.25,3,3,AAAGTCCGGGAGGTCCAGCA,0,439234
acrZp,0.25,3,3,AAAGCAGTAAACAAACATCA,0,411942
acrZp,0.25,3,3,AAAGAGGGTGATTCGTAAGC,0,409000
acrZp,0.25,3,3,AAACCTGTGGGAGCATGAGG,0,463986
acrZp,0.25,3,3,AAACAGTATATTGGTAACAT,0,427595
acrZp,0.3333333333333333,2,2,TTTTTTTGCGTAGTGGCGGG,0,449802
acrZp,0.3333333333333333,2,2,TTTTTGTTTCTGCATTCTAG,0,437371
acrZp,0.3333333333333333,2,2,TTTTCTTGAGCCATGCGCAT,0,410379
acrZp,0.3333333333333333,2,2,TTTTCGTTCATGGTACGAAT,0,420195
acrZp,0.3333333333333333,2,2,TTTTCATTTCCAGACGGGTA,0,419409
acrZp,0.3333333333333333,2,2,TTTTACCGGCAGAGATCATT,0,428953
acrZp,0.3333333333333333,2,2,TTTGGTCAATCAATATACAC,0,432961
acrZp,0.3333333333333333,2,2,TTTGGGTCTGAAAATTGCAT,0,451170
acrZp,0.3333333333333333,2,2,TTTGGCCGGGCGTTGCCTGG,0,425129
acrZp,0.3333333333333333,2,2,TTTGCAGACGTAAATCACAT,0,429719
acrZp,0.3333333333333333,2,2,TTTCTCGGCCTACATCCCAC,0,448074
acrZp,0.3333333333333333,2,2,TTTCCCATGCGAGATCGGAT,0,410343
acrZp,0.3333333333333333,2,2,TTTCACGGAGTATTGCCGAG,0,428561
acrZp,0.3333333333333333,2,2,TTTAGGGACCCGCTCATCGT,0,451001
acrZp,0.3333333333333333,2,2,TTGTACCTGGTGTGAGTGTT,0,441295
acrZp,0.3333333333333333,2,2,TTGGGGGTGTCGCCACTCGA,0,462405
acrZp,0.3333333333333333,2,2,TTGGCTCGCACCCTAACACC,0,427188
acrZp,0.3333333333333333,2,2,TTGGACGCGGCTGATTACGA,0,422834
acrZp,0.3333333333333333,2,2,TTGCTTGACTTGGAATGCTG,0,427281
acrZp,0.3333333333333333,2,2,TTGCCTGGTTCGTACCAGCA,0,449803
acrZp,0.3333333333333333,2,2,TTGCAGGAATGTGTAATAAG,0,428695
acrZp,0.3333333333333333,2,2,TTGATCGTGAGATCAACCCT,0,425928
acrZp,0.3333333333333333,2,2,TTCTTTTGCTTGACATCAGA,0,412340
acrZp,0.3333333333333333,2,2,TTCTTTCAGGTACCTTCTGT,0,458738
acrZp,0.3333333333333333,2,2,TTCTTGGTGAGGGGACGCTT,0,464355
acrZp,0.3333333333333333,2,2,TTCTCGCCACCGAATAGGGA,0,458043
acrZp,0.3333333333333333,2,2,TTCTATTCTTACTAGGGGGT,0,421995
acrZp,0.3333333333333333,2,2,TTCTAACTCCGAAGCGTTCA,0,433283
acrZp,0.3333333333333333,2,2,TTCGTTATTCCGGAACATTG,0,428841
acrZp,0.3333333333333333,2,2,TTCGTTATTAGCCCGGTGCT,0,451404
acrZp,0.3333333333333333,2,2,TTCGCTAAAGGTTCCCTGCA,0,413302
acrZp,0.3333333333333333,2,2,TTCGAGGGCTCTACCCTTCT,0,455193
acrZp,0.3333333333333333,2,2,TTCCTCCAGCACCAATCTAA,0,436646
acrZp,0.3333333333333333,2,2,TTCCGGCCTCGGCGACCGTT,0,418392
acrZp,0.3333333333333333,2,2,TTCCGCAATGTTTGCTGGCG,0,447973
acrZp,0.3333333333333333,2,2,TTCATGATCCGCACCCGCAT,0,432182
acrZp,0.3333333333333333,2,2,TTCATGACGGACCTTCAGTT,0,421186
acrZp,0.3333333333333333,2,2,TTCACATGTGAAGACAGCAT,0,417960
acrZp,0.3333333333333333,2,2,TTCAATCCTGTGAGTCCGTG,0,414283
acrZp,0.3333333333333333,2,2,TTCAACCCTCAGGTGGTCGT,0,426853
acrZp,0.3333333333333333,2,2,TTATTTCGTTCGCGCATTAT,0,444690
acrZp,0.3333333333333333,2,2,TTATGCGGACATTGAGATGG,0,409392
acrZp,0.3333333333333333,2,2,TTAGTTTAGCACCACCCTAG,0,439696
acrZp,0.3333333333333333,2,2,TTAGTAGTTAACTTCCAGGG,0,429992
acrZp,0.3333333333333333,2,2,TTAGGTCTGTATGCGATTAT,0,437653
acrZp,0.3333333333333333,2,2,TTAGGGAAGTGATCACGTAC,0,461195
acrZp,0.3333333333333333,2,2,TTAGGCTCGAGGCTCGCATC,0,465319
acrZp,0.3333333333333333,2,2,TTAGCCTCGACTGATAATAC,0,456373
acrZp,0.3333333333333333,2,2,TTAGCCATTCTGTGATTACT,0,430745
acrZp,0.3333333333333333,2,2,TTACTAACCAGTTTAGCTAA,0,467422
acrZp,0.3333333333333333,2,2,TTACATCCCCCGCTGTCAGC,0,412409
acrZp,0.3333333333333333,2,2,TTAATCCCTCATCAGCTTAC,0,458997
acrZp,0.3333333333333333,2,2,TTAAAGGAGTTAGCTTTAAT,0,419520
acrZp,0.3333333333333333,2,2,TTAAAGCTAAGAGTTCCAGT,0,444752
acrZp,0.3333333333333333,2,2,TGTTGGCGGGCAACCGCGGA,0,443190
acrZp,0.3333333333333333,2,2,TGTTGCCTAGGCTGGCGCAT,0,460868
acrZp,0.3333333333333333,2,2,TGTGGTAAGGGCGAGGGACA,0,428803
acrZp,0.3333333333333333,2,2,TGTGGGTGCGTTTCACTATT,0,419608
acrZp,0.3333333333333333,2,2,TGTGGCTAAGGGGTTGGACA,0,449943
acrZp,0.3333333333333333,2,2,TGTGGCGAGTGAAACTTTCT,0,440753
acrZp,0.3333333333333333,2,2,TGTGCCGAACGTTTTTCATG,0,426818
acrZp,0.3333333333333333,2,2,TGTGAGTCTAACGTCGCGGT,0,418479
acrZp,0.3333333333333333,2,2,TGTCCACCGCCCAGTACGCA,0,415435
acrZp,0.3333333333333333,2,2,TGTCAGGTTTTTTTGGTGGG,0,455548
acrZp,0.3333333333333333,2,2,TGTCAAGGACTGGACACGCG,0,452118
acrZp,0.3333333333333333,2,2,TGTAAAAGACGCATTATTTT,0,436822
acrZp,0.3333333333333333,2,2,TGGTTTTAGTATCAAGAGCC,0,460805
acrZp,0.3333333333333333,2,2,TGGTGCCAAGCCAGCCTAGA,0,455366
acrZp,0.3333333333333333,2,2,TGGTGAGGCTGGCCGTCCAC,0,423239
acrZp,0.3333333333333333,2,2,TGGTCTTTGAAGTCCCCTGT,0,455768
acrZp,0.3333333333333333,2,2,TGGTCGTAAATCTATCCTAA,0,409052
acrZp,0.3333333333333333,2,2,TGGTATTTTGTGTAAGCCCA,0,427127
acrZp,0.3333333333333333,2,2,TGGTAGGTAGTATGTCTACG,0,425275
acrZp,0.3333333333333333,2,2,TGGGGCAATCCGGAATCCAT,0,462169
acrZp,0.3333333333333333,2,2,TGGGGACTATGTCCAGCAAT,0,428478
acrZp,0.3333333333333333,2,2,TGGGCGACCCGCGAAAACCA,0,467623
acrZp,0.3333333333333333,2,2,TGGGCAGGGATATGGTCACC,0,455270
acrZp,0.3333333333333333,2,2,TGGGACATCTGTGCCGCAGA,0,440999
acrZp,0.3333333333333333,2,2,TGGCTAAATCGTCACCATTG,0,409131
acrZp,0.3333333333333333,2,2,TGGCCTGTCCCGCCTGTTTA,0,456448
acrZp,0.3333333333333333,2,2,TGGCCTATAGCACTCTAGTA,0,409618
acrZp,0.3333333333333333,2,2,TGGCATTCCCTATTAGACAC,0,452706
acrZp,0.3333333333333333,2,2,TGGATGTGGCAATCTGATAA,0,433599
acrZp,0.3333333333333333,2,2,TGGATCGATTTCCTTATCTC,0,425504
acrZp,0.3333333333333333,2,2,TGGAAGAGGTTCTATTCGTA,0,462426
acrZp,0.3333333333333333,2,2,TGCTTCCAGCGATTACGGTA,0,426229
acrZp,0.3333333333333333,2,2,TGCGGCGGGTTCCCCAGCGG,0,420790
acrZp,0.3333333333333333,2,2,TGCGCGCAGATCATGAAATA,0,430659
acrZp,0.3333333333333333,2,2,TGCCTTAATTCCGGGGTCTG,0,465054
acrZp,0.3333333333333333,2,2,TGCCGGCTGGTGCAGAGATA,0,445395
acrZp,0.3333333333333333,2,2,TGCCACACCTCGGATATCAA,0,430233
acrZp,0.3333333333333333,2,2,TGCCAATCCCACACTTCACG,0,439030
acrZp,0.3333333333333333,2,2,TGCATTGCTGTAGTCGCGCT,0,416721
acrZp,0.3333333333333333,2,2,TGCATGAGACCATACAAACG,0,445225
acrZp,0.3333333333333333,2,2,TGCAGGCGTAGGGTCCCCAC,0,426457
acrZp,0.3333333333333333,2,2,TGCACTGACATTCCATACCT,0,422714
acrZp,0.3333333333333333,2,2,TGATTACAATGGGGATTCTT,0,429880
acrZp,0.3333333333333333,2,2,TGATCCTCACATCTTCTAAC,0,434605
acrZp,0.3333333333333333,2,2,TGAGTTCTATAGCGTTCATC,0,457035
acrZp,0.3333333333333333,2,2,TGAGGTGACTTAAGCGGGAG,0,431230
acrZp,0.3333333333333333,2,2,TGAGCTCCGACCGCCTTTAA,0,422324
acrZp,0.3333333333333333,2,2,TGAGCCCTTTGAATCGGGAC,0,434408
acrZp,0.3333333333333333,2,2,TGAGATGCGCCCCCTGAAGG,0,458603
acrZp,0.3333333333333333,2,2,TGACCTATCATCAAGATTGA,0,431632
acrZp,0.3333333333333333,2,2,TGACATGCTGCCAGCTTGAT,0,434004
acrZp,0.3333333333333333,2,2,TGAATCTTGCCCGGCTGGTT,0,425701
acrZp,0.3333333333333333,2,2,TCTTTGCGCGCGTTTACCAA,0,417770
acrZp,0.3333333333333333,2,2,TCTTGATCTGGGAGGCCTTG,0,440083
acrZp,0.3333333333333333,2,2,TCTTCAACTAATCGCATGGG,0,423192
acrZp,0.3333333333333333,2,2,TCTGTGGCATACTTACGCTG,0,412119
acrZp,0.3333333333333333,2,2,TCTGCCGGCGCGGTAGACCA,0,428934
acrZp,0.3333333333333333,2,2,TCTGAACTAGACCAGTTTCA,0,459079
acrZp,0.3333333333333333,2,2,TCTCTTTCCTATGTCAATAA,0,413230
acrZp,0.3333333333333333,2,2,TCTCTATCATGGGGAGGTGG,0,446925
acrZp,0.3333333333333333,2,2,TCTCGTGTTGGACATCAGAG,0,453509
acrZp,0.3333333333333333,2,2,TCTCCAGTGCATCCCTTGGC,0,455981
acrZp,0.3333333333333333,2,2,TCTCATAGCAACGAGATGCA,0,434881
acrZp,0.3333333333333333,2,2,TCTCAAGATTCCGCTACAGC,0,428036
acrZp,0.3333333333333333,2,2,TCGTTCCCTCTCTAGGAAAG,0,438494
acrZp,0.3333333333333333,2,2,TCGTCTGTTAAGTCTGTCGC,0,412913
acrZp,0.3333333333333333,2,2,TCGTACCGACCGCCCGCTAT,0,409654
acrZp,0.3333333333333333,2,2,TCGGGCGAGTCCGAGCGAAC,0,415640
acrZp,0.3333333333333333,2,2,TCGGCCCGGGTACTGCCAAG,0,443990
acrZp,0.3333333333333333,2,2,TCGGCACCGAGGGCATTGCG,0,432115
acrZp,0.3333333333333333,2,2,TCGCTACGCGAAATGATTAA,0,429244
acrZp,0.3333333333333333,2,2,TCGCGTTCAGTTCGCTTTTT,0,457961
acrZp,0.3333333333333333,2,2,TCGCGTGAAGCCTACGGGCA,0,442726
acrZp,0.3333333333333333,2,2,TCGCGAAACTGCGATAGGTC,0,435084
acrZp,0.3333333333333333,2,2,TCGCCGGCCTCATAGAAATT,0,436744
acrZp,0.3333333333333333,2,2,TCGCCAGTTTGCCGTAGCAC,0,435270
acrZp,0.3333333333333333,2,2,TCGATCAGGGGAGGCGATTA,0,443303
acrZp,0.3333333333333333,2,2,TCGATAAAGGTTAGCACTGG,0,455604
acrZp,0.3333333333333333,2,2,TCGAGTCCTCTCGGGGGCAG,0,422061
acrZp,0.3333333333333333,2,2,TCGACCGTGCAATGGTACGA,0,438684
acrZp,0.3333333333333333,2,2,TCGAAGTATTGGGATGGCGT,0,449646
acrZp,0.3333333333333333,2,2,TCGAAGAATGCACGCGCCTC,0,435778
acrZp,0.3333333333333333,2,2,TCCTGATCGGTCCCGTGGTT,0,425995
acrZp,0.3333333333333333,2,2,TCCTGACTTCCCCTGTAGGC,0,409067
acrZp,0.3333333333333333,2,2,TCCTATTATGTATCACCAGG,0,413418
acrZp,0.3333333333333333,2,2,TCCGCTGGGCCTATTATGGT,0,415068
acrZp,0.3333333333333333,2,2,TCCGAACAACCGAAGTGTGT,0,463893
acrZp,0.3333333333333333,2,2,TCCCCATGGAGGACGGCTGA,0,449675
acrZp,0.3333333333333333,2,2,TCCATCACATTGGTTCATCT,0,456254
acrZp,0.3333333333333333,2,2,TCATTGTGATTAGCATATGT,0,434965
acrZp,0.3333333333333333,2,2,TCATGCCGCGCAAAAAGCTC,0,435612
acrZp,0.3333333333333333,2,2,TCATGATACATTTGAAAAAG,0,452996
acrZp,0.3333333333333333,2,2,TCATCCTTCGCATTTAGATG,0,426886
acrZp,0.3333333333333333,2,2,TCACGGGTCTGTGTGGTTGA,0,435930
acrZp,0.3333333333333333,2,2,TCACCGAGCCCCGTTATGAG,0,458893
acrZp,0.3333333333333333,2,2,TCACATTGGTTTTACCTCAT,0,441828
acrZp,0.3333333333333333,2,2,TCAAGTCCAAGACGAGTGTG,0,434435
acrZp,0.3333333333333333,2,2,TCAAGCGCGGTCCATCTAGC,0,412276
acrZp,0.3333333333333333,2,2,TCAACGCGCCTCCGGATGGC,0,410713
acrZp,0.3333333333333333,2,2,TCAACAGGGTGTCGCAGTGT,0,409060
acrZp,0.3333333333333333,2,2,TATTTTCCTGCCAAATAGCC,0,430235
acrZp,0.3333333333333333,2,2,TATGTCTCCGGGCAGACGTT,0,465845
acrZp,0.3333333333333333,2,2,TATGATAGAATCTCCTCCGC,0,442512
acrZp,0.3333333333333333,2,2,TATCGCTATGTAGTTGCTCT,0,436655
acrZp,0.3333333333333333,2,2,TATCACGCTGGCCCTAGCAG,0,426462
acrZp,0.3333333333333333,2,2,TATAGTCAATGTGAAAATTA,0,412517
acrZp,0.3333333333333333,2,2,TATACATAACAGTGCAAGCC,0,423741
acrZp,0.3333333333333333,2,2,TAGTCGGTCTAATCTGCGAC,0,457654
acrZp,0.3333333333333333,2,2,TAGGTGCGCCAGTTTGCATG,0,449573
acrZp,0.3333333333333333,2,2,TAGGTCCCGCGCGCCCGGTG,0,441899
acrZp,0.3333333333333333,2,2,TAGGGTTGTGGCTCATGGGT,0,423946
acrZp,0.3333333333333333,2,2,TAGGGGTGGACGCCAGGCTT,0,452136
acrZp,0.3333333333333333,2,2,TAGGCAAGCCAGAATTCCGT,0,443322
acrZp,0.3333333333333333,2,2,TAGCGCCCTTGGCGTATCTA,0,457127
acrZp,0.3333333333333333,2,2,TAGATGGTGGCCCAAATCAA,0,426173
acrZp,0.3333333333333333,2,2,TAGATAGGAAAGTGAAAGTT,0,414614
acrZp,0.3333333333333333,2,2,TAGAGCGCAGTGTGAGGGGG,0,461298
acrZp,0.3333333333333333,2,2,TAGACTCAGCTCGTCCGTCG,0,446577
acrZp,0.3333333333333333,2,2,TACTTATTCGGTGAGGCCAT,0,425501
acrZp,0.3333333333333333,2,2,TACTGTTCGCCTTATTTGAT,0,430963
acrZp,0.3333333333333333,2,2,TACTCGCTTCTGGACGGCAA,0,464704
acrZp,0.3333333333333333,2,2,TACTCCCAGGCGCGACTTTA,0,454837
acrZp,0.3333333333333333,2,2,TACGTTCCCACGCACTTCCT,0,455280
acrZp,0.3333333333333333,2,2,TACGGTTATTACACTCGGAA,0,438604
acrZp,0.3333333333333333,2,2,TACGCGAATCGGGGAAAGGT,0,414410
acrZp,0.3333333333333333,2,2,TACGCCGTTCTTAGCGTTTT,0,444827
acrZp,0.3333333333333333,2,2,TACGCACCGACTCATTGGCG,0,412065
acrZp,0.3333333333333333,2,2,TACGATGAGAGGCAAGATTG,0,432394
acrZp,0.3333333333333333,2,2,TACCTATTTTGTAAGTATAT,0,465859
acrZp,0.3333333333333333,2,2,TACCGAATTGACACGAACGC,0,423270
acrZp,0.3333333333333333,2,2,TACATGATGACAGTCTAGTT,0,446918
acrZp,0.3333333333333333,2,2,TACAGATGGGTATTGATTGT,0,462151
acrZp,0.3333333333333333,2,2,TACAACGGAGATTTTTGGCC,0,432923
acrZp,0.3333333333333333,2,2,TAATAGGTTCCACAGTCCGG,0,452246
acrZp,0.3333333333333333,2,2,TAATACTTCAGGATAGGAAT,0,434839
acrZp,0.3333333333333333,2,2,TAATAACAGATGGATGGCGT,0,446568
acrZp,0.3333333333333333,2,2,TAAGCAATGGGGGCTATAAC,0,416499
acrZp,0.3333333333333333,2,2,TAACTTGGGTCAAGACCATA,0,454342
acrZp,0.3333333333333333,2,2,TAACTGATTTCAGGGAATCC,0,429287
acrZp,0.3333333333333333,2,2,TAACGTTGTCAACGACGAAC,0,414249
acrZp,0.3333333333333333,2,2,TAACGGTTGGACTGCCCGAC,0,441637
acrZp,0.3333333333333333,2,2,TAACGGATATCTCCGTGTCG,0,456736
acrZp,0.3333333333333333,2,2,TAACATTCGTATTAAAGTCG,0,419481
acrZp,0.3333333333333333,2,2,TAAAGCTGCCTTATTTTTGG,0,446111
acrZp,0.3333333333333333,2,2,TAAAGCTGAACTCCTGCCCG,0,420417
acrZp,0.3333333333333333,2,2,TAAACTCGGATTTCGTATCC,0,457675
acrZp,0.3333333333333333,2,2,GTTTTTGCTAATTGAAAGCC,0,437030
acrZp,0.3333333333333333,2,2,GTTTTGAATGCCCGCTTATC,0,466858
acrZp,0.3333333333333333,2,2,GTTTGTTCTACGCATACGTT,0,423918
acrZp,0.3333333333333333,2,2,GTTTATTTATTGTGGCTCAG,0,455341
acrZp,0.3333333333333333,2,2,GTTTACAATCTAAGCAACGC,0,464024
acrZp,0.3333333333333333,2,2,GTTGTTGTCCATGACTTCCC,0,442706
acrZp,0.3333333333333333,2,2,GTTGCGAGCGACTCCCATAA,0,460944
acrZp,0.3333333333333333,2,2,GTTGACCTACCAGGGGGTCC,0,460969
acrZp,0.3333333333333333,2,2,GTTCGGTCACCCCCGGTGAG,0,415064
acrZp,0.3333333333333333,2,2,GTTCATGGGGTTTACGAGTG,0,417387
acrZp,0.3333333333333333,2,2,GTTATTCGGTACAGTACCGC,0,442730
acrZp,0.3333333333333333,2,2,GTTAGTCTACAATAGCATCT,0,433830
acrZp,0.3333333333333333,2,2,GTTAGCGTAGTAGGAGATTA,0,418191
acrZp,0.3333333333333333,2,2,GTTAGAACAGGGCGGTCAAG,0,446864
acrZp,0.3333333333333333,2,2,GTTAAGGTCTACGAAGTAGG,0,419589
acrZp,0.3333333333333333,2,2,GTGGTAGGGATGAGGATGCA,0,431173
acrZp,0.3333333333333333,2,2,GTGGGAGTAACCGGTTTAAC,0,410752
acrZp,0.3333333333333333,2,2,GTGGGACTAACCAAGGCTGA,0,440938
acrZp,0.3333333333333333,2,2,GTGGGACCCACAGGTGGACG,0,437041
acrZp,0.3333333333333333,2,2,GTGGGAATGCGGACTCGGCC,0,459102
acrZp,0.3333333333333333,2,2,GTGCGCGCCACAAACGCTGG,0,439059
acrZp,0.3333333333333333,2,2,GTGAGCTCCTTATCGCACGG,0,437364
acrZp,0.3333333333333333,2,2,GTGACCTAGGATCCTGATGA,0,418667
acrZp,0.3333333333333333,2,2,GTGAAAGTCCCGAAAACCGA,0,456253
acrZp,0.3333333333333333,2,2,GTCTGAGGCTCCACGGAAAG,0,438607
acrZp,0.3333333333333333,2,2,GTCTGACACTGGTCTGTAGT,0,417659
acrZp,0.3333333333333333,2,2,GTCGGTCTGAGCGCTTGGGT,0,420807
acrZp,0.3333333333333333,2,2,GTCGGGCAATCAATTTTATA,0,454397
acrZp,0.3333333333333333,2,2,GTCGGGAAAAACAACGCCGG,0,455724
acrZp,0.3333333333333333,2,2,GTCGGCGTGGCACTCTCTCA,0,415699
acrZp,0.3333333333333333,2,2,GTCGCCGTGGCCCGGGGGTT,0,441723
acrZp,0.3333333333333333,2,2,GTCCTCTCGTGTTTCTTTGG,0,415261
acrZp,0.3333333333333333,2,2,GTCCTATTCCCGCCCCATAG,0,447050
acrZp,0.3333333333333333,2,2,GTCCGGGTATGTGCAGGTCA,0,434781
acrZp,0.3333333333333333,2,2,GTCCGACTCAACCTGTGGGT,0,452120
acrZp,0.3333333333333333,2,2,GTCCATAACGAGAGGCGAAG,0,426791
acrZp,0.3333333333333333,2,2,GTCCAGCCTCAAAGCCGTTG,0,418537
acrZp,0.3333333333333333,2,2,GTCCAACGGTGTCTCAATCG,0,446560
acrZp,0.3333333333333333,2,2,GTCATTTTGGTTATCTCGAA,0,449408
acrZp,0.3333333333333333,2,2,GTCAGCCAAGGTTTTCGTAA,0,438676
acrZp,0.3333333333333333,2,2,GTCAGATTTGTTCGGAAGAT,0,461674
acrZp,0.3333333333333333,2,2,GTATTGGCGCTATGCGACAG,0,432226
acrZp,0.3333333333333333,2,2,GTATCGACCTTGCCTGACTC,0,450097
acrZp,0.3333333333333333,2,2,GTAGGTGCTATTCCGGTATA,0,432970
acrZp,0.3333333333333333,2,2,GTAGGTGCCTCCGAAATAAC,0,425919
acrZp,0.3333333333333333,2,2,GTAGGAGTAGCGGTACGGGA,0,421158
acrZp,0.3333333333333333,2,2,GTACTTTCTAACTCAGAAGA,0,435855
acrZp,0.3333333333333333,2,2,GTACTTTATGGGTTGGACAT,0,454916
acrZp,0.3333333333333333,2,2,GTACCGCACGAAAAAGAGAA,0,460853
acrZp,0.3333333333333333,2,2,GTAATCAGTGCTCATGGACA,0,434492
acrZp,0.3333333333333333,2,2,GTAAGTTACGCGTGCTTCCG,0,443336
acrZp,0.3333333333333333,2,2,GTAAGTGTAAAAGACTGGCT,0,430709
acrZp,0.3333333333333333,2,2,GTAAGGGGTTCCCAGGGCCC,0,415072
acrZp,0.3333333333333333,2,2,GTAAGCGCGTACGTTTTCGC,0,464502
acrZp,0.3333333333333333,2,2,GTAACTCTCGCGGACATCGC,0,430925
acrZp,0.3333333333333333,2,2,GTAACGATTAGATTAAGTGA,0,427874
acrZp,0.3333333333333333,2,2,GGTTTTTATGGCGCGCTGGA,0,448746
acrZp,0.3333333333333333,2,2,GGTTTCCTGGTCCCACGATT,0,424577
acrZp,0.3333333333333333,2,2,GGTTCTTAAAGCTATGGACA,0,428696
acrZp,0.3333333333333333,2,2,GGTTAATGCACCTCTCAGTA,0,458456
acrZp,0.3333333333333333,2,2,GGTGCTCCTTGTAGTATCGC,0,424316
acrZp,0.3333333333333333,2,2,GGTGCGCCTACCATGTGGTT,0,434222
acrZp,0.3333333333333333,2,2,GGTGCCCGGGCCTAACTAGA,0,416469
acrZp,0.3333333333333333,2,2,GGTGCAGAGGTTGGAACATA,0,411921
acrZp,0.3333333333333333,2,2,GGTGCACCGAGTCAGCCGGA,0,467270
acrZp,0.3333333333333333,2,2,GGTGAGAGCCCGATGCTGAT,0,455144
acrZp,0.3333333333333333,2,2,GGTCTGTGTATGCTATGGTG,0,450852
acrZp,0.3333333333333333,2,2,GGTCTCCAAAACGAACACTG,0,414769
acrZp,0.3333333333333333,2,2,GGTCGAATGATTCTATAGTA,0,420343
acrZp,0.3333333333333333,2,2,GGTCCTTCAATGCTTATTTG,0,452704
acrZp,0.3333333333333333,2,2,GGTAGTCTTTCCCAGCCCCG,0,421167
acrZp,0.3333333333333333,2,2,GGTAGTCTAAGGGTCTGTCA,0,448389
acrZp,0.3333333333333333,2,2,GGGTTTTGCTACTTTGTGTA,0,441583
acrZp,0.3333333333333333,2,2,GGGTTTCGGGACGTGATGGC,0,414785
acrZp,0.3333333333333333,2,2,GGGTTCTGAGAACATGGGCT,0,453260
acrZp,0.3333333333333333,2,2,GGGTCTGGGTGTGTCGCGGC,0,428878
acrZp,0.3333333333333333,2,2,GGGTATTTCGCTATCTCTCA,0,431326
acrZp,0.3333333333333333,2,2,GGGTATTGTAGTCGATAGTA,0,412248
acrZp,0.3333333333333333,2,2,GGGTATGGTCAGACGTGCTG,0,427894
acrZp,0.3333333333333333,2,2,GGGGTCTACGCCAGGTTTAC,0,463822
acrZp,0.3333333333333333,2,2,GGGGTACAGCGGTAGTATAC,0,424358
acrZp,0.3333333333333333,2,2,GGGGGGGCGCATTGTATTGA,0,434787
acrZp,0.3333333333333333,2,2,GGGGGACCTGATAGAACATA,0,459381
acrZp,0.3333333333333333,2,2,GGGGCCAGCGTCGGGTCCAA,0,452620
acrZp,0.3333333333333333,2,2,GGGGATTTGACCGCTAGCTC,0,437528
acrZp,0.3333333333333333,2,2,GGGGAGCTGCCCGTAATCTA,0,443897
acrZp,0.3333333333333333,2,2,GGGGACTCGATTTTGGATGT,0,413167
acrZp,0.3333333333333333,2,2,GGGCTCTGGGTTCGGCCGTA,0,430934
acrZp,0.3333333333333333,2,2,GGGCGGCAGGGGACAATCAA,0,445527
acrZp,0.3333333333333333,2,2,GGGCCGTGTGTGGCGACCAA,0,457425
acrZp,0.3333333333333333,2,2,GGGCACTCGCCAATATCGCC,0,442396
acrZp,0.3333333333333333,2,2,GGGATGTAATGGCAAAGTAA,0,463652
acrZp,0.3333333333333333,2,2,GGGACGACTGGATCGATTGA,0,449420
acrZp,0.3333333333333333,2,2,GGGACAGCGTCAACGCTCCA,0,437898
acrZp,0.3333333333333333,2,2,GGGACACATCAGAGGGGTAG,0,419547
acrZp,0.3333333333333333,2,2,GGGACAAAGCTCTTCATCCC,0,441585
acrZp,0.3333333333333333,2,2,GGCTAATTTTCGTTCCGGGT,0,453881
acrZp,0.3333333333333333,2,2,GGCGGTTCGCTGAGCCAACG,0,418062
acrZp,0.3333333333333333,2,2,GGCGGTAGGAATACTATTGC,0,432414
acrZp,0.3333333333333333,2,2,GGCGGACAGTTATTAATTGG,0,424668
acrZp,0.3333333333333333,2,2,GGCGAGGAGTACCGGGCTTC,0,447398
acrZp,0.3333333333333333,2,2,GGCGAAGTATAGGAACAAAA,0,442817
acrZp,0.3333333333333333,2,2,GGCCTCCGCGCCAGGTTCAC,0,424262
acrZp,0.3333333333333333,2,2,GGCCGCTATAGCTACAGGGT,0,463846
acrZp,0.3333333333333333,2,2,GGCCCCCCCGCTTATCCATT,0,460976
acrZp,0.3333333333333333,2,2,GGCAGTATGCGCGTGCCCTA,0,425798
acrZp,0.3333333333333333,2,2,GGCACGCATTACAAAATCAC,0,460025
acrZp,0.3333333333333333,2,2,GGATTCTCAGCCCAACAATT,0,459376
acrZp,0.3333333333333333,2,2,GGATGCACGAAGGGGGGCGT,0,438163
acrZp,0.3333333333333333,2,2,GGATCTCCGAGCCAACTCTA,0,430373
acrZp,0.3333333333333333,2,2,GGAGGACATAGACCTATTAA,0,418868
acrZp,0.3333333333333333,2,2,GGAGACATCTTTGTGGTCAT,0,431241
acrZp,0.3333333333333333,2,2,GGAGAATGACCCCACCAAGT,0,455118
acrZp,0.3333333333333333,2,2,GGACTTATTTGGACCAGTGG,0,436815
acrZp,0.3333333333333333,2,2,GGACTACTGCGGTTGAACTC,0,421318
acrZp,0.3333333333333333,2,2,GGAAGGTCGGTGGAACGTGC,0,431516
acrZp,0.3333333333333333,2,2,GGAAACTTAATTTTTGTACT,0,433672
acrZp,0.3333333333333333,2,2,GCTTGAATCTCCGTCGAGTC,0,438286
acrZp,0.3333333333333333,2,2,GCTTACGGTTGGCGTTCTTC,0,418507
acrZp,0.3333333333333333,2,2,GCTGTCAGGCGGTAAGGTGT,0,431033
acrZp,0.3333333333333333,2,2,GCTGGGGTCACTTGGTCTAA,0,439116
acrZp,0.3333333333333333,2,2,GCTGGGGGAACAAGACCTTG,0,436523
acrZp,0.3333333333333333,2,2,GCTGGGCGCCAGGAGAACTC,0,426957
acrZp,0.3333333333333333,2,2,GCTCTGCGGCCCTCTTTAAT,0,455047
acrZp,0.3333333333333333,2,2,GCTCTATGTGTAAATAAGCA,0,459505
acrZp,0.3333333333333333,2,2,GCTCGGATTTTGTTCAGAAT,0,410129
acrZp,0.3333333333333333,2,2,GCTCGAGCTGCGCCTTGGCG,0,453037
acrZp,0.3333333333333333,2,2,GCTCCATAGAACCGTGGCCA,0,421989
acrZp,0.3333333333333333,2,2,GCTAGGAGCGGCTGAGTCCT,0,454169
acrZp,0.3333333333333333,2,2,GCTAGACGCGATTCTAGCCG,0,432457
acrZp,0.3333333333333333,2,2,GCTAACAAACCACCCATGGA,0,409404
acrZp,0.3333333333333333,2,2,GCGTTTGTTACCCTAGTAGT,0,410518
acrZp,0.3333333333333333,2,2,GCGTTGATGGCTTTAAGATA,0,456505
acrZp,0.3333333333333333,2,2,GCGTTCTGATGGTCAAGGAG,0,448387
acrZp,0.3333333333333333,2,2,GCGTTACTTGACGTGGAGTG,0,433821
acrZp,0.3333333333333333,2,2,GCGTGTTCAGGCAAGTGTCA,0,438284
acrZp,0.3333333333333333,2,2,GCGTCGGTTGCTCGGCAGAA,0,418264
acrZp,0.3333333333333333,2,2,GCGTCAACAAGCCTTTGTCT,0,443204
acrZp,0.3333333333333333,2,2,GCGGTGAATCCGCCAATCTT,0,461547
acrZp,0.3333333333333333,2,2,GCGGGGTCCCGGTGGAGTGT,0,441218
acrZp,0.3333333333333333,2,2,GCGCTGTTTGAGGGAAATCC,0,417159
acrZp,0.3333333333333333,2,2,GCGCGGGCTAAATGCGTCAC,0,452542
acrZp,0.3333333333333333,2,2,GCGCGACTCAACGGTTCGGG,0,457012
acrZp,0.3333333333333333,2,2,GCGCAGTTGTTCCAGCTAGA,0,448331
acrZp,0.3333333333333333,2,2,GCGATGCTTGCCTGATACCA,0,457557
acrZp,0.3333333333333333,2,2,GCGATCATGTCGCGATCCAC,0,466624
acrZp,0.3333333333333333,2,2,GCGAGGGGTATGTATAGCAA,0,442495
acrZp,0.3333333333333333,2,2,GCCTCCGTGTCGCGCGAGGG,0,428866
acrZp,0.3333333333333333,2,2,GCCTAACGCCGAAAAGGCCC,0,436855
acrZp,0.3333333333333333,2,2,GCCTAAACCACACCAGAAAG,0,449417
acrZp,0.3333333333333333,2,2,GCCGGTTCCTTGGCCATTAT,0,431828
acrZp,0.3333333333333333,2,2,GCCGATAGGGTCTCATTCTT,0,452765
acrZp,0.3333333333333333,2,2,GCCCTTCTTCGGGCCTTAAG,0,425589
acrZp,0.3333333333333333,2,2,GCCCTGAAGTCGGACCGACC,0,436727
acrZp,0.3333333333333333,2,2,GCCATGCTGGCTTGGACATC,0,460661
acrZp,0.3333333333333333,2,2,GCAGAGGTGGCCATCAGCGA,0,415612
acrZp,0.3333333333333333,2,2,GCAGAACGGTTGATCCATCA,0,437195
acrZp,0.3333333333333333,2,2,GCAAGTAACGGTCGTCACCC,0,431932
acrZp,0.3333333333333333,2,2,GCAAGAAGTATCGTTTGGCC,0,409465
acrZp,0.3333333333333333,2,2,GCAACTCCAACGGCGGGGGC,0,418582
acrZp,0.3333333333333333,2,2,GCAAATCCCTAGGGCCGTCC,0,409132
acrZp,0.3333333333333333,2,2,GCAAAGATAACTGTAGAAAA,0,416460
acrZp,0.3333333333333333,2,2,GATTTCGGTTTCCTTGCCGG,0,412342
acrZp,0.3333333333333333,2,2,GATTGACCAGGAGAGGGACG,0,422749
acrZp,0.3333333333333333,2,2,GATGTTGGGATCCGTGAAGG,0,444667
acrZp,0.3333333333333333,2,2,GATGGAACTGGATTCAATGC,0,430875
acrZp,0.3333333333333333,2,2,GATGCTTCTAAATGTAAGAT,0,444335
acrZp,0.3333333333333333,2,2,GATGCGCTTTTCATTACCGA,0,458058
acrZp,0.3333333333333333,2,2,GATGCATCCGGGCGCGTGGA,0,442113
acrZp,0.3333333333333333,2,2,GATCACCAATTTCGCATGGC,0,465623
acrZp,0.3333333333333333,2,2,GATATGTTGGCAAACTGTGT,0,430274
acrZp,0.3333333333333333,2,2,GATATGTCCTAAGGCCCTCC,0,445762
acrZp,0.3333333333333333,2,2,GATATACAGGCAGTTTTTTT,0,451823
acrZp,0.3333333333333333,2,2,GATACGATGTCGGTGTATGT,0,429782
acrZp,0.3333333333333333,2,2,GATAAGCAGTTTCTACGCCA,0,466011
acrZp,0.3333333333333333,2,2,GATAAAGGTTAGGATGTGGT,0,420764
acrZp,0.3333333333333333,2,2,GAGTGATCAATACTGGTGTC,0,435534
acrZp,0.3333333333333333,2,2,GAGTCCGGGGCGACCAGCAG,0,427697
acrZp,0.3333333333333333,2,2,GAGGTCTTCGACAGTACTAT,0,410693
acrZp,0.3333333333333333,2,2,GAGGGGCAAACTATGAGATG,0,447649
acrZp,0.3333333333333333,2,2,GAGGGACATTGGACACCAGG,0,429775
acrZp,0.3333333333333333,2,2,GAGGACTGTCATATTAGGTG,0,439990
acrZp,0.3333333333333333,2,2,GAGGAAGGTAAGAACAGGCA,0,440008
acrZp,0.3333333333333333,2,2,GAGATTATGTCCACGGCTGT,0,433780
acrZp,0.3333333333333333,2,2,GAGAGCCTCGTCTATTTAGA,0,412034
acrZp,0.3333333333333333,2,2,GAGAGATCTCCCACTCTTAA,0,461706
acrZp,0.3333333333333333,2,2,GAGAATCACTTTAGCTTGTT,0,460398
acrZp,0.3333333333333333,2,2,GACTGTCTAAACCGACAGTA,0,420227
acrZp,0.3333333333333333,2,2,GACTCCCGTAAATCGCGGCA,0,440993
acrZp,0.3333333333333333,2,2,GACGCTAAATGCCTCTCTCG,0,443945
acrZp,0.3333333333333333,2,2,GACCTGTTCAGGCTGACGAG,0,408575
acrZp,0.3333333333333333,2,2,GACCTGCTTCGGTATACAGA,0,423334
acrZp,0.3333333333333333,2,2,GACCACCGTGCGGCCATACT,0,444761
acrZp,0.3333333333333333,2,2,GACACTATGGGCACAGGCCC,0,410171
acrZp,0.3333333333333333,2,2,GAATTCTGGGTGTAAGGGCA,0,441584
acrZp,0.3333333333333333,2,2,GAATTCCGCCGTCCGACTCA,0,461699
acrZp,0.3333333333333333,2,2,GAATGTGCTGGGATATTGGA,0,432765
acrZp,0.3333333333333333,2,2,GAATCTGAAGAAGGTAATGG,0,444425
acrZp,0.3333333333333333,2,2,GAAGGTTGGCCGGTACTTAA,0,421015
acrZp,0.3333333333333333,2,2,GAAGGTAAGCCGACACATAC,0,417678
acrZp,0.3333333333333333,2,2,GAAGGGTATATAAAGCTGAG,0,425705
acrZp,0.3333333333333333,2,2,GAAGCGGTGACGTCTTCCAT,0,454446
acrZp,0.3333333333333333,2,2,GAAGCACGGTTCGGGCGTTC,0,441040
acrZp,0.3333333333333333,2,2,GAAGATTGTCAGACCTTTCA,0,448276
acrZp,0.3333333333333333,2,2,GAACGCCTTCGTTATGACCT,0,448173
acrZp,0.3333333333333333,2,2,GAACGAAGCTCCAGCTGGCT,0,448005
acrZp,0.3333333333333333,2,2,GAACCATAAGTCGGATTGGG,0,445233
acrZp,0.3333333333333333,2,2,GAACCAGGCAACCAATCGGG,0,437122
acrZp,0.3333333333333333,2,2,GAACACATATAAAGTGGCGA,0,454222
acrZp,0.3333333333333333,2,2,GAAATTTAAAGGTCAAAATT,0,432589
acrZp,0.3333333333333333,2,2,GAAAGATGTGCCGTGGCCGT,0,453771
acrZp,0.3333333333333333,2,2,CTTTGCTGTCCGAGATCAGC,0,422170
acrZp,0.3333333333333333,2,2,CTTGTATAATTGGTCCATAC,0,431666
acrZp,0.3333333333333333,2,2,CTTGGGTTTCTTACGACCCA,0,463059
acrZp,0.3333333333333333,2,2,CTTGCGTGAAGTAGCTTGCC,0,424369
acrZp,0.3333333333333333,2,2,CTTGCATTTTCTAACTAGAA,0,453719
acrZp,0.3333333333333333,2,2,CTTCTTGGTTCGCTTCGGAG,0,434714
acrZp,0.3333333333333333,2,2,CTTCTTACCGATGTTGCGGT,0,420704
acrZp,0.3333333333333333,2,2,CTTCTGTTCACGGTCGGTGA,0,412982
acrZp,0.3333333333333333,2,2,CTTCCTCAGTGCGGGCAGGG,0,431763
acrZp,0.3333333333333333,2,2,CTTATACGCCTGTGCGTAGC,0,446809
acrZp,0.3333333333333333,2,2,CTTAGTGGCTCCGCACCTTA,0,437029
acrZp,0.3333333333333333,2,2,CTTACCAACCAGTAGTCCCG,0,439512
acrZp,0.3333333333333333,2,2,CTGTTCCTAACTAGAATACT,0,436489
acrZp,0.3333333333333333,2,2,CTGTGAGCCCTTTTACGTAC,0,455347
acrZp,0.3333333333333333,2,2,CTGTAAGGGTTACGGCACCA,0,444115
acrZp,0.3333333333333333,2,2,CTGGTGACCCGAGGCCCGCA,0,426316
acrZp,0.3333333333333333,2,2,CTGGTGAACACGGGAGGAAT,0,437791
acrZp,0.3333333333333333,2,2,CTGGTCTACACTACTGGATA,0,439660
acrZp,0.3333333333333333,2,2,CTGGCTGGCTCAGAATCATA,0,440852
acrZp,0.3333333333333333,2,2,CTGCGTACATGAACGTGCCA,0,445930
acrZp,0.3333333333333333,2,2,CTGCGCAAACGTCGCTCAGA,0,437183
acrZp,0.3333333333333333,2,2,CTGCCTTCGGTGAATGGAGA,0,453170
acrZp,0.3333333333333333,2,2,CTGCCACTGCAGGGATATAT,0,417787
acrZp,0.3333333333333333,2,2,CTGAGCAACAAACCCGTATA,0,425248
acrZp,0.3333333333333333,2,2,CTGACGAAAGTTAGACGCCT,0,409201
acrZp,0.3333333333333333,2,2,CTGAATTGCAGCATCGTGAC,0,464619
acrZp,0.3333333333333333,2,2,CTCTTGAAGGTGGGGCACAG,0,408755
acrZp,0.3333333333333333,2,2,CTCTTCTGGCATATAGGCGA,0,438614
acrZp,0.3333333333333333,2,2,CTCTCCTTGAAGCAGAGTGC,0,429649
acrZp,0.3333333333333333,2,2,CTCTATCTTTCGCAACGTTT,0,414242
acrZp,0.3333333333333333,2,2,CTCGTGTTGGAGTGCGTAAC,0,455350
acrZp,0.3333333333333333,2,2,CTCGTCCTCGTCGGGGGTGT,0,449683
acrZp,0.3333333333333333,2,2,CTCGTCCGGTCAACACTGAA,0,452444
acrZp,0.3333333333333333,2,2,CTCGAGTGCGATGAAGCAGT,0,448451
acrZp,0.3333333333333333,2,2,CTCGAGGGTGGTGACACTAA,0,443498
acrZp,0.3333333333333333,2,2,CTCATCCCCGACCGGTTTGC,0,464804
acrZp,0.3333333333333333,2,2,CTCACTCTTTCTCAGTACTT,0,436794
acrZp,0.3333333333333333,2,2,CTCAATCCGGGAAGCTAGTG,0,461885
acrZp,0.3333333333333333,2,2,CTCAACGGATGCGCTTGATG,0,421647
acrZp,0.3333333333333333,2,2,CTCAACACGGAGGGCTAAGG,0,446503
acrZp,0.3333333333333333,2,2,CTATTGGCCGCCATTGCGGT,0,458919
acrZp,0.3333333333333333,2,2,CTATGGCCCTAACCGGGACA,0,426151
acrZp,0.3333333333333333,2,2,CTATAGAGGGCATATACAGC,0,421789
acrZp,0.3333333333333333,2,2,CTATAGACGCAGGCCAGAAG,0,451009
acrZp,0.3333333333333333,2,2,CTAGTGAAAACATTGCCTCG,0,430230
acrZp,0.3333333333333333,2,2,CTAGCATGATAGGCTAGGTG,0,443754
acrZp,0.3333333333333333,2,2,CTAGACATGCGGGCAGGCAG,0,420491
acrZp,0.3333333333333333,2,2,CTAATGGCGATACGTTCAGG,0,412911
acrZp,0.3333333333333333,2,2,CTAATGCCACTGCACCGTTG,0,435857
acrZp,0.3333333333333333,2,2,CTAAGTGCGTACTCGCGCGA,0,439514
acrZp,0.3333333333333333,2,2,CTAAGCCTAGGGAGGTCCTT,0,409535
acrZp,0.3333333333333333,2,2,CTAACTCCGAGCTCAGAACA,0,453031
acrZp,0.3333333333333333,2,2,CTAAAGCCGAAGCAGTTGGG,0,451118
acrZp,0.3333333333333333,2,2,CTAAAGAAGGCTCCGGCGTC,0,421085
acrZp,0.3333333333333333,2,2,CGTTTTGTCCTCTTATGCTC,0,414443
acrZp,0.3333333333333333,2,2,CGTTATACGGGAACGCTGCA,0,459438
acrZp,0.3333333333333333,2,2,CGTGATAATGTTGGATCGAA,0,449066
acrZp,0.3333333333333333,2,2,CGTGAGGAGTGGGTCCGGAT,0,434402
acrZp,0.3333333333333333,2,2,CGTGAACGCTAAATTGGTAC,0,428790
acrZp,0.3333333333333333,2,2,CGTCTCCTGCGAAAGCGCCG,0,467488
acrZp,0.3333333333333333,2,2,CGTCGTTCCGCGTGGGTCCT,0,435796
acrZp,0.3333333333333333,2,2,CGTCCGGGAGGACCTATTTA,0,450977
acrZp,0.3333333333333333,2,2,CGTCACTCTGCGAAAGCTGG,0,450138
acrZp,0.3333333333333333,2,2,CGTACGCGGATCATGAAGGA,0,434607
acrZp,0.3333333333333333,2,2,CGTAAGCGCAAGTCTACTAG,0,462499
acrZp,0.3333333333333333,2,2,CGGTTCTGCTGGTCTTCGGA,0,440136
acrZp,0.3333333333333333,2,2,CGGTACGCTACACTGAGAAA,0,412875
acrZp,0.3333333333333333,2,2,CGGTACATTTTTCCTGCTTG,0,446785
acrZp,0.3333333333333333,2,2,CGGGGTTGCAATCCGTATAC,0,416111
acrZp,0.3333333333333333,2,2,CGGGCGTGACCGTCTCTTCA,0,448835
acrZp,0.3333333333333333,2,2,CGGGAGCACGTCCAGTCGGA,0,450946
acrZp,0.3333333333333333,2,2,CGGCTTCGACGTGTATGAAG,0,417124
acrZp,0.3333333333333333,2,2,CGGCTTATGTGCAGGGTTTG,0,440516
acrZp,0.3333333333333333,2,2,CGGCTCATCCGGCGCCACCC,0,430591
acrZp,0.3333333333333333,2,2,CGGCTCACTATGCGGTAGTT,0,454689
acrZp,0.3333333333333333,2,2,CGGCGGAAGTCACAATTATA,0,447303
acrZp,0.3333333333333333,2,2,CGGCGACTACAGAAGCTCAT,0,424458
acrZp,0.3333333333333333,2,2,CGGCCAATAGTAGCGAAATC,0,459058
acrZp,0.3333333333333333,2,2,CGGATGGTCATGACATGTAC,0,446590
acrZp,0.3333333333333333,2,2,CGGAGTGGGGTGTCTGCTCA,0,413370
acrZp,0.3333333333333333,2,2,CGGAGGTCAAATACCATCCT,0,461399
acrZp,0.3333333333333333,2,2,CGGAGGCTCGTCCGCCGCGT,0,442250
acrZp,0.3333333333333333,2,2,CGGAGCTTCCGTGTTGTGCA,0,435875
acrZp,0.3333333333333333,2,2,CGGAGATTTACCCTCCAGAG,0,451638
acrZp,0.3333333333333333,2,2,CGGACATGAGACACTTCTTA,0,446739
acrZp,0.3333333333333333,2,2,CGGAAGATTATAGTTTATCA,0,409268
acrZp,0.3333333333333333,2,2,CGCTTTATTCCACGGAGGCT,0,409486
acrZp,0.3333333333333333,2,2,CGCTGACGGTCTCTAACTCT,0,410658
acrZp,0.3333333333333333,2,2,CGCTACGAGGCCGTTGTGTC,0,433786
acrZp,0.3333333333333333,2,2,CGCTAAATGAGTTAAACATT,0,424428
acrZp,0.3333333333333333,2,2,CGCGTTCGGCAACACTCGTA,0,452988
acrZp,0.3333333333333333,2,2,CGCGTGACATGGCGTTCAGG,0,443196
acrZp,0.3333333333333333,2,2,CGCGTCGCTGTCCGCGCCGA,0,458862
acrZp,0.3333333333333333,2,2,CGCGGATTCATTAAGGAGAC,0,452178
acrZp,0.3333333333333333,2,2,CGCGCAGCCCTTGGGGGAAG,0,439504
acrZp,0.3333333333333333,2,2,CGCGAGAGATCGGTGCCTTG,0,416317
acrZp,0.3333333333333333,2,2,CGCGAATCTGGTTGATGCCT,0,453811
acrZp,0.3333333333333333,2,2,CGCCTTCGAGTCCTGAGACG,0,438883
acrZp,0.3333333333333333,2,2,CGCCGCTCAACGCTTGCTTC,0,417990
acrZp,0.3333333333333333,2,2,CGCCAATGGCCTGTCCCATA,0,456137
acrZp,0.3333333333333333,2,2,CGCCAAGACAGTGCAAGCCT,0,418556
acrZp,0.3333333333333333,2,2,CGCATTGGATAGGCAAAACT,0,409023
acrZp,0.3333333333333333,2,2,CGCATAATGATGTTGATTGT,0,449316
acrZp,0.3333333333333333,2,2,CGCACCACTCCATTTCATGT,0,439964
acrZp,0.3333333333333333,2,2,CGCACACAAAGCTCTTCATC,0,437701
acrZp,0.3333333333333333,2,2,CGCAAACAGGGGATTCATTT,0,464570
acrZp,0.3333333333333333,2,2,CGCAAACAGCATGGGCATCA,0,444509
acrZp,0.3333333333333333,2,2,CGCAAAAGTCCAGCGCAACA,0,448337
acrZp,0.3333333333333333,2,2,CGATTTATGGGACTCGGACC,0,459234
acrZp,0.3333333333333333,2,2,CGATGTATAGCTTCAATTAA,0,420406
acrZp,0.3333333333333333,2,2,CGATGGATGCATCGTTACCA,0,434003
acrZp,0.3333333333333333,2,2,CGAGGACGTCCGGGCATTAA,0,461578
acrZp,0.3333333333333333,2,2,CGAGCGTAGATGGGAGGCTA,0,460499
acrZp,0.3333333333333333,2,2,CGAGCCCAGGTGGATGTAGC,0,408603
acrZp,0.3333333333333333,2,2,CGAGCACAACATATTGTTCT,0,455498
acrZp,0.3333333333333333,2,2,CGACTTACCTGTAATACGTA,0,459846
acrZp,0.3333333333333333,2,2,CGACGCGTAACGGAACATGA,0,449925
acrZp,0.3333333333333333,2,2,CGACACCCGATGAGTTTTCT,0,463909
acrZp,0.3333333333333333,2,2,CGACAACGGGTAAGATGGGA,0,426186
acrZp,0.3333333333333333,2,2,CCTTTGGTAGCATGGCACTC,0,436605
acrZp,0.3333333333333333,2,2,CCTTGCCCCTAGGTCTATTG,0,445500
acrZp,0.3333333333333333,2,2,CCTTCAGTGCTCGCTTGTCT,0,415177
acrZp,0.3333333333333333,2,2,CCTGTTAGTTACGTCTTCCC,0,437341
acrZp,0.3333333333333333,2,2,CCTGGGAGCCTGGGTGCTGT,0,408639
acrZp,0.3333333333333333,2,2,CCTGGGACAGTTGGGCTCCC,0,419009
acrZp,0.3333333333333333,2,2,CCTCCGGCCGGTTAGCCTAT,0,435723
acrZp,0.3333333333333333,2,2,CCTCCCCCAATTACTTGGAG,0,435899
acrZp,0.3333333333333333,2,2,CCTAAATGATTTAATAGTTA,0,442565
acrZp,0.3333333333333333,2,2,CCGGGTTTGTAACGGCGCGA,0,427734
acrZp,0.3333333333333333,2,2,CCGGGTCCAACCGATAGACC,0,462420
acrZp,0.3333333333333333,2,2,CCGGGGTTTTTGATGTCCTT,0,461460
acrZp,0.3333333333333333,2,2,CCGGGGGGCTTAATGTTTCA,0,428874
acrZp,0.3333333333333333,2,2,CCGGGCTATTGAAGCACACT,0,444859
acrZp,0.3333333333333333,2,2,CCGGGCGCTAAGATTAACAT,0,411474
acrZp,0.3333333333333333,2,2,CCGGCTGCGTCTATTCGCCA,0,436314
acrZp,0.3333333333333333,2,2,CCGGCGGTAGTTCTTGAGAT,0,445445
acrZp,0.3333333333333333,2,2,CCGGAATGAAAGTCATAATT,0,419232
acrZp,0.3333333333333333,2,2,CCGGAAATACCCAGTCTGAA,0,415012
acrZp,0.3333333333333333,2,2,CCGCGTCCAGGGTCGGCCCG,0,414129
acrZp,0.3333333333333333,2,2,CCGCCTCCGGTGCAGGAATA,0,416936
acrZp,0.3333333333333333,2,2,CCGCCGGCACCACCAGTTCT,0,459933
acrZp,0.3333333333333333,2,2,CCGCATGACCATCTGGGAAA,0,412023
acrZp,0.3333333333333333,2,2,CCGATGCTGGACGACCTTAG,0,433318
acrZp,0.3333333333333333,2,2,CCGAGTCGTCCCTACACCTA,0,419848
acrZp,0.3333333333333333,2,2,CCGAGAAAGGTGGCCACAGC,0,423819
acrZp,0.3333333333333333,2,2,CCGACTCTACTCCCAGTTTC,0,430392
acrZp,0.3333333333333333,2,2,CCCTTTGTCGGCACACCGCA,0,452398
acrZp,0.3333333333333333,2,2,CCCTTATACCCGCGATTCTT,0,439820
acrZp,0.3333333333333333,2,2,CCCTTAGTAGACGCAAGCAT,0,447893
acrZp,0.3333333333333333,2,2,CCCTGAGTAAAGGGGCCTGC,0,427282
acrZp,0.3333333333333333,2,2,CCCTCGGTAGTACACAAGAG,0,412245
acrZp,0.3333333333333333,2,2,CCCTATCGACGACCCCACCA,0,439850
acrZp,0.3333333333333333,2,2,CCCGGACCTGCGAAAGTTTG,0,430623
acrZp,0.3333333333333333,2,2,CCCGGAATCAGGATTTATCT,0,410792
acrZp,0.3333333333333333,2,2,CCCCTCTGGAATCCTGTTAT,0,445592
acrZp,0.3333333333333333,2,2,CCCCGGTGTGGATTTCCCAC,0,430575
acrZp,0.3333333333333333,2,2,CCCAATTCATCTGGCTGCTG,0,453592
acrZp,0.3333333333333333,2,2,CCATAGCGGGGCAGACTTCG,0,454793
acrZp,0.3333333333333333,2,2,CCAGTGCGCTCGACAGTCAT,0,440364
acrZp,0.3333333333333333,2,2,CCAGGTAGGGGAGAGGGAGC,0,428043
acrZp,0.3333333333333333,2,2,CCAGCTTGCGGTTCGTTCGT,0,419596
acrZp,0.3333333333333333,2,2,CCAGCTTACTTGCCGCAGGT,0,454486
acrZp,0.3333333333333333,2,2,CCAGCGAGTCATGAGAGCAA,0,412060
acrZp,0.3333333333333333,2,2,CCAGATGGCACATACAGAGG,0,441340
acrZp,0.3333333333333333,2,2,CCACTGTTAAGGAACCAACT,0,414666
acrZp,0.3333333333333333,2,2,CCACATCCTCGTTCAAACAG,0,436650
acrZp,0.3333333333333333,2,2,CCACATAGCACTTACAGATA,0,418154
acrZp,0.3333333333333333,2,2,CCACAGATCGTGCCCACGCC,0,429897
acrZp,0.3333333333333333,2,2,CCAATTAAACCCGGGGCGCA,0,460744
acrZp,0.3333333333333333,2,2,CCAATCCCTCTACTACGCGT,0,426157
acrZp,0.3333333333333333,2,2,CCAAAGCGGTCCCCGCTCGA,0,454002
acrZp,0.3333333333333333,2,2,CATTGTGGCCCCAGCGACGG,0,412731
acrZp,0.3333333333333333,2,2,CATTCCTGGGCACTCCAAGG,0,438610
acrZp,0.3333333333333333,2,2,CATTACGATGTTCGGACTCT,0,439603
acrZp,0.3333333333333333,2,2,CATCTAGACTAATATCAACG,0,449482
acrZp,0.3333333333333333,2,2,CATCGTGAGGATGGCGTAGT,0,453660
acrZp,0.3333333333333333,2,2,CATATATGCTGCACTACCTC,0,424243
acrZp,0.3333333333333333,2,2,CATACGTTCGTTTCTGAACG,0,410124
acrZp,0.3333333333333333,2,2,CATAACCTAATGAGGTCGTA,0,420207
acrZp,0.3333333333333333,2,2,CAGTTGGGAGTTCGTGGCAA,0,417945
acrZp,0.3333333333333333,2,2,CAGTTGCCTCAATTTAGTCA,0,447551
acrZp,0.3333333333333333,2,2,CAGTTGATCTCGCCGTGGTA,0,462879
acrZp,0.3333333333333333,2,2,CAGTTAGTTAGTATCCAACA,0,430791
acrZp,0.3333333333333333,2,2,CAGTGGCGGACCGCAGCGTT,0,458702
acrZp,0.3333333333333333,2,2,CAGTCGGTTCGTATGATTCC,0,412036
acrZp,0.3333333333333333,2,2,CAGGGTGCGGTTGCGTAGGA,0,438646
acrZp,0.3333333333333333,2,2,CAGGGCTTCGAGAGCGCGAT,0,465027
acrZp,0.3333333333333333,2,2,CAGGCGTTAGATAAGTCTGT,0,464028
acrZp,0.3333333333333333,2,2,CAGGAGCTCTAGCAAATTAC,0,452801
acrZp,0.3333333333333333,2,2,CAGCCACTACGGGTATCAGC,0,413001
acrZp,0.3333333333333333,2,2,CAGAAGGAGGCTATCTTGTC,0,462639
acrZp,0.3333333333333333,2,2,CACTGAGAGCGTTCGTTAGA,0,431920
acrZp,0.3333333333333333,2,2,CACTCGGACCGAAATGGTTG,0,452973
acrZp,0.3333333333333333,2,2,CACGTCTGCTGAGGGAAGGT,0,466631
acrZp,0.3333333333333333,2,2,CACGGGGGGCAAGCACCTTG,0,455774
acrZp,0.3333333333333333,2,2,CACGACCAGGATCGGGGCGC,0,422398
acrZp,0.3333333333333333,2,2,CACATGAGGGCATCAATAAT,0,442080
acrZp,0.3333333333333333,2,2,CACACACGACTGGGTGGTGT,0,411833
acrZp,0.3333333333333333,2,2,CACAATCTGCAATCTCCATT,0,411841
acrZp,0.3333333333333333,2,2,CAATTCAGGGGTGAACGTGT,0,438927
acrZp,0.3333333333333333,2,2,CAATCTTAGGGCATCTGTTG,0,446242
acrZp,0.3333333333333333,2,2,CAATCCCAATTGTAGTGATT,0,447011
acrZp,0.3333333333333333,2,2,CAATACTAGAAGATAGGCCT,0,411632
acrZp,0.3333333333333333,2,2,CAAGGACGGGGGTGTAAGTA,0,445028
acrZp,0.3333333333333333,2,2,CAAGCATCGGATATGGGAAC,0,426648
acrZp,0.3333333333333333,2,2,CAAGCAGTCTGGCCCTATAT,0,466236
acrZp,0.3333333333333333,2,2,CAAGATTCCAAGGTATTAAT,0,416914
acrZp,0.3333333333333333,2,2,CAACTATGGAGGAGAAACAT,0,440264
acrZp,0.3333333333333333,2,2,CAACAGAATGTGGAGGTTTA,0,426155
acrZp,0.3333333333333333,2,2,CAACAATGGGGCTAATAACG,0,412204
acrZp,0.3333333333333333,2,2,CAAATAGCGGTAGTAAGTTC,0,415674
acrZp,0.3333333333333333,2,2,CAAACGGCGACGCGTTCCGT,0,453281
acrZp,0.3333333333333333,2,2,ATTTGCTCTTCTAGCAAGTC,0,438603
acrZp,0.3333333333333333,2,2,ATTTCGTCATCAGTATACCT,0,415010
acrZp,0.3333333333333333,2,2,ATTTCGCTCTGTCTGCTTCT,0,457841
acrZp,0.3333333333333333,2,2,ATTTACACGAGCGAACGCCG,0,412524
acrZp,0.3333333333333333,2,2,ATTGTTCTCCTGGCAACAAA,0,418318
acrZp,0.3333333333333333,2,2,ATTGGGAGCACGAATTAGGG,0,427085
acrZp,0.3333333333333333,2,2,ATTGATGTAGAGTCTGTGCC,0,423093
acrZp,0.3333333333333333,2,2,ATTCTTTGGGTGCCCCGTCA,0,412208
acrZp,0.3333333333333333,2,2,ATTCTTTGCTGTCGTCTTTC,0,451800
acrZp,0.3333333333333333,2,2,ATTCTTTATGTTAAAAGTCT,0,429228
acrZp,0.3333333333333333,2,2,ATTCTTGAGGACCTGTGAAG,0,415156
acrZp,0.3333333333333333,2,2,ATTCGTCGTCTTTAGGTCAA,0,431006
acrZp,0.3333333333333333,2,2,ATTCGGGTCGATCCATTTTT,0,411042
acrZp,0.3333333333333333,2,2,ATTCCGCAAAGAGAAGCCGT,0,409141
acrZp,0.3333333333333333,2,2,ATTCCCGTCTCTTGTGTGTT,0,455644
acrZp,0.3333333333333333,2,2,ATTCCAAATCGTCACTGTGG,0,409056
acrZp,0.3333333333333333,2,2,ATTCACTGAGGGGTTTAGTC,0,433035
acrZp,0.3333333333333333,2,2,ATTATCACACGGGCTGACGC,0,428842
acrZp,0.3333333333333333,2,2,ATTAGATAACTGGATGCGGA,0,411675
acrZp,0.3333333333333333,2,2,ATTAGAGTCACTTTCAGAAA,0,449876
acrZp,0.3333333333333333,2,2,ATTACACTTCCCTACAACCA,0,435570
acrZp,0.3333333333333333,2,2,ATGTTTACCTGAATGCTGGA,0,453706
acrZp,0.3333333333333333,2,2,ATGTTGAATAATCCTATCAA,0,453641
acrZp,0.3333333333333333,2,2,ATGTTCGAGGCAACTCAACT,0,443947
acrZp,0.3333333333333333,2,2,ATGTTCAATAGCGGGGCTAG,0,411441
acrZp,0.3333333333333333,2,2,ATGTTCAAGACCCTTGTACT,0,438291
acrZp,0.3333333333333333,2,2,ATGTGTTATATCGCTGTTTG,0,455336
acrZp,0.3333333333333333,2,2,ATGTGGACGGTTCGTAATCA,0,418967
acrZp,0.3333333333333333,2,2,ATGTGATGCTTTCCCCTTTG,0,408870
acrZp,0.3333333333333333,2,2,ATGTCTCGCCAAGACGCTGT,0,449958
acrZp,0.3333333333333333,2,2,ATGTATGCCTAGCAAACCTA,0,436905
acrZp,0.3333333333333333,2,2,ATGTAGGCTCAAACTCTAGC,0,428990
acrZp,0.3333333333333333,2,2,ATGCTGGCATAAAAAGCCCG,0,440372
acrZp,0.3333333333333333,2,2,ATGCGCGAATTATACCTACT,0,413354
acrZp,0.3333333333333333,2,2,ATGCGCATAAACGGTGGAAG,0,420027
acrZp,0.3333333333333333,2,2,ATGCATGTATATGTCGGTGC,0,465146
acrZp,0.3333333333333333,2,2,ATGCATAAGATGTAGCGTGT,0,429361
acrZp,0.3333333333333333,2,2,ATGATTACAAGATCACGATC,0,423200
acrZp,0.3333333333333333,2,2,ATGATGTATAGATGAGCCCA,0,414453
acrZp,0.3333333333333333,2,2,ATGAGGCAGCATGATCCTTT,0,412719
acrZp,0.3333333333333333,2,2,ATGAAGTGTAAAGGTTTCAA,0,439792
acrZp,0.3333333333333333,2,2,ATCTTGAAAGGACCTGCCGG,0,452052
acrZp,0.3333333333333333,2,2,ATCTGGCGCCACACCTACGT,0,432868
acrZp,0.3333333333333333,2,2,ATCGTTGGTATTTCCTGATA,0,443663
acrZp,0.3333333333333333,2,2,ATCGTCCTTCCCTAACACGG,0,458754
acrZp,0.3333333333333333,2,2,ATCGTATTCGATATCCCACA,0,464241
acrZp,0.3333333333333333,2,2,ATCGTAGGCGGGCCAGTTTT,0,443998
acrZp,0.3333333333333333,2,2,ATCGGTCAGAGGCAGAGGAT,0,418148
acrZp,0.3333333333333333,2,2,ATCGGCCCGCGTAGTAGCGC,0,453849
acrZp,0.3333333333333333,2,2,ATCGGAAGGCTCCTTTAAGT,0,416595
acrZp,0.3333333333333333,2,2,ATCGCTCAAGCTATGGGAGG,0,430258
acrZp,0.3333333333333333,2,2,ATCCTGCGCCGGACAGTTGA,0,409548
acrZp,0.3333333333333333,2,2,ATCCATCACCCTCTACGATC,0,448511
acrZp,0.3333333333333333,2,2,ATCATCGCAGTGACCGTTTG,0,418337
acrZp,0.3333333333333333,2,2,ATCACGATGTAGGATGAATT,0,426523
acrZp,0.3333333333333333,2,2,ATCACCGCGCGGGTGTCCCC,0,433647
acrZp,0.3333333333333333,2,2,ATCACCCACCAATATGGTTG,0,467271
acrZp,0.3333333333333333,2,2,ATCAATAAGTGGTTGGGTGC,0,410045
acrZp,0.3333333333333333,2,2,ATCAACCACGGTCATGATCT,0,451582
acrZp,0.3333333333333333,2,2,ATATTGGATAGAGAATGTCT,0,437339
acrZp,0.3333333333333333,2,2,ATATGCATTAAGCTCCAGGG,0,452392
acrZp,0.3333333333333333,2,2,ATATAGGTGATTACCTGTGA,0,435250
acrZp,0.3333333333333333,2,2,ATATAATCCCCTTGCCGTTG,0,452114
acrZp,0.3333333333333333,2,2,ATAGGTGGTTACGTGATGCA,0,424667
acrZp,0.3333333333333333,2,2,ATAGGGCGTTACACCAGAGC,0,410388
acrZp,0.3333333333333333,2,2,ATAGAGCTACCGATATTGTT,0,443976
acrZp,0.3333333333333333,2,2,ATAGACGGTACTCCTCGGCT,0,438172
acrZp,0.3333333333333333,2,2,ATAGACACATGGACATCTGT,0,424193
acrZp,0.3333333333333333,2,2,ATAGAACCCGACGAACGGCT,0,442902
acrZp,0.3333333333333333,2,2,ATACTGTGCAGCAGCACGTT,0,464673
acrZp,0.3333333333333333,2,2,ATACGGTGAAATAAGCCGTT,0,429872
acrZp,0.3333333333333333,2,2,ATACAGCGCACATTGCACTA,0,423987
acrZp,0.3333333333333333,2,2,ATAAGTTCGTTACGCTTCGC,0,455636
acrZp,0.3333333333333333,2,2,ATAAGCTCAAACAGGAAATA,0,412453
acrZp,0.3333333333333333,2,2,ATAAGCTACTATGCTAAATA,0,422119
acrZp,0.3333333333333333,2,2,ATAACGGTATAGCGTTGTAA,0,418204
acrZp,0.3333333333333333,2,2,ATAACATATGCCGATGGCAG,0,463222
acrZp,0.3333333333333333,2,2,ATAAATGTCACCGAATATCC,0,421266
acrZp,0.3333333333333333,2,2,ATAAACGCCTATACTGGAGC,0,448487
acrZp,0.3333333333333333,2,2,AGTTTTTAGCAAGTGTGACT,0,429435
acrZp,0.3333333333333333,2,2,AGTTGGTCAGAAACAGATCG,0,420678
acrZp,0.3333333333333333,2,2,AGTTACGTTCGAAGCGTCAT,0,433008
acrZp,0.3333333333333333,2,2,AGTTACCTAGCCTATTTGGG,0,412609
acrZp,0.3333333333333333,2,2,AGTGTACCACGTCAGACCAT,0,449895
acrZp,0.3333333333333333,2,2,AGTGGTCAGACGGAAATGAT,0,450130
acrZp,0.3333333333333333,2,2,AGTGGGCTCTTGGTCACACG,0,439940
acrZp,0.3333333333333333,2,2,AGTGCGCTTTAGGAACCGTC,0,434084
acrZp,0.3333333333333333,2,2,AGTGCAAGGGCTGGGGCCGT,0,411539
acrZp,0.3333333333333333,2,2,AGTGAGCGTTAAGCCCAAGT,0,435614
acrZp,0.3333333333333333,2,2,AGTCTTATCCCGCATCTGGG,0,425249
acrZp,0.3333333333333333,2,2,AGTCGTGCAGTGCTCGGATA,0,447406
acrZp,0.3333333333333333,2,2,AGTCGTGACAGGTGTGTGAG,0,420782
acrZp,0.3333333333333333,2,2,AGTCGTATTCGGCTCTCTCA,0,434511
acrZp,0.3333333333333333,2,2,AGTATTATTTACCTATTTTT,0,459077
acrZp,0.3333333333333333,2,2,AGTATTATCGAAGAAATCTC,0,430115
acrZp,0.3333333333333333,2,2,AGTAGATGAAATGCCCGGAT,0,432213
acrZp,0.3333333333333333,2,2,AGTAAGGGCAGTTCACCATG,0,431483
acrZp,0.3333333333333333,2,2,AGTAACGCTAGCACCGGTAC,0,445809
acrZp,0.3333333333333333,2,2,AGGTTGCCGCGGGTGGCAAC,0,421445
acrZp,0.3333333333333333,2,2,AGGTCTCACCAAGACGGGTC,0,459036
acrZp,0.3333333333333333,2,2,AGGTCCGATCTTACGTTCAC,0,449858
acrZp,0.3333333333333333,2,2,AGGTCCCCGCTCCGTGTGGC,0,448466
acrZp,0.3333333333333333,2,2,AGGTAAGACGATATGAATAG,0,436626
acrZp,0.3333333333333333,2,2,AGGGTACGCATGATGGCTGT,0,451796
acrZp,0.3333333333333333,2,2,AGGGGTGCCTAACGAGGAAC,0,442170
acrZp,0.3333333333333333,2,2,AGGGGTAGAGCCCCCAGGGT,0,446056
acrZp,0.3333333333333333,2,2,AGGGGGGAGGGCACCTAGAA,0,414956
acrZp,0.3333333333333333,2,2,AGGGGGACGGATTACCAAGG,0,432554
acrZp,0.3333333333333333,2,2,AGGGGCATAGACGGATCCCA,0,419746
acrZp,0.3333333333333333,2,2,AGGGCGTGATAAAGGGGACC,0,458077
acrZp,0.3333333333333333,2,2,AGGGATCTCTTTTAGGGGTG,0,447620
acrZp,0.3333333333333333,2,2,AGGGATACAGTAGGACGGAA,0,420732
acrZp,0.3333333333333333,2,2,AGGCTAAAGCAGTTCGCTAT,0,464023
acrZp,0.3333333333333333,2,2,AGGCGTGAACATGACGGTGG,0,460147
acrZp,0.3333333333333333,2,2,AGGCGCCGTGAACTGAGATA,0,458227
acrZp,0.3333333333333333,2,2,AGGCCGGCGCGCAGTTGTTA,0,450723
acrZp,0.3333333333333333,2,2,AGGCCACAGTGGATCGAAAC,0,427233
acrZp,0.3333333333333333,2,2,AGGATGAGCAGAAAGCCATA,0,428378
acrZp,0.3333333333333333,2,2,AGGATACTCGCGAACAAATG,0,420456
acrZp,0.3333333333333333,2,2,AGGAGATATTAAAAAGCACT,0,440526
acrZp,0.3333333333333333,2,2,AGGAGATACTTGCGGACAGA,0,412863
acrZp,0.3333333333333333,2,2,AGGAGAGTATCATTATGCAA,0,411523
acrZp,0.3333333333333333,2,2,AGGAAAGCTGATTGGTTCAA,0,422009
acrZp,0.3333333333333333,2,2,AGCTCGCCCGTTATAGTCAG,0,425541
acrZp,0.3333333333333333,2,2,AGCGGCAAAACACATTTTAA,0,438185
acrZp,0.3333333333333333,2,2,AGCGACAGTGATGACCTCAA,0,455634
acrZp,0.3333333333333333,2,2,AGCCTCGTATGCACCACTCC,0,420557
acrZp,0.3333333333333333,2,2,AGCCAGCCTCGTAGTTGGAA,0,448469
acrZp,0.3333333333333333,2,2,AGCCAGCCATTCTTTTCGAC,0,412116
acrZp,0.3333333333333333,2,2,AGCCACACTGGTCCGCCGGT,0,448026
acrZp,0.3333333333333333,2,2,AGCCACACTATCGTAACGAC,0,449864
acrZp,0.3333333333333333,2,2,AGCAGGAGTAGCTCAGAGCC,0,435278
acrZp,0.3333333333333333,2,2,AGCACACTTATCCCCGACAA,0,412994
acrZp,0.3333333333333333,2,2,AGCAATGTGCAGGTTGTTCA,0,456583
acrZp,0.3333333333333333,2,2,AGCAACAGCCTGCACGCAGA,0,439096
acrZp,0.3333333333333333,2,2,AGATGTCTGTAATACAGCTT,0,447754
acrZp,0.3333333333333333,2,2,AGATGGGTAAAAGGTATGTT,0,416038
acrZp,0.3333333333333333,2,2,AGAGCGTCTAAGAAGGATGT,0,438669
acrZp,0.3333333333333333,2,2,AGAGACTATCAATGCCGGAA,0,419795
acrZp,0.3333333333333333,2,2,AGACCGGTCGGCCGGACCAA,0,408733
acrZp,0.3333333333333333,2,2,AGACATGGATATTTCGGTAC,0,423753
acrZp,0.3333333333333333,2,2,AGAATCCATGGCAGTCGAGT,0,430885
acrZp,0.3333333333333333,2,2,ACTTTACTTCATATCAGCAA,0,440497
acrZp,0.3333333333333333,2,2,ACTTATCCTGGGGTCGCAAT,0,438437
acrZp,0.3333333333333333,2,2,ACTGGATGCTAGGTAGGACC,0,465843
acrZp,0.3333333333333333,2,2,ACTGGACTCACGAACTCTCC,0,433711
acrZp,0.3333333333333333,2,2,ACTGATGATTACACTCCGCA,0,425189
acrZp,0.3333333333333333,2,2,ACTGAATTTTTGCCAAACGC,0,429387
acrZp,0.3333333333333333,2,2,ACTGAAGCATGCCCATCATT,0,429115
acrZp,0.3333333333333333,2,2,ACTCTATTCGTTGGGTAGGA,0,448330
acrZp,0.3333333333333333,2,2,ACTCGACGACACTCTCCCTA,0,417059
acrZp,0.3333333333333333,2,2,ACTCAAACGACCGCTCGAAG,0,417732
acrZp,0.3333333333333333,2,2,ACTACGATGTTTGTACTACT,0,432393
acrZp,0.3333333333333333,2,2,ACTACGAAAGCAGTCTTCAC,0,422820
acrZp,0.3333333333333333,2,2,ACTAAGCTGCAAAACTAGCA,0,415762
acrZp,0.3333333333333333,2,2,ACGTCTCACAGGAATGTATC,0,422918
acrZp,0.3333333333333333,2,2,ACGTCGCTGGCTTTCTTATT,0,413002
acrZp,0.3333333333333333,2,2,ACGTACTGTGAGGTCAGGTG,0,423549
acrZp,0.3333333333333333,2,2,ACGTACGTAGCGCGTTGGGC,0,427140
acrZp,0.3333333333333333,2,2,ACGTAATATGTCGTCCACCC,0,450066
acrZp,0.3333333333333333,2,2,ACGGTCTCGCTCCGCACCGT,0,412118
acrZp,0.3333333333333333,2,2,ACGGGCAAGTAACGAGAAGT,0,449053
acrZp,0.3333333333333333,2,2,ACGCGCTCCCCGCTAACGTT,0,429555
acrZp,0.3333333333333333,2,2,ACGCCGTATTACCTTCGTTT,0,417626
acrZp,0.3333333333333333,2,2,ACGCCGGGTTTAGCTATCAT,0,466431
acrZp,0.3333333333333333,2,2,ACGATCCTCTGGTAGAGTGG,0,409997
acrZp,0.3333333333333333,2,2,ACGAGTGAGTTCCAGTCTGG,0,459262
acrZp,0.3333333333333333,2,2,ACGAGCTGATCAGGGGCACA,0,466970
acrZp,0.3333333333333333,2,2,ACGAAATGATAAGACATTCA,0,452603
acrZp,0.3333333333333333,2,2,ACCTGGATATGAGCATTCTA,0,458978
acrZp,0.3333333333333333,2,2,ACCTCAACGTTGCGGTATGT,0,444105
acrZp,0.3333333333333333,2,2,ACCTAGAGGTGGTTCGACGA,0,415950
acrZp,0.3333333333333333,2,2,ACCTAAATATTACTTGCATC,0,452439
acrZp,0.3333333333333333,2,2,ACCGTTCATGTGCCTACTGG,0,464934
acrZp,0.3333333333333333,2,2,ACCGGGATTACGGGGCGTGA,0,440757
acrZp,0.3333333333333333,2,2,ACCGCAAATTTATGGGCCGA,0,432764
acrZp,0.3333333333333333,2,2,ACCCGACGAAGGCTTGTCGC,0,426087
acrZp,0.3333333333333333,2,2,ACCCACACTTTCCTTGACAA,0,459222
acrZp,0.3333333333333333,2,2,ACCCAAAGTTAGCTTAAAGT,0,426935
acrZp,0.3333333333333333,2,2,ACCATGATAGCGGCAAGAGA,0,459531
acrZp,0.3333333333333333,2,2,ACCAGTTCGTGGATCAGGTT,0,410004
acrZp,0.3333333333333333,2,2,ACCAGGAAGCCTGGATGAGC,0,411197
acrZp,0.3333333333333333,2,2,ACCAGATTGAAATCGAACCT,0,439346
acrZp,0.3333333333333333,2,2,ACCAAGCGGCGAACCCCAGA,0,413065
acrZp,0.3333333333333333,2,2,ACATTCGAGTAATGAAAAAC,0,414692
acrZp,0.3333333333333333,2,2,ACATTAACGGGCAAAACGTA,0,464008
acrZp,0.3333333333333333,2,2,ACATAGCACAGCGCAAGGAT,0,447352
acrZp,0.3333333333333333,2,2,ACAGTATACGTAGGAACATT,0,442427
acrZp,0.3333333333333333,2,2,ACAGGTAAAGCTGCGGGTCT,0,454064
acrZp,0.3333333333333333,2,2,ACAGACCTGCAGCTCACCAT,0,462672
acrZp,0.3333333333333333,2,2,ACACGATTCTTTGGTCGTCA,0,424601
acrZp,0.3333333333333333,2,2,ACACGATTATTGCTGTCTGA,0,426533
acrZp,0.3333333333333333,2,2,ACACAGTTATGTCCAATATC,0,411725
acrZp,0.3333333333333333,2,2,ACAATTCATTCACTGCAGTA,0,422592
acrZp,0.3333333333333333,2,2,ACAATGGAATTACCTACTTC,0,432775
acrZp,0.3333333333333333,2,2,ACAAGGCGGCGTGCAAGACT,0,425551
acrZp,0.3333333333333333,2,2,ACAAGAAATATGGCCAGGTT,0,438704
acrZp,0.3333333333333333,2,2,ACAACGCATCCTTAATGTTC,0,426364
acrZp,0.3333333333333333,2,2,ACAAATTACTTTTTAACTCA,0,426814
acrZp,0.3333333333333333,2,2,ACAAATGTAAACAGAGCGAC,0,449795
acrZp,0.3333333333333333,2,2,ACAAAGGATGTCAATGTTAT,0,446479
acrZp,0.3333333333333333,2,2,ACAAACCTTCCTAATGACAC,0,435894
acrZp,0.3333333333333333,2,2,ACAAACATGGGTGGGTGTCA,0,439926
acrZp,0.3333333333333333,2,2,ACAAAAACTGTGCTTCTGCC,0,423734
acrZp,0.3333333333333333,2,2,AATTTTTATGGACGGAAAGC,0,447770
acrZp,0.3333333333333333,2,2,AATTTTAAAAAAGCTGTACA,0,439944
acrZp,0.3333333333333333,2,2,AATTTGGTATGCGTCCTGCA,0,423501
acrZp,0.3333333333333333,2,2,AATTTATATAGATCCTCCTG,0,426590
acrZp,0.3333333333333333,2,2,AATTGGGTTAATCCACATGA,0,447594
acrZp,0.3333333333333333,2,2,AATGGCGTTGATCATGAAAG,0,456834
acrZp,0.3333333333333333,2,2,AATGACTGTCGGATGTTTCC,0,460060
acrZp,0.3333333333333333,2,2,AATGAACTGAATCGATCCAA,0,455965
acrZp,0.3333333333333333,2,2,AATCTAGTTAGGTGGAGACG,0,437157
acrZp,0.3333333333333333,2,2,AATATCTGGGATCTGGCACC,0,408693
acrZp,0.3333333333333333,2,2,AAGTTTCTGCAGGGGAAGGC,0,454006
acrZp,0.3333333333333333,2,2,AAGTGTCCCATAATTAACCC,0,459624
acrZp,0.3333333333333333,2,2,AAGTGCCGGGACACGTTAGT,0,428783
acrZp,0.3333333333333333,2,2,AAGTCGCTTGGCGGGAGAGT,0,454991
acrZp,0.3333333333333333,2,2,AAGTCATGGTTTTAAAAACG,0,449800
acrZp,0.3333333333333333,2,2,AAGTACCAATGGTGTAACGC,0,452700
acrZp,0.3333333333333333,2,2,AAGGGTTTAGTCGGACTGTA,0,459539
acrZp,0.3333333333333333,2,2,AAGGGCTGTGGTGGCCATAT,0,432738
acrZp,0.3333333333333333,2,2,AAGCCTACAGTATAAGACAG,0,447676
acrZp,0.3333333333333333,2,2,AAGATTATGTCGGCATTTAT,0,461116
acrZp,0.3333333333333333,2,2,AAGATTATCTATTAGAGGAG,0,454025
acrZp,0.3333333333333333,2,2,AAGATAGCCCGAGCAAGCGT,0,418189
acrZp,0.3333333333333333,2,2,AAGACGCCTATAGCGTAGCT,0,424900
acrZp,0.3333333333333333,2,2,AACTCTACCGGAAAATTAAA,0,462332
acrZp,0.3333333333333333,2,2,AACTATCATACACAATTAGA,0,422020
acrZp,0.3333333333333333,2,2,AACGGTTTCGGGTTAACAGA,0,433521
acrZp,0.3333333333333333,2,2,AACGAGCCTTCTATTCGGGG,0,415698
acrZp,0.3333333333333333,2,2,AACGACTAAGGTAGGCGGCA,0,421164
acrZp,0.3333333333333333,2,2,AACGACAAAACCTACACTCA,0,441036
acrZp,0.3333333333333333,2,2,AACCGCGCCACGTGCGGCGT,0,429675
acrZp,0.3333333333333333,2,2,AACCCAAGGTAAATAACATC,0,424670
acrZp,0.3333333333333333,2,2,AACCACGAAAGTTGTACGGT,0,424996
acrZp,0.3333333333333333,2,2,AACATCGGAGGGACGACGCA,0,438136
acrZp,0.3333333333333333,2,2,AACAGGGGTGAATGACCGCC,0,428121
acrZp,0.3333333333333333,2,2,AAATTCTCGGGTGGTCGATT,0,425644
acrZp,0.3333333333333333,2,2,AAATGTCTCAGACTTAATTT,0,434751
acrZp,0.3333333333333333,2,2,AAATACGTGGATTCGATCTG,0,450582
acrZp,0.3333333333333333,2,2,AAAGATACGATGGAAGGCCG,0,426150
acrZp,0.3333333333333333,2,2,AAAGATAAATAGGAACGCTT,0,432763
acrZp,0.3333333333333333,2,2,AAACGTAAGGTCCCTGGACT,0,448693
acrZp,0.3333333333333333,2,2,AAACGGTTCGCAGAATAGGG,0,466171
acrZp,0.3333333333333333,2,2,AAAATCCCCGCGTACCGATC,0,459533
acrZp,0.3333333333333333,2,2,AAAAGTTCGGGCGAAGGTAA,0,444840
acrZp,0.5,1,1,TTTTTTCTTGGGTATCATTG,0,462618
acrZp,0.5,1,1,TTTTGTCCCATTGTGCTCTG,0,432521
acrZp,0.5,1,1,TTTTGGTAGCCAGCCGGGGT,0,432362
acrZp,0.5,1,1,TTTTGGGATTATACTAAGCG,0,456362
acrZp,0.5,1,1,TTTTGGCCTCTTTAGTACGT,0,419980
acrZp,0.5,1,1,TTTTGGATTCGCTCATACGA,0,426268
acrZp,0.5,1,1,TTTTGCCGATAAGCGGTTAC,0,432240
acrZp,0.5,1,1,TTTTGCCATGTAGGCGCCGT,0,459814
acrZp,0.5,1,1,TTTTCTTTGCGAACTGAATA,0,431474
acrZp,0.5,1,1,TTTTCTGTTCTGGACTCGTA,0,423891
acrZp,0.5,1,1,TTTTCCTCCGCGTTCAAGGT,0,450854
acrZp,0.5,1,1,TTTTACTGGCATGTTAATTA,0,421715
acrZp,0.5,1,1,TTTGTAGGCAGTGGGTAGCA,0,445897
acrZp,0.5,1,1,TTTGGTCTGTCCGGAGTGTA,0,417950
acrZp,0.5,1,1,TTTGCGGATGTCGTGCAAAA,0,448060
acrZp,0.5,1,1,TTTGCCTTGGTCTAACTAGG,0,429071
acrZp,0.5,1,1,TTTGCCTAATACACATGGGC,0,427735
acrZp,0.5,1,1,TTTGCCGGTTTAGAGACGAG,0,416641
acrZp,0.5,1,1,TTTGCCAACAGCCAGATAAC,0,463208
acrZp,0.5,1,1,TTTGATGAGAGGTGGGAAGT,0,432354
acrZp,0.5,1,1,TTTCTGTAGAGGTAAGTACG,0,436082
acrZp,0.5,1,1,TTTCTCCAGAATGCAAACCT,0,426752
acrZp,0.5,1,1,TTTCGTACTTTCGTCCTGGC,0,428428
acrZp,0.5,1,1,TTTCGGTGGCTTGATGCGCC,0,464860
acrZp,0.5,1,1,TTTCGAGTAAATCGACTGCC,0,452455
acrZp,0.5,1,1,TTTCCTGAGGGAAGGCATGC,0,444862
acrZp,0.5,1,1,TTTCAGGAGAGGTCGGGCGA,0,433538
acrZp,0.5,1,1,TTTCAGGAAATCCGTAAATC,0,419146
acrZp,0.5,1,1,TTTCACTGAACTCGATAGGA,0,416544
acrZp,0.5,1,1,TTTAGTGATGTGGGGCGATC,0,432306
acrZp,0.5,1,1,TTGTTGAAGATCACGGGGGT,0,412191
acrZp,0.5,1,1,TTGTGTGCCATCGCGACCAT,0,462344
acrZp,0.5,1,1,TTGTGGTTCTGGTACGATGT,0,438325
acrZp,0.5,1,1,TTGTCCTTTCCTCAACCAAT,0,417149
acrZp,0.5,1,1,TTGTCAAGCTTGAATATCTC,0,450120
acrZp,0.5,1,1,TTGTATGGGTTCTGTTACTA,0,423378
acrZp,0.5,1,1,TTGGTGGCACCCTCAATGCT,0,466092
acrZp,0.5,1,1,TTGGTCGTGCGCGGTCTTTT,0,419091
acrZp,0.5,1,1,TTGGGTATTTGAGGGCGGTG,0,450114
acrZp,0.5,1,1,TTGGCGTCAAGTTTGCAATG,0,451798
acrZp,0.5,1,1,TTGCTATGCGTAGACGTATT,0,461952
acrZp,0.5,1,1,TTGCTACAGTTTTCGTTCGT,0,409009
acrZp,0.5,1,1,TTGCGGTTTAGAACCCAGCT,0,448502
acrZp,0.5,1,1,TTGATCGTAGGGTCATACCT,0,451419
acrZp,0.5,1,1,TTGAGCTGATCTCATAGTTA,0,456273
acrZp,0.5,1,1,TTGAGACCTATACGCTTCAA,0,416810
acrZp,0.5,1,1,TTGACTGCTAGTGCCAGTAA,0,426984
acrZp,0.5,1,1,TTGACGTTAACTGCTATCCC,0,444078
acrZp,0.5,1,1,TTGAACCAGACTGTCATGCG,0,456611
acrZp,0.5,1,1,TTGAAAATTGCCTTCCTCGG,0,466304
acrZp,0.5,1,1,TTCTTCAGGCCTCCATGGCG,0,412071
acrZp,0.5,1,1,TTCTCTACTTACTTAGGCAT,0,447162
acrZp,0.5,1,1,TTCTAGAGCCCCTGCTCCGT,0,425546
acrZp,0.5,1,1,TTCTACGTGCCTACAGTGAT,0,444981
acrZp,0.5,1,1,TTCTACACATAAAATCGCCT,0,443671
acrZp,0.5,1,1,TTCGTAGAAGGTTGCGACCC,0,453236
acrZp,0.5,1,1,TTCGGCCTCGTTCCTGTCTG,0,421515
acrZp,0.5,1,1,TTCGATCTGCCAGGCCCCAT,0,465920
acrZp,0.5,1,1,TTCGACCCGGACATACTCAC,0,415301
acrZp,0.5,1,1,TTCCTGCGTTCAGTCTCCTA,0,424424
acrZp,0.5,1,1,TTCCTCTTGAAACGCACGTG,0,429367
acrZp,0.5,1,1,TTCCTCTATTCAGAGGGTGA,0,419817
acrZp,0.5,1,1,TTCCTACAGTCTTATTGGAG,0,427758
acrZp,0.5,1,1,TTCCGTCAAAATATTTGCGA,0,459685
acrZp,0.5,1,1,TTCCGGGCTGCTTGACAGGT,0,415911
acrZp,0.5,1,1,TTCCGCAGAAGAGTCAAGCG,0,464897
acrZp,0.5,1,1,TTCCCCTAGCTGAATGCCTG,0,447533
acrZp,0.5,1,1,TTCCCAGCGGGTAAGGAAAA,0,428459
acrZp,0.5,1,1,TTCATTGGGATTATCGGGAT,0,458825
acrZp,0.5,1,1,TTCATGAAGTTCCTCCCACT,0,459133
acrZp,0.5,1,1,TTCATAAATATAAAGACGGC,0,464658
acrZp,0.5,1,1,TTCAGGACTACATACGGACC,0,433378
acrZp,0.5,1,1,TTCAGATATCTGCAGGCCGG,0,415096
acrZp,0.5,1,1,TTCACCACGGGAATGAATCC,0,412424
acrZp,0.5,1,1,TTCAAAAAGGACCGACCCCA,0,444912
acrZp,0.5,1,1,TTATTTTCTGTCCGACAAGC,0,453147
acrZp,0.5,1,1,TTATTTACTATTATACGTAG,0,462309
acrZp,0.5,1,1,TTATGATGTTTCATGTGAAT,0,424415
acrZp,0.5,1,1,TTATCACCCAAGTCATAACT,0,443039
acrZp,0.5,1,1,TTAGTGTCATAGCGGGGCGC,0,461718
acrZp,0.5,1,1,TTAGTATGCCTTACTGACAC,0,431764
acrZp,0.5,1,1,TTAGGTGAACACTCAAAGAT,0,460634
acrZp,0.5,1,1,TTAGGGCGGGCAGGAAACAA,0,451647
acrZp,0.5,1,1,TTAGGGAAAGTGTGGGTGGT,0,438444
acrZp,0.5,1,1,TTAGGCGGATTCTCAGGGGG,0,445825
acrZp,0.5,1,1,TTAGCTACTAAACATACTAC,0,429040
acrZp,0.5,1,1,TTAGCGCCAGTACGGTTTCG,0,450471
acrZp,0.5,1,1,TTAGACTAGGAGAAATATAG,0,416147
acrZp,0.5,1,1,TTACTTTGTGGTTCTGGGCG,0,429838
acrZp,0.5,1,1,TTACTCACTGACCGTTTTAT,0,425377
acrZp,0.5,1,1,TTACTAATGAATATTGCAGC,0,434002
acrZp,0.5,1,1,TTACGGAGTGAGATTCAGAG,0,421221
acrZp,0.5,1,1,TTACGAGCACTCGAGAAAAT,0,434957
acrZp,0.5,1,1,TTACAATAGATTCAGGCAAT,0,432990
acrZp,0.5,1,1,TTAATGCTTGGACTTCCTAC,0,467396
acrZp,0.5,1,1,TTAAGTGCCGGGATAAAGAC,0,436628
acrZp,0.5,1,1,TTAAGGGCGGTGCCACTCCC,0,410561
acrZp,0.5,1,1,TTAAGCGATCTGAGAAATAC,0,423082
acrZp,0.5,1,1,TTAACCCAGTCTGAGTCCCT,0,442327
acrZp,0.5,1,1,TTAACATGTAATGAGCGCTA,0,445105
acrZp,0.5,1,1,TTAAATTGAAGCACCCCGCA,0,460313
acrZp,0.5,1,1,TTAAAATTGAGGCGCCTTGG,0,441117
acrZp,0.5,1,1,TGTTTTCAGGTTTGCTGAGC,0,459554
acrZp,0.5,1,1,TGTTGTAGGGCAGGGCGACG,0,408973
acrZp,0.5,1,1,TGTTGCGTAACGGTCGGTAT,0,420144
acrZp,0.5,1,1,TGTTCATCACAGGGTCCTTC,0,436961
acrZp,0.5,1,1,TGTTACCGAAAAATATCCGC,0,437995
acrZp,0.5,1,1,TGTTAAGTGGCGGTGACTTA,0,451970
acrZp,0.5,1,1,TGTGTTCGTGGTTAAGGGGA,0,430970
acrZp,0.5,1,1,TGTGGTGTCCACAGAGCGAG,0,432511
acrZp,0.5,1,1,TGTGCTTCTCGTTGGGTGCT,0,464643
acrZp,0.5,1,1,TGTGCCAGGCGGAATAGTTA,0,433673
acrZp,0.5,1,1,TGTGACCCAAGGGCGTCCTG,0,420776
acrZp,0.5,1,1,TGTGAACCCAAGAAATTTGA,0,431678
acrZp,0.5,1,1,TGTCTTATCAGCATAGAGTA,0,422022
acrZp,0.5,1,1,TGTCTCAACTTGGGGGCCAT,0,464512
acrZp,0.5,1,1,TGTCCGTTATCTTAATCACA,0,418511
acrZp,0.5,1,1,TGTATTTCGCGTGTGTATCT,0,438170
acrZp,0.5,1,1,TGTAACCCTTCACGTCACTA,0,431193
acrZp,0.5,1,1,TGTAAACCGCTTCCATATAT,0,411578
acrZp,0.5,1,1,TGGTTTATCATGGCGATATG,0,417297
acrZp,0.5,1,1,TGGTTTAAACGGCGTCGGCA,0,466785
acrZp,0.5,1,1,TGGTGCGACTGCTAGTATTC,0,450777
acrZp,0.5,1,1,TGGTCTTCGTTGGCAAGGTT,0,420332
acrZp,0.5,1,1,TGGTCAGCGTTGTGCTCAGG,0,463255
acrZp,0.5,1,1,TGGTAGTATCGATGGAGTGA,0,466374
acrZp,0.5,1,1,TGGTAGCAATAGCCAGAACT,0,443907
acrZp,0.5,1,1,TGGTAGAGTCTGGATAACAG,0,460211
acrZp,0.5,1,1,TGGGTGCCACACATTTCGGT,0,426559
acrZp,0.5,1,1,TGGGTCTTAGATGGGCGATA,0,414816
acrZp,0.5,1,1,TGGGTCATGTAGAATGGAGC,0,464465
acrZp,0.5,1,1,TGGGGGTACCACAAGGCTAG,0,433386
acrZp,0.5,1,1,TGGGGGCATTGTCAAATACT,0,435581
acrZp,0.5,1,1,TGGGCTTTCGTTCCTTACTG,0,454994
acrZp,0.5,1,1,TGGGCGCACCACGGTACGTG,0,451057
acrZp,0.5,1,1,TGGGCCATGATCCATTAATC,0,436115
acrZp,0.5,1,1,TGGGCACAGTCCACTACAAG,0,456482
acrZp,0.5,1,1,TGGCTGTATAGAAGAGATGG,0,411689
acrZp,0.5,1,1,TGGCTGAAGTATGGGTCGGG,0,436034
acrZp,0.5,1,1,TGGCGGTTAAGCTCGGCAGT,0,462678
acrZp,0.5,1,1,TGGCGCATAGAACGTTTTAG,0,423803
acrZp,0.5,1,1,TGGCGCACCTATCCGATGGT,0,449512
acrZp,0.5,1,1,TGGCCAACAGCAGAATTAGG,0,409758
acrZp,0.5,1,1,TGGCACACTCACCGCTGTAC,0,457997
acrZp,0.5,1,1,TGGATCTCGACGTCCAAAAC,0,463826
acrZp,0.5,1,1,TGGAGTGGCATGTACCTTCC,0,448014
acrZp,0.5,1,1,TGGAGGTGGGCGTAACTTAC,0,459120
acrZp,0.5,1,1,TGGACCAGCGCAGAATGGAA,0,451984
acrZp,0.5,1,1,TGGACAATCGATGGACTCAG,0,421051
acrZp,0.5,1,1,TGGAATCGAAGCCCGTATAC,0,424317
acrZp,0.5,1,1,TGCTTGTCGATGTTTTCATG,0,425497
acrZp,0.5,1,1,TGCTCAAGACGTTTGACAGT,0,439214
acrZp,0.5,1,1,TGCTACAGAGGACTGTTATC,0,452931
acrZp,0.5,1,1,TGCTAAGTAGCCCTAAACGA,0,448504
acrZp,0.5,1,1,TGCGTGCAAATGATTTATCC,0,464701
acrZp,0.5,1,1,TGCGTCTCACATTGCGGGTA,0,456462
acrZp,0.5,1,1,TGCGGTTCACTAGCGGAGAA,0,438169
acrZp,0.5,1,1,TGCGCTAACCGTTACCACGA,0,427909
acrZp,0.5,1,1,TGCGCCGCAGCGTTTCATTT,0,450011
acrZp,0.5,1,1,TGCGCACCTAATTGTCGTTG,0,431196
acrZp,0.5,1,1,TGCGATGCGCCAGGGTAAAA,0,464230
acrZp,0.5,1,1,TGCGACCCACCTCTTCCCCG,0,460017
acrZp,0.5,1,1,TGCCTAGTAAACGGCTTTAC,0,422036
acrZp,0.5,1,1,TGCCGGTTCGGACTCCTTAT,0,448286
acrZp,0.5,1,1,TGCCGGTGAGGCATGATTGT,0,415718
acrZp,0.5,1,1,TGCCGCGCCCGCTTGCCAAT,0,440253
acrZp,0.5,1,1,TGCCCTTCAGCTCCTTCTAC,0,447979
acrZp,0.5,1,1,TGCCACTGTAATCGCGCAGA,0,456262
acrZp,0.5,1,1,TGCCACTCACGACCCATTAT,0,429881
acrZp,0.5,1,1,TGCCAAAGTACAGCATTTCA,0,409524
acrZp,0.5,1,1,TGCAGTTAGGTTGGGTGACC,0,425917
acrZp,0.5,1,1,TGCACATTCTCCTTTAGCGT,0,437028
acrZp,0.5,1,1,TGATGTGTGATGTGAGAGTT,0,457642
acrZp,0.5,1,1,TGATGCCGCTTAGCGCCGAC,0,445415
acrZp,0.5,1,1,TGATGAATCCAGGGACCCGC,0,421433
acrZp,0.5,1,1,TGATCTGTGGCTCCGCTATT,0,447976
acrZp,0.5,1,1,TGAGTTTGCATAGCAACAAA,0,466278
acrZp,0.5,1,1,TGAGGGGCAGAAAACAACCC,0,465276
acrZp,0.5,1,1,TGAGGGAACCGCGAAGATTA,0,448541
acrZp,0.5,1,1,TGAGGCAAGTGTAGGGCGTT,0,423195
acrZp,0.5,1,1,TGAGGAAGTAAGAACGATTC,0,417132
acrZp,0.5,1,1,TGAGCTTAGATCTCCGGGAT,0,429739
acrZp,0.5,1,1,TGAGCGGTCGCTCGTATTGG,0,449068
acrZp,0.5,1,1,TGAGCCACTAGCCCCCGGTG,0,431016
acrZp,0.5,1,1,TGAGACGCGATGTTAAGACG,0,453280
acrZp,0.5,1,1,TGACTTTATGTGAGGCCGCT,0,420749
acrZp,0.5,1,1,TGACTTAGCTCCGCCCCTCG,0,442177
acrZp,0.5,1,1,TGACTGTTTCCTTGCTCTGT,0,435114
acrZp,0.5,1,1,TGACGTCTTTTTTCGAAAAA,0,445843
acrZp,0.5,1,1,TGACATTGGTGTGTCATACC,0,465270
acrZp,0.5,1,1,TGACATCGGCCTTGTGGATA,0,416170
acrZp,0.5,1,1,TGACAGTGTAATTATGCAGT,0,436821
acrZp,0.5,1,1,TGACAGAGTAACGGTGTTAG,0,418656
acrZp,0.5,1,1,TGAAGTTTAGGGCTGATAAT,0,410464
acrZp,0.5,1,1,TGAAGGGAAATATGTGGCGT,0,446995
acrZp,0.5,1,1,TGAAGGATTGCACGAGCGTA,0,431645
acrZp,0.5,1,1,TGAACGCGGGTGATTAGAAT,0,420725
acrZp,0.5,1,1,TGAACGCAGCGGAGCGTCCT,0,419168
acrZp,0.5,1,1,TGAACCATCCAGCTGCGAGA,0,422736
acrZp,0.5,1,1,TGAACATACGCTAAACGCCG,0,452831
acrZp,0.5,1,1,TGAACACGTGTCCAATGATC,0,419637
acrZp,0.5,1,1,TGAAATTCTGTGACTGGTCC,0,414252
acrZp,0.5,1,1,TGAAATAAAGGACGAGTCTA,0,419440
acrZp,0.5,1,1,TGAAAACCCGTCAAGCTTGA,0,432995
acrZp,0.5,1,1,TCTTTTCCAATTTCGAAAAT,0,435493
acrZp,0.5,1,1,TCTTTGCCAGTTGACAAAGC,0,461619
acrZp,0.5,1,1,TCTTTCCGAAACGTGAGCTC,0,427608
acrZp,0.5,1,1,TCTTCCATGGTGAATGGCTT,0,457849
acrZp,0.5,1,1,TCTTACTCTTGTGGACGTGG,0,432151
acrZp,0.5,1,1,TCTTACGACTAAAGAGCAGA,0,433756
acrZp,0.5,1,1,TCTGTTGAGCCCTGCTATAT,0,447205
acrZp,0.5,1,1,TCTGTGGGATAATGGCCATA,0,455971
acrZp,0.5,1,1,TCTGGAGTGCTTTTTTTTCG,0,457259
acrZp,0.5,1,1,TCTGCTCGATTCCAAGTGTC,0,420056
acrZp,0.5,1,1,TCTGCGGTGCGGTCGGGGTA,0,461090
acrZp,0.5,1,1,TCTGCATGTTAAACTGTAGC,0,441556
acrZp,0.5,1,1,TCTGCAGAACCTTTTAGAAT,0,454849
acrZp,0.5,1,1,TCTGATTACATACAGTTCCA,0,454005
acrZp,0.5,1,1,TCTGAGGCGTCAGGGGCGAG,0,439812
acrZp,0.5,1,1,TCTGAGCCCCCACATAACTG,0,415067
acrZp,0.5,1,1,TCTCTTGGAATACGCTGAGA,0,431021
acrZp,0.5,1,1,TCTCTGCAAGTGGGCACAGC,0,439935
acrZp,0.5,1,1,TCTCCGCGTGCAAGGGCATA,0,459483
acrZp,0.5,1,1,TCTCATTCACTGAGGGATGG,0,415744
acrZp,0.5,1,1,TCTCAAGGCGTCATATGTCT,0,420429
acrZp,0.5,1,1,TCTCAAGCGGCGGGTGTCAA,0,448408
acrZp,0.5,1,1,TCTACGTGGGTTGTTGTGCC,0,425921
acrZp,0.5,1,1,TCTACGCGCTAAGTAGTTGT,0,418637
acrZp,0.5,1,1,TCTACATCCCGTACAGGCGC,0,450923
acrZp,0.5,1,1,TCGTTTACGCAGTCCGCATT,0,443021
acrZp,0.5,1,1,TCGTTGGGCGCACTGGGGCT,0,440511
acrZp,0.5,1,1,TCGTTCTGATCGGAGCTATT,0,417134
acrZp,0.5,1,1,TCGTGTGTGCATCGCATCAC,0,459540
acrZp,0.5,1,1,TCGTGTAAGAACGTACGATA,0,446986
acrZp,0.5,1,1,TCGTAGAGCTAGAAAAACGG,0,424621
acrZp,0.5,1,1,TCGTACTTCAATTAGGGATT,0,461680
acrZp,0.5,1,1,TCGGTTTAAGAGTTTTGTGT,0,451087
acrZp,0.5,1,1,TCGGTAGTGAGCGACTAATA,0,444824
acrZp,0.5,1,1,TCGGGTAATAAACCGGGCTA,0,441576
acrZp,0.5,1,1,TCGGGAGAGGTAGCTGGCAC,0,446547
acrZp,0.5,1,1,TCGGCAAGACCTAAAAAATA,0,462881
acrZp,0.5,1,1,TCGGATGGGGGTCCTTGAAT,0,459100
acrZp,0.5,1,1,TCGGAGTATGCGGGTATGTC,0,432842
acrZp,0.5,1,1,TCGCTTCATCAGACTGTAAA,0,428274
acrZp,0.5,1,1,TCGCTCCGCCAGGGAGCTAT,0,459496
acrZp,0.5,1,1,TCGCTCAACCAAACACCTAG,0,422317
acrZp,0.5,1,1,TCGCAGATATCAAGGCGGGA,0,459515
acrZp,0.5,1,1,TCGCACGGTAAGTGTGCGTC,0,429377
acrZp,0.5,1,1,TCGCAAGACGGATTTATATA,0,428375
acrZp,0.5,1,1,TCGCAACAAAGGGAGTTGTA,0,423342
acrZp,0.5,1,1,TCGATGTAACCCTTTCCGTC,0,442959
acrZp,0.5,1,1,TCGATCTTCTGAGTACCTTT,0,464639
acrZp,0.5,1,1,TCGAGTCTAGTTGTCGTCGT,0,460760
acrZp,0.5,1,1,TCGAGGAGTGTGTAGGTTGA,0,436210
acrZp,0.5,1,1,TCGACTTATGGGCGTATCTC,0,467742
acrZp,0.5,1,1,TCGAAGCTGTGGATATATTA,0,417656
acrZp,0.5,1,1,TCGAAACTGGGTAAACGGGA,0,457434
acrZp,0.5,1,1,TCCTTCGCAGGGACGCGGAA,0,418929
acrZp,0.5,1,1,TCCTGTACGCAATCGCGGCC,0,443908
acrZp,0.5,1,1,TCCTGCATGTTGGCTATCAT,0,410176
acrZp,0.5,1,1,TCCTGATGCCACGCGAAGGC,0,461817
acrZp,0.5,1,1,TCCTCTGAATTTGCCACGAG,0,422105
acrZp,0.5,1,1,TCCTCCGGACTCCTTAAGTT,0,441572
acrZp,0.5,1,1,TCCTAGTATGTATGTCCTCA,0,443311
acrZp,0.5,1,1,TCCTAGGAAGGAACCGAGTT,0,413613
acrZp,0.5,1,1,TCCGTTGGTGAAGCACACCG,0,447385
acrZp,0.5,1,1,TCCGTGATTTGCTGTCAAAT,0,418813
acrZp,0.5,1,1,TCCGTATGCACCAGGCCGGT,0,446589
acrZp,0.5,1,1,TCCGGAACTGACAAGGGTTA,0,420185
acrZp,0.5,1,1,TCCGATTACCCATTCTGTCC,0,460847
acrZp,0.5,1,1,TCCCTATCTATTCGCCACTC,0,438476
acrZp,0.5,1,1,TCCCGGCGGTTGATTTGCAT,0,417308
acrZp,0.5,1,1,TCCCCCGACTGTAAGTCAAC,0,448863
acrZp,0.5,1,1,TCCCAGGAGCAGGCAGGCAT,0,463968
acrZp,0.5,1,1,TCCCAACAGGTTAATCGAGT,0,441790
acrZp,0.5,1,1,TCCATTTCAGCACTTATACA,0,456049
acrZp,0.5,1,1,TCCAGTGTTAAAGTTCGTCT,0,449889
acrZp,0.5,1,1,TCCAGGTAAAGCCTAGCCGT,0,457697
acrZp,0.5,1,1,TCCAGGGAGTAAGATGTGTT,0,459086
acrZp,0.5,1,1,TCCACGGGCTCTTGTGCTTG,0,462450
acrZp,0.5,1,1,TCATCTTTAATAAATGCCTC,0,416772
acrZp,0.5,1,1,TCATCTGTCTGTGATTTGTT,0,436639
acrZp,0.5,1,1,TCATAGCACGCGAAGTGTGA,0,416463
acrZp,0.5,1,1,TCATACGGGCTCATGGCCGA,0,446562
acrZp,0.5,1,1,TCAGTTGAGAATTGAAGGGT,0,431720
acrZp,0.5,1,1,TCAGTCGGACCATTGGGGCT,0,460062
acrZp,0.5,1,1,TCAGGTCTCGTCTCGCTAGA,0,425088
acrZp,0.5,1,1,TCAGGTCAGGCGTGCTGGGC,0,415208
acrZp,0.5,1,1,TCAGGGACCACGGCATACAA,0,414010
acrZp,0.5,1,1,TCAGGCATTAGGAGGTTTTC,0,435371
acrZp,0.5,1,1,TCAGGACGCCGGCATGGAGA,0,443912
acrZp,0.5,1,1,TCAGGACACTCTAAATCTTG,0,412530
acrZp,0.5,1,1,TCAGCCCTTGGTCCGTTTTG,0,451245
acrZp,0.5,1,1,TCAGCAAGACGATGGCTATT,0,412427
acrZp,0.5,1,1,TCAGCAAAGGGAAGAGACTA,0,437303
acrZp,0.5,1,1,TCAGATTCTACCACCTAGGC,0,420908
acrZp,0.5,1,1,TCAGACGCTAAGGCCAATGT,0,464192
acrZp,0.5,1,1,TCAGAAGGCCCGGGCAGGCT,0,464289
acrZp,0.5,1,1,TCACTCGCGTCGCTGGCTGG,0,411328
acrZp,0.5,1,1,TCACTCGATTTTAGGATAGT,0,433398
acrZp,0.5,1,1,TCACTATTACGCCCGGGATG,0,416583
acrZp,0.5,1,1,TCACTAAATTATCGGTTGGA,0,434730
acrZp,0.5,1,1,TCACGCTCGGGCTGCACACA,0,462414
acrZp,0.5,1,1,TCACGCTCCGTAATCCCCCA,0,419178
acrZp,0.5,1,1,TCACGCGGTAGTTATGAAAA,0,455130
acrZp,0.5,1,1,TCACCTGTCGTTCCCGAGAA,0,415901
acrZp,0.5,1,1,TCACCACTTAATGGAGAGGC,0,458731
acrZp,0.5,1,1,TCACACCCTGGGCTATCATG,0,436862
acrZp,0.5,1,1,TCAATCTCGCGTTATTGTCA,0,454590
acrZp,0.5,1,1,TCAATCTACAGTTTGTCGCC,0,446397
acrZp,0.5,1,1,TCAAGTCCTTCACACATTGG,0,428869
acrZp,0.5,1,1,TCAAGTCCAGTGTCGAATGA,0,427989
acrZp,0.5,1,1,TCAAGCCGAGTGGCCAAGAG,0,410574
acrZp,0.5,1,1,TCAACTTCGACCTTTGGAAT,0,449684
acrZp,0.5,1,1,TCAACGCAACCTTCTGTGGT,0,439500
acrZp,0.5,1,1,TCAACGACCCAGGTGGGTGG,0,445298
acrZp,0.5,1,1,TATTTAGACTTCCCGCCGCT,0,456035
acrZp,0.5,1,1,TATTTAAGCTCATTGCGTGT,0,423185
acrZp,0.5,1,1,TATTGATCACACTATCTAAC,0,445859
acrZp,0.5,1,1,TATTCTCATACCGGCGAACT,0,454437
acrZp,0.5,1,1,TATTCTAGGTGGACGTGTTA,0,450995
acrZp,0.5,1,1,TATTACGACGAGTTGCCTTA,0,410777
acrZp,0.5,1,1,TATTAATCTAGTACGCGTGA,0,422517
acrZp,0.5,1,1,TATGTGGAGACCTTTGACGC,0,462313
acrZp,0.5,1,1,TATGGTGAACTTCTTACGCC,0,437896
acrZp,0.5,1,1,TATGGATTTCTAAGGGTAAA,0,409483
acrZp,0.5,1,1,TATGCTATTCTCGTAGGCAT,0,455967
acrZp,0.5,1,1,TATGCCGGGGCGCCTCGGGA,0,412213
acrZp,0.5,1,1,TATGAGCTTCCATTATCCGT,0,451815
acrZp,0.5,1,1,TATGAATTGACTCGAGAAAC,0,422096
acrZp,0.5,1,1,TATCTTGTGTGAGAGTACGT,0,442972
acrZp,0.5,1,1,TATCTGTCATACTTTATGAG,0,444486
acrZp,0.5,1,1,TATCGGCGCAGAGTTCCACC,0,428420
acrZp,0.5,1,1,TATCGGCAAGTCGCTGCAAG,0,412195
acrZp,0.5,1,1,TATCCGGCCTGTACGCTGTG,0,415759
acrZp,0.5,1,1,TATCCCCGCGAAGGGACTAT,0,461678
acrZp,0.5,1,1,TATCCATGCATTTTCGATGC,0,448775
acrZp,0.5,1,1,TATCACGGCACTTCGTCCGC,0,436937
acrZp,0.5,1,1,TATCACCCAAGATCTTCAGA,0,458048
acrZp,0.5,1,1,TATCAAATCGTACCTTTCCT,0,440278
acrZp,0.5,1,1,TATAGCTCATGGGGCTCTGT,0,410154
acrZp,0.5,1,1,TATACCCACTCAGCTGCCTT,0,420393
acrZp,0.5,1,1,TATAATTGCCCTTCGTCCTT,0,449685
acrZp,0.5,1,1,TATAAAATCGGAATTCTCGT,0,455314
acrZp,0.5,1,1,TAGTGGAGAAACGCGGAGTG,0,461323
acrZp,0.5,1,1,TAGGTTAAACGAAAAGAGGT,0,448278
acrZp,0.5,1,1,TAGGGTCCGGCTGCAAGACC,0,429887
acrZp,0.5,1,1,TAGGGGTTAAATAAAGGTAC,0,439581
acrZp,0.5,1,1,TAGGACTTCGGTGCTTCTCT,0,459094
acrZp,0.5,1,1,TAGGAAGAATAAGTCTTGCG,0,421364
acrZp,0.5,1,1,TAGCTCCCGTAATCGCAGCA,0,444266
acrZp,0.5,1,1,TAGCTCAACGTCTGTGCAGC,0,464513
acrZp,0.5,1,1,TAGCGCGGGCCGACCAATCC,0,414199
acrZp,0.5,1,1,TAGCCGCCTTTAATGAAACA,0,421740
acrZp,0.5,1,1,TAGCACGGATTCTAGAGAAC,0,459612
acrZp,0.5,1,1,TAGAGAGTGTGTCCGACTCC,0,410077
acrZp,0.5,1,1,TAGAGAGCGCTAACCCATGA,0,434101
acrZp,0.5,1,1,TACTTCGGTCAAGTTAGCGG,0,466694
acrZp,0.5,1,1,TACTACGATCCGTTTGTGCA,0,424258
acrZp,0.5,1,1,TACGTCACTCACGAGCGATA,0,427769
acrZp,0.5,1,1,TACGCCGTAATGTGTCCTAA,0,442222
acrZp,0.5,1,1,TACGCACGTGGTTGACCAAT,0,442229
acrZp,0.5,1,1,TACGCACGCAACTTGATTAT,0,441990
acrZp,0.5,1,1,TACGCAAGCTGCGCACCGGG,0,431019
acrZp,0.5,1,1,TACGATCTGGCCATTGATCC,0,420374
acrZp,0.5,1,1,TACGACGGATTTGTGTCTCG,0,411853
acrZp,0.5,1,1,TACGAACAGTGTAATGCCAG,0,416304
acrZp,0.5,1,1,TACGAAAAAACGACCCAACC,0,424711
acrZp,0.5,1,1,TACCGTAGATCAGAGCAAGT,0,417089
acrZp,0.5,1,1,TACCCTGTCCTTCCTTATGA,0,408659
acrZp,0.5,1,1,TACCCGCAATCCTTTAATAC,0,415793
acrZp,0.5,1,1,TACATTTAATTAAAAAAAGC,0,433428
acrZp,0.5,1,1,TACAGTTTTGCTACGCCGGT,0,442615
acrZp,0.5,1,1,TACAGTATTCTTTGGCATCT,0,410586
acrZp,0.5,1,1,TAATTTAGTACTGGCGCCGA,0,426460
acrZp,0.5,1,1,TAATTCGCGCCTACAGTTGG,0,448062
acrZp,0.5,1,1,TAATGGAATATGGCATACTG,0,433704
acrZp,0.5,1,1,TAATGAAACGAAGCGGGCGC,0,464827
acrZp,0.5,1,1,TAATCGAACTTCGCATTGCA,0,448435
acrZp,0.5,1,1,TAATCCGTATGTCGCACTGA,0,435168
acrZp,0.5,1,1,TAATAGTCCCTGCTACTATT,0,454092
acrZp,0.5,1,1,TAATACTAACGGAGGAACTA,0,413281
acrZp,0.5,1,1,TAAGTGACCTGTAGGATGGG,0,450181
acrZp,0.5,1,1,TAAGTCCCAGTCCAGTATTG,0,447043
acrZp,0.5,1,1,TAAGTATCACGGTCACGGCT,0,422550
acrZp,0.5,1,1,TAAGCAGCCCCCTAAAGAGT,0,445521
acrZp,0.5,1,1,TAAGAGAAAACTTTGGACGT,0,454589
acrZp,0.5,1,1,TAACTTTACACGGTTCAGGT,0,451446
acrZp,0.5,1,1,TAACGGGAAACACGTGTTAA,0,464901
acrZp,0.5,1,1,TAACGGCCCGAGCTTCCCAC,0,466081
acrZp,0.5,1,1,TAACGCCTATCCAATTTAAA,0,416349
acrZp,0.5,1,1,TAACCTCCAATTTCACGGTA,0,444496
acrZp,0.5,1,1,TAACCACCTGACGGCTTCTG,0,422508
acrZp,0.5,1,1,TAACATTATTTTTATAAGTA,0,451051
acrZp,0.5,1,1,TAACAATGCGCCACGGGGTC,0,435912
acrZp,0.5,1,1,TAACAAGTCACTGGGCATTA,0,444052
acrZp,0.5,1,1,TAAATGTTTCCTTGAACTCA,0,465112
acrZp,0.5,1,1,TAAATCTACACGGGAGTTCA,0,412886
acrZp,0.5,1,1,TAAATATTTTACGCAAAGCT,0,433483
acrZp,0.5,1,1,TAAAGGCGTCAGGTCGCGAG,0,442963
acrZp,0.5,1,1,TAAACGGAAGGTTAGCCAAT,0,450253
acrZp,0.5,1,1,TAAACCGATGGTATTTTTCT,0,443421
acrZp,0.5,1,1,TAAACAGTTGCGGTACCCTA,0,432195
acrZp,0.5,1,1,TAAACAGGTCGGAGTAACTC,0,444461
acrZp,0.5,1,1,TAAAACGTCGGATTTAGGCT,0,432550
acrZp,0.5,1,1,GTTTGTGTGTAGGTTGACTG,0,457430
acrZp,0.5,1,1,GTTTGTCGCAAGTGTAAAAC,0,462833
acrZp,0.5,1,1,GTTTCTATTCTCAGTGCATC,0,442901
acrZp,0.5,1,1,GTTTCTACCGCAGATACCTG,0,412202
acrZp,0.5,1,1,GTTTCCCGCGTGAAAGCACC,0,446398
acrZp,0.5,1,1,GTTTCACAGAGATGGTCAGC,0,432802
acrZp,0.5,1,1,GTTTAAGTAACGTAGTCCCG,0,428114
acrZp,0.5,1,1,GTTGTCTGTTTTCATGATTG,0,446020
acrZp,0.5,1,1,GTTGGCGCGAAGGCCGCTTT,0,453919
acrZp,0.5,1,1,GTTGGCAGAAGCTCCTACTT,0,431133
acrZp,0.5,1,1,GTTGCCGCGACCGGCCAACG,0,438966
acrZp,0.5,1,1,GTTGATTGATTGAACCTACA,0,418707
acrZp,0.5,1,1,GTTGATTAGTGCTCCTTATG,0,445006
acrZp,0.5,1,1,GTTGACTAGGACTTCCGGAA,0,435508
acrZp,0.5,1,1,GTTCTTTGGCTACGTGAGAC,0,421531
acrZp,0.5,1,1,GTTCTTCCTGCTGCGCCCTG,0,457198
acrZp,0.5,1,1,GTTCGGTAGGTGGAATTTGC,0,421490
acrZp,0.5,1,1,GTTCGGACCCCTCTTATTTC,0,462665
acrZp,0.5,1,1,GTTCGCTTTCAGGCATGAAC,0,446764
acrZp,0.5,1,1,GTTCATGGAGTTCTTGTATG,0,442773
acrZp,0.5,1,1,GTTCAGCTATACCTTTCCTA,0,411587
acrZp,0.5,1,1,GTTCAGCGCAAAAAGTGGGG,0,414861
acrZp,0.5,1,1,GTTCACGAAGTTAGCAAAGG,0,412220
acrZp,0.5,1,1,GTTCACCCGCTAGGATTCAT,0,438345
acrZp,0.5,1,1,GTTATTTTGGTTTCCTAGTC,0,435905
acrZp,0.5,1,1,GTTATTTATTGGTTCCGCGC,0,423074
acrZp,0.5,1,1,GTTATTCCTTCCTTTATTCT,0,459056
acrZp,0.5,1,1,GTTATGTGCAGTAATACAAA,0,466538
acrZp,0.5,1,1,GTTACTTGGGAAATAGTCAA,0,436742
acrZp,0.5,1,1,GTTACCCTGAGATTGGATGG,0,456786
acrZp,0.5,1,1,GTTAAACGCGTGGTCCTCCT,0,445386
acrZp,0.5,1,1,GTGTTCCTTTCCCGGATTTC,0,419224
acrZp,0.5,1,1,GTGTTAATGGTCATGTACAA,0,437615
acrZp,0.5,1,1,GTGTGTGGGCGGTAGATGTT,0,425213
acrZp,0.5,1,1,GTGTGGCTGGCTGCTATAAG,0,439604
acrZp,0.5,1,1,GTGTATCGGCGACGTGATTT,0,413605
acrZp,0.5,1,1,GTGTAATGTTACCGGTGTAC,0,412419
acrZp,0.5,1,1,GTGTAAACCTGGTCCACCGA,0,461462
acrZp,0.5,1,1,GTGGTCTTGAGTGTCAATGA,0,437732
acrZp,0.5,1,1,GTGGTCACGACGTAATTCAG,0,463408
acrZp,0.5,1,1,GTGGAGACCAGAGGCAAAAC,0,426205
acrZp,0.5,1,1,GTGCTGGTGCTCTCTTCGGG,0,417128
acrZp,0.5,1,1,GTGCTCAGTAGCACAGATGA,0,430790
acrZp,0.5,1,1,GTGCGTGCGCTACATGAGAC,0,464273
acrZp,0.5,1,1,GTGCGTGCAAGTTTTCTGAG,0,431535
acrZp,0.5,1,1,GTGCGTAAAATTAAGGGTAG,0,419286
acrZp,0.5,1,1,GTGCCTTATAACAATGAGAG,0,428527
acrZp,0.5,1,1,GTGCCCAACCGTTCTGCTAT,0,410715
acrZp,0.5,1,1,GTGCCAGAAGCCGGGCGCGT,0,423696
acrZp,0.5,1,1,GTGCATAAGCCCGTCTGCCT,0,458762
acrZp,0.5,1,1,GTGCACGTCATTGCCAAACC,0,446019
acrZp,0.5,1,1,GTGCAATTATATCTTAGGTT,0,455418
acrZp,0.5,1,1,GTGCAAGTAGATATTTGAGT,0,464180
acrZp,0.5,1,1,GTGATTCTACGGCAAGTGTC,0,430772
acrZp,0.5,1,1,GTGATCGGATTGAATGGTTG,0,418202
acrZp,0.5,1,1,GTGAGTTCGAATATGACCTA,0,415844
acrZp,0.5,1,1,GTGAGGTGCGGCGGTAGCTC,0,432170
acrZp,0.5,1,1,GTGACTGTTGTTCCTGAGTA,0,434490
acrZp,0.5,1,1,GTGACTAGGAAGGTACGAAC,0,430648
acrZp,0.5,1,1,GTGACGTTGGGACGCGACGA,0,461419
acrZp,0.5,1,1,GTGACGGCTGCGCTCCGCTT,0,441344
acrZp,0.5,1,1,GTGAATCTATTAGGAGAGGA,0,454350
acrZp,0.5,1,1,GTGAAGGGGAGCGAAGTGGG,0,450143
acrZp,0.5,1,1,GTCTTTACTATTTCCATTCA,0,418395
acrZp,0.5,1,1,GTCTTTACCTACATATATAT,0,425548
acrZp,0.5,1,1,GTCTTAGGAGTCACTGGTGA,0,425366
acrZp,0.5,1,1,GTCTGGTTTAAAGGGTAAGA,0,446717
acrZp,0.5,1,1,GTCTGAAACACATGGGGTCA,0,460020
acrZp,0.5,1,1,GTCTCTCGACCCGTGACCGG,0,416362
acrZp,0.5,1,1,GTCTCACGTCTGATTCGAAA,0,423019
acrZp,0.5,1,1,GTCTATATAGCCAAGGAGGC,0,445935
acrZp,0.5,1,1,GTCGGCGGATATTGCCAACG,0,420033
acrZp,0.5,1,1,GTCGGAATGACAGGTAATTC,0,423948
acrZp,0.5,1,1,GTCGCGTCCCGGCGTCGAAT,0,443252
acrZp,0.5,1,1,GTCGCGCGGTCGCCGAATTT,0,410883
acrZp,0.5,1,1,GTCGCCGCACCAATCAAGAG,0,435839
acrZp,0.5,1,1,GTCGCAAATTGAGATGATTA,0,456265
acrZp,0.5,1,1,GTCGACTTTTAGTGGTGTGG,0,419250
acrZp,0.5,1,1,GTCGAAGTGCTACGGCCTAT,0,419871
acrZp,0.5,1,1,GTCGAACTGGAGTCTTCATA,0,442550
acrZp,0.5,1,1,GTCCTTCATCCATCGAGTCC,0,412586
acrZp,0.5,1,1,GTCCTTACTGGACCTTCAAA,0,436873
acrZp,0.5,1,1,GTCCTCGTAACATCGAAAAG,0,456948
acrZp,0.5,1,1,GTCCGGCATCCGGTTCGTCC,0,460959
acrZp,0.5,1,1,GTCCGCGTTTGTCTTGAGAT,0,426819
acrZp,0.5,1,1,GTCCCTTATTTCGAGACTTT,0,412637
acrZp,0.5,1,1,GTCCCCTTGGCTATAGTACA,0,466250
acrZp,0.5,1,1,GTCCATAGTACAGTCGAGCT,0,459080
acrZp,0.5,1,1,GTCCAGAGAGATCTAGCTTA,0,433345
acrZp,0.5,1,1,GTCATCAAATGGAAGCGTGC,0,455721
acrZp,0.5,1,1,GTCATAGGGATGTCTATAGT,0,463455
acrZp,0.5,1,1,GTCAGTGCAATCCTCAGTTG,0,430031
acrZp,0.5,1,1,GTCAGCGGGGAGAGCCTGAT,0,439559
acrZp,0.5,1,1,GTCAGCAGCGTGTAGAAACC,0,458234
acrZp,0.5,1,1,GTCACTCTCCACTGACTATT,0,446588
acrZp,0.5,1,1,GTCAATTTATTTATTCAGTG,0,456576
acrZp,0.5,1,1,GTCAATACCTCTTGCGCGTA,0,457102
acrZp,0.5,1,1,GTCAATACAGTTAGGCCTAT,0,428329
acrZp,0.5,1,1,GTCAACGTTTGCCACCGAAG,0,433693
acrZp,0.5,1,1,GTCAACCTGGATTACTTACA,0,429288
acrZp,0.5,1,1,GTATGCTGCCCCACTGTGCT,0,456377
acrZp,0.5,1,1,GTATGCGCGTAGCTGTGAAC,0,457231
acrZp,0.5,1,1,GTATGATTAGGACGGCGCCA,0,418188
acrZp,0.5,1,1,GTATGATCACCATACGGGAT,0,460930
acrZp,0.5,1,1,GTAGTGGGAGGTGTGCGGAG,0,413355
acrZp,0.5,1,1,GTAGGTTGGCTACAGTGCGT,0,443340
acrZp,0.5,1,1,GTAGGGCGTAGAGCGGAGTC,0,419305
acrZp,0.5,1,1,GTAGGGCCAGCATTAACTCG,0,460246
acrZp,0.5,1,1,GTAGGCTCCATGCAATTATA,0,451038
acrZp,0.5,1,1,GTAGGAGTCGTAACTGGCAT,0,450878
acrZp,0.5,1,1,GTAGCGAGCTCTCATTTTTA,0,448643
acrZp,0.5,1,1,GTAGATTGAATAATAGGCTC,0,427080
acrZp,0.5,1,1,GTAGATACTTCTCTGTTGCG,0,409558
acrZp,0.5,1,1,GTACGGGATCGGAGTAGGTA,0,410208
acrZp,0.5,1,1,GTACGATAGGCTATGCCACA,0,465589
acrZp,0.5,1,1,GTACCGGACCTTTACGCATT,0,458773
acrZp,0.5,1,1,GTACAATCCAGCATGAATCG,0,438087
acrZp,0.5,1,1,GTAATTAAGTTCAACGGTGC,0,412024
acrZp,0.5,1,1,GTAATGTTGAACTCATATGA,0,465968
acrZp,0.5,1,1,GTAATCCGAGCAGTAGTCCC,0,434012
acrZp,0.5,1,1,GTAATACGCCCGGGGGTCAC,0,438341
acrZp,0.5,1,1,GTAAGAGGCGGAATCATCAT,0,409314
acrZp,0.5,1,1,GTAACTCGTCAGCGCCCTCC,0,442620
acrZp,0.5,1,1,GTAAACGGTATGACGTGCGT,0,446018
acrZp,0.5,1,1,GGTTTCACGGACACACTGGC,0,442493
acrZp,0.5,1,1,GGTTTAACGTAAGACTCCCA,0,451958
acrZp,0.5,1,1,GGTTGGACGGAGATAGCACT,0,461402
acrZp,0.5,1,1,GGTTCTCGCTACCGATGTCA,0,458460
acrZp,0.5,1,1,GGTTAAGATACATAGAGAGA,0,440881
acrZp,0.5,1,1,GGTTAACTCTACTTTATGTC,0,422464
acrZp,0.5,1,1,GGTGTGGTGATACTGCGGAA,0,411491
acrZp,0.5,1,1,GGTGTATATGGGGCCACAAC,0,411594
acrZp,0.5,1,1,GGTGGTAGACCTGCATGCTG,0,411792
acrZp,0.5,1,1,GGTGGGTAAGTTTAACTGGG,0,417200
acrZp,0.5,1,1,GGTGGCGCACTGTTGCTTTA,0,410538
acrZp,0.5,1,1,GGTGGCATTCTTGCACGGTT,0,421604
acrZp,0.5,1,1,GGTGGCAGCATATATCGCAA,0,463496
acrZp,0.5,1,1,GGTGGCAATATTTGTGCTCT,0,459360
acrZp,0.5,1,1,GGTGCGGGAGGGGGGTTATA,0,429783
acrZp,0.5,1,1,GGTGACTAGAACTGTAATTT,0,447309
acrZp,0.5,1,1,GGTCTGGATCATCCGCTCGT,0,452698
acrZp,0.5,1,1,GGTCTGCATCGCGTGCAGTT,0,437841
acrZp,0.5,1,1,GGTCTGAGGCAATCTAGTAA,0,449681
acrZp,0.5,1,1,GGTCGAGGTCCGAGTTCCGT,0,466286
acrZp,0.5,1,1,GGTCCTGATACCCGACATAA,0,448674
acrZp,0.5,1,1,GGTCCTATTGATAAGCCATA,0,414448
acrZp,0.5,1,1,GGTCCGTTACTGCGGCAATC,0,454591
acrZp,0.5,1,1,GGTCCGGAAAGGAGGCAAGG,0,430113
acrZp,0.5,1,1,GGTCCCATGATCCGGAAGTA,0,421427
acrZp,0.5,1,1,GGTCCAGACCTCGTAGCGTC,0,447121
acrZp,0.5,1,1,GGTCATTAAGTCTGGAGCGC,0,412739
acrZp,0.5,1,1,GGTCATAGTACCCATTCCTC,0,412027
acrZp,0.5,1,1,GGTCAGTTTTATTTGTCCAA,0,453250
acrZp,0.5,1,1,GGTCAGTAATGGTGCGAAAT,0,427234
acrZp,0.5,1,1,GGTCAGCGAGGTCACGCTTT,0,423009
acrZp,0.5,1,1,GGTCAGACCCGGATCGAGTT,0,420731
acrZp,0.5,1,1,GGTAGAGAGGACCCCACGCT,0,466094
acrZp,0.5,1,1,GGGTTTGAAATCCGCCAGCT,0,466901
acrZp,0.5,1,1,GGGTTTCTTCAAGTCGTTTG,0,419171
acrZp,0.5,1,1,GGGTTGGACTTACGTATAAT,0,409547
acrZp,0.5,1,1,GGGTTGCGAGAGTCGGATAT,0,456487
acrZp,0.5,1,1,GGGTTCTGCTATAAGCCAGG,0,435844
acrZp,0.5,1,1,GGGTCTAGGAGAGCAGAGAT,0,445846
acrZp,0.5,1,1,GGGTACGCATGACGAAGGTC,0,417390
acrZp,0.5,1,1,GGGGTGATGAATCACACCGT,0,426856
acrZp,0.5,1,1,GGGGGCCCACGAGACGACGA,0,436741
acrZp,0.5,1,1,GGGGGCACTACGGACGTCCG,0,421881
acrZp,0.5,1,1,GGGGCCGTTGGAGGCTTTCA,0,421759
acrZp,0.5,1,1,GGGGCAGTCGCACCGTTAAA,0,428548
acrZp,0.5,1,1,GGGGATTAGCCAACTGCCGG,0,456383
acrZp,0.5,1,1,GGGGACTAGAAATTCACAAA,0,409158
acrZp,0.5,1,1,GGGGAAGGGGACGGATTGTC,0,420795
acrZp,0.5,1,1,GGGCTAAGGCTCGATCCGCA,0,410694
acrZp,0.5,1,1,GGGCGTTTCTCACCAACCCG,0,451828
acrZp,0.5,1,1,GGGCGTGCCAAGGATCTGTA,0,447110
acrZp,0.5,1,1,GGGCGGTACGTGCCTCTCCA,0,423269
acrZp,0.5,1,1,GGGCGGCTTGATAATCCCTG,0,419628
acrZp,0.5,1,1,GGGCGCTATGCAGTTCGGCA,0,412817
acrZp,0.5,1,1,GGGCGAATCGTCGGGCTTAG,0,438374
acrZp,0.5,1,1,GGGCCGTGAGGCGATGGATA,0,446719
acrZp,0.5,1,1,GGGCCGGTGGATGCTGATCT,0,444383
acrZp,0.5,1,1,GGGCCGGAAATATTGATAGC,0,448426
acrZp,0.5,1,1,GGGCAGTCAGGTTTACCATT,0,438620
acrZp,0.5,1,1,GGGATTGCGAGATCACTAAG,0,414797
acrZp,0.5,1,1,GGGATTAAAGGACCGCAAGC,0,412782
acrZp,0.5,1,1,GGGATATAGGCTGCTTTCTA,0,465367
acrZp,0.5,1,1,GGGAGGTAAGCCGAAGCCCA,0,460903
acrZp,0.5,1,1,GGGAGAATGATAATAAGAGC,0,465855
acrZp,0.5,1,1,GGGACTTTCTCCCGTGACTG,0,411173
acrZp,0.5,1,1,GGGAAGGAGGAGGAGCCTAC,0,464178
acrZp,0.5,1,1,GGGAACTAGACAGGATAGAA,0,411728
acrZp,0.5,1,1,GGCTTCGCTTGAAGCTCATT,0,455995
acrZp,0.5,1,1,GGCTTATAGTAGCATAATCT,0,411837
acrZp,0.5,1,1,GGCTGTTAGGTACTTGAGAA,0,411807
acrZp,0.5,1,1,GGCTCTGCGGTATCTCGCCG,0,453365
acrZp,0.5,1,1,GGCTCGTGCAACGGTGAGGT,0,414582
acrZp,0.5,1,1,GGCTCACCGATAGAAGCAAA,0,429569
acrZp,0.5,1,1,GGCTACGGTGCTTCGAATGG,0,460518
acrZp,0.5,1,1,GGCGTTTGAGCTTCAAATGG,0,421156
acrZp,0.5,1,1,GGCGTGAACTCATATCATAG,0,458017
acrZp,0.5,1,1,GGCGTCCTAATCCCATGCAT,0,456517
acrZp,0.5,1,1,GGCGTATACAGACACATGTC,0,411153
acrZp,0.5,1,1,GGCGGGGGTTCTACATCATG,0,440894
acrZp,0.5,1,1,GGCGGAACCCGGCAACCAGT,0,446087
acrZp,0.5,1,1,GGCGCAAAGTATTCTGTATG,0,418676
acrZp,0.5,1,1,GGCGATCAGAACGGATGTGT,0,462139
acrZp,0.5,1,1,GGCGAGAGGCCCTTTAAGAG,0,416221
acrZp,0.5,1,1,GGCCGGTTCTCTATCCCATG,0,450302
acrZp,0.5,1,1,GGCCGGAAACCCTAGCGGTA,0,414039
acrZp,0.5,1,1,GGCCGCATTACCCGCTCAGG,0,455273
acrZp,0.5,1,1,GGCCGCAGTATGCGCTCCCC,0,442219
acrZp,0.5,1,1,GGCCCCCGGTGTATTACGTT,0,433119
acrZp,0.5,1,1,GGCCAGAATTGGTCCTGACT,0,408758
acrZp,0.5,1,1,GGCCACTGCTTAAACATCGG,0,428422
acrZp,0.5,1,1,GGCCACGAGGAGCACTCTCT,0,408570
acrZp,0.5,1,1,GGCATGGAGAGTCGTGGATA,0,451197
acrZp,0.5,1,1,GGCAGCCTCGATCAATTCTT,0,438290
acrZp,0.5,1,1,GGCACTTAACGAATAGTCCA,0,447934
acrZp,0.5,1,1,GGCACGTTTTTTAAGCGGTG,0,443364
acrZp,0.5,1,1,GGCACAAATCCTGCGGCTCG,0,418644
acrZp,0.5,1,1,GGCAATAGGGCGTCTAGGGG,0,446172
acrZp,0.5,1,1,GGCAAAGGACAGTCTTGCTA,0,459646
acrZp,0.5,1,1,GGATTTTATCATAAGTAGGG,0,429156
acrZp,0.5,1,1,GGATTTGTAATTCAGGTGTA,0,466246
acrZp,0.5,1,1,GGATTTAAGTCCGATAGTTA,0,414293
acrZp,0.5,1,1,GGATTGGATCGCGGGTTTGA,0,466808
acrZp,0.5,1,1,GGATTAGGGCGTGCAGGGGG,0,433986
acrZp,0.5,1,1,GGATGTCCCTCTATGTAATT,0,436780
acrZp,0.5,1,1,GGATGGAAACTAATTACGTT,0,462981
acrZp,0.5,1,1,GGATGCACGAGGGAAAATCA,0,415749
acrZp,0.5,1,1,GGATGAAGTATCTGTCGGTG,0,429316
acrZp,0.5,1,1,GGATCTCCCAAAGTCAGAAA,0,455149
acrZp,0.5,1,1,GGATCGTCAGGATTGACACA,0,441495
acrZp,0.5,1,1,GGATCGTACCAGCCCCCGCT,0,439842
acrZp,0.5,1,1,GGATAATTCGGTAGTTCGGC,0,410952
acrZp,0.5,1,1,GGAGTTCCCCTCGGGCGCGA,0,411829
acrZp,0.5,1,1,GGAGTGCTGACGATATCTGT,0,423472
acrZp,0.5,1,1,GGAGTGCGGCGACATCCGAC,0,412632
acrZp,0.5,1,1,GGAGGCGTCGTCAATTACGT,0,454227
acrZp,0.5,1,1,GGAGAGGGTTGGCCCAAAGT,0,420167
acrZp,0.5,1,1,GGAGAATCTTTAAGGAATCC,0,459804
acrZp,0.5,1,1,GGACTGCGCATATTTTCTAT,0,419549
acrZp,0.5,1,1,GGACTGCGCACGCCTGAGCT,0,460954
acrZp,0.5,1,1,GGACTCCTAGATCGATTCGT,0,458083
acrZp,0.5,1,1,GGACGTGTGAATCTACGGGG,0,419203
acrZp,0.5,1,1,GGACGTCCATGTCGCATTCC,0,412458
acrZp,0.5,1,1,GGACGTATCTAATGTCGTAC,0,417664
acrZp,0.5,1,1,GGACGATTGTCCAAGCAGGT,0,413701
acrZp,0.5,1,1,GGACCTGGGGGCCACGTCCG,0,464354
acrZp,0.5,1,1,GGACCTAGAAAAGAATACAA,0,427525
acrZp,0.5,1,1,GGACCACACTGTATCAGATG,0,433334
acrZp,0.5,1,1,GGACAGTTCATTTTAGAAAT,0,422770
acrZp,0.5,1,1,GGACAAGGCCTACCTACACG,0,440961
acrZp,0.5,1,1,GGAATGAGTCATTGCAAGAA,0,410783
acrZp,0.5,1,1,GGAAGCCTAGTTCTCGCGCA,0,443755
acrZp,0.5,1,1,GGAAGCCAGCCGTGTTGGCA,0,445801
acrZp,0.5,1,1,GGAAGAGTATTTGCTCTTTG,0,417014
acrZp,0.5,1,1,GGAACCTGACCCAGCTCTTC,0,433595
acrZp,0.5,1,1,GGAACATTATTACATCTGAA,0,433402
acrZp,0.5,1,1,GGAAATGAGCGATTAGGCGC,0,449365
acrZp,0.5,1,1,GCTTTTCATCGACTATGCCC,0,432078
acrZp,0.5,1,1,GCTTTGCATACATGTAGTTT,0,414156
acrZp,0.5,1,1,GCTTTGAGAGTTTTGTCACG,0,456530
acrZp,0.5,1,1,GCTTTCTTAGTACGGTGCCT,0,410122
acrZp,0.5,1,1,GCTTTAACGGCGAGTTACAC,0,422081
acrZp,0.5,1,1,GCTTCATCCTCGCGCTCCTT,0,426410
acrZp,0.5,1,1,GCTTATGGTGGCAACGGTAC,0,437225
acrZp,0.5,1,1,GCTTATCTAATTCCTTTTGC,0,455425
acrZp,0.5,1,1,GCTGGTGTGTGTATGATAGG,0,448937
acrZp,0.5,1,1,GCTGCTGTTTAGACCTTCAG,0,418087
acrZp,0.5,1,1,GCTGCGAGAGATGGACGCAT,0,446657
acrZp,0.5,1,1,GCTGCCAGGTCTGCAGTGAT,0,449580
acrZp,0.5,1,1,GCTGCAACTCGATGGTTTCT,0,449801
acrZp,0.5,1,1,GCTGAATTAATGGTGAGCTG,0,433567
acrZp,0.5,1,1,GCTCTCGAGATGCCTCCGTC,0,460905
acrZp,0.5,1,1,GCTCGGGATAAGTACATATT,0,429091
acrZp,0.5,1,1,GCTCGCGCTTGGCCCCAATC,0,411930
acrZp,0.5,1,1,GCTCCGCGTAGTATCAGTGC,0,423619
acrZp,0.5,1,1,GCTATATGATTCGCGCCCTG,0,423043
acrZp,0.5,1,1,GCTACTTTGCGTAGGGCAAA,0,428956
acrZp,0.5,1,1,GCTACGTCGCTCTGTTAGTA,0,424082
acrZp,0.5,1,1,GCTACAGGGTACCGCCATCT,0,445193
acrZp,0.5,1,1,GCTACAAAGCCCCAAGATAC,0,418595
acrZp,0.5,1,1,GCTAATGAGTTTGAGGGCTG,0,410470
acrZp,0.5,1,1,GCTAACGTGGGCAGCGCTAC,0,431517
acrZp,0.5,1,1,GCGTTGTAAGACCACTCGCC,0,423361
acrZp,0.5,1,1,GCGTTCGCGCAAGCGTAGGT,0,422180
acrZp,0.5,1,1,GCGTTCGACGCGAGCCGGAC,0,423784
acrZp,0.5,1,1,GCGTGTACGGAGTCCGGACT,0,453489
acrZp,0.5,1,1,GCGTCTTGAGTGAGTTGCGG,0,428846
acrZp,0.5,1,1,GCGTCGGGAGCCACCTGAAT,0,440533
acrZp,0.5,1,1,GCGTAGTGTGGGTCTCACTT,0,464988
acrZp,0.5,1,1,GCGGTGGTCACCGATGCAGC,0,435828
acrZp,0.5,1,1,GCGGCTCTACGCTCCTCCAC,0,453624
acrZp,0.5,1,1,GCGGCTCGCGACTCGAGAAT,0,416227
acrZp,0.5,1,1,GCGGCCGCATTCGCTACGCA,0,423790
acrZp,0.5,1,1,GCGGACAGGGATATGTGTAT,0,454565
acrZp,0.5,1,1,GCGGACACAGTCCAATTTGG,0,412074
acrZp,0.5,1,1,GCGGAATCACGCCAGTCGCA,0,429364
acrZp,0.5,1,1,GCGCTGATCGAATAGGCGCG,0,425272
acrZp,0.5,1,1,GCGCTCAAGAGACCATGTCG,0,418916
acrZp,0.5,1,1,GCGCGTGCACTCAATTTTGA,0,444495
acrZp,0.5,1,1,GCGCCACTCAGGAACGATCG,0,426944
acrZp,0.5,1,1,GCGCAGGTTCCAAAGGAAGA,0,461274
acrZp,0.5,1,1,GCGAGCCCGGAATCGCTGTA,0,444736
acrZp,0.5,1,1,GCGACATGGAGAGATCAATC,0,434882
acrZp,0.5,1,1,GCGAATGAACAAAGAGGAGT,0,455843
acrZp,0.5,1,1,GCGAATCACCTTAGCACGGG,0,423859
acrZp,0.5,1,1,GCGAAGTTTTTTGTTCCAGT,0,446210
acrZp,0.5,1,1,GCGAACTATTATAGATATCA,0,436059
acrZp,0.5,1,1,GCCTTGGTCACACAGGTTAG,0,427762
acrZp,0.5,1,1,GCCTTATATCCATGGGCTGC,0,461790
acrZp,0.5,1,1,GCCTGTCTACTAAGAGGTCC,0,457222
acrZp,0.5,1,1,GCCTGCTTCGACGTCATCTT,0,417617
acrZp,0.5,1,1,GCCTCGTACACAACAAGAAT,0,421392
acrZp,0.5,1,1,GCCTCACGCTCCATTCTTTG,0,424855
acrZp,0.5,1,1,GCCTAAATATATACACTCGA,0,433024
acrZp,0.5,1,1,GCCGGGCACTGGCTAAGACG,0,465993
acrZp,0.5,1,1,GCCGCTTTCCGTTCTTGAAC,0,445205
acrZp,0.5,1,1,GCCCGTTGAGAGCTGAGGTA,0,454088
acrZp,0.5,1,1,GCCCGTCCCGACTCAGATCC,0,425456
acrZp,0.5,1,1,GCCCCTCATGCGGCATAACT,0,448448
acrZp,0.5,1,1,GCCCCACGGATTTGGAAAGC,0,466245
acrZp,0.5,1,1,GCCATTTTAGCTGGCGTACA,0,463866
acrZp,0.5,1,1,GCCATATCTTGCGTTCAATT,0,428989
acrZp,0.5,1,1,GCCAGTTAAGCTGTATGGCT,0,418560
acrZp,0.5,1,1,GCCAGTGTTCTGTCGTAGTT,0,418301
acrZp,0.5,1,1,GCCACTTAATTTGGATTGAG,0,413997
acrZp,0.5,1,1,GCCACAGTAGAGGCCCCGAT,0,435382
acrZp,0.5,1,1,GCCACAGGGCGACGGCCCCC,0,430820
acrZp,0.5,1,1,GCCAAGGGTCGAATCAATCG,0,438933
acrZp,0.5,1,1,GCCAAATTAGAGGTTGTAGT,0,453171
acrZp,0.5,1,1,GCATCGTGAGCGTCCCCATG,0,446477
acrZp,0.5,1,1,GCATCCCTACTGTAGTTTAT,0,464302
acrZp,0.5,1,1,GCATATGCAGTGAATCGGCA,0,433087
acrZp,0.5,1,1,GCATACCAAGTTTATACATT,0,444913
acrZp,0.5,1,1,GCATACCAAAGTCCCGGGCT,0,409753
acrZp,0.5,1,1,GCAGTTCCCACAGGCTCGTA,0,466347
acrZp,0.5,1,1,GCAGTTAGCATGCACATTCC,0,411123
acrZp,0.5,1,1,GCAGTGAATCATACGTTTCC,0,463713
acrZp,0.5,1,1,GCAGGTCTTAACGCATACGT,0,429041
acrZp,0.5,1,1,GCAGGAAGGGGGCCCGTGTA,0,437481
acrZp,0.5,1,1,GCAGCGGATAATTATATAAA,0,430823
acrZp,0.5,1,1,GCAGATTGCAGGCGTGCTGT,0,420506
acrZp,0.5,1,1,GCAGAACATACTGCGTTATG,0,457703
acrZp,0.5,1,1,GCACTAGGAGTCATCTATGA,0,446013
acrZp,0.5,1,1,GCACTACCCGTAAGCGTCCC,0,457104
acrZp,0.5,1,1,GCACGTTTTGTCTTATTTGC,0,444195
acrZp,0.5,1,1,GCACGTGTTCGTACCGCCTC,0,464875
acrZp,0.5,1,1,GCACGCCTCATTCCGGGTCG,0,418806
acrZp,0.5,1,1,GCACCTGGCTCGCGGAGGAT,0,454592
acrZp,0.5,1,1,GCACCCTCTGATCGAGGCCA,0,445886
acrZp,0.5,1,1,GCACATCGGCTTTCTATAGT,0,420233
acrZp,0.5,1,1,GCACAGGGTGCTGGTTAGCC,0,446533
acrZp,0.5,1,1,GCACAATAATGGCTAACAAA,0,461230
acrZp,0.5,1,1,GCACAAACTTTTAAGGAGAG,0,419832
acrZp,0.5,1,1,GCAATGTTAGAATGAGCCCA,0,444343
acrZp,0.5,1,1,GCAAGCTTGCGGTTTACCCC,0,440369
acrZp,0.5,1,1,GCAACTTGCGACCCTCCCTG,0,426635
acrZp,0.5,1,1,GCAACTGTTCCGAATCGATA,0,444606
acrZp,0.5,1,1,GCAACGTCCCACAGGCTCAG,0,443019
acrZp,0.5,1,1,GCAAACCACTTGGTACCACT,0,433156
acrZp,0.5,1,1,GCAAAAGCTCACGTAAATGC,0,448353
acrZp,0.5,1,1,GATTTCCCTTAGTAAGGGTG,0,416884
acrZp,0.5,1,1,GATTTATTCCCGTCATAGCT,0,455279
acrZp,0.5,1,1,GATTGTCAAGAAAATAACAC,0,455362
acrZp,0.5,1,1,GATTGCTTTTGTGTCCTGTC,0,429281
acrZp,0.5,1,1,GATTCCCGCGAACAGTTTAT,0,411148
acrZp,0.5,1,1,GATTATTCACGACAGTTTCC,0,457209
acrZp,0.5,1,1,GATTATGGAAGTCAAGGTTC,0,414484
acrZp,0.5,1,1,GATGTCAGCGCGCAATCGTT,0,412686
acrZp,0.5,1,1,GATGGATATCCAGCGCCGGG,0,448391
acrZp,0.5,1,1,GATGACCCGGGCCTTGTTTT,0,434287
acrZp,0.5,1,1,GATGAAGGATAATTCTGTGA,0,424185
acrZp,0.5,1,1,GATCTGCCATCCCAATGCTC,0,434330
acrZp,0.5,1,1,GATCTAGATGTGACTAACTA,0,440201
acrZp,0.5,1,1,GATCGCTAGGGGCTTATACA,0,422028
acrZp,0.5,1,1,GATCCGTGGGTGACCCGGAG,0,459901
acrZp,0.5,1,1,GATCCAGTGTGTCGCGCCCC,0,412536
acrZp,0.5,1,1,GATCAGGTGGTTGCTAATTC,0,430270
acrZp,0.5,1,1,GATCAAAATCAGGGGTAAAA,0,460849
acrZp,0.5,1,1,GATAGGTTAGGGATCTAATC,0,457913
acrZp,0.5,1,1,GATACGATATCGCTTCAGGC,0,435280
acrZp,0.5,1,1,GATACACGCGCCTCGGTAAA,0,420513
acrZp,0.5,1,1,GAGTTTCGCTTCCTTGTGTA,0,432360
acrZp,0.5,1,1,GAGTGGGATGAGAGATTGAG,0,438516
acrZp,0.5,1,1,GAGTACATGGAGACCCACGT,0,467336
acrZp,0.5,1,1,GAGGGTTAGGCCCTTGTCCT,0,428379
acrZp,0.5,1,1,GAGGGCATGGGGGGTTCCTT,0,447673
acrZp,0.5,1,1,GAGGCGAAGCTTGACTTAAC,0,441092
acrZp,0.5,1,1,GAGGCCAGCCCTATGGCCCG,0,409780
acrZp,0.5,1,1,GAGGCAGTTGCGCTGGTGAT,0,425024
acrZp,0.5,1,1,GAGGCAGGGCTTCGACCCCA,0,420240
acrZp,0.5,1,1,GAGGCAACCTTTGAGTAAGC,0,424983
acrZp,0.5,1,1,GAGGAAGTTTGACAATAGTC,0,413012
acrZp,0.5,1,1,GAGCGGCGAGGGCTTATTTT,0,408832
acrZp,0.5,1,1,GAGCCCAGTTTAGTCTTAAA,0,452332
acrZp,0.5,1,1,GAGCCATCGTACTCTGTGTA,0,463903
acrZp,0.5,1,1,GAGCCAATAAAGCTACGACC,0,434618
acrZp,0.5,1,1,GAGATGCGGTTAAACTGACA,0,445241
acrZp,0.5,1,1,GAGAGAGCGGTCACGTAGAC,0,436627
acrZp,0.5,1,1,GAGAGAACTCTTCTAGGGAA,0,418930
acrZp,0.5,1,1,GAGACGGTTCGGCAAACGAT,0,440195
acrZp,0.5,1,1,GAGAAACATCGAGCTAGAAG,0,437492
acrZp,0.5,1,1,GACTTGCTCGTGCTCGGTAT,0,414981
acrZp,0.5,1,1,GACTTCATCTCTGCGCCGCC,0,420839
acrZp,0.5,1,1,GACTGTGGAACTAAATGAAT,0,466768
acrZp,0.5,1,1,GACTGGAAGGGTCAAGGAAT,0,432488
acrZp,0.5,1,1,GACTGAAATGTACGATGTGT,0,431631
acrZp,0.5,1,1,GACTAACTGTATCTACTACA,0,430798
acrZp,0.5,1,1,GACGTGTGGTGAGGTTGCGG,0,457045
acrZp,0.5,1,1,GACGTGGAGGACTTGACGTC,0,466975
acrZp,0.5,1,1,GACGTCTGAGGCACGAGCCG,0,420145
acrZp,0.5,1,1,GACGCCGGCGGAGTGCCCTC,0,417806
acrZp,0.5,1,1,GACCTCCGGGGCAGTGCACT,0,465111
acrZp,0.5,1,1,GACCGAAGTCTGCTCTTAAT,0,424423
acrZp,0.5,1,1,GACCCTCGAGGTAGATTTCT,0,412791
acrZp,0.5,1,1,GACCCATTGTATTACAACAA,0,424578
acrZp,0.5,1,1,GACCATGTGAGCTACTCCTT,0,462808
acrZp,0.5,1,1,GACCACTGTGATGTTGGAGA,0,453922
acrZp,0.5,1,1,GACCACATGCCCGGCCAATA,0,442304
acrZp,0.5,1,1,GACAGCTGGACCGGTCTAGG,0,440255
acrZp,0.5,1,1,GACAGCGCAATTGGAATGCG,0,463996
acrZp,0.5,1,1,GACACCGGGTGCTTTGTGGA,0,435871
acrZp,0.5,1,1,GAATTGGGCACGATTCGTCC,0,438028
acrZp,0.5,1,1,GAATTCGTGGACCTGCACGA,0,447963
acrZp,0.5,1,1,GAATGGACTACCCAAAGGTC,0,424469
acrZp,0.5,1,1,GAATGAAAGATATCCGTGAT,0,449430
acrZp,0.5,1,1,GAATCTGGAAAGCCTTGTGC,0,413801
acrZp,0.5,1,1,GAATCCCTGCAAAAACGGGT,0,430552
acrZp,0.5,1,1,GAATCCATGCTGGTGGCTCG,0,436529
acrZp,0.5,1,1,GAATCCAACGTTAGTAAGGA,0,459456
acrZp,0.5,1,1,GAATAGGGAGTCTCATAGTT,0,443235
acrZp,0.5,1,1,GAATAGACACGGTTGTCGTT,0,451604
acrZp,0.5,1,1,GAATAAGGAGTCTATAAATT,0,467328
acrZp,0.5,1,1,GAAGTGTTCTCGCACGTACG,0,408857
acrZp,0.5,1,1,GAAGCAGGTATCAAATAGCC,0,413069
acrZp,0.5,1,1,GAAGCAATGAGGTAGTTCCG,0,442506
acrZp,0.5,1,1,GAAGAGCGCAACTCTAAAAA,0,437389
acrZp,0.5,1,1,GAACTTAGTCTCGCACGAGT,0,439704
acrZp,0.5,1,1,GAACTCGGCATTCAACGGTT,0,431070
acrZp,0.5,1,1,GAACCGTCATTCAAGTGTCT,0,435683
acrZp,0.5,1,1,GAACAGGTCTAATAAAGGGG,0,422587
acrZp,0.5,1,1,GAAATTCGTATAAGAAAATG,0,415070
acrZp,0.5,1,1,GAAATGCATGCAACGCGACA,0,433092
acrZp,0.5,1,1,GAAATATTGGTCAGCGGTTC,0,427012
acrZp,0.5,1,1,GAAAGCTTCATGACTAGAAG,0,460712
acrZp,0.5,1,1,GAAAAACACCTAGACCTTTA,0,425500
acrZp,0.5,1,1,CTTTTGGCAAACGGTTTGTA,0,441016
acrZp,0.5,1,1,CTTTCTTAACAAGAATAGAA,0,418341
acrZp,0.5,1,1,CTTTAACGGCGCGGCCGGAT,0,412133
acrZp,0.5,1,1,CTTGGTGGGGCCACAAACAA,0,424359
acrZp,0.5,1,1,CTTGGTGACTGGACCTTAGG,0,458840
acrZp,0.5,1,1,CTTGGGGTAGAGATCAAGAA,0,422035
acrZp,0.5,1,1,CTTGGCGGGCTCAAATCCGT,0,424022
acrZp,0.5,1,1,CTTGGCCTCCGGGCGAGGTA,0,463006
acrZp,0.5,1,1,CTTGCCAGGCACTCCGCACG,0,442446
acrZp,0.5,1,1,CTTCTTTCCAGCAGCTATGG,0,459354
acrZp,0.5,1,1,CTTCTTCCCTCGGGCGCTAA,0,419111
acrZp,0.5,1,1,CTTCTTCCAGGTAAATCAAA,0,449692
acrZp,0.5,1,1,CTTCGTACCACGATAGTCCT,0,459693
acrZp,0.5,1,1,CTTCGGTGGATATAGCGCCA,0,436147
acrZp,0.5,1,1,CTTCGGACCGCGCTGGTTCG,0,448007
acrZp,0.5,1,1,CTTCCCGCGGTGTAGATTAA,0,445228
acrZp,0.5,1,1,CTTCCAGTGTTGTTATAGAT,0,425196
acrZp,0.5,1,1,CTTCATCCAGGCCCTGGCAA,0,427848
acrZp,0.5,1,1,CTTCACTTACCGTCGCAACT,0,409148
acrZp,0.5,1,1,CTTCAATTCTTTACCCCACC,0,435623
acrZp,0.5,1,1,CTTACGAGGATAAACAGAAG,0,414580
acrZp,0.5,1,1,CTTACGAATAGCTGGGCATA,0,440021
acrZp,0.5,1,1,CTTAATTTGTCACCGGATCC,0,410724
acrZp,0.5,1,1,CTTAATAGGCTAAACGCTCC,0,433604
acrZp,0.5,1,1,CTTAAGGTACGTGGCTGCGC,0,415877
acrZp,0.5,1,1,CTGTTTACCGCTGTCCTCGT,0,435751
acrZp,0.5,1,1,CTGTTGTCGCCACTTCTCAC,0,424831
acrZp,0.5,1,1,CTGTTCTAGGAGAGGTGTGT,0,409171
acrZp,0.5,1,1,CTGTGCAGACCGTTAGCGGG,0,426509
acrZp,0.5,1,1,CTGTGCAACGACCGCCTTTC,0,430609
acrZp,0.5,1,1,CTGTGATGAACTGACCTATT,0,432862
acrZp,0.5,1,1,CTGTGAACAACGAACTGTGG,0,420680
acrZp,0.5,1,1,CTGTCGAAACTTCCGAACGA,0,410565
acrZp,0.5,1,1,CTGTCCCACGCTCGTGATTA,0,456609
acrZp,0.5,1,1,CTGGTCTAATATCTACAAAA,0,414873
acrZp,0.5,1,1,CTGGGGTCTTAGTGGTTATG,0,421899
acrZp,0.5,1,1,CTGGGGTAATCTAGGCGTCA,0,415838
acrZp,0.5,1,1,CTGGGCCATACCTCAGATCG,0,428285
acrZp,0.5,1,1,CTGGCGGCAACTAATCGGCC,0,457774
acrZp,0.5,1,1,CTGGCAGAATAACTGGCGCC,0,460967
acrZp,0.5,1,1,CTGGATTCATCTGGTTGCGG,0,439984
acrZp,0.5,1,1,CTGGAATTGTCGCATAAAGG,0,444632
acrZp,0.5,1,1,CTGGAAGATACGACTAGGAC,0,464270
acrZp,0.5,1,1,CTGGAACCTGAGAGCGAGCC,0,430276
acrZp,0.5,1,1,CTGCTCGACCCGGTTGACTT,0,441579
acrZp,0.5,1,1,CTGCTCCCCTTGGGAGACTC,0,435345
acrZp,0.5,1,1,CTGCGGGTCTACACTAAATA,0,433633
acrZp,0.5,1,1,CTGCGGATGGGTCTCGCCAG,0,416387
acrZp,0.5,1,1,CTGCCGCACTGTTGCATGGT,0,456931
acrZp,0.5,1,1,CTGCCCTGTAATCCTCGCGG,0,411119
acrZp,0.5,1,1,CTGCCCGCTTTCTAAGCTCT,0,463048
acrZp,0.5,1,1,CTGCATCCAATTCTCCAGTT,0,461998
acrZp,0.5,1,1,CTGATTTATAGCGACACGGT,0,433708
acrZp,0.5,1,1,CTGAGTAACCACGAGGTCTT,0,429355
acrZp,0.5,1,1,CTGACTTCGACCAAATGACG,0,409482
acrZp,0.5,1,1,CTGACCCGCGCACGGATATA,0,424184
acrZp,0.5,1,1,CTGACAGTGGGGTCCTAATG,0,420703
acrZp,0.5,1,1,CTGAAGTTAGCTGTTCGGAA,0,429386
acrZp,0.5,1,1,CTCTTTTAGAAATTGGTTCC,0,415813
acrZp,0.5,1,1,CTCTTTGAACGTCTTAAGAA,0,430518
acrZp,0.5,1,1,CTCTTGGGGTGCGCTACTGA,0,457500
acrZp,0.5,1,1,CTCTGGAACTGGATTCTGAC,0,445050
acrZp,0.5,1,1,CTCTGCGTTGGTGAACACAT,0,450498
acrZp,0.5,1,1,CTCTCGCTTTCACCCTCGTC,0,434510
acrZp,0.5,1,1,CTCTAGGGCCTCACCTGCAG,0,411299
acrZp,0.5,1,1,CTCGTGTGCCTGTGGACTAC,0,409669
acrZp,0.5,1,1,CTCGTATAGTTCAGTTATGC,0,418661
acrZp,0.5,1,1,CTCGGTACCGTCGAGATTCA,0,439979
acrZp,0.5,1,1,CTCGGGCCTGAGGTGTGGCC,0,427988
acrZp,0.5,1,1,CTCGCCTAGGCGGGCAGATC,0,433970
acrZp,0.5,1,1,CTCGAAGTCGGCGAACCTCG,0,412792
acrZp,0.5,1,1,CTCGAAATGGAAATTAATGT,0,438680
acrZp,0.5,1,1,CTCCTGCCGTCAAAGGATAA,0,459834
acrZp,0.5,1,1,CTCCCGCAAACTGTTTGTAC,0,422516
acrZp,0.5,1,1,CTCCCGAATTAGCCACCGGG,0,444665
acrZp,0.5,1,1,CTCCCAACGGTGACACAAAG,0,423817
acrZp,0.5,1,1,CTCATCTCTGATCGCGAGCA,0,424788
acrZp,0.5,1,1,CTCATCATTCGCGGACACAA,0,410650
acrZp,0.5,1,1,CTCAGTTCTAGCTTGTACTG,0,415322
acrZp,0.5,1,1,CTCAGTGGGCGACGAAGACT,0,413101
acrZp,0.5,1,1,CTCAGGAGATGCGTCCCGGG,0,437121
acrZp,0.5,1,1,CTCACCACGAAACATCAAGA,0,414024
acrZp,0.5,1,1,CTATTTTCATCGAGCTTTGG,0,411886
acrZp,0.5,1,1,CTATTCGTGGTTTATCGAGA,0,440085
acrZp,0.5,1,1,CTATGGGGTGAAACATGGAA,0,412934
acrZp,0.5,1,1,CTATGGCCCGCGTTAAGTTT,0,444747
acrZp,0.5,1,1,CTATAAACTGCCTCATTACG,0,410163
acrZp,0.5,1,1,CTAGTCTTTATTGTGCCAGT,0,449233
acrZp,0.5,1,1,CTAGGTTCGGAATAAGAATT,0,452889
acrZp,0.5,1,1,CTAGCGCAGGGTCATGCACT,0,435347
acrZp,0.5,1,1,CTAGATGCAGCATCCACGGT,0,448847
acrZp,0.5,1,1,CTAGAGGCAATGTGGACCAC,0,424328
acrZp,0.5,1,1,CTAGAATGATTCTCTCCTGG,0,448814
acrZp,0.5,1,1,CTACTTCGTTTCCAGAGGTA,0,421361
acrZp,0.5,1,1,CTACTGGGGACTTGGGGCCA,0,427596
acrZp,0.5,1,1,CTACGTTTCGCAATCCTTGT,0,438221
acrZp,0.5,1,1,CTACGGCAGGTCCAAAAACA,0,437504
acrZp,0.5,1,1,CTACGCTTTTGGCCCCCTCC,0,438019
acrZp,0.5,1,1,CTACGATAGGAACCATGACA,0,424379
acrZp,0.5,1,1,CTACCTCAGCTGTGTTCACT,0,447776
acrZp,0.5,1,1,CTACCGAGAGTTGCCTATGT,0,454207
acrZp,0.5,1,1,CTACAGTCTGTCCACATCGT,0,411306
acrZp,0.5,1,1,CTAATTTGAAAGACGGCAAT,0,447740
acrZp,0.5,1,1,CTAATTCAGGTGATGAGTTG,0,460904
acrZp,0.5,1,1,CTAATCGGGATCTTGTAAGC,0,461183
acrZp,0.5,1,1,CTAACTGCTCAGCGCGCGGG,0,427033
acrZp,0.5,1,1,CTAACTGATCGAATCGTTTT,0,454744
acrZp,0.5,1,1,CGTTTTCTAATGTTATAATT,0,437904
acrZp,0.5,1,1,CGTTTGGTTTGAGAGTCGGC,0,427876
acrZp,0.5,1,1,CGTTTGCGCACCTTATGTAA,0,463598
acrZp,0.5,1,1,CGTTTCTCGGTGCCCCCCCA,0,466409
acrZp,0.5,1,1,CGTTTCGCCTTCACGCCGCT,0,441408
acrZp,0.5,1,1,CGTTTATGTGACCTTTGCAC,0,442331
acrZp,0.5,1,1,CGTTCGGTAGGGTGGATTGT,0,442936
acrZp,0.5,1,1,CGTTAGGTACCTGGGTTTTC,0,434956
acrZp,0.5,1,1,CGTGTGAAAGGGGTTAAAAG,0,451289
acrZp,0.5,1,1,CGTGTCGGAAAATGGATTTC,0,422800
acrZp,0.5,1,1,CGTGTATGGTTGAGGCAATG,0,422900
acrZp,0.5,1,1,CGTGTAACTGGTAGACGGTC,0,446742
acrZp,0.5,1,1,CGTGGTCCATAGTGCGGAAG,0,432583
acrZp,0.5,1,1,CGTGGTACCTGGCATCACAT,0,412900
acrZp,0.5,1,1,CGTGGCCGATAACGGGCATT,0,418455
acrZp,0.5,1,1,CGTGGACGCCAAAATGATAG,0,447965
acrZp,0.5,1,1,CGTGGACAATGAGCCGATAT,0,451974
acrZp,0.5,1,1,CGTGCTGTGGGCGTGCAGAG,0,465212
acrZp,0.5,1,1,CGTGCCGTAACGCCGCAAAG,0,427298
acrZp,0.5,1,1,CGTGAGTAGCCGTACCTATA,0,409407
acrZp,0.5,1,1,CGTGAAGGGATCATTTGCAA,0,428427
acrZp,0.5,1,1,CGTCTGGCGGGAGTAATCAG,0,455646
acrZp,0.5,1,1,CGTCTCCACATAGCCACTAA,0,425138
acrZp,0.5,1,1,CGTCCTGCAAGATGCTTAAA,0,418696
acrZp,0.5,1,1,CGTCCCTCTGGAGCCGTTTT,0,442062
acrZp,0.5,1,1,CGTCCATGACTCTAGAGGAT,0,450101
acrZp,0.5,1,1,CGTCATTTGGTCGGCAGGGC,0,428391
acrZp,0.5,1,1,CGTCATTCCGGATGCTGGCC,0,429192
acrZp,0.5,1,1,CGTCACCGTAGATGCGGTAG,0,463420
acrZp,0.5,1,1,CGTATAACCGGCGATGACAA,0,451306
acrZp,0.5,1,1,CGTAGTTAGCCGGTTACGGA,0,429425
acrZp,0.5,1,1,CGTAGGGACTACGGGAACCT,0,440853
acrZp,0.5,1,1,CGTAGATCCGGTCTGTCGAT,0,414523
acrZp,0.5,1,1,CGTAGAGATGGTGTGGACTC,0,451865
acrZp,0.5,1,1,CGTAGAGACAGTCACGTCAG,0,441364
acrZp,0.5,1,1,CGTACATCCCATCCGAAGCT,0,415102
acrZp,0.5,1,1,CGTAATTGTGGGAACTGCGA,0,441106
acrZp,0.5,1,1,CGTAACTGCCAGCCTTAAGC,0,466155
acrZp,0.5,1,1,CGGTTCTCCTCACTTGTGCT,0,449487
acrZp,0.5,1,1,CGGTTCGAAAACAAATTTAA,0,454369
acrZp,0.5,1,1,CGGTTCAGTCCTCCGTTAGG,0,434512
acrZp,0.5,1,1,CGGTGTTGTGGGAGGAATGA,0,456327
acrZp,0.5,1,1,CGGTGGGTGTGTCGCTCTGC,0,458618
acrZp,0.5,1,1,CGGTGCTAGTTATCATGCTA,0,463847
acrZp,0.5,1,1,CGGTCTAAGAGAGAATCCGG,0,427124
acrZp,0.5,1,1,CGGTCCTGAACGTCAAAGCA,0,458403
acrZp,0.5,1,1,CGGTCATGCGCTCCCGTTGT,0,459214
acrZp,0.5,1,1,CGGTCAGACTACGCACCCCA,0,452738
acrZp,0.5,1,1,CGGTCACTGGTTGGCATGGT,0,461344
acrZp,0.5,1,1,CGGTATACGGAGTCGGCAAA,0,421869
acrZp,0.5,1,1,CGGTAGAGTACGCAGTCCGG,0,416146
acrZp,0.5,1,1,CGGTAGAAGATTTTGAAAAA,0,438812
acrZp,0.5,1,1,CGGGTTAACACTACGCACGC,0,454867
acrZp,0.5,1,1,CGGGGTGCATGCATGCAGCT,0,460399
acrZp,0.5,1,1,CGGGGCCGATCGCTGGAGCG,0,445290
acrZp,0.5,1,1,CGGGCATAACGGTGACCGCG,0,458883
acrZp,0.5,1,1,CGGGAGAGTCAAACGGCAAG,0,442233
acrZp,0.5,1,1,CGGGACAGTCGGCATTGGGT,0,411776
acrZp,0.5,1,1,CGGCTTCCGTCACAGAGATT,0,454343
acrZp,0.5,1,1,CGGCTCAGCCGCAGCACCGA,0,422213
acrZp,0.5,1,1,CGGCTAATAAGTATTACTCA,0,421054
acrZp,0.5,1,1,CGGCGGGATACCACGACATA,0,441720
acrZp,0.5,1,1,CGGCCGCTTATAGCTCACAC,0,449243
acrZp,0.5,1,1,CGGCCAGCGTACATCCGGCT,0,455239
acrZp,0.5,1,1,CGGCAACTACCTAGTGGAGT,0,461686
acrZp,0.5,1,1,CGGATTTTTTGACAGAAGTC,0,430305
acrZp,0.5,1,1,CGGATTATGTGTCCAGTTTT,0,410469
acrZp,0.5,1,1,CGGATCCGTTATTCATCGGC,0,432515
acrZp,0.5,1,1,CGGATCACCGGTTCACTTAC,0,418767
acrZp,0.5,1,1,CGGATAGCTGCACGACGCCC,0,452441
acrZp,0.5,1,1,CGGAGTGTCACATGGCCGGT,0,455977
acrZp,0.5,1,1,CGGAGCGTATCGACGTTAAA,0,449018
acrZp,0.5,1,1,CGGAGCATCAAGGAACATCT,0,425784
acrZp,0.5,1,1,CGGACTCTTAGTGAGACCAC,0,447522
acrZp,0.5,1,1,CGGACACCTGCCGATCGCCT,0,422418
acrZp,0.5,1,1,CGGAATACTTTAGGTGGTTA,0,442188
acrZp,0.5,1,1,CGCTTTATGCAGTACTAAGG,0,445384
acrZp,0.5,1,1,CGCTTAGTTTCACGAGCTAT,0,431080
acrZp,0.5,1,1,CGCTGCGCCATAGCGGGATG,0,438389
acrZp,0.5,1,1,CGCTGATCCCCGCATGGGAA,0,428432
acrZp,0.5,1,1,CGCTGAGGTGCGATTTTTCC,0,410954
acrZp,0.5,1,1,CGCTCCCTCACACATACCTT,0,466154
acrZp,0.5,1,1,CGCGTACTGGCTCGGCCTAG,0,426741
acrZp,0.5,1,1,CGCGGTATACGATGCGTTCG,0,433625
acrZp,0.5,1,1,CGCGGAGCCTCGCCCATTGC,0,445106
acrZp,0.5,1,1,CGCGCTAAATAGCACTTTTG,0,412642
acrZp,0.5,1,1,CGCGAAAAGGCGTGCGGTAG,0,459488
acrZp,0.5,1,1,CGCCTTGCAAAGGGAAAAAT,0,422747
acrZp,0.5,1,1,CGCCTTATGCGTACATTGTA,0,433828
acrZp,0.5,1,1,CGCCTGGCTTTCTAGTATCT,0,419278
acrZp,0.5,1,1,CGCCTCATCAACTTCTCATG,0,458146
acrZp,0.5,1,1,CGCCGCGATTCGAGGCGAGG,0,447938
acrZp,0.5,1,1,CGCCGCAAGCAGTCTGCCAC,0,443860
acrZp,0.5,1,1,CGCCGACAGGTTACGGCTCT,0,409629
acrZp,0.5,1,1,CGCCGAATGGATCAATGGAT,0,413059
acrZp,0.5,1,1,CGCCAGATGCCTGGCTTTTA,0,455720
acrZp,0.5,1,1,CGCCAGAGGTTCGACGTGCA,0,412433
acrZp,0.5,1,1,CGCAGGAGTTCATCAGGCTA,0,463097
acrZp,0.5,1,1,CGCAGAGGGAACATAATGGT,0,458627
acrZp,0.5,1,1,CGCACATTCTGCCGGAATAA,0,434602
acrZp,0.5,1,1,CGCAAGGGTATCCGCAAACT,0,416670
acrZp,0.5,1,1,CGATTGCTTGGTCACATTAG,0,414810
acrZp,0.5,1,1,CGATTACTTCCCTGCACGCG,0,426598
acrZp,0.5,1,1,CGATGGCGGTGGTCTCGATA,0,411034
acrZp,0.5,1,1,CGATCATGGAAATCCCTTCA,0,431910
acrZp,0.5,1,1,CGATAGGTGCTGTGGATAGG,0,467513
acrZp,0.5,1,1,CGATACTCTCTCGTATAGAT,0,417777
acrZp,0.5,1,1,CGATACCGGGGGGGGGTAAT,0,413609
acrZp,0.5,1,1,CGATAATGTGGCGCCGAAAA,0,458547
acrZp,0.5,1,1,CGATAAGTGCTTGGATTTCG,0,414332
acrZp,0.5,1,1,CGATAAGTAATTAAATCTTA,0,419850
acrZp,0.5,1,1,CGAGTTTTAAAAGGGACCTC,0,410967
acrZp,0.5,1,1,CGAGTGGTGTCATACCGTGT,0,441468
acrZp,0.5,1,1,CGAGGATGTAAGTGAACTCA,0,462497
acrZp,0.5,1,1,CGAGCGTCCTTCACACCTTG,0,417198
acrZp,0.5,1,1,CGAGCAAACGCCGTTCTGTC,0,455787
acrZp,0.5,1,1,CGAGATATACAAGCGCCTTG,0,457926
acrZp,0.5,1,1,CGACTCTGAACTATTTGGTC,0,449019
acrZp,0.5,1,1,CGACTCTAGTACCTTGGGGC,0,413072
acrZp,0.5,1,1,CGACGGTACTCCGGACCTTT,0,415274
acrZp,0.5,1,1,CGACGCCCGCTAAGTGTTGG,0,436439
acrZp,0.5,1,1,CGACATCAGATACAGGGCGT,0,429874
acrZp,0.5,1,1,CGAATCTGGTAGGGTACTTC,0,419170
acrZp,0.5,1,1,CGAAGTGCACGCTGTACGTT,0,435043
acrZp,0.5,1,1,CGAAGCTCTCACCGGGGCCA,0,434290
acrZp,0.5,1,1,CGAACATTCGCGGTAGAGCG,0,445036
acrZp,0.5,1,1,CGAAAGAGAGACGGATCCCC,0,426845
acrZp,0.5,1,1,CGAAAACTAACCCTCGAGTT,0,458778
acrZp,0.5,1,1,CCTTTGTGCGTCTTGTGTAC,0,411303
acrZp,0.5,1,1,CCTTTGCTCTCGTCGGAACA,0,442586
acrZp,0.5,1,1,CCTTTAAAATAGCAGGACAT,0,429004
acrZp,0.5,1,1,CCTTGCGGTGTTACTAGGCC,0,439803
acrZp,0.5,1,1,CCTTGCACCGAAGGTCAGAC,0,466762
acrZp,0.5,1,1,CCTTGAGATTCTGGCGTTTC,0,437612
acrZp,0.5,1,1,CCTTCAGTTCCGGTGTGCGT,0,414451
acrZp,0.5,1,1,CCTTAGTGTCAAAATCAATT,0,419825
acrZp,0.5,1,1,CCTTAGCACAAACCGTTGCT,0,458253
acrZp,0.5,1,1,CCTGTGTATCACCCGGGGCT,0,409686
acrZp,0.5,1,1,CCTGGCTTTAAGTGCCGATT,0,426932
acrZp,0.5,1,1,CCTGCTAGGCCACACAGCTA,0,436335
acrZp,0.5,1,1,CCTGCGTAAAACGCGAAGTG,0,441243
acrZp,0.5,1,1,CCTGAAACAGAACATCAATC,0,427187
acrZp,0.5,1,1,CCTCTTTCATTACGAAGGTA,0,456403
acrZp,0.5,1,1,CCTCTGGAGACTGGTCTTCG,0,440291
acrZp,0.5,1,1,CCTCTGAGTCAGGAGTCAGG,0,453073
acrZp,0.5,1,1,CCTCTCAGATTAAATATCTA,0,456131
acrZp,0.5,1,1,CCTCGTCCGCAATACGCGTC,0,423635
acrZp,0.5,1,1,CCTCGCTCTCTTCAAAAGGG,0,434975
acrZp,0.5,1,1,CCTCCGGCACCATGCGAAAT,0,424356
acrZp,0.5,1,1,CCTCACGAACCTAAGGAGCC,0,458300
acrZp,0.5,1,1,CCTAGCTTGTTACTGACAGT,0,455345
acrZp,0.5,1,1,CCTAGATAGACGGCCGGACA,0,464362
acrZp,0.5,1,1,CCTAGACATTATGCGTGGAT,0,439154
acrZp,0.5,1,1,CCTAGAATGACAGTACGGGG,0,438161
acrZp,0.5,1,1,CCTAAGGATAGAGACCGATT,0,464367
acrZp,0.5,1,1,CCTAACGCCACATTCCTCAT,0,452074
acrZp,0.5,1,1,CCTAAACTATCTAGACGTGC,0,443665
acrZp,0.5,1,1,CCGTTCAGTTTTCTTATCAT,0,429832
acrZp,0.5,1,1,CCGTGGGCACCGTCTGTTAA,0,459442
acrZp,0.5,1,1,CCGTGGGAATCCGTGCAGGG,0,460988
acrZp,0.5,1,1,CCGTCTCGGGGTGAATCATT,0,457377
acrZp,0.5,1,1,CCGTCATCACTGTCAAGCCT,0,426698
acrZp,0.5,1,1,CCGTCAGGCCAAGTAACCTT,0,450534
acrZp,0.5,1,1,CCGTCACTGTCGTGAATTAG,0,420409
acrZp,0.5,1,1,CCGTATCACTCTCTCAGCAT,0,443986
acrZp,0.5,1,1,CCGTAACCGGGGTCAGACGT,0,419856
acrZp,0.5,1,1,CCGGTGGTCTCTATGCCGAG,0,443309
acrZp,0.5,1,1,CCGGGTCACGTAGGAGTACG,0,409961
acrZp,0.5,1,1,CCGGACGTACAATCGACCGG,0,419472
acrZp,0.5,1,1,CCGCGGTTTGCTCCTTTCAG,0,419558
acrZp,0.5,1,1,CCGCCTTCTGTCTAGCGCGT,0,412685
acrZp,0.5,1,1,CCGCCCCCCAGAAAGTCGAT,0,434474
acrZp,0.5,1,1,CCGCAGCTTGGCAGCCAGAG,0,437784
acrZp,0.5,1,1,CCGCAAGTGAGCGACGCGTG,0,458683
acrZp,0.5,1,1,CCGATCGTCGCAACCATGTC,0,441009
acrZp,0.5,1,1,CCGAGGAGTTTGGGCAGGCA,0,419231
acrZp,0.5,1,1,CCGAGAACGGGACTCCAGCT,0,430860
acrZp,0.5,1,1,CCGACTGACGATTGCATCCG,0,441985
acrZp,0.5,1,1,CCGACGTGAAGTAAGGTGCA,0,444670
acrZp,0.5,1,1,CCGAATAGGATAAGGGCGCC,0,421590
acrZp,0.5,1,1,CCCTTATTTTAAATTCTTAG,0,435080
acrZp,0.5,1,1,CCCTTATATTTTTAGAGTCG,0,448473
acrZp,0.5,1,1,CCCTTAAGATAGGCCCCAAA,0,463541
acrZp,0.5,1,1,CCCTCCTTGCAAATCACGAC,0,412728
acrZp,0.5,1,1,CCCTAGAATAGGCAGGTTGT,0,416035
acrZp,0.5,1,1,CCCTAAGATGTTATGTTACT,0,442552
acrZp,0.5,1,1,CCCGTGCATGATTCAAAGTA,0,423132
acrZp,0.5,1,1,CCCGGATGTCTAACTATGTC,0,453174
acrZp,0.5,1,1,CCCGCGCTGCCTAATCGTAG,0,450949
acrZp,0.5,1,1,CCCGATTTACCCAAATAAGA,0,416357
acrZp,0.5,1,1,CCCGAGGCGTGACGCCATAG,0,464357
acrZp,0.5,1,1,CCCGACTCTACTTGAAATAT,0,420714
acrZp,0.5,1,1,CCCGAAGGCACTCTAACCAT,0,446068
acrZp,0.5,1,1,CCCCTTGCCCCAGGGAGCAG,0,415470
acrZp,0.5,1,1,CCCCTCCGCGCATCCCTTGT,0,436083
acrZp,0.5,1,1,CCCCATGGGTTCGTCCGAAG,0,412491
acrZp,0.5,1,1,CCCATTAAATTCCGGGCAAT,0,414282
acrZp,0.5,1,1,CCCAGGGACTAGATGAGAAT,0,417813
acrZp,0.5,1,1,CCCAGCGGACGAGGAGCATT,0,457336
acrZp,0.5,1,1,CCCAGACGAGAATTTGGGGT,0,419136
acrZp,0.5,1,1,CCCACGCTCTGGAGAGAAGT,0,439692
acrZp,0.5,1,1,CCCACGCACATGGAAAACAA,0,436540
acrZp,0.5,1,1,CCCACCAGTGTCGAATTTTT,0,434185
acrZp,0.5,1,1,CCCAATTTGGATACTTATAA,0,411571
acrZp,0.5,1,1,CCCAAAGGTGACCGGCGGGA,0,416309
acrZp,0.5,1,1,CCATTTGGGATGGAACGTCG,0,458418
acrZp,0.5,1,1,CCATGTCGATTCAAAGATAT,0,460699
acrZp,0.5,1,1,CCATGGCTTCGGACCTCTGT,0,432873
acrZp,0.5,1,1,CCATGCTACGTGGGCCACGC,0,424259
acrZp,0.5,1,1,CCATGCGCACCTGACGGGGG,0,423701
acrZp,0.5,1,1,CCATATAGTTTCGGTTTCAC,0,413105
acrZp,0.5,1,1,CCATAAGAGGGCAAAAGAGG,0,427301
acrZp,0.5,1,1,CCAGTACTCCGATAGGTTCT,0,431076
acrZp,0.5,1,1,CCAGTACGACTTAAGGGCCG,0,411025
acrZp,0.5,1,1,CCAGGGTGATATATCACCCG,0,439925
acrZp,0.5,1,1,CCAGCACTTGGTGTCAGGTG,0,434206
acrZp,0.5,1,1,CCAGAGGGTAATGTCTAACA,0,456671
acrZp,0.5,1,1,CCAGAGAAGATTGGACTTCG,0,459674
acrZp,0.5,1,1,CCACTTGGCCGCTCAAAGAT,0,416613
acrZp,0.5,1,1,CCACTCGGATTCTGGTGTAA,0,423349
acrZp,0.5,1,1,CCACGTTTGGACGAAGGTCT,0,410736
acrZp,0.5,1,1,CCACGTGGTTTCGCCGCCCG,0,447290
acrZp,0.5,1,1,CCACGCGAGGTCTGGTTAGT,0,422585
acrZp,0.5,1,1,CCACGAGAACTCCTAGAGGC,0,419292
acrZp,0.5,1,1,CCACCCAAGTGCGAGTTGAT,0,411070
acrZp,0.5,1,1,CCACATGAGCCCGCTTAAAA,0,449798
acrZp,0.5,1,1,CCAAGCCTCGGAATACACTC,0,423882
acrZp,0.5,1,1,CCAACCTCTGCACAACCCTA,0,460026
acrZp,0.5,1,1,CCAAACCATCTTTTCGCAAG,0,456867
acrZp,0.5,1,1,CCAAAATCACGGAGTACTTA,0,441507
acrZp,0.5,1,1,CATTTCCGTTAATTGGTAAC,0,438071
acrZp,0.5,1,1,CATTTCCGGAGGGTATAGCG,0,409137
acrZp,0.5,1,1,CATTTAATCAATGGATTTGA,0,428593
acrZp,0.5,1,1,CATTGTCCTCCACTCCAACT,0,446058
acrZp,0.5,1,1,CATTGTACATTACCCGCTAG,0,436629
acrZp,0.5,1,1,CATTGGCGGCTTGGCACTGC,0,418769
acrZp,0.5,1,1,CATTCTACCTCTGGAATTCT,0,418067
acrZp,0.5,1,1,CATTCGGGGGTTAGCCTCTG,0,418244
acrZp,0.5,1,1,CATTCGGACACATCACGCCA,0,466434
acrZp,0.5,1,1,CATTCCGCCGTTTTGGTTGG,0,462830
acrZp,0.5,1,1,CATTCCAACATGGCTCTATG,0,453445
acrZp,0.5,1,1,CATTACCCGCACCCAGTGAG,0,446838
acrZp,0.5,1,1,CATGTCACACGGTCGAGGGT,0,431341
acrZp,0.5,1,1,CATGGGGCTTAGGGGTGACA,0,420094
acrZp,0.5,1,1,CATGGCTTTCGTTGGTGTCT,0,417739
acrZp,0.5,1,1,CATGGCATTCCAGCTCGCAG,0,445101
acrZp,0.5,1,1,CATGCTTGGGCTCCGCACCA,0,454062
acrZp,0.5,1,1,CATGCTATTGATCCGAAACC,0,416576
acrZp,0.5,1,1,CATGCAGGATTCGGAGTCAA,0,461308
acrZp,0.5,1,1,CATGCAGACCAAAAGATTAA,0,436030
acrZp,0.5,1,1,CATGAGCTCAGGGAAACTCA,0,452238
acrZp,0.5,1,1,CATGAGCGATCTGTTACTGT,0,448328
acrZp,0.5,1,1,CATGACCAAGGATGGATATA,0,425805
acrZp,0.5,1,1,CATGAATTCAGCTTGTTGGG,0,440675
acrZp,0.5,1,1,CATCTGGCCGCAGAGGGAAG,0,457345
acrZp,0.5,1,1,CATCGGACCTGGCGCGTCAT,0,457683
acrZp,0.5,1,1,CATCGCGTGGGTCATGTTCC,0,450765
acrZp,0.5,1,1,CATCCTCGAGGCGAAAATTC,0,430690
acrZp,0.5,1,1,CATCATGCGTCTGAGCTAAG,0,465089
acrZp,0.5,1,1,CATCACGAGACTCTCATCAT,0,417282
acrZp,0.5,1,1,CATATATCGAACCGTATCAC,0,415525
acrZp,0.5,1,1,CATAGTCTCGCTGACCGACG,0,446926
acrZp,0.5,1,1,CATAGTCGCGCACATCGGCC,0,441661
acrZp,0.5,1,1,CATAGGATAAAGTTCCCTTG,0,411596
acrZp,0.5,1,1,CATAGGAGGGCTAGTCAGCC,0,426822
acrZp,0.5,1,1,CATAGCTCGGTCCTGAGCAA,0,437484
acrZp,0.5,1,1,CATAGCATTCGTGTGCCCTC,0,430996
acrZp,0.5,1,1,CATACAGCGACATACGTGAC,0,455041
acrZp,0.5,1,1,CATAAGGTCTTGGTACTTGC,0,443970
acrZp,0.5,1,1,CATAAAAGAATTAAGAGACT,0,413058
acrZp,0.5,1,1,CAGTTTGTCCATATGCCCAT,0,413289
acrZp,0.5,1,1,CAGTTTCTGCCCCAAGGTAT,0,434815
acrZp,0.5,1,1,CAGTGAACAGATTGAACCTC,0,420284
acrZp,0.5,1,1,CAGTGAAAAATTCAGGGCAA,0,453873
acrZp,0.5,1,1,CAGTCGCACTACCCGCCACC,0,440708
acrZp,0.5,1,1,CAGTCCGTGACAAACTTAGC,0,465831
acrZp,0.5,1,1,CAGTCCCCGCTGAAAACTGG,0,416059
acrZp,0.5,1,1,CAGTCCAAAGACAATGAGCG,0,450574
acrZp,0.5,1,1,CAGTATACCCAATAAGTTTG,0,461412
acrZp,0.5,1,1,CAGTAGCTTGTCGATTTCGT,0,409541
acrZp,0.5,1,1,CAGGTTTCGTGAGACGTGCG,0,459557
acrZp,0.5,1,1,CAGGTTTATGGGGGCCACAT,0,428277
acrZp,0.5,1,1,CAGGTTGAGCAAGGCAGGTC,0,411425
acrZp,0.5,1,1,CAGGGCGTAGCCGTAACATT,0,452894
acrZp,0.5,1,1,CAGGCTGAGTATGTTGAGCG,0,455553
acrZp,0.5,1,1,CAGGCAGCTTGTGGCCAAAG,0,465883
acrZp,0.5,1,1,CAGGCAACGCATTATGGAAA,0,436986
acrZp,0.5,1,1,CAGGATGCCGAGCTCTGACA,0,426656
acrZp,0.5,1,1,CAGGACAGTCTGTGGTGTTC,0,451733
acrZp,0.5,1,1,CAGCTTGCTATTTGGAGTAG,0,454999
acrZp,0.5,1,1,CAGCTTCACGTTTGTACGCG,0,446638
acrZp,0.5,1,1,CAGCTGCGCCACTCCAGATA,0,445842
acrZp,0.5,1,1,CAGCGGCAGCGAACTTAACG,0,449914
acrZp,0.5,1,1,CAGCGCTCTCTATCGCAATA,0,433822
acrZp,0.5,1,1,CAGCGCAGTTCGGTGGATGT,0,439810
acrZp,0.5,1,1,CAGCGATACCGGAGGGGGTT,0,439919
acrZp,0.5,1,1,CAGCCGTTCTAGCCACCGCA,0,408718
acrZp,0.5,1,1,CAGCACGTGACAACCACTTG,0,418673
acrZp,0.5,1,1,CAGCAAGTAGTCCGGCCTAA,0,412355
acrZp,0.5,1,1,CAGCAAATCCAAATATCCGT,0,419749
acrZp,0.5,1,1,CAGATTCTCACGGCGCTATA,0,448003
acrZp,0.5,1,1,CAGATTACAACACAAGTGGG,0,436988
acrZp,0.5,1,1,CAGAGCCTTGTACATTGTCA,0,411331
acrZp,0.5,1,1,CAGACGCGCCTATTCCTGCA,0,424400
acrZp,0.5,1,1,CAGACAATGCAGCAGTGAAG,0,444196
acrZp,0.5,1,1,CAGAATGTCTTGAGACTCCG,0,457003
acrZp,0.5,1,1,CACTTTGGTCTTTCAATCTT,0,436964
acrZp,0.5,1,1,CACTGGCGAATGGTTCATTG,0,430699
acrZp,0.5,1,1,CACTCTAGAGAGTTGTACTT,0,438570
acrZp,0.5,1,1,CACTCCCGCTCTAGCGGATT,0,432361
acrZp,0.5,1,1,CACTAATCTTATTTATGGGT,0,450921
acrZp,0.5,1,1,CACGTTGCTCCAATCCGCGC,0,449887
acrZp,0.5,1,1,CACGTAAAGTTCAGGAAGAT,0,427564
acrZp,0.5,1,1,CACGGAATGGGAGGGAAGAA,0,438012
acrZp,0.5,1,1,CACGGAAACGGTCGCAACGA,0,456478
acrZp,0.5,1,1,CACGCGTGTCCTAGATGCAG,0,445401
acrZp,0.5,1,1,CACGACTTCAGCTAACTCGC,0,434399
acrZp,0.5,1,1,CACCTGGTGGGTTGTTAAGT,0,419225
acrZp,0.5,1,1,CACCCGGTTGTGAGTTCGAC,0,424444
acrZp,0.5,1,1,CACCCCTAGCGTAAGGACGT,0,413107
acrZp,0.5,1,1,CACATTACTCCAGCGCTAGG,0,411063
acrZp,0.5,1,1,CACATGCGCGGATGTGTGAC,0,428474
acrZp,0.5,1,1,CACATCAGTCCTAGCTAATC,0,410919
acrZp,0.5,1,1,CACAGTTAGACTTACGCCGG,0,450212
acrZp,0.5,1,1,CACAACTATGCCCGGGGCTT,0,458358
acrZp,0.5,1,1,CACAACGGTAAGCTTGGGAA,0,453015
acrZp,0.5,1,1,CAATTTTTGTCATTTGACAT,0,421313
acrZp,0.5,1,1,CAATGGTGCTGACCGCGAGT,0,462839
acrZp,0.5,1,1,CAATGGATAGACCCATGCAT,0,465903
acrZp,0.5,1,1,CAATCGTAGTGTTGCGGGAA,0,430345
acrZp,0.5,1,1,CAATCATTATCGTTGTCAAT,0,448066
acrZp,0.5,1,1,CAATCAGGTATACTTAAATC,0,419089
acrZp,0.5,1,1,CAATATTCTCAGTAGAAATT,0,446197
acrZp,0.5,1,1,CAATATCATCCCGCGGGCAA,0,436493
acrZp,0.5,1,1,CAAGTTTTGCACGGGTCGCG,0,460449
acrZp,0.5,1,1,CAAGTGGCGTCCTCTGTCCT,0,414452
acrZp,0.5,1,1,CAAGTCCGAGGTGCATTGCT,0,419213
acrZp,0.5,1,1,CAAGTACGCTCAGCTTAGCA,0,417290
acrZp,0.5,1,1,CAAGGTATAGCTCCTCCGTG,0,430818
acrZp,0.5,1,1,CAAGGGTTAACGGTGGTCGG,0,463044
acrZp,0.5,1,1,CAAGGCTCTTAGGTTACCAA,0,446977
acrZp,0.5,1,1,CAAGCGAGGCGTTGAGGAAA,0,417977
acrZp,0.5,1,1,CAAGCCGGTTACATCCACCG,0,450384
acrZp,0.5,1,1,CAAGCCCACCCCATGAGCCT,0,460845
acrZp,0.5,1,1,CAACGTTGGTTCAAGGCATC,0,418396
acrZp,0.5,1,1,CAACGTGATGGGGTAGGCCC,0,439899
acrZp,0.5,1,1,CAACGGAGTGGGGTATCAAT,0,462704
acrZp,0.5,1,1,CAACCTCAATCATAAGGGAA,0,456511
acrZp,0.5,1,1,CAACCCCGAGAAAAGGGGGT,0,449384
acrZp,0.5,1,1,CAACCAGTGGTGCGGCTACA,0,442414
acrZp,0.5,1,1,CAAATAATAAGTCACTGATT,0,456418
acrZp,0.5,1,1,CAAAGGTCTCTGTACCAACT,0,414811
acrZp,0.5,1,1,CAAAGAGTGAAGATTTGCTA,0,413347
acrZp,0.5,1,1,CAAACCGGGTTTGAGCCGTT,0,454029
acrZp,0.5,1,1,CAAAACCGTCGGGCCTGGAA,0,457757
acrZp,0.5,1,1,CAAAAAGATTGCTCTTCCCA,0,410656
acrZp,0.5,1,1,ATTTTTGATAAACGTACGGA,0,426644
acrZp,0.5,1,1,ATTTTTAAGCCGCGCAGTAA,0,414521
acrZp,0.5,1,1,ATTTTGTATCCGGGTGCTAG,0,413383
acrZp,0.5,1,1,ATTTTGCCTATCTTTCATAC,0,448277
acrZp,0.5,1,1,ATTTTCAAGGACCCCAAGAG,0,465265
acrZp,0.5,1,1,ATTTGGACCCGCGAGATCAT,0,416503
acrZp,0.5,1,1,ATTTCTCCTCATAGTTGGAA,0,416123
acrZp,0.5,1,1,ATTTCCATCTAACGCCGCGA,0,429994
acrZp,0.5,1,1,ATTTCACGCCGAGTAGAGAA,0,452093
acrZp,0.5,1,1,ATTTACTTGCTCTTAGTTAA,0,444908
acrZp,0.5,1,1,ATTTACTCGTCCAATGTCCT,0,459377
acrZp,0.5,1,1,ATTGGTTTTTGAATGCTGGA,0,438515
acrZp,0.5,1,1,ATTGGTAGGTGTCAGGGGAT,0,425980
acrZp,0.5,1,1,ATTGGGTAAGGTGCATGAAT,0,425466
acrZp,0.5,1,1,ATTGCAGGACGGAGTTATAC,0,456677
acrZp,0.5,1,1,ATTGCAAGCTTGGAGTTCAG,0,454273
acrZp,0.5,1,1,ATTCTCGGTTTAGTCCTACG,0,427768
acrZp,0.5,1,1,ATTCTCAGGAGCAAAAAAAG,0,461313
acrZp,0.5,1,1,ATTCTAAGCCATTTCTTGAG,0,424945
acrZp,0.5,1,1,ATTCGTGTCGCATGGCTACT,0,454240
acrZp,0.5,1,1,ATTCGTCCGTTAATCTCATC,0,445615
acrZp,0.5,1,1,ATTCGGGTCTAACATGGACG,0,425068
acrZp,0.5,1,1,ATTCGGAGCCTATCTTAAAA,0,452735
acrZp,0.5,1,1,ATTCCCGACACGGAGGACGC,0,453981
acrZp,0.5,1,1,ATTCCAACCGTTCGATGGAA,0,424865
acrZp,0.5,1,1,ATTCAGACCGGGACGTACCG,0,424609
acrZp,0.5,1,1,ATTATTGTCCTGGACACGGA,0,411777
acrZp,0.5,1,1,ATTATTACAAGGGCCTGAGC,0,442852
acrZp,0.5,1,1,ATTATGTCTTACTAGACGCG,0,454185
acrZp,0.5,1,1,ATTAGTGGGGAATCTTAATA,0,437031
acrZp,0.5,1,1,ATTAGGATGCTTTCACCCAC,0,445086
acrZp,0.5,1,1,ATTAGCAACGATGGCCACGA,0,411651
acrZp,0.5,1,1,ATTACCCTCTGCCCAACCTT,0,442686
acrZp,0.5,1,1,ATTAACCATCAACACCGAAT,0,462700
acrZp,0.5,1,1,ATGTTTGCAGATTTCACTAT,0,425445
acrZp,0.5,1,1,ATGTTAGATAGGCAAAATCA,0,458680
acrZp,0.5,1,1,ATGTGGGGTTCACTTGGTAG,0,426451
acrZp,0.5,1,1,ATGTCTTTGAGGAAAAGGCT,0,451275
acrZp,0.5,1,1,ATGTCGGCACTATTTGTAAC,0,423029
acrZp,0.5,1,1,ATGGGGTCAAGCACAGTTTA,0,433208
acrZp,0.5,1,1,ATGGGGATAAGGTCTGGCGA,0,422075
acrZp,0.5,1,1,ATGGGCTTTTTCAACGTGCG,0,417187
acrZp,0.5,1,1,ATGGGAGGCACCTCGGGAGA,0,409151
acrZp,0.5,1,1,ATGGCTAAAACATACCACCT,0,440370
acrZp,0.5,1,1,ATGGCGGGTGTTACAGCGCT,0,422393
acrZp,0.5,1,1,ATGGCATATTACTGCGATGT,0,447324
acrZp,0.5,1,1,ATGCTTGCAGGCAAGCAATA,0,433526
acrZp,0.5,1,1,ATGCTGGCCTGCCAACCTCA,0,409440
acrZp,0.5,1,1,ATGCTACCCATAAACGTCCA,0,452768
acrZp,0.5,1,1,ATGCGCGCGGGGGTCTTCCG,0,411690
acrZp,0.5,1,1,ATGCGCCGACCGGCCTTGGG,0,449151
acrZp,0.5,1,1,ATGCCATGTCTTAAGTCTTG,0,425920
acrZp,0.5,1,1,ATGCCACCCGGTAACCACAG,0,457881
acrZp,0.5,1,1,ATGCATCAAGCGTGTACTCT,0,447233
acrZp,0.5,1,1,ATGATCTACAGAGTCATGAG,0,455053
acrZp,0.5,1,1,ATGAGGGTTACCAGGACACG,0,420872
acrZp,0.5,1,1,ATGAGAGGCCATAATATTAA,0,449312
acrZp,0.5,1,1,ATGACTTTGGGACGGGGATT,0,409922
acrZp,0.5,1,1,ATGACCCCAGGCCGACAAAG,0,432967
acrZp,0.5,1,1,ATGACCCAACACATAATCGA,0,431623
acrZp,0.5,1,1,ATGAACTACGAACGGTCTAT,0,412126
acrZp,0.5,1,1,ATGAAAATGCAGACCTCGTC,0,448393
acrZp,0.5,1,1,ATCTTGGGGGCGTGAGGATC,0,428839
acrZp,0.5,1,1,ATCTGGTAGTATTATGTACA,0,420495
acrZp,0.5,1,1,ATCTAATTGGGTTTACCGAA,0,411155
acrZp,0.5,1,1,ATCGTGACCATCTAATTCGG,0,430788
acrZp,0.5,1,1,ATCGTCATCCCTGCTCCCGC,0,437986
acrZp,0.5,1,1,ATCGGGCAGGGAACTTATGT,0,420391
acrZp,0.5,1,1,ATCGGAGATAGCTATGACTT,0,434250
acrZp,0.5,1,1,ATCGGACACGTGTTGTTCAA,0,456033
acrZp,0.5,1,1,ATCGCAGGGGGGTCTCATTC,0,435986
acrZp,0.5,1,1,ATCGAGCGGAGTAAGAATGA,0,426398
acrZp,0.5,1,1,ATCCCTGGATTCCCGATGAA,0,412347
acrZp,0.5,1,1,ATCCATTCGTGGTCCAGTGA,0,459149
acrZp,0.5,1,1,ATCAGCTTGGACCGGGATCA,0,454297
acrZp,0.5,1,1,ATCAGCTGTGGAACAGATCT,0,467279
acrZp,0.5,1,1,ATATTCGCATGATCAATTTC,0,449004
acrZp,0.5,1,1,ATATCGTGACTTCGCGAAAC,0,428237
acrZp,0.5,1,1,ATATCGGGAAGCTTGATCAA,0,449083
acrZp,0.5,1,1,ATATCGGCTCTGGGCCTGCA,0,462511
acrZp,0.5,1,1,ATATCGAGCTAACTTTTCTA,0,462563
acrZp,0.5,1,1,ATATCATACGGATTTTTGAC,0,418143
acrZp,0.5,1,1,ATATCAGGGTTGTCATTTAA,0,432955
acrZp,0.5,1,1,ATATCAAGCAGGGAGGCCTG,0,433385
acrZp,0.5,1,1,ATATATACTGTGCAATGACT,0,408754
acrZp,0.5,1,1,ATATAGGTTCGAAGTTCAAC,0,453906
acrZp,0.5,1,1,ATATACCCGCGAGCAATCGG,0,429697
acrZp,0.5,1,1,ATATACATGTGATGAGCCGT,0,435067
acrZp,0.5,1,1,ATATAAAGCATAGGCATAGT,0,421988
acrZp,0.5,1,1,ATAGTTCTAATCCCGCGTGC,0,418897
acrZp,0.5,1,1,ATAGTCAGTACGATTGCCCG,0,409556
acrZp,0.5,1,1,ATAGGTCGCCATAACTTGAG,0,438860
acrZp,0.5,1,1,ATAGGGTGCCTCGCTTCGGA,0,428528
acrZp,0.5,1,1,ATAGCCTGTAAAAGTAACCA,0,459305
acrZp,0.5,1,1,ATAGCACATGATCATGCGTC,0,415866
acrZp,0.5,1,1,ATACTGGGCTGGGGAGTTTG,0,463884
acrZp,0.5,1,1,ATACTACAGGGTCAGCCAGG,0,446500
acrZp,0.5,1,1,ATACGGGTTGTTCGAGATAA,0,446921
acrZp,0.5,1,1,ATACGATGGAAGCTATCAGT,0,462014
acrZp,0.5,1,1,ATACCATGCTAAAATATCAA,0,439014
acrZp,0.5,1,1,ATACATTGCAGTGCCACGCA,0,452566
acrZp,0.5,1,1,ATACAGTATTTATTTGAGCC,0,463895
acrZp,0.5,1,1,ATACACACCTAACCCAATCA,0,434081
acrZp,0.5,1,1,ATAATTATCGGTTCGGCGAT,0,462495
acrZp,0.5,1,1,ATAATCGCTGATCTAGAGGT,0,465706
acrZp,0.5,1,1,ATAATCCATATTTTTGGGGA,0,414590
acrZp,0.5,1,1,ATAATAAGATCCCAGCTCTA,0,415078
acrZp,0.5,1,1,ATAAGTGGCCAGGATGGTCG,0,410971
acrZp,0.5,1,1,ATAAGGGGGATGAAAACGCA,0,419404
acrZp,0.5,1,1,ATAAGGAGACCCACGTCCGG,0,409642
acrZp,0.5,1,1,ATAACTATGCGCTTGCGGAC,0,411468
acrZp,0.5,1,1,ATAACGTTTAATTCGGATCG,0,447287
acrZp,0.5,1,1,ATAACCTTTTAGGTCTCATC,0,446180
acrZp,0.5,1,1,ATAAATCTCACACTTTTTCT,0,422537
acrZp,0.5,1,1,AGTTTCATGATTCGAAGCAA,0,433228
acrZp,0.5,1,1,AGTTCGTGAACATACAAGGC,0,457306
acrZp,0.5,1,1,AGTTACGTGGGCCGTCATCT,0,435960
acrZp,0.5,1,1,AGTGTGTCCACGCCTTAGAC,0,459929
acrZp,0.5,1,1,AGTGTCTTGACGCGGCGCCG,0,460221
acrZp,0.5,1,1,AGTGGTTGAGCGTGGCTGAC,0,433157
acrZp,0.5,1,1,AGTGGTGGGCACTCTGTTCA,0,465702
acrZp,0.5,1,1,AGTGGTGGGATTAATCCACG,0,455056
acrZp,0.5,1,1,AGTGGGGAGCCAGCATTAGT,0,437133
acrZp,0.5,1,1,AGTGGCCCTAAGGTACGTTT,0,452981
acrZp,0.5,1,1,AGTGCCGAAGCGAGAGGCGA,0,412203
acrZp,0.5,1,1,AGTGCAAGACAAGCGGATTA,0,438511
acrZp,0.5,1,1,AGTGCAAAAAATAAGCCTGG,0,461725
acrZp,0.5,1,1,AGTGATAGAGGATCGAATTG,0,436459
acrZp,0.5,1,1,AGTGACACGTTGCAAATCAA,0,451244
acrZp,0.5,1,1,AGTCTTGGTATAGCACAGTG,0,452239
acrZp,0.5,1,1,AGTCTAAACGTATGGTGAGG,0,433115
acrZp,0.5,1,1,AGTCGTTTGCATGGTATGCT,0,451805
acrZp,0.5,1,1,AGTCGCAACCCCTCGTACCT,0,446352
acrZp,0.5,1,1,AGTCAGTCACGTTGGTAGTG,0,435162
acrZp,0.5,1,1,AGTCACTTTCTGTTTTGGTC,0,442169
acrZp,0.5,1,1,AGTCACACAAATACCCCAAC,0,420523
acrZp,0.5,1,1,AGTATGCGCGTGTTGGGGTA,0,432321
acrZp,0.5,1,1,AGTATGAGCGCAGGCTGCAT,0,444085
acrZp,0.5,1,1,AGTAGAGAATCAGCTCAGCA,0,425545
acrZp,0.5,1,1,AGTAGAAGATTCGGGTTAAA,0,456359
acrZp,0.5,1,1,AGTAATGGGTGACGGACCTT,0,454305
acrZp,0.5,1,1,AGTAAGGCTAAATTACTATG,0,446635
acrZp,0.5,1,1,AGGTGATCCTGGGTCGTTGA,0,424078
acrZp,0.5,1,1,AGGTCGTATCTGCCGGTTAT,0,409362
acrZp,0.5,1,1,AGGTCCGGACAGGAATGAAT,0,442243
acrZp,0.5,1,1,AGGTATTGTGGATCGGGTCC,0,455039
acrZp,0.5,1,1,AGGTAAAGTGGGCCGATTCG,0,463721
acrZp,0.5,1,1,AGGGTGTCACTGTATAATTC,0,421214
acrZp,0.5,1,1,AGGGTGAGGAGTAACAAGGT,0,431215
acrZp,0.5,1,1,AGGGTCCCCACGAGATCACA,0,417398
acrZp,0.5,1,1,AGGGGGTAATCGCTCCTCAA,0,424197
acrZp,0.5,1,1,AGGGCTTCTGCTGCCATCTA,0,439053
acrZp,0.5,1,1,AGGCTATCAAAGCTCAGGTA,0,425273
acrZp,0.5,1,1,AGGCAGCACATTATGATAGC,0,443988
acrZp,0.5,1,1,AGGATGAGACATATACGGGT,0,448754
acrZp,0.5,1,1,AGGATATACCGCACGCTCAC,0,435440
acrZp,0.5,1,1,AGGATAGTATTTCGCCGGAT,0,453169
acrZp,0.5,1,1,AGGAGCGGATGACATTCTAA,0,423141
acrZp,0.5,1,1,AGGAGAAGAGCAGAGTGACA,0,451746
acrZp,0.5,1,1,AGGACCGCGTGGCGTTGAAC,0,446171
acrZp,0.5,1,1,AGGACCCGCCTTTTCAGTCC,0,412393
acrZp,0.5,1,1,AGGACACGTGCTCCACAAGT,0,417301
acrZp,0.5,1,1,AGGAAAGCCCGATACGGTTC,0,428454
acrZp,0.5,1,1,AGGAAACGGAGCTACCCGGC,0,417488
acrZp,0.5,1,1,AGCTGTGTCTATCTTTCTGG,0,441242
acrZp,0.5,1,1,AGCTGGCCGATAACTCTCAA,0,439074
acrZp,0.5,1,1,AGCTCTTTTTCCCGCATCCA,0,455294
acrZp,0.5,1,1,AGCTCTCGGTCCCTCACGGT,0,419015
acrZp,0.5,1,1,AGCGTGACGCCCGCTCACGT,0,464404
acrZp,0.5,1,1,AGCGTCTTGTGATAAAAGAC,0,450334
acrZp,0.5,1,1,AGCGTAACATTTGGGTCCCA,0,439924
acrZp,0.5,1,1,AGCGTAACACTGACTGGCTA,0,430306
acrZp,0.5,1,1,AGCGGGCGTGGCCCTAGGGA,0,457097
acrZp,0.5,1,1,AGCGGCTAAGGGATGCATGT,0,429879
acrZp,0.5,1,1,AGCGGCCATCAAATTGCTAA,0,441492
acrZp,0.5,1,1,AGCGCGTACCGGATAGGACT,0,411029
acrZp,0.5,1,1,AGCGAGTCAACAAAGATTCT,0,432734
acrZp,0.5,1,1,AGCCTCGTCCGGCACCGGGT,0,420961
acrZp,0.5,1,1,AGCCGGATTGCATTGTCCCA,0,466397
acrZp,0.5,1,1,AGCCGACTAAACTCCCAGCG,0,431513
acrZp,0.5,1,1,AGCCCTTAGGGGTGGCCACT,0,464446
acrZp,0.5,1,1,AGCCCACTACATTGCGCGAA,0,420407
acrZp,0.5,1,1,AGCCAGATTGACACAACCCA,0,438634
acrZp,0.5,1,1,AGCCACGACTTGGCACTTAT,0,433919
acrZp,0.5,1,1,AGCCACAATATGGTAATCCT,0,441129
acrZp,0.5,1,1,AGCATTGTTTGGGCACGGTG,0,443168
acrZp,0.5,1,1,AGCATGAGCATCTGTCTAAC,0,440557
acrZp,0.5,1,1,AGCAGCCACGCATCCGACGA,0,417048
acrZp,0.5,1,1,AGCAGATCCTAGCTCCATCA,0,427469
acrZp,0.5,1,1,AGCACGTAGTACTGGGCGCT,0,426616
acrZp,0.5,1,1,AGCACGAGCCCCAGTAGGCT,0,423108
acrZp,0.5,1,1,AGCAACAGACTAACCCTTGC,0,435139
acrZp,0.5,1,1,AGATTTCGGGGATGGGTCAG,0,428045
acrZp,0.5,1,1,AGATTCTTAGGACTGATGCA,0,414729
acrZp,0.5,1,1,AGATTACGTGAGGCATATCT,0,419841
acrZp,0.5,1,1,AGATTAAAGGGGATCCGGCG,0,423011
acrZp,0.5,1,1,AGATGCAGGTTTTGAGCGAG,0,428081
acrZp,0.5,1,1,AGATCGCTAGGATATGGAGG,0,459500
acrZp,0.5,1,1,AGATCATATCAGAGAGCTGT,0,449274
acrZp,0.5,1,1,AGAGGGTTCAGTCAAGGGCG,0,442580
acrZp,0.5,1,1,AGAGCTCCTATGGGCTATGG,0,457931
acrZp,0.5,1,1,AGAGATGGTCGCACAGAGGC,0,409364
acrZp,0.5,1,1,AGAGACACGAACAACGCGAT,0,447453
acrZp,0.5,1,1,AGACTATTATGTCTCGTGAT,0,423822
acrZp,0.5,1,1,AGACCAACCTGAAAAGCCTT,0,429279
acrZp,0.5,1,1,AGACAGGTCGATTTCCCAGT,0,450483
acrZp,0.5,1,1,AGACACTATGATACGTGTCA,0,411727
acrZp,0.5,1,1,AGACACCACTGGAGCGAGTA,0,431761
acrZp,0.5,1,1,AGACAAGACCATGTCCCTTT,0,408957
acrZp,0.5,1,1,AGAAGGTAAAGCAAGCAAGA,0,443283
acrZp,0.5,1,1,AGAAGCTTGACAGTAGGCAA,0,438686
acrZp,0.5,1,1,AGAACGGTATACGTGGGTTG,0,453135
acrZp,0.5,1,1,AGAACAGGAAGCTGATCGAG,0,450527
acrZp,0.5,1,1,AGAAATCTTGTGAAGGAGAC,0,414462
acrZp,0.5,1,1,ACTTTTTAAGTTCGTCCGGG,0,414032
acrZp,0.5,1,1,ACTTTTCTGCGCGGAACGAC,0,456872
acrZp,0.5,1,1,ACTTTTAGAACTGCCGACCA,0,428294
acrZp,0.5,1,1,ACTTTGACACGACGACAAGT,0,436651
acrZp,0.5,1,1,ACTTTCAGGGGTTTATGGCA,0,415173
acrZp,0.5,1,1,ACTTGTGGGTCTTTCACTCG,0,467201
acrZp,0.5,1,1,ACTTGATTTCTGGCGTAGAT,0,455337
acrZp,0.5,1,1,ACTTCTGGGAGAGCTTCCTT,0,414587
acrZp,0.5,1,1,ACTTCCGAGTAACGAAATTA,0,424532
acrZp,0.5,1,1,ACTTAGGTCTTTATGGGAGA,0,461118
acrZp,0.5,1,1,ACTGTGGGATGCCTTGCCAA,0,459385
acrZp,0.5,1,1,ACTGTAGAGATACCGCTCTG,0,446324
acrZp,0.5,1,1,ACTGTAATTGCGAGCACGTG,0,460643
acrZp,0.5,1,1,ACTGGTCATATCGGACTGCT,0,464136
acrZp,0.5,1,1,ACTGGAGCCGAAGAAATCAG,0,454056
acrZp,0.5,1,1,ACTGGAAAAATTGGCAGCCT,0,440451
acrZp,0.5,1,1,ACTGCTTTTGTGCTCTCCAA,0,410397
acrZp,0.5,1,1,ACTGCGTTGAAATTGCATCT,0,448236
acrZp,0.5,1,1,ACTGCCCAATAGAGCGAGAG,0,432180
acrZp,0.5,1,1,ACTGAGAATGTAGGGCCGTT,0,412597
acrZp,0.5,1,1,ACTGAGAAGGGCTGTAGGCA,0,460235
acrZp,0.5,1,1,ACTGACGGCGATTGGATGCC,0,430015
acrZp,0.5,1,1,ACTGACGACGTGTGTCTTCA,0,441748
acrZp,0.5,1,1,ACTGACCCTGTAACAGACGA,0,423013
acrZp,0.5,1,1,ACTCCTCGAATCATCTAGGT,0,431190
acrZp,0.5,1,1,ACTCCGAAGAGTTGTAGCCC,0,466943
acrZp,0.5,1,1,ACTCATAGTTCCGATTAGTC,0,418780
acrZp,0.5,1,1,ACTCAGATGAGCACTTCGTT,0,422215
acrZp,0.5,1,1,ACTATCGGTCCAACAATGCA,0,454808
acrZp,0.5,1,1,ACTAGGGAAGGGTGTCTTAG,0,416770
acrZp,0.5,1,1,ACTAGGGAACTCCAGTTACG,0,411991
acrZp,0.5,1,1,ACTACCATACGAGAGCTAGA,0,452434
acrZp,0.5,1,1,ACTACAAGAACAACGACTCG,0,423046
acrZp,0.5,1,1,ACGTTGTCGCGAGGTTAGGA,0,445961
acrZp,0.5,1,1,ACGTTCCCCGGTCCAACCGC,0,431689
acrZp,0.5,1,1,ACGTTAATACACAGTGGGAG,0,410062
acrZp,0.5,1,1,ACGTTAAGCGGATACTAGAA,0,438509
acrZp,0.5,1,1,ACGTGTTTACCCACTGTAGT,0,440176
acrZp,0.5,1,1,ACGTGCGGGTACTGTATTGT,0,460939
acrZp,0.5,1,1,ACGTGCAAAGGAGCTTAACG,0,443299
acrZp,0.5,1,1,ACGTATTCTCAGCCTGTTCG,0,440847
acrZp,0.5,1,1,ACGTAGCCAAGACACCTCAA,0,465731
acrZp,0.5,1,1,ACGGTTTTACCTCTGGCCCT,0,446022
acrZp,0.5,1,1,ACGGTATATGACGTCCGAAC,0,454252
acrZp,0.5,1,1,ACGGTACTCCCCGGGCTGGA,0,442359
acrZp,0.5,1,1,ACGGGTTACTCCGTAGTCCA,0,448010
acrZp,0.5,1,1,ACGGGGTATGGGCATGTCGT,0,453024
acrZp,0.5,1,1,ACGGGGAAATGTCTCCGAAA,0,426335
acrZp,0.5,1,1,ACGGGCGGTTCTGTCAATGT,0,450734
acrZp,0.5,1,1,ACGGGATTAGTGTGAGTTTA,0,438613
acrZp,0.5,1,1,ACGGGACGGCATGCTAACAA,0,431759
acrZp,0.5,1,1,ACGGCACTAAGAAACAATCA,0,426703
acrZp,0.5,1,1,ACGGATGACACGTCATTATG,0,443562
acrZp,0.5,1,1,ACGGACCTCGCTGCTGAGAG,0,413709
acrZp,0.5,1,1,ACGGACAAAAGGTAAAGGTG,0,419138
acrZp,0.5,1,1,ACGCTTGTAACAGCGCTTTA,0,422759
acrZp,0.5,1,1,ACGCTCGGAGTTGCCCGAAC,0,411778
acrZp,0.5,1,1,ACGCTCACGACGTGAGAAAC,0,408966
acrZp,0.5,1,1,ACGCGTTAGTATTGAGCCCC,0,440571
acrZp,0.5,1,1,ACGCCGGTGCGCCACGCATC,0,414289
acrZp,0.5,1,1,ACGCCGGTCGCTCTGGTCAA,0,466590
acrZp,0.5,1,1,ACGCCGGATGGTACTCAGCG,0,425931
acrZp,0.5,1,1,ACGCCAAGGTATGGTACTAC,0,415748
acrZp,0.5,1,1,ACGCATGTTGACGACGACTG,0,466153
acrZp,0.5,1,1,ACGAGATTAGAATTCTAGCT,0,437184
acrZp,0.5,1,1,ACGACGTAGGGAACTTAAAC,0,442492
acrZp,0.5,1,1,ACGACCACGCATGGCTAGAA,0,411226
acrZp,0.5,1,1,ACGACACATAAGTGGGTTTT,0,456788
acrZp,0.5,1,1,ACGAATGTTCATGGTTTGCT,0,443440
acrZp,0.5,1,1,ACCTTAGAGAACGGAGTCAT,0,421682
acrZp,0.5,1,1,ACCTGTTGAGGCGGACCACA,0,441549
acrZp,0.5,1,1,ACCTGTTCCACAGTCATGTC,0,445599
acrZp,0.5,1,1,ACCTGTAGTGAAGGCGATCT,0,427392
acrZp,0.5,1,1,ACCTGGGGCGCTGTTTAAGT,0,414867
acrZp,0.5,1,1,ACCTGGACCCTGCTACCAGT,0,432352
acrZp,0.5,1,1,ACCTATGTGGGTGACCCCAG,0,439488
acrZp,0.5,1,1,ACCTAGCCTGGGCAGGGTTG,0,441373
acrZp,0.5,1,1,ACCTAACTTACATGTCTATT,0,463469
acrZp,0.5,1,1,ACCGTTTGAAATTATCTGAT,0,423411
acrZp,0.5,1,1,ACCGGGATCCTCGAGTTGTT,0,413587
acrZp,0.5,1,1,ACCGGCGGTCTGTGATTCTA,0,420783
acrZp,0.5,1,1,ACCGCATGGATGGATACCAC,0,420179
acrZp,0.5,1,1,ACCGATTTTTTGACCTCTAG,0,419977
acrZp,0.5,1,1,ACCGATAGGTTACCGGACTT,0,416809
acrZp,0.5,1,1,ACCGAGGCGTTTGGAGCAAC,0,428484
acrZp,0.5,1,1,ACCGAGGAACAGTCAAGCTT,0,459478
acrZp,0.5,1,1,ACCGAATCTATGCTCGCAGC,0,428027
acrZp,0.5,1,1,ACCCTAAAATATAACTGGAC,0,420062
acrZp,0.5,1,1,ACCCTAAAAGGGGTCAGTCG,0,447491
acrZp,0.5,1,1,ACCCGTTGACATGCTATAAA,0,450250
acrZp,0.5,1,1,ACCCCTCTAGTGGGCGCAGA,0,425148
acrZp,0.5,1,1,ACCCAAGCGCAGACTATCGA,0,420228
acrZp,0.5,1,1,ACCATGGTGTAGGTCCGGGA,0,452251
acrZp,0.5,1,1,ACCATATCGCGTCACTCTCC,0,416312
acrZp,0.5,1,1,ACCAGTACACAGATCAGAGT,0,432259
acrZp,0.5,1,1,ACCACTGTAAAGAATCTTGC,0,435779
acrZp,0.5,1,1,ACCACTGATACCATCACAAT,0,429990
acrZp,0.5,1,1,ACCACTAGCTAGATCGTTAT,0,457207
acrZp,0.5,1,1,ACCACATCCCTCTACAGTCA,0,451771
acrZp,0.5,1,1,ACCAATCGGGGTTGAGGAGA,0,419371
acrZp,0.5,1,1,ACCAATCCACCATTCGTTTT,0,446243
acrZp,0.5,1,1,ACCAAGAGATACGTTAACGA,0,418924
acrZp,0.5,1,1,ACATTTATGGTGGCCGTGTT,0,412045
acrZp,0.5,1,1,ACATTGAGACAAGAATCGTA,0,440222
acrZp,0.5,1,1,ACATTACTTGGGCATCCCTT,0,414412
acrZp,0.5,1,1,ACATTACTGTCCAGCCGGTT,0,422220
acrZp,0.5,1,1,ACATGTCATTTCACTTCTGC,0,431576
acrZp,0.5,1,1,ACATGGAATCGCTGGGTCTA,0,445132
acrZp,0.5,1,1,ACATACGATTACGATCCGGC,0,441992
acrZp,0.5,1,1,ACAGGTTGGAATGTTTCTAG,0,448526
acrZp,0.5,1,1,ACAGGGGCCGGGCAAACGCG,0,454294
acrZp,0.5,1,1,ACAGGCCTGGCCAGCACTGG,0,449491
acrZp,0.5,1,1,ACAGGAAAGTTTCGATGAGG,0,440161
acrZp,0.5,1,1,ACAGCCGGTAGCCGGTTACA,0,454906
acrZp,0.5,1,1,ACAGACCGGGTTCGGTGTTG,0,421680
acrZp,0.5,1,1,ACAGACCAAAGGCATGCCGC,0,462087
acrZp,0.5,1,1,ACACTTCCAAGGTTCAACGC,0,414454
acrZp,0.5,1,1,ACACTTCAGGGCTGTCCTTC,0,455549
acrZp,0.5,1,1,ACACGGCAGAGGTATTTTTA,0,432712
acrZp,0.5,1,1,ACACCGTCGCATAGGATCAT,0,417901
acrZp,0.5,1,1,ACAATTCAAACTGGCTCATG,0,417993
acrZp,0.5,1,1,ACAATATGCGGGATGTGAAG,0,450830
acrZp,0.5,1,1,ACAAGTGTAGCCGACGGTTT,0,425498
acrZp,0.5,1,1,ACAACTTGACAAAGCCTCTG,0,443281
acrZp,0.5,1,1,ACAACAGTCTTTGGTCCTGA,0,457475
acrZp,0.5,1,1,ACAAAGGCGTTTCACGCTAG,0,456544
acrZp,0.5,1,1,ACAAACTAAAGGGTAATTTC,0,442000
acrZp,0.5,1,1,ACAAAAGGTTGGATCGCTTT,0,409611
acrZp,0.5,1,1,AATTTCGAGTGCAAACTTTT,0,439387
acrZp,0.5,1,1,AATTTACCCTACGTGAGGGT,0,414904
acrZp,0.5,1,1,AATTGATCCTTGCAGTCTCT,0,453983
acrZp,0.5,1,1,AATTCGAGCGCTTGCATGGG,0,451741
acrZp,0.5,1,1,AATTAACTTACACTTTCGGT,0,410065
acrZp,0.5,1,1,AATGGTAACCGTTAGCCCCA,0,421424
acrZp,0.5,1,1,AATGGCGTCCGCGATACCTA,0,437960
acrZp,0.5,1,1,AATGCAAGCCGTGCTGGTGT,0,457297
acrZp,0.5,1,1,AATGAAAGCTACACCAAGGT,0,412456
acrZp,0.5,1,1,AATCTTCGTCCTCTGAAGGT,0,458282
acrZp,0.5,1,1,AATCTCGTTATCAACCCATA,0,449508
acrZp,0.5,1,1,AATCCGGCGTGGCTGATCGT,0,414206
acrZp,0.5,1,1,AATCAAGAAAGGTCTACTAT,0,429674
acrZp,0.5,1,1,AATCAACAGCAGACGGGTGC,0,426230
acrZp,0.5,1,1,AATATCCCCTTGCATAAACT,0,426399
acrZp,0.5,1,1,AATAGTGACCCTCTTAAAGC,0,423129
acrZp,0.5,1,1,AATACTAACTGCGAGTGAGA,0,453525
acrZp,0.5,1,1,AATACAAAGTTCGCTATGGA,0,429917
acrZp,0.5,1,1,AATAAGGTAAACACAAGAAA,0,461990
acrZp,0.5,1,1,AATAACCGACATAGCGAAGG,0,449413
acrZp,0.5,1,1,AAGTTGTTGAAGCCTACACC,0,430033
acrZp,0.5,1,1,AAGTTAATTACACTACGCAA,0,428911
acrZp,0.5,1,1,AAGTGGTGCCCATGTTAACA,0,458226
acrZp,0.5,1,1,AAGTGGGATCAGTAGCGGTC,0,419950
acrZp,0.5,1,1,AAGTAGAATGCTTGTATCGA,0,408822
acrZp,0.5,1,1,AAGTACAGGATGGGATCTAT,0,447509
acrZp,0.5,1,1,AAGTAATGCTAGTAGGGTGT,0,458047
acrZp,0.5,1,1,AAGGTCTGTTTGCGGACGAT,0,421092
acrZp,0.5,1,1,AAGGTACCCGCCATCTTGTG,0,438819
acrZp,0.5,1,1,AAGGCGGGGGGCGGCTCCCG,0,439465
acrZp,0.5,1,1,AAGGCGCTTATCTCCTAAAT,0,417230
acrZp,0.5,1,1,AAGGCGATTAAAGAAACTCA,0,463042
acrZp,0.5,1,1,AAGGCAGGCACCTTACCCTG,0,446718
acrZp,0.5,1,1,AAGGCACTTCGGTGTAATAA,0,418910
acrZp,0.5,1,1,AAGGATTTGACCGCAGTTGA,0,442115
acrZp,0.5,1,1,AAGGAGGAGCAAGAAACAAA,0,421389
acrZp,0.5,1,1,AAGGAACGACTTCAGAAGGT,0,445191
acrZp,0.5,1,1,AAGCTTCTTCTAAATACTCT,0,442027
acrZp,0.5,1,1,AAGCGTCTATCCATGGCCAA,0,447283
acrZp,0.5,1,1,AAGCGGTCCTAAAAGCCCTA,0,435264
acrZp,0.5,1,1,AAGCGGGGATTGGAAGTCTG,0,423908
acrZp,0.5,1,1,AAGCGAGATCATAGTCTGAT,0,442311
acrZp,0.5,1,1,AAGCCCGCATCCGAAGACAT,0,461569
acrZp,0.5,1,1,AAGCAATGGCATGGTTATTA,0,427540
acrZp,0.5,1,1,AAGATTTTACATAACCACAA,0,438055
acrZp,0.5,1,1,AAGATTTAGCGGCGGTGATA,0,445192
acrZp,0.5,1,1,AAGACTCTGGTTTAGTCGTT,0,427280
acrZp,0.5,1,1,AAGACGCAAGAGATCCCGTC,0,449402
acrZp,0.5,1,1,AAGACGACGTGATATATTTA,0,457260
acrZp,0.5,1,1,AAGAAGTTGTAAAGACGGTC,0,451754
acrZp,0.5,1,1,AAGAACCTAGGACCATGATC,0,439139
acrZp,0.5,1,1,AACTTTTACTTGGATTCTTA,0,419859
acrZp,0.5,1,1,AACTTTGGGCGTGGTAGTTT,0,464449
acrZp,0.5,1,1,AACTTAGGCGTCATAACATT,0,411582
acrZp,0.5,1,1,AACTGTTTACACATTGCATT,0,466881
acrZp,0.5,1,1,AACTGGGCGTACTTAGTTAT,0,428623
acrZp,0.5,1,1,AACTGCTCTTTAAAAACTAT,0,414425
acrZp,0.5,1,1,AACTGCCTTGAAAAAGTGCA,0,455725
acrZp,0.5,1,1,AACTGAGAACCGCCGTTTGA,0,454436
acrZp,0.5,1,1,AACTCGGAAACAAGTTAAAT,0,416718
acrZp,0.5,1,1,AACGTTGTTTGCATGCGCAT,0,426181
acrZp,0.5,1,1,AACGTCTGGTCACTCAGGAC,0,412490
acrZp,0.5,1,1,AACGTCGGTGATATAGAGGG,0,418812
acrZp,0.5,1,1,AACGGTCACCCCGGATGGGG,0,466061
acrZp,0.5,1,1,AACGGGCACAGATACTGGAG,0,439764
acrZp,0.5,1,1,AACGCGAGCTGGGCACGAGA,0,452941
acrZp,0.5,1,1,AACGCATCGCCCTGTTACAT,0,408581
acrZp,0.5,1,1,AACGACAGGCTTACTAGCGT,0,442757
acrZp,0.5,1,1,AACCTATGTTCCGGCACATT,0,460850
acrZp,0.5,1,1,AACCGTCCCGGGTCTGTTTT,0,443892
acrZp,0.5,1,1,AACCGTAGGCAGCTCACGGT,0,452122
acrZp,0.5,1,1,AACCGGCTGTATCCGACCCT,0,459690
acrZp,0.5,1,1,AACCGAGCCGTTACGCGGAA,0,444198
acrZp,0.5,1,1,AACCCCGCTACAACCTTTGC,0,452133
acrZp,0.5,1,1,AACATCATGAATGGTCCACG,0,438067
acrZp,0.5,1,1,AACAGAGGACACACCGAGCA,0,408960
acrZp,0.5,1,1,AACAGAAAAATGCCGTCGCT,0,447964
acrZp,0.5,1,1,AACACTTTTAAGGGGTATAA,0,451314
acrZp,0.5,1,1,AACAATGGGGTTCTATGAAT,0,435759
acrZp,0.5,1,1,AACAAGGGGTTCAGTGAGTC,0,447003
acrZp,0.5,1,1,AACAACGCGGTCGCTCAGAG,0,459899
acrZp,0.5,1,1,AAATTGGTTTGCCGCATTTC,0,416767
acrZp,0.5,1,1,AAATTCACAAGTCTGCTCAG,0,414860
acrZp,0.5,1,1,AAATTATCCGAACCCGGTAC,0,427284
acrZp,0.5,1,1,AAATGGCTCCCCTTGCGTAG,0,439163
acrZp,0.5,1,1,AAATCTAAGTATTACTATTA,0,429710
acrZp,0.5,1,1,AAATACGCTATCGGGTCAAT,0,454055
acrZp,0.5,1,1,AAAGTTAAAGTTTCAGTATA,0,416811
acrZp,0.5,1,1,AAAGGTTCCTTATACCACTT,0,420223
acrZp,0.5,1,1,AAAGCCGTGAATAGTATATC,0,416208
acrZp,0.5,1,1,AAAGCACGGAGTGCAGAGAC,0,448259
acrZp,0.5,1,1,AAAGATTGAACCCAGGTGCA,0,466336
acrZp,0.5,1,1,AAACTTTCTTCCGTTCACGA,0,443922
acrZp,0.5,1,1,AAACTGTCAAGTGTTCTGTT,0,421930
acrZp,0.5,1,1,AAACGTGTTAGCCGTCGTTG,0,434667
acrZp,0.5,1,1,AAACGTGTATCTTTTCACCT,0,425954
acrZp,0.5,1,1,AAACGTGAGTAACGAGTACT,0,444375
acrZp,0.5,1,1,AAACGGGTTCAAATGACGAG,0,451859
acrZp,0.5,1,1,AAACCTCTGTGGAATCCGGT,0,410125
acrZp,0.5,1,1,AAACCAGGGCTTCTTGTTAG,0,457159
acrZp,0.5,1,1,AAACATATCAAGTGGTCCGT,0,457422
acrZp,0.5,1,1,AAACAGCTGCCAGGGTACGG,0,447047
acrZp,0.5,1,1,AAACAAATCAGTCGCAATTT,0,417778
acrZp,0.5,1,1,AAAATGCTTAATCATTAATT,0,431035
acrZp,0.5,1,1,AAAAGAGGGGCACCTATGCC,0,454477
acrZp,0.5,1,1,AAAACGAATAGGCGGTCAAT,0,434037
acrZp,0.5,1,1,AAAAAACCTTTGGGGGTTCA,0,431581
acrZp,2065.0,2064,0,TACTTTGTTCAAAGATAGAA,2064,419666
acrZp,1880.0,1879,0,TACGCGTTCTTACCGTTGGT,1879,429623
acrZp,1725.0,1724,0,GTTTAGTGAGGGCTAGGCGC,1724,430075
acrZp,1476.0,1475,0,CATTGTCCACGGAGTGAGGA,1475,456851
acrZp,1351.0,1350,0,TTGGCTTGTTGGTTGACCTA,1350,413164
acrZp,1245.0,1244,0,ACCTTGAGTCTGTAAACCCT,1244,423548
acrZp,1185.0,1184,0,TCCCTGCGACCGTCTCCACA,1184,427868
acrZp,1053.0,1052,0,TTCGGGGTTAATTTTTTTAG,1052,444305
acrZp,1027.0,1026,0,AGGTACATAGGGTCATCGTA,1026,418474
acrZp,970.0,969,0,AACTCTATTCACGATATGGA,969,413924
acrZp,876.0,875,0,CTCAATAGGGAACGATGTTA,875,458510
acrZp,833.0,832,0,CTATTCGGCAGATGGCTTTC,832,415303
acrZp,795.0,794,0,CAACATCGTGAGTTGCCGGA,794,446272
acrZp,765.0,764,0,GTCAGATCCTAATAGTACCA,764,445005
acrZp,763.0,762,0,ACATGCAATGCCGTTAGATA,762,432456
acrZp,718.0,717,0,GCAGCCCGGGTCAAGTTTGT,717,417459
acrZp,642.0,641,0,CATTAGTCTCCTTAGATACC,641,467229
acrZp,629.0,628,0,CGATAGGGGTTCCAGGCGAA,628,440300
acrZp,626.0,625,0,GTGGGCAGCCCCTTAAAATC,625,413231
acrZp,624.0,623,0,ACGCAACTCAATACGGGGTG,623,441871
acrZp,602.0,601,0,ATTGCTACGACATCTTGCAG,601,440899
acrZp,601.0,600,0,AAACGGGCACTCCGTCTTCT,600,409103
acrZp,590.0,589,0,GAATAATGGCTACACCGTAT,589,437648
acrZp,586.0,585,0,GTGAGTAAAGAGGAGTGTCA,585,418849
acrZp,576.0,575,0,CCGGATAAGCGACCTACGAT,575,467349
acrZp,564.0,563,0,ATTCCGCTCGGCTGCTAGTG,563,418859
acrZp,554.0,553,0,GCGTGGATCGTCCGCATCTC,553,408836
acrZp,551.0,550,0,CGGTACGCGTTCTGGGTGCT,550,437078
acrZp,547.0,546,0,GATACTAATTGAGTTTTGTT,546,448109
acrZp,546.0,545,0,AGTAATATCGATACCCGAAT,545,467583
acrZp,524.0,523,0,GTCCTCCAACATAGACCTCC,523,410755
acrZp,523.0,522,0,TCCGATCTTAAGGTGTGCCA,522,446459
acrZp,520.0,519,0,ATGGTCCAATTGCTCCCGGG,519,450606
acrZp,517.0,516,0,AATCTTAGTCACTTTGCCAG,516,411221
acrZp,507.0,506,0,TTGGATGCCACGCTCCCGCC,506,431813
acrZp,504.0,503,0,TCTGGGTTTGCGGAAAAGTT,503,464055
acrZp,500.0,499,0,GTACGATGACGGTTGCGTAA,499,467359
acrZp,494.0,493,0,TTTGTGAACTATTTCCCATT,493,446456
acrZp,492.0,491,0,TAAACTACGGCTTTTCAAGT,491,445145
acrZp,491.0,490,0,GGGCGATTCAGATGGGAATA,490,439243
acrZp,490.0,489,0,GTCTGGGCAGGTTAAATCAA,489,423471
acrZp,489.0,488,0,TTGGAGATTGTAGACTGAAG,488,410238
acrZp,485.0,484,0,TGGCGCGCCCTCTTCAAATA,484,413168
acrZp,483.0,482,0,CGATGAATGTGCGAGTCAAT,482,448124
acrZp,481.0,480,0,CCCACCGATGTAGGACTGAC,480,413207
acrZp,480.0,479,0,AATAGTAGCGTGTGAAACCT,479,414170
acrZp,477.0,476,0,TATTTGGGCCATCTAATCAA,476,453356
acrZp,473.0,472,0,GCACCTTACTCCATTGGTTG,472,417435
acrZp,471.0,470,0,CATTGCCAAGTACTGAGAGA,470,414915
acrZp,470.0,469,0,ATACGATGAAAGACACTGAT,469,445134
acrZp,463.0,462,0,AATTCGTTAAAAAAGTAGGT,462,415806
acrZp,454.0,453,0,CGCCGTCGGAGTTCCCCGTG,453,439247
acrZp,453.0,452,0,TTATGCAGAGCGTTTTTCTT,452,417446
acrZp,448.0,447,0,TAAATCGTGGGAACATATCC,447,467369
acrZp,447.0,446,0,AATGTCCACCGGGCAGCCAT,446,421646
acrZp,442.0,441,0,GTGAGGGGGTTGACTCTACC,441,436875
acrZp,441.0,440,0,TAAGAGTGTGAGCTACCGGT,440,467368
acrZp,430.0,429,0,TTGAACCTCACAGCGGGTCC,429,457621
acrZp,426.0,425,0,AGTTATTGGATAAACGTTAA,425,443673
acrZp,425.0,424,0,ACGTGCTCCCAACTAGCGTT,424,437192
acrZp,423.0,422,0,TTCGAGCAATAACACGACTA,422,465171
acrZp,423.0,422,0,CAGAATTATTAAGGCAAAGG,422,413699
acrZp,423.0,422,0,AGCGCGTCGAGAGTCTGGTG,422,424507
acrZp,422.0,421,0,TGAGGTCTAGGGGATGTTAC,421,443821
acrZp,419.0,418,0,GTGTTCCGGTAGGCTCGGAT,418,458160
acrZp,419.0,418,0,ATGGGATTGTTTTGACGCGA,418,456831
acrZp,419.0,418,0,AGCCAGCGTGATCGACACCA,418,445265
acrZp,417.0,416,0,ACGAGTGATTGGTCAGTGAT,416,437779
acrZp,415.0,414,0,CATGGGCGGCGAAACCATGT,414,464543
acrZp,415.0,414,0,AATGAGAGAATGGCCCACCA,414,410799
acrZp,414.0,413,0,ACATCGTTCCGACGGGATTC,413,419865
acrZp,412.0,411,0,CCTGCCGAGACCGGGTTACA,411,458449
acrZp,408.0,407,0,TCAAACAAAACGGTGGGATA,407,432460
acrZp,407.0,406,0,TTGACTTCGTTAAAACGGGG,406,436982
acrZp,407.0,406,0,CGAGAAAGGGTACTATTGTC,406,426031
acrZp,401.0,400,0,CTATGAACTTTGAAAGGCAG,400,443124
acrZp,399.0,398,0,TGGGCACACAATGGGGAATC,398,421587
acrZp,397.0,396,0,CGAATGTTCTGGTCGAACGA,396,413428
acrZp,393.0,392,0,TGATAGGGCCACCTGATCGC,392,436249
acrZp,392.0,391,0,CTCCCGCTGTGATCGAATTT,391,421653
acrZp,389.0,388,0,CTATGGCTTGAAAGTGGTAA,388,426687
acrZp,387.0,386,0,TTCTTACTCGCGCGGTTTTA,386,436382
acrZp,386.0,385,0,TTCAATAATCTGGGGGACAT,385,435181
acrZp,386.0,385,0,TCCGAGAACGAGATCGAATA,385,452631
acrZp,386.0,385,0,TCAGTGAAGCAGAGCGCTGT,385,426552
acrZp,385.0,384,0,CTACTTGATGAGGTTTGCTC,384,448135
acrZp,381.0,380,0,TATTGATGACACCGTTGCTG,380,414216
acrZp,376.0,375,0,TTAACATCGCCCCGTTATCC,375,443418
acrZp,375.0,374,0,TCCGTCATTCAGGTATCTTT,374,458529
acrZp,375.0,374,0,CAATCGATATCGAGGCATCT,374,465902
acrZp,374.0,373,0,CGCCCAGACCCCTGCGGTCG,373,418854
acrZp,372.0,371,0,ACTAGTGCGCCGATTCGTCT,371,448986
acrZp,369.0,368,0,GAGAAGCGGATCCGCAAATA,368,462912
acrZp,367.0,366,0,CGACCAATTGCAACAGATGA,366,416899
acrZp,367.0,366,0,AACGCCTAGTCTAAGGTTGA,366,425804
acrZp,366.0,365,0,AGGTCAATTTGCCTAGTACG,365,439249
acrZp,365.0,364,0,CGGACAACACGGTGTCTCCG,364,427693
acrZp,364.0,363,0,TCTTGTTACTTACGCTTTAG,363,456753
acrZp,364.0,363,0,ACACCCGGGCCAGTTACCTT,363,444307
acrZp,363.0,362,0,TAAAGCTTGCGTTTCAACTG,362,453271
acrZp,359.0,358,0,CCTGTTTCAACTCTACTGAC,358,432650
acrZp,358.0,357,0,TGGATGCCACATAGGTCTCT,357,436090
acrZp,358.0,357,0,GTGGTTGTCTCACGCATGGA,357,433562
acrZp,358.0,357,0,CTGTTTGGTGGCGTTGCGTA,357,410821
acrZp,352.0,351,0,CAGCTGTCAATGCCCTGGGA,351,411528
acrZp,351.0,350,0,TCGGTCTAAATATCATTACT,350,409281
acrZp,345.0,344,0,CTAATGAGAGATCTGCTGTT,344,432448
acrZp,340.0,339,0,GTTCCTTGTTGTACCTACAC,339,449532
acrZp,339.0,338,0,TTGTATCGTGGCGAGTACGC,338,410847
acrZp,339.0,338,0,TGCGGCTACGTAATGGGATG,338,464053
acrZp,337.0,336,0,ATAGTCGCACTACGAGAGTA,336,464479
acrZp,336.0,335,0,GCTCGAGGAGAGTCTAACGT,335,456986
acrZp,332.0,331,0,GAGGGCAGGCTAATCGGCCT,331,420266
acrZp,331.0,330,0,AGTCTCCTCCTGTTAAATAT,330,413704
acrZp,330.0,329,0,AGATTTTTCCGTTACGTACA,329,440386
acrZp,329.0,328,0,ATTTCCCTGGCCCTTTCCTA,328,440909
acrZp,328.0,327,0,GACCAGTCCCCTACGGGGTT,327,437656
acrZp,327.0,326,0,ATCGCTAATCGCCAAATTTA,326,466717
acrZp,325.0,324,0,GTGTTATTAAAACTGGCTTA,324,411230
acrZp,323.0,322,0,AGTACTCGGGGTCCCTGTTA,322,441642
acrZp,317.0,316,0,ACGAGCACTTCGTCGGTACA,316,423575
acrZp,315.0,314,0,ATGTCCGTAAGCCATGTATT,314,448119
acrZp,312.0,311,0,TATGAGATAGATAGACCCCC,311,462161
acrZp,312.0,311,0,AGATACAGACGACTTCGCTT,311,432644
acrZp,311.0,310,0,GTAACGATGATTACTTGATC,310,439507
acrZp,310.0,309,0,GGGAGCACATTTTGTTTCTG,309,459141
acrZp,310.0,309,0,AGTTAGGATCGTGAAAGCCG,309,450104
acrZp,310.0,309,0,ACTACAGCCACTCCAGAACT,309,445888
acrZp,310.0,309,0,ACACCTGGCTGCAATTACAC,309,429614
acrZp,308.0,307,0,TTTTGTACCGCTAAGGAAAG,307,450999
acrZp,307.0,306,0,AGGGAGCACGCTGAGTGAGG,306,448117
acrZp,307.0,306,0,ACCTCTGTGGTGGGCACCAT,306,431257
acrZp,304.0,303,0,TAAAACGTGAAACGGGACAA,303,421007
acrZp,304.0,303,0,GGGGTGATAGAACTCTTCCC,303,440879
acrZp,304.0,303,0,ATATCTGCGTACGAAGCTGT,303,429420
acrZp,303.0,302,0,CCAGAGACATCGGCATTCTC,302,453542
acrZp,302.0,301,0,GTCCGGCTTTTCCTTATAAT,301,419338
acrZp,302.0,301,0,GGGGGCGGTCGTGCTTATTA,301,417534
acrZp,302.0,301,0,GAGGTCATTATACTCAGCAG,301,423553
acrZp,297.0,296,0,TCAGCAAAGTAGGGCCGGAT,296,446454
acrZp,296.0,295,0,ACTTTATAGAACAACGGTAC,295,439244
acrZp,294.0,293,0,TGCTATTTGTGATGACGGAA,293,454683
acrZp,294.0,293,0,ATGTTGACGTATGTTTATTT,293,412076
acrZp,293.0,292,0,GGGACACTAACCGCCAGATG,292,444309
acrZp,292.0,291,0,GATAGTTCCACACGGCCTAC,291,447164
acrZp,291.0,290,0,CTGACTCCTCGTCATAAAAG,290,461461
acrZp,290.0,289,0,GCCGTAATGGCCGATGGGTA,289,449911
acrZp,290.0,289,0,CTAAACCTAATTGGCTACTG,289,435473
acrZp,290.0,289,0,CGGGCTGATTTCGTTAAACT,289,452408
acrZp,289.0,288,0,TCTTGCCCAAGGGTGCTGTT,288,451871
acrZp,289.0,288,0,GACGTAACGACCTCGGCGTA,288,439240
acrZp,289.0,288,0,CCGCGGCTTGAACACGAGGG,288,418639
acrZp,289.0,288,0,AAATCCTGGTGCGCAAGGCC,288,452498
acrZp,288.0,287,0,AGCACCCGCGCGAATATGGG,287,447200
acrZp,288.0,287,0,AGAGTGCATTCTGTGGCGCG,287,440973
acrZp,287.0,286,0,GCTGTACTCTGGTACTCTAC,286,445864
acrZp,286.0,285,0,CGGTTATTGAGTGTGGTGGC,285,453270
acrZp,286.0,285,0,CGCGTAGTCCAGACTAGATT,285,461823
acrZp,284.0,283,0,GGTGGGTCAATATGATAGGC,283,437572
acrZp,284.0,283,0,CCCGGAACCATGGTCGGGTA,283,437807
acrZp,284.0,283,0,ACAGTCGTCCGAGAATAACA,283,428529
acrZp,283.0,282,0,GTCCGGTCGGAGGGTCTATG,282,432737
acrZp,283.0,282,0,CGCGGCATACCTTCTATGTA,282,434588
acrZp,283.0,282,0,CGAAGAAACGACGCGCCTCT,282,460339
acrZp,282.0,281,0,AATCCATAACTCCGGGCTTC,281,420511
acrZp,281.0,280,0,CCTGGCTACGAATTCGATCA,280,450140
acrZp,281.0,280,0,CAATAGCGGGTACACTAGAT,280,453401
acrZp,280.0,279,0,GTTCCGTAAAGTTGCCCTGT,279,442364
acrZp,280.0,279,0,GAATAGCTTCCTGATGAGGT,279,413224
acrZp,280.0,279,0,CCAGCGATGTAAAAGAGCGG,279,412295
acrZp,280.0,279,0,ATATGAAAATCGTTTAGGAG,279,462761
acrZp,279.0,278,0,GTACTCTGCTTTGCGTATAA,278,458007
acrZp,277.0,276,0,TCCACCGTTCGACGCCCTCG,276,411429
acrZp,277.0,276,0,GGTCTGGAACTTCTACTTTC,276,414927
acrZp,277.0,276,0,GCTGGATCATGGGCGTATAC,276,434331
acrZp,276.0,275,0,CTGTGGTGTGCATTTGGCCG,275,418863
acrZp,275.0,274,0,GGAGTATACGCGGTTCCGAA,274,459976
acrZp,274.0,273,0,GTTGTATTTTTAAGTGCAAC,273,425925
acrZp,274.0,273,0,GCAGGTATATGCTGTCACAC,273,431596
acrZp,273.0,272,0,GGAGACATTGGCTCCCAGGG,272,460346
acrZp,273.0,272,0,GCCGCGGGTTGGTATCCTAT,272,417509
acrZp,273.0,272,0,ATGATCTGCATCATAATGGT,272,459265
acrZp,272.0,271,0,GTCAGGCATAGGGCATCAAG,271,437085
acrZp,272.0,271,0,CCCAGCTGGGGGCGATTATG,271,416699
acrZp,271.0,270,0,CTCGACGCTAGACGGACCTC,270,453258
acrZp,269.0,268,0,GATAGGCAATAGCGATCTGG,268,438785
acrZp,269.0,268,0,CCAATCACCAGCTGTGATTT,268,460290
acrZp,268.0,267,0,GTTGTAAAGCGGACCTTATA,267,422295
acrZp,268.0,267,0,ATAAGGACTGGATTTAACCT,267,435377
acrZp,267.0,266,0,CTATTATAATGATTAACGTA,266,422250
acrZp,267.0,266,0,ATGATCACAGTCACAAAGGT,266,458715
acrZp,265.0,264,0,GGTGGCGGGACCCAGGAAAC,264,409081
acrZp,264.0,263,0,CCAGTAGCAAACATGCTATT,263,410274
acrZp,264.0,263,0,AAGGTGCCACAATTGTATAA,263,436252
acrZp,264.0,263,0,AAGAACTCTAGACTCATTTT,263,419356
acrZp,263.0,262,0,GTTACGGCCTGAAGGAACCC,262,412290
acrZp,262.0,261,0,GTCTCACCATACGTCGAGTA,261,414172
acrZp,262.0,261,0,CCCCTAATGAATTTAAGATA,261,453566
acrZp,261.0,260,0,TGACTTATTGTCTCTGTTAG,260,431472
acrZp,261.0,260,0,CGGGTGCAGGAACGGCCCCC,260,435072
acrZp,261.0,260,0,CCGTAGTGGCCAGGGTAGCC,260,436206
acrZp,261.0,260,0,AGGACACCTCGGAAAGAGTA,260,459677
acrZp,260.0,259,0,ATCTTCCTAAAAACCAACGG,259,418857
acrZp,259.0,258,0,CATTAGCAGTGATCACTCAA,258,444780
acrZp,258.0,257,0,GCCTGCGACCGAAATGTTCT,257,410428
acrZp,257.0,256,0,TTCGACAACCGTCCGAACGC,256,459798
acrZp,257.0,256,0,GTATCAGAAAGTACCACAGG,256,433524
acrZp,256.0,255,0,GCGCGCTCAAAGTTATGGAC,255,444129
acrZp,256.0,255,0,CGGGGGCTCAGGATGCCTAG,255,425312
acrZp,256.0,255,0,CGAAGTTACCAAGCTGAGTG,255,445852
acrZp,256.0,255,0,ATCTGGACAACATTTGCGTT,255,454293
acrZp,255.0,254,0,TCATACCGGGACATATGTTC,254,414360
acrZp,254.0,253,0,TGATGTCCCTGTGCCTAAGC,253,437430
acrZp,254.0,253,0,TCCGGAGAGGTCGAGAGTAG,253,458866
acrZp,254.0,253,0,CTCCGGCTAAATGTACTTAA,253,433323
acrZp,253.0,252,0,ATAATTTGAAAGGGGTGCTA,252,450404
acrZp,252.0,251,0,TCGTGGTTCACTTGGTGGTT,251,467123
acrZp,252.0,251,0,CTTTCAACTGGAAGGGACCT,251,452642
acrZp,251.0,250,0,CTAGGATCCGCGGGGTGAGC,250,417499
acrZp,251.0,250,0,CGAAATTGGGGGTTAACGGT,250,467453
acrZp,250.0,249,0,TTTTTGAGGGGCACATCGAC,249,419279
acrZp,250.0,249,0,GGTTCGATCAAGGCGATTAT,249,447507
acrZp,250.0,249,0,CTTGATGTGTCTGGATTAGG,249,447257
acrZp,250.0,249,0,CGGGAGGTTCGTGCAGCCGA,249,449633
acrZp,249.0,248,0,TGAGTTGTAATAGCACTCGA,248,445552
acrZp,249.0,248,0,GTCTAAAACTTCTTCGAGCG,248,459184
acrZp,249.0,248,0,CTGTGAACCGTGTACGACAA,248,415673
acrZp,249.0,248,0,CTCATCGGTTTTCTAGAGGA,248,421655
acrZp,249.0,248,0,ACCTTTCGCCCCGGAGAACT,248,443701
acrZp,248.0,247,0,GCAGCTCTAGAGTCCTGAGT,247,455141
acrZp,248.0,247,0,GACGTCACCTCCTTGCATTT,247,443641
acrZp,248.0,247,0,AATATGATGTCCGGAACATA,247,433145
acrZp,247.0,246,0,TTAAATGGGCGCACCGAGTG,246,429828
acrZp,247.0,246,0,TAACGAGTCCTGTAGGGTTT,246,443627
acrZp,246.0,245,0,TCCTCGAATGTATAGCGAGA,245,465084
acrZp,245.0,244,0,GGCCCACAGCGTGGTCTGTT,244,446279
acrZp,244.0,243,0,GTTCCGCGTCATCGGCGCAG,243,431459
acrZp,244.0,243,0,AGCAGCATTTAACATTACAT,243,437789
acrZp,243.0,242,0,ATGTACAGGGATACCCGGCA,242,433116
acrZp,242.0,241,0,GGGTCGTTATAGACACGTTG,241,437507
acrZp,242.0,241,0,CGGGTCAACCGTGACATCAT,241,458999
acrZp,241.0,240,0,CACTCGAGTCTACCCGATGG,240,421883
acrZp,239.0,238,0,GCCTCCACCTAAAACCAATC,238,459219
acrZp,239.0,238,0,CGGTTACTGCATCCGTCAGC,238,431760
acrZp,238.0,237,0,TTCATGCCCAGTTTCGGTGG,237,443664
acrZp,237.0,236,0,TGCTAAGGCGAAGGGCTGAC,236,413700
acrZp,237.0,236,0,GTTCCACCTCCGGAGTATCT,236,443786
acrZp,237.0,236,0,GGAGCGTAATATGTTATACT,236,412559
acrZp,236.0,235,0,AAGGTAGGATAAGTTAATTT,235,458561
acrZp,235.0,234,0,AAAAGGGGGCAATGTTAATA,234,415563
acrZp,234.0,233,0,TGGCATTGACTTATCACGAT,233,436878
acrZp,234.0,233,0,CGACCTTAGCCGGGCGATTC,233,419683
acrZp,234.0,233,0,ATGTGGGCTGACGGCTGGAT,233,417450
acrZp,231.0,230,0,TGACACGATCCACCTACGTC,230,420510
acrZp,231.0,230,0,CTCCTCGAAGGGGATTACCT,230,464477
acrZp,230.0,229,0,GGTTGCCTTGCACTCTGTAA,229,433111
acrZp,230.0,229,0,GCGGCTACCACAAATTTTAT,229,459532
acrZp,229.0,228,0,GGTCCCTGCACCGCGAATTT,228,459014
acrZp,229.0,228,0,CAAGAATACGAGGTGCCGCT,228,410014
acrZp,229.0,228,0,ACAATGGCATAGTCGAGCTT,228,426692
acrZp,228.0,227,0,GCTTAGTTTTGGGTCTAGTT,227,442342
acrZp,228.0,227,0,CCTTAACGGTTTGAAGGGAT,227,430664
acrZp,228.0,227,0,ACCCGACATGTTTTACTACA,227,413975
acrZp,226.0,225,0,TGGTATGCGGAACTACGACG,225,447226
acrZp,225.0,224,0,TCTCAATTGCTCACAAGGAA,224,448982
acrZp,224.0,223,0,GGCACACGTTAATATCGAGT,223,449536
acrZp,224.0,223,0,CGGTGGGCCGACGGTCTAAA,223,458543
acrZp,224.0,223,0,CAATTGATAAATCTTACACA,223,429643
acrZp,223.0,222,0,AACCTTTCGTGCAATACTAT,222,420460
acrZp,222.0,221,0,AACGCGAACACCCCGTACAC,221,433044
acrZp,221.0,220,0,GCCGCGCTGGTTAGGCGGAG,220,427843
acrZp,221.0,220,0,ATATTCTGTATGCACTGACG,220,453591
acrZp,220.0,219,0,GTCGTACACCAGGCTGCACG,219,422662
acrZp,220.0,219,0,GCTGTGAATGTTGGCCGAAG,219,417242
acrZp,219.0,218,0,TCATAAGTAAATACGGTCCT,218,459550
acrZp,218.0,217,0,AAGCGCGCGTCACTCAGTAT,217,423554
acrZp,217.0,216,0,CCCCCGCCGAGTCGTAGTAA,216,425330
acrZp,216.0,215,0,GACCGATCGTACTCGTGTCC,215,453285
acrZp,216.0,215,0,CCCGTACAATGGCATCGCGT,215,413724
acrZp,215.0,214,0,GGGGTCCGCTGGTCTAAGGG,214,454220
acrZp,215.0,214,0,CTTAACAAGGCTGAATGGAC,214,424966
acrZp,215.0,214,0,CAGGACTACCCGTTTGACAT,214,447878
acrZp,212.0,211,0,AAGCACGGTAACCTTTAGCT,211,449538
acrZp,210.0,209,0,TACGCCGGCAAACAAGCCCC,209,444796
acrZp,210.0,209,0,CTGATCGACCGGCCCTTTAA,209,409850
acrZp,210.0,209,0,CGTCCAGAATATGTTAGATG,209,424786
acrZp,210.0,209,0,CGAAAGTGAGTCGTCATACA,209,458996
acrZp,209.0,208,0,GTACAAATATAGAAGTTGGA,208,414359
acrZp,208.0,207,0,ATTGGCTCGGACTCGGAATG,207,431809
acrZp,207.0,206,0,ATCCAGCGTCTTACCCCCTT,206,452547
acrZp,206.0,205,0,TATCCAGTCTGTAGGCGTTT,205,467563
acrZp,206.0,205,0,ACGAATGAGGATGCCAATCA,205,419318
acrZp,205.0,204,0,TGTCCGCTTTCTCCGCTCGT,204,461653
acrZp,205.0,204,0,CGGACGCTAGCTCAGATTAT,204,456912
acrZp,205.0,204,0,CCAGGCCAATTTTTTCTGCA,204,417467
acrZp,204.0,203,0,CGAGGATGAGGGCGTTATTA,203,440985
acrZp,204.0,203,0,ATTTTCGTGTCGCCATGTCT,203,447897
acrZp,202.0,201,0,AATTGCTTACGCATGGTTTA,201,450601
acrZp,201.0,200,0,GGTGGAAGTGGTCGTATCAA,200,457995
acrZp,201.0,200,0,CCCCGGGAACGTCCGTTACA,200,464057
acrZp,201.0,200,0,CCCATGCTTTTGTGGACGTA,200,410513
acrZp,201.0,200,0,AAAGGTAACTAACATTAGCC,200,423441
acrZp,200.0,199,0,GACCTATAAGATTTCTTGGA,199,447824
acrZp,199.0,198,0,TTAGACGCCCCGGGTCACAG,198,430065
acrZp,199.0,198,0,GGCACACTCTGTAACATCTT,198,409513
acrZp,198.0,197,0,AGGTATAACGCAAAACCGGC,197,415686
acrZp,196.0,195,0,CACTGGTTCACTGGACTATT,195,434643
acrZp,194.0,193,0,TGGTTACTGGTTGTAGAATC,193,437654
acrZp,194.0,193,0,TATATGTTCACTCCAGGTCA,193,443788
acrZp,193.0,192,0,ATGGTATCAGTGGACCCCTA,192,437185
acrZp,191.0,190,0,CAGCTGACCCCTCGGGGACT,190,417841
acrZp,190.0,189,0,TACGTCCATAATAATCTACG,189,440576
acrZp,190.0,189,0,GGAACCCGGGGGTCAGGCGG,189,451558
acrZp,189.0,188,0,TTGTGTATCCACTTTGCATA,188,415860
acrZp,189.0,188,0,GGACTACGGGTCGGTAAATA,188,458874
acrZp,189.0,188,0,CATTAATCCCGCTTCAAGCA,188,429077
acrZp,189.0,188,0,ATCGCGAGATCTATACAAAG,188,449639
acrZp,188.0,187,0,GTTCCCTCTTGTGGTACGAG,187,442335
acrZp,187.0,186,0,TAGTTGCAGCTGCGTCTGAC,186,414710
acrZp,187.0,186,0,CATTTCCGCAGTGCTACCAG,186,433160
acrZp,186.0,185,0,CGTGTAGGGATCATTACGAT,185,447194
acrZp,185.0,184,0,GGGCAGTAACGACTTAGTAC,184,440200
acrZp,184.0,183,0,TCTTGCAAGTTAGAACCATC,183,461084
acrZp,184.0,183,0,CGATCGCAGTTTAACGGATT,183,431580
acrZp,182.0,181,0,CGGGTTACCTTGTTAAGTTC,181,434822
acrZp,182.0,181,0,AGGGAGATATCGGTAATGCC,181,458667
acrZp,182.0,181,0,ACCGTATCCCAATTCTCTCT,181,432161
acrZp,182.0,181,0,ACAGGAAGAGTATACCTAGG,181,460421
acrZp,181.0,180,0,ATCGGGCTTCGCCTCACAAA,180,412079
acrZp,180.0,179,0,TCCCCAGTCGGACTAAGTAT,179,449527
acrZp,180.0,179,0,GGTGGTTAAGATCCCAAAGG,179,415586
acrZp,180.0,179,0,CCCTCCCCCCTTACTGGTTC,179,418200
acrZp,180.0,179,0,CAGTACGTCTTTTTGCTGCT,179,461017
acrZp,178.0,177,0,TCGGATCGTTGGCAGTTATG,177,443692
acrZp,178.0,177,0,GTTGAGGGTAGACAAACGCA,177,432648
acrZp,178.0,177,0,AAAGGAGGGGTGAATGCGGT,177,465800
acrZp,177.0,176,0,TTTCTAAATCAGATCTAACC,176,416498
acrZp,177.0,176,0,GATGCGGAGCGAGTTGCTTA,176,460748
acrZp,176.0,175,0,GCGCGGGAATACCAGAAGAG,175,448120
acrZp,176.0,175,0,CAGGTCTTAATATTTTACTT,175,448234
acrZp,176.0,175,0,AGCAGCATGCCGGTTTTTAG,175,467334
acrZp,175.0,174,0,GATCGCACGGTATCAAGGAT,174,446332
acrZp,175.0,174,0,CGTTATAAAAACTTAGAGCT,174,433251
acrZp,175.0,174,0,CGGCCTTGATACGGGTTTCC,174,411159
acrZp,175.0,174,0,CGCTCCGGCAATGCGACGTA,174,465071
acrZp,175.0,174,0,ACGACGACCTTCCATAGACT,174,433374
acrZp,174.0,173,0,TTCCGAATGTGTTTCACCAG,173,417038
acrZp,174.0,173,0,TCGTTATGGGTGCACGCCCT,173,417925
acrZp,174.0,173,0,GTCAATGTGGACAAGGATCG,173,420003
acrZp,174.0,173,0,GTAAATCGCATCAACCACTT,173,416686
acrZp,174.0,173,0,CTTCATTGCTGCAACTCGTA,173,451560
acrZp,173.0,172,0,GGCGTCATCAGAAAGTTCGG,172,429626
acrZp,173.0,172,0,CTAGTGCGCCCGATCCCTCA,172,465176
acrZp,173.0,172,0,ACCCAATCCTGCTAAATGTG,172,457856
acrZp,173.0,172,0,AAAGGCAGGGGTCGTCCATT,172,415206
acrZp,172.0,171,0,ACGCGACCGAAAACAAGTTA,171,443678
acrZp,172.0,171,0,AAACTTTTACAAGCAGCCCG,171,424767
acrZp,171.0,170,0,TGCGTTCTGTTACCAATAAG,170,432628
acrZp,171.0,170,0,GGCGGTTCGTCGTGGAGGGC,170,414724
acrZp,170.0,169,0,GTGAGTCAGTCCATGTAGTC,169,439498
acrZp,170.0,169,0,AGTCCCGATACAGACGATAC,169,437076
acrZp,170.0,169,0,ACTTCGGGACGTTGTTATCC,169,437182
acrZp,170.0,169,0,ACTTCAGAGGGAGGGGCGAC,169,429437
acrZp,169.0,168,0,TGAAAACTAGCGTAAAGTCA,168,415791
acrZp,169.0,168,0,GTATGGCGTGAGAATCACCA,168,460719
acrZp,169.0,168,0,GAAGGGCAAGAAAGCGCGTA,168,456902
acrZp,169.0,168,0,CGGCATAACAGGCTGTATTG,168,462342
acrZp,169.0,168,0,AGGGGTCAGAGGTTTATAGT,168,430369
acrZp,169.0,168,0,ACGTTAGGTCCTCAGCCGAG,168,413183
acrZp,168.0,167,0,TCGGCCGAGGTCCCGTGTAG,167,410572
acrZp,168.0,167,0,GGCATCCACAGGAGCGTATC,167,433273
acrZp,168.0,167,0,GCGCGGTAAGCAGGCCCGTG,167,459604
acrZp,168.0,167,0,ATGGCCCCGAGCCTGACATC,167,424366
acrZp,168.0,167,0,AGAGTGGTACAAAAGATAGC,167,437516
acrZp,167.0,166,0,TTCATCACTTCGTACCAACT,166,424183
acrZp,167.0,166,0,TTACACAGGAGTCAAGGGTC,166,452574
acrZp,167.0,166,0,CGTCATAGGAATATCCGGAC,166,448075
acrZp,167.0,166,0,CGAGAATATGCTGCGTAGAG,166,419120
acrZp,167.0,166,0,AAGGGCACAGGCTGTACGTG,166,457467
acrZp,166.0,165,0,GCACTTCGGGATTGGTGTAC,165,463729
acrZp,166.0,165,0,CCGGGGTGTTAATTCATCAC,165,439281
acrZp,166.0,165,0,CCGGCGAGGTACAGGTGTTA,165,429840
acrZp,166.0,165,0,ATGCCGTGTGTACAGTGTAG,165,427123
acrZp,165.0,164,0,GGGTCTGCCTGCGACCGCGT,164,439257
acrZp,165.0,164,0,CTGACAAATTCCCTAGGGTC,164,464660
acrZp,165.0,164,0,CATTATACTGATGGGGGACA,164,435555
acrZp,165.0,164,0,CATGCTTGTCCCCGGATAAC,164,444676
acrZp,165.0,164,0,AGACGGTTGCTGTGTTCTAA,164,456911
acrZp,165.0,164,0,ACATCAAGGGCCATCTTGTC,164,432678
acrZp,164.0,163,0,TCAGCCACGAGGGTTGACCT,163,416778
acrZp,163.0,162,0,AGAGTGCAGCGATTAGAATG,162,435406
acrZp,163.0,162,0,ACATTGTTCCCTTAGCCAAT,162,425015
acrZp,163.0,162,0,AACTTTTCATACCACCGGAA,162,421741
acrZp,163.0,162,0,AAACGGGTTCTGGAGCACCG,162,423699
acrZp,162.0,161,0,TGCTGTGTGGAGTATGGCCA,161,456735
acrZp,162.0,161,0,TCTGTTAACGTAGACGGGTC,161,409323
acrZp,162.0,161,0,GTAGCTACGGCTCAGCTATA,161,415323
acrZp,162.0,161,0,CTTACCAACCGGAGCTTCGT,161,411121
acrZp,161.0,160,0,TCACTACGAAGCCGGTTTGG,160,411096
acrZp,161.0,160,0,TATCACAGTCATGGGCGACG,160,443790
acrZp,161.0,160,0,GAATACGGCATTCTTAAAGT,160,420037
acrZp,161.0,160,0,CGTTCTTCTCGCTTTCAGGA,160,453793
acrZp,161.0,160,0,CGAAATCGTGATTCACAGAC,160,417562
acrZp,161.0,160,0,ATGGTCTTCTAAATGCAATG,160,414370
acrZp,161.0,160,0,AGGCCTCTCGCCAAGGTTTG,160,459425
acrZp,161.0,160,0,ACTCCCGAAGGACGTACTTG,160,424301
acrZp,160.0,159,0,TTCCATTTAACGCGGCGAAG,159,409101
acrZp,160.0,159,0,TTACGACGCGCAGTACAGGA,159,430147
acrZp,160.0,159,0,TATGAGAGTACGGCTCGCGC,159,449913
acrZp,160.0,159,0,TACGCTACTCGCACACGTGT,159,433656
acrZp,160.0,159,0,CCTACGAGCACGAGTCGAGT,159,453231
acrZp,160.0,159,0,CCGGGTTTTTTCACCGCAGG,159,444986
acrZp,160.0,159,0,CAGTTCGATGCTTTGGCTGA,159,437175
acrZp,160.0,159,0,ATGCAGGGAATTTGTTCGGG,159,445721
acrZp,159.0,158,0,TTTTGGACAGACCGTGCGGA,158,466302
acrZp,159.0,158,0,TAGCAGGTGGAGGATACATT,158,458273
acrZp,159.0,158,0,GTTTGCAGACGTGGTCACAG,158,454768
acrZp,159.0,158,0,GTTCTCGCTGTCTGACATCT,158,447866
acrZp,159.0,158,0,GCTTCTCCCCACAGGGGGAC,158,463298
acrZp,159.0,158,0,CGTAAGCGTCCTCCCATGAT,158,451784
acrZp,159.0,158,0,AGTGACGTCTAACGGTTCCA,158,460097
acrZp,159.0,158,0,AGCGGTCCAGTTCGTCAGGT,158,460293
acrZp,159.0,158,0,AGCCGGCACCATTTGTGAGC,158,452486
acrZp,159.0,158,0,AGACTCAGGATTATCCAGTT,158,458157
acrZp,158.0,157,0,TTCCAATCCTCCACAGGGAG,157,429733
acrZp,158.0,157,0,GGTATACCCGCAGCAACATG,157,442432
acrZp,158.0,157,0,GACGATGGAGTATTTCTACA,157,415756
acrZp,158.0,157,0,CTGGCTGCACTCGGTATCAC,157,426034
acrZp,158.0,157,0,CGCAAGCAGGTTTCAAAGTC,157,453526
acrZp,158.0,157,0,ATTGCGAGCAGCGTCCCAAA,157,443621
acrZp,158.0,157,0,AATCCGCTATCTTCGGTCGT,157,422315
acrZp,157.0,156,0,TTTTAGTCTTGATCCGCAGA,156,411846
acrZp,157.0,156,0,TCGCAGATTGTAAGAGCCTC,156,464406
acrZp,157.0,156,0,GTTCTGGGTGCGGTCAATGG,156,427842
acrZp,157.0,156,0,GGTTGGGCGTTAATCACTGT,156,436469
acrZp,157.0,156,0,GGCTTAAGTGGAGCGTTTGA,156,409694
acrZp,157.0,156,0,GATTGTGGATGCGGCCGGAG,156,437934
acrZp,157.0,156,0,CTATGGATGCACTAGACATT,156,412115
acrZp,157.0,156,0,CAAAAGTCCTTGGGATAAGG,156,425386
acrZp,157.0,156,0,ATCCTGAAAGGAGCGCCGTT,156,410419
acrZp,157.0,156,0,ACCGCTGTTTAATCCCCCCA,156,438977
acrZp,156.0,155,0,TTGAGCCGCCGTCGTGCCGA,155,426389
acrZp,156.0,155,0,TTATAGGGTAACCTACAACG,155,463854
acrZp,156.0,155,0,TGCAACGAGTCGAACACTGG,155,408812
acrZp,156.0,155,0,GCCGGTTATGTAATGTCAAA,155,422415
acrZp,156.0,155,0,CGGACCCTATTGATCAGTAA,155,431960
acrZp,156.0,155,0,CGAAGCTGTCCTACTCGTCT,155,460936
acrZp,156.0,155,0,CAGTCACTAAAGCTTTGTTG,155,427144
acrZp,156.0,155,0,CAGAGCACCTCCATCGCCGT,155,417859
acrZp,156.0,155,0,ATAAGCCTGGCACGGCATAT,155,413109
acrZp,156.0,155,0,AGCTTTATGTCTTCTGGGCT,155,460618
acrZp,156.0,155,0,AACGGCCTTCGTAGTGTTTA,155,440089
acrZp,155.0,154,0,TCCCGTTCCCTCTGTCCTCA,154,417462
acrZp,155.0,154,0,TAGACGCCTCGGATTACGAA,154,465701
acrZp,155.0,154,0,GGGCTCGGCGGGGAACGCCT,154,433554
acrZp,155.0,154,0,CTTTTAGCTACTTCGATCCT,154,436091
acrZp,155.0,154,0,ATTGAAGGAGGGGCTGCACT,154,425013
acrZp,155.0,154,0,AGCCGCATAGTTGTAAGGTA,154,429063
acrZp,155.0,154,0,ACACATAATTACGGGCGGTA,154,430163
acrZp,154.0,153,0,TTTATCGCGATGGCGTGGGC,153,459502
acrZp,154.0,153,0,TTGTCACGTTTTGCTTATGC,153,444264
acrZp,154.0,153,0,TTGCACACAGTCACGTTAAG,153,458518
acrZp,154.0,153,0,TTCATTAGTGTTGGAAAAAA,153,452794
acrZp,154.0,153,0,GTGACCTCAGTTCCTTCAAT,153,437009
acrZp,154.0,153,0,GCGATAGCTAGCAAATAGGG,153,455186
acrZp,154.0,153,0,GATGGTCTGGAAACAAATGG,153,409018
acrZp,154.0,153,0,AGCTCTGGTCCGTTCATACC,153,420331
acrZp,154.0,153,0,ACCTATTGGCGCCCTAAATT,153,410258
acrZp,153.0,152,0,TTTTTGGGCTAGTACATTGT,152,427086
acrZp,153.0,152,0,GGTAAGGGGGTCCTGTCCCG,152,464836
acrZp,153.0,152,0,CACCGATCTGGCATCTCAAC,152,436277
acrZp,153.0,152,0,ACCTGAACAGGGCAGTAGCA,152,453845
acrZp,153.0,152,0,AAGCTCTTTCGGGCAGTATT,152,417433
acrZp,153.0,152,0,AAACCTTTGAAGTTCAATGA,152,422296
acrZp,152.0,151,0,TTCAAGACCAAGGATGCCTA,151,410218
acrZp,152.0,151,0,TAGGACAGTCTTACACTGGA,151,434191
acrZp,152.0,151,0,TAACGGCCCACGAGGAACTT,151,455419
acrZp,152.0,151,0,GTTCGATAGCAGCGCTATCT,151,459944
acrZp,152.0,151,0,GTGGAAGACGGCCCACGGAC,151,424253
acrZp,152.0,151,0,GAGATTCAAGCTTATCTAAC,151,425674
acrZp,152.0,151,0,GACCGGAAGGCTTGTTATGG,151,440875
acrZp,152.0,151,0,CGGTCGAGAGCTGGGTAGCA,151,422390
acrZp,152.0,151,0,CGGGCGAGCACGGTCGCATA,151,444378
acrZp,152.0,151,0,ATTCGAGTTGACCCCGGCTA,151,447002
acrZp,152.0,151,0,ATGTAAATGATCCTCTGATC,151,439267
acrZp,152.0,151,0,ATGGAACGCAAGATTGTTTT,151,436081
acrZp,152.0,151,0,ATCTTGGGCGCCCGCGGCCT,151,441199
acrZp,152.0,151,0,AGACTCCAAGACGTCAATGT,151,432152
acrZp,152.0,151,0,AAGGGCATTAAGTTCGCAAG,151,409092
acrZp,151.0,150,0,TTATCAAGTTCAAAAACCAA,150,460205
acrZp,151.0,150,0,TTACATCCCTGTACGCCGAT,150,431065
acrZp,151.0,150,0,TCCATGCACGGCGGTTAGGT,150,410054
acrZp,151.0,150,0,TCCACGATCGTCTTACCGCT,150,450619
acrZp,151.0,150,0,TATGAGATTAGGTTTTTAGA,150,410355
acrZp,151.0,150,0,GTCTGCAAATACTAAGCCTT,150,414905
acrZp,151.0,150,0,GTCCGGGACCAGCGTCGGTA,150,431260
acrZp,151.0,150,0,GAATTTCTGGCGTCGGTGAC,150,409287
acrZp,151.0,150,0,CTACACGCACATGGTCCCGA,150,434715
acrZp,151.0,150,0,CGGCAAGTAGACATTGCATA,150,425012
acrZp,151.0,150,0,ATTTGGTAAGGGCAGAAGAC,150,410061
acrZp,151.0,150,0,AGTGCGAGTTAGAATAGGTC,150,417388
acrZp,151.0,150,0,AGTCTGAGCAGCCAGGTTTC,150,462121
acrZp,151.0,150,0,AGTAAAGGGCAGGTGTTCTG,150,416610
acrZp,151.0,150,0,ACCTGCGTGAGGGATATCAA,150,417969
acrZp,151.0,150,0,AAGCGTCCCTTCTGGCGGCA,150,436449
acrZp,151.0,150,0,AACATTTATGGCGGGCTTCA,150,438794
acrZp,150.0,149,0,TCGCTGTTCTGCCATTCGCA,149,417613
acrZp,150.0,149,0,TAGGATAGACTATGGAGTGT,149,436319
acrZp,150.0,149,0,GTGGGGCGGCTAGTCATCTA,149,464927
acrZp,150.0,149,0,CCGGACCTTTTCTATGACGA,149,413209
acrZp,150.0,149,0,CCCTCACAGCCCGCTCCTGG,149,461440
acrZp,150.0,149,0,CCCCCTGTTATTCGCAAAAT,149,433514
acrZp,150.0,149,0,AAGGGCTTTAGAAAGAACAG,149,454573
acrZp,149.0,148,0,TGCATTGATCGCACTGAAAG,148,455389
acrZp,149.0,148,0,TACGGGGCAGCTGAGATTCT,148,448800
acrZp,149.0,148,0,TAACAGTTGAGTTAGATGGT,148,411433
acrZp,149.0,148,0,CCTCGATTTTCCCCAGACAC,148,412884
acrZp,149.0,148,0,CCAACACCACATTGCGACGT,148,463047
acrZp,149.0,148,0,CACTAGCCATGGTTACGGTG,148,442142
acrZp,148.0,147,0,TCATCAATAGCAGTAATCGC,147,440946
acrZp,148.0,147,0,GCACTTGCACCGAATTAAGG,147,457861
acrZp,148.0,147,0,GAATAGGGTGAGCAGATAGC,147,451431
acrZp,148.0,147,0,CCGCTCCCTGAAAGCGGCCA,147,441182
acrZp,148.0,147,0,CCAAGCTTCGCCGTAGTCAT,147,429277
acrZp,148.0,147,0,ATGCTGTGACGATCAGTCGC,147,455386
acrZp,148.0,147,0,ATACAAAGGTTTTACAAGGC,147,427327
acrZp,147.0,146,0,TTGTCGTTCCCTCATTCGGC,146,424385
acrZp,147.0,146,0,TTCGCAGTGTCTGCCCGGCA,146,417127
acrZp,147.0,146,0,TGTCCTCTTGCTCGGAGCTA,146,414361
acrZp,147.0,146,0,TAACCTGTCACATCGGGGTC,146,465189
acrZp,147.0,146,0,GTCGGTCTTTCGGGTCGAAG,146,435832
acrZp,147.0,146,0,GCTTAGCCACCTTCAGGGAC,146,453103
acrZp,147.0,146,0,CTTTGTAATAATACAGACAC,146,414911
acrZp,147.0,146,0,CTCCCACACGACGGTCATTC,146,448168
acrZp,147.0,146,0,CCGGCTCCTCATCTAGCGCA,146,429090
acrZp,147.0,146,0,AGCGGGAAGGAGTGCAACAC,146,410437
acrZp,147.0,146,0,ACTCTGAAGATTTAGCACCC,146,409276
acrZp,147.0,146,0,ACATTCTGACATCATGAACG,146,439535
acrZp,147.0,146,0,AATGACTCGGTCTTTTTAAT,146,451248
acrZp,147.0,146,0,AACTGGTTGTCGAAGGCCCG,146,459288
acrZp,146.0,145,0,TTTACTATAAGCGACGCCGT,145,450346
acrZp,146.0,145,0,TAAAGCGCAAACCAAGCGTA,145,436984
acrZp,146.0,145,0,GCTCGTCGTTCAAAATAATA,145,457904
acrZp,146.0,145,0,GCTCAACAACAGGGCCGGCG,145,447895
acrZp,146.0,145,0,GAAAAGTTGGGGAGGCAGGG,145,408761
acrZp,146.0,145,0,CTTGCCGGGGAAACTTGGCT,145,409099
acrZp,146.0,145,0,CCCATGGTCGGGCGAATCGT,145,420476
acrZp,146.0,145,0,CATCCGGGACTCAATCACAT,145,416663
acrZp,146.0,145,0,AGGATCGCGCGCGGTTGAAG,145,452096
acrZp,146.0,145,0,ACAACTCTCTTGTACTAAAC,145,454186
acrZp,146.0,145,0,AAGACATAGTTTAATCTGTA,145,423027
acrZp,146.0,145,0,AACATCGCTCACAGACAATC,145,465470
acrZp,146.0,145,0,AAATCAAGGTTGACAACCAG,145,440928
acrZp,145.0,144,0,TATGACTCTCGGTACGTGGA,144,415792
acrZp,145.0,144,0,GTCGCACGCAAACCAGAAGG,144,454000
acrZp,145.0,144,0,GTCATCCCGCGTTGGAATCT,144,456832
acrZp,145.0,144,0,GGAATCCGGCCGGTGATGTA,144,461449
acrZp,145.0,144,0,GAAGTTAGTGTCACATCAGC,144,409164
acrZp,145.0,144,0,GAAGTTAGTAATTGGGATCA,144,424491
acrZp,145.0,144,0,CTGATGAGAGGACTTTACAT,144,415151
acrZp,145.0,144,0,CGAATCTTTGGCAGCTTCCT,144,447967
acrZp,145.0,144,0,CCGACTTGCGCTACCGTGAG,144,460083
acrZp,145.0,144,0,CATAACGACTATGTATGTGT,144,410553
acrZp,145.0,144,0,CAGGGGTTACACGACACCCA,144,442513
acrZp,145.0,144,0,CACTACACTTGTAGGGATGG,144,460487
acrZp,145.0,144,0,CACGCATCGGCATACGCGCA,144,462841
acrZp,145.0,144,0,ATAGACCAGCAAGTAAGATA,144,451268
acrZp,145.0,144,0,AGGTTGAATGGTTAGGACAC,144,448956
acrZp,145.0,144,0,ACCGCGACTTCCCAGGTGTG,144,452056
acrZp,145.0,144,0,AAGCACTGGTGATTGCGAAC,144,421787
acrZp,145.0,144,0,AAAAATAGCCGACGTACTTC,144,410284
acrZp,144.0,143,0,TTTACGTACCTGTTGGATCT,143,446563
acrZp,144.0,143,0,TTCCTTTAGGTGGTGAGAGA,143,421641
acrZp,144.0,143,0,TGGGTCCCATCGCCATCATA,143,411372
acrZp,144.0,143,0,TACCACGCACTAATAGGTAT,143,449631
acrZp,144.0,143,0,GCCTGCGCACGCGTAAATAT,143,413740
acrZp,144.0,143,0,CTAATTGCATCTTCAATAAA,143,426597
acrZp,144.0,143,0,CGTTCACCACTGTCCTAGCA,143,424780
acrZp,144.0,143,0,CGCGTCTACCGGAATTTATA,143,421345
acrZp,144.0,143,0,CCGCCTTTGGATGGCTTCGA,143,413238
acrZp,144.0,143,0,CCATTCCATGGCACTAGATA,143,458361
acrZp,144.0,143,0,ATTCACCCAGTCTTGGCTTA,143,440500
acrZp,144.0,143,0,ACTTAGGAATGGCTCAGCCC,143,447054
acrZp,144.0,143,0,AATCATTGATCTCGCGAGAG,143,440506
acrZp,144.0,143,0,AAGAGCAGCGAGCCTGCTGT,143,435014
acrZp,144.0,143,0,AACGTTACCTTAATTGGGAT,143,459854
acrZp,144.0,143,0,AAAAAGGGTTTATTTTGAAG,143,463328
acrZp,143.0,142,0,TACAGTCCTACGCGCCTGGG,142,418615
acrZp,143.0,142,0,GTAAGCCGGCAAACCAGAGC,142,445469
acrZp,143.0,142,0,GGGTAGTTATACGCCATCTG,142,425395
acrZp,143.0,142,0,GCACGCTTAGCAAAGTTCTT,142,417702
acrZp,143.0,142,0,CTTTTGAGTACTTTTGCAGA,142,423481
acrZp,143.0,142,0,CTTACCAATAGCTGTGTACC,142,437187
acrZp,143.0,142,0,CCTAGACCAGGGCCATCAAC,142,436563
acrZp,143.0,142,0,CAAGGAGCTCCGGTTGTTAA,142,410460
acrZp,143.0,142,0,ATGCGGCCCTCTCGTGGGAG,142,422361
acrZp,142.0,141,0,TGTAATCATTCGTTAAAGTA,141,439866
acrZp,142.0,141,0,TCATCCGGTCTGCATCAGAG,141,440317
acrZp,142.0,141,0,TAAAGCCAAATTTTGTCCCG,141,427709
acrZp,142.0,141,0,CGGGGTAACCGTGCGTAAGA,141,459864
acrZp,142.0,141,0,CGGAGGGGAATAGAAAGGGC,141,465624
acrZp,142.0,141,0,CGACTACGTCTATATGAGAC,141,425901
acrZp,142.0,141,0,CAGTACGGACTGGCATACGA,141,427689
acrZp,142.0,141,0,CAGAGCATCCACGTTCATGT,141,455799
acrZp,142.0,141,0,ACCTGATTAAACTAGCGTCA,141,458008
acrZp,142.0,141,0,ACCAAACGACGGTGTAGTTA,141,445246
acrZp,142.0,141,0,AATATTAACCACACTTCACA,141,448633
acrZp,142.0,141,0,AAGTAGTATGGACCCAGGTG,141,411533
acrZp,142.0,141,0,AACTTAAGTTCGTAATCACA,141,425870
acrZp,142.0,141,0,AACCCGTCTCAGAGGAGAGA,141,431486
acrZp,141.0,140,0,TTGTATCAGCTATATTTTGA,140,446572
acrZp,141.0,140,0,TTGCCTGGTGTTCAATCGCT,140,438804
acrZp,141.0,140,0,TTATCTTGTAGGTCTTTCTA,140,417408
acrZp,141.0,140,0,TCTACAAAGCAGTAAGCAGG,140,418498
acrZp,141.0,140,0,TCGTTTGGTACAATTATCAT,140,449671
acrZp,141.0,140,0,TCGGGCTTCTCAGCTTAGGA,140,453382
acrZp,141.0,140,0,GTTTTGGATCATGTGGCCGA,140,426701
acrZp,141.0,140,0,GTAACCAGTTAAGCGTGATT,140,450571
acrZp,141.0,140,0,GTAACACCTAGCGATATTAG,140,444154
acrZp,141.0,140,0,GGGGTGCAACAGCTCGGAAA,140,410320
acrZp,141.0,140,0,GCGCATTGGGGTTGAACCCA,140,432444
acrZp,141.0,140,0,GCATTGCCCTATGCAGCGCT,140,410442
acrZp,141.0,140,0,CTACCCTCCCTAGCCTAAGG,140,418928
acrZp,141.0,140,0,CGGCCCCCGAAATATTAAAA,140,427712
acrZp,141.0,140,0,CCTTACCGATACCTCCGATG,140,420449
acrZp,141.0,140,0,CCATTCTGCTAGCTGAGCTC,140,441127
acrZp,141.0,140,0,CACTTAGTTGCTGAGCAAGG,140,464142
acrZp,141.0,140,0,ATTCGAACTATTGGCAGGTA,140,447237
acrZp,141.0,140,0,ATCTCACTTCTATCGCTGTA,140,457854
acrZp,141.0,140,0,ATCACAGGGTTCAGGCGAGG,140,444789
acrZp,141.0,140,0,ACCCATTTGGAACGAGAGTG,140,420906
acrZp,140.0,139,0,TTTGGTAACCAATAAACCTC,139,456988
acrZp,140.0,139,0,TGGAGTAGTACGGGTTCCGT,139,416762
acrZp,140.0,139,0,TACCCTGACATCTCAGGAAA,139,464697
acrZp,140.0,139,0,GTTGGACCCTTTTCGAGAAC,139,465588
acrZp,140.0,139,0,GGGCGCAACTAGAGGTAATA,139,464478
acrZp,140.0,139,0,GGAAAACGGGGATTCGTTTG,139,410058
acrZp,140.0,139,0,GCCAAGATGCGCCACGATTA,139,460212
acrZp,140.0,139,0,GATTGCTAGTAGCCGAGTGT,139,427253
acrZp,140.0,139,0,GATACGTTAAATCACAGAAA,139,418139
acrZp,140.0,139,0,CGCTTTCTGCTAAGGTGAAC,139,460721
acrZp,140.0,139,0,CCTTTATTCTTCGCCGCGGT,139,447933
acrZp,140.0,139,0,CCCTGGTCTAGATATTTTTA,139,454668
acrZp,140.0,139,0,CACTTTGGTTATCCAGTTCT,139,411564
acrZp,140.0,139,0,ACTATTTTCGGCCTTTTAGG,139,443719
acrZp,140.0,139,0,AAAGTGGACCTCACCGCGGC,139,443712
acrZp,139.0,138,0,TCCATGGCCATAAAGACTAT,138,445595
acrZp,139.0,138,0,GTGCCGCCATACTATCACTA,138,418701
acrZp,139.0,138,0,GGTGCCCAACTATCACCGGA,138,461992
acrZp,139.0,138,0,GGCTAAGTATATGTTATCAT,138,439869
acrZp,139.0,138,0,GCCTTATATCTCAACGGTGT,138,450154
acrZp,139.0,138,0,GCCCGGAACCTGTCATGCCC,138,422419
acrZp,139.0,138,0,GACTCGAACCTGAGCGCTTA,138,456434
acrZp,139.0,138,0,CTCTTCTCAGAACGCGCGCA,138,437075
acrZp,139.0,138,0,ATTCTCCGTCGAATGCCTGT,138,443359
acrZp,139.0,138,0,ACCCGGACCCTGCTATGGTG,138,419818
acrZp,139.0,138,0,ACATTGGGCCACTCAGCTTG,138,460286
acrZp,139.0,138,0,AATGTGTCATTGTGTCGTTG,138,462069
acrZp,139.0,138,0,AAGTAATTTGAGATAAATCC,138,430574
acrZp,138.0,137,0,TGTTACGACGGACGATACTA,137,425022
acrZp,138.0,137,0,TCATGCGAACATTTTAAAAT,137,424063
acrZp,138.0,137,0,TATGAGGAAGCAAGAAACTT,137,436098
acrZp,138.0,137,0,GTTAGAAGACGACGGAAGTG,137,435543
acrZp,138.0,137,0,GCCTGTTGCTAAATTCTCGT,137,467732
acrZp,138.0,137,0,GCCGCAGCCCTGAAATTTGA,137,455101
acrZp,138.0,137,0,CTGTCTAATTGCTACTGGGT,137,447223
acrZp,138.0,137,0,CAGTGACGATCGCGAAGATT,137,450600
acrZp,138.0,137,0,ATAATAAGAAGTCGTGTGAG,137,418851
acrZp,138.0,137,0,AGCTGTTCGTAGCTCTGTCA,137,453486
acrZp,138.0,137,0,ACTATCGAATAATGTCATCG,137,451343
acrZp,138.0,137,0,ACCACACCTGAGTACATCCT,137,442865
acrZp,137.0,136,0,TGCCCCGTGATTTCCCACAG,136,425372
acrZp,137.0,136,0,TCCCAATCCGATCTTCTTGT,136,429417
acrZp,137.0,136,0,TATGCCCTATTGTTCTACCC,136,444280
acrZp,137.0,136,0,GTTGCTTGCCTTTTAATATA,136,416158
acrZp,137.0,136,0,GCTCAGACGGGCAACACTGC,136,424777
acrZp,137.0,136,0,GAATACCCACTGCTTACAAT,136,467397
acrZp,137.0,136,0,CGATTGAGCGTCGGACATTT,136,423709
acrZp,137.0,136,0,CATCTGATTTAGCGAGGCTA,136,417740
acrZp,137.0,136,0,AGTTGCAAGGCCTGGTCAAA,136,449557
acrZp,137.0,136,0,ACGTATGCGCGGATACAAAG,136,447281
acrZp,137.0,136,0,ACCTTTTAATCATAGCTGAT,136,439870
acrZp,137.0,136,0,AATTTACGGATGCGATCAAC,136,456910
acrZp,136.0,135,0,TTTTGTCAGTATGTTCGATG,135,433424
acrZp,136.0,135,0,TTGGTGTGACGAGGGTAGGT,135,434523
acrZp,136.0,135,0,TCTGTTTGGGGTACGCTCGC,135,464056
acrZp,136.0,135,0,TATCAGGTACCAGTCGATTG,135,463856
acrZp,136.0,135,0,TAACTTTCAAATTTTAACCT,135,417589
acrZp,136.0,135,0,GTAAACGCAGGCTCCAAGTT,135,423463
acrZp,136.0,135,0,GGTCACGCTTTCCCAACAAT,135,420629
acrZp,136.0,135,0,GGGATGCCGCAGTTTGTGGG,135,451202
acrZp,136.0,135,0,CTAGACCACACGAATGAAAG,135,460350
acrZp,136.0,135,0,CGCGTCCTTTCTATGAACCT,135,465067
acrZp,136.0,135,0,CGCGGGATTTCTTGCTACAC,135,445353
acrZp,136.0,135,0,CGCAGTCTTGTTATTTCAGT,135,412067
acrZp,136.0,135,0,CCTACGCCCATAGAGCGTAT,135,426446
acrZp,136.0,135,0,ACGGCAGTGGTTACGAGAGT,135,422552
acrZp,136.0,135,0,ACGCGGAAGTTTTCTGACGG,135,459737
acrZp,136.0,135,0,AACTCGCTTCTAAATAAGGA,135,426716
acrZp,135.0,134,0,TTGCACCAGACGTCAGCCTG,134,437800
acrZp,135.0,134,0,TGGTATTGCGCAACCATCGT,134,458639
acrZp,135.0,134,0,GTTTCCCCACCAGCATTCAA,134,462914
acrZp,135.0,134,0,GTTCTGGCCATTGGGTTCAC,134,416873
acrZp,135.0,134,0,GTGACTCTTGCCCACGCGTC,134,463961
acrZp,135.0,134,0,GGGACTGAGCTGTGTACGTT,134,418478
acrZp,135.0,134,0,GGCGTCCTGAGCACTTTAGA,134,418149
acrZp,135.0,134,0,GCGTGACAGGCTGAATCGAT,134,425585
acrZp,135.0,134,0,CGCACAGGATTCTAACTGAA,134,424864
acrZp,135.0,134,0,AGTGTATTCGGTGTGCCAGA,134,436097
acrZp,135.0,134,0,AAATCGACGGGCGAATAGTT,134,436102
acrZp,134.0,133,0,TTCGGGGTTTAAGAACGACT,133,412968
acrZp,134.0,133,0,TCTAAAGGGCACAACGTTGT,133,458322
acrZp,134.0,133,0,TATTTCGTGACCAGCCAGAT,133,431825
acrZp,134.0,133,0,TAAAGGTGGGCACGATGGGA,133,458576
acrZp,134.0,133,0,GGGGGGGCTGTGAACCTGTA,133,457869
acrZp,134.0,133,0,GATCTGGAGTCATCCTATAC,133,441645
acrZp,134.0,133,0,CTCTACCTTGTGGGGTCACC,133,448539
acrZp,134.0,133,0,CGGAAGTGTGCGAGGCATCT,133,450393
acrZp,134.0,133,0,CAGCGTTTCCGCCTATGGGC,133,440924
acrZp,134.0,133,0,AGCCCTGGTCTCACATCACA,133,462402
acrZp,134.0,133,0,ACTACTTTGCGAGTCATTAA,133,425194
acrZp,134.0,133,0,ACGGCACAATAGTCGGGAGA,133,413779
acrZp,134.0,133,0,ACGAATCGCAACCCTTAGAT,133,462922
acrZp,134.0,133,0,ACATAACCCCGTCCCCACTT,133,422348
acrZp,134.0,133,0,AATTTATGATAAAGCTTTGA,133,417353
acrZp,133.0,132,0,GTCCCTACACTCCTAGCAGA,132,438133
acrZp,133.0,132,0,CCACAGCGGTGTTACCTGGA,132,464529
acrZp,133.0,132,0,CAACGACCCGCATTGTCGCT,132,454523
acrZp,133.0,132,0,AATTTGTTTCCTCCTACCAG,132,456748
acrZp,133.0,132,0,AATTCTAGGACTTTTAAAAC,132,465506
acrZp,133.0,132,0,AACGCCGTGACTAAGACCCT,132,442814
acrZp,132.0,131,0,GACGAGAGTTACACATTCTT,131,436939
acrZp,132.0,131,0,CTATTTACTGTACCTTTCTC,131,451573
acrZp,132.0,131,0,CGTTTGTAGGATACTTTGGA,131,427470
acrZp,132.0,131,0,CCGCGCCGTAGATTGCTAGT,131,455415
acrZp,132.0,131,0,CATAGGGTAAACAGGGTGGT,131,418867
acrZp,132.0,131,0,CAGATGCCGGAGAAAGAAGA,131,452053
acrZp,132.0,131,0,ATCATCGTAAATCCAGAGCC,131,452496
acrZp,132.0,131,0,AGTACCCAGAGCAATGTGTT,131,408595
acrZp,132.0,131,0,ACCTAAGAGGGTAACAGTCT,131,448524
acrZp,132.0,131,0,ACCCCGTTGGGTAGTCAATT,131,454208
acrZp,131.0,130,0,TTCTAGGGAGCAGAGTCGTC,130,418146
acrZp,131.0,130,0,TTCAAGTGGATCCTCAAAAG,130,458966
acrZp,131.0,130,0,TCAATGTCCTTGTCACGTAC,130,416204
acrZp,131.0,130,0,TAATGAGTCTCCATACTCAT,130,460439
acrZp,131.0,130,0,GTCGTAAAAGAGTAAACGAA,130,412727
acrZp,131.0,130,0,GTACGGGCCGGAGTCCGCAG,130,445884
acrZp,131.0,130,0,GGTGTAATGATCGCTTTGTT,130,409270
acrZp,131.0,130,0,GGTATCTATATCGTCAGAGT,130,448006
acrZp,131.0,130,0,GATAGCCTACTAGACTGTTA,130,440322
acrZp,131.0,130,0,CTCCAAGGTTTCCATTACAC,130,432732
acrZp,131.0,130,0,CGCGATCGTGGATAAGTGTG,130,466960
acrZp,131.0,130,0,CGAATAACCACACCCAGTAC,130,411477
acrZp,131.0,130,0,CAGCGTTCCTGATTAGTCGG,130,458264
acrZp,131.0,130,0,CACAAACTCGAGGATACCCT,130,434750
acrZp,131.0,130,0,ATGGGAGACCTAATCATGGT,130,422493
acrZp,131.0,130,0,ATAGGGGTTTATTGTGAACA,130,448250
acrZp,131.0,130,0,ACTCGTCCGGTGTGTAAGAT,130,462108
acrZp,131.0,130,0,ACCTTGCCGCCTAACTAAAT,130,445696
acrZp,131.0,130,0,AAGGCTTTGTTCCAGATCGA,130,457303
acrZp,130.0,129,0,TGTAGAGCCGGGCTTTAGCA,129,417317
acrZp,130.0,129,0,TGCCGGAGTGACCTTGAATG,129,445280
acrZp,130.0,129,0,GGCAGTGAAGCGGGTGGCGC,129,435160
acrZp,130.0,129,0,GGAACCTGGAACTCACGCAT,129,447557
acrZp,130.0,129,0,GCTGCCTACATGGGGGGTGG,129,440098
acrZp,130.0,129,0,GACTGTTCGGAACTCCATTG,129,442960
acrZp,130.0,129,0,CTTAAACATCGGATCAGTAA,129,444045
acrZp,130.0,129,0,CGGAAGAACGACATACGGTA,129,435175
acrZp,130.0,129,0,CCCGGATCTGATTATGCCGT,129,443616
acrZp,130.0,129,0,ATGCGGTCCTGAACTTCAAG,129,457959
acrZp,130.0,129,0,AGGTATACACTTACACGAGA,129,415071
acrZp,130.0,129,0,AGACGCTACACAGTCCCGGT,129,413453
acrZp,130.0,129,0,ACCATACGGAATACTCCGGG,129,450731
acrZp,129.0,128,0,TCGTAGTACGTTTATTGGCG,128,464540
acrZp,129.0,128,0,TCACCCAATTTTACGATCCA,128,415816
acrZp,129.0,128,0,TACGCGCTGATCAGTGTGGA,128,427402
acrZp,129.0,128,0,TAAAAGGCCTTCACCCTGGT,128,464062
acrZp,129.0,128,0,GTCCTTTTTGTATACACGCT,128,449585
acrZp,129.0,128,0,GAGGGCGAATTAGATCAGGT,128,419668
acrZp,129.0,128,0,CTGAACCGACCAGCCGGATA,128,459420
acrZp,129.0,128,0,CTCGGGTCAGCGACGTATAC,128,421016
acrZp,129.0,128,0,CGTAAACCTGGAGTTTGTTA,128,437005
acrZp,129.0,128,0,CGGGGTGCTGCGAAGGAGTA,128,437539
acrZp,129.0,128,0,CATCACATTCACAGGGTCGT,128,429616
acrZp,129.0,128,0,AGTAGCTGGAGAGCGGGTCC,128,448519
acrZp,129.0,128,0,AGGCCGGTTATCCGTTGCTA,128,434564
acrZp,129.0,128,0,AATTTTCTCTCCCACAGCTT,128,425796
acrZp,128.0,127,0,TTTTTACCACTGGACGGACT,127,445947
acrZp,128.0,127,0,TTACGTTCTATTATTGAATT,127,428130
acrZp,128.0,127,0,TGTTGACGTAGCTACTTCCT,127,466738
acrZp,128.0,127,0,TAGCAAGTTTACCTGTACGC,127,453805
acrZp,128.0,127,0,TACCCCGGTTATAAAGGTAC,127,466927
acrZp,128.0,127,0,TACAAATAGAGAGTAACTGT,127,443631
acrZp,128.0,127,0,GTTACAATCCCGGGCGATCA,127,459947
acrZp,128.0,127,0,GGGAGATCTACTCCTCAGGT,127,412473
acrZp,128.0,127,0,GGAACCGGACCAGTTAAAGA,127,442575
acrZp,128.0,127,0,GAGGGCTTTCGTTTGTGTGT,127,450476
acrZp,128.0,127,0,ATGGGTACCCCGGTTCCGTC,127,437390
acrZp,127.0,126,0,TTAGTCGCTATACGCCGGCC,126,417239
acrZp,127.0,126,0,TAAAAGAATACCAATATGCT,126,447245
acrZp,127.0,126,0,GTTTTGTAAGTGACGCATGA,126,440134
acrZp,127.0,126,0,GGAGCAAAAGGGTGTATAAA,126,436108
acrZp,127.0,126,0,GATCGCGAAAAAACCAGGCA,126,427699
acrZp,127.0,126,0,CTGGTAATCAGATATTACCA,126,428399
acrZp,127.0,126,0,ATCTAGCCATTTACGCGTTC,126,446194
acrZp,127.0,126,0,ATAAAAAAAAATAGCCCTTT,126,436298
acrZp,127.0,126,0,AGTTACAGTCCTCCCCCTAT,126,445172
acrZp,127.0,126,0,AGGATTGGTACAGGAATAGT,126,434215
acrZp,127.0,126,0,AGATTTAATTGCAATTTGTC,126,415295
acrZp,126.0,125,0,TGAGACGTCAGCCTAGATTA,125,460927
acrZp,126.0,125,0,TCACCTATTTTATTGAACGA,125,454669
acrZp,126.0,125,0,GTAACTAGGGGAATTTGATG,125,452852
acrZp,126.0,125,0,GGACTTCTTGACATAGTGTC,125,441044
acrZp,126.0,125,0,GCTCTAATCTCAGGTCCTGT,125,460009
acrZp,126.0,125,0,GCGGGACCTCAGTCTGTGGA,125,429475
acrZp,126.0,125,0,CGTTCGCTTGCGTCTCAGAA,125,464815
acrZp,126.0,125,0,CGTCTGGCGAGATCTACTTG,125,420624
acrZp,126.0,125,0,CGAAACAGGCTGTTTACCCC,125,453880
acrZp,126.0,125,0,CCGTAACAGTGCAAACACGA,125,426681
acrZp,126.0,125,0,CCCCTCCGCGCTGGTACAAG,125,465769
acrZp,126.0,125,0,CCAGACCCCGGTCTCCGTAT,125,416424
acrZp,126.0,125,0,CATGTGGCTCCGGCAAGCGC,125,445844
acrZp,126.0,125,0,CACTCAGGTCGTCTTCCGGA,125,423985
acrZp,126.0,125,0,CACTATATACGACTATCGTT,125,427020
acrZp,126.0,125,0,ACTTTAGTCGCTTGATTATC,125,444392
acrZp,126.0,125,0,ACGCGTCATCCCCGCGCGGT,125,451803
acrZp,126.0,125,0,ACATATCGACAACTCGCATA,125,411132
acrZp,126.0,125,0,AATACCGCTTTCCAATAATG,125,447717
acrZp,126.0,125,0,AAGAAGTAGGATCGTAACTT,125,464240
acrZp,125.0,124,0,TTCTGCTTTTCAGCCAAGTT,124,451874
acrZp,125.0,124,0,TGAGTACCTACACACACAGT,124,432636
acrZp,125.0,124,0,TCTCGCCCCTGTCGTTGCGG,124,411234
acrZp,125.0,124,0,TCGCGTTCGACCATTAGAGG,124,416916
acrZp,125.0,124,0,TCAGGCAGCCGCTCCTACTG,124,446430
acrZp,125.0,124,0,TACGGAAGCGGCAAATAAGG,124,419336
acrZp,125.0,124,0,TAAGCGTTTGATAACGATTG,124,423618
acrZp,125.0,124,0,GGTTGAAGGATAGACGCCAA,124,447811
acrZp,125.0,124,0,GGGATAACTTGTATTCACTT,124,427787
acrZp,125.0,124,0,GCGGCCTTCCGCTCTGGGTG,124,435065
acrZp,125.0,124,0,GCATGCGTCTTCTTAAAAAT,124,431601
acrZp,125.0,124,0,CCACTTTGACCAGAGTTACT,124,450380
acrZp,125.0,124,0,CATAAATGAAGCCACTCTTG,124,441353
acrZp,124.0,123,0,TTTTACCAGGATTCCTGGGT,123,458016
acrZp,124.0,123,0,TGGGTCGAGAGATGGTGGTC,123,441456
acrZp,124.0,123,0,GTGCGCGATGATGCCAAGGC,123,467436
acrZp,124.0,123,0,GGGTGGAAGGGCGTTCTTTG,123,450729
acrZp,124.0,123,0,GGGGTGTGAACCGGAATTAA,123,439824
acrZp,124.0,123,0,GAACTTAATAGGGATCGGCT,123,427237
acrZp,124.0,123,0,CTGGAGAGCGCAGTTTCCGA,123,457111
acrZp,124.0,123,0,CGTCACCGATACATTGTCCA,123,446364
acrZp,124.0,123,0,CGGCGCATAATTTCGGCTGA,123,435775
acrZp,124.0,123,0,ATTTCTTCGAAGCATGGGTC,123,452219
acrZp,124.0,123,0,ATTACTAGCCGACCTAGCCA,123,431704
acrZp,124.0,123,0,AGTGTGGCTTCATCAGATCG,123,422384
acrZp,124.0,123,0,ACTCATTGCCGTCAAGAAAG,123,444120
acrZp,124.0,123,0,AATTATGCAACGTGCAACCT,123,421239
acrZp,123.0,122,0,TGTGCTTGTGGCATATGATC,122,448590
acrZp,123.0,122,0,TAGCCGTGTGCAATAATTCG,122,434986
acrZp,123.0,122,0,GTCATCAAAACTGCGGGAAC,122,463794
acrZp,123.0,122,0,GGTCTCGGACGACCTGTTGA,122,450818
acrZp,123.0,122,0,GGACGATCACCATAGTCAAT,122,444379
acrZp,123.0,122,0,GCTCAACCCTACGCTAATTT,122,443241
acrZp,123.0,122,0,GATGATTGTTGCAGGTAGTC,122,445291
acrZp,123.0,122,0,GAGCGGGCTACGCGTAGTCA,122,457343
acrZp,123.0,122,0,GACTTGCGTTAGCCTGACTT,122,435186
acrZp,123.0,122,0,GAACTTTTTAACGAGGAATT,122,457851
acrZp,123.0,122,0,CAGCACTGGAGCTGCGGTTT,122,413926
acrZp,123.0,122,0,AGTCGGGGCTGCGAGGTGTA,122,459611
acrZp,123.0,122,0,AGCACATGATGCCCTCATTG,122,443782
acrZp,122.0,121,0,TTCCGAGGGGACACACGGGA,121,427836
acrZp,122.0,121,0,TCCACGTTGGTGTTGAGTCA,121,457110
acrZp,122.0,121,0,TACAGTATGAGCCTGTAATG,121,420737
acrZp,122.0,121,0,GGCCTGAGAAAGCCTGGTTT,121,460102
acrZp,122.0,121,0,GCCCACTTATCAATCTGTCT,121,441212
acrZp,122.0,121,0,GAGCGTTCAAGGCCTACAAG,121,443189
acrZp,122.0,121,0,GAGAGACTTTCAGTTAAGAA,121,418960
acrZp,122.0,121,0,CTCCTATACTTGTAATATAA,121,418302
acrZp,122.0,121,0,CGAGTTATCTGCAAGTGGGG,121,457873
acrZp,122.0,121,0,CCCCGCGCGCTGGCAAACCA,121,458970
acrZp,122.0,121,0,CCCCCCACGACGTACAGGTT,121,420959
acrZp,122.0,121,0,CCATTAGACTTGCGACTTAA,121,427521
acrZp,122.0,121,0,CCAAATCCTCTTACGCTATC,121,411068
acrZp,122.0,121,0,CACAGCAGTGCAAGCAGATT,121,415241
acrZp,122.0,121,0,ACTTACGGCCGAATTATCTT,121,431424
acrZp,122.0,121,0,AAATTGATATGGCACTTGGT,121,408797
acrZp,121.0,120,0,TGTTTTCCTGAGGCTGCGAA,120,421582
acrZp,121.0,120,0,TCTTTTGTACTAGCGATCTA,120,437566
acrZp,121.0,120,0,TCAGGCAAATGGTGTAGGTT,120,429280
acrZp,121.0,120,0,TCAGACTTTGGTATTGGGTT,120,463919
acrZp,121.0,120,0,TAGGACCGCCATCACTGTAC,120,464563
acrZp,121.0,120,0,GGGCAAGTCAAAGTTTGGAT,120,433109
acrZp,121.0,120,0,CGCAAGTTCACAGACCTCTT,120,446328
acrZp,121.0,120,0,ATTGGGCCGGGGGGGAGAAT,120,456311
acrZp,121.0,120,0,AGGGATGCGCTCCGTTTTAA,120,460344
acrZp,121.0,120,0,ACTCGGTTGTCGTCGCGAAT,120,411071
acrZp,121.0,120,0,ACTACGCTCGGCGCTCTCGC,120,409825
acrZp,120.0,119,0,TTGTTAACTTATTACTCTAC,119,431451
acrZp,120.0,119,0,TGGGTTCGGCCAGCGTGAGT,119,420443
acrZp,120.0,119,0,TAGCATATCGTATGGTGGAA,119,442148
acrZp,120.0,119,0,TACCTTCCTGTGTCTGTGCG,119,410347
acrZp,120.0,119,0,GGTATACGAGGGGAGCGACG,119,433965
acrZp,120.0,119,0,GCTACGTTGCTGAGGGACGT,119,437613
acrZp,120.0,119,0,GCGTTCTCGTCAAGGATTAT,119,432452
acrZp,120.0,119,0,GCCGGAACGAGCCCAAGTTT,119,423090
acrZp,120.0,119,0,GATTTGTTGAGACGATAGTG,119,409442
acrZp,120.0,119,0,GACTCGCACGGCTAAGCCAG,119,445944
acrZp,120.0,119,0,CTGTGTTAGCATTTTCCTAC,119,445029
acrZp,120.0,119,0,CTGGAAATAAAGTGCAAAAT,119,437590
acrZp,120.0,119,0,CGTATATTACATCACTTTGA,119,421877
acrZp,120.0,119,0,AGGACTCATTCAGTAAAATT,119,415299
acrZp,120.0,119,0,ACCTCTCAACGTCATCTCAG,119,433366
acrZp,120.0,119,0,AAGTGGTGCAGATAGTGGTC,119,433107
acrZp,120.0,119,0,AACTGGTATAGACAACTCAT,119,417927
acrZp,120.0,119,0,AACAGTCAGAACTTGCCCTC,119,432447
acrZp,119.0,118,0,TTAATTCACCCTAATTCAGA,118,453094
acrZp,119.0,118,0,TCTTGATGATCGGGTATTAG,118,433365
acrZp,119.0,118,0,GCCGCCTATCGTCCAATATT,118,466442
acrZp,119.0,118,0,GAGTATTCGTGCCGCCCACA,118,421539
acrZp,119.0,118,0,GAAGCCCCTTGTCGTACATA,118,427937
acrZp,119.0,118,0,CGAATAGAGGTAACCCACGC,118,465477
acrZp,119.0,118,0,CAGACTTATGCGTGTTAAAG,118,440872
acrZp,119.0,118,0,ATTTAGGGTAGTGCGCCATT,118,416451
acrZp,119.0,118,0,AGAAGATTATTCGGCAACGA,118,451858
acrZp,119.0,118,0,ACCCAGCAGCCTGGTTTCTC,118,414925
acrZp,118.0,117,0,TTGTTGCCCGTCTTAATATG,117,425994
acrZp,118.0,117,0,TTAGTATCACCACCTGAAGC,117,420225
acrZp,118.0,117,0,TGAAGGAAGATTGCAATCTA,117,414207
acrZp,118.0,117,0,GTAGATTATTTTTGGAGGAT,117,423007
acrZp,118.0,117,0,GGACAAGGTTAACTCCTTAC,117,417771
acrZp,118.0,117,0,GCCGGGGAACTGCGGGATAA,117,453043
acrZp,118.0,117,0,GACATTACTCTTATGATCCA,117,409534
acrZp,118.0,117,0,CTCTGCATATCCTCCTGATG,117,431406
acrZp,118.0,117,0,CGTGACGAATCACCTGGTTA,117,411472
acrZp,118.0,117,0,CCGAATTCTGGGATGAAGCT,117,440874
acrZp,118.0,117,0,CCCGCCAGGCATCCTTTGTT,117,416203
acrZp,118.0,117,0,AACCATGCTGAGCTGTCATA,117,422913
acrZp,117.0,116,0,TTTATACATAATTTAAACTG,116,465905
acrZp,117.0,116,0,GTCAGGATCAGAGTGGCACT,116,467208
acrZp,117.0,116,0,GACTAGATCCTTTAGAGTTA,116,432178
acrZp,117.0,116,0,CAACGTTATTCGGCCAATGT,116,462791
acrZp,117.0,116,0,ACGCATAACCAGTATCAAGC,116,426086
acrZp,116.0,115,0,TTGAGATAAGAGGATTATGG,115,421514
acrZp,116.0,115,0,TTAGCTACCGGAAGCCGTGC,115,436385
acrZp,116.0,115,0,TCAGGGCTTACCGTAGACCT,115,466702
acrZp,116.0,115,0,TAATCTCATGATCTCCAGCT,115,439248
acrZp,116.0,115,0,GCGCGCGCAACTAGCATCGG,115,409650
acrZp,116.0,115,0,GCCTTGTACGACGCCGGAAC,115,437670
acrZp,116.0,115,0,ACGGCGGTGCGGAGCGAATC,115,445188
acrZp,116.0,115,0,ACACTAAGTACAAAGGCTTA,115,454933
acrZp,116.0,115,0,AATGGAGTAGGAAACACGAA,115,445697
acrZp,116.0,115,0,AAAATCTGAAGATTAAACGC,115,434379
acrZp,115.0,114,0,TTCGCTAGACGGTCTGGCCC,114,454189
acrZp,115.0,114,0,TGTATATCGCTGGTCTTCAG,114,414599
acrZp,115.0,114,0,TGAATGTCAAGAACGCTAGT,114,427254
acrZp,115.0,114,0,TAGGTGGCGGACCGTTTTCT,114,426043
acrZp,115.0,114,0,GGCGTTCGACAACAATGGCC,114,450094
acrZp,115.0,114,0,GCTAAGTCTGGGGGGATCGT,114,450578
acrZp,115.0,114,0,GATCCATTAGTTTTTGACAC,114,441462
acrZp,115.0,114,0,CTAGTTTATACTCCAGAAAG,114,413916
acrZp,115.0,114,0,AGTACGTACATTTTGATGAG,114,419037
acrZp,115.0,114,0,ACTGAGCGGCCCCGCAGCCC,114,409053
acrZp,114.0,113,0,TGTTGGGCTCATAAACGGAA,113,425264
acrZp,114.0,113,0,TGGAGGGAGTTGCAGTTGTC,113,454295
acrZp,114.0,113,0,TAGAATCTCAGCACATGTTG,113,451515
acrZp,114.0,113,0,TAAACAACTCCCGGCAATCC,113,445297
acrZp,114.0,113,0,GTCTATGAAGCCCAGCGGTA,113,460915
acrZp,114.0,113,0,GGATTCGAATCCGTAGGAAA,113,452629
acrZp,114.0,113,0,GCCAAAACGGCGTGAGTAGT,113,459179
acrZp,114.0,113,0,GACGAATCGCAATGATTTAA,113,436877
acrZp,114.0,113,0,CCTCCAACGACGACTACTTA,113,414186
acrZp,114.0,113,0,CCGGCCGTGAGTAGACACGG,113,448958
acrZp,114.0,113,0,ATAGCCTCGCGAAACTTGTG,113,410828
acrZp,114.0,113,0,AACGTTTATAGTGGTAGGTT,113,441158
acrZp,113.0,112,0,TGCGTCTGAAGTAAAGTTAC,112,443434
acrZp,113.0,112,0,TCTAGTAGGCTAAATAGGAT,112,458535
acrZp,113.0,112,0,GTAACTCATCTACCTCTTTT,112,432265
acrZp,113.0,112,0,CGTCACGGCTTCTTCGCGAC,112,434218
acrZp,113.0,112,0,CGTAAAGGGCTTGGCTCTCG,112,462222
acrZp,113.0,112,0,CCTAATCACGTCCTTCTGAG,112,417541
acrZp,113.0,112,0,AGGATTGATCACACACCGGG,112,441860
acrZp,113.0,112,0,AGCGCATTCAAGAAATCTCC,112,466974
acrZp,113.0,112,0,ACCTAAAGTGGTCTATCATA,112,429230
acrZp,113.0,112,0,ACAGTGGCTCATCCAGGCAT,112,434056
acrZp,113.0,112,0,ACAGACGAAGTTGTGGAGGA,112,443416
acrZp,112.0,111,0,TTGGCTAAATCTCCATTGGT,111,421308
acrZp,112.0,111,0,TGTTCTGGTCGCCCCCCCAT,111,440194
acrZp,112.0,111,0,GCGTTATACTCTAACGGATG,111,456635
acrZp,112.0,111,0,GATAGCTACATTCAAGTTAT,111,448113
acrZp,112.0,111,0,CTTCTGCAAGCGTGACTTCT,111,426269
acrZp,112.0,111,0,CCTTGGCCTGTTGTTGTCAG,111,438252
acrZp,112.0,111,0,CAATGTATATACCCCCTACT,111,433276
acrZp,112.0,111,0,ATTTATAGCTCGGCTAAGCG,111,443690
acrZp,112.0,111,0,ACTCACAAGTAAGGCCCATA,111,410113
acrZp,111.0,110,0,TTACCTGGTACAACCATTAG,110,446823
acrZp,111.0,110,0,TCCTGACTTCTATGAGGAAG,110,453298
acrZp,111.0,110,0,TATATAGCCTGAAATGAGAA,110,454731
acrZp,111.0,110,0,GCGCCGCCTCGTTAGCCGTC,110,436327
acrZp,111.0,110,0,GCCACCACCACGCTTGCTGT,110,424589
acrZp,111.0,110,0,GCATATCAGATGAGAAATTG,110,445229
acrZp,111.0,110,0,GAGAACACAAGGATTTTTCG,110,434186
acrZp,111.0,110,0,CTTCACGAGAAGCGGGGGTT,110,420626
acrZp,111.0,110,0,CCACAGGTCAATTCGTAACA,110,420224
acrZp,111.0,110,0,CAGCTTGAACGTATCCCTTA,110,431684
acrZp,111.0,110,0,AGGAACAAATTCCTATCAGC,110,459171
acrZp,111.0,110,0,ACCATAGACTTCGTTAGGTA,110,426634
acrZp,110.0,109,0,TTTCAGACTAACCATTCCGA,109,439982
acrZp,110.0,109,0,TTCGCGACTGTGTTGAGGTG,109,426560
acrZp,110.0,109,0,TCAGTGTTACCCTTTAGGGC,109,462050
acrZp,110.0,109,0,GCCTGCATCTGCAGCAGTTG,109,427931
acrZp,110.0,109,0,GACGCGACATTAGTTCGGCG,109,430731
acrZp,110.0,109,0,CGTCTACACATGTGTGACTC,109,423907
acrZp,110.0,109,0,CATTACACAGCCAGCTGGTG,109,448517
acrZp,110.0,109,0,ATGGCATATTATGGTTAATT,109,466874
acrZp,110.0,109,0,AATCTAATTCAAACTCGCCC,109,432777
acrZp,110.0,109,0,AACGCCCCGTTGCAATAGGC,109,445773
acrZp,109.0,108,0,TTCTAAATCTATGTCGAGCA,108,462411
acrZp,109.0,108,0,TCGTTTAAAGAGAGACTATA,108,416662
acrZp,109.0,108,0,TAGGGAAAGGTGATTCTCTT,108,411088
acrZp,109.0,108,0,TACCCCTATGCAATTGCTGC,108,451107
acrZp,109.0,108,0,GTAAGACTACGTACACTTTA,108,436219
acrZp,109.0,108,0,GCTTAAATACCATCGCTGAG,108,415869
acrZp,109.0,108,0,GCACACTAAAGTCCTTAAGC,108,457099
acrZp,109.0,108,0,GATCCTTTTATGGACTCCGT,108,414352
acrZp,109.0,108,0,CCTGCGAAATAAGTACCCCC,108,410111
acrZp,109.0,108,0,ATTCCCATTTTATTTAGGAT,108,411163
acrZp,109.0,108,0,ATGTTACTTATACTTCTCCT,108,413259
acrZp,109.0,108,0,AAACTCATACAGGTTAGATT,108,429731
acrZp,108.0,107,0,TTGACGTCGAACAATGACGT,107,426713
acrZp,108.0,107,0,TCGGGCTATATAGACCGAAT,107,412939
acrZp,108.0,107,0,GGTATAGACACATAATATGG,107,447801
acrZp,108.0,107,0,GCCCGTAAGATTGTGTGAGC,107,415254
acrZp,108.0,107,0,GAAAGGGCGTTTGATGTATA,107,431253
acrZp,108.0,107,0,ATGCTGTTTACTAAGCGTTA,107,466127
acrZp,108.0,107,0,ATAAATCACCCGAACGGTTA,107,437201
acrZp,108.0,107,0,AACGGCAATCGTCTAATCAT,107,457394
acrZp,108.0,107,0,AACACTCTAAGGTCCGAATA,107,433437
acrZp,107.0,106,0,TTTTTTCCGGGGAATTTCTC,106,447154
acrZp,107.0,106,0,TTTAGACATCGTATTCTATG,106,410609
acrZp,107.0,106,0,TTCACATGAAACGGTTATCA,106,465327
acrZp,107.0,106,0,TACTGTAGTATGCGGCCTGA,106,411918
acrZp,107.0,106,0,TACGTGCCAACGGTCAAGCG,106,424772
acrZp,107.0,106,0,GGTGGGGGTCCTAACGTCCA,106,454767
acrZp,107.0,106,0,GGAGATATAGGCCAGCGAAA,106,419439
acrZp,107.0,106,0,GGAAGCTAAGCCGGGTTACT,106,425888
acrZp,107.0,106,0,GATTTCAGCGTAACTGAATT,106,466301
acrZp,107.0,106,0,GATATCACTGACTAGGTCAT,106,454686
acrZp,107.0,106,0,CATCAGTTGACGTTACAGGA,106,455825
acrZp,107.0,106,0,CATCACCTGACCTTTTCATA,106,448110
acrZp,107.0,106,0,ATAGACAACTGTTTCATTTG,106,444664
acrZp,106.0,105,0,TGTTCACGTACTTCGTGCGA,105,450142
acrZp,106.0,105,0,TGCCGTGTTAGTGTTGCATT,105,437387
acrZp,106.0,105,0,GCTTTATCGGTTTCTGCGGG,105,466722
acrZp,106.0,105,0,ACAGCATTGGGCTTACCAAA,105,440308
acrZp,106.0,105,0,AAGGGCCGACGATCTCCCAA,105,450085
acrZp,105.0,104,0,TCCCAATTTCTAATGGGCCT,104,424978
acrZp,105.0,104,0,GGGCCTGCCTCTAGTGGCGG,104,462484
acrZp,105.0,104,0,CTTCCGCTTATGCTCTGATT,104,408819
acrZp,105.0,104,0,CGGGAGGCTATTCGGGGAAA,104,437100
acrZp,105.0,104,0,CACAATCGCTCGGAATGTGC,104,452272
acrZp,105.0,104,0,ACCCGACGGGAGGATTATCG,104,433516
acrZp,105.0,104,0,AAAAGTCTGTAGGTGCACTA,104,415971
acrZp,104.0,103,0,TTCACCAAGAATTCACATAA,103,458575
acrZp,104.0,103,0,TCAATCCAAGCGCGGCCTGT,103,421591
acrZp,104.0,103,0,GTGGCCGGTGCCCCTTAAAA,103,451665
acrZp,104.0,103,0,GTGGACAATGGTTTCCTTGG,103,448332
acrZp,104.0,103,0,GTCGCCTGGTTCGGAAATTT,103,462646
acrZp,104.0,103,0,GAGTTGTTGAGCTCACTGCA,103,423189
acrZp,104.0,103,0,GAGCCGCAATGCATATCTAG,103,412339
acrZp,104.0,103,0,CTAGATGTTATTGGCGATCC,103,464613
acrZp,104.0,103,0,CGTAATCTGTAGCGAGCTTT,103,413931
acrZp,104.0,103,0,CGGGCCTCCTTCATTCAAAA,103,416961
acrZp,104.0,103,0,CGCGGATCTGTCTAAGCCGG,103,427136
acrZp,104.0,103,0,CGAGCAACATCTATGGTAGA,103,446539
acrZp,104.0,103,0,CCGCGGTCTACCCGTGCATG,103,466054
acrZp,104.0,103,0,CCCTAAAAAGGGGTAGCATT,103,427906
acrZp,104.0,103,0,CAAGTACCCCATTGTCGTAA,103,455278
acrZp,104.0,103,0,AGTTGAGCGTATTTGCCACT,103,455016
acrZp,103.0,102,0,TTCACATGGTGTAAGGAAGT,102,439168
acrZp,103.0,102,0,GCTAGGTCCTAGCGCCCCTT,102,459163
acrZp,103.0,102,0,GCCGTTTAGATCGGACGTCG,102,454544
acrZp,103.0,102,0,CTAATAATGTTAGATGCTAA,102,413182
acrZp,103.0,102,0,CGTGACCCATGGCACAGAGT,102,415873
acrZp,103.0,102,0,CGCCAATAGCCCAATTACAA,102,452647
acrZp,103.0,102,0,CGCACGTCTCTCAACTAGAA,102,463589
acrZp,103.0,102,0,AGCCGGTCATTAATCCTGGT,102,418958
acrZp,103.0,102,0,ACTTCCGTAAATCTAGATAC,102,417507
acrZp,103.0,102,0,ACAACGTATCCTAGTTTCAG,102,456710
acrZp,103.0,102,0,AAAGCAGGCTGACTCCGTCA,102,459971
acrZp,102.0,101,0,GTAAGGTTGTTCATAAGGAT,101,463137
acrZp,102.0,101,0,GCGGGTGTCTTTGTTAATGT,101,434524
acrZp,102.0,101,0,GCGGCTCAGACGCGACATGG,101,418873
acrZp,102.0,101,0,CTGTCTCGCTATACTGGCGC,101,426532
acrZp,102.0,101,0,CCAATCACCAGCAGACCAGA,101,413218
acrZp,101.0,100,0,TTATTCAGTATGAGCATATA,100,424901
acrZp,101.0,100,0,GTGCTATCTTTTTAGAAATT,100,428938
acrZp,101.0,100,0,GGTCGATGCAGATCTCTCTT,100,436908
acrZp,101.0,100,0,CTGTAGGAGCCTCCTCAGAG,100,419228
acrZp,101.0,100,0,CGAGCGCAAGAAGAAATCGC,100,456365
acrZp,101.0,100,0,ATTTTCGCGGTACATGGGAC,100,421832
acrZp,101.0,100,0,AGGAATTTGAAGATAGGATT,100,427993
acrZp,101.0,100,0,AGCGTGCCGAAATAACATCG,100,431256
acrZp,101.0,100,0,ACAGGGTGTTAGTCACAACA,100,452626
acrZp,100.0,99,0,TTTGTTATCGGTGTGATTGT,99,413380
acrZp,100.0,99,0,TTGACCCGACCCGGATCCAC,99,422807
acrZp,100.0,99,0,TCTGGCCAAGACGAGGGATA,99,432183
acrZp,100.0,99,0,GTACGTTGACACGCCCCTTT,99,446323
acrZp,100.0,99,0,GACCTTGTTATCGATTCGAG,99,418993
acrZp,100.0,99,0,GAACTAAAATTGTCTATGTA,99,433707
acrZp,100.0,99,0,CTTATTCCCTCTACTACAAA,99,428381
acrZp,100.0,99,0,CAGGTATATAAGCTCTAAAG,99,436733
acrZp,99.0,98,0,TTGGGTGGGTGAACGCAGAC,98,448244
acrZp,99.0,98,0,TGCAGGTGGGGGGCTGATTA,98,410119
acrZp,99.0,98,0,TCCATTCTGACAACTGGAAA,98,435036
acrZp,99.0,98,0,TATTCACGTCATGCCAGCCC,98,410611
acrZp,99.0,98,0,GTTTGATCACACCACATCAA,98,456346
acrZp,99.0,98,0,GGAGGTCAAACTTCATAACA,98,438956
acrZp,99.0,98,0,GGAACTAACGACGTGACAAA,98,439246
acrZp,99.0,98,0,CTGCAATGCTCAGTCCTGAT,98,456859
acrZp,99.0,98,0,CAGAAAACCTATACTGCGCG,98,430187
acrZp,99.0,98,0,ACGAGCTCCATTGGGAGAAT,98,447558
acrZp,99.0,98,0,AACTCTCTTTCTACGTGGTC,98,444295
acrZp,98.0,97,0,TTCAACGAGTTCGACCATTT,97,418603
acrZp,98.0,97,0,TACCCACGACACGAGCTTGA,97,464238
acrZp,98.0,97,0,GCGTACCGATGATTTATAGA,97,410219
acrZp,98.0,97,0,ATCCTACGTTTTCCCGGTGC,97,447724
acrZp,98.0,97,0,AACTCCGATCCTTCAATAGG,97,462913
acrZp,97.0,96,0,TTCTCCGGGACACGAGAGGA,96,414579
acrZp,97.0,96,0,TATAAAATACACGCCGGAGT,96,445590
acrZp,97.0,96,0,GTGGCTTATGGGAGAAACGA,96,436874
acrZp,97.0,96,0,GGTTTCTTGGCGAGGACCTG,96,424537
acrZp,97.0,96,0,GACATCTCTGTAACAGGCTC,96,417614
acrZp,97.0,96,0,CTTGCCACTGGGCGACTCTA,96,453148
acrZp,97.0,96,0,CACATACCACCGTCAGTCTT,96,421664
acrZp,97.0,96,0,ACTGTTTTGCGACTCCGTGG,96,456825
acrZp,97.0,96,0,AAGGAGACTTTGACATCTGG,96,422349
acrZp,96.0,95,0,TTTTGCATCTGACGTATATT,95,445338
acrZp,96.0,95,0,TTTGAAGCGATACGGAGTGG,95,414519
acrZp,96.0,95,0,TCCCCGGAGGGATAACTATG,95,413793
acrZp,96.0,95,0,CTTCTATTTTTTTACTCACA,95,444377
acrZp,96.0,95,0,CCAGAAGTTAAGGTGTAGGT,95,410210
acrZp,96.0,95,0,AATGCATTGGGTGTAACAAC,95,429640
acrZp,95.0,94,0,TTGCCGGACACGGGTGGGCA,94,445295
acrZp,95.0,94,0,TGCTAAATGTATTTTGAATG,94,459022
acrZp,95.0,94,0,TCGAAGGCCATTTTGCGCAT,94,445173
acrZp,95.0,94,0,GTTGTAGTTTTCGAACGAAT,94,445719
acrZp,95.0,94,0,GTATACGACGCTTAGGACGA,94,455916
acrZp,95.0,94,0,GCGAGACAAAGGTGACCCTG,94,462796
acrZp,95.0,94,0,CGTGCCCAGTCGGATTTAAG,94,417734
acrZp,95.0,94,0,CGGACGCCTTTAAGGAGACT,94,452147
acrZp,95.0,94,0,CGAGCTCTTCAAAGACGAAG,94,428073
acrZp,95.0,94,0,CATCCCATGATGGAGGGAGG,94,430375
acrZp,95.0,94,0,ATCCCTCTATAGTTGCCACA,94,452366
acrZp,95.0,94,0,AAGCCCGCATTACTAGAATA,94,415581
acrZp,95.0,94,0,AAGATGATGCCGACGTGTGC,94,457570
acrZp,94.0,93,0,TTGTAAATTGCCTCGACTCC,93,458922
acrZp,94.0,93,0,GTTTTAGTTTTATACTCCTT,93,466411
acrZp,94.0,93,0,GTCGCAGAATATGGCTAGCA,93,426601
acrZp,94.0,93,0,GGAGGATGTTCCTACCGAGT,93,466129
acrZp,94.0,93,0,GCACTTTCCCAGTACTTAGT,93,439172
acrZp,94.0,93,0,GAGTAGGTTGAACGCCGTGT,93,465877
acrZp,94.0,93,0,CTAGATCGACCGGATGGACC,93,428458
acrZp,94.0,93,0,CGTAGGTGTTCACACTCCTC,93,432445
acrZp,94.0,93,0,AGTGACGTTACTCAACATTG,93,452991
acrZp,94.0,93,0,AGCTGTTTTGCTGCACAGGA,93,414907
acrZp,94.0,93,0,ACGGGATATATTTTTTCACC,93,428392
acrZp,94.0,93,0,ACGCGGACAATCATGAACTC,93,433207
acrZp,93.0,92,0,TAGGTTTGCGCGAATCACTA,92,428494
acrZp,93.0,92,0,CTTGTCTAGGCCCCGTGTGC,92,426561
acrZp,93.0,92,0,CGACACAGTTTGATCCCGTT,92,448972
acrZp,93.0,92,0,ATTCTCAGTCACTAAGCAAT,92,418818
acrZp,93.0,92,0,AGATACGCTTGGCATAAATG,92,427357
acrZp,93.0,92,0,ACATGAAGCTGTGGTATAGT,92,453416
acrZp,92.0,91,0,TTTTGTTTCTCCGGCGTCTA,91,445276
acrZp,92.0,91,0,TCTTTCTCTGAGTGCAATTC,91,461477
acrZp,92.0,91,0,TAGCCCTGAATCAATGCCAC,91,427789
acrZp,92.0,91,0,GTGCCCGACGTCTAGCCCGT,91,452770
acrZp,92.0,91,0,GGCGTGGCGATAGGGCTTGT,91,418106
acrZp,92.0,91,0,CTTGTGTAATCTTTCACCTT,91,455891
acrZp,92.0,91,0,CCGTATGGCCGGGGATCCGC,91,453595
acrZp,92.0,91,0,CCCTCTCAGGTAATAAAAAG,91,460956
acrZp,92.0,91,0,AGCAAATGCTCCGTGTGCAG,91,424039
acrZp,92.0,91,0,AACGGTACTATGCCTCTGGC,91,452485
acrZp,91.0,90,0,TTGTTAAGTGTGCATCTGTG,90,413719
acrZp,91.0,90,0,TTAAAGAAGTCGCAATCAAA,90,449628
acrZp,91.0,90,0,TGGTCTTGGGAGATTAGCAG,90,438974
acrZp,91.0,90,0,TAAGAAATTTAAACCTAATA,90,436226
acrZp,91.0,90,0,GGCTATGGCGACTTGCGTAC,90,456112
acrZp,91.0,90,0,GCTTGACATCTATGATACCC,90,410871
acrZp,91.0,90,0,CAGACCGCTCTATGTACGCG,90,434205
acrZp,91.0,90,0,ATACCTCGAATTTTATTGTT,90,426039
acrZp,90.0,89,0,TTCGGCGAGTTAGGTCGAGA,89,466904
acrZp,90.0,89,0,TGGTCACTTATTTAGACTTA,89,416680
acrZp,90.0,89,0,TAATGCCATACACCGTCGCC,89,456441
acrZp,90.0,89,0,GGACAGACTTTCGTTACTAA,89,453735
acrZp,90.0,89,0,ATCGAGTTTTGTGAGTTACA,89,416061
acrZp,89.0,88,0,TGCGGCTCTTTGGAGAACCC,88,441621
acrZp,89.0,88,0,TCCCACATTATAGAAGCTCC,88,460130
acrZp,89.0,88,0,GAACCGAGAGATGCATTGAG,88,414056
acrZp,89.0,88,0,CTCAGTTTTAACTTCTACCG,88,423836
acrZp,89.0,88,0,CGTTCGTCATCACGGCTTTG,88,435870
acrZp,89.0,88,0,CCCGTACGGGGACGGAAGCG,88,445385
acrZp,89.0,88,0,ATCTAAATAAACATTAAGTG,88,418882
acrZp,89.0,88,0,ACGTCTTCTATGCGAAGTCA,88,452630
acrZp,89.0,88,0,ACCTAACCTATGGTTCGTCG,88,456778
acrZp,89.0,88,0,ACACCGGCAATTCTCAAAGT,88,445170
acrZp,89.0,88,0,AAGAGGTGCTCAGGCCAATC,88,438466
acrZp,88.0,87,0,TCGCTTGGCGCCTGCTTATA,87,432654
acrZp,88.0,87,0,GGTGGGCGGCCCCGCAGGGT,87,455924
acrZp,88.0,87,0,GAAAACAATTTGCTAACCCT,87,466264
acrZp,88.0,87,0,ATGCGGATCTCGAACGTGAC,87,461327
acrZp,88.0,87,0,ACGATGTAGACTAAGGACTA,87,462208
acrZp,87.0,86,0,TCTATGCAGAGGTGTTAACG,86,411524
acrZp,87.0,86,0,TATTTCAGAGTGTGGGCACG,86,436584
acrZp,87.0,86,0,ATTGTCTTAGAGTAGGCTCG,86,452899
acrZp,86.0,85,0,TATTTATGATCTTACCTGCA,85,446982
acrZp,86.0,85,0,GGGTACATCCGCACGGCATT,85,424431
acrZp,86.0,85,0,GCGAGCGTCCAACAGCAGTA,85,432443
acrZp,86.0,85,0,CTTAGAGAGCACGTCTTTCT,85,420730
acrZp,86.0,85,0,CCGATAAGCGTCGGAGACCT,85,418272
acrZp,86.0,85,0,ACTATCACATAATACAGGTT,85,451855
acrZp,85.0,84,0,TCGCCAAAACCACGATTTCC,84,428517
acrZp,85.0,84,0,TAGGTGAGGCACAAGTTATT,84,421744
acrZp,85.0,84,0,GGATTCAGGTGGGGGGTAAA,84,435536
acrZp,85.0,84,0,GGAACTGACCTCACGTAGTG,84,409998
acrZp,85.0,84,0,GCAGTACTGTACGCCCTTCC,84,409632
acrZp,85.0,84,0,AAGGATCACGACGTGGAAAC,84,416585
acrZp,84.0,83,0,TGTCATAACTAGGGAAAGCA,83,449217
acrZp,84.0,83,0,TGGATTCAAGATTACAGCTG,83,409181
acrZp,84.0,83,0,TATCTCAACGTGCAGGCATA,83,436736
acrZp,84.0,83,0,GTTCACCGGCTCACGATGGA,83,426624
acrZp,84.0,83,0,GTGGCTTGTCCTCTGACGAA,83,414358
acrZp,84.0,83,0,GGTTAAGTCAGGCAGATGAG,83,456670
acrZp,84.0,83,0,GCGCGCGCGCTCCTGAAACC,83,427730
acrZp,84.0,83,0,GCATTTGCTCACAATGAGAT,83,415707
acrZp,84.0,83,0,CTTAAGCAGGAGCGAGCTTA,83,421287
acrZp,84.0,83,0,CCACTGTGATAGTCTTTCCC,83,423344
acrZp,83.0,82,0,TGGCTGTTTTGTCACTTATA,82,443680
acrZp,83.0,82,0,GGGCGAGCTTCGGTACGGAC,82,419721
acrZp,83.0,82,0,CTGCTACGTTTCGAACAAAG,82,449634
acrZp,83.0,82,0,CCCACGTTGACTCAATCCAG,82,409957
acrZp,82.0,81,0,TCCTGACCTATGGTGGTGTT,81,425850
acrZp,82.0,81,0,GGGCGACACTTACAACGAGA,81,466275
acrZp,82.0,81,0,GGCATTCACACCTAACGATA,81,417560
acrZp,82.0,81,0,CATAGATGGGCGACCTCCAA,81,437581
acrZp,82.0,81,0,CAGAGAGGCCCAGTTTATCC,81,450333
acrZp,82.0,81,0,AGAATATAGTTATACACCTA,81,465592
acrZp,82.0,81,0,ACCGAGGTGGATCAACACTG,81,446218
acrZp,82.0,81,0,AACCGGCTGATTTTGGCGCT,81,447196
acrZp,81.0,80,0,TTAATTCCACATTTTTCTAT,80,430257
acrZp,81.0,80,0,TGAGTTGGTAATCACAGGCT,80,445603
acrZp,81.0,80,0,TATTTGTGTCAGTGAACGGA,80,456833
acrZp,81.0,80,0,CGTGCGTGCCTTCTCATGCG,80,439241
acrZp,81.0,80,0,AGGATGAACTCGGAGAGGCG,80,410486
acrZp,81.0,80,0,AGCATATTATAGACGCGGTT,80,461816
acrZp,81.0,80,0,AATAACCAGATGTATCATGC,80,422113
acrZp,80.0,79,0,GGTTGTCCCAGGGTGAACGT,79,463018
acrZp,79.0,78,0,TTTGAACGTGTGTCTCGCTA,78,415218
acrZp,79.0,78,0,TCGTGCTACCACCTACACTA,78,429026
acrZp,79.0,78,0,TCGGCTGAGATGACGGCCGG,78,446608
acrZp,79.0,78,0,GTGCTCATTTGTAAAGCTCT,78,432586
acrZp,79.0,78,0,GGACAGTAACATTACTCAGA,78,460316
acrZp,79.0,78,0,CAGATGGTTGTCGCGATGGC,78,410223
acrZp,79.0,78,0,CAATTTGCGGTGGGTGTCAG,78,436109
acrZp,79.0,78,0,AGTTGCGGTGTCGCGGAGAT,78,422968
acrZp,79.0,78,0,ACGGCTAAAGTCCGGCGTTC,78,454285
acrZp,79.0,78,0,AAAACATACTCATAATATTG,78,427953
acrZp,78.0,77,0,GTATCCGCATTGGACAGCTC,77,431334
acrZp,78.0,77,0,GTAAGGAAGCCTACGGCTCA,77,425885
acrZp,78.0,77,0,CTGTGCTGCATGACATCCCA,77,462728
acrZp,78.0,77,0,ATAATATCATCTCACGCGGA,77,459168
acrZp,78.0,77,0,ATAAAACTGGATCATTAAGT,77,422288
acrZp,77.0,76,0,TGCCATCCATGACGCCGGGA,76,417394
acrZp,77.0,76,0,TGAAAGATTAACCGTGCGTC,76,451085
acrZp,77.0,76,0,GGGGGAGAGGTGTTCCTACT,76,442329
acrZp,77.0,76,0,CAGAATCTGCCACTGACCTC,76,409855
acrZp,76.0,75,0,TGTAGGCGACCGCGGGTTAT,75,461573
acrZp,76.0,75,0,TAGCCGAGCATGAATGGGAT,75,425753
acrZp,76.0,75,0,GAAACAGTGTTTGTTTCCAT,75,450162
acrZp,76.0,75,0,CCACGATCTTACGGGGACCT,75,428525
acrZp,76.0,75,0,CAGGAAAGCGGCCCACTTTT,75,431587
acrZp,76.0,75,0,ATGTCCTTACGGTTAGAGAT,75,454677
acrZp,76.0,75,0,AGTAGTGTAGCATGTACCAT,75,410902
acrZp,75.0,74,0,TGCGGGAGACTGGGCGCCTA,74,418335
acrZp,75.0,74,0,TCTGTCTATAAGTTGTAGGT,74,426684
acrZp,75.0,74,0,TCTGATCGGCCGGTTACATA,74,435591
acrZp,75.0,74,0,TAAGGTTTGCCCTTTTCCGT,74,456332
acrZp,75.0,74,0,CTGTCAGTCAGTAAGGTCAA,74,442356
acrZp,75.0,74,0,CTCTAGTGAACTACGTGATC,74,425557
acrZp,75.0,74,0,AGCATTGTTGTAGCCTATGA,74,430833
acrZp,74.0,73,0,TTCATTTACTTAAGTAGCTC,73,433164
acrZp,74.0,73,0,TACGTGAACCAGGAATTCAA,73,438303
acrZp,74.0,73,0,GTATTTTCGAATTATGGCGT,73,414700
acrZp,74.0,73,0,CCGGGTTCAATGATCGACTA,73,413703
acrZp,74.0,73,0,CATCCCAGATTTAGTGGGTT,73,433317
acrZp,74.0,73,0,CACAAATTGCAGAGTAAGGC,73,416574
acrZp,73.0,72,0,TAATAAGGGGGGAACCGCTG,72,446873
acrZp,73.0,72,0,GTCGAGTTGTAAATCTTATG,72,412554
acrZp,73.0,72,0,GTACATGGCTAACCCACCAT,72,456011
acrZp,73.0,72,0,CTGTCGCGGGCGCTGTATAC,72,466883
acrZp,73.0,72,0,CTCCATCGAAGCATAGTTCT,72,457655
acrZp,73.0,72,0,CCTGAACTAGGTCAAGTTGT,72,420740
acrZp,73.0,72,0,AAACAGTACCTTCGGGTAAT,72,439702
acrZp,72.0,71,0,TAGCTCCGGCATATGCCAAT,71,432432
acrZp,72.0,71,0,TAAAAGAGGGCAGTGGGGAA,71,418990
acrZp,72.0,71,0,GGGTGTGACAGTCGGCCTCC,71,434403
acrZp,72.0,71,0,CTTTAGTGCATCTTCCCTGC,71,442030
acrZp,72.0,71,0,CGCACGATGGCCCCCCCCGG,71,426570
acrZp,72.0,71,0,ACCGGGGGAGGTTCATAAAG,71,422004
acrZp,71.0,70,0,TGCGAGCTCGGGACTGGATT,70,466343
acrZp,71.0,70,0,TAGCAAGCGCCGTTATTTCC,70,427567
acrZp,71.0,70,0,GCCCTGCTGGTCGTGGGGCT,70,454452
acrZp,71.0,70,0,GCACGCCTTGCAATAGCTTG,70,465775
acrZp,71.0,70,0,GATAAGGCCCGGTTTCAGGT,70,447935
acrZp,71.0,70,0,CTTCAAACTCCGAGCCGAGA,70,455915
acrZp,71.0,70,0,CATCTAAAAACTGGCTGAAT,70,411431
acrZp,70.0,69,0,TTACTGGGTGCGGAAGATAA,69,459300
acrZp,70.0,69,0,TGCTCCGATAGAGCACGCAA,69,458463
acrZp,70.0,69,0,TGAAGTATTGAGGGTGTATT,69,436738
acrZp,70.0,69,0,TCGCAAGCTACGAGGATCCA,69,435730
acrZp,70.0,69,0,TAGAATCGTATAAAGTTTTC,69,446353
acrZp,70.0,69,0,CTGGTCAAGGTGAGGCCGCG,69,426513
acrZp,70.0,69,0,CGCTGTGAAAGTGAGGGAGC,69,422350
acrZp,69.0,68,0,TTTTGTGTATTGCCACGTAT,68,437037
acrZp,69.0,68,0,TCCACGCCACACCAGAGGTT,68,434818
acrZp,69.0,68,0,GTACTGCTTCATAGAATTTT,68,429237
acrZp,69.0,68,0,AATCCTGAGGCCAGGCAAGC,68,453705
acrZp,68.0,67,0,GTCGATATGCGACGTACAGG,67,412518
acrZp,68.0,67,0,GACTGAACGTACAGTGTCGT,67,443630
acrZp,68.0,67,0,CTTTGGCAGGCATCCTGACT,67,413951
acrZp,68.0,67,0,CTATAATATTGTATTTAGAG,67,422214
acrZp,68.0,67,0,CAGTACTAAACGGCTCGTGC,67,414850
acrZp,68.0,67,0,ATGCGGCTCGGACGGCTTAC,67,439822
acrZp,68.0,67,0,AATGCCAGTTAAAAGAGTAG,67,434566
acrZp,67.0,66,0,TATACCAACTCCAAGTAAAT,66,409007
acrZp,67.0,66,0,GGAATGGCAGCCTAACCGGA,66,448257
acrZp,67.0,66,0,GCCGTACACAGTCTGCTATA,66,444136
acrZp,67.0,66,0,CCGAGACTGTCAATTCAAAC,66,441987
acrZp,67.0,66,0,AGTAAGTGGTTCATTAAGCG,66,422449
acrZp,67.0,66,0,AGCAAACAAAGTTAGATTGA,66,454001
acrZp,67.0,66,0,AAGTTGTCCCGGTAGACTCC,66,418605
acrZp,66.0,65,0,GGCAGTCTTAAATCCTCGCA,65,452479
acrZp,66.0,65,0,GAATGAACGACCTTCTGTCA,65,443104
acrZp,66.0,65,0,CGAACGACCGGCCGCCCCAC,65,467019
acrZp,66.0,65,0,CATTGCGTGGCTTAGTCTCC,65,417843
acrZp,65.0,64,0,TGGCTTACCATCTGATAATA,64,411724
acrZp,65.0,64,0,GGCTTTTCCAGGCAATAATC,64,429830
acrZp,65.0,64,0,GCTCAGGGCTCCCGCACCCA,64,460843
acrZp,65.0,64,0,CTTGTACCAAGATCCGCTTA,64,440445
acrZp,65.0,64,0,AACGAAAGATCGTGCGATGG,64,451768
acrZp,64.0,63,0,TTGCTTCCAAGATTCGGTAT,63,412732
acrZp,64.0,63,0,TACTGGTCTATAACTCGGGC,63,451517
acrZp,64.0,63,0,GATGCAGATTAACAAGGTCG,63,432227
acrZp,64.0,63,0,CGTGATGCCCTAAGCTCGAA,63,433677
acrZp,64.0,63,0,CCTTGTTGCTTGTGCCCAGC,63,409563
acrZp,64.0,63,0,CCTCATGTATGCGGTTAGAA,63,417522
acrZp,64.0,63,0,ATTTGGGTAGAATCCACTCA,63,453376
acrZp,63.0,62,0,TAGAGCCATCGGCTCATGTC,62,434579
acrZp,63.0,62,0,TAATTTTCCTCACGCCTGTT,62,437903
acrZp,63.0,62,0,GTGTGTTAAGCTAATACTGC,62,459489
acrZp,63.0,62,0,CCTTTTATGTTTGTTCAAAG,62,467350
acrZp,63.0,62,0,ACAGGGTGCTTGCCTCAATG,62,467594
acrZp,62.0,61,0,TCATATAAGCGAAGCTCAGA,61,450608
acrZp,62.0,61,0,TCAGGTGACGTCGGTCTTTC,61,446763
acrZp,62.0,61,0,TAGCTATGTCTGGATCCAGT,61,449022
acrZp,62.0,61,0,TAACCGGTTGTCTGTAGCCA,61,437132
acrZp,62.0,61,0,GCCAACGTACCGGCACCAGA,61,458985
acrZp,62.0,61,0,CACCCAACCGGCCGTCTCTC,61,443615
acrZp,62.0,61,0,ATCGATTCCGTTGAGACAAA,61,428741
acrZp,62.0,61,0,AGATAGACGGCGATCGGGCG,61,435497
acrZp,61.0,60,0,TCCCGACGGGTTTATTCACA,60,457533
acrZp,61.0,60,0,TATTGAATGCGACTTCAAGC,60,455198
acrZp,61.0,60,0,CCACTTTACGGTGTCTGCAA,60,458279
acrZp,61.0,60,0,CACACTATATCCCGGATTAT,60,460469
acrZp,61.0,60,0,AATTTCAGCGTGAGTAGTCA,60,425561
acrZp,61.0,60,0,AATCGGCAGTCGGCGCATCA,60,461534
acrZp,60.0,59,0,TTGTTTTTATGTTTCGCGGC,59,418961
acrZp,60.0,59,0,ACGTAACGACAAGTCTAGCA,59,456113
acrZp,59.0,58,0,TGTTTGGAACACTCAGCGGA,58,429315
acrZp,59.0,58,0,TGACTAGCAGCCCGAGCCCT,58,460295
acrZp,59.0,58,0,GGTAGTGGTTTGGAGGTCGT,58,446236
acrZp,59.0,58,0,GGAGTTCGAAAATGCGATGT,58,451578
acrZp,59.0,58,0,GCTACGAGCCGCGGCATAAG,58,464156
acrZp,59.0,58,0,CCAGGTATAAGACAGTAACG,58,462178
acrZp,59.0,58,0,CACACCGGGCATAAGTAATA,58,439871
acrZp,58.0,57,0,TTGTTCGGAACTATTCCGAT,57,465508
acrZp,58.0,57,0,TTGGGAAGCATTGTTGTTGC,57,426649
acrZp,58.0,57,0,TGGTTTAAACCGGGTCCCAA,57,417315
acrZp,58.0,57,0,TGAGGTAATGTGTAGATATG,57,457640
acrZp,58.0,57,0,TAGCTGAGGTTACCCGACGT,57,428168
acrZp,58.0,57,0,GGTGTTAAATTAACAAATGT,57,457946
acrZp,58.0,57,0,GACCCGAGTGTGTAGTGCTT,57,459336
acrZp,58.0,57,0,CTACAATTTTGGTATAATAT,57,462053
acrZp,58.0,57,0,CACTAAAAAGAATCGGTAGC,57,425178
acrZp,58.0,57,0,CACATATATCCACGGCCTAA,57,425314
acrZp,57.0,56,0,TAACCCCAGGGCAAGACGTC,56,414685
acrZp,57.0,56,0,GGTCTCCTGTGAACGACATC,56,419753
acrZp,57.0,56,0,GGTCGCGCAAGGTATCCGGT,56,443236
acrZp,57.0,56,0,GGGACTTCCAGTTTTATCTC,56,462205
acrZp,57.0,56,0,GGCGCCGGACTGGTTTTATG,56,436879
acrZp,57.0,56,0,GACGTTCAGTTCAGTACCCC,56,450488
acrZp,57.0,56,0,CTAAATTTCATATGAAGCTG,56,429620
acrZp,57.0,56,0,CCTCTCCGAAATTGAATGCT,56,438761
acrZp,57.0,56,0,CCCGGATATAAAGCGCATCA,56,427245
acrZp,57.0,56,0,AGCTCAGTAGGAACAGGGCT,56,436079
acrZp,56.0,55,0,GTCTCTATGCGAGCATCTCT,55,437913
acrZp,56.0,55,0,GAGGGCCATAGTTGTTAACG,55,415803
acrZp,56.0,55,0,ATATGAAGGTCCCCAATAAT,55,426404
acrZp,56.0,55,0,AGAGGGTGAACGCGCCAGAC,55,460560
acrZp,56.0,55,0,AAGAGCCGCGCCAGCTAGGT,55,424198
acrZp,55.0,54,0,TGTTTGCCAAAGGGGGACCT,54,413205
acrZp,55.0,54,0,TGACAACAATAAAAGGCACT,54,458175
acrZp,55.0,54,0,GTGCAGCCACGACGTCAAAA,54,445734
acrZp,55.0,54,0,GCTGTCCATACCCAGTAAAA,54,421610
acrZp,55.0,54,0,CTGGCGGGTTCTCAGACCCA,54,433833
acrZp,55.0,54,0,CATAGTGATAGTGCAGTTGA,54,415518
acrZp,55.0,54,0,AAGGGGCGGTTTGAACGATT,54,451721
acrZp,54.0,53,0,TCGGTGGTGTAATTGGGTCT,53,449844
acrZp,54.0,53,0,TATACAGTAACGATTAATAT,53,449338
acrZp,54.0,53,0,GTGAGACAGCACACTATCCC,53,452847
acrZp,54.0,53,0,CGGGCTTGAAAACAGGATGA,53,433335
acrZp,54.0,53,0,ACAACGGAAGTTAGGACTCA,53,426679
acrZp,53.0,52,0,TGCCTAGGACCGGGTAAAGA,52,420007
acrZp,53.0,52,0,TCCGTTATCATGACATCACA,52,417189
acrZp,53.0,52,0,CCGTGCCTTGCATCAAATTC,52,431318
acrZp,52.0,51,0,TCATGAATTTGTACGTAGCA,51,437186
acrZp,52.0,51,0,GCGTACTCTTCCTATTTCAA,51,439167
acrZp,52.0,51,0,GATTCAACTCCGTCTGCTAA,51,426840
acrZp,52.0,51,0,CGTTGGTAACATATCCAATT,51,452339
acrZp,52.0,51,0,CGTGGGATATGGATTGAAAG,51,466279
acrZp,52.0,51,0,AATTACAAGGTTAGAATGCA,51,441170
acrZp,52.0,51,0,AAACCATCTCTTGGGTTTGT,51,415537
acrZp,51.0,50,0,TTATAAGTCGTGAATGGACG,50,461025
acrZp,51.0,50,0,TAAGTAAAGATGTCTAATCT,50,409714
acrZp,51.0,50,0,AATTACTCCCTCCTTGCAAG,50,432861
acrZp,50.0,49,0,ATTAGGGGAATGATAACTAT,49,454241
acrZp,50.0,49,0,AATTGATCTTCGCACTCCGG,49,415670
acrZp,49.0,48,0,GAGGCGCAATTTCTACCAGT,48,467451
acrZp,49.0,48,0,GAACGGGACTAAAATTCTTG,48,446561
acrZp,48.0,47,0,TACCTGCGGATGATCAGGAC,47,450728
acrZp,48.0,47,0,GTAGTTCGGTTATGCAATAG,47,447876
acrZp,48.0,47,0,GATAGAACGTATTATTAGCT,47,437095
acrZp,48.0,47,0,CCCACTGGTCACACGCGCAA,47,460625
acrZp,47.0,46,0,TCGAGCCCGTGTGCACCCCC,46,422257
acrZp,47.0,46,0,TCAAGGATTTGTGGTGCTCA,46,458585
acrZp,47.0,46,0,CTGGGAGTTGGCACAGTTAT,46,438387
acrZp,47.0,46,0,CTGATGCAGACGCTTTGAGC,46,450019
acrZp,47.0,46,0,CCCCCGCCTTATACTGGGAT,46,436274
acrZp,47.0,46,0,CAAGGTGGGATAGTCGCGAC,46,450732
acrZp,47.0,46,0,AACACCCAGTTTATGGATAC,46,460289
acrZp,46.0,45,0,TCGTTGCCAGCTGCTGAACT,45,444226
acrZp,45.0,44,0,GATCTTGCGTGCACATCGAT,44,417492
acrZp,45.0,44,0,CATGAACTGCCGGAATTAGC,44,446769
acrZp,45.0,44,0,ACGGCCCTCCAATAGACGTT,44,450630
acrZp,44.0,43,0,CCCTCAAGCGTTGACAGATG,43,445528
acrZp,44.0,43,0,AGCGGGAGGTAGGTAAAATT,43,417072
acrZp,43.0,42,0,TGGTCCTCTACCACTGATTC,42,458581
acrZp,43.0,42,0,GGGCTCCCTTAGACGGAAAA,42,409717
acrZp,43.0,42,0,GACGACTCGGTATTGGAGAA,42,436316
acrZp,43.0,42,0,CTTCATGCACCAACGTATTA,42,422555
acrZp,43.0,42,0,CGTACTAGACTGCCGCAAAC,42,409106
acrZp,42.0,41,0,GCAGGGTTATTCTTAGCAAT,41,415864
acrZp,42.0,41,0,ACCCGTATCTTGTCTGGCTT,41,460741
acrZp,41.0,40,0,TCCGGTTCGGTCTCTTTTAG,40,434505
acrZp,41.0,40,0,TCCGCAAAACTGCGTCTCCT,40,436942
acrZp,41.0,40,0,GCTTGGTATGCCAGCTAGTA,40,421991
acrZp,41.0,40,0,CGCTGGGCTTTTCCGGATAC,40,422104
acrZp,41.0,40,0,ACAAAGAGCGTTGCGTGCCT,40,434665
acrZp,40.0,39,0,TGCCCCAGCCAACTCGTCGC,39,410185
acrZp,40.0,39,0,TATGCGGTTCAAAGGTATCA,39,466967
acrZp,40.0,39,0,ACTATGCAAGATGCTCTGGT,39,437782
acrZp,40.0,39,0,ACGCTTGTCACGGCATATAA,39,430948
acrZp,39.0,38,0,TACTAGGTCTTGTCCGTTCT,38,440882
acrZp,39.0,38,0,TACAATAGTTGACTAAGACT,38,467460
acrZp,39.0,38,0,GGACACAGGTCTTAGCGCGG,38,409310
acrZp,39.0,38,0,CAACGAATGACATCTATGTA,38,451086
acrZp,38.0,37,0,CGACTTTTTTACATTCCTCC,37,418964
acrZp,37.0,36,0,TTATGAGCACAACTCTTAAG,36,451171
acrZp,37.0,36,0,TACAACTATGCTGCGTGTGT,36,439776
acrZp,37.0,36,0,GTGGGCGTCCACTTGAACCT,36,438711
acrZp,37.0,36,0,CCTATGGGCTGATGCTGCGT,36,413425
acrZp,37.0,36,0,ATGGCGTTTATTCAAGCAGC,36,461640
acrZp,37.0,36,0,AGTTGGGATCGGTTAAAACA,36,445061
acrZp,36.0,35,0,TGGATCAGTGAGATCATACT,35,416212
acrZp,36.0,35,0,TAAGGGCAGATGAGTCTATG,35,456928
acrZp,36.0,35,0,GGACGGGGTCCGTCATCTCC,35,451206
acrZp,36.0,35,0,CGCGCAAAATGATCTATGGC,35,429416
acrZp,36.0,35,0,CCGTTACTGTCAAGAGCGAC,35,458266
acrZp,36.0,35,0,CCGATCGAAACTGGCACGTT,35,431421
acrZp,36.0,35,0,CCCTATCTTCGTTCATGGAC,35,453876
acrZp,35.0,34,0,TGGCTTGTTACAAGACAATG,34,413076
acrZp,34.0,33,0,GATCCAGACCGTATGTACCT,33,423330
acrZp,34.0,33,0,ATTCCTGAGCGAGTTACCTT,33,435539
acrZp,33.0,32,0,CCCATTACTATGAGCAAGTT,32,459330
acrZp,32.0,31,0,TTATATTTTAGATAATCGGT,31,446433
acrZp,32.0,31,0,TGCAATCGATTATTCCCCCT,31,416683
acrZp,32.0,31,0,GTGTTTCTGCTGACGAACTA,31,454003
acrZp,30.0,29,0,GGCGTGACAGGCGAGAACCA,29,461309
acrZp,30.0,29,0,GGCAGGAACTGATGACATGC,29,466751
acrZp,30.0,29,0,CGCACGCTGAAAGGATGTCT,29,410313
acrZp,29.0,28,0,TGTGGTAAGTGGCTAAACAT,28,439426
acrZp,28.0,27,0,TTCGTCACAGGGACCTGCAT,27,449395
acrZp,26.0,25,0,TGTCTTGAATCAGCTCAGTC,25,435009
acrZp,26.0,25,0,GTCAGTCATCGATACTCACC,25,467582
acrZp,26.0,25,0,GCCTTCAGGGTAATACAAGG,25,421161
acrZp,26.0,25,0,CCTGCCGCGATTATAAAAAT,25,465401
acrZp,25.0,24,0,TAGCAATTGCAAGCTCCAAA,24,419099
acrZp,25.0,24,0,CCCACAGAGCGTTTCCCTCT,24,417104
acrZp,23.0,22,0,TCGTCGTTCGCTGTACCTCG,22,426707
acrZp,23.0,22,0,ATCTTTTTGGGCGCTTCTCT,22,448130
acrZp,22.0,21,0,CATCATCTGGTTTATTTTTC,21,453021
acrZp,22.0,21,0,AGGATCTATTACAGCGCAGC,21,452536
acrZp,21.0,20,0,ACTGTCTCCCTGCCTCAACG,20,419245
acrZp,20.0,19,0,CTTGCTGGGCATTCGGGGCT,19,424188
acrZp,20.0,19,0,AGGAAAAATGTAACTCAGAC,19,452090
acrZp,19.0,18,0,GGTGTTCAGTTTCTGGCGCA,18,421589
acrZp,19.0,18,0,GCCCTGTTAGCTCATCTCCT,18,410624
acrZp,17.0,16,0,TGCTTGAACTAAGATCCCCT,16,447643
acrZp,17.0,16,0,GCCGGAGGGAGGACGATGCA,16,423830
acrZp,16.0,15,0,GTTTTCATCGAGCACGCAAT,15,434264
acrZp,16.0,15,0,GCAGCATACCACCAAAGTCC,15,440870
acrZp,16.0,15,0,CTTCAGGGCTGGGACCCTCG,15,447692
acrZp,16.0,15,0,AAATCCGGCTGCTCAAAGCA,15,412690
acrZp,15.0,14,0,TTTACTATCATATCTGACAC,14,425173
acrZp,15.0,14,0,CACATAGGCTACCGATGCGC,14,437840
acrZp,14.0,13,0,GCGAGGGTCAAAACAGCAGA,13,451960
acrZp,13.0,12,0,GGGGCACAGGAAGTAAGCCC,12,452488
acrZp,13.0,12,0,GCACCCTAGTATTCGCCAAA,12,440796
acrZp,13.0,12,0,CTGGTTCCTGGTAAAGACGC,12,421685
acrZp,13.0,12,0,CGTCTCGAGCGTTTTCGCTA,12,424157
acrZp,13.0,12,0,ATGCGGGTTGTCACGGGTCA,12,467080
acrZp,12.0,11,0,TTATGGCTGGCTAAGACCGG,11,428316
acrZp,12.0,11,0,GCTGGCACCATATCGAGGAT,11,460277
acrZp,12.0,11,0,CCATCATATCAGCTTTTCGT,11,429312
acrZp,12.0,11,0,ATAGAAGTGTATGATCTTGA,11,438089
acrZp,11.0,10,0,TCTAGACGCGCGCTACGACG,10,417805
acrZp,11.0,10,0,TACTTACACATCGGTGACGC,10,432888
acrZp,10.0,9,0,CTGGATGTTTATGCTCCTCT,9,436041
acrZp,10.0,9,0,ACACTTCTCAAAGTTAGCCG,9,441179
acrZp,9.0,8,0,TCGGATCCTGCCTCATACTC,8,430737
acrZp,9.0,8,0,GTGGAGGGCTCCGTAGGTCT,8,421159
acrZp,9.0,8,0,CCTAAGCGTATCTTGCCTAA,8,461483
acrZp,8.0,7,0,TCAAGGGTTGCGACGTGAGA,7,445594
acrZp,7.0,6,0,TATGGAACCTTAAGAATCTG,6,427145
acrZp,7.0,6,0,GGGGCATTGAGTCTCTTCCT,6,438786
acrZp,6.0,5,0,TCTAGAATGGGGCCAGACTT,5,435434
acrZp,6.0,5,0,CAGCCCTCACACCGCGCTTG,5,428187
acrZp,5.0,4,0,CGGCGCAAAGTACAGGTCTA,4,444611
acrZp,5.0,4,0,CAGTATGTGGCGGCACGCGA,4,461310
acrZp,4.0,3,0,TAGCGGGATTGCAGGGCGTT,3,445664
acrZp,4.0,3,0,GTTCAGGCCGAGAAAAACAG,3,465090
acrZp,4.0,3,0,GTGCTAGGGTCAAGATGGCT,3,466996
acrZp,4.0,3,0,GTGACCCTGGGCCGGCCCAG,3,432674
acrZp,4.0,3,0,GGGTTGCTGGGTTATGTTCA,3,450444
acrZp,4.0,3,0,GGGGCACCATTGTGTGAGAA,3,447399
acrZp,4.0,3,0,GATTTGTTCGCTCTTGGCGG,3,417173
acrZp,4.0,3,0,GATATCTATTGGGCTCCAAG,3,444011
acrZp,4.0,3,0,CTTTTATAAGGCAATACAGC,3,415341
acrZp,4.0,3,0,CCTATTTACCTCGGGGCAAG,3,418410
acrZp,4.0,3,0,ATCAGAATAGTACCCCCCTG,3,438845
acrZp,4.0,3,0,AGTCTGACAAGAGGCTACTT,3,433327
acrZp,4.0,3,0,AGTCATCTTCATCTCTCCTA,3,429850
acrZp,4.0,3,0,AGCGGGAGACCGACACCGGA,3,436463
acrZp,4.0,3,0,AGCCGAGATCCAGGACGATT,3,427524
acrZp,4.0,3,0,ACTTGACGCAATCGAGGGCT,3,440912
acrZp,4.0,3,0,ACGGGACACCATTCGTATGG,3,462093
acrZp,4.0,3,0,AACGGCACCTTCCAGCAGAG,3,461679
acrZp,3.0,2,0,TTTTGATAGCAATACGGTTC,2,440092
acrZp,3.0,2,0,TTCATCAAAACAGAAAGACC,2,408799
acrZp,3.0,2,0,TTAGCAGGCGGAGTCATACT,2,429419
acrZp,3.0,2,0,TGGTGCCAAATCGATGTTAT,2,466018
acrZp,3.0,2,0,TGGGTACACTAGGGCGCTAC,2,427466
acrZp,3.0,2,0,TGGACTTGCCAATCGGAATG,2,425759
acrZp,3.0,2,0,TGAACGCGGTCAAGTTCCAT,2,446691
acrZp,3.0,2,0,TCTCATACAAACGTGGTCAA,2,418429
acrZp,3.0,2,0,TCGTTTGCCAGAATGTTGAT,2,427887
acrZp,3.0,2,0,TCCACGCACCCTCCTAGCAG,2,426993
acrZp,3.0,2,0,TCAAGGCGACAGCTTCACGC,2,418640
acrZp,3.0,2,0,GTTTCAGGGCGGCCGGGATT,2,422207
acrZp,3.0,2,0,GTTATAATCTTAGGCCGTAA,2,417854
acrZp,3.0,2,0,GTGACTTCGGTCGCATGCAG,2,454333
acrZp,3.0,2,0,GTAACACATTCCGGCGGCTA,2,435496
acrZp,3.0,2,0,GGTCTTAGTCCTCTGAAATT,2,417956
acrZp,3.0,2,0,GGTATATAATTCCTGTAGAG,2,456069
acrZp,3.0,2,0,GGGGCAGGGACGACAGCTGA,2,432234
acrZp,3.0,2,0,GGGCCTCAAAGCGAAGTCAA,2,438736
acrZp,3.0,2,0,GGCAGCCACTGGACGTACGG,2,454935
acrZp,3.0,2,0,GCTAGTGATAGTCGGGCGTG,2,458054
acrZp,3.0,2,0,GCCGACCTACGTCGCATCCA,2,452047
acrZp,3.0,2,0,GCACAAACTGAAAATCTTTC,2,438802
acrZp,3.0,2,0,GAATCCGTCGGTCACGCGAA,2,422661
acrZp,3.0,2,0,CTTGGCGTTTCAAGTACGGC,2,442054
acrZp,3.0,2,0,CTTCAATGTAGCAAGGCTAC,2,458352
acrZp,3.0,2,0,CTTAGGTCCCAGAATGGATT,2,448112
acrZp,3.0,2,0,CGCATGCGCTACGGAACGGT,2,445958
acrZp,3.0,2,0,CGCATCCTACAAATTACTGT,2,451005
acrZp,3.0,2,0,CCCACCCGATCTTGTCATTA,2,416339
acrZp,3.0,2,0,CCACTATTGGACCGTCCGGA,2,422086
acrZp,3.0,2,0,CCAAAAGATTCACACGATAT,2,432467
acrZp,3.0,2,0,CAGTGAGCATCCCGAATATC,2,426794
acrZp,3.0,2,0,CAGCTTACACATATCATGGA,2,433699
acrZp,3.0,2,0,CAGCGGCATGAAAGGCTGCT,2,457586
acrZp,3.0,2,0,CACATTCGGCCCAATAGCAG,2,466394
acrZp,3.0,2,0,CACACTGGTCGCACCCCGGT,2,410696
acrZp,3.0,2,0,CAACGCGATGCGGTCACTCT,2,437285
acrZp,3.0,2,0,CAACCTATTCACACTCAAAG,2,443207
acrZp,3.0,2,0,ATTGTGCTTAGCGCTAGATT,2,431771
acrZp,3.0,2,0,AGTGCCACGTAATCGAAATC,2,435907
acrZp,3.0,2,0,AGCTTTCACAGTGATCGTGG,2,424181
acrZp,3.0,2,0,AGCTAGGGAGCCATACCCAA,2,459897
acrZp,3.0,2,0,AGCGGACATAGCTAACGGTA,2,445949
acrZp,3.0,2,0,AGCATACCATTGCGGTGGAC,2,453173
acrZp,3.0,2,0,ACTAGTTGGTGGGGGTATCA,2,425069
acrZp,3.0,2,0,ACGAATTTGTCCCGCGCATG,2,416310
acrZp,3.0,2,0,AACGGCTTTCGGAGTCATCA,2,417893
acrZp,2.0,1,0,TTTTGGCTTAAGCGGCTAAT,1,461092
acrZp,2.0,1,0,TTTTCCGTCCGTAGCCCAAA,1,456139
acrZp,2.0,1,0,TTTTAACCGAGCCACAAAAG,1,422682
acrZp,2.0,1,0,TTTGATGACGGGTATCTTGC,1,435266
acrZp,2.0,1,0,TTTGAAACTCTATGCGGCCT,1,424534
acrZp,2.0,1,0,TTTCTTACGTGTGATAAGTG,1,456143
acrZp,2.0,1,0,TTTCTACCATCAGAGTATGT,1,433961
acrZp,2.0,1,0,TTTCTAATCGGTGGACCCAC,1,426089
acrZp,2.0,1,0,TTTCAAAATAAGTCAGTTGG,1,447341
acrZp,2.0,1,0,TTGTTAGCTTCCTATAGCGA,1,452376
acrZp,2.0,1,0,TTGTGCGCGTAAATTTATTC,1,415273
acrZp,2.0,1,0,TTGTCCGCGCTATAGCGTGG,1,413068
acrZp,2.0,1,0,TTGGTTTAACGTATGGGATT,1,448289
acrZp,2.0,1,0,TTGGGTACTAAGTTGTAGCG,1,437694
acrZp,2.0,1,0,TTGAGGCGAGTCCAAGTGTG,1,421863
acrZp,2.0,1,0,TTGAGAGTGGGGAAACGGTC,1,451320
acrZp,2.0,1,0,TTGAACGCTGTTAACACCGA,1,424684
acrZp,2.0,1,0,TTCTGTCCGATTGTTGACAG,1,424189
acrZp,2.0,1,0,TTCTGGTAGATAACTTTGGG,1,443714
acrZp,2.0,1,0,TTCTAAGAGAGTACTAGCGT,1,430371
acrZp,2.0,1,0,TTCGGACAGACCGTATAACA,1,453275
acrZp,2.0,1,0,TTCGAGCTAGGTAGGCCCTA,1,433619
acrZp,2.0,1,0,TTCAGGAAGCGAAATACCTA,1,458911
acrZp,2.0,1,0,TTCACCCCGGACCCTTGGCA,1,430366
acrZp,2.0,1,0,TTATGTTTAGAAACAGAGAG,1,437777
acrZp,2.0,1,0,TTATGATTCCTAAGTACCTG,1,448842
acrZp,2.0,1,0,TTAGTGTGTCGCCCGCTGTT,1,449604
acrZp,2.0,1,0,TTAGGGAGCGTAGGAATTTG,1,457263
acrZp,2.0,1,0,TTACTGAAGGGGTGATGGAT,1,451579
acrZp,2.0,1,0,TTACTCGCTTCCGCGTGTGA,1,409818
acrZp,2.0,1,0,TTACCCAGCGTTGCCCAAAA,1,419401
acrZp,2.0,1,0,TGTTCCTATTGCTCTCGGTC,1,414803
acrZp,2.0,1,0,TGTGTATATAACCACTAATA,1,466912
acrZp,2.0,1,0,TGTGTAACAGACTACAGCTG,1,412532
acrZp,2.0,1,0,TGTGGATAGGCTTGGTTAAT,1,462870
acrZp,2.0,1,0,TGTGGAGCAGAATGCTTCGG,1,421279
acrZp,2.0,1,0,TGTGCAGTACGGAACAGAGG,1,430796
acrZp,2.0,1,0,TGTCTTACCATCGTACGTAT,1,453058
acrZp,2.0,1,0,TGTCGATAGTCTCACAGAAT,1,443390
acrZp,2.0,1,0,TGTCAAGTACGGTAATTCTC,1,435573
acrZp,2.0,1,0,TGGTGGGATTGAATTTACCC,1,446614
acrZp,2.0,1,0,TGGTCGTGCAATTTCCGATC,1,419769
acrZp,2.0,1,0,TGGGTGTTGGTGTTCCGGGA,1,424447
acrZp,2.0,1,0,TGGCTTTACTTTAGACAATA,1,412873
acrZp,2.0,1,0,TGGATGCGCATCCGGCTCCC,1,445588
acrZp,2.0,1,0,TGGAGCCGATCTTATGGAAT,1,422685
acrZp,2.0,1,0,TGGAAGTACCTGCGGAACGC,1,456437
acrZp,2.0,1,0,TGCTCACATCCGAGATAAAT,1,423705
acrZp,2.0,1,0,TGCTAATTGTTCTCCCAAGT,1,427944
acrZp,2.0,1,0,TGCGGTCACATTCGGGTCTT,1,452347
acrZp,2.0,1,0,TGCCCGATTCAGTGCTCAAT,1,463595
acrZp,2.0,1,0,TGCAATCCGATGAATTAAAA,1,411169
acrZp,2.0,1,0,TGATCTGTAGCGTGTTCACT,1,447795
acrZp,2.0,1,0,TGATCTAGGGTAAGTCTAGC,1,461875
acrZp,2.0,1,0,TGATAGCGGCGTCTCCTTAC,1,435632
acrZp,2.0,1,0,TGATAAAACCTCACTGCCAG,1,437954
acrZp,2.0,1,0,TGAGTGGTTACTCGCCACCC,1,436223
acrZp,2.0,1,0,TGAATGTGCACTGGAACCAT,1,456440
acrZp,2.0,1,0,TGAATAATTGGTCGGTGAGG,1,415282
acrZp,2.0,1,0,TGAAGAGCGCACCGGTTGAT,1,442235
acrZp,2.0,1,0,TGAACTACAAGAATGTAAGA,1,439072
acrZp,2.0,1,0,TGAAAACTTATACAGAGGAA,1,421157
acrZp,2.0,1,0,TCTTTTTAGAATGATCCTAA,1,454710
acrZp,2.0,1,0,TCTTTTTAAAGCCACCCACT,1,450918
acrZp,2.0,1,0,TCTTTGCCGCGGCCACTTTT,1,444331
acrZp,2.0,1,0,TCTTGTTCAAATACATATGT,1,415074
acrZp,2.0,1,0,TCTTATTCATCTAGTTCGCT,1,455822
acrZp,2.0,1,0,TCTGTCCTTGCTTTAAACGT,1,451655
acrZp,2.0,1,0,TCTGTACAGGCTCCAATTGG,1,418852
acrZp,2.0,1,0,TCTGCTTGTAGTTTGTGAAC,1,436777
acrZp,2.0,1,0,TCTGCGCGGTAGTCCCTCCT,1,411149
acrZp,2.0,1,0,TCTCTCAATAGCGAGAATGG,1,453234
acrZp,2.0,1,0,TCTCGGTGCTTGCTCACAAT,1,455528
acrZp,2.0,1,0,TCTCGGGGGACTTTTTGACC,1,437739
acrZp,2.0,1,0,TCTCAGCTGATAACTCAGCT,1,426750
acrZp,2.0,1,0,TCTATTGGCATAAGACCACT,1,455038
acrZp,2.0,1,0,TCTAATATGCCCAATCTTTG,1,442877
acrZp,2.0,1,0,TCTAAAGCGTCAGGCCTAGT,1,435226
acrZp,2.0,1,0,TCGTTACACGACACCTTGGG,1,419512
acrZp,2.0,1,0,TCGGTTAACCCTCGAGGGAA,1,458368
acrZp,2.0,1,0,TCGATTTAAATCTTCCTGTA,1,451140
acrZp,2.0,1,0,TCGATCACGGGTGGAGTTGA,1,445430
acrZp,2.0,1,0,TCGACAGTATTGGAGACAGG,1,423337
acrZp,2.0,1,0,TCGAAGCGCACTCTATGTTA,1,444082
acrZp,2.0,1,0,TCCGTCGGGGTTTCCCAGTA,1,410152
acrZp,2.0,1,0,TCCATGCTTTCGATGTGGTG,1,457060
acrZp,2.0,1,0,TCCATAATTGGGAGATGTTA,1,454450
acrZp,2.0,1,0,TCCAGTGTATAAGTCCGCGG,1,443159
acrZp,2.0,1,0,TCCAATCCGGTCAGTGTAGA,1,466987
acrZp,2.0,1,0,TCATAGCGAGGACTGATGAG,1,457005
acrZp,2.0,1,0,TCAGGGTTGTCATCTGACAT,1,437748
acrZp,2.0,1,0,TCAGAAATTTCTTTCCTATA,1,420727
acrZp,2.0,1,0,TCAGAAAACTGCAATCCTTG,1,464475
acrZp,2.0,1,0,TCAATGGCTAGGTGCTAGAA,1,449240
acrZp,2.0,1,0,TATTAGCCTCGTGTGCAGGC,1,412552
acrZp,2.0,1,0,TATGGCCGCTGAGTAATCTA,1,441095
acrZp,2.0,1,0,TATGACGGTACGTTGATCTG,1,424029
acrZp,2.0,1,0,TATCTTCCAAAGAAGGCAGG,1,462738
acrZp,2.0,1,0,TATCTGATCGCATTGAATCG,1,423193
acrZp,2.0,1,0,TATCGATACCGTGCTTTTAT,1,436065
acrZp,2.0,1,0,TATAAGCTATTGTTCGGTAT,1,432739
acrZp,2.0,1,0,TAGTAATAGTGCCCCGGCCT,1,431138
acrZp,2.0,1,0,TAGGTGGTTTGTCTCATACA,1,464564
acrZp,2.0,1,0,TAGGTAGGATGCTAAGCGAG,1,435892
acrZp,2.0,1,0,TAGCGGGCCTGATTCCATTA,1,414173
acrZp,2.0,1,0,TAGCGAAGGGCTGAACCAGG,1,447553
acrZp,2.0,1,0,TAGACGCTGTCTCCGCTCTA,1,432772
acrZp,2.0,1,0,TAGACGAGACCAGGAAAGCA,1,457188
acrZp,2.0,1,0,TAGAAGGGTTTCGTGGTGCT,1,450890
acrZp,2.0,1,0,TACTGTGTACGTCTCTAGTC,1,454968
acrZp,2.0,1,0,TACTCTAGGGTTCAGAGCCT,1,442372
acrZp,2.0,1,0,TACTCGATCGAAAGCTGCAG,1,459726
acrZp,2.0,1,0,TACGGGGACACGGATCAAGT,1,447365
acrZp,2.0,1,0,TACGCGGACTTTGTGAGTGC,1,438665
acrZp,2.0,1,0,TACGATTGAATACGGCACCA,1,412231
acrZp,2.0,1,0,TACCATCTTGAGAACTTGAG,1,449239
acrZp,2.0,1,0,TACAGTTTCCCTTCACCCTG,1,451559
acrZp,2.0,1,0,TACAAGTTAGCGAACTGGTT,1,419109
acrZp,2.0,1,0,TAATCGCTTTTGACCGAACC,1,443049
acrZp,2.0,1,0,TAAGAGGGCGGGGTATGATT,1,449419
acrZp,2.0,1,0,TAACTCTCACATGTTCGGCT,1,438364
acrZp,2.0,1,0,TAACTCTACAGTTCAGTGAC,1,445104
acrZp,2.0,1,0,TAACGCCTCTAGCCAGTTCA,1,466877
acrZp,2.0,1,0,TAACATGGAGTGCGGTCATA,1,439548
acrZp,2.0,1,0,TAACACCTTTCGGCAGCGAC,1,439986
acrZp,2.0,1,0,TAAACGAGGACGCGTCGCAA,1,409266
acrZp,2.0,1,0,TAAAAGGTCGAGTAACTCGA,1,451687
acrZp,2.0,1,0,GTTTTGATTCTGTGTATACT,1,439421
acrZp,2.0,1,0,GTTGTGCACGATGGTTGAAG,1,465463
acrZp,2.0,1,0,GTTGGAAATCAAGGAAGCTT,1,431010
acrZp,2.0,1,0,GTTGACATTATCGTGCGTGA,1,413686
acrZp,2.0,1,0,GTTCGCTTAGGGTAAAAGCC,1,419254
acrZp,2.0,1,0,GTTCGCTAAAGCAACTCGTT,1,436354
acrZp,2.0,1,0,GTTCCCTTTGGCGACGTATC,1,447695
acrZp,2.0,1,0,GTTCCCACTGTATGTTATCA,1,434569
acrZp,2.0,1,0,GTTAGGGACCCGTCGCCTCG,1,451535
acrZp,2.0,1,0,GTGTTACGAACAATAATGCG,1,453158
acrZp,2.0,1,0,GTGGTTCGAGGGTGATTTTA,1,428234
acrZp,2.0,1,0,GTGGCCTCTATATGATCTAT,1,457337
acrZp,2.0,1,0,GTGGACTCTAATTCAAAAGA,1,426051
acrZp,2.0,1,0,GTGGACAGGCCTCGTACCTT,1,413526
acrZp,2.0,1,0,GTGCTTCCCTCGACGAAAGG,1,461833
acrZp,2.0,1,0,GTGCTGTTGATTGCCCATCT,1,434014
acrZp,2.0,1,0,GTGATCCGGAGAATGAGCGA,1,412376
acrZp,2.0,1,0,GTGAGCTTATGGATGCAGAT,1,427475
acrZp,2.0,1,0,GTCGGGATCAGTTGCATTGT,1,451092
acrZp,2.0,1,0,GTCGGGAATTGCGACCTCTT,1,465007
acrZp,2.0,1,0,GTCGCGCCGACTTAGAGGTA,1,413084
acrZp,2.0,1,0,GTCCCATATACGTTTAAAGA,1,429109
acrZp,2.0,1,0,GTCCATCCATTGTTGGAAAA,1,427138
acrZp,2.0,1,0,GTCACGTGAGCGATGTGTGT,1,418346
acrZp,2.0,1,0,GTAGGATATCCGTGCCGAAA,1,421457
acrZp,2.0,1,0,GTAGATAGTCTATGGTTGGC,1,456016
acrZp,2.0,1,0,GTACCGCCCTACGTGAAGGT,1,415595
acrZp,2.0,1,0,GTACAGAAGCGTAGTAACAT,1,414703
acrZp,2.0,1,0,GTAAAGCCTCAGAACGCGGA,1,416768
acrZp,2.0,1,0,GGTTATGTTTCCAATGCCGG,1,410662
acrZp,2.0,1,0,GGTGCACATCAATTCTGGCA,1,412555
acrZp,2.0,1,0,GGTCCACGTACGGCCTTAAT,1,457863
acrZp,2.0,1,0,GGTCAGTAAGAAGAAGCTTT,1,434646
acrZp,2.0,1,0,GGTCACCGGCGTGAGCACCT,1,455093
acrZp,2.0,1,0,GGTATTCACTTTCTAAATAC,1,410964
acrZp,2.0,1,0,GGGTTTTGGTGTACACGCTT,1,409960
acrZp,2.0,1,0,GGGTTGGTTGTTGATTTTAT,1,424665
acrZp,2.0,1,0,GGGTCCAAGGTCGGGGCATA,1,460657
acrZp,2.0,1,0,GGGTCACAAACAGATCTAAA,1,445887
acrZp,2.0,1,0,GGGTAAGACTGGGCAGGTCC,1,409725
acrZp,2.0,1,0,GGGGCGAGAGCCACACCATG,1,450886
acrZp,2.0,1,0,GGGGACTCTCGATATTTTTA,1,434404
acrZp,2.0,1,0,GGGGACACATCTTAACTATC,1,408690
acrZp,2.0,1,0,GGGAGCCCTGGGAAACACGA,1,457850
acrZp,2.0,1,0,GGGAACTAGGTGGGCTCGGG,1,439326
acrZp,2.0,1,0,GGCTCAACGATCATGACTAC,1,439907
acrZp,2.0,1,0,GGCGTCGTTCATAGTGTACT,1,456457
acrZp,2.0,1,0,GGCGTAAGGGAAAGGGTCGG,1,428006
acrZp,2.0,1,0,GGCGGTTTGCGTATGCTGGA,1,423202
acrZp,2.0,1,0,GGCGGGTAAGTAGGTGGTGA,1,411022
acrZp,2.0,1,0,GGCCTCTGGCAAAACCCACC,1,416373
acrZp,2.0,1,0,GGCACGCCCACTAGATCACA,1,444242
acrZp,2.0,1,0,GGATTTGGAAAGGGGGTTTA,1,463716
acrZp,2.0,1,0,GGATTCTTCCCTGGTGGCCC,1,441208
acrZp,2.0,1,0,GGATGGGGATGTATACCTCC,1,460059
acrZp,2.0,1,0,GGATGACCCACGCGAGTCGG,1,411345
acrZp,2.0,1,0,GGAGCCGTCACAGGCATCAT,1,465282
acrZp,2.0,1,0,GGACAGGGGGATAAATTATC,1,434888
acrZp,2.0,1,0,GGAATAATATTGGATGATCA,1,409313
acrZp,2.0,1,0,GGAACGTTCCGGAGAACCGT,1,466589
acrZp,2.0,1,0,GGAACGTAGACTCACTAAGC,1,425508
acrZp,2.0,1,0,GCTGGGCAGTGTAAGGGATC,1,411933
acrZp,2.0,1,0,GCTGCCGCAACTCATACTAA,1,449009
acrZp,2.0,1,0,GCTCTTATCGAAAGAGTAGG,1,446673
acrZp,2.0,1,0,GCTCCATGACCTATTGAGAC,1,433762
acrZp,2.0,1,0,GCTCACATAATGTTGCAATG,1,461108
acrZp,2.0,1,0,GCTATTGCAAATCAGGAGCA,1,460168
acrZp,2.0,1,0,GCTATAATTACACTTAAAAG,1,428605
acrZp,2.0,1,0,GCTAGTTCCGCCATGATATG,1,451756
acrZp,2.0,1,0,GCGTGCAAAGAGAGTTTCTT,1,428189
acrZp,2.0,1,0,GCGTATCGGTATTACCCTAA,1,450312
acrZp,2.0,1,0,GCGCTCCTCGTGCTCAGCCG,1,417109
acrZp,2.0,1,0,GCGCCCTTTATGAATTGACA,1,454692
acrZp,2.0,1,0,GCCTGTATTAGCCGGTGTTC,1,454371
acrZp,2.0,1,0,GCCGTGGTGATACCGTCATA,1,429956
acrZp,2.0,1,0,GCCGGCACTACGTATACGAG,1,454593
acrZp,2.0,1,0,GCCGGATCACTATTTGCTTG,1,446603
acrZp,2.0,1,0,GCCCTTCGCAGGACAGATGA,1,414251
acrZp,2.0,1,0,GCCCGGTTGCCTGAGGCGTC,1,439715
acrZp,2.0,1,0,GCCAAATTGTAAAATGTTCA,1,438627
acrZp,2.0,1,0,GCATTCAAGCACGAGAGAGC,1,467743
acrZp,2.0,1,0,GCACTACCCTATAGAGGCTC,1,411463
acrZp,2.0,1,0,GCACGGGCAATATATGGCCA,1,463061
acrZp,2.0,1,0,GCACCTACACGATCATCGGT,1,466291
acrZp,2.0,1,0,GCAAGAGCGGACGTGGTTAC,1,428742
acrZp,2.0,1,0,GCAACTAAGCTATCTTATAG,1,425423
acrZp,2.0,1,0,GCAACAATAATCCAACCCGT,1,411719
acrZp,2.0,1,0,GCAAAGTGCTTCATGCCTTT,1,445523
acrZp,2.0,1,0,GATTCTGTGTAGGTATTGAC,1,447388
acrZp,2.0,1,0,GATTCCTAAAAAACGTGAAC,1,448013
acrZp,2.0,1,0,GATGTCCATGCATTCGGATG,1,459934
acrZp,2.0,1,0,GATGCTGCTCTCAATTGAAT,1,439600
acrZp,2.0,1,0,GATGACGCCCGACTCTTACA,1,454474
acrZp,2.0,1,0,GAGTTGCGGAATGACGCACT,1,411120
acrZp,2.0,1,0,GAGTGTAGTCCTGCTTTGGA,1,432513
acrZp,2.0,1,0,GAGTCGCTATGAACGGAACT,1,420898
acrZp,2.0,1,0,GAGTCAGGTTTCCTAATGTC,1,467387
acrZp,2.0,1,0,GAGGTAATGCAATGCAAACG,1,410640
acrZp,2.0,1,0,GAGGGGGTCTTTAGCAAGGG,1,438709
acrZp,2.0,1,0,GAGGCTCCTCCGATTATATT,1,466959
acrZp,2.0,1,0,GAGCCCGTCGGTTAAGCCAC,1,432675
acrZp,2.0,1,0,GAGATGCAAATGAAACAAAA,1,436690
acrZp,2.0,1,0,GAGATGAGACTCGTTTTTTA,1,427031
acrZp,2.0,1,0,GAGAGTCCGCGAGCTACGCT,1,420467
acrZp,2.0,1,0,GACTTACATTTGGAAGCCCG,1,416808
acrZp,2.0,1,0,GACTGCTAGTCACAGCGGGA,1,415876
acrZp,2.0,1,0,GACGTGGCTGGTCGTGCGCT,1,451544
acrZp,2.0,1,0,GACGGTGACCGCGGTTCCAT,1,460557
acrZp,2.0,1,0,GACGCGTTGACGGCAAGGGG,1,452767
acrZp,2.0,1,0,GACCCCGTTCTCTGCTTGTG,1,463768
acrZp,2.0,1,0,GACAACTTATGTTTTATCCA,1,429864
acrZp,2.0,1,0,GAATTTGTGATACTGTCGCT,1,437074
acrZp,2.0,1,0,GAATGCACGATGTCTCAAGA,1,456913
acrZp,2.0,1,0,GAATCGGGAGCGGTTCGGGT,1,411343
acrZp,2.0,1,0,GAATAGCCAGCCACAAAAGT,1,466210
acrZp,2.0,1,0,GAAGTTGGACACGCGAACAG,1,422256
acrZp,2.0,1,0,GAAGGAGCTAATTCCCCTTA,1,429725
acrZp,2.0,1,0,GAACGCTTGTTTGTACAAGT,1,453467
acrZp,2.0,1,0,GAACGCGCTGTCGAGACTTG,1,420099
acrZp,2.0,1,0,GAACCTTACAATTTTATCAG,1,427155
acrZp,2.0,1,0,GAACCGGTAATACTTGTTAT,1,446841
acrZp,2.0,1,0,GAACAGTAAAGGCAGAAACT,1,427574
acrZp,2.0,1,0,GAAATAAGGAAATGCATTGT,1,419340
acrZp,2.0,1,0,GAAAGGTTCTGCCTGTGCCA,1,453362
acrZp,2.0,1,0,CTTTCATGGTGCATGAGTCG,1,423234
acrZp,2.0,1,0,CTTGTTTGTATAATTACTAG,1,445872
acrZp,2.0,1,0,CTTGTGAAAAGGGCGACCTA,1,426235
acrZp,2.0,1,0,CTTGCAACTCGTTGATCGGA,1,454797
acrZp,2.0,1,0,CTTCGGAAGAGAGTAAAGAC,1,442024
acrZp,2.0,1,0,CTTATGGGAGCAAAGCGTCC,1,453033
acrZp,2.0,1,0,CTTAGAGAGGCTACTACACA,1,463723
acrZp,2.0,1,0,CTGTCAGTCACGAAGCTCCT,1,451644
acrZp,2.0,1,0,CTGTCACCGCGTTGATACAC,1,422463
acrZp,2.0,1,0,CTGGCGTCCTCTGAGTACAG,1,451308
acrZp,2.0,1,0,CTGGCAAAGGGTAAATTGTT,1,457791
acrZp,2.0,1,0,CTGCTTATTCGTTGTTTCCT,1,464254
acrZp,2.0,1,0,CTGCTCCTTTCAGATCGCGT,1,444879
acrZp,2.0,1,0,CTGATTTGATAGGACGGTGA,1,409710
acrZp,2.0,1,0,CTGATGCGTACCTTGACCAC,1,461592
acrZp,2.0,1,0,CTGATAATGATGTATTTCAT,1,446501
acrZp,2.0,1,0,CTCGGGCCGTTTTCAAAACC,1,445031
acrZp,2.0,1,0,CTCGGACTACACCAGGCAGA,1,466149
acrZp,2.0,1,0,CTCCGTGAAATAACTCGTTA,1,429784
acrZp,2.0,1,0,CTCCGCTTATTGCCTCCATC,1,452490
acrZp,2.0,1,0,CTCCCGTTCTGAGGTAGCGT,1,426452
acrZp,2.0,1,0,CTCATAGGCTCACGTGAAAT,1,426864
acrZp,2.0,1,0,CTCAGAAGGGCGATGGCCCG,1,453129
acrZp,2.0,1,0,CTCAACGCCGCGGGACGGTA,1,425499
acrZp,2.0,1,0,CTATTATATTACATTGATCC,1,449770
acrZp,2.0,1,0,CTATGTGGCTGTCATTGAGC,1,416946
acrZp,2.0,1,0,CTAAGACTACGAAGGAGTTA,1,454214
acrZp,2.0,1,0,CGTGTCCGACGCTAGCCTTA,1,412075
acrZp,2.0,1,0,CGTGGAATCTAGGATTATTG,1,427013
acrZp,2.0,1,0,CGTCTCGAACGGGATTACTC,1,467297
acrZp,2.0,1,0,CGTCGGAGACAGGACAACAC,1,454345
acrZp,2.0,1,0,CGTCGAGCACGAGAAGCGAA,1,419514
acrZp,2.0,1,0,CGTAGAGAATGGTACGCGAT,1,467002
acrZp,2.0,1,0,CGTAAAATATTGCCTAGCAG,1,456785
acrZp,2.0,1,0,CGGTTGTGTGCGCCGTACGC,1,437289
acrZp,2.0,1,0,CGGTTGGCCCCATCGGCGCG,1,435872
acrZp,2.0,1,0,CGGTACGACGGCAAACGAGA,1,455848
acrZp,2.0,1,0,CGGGGGCTCGGGATGCCTAG,1,425352
acrZp,2.0,1,0,CGGGGCTCGACTGCTGATGT,1,456351
acrZp,2.0,1,0,CGGGCAACTGACCAAGGGCA,1,465216
acrZp,2.0,1,0,CGGCGGTGGAGTCAGTAACC,1,466963
acrZp,2.0,1,0,CGGATTATTCTCTGATCCCA,1,452703
acrZp,2.0,1,0,CGGACGCCGAGTGTTACTTC,1,445608
acrZp,2.0,1,0,CGCTTCCACGTATCAACGAA,1,458386
acrZp,2.0,1,0,CGCTCTCCTCACGTAAATCC,1,424264
acrZp,2.0,1,0,CGCTATGATTTCTCCAATTA,1,461911
acrZp,2.0,1,0,CGCGTCTATCCAACCTGCAG,1,410719
acrZp,2.0,1,0,CGCGGTCATCTTCTGTACCG,1,460282
acrZp,2.0,1,0,CGCGGGCACTTTGTAGCGGT,1,411161
acrZp,2.0,1,0,CGCGCGCATTCTGTAAGCAG,1,452115
acrZp,2.0,1,0,CGCGAACACTCCCCGGTCGA,1,446703
acrZp,2.0,1,0,CGCCGTCACCGAATATTAGG,1,431964
acrZp,2.0,1,0,CGCAGATGCAACTAAAGGGG,1,452798
acrZp,2.0,1,0,CGCACTAAAAGCCGGACTAT,1,412523
acrZp,2.0,1,0,CGCACCAGAAGAGCCAGCGA,1,414936
acrZp,2.0,1,0,CGATACGAGGGAAAAGGAAT,1,429261
acrZp,2.0,1,0,CGATACATATTGCCGGAGCC,1,417487
acrZp,2.0,1,0,CGAGTTGCCCGAGCGAATTT,1,462425
acrZp,2.0,1,0,CGAGTCGTCTGGGCAGCAAC,1,434257
acrZp,2.0,1,0,CGAGTCCAACATATACGGCA,1,417356
acrZp,2.0,1,0,CGAGTACCGCTGGCCGATAC,1,455693
acrZp,2.0,1,0,CGACGACCTACGGGAGAACT,1,413713
acrZp,2.0,1,0,CGAAGGGGTCAAATGGCGAT,1,410342
acrZp,2.0,1,0,CGAAATTGACAATATTACTG,1,423623
acrZp,2.0,1,0,CGAAATTATTGTTACACAAT,1,408954
acrZp,2.0,1,0,CCTTGTAAGTGAGTACAGGT,1,455103
acrZp,2.0,1,0,CCTTAGTGTACCTGCGGGTA,1,425645
acrZp,2.0,1,0,CCTTAAGAATTTTGTCGGGA,1,422186
acrZp,2.0,1,0,CCTGTCACGTGTACGGTATA,1,444797
acrZp,2.0,1,0,CCTGAGCCAAGATAGGTTGT,1,457109
acrZp,2.0,1,0,CCTCATTGGTATTTGATCGG,1,434672
acrZp,2.0,1,0,CCTATCAAAACCTGTGATTA,1,452495
acrZp,2.0,1,0,CCTAACACTGGCTTTCGCAA,1,464549
acrZp,2.0,1,0,CCGTGTCTCCCTCACAGACA,1,410314
acrZp,2.0,1,0,CCGGAAATAGGGCCAAAGGG,1,446792
acrZp,2.0,1,0,CCGCGGGCGGTCTCGGACAA,1,427472
acrZp,2.0,1,0,CCGACTGCTCAGGGAGGTAT,1,441951
acrZp,2.0,1,0,CCGACGTGTGTTGATACCGG,1,466463
acrZp,2.0,1,0,CCCTTATAGCCTGTAAGTTA,1,446876
acrZp,2.0,1,0,CCCTGCCTGGCGGACTGCTC,1,431931
acrZp,2.0,1,0,CCCGGTTTTGGCGAACGTAA,1,454672
acrZp,2.0,1,0,CCCCTAGCATTCCATACAAC,1,409428
acrZp,2.0,1,0,CCCCCTAGGGTTCCAGCTGG,1,433714
acrZp,2.0,1,0,CCCATGTTGGGTTCCATTGG,1,458670
acrZp,2.0,1,0,CCCATACCCGGTCAGTGGCA,1,410620
acrZp,2.0,1,0,CCCACTGCCTTGCACGGGTG,1,422039
acrZp,2.0,1,0,CCATATTGGAGGGACAGTCT,1,458376
acrZp,2.0,1,0,CCATAGGGTACCAACTTAAG,1,431951
acrZp,2.0,1,0,CCATACAGTTCGTGCAAAAT,1,446215
acrZp,2.0,1,0,CCACTTACTCTGTTGACCCG,1,452105
acrZp,2.0,1,0,CCACGAGCAACCCAGGGTCT,1,436912
acrZp,2.0,1,0,CCACCTCAGGTTCCTTTTAT,1,428322
acrZp,2.0,1,0,CCAAAGCTCACTGTATAACA,1,410511
acrZp,2.0,1,0,CCAAAGCTAGGTTTTAAAAA,1,463853
acrZp,2.0,1,0,CCAAACAAATGCCGCGAGAT,1,450603
acrZp,2.0,1,0,CATTGGCCAACGATTTGTAT,1,443160
acrZp,2.0,1,0,CATTCTAATCAACTTAGCGA,1,438918
acrZp,2.0,1,0,CATTCGCATAGCCGCTATGG,1,415462
acrZp,2.0,1,0,CATTACGGGTGTGGTCGGCC,1,460419
acrZp,2.0,1,0,CATGCTCGCGCAGAACGTTA,1,466784
acrZp,2.0,1,0,CATGCAGTAGCACCGAACAA,1,462806
acrZp,2.0,1,0,CATCCCTACCTAAGATTTTC,1,422120
acrZp,2.0,1,0,CATACAGAGTTAGCACTGCA,1,428419
acrZp,2.0,1,0,CATAACGTAACACTGGGGTT,1,460642
acrZp,2.0,1,0,CAGTAGTCGGTTTAATGTAT,1,449848
acrZp,2.0,1,0,CAGTAACCCTCTAGATTCCC,1,412450
acrZp,2.0,1,0,CAGGGCTAAATTAGGCGGAT,1,426693
acrZp,2.0,1,0,CAGGCATGGGGGGGCCTTAT,1,466346
acrZp,2.0,1,0,CAGCGTAACCAATGACTTCT,1,432647
acrZp,2.0,1,0,CAGATATCAGTTGACGTCTG,1,460617
acrZp,2.0,1,0,CACTATGACCGAAAATCTAG,1,437981
acrZp,2.0,1,0,CACTAGGTGGATAAGTCTCA,1,454215
acrZp,2.0,1,0,CACGATGGAGCGAGGTCCTC,1,442082
acrZp,2.0,1,0,CACGAGTCCGATGCAATAGT,1,412702
acrZp,2.0,1,0,CACCTGCACTCTCGATGTTC,1,444947
acrZp,2.0,1,0,CACCTCCGAGTAGACCGCTT,1,422859
acrZp,2.0,1,0,CACATAATCTTACTCATGCT,1,440088
acrZp,2.0,1,0,CAAGCCCTGGCTTTCGAAAA,1,448677
acrZp,2.0,1,0,CAAGACTGTACCAGATATCT,1,438958
acrZp,2.0,1,0,CAACTGACCTGTCACGCGCA,1,441928
acrZp,2.0,1,0,CAACTCTCTCATGAGGGTCT,1,435482
acrZp,2.0,1,0,CAACGTAGGTTGCACGTGTG,1,437113
acrZp,2.0,1,0,CAACCGAAGAAAGGTGCGTC,1,438884
acrZp,2.0,1,0,CAAATTCTGATGACGAAAAA,1,463949
acrZp,2.0,1,0,CAAAAGAACTATTCGCTAAG,1,445012
acrZp,2.0,1,0,ATTTGTCGCCGACGGTCAGG,1,450038
acrZp,2.0,1,0,ATTTGAACGAGGGGAAGCGC,1,465686
acrZp,2.0,1,0,ATTTCCGTCCGCGGAATTAA,1,432168
acrZp,2.0,1,0,ATTTAACCAATGGACAGGCT,1,441439
acrZp,2.0,1,0,ATTGGCCCAAACGTTGTTAT,1,443287
acrZp,2.0,1,0,ATTGCCTTCTTTGGACTAGA,1,450293
acrZp,2.0,1,0,ATTCTTCGGTCATGAGTAAG,1,459912
acrZp,2.0,1,0,ATTCTGCAAACAGCCCTCTA,1,456469
acrZp,2.0,1,0,ATTCTCGACGGGTGCAAAAA,1,454511
acrZp,2.0,1,0,ATTACTCCATGAAACTTGAT,1,411489
acrZp,2.0,1,0,ATGTTGAGCGCCTATCTGAA,1,465959
acrZp,2.0,1,0,ATGTCTCCTGGGCTTTGGGT,1,450139
acrZp,2.0,1,0,ATGTAGGGAGCTTACTCTGC,1,440782
acrZp,2.0,1,0,ATGTAGCGATCCTGTTTTTC,1,426118
acrZp,2.0,1,0,ATGGTGACCAGGGTGCCTAG,1,457726
acrZp,2.0,1,0,ATGGTCACGCGGCCCATGCG,1,433396
acrZp,2.0,1,0,ATGGATATCAGGTGACTTGT,1,429712
acrZp,2.0,1,0,ATGGAGCAATCAGATCAATA,1,443916
acrZp,2.0,1,0,ATGCTGCATACCAGATAAGG,1,464243
acrZp,2.0,1,0,ATGCACTTTTGAATTGATCC,1,445330
acrZp,2.0,1,0,ATGCAAGGAGCCATCAGTCT,1,457793
acrZp,2.0,1,0,ATCTGTCTCGTTAGGGGTAA,1,455352
acrZp,2.0,1,0,ATCTGCGCCTCTCGGTCTTA,1,452271
acrZp,2.0,1,0,ATCGTCCAACAACAGTGACC,1,440842
acrZp,2.0,1,0,ATCGGAAAGCGTTACCAGGG,1,434337
acrZp,2.0,1,0,ATCCTCAAGTGACCGAAAAG,1,461343
acrZp,2.0,1,0,ATCCATCAGATTAGGGTCGG,1,448530
acrZp,2.0,1,0,ATCCACTTGAATTTATAATG,1,451058
acrZp,2.0,1,0,ATCATAATGGACACCGACGA,1,454058
acrZp,2.0,1,0,ATCAATGACCCAATTATAAT,1,436927
acrZp,2.0,1,0,ATCAAGCTCACCTCGCAGCA,1,464014
acrZp,2.0,1,0,ATATTCATAAAAGTTCGCGA,1,414986
acrZp,2.0,1,0,ATATCGATGATAAACATCAG,1,466540
acrZp,2.0,1,0,ATATATCGGTGTGCACAAGA,1,441174
acrZp,2.0,1,0,ATAGTGATAGATGGCCTCAG,1,427740
acrZp,2.0,1,0,ATAGCCGTCACGTTCGGTGG,1,419229
acrZp,2.0,1,0,ATACGACTGTACCTAATCTT,1,414849
acrZp,2.0,1,0,ATAACTCTGTAAGGTAAGCC,1,418718
acrZp,2.0,1,0,ATAAAAAGTTATCTGTCTGA,1,423866
acrZp,2.0,1,0,AGTTACGGCGCACTGAAATC,1,432389
acrZp,2.0,1,0,AGTTACACCGCGATTTGTCG,1,464314
acrZp,2.0,1,0,AGTGCAACGGTCCTCAGAAG,1,433244
acrZp,2.0,1,0,AGTGAATACCTCCTACCTAC,1,413572
acrZp,2.0,1,0,AGTCTACGTGAACCCTGACA,1,437432
acrZp,2.0,1,0,AGTCCGGATGGACTCTGGGG,1,446110
acrZp,2.0,1,0,AGTCCCTCCTTTTTTCGCTT,1,439368
acrZp,2.0,1,0,AGTATGGTTACACTTTAGCG,1,434612
acrZp,2.0,1,0,AGGTGACAGGGGTCGTGAAT,1,439527
acrZp,2.0,1,0,AGGTCACTTGGGTCTACGCC,1,451041
acrZp,2.0,1,0,AGGGACGCACAGTATCGCTA,1,461891
acrZp,2.0,1,0,AGGCTGGTCACGACTGCAAT,1,465076
acrZp,2.0,1,0,AGGCTGCGACGACCGTGGCT,1,460527
acrZp,2.0,1,0,AGGCTAGTGCGACTGGAATG,1,455846
acrZp,2.0,1,0,AGGCCTAATAGTATAGGCTG,1,434527
acrZp,2.0,1,0,AGGAGTTTTCCGCCACCCAT,1,437815
acrZp,2.0,1,0,AGGAGAGAAGCGCCGAACCT,1,436722
acrZp,2.0,1,0,AGGAGAAGCGATTGTACAGG,1,425782
acrZp,2.0,1,0,AGGACGCTGGGAGATTGAAA,1,422739
acrZp,2.0,1,0,AGGACGAGGCAGTGCGAGTT,1,463798
acrZp,2.0,1,0,AGCTCCGAGCCCACTAGCAG,1,419699
acrZp,2.0,1,0,AGCTCCAACACTGAGAAGGA,1,437433
acrZp,2.0,1,0,AGCTCATAGCGATGGGAAAA,1,466006
acrZp,2.0,1,0,AGCCGTCGCTGAGTCATAGT,1,457203
acrZp,2.0,1,0,AGCATCGCGTACAATGGCAT,1,419128
acrZp,2.0,1,0,AGCATCATATTCGGCTGCGA,1,457603
acrZp,2.0,1,0,AGCAAATTGGGCTATCCCTT,1,419113
acrZp,2.0,1,0,AGATCCAATACTAGCGTTTA,1,423130
acrZp,2.0,1,0,AGAGAGTGGTAAATCACAAG,1,442375
acrZp,2.0,1,0,AGACGCAAAATTTCCTGGAA,1,450998
acrZp,2.0,1,0,AGACCGGTGCTTACTCCGAG,1,461751
acrZp,2.0,1,0,AGAATGAGCAGGCCCCTCCT,1,423248
acrZp,2.0,1,0,AGAAGCACTGTGAGAGCTTT,1,449250
acrZp,2.0,1,0,ACTTTCAACTTATCCAGACT,1,443270
acrZp,2.0,1,0,ACTTGGCTGGGGACGCATAC,1,457076
acrZp,2.0,1,0,ACTTCGCAACTCGTGAGGTT,1,451845
acrZp,2.0,1,0,ACTTCCTATCATGCCGGGAC,1,447141
acrZp,2.0,1,0,ACTTAATTAGTCTTCTTGGA,1,427838
acrZp,2.0,1,0,ACTGACGGAACCTAAATAGG,1,455442
acrZp,2.0,1,0,ACTCTTTAACGTCAAATATA,1,424144
acrZp,2.0,1,0,ACTATGAGCATACTCGTATT,1,451313
acrZp,2.0,1,0,ACTAGGAAGCTGAAACCTGT,1,411805
acrZp,2.0,1,0,ACTAGACCGGCATCGTCCAT,1,452304
acrZp,2.0,1,0,ACGTCGTCGATTTCAACCTT,1,452887
acrZp,2.0,1,0,ACGTACGCGCACCTCCGTAC,1,427068
acrZp,2.0,1,0,ACGTAATAGACCGGACCTTT,1,467161
acrZp,2.0,1,0,ACGGTAAATGAGAACCGGAA,1,450872
acrZp,2.0,1,0,ACGGGACCTGGAGAGTAAAT,1,432261
acrZp,2.0,1,0,ACGGCGATCGTGAAGGTGAA,1,417688
acrZp,2.0,1,0,ACGCGGGTAAGAGTGCCAAG,1,448846
acrZp,2.0,1,0,ACGAGGCCGTATGGTTAGGC,1,410663
acrZp,2.0,1,0,ACGAAAGAAGAGTAGCGCCC,1,420450
acrZp,2.0,1,0,ACCTTTGGACGGGATTAGCT,1,437058
acrZp,2.0,1,0,ACCGGCGAGATGACTCTGAC,1,429798
acrZp,2.0,1,0,ACCCGCAATAAAAGGGACTC,1,453359
acrZp,2.0,1,0,ACCATTCTAGGAGGGTACAC,1,437697
acrZp,2.0,1,0,ACCATCCGACTCAGGTTTAA,1,420313
acrZp,2.0,1,0,ACCAGAAAACGACAGTTATC,1,427058
acrZp,2.0,1,0,ACATTTTTCGAACTTTGCTT,1,443958
acrZp,2.0,1,0,ACATTTCGGCTATGGCTCGT,1,428095
acrZp,2.0,1,0,ACATTCGGCGAACCTGGTAT,1,429042
acrZp,2.0,1,0,ACATGGTCTTGTAGTAGGTA,1,431248
acrZp,2.0,1,0,ACATGAAACGCAGCACCATT,1,410055
acrZp,2.0,1,0,ACATAGTTTCCACCGGTCGC,1,452997
acrZp,2.0,1,0,ACACTGTTGGCACCGGTTCG,1,417299
acrZp,2.0,1,0,ACAACGGGTTTTGCACTACT,1,424337
acrZp,2.0,1,0,ACAAAATCTGCCGAGAGAGC,1,463335
acrZp,2.0,1,0,AATTGAGACGCCGGTTTTGT,1,420555
acrZp,2.0,1,0,AATTCATGTTTCTTACTTTG,1,461097
acrZp,2.0,1,0,AATGGGGGACATCCTATAAC,1,434693
acrZp,2.0,1,0,AATGGGAAAACCCGCCTTTC,1,419591
acrZp,2.0,1,0,AATGCGCGGTCCAGAAATGT,1,461043
acrZp,2.0,1,0,AATCGGTGAGTAAGGGTAGT,1,411030
acrZp,2.0,1,0,AATCCTAGGCGTAACCATGT,1,433486
acrZp,2.0,1,0,AATCCACTCAAATAGGCGCA,1,439218
acrZp,2.0,1,0,AATATCGTCTTATACGTAAT,1,422676
acrZp,2.0,1,0,AAGTTGAATCTCCCCGGAGC,1,421344
acrZp,2.0,1,0,AAGTCCATCTTGGGAACGCA,1,449418
acrZp,2.0,1,0,AAGGGATACCATAAATTAAA,1,424092
acrZp,2.0,1,0,AAGGCCGGGGTCTTGTACCA,1,434746
acrZp,2.0,1,0,AAGCGCGACCCCGTGTCCTT,1,447094
acrZp,2.0,1,0,AAGATTTATTTACCGCGGAC,1,440303
acrZp,2.0,1,0,AACTTGGCAATATTTTTGTA,1,418932
acrZp,2.0,1,0,AACGTAGCCGACGGTTTCCT,1,430376
acrZp,2.0,1,0,AACGGAGACTTAGCCTATGC,1,426633
acrZp,2.0,1,0,AACCACTGCGGCGACGTTAT,1,432592
acrZp,2.0,1,0,AACATAGCAAATTTAGGCTT,1,416491
acrZp,2.0,1,0,AACAAGCTTCGGCAAGGTTT,1,444128
acrZp,2.0,1,0,AACAACAGATACGGGTATCG,1,435625
acrZp,2.0,1,0,AAATTACCCACCACGGGGAC,1,445452
acrZp,2.0,1,0,AAATCACGTCGCCACGGTAT,1,434737
acrZp,2.0,1,0,AAATATTCGCTCAGTTCACA,1,459485
acrZp,2.0,1,0,AAAGTAGAGAGCATACTCGT,1,412736
acrZp,2.0,1,0,AAAGCCCCGCTCGTCCAGAT,1,416237
acrZp,2.0,1,0,AAAGAACGGTCGTGTTTCGT,1,465693
acrZp,2.0,1,0,AAACTTTCATTGTTAGGTTA,1,446569
acrZp,2.0,1,0,AAACTGCCAATCCTGATCCA,1,410461
acrZp,2.0,1,0,AAACGCAGGGGAGCTTCAGA,1,420299
acrZp,2.0,1,0,AAACAGTTTCTGTTCGTCAT,1,421562
acrZp,2.0,1,0,AAACAGCAGCACCCTCGGAT,1,451548
acrZp,2.0,1,0,AAAAGTTGGTCCTCGACAAT,1,467746
acrZp,2.0,1,0,AAAAGTTAACTAGGTAGGAG,1,442846
acrZp,2.0,1,0,AAAACAGTAACGAATGTCTT,1,433787
