name,relative_counts,ct,ct_0,barcode,ct_1,barcode_ind
ykgRp,0.449820788530466,1616,1115,TGGCGTCAATGTATTGATTT,501,5049237
ykgRp,0.6086956521739131,220,137,CGGACTCGACCTGCTCCCAG,83,5037720
ykgRp,0.022222222222222223,90,89,CCTTTGCTGCGTCTGTATAG,1,5049407
ykgRp,1.4647887323943662,173,70,GCCTTCCTACGCACTCAACC,103,5038770
ykgRp,0.39705882352941174,93,67,TGAGTAGGGATTTACTGCGA,26,5035797
ykgRp,0.06451612903225806,64,61,CGGGCGGAATCCCGTGGATG,3,5038435
ykgRp,0.03225806451612903,62,61,AACAACCGTGGGTTAGCCCT,1,5036444
ykgRp,1.5333333333333334,150,59,ACGTCGTGTTTATTCTGAAT,91,5051988
ykgRp,0.03389830508474576,59,58,CATGGCTGTCGTAATGCTGA,1,5034674
ykgRp,1.543859649122807,143,56,GATGCCTCCTATTTCGAGCT,87,5050448
ykgRp,0.5357142857142857,84,55,TATGCGAACTGGTATTTGTC,29,5046021
ykgRp,1.2452830188679245,117,52,TTCGACTTCCCTCCGCTCGA,65,5036070
ykgRp,0.35294117647058826,67,50,GCAATGGGAACCGTGCTTGT,17,5032285
ykgRp,0.06,51,49,GTATGAGGGCTTCGAAAAAT,2,5037512
ykgRp,0.2857142857142857,61,48,GGTGGCGTAAGACGGTTAAT,13,5052368
ykgRp,0.425531914893617,65,46,TTCTTAGTTCGGTACATGTA,19,5033473
ykgRp,1.7659574468085106,128,46,TGGCATTCCGCACCTCTCAC,82,5040211
ykgRp,0.06521739130434782,47,45,TTCGTGTAGCAAGTCGGGCA,2,5054818
ykgRp,0.34782608695652173,60,45,TTAAAGGCCCGGATAGCGTG,15,5053614
ykgRp,1.2272727272727273,96,43,TCCCCAAACCGCCCCTTTCG,53,5031396
ykgRp,0.38636363636363635,59,43,GTAGGTAATGACGCTGGACA,16,5036477
ykgRp,0.3409090909090909,57,43,CCTCGCGCGATGCTCAGCCA,14,5031438
ykgRp,0.5714285714285714,64,41,TAAGGAGATCCAGTAAGTCA,23,5031722
ykgRp,0.30952380952380953,53,41,GATGGGGCCGCGTTGGCTGT,12,5035856
ykgRp,0.40476190476190477,57,41,AAGATGGAACCTGCAGCATC,16,5033976
ykgRp,1.170731707317073,87,40,TCGGAGGTGAATGTCGCATC,47,5033802
ykgRp,0.4146341463414634,56,40,CGTAAAAGCCTTGACCTAAT,16,5032003
ykgRp,0.45,56,39,CCCACAAGAAAGGGATGAAT,17,5035512
ykgRp,0.9487179487179487,74,38,TGCTTGCTATAACATAAAGC,36,5050828
ykgRp,0.8974358974358975,72,38,TACGTACACGCAATCAGAGA,34,5031678
ykgRp,0.5128205128205128,57,38,CGCGACACCCTGTCTCTACT,19,5034035
ykgRp,0.05128205128205128,39,38,AGTGGTAAGCTAAGTGTTCA,1,5043830
ykgRp,0.5789473684210527,58,37,TTTGATTAACGGCTATGTTG,21,5033727
ykgRp,0.4473684210526316,53,37,TTTACGGGTCAAGCGCTGTA,16,5046314
ykgRp,0.3684210526315789,50,37,TGTGGGGCCAGAGGACCGCA,13,5036089
ykgRp,0.4473684210526316,53,37,ACTAATCGGGCAGTCGTCGC,16,5037131
ykgRp,1.162162162162162,78,36,TAAAAAACCCGGCGCCTAGT,42,5031582
ykgRp,0.7837837837837838,64,36,AGGTACCTGTGGTGCGGATA,28,5050859
ykgRp,0.8611111111111112,65,35,TGTAAGCGGACCGCGTTCTT,30,5038511
ykgRp,0.2777777777777778,44,35,GGTAATACAAACGCACTCCA,9,5033688
ykgRp,0.3055555555555556,45,35,CCACGACATTGTAGCCTTTC,10,5049307
ykgRp,1.1666666666666667,76,35,CAGGTGGCAACCACCTCCGA,41,5036514
ykgRp,1.0,70,35,AGGAAGTACACCCATTTGGG,35,5042123
ykgRp,0.2571428571428571,42,34,TTTGAATGGCCGTTATTTTA,8,5034718
ykgRp,0.6857142857142857,57,34,TAATGTGACCGGGCAAACAA,23,5041412
ykgRp,1.8571428571428572,98,34,CTTAGGTACAAATTCCTAAA,64,5033516
ykgRp,0.14285714285714285,38,34,CCAGGGCTCTGGAGAACAGG,4,5042469
ykgRp,0.5,49,33,TCATGACAGCAGGGGTCCGA,16,5031409
ykgRp,1.2647058823529411,75,33,CTTTCCATTGTCCAGTATCT,42,5041932
ykgRp,1.7352941176470589,91,33,AGAGAGAACGGCCTTCAGAC,58,5048014
ykgRp,0.7575757575757576,56,32,GTAGGTCTAGCATATTGGTT,24,5032565
ykgRp,0.30303030303030304,41,32,GCATACTTATGAGCCGTTGT,9,5034497
ykgRp,0.3333333333333333,42,32,CCCCCCGGTCTAACAAGTGT,10,5043380
ykgRp,0.30303030303030304,41,32,ACCGACAGGTCGCCTAGCAT,9,5033779
ykgRp,0.5,46,31,TGTGCCCGGCGGATTCAAAT,15,5057487
ykgRp,2.3125,104,31,TGGATACGCCTGTAGGTCGT,73,5060502
ykgRp,0.6875,52,31,GGTCGCTAGATACACCAATA,21,5035465
ykgRp,0.4375,44,31,CGGGATTCGATACTGTCTGT,13,5035207
ykgRp,0.3125,40,31,CCTTGGCGGGGACACACTCT,9,5039334
ykgRp,0.78125,55,31,ACCTGTGCAAGCGTATATTA,24,5034652
ykgRp,2.129032258064516,95,30,TTTCTCGTCCCGGCAAATAC,65,5051691
ykgRp,0.6451612903225806,49,30,TTGAAACAGCAGGAGAGGGT,19,5039782
ykgRp,0.6129032258064516,48,30,GTTTGGTACGTTGAGTTCTT,18,5038509
ykgRp,0.5161290322580645,45,30,GTATAGAGAGTAAGGCGAGA,15,5056012
ykgRp,1.096774193548387,63,30,GTAGGTAGGCATACGGCGCT,33,5034462
ykgRp,1.903225806451613,88,30,GATAGTTCTTCTCAGTCGGT,58,5049375
ykgRp,0.4838709677419355,44,30,GACGATTACGTGGGTAAGCT,14,5034103
ykgRp,0.41935483870967744,42,30,CGTACTTTACGACGGTCTGC,12,5041443
ykgRp,0.9354838709677419,58,30,CGTAAGTATGGTTGGCGACT,28,5038239
ykgRp,0.6129032258064516,48,30,AGCCCAGAATCTAGTTGCGT,18,5047423
ykgRp,0.7741935483870968,53,30,ACGTTCTCGGGAGCTTCAGT,23,5037354
ykgRp,0.5806451612903226,47,30,AATGTGGTAAAGTTGTAGTT,17,5054513
ykgRp,1.6333333333333333,77,29,TGGTCTGCTGTGATGTTATA,48,5042326
ykgRp,0.06666666666666667,30,29,TGGTATATAGGACAACGAAT,1,5043994
ykgRp,1.2333333333333334,65,29,GTTAGCAACGTGGCCCGGGT,36,5035511
ykgRp,0.7666666666666667,51,29,CCCCCCTGATTTTGCCGAGA,22,5038858
ykgRp,0.8333333333333334,53,29,CATAAAGAGTAATGGGCACG,24,5034252
ykgRp,0.9666666666666667,57,29,CAAGTTGTGTGGCCGGCTGT,28,5053164
ykgRp,0.5862068965517241,44,28,TTTGGCAACACGGAAACTTT,16,5045256
ykgRp,0.3448275862068966,37,28,TTTATACATGGCACGATCCT,9,5049487
ykgRp,0.9655172413793104,55,28,TTCGCGTCGTTGGAATGGAA,27,5054311
ykgRp,0.8275862068965517,51,28,TGTACTTGCGCATGGTGGTA,23,5043081
ykgRp,0.3793103448275862,38,28,TATGCGGATAGTGCTCCCTA,10,5041943
ykgRp,0.13793103448275862,31,28,TAGGGCAAACTAATCAGTAT,3,5031723
ykgRp,1.103448275862069,59,28,CACTCCGAATACCAATCCCC,31,5051693
ykgRp,1.6551724137931034,75,28,ATTTATTAACAGCTTCAGCT,47,5032258
ykgRp,0.41379310344827586,39,28,ATAGCTTGGAACACACTCAT,11,5041185
ykgRp,0.4482758620689655,40,28,ATAGATTCGGCTAGACACGT,12,5060393
ykgRp,0.10344827586206896,30,28,AGCATAACAAGGAACGTTAT,2,5037475
ykgRp,0.06896551724137931,29,28,AGCAACGGTTAAAGATATTT,1,5039750
ykgRp,0.3103448275862069,36,28,AAAGACATCCAAATTTCTGA,8,5033781
ykgRp,0.07142857142857142,28,27,TGTGCTAACTAGAGCCCTGT,1,5033674
ykgRp,0.8571428571428571,50,27,TGGTGTGTCGTGGTGCCCGT,23,5035174
ykgRp,0.07142857142857142,28,27,TCTCAAAGCCTTCCCGACTT,1,5032036
ykgRp,1.3928571428571428,65,27,TAATAAAAAGTCGGTGTCCC,38,5045554
ykgRp,0.7857142857142857,48,27,TAACAACGATGCGCCGACAA,21,5037481
ykgRp,0.8928571428571429,51,27,CCGGACATAGTCGGTATTTA,24,5032965
ykgRp,0.6428571428571429,44,27,CACGTACGCTGCAAGAATTA,17,5057663
ykgRp,0.6666666666666666,43,26,TTAGTGGATTGGGAAAAAGC,17,5043327
ykgRp,3.1481481481481484,110,26,TGTAGGTCCCCTGCCTTTTG,84,5036766
ykgRp,0.7037037037037037,44,26,TCGAATAGTACAATGCCCCA,18,5034017
ykgRp,0.3333333333333333,34,26,TCCAGTTCGTGGTATTATTG,8,5035123
ykgRp,0.7777777777777778,46,26,TATTCTCTTCGAGTACACAT,20,5058693
ykgRp,0.48148148148148145,38,26,TAGCTGCCATGCCATGGTTG,12,5060776
ykgRp,2.185185185185185,84,26,TAATACAAGGCTGTGACCGT,58,5033867
ykgRp,0.4444444444444444,37,26,GATCATCTACGGAACGGTGA,11,5044975
ykgRp,0.9629629629629629,51,26,GAGTTGCGCACCTGACTTAA,25,5036129
ykgRp,0.8148148148148148,47,26,GAGGGTATGGTCTGGGAAGG,21,5031523
ykgRp,3.0,106,26,CTACGGAAATTTGATAGTGC,80,5056922
ykgRp,0.8148148148148148,47,26,CGTCGGGCTTAACGTTGCGT,21,5042380
ykgRp,0.7777777777777778,46,26,CACAGTTTTCCGAAGATAGA,20,5032388
ykgRp,2.7037037037037037,98,26,ATTTTGATTGCGTAATGGAT,72,5045639
ykgRp,1.5185185185185186,66,26,ACGTCTTACCAGGCAAATTG,40,5038772
ykgRp,1.8518518518518519,75,26,ACGCCCAGTGTGATCAAAAG,49,5041492
ykgRp,0.2222222222222222,31,26,AACGGGTCTGCATTTAGACT,5,5032939
ykgRp,1.2592592592592593,59,26,AAACAAATAGGCCTATGAAC,33,5042479
ykgRp,0.19230769230769232,29,25,TGACCGGCAAGGGCCGCAGT,4,5049911
ykgRp,0.3076923076923077,32,25,TCACGCCTAAATATCGACAC,7,5032769
ykgRp,0.7307692307692307,43,25,TACGCACGCTGCGGTATGCA,18,5036566
ykgRp,0.23076923076923078,30,25,GTCAAAGCGAGGAAAGAGAG,5,5040055
ykgRp,0.6923076923076923,42,25,GGGGACCCTCCCGGAACATC,17,5036211
ykgRp,0.9230769230769231,48,25,GGGAATCAACTCTCGACACA,23,5059147
ykgRp,0.34615384615384615,33,25,GACAGTGCAGTATAATAAAT,8,5032823
ykgRp,0.3076923076923077,32,25,CTCATAGACGGTTCCAAAAT,7,5036791
ykgRp,0.7307692307692307,43,25,CTACCTCCGAATGGTTATTT,18,5035614
ykgRp,0.4230769230769231,35,25,AGACTAGCGAGGCCGGAATG,10,5060175
ykgRp,1.5,63,25,ACATCATGGACTCTAACAGT,38,5055645
ykgRp,0.52,36,24,TTCGCCGGGAGGTAATCAAA,12,5044419
ykgRp,1.92,71,24,TTCAGTTCAGTTCCTCACAC,47,5033218
ykgRp,0.92,46,24,TGATCTATGGTTCTAGTCTA,22,5037781
ykgRp,1.24,54,24,TAGGCATGCATCAAGCTCAA,30,5034361
ykgRp,0.96,47,24,TAGCCGGAGCCCCGTTTCGA,23,5039751
ykgRp,3.56,112,24,GTTGTGTCCAGCTATTATTG,88,5048214
ykgRp,0.56,37,24,GTGTTATTAAGCAAGCCCTA,13,5047934
ykgRp,1.56,62,24,GTGTAATCACCTAGTGTGTC,38,5041399
ykgRp,0.4,33,24,GTCTACCCCCAATTATTATT,9,5035610
ykgRp,0.2,28,24,GATATTGATCTGATTATATT,4,5034719
ykgRp,0.16,27,24,GAACCAACCCTATCCAGGTC,3,5031779
ykgRp,0.88,45,24,GAAACCGGATTTATGGAGTA,21,5043238
ykgRp,0.08,25,24,CTTAACCGCCATGGTATTTG,1,5042986
ykgRp,1.2,53,24,CGTGAACTTAGTGCACAGGC,29,5036890
ykgRp,1.8,68,24,CGGCGGGGGGTCAACACGAC,44,5037746
ykgRp,0.84,44,24,CATTGGAGATCGAGAAATGA,20,5052734
ykgRp,0.92,46,24,ATGGTGACTGAACCTCGAGA,22,5050992
ykgRp,0.24,29,24,ACCGCCAGAAGCAGCGCTCA,5,5041233
ykgRp,0.76,42,24,AAGTCGCGAGGTGAGTCTGA,18,5043880
ykgRp,0.375,31,23,TTCAATAGGTGCCTCTGATC,8,5050447
ykgRp,1.25,52,23,TGTCACATCTAGGACTTTTT,29,5038366
ykgRp,1.375,55,23,GTTGCAGAATACCAGGACTC,32,5051917
ykgRp,0.4583333333333333,33,23,GGCCAATGGTTTGACGCCCC,10,5041258
ykgRp,0.75,40,23,GAAATGCACTAATATCCCGA,17,5038760
ykgRp,0.6666666666666666,38,23,CCACCACTATGGCTTGGCGT,15,5038729
ykgRp,0.75,40,23,CAGTAATACAATGGAGTTTG,17,5053625
ykgRp,1.875,67,23,CACCGCCATAAGAAACAACA,44,5042575
ykgRp,0.875,43,23,CAAGAAGCCATCGGAAGGTT,20,5049551
ykgRp,1.9166666666666667,68,23,CAACTGAAATGGTTTAGGGT,45,5041884
ykgRp,0.3333333333333333,30,23,CAACTCTGTTGTGGGGGCCT,7,5032944
ykgRp,1.0833333333333333,48,23,ATCGGACCCCGGGGTGGATT,25,5035218
ykgRp,0.7916666666666666,41,23,ACGTCGGTGCCCTGTTTTGG,18,5038708
ykgRp,1.4166666666666667,56,23,ACGGGCAAAGTAACCGATCT,33,5037133
ykgRp,0.375,31,23,ACCCATGTGGAGGCAGCTTG,8,5038863
ykgRp,1.375,55,23,AATCGCAGATTAGGTCGTGG,32,5032996
ykgRp,1.826086956521739,63,22,TTCCACTTTACTCGAGGCTG,41,5035956
ykgRp,0.8260869565217391,40,22,TGTCTCGAACCCCCGCTTAT,18,5052455
ykgRp,0.6956521739130435,37,22,TGGGTCAGATGGCCTACCAC,15,5053000
ykgRp,2.260869565217391,73,22,TCCAACTTCATGTACCATGT,51,5033804
ykgRp,0.6086956521739131,35,22,TAGGGCGGCGTGCTCGGCCG,13,5037721
ykgRp,0.8695652173913043,41,22,TACTTTTTTAGCGGGTGTAA,19,5041831
ykgRp,1.7826086956521738,62,22,GTAAAAGTTTATGCTACGCA,40,5057237
ykgRp,0.5652173913043478,34,22,GGTTCCCTGGGTATTTCAGC,12,5039514
ykgRp,1.608695652173913,58,22,GCTTCGCCGGTTTCGAACTG,36,5056583
ykgRp,0.6521739130434783,36,22,GCAAGGACAAGACTTCTGAT,14,5046738
ykgRp,0.08695652173913043,23,22,GAGGGCATGATCCCTCAGAG,1,5033707
ykgRp,0.782608695652174,39,22,GAGAGGGTTCCTGATCGCGA,17,5042951
ykgRp,0.4782608695652174,32,22,CTTCCGCCATCTTGTTCAAG,10,5037194
ykgRp,1.2608695652173914,50,22,CTTATTTCGATAGTGTTCGT,28,5049764
ykgRp,0.08695652173913043,23,22,CTACTACAATGGCTTTGGAT,1,5054417
ykgRp,1.7391304347826086,61,22,CGGTGATTTCCTCACACTTA,39,5032874
ykgRp,0.5217391304347826,33,22,CGCGCGGTCTTCCATAGTCA,11,5049173
ykgRp,1.434782608695652,54,22,CATTCGGACGGTTCGGGGCG,32,5051965
ykgRp,1.2608695652173914,50,22,CACTCCTCTGACGTCCCGCT,28,5047031
ykgRp,0.43478260869565216,31,22,CACGAAAGTGGAAGCCTTTG,9,5049031
ykgRp,0.5652173913043478,34,22,ATTAACCATCAGCATTTATA,12,5045972
ykgRp,1.5217391304347827,56,22,AGTGCCCGTTGACAGAGCCA,34,5032039
ykgRp,1.3043478260869565,51,22,ACATCGTGACTGGGTAGCTT,29,5056367
ykgRp,0.8695652173913043,41,22,AAGGTCATGTTTTTAGATGA,19,5044679
ykgRp,1.3636363636363635,50,21,TTGAATCCTATGTAACGCAA,29,5048475
ykgRp,1.0909090909090908,44,21,TCACGTGATACAGGGCTCCA,23,5045377
ykgRp,1.6818181818181819,57,21,TAAATCAGGCGGCCGTACTC,36,5041719
ykgRp,5.636363636363637,144,21,GTATGTAGTAACCATCGGAC,123,5043829
ykgRp,0.8181818181818182,38,21,GGCGATATAGTTGGACTACT,17,5040381
ykgRp,1.4545454545454546,52,21,GCAGGTAGATGAGAGGGCGA,31,5041230
ykgRp,0.7272727272727273,36,21,GAAGAAGGCTTGGGGTAGCA,15,5033438
ykgRp,1.0909090909090908,44,21,CTTTCAATACGCCGCCATCT,23,5036844
ykgRp,1.0,42,21,AGTGGGGATCATGTAGAGAC,21,5045439
ykgRp,0.7272727272727273,36,21,AATAAAATCTTGCACGCCTG,15,5046385
ykgRp,0.6363636363636364,34,21,AAGAAACATTAAGCTACCTC,13,5043743
ykgRp,0.9047619047619048,38,20,TTAAGTTGGACCTTTTTCTC,18,5040792
ykgRp,1.619047619047619,53,20,TCCAACAAAGGATTTCTATA,33,5045317
ykgRp,0.8571428571428571,37,20,GTGAGCGGCGTTTGGGAAAC,17,5058455
ykgRp,1.8095238095238095,57,20,GCGGTGATTAGTTACGACTG,37,5043543
ykgRp,0.9523809523809523,39,20,GATTTGCGCAGCACTCGCGT,19,5050468
ykgRp,1.5238095238095237,51,20,GACGATAAAACCGTCAGGTA,31,5048640
ykgRp,1.3333333333333333,47,20,CTGTCAGGCGATACCCCTGA,27,5050189
ykgRp,0.7619047619047619,35,20,CTGATATCAAAGCTTCCGCT,15,5059467
ykgRp,2.0476190476190474,62,20,CGTCGTCCGCGGTACTCACT,42,5047305
ykgRp,0.9047619047619048,38,20,CGCTTCTGGAGTCCATCGAA,18,5037027
ykgRp,0.7619047619047619,35,20,CCGGAGACTTCCGCGGACCT,15,5053674
ykgRp,1.8095238095238095,57,20,CCATTTTAGGACGGAAAGTT,37,5033078
ykgRp,1.2857142857142858,46,20,CACTAACAGCGACTATCCCC,26,5032214
ykgRp,0.7619047619047619,35,20,ACCGGTCAGAGGTAGCTCAT,15,5047072
ykgRp,0.8095238095238095,36,20,AACCTATTGCTGAGTGCATG,16,5031466
ykgRp,0.8,34,19,TTACCTTGCTGATGGCGCAA,15,5058464
ykgRp,1.0,38,19,TGTGGGAGCGGTCACTGGGG,19,5046907
ykgRp,0.1,20,19,TGGTAGTTACATACCAGTGT,1,5033449
ykgRp,0.8,34,19,TGACGTAGGGGGTAGCGGCG,15,5037087
ykgRp,1.5,48,19,TCTTTACTGTTATTAAGGTA,29,5044934
ykgRp,1.85,55,19,TCCCGTTGCAGGCTCTAATA,36,5055386
ykgRp,0.1,20,19,TAGGTTACGAACACGTCCGG,1,5038837
ykgRp,0.15,21,19,TAGATACGCTCTAGGGCACG,2,5047741
ykgRp,0.1,20,19,GTCTTTTCTGTGGGAAGCCA,1,5035567
ykgRp,1.15,41,19,GGGGTGAGGCCCAGGAGTAA,22,5039837
ykgRp,0.7,32,19,GGGGGCACCTTTTACGTACT,13,5044020
ykgRp,0.8,34,19,GATCATCCCGGTCCCAGGCT,15,5051271
ykgRp,0.55,29,19,GACTAAACTGCGTTTGGACT,10,5060023
ykgRp,1.15,41,19,GACCCCTGGAAGTAAGAAAT,22,5046273
ykgRp,0.7,32,19,GAATGCAGATCAAAACGGTT,13,5047048
ykgRp,1.3,44,19,GAACATGCCTCCGTTGTGCC,25,5042094
ykgRp,0.7,32,19,CTTCTTCTGCACGGATCACA,13,5050913
ykgRp,1.55,49,19,CTGAAAGTTGATTCTCGGTC,30,5048383
ykgRp,0.55,29,19,CGTACCTACGTTTCCCGCGG,10,5045197
ykgRp,0.5,28,19,CGAGATACACAGTAGGGACA,9,5057660
ykgRp,1.45,47,19,CGAATAGTAAACCGTTAGTG,28,5041198
ykgRp,0.1,20,19,CCGGAACAGTATGCTACACT,1,5037132
ykgRp,0.95,37,19,CCCTCCACCCTTAATCTTGA,18,5044748
ykgRp,1.15,41,19,CCCGTCTTCTGGGTAAGCGT,22,5044621
ykgRp,0.9,36,19,CAGGGGGCAAAGGAAACCAT,17,5033314
ykgRp,0.35,25,19,ATGGATCGGAGACGACACAA,6,5034734
ykgRp,3.0,78,19,ATCTGACTTAGACGCCCAAG,59,5031840
ykgRp,1.65,51,19,ATCCTCTCAGCCTAAGCAGA,32,5039084
ykgRp,1.0,38,19,ATCCGGCTCTATCAACGCTA,19,5035131
ykgRp,2.7,72,19,AGTGTCCTTGAACAAGCCTG,53,5035234
ykgRp,1.8,54,19,AGAAGATAAGTATCTATTCA,35,5047035
ykgRp,0.5,28,19,ACGGATGAAATTAAATCCAG,9,5032964
ykgRp,1.5,48,19,ACGAGACGGACGGAGAGGTC,29,5038557
ykgRp,0.1,20,19,ACCTATAGGGCGGATAAACC,1,5060476
ykgRp,1.1,40,19,ACCGTCTGATACCCGCTTGA,21,5047310
ykgRp,0.35,25,19,AAGGTTTACGGGATAAGACC,6,5041782
ykgRp,0.6842105263157895,30,18,TTTTCTGGTCCTTGCGTATC,12,5052803
ykgRp,1.2105263157894737,40,18,TTAATAGTGGGAAGGCTCAG,22,5038047
ykgRp,0.5263157894736842,27,18,TGGCCATAAGGATAACAAGT,9,5044101
ykgRp,0.8421052631578947,33,18,TACCCTATCAGCGTTCGTAT,15,5031341
ykgRp,0.6842105263157895,30,18,TACAGACCCCACATTACTTG,12,5033581
ykgRp,0.15789473684210525,20,18,TAATACGAAGCGTCTGAGAT,2,5054420
ykgRp,0.5789473684210527,28,18,TAACCAAACATCGTCCGGAC,10,5046946
ykgRp,1.0526315789473684,37,18,GTGTACGCATGGGCGTCTAA,19,5049618
ykgRp,1.1578947368421053,39,18,GTGCCTAGGGTACTCCTGGA,21,5036152
ykgRp,1.7894736842105263,51,18,GTCGGACTCTGTCTCTACTG,33,5034399
ykgRp,0.8421052631578947,33,18,GGTGTAGATTGGAAGCTGAC,15,5037726
ykgRp,0.9473684210526315,35,18,GGTCCTTCCTGAAACGAATA,17,5040294
ykgRp,0.8947368421052632,34,18,GGGTAGCCCGAATGGATCGT,16,5038494
ykgRp,0.9473684210526315,35,18,GGAGCCATCCCCATCCAATT,17,5036195
ykgRp,3.263157894736842,79,18,GCTGTAGAGCTAACTAACCC,61,5034853
ykgRp,1.0526315789473684,37,18,GCCGTATCAATAGGATTTCT,19,5032527
ykgRp,1.631578947368421,48,18,GCACTATGGTTTCGTTTACG,30,5044648
ykgRp,0.15789473684210525,20,18,GATTGTAACAAAGAGCTGCC,2,5033191
ykgRp,1.9473684210526316,54,18,GAGGGGCGTCAGCCGAATAA,36,5039869
ykgRp,0.15789473684210525,20,18,GAACATCAGAACGCCGTATG,2,5058682
ykgRp,1.263157894736842,41,18,CTTGGAACAATGAGCGGTGC,23,5035022
ykgRp,0.5263157894736842,27,18,CGGTCTATTTGCGGACCCCT,9,5058171
ykgRp,0.10526315789473684,19,18,CGCTGATGGGAGGTTTAGGG,1,5039167
ykgRp,1.6842105263157894,49,18,CATCAAAGCAAGCTACGATA,31,5031811
ykgRp,1.1578947368421053,39,18,CAGATATCATGGTGTTTGGA,21,5046662
ykgRp,1.263157894736842,41,18,CACCTCCCTACCCTGATATC,23,5051334
ykgRp,0.7894736842105263,32,18,CACCCAGAGCTGGCCGTTGA,14,5033490
ykgRp,2.3684210526315788,62,18,AGCAATGAACGATGACCAAG,44,5050598
ykgRp,1.4736842105263157,45,18,ACTTCTTGGGCTGCCATGCC,27,5036563
ykgRp,1.2105263157894737,40,18,ACGACCCTACGGCTGAGCGC,22,5049796
ykgRp,1.0526315789473684,37,18,ACCTGTCGCCATGCCGTCTG,19,5055798
ykgRp,0.47368421052631576,26,18,ACAGTTCATCCAGAGCATTT,8,5039022
ykgRp,2.1052631578947367,57,18,ACAGGATCCGGGGACCAATG,39,5044322
ykgRp,4.631578947368421,105,18,AATCGTGTACGCGCCGACTA,87,5047021
ykgRp,1.8421052631578947,52,18,AATATGCATCTTGCAGTAGC,34,5048813
ykgRp,0.15789473684210525,20,18,AAGGATGTGCGTTTGAGTGT,2,5043262
ykgRp,2.5789473684210527,66,18,AAAGAACCATGTAATATTCT,48,5051824
ykgRp,1.0,34,17,TTGCGCCTAAGTCCCATGAC,17,5055837
ykgRp,1.5,43,17,TTCGTATAGTGTAACATCCG,26,5058669
ykgRp,0.4444444444444444,24,17,TGGGGCGTTTAGGGCTGTCT,7,5039059
ykgRp,1.5555555555555556,44,17,TCCGTTACCGAGTAGTCCAT,27,5060439
ykgRp,3.0555555555555554,71,17,TCACGTGGTAGCGCTGCTGA,54,5034315
ykgRp,4.0,88,17,TATTAAGATTCTGCGTGCAT,71,5050077
ykgRp,1.1666666666666667,37,17,TAGGGTACAGCGTAGTTGTT,20,5056276
ykgRp,0.1111111111111111,18,17,TAGCTACCACTTTCGGAAGG,1,5059681
ykgRp,1.3888888888888888,41,17,GTTTTCACGTATGTGGAGCA,24,5059309
ykgRp,0.8888888888888888,32,17,GTGCGCGGTGAAGACCGTTC,15,5042581
ykgRp,0.7777777777777778,30,17,GGTTTATCTGTCAGTATTGG,13,5045186
ykgRp,2.0555555555555554,53,17,GGCCGGAATAATCTGCATTA,36,5044305
ykgRp,0.5555555555555556,26,17,GGAGTCTGCGGTCTTCTTGG,9,5041578
ykgRp,0.8888888888888888,32,17,GGACTTATCTAACGGATTAA,15,5031479
ykgRp,0.1111111111111111,18,17,GGACAGTGGGTAGTAGTAGT,1,5047217
ykgRp,0.8333333333333334,31,17,GCATTGTTTGAGATCAAGCT,14,5040089
ykgRp,1.1666666666666667,37,17,GCACCATCATATGTATCAGT,20,5041609
ykgRp,1.1111111111111112,36,17,GATAAGAATATATATCTTTG,19,5047450
ykgRp,0.1111111111111111,18,17,GAGTCAGTTCTGGTACGTCA,1,5039687
ykgRp,1.1666666666666667,37,17,GAGCCACGTCCTCACTCCAC,20,5038733
ykgRp,0.1111111111111111,18,17,GAGCATGAAACGGACTTGCA,1,5041107
ykgRp,1.5555555555555556,44,17,GACGTGGCCGCGTGGATCTG,27,5043878
ykgRp,0.7222222222222222,29,17,CGTCATGCCTCGTTAGCCAT,12,5051572
ykgRp,1.0,34,17,CGGCCGAGGAGCAGTGTGGA,17,5042684
ykgRp,0.7222222222222222,29,17,CGCCGTGATCACTCAGGAGT,12,5038896
ykgRp,1.3888888888888888,41,17,CGCCGAGAGTCCGGTCGCAT,24,5037449
ykgRp,1.2777777777777777,39,17,CGAGGACAGATTATTTCTGA,22,5033059
ykgRp,0.8333333333333334,31,17,CGACTTGCTTTTTTTCGCAT,14,5032066
ykgRp,2.7222222222222223,65,17,CCTCTCCCCGGGTACGGGTA,48,5053397
ykgRp,0.16666666666666666,19,17,CCGGAACGTGAAGATCCCCC,2,5041929
ykgRp,0.3333333333333333,22,17,CCCTACCGGCTATGGTGCAA,5,5036091
ykgRp,1.2777777777777777,39,17,CCAGCGGGGTTTACTGTCAT,22,5059353
ykgRp,0.9444444444444444,33,17,CATGCTCCCCGGTCTGGTCT,16,5054292
ykgRp,0.6111111111111112,27,17,CATGCCTTGGGGAAATGTCT,10,5036428
ykgRp,0.6666666666666666,28,17,ATTTTGTCAAATTCTCGGCA,11,5033708
ykgRp,0.3888888888888889,23,17,AGGTGCTCGGTCTCTAAATT,6,5034070
ykgRp,0.7777777777777778,30,17,ACGTTTCAGATTTTGGCCAG,13,5053531
ykgRp,0.9444444444444444,33,17,ACGGTGTCTGCAACGTAGGA,16,5052481
ykgRp,0.1111111111111111,18,17,ACCCTTAAATACCTGCGGGA,1,5032065
ykgRp,0.8888888888888888,32,17,AACCAAATGTGAAGCCAATT,15,5039863
ykgRp,1.3529411764705883,38,16,TTGCGTGTCCGAATTTTGAT,22,5057213
ykgRp,2.8823529411764706,64,16,TTAATTTGACGGTTTACGTG,48,5051006
ykgRp,1.0,32,16,TGGCAAATCGGCCCCTAGAG,16,5044939
ykgRp,0.11764705882352941,17,16,TCTTAGTGCGCGGTCAGAGG,1,5037847
ykgRp,1.0,32,16,TCTATAGGCTGCCCGATGTG,16,5033645
ykgRp,0.17647058823529413,18,16,TCTAGAGCTATCGAGCCCTT,2,5054314
ykgRp,5.529411764705882,109,16,TCGCTCCTAGGCGAAACCCA,93,5049974
ykgRp,1.4705882352941178,40,16,TAGACAACTCGGGCAGGCGC,24,5059264
ykgRp,1.3529411764705883,38,16,TAACGCCTGTCGCTCAGTCA,22,5054113
ykgRp,0.8823529411764706,30,16,GTTACATGACACTGTCTGAT,14,5055710
ykgRp,0.7058823529411765,27,16,GTCGGTTGTGTCAGGCCGGT,11,5045347
ykgRp,2.4705882352941178,57,16,GTATAGGGCAACCAACACCA,41,5050083
ykgRp,0.7647058823529411,28,16,GGAGCAGAGGTTGTACGGGT,12,5040160
ykgRp,1.3529411764705883,38,16,GCGGCTTATCTCTGGGAGGA,22,5042381
ykgRp,1.1176470588235294,34,16,GCGATGGACATTGGGATGGA,18,5056635
ykgRp,1.1764705882352942,35,16,GCCAGCAGTATCTGCGTGAG,19,5060948
ykgRp,2.0588235294117645,50,16,GCACGCTTAACCACGGCTCA,34,5049977
ykgRp,0.8823529411764706,30,16,GCAATGGGTGAAAGGTGAGT,14,5038725
ykgRp,1.411764705882353,39,16,GATCCGGGGGCCACGACTCC,23,5032361
ykgRp,1.6470588235294117,43,16,GACTTTAATGTTAAGCGATA,27,5050326
ykgRp,0.8823529411764706,30,16,CTTCTTAGCTTGTCCGTGCG,14,5060039
ykgRp,0.11764705882352941,17,16,CTTACCATCGAATGCTTTCT,1,5053524
ykgRp,1.0,32,16,CTTAATGTAGTTCCAGCGAG,16,5048648
ykgRp,2.5294117647058822,58,16,CTGTTGAGCGCCATATCAGT,42,5042671
ykgRp,0.7647058823529411,28,16,CTCGCATCTGGAGGGCCTGT,12,5040913
ykgRp,1.1764705882352942,35,16,CTACTAGTTGGATCAGTCTT,19,5034231
ykgRp,0.17647058823529413,18,16,CGAGCATGCCTAAAGGTCTA,2,5032139
ykgRp,0.17647058823529413,18,16,CCTCACACTAAGAGTAATAA,2,5034867
ykgRp,1.4705882352941178,40,16,CCGGGGGAAGTTTGGTGGTT,24,5033161
ykgRp,0.7647058823529411,28,16,CCCGCCTCCCCGCCTTAAGA,12,5034959
ykgRp,1.588235294117647,42,16,CATCCGATACGTGTAGGAAG,26,5052737
ykgRp,2.1176470588235294,51,16,CACTAAATTGTAATCGTCAG,35,5038046
ykgRp,1.0,32,16,CAAATAGTAGACCGGAGGAT,16,5032541
ykgRp,0.4117647058823529,22,16,ATTATGTGTAAATCTGCGAA,6,5047424
ykgRp,2.0588235294117645,50,16,ATCAATGGTATCAAAGGGAT,34,5043414
ykgRp,0.5882352941176471,25,16,ATATGTGTAGTTGCTTCACA,9,5037195
ykgRp,0.9411764705882353,31,16,ACTTTTGGGGATTGTGCGGG,15,5049507
ykgRp,0.6470588235294118,26,16,ACGGGCCGACGTCACGTTGC,10,5049879
ykgRp,0.5882352941176471,25,16,ACCTCTCTTGATTCCACTCC,9,5044822
ykgRp,0.47058823529411764,23,16,ACATATGGACCGTTGCCTTA,7,5041859
ykgRp,2.375,52,15,TTGTGCTACGTTTTCATACT,37,5039085
ykgRp,0.1875,17,15,TTGGGTCTGAGTATCTATAC,2,5045919
ykgRp,0.5625,23,15,TTGGACCATGCCAGCCAGAT,8,5046887
ykgRp,0.125,16,15,TTCCCGGTAGTGAGGTGAAT,1,5047009
ykgRp,1.375,36,15,TGTTCTGAAGCCCAGTCTGA,21,5046924
ykgRp,2.9375,61,15,TGTCGTGCTCGCCTCACTGC,46,5047085
ykgRp,1.9375,45,15,TGCCTAGATCACGGTCCAGT,30,5039269
ykgRp,1.375,36,15,TAACCGGGGCTCCAGAGTAC,21,5053673
ykgRp,5.375,100,15,GTTTCAGTTACGGTTTCCGG,85,5059974
ykgRp,1.0,30,15,GTTGGGATATAGGGTCATGA,15,5032035
ykgRp,1.125,32,15,GTACGTCTTGCCTAGGCTCA,17,5043426
ykgRp,0.8125,27,15,GGGTAGGCTTAGACGCAACC,12,5050756
ykgRp,0.625,24,15,GGGAAAGATACCTTTAGTGG,9,5054121
ykgRp,1.3125,35,15,GGCTTCGTGAAGGACGTGTG,20,5050745
ykgRp,1.5625,39,15,GGCGCGGAGTTTTCGCCCGT,24,5044017
ykgRp,1.125,32,15,GCTAGTACTTGTTTCTGAAT,17,5036371
ykgRp,1.0,30,15,GATTTGATGAAATATGTCCG,15,5032442
ykgRp,0.125,16,15,GATCTCTAGAAGGTTGTAAA,1,5034269
ykgRp,0.125,16,15,GATAACTAGGCCGTGAACAA,1,5055257
ykgRp,0.25,18,15,GAGTATCCCACATTCGAGAG,3,5043498
ykgRp,0.25,18,15,GAGATTGTCAAGTGGCTTCA,3,5034460
ykgRp,1.5,38,15,GACTATCCTACTCTAGGGAT,23,5041566
ykgRp,1.8125,43,15,CTTCAGATGTTAGCATCATG,28,5033979
ykgRp,2.9375,61,15,CTGGAAGAGCTCCATGCCAC,46,5041165
ykgRp,1.125,32,15,CTCGGTGGAAGGTTCCGTGC,17,5041997
ykgRp,1.375,36,15,CTACCATAGCGGTCCTCATA,21,5040276
ykgRp,2.125,48,15,CGGGGGCTCTCATCGCTATA,33,5057837
ykgRp,0.625,24,15,CGGGGCTGGTATACCCGTAT,9,5033398
ykgRp,1.75,42,15,CGGCCTACGTGGAGCAATTT,27,5036515
ykgRp,1.75,42,15,CGCGGATGATTGCGTCGCTT,27,5048157
ykgRp,0.3125,19,15,CGAAGACGTAAGCGTGACCG,4,5049954
ykgRp,0.3125,19,15,CAGCTTTGCCCTTTTGTTTA,4,5033441
ykgRp,1.4375,37,15,CACGAATAGTCTTGGTTAGA,22,5052406
ykgRp,0.9375,29,15,CAACTCACATTTCATGTTTA,14,5045767
ykgRp,1.375,36,15,ATTCTTAGTGTAGGATTACT,21,5053122
ykgRp,0.875,28,15,ATCATAACCGACGCAGTAGC,13,5049346
ykgRp,2.875,60,15,ATATCATTTTTTACGTATCT,45,5039430
ykgRp,4.125,80,15,ATAGTACGCTCCCCATCATC,65,5048762
ykgRp,1.25,34,15,ATAGGACCCAGTTACTACCA,19,5054308
ykgRp,0.9375,29,15,AGTCGATTGGGAGTGTTCAT,14,5057234
ykgRp,1.1875,33,15,AGGTTCAACCTATGCTGGAG,18,5046774
ykgRp,1.4375,37,15,AGGTACACTCGCGTCCACTA,22,5049926
ykgRp,1.8125,43,15,AGGATCGGGGAGGATTATTG,28,5041156
ykgRp,3.25,66,15,ACTGGTAAGAAGGAAGGGTT,51,5040941
ykgRp,7.9375,141,15,ACTATGCAGTTTACCCTGCA,126,5040121
ykgRp,1.125,32,15,ACTAACTGGGGTTTTCCGCT,17,5051351
ykgRp,1.9375,45,15,ACAGGTTGTTTATGCTTGCT,30,5053399
ykgRp,1.5,38,15,AAGTATTCGCTAGCGAGCTA,23,5048535
ykgRp,1.4375,37,15,AAGTAAGCGGCTACTGGTGT,22,5033892
ykgRp,2.75,58,15,AAGCGCGGTCAATTACGGTA,43,5061667
ykgRp,1.1333333333333333,30,14,TGTCCTATACCGTTCCTATT,16,5059822
ykgRp,1.6,37,14,TGGTCTCGCAAAAGACACAG,23,5060323
ykgRp,1.4,34,14,TGGGTATGATTGAACATTGC,20,5036306
ykgRp,0.9333333333333333,27,14,TGGAACGTTAATCGGCCTGC,13,5039689
ykgRp,2.533333333333333,51,14,TGACGGAACAGGTTCCAAAG,37,5032753
ykgRp,1.3333333333333333,33,14,TCTTTCTTAGGGGTCGGCGA,19,5043453
ykgRp,2.3333333333333335,48,14,TCTTATCCGTGACGGCCAGT,34,5042672
ykgRp,0.8,25,14,TCTAGAGAGCCTAGGCCTTG,11,5042805
ykgRp,0.7333333333333333,24,14,TCGTTGCACGTCCTGCGCTT,10,5032378
ykgRp,1.0666666666666667,29,14,TCGAGGGCGGTATAGTGGTA,15,5061327
ykgRp,0.9333333333333333,27,14,TCATTGGGATGCCAACAGGC,13,5036095
ykgRp,2.2,46,14,TACCGCTCTTGCGGTTCCTG,32,5037571
ykgRp,0.13333333333333333,15,14,GTCTCCTGCAAAGTAGTAAT,1,5040912
ykgRp,1.0,28,14,GTCGGCTTGTTTGGTTAACT,14,5049673
ykgRp,1.4666666666666666,35,14,GTCAGCACCTCTTCTAATTG,21,5032798
ykgRp,1.5333333333333334,36,14,GTAGTGATTATTTTGTAAAC,22,5055457
ykgRp,1.0,28,14,GGTCTTGCGATCGGGGTATG,14,5032571
ykgRp,0.4666666666666667,20,14,GGTCCCTACTACATCCGTCA,6,5037122
ykgRp,1.2,31,14,GGGGTTTTTTCTTAATTCGA,17,5036907
ykgRp,1.0666666666666667,29,14,GGGCATTGCTTTCACACTGA,15,5033115
ykgRp,0.7333333333333333,24,14,GCGTACTGCCAGTCCTAAGA,10,5058299
ykgRp,1.6,37,14,GCGGGTCTCTCACAGTGTGG,23,5047027
ykgRp,2.7333333333333334,54,14,GCCTCTCCTCCACCTCAAGC,40,5035357
ykgRp,1.0,28,14,GCATGATACATTGCGCAGGA,14,5055003
ykgRp,0.6,22,14,GCAATATCTTGAAACATCCC,8,5058311
ykgRp,0.8,25,14,GATGCACAACCGGCAGTAGT,11,5045440
ykgRp,2.3333333333333335,48,14,GACTTGAACCTCACCGTATT,34,5046315
ykgRp,0.9333333333333333,27,14,GACTCTCGACGTGGCCCTAA,13,5048620
ykgRp,0.6666666666666666,23,14,GACGGTATCAATATCTGGTG,9,5031733
ykgRp,1.2,31,14,GAAGGGGAAGTAGCGCCCGA,17,5035019
ykgRp,0.13333333333333333,15,14,CTTCTCTATCACATAATCTT,1,5035963
ykgRp,1.3333333333333333,33,14,CTACGGCCGGACAGTTAGTT,19,5036983
ykgRp,4.133333333333334,75,14,CGTTTGAGCTGTCTTTTACT,61,5035532
ykgRp,1.0666666666666667,29,14,CGTACAAAACTCGGGTAGTG,15,5032995
ykgRp,1.2666666666666666,32,14,CGGCTACATGGATCTATCCA,18,5032437
ykgRp,1.8666666666666667,41,14,CGCTCTGCCCAGTCACCCAG,27,5035855
ykgRp,1.0666666666666667,29,14,CGAGATGAACCCCTTATCTA,15,5046282
ykgRp,0.8,25,14,CGAACTTCCCATGGGAGTCA,11,5052098
ykgRp,2.2,46,14,CCCTTTATTCGAGGCACACG,32,5034461
ykgRp,0.4,19,14,CCCGTGACCGCTTAGACGGA,5,5050759
ykgRp,1.0666666666666667,29,14,CATTCTTGCTAGAGTTAACT,15,5035423
ykgRp,0.5333333333333333,21,14,CATAGGACCTCACGTACTAG,7,5051251
ykgRp,1.6666666666666667,38,14,CAGTCGATCGCTTCAGTTCT,24,5040885
ykgRp,1.2666666666666666,32,14,CAGATCAACGACTCGCGCCT,18,5057753
ykgRp,1.8,40,14,CAGACATCGGTAATGAGCGA,26,5033264
ykgRp,1.3333333333333333,33,14,ATTGGGTCCCACACTAGCGA,19,5035208
ykgRp,3.2666666666666666,62,14,AGCGTAAAGACTAATCAGTG,48,5059053
ykgRp,1.1333333333333333,30,14,AGACACAGGTTTACGCGATG,16,5043475
ykgRp,1.4,34,14,ACTGCCCTTGACTCATTAGC,20,5037059
ykgRp,1.2666666666666666,32,14,ACGGGTACTTATATAACCAA,18,5035051
ykgRp,0.6,22,14,ACGCAACAGAGATTTACGGC,8,5040842
ykgRp,1.0,28,14,ACGACTACGGACGAGTAAGT,14,5037642
ykgRp,1.5333333333333334,36,14,ACCGATTACTTGTCCTCCGC,22,5037969
ykgRp,0.9333333333333333,27,14,ACATGTCTCTTACAGATTAG,13,5047475
ykgRp,1.0,28,14,ACAACGGATAGCCTGGGGGA,14,5036218
ykgRp,0.13333333333333333,15,14,AATCCACCCAGGTATCGGTT,1,5061571
ykgRp,0.7333333333333333,24,14,AATAAAGTCATTTTTAACAT,10,5037810
ykgRp,0.2,16,14,AAGCAATGCCTAGTTTGCTC,2,5057677
ykgRp,0.13333333333333333,15,14,AACTGCCTGTGGTTTACCCA,1,5039842
ykgRp,1.7333333333333334,39,14,AACCATGCTCTCAATATCCT,25,5058396
ykgRp,2.2666666666666666,47,14,AACATATACCTCGTAAGATA,33,5031653
ykgRp,2.8,55,14,AAACAATCTAGCCACTGGGA,41,5042262
ykgRp,3.7142857142857144,64,13,TTCCTTGCGTTTGTCCATCC,51,5041063
ykgRp,0.5714285714285714,20,13,TTATGGAAGGAATACGAATC,7,5047146
ykgRp,1.2857142857142858,30,13,TGTTGCCGCTTCTTGGTGTT,17,5057362
ykgRp,0.14285714285714285,14,13,TGTGTCGTAAGGTCGAGCGT,1,5055007
ykgRp,1.2857142857142858,30,13,TGTGCTAGGCTCGATGAAAA,17,5047661
ykgRp,1.9285714285714286,39,13,TGTCGCCCGCGTGCTCGGGT,26,5043269
ykgRp,2.2857142857142856,44,13,TGTAACTCGTCTCCGTCGCA,31,5051989
ykgRp,3.142857142857143,56,13,TGGAGCATTCGCCCAGAGGC,43,5039315
ykgRp,0.6428571428571429,21,13,TGACTGTATGTTAATAATTT,8,5052513
ykgRp,1.0714285714285714,27,13,TCTGATCCAAGCTTATAGGG,14,5057548
ykgRp,1.2857142857142858,30,13,TCGAGAAAGCTACTCCCGCC,17,5037840
ykgRp,3.142857142857143,56,13,TCCTTCGTTCACGCAAGGCC,43,5053253
ykgRp,4.357142857142857,73,13,TCCTGTGGTTACGTTTATTA,60,5048639
ykgRp,0.9285714285714286,25,13,TCATGCACAGACGTAGTACT,12,5058741
ykgRp,1.8571428571428572,38,13,TATATGACAATCGTGCGGAT,25,5036954
ykgRp,0.8571428571428571,24,13,TAAGGAAGACCAAATTATGA,11,5036263
ykgRp,1.6428571428571428,35,13,GTTTTCCTAGTTTCATTTTT,22,5032462
ykgRp,2.2857142857142856,44,13,GTTTAGATCACTCAAGCAAA,31,5033177
ykgRp,0.21428571428571427,15,13,GTTGAATTCGTTTTCTGACA,2,5033166
ykgRp,1.4285714285714286,32,13,GTGGTGGGACGGGGTCGCAA,19,5049085
ykgRp,1.0,26,13,GTGACTGCATGTTCCTAAAC,13,5045849
ykgRp,1.4285714285714286,32,13,GGCGGCGCTCCCGGACTTCA,19,5050364
ykgRp,1.6428571428571428,35,13,GGCAAGGGTTATTGGCGGAT,22,5033532
ykgRp,14.285714285714286,212,13,GGATTCAGCTTTTCAGTTTA,199,5042198
ykgRp,0.6428571428571429,21,13,GGACTTTGTAACAAGAACAA,8,5048941
ykgRp,0.9285714285714286,25,13,GGACGTTACCGGGGCTAAGG,12,5033190
ykgRp,2.9285714285714284,53,13,GGAACCCACCCGTCACCTTT,40,5032195
ykgRp,0.42857142857142855,18,13,GCGACATACGCTACTCTGGG,5,5041341
ykgRp,1.6428571428571428,35,13,GCAACATCTTCGACGGCATC,22,5041649
ykgRp,1.7142857142857142,36,13,GCAAATTTCACCATGCCTGG,23,5047791
ykgRp,1.3571428571428572,31,13,GACACTTAACTCGGGTAGAA,18,5038185
ykgRp,0.21428571428571427,15,13,GAATTATCGCGACCGTAGAG,2,5042199
ykgRp,2.5,47,13,CTTGGACACCCGGTTAACCC,34,5045069
ykgRp,0.14285714285714285,14,13,CTTGCGTGCTGATGGATGGG,1,5038945
ykgRp,1.3571428571428572,31,13,CTTGACGGTGTTTGTCCTTG,18,5050723
ykgRp,0.14285714285714285,14,13,CTTACTCGAAAGACGATTCA,1,5037919
ykgRp,1.0714285714285714,27,13,CGGCTCCATGCGTTGGTGTC,14,5044979
ykgRp,1.0,26,13,CGCGCTTGCTATCAAGCGCT,13,5031859
ykgRp,2.0714285714285716,41,13,CCTGAGCGGGCCGCGAAGCA,28,5036001
ykgRp,2.2142857142857144,43,13,CATTTTACGTGCTCTCTTCG,30,5054616
ykgRp,0.14285714285714285,14,13,CAAATTGGATGGGGTCTTCC,1,5032569
ykgRp,0.21428571428571427,15,13,ATTTGATATCGATCCCTAAA,2,5041891
ykgRp,0.14285714285714285,14,13,ATGTGGTTTTCCTCAACTTA,1,5053823
ykgRp,2.0,40,13,ATCCCTGGGGTGTGCTTCTA,27,5053191
ykgRp,1.0714285714285714,27,13,ATAGACGCATACCGACTCCA,14,5061020
ykgRp,0.6428571428571429,21,13,ATACACTCCCATGTCGAACC,8,5049841
ykgRp,1.9285714285714286,39,13,AGTTGTGCTATATCAATCGC,26,5050506
ykgRp,1.0714285714285714,27,13,AGTGTACCTTTAGGATGAAG,14,5054282
ykgRp,1.8571428571428572,38,13,AGCTTATAACGGTGATCCAA,25,5033063
ykgRp,5.285714285714286,86,13,AGACGACTGAACTACCCCTA,73,5048670
ykgRp,0.14285714285714285,14,13,AGAACTCGCAGCGTCAACTG,1,5056043
ykgRp,1.5,33,13,ACTTTGTGCGGTTTCCCGTG,20,5038365
ykgRp,2.7857142857142856,51,13,ACTTTGCGAATCAACGAGGA,38,5038606
ykgRp,2.0714285714285716,41,13,ACTGGATGGGTGTTTCGGAA,28,5042554
ykgRp,1.4285714285714286,32,13,ACGACAAAATAGACCGCGAC,19,5044021
ykgRp,0.14285714285714285,14,13,ACCCTATCTCTACCTTGTCT,1,5040363
ykgRp,2.357142857142857,45,13,ACCAGATCGCGGAAGAGCTT,32,5033172
ykgRp,1.1428571428571428,28,13,AATTCACGTAAATTGATGCT,15,5055078
ykgRp,1.2142857142857142,29,13,AAGGTGAAGGGTCGTCTTTT,16,5035830
ykgRp,2.0714285714285716,41,13,AAGGTCCATTCCTAGTCGAA,28,5040380
ykgRp,1.8571428571428572,38,13,AACTGGGTGGTGTTTATGCA,25,5045761
ykgRp,0.14285714285714285,14,13,AACTGAATGGGTTGAGTCCA,1,5057874
ykgRp,1.4285714285714286,32,13,AACTCTTACACAGTGGTGAG,19,5037187
ykgRp,1.0714285714285714,27,13,AAAGGATACCTCGCATACTG,14,5042516
ykgRp,2.4615384615384617,43,12,TTGTGATTCCGTGAGGGTTG,31,5039647
ykgRp,0.3076923076923077,15,12,TTGCTTACGGATACGTCGAT,3,5043281
ykgRp,1.0769230769230769,25,12,TTGCTGTAGACATAGACACT,13,5038247
ykgRp,3.5384615384615383,57,12,TTGCCTACCCGTCATAAGCG,45,5037015
ykgRp,0.15384615384615385,13,12,TTCGGAGTCGAATCCTAAAC,1,5040184
ykgRp,0.8461538461538461,22,12,TTACCTTGTTGAAATAGGTT,10,5035975
ykgRp,1.4615384615384615,30,12,TTAAGCGCTGCCCGTGTGAG,18,5034186
ykgRp,0.15384615384615385,13,12,TGCTAGCTTGACATGTACTA,1,5048295
ykgRp,1.8461538461538463,35,12,TGCCACTAACGCGGTATTGT,23,5033109
ykgRp,2.230769230769231,40,12,TGATATCTAACCTTAACCCA,28,5032525
ykgRp,0.15384615384615385,13,12,TCTGCAGCTAGGTCGTTGGT,1,5047120
ykgRp,0.5384615384615384,18,12,TCCTGATCGCATGCCAAACA,6,5045154
ykgRp,0.38461538461538464,16,12,TCAACCGCTCATCCCAGTGA,4,5033281
ykgRp,0.8461538461538461,22,12,TATTTAAATCCGGGCAAGAA,10,5051367
ykgRp,3.6153846153846154,58,12,TAGCCTTGCTCGGGCCTACT,46,5040865
ykgRp,1.2307692307692308,27,12,TACGAAAAACGCAAGTCCCA,15,5031622
ykgRp,1.6153846153846154,32,12,TAAGTTGGCGACCTAAGGGT,20,5031892
ykgRp,1.6923076923076923,33,12,TAAGGTAAAAGAATTCAATT,21,5031765
ykgRp,0.6153846153846154,19,12,TAAAATATCGTTTAGAGCTG,7,5058219
ykgRp,0.8461538461538461,22,12,GTTTAACTCTCGACCATACT,10,5049111
ykgRp,0.38461538461538464,16,12,GTTGACCCTACGTGCACGTT,4,5038260
ykgRp,1.9230769230769231,36,12,GTCACTCGGAGAGTTCTTTG,24,5046458
ykgRp,5.230769230769231,79,12,GTAAAATCTTTCGATTTATT,67,5037626
ykgRp,10.923076923076923,153,12,GGGTAGCTCACAACCGAGAA,141,5032122
ykgRp,1.3846153846153846,29,12,GGCGTTGGCACCCACTATGT,17,5040649
ykgRp,1.6153846153846154,32,12,GGCAGGTCTTGTATCCCCAT,20,5051249
ykgRp,1.1538461538461537,26,12,GGCACTGTTCAAGGGTCTTT,14,5051115
ykgRp,1.3846153846153846,29,12,GGATTCGTTGTATTAAAGCA,17,5060286
ykgRp,1.6153846153846154,32,12,GGAGCACATGGCTGTCTGTA,20,5033318
ykgRp,1.5384615384615385,31,12,GCCACATAATACCCCTTCGG,19,5032676
ykgRp,2.4615384615384617,43,12,GATTCGAGCCTCCCTTCTGT,31,5037295
ykgRp,0.8461538461538461,22,12,GATGTGTTCGCTCGAAACGG,10,5033728
ykgRp,2.3846153846153846,42,12,GATGGTGACCGTATCCCTGT,30,5033080
ykgRp,3.769230769230769,60,12,GATGCTAGAAGGGGCCGGCA,48,5058303
ykgRp,2.923076923076923,49,12,GATCCATTGGACAAATTCAA,37,5053433
ykgRp,1.0769230769230769,25,12,GAGTCGGTTCTAATATCACG,13,5059781
ykgRp,1.8461538461538463,35,12,GAGCCGCCGGTTGTGCACAA,23,5048024
ykgRp,0.8461538461538461,22,12,GAATCGCCCTAGTTGTCGAC,10,5050050
ykgRp,1.4615384615384615,30,12,GAAGGTTTAATGCGCAATGT,18,5041996
ykgRp,1.0,24,12,GAAGGACTGAATCAGTACGT,12,5035533
ykgRp,1.5384615384615385,31,12,GAAGCATGCGAAGGTTCGAA,19,5055657
ykgRp,4.3076923076923075,67,12,CTTTCTGTACGATGTGGTAA,55,5057243
ykgRp,2.076923076923077,38,12,CTCGCTTGGTATCGTGGGGT,26,5048703
ykgRp,1.5384615384615385,31,12,CTACGCACCCGGACTACGTT,19,5047594
ykgRp,4.0,63,12,CGTCCATGGCGCCGTTATTG,51,5041860
ykgRp,0.15384615384615385,13,12,CGGGTAGATTTACTGGAACA,1,5053775
ykgRp,1.3076923076923077,28,12,CGCCGGTTCGCCGAGCAGAA,16,5055592
ykgRp,0.6153846153846154,19,12,CGCCCTCGCGTATTATTAAA,7,5042323
ykgRp,1.2307692307692308,27,12,CGACTTCAGTGGCGCCAAAA,15,5035271
ykgRp,0.15384615384615385,13,12,CCTATGGCGTCTTTCATTTG,1,5049174
ykgRp,2.5384615384615383,44,12,CCGGCACTATACTACCGGTT,32,5058361
ykgRp,1.1538461538461537,26,12,CCCAGTACACCGGTACTTGA,14,5050862
ykgRp,3.0,50,12,CATGGTCTAACCAGCGAAAA,38,5054442
ykgRp,1.3076923076923077,28,12,CATGGTATAGGGTTCTTAGT,16,5033211
ykgRp,3.4615384615384617,56,12,CAATTCTATCATGACTCCAC,44,5041681
ykgRp,1.5384615384615385,31,12,CAACTCTAATGAACAAAAGA,19,5039488
ykgRp,2.769230769230769,47,12,ATGTCCGTAATCCAACAGTT,35,5041202
ykgRp,1.1538461538461537,26,12,ATCTACCAAGGGGACTCAAG,14,5044001
ykgRp,0.15384615384615385,13,12,ATCATCGGGAGTGGCAAGGT,1,5039110
ykgRp,1.4615384615384615,30,12,ATATCTGCGCACACTAACAT,18,5052201
ykgRp,1.3846153846153846,29,12,ATACGACATACCACGAATCC,17,5038510
ykgRp,0.6923076923076923,20,12,AGTAACCGTCATACCGTTCC,8,5031358
ykgRp,1.6923076923076923,33,12,AGCTCCGGTTCTGTCTCTGA,21,5031926
ykgRp,0.23076923076923078,14,12,AGATTAACCTATTTCCTACA,2,5040565
ykgRp,1.8461538461538463,35,12,AGAACATCCCTTAGTAACTG,23,5042308
ykgRp,2.0,37,12,ACTCCTACTTCTGTATCGTT,25,5056989
ykgRp,1.3076923076923077,28,12,ACTCCTACGTTCTAGAGTAT,16,5056350
ykgRp,0.15384615384615385,13,12,ACGGGTGGTCTACTGACGTA,1,5033350
ykgRp,0.15384615384615385,13,12,ACATAGACTACCACGCCCCT,1,5056421
ykgRp,1.9230769230769231,36,12,AAGACACGGCAAGCATTCTG,24,5053819
ykgRp,2.1538461538461537,39,12,AACAGGCGTCATCCTAAAGA,27,5044938
ykgRp,1.8461538461538463,35,12,AACAGAGGCCCTAGATACGC,23,5056521
ykgRp,0.9166666666666666,21,11,TTTGTTCGCCATGCATACAT,10,5048312
ykgRp,0.5833333333333334,17,11,TTGCACTGATTGAAACCTTT,6,5048641
ykgRp,0.16666666666666666,12,11,TTATCTGGGGTTTGAAGAAT,1,5040475
ykgRp,1.5,28,11,TTACCTGCTATTTCCTATGA,17,5039449
ykgRp,0.75,19,11,TGTGACCTTGAAGCCGGGAA,8,5046581
ykgRp,1.75,31,11,TGTCACCGGTAGCACGGTCT,20,5033784
ykgRp,2.5,40,11,TGGTGTGCGGAATTCATTTC,29,5033506
ykgRp,1.3333333333333333,26,11,TGGGGCTAGCCATTGGCAAA,15,5059698
ykgRp,0.16666666666666666,12,11,TGGGCTCTCTACAGAGATAG,1,5054423
ykgRp,1.5833333333333333,29,11,TGGCGCTACGCGTCCTAGAC,18,5039940
ykgRp,1.0833333333333333,23,11,TCTCCATAGGTAAGTAATTA,12,5035881
ykgRp,0.16666666666666666,12,11,TCGGCTGCGAATTGTCGCTA,1,5056568
ykgRp,1.0,22,11,TCGATACTGGACGTCGTCGC,11,5054959
ykgRp,1.6666666666666667,30,11,TCCCCTAGAGCCGCAGCAGG,19,5047722
ykgRp,3.25,49,11,TATTAGGGTTGTGTCGGTGC,38,5049773
ykgRp,4.416666666666667,63,11,TATTACCGACCCTTTCTCCA,52,5050043
ykgRp,0.16666666666666666,12,11,TATCGAGATAGTGCATGCTA,1,5031370
ykgRp,0.5833333333333334,17,11,TAGGACGTTTACAGCCCGGC,6,5054829
ykgRp,0.75,19,11,TACCGAGCGGCTCTGGGCGT,8,5060957
ykgRp,2.1666666666666665,36,11,GTTGTTCAACACGGGCGATG,25,5034050
ykgRp,2.1666666666666665,36,11,GTGAATCACAGTATGGAAGT,25,5042737
ykgRp,1.0,22,11,GTAATGATCTATACTTCACA,11,5041413
ykgRp,1.1666666666666667,24,11,GGTTCCGGTAAGAGAACTTA,13,5034120
ykgRp,0.16666666666666666,12,11,GGTCACGGGACGAGGACAAT,1,5049014
ykgRp,4.416666666666667,63,11,GGGTTGATATTGTTTGAAAA,52,5056982
ykgRp,0.9166666666666666,21,11,GGGTTCAAAGTATAGCAGTA,10,5045725
ykgRp,1.5833333333333333,29,11,GGGGCGATGTTCCGCTGCAA,18,5051679
ykgRp,1.3333333333333333,26,11,GGGGCACAGACGTGGAATTG,15,5036761
ykgRp,1.6666666666666667,30,11,GGGAGTAATGTCTAAGGGAT,19,5051218
ykgRp,0.16666666666666666,12,11,GGCGCGACGACAGCATGGTG,1,5050865
ykgRp,0.5833333333333334,17,11,GGATAGAAGGTTGTTTGGTA,6,5046026
ykgRp,0.75,19,11,GGAGCAGACTCAAGACTCCT,8,5058161
ykgRp,1.75,31,11,GCTGAGTACAATTCAACGGT,20,5034737
ykgRp,3.3333333333333335,50,11,GCGTTGATTAAAACTTGCTA,39,5050054
ykgRp,0.16666666666666666,12,11,GCGAGTGAATAACATCGGTT,1,5041447
ykgRp,1.5833333333333333,29,11,GCCCGGTAACGAACTAAAAT,18,5037397
ykgRp,1.1666666666666667,24,11,GCCAGTTAAGTCAGCGAATG,13,5036795
ykgRp,1.9166666666666667,33,11,GCACGGCCGGACACTCCTGT,22,5052610
ykgRp,1.9166666666666667,33,11,GATCGTGGTCTAACGAGGCA,22,5047793
ykgRp,1.8333333333333333,32,11,GACGACATATGGCTCATAAA,21,5056172
ykgRp,1.4166666666666667,27,11,CTTCCGTACGAGTTTTACGG,16,5057236
ykgRp,1.5,28,11,CTTACTTCCGTCTTACGATT,17,5044174
ykgRp,2.1666666666666665,36,11,CTGATATGCGGAAATGATGT,25,5055999
ykgRp,4.75,67,11,CTCTCCTGTTAAGTTTATTG,56,5034464
ykgRp,0.16666666666666666,12,11,CTCGAGGCCAACCTCAGGTA,1,5034716
ykgRp,0.16666666666666666,12,11,CGTTTTTGCTTTAGTGCTAC,1,5048027
ykgRp,0.3333333333333333,14,11,CGTGTGCCCGGGGAACGATG,3,5045444
ykgRp,1.9166666666666667,33,11,CGGTTGTTAAGCTATGCGCT,22,5056254
ykgRp,1.4166666666666667,27,11,CGGGCTCACTAAAAGGATCT,16,5037166
ykgRp,1.6666666666666667,30,11,CGGCTTTGCCCATGACCTCG,19,5045047
ykgRp,2.5833333333333335,41,11,CGGCAATCAAGTCGGTCTAC,30,5036680
ykgRp,2.0833333333333335,35,11,CGATCGAAACTAGGTTACGT,24,5053960
ykgRp,2.0833333333333335,35,11,CGATATCTTTACCAGCGTGA,24,5040431
ykgRp,0.5833333333333334,17,11,CGAGTGGAAAACCGATATGA,6,5034498
ykgRp,1.4166666666666667,27,11,CGAGTCCATATGATTTTGAA,16,5049294
ykgRp,1.9166666666666667,33,11,CCTTTTGTGGTAGTCTTCGC,22,5057460
ykgRp,1.5833333333333333,29,11,CCTTCATAAAGCTTCGTTGC,18,5039188
ykgRp,2.0,34,11,CCTGTCAGCCACACGTCTGG,23,5031927
ykgRp,2.0833333333333335,35,11,CCTGAAACCAGGGCCAGCGA,24,5043381
ykgRp,0.16666666666666666,12,11,CCATAAACCCGTAGGAAATC,1,5034600
ykgRp,0.16666666666666666,12,11,CATGGGACTTTCACGCGTAT,1,5040197
ykgRp,3.5,52,11,CAGTCGGTCTCTTCGAAATT,41,5031542
ykgRp,1.0833333333333333,23,11,CACCGAAACACGCCGGTCGG,12,5056170
ykgRp,3.9166666666666665,57,11,ATTCCACTAAGTGAATCCAC,46,5036653
ykgRp,1.0833333333333333,23,11,ATTCACTGCGTATGTTTTAA,12,5054111
ykgRp,0.16666666666666666,12,11,ATTACGGAACTGAGCAAGGT,1,5034388
ykgRp,1.0833333333333333,23,11,ATTAACAGCGGTATGAAGGT,12,5050880
ykgRp,1.5,28,11,ATGTTAATTCACCATGGCAT,17,5057312
ykgRp,1.4166666666666667,27,11,ATGGGTTTAGGAAGGGCTCC,16,5043452
ykgRp,1.8333333333333333,32,11,ATGAAGGTTGCTCTACATTA,21,5051186
ykgRp,0.16666666666666666,12,11,ATCTCTACACTCCTTGCTGC,1,5035780
ykgRp,5.083333333333333,71,11,ATCCAATTTGCTTGTTGACA,60,5049533
ykgRp,0.6666666666666666,18,11,ATACGTCTGCTGACAACCCT,7,5036068
ykgRp,4.75,67,11,ATACCGCCTTCGGGTAATTA,56,5057228
ykgRp,2.0833333333333335,35,11,AGTCTAGACAGTCGGGCAAA,24,5059168
ykgRp,0.4166666666666667,15,11,AGTACACCACCACGGTAAGA,4,5047116
ykgRp,0.16666666666666666,12,11,AGATTTGATAAGACTTGCAG,1,5049684
ykgRp,2.4166666666666665,39,11,AGAGGCGCAGCGTGGTCACT,28,5048318
ykgRp,0.5833333333333334,17,11,AGACACCAAGTATCGGGAGG,6,5039942
ykgRp,0.9166666666666666,21,11,ACGATAAGTTGGTTAACAAC,10,5039309
ykgRp,3.6666666666666665,54,11,ACAAGCCCGTTTGCCTTCCA,43,5056910
ykgRp,1.4166666666666667,27,11,AAGGCAACATAGGCATACGT,16,5052732
ykgRp,0.16666666666666666,12,11,AAACAAGTTACAAATTCTGA,1,5041607
ykgRp,5.25,73,11,AAAACTCCATCCTTGAACGT,62,5041152
ykgRp,1.0,20,10,TTTTAAAAAGCACACGTCCC,10,5050475
ykgRp,6.2727272727272725,78,10,TTGGGATTAAGTCCGCCCCA,68,5055742
ykgRp,2.1818181818181817,33,10,TTGCGATTCTAAATTATGTT,23,5042557
ykgRp,0.6363636363636364,16,10,TTGCACCTCGGTCCTCATAA,6,5035858
ykgRp,2.3636363636363638,35,10,TTCTCAGAGTTGCACGGACA,25,5032506
ykgRp,1.8181818181818181,29,10,TTAATTGGAACAAAAAGCAT,19,5039542
ykgRp,0.18181818181818182,11,10,TTAAAGCGACGACTCAATGA,1,5052091
ykgRp,1.1818181818181819,22,10,TGTTTGCGCTAGAGTAGGCC,12,5037322
ykgRp,0.45454545454545453,14,10,TGTTCAACAACATGGGACTA,4,5052609
ykgRp,0.18181818181818182,11,10,TGTGCCTCGATCTAAGCGAT,1,5036910
ykgRp,0.18181818181818182,11,10,TGTGACACCGATGCGAAGTT,1,5037950
ykgRp,1.0,20,10,TGTCCTACGGTGCGTCTAGG,10,5032393
ykgRp,1.5454545454545454,26,10,TGTAGCCATTTTTCGCCCTC,16,5038118
ykgRp,0.2727272727272727,12,10,TGTAGCCAGAGTCATGAGCA,2,5041779
ykgRp,0.5454545454545454,15,10,TGGTAGGAAAGCTTTGGTAC,5,5044248
ykgRp,0.2727272727272727,12,10,TGGCGAGAATGGTTACATAC,2,5044221
ykgRp,1.3636363636363635,24,10,TGGACAGGGTTTCCCGTGGG,14,5033297
ykgRp,1.1818181818181819,22,10,TGAACTTTGATGGGCAGCAC,12,5045886
ykgRp,1.8181818181818181,29,10,TGAACCCTGTTAGCCTAAAG,19,5047669
ykgRp,1.5454545454545454,26,10,TCTCATGACCCTTTATACTT,16,5056939
ykgRp,0.9090909090909091,19,10,TCGGGGATCCGGGTGGGTTG,9,5048888
ykgRp,1.5454545454545454,26,10,TCGCCCTAGGACGGAAAGAG,16,5039611
ykgRp,1.7272727272727273,28,10,TCGAGGGGCGTGACCTCGGG,18,5043126
ykgRp,0.18181818181818182,11,10,TCCTATTTAACATTGCCCAT,1,5050614
ykgRp,0.7272727272727273,17,10,TCCCTGTGCGCCTAACGGGA,7,5043002
ykgRp,1.9090909090909092,30,10,TATCGGGGGCTGGGGGTCTC,20,5041629
ykgRp,1.4545454545454546,25,10,TATATCGTACAGCTCTCAAA,15,5038175
ykgRp,1.9090909090909092,30,10,TATACCAGCTTGGTGATGGT,20,5048865
ykgRp,0.2727272727272727,12,10,TAGGGTCGTCTTAAACGGGT,2,5061190
ykgRp,0.18181818181818182,11,10,TAGACGTGACGGGACATGTG,1,5058689
ykgRp,1.2727272727272727,23,10,TACGCGATTATACGATCGAT,13,5031323
ykgRp,0.18181818181818182,11,10,TACACCCATTCGATAAATGG,1,5042827
ykgRp,0.9090909090909091,19,10,TAAGCGTCGTAGTGTCTAGC,9,5049191
ykgRp,2.090909090909091,32,10,TAACCAGAGTACTAAGCTCA,22,5042625
ykgRp,1.6363636363636365,27,10,TAAAGTGTCTTTGAACGCTA,17,5041081
ykgRp,0.7272727272727273,17,10,GTTCTCCCTGACGGCGTCGT,7,5039020
ykgRp,1.7272727272727273,28,10,GTGCGGCCTGCCTCCTTCAA,18,5036251
ykgRp,0.36363636363636365,13,10,GTGCCGTTGAGCACAAGATC,3,5033212
ykgRp,3.1818181818181817,44,10,GTGAATGTACGTTCTTCAGA,34,5049930
ykgRp,3.8181818181818183,51,10,GTAAATCGAGGTCCAGTTTC,41,5034317
ykgRp,0.18181818181818182,11,10,GGTGATATACCGAGTTTCAC,1,5053298
ykgRp,1.0909090909090908,21,10,GGGTAGGTACCCGTATCATG,11,5044314
ykgRp,2.0,31,10,GGGGGCGAATAACTTATACT,21,5045999
ykgRp,1.7272727272727273,28,10,GGGGGAGACCTCGTGGCGTC,18,5050594
ykgRp,1.1818181818181819,22,10,GGCTGGAGTGCATAAGGGAC,12,5031812
ykgRp,2.1818181818181817,33,10,GGCTCTTAAGAAATTACGAA,23,5044310
ykgRp,0.2727272727272727,12,10,GGCGTGGCGGGTCGCACATT,2,5045266
ykgRp,1.7272727272727273,28,10,GGCAATCAGTCAGGCTCGTA,18,5049167
ykgRp,1.1818181818181819,22,10,GGAGCTTCCATTGTGAAAAA,12,5040253
ykgRp,1.7272727272727273,28,10,GGACGATAGAGCGCGCTAGA,18,5035942
ykgRp,1.3636363636363635,24,10,GCTGTTAGCCACTGTTTAAT,14,5031809
ykgRp,1.2727272727272727,23,10,GCTCCAGGTGTTTAAAAAGA,13,5056349
ykgRp,0.8181818181818182,18,10,GCCTTGGCCCTGGAGCCTAA,8,5034548
ykgRp,0.9090909090909091,19,10,GCCTGCGTTCTCCCCTTTCA,9,5041199
ykgRp,3.5454545454545454,48,10,GCCAACTTTACGTCGTAATG,38,5043216
ykgRp,1.0909090909090908,21,10,GCAAAGCCTTTTACGCGGCA,11,5036782
ykgRp,1.3636363636363635,24,10,GATAGAGTTATCCTGCTTGT,14,5034266
ykgRp,0.7272727272727273,17,10,GAGTATTAGCAAACATCTGC,7,5034598
ykgRp,0.36363636363636365,13,10,CTTGTGAAATATTGCCGCGA,3,5054845
ykgRp,3.6363636363636362,49,10,CTTGAGTTTTGAGTCTCTTC,39,5050985
ykgRp,1.6363636363636365,27,10,CTTCAAGTACTACTTAGGTC,17,5054640
ykgRp,0.18181818181818182,11,10,CTTAGGCTATAGTGGGCACA,1,5041445
ykgRp,1.8181818181818181,29,10,CTTAGAGAAGAACGGATATT,19,5057706
ykgRp,1.7272727272727273,28,10,CTCTGTATTTATAGACTCTG,18,5049620
ykgRp,1.0909090909090908,21,10,CGTGATGAGGCAACTCTCTT,11,5048709
ykgRp,1.5454545454545454,26,10,CGTAGGGAGCCCCATTTCTT,16,5050182
ykgRp,1.3636363636363635,24,10,CGTAGATCACTCGTTCGTCT,14,5050851
ykgRp,1.9090909090909092,30,10,CGGGGAAGACATCGGCAAAG,20,5041353
ykgRp,4.636363636363637,60,10,CGGGAGGCCCGACGTTGGTT,50,5048145
ykgRp,0.18181818181818182,11,10,CGAGTCGCGCGAGGTGGGGA,1,5046435
ykgRp,2.727272727272727,39,10,CGAGCGCTATCGTATTAGCC,29,5052849
ykgRp,1.8181818181818181,29,10,CGAGAAAGGTAACTGCAAAG,19,5056357
ykgRp,0.18181818181818182,11,10,CGACCGTGCGGACGTCTGAA,1,5031587
ykgRp,2.1818181818181817,33,10,CGACAACTGCCACAATCTCC,23,5051188
ykgRp,1.0,20,10,CGAATTCAGCCACCGTCGTT,10,5041330
ykgRp,1.2727272727272727,23,10,CCTTCACATGCCTAGGGAGC,13,5038045
ykgRp,2.1818181818181817,33,10,CCGGAGAACAGTAATATTTG,23,5039811
ykgRp,0.5454545454545454,15,10,CCCCAAAATATCTCCAAACG,5,5041812
ykgRp,5.2727272727272725,67,10,CCAGCGCGAGACACACCGCT,57,5039648
ykgRp,5.7272727272727275,72,10,CCAATCAGATGTGGCCTTAG,62,5050895
ykgRp,0.6363636363636364,16,10,CATGGCAGTTACCATTTGAA,6,5046116
ykgRp,1.0909090909090908,21,10,CATCGAGAGTTCATACCACG,11,5036717
ykgRp,1.8181818181818181,29,10,CATAAAACATATGTTGTCAA,19,5031649
ykgRp,3.8181818181818183,51,10,CAGCTCAGCTTCTGGTCCCA,41,5046619
ykgRp,3.909090909090909,52,10,CAGATCCGAATTGTTATATC,42,5039297
ykgRp,1.2727272727272727,23,10,CACGTCTGTAAGCTCTTCAA,13,5040088
ykgRp,0.18181818181818182,11,10,CACACTGCGTCGCCGTACTC,1,5055740
ykgRp,1.0909090909090908,21,10,CAAGGGCGCGCTTGTTTATG,11,5058268
ykgRp,1.9090909090909092,30,10,ATTGGCTTAAAATAACGTCG,20,5045091
ykgRp,0.36363636363636365,13,10,ATTCTTTTCTTACCTTTATT,3,5039023
ykgRp,1.5454545454545454,26,10,ATTCCGATATATGTGCCAGA,16,5050630
ykgRp,0.18181818181818182,11,10,ATTATATAAGTCGGCACGTA,1,5038126
ykgRp,0.2727272727272727,12,10,ATGGGTCCTCAGGTCCGATT,2,5052640
ykgRp,1.9090909090909092,30,10,ATATTGCCACCTCCGTTATA,20,5059371
ykgRp,2.0,31,10,AGGCTCCGCTAGCCAGTAGA,21,5056679
ykgRp,0.2727272727272727,12,10,AGCCAAGAGCGGAATGAACC,2,5041548
ykgRp,1.5454545454545454,26,10,ACTGGTTGCTTGGCGTTTTG,16,5033503
ykgRp,2.1818181818181817,33,10,ACGTTAGCGGCCAGGGCTGT,23,5049994
ykgRp,0.8181818181818182,18,10,ACGGTCCAAACTAATTCGGC,8,5040501
ykgRp,1.3636363636363635,24,10,ACGCCCCTTTATGGGTGTAC,14,5052287
ykgRp,1.6363636363636365,27,10,ACCGTCAGCGGGTAACGACA,17,5048678
ykgRp,0.9090909090909091,19,10,ACCCGGGTTACCGGGATATG,9,5032827
ykgRp,2.1818181818181817,33,10,ACAAGCTGTGTACCAAGACA,23,5059153
ykgRp,0.6363636363636364,16,10,AATGAATAGACAGTCCAGTA,6,5049273
ykgRp,0.2727272727272727,12,10,AATCCGCCGTTGCCAGATGT,2,5055385
ykgRp,0.7272727272727273,17,10,AATCCAACTTCGTAGCTCGC,7,5035261
ykgRp,0.18181818181818182,11,10,AAGCGCACTTCATAGTGTGA,1,5059009
ykgRp,1.7272727272727273,28,10,AACACCCATTGCATGGAATT,18,5060569
ykgRp,0.18181818181818182,11,10,AAATTCTCCATGATCGCGGC,1,5032045
ykgRp,1.8181818181818181,29,10,AAAGGACTTTGGTAAAGAAG,19,5044512
ykgRp,0.18181818181818182,11,10,AAAAAACGATGGATTACCGT,1,5035308
ykgRp,2.0,28,9,TTTGCGCATGTACTAATTCT,19,5044477
ykgRp,2.3,31,9,TTGGCATGCGTATCGGACCC,22,5035277
ykgRp,1.4,22,9,TTCTCAAGCAGCTCAAACTT,13,5042396
ykgRp,0.2,10,9,TTCGCGTTCAGCTTTTGTCT,1,5032938
ykgRp,2.4,32,9,TGGTAGGGAACGTACTGTTG,23,5058446
ykgRp,2.2,30,9,TGGCCCGAGACGTGCAGGCG,21,5050117
ykgRp,2.0,28,9,TGCGTGCCTGAATTTTTTGT,19,5040430
ykgRp,1.5,23,9,TGAGTGCAGACGGTTTTCCA,14,5033007
ykgRp,1.5,23,9,TCTTGGAGTCCGGAGCACAG,14,5033874
ykgRp,3.1,39,9,TCTTGCATAGAGAAAGCCGA,30,5046909
ykgRp,1.5,23,9,TCTGCCTCATATATAGGCGA,14,5055904
ykgRp,3.0,38,9,TCCGTGACGGTCGTACGAGT,29,5038461
ykgRp,2.1,29,9,TCCCATTTACCGCAGGGTTT,20,5047304
ykgRp,0.2,10,9,TCCAGTCCTACGCCCTCACA,1,5044237
ykgRp,1.6,24,9,TCACGCTCAGCACTACGTTA,15,5045913
ykgRp,1.0,18,9,TCAAGCCAGATTAGTGAACT,9,5045108
ykgRp,1.9,27,9,TCAAGCAGCGCCCCTATGGG,18,5052538
ykgRp,0.2,10,9,TATTACACGTTGGACAGTGC,1,5040729
ykgRp,1.9,27,9,TATATGTATTCGTTCAAGAG,18,5038074
ykgRp,1.8,26,9,TATAGTGTGCCCTTGCGTGC,17,5055623
ykgRp,0.2,10,9,TATAACGAGACCCAGGGTTT,1,5052932
ykgRp,1.9,27,9,TACCAGTAGTGATGCTTCGA,18,5046643
ykgRp,2.1,29,9,GTTCTTACTATATGGGTTCC,20,5043438
ykgRp,4.9,57,9,GTCCGAATTTTAGTTACATG,48,5034413
ykgRp,1.5,23,9,GTCCCCTATTAACGCGCGTG,14,5039841
ykgRp,0.5,13,9,GTCAGATCAAACAAACCCCA,4,5032484
ykgRp,1.6,24,9,GGTTGCGTCGGAAATGGACT,15,5048901
ykgRp,2.1,29,9,GGTCTAGTACTTAAGAGGAT,20,5048903
ykgRp,1.4,22,9,GGGGGGCTGGTGGGCATATG,13,5050892
ykgRp,0.2,10,9,GGGGAGGTCAGCGCCCCCCT,1,5035702
ykgRp,2.0,28,9,GGGAGAACCTAAGAAGAATG,19,5037160
ykgRp,1.3,21,9,GGCCCTTAGTGTTGATTATA,12,5032774
ykgRp,0.2,10,9,GGAAAAACTCACATGCTGAG,1,5046425
ykgRp,2.5,33,9,GCTGCATTTGTCATTACGAT,24,5058898
ykgRp,1.7,25,9,GCTCAGTTATCCATGCGGGA,16,5049516
ykgRp,0.2,10,9,GCGTACTATCAACTTGTAGT,1,5058153
ykgRp,1.9,27,9,GCCTCTCCACTTGCCGTAGA,18,5055778
ykgRp,0.3,11,9,GCCTCTAAATATATCAACAC,2,5052997
ykgRp,1.5,23,9,GCCCCGTAATGGACGTTTAA,14,5045090
ykgRp,0.2,10,9,GCATTATGTCGTCAATCTAG,1,5041024
ykgRp,1.1,19,9,GATTGGTAGTATGGAGAGAA,10,5036570
ykgRp,2.2,30,9,GATGAGGATGATTTTTCAAA,21,5055936
ykgRp,1.6,24,9,GAGTACGCGAAATCCGGCGC,15,5038347
ykgRp,2.5,33,9,GAGCTAAAGGTGAGTAATCG,24,5046933
ykgRp,2.5,33,9,GACTTCTGCAGCTTAACAGG,24,5045817
ykgRp,0.2,10,9,GACTGTATACCTGTGGGATT,1,5039956
ykgRp,2.8,36,9,GAACGACTGATCGGGTGGAG,27,5058192
ykgRp,0.2,10,9,CTTCCCATGTCGTCACCACA,1,5039728
ykgRp,2.0,28,9,CTCTTTGAGCACCGGCCGTG,19,5032418
ykgRp,2.0,28,9,CTCCGCGCCTATCGAGACTC,19,5042824
ykgRp,0.9,17,9,CTCCATACATCGAAAGTGAT,8,5046686
ykgRp,1.3,21,9,CTCACGAGGTTACCGGCACG,12,5058026
ykgRp,1.8,26,9,CTACTGGAACTACAAATCTT,17,5041249
ykgRp,0.2,10,9,CGTTGTCGAAGCCAAAAACA,1,5033260
ykgRp,1.0,18,9,CGTGGTCTCGTGCCATATGT,9,5056683
ykgRp,1.6,24,9,CGTGACATGGTGCTATATAT,15,5044412
ykgRp,1.4,22,9,CGTCTATCATAGCGGGCTAG,13,5046028
ykgRp,0.5,13,9,CGGTTACGCTTTTTGCGTCC,4,5039986
ykgRp,0.2,10,9,CGGCTGGCCACAGTACCTAA,1,5060392
ykgRp,0.2,10,9,CGCGCGAATGCTCCAGCCGA,1,5036458
ykgRp,1.8,26,9,CGATTTGTCGCCGGAAGTGT,17,5060805
ykgRp,0.7,15,9,CGATTGACAGGCGCGATTAG,6,5058037
ykgRp,4.5,53,9,CCTTCAGGTCTACGTTGTCT,44,5039170
ykgRp,0.2,10,9,CCTGGAGAGTTGCCCTATCG,1,5041446
ykgRp,0.2,10,9,CCGCTCCATGAGCAATAACT,1,5031983
ykgRp,0.9,17,9,CCCGTGGGCACCTGCCGTAG,8,5049036
ykgRp,2.2,30,9,CCCGAGAGATCGTCAGCCGT,21,5043499
ykgRp,0.2,10,9,CATAGTAGTTGGCGGTAGAA,1,5057672
ykgRp,4.5,53,9,CATAAACCATCGGGGACAAA,44,5056713
ykgRp,4.1,49,9,CAGTGACCGTTCATTCTTCA,40,5049925
ykgRp,0.2,10,9,CACTAATTTAAAGGCATTGG,1,5055388
ykgRp,0.2,10,9,CAATTAAACTGGATTTACGC,1,5057343
ykgRp,1.6,24,9,CAATCTCTGAGAAGGACCTA,15,5048346
ykgRp,1.5,23,9,CAAGCTGTTTTGAACTTGTA,14,5041568
ykgRp,3.0,38,9,CAACCGGATGACCCGGGAAC,29,5049497
ykgRp,1.1,19,9,ATGACACGATAAAAGGAATT,10,5047820
ykgRp,2.2,30,9,ATCAGCTCGAATTACATGGG,21,5042517
ykgRp,0.2,10,9,ATCAGAGTTTGCTTGGGGGT,1,5056227
ykgRp,1.7,25,9,ATATTACCAATTAGGGCACC,16,5047589
ykgRp,1.9,27,9,ATACAAAAAGTCTTTTCGCT,18,5036456
ykgRp,0.2,10,9,AGCTCATGGGTCACCAGCTC,1,5032609
ykgRp,0.2,10,9,AGCGTCAGAAAGAAGAATAA,1,5057816
ykgRp,1.4,22,9,AGATATCCAACTTAGACCGT,13,5033803
ykgRp,2.0,28,9,ACTTCTGCCCGCTTGAATTA,19,5042837
ykgRp,2.9,37,9,ACTGTGCTAGTGCTAAAACG,28,5043904
ykgRp,2.5,33,9,ACTGATAGGAGTTCGAGGTT,24,5034447
ykgRp,0.3,11,9,ACCGTTTCAATTATCCGGGT,2,5035930
ykgRp,1.9,27,9,ACCACTATAGGCCGTCAATA,18,5046342
ykgRp,2.0,28,9,ACAGCGGTTGATCCCAATCG,19,5031935
ykgRp,1.3,21,9,ACAAGTGACCAGGCTTTATA,12,5058917
ykgRp,1.2,20,9,AAGGGGGAATTACGGTGTTT,11,5032858
ykgRp,1.3,21,9,AAGACACTTTGGATACCCTG,12,5035001
ykgRp,11.6,124,9,AACCCCGGAAGACATAACCT,115,5032123
ykgRp,1.0,18,9,AACCACTTTTACGCACGGTA,9,5055175
ykgRp,1.6,24,9,AAAGAGGGAAGGCTCGATAA,15,5046555
ykgRp,2.888888888888889,33,8,TTTTCCCTACGTCCATCGGG,25,5049900
ykgRp,3.0,34,8,TTTGCTCTCTGACTCCAGAA,26,5045853
ykgRp,0.6666666666666666,13,8,TTGGTCAAGCCAAGAGAGGG,5,5047907
ykgRp,3.6666666666666665,40,8,TTCTTTAAGCTTGCTCACAC,32,5044474
ykgRp,7.666666666666667,76,8,TTCCCCTAACCTTTTTATAG,68,5047552
ykgRp,1.5555555555555556,21,8,TTCCAACCGACCGTTTGTAG,13,5046753
ykgRp,0.8888888888888888,15,8,TTATGTATGCCCTATCTCTG,7,5054913
ykgRp,2.4444444444444446,29,8,TTAAGAACCGTAGCTGCGAC,21,5055389
ykgRp,15.666666666666666,148,8,TGCCGTTTCTCTACGAAACC,140,5044532
ykgRp,0.2222222222222222,9,8,TGCATGTACTAGTCAGTCAT,1,5035453
ykgRp,0.8888888888888888,15,8,TGCAATGGGCCAATCACTTT,7,5050660
ykgRp,2.2222222222222223,27,8,TGATCCTTCTTTCTTGTTCT,19,5047209
ykgRp,0.2222222222222222,9,8,TGACGGACTAAACACCCTCT,1,5051389
ykgRp,3.0,34,8,TGACAGGGAGGGGGTAGGAT,26,5031823
ykgRp,1.3333333333333333,19,8,TGACACCCCACCTTTGCTTG,11,5054165
ykgRp,2.111111111111111,26,8,TCGTCCTCATTAATACGGTA,18,5058463
ykgRp,0.4444444444444444,11,8,TCGGAGAAAGCGTGGCTCCT,3,5042284
ykgRp,1.4444444444444444,20,8,TCCTTACAAGGCCATGCACT,12,5033226
ykgRp,1.6666666666666667,22,8,TCCCGGTGCCGGAAACGATT,14,5053469
ykgRp,1.7777777777777777,23,8,TCATGGTTTCAGAAAAGTTC,15,5058449
ykgRp,1.8888888888888888,24,8,TCATCTAACGACTGGCTAAA,16,5058915
ykgRp,6.666666666666667,67,8,TCACGGTGGGTTAAGTTAGT,59,5049332
ykgRp,0.2222222222222222,9,8,TATCATTGCAGCGCCATACT,1,5035664
ykgRp,0.8888888888888888,15,8,TAGAAGGCCGCACTCATAGA,7,5039856
ykgRp,0.2222222222222222,9,8,TACTCGGGTGTCGTCCCGTG,1,5032503
ykgRp,0.8888888888888888,15,8,TAAGCGGGTTTTCTAGATTG,7,5057206
ykgRp,1.3333333333333333,19,8,TAAAGTTTACTGGTGAATGT,11,5060090
ykgRp,3.0,34,8,GTTTTAATTTGCCGCAACAC,26,5037547
ykgRp,0.2222222222222222,9,8,GTTGTATAAATCGCTGGTCT,1,5048244
ykgRp,2.2222222222222223,27,8,GTTCCATCACTATATCCTGT,19,5056074
ykgRp,2.4444444444444446,29,8,GTGGGTATCGATCCCAACAA,21,5041514
ykgRp,1.1111111111111112,17,8,GTGGGGTTCTGCAGACACCG,9,5053188
ykgRp,0.3333333333333333,10,8,GTGAGCACCCTAGAGGACAC,2,5045075
ykgRp,1.4444444444444444,20,8,GTCTGCCGTTGAGATCATCT,12,5043089
ykgRp,2.5555555555555554,30,8,GTCGGGTACCTCCTATATTA,22,5042406
ykgRp,2.7777777777777777,32,8,GGCTTTATCATGCTTCCATA,24,5052462
ykgRp,1.4444444444444444,20,8,GGCTATTACTTGGATGGCTG,12,5043624
ykgRp,6.0,61,8,GATCCAACTTTGATGACGAA,53,5034212
ykgRp,2.111111111111111,26,8,GAGTCGATGATGAGCCCATA,18,5059247
ykgRp,2.2222222222222223,27,8,GAGACGCGTGGAGTACGGGA,19,5057293
ykgRp,0.2222222222222222,9,8,GACTCGAAGCTTTCCCTTAC,1,5038120
ykgRp,1.1111111111111112,17,8,GACTCATCCGTGCTGCATCA,9,5041442
ykgRp,0.2222222222222222,9,8,GACTACTTGACCACGTATAA,1,5043650
ykgRp,0.3333333333333333,10,8,GACCTTTGTTGGTCCCGTCC,2,5036929
ykgRp,2.5555555555555554,30,8,GAATGTGACAGACCAAAGGT,22,5054168
ykgRp,5.333333333333333,55,8,GAACAAACTGAAAGAAAACT,47,5039697
ykgRp,0.2222222222222222,9,8,CTTTCGCGCGTCCTTAGGGG,1,5036757
ykgRp,0.6666666666666666,13,8,CTTGTTAGGGTCACGATATA,5,5047595
ykgRp,1.8888888888888888,24,8,CTGTTTTGTTTCGAACAGTG,16,5058583
ykgRp,0.2222222222222222,9,8,CTGTCGGGAAAAGCTCTACA,1,5037928
ykgRp,9.88888888888889,96,8,CTCGGCTCAGTGGTTTTCTC,88,5041131
ykgRp,3.6666666666666665,40,8,CTCCTTTGTTATACTTGCAG,32,5048733
ykgRp,2.0,25,8,CTATATTACATCATTACACT,17,5041685
ykgRp,2.2222222222222223,27,8,CTATAAGCGTCCTCTGCGTA,19,5040597
ykgRp,1.0,16,8,CTAGATTGCTTGCGGTCTAG,8,5043447
ykgRp,0.2222222222222222,9,8,CGGATTCGCATTTACAATAT,1,5058183
ykgRp,0.2222222222222222,9,8,CGGACTTCCTATTACTGAAC,1,5047073
ykgRp,1.8888888888888888,24,8,CGCAACCGGGCATGGGGCTA,16,5034387
ykgRp,2.4444444444444446,29,8,CGATGCGCCGGCTAGTACAG,21,5049205
ykgRp,0.3333333333333333,10,8,CGAGTATCAGAACCAAGTAG,2,5046367
ykgRp,1.4444444444444444,20,8,CGAACCTCATCACGTTATTA,12,5045724
ykgRp,3.111111111111111,35,8,CGAACAATAGTGAGTTGATC,27,5060773
ykgRp,2.888888888888889,33,8,CCTTCAGAAATGTGGCCTCC,25,5048450
ykgRp,0.4444444444444444,11,8,CCTCGGTAGCAATGCACTAG,3,5052856
ykgRp,2.111111111111111,26,8,CCGGTGAGTACTGGCCGTCA,18,5035572
ykgRp,1.8888888888888888,24,8,CCCTATGGCAGGTTCTTTGT,16,5045712
ykgRp,1.1111111111111112,17,8,CATTGGGCCTAAGGCCTGCA,9,5047631
ykgRp,3.0,34,8,CAGTACTCTATCTTTTGGGG,26,5056619
ykgRp,3.3333333333333335,37,8,CAGGTCGTTATACATTCGAC,29,5044531
ykgRp,2.111111111111111,26,8,CAGGTCGCGGCAGGGCAATA,18,5034877
ykgRp,1.2222222222222223,18,8,CAGCTAAACTCGGCAAGATA,10,5034188
ykgRp,2.3333333333333335,28,8,CACCAGGAGTTGGAGGCGTT,20,5059162
ykgRp,1.6666666666666667,22,8,CACATCATTCCGTAACAGGT,14,5058772
ykgRp,1.6666666666666667,22,8,CAAGGATAGATTATTGACAG,14,5032925
ykgRp,2.3333333333333335,28,8,ATGCGCCGGATATTACGTAA,20,5038921
ykgRp,0.2222222222222222,9,8,ATGAAGATTTCGTCAGAATT,1,5041941
ykgRp,1.8888888888888888,24,8,ATCTTATGTTGGGCGCATAA,16,5032098
ykgRp,1.2222222222222223,18,8,AGGGCCAGGTGTTGGGGATC,10,5039440
ykgRp,1.7777777777777777,23,8,AGCGGGTGCCCAGGTCTATG,15,5044736
ykgRp,6.888888888888889,69,8,AGCCCCTACGGTGGGGCGAG,61,5057241
ykgRp,2.3333333333333335,28,8,AGACGGGCTAGGGATTCTGC,20,5043924
ykgRp,0.2222222222222222,9,8,AGAACAGTACCCGCGCCCAT,1,5057768
ykgRp,0.4444444444444444,11,8,ACTGAGAGCCACTAGACTTT,3,5050380
ykgRp,1.0,16,8,ACGTTTAGGAGGCAGACTGA,8,5040185
ykgRp,2.3333333333333335,28,8,ACGTTGGAATTTTACATACA,20,5048988
ykgRp,1.7777777777777777,23,8,ACGCATGGAGTTAGGTGCCG,15,5041027
ykgRp,0.6666666666666666,13,8,ACGATGTGGTAGCGGTAAGT,5,5043310
ykgRp,0.5555555555555556,12,8,ACCGATCTTAGGGGCGCTGA,4,5048603
ykgRp,1.3333333333333333,19,8,ACCATACCCGGAAAAGCTGT,11,5031375
ykgRp,1.5555555555555556,21,8,ACAATGTGGGGAGATTGAAC,13,5040974
ykgRp,2.0,25,8,ACAATCTCAAATCAGGCTCT,17,5037816
ykgRp,4.222222222222222,45,8,AATGAATCTTCATGTGGATA,37,5048022
ykgRp,1.4444444444444444,20,8,AATCTGGGAGTCAGCGGGTA,12,5035504
ykgRp,2.5555555555555554,30,8,AATCATTACAATAGGCGCCG,22,5040095
ykgRp,1.5555555555555556,21,8,AAGTGGACGACACGTTAACT,13,5051116
ykgRp,2.3333333333333335,28,8,AAGGTTGGTCGATAATCGCC,20,5046428
ykgRp,1.2222222222222223,18,8,AAAGGTCACCCGGGGCTTTT,10,5042093
ykgRp,16.555555555555557,156,8,AAAGCGCCATTTCGTTCGAT,148,5051378
ykgRp,1.75,20,7,TTTGGTCCACTCACCTCTCA,13,5052872
ykgRp,2.125,23,7,TTTGCGGGGTTTAGGCTATG,16,5037448
ykgRp,1.875,21,7,TTGGTACCCGGCAATCACAT,14,5044470
ykgRp,2.125,23,7,TTGGCCTCATGCTTGGATCA,16,5039412
ykgRp,14.5,122,7,TTGGATTCCCACGCGCTCAA,115,5055425
ykgRp,4.75,44,7,TTGACCATTATGCAATTCTT,37,5052901
ykgRp,1.25,16,7,TTCCCAATCGACCCTCACTA,9,5055724
ykgRp,2.25,24,7,TTCAAATATGGCTTCTCCTC,17,5046079
ykgRp,5.125,47,7,TTATAAGTCCGGTGAAAATG,40,5035730
ykgRp,2.0,22,7,TGTTCAATATCTCCTTTTGA,15,5054982
ykgRp,4.375,41,7,TGTATCGCCAGTGAGTCCCT,34,5038206
ykgRp,0.25,8,7,TGTAGTCACGAACGGTAAAC,1,5051098
ykgRp,3.5,34,7,TGTAGCCGATCTGCCTTCAT,27,5048180
ykgRp,1.875,21,7,TGGGAGAGTTGTCCAAGAAT,14,5047045
ykgRp,2.5,26,7,TGGAGGCAAATGAGAAGTGT,19,5033753
ykgRp,0.5,10,7,TGACGCACACCGTTGCTAAA,3,5056158
ykgRp,1.875,21,7,TGAATTGAAGTGCTGCGGTA,14,5048363
ykgRp,2.5,26,7,TCTAACTCCTTACCATAGAT,19,5041763
ykgRp,1.875,21,7,TCCTCCTCCCCCTTACGAGT,14,5032294
ykgRp,3.25,32,7,TCCGCGGGGACCTGCGTCGT,25,5046568
ykgRp,1.0,14,7,TCCGAGCATTTACACCATCA,7,5058812
ykgRp,7.375,65,7,TCCAGGTGCCCGAGGTTTGG,58,5044537
ykgRp,0.25,8,7,TCATCGTTGGTTCACATTGT,1,5045594
ykgRp,2.25,24,7,TCACCGCTTGGCCCCCTGAA,17,5044997
ykgRp,3.125,31,7,TATTAAGTTTGGCTGCGGCT,24,5054912
ykgRp,1.125,15,7,TATGAGGCTGTCATGCGATT,8,5043703
ykgRp,1.625,19,7,TAGGTTACTGTGTGATGGAA,12,5045327
ykgRp,2.875,29,7,TACTGCGGACCATCCCGACG,22,5036868
ykgRp,1.75,20,7,TACTAAAGACATATTCTTGC,13,5048384
ykgRp,3.75,36,7,TAACACTTACGATCTCCCCC,29,5033780
ykgRp,2.25,24,7,GTTTCATTCTAACTGGATTC,17,5042511
ykgRp,1.25,16,7,GTTCACAATGATCCCGCCGC,9,5057612
ykgRp,0.25,8,7,GTTATACTCTAGCACACCTC,1,5048964
ykgRp,2.0,22,7,GTTAGACCTTCCCAATACCT,15,5051880
ykgRp,0.875,13,7,GTGCTTAGAAAACTGTAACT,6,5059372
ykgRp,0.25,8,7,GTGAGATCAATGGAACGGCG,1,5038300
ykgRp,2.125,23,7,GTGAAGATTCCGTGTAGTGG,16,5061136
ykgRp,1.125,15,7,GTCTGGGAAAGTGGACAATA,8,5033213
ykgRp,1.875,21,7,GTCGGGACTGCGCAGATAAG,14,5050256
ykgRp,1.75,20,7,GTATTGCAGGTATATCGAAG,13,5035026
ykgRp,0.75,12,7,GTATTCCTGCGCTATAGTCT,5,5037143
ykgRp,2.125,23,7,GTAGTGCATTTAAATTGAAT,16,5050012
ykgRp,1.5,18,7,GTACCGATCACACTGTCGAA,11,5047026
ykgRp,0.25,8,7,GTAAAAGGAATAAGGTGAAT,1,5041484
ykgRp,0.25,8,7,GGTTTTCCAGGCTACCTTTG,1,5039688
ykgRp,1.125,15,7,GGTTACTACTTAGGACGGTC,8,5047563
ykgRp,1.875,21,7,GGGTGATCGTGTCATCAAGT,14,5058356
ykgRp,6.0,54,7,GGCTCTATGTGTTAGCAATT,47,5044386
ykgRp,1.5,18,7,GGCTCACCATTCTTCGGATT,11,5050529
ykgRp,1.75,20,7,GGCAGCCAACGCGATCGGGT,13,5052608
ykgRp,0.25,8,7,GGCACTCTCGTCCTAGCCCA,1,5045595
ykgRp,2.25,24,7,GGAGGGCACCGCGTCACTAT,17,5045270
ykgRp,2.125,23,7,GGAAGGCTCCGTTGGTGGCC,16,5053880
ykgRp,2.625,27,7,GCTGGACAGTGTCCAATATA,20,5043686
ykgRp,2.375,25,7,GCTACCTTTGCCTTTTTGTT,18,5039107
ykgRp,0.25,8,7,GCGTCTCATCGATGGCCTGT,1,5057624
ykgRp,7.75,68,7,GCGTAACGTGTAGCGATATG,61,5061742
ykgRp,4.125,39,7,GCGGGCTATTCCATACCGGT,32,5057623
ykgRp,0.25,8,7,GCGGAATACAGTTGAACCAC,1,5034801
ykgRp,0.625,11,7,GCCTAACGGGCACACGATAT,4,5049172
ykgRp,5.0,46,7,GCCGGAAGTTAAAAAGTATT,39,5031893
ykgRp,3.375,33,7,GATTTGCGGGATGCCTACAA,26,5038561
ykgRp,2.0,22,7,GATGAGACTAGAGCTGTTTG,15,5050954
ykgRp,1.375,17,7,GATCTATGTCTATGACGCCT,10,5056626
ykgRp,2.375,25,7,GAGTTGCGAGTTGGCGGGGA,18,5057125
ykgRp,0.375,9,7,GAGATGGGCGGAACGGATTC,2,5054735
ykgRp,1.75,20,7,GACTCTACGACCATCTCGAA,13,5054031
ykgRp,1.875,21,7,GACGAGATGTCACGGGGATA,14,5053971
ykgRp,2.125,23,7,GACCCCTGAAGCTGAAATCG,16,5035697
ykgRp,1.75,20,7,GAATTCGTTCTGTACTAGGC,13,5047621
ykgRp,1.25,16,7,GAACCTTACATGATCGCCAT,9,5041170
ykgRp,5.0,46,7,CTTTGACCTAAGTACAGTAC,39,5060513
ykgRp,2.125,23,7,CTTTCGGGAAGGAGCCCGCC,16,5052733
ykgRp,0.25,8,7,CTTCCGATCCCCCATCGCGA,1,5046886
ykgRp,0.25,8,7,CTTAGTCTTGGTACGAATGT,1,5039180
ykgRp,2.5,26,7,CTGGGTCATTGCCCGAAATG,19,5037808
ykgRp,2.375,25,7,CTGGCCGGTGGAGCTGATAC,18,5039565
ykgRp,0.25,8,7,CTGCCTGGCGCACCTGCTAC,1,5041237
ykgRp,2.0,22,7,CTGATATTCATGCTAGGGGA,15,5035877
ykgRp,2.25,24,7,CTATGAAGACCTTCAGAGTA,17,5046617
ykgRp,3.25,32,7,CGTGGAGAATCGTAAGCCTT,25,5044721
ykgRp,1.125,15,7,CGTAACGCACCGGAGCTAAA,8,5038471
ykgRp,2.25,24,7,CGGGAACTGCGTTTGCTTAC,17,5037976
ykgRp,2.375,25,7,CGGCCATTCATATGCTGATC,18,5036513
ykgRp,1.25,16,7,CGCGGACAGCACAGCGCTGT,9,5048190
ykgRp,0.25,8,7,CGCGAAGTAACCCCAGTTGA,1,5041522
ykgRp,2.25,24,7,CGCCGGGAAAGTCCGACGTA,17,5045242
ykgRp,1.875,21,7,CGATACTCAGGCATCGGGAA,14,5036571
ykgRp,2.25,24,7,CCTTTGTAGCTACGATACTA,17,5057242
ykgRp,1.875,21,7,CCTGCACAGAGAACGCGTGG,14,5033214
ykgRp,2.875,29,7,CCTAATGCTGAAAGTAAGCA,22,5044030
ykgRp,1.5,18,7,CCAGTTAGTAACTAGGAACC,11,5043392
ykgRp,2.75,28,7,CCACTCGTGCGTCAAGTGAT,21,5046301
ykgRp,0.25,8,7,CATGCCGTACCTTGATCCGA,1,5050635
ykgRp,0.875,13,7,CATAAAAGGAACCGAAAAGA,6,5054588
ykgRp,3.625,35,7,CAGTTCGACGCTATTTACAA,28,5061331
ykgRp,2.5,26,7,CAGGTAAGCGTTAGTATGGC,19,5035369
ykgRp,1.875,21,7,CAGCGTAGATCTGCAGAGTA,14,5044530
ykgRp,2.125,23,7,CAGAGTCGGTCATGGCGGCG,16,5032845
ykgRp,1.375,17,7,CACTAATACTTTGTTGGAGA,10,5059551
ykgRp,2.25,24,7,CACAGAAGAACGCCCTTGTT,17,5048399
ykgRp,0.25,8,7,CAATCACCGAATGGAATTTT,1,5034828
ykgRp,2.625,27,7,CAATATGACGTGTTGGCCGG,20,5044199
ykgRp,0.25,8,7,CAAGCAGCAGAGGAGTTAAA,1,5054520
ykgRp,0.75,12,7,CAACGCCTCGTTGATTCCTT,5,5042841
ykgRp,1.875,21,7,ATTTCCTTCGGCGTTACACG,14,5056096
ykgRp,5.375,49,7,ATTACATTAATTTGTCAGGC,42,5054209
ykgRp,1.875,21,7,ATGTGAAGACGCAAGGGTGT,14,5047508
ykgRp,2.125,23,7,ATGCCACGTTATTTTATCTA,16,5059109
ykgRp,1.5,18,7,ATCTTGTAAATGGTAAAACC,11,5044316
ykgRp,1.375,17,7,ATCTCTTTGTGCGACCCGCC,10,5043337
ykgRp,0.25,8,7,ATCCTAAGTCTCTATTGTTC,1,5053223
ykgRp,0.75,12,7,ATCAAGGTGAGGATGTCGAT,5,5036658
ykgRp,2.375,25,7,ATAGGGTCTCATCAAGGTCT,18,5033321
ykgRp,1.5,18,7,ATAGCATGGAATTGTCAAGC,11,5058514
ykgRp,2.125,23,7,ATAGCAAATGTGGATTATGG,16,5043647
ykgRp,2.375,25,7,ATACTCGTGTACGGTGGTTA,18,5056467
ykgRp,0.25,8,7,AGTCTCGAGGTTACAGGCCT,1,5057583
ykgRp,2.25,24,7,AGCTTTCATGACTGGTGTCG,17,5058616
ykgRp,2.25,24,7,AGCGTGAGCGTAAGATATTA,17,5060936
ykgRp,1.75,20,7,AGCGCAATCATTAATTTGCC,13,5051913
ykgRp,2.5,26,7,AGCAGCTCACCTTCGACTAA,19,5051278
ykgRp,2.25,24,7,AGCACAATACAATGTGAGCA,17,5053273
ykgRp,1.375,17,7,AGCAAAGGCACCGGAAGACA,10,5032413
ykgRp,4.125,39,7,ACTTTATAGAGAGGCTGTTG,32,5035000
ykgRp,2.875,29,7,ACTTCTAAGGTACGTACCTT,22,5037974
ykgRp,0.25,8,7,ACTGGGTGCAATTGCTCATA,1,5052505
ykgRp,1.875,21,7,ACTGGAATCAATAGGATGGT,14,5036066
ykgRp,0.25,8,7,ACTCTGTTAATCTAACTCGA,1,5052612
ykgRp,1.875,21,7,ACGTTGGTACCCTGGTCGAG,14,5031885
ykgRp,2.375,25,7,ACGCTTGCAGAGGCGGGTTA,18,5042688
ykgRp,1.25,16,7,ACAGTATGCAACCTGGGCGT,9,5037245
ykgRp,4.5,42,7,ACAGGCTGCCTCGTGACCCT,35,5048856
ykgRp,2.25,24,7,ACAGCGAGGCATTGCATTGG,17,5049619
ykgRp,6.625,59,7,ACACAATCACTGCCTGCTAT,52,5052705
ykgRp,0.75,12,7,AATGGCATGGCCCTCGTTAA,5,5051314
ykgRp,2.25,24,7,AATAGGGTCCTTCAAAATTG,17,5058509
ykgRp,3.125,31,7,AAGTCATGCGACCATCATTC,24,5057998
ykgRp,2.5,26,7,AAGAACGGACCTGTGGACCG,19,5046961
ykgRp,1.75,20,7,AAACGATGGTCCCCAGAGGC,13,5047763
ykgRp,4.0,33,6,TTTTAAAGGGCTTAACTGAA,27,5054936
ykgRp,6.428571428571429,50,6,TTTATGATCGGCTTGCGAAA,44,5050856
ykgRp,0.2857142857142857,7,6,TTTAGCCACGTCAGAGGCGA,1,5051778
ykgRp,4.0,33,6,TTGTACTACGTTCAAGATGA,27,5050871
ykgRp,3.5714285714285716,30,6,TTGCGTGATACGCACCGCGG,24,5056360
ykgRp,2.4285714285714284,22,6,TTGATGATCAGATCTGTCAA,16,5036010
ykgRp,0.5714285714285714,9,6,TTGAGTATGTTTGTTTGGCT,3,5059493
ykgRp,4.714285714285714,38,6,TTGAAGGATGACGATACGGT,32,5032048
ykgRp,2.7142857142857144,24,6,TTCCTAACGATGCCGTTTTA,18,5033938
ykgRp,2.4285714285714284,22,6,TTCAAGTGGTCTTGCCAAAC,16,5034292
ykgRp,3.857142857142857,32,6,TGTTCCTTATGGCCCTTTGG,26,5039393
ykgRp,2.0,19,6,TGTGGACGTCTGGGGCTTTA,13,5039698
ykgRp,2.142857142857143,20,6,TGTCCTGAACCCTTACCCCA,14,5035399
ykgRp,4.285714285714286,35,6,TGCCCAATGAAGCTAAAGTG,29,5058032
ykgRp,3.2857142857142856,28,6,TGAGGTTTTCTCATCAACTC,22,5040465
ykgRp,1.7142857142857142,17,6,TGAAGCCGTCGAAATCGTTA,11,5055766
ykgRp,5.0,40,6,TCTGAGGCTACGGTAACCCT,34,5049854
ykgRp,5.714285714285714,45,6,TCTGAGGATTTGTGTGACGA,39,5049993
ykgRp,6.285714285714286,49,6,TCTCTATTTGCCCCTTCTCT,43,5046831
ykgRp,5.142857142857143,41,6,TCTAACCGATCCTAGTTGCG,35,5054652
ykgRp,0.2857142857142857,7,6,TCGGTTTTTCTCACCCATAG,1,5048897
ykgRp,2.4285714285714284,22,6,TCGAAAGTAGATTCAGCGCT,16,5054087
ykgRp,2.2857142857142856,21,6,TCCTGCGTCAACTACAAATG,15,5048717
ykgRp,4.714285714285714,38,6,TCCTCACCTAGGGCACAAAA,32,5055709
ykgRp,0.7142857142857143,10,6,TCCGTGTTTTGGGCTCCGAC,4,5036108
ykgRp,2.857142857142857,25,6,TCCGAGCTCCTGGGCGCGTT,19,5040237
ykgRp,8.857142857142858,67,6,TCCATGATAGCGGGTTTGAT,61,5061405
ykgRp,4.285714285714286,35,6,TCAGGCTCTATCAGACGAGA,29,5049868
ykgRp,1.8571428571428572,18,6,TATTTCCGTCAGGGTTGATG,12,5037795
ykgRp,2.7142857142857144,24,6,TAGGGGAACAGGGCTCCTGG,18,5048907
ykgRp,2.2857142857142856,21,6,TAGCGAGCGTCTTGCCAAGA,15,5057218
ykgRp,2.7142857142857144,24,6,TACAATCCACATTCACGGGT,18,5032634
ykgRp,1.2857142857142858,14,6,TAACCTCCCTTAGTAACTTT,8,5049621
ykgRp,4.285714285714286,35,6,TAACATGGGTCCCACCGCAG,29,5050472
ykgRp,0.2857142857142857,7,6,TAAACAGTCATAGCAGACAA,1,5032040
ykgRp,2.857142857142857,25,6,GTTTTGGAAGTAGTGAGGCA,19,5046143
ykgRp,0.7142857142857143,10,6,GTTTATCATTTGGCCGTATT,4,5051916
ykgRp,2.857142857142857,25,6,GTTATGAGTGATACTACCTT,19,5044097
ykgRp,4.285714285714286,35,6,GTGTGAAGTCCGCTTTGTGG,29,5044529
ykgRp,1.8571428571428572,18,6,GTGGTACGGACATCGAATCC,12,5036380
ykgRp,2.5714285714285716,23,6,GTGCAGTCCTTCTTACATTG,17,5053255
ykgRp,4.714285714285714,38,6,GTCTAAGTCGGTGCCCTTTT,32,5047622
ykgRp,1.5714285714285714,16,6,GTCTAAAGTTAATTTAGTCT,10,5051285
ykgRp,3.0,26,6,GTCGCCACTTCCTTTGCTTG,20,5055726
ykgRp,4.571428571428571,37,6,GTCATAATTCGACCAAATAA,31,5061710
ykgRp,1.5714285714285714,16,6,GTATATCAATACCCACCCTC,10,5036715
ykgRp,3.4285714285714284,29,6,GGGTTTATGTCGGGTCACAA,23,5035573
ykgRp,5.285714285714286,42,6,GGGGAATCATGGCTAGTAAC,36,5059159
ykgRp,4.0,33,6,GGCTTTAAGGCGAGCAATTG,27,5058052
ykgRp,0.2857142857142857,7,6,GGCTGGTGGCAATATGGCTA,1,5058027
ykgRp,1.1428571428571428,13,6,GGCGTTAGCAACATGCACAT,7,5058553
ykgRp,1.4285714285714286,15,6,GGATGCTTCGGTCTACTTTC,9,5038305
ykgRp,0.2857142857142857,7,6,GGAGTAAAATCAAAGAGTTC,1,5041743
ykgRp,0.2857142857142857,7,6,GGAGGCCCGTTACGAACATT,1,5045971
ykgRp,0.2857142857142857,7,6,GGAGGACACCGTTCCTGCAA,1,5038197
ykgRp,1.1428571428571428,13,6,GGAGCCCATTGCTTACACTA,7,5036186
ykgRp,12.571428571428571,93,6,GCGTATAACAGGTGGTGTTA,87,5049765
ykgRp,2.142857142857143,20,6,GCGGGTAGTGATTAAGGCGT,14,5054618
ykgRp,2.857142857142857,25,6,GCATCCGTAGCGCTTTGTGA,19,5050410
ykgRp,4.0,33,6,GCACTGGGAAATGACATGGG,27,5040024
ykgRp,23.714285714285715,171,6,GACGCTTATACGGTGCTTAA,165,5058012
ykgRp,1.7142857142857142,17,6,GACGACTCCGTAACGGACGA,11,5058445
ykgRp,1.0,12,6,GACAGCTGCATAGCTCGGCT,6,5059491
ykgRp,4.428571428571429,36,6,GACAGCGTAGGTGAGTGATT,30,5042551
ykgRp,0.2857142857142857,7,6,GAACTCATGAATCATATCCT,1,5051665
ykgRp,2.0,19,6,GAAAATCCAAGAGCCAATCA,13,5038288
ykgRp,3.4285714285714284,29,6,CTTACTTAGTCCCCGCCATA,23,5042442
ykgRp,2.857142857142857,25,6,CTGGGACTCGGTGGGGAAGG,19,5038728
ykgRp,12.142857142857142,90,6,CTGGCCTTGAGAGCAGATCA,84,5041136
ykgRp,3.5714285714285716,30,6,CTCTCCTTACAGCTCAAACG,24,5034153
ykgRp,6.142857142857143,48,6,CTCAAGTCGGCAACAGTTAC,42,5060514
ykgRp,2.7142857142857144,24,6,CTACGTCATGTCCTCCAGGA,18,5052693
ykgRp,1.1428571428571428,13,6,CTAATATGCTTGAACGTAGC,7,5058261
ykgRp,2.0,19,6,CTAACTGGCTCACGTCTGCG,13,5057619
ykgRp,1.4285714285714286,15,6,CGTTACTCGCCGAAAAGTAG,9,5046573
ykgRp,2.5714285714285716,23,6,CGTGCGCATACATGAATTCT,17,5059614
ykgRp,0.2857142857142857,7,6,CGTCGCTCATTCGCTCTACA,1,5040397
ykgRp,3.5714285714285716,30,6,CGGTGCCCGTGTGGCGCTAT,24,5053612
ykgRp,0.8571428571428571,11,6,CGATAGGCTTATGACCGAGA,5,5053387
ykgRp,0.8571428571428571,11,6,CGAACTCAAAAAGAATCCCT,5,5053867
ykgRp,5.428571428571429,43,6,CGAACAACTCCTATACCTAC,37,5054882
ykgRp,5.285714285714286,42,6,CCTTTTTGCACCATGGCAGG,36,5036548
ykgRp,1.5714285714285714,16,6,CCTGTTTTTCCTAACAGGTG,10,5032538
ykgRp,2.7142857142857144,24,6,CCTGTGCCATGATGGATCAT,18,5052268
ykgRp,2.5714285714285716,23,6,CCTGGTACGCCTGGATGAAG,17,5034156
ykgRp,2.0,19,6,CCTCTGATATACAATCACGG,13,5055938
ykgRp,2.5714285714285716,23,6,CCTCGCTCGAATTTGCAAGT,17,5059231
ykgRp,2.0,19,6,CCTCCCGGAACTAAGGCCAT,13,5033980
ykgRp,9.714285714285714,73,6,CCTATTTTTCCTCTGCCTGT,67,5036187
ykgRp,6.142857142857143,48,6,CCTATGCAACTGAAGGTGCT,42,5032097
ykgRp,5.0,40,6,CCGTCGGGCCTGATTGGGGG,34,5054374
ykgRp,11.857142857142858,88,6,CCGAACTCCAGCCGGATCTG,82,5057252
ykgRp,2.857142857142857,25,6,CCCTTGTAGTCGTTGGGAGG,19,5060418
ykgRp,2.5714285714285716,23,6,CCATCAACGATTGTCCCGGT,17,5042637
ykgRp,3.5714285714285716,30,6,CCAGTGTCCGGCCGGATCGT,24,5032668
ykgRp,2.4285714285714284,22,6,CATTTTGCCTGTACGGCCCT,16,5047626
ykgRp,0.2857142857142857,7,6,CATCGAGAAGGTACTGCGCT,1,5046129
ykgRp,2.142857142857143,20,6,CAGTAGTGAGAAATCCGATA,14,5041699
ykgRp,2.4285714285714284,22,6,CAGAAAGTCGAGGGTCGAGT,16,5040745
ykgRp,3.7142857142857144,31,6,CACGGCACCAGTCAACACGT,25,5035018
ykgRp,0.2857142857142857,7,6,CACAGGAGCGCAGTTGACAT,1,5033557
ykgRp,6.428571428571429,50,6,CAAGAACATCCGTATGCACA,44,5057576
ykgRp,1.1428571428571428,13,6,CAAAACGCCTAATGTTTGAG,7,5041271
ykgRp,1.7142857142857142,17,6,ATTCGGGTCTCAGATACTGG,11,5032259
ykgRp,1.4285714285714286,15,6,ATGTTTTCTTTGTGCTTGTG,9,5048408
ykgRp,0.2857142857142857,7,6,ATGTCAGATAAGGGCGCTAA,1,5050972
ykgRp,2.2857142857142856,21,6,ATCCGATTCGGGCCAAGGCA,15,5052999
ykgRp,9.714285714285714,73,6,ATCCCCGAACCAGAAGGAAA,67,5058903
ykgRp,4.714285714285714,38,6,ATCAAGGATTAAGATGGGCT,32,5035600
ykgRp,0.2857142857142857,7,6,ATATCTCTCTATCACGTTTT,1,5057398
ykgRp,1.4285714285714286,15,6,AGGTACGCCTCTTCGACCAT,9,5045943
ykgRp,0.2857142857142857,7,6,AGGGATGACCAATCAACCAC,1,5033224
ykgRp,0.2857142857142857,7,6,AGCTCCTCGTGAGAGTTAAC,1,5037633
ykgRp,2.4285714285714284,22,6,AGCAGAGAACGCTAAATGGA,16,5034701
ykgRp,1.0,12,6,AGCAACTAACCTTTTGTATG,6,5053250
ykgRp,0.42857142857142855,8,6,AGAGGCGCATTTACGTAGGT,2,5045924
ykgRp,2.0,19,6,AGACTATTACCGCCTTTATC,13,5051893
ykgRp,0.2857142857142857,7,6,AGACCTGAGCAGTAATTTGG,1,5034956
ykgRp,0.2857142857142857,7,6,ACTGCTAGCTCGCCGTGCCT,1,5054517
ykgRp,3.0,26,6,ACTGATTATCGATCAGGTCT,20,5058488
ykgRp,0.42857142857142855,8,6,ACGTACTGCGAAGGTTTCGT,2,5059508
ykgRp,1.8571428571428572,18,6,ACCCGTTTCGCGTCCGATGA,12,5039483
ykgRp,1.5714285714285714,16,6,ACAGTTGGACTCGATTTTGT,10,5059352
ykgRp,1.4285714285714286,15,6,AATGGATTGCAACCATAGAA,9,5035291
ykgRp,1.0,12,6,AATCTTTCTCCCGGGTGTCC,6,5057488
ykgRp,0.2857142857142857,7,6,AATCATAAGTCATTCTTGGG,1,5033021
ykgRp,1.1428571428571428,13,6,AATAGCTCGGGGGAATTTAT,7,5058040
ykgRp,1.8571428571428572,18,6,AAGCTTGAACAACGGGCTTA,12,5033616
ykgRp,0.5714285714285714,9,6,AAGAGAGCGGGCGCTAAACA,3,5035125
ykgRp,0.42857142857142855,8,6,AAGAACTGACCCCGGGTGTT,2,5036540
ykgRp,2.7142857142857144,24,6,AAGAAAAAAGCTAGTCATGG,18,5054122
ykgRp,0.2857142857142857,7,6,AACGTGATCTGAGGCCGCTC,1,5037398
ykgRp,2.2857142857142856,21,6,AACGAAAACCGTCTACAATG,15,5059729
ykgRp,4.428571428571429,36,6,AAAAGCAACCGTCTCCGCTC,30,5059245
ykgRp,4.666666666666667,32,5,TTGTCCGGCCATATTTGGTG,27,5042898
ykgRp,1.6666666666666667,14,5,TTGATGCGCTTTTCCCATAC,9,5032168
ykgRp,3.5,25,5,TTGACACAGTGGTCTGGGGT,20,5037776
ykgRp,2.1666666666666665,17,5,TTCTCTCTCACCGGGCCACT,12,5040148
ykgRp,3.0,22,5,TTCTACAAGTCTTCCGGCTA,17,5041302
ykgRp,0.3333333333333333,6,5,TTCGATCTTGGTTTAATGCC,1,5053784
ykgRp,2.6666666666666665,20,5,TTCAGGTTAATAGTCCTGTT,15,5045857
ykgRp,1.5,13,5,TTCAGACTGCTCCGACCCAC,8,5045505
ykgRp,2.6666666666666665,20,5,TGTTCCCGACATTTAGTGAC,15,5045649
ykgRp,3.5,25,5,TGTGGGGCGCAAGGTATCGA,20,5045503
ykgRp,3.5,25,5,TGTGGGCCAGAAAACGGTCG,20,5058507
ykgRp,4.833333333333333,33,5,TGGTGGACAATTTTGCATCA,28,5050552
ykgRp,12.166666666666666,77,5,TGGTGCACCTGTAAGTGTTG,72,5050081
ykgRp,0.6666666666666666,8,5,TGGGTTATACAGGATAGGAT,3,5059450
ykgRp,3.8333333333333335,27,5,TGGGTTAGTAAGTTTTGGGA,22,5054103
ykgRp,3.8333333333333335,27,5,TGGGGGCACGCGGGGCGAAG,22,5043955
ykgRp,0.3333333333333333,6,5,TGGCGAAGTAGGTGGGACTT,1,5041422
ykgRp,1.1666666666666667,11,5,TGGACCCGCCACTGTTCGGA,6,5049281
ykgRp,2.8333333333333335,21,5,TGCGCACTATTCTCCGAAAA,16,5058612
ykgRp,2.6666666666666665,20,5,TGCCTTAGGTACTCGGGTAA,15,5040976
ykgRp,2.3333333333333335,18,5,TGCCGAACTCCGTCTGACTG,13,5061614
ykgRp,2.5,19,5,TGATGGGCGATAGGAAATCT,14,5037558
ykgRp,3.8333333333333335,27,5,TGATGATACGGATTTAGATG,22,5061282
ykgRp,3.0,22,5,TGACTTGAGTCTGCTATGCT,17,5036328
ykgRp,6.333333333333333,42,5,TCTTGGCAGTCCAATGCCGC,37,5050676
ykgRp,2.3333333333333335,18,5,TCTTCGTTAGCCGACGGGCA,13,5032465
ykgRp,3.8333333333333335,27,5,TCTGTAGCGGCTATTACCAT,22,5047167
ykgRp,4.833333333333333,33,5,TCTCCTCCCCAGAAGGGTTT,28,5052273
ykgRp,7.166666666666667,47,5,TCTAATTGGCTTTTCGTCTA,42,5060000
ykgRp,4.5,31,5,TCGCGATGGAGTCAAGGGAC,26,5040064
ykgRp,1.8333333333333333,15,5,TCGACATCCCTCACCGGTCA,10,5033720
ykgRp,3.5,25,5,TCGAACCCCAAATTTTTCTC,20,5042081
ykgRp,3.5,25,5,TCCGAAACGAGGCTCCCGAA,20,5052433
ykgRp,1.3333333333333333,12,5,TCCATCAGAGCCTATACAAC,7,5060413
ykgRp,4.333333333333333,30,5,TCATTTATGTGCTGCGACTG,25,5060540
ykgRp,2.1666666666666665,17,5,TCAACCATGACTTAACTGAC,12,5037248
ykgRp,3.8333333333333335,27,5,TATTACCGAGAATGCGGAAT,22,5057572
ykgRp,0.8333333333333334,9,5,TAGGTAGTTTTCCAGATAGT,4,5034318
ykgRp,0.3333333333333333,6,5,TACTGGGGATGTGTGCTGCA,1,5058684
ykgRp,6.166666666666667,41,5,TACTCGGATGGTTGCTAGGT,36,5047795
ykgRp,2.3333333333333335,18,5,TACTACAAAAGTGTGGTAGC,13,5034040
ykgRp,3.3333333333333335,24,5,TACCCTGCTGTAGTATTGTT,19,5053332
ykgRp,6.166666666666667,41,5,TAATATAAACAACGGGCACA,36,5052018
ykgRp,4.166666666666667,29,5,TAATAATTTGATAGATGGGT,24,5044821
ykgRp,2.6666666666666665,20,5,TAAGTTCAAAAATCGTACCC,15,5046400
ykgRp,1.6666666666666667,14,5,TAACGTTTCTACACATAATA,9,5049903
ykgRp,3.6666666666666665,26,5,TAACCATAAGGGTGTAAAAA,21,5044390
ykgRp,3.8333333333333335,27,5,TAACCAATACCCCGTCCATT,22,5043574
ykgRp,5.0,34,5,TAAATCAGGCAGTCCTCAGT,29,5045397
ykgRp,2.3333333333333335,18,5,GTTTCGCATAATTTCTGTAC,13,5035085
ykgRp,4.0,28,5,GTTCGAGCGGAGATATCATG,23,5037276
ykgRp,3.3333333333333335,24,5,GTGGCTGCTTTAATGTGACA,19,5048135
ykgRp,1.5,13,5,GTGCTTTTGGTTGACTATTA,8,5046433
ykgRp,0.3333333333333333,6,5,GTCGGCTGTCTCTAGGCAGG,1,5043282
ykgRp,3.5,25,5,GTAGATCATGCTGTGGCCGA,20,5039586
ykgRp,3.5,25,5,GTACGGGTGTGATCTGGTTA,20,5031482
ykgRp,2.0,16,5,GGTGCCGCCCATGAATTTCG,11,5054512
ykgRp,3.6666666666666665,26,5,GGTGCATAGGCAGAATGTCG,21,5034580
ykgRp,1.5,13,5,GGTACGAGATTCTCGGCGAA,8,5055214
ykgRp,2.5,19,5,GGCACATTGGGCACATTAGG,14,5040377
ykgRp,1.8333333333333333,15,5,GGACCCTGAACGTGATTCTC,10,5039839
ykgRp,0.3333333333333333,6,5,GGAAAGACTCTTCTGACTAT,1,5054025
ykgRp,2.3333333333333335,18,5,GCTGTTATTAGAGTGGCTCC,13,5046262
ykgRp,1.0,10,5,GCTCAATGGCTTTTCGTTAG,5,5050479
ykgRp,2.8333333333333335,21,5,GCTAAAGTGCTTGGCATGCT,16,5045973
ykgRp,3.5,25,5,GCGTGGAGATAGTCGGTTCC,20,5048775
ykgRp,0.3333333333333333,6,5,GCGATCGGACAACGAGATGA,1,5058189
ykgRp,3.6666666666666665,26,5,GCGACTCAGATTATGGGGTA,21,5041870
ykgRp,2.6666666666666665,20,5,GCCGATGCGGGTAGTAGAGG,15,5059246
ykgRp,3.6666666666666665,26,5,GCCATCCTACCCTGCAGTCA,21,5054396
ykgRp,1.5,13,5,GCATCTCGTCTGGATCGAGG,8,5055515
ykgRp,4.666666666666667,32,5,GCAGCAGGTTGGCGAATAGG,27,5035232
ykgRp,2.1666666666666665,17,5,GCAATCATTGCGCAACTTAT,12,5045939
ykgRp,2.6666666666666665,20,5,GCAAGGCAGGTAACTACGGT,15,5061334
ykgRp,8.666666666666666,56,5,GCAAGCTACACGTTTTCAGT,51,5043060
ykgRp,4.5,31,5,GAGCATAACTCATACACAAT,26,5048986
ykgRp,3.5,25,5,GAATAAACCGTGGAAGCTCA,20,5057036
ykgRp,3.8333333333333335,27,5,GAAGAAATATCGACCTAGGG,22,5054199
ykgRp,5.166666666666667,35,5,CTTTTTCTTTATCGCTGAAG,30,5032364
ykgRp,3.3333333333333335,24,5,CTTTACCGCTATACGGACGG,19,5049049
ykgRp,10.333333333333334,66,5,CTTGCGCGGATGTGTGGTTG,61,5032415
ykgRp,2.3333333333333335,18,5,CTTATCAGACCTTCTACTCT,13,5049556
ykgRp,3.5,25,5,CTGTACCAGAAGGGAGCAGT,20,5047767
ykgRp,5.0,34,5,CTGGCTGAAACACGTTCATT,29,5043531
ykgRp,1.3333333333333333,12,5,CTCTTTCTACCCCCCGCAAG,7,5061171
ykgRp,0.3333333333333333,6,5,CTCGCCTTAGACTGTCTCCA,1,5032091
ykgRp,2.6666666666666665,20,5,CTCATGGCCGTAGATAAATG,15,5035926
ykgRp,2.3333333333333335,18,5,CTCACCCCGTTTCTCTGATA,13,5043193
ykgRp,3.5,25,5,CTATGGCCGGGACGTACTGT,20,5037314
ykgRp,3.0,22,5,CTAGTAACGTCAACTGGTAT,17,5035047
ykgRp,1.3333333333333333,12,5,CTAACAGAAATAAGCTTACC,7,5035667
ykgRp,2.6666666666666665,20,5,CGTTGTTAGATGCGAGCGGT,15,5055921
ykgRp,2.3333333333333335,18,5,CGTCTCCGGATTAAGCGCCT,13,5052155
ykgRp,4.0,28,5,CGGTTTACATCCGCCTAACA,23,5061479
ykgRp,2.0,16,5,CGGGCGGTCTTTCGCTAGCT,11,5039283
ykgRp,2.6666666666666665,20,5,CGCTTACCGGGCCTAAACCT,15,5037005
ykgRp,3.1666666666666665,23,5,CGCGTCACGAGGGTGAGCAG,18,5044317
ykgRp,5.0,34,5,CGCCGCTATAAGGTGGATAT,29,5046943
ykgRp,0.3333333333333333,6,5,CGCCGCACGTATCTGATTCA,1,5053044
ykgRp,4.666666666666667,32,5,CGAGCTTCGGACAATCAAGG,27,5038144
ykgRp,1.5,13,5,CCTTCCTCTAACCAGGCGCT,8,5048163
ykgRp,5.5,37,5,CCTCTGCAACCAGCGTCTAT,32,5049610
ykgRp,2.6666666666666665,20,5,CCTATCTCTAGCAAACGTAC,15,5033466
ykgRp,1.1666666666666667,11,5,CCTACGGAGGTATGCGGGCA,6,5046409
ykgRp,0.3333333333333333,6,5,CCATACTTGTTTCCTTCCAG,1,5036767
ykgRp,3.3333333333333335,24,5,CCACTACTGCGTTATGTAGT,19,5056315
ykgRp,0.3333333333333333,6,5,CCAAAGTACAGGTCGGGTGG,1,5057782
ykgRp,1.3333333333333333,12,5,CATGCGTAAATCTCCCCCAC,7,5046399
ykgRp,2.8333333333333335,21,5,CATCTTTCGAGTAAAAATAT,16,5054156
ykgRp,2.8333333333333335,21,5,CATATGGCTCTCTTACAACT,16,5049511
ykgRp,0.3333333333333333,6,5,CATATCCATGAACGGGACCA,1,5037714
ykgRp,14.333333333333334,90,5,CAGTATGAATCGCCTCATCG,85,5033220
ykgRp,6.833333333333333,45,5,CAGACAGTGATAATGTGGCT,40,5060210
ykgRp,4.0,28,5,CACTCTTGATAGTCCTTGTG,23,5044273
ykgRp,6.5,43,5,CAATCCTACCTTTGAGTGTG,38,5061675
ykgRp,3.8333333333333335,27,5,CAATAATGTACAACGGTATG,22,5043413
ykgRp,2.6666666666666665,20,5,CAACCTATCCTCCTCGGACT,15,5045640
ykgRp,0.6666666666666666,8,5,CAACCGACCAACAAATCATG,3,5060575
ykgRp,0.3333333333333333,6,5,CAACAATACGACTATACACT,1,5036009
ykgRp,0.3333333333333333,6,5,ATTTTCTGTAACCCCTGATT,1,5058421
ykgRp,1.0,10,5,ATTCTCCACACGGACCCGTG,5,5057360
ykgRp,3.5,25,5,ATTATTTTATCTGTCAGATA,20,5037338
ykgRp,7.333333333333333,48,5,ATGGTCATTCGCGTGGCTTT,43,5061564
ykgRp,34.166666666666664,209,5,ATGCTTCCTGTACCTAAGTT,204,5061708
ykgRp,2.3333333333333335,18,5,ATGCGACGACATGATAGATC,13,5048886
ykgRp,3.1666666666666665,23,5,ATGCAACATCGTTTACCGTG,18,5049309
ykgRp,1.1666666666666667,11,5,ATGATGCCGTCGTCGTGTAC,6,5040622
ykgRp,0.3333333333333333,6,5,ATCTGCTCACGGGTGCTCTC,1,5042122
ykgRp,2.8333333333333335,21,5,ATCTATAGGTAACAAGACGA,16,5059865
ykgRp,0.3333333333333333,6,5,ATACTATCAGAATGAATTAT,1,5034470
ykgRp,3.6666666666666665,26,5,AGTATGCATCGGCCCCGACC,21,5038025
ykgRp,0.3333333333333333,6,5,AGGTGTTGAACAAGTAGGTA,1,5051793
ykgRp,2.6666666666666665,20,5,AGCGCGACTGGGTATTGGAT,15,5058490
ykgRp,0.3333333333333333,6,5,AGCCCCGAAAGTTAATTGTT,1,5041306
ykgRp,4.166666666666667,29,5,AGACTGTTATTCGTAGTACA,24,5044124
ykgRp,0.3333333333333333,6,5,AGAATCGAGCGGGAGTGGTA,1,5047681
ykgRp,1.8333333333333333,15,5,ACGTCTAGATTATGTGGTCC,10,5044303
ykgRp,3.8333333333333335,27,5,ACGGTTTTAGCAGGATTGCA,22,5032445
ykgRp,2.5,19,5,ACCCAATCTGATGGCTGGGT,14,5054097
ykgRp,4.833333333333333,33,5,ACATCCTGAGGGCGCGATCT,28,5040829
ykgRp,8.5,55,5,ACAGCCTTCAGAATCTACGT,50,5056917
ykgRp,5.0,34,5,ACAGACGTAATTACAATCTA,29,5042454
ykgRp,3.5,25,5,AATGGGTTGTCTGTTTCTTA,20,5059165
ykgRp,2.0,16,5,AATATGCGAAGACCATGCGT,11,5048347
ykgRp,3.1666666666666665,23,5,AATAGTAGCGAAGATGATTC,18,5031565
ykgRp,5.166666666666667,35,5,AACGCAGTCGGATGGGGGTC,30,5053283
ykgRp,3.6666666666666665,26,5,AAATTGTCCTCGTTCCCTAT,21,5036479
ykgRp,1.6666666666666667,14,5,AAATATGGGTCCACAGGAGG,9,5047808
ykgRp,2.1666666666666665,17,5,AAACCGTTTAGCGTTGGGTT,12,5037842
ykgRp,4.5,31,5,AAACCACCTATATAGCGTTT,26,5049996
ykgRp,3.0,18,4,TTTTCAAGGACAGTTAGCAG,14,5048761
ykgRp,4.8,27,4,TTTCCGTGAGCATTCAAGGA,23,5053172
ykgRp,1.6,11,4,TTGTCTCTTTAGCATACTTA,7,5039484
ykgRp,2.2,14,4,TTCTTTGTCCAATGGTAGCC,10,5060214
ykgRp,0.4,5,4,TTCGGGATTCTGTCAGAGAA,1,5057831
ykgRp,7.8,42,4,TTCCAGTCACGATACTTGTC,38,5050465
ykgRp,3.4,20,4,TTCACATTTCGCACCTAGCA,16,5053782
ykgRp,3.6,21,4,TTATGGTACTGGTTGCAAAT,17,5046183
ykgRp,9.4,50,4,TTATGCGCAATAATCCGAAT,46,5048143
ykgRp,11.8,62,4,TTATCAGGTACATGCATAAG,58,5048815
ykgRp,2.6,16,4,TTACCAGAATATATGACCCT,12,5034848
ykgRp,11.4,60,4,TTACAGTCTGGCTATTCCGC,56,5055665
ykgRp,1.2,9,4,TTAATGATGCCTGGGCATGG,5,5033743
ykgRp,0.4,5,4,TGGTTTATCCCGCATAGACA,1,5054258
ykgRp,6.0,33,4,TGGGCAATTTACGGTACGGT,29,5052895
ykgRp,0.4,5,4,TGGCTATAGGCCAATGTCCC,1,5055406
ykgRp,7.6,41,4,TGGATCGGCACGGTAACCAC,37,5041379
ykgRp,2.6,16,4,TGGAGGGTCGAGTTCTCAGA,12,5053841
ykgRp,4.4,25,4,TGCTCTGATCAGTCCAATCG,21,5033340
ykgRp,2.6,16,4,TGCGGCAGTATTTCCAAATA,12,5040723
ykgRp,11.2,59,4,TGCGGAACATCGGGGTTGTT,55,5058904
ykgRp,2.6,16,4,TGCGCGTCTACTATATATCA,12,5046714
ykgRp,2.6,16,4,TGCCTGTCTAAGGTTAAATG,12,5037093
ykgRp,2.2,14,4,TGCCCGTAAGTATAAGTCAA,10,5037089
ykgRp,1.0,8,4,TGCATCCGCGGTAGCCGCAG,4,5046666
ykgRp,3.6,21,4,TCTTTAGCCCGATTATGGGG,17,5042919
ykgRp,3.6,21,4,TCTTGTAATGCACAGACATT,17,5048469
ykgRp,8.8,47,4,TCGTATGTCCCCCGTGAGGG,43,5039159
ykgRp,3.2,19,4,TCGCGGTCAGATTTAACATC,15,5055034
ykgRp,0.4,5,4,TCGAGGCAATTGCGGCTGAT,1,5044026
ykgRp,5.2,29,4,TCCGTGCTCTTCGAATTAGG,25,5059129
ykgRp,1.0,8,4,TCCAGCGCTCCTCTCGTTCA,4,5055278
ykgRp,2.6,16,4,TCCACGTATGTAACACAGCT,12,5042706
ykgRp,4.8,27,4,TCAGCTTGTCGAACCCTCGT,23,5040343
ykgRp,1.8,12,4,TCACTTTATTTCTTCGAAAT,8,5035126
ykgRp,3.2,19,4,TCACTGGGAGCAGCTGTCGT,15,5048333
ykgRp,2.8,17,4,TCACCATAAGCGGGGCTCGT,13,5051596
ykgRp,8.8,47,4,TCAAAATGGTCATGGCTGAA,43,5044473
ykgRp,2.4,15,4,TATGGTGGTGAGTCAATCGT,11,5032831
ykgRp,0.4,5,4,TATGACGAGCCCTAGGGCGT,1,5056795
ykgRp,3.6,21,4,TAGGTCGATTATCAGGGGCG,17,5046659
ykgRp,0.4,5,4,TAAGGTAGCATGTGGCAACA,1,5041481
ykgRp,2.0,13,4,GTGTATATCGTTAAAAAGTC,9,5057436
ykgRp,0.4,5,4,GTGGTCATGGACATTATGGA,1,5060888
ykgRp,3.8,22,4,GTGGGTGGCGAGGTAAAAGA,18,5050078
ykgRp,0.4,5,4,GTGGGGGCCGGGTAAGGTCT,1,5056805
ykgRp,4.0,23,4,GTGCTATCGAAAAGGCCTCC,19,5034699
ykgRp,2.4,15,4,GTGCCGTATTATCTCTTGAA,11,5060919
ykgRp,7.8,42,4,GTCCACATCGTTATGCCTGT,38,5038778
ykgRp,2.2,14,4,GTCATTGCCGTACTGTAATA,10,5037907
ykgRp,0.4,5,4,GTATAATCATATATTTACCC,1,5045945
ykgRp,4.6,26,4,GTAGTGAGGGAGTTCTGGTC,22,5049940
ykgRp,4.0,23,4,GTACTGTTCTTAGATGTTTT,19,5057229
ykgRp,4.0,23,4,GTACGACCCCCGCCTTAAGA,19,5047220
ykgRp,2.2,14,4,GTAATAGCATTTTCAGACTT,10,5060935
ykgRp,1.8,12,4,GGTGAATCCGTAACCTCCCT,8,5050514
ykgRp,0.6,6,4,GGTCCGTACAACACACACAC,2,5059017
ykgRp,12.0,63,4,GGTCCAACTCCACACTTACA,59,5044550
ykgRp,0.4,5,4,GGGTGTCGTAACATTTAAAC,1,5050757
ykgRp,3.2,19,4,GGGGAGCCGATAATAGGTGC,15,5045563
ykgRp,6.2,34,4,GGCCCTCGTTCGTGGCCGGC,30,5059169
ykgRp,3.0,18,4,GGCCATTGTTCTGGTTTCAA,14,5035746
ykgRp,2.4,15,4,GGATTGGAAGACTGTCCCGT,11,5049877
ykgRp,0.4,5,4,GGACCGTGTATAAGGACGAT,1,5053783
ykgRp,3.6,21,4,GGACCGATGTCGTCCCATTA,17,5042823
ykgRp,3.6,21,4,GCTCGTCGGGCGTGGGTTAG,17,5032550
ykgRp,8.2,44,4,GCTACTTCTATTGCGGTAAG,40,5052536
ykgRp,4.2,24,4,GCGAATAGCTTGACTTCGGT,20,5036686
ykgRp,4.4,25,4,GCCGAGAGGGATGCAGCGGC,21,5054592
ykgRp,2.8,17,4,GCCCGGGCAACATGGGGTAC,13,5056572
ykgRp,3.4,20,4,GCCATATATAAAGTAGACGG,16,5039931
ykgRp,7.8,42,4,GATCTTCATAGACCTAAACC,38,5050825
ykgRp,0.4,5,4,GATACTGGTCACTAACGCTA,1,5052637
ykgRp,4.6,26,4,GAGGTGTTATCAATTCCGCT,22,5033785
ykgRp,3.8,22,4,GAGATCGAGCGGTGTCGAGA,18,5037214
ykgRp,6.8,37,4,GAGAAACGTTTCCGTACACT,33,5049826
ykgRp,0.4,5,4,GACTACGGCGTGACACTATT,1,5048683
ykgRp,1.4,10,4,GACATTGAGCTTCCGAACTA,6,5041906
ykgRp,4.0,23,4,GACATGTTCTGGAACTTCTC,19,5038345
ykgRp,0.6,6,4,GACATCCAAGTAACCAAACA,2,5048492
ykgRp,1.4,10,4,GACAGCGGCGGGGTCCATTG,6,5034725
ykgRp,6.0,33,4,GAATTTTGTGTTGGGTATGC,29,5049455
ykgRp,0.4,5,4,GAACTCCTCTGCCTGGGATA,1,5038276
ykgRp,4.4,25,4,GAAATTGTGTTATTGACGCC,21,5039046
ykgRp,0.4,5,4,GAAAATCCACGCAATGAATG,1,5058329
ykgRp,4.0,23,4,CTTTCAGCTCTCGCGTTTTA,19,5041938
ykgRp,2.6,16,4,CTTTATCGTCCAGCGAGCGG,12,5038715
ykgRp,2.2,14,4,CTTCAGAAATCGACTAGGTG,10,5043759
ykgRp,0.4,5,4,CTGGAGGCAAGCGTAGCCCA,1,5050285
ykgRp,4.8,27,4,CTCTGTGTTGAGTTTGTGAA,23,5060417
ykgRp,0.4,5,4,CTCAGATTGTTCTCAATCTT,1,5056685
ykgRp,13.6,71,4,CTAGCAGAACCTTGTAGTGT,67,5044271
ykgRp,0.4,5,4,CGTGGAACCTCGGAGGCACA,1,5055711
ykgRp,6.2,34,4,CGTCTCAAATCAGGTAATGC,30,5058010
ykgRp,6.0,33,4,CGTCGGGGGGTCCGGCCATA,29,5044307
ykgRp,4.8,27,4,CGGTGGCTGATACACGTCCT,23,5040152
ykgRp,4.8,27,4,CGGCTTTGAAAGTGTGTCAA,23,5036132
ykgRp,2.0,13,4,CGGATACGATCGGAACTGGA,9,5051461
ykgRp,1.6,11,4,CGCTAAGGCGCTCCCCTCAT,7,5045863
ykgRp,5.8,32,4,CGCGCCGTACGTCCCTTCCA,28,5041072
ykgRp,4.6,26,4,CGATCTAGATAGCTGTACTC,22,5036234
ykgRp,9.0,48,4,CGACAGCCTTTTCGCGGAGT,44,5057909
ykgRp,6.8,37,4,CCTGCTAGTCATTAGCTTCT,33,5055951
ykgRp,5.2,29,4,CCGTTAAATGGCCGGTATAA,25,5057459
ykgRp,0.6,6,4,CCGTACGAGTGCGGTTTGCT,2,5059460
ykgRp,1.2,9,4,CCAAACTCTCTGCCGAGGTA,5,5056425
ykgRp,5.4,30,4,CATCCTTGGGCAGACATTCA,26,5052759
ykgRp,2.2,14,4,CATATTCATATTCGGAATCA,10,5038398
ykgRp,5.4,30,4,CATAAAGTCCTCATATATGT,26,5058716
ykgRp,4.0,23,4,CAGTCCACAAGACGCTCTTC,19,5056169
ykgRp,8.6,46,4,CAGCTGGGTTTTACTTGAGC,42,5060615
ykgRp,3.0,18,4,CAGCGTCTTACGTTCCGGTA,14,5052850
ykgRp,0.4,5,4,CAGCACTTGCGTGTCTAAAG,1,5051451
ykgRp,4.2,24,4,CAGACTGACCGGTAAGACAT,20,5047765
ykgRp,1.2,9,4,CACATCGCAACTTTAGCTTG,5,5051048
ykgRp,0.4,5,4,CAATGTGATAGGTAAAATTC,1,5052648
ykgRp,1.0,8,4,ATTGCTCATGGCCCCTTGCG,4,5032501
ykgRp,2.2,14,4,ATGTTAAATTGGTGGGGGTG,10,5050493
ykgRp,0.4,5,4,ATGCTGTTACGTCCACCCGA,1,5045021
ykgRp,3.4,20,4,ATCCCAGGTGTCTGATCGAA,16,5038996
ykgRp,3.2,19,4,ATATGAAGTTCAATTGAGAT,15,5052404
ykgRp,0.4,5,4,ATACATACGGGCTTTCATCA,1,5061453
ykgRp,3.4,20,4,ATAATGTCATCGCGGTCGCT,16,5033580
ykgRp,4.2,24,4,ATAAAGGCTGAAGGAGGCCC,20,5037849
ykgRp,5.0,28,4,AGTGGTAGAACTCGCTTGTA,24,5056830
ykgRp,9.6,51,4,AGGTGTAGGAAATGTCCGTG,47,5034565
ykgRp,4.0,23,4,AGGCGGGCCACTCACAAGAA,19,5038712
ykgRp,4.0,23,4,AGCGGGTAGGAATCTCTCAT,19,5054655
ykgRp,1.6,11,4,AGCCCAGGCCGGTGAATGGG,7,5047885
ykgRp,0.8,7,4,AGATTGGGCAAAAATGGGCG,3,5045774
ykgRp,0.4,5,4,AGATAATACATTTAACCACC,1,5034909
ykgRp,1.2,9,4,AGACCCATACTCGTCTTCTT,5,5032533
ykgRp,0.4,5,4,AGAAGGAAAAGTTGGAGGCG,1,5058942
ykgRp,2.6,16,4,ACTGCTTGGTCCCGCTGCAT,12,5060525
ykgRp,3.4,20,4,ACTAGCTTAACACGTTTGGA,16,5050984
ykgRp,8.2,44,4,ACGTAGATCTTGTGTTATTG,40,5035583
ykgRp,2.6,16,4,ACGGGTCTTAGATCTGCTTG,12,5047195
ykgRp,4.8,27,4,ACGCGAGTGTTACCATCTCG,23,5043242
ykgRp,3.0,18,4,ACGCAGCCAAAAGCTTGGAA,14,5035196
ykgRp,1.4,10,4,ACGATGTTGGGTTCACCCGG,6,5048794
ykgRp,1.6,11,4,ACGATCAGGGCCATATCTTG,7,5049236
ykgRp,4.4,25,4,ACCTGTCGGTGCCGAGTGGC,21,5048982
ykgRp,10.2,54,4,ACCAAGATAGCGGTTAGTTT,50,5059675
ykgRp,0.6,6,4,ACCAAAGAAAGCGGTGAATT,2,5041946
ykgRp,5.0,28,4,ACAATAATATTTCCAGCCTC,24,5055827
ykgRp,1.4,10,4,AAGTAGTTGCAATCGAAGAA,6,5058511
ykgRp,2.4,15,4,AAGGGGATTGGATAAGGGGA,11,5038744
ykgRp,0.4,5,4,AAGGCGTGCGAAAGACTCCG,1,5047421
ykgRp,0.4,5,4,AACTCGGATAAAATACACGT,1,5047968
ykgRp,0.4,5,4,AACTCCCGTAAGAATTGAAA,1,5049313
ykgRp,4.0,23,4,AACGCCTGTAAGAGCATTAC,19,5035235
ykgRp,2.6,16,4,AACCTTAATTCAGTTGGAAA,12,5038655
ykgRp,0.4,5,4,AAAGGGGTCTGCGTTCTCGA,1,5055419
ykgRp,2.6,16,4,AAAAATCCCCCCCGCCCGTT,12,5050286
ykgRp,0.4,5,4,AAAAAATGAGGCTCAGCCTT,1,5043394
ykgRp,1.5,8,3,TTTTCTGCTATAAGGTGGCT,5,5049712
ykgRp,3.75,17,3,TTTTATCTCCTCGCTATTCA,14,5035699
ykgRp,10.75,45,3,TTTCGGTGCTCAGATTACTT,42,5048597
ykgRp,6.75,29,3,TTTAACAATTTGATGTAGTC,26,5043954
ykgRp,1.0,6,3,TTGCTATACGTCACACAGAA,3,5046254
ykgRp,5.5,24,3,TTGAAGTATAACCATCGCCC,21,5046462
ykgRp,0.5,4,3,TTCTTGGCTTAACGCACCCC,1,5040435
ykgRp,12.25,51,3,TTCTTGAAGTTCTTCTAGAC,48,5053773
ykgRp,7.25,31,3,TTCTTAGTGCATATGAAGGT,28,5039032
ykgRp,2.5,12,3,TTCTCTACGGCCTAGAGCTG,9,5056916
ykgRp,7.25,31,3,TTCGCCAGCTAGCACCACGC,28,5054713
ykgRp,5.0,22,3,TTCGACTTCCTTTAGGTGAC,19,5044247
ykgRp,2.75,13,3,TTCCTAAGGTCGCTTCTTGA,10,5044023
ykgRp,3.25,15,3,TTAGCCGTGGCTAGTTACGT,12,5061609
ykgRp,0.5,4,3,TTAGAACCGCTTACGTGCGG,1,5047090
ykgRp,4.75,21,3,TTACATTGTTAGTTCTGGTA,18,5036188
ykgRp,9.0,38,3,TGTTCAGTATGGGTTGGCCT,35,5044962
ykgRp,10.5,44,3,TGTATGACGGTGGGCATTGG,41,5058521
ykgRp,6.25,27,3,TGTAGCAGGCTGTGCCTGTA,24,5059660
ykgRp,2.75,13,3,TGGTAGTGTTAAGGGATGCT,10,5057235
ykgRp,4.25,19,3,TGGAGCATCGACTATAGTCT,16,5034011
ykgRp,2.75,13,3,TGCTGAGCCCGTTCCATACG,10,5037852
ykgRp,1.5,8,3,TGCTCCACAACACTTAAATG,5,5040165
ykgRp,8.0,34,3,TGCGGATGTGATCGACCATG,31,5050897
ykgRp,3.75,17,3,TGACGGTCAACGTCCTTACA,14,5033952
ykgRp,8.5,36,3,TGACGCCTCGGTTATCAGTT,33,5031454
ykgRp,3.75,17,3,TCTTAAAAATTTTTGCGCCT,14,5044410
ykgRp,0.5,4,3,TCTACCGGGGTGTAAGTAGG,1,5056128
ykgRp,5.0,22,3,TCGGGATATTCACGTCATGG,19,5054284
ykgRp,4.25,19,3,TCGAATGACACGGGAACCTA,16,5038554
ykgRp,6.0,26,3,TCCTGTACGGTCTCAAATGA,23,5043608
ykgRp,0.5,4,3,TCCAGTGGCACCCTGCGTCC,1,5049416
ykgRp,2.0,10,3,TCCAATCGTCTCTGTCGGGG,7,5058870
ykgRp,4.25,19,3,TCCAAAATATGGAGCATCTA,16,5033509
ykgRp,0.75,5,3,TCATAAAAGGTTGGCACTCC,2,5048023
ykgRp,0.75,5,3,TCAAAGATTGACGCGAAATA,2,5041791
ykgRp,0.5,4,3,TATGGGGGCGTCCGGTGTGC,1,5057074
ykgRp,14.25,59,3,TATCCTACGAGTGTTAGCCA,56,5047554
ykgRp,4.25,19,3,TATATGGGTCATTCGCGCAA,16,5054474
ykgRp,5.5,24,3,TATAATGTAAATAGGCAGTT,21,5045074
ykgRp,4.25,19,3,TAGCCACATCGTACAAAACT,16,5059602
ykgRp,3.0,14,3,TAGATGTAGCCCCTGATTTC,11,5047659
ykgRp,5.0,22,3,TAAGCCTTAACGCGGTATAC,19,5045441
ykgRp,4.25,19,3,TAAACCGGTATTCCCCTGTG,16,5051550
ykgRp,7.5,32,3,GTTAATCATCGTATGGCTGG,29,5042574
ykgRp,4.5,20,3,GTGGTGGGTTGACTTTGATT,17,5057872
ykgRp,2.25,11,3,GTGCTATCTCCGTACTAGTT,8,5060710
ykgRp,0.5,4,3,GTGCCTTACGACTAGCATGC,1,5052047
ykgRp,0.5,4,3,GTGATGATTGCCGCAGTCTT,1,5051303
ykgRp,5.5,24,3,GTCTTGATAGTACCGAAGGA,21,5037034
ykgRp,4.5,20,3,GTCCGTAGTTCTGAGGAGAC,17,5054921
ykgRp,5.0,22,3,GTCCGGCACACCAACCGTTA,19,5032750
ykgRp,2.75,13,3,GTCCCTCCCCAATTCCGGGT,10,5041952
ykgRp,4.5,20,3,GTCCCTAAGCAACCCCGCTG,17,5035451
ykgRp,3.75,17,3,GTCACGGGACGTAAGACAAA,14,5048749
ykgRp,5.0,22,3,GTATTCTTGTATTAGGTCAG,19,5032126
ykgRp,1.25,7,3,GTATGTAAAACTAGCTATCC,4,5052418
ykgRp,5.25,23,3,GGTTCTCCGGTGTCACCGTG,20,5049845
ykgRp,0.5,4,3,GGTGTTCCTGGGACCCTCTG,1,5050308
ykgRp,0.5,4,3,GGTGGGAATAGCCAGAGGCC,1,5036252
ykgRp,2.25,11,3,GGTCTAAACTTGCTCGGAGA,8,5032507
ykgRp,0.5,4,3,GGGATCAAAGAACGACTCGA,1,5061086
ykgRp,0.5,4,3,GGGAATCCCAGTCAGATAGA,1,5042673
ykgRp,3.0,14,3,GGCTTAGAGAGCAGCCTCGT,11,5061690
ykgRp,13.5,56,3,GGCGTCCTAACCTGTAACCT,53,5051238
ykgRp,3.0,14,3,GGCGTACGCTGGTGGTGATG,11,5035107
ykgRp,5.5,24,3,GGCGAGCTTCTTGGTAATCA,21,5032376
ykgRp,5.0,22,3,GGAGAGTGGACCCTTTGTCA,19,5054817
ykgRp,0.5,4,3,GGACTTTACGCTAGTGTCTC,1,5061741
ykgRp,5.25,23,3,GGACTAATCACGTTGCAACG,20,5047266
ykgRp,0.5,4,3,GCTTATATTGGGCTTGGAAG,1,5059495
ykgRp,3.5,16,3,GCTGTAACACCAGTAGAATT,13,5052138
ykgRp,6.75,29,3,GCTGACTTTGCGTTCATTAT,26,5040908
ykgRp,3.0,14,3,GCTCATCGTTGCCTCTGTTT,11,5039365
ykgRp,3.5,16,3,GCTATAGACCACTTCAAATA,13,5034431
ykgRp,6.25,27,3,GCTACGCCGGTACCGCTCTG,24,5045993
ykgRp,6.0,26,3,GCGTAATAGGCCTGACCATG,23,5034825
ykgRp,5.25,23,3,GCGCGTCATAGGCACGCGCC,20,5035554
ykgRp,5.25,23,3,GCCCATTATAAACCCGGAAT,20,5037685
ykgRp,5.25,23,3,GCATAACGCGTGCCATCAGG,20,5046854
ykgRp,0.5,4,3,GCAGACCTAGGGACTCATAG,1,5055174
ykgRp,5.75,25,3,GCAATTGAACCTCCGGGAAC,22,5057130
ykgRp,5.75,25,3,GCAACTAAACGGTCGGAGTG,22,5046579
ykgRp,5.5,24,3,GATCTCTAGCGCACATGGAT,21,5057463
ykgRp,5.5,24,3,GATCCGCCATTTGCTCCTGT,21,5038971
ykgRp,3.0,14,3,GAATTCCAGTGAGTGAAAAA,11,5034224
ykgRp,5.0,22,3,GAATCTTAAACGGATTGGGG,19,5059809
ykgRp,14.0,58,3,GAAATGATAGGCACGGAGCG,55,5060886
ykgRp,1.25,7,3,CTTTTAGGTGACTTCTGTTT,4,5059775
ykgRp,7.5,32,3,CTTGGCTTCACCTCCACCAC,29,5061007
ykgRp,9.0,38,3,CTTCGTCATGATTTAACAAG,35,5041868
ykgRp,5.0,22,3,CTGGATTACCTTGTAGGATG,19,5032968
ykgRp,3.0,14,3,CTGCTAGGTCCGCAGAATCT,11,5048542
ykgRp,5.0,22,3,CTGCCTGGAATACTCAATGT,19,5032509
ykgRp,1.0,6,3,CTGATGCAGGTAAATCTTTG,3,5031849
ykgRp,4.5,20,3,CTCGGGCAACCGAGGCTCGA,17,5038974
ykgRp,2.75,13,3,CTCGCGACCAGGACGGTCGA,10,5031427
ykgRp,5.75,25,3,CTCGCATCACCTCACAACGT,22,5036814
ykgRp,3.5,16,3,CTCGATATTAGCTTACTTGC,13,5035819
ykgRp,1.75,9,3,CTCGAAAATGCCATAGCGGA,6,5054183
ykgRp,3.25,15,3,CTCATAGTGTCTTTCCGCTC,12,5038919
ykgRp,5.0,22,3,CTCACCCTACCCCTAACGCC,19,5056047
ykgRp,0.5,4,3,CGTGCGACCATGCCGGATTT,1,5055682
ykgRp,3.75,17,3,CGTCGGATGCAGGATATGTG,14,5058899
ykgRp,8.0,34,3,CGGGGTGCTGACTCGATTAA,31,5034034
ykgRp,1.75,9,3,CGGGATATCCGGCGCTCGTA,6,5042940
ykgRp,4.75,21,3,CGCTTAGCGAAGCGTGAGAA,18,5045099
ykgRp,2.75,13,3,CGACAGATATTCGAGTTGGA,10,5041204
ykgRp,17.25,71,3,CCTGTTATAAGTGAGTTAGG,68,5058896
ykgRp,2.0,10,3,CCTCGATCTGTAGCGTATGC,7,5039810
ykgRp,2.75,13,3,CCGGTTCGCAAAGGCCTAAC,10,5051641
ykgRp,10.75,45,3,CCCGTGCTTGTAGAGACCAG,42,5039517
ykgRp,6.75,29,3,CCCCGGCGGCGCCGTTTTCC,26,5053398
ykgRp,2.0,10,3,CCCCCATCCACTCGCGCGTA,7,5051955
ykgRp,2.0,10,3,CCATTGCCAGCGACTGTAGT,7,5055350
ykgRp,7.25,31,3,CCAGTCAACGGGCTCGCTGT,28,5049248
ykgRp,4.75,21,3,CCACCGAATGGAATTCATAG,18,5033930
ykgRp,3.75,17,3,CCAAACACCTAGTACGAGTA,14,5052090
ykgRp,3.25,15,3,CATTTGGGCCACTCCGGAAG,12,5056278
ykgRp,2.75,13,3,CATGGAGTAGATGCTGATAC,10,5035799
ykgRp,2.0,10,3,CATCCGTGATAAGACCCTCG,7,5055199
ykgRp,6.25,27,3,CATATACTTAATGCATCCCC,24,5036181
ykgRp,0.5,4,3,CAGGCGTTACGGGGTTAGCT,1,5058844
ykgRp,4.25,19,3,CAGGCGCGGCGGTGTGCGAA,16,5038465
ykgRp,5.25,23,3,CAGAGACCGCGGTTATTACA,20,5059787
ykgRp,4.0,18,3,CACTGGTCATGCCCGGTACC,15,5033793
ykgRp,4.0,18,3,CACGAGTTAATTTTCAGGTG,15,5041732
ykgRp,4.0,18,3,CACAGTTCGTAGCGGCAAGT,15,5049089
ykgRp,3.75,17,3,CAATTCTGTTCACGTTGCAG,14,5042911
ykgRp,0.5,4,3,CAAATGAACCGATGGCTATC,1,5036716
ykgRp,2.5,12,3,CAAAGCGTATTATTTTACCC,9,5039361
ykgRp,0.5,4,3,ATTTGTGTCAAGTTGATTTA,1,5044284
ykgRp,4.5,20,3,ATTGCGAGAGAAACTGTTTA,17,5032997
ykgRp,3.75,17,3,ATTGATCGTGTTGAAGGACA,14,5052347
ykgRp,2.0,10,3,ATTATACTGCCCTCTTTCTG,7,5052769
ykgRp,0.75,5,3,ATGTTGGCTTTACAGTAAGG,2,5032972
ykgRp,5.25,23,3,ATGTAGACTTTGGGATCTAG,20,5057120
ykgRp,3.0,14,3,ATGGGTACGGTTTGGTTGAG,11,5045734
ykgRp,1.0,6,3,ATGGACATGCCCAATTGACT,3,5034640
ykgRp,8.5,36,3,ATGCCCTCCGGACCCTGACA,33,5056894
ykgRp,3.5,16,3,ATGACTCCATGCTACTAAGG,13,5049152
ykgRp,4.75,21,3,ATCGTTGATTGCTTTAATGT,18,5040220
ykgRp,5.5,24,3,ATCCCACGTAGCAAGGTTTA,21,5046465
ykgRp,2.75,13,3,ATATCTTCTGAAAATAAGTT,10,5032825
ykgRp,2.0,10,3,ATATAGTACTCATATGGAGG,7,5034765
ykgRp,0.5,4,3,ATATACCCGGTCAGAATGTT,1,5031422
ykgRp,4.75,21,3,ATACACCTCTCGGCCGTCTT,18,5050839
ykgRp,3.25,15,3,ATAAGTCGCACTGTCGTCAT,12,5031589
ykgRp,8.75,37,3,AGTTGCCTACATCACATAAC,34,5037833
ykgRp,3.0,14,3,AGTGCTGACTCGACCTTTGT,11,5052237
ykgRp,3.5,16,3,AGGTATTGCGTAATATTCCG,13,5049776
ykgRp,5.0,22,3,AGGCTCGGGGCCTTCCCATA,19,5046407
ykgRp,5.5,24,3,AGGCCGGATAGGGTACGAGC,21,5053643
ykgRp,4.25,19,3,AGGATCTCTTCACTGCGCCT,16,5054956
ykgRp,4.5,20,3,AGCCCTGCGGGTGCGAGTAC,17,5052565
ykgRp,1.0,6,3,AGCACGTCATGAGCACAAGT,3,5033511
ykgRp,4.25,19,3,AGCACATCAAGTTCTAGAGA,16,5051757
ykgRp,5.0,22,3,AGATGATGAGATCAAGTGAG,19,5046809
ykgRp,4.5,20,3,AGAGGAGATATCACACTGGA,17,5033927
ykgRp,10.0,42,3,AGAGCACTGTCGCCCGTATG,39,5049512
ykgRp,4.75,21,3,AGAGAAACAGTTTAAGGCAG,18,5057261
ykgRp,6.5,28,3,ACTTATTCACGACCCCGAGG,25,5061602
ykgRp,1.25,7,3,ACTTAATTTCCGATAGGTAG,4,5060506
ykgRp,3.0,14,3,ACTGGTCCTACACTCCTAGC,11,5043930
ykgRp,5.5,24,3,ACTGCAACATTGAACCAGTG,21,5045584
ykgRp,0.75,5,3,ACTACTGGTCTGGTTGGCCC,2,5049219
ykgRp,4.5,20,3,ACGTACATAAAACCAGGAAA,17,5060685
ykgRp,7.75,33,3,ACGGTCAAGATGCAAGAAAA,30,5052296
ykgRp,4.5,20,3,ACGGCAAATTCAGGCGATAA,17,5055566
ykgRp,0.5,4,3,ACCACTATTATGAGAAGAAC,1,5045555
ykgRp,0.5,4,3,ACCAACGGGGGGTAGGGGCG,1,5057144
ykgRp,2.5,12,3,ACATTAGACTGTCTGCTCGT,9,5037137
ykgRp,2.75,13,3,ACATCTCGACGTCAGACGCG,10,5040559
ykgRp,6.25,27,3,AATTTCCACCGAAGGGGTGC,24,5031846
ykgRp,5.25,23,3,AATGTGTGTTCGATTATGGC,20,5034777
ykgRp,9.0,38,3,AATACCCACTCCGGATGCGC,35,5049409
ykgRp,11.0,46,3,AAGGGTCCGTGGCATCATCC,43,5061551
ykgRp,6.5,28,3,AAGAGCGAGTTTTAGCATTG,25,5039846
ykgRp,4.25,19,3,AACTGCTTGGCTATAGGTTT,16,5046609
ykgRp,4.5,20,3,AACCCTCCTCTCACGTGACT,17,5043982
ykgRp,9.75,41,3,AAATTGCACATACTAAGCAT,38,5053460
ykgRp,5.5,24,3,AAAGTTAAGTCGGCGATTTG,21,5032604
ykgRp,3.25,15,3,AAAGAGCACGGGGATCGGGT,12,5046231
ykgRp,5.0,16,2,TTTTTTAGTTACTGGCTGTA,14,5036447
ykgRp,0.6666666666666666,3,2,TTTTAGGTGGGTAGCGAAGT,1,5058343
ykgRp,2.6666666666666665,9,2,TTTCCATTATTAAAGGTTAT,7,5031584
ykgRp,2.6666666666666665,9,2,TTTAGAGACGCGCGATCATA,7,5032772
ykgRp,1.0,4,2,TTGTTCCGCAGATCCTAGCA,2,5061250
ykgRp,1.3333333333333333,5,2,TTGGACTAGGGGCTCGCAAT,3,5037264
ykgRp,4.333333333333333,14,2,TTGCGTCATTCCGGTTAACG,12,5054813
ykgRp,3.0,10,2,TTGCGTACGCGAACCTAAAT,8,5041304
ykgRp,5.666666666666667,18,2,TTGCGCCACATCGGCCACTC,16,5045042
ykgRp,5.0,16,2,TTGCAGAGACCATATAACCC,14,5037372
ykgRp,0.6666666666666666,3,2,TTGACGTCCATACTTGAATT,1,5056741
ykgRp,0.6666666666666666,3,2,TTCTTTTACTGGACGTCCAG,1,5045054
ykgRp,7.0,22,2,TTCCCTTTAAGATAAAACTT,20,5032299
ykgRp,14.0,43,2,TTACGCTTTGTGGCACATAG,41,5034475
ykgRp,6.666666666666667,21,2,TTAACGGCGCAGAGCTCACG,19,5037476
ykgRp,1.0,4,2,TGTTTTGCTATAACGTGTAT,2,5036600
ykgRp,6.333333333333333,20,2,TGTTTCCAAGTAAATCCATT,18,5052947
ykgRp,5.0,16,2,TGTTATTGACACGCTTTGGA,14,5039270
ykgRp,4.666666666666667,15,2,TGTTAATTTCAGGCATAACC,13,5034841
ykgRp,5.333333333333333,17,2,TGTGGCTTTCGGCTTTCCTA,15,5046843
ykgRp,1.6666666666666667,6,2,TGTCAAGTTGACGGGCCAAT,4,5031549
ykgRp,0.6666666666666666,3,2,TGGTATGTCTATAGTCCTAC,1,5057220
ykgRp,9.0,28,2,TGGAATAGCGTAGTTCACCA,26,5041873
ykgRp,8.333333333333334,26,2,TGCTATGCATTAAACAGTTT,24,5036340
ykgRp,4.0,13,2,TGCGGCAACCAATATGGTAT,11,5061659
ykgRp,5.333333333333333,17,2,TGCCGACGAACCAAAGAACC,15,5044741
ykgRp,0.6666666666666666,3,2,TGATTGTAGAGAGCGTTCTG,1,5055251
ykgRp,6.666666666666667,21,2,TGATCCTCTAACATTAGGCT,19,5043512
ykgRp,0.6666666666666666,3,2,TGACTGTTGAAAGACACTTA,1,5035210
ykgRp,3.0,10,2,TCTAGACTTCTTTGCTTTGG,8,5031875
ykgRp,1.3333333333333333,5,2,TCTACCCGGATTCCATTGGT,3,5041151
ykgRp,1.6666666666666667,6,2,TCGTAGCGTGCAACGCAATC,4,5057126
ykgRp,0.6666666666666666,3,2,TCGTACGATCATTTGTCTTA,1,5058808
ykgRp,0.6666666666666666,3,2,TCGGGATCTTACAGAGAACT,1,5051592
ykgRp,4.0,13,2,TCGACATCGGGGATTAAGTA,11,5054822
ykgRp,8.333333333333334,26,2,TCCTGTGTGTGTAGGTACGT,24,5038737
ykgRp,2.6666666666666665,9,2,TCCGGCAAGGCCAGACGATC,7,5043981
ykgRp,7.0,22,2,TCCAGCTATTGCCAGGTTTT,20,5053541
ykgRp,5.333333333333333,17,2,TCAACTTCCCGAGACCGACT,15,5060616
ykgRp,2.3333333333333335,8,2,TATGCGCTCCACACGAAGGT,6,5033958
ykgRp,4.0,13,2,TAGTTTTCAAGTCTCCTTTC,11,5037025
ykgRp,4.0,13,2,TACGGTTCTTTATGACCACT,11,5056592
ykgRp,12.0,37,2,TACATGCCCACCGCAGCCGA,35,5059110
ykgRp,8.666666666666666,27,2,TAACCCGGAGCGTGGCAGGA,25,5039003
ykgRp,7.0,22,2,GTTTCTAGATCCAGAGCCGA,20,5043753
ykgRp,1.3333333333333333,5,2,GTTGACCCAGGCAACGCTTG,3,5031680
ykgRp,4.0,13,2,GTTCTGTCTGAAGGCGCCTT,11,5042903
ykgRp,1.6666666666666667,6,2,GTTACTCCATACCTCGCCAT,4,5039247
ykgRp,17.666666666666668,54,2,GTGTTTGTGAGGCTTTTAAC,52,5047788
ykgRp,4.0,13,2,GTGTTCTTCTCCCTAGCAAT,11,5060399
ykgRp,2.6666666666666665,9,2,GTGTTAAAATAGCTTCCTAT,7,5043125
ykgRp,0.6666666666666666,3,2,GTGCTGTTCTGTGCATGGAT,1,5045094
ykgRp,7.666666666666667,24,2,GTGCGGTTTGTGTCTGCAAG,22,5055872
ykgRp,4.0,13,2,GTGAGGGGTTGCCGTTACGG,11,5042610
ykgRp,0.6666666666666666,3,2,GTCGTTTTGTGAGTAGGAAG,1,5047117
ykgRp,6.333333333333333,20,2,GTCGTTTCAGCCGTTATTAG,18,5052556
ykgRp,10.0,31,2,GTCGGAGCGGCTGGCCTCGA,29,5058011
ykgRp,6.666666666666667,21,2,GTCACCTTACATAATCTTTA,19,5050857
ykgRp,1.6666666666666667,6,2,GTATTGAAGGGCTATTCCCT,4,5053358
ykgRp,5.0,16,2,GTATGTCAGGTGGCCGTCCT,14,5043288
ykgRp,4.0,13,2,GTATCTTTTGGGCGCCGGGT,11,5037566
ykgRp,4.666666666666667,15,2,GTATCGTTGTCCGGCTTTAG,13,5034062
ykgRp,7.666666666666667,24,2,GTACCCGAAAAATTTCAGAT,22,5056647
ykgRp,6.333333333333333,20,2,GTAATGCTCCCGCTACTTTC,18,5055945
ykgRp,5.333333333333333,17,2,GGTGTCTCCCCGAGTCATTA,15,5058696
ykgRp,1.6666666666666667,6,2,GGTGATCTAAACCTAACGGA,4,5035392
ykgRp,0.6666666666666666,3,2,GGTATCTGGGGAACAGCTCT,1,5048316
ykgRp,0.6666666666666666,3,2,GGGCTAAGTCTGGATGTTTC,1,5037713
ykgRp,7.333333333333333,23,2,GGGCAGCCAGGAGGGAGTGA,21,5047272
ykgRp,4.333333333333333,14,2,GGGCACATCGGATTGATAAG,12,5051167
ykgRp,5.0,16,2,GGGCAATGGGCTAGGGTTAG,14,5060920
ykgRp,5.333333333333333,17,2,GGCTGAACCAATTCCTTGTT,15,5044175
ykgRp,1.0,4,2,GGCGCCCAACTCTGAACGAG,2,5051739
ykgRp,4.333333333333333,14,2,GGCCTAATAGAACTTCGGTG,12,5031773
ykgRp,12.333333333333334,38,2,GGAAAACACACCCCGAGCCC,36,5031586
ykgRp,5.333333333333333,17,2,GCTGGGCGCGGTCAACAGCC,15,5042246
ykgRp,5.333333333333333,17,2,GCTGCTTGCCGAAAGTAATT,15,5057817
ykgRp,0.6666666666666666,3,2,GCGCCGGAAGACTTATTGTT,1,5051696
ykgRp,5.666666666666667,18,2,GCGACGCGAGCTTCCGCGTG,16,5035922
ykgRp,6.0,19,2,GCCTAACGCTTGTGTAGAAC,17,5056656
ykgRp,0.6666666666666666,3,2,GCAGAATTGTGCACTACTCT,1,5034158
ykgRp,1.6666666666666667,6,2,GCAATTACATTATCTCCGCT,4,5050177
ykgRp,7.0,22,2,GATTTTAGGACATTTCCCAG,20,5052362
ykgRp,5.666666666666667,18,2,GATCCGTTAAGGAATGGGCG,16,5043123
ykgRp,8.666666666666666,27,2,GATCATCTCGCGCGTCGTTC,25,5046534
ykgRp,8.666666666666666,27,2,GAGTCTGGGTCAAAGAAGTC,25,5039983
ykgRp,0.6666666666666666,3,2,GAGTCGGACGTTCACCATTT,1,5047679
ykgRp,3.6666666666666665,12,2,GAGGGCAACTCGTACCCTAC,10,5041382
ykgRp,15.333333333333334,47,2,GAGAGATTGTGGGAGTCGTA,45,5049979
ykgRp,7.0,22,2,GACGTCCCGGGGATGCTCTT,20,5035579
ykgRp,3.3333333333333335,11,2,GACCCCTATCCTACCTGAGG,9,5044019
ykgRp,1.3333333333333333,5,2,GACAGGTAGCGGTATCTTGG,3,5060787
ykgRp,9.333333333333334,29,2,GAAGTTTAATCGGCTCTATG,27,5057772
ykgRp,6.666666666666667,21,2,GAAGCCCATACGAATGTTAC,19,5049763
ykgRp,7.333333333333333,23,2,CTTTTTAGCCCTGGAGCGGC,21,5058836
ykgRp,0.6666666666666666,3,2,CTTATTGTGGCTGGTACGAT,1,5055010
ykgRp,10.0,31,2,CTGTGTAATACTATATATGG,29,5052900
ykgRp,0.6666666666666666,3,2,CTGCCCACTGGAGTTGCCCT,1,5045855
ykgRp,0.6666666666666666,3,2,CTGCATTCCGTTGCATAGCC,1,5038995
ykgRp,1.6666666666666667,6,2,CTGAGCGGCACGTTCAAAAG,4,5058330
ykgRp,6.666666666666667,21,2,CTCGCTTGTCTGGTTTTAGG,19,5054047
ykgRp,0.6666666666666666,3,2,CTCCCCAATCGACTGTCCTT,1,5061660
ykgRp,2.3333333333333335,8,2,CTCCCATTCCGATGTGAATG,6,5046884
ykgRp,6.333333333333333,20,2,CTCAACACGGTAATGTCAGT,18,5048763
ykgRp,7.0,22,2,CTAGTAACTCCCAAGGAGAG,20,5055208
ykgRp,5.333333333333333,17,2,CTAAGCTTTCTCGTGGGATA,15,5038636
ykgRp,3.0,10,2,CGTGAAGGGTAAATATTGGT,8,5053246
ykgRp,6.0,19,2,CGTCATGCCGACTTAGCAAG,17,5045152
ykgRp,6.333333333333333,20,2,CGGAGCCTTGCGGGTAAGGT,18,5038080
ykgRp,12.0,37,2,CGGACTCTGGGGCGAGTGAC,35,5058524
ykgRp,4.333333333333333,14,2,CGCGAGCCAAGCAGCCAAAG,12,5038130
ykgRp,5.333333333333333,17,2,CGCACAGGCCCAGTTGTGGC,15,5033933
ykgRp,1.0,4,2,CGAGGAATATAATCGGGATA,2,5043385
ykgRp,0.6666666666666666,3,2,CGAGCCCTCCTTGCCGCTAG,1,5061182
ykgRp,5.0,16,2,CGAGACTAAGTTAAACATAT,14,5055488
ykgRp,4.333333333333333,14,2,CGAATATTGTAACAATGTCA,12,5034658
ykgRp,6.0,19,2,CGAACATGATCGGTTTTTTT,17,5044340
ykgRp,2.3333333333333335,8,2,CCTTATTTTTGGTAAATACG,6,5057258
ykgRp,0.6666666666666666,3,2,CCTGGGAGCTTATGATTGTT,1,5051458
ykgRp,11.333333333333334,35,2,CCTCGGTACTTTGGAACCGC,33,5031527
ykgRp,2.0,7,2,CCGTTTTCCTCCCTCATCTT,5,5056423
ykgRp,0.6666666666666666,3,2,CCGTCAAAAAGATCCTTGGC,1,5039650
ykgRp,6.333333333333333,20,2,CCGGAGGTCAAGACTATTAT,18,5046956
ykgRp,7.0,22,2,CCGCGGAGGCGCCCTGACCA,20,5057820
ykgRp,0.6666666666666666,3,2,CCCCACTGCGTGCCGGAATT,1,5057980
ykgRp,6.0,19,2,CCCAGTTTATCCCCAGGCTT,17,5043532
ykgRp,7.333333333333333,23,2,CCACCCTCTTCCGCCTGCAG,21,5060255
ykgRp,3.6666666666666665,12,2,CATTTCACTCAATGTTCCTT,10,5056906
ykgRp,7.0,22,2,CATCCCATGCGAATAAAAGC,20,5042324
ykgRp,11.0,34,2,CATAGTCCCCTGAAGGCGAT,32,5045905
ykgRp,0.6666666666666666,3,2,CAGTATACGAAACAGAGGCA,1,5059801
ykgRp,0.6666666666666666,3,2,CAGGGTGAAACTCAGTCCGG,1,5051123
ykgRp,6.333333333333333,20,2,CAGGCGTTCAACCGGCGATA,18,5034133
ykgRp,1.3333333333333333,5,2,CAGATTGCAAGCTAATTATG,3,5058397
ykgRp,2.3333333333333335,8,2,CAGAGGTCCTCGTAACGTCT,6,5042256
ykgRp,3.3333333333333335,11,2,CAGACATCAACATAGTCTTT,9,5038114
ykgRp,0.6666666666666666,3,2,CACGTATTTTCGGCGATCAT,1,5033371
ykgRp,0.6666666666666666,3,2,CACGGTGTCCACAACGATGC,1,5054909
ykgRp,2.0,7,2,CACCGCGGTAGGTCGCGCAA,5,5049771
ykgRp,4.333333333333333,14,2,CAATGGGTTTTTAGACACAA,12,5040863
ykgRp,5.666666666666667,18,2,CAATACGAGAATGCATCATG,16,5039937
ykgRp,8.0,25,2,CAACCTCCAGGTTTCCACTG,23,5051754
ykgRp,5.0,16,2,CAAATCTCGGACATTGCTAA,14,5046505
ykgRp,3.3333333333333335,11,2,CAAACACCTGGTCTGTTATG,9,5049988
ykgRp,1.0,4,2,ATTTGTCTTCAGGACGGGTA,2,5048837
ykgRp,6.0,19,2,ATTTAAGGATGGACACACAC,17,5058382
ykgRp,6.0,19,2,ATTCCCAGGGACGGAGCCTT,17,5047835
ykgRp,0.6666666666666666,3,2,ATGCAGAACGGGAGCGCTCA,1,5056177
ykgRp,5.333333333333333,17,2,ATGAGAAATTTTAAAACAAA,15,5058817
ykgRp,7.666666666666667,24,2,ATCATGATAAGTCACGATCG,22,5050212
ykgRp,5.333333333333333,17,2,ATCAGGCCGGAAGTAAGGTG,15,5031439
ykgRp,4.333333333333333,14,2,ATAGAAGGAGTTACCTGGTA,12,5058900
ykgRp,0.6666666666666666,3,2,AGTGCTCCGTTGACGGGAGG,1,5046370
ykgRp,4.666666666666667,15,2,AGGTGATTTTCCAAGGCCGG,13,5053368
ykgRp,6.666666666666667,21,2,AGGCAACATTTTACTGAGAT,19,5032657
ykgRp,4.0,13,2,AGGACGAGACGCAAGGCGGA,11,5046219
ykgRp,2.3333333333333335,8,2,AGCGTTTTATCAGACAGGAC,6,5055076
ykgRp,3.6666666666666665,12,2,AGACGACAAACTTTAACCTC,10,5058945
ykgRp,2.3333333333333335,8,2,AGACCACGAGAGATGTGGTG,6,5032799
ykgRp,10.0,31,2,ACTCTTGTTGGGAACAGACA,29,5033809
ykgRp,9.666666666666666,30,2,ACGTTTCTCTCTAGCGTAGG,28,5047648
ykgRp,0.6666666666666666,3,2,ACGTGGTTACCTTCATTGAA,1,5061336
ykgRp,5.333333333333333,17,2,ACGGGCCGAGTTTCTACAGC,15,5061118
ykgRp,5.0,16,2,ACGACGCCTTTTTGGCTGAG,14,5058149
ykgRp,14.666666666666666,45,2,ACCGCACACTGAATCTGCCT,43,5041130
ykgRp,3.3333333333333335,11,2,ACCAATCGATCCCTCCCGAC,9,5044552
ykgRp,3.0,10,2,ACATTGGTCGGAGCGACGAG,8,5033066
ykgRp,4.666666666666667,15,2,ACATCTCCGAATAACCTCAG,13,5045162
ykgRp,2.6666666666666665,9,2,ACATATCGGTAATCACCCCC,7,5054966
ykgRp,11.666666666666666,36,2,ACAGGCCTTCAACTCACCAC,34,5041405
ykgRp,13.666666666666666,42,2,ACACGGCGATCTGTCGCCAT,40,5056914
ykgRp,4.0,13,2,AATGTAACGAAACAAAAATG,11,5040347
ykgRp,17.333333333333332,53,2,AATGCCTCCCTTTTATCTAT,51,5053777
ykgRp,7.0,22,2,AATCGTTCACGCTGTGGTTA,20,5054494
ykgRp,0.6666666666666666,3,2,AATCCGCTTGTCAAACGTAA,1,5048288
ykgRp,2.3333333333333335,8,2,AATCCCTTTCACTAATTGTC,6,5059995
ykgRp,4.333333333333333,14,2,AAGCCCAAGAGCCGAACCTT,12,5053526
ykgRp,2.3333333333333335,8,2,AAGATGTTTGGACCAGAGGA,6,5052981
ykgRp,6.666666666666667,21,2,AAGATATCATGACGAATTCC,19,5055813
ykgRp,6.666666666666667,21,2,AAGAACCTCAGTAGCTGGAC,19,5038139
ykgRp,1.0,4,2,AACTGTCCGTTCGATGGCTC,2,5052760
ykgRp,3.0,10,2,AACGTCGCTTGATGCGCTCA,8,5040077
ykgRp,7.666666666666667,24,2,AACGGCGTTGAACCACCTCA,22,5044277
ykgRp,6.0,19,2,AACCGCGTTCGAACGCTACC,17,5041964
ykgRp,4.0,13,2,AAATTTCCGACTCACTTCAC,11,5040110
ykgRp,8.666666666666666,27,2,AAACGCGGTAGGGTGCAAAA,25,5054763
ykgRp,0.6666666666666666,3,2,AAACCCATTCGGATAAAGAT,1,5036517
ykgRp,3.0,10,2,AAAAGCGGGCTCGTCCTTGT,8,5042816
ykgRp,9.0,18,1,TTTTGGGATATGTCCGAATA,17,5038999
ykgRp,1.0,2,1,TTTGGAAGCATCAGTACCAG,1,5033208
ykgRp,8.5,17,1,TTTCAGCACCATCGGAGAGG,16,5044185
ykgRp,3.5,7,1,TTTATTTGCTATTCGGGTTG,6,5037814
ykgRp,16.0,32,1,TTTATCACGTTTCGTCCATC,31,5042209
ykgRp,8.5,17,1,TTTATCAATGGTCACCACTG,16,5058345
ykgRp,7.5,15,1,TTGGTATCTACAAATCTCAT,14,5044503
ykgRp,4.5,9,1,TTGACGACCCCAGCCACCTC,8,5048276
ykgRp,1.0,2,1,TTCGGCGACGTCACTCAGGC,1,5036537
ykgRp,8.5,17,1,TTCACTTGGGATGAGAATCC,16,5035016
ykgRp,4.0,8,1,TTATGCGGATAATGATATGC,7,5034020
ykgRp,12.5,25,1,TTAGCTTAAAGGCCAGAATA,24,5034800
ykgRp,1.0,2,1,TTACCTCCTAACCGGCCAGT,1,5032570
ykgRp,8.0,16,1,TTAAAACGCGAGACCACATA,15,5040946
ykgRp,6.0,12,1,TGTTTGACACGCCGGCACGG,11,5037850
ykgRp,6.0,12,1,TGTTTATTGCTGTAGTAGAC,11,5052898
ykgRp,8.5,17,1,TGTTAAACGGGGAAGCAGTC,16,5059547
ykgRp,10.0,20,1,TGTGCTTTGGCCCATTGGAC,19,5047393
ykgRp,3.5,7,1,TGTCCGGATCAAGACCTACA,6,5037731
ykgRp,9.5,19,1,TGTCAATCTACAGAAGTGCG,18,5044786
ykgRp,19.0,38,1,TGGTAGTGAGAACAACGGGC,37,5046408
ykgRp,1.0,2,1,TGGAGGCTTAGGAGTGGTAG,1,5060481
ykgRp,2.5,5,1,TGCGTCTGTTTACAGAGGCT,4,5051374
ykgRp,8.5,17,1,TGCGAAGTCTCACAAATAGT,16,5051103
ykgRp,10.0,20,1,TGAGAACGTGGCATTTAGTA,19,5044548
ykgRp,10.0,20,1,TGAATCTCTGGGTACCCTTA,19,5052931
ykgRp,1.5,3,1,TGAAGGCAGTAACGGTTTCC,2,5038293
ykgRp,5.0,10,1,TGAACATGAGACACTCAACC,9,5037546
ykgRp,7.0,14,1,TCTCGATGAAATCAAGGCAT,13,5046405
ykgRp,18.5,37,1,TCTAAGACACCGAGGTCGCA,36,5033812
ykgRp,8.0,16,1,TCGTGACTACCTCTAGTCAT,15,5059565
ykgRp,9.5,19,1,TCCTGTTGAGCTTCGGAGAA,18,5061292
ykgRp,1.0,2,1,TCCTATGTACGAGGACCCAC,1,5031621
ykgRp,15.5,31,1,TATGCCTTAAAGGACTCTTA,30,5043788
ykgRp,7.5,15,1,TATGACAGTGATTATAGTTT,14,5049491
ykgRp,8.0,16,1,TACTCGCTGCGTTGGCGGGG,15,5057895
ykgRp,16.5,33,1,TACGAGCAGCGGCTGCCTAG,32,5055261
ykgRp,13.5,27,1,TAATTGTCTATGCACAGCAA,26,5040942
ykgRp,18.0,36,1,TAATGTGTACTGATGTCACT,35,5061172
ykgRp,1.0,2,1,TAAGGTATAGTCTACACCCT,1,5042920
ykgRp,21.5,43,1,TAACTATTCGTCGGTTCAAG,42,5056784
ykgRp,1.0,2,1,TAAAGGCGAATCGTTTTGGA,1,5044732
ykgRp,3.0,6,1,GTTTGGGGGTGCAAACTTTA,5,5036980
ykgRp,3.5,7,1,GTTGGCGGCCTAGAGCCCTT,6,5047570
ykgRp,10.5,21,1,GTTAGTAGCCACCATATCTA,20,5048674
ykgRp,1.0,2,1,GTTACCCCGGTACGGGCTGG,1,5061341
ykgRp,1.0,2,1,GTGAGGTAGAGCCAAAGACT,1,5043458
ykgRp,7.0,14,1,GTCGTACACTGGGATGACCC,13,5059098
ykgRp,1.0,2,1,GTCGCACTCCTGGCGCTCAG,1,5038714
ykgRp,9.5,19,1,GTCCGCGATCGGAGAGTGAA,18,5041535
ykgRp,16.5,33,1,GTATTGACCTCCCGCGCCCA,32,5044536
ykgRp,1.0,2,1,GTAGCATAGACCCGTACAGT,1,5040156
ykgRp,23.0,46,1,GTAAATTAATAAGAAATGGA,45,5036701
ykgRp,9.0,18,1,GGTGAGCAGCGAGCGACCAC,17,5044352
ykgRp,7.5,15,1,GGTCGATATATACTAACCCG,14,5047429
ykgRp,12.0,24,1,GGTAGGCTGTGGCGCATAGT,23,5055002
ykgRp,11.5,23,1,GGCGTACCTCTTTTTCATAA,22,5048925
ykgRp,24.0,48,1,GGCCAACGGCACGCTGCCGC,47,5047037
ykgRp,3.0,6,1,GGACTCAGGATTACGGCTGA,5,5054848
ykgRp,39.5,79,1,GCGTCAGAGAAACCGTATGA,78,5061559
ykgRp,2.5,5,1,GCGTAATTGGGCGCGACGTT,4,5033788
ykgRp,18.5,37,1,GCGGTTAGTTGCCTATCTCT,36,5044720
ykgRp,18.0,36,1,GCGGGCTTACGGATGGAGCA,35,5058801
ykgRp,9.5,19,1,GCCTTTTGCACTTGATAAAG,18,5057891
ykgRp,6.5,13,1,GCCTTTTCGTCGCTGGCAAT,12,5037695
ykgRp,3.0,6,1,GCCGTTAACCGCAGATCACA,5,5060503
ykgRp,10.5,21,1,GCCGGGGCAAGCTCGGCGCT,20,5061354
ykgRp,10.5,21,1,GCCCGGAAAGGGTTGCGTTT,20,5056585
ykgRp,13.5,27,1,GATGTTGTCTCCGTTGATGT,26,5031729
ykgRp,1.0,2,1,GATGTAATATACAATTGCCT,1,5054885
ykgRp,12.0,24,1,GATGAAGTCCGTGGGAACAT,23,5060835
ykgRp,10.0,20,1,GATCATGTTAACCTGCTGGC,19,5051246
ykgRp,10.5,21,1,GAGTCTCATCCTGGGCCTCT,20,5041994
ykgRp,9.5,19,1,GAGGACGGTCCAGGTAAAGT,18,5049716
ykgRp,11.5,23,1,GACGACGCATCCGCTATACA,22,5056060
ykgRp,8.5,17,1,GACCGTGTTGCCTGACAGCG,16,5048227
ykgRp,1.0,2,1,GAATACAACTCTAGCGCGGT,1,5047539
ykgRp,2.5,5,1,CTTGACTAAATTCTCAGAGA,4,5034213
ykgRp,2.5,5,1,CTGGGACTGAACAGTTTCGA,4,5040446
ykgRp,1.5,3,1,CTCTATCAGATTAGATGATT,2,5039235
ykgRp,13.5,27,1,CTAGGTCTTACGATCGATCT,26,5060211
ykgRp,1.0,2,1,CTAGGAGAGGAACTAGCCGT,1,5059260
ykgRp,22.0,44,1,CGTTCACACCATGGTACGAG,43,5043534
ykgRp,4.5,9,1,CGTGCAGACAGGCCTCTACT,8,5047213
ykgRp,7.5,15,1,CGTCAGATCGTCTAAACCTG,14,5058897
ykgRp,6.5,13,1,CGGTGACTCCTGGTCGGCGG,12,5036454
ykgRp,1.5,3,1,CGGGCAGTTTGAGCGTACAT,2,5045920
ykgRp,1.0,2,1,CGGCAATAGCATGAACAGAG,1,5045247
ykgRp,11.0,22,1,CGGATATGATTTGGTATGGG,21,5061733
ykgRp,16.5,33,1,CGGAAGAACTTAAGTGACTT,32,5046130
ykgRp,11.5,23,1,CGCTACTCAGGAATAGTGTG,22,5032306
ykgRp,4.5,9,1,CGCCTTGGGCTTAGACCTTC,8,5045583
ykgRp,8.5,17,1,CGAGATACAAATTAGGTCCT,16,5057641
ykgRp,9.0,18,1,CCTCTCCCCCGCATAGAGGT,17,5042987
ykgRp,1.0,2,1,CCTAGCTGTGTGGCCTTGTA,1,5038196
ykgRp,6.5,13,1,CCGTCCCAAGGCAACCCGGT,12,5055424
ykgRp,7.5,15,1,CCGTAATTGACGCCCGGTTG,14,5056340
ykgRp,6.5,13,1,CCCTTCCGACAGCTCCTATT,12,5053997
ykgRp,14.0,28,1,CCCCTCGTGCACTGATAAAA,27,5060531
ykgRp,1.0,2,1,CCCCGGGGGGACGTAGGTAT,1,5045606
ykgRp,8.0,16,1,CCCATGGAGTATAAGATATT,15,5050411
ykgRp,21.5,43,1,CCCAACTGAACAGTTCCACT,42,5052718
ykgRp,1.5,3,1,CATTCCTAAGTGGACATTCT,2,5047557
ykgRp,9.0,18,1,CATTCCCATTTATGTGCTTA,17,5035476
ykgRp,1.0,2,1,CATCATGATTCGTGAACGTT,1,5036035
ykgRp,19.5,39,1,CATATGCCGGAAATAGATAG,38,5061120
ykgRp,1.0,2,1,CAGTATATATTGTTGCTCCG,1,5053096
ykgRp,7.0,14,1,CAGGAACCACCACCTTCCGT,13,5049906
ykgRp,8.5,17,1,CAGCCAAATAACTAACGAAT,16,5048098
ykgRp,9.0,18,1,CACTCGTGCTAAGCCCGTGG,17,5054084
ykgRp,10.0,20,1,CAAGGGCGTTAGGGTTAAGA,19,5052984
ykgRp,6.5,13,1,CAACCTACTTTAGAATAATG,12,5061274
ykgRp,1.0,2,1,CAACCACGTTCACGCTTAAA,1,5050677
ykgRp,8.5,17,1,ATTTTGTAATAGGGCTAGCT,16,5050157
ykgRp,2.5,5,1,ATTCTTCAGTAGAACACAGT,4,5037429
ykgRp,6.5,13,1,ATTCCCGTTGGAGGTCGGGT,12,5052251
ykgRp,5.0,10,1,ATGGCCCAAGATCCTGCGTA,9,5049679
ykgRp,7.5,15,1,ATGCTACATACAATTCGAAT,14,5040726
ykgRp,8.0,16,1,ATGCCCCTATTACTTTACAA,15,5047652
ykgRp,7.5,15,1,ATGCACATCGGTCCCGAGTT,14,5048519
ykgRp,3.0,6,1,ATCAAGAATATACGCTCCTC,5,5047370
ykgRp,1.0,2,1,ATATTGCTTAATCGGAAGAA,1,5033791
ykgRp,14.5,29,1,ATATGGGCTATAAAGAAGTT,28,5055775
ykgRp,6.0,12,1,ATAGGCTAATAAAGTCACTT,11,5050483
ykgRp,8.0,16,1,ATAGCAAGCTGACATCATGT,15,5038162
ykgRp,10.0,20,1,ATAGAACGGTAAAGCGGGTA,19,5057978
ykgRp,3.5,7,1,ATACGTGTTCCGAACTTCGT,6,5060370
ykgRp,11.5,23,1,ATACCGGGTATTTGTAGCGT,22,5056389
ykgRp,21.5,43,1,AGTTAATTAGCTGTTCTTGC,42,5061527
ykgRp,1.5,3,1,AGTCTTATCGGTACCCGCCG,2,5055679
ykgRp,3.5,7,1,AGTCCTACTGAATCTAGCTC,6,5038669
ykgRp,9.5,19,1,AGGCCTGCGGTTTTAGTTCT,18,5054036
ykgRp,4.0,8,1,AGCCGAAGTTGTTTCGTCCT,7,5053366
ykgRp,13.0,26,1,AGATGCAAAAATGTACTTAT,25,5033065
ykgRp,9.0,18,1,AGACGGGTACGGCGAGGGAT,17,5061597
ykgRp,1.0,2,1,AGACCCCACGCAGCCTTCAG,1,5034856
ykgRp,5.5,11,1,AGAATAAGGGTCACTATTTT,10,5037346
ykgRp,2.5,5,1,ACTGTTTCATTACAAGATCT,4,5057594
ykgRp,1.0,2,1,ACCTTGGGAGTTGTTCGGCG,1,5058943
ykgRp,10.5,21,1,ACCGTGTTTACATATGTGAG,20,5060237
ykgRp,1.0,2,1,ACCGCGCTTGTTTACGAGTC,1,5061380
ykgRp,2.5,5,1,ACCAAAAAAGTTAGGAGGGT,4,5053502
ykgRp,1.0,2,1,ACATGCTCCATAAGATAATG,1,5034125
ykgRp,12.5,25,1,ACAGAAACACCTCAAACATC,24,5048496
ykgRp,9.0,18,1,ACACGACGTCAGTAAGCCCG,17,5050695
ykgRp,1.0,2,1,ACAAGGTTTTGGGAGTGACG,1,5038950
ykgRp,1.0,2,1,AATTTGGCGCGGGTTCCTCC,1,5054859
ykgRp,1.5,3,1,AATCGTCGCATCATCGCCAC,2,5047509
ykgRp,1.0,2,1,AAGTGAGGTACACGGTGTTG,1,5032582
ykgRp,8.5,17,1,AAGCGGATCCTGCTGTCCTC,16,5054563
ykgRp,15.0,30,1,AAGATAACGTGGATTAGCAA,29,5046216
ykgRp,7.5,15,1,AACCCGGTTATCGGTCAAGT,14,5044675
ykgRp,5.5,11,1,AACCAGGCCTCCTTGGTCTG,10,5047559
ykgRp,12.5,25,1,AACCAAAGATGCTGTGGTAT,24,5053050
ykgRp,0.017543859649122806,56,56,CCATGCGGTGCGACAGCTAT,0,5041608
ykgRp,0.02631578947368421,37,37,AGGGTTCGCAACCGTGGACA,0,5032524
ykgRp,0.02702702702702703,36,36,ATGAATGACTGCGCTTCTCA,0,5057212
ykgRp,0.027777777777777776,35,35,CCAGGACATCCAACAACCTG,0,5034190
ykgRp,0.02857142857142857,34,34,TCCGCATCGAGAGAAATAGA,0,5052042
ykgRp,0.02857142857142857,34,34,GTAATTTGGCCGTGGTCGTT,0,5034544
ykgRp,0.02857142857142857,34,34,GTAAGCATCGCCTAGAACAG,0,5038652
ykgRp,0.02857142857142857,34,34,CGTAGCGGTTCAGCAAAGTC,0,5038091
ykgRp,0.02857142857142857,34,34,CACTGTTGATTCCGAGGGAA,0,5035778
ykgRp,0.02857142857142857,34,34,ACAGAGAGTGGACAAGCTAG,0,5031503
ykgRp,0.029411764705882353,33,33,TCCTGATGGGCGTATCTAGC,0,5042011
ykgRp,0.030303030303030304,32,32,GATCGGAAGTGTTAAAACGG,0,5036416
ykgRp,0.03125,31,31,TGCCCTTTCGGGCTCGCGCT,0,5035698
ykgRp,0.03125,31,31,ATTTTCTACCGTTAACCAAC,0,5040632
ykgRp,0.03225806451612903,30,30,CAACGGACTCGTTGATTTGA,0,5049283
ykgRp,0.03333333333333333,29,29,GACCCATTAGAGTCAATGGG,0,5042172
ykgRp,0.03333333333333333,29,29,ATTCTTGGTCTTCATAGACG,0,5044351
ykgRp,0.034482758620689655,28,28,TGGAAGCTAAGTACCGGGAA,0,5038631
ykgRp,0.034482758620689655,28,28,TAACGATTGGGTATCGATGC,0,5032034
ykgRp,0.034482758620689655,28,28,GGGATAGTGGAACAGGCCCT,0,5044493
ykgRp,0.034482758620689655,28,28,GCTACTGTGCTCACGCCCCA,0,5056992
ykgRp,0.034482758620689655,28,28,GATTCAGGATCGTAGCGGGT,0,5046708
ykgRp,0.034482758620689655,28,28,ATGTAATTACACCAGGGACA,0,5031647
ykgRp,0.034482758620689655,28,28,ATAGGTCACGAGTCGTCAGA,0,5052578
ykgRp,0.034482758620689655,28,28,AGGTTCCTAGGGATTGCCGG,0,5057588
ykgRp,0.034482758620689655,28,28,AGACCTTGCCTTAAAAGCAT,0,5033917
ykgRp,0.03571428571428571,27,27,GTAGACGACCTGAATCGCAT,0,5036305
ykgRp,0.03571428571428571,27,27,GGCGACGAGGCACGTATTTA,0,5044439
ykgRp,0.03571428571428571,27,27,GATAGAACTGAAGGCCGTCA,0,5031411
ykgRp,0.037037037037037035,26,26,TCGTGAAGTGAAGCTATGCA,0,5050412
ykgRp,0.037037037037037035,26,26,CTCGGGCATTAACCTCCTGC,0,5035983
ykgRp,0.037037037037037035,26,26,CGAAGTGTTGGCAAGAAAGG,0,5037854
ykgRp,0.037037037037037035,26,26,CACTGCCGATCGAACTTCGA,0,5036346
ykgRp,0.037037037037037035,26,26,AGGGCCACAGAAGATAAACT,0,5033417
ykgRp,0.037037037037037035,26,26,AGATAGTGGTGTGCCCTAAC,0,5038343
ykgRp,0.038461538461538464,25,25,TTCGCCACAATGATGAGCTA,0,5051849
ykgRp,0.038461538461538464,25,25,TGCTAGTACCCTACAACGCT,0,5044337
ykgRp,0.038461538461538464,25,25,GACCTGCGTACTCGGGGGGA,0,5034774
ykgRp,0.038461538461538464,25,25,GACCCGGTCGGGACGCTGCT,0,5040905
ykgRp,0.038461538461538464,25,25,CCCGAACCTACTCTTGCGCT,0,5040744
ykgRp,0.038461538461538464,25,25,CAGCGCAGTGGAGAAATGGG,0,5037223
ykgRp,0.038461538461538464,25,25,ATTACATGAAATGTGACCAT,0,5042858
ykgRp,0.04,24,24,TCCGAGCTCATTGTTAGCCC,0,5040275
ykgRp,0.04,24,24,CTGTGTCATCGGGTCGAAGC,0,5031883
ykgRp,0.04,24,24,CGTATCTTGTATCGGAGGGA,0,5040791
ykgRp,0.04,24,24,CCCCGATGCCCCGACAGATA,0,5043083
ykgRp,0.04,24,24,CCACCACTATCTGAATCTGG,0,5047939
ykgRp,0.04,24,24,CAGCGTACATTAAACACAAA,0,5042254
ykgRp,0.04,24,24,AGGGTTCGGCACGCATAGCT,0,5051613
ykgRp,0.04,24,24,AGAGTGGAGTACACTTATGA,0,5036482
ykgRp,0.04,24,24,ACATGCGTGGAAAGGATGGT,0,5059409
ykgRp,0.04,24,24,AAACACATGGTATGATGTTA,0,5043558
ykgRp,0.04,24,24,AAAACTTGTCTAACGTCTAT,0,5032633
ykgRp,0.041666666666666664,23,23,GTCGCATTGTAGGATTTTGC,0,5042453
ykgRp,0.041666666666666664,23,23,GGTTGCACGTTGCTGATCGT,0,5036567
ykgRp,0.041666666666666664,23,23,GGTGCAGCTATTTAGTACTT,0,5055205
ykgRp,0.041666666666666664,23,23,GCGGATAGCGTCGTCCTTTA,0,5035050
ykgRp,0.041666666666666664,23,23,GCGCCTTGCTGTGTGGCCTT,0,5047873
ykgRp,0.041666666666666664,23,23,CGATCGTTACTGGTGTTACA,0,5034028
ykgRp,0.041666666666666664,23,23,CCGCGGGCACTACACTCCCG,0,5040301
ykgRp,0.041666666666666664,23,23,CCAGGGCTATCGGCTGGTCC,0,5058581
ykgRp,0.041666666666666664,23,23,CATTAGGAGTAGCAACTTCT,0,5041247
ykgRp,0.041666666666666664,23,23,CAAGATCGTATTAAAGTTCA,0,5032666
ykgRp,0.041666666666666664,23,23,ATTTGCGCGAACGGTGATAT,0,5046710
ykgRp,0.041666666666666664,23,23,ATAAGCAGGATCGTTCCTCA,0,5032360
ykgRp,0.041666666666666664,23,23,AGACTGGGTGGCTACTCGCA,0,5036737
ykgRp,0.041666666666666664,23,23,ACTGCGGTGATATGCATCTG,0,5052405
ykgRp,0.041666666666666664,23,23,AAACAATCGGTTTTCTGCGA,0,5054214
ykgRp,0.043478260869565216,22,22,TTAGATCGACGAGTCTCGCC,0,5049923
ykgRp,0.043478260869565216,22,22,TCGGGTCCGTTGGCTGGAAG,0,5036883
ykgRp,0.043478260869565216,22,22,TCGACTTCTGGTGCTACGCA,0,5050971
ykgRp,0.043478260869565216,22,22,TCAACCAAGTCACACCCATT,0,5039566
ykgRp,0.043478260869565216,22,22,TAAATTTCATATCGGTCTGA,0,5047935
ykgRp,0.043478260869565216,22,22,GTTCTGGCGAGACGGTTCGT,0,5046225
ykgRp,0.043478260869565216,22,22,GTGCATATTGCGTAGTCGCC,0,5058724
ykgRp,0.043478260869565216,22,22,GTGAGTGAAGACATTCGGTT,0,5041275
ykgRp,0.043478260869565216,22,22,GGTGACCGCCAGACAGGTTA,0,5033116
ykgRp,0.043478260869565216,22,22,GGGGAACTTATGTCAGTCGT,0,5042394
ykgRp,0.043478260869565216,22,22,GATTATAGTCTGAACAGCGT,0,5039333
ykgRp,0.043478260869565216,22,22,CTGACGGTGATAGACACATG,0,5042059
ykgRp,0.043478260869565216,22,22,CTACTACAGGATTACACATA,0,5033027
ykgRp,0.043478260869565216,22,22,CTAACCGCACCTAGTATCCA,0,5049570
ykgRp,0.043478260869565216,22,22,CGATGGTCACAGGGTGTATA,0,5049306
ykgRp,0.043478260869565216,22,22,CCGGCCCGCGCACAACACGC,0,5054101
ykgRp,0.043478260869565216,22,22,CCATTGCAGGACAATATTAA,0,5041378
ykgRp,0.043478260869565216,22,22,ATTAAGCACAACGGCACTAA,0,5039479
ykgRp,0.043478260869565216,22,22,AGAGCAGTCATCATGGCAGG,0,5037525
ykgRp,0.043478260869565216,22,22,ACTCTCCTGAGTGGCTTGGT,0,5034581
ykgRp,0.043478260869565216,22,22,AATGGTGCGCATTTCACACT,0,5050918
ykgRp,0.045454545454545456,21,21,TGGTGTCACTGAATTCCGCA,0,5041513
ykgRp,0.045454545454545456,21,21,TATACTGGGCGGTTTCCCGG,0,5043485
ykgRp,0.045454545454545456,21,21,TAGGGCAGCGATGATAGACG,0,5033369
ykgRp,0.045454545454545456,21,21,TAATGCTCTTTTACATTTTT,0,5039919
ykgRp,0.045454545454545456,21,21,GTGTAGCATGGGCTCAACCA,0,5048140
ykgRp,0.045454545454545456,21,21,GTAAAAACTTTGTAGCAGCT,0,5034187
ykgRp,0.045454545454545456,21,21,GGGCTCAGCACTGACTAAGC,0,5034573
ykgRp,0.045454545454545456,21,21,GGAGTATTGCCTGATTTGTT,0,5036914
ykgRp,0.045454545454545456,21,21,GCCACCAGAGGACCTGATAA,0,5053330
ykgRp,0.045454545454545456,21,21,GCATGAAAGGGCAACAGTGA,0,5032667
ykgRp,0.045454545454545456,21,21,GAGTGTATTGGAATTGCAGT,0,5055062
ykgRp,0.045454545454545456,21,21,CGGTCCCGGGACTAACCTAG,0,5034159
ykgRp,0.045454545454545456,21,21,CCTTCGGCTTAAAAGTCGTT,0,5041810
ykgRp,0.045454545454545456,21,21,CAACCTACCGAAACGCTCTG,0,5032746
ykgRp,0.045454545454545456,21,21,ATGCACGGTTGCCATAGTTG,0,5039906
ykgRp,0.045454545454545456,21,21,ATCGGAGGCTACATACTCTC,0,5042248
ykgRp,0.045454545454545456,21,21,AGACTGGGTCGGAACTTGGA,0,5049101
ykgRp,0.045454545454545456,21,21,AGACGGATGTGATGTCCTAA,0,5055536
ykgRp,0.045454545454545456,21,21,ACAGAACGCTACGCAGTCAT,0,5044157
ykgRp,0.045454545454545456,21,21,AACAATGAATCGGGACCCAG,0,5053054
ykgRp,0.045454545454545456,21,21,AAATATGAGTTGTAAGGCAT,0,5035326
ykgRp,0.047619047619047616,20,20,TGGGGTGTGTCGCTGGCCCC,0,5049933
ykgRp,0.047619047619047616,20,20,TGAATTCAGCTTAACGTAGA,0,5056473
ykgRp,0.047619047619047616,20,20,TCATGCGAGTGACCAACTCG,0,5042679
ykgRp,0.047619047619047616,20,20,TCAAAGTCGGGATAAGACCA,0,5048092
ykgRp,0.047619047619047616,20,20,GTTTCTATGTGCATCCGGCA,0,5035487
ykgRp,0.047619047619047616,20,20,GTGGTTGACGTAACTAGCTA,0,5040404
ykgRp,0.047619047619047616,20,20,GGGATGCTGGTGCTGAGGAC,0,5033036
ykgRp,0.047619047619047616,20,20,GCTATATCCCGTTACATGAG,0,5051616
ykgRp,0.047619047619047616,20,20,GCCGGCAGATCGCTACAGGA,0,5035272
ykgRp,0.047619047619047616,20,20,GATTGCAAGGACGGTGTAGG,0,5046712
ykgRp,0.047619047619047616,20,20,GATCGTGTCAGCTGAGGCTA,0,5032605
ykgRp,0.047619047619047616,20,20,GATATTCATAGAACATGGAC,0,5048693
ykgRp,0.047619047619047616,20,20,CGGAATCGGTTGGCCCTGAG,0,5037484
ykgRp,0.047619047619047616,20,20,CAGTGGGTAGGGGGCAATTC,0,5034926
ykgRp,0.047619047619047616,20,20,CAAGACTAGGCCGTAACTAC,0,5031357
ykgRp,0.047619047619047616,20,20,ATGCTCGACCAAGTAATTTT,0,5036749
ykgRp,0.047619047619047616,20,20,ATCTGTAGAGCAATGTCCAA,0,5046345
ykgRp,0.047619047619047616,20,20,ATCGTTGGGCTATTGAGAAC,0,5046801
ykgRp,0.05,19,19,TTGGGGATGGGCGATTTATA,0,5058695
ykgRp,0.05,19,19,TTAGACAGGATTATTCCTAA,0,5032316
ykgRp,0.05,19,19,TGATGGCCTGTCGAGAAAAA,0,5048616
ykgRp,0.05,19,19,TATAACTACGACGGCCAGGG,0,5052846
ykgRp,0.05,19,19,TAAGCAACGGTACAGGCAGG,0,5037834
ykgRp,0.05,19,19,TAACCACAAAGGCGCTGAAA,0,5033015
ykgRp,0.05,19,19,GTCCCCGGAGAGAAGGTCGC,0,5040146
ykgRp,0.05,19,19,GTAACCCTGACTCCTCGCGT,0,5035421
ykgRp,0.05,19,19,GGACTCAAATAACATACGCT,0,5056431
ykgRp,0.05,19,19,GCTAGGAACTTTAACTCGAG,0,5047243
ykgRp,0.05,19,19,GCCATTGACTCGAGCGCGGC,0,5044154
ykgRp,0.05,19,19,GCAACCCTGCCCCATCTGTA,0,5055193
ykgRp,0.05,19,19,GACCCAAAAAGGCGAACCGT,0,5054933
ykgRp,0.05,19,19,CTTTTTAGCTACACCCATCT,0,5054027
ykgRp,0.05,19,19,CTGAGCTCAGAGGCTGCAAC,0,5055646
ykgRp,0.05,19,19,CGAGGCATAGGCGTTACCTC,0,5034520
ykgRp,0.05,19,19,CCATTAGGGGTAGCGTTAGA,0,5046436
ykgRp,0.05,19,19,CAACAGTAGGCCCTTGATGC,0,5042682
ykgRp,0.05,19,19,AGGGACAGCACGACGCATGG,0,5032876
ykgRp,0.05,19,19,ACCTAATCCCTTCAGCATGC,0,5033615
ykgRp,0.05,19,19,AAATTGCCTCCTTAGACAGT,0,5045423
ykgRp,0.05263157894736842,18,18,TTCCGAAGCCCCGATAGCCA,0,5040569
ykgRp,0.05263157894736842,18,18,TTAATAATTGAGGGAGGTGA,0,5045198
ykgRp,0.05263157894736842,18,18,TTAAAAGAAAACTTAGCGAT,0,5048250
ykgRp,0.05263157894736842,18,18,TGTGAGGAGCTTATTCGCAG,0,5053261
ykgRp,0.05263157894736842,18,18,TGTGAGATTAATGAAGTTAA,0,5038724
ykgRp,0.05263157894736842,18,18,TCTCCCGGGGGACACTGGAT,0,5035484
ykgRp,0.05263157894736842,18,18,TAGAGTATACAAGAGGCATA,0,5047302
ykgRp,0.05263157894736842,18,18,TACGCAATCCTCGCGTGGAA,0,5042134
ykgRp,0.05263157894736842,18,18,GTTCTTACGTGGGGGTTACA,0,5033114
ykgRp,0.05263157894736842,18,18,GTCGATGCCACTACTGATAC,0,5042950
ykgRp,0.05263157894736842,18,18,GTCAGCCTGGCGGTTCTCGG,0,5035169
ykgRp,0.05263157894736842,18,18,GGCTGGATGTACGGTCTTAT,0,5037812
ykgRp,0.05263157894736842,18,18,GGCTAACGGGGCCAGGGGGT,0,5037054
ykgRp,0.05263157894736842,18,18,GGAAAGCGTGAGGACCATCT,0,5055919
ykgRp,0.05263157894736842,18,18,GCGACCGTGCTGTAGCAGAG,0,5044228
ykgRp,0.05263157894736842,18,18,GATGTCGCCGTGATACCGCT,0,5056121
ykgRp,0.05263157894736842,18,18,GATAAATGCTTGGACTGCTC,0,5045036
ykgRp,0.05263157894736842,18,18,GAGTCGAAGTGTTACATCAG,0,5051213
ykgRp,0.05263157894736842,18,18,GAGCGGATTGGCATTCCAGC,0,5041065
ykgRp,0.05263157894736842,18,18,CTGGTTTTATATCTCGGCTA,0,5037643
ykgRp,0.05263157894736842,18,18,CGTTGATGGCAGTGTCGTCT,0,5039220
ykgRp,0.05263157894736842,18,18,CGTCATTTCGTCATGCTATG,0,5050357
ykgRp,0.05263157894736842,18,18,CCAGTTACGGAACATCACGT,0,5035957
ykgRp,0.05263157894736842,18,18,CAGCGGGTGTGGTTTCTTAT,0,5054564
ykgRp,0.05263157894736842,18,18,CAAGACCACGTGAACGCAGC,0,5060875
ykgRp,0.05263157894736842,18,18,CAACGCAACCCCCTGGACTC,0,5056609
ykgRp,0.05263157894736842,18,18,ATTATGACCGGGGTACTCCA,0,5041470
ykgRp,0.05263157894736842,18,18,AGTTGGCCTGTGTTAGCGAT,0,5046426
ykgRp,0.05263157894736842,18,18,AGCGCCTGTCTCATAGAAAA,0,5042624
ykgRp,0.05263157894736842,18,18,ACTCGCGTCATACAGGGGCA,0,5055937
ykgRp,0.05263157894736842,18,18,ACGAATTCAGTTATTTTGAT,0,5057339
ykgRp,0.05263157894736842,18,18,ACCTTGACGGAAGCTACACA,0,5059641
ykgRp,0.05263157894736842,18,18,ACAGTACCCCGACATATAAA,0,5040944
ykgRp,0.05263157894736842,18,18,AAATAAGGGCACTGGCTAGT,0,5032420
ykgRp,0.05555555555555555,17,17,TTTGGAATCGCTCTATGGTA,0,5033315
ykgRp,0.05555555555555555,17,17,TTGCGAAGACAAGCATTTGA,0,5038261
ykgRp,0.05555555555555555,17,17,TGTGGAAGAGTAAAACGTAA,0,5032176
ykgRp,0.05555555555555555,17,17,TCTATGTCCTCGGTGCTGCA,0,5046941
ykgRp,0.05555555555555555,17,17,TCGCGGTGGTTGCTCTAAGT,0,5032443
ykgRp,0.05555555555555555,17,17,TCCGTTGCACAAATGACGGC,0,5054397
ykgRp,0.05555555555555555,17,17,GTTTGGGTTATGAGTATAGA,0,5050429
ykgRp,0.05555555555555555,17,17,GTGTAACCGCATGGGGAGGC,0,5032331
ykgRp,0.05555555555555555,17,17,GTGCAGGTCTGGCGAATTAG,0,5031683
ykgRp,0.05555555555555555,17,17,GTCCCTTTGTTGCCCTTCTG,0,5043150
ykgRp,0.05555555555555555,17,17,GTATACTGTGCTTTGTGTTT,0,5041344
ykgRp,0.05555555555555555,17,17,GGGCGGGTGGCGGCACCATA,0,5036621
ykgRp,0.05555555555555555,17,17,GGCACATAAAACTGATCGTT,0,5041648
ykgRp,0.05555555555555555,17,17,GCGTCGTCGTGAGATGTGAG,0,5050175
ykgRp,0.05555555555555555,17,17,GCCCAGCAAGCTGTCTGATA,0,5040233
ykgRp,0.05555555555555555,17,17,GCATTGTTTCCCATACCGTA,0,5040232
ykgRp,0.05555555555555555,17,17,GAGTGGATAACTCCAGGGCT,0,5049007
ykgRp,0.05555555555555555,17,17,GACCAACGTCGAGCGCACTT,0,5034904
ykgRp,0.05555555555555555,17,17,GAAGCCTTTCGGAGGCGGCA,0,5054080
ykgRp,0.05555555555555555,17,17,CGTCATAACCGGAGACAAAT,0,5056661
ykgRp,0.05555555555555555,17,17,CGTATGGATCTAGTACGAAC,0,5034873
ykgRp,0.05555555555555555,17,17,CGGAGGGTCCTTCAGTAGAA,0,5049149
ykgRp,0.05555555555555555,17,17,CGCTGCCCGGCAGTCTCGAT,0,5048486
ykgRp,0.05555555555555555,17,17,CGACACTGGACATGTTTCAT,0,5049128
ykgRp,0.05555555555555555,17,17,CCCGCCTTTTGGACAGCACG,0,5044916
ykgRp,0.05555555555555555,17,17,ATTAAGATTGATAAGCAGCT,0,5058092
ykgRp,0.05555555555555555,17,17,ATTAAAGCGTGCGCGTGGAT,0,5041515
ykgRp,0.05555555555555555,17,17,AGGCGTGTTGTCTAAGGGCT,0,5037110
ykgRp,0.05555555555555555,17,17,ACCTGGTCTAGGCAAGCCAG,0,5034614
ykgRp,0.05555555555555555,17,17,ACCTGGGCCTAGGAATTATT,0,5051521
ykgRp,0.05555555555555555,17,17,AAGCCGACGAGTCGTCTTGT,0,5041248
ykgRp,0.05555555555555555,17,17,AAACATATTGCTTTACGAAA,0,5051852
ykgRp,0.058823529411764705,16,16,TTTTGTAACTCCTGATATCA,0,5045674
ykgRp,0.058823529411764705,16,16,TTGTCGGAATAAAGGTACAT,0,5040240
ykgRp,0.058823529411764705,16,16,TTATCGTGGTAAGCTATACT,0,5047832
ykgRp,0.058823529411764705,16,16,TTATAAACCATGAGCCCGTA,0,5040975
ykgRp,0.058823529411764705,16,16,TGTACATGTAGAGGGCCTAA,0,5034773
ykgRp,0.058823529411764705,16,16,TGGTAAGTAGTTACCCTGTG,0,5037994
ykgRp,0.058823529411764705,16,16,TGCGAAGCGCGGAGGCCACG,0,5036182
ykgRp,0.058823529411764705,16,16,TCGAAGGTGACGGGCTGATC,0,5056366
ykgRp,0.058823529411764705,16,16,TACTCAGTATACAAATTATA,0,5056090
ykgRp,0.058823529411764705,16,16,TAAGCTAGACTATCCGGCGG,0,5036071
ykgRp,0.058823529411764705,16,16,TAAAAAGCCGTAGATCTCTA,0,5039273
ykgRp,0.058823529411764705,16,16,GTATGTATGCGGTTCGGGGA,0,5039019
ykgRp,0.058823529411764705,16,16,GGCCTGTTCATTTCCCGGTT,0,5031509
ykgRp,0.058823529411764705,16,16,GGACCTTCAGGGATCGAACT,0,5033517
ykgRp,0.058823529411764705,16,16,GCTATGGGAAGGGTGTTTTC,0,5034033
ykgRp,0.058823529411764705,16,16,GCCGCTTCCTCGAAAACTCG,0,5058269
ykgRp,0.058823529411764705,16,16,GAGCTTGGCGAAACTATAAT,0,5058467
ykgRp,0.058823529411764705,16,16,GACGCGTAAGGGCGGAGGTA,0,5051794
ykgRp,0.058823529411764705,16,16,GAAGGACTTAGCAATGGCGC,0,5037213
ykgRp,0.058823529411764705,16,16,CTTGAACATCGCTTGTTCAC,0,5049453
ykgRp,0.058823529411764705,16,16,CGTGATCACCTCCAAACTAC,0,5045110
ykgRp,0.058823529411764705,16,16,CGGGCTGAGCTGCCGGTAGG,0,5033459
ykgRp,0.058823529411764705,16,16,CGCAGTTACCTGCTGGCGAT,0,5033440
ykgRp,0.058823529411764705,16,16,CGATCGTCCGTCTTTGTCGC,0,5058531
ykgRp,0.058823529411764705,16,16,CGAGGTGGTGTCCGGTTCCA,0,5054670
ykgRp,0.058823529411764705,16,16,CATACATGTTCGGAGCGATA,0,5037198
ykgRp,0.058823529411764705,16,16,CATAAAAGAACGTCAGGAGC,0,5047410
ykgRp,0.058823529411764705,16,16,CAGGCTGGGATGCTCCGAAA,0,5041016
ykgRp,0.058823529411764705,16,16,CAGACAACGTAATTGTCCGG,0,5035547
ykgRp,0.058823529411764705,16,16,CACTCCGCGGGGGCTTTAAT,0,5031421
ykgRp,0.058823529411764705,16,16,ATATCCATCGGTGAGGGAAG,0,5048684
ykgRp,0.058823529411764705,16,16,ATAGGTGATGTACTGGTGCG,0,5058538
ykgRp,0.058823529411764705,16,16,AGTGTGGTATAAGAGGTGGG,0,5044937
ykgRp,0.058823529411764705,16,16,AGTATTGCGTATTCGCTCAC,0,5060099
ykgRp,0.058823529411764705,16,16,AGGTTAGCATGCGCACGTTA,0,5047058
ykgRp,0.058823529411764705,16,16,AGCTTCTGAGACAGGGCATT,0,5047838
ykgRp,0.058823529411764705,16,16,AGCTCATCAGACGCTAGCTG,0,5038860
ykgRp,0.058823529411764705,16,16,AGATGGGCACCGACTCAAAC,0,5036864
ykgRp,0.058823529411764705,16,16,ACTCTAAGAAAGGGCGACGG,0,5053351
ykgRp,0.058823529411764705,16,16,ACTCCGCGTAACGTAATATT,0,5039730
ykgRp,0.058823529411764705,16,16,ACCTTTACTAATTCCAGCAT,0,5047954
ykgRp,0.058823529411764705,16,16,ACAGCTGTCGGTACGTTTCG,0,5044167
ykgRp,0.058823529411764705,16,16,AATCATTTAACATTGGCAAT,0,5059322
ykgRp,0.058823529411764705,16,16,AAGTTTATCTGCATCTTGAT,0,5058500
ykgRp,0.058823529411764705,16,16,AAGGTAGGCCACCACTTACT,0,5057693
ykgRp,0.058823529411764705,16,16,AAATCACTGGCCCGTTTCGG,0,5044773
ykgRp,0.0625,15,15,TTGCTTACATTAGGGTTTAG,0,5041342
ykgRp,0.0625,15,15,TTCGAAATTTATTGCTTACA,0,5048355
ykgRp,0.0625,15,15,TTAGGTCTTCAGAAAGTTGT,0,5055127
ykgRp,0.0625,15,15,TTAGGCTTCTGAAGGGGCGC,0,5047400
ykgRp,0.0625,15,15,TTAATCGGGTCCCAAGGGCC,0,5056016
ykgRp,0.0625,15,15,TGTTAACTACTTACAACGAT,0,5047964
ykgRp,0.0625,15,15,TGTATAAGTACGTTAGAAAT,0,5044990
ykgRp,0.0625,15,15,TGGGATGGCTGGGGCGCCGA,0,5051744
ykgRp,0.0625,15,15,TGCGCTATGGGTAAGCTACG,0,5039268
ykgRp,0.0625,15,15,TCATAGAGGTATTCTGCGCG,0,5031932
ykgRp,0.0625,15,15,TCACGTATCCAGGGAAACCC,0,5054018
ykgRp,0.0625,15,15,TCAATTTTGAGGAAAGTACA,0,5051114
ykgRp,0.0625,15,15,TAACACCAAAGGTCTAGTTC,0,5055192
ykgRp,0.0625,15,15,GTGTCGCCGTTCGCCGAACA,0,5034933
ykgRp,0.0625,15,15,GTCATTACGGGGAATCCGGC,0,5053907
ykgRp,0.0625,15,15,GTACCCCATTTAGCAATTCA,0,5057055
ykgRp,0.0625,15,15,GGCCTCTTCACGAATGGAAT,0,5037948
ykgRp,0.0625,15,15,GCTTACTTGTAGCGACAGGG,0,5059007
ykgRp,0.0625,15,15,GCTGTTTGGAGAAAGATATG,0,5034100
ykgRp,0.0625,15,15,GCTCAAGATCGAATGGTGAC,0,5050787
ykgRp,0.0625,15,15,GCCTTTGTCATCGCGGGCAT,0,5050912
ykgRp,0.0625,15,15,GCACCGGGTCCTTGGTGGTA,0,5035716
ykgRp,0.0625,15,15,GATGTGAAATTGCAGAAGAT,0,5039452
ykgRp,0.0625,15,15,GATAAAAAGGGTAGTGTATG,0,5035558
ykgRp,0.0625,15,15,GAGCTCATCTCGAGTTCAGA,0,5046796
ykgRp,0.0625,15,15,GACAATGCTCAGTTGGGCTC,0,5040345
ykgRp,0.0625,15,15,CTTGCCTGTACGAGGTATAC,0,5058704
ykgRp,0.0625,15,15,CTTGATCCTAGAGACACGAG,0,5039310
ykgRp,0.0625,15,15,CTTCGCGCGAACCTGTGGAT,0,5032617
ykgRp,0.0625,15,15,CTGCTTGCGGGATCGCAGTT,0,5054752
ykgRp,0.0625,15,15,CTCAAGCAGGCCGTTTTAGT,0,5035309
ykgRp,0.0625,15,15,CTAAAAATCCAACCCGCTAC,0,5061422
ykgRp,0.0625,15,15,CGGCCACTGTGCAGGCTACC,0,5044684
ykgRp,0.0625,15,15,CCATCAGGTTAACATCAGAG,0,5047151
ykgRp,0.0625,15,15,CCACTATCACGCACGAGTTG,0,5040532
ykgRp,0.0625,15,15,CCAAATGAAGATTGTGAACA,0,5035275
ykgRp,0.0625,15,15,CAGGCACACTACGACATTTT,0,5049601
ykgRp,0.0625,15,15,CAGAACCATCATTGATGGCG,0,5055773
ykgRp,0.0625,15,15,CACTTTGGGATTGCAACCGG,0,5043000
ykgRp,0.0625,15,15,CAAGTTATACAGCGGCTTCG,0,5050250
ykgRp,0.0625,15,15,ATTTAGTCAACAATGGTTCT,0,5036110
ykgRp,0.0625,15,15,ATTGGAGTTGGTGTGCCCTC,0,5038265
ykgRp,0.0625,15,15,ATCTGGATCCGTCCAGGGGT,0,5036399
ykgRp,0.0625,15,15,ATCTGCAAACATCCCGATCT,0,5042907
ykgRp,0.0625,15,15,AGGCCACGGGTGGGTTCATA,0,5055491
ykgRp,0.0625,15,15,AGCCCACGGGCAAGACGGCT,0,5056388
ykgRp,0.0625,15,15,AGATCGCTATCCGCTCCTAG,0,5050466
ykgRp,0.0625,15,15,AGATAGCTTGCCCCCCGCAA,0,5037020
ykgRp,0.0625,15,15,AGAGTTGGGAGCACAGCTAT,0,5034599
ykgRp,0.0625,15,15,ACGGTCTTAGATACCACGGC,0,5039438
ykgRp,0.0625,15,15,AATCACACCCACGGTAGACT,0,5054739
ykgRp,0.0625,15,15,AACGCAGCGAACTGCTTCCC,0,5035515
ykgRp,0.0625,15,15,AAAGGCATATGATATCAGGC,0,5031763
ykgRp,0.06666666666666667,14,14,TTGTACGCCTGCCGGCAAAA,0,5041704
ykgRp,0.06666666666666667,14,14,TTCTCCCATCCCTCCGCGGC,0,5031860
ykgRp,0.06666666666666667,14,14,TTCCGCGGCCGCCTGGGGGA,0,5039781
ykgRp,0.06666666666666667,14,14,TTAATGTCTCCCGCGCGTCA,0,5047458
ykgRp,0.06666666666666667,14,14,TGTAGTATGAGGTAGCGCCC,0,5043379
ykgRp,0.06666666666666667,14,14,TGTACTCGTCGGCAACTGTT,0,5061634
ykgRp,0.06666666666666667,14,14,TGGGCGCCTAGACACGTGTT,0,5057951
ykgRp,0.06666666666666667,14,14,TGGATCATCTGCGGCAGCCG,0,5055277
ykgRp,0.06666666666666667,14,14,TGCGGCGTACCATAAGAAGA,0,5054082
ykgRp,0.06666666666666667,14,14,TCTAATGGCATCTCCCATTA,0,5037408
ykgRp,0.06666666666666667,14,14,TCGGCGGCCACGTTCGAATT,0,5058919
ykgRp,0.06666666666666667,14,14,TCCGATATAACATAGTCAAC,0,5040904
ykgRp,0.06666666666666667,14,14,TCAGCACTACCCAGTAGTGT,0,5037507
ykgRp,0.06666666666666667,14,14,TATCCTGTCACGGCGTTACA,0,5045418
ykgRp,0.06666666666666667,14,14,TAGCTGTCGAGATCTCACCC,0,5034989
ykgRp,0.06666666666666667,14,14,TAGCGATTGGTAAGCCCGCT,0,5040379
ykgRp,0.06666666666666667,14,14,TACTTAGTTCGCCCAACTTG,0,5057871
ykgRp,0.06666666666666667,14,14,TAATGCGTCTGAGAGCGAGA,0,5034367
ykgRp,0.06666666666666667,14,14,GTTTCAGCGTTGTCAATGCA,0,5047694
ykgRp,0.06666666666666667,14,14,GTTCAAGATCAAGCCGCTCG,0,5057380
ykgRp,0.06666666666666667,14,14,GTGCTCGTAGCTTAGTCACA,0,5059676
ykgRp,0.06666666666666667,14,14,GGTTCCTATGTACAGTGCTT,0,5033961
ykgRp,0.06666666666666667,14,14,GGTTCACCTCGAGGATCTAG,0,5041187
ykgRp,0.06666666666666667,14,14,GGGGTAAAGGTTAGGGGGAT,0,5046524
ykgRp,0.06666666666666667,14,14,GGCCACACGTCGCTTTGAGT,0,5053539
ykgRp,0.06666666666666667,14,14,GGATCCTTAGCGGAGATTAA,0,5040717
ykgRp,0.06666666666666667,14,14,GCTCCTACACGAGCAGCATG,0,5054816
ykgRp,0.06666666666666667,14,14,GCTAGGGTGTAGTAGCGTCC,0,5044980
ykgRp,0.06666666666666667,14,14,GCTAGGGGCAAAGTAACGGG,0,5037591
ykgRp,0.06666666666666667,14,14,GCGAGTAGAGACGGTCACGT,0,5053408
ykgRp,0.06666666666666667,14,14,GCATATTAACATGGTCTGAA,0,5038043
ykgRp,0.06666666666666667,14,14,GCACTTTAGTAAGGCCCCCT,0,5041375
ykgRp,0.06666666666666667,14,14,GAGTGGGCAGCAATGCAATT,0,5036478
ykgRp,0.06666666666666667,14,14,GAGGTGGTTGCGAAGCGTAG,0,5039865
ykgRp,0.06666666666666667,14,14,GAGCGCGAAAGCATTGTAGA,0,5050044
ykgRp,0.06666666666666667,14,14,GAGAGCTGTAATCATACTGG,0,5032161
ykgRp,0.06666666666666667,14,14,GAATGGCACTAGCTAGGGAA,0,5051968
ykgRp,0.06666666666666667,14,14,CTGTGCGAACGTGCACGCAG,0,5050553
ykgRp,0.06666666666666667,14,14,CTGAACCGCTCCCAGTCGCT,0,5059600
ykgRp,0.06666666666666667,14,14,CTATTATGGTAGACTGGATA,0,5050922
ykgRp,0.06666666666666667,14,14,CTAAATCTACCAGGTACGGA,0,5055785
ykgRp,0.06666666666666667,14,14,CGTTTTTAGTCCTTATGGAT,0,5040701
ykgRp,0.06666666666666667,14,14,CGTGGGAGTATTTTCGTCGC,0,5057104
ykgRp,0.06666666666666667,14,14,CGTGAGTGTCCCGGAATGCC,0,5056538
ykgRp,0.06666666666666667,14,14,CGGTCTCTAGACTGGTGGGT,0,5039515
ykgRp,0.06666666666666667,14,14,CGGCGAACGAACTTGCTGAT,0,5039981
ykgRp,0.06666666666666667,14,14,CGGATAACTTCCGGTGACTC,0,5044342
ykgRp,0.06666666666666667,14,14,CGCACACACGGGGTATAGCT,0,5035305
ykgRp,0.06666666666666667,14,14,CCGTCCAAGAAGTCATGGGC,0,5060590
ykgRp,0.06666666666666667,14,14,CCGCCAAGTCATTTAATGTA,0,5035880
ykgRp,0.06666666666666667,14,14,CCGCAGGATTCCGAGGTAAA,0,5045747
ykgRp,0.06666666666666667,14,14,CCGCACTAGGACCGACAGTT,0,5034522
ykgRp,0.06666666666666667,14,14,CCAATCCACGGCCATGAGCT,0,5055812
ykgRp,0.06666666666666667,14,14,CAGGCTATTTTACGAAGAGT,0,5037954
ykgRp,0.06666666666666667,14,14,CAGAATAGGCTCAAGAACGG,0,5033038
ykgRp,0.06666666666666667,14,14,CACGGCTGATCAGTGAGACA,0,5053628
ykgRp,0.06666666666666667,14,14,CAAAACTCGCGTAGTCTGAG,0,5035779
ykgRp,0.06666666666666667,14,14,ATTTCACCGTAGATCCACTT,0,5043103
ykgRp,0.06666666666666667,14,14,ATGTTCTTGCGCGTCGGTGA,0,5051523
ykgRp,0.06666666666666667,14,14,ATGGGGGGCGCAGGGACCAT,0,5059120
ykgRp,0.06666666666666667,14,14,ATCTTCCCTTACAACGACTT,0,5054324
ykgRp,0.06666666666666667,14,14,ATCTCAACAGTGCATCCGTC,0,5056134
ykgRp,0.06666666666666667,14,14,ATCAGCATAGCCTAGTCTCA,0,5034058
ykgRp,0.06666666666666667,14,14,ATAACCTCATAGATGGGTTA,0,5039548
ykgRp,0.06666666666666667,14,14,AGCCTCTAATTAGATATTCA,0,5043200
ykgRp,0.06666666666666667,14,14,AGATTTCTCATCGAAGTGTA,0,5044978
ykgRp,0.06666666666666667,14,14,AGAGGCCCAAGAGGAGCATA,0,5053008
ykgRp,0.06666666666666667,14,14,ACTAACGGGTCCGATGTACA,0,5054565
ykgRp,0.06666666666666667,14,14,ACGGTTATTTCCATTCGGCA,0,5053350
ykgRp,0.06666666666666667,14,14,ACGCTCCGTCAGTGACCCCC,0,5037848
ykgRp,0.06666666666666667,14,14,ACCTTTCAGTCTGCTGCTGT,0,5050170
ykgRp,0.06666666666666667,14,14,ACCCCTCCGGACGGCGTGCA,0,5040178
ykgRp,0.06666666666666667,14,14,ACCAGACCACACTGATAAGA,0,5061233
ykgRp,0.06666666666666667,14,14,AATCTGTTGACGCCAAAGCA,0,5040420
ykgRp,0.06666666666666667,14,14,AATAAGCCACCTCTCTTCAA,0,5054395
ykgRp,0.06666666666666667,14,14,AAGTTGGTTCTTGGCTAATA,0,5044974
ykgRp,0.06666666666666667,14,14,AAGAAGTGGTGCGTGCTCGA,0,5031818
ykgRp,0.06666666666666667,14,14,AACGGGGTGACACAACCTTA,0,5046889
ykgRp,0.07142857142857142,13,13,TTGCCCACCCGATGATCGTG,0,5049109
ykgRp,0.07142857142857142,13,13,TTGCAATGGGTATGGAGCAT,0,5054441
ykgRp,0.07142857142857142,13,13,TTCATCTTTAATTACTGTAA,0,5056990
ykgRp,0.07142857142857142,13,13,TTATAGAGGAGGCAGCCTCA,0,5042334
ykgRp,0.07142857142857142,13,13,TTAGATGGAACAGGTGGAGT,0,5036975
ykgRp,0.07142857142857142,13,13,TTAGAGGGAATTACCACGGT,0,5032637
ykgRp,0.07142857142857142,13,13,TTACGATGGGTTCTGCGGTA,0,5032971
ykgRp,0.07142857142857142,13,13,TGTCCACACTCGGGAGCGTA,0,5035745
ykgRp,0.07142857142857142,13,13,TGTAGACGTCCACAAACTTA,0,5032137
ykgRp,0.07142857142857142,13,13,TGGCTAATATCGAGACAAAC,0,5036620
ykgRp,0.07142857142857142,13,13,TGACACGCAGAGAGTGCACA,0,5054810
ykgRp,0.07142857142857142,13,13,TCTGGTGTAAAATTGTCCAG,0,5048103
ykgRp,0.07142857142857142,13,13,TCTATACATTAACATGCATT,0,5054083
ykgRp,0.07142857142857142,13,13,TCTAATGTGCAAAAGCGTCT,0,5033954
ykgRp,0.07142857142857142,13,13,TCGAAGTGACAGTAGGGCTG,0,5035422
ykgRp,0.07142857142857142,13,13,TCAGCGGGTCTTACGGTTAC,0,5040660
ykgRp,0.07142857142857142,13,13,TCACGGGGGGTCTGCTAACT,0,5035823
ykgRp,0.07142857142857142,13,13,TACTGTCAGCCAACGGTGGA,0,5059737
ykgRp,0.07142857142857142,13,13,TACGTGATAAGAGGGGTGCG,0,5037452
ykgRp,0.07142857142857142,13,13,TAATCTCCGTCCTTTGAACA,0,5041048
ykgRp,0.07142857142857142,13,13,TAAATTTAAATCTTTACCGA,0,5037097
ykgRp,0.07142857142857142,13,13,TAAAACGCGGCTATGGCACA,0,5045169
ykgRp,0.07142857142857142,13,13,GTGTTGGGGGTTACTGGATG,0,5051358
ykgRp,0.07142857142857142,13,13,GTGCAACGCCGGAAGGAGGT,0,5046002
ykgRp,0.07142857142857142,13,13,GTGACGGGGCTGCATGCTGT,0,5051420
ykgRp,0.07142857142857142,13,13,GTCTCGCCACCTCATGCGGC,0,5053722
ykgRp,0.07142857142857142,13,13,GTCATCTGACCGATATTGAA,0,5048790
ykgRp,0.07142857142857142,13,13,GTACACGCACTGTGAAAATG,0,5046814
ykgRp,0.07142857142857142,13,13,GGTTGGAATAGTGGATGTGC,0,5037061
ykgRp,0.07142857142857142,13,13,GGTGCGGTGGAGGCATAGGT,0,5051423
ykgRp,0.07142857142857142,13,13,GGGGGACTGGTACTTTGCTA,0,5035984
ykgRp,0.07142857142857142,13,13,GGGCATTTGCGAAAGTTCGT,0,5036831
ykgRp,0.07142857142857142,13,13,GGGCAGTCGTAGGCATACCA,0,5032682
ykgRp,0.07142857142857142,13,13,GGCGCCGAAGTGGTCCAGCT,0,5059648
ykgRp,0.07142857142857142,13,13,GGCCAGTTACTAATTCAGGT,0,5042440
ykgRp,0.07142857142857142,13,13,GGATACCGATCAAGCGCGCG,0,5045646
ykgRp,0.07142857142857142,13,13,GGACCAATCAGTTCCTCTGA,0,5034722
ykgRp,0.07142857142857142,13,13,GCGCTCAGCTAGTCACTGTC,0,5041841
ykgRp,0.07142857142857142,13,13,GCCTCAAAAGAGCTAGCATT,0,5059582
ykgRp,0.07142857142857142,13,13,GCCCAAGAGTGCGCCAACTT,0,5035400
ykgRp,0.07142857142857142,13,13,GCAGGTTTCCCGGGCTCATA,0,5047916
ykgRp,0.07142857142857142,13,13,GCAATCACGAACGGAAGGGG,0,5033873
ykgRp,0.07142857142857142,13,13,GCAAATGCGTATATGTTGTA,0,5038387
ykgRp,0.07142857142857142,13,13,GATACTGCAAGAGGCTGCTA,0,5051866
ykgRp,0.07142857142857142,13,13,GATACGGCTGCTTCCCGTAA,0,5036443
ykgRp,0.07142857142857142,13,13,GAGACCTAGTCGTCATGGAG,0,5053161
ykgRp,0.07142857142857142,13,13,GAATGATTATAGGGGATGGG,0,5042492
ykgRp,0.07142857142857142,13,13,GAACCTTGGGCCATGGTACT,0,5035323
ykgRp,0.07142857142857142,13,13,GAACCTGTTGTCGTTAGGTA,0,5052376
ykgRp,0.07142857142857142,13,13,CTTGTCTAAGCGTGTGTCAT,0,5040212
ykgRp,0.07142857142857142,13,13,CTGTCAGGCGTTAGTCGGAA,0,5036448
ykgRp,0.07142857142857142,13,13,CTCTTTCTGACAACCGAGTA,0,5034362
ykgRp,0.07142857142857142,13,13,CTAAAACCAATGACAAGCCA,0,5048447
ykgRp,0.07142857142857142,13,13,CGTCTGCCGGAACACCCTTT,0,5051990
ykgRp,0.07142857142857142,13,13,CGGTACCTCACCTCCGAGTC,0,5034022
ykgRp,0.07142857142857142,13,13,CGGCTCAACATTAAACTCGA,0,5040366
ykgRp,0.07142857142857142,13,13,CCGCAACAGATGCACGAGAA,0,5036573
ykgRp,0.07142857142857142,13,13,CCGAGTAGCGTTATAATATC,0,5052934
ykgRp,0.07142857142857142,13,13,CCCTTTTCAAGTTTCGACCA,0,5042607
ykgRp,0.07142857142857142,13,13,CCCGATCGACAGTTCGTAGA,0,5058868
ykgRp,0.07142857142857142,13,13,CCAGTCTTCGGTCTTGCGTA,0,5031886
ykgRp,0.07142857142857142,13,13,CCAGCACTATGGGATTTATG,0,5040143
ykgRp,0.07142857142857142,13,13,CATCAATGCATTCGCAATTG,0,5046230
ykgRp,0.07142857142857142,13,13,CATAACACGCTCACTCAAAG,0,5052260
ykgRp,0.07142857142857142,13,13,CAGTGCGGGCAGCCTAGGGA,0,5032719
ykgRp,0.07142857142857142,13,13,CAGCGAGGCCTAGTATTCAC,0,5054309
ykgRp,0.07142857142857142,13,13,CACATGAGAAAGACCAGCCC,0,5046341
ykgRp,0.07142857142857142,13,13,CACATACAGAAGGTTTACCT,0,5052736
ykgRp,0.07142857142857142,13,13,CAATCAGGGTTGAGAAATAG,0,5053001
ykgRp,0.07142857142857142,13,13,CAACTACGTTCTTTGAAAAG,0,5051453
ykgRp,0.07142857142857142,13,13,ATTTGCCAAGAAGATAAAGA,0,5035695
ykgRp,0.07142857142857142,13,13,ATTGTGCAAAAGATGCTCGA,0,5039195
ykgRp,0.07142857142857142,13,13,ATTGTAAACAGAATGTTAAG,0,5049006
ykgRp,0.07142857142857142,13,13,ATTCAACAGTATTTAGTCAT,0,5057399
ykgRp,0.07142857142857142,13,13,ATTAAGAAAGCTCTCCCCCG,0,5036327
ykgRp,0.07142857142857142,13,13,ATGAAGGACTCGAGATTGGG,0,5056938
ykgRp,0.07142857142857142,13,13,ATCTTCCGCTAAAAGGTTCT,0,5050102
ykgRp,0.07142857142857142,13,13,ATCGTAAACAGGCAGGCAGC,0,5032612
ykgRp,0.07142857142857142,13,13,ATACTAGGCTGGCTGACTGA,0,5052496
ykgRp,0.07142857142857142,13,13,AGTTTCTAGCCTATACAAAT,0,5035446
ykgRp,0.07142857142857142,13,13,AGTGTGGAGGCGATTCCCGA,0,5056844
ykgRp,0.07142857142857142,13,13,AGTGACACCGTGGAGTCTAC,0,5038131
ykgRp,0.07142857142857142,13,13,AGGCGGAATATGTCACTGGC,0,5050989
ykgRp,0.07142857142857142,13,13,AGGAGGGCAGGATTAACAGA,0,5059273
ykgRp,0.07142857142857142,13,13,AGGAGGCATGGCTGAGCCAA,0,5032745
ykgRp,0.07142857142857142,13,13,AGATCTAATTATGCCAGTAC,0,5056509
ykgRp,0.07142857142857142,13,13,AGATCAGGGGCTAATTGCCT,0,5051397
ykgRp,0.07142857142857142,13,13,AGACGTGGTCAACTCACAGT,0,5053472
ykgRp,0.07142857142857142,13,13,AGAAATTGTTGGGGTTTTAT,0,5038899
ykgRp,0.07142857142857142,13,13,ACTAACTGCAGCTACTGACC,0,5048348
ykgRp,0.07142857142857142,13,13,ACGGGTGTAGATTAGCTCCA,0,5046066
ykgRp,0.07142857142857142,13,13,ACGAACTGCCCTGTTGATGC,0,5049791
ykgRp,0.07142857142857142,13,13,ACCTACAGAGGGGAAAGCGC,0,5040434
ykgRp,0.07142857142857142,13,13,ACCAGCTTAGAGCGATTGCC,0,5058331
ykgRp,0.07142857142857142,13,13,ACACGACTCCTCCGACTAGC,0,5049272
ykgRp,0.07142857142857142,13,13,ACAAGGAGCGCATTGAATTA,0,5050311
ykgRp,0.07142857142857142,13,13,AATCAATCATGGGCGACGCG,0,5052344
ykgRp,0.07142857142857142,13,13,AATATATGACGGCGGCGCGA,0,5032591
ykgRp,0.07142857142857142,13,13,AATAAATAGTCTTTACCCAT,0,5033192
ykgRp,0.07142857142857142,13,13,AAGGGTGTCACATCGGATCT,0,5050426
ykgRp,0.07142857142857142,13,13,AAGCTGCGACTTCACCTGTC,0,5044229
ykgRp,0.07142857142857142,13,13,AAACCTGTGACTTGTACTCC,0,5056327
ykgRp,0.07692307692307693,12,12,TTTTGATAGAGCAACCTGCT,0,5042822
ykgRp,0.07692307692307693,12,12,TTTCGGCACGCATCGTGGCA,0,5046739
ykgRp,0.07692307692307693,12,12,TTGGTACAAACCGGGGCGAG,0,5044073
ykgRp,0.07692307692307693,12,12,TTCTGGCAGAAGCCGGAGTT,0,5038298
ykgRp,0.07692307692307693,12,12,TTCCGGCAGTACGTAGTTAG,0,5035128
ykgRp,0.07692307692307693,12,12,TTCCAGAGAGGATCTAGGGA,0,5044393
ykgRp,0.07692307692307693,12,12,TTATGGATACAAGAAATTAT,0,5034448
ykgRp,0.07692307692307693,12,12,TGTTAGTCATAGTACCTTGT,0,5059418
ykgRp,0.07692307692307693,12,12,TGTGGGAACAACAGTTCAAC,0,5034875
ykgRp,0.07692307692307693,12,12,TGTATGAAAGTCGCTTCCGT,0,5045675
ykgRp,0.07692307692307693,12,12,TGGTTTGCATACACGAATTC,0,5035233
ykgRp,0.07692307692307693,12,12,TGGTGGCTACGTGTCATTCT,0,5054100
ykgRp,0.07692307692307693,12,12,TGGCAAGGTCTCCAGTAACG,0,5055004
ykgRp,0.07692307692307693,12,12,TGCATGTTTGGTATCCAGGA,0,5039063
ykgRp,0.07692307692307693,12,12,TGATCATCGCAGCATTAATG,0,5033282
ykgRp,0.07692307692307693,12,12,TGAGTAATACCTGAGGGTTT,0,5035731
ykgRp,0.07692307692307693,12,12,TCTTTGTGCTGATTCATGGA,0,5031950
ykgRp,0.07692307692307693,12,12,TCTGCAGAAGATTGATCAGG,0,5032004
ykgRp,0.07692307692307693,12,12,TCGGCCGGCGTTCTTTAATA,0,5045578
ykgRp,0.07692307692307693,12,12,TCCTCCTGGATGAACAGCCC,0,5032367
ykgRp,0.07692307692307693,12,12,TCCGCGTAGGGCTAGGCAAT,0,5044389
ykgRp,0.07692307692307693,12,12,TCCCGCCGGTAGAGAACAAA,0,5050335
ykgRp,0.07692307692307693,12,12,TCCAGGTAGAAGTCCGAGCC,0,5054853
ykgRp,0.07692307692307693,12,12,TCACGACCGTGTTTACAATT,0,5051567
ykgRp,0.07692307692307693,12,12,TCAAAAGTATGGGGCCAAAG,0,5046878
ykgRp,0.07692307692307693,12,12,TAGGGTTGTTCCCAGCTCGG,0,5036735
ykgRp,0.07692307692307693,12,12,TAGGGTGGATTTCCCACGGA,0,5055651
ykgRp,0.07692307692307693,12,12,TAGAACATGTGGCTCATTCA,0,5042385
ykgRp,0.07692307692307693,12,12,TAAATTCAAACGATGGCACA,0,5040177
ykgRp,0.07692307692307693,12,12,GTTGGTGGGACGAGCCCTAT,0,5058255
ykgRp,0.07692307692307693,12,12,GTTCCAATTGTCGCACCCGG,0,5039480
ykgRp,0.07692307692307693,12,12,GTTCACCGGCCGTCCTAAGG,0,5042281
ykgRp,0.07692307692307693,12,12,GTGGCTTAACTTGCCTTCGA,0,5033058
ykgRp,0.07692307692307693,12,12,GTGCCCCCGGCGGCCTGGAA,0,5035658
ykgRp,0.07692307692307693,12,12,GTGAGCAGCCTATTTATAGC,0,5036561
ykgRp,0.07692307692307693,12,12,GTGACCATAGACAATGCTGT,0,5037477
ykgRp,0.07692307692307693,12,12,GTGAAGTTGTGCGTAATGAG,0,5037993
ykgRp,0.07692307692307693,12,12,GTCTAAGAAACAGCACAGAG,0,5032472
ykgRp,0.07692307692307693,12,12,GTCCTTTTTTCCTTTCCGCC,0,5052506
ykgRp,0.07692307692307693,12,12,GTCCGACTGTCGAGCTCTGA,0,5032142
ykgRp,0.07692307692307693,12,12,GTCAATACAGCATTGCATGT,0,5047406
ykgRp,0.07692307692307693,12,12,GTAGATTTTAGGTGTGGGGT,0,5042447
ykgRp,0.07692307692307693,12,12,GTAAATCAATACGGCTAGGG,0,5035163
ykgRp,0.07692307692307693,12,12,GGGTCGCCTGGGTCCCCGAC,0,5044750
ykgRp,0.07692307692307693,12,12,GGGTCCACAAAGTGGATACT,0,5033529
ykgRp,0.07692307692307693,12,12,GGGGTCTGTACCAATGTATT,0,5056515
ykgRp,0.07692307692307693,12,12,GGGGCGTAGTCAGGCTGTCC,0,5047697
ykgRp,0.07692307692307693,12,12,GGGCTGACCGCCCCAGAGGT,0,5040638
ykgRp,0.07692307692307693,12,12,GGCCTGCTCTCGTAGTTCCA,0,5052611
ykgRp,0.07692307692307693,12,12,GGCATGCATATACGCGAAAT,0,5045829
ykgRp,0.07692307692307693,12,12,GGATCTAGGGTCGAGAGCGG,0,5044778
ykgRp,0.07692307692307693,12,12,GGACACTGTACGACAATTTG,0,5039652
ykgRp,0.07692307692307693,12,12,GCTAGTTAGTGAATCAGGCA,0,5054876
ykgRp,0.07692307692307693,12,12,GCTACTGGCTTGATACGAGT,0,5037339
ykgRp,0.07692307692307693,12,12,GCGTGTCTGTCCCCTTCTGA,0,5034799
ykgRp,0.07692307692307693,12,12,GCGAAGGCCAGAAGGAAGGG,0,5043542
ykgRp,0.07692307692307693,12,12,GCCTCCGGCACTGGTGGGGT,0,5057382
ykgRp,0.07692307692307693,12,12,GCCGCGACTGTTTAAGTACT,0,5049543
ykgRp,0.07692307692307693,12,12,GCCGCCTCGCCTGGACGGCA,0,5037593
ykgRp,0.07692307692307693,12,12,GCCACGCCTAAGAGTCGTGA,0,5042482
ykgRp,0.07692307692307693,12,12,GCATTTTGCAGACAGGGTCA,0,5031946
ykgRp,0.07692307692307693,12,12,GCATTGCATGGATCTAGATA,0,5049168
ykgRp,0.07692307692307693,12,12,GCACGCCCGGCTCGTAATCA,0,5059543
ykgRp,0.07692307692307693,12,12,GATTTTGCTTTGCGCTGAAC,0,5039629
ykgRp,0.07692307692307693,12,12,GATTGGCATGTTCTCAGAAG,0,5032006
ykgRp,0.07692307692307693,12,12,GATAGTGTTAGCGTCGCTGG,0,5055306
ykgRp,0.07692307692307693,12,12,GATAGGAATCTATGTTGCTT,0,5058580
ykgRp,0.07692307692307693,12,12,GATAGAAACTAGCGTGAATA,0,5046586
ykgRp,0.07692307692307693,12,12,GAGTGGTTGACGCACAGAGC,0,5048909
ykgRp,0.07692307692307693,12,12,GAGGCGGGGATAAGATGATT,0,5034038
ykgRp,0.07692307692307693,12,12,GAGCCGAGGGGTGAATCCAC,0,5036216
ykgRp,0.07692307692307693,12,12,GAGAAGATATTGTAGAAGCT,0,5032412
ykgRp,0.07692307692307693,12,12,GAATCCACGTGTAATACAGA,0,5056168
ykgRp,0.07692307692307693,12,12,GAAGTGTCTTGACTTGATCG,0,5052592
ykgRp,0.07692307692307693,12,12,GAAGCGGTAACGCGGATCTA,0,5042126
ykgRp,0.07692307692307693,12,12,CTGTAGCCAAGCCCACTTGT,0,5035718
ykgRp,0.07692307692307693,12,12,CTCGTCCGGTACGTCCTGCA,0,5039982
ykgRp,0.07692307692307693,12,12,CTCGCCTCCGCGCAATGCGA,0,5049878
ykgRp,0.07692307692307693,12,12,CGTTTTAAGCGTAGCGATCA,0,5039299
ykgRp,0.07692307692307693,12,12,CGTGTAGGGCTGTTAAGGTT,0,5039335
ykgRp,0.07692307692307693,12,12,CGTGGCCCTGAAATAGAAGG,0,5056154
ykgRp,0.07692307692307693,12,12,CGTCTACGATTAACCTATAT,0,5049508
ykgRp,0.07692307692307693,12,12,CGGCTAAGGTGTATTGTCCA,0,5042024
ykgRp,0.07692307692307693,12,12,CGCCTCTCGCCACGTAGAAG,0,5034914
ykgRp,0.07692307692307693,12,12,CGCAACAGTGGCTACCGTTA,0,5058627
ykgRp,0.07692307692307693,12,12,CGATGAGCACTAGATGGGTA,0,5044775
ykgRp,0.07692307692307693,12,12,CCTGGGATAACGTTAAAGCA,0,5039992
ykgRp,0.07692307692307693,12,12,CCGTAAGGAAACATTATTGG,0,5054639
ykgRp,0.07692307692307693,12,12,CCGGTCCGATTATGATCAGA,0,5045112
ykgRp,0.07692307692307693,12,12,CCGCACTTCACCATCGCATA,0,5048685
ykgRp,0.07692307692307693,12,12,CCCGATCTACTCCTCTTATA,0,5047511
ykgRp,0.07692307692307693,12,12,CCCAGGCGACGCCGGCGACT,0,5048104
ykgRp,0.07692307692307693,12,12,CCATGCAAGGTAGAGCTCAC,0,5033141
ykgRp,0.07692307692307693,12,12,CCACATGAAGCGAGCAACAG,0,5053143
ykgRp,0.07692307692307693,12,12,CCAAATATGAAAGCCGCGGA,0,5054237
ykgRp,0.07692307692307693,12,12,CATCGCAACACGATTCAATC,0,5048728
ykgRp,0.07692307692307693,12,12,CAGGTATCCACTCGACCGAT,0,5051966
ykgRp,0.07692307692307693,12,12,CAGGGATAACCACTCAGCCG,0,5058768
ykgRp,0.07692307692307693,12,12,CAGCATTACAGGTCTGTCAC,0,5055287
ykgRp,0.07692307692307693,12,12,CACGTGGGTTACCCCGGGTT,0,5037244
ykgRp,0.07692307692307693,12,12,CACCTGGAAACTTGGGATGT,0,5057469
ykgRp,0.07692307692307693,12,12,CAATACAGTTTACAATCGGA,0,5057801
ykgRp,0.07692307692307693,12,12,CAACGCAGCCACCACTCGTT,0,5056818
ykgRp,0.07692307692307693,12,12,CAAACCGTTCACCATAGGGA,0,5047359
ykgRp,0.07692307692307693,12,12,ATGTAGAGCGCTTCATTCAA,0,5041686
ykgRp,0.07692307692307693,12,12,ATCGTCCAGCATCTCAATAA,0,5054815
ykgRp,0.07692307692307693,12,12,ATCGCCAAGAGTTATGAGGA,0,5049376
ykgRp,0.07692307692307693,12,12,ATCCAAGTCAGTCATGCAAA,0,5036219
ykgRp,0.07692307692307693,12,12,ATATACCCTCAGACCTCAGG,0,5040672
ykgRp,0.07692307692307693,12,12,ATACGATTCGAAGTCAGCAG,0,5044875
ykgRp,0.07692307692307693,12,12,AGTGAGGTACCCTCTATACA,0,5045381
ykgRp,0.07692307692307693,12,12,AGCCTGTTGTAACCGTATGA,0,5059780
ykgRp,0.07692307692307693,12,12,AGCCGATCGTGTAGTTGAGG,0,5054464
ykgRp,0.07692307692307693,12,12,AGCACTGGCATTTGGGCCAA,0,5044753
ykgRp,0.07692307692307693,12,12,AGAGGCAGGGTTGCCGGGTA,0,5048771
ykgRp,0.07692307692307693,12,12,ACTGCCGTACGAAGGTCGGA,0,5045304
ykgRp,0.07692307692307693,12,12,ACGTACATATCCGGTGCGTG,0,5033678
ykgRp,0.07692307692307693,12,12,ACGGGTAATGGCCAGGCAAC,0,5036993
ykgRp,0.07692307692307693,12,12,ACGGGCCAAAGGTTGACTTA,0,5054505
ykgRp,0.07692307692307693,12,12,ACCACAAACTAGCATTGACT,0,5040903
ykgRp,0.07692307692307693,12,12,ACCAATCCTCGGGGTAGTTC,0,5050281
ykgRp,0.07692307692307693,12,12,ACATGACCCCGATGCGGTCT,0,5057017
ykgRp,0.07692307692307693,12,12,ACAGTAGATACTCTCGCACC,0,5055547
ykgRp,0.07692307692307693,12,12,ACAGGGGGAATATGCGGCAG,0,5037608
ykgRp,0.07692307692307693,12,12,ACACGACAGATTGGCGTTCC,0,5039369
ykgRp,0.07692307692307693,12,12,ACAATGTTCTGGTCGGTTAC,0,5033828
ykgRp,0.07692307692307693,12,12,AATTGTGACGGGCCGGCGCC,0,5061359
ykgRp,0.07692307692307693,12,12,AAGTCTGTGAGTGATCGTTT,0,5035576
ykgRp,0.07692307692307693,12,12,AACTTGTAGAACGACATTAT,0,5048105
ykgRp,0.07692307692307693,12,12,AACGGAATGGAATGGCCCAT,0,5043852
ykgRp,0.07692307692307693,12,12,AACCGTGCACGTGGGAGTGT,0,5048530
ykgRp,0.07692307692307693,12,12,AACACGAGCGGCTAGTTTCA,0,5042873
ykgRp,0.07692307692307693,12,12,AACACACTGGAGAGAGTTGT,0,5056559
ykgRp,0.07692307692307693,12,12,AACAACGCCATTGGACAGGA,0,5044819
ykgRp,0.07692307692307693,12,12,AAACGTCGGCGCGTACGCTC,0,5033920
ykgRp,0.08333333333333333,11,11,TTTTGGAGAGAACAAAGTAG,0,5060383
ykgRp,0.08333333333333333,11,11,TTTGACGGGCGCCGGGGCCA,0,5046316
ykgRp,0.08333333333333333,11,11,TTGTTACCTCAGCCGAGCGC,0,5056023
ykgRp,0.08333333333333333,11,11,TTGTGGGTACACAGAAAGGG,0,5033353
ykgRp,0.08333333333333333,11,11,TTGGTCTCTTTCTACTCCCA,0,5059839
ykgRp,0.08333333333333333,11,11,TTGGGTTCCGAGACACATAG,0,5040598
ykgRp,0.08333333333333333,11,11,TTGAAGGCACTGCGTTTTGG,0,5037242
ykgRp,0.08333333333333333,11,11,TTCTCTCTTTTTCCTAATAA,0,5032224
ykgRp,0.08333333333333333,11,11,TTCTCGGGGTACGCGTTTAA,0,5044676
ykgRp,0.08333333333333333,11,11,TTATTCAGGCTATAGCTGTT,0,5034703
ykgRp,0.08333333333333333,11,11,TTACCCTCTTTCAAGGAGAG,0,5048885
ykgRp,0.08333333333333333,11,11,TGTTTGATCCATAGTTCCTA,0,5048162
ykgRp,0.08333333333333333,11,11,TGTTCCTAGTGAGGGACAGT,0,5050582
ykgRp,0.08333333333333333,11,11,TGTGAAGCTGAATCATTGTT,0,5044842
ykgRp,0.08333333333333333,11,11,TGTCGGATATATATGAAGGT,0,5046277
ykgRp,0.08333333333333333,11,11,TGTCATCTAGGACGAGGGAG,0,5048696
ykgRp,0.08333333333333333,11,11,TGTAGCAGTGTGAGCCTAGT,0,5046113
ykgRp,0.08333333333333333,11,11,TGGGTAGGTAGTACGCGTAA,0,5036818
ykgRp,0.08333333333333333,11,11,TGCTTGTTTTGGTATTCCAG,0,5043234
ykgRp,0.08333333333333333,11,11,TGATTGCAACGGGCGCTTAG,0,5034270
ykgRp,0.08333333333333333,11,11,TGAACCGGACGGCCGAATAA,0,5046322
ykgRp,0.08333333333333333,11,11,TCGTACGTTTGCCTTTATAT,0,5054264
ykgRp,0.08333333333333333,11,11,TCGCACAAAGCGCTATTGTG,0,5054451
ykgRp,0.08333333333333333,11,11,TCCAAATGATCTCCCTCTCA,0,5040198
ykgRp,0.08333333333333333,11,11,TCATGATGCTGCGGATAGAC,0,5049744
ykgRp,0.08333333333333333,11,11,TCAACACAAACAAACGCATA,0,5037197
ykgRp,0.08333333333333333,11,11,TATCGTCACGTCCACGCCTA,0,5043953
ykgRp,0.08333333333333333,11,11,TATCGTATGGACGATAAAAT,0,5034506
ykgRp,0.08333333333333333,11,11,TAGCTGTTGGGTAATCAGAA,0,5042325
ykgRp,0.08333333333333333,11,11,TACCCTATATACGCGCGCAG,0,5040834
ykgRp,0.08333333333333333,11,11,GTTAAGACGAAGGCCCTGAT,0,5044197
ykgRp,0.08333333333333333,11,11,GTGTCCCAGGAGAAAGCGGT,0,5039705
ykgRp,0.08333333333333333,11,11,GTGGGAAAATAGATCACTCA,0,5050205
ykgRp,0.08333333333333333,11,11,GTGCTTGAGGTCATTTGTGG,0,5033278
ykgRp,0.08333333333333333,11,11,GTGACGGGCGTGCACCTGAC,0,5038312
ykgRp,0.08333333333333333,11,11,GTATCGCGTGTTAGGAAAAA,0,5033127
ykgRp,0.08333333333333333,11,11,GTAAGGGTCCAAACAAGGTT,0,5053829
ykgRp,0.08333333333333333,11,11,GGTGTCGTCACAAATCTCTG,0,5041546
ykgRp,0.08333333333333333,11,11,GGTCGAGAATATCGAAGTAT,0,5054798
ykgRp,0.08333333333333333,11,11,GGGGTTCTTGTAGCAGACGC,0,5040767
ykgRp,0.08333333333333333,11,11,GGCTAGCATATCGTCCAGCC,0,5041195
ykgRp,0.08333333333333333,11,11,GGCGGTTTTCGTGATTTCAC,0,5040289
ykgRp,0.08333333333333333,11,11,GGCGATAGTCTGACTTGGGG,0,5033644
ykgRp,0.08333333333333333,11,11,GGCCGCGATCATCCGGTAAT,0,5039039
ykgRp,0.08333333333333333,11,11,GGATCGCATAGTAACCGACT,0,5036098
ykgRp,0.08333333333333333,11,11,GGAGTGCCCGTCCCTCTAGT,0,5057839
ykgRp,0.08333333333333333,11,11,GCTTTGAGACAATTTGATGA,0,5052955
ykgRp,0.08333333333333333,11,11,GCTCACGCTGGTTCCAGAAA,0,5049642
ykgRp,0.08333333333333333,11,11,GCGTTATACGTGGTGGGGCT,0,5034486
ykgRp,0.08333333333333333,11,11,GCCCAGCAAATACACGCCAT,0,5056756
ykgRp,0.08333333333333333,11,11,GCATACCTGACGTGTTGAAG,0,5055340
ykgRp,0.08333333333333333,11,11,GCACATAGGGCATGTATATG,0,5050040
ykgRp,0.08333333333333333,11,11,GATTGGCAGCTTTTTTGCAT,0,5035325
ykgRp,0.08333333333333333,11,11,GATCTCTAACTTGTAGTAGT,0,5053031
ykgRp,0.08333333333333333,11,11,GAGGGCTTGTTTAGAACGAT,0,5037990
ykgRp,0.08333333333333333,11,11,GAGAGTGGGGGAATCCAGTA,0,5041261
ykgRp,0.08333333333333333,11,11,GACTGCAGTGGTTCAGTGGA,0,5057108
ykgRp,0.08333333333333333,11,11,GAATATTGGCCTTGCGATCA,0,5039904
ykgRp,0.08333333333333333,11,11,GAATACTGCGTTCCTGTTAC,0,5044072
ykgRp,0.08333333333333333,11,11,CTTCTGACCTGTCCGCACTC,0,5031813
ykgRp,0.08333333333333333,11,11,CTGGCCCTCCTCGTCGTTGG,0,5051530
ykgRp,0.08333333333333333,11,11,CTGATTGCTACTGGCTTGAA,0,5037725
ykgRp,0.08333333333333333,11,11,CTGAGCATGTTCGGCCTAGA,0,5039497
ykgRp,0.08333333333333333,11,11,CTCTTTGCGTGAGTAGAGCT,0,5047662
ykgRp,0.08333333333333333,11,11,CTCGCGACAAAACGCAAGCG,0,5041926
ykgRp,0.08333333333333333,11,11,CTACAGCGAGAAGGTTACAT,0,5061577
ykgRp,0.08333333333333333,11,11,CTAAGGTAAAGGCCGGACGG,0,5045120
ykgRp,0.08333333333333333,11,11,CTAAACTCCTACTACATTAA,0,5034030
ykgRp,0.08333333333333333,11,11,CGTGGCGGCTAGGGACATGC,0,5037696
ykgRp,0.08333333333333333,11,11,CGTCTGACTAGACACTTTCT,0,5031898
ykgRp,0.08333333333333333,11,11,CGTATGTGCAGTCTGGGGAT,0,5046212
ykgRp,0.08333333333333333,11,11,CGGTCTTATCCACAGTGCGC,0,5034337
ykgRp,0.08333333333333333,11,11,CGGTCATAATTGACGGCCGG,0,5053755
ykgRp,0.08333333333333333,11,11,CGGGTATATGGTAGAGAAGG,0,5058651
ykgRp,0.08333333333333333,11,11,CGGCTGGAGCGATGGATCAG,0,5040832
ykgRp,0.08333333333333333,11,11,CGGAGGAATGGCGGCTCTAT,0,5038607
ykgRp,0.08333333333333333,11,11,CGGAAGGCAGCTTATTGTGA,0,5059879
ykgRp,0.08333333333333333,11,11,CGCGAGTGTTGACCTGCTGT,0,5049384
ykgRp,0.08333333333333333,11,11,CGCCGAGAACGCTTTTAAAG,0,5042896
ykgRp,0.08333333333333333,11,11,CGATATCCGCTATTTGTGGG,0,5040902
ykgRp,0.08333333333333333,11,11,CGAGGCCTTTCCGTCTGATC,0,5055743
ykgRp,0.08333333333333333,11,11,CGAAAAGTGTCCCACTTGGC,0,5054978
ykgRp,0.08333333333333333,11,11,CCTCTCGTCTTGTAACGCTG,0,5053231
ykgRp,0.08333333333333333,11,11,CCTCCGCAGTAATAGTCTGA,0,5047402
ykgRp,0.08333333333333333,11,11,CCGTCCACCCCTGGAACCGA,0,5038771
ykgRp,0.08333333333333333,11,11,CCGGGGCCTACCCGCGGCTC,0,5042732
ykgRp,0.08333333333333333,11,11,CCGGATGTTGTGTTGGCGCA,0,5049008
ykgRp,0.08333333333333333,11,11,CCGCGCGGTGCACTGAATAT,0,5042694
ykgRp,0.08333333333333333,11,11,CCCGAACGCAGAACTACGCC,0,5041944
ykgRp,0.08333333333333333,11,11,CCACTGCGTAATAGGCCCTA,0,5052647
ykgRp,0.08333333333333333,11,11,CCAACGCGACAACCAACACT,0,5033428
ykgRp,0.08333333333333333,11,11,CATAGGGGACCCGTGTAAGG,0,5041646
ykgRp,0.08333333333333333,11,11,CATAATCGGGGTTGGGACAT,0,5050144
ykgRp,0.08333333333333333,11,11,CATAACGTGTATAGCTGGTG,0,5053993
ykgRp,0.08333333333333333,11,11,CAGGCTCTCGGTCAGCGGTT,0,5048107
ykgRp,0.08333333333333333,11,11,CACTATTCAAGAAGTTCTAA,0,5031325
ykgRp,0.08333333333333333,11,11,CACGATGCCTCCGATACTGT,0,5042330
ykgRp,0.08333333333333333,11,11,CAATGAGCACAAATGGGTAA,0,5043457
ykgRp,0.08333333333333333,11,11,CAAGTGGGACCTTAATAGAG,0,5033623
ykgRp,0.08333333333333333,11,11,CAACGTGAAATAGGTGTCCC,0,5047182
ykgRp,0.08333333333333333,11,11,ATTGGGCAGTCTTTAGAGTC,0,5059568
ykgRp,0.08333333333333333,11,11,ATTCCCGTGCAGTAAAAGTC,0,5034903
ykgRp,0.08333333333333333,11,11,ATTATGTGAATCATGCGACT,0,5038987
ykgRp,0.08333333333333333,11,11,ATTAATACGCATGAGTGATC,0,5034458
ykgRp,0.08333333333333333,11,11,ATGAGGTCATACTTTCGACC,0,5059443
ykgRp,0.08333333333333333,11,11,ATGAGATTGAAACAAATTTC,0,5043387
ykgRp,0.08333333333333333,11,11,ATGAACTGCGACACCAGTAT,0,5040673
ykgRp,0.08333333333333333,11,11,ATGAACGAAGTTATAAAAGA,0,5058073
ykgRp,0.08333333333333333,11,11,ATCTTATCGCCCAACGTAAG,0,5038827
ykgRp,0.08333333333333333,11,11,ATCTAACTGGAAGCATCGTG,0,5056504
ykgRp,0.08333333333333333,11,11,ATCGGGAAGGGACATTTGTT,0,5037644
ykgRp,0.08333333333333333,11,11,ATCGACCGTCGATACATCAC,0,5044562
ykgRp,0.08333333333333333,11,11,ATCAATAGACTAATAGCAGT,0,5040297
ykgRp,0.08333333333333333,11,11,ATAGGCTTGCTAACTTCGCT,0,5047051
ykgRp,0.08333333333333333,11,11,AGTTCCTGCTGCGAGCCCGG,0,5044488
ykgRp,0.08333333333333333,11,11,AGTTAGGGAACCTATGCGTC,0,5036075
ykgRp,0.08333333333333333,11,11,AGTCGCCGGCGTGGGCAGGA,0,5033258
ykgRp,0.08333333333333333,11,11,AGTCGCACCTTGGGTCAGAT,0,5059672
ykgRp,0.08333333333333333,11,11,AGTAAATAATCAACCGATGC,0,5048483
ykgRp,0.08333333333333333,11,11,AGGTACCTGGGACGCATACA,0,5061727
ykgRp,0.08333333333333333,11,11,AGGGGTAGAGGAACATCAGT,0,5052652
ykgRp,0.08333333333333333,11,11,AGGGATAAGCTTGCAAGAGT,0,5044003
ykgRp,0.08333333333333333,11,11,AGGAGGTTCCGTCCGTGCCT,0,5054081
ykgRp,0.08333333333333333,11,11,AGCTATAGAAGTGCGTCCAT,0,5037684
ykgRp,0.08333333333333333,11,11,AGCGCGAAACTATATGTTGA,0,5054955
ykgRp,0.08333333333333333,11,11,AGCCTTACGGTTCAATTGTC,0,5060466
ykgRp,0.08333333333333333,11,11,AGCCCGGTGGTGAGTCAACA,0,5051181
ykgRp,0.08333333333333333,11,11,AGCATGAATCGAATGGCAGA,0,5053743
ykgRp,0.08333333333333333,11,11,AGAGTTAGTGACGTCATGCC,0,5036496
ykgRp,0.08333333333333333,11,11,AGAAAATTCATTTACGGCAA,0,5048991
ykgRp,0.08333333333333333,11,11,ACGGCTCGGTCGGTCGGCTC,0,5034672
ykgRp,0.08333333333333333,11,11,ACGCGCTCGCGTTCGTACAC,0,5032812
ykgRp,0.08333333333333333,11,11,ACGAATTCACCTGGCGCGAT,0,5032802
ykgRp,0.08333333333333333,11,11,ACCGTGCAGAGGGGCGCCCA,0,5031931
ykgRp,0.08333333333333333,11,11,ACCGCGTATTGGCCAGACTA,0,5039778
ykgRp,0.08333333333333333,11,11,ACCAGATTAGGTCGCCTCAA,0,5052349
ykgRp,0.08333333333333333,11,11,AATTAATATTCGCCACCATA,0,5037839
ykgRp,0.08333333333333333,11,11,AAGCATATGCGGAGGGAAGA,0,5050325
ykgRp,0.08333333333333333,11,11,AAGACCTGGGCTTACGAGAG,0,5045187
ykgRp,0.08333333333333333,11,11,AACTGCGGGTAGAAAATGGA,0,5056890
ykgRp,0.08333333333333333,11,11,AACGGTGCCTTCCATAAGGA,0,5058806
ykgRp,0.08333333333333333,11,11,AACCATGATATATTGGTGCG,0,5048396
ykgRp,0.08333333333333333,11,11,AAAGTCGTTCGGCTGTGATC,0,5042083
ykgRp,0.09090909090909091,10,10,TTTGGCATAACAATAGAAAT,0,5040344
ykgRp,0.09090909090909091,10,10,TTTGCTACACTCTAGTGTTA,0,5048955
ykgRp,0.09090909090909091,10,10,TTTAACCTGTAATGGCAGCC,0,5037908
ykgRp,0.09090909090909091,10,10,TTGTATGGGAGTCTGACTGG,0,5049720
ykgRp,0.09090909090909091,10,10,TTGGGGCTCAAGAGACAATA,0,5046757
ykgRp,0.09090909090909091,10,10,TTGGGCTACGAGGAGCGGAT,0,5051900
ykgRp,0.09090909090909091,10,10,TTGCGAGGTCTACTTGTCCA,0,5059210
ykgRp,0.09090909090909091,10,10,TTGCAGTGGGTTGCGAGTAA,0,5058589
ykgRp,0.09090909090909091,10,10,TTGAGGCATGCTACCCGAAC,0,5057270
ykgRp,0.09090909090909091,10,10,TTCGAAGCGACTTCACGATG,0,5032878
ykgRp,0.09090909090909091,10,10,TTATCATTTCACGGTATGAA,0,5037905
ykgRp,0.09090909090909091,10,10,TGTGGCAGGAGCTTTGAGGT,0,5056558
ykgRp,0.09090909090909091,10,10,TGTCTTTCACTGCGGATGGT,0,5054988
ykgRp,0.09090909090909091,10,10,TGTCCTGGTGAGCCATGGAA,0,5057876
ykgRp,0.09090909090909091,10,10,TGTCAAGAATTTGGTAAGTT,0,5053906
ykgRp,0.09090909090909091,10,10,TGTAGGCTTTTGTACAAGTT,0,5048491
ykgRp,0.09090909090909091,10,10,TGGTAGCCGCGATTGGTTTA,0,5042880
ykgRp,0.09090909090909091,10,10,TGGGGTCAAATGAAAGCCCA,0,5050469
ykgRp,0.09090909090909091,10,10,TGGGCCGTGGACCTAGGATT,0,5045984
ykgRp,0.09090909090909091,10,10,TGGCTCGACCTCAATCTTGG,0,5051615
ykgRp,0.09090909090909091,10,10,TGGAATTCTCAATCGCGGCA,0,5042472
ykgRp,0.09090909090909091,10,10,TGCTGCTACCCCGGGAAGGA,0,5044818
ykgRp,0.09090909090909091,10,10,TGCGGTTCCGCGTCATCGTA,0,5044976
ykgRp,0.09090909090909091,10,10,TGCCACCAATTGTCCCTCAA,0,5041196
ykgRp,0.09090909090909091,10,10,TGCCAAGCAGCATGGCGTCA,0,5051904
ykgRp,0.09090909090909091,10,10,TGATGGCGTCATCTGTGAGG,0,5033343
ykgRp,0.09090909090909091,10,10,TGAGTATCACGAATGTCCTC,0,5036162
ykgRp,0.09090909090909091,10,10,TGAGCCCGGCATCTGAGTCT,0,5046715
ykgRp,0.09090909090909091,10,10,TCGCACGCGCATTACTCATT,0,5044988
ykgRp,0.09090909090909091,10,10,TCCGCTGTCGGTAATATTGG,0,5054638
ykgRp,0.09090909090909091,10,10,TCCCTGCTCATGAGGGGAAT,0,5055148
ykgRp,0.09090909090909091,10,10,TCAGGTGACTGGTAACCATA,0,5039567
ykgRp,0.09090909090909091,10,10,TCAGGTAATTTATGAATTAG,0,5044649
ykgRp,0.09090909090909091,10,10,TCACTTGCGAAAAGTATGGG,0,5045805
ykgRp,0.09090909090909091,10,10,TCACAGAAGCACGGTAGGAG,0,5040196
ykgRp,0.09090909090909091,10,10,TATACGAGCTGCTGCAAGTC,0,5039624
ykgRp,0.09090909090909091,10,10,TAGGTGGTTATCGTTGAATG,0,5051327
ykgRp,0.09090909090909091,10,10,TAGCCACATTCAGTAAGAAG,0,5033906
ykgRp,0.09090909090909091,10,10,TACGAAGGCGAGCAGCACCT,0,5043084
ykgRp,0.09090909090909091,10,10,TACCTTGCAAGTAAGGCTTC,0,5050141
ykgRp,0.09090909090909091,10,10,TACCTAATTCTGACCAGCCT,0,5041310
ykgRp,0.09090909090909091,10,10,TAACATTGGATCGCCCCGCT,0,5046802
ykgRp,0.09090909090909091,10,10,GTTTTATTAGGGGTCACACT,0,5041346
ykgRp,0.09090909090909091,10,10,GTTGTTGACGGATGTACGTT,0,5038346
ykgRp,0.09090909090909091,10,10,GTTCGACTACTATGTACTGC,0,5056013
ykgRp,0.09090909090909091,10,10,GTTACACTGACCCGGCGGTG,0,5038132
ykgRp,0.09090909090909091,10,10,GTGTCGCCCATATCACTTCA,0,5046978
ykgRp,0.09090909090909091,10,10,GTGCTGCAAAGCTGGTTGGG,0,5042023
ykgRp,0.09090909090909091,10,10,GTGCTCCTTTTGGCTCCGCG,0,5059566
ykgRp,0.09090909090909091,10,10,GTGCGGCGTGGGTCAATGAA,0,5047555
ykgRp,0.09090909090909091,10,10,GTGACGTCGCTGATCGTCTG,0,5055212
ykgRp,0.09090909090909091,10,10,GTCTCGCCCGAGGAATAGGC,0,5053432
ykgRp,0.09090909090909091,10,10,GTCCTGAGTTGGGACTATGG,0,5044896
ykgRp,0.09090909090909091,10,10,GTATTACTCGCCATATGAAA,0,5048726
ykgRp,0.09090909090909091,10,10,GTACTGCCCTCAGTGGTGAC,0,5035006
ykgRp,0.09090909090909091,10,10,GTACAACGATTGTTACGTGT,0,5039169
ykgRp,0.09090909090909091,10,10,GGTATTTACAACTTAAACAA,0,5035091
ykgRp,0.09090909090909091,10,10,GGTATAGTCATGGGTTATAC,0,5041186
ykgRp,0.09090909090909091,10,10,GGTAAGTCTCCCCATCAAAT,0,5041920
ykgRp,0.09090909090909091,10,10,GGGTGTCGTCACCTCAGTCT,0,5035260
ykgRp,0.09090909090909091,10,10,GGGTCGAAATCAGACTAAGT,0,5057904
ykgRp,0.09090909090909091,10,10,GGGTCACGGACTGCGGAGGT,0,5052507
ykgRp,0.09090909090909091,10,10,GGGCGCGATTCCTCTGACTA,0,5047664
ykgRp,0.09090909090909091,10,10,GGGCACTGTACTGCCATGGT,0,5049457
ykgRp,0.09090909090909091,10,10,GGGAGAATGCGGATGTCCCA,0,5058782
ykgRp,0.09090909090909091,10,10,GGCTCGCTTTCACCAAGCGG,0,5032461
ykgRp,0.09090909090909091,10,10,GGCGTTTGGCGACACAATGG,0,5051662
ykgRp,0.09090909090909091,10,10,GGCGTACGGGAGGAACCGAG,0,5055352
ykgRp,0.09090909090909091,10,10,GGCCATCCGACTATTTTTGG,0,5039564
ykgRp,0.09090909090909091,10,10,GGAGTAGGAGTTAATAGTTA,0,5033591
ykgRp,0.09090909090909091,10,10,GGAAGTTGATCTTGCCAACA,0,5051629
ykgRp,0.09090909090909091,10,10,GCTTTTATGAGCGCACTGTT,0,5060713
ykgRp,0.09090909090909091,10,10,GCTGTTCCTGTGCGTTTTCC,0,5054647
ykgRp,0.09090909090909091,10,10,GCTGCATGTAATGATGCGAC,0,5037970
ykgRp,0.09090909090909091,10,10,GCTGAGCGATGGGGATGCAA,0,5037554
ykgRp,0.09090909090909091,10,10,GCCGGGTTTTGTTATAGGCT,0,5057829
ykgRp,0.09090909090909091,10,10,GCCACCTGAGGATGAAGCTG,0,5041049
ykgRp,0.09090909090909091,10,10,GCATGTGTTTACGGAACACT,0,5051610
ykgRp,0.09090909090909091,10,10,GCATATGTTCAATGGTGCTG,0,5055106
ykgRp,0.09090909090909091,10,10,GCAGTTATCACACGCTACGG,0,5036483
ykgRp,0.09090909090909091,10,10,GCAGTCTGTAGAGCTTGTCA,0,5056123
ykgRp,0.09090909090909091,10,10,GCAACCCCTGAATCAAACGT,0,5037353
ykgRp,0.09090909090909091,10,10,GAGGTTATAGCTCTCGGGCA,0,5042369
ykgRp,0.09090909090909091,10,10,GACTGTACTTGACTCGAAAG,0,5047927
ykgRp,0.09090909090909091,10,10,GACGTGACTTTTATCCCATC,0,5043509
ykgRp,0.09090909090909091,10,10,GACGGTAATATGGCCCGGCG,0,5061251
ykgRp,0.09090909090909091,10,10,GACCTAAATGGATCATTGAA,0,5049030
ykgRp,0.09090909090909091,10,10,GACCCTCTGGCCGTGGGTGC,0,5059079
ykgRp,0.09090909090909091,10,10,GACCCTAGCCATGTGACGGA,0,5048158
ykgRp,0.09090909090909091,10,10,GACCACATTGGCTGGGATCT,0,5039272
ykgRp,0.09090909090909091,10,10,GACATGATTGGCTACGATGT,0,5050722
ykgRp,0.09090909090909091,10,10,GAATGAACAGTGAGTACCTG,0,5037704
ykgRp,0.09090909090909091,10,10,GAACCTTTCCTGGATACTCT,0,5038368
ykgRp,0.09090909090909091,10,10,CTTTGACCGCCATTTTTTGT,0,5045294
ykgRp,0.09090909090909091,10,10,CTTAGTCGCGGGACAGAGAG,0,5038957
ykgRp,0.09090909090909091,10,10,CTTACTATCGATTAACGGAG,0,5042905
ykgRp,0.09090909090909091,10,10,CTGGCGTGGATCAGGGATAG,0,5052694
ykgRp,0.09090909090909091,10,10,CTGGATTCTGCCCACAACCC,0,5032994
ykgRp,0.09090909090909091,10,10,CTGCTCCATATTGTCCGCGG,0,5031730
ykgRp,0.09090909090909091,10,10,CTGCGGCCCGGTAGACTTTT,0,5060094
ykgRp,0.09090909090909091,10,10,CTGATAGTATCTTCAGTAAC,0,5050301
ykgRp,0.09090909090909091,10,10,CTGACTCGCCCGCAACTCAG,0,5034675
ykgRp,0.09090909090909091,10,10,CTGACAGAGGTATCACCAGC,0,5050408
ykgRp,0.09090909090909091,10,10,CTGAAGCCGTGACAATTGTT,0,5042276
ykgRp,0.09090909090909091,10,10,CTCTTAGATAAGACTCTACT,0,5061286
ykgRp,0.09090909090909091,10,10,CTCGGCAATTTTTGGCCGGG,0,5038344
ykgRp,0.09090909090909091,10,10,CTCGATTAAACCATTATCAA,0,5031752
ykgRp,0.09090909090909091,10,10,CTCGACATACTGTCGCGGCG,0,5040779
ykgRp,0.09090909090909091,10,10,CTCCCCAACCCGGGACCCGT,0,5045227
ykgRp,0.09090909090909091,10,10,CTCATTCCGATAAGAGGAGA,0,5047951
ykgRp,0.09090909090909091,10,10,CTAGAGGAGCCCTCAGCTTG,0,5060038
ykgRp,0.09090909090909091,10,10,CTACCACGAAATTCCAATTA,0,5032567
ykgRp,0.09090909090909091,10,10,CGTTTCCCTCACATCAAATG,0,5038583
ykgRp,0.09090909090909091,10,10,CGTCACAAGTTCACTGCTCG,0,5032292
ykgRp,0.09090909090909091,10,10,CGTATCTGCCCAGGATTTAT,0,5054340
ykgRp,0.09090909090909091,10,10,CGTAAGGGACGCCGAAAGGC,0,5034501
ykgRp,0.09090909090909091,10,10,CGGCTCGGAATCACTGAAGT,0,5045276
ykgRp,0.09090909090909091,10,10,CGGCGTGCAGGCTCCAACAA,0,5060865
ykgRp,0.09090909090909091,10,10,CGCTTTAGGTACATACGCTC,0,5032257
ykgRp,0.09090909090909091,10,10,CGCTTACAGTCAATGCGCAT,0,5055202
ykgRp,0.09090909090909091,10,10,CGCAGCATGCACCGAGGTGC,0,5046224
ykgRp,0.09090909090909091,10,10,CGATTTAGTAAAATAATCCT,0,5045903
ykgRp,0.09090909090909091,10,10,CGATCCCAGCGTCTTAAAAC,0,5042476
ykgRp,0.09090909090909091,10,10,CGATATATCACCGACGGAGC,0,5040413
ykgRp,0.09090909090909091,10,10,CGAGGTGAAGACCACGCAGT,0,5044156
ykgRp,0.09090909090909091,10,10,CGAGGGGCCAACTTACTTTC,0,5053020
ykgRp,0.09090909090909091,10,10,CGAGCTTGATGTTTTGGCGA,0,5056292
ykgRp,0.09090909090909091,10,10,CGAGCTAGTTGCGTTGCACG,0,5060956
ykgRp,0.09090909090909091,10,10,CCTTACACATGAATGAACAT,0,5042382
ykgRp,0.09090909090909091,10,10,CCTATGGAACTTTTGAAAGA,0,5054493
ykgRp,0.09090909090909091,10,10,CCGTATAACTCCCCGTTGGG,0,5038762
ykgRp,0.09090909090909091,10,10,CCGGTCCCATGCTCCAGACG,0,5049766
ykgRp,0.09090909090909091,10,10,CCGCACATCACGCACGGGAA,0,5042626
ykgRp,0.09090909090909091,10,10,CCCGCTTGACTGGATGATAA,0,5042955
ykgRp,0.09090909090909091,10,10,CCCATAGTACTCACAGTGAT,0,5040322
ykgRp,0.09090909090909091,10,10,CCCAGGAAATGGGGCCAAAG,0,5047839
ykgRp,0.09090909090909091,10,10,CCCAGCTGGAGCTTTCCCTT,0,5034191
ykgRp,0.09090909090909091,10,10,CCATCGCGGGTGAACGTGGT,0,5050505
ykgRp,0.09090909090909091,10,10,CCAGTTGCGCCGCAGTGCCA,0,5041901
ykgRp,0.09090909090909091,10,10,CCACTATCACCACGACGCAA,0,5054536
ykgRp,0.09090909090909091,10,10,CCACGCAGTGGGCGCCGCTT,0,5041348
ykgRp,0.09090909090909091,10,10,CCAACAAGGGTAAACAGGAT,0,5040479
ykgRp,0.09090909090909091,10,10,CCAAACTAGGTTCAGACTGT,0,5039984
ykgRp,0.09090909090909091,10,10,CATGCCAGTAACATCTTGGC,0,5031486
ykgRp,0.09090909090909091,10,10,CATGATTTCGCCCGGTATGG,0,5055526
ykgRp,0.09090909090909091,10,10,CATCTGTGCTTTTCGGGGAA,0,5052559
ykgRp,0.09090909090909091,10,10,CAGTTCTGTGCTCCTGGAGT,0,5039140
ykgRp,0.09090909090909091,10,10,CAGGGGGCCGTGGTCCAAAC,0,5057780
ykgRp,0.09090909090909091,10,10,CAGCGCTCGGTAAACCATAT,0,5031445
ykgRp,0.09090909090909091,10,10,CACTTTTGGGCCGACGAGGC,0,5032191
ykgRp,0.09090909090909091,10,10,CACCATATTAGGCCAACGCC,0,5042870
ykgRp,0.09090909090909091,10,10,CACACACGTACTCAGCTCTC,0,5059690
ykgRp,0.09090909090909091,10,10,ATTGCGGTACGACTCTGGTT,0,5049849
ykgRp,0.09090909090909091,10,10,ATTGAGAAGGCTAGCGTCTA,0,5036903
ykgRp,0.09090909090909091,10,10,ATTGACTGCGGGTAATTGGG,0,5051156
ykgRp,0.09090909090909091,10,10,ATTCGTCGAATCCGGTCACA,0,5044887
ykgRp,0.09090909090909091,10,10,ATGGGTTCCGTAGAACGTTT,0,5047619
ykgRp,0.09090909090909091,10,10,ATGCGTCCGGGAACGACTGA,0,5041834
ykgRp,0.09090909090909091,10,10,ATGCCTTTGATTCGAGTATG,0,5044663
ykgRp,0.09090909090909091,10,10,ATGCACCGGGGGCTCGGTCT,0,5037218
ykgRp,0.09090909090909091,10,10,ATGAGTGCCGTATACGAAGG,0,5061125
ykgRp,0.09090909090909091,10,10,ATCGCGGTCCGCCTTACCTT,0,5033525
ykgRp,0.09090909090909091,10,10,ATAGGATCGTGCAAAGCGGT,0,5059375
ykgRp,0.09090909090909091,10,10,ATACCCTTCAGAGAGCACAC,0,5042815
ykgRp,0.09090909090909091,10,10,AGTTTTGTGGACAAGCTATA,0,5042367
ykgRp,0.09090909090909091,10,10,AGTGGCGTTAAGAGGGACAA,0,5033868
ykgRp,0.09090909090909091,10,10,AGGTCCTGTACTCTAGCGCA,0,5035944
ykgRp,0.09090909090909091,10,10,AGGGGCTGGCCCCTTTGTTA,0,5047438
ykgRp,0.09090909090909091,10,10,AGGAGGTAGGGTGCAAAAGT,0,5040933
ykgRp,0.09090909090909091,10,10,AGGACCTGTGGAGGCTCGTA,0,5040533
ykgRp,0.09090909090909091,10,10,AGCGGAAACAAGTTGCCTCA,0,5037055
ykgRp,0.09090909090909091,10,10,AGCATCCGTCTCACTATCGT,0,5060258
ykgRp,0.09090909090909091,10,10,ACTTTGTTTCTAGCAGGTTG,0,5036539
ykgRp,0.09090909090909091,10,10,ACTTATTCAAAATCAAGTTG,0,5044593
ykgRp,0.09090909090909091,10,10,ACTATGCGGACAGGAAACGG,0,5033900
ykgRp,0.09090909090909091,10,10,ACGCTAGTAGGCATTGTACG,0,5049151
ykgRp,0.09090909090909091,10,10,ACGCGAAGTACAATCGGAGT,0,5039995
ykgRp,0.09090909090909091,10,10,ACGAGTTTGCGGTTATGGGA,0,5044106
ykgRp,0.09090909090909091,10,10,ACGACAAAGCAGTTCAATGC,0,5041837
ykgRp,0.09090909090909091,10,10,ACCTAGCAAATCGCTTAAGA,0,5041742
ykgRp,0.09090909090909091,10,10,ACCAGTCAAGGAATCCCCCG,0,5040712
ykgRp,0.09090909090909091,10,10,ACACTCATAAGTTGAAAAGG,0,5047104
ykgRp,0.09090909090909091,10,10,ACACAAAAAGGGTGTGCGGA,0,5051697
ykgRp,0.09090909090909091,10,10,AATGGCGCAGGTATTACCCG,0,5045938
ykgRp,0.09090909090909091,10,10,AATCCGTAAGAACAGATCCT,0,5043785
ykgRp,0.09090909090909091,10,10,AATAGTGAAAGTTTACTTAT,0,5037991
ykgRp,0.09090909090909091,10,10,AAGTTCCCATCAGGTGTCTT,0,5041038
ykgRp,0.09090909090909091,10,10,AAGTGCCGATATCAAGCACG,0,5050794
ykgRp,0.09090909090909091,10,10,AAGGAGAGCGGTTACAACTT,0,5036254
ykgRp,0.09090909090909091,10,10,AACTAGGCTGTCGATTAATA,0,5036792
ykgRp,0.09090909090909091,10,10,AACGCTTCGGCAGCCGAAAC,0,5039615
ykgRp,0.09090909090909091,10,10,AACGCTTACGTCTTACGTCA,0,5045109
ykgRp,0.09090909090909091,10,10,AACGATGATGGGGGAAAGCA,0,5057997
ykgRp,0.09090909090909091,10,10,AACCGTTCTCATTTCGCGCC,0,5055026
ykgRp,0.09090909090909091,10,10,AACAATCGGCGACCCCACTT,0,5031327
ykgRp,0.09090909090909091,10,10,AACAAGAATTCAAACACGGC,0,5056881
ykgRp,0.09090909090909091,10,10,AAATGCAGCTCTTACTAATT,0,5054948
ykgRp,0.09090909090909091,10,10,AAAGGTAATATGTATTCTAT,0,5053592
ykgRp,0.09090909090909091,10,10,AAAAGGGTACAAGCCGAACT,0,5045776
ykgRp,0.09090909090909091,10,10,AAAAGCAGAAAGTTTTGGGG,0,5052607
ykgRp,0.1,9,9,TTTCATAAGGGTAAGCGGAT,0,5044126
ykgRp,0.1,9,9,TTGTGAGACCGTTTAACGAA,0,5044577
ykgRp,0.1,9,9,TTGTCTTAAGGATGTTGCGC,0,5054795
ykgRp,0.1,9,9,TTGCGAGGCTCTCTGCACGA,0,5061589
ykgRp,0.1,9,9,TTGCAAGGCTTACAGGGTCT,0,5048275
ykgRp,0.1,9,9,TTCCTGGTTCGGCCGACTGA,0,5042938
ykgRp,0.1,9,9,TTCCACAAAATCACTGTTGT,0,5052313
ykgRp,0.1,9,9,TTATCGTATGTACTATGAGG,0,5058761
ykgRp,0.1,9,9,TTAGTCAATTTTATACCGCG,0,5043104
ykgRp,0.1,9,9,TTAGATGGTCCTGTCCAAAG,0,5032287
ykgRp,0.1,9,9,TTACATTTACACGAGTTAAG,0,5050906
ykgRp,0.1,9,9,TGTTAACCGGACAAAGACTC,0,5058118
ykgRp,0.1,9,9,TGTGTCCACTAAAAGCCAAT,0,5059842
ykgRp,0.1,9,9,TGTGTCAGTTTGGCAATGGA,0,5042512
ykgRp,0.1,9,9,TGTATGCCCAACGCCCCTGG,0,5060694
ykgRp,0.1,9,9,TGTAGTACAAAGCAACTTTG,0,5040677
ykgRp,0.1,9,9,TGTAATGACATGAAAGTTGC,0,5032317
ykgRp,0.1,9,9,TGGGGTTCTCTTGAGTGCTC,0,5040406
ykgRp,0.1,9,9,TGGGAGGCTGACCTAACAAC,0,5045539
ykgRp,0.1,9,9,TGGCGACAGTAACATTAGGA,0,5051335
ykgRp,0.1,9,9,TGGCACCGTTCCAGTAATTG,0,5042397
ykgRp,0.1,9,9,TGGATCAGCCTGAAATTTCT,0,5060554
ykgRp,0.1,9,9,TGCTTTCTTTGCAATACGGA,0,5040348
ykgRp,0.1,9,9,TGCTATCAAATCGAACACTA,0,5051559
ykgRp,0.1,9,9,TCTTAGGCCTAAGAGACGCG,0,5046270
ykgRp,0.1,9,9,TCTTACCATTGCGACGGAGC,0,5055237
ykgRp,0.1,9,9,TCTGTGAAGCATGGGAGATA,0,5049358
ykgRp,0.1,9,9,TCGTTAGGCGCCGCCTGGCG,0,5044220
ykgRp,0.1,9,9,TCGGTGAGGCGCTGCAGTTA,0,5034855
ykgRp,0.1,9,9,TCGGACAGGCCTTAATAAAT,0,5036072
ykgRp,0.1,9,9,TCGACTTACACCGCGGGCAT,0,5052386
ykgRp,0.1,9,9,TCGAATCGTAAAGGGAACAT,0,5059506
ykgRp,0.1,9,9,TCGAAATCTTGAACTGACGG,0,5033471
ykgRp,0.1,9,9,TCCTTTACATAATAATCGGG,0,5052848
ykgRp,0.1,9,9,TCCGTCTAGGGGGGCTGAAT,0,5054637
ykgRp,0.1,9,9,TCCATATCGGTAGGTGCGAC,0,5033070
ykgRp,0.1,9,9,TCATGGAGGCTAGGTTCCTT,0,5054419
ykgRp,0.1,9,9,TCATGCCATCCATTGTGGAA,0,5039060
ykgRp,0.1,9,9,TCAAGCTCGCACCTGTCTTG,0,5033923
ykgRp,0.1,9,9,TCAACCAATCTTTCCGTGAA,0,5054591
ykgRp,0.1,9,9,TCAAAGCGCACGAGACCCGT,0,5045351
ykgRp,0.1,9,9,TATCATAGGCAGCGGAAGGA,0,5048155
ykgRp,0.1,9,9,TATATAATAGATACCCAGGT,0,5050631
ykgRp,0.1,9,9,TAGGTCGCGTAATTGGGCCC,0,5053585
ykgRp,0.1,9,9,TAGCCTACTGCGAAGCCCGA,0,5033685
ykgRp,0.1,9,9,TAGATATTTTCCGACGCTAA,0,5036193
ykgRp,0.1,9,9,TAGAGGGCATTAATGAGTGG,0,5034312
ykgRp,0.1,9,9,TACTCTCGATCAGGTCAAAT,0,5042510
ykgRp,0.1,9,9,TACACCCAGTGGCATTTATG,0,5041485
ykgRp,0.1,9,9,TAAGGCTGCAAAAGGGAAGC,0,5040364
ykgRp,0.1,9,9,TAACCTGGCATGGACTCTAG,0,5051999
ykgRp,0.1,9,9,TAAAATTCGGGTATTACCCC,0,5046785
ykgRp,0.1,9,9,GTTTTACGGTGGATACTGGG,0,5036992
ykgRp,0.1,9,9,GTTTGAGTTTGGGATACTAA,0,5048602
ykgRp,0.1,9,9,GTTTACGTGCTGGAGTGACT,0,5032854
ykgRp,0.1,9,9,GTGTTAAACGTGAGCGCTCT,0,5038920
ykgRp,0.1,9,9,GTGTGAGTGACAGTGTCTAT,0,5046152
ykgRp,0.1,9,9,GTGAGTTGAGCGATATTCAG,0,5038820
ykgRp,0.1,9,9,GTCTAATTGAGTATTATTCA,0,5050948
ykgRp,0.1,9,9,GTCGCATAGCCCATAGTGGC,0,5047033
ykgRp,0.1,9,9,GTCCTATAGTGGATCACACG,0,5042750
ykgRp,0.1,9,9,GTCCGATTAACGGGGCGCGG,0,5043003
ykgRp,0.1,9,9,GTCAGAGAATTATAAGAAAT,0,5036445
ykgRp,0.1,9,9,GTATAGATCTAGGACTTAGA,0,5052677
ykgRp,0.1,9,9,GTAGTAAGCCACTGGACTCA,0,5033351
ykgRp,0.1,9,9,GTAGCCATAAAGCGGATTAT,0,5049924
ykgRp,0.1,9,9,GTACACCACTCATCAGGGGA,0,5037929
ykgRp,0.1,9,9,GTACAAGGCGTTCCTCATTA,0,5058346
ykgRp,0.1,9,9,GTAAGTCACGGATGCTGTCC,0,5045591
ykgRp,0.1,9,9,GTAAAAACCAACCGTTATTC,0,5037216
ykgRp,0.1,9,9,GGTGTAAACTCACCCCGATC,0,5054941
ykgRp,0.1,9,9,GGTAAGGGAGTCGGTATGAT,0,5039755
ykgRp,0.1,9,9,GGGTGACCTCGGTTTGTAGA,0,5035179
ykgRp,0.1,9,9,GGGGAAGGCGGGCTCACTAT,0,5054972
ykgRp,0.1,9,9,GGGCTTTGACTTCCGGTTTC,0,5040695
ykgRp,0.1,9,9,GGGCCAGTTTATCCTGCTTG,0,5043871
ykgRp,0.1,9,9,GGGAGGGGACAGGAAGATGT,0,5031782
ykgRp,0.1,9,9,GGGAAGTACCTTTTGACCAC,0,5037317
ykgRp,0.1,9,9,GGCTGGGAAGTAATTTATGG,0,5043486
ykgRp,0.1,9,9,GGCCGGGGCAAGCAACTATG,0,5044643
ykgRp,0.1,9,9,GGCAGCACATCAATTCCAAA,0,5054290
ykgRp,0.1,9,9,GCTCGCACTGTGCTACGTTA,0,5033330
ykgRp,0.1,9,9,GCTATCTGCGGGAGTAGAAA,0,5046414
ykgRp,0.1,9,9,GCGTGATAATACAGCCTCAG,0,5050678
ykgRp,0.1,9,9,GCGTCTGGGCGTTCAAATCC,0,5042240
ykgRp,0.1,9,9,GCGTCGGATCCTAGCTAGCC,0,5039221
ykgRp,0.1,9,9,GCGCGCTACACGTGACATAT,0,5033832
ykgRp,0.1,9,9,GCCCCGCGCAGATGGCCGAT,0,5047868
ykgRp,0.1,9,9,GCCCACTGTATGAGGAAATA,0,5044677
ykgRp,0.1,9,9,GCAGTGTGCAGCGCACCGGA,0,5039694
ykgRp,0.1,9,9,GCAGGCGGTCTATTTTCGTT,0,5052379
ykgRp,0.1,9,9,GCAGCAATTACTGCGGGGCG,0,5059521
ykgRp,0.1,9,9,GCAAGGATTTAGTTATTTAA,0,5060778
ykgRp,0.1,9,9,GCAAAGGACGCAACCTGGCT,0,5038496
ykgRp,0.1,9,9,GATTGATGTGTCTCTTTAGT,0,5038841
ykgRp,0.1,9,9,GATGCTCCCAGCTATTGTCC,0,5032022
ykgRp,0.1,9,9,GATCGGGTCGCCCCGGACTC,0,5045506
ykgRp,0.1,9,9,GATCGCGCTAAGAGGATGTA,0,5056450
ykgRp,0.1,9,9,GATCAACTAGCGAGTTACAC,0,5058206
ykgRp,0.1,9,9,GATACGCCATTACGCGAGTT,0,5032337
ykgRp,0.1,9,9,GATACCAATAAGTATTGAGG,0,5049708
ykgRp,0.1,9,9,GAGTTGCTGTCTGCGTATTT,0,5046940
ykgRp,0.1,9,9,GAGGGCAAACAGTCGCTCAT,0,5052881
ykgRp,0.1,9,9,GAGCTCCCCGTTGGCACGTC,0,5056015
ykgRp,0.1,9,9,GACTTGGGGATTGTTGACAA,0,5047792
ykgRp,0.1,9,9,GACTTCACCCTCCCATCGAA,0,5052525
ykgRp,0.1,9,9,GACGCTCGACCCGTCAGGTG,0,5052128
ykgRp,0.1,9,9,GAATGGCTTACGCTCCTGAT,0,5036309
ykgRp,0.1,9,9,GAAGTCTCAAAAAACCGTCG,0,5036212
ykgRp,0.1,9,9,GAAGGGCATCGCTCGCATTA,0,5035209
ykgRp,0.1,9,9,CTTTGGGTGTAATAATGTTG,0,5045356
ykgRp,0.1,9,9,CTTCAGGCTGCAGCTTCACT,0,5045296
ykgRp,0.1,9,9,CTTAGGGCCTCTAGGGACAC,0,5035152
ykgRp,0.1,9,9,CTTACTGGATACGATTCAGA,0,5037750
ykgRp,0.1,9,9,CTTAAGGTATCCACAGCGGA,0,5059202
ykgRp,0.1,9,9,CTGTGCTCTCTGGAGATTTG,0,5040442
ykgRp,0.1,9,9,CTGCGTATGCGTCGCGTTGT,0,5050383
ykgRp,0.1,9,9,CTGACTATGCGATCTCTGGA,0,5034721
ykgRp,0.1,9,9,CTCTAGCATCGAGCAGGTTA,0,5038051
ykgRp,0.1,9,9,CTCGGAAAATTTCATGACAG,0,5035191
ykgRp,0.1,9,9,CTCCGCGCCGTCTATAGACT,0,5043915
ykgRp,0.1,9,9,CTCCATGAATGGTTTTGCCA,0,5051659
ykgRp,0.1,9,9,CTCATAAATTCTGGTAATTA,0,5038868
ykgRp,0.1,9,9,CTCACCCAGCCTGTGTCATG,0,5053840
ykgRp,0.1,9,9,CTATTCCGTCTTCCCCGCAT,0,5051066
ykgRp,0.1,9,9,CTATGAGTTTCATAATCAGT,0,5032810
ykgRp,0.1,9,9,CTAAAAGAAAAATACACTCA,0,5053764
ykgRp,0.1,9,9,CGTTTGTCAAGTTGCTACGT,0,5047720
ykgRp,0.1,9,9,CGTTGGTTTCCTAAGAGTCA,0,5044475
ykgRp,0.1,9,9,CGTGGCGGACCAGCGAAATG,0,5041861
ykgRp,0.1,9,9,CGTACTGCTATATGCCTCAT,0,5045918
ykgRp,0.1,9,9,CGGGTGAGGCACTCATATGC,0,5050731
ykgRp,0.1,9,9,CGGGACCGAAGAAAGGCTGG,0,5049748
ykgRp,0.1,9,9,CGGCGGTGGACCGCAAATAT,0,5042234
ykgRp,0.1,9,9,CGGCATATCAAGCTTATTAA,0,5059831
ykgRp,0.1,9,9,CGGCAAAAATTAGTTAGGTA,0,5049212
ykgRp,0.1,9,9,CGCGTGATGAAGCGCCCCTC,0,5033339
ykgRp,0.1,9,9,CGATTTGTCAATGAAGATTG,0,5040058
ykgRp,0.1,9,9,CGATGTTCCGGCTAAACGGT,0,5036685
ykgRp,0.1,9,9,CGAGCAGCCGTCATGGACTG,0,5042860
ykgRp,0.1,9,9,CGACGGGCTGCCGGTTCCAG,0,5040027
ykgRp,0.1,9,9,CGACCTCCTGCACATTTGTT,0,5060614
ykgRp,0.1,9,9,CCTTGGCCGAAGGGTCGTGA,0,5039617
ykgRp,0.1,9,9,CCTTAACCGTAAACCAGCAG,0,5056471
ykgRp,0.1,9,9,CCTGGCATAGGGTTCTCCAA,0,5055836
ykgRp,0.1,9,9,CCTGCTGCTTTCGGCCTCGA,0,5056993
ykgRp,0.1,9,9,CCTCTCCACACGCCAGGCTG,0,5032770
ykgRp,0.1,9,9,CCTCACCTACCGTAATGTCC,0,5041903
ykgRp,0.1,9,9,CCGCGCAACTGCTACATCCA,0,5056331
ykgRp,0.1,9,9,CCGCAGCCCGCTAAAAGCGA,0,5047553
ykgRp,0.1,9,9,CCCGGAGAAATAGGAGGTGC,0,5044094
ykgRp,0.1,9,9,CCCACCTCGCATGTACCGTT,0,5037026
ykgRp,0.1,9,9,CCATGTCTGAGTAAAACGAC,0,5056474
ykgRp,0.1,9,9,CCAGGCAATGGTTGGACAGA,0,5047833
ykgRp,0.1,9,9,CATTCCTGCTGGGGCCTTCT,0,5058980
ykgRp,0.1,9,9,CATCCTATCTGTCGCGATAG,0,5031335
ykgRp,0.1,9,9,CATAGCGGGAAACCCCTGAT,0,5042152
ykgRp,0.1,9,9,CAGGGTGCCGCACCCTCCGA,0,5039609
ykgRp,0.1,9,9,CAGCTCAGGTCCGCAGCGGT,0,5041462
ykgRp,0.1,9,9,CAGCCAATGGATGAATGCTT,0,5048110
ykgRp,0.1,9,9,CAGATTAGCAGAACTATTGG,0,5035887
ykgRp,0.1,9,9,CAGATGCCAGTTCAGTGGGA,0,5040213
ykgRp,0.1,9,9,CAGATCAAACCCTGAACTGC,0,5049442
ykgRp,0.1,9,9,CACTCAGTTGAGGGCATGTG,0,5057969
ykgRp,0.1,9,9,CACAGGAGGGGTGGCACCAT,0,5050052
ykgRp,0.1,9,9,CACAGAATAAGGTAGCAGTG,0,5044411
ykgRp,0.1,9,9,CAAGGTCGTCGCGTGTAATG,0,5041307
ykgRp,0.1,9,9,CAAGCACACTGGATGACCCA,0,5053528
ykgRp,0.1,9,9,CAAACCTTTATCACTTCATG,0,5035407
ykgRp,0.1,9,9,ATTTGAACCTAAACTGAAGT,0,5054910
ykgRp,0.1,9,9,ATTTCTACCCCTAGAGATTG,0,5048798
ykgRp,0.1,9,9,ATTGCCGTGGCCCAGTTTCA,0,5038923
ykgRp,0.1,9,9,ATTCTAGCCCCCCCAAGCTA,0,5040633
ykgRp,0.1,9,9,ATTCATTAGACCCGGGATAT,0,5041753
ykgRp,0.1,9,9,ATGTGGACACTGGCATCCGT,0,5042913
ykgRp,0.1,9,9,ATGCCGCCAGTCGGGCTGTA,0,5051219
ykgRp,0.1,9,9,ATGAGGAGATTTGTAGGGCG,0,5042976
ykgRp,0.1,9,9,ATCTATGCATCGACATATAT,0,5038501
ykgRp,0.1,9,9,ATCCTACTGAATTAACACGT,0,5046500
ykgRp,0.1,9,9,ATCCGGGGGTCCTTGCAAGA,0,5049356
ykgRp,0.1,9,9,ATAGAGTCTTGGGATGTGTA,0,5051670
ykgRp,0.1,9,9,ATACCGGTGGAAATTGACAC,0,5032203
ykgRp,0.1,9,9,ATACAAGCGCTAGGTGGGAT,0,5035521
ykgRp,0.1,9,9,ATAAGCTGTCGTCCTGTTGA,0,5032913
ykgRp,0.1,9,9,ATAACAGAGGTGAATCCGTC,0,5056616
ykgRp,0.1,9,9,AGTTACATAGTCCTCCAAAT,0,5040286
ykgRp,0.1,9,9,AGTGAGCAGAAGGAGCTCAC,0,5061723
ykgRp,0.1,9,9,AGTCAACATTAGGTAGGGAT,0,5031373
ykgRp,0.1,9,9,AGGATCCGTAAGACGTAAAT,0,5038436
ykgRp,0.1,9,9,AGGACCCTTAATTATCCGGA,0,5033118
ykgRp,0.1,9,9,AGCTACTTAACCCACTCTAT,0,5041789
ykgRp,0.1,9,9,AGCGGTTGAACGATAAAGGT,0,5051483
ykgRp,0.1,9,9,AGCGGGCATGCCAGGTCTTG,0,5040697
ykgRp,0.1,9,9,AGCGCAATAGATTCGAGGAC,0,5039282
ykgRp,0.1,9,9,AGCAAGTATGTCCGGGAATC,0,5038055
ykgRp,0.1,9,9,AGACCGCTGACCTCAGCCAA,0,5054788
ykgRp,0.1,9,9,AGACCAATTCGAGATGGAGG,0,5056045
ykgRp,0.1,9,9,AGAAAGCGGAGGGTGCCCGG,0,5054731
ykgRp,0.1,9,9,ACTGAACAGGGTTTCAAAGT,0,5055111
ykgRp,0.1,9,9,ACTCCATGTCCGTGGCCAGG,0,5054911
ykgRp,0.1,9,9,ACTCAGCCACGGCGGCAAGG,0,5052985
ykgRp,0.1,9,9,ACGGGCTATAAAAGTGATCA,0,5036585
ykgRp,0.1,9,9,ACGCTTTAAGAACGGTACGA,0,5054115
ykgRp,0.1,9,9,ACGCACCGGGGCGACATGTA,0,5059031
ykgRp,0.1,9,9,ACAAGCGCGACCATCCCTGA,0,5033067
ykgRp,0.1,9,9,ACAACGCCAATCTGAAACAT,0,5054401
ykgRp,0.1,9,9,AATCTATGCGTCAGGAGACT,0,5041356
ykgRp,0.1,9,9,AATCGAAAGCGCTCTGCATA,0,5038512
ykgRp,0.1,9,9,AATAATGGGTGGTCATGGAA,0,5058482
ykgRp,0.1,9,9,AAGCTAGTCGCGGCCGGCGC,0,5036884
ykgRp,0.1,9,9,AAGATAAAGCAACGGTTCAC,0,5051798
ykgRp,0.1,9,9,AACTTGGGTCGTCTGTATGC,0,5034219
ykgRp,0.1,9,9,AAATACGACGGGTGAGGGTG,0,5032679
ykgRp,0.1,9,9,AAAGCGTTTCCCGCTTTGGA,0,5040116
ykgRp,0.1,9,9,AAAGAAATTATCGGGTATGA,0,5056937
ykgRp,0.1,9,9,AAACACACGAGGTGGTTACG,0,5036196
ykgRp,0.1111111111111111,8,8,TTTTTATATAAGGTGAAGGC,0,5036597
ykgRp,0.1111111111111111,8,8,TTTTGGGAAGGTGAAGTAAG,0,5060809
ykgRp,0.1111111111111111,8,8,TTTCATGCTACCCGCAACAG,0,5047510
ykgRp,0.1111111111111111,8,8,TTGTTTGTAACAAGTTGATC,0,5034657
ykgRp,0.1111111111111111,8,8,TTGTGGTGTATGGCTTGAGT,0,5039405
ykgRp,0.1111111111111111,8,8,TTGTCTACTGGAAGAATCGG,0,5036681
ykgRp,0.1111111111111111,8,8,TTGTACGGACCCGACCTTTT,0,5039010
ykgRp,0.1111111111111111,8,8,TTGTAAGAGTTGTCACCAAT,0,5040884
ykgRp,0.1111111111111111,8,8,TTGGTTTGAAGCATTCCTGT,0,5048745
ykgRp,0.1111111111111111,8,8,TTGGGTTCTTTGACGGACTC,0,5036995
ykgRp,0.1111111111111111,8,8,TTGGGCTGGTTATCTTGATA,0,5043559
ykgRp,0.1111111111111111,8,8,TTGCCATGTCGGGTACCTTG,0,5037073
ykgRp,0.1111111111111111,8,8,TTGAATTGGTAGAAGCCTCG,0,5035329
ykgRp,0.1111111111111111,8,8,TTCTCAAATCGACTAACAAC,0,5031819
ykgRp,0.1111111111111111,8,8,TTCGGGCCAAAAACCGACGC,0,5048199
ykgRp,0.1111111111111111,8,8,TTCAATCGGTTCTGGCCGAT,0,5044403
ykgRp,0.1111111111111111,8,8,TTAACAATGCCAATAGGTAA,0,5051748
ykgRp,0.1111111111111111,8,8,TGTTGACCGGTAGCTGTCCG,0,5040585
ykgRp,0.1111111111111111,8,8,TGTTCTCGCTTTTCCGTCGT,0,5034656
ykgRp,0.1111111111111111,8,8,TGTGTGCTGTAATGGGCCAT,0,5053038
ykgRp,0.1111111111111111,8,8,TGTGATCTTTACGGAAATAG,0,5036036
ykgRp,0.1111111111111111,8,8,TGTCATGGGGGCACTCTCTG,0,5037782
ykgRp,0.1111111111111111,8,8,TGGTTGAGGGTTATTTGGTA,0,5054372
ykgRp,0.1111111111111111,8,8,TGGTGTCCACGTACTCGAAT,0,5037453
ykgRp,0.1111111111111111,8,8,TGGTGACGGACTGTCAGAGT,0,5060243
ykgRp,0.1111111111111111,8,8,TGGTATAGCAAATCATCATA,0,5045011
ykgRp,0.1111111111111111,8,8,TGGGAGGCAAACGCTCGTTA,0,5055943
ykgRp,0.1111111111111111,8,8,TGGCTCGGTGCGATCGGGTT,0,5047156
ykgRp,0.1111111111111111,8,8,TGCGAATTAAGTGGTAAACA,0,5032138
ykgRp,0.1111111111111111,8,8,TGCCATAGGAGAGTCCAACC,0,5037334
ykgRp,0.1111111111111111,8,8,TGCATCGGACCCGGAGTGAC,0,5033905
ykgRp,0.1111111111111111,8,8,TGCACCCGTATCCTAGGGGT,0,5049214
ykgRp,0.1111111111111111,8,8,TGCAACGGGAGACGAAGACG,0,5046908
ykgRp,0.1111111111111111,8,8,TGATTGGGGTTTCCGTGTTT,0,5058472
ykgRp,0.1111111111111111,8,8,TGATCACCCTGGGTTCTCGC,0,5056796
ykgRp,0.1111111111111111,8,8,TGATCAAGGTTTCAGGCGCT,0,5039518
ykgRp,0.1111111111111111,8,8,TCTTTCATAACTGTTCTGCA,0,5041780
ykgRp,0.1111111111111111,8,8,TCTGAGTCTGTCTTCAAGGT,0,5059589
ykgRp,0.1111111111111111,8,8,TCGTACCTAACGTACAATCG,0,5042899
ykgRp,0.1111111111111111,8,8,TCGCCTTTTTTAAGCTAACG,0,5056657
ykgRp,0.1111111111111111,8,8,TCCAGCATTTGGTATTAGCG,0,5044804
ykgRp,0.1111111111111111,8,8,TCATAGAAAACGCTGGTTGG,0,5043430
ykgRp,0.1111111111111111,8,8,TCAGGCATCCGAGGGGCACA,0,5039144
ykgRp,0.1111111111111111,8,8,TCAGCGCATGGTGGATGATC,0,5057059
ykgRp,0.1111111111111111,8,8,TCACGCTGAGCGGCATTAAA,0,5034519
ykgRp,0.1111111111111111,8,8,TCAACGGTATCTGCTGCGTA,0,5034723
ykgRp,0.1111111111111111,8,8,TATTGGGAACCCGCGTATAG,0,5036118
ykgRp,0.1111111111111111,8,8,TATGCAACACATCCTAACCG,0,5034365
ykgRp,0.1111111111111111,8,8,TATCCTCCGCCTGGCATGAA,0,5049509
ykgRp,0.1111111111111111,8,8,TATCCATACTCTACCGCGAA,0,5039275
ykgRp,0.1111111111111111,8,8,TATATTTTTGGACAAGGTCG,0,5046296
ykgRp,0.1111111111111111,8,8,TATATGTCTTTAGGCGATCT,0,5043572
ykgRp,0.1111111111111111,8,8,TATATCTCGATCTAAAACCC,0,5036599
ykgRp,0.1111111111111111,8,8,TATAATTATGCGAGCTAGGT,0,5054641
ykgRp,0.1111111111111111,8,8,TAGGGGCCTCAGTACCTACA,0,5032927
ykgRp,0.1111111111111111,8,8,TAGCTGTAAGGCTCAAGTTC,0,5059539
ykgRp,0.1111111111111111,8,8,TAGCTCAGAGATAACCCTGT,0,5033527
ykgRp,0.1111111111111111,8,8,TAGCCGTGGGACGATGGCGA,0,5056112
ykgRp,0.1111111111111111,8,8,TAGCCAATCAAAATAATACG,0,5058854
ykgRp,0.1111111111111111,8,8,TAGAGGTGAACGACCGGTAT,0,5048549
ykgRp,0.1111111111111111,8,8,TACGTATGGTGGGGCCTTCT,0,5037118
ykgRp,0.1111111111111111,8,8,TAAGTTTAAGTCTTCGTTCG,0,5035049
ykgRp,0.1111111111111111,8,8,TAACGTATACTAAGGCCTTG,0,5032092
ykgRp,0.1111111111111111,8,8,TAACGAGGGAAGCCCAGCTT,0,5034193
ykgRp,0.1111111111111111,8,8,GTTTATTGCAAGATAATACA,0,5055866
ykgRp,0.1111111111111111,8,8,GTTGGAGCGCGTCTTCAAGT,0,5031620
ykgRp,0.1111111111111111,8,8,GTTCTCCAGGCACAAGTGAA,0,5049255
ykgRp,0.1111111111111111,8,8,GTTATTTACCGCCAGGCTAG,0,5060284
ykgRp,0.1111111111111111,8,8,GTTAAGGGTGATATGCATAA,0,5044055
ykgRp,0.1111111111111111,8,8,GTGCGTGCCCAATGTTAAGA,0,5052375
ykgRp,0.1111111111111111,8,8,GTCATTTAGTATGACGGTCA,0,5034319
ykgRp,0.1111111111111111,8,8,GTCAGATCTAGTTTAATTAG,0,5040654
ykgRp,0.1111111111111111,8,8,GTATTGGTCACGTGTGTACG,0,5034902
ykgRp,0.1111111111111111,8,8,GTAGTAATTTACCGGCGCGT,0,5041288
ykgRp,0.1111111111111111,8,8,GTAGCATCAATTACTGCCAC,0,5048087
ykgRp,0.1111111111111111,8,8,GTACACGCTACGTTGGGAAG,0,5054475
ykgRp,0.1111111111111111,8,8,GTACACACTATACGATTAGT,0,5033477
ykgRp,0.1111111111111111,8,8,GGTTGCTGCTTGATCATGGA,0,5036203
ykgRp,0.1111111111111111,8,8,GGTTCTCAATAATAACAACA,0,5045677
ykgRp,0.1111111111111111,8,8,GGTTATTCTTCCGAGGCCAG,0,5033710
ykgRp,0.1111111111111111,8,8,GGTCTGTAATTCTCGAACAG,0,5052685
ykgRp,0.1111111111111111,8,8,GGTCGCCATGAATCCATTCA,0,5045975
ykgRp,0.1111111111111111,8,8,GGTCACATAAGACCTGATAA,0,5050796
ykgRp,0.1111111111111111,8,8,GGTAGGTCGTCCGGGAGCCA,0,5041308
ykgRp,0.1111111111111111,8,8,GGTAGAGTTCGCGGTTTAAG,0,5059227
ykgRp,0.1111111111111111,8,8,GGGTGGATATTGTGTAACAA,0,5048697
ykgRp,0.1111111111111111,8,8,GGGTCCCATGCATTTGCTTC,0,5039511
ykgRp,0.1111111111111111,8,8,GGGGCCCCGGTTTTGAGGAA,0,5051642
ykgRp,0.1111111111111111,8,8,GGGGAGAGTGGAGCGCAAAT,0,5040703
ykgRp,0.1111111111111111,8,8,GGGGACAAGTGGCGCAATGA,0,5031572
ykgRp,0.1111111111111111,8,8,GGGCTCTGAGGCTATACCCC,0,5038213
ykgRp,0.1111111111111111,8,8,GGGCAAGTTCACTCGTCGCG,0,5058587
ykgRp,0.1111111111111111,8,8,GGGACGGTCTTTTGCATAAT,0,5060631
ykgRp,0.1111111111111111,8,8,GGGACCCCACGTTCGTCTGT,0,5034666
ykgRp,0.1111111111111111,8,8,GGCGTCTATGGACCTTGAGT,0,5038726
ykgRp,0.1111111111111111,8,8,GGCGCCGGTTCACAGGGACT,0,5053024
ykgRp,0.1111111111111111,8,8,GGCCATGTTGGCTTATTGCG,0,5048583
ykgRp,0.1111111111111111,8,8,GGCATTTATCACCTTTCCGG,0,5039450
ykgRp,0.1111111111111111,8,8,GGCAGACCCGAGGGTACGTC,0,5031480
ykgRp,0.1111111111111111,8,8,GGCAACGGTCATCCGATCAC,0,5038897
ykgRp,0.1111111111111111,8,8,GGATCTAGTTGGACTGGTGG,0,5053156
ykgRp,0.1111111111111111,8,8,GGATCAGTCTTTTTGCCGTC,0,5056271
ykgRp,0.1111111111111111,8,8,GGAGGTAGCGCGGTAGTTGC,0,5037066
ykgRp,0.1111111111111111,8,8,GGAGCAACATTTCTTGCATG,0,5034336
ykgRp,0.1111111111111111,8,8,GGACTCGTGCTATCGAGGGG,0,5033507
ykgRp,0.1111111111111111,8,8,GGACTCAAGAAGCGGGGCAA,0,5031933
ykgRp,0.1111111111111111,8,8,GGACGCGCACCCTTGGCCAC,0,5043964
ykgRp,0.1111111111111111,8,8,GGACATACTGGCGATACTCC,0,5036139
ykgRp,0.1111111111111111,8,8,GGAACGAGCCGAATCGCAAA,0,5038481
ykgRp,0.1111111111111111,8,8,GCTTGCCAGTACGAGGCATA,0,5041741
ykgRp,0.1111111111111111,8,8,GCTTCGGGGTGAAAAGCATT,0,5056739
ykgRp,0.1111111111111111,8,8,GCTGACGCCAGCGATTCAAC,0,5035893
ykgRp,0.1111111111111111,8,8,GCTCTCTTCGCACTTGATAC,0,5042444
ykgRp,0.1111111111111111,8,8,GCTCGTACCCCCCTGGACTG,0,5059848
ykgRp,0.1111111111111111,8,8,GCTAGTCAGGGATACTCTCG,0,5046242
ykgRp,0.1111111111111111,8,8,GCTAAGGATTCATAATGGCG,0,5045031
ykgRp,0.1111111111111111,8,8,GCGTTCTGCGGCGGTCCAGA,0,5046217
ykgRp,0.1111111111111111,8,8,GCGTTAACCGTGGACCGCCA,0,5040057
ykgRp,0.1111111111111111,8,8,GCGGGAACATAGACAACGGA,0,5034161
ykgRp,0.1111111111111111,8,8,GCGGCATAGTGCTCTCCTAC,0,5033090
ykgRp,0.1111111111111111,8,8,GCGGCAAAGTTGTGCAAGGT,0,5054944
ykgRp,0.1111111111111111,8,8,GCGAGCCCAAGGCTTCGGAT,0,5055339
ykgRp,0.1111111111111111,8,8,GCCTTTTTTAGTGTAAGGGA,0,5044471
ykgRp,0.1111111111111111,8,8,GCCTTGGGTCATCTTCAAAT,0,5060026
ykgRp,0.1111111111111111,8,8,GCCGTTTGTGCCGATTAAAG,0,5054455
ykgRp,0.1111111111111111,8,8,GCCGGAACTCGGCTGCGATG,0,5037783
ykgRp,0.1111111111111111,8,8,GCCAGACCGCTAGGGTACAC,0,5037890
ykgRp,0.1111111111111111,8,8,GCATGATGCACTCTAACCGT,0,5036659
ykgRp,0.1111111111111111,8,8,GCACCTATGAATGGAATTGG,0,5036722
ykgRp,0.1111111111111111,8,8,GATTATTACTTAGGGATCTG,0,5047242
ykgRp,0.1111111111111111,8,8,GATGGAGGTCACCGATATAG,0,5044572
ykgRp,0.1111111111111111,8,8,GATCTCGACTAGAATGTGAT,0,5033677
ykgRp,0.1111111111111111,8,8,GATCATACATCCATAAGGCC,0,5056655
ykgRp,0.1111111111111111,8,8,GATCACGATATTTCCCACTT,0,5042443
ykgRp,0.1111111111111111,8,8,GAGGTGCCGGTTTAAAACGG,0,5050042
ykgRp,0.1111111111111111,8,8,GAGGTACAGTTCTCCGTTTA,0,5055544
ykgRp,0.1111111111111111,8,8,GAGGGCCTGGTTACAACATG,0,5045409
ykgRp,0.1111111111111111,8,8,GAGGAGAAGGCTCTTTATGG,0,5036014
ykgRp,0.1111111111111111,8,8,GAGGACAGTGTCAGTCATAA,0,5048541
ykgRp,0.1111111111111111,8,8,GACTTATACGAATAATACTC,0,5040410
ykgRp,0.1111111111111111,8,8,GACCTCGGATCCTTAGCAAG,0,5048210
ykgRp,0.1111111111111111,8,8,GACACCAGGCCTGCATAGGT,0,5058497
ykgRp,0.1111111111111111,8,8,GAATGTTTAAAGTTTACGGC,0,5059419
ykgRp,0.1111111111111111,8,8,GAAGTCCACCACTGGAAAGA,0,5054497
ykgRp,0.1111111111111111,8,8,GAAGCCAAGCATCCCGCCAT,0,5057514
ykgRp,0.1111111111111111,8,8,GAAGATCGCCTAAACTCTGA,0,5045784
ykgRp,0.1111111111111111,8,8,CTTTTTCAAAGGACCTAAAA,0,5054261
ykgRp,0.1111111111111111,8,8,CTTGGCAATGGCCTGTATTA,0,5054740
ykgRp,0.1111111111111111,8,8,CTTCGTTTACTACCTCATCA,0,5036913
ykgRp,0.1111111111111111,8,8,CTTCACTGTAGTGCTAAACA,0,5038437
ykgRp,0.1111111111111111,8,8,CTTAGCGACAAGAAAAAGGA,0,5049029
ykgRp,0.1111111111111111,8,8,CTGTCATAGGTTGCAAAAGA,0,5040014
ykgRp,0.1111111111111111,8,8,CTGTAAGAAGAATGCACAAC,0,5032136
ykgRp,0.1111111111111111,8,8,CTGGCTTGGGTCAAAGGATA,0,5038973
ykgRp,0.1111111111111111,8,8,CTGAGTCCCTTAAACCGCTC,0,5040505
ykgRp,0.1111111111111111,8,8,CTCATGCCGCCCGTAGGTGA,0,5042130
ykgRp,0.1111111111111111,8,8,CTCAGGGATTCCACTCGCTA,0,5039127
ykgRp,0.1111111111111111,8,8,CTCACCATTAGCCTGGCCGG,0,5050345
ykgRp,0.1111111111111111,8,8,CTCAACCGAGAGGCTTATTC,0,5047029
ykgRp,0.1111111111111111,8,8,CTATGGTTCCTACTATCGGT,0,5047819
ykgRp,0.1111111111111111,8,8,CTATCCCCGCCCTTGCACAA,0,5034992
ykgRp,0.1111111111111111,8,8,CTATAGCTCGAGATCGACGA,0,5053466
ykgRp,0.1111111111111111,8,8,CTAGTTGTAAAAGCTACAAT,0,5052643
ykgRp,0.1111111111111111,8,8,CTAGGGATATAACTACAAGG,0,5042597
ykgRp,0.1111111111111111,8,8,CTACAGCGACGTCTCACCTA,0,5046366
ykgRp,0.1111111111111111,8,8,CTAAATAGGCAGATGGAATG,0,5042559
ykgRp,0.1111111111111111,8,8,CGTGTGATCCACTCCAGATG,0,5040346
ykgRp,0.1111111111111111,8,8,CGTGCTCCGTCCATCCCCGT,0,5048743
ykgRp,0.1111111111111111,8,8,CGTGCAATGGGTATGTATTT,0,5043025
ykgRp,0.1111111111111111,8,8,CGTATGCCAATCACGAGAAG,0,5056251
ykgRp,0.1111111111111111,8,8,CGTAAATGTATTAGCATCAG,0,5033018
ykgRp,0.1111111111111111,8,8,CGGTTTGACGGCAGGCTTCT,0,5043709
ykgRp,0.1111111111111111,8,8,CGGTTTCATACCTCCTAGAC,0,5041400
ykgRp,0.1111111111111111,8,8,CGGGGGTGGTTCCATAAATG,0,5038448
ykgRp,0.1111111111111111,8,8,CGGGGCCTGGCGACACGGCA,0,5059335
ykgRp,0.1111111111111111,8,8,CGGGAGGAACCGCGAAAAAC,0,5037606
ykgRp,0.1111111111111111,8,8,CGGCTCGCCCCTGTGAAGAG,0,5059655
ykgRp,0.1111111111111111,8,8,CGGCAAACGGATGGTAGCGA,0,5042839
ykgRp,0.1111111111111111,8,8,CGGAAGTCCCAGCAGTGAAT,0,5056949
ykgRp,0.1111111111111111,8,8,CGCTTACGCTAGAGGGCATA,0,5043251
ykgRp,0.1111111111111111,8,8,CGCTACAATTTGGAATTTAT,0,5032093
ykgRp,0.1111111111111111,8,8,CGCAAGTACTGTTACGGTTT,0,5032981
ykgRp,0.1111111111111111,8,8,CGAGAGCGAGCGCAACAAAT,0,5046527
ykgRp,0.1111111111111111,8,8,CGACTTGTCCGCGCATGATA,0,5037930
ykgRp,0.1111111111111111,8,8,CGAAGCAGGACGTCGGAAAG,0,5052294
ykgRp,0.1111111111111111,8,8,CGAACCCAAAGTTTTCAGTA,0,5041491
ykgRp,0.1111111111111111,8,8,CCTTACCTTCGTACCCAAAC,0,5046525
ykgRp,0.1111111111111111,8,8,CCTAGCTCATATTCGTTCGA,0,5040824
ykgRp,0.1111111111111111,8,8,CCGCTTGGGATGAACCACAC,0,5042778
ykgRp,0.1111111111111111,8,8,CCCTGGATCCAAGCTGGCCG,0,5044074
ykgRp,0.1111111111111111,8,8,CCCGTAACGTTAGTATCCCT,0,5056155
ykgRp,0.1111111111111111,8,8,CCCCTAGCAGTCAGACCGCC,0,5050385
ykgRp,0.1111111111111111,8,8,CCCCGGAGGGAACGGGTGAT,0,5048904
ykgRp,0.1111111111111111,8,8,CCATTTAACGTGCCCCCGCG,0,5048938
ykgRp,0.1111111111111111,8,8,CCATGGCTTAGGGGATACAA,0,5061280
ykgRp,0.1111111111111111,8,8,CCATCGTCGGGGCATAGGAA,0,5046283
ykgRp,0.1111111111111111,8,8,CCATCGAATGGTTAGACATA,0,5039280
ykgRp,0.1111111111111111,8,8,CCAGATCTCACCTTGGGTTA,0,5047836
ykgRp,0.1111111111111111,8,8,CCACAAACCGAAATTAGGGA,0,5052081
ykgRp,0.1111111111111111,8,8,CCAATAAAGCCAGCAATCAC,0,5059392
ykgRp,0.1111111111111111,8,8,CATTTCGTCCAGCCATCTAT,0,5060664
ykgRp,0.1111111111111111,8,8,CATTAACCATTATTCGGTGT,0,5045145
ykgRp,0.1111111111111111,8,8,CATGGTCAGAGTTTATCTTT,0,5038776
ykgRp,0.1111111111111111,8,8,CAGGCCGGCCGCGTGTGGGA,0,5042000
ykgRp,0.1111111111111111,8,8,CAGGAGTGCTCCGGTGCATA,0,5061692
ykgRp,0.1111111111111111,8,8,CAGATGGCGTTCCCTAGGAG,0,5032980
ykgRp,0.1111111111111111,8,8,CACTCGAGGGACACGCGGCC,0,5034608
ykgRp,0.1111111111111111,8,8,CACGTTTGCATCACTTTCTG,0,5046207
ykgRp,0.1111111111111111,8,8,CACGGCGGCCCTATCTTTAA,0,5041476
ykgRp,0.1111111111111111,8,8,CACGGCCATTCGACGTCCCT,0,5035466
ykgRp,0.1111111111111111,8,8,CACCCAATCAGCCTTACCGT,0,5056398
ykgRp,0.1111111111111111,8,8,CACAGATCGCCCTAGTGGCT,0,5042025
ykgRp,0.1111111111111111,8,8,CAAGTGCGTAAACTCTCAGC,0,5053709
ykgRp,0.1111111111111111,8,8,CAAGCGAACATCTCGAACGC,0,5032095
ykgRp,0.1111111111111111,8,8,CAAGAATTCTAAAGGACAAT,0,5042563
ykgRp,0.1111111111111111,8,8,CAAGAATAATGACGATACGT,0,5038842
ykgRp,0.1111111111111111,8,8,CAAATGTCACGAAGCCGGAG,0,5046246
ykgRp,0.1111111111111111,8,8,CAAACCAAGATGTACACTAG,0,5050515
ykgRp,0.1111111111111111,8,8,ATTTTCGGTACATTGCCTCC,0,5042061
ykgRp,0.1111111111111111,8,8,ATTGTGTGGCAAGGTTAGGC,0,5048241
ykgRp,0.1111111111111111,8,8,ATTCCATTTCCACGTGACGG,0,5034697
ykgRp,0.1111111111111111,8,8,ATTCAGCAAATGACGGAGGG,0,5036994
ykgRp,0.1111111111111111,8,8,ATTAGGATTATTTCGATCGG,0,5052936
ykgRp,0.1111111111111111,8,8,ATTACTGGTGCGTGAGCTTT,0,5051660
ykgRp,0.1111111111111111,8,8,ATGGCCCCATGGACCCCTTG,0,5041882
ykgRp,0.1111111111111111,8,8,ATGCTTACAACTCGCCGTCA,0,5035177
ykgRp,0.1111111111111111,8,8,ATCTGATCCAAGGTACGTCC,0,5048898
ykgRp,0.1111111111111111,8,8,ATCTCCAGTGTGATATCGCA,0,5041849
ykgRp,0.1111111111111111,8,8,ATCTACGGGCGAGGAGAATC,0,5038484
ykgRp,0.1111111111111111,8,8,ATCGTAGAAGGGCTAGTTAA,0,5052133
ykgRp,0.1111111111111111,8,8,ATCGGGTGTCTTGCATAAAA,0,5057136
ykgRp,0.1111111111111111,8,8,ATCCTAAAGGATGACCTGCG,0,5054110
ykgRp,0.1111111111111111,8,8,ATCCAAAGCGCAGATCGGAG,0,5040119
ykgRp,0.1111111111111111,8,8,ATATACACGCCATATGGGCA,0,5037868
ykgRp,0.1111111111111111,8,8,ATAGTAGCCAACACGACATA,0,5045137
ykgRp,0.1111111111111111,8,8,ATACTACTATAACGATACGA,0,5046050
ykgRp,0.1111111111111111,8,8,AGTGTTTCATCCCATTTGAA,0,5053448
ykgRp,0.1111111111111111,8,8,AGTGTGGACTCGGTTGGGCT,0,5052558
ykgRp,0.1111111111111111,8,8,AGTGTAGGCTGCAATCAACG,0,5032110
ykgRp,0.1111111111111111,8,8,AGTGGTACTGACGGCCAAGA,0,5052745
ykgRp,0.1111111111111111,8,8,AGTGGGAACATGTGTTTCGT,0,5056044
ykgRp,0.1111111111111111,8,8,AGTCTGCGCGCATAGTTGTT,0,5044565
ykgRp,0.1111111111111111,8,8,AGTCGATCATGAGCCGCGGA,0,5037454
ykgRp,0.1111111111111111,8,8,AGTAATGTGGGTAGGGTGCC,0,5033926
ykgRp,0.1111111111111111,8,8,AGGAGGCCTTATACTCTTTA,0,5055131
ykgRp,0.1111111111111111,8,8,AGCTTAACGTGGTACCGGGA,0,5043001
ykgRp,0.1111111111111111,8,8,AGCTGTATTTGGCTGCGTGC,0,5053899
ykgRp,0.1111111111111111,8,8,AGCTCCTTTACCTCCACATT,0,5048787
ykgRp,0.1111111111111111,8,8,AGCGCGGCTAGGACACGCCA,0,5049769
ykgRp,0.1111111111111111,8,8,AGATTATCGCCAGGTAGAGA,0,5040199
ykgRp,0.1111111111111111,8,8,AGACGTAAGGTCTTCCAATT,0,5041814
ykgRp,0.1111111111111111,8,8,AGACCTGGGGGCGTACTGTT,0,5035403
ykgRp,0.1111111111111111,8,8,AGAACCTGGATGTTTGGTGA,0,5048764
ykgRp,0.1111111111111111,8,8,ACTTTTTTATACTTACGATA,0,5033834
ykgRp,0.1111111111111111,8,8,ACTTTCATTAAATTTCGACG,0,5044758
ykgRp,0.1111111111111111,8,8,ACTTTAGAGCGCCCTGACTA,0,5059476
ykgRp,0.1111111111111111,8,8,ACTGAGGAAGCATGTCATTA,0,5052691
ykgRp,0.1111111111111111,8,8,ACTAGCCCGTCCATTAGGGG,0,5036942
ykgRp,0.1111111111111111,8,8,ACTACCCATATAAGTAGATA,0,5035075
ykgRp,0.1111111111111111,8,8,ACTAAAACTAGGTTGGCGCT,0,5046384
ykgRp,0.1111111111111111,8,8,ACGGGACAATCCGCCAGCCA,0,5056132
ykgRp,0.1111111111111111,8,8,ACGGCGTGACCTTCAGCGAA,0,5051723
ykgRp,0.1111111111111111,8,8,ACGCTGGGCAGTCCGAGGGT,0,5054224
ykgRp,0.1111111111111111,8,8,ACGAAGGTGTGCTAATCAAA,0,5043388
ykgRp,0.1111111111111111,8,8,ACCTAATTACTGTAAACAAC,0,5033320
ykgRp,0.1111111111111111,8,8,ACCGTGTGCAAGTTAGTTAT,0,5050204
ykgRp,0.1111111111111111,8,8,ACCGGTTGCACGCCCTGACC,0,5042149
ykgRp,0.1111111111111111,8,8,ACCGCGCCATTTGCCTAGGG,0,5048533
ykgRp,0.1111111111111111,8,8,ACCCGTCAGGGACCCATAAT,0,5045781
ykgRp,0.1111111111111111,8,8,ACCCCTCTCAGTCGTCCGTT,0,5037914
ykgRp,0.1111111111111111,8,8,ACCATACAGCTAAGAATATC,0,5036872
ykgRp,0.1111111111111111,8,8,ACAGCGAGATACTAGAGTGA,0,5050632
ykgRp,0.1111111111111111,8,8,AATTAGCTGTCCCGGGGAAC,0,5045150
ykgRp,0.1111111111111111,8,8,AATGATACCGGTTTCGGCTG,0,5059326
ykgRp,0.1111111111111111,8,8,AATCTGGGTGTTAATCGAAC,0,5039338
ykgRp,0.1111111111111111,8,8,AATCAGGCGGGTGAATTGCT,0,5048296
ykgRp,0.1111111111111111,8,8,AATCAACGTTTTCATCCATA,0,5037972
ykgRp,0.1111111111111111,8,8,AAGTGCAGGCTCTCATCGAC,0,5058452
ykgRp,0.1111111111111111,8,8,AAGGTGCACAAATCTTTAGG,0,5053731
ykgRp,0.1111111111111111,8,8,AAGGGTTCTTACTCGCGTTG,0,5036688
ykgRp,0.1111111111111111,8,8,AAGGAAGGTGTTATGGTGAG,0,5035144
ykgRp,0.1111111111111111,8,8,AAGCTTGTGTCCTGCCGGGT,0,5031525
ykgRp,0.1111111111111111,8,8,AACGGTGACCAGCGATCCCC,0,5040458
ykgRp,0.1111111111111111,8,8,AAAGTCTAGGGTTAAATCTA,0,5043218
ykgRp,0.1111111111111111,8,8,AAAGCCCGTTCGCGGCACCG,0,5038970
ykgRp,0.1111111111111111,8,8,AAACGCTCCGACGGGATTTT,0,5035941
ykgRp,0.1111111111111111,8,8,AAAAACGCTTCGTCGCAGAC,0,5050881
ykgRp,0.125,7,7,TTTTCTGACCCCAGACAAGA,0,5052089
ykgRp,0.125,7,7,TTTTAATGGATTATTGGCTA,0,5045750
ykgRp,0.125,7,7,TTTGGGCAGAAATGGGTCCC,0,5048206
ykgRp,0.125,7,7,TTTGGCATGGAGGACCGCTT,0,5037103
ykgRp,0.125,7,7,TTTGATCGCTGCCTCTGGCG,0,5040892
ykgRp,0.125,7,7,TTTCACTGAGGTGATGGTAA,0,5042874
ykgRp,0.125,7,7,TTTAGAGCAAGAGTGTGCAT,0,5058981
ykgRp,0.125,7,7,TTTAAGGGGTCCTGCCGGCC,0,5050665
ykgRp,0.125,7,7,TTGGAATCGGCTAATACGTT,0,5055577
ykgRp,0.125,7,7,TTGCTGACTTCTTTTGCAGG,0,5053544
ykgRp,0.125,7,7,TTGCGATGTAGAACGAATCA,0,5037722
ykgRp,0.125,7,7,TTGAAGATTTTCCCCACGTT,0,5042471
ykgRp,0.125,7,7,TTCTCGCCTTAGTGTGGGAG,0,5048445
ykgRp,0.125,7,7,TTCTACTTGCCTTTTTTGAT,0,5037152
ykgRp,0.125,7,7,TTCGGTAATGACCGGCTGCG,0,5032875
ykgRp,0.125,7,7,TTCGCCATTTGATCGACTAG,0,5041679
ykgRp,0.125,7,7,TTCCTGATCCTATATCCGAG,0,5038129
ykgRp,0.125,7,7,TTCCCATAGTAGCCACAAGT,0,5034395
ykgRp,0.125,7,7,TTCCACCGTCCGGAAGTTAC,0,5051894
ykgRp,0.125,7,7,TTCAAGCAATGAAGCTATCG,0,5050733
ykgRp,0.125,7,7,TTCAAATAGCGGCCCAGGAG,0,5050260
ykgRp,0.125,7,7,TTATCTTGATTGCTCTGCGA,0,5057549
ykgRp,0.125,7,7,TTAGTTGCACCCTTAGCGGG,0,5033922
ykgRp,0.125,7,7,TTAGCGATACACCAAGAGGA,0,5034233
ykgRp,0.125,7,7,TTAGAGGACGAGTCTCATTG,0,5046491
ykgRp,0.125,7,7,TTACCGGTATTCATTGAATC,0,5043454
ykgRp,0.125,7,7,TGTTCTCAATTATTTTAGAT,0,5039632
ykgRp,0.125,7,7,TGTGTATCGTTAGAGTACAT,0,5060155
ykgRp,0.125,7,7,TGTGGTTTGAGTTGGATCAT,0,5036578
ykgRp,0.125,7,7,TGTGCGTTGGTGCGTACTTT,0,5051848
ykgRp,0.125,7,7,TGTCCACTTGGGTTACCGCC,0,5057689
ykgRp,0.125,7,7,TGTACTAAGCTTGGTGGAGT,0,5033024
ykgRp,0.125,7,7,TGGTTCTGCAGCTACCACAA,0,5046737
ykgRp,0.125,7,7,TGGGTCTTATGCGAGGCTTT,0,5035958
ykgRp,0.125,7,7,TGGGTCCGCCGTGTGATGGT,0,5040937
ykgRp,0.125,7,7,TGGGGCATCGCCGAAGCACG,0,5060091
ykgRp,0.125,7,7,TGGGGAACATCCAAGAAGAT,0,5033978
ykgRp,0.125,7,7,TGGGAACGGCATCGCTCTGC,0,5042307
ykgRp,0.125,7,7,TGGATGCACAAACATCGAGC,0,5032855
ykgRp,0.125,7,7,TGGACTGGGGTCTGTTAGCC,0,5060248
ykgRp,0.125,7,7,TGCTTTGACCAGAAGGTGTG,0,5050674
ykgRp,0.125,7,7,TGCTGGGGTCGTATGTGTCC,0,5041705
ykgRp,0.125,7,7,TGCTGGACACGCGGGGTTTT,0,5033586
ykgRp,0.125,7,7,TGCCGTAACTCCGGAATTAT,0,5038066
ykgRp,0.125,7,7,TGCATAACGTGCTCCATTGT,0,5053942
ykgRp,0.125,7,7,TGCACTGTTGGCGGACAATT,0,5051405
ykgRp,0.125,7,7,TGATTATAGTCTCGAGCGTC,0,5052861
ykgRp,0.125,7,7,TGAGCCAATCCCCTGTGGCA,0,5044230
ykgRp,0.125,7,7,TCTTCGTCGAGGCCAGCTGC,0,5046158
ykgRp,0.125,7,7,TCTGTATTCACGGTAGGTGT,0,5054738
ykgRp,0.125,7,7,TCTGGTTTCCGCTGGTGGTA,0,5033476
ykgRp,0.125,7,7,TCTGGGTCCAACCGTCAGTT,0,5051441
ykgRp,0.125,7,7,TCTGGCCAGTAAAATGGCTG,0,5058083
ykgRp,0.125,7,7,TCTGATTAGGGCAGCGCCCG,0,5036579
ykgRp,0.125,7,7,TCTCGCACCAGGGCGCCCAG,0,5060755
ykgRp,0.125,7,7,TCGGATCGTATTGTGAGCCT,0,5036314
ykgRp,0.125,7,7,TCGCCAGGGTACGACATTGC,0,5040323
ykgRp,0.125,7,7,TCGATTTGGGCTGAGTTGGG,0,5040580
ykgRp,0.125,7,7,TCGAGGAGGATCCCCCCTAG,0,5056887
ykgRp,0.125,7,7,TCCGTCGATCGGCAGTTTAG,0,5053822
ykgRp,0.125,7,7,TCCGGCGTAATCTAATGAGG,0,5046182
ykgRp,0.125,7,7,TCCCTTAAACTAGCTGTTAG,0,5031888
ykgRp,0.125,7,7,TCCATGTATACGTAATGTTG,0,5040539
ykgRp,0.125,7,7,TCATTTACGTGCCCGTGAGA,0,5054332
ykgRp,0.125,7,7,TCATGAGATGAAGTTGATCA,0,5052979
ykgRp,0.125,7,7,TCATATTAGGCTCCATATGA,0,5038689
ykgRp,0.125,7,7,TCAGTTTGCAGGGTTTATTG,0,5053525
ykgRp,0.125,7,7,TCAATGCTGAGCGGGGCTAG,0,5035596
ykgRp,0.125,7,7,TCAAGGATCGCAAATTAGAT,0,5057948
ykgRp,0.125,7,7,TCAAACCTGAACCGCTTTAC,0,5033752
ykgRp,0.125,7,7,TATTCGTACATCAAATCACC,0,5059070
ykgRp,0.125,7,7,TATTAGTGGCCTTCCAGCTG,0,5041322
ykgRp,0.125,7,7,TATGGGCACTTAAGACAGTC,0,5035359
ykgRp,0.125,7,7,TATCGGGCGTCTCTTACCGT,0,5032606
ykgRp,0.125,7,7,TATCGAGCTCCTGGGACAGC,0,5050041
ykgRp,0.125,7,7,TATATATAGCGAGCATTTGC,0,5053080
ykgRp,0.125,7,7,TAGGTTGATGTGCCCTTAAT,0,5043263
ykgRp,0.125,7,7,TAGCGAAAGGGGCCAACGCC,0,5041490
ykgRp,0.125,7,7,TAGCATTGAACGGCTTGATC,0,5056341
ykgRp,0.125,7,7,TACTTATTTGAACGGGTAGT,0,5037597
ykgRp,0.125,7,7,TACTGATTAAGTTCACTGTC,0,5052236
ykgRp,0.125,7,7,TACCCGCGAGATCTGTCTGT,0,5036194
ykgRp,0.125,7,7,TAACGAAAAACACAGGGCCA,0,5039825
ykgRp,0.125,7,7,TAACATCCTGAGCTCTGAAA,0,5042615
ykgRp,0.125,7,7,TAACACTATTGAGGGCTGTT,0,5044973
ykgRp,0.125,7,7,TAAATGCACACGTTTCCCGT,0,5059349
ykgRp,0.125,7,7,GTTTTTACGTGGTTTCGACC,0,5050662
ykgRp,0.125,7,7,GTTGACCATCGCGATACAAA,0,5043571
ykgRp,0.125,7,7,GTTCGTGCGCATATTGTTAG,0,5040562
ykgRp,0.125,7,7,GTTCCTCTCGCATGATCGGA,0,5051272
ykgRp,0.125,7,7,GTTCAACCAGTGCTGCCATA,0,5038332
ykgRp,0.125,7,7,GTTATGCTTACTGAAAATGG,0,5031361
ykgRp,0.125,7,7,GTTACATTCAGTCCACAAAG,0,5041707
ykgRp,0.125,7,7,GTTAAGCGGGCCCAACTCAT,0,5051939
ykgRp,0.125,7,7,GTGTGCCGAGAACAGTCTGG,0,5039234
ykgRp,0.125,7,7,GTGGTAGACCGGCCTGTTCG,0,5047620
ykgRp,0.125,7,7,GTGGAGAGGATGTACCTCAA,0,5037221
ykgRp,0.125,7,7,GTGCCCATTCCCGTGTCGTA,0,5044940
ykgRp,0.125,7,7,GTCTTTGCATTCTAGCTGAC,0,5057547
ykgRp,0.125,7,7,GTCTTCATCGTTGCAGGGGG,0,5037598
ykgRp,0.125,7,7,GTCTCAACTCAGAGTGCTTT,0,5044837
ykgRp,0.125,7,7,GTCCTAGATGAACTAGATGT,0,5048254
ykgRp,0.125,7,7,GTCAATCGCTGACGTCTTCT,0,5041416
ykgRp,0.125,7,7,GTCAATAATTCATCGCGAAT,0,5040440
ykgRp,0.125,7,7,GTATGTTAACAGGAGGGTTA,0,5043768
ykgRp,0.125,7,7,GTATCATAGATAGCATACAA,0,5051614
ykgRp,0.125,7,7,GTAGTTTTAAGTATCGTCTC,0,5047143
ykgRp,0.125,7,7,GTACGGCTCCAAGGTTTCTA,0,5058694
ykgRp,0.125,7,7,GTACCCGCACGAATTAAAAC,0,5049178
ykgRp,0.125,7,7,GTAATATGGGAGTTAATGTC,0,5046812
ykgRp,0.125,7,7,GTAAGTGTTTGCCCAGGACC,0,5061236
ykgRp,0.125,7,7,GGTTTTCCGTCTTTAGCCCA,0,5056637
ykgRp,0.125,7,7,GGTTGGTGGCTTTACCATTG,0,5061385
ykgRp,0.125,7,7,GGTTCTAACAGTCGAATGAT,0,5041747
ykgRp,0.125,7,7,GGTTACAAAAGGGGCATCGT,0,5036794
ykgRp,0.125,7,7,GGTGTTAAAGGATGGACCTT,0,5057865
ykgRp,0.125,7,7,GGTGAGATCTGGGTCTAACC,0,5061729
ykgRp,0.125,7,7,GGTCTTCTAGGAGCGTTCTT,0,5054771
ykgRp,0.125,7,7,GGTCCGAATGAGTCTTCAGT,0,5042734
ykgRp,0.125,7,7,GGTATACGCCGTGTAAAGGT,0,5038886
ykgRp,0.125,7,7,GGGGGAGGAGGGAATTGCAA,0,5054341
ykgRp,0.125,7,7,GGGGACCTAATATGTTCGGA,0,5058512
ykgRp,0.125,7,7,GGGATTGACTGACCATATAA,0,5042825
ykgRp,0.125,7,7,GGGACTTATGGAAAGTGAGC,0,5052009
ykgRp,0.125,7,7,GGCTCTGACGGAGTGTTGAA,0,5044160
ykgRp,0.125,7,7,GGCGTGATATGCTGGCCCCG,0,5057456
ykgRp,0.125,7,7,GGCGTCCGGGTCCGGTCTCA,0,5048845
ykgRp,0.125,7,7,GGCGGGTGGAACAAAAAAGT,0,5054184
ykgRp,0.125,7,7,GGCGCCGTACATAAACGGAA,0,5044782
ykgRp,0.125,7,7,GGCATGTTACGACGGTGAAT,0,5055001
ykgRp,0.125,7,7,GGCATGGCCAGGCCGACAAC,0,5051584
ykgRp,0.125,7,7,GGATGATTGTCGCTTTACCT,0,5038275
ykgRp,0.125,7,7,GGATATTGGGTGCTTGGTGT,0,5031753
ykgRp,0.125,7,7,GGATAAACGATACCTGTAGT,0,5043049
ykgRp,0.125,7,7,GGAGGACCTTCTACACCAGT,0,5057937
ykgRp,0.125,7,7,GGAGCGTATACCACTTCGTC,0,5034740
ykgRp,0.125,7,7,GGAATGGTCCGGTTAACTAG,0,5057701
ykgRp,0.125,7,7,GGAAAAGATAGCGGCGATAT,0,5045793
ykgRp,0.125,7,7,GCTTCATTTGCGAGCCCAAG,0,5041391
ykgRp,0.125,7,7,GCTCTGCCGCTGTACTCTTA,0,5041480
ykgRp,0.125,7,7,GCTCCACTTGCCGGACAGTC,0,5035020
ykgRp,0.125,7,7,GCTCAGGCACACCTAGAATA,0,5032880
ykgRp,0.125,7,7,GCTAGGCCTGATGCGTGACA,0,5049021
ykgRp,0.125,7,7,GCGGACGTTACTATGTACCG,0,5036655
ykgRp,0.125,7,7,GCGCAGGGACACCTGTAACG,0,5031778
ykgRp,0.125,7,7,GCGATGCTAACCGCAAGCGC,0,5037335
ykgRp,0.125,7,7,GCGAGCTTTTGAGTTGATCA,0,5050920
ykgRp,0.125,7,7,GCGACTCCTGTTTCGGCGGT,0,5043105
ykgRp,0.125,7,7,GCCTCCAAGGGAGACGAACG,0,5039277
ykgRp,0.125,7,7,GCCGGGCTGTACGACCCGTG,0,5046025
ykgRp,0.125,7,7,GCCCGCATCAGTACCCAGCC,0,5058763
ykgRp,0.125,7,7,GCCCATTGGAAGTATTGGGT,0,5039543
ykgRp,0.125,7,7,GCCATGTCCCCACCGGTAAA,0,5047011
ykgRp,0.125,7,7,GCATCCCTCGTGGCAATCTA,0,5042865
ykgRp,0.125,7,7,GCAGACGTCCAGACAACCCC,0,5042263
ykgRp,0.125,7,7,GCACGAGTGTACTTGCGGCA,0,5046213
ykgRp,0.125,7,7,GCACCACAAAAAACACAGAA,0,5039595
ykgRp,0.125,7,7,GCAACTGCCTATTTTAGCCA,0,5056695
ykgRp,0.125,7,7,GATTTTATATACCCATCAGG,0,5042798
ykgRp,0.125,7,7,GATTGACGCCGGTAATGATG,0,5043233
ykgRp,0.125,7,7,GATCGTCAATTGCGGATAGT,0,5034551
ykgRp,0.125,7,7,GATCCTTCCCCCGGTGCGAT,0,5036619
ykgRp,0.125,7,7,GAGCTACCTGCGCAGTGTAC,0,5052220
ykgRp,0.125,7,7,GAGAGGGCATAGCTTCCTGT,0,5040964
ykgRp,0.125,7,7,GAGAGCCCTAGAGCGCGGAT,0,5031741
ykgRp,0.125,7,7,GACGGGATCGGATATCAGTT,0,5043886
ykgRp,0.125,7,7,GACGCAGTTGTTGTTCTTAA,0,5047430
ykgRp,0.125,7,7,GACCCCATTCACTCGCGAAA,0,5041597
ykgRp,0.125,7,7,GAAGGGTTCCAGCAGCAAAA,0,5034192
ykgRp,0.125,7,7,GAAGGGGCGGTTGGGTTTAT,0,5048314
ykgRp,0.125,7,7,GAAGGACAACCTCCACACCT,0,5040811
ykgRp,0.125,7,7,GAACCGCGGTCCCGTCGAAT,0,5051037
ykgRp,0.125,7,7,GAAATCCGTGATGGATGGCT,0,5032213
ykgRp,0.125,7,7,CTTTGTTGCATGTGACGAAC,0,5038605
ykgRp,0.125,7,7,CTTTCGCTGTAGAGGCATAA,0,5036485
ykgRp,0.125,7,7,CTTTAGCGGATTCGCCACTT,0,5032882
ykgRp,0.125,7,7,CTTGATTGGTCTTCACCACA,0,5047102
ykgRp,0.125,7,7,CTTGACACCTTGCAATTAAT,0,5039640
ykgRp,0.125,7,7,CTTAAATGCTGTCTTACGGC,0,5045468
ykgRp,0.125,7,7,CTGTGCAATTTCGACAGCGG,0,5039099
ykgRp,0.125,7,7,CTGTCCTGGCCAATATAAGT,0,5056011
ykgRp,0.125,7,7,CTGCGGTTCCCTTTTTCGTT,0,5055815
ykgRp,0.125,7,7,CTGCCAATGGACCGTAAATA,0,5047439
ykgRp,0.125,7,7,CTGATCGCATCTGGTGCGTT,0,5054229
ykgRp,0.125,7,7,CTGAGACAATGATTAGTTAA,0,5058221
ykgRp,0.125,7,7,CTCTCAGCTACGTAAATTCA,0,5037886
ykgRp,0.125,7,7,CTCGGATGCGGTGGACGGCA,0,5038291
ykgRp,0.125,7,7,CTCGCAGACTACGTAGCCGG,0,5052524
ykgRp,0.125,7,7,CTCAGTGTTCGAATCATTAT,0,5059798
ykgRp,0.125,7,7,CTAGTTCGGGGTTTGTCAAG,0,5035571
ykgRp,0.125,7,7,CTAGCCGCACAGTCAGGCTC,0,5043766
ykgRp,0.125,7,7,CTACTGGTGCGCTGTCCGGA,0,5059228
ykgRp,0.125,7,7,CTAAGACTTCTATAGCGGGC,0,5043831
ykgRp,0.125,7,7,CTAACATGTTAGGTGAAACT,0,5034262
ykgRp,0.125,7,7,CTAAAATCGACGGATGAAGG,0,5050987
ykgRp,0.125,7,7,CGTTTTGAGCGCACACTGAA,0,5051547
ykgRp,0.125,7,7,CGTGTCACGATCCACAGGGT,0,5033231
ykgRp,0.125,7,7,CGTGGTTACCACCACGTTTA,0,5035449
ykgRp,0.125,7,7,CGTGCGCACTCAACTTCACA,0,5050725
ykgRp,0.125,7,7,CGTATTATGTACCTAGAGGA,0,5035445
ykgRp,0.125,7,7,CGGTGGTGGGGGTGTTCACA,0,5046214
ykgRp,0.125,7,7,CGGGTCAGCGTTGGTAGTCA,0,5050154
ykgRp,0.125,7,7,CGGGCTCGGTTGTGTCGAGA,0,5048111
ykgRp,0.125,7,7,CGGCGGAACCAGTTGTGGAT,0,5046271
ykgRp,0.125,7,7,CGGCCGGGTCTCACGATTCG,0,5036911
ykgRp,0.125,7,7,CGGCCGCCTACCTGCGAACA,0,5040503
ykgRp,0.125,7,7,CGGCATTAGAGCTTTGGGGT,0,5035324
ykgRp,0.125,7,7,CGCTGGGGCAACATGGATTA,0,5038290
ykgRp,0.125,7,7,CGCGGGTCGGTCCATCCTGC,0,5034283
ykgRp,0.125,7,7,CGCCGCTAGGATAGATGGAA,0,5037246
ykgRp,0.125,7,7,CGCAGCTGCTCAAGCATCTA,0,5044194
ykgRp,0.125,7,7,CGATTATAACGCACGCTTCC,0,5058914
ykgRp,0.125,7,7,CGATATTCAATATTTATCGT,0,5050761
ykgRp,0.125,7,7,CGAGTTGATCCAGTGTCGCG,0,5051125
ykgRp,0.125,7,7,CGAGTATTAGGTTGATGAGT,0,5043684
ykgRp,0.125,7,7,CGAGGATGTTCCGATTGTAC,0,5034814
ykgRp,0.125,7,7,CGAGATGGACTTGCAAACGA,0,5053806
ykgRp,0.125,7,7,CGAGAGACCTCAAAAAGTTT,0,5034585
ykgRp,0.125,7,7,CGACGGAGGGCTCCATTCTC,0,5052804
ykgRp,0.125,7,7,CCTGTCGGATGAACGATTGC,0,5035061
ykgRp,0.125,7,7,CCTGGGCACGCCAAGTCAGA,0,5048528
ykgRp,0.125,7,7,CCTCATGTCAGCAGCTGCCC,0,5043121
ykgRp,0.125,7,7,CCTAATTTGCCTTCCAACGC,0,5040400
ykgRp,0.125,7,7,CCGTTTCCTCGGACTTTTAC,0,5051018
ykgRp,0.125,7,7,CCGTTTATCAATTTGGGGCG,0,5060526
ykgRp,0.125,7,7,CCGTCCATCTGGGGCGCTTG,0,5048013
ykgRp,0.125,7,7,CCGTCCACGACCGGTGACCC,0,5045622
ykgRp,0.125,7,7,CCGGTATGGGACAGTTCTTC,0,5052626
ykgRp,0.125,7,7,CCGGGAGGGTACCACAGTCG,0,5037528
ykgRp,0.125,7,7,CCGGCTAATTGGGGGTTATT,0,5034545
ykgRp,0.125,7,7,CCGCTGCGCTGCGTGGAAGT,0,5033484
ykgRp,0.125,7,7,CCGCGCACGCTTCGAGGGAG,0,5045118
ykgRp,0.125,7,7,CCCTCCTTGGTGATGATGGT,0,5045466
ykgRp,0.125,7,7,CCCGTCACGAGCGGCATATC,0,5037508
ykgRp,0.125,7,7,CCCGATGTTACCTGTACAAA,0,5048847
ykgRp,0.125,7,7,CCCATTCGTCTTCGTGAATT,0,5045699
ykgRp,0.125,7,7,CCCAACTTAGTCTCAAAAAG,0,5046492
ykgRp,0.125,7,7,CCACCACCGGTAATGTTGAG,0,5054172
ykgRp,0.125,7,7,CCAATCCCACGGCCCGCATG,0,5059057
ykgRp,0.125,7,7,CATTTCTAGTTCGAATATTT,0,5044920
ykgRp,0.125,7,7,CATTCAAATTTAACTCAAAC,0,5055516
ykgRp,0.125,7,7,CATTAAGGCCGTCATTCTCG,0,5054317
ykgRp,0.125,7,7,CATGCAGGGAGCGGCTCACA,0,5041279
ykgRp,0.125,7,7,CATGATTGCTAGTTTTGCGC,0,5049787
ykgRp,0.125,7,7,CATGAGTATGTTTTTAGAAG,0,5054443
ykgRp,0.125,7,7,CATAGAAATGTTCCATATGG,0,5043455
ykgRp,0.125,7,7,CAGTGGTGAACCCTCGTCGA,0,5054657
ykgRp,0.125,7,7,CAGGTCGTGTCGCTGGGTAT,0,5036683
ykgRp,0.125,7,7,CAGGGTCGAACAACCCCGTT,0,5033759
ykgRp,0.125,7,7,CACGGGGTCCCGCTCAGTCT,0,5051433
ykgRp,0.125,7,7,CACCAGATCAGGGATGTGGG,0,5039528
ykgRp,0.125,7,7,CACACACATAAAATCGCAAT,0,5037545
ykgRp,0.125,7,7,CAATTAGGGACATTGTTGGT,0,5043789
ykgRp,0.125,7,7,CAAGTTCATATAGAGAAGTC,0,5038905
ykgRp,0.125,7,7,CAAGGTCAACGAATAAATGG,0,5034351
ykgRp,0.125,7,7,CAAGGCGAGAGCGGGAAGAA,0,5038222
ykgRp,0.125,7,7,CAACAATATTCGCGTGCTGA,0,5047231
ykgRp,0.125,7,7,CAACAACAAACACTGTTAAG,0,5050297
ykgRp,0.125,7,7,CAAAGACCAGGCACTGAAGA,0,5055543
ykgRp,0.125,7,7,CAAACATATAAGTTACGTCC,0,5040398
ykgRp,0.125,7,7,ATTTTTCCGCGTCATCTCTA,0,5051781
ykgRp,0.125,7,7,ATTTTCGTTAGCCATGGGGA,0,5034823
ykgRp,0.125,7,7,ATTTGTTTATTCCACCAACA,0,5034198
ykgRp,0.125,7,7,ATTTGGGGCGGACTAAGGCT,0,5034080
ykgRp,0.125,7,7,ATTCGGGGCCATCTCTAAGT,0,5042831
ykgRp,0.125,7,7,ATTATTCCAGACGGTGCCAG,0,5032673
ykgRp,0.125,7,7,ATTAGTTGTCTTATTGACTC,0,5059951
ykgRp,0.125,7,7,ATTAGCAAGTGTACCAACGA,0,5033661
ykgRp,0.125,7,7,ATGTGCGCATGCTCCGCTCA,0,5048746
ykgRp,0.125,7,7,ATGGGTGTGTCATACCCTGT,0,5040713
ykgRp,0.125,7,7,ATGGGACTAGGAGCACTTGT,0,5044312
ykgRp,0.125,7,7,ATGGGACGATGGAGGAAAGT,0,5049441
ykgRp,0.125,7,7,ATGCAAGACTCTCCCTGCCG,0,5047834
ykgRp,0.125,7,7,ATGAGCCTCGCAGTGAGAAT,0,5039362
ykgRp,0.125,7,7,ATGAGCCAGTCCCGGACAAG,0,5041650
ykgRp,0.125,7,7,ATCTGCACCTGGGGTGTTTC,0,5031966
ykgRp,0.125,7,7,ATCTGATCCGGTGGCTCTGA,0,5059611
ykgRp,0.125,7,7,ATCTCGGTCCCAGTCCCCTG,0,5044871
ykgRp,0.125,7,7,ATCGAGTATGCCGGGAGAAG,0,5040664
ykgRp,0.125,7,7,ATCGACGGGTCAGCCGATCA,0,5059069
ykgRp,0.125,7,7,ATCCGGTAATGAAAAGCTGA,0,5040402
ykgRp,0.125,7,7,ATCAAACGCTCGTGAGTCTG,0,5046497
ykgRp,0.125,7,7,ATATTTCGATCGCCATACCA,0,5057812
ykgRp,0.125,7,7,ATATTATGATTGGGTACGAT,0,5060724
ykgRp,0.125,7,7,ATAGGGCCTGTCCTGGACAG,0,5059862
ykgRp,0.125,7,7,ATAGCCATCCGTCTGAGTTA,0,5056638
ykgRp,0.125,7,7,ATACGGCTCAAATTGCCGGA,0,5054690
ykgRp,0.125,7,7,ATAATTCACGCGGTATTGGT,0,5046371
ykgRp,0.125,7,7,AGTTCGGTCATACAGGGCCT,0,5058983
ykgRp,0.125,7,7,AGTGTTTGTTCTCGTTTATT,0,5031745
ykgRp,0.125,7,7,AGTGTCCAATCGGGCATGTG,0,5043507
ykgRp,0.125,7,7,AGTCTGTGTACAAGAGTGGT,0,5051409
ykgRp,0.125,7,7,AGTCCTTCCACATACTTCTT,0,5049241
ykgRp,0.125,7,7,AGTAGCGGCGCGGGTGACTC,0,5032590
ykgRp,0.125,7,7,AGGTAGATGGTCTGGATTTT,0,5045185
ykgRp,0.125,7,7,AGGGGTTCGCTTGAATGTCG,0,5046044
ykgRp,0.125,7,7,AGGCAACTTGTACTTTCAAT,0,5042989
ykgRp,0.125,7,7,AGGATGTCAGGCCAAAAGCA,0,5049449
ykgRp,0.125,7,7,AGGAATTATAGGCTCATGCA,0,5037088
ykgRp,0.125,7,7,AGCGTCTACCGACGAATTAA,0,5052577
ykgRp,0.125,7,7,AGCGCGGTGCGCCGCAGAGG,0,5051912
ykgRp,0.125,7,7,AGCACATGGGATCAGCATCG,0,5049278
ykgRp,0.125,7,7,AGATTCGCCCGCTGCAACTA,0,5047303
ykgRp,0.125,7,7,AGATCAATGGCCATTCGGAG,0,5053702
ykgRp,0.125,7,7,AGAGTAGTTCAAACCGGACG,0,5059753
ykgRp,0.125,7,7,AGAGCCCTCCTACCGTTCGG,0,5053504
ykgRp,0.125,7,7,AGAATCCTTGGAACGAATAC,0,5045619
ykgRp,0.125,7,7,ACTTTTCGGCTATAGGTGCA,0,5040034
ykgRp,0.125,7,7,ACTTATACAGCATCTTCTGG,0,5034268
ykgRp,0.125,7,7,ACTTACTATTCGATATCTGT,0,5043329
ykgRp,0.125,7,7,ACTTACATCCGGATAATTTA,0,5046334
ykgRp,0.125,7,7,ACTGAAATGTGAGGCAACGC,0,5036679
ykgRp,0.125,7,7,ACTCAGTAAGCATAGTCAGA,0,5058533
ykgRp,0.125,7,7,ACTAAGAGGCTTAATTTGAT,0,5055891
ykgRp,0.125,7,7,ACGTTATGGTAGATAAGATT,0,5060488
ykgRp,0.125,7,7,ACGGCCCTGGCCCACGGATT,0,5055319
ykgRp,0.125,7,7,ACGGACGTGAGTGACGTTGT,0,5042627
ykgRp,0.125,7,7,ACGCCAGGAAGGGAACCCAA,0,5060795
ykgRp,0.125,7,7,ACGATCGGACCCATAATTGT,0,5039199
ykgRp,0.125,7,7,ACGAGGATCGGACGGTTATG,0,5041919
ykgRp,0.125,7,7,ACCTAGCCGGCCTTCCAATA,0,5058493
ykgRp,0.125,7,7,ACCTAACCTTCATCGGTTCA,0,5045749
ykgRp,0.125,7,7,ACCGTCAAACGCATGTGCCT,0,5049454
ykgRp,0.125,7,7,ACCGGTGGGTAGCACCACGG,0,5031939
ykgRp,0.125,7,7,ACATAGCCGGGACCGCATTG,0,5033755
ykgRp,0.125,7,7,ACAGGTCTTCTCCTGCCACT,0,5045553
ykgRp,0.125,7,7,ACAGGAGTGCAGATGGAACA,0,5057354
ykgRp,0.125,7,7,ACAGAGTGCATGCAGCATTG,0,5061049
ykgRp,0.125,7,7,ACAGAAGCACGCACCATTCT,0,5047278
ykgRp,0.125,7,7,ACAAAGCGAAAACGATTGAA,0,5039165
ykgRp,0.125,7,7,AATGTCGATTGGTGTTTGGC,0,5055390
ykgRp,0.125,7,7,AATAGACGCACAGCTATGAG,0,5052688
ykgRp,0.125,7,7,AAGCACGAGCTCTCGAGGCT,0,5044774
ykgRp,0.125,7,7,AAGAGTAACCACTTGATAAG,0,5051277
ykgRp,0.125,7,7,AAGAAATCGTTTTACCGGTT,0,5043091
ykgRp,0.125,7,7,AACTTCCAAGTGGCCAACCA,0,5036500
ykgRp,0.125,7,7,AACTCCGAGATTTCGGTTGA,0,5036545
ykgRp,0.125,7,7,AACGTAACACATCGGACCAG,0,5038028
ykgRp,0.125,7,7,AACCGAATCGGGTCCGGGAA,0,5058762
ykgRp,0.125,7,7,AACAGGGCTGTCACTACATT,0,5032747
ykgRp,0.125,7,7,AACACTAACCTCTACAATAT,0,5041420
ykgRp,0.125,7,7,AAATTGCGTATACAATTTAC,0,5054320
ykgRp,0.125,7,7,AAATAATAGCCCTGAAGCTG,0,5031696
ykgRp,0.125,7,7,AAAGGGTGTCACCCGATAAA,0,5058305
ykgRp,0.125,7,7,AAACGTGCCCAAATTCTAAT,0,5055580
ykgRp,0.125,7,7,AAACGGATAGGGCGCATCCT,0,5044797
ykgRp,0.125,7,7,AAACAATCGGTCCTAACTCC,0,5032197
ykgRp,0.125,7,7,AAAATCGGTGATTGATCGAA,0,5040966
ykgRp,0.125,7,7,AAAACTTATAGTCTATTACC,0,5038277
ykgRp,0.14285714285714285,6,6,TTTGGACTTCAGTCCTAGGT,0,5051225
ykgRp,0.14285714285714285,6,6,TTTCTCGCAAAAGGCTCGGA,0,5051703
ykgRp,0.14285714285714285,6,6,TTTCTACAGGGTTTGACTCA,0,5053081
ykgRp,0.14285714285714285,6,6,TTTCATCAACATGGAAAGAA,0,5044879
ykgRp,0.14285714285714285,6,6,TTTCAAATCTTGAGTTCTTG,0,5044591
ykgRp,0.14285714285714285,6,6,TTGTTATGTAACATATGATT,0,5058783
ykgRp,0.14285714285714285,6,6,TTGTGGTACGATTATTGTAC,0,5035402
ykgRp,0.14285714285714285,6,6,TTGGTCTCGATAACAGACCA,0,5043821
ykgRp,0.14285714285714285,6,6,TTGCACCGTCAAGGCCTGCG,0,5053635
ykgRp,0.14285714285714285,6,6,TTGCACATTAGATCGACGGA,0,5039845
ykgRp,0.14285714285714285,6,6,TTGAGAGTGGCGGTATCTGC,0,5042027
ykgRp,0.14285714285714285,6,6,TTGAAAACACTTATCCAAAT,0,5035566
ykgRp,0.14285714285714285,6,6,TTCCTCGGATGACTGCATAT,0,5044689
ykgRp,0.14285714285714285,6,6,TTCCATTATTAACGCGGGTA,0,5035574
ykgRp,0.14285714285714285,6,6,TTCAGCCGGATGGGTAAGAG,0,5046272
ykgRp,0.14285714285714285,6,6,TTCACTCAACGACTAGAAGG,0,5051139
ykgRp,0.14285714285714285,6,6,TTATGCGGTTGTCACAAACT,0,5049785
ykgRp,0.14285714285714285,6,6,TTATAAGGACAATAATAACA,0,5038112
ykgRp,0.14285714285714285,6,6,TTAGGGCGTTACTCATTAAA,0,5047581
ykgRp,0.14285714285714285,6,6,TTACTGTACAGATATTCTAA,0,5036979
ykgRp,0.14285714285714285,6,6,TTACGTCGCACCAATTTGCT,0,5038186
ykgRp,0.14285714285714285,6,6,TTACCTGGGGCTCCAGACAA,0,5031748
ykgRp,0.14285714285714285,6,6,TTACAATTGAAGGTGGCCTA,0,5059225
ykgRp,0.14285714285714285,6,6,TTAATGCATCAGTGTATTCA,0,5036796
ykgRp,0.14285714285714285,6,6,TGTTTTAGTTGTGCTTTAGA,0,5035666
ykgRp,0.14285714285714285,6,6,TGTTTGGCAGGGTTCGATAA,0,5052673
ykgRp,0.14285714285714285,6,6,TGTTCGCGACTTGGGAAGGC,0,5042012
ykgRp,0.14285714285714285,6,6,TGTTCATGTTCCGAGGACGA,0,5047200
ykgRp,0.14285714285714285,6,6,TGTTAACTCTGGTGACTTAA,0,5041171
ykgRp,0.14285714285714285,6,6,TGTGTGCCGATCTTTTGCTA,0,5056050
ykgRp,0.14285714285714285,6,6,TGTGGCAATTAGTCTATTTC,0,5058655
ykgRp,0.14285714285714285,6,6,TGTCGTGGTAATTGCTCCGG,0,5037932
ykgRp,0.14285714285714285,6,6,TGTCGGTTCCGACACGGAGA,0,5052439
ykgRp,0.14285714285714285,6,6,TGTAGTGTCACCGCGGTCAA,0,5035214
ykgRp,0.14285714285714285,6,6,TGTACGTCAGGTATTACCTG,0,5051551
ykgRp,0.14285714285714285,6,6,TGGTGGCTGCGTTCATAGAA,0,5044279
ykgRp,0.14285714285714285,6,6,TGGTCGCGGTCTAGGGTACG,0,5040914
ykgRp,0.14285714285714285,6,6,TGGGGGGAGCAATCTGCCCC,0,5049510
ykgRp,0.14285714285714285,6,6,TGGCTCCGGATGTGTCGAGG,0,5044153
ykgRp,0.14285714285714285,6,6,TGGCACCCAAAAAGCAGTAC,0,5035502
ykgRp,0.14285714285714285,6,6,TGGCAACGGGGCGGCCAAAG,0,5036623
ykgRp,0.14285714285714285,6,6,TGGAAAGTGGGGGGGTCGCT,0,5046776
ykgRp,0.14285714285714285,6,6,TGCTCGACAACGTCATAAGC,0,5033060
ykgRp,0.14285714285714285,6,6,TGCTCGAAACATGTCAGATT,0,5035613
ykgRp,0.14285714285714285,6,6,TGCTATCACCCTAGCGCTGC,0,5041580
ykgRp,0.14285714285714285,6,6,TGCGGTAGGATCGCCACATA,0,5043087
ykgRp,0.14285714285714285,6,6,TGCCTAGTGCGGACGCAGAT,0,5042495
ykgRp,0.14285714285714285,6,6,TGCAGTCAGGCGATATAGTT,0,5041524
ykgRp,0.14285714285714285,6,6,TGATGGCCTCCTCGACTTAT,0,5054434
ykgRp,0.14285714285714285,6,6,TGACTTACCTCCGTGTACAA,0,5058327
ykgRp,0.14285714285714285,6,6,TGAAGTCAACAATTAGCAGG,0,5045226
ykgRp,0.14285714285714285,6,6,TCTGTTATTCATCAAGGGGC,0,5059189
ykgRp,0.14285714285714285,6,6,TCTCTCATGCTCATGATCAG,0,5042441
ykgRp,0.14285714285714285,6,6,TCTCGGCCACCGTGGGCTCA,0,5034284
ykgRp,0.14285714285714285,6,6,TCTAGAGAGTCCCATGGGGT,0,5048582
ykgRp,0.14285714285714285,6,6,TCTACATATCCGTTACCCGG,0,5039867
ykgRp,0.14285714285714285,6,6,TCGGCATAATGAGGGGGGGG,0,5059769
ykgRp,0.14285714285714285,6,6,TCGAGGCCAATCTCATTAGG,0,5055247
ykgRp,0.14285714285714285,6,6,TCCTTCAGGAGTGCATGGTG,0,5040502
ykgRp,0.14285714285714285,6,6,TCCTTAGTATCCTGCGCATT,0,5046888
ykgRp,0.14285714285714285,6,6,TCCGTTCTGGACAATTGCTG,0,5055482
ykgRp,0.14285714285714285,6,6,TCCGCTTATTGCGGGGTTGA,0,5057211
ykgRp,0.14285714285714285,6,6,TCCCGACGTGTGTGTTACCC,0,5044103
ykgRp,0.14285714285714285,6,6,TCATGCTCACTGATTGCACT,0,5041278
ykgRp,0.14285714285714285,6,6,TCAGGATGTAAGTGTAACGG,0,5056625
ykgRp,0.14285714285714285,6,6,TCAATTCAGGGTTCAAGAGA,0,5041360
ykgRp,0.14285714285714285,6,6,TATTGCAAGGTTCGCCGGCC,0,5047337
ykgRp,0.14285714285714285,6,6,TATGTATACCACTGTTGATG,0,5055918
ykgRp,0.14285714285714285,6,6,TATCGCCCACGGCTGTAGGT,0,5040694
ykgRp,0.14285714285714285,6,6,TATCGACGGTATGAGCCGAA,0,5045524
ykgRp,0.14285714285714285,6,6,TATACCGGAACGTTTCTGGT,0,5044481
ykgRp,0.14285714285714285,6,6,TAGAGAGTCGGAATTATTCA,0,5031780
ykgRp,0.14285714285714285,6,6,TAGACTTGTTGCCATCGTGG,0,5034753
ykgRp,0.14285714285714285,6,6,TACTGGACCAGTGCCGTCTT,0,5043427
ykgRp,0.14285714285714285,6,6,TACTCATTTTTCATACTATT,0,5048303
ykgRp,0.14285714285714285,6,6,TACTATGTCGCGAACGTTTG,0,5061767
ykgRp,0.14285714285714285,6,6,TACGCGTACGAAAGACATGA,0,5052393
ykgRp,0.14285714285714285,6,6,TACCTTGGCCTACGAGGATC,0,5039754
ykgRp,0.14285714285714285,6,6,TACCCACATAGCGATTGGGA,0,5060780
ykgRp,0.14285714285714285,6,6,TAAGCTTAGATTTCCCAAAC,0,5055399
ykgRp,0.14285714285714285,6,6,TAAGCTACGCCAGGACACTT,0,5059843
ykgRp,0.14285714285714285,6,6,TAAGATCTCACCCCGTTAAC,0,5039752
ykgRp,0.14285714285714285,6,6,TAACGTCATAGCTGTATTAA,0,5049251
ykgRp,0.14285714285714285,6,6,TAACCCGGCATTTCGAGTGC,0,5034314
ykgRp,0.14285714285714285,6,6,TAAACAAACCTCCTTTGGCG,0,5054467
ykgRp,0.14285714285714285,6,6,GTTTTACGTCCCATTATTAT,0,5032356
ykgRp,0.14285714285714285,6,6,GTTGTGTGTTGCCTATAGGC,0,5040887
ykgRp,0.14285714285714285,6,6,GTTGATTCTTCAGAACGACT,0,5042844
ykgRp,0.14285714285714285,6,6,GTTGATAGGCCGCGTGTCTT,0,5042636
ykgRp,0.14285714285714285,6,6,GTTCTTTAGATCTTGGCGAC,0,5055576
ykgRp,0.14285714285714285,6,6,GTTCTTTACAATCGCTATAG,0,5052641
ykgRp,0.14285714285714285,6,6,GTTCGCGGGGATAACAGTGT,0,5033885
ykgRp,0.14285714285714285,6,6,GTTCATTGGCATGGTCTAAC,0,5054134
ykgRp,0.14285714285714285,6,6,GTGTGGAAACCAGATCGCGA,0,5046089
ykgRp,0.14285714285714285,6,6,GTGGGTAGAATATGCACAAT,0,5052863
ykgRp,0.14285714285714285,6,6,GTGGCTCTACCTTTATTCGG,0,5060117
ykgRp,0.14285714285714285,6,6,GTGGCTAACGGCTTTACCGT,0,5035568
ykgRp,0.14285714285714285,6,6,GTGGCGAACGTCAAAAACTA,0,5049333
ykgRp,0.14285714285714285,6,6,GTGCCTAGAGGCTATGGGGG,0,5045966
ykgRp,0.14285714285714285,6,6,GTCTTCTATTGTCCGAGTAA,0,5051054
ykgRp,0.14285714285714285,6,6,GTCCTCCGTCGTGAGGTGCA,0,5044747
ykgRp,0.14285714285714285,6,6,GTCCGCGAACGTTGGCGGCA,0,5056502
ykgRp,0.14285714285714285,6,6,GTCATTGTTTAATCTCCTCA,0,5048770
ykgRp,0.14285714285714285,6,6,GTCATGTGCTCGCAGCAGAA,0,5056387
ykgRp,0.14285714285714285,6,6,GTCAGGCAACGGTTCATCCC,0,5053411
ykgRp,0.14285714285714285,6,6,GTCAAAAAAAGAAAAACTGA,0,5040105
ykgRp,0.14285714285714285,6,6,GTATCTTATTCGTATGTACA,0,5042752
ykgRp,0.14285714285714285,6,6,GTATATGAAACGTACGCGAG,0,5038445
ykgRp,0.14285714285714285,6,6,GTATATCGGGGAGGTCCCAT,0,5035503
ykgRp,0.14285714285714285,6,6,GTAGTCGGTCATGGTACTGG,0,5041716
ykgRp,0.14285714285714285,6,6,GTAGGGTCCAAAAGGACATA,0,5056182
ykgRp,0.14285714285714285,6,6,GTACGGCTCCCAGTGCGCAA,0,5034741
ykgRp,0.14285714285714285,6,6,GTACACGATCTTCAAGCGGG,0,5041723
ykgRp,0.14285714285714285,6,6,GTACAAGAATCAGAGATATT,0,5057600
ykgRp,0.14285714285714285,6,6,GTAATTATATATGGGTGATG,0,5031372
ykgRp,0.14285714285714285,6,6,GTAACCTCCTTACACGACAT,0,5040540
ykgRp,0.14285714285714285,6,6,GTAAATCCGCTCTCTGTGTC,0,5051527
ykgRp,0.14285714285714285,6,6,GGTTGGACGAGCCAGGCAGC,0,5050096
ykgRp,0.14285714285714285,6,6,GGTGTGAGCCAGCTCATATG,0,5036849
ykgRp,0.14285714285714285,6,6,GGTCCGTTAGGGCCACTCGT,0,5047903
ykgRp,0.14285714285714285,6,6,GGTATAGGATCCTAGGACTG,0,5041781
ykgRp,0.14285714285714285,6,6,GGTAGTACGAGTAGAAGACT,0,5053976
ykgRp,0.14285714285714285,6,6,GGTACATGGTTGCCTGTGCC,0,5054875
ykgRp,0.14285714285714285,6,6,GGTACACTTGTTACTGCAAG,0,5056091
ykgRp,0.14285714285714285,6,6,GGGTGAGACCATTGAATCCA,0,5044254
ykgRp,0.14285714285714285,6,6,GGGTCGGCAGGTAAGCCGAG,0,5046023
ykgRp,0.14285714285714285,6,6,GGGTAAATGAATGTAAAGGC,0,5041231
ykgRp,0.14285714285714285,6,6,GGGGCGTGATGAGATTCGTA,0,5041401
ykgRp,0.14285714285714285,6,6,GGGCTAATCACTCTGAAGTC,0,5035582
ykgRp,0.14285714285714285,6,6,GGGCGGCTCTGCATATGAGT,0,5043041
ykgRp,0.14285714285714285,6,6,GGGCGCTAACCCCCGATTCT,0,5039516
ykgRp,0.14285714285714285,6,6,GGGACTGGCATCGTCTTTTC,0,5059854
ykgRp,0.14285714285714285,6,6,GGGAACGGGGAAGTAGTGTT,0,5042861
ykgRp,0.14285714285714285,6,6,GGGAAAACCTTCATAGAGGA,0,5038429
ykgRp,0.14285714285714285,6,6,GGCGGGATAAGAAACAAAAT,0,5040511
ykgRp,0.14285714285714285,6,6,GGCGCCCTTCAGAATCCCCT,0,5053545
ykgRp,0.14285714285714285,6,6,GGCGCAATCCAGACATCAAG,0,5060477
ykgRp,0.14285714285714285,6,6,GGCCCGGAGAGTGAGTACTA,0,5032182
ykgRp,0.14285714285714285,6,6,GGCCCATAGTGCTCCTCAAT,0,5033886
ykgRp,0.14285714285714285,6,6,GGCAGCAGACCGGCAGACCC,0,5055777
ykgRp,0.14285714285714285,6,6,GGCAAGTGGACCCGATGAAA,0,5033964
ykgRp,0.14285714285714285,6,6,GGATTTGCTATCGCTTCTGA,0,5056897
ykgRp,0.14285714285714285,6,6,GGATCAGGACTAGGGCACAA,0,5057931
ykgRp,0.14285714285714285,6,6,GGACTTATGGTGGGGGGGCA,0,5034183
ykgRp,0.14285714285714285,6,6,GGAAGGCTGGTCACAGATGG,0,5033126
ykgRp,0.14285714285714285,6,6,GGAACCAACGGTTGGAGGTA,0,5040371
ykgRp,0.14285714285714285,6,6,GGAAATCAATCTAGGGCATG,0,5052099
ykgRp,0.14285714285714285,6,6,GGAAAGCGATGCGCCAATGA,0,5033171
ykgRp,0.14285714285714285,6,6,GGAAAACATCGACACCATGA,0,5041110
ykgRp,0.14285714285714285,6,6,GCTTGTCCCGTGATCGTTAA,0,5053325
ykgRp,0.14285714285714285,6,6,GCTTGCCGCAAGTGTCGAAG,0,5034189
ykgRp,0.14285714285714285,6,6,GCTCTACCCAGGTAATGATT,0,5058790
ykgRp,0.14285714285714285,6,6,GCTATCTCACTTTGCGCGCC,0,5040666
ykgRp,0.14285714285714285,6,6,GCTACGGCCTACCCGGCCCG,0,5038093
ykgRp,0.14285714285714285,6,6,GCTACCACCACATAGAGCAG,0,5037385
ykgRp,0.14285714285714285,6,6,GCGTTTAGTACTGTTCGGCG,0,5048161
ykgRp,0.14285714285714285,6,6,GCGTATCTATGTACAGGGGG,0,5056063
ykgRp,0.14285714285714285,6,6,GCGGTTATCGGAGAACAGGT,0,5039519
ykgRp,0.14285714285714285,6,6,GCGGGCTTGCAGCTCAATAT,0,5060024
ykgRp,0.14285714285714285,6,6,GCGCGTCTGATCATCAGTGT,0,5032891
ykgRp,0.14285714285714285,6,6,GCGCGTCAACATGTACCATT,0,5047275
ykgRp,0.14285714285714285,6,6,GCGCCCTGAATACCTCAAAC,0,5051481
ykgRp,0.14285714285714285,6,6,GCGATGTTAGTAGGCAGGAC,0,5061473
ykgRp,0.14285714285714285,6,6,GCGATAGCCAATTGGATGCG,0,5033951
ykgRp,0.14285714285714285,6,6,GCGAGCAGTCTCTCTGTTGG,0,5032645
ykgRp,0.14285714285714285,6,6,GCGAGAGTACAAATAGGTTA,0,5033621
ykgRp,0.14285714285714285,6,6,GCCTGTTTGTCCCAGGGCGT,0,5040478
ykgRp,0.14285714285714285,6,6,GCCTCTAGTAGAGGTCATGT,0,5037931
ykgRp,0.14285714285714285,6,6,GCCTCGTGTCACCAAAATCA,0,5038314
ykgRp,0.14285714285714285,6,6,GCCTACAAGTTTGTACAATA,0,5048852
ykgRp,0.14285714285714285,6,6,GCCGGAACCGTCAAGAGTAG,0,5040716
ykgRp,0.14285714285714285,6,6,GCCCTTCGAGTAATCACGAG,0,5040527
ykgRp,0.14285714285714285,6,6,GCCCTCCGAACCACTGTCGT,0,5036115
ykgRp,0.14285714285714285,6,6,GCCCCGAGTACCCCATGTCA,0,5038134
ykgRp,0.14285714285714285,6,6,GCCCAGCATGGGTACTGGAC,0,5040114
ykgRp,0.14285714285714285,6,6,GCCATATTTTTAAGAAACTG,0,5035905
ykgRp,0.14285714285714285,6,6,GCATTCACATATGGGATCGG,0,5061429
ykgRp,0.14285714285714285,6,6,GCATTAGAAATACGCACGAC,0,5059276
ykgRp,0.14285714285714285,6,6,GCATGAAGCAAGAAATAGAA,0,5033478
ykgRp,0.14285714285714285,6,6,GCAGAACTGTCGGCGCCGTG,0,5033017
ykgRp,0.14285714285714285,6,6,GCACAGCCCCATTGACAGGC,0,5034527
ykgRp,0.14285714285714285,6,6,GCAATCAGTTGGTTAAGAAC,0,5031410
ykgRp,0.14285714285714285,6,6,GCAAGGCGCGGCATAAATGG,0,5044015
ykgRp,0.14285714285714285,6,6,GCAAGAGAAGCCATCGGTCT,0,5039695
ykgRp,0.14285714285714285,6,6,GCAAAGTTTAAAGGTCTCGT,0,5038954
ykgRp,0.14285714285714285,6,6,GATTTGTCTGACTCTGGGTC,0,5047161
ykgRp,0.14285714285714285,6,6,GATTCGAGTGAATCCCGTCG,0,5034983
ykgRp,0.14285714285714285,6,6,GATGCGTGCTAGCGGGCAAA,0,5061769
ykgRp,0.14285714285714285,6,6,GATGACTCCGCGGTGTCTCA,0,5050551
ykgRp,0.14285714285714285,6,6,GATCTGTGACAGCCCCAAAT,0,5056611
ykgRp,0.14285714285714285,6,6,GATCAGCAGGCCCGAACGAA,0,5037243
ykgRp,0.14285714285714285,6,6,GAGTGGGGTCTCCTATGTGC,0,5045641
ykgRp,0.14285714285714285,6,6,GAGTCCGGTCCTCGCTCCCT,0,5055564
ykgRp,0.14285714285714285,6,6,GAGGTGATAGCTGTGTCGAT,0,5035055
ykgRp,0.14285714285714285,6,6,GAGGATACGTGGACTTAGGG,0,5041953
ykgRp,0.14285714285714285,6,6,GACTTTGGAAATTAGTATGG,0,5061127
ykgRp,0.14285714285714285,6,6,GACTTATACATTTAGGATCG,0,5056782
ykgRp,0.14285714285714285,6,6,GACTGCAAGATGTTACGCGA,0,5055860
ykgRp,0.14285714285714285,6,6,GACCGCCTTCTTCAGACCTC,0,5043854
ykgRp,0.14285714285714285,6,6,GACCCCGTCCCTCTAGTAAC,0,5050251
ykgRp,0.14285714285714285,6,6,GACCAGATGTGGACCCTCTA,0,5039619
ykgRp,0.14285714285714285,6,6,GACAGCTCGGGGAGTACACC,0,5060700
ykgRp,0.14285714285714285,6,6,GACACACGAACGGACTCCTA,0,5045941
ykgRp,0.14285714285714285,6,6,GAATTTACTGTGGTTGCATC,0,5055520
ykgRp,0.14285714285714285,6,6,GAATCTGGCAAATGGGGCAT,0,5045277
ykgRp,0.14285714285714285,6,6,GAACTCAGGTACGAACACCG,0,5057458
ykgRp,0.14285714285714285,6,6,GAACCATCAACTATCCATTA,0,5043995
ykgRp,0.14285714285714285,6,6,GAACATCCGCAAATTGTCAG,0,5036656
ykgRp,0.14285714285714285,6,6,CTTTGCGAATCCGGTGAGGT,0,5051385
ykgRp,0.14285714285714285,6,6,CTTTCGGGATATTCGTGATA,0,5040470
ykgRp,0.14285714285714285,6,6,CTTGTATCGTTAAGAATTTG,0,5046305
ykgRp,0.14285714285714285,6,6,CTTGGGGTGTAGGTGTTCGT,0,5041695
ykgRp,0.14285714285714285,6,6,CTTGCACGAAATCGGCGGGA,0,5033131
ykgRp,0.14285714285714285,6,6,CTTGCAACTGTACAATCCAG,0,5034064
ykgRp,0.14285714285714285,6,6,CTTGACGGTTATTGTTACGA,0,5045678
ykgRp,0.14285714285714285,6,6,CTTGAATCAGAGGGTCCAAA,0,5046024
ykgRp,0.14285714285714285,6,6,CTTACAGCAGGTGTGTTATC,0,5041611
ykgRp,0.14285714285714285,6,6,CTGGTGCTCCTTCAAACAGA,0,5046656
ykgRp,0.14285714285714285,6,6,CTGGTAGTATGCCCTCGGCC,0,5032729
ykgRp,0.14285714285714285,6,6,CTGGCGCTTCCCAACTGGCG,0,5052343
ykgRp,0.14285714285714285,6,6,CTGGACGGGAAGGGCGAAAT,0,5047898
ykgRp,0.14285714285714285,6,6,CTGCAGACCTGACAACGCCT,0,5047575
ykgRp,0.14285714285714285,6,6,CTGATAGGCTTCGCATCCGT,0,5042187
ykgRp,0.14285714285714285,6,6,CTGATAATTCCTCGGATGAT,0,5031610
ykgRp,0.14285714285714285,6,6,CTGAGACATCCACTATGTTA,0,5038593
ykgRp,0.14285714285714285,6,6,CTGACCAAATCCTGGGATCC,0,5049884
ykgRp,0.14285714285714285,6,6,CTCTAGGTGGCGCCATGATA,0,5050917
ykgRp,0.14285714285714285,6,6,CTCGAATAACGTTGCGATGT,0,5057422
ykgRp,0.14285714285714285,6,6,CTCCTGGGAGCGTCCACGGT,0,5048690
ykgRp,0.14285714285714285,6,6,CTCCCTCACACCTGCCTTGG,0,5049086
ykgRp,0.14285714285714285,6,6,CTCACCCGCGCGTGTCATTG,0,5039772
ykgRp,0.14285714285714285,6,6,CTATTGCTATCCGTTCATAG,0,5035140
ykgRp,0.14285714285714285,6,6,CTAGACTCACGTTGGATAGA,0,5041213
ykgRp,0.14285714285714285,6,6,CTACTAGAACGCGGGCCGCC,0,5053965
ykgRp,0.14285714285714285,6,6,CTACGGAGAGACTAACAGAG,0,5061464
ykgRp,0.14285714285714285,6,6,CTACAACGTGTAACCTAACT,0,5045782
ykgRp,0.14285714285714285,6,6,CTACAACAACTTCCTTTTCC,0,5043266
ykgRp,0.14285714285714285,6,6,CTAATGCAGCGGTTCACGAA,0,5053205
ykgRp,0.14285714285714285,6,6,CGTTAAAAATCTACGTCTGC,0,5044438
ykgRp,0.14285714285714285,6,6,CGTGTCGTTCCGCCTAGAGT,0,5033617
ykgRp,0.14285714285714285,6,6,CGTCAGGTGTTAGCGACACG,0,5059134
ykgRp,0.14285714285714285,6,6,CGGGTGACATGAGTGCACCT,0,5033138
ykgRp,0.14285714285714285,6,6,CGGGTCGTTTGGGGGTGTTT,0,5051804
ykgRp,0.14285714285714285,6,6,CGGGTCATTAGTGTTCAACT,0,5055906
ykgRp,0.14285714285714285,6,6,CGGGAACCTCTACAGTCTCA,0,5044839
ykgRp,0.14285714285714285,6,6,CGGCTCCAACTGCCACTCAC,0,5044872
ykgRp,0.14285714285714285,6,6,CGGCGATAATTGCTGTGAAT,0,5050554
ykgRp,0.14285714285714285,6,6,CGGCAACCGGGGCATTATAC,0,5035748
ykgRp,0.14285714285714285,6,6,CGGAGTCCGGAAGGAATAAT,0,5046782
ykgRp,0.14285714285714285,6,6,CGGACAACGCGAAGTCTTAC,0,5038630
ykgRp,0.14285714285714285,6,6,CGGAATCACTTGTGAGAATT,0,5043239
ykgRp,0.14285714285714285,6,6,CGGAACTTGTTCACTACATT,0,5050640
ykgRp,0.14285714285714285,6,6,CGCGTCATTAGTTATCCCGA,0,5055538
ykgRp,0.14285714285714285,6,6,CGCGTAGGGTTATATGATGT,0,5052253
ykgRp,0.14285714285714285,6,6,CGCCAATTTAGTCACGACCA,0,5036307
ykgRp,0.14285714285714285,6,6,CGCACGGGAGGTAAGATTCG,0,5042685
ykgRp,0.14285714285714285,6,6,CGATTTCCGACAAGTGATTC,0,5037957
ykgRp,0.14285714285714285,6,6,CGATCAGGTTCGCTCTGCCT,0,5043653
ykgRp,0.14285714285714285,6,6,CGACTTAGTTTGCCTGAACT,0,5045832
ykgRp,0.14285714285714285,6,6,CGACAGAACATAAAAGACTC,0,5047777
ykgRp,0.14285714285714285,6,6,CGAATAAGTGTTTTCCAGGT,0,5035087
ykgRp,0.14285714285714285,6,6,CGAAACATAAAGTTTTCACG,0,5044678
ykgRp,0.14285714285714285,6,6,CCTGTGACCGCAGTTAACTT,0,5051601
ykgRp,0.14285714285714285,6,6,CCTGGGTTAAGGGGACCAGT,0,5059485
ykgRp,0.14285714285714285,6,6,CCTGGGTGGCAGGAGTATGG,0,5041376
ykgRp,0.14285714285714285,6,6,CCTGGACATGTTGATACAAG,0,5044130
ykgRp,0.14285714285714285,6,6,CCTGGAATTCCAACCCACGT,0,5047817
ykgRp,0.14285714285714285,6,6,CCTGCGAACCTGGAGAGCCA,0,5034839
ykgRp,0.14285714285714285,6,6,CCTGCATAGATGATCTATAA,0,5053157
ykgRp,0.14285714285714285,6,6,CCGTTTAGCTCCAGTCCGCG,0,5033595
ykgRp,0.14285714285714285,6,6,CCGTCGGTACTTAGGGCGTT,0,5052295
ykgRp,0.14285714285714285,6,6,CCGCGTAGATATTCCGTCCA,0,5035499
ykgRp,0.14285714285714285,6,6,CCGCCTTGACCCCAAGTATG,0,5044820
ykgRp,0.14285714285714285,6,6,CCGCCCCACGCCATTGCCAT,0,5044752
ykgRp,0.14285714285714285,6,6,CCGACTATTATTGTTCCGTA,0,5044222
ykgRp,0.14285714285714285,6,6,CCCGCAGGCGATTCTGGGAT,0,5051548
ykgRp,0.14285714285714285,6,6,CCCCACTCAGTTGAGCGGTG,0,5035899
ykgRp,0.14285714285714285,6,6,CCCACAACGATCGCCACCAC,0,5037010
ykgRp,0.14285714285714285,6,6,CCCAAAAGGGGAGCGGCATA,0,5036754
ykgRp,0.14285714285714285,6,6,CCATGTCCTGTGTACCCGAT,0,5061315
ykgRp,0.14285714285714285,6,6,CCAGTTATTTGACCACCCAA,0,5031366
ykgRp,0.14285714285714285,6,6,CCAGTGATGAAACGGGACCA,0,5049305
ykgRp,0.14285714285714285,6,6,CCACGTATTTGATGGGAACC,0,5056067
ykgRp,0.14285714285714285,6,6,CCACCGAGGGCGGTTGTCAT,0,5041314
ykgRp,0.14285714285714285,6,6,CCAACATATATGCAAAGTGG,0,5048164
ykgRp,0.14285714285714285,6,6,CCAAAGGCAAAATGCATCAA,0,5042407
ykgRp,0.14285714285714285,6,6,CCAAAGAGCTTGGAGGGATC,0,5051476
ykgRp,0.14285714285714285,6,6,CATGGGACGGCTCAAACAAA,0,5040651
ykgRp,0.14285714285714285,6,6,CATGGAGCAGCGCATGGTAG,0,5039838
ykgRp,0.14285714285714285,6,6,CATGAGTCTGAAATCTCAAT,0,5043820
ykgRp,0.14285714285714285,6,6,CATCTCATCTCACAGCCTGT,0,5053676
ykgRp,0.14285714285714285,6,6,CATCCCATGTCGGGAATCGC,0,5059788
ykgRp,0.14285714285714285,6,6,CATACGAGAGTCACGACCGA,0,5034075
ykgRp,0.14285714285714285,6,6,CAGTTAGGTTTCGTGCATAA,0,5038483
ykgRp,0.14285714285714285,6,6,CAGTGGCATGTTGCATTGGG,0,5046561
ykgRp,0.14285714285714285,6,6,CAGGTTTCACAAAAGGACAT,0,5043300
ykgRp,0.14285714285714285,6,6,CAGGTTGAACTGTGGGTCTT,0,5056991
ykgRp,0.14285714285714285,6,6,CAGGTACTCGCATTCGCAAC,0,5044162
ykgRp,0.14285714285714285,6,6,CAGGATTGGGGACTGGCAGA,0,5052224
ykgRp,0.14285714285714285,6,6,CAGGAAGGATTATTGTGTTA,0,5036968
ykgRp,0.14285714285714285,6,6,CAGGAAACATGACCCGATTT,0,5061671
ykgRp,0.14285714285714285,6,6,CAGCTTTTAGGTTAGGTCAG,0,5033730
ykgRp,0.14285714285714285,6,6,CAGCGGTCGCTTAAAAAAAT,0,5053763
ykgRp,0.14285714285714285,6,6,CAGCGCATCAGAGGCTAGGT,0,5041169
ykgRp,0.14285714285714285,6,6,CAGACTATAGGGTCAAACAC,0,5048181
ykgRp,0.14285714285714285,6,6,CACTCCTATCAGACGTGTGT,0,5031899
ykgRp,0.14285714285714285,6,6,CACGGCAGCCAGGTCTGCGT,0,5049901
ykgRp,0.14285714285714285,6,6,CACGCCACCCAAGCTCATGT,0,5032140
ykgRp,0.14285714285714285,6,6,CACCTCGAACACTCGCATCC,0,5058592
ykgRp,0.14285714285714285,6,6,CAATTACGTCATACTGGATA,0,5031901
ykgRp,0.14285714285714285,6,6,CAAGGTCGCCACAAAGTCAT,0,5046543
ykgRp,0.14285714285714285,6,6,CAAGGACTGCCTACCTCGTA,0,5051611
ykgRp,0.14285714285714285,6,6,CAAGAACGGCAAGTTCGGTT,0,5031724
ykgRp,0.14285714285714285,6,6,CAACTTGTGTCAAGGAGCGA,0,5053144
ykgRp,0.14285714285714285,6,6,CAACGGATCTGCGCGCGAAC,0,5037548
ykgRp,0.14285714285714285,6,6,CAACCATTTTTCCCTTGCAT,0,5035358
ykgRp,0.14285714285714285,6,6,CAAACTGAGAGACGACAAAA,0,5048707
ykgRp,0.14285714285714285,6,6,CAAAAATTCCCTACGGGTGT,0,5037115
ykgRp,0.14285714285714285,6,6,ATTTGGTCTGCCGTAGGCTG,0,5033742
ykgRp,0.14285714285714285,6,6,ATTTGAGGGTCTCCAACCAA,0,5043219
ykgRp,0.14285714285714285,6,6,ATTGGTCTCTCAGCTATGTA,0,5054418
ykgRp,0.14285714285714285,6,6,ATTGAGACTAATTGGCTAGA,0,5056114
ykgRp,0.14285714285714285,6,6,ATTACGGAGTAGGGTTGTAG,0,5056476
ykgRp,0.14285714285714285,6,6,ATGTTTCCATCTTAAGCACG,0,5043744
ykgRp,0.14285714285714285,6,6,ATGTGTCGTACTCTTAGTGC,0,5056658
ykgRp,0.14285714285714285,6,6,ATGTGCGATTGGTCGGGTTG,0,5036308
ykgRp,0.14285714285714285,6,6,ATGTACACCGACACCAAGGC,0,5046429
ykgRp,0.14285714285714285,6,6,ATGGACGAATCCCGTTTTCC,0,5044302
ykgRp,0.14285714285714285,6,6,ATGGACCGAATCGCAAATTT,0,5054262
ykgRp,0.14285714285714285,6,6,ATGCTTCCAAGCGAGGCCCA,0,5047368
ykgRp,0.14285714285714285,6,6,ATGCGGTCACACGTTCTAAG,0,5056943
ykgRp,0.14285714285714285,6,6,ATGCGGCCGGGACGAATTTC,0,5034256
ykgRp,0.14285714285714285,6,6,ATGCAGTAATCCTCGGTTCT,0,5046432
ykgRp,0.14285714285714285,6,6,ATGACTAATCTCACGTTTTG,0,5038095
ykgRp,0.14285714285714285,6,6,ATCGTTAACGTAGACGGGGG,0,5043170
ykgRp,0.14285714285714285,6,6,ATCGTGGGTTTTAGATATAT,0,5058647
ykgRp,0.14285714285714285,6,6,ATCGTGGAGGAATGGGTTGC,0,5056947
ykgRp,0.14285714285714285,6,6,ATCGCGCTTCGTTCGCCCTG,0,5054644
ykgRp,0.14285714285714285,6,6,ATCGATACTACTTTCCAAGT,0,5032008
ykgRp,0.14285714285714285,6,6,ATCCCGCAATCTTGCAATTA,0,5054688
ykgRp,0.14285714285714285,6,6,ATCCCGAGACAGAATCGCGG,0,5046456
ykgRp,0.14285714285714285,6,6,ATCCAAGGTGTGGCAAGATT,0,5047094
ykgRp,0.14285714285714285,6,6,ATCAGTTGGCTTCCCTGTAC,0,5053532
ykgRp,0.14285714285714285,6,6,ATCAGTCTGAGTAGTGCCAG,0,5051261
ykgRp,0.14285714285714285,6,6,ATCAAAGTCGCATCGCGCGT,0,5061090
ykgRp,0.14285714285714285,6,6,ATATTCCCCGTAGAATCTCA,0,5039844
ykgRp,0.14285714285714285,6,6,ATATGCAGACTTAAGGTCTT,0,5040889
ykgRp,0.14285714285714285,6,6,ATAGCAGGTAGTTACCTGAT,0,5039166
ykgRp,0.14285714285714285,6,6,ATAGACCACACGGAAATTAG,0,5056092
ykgRp,0.14285714285714285,6,6,ATACGTTGTATGTTAGCGAA,0,5046883
ykgRp,0.14285714285714285,6,6,ATACGACGCCACAAGAATAC,0,5049100
ykgRp,0.14285714285714285,6,6,AGTTTGCAATACCAACGATC,0,5043752
ykgRp,0.14285714285714285,6,6,AGTTTCGTTTGTGAGTCATC,0,5032999
ykgRp,0.14285714285714285,6,6,AGTTGTCAGGTACCCGCCAG,0,5050409
ykgRp,0.14285714285714285,6,6,AGTTAACAAATTGCACGGGT,0,5041499
ykgRp,0.14285714285714285,6,6,AGTGGTTACTCTGCACCGCC,0,5036311
ykgRp,0.14285714285714285,6,6,AGTGAGTCGCGTCTTGCGCC,0,5061330
ykgRp,0.14285714285714285,6,6,AGTATGCGTCAAGAGTTCGT,0,5047181
ykgRp,0.14285714285714285,6,6,AGTAGTTTTCATTGATGGCG,0,5050330
ykgRp,0.14285714285714285,6,6,AGTAGGTACAATCGGAAGCT,0,5038173
ykgRp,0.14285714285714285,6,6,AGGGGGATCAAACGCCTTAA,0,5039435
ykgRp,0.14285714285714285,6,6,AGGGATAGATGTTCCGTTAT,0,5047489
ykgRp,0.14285714285714285,6,6,AGGCGCATGATATCGGGGAA,0,5039580
ykgRp,0.14285714285714285,6,6,AGGAAGAATTGGAGCGCGTC,0,5033391
ykgRp,0.14285714285714285,6,6,AGCTTATAACCACGTGTAGC,0,5038808
ykgRp,0.14285714285714285,6,6,AGCGTGGGGCTCTTCTCCTA,0,5038926
ykgRp,0.14285714285714285,6,6,AGCGTATCTCCAGAAACCGT,0,5054698
ykgRp,0.14285714285714285,6,6,AGCGCGGTTTGAGAAACCGT,0,5039593
ykgRp,0.14285714285714285,6,6,AGCCCTCTCCAACTAATCAA,0,5038013
ykgRp,0.14285714285714285,6,6,AGCATCCGCGGACATCTGCT,0,5051593
ykgRp,0.14285714285714285,6,6,AGCAGGTTCATATTAATAGC,0,5041618
ykgRp,0.14285714285714285,6,6,AGCACCGTGGTCGGATCAGG,0,5037307
ykgRp,0.14285714285714285,6,6,AGCAAGTCCACGTTTATGAA,0,5059530
ykgRp,0.14285714285714285,6,6,AGATTGAGATTGGAGCGGAG,0,5058540
ykgRp,0.14285714285714285,6,6,AGATCCTCTAGATTTGTTCA,0,5054048
ykgRp,0.14285714285714285,6,6,AGATAGATCGACCGCTGTCT,0,5031333
ykgRp,0.14285714285714285,6,6,AGAGTTTGTCCGATTGCGCA,0,5037291
ykgRp,0.14285714285714285,6,6,AGAGCGATAGTAGGTGGGCA,0,5049536
ykgRp,0.14285714285714285,6,6,AGAGCACAGCGCAGTCGGAA,0,5041267
ykgRp,0.14285714285714285,6,6,AGAGATGGATTGAGTTATAT,0,5051212
ykgRp,0.14285714285714285,6,6,AGACGGGCTGGTACTGTAAT,0,5058532
ykgRp,0.14285714285714285,6,6,AGACACTAGGGAACTCCCAG,0,5039820
ykgRp,0.14285714285714285,6,6,ACTTGTATGGATGCCTCTTA,0,5038477
ykgRp,0.14285714285714285,6,6,ACTTGCGGGGAGGTATACGC,0,5041503
ykgRp,0.14285714285714285,6,6,ACTGTCGGTCCGGGAAACTC,0,5044200
ykgRp,0.14285714285714285,6,6,ACTGAAATTACGAGGTACAC,0,5057517
ykgRp,0.14285714285714285,6,6,ACTCTGTTTAGTGGAGGTCC,0,5060357
ykgRp,0.14285714285714285,6,6,ACTCCACAGCTATCTACGGC,0,5038838
ykgRp,0.14285714285714285,6,6,ACTCATCTTCGAGAGAATTA,0,5045142
ykgRp,0.14285714285714285,6,6,ACGTCTGATACTGTATTGTG,0,5053633
ykgRp,0.14285714285714285,6,6,ACGGCCCAGTCTAAATTCTT,0,5052509
ykgRp,0.14285714285714285,6,6,ACGGCAAACATACTCGCACT,0,5056455
ykgRp,0.14285714285714285,6,6,ACGCGGCACTGCATATAATA,0,5031619
ykgRp,0.14285714285714285,6,6,ACGAGTGTATCCGTTATGAT,0,5054943
ykgRp,0.14285714285714285,6,6,ACCTTGGTCTGAAGCAGCTT,0,5044132
ykgRp,0.14285714285714285,6,6,ACCGTAATAACTGTAGACCC,0,5051772
ykgRp,0.14285714285714285,6,6,ACCGCGGCTTGTCCAGGGGG,0,5060183
ykgRp,0.14285714285714285,6,6,ACCGAAGCTAGGTCACGGAG,0,5031962
ykgRp,0.14285714285714285,6,6,ACCCCGCCAGGCCGCGGGCG,0,5047803
ykgRp,0.14285714285714285,6,6,ACCAAAGGATGGATTTGGGG,0,5044587
ykgRp,0.14285714285714285,6,6,ACATTGGGGTAGATAGTAAA,0,5056634
ykgRp,0.14285714285714285,6,6,ACATTATGCTACACGTCGGT,0,5056113
ykgRp,0.14285714285714285,6,6,ACATACAAACGTCATGTCAC,0,5039512
ykgRp,0.14285714285714285,6,6,ACAGTTCCTACATATACTAC,0,5036004
ykgRp,0.14285714285714285,6,6,ACAGCGACGTGCATTGGCAG,0,5041037
ykgRp,0.14285714285714285,6,6,ACAGATTGGCTCTGAATAAT,0,5055840
ykgRp,0.14285714285714285,6,6,ACACACTTCTTACTCCTTGA,0,5051424
ykgRp,0.14285714285714285,6,6,ACAAGAACGACGGAGAACGC,0,5033062
ykgRp,0.14285714285714285,6,6,ACAAACAGTGCCCCCTTTGC,0,5036752
ykgRp,0.14285714285714285,6,6,AATTGTCAGCTCTATCGTCT,0,5040746
ykgRp,0.14285714285714285,6,6,AATTACCGTGAGGAAATGGG,0,5053098
ykgRp,0.14285714285714285,6,6,AATGTCCACCGCTACTCTCG,0,5042801
ykgRp,0.14285714285714285,6,6,AATGGTGGATCGATGGCACC,0,5058292
ykgRp,0.14285714285714285,6,6,AATGCCGCCGGACATAATCG,0,5037831
ykgRp,0.14285714285714285,6,6,AATGCAGGGTATTCCGCCTG,0,5051217
ykgRp,0.14285714285714285,6,6,AATGATCGCGTGTAGCTGCG,0,5037550
ykgRp,0.14285714285714285,6,6,AATGAACTTGGCAACGGTCT,0,5044836
ykgRp,0.14285714285714285,6,6,AATGAAACTGATTGGATCCA,0,5037922
ykgRp,0.14285714285714285,6,6,AATCGCGTGGTTGAAGAACA,0,5054218
ykgRp,0.14285714285714285,6,6,AATATGACCGAACGGCACGC,0,5043199
ykgRp,0.14285714285714285,6,6,AATAGATTCCTAGGCGTCCT,0,5046879
ykgRp,0.14285714285714285,6,6,AATAGAGGAGCCGACCTTGT,0,5040202
ykgRp,0.14285714285714285,6,6,AATAGAAGGTGTTATTGTGG,0,5053254
ykgRp,0.14285714285714285,6,6,AAGTTTGGGTTGCTCGGCGG,0,5044383
ykgRp,0.14285714285714285,6,6,AAGTGTGCTTTCCCATACGG,0,5054967
ykgRp,0.14285714285714285,6,6,AAGGCAACCGTCGTGAGGCA,0,5057225
ykgRp,0.14285714285714285,6,6,AAGCGGTGCGTAGTGATATT,0,5051783
ykgRp,0.14285714285714285,6,6,AAGATACACCGCCCTGTTTG,0,5032929
ykgRp,0.14285714285714285,6,6,AAGACAACCAGGATCGCAGT,0,5040474
ykgRp,0.14285714285714285,6,6,AAGAAAATGTCAATATCCGA,0,5047192
ykgRp,0.14285714285714285,6,6,AACTCTCATGTTGCACATAT,0,5057950
ykgRp,0.14285714285714285,6,6,AACTCGACCGCCCGGTCCTC,0,5034007
ykgRp,0.14285714285714285,6,6,AACGTTTGGCAGCTCCCGGG,0,5040382
ykgRp,0.14285714285714285,6,6,AACGTAAACATCAGAATGGA,0,5054491
ykgRp,0.14285714285714285,6,6,AACGCCGTACGGTTGTGCTA,0,5034200
ykgRp,0.14285714285714285,6,6,AACCCTTGTTAATGACATTG,0,5038782
ykgRp,0.14285714285714285,6,6,AACCCGGTCTATGGTTGTCT,0,5060964
ykgRp,0.14285714285714285,6,6,AACCATCACATTTCGAGATC,0,5053256
ykgRp,0.14285714285714285,6,6,AACAATTCTGGACTCCTTTG,0,5060933
ykgRp,0.14285714285714285,6,6,AAATAGCGGCTGGACTTATC,0,5046022
ykgRp,0.14285714285714285,6,6,AAAGGGTCTCCACGTGTCGG,0,5043993
ykgRp,0.14285714285714285,6,6,AAAGATCTTAGGTACTCAAG,0,5031364
ykgRp,0.14285714285714285,6,6,AAACCGTTCCTAATAATTTA,0,5043796
ykgRp,0.14285714285714285,6,6,AAACCGGTGGCGCTGGAGCA,0,5041226
ykgRp,0.14285714285714285,6,6,AAAATGAGATTACGAGGTGA,0,5035678
ykgRp,0.14285714285714285,6,6,AAAAACGTGACTTGTTCTGT,0,5054318
ykgRp,0.14285714285714285,6,6,AAAAAATTCGATTCAATGAC,0,5040760
ykgRp,0.16666666666666666,5,5,TTTGTATGTTGGAATCTAAA,0,5039024
ykgRp,0.16666666666666666,5,5,TTTGGGGTCTCCCCCAACGG,0,5039132
ykgRp,0.16666666666666666,5,5,TTTGAAGCTGGTTGTGATAG,0,5059777
ykgRp,0.16666666666666666,5,5,TTTCTTGTTAGATGATGTCT,0,5050755
ykgRp,0.16666666666666666,5,5,TTTCTCCCTGGCGTCTTAGA,0,5054200
ykgRp,0.16666666666666666,5,5,TTTCAGAGAATACTCCATGG,0,5046661
ykgRp,0.16666666666666666,5,5,TTTCAACCGCAACAGTCAGG,0,5044095
ykgRp,0.16666666666666666,5,5,TTTATACTACACTCGCGGAG,0,5047315
ykgRp,0.16666666666666666,5,5,TTTAGGCCTGTATCTCACAC,0,5054770
ykgRp,0.16666666666666666,5,5,TTTAGAGCGTAACGTGTTGT,0,5036738
ykgRp,0.16666666666666666,5,5,TTTACCGCACGCAACGGGAG,0,5032225
ykgRp,0.16666666666666666,5,5,TTTAATACCTTGAGTTCCTA,0,5046209
ykgRp,0.16666666666666666,5,5,TTGTTTGGCTTTGAATCCTT,0,5057750
ykgRp,0.16666666666666666,5,5,TTGGACTCATGGTGAGGGGA,0,5050684
ykgRp,0.16666666666666666,5,5,TTGGAAGAATCGATCCACGT,0,5051644
ykgRp,0.16666666666666666,5,5,TTGCGGTGGGTGTTCCGCTT,0,5051049
ykgRp,0.16666666666666666,5,5,TTGCGGGCAAATTTTCAGTT,0,5042405
ykgRp,0.16666666666666666,5,5,TTGCGGGATCGAGTGTGTGC,0,5058413
ykgRp,0.16666666666666666,5,5,TTGCGCCTACCCACGCCACT,0,5041694
ykgRp,0.16666666666666666,5,5,TTGCATGATTCCAAAAAGAG,0,5035285
ykgRp,0.16666666666666666,5,5,TTGCAGGCACTGAGCGAAGT,0,5036100
ykgRp,0.16666666666666666,5,5,TTGAGACTTTAATGGGCTTA,0,5059526
ykgRp,0.16666666666666666,5,5,TTGAGACAGCGGGGGCTCAA,0,5054142
ykgRp,0.16666666666666666,5,5,TTGAATTTAGCGCGCAGGGG,0,5056370
ykgRp,0.16666666666666666,5,5,TTGAAAGGCTATAGTTTAGG,0,5054764
ykgRp,0.16666666666666666,5,5,TTCTTGGACACTCGGTCAGA,0,5049652
ykgRp,0.16666666666666666,5,5,TTCTGCTTGCGTTCCGCCAC,0,5060830
ykgRp,0.16666666666666666,5,5,TTCTCAAGACTACTGTCACA,0,5054185
ykgRp,0.16666666666666666,5,5,TTCGAGTCCGTAAAAGATAG,0,5035696
ykgRp,0.16666666666666666,5,5,TTCCGTATTATGGCTAATGC,0,5054734
ykgRp,0.16666666666666666,5,5,TTCCGGGGAGTTCGTCGGGT,0,5044843
ykgRp,0.16666666666666666,5,5,TTCCCGAAGGTTGAACAGAG,0,5040583
ykgRp,0.16666666666666666,5,5,TTCATTTTTCTTATCTGGTG,0,5033579
ykgRp,0.16666666666666666,5,5,TTCATTTAGACTCATAATAC,0,5034836
ykgRp,0.16666666666666666,5,5,TTCAGTAGGGAAACTCTCCT,0,5060893
ykgRp,0.16666666666666666,5,5,TTCACCATCCTTTCACTCAC,0,5055415
ykgRp,0.16666666666666666,5,5,TTATTGGAGTTTGGTCTGGC,0,5039186
ykgRp,0.16666666666666666,5,5,TTATGTTGAAGGCCTGTCGG,0,5059739
ykgRp,0.16666666666666666,5,5,TTATGTGCTAGCGGCAGTCT,0,5035135
ykgRp,0.16666666666666666,5,5,TTAGGGCTCCTGATAGAGTA,0,5061401
ykgRp,0.16666666666666666,5,5,TTAGCGTTTGGTAAGATTTA,0,5051168
ykgRp,0.16666666666666666,5,5,TTAACCGTCCTCAGACGGTA,0,5052210
ykgRp,0.16666666666666666,5,5,TGTTTGAATCCGTTAGAATA,0,5037992
ykgRp,0.16666666666666666,5,5,TGTGTATCTGATTCAGCTCA,0,5031441
ykgRp,0.16666666666666666,5,5,TGTGGCCCTGTTGGTTGCCC,0,5036383
ykgRp,0.16666666666666666,5,5,TGTCGAGACATCAGTGAACA,0,5043901
ykgRp,0.16666666666666666,5,5,TGTCGAACTCATAAATGTGA,0,5041257
ykgRp,0.16666666666666666,5,5,TGTAGACATCGTCTACAACT,0,5035989
ykgRp,0.16666666666666666,5,5,TGTACATGCTGGGGAATCTC,0,5037378
ykgRp,0.16666666666666666,5,5,TGTAATGTCGATTTTGCTAC,0,5034735
ykgRp,0.16666666666666666,5,5,TGGTGATGCTCAAATCTAGT,0,5053100
ykgRp,0.16666666666666666,5,5,TGGTATTTTGGACAAATGTG,0,5053307
ykgRp,0.16666666666666666,5,5,TGGTAGACCGCGTAGACTTC,0,5033474
ykgRp,0.16666666666666666,5,5,TGGGGGCATTACAACGTGGT,0,5051520
ykgRp,0.16666666666666666,5,5,TGGGAGGCTACCCAGGGTCT,0,5052394
ykgRp,0.16666666666666666,5,5,TGGGAGATAGCCATGTTACG,0,5036498
ykgRp,0.16666666666666666,5,5,TGGCTTTGCTCTGCTGATGC,0,5050165
ykgRp,0.16666666666666666,5,5,TGGCTGGGAATCGCTATATC,0,5034781
ykgRp,0.16666666666666666,5,5,TGCTTGTTATGAGTCGAACG,0,5037906
ykgRp,0.16666666666666666,5,5,TGCTGTCCCACAGGCTCGAA,0,5054820
ykgRp,0.16666666666666666,5,5,TGCTCAGAATAGCAAACAAA,0,5042720
ykgRp,0.16666666666666666,5,5,TGCGTTCCGACCCATCCGTT,0,5055284
ykgRp,0.16666666666666666,5,5,TGCGATACAATATGGGTGAA,0,5035281
ykgRp,0.16666666666666666,5,5,TGCCGGAAATTATTAAGCGT,0,5059678
ykgRp,0.16666666666666666,5,5,TGCCAGGCGTATTTTCAGTC,0,5046977
ykgRp,0.16666666666666666,5,5,TGCAACGGTGACCTTGAAGG,0,5058615
ykgRp,0.16666666666666666,5,5,TGATGATTTATAGAAGTCTT,0,5035492
ykgRp,0.16666666666666666,5,5,TGATCGTTGCTAGTTAACAA,0,5047690
ykgRp,0.16666666666666666,5,5,TGATAAGATTCTTCTATTGA,0,5036821
ykgRp,0.16666666666666666,5,5,TGAGTCATACATCATCTGAC,0,5053203
ykgRp,0.16666666666666666,5,5,TGAGAAAAGTACGTTGTGAA,0,5042480
ykgRp,0.16666666666666666,5,5,TGACTCTCGGGACTAGAGCA,0,5035090
ykgRp,0.16666666666666666,5,5,TGACGGAATGAGGAAAGCCC,0,5043850
ykgRp,0.16666666666666666,5,5,TGACCACCGATGACACTCTA,0,5056508
ykgRp,0.16666666666666666,5,5,TGACAAATGTCTTCGATCAT,0,5034917
ykgRp,0.16666666666666666,5,5,TGAATAGATTGCGTGGTGAT,0,5050659
ykgRp,0.16666666666666666,5,5,TCTTCCCCGGCAAGTACACC,0,5034445
ykgRp,0.16666666666666666,5,5,TCTGTGCGCAAACAGCGAGT,0,5034102
ykgRp,0.16666666666666666,5,5,TCTGATTGGCCGACGCGGCC,0,5043588
ykgRp,0.16666666666666666,5,5,TCTGATCTCAGGTCAGTAAT,0,5049668
ykgRp,0.16666666666666666,5,5,TCTCGGATCACTGTCTAGCA,0,5036012
ykgRp,0.16666666666666666,5,5,TCGGTCCTAAGGGGCCTAGA,0,5035274
ykgRp,0.16666666666666666,5,5,TCGGGGCAGGTGGATCGTCG,0,5055102
ykgRp,0.16666666666666666,5,5,TCGGGGAAAATCTTTTACTT,0,5042383
ykgRp,0.16666666666666666,5,5,TCGGGCCTAATCAATACTTG,0,5056452
ykgRp,0.16666666666666666,5,5,TCGGAGCATGGCCCTAGAGG,0,5039627
ykgRp,0.16666666666666666,5,5,TCGCTGGAACAGTACGCGTA,0,5050168
ykgRp,0.16666666666666666,5,5,TCGCGTGGTCGAAACTGGGA,0,5040215
ykgRp,0.16666666666666666,5,5,TCGCGCTTAGGGGGGGCTGT,0,5040482
ykgRp,0.16666666666666666,5,5,TCGATACATATTATCGGTAG,0,5039454
ykgRp,0.16666666666666666,5,5,TCGAGCACTTCACGTTAAGT,0,5038219
ykgRp,0.16666666666666666,5,5,TCCTTATTGGCAGACGGTGG,0,5059852
ykgRp,0.16666666666666666,5,5,TCCTCAGCAATTGGACCAAA,0,5058309
ykgRp,0.16666666666666666,5,5,TCCGGAGGTACGCCGCTATT,0,5035404
ykgRp,0.16666666666666666,5,5,TCCGGACTTAGCCCAACAGC,0,5057135
ykgRp,0.16666666666666666,5,5,TCCGGACCACTGCGTGACAG,0,5060695
ykgRp,0.16666666666666666,5,5,TCCGCTATATCCGCGTTTTC,0,5054069
ykgRp,0.16666666666666666,5,5,TCCAACCGGCTGATGCCGTA,0,5053121
ykgRp,0.16666666666666666,5,5,TCATTTAACTTATCTTATCT,0,5051226
ykgRp,0.16666666666666666,5,5,TCATACTTAACTATCGTACA,0,5054707
ykgRp,0.16666666666666666,5,5,TCAGTTTGCCAGAAAGGTTC,0,5036221
ykgRp,0.16666666666666666,5,5,TCAGCCCAATGATAGAGAAG,0,5041940
ykgRp,0.16666666666666666,5,5,TCAGAGACCAACACGCTTGG,0,5041126
ykgRp,0.16666666666666666,5,5,TCACGGGGATGTGTTGCCAC,0,5038109
ykgRp,0.16666666666666666,5,5,TCACATTTAACCCATTAGAG,0,5051179
ykgRp,0.16666666666666666,5,5,TCAATTGACTACTTACTAAA,0,5043196
ykgRp,0.16666666666666666,5,5,TCAATCCTTCTTTGCACGCC,0,5035618
ykgRp,0.16666666666666666,5,5,TCAAGCGGAGTACAACTCTG,0,5044981
ykgRp,0.16666666666666666,5,5,TCAAGATCATTCGATTGGTG,0,5031533
ykgRp,0.16666666666666666,5,5,TATTGGCGGGCCGTCGAAAG,0,5033729
ykgRp,0.16666666666666666,5,5,TATTAGCAAAAGGCTTTAGG,0,5046223
ykgRp,0.16666666666666666,5,5,TATGTTGGCAGTAGCTTCTT,0,5055845
ykgRp,0.16666666666666666,5,5,TATGCTGGAGCCCCCTTGGA,0,5044359
ykgRp,0.16666666666666666,5,5,TATGATTGCTAAATAACGTT,0,5033953
ykgRp,0.16666666666666666,5,5,TATCTCTGTTAGCATCTGTA,0,5060341
ykgRp,0.16666666666666666,5,5,TATCTAGTCGGTCCGCTCAA,0,5055465
ykgRp,0.16666666666666666,5,5,TATCGCCCAAGCAGTCGGGG,0,5041318
ykgRp,0.16666666666666666,5,5,TAGGTCTGCCAGCTCAACTC,0,5035486
ykgRp,0.16666666666666666,5,5,TAGGGGAAGGTGTACAGCGG,0,5048949
ykgRp,0.16666666666666666,5,5,TAGGGAAATTATCCAGTGAT,0,5052930
ykgRp,0.16666666666666666,5,5,TAGGCGTAATACCACATATG,0,5036253
ykgRp,0.16666666666666666,5,5,TAGCGCCTTCGGTGGCATTA,0,5050167
ykgRp,0.16666666666666666,5,5,TAGAGGAGAACTATTCACGT,0,5053434
ykgRp,0.16666666666666666,5,5,TAGAGCTCAGGGACGTAAAG,0,5044208
ykgRp,0.16666666666666666,5,5,TAGAAGTGATGGGAATCCCG,0,5043583
ykgRp,0.16666666666666666,5,5,TAGAAACGGTTCGCATATCT,0,5045459
ykgRp,0.16666666666666666,5,5,TACTTAACGCCATCGGGTGT,0,5036804
ykgRp,0.16666666666666666,5,5,TACTGTCAATACCCTCGTAC,0,5034906
ykgRp,0.16666666666666666,5,5,TACTCCCGCTTTGCACGTAC,0,5034831
ykgRp,0.16666666666666666,5,5,TACGGATCGTTGGAGGTGTA,0,5053846
ykgRp,0.16666666666666666,5,5,TACGCAATCCTTACCCGGAA,0,5047886
ykgRp,0.16666666666666666,5,5,TACACATACGTCCGTCTGAA,0,5054104
ykgRp,0.16666666666666666,5,5,TACAAACAACACACACGCGC,0,5043217
ykgRp,0.16666666666666666,5,5,TAATTTTAAGTCTACGGCAT,0,5033919
ykgRp,0.16666666666666666,5,5,TAATTAGGATTTTAATGGAA,0,5043317
ykgRp,0.16666666666666666,5,5,TAATGTCATACGGGAACCCC,0,5047055
ykgRp,0.16666666666666666,5,5,TAATCGGTGCAAATAACCAT,0,5049264
ykgRp,0.16666666666666666,5,5,TAATAGGTATACTCCAGGGC,0,5052378
ykgRp,0.16666666666666666,5,5,TAAGCGGCATCCGGTGGTAT,0,5056181
ykgRp,0.16666666666666666,5,5,TAAGATAATAACGAGTATCG,0,5041677
ykgRp,0.16666666666666666,5,5,TAACTAAATTCTACTACACT,0,5053746
ykgRp,0.16666666666666666,5,5,TAACGCTTGATAGTTGGTCC,0,5038266
ykgRp,0.16666666666666666,5,5,TAACCCGAACGGAATTAGCT,0,5046557
ykgRp,0.16666666666666666,5,5,GTTTAGAAGGCATATGAACG,0,5041453
ykgRp,0.16666666666666666,5,5,GTTGTCACCCTAATCACCAG,0,5038220
ykgRp,0.16666666666666666,5,5,GTTGCTCACCGTTTTTCGAA,0,5038657
ykgRp,0.16666666666666666,5,5,GTTGCGAAGTTTGGCTGCAT,0,5034324
ykgRp,0.16666666666666666,5,5,GTTCTGCGCATAGTCGTTCT,0,5054092
ykgRp,0.16666666666666666,5,5,GTTCTATTGGAAGGTTAGTT,0,5041668
ykgRp,0.16666666666666666,5,5,GTTCGTGGGAATAGTAGGGA,0,5040973
ykgRp,0.16666666666666666,5,5,GTTCGTACGGGTAGGGCGTT,0,5041083
ykgRp,0.16666666666666666,5,5,GTTCGTAAGAGGACTACGAT,0,5056742
ykgRp,0.16666666666666666,5,5,GTTCGATGCCGAGTACGATC,0,5038184
ykgRp,0.16666666666666666,5,5,GTTCCCCAGGCGCAAAGCAT,0,5042425
ykgRp,0.16666666666666666,5,5,GTTCAGTAGTGGTCACAGGA,0,5051676
ykgRp,0.16666666666666666,5,5,GTTATTGGCTTTAGTTTCTC,0,5051119
ykgRp,0.16666666666666666,5,5,GTTATGACCCACACGACGGA,0,5032642
ykgRp,0.16666666666666666,5,5,GTTAGCATAAGAGTCGAGTA,0,5054425
ykgRp,0.16666666666666666,5,5,GTTACTGGCAACGGATAGAC,0,5039676
ykgRp,0.16666666666666666,5,5,GTGTGGATAACTCTTCACAG,0,5040091
ykgRp,0.16666666666666666,5,5,GTGGTGTACGCGTTATAACA,0,5043336
ykgRp,0.16666666666666666,5,5,GTGGGTCCACTTGGCCCATT,0,5053438
ykgRp,0.16666666666666666,5,5,GTGGGCTCAACGATGGACGT,0,5049119
ykgRp,0.16666666666666666,5,5,GTGGGCGTAGGACACTAAAA,0,5047683
ykgRp,0.16666666666666666,5,5,GTGGCTTTTAGTATGGAGTG,0,5058739
ykgRp,0.16666666666666666,5,5,GTGGCTGCACAGTCGTGGAA,0,5057970
ykgRp,0.16666666666666666,5,5,GTGCGTGACAGCAAGAAAGT,0,5043154
ykgRp,0.16666666666666666,5,5,GTGACTACGGTAGCAATCAT,0,5036793
ykgRp,0.16666666666666666,5,5,GTGACCAGTGCGGGAAGGCG,0,5036257
ykgRp,0.16666666666666666,5,5,GTGACAACTAAAAGATTGTT,0,5031930
ykgRp,0.16666666666666666,5,5,GTCGCTATTTCGAGACCGAG,0,5034813
ykgRp,0.16666666666666666,5,5,GTCCTAACAGTCGGGCACCA,0,5043548
ykgRp,0.16666666666666666,5,5,GTCCCCCAGGATGCAGCAGT,0,5054977
ykgRp,0.16666666666666666,5,5,GTCATCAGGCGGCATTACAT,0,5036347
ykgRp,0.16666666666666666,5,5,GTCATAGAGTTAGTCTAAAA,0,5050741
ykgRp,0.16666666666666666,5,5,GTCACTATAGTACGGTTATA,0,5052676
ykgRp,0.16666666666666666,5,5,GTCACACGGATGCCTTCTTT,0,5045156
ykgRp,0.16666666666666666,5,5,GTAGTATTTGAACGCGCTTG,0,5058971
ykgRp,0.16666666666666666,5,5,GTAGGTGAATCTTATGAAAG,0,5055781
ykgRp,0.16666666666666666,5,5,GTAGCCTACAAAAGAATGAT,0,5031508
ykgRp,0.16666666666666666,5,5,GTAGCACAACTTGCACAAGT,0,5051425
ykgRp,0.16666666666666666,5,5,GTACTTAGGGCGCGGCCAGG,0,5038374
ykgRp,0.16666666666666666,5,5,GTACCTCCAGCGAACAAGAT,0,5047271
ykgRp,0.16666666666666666,5,5,GGTTCTAGCGATCGCAAGTC,0,5037159
ykgRp,0.16666666666666666,5,5,GGTTCGGAGGGCAATCAGGC,0,5054234
ykgRp,0.16666666666666666,5,5,GGTTCACTCGCCTCAATGGT,0,5041839
ykgRp,0.16666666666666666,5,5,GGTGGTGAGCATGATGGTAC,0,5050901
ykgRp,0.16666666666666666,5,5,GGTAGCTCTCCCCCTTGTCA,0,5038058
ykgRp,0.16666666666666666,5,5,GGTACTAGGTACGTGCTGTT,0,5036909
ykgRp,0.16666666666666666,5,5,GGGTCCGACACATCTGGTCT,0,5043849
ykgRp,0.16666666666666666,5,5,GGGTAGTCGCTACAGGCTAC,0,5058439
ykgRp,0.16666666666666666,5,5,GGGCAATGCGACAGGATCTA,0,5057091
ykgRp,0.16666666666666666,5,5,GGGATTTACGCGAATTTAAA,0,5038685
ykgRp,0.16666666666666666,5,5,GGGAGCCTTGACTTGGGTTA,0,5044338
ykgRp,0.16666666666666666,5,5,GGGACGGTTCTTACGGACAG,0,5048305
ykgRp,0.16666666666666666,5,5,GGGAACCTTTGGGATCCTTA,0,5041036
ykgRp,0.16666666666666666,5,5,GGGAACCATGTGAGGCGCCG,0,5054490
ykgRp,0.16666666666666666,5,5,GGCTTACGCAAGAGCCTATT,0,5037652
ykgRp,0.16666666666666666,5,5,GGCTAAAATAAAGTCGTCGC,0,5050293
ykgRp,0.16666666666666666,5,5,GGCGGACTGCGAATCCACGA,0,5055322
ykgRp,0.16666666666666666,5,5,GGCGCTTCACTTCGTTCCTA,0,5047998
ykgRp,0.16666666666666666,5,5,GGCCAAGTCTCGGGGAAGAC,0,5041068
ykgRp,0.16666666666666666,5,5,GGCAAGCCGGTCACGTCTTA,0,5043206
ykgRp,0.16666666666666666,5,5,GGCAAATTGAAATCCGGCAA,0,5031484
ykgRp,0.16666666666666666,5,5,GGATGCTTATGGTCCAAAAG,0,5045225
ykgRp,0.16666666666666666,5,5,GGAGGTCCGAGCCCGGAAAG,0,5039164
ykgRp,0.16666666666666666,5,5,GGAGGGCCATGGGTGTAGTT,0,5036916
ykgRp,0.16666666666666666,5,5,GGAGCGTATGGTAGAGACAT,0,5052582
ykgRp,0.16666666666666666,5,5,GGACATGGAGGAACCGTGAA,0,5048547
ykgRp,0.16666666666666666,5,5,GGACATCACAGATAGTGGTA,0,5046980
ykgRp,0.16666666666666666,5,5,GGAAATTGCGGTACGCTCTT,0,5038410
ykgRp,0.16666666666666666,5,5,GCTGACTGAATCATGGCGGT,0,5048564
ykgRp,0.16666666666666666,5,5,GCTCGGACGATGATATCAAC,0,5053034
ykgRp,0.16666666666666666,5,5,GCTCGCCACGTCCATTAGGC,0,5035368
ykgRp,0.16666666666666666,5,5,GCTCCCACATCTCGAAGTTT,0,5055920
ykgRp,0.16666666666666666,5,5,GCTATTTGCTTGCAGTTGGT,0,5041778
ykgRp,0.16666666666666666,5,5,GCTATATACGTGCTGAGCAG,0,5053804
ykgRp,0.16666666666666666,5,5,GCTAGCCGGTTTTAGCTCGT,0,5032643
ykgRp,0.16666666666666666,5,5,GCTAGATCTTCGCTTCCCGG,0,5050656
ykgRp,0.16666666666666666,5,5,GCGTCGGATACTCAGGGGCA,0,5038389
ykgRp,0.16666666666666666,5,5,GCGTATATTACGGGGTCCGT,0,5058793
ykgRp,0.16666666666666666,5,5,GCGTAATGCGACGCCGAAAG,0,5032993
ykgRp,0.16666666666666666,5,5,GCGTAAGGTTTGGCGCCATC,0,5053556
ykgRp,0.16666666666666666,5,5,GCGGTGTTTGCATACGCCAT,0,5043043
ykgRp,0.16666666666666666,5,5,GCGGTGCGAGTTACGTGCGC,0,5044917
ykgRp,0.16666666666666666,5,5,GCGGCTGAAGATAACCGACG,0,5038928
ykgRp,0.16666666666666666,5,5,GCGCTATGCAGGTGAAGTAC,0,5053728
ykgRp,0.16666666666666666,5,5,GCGATCACACTCGATCTTCC,0,5055804
ykgRp,0.16666666666666666,5,5,GCGAGAAAAGCACTCGGATC,0,5050544
ykgRp,0.16666666666666666,5,5,GCGACTCTTCATATGTGCGT,0,5046124
ykgRp,0.16666666666666666,5,5,GCCTTGAATCTGAGCATTTC,0,5049150
ykgRp,0.16666666666666666,5,5,GCCTCACGGGGTTTGCACTT,0,5045732
ykgRp,0.16666666666666666,5,5,GCCTATGTATTCTGGCATAC,0,5031505
ykgRp,0.16666666666666666,5,5,GCCGTGTGTTATTCCTTCAT,0,5055398
ykgRp,0.16666666666666666,5,5,GCCGGGCTCTTCTCGCTGTT,0,5031801
ykgRp,0.16666666666666666,5,5,GCCGGCCTCGAGTAGACGAC,0,5049855
ykgRp,0.16666666666666666,5,5,GCCGCCTCCGTCTGTTATCA,0,5056822
ykgRp,0.16666666666666666,5,5,GCCCGAGAGGAATACTGCCC,0,5043701
ykgRp,0.16666666666666666,5,5,GCCCAATGGTGCATCGCCAT,0,5046960
ykgRp,0.16666666666666666,5,5,GCCAGCTCCATATCCAGCCA,0,5046577
ykgRp,0.16666666666666666,5,5,GCCACGAAAGAGGTGTCCTA,0,5034804
ykgRp,0.16666666666666666,5,5,GCCAACGCTACGCGTTATGC,0,5036904
ykgRp,0.16666666666666666,5,5,GCATTGTGTGCGAGTAGTGG,0,5054938
ykgRp,0.16666666666666666,5,5,GCATTAGATTCATCTCCGAC,0,5039601
ykgRp,0.16666666666666666,5,5,GCATCATTAGACTCCGGTAT,0,5033695
ykgRp,0.16666666666666666,5,5,GCAGCCGGTGGTGGTCTGTT,0,5040991
ykgRp,0.16666666666666666,5,5,GCACTGAGGGAGGCGGTAAT,0,5039133
ykgRp,0.16666666666666666,5,5,GCACTACCAACTTCCGCGAG,0,5057227
ykgRp,0.16666666666666666,5,5,GCACGGGTCAATATAGCCAC,0,5053468
ykgRp,0.16666666666666666,5,5,GCACATGGAAGGCGTGGCGT,0,5037175
ykgRp,0.16666666666666666,5,5,GCAAATCCTCCTCCGGTCCG,0,5034476
ykgRp,0.16666666666666666,5,5,GATTTTCAGAAAGAGGAAGA,0,5044424
ykgRp,0.16666666666666666,5,5,GATTGTTGGGTCACGTAGGC,0,5054108
ykgRp,0.16666666666666666,5,5,GATTGTGGGGATTGTATAGT,0,5060872
ykgRp,0.16666666666666666,5,5,GATTGCGAGGCGGCAGACCC,0,5048423
ykgRp,0.16666666666666666,5,5,GATGTGGTTGAAAGTAGGTA,0,5056660
ykgRp,0.16666666666666666,5,5,GATGTCCGCCCACTGTCATT,0,5052660
ykgRp,0.16666666666666666,5,5,GATCTCTGCAAATTGATGCG,0,5058765
ykgRp,0.16666666666666666,5,5,GATCACCACAGATGTTGACC,0,5060056
ykgRp,0.16666666666666666,5,5,GATCAATTAAGACCGCGTTG,0,5040883
ykgRp,0.16666666666666666,5,5,GATACGGGCAATCTAGATGA,0,5032776
ykgRp,0.16666666666666666,5,5,GATACAGACGAAAGAATAAG,0,5061757
ykgRp,0.16666666666666666,5,5,GATAATCTCCGCTTAAGCTT,0,5037030
ykgRp,0.16666666666666666,5,5,GAGTTAAGTTGCAACCTTAC,0,5051964
ykgRp,0.16666666666666666,5,5,GAGTCTTCCTAGGTGGACTA,0,5032212
ykgRp,0.16666666666666666,5,5,GAGGTCATGAGGTGTGAAGA,0,5058094
ykgRp,0.16666666666666666,5,5,GAGGGTCCTGTGGATATTTT,0,5043547
ykgRp,0.16666666666666666,5,5,GAGGCCGATCTCTAGGAGGA,0,5034698
ykgRp,0.16666666666666666,5,5,GAGCTAGGGGCCTTATTCGT,0,5057775
ykgRp,0.16666666666666666,5,5,GAGCATTGTAACATAACCTT,0,5056936
ykgRp,0.16666666666666666,5,5,GAGCATAGGGCGGTCGGAGC,0,5038299
ykgRp,0.16666666666666666,5,5,GAGACTCATCTTGAGGCCCA,0,5044686
ykgRp,0.16666666666666666,5,5,GACTCGAGGGGTATCGAGCT,0,5048544
ykgRp,0.16666666666666666,5,5,GACTACCCTTACTCAGGGTC,0,5058282
ykgRp,0.16666666666666666,5,5,GACGTCGTGAGATGTGCAAG,0,5040910
ykgRp,0.16666666666666666,5,5,GACGGTCTGTATGATTATGC,0,5057012
ykgRp,0.16666666666666666,5,5,GACAGTCTCTGTCTTAGGCA,0,5045396
ykgRp,0.16666666666666666,5,5,GAATTGTTAATCTGTACTTC,0,5044031
ykgRp,0.16666666666666666,5,5,GAATTATGTGGGGACGTTCA,0,5061635
ykgRp,0.16666666666666666,5,5,GAATGACTATCTATTGTTTT,0,5044416
ykgRp,0.16666666666666666,5,5,GAATAAACCACGGGCAATCT,0,5046284
ykgRp,0.16666666666666666,5,5,GAAGCAATTTGTTACGGCAA,0,5049074
ykgRp,0.16666666666666666,5,5,GAAATCGCATCCTCATCGTA,0,5057196
ykgRp,0.16666666666666666,5,5,GAAAGGTCGGTGTACTTGGA,0,5056547
ykgRp,0.16666666666666666,5,5,GAAAGGCGGATCGGTATTAT,0,5044016
ykgRp,0.16666666666666666,5,5,GAAAAGAAGCATATCATTAA,0,5033454
ykgRp,0.16666666666666666,5,5,GAAAACTAATCAAGCATGTT,0,5046045
ykgRp,0.16666666666666666,5,5,GAAAACGCTCGCACATTCGG,0,5042309
ykgRp,0.16666666666666666,5,5,CTTTTTAACGATATTACAGG,0,5058794
ykgRp,0.16666666666666666,5,5,CTTTTGGCGGCCGAGCATGT,0,5040081
ykgRp,0.16666666666666666,5,5,CTTTGTACGAGCAACAGAAC,0,5059102
ykgRp,0.16666666666666666,5,5,CTTTCGTGGCGCACCGAGAC,0,5036374
ykgRp,0.16666666666666666,5,5,CTTGGCCTACAGGCCCATTA,0,5033508
ykgRp,0.16666666666666666,5,5,CTTGGACTGGTAGCGCTGGG,0,5052238
ykgRp,0.16666666666666666,5,5,CTTGAGACTAGGCACCGGTA,0,5033093
ykgRp,0.16666666666666666,5,5,CTTCTTTTAATTATTTCTAT,0,5057811
ykgRp,0.16666666666666666,5,5,CTTCTACCACGTGGCACCCA,0,5060158
ykgRp,0.16666666666666666,5,5,CTTCCGGTCCGAAGGCGAGA,0,5055067
ykgRp,0.16666666666666666,5,5,CTTACCCCATTGTGGCGGCG,0,5047576
ykgRp,0.16666666666666666,5,5,CTTAAGTTTTCCGGGATATT,0,5052928
ykgRp,0.16666666666666666,5,5,CTGTTACCGCAGAGACCTCC,0,5033888
ykgRp,0.16666666666666666,5,5,CTGTGCTGATAAAGCCCCGC,0,5058767
ykgRp,0.16666666666666666,5,5,CTGTGCCGAAGTAGGGTACA,0,5042120
ykgRp,0.16666666666666666,5,5,CTGGTATTTCTTATGCAATT,0,5046910
ykgRp,0.16666666666666666,5,5,CTGGGGAGACCGGACATTGG,0,5057453
ykgRp,0.16666666666666666,5,5,CTGGCCATCTCACAAACAGT,0,5042711
ykgRp,0.16666666666666666,5,5,CTGGATAGGAAACGCAAACT,0,5035485
ykgRp,0.16666666666666666,5,5,CTGCCCTTGAATCATTTTTA,0,5044665
ykgRp,0.16666666666666666,5,5,CTGCCATATAGCATGGAGCA,0,5040907
ykgRp,0.16666666666666666,5,5,CTGCACGCGCACTCTTCTGG,0,5051853
ykgRp,0.16666666666666666,5,5,CTGACCGCTTAAGACTAGGA,0,5055224
ykgRp,0.16666666666666666,5,5,CTCTTAGGTGCTTCTGTGCA,0,5031612
ykgRp,0.16666666666666666,5,5,CTCTCCCGCTACCATACTTT,0,5056518
ykgRp,0.16666666666666666,5,5,CTCGGTCGTGAATGAAGGGA,0,5060012
ykgRp,0.16666666666666666,5,5,CTCGGGGTACCGTAGGAATG,0,5035259
ykgRp,0.16666666666666666,5,5,CTATTGCTTAAGCGTTTGAG,0,5044726
ykgRp,0.16666666666666666,5,5,CTATTGCGGCGTCACTTGGC,0,5040461
ykgRp,0.16666666666666666,5,5,CTATGGCACGTTCTCAGTCG,0,5055023
ykgRp,0.16666666666666666,5,5,CTATGGATTCAAGATCACAT,0,5041444
ykgRp,0.16666666666666666,5,5,CTAGGCTTATGGGCCTACCC,0,5040234
ykgRp,0.16666666666666666,5,5,CTAGGAGCGCTCAGTGTGGT,0,5054825
ykgRp,0.16666666666666666,5,5,CTAGGAAGCTATCAATGGAG,0,5038044
ykgRp,0.16666666666666666,5,5,CTAGCTATAGCTGGTCAAGT,0,5060081
ykgRp,0.16666666666666666,5,5,CTAGCGCATCCCGTATGCGG,0,5032172
ykgRp,0.16666666666666666,5,5,CTACTGAAGTATCTGCTAGC,0,5033326
ykgRp,0.16666666666666666,5,5,CTACCGGGACGAACGTGTCT,0,5033891
ykgRp,0.16666666666666666,5,5,CTAATCTGCATTGTATCTTT,0,5061202
ykgRp,0.16666666666666666,5,5,CTAACGAAGATGTACTTCTT,0,5032566
ykgRp,0.16666666666666666,5,5,CTAAACTTAGGATCAAATGT,0,5039598
ykgRp,0.16666666666666666,5,5,CGTTTGATTTCGGATTAGAA,0,5037748
ykgRp,0.16666666666666666,5,5,CGTACACTTGCTGCCCCGGA,0,5038676
ykgRp,0.16666666666666666,5,5,CGGTTTGAACAGGTGGGGGC,0,5031550
ykgRp,0.16666666666666666,5,5,CGGTGAACGAAGAGCGAATT,0,5041625
ykgRp,0.16666666666666666,5,5,CGGTCCCTGACTTCAGGCCT,0,5054535
ykgRp,0.16666666666666666,5,5,CGGGGTTTGCGTGTGAGCAG,0,5040536
ykgRp,0.16666666666666666,5,5,CGGGCCGATAGCTGAGCGCT,0,5052698
ykgRp,0.16666666666666666,5,5,CGGGAGCATTCTAATAAAGC,0,5034069
ykgRp,0.16666666666666666,5,5,CGGCTGGTGATCGCCCACGG,0,5048088
ykgRp,0.16666666666666666,5,5,CGGCTAAGATTTTGGGAGCA,0,5038671
ykgRp,0.16666666666666666,5,5,CGGCCTGGAATAGGGGTATA,0,5036189
ykgRp,0.16666666666666666,5,5,CGGACGGCCTCCCAGAGGAC,0,5058595
ykgRp,0.16666666666666666,5,5,CGCTGGTAGCCCGGGTATAT,0,5047538
ykgRp,0.16666666666666666,5,5,CGCTCTACGGCTCAAATCTT,0,5057551
ykgRp,0.16666666666666666,5,5,CGCTACTCCCTCGTACAGAA,0,5050526
ykgRp,0.16666666666666666,5,5,CGCGCGTACAGTCGCTAGTG,0,5055091
ykgRp,0.16666666666666666,5,5,CGCGACTTCTTAACTACATA,0,5055079
ykgRp,0.16666666666666666,5,5,CGCCAACCTTAGCTGCCACT,0,5060137
ykgRp,0.16666666666666666,5,5,CGCAGTTAATGAGACGTTAA,0,5054755
ykgRp,0.16666666666666666,5,5,CGCACATCGGTTACACGAGA,0,5041092
ykgRp,0.16666666666666666,5,5,CGCAACATCGACTCTGAGGC,0,5032193
ykgRp,0.16666666666666666,5,5,CGATCGGCTTCATTCGGGAT,0,5042687
ykgRp,0.16666666666666666,5,5,CGAGAAATTAGATGAGCAGT,0,5032926
ykgRp,0.16666666666666666,5,5,CGACGTAGTCAGATCCAGCT,0,5044137
ykgRp,0.16666666666666666,5,5,CGACCTTTTATGCAGACCTA,0,5055483
ykgRp,0.16666666666666666,5,5,CGACAAAATTTAGAGGTGTC,0,5040239
ykgRp,0.16666666666666666,5,5,CGAATCCCAGAAAACTAGGT,0,5050770
ykgRp,0.16666666666666666,5,5,CCTTGGTCAGCGGATCGCGG,0,5057853
ykgRp,0.16666666666666666,5,5,CCTGTTAATCGCGGGACCGC,0,5032912
ykgRp,0.16666666666666666,5,5,CCTCGCCCTCGAGCTATCTC,0,5042350
ykgRp,0.16666666666666666,5,5,CCTCGATTCCTCTCACTCCG,0,5050997
ykgRp,0.16666666666666666,5,5,CCTAGTAGGAAATATACTGG,0,5037757
ykgRp,0.16666666666666666,5,5,CCTACTTAGATAAGGTATTC,0,5048108
ykgRp,0.16666666666666666,5,5,CCTACTTACTGTGACCAGCG,0,5041786
ykgRp,0.16666666666666666,5,5,CCTACAAGCGTGTCTTCTGA,0,5060868
ykgRp,0.16666666666666666,5,5,CCGGTCCTATCTTTTCATGT,0,5035726
ykgRp,0.16666666666666666,5,5,CCGGGAGTCAGGAAACGATG,0,5048613
ykgRp,0.16666666666666666,5,5,CCGGCGCTCAGCTCATCGCA,0,5048420
ykgRp,0.16666666666666666,5,5,CCGCTCCCTGGCATGGAATG,0,5049638
ykgRp,0.16666666666666666,5,5,CCGCGGGCTAACGCTATAGG,0,5052123
ykgRp,0.16666666666666666,5,5,CCGCAGCCCGGGTCAGCCCG,0,5034546
ykgRp,0.16666666666666666,5,5,CCGATCCATCTGTGGTAGCG,0,5059733
ykgRp,0.16666666666666666,5,5,CCGAGTCGCAGTGGTGGTTC,0,5038026
ykgRp,0.16666666666666666,5,5,CCGAGATAGGGATAAGCCCT,0,5061005
ykgRp,0.16666666666666666,5,5,CCGACAAAGCCTCGGTCCTC,0,5046348
ykgRp,0.16666666666666666,5,5,CCCGTCCCAGGACGTGGACT,0,5049126
ykgRp,0.16666666666666666,5,5,CCCGTAAGTTATTGTGTACA,0,5052808
ykgRp,0.16666666666666666,5,5,CCCGACGTCGTACTCGAGGC,0,5050337
ykgRp,0.16666666666666666,5,5,CCCAATTCTCATGCGATTTT,0,5032851
ykgRp,0.16666666666666666,5,5,CCCAAGGGGTTCCTCCTATG,0,5058928
ykgRp,0.16666666666666666,5,5,CCATCACGCGTGCGCTAGGG,0,5036321
ykgRp,0.16666666666666666,5,5,CCAGCAGTGTGAGCAACACT,0,5046650
ykgRp,0.16666666666666666,5,5,CCAGAATGATGGCTATGATC,0,5037789
ykgRp,0.16666666666666666,5,5,CCAGAAAAGAATGTAGCAGT,0,5047583
ykgRp,0.16666666666666666,5,5,CCAATATGAAGGATTATGTT,0,5043784
ykgRp,0.16666666666666666,5,5,CCAACGTACGCCCGCACGCT,0,5056256
ykgRp,0.16666666666666666,5,5,CATTCCTACAACTGATAGTA,0,5056439
ykgRp,0.16666666666666666,5,5,CATGGTTAGCTATTGCTTAT,0,5057688
ykgRp,0.16666666666666666,5,5,CATGGGTTGAGCCTTCTATA,0,5054712
ykgRp,0.16666666666666666,5,5,CATGCAGCGAATTGATATTC,0,5044898
ykgRp,0.16666666666666666,5,5,CATGCAAAGTGTAGGTCAGG,0,5035289
ykgRp,0.16666666666666666,5,5,CATCGTGACCACTTGGTGAC,0,5059191
ykgRp,0.16666666666666666,5,5,CATCGAATCTGATCGGTGTG,0,5047744
ykgRp,0.16666666666666666,5,5,CATCCACCCCACCGGACATA,0,5035945
ykgRp,0.16666666666666666,5,5,CATCAAGCTCGGCTTTCAGG,0,5058775
ykgRp,0.16666666666666666,5,5,CATAGTCCGTTCACCTATGG,0,5033921
ykgRp,0.16666666666666666,5,5,CATAATTAGCTTAACAATCC,0,5036055
ykgRp,0.16666666666666666,5,5,CATAACAAATGGATCGATGA,0,5052860
ykgRp,0.16666666666666666,5,5,CAGTTGGCGCTAGCCGATAA,0,5051561
ykgRp,0.16666666666666666,5,5,CAGTGCCCCTGAAGCATAGA,0,5049169
ykgRp,0.16666666666666666,5,5,CAGGGTAGCATATGGACTAT,0,5037819
ykgRp,0.16666666666666666,5,5,CAGGCGCACGCCCATCCTCC,0,5036005
ykgRp,0.16666666666666666,5,5,CAGGCATCCCTCTAACTGTT,0,5039674
ykgRp,0.16666666666666666,5,5,CAGGCATACAACGCTGGAAG,0,5054473
ykgRp,0.16666666666666666,5,5,CAGGCAATTTTGTTGCTATG,0,5040618
ykgRp,0.16666666666666666,5,5,CAGATTCGCGCGACATCGCA,0,5055196
ykgRp,0.16666666666666666,5,5,CAGATGGTTTCAACATCAGA,0,5054066
ykgRp,0.16666666666666666,5,5,CAGAAGTCAAAACATCGCAT,0,5039219
ykgRp,0.16666666666666666,5,5,CACGGTATAACCGTAAAGGA,0,5050384
ykgRp,0.16666666666666666,5,5,CACGCACAACTGTTTTAGGT,0,5047457
ykgRp,0.16666666666666666,5,5,CACCTACGATTTACTTGTGG,0,5042751
ykgRp,0.16666666666666666,5,5,CACCGAGCTGGACTCAAAGG,0,5043223
ykgRp,0.16666666666666666,5,5,CACCCCACCGGGGAACACGA,0,5051295
ykgRp,0.16666666666666666,5,5,CACAGTTCATGGCTGCATGC,0,5035276
ykgRp,0.16666666666666666,5,5,CAATCGATACTGGTACTTAG,0,5056115
ykgRp,0.16666666666666666,5,5,CAAGTATCTTGGTGATGAAT,0,5042588
ykgRp,0.16666666666666666,5,5,CAAGCTTATATGTCATCGGC,0,5048744
ykgRp,0.16666666666666666,5,5,CAAGCTCACCTAGCATAGGA,0,5046644
ykgRp,0.16666666666666666,5,5,CAAGCGCAGATACAGGCCCA,0,5044100
ykgRp,0.16666666666666666,5,5,CAACTCGCAAGACGCAAATA,0,5056297
ykgRp,0.16666666666666666,5,5,CAACGAAGCCGTATTCACAA,0,5057268
ykgRp,0.16666666666666666,5,5,CAACCAACGGGGATACATTA,0,5040154
ykgRp,0.16666666666666666,5,5,CAAATTCCCCCCATGCACGG,0,5056175
ykgRp,0.16666666666666666,5,5,ATTTTTTTGTGTGTATAACC,0,5049207
ykgRp,0.16666666666666666,5,5,ATTGGAAGCTCGACGATCAC,0,5035644
ykgRp,0.16666666666666666,5,5,ATTGAGAATGAAGTCAAAAC,0,5032958
ykgRp,0.16666666666666666,5,5,ATTGACAAGGACCACCCGCA,0,5040454
ykgRp,0.16666666666666666,5,5,ATTCCTGCTCAGGTCTTGCA,0,5037658
ykgRp,0.16666666666666666,5,5,ATTAGCTTTTCAGGTAGGCA,0,5033620
ykgRp,0.16666666666666666,5,5,ATGTGTAGAAAATATCGGAC,0,5056219
ykgRp,0.16666666666666666,5,5,ATGTAAGCTCCAAAAGCTAA,0,5048300
ykgRp,0.16666666666666666,5,5,ATGGTTGATCGGATAGATTA,0,5048471
ykgRp,0.16666666666666666,5,5,ATGGGTGACTACCAGGTTGA,0,5041631
ykgRp,0.16666666666666666,5,5,ATGGGGGCGGACTCCAGCAG,0,5035720
ykgRp,0.16666666666666666,5,5,ATGGGCATCTTAAGTAAAAG,0,5038388
ykgRp,0.16666666666666666,5,5,ATGCGACCGAATATGAACCC,0,5037315
ykgRp,0.16666666666666666,5,5,ATGATCCTAGCCTGACGTCA,0,5054649
ykgRp,0.16666666666666666,5,5,ATGAGGACTAATGGTGTCGG,0,5031528
ykgRp,0.16666666666666666,5,5,ATGAGCACTTCTCAACCTAT,0,5048687
ykgRp,0.16666666666666666,5,5,ATCTAAAAAGCGTATCGAGC,0,5043236
ykgRp,0.16666666666666666,5,5,ATCGTCGTTCCTCGGCAGAA,0,5049311
ykgRp,0.16666666666666666,5,5,ATCGGTGTTTGATGCACTGG,0,5049426
ykgRp,0.16666666666666666,5,5,ATCGCACAATAAACAGAGAT,0,5061568
ykgRp,0.16666666666666666,5,5,ATCCTGGCTTAGGACAAGAT,0,5045358
ykgRp,0.16666666666666666,5,5,ATCCCCGGGTGTGACGCGGG,0,5038633
ykgRp,0.16666666666666666,5,5,ATCATGGGGGTACCAGTTTG,0,5033152
ykgRp,0.16666666666666666,5,5,ATCAGTTCGAAAACGTCCTT,0,5052120
ykgRp,0.16666666666666666,5,5,ATCAAGCGGATGGTGTAACG,0,5056823
ykgRp,0.16666666666666666,5,5,ATCAACACGGGATCGTTAGC,0,5061241
ykgRp,0.16666666666666666,5,5,ATATCTTGCCGCCCCTATGT,0,5056372
ykgRp,0.16666666666666666,5,5,ATAGTCGGATGCACGCGATG,0,5054999
ykgRp,0.16666666666666666,5,5,ATAGCAGCGGATTACTTAGA,0,5035518
ykgRp,0.16666666666666666,5,5,ATAGATAAGTTTAGTTACGC,0,5051191
ykgRp,0.16666666666666666,5,5,ATAATTGGTCCTCGCCAGCG,0,5033858
ykgRp,0.16666666666666666,5,5,AGTTGTACGCCACTCAGGCT,0,5034031
ykgRp,0.16666666666666666,5,5,AGTTGAAGTATGTGCTCAAG,0,5050673
ykgRp,0.16666666666666666,5,5,AGTGCCGATTGCGAGGCGGC,0,5057855
ykgRp,0.16666666666666666,5,5,AGTCCTGTGAACTTGTTCGG,0,5049451
ykgRp,0.16666666666666666,5,5,AGTCAGGCAGTCTCAACGCA,0,5036489
ykgRp,0.16666666666666666,5,5,AGTAGGATAACAGGACATTC,0,5053436
ykgRp,0.16666666666666666,5,5,AGTAGACGTATCTGATATTA,0,5032749
ykgRp,0.16666666666666666,5,5,AGTAAGGGGACTGCATGCAA,0,5035199
ykgRp,0.16666666666666666,5,5,AGGTCATAAAGAGTTCCACC,0,5059113
ykgRp,0.16666666666666666,5,5,AGGTACGTAGGCCTTCAGCT,0,5059175
ykgRp,0.16666666666666666,5,5,AGGGGGGGCGTACAGACCTT,0,5057659
ykgRp,0.16666666666666666,5,5,AGGGGCTGGTATTTCAGCCA,0,5053305
ykgRp,0.16666666666666666,5,5,AGGGCCTTGAAGCGCTCGCT,0,5032941
ykgRp,0.16666666666666666,5,5,AGGCCGCAGTCGGGTTTCAT,0,5038096
ykgRp,0.16666666666666666,5,5,AGGCAGGGGTTATTCTTGAG,0,5050289
ykgRp,0.16666666666666666,5,5,AGGATTATACGTAAATGCCG,0,5052306
ykgRp,0.16666666666666666,5,5,AGGAGAGGTATGCCACACCT,0,5044749
ykgRp,0.16666666666666666,5,5,AGGACCTTCGGTCAATGGAA,0,5051315
ykgRp,0.16666666666666666,5,5,AGCTGTGAGGGCCGAGAGAT,0,5059718
ykgRp,0.16666666666666666,5,5,AGCGGAGACCGGCCCTCACA,0,5059820
ykgRp,0.16666666666666666,5,5,AGCCCAGCGCCAAGAAGAGG,0,5034905
ykgRp,0.16666666666666666,5,5,AGCCCAAATTTAGTACATCG,0,5045435
ykgRp,0.16666666666666666,5,5,AGCCAGTCCCTATCAGCTAG,0,5043319
ykgRp,0.16666666666666666,5,5,AGCCAAAATATTAAAGCCAT,0,5031908
ykgRp,0.16666666666666666,5,5,AGCATCGGATGGCGGCACTT,0,5033168
ykgRp,0.16666666666666666,5,5,AGATCGAGGGCAGCATACCT,0,5042182
ykgRp,0.16666666666666666,5,5,AGAGCCAGAGCGGAATTCAG,0,5035800
ykgRp,0.16666666666666666,5,5,AGACTTGGAGGTATTCCATT,0,5052005
ykgRp,0.16666666666666666,5,5,AGACCCCTAATGCCCACTCA,0,5050430
ykgRp,0.16666666666666666,5,5,AGACAATACAGGGGCTACCT,0,5036762
ykgRp,0.16666666666666666,5,5,AGAATCCAAACCCCGTTTCA,0,5057586
ykgRp,0.16666666666666666,5,5,ACTGCGCTTTTCAAAGCGCA,0,5057546
ykgRp,0.16666666666666666,5,5,ACTGAGAGAACAGCAATTTC,0,5040383
ykgRp,0.16666666666666666,5,5,ACTATTAGTACGGGAGCTGT,0,5056457
ykgRp,0.16666666666666666,5,5,ACTAGCGCCGTTCCACCATT,0,5033150
ykgRp,0.16666666666666666,5,5,ACTAAGCCGTCAGTGCCAGC,0,5043280
ykgRp,0.16666666666666666,5,5,ACGTTTAACCCGCTGAGGGT,0,5035336
ykgRp,0.16666666666666666,5,5,ACGTCAGACGTACGAATCGC,0,5050923
ykgRp,0.16666666666666666,5,5,ACGTAGTTGCAAGACCATTT,0,5036273
ykgRp,0.16666666666666666,5,5,ACGTAGACTTCTCATGCACA,0,5044533
ykgRp,0.16666666666666666,5,5,ACGTAAAGCGTAACCAGGAG,0,5032427
ykgRp,0.16666666666666666,5,5,ACGGGTTAAGGTGTTAGCCT,0,5044078
ykgRp,0.16666666666666666,5,5,ACGCGGTAGGAGGTGTGCTG,0,5041654
ykgRp,0.16666666666666666,5,5,ACGCCTACGGCATTTCTTTG,0,5038447
ykgRp,0.16666666666666666,5,5,ACGCAGCGTTTCCATGGGTA,0,5045577
ykgRp,0.16666666666666666,5,5,ACGAGGTAACAGCAACGCGT,0,5039245
ykgRp,0.16666666666666666,5,5,ACGACTGGTCCCCCCTTGAC,0,5060530
ykgRp,0.16666666666666666,5,5,ACCTTGTTCTTGTTCAACTT,0,5032284
ykgRp,0.16666666666666666,5,5,ACCTTCTATCCGCGTTCCAG,0,5054315
ykgRp,0.16666666666666666,5,5,ACCGTGGGAAGGCACTACTG,0,5042779
ykgRp,0.16666666666666666,5,5,ACCGTGCCTGCCCATACTGG,0,5058279
ykgRp,0.16666666666666666,5,5,ACCGCGGCCGTAACAAGTGA,0,5049360
ykgRp,0.16666666666666666,5,5,ACCGCCCGCAACGCTTCGTA,0,5033418
ykgRp,0.16666666666666666,5,5,ACCATATTTCTCGCGGAGTC,0,5040319
ykgRp,0.16666666666666666,5,5,ACCAGTGATCCTACTGGCGC,0,5035170
ykgRp,0.16666666666666666,5,5,ACCAGAGACGGGACGGCCTT,0,5048750
ykgRp,0.16666666666666666,5,5,ACCACACTAGCGTAGAGCCG,0,5053234
ykgRp,0.16666666666666666,5,5,ACCAACCCTAGGAACTTTTG,0,5051418
ykgRp,0.16666666666666666,5,5,ACATGAGTACCCGTCATTCA,0,5054051
ykgRp,0.16666666666666666,5,5,ACATCAGAACGATCGTCCTT,0,5047103
ykgRp,0.16666666666666666,5,5,ACAGCGAGACTGAAAATACT,0,5044674
ykgRp,0.16666666666666666,5,5,ACAGAGCCACCGGCGTGTCC,0,5044260
ykgRp,0.16666666666666666,5,5,ACACTGTGGGCTTCCGGTAA,0,5048455
ykgRp,0.16666666666666666,5,5,ACAAGTCAACGGTAAGCTGA,0,5040118
ykgRp,0.16666666666666666,5,5,ACAAGTAGGCTGAGTGGGCA,0,5049693
ykgRp,0.16666666666666666,5,5,ACAACCGCGTGATCATTCGA,0,5057122
ykgRp,0.16666666666666666,5,5,ACAACCCTCTTCGGCACTTT,0,5043508
ykgRp,0.16666666666666666,5,5,ACAACCAGATACCCGCAACG,0,5033918
ykgRp,0.16666666666666666,5,5,AATGGGGTCTATTCCTTCAA,0,5038613
ykgRp,0.16666666666666666,5,5,AATCTGTTGCTGACAGGCTA,0,5046982
ykgRp,0.16666666666666666,5,5,AATCGTTTGCACACGTAAGA,0,5060775
ykgRp,0.16666666666666666,5,5,AATCAGATCTCCTATCGGAA,0,5047087
ykgRp,0.16666666666666666,5,5,AATCAAGATATATCTACATC,0,5034335
ykgRp,0.16666666666666666,5,5,AATAGCGAACCGCAATGTTG,0,5050155
ykgRp,0.16666666666666666,5,5,AATACAGTGTGTGGGAAAAA,0,5046709
ykgRp,0.16666666666666666,5,5,AAGTGTGTCAGTAATGTTCA,0,5044159
ykgRp,0.16666666666666666,5,5,AAGTCAGAAGGTGGGTTTTA,0,5038786
ykgRp,0.16666666666666666,5,5,AAGTAGAGGTACGGGAAGGC,0,5052890
ykgRp,0.16666666666666666,5,5,AAGTAGACAGCTAACCTTAT,0,5054737
ykgRp,0.16666666666666666,5,5,AAGGTCATTAATCCGGGAAC,0,5060777
ykgRp,0.16666666666666666,5,5,AAGGGAACTGATTTATGCAC,0,5049998
ykgRp,0.16666666666666666,5,5,AAGGATGCAACTTGAAACTC,0,5050946
ykgRp,0.16666666666666666,5,5,AAGCTGCGTAGATACGTCTC,0,5040950
ykgRp,0.16666666666666666,5,5,AAGCTCTGCAGGGAGTTTAT,0,5053166
ykgRp,0.16666666666666666,5,5,AAGCGCCATTTTAACGATAC,0,5047145
ykgRp,0.16666666666666666,5,5,AAGCCAACGGAAGTCGGCTT,0,5049041
ykgRp,0.16666666666666666,5,5,AAGAGTGGTACTCGGTTTAT,0,5048751
ykgRp,0.16666666666666666,5,5,AAGAGGATTGCGGGTTCTTT,0,5032446
ykgRp,0.16666666666666666,5,5,AACTTACGGCAGACTTGTTT,0,5037196
ykgRp,0.16666666666666666,5,5,AACTAGGGGGAATGCGCTTT,0,5040305
ykgRp,0.16666666666666666,5,5,AACTAGCTGAACGATGTATG,0,5032502
ykgRp,0.16666666666666666,5,5,AACGTCGTAATTCAAGTACG,0,5037275
ykgRp,0.16666666666666666,5,5,AACGCGACCAGGGGTTTTTG,0,5056494
ykgRp,0.16666666666666666,5,5,AACGCCGACTGTCATGCAAT,0,5043685
ykgRp,0.16666666666666666,5,5,AACCCTTAACAAGCACGAAG,0,5053018
ykgRp,0.16666666666666666,5,5,AACCATAGCTGCAGACCTAG,0,5034484
ykgRp,0.16666666666666666,5,5,AACATTAGGACTCAGCGACT,0,5032833
ykgRp,0.16666666666666666,5,5,AAATTGCTCCGAACTAACCA,0,5038401
ykgRp,0.16666666666666666,5,5,AAATCTAGCCGATCAGACTA,0,5035807
ykgRp,0.16666666666666666,5,5,AAAGTTGGAGTATAGCAGAC,0,5034334
ykgRp,0.16666666666666666,5,5,AAAGTGGACGGCGATTCGGA,0,5055376
ykgRp,0.16666666666666666,5,5,AAAGCACGGGCAGCTGAGTC,0,5042090
ykgRp,0.16666666666666666,5,5,AAAGATCACTGGTTCAATTA,0,5054527
ykgRp,0.16666666666666666,5,5,AAACTCTGGGGTAGTACGGT,0,5047148
ykgRp,0.16666666666666666,5,5,AAACCCCGCAAGGCAAGGTG,0,5061423
ykgRp,0.16666666666666666,5,5,AAAATTGTTACACAACCTCA,0,5058749
ykgRp,0.16666666666666666,5,5,AAAATGAGATCTTTGTCAGT,0,5037759
ykgRp,0.16666666666666666,5,5,AAAATGACACGGGCAGAGAC,0,5034910
ykgRp,0.16666666666666666,5,5,AAAAGCTTCATGGCACGCGT,0,5033360
ykgRp,0.16666666666666666,5,5,AAAACAAAGTATGTAGGGTT,0,5057142
ykgRp,0.16666666666666666,5,5,AAAAATGCGGGTGACGCGAC,0,5046975
ykgRp,0.16666666666666666,5,5,AAAAAATGTAGCGAAACACG,0,5033647
ykgRp,0.2,4,4,TTTTGCGGACAGCGCACACC,0,5039489
ykgRp,0.2,4,4,TTTTATAAAAACACGTTCAA,0,5057043
ykgRp,0.2,4,4,TTTGGATTCCATAATATCTT,0,5036829
ykgRp,0.2,4,4,TTTGATTTATTTGCAGTAAG,0,5048900
ykgRp,0.2,4,4,TTTCGGATTCTAACAGGGTG,0,5040433
ykgRp,0.2,4,4,TTTCGCAAAAGATCTCGCGA,0,5032907
ykgRp,0.2,4,4,TTTATGTTCACACGTCACGT,0,5036228
ykgRp,0.2,4,4,TTTATAGGCACCCGACCGTA,0,5049153
ykgRp,0.2,4,4,TTTAGTCAGCAAAAACATAT,0,5058776
ykgRp,0.2,4,4,TTTAATCATAAGGGGGGGAG,0,5054613
ykgRp,0.2,4,4,TTGTGTTTGCAATCAAGGCC,0,5047268
ykgRp,0.2,4,4,TTGTGGCTTAGGGTTTAAGG,0,5060444
ykgRp,0.2,4,4,TTGGGGATAACTGCATCTGG,0,5042344
ykgRp,0.2,4,4,TTGGGAGATATCGTGTTGGT,0,5044873
ykgRp,0.2,4,4,TTGGAGGACTGCTCTCTCTG,0,5053683
ykgRp,0.2,4,4,TTGCTCGGGGCACTGTACCA,0,5035473
ykgRp,0.2,4,4,TTGCGTTGATCAGCGGACTT,0,5042175
ykgRp,0.2,4,4,TTGCGAATAGGGACGACGGG,0,5055130
ykgRp,0.2,4,4,TTGCCGCGGTCTGCAGTCCG,0,5036809
ykgRp,0.2,4,4,TTGCATCAGATTCGGTGAGT,0,5048838
ykgRp,0.2,4,4,TTGATACAGGCGGGCACCCG,0,5054215
ykgRp,0.2,4,4,TTGAGTGCCTGAGCAACGCC,0,5056239
ykgRp,0.2,4,4,TTGACCCACAGTACATTTAC,0,5038333
ykgRp,0.2,4,4,TTGAATTGCTGGCTGCCGGA,0,5057011
ykgRp,0.2,4,4,TTGAAGCGACATTCGCCTAA,0,5046099
ykgRp,0.2,4,4,TTGAACCTAATTAATCGGCT,0,5034515
ykgRp,0.2,4,4,TTGAAAGCTGATAGGCTCAA,0,5031326
ykgRp,0.2,4,4,TTCTCCCCAAACCTATAGAT,0,5058168
ykgRp,0.2,4,4,TTCGTGTCACGTAAATCTCC,0,5042601
ykgRp,0.2,4,4,TTCGTAATCGCGCGGGCGCA,0,5053414
ykgRp,0.2,4,4,TTCGCCTCGCCACGAATAGT,0,5061257
ykgRp,0.2,4,4,TTCCTTACGATGGTATACGT,0,5040500
ykgRp,0.2,4,4,TTCCCGCTCTGAAGATATGC,0,5038558
ykgRp,0.2,4,4,TTCCACGGCAGCGATCGAAG,0,5043883
ykgRp,0.2,4,4,TTCAGTTGTGACGTCGTCGG,0,5050583
ykgRp,0.2,4,4,TTATGTAGGATCAGCTGGAC,0,5033327
ykgRp,0.2,4,4,TTATGGCCATGTGTCATATG,0,5042086
ykgRp,0.2,4,4,TTATAGACAGGCAATTCGTA,0,5047403
ykgRp,0.2,4,4,TTAGTGATCAGATCCTGATC,0,5047618
ykgRp,0.2,4,4,TTAGGATTCTCAGGCATCCT,0,5033044
ykgRp,0.2,4,4,TTACCATCCCAGCATTGAGT,0,5039343
ykgRp,0.2,4,4,TTACCAGCTCACCGTGAGAG,0,5038873
ykgRp,0.2,4,4,TTACCAACGTGGATTGCGAG,0,5031786
ykgRp,0.2,4,4,TTAACGGTGGCCCTGGGCGA,0,5054916
ykgRp,0.2,4,4,TTAACAGTAGTTGGCTTGGG,0,5043704
ykgRp,0.2,4,4,TTAACAGGTTTGGTGTATCG,0,5046976
ykgRp,0.2,4,4,TGTTGGTCGCTCGGCTACCA,0,5032129
ykgRp,0.2,4,4,TGTGGTCCTTCCGCACGTAA,0,5056849
ykgRp,0.2,4,4,TGTGCGGTTCAAGGAATGCC,0,5046251
ykgRp,0.2,4,4,TGTGATCTGTCGGGTCCCTG,0,5055627
ykgRp,0.2,4,4,TGTCCATCCGTTGTGGCCAT,0,5060966
ykgRp,0.2,4,4,TGTCAAAACAACGTAGTTAT,0,5044987
ykgRp,0.2,4,4,TGTACTCGCATTAACGCAGA,0,5033370
ykgRp,0.2,4,4,TGGTGGGCGGTCTTATAAAG,0,5044269
ykgRp,0.2,4,4,TGGTACACGCGTCGGCGCCG,0,5044343
ykgRp,0.2,4,4,TGGGCTCGCCAAACAGTTAA,0,5031399
ykgRp,0.2,4,4,TGGGCGTACGTGACGCACGA,0,5061591
ykgRp,0.2,4,4,TGGGCCGGACGGCGCATGTT,0,5036214
ykgRp,0.2,4,4,TGGGCAAATAGTCGCCCCTG,0,5036602
ykgRp,0.2,4,4,TGGGAAGAACGTTGACAGTG,0,5045251
ykgRp,0.2,4,4,TGGCACCCAGCAGGGATCAA,0,5039086
ykgRp,0.2,4,4,TGGCACAGTAGAGCCTTGCC,0,5056740
ykgRp,0.2,4,4,TGGACGCGACCTATAGCGGA,0,5036354
ykgRp,0.2,4,4,TGGAAAAATTGAGACGAGTA,0,5053828
ykgRp,0.2,4,4,TGCTCCCGATCTTTGATCCT,0,5039620
ykgRp,0.2,4,4,TGCTAAGCAATTCGGAGGAT,0,5059252
ykgRp,0.2,4,4,TGCGCCTGGGAATCACTAAG,0,5041939
ykgRp,0.2,4,4,TGCGAAACAAGTCTCCCACC,0,5039062
ykgRp,0.2,4,4,TGCCCTAAAACCAAGACGAC,0,5047025
ykgRp,0.2,4,4,TGCAGCTGAGGGGCCAAGTT,0,5039030
ykgRp,0.2,4,4,TGATCACTGATTATTGGTGC,0,5036415
ykgRp,0.2,4,4,TGAGGGCAGCAAACCCCTCC,0,5031964
ykgRp,0.2,4,4,TGAGCTTATCAACGGGGCGA,0,5056428
ykgRp,0.2,4,4,TGACTTGTAAACCAGCGGAA,0,5059680
ykgRp,0.2,4,4,TGACTGGGGGACTGCGAACG,0,5047726
ykgRp,0.2,4,4,TGACGTATCAAAAATGAGCA,0,5053148
ykgRp,0.2,4,4,TGAATGCAGGCTCGTCTGGA,0,5057639
ykgRp,0.2,4,4,TGAAGGTTCCCATACCTACT,0,5055103
ykgRp,0.2,4,4,TGAAGCCGCTTGTGAGTTCA,0,5046376
ykgRp,0.2,4,4,TGAACCAAGCAACGACGATT,0,5056048
ykgRp,0.2,4,4,TGAAATTTCTACCGCCTTCG,0,5060657
ykgRp,0.2,4,4,TCTTTTTATTGTACTTTTCT,0,5056426
ykgRp,0.2,4,4,TCTTATCCTAATGGTCAAAC,0,5050464
ykgRp,0.2,4,4,TCTGTACCCTTGTTGGCTAT,0,5034882
ykgRp,0.2,4,4,TCTGCACCAGTAGACAGAAG,0,5039526
ykgRp,0.2,4,4,TCTGAACTGTCTCTTTAGGT,0,5045601
ykgRp,0.2,4,4,TCTCTTCTCTGAAAGATCGT,0,5035816
ykgRp,0.2,4,4,TCTCTTAACACTGGGTATAA,0,5048645
ykgRp,0.2,4,4,TCTCGTTGCAGAGCATTCAT,0,5045027
ykgRp,0.2,4,4,TCTCGCGTGCTTCACTTTTG,0,5034919
ykgRp,0.2,4,4,TCTCAGGGTTAAGGTACGCA,0,5045820
ykgRp,0.2,4,4,TCTATTTGACGCATAGTTCG,0,5060786
ykgRp,0.2,4,4,TCTACGGGGTCAGACCTGGT,0,5042408
ykgRp,0.2,4,4,TCTAATCAAACGGCTGCGGC,0,5036718
ykgRp,0.2,4,4,TCTAAAAGAAGTGGTCTATT,0,5042803
ykgRp,0.2,4,4,TCGTGGGATCACTCTATATC,0,5048294
ykgRp,0.2,4,4,TCGTACAAGTGATCGTTCTC,0,5035383
ykgRp,0.2,4,4,TCGGGTGGCCGTCACTAGAC,0,5060257
ykgRp,0.2,4,4,TCGGCCATCCGAGTCTGGTG,0,5048397
ykgRp,0.2,4,4,TCGGATTGAGTGGGGCTTTA,0,5060429
ykgRp,0.2,4,4,TCGGATCTAACTAAGACTGC,0,5048273
ykgRp,0.2,4,4,TCGCATCCGTATCCATCTTA,0,5056856
ykgRp,0.2,4,4,TCGCAACCGTTACGGGGAAA,0,5058642
ykgRp,0.2,4,4,TCCTACCCGTGATTAGAATC,0,5056714
ykgRp,0.2,4,4,TCCGGGTGGAGCTAGGCAAT,0,5039600
ykgRp,0.2,4,4,TCCCGGTACGGCATGCTGCA,0,5058415
ykgRp,0.2,4,4,TCCCGATGATTGTTCTCGAC,0,5054761
ykgRp,0.2,4,4,TCCATTATCGCTGTCCCAAC,0,5052684
ykgRp,0.2,4,4,TCCAGGACTTCCCGAGTCTG,0,5041752
ykgRp,0.2,4,4,TCCACGTCGCGGGTGCTGGA,0,5046726
ykgRp,0.2,4,4,TCCAACCTGTATAGGTGGCG,0,5046599
ykgRp,0.2,4,4,TCATTGACATATATCGACGT,0,5045479
ykgRp,0.2,4,4,TCATTAGAAGCTAGCAGTGC,0,5047721
ykgRp,0.2,4,4,TCATGTCGTCGTAGCTGCTG,0,5061463
ykgRp,0.2,4,4,TCAGTGCGGCCATACGGCTT,0,5049929
ykgRp,0.2,4,4,TCAGCGGACCACATCTTATG,0,5060119
ykgRp,0.2,4,4,TCAGCAAGCATTCCCCTCAC,0,5049624
ykgRp,0.2,4,4,TCAGAAGGAGGCCGCCTCTT,0,5033277
ykgRp,0.2,4,4,TCACCTCCATCTAACCTGTA,0,5052232
ykgRp,0.2,4,4,TCACACGAGGTATTGACCGT,0,5034032
ykgRp,0.2,4,4,TCACACCCACTACAACTGGT,0,5057032
ykgRp,0.2,4,4,TCACAATCGGCTTAGATGTT,0,5049630
ykgRp,0.2,4,4,TCACAAGTGGCAAAAATTTA,0,5038367
ykgRp,0.2,4,4,TCACAAGTATCCTTCTACAT,0,5035790
ykgRp,0.2,4,4,TCAATTAGCGCAATTAACAC,0,5055012
ykgRp,0.2,4,4,TCAATAAGGGTGCCAGGACT,0,5034758
ykgRp,0.2,4,4,TCAAAAGATCCACACGATGG,0,5039657
ykgRp,0.2,4,4,TATTTCGATCACCAATTATA,0,5035906
ykgRp,0.2,4,4,TATTGACCAACTAAGCATTT,0,5032350
ykgRp,0.2,4,4,TATTCAGGGCTGAACCTGAT,0,5032528
ykgRp,0.2,4,4,TATGTCTGTGCGCAACGGCC,0,5042365
ykgRp,0.2,4,4,TATGTCAAAGGGGGTGTTCA,0,5032646
ykgRp,0.2,4,4,TATGGGATAAGATATCACTT,0,5048485
ykgRp,0.2,4,4,TATGGAAGGATTGTTATCGT,0,5050341
ykgRp,0.2,4,4,TATGCACGAAAACCGACAGA,0,5033866
ykgRp,0.2,4,4,TATGATGCGGTGTAGGCGCA,0,5052360
ykgRp,0.2,4,4,TATCGCGGTCAAGCGGCTTA,0,5037813
ykgRp,0.2,4,4,TATCCAGATTGGATTGTTTT,0,5040137
ykgRp,0.2,4,4,TATCACCAGACCTCTAACTG,0,5033521
ykgRp,0.2,4,4,TATATGTTGGTTAACAAGAG,0,5038146
ykgRp,0.2,4,4,TAGGTTCAGGACACAGTGTA,0,5034643
ykgRp,0.2,4,4,TAGGATCTCGCGCCATTCCT,0,5053649
ykgRp,0.2,4,4,TAGGAGTTCAATTTGCTACT,0,5048625
ykgRp,0.2,4,4,TAGGAACATCTGGCATACCA,0,5058738
ykgRp,0.2,4,4,TAGCGTGGCTGTGGGGGCCA,0,5046472
ykgRp,0.2,4,4,TAGCGAGTTCTTGCGTTAGT,0,5052100
ykgRp,0.2,4,4,TAGACTGGTCTTATGCGAGG,0,5050691
ykgRp,0.2,4,4,TACTTTCAGATCTCGTTCGC,0,5039105
ykgRp,0.2,4,4,TACTTATACTCAGTAGTCCA,0,5048774
ykgRp,0.2,4,4,TACTGGGGGGGTTTTTGGAA,0,5056817
ykgRp,0.2,4,4,TACGTGTCTAACCCGTCAAT,0,5046317
ykgRp,0.2,4,4,TACGGACTCGCGCAGGCTTG,0,5053590
ykgRp,0.2,4,4,TACGCCCCATCCGCTCGGAG,0,5061205
ykgRp,0.2,4,4,TACGACGACCCGGGTCAAGT,0,5051779
ykgRp,0.2,4,4,TACCTCAAACCGGGCAATTG,0,5049714
ykgRp,0.2,4,4,TACCGTCAGGGAGAGAGATT,0,5047158
ykgRp,0.2,4,4,TACCATCGGACCATGCATCT,0,5044645
ykgRp,0.2,4,4,TACAGTTACTCTGACGTTAG,0,5057157
ykgRp,0.2,4,4,TACACTCAAGCGCAAGTAAA,0,5049246
ykgRp,0.2,4,4,TACAATAGTACGGGAGAAAC,0,5057143
ykgRp,0.2,4,4,TACAAGTTGAAGAATCTCCT,0,5061161
ykgRp,0.2,4,4,TACAACTTGATTTAATGTAG,0,5040150
ykgRp,0.2,4,4,TAATAGAGGGCGGACTGATT,0,5058516
ykgRp,0.2,4,4,TAAGAAGGACCGTACACTGC,0,5057893
ykgRp,0.2,4,4,TAACTGTTAAAGCCTCCACA,0,5056820
ykgRp,0.2,4,4,TAAATTCGGCACCCCTGATC,0,5054814
ykgRp,0.2,4,4,TAAAGGTCACACAGACATGT,0,5057616
ykgRp,0.2,4,4,TAAAGCACGACCATGTGCTA,0,5032687
ykgRp,0.2,4,4,GTTTCAGGCAAGCCCGTCAC,0,5047060
ykgRp,0.2,4,4,GTTTAAGAGCTGTGATTATA,0,5034463
ykgRp,0.2,4,4,GTTGTTTGTGGGAATGACAC,0,5052645
ykgRp,0.2,4,4,GTTGTTGCTGACGGTGATCC,0,5033590
ykgRp,0.2,4,4,GTTCTTCGCACGCCTAACAT,0,5045717
ykgRp,0.2,4,4,GTTCTGTAGCGTACCACACT,0,5037488
ykgRp,0.2,4,4,GTTCTAATACGTTGGGAGCA,0,5039337
ykgRp,0.2,4,4,GTTCGGGGCTGTTTGATAAC,0,5040605
ykgRp,0.2,4,4,GTTCGAAACTGTCTAGTAAA,0,5039363
ykgRp,0.2,4,4,GTTCCCGACTTTGGAAGAGG,0,5059051
ykgRp,0.2,4,4,GTTAATGAGGTTTAAAAGTT,0,5053382
ykgRp,0.2,4,4,GTGTTACGTGGCCCGGTGGG,0,5036674
ykgRp,0.2,4,4,GTGTGGACTGTGCGTGGTTA,0,5038311
ykgRp,0.2,4,4,GTGTGAACTTGATGTGGTGT,0,5034046
ykgRp,0.2,4,4,GTGGTGAGGGTTCAGGTGGC,0,5031817
ykgRp,0.2,4,4,GTGGTCGCGAACCGGCTAGG,0,5053336
ykgRp,0.2,4,4,GTGGTAAAGAAAATAAAACT,0,5057511
ykgRp,0.2,4,4,GTGGCGCCACTCGCGAAGGA,0,5047770
ykgRp,0.2,4,4,GTGGATCAACCGACTAGATG,0,5047479
ykgRp,0.2,4,4,GTGCATATTTTTTACGAGAA,0,5039490
ykgRp,0.2,4,4,GTGATGTGAAGGGCTATTGA,0,5035798
ykgRp,0.2,4,4,GTGATGACCACTGTGCCCGG,0,5056555
ykgRp,0.2,4,4,GTGACATGCATACAACAAGC,0,5061219
ykgRp,0.2,4,4,GTCTTTCGAAGGTTGCAAAA,0,5059354
ykgRp,0.2,4,4,GTCTACGCTAGAGCATTAAT,0,5054963
ykgRp,0.2,4,4,GTCTACAGCCGGCCTCTGAT,0,5045100
ykgRp,0.2,4,4,GTCGTTATAACAGAGACTTT,0,5037450
ykgRp,0.2,4,4,GTCGGCTATTAAAATACTTT,0,5055436
ykgRp,0.2,4,4,GTCGGAGGGGCGGAAGGTAC,0,5047572
ykgRp,0.2,4,4,GTCGCCTATCAACTATACGT,0,5044413
ykgRp,0.2,4,4,GTCCTTCTCTGGCAAAGTCT,0,5042001
ykgRp,0.2,4,4,GTCCCTCGGTATGATAAATC,0,5040857
ykgRp,0.2,4,4,GTCATCAGCAATAGCCCTAG,0,5054465
ykgRp,0.2,4,4,GTCACTCACTAAAACTGCAT,0,5040918
ykgRp,0.2,4,4,GTCACATGACCAAAACCTCC,0,5045463
ykgRp,0.2,4,4,GTATTCCCCGGAATAGCACT,0,5039390
ykgRp,0.2,4,4,GTATCGCCTCACTCCCTGAT,0,5054159
ykgRp,0.2,4,4,GTATAAAGGTCGTGAGTTCT,0,5038138
ykgRp,0.2,4,4,GTATAAACACTCTCTAAGGT,0,5036417
ykgRp,0.2,4,4,GTAGTTTGGTCATACAGTAG,0,5057936
ykgRp,0.2,4,4,GTAGGCCGAGCAGCCCTATC,0,5034730
ykgRp,0.2,4,4,GTAGCCATTACACTATTGCG,0,5036847
ykgRp,0.2,4,4,GTAGATGGTAAATCGATGGA,0,5032339
ykgRp,0.2,4,4,GTAGAACGTGTTTGGCCAAA,0,5047113
ykgRp,0.2,4,4,GTACGAGGGGAACGTGTCAA,0,5047655
ykgRp,0.2,4,4,GTACCTAGGATGATGTCCTC,0,5054263
ykgRp,0.2,4,4,GTACCCAAAGTCCAATCACA,0,5049408
ykgRp,0.2,4,4,GTACATCGCTTGGGACTGGA,0,5046132
ykgRp,0.2,4,4,GTAAGCTAACGGGCAAAAAG,0,5050302
ykgRp,0.2,4,4,GTAAGCCCGCTTGGAGGAGT,0,5056911
ykgRp,0.2,4,4,GTAACTCACTTGGTTATTGG,0,5046227
ykgRp,0.2,4,4,GTAAAAGATCAACTAAGATG,0,5057272
ykgRp,0.2,4,4,GGTTTGTGCCAGTTAGGGAC,0,5055249
ykgRp,0.2,4,4,GGTTTCTCGATACTAGGCTG,0,5048116
ykgRp,0.2,4,4,GGTTTCATACTGGCCTTGAA,0,5055355
ykgRp,0.2,4,4,GGTTGGGAACTCACTTAGAG,0,5049550
ykgRp,0.2,4,4,GGTTAGTGAAGTCAGTCTAG,0,5032449
ykgRp,0.2,4,4,GGTGCTCGGAAACTGGGTCT,0,5040062
ykgRp,0.2,4,4,GGTCGTCGGGAATCGCGGTC,0,5042239
ykgRp,0.2,4,4,GGTCGGTTTACTCATTTCCG,0,5033593
ykgRp,0.2,4,4,GGTCCTAGAACTGGCGCTAC,0,5053725
ykgRp,0.2,4,4,GGTCAACCGTGGGCCATCAT,0,5060366
ykgRp,0.2,4,4,GGTATCGTCCGGGAGACCCA,0,5036996
ykgRp,0.2,4,4,GGTAGATACGGACGTCTGGC,0,5037396
ykgRp,0.2,4,4,GGTAATAGAAGAAGTCGATC,0,5051822
ykgRp,0.2,4,4,GGGTCGGTGCCTGACGGCTT,0,5032368
ykgRp,0.2,4,4,GGGGGATGTTCATGTCTCCG,0,5045780
ykgRp,0.2,4,4,GGGGCTCTCATATTGCATGG,0,5046979
ykgRp,0.2,4,4,GGGCAGGTGCAAAAGGATTG,0,5034449
ykgRp,0.2,4,4,GGGATCTCGCGTCTAGGGGT,0,5040828
ykgRp,0.2,4,4,GGGATCACACTCTTTGCCGC,0,5036577
ykgRp,0.2,4,4,GGGAGTGTGCGTCATTGGCA,0,5031690
ykgRp,0.2,4,4,GGGAGGTTGTAAGGAGTAAA,0,5041255
ykgRp,0.2,4,4,GGGACCAAGGCGACCGCAAT,0,5052279
ykgRp,0.2,4,4,GGGAAGGGTGTAGTTATACA,0,5059060
ykgRp,0.2,4,4,GGGAAATACAGACAGGCACT,0,5033287
ykgRp,0.2,4,4,GGCTTTGTAGGATGGGGGGA,0,5058718
ykgRp,0.2,4,4,GGCTGGCAATCCCGAGACTT,0,5042089
ykgRp,0.2,4,4,GGCTAGTTGGAAAGAAGTCT,0,5057508
ykgRp,0.2,4,4,GGCTAGGCCGTACCATTCAG,0,5043056
ykgRp,0.2,4,4,GGCTAGCTTTCATGCAACTT,0,5042691
ykgRp,0.2,4,4,GGCTACACAGGACGTGACGT,0,5051813
ykgRp,0.2,4,4,GGCGGTACTCGGATTTCGCC,0,5035306
ykgRp,0.2,4,4,GGCGAATCGTGATACGGGTT,0,5039340
ykgRp,0.2,4,4,GGCCTGATGGTATTCGCCAG,0,5042662
ykgRp,0.2,4,4,GGCCGTCTTACGCGTAGAGG,0,5034427
ykgRp,0.2,4,4,GGCCCTACCATCTGATTACA,0,5036628
ykgRp,0.2,4,4,GGCCACGGTCCGGCCATGTC,0,5037092
ykgRp,0.2,4,4,GGCATAAGGCAAACTGTAAG,0,5034280
ykgRp,0.2,4,4,GGCAGGACTAGGAGACAATG,0,5054099
ykgRp,0.2,4,4,GGCACAGGTGGGGCGACAGA,0,5038440
ykgRp,0.2,4,4,GGCAATCGCAGGTCTCCATA,0,5044952
ykgRp,0.2,4,4,GGCAACAGGACTCCGAGTTA,0,5059519
ykgRp,0.2,4,4,GGATGGCTTCAAGACAGAGT,0,5059459
ykgRp,0.2,4,4,GGAGGGTTTAGACAGCGTCG,0,5041361
ykgRp,0.2,4,4,GGAGGCGTTACTGGAAACCT,0,5032050
ykgRp,0.2,4,4,GGAGGCGTCGGAAACCATCT,0,5045010
ykgRp,0.2,4,4,GGAGATATTCGGGCAAGCGT,0,5057181
ykgRp,0.2,4,4,GGACTTCGCCACCTTCTTTT,0,5045200
ykgRp,0.2,4,4,GGACACTAGTGAAACACGAA,0,5049532
ykgRp,0.2,4,4,GGAAGACCCAGTTCAGGGAA,0,5033879
ykgRp,0.2,4,4,GCTTGAGCGTCCCCATTGCT,0,5042150
ykgRp,0.2,4,4,GCTGTTTGTGAAGAGTCTCG,0,5041552
ykgRp,0.2,4,4,GCTGTTGTTACTACTTATAC,0,5041305
ykgRp,0.2,4,4,GCTGTCCAGACGGGGCTCAA,0,5054236
ykgRp,0.2,4,4,GCTGCATATAGCTGCGTATG,0,5046964
ykgRp,0.2,4,4,GCTGAACGGCCTCACTTAAT,0,5050153
ykgRp,0.2,4,4,GCTCAGTACCACTCGGATCC,0,5052171
ykgRp,0.2,4,4,GCTAGTGATGGGTATAGCCT,0,5032321
ykgRp,0.2,4,4,GCTAGGGATAGACCTTGCAA,0,5031576
ykgRp,0.2,4,4,GCTAGGAACCCTCCAGCGTA,0,5056762
ykgRp,0.2,4,4,GCTACTCTCTACTGCACAGT,0,5054760
ykgRp,0.2,4,4,GCGTGTGAGCAGACTGGAAG,0,5051941
ykgRp,0.2,4,4,GCGGTGAATCATAGCGATAT,0,5038294
ykgRp,0.2,4,4,GCGGTCCAACAGAAACTGCT,0,5035806
ykgRp,0.2,4,4,GCGGACGGGGATCCATCTAC,0,5046618
ykgRp,0.2,4,4,GCGCGTGAGTACTCTGGGGG,0,5044641
ykgRp,0.2,4,4,GCGCGAGACACCAGAACCTT,0,5036958
ykgRp,0.2,4,4,GCGCCTGATAGTAAACCTGA,0,5050945
ykgRp,0.2,4,4,GCGCACATCGTGCATTTCGC,0,5045835
ykgRp,0.2,4,4,GCGAGGTAACGTGATTGTCG,0,5034225
ykgRp,0.2,4,4,GCGACTGATCGTTAGTCTAT,0,5058940
ykgRp,0.2,4,4,GCGAATCCCGAGTGCATTCG,0,5046580
ykgRp,0.2,4,4,GCGAAGTTTGGGCTAGGTAT,0,5035361
ykgRp,0.2,4,4,GCCTCTAATTCAGCCAATAA,0,5034830
ykgRp,0.2,4,4,GCCGGCCTGGCCGGGAGACC,0,5044414
ykgRp,0.2,4,4,GCCGCCTATATAGAACAAAG,0,5045426
ykgRp,0.2,4,4,GCCGATGCTGCGTGTCGAAG,0,5061101
ykgRp,0.2,4,4,GCCGAGAGCCTTGGGCCACG,0,5053988
ykgRp,0.2,4,4,GCCGACCTTTCGGTTTGTTA,0,5041749
ykgRp,0.2,4,4,GCCCTTCTAGGGGTTCGTTT,0,5044933
ykgRp,0.2,4,4,GCCCTCATTCTGTTATAAGG,0,5058065
ykgRp,0.2,4,4,GCCAAGTTCAGAGGGCGGGT,0,5056816
ykgRp,0.2,4,4,GCATCAACACCTGTCGGGTT,0,5049443
ykgRp,0.2,4,4,GCAGTATTAGTGTACCCGAA,0,5047505
ykgRp,0.2,4,4,GCAGGAAAACTCTTGCTTTA,0,5040635
ykgRp,0.2,4,4,GCACGTCTTTATCTCAGACC,0,5054878
ykgRp,0.2,4,4,GCACGTCTCCTATCACGACA,0,5042060
ykgRp,0.2,4,4,GCACCAGATCCCGCAGTCAC,0,5043651
ykgRp,0.2,4,4,GCACAGCCACAGAAAGGCTG,0,5032761
ykgRp,0.2,4,4,GCAAGGGGAGGGAGGGTGAG,0,5043881
ykgRp,0.2,4,4,GCAAGCCCGGTGAGTTGGCG,0,5033442
ykgRp,0.2,4,4,GCAAAGTCGGGTGTCGTACG,0,5041359
ykgRp,0.2,4,4,GATTGCGACCATCGTTCAGC,0,5061739
ykgRp,0.2,4,4,GATTCTAAGGTACTGCTTCG,0,5058624
ykgRp,0.2,4,4,GATGTGTTAATGTAGACATT,0,5039495
ykgRp,0.2,4,4,GATGTATTAGGCAATAGGTC,0,5035376
ykgRp,0.2,4,4,GATGGTGCTGCAACGCAGAG,0,5043220
ykgRp,0.2,4,4,GATGGCGGACCGACAAATTC,0,5058328
ykgRp,0.2,4,4,GATGCGCGGTTGCGGGCGAC,0,5055708
ykgRp,0.2,4,4,GATCGTATCACTCTGCAAGT,0,5031941
ykgRp,0.2,4,4,GATCGGGGCTCCAAGAAACT,0,5048123
ykgRp,0.2,4,4,GATCGACAGTCAAAACACTA,0,5047776
ykgRp,0.2,4,4,GATAGGTAGACAGCAACAAA,0,5047854
ykgRp,0.2,4,4,GATAAGACCGGATCGCCACT,0,5058796
ykgRp,0.2,4,4,GAGTTCGCGTCGTGAGCTGA,0,5039205
ykgRp,0.2,4,4,GAGTTAGTCTTATCTGTGGG,0,5055765
ykgRp,0.2,4,4,GAGTACTTGAGTTTCGAAAA,0,5033117
ykgRp,0.2,4,4,GAGGGTGTGTACGTTTCTTC,0,5049048
ykgRp,0.2,4,4,GAGGGTCGAACCCTTCCGAT,0,5049286
ykgRp,0.2,4,4,GAGGGGCCGGTATTCACGTC,0,5055843
ykgRp,0.2,4,4,GAGACGACTACTTTCAACAT,0,5047186
ykgRp,0.2,4,4,GAGACAAATTAGCTACTCGA,0,5042491
ykgRp,0.2,4,4,GACTTGGATTTGAATAGTTG,0,5052980
ykgRp,0.2,4,4,GACTGTAGTGTATGCGGGCA,0,5047999
ykgRp,0.2,4,4,GACTCTTGGCCTTTAAAAAG,0,5045245
ykgRp,0.2,4,4,GACTAGAGCGCTAGCTTGGG,0,5051868
ykgRp,0.2,4,4,GACGTAGGATGAGCTCGCGA,0,5037146
ykgRp,0.2,4,4,GACGCCTACAGTTAACTAAT,0,5031974
ykgRp,0.2,4,4,GACCTAGAGCCATTCGCATT,0,5042092
ykgRp,0.2,4,4,GACCGCTGTCTTCTGCTCGT,0,5036635
ykgRp,0.2,4,4,GACCGCGGGGGGTCGCAGTT,0,5049314
ykgRp,0.2,4,4,GACCGATTTAGAGGGAGCAT,0,5059329
ykgRp,0.2,4,4,GACCAGTTTACATATAGGGT,0,5037937
ykgRp,0.2,4,4,GACCAGTGAAGGCGTACCAA,0,5054732
ykgRp,0.2,4,4,GACCAGGAACCTATTAACAA,0,5051015
ykgRp,0.2,4,4,GACATACCGGGTATAACCGG,0,5031770
ykgRp,0.2,4,4,GACACCAGAGGTGAGTTCCG,0,5056979
ykgRp,0.2,4,4,GAATTATGGTGGCCTCTATT,0,5048213
ykgRp,0.2,4,4,GAATGTTAGCGAATCATTTG,0,5037796
ykgRp,0.2,4,4,GAATGTGCGCCAGCTGAGGA,0,5057053
ykgRp,0.2,4,4,GAAGGGGTGATCGGGTTGAA,0,5040255
ykgRp,0.2,4,4,GAAGCGTCGCCAAGAATGGA,0,5047340
ykgRp,0.2,4,4,GAACTCGCAAGGGCTTTCGG,0,5045797
ykgRp,0.2,4,4,GAACGGAAGACGGATGAACG,0,5061107
ykgRp,0.2,4,4,GAAAGAGGAAGCGCTCTTAT,0,5032081
ykgRp,0.2,4,4,GAAACAATTTATTGCGGATT,0,5042448
ykgRp,0.2,4,4,CTTTGCTTCGTTAGTTATCA,0,5049252
ykgRp,0.2,4,4,CTTTCCTCCCCGAGAATATA,0,5039485
ykgRp,0.2,4,4,CTTGGTTCGGTAGATATATA,0,5044306
ykgRp,0.2,4,4,CTTCTTTACCGGGGGCTTAT,0,5032535
ykgRp,0.2,4,4,CTTATCAAAGGCGATTCTAC,0,5061470
ykgRp,0.2,4,4,CTTATATTTGGACTCTATGT,0,5042428
ykgRp,0.2,4,4,CTTAAAATCACGGAAGATTC,0,5032725
ykgRp,0.2,4,4,CTGTACTTCGATATATCCAC,0,5044761
ykgRp,0.2,4,4,CTGTAAGTATGGTCCTACCG,0,5038127
ykgRp,0.2,4,4,CTGGTATAGAGCAATTGTCT,0,5060458
ykgRp,0.2,4,4,CTGCGGATCATACACAGTAG,0,5034019
ykgRp,0.2,4,4,CTGATTTGGTCGTAGAGATC,0,5042084
ykgRp,0.2,4,4,CTCTTGGGCGTTACGCTCTT,0,5053623
ykgRp,0.2,4,4,CTCTGTTCCAGCGTACGTAC,0,5056899
ykgRp,0.2,4,4,CTCGTTCCTCAGTTGTTCAT,0,5052381
ykgRp,0.2,4,4,CTCGGTCGTCTCATAGCTGG,0,5043580
ykgRp,0.2,4,4,CTCGAGGACGATAGAGTAGA,0,5046585
ykgRp,0.2,4,4,CTCGAATTCCCTACCGCGAC,0,5040678
ykgRp,0.2,4,4,CTCCTTACGTTTTTGTCCGA,0,5051560
ykgRp,0.2,4,4,CTCCGCAGCGAGTCCCTGCT,0,5051747
ykgRp,0.2,4,4,CTCAGAACGCTGACCTTCGT,0,5038050
ykgRp,0.2,4,4,CTATGCACGTTTCATTCATC,0,5041459
ykgRp,0.2,4,4,CTATCGTTGGATTATTTATC,0,5041502
ykgRp,0.2,4,4,CTAGTGTTTGGCATACGGGG,0,5059471
ykgRp,0.2,4,4,CTAGTAGGAGAATCCAGGGA,0,5032261
ykgRp,0.2,4,4,CTACCCATGGCGCGTTGAAC,0,5045856
ykgRp,0.2,4,4,CTACAACCTACGTGGCCTGC,0,5042835
ykgRp,0.2,4,4,CTAAGCCAACGGACGCGCTA,0,5043224
ykgRp,0.2,4,4,CTAACGCAGAGCCGTCGCTC,0,5040938
ykgRp,0.2,4,4,CGTTTTTGTGGCCGCTCCCA,0,5034234
ykgRp,0.2,4,4,CGTTTCTACGGGCTGATTCA,0,5032513
ykgRp,0.2,4,4,CGTTGTCAGCTCGTGACGGC,0,5038917
ykgRp,0.2,4,4,CGTGGTTTACACTAACATGA,0,5047568
ykgRp,0.2,4,4,CGTCTTCCAGAAGTGGAGCC,0,5039622
ykgRp,0.2,4,4,CGTCGCCATGGCCGTTTTAA,0,5042260
ykgRp,0.2,4,4,CGTCCAGAGCGGACCAACCA,0,5061747
ykgRp,0.2,4,4,CGTCAGCCGATAAGACGTTC,0,5058370
ykgRp,0.2,4,4,CGTAACTGGTTACAAATCCG,0,5045009
ykgRp,0.2,4,4,CGGTTTGGCTTCATGATTGG,0,5048113
ykgRp,0.2,4,4,CGGTTAGACATAATACACGT,0,5059915
ykgRp,0.2,4,4,CGGTGCCACATCGCAGCGAT,0,5049741
ykgRp,0.2,4,4,CGGTCTTACCTCCATCGCCT,0,5055935
ykgRp,0.2,4,4,CGGTAGACCAAGCGGTGTAA,0,5038292
ykgRp,0.2,4,4,CGGTACCCCACTAGGGGAGT,0,5040747
ykgRp,0.2,4,4,CGGCGTAACGCCACCTCATC,0,5034055
ykgRp,0.2,4,4,CGGCGATTTATAGCTGCCAT,0,5037247
ykgRp,0.2,4,4,CGGCGATTATACGGCCGGAA,0,5061695
ykgRp,0.2,4,4,CGGCATTGTCGGGATGCGTA,0,5059389
ykgRp,0.2,4,4,CGGATATATATAAGCCACAC,0,5034859
ykgRp,0.2,4,4,CGGAATGCATGTCCTGGTTA,0,5058666
ykgRp,0.2,4,4,CGGAATACAGCTCATCACGT,0,5057271
ykgRp,0.2,4,4,CGCTCGCCGTATTTGGCTGG,0,5033324
ykgRp,0.2,4,4,CGCGGTTACTCGTGTCGTGC,0,5059082
ykgRp,0.2,4,4,CGCGGTCCCATCTCTTGAAT,0,5053180
ykgRp,0.2,4,4,CGCGGACGAGTCTCGTGCCC,0,5052982
ykgRp,0.2,4,4,CGCGCTTCCCGCCCCTCTCT,0,5031397
ykgRp,0.2,4,4,CGCCTGATGATTCACACGGA,0,5057020
ykgRp,0.2,4,4,CGCCCTTTACGATCTCGACA,0,5058036
ykgRp,0.2,4,4,CGCCCCGCCTGTCGCGTTCT,0,5033679
ykgRp,0.2,4,4,CGCATTAAAGTTAGTCAGAA,0,5035581
ykgRp,0.2,4,4,CGCATGGTCAATCCACCTAA,0,5039920
ykgRp,0.2,4,4,CGCAGTGTTCGTGGGAAAGG,0,5037526
ykgRp,0.2,4,4,CGCACTGTTAACGATGTGTT,0,5049382
ykgRp,0.2,4,4,CGCAAGTACGTGAACCTGAT,0,5056940
ykgRp,0.2,4,4,CGCAAGGTTAAGGTCACAGT,0,5059307
ykgRp,0.2,4,4,CGCAAGCCAGACTCAAGGCG,0,5031616
ykgRp,0.2,4,4,CGATTCTAAACCAATTTGAG,0,5056827
ykgRp,0.2,4,4,CGAGTCTCGTCAGTTCGCCC,0,5031815
ykgRp,0.2,4,4,CGAGGGGGTAGCCAGCCCCA,0,5059693
ykgRp,0.2,4,4,CGAGGCGAAACATGACCGCT,0,5044664
ykgRp,0.2,4,4,CGAGGATCATGTACGAGTTC,0,5031661
ykgRp,0.2,4,4,CGAGCGGACTTTCGGCGGTT,0,5044691
ykgRp,0.2,4,4,CGACTGAAGGTTCACCTAGG,0,5048159
ykgRp,0.2,4,4,CGACGGGTTATGTACTACGG,0,5049565
ykgRp,0.2,4,4,CGACGAGCATGGAGGAGGTA,0,5044161
ykgRp,0.2,4,4,CGACCCTGGTAATGCGTAGC,0,5045923
ykgRp,0.2,4,4,CGACATGTTTTTGTATGAGA,0,5045029
ykgRp,0.2,4,4,CGACAAACCTAATTCATAAG,0,5043250
ykgRp,0.2,4,4,CGAATTTCATCATGGGTGAC,0,5032475
ykgRp,0.2,4,4,CGAATGCTTGCCTTGGTCGC,0,5033261
ykgRp,0.2,4,4,CGAATAATTTCGGATTAGCT,0,5059187
ykgRp,0.2,4,4,CGAACGCTAGTCGTTAACGA,0,5034371
ykgRp,0.2,4,4,CCTTTTTTGTAATACAAGGC,0,5034553
ykgRp,0.2,4,4,CCTTTTAATCGAGAACGGGG,0,5034987
ykgRp,0.2,4,4,CCTGTGCTACTTGCGTTGGC,0,5045839
ykgRp,0.2,4,4,CCTGTATGCTGTCAAACACT,0,5048067
ykgRp,0.2,4,4,CCTGGGTAAAACGCCCGGCT,0,5054310
ykgRp,0.2,4,4,CCTGCCAAGCAGGGGTTCAC,0,5043384
ykgRp,0.2,4,4,CCTAGCGGTTGTGCAGCGCT,0,5033341
ykgRp,0.2,4,4,CCTACTGCCTCGATTGTTGG,0,5052630
ykgRp,0.2,4,4,CCTACGCAGTTTGCGGGTGA,0,5044131
ykgRp,0.2,4,4,CCTACAGAGGGAAAGTGAAG,0,5044339
ykgRp,0.2,4,4,CCGTTCGGCTGGTCCGTGTA,0,5037296
ykgRp,0.2,4,4,CCGTTCAGTCCAAAGCGAAT,0,5036875
ykgRp,0.2,4,4,CCGTCTTCCAGTATGGTTCA,0,5052216
ykgRp,0.2,4,4,CCGTCTGGACCGGAACAATA,0,5053726
ykgRp,0.2,4,4,CCGGTGGGTAAAGGATTCTT,0,5044540
ykgRp,0.2,4,4,CCGGTAAGGGGTAGTTTGGG,0,5055217
ykgRp,0.2,4,4,CCGGGGTGCGCTTACACGAG,0,5047628
ykgRp,0.2,4,4,CCGGGGGCCTGTTGGAAGAG,0,5036721
ykgRp,0.2,4,4,CCGGGCAGGGGCAGTAACAC,0,5057867
ykgRp,0.2,4,4,CCGGGCAGGGCGGTTTACCA,0,5055487
ykgRp,0.2,4,4,CCGGCTACAGGCGACTAAAC,0,5047748
ykgRp,0.2,4,4,CCGGCGATTGCAAGTGCACT,0,5044440
ykgRp,0.2,4,4,CCGGCGAAGTGACGGCATAA,0,5053811
ykgRp,0.2,4,4,CCGGAACTGAACGGCTCCTC,0,5056373
ykgRp,0.2,4,4,CCGCCATGAGGAATGGAAGC,0,5040060
ykgRp,0.2,4,4,CCGATTACGACGTCTCTCTA,0,5049548
ykgRp,0.2,4,4,CCGAGCCCCACGATGTAGTT,0,5049571
ykgRp,0.2,4,4,CCGAACACAACGCTAACGGG,0,5035985
ykgRp,0.2,4,4,CCCTTGCGCCTGGGCTCGCT,0,5031639
ykgRp,0.2,4,4,CCCTTACGTGTTCGACGGCG,0,5053025
ykgRp,0.2,4,4,CCCTCTGGGCGATAATTTAT,0,5050485
ykgRp,0.2,4,4,CCCTCAATATTTAATATCGT,0,5047208
ykgRp,0.2,4,4,CCCTATCCAACTCCAGCCTT,0,5044574
ykgRp,0.2,4,4,CCCTAGATTGGGTGCCACTC,0,5039745
ykgRp,0.2,4,4,CCCTACAACAACATGGATAG,0,5054153
ykgRp,0.2,4,4,CCCGGTTACACATGGTCCAA,0,5050454
ykgRp,0.2,4,4,CCCGGTCTATACGTCATTAT,0,5048386
ykgRp,0.2,4,4,CCCGGATCCGTGCTAAAATG,0,5045541
ykgRp,0.2,4,4,CCCGGACCGAAGGGTGCTCA,0,5039014
ykgRp,0.2,4,4,CCCGCGTTTTTAAGGTCATT,0,5052131
ykgRp,0.2,4,4,CCCCATAGGCGGGTGTTTAG,0,5052961
ykgRp,0.2,4,4,CCCAGGCGGCCTTCTGGAGA,0,5056260
ykgRp,0.2,4,4,CCCACGGTTTTACGTCCGGA,0,5048448
ykgRp,0.2,4,4,CCCACCCCTGCCTGTCCTAC,0,5033760
ykgRp,0.2,4,4,CCCAACACTCGACAAGGGTA,0,5036003
ykgRp,0.2,4,4,CCATGGGGTTGTCAAGGTCA,0,5042279
ykgRp,0.2,4,4,CCATGCTTTGACATGAATAT,0,5048160
ykgRp,0.2,4,4,CCAGGGACTTTCATTCAGTA,0,5053225
ykgRp,0.2,4,4,CCAGAGCCCCAGTCGGCCTA,0,5036459
ykgRp,0.2,4,4,CCAGAAGAACTCTCGTATTA,0,5037120
ykgRp,0.2,4,4,CCACCTACGTACGCTGAGGA,0,5057198
ykgRp,0.2,4,4,CCACAGGGAATTAATAGTAT,0,5031897
ykgRp,0.2,4,4,CCACAGCTAAAATTCGTTAG,0,5048090
ykgRp,0.2,4,4,CCAATTAACGTGTGCTGACT,0,5036536
ykgRp,0.2,4,4,CCAAACGGGGGCTAGTGTGA,0,5058618
ykgRp,0.2,4,4,CATTTTTCCACAAGCCCATT,0,5037856
ykgRp,0.2,4,4,CATTTCTCAGTAATGGGGAT,0,5054646
ykgRp,0.2,4,4,CATTGGCATAATAGTCGGTG,0,5045403
ykgRp,0.2,4,4,CATTCGGCTGGTATTTTTAA,0,5060340
ykgRp,0.2,4,4,CATTATCTCAATCTCTGTGG,0,5042124
ykgRp,0.2,4,4,CATGTTTCACGTCTAGGCCG,0,5044176
ykgRp,0.2,4,4,CATGGATGATCTCTAGACCG,0,5032489
ykgRp,0.2,4,4,CATGCTAAGCGTAGTTGTGG,0,5046406
ykgRp,0.2,4,4,CATCTGCGCGTCCGGGGACC,0,5059734
ykgRp,0.2,4,4,CATCTATAATCCGCTGGTGA,0,5053530
ykgRp,0.2,4,4,CATCGTTAGTTCTGGTACAG,0,5047222
ykgRp,0.2,4,4,CATCCGACCGTGCAACTACT,0,5040796
ykgRp,0.2,4,4,CATCCATATAAACTGCGAGT,0,5033725
ykgRp,0.2,4,4,CATCACCCTTGTAGGCAGTC,0,5054884
ykgRp,0.2,4,4,CATAGTGCAACCTCGATTAA,0,5055243
ykgRp,0.2,4,4,CATAGGGTGCGATTCGCGTC,0,5043855
ykgRp,0.2,4,4,CATACGCAAACCTTATCGTA,0,5042082
ykgRp,0.2,4,4,CATAAGCCAAGTCTTTGAGG,0,5047513
ykgRp,0.2,4,4,CAGTGGGCGATCTCGCTGGG,0,5048820
ykgRp,0.2,4,4,CAGGTCGTACAGAAGGCAAC,0,5050622
ykgRp,0.2,4,4,CAGGATTGATTAGAGGTTAT,0,5036906
ykgRp,0.2,4,4,CAGGACCCAGATTTGACAAC,0,5051970
ykgRp,0.2,4,4,CAGCTTGGGTTGTTGCGGGG,0,5033599
ykgRp,0.2,4,4,CAGCGTTGGCACGTACCGAT,0,5045149
ykgRp,0.2,4,4,CAGCGCGTCAACACTAGGTC,0,5045683
ykgRp,0.2,4,4,CAGCCTGTCTCTGGCCCCTC,0,5045141
ykgRp,0.2,4,4,CAGCAGAGACACGTGTTACC,0,5039555
ykgRp,0.2,4,4,CAGATATAAAGGGCCTCTTA,0,5050884
ykgRp,0.2,4,4,CAGACGAGTCGCGATCAGGC,0,5038209
ykgRp,0.2,4,4,CAGACAAAAGTCTGCACAAT,0,5044099
ykgRp,0.2,4,4,CACTCGGGCCGAAGCGGTAG,0,5060556
ykgRp,0.2,4,4,CACTCAATGACTTAGCTCTC,0,5042593
ykgRp,0.2,4,4,CACGGGAGGCTTATAAAACT,0,5042721
ykgRp,0.2,4,4,CACGACGTAGGGCCAATTTA,0,5040653
ykgRp,0.2,4,4,CACCAAGGCTGTGCTATCAT,0,5050970
ykgRp,0.2,4,4,CACATCATAGAATACAGTAT,0,5049042
ykgRp,0.2,4,4,CACATACACCGTGCGAGACT,0,5053022
ykgRp,0.2,4,4,CACAAAAGAGACCTACCGCG,0,5045140
ykgRp,0.2,4,4,CAATCTCTACTTGAAGCCTG,0,5045407
ykgRp,0.2,4,4,CAATCATCTGCAGCAACCGA,0,5039905
ykgRp,0.2,4,4,CAAGTGCACAGATTAGGAAC,0,5056470
ykgRp,0.2,4,4,CAAGGTGGGGGTGTCTGCGT,0,5053535
ykgRp,0.2,4,4,CAAGGACAGGTTCATATCAT,0,5050226
ykgRp,0.2,4,4,CAAGCTTTCGAGGGGTGGCT,0,5040656
ykgRp,0.2,4,4,CAACTGATGTCCCATATCAA,0,5039001
ykgRp,0.2,4,4,CAACCAGATTTGCGTAGGAC,0,5035419
ykgRp,0.2,4,4,CAACATTTTACATGAGGCAT,0,5043922
ykgRp,0.2,4,4,CAACACGTTGGACCCCGTCA,0,5060953
ykgRp,0.2,4,4,CAAAGGGCGATTCGCAGAAA,0,5044102
ykgRp,0.2,4,4,CAAACTGCTCGTGACGGGCT,0,5031764
ykgRp,0.2,4,4,ATTTTGCTTAGGGCATAACT,0,5051887
ykgRp,0.2,4,4,ATTTTACACTGGTGGAGTCT,0,5047404
ykgRp,0.2,4,4,ATTGTTCTGGGCCTAGAGGT,0,5048527
ykgRp,0.2,4,4,ATTGTTCTCTCATTAGTTGG,0,5040763
ykgRp,0.2,4,4,ATTATTCGCGCTTGATTCCT,0,5054780
ykgRp,0.2,4,4,ATGTTGGTGGAGTTTCCCCA,0,5059704
ykgRp,0.2,4,4,ATGTGAGCGATCATAGATCG,0,5047769
ykgRp,0.2,4,4,ATGTCTGTGGGTTGGTATCC,0,5049339
ykgRp,0.2,4,4,ATGTCACGTCTCAAGCGTGT,0,5060276
ykgRp,0.2,4,4,ATGTATTGAAAGGTCCAGGA,0,5052276
ykgRp,0.2,4,4,ATGGTAGTTGTAGTGTCACC,0,5042151
ykgRp,0.2,4,4,ATGGGTACATAAGGTTCGCT,0,5049830
ykgRp,0.2,4,4,ATGGGCTCACGAATAGGTTG,0,5033294
ykgRp,0.2,4,4,ATGATCGGGGAATCTTGACT,0,5060736
ykgRp,0.2,4,4,ATGAAATACCAGTCTGAGGC,0,5042259
ykgRp,0.2,4,4,ATCTTCATCCATGCGGATTA,0,5037659
ykgRp,0.2,4,4,ATCTGCTACGGCTCAAAATC,0,5034044
ykgRp,0.2,4,4,ATCTGAGGGTGGTCCAGTCT,0,5038133
ykgRp,0.2,4,4,ATCTCGCCTCTTGAAGTTGC,0,5032608
ykgRp,0.2,4,4,ATCTATTATTCTGAAATGCT,0,5057378
ykgRp,0.2,4,4,ATCGCGCCACAGCGTAGATA,0,5037099
ykgRp,0.2,4,4,ATCGCACAGAAGCCCTTCTT,0,5057889
ykgRp,0.2,4,4,ATCGAGTCTGTATCCCGTAA,0,5037951
ykgRp,0.2,4,4,ATCGAGATGTCAGGCGAAGC,0,5046029
ykgRp,0.2,4,4,ATCCTCGTAGGCAATAGAAC,0,5054432
ykgRp,0.2,4,4,ATCCGTTGTATTGACACTTT,0,5059423
ykgRp,0.2,4,4,ATCCCTGTTGGTGAGTGTAA,0,5048289
ykgRp,0.2,4,4,ATCCCCTGCTCCCATTTAGT,0,5054086
ykgRp,0.2,4,4,ATCCACGGTCCCTCACATGG,0,5044125
ykgRp,0.2,4,4,ATCATTAGTTTGATGGTTAA,0,5037360
ykgRp,0.2,4,4,ATCAGTGTTGACGCCGAAGG,0,5032286
ykgRp,0.2,4,4,ATCAGGGCATTGACTCCAAT,0,5037164
ykgRp,0.2,4,4,ATCAGGAACAGGCGATTGAG,0,5044935
ykgRp,0.2,4,4,ATCAGCCTCCAGGGTATCTT,0,5053232
ykgRp,0.2,4,4,ATCACTACAGAATAGGCCTC,0,5040214
ykgRp,0.2,4,4,ATCACGTGTGAATACTTCAC,0,5047842
ykgRp,0.2,4,4,ATATGTTTTATCCCCACCTT,0,5037457
ykgRp,0.2,4,4,ATATAGTCTGGAGTGACAAC,0,5036504
ykgRp,0.2,4,4,ATAGTCACGAACAGGTTTTA,0,5048618
ykgRp,0.2,4,4,ATAGCCACGAGTCTCCGCTT,0,5056495
ykgRp,0.2,4,4,ATAGAACAAGTCGTAAGGCT,0,5053378
ykgRp,0.2,4,4,ATAATGCTAGTTGCTAAATG,0,5043165
ykgRp,0.2,4,4,ATAAATAGGTTGCGTCATAG,0,5035194
ykgRp,0.2,4,4,AGTTGCTCGTTGGTGCTCGT,0,5035103
ykgRp,0.2,4,4,AGTTGATGAGCTTTCCGTGA,0,5033122
ykgRp,0.2,4,4,AGTTCGTGATCATAAGCTTG,0,5054918
ykgRp,0.2,4,4,AGTTCCACCGAAGAACATCG,0,5056135
ykgRp,0.2,4,4,AGTGCGTGGCCACAAATCAG,0,5041139
ykgRp,0.2,4,4,AGTGCCCCCGACCATTTGAG,0,5038404
ykgRp,0.2,4,4,AGTGAGCTCGTGCAATGAGA,0,5032623
ykgRp,0.2,4,4,AGTCTGCGCGCGCCGCGTTG,0,5045014
ykgRp,0.2,4,4,AGTCCTGGTATGCGGGTAGG,0,5042579
ykgRp,0.2,4,4,AGTCATTTCTGGGTGAGCCA,0,5043301
ykgRp,0.2,4,4,AGTCACGTAGCACAAACATG,0,5035483
ykgRp,0.2,4,4,AGTATGACGATGGATAAGAG,0,5060493
ykgRp,0.2,4,4,AGTAGGGGGCCTTATTCTGC,0,5031504
ykgRp,0.2,4,4,AGTACTTGTAGAGACAGCGA,0,5047371
ykgRp,0.2,4,4,AGTACCGTGGAGTGGATCGG,0,5048531
ykgRp,0.2,4,4,AGTAATGAATCCTTTAGTAG,0,5031726
ykgRp,0.2,4,4,AGGTTCAACCAGACTTCCAG,0,5036768
ykgRp,0.2,4,4,AGGTGGCCAGCGGCATCTTC,0,5041354
ykgRp,0.2,4,4,AGGTGCACGGAAATGCCCGG,0,5050914
ykgRp,0.2,4,4,AGGTCCTCTAGGGTTTTACA,0,5035367
ykgRp,0.2,4,4,AGGGTCTATCTACGTCGGAG,0,5047459
ykgRp,0.2,4,4,AGGGGAGCCGCTAAGCAGAA,0,5059673
ykgRp,0.2,4,4,AGGGCGAACGCCTCTAGAGA,0,5037024
ykgRp,0.2,4,4,AGGGCAATAAGCCGGTTTAA,0,5048451
ykgRp,0.2,4,4,AGGGAGGGGTGTTGACCCAC,0,5046937
ykgRp,0.2,4,4,AGGGACATAGATAGACGAAT,0,5055608
ykgRp,0.2,4,4,AGGACGTCTGAAGACAAACT,0,5041881
ykgRp,0.2,4,4,AGGACATCGAGCCTCCAAAT,0,5056356
ykgRp,0.2,4,4,AGCTTCCGTCAACAGGCCTA,0,5033304
ykgRp,0.2,4,4,AGCTATTAGGTGAGCATGCG,0,5036618
ykgRp,0.2,4,4,AGCGTGACAGTGTGTAGGTT,0,5046297
ykgRp,0.2,4,4,AGCGGCGGGTGCGACAAATC,0,5055118
ykgRp,0.2,4,4,AGCGAGCTCCACGCTAAGTA,0,5041108
ykgRp,0.2,4,4,AGCACTAGACGGATCAAAAT,0,5038946
ykgRp,0.2,4,4,AGCACGGAGTTTTAGTTCAC,0,5047262
ykgRp,0.2,4,4,AGCACCAATGGCAGGGGAGC,0,5038781
ykgRp,0.2,4,4,AGATGAGGGCAATGAAACTG,0,5048786
ykgRp,0.2,4,4,AGATATGTCTATTAAGACCT,0,5039731
ykgRp,0.2,4,4,AGAGTATTGCAACACGAGAG,0,5042748
ykgRp,0.2,4,4,AGAGGGCGCGGCCGCATCAT,0,5052012
ykgRp,0.2,4,4,AGAGAGTCGTAAGCAATCCC,0,5048983
ykgRp,0.2,4,4,AGAGACACCAACATAGCTTT,0,5052689
ykgRp,0.2,4,4,AGAGACACATCGCCGCGGCA,0,5043579
ykgRp,0.2,4,4,AGACAGTTTACTAGGACATG,0,5061366
ykgRp,0.2,4,4,AGACACCTTACAGAGAGTTT,0,5060220
ykgRp,0.2,4,4,AGACAAGCCAAATCTTGGGG,0,5038683
ykgRp,0.2,4,4,AGAACGTGCGTTATGCAGAG,0,5034228
ykgRp,0.2,4,4,AGAACGGTTAAAGTATCCTC,0,5045798
ykgRp,0.2,4,4,AGAACCTGGATGCCCAACTC,0,5059067
ykgRp,0.2,4,4,AGAAACATCAGCACTAGGCC,0,5042494
ykgRp,0.2,4,4,ACTTGTTTGAAAGTGCCGCT,0,5041259
ykgRp,0.2,4,4,ACTTCCGATACAAACTGCTG,0,5056701
ykgRp,0.2,4,4,ACTGTTGGTTTTTGCACGAG,0,5040793
ykgRp,0.2,4,4,ACTCGGCAGGACAAACACTG,0,5041410
ykgRp,0.2,4,4,ACGTTTGACCTGGCAACACC,0,5056437
ykgRp,0.2,4,4,ACGTCTGCAAGCTTTTCAGG,0,5049731
ykgRp,0.2,4,4,ACGTCAAATGTGTATTATCT,0,5040144
ykgRp,0.2,4,4,ACGGCTAAACCGGGCCGCGT,0,5052199
ykgRp,0.2,4,4,ACGGAGCATGGTCCGGACCA,0,5047492
ykgRp,0.2,4,4,ACGGAAGTATTCAATGAATA,0,5053308
ykgRp,0.2,4,4,ACGCGTCGCATGGATGATCC,0,5051023
ykgRp,0.2,4,4,ACGCGGCAATCGTGTTTGTT,0,5055348
ykgRp,0.2,4,4,ACGCGCTTCCAGGCCCGTTC,0,5037619
ykgRp,0.2,4,4,ACGCCGTTTGGAGGAGCGTT,0,5049964
ykgRp,0.2,4,4,ACGCACGGCCTGAGAAGCGT,0,5046434
ykgRp,0.2,4,4,ACGATCCAATGCAGAAGCTC,0,5037648
ykgRp,0.2,4,4,ACGACAGTATGCTTATTGCT,0,5055687
ykgRp,0.2,4,4,ACCTTTCAGGGAAGGTCTAG,0,5040947
ykgRp,0.2,4,4,ACCGAGTACCCTGTAATACT,0,5056994
ykgRp,0.2,4,4,ACCCACAGCCGTGGCTCACA,0,5048429
ykgRp,0.2,4,4,ACCAGTCTCTACGGTAATAA,0,5034720
ykgRp,0.2,4,4,ACCAGAGGTGACACGGTTAG,0,5056821
ykgRp,0.2,4,4,ACCAACGTGAAGAACAAAAT,0,5034717
ykgRp,0.2,4,4,ACATTCTAACCCCACTCATG,0,5045922
ykgRp,0.2,4,4,ACATGAGTGCTTCAAGAGCA,0,5061329
ykgRp,0.2,4,4,ACAGGGCTGGCGGTTTAAAT,0,5036274
ykgRp,0.2,4,4,ACAGCTTCTCTGGAGCTCAG,0,5034513
ykgRp,0.2,4,4,ACACAATCAAGGCCGTGCGC,0,5061222
ykgRp,0.2,4,4,ACACAAGTAATAGCACCTAT,0,5054539
ykgRp,0.2,4,4,ACAATGATTCTGTCTAGTGC,0,5043899
ykgRp,0.2,4,4,ACAAGGCCCGACTTTCTGGG,0,5054169
ykgRp,0.2,4,4,ACAACTTGGGTAATATTACC,0,5033155
ykgRp,0.2,4,4,ACAACATATGGGCATCGGGG,0,5040688
ykgRp,0.2,4,4,ACAAATTATATTCACATAAT,0,5038142
ykgRp,0.2,4,4,ACAAACGGGTGGCCACTGGT,0,5057381
ykgRp,0.2,4,4,AATTGGACATTTCCAGCCCT,0,5053413
ykgRp,0.2,4,4,AATTCGAGTGAATTAGTCGG,0,5040499
ykgRp,0.2,4,4,AATTACAGCAGTGTAGCGGG,0,5055395
ykgRp,0.2,4,4,AATGAGGAATGGCATTGCTA,0,5055539
ykgRp,0.2,4,4,AATCTGGTAAGCGCGCGCCT,0,5043350
ykgRp,0.2,4,4,AATCGGTTACTTTTTTCGTA,0,5040614
ykgRp,0.2,4,4,AATAGTTGGACGTGTAACTG,0,5049450
ykgRp,0.2,4,4,AATAGACGGATATTTCGAGT,0,5047050
ykgRp,0.2,4,4,AATACAGCACATTTTATATG,0,5041923
ykgRp,0.2,4,4,AAGTGCAGAAACCGCGGTGA,0,5059537
ykgRp,0.2,4,4,AAGTCTTCGTGTGTGATAAC,0,5037018
ykgRp,0.2,4,4,AAGTAAATGTCCCCAAACGA,0,5054812
ykgRp,0.2,4,4,AAGGGTAACAGCACGTTTAA,0,5056693
ykgRp,0.2,4,4,AAGGCGTTGATATACCTTAG,0,5045447
ykgRp,0.2,4,4,AAGGCGGTCGGCAATGAAAC,0,5054333
ykgRp,0.2,4,4,AAGGACTCGCGCAAAGCTCT,0,5049448
ykgRp,0.2,4,4,AAGCGATTCAGGTTCGCTGC,0,5034444
ykgRp,0.2,4,4,AAGCAAGGCCATGGGCGCGT,0,5033830
ykgRp,0.2,4,4,AAGAGCATGAGCCTCACAGA,0,5047602
ykgRp,0.2,4,4,AAGAGATCGGGGGCCAATCC,0,5031821
ykgRp,0.2,4,4,AAGACCCACCTAGAACCGAT,0,5049206
ykgRp,0.2,4,4,AACTTTACATGAGTCCATTG,0,5053922
ykgRp,0.2,4,4,AACTTCTGTCAGCGCTCAAG,0,5033836
ykgRp,0.2,4,4,AACTCTGGTCTGGCTGGGAA,0,5032105
ykgRp,0.2,4,4,AACTCCGAGTCTTTCCATTC,0,5034955
ykgRp,0.2,4,4,AACTCCACGCTCACATTACC,0,5049444
ykgRp,0.2,4,4,AACGGGACAGGAAGGCTACA,0,5050328
ykgRp,0.2,4,4,AACGGATTCTCCTTGTGTGC,0,5049012
ykgRp,0.2,4,4,AACGGAATGGCAGTAGATGA,0,5056759
ykgRp,0.2,4,4,AACCTGATGGCCTCTTATTA,0,5048731
ykgRp,0.2,4,4,AACCAACAAGTCGTTCCCGA,0,5058834
ykgRp,0.2,4,4,AAATGCTACATTGTACATCG,0,5053723
ykgRp,0.2,4,4,AAAGGCTCGCCTCTCAATCA,0,5038687
ykgRp,0.2,4,4,AAAGAGACCTGCACCCAGGG,0,5043311
ykgRp,0.2,4,4,AAACGTTAACTGCAAGAACA,0,5035133
ykgRp,0.2,4,4,AAACGGGCAGGTCCCAAGTA,0,5036977
ykgRp,0.2,4,4,AAACAGTTGCGATGGCAAAG,0,5036121
ykgRp,0.2,4,4,AAACACAACGGTTACCCGTC,0,5048995
ykgRp,0.2,4,4,AAAAGTCCATTGCACCTCAT,0,5040277
ykgRp,0.25,3,3,TTTTTCAAGGGGATTAAATT,0,5035344
ykgRp,0.25,3,3,TTTTGTCATAGCTCATGATG,0,5052658
ykgRp,0.25,3,3,TTTTGGACTCCTCTTCACTA,0,5060811
ykgRp,0.25,3,3,TTTTCTAAATCGAATGGATA,0,5048017
ykgRp,0.25,3,3,TTTTCGAATCTGTCGATATC,0,5049392
ykgRp,0.25,3,3,TTTTAAGGAAGACGGCTAAG,0,5061100
ykgRp,0.25,3,3,TTTGTCCCACTGGCATTTAA,0,5034862
ykgRp,0.25,3,3,TTTGTAATTCCCATAACCGG,0,5035964
ykgRp,0.25,3,3,TTTGGGTCTGCCAGATGAGG,0,5045422
ykgRp,0.25,3,3,TTTGGCAATTCCGATCATGT,0,5040657
ykgRp,0.25,3,3,TTTGCTGCCGAGGATGTCTT,0,5038360
ykgRp,0.25,3,3,TTTGAACATACGGCGATACC,0,5032783
ykgRp,0.25,3,3,TTTCTACCAGTTGTGTCCTT,0,5057930
ykgRp,0.25,3,3,TTTCGGAAAAAGACCCCCTG,0,5052160
ykgRp,0.25,3,3,TTTCAGAATGTTAGCGCAGT,0,5041709
ykgRp,0.25,3,3,TTTCACTGGTGACCAAGCCG,0,5053357
ykgRp,0.25,3,3,TTTATTGTTCAGACCCTCCG,0,5048942
ykgRp,0.25,3,3,TTTATAGTGCAGCAAAGAAC,0,5050200
ykgRp,0.25,3,3,TTTACATTCGCTGCATAATG,0,5038819
ykgRp,0.25,3,3,TTTAAGCTGCCGGCCAGACT,0,5052056
ykgRp,0.25,3,3,TTGTGGGCGTAGGTACGTAG,0,5053565
ykgRp,0.25,3,3,TTGTGCATTCAAACCCTACG,0,5037439
ykgRp,0.25,3,3,TTGTGCAATGGAGTTCACCG,0,5052015
ykgRp,0.25,3,3,TTGTCCAGCCTACTTGCAAA,0,5037609
ykgRp,0.25,3,3,TTGTCCACCTGGTGTTATCC,0,5049419
ykgRp,0.25,3,3,TTGGTTACTTCTATCCATTC,0,5048546
ykgRp,0.25,3,3,TTGGTGTTGTTTGCGAACGA,0,5034620
ykgRp,0.25,3,3,TTGGTCATCTGGGTCATGAG,0,5032500
ykgRp,0.25,3,3,TTGGTCAGTATAACTTCGTC,0,5046098
ykgRp,0.25,3,3,TTGGTAGACCCTATGTTGTA,0,5053554
ykgRp,0.25,3,3,TTGGTAAAGCTCGTGTTACG,0,5051298
ykgRp,0.25,3,3,TTGGACCGCCTAACCTTTTC,0,5033404
ykgRp,0.25,3,3,TTGCTGAACATACCGTTTAA,0,5045020
ykgRp,0.25,3,3,TTGCCACGCTGGTCGTATCT,0,5035643
ykgRp,0.25,3,3,TTGATTATTACATCACGCTT,0,5059507
ykgRp,0.25,3,3,TTGATCGACCGTAAGGGGGC,0,5042776
ykgRp,0.25,3,3,TTGACTCTTCAAAACGTGAA,0,5032448
ykgRp,0.25,3,3,TTGACGGAGATCTCGGCGGA,0,5045867
ykgRp,0.25,3,3,TTGAAGATCGATATCATCAT,0,5037382
ykgRp,0.25,3,3,TTCTCTATGTCAAAGTGAAT,0,5060753
ykgRp,0.25,3,3,TTCGCCCTCCTACATACGTC,0,5058126
ykgRp,0.25,3,3,TTATGTAGTCCCGCCGTGGA,0,5035240
ykgRp,0.25,3,3,TTATGGTCGGAGGCCTCATT,0,5054749
ykgRp,0.25,3,3,TTATCCCCCGGCCAATCCCC,0,5050449
ykgRp,0.25,3,3,TTAGTTAAGCCTTTCGAAAC,0,5052207
ykgRp,0.25,3,3,TTAGTCGGTAGGGCGTGTGC,0,5059008
ykgRp,0.25,3,3,TTAGGTACTCGGCTTGGGCT,0,5041404
ykgRp,0.25,3,3,TTAGGTAAGCAGGTACAATA,0,5056257
ykgRp,0.25,3,3,TTAGGATGAACCATTACTGT,0,5033064
ykgRp,0.25,3,3,TTAGCTGTACTATCTAAAAT,0,5041508
ykgRp,0.25,3,3,TTAGCATTCTGCGAGTGGGA,0,5043082
ykgRp,0.25,3,3,TTACGGTAGTGGATCAGAAT,0,5050149
ykgRp,0.25,3,3,TTACCGCGCCAATTTAAGCC,0,5054102
ykgRp,0.25,3,3,TTACAACATACGAGCGTTTA,0,5046347
ykgRp,0.25,3,3,TTAATAACGCGCTCTGGTAA,0,5054694
ykgRp,0.25,3,3,TTAAGTTTGCGCAACCTTTT,0,5058912
ykgRp,0.25,3,3,TTAAGGATAAATCTTGGCAC,0,5042948
ykgRp,0.25,3,3,TGTTGTTCAGTAGGCGGCAT,0,5043152
ykgRp,0.25,3,3,TGTTGTGGGATTGCAGGGAT,0,5045480
ykgRp,0.25,3,3,TGTTGACTTGACTTATGCGT,0,5050885
ykgRp,0.25,3,3,TGTGTGACCGGGGGCATCCA,0,5037861
ykgRp,0.25,3,3,TGTGTACGTTGTCCGCGGCC,0,5048121
ykgRp,0.25,3,3,TGTGGTTATAGCTTAATGGG,0,5058142
ykgRp,0.25,3,3,TGTGGTACGCAAAAGGCTCT,0,5039172
ykgRp,0.25,3,3,TGTGGGCCACACCCAGGAAT,0,5060662
ykgRp,0.25,3,3,TGTGGCGCTCCCGTATTCTC,0,5031942
ykgRp,0.25,3,3,TGTGCTTTAGGGAAACTGGT,0,5057291
ykgRp,0.25,3,3,TGTGCTATTCGTCAGAGGGT,0,5061721
ykgRp,0.25,3,3,TGTGATATTCTACGTCCGAT,0,5058315
ykgRp,0.25,3,3,TGTCCAATTATTGCGCACCG,0,5061402
ykgRp,0.25,3,3,TGTCAGGGTCCCTTTGGGTG,0,5039404
ykgRp,0.25,3,3,TGTCAAGGCTTGACATATGA,0,5057172
ykgRp,0.25,3,3,TGTATGCGTCACTTCAACTT,0,5060108
ykgRp,0.25,3,3,TGTATCGTACTATGAAGGGT,0,5048246
ykgRp,0.25,3,3,TGTAAGCGGCTCTAGGACTG,0,5045135
ykgRp,0.25,3,3,TGGTCCCGAACTCCTCCGCG,0,5043816
ykgRp,0.25,3,3,TGGGTCTATGTGCTGCACTG,0,5042629
ykgRp,0.25,3,3,TGGGGCAGCATTCTCAACAC,0,5033663
ykgRp,0.25,3,3,TGGGGAAACCGTCAACCGCG,0,5057702
ykgRp,0.25,3,3,TGGGCCTACCAGGTCCAACC,0,5032370
ykgRp,0.25,3,3,TGGGATGGGAACTTGCGCGA,0,5059250
ykgRp,0.25,3,3,TGGGAATATTATCGAGACGG,0,5039990
ykgRp,0.25,3,3,TGGCTCATCCTCGGTAAGAG,0,5032371
ykgRp,0.25,3,3,TGGCTATCGAGGACTAAGAT,0,5033698
ykgRp,0.25,3,3,TGGCACTCCCGAGCGTAATG,0,5060900
ykgRp,0.25,3,3,TGGAGGTTGTTCGGGACAAA,0,5038110
ykgRp,0.25,3,3,TGGACTCCGGCCGGTCACCT,0,5053097
ykgRp,0.25,3,3,TGGACCAAAATACATGTCCG,0,5052780
ykgRp,0.25,3,3,TGGAAATGCTTCCCTCAGGT,0,5037596
ykgRp,0.25,3,3,TGCTTAAGATCTCGGGTGGT,0,5050760
ykgRp,0.25,3,3,TGCTAATAGGACGAAATCAG,0,5046235
ykgRp,0.25,3,3,TGCGGCTATACAAGTCGCTA,0,5053901
ykgRp,0.25,3,3,TGCGCGGCTATCTCCGATAA,0,5051471
ykgRp,0.25,3,3,TGCCGCTGAGAGCTTCAACC,0,5059136
ykgRp,0.25,3,3,TGCCGATATAGGATTAATAG,0,5043517
ykgRp,0.25,3,3,TGCCCCAACGTTACACTATA,0,5053820
ykgRp,0.25,3,3,TGCCATGAACACATTTCGGC,0,5032970
ykgRp,0.25,3,3,TGCAGCCCTCTGGGTGGGAA,0,5037516
ykgRp,0.25,3,3,TGCAATGCCAATCCCAGGTG,0,5032581
ykgRp,0.25,3,3,TGATCTTAATTCACCGTCCG,0,5044253
ykgRp,0.25,3,3,TGAGGCTCGAGATTTGCTCG,0,5038967
ykgRp,0.25,3,3,TGAGCATGACTCGCTCGTTA,0,5043341
ykgRp,0.25,3,3,TGACTGGAATGCACAAAGAA,0,5039681
ykgRp,0.25,3,3,TGACCCTCTCTTCACGGCTT,0,5047673
ykgRp,0.25,3,3,TGACCCAGCGCCGGCCAGTT,0,5038653
ykgRp,0.25,3,3,TGACAATGAGGGGCTGATTG,0,5044779
ykgRp,0.25,3,3,TGAAGTCGAAAACTTTGTAC,0,5041473
ykgRp,0.25,3,3,TCTTGTATTTTTGCATGCCG,0,5043884
ykgRp,0.25,3,3,TCTTGTATACTTCTACTAAT,0,5036226
ykgRp,0.25,3,3,TCTTAGTCCTTAAGTGCAGT,0,5034339
ykgRp,0.25,3,3,TCTGCCCCGGCTGTGTCTGC,0,5048923
ykgRp,0.25,3,3,TCTCTAGCGCTGGACTACGT,0,5053155
ykgRp,0.25,3,3,TCTCCGAGGGAGGTACCATG,0,5044516
ykgRp,0.25,3,3,TCTCAGGAATTCAACTCTGA,0,5053061
ykgRp,0.25,3,3,TCTATATAGGTCATCTGTAC,0,5050861
ykgRp,0.25,3,3,TCTAGACCTTAACTATGGTC,0,5037989
ykgRp,0.25,3,3,TCTAGACAGCCATCAGCGTG,0,5032653
ykgRp,0.25,3,3,TCTAAAAGTACGTTGCCATG,0,5052200
ykgRp,0.25,3,3,TCGTTTCCATGTGAATAATT,0,5047264
ykgRp,0.25,3,3,TCGTACGACCCTTTTGTCAG,0,5038565
ykgRp,0.25,3,3,TCGGTGCATGTCCGGAAGAC,0,5038502
ykgRp,0.25,3,3,TCGGGGCAGATAGGCCCCGA,0,5053937
ykgRp,0.25,3,3,TCGGGCAGTAACTATTCTAT,0,5054287
ykgRp,0.25,3,3,TCGGGAAAGAGAGGACTTTT,0,5040115
ykgRp,0.25,3,3,TCGGCGCATGTCCCGTCATA,0,5035115
ykgRp,0.25,3,3,TCGGACTATTGGAAGGCATG,0,5056298
ykgRp,0.25,3,3,TCGGACGGACTGCTCGTTGT,0,5049792
ykgRp,0.25,3,3,TCGCGTCACTGGGCGGGGTC,0,5057263
ykgRp,0.25,3,3,TCGCATAAAGACAGGACCGG,0,5037832
ykgRp,0.25,3,3,TCGCAGGCGAATGCCCGGTT,0,5055964
ykgRp,0.25,3,3,TCGATAGCTTGATGGGAAGC,0,5047560
ykgRp,0.25,3,3,TCGAGTAACTTTGTATAGCT,0,5038889
ykgRp,0.25,3,3,TCGACAGTACTTTCGGTGGT,0,5057783
ykgRp,0.25,3,3,TCGAAGTCGGAGTCAGGGTA,0,5041927
ykgRp,0.25,3,3,TCCTTTGATGCCATGTAGTA,0,5045949
ykgRp,0.25,3,3,TCCTCTATCAGGGCTATCGC,0,5037664
ykgRp,0.25,3,3,TCCTCAGCAAATGATTGTAA,0,5053431
ykgRp,0.25,3,3,TCCGTTTAACCTCTAGGAAC,0,5047470
ykgRp,0.25,3,3,TCCGTCTGGACCATGGCAAG,0,5033395
ykgRp,0.25,3,3,TCCGGCCTGAAATGACCTCA,0,5039143
ykgRp,0.25,3,3,TCCGATGGGGGCTCCGTAAG,0,5053272
ykgRp,0.25,3,3,TCCGAGGGCGGGTATCTGGG,0,5053613
ykgRp,0.25,3,3,TCCGAGAAAGATGCATGGGA,0,5057039
ykgRp,0.25,3,3,TCCGACTTGTTTTGATACGG,0,5059361
ykgRp,0.25,3,3,TCCCAGATAGGTAGACTCGC,0,5039921
ykgRp,0.25,3,3,TCCACATGGGTTATTCGCGC,0,5039753
ykgRp,0.25,3,3,TCATTATGCTGCGATCATTA,0,5039190
ykgRp,0.25,3,3,TCATAGCAACTCGGTGCCTC,0,5036562
ykgRp,0.25,3,3,TCATAGAGCCCTACGTACTA,0,5034602
ykgRp,0.25,3,3,TCACTTTGTTGTCTAGACCT,0,5031906
ykgRp,0.25,3,3,TCACGAGCGTATGTATTCCA,0,5056573
ykgRp,0.25,3,3,TCACAAGGGAGAGATCCTTT,0,5034157
ykgRp,0.25,3,3,TCACAAACTTATCTATAGGT,0,5057766
ykgRp,0.25,3,3,TCAAGACCAGGATATTTATG,0,5039767
ykgRp,0.25,3,3,TATTTATAGCGCTGGGCGAA,0,5059390
ykgRp,0.25,3,3,TATTCTGGGTTATTCCGGAC,0,5038322
ykgRp,0.25,3,3,TATTCATCTAGCTCACCAAG,0,5038407
ykgRp,0.25,3,3,TATTATGGTACCGGTATACA,0,5037723
ykgRp,0.25,3,3,TATGCCAGCACAATTCTCAT,0,5037524
ykgRp,0.25,3,3,TATCGGGGAGACCGGATAAT,0,5048484
ykgRp,0.25,3,3,TATCGGGCAGCATATACCTG,0,5053030
ykgRp,0.25,3,3,TATCCTGAACGGATTTAGGA,0,5033924
ykgRp,0.25,3,3,TATCAGTCATGGCTTCAGGC,0,5038019
ykgRp,0.25,3,3,TATCAGCATCTGTCAACTAC,0,5038397
ykgRp,0.25,3,3,TATCACCTCAGTGTCCAAGA,0,5040369
ykgRp,0.25,3,3,TATCAAGTACGGGTGGTAGT,0,5033766
ykgRp,0.25,3,3,TATATCATAACCCGTAATCT,0,5060483
ykgRp,0.25,3,3,TATAGACTTCGATAGCAAGT,0,5052410
ykgRp,0.25,3,3,TATAATAGCCTCGACCCCAT,0,5035580
ykgRp,0.25,3,3,TATAAGCGCAGTGTGTAATG,0,5034907
ykgRp,0.25,3,3,TAGGGTGCTTCGCTATGTGA,0,5052629
ykgRp,0.25,3,3,TAGGCGCCTATAGTAGTCGG,0,5046950
ykgRp,0.25,3,3,TAGGAAACGCGCGCAGTCCC,0,5041246
ykgRp,0.25,3,3,TAGCTTCGGGTCGTTCAGGC,0,5046784
ykgRp,0.25,3,3,TAGCTGAAACAGGGTCTAAC,0,5050709
ykgRp,0.25,3,3,TAGCGTATCATTTTTCAGAT,0,5043940
ykgRp,0.25,3,3,TAGCGCCAAAGTCTCGCATT,0,5031524
ykgRp,0.25,3,3,TAGCGATGCCTACATTGGAC,0,5059540
ykgRp,0.25,3,3,TAGCAGCTCGGATACGCAAC,0,5034226
ykgRp,0.25,3,3,TAGCAGACATCTAGTCATGA,0,5036644
ykgRp,0.25,3,3,TAGCACTTGAAAGCGCTAAG,0,5033660
ykgRp,0.25,3,3,TAGATGCGCAAAATTGTTCA,0,5047889
ykgRp,0.25,3,3,TAGATGATTGGCAGAGTCAC,0,5034638
ykgRp,0.25,3,3,TAGATAATGCATCCGCCCTG,0,5039298
ykgRp,0.25,3,3,TACTATTTGAAGTGCCTCTG,0,5059074
ykgRp,0.25,3,3,TACGGGAAATATTCCGCGCT,0,5041362
ykgRp,0.25,3,3,TACCGAGCACAGAAAGAGGT,0,5045272
ykgRp,0.25,3,3,TACCATCAAGTTAAGGCTCC,0,5052998
ykgRp,0.25,3,3,TACCAGTTTACGGATTTGGC,0,5033429
ykgRp,0.25,3,3,TACATTCGTGCGACCGGGAT,0,5050249
ykgRp,0.25,3,3,TACATCCTATATTCACAATC,0,5059606
ykgRp,0.25,3,3,TACAGTCCGGGTATTCGGAG,0,5054627
ykgRp,0.25,3,3,TACAGGATTGGATAAGAACT,0,5036192
ykgRp,0.25,3,3,TAATGTTTACCAGCGAATGA,0,5051667
ykgRp,0.25,3,3,TAATGGCGAGTGGGGGGTAC,0,5038686
ykgRp,0.25,3,3,TAATGACGGATGAATCGCGT,0,5060504
ykgRp,0.25,3,3,TAATATATGGTTGTCTGTCA,0,5053027
ykgRp,0.25,3,3,TAAGTTGCACGCGAGCGAGT,0,5036858
ykgRp,0.25,3,3,TAAGGTTAAGCCGCCTCGCA,0,5044563
ykgRp,0.25,3,3,TAAGGCCTGGGCTTTTCTGC,0,5059374
ykgRp,0.25,3,3,TAAGAGTCCCTTTGGCTTCA,0,5047665
ykgRp,0.25,3,3,TAAGAGTATGCCCCTCCCTA,0,5045324
ykgRp,0.25,3,3,TAAGAGTATAGGACGTGGAG,0,5043659
ykgRp,0.25,3,3,TAACTATGATTGATTAGCAA,0,5036776
ykgRp,0.25,3,3,TAACCCTGGGTAATGGTGAC,0,5052331
ykgRp,0.25,3,3,TAACCAAAGAGTACAAATAT,0,5039336
ykgRp,0.25,3,3,TAACAACGTCACTTCTAGCC,0,5043623
ykgRp,0.25,3,3,TAAAGGGTATAGCATATCAT,0,5047042
ykgRp,0.25,3,3,TAAAGGCGTCTAGTTGACTA,0,5043161
ykgRp,0.25,3,3,GTTGTAAGCCTTGCGTATCC,0,5033034
ykgRp,0.25,3,3,GTTGGGGCAAGCAGGTATAA,0,5049423
ykgRp,0.25,3,3,GTTCGATTACCCGAATTAGG,0,5058654
ykgRp,0.25,3,3,GTTCCTGAATCAGCTATTTA,0,5048388
ykgRp,0.25,3,3,GTTCCCCGAGCACTGCAACT,0,5048112
ykgRp,0.25,3,3,GTTCCACTTTGAGACTTTGT,0,5054359
ykgRp,0.25,3,3,GTTATGAGATTTTGTAAGGT,0,5056845
ykgRp,0.25,3,3,GTTACACACGCGCGAACATC,0,5058004
ykgRp,0.25,3,3,GTGTTCCGCGGGGGCAATCG,0,5059068
ykgRp,0.25,3,3,GTGTTAGGGCGGTAGAATAT,0,5051898
ykgRp,0.25,3,3,GTGTCATGGGAAGGGATTTG,0,5033709
ykgRp,0.25,3,3,GTGGTAGCGGTATCAAGCGC,0,5044642
ykgRp,0.25,3,3,GTGGGCGCATTTGGGAAGCA,0,5049572
ykgRp,0.25,3,3,GTGGGCCAGGAAGCAATGGA,0,5050708
ykgRp,0.25,3,3,GTGGCCACGCATAGCTCACA,0,5040216
ykgRp,0.25,3,3,GTGGCAGTCTAGTAGAAGGT,0,5045597
ykgRp,0.25,3,3,GTGGACCTTGACTGCGTTGA,0,5058646
ykgRp,0.25,3,3,GTGGAAGTTGCGTTCCGGCC,0,5055312
ykgRp,0.25,3,3,GTGCGGCAGCTCGGCAAGGA,0,5058326
ykgRp,0.25,3,3,GTGCAATTGTCGCATCAGGT,0,5056497
ykgRp,0.25,3,3,GTGATTAGTAGTGGGGGGGA,0,5056322
ykgRp,0.25,3,3,GTGAGTCGGTGGTGTTGCGA,0,5048251
ykgRp,0.25,3,3,GTGAGCACGGGAGACCATTA,0,5058357
ykgRp,0.25,3,3,GTGACAGCGCAAGGGGGAGA,0,5039910
ykgRp,0.25,3,3,GTGAAGTGACGTGGTGGAAT,0,5052258
ykgRp,0.25,3,3,GTGAAACCCCTTAACTGGTA,0,5049489
ykgRp,0.25,3,3,GTCTTAGTAGCGGCCAGCGA,0,5032303
ykgRp,0.25,3,3,GTCTGGTGCAGGCGAATCTG,0,5033392
ykgRp,0.25,3,3,GTCTCGTAAGTGGGAGAGTC,0,5039481
ykgRp,0.25,3,3,GTCTCATTCTCCTCATATGA,0,5033167
ykgRp,0.25,3,3,GTCTAGCACAAACCCCGGGA,0,5050996
ykgRp,0.25,3,3,GTCGTTTATTGTACGCGCGG,0,5046688
ykgRp,0.25,3,3,GTCGGGTTATGTCGCTAACA,0,5053604
ykgRp,0.25,3,3,GTCGGACCAGCAGATCACCG,0,5051393
ykgRp,0.25,3,3,GTCCTCAAGCGTATTCAGGA,0,5038262
ykgRp,0.25,3,3,GTCCCCGTTCGGCGGGTAAT,0,5055120
ykgRp,0.25,3,3,GTCCCAAGTCGCGGTTATTG,0,5058536
ykgRp,0.25,3,3,GTCCATGATGTGCCATGACT,0,5044109
ykgRp,0.25,3,3,GTCCATCTCATGGACGTTTC,0,5046167
ykgRp,0.25,3,3,GTCCACGGCACACGACCGGT,0,5052173
ykgRp,0.25,3,3,GTCCACGACTCCTTGATGGA,0,5052419
ykgRp,0.25,3,3,GTCATTTTCATCTTTTAGCG,0,5044718
ykgRp,0.25,3,3,GTCAGATTATTCGTGCGTCC,0,5055481
ykgRp,0.25,3,3,GTATTTGGGTGTGCACACGT,0,5058811
ykgRp,0.25,3,3,GTATGTGAGGGAAAGGGTAT,0,5035426
ykgRp,0.25,3,3,GTATGGCTCTTAGTACGTAT,0,5061019
ykgRp,0.25,3,3,GTATATGTCGAGACCTGTGT,0,5051795
ykgRp,0.25,3,3,GTAGTCGCCATTAAAGGCTG,0,5053483
ykgRp,0.25,3,3,GTAGAGAGGAGTACCTGAAA,0,5042099
ykgRp,0.25,3,3,GTAGAACTGCATGCTGTACA,0,5040926
ykgRp,0.25,3,3,GTACGGGGGCTGCCGTCAGG,0,5052060
ykgRp,0.25,3,3,GTACGCCCTAAGACCAAGCC,0,5037427
ykgRp,0.25,3,3,GTACGATGATGATTCAAGGT,0,5060463
ykgRp,0.25,3,3,GTACGAGCCATAACGTAGGG,0,5034426
ykgRp,0.25,3,3,GTACATTACGCGAATATCGG,0,5032046
ykgRp,0.25,3,3,GTACAGGTGCCTTGGCCTAA,0,5040953
ykgRp,0.25,3,3,GTAAGGTGATGCCATGTGCG,0,5036101
ykgRp,0.25,3,3,GTAACTGATCTGCTATAACA,0,5049835
ykgRp,0.25,3,3,GGTTGTTTGAGGCTCAGTTT,0,5060426
ykgRp,0.25,3,3,GGTTCCAAATTCCGGCTTGC,0,5032192
ykgRp,0.25,3,3,GGTTACGTCGTTCCCGGTGG,0,5053597
ykgRp,0.25,3,3,GGTGTGCCCAGCACCGATCC,0,5057341
ykgRp,0.25,3,3,GGTGGTCCCGGTCGGGGGTT,0,5034927
ykgRp,0.25,3,3,GGTGGAGTCTACTGGGGGTA,0,5039141
ykgRp,0.25,3,3,GGTGAGAACATGCCAACTTC,0,5035472
ykgRp,0.25,3,3,GGTCTGGAGGTAATGTCTCC,0,5051549
ykgRp,0.25,3,3,GGTCTGAGACCAGGTCAGCT,0,5036002
ykgRp,0.25,3,3,GGTCCGGCTTACGTGACGAC,0,5060593
ykgRp,0.25,3,3,GGTCCCTATTATGCGAGGCG,0,5058725
ykgRp,0.25,3,3,GGTCCAGGCTGTAGCACGCG,0,5038070
ykgRp,0.25,3,3,GGTCAGATGAAACGCGGCTT,0,5057854
ykgRp,0.25,3,3,GGTCACCGGCAGGATCCCCT,0,5036074
ykgRp,0.25,3,3,GGTATTCTATCGCATTAGAT,0,5048910
ykgRp,0.25,3,3,GGTATCCGCGGGTCTAAGAG,0,5041207
ykgRp,0.25,3,3,GGTATACAAGCGTGCGAACT,0,5039074
ykgRp,0.25,3,3,GGTAGTGTAAACTTCCCTTG,0,5055817
ykgRp,0.25,3,3,GGTAGATGTGTGTCAAGGCC,0,5052003
ykgRp,0.25,3,3,GGTACTGATGCCCCCACGGT,0,5034350
ykgRp,0.25,3,3,GGTACTGAGAACCAAATGGG,0,5047605
ykgRp,0.25,3,3,GGTAACTGCTGTACTAATTG,0,5039794
ykgRp,0.25,3,3,GGGTTTGAATCGTGCCACGG,0,5059494
ykgRp,0.25,3,3,GGGTTCGTGCGGGCTTGTAC,0,5048171
ykgRp,0.25,3,3,GGGTGACACCGAATGCATAA,0,5051756
ykgRp,0.25,3,3,GGGTGAAACTGATTAATGCC,0,5056773
ykgRp,0.25,3,3,GGGTCCATAGTATGAGAATA,0,5050121
ykgRp,0.25,3,3,GGGTCAAAACGCACACGGAA,0,5048223
ykgRp,0.25,3,3,GGGTACACTGTTTTGTACTT,0,5036503
ykgRp,0.25,3,3,GGGTAAGTAATATAGACAAT,0,5050193
ykgRp,0.25,3,3,GGGGTGGCAGGCTGCGCCGG,0,5055849
ykgRp,0.25,3,3,GGGGCTTACGAGCGGGCTCA,0,5051997
ykgRp,0.25,3,3,GGGGCTCTCCGATAAGTAAA,0,5041999
ykgRp,0.25,3,3,GGGGCCAACGCTACGCACGT,0,5057314
ykgRp,0.25,3,3,GGGCTATTATACGTTCGAGC,0,5056427
ykgRp,0.25,3,3,GGGCTATAGTATATTAAAGC,0,5045967
ykgRp,0.25,3,3,GGGCATTAGCGCTTCGAGAG,0,5055718
ykgRp,0.25,3,3,GGGCACTGAGATTCCGCTAA,0,5041533
ykgRp,0.25,3,3,GGGAGTGGGAAGTTCATCTA,0,5040582
ykgRp,0.25,3,3,GGGAGTCCCTGACCGACCTT,0,5048188
ykgRp,0.25,3,3,GGGAGAAGATAGTACGACCG,0,5046820
ykgRp,0.25,3,3,GGGAACGGGATTTGCCATCA,0,5039322
ykgRp,0.25,3,3,GGCTTCACGTAGAGTACCCC,0,5057146
ykgRp,0.25,3,3,GGCTGGTGTAGTGCTCCGAG,0,5037635
ykgRp,0.25,3,3,GGCTCCGTGCACTCGGTCGG,0,5047269
ykgRp,0.25,3,3,GGCTATAGTGAATAGATGGT,0,5052580
ykgRp,0.25,3,3,GGCGCAGGGTGACCATCGAG,0,5049114
ykgRp,0.25,3,3,GGCGACCTCAAAATTCGTGT,0,5032722
ykgRp,0.25,3,3,GGCCTGCAGAACGAGCACGT,0,5041773
ykgRp,0.25,3,3,GGCCACGTAAGTATCACAGT,0,5047663
ykgRp,0.25,3,3,GGCCAATAGCCCCGGACAGT,0,5039439
ykgRp,0.25,3,3,GGCAGGCCAATACGTACACT,0,5047899
ykgRp,0.25,3,3,GGCAGCTCAAAGTTCCACTG,0,5034327
ykgRp,0.25,3,3,GGCACTCCGAACGCGATTTG,0,5051715
ykgRp,0.25,3,3,GGCACTAACGCGCTACTCAG,0,5057351
ykgRp,0.25,3,3,GGAGTGGCTATCTGACTGGT,0,5033325
ykgRp,0.25,3,3,GGAGATTTCTAGCTCAGTCT,0,5050966
ykgRp,0.25,3,3,GGAGATGTATAAGTCGTCAA,0,5058818
ykgRp,0.25,3,3,GGAGAGTCCTGAAGTTCTGA,0,5059413
ykgRp,0.25,3,3,GGACTTGAGAAGTCCCCTCT,0,5059132
ykgRp,0.25,3,3,GGACTGCCAGACCGAAATTG,0,5040093
ykgRp,0.25,3,3,GGACGGGGCAGCAAATAAGT,0,5040911
ykgRp,0.25,3,3,GGACGGATTAAGTGTTGTCG,0,5041069
ykgRp,0.25,3,3,GGACCGTTAAAACCTATGCC,0,5047500
ykgRp,0.25,3,3,GGACAGAACTATTCCGATCT,0,5053116
ykgRp,0.25,3,3,GGAATGCTCCAGCGGCCATT,0,5042683
ykgRp,0.25,3,3,GCTTGGGAATTACATCTTGT,0,5050118
ykgRp,0.25,3,3,GCTTGGACACACGGGAGGTT,0,5058620
ykgRp,0.25,3,3,GCTTGAAGTATCGCACTAGG,0,5059181
ykgRp,0.25,3,3,GCTTATGAACAATTAACGCC,0,5047487
ykgRp,0.25,3,3,GCTTACACGCTTAGACAACT,0,5054138
ykgRp,0.25,3,3,GCTGTGAATGTCAACGCCTA,0,5050105
ykgRp,0.25,3,3,GCTGGGCTCAACGGTAACGT,0,5037138
ykgRp,0.25,3,3,GCTGGCTCCAAGCCTCGTGC,0,5046665
ykgRp,0.25,3,3,GCTGCAGTATCCCGGAGTAT,0,5038535
ykgRp,0.25,3,3,GCTGATTTCTAGTATGCCCC,0,5041221
ykgRp,0.25,3,3,GCTGACCTATAACTGACATA,0,5049057
ykgRp,0.25,3,3,GCTCTGTATAAAAGGTCGTG,0,5061442
ykgRp,0.25,3,3,GCTCTCAACGCTCCTCCAAA,0,5045556
ykgRp,0.25,3,3,GCTCGGAGCGTCTATTCAAA,0,5036669
ykgRp,0.25,3,3,GCTCAGTCGTAAGCCAAGCA,0,5058683
ykgRp,0.25,3,3,GCTATCGTTGACGCACAAAG,0,5056576
ykgRp,0.25,3,3,GCTATAGGCCTCTACACATA,0,5060192
ykgRp,0.25,3,3,GCTAGCATCGTTGATCATTT,0,5057815
ykgRp,0.25,3,3,GCTAGATTGCCGGGTTACAA,0,5051828
ykgRp,0.25,3,3,GCTAGACGACTCCACCCGGG,0,5059193
ykgRp,0.25,3,3,GCTAGACATACGTAGAATAC,0,5060682
ykgRp,0.25,3,3,GCTACTCGTCCTATACGGTA,0,5053187
ykgRp,0.25,3,3,GCTAACATACGGGATGGAGT,0,5048721
ykgRp,0.25,3,3,GCTAACAGCATACACGGGGG,0,5056878
ykgRp,0.25,3,3,GCGTTACGGGTGTGTATGGT,0,5035025
ykgRp,0.25,3,3,GCGTGCGGGGTTCGATTACC,0,5044353
ykgRp,0.25,3,3,GCGTCTAAGGTGGCCCGATG,0,5047900
ykgRp,0.25,3,3,GCGTATAAACTCTAGGGGCT,0,5055554
ykgRp,0.25,3,3,GCGTAGGGGCCTGCGATCCG,0,5060821
ykgRp,0.25,3,3,GCGTACGGGCCATATGGGTT,0,5059454
ykgRp,0.25,3,3,GCGTAATCGCGTATCTGGAA,0,5035932
ykgRp,0.25,3,3,GCGGATCTTGTAGTCTCCGA,0,5061722
ykgRp,0.25,3,3,GCGGACTCCCCGGGGCGGTA,0,5036885
ykgRp,0.25,3,3,GCGGAATCTGGTGTATCGTT,0,5043445
ykgRp,0.25,3,3,GCGCTGCTTGTGCGCGCCAC,0,5051199
ykgRp,0.25,3,3,GCGCCACAATCGCAACTGGG,0,5046146
ykgRp,0.25,3,3,GCGCAGCAGCAGGTCACGTC,0,5043943
ykgRp,0.25,3,3,GCGCACTGTAAGTGCGGGGA,0,5034036
ykgRp,0.25,3,3,GCGCACCCTGTCAACGCAGG,0,5061391
ykgRp,0.25,3,3,GCGCAAACCATGGTCAGTAC,0,5038252
ykgRp,0.25,3,3,GCGACTTTTTGTATGCAGTA,0,5038372
ykgRp,0.25,3,3,GCGACCCGCTCTTGAGACAA,0,5045513
ykgRp,0.25,3,3,GCGAATTCTTCTTGCCAGTG,0,5061412
ykgRp,0.25,3,3,GCGAATTCCCACAGCTGGTA,0,5054981
ykgRp,0.25,3,3,GCGAAGTACAAGTCAATTGG,0,5040078
ykgRp,0.25,3,3,GCGAACAAGGCTGCTTCGGG,0,5042272
ykgRp,0.25,3,3,GCCTTGGACCCTTAACAATA,0,5042004
ykgRp,0.25,3,3,GCCTTCTCCGCAACCGAGGT,0,5042154
ykgRp,0.25,3,3,GCCTTCCTGCCCGTTTATTG,0,5057296
ykgRp,0.25,3,3,GCCTTCATCTAGCTGCCACT,0,5058093
ykgRp,0.25,3,3,GCCTGCTCGTTATACGAAAT,0,5049678
ykgRp,0.25,3,3,GCCTCTTTTGCAGTGTCCAT,0,5053309
ykgRp,0.25,3,3,GCCGTACCAAGCGTAGGCTT,0,5061287
ykgRp,0.25,3,3,GCCGACGGACCATGTTTGGG,0,5056527
ykgRp,0.25,3,3,GCCCTTCTGGTCGGGGAATA,0,5035625
ykgRp,0.25,3,3,GCCCGACCGAAAACGGTATG,0,5041740
ykgRp,0.25,3,3,GCCATGCGGGTTAATGAATC,0,5054846
ykgRp,0.25,3,3,GCCAATGATAGAGTCGTTTC,0,5050261
ykgRp,0.25,3,3,GCCAACGAACCGCCACGATA,0,5060640
ykgRp,0.25,3,3,GCATCCACAGTAGACGCGCA,0,5056116
ykgRp,0.25,3,3,GCATATGAATTTATTTTGCG,0,5041621
ykgRp,0.25,3,3,GCATATCTACAATAGATGTT,0,5058593
ykgRp,0.25,3,3,GCAGTCTCTAACGGGCGTAG,0,5036865
ykgRp,0.25,3,3,GCAGGCGTAGCCCAGGTTGG,0,5044805
ykgRp,0.25,3,3,GCAGGCCTCGATGAAGCGAC,0,5035955
ykgRp,0.25,3,3,GCACGAGGGCACATTGACAA,0,5061183
ykgRp,0.25,3,3,GCACAGCAGCACCGGTCCGA,0,5057881
ykgRp,0.25,3,3,GCAATGATTGGAAGCATATG,0,5041345
ykgRp,0.25,3,3,GCAATCACGAATTATTCGGA,0,5032059
ykgRp,0.25,3,3,GCAAGGGGGAGGGGACCCGC,0,5035548
ykgRp,0.25,3,3,GCAAGCGATATTTCTGTGCA,0,5045848
ykgRp,0.25,3,3,GCAACTCGGCCGAGCCATAT,0,5038393
ykgRp,0.25,3,3,GCAACGCTGTCACGCGAGAT,0,5040815
ykgRp,0.25,3,3,GATTTCTGCCCTCAGTTGGA,0,5037694
ykgRp,0.25,3,3,GATTGTGGCAGGCACGTAGT,0,5046084
ykgRp,0.25,3,3,GATTGACGGTGCAGCCATGA,0,5049337
ykgRp,0.25,3,3,GATTGACGGCGGATGGCGGC,0,5032811
ykgRp,0.25,3,3,GATTAATCGAAAACTTTAAA,0,5051384
ykgRp,0.25,3,3,GATTAAGGAGATGCCCTATT,0,5034122
ykgRp,0.25,3,3,GATGTTCGTCACTTCGTGGG,0,5034688
ykgRp,0.25,3,3,GATGTGGGTTTATAAGCTCA,0,5031440
ykgRp,0.25,3,3,GATGCTTCGAGGCGCGTCTA,0,5037979
ykgRp,0.25,3,3,GATGATCTCAGTTAAAAAGA,0,5060419
ykgRp,0.25,3,3,GATCTCCGTCATAGGGCAAT,0,5039550
ykgRp,0.25,3,3,GATCCTTCTGTTTGTCGATG,0,5051664
ykgRp,0.25,3,3,GATCAGTGTGGATGCTCCAG,0,5043273
ykgRp,0.25,3,3,GATCAAAACAGGACTTGTAT,0,5042799
ykgRp,0.25,3,3,GATATCAACCCATCGCGCCT,0,5052897
ykgRp,0.25,3,3,GATAGGGCTGATGTGTAGTG,0,5056237
ykgRp,0.25,3,3,GAGTTTGGTCTCACTTTCTA,0,5034803
ykgRp,0.25,3,3,GAGTTGAGTTCCATGAAGAA,0,5035333
ykgRp,0.25,3,3,GAGTCGTCAGTATGCCCGTG,0,5042374
ykgRp,0.25,3,3,GAGGTGGGTTCTTTTCGGCC,0,5043124
ykgRp,0.25,3,3,GAGGTAGTGTACAACCGGGA,0,5038953
ykgRp,0.25,3,3,GAGGGTCAGAAATTCAAACA,0,5043963
ykgRp,0.25,3,3,GAGGCCGGACAGTCTCGTTA,0,5044698
ykgRp,0.25,3,3,GAGGCCCATCGTAGGCTTAA,0,5043005
ykgRp,0.25,3,3,GAGGATACCCTCGCGGGCGA,0,5057710
ykgRp,0.25,3,3,GAGCGCTCAAGTAATGTAAC,0,5055211
ykgRp,0.25,3,3,GAGCGCAAGGGGGGATGGAG,0,5048277
ykgRp,0.25,3,3,GAGCCCTTTTCGGTTTCCCA,0,5033035
ykgRp,0.25,3,3,GAGCATACTTGTCGGTCTGA,0,5042366
ykgRp,0.25,3,3,GAGAGGCCCTCGGAACGTAA,0,5034478
ykgRp,0.25,3,3,GAGAGGAAAGAACCAAAATA,0,5043469
ykgRp,0.25,3,3,GACTTAAGACTTTTGAATTG,0,5046845
ykgRp,0.25,3,3,GACTCACGTCATTCGCATCG,0,5052467
ykgRp,0.25,3,3,GACGTGGTGAATGCTCATTG,0,5034868
ykgRp,0.25,3,3,GACGCAAACGCTACACACGA,0,5050255
ykgRp,0.25,3,3,GACCTGTTAACCCACAGTGG,0,5032080
ykgRp,0.25,3,3,GACCTGGCCCTTCGGTCGCC,0,5061606
ykgRp,0.25,3,3,GACCTAATGCGTAGGAACAC,0,5050305
ykgRp,0.25,3,3,GACCGGTAGACTATAACGCG,0,5052342
ykgRp,0.25,3,3,GACCCATTGCCGCGCCATGC,0,5047546
ykgRp,0.25,3,3,GACAGCTAAGCAAGAAATTT,0,5052193
ykgRp,0.25,3,3,GACAGCGGTGCCTTGTACCC,0,5034742
ykgRp,0.25,3,3,GACACCATGTGCCTTAGCGG,0,5054357
ykgRp,0.25,3,3,GAATTAGTCCGATATTTTAA,0,5031348
ykgRp,0.25,3,3,GAATCTGAGTTCCCTCGAGA,0,5044647
ykgRp,0.25,3,3,GAATATGATTCGTGCTGATT,0,5040460
ykgRp,0.25,3,3,GAATACCTTCTTAGCTTGCC,0,5042098
ykgRp,0.25,3,3,GAAGTCGGACACTAAAGGTA,0,5050059
ykgRp,0.25,3,3,GAAGGAAATAGGGTTCTGCG,0,5041565
ykgRp,0.25,3,3,GAAGCCAGATCTAGGAAGCT,0,5039696
ykgRp,0.25,3,3,GAAGAGATCCAAGGATACAA,0,5042264
ykgRp,0.25,3,3,GAAGAAATGCCCGATTGTCA,0,5047912
ykgRp,0.25,3,3,GAACGACTAAGGAGTTGACA,0,5041193
ykgRp,0.25,3,3,GAACCGGACGAATTCTGTGA,0,5056824
ykgRp,0.25,3,3,GAACAATTATACCTCTACTC,0,5060940
ykgRp,0.25,3,3,GAAAGGACTGTTGTCTAGCC,0,5033972
ykgRp,0.25,3,3,GAAAGGACTCCACTGGCAAT,0,5042523
ykgRp,0.25,3,3,GAAACTTGGGAAGGGAAGCG,0,5042838
ykgRp,0.25,3,3,GAAACAGCACAGTTTTCGAT,0,5035827
ykgRp,0.25,3,3,CTTTTGTCGTAAAAGCCTCT,0,5037662
ykgRp,0.25,3,3,CTTTTATCATAGCATGACGA,0,5058518
ykgRp,0.25,3,3,CTTTCGTGCGTATTACGATA,0,5059849
ykgRp,0.25,3,3,CTTTCGTAGCACTTTCTCAT,0,5045374
ykgRp,0.25,3,3,CTTTACGTTAAGGTGGTACG,0,5051991
ykgRp,0.25,3,3,CTTTACATCAGCCAAATTAC,0,5033585
ykgRp,0.25,3,3,CTTGTTATTGTATTCGGTTA,0,5034871
ykgRp,0.25,3,3,CTTGGTTCGAATACAAATGA,0,5060376
ykgRp,0.25,3,3,CTTGGTAGTTCAAGGCCTGT,0,5036568
ykgRp,0.25,3,3,CTTGAGCTGCGTCAGTGACA,0,5037762
ykgRp,0.25,3,3,CTTCGTTGGCTAATTTTATT,0,5049353
ykgRp,0.25,3,3,CTTAGGTGTAATGGTGATAT,0,5060819
ykgRp,0.25,3,3,CTTACTTAGGCTTGCTGCCT,0,5055314
ykgRp,0.25,3,3,CTGTTGGGCTCCGATTCGCT,0,5049276
ykgRp,0.25,3,3,CTGTGGCTAAAAGATCAATG,0,5052576
ykgRp,0.25,3,3,CTGTCAAAGTCACCCCGGCC,0,5044233
ykgRp,0.25,3,3,CTGGTGTTCTTACGCTGTGT,0,5044209
ykgRp,0.25,3,3,CTGGTGGCACTTCCGCACCC,0,5042277
ykgRp,0.25,3,3,CTGGGTAGACCTATCCCTTG,0,5051791
ykgRp,0.25,3,3,CTGGCGTGTATTTTCGAGCC,0,5047047
ykgRp,0.25,3,3,CTGGCATGCACTCGGCACCA,0,5051414
ykgRp,0.25,3,3,CTGGAGTAGGTTGGTGTTCG,0,5052361
ykgRp,0.25,3,3,CTGGAAGCTCATGCATTCTC,0,5058833
ykgRp,0.25,3,3,CTGCTGAAAAGGACCCCCTC,0,5036824
ykgRp,0.25,3,3,CTGCGGCGTAAGAAGTGTGG,0,5060814
ykgRp,0.25,3,3,CTGCATTAGTTCACATATAA,0,5031781
ykgRp,0.25,3,3,CTGACTCCCAGTCGTTTGAT,0,5055484
ykgRp,0.25,3,3,CTCTTTTATATCCACAACAT,0,5057046
ykgRp,0.25,3,3,CTCTTTAGCGATTGTATGCT,0,5033841
ykgRp,0.25,3,3,CTCTGGGTAATGTCTGGGAG,0,5056124
ykgRp,0.25,3,3,CTCTAGCTAACCTTGCGGCA,0,5046187
ykgRp,0.25,3,3,CTCGCATAGAGGCCGTCGGT,0,5059119
ykgRp,0.25,3,3,CTCGCAGGCATTTACTCCTG,0,5036662
ykgRp,0.25,3,3,CTCGAGCCCTCTAGCCCAAT,0,5035420
ykgRp,0.25,3,3,CTCCTACGGGACATAGTGCC,0,5051711
ykgRp,0.25,3,3,CTCCGCGTAGAATTTTAACT,0,5055816
ykgRp,0.25,3,3,CTCCGAGTAGTGTGTCCCAC,0,5051457
ykgRp,0.25,3,3,CTCCCCGCTTTAACATGGAT,0,5048041
ykgRp,0.25,3,3,CTCCACAGCGATTCTACACA,0,5057113
ykgRp,0.25,3,3,CTCATGTCCGTGGACACAAG,0,5038792
ykgRp,0.25,3,3,CTCATGCGAGACTAGCTTTC,0,5047311
ykgRp,0.25,3,3,CTCATCGATATGATCACCCG,0,5035659
ykgRp,0.25,3,3,CTCACGAAGCCGTGATCTTC,0,5041355
ykgRp,0.25,3,3,CTCACAGTACCAACCCCCCG,0,5044966
ykgRp,0.25,3,3,CTATGTTTACATAACAACGC,0,5039573
ykgRp,0.25,3,3,CTATCGCCGGTATTACGTAT,0,5034163
ykgRp,0.25,3,3,CTATCAAGTATGTGATGTTC,0,5042917
ykgRp,0.25,3,3,CTATAATAAACTATTGCCTC,0,5032332
ykgRp,0.25,3,3,CTAGTAACCAATACACTCGA,0,5050569
ykgRp,0.25,3,3,CTAGGGCGCGGAAACGAGGC,0,5050098
ykgRp,0.25,3,3,CTAGGCCAGATTCGTGGTAA,0,5042900
ykgRp,0.25,3,3,CTACTTCATTGGGCGGAATA,0,5061226
ykgRp,0.25,3,3,CTACGGTCAATTTTTCCAAA,0,5055109
ykgRp,0.25,3,3,CTAAGGCCGCGTGGCACACA,0,5035670
ykgRp,0.25,3,3,CTAAAATCCGTGTGGCAAGC,0,5037289
ykgRp,0.25,3,3,CGTTAGTTCGTAGTATCAGT,0,5043173
ykgRp,0.25,3,3,CGTATCGCACGCCACACGCT,0,5036090
ykgRp,0.25,3,3,CGTAGACAGTTGTGCACGCA,0,5036326
ykgRp,0.25,3,3,CGTACACGGCTGTACCCAAA,0,5053780
ykgRp,0.25,3,3,CGTAAGGCATCTTTGTTATA,0,5060313
ykgRp,0.25,3,3,CGGTTGGAGGAAACGCGCGA,0,5047975
ykgRp,0.25,3,3,CGGTCATTGGTATCGTTTCC,0,5056556
ykgRp,0.25,3,3,CGGTATCCCCGCAAGGGGTA,0,5033467
ykgRp,0.25,3,3,CGGTACTGGAGTGCCGCGTG,0,5051387
ykgRp,0.25,3,3,CGGGGAAGCTTTATTCACAA,0,5038211
ykgRp,0.25,3,3,CGGGCGCACTCTGTCGCACT,0,5046536
ykgRp,0.25,3,3,CGGGCCAAACAGTGACACAG,0,5058843
ykgRp,0.25,3,3,CGGGACTTAGGGGCGTGGAG,0,5039201
ykgRp,0.25,3,3,CGGGACTGACATCTGGCTTT,0,5037028
ykgRp,0.25,3,3,CGGGACACAGGCCTACAAAC,0,5035012
ykgRp,0.25,3,3,CGGCGACTGGACCAAAACGG,0,5046676
ykgRp,0.25,3,3,CGGAGTGCCTAGGCGCGGCC,0,5040721
ykgRp,0.25,3,3,CGGAGGTATTAAACAGAAGA,0,5038210
ykgRp,0.25,3,3,CGGACAGGGCAAGAGCGGCC,0,5043261
ykgRp,0.25,3,3,CGGACACATGTATCCTGTCG,0,5056850
ykgRp,0.25,3,3,CGGAACTTCCACGTTGTCAT,0,5043021
ykgRp,0.25,3,3,CGCTATATCTCCCCGTTGTA,0,5041066
ykgRp,0.25,3,3,CGCGTCGAGCGATCTGCGGG,0,5032041
ykgRp,0.25,3,3,CGCGGCTATTAGGGAAAATT,0,5054046
ykgRp,0.25,3,3,CGCGGACAGGACCGCTTCAT,0,5039651
ykgRp,0.25,3,3,CGCGAGCCGCGGAAAATCTT,0,5045502
ykgRp,0.25,3,3,CGCGACTTTCGTAAGCTTTA,0,5048242
ykgRp,0.25,3,3,CGCGAAACAAGTTGTTGTGG,0,5055068
ykgRp,0.25,3,3,CGCCGGGATAGAAGGAACGC,0,5052847
ykgRp,0.25,3,3,CGCCCTCTTAGACCGAAGTC,0,5031608
ykgRp,0.25,3,3,CGCCCTCGAAGAGTAAGACA,0,5041966
ykgRp,0.25,3,3,CGCCCGCGGTTGAGGAAGTT,0,5055648
ykgRp,0.25,3,3,CGCCAACTCTGACGATAGTA,0,5043553
ykgRp,0.25,3,3,CGCATACAGATTCGAAGTGC,0,5037636
ykgRp,0.25,3,3,CGCAGTTTATTGATGCTCCA,0,5058664
ykgRp,0.25,3,3,CGCAGCTCCCGGAGGTATGG,0,5056610
ykgRp,0.25,3,3,CGCAGAGGGCAGCCTTGCGA,0,5053824
ykgRp,0.25,3,3,CGCAGAGAGACCGAACACTT,0,5044268
ykgRp,0.25,3,3,CGATTTTCCCCGAAAAGCTT,0,5038394
ykgRp,0.25,3,3,CGATTACTTAATGCCTACCT,0,5033085
ykgRp,0.25,3,3,CGATGGACCAGTTAAACTCC,0,5046369
ykgRp,0.25,3,3,CGATCGGTCAAGCAAATGCG,0,5038592
ykgRp,0.25,3,3,CGATAAAGGTCAGATAAACG,0,5037190
ykgRp,0.25,3,3,CGAGTGTGGGGGTCGGGTAC,0,5033162
ykgRp,0.25,3,3,CGAGTCGCCGGAGGATATCA,0,5046638
ykgRp,0.25,3,3,CGAGGCACGCGTTGTCTCGT,0,5039146
ykgRp,0.25,3,3,CGAGCGCGCTTGTGACAGGA,0,5059970
ykgRp,0.25,3,3,CGAGCAAGCAGGGAGACACC,0,5050516
ykgRp,0.25,3,3,CGAGATATGTCTCCTCACCA,0,5056215
ykgRp,0.25,3,3,CGACTTAGGAAATAACTCCA,0,5040637
ykgRp,0.25,3,3,CGACTCGGCAGAACCGAGCC,0,5051007
ykgRp,0.25,3,3,CGACGCTACGACAGGAGTAC,0,5059429
ykgRp,0.25,3,3,CGACGACGCTGCCCTCACAT,0,5036215
ykgRp,0.25,3,3,CGACCCGTGCACCAAGCAAC,0,5043004
ykgRp,0.25,3,3,CGACATGTTTGAGCCATAAG,0,5033419
ykgRp,0.25,3,3,CGACACTAGACGTCTGGACA,0,5054468
ykgRp,0.25,3,3,CGAATTTAATACTCATACAC,0,5053099
ykgRp,0.25,3,3,CGAATCAGATCAGACGATGA,0,5045322
ykgRp,0.25,3,3,CGAATAGGTGTTACACATTG,0,5046222
ykgRp,0.25,3,3,CGAACCATAGCACGTCAAGT,0,5059688
ykgRp,0.25,3,3,CGAACAGAATCGCTCCGGCT,0,5046984
ykgRp,0.25,3,3,CGAAACGAGCTCAGTCACGG,0,5046198
ykgRp,0.25,3,3,CGAAAAAAGGATGGACCTAG,0,5044169
ykgRp,0.25,3,3,CCTTTGGAAGAGAACGATTG,0,5044323
ykgRp,0.25,3,3,CCTTTGGAAACGCACCTTGG,0,5040992
ykgRp,0.25,3,3,CCTTTCCTAGAAGCAGTGTA,0,5044022
ykgRp,0.25,3,3,CCTTGTCCAGCGAAAATAGC,0,5042749
ykgRp,0.25,3,3,CCTTCCGACGTGTTTTGTTG,0,5037534
ykgRp,0.25,3,3,CCTTACGACTGCAGATTGGA,0,5042327
ykgRp,0.25,3,3,CCTTACAGTTGCAATTTAAT,0,5054005
ykgRp,0.25,3,3,CCTGCAGCGACTGAGTTCCA,0,5047970
ykgRp,0.25,3,3,CCTGATCTGCCCGAATTCCG,0,5049394
ykgRp,0.25,3,3,CCTCGCTAGGATTCCAATAA,0,5058992
ykgRp,0.25,3,3,CCTCGCTACTGGTTCGTCCG,0,5056189
ykgRp,0.25,3,3,CCTCCTCCAGGAACGATTAG,0,5038188
ykgRp,0.25,3,3,CCTCCCCCGATTGCAGGACA,0,5050596
ykgRp,0.25,3,3,CCTCCACTATGCGTAGTGAC,0,5061432
ykgRp,0.25,3,3,CCTATATCCGCGGAAAAAAC,0,5052428
ykgRp,0.25,3,3,CCTATACATCCTGGCTACTC,0,5056371
ykgRp,0.25,3,3,CCTAACGCCTGATATAGTCA,0,5058332
ykgRp,0.25,3,3,CCGTTCTGAGGGCGTGTCTA,0,5049293
ykgRp,0.25,3,3,CCGTGTATGGCTGCCATGTC,0,5046118
ykgRp,0.25,3,3,CCGTACCCTCATAAGTCCCA,0,5031536
ykgRp,0.25,3,3,CCGGTTTCGTGGAGAGCATA,0,5051478
ykgRp,0.25,3,3,CCGGTTGTGTCTAACTCTAA,0,5057388
ykgRp,0.25,3,3,CCGGCTATGGGATGAAGGGG,0,5056176
ykgRp,0.25,3,3,CCGGCGATCCAATAAAGGGT,0,5054711
ykgRp,0.25,3,3,CCGGCCCCCAGCCCAGGTCC,0,5033301
ykgRp,0.25,3,3,CCGGACACGGTTTAGCACAT,0,5048839
ykgRp,0.25,3,3,CCGCTCCTCGCTTTCAATGT,0,5036418
ykgRp,0.25,3,3,CCGCCTCGGTGTAGCTCTCG,0,5053640
ykgRp,0.25,3,3,CCGATACGAGGATCATGATG,0,5047196
ykgRp,0.25,3,3,CCGACTGAAGGCCCGGGTCG,0,5049011
ykgRp,0.25,3,3,CCGAAGGCTACAATAAAAGG,0,5039009
ykgRp,0.25,3,3,CCCTTCCAGGGTTTGATAAT,0,5058042
ykgRp,0.25,3,3,CCCTGCACAAGCGTCAAGAA,0,5039364
ykgRp,0.25,3,3,CCCTCCGGCTTGACACGTCG,0,5048724
ykgRp,0.25,3,3,CCCTCCCTTCGATTGCGAAC,0,5045017
ykgRp,0.25,3,3,CCCTCAGGCTCACAGCAGAG,0,5048003
ykgRp,0.25,3,3,CCCTAGTTCAGACTCACGGT,0,5057006
ykgRp,0.25,3,3,CCCTAGGCCGTCATCGCAGA,0,5041164
ykgRp,0.25,3,3,CCCTACGAGTAGAACAAATC,0,5057786
ykgRp,0.25,3,3,CCCGGTCTCATTGCTTACAC,0,5039045
ykgRp,0.25,3,3,CCCGGATAGGGCCTGATTTG,0,5060455
ykgRp,0.25,3,3,CCCGCGCCGACCGGGCTCAG,0,5049133
ykgRp,0.25,3,3,CCCGCCGGCTGTCTGAGCTA,0,5060890
ykgRp,0.25,3,3,CCCGCCCGTGCAGTTCCTCC,0,5056344
ykgRp,0.25,3,3,CCCGATTCGGTAGATGGCGG,0,5042386
ykgRp,0.25,3,3,CCCGACACCCGTTGTAAGTA,0,5046259
ykgRp,0.25,3,3,CCCCGTGGTATGTCGATACT,0,5031360
ykgRp,0.25,3,3,CCCCGCGGCCCATACATCGA,0,5060646
ykgRp,0.25,3,3,CCCCAAGGTGGATTTCTGCC,0,5032597
ykgRp,0.25,3,3,CCCATCTGCAGGGAGCGGAT,0,5053536
ykgRp,0.25,3,3,CCCACGGCTAGCTAGCTCAG,0,5043823
ykgRp,0.25,3,3,CCATGGCCAGCAGACTCTTG,0,5046333
ykgRp,0.25,3,3,CCATGGAGGGGGATAATAGC,0,5056588
ykgRp,0.25,3,3,CCATCCTTGAGCACGAGGTA,0,5045147
ykgRp,0.25,3,3,CCATATTGCACGGGAAACAA,0,5055680
ykgRp,0.25,3,3,CCATAGGGGAAGGTCTTTAG,0,5056424
ykgRp,0.25,3,3,CCAGGGACTATGTTGGACTC,0,5043913
ykgRp,0.25,3,3,CCAGGAGTGCACCGGAGCCT,0,5039064
ykgRp,0.25,3,3,CCAGGAGCGGCATACGCACA,0,5055747
ykgRp,0.25,3,3,CCAGCATGCAGCGTCCTCGT,0,5060464
ykgRp,0.25,3,3,CCAGATATCTTGTACGTAAT,0,5058286
ykgRp,0.25,3,3,CCAGAGTGTCTTTTACGGAA,0,5046763
ykgRp,0.25,3,3,CCAGACGCTGCACCGATTTG,0,5053652
ykgRp,0.25,3,3,CCACCTTTAAGAATCACGAA,0,5041329
ykgRp,0.25,3,3,CCACAAGTGCTAGTATACTG,0,5055346
ykgRp,0.25,3,3,CCACAACTCACTGGTGTGGA,0,5045831
ykgRp,0.25,3,3,CCAATTCAGTTACTGGTACT,0,5059803
ykgRp,0.25,3,3,CCAATCTGGAAACAGAAAAT,0,5046778
ykgRp,0.25,3,3,CATTTTGACCAAGGCAGTCC,0,5041547
ykgRp,0.25,3,3,CATTTGTCTGAGGATCTCCA,0,5060917
ykgRp,0.25,3,3,CATTGACGCTATATATAATA,0,5036492
ykgRp,0.25,3,3,CATTCGGCAATATCCGGGTT,0,5049224
ykgRp,0.25,3,3,CATTCCGCGTGGTCTAACCC,0,5061691
ykgRp,0.25,3,3,CATTCATCTCATTGCGCACT,0,5057691
ykgRp,0.25,3,3,CATGTCTTCCGGTGGGATCA,0,5044091
ykgRp,0.25,3,3,CATGTCGAGCAGTCCCCTTT,0,5055802
ykgRp,0.25,3,3,CATCTTAGGACGTCGATGAA,0,5041796
ykgRp,0.25,3,3,CATCGCTGAGTCAACTTGTC,0,5040466
ykgRp,0.25,3,3,CATATTATAATCTACGGCTC,0,5061316
ykgRp,0.25,3,3,CATATAGTCAGCGTTAATGT,0,5038156
ykgRp,0.25,3,3,CATAGTCATATATTAGTGGG,0,5042988
ykgRp,0.25,3,3,CATACGGATGCCCTGCGGAC,0,5037356
ykgRp,0.25,3,3,CATACCTTTTGTGTGTGAAC,0,5040265
ykgRp,0.25,3,3,CATACACCTTCTACTGTTCC,0,5034414
ykgRp,0.25,3,3,CATAACCCCGACAATGAAGT,0,5034845
ykgRp,0.25,3,3,CAGTTAGACGCCTTACAGGC,0,5060060
ykgRp,0.25,3,3,CAGTGTCCTGTGAACCGGAT,0,5040223
ykgRp,0.25,3,3,CAGTGCATTAGTACGGATTT,0,5033960
ykgRp,0.25,3,3,CAGTCTAAAGCGATCTCCTG,0,5039455
ykgRp,0.25,3,3,CAGTCGTAACAAATGCGGGT,0,5051563
ykgRp,0.25,3,3,CAGTCCTATCAGAGGGATTT,0,5058729
ykgRp,0.25,3,3,CAGTCCCGGGATCATTCCAG,0,5034622
ykgRp,0.25,3,3,CAGGGTGTAAACGTTGGTGA,0,5044071
ykgRp,0.25,3,3,CAGGGGGCGAATCAGGTAGG,0,5051479
ykgRp,0.25,3,3,CAGCGGAAAGAGTCACTCTC,0,5059520
ykgRp,0.25,3,3,CAGCCGTCGATGAGCCTTTC,0,5058688
ykgRp,0.25,3,3,CAGCATGAATGATGCAAGCT,0,5037390
ykgRp,0.25,3,3,CAGATTGAACTTGGTGAAGG,0,5043444
ykgRp,0.25,3,3,CAGATAGGGTTGTCACTGAG,0,5046119
ykgRp,0.25,3,3,CAGACACAACCATAAAGTGA,0,5034132
ykgRp,0.25,3,3,CACTTGGTTTTTTTAGGTCG,0,5055455
ykgRp,0.25,3,3,CACTTGCGAGCTGAAGGAAC,0,5053903
ykgRp,0.25,3,3,CACTGTTACTAAAAGGCGGG,0,5053475
ykgRp,0.25,3,3,CACTGACGGTTCCCCACGCT,0,5047746
ykgRp,0.25,3,3,CACTCTGGTTACACATCGCA,0,5052218
ykgRp,0.25,3,3,CACTCCAGCGCTGAGGAGTA,0,5033582
ykgRp,0.25,3,3,CACTAAAATGCCCGTTAAGC,0,5033870
ykgRp,0.25,3,3,CACTAAAAATTCATTCGTCG,0,5041981
ykgRp,0.25,3,3,CACGTCTGCATTATCTTTGA,0,5036550
ykgRp,0.25,3,3,CACGCTATACGGAGTGCTAC,0,5033288
ykgRp,0.25,3,3,CACGCAAAGCCAAACCCTGA,0,5047105
ykgRp,0.25,3,3,CACCTTCTGGGGCCTACTTG,0,5059350
ykgRp,0.25,3,3,CACCTTCATACACGGGGTTC,0,5055707
ykgRp,0.25,3,3,CACCATCTGGCCGTAATGTA,0,5043670
ykgRp,0.25,3,3,CACATTGGTCTAGGTCGGTA,0,5054436
ykgRp,0.25,3,3,CACAGTGCTCGTAGTCAAGC,0,5056688
ykgRp,0.25,3,3,CACAGAGAATGGTGTTACTT,0,5038190
ykgRp,0.25,3,3,CACACTTGACATGTCGGCGA,0,5044150
ykgRp,0.25,3,3,CACACAGCGTTTTAAGTACG,0,5036720
ykgRp,0.25,3,3,CACAAGGGGGATAGGTGTGT,0,5048297
ykgRp,0.25,3,3,CACAACGTTTAGAAGAAGCG,0,5047771
ykgRp,0.25,3,3,CACAAAAAAACTCTTTTATT,0,5034338
ykgRp,0.25,3,3,CAATTGACTTGGCACCATGT,0,5043984
ykgRp,0.25,3,3,CAATCTTAGTTTTCACAGTT,0,5046594
ykgRp,0.25,3,3,CAATAGCGATGTTCATTAGC,0,5040714
ykgRp,0.25,3,3,CAAGCGCTTAAAGATCATAG,0,5050934
ykgRp,0.25,3,3,CAAGAGACAAAGAAGAGCAG,0,5055006
ykgRp,0.25,3,3,CAACGTATCAAATGAAGTTA,0,5050835
ykgRp,0.25,3,3,CAACGACGTTTGAGGATCTT,0,5050359
ykgRp,0.25,3,3,CAACAGTGTCGGCAGATCGG,0,5050740
ykgRp,0.25,3,3,CAACACGCCCGTGTTGGTAA,0,5049334
ykgRp,0.25,3,3,CAAATTGGGCGCATGCGATG,0,5038192
ykgRp,0.25,3,3,CAAATGTGTTGAGGTGTGCG,0,5033184
ykgRp,0.25,3,3,CAAAATGGGCCTCACAAAGA,0,5047108
ykgRp,0.25,3,3,CAAAAGCTCTGGTAAGATGA,0,5059373
ykgRp,0.25,3,3,ATTTTCGGAATTGTCTTGCC,0,5041900
ykgRp,0.25,3,3,ATTTTCCTCGAAGGTCCTAC,0,5035878
ykgRp,0.25,3,3,ATTTTAGCGGGGGCAGAAGT,0,5060954
ykgRp,0.25,3,3,ATTTGTTCATCCGGGCAAAA,0,5054283
ykgRp,0.25,3,3,ATTTATGAGGTATGTAGAAG,0,5039571
ykgRp,0.25,3,3,ATTTATCGGCGGTAAGTGGG,0,5048994
ykgRp,0.25,3,3,ATTTAGTAGGTTGGACCTGT,0,5049858
ykgRp,0.25,3,3,ATTTAACGAAGACGTCTTGA,0,5061203
ykgRp,0.25,3,3,ATTGTGTATGTGTTAGTCGT,0,5045845
ykgRp,0.25,3,3,ATTGTGGACACTGTAATGGC,0,5038414
ykgRp,0.25,3,3,ATTGGTGGGATTGGTAACTA,0,5054772
ykgRp,0.25,3,3,ATTGCGAACGTCGGCACGGC,0,5034078
ykgRp,0.25,3,3,ATTGAATAACGGCTGTGGCT,0,5046278
ykgRp,0.25,3,3,ATTCGCCGACTTTATCTGAA,0,5043804
ykgRp,0.25,3,3,ATTCGACGAATAGAGTCTAA,0,5049279
ykgRp,0.25,3,3,ATTCACTTCCGTGTACTAGC,0,5049280
ykgRp,0.25,3,3,ATTCAACAGAACCCTTGGGA,0,5041450
ykgRp,0.25,3,3,ATTATTAGGCTTTCGTTGAA,0,5047582
ykgRp,0.25,3,3,ATTAGTCACCGCACGCATAT,0,5056912
ykgRp,0.25,3,3,ATTACGAGGGCATGTCTGTA,0,5053809
ykgRp,0.25,3,3,ATTAATGTTCGGGAGTGGTT,0,5035954
ykgRp,0.25,3,3,ATTAATCGGGATCGCCTGAG,0,5046208
ykgRp,0.25,3,3,ATGTTAAAAGCACTTTTGAC,0,5061124
ykgRp,0.25,3,3,ATGTGGGATTCTACGGTCTA,0,5056776
ykgRp,0.25,3,3,ATGGTTGCCGGCGGAATAAC,0,5034646
ykgRp,0.25,3,3,ATGGGTGGGGGAGGTCATCC,0,5043166
ykgRp,0.25,3,3,ATGGGGAGCTACAAACACGC,0,5032717
ykgRp,0.25,3,3,ATGGCTTGGACTAACCAGAT,0,5052731
ykgRp,0.25,3,3,ATGGCGAATCAATCCGCCTC,0,5033833
ykgRp,0.25,3,3,ATGGCCCGCGAGCCGGGAAC,0,5037428
ykgRp,0.25,3,3,ATGGCCACCCTCTAAAATCT,0,5058711
ykgRp,0.25,3,3,ATGCGACGCAGGGCAGGTGT,0,5041922
ykgRp,0.25,3,3,ATGCATTCAGCACTACCCAA,0,5037460
ykgRp,0.25,3,3,ATGAGTCAAGGAATTCGTAA,0,5047086
ykgRp,0.25,3,3,ATGAATCCCAACGATTCGGG,0,5052966
ykgRp,0.25,3,3,ATGAATATGGATACGTAATT,0,5056032
ykgRp,0.25,3,3,ATGAACCAGGTCCAGAAGTA,0,5050203
ykgRp,0.25,3,3,ATCTTGCTTAAAGCTCATCT,0,5050932
ykgRp,0.25,3,3,ATCTTAATTGAGCATACAAG,0,5044172
ykgRp,0.25,3,3,ATCTCGGCCAATAGGAATGC,0,5031727
ykgRp,0.25,3,3,ATCTATACTAAACGACACCA,0,5038975
ykgRp,0.25,3,3,ATCTAGTTTCATAGCCGCCT,0,5042771
ykgRp,0.25,3,3,ATCGTGTGTTGGCGCTTTGT,0,5053729
ykgRp,0.25,3,3,ATCGGCAATCTTTACTTGTT,0,5044850
ykgRp,0.25,3,3,ATCGCTGCAGGCAGATTGTA,0,5041326
ykgRp,0.25,3,3,ATCGCCCTCTCGACCTGTAC,0,5043335
ykgRp,0.25,3,3,ATCGACTTCAGGCTGGGACA,0,5036854
ykgRp,0.25,3,3,ATCCTTGATGTAACAAGCGC,0,5049709
ykgRp,0.25,3,3,ATCCTTAGTCCACGTTGTTA,0,5038073
ykgRp,0.25,3,3,ATCCTGGACACTCGCCAGCC,0,5055279
ykgRp,0.25,3,3,ATCCTCCATCCCGGAAGCCA,0,5048947
ykgRp,0.25,3,3,ATCCAGAGTGCAAGAACACT,0,5056064
ykgRp,0.25,3,3,ATCAGTAACTTGTTGCAGAT,0,5055384
ykgRp,0.25,3,3,ATCAAGCGAGTCCCTGCGAA,0,5060561
ykgRp,0.25,3,3,ATATTCGTCTTGGCAACGTG,0,5053803
ykgRp,0.25,3,3,ATATCTAAGGGTCGTCAAAT,0,5043692
ykgRp,0.25,3,3,ATATCATCAGCCCAAACAGA,0,5057729
ykgRp,0.25,3,3,ATATAGGTCAACGAATTTCC,0,5055888
ykgRp,0.25,3,3,ATATACACAGATTATCAGGA,0,5048643
ykgRp,0.25,3,3,ATAGGTTTGTAAGTTATATT,0,5033844
ykgRp,0.25,3,3,ATAGGTAGTTTTCGATCCCA,0,5051826
ykgRp,0.25,3,3,ATAGGGTACCCACCCATATA,0,5043315
ykgRp,0.25,3,3,ATAGGACAAGGCTCCAGGTT,0,5060245
ykgRp,0.25,3,3,ATAGCCCAGGGCTCAACTAG,0,5042462
ykgRp,0.25,3,3,ATAGATTGCTGCCAGTGTAG,0,5050666
ykgRp,0.25,3,3,ATACTAATCCCAGCATCCAT,0,5051903
ykgRp,0.25,3,3,ATACAGAGCTGCGCCAACAC,0,5033279
ykgRp,0.25,3,3,ATAATTCGAAAATCACATGT,0,5039370
ykgRp,0.25,3,3,ATAAATTTTGGAGACTGGTA,0,5049852
ykgRp,0.25,3,3,ATAAAGGGCGGCTCTCAAAA,0,5038763
ykgRp,0.25,3,3,ATAAAACGCGTGTGGGGTTG,0,5045990
ykgRp,0.25,3,3,AGTTTATCCTTCTCGGAGGC,0,5052020
ykgRp,0.25,3,3,AGTTCAGACGAGATCGTGGT,0,5051944
ykgRp,0.25,3,3,AGTTCACCTGCAGTGCTCGC,0,5060252
ykgRp,0.25,3,3,AGTTAAACGTGGATGTCCCA,0,5035653
ykgRp,0.25,3,3,AGTGTGGTCGAAGGATCACG,0,5060343
ykgRp,0.25,3,3,AGTGAACGAGTGACTAATCT,0,5057890
ykgRp,0.25,3,3,AGTCGTCATAGAGCATGGCC,0,5033806
ykgRp,0.25,3,3,AGTCGGAAAAGGAAAGCACA,0,5032644
ykgRp,0.25,3,3,AGTCCTGCATTCACTCGTAT,0,5040552
ykgRp,0.25,3,3,AGTCCGCTGAGACGCGTTAT,0,5059552
ykgRp,0.25,3,3,AGTCCCGGAGTCACGGTATA,0,5048767
ykgRp,0.25,3,3,AGTCCAGCGCTCCACTTGGA,0,5060185
ykgRp,0.25,3,3,AGTAGTCCTAAGCGGACTAG,0,5042668
ykgRp,0.25,3,3,AGTAGGAAGTATCTCTTTTG,0,5053314
ykgRp,0.25,3,3,AGTACCTAAAGCTCCGGAAT,0,5044594
ykgRp,0.25,3,3,AGTACCGTAATTTATCAAGG,0,5053444
ykgRp,0.25,3,3,AGTAATTGCACTACCCAGGG,0,5031623
ykgRp,0.25,3,3,AGGTTCAACTCATGTTTATG,0,5058398
ykgRp,0.25,3,3,AGGTATGTAGTTAGTCGGTA,0,5032748
ykgRp,0.25,3,3,AGGGGCACACTACAAGGCTT,0,5039018
ykgRp,0.25,3,3,AGGGGACGTCCGTATGGGCA,0,5042663
ykgRp,0.25,3,3,AGGGCTTCAGAACTTCCAGG,0,5059584
ykgRp,0.25,3,3,AGGGCGCCGCGAAGGCTCCT,0,5049626
ykgRp,0.25,3,3,AGGGCCATGCAACGGTAAAT,0,5050763
ykgRp,0.25,3,3,AGGGCACCGACTACTATAAA,0,5048615
ykgRp,0.25,3,3,AGGCCGTGTGGTACCCCCGT,0,5047686
ykgRp,0.25,3,3,AGGCCCGCAAACTGTTTCAA,0,5059274
ykgRp,0.25,3,3,AGGCCAACTCTTACAATGCC,0,5052425
ykgRp,0.25,3,3,AGGATGTTAAAGACGGTCCA,0,5043110
ykgRp,0.25,3,3,AGGATGACGGGTACCTGAGG,0,5058359
ykgRp,0.25,3,3,AGGAAATTGTACGGTGCTTC,0,5044366
ykgRp,0.25,3,3,AGCTTCAAGGTGATACCCAA,0,5037760
ykgRp,0.25,3,3,AGCTCTAGACCGCCATTGAG,0,5049828
ykgRp,0.25,3,3,AGCTCCATACTCAATAGAGC,0,5036052
ykgRp,0.25,3,3,AGCGCCGAGACAACTCAGGT,0,5044053
ykgRp,0.25,3,3,AGCCTCGCGATGAACGGTGA,0,5032670
ykgRp,0.25,3,3,AGCCGGTAAATATACGTTGG,0,5060336
ykgRp,0.25,3,3,AGCCGATGACGGCATACATA,0,5033754
ykgRp,0.25,3,3,AGCCCGAGCGGCACATACCT,0,5060958
ykgRp,0.25,3,3,AGCCCAGCGTTCACCGCACG,0,5039135
ykgRp,0.25,3,3,AGCCAGGCGAATCACTGTCA,0,5058451
ykgRp,0.25,3,3,AGCATTGCATCACAGACGGA,0,5043194
ykgRp,0.25,3,3,AGCATTCCGGCGCAAGCCGC,0,5055113
ykgRp,0.25,3,3,AGCATTATTAGTCTTGAGGA,0,5047401
ykgRp,0.25,3,3,AGCAGTGCCACCGTTGACTG,0,5034920
ykgRp,0.25,3,3,AGCACTAACAAACTCAACAA,0,5036850
ykgRp,0.25,3,3,AGCACAGTTAACAGGACACT,0,5038711
ykgRp,0.25,3,3,AGCAATTGGTGAGATGTTCG,0,5056871
ykgRp,0.25,3,3,AGCAACGCTTACAATCTGGT,0,5036112
ykgRp,0.25,3,3,AGATTGGTGACAGTGGTTCC,0,5044341
ykgRp,0.25,3,3,AGATGTTAGGACTATTAAGC,0,5060101
ykgRp,0.25,3,3,AGATGCGAGTGACGGTGCTG,0,5034507
ykgRp,0.25,3,3,AGATGCCTTACTCAAACAGG,0,5046786
ykgRp,0.25,3,3,AGATGAATGGGCCATGGTGT,0,5032301
ykgRp,0.25,3,3,AGATCGTCATACGCTTCCCG,0,5039187
ykgRp,0.25,3,3,AGATCGAGATTGAGGTGTAC,0,5055064
ykgRp,0.25,3,3,AGATAGCGTATCTATTTAGT,0,5035127
ykgRp,0.25,3,3,AGATAATAAGTGGCGCTGGT,0,5043117
ykgRp,0.25,3,3,AGAGGGCTACTTGCATTGTT,0,5050704
ykgRp,0.25,3,3,AGAGGCGGCCAACGCGATAG,0,5059265
ykgRp,0.25,3,3,AGAGCAGCTTCCCCCGCCAG,0,5034505
ykgRp,0.25,3,3,AGAGCACCCAATAAGTAAGT,0,5060757
ykgRp,0.25,3,3,AGAGAAATATGTACATCTCA,0,5059420
ykgRp,0.25,3,3,AGACGTTGGTCAGGGTGCTA,0,5051259
ykgRp,0.25,3,3,AGACGACATTGGTCCACTGA,0,5040292
ykgRp,0.25,3,3,AGACGACACAAGGGTCTACA,0,5037134
ykgRp,0.25,3,3,AGACCTACCACCAACTACTC,0,5046755
ykgRp,0.25,3,3,AGACACGGAACTGTTGTAGG,0,5059754
ykgRp,0.25,3,3,AGACACCGGGTAGTGCCTGG,0,5061066
ykgRp,0.25,3,3,AGACAATATAACTCGGGGCT,0,5032838
ykgRp,0.25,3,3,AGAATGGCAGAAAGGGCATG,0,5040469
ykgRp,0.25,3,3,AGAATGCTTGTCCAAGGGTG,0,5047474
ykgRp,0.25,3,3,AGAACGGAGGCCACGAGAGT,0,5038692
ykgRp,0.25,3,3,AGAACCTTTTGCCAACCCTA,0,5051669
ykgRp,0.25,3,3,AGAACCCACGCGCGGGCTAG,0,5040296
ykgRp,0.25,3,3,ACTTTCATTGAAGCTGCATG,0,5033480
ykgRp,0.25,3,3,ACTTTATAGGTTCCTTTAAC,0,5036965
ykgRp,0.25,3,3,ACTTCCGAATGACGTCCAAC,0,5058830
ykgRp,0.25,3,3,ACTTCCAGGTGGGCGAAGTC,0,5033074
ykgRp,0.25,3,3,ACTTATGGTGTGCTGCTCAT,0,5061126
ykgRp,0.25,3,3,ACTTATGAACCTTCCCTGCG,0,5059549
ykgRp,0.25,3,3,ACTGTGCCTGTTCGGATTTG,0,5053130
ykgRp,0.25,3,3,ACTGTATCTTTCGCTATGAT,0,5050049
ykgRp,0.25,3,3,ACTGCCAGCGAACTGTCAAG,0,5059717
ykgRp,0.25,3,3,ACTGACGTTTGTATCTGAGC,0,5055458
ykgRp,0.25,3,3,ACTCTTACCATATGTATTCG,0,5035517
ykgRp,0.25,3,3,ACTCGTAAATTCCCGTCAGT,0,5048890
ykgRp,0.25,3,3,ACTCGGAGTTTGCGGGCGGC,0,5035171
ykgRp,0.25,3,3,ACTACAGCTAGTCTAAGGTG,0,5046728
ykgRp,0.25,3,3,ACGTTTAGCTACCTACGACA,0,5031863
ykgRp,0.25,3,3,ACGTTTACTTTCATCCTAAG,0,5048082
ykgRp,0.25,3,3,ACGTTCTCCCCGCGTGTCTG,0,5032288
ykgRp,0.25,3,3,ACGTGCTGCGAAGGAGTTCC,0,5044096
ykgRp,0.25,3,3,ACGTGCGAGGATCCGCGGGT,0,5042117
ykgRp,0.25,3,3,ACGTGATGCGATGGTGGCGT,0,5043130
ykgRp,0.25,3,3,ACGTCGTGGCTATTAAGCCG,0,5041748
ykgRp,0.25,3,3,ACGTAGTGGTTAAGAGGACC,0,5039843
ykgRp,0.25,3,3,ACGTAACAAATTGTTGGTCA,0,5050101
ykgRp,0.25,3,3,ACGGTTTCCTTTAGAAAGGC,0,5033714
ykgRp,0.25,3,3,ACGGGAGATGTATGTATACA,0,5040795
ykgRp,0.25,3,3,ACGGCGCCGTATGTAACAGG,0,5059407
ykgRp,0.25,3,3,ACGGATAGGCGCATCAAGAC,0,5058929
ykgRp,0.25,3,3,ACGCTTTATTTCCAACCTGA,0,5040886
ykgRp,0.25,3,3,ACGCGTGCATGTTTCTGTTC,0,5040752
ykgRp,0.25,3,3,ACGCCGGGCATACAATATCA,0,5035864
ykgRp,0.25,3,3,ACGCACGGGCGAAACGTCAG,0,5033732
ykgRp,0.25,3,3,ACGATGCAATTTTCCTTCTC,0,5049277
ykgRp,0.25,3,3,ACGACGCGCTACTGTATGTG,0,5050973
ykgRp,0.25,3,3,ACGACCGTGAATCGGGCACG,0,5053761
ykgRp,0.25,3,3,ACCTTTAGGCCTGTGGTCGG,0,5059750
ykgRp,0.25,3,3,ACCTTAGCCATCATTTAGAT,0,5061283
ykgRp,0.25,3,3,ACCGGTTTGTGTCGTTCAGT,0,5031641
ykgRp,0.25,3,3,ACCGCGGATACGAATCTCGT,0,5033098
ykgRp,0.25,3,3,ACCGCCTTATCAAATGGTTG,0,5040725
ykgRp,0.25,3,3,ACCGATGCTTTAAACGGTAT,0,5043433
ykgRp,0.25,3,3,ACCGATAGCCTAAATGCGCC,0,5031634
ykgRp,0.25,3,3,ACCGAAACGGATCCTGCCCT,0,5057423
ykgRp,0.25,3,3,ACCCTTAGTGGTATTGACCC,0,5045257
ykgRp,0.25,3,3,ACCCGTATTATCACGTCTGG,0,5045988
ykgRp,0.25,3,3,ACCCGAGGGTAGACTCGCTT,0,5050284
ykgRp,0.25,3,3,ACCCAGCTCAGATTGCGGAC,0,5058492
ykgRp,0.25,3,3,ACCATTTCAAAGCCGCCCTA,0,5038791
ykgRp,0.25,3,3,ACCATGATTGAGTGCGGCTC,0,5035871
ykgRp,0.25,3,3,ACCAGGAAACGTGGGTGTTA,0,5046005
ykgRp,0.25,3,3,ACCACTGCATGGGCCTCGGG,0,5054458
ykgRp,0.25,3,3,ACATTCAACATAATGTGCTC,0,5041157
ykgRp,0.25,3,3,ACATGTAAACAACTACTCAG,0,5037313
ykgRp,0.25,3,3,ACATGCAACAGCCTCCAATG,0,5040487
ykgRp,0.25,3,3,ACATCTTAAAATCTCTGACG,0,5042242
ykgRp,0.25,3,3,ACATCCAACTTTATTGGATT,0,5045136
ykgRp,0.25,3,3,ACATATTGTCGTGTTCATCA,0,5046752
ykgRp,0.25,3,3,ACATACGCTAGGGCGTCCTT,0,5039028
ykgRp,0.25,3,3,ACAGGTTCGGGTGTGAACGT,0,5040071
ykgRp,0.25,3,3,ACAGATTGCCGACTTAATTT,0,5033084
ykgRp,0.25,3,3,ACACGTATAGAGTCCGGAGT,0,5047660
ykgRp,0.25,3,3,ACACCTTACTATGCATATCA,0,5041899
ykgRp,0.25,3,3,ACACCCTCCATACTTCTCTC,0,5036223
ykgRp,0.25,3,3,ACACAGCGTATTCGGGGAGA,0,5044082
ykgRp,0.25,3,3,ACACACAGCTATAGAAAGCA,0,5050820
ykgRp,0.25,3,3,ACAATTCCATCATTGCAACA,0,5045465
ykgRp,0.25,3,3,ACAATGTTGATTCAAGTTGT,0,5045299
ykgRp,0.25,3,3,ACAATACGTTTGTGTCCCTG,0,5053637
ykgRp,0.25,3,3,ACAAGTAGACTCGGGGTAAA,0,5033394
ykgRp,0.25,3,3,ACAACCTGCGGGATAGATCT,0,5053189
ykgRp,0.25,3,3,ACAAATCTCACAAGGAGAAG,0,5036867
ykgRp,0.25,3,3,ACAAAAACTTGTGAAAGTAC,0,5031891
ykgRp,0.25,3,3,AATTTGTAATTACGTTCCTG,0,5050331
ykgRp,0.25,3,3,AATTGATCATTTTCCCATGA,0,5050366
ykgRp,0.25,3,3,AATTCGTCAAATAGACTTCT,0,5045600
ykgRp,0.25,3,3,AATTATCGCGGTCGATTACC,0,5058905
ykgRp,0.25,3,3,AATGGGGAACGTAGACTGTC,0,5032289
ykgRp,0.25,3,3,AATGGCAAGGCCAGGGCTCC,0,5040025
ykgRp,0.25,3,3,AATGCAGGTAGATAATTCTA,0,5055132
ykgRp,0.25,3,3,AATCTAGTGCATCCGCGCTA,0,5060062
ykgRp,0.25,3,3,AATCGTCTAGCCAACAAATT,0,5034876
ykgRp,0.25,3,3,AATCGAGGAGTCCCCACGGG,0,5059510
ykgRp,0.25,3,3,AATCCGGACGGGCGCAGAAT,0,5037689
ykgRp,0.25,3,3,AATCCAAGTAAACAGCACCG,0,5044505
ykgRp,0.25,3,3,AATCATGGCTTGCTTTGCCT,0,5045968
ykgRp,0.25,3,3,AATCATCAATCAGTACGGAT,0,5042985
ykgRp,0.25,3,3,AATCAAGGGGTAAACATTGT,0,5059327
ykgRp,0.25,3,3,AATAATGCGGGCAAGTATTT,0,5041670
ykgRp,0.25,3,3,AATAAATTATTAGCCCACGC,0,5055165
ykgRp,0.25,3,3,AAGTGGCACGAGTCGGGCGA,0,5060576
ykgRp,0.25,3,3,AAGTGAACGATTACCGAATA,0,5040179
ykgRp,0.25,3,3,AAGTCTGTTAGTCCCCGGCA,0,5040291
ykgRp,0.25,3,3,AAGTATCAGTGGATCGCTCT,0,5056853
ykgRp,0.25,3,3,AAGGGGTCCTTGGTTCAACT,0,5031679
ykgRp,0.25,3,3,AAGGAAGACAGAGCAGTAAC,0,5037949
ykgRp,0.25,3,3,AAGCTTAGAGTAATTTAGAG,0,5055316
ykgRp,0.25,3,3,AAGCGGACTGGCGGTATCTG,0,5043175
ykgRp,0.25,3,3,AAGCGACGGGGTACCGGAAA,0,5032302
ykgRp,0.25,3,3,AAGCCTTGCGCAATGAACAG,0,5058310
ykgRp,0.25,3,3,AAGCCTTAGTCCCAAAATTT,0,5036866
ykgRp,0.25,3,3,AAGCCCAGAGAAAACAGATG,0,5053190
ykgRp,0.25,3,3,AAGCCATTAAGTTGTTTTAC,0,5052557
ykgRp,0.25,3,3,AAGCAATAGGCGCTGTGCAG,0,5040172
ykgRp,0.25,3,3,AAGATCGTTAAGCGCGTTAA,0,5058465
ykgRp,0.25,3,3,AAGAAGCCCCACCCGGTGAT,0,5044874
ykgRp,0.25,3,3,AAGAAAAGCACTTATACATC,0,5057397
ykgRp,0.25,3,3,AACTGGCGTGAAGAAGACCT,0,5056453
ykgRp,0.25,3,3,AACTATGTTGAACCGTAGAA,0,5036538
ykgRp,0.25,3,3,AACTATGACCACTGTTAAAC,0,5056040
ykgRp,0.25,3,3,AACGTCAGTGGTACAAAGCC,0,5051235
ykgRp,0.25,3,3,AACGTATATCGTGTGCGGGT,0,5039137
ykgRp,0.25,3,3,AACGGGGGGGTTGCAGGCCA,0,5046343
ykgRp,0.25,3,3,AACGGGCTCTTCTGACACGG,0,5054495
ykgRp,0.25,3,3,AACGGCTGTATCGATATCAG,0,5038392
ykgRp,0.25,3,3,AACGGATACCTTTTACAAGT,0,5037067
ykgRp,0.25,3,3,AACGACAAGGATACTAACTA,0,5034673
ykgRp,0.25,3,3,AACCGGTTCCGATGTTATTA,0,5056499
ykgRp,0.25,3,3,AACCGATCAGTCTTAGTTGC,0,5043468
ykgRp,0.25,3,3,AACCGACTCTCACAAGTCAC,0,5058485
ykgRp,0.25,3,3,AACCACAGGTGGTGGAGAGA,0,5045671
ykgRp,0.25,3,3,AACAGGACCTAGGCGGGCTC,0,5036357
ykgRp,0.25,3,3,AAATTGTCGCATCCCTCCTG,0,5047334
ykgRp,0.25,3,3,AAATATTGGGCCTGGCCCAT,0,5031359
ykgRp,0.25,3,3,AAATATACGGTTCTATTTTG,0,5041451
ykgRp,0.25,3,3,AAATACGCTTACCGTGCCAC,0,5039339
ykgRp,0.25,3,3,AAAGTACGTTTGATTCGTAG,0,5042285
ykgRp,0.25,3,3,AAAGGTAAAGTTTCTACAAT,0,5033569
ykgRp,0.25,3,3,AAAGGATTGAGTGTAGGTTC,0,5050287
ykgRp,0.25,3,3,AAAGCGGCAGGGCAGCCAGT,0,5037978
ykgRp,0.25,3,3,AAAGAGATAACAGCAGCATG,0,5056875
ykgRp,0.25,3,3,AAAGACCAGTGGCATACGTA,0,5049415
ykgRp,0.25,3,3,AAACTGGGAGGGTGGGACAT,0,5056668
ykgRp,0.25,3,3,AAACGTGTGGGATTGATTCT,0,5042763
ykgRp,0.25,3,3,AAACCCGGGATACCCTATGC,0,5035937
ykgRp,0.25,3,3,AAACATCTGTGTGTACCCAG,0,5050799
ykgRp,0.25,3,3,AAACACTTTGGGTACTTCCA,0,5051062
ykgRp,0.25,3,3,AAAATCGTGCTACACTGAAC,0,5056519
ykgRp,0.25,3,3,AAAACATTGCCATATTGTCA,0,5045213
ykgRp,0.25,3,3,AAAAATGAGAGTAACGTCTT,0,5060828
ykgRp,0.3333333333333333,2,2,TTTTTTTTACAACTCTTCGT,0,5047573
ykgRp,0.3333333333333333,2,2,TTTTTGGGTCCAGACACCTC,0,5055720
ykgRp,0.3333333333333333,2,2,TTTTTCGGGAAACATGCTCG,0,5038573
ykgRp,0.3333333333333333,2,2,TTTTGTCGGTGTCTCCAAGG,0,5049179
ykgRp,0.3333333333333333,2,2,TTTTGGATGGGGTAGATGCA,0,5032375
ykgRp,0.3333333333333333,2,2,TTTTCCTCAGAAGCAACTGT,0,5031853
ykgRp,0.3333333333333333,2,2,TTTTACCTGAGTTTCTATCC,0,5043040
ykgRp,0.3333333333333333,2,2,TTTGGGTTTAGCTTTTATAC,0,5055746
ykgRp,0.3333333333333333,2,2,TTTGGAAAGTTACATATGAC,0,5041064
ykgRp,0.3333333333333333,2,2,TTTCTTCGTTGAGGCAAGGC,0,5052855
ykgRp,0.3333333333333333,2,2,TTTCTGTGGGCGTTGGTAAC,0,5036771
ykgRp,0.3333333333333333,2,2,TTTCGGGGCCAGAGGTATCC,0,5052327
ykgRp,0.3333333333333333,2,2,TTTCGCACGCATGAAACGCA,0,5044496
ykgRp,0.3333333333333333,2,2,TTTCCCGAGGTCTTTCCTTT,0,5036740
ykgRp,0.3333333333333333,2,2,TTTCCCATGAGCAGGATGTG,0,5059876
ykgRp,0.3333333333333333,2,2,TTTAGTAATAACCTTGCTTA,0,5036955
ykgRp,0.3333333333333333,2,2,TTTAGCGCCAATGCTCGTAC,0,5046038
ykgRp,0.3333333333333333,2,2,TTTAGAATTCGCTCCCGACC,0,5055119
ykgRp,0.3333333333333333,2,2,TTTACTTACAAGTATGCGGC,0,5059218
ykgRp,0.3333333333333333,2,2,TTTACCGATTAGCGCGTGGT,0,5048529
ykgRp,0.3333333333333333,2,2,TTGTGTGTCAGTAACTCTAC,0,5033397
ykgRp,0.3333333333333333,2,2,TTGTGGCCTGATCACCGACG,0,5053578
ykgRp,0.3333333333333333,2,2,TTGTCGTTATTGGAGCAACA,0,5032377
ykgRp,0.3333333333333333,2,2,TTGTCGGTTTCTTCTGCGAT,0,5033148
ykgRp,0.3333333333333333,2,2,TTGTCCCTAGAAACGCCTAT,0,5039319
ykgRp,0.3333333333333333,2,2,TTGTCCAGCAGCGGCGCGTA,0,5037432
ykgRp,0.3333333333333333,2,2,TTGTCCACTGAAGTATACGC,0,5045151
ykgRp,0.3333333333333333,2,2,TTGTATGGCCTCACATGGAT,0,5032379
ykgRp,0.3333333333333333,2,2,TTGTACAGAATCACTATTTA,0,5048776
ykgRp,0.3333333333333333,2,2,TTGGTCACGATCAGGGTATG,0,5039813
ykgRp,0.3333333333333333,2,2,TTGCTTGCGCCAGTTTATTT,0,5046882
ykgRp,0.3333333333333333,2,2,TTGCTGCCGCTAATTGCGTG,0,5039985
ykgRp,0.3333333333333333,2,2,TTGCGGAACCTTGACTACGT,0,5059802
ykgRp,0.3333333333333333,2,2,TTGCGCTATATGAAGGCCTC,0,5046645
ykgRp,0.3333333333333333,2,2,TTGCATCCTATCCCTGGATA,0,5049316
ykgRp,0.3333333333333333,2,2,TTGATAATGTTCAGCAAAGA,0,5060693
ykgRp,0.3333333333333333,2,2,TTGAGTTTCTGGGATGATGA,0,5031792
ykgRp,0.3333333333333333,2,2,TTGAGCCGCTCGGGGACCTG,0,5035117
ykgRp,0.3333333333333333,2,2,TTGACTGGAATCTATAACGT,0,5055593
ykgRp,0.3333333333333333,2,2,TTGAAGGGGTGGAGGTTAAA,0,5057755
ykgRp,0.3333333333333333,2,2,TTGAAGAACGGCCTCGACAC,0,5039134
ykgRp,0.3333333333333333,2,2,TTCTTAGGCGCTAGAACAGT,0,5056717
ykgRp,0.3333333333333333,2,2,TTCTGGTTTCCCCAAAACTA,0,5056751
ykgRp,0.3333333333333333,2,2,TTCTCGTCGCAAGTGACCAG,0,5059433
ykgRp,0.3333333333333333,2,2,TTCGTTGAAATATAGAGATT,0,5043045
ykgRp,0.3333333333333333,2,2,TTCGTGTCATCTCCTGAAGC,0,5044168
ykgRp,0.3333333333333333,2,2,TTCGTGGATCCGTCTCTCGC,0,5039599
ykgRp,0.3333333333333333,2,2,TTCGTCACCGAGCATAGGAA,0,5060487
ykgRp,0.3333333333333333,2,2,TTCGGTGTTTCCTGATATTC,0,5060858
ykgRp,0.3333333333333333,2,2,TTCGATGCCGACCGTGATTA,0,5051830
ykgRp,0.3333333333333333,2,2,TTCGACACATAAAACGTACG,0,5054542
ykgRp,0.3333333333333333,2,2,TTCCCAGGGCTGTTTGCTAC,0,5049628
ykgRp,0.3333333333333333,2,2,TTCCAGTGAGTAGTACGGCC,0,5055281
ykgRp,0.3333333333333333,2,2,TTCCAGGGGCACGAGCCTAC,0,5034271
ykgRp,0.3333333333333333,2,2,TTCATGAATTCGGTGTATTA,0,5042558
ykgRp,0.3333333333333333,2,2,TTCATCTCAGAAGTCTTCCC,0,5045955
ykgRp,0.3333333333333333,2,2,TTCACAATCCTGGTCTTTTG,0,5035287
ykgRp,0.3333333333333333,2,2,TTATTTGTTGCTTAGTAGTC,0,5038334
ykgRp,0.3333333333333333,2,2,TTATTTCGCCTCCCCACGGC,0,5056042
ykgRp,0.3333333333333333,2,2,TTATTGCCGGCACATAAATA,0,5034653
ykgRp,0.3333333333333333,2,2,TTATCACAGCGTGGGATATT,0,5054353
ykgRp,0.3333333333333333,2,2,TTAGGGAGCCTATACCGTTC,0,5043663
ykgRp,0.3333333333333333,2,2,TTAGGCAGTTCCTTCACATA,0,5044195
ykgRp,0.3333333333333333,2,2,TTAGATTTAAACCGGGGCGG,0,5055138
ykgRp,0.3333333333333333,2,2,TTAGATGGGTCTTACTTGGG,0,5036117
ykgRp,0.3333333333333333,2,2,TTAGACGGTATCGTGTCTCA,0,5054343
ykgRp,0.3333333333333333,2,2,TTAGACCGAACTGCGAGCTA,0,5052315
ykgRp,0.3333333333333333,2,2,TTACGGGACCGTGGGAACGT,0,5053969
ykgRp,0.3333333333333333,2,2,TTACGCCACTGCGCTTATAA,0,5047768
ykgRp,0.3333333333333333,2,2,TTACGCAGGTGTCAGGAGCG,0,5037592
ykgRp,0.3333333333333333,2,2,TTACATAGATGAATGTTCCG,0,5055392
ykgRp,0.3333333333333333,2,2,TTACAAGGGATGCCCGCCGT,0,5048412
ykgRp,0.3333333333333333,2,2,TTACAAACTTGCCGGACGAG,0,5054932
ykgRp,0.3333333333333333,2,2,TTAATAGCCTGCAACGTAGT,0,5045596
ykgRp,0.3333333333333333,2,2,TTAAGCGCATTATAACATCA,0,5046539
ykgRp,0.3333333333333333,2,2,TTAACTAAGAAGACGTGAGA,0,5056479
ykgRp,0.3333333333333333,2,2,TTAACGCCTACGCTCCGGCT,0,5048390
ykgRp,0.3333333333333333,2,2,TGTTTTCCCGCGTTATGATA,0,5054383
ykgRp,0.3333333333333333,2,2,TGTTCTCGAAGGAGCCCGAC,0,5060946
ykgRp,0.3333333333333333,2,2,TGTTCGCGTATGTCAAAAGA,0,5043186
ykgRp,0.3333333333333333,2,2,TGTTCCACGGCAGGATTGAA,0,5046735
ykgRp,0.3333333333333333,2,2,TGTTATGTTCGAATAAGGTC,0,5061594
ykgRp,0.3333333333333333,2,2,TGTTACAAGGGCGTGAACTC,0,5059488
ykgRp,0.3333333333333333,2,2,TGTGTTTTGCTCTGGGCACG,0,5053990
ykgRp,0.3333333333333333,2,2,TGTGTTACTTTTACTTAATC,0,5055027
ykgRp,0.3333333333333333,2,2,TGTGTAGGGAAGGCTGAGTT,0,5045833
ykgRp,0.3333333333333333,2,2,TGTGCGCAGTGCCATGCGGT,0,5049515
ykgRp,0.3333333333333333,2,2,TGTCTAGCGGTCAATCCCCT,0,5052221
ykgRp,0.3333333333333333,2,2,TGTCTACTGGAGCACTCGCG,0,5055047
ykgRp,0.3333333333333333,2,2,TGTAGTCTTAAAGAAAAACA,0,5045320
ykgRp,0.3333333333333333,2,2,TGTAGTACTTGAAGGTGTAT,0,5032163
ykgRp,0.3333333333333333,2,2,TGTAGGTTCGGTGAGACCAT,0,5045590
ykgRp,0.3333333333333333,2,2,TGTAGCATTAACAGGACTTC,0,5056761
ykgRp,0.3333333333333333,2,2,TGTACGGTGATGACCCGGCA,0,5052852
ykgRp,0.3333333333333333,2,2,TGTACAAAACGGTAGAGTAT,0,5054769
ykgRp,0.3333333333333333,2,2,TGTAACTAGTTTTGTAATTA,0,5057107
ykgRp,0.3333333333333333,2,2,TGGTTGGCTGGTAGCGCAGT,0,5052642
ykgRp,0.3333333333333333,2,2,TGGTGCTGTACGCTGGACAG,0,5034483
ykgRp,0.3333333333333333,2,2,TGGTCCGCCTACTAACATGG,0,5053297
ykgRp,0.3333333333333333,2,2,TGGGTCTAGGATTAACTGAT,0,5044880
ykgRp,0.3333333333333333,2,2,TGGGTCCAATTACCACCCCT,0,5049886
ykgRp,0.3333333333333333,2,2,TGGGTAGAACCCAATACGGG,0,5054750
ykgRp,0.3333333333333333,2,2,TGGGCATTCCCAGACCAAAA,0,5052537
ykgRp,0.3333333333333333,2,2,TGGGCAAACAACACACGTGG,0,5037111
ykgRp,0.3333333333333333,2,2,TGGGAGAGATCGCGCCACTC,0,5059996
ykgRp,0.3333333333333333,2,2,TGGGACACTTATTCCGCGTG,0,5036896
ykgRp,0.3333333333333333,2,2,TGGCTGGCAGCCTCCAGGGC,0,5057023
ykgRp,0.3333333333333333,2,2,TGGCTGCCAGAGATAAGCGT,0,5057627
ykgRp,0.3333333333333333,2,2,TGGCGTGATGTGCTAGGGCA,0,5053913
ykgRp,0.3333333333333333,2,2,TGGCGGCCACGTTGACTCCT,0,5041619
ykgRp,0.3333333333333333,2,2,TGGCGAAAGACGCGCTATTG,0,5042202
ykgRp,0.3333333333333333,2,2,TGGCCAAAGATTTAGAACAA,0,5033967
ykgRp,0.3333333333333333,2,2,TGGCAGATTGGTTCGGTTCT,0,5037485
ykgRp,0.3333333333333333,2,2,TGGCACAAAATGGCGAATCT,0,5054189
ykgRp,0.3333333333333333,2,2,TGGATTATGCGCAACGTCTT,0,5035033
ykgRp,0.3333333333333333,2,2,TGGATCACTGAGGCGATCGG,0,5037316
ykgRp,0.3333333333333333,2,2,TGGAGGAGCCTACTGATACG,0,5060266
ykgRp,0.3333333333333333,2,2,TGGAGATGGGTCTCAGATTA,0,5056105
ykgRp,0.3333333333333333,2,2,TGGACTGACCCCCGGTGACC,0,5044448
ykgRp,0.3333333333333333,2,2,TGGACCTCGAGTGAACGATG,0,5050713
ykgRp,0.3333333333333333,2,2,TGGAAGTAAATGTATTGGAA,0,5039378
ykgRp,0.3333333333333333,2,2,TGGAACTGCCCGCGGATCAT,0,5041697
ykgRp,0.3333333333333333,2,2,TGGAACGCGAAGGGGGGGTG,0,5061323
ykgRp,0.3333333333333333,2,2,TGCTTGCCAAGAATACACGA,0,5056137
ykgRp,0.3333333333333333,2,2,TGCGCCCCGGAGGGAATATA,0,5041250
ykgRp,0.3333333333333333,2,2,TGCCTTCTTGACGGCCGACA,0,5034671
ykgRp,0.3333333333333333,2,2,TGCCCTTCGACGGCTGTTAC,0,5053651
ykgRp,0.3333333333333333,2,2,TGCCAGCTCGAACTCCCCTG,0,5041615
ykgRp,0.3333333333333333,2,2,TGCAGCATCCGTTTTTAACG,0,5050194
ykgRp,0.3333333333333333,2,2,TGCAATATACGCTGTTCGTA,0,5053135
ykgRp,0.3333333333333333,2,2,TGCAAAGTATTGACCTGGAG,0,5055793
ykgRp,0.3333333333333333,2,2,TGATGTCGTGCGGCGAATAA,0,5058594
ykgRp,0.3333333333333333,2,2,TGATGGCTACTTAGGGTACA,0,5056798
ykgRp,0.3333333333333333,2,2,TGAGTAAGGTGTAGCTTGGT,0,5051574
ykgRp,0.3333333333333333,2,2,TGAGGCTTCCTTGATAATCA,0,5043210
ykgRp,0.3333333333333333,2,2,TGAGAATACGTGTTGTATCC,0,5036213
ykgRp,0.3333333333333333,2,2,TGACGCTGCGGATAGCCTTG,0,5052579
ykgRp,0.3333333333333333,2,2,TGACGCAGGGGGGGTGGCGC,0,5035820
ykgRp,0.3333333333333333,2,2,TGACCTTCGTATTCATTGTG,0,5045376
ykgRp,0.3333333333333333,2,2,TGACAGCTACAAGTTGCGAC,0,5041343
ykgRp,0.3333333333333333,2,2,TGAATTCATACACTTATTGT,0,5037630
ykgRp,0.3333333333333333,2,2,TGAATAAGCCTAGAGGTTAA,0,5035172
ykgRp,0.3333333333333333,2,2,TGAAGGTTTAAATTTACATC,0,5051039
ykgRp,0.3333333333333333,2,2,TGAAGCTCCCTTGTTCATAA,0,5046027
ykgRp,0.3333333333333333,2,2,TGAACGCGGACCGCAGCGTA,0,5036739
ykgRp,0.3333333333333333,2,2,TGAAAGTAATGTAGCCAATT,0,5036113
ykgRp,0.3333333333333333,2,2,TGAAAGAAGGGACTGCTAGA,0,5050257
ykgRp,0.3333333333333333,2,2,TCTTTTTAATGTGTTTCGGC,0,5038634
ykgRp,0.3333333333333333,2,2,TCTTTTGAGGGCATGCCCTT,0,5053555
ykgRp,0.3333333333333333,2,2,TCTTCCGACGTGGGCCTACC,0,5033439
ykgRp,0.3333333333333333,2,2,TCTTAATTTTAACACAAAGG,0,5046807
ykgRp,0.3333333333333333,2,2,TCTTAAAAAACGGTCTCGAG,0,5036522
ykgRp,0.3333333333333333,2,2,TCTGGTCGTTAGCCTGCAAT,0,5053629
ykgRp,0.3333333333333333,2,2,TCTGGGTGGTAACGGAGCGA,0,5033805
ykgRp,0.3333333333333333,2,2,TCTGCTCTTTGGCAGAACGC,0,5057013
ykgRp,0.3333333333333333,2,2,TCTGCAGACGGGCGGAAGAG,0,5043555
ykgRp,0.3333333333333333,2,2,TCTGATGCACTGTAAATAAT,0,5054219
ykgRp,0.3333333333333333,2,2,TCTCGGCGATTTTTTACTAT,0,5050785
ykgRp,0.3333333333333333,2,2,TCTCACAATCCGGTGGCGGT,0,5051190
ykgRp,0.3333333333333333,2,2,TCTAGTTCTTACTGTGCTAG,0,5035933
ykgRp,0.3333333333333333,2,2,TCTAGTAGCTAGCACAGAAA,0,5045757
ykgRp,0.3333333333333333,2,2,TCTAGAAGTCCAACTCTTTA,0,5060471
ykgRp,0.3333333333333333,2,2,TCTACAGGTCTTGGAAATGC,0,5038906
ykgRp,0.3333333333333333,2,2,TCTAACGTTCCATTGCAATG,0,5055063
ykgRp,0.3333333333333333,2,2,TCTAACCAAGGCTTATCGTT,0,5032165
ykgRp,0.3333333333333333,2,2,TCGTTTTCCCAGGCAAGACG,0,5042513
ykgRp,0.3333333333333333,2,2,TCGTTTCGAGGACGTTGTAA,0,5056535
ykgRp,0.3333333333333333,2,2,TCGTTACACCATCCAGATGT,0,5049562
ykgRp,0.3333333333333333,2,2,TCGTCCCGTCCGCTCGCAAT,0,5035088
ykgRp,0.3333333333333333,2,2,TCGTAGTCTTGGACCCTGCC,0,5049107
ykgRp,0.3333333333333333,2,2,TCGTAACAATACGCACTCAT,0,5056976
ykgRp,0.3333333333333333,2,2,TCGGTTCGCGGGATTTGCGT,0,5050767
ykgRp,0.3333333333333333,2,2,TCGGGGGAGTAACACATAGG,0,5046402
ykgRp,0.3333333333333333,2,2,TCGGGGACGGAATCGGTTAG,0,5031615
ykgRp,0.3333333333333333,2,2,TCGGGAAGGCAAAAGATTGA,0,5050795
ykgRp,0.3333333333333333,2,2,TCGGCCCAAGTCACAAAGAT,0,5039744
ykgRp,0.3333333333333333,2,2,TCGGATTAGAACGTGTTGTA,0,5039429
ykgRp,0.3333333333333333,2,2,TCGGATGCGCCTTGTAGTAC,0,5039699
ykgRp,0.3333333333333333,2,2,TCGGAAACGTTGACCGAGGA,0,5049623
ykgRp,0.3333333333333333,2,2,TCGCTGGACATCTAACCCAT,0,5036891
ykgRp,0.3333333333333333,2,2,TCGCGTGTGACCGTGTATCT,0,5033837
ykgRp,0.3333333333333333,2,2,TCGCGGTGGTCCCCGACACA,0,5033482
ykgRp,0.3333333333333333,2,2,TCGCGCCTTACATGGCCAAC,0,5052492
ykgRp,0.3333333333333333,2,2,TCGCGAGTTTCAATCCTACC,0,5058784
ykgRp,0.3333333333333333,2,2,TCGCATTTGAGGGCACAGCA,0,5042883
ykgRp,0.3333333333333333,2,2,TCGCATGGGGCTACCAATGG,0,5052661
ykgRp,0.3333333333333333,2,2,TCGATGGAATGCATCGTAAG,0,5055549
ykgRp,0.3333333333333333,2,2,TCGATCGCGTTCCATCTGTT,0,5056587
ykgRp,0.3333333333333333,2,2,TCGATAGTGGAATGGGTATG,0,5039544
ykgRp,0.3333333333333333,2,2,TCGAGCAAGCGCCAAGGACT,0,5054833
ykgRp,0.3333333333333333,2,2,TCGACTTGCTGGTATGGAGC,0,5050474
ykgRp,0.3333333333333333,2,2,TCGACACGCACTAAAGGCCT,0,5058807
ykgRp,0.3333333333333333,2,2,TCGAAGTCATTGTACTGTTT,0,5058422
ykgRp,0.3333333333333333,2,2,TCGAAGCGTGCTGCACCGCT,0,5053949
ykgRp,0.3333333333333333,2,2,TCGAAAGTTCAGGAACTCCA,0,5045762
ykgRp,0.3333333333333333,2,2,TCGAAAGTTCAAGGAATTTT,0,5057751
ykgRp,0.3333333333333333,2,2,TCCTTTTGATCGACGCTAGG,0,5036348
ykgRp,0.3333333333333333,2,2,TCCCCCCGCAGTTATCGTAA,0,5058766
ykgRp,0.3333333333333333,2,2,TCCCAAGTCTGTGCCCAGTT,0,5057301
ykgRp,0.3333333333333333,2,2,TCCATGAGGTGAAGACGATT,0,5044196
ykgRp,0.3333333333333333,2,2,TCCATCGCAGGGATACTCTC,0,5056355
ykgRp,0.3333333333333333,2,2,TCCAGCGGGGTGAACTTGAT,0,5045770
ykgRp,0.3333333333333333,2,2,TCCAATCCTAGAGGTTAAGG,0,5047218
ykgRp,0.3333333333333333,2,2,TCCAAACAGCAACGTGGAAC,0,5042862
ykgRp,0.3333333333333333,2,2,TCATGAGCGTTAATCATAGT,0,5061003
ykgRp,0.3333333333333333,2,2,TCATCTTTGCTAGTCACCCG,0,5056569
ykgRp,0.3333333333333333,2,2,TCATCCTACCCATATGTGCC,0,5039876
ykgRp,0.3333333333333333,2,2,TCATATTGTCGATTCTCTTC,0,5032975
ykgRp,0.3333333333333333,2,2,TCATAGCCTGTTCCGACAAT,0,5050428
ykgRp,0.3333333333333333,2,2,TCATACCAGGCTTTCATTGC,0,5059888
ykgRp,0.3333333333333333,2,2,TCATAACCATAGCTGTCAGG,0,5056440
ykgRp,0.3333333333333333,2,2,TCAGGCCTTGCTAACACCGG,0,5055967
ykgRp,0.3333333333333333,2,2,TCAGGCCGGGCCAGGGGCTT,0,5058162
ykgRp,0.3333333333333333,2,2,TCAGGATCCGGCTCGTTACT,0,5039915
ykgRp,0.3333333333333333,2,2,TCAGCTATGAAGAAATACTA,0,5035029
ykgRp,0.3333333333333333,2,2,TCAGCGACTGTCCGTTCAAG,0,5044069
ykgRp,0.3333333333333333,2,2,TCAGAAGGGGTATGTAGTAA,0,5058650
ykgRp,0.3333333333333333,2,2,TCACGGAGGCGTTTGTTGGG,0,5038759
ykgRp,0.3333333333333333,2,2,TCACGCAACCGCATTAGAAT,0,5031949
ykgRp,0.3333333333333333,2,2,TCACCCGCAACAGTCTGTTC,0,5045116
ykgRp,0.3333333333333333,2,2,TCACAGCCTAAGATATCCCT,0,5050237
ykgRp,0.3333333333333333,2,2,TCACAACGCAGATAGTACTG,0,5039636
ykgRp,0.3333333333333333,2,2,TCAAGGGCAATTCGGGGGGT,0,5040820
ykgRp,0.3333333333333333,2,2,TCAAGGATAGTCCGGTTTTA,0,5041245
ykgRp,0.3333333333333333,2,2,TCAACGTAGATCCCAGTAAG,0,5042515
ykgRp,0.3333333333333333,2,2,TATTGAGGTCTCGTAGAAAC,0,5053356
ykgRp,0.3333333333333333,2,2,TATTCCAGAAAAGCCACCAA,0,5055343
ykgRp,0.3333333333333333,2,2,TATTACCCTGGCGGATAAAG,0,5057077
ykgRp,0.3333333333333333,2,2,TATGCTTGGTGGTTCTTAAG,0,5058787
ykgRp,0.3333333333333333,2,2,TATGCTGGGGCCATTTATGC,0,5046461
ykgRp,0.3333333333333333,2,2,TATGCTGGAACAGTTAAGGA,0,5038068
ykgRp,0.3333333333333333,2,2,TATGCGTGTCACCGGGTAGG,0,5035641
ykgRp,0.3333333333333333,2,2,TATGCACACGTCTTATCAGA,0,5047046
ykgRp,0.3333333333333333,2,2,TATGAGCCACCCTTTACACG,0,5038773
ykgRp,0.3333333333333333,2,2,TATGAGATGGAATCGAAGCG,0,5042372
ykgRp,0.3333333333333333,2,2,TATGAGACGAAACTATCCCA,0,5039700
ykgRp,0.3333333333333333,2,2,TATGACGGGTGGTCAAAGAG,0,5051468
ykgRp,0.3333333333333333,2,2,TATCCGTTTTGTCATCCGTG,0,5054905
ykgRp,0.3333333333333333,2,2,TATCCGTCGCTGCAAGCCCT,0,5060574
ykgRp,0.3333333333333333,2,2,TATCCCAGGGAAACATGTTA,0,5033124
ykgRp,0.3333333333333333,2,2,TATCCAGGACTCGATTTATT,0,5044034
ykgRp,0.3333333333333333,2,2,TATATCCAGAAGCAAAGGGC,0,5044846
ykgRp,0.3333333333333333,2,2,TATAGATATTATTGCTAGGA,0,5061248
ykgRp,0.3333333333333333,2,2,TATAGAGACGAGGCATTCAT,0,5040287
ykgRp,0.3333333333333333,2,2,TATAGAACGGAGTAGACGGT,0,5037172
ykgRp,0.3333333333333333,2,2,TATACGTTTGGCCTAACTGA,0,5056310
ykgRp,0.3333333333333333,2,2,TATAAGAATGGATTCGACAC,0,5055121
ykgRp,0.3333333333333333,2,2,TATAAACCTAGTAAGTTTCA,0,5051682
ykgRp,0.3333333333333333,2,2,TAGTTGTGAAAATTTGTGCT,0,5033526
ykgRp,0.3333333333333333,2,2,TAGTGGATCGGAATGCCTTA,0,5051666
ykgRp,0.3333333333333333,2,2,TAGTGACAAAACCAAAAGAT,0,5031507
ykgRp,0.3333333333333333,2,2,TAGGGGGTCACCCGGTTAAT,0,5049395
ykgRp,0.3333333333333333,2,2,TAGGACGCACACATTTTTGG,0,5047606
ykgRp,0.3333333333333333,2,2,TAGGAACCGCGATCAATCCG,0,5032466
ykgRp,0.3333333333333333,2,2,TAGCTGACCTACTAAAATCC,0,5049088
ykgRp,0.3333333333333333,2,2,TAGCTCATGGAGCCGGATTC,0,5055628
ykgRp,0.3333333333333333,2,2,TAGCGAGTGCTCTTTCTCTG,0,5060469
ykgRp,0.3333333333333333,2,2,TAGCACAGTGTAAGTAAAAG,0,5041276
ykgRp,0.3333333333333333,2,2,TAGATTGGAGGCGGAGGCTC,0,5047990
ykgRp,0.3333333333333333,2,2,TAGATAGTTTGGTGGTGCCT,0,5056707
ykgRp,0.3333333333333333,2,2,TAGAGCCGCATCTAACTAGG,0,5042424
ykgRp,0.3333333333333333,2,2,TAGAATCTGGAGCGTACTTG,0,5041599
ykgRp,0.3333333333333333,2,2,TACTTGCATTATCAAGCACA,0,5054775
ykgRp,0.3333333333333333,2,2,TACTGTTATGGACCTGGCTT,0,5035785
ykgRp,0.3333333333333333,2,2,TACTGGTACCCATGTGCATC,0,5057109
ykgRp,0.3333333333333333,2,2,TACTGGCACACTTAGGGACA,0,5034710
ykgRp,0.3333333333333333,2,2,TACGTAGCCCTATTAGGTAC,0,5039501
ykgRp,0.3333333333333333,2,2,TACCTGGTGGTCATGCGTTC,0,5036131
ykgRp,0.3333333333333333,2,2,TACCGACTCTCAAGTTTGCA,0,5059003
ykgRp,0.3333333333333333,2,2,TACCATGTGCCTCCAGTAAC,0,5036258
ykgRp,0.3333333333333333,2,2,TACCATAGCAATCCTAACAG,0,5058570
ykgRp,0.3333333333333333,2,2,TACCACGCTTGCGGCCCGGC,0,5058390
ykgRp,0.3333333333333333,2,2,TACCACACCGTTATTCGACC,0,5042347
ykgRp,0.3333333333333333,2,2,TACCAATTTCAAGTAGTAAT,0,5033230
ykgRp,0.3333333333333333,2,2,TACAGTAGACCGATCCGCGA,0,5035258
ykgRp,0.3333333333333333,2,2,TACAATGTACTGTCCATGTA,0,5047950
ykgRp,0.3333333333333333,2,2,TACAACTTATTAGTCGATAC,0,5055485
ykgRp,0.3333333333333333,2,2,TAATTGTTGATGCTTCAGTG,0,5046288
ykgRp,0.3333333333333333,2,2,TAATGGCCCATCTATGCTAC,0,5049028
ykgRp,0.3333333333333333,2,2,TAATCATCAGTGCCTAGCAC,0,5045224
ykgRp,0.3333333333333333,2,2,TAATATGGAATTCAACACGT,0,5042019
ykgRp,0.3333333333333333,2,2,TAAGTTATTCAGGGCAGACC,0,5049676
ykgRp,0.3333333333333333,2,2,TAAGTATTGGCACAGCTGGT,0,5033653
ykgRp,0.3333333333333333,2,2,TAAGGCCGATATCCAACTAC,0,5049713
ykgRp,0.3333333333333333,2,2,TAAGGACTGCCCCACTTGAA,0,5050542
ykgRp,0.3333333333333333,2,2,TAAGCCCCGGGACTAGCTCG,0,5038168
ykgRp,0.3333333333333333,2,2,TAAGAATGTATGTCTTCTCG,0,5040715
ykgRp,0.3333333333333333,2,2,TAACGCGAAAGGTCCAAAGG,0,5032073
ykgRp,0.3333333333333333,2,2,TAACCTCAGCGCCCGGAAGA,0,5053335
ykgRp,0.3333333333333333,2,2,TAACACAAGTCCAACTACCA,0,5055082
ykgRp,0.3333333333333333,2,2,TAACAATCCACTGGGGATCG,0,5047938
ykgRp,0.3333333333333333,2,2,TAAATCCGTTGTGCAGTTTC,0,5045458
ykgRp,0.3333333333333333,2,2,GTTTTTCTACATTGGACCTT,0,5051280
ykgRp,0.3333333333333333,2,2,GTTTTATCCCTCGACGGAGC,0,5032680
ykgRp,0.3333333333333333,2,2,GTTTGTAAGCCATGCCGGTC,0,5037811
ykgRp,0.3333333333333333,2,2,GTTTACAATGTTCAAAGGCT,0,5045735
ykgRp,0.3333333333333333,2,2,GTTTAAGTAGCGGATATCAT,0,5056293
ykgRp,0.3333333333333333,2,2,GTTGGGTCAGGTAGCGTTCT,0,5031844
ykgRp,0.3333333333333333,2,2,GTTGGGTCAGCATGCTTGCA,0,5058399
ykgRp,0.3333333333333333,2,2,GTTGCGGCTATCCGCACCTA,0,5041495
ykgRp,0.3333333333333333,2,2,GTTGCAACGCCTCCGATCGA,0,5032262
ykgRp,0.3333333333333333,2,2,GTTGACTCAGTGTACAACTA,0,5033229
ykgRp,0.3333333333333333,2,2,GTTCTCTCATCATGGTGTTT,0,5038439
ykgRp,0.3333333333333333,2,2,GTTCGTCGTAGCAGCCTGGT,0,5031692
ykgRp,0.3333333333333333,2,2,GTTCGTCAGACTACCTGCAG,0,5040201
ykgRp,0.3333333333333333,2,2,GTTCCTCGGATCAGTTGTTT,0,5042571
ykgRp,0.3333333333333333,2,2,GTTCAGATCCTATAGAAGGA,0,5047219
ykgRp,0.3333333333333333,2,2,GTTACTGGGGCGAATCTATA,0,5034405
ykgRp,0.3333333333333333,2,2,GTTACCCACCGTCTGACATA,0,5055613
ykgRp,0.3333333333333333,2,2,GTTACAGGTGCACGGATCAA,0,5043956
ykgRp,0.3333333333333333,2,2,GTTAATAGCGCAAACCAGCT,0,5048540
ykgRp,0.3333333333333333,2,2,GTGTTGTAGGGGACTAAAAC,0,5038379
ykgRp,0.3333333333333333,2,2,GTGTTAAGCTTTACTCGTTA,0,5038478
ykgRp,0.3333333333333333,2,2,GTGTGACCAATCGGTCATGC,0,5037610
ykgRp,0.3333333333333333,2,2,GTGTCCCAGTTTGTTCACTG,0,5047363
ykgRp,0.3333333333333333,2,2,GTGTCACGGTTGATCGCTGA,0,5053328
ykgRp,0.3333333333333333,2,2,GTGTCACCGAGCGATTGAGT,0,5046047
ykgRp,0.3333333333333333,2,2,GTGGTGGAGGAGGTCAGTAA,0,5055299
ykgRp,0.3333333333333333,2,2,GTGGGTAGAGTACTACTCTA,0,5042402
ykgRp,0.3333333333333333,2,2,GTGGCTTGTCAACCGGATTT,0,5033300
ykgRp,0.3333333333333333,2,2,GTGGCGGGCTGAACATGGAA,0,5039371
ykgRp,0.3333333333333333,2,2,GTGGCGACTTCAAATTTACA,0,5054356
ykgRp,0.3333333333333333,2,2,GTGGCCTTGGCGGAGCGGTG,0,5040765
ykgRp,0.3333333333333333,2,2,GTGGCAACCTATTCAACCAA,0,5045689
ykgRp,0.3333333333333333,2,2,GTGCTCCCAGCCTCAATTTG,0,5051450
ykgRp,0.3333333333333333,2,2,GTGCTCAACTTTGGACAGCT,0,5041836
ykgRp,0.3333333333333333,2,2,GTGCCGCGACCCATTTTTTT,0,5049549
ykgRp,0.3333333333333333,2,2,GTGAGTACATGCAAGAACGC,0,5034583
ykgRp,0.3333333333333333,2,2,GTGAGGATGGCTATCTAGTT,0,5049815
ykgRp,0.3333333333333333,2,2,GTGACAGCTGGCTATATTAT,0,5053138
ykgRp,0.3333333333333333,2,2,GTGACAGCACTCGCTTGTAA,0,5044469
ykgRp,0.3333333333333333,2,2,GTCTTGTCAGTCACGTACAA,0,5053451
ykgRp,0.3333333333333333,2,2,GTCTTCCTTCTATGAATTCC,0,5049847
ykgRp,0.3333333333333333,2,2,GTCTTCAGCCGGGTTGTGAG,0,5046156
ykgRp,0.3333333333333333,2,2,GTCTGTATCGTCGGGCATGG,0,5034162
ykgRp,0.3333333333333333,2,2,GTCTGGTATCGCAATGGAGT,0,5056543
ykgRp,0.3333333333333333,2,2,GTCTGCTTCCGAAAGAACTG,0,5054710
ykgRp,0.3333333333333333,2,2,GTCTGCTCGCATGATGACGG,0,5049043
ykgRp,0.3333333333333333,2,2,GTCTCGGATTTGGGTGGAAA,0,5046582
ykgRp,0.3333333333333333,2,2,GTCTATGTTGAGGGGTTAAG,0,5041602
ykgRp,0.3333333333333333,2,2,GTCTAAGGGTGCCACTGCGT,0,5061276
ykgRp,0.3333333333333333,2,2,GTCGTGCATCGGCATTGACC,0,5033345
ykgRp,0.3333333333333333,2,2,GTCGGTAGTAACCCAGGCTA,0,5051529
ykgRp,0.3333333333333333,2,2,GTCGGGCGCATAGCTATGGG,0,5036750
ykgRp,0.3333333333333333,2,2,GTCGGCTTAGGAACCGATAG,0,5054326
ykgRp,0.3333333333333333,2,2,GTCGGAGTCAAGAAACAGTG,0,5052430
ykgRp,0.3333333333333333,2,2,GTCGCGTCGCCCGCGAATCC,0,5058988
ykgRp,0.3333333333333333,2,2,GTCGCCATACGCAACCCATT,0,5060889
ykgRp,0.3333333333333333,2,2,GTCGATGGATGAGGTGGACT,0,5046211
ykgRp,0.3333333333333333,2,2,GTCCTGGGCCAGACGGCCCA,0,5054823
ykgRp,0.3333333333333333,2,2,GTCCGTCAATAAGAAAGAGT,0,5039194
ykgRp,0.3333333333333333,2,2,GTCCGGTATCACGCCTACAC,0,5058631
ykgRp,0.3333333333333333,2,2,GTCCGGCTCAATCTTTCGGC,0,5048093
ykgRp,0.3333333333333333,2,2,GTCCGCCTCCGTGCTCCTGC,0,5046121
ykgRp,0.3333333333333333,2,2,GTCCCGGCCGACTGTCAAAA,0,5039459
ykgRp,0.3333333333333333,2,2,GTCCCCGTTCGGAGAGCAGA,0,5031740
ykgRp,0.3333333333333333,2,2,GTCATCGCTGGCGGGTCGGA,0,5048766
ykgRp,0.3333333333333333,2,2,GTCATCCAACGGTTAACGGC,0,5032336
ykgRp,0.3333333333333333,2,2,GTCAGAATTGTAGCCGTAAA,0,5036446
ykgRp,0.3333333333333333,2,2,GTCACTTGCGACGTATTACA,0,5036605
ykgRp,0.3333333333333333,2,2,GTCAATACGCCACCACATGA,0,5045205
ykgRp,0.3333333333333333,2,2,GTCAACCTGTGAGTACTAGA,0,5058813
ykgRp,0.3333333333333333,2,2,GTATGACGATAGCGTCGAGC,0,5046947
ykgRp,0.3333333333333333,2,2,GTATCGGAAACCCACAGTCT,0,5037527
ykgRp,0.3333333333333333,2,2,GTATCAGGCCGAAGGGGAAC,0,5054173
ykgRp,0.3333333333333333,2,2,GTATAACAAGAACATTCTTA,0,5037222
ykgRp,0.3333333333333333,2,2,GTAGGATCCCTCGAGTCTAA,0,5033607
ykgRp,0.3333333333333333,2,2,GTAGCTATACTGCTTGATTT,0,5035890
ykgRp,0.3333333333333333,2,2,GTACTTCATTCTTTCAGGTC,0,5055604
ykgRp,0.3333333333333333,2,2,GTACCCACCTGGCTAGATGC,0,5031934
ykgRp,0.3333333333333333,2,2,GTACAACGCCCGCCCTTATT,0,5044948
ykgRp,0.3333333333333333,2,2,GTAATGGTCACTCTTTTGTA,0,5043330
ykgRp,0.3333333333333333,2,2,GTAAGCCCATACAGGTGTAA,0,5047193
ykgRp,0.3333333333333333,2,2,GTAAGAGTTCCGGTGACAAC,0,5045764
ykgRp,0.3333333333333333,2,2,GTAAGAATTAAGATGCACGT,0,5032344
ykgRp,0.3333333333333333,2,2,GTAACGTGTTTAAAGCGTTA,0,5050641
ykgRp,0.3333333333333333,2,2,GTAACGGTCATGTCTCCGCA,0,5040350
ykgRp,0.3333333333333333,2,2,GTAACGCTTTTGGTTCATTG,0,5043504
ykgRp,0.3333333333333333,2,2,GTAACAATTTGACACAGGGA,0,5043042
ykgRp,0.3333333333333333,2,2,GTAAATCAGACAAGTTTTTA,0,5039847
ykgRp,0.3333333333333333,2,2,GTAAATAGCATTAAGTGAAC,0,5058211
ykgRp,0.3333333333333333,2,2,GTAAATAACACCACCTATGA,0,5061744
ykgRp,0.3333333333333333,2,2,GGTTTGCGTGTATTGCGAAA,0,5040272
ykgRp,0.3333333333333333,2,2,GGTTTGACAGCGCGTGCCCT,0,5051969
ykgRp,0.3333333333333333,2,2,GGTTGCCAGTGGGTCGGAGA,0,5041076
ykgRp,0.3333333333333333,2,2,GGTTCGGTTAGTTGTTTGAA,0,5033835
ykgRp,0.3333333333333333,2,2,GGTTATTCTTAAATCACGCC,0,5040699
ykgRp,0.3333333333333333,2,2,GGTGGTGACTGTGCAATGGA,0,5054135
ykgRp,0.3333333333333333,2,2,GGTGGGCTCTTATGTTCCAG,0,5031855
ykgRp,0.3333333333333333,2,2,GGTGGCGTTATCCGCCAGGC,0,5060009
ykgRp,0.3333333333333333,2,2,GGTGGCATTGTGTCTTCATT,0,5041426
ykgRp,0.3333333333333333,2,2,GGTGCTCAATGGGTCGTGAA,0,5033990
ykgRp,0.3333333333333333,2,2,GGTCTGTACGGTATCGCGTA,0,5057159
ykgRp,0.3333333333333333,2,2,GGTCTACCGTTCGCGACAGT,0,5049681
ykgRp,0.3333333333333333,2,2,GGTCGTGCTGTAAACACAAA,0,5058842
ykgRp,0.3333333333333333,2,2,GGTCGCGGGACGGACGCCTC,0,5032474
ykgRp,0.3333333333333333,2,2,GGTCCTGCCGGCACTTGTTA,0,5056780
ykgRp,0.3333333333333333,2,2,GGTCCAGTAAATGATGGCCC,0,5057571
ykgRp,0.3333333333333333,2,2,GGTCCACGCGTGCGATGTGT,0,5037673
ykgRp,0.3333333333333333,2,2,GGTATCTTCCTCTCGATGAC,0,5042410
ykgRp,0.3333333333333333,2,2,GGTATACCGCACCGACCAGC,0,5055741
ykgRp,0.3333333333333333,2,2,GGTAGTCTTTGCCGACTGGG,0,5054146
ykgRp,0.3333333333333333,2,2,GGTACGAGCGGTCGCACTCA,0,5042753
ykgRp,0.3333333333333333,2,2,GGTAATTACCTTACGTCGTG,0,5044133
ykgRp,0.3333333333333333,2,2,GGTAACGCATCGAGGCTAGC,0,5052542
ykgRp,0.3333333333333333,2,2,GGGTTTAGGCATTGCCAGGG,0,5054238
ykgRp,0.3333333333333333,2,2,GGGTTCTTACACATCAGGTT,0,5057101
ykgRp,0.3333333333333333,2,2,GGGTCTGCAATAAAAAGGTT,0,5058408
ykgRp,0.3333333333333333,2,2,GGGTAACGCTGACGACTACA,0,5045654
ykgRp,0.3333333333333333,2,2,GGGGGTGGTAGGTACGAGCT,0,5032473
ykgRp,0.3333333333333333,2,2,GGGGGTCTAAGGAGAGTGGC,0,5038698
ykgRp,0.3333333333333333,2,2,GGGGGTCATAAGCTCGATCG,0,5057732
ykgRp,0.3333333333333333,2,2,GGGGGCTAAGCTCCAATTTC,0,5046035
ykgRp,0.3333333333333333,2,2,GGGGCACAGAGATGAACAAC,0,5045816
ykgRp,0.3333333333333333,2,2,GGGGCAAGCCGAAACCTTAC,0,5057111
ykgRp,0.3333333333333333,2,2,GGGGAGTTTCCGTCCGGCGT,0,5053222
ykgRp,0.3333333333333333,2,2,GGGGACAAATAGTGGCGGTT,0,5050925
ykgRp,0.3333333333333333,2,2,GGGCTTTGTCCTACGTGGCT,0,5056946
ykgRp,0.3333333333333333,2,2,GGGCTTTAAAATAAATTTGA,0,5054741
ykgRp,0.3333333333333333,2,2,GGGCGATTCTGATACCTGTT,0,5045660
ykgRp,0.3333333333333333,2,2,GGGCGAACAGGCCCCATACC,0,5043889
ykgRp,0.3333333333333333,2,2,GGGCCTGTAATAGTTGCTGG,0,5052599
ykgRp,0.3333333333333333,2,2,GGGATGATCAGCGCCTACGC,0,5049211
ykgRp,0.3333333333333333,2,2,GGGATGAGATAGGCCCTATT,0,5044455
ykgRp,0.3333333333333333,2,2,GGGAGGGTTCCGTAAGGCGT,0,5055105
ykgRp,0.3333333333333333,2,2,GGGAGCCTAAGCAGGGGCTG,0,5036705
ykgRp,0.3333333333333333,2,2,GGGAAGCTGAAAATCTACAC,0,5046597
ykgRp,0.3333333333333333,2,2,GGCTATGGCTGTCCTGTATG,0,5049687
ykgRp,0.3333333333333333,2,2,GGCTACATCACGTCGAATAT,0,5056857
ykgRp,0.3333333333333333,2,2,GGCGTCCCGGGGTTCTTTGA,0,5034790
ykgRp,0.3333333333333333,2,2,GGCGTCAACCAAAAGAAATT,0,5055730
ykgRp,0.3333333333333333,2,2,GGCGTAGAGGTTGTTCGGCA,0,5033203
ykgRp,0.3333333333333333,2,2,GGCGCTATTCCGTAGCTCCG,0,5032444
ykgRp,0.3333333333333333,2,2,GGCCTCTTGTCGGATTTACA,0,5039868
ykgRp,0.3333333333333333,2,2,GGCCGACTTTCGGCTGACAA,0,5045044
ykgRp,0.3333333333333333,2,2,GGCCCTCAACGCGACGGAGA,0,5038529
ykgRp,0.3333333333333333,2,2,GGCCCGCATATGGATGTGTT,0,5058699
ykgRp,0.3333333333333333,2,2,GGCCCAGGAGTGTTAAATCT,0,5060330
ykgRp,0.3333333333333333,2,2,GGCCACATGCTGTGGGGTTT,0,5045992
ykgRp,0.3333333333333333,2,2,GGCCAAGCTCTGAGATGGAA,0,5035866
ykgRp,0.3333333333333333,2,2,GGCCAACCGTATCTCGTTTT,0,5049274
ykgRp,0.3333333333333333,2,2,GGCATGTGGCATCAGATATA,0,5047960
ykgRp,0.3333333333333333,2,2,GGCAGTTCTCAGTAAAGTAA,0,5051120
ykgRp,0.3333333333333333,2,2,GGCACCCGTGACAGATTCAA,0,5050478
ykgRp,0.3333333333333333,2,2,GGCAAAATGAGAACAGCTTA,0,5046674
ykgRp,0.3333333333333333,2,2,GGATTATGGCGCGCCACAGG,0,5032074
ykgRp,0.3333333333333333,2,2,GGATGAGTCTCCGCCCTGTA,0,5057579
ykgRp,0.3333333333333333,2,2,GGATATAATGGATCTAAACT,0,5035178
ykgRp,0.3333333333333333,2,2,GGATAGCGCGGGGTTCTACA,0,5053581
ykgRp,0.3333333333333333,2,2,GGATACCTAAAGGTATATAA,0,5054819
ykgRp,0.3333333333333333,2,2,GGAGCGCGCGATGGACAAGC,0,5034597
ykgRp,0.3333333333333333,2,2,GGAGATAGGATCAAGAGGAT,0,5061013
ykgRp,0.3333333333333333,2,2,GGAGAGAGGATAAGTCTAGT,0,5050845
ykgRp,0.3333333333333333,2,2,GGACTAATCGTGCGCTCCAC,0,5058881
ykgRp,0.3333333333333333,2,2,GGACTAAGCTCCGCCGAATG,0,5055180
ykgRp,0.3333333333333333,2,2,GGACCTCTCCCGGTGCGGGT,0,5048432
ykgRp,0.3333333333333333,2,2,GGACCAAATGTGTAACGTTT,0,5052768
ykgRp,0.3333333333333333,2,2,GGACACGTTGGGTAGTTGTT,0,5046274
ykgRp,0.3333333333333333,2,2,GGACAAATCTGGATCCTGAA,0,5034241
ykgRp,0.3333333333333333,2,2,GGAATCTGGGGTCAGGCGTA,0,5053853
ykgRp,0.3333333333333333,2,2,GGAAGAGCTTATACGATACA,0,5032069
ykgRp,0.3333333333333333,2,2,GGAACCCCCGGGAGACGGGC,0,5052770
ykgRp,0.3333333333333333,2,2,GGAACCCACTATAACAAATA,0,5058411
ykgRp,0.3333333333333333,2,2,GGAAAATCGCGGCACCTAAT,0,5044754
ykgRp,0.3333333333333333,2,2,GCTTTTATATTATTTTGGCC,0,5060479
ykgRp,0.3333333333333333,2,2,GCTTTGGATGTCGTAGGGGT,0,5036047
ykgRp,0.3333333333333333,2,2,GCTTTGGAATCCTGTTTGCG,0,5033143
ykgRp,0.3333333333333333,2,2,GCTTGTATGATGCCATCGAA,0,5040284
ykgRp,0.3333333333333333,2,2,GCTTCCCATATACGAGCTGG,0,5057221
ykgRp,0.3333333333333333,2,2,GCTTATCTTGAATAATATCA,0,5052101
ykgRp,0.3333333333333333,2,2,GCTGGTTTTATGCTATTATC,0,5048598
ykgRp,0.3333333333333333,2,2,GCTGGGCAGGGTGAAAAGAC,0,5050394
ykgRp,0.3333333333333333,2,2,GCTGGCTGATTTGGCAGCAG,0,5059749
ykgRp,0.3333333333333333,2,2,GCTGGAATTGCCGGTCCAAG,0,5058031
ykgRp,0.3333333333333333,2,2,GCTGCGTCGCATACACGGTA,0,5057859
ykgRp,0.3333333333333333,2,2,GCTGCCTTGTCTAGTCAAGA,0,5052521
ykgRp,0.3333333333333333,2,2,GCTGCAGACTGATCTTGATT,0,5036372
ykgRp,0.3333333333333333,2,2,GCTCTGCATTTGAGCATCTT,0,5047523
ykgRp,0.3333333333333333,2,2,GCTCTCACTACTGTACAGGT,0,5054515
ykgRp,0.3333333333333333,2,2,GCTCTATTTCACCATAACGG,0,5055133
ykgRp,0.3333333333333333,2,2,GCTCGGGATGCATCCCGTAT,0,5055988
ykgRp,0.3333333333333333,2,2,GCTCCTGCCTGGACTAGCCG,0,5046671
ykgRp,0.3333333333333333,2,2,GCTCCTAGAATCTTCGTTCA,0,5050863
ykgRp,0.3333333333333333,2,2,GCTCCGAGTGGCTACATTCT,0,5039061
ykgRp,0.3333333333333333,2,2,GCTATCATTTGCAGATTCGA,0,5048887
ykgRp,0.3333333333333333,2,2,GCTAGTTATGTTAAGAAGTC,0,5037090
ykgRp,0.3333333333333333,2,2,GCTAGGGACCGTTGTCTGCT,0,5033875
ykgRp,0.3333333333333333,2,2,GCTAGCGGCTCCGGGAGAGG,0,5048467
ykgRp,0.3333333333333333,2,2,GCTACTGTGCTAAGTCTTTG,0,5032862
ykgRp,0.3333333333333333,2,2,GCTACAGATGTATCCACCCC,0,5036842
ykgRp,0.3333333333333333,2,2,GCTAATGGTTCGATCCTTAT,0,5049424
ykgRp,0.3333333333333333,2,2,GCGTGTACCAATTCCATGTG,0,5032293
ykgRp,0.3333333333333333,2,2,GCGGTTCGGCTCGGCTCCCA,0,5052245
ykgRp,0.3333333333333333,2,2,GCGGTATTTTGGTACTGATA,0,5055234
ykgRp,0.3333333333333333,2,2,GCGGCGGTACGATGTGATTG,0,5033319
ykgRp,0.3333333333333333,2,2,GCGGCGACGCGCTAGTGTCT,0,5032587
ykgRp,0.3333333333333333,2,2,GCGCTCTTTTAGACGACAGT,0,5050697
ykgRp,0.3333333333333333,2,2,GCGCGTATGCGCGGCCAGAA,0,5041035
ykgRp,0.3333333333333333,2,2,GCGCGGTTGGGATGGTATAA,0,5054599
ykgRp,0.3333333333333333,2,2,GCGCGCAGTTTCAGGCATTA,0,5060689
ykgRp,0.3333333333333333,2,2,GCGCGATGGTATCCACAGAA,0,5039342
ykgRp,0.3333333333333333,2,2,GCGCCGTTGTGGGTTCAGCT,0,5041493
ykgRp,0.3333333333333333,2,2,GCGCAGGGTCGATATTCGTA,0,5059588
ykgRp,0.3333333333333333,2,2,GCGCAGGAAAATAAAGTAGA,0,5053882
ykgRp,0.3333333333333333,2,2,GCGAGGGATGCACCGAGTGG,0,5034119
ykgRp,0.3333333333333333,2,2,GCGAGCATCTTGTCCTCATA,0,5032801
ykgRp,0.3333333333333333,2,2,GCGACCAAGCCAATTAATAA,0,5032343
ykgRp,0.3333333333333333,2,2,GCGAATTGTGGTTGCTTTCC,0,5039673
ykgRp,0.3333333333333333,2,2,GCCTTTCCTTATGGGGTGTA,0,5046164
ykgRp,0.3333333333333333,2,2,GCCTTCATTGCATGGTCACC,0,5057075
ykgRp,0.3333333333333333,2,2,GCCTCCAGCACGCAACTACT,0,5059424
ykgRp,0.3333333333333333,2,2,GCCTAGTAGTTTGCGCATAT,0,5051486
ykgRp,0.3333333333333333,2,2,GCCTAAAATTTGTGAGGCCA,0,5050776
ykgRp,0.3333333333333333,2,2,GCCGTCAGAACGATATAGAG,0,5056836
ykgRp,0.3333333333333333,2,2,GCCGCTGGCCGGATCGAGAG,0,5032392
ykgRp,0.3333333333333333,2,2,GCCGCGATCGAACGACCCGT,0,5056593
ykgRp,0.3333333333333333,2,2,GCCGATGTCTCCTATTAAGC,0,5058426
ykgRp,0.3333333333333333,2,2,GCCCTCATGCTCGCATCGCC,0,5054528
ykgRp,0.3333333333333333,2,2,GCCCCGCGTTAGTAGAAAGT,0,5060557
ykgRp,0.3333333333333333,2,2,GCCCCCGCGACGGGGACCCT,0,5047764
ykgRp,0.3333333333333333,2,2,GCCCATGCTTTATGAATTAT,0,5041682
ykgRp,0.3333333333333333,2,2,GCCCAACTCGAGAACAGCTC,0,5035035
ykgRp,0.3333333333333333,2,2,GCCATAATTATCACAACCAG,0,5047600
ykgRp,0.3333333333333333,2,2,GCATTTCCCTGGTCGTAAGA,0,5049685
ykgRp,0.3333333333333333,2,2,GCATTAGAGGGCGTATAGTG,0,5043552
ykgRp,0.3333333333333333,2,2,GCATGTTTGCGTTAAGGTTC,0,5032042
ykgRp,0.3333333333333333,2,2,GCATGGCCCTCGATAAGAAA,0,5052541
ykgRp,0.3333333333333333,2,2,GCATGCATCCATTCAAACCC,0,5043189
ykgRp,0.3333333333333333,2,2,GCATCTTGTACCGTTTGTCC,0,5045709
ykgRp,0.3333333333333333,2,2,GCATAAGAGAATACATTATA,0,5040219
ykgRp,0.3333333333333333,2,2,GCATAAACGGGCGATCGACA,0,5050178
ykgRp,0.3333333333333333,2,2,GCATAAACCATGATATGCGT,0,5036643
ykgRp,0.3333333333333333,2,2,GCAGTGGCTCACGAGCGTAA,0,5059720
ykgRp,0.3333333333333333,2,2,GCAGTATGGCGATAGGTGAG,0,5042539
ykgRp,0.3333333333333333,2,2,GCAGCCGGGTTAACGTAAGG,0,5054519
ykgRp,0.3333333333333333,2,2,GCAGCAACAGTTCTAGATCA,0,5046817
ykgRp,0.3333333333333333,2,2,GCAGATTTATTAGTCTGGGT,0,5031650
ykgRp,0.3333333333333333,2,2,GCAGAGCATAGAGACCTATG,0,5048723
ykgRp,0.3333333333333333,2,2,GCACTCTAGCATCCTACGAA,0,5035066
ykgRp,0.3333333333333333,2,2,GCACTCCTTTAGTGAATGGC,0,5047074
ykgRp,0.3333333333333333,2,2,GCACGAGCAGTCGGAGATTT,0,5052239
ykgRp,0.3333333333333333,2,2,GCACAGGCCTACATTCCTCG,0,5042647
ykgRp,0.3333333333333333,2,2,GCACAAGGCCAGTGTGTGCC,0,5041937
ykgRp,0.3333333333333333,2,2,GCAAGGAGTTTAGCCTTTGT,0,5059732
ykgRp,0.3333333333333333,2,2,GCAACGTCTCCCATGAAGCT,0,5044901
ykgRp,0.3333333333333333,2,2,GCAAAGTCGGTCTGATGGAG,0,5060314
ykgRp,0.3333333333333333,2,2,GATTTGCCGGGCCTGTTCAT,0,5048908
ykgRp,0.3333333333333333,2,2,GATTGGAGAGTCCTCCACGA,0,5045561
ykgRp,0.3333333333333333,2,2,GATTCTCCCAATCCTTGCCT,0,5033715
ykgRp,0.3333333333333333,2,2,GATTCCGGGGATGCACGTGT,0,5033374
ykgRp,0.3333333333333333,2,2,GATTATCAGCTCCGTCCAAA,0,5061006
ykgRp,0.3333333333333333,2,2,GATTAGCTAACGGTCCCAAA,0,5058308
ykgRp,0.3333333333333333,2,2,GATGTGTGACTATAAGCTTC,0,5053762
ykgRp,0.3333333333333333,2,2,GATGTCTTACCGGCAGCTTG,0,5053727
ykgRp,0.3333333333333333,2,2,GATGATCTTCGATTCGTATT,0,5045419
ykgRp,0.3333333333333333,2,2,GATCTACACACGTTACATCA,0,5042956
ykgRp,0.3333333333333333,2,2,GATCGTGCGTGCTCAAAAGG,0,5038508
ykgRp,0.3333333333333333,2,2,GATCGCACCCAGCTCTTCCG,0,5052620
ykgRp,0.3333333333333333,2,2,GATCCGGGGTCCCGCGCGGT,0,5048431
ykgRp,0.3333333333333333,2,2,GATCCGCACCGCGCCAGGGC,0,5033872
ykgRp,0.3333333333333333,2,2,GATCCCTACCTGTGGTCTAT,0,5055683
ykgRp,0.3333333333333333,2,2,GATATGGCCCCATATCAGTG,0,5044442
ykgRp,0.3333333333333333,2,2,GATATGCGGAGGCGGCAGCC,0,5042929
ykgRp,0.3333333333333333,2,2,GATACTCCTGAGCGGCCACT,0,5040517
ykgRp,0.3333333333333333,2,2,GATACGGGCCACAAAATGCG,0,5040775
ykgRp,0.3333333333333333,2,2,GATACGCGCGTGACCCCGAG,0,5053940
ykgRp,0.3333333333333333,2,2,GATAATGCATTAGGCGCGCC,0,5042137
ykgRp,0.3333333333333333,2,2,GATAAAGTTCAACGTCGGTT,0,5056578
ykgRp,0.3333333333333333,2,2,GAGGTGCTTCCCTTCTGCGG,0,5047946
ykgRp,0.3333333333333333,2,2,GAGGTATCGAGGCTTAGTTG,0,5053321
ykgRp,0.3333333333333333,2,2,GAGCGGCACGCTACACAGGA,0,5057283
ykgRp,0.3333333333333333,2,2,GAGCACTGTGACACACCACA,0,5033939
ykgRp,0.3333333333333333,2,2,GAGATCATAATATGTACTGT,0,5039893
ykgRp,0.3333333333333333,2,2,GAGAGACAGAAGTAACGGAC,0,5053168
ykgRp,0.3333333333333333,2,2,GAGACTTATGTTTAGAGCGT,0,5044163
ykgRp,0.3333333333333333,2,2,GAGACGGCGGATGAATCGGA,0,5049961
ykgRp,0.3333333333333333,2,2,GAGACGGCAAAATTGATAGT,0,5060287
ykgRp,0.3333333333333333,2,2,GAGAAACCGGATCCTTAGTG,0,5034745
ykgRp,0.3333333333333333,2,2,GACTTAGCGTGATCAAAAGA,0,5059259
ykgRp,0.3333333333333333,2,2,GACTGTTTCGCAACTGCTGC,0,5046736
ykgRp,0.3333333333333333,2,2,GACTCAACGTGGGACTATGA,0,5060116
ykgRp,0.3333333333333333,2,2,GACTATCCTTCAGGTCCGCT,0,5043284
ykgRp,0.3333333333333333,2,2,GACTACGTACCCCTACGGTC,0,5057857
ykgRp,0.3333333333333333,2,2,GACGTGGTCCGGGGAGAGTG,0,5041729
ykgRp,0.3333333333333333,2,2,GACGCGAGATGGAAGCCAGA,0,5032431
ykgRp,0.3333333333333333,2,2,GACCTCTAGGTGGGAAACCT,0,5049733
ykgRp,0.3333333333333333,2,2,GACCGTGCACCGCTCACAAC,0,5051304
ykgRp,0.3333333333333333,2,2,GACCGTAGGTGCATCTGGGG,0,5039576
ykgRp,0.3333333333333333,2,2,GACCGTAAATCTTCTCACGC,0,5038462
ykgRp,0.3333333333333333,2,2,GACCGGGCTGCTATTTAGCC,0,5035721
ykgRp,0.3333333333333333,2,2,GACCCGGACAGCATCATGTG,0,5033735
ykgRp,0.3333333333333333,2,2,GACCCGATGACTTATTCAAC,0,5052340
ykgRp,0.3333333333333333,2,2,GACCCATGGTTTCAGCGATT,0,5032559
ykgRp,0.3333333333333333,2,2,GACCCATGCATCCTTAGTAA,0,5059932
ykgRp,0.3333333333333333,2,2,GACATAGTTTAAAACAGAGT,0,5053690
ykgRp,0.3333333333333333,2,2,GACACATCGCTCAGTGGGCG,0,5059979
ykgRp,0.3333333333333333,2,2,GACAAGTGGATGTTCGGGTC,0,5040720
ykgRp,0.3333333333333333,2,2,GACAAGTAACAACATAATAC,0,5040298
ykgRp,0.3333333333333333,2,2,GAATGACATAGCAATCCAAT,0,5040090
ykgRp,0.3333333333333333,2,2,GAATCTTCGAGCCGTTCATG,0,5031510
ykgRp,0.3333333333333333,2,2,GAATCTTCCTAACCAGCGAG,0,5059263
ykgRp,0.3333333333333333,2,2,GAATAATTGTTCTGGAGGCC,0,5053818
ykgRp,0.3333333333333333,2,2,GAAGGGACAGATTTCCCAGG,0,5050958
ykgRp,0.3333333333333333,2,2,GAAGGATTACTTTCGGTGGT,0,5053103
ykgRp,0.3333333333333333,2,2,GAAGCTCATCATATTGCCAC,0,5053693
ykgRp,0.3333333333333333,2,2,GAACCGCTGTCCATCCCGGT,0,5060178
ykgRp,0.3333333333333333,2,2,GAACACTCTGAGTTGTTCGT,0,5034727
ykgRp,0.3333333333333333,2,2,GAACAATGCAACCACAATGA,0,5057626
ykgRp,0.3333333333333333,2,2,GAAAGGGTCGGTTTTAGCGG,0,5043694
ykgRp,0.3333333333333333,2,2,GAAAGATCACCCACCTCTCG,0,5045472
ykgRp,0.3333333333333333,2,2,CTTTTCGGCTATGATCCCAT,0,5060654
ykgRp,0.3333333333333333,2,2,CTTTGGTTGGCCTAGTCTGT,0,5049362
ykgRp,0.3333333333333333,2,2,CTTTGGGTTTTGAATGTCTC,0,5052427
ykgRp,0.3333333333333333,2,2,CTTTGCGTTAAAACCAATCT,0,5033495
ykgRp,0.3333333333333333,2,2,CTTTCGTATAACCTGGAGTT,0,5052713
ykgRp,0.3333333333333333,2,2,CTTTCGGCTTCTCTGTGAAC,0,5042521
ykgRp,0.3333333333333333,2,2,CTTTAGAGAGGGATGGATGT,0,5043187
ykgRp,0.3333333333333333,2,2,CTTTAAATTTAATATACCTC,0,5061540
ykgRp,0.3333333333333333,2,2,CTTGTAAGAGCGCGGGGAGC,0,5034400
ykgRp,0.3333333333333333,2,2,CTTGGGTGTATTGTCATCGT,0,5058135
ykgRp,0.3333333333333333,2,2,CTTGCCGGTCAGGTTGCGGA,0,5039828
ykgRp,0.3333333333333333,2,2,CTTCTACGTTTTGAAATAGA,0,5059504
ykgRp,0.3333333333333333,2,2,CTTCGAGAAAGTCGATTCAC,0,5045726
ykgRp,0.3333333333333333,2,2,CTTCGAACAAACTATAGTCC,0,5039966
ykgRp,0.3333333333333333,2,2,CTTCCGTGCCCCCTAGTCAA,0,5045621
ykgRp,0.3333333333333333,2,2,CTTCCCAGCAGCGCATGAAT,0,5056225
ykgRp,0.3333333333333333,2,2,CTTCATATTGTTTCGGAACT,0,5059634
ykgRp,0.3333333333333333,2,2,CTTCACCAATGATTATTCTT,0,5049822
ykgRp,0.3333333333333333,2,2,CTTATGCTGCCTCTGTTTGG,0,5034472
ykgRp,0.3333333333333333,2,2,CTTAGCAGTGTATAAAATTG,0,5032108
ykgRp,0.3333333333333333,2,2,CTTACTTCAGGCACCGAGCC,0,5046955
ykgRp,0.3333333333333333,2,2,CTTACACAAGTTTAGTCTCA,0,5045446
ykgRp,0.3333333333333333,2,2,CTGTTAGAAATACCTTATAT,0,5056217
ykgRp,0.3333333333333333,2,2,CTGTCAGGGGCAAAAACAGT,0,5045602
ykgRp,0.3333333333333333,2,2,CTGTAGCAAGACCTTCTCTG,0,5052272
ykgRp,0.3333333333333333,2,2,CTGTAACAGTCGATGCTTCA,0,5057703
ykgRp,0.3333333333333333,2,2,CTGGTACGTGGGCTCTGTGA,0,5053620
ykgRp,0.3333333333333333,2,2,CTGGCTGGGATAGCGTGGGT,0,5046392
ykgRp,0.3333333333333333,2,2,CTGGCGAGGTTGGATCTGCC,0,5057827
ykgRp,0.3333333333333333,2,2,CTGGACTCTGGGCGAGTCCT,0,5050775
ykgRp,0.3333333333333333,2,2,CTGGAAGTTTGTATACCTTC,0,5061263
ykgRp,0.3333333333333333,2,2,CTGCTGGAGGTTTGCTTGAT,0,5057201
ykgRp,0.3333333333333333,2,2,CTGCGGCATCAGAGTCAGCA,0,5054748
ykgRp,0.3333333333333333,2,2,CTGCGCGCGTTCTATCTTAA,0,5053005
ykgRp,0.3333333333333333,2,2,CTGCGCCACAAGCTTACTGA,0,5059683
ykgRp,0.3333333333333333,2,2,CTGCGACATCGGTGGGCATA,0,5034286
ykgRp,0.3333333333333333,2,2,CTGATCTGAAGAGATCGGCC,0,5044490
ykgRp,0.3333333333333333,2,2,CTGACGTAAATGTTTAGGCA,0,5050181
ykgRp,0.3333333333333333,2,2,CTGAAGCGATCACTATAGCC,0,5051736
ykgRp,0.3333333333333333,2,2,CTCTTAGCTAGCTGACCCGA,0,5044075
ykgRp,0.3333333333333333,2,2,CTCTGCAATCTCAGCACACG,0,5043022
ykgRp,0.3333333333333333,2,2,CTCTCAAGGATTGTTTCGAG,0,5056469
ykgRp,0.3333333333333333,2,2,CTCTAGCTATCTTGCCTTAA,0,5054460
ykgRp,0.3333333333333333,2,2,CTCGTCATGCAGTACGCCTC,0,5060962
ykgRp,0.3333333333333333,2,2,CTCGGGCATTATGCCCTGAG,0,5036946
ykgRp,0.3333333333333333,2,2,CTCGGATTACGGACGGGATC,0,5035224
ykgRp,0.3333333333333333,2,2,CTCGGAGGCCAAATTAAGTG,0,5038801
ykgRp,0.3333333333333333,2,2,CTCGGAACGGGCTCATTTCC,0,5032806
ykgRp,0.3333333333333333,2,2,CTCGAGAATGCAAGCCCGAT,0,5056436
ykgRp,0.3333333333333333,2,2,CTCCTTTTGTAAGCGTTTTA,0,5036056
ykgRp,0.3333333333333333,2,2,CTCCTTTGTCGCAGGCATTG,0,5034499
ykgRp,0.3333333333333333,2,2,CTCCCATTGCCTGACATATC,0,5060678
ykgRp,0.3333333333333333,2,2,CTCCAGTACGAAGTCGGGGT,0,5039770
ykgRp,0.3333333333333333,2,2,CTCATTTTTTGGTGGTACGC,0,5057303
ykgRp,0.3333333333333333,2,2,CTCATTTCGCTCTACCCAGA,0,5056010
ykgRp,0.3333333333333333,2,2,CTCATCCAAACACCTTCGAA,0,5050746
ykgRp,0.3333333333333333,2,2,CTCAGTGAAACGTTCCACTC,0,5059563
ykgRp,0.3333333333333333,2,2,CTCAGGCATAGGAATCTTTC,0,5059522
ykgRp,0.3333333333333333,2,2,CTCAGCGAGCCAATTGTAAC,0,5040432
ykgRp,0.3333333333333333,2,2,CTCAGAATACAACCTAAGAT,0,5038390
ykgRp,0.3333333333333333,2,2,CTCACTTTGAATCCCTAACA,0,5040818
ykgRp,0.3333333333333333,2,2,CTATTTAGCAAATCCACATG,0,5058510
ykgRp,0.3333333333333333,2,2,CTATTCTTACCGAAACCGTA,0,5047979
ykgRp,0.3333333333333333,2,2,CTATGTTCACGACATATGTT,0,5038224
ykgRp,0.3333333333333333,2,2,CTATGAGGCGTCTATATCAT,0,5041595
ykgRp,0.3333333333333333,2,2,CTATCATCTGCTGACATTCT,0,5057897
ykgRp,0.3333333333333333,2,2,CTATATGCTCAGCGGCTACC,0,5038862
ykgRp,0.3333333333333333,2,2,CTAGTCCAATTTGGTTCAGC,0,5043546
ykgRp,0.3333333333333333,2,2,CTAGGAACATGCTGATTTTG,0,5052950
ykgRp,0.3333333333333333,2,2,CTAGATTTGACACGAACTGT,0,5039739
ykgRp,0.3333333333333333,2,2,CTAGACCCTCCTGTGTAACT,0,5045580
ykgRp,0.3333333333333333,2,2,CTACTCTGGCGATGTTAAAA,0,5049325
ykgRp,0.3333333333333333,2,2,CTACGGTTGAGTGAGCACCC,0,5045889
ykgRp,0.3333333333333333,2,2,CTACGAAGCGAACCAATCCT,0,5041924
ykgRp,0.3333333333333333,2,2,CTACCCTTTCCGCCACTAGC,0,5031787
ykgRp,0.3333333333333333,2,2,CTACATTTATGAAAGCATAA,0,5043705
ykgRp,0.3333333333333333,2,2,CTACATACCGAATCAGCAAG,0,5044652
ykgRp,0.3333333333333333,2,2,CTACAGTGTATCTGACGACG,0,5049790
ykgRp,0.3333333333333333,2,2,CTACAAAGACTCATGTAGCT,0,5045271
ykgRp,0.3333333333333333,2,2,CTAATGATTAATTTTAGGGG,0,5042995
ykgRp,0.3333333333333333,2,2,CTAAGTGACTTGTGAGCGGC,0,5036352
ykgRp,0.3333333333333333,2,2,CTAACTTCGCAACAGACTCA,0,5060107
ykgRp,0.3333333333333333,2,2,CTAACGCGTGATGTATCCCT,0,5031382
ykgRp,0.3333333333333333,2,2,CTAACCCAAGGCCGACGGCC,0,5032402
ykgRp,0.3333333333333333,2,2,CTAAAATTGGGCGGGCAATG,0,5032340
ykgRp,0.3333333333333333,2,2,CTAAAAGTGTATGTCACTAA,0,5040833
ykgRp,0.3333333333333333,2,2,CGTTTTGCTATAAAGGATAT,0,5056630
ykgRp,0.3333333333333333,2,2,CGTTTAGGTCTGGAACGGAG,0,5047807
ykgRp,0.3333333333333333,2,2,CGTTGTGCTAGGCATTCAGG,0,5036038
ykgRp,0.3333333333333333,2,2,CGTTGGGTTGGTTGCGAGTA,0,5049345
ykgRp,0.3333333333333333,2,2,CGTTGCGTGGGGGGCACCCA,0,5044907
ykgRp,0.3333333333333333,2,2,CGTTGCAGCACGAAAGATTT,0,5055074
ykgRp,0.3333333333333333,2,2,CGTTAGGCCGAAGGAATTGC,0,5042589
ykgRp,0.3333333333333333,2,2,CGTGTGAGTCCACTTATACG,0,5033460
ykgRp,0.3333333333333333,2,2,CGTGGGGCTTCGGGGCCGGA,0,5039821
ykgRp,0.3333333333333333,2,2,CGTGGGCTTTTTTGAAGAAG,0,5045314
ykgRp,0.3333333333333333,2,2,CGTGGAGTTCGTAAGTAAGG,0,5046729
ykgRp,0.3333333333333333,2,2,CGTGCTGCTGAACTCCACAA,0,5032573
ykgRp,0.3333333333333333,2,2,CGTGCCGCTTAGACCTGGCT,0,5044918
ykgRp,0.3333333333333333,2,2,CGTGATTATTTCATAATCAA,0,5039551
ykgRp,0.3333333333333333,2,2,CGTGACCGATGGACGTGTTT,0,5052083
ykgRp,0.3333333333333333,2,2,CGTGACCCGTTCGGCCATCG,0,5051410
ykgRp,0.3333333333333333,2,2,CGTCTTGCCGTTGTAAGGTG,0,5045428
ykgRp,0.3333333333333333,2,2,CGTCTCCATAGTGCGAGCCA,0,5041054
ykgRp,0.3333333333333333,2,2,CGTCGGGAGTTACTGTAGTA,0,5032404
ykgRp,0.3333333333333333,2,2,CGTCGAAAACCAGCTAACCC,0,5032946
ykgRp,0.3333333333333333,2,2,CGTCCGCAGTTGGTTTTTAT,0,5044942
ykgRp,0.3333333333333333,2,2,CGTATTTTGGCTGTATAACT,0,5033583
ykgRp,0.3333333333333333,2,2,CGTATGGCGCGGGGCTACTT,0,5048142
ykgRp,0.3333333333333333,2,2,CGTATCTAGAGGTAGTGAAA,0,5032107
ykgRp,0.3333333333333333,2,2,CGTATCGGCGGCTGTCAGGG,0,5040993
ykgRp,0.3333333333333333,2,2,CGTAATCCGACTATTGTAAT,0,5047434
ykgRp,0.3333333333333333,2,2,CGTAAGGCCAGGTAACTCAC,0,5034101
ykgRp,0.3333333333333333,2,2,CGTAAATAGGGTCCAAAAGA,0,5043838
ykgRp,0.3333333333333333,2,2,CGGTTTCGGCTAAATTCCTG,0,5050730
ykgRp,0.3333333333333333,2,2,CGGTGTGAGAGACTGACCTT,0,5058714
ykgRp,0.3333333333333333,2,2,CGGTGTCCTAAGAGAGTTGT,0,5043933
ykgRp,0.3333333333333333,2,2,CGGTGCTGGCCGTCCAAATA,0,5034843
ykgRp,0.3333333333333333,2,2,CGGTGCAGGCATTAAATAGG,0,5056241
ykgRp,0.3333333333333333,2,2,CGGTGATCCTCCGAAAGGGC,0,5053124
ykgRp,0.3333333333333333,2,2,CGGTCTTGCCACCTATTAGT,0,5046338
ykgRp,0.3333333333333333,2,2,CGGTCGGCCGTCACGGGTCT,0,5059004
ykgRp,0.3333333333333333,2,2,CGGTCCCAGCTTTCGGACTA,0,5032967
ykgRp,0.3333333333333333,2,2,CGGTATTCGAATTCTAAATT,0,5043786
ykgRp,0.3333333333333333,2,2,CGGTATGACAAGAGACAGGG,0,5052508
ykgRp,0.3333333333333333,2,2,CGGTATCTTTAATGCACGCT,0,5059256
ykgRp,0.3333333333333333,2,2,CGGTAAGGTCGGTCCACAGT,0,5044382
ykgRp,0.3333333333333333,2,2,CGGTAAGGATTGAGGTTGCA,0,5054854
ykgRp,0.3333333333333333,2,2,CGGGTTGCCGAGTACGCTAG,0,5058214
ykgRp,0.3333333333333333,2,2,CGGGTCGGATTCTTTAGCCT,0,5060527
ykgRp,0.3333333333333333,2,2,CGGGTATGGCGCTCAGGAGT,0,5035909
ykgRp,0.3333333333333333,2,2,CGGGCGGTACACCTTATTGA,0,5045353
ykgRp,0.3333333333333333,2,2,CGGGATGGATTTGTCCGCGG,0,5057276
ykgRp,0.3333333333333333,2,2,CGGGATGCTTGGATTGTAAC,0,5052828
ykgRp,0.3333333333333333,2,2,CGGGATCTGACTTGGAGGTA,0,5037531
ykgRp,0.3333333333333333,2,2,CGGGAACATTGTGATTTTGT,0,5034127
ykgRp,0.3333333333333333,2,2,CGGCTGGGTATTTGGTTTCG,0,5051945
ykgRp,0.3333333333333333,2,2,CGGCGTTAAGCCCTTGATTA,0,5034197
ykgRp,0.3333333333333333,2,2,CGGCGCGAGTATGACGGTCA,0,5052318
ykgRp,0.3333333333333333,2,2,CGGCAATACTTTTTACATGG,0,5043836
ykgRp,0.3333333333333333,2,2,CGGATTCACTCGACAAGCCA,0,5046767
ykgRp,0.3333333333333333,2,2,CGGAGAAGCGTTCACTGAGC,0,5046051
ykgRp,0.3333333333333333,2,2,CGGACTGGATCAGAAGATTT,0,5049599
ykgRp,0.3333333333333333,2,2,CGGACGGGTAGTATTCAATT,0,5060484
ykgRp,0.3333333333333333,2,2,CGGAATATTTGACCAGAAAT,0,5031324
ykgRp,0.3333333333333333,2,2,CGCTTTAATGCGTCGTGGGC,0,5032572
ykgRp,0.3333333333333333,2,2,CGCTTGGGCCGCAAACTATA,0,5060975
ykgRp,0.3333333333333333,2,2,CGCTTGCATCGATTTGGCGT,0,5031913
ykgRp,0.3333333333333333,2,2,CGCTTCACACGGTAACGGAG,0,5031609
ykgRp,0.3333333333333333,2,2,CGCTGTGTGCCCTTATGAGG,0,5054233
ykgRp,0.3333333333333333,2,2,CGCTGGTAGAATCCGTGGTC,0,5048562
ykgRp,0.3333333333333333,2,2,CGCTGAGATAGTGTCCCTTT,0,5044385
ykgRp,0.3333333333333333,2,2,CGCGTTTTGTACGTTACGGA,0,5050670
ykgRp,0.3333333333333333,2,2,CGCGTGAATCAAGTCTCCAT,0,5049383
ykgRp,0.3333333333333333,2,2,CGCGTCCACGTGCGTAAGAG,0,5046324
ykgRp,0.3333333333333333,2,2,CGCGTAAGGGGAAGTGGGGT,0,5036460
ykgRp,0.3333333333333333,2,2,CGCGGTTCGTGGTCGCTGTG,0,5039639
ykgRp,0.3333333333333333,2,2,CGCGGAAAGCCTTATATTAC,0,5034285
ykgRp,0.3333333333333333,2,2,CGCGCTTACAGAATACCAGA,0,5046186
ykgRp,0.3333333333333333,2,2,CGCGCGCTGCATCCAGTCTT,0,5036481
ykgRp,0.3333333333333333,2,2,CGCGCCAGGCCGTTTCGCCC,0,5038356
ykgRp,0.3333333333333333,2,2,CGCGATGCCACCACTTTTTT,0,5059771
ykgRp,0.3333333333333333,2,2,CGCGAGAGACCTTCGCGAGG,0,5056302
ykgRp,0.3333333333333333,2,2,CGCGAAAGTATCTGTGTAGG,0,5039227
ykgRp,0.3333333333333333,2,2,CGCCTCGTATAGATCATTGA,0,5039945
ykgRp,0.3333333333333333,2,2,CGCCTCGGGGGTGTAACCGA,0,5033195
ykgRp,0.3333333333333333,2,2,CGCCACGTTACAACCAAGAC,0,5047160
ykgRp,0.3333333333333333,2,2,CGCCACCAGACCGCCGGGCG,0,5057102
ykgRp,0.3333333333333333,2,2,CGCATGGATTTCGTTCTTTC,0,5046849
ykgRp,0.3333333333333333,2,2,CGCATCAACCTACGCCAATT,0,5053248
ykgRp,0.3333333333333333,2,2,CGCAGAAGCGGCTAGCTGAG,0,5054830
ykgRp,0.3333333333333333,2,2,CGCACAATAGGGGCGTATCT,0,5044857
ykgRp,0.3333333333333333,2,2,CGATGTTCTCGCGCCTCAGT,0,5036639
ykgRp,0.3333333333333333,2,2,CGAGTTCTTAGGCGTGGTGC,0,5039741
ykgRp,0.3333333333333333,2,2,CGAGTGGCGTGTTGCTTGCA,0,5057901
ykgRp,0.3333333333333333,2,2,CGAGTCCTGGTTCGGTAGCG,0,5041678
ykgRp,0.3333333333333333,2,2,CGAGTCATGTGAAACCTTTC,0,5038018
ykgRp,0.3333333333333333,2,2,CGAGTACCATGCGTAGGTAA,0,5049912
ykgRp,0.3333333333333333,2,2,CGAGTAACTCACACTTACCA,0,5060278
ykgRp,0.3333333333333333,2,2,CGAGGGGACTGCTGGTGATA,0,5037117
ykgRp,0.3333333333333333,2,2,CGAGGAAACGTGGGTTATTT,0,5056255
ykgRp,0.3333333333333333,2,2,CGAGCCCGGAAGTTTTCGGG,0,5035896
ykgRp,0.3333333333333333,2,2,CGACTCTCGTCTCGGTGCCG,0,5061677
ykgRp,0.3333333333333333,2,2,CGACTATAATGCTACTGGAG,0,5050471
ykgRp,0.3333333333333333,2,2,CGACGGATGCCTCTGAGGGA,0,5046471
ykgRp,0.3333333333333333,2,2,CGACGACGGGTTGAGCTATA,0,5057954
ykgRp,0.3333333333333333,2,2,CGACCTTGCGTAGAACCTAT,0,5056163
ykgRp,0.3333333333333333,2,2,CGACCTCGTTATTTCGGGAG,0,5037337
ykgRp,0.3333333333333333,2,2,CGAACTGGCTGTGGTCTGGA,0,5056299
ykgRp,0.3333333333333333,2,2,CGAACTCGGGCCACCTAGCA,0,5045693
ykgRp,0.3333333333333333,2,2,CGAACGGACTCATCGCAAAA,0,5049104
ykgRp,0.3333333333333333,2,2,CGAACCGTGGGTTAGCCTAT,0,5046583
ykgRp,0.3333333333333333,2,2,CGAAATGTATCAAGCCATGA,0,5043998
ykgRp,0.3333333333333333,2,2,CGAAATCCCCGCACTCTCGA,0,5045834
ykgRp,0.3333333333333333,2,2,CCTTTTGAATTCTTGGCCGA,0,5043968
ykgRp,0.3333333333333333,2,2,CCTTCTCTGCGCGCGGTGCG,0,5046234
ykgRp,0.3333333333333333,2,2,CCTTACATTAGGGTGGGCTA,0,5061109
ykgRp,0.3333333333333333,2,2,CCTGTTTACTAGCGCTTGGA,0,5050000
ykgRp,0.3333333333333333,2,2,CCTGTCTCTGGCAACAGCCA,0,5045378
ykgRp,0.3333333333333333,2,2,CCTGGCTTGCCCTTTCCCTA,0,5061164
ykgRp,0.3333333333333333,2,2,CCTGCTTGTTGTGATCAGTA,0,5036469
ykgRp,0.3333333333333333,2,2,CCTGCTCATTTCTGCGAGTC,0,5044914
ykgRp,0.3333333333333333,2,2,CCTGATGTGTGGGTAAGCGG,0,5038980
ykgRp,0.3333333333333333,2,2,CCTGACTTTCATCTATCATG,0,5031816
ykgRp,0.3333333333333333,2,2,CCTCTCTAACTATGTACTCT,0,5036654
ykgRp,0.3333333333333333,2,2,CCTCCTTGCCGGCATAAATA,0,5033887
ykgRp,0.3333333333333333,2,2,CCTCATATGGCGTAAGGTTT,0,5033217
ykgRp,0.3333333333333333,2,2,CCTATGGGGTCTTTCATTTG,0,5049204
ykgRp,0.3333333333333333,2,2,CCTAGCGGAATCGTAGCCAA,0,5049013
ykgRp,0.3333333333333333,2,2,CCTAGAGGCAGCACCCAATG,0,5056948
ykgRp,0.3333333333333333,2,2,CCTAATGCCCTCGAGCTTTT,0,5053032
ykgRp,0.3333333333333333,2,2,CCTAACGAGAAGTACCAACT,0,5032307
ykgRp,0.3333333333333333,2,2,CCGTTCTGGACCCCTCAGGG,0,5036714
ykgRp,0.3333333333333333,2,2,CCGTCCTCTGCCGGAGCGTG,0,5058820
ykgRp,0.3333333333333333,2,2,CCGTCATCTGCCACGTTTTA,0,5034696
ykgRp,0.3333333333333333,2,2,CCGTATGGAGCACTGGCAAG,0,5040831
ykgRp,0.3333333333333333,2,2,CCGTATACGGGGACGGTTTA,0,5044311
ykgRp,0.3333333333333333,2,2,CCGTACCCGGCTTATTTAAT,0,5060057
ykgRp,0.3333333333333333,2,2,CCGGTTTAGTTTTTAAGTTC,0,5038480
ykgRp,0.3333333333333333,2,2,CCGGTCATGATTGACTCGTT,0,5049282
ykgRp,0.3333333333333333,2,2,CCGGTCATAGCGGAACTAGG,0,5039192
ykgRp,0.3333333333333333,2,2,CCGGTAACGGCAATTTCAGT,0,5045744
ykgRp,0.3333333333333333,2,2,CCGGCTTTTTCCATAGGGGA,0,5031689
ykgRp,0.3333333333333333,2,2,CCGGCTGTTTCAGATACGCC,0,5049377
ykgRp,0.3333333333333333,2,2,CCGCTAGAAGCGTCAATTCG,0,5040836
ykgRp,0.3333333333333333,2,2,CCGCGGTATTAGCTCGGCGC,0,5045349
ykgRp,0.3333333333333333,2,2,CCGCCGCTATGTCAGTGTAT,0,5044789
ykgRp,0.3333333333333333,2,2,CCGATCCATCGTGATTCGGA,0,5034641
ykgRp,0.3333333333333333,2,2,CCGACACGCAGTGCATATGG,0,5044250
ykgRp,0.3333333333333333,2,2,CCGAATCCTTGAGACGGCCC,0,5038107
ykgRp,0.3333333333333333,2,2,CCCTTCGGAGGGCGCGAGGA,0,5035788
ykgRp,0.3333333333333333,2,2,CCCTGGACACCCGCCATGTA,0,5056433
ykgRp,0.3333333333333333,2,2,CCCTGCTATACCAATTAGAT,0,5038519
ykgRp,0.3333333333333333,2,2,CCCTCTGCGCTAAAGCGAAA,0,5035894
ykgRp,0.3333333333333333,2,2,CCCTAATGGACTTTCGCCGG,0,5031429
ykgRp,0.3333333333333333,2,2,CCCGGCGGCGCGGTCAAGCT,0,5043877
ykgRp,0.3333333333333333,2,2,CCCGGCAATATCAAATGCCG,0,5060699
ykgRp,0.3333333333333333,2,2,CCCCTCTGGCGTCTTGTCGT,0,5059313
ykgRp,0.3333333333333333,2,2,CCCCGTAATGCTGGGCCTTG,0,5040327
ykgRp,0.3333333333333333,2,2,CCCCGCACGCCAGCTAAATA,0,5057016
ykgRp,0.3333333333333333,2,2,CCCCAGCTGGCTAATGTTTA,0,5052902
ykgRp,0.3333333333333333,2,2,CCCCAGCTCTCTGTCAGCTG,0,5035180
ykgRp,0.3333333333333333,2,2,CCCAATAAAAAGAATTCGTG,0,5033845
ykgRp,0.3333333333333333,2,2,CCATTTTCTCCAAGTTATGG,0,5051926
ykgRp,0.3333333333333333,2,2,CCATGCGAATAAGGTGCAAT,0,5048025
ykgRp,0.3333333333333333,2,2,CCATGCCTTATGAGCGTGTG,0,5052833
ykgRp,0.3333333333333333,2,2,CCATAGGTTTTTGAACATCC,0,5032263
ykgRp,0.3333333333333333,2,2,CCAGTTTATTCGTCTCTTGG,0,5040153
ykgRp,0.3333333333333333,2,2,CCAGTCGGAAAGGAACCAAG,0,5039818
ykgRp,0.3333333333333333,2,2,CCAGTATAGGCGGCCGCTTC,0,5060577
ykgRp,0.3333333333333333,2,2,CCAGTAGTTCACGTGAGTTT,0,5031613
ykgRp,0.3333333333333333,2,2,CCAGTACTAGCCCATACCAA,0,5054614
ykgRp,0.3333333333333333,2,2,CCAGGGGGTACGCGTCCGGG,0,5058918
ykgRp,0.3333333333333333,2,2,CCAGGAGGCACCGTGCACCA,0,5054990
ykgRp,0.3333333333333333,2,2,CCAGAGTGTGCGACCCCGAC,0,5053207
ykgRp,0.3333333333333333,2,2,CCAGACAAAGTGTGCACTCT,0,5047478
ykgRp,0.3333333333333333,2,2,CCACTTCACCCCGATATAAA,0,5042345
ykgRp,0.3333333333333333,2,2,CCACTGCTCAAATCAAAGGG,0,5043648
ykgRp,0.3333333333333333,2,2,CCACTCTGCAGTTGAGCCAT,0,5045890
ykgRp,0.3333333333333333,2,2,CCACTACAATGCGCATGATG,0,5055839
ykgRp,0.3333333333333333,2,2,CCACGTCCTTATTACTAACA,0,5034491
ykgRp,0.3333333333333333,2,2,CCACCTAAGGCGCTAGCTCT,0,5040977
ykgRp,0.3333333333333333,2,2,CCACAAGCTGGCGTGGTTAC,0,5041007
ykgRp,0.3333333333333333,2,2,CCAATTCGGCGACTTTGTCG,0,5054632
ykgRp,0.3333333333333333,2,2,CCAAAGCAACGTTAGGTCAT,0,5056429
ykgRp,0.3333333333333333,2,2,CCAAAATTTCCTTATTCCCC,0,5051971
ykgRp,0.3333333333333333,2,2,CATTTCTTATTCAGGTCTCG,0,5057224
ykgRp,0.3333333333333333,2,2,CATTGTAGGGGTAATGGAAT,0,5054984
ykgRp,0.3333333333333333,2,2,CATTGGTCATGATGTGCTGA,0,5052129
ykgRp,0.3333333333333333,2,2,CATTGGCTGAAACTCCATCT,0,5041863
ykgRp,0.3333333333333333,2,2,CATTCTGCGGTCGAATTGTG,0,5046437
ykgRp,0.3333333333333333,2,2,CATTCTCGCCGACCTCTGTG,0,5038645
ykgRp,0.3333333333333333,2,2,CATTCGTCCCGGACTCTGAC,0,5042817
ykgRp,0.3333333333333333,2,2,CATTATCTTTCCTAAAATGG,0,5049850
ykgRp,0.3333333333333333,2,2,CATTAGCTTTGATTCCCTGA,0,5053327
ykgRp,0.3333333333333333,2,2,CATGCGCATGTAAATTGCGT,0,5046431
ykgRp,0.3333333333333333,2,2,CATGCCGGCACGGTCGGGAA,0,5054424
ykgRp,0.3333333333333333,2,2,CATGCCATTACAAGGAAGGG,0,5059212
ykgRp,0.3333333333333333,2,2,CATGAGGTGGGACCATCATC,0,5037514
ykgRp,0.3333333333333333,2,2,CATGACACGCCAGGACTGCG,0,5032526
ykgRp,0.3333333333333333,2,2,CATCTCGGGGTACTGTTTAT,0,5040028
ykgRp,0.3333333333333333,2,2,CATCTCGGAGTAAGTTATGA,0,5032327
ykgRp,0.3333333333333333,2,2,CATCTCAGTCACTATCATAG,0,5055633
ykgRp,0.3333333333333333,2,2,CATCTAGGTATGATGGCTCA,0,5050728
ykgRp,0.3333333333333333,2,2,CATCGGAGACTAAGATTAGA,0,5032362
ykgRp,0.3333333333333333,2,2,CATCGATTGTGCAAGTGCGG,0,5054131
ykgRp,0.3333333333333333,2,2,CATCCGTCATACTGAGTCAA,0,5040061
ykgRp,0.3333333333333333,2,2,CATCACCTCTTTTTAGGAAT,0,5051318
ykgRp,0.3333333333333333,2,2,CATATCCGGTTTTAACTAGA,0,5039729
ykgRp,0.3333333333333333,2,2,CATATAGGACACGGAACTTT,0,5053361
ykgRp,0.3333333333333333,2,2,CATAGTCTCGCTAATAAAAA,0,5060344
ykgRp,0.3333333333333333,2,2,CATAGGATTCATGTGTTCGG,0,5051319
ykgRp,0.3333333333333333,2,2,CATAGGATGGGTTAGAGACG,0,5037399
ykgRp,0.3333333333333333,2,2,CATACGCGTAAACGCGACGT,0,5058403
ykgRp,0.3333333333333333,2,2,CATAATGGAGATCTACCTAG,0,5040802
ykgRp,0.3333333333333333,2,2,CAGTGTCGATCGTCGTACTA,0,5044356
ykgRp,0.3333333333333333,2,2,CAGTGGGAGCAAAGAAAGTG,0,5031698
ykgRp,0.3333333333333333,2,2,CAGGTGATAGGCCAACCAAG,0,5039706
ykgRp,0.3333333333333333,2,2,CAGGGTGGGCTTGGGCCTGG,0,5057440
ykgRp,0.3333333333333333,2,2,CAGGGGCCACGCTAATCCGG,0,5058291
ykgRp,0.3333333333333333,2,2,CAGGATTTGCTTACGTATTC,0,5051604
ykgRp,0.3333333333333333,2,2,CAGGACTTAGTCATTGTGCC,0,5056557
ykgRp,0.3333333333333333,2,2,CAGGAATTGTGTAGCCGTGA,0,5054555
ykgRp,0.3333333333333333,2,2,CAGGAAGCTTCTGCCAGTTC,0,5037774
ykgRp,0.3333333333333333,2,2,CAGCTTTGGGCCAGGGCGGG,0,5046743
ykgRp,0.3333333333333333,2,2,CAGCTCATATAGAGCTCTTA,0,5052590
ykgRp,0.3333333333333333,2,2,CAGCGGGCGCGTCCCCAAGG,0,5046660
ykgRp,0.3333333333333333,2,2,CAGCGCACGTACATGCCAGT,0,5038121
ykgRp,0.3333333333333333,2,2,CAGCCCGGAATATAGTAATC,0,5048259
ykgRp,0.3333333333333333,2,2,CAGCCCCTAGGGGGTCCCGT,0,5053070
ykgRp,0.3333333333333333,2,2,CAGCAAGTATACATCACTCA,0,5034678
ykgRp,0.3333333333333333,2,2,CAGAGGTATGATTGGCGTTA,0,5035550
ykgRp,0.3333333333333333,2,2,CAGAGGACGACCTCAAAATG,0,5059052
ykgRp,0.3333333333333333,2,2,CACTTCCTAATCTATGGGTA,0,5037377
ykgRp,0.3333333333333333,2,2,CACTGGTAAATACTGAGATA,0,5051248
ykgRp,0.3333333333333333,2,2,CACTGGAAAAACTGAAAACA,0,5051875
ykgRp,0.3333333333333333,2,2,CACTCCCTCATATGAGAGCA,0,5048068
ykgRp,0.3333333333333333,2,2,CACTACCATTGAGGGTCGGG,0,5039594
ykgRp,0.3333333333333333,2,2,CACTAAAACCCTGATTTAAT,0,5041855
ykgRp,0.3333333333333333,2,2,CACGTACCTTGCTAATTGAA,0,5057100
ykgRp,0.3333333333333333,2,2,CACGCGCCTGCGATTAACTA,0,5036564
ykgRp,0.3333333333333333,2,2,CACGAATTGTGGATACGAAG,0,5039036
ykgRp,0.3333333333333333,2,2,CACCGCGTCGATTCCGTTAA,0,5056230
ykgRp,0.3333333333333333,2,2,CACCCCTTTGTAGGTAACTT,0,5046162
ykgRp,0.3333333333333333,2,2,CACATGTGTACGCGAGGATG,0,5036944
ykgRp,0.3333333333333333,2,2,CACATGCTTATCGATACACT,0,5057207
ykgRp,0.3333333333333333,2,2,CACATGCCAATCCTCTCCAG,0,5037037
ykgRp,0.3333333333333333,2,2,CACAGTCAGTAGTATCTCTT,0,5043008
ykgRp,0.3333333333333333,2,2,CACAGGGGAGGGTATTCTGC,0,5034221
ykgRp,0.3333333333333333,2,2,CACACCGTGGCGTAGTGGTA,0,5060109
ykgRp,0.3333333333333333,2,2,CAATTGGCTGAAAGTATAAG,0,5034837
ykgRp,0.3333333333333333,2,2,CAATTGAGGGTCGAGTAAGT,0,5047258
ykgRp,0.3333333333333333,2,2,CAATCTGGGGCGATTTCGCA,0,5037063
ykgRp,0.3333333333333333,2,2,CAATCGGGCAGTCAGAGGGA,0,5050672
ykgRp,0.3333333333333333,2,2,CAATCGCCAGTTGTTCTAGT,0,5055194
ykgRp,0.3333333333333333,2,2,CAATCCAACGGCGGATGTGA,0,5045379
ykgRp,0.3333333333333333,2,2,CAATAAAAGGGTAAGCGGAA,0,5043802
ykgRp,0.3333333333333333,2,2,CAACTGATTCGGTTCAATAA,0,5052414
ykgRp,0.3333333333333333,2,2,CAACTGAGCGGGGTGACAAA,0,5039071
ykgRp,0.3333333333333333,2,2,CAACGCCCTCGGGGCCGTGC,0,5058954
ykgRp,0.3333333333333333,2,2,CAACCAACGCCCACGATACC,0,5040427
ykgRp,0.3333333333333333,2,2,CAACATTCGATCAGGTAACA,0,5046056
ykgRp,0.3333333333333333,2,2,CAACATCTCATCCCCGGCGC,0,5055551
ykgRp,0.3333333333333333,2,2,CAACACTTCCGCTCGTTAAA,0,5046351
ykgRp,0.3333333333333333,2,2,CAACACCAGCAGCTAACGTA,0,5035184
ykgRp,0.3333333333333333,2,2,CAAATAGGTGAGCGTATGAC,0,5035927
ykgRp,0.3333333333333333,2,2,CAAAGCGTTTCGTACGTTCG,0,5040534
ykgRp,0.3333333333333333,2,2,CAAAGCGTCGCATAAGCTTG,0,5051810
ykgRp,0.3333333333333333,2,2,CAAACAGCAGAGAGGTCGTC,0,5048391
ykgRp,0.3333333333333333,2,2,ATTTGTGTTGGGTGACACTT,0,5040732
ykgRp,0.3333333333333333,2,2,ATTTGAATCGCGCAAGCGTC,0,5058779
ykgRp,0.3333333333333333,2,2,ATTTCTGTGCGTTCTGGAGT,0,5057363
ykgRp,0.3333333333333333,2,2,ATTTACCCGTAGGCCAATTA,0,5053195
ykgRp,0.3333333333333333,2,2,ATTGTCTAAAAATTGATCAT,0,5033596
ykgRp,0.3333333333333333,2,2,ATTGTAACTCAGGCAGGACC,0,5061500
ykgRp,0.3333333333333333,2,2,ATTGATATGGTGCCGTCCTT,0,5032007
ykgRp,0.3333333333333333,2,2,ATTGAACGACACTAAAAGCA,0,5060319
ykgRp,0.3333333333333333,2,2,ATTGAACATATTTTCCCACA,0,5040724
ykgRp,0.3333333333333333,2,2,ATTCTAGTGCGCAGCTTTGA,0,5035212
ykgRp,0.3333333333333333,2,2,ATTCGTCCGCGCTGCCCTGT,0,5033786
ykgRp,0.3333333333333333,2,2,ATTCGACACAGTCAGTTGAT,0,5054872
ykgRp,0.3333333333333333,2,2,ATTCCCCGCTGATCTAACTT,0,5051370
ykgRp,0.3333333333333333,2,2,ATTCCCACACAAAATCATTG,0,5043729
ykgRp,0.3333333333333333,2,2,ATTCATGGGGCGGAGCACGT,0,5048730
ykgRp,0.3333333333333333,2,2,ATTCAAATCTGAACGCTCAA,0,5044999
ykgRp,0.3333333333333333,2,2,ATTATGAATGTCTATCTTCT,0,5057098
ykgRp,0.3333333333333333,2,2,ATTATAGGCTCTATGTTTAA,0,5050726
ykgRp,0.3333333333333333,2,2,ATTAGTTGAATGCCTCAAAC,0,5059487
ykgRp,0.3333333333333333,2,2,ATTAGGACCAATAGGCCCTT,0,5036312
ykgRp,0.3333333333333333,2,2,ATTAGCTTTACCTCATCGGT,0,5033491
ykgRp,0.3333333333333333,2,2,ATTACGCCATAATTCCCTCT,0,5036952
ykgRp,0.3333333333333333,2,2,ATTACAAGGCAATCCTTAGA,0,5054541
ykgRp,0.3333333333333333,2,2,ATGTTAATCCATCAGCGTCA,0,5040378
ykgRp,0.3333333333333333,2,2,ATGTGTTAGGAGTGTACTGC,0,5054806
ykgRp,0.3333333333333333,2,2,ATGTGATAAAATGAGCCCCA,0,5046912
ykgRp,0.3333333333333333,2,2,ATGTGAGTCACTTCATTCGA,0,5046412
ykgRp,0.3333333333333333,2,2,ATGTCCGGATCCCCAAATAA,0,5047597
ykgRp,0.3333333333333333,2,2,ATGTCATGATTCGATACGGC,0,5049018
ykgRp,0.3333333333333333,2,2,ATGTCAATAGAGTCCCTATT,0,5038513
ykgRp,0.3333333333333333,2,2,ATGGGAAGGGTGGAGCTAGA,0,5041153
ykgRp,0.3333333333333333,2,2,ATGGAGGGAACCAGATCGCG,0,5053879
ykgRp,0.3333333333333333,2,2,ATGCTATGTCCGGTGCAGCA,0,5049742
ykgRp,0.3333333333333333,2,2,ATGCGATCTAACTGCGAGCT,0,5047001
ykgRp,0.3333333333333333,2,2,ATGCATGCTGGCCGTTATGC,0,5056041
ykgRp,0.3333333333333333,2,2,ATGCATAGTAGTTACATGAA,0,5035370
ykgRp,0.3333333333333333,2,2,ATGCAGGAAAGGATGTTGAT,0,5042519
ykgRp,0.3333333333333333,2,2,ATGCAGAAGGTTGGGAAACG,0,5032366
ykgRp,0.3333333333333333,2,2,ATGATTTCTGTGTACCCTGA,0,5061163
ykgRp,0.3333333333333333,2,2,ATGATGTATCGTTTCCGAAG,0,5031328
ykgRp,0.3333333333333333,2,2,ATGAGAACTTTCTGCATAAT,0,5042096
ykgRp,0.3333333333333333,2,2,ATGACATTTGAGCTATCTAG,0,5046302
ykgRp,0.3333333333333333,2,2,ATGAATTTTTAGCCTGTTAC,0,5048118
ykgRp,0.3333333333333333,2,2,ATGAATGAGAACGGCGGTGG,0,5037347
ykgRp,0.3333333333333333,2,2,ATGAACGATGCAAGGCTCTA,0,5058601
ykgRp,0.3333333333333333,2,2,ATGAACCCAGTCATCGTATC,0,5037430
ykgRp,0.3333333333333333,2,2,ATCTTTGTGCTGCAAGACAG,0,5039994
ykgRp,0.3333333333333333,2,2,ATCTTCCGTTAGGGCATTAA,0,5046353
ykgRp,0.3333333333333333,2,2,ATCTGTGATTCACAAAAGAT,0,5034574
ykgRp,0.3333333333333333,2,2,ATCTGAACGCGTCATAAATG,0,5059251
ykgRp,0.3333333333333333,2,2,ATCTCGTCAGGAAATCACTA,0,5058151
ykgRp,0.3333333333333333,2,2,ATCTCCTTAATGGCGAATAT,0,5041173
ykgRp,0.3333333333333333,2,2,ATCTCATCAATGGGCTGTGG,0,5038947
ykgRp,0.3333333333333333,2,2,ATCGTTCTACAGTATGGCGG,0,5053843
ykgRp,0.3333333333333333,2,2,ATCGTTACTGACCGTCCGGA,0,5061357
ykgRp,0.3333333333333333,2,2,ATCGTGGTGCGGCACTGGCT,0,5050671
ykgRp,0.3333333333333333,2,2,ATCGTGATAGCGAAATGCTA,0,5038661
ykgRp,0.3333333333333333,2,2,ATCGTCGTTAGTGTACATTA,0,5048956
ykgRp,0.3333333333333333,2,2,ATCGTCCGTTTCTCTCCACT,0,5040955
ykgRp,0.3333333333333333,2,2,ATCGGGAGCGCCTTAGGAAG,0,5061008
ykgRp,0.3333333333333333,2,2,ATCGGGAATCGATTACCTAT,0,5058342
ykgRp,0.3333333333333333,2,2,ATCGGAAGTGTCGTTAGTGA,0,5037135
ykgRp,0.3333333333333333,2,2,ATCGCACCTGGTGCATTATA,0,5051618
ykgRp,0.3333333333333333,2,2,ATCGAATTGCGGTAGGGGAC,0,5043191
ykgRp,0.3333333333333333,2,2,ATCCTTGGGCTCAATCCCTT,0,5031700
ykgRp,0.3333333333333333,2,2,ATCCTTCTGAATAATCAGAA,0,5045201
ykgRp,0.3333333333333333,2,2,ATCCGTATGACCTGAATGTG,0,5042470
ykgRp,0.3333333333333333,2,2,ATCCCCACACGATCGAAAAA,0,5056294
ykgRp,0.3333333333333333,2,2,ATCATAACCCTTCCCACCAG,0,5042964
ykgRp,0.3333333333333333,2,2,ATCACTCAAGTACGATCGAT,0,5044428
ykgRp,0.3333333333333333,2,2,ATCAATCTGTGACTAATCAA,0,5038520
ykgRp,0.3333333333333333,2,2,ATCAACTCACTAATTCTGTA,0,5057525
ykgRp,0.3333333333333333,2,2,ATATTTTTAGAAGCAGAAAT,0,5039971
ykgRp,0.3333333333333333,2,2,ATATTGGAATAGTATGTATA,0,5056633
ykgRp,0.3333333333333333,2,2,ATATTGCACCTGCCTGCGTC,0,5049189
ykgRp,0.3333333333333333,2,2,ATATTAAAGCACTCGTCTTT,0,5046677
ykgRp,0.3333333333333333,2,2,ATATGACCTCAAATTTCGGC,0,5061281
ykgRp,0.3333333333333333,2,2,ATATCTGCCATCAGATCCAA,0,5032425
ykgRp,0.3333333333333333,2,2,ATATAGGAACTAGGGCAGCG,0,5047507
ykgRp,0.3333333333333333,2,2,ATAGGGGCGGGCGTGGGCAG,0,5052431
ykgRp,0.3333333333333333,2,2,ATAGGGGACTCAGGGATTCA,0,5034021
ykgRp,0.3333333333333333,2,2,ATAGATCGGCTAAGCAAATA,0,5034683
ykgRp,0.3333333333333333,2,2,ATACTCGGTCAGCGGAAGGC,0,5055005
ykgRp,0.3333333333333333,2,2,ATACGACATACCACGACTCC,0,5038553
ykgRp,0.3333333333333333,2,2,ATACCCAAAACTCCCGAGTA,0,5057899
ykgRp,0.3333333333333333,2,2,ATAATCGCTGCGCGCCTTGC,0,5045248
ykgRp,0.3333333333333333,2,2,ATAAGCTGCGTTGAACTAAT,0,5044581
ykgRp,0.3333333333333333,2,2,ATAAGCTATAACCGGGTAAG,0,5041232
ykgRp,0.3333333333333333,2,2,ATAAGCCAAGTCCTCGTCTC,0,5056352
ykgRp,0.3333333333333333,2,2,AGTTTCCGCCGTGCACATTC,0,5054445
ykgRp,0.3333333333333333,2,2,AGTTGGAGACTGGGGCGCTG,0,5061271
ykgRp,0.3333333333333333,2,2,AGTTAGTTCGTTCGTCCCTC,0,5037911
ykgRp,0.3333333333333333,2,2,AGTGTTCAGACAAGCTCGAC,0,5041303
ykgRp,0.3333333333333333,2,2,AGTGTATTTTATCGTAAAGC,0,5033120
ykgRp,0.3333333333333333,2,2,AGTGTAGACGGAATGAGAAC,0,5037853
ykgRp,0.3333333333333333,2,2,AGTGGGGGAGTTTTAGAGTC,0,5046699
ykgRp,0.3333333333333333,2,2,AGTGGAGGTTCACGATGCCC,0,5060751
ykgRp,0.3333333333333333,2,2,AGTGCGGGCCTTACAGGTTG,0,5047075
ykgRp,0.3333333333333333,2,2,AGTGCGCAAGTCAAGTCCGG,0,5058726
ykgRp,0.3333333333333333,2,2,AGTGATATACATGCGGTAGC,0,5051027
ykgRp,0.3333333333333333,2,2,AGTCTCAATGGGCTACGAGG,0,5034310
ykgRp,0.3333333333333333,2,2,AGTCCTTTCTATCAGTACGT,0,5051901
ykgRp,0.3333333333333333,2,2,AGTCCCGTGACGATAGACAG,0,5049050
ykgRp,0.3333333333333333,2,2,AGTCCAGTACTAGACACAAG,0,5050591
ykgRp,0.3333333333333333,2,2,AGTCATCATCAGCATTTGCA,0,5034166
ykgRp,0.3333333333333333,2,2,AGTAGTTTGACGGTGGGCGT,0,5057658
ykgRp,0.3333333333333333,2,2,AGTAGTTTAATTCTCGGGGG,0,5036000
ykgRp,0.3333333333333333,2,2,AGTAGTCCATTAGTCCATTC,0,5052540
ykgRp,0.3333333333333333,2,2,AGTAGGTGGAGGGCGGTGTG,0,5059666
ykgRp,0.3333333333333333,2,2,AGTAGAACTCGGATTGTGCT,0,5056262
ykgRp,0.3333333333333333,2,2,AGTACAGTTGGCGACGCGCA,0,5032545
ykgRp,0.3333333333333333,2,2,AGTAATTGATTTGATTGCGT,0,5052250
ykgRp,0.3333333333333333,2,2,AGGTCCCTTAGCTGGACGCT,0,5049136
ykgRp,0.3333333333333333,2,2,AGGTCACGGGTAGCTGACGG,0,5038243
ykgRp,0.3333333333333333,2,2,AGGTATTGATTGCTGCAAAG,0,5045607
ykgRp,0.3333333333333333,2,2,AGGTAGGGTTCTTTGAGTAA,0,5054850
ykgRp,0.3333333333333333,2,2,AGGTAAAAAGTAACTGTTAC,0,5034878
ykgRp,0.3333333333333333,2,2,AGGGTTAGCGATCCGGCGCT,0,5046430
ykgRp,0.3333333333333333,2,2,AGGGCATCGGCTTGACGCGT,0,5042908
ykgRp,0.3333333333333333,2,2,AGGGACCCGGCGACTCTGTT,0,5050942
ykgRp,0.3333333333333333,2,2,AGGCTGGTTGCGGCTTATGC,0,5045048
ykgRp,0.3333333333333333,2,2,AGGCTATGGTTCCAAAGCGG,0,5055996
ykgRp,0.3333333333333333,2,2,AGGCGCCATTCAGGCTTCAC,0,5039067
ykgRp,0.3333333333333333,2,2,AGGCCACTGTATAATGCGTC,0,5060987
ykgRp,0.3333333333333333,2,2,AGGCATTCATCTCTACTGGA,0,5057040
ykgRp,0.3333333333333333,2,2,AGGCACAAAGTGTAGTGCTA,0,5049627
ykgRp,0.3333333333333333,2,2,AGGATTGCGATAATGAGAAG,0,5042553
ykgRp,0.3333333333333333,2,2,AGGATTCGAGCCGCATTGCG,0,5037056
ykgRp,0.3333333333333333,2,2,AGGATGTTTTAAAGTAAACC,0,5033349
ykgRp,0.3333333333333333,2,2,AGGATGATGGATGACAGCTA,0,5059935
ykgRp,0.3333333333333333,2,2,AGGATCCGACCCTAGTCGCT,0,5040452
ykgRp,0.3333333333333333,2,2,AGGAGTTAATAACTACTGCA,0,5050928
ykgRp,0.3333333333333333,2,2,AGGAGTGTACCAGCGAACAC,0,5050252
ykgRp,0.3333333333333333,2,2,AGGAGTCTCCACCCAGGGAG,0,5034471
ykgRp,0.3333333333333333,2,2,AGGAGGGTTCCCGCAGGCAG,0,5037600
ykgRp,0.3333333333333333,2,2,AGGAGCCAAAAATGCCGGCA,0,5039021
ykgRp,0.3333333333333333,2,2,AGGACCCAAGAACCAGAGAG,0,5036632
ykgRp,0.3333333333333333,2,2,AGGAACTGAGTTCGCTCTGT,0,5048796
ykgRp,0.3333333333333333,2,2,AGGAAAAGACTCCTACTGAG,0,5048930
ykgRp,0.3333333333333333,2,2,AGCTGTGACTCGCTCTCAGG,0,5049985
ykgRp,0.3333333333333333,2,2,AGCTGCATATTGGAGCACCA,0,5056017
ykgRp,0.3333333333333333,2,2,AGCTGATAATAGTATTGTGA,0,5051273
ykgRp,0.3333333333333333,2,2,AGCTCTCTACGCGAGTAAAA,0,5054050
ykgRp,0.3333333333333333,2,2,AGCTCAGTGTATTAAGGGTA,0,5040149
ykgRp,0.3333333333333333,2,2,AGCTAGGTGCACCACGAAAT,0,5034922
ykgRp,0.3333333333333333,2,2,AGCTACCCTCAAATCTGCAC,0,5057145
ykgRp,0.3333333333333333,2,2,AGCGTTCGGTAGGTAAACTG,0,5050612
ykgRp,0.3333333333333333,2,2,AGCGTGTAAAGCCATTTTGC,0,5045442
ykgRp,0.3333333333333333,2,2,AGCGTGCGCGAGTTTGCAGA,0,5032253
ykgRp,0.3333333333333333,2,2,AGCGTGCAACCACCACGAGG,0,5045838
ykgRp,0.3333333333333333,2,2,AGCGTCTAGGGTTACCGAAA,0,5044204
ykgRp,0.3333333333333333,2,2,AGCGCTAGACCCATGTTAGT,0,5037077
ykgRp,0.3333333333333333,2,2,AGCGCGGGTCCTGGTCGCGT,0,5061159
ykgRp,0.3333333333333333,2,2,AGCGATGCCCGATTTTGAGC,0,5049038
ykgRp,0.3333333333333333,2,2,AGCGAGCACTATTTTAAACG,0,5050681
ykgRp,0.3333333333333333,2,2,AGCGACCGTTCTAAGAGGGA,0,5034344
ykgRp,0.3333333333333333,2,2,AGCCTGTCAGTTACTACAAT,0,5042580
ykgRp,0.3333333333333333,2,2,AGCCGTCAAAATCTCTAACG,0,5048737
ykgRp,0.3333333333333333,2,2,AGCCGGCATCCGTATATGGG,0,5051502
ykgRp,0.3333333333333333,2,2,AGCCGCTCGCGTTTGGTCCA,0,5052011
ykgRp,0.3333333333333333,2,2,AGCCCTGCTCCAGTGCAAGC,0,5037988
ykgRp,0.3333333333333333,2,2,AGCCCAGGACACCCCCTCGC,0,5045912
ykgRp,0.3333333333333333,2,2,AGCCATCGTTTTTACACGGC,0,5036856
ykgRp,0.3333333333333333,2,2,AGCCAGAGCGTTGCTGATTG,0,5052297
ykgRp,0.3333333333333333,2,2,AGCAATGGATCGTATGGCTC,0,5035938
ykgRp,0.3333333333333333,2,2,AGCAACGAAGCTTCCCCGAT,0,5061132
ykgRp,0.3333333333333333,2,2,AGATTGCTGTGCCTTGGAGG,0,5053252
ykgRp,0.3333333333333333,2,2,AGATTACGTTCAAGGATTAA,0,5033426
ykgRp,0.3333333333333333,2,2,AGATTAAAGATGAGTGCCGA,0,5052234
ykgRp,0.3333333333333333,2,2,AGATGGGTTGACGCGCAATC,0,5052259
ykgRp,0.3333333333333333,2,2,AGATGCAGTCTTTTAACTGC,0,5035124
ykgRp,0.3333333333333333,2,2,AGATCTGGACGGCCACGGTA,0,5032397
ykgRp,0.3333333333333333,2,2,AGAGTGCATTCCAGTCCATT,0,5059525
ykgRp,0.3333333333333333,2,2,AGAGTATTTTCGATAATGCA,0,5034203
ykgRp,0.3333333333333333,2,2,AGAGTACGCGGTTCTGTGGT,0,5046622
ykgRp,0.3333333333333333,2,2,AGAGGTCCGTGAGAGTCTCT,0,5055600
ykgRp,0.3333333333333333,2,2,AGAGGGTTGAAGATCATCAC,0,5043505
ykgRp,0.3333333333333333,2,2,AGAGATCTTCGCACTGCCAC,0,5051155
ykgRp,0.3333333333333333,2,2,AGAGAGGGGGCGTCAAACTC,0,5037287
ykgRp,0.3333333333333333,2,2,AGAGAGCAGGGGCACTCATG,0,5044841
ykgRp,0.3333333333333333,2,2,AGACATTGTGGATCGCGTAT,0,5056253
ykgRp,0.3333333333333333,2,2,AGACACCTCCGCACCAGGCA,0,5052008
ykgRp,0.3333333333333333,2,2,AGACACCCCAGAGGCCCTAT,0,5046499
ykgRp,0.3333333333333333,2,2,AGACACACATCCATCTCGTA,0,5053510
ykgRp,0.3333333333333333,2,2,AGACAACATGCCCTTTTAAG,0,5040317
ykgRp,0.3333333333333333,2,2,AGAATTCTATAGTAGGTACA,0,5037091
ykgRp,0.3333333333333333,2,2,AGAATTCGCACAAAAGCTCT,0,5037459
ykgRp,0.3333333333333333,2,2,AGAATGTCAGGGTATTGCGT,0,5045509
ykgRp,0.3333333333333333,2,2,AGAAGTCGTAAATCTGCGAT,0,5042724
ykgRp,0.3333333333333333,2,2,AGAAGACAATCTGTAGACTT,0,5052278
ykgRp,0.3333333333333333,2,2,AGAACGACTCCTAATGCTTC,0,5041883
ykgRp,0.3333333333333333,2,2,AGAACCGGAAGTTCAAAGGG,0,5045925
ykgRp,0.3333333333333333,2,2,AGAACAGGTCGCCCGCCTAT,0,5033257
ykgRp,0.3333333333333333,2,2,ACTTTCGTATAGAGTGTAAG,0,5041509
ykgRp,0.3333333333333333,2,2,ACTTTCAAAGGACCCTGGGA,0,5053338
ykgRp,0.3333333333333333,2,2,ACTTGTAGATACAACATTAC,0,5051467
ykgRp,0.3333333333333333,2,2,ACTTGATGAGATCACCAGCA,0,5033149
ykgRp,0.3333333333333333,2,2,ACTTCGCTTAAACCGGGGAC,0,5057473
ykgRp,0.3333333333333333,2,2,ACTTCGAAGGATCACGTGAA,0,5051838
ykgRp,0.3333333333333333,2,2,ACTTCGAAACGACCGGGCAT,0,5051140
ykgRp,0.3333333333333333,2,2,ACTTATGAAAGGTTAATGGG,0,5044849
ykgRp,0.3333333333333333,2,2,ACTTACTGCGACTGTTATTA,0,5061139
ykgRp,0.3333333333333333,2,2,ACTTACAAACGCTGTGTAGA,0,5032451
ykgRp,0.3333333333333333,2,2,ACTTAAGGGAGGAGGGTGGT,0,5034363
ykgRp,0.3333333333333333,2,2,ACTTAAGCACCCGAACCGCG,0,5036879
ykgRp,0.3333333333333333,2,2,ACTGTGCAAATATGGCTCCG,0,5051069
ykgRp,0.3333333333333333,2,2,ACTGTCGCAGTATCGACCAT,0,5040132
ykgRp,0.3333333333333333,2,2,ACTGGGTTAGCACCGCGGAA,0,5042460
ykgRp,0.3333333333333333,2,2,ACTGGCAACCAGAACAAGAT,0,5033757
ykgRp,0.3333333333333333,2,2,ACTGCGGGGTTTACACGGGC,0,5057887
ykgRp,0.3333333333333333,2,2,ACTGCCAGTAGGAGTCCCTC,0,5040097
ykgRp,0.3333333333333333,2,2,ACTGATCTGACTATTCCGGG,0,5037952
ykgRp,0.3333333333333333,2,2,ACTCTACCCCTATCATAAAG,0,5034391
ykgRp,0.3333333333333333,2,2,ACTCGTACATACAAGTGCCT,0,5041031
ykgRp,0.3333333333333333,2,2,ACTCGGTTTAATGACGCGTA,0,5036280
ykgRp,0.3333333333333333,2,2,ACTCCGTATTCCGTATCGGG,0,5060816
ykgRp,0.3333333333333333,2,2,ACTCAGACCACCTCCAATGG,0,5050214
ykgRp,0.3333333333333333,2,2,ACTCAATGATTGTAATGCCA,0,5045885
ykgRp,0.3333333333333333,2,2,ACTCAAGTCATGCCGGTTAA,0,5032837
ykgRp,0.3333333333333333,2,2,ACTATTTGCTCGACTTAAGC,0,5040437
ykgRp,0.3333333333333333,2,2,ACTATGAGTACTGGACATAG,0,5044680
ykgRp,0.3333333333333333,2,2,ACTACGAGTTGACCAACCGG,0,5040245
ykgRp,0.3333333333333333,2,2,ACTACCACGGGGAACTGTAG,0,5042173
ykgRp,0.3333333333333333,2,2,ACGTTTTCAGATCAAACTAA,0,5049534
ykgRp,0.3333333333333333,2,2,ACGTTACTAAGGGAGAAGTA,0,5059620
ykgRp,0.3333333333333333,2,2,ACGTCGTGCCATACTTAGAA,0,5042007
ykgRp,0.3333333333333333,2,2,ACGTATTTGTGTTTTGATGC,0,5046340
ykgRp,0.3333333333333333,2,2,ACGTATCCGTATGGCCGTTG,0,5043999
ykgRp,0.3333333333333333,2,2,ACGTACATATCATACCCGGT,0,5052654
ykgRp,0.3333333333333333,2,2,ACGGGACGCGGCAGTGTATA,0,5041472
ykgRp,0.3333333333333333,2,2,ACGGGAATTTTACTTAGTAG,0,5051542
ykgRp,0.3333333333333333,2,2,ACGGCATATGCTGAAAAGGG,0,5048115
ykgRp,0.3333333333333333,2,2,ACGGACAGAGGAGATATTTG,0,5033342
ykgRp,0.3333333333333333,2,2,ACGCTTACTCTGTCAATGGG,0,5041222
ykgRp,0.3333333333333333,2,2,ACGCTGACACAAGTCCCCGT,0,5041251
ykgRp,0.3333333333333333,2,2,ACGCTACCTGGACCGCTAAC,0,5036377
ykgRp,0.3333333333333333,2,2,ACGCTACAAGCGTGTGAATG,0,5046615
ykgRp,0.3333333333333333,2,2,ACGCAGTCTCCAATCTGCCC,0,5057674
ykgRp,0.3333333333333333,2,2,ACGCACGGCAGCTCCGGGGG,0,5035390
ykgRp,0.3333333333333333,2,2,ACGATCTGATCCGCACTTAC,0,5051823
ykgRp,0.3333333333333333,2,2,ACGATATCCGGTCTCCGTAT,0,5040535
ykgRp,0.3333333333333333,2,2,ACGAGAATTTGGTCGTACAC,0,5058649
ykgRp,0.3333333333333333,2,2,ACGACTCGACTGTATCCATC,0,5043185
ykgRp,0.3333333333333333,2,2,ACGACTCCTACCGGGCTTTA,0,5053037
ykgRp,0.3333333333333333,2,2,ACGACCCCGTGATATTCTGG,0,5051485
ykgRp,0.3333333333333333,2,2,ACGAAATCATAAACATGATC,0,5044333
ykgRp,0.3333333333333333,2,2,ACCTTCGTCGTTCATTCTCA,0,5060184
ykgRp,0.3333333333333333,2,2,ACCTGGAACCTCTAGGGTCC,0,5049598
ykgRp,0.3333333333333333,2,2,ACCTGAGAACATATCGCTCC,0,5032189
ykgRp,0.3333333333333333,2,2,ACCTCGTAGGATCTCTCTTT,0,5048487
ykgRp,0.3333333333333333,2,2,ACCTAGAGGCTCGAGCAAGA,0,5035339
ykgRp,0.3333333333333333,2,2,ACCGTTCCTGAGGATAGAGA,0,5046114
ykgRp,0.3333333333333333,2,2,ACCGAGGCTTAACTCTGTGG,0,5033031
ykgRp,0.3333333333333333,2,2,ACCCTTCGGGCGGACCCTGT,0,5049034
ykgRp,0.3333333333333333,2,2,ACCCTGACCGAATACATCCA,0,5046898
ykgRp,0.3333333333333333,2,2,ACCCGGAAAGTCCAGAGTTC,0,5048459
ykgRp,0.3333333333333333,2,2,ACCCACGTCTACTTGTAACT,0,5048053
ykgRp,0.3333333333333333,2,2,ACCATTTTTCGACTCTGATT,0,5043882
ykgRp,0.3333333333333333,2,2,ACCAGAAAATCCAGGGAGGG,0,5044285
ykgRp,0.3333333333333333,2,2,ACCACGTGCGAGGATGCCCG,0,5054991
ykgRp,0.3333333333333333,2,2,ACCACCAGCACTTGATCTCG,0,5048070
ykgRp,0.3333333333333333,2,2,ACATTTAATCGGGGTGGTTC,0,5043903
ykgRp,0.3333333333333333,2,2,ACATGTCCTGGAATTTTCCC,0,5032727
ykgRp,0.3333333333333333,2,2,ACATCGGTTCTGAGACACAA,0,5058597
ykgRp,0.3333333333333333,2,2,ACATCGGGCGTCACAGACTA,0,5043826
ykgRp,0.3333333333333333,2,2,ACATCGCAATGTTGCGGTAC,0,5058921
ykgRp,0.3333333333333333,2,2,ACATAACCTCTGGTTTTTTG,0,5055163
ykgRp,0.3333333333333333,2,2,ACAGTTTCGCCATAACCTTG,0,5049809
ykgRp,0.3333333333333333,2,2,ACAGTTCACCCTCCCTTAGT,0,5050476
ykgRp,0.3333333333333333,2,2,ACAGTAGGGCAGCATACAAT,0,5035114
ykgRp,0.3333333333333333,2,2,ACAGCGGTCCCAGTCTGGAT,0,5049071
ykgRp,0.3333333333333333,2,2,ACACTCCGCTGCACTTTATT,0,5055197
ykgRp,0.3333333333333333,2,2,ACACTATGGCACGTGGTAGT,0,5044032
ykgRp,0.3333333333333333,2,2,ACACTACCAACTCAAGATCA,0,5057377
ykgRp,0.3333333333333333,2,2,ACACGTAAATGCAGTTATTT,0,5047624
ykgRp,0.3333333333333333,2,2,ACACGGTTGTTAGTAAGGTG,0,5054730
ykgRp,0.3333333333333333,2,2,ACACGGCACTATCACGACAA,0,5048754
ykgRp,0.3333333333333333,2,2,ACACCAAGACTAGGACAAGT,0,5047921
ykgRp,0.3333333333333333,2,2,ACACAAGGCATTCGCTAAAG,0,5032618
ykgRp,0.3333333333333333,2,2,ACAAGTGCTTCCAGAATGCT,0,5036820
ykgRp,0.3333333333333333,2,2,ACAAGGCAGTTCGTTCGCTC,0,5055285
ykgRp,0.3333333333333333,2,2,ACAACTCCGACGTCCCTACT,0,5045514
ykgRp,0.3333333333333333,2,2,ACAACTCCACTTGAGTTAGT,0,5048151
ykgRp,0.3333333333333333,2,2,ACAAACAGCTCAGTACGAGC,0,5055774
ykgRp,0.3333333333333333,2,2,AATTTGTGGAGGCGGTTTCG,0,5038562
ykgRp,0.3333333333333333,2,2,AATTTGACATGCGCAGGCAT,0,5039118
ykgRp,0.3333333333333333,2,2,AATTGCCGTTAAATTGTTGC,0,5039513
ykgRp,0.3333333333333333,2,2,AATTGCAGACATATTACGAT,0,5032515
ykgRp,0.3333333333333333,2,2,AATTAATCAACTCCAGGCAG,0,5037574
ykgRp,0.3333333333333333,2,2,AATGTCTTAGGTGGTGGACC,0,5042212
ykgRp,0.3333333333333333,2,2,AATGTAGGTTGTGCCGATTG,0,5039428
ykgRp,0.3333333333333333,2,2,AATGGTGAAATGTGTTAGAG,0,5050679
ykgRp,0.3333333333333333,2,2,AATGGCGCAAGAAGTGGTTC,0,5048320
ykgRp,0.3333333333333333,2,2,AATGGCCATGACCTACCATT,0,5052743
ykgRp,0.3333333333333333,2,2,AATGCTGCAGCCTTAGTCAA,0,5057468
ykgRp,0.3333333333333333,2,2,AATGAGCGTAGAGCTCTGTC,0,5040756
ykgRp,0.3333333333333333,2,2,AATGAAAAGTCAGATTCTTT,0,5059975
ykgRp,0.3333333333333333,2,2,AATCCGGGAGACATAAACTG,0,5050769
ykgRp,0.3333333333333333,2,2,AATCCCAGAGATATATACAG,0,5047909
ykgRp,0.3333333333333333,2,2,AATCCAGAGTGCTTCCCGTC,0,5034096
ykgRp,0.3333333333333333,2,2,AATCAAGACTGTTTATGATC,0,5032954
ykgRp,0.3333333333333333,2,2,AATATTCTTCGTTATTAGGC,0,5037809
ykgRp,0.3333333333333333,2,2,AATAGGTGGTTAGCGTTGGA,0,5061130
ykgRp,0.3333333333333333,2,2,AATAGGCAGGCGGAGGCCTT,0,5043343
ykgRp,0.3333333333333333,2,2,AATAGCCGGGGGTAGACTAA,0,5049288
ykgRp,0.3333333333333333,2,2,AATAGATGCGTACAGAATAA,0,5056888
ykgRp,0.3333333333333333,2,2,AAGTTTCGACCCACTACCGT,0,5040923
ykgRp,0.3333333333333333,2,2,AAGTGACTGTGATAAGGCGT,0,5049662
ykgRp,0.3333333333333333,2,2,AAGTCGGCCGCAGCTTGCGC,0,5044008
ykgRp,0.3333333333333333,2,2,AAGTCAGTCAGTCGTAAGCT,0,5040491
ykgRp,0.3333333333333333,2,2,AAGTAGTCCTCAGTAAATCA,0,5048563
ykgRp,0.3333333333333333,2,2,AAGTACATGGAACGTCAACT,0,5036351
ykgRp,0.3333333333333333,2,2,AAGGTTGGGAGCACTTATTC,0,5051919
ykgRp,0.3333333333333333,2,2,AAGGTCATTTGTGGCGTTCT,0,5052192
ykgRp,0.3333333333333333,2,2,AAGGGATGCCCAACTACTTA,0,5059075
ykgRp,0.3333333333333333,2,2,AAGGGAAGTAAGTCGTCTAT,0,5057631
ykgRp,0.3333333333333333,2,2,AAGGCCTGTGATTTGCAGGG,0,5058731
ykgRp,0.3333333333333333,2,2,AAGGAATCAGCGTTATTGGG,0,5048543
ykgRp,0.3333333333333333,2,2,AAGGAAGGGTCTCGCCTCAC,0,5042923
ykgRp,0.3333333333333333,2,2,AAGCTGCGATATCTCTTCAC,0,5049349
ykgRp,0.3333333333333333,2,2,AAGCGGAGATGACCTCTCGA,0,5058774
ykgRp,0.3333333333333333,2,2,AAGCGCATACCCTATTGAGT,0,5049102
ykgRp,0.3333333333333333,2,2,AAGCCCCACAACGTGTAATT,0,5039240
ykgRp,0.3333333333333333,2,2,AAGCCATATATACGACGACA,0,5050744
ykgRp,0.3333333333333333,2,2,AAGCCACGGAAAGGTCAATG,0,5033204
ykgRp,0.3333333333333333,2,2,AAGCAATGTGTGAATTTAAA,0,5047380
ykgRp,0.3333333333333333,2,2,AAGCAAATATCTTCGTGAAC,0,5036029
ykgRp,0.3333333333333333,2,2,AAGATTACACTCTGGCGCTA,0,5034616
ykgRp,0.3333333333333333,2,2,AAGATCCTTCTGTGTCAAGT,0,5056863
ykgRp,0.3333333333333333,2,2,AAGAGTGTGACTTGGATAAA,0,5035617
ykgRp,0.3333333333333333,2,2,AAGAGGGTACGGGGGCGCCC,0,5051624
ykgRp,0.3333333333333333,2,2,AAGACTGTTTATCGGCAAGT,0,5035028
ykgRp,0.3333333333333333,2,2,AAGACCCCGTGTCAAAGAGT,0,5040530
ykgRp,0.3333333333333333,2,2,AACTGAGCTTTAGTGTCACT,0,5053615
ykgRp,0.3333333333333333,2,2,AACTAGGTAGCGCAGTCCCC,0,5031965
ykgRp,0.3333333333333333,2,2,AACGGGACCTTGTGAGATTT,0,5056873
ykgRp,0.3333333333333333,2,2,AACGGCATTACAATGATCTC,0,5056232
ykgRp,0.3333333333333333,2,2,AACGCTTTTCCAACGGAATC,0,5048449
ykgRp,0.3333333333333333,2,2,AACGCGAATTCTCAATATCT,0,5056962
ykgRp,0.3333333333333333,2,2,AACGCCTATCCATAAGCTTT,0,5057345
ykgRp,0.3333333333333333,2,2,AACGCCGCGTAGGTACTGAG,0,5060037
ykgRp,0.3333333333333333,2,2,AACGCCCCCGTATATGGCCC,0,5043840
ykgRp,0.3333333333333333,2,2,AACGCACAGGACCCGACCAC,0,5059177
ykgRp,0.3333333333333333,2,2,AACGAACGGCACTCCACATG,0,5033164
ykgRp,0.3333333333333333,2,2,AACGAACATTAATGCGGCGG,0,5053571
ykgRp,0.3333333333333333,2,2,AACCTCCGGTATTAGTCCTA,0,5046157
ykgRp,0.3333333333333333,2,2,AACCGGCAACGTCATATTAG,0,5032930
ykgRp,0.3333333333333333,2,2,AACCCTCCACGGCGTAATTT,0,5035965
ykgRp,0.3333333333333333,2,2,AACCATTGAGGCAAGGCGGC,0,5043536
ykgRp,0.3333333333333333,2,2,AACCATGCACATTCCAGGCA,0,5043665
ykgRp,0.3333333333333333,2,2,AACATTGTCGTCATCGATCT,0,5058723
ykgRp,0.3333333333333333,2,2,AACATGTTATGTACGTCAGT,0,5043747
ykgRp,0.3333333333333333,2,2,AACATCTACAAAGCCTCAAG,0,5032915
ykgRp,0.3333333333333333,2,2,AACAGTCGGTCTTTGAGCCC,0,5034822
ykgRp,0.3333333333333333,2,2,AACACCTGTAGTCGATACGG,0,5059725
ykgRp,0.3333333333333333,2,2,AACACCCTATGTTTAGCGGC,0,5054371
ykgRp,0.3333333333333333,2,2,AACACACAGTTCTTTGGTAT,0,5059056
ykgRp,0.3333333333333333,2,2,AACACAAGGCCATCCTCGAT,0,5048101
ykgRp,0.3333333333333333,2,2,AACACAACCATACATCCGAC,0,5048350
ykgRp,0.3333333333333333,2,2,AACAATGCAAATAACACGGC,0,5038171
ykgRp,0.3333333333333333,2,2,AACAAAGGAATACGTCGGGC,0,5047049
ykgRp,0.3333333333333333,2,2,AAATTTGTACGGAGTTGTTG,0,5050253
ykgRp,0.3333333333333333,2,2,AAATGCAATGTCCGGTAGTC,0,5049052
ykgRp,0.3333333333333333,2,2,AAATGATGCAGTGCCCCATG,0,5053041
ykgRp,0.3333333333333333,2,2,AAATCTTGTTTGCGCACCTC,0,5043545
ykgRp,0.3333333333333333,2,2,AAATCCGAGGCAGCAGCGCC,0,5043763
ykgRp,0.3333333333333333,2,2,AAAGGGAAGGAATTCTCATA,0,5050644
ykgRp,0.3333333333333333,2,2,AAACTCAACCCACGCTGTAG,0,5051174
ykgRp,0.3333333333333333,2,2,AAACTAAACTATTACATCGC,0,5037161
ykgRp,0.3333333333333333,2,2,AAACGACGCGATCGAGTTTA,0,5046948
ykgRp,0.3333333333333333,2,2,AAACCAGTGAGTGACCAATG,0,5054481
ykgRp,0.3333333333333333,2,2,AAACCAGGGACGACAATAGA,0,5033039
ykgRp,0.3333333333333333,2,2,AAAATTCGTCCTCTGAAAGA,0,5052130
ykgRp,0.3333333333333333,2,2,AAAATGGGAAATGCCGCGCT,0,5052871
ykgRp,0.3333333333333333,2,2,AAAATGACCGGAAACAGTTC,0,5041968
ykgRp,0.3333333333333333,2,2,AAAACTTGATGAATTCAATG,0,5033657
ykgRp,0.3333333333333333,2,2,AAAACGCTACTTCGGTTCGT,0,5045161
ykgRp,0.3333333333333333,2,2,AAAAATCCATTACAGCTTCT,0,5056758
ykgRp,0.5,1,1,TTTTTGGAGGGTAGTCTGTT,0,5060138
ykgRp,0.5,1,1,TTTTTCTGCTAAATGGCGCG,0,5031963
ykgRp,0.5,1,1,TTTTGCACTATGGAGGCTTG,0,5053088
ykgRp,0.5,1,1,TTTGACTGCCAATCCATCGT,0,5046630
ykgRp,0.5,1,1,TTTCTTGGCGACGGCCCTAG,0,5045946
ykgRp,0.5,1,1,TTTCTGTGTTCACACTCCCG,0,5040504
ykgRp,0.5,1,1,TTTCTCAGTGGTCGGCAACA,0,5034984
ykgRp,0.5,1,1,TTTCGTCAGGTTTGTAATGA,0,5036386
ykgRp,0.5,1,1,TTTCGAGGTCTTGCAAACTT,0,5041724
ykgRp,0.5,1,1,TTTCGAGCCATTTTCTTTAA,0,5032624
ykgRp,0.5,1,1,TTTCATGGCCCCGGTGATAC,0,5052503
ykgRp,0.5,1,1,TTTCAGGTCTGGACCGATTC,0,5042030
ykgRp,0.5,1,1,TTTCAGGATATGAAACTGGA,0,5057690
ykgRp,0.5,1,1,TTTCAAAGGAGGTCTGCGAA,0,5034392
ykgRp,0.5,1,1,TTTATGCTAGCGCAGCGCGG,0,5034025
ykgRp,0.5,1,1,TTTATCGAGTTAGCCTGCTC,0,5036185
ykgRp,0.5,1,1,TTTAGCCGTGCCGCCAGGGA,0,5031543
ykgRp,0.5,1,1,TTTAGAAATTCGCGGATCAG,0,5038742
ykgRp,0.5,1,1,TTTACGTTGGGGGCGTCGTG,0,5036851
ykgRp,0.5,1,1,TTTACGGGTAACTTCTGTTT,0,5041634
ykgRp,0.5,1,1,TTTACGGCCCGATCAGTCTT,0,5036272
ykgRp,0.5,1,1,TTTACGAGGTCAGTCACGAC,0,5043875
ykgRp,0.5,1,1,TTTACACATAATTTTATCAT,0,5040675
ykgRp,0.5,1,1,TTTAAAGTCATAAAATTGAG,0,5038331
ykgRp,0.5,1,1,TTTAAACGGGCTCCACTGCT,0,5052839
ykgRp,0.5,1,1,TTTAAAATTGTGCCGTCCCC,0,5049462
ykgRp,0.5,1,1,TTGTTAGTGTGCAAGCTACA,0,5055550
ykgRp,0.5,1,1,TTGTTAACATCGGTTAGCAG,0,5055962
ykgRp,0.5,1,1,TTGTCTTATACCAGGCGATT,0,5043808
ykgRp,0.5,1,1,TTGTCCGAAACTAATGCATC,0,5044018
ykgRp,0.5,1,1,TTGTCCAGGGTATTCTAAAT,0,5050850
ykgRp,0.5,1,1,TTGTCACCGAGCGAGGCTAG,0,5042620
ykgRp,0.5,1,1,TTGTATTGTGATCATGGGAT,0,5037629
ykgRp,0.5,1,1,TTGTACGGCCAAACTGTCGG,0,5042997
ykgRp,0.5,1,1,TTGTACACGACGCTAGGTAC,0,5053721
ykgRp,0.5,1,1,TTGGTGGGTCCGACTGGCGA,0,5049757
ykgRp,0.5,1,1,TTGGGATATGTGCTCTACAT,0,5055859
ykgRp,0.5,1,1,TTGGGAGTCCTGGAACAGCC,0,5059229
ykgRp,0.5,1,1,TTGGCTCAATGCGGAGCGGA,0,5050055
ykgRp,0.5,1,1,TTGGCGCACGAACGTTGGTT,0,5043699
ykgRp,0.5,1,1,TTGGATGCCAGGAGTTAAGA,0,5050604
ykgRp,0.5,1,1,TTGGACTAGATGACTTCTAC,0,5044943
ykgRp,0.5,1,1,TTGCTGAACCTTGCCCCTGA,0,5034874
ykgRp,0.5,1,1,TTGCCAGAACGCTACTAATA,0,5048797
ykgRp,0.5,1,1,TTGCACTGGTGCTTCTGGCT,0,5058652
ykgRp,0.5,1,1,TTGATTAAGCAACGACCCAC,0,5046068
ykgRp,0.5,1,1,TTGATGAACATAAGGCGACC,0,5046404
ykgRp,0.5,1,1,TTGAGATTAATTGGTATCGA,0,5043928
ykgRp,0.5,1,1,TTGAGAACTTCGTTGGGATT,0,5057599
ykgRp,0.5,1,1,TTGACGCGAGTGTTATCTTG,0,5051950
ykgRp,0.5,1,1,TTGAAGGTTACAAATTTACT,0,5045676
ykgRp,0.5,1,1,TTGAAACTGTAGCAGACATT,0,5040945
ykgRp,0.5,1,1,TTCTTTTTGCGTTGTGCAGA,0,5056523
ykgRp,0.5,1,1,TTCTTGAACATCCGACAAGA,0,5055717
ykgRp,0.5,1,1,TTCTCTATGAGGGTGGTGTA,0,5035034
ykgRp,0.5,1,1,TTCTCCGGAATCTCGATCCA,0,5048848
ykgRp,0.5,1,1,TTCTATATATGGAGCACCAG,0,5061447
ykgRp,0.5,1,1,TTCGTGTAGCGTTAAGGTTT,0,5048324
ykgRp,0.5,1,1,TTCGGTTCGCAAACTCGTAT,0,5031662
ykgRp,0.5,1,1,TTCGGTGACTCAAACGTTTA,0,5046720
ykgRp,0.5,1,1,TTCGGACGGAGCTAGAACTT,0,5056659
ykgRp,0.5,1,1,TTCGGAAGAGTCGCCTGACC,0,5043235
ykgRp,0.5,1,1,TTCGCGAGGGGTAGGCGGGG,0,5053895
ykgRp,0.5,1,1,TTCGCCTTAAACCAATGTTT,0,5041523
ykgRp,0.5,1,1,TTCGCCGTATCTCCAAACCT,0,5046083
ykgRp,0.5,1,1,TTCCGAAGGAAATTGGTCTA,0,5052416
ykgRp,0.5,1,1,TTCCCGAGTTCACGCAATTC,0,5039276
ykgRp,0.5,1,1,TTCCCCGCTATGGCATCTAT,0,5050122
ykgRp,0.5,1,1,TTCCCCCGTCAAATTCTCTC,0,5058525
ykgRp,0.5,1,1,TTCCCCCGCCCCCATGAGCC,0,5048569
ykgRp,0.5,1,1,TTCATACCATGGCTGCCCTT,0,5048306
ykgRp,0.5,1,1,TTCAGCATATGAGAGGGACG,0,5049772
ykgRp,0.5,1,1,TTCAGCACCGCGACTGCCTA,0,5047170
ykgRp,0.5,1,1,TTCACTGAGTCTTTCCCATG,0,5032934
ykgRp,0.5,1,1,TTCACGACATACGCTGAGAG,0,5031783
ykgRp,0.5,1,1,TTCAACTACTGAAATCCGCT,0,5034762
ykgRp,0.5,1,1,TTCAAAACGTAGTTTGCTTC,0,5035093
ykgRp,0.5,1,1,TTATTTTCCGTTCTCGCTAA,0,5046533
ykgRp,0.5,1,1,TTATTTCGTGCGGCCCAGGC,0,5049786
ykgRp,0.5,1,1,TTATTTCCCGATTTTCGAAT,0,5052069
ykgRp,0.5,1,1,TTATTGCATTAACTGTTTGT,0,5049564
ykgRp,0.5,1,1,TTATTACAGATCCAGGATGG,0,5046229
ykgRp,0.5,1,1,TTATGAGCGCCGGACCGGGA,0,5056779
ykgRp,0.5,1,1,TTATCAAACACTACTCGTTT,0,5037953
ykgRp,0.5,1,1,TTATATTTTCAAACGCACAG,0,5035973
ykgRp,0.5,1,1,TTATATATGACCTCTTGAGG,0,5039771
ykgRp,0.5,1,1,TTATACCGCGGACTTCTTAC,0,5047943
ykgRp,0.5,1,1,TTAGTCCCTAAGCTGGAAAG,0,5047214
ykgRp,0.5,1,1,TTAGTACCTACAGTTAATTT,0,5059138
ykgRp,0.5,1,1,TTAGTAAGCGTTTTACGCCA,0,5041216
ykgRp,0.5,1,1,TTAGGGACTCGATTGTGCTT,0,5060645
ykgRp,0.5,1,1,TTAGGCGCGTTGATTTCAGT,0,5053956
ykgRp,0.5,1,1,TTAGCGTTGACCTGGTTATC,0,5058223
ykgRp,0.5,1,1,TTAGCGCCTCGCGGCTTTGC,0,5060873
ykgRp,0.5,1,1,TTACTGGGGGGTGGGATTTG,0,5042639
ykgRp,0.5,1,1,TTACTGCTTGCAGCGTCGCT,0,5056726
ykgRp,0.5,1,1,TTACTAATCTTGCCAACACA,0,5055178
ykgRp,0.5,1,1,TTACGTGGTAACTGCCTCAA,0,5060735
ykgRp,0.5,1,1,TTACATAAAACTTTCGAGAG,0,5055779
ykgRp,0.5,1,1,TTACAGGCGTTTCGCCGGAA,0,5039549
ykgRp,0.5,1,1,TTAATTGAGTCTGCTGAAGC,0,5052450
ykgRp,0.5,1,1,TTAATCGCATATGGGTCATT,0,5042863
ykgRp,0.5,1,1,TTAATCGAATGACGGCACAA,0,5040871
ykgRp,0.5,1,1,TTAATCCATCACCAAGAGGA,0,5032742
ykgRp,0.5,1,1,TTAATAAGGTTCATCCAGTC,0,5041073
ykgRp,0.5,1,1,TTAAGCTAGCGGGCGTTCAC,0,5056492
ykgRp,0.5,1,1,TTAAGATGCGTCCTAGGTCT,0,5035448
ykgRp,0.5,1,1,TTAAGAGGGCGTGGTACCAT,0,5040414
ykgRp,0.5,1,1,TTAACTTGAGATGAGGCGTT,0,5032948
ykgRp,0.5,1,1,TTAACATGAACATTAGTTAA,0,5051829
ykgRp,0.5,1,1,TTAACAGTATTGCCACAAGG,0,5048915
ykgRp,0.5,1,1,TTAACAAGCAGCACAGGAAC,0,5046070
ykgRp,0.5,1,1,TTAAAGTGTGAATGCTCTGG,0,5037491
ykgRp,0.5,1,1,TTAAACTGTGCCATGCGACA,0,5032333
ykgRp,0.5,1,1,TTAAACCCTTTTGTTTGCCT,0,5042035
ykgRp,0.5,1,1,TTAAAAATTTTCGGTATCCA,0,5033899
ykgRp,0.5,1,1,TTAAAAACACTTGAGCGTCC,0,5052877
ykgRp,0.5,1,1,TGTTGCTTCATCCTTATCAT,0,5040986
ykgRp,0.5,1,1,TGTTCGGTTTACGACTATGG,0,5043619
ykgRp,0.5,1,1,TGTTATGGACAGTATTTTAT,0,5036082
ykgRp,0.5,1,1,TGTGTTATGGGGCACGCTCG,0,5039890
ykgRp,0.5,1,1,TGTGGAGGTTTACTACTGTC,0,5033839
ykgRp,0.5,1,1,TGTGCCGTTGTAGCAGGCAT,0,5041972
ykgRp,0.5,1,1,TGTGAGTAAATTCGGAAGTG,0,5039177
ykgRp,0.5,1,1,TGTGAAGGGCGCCGAGGTCG,0,5034663
ykgRp,0.5,1,1,TGTCTGACTCGGTCTTTATA,0,5055894
ykgRp,0.5,1,1,TGTCTACAACAACCTACGTC,0,5042232
ykgRp,0.5,1,1,TGTCAGGACCAGATCATTAA,0,5049876
ykgRp,0.5,1,1,TGTCAGAAACTATGAGGCAA,0,5037357
ykgRp,0.5,1,1,TGTATTCACGTTACGTAATA,0,5039758
ykgRp,0.5,1,1,TGTATTAGCCGCGCCAGAAC,0,5039058
ykgRp,0.5,1,1,TGTATGGTGTACGGAGAATT,0,5060595
ykgRp,0.5,1,1,TGTATGGGTCACTTCAACTT,0,5060110
ykgRp,0.5,1,1,TGTATCAATGGAGGCCGTGT,0,5047018
ykgRp,0.5,1,1,TGTAGTCTTTATGAGCCTAC,0,5057662
ykgRp,0.5,1,1,TGTACTTCTTCGTTGCTGAC,0,5040570
ykgRp,0.5,1,1,TGTACGTATATCTCGATCCT,0,5044369
ykgRp,0.5,1,1,TGTACCACCGGCAGTGTATA,0,5059773
ykgRp,0.5,1,1,TGTAACCTCTAGCCTGCCCC,0,5040819
ykgRp,0.5,1,1,TGGTTTGCATACACGACTTC,0,5035257
ykgRp,0.5,1,1,TGGTTTCTCAGAGGGTCCTG,0,5046011
ykgRp,0.5,1,1,TGGTTGTCTTTGTACACGAG,0,5061089
ykgRp,0.5,1,1,TGGTTCCTATGCATGGGTGT,0,5040200
ykgRp,0.5,1,1,TGGTTCCGTGGCGTGAAAAT,0,5037029
ykgRp,0.5,1,1,TGGTGTCCGGCGGTTTGCAA,0,5050852
ykgRp,0.5,1,1,TGGTGTACGTCTGCTCACAT,0,5046658
ykgRp,0.5,1,1,TGGTGCATAACACTGTTATA,0,5035835
ykgRp,0.5,1,1,TGGTCGAGGGCCACCCGATG,0,5036933
ykgRp,0.5,1,1,TGGTCCTCTGGAGTACTCCA,0,5049357
ykgRp,0.5,1,1,TGGTCCTAACAGGACGGAAA,0,5051289
ykgRp,0.5,1,1,TGGTCACCCATAACTCGAGC,0,5051886
ykgRp,0.5,1,1,TGGGTTAAGCTACTAATTAC,0,5054584
ykgRp,0.5,1,1,TGGGGTTGACGCCCGTTGAT,0,5054650
ykgRp,0.5,1,1,TGGGGTAAGTCATGCAGTTT,0,5032204
ykgRp,0.5,1,1,TGGGCCACGGGACCTCTCAT,0,5036006
ykgRp,0.5,1,1,TGGGCACCCGCTGGCCTCCG,0,5033265
ykgRp,0.5,1,1,TGGGAGAGACTAAATTGCGA,0,5059699
ykgRp,0.5,1,1,TGGCTTGTGTCGGGTGTTTG,0,5043055
ykgRp,0.5,1,1,TGGCTTCAAGACCGACCGGC,0,5032804
ykgRp,0.5,1,1,TGGCTATTATCAAGTTTTCT,0,5033624
ykgRp,0.5,1,1,TGGCTAGGCCCGCGAATTTG,0,5046494
ykgRp,0.5,1,1,TGGCCCCCCGATAGCACGGT,0,5055632
ykgRp,0.5,1,1,TGGCAGAAGCATTCATACTC,0,5055963
ykgRp,0.5,1,1,TGGCAACATTGTCATTCGTA,0,5048795
ykgRp,0.5,1,1,TGGATTTTACTACACGAGAA,0,5042643
ykgRp,0.5,1,1,TGGATGGAATTCGTGAAAAA,0,5055542
ykgRp,0.5,1,1,TGGATCCAACATCAGTCCCG,0,5046718
ykgRp,0.5,1,1,TGGATCATTTATGGGCAAAT,0,5056489
ykgRp,0.5,1,1,TGGAGGCTTCGTAGGTTGGC,0,5038049
ykgRp,0.5,1,1,TGGAGAACCACCGGAATGCT,0,5054662
ykgRp,0.5,1,1,TGGACATGGTCTGTCAGCGG,0,5058385
ykgRp,0.5,1,1,TGGAAGATATTTACGCCCAA,0,5040698
ykgRp,0.5,1,1,TGGAACCATATAGGCCCGAC,0,5039453
ykgRp,0.5,1,1,TGCTGTCTGCCGTGAGGTGT,0,5037259
ykgRp,0.5,1,1,TGCTAATGAGGGGTGGATCT,0,5054953
ykgRp,0.5,1,1,TGCGTGTGTGGGCCGCAACC,0,5035824
ykgRp,0.5,1,1,TGCGTGCACTGCATCGTCGG,0,5040182
ykgRp,0.5,1,1,TGCGTGATGTTCCGAAACCG,0,5046951
ykgRp,0.5,1,1,TGCGTACAGGGGAGTTACAT,0,5041114
ykgRp,0.5,1,1,TGCGGTAGGAAGTGATTAGT,0,5036135
ykgRp,0.5,1,1,TGCGCTAAGGGTCGCTTCGG,0,5047893
ykgRp,0.5,1,1,TGCGAACCATCTGACCGCAG,0,5057555
ykgRp,0.5,1,1,TGCCTAAGTTGATTGGGGAA,0,5051376
ykgRp,0.5,1,1,TGCCCGTGCGGGTCCCGAGC,0,5057000
ykgRp,0.5,1,1,TGCCCCTACGTAGGCTAATA,0,5056231
ykgRp,0.5,1,1,TGCCAGATGTGATCTTGCAA,0,5051594
ykgRp,0.5,1,1,TGCATAACTATCTTTTAATC,0,5055379
ykgRp,0.5,1,1,TGCAGGCTAGCTGAACGCAG,0,5034196
ykgRp,0.5,1,1,TGCAGCGCTTCCTCATATTG,0,5059742
ykgRp,0.5,1,1,TGCAGAGTTCCGCCCGATTC,0,5034702
ykgRp,0.5,1,1,TGCAGACTTGACGCGAATGG,0,5055219
ykgRp,0.5,1,1,TGATTTGGACTGTTGGCTAA,0,5059131
ykgRp,0.5,1,1,TGATTGGTGATCGGCGACAC,0,5044730
ykgRp,0.5,1,1,TGATTCACGAATTATCAAAC,0,5056438
ykgRp,0.5,1,1,TGATGTTGTGCATTCTCTGT,0,5042614
ykgRp,0.5,1,1,TGATGTCTTGATATGGGAGT,0,5042128
ykgRp,0.5,1,1,TGATGAATAATAAAATGATG,0,5051522
ykgRp,0.5,1,1,TGATAACCTTGTTATGTGGT,0,5036204
ykgRp,0.5,1,1,TGAGTGTGGCCGTAGGTAGC,0,5049065
ykgRp,0.5,1,1,TGAGTCGGGCGGTGTCCTTC,0,5039760
ykgRp,0.5,1,1,TGAGGCGTATCGACTTGTTA,0,5038003
ykgRp,0.5,1,1,TGAGGAGCAGCCCCTGAAGT,0,5051943
ykgRp,0.5,1,1,TGAGCTTGAATCTCTATAGT,0,5034457
ykgRp,0.5,1,1,TGAGCTGGTTTCTCTGTTGT,0,5053086
ykgRp,0.5,1,1,TGAGCGGTGAAGAACGGCAT,0,5045093
ykgRp,0.5,1,1,TGAGCATAGCGTAGTCCCAG,0,5055116
ykgRp,0.5,1,1,TGAGATAGGCCCGGCCTTCA,0,5052041
ykgRp,0.5,1,1,TGAGAGCCCAACGACTATTT,0,5042358
ykgRp,0.5,1,1,TGACTTTCAACATTAGGAGT,0,5058435
ykgRp,0.5,1,1,TGACTGGCCATCAGCTGGCG,0,5060634
ykgRp,0.5,1,1,TGACGAGGTCGGTTTCGAAA,0,5049411
ykgRp,0.5,1,1,TGACCTGTATTGTTTTCCGG,0,5032201
ykgRp,0.5,1,1,TGACAGTTTTCATTTCAGAT,0,5061360
ykgRp,0.5,1,1,TGACACATGGCGGAGGTTAA,0,5036543
ykgRp,0.5,1,1,TGACACAAAATTGGAGCCTA,0,5034061
ykgRp,0.5,1,1,TGAATGGTATAATGTCAATG,0,5038259
ykgRp,0.5,1,1,TGAAGTGGGTGACCGGACAC,0,5046346
ykgRp,0.5,1,1,TGAAGATTGTCAACATCTGC,0,5037611
ykgRp,0.5,1,1,TGAAGACACTATTGACAGTT,0,5055351
ykgRp,0.5,1,1,TGAACGGATGGGGACGTAAA,0,5044539
ykgRp,0.5,1,1,TGAACCTGTCTAGGGGTGTC,0,5061421
ykgRp,0.5,1,1,TCTTTCGAGCAGGTATATGT,0,5042657
ykgRp,0.5,1,1,TCTTGTAGGTTTAACCCAAC,0,5037569
ykgRp,0.5,1,1,TCTTGGTAACTCATGTGCTC,0,5055146
ykgRp,0.5,1,1,TCTTCACCGAATAAGCCTTG,0,5044236
ykgRp,0.5,1,1,TCTGGTGTGTTTTTCGACTC,0,5040224
ykgRp,0.5,1,1,TCTGATAGCGCCGAATTTAG,0,5054587
ykgRp,0.5,1,1,TCTGACGAAGCTAAGGGCGC,0,5039228
ykgRp,0.5,1,1,TCTCGCCTGGAGTTAGCCCA,0,5060971
ykgRp,0.5,1,1,TCTCCTAATCACGGGAACTC,0,5046131
ykgRp,0.5,1,1,TCTCCGCGATTTGCCTTTGC,0,5033450
ykgRp,0.5,1,1,TCTCCCGCGTTCGTTACAGC,0,5044506
ykgRp,0.5,1,1,TCTATTTTGAGGGATGCAAG,0,5047635
ykgRp,0.5,1,1,TCTATTCATGCTTCGCACAT,0,5056178
ykgRp,0.5,1,1,TCTATCGTAGCCCCTTCAGC,0,5032436
ykgRp,0.5,1,1,TCTATACCCATGTAAATGAC,0,5037787
ykgRp,0.5,1,1,TCTAGGTAGCTGAAAGCTCA,0,5033690
ykgRp,0.5,1,1,TCTACGTTATAGATCCTCGA,0,5053087
ykgRp,0.5,1,1,TCTACAGTAGTGTACTCCAA,0,5040813
ykgRp,0.5,1,1,TCTAATAACCTAGGTACGTA,0,5048243
ykgRp,0.5,1,1,TCTAAGATATCGAGGGAAGA,0,5049643
ykgRp,0.5,1,1,TCGTTCCGTACCTCCGTGAT,0,5060977
ykgRp,0.5,1,1,TCGTGTCAACAATGATGGAG,0,5038627
ykgRp,0.5,1,1,TCGTGCGGAATCCGTGGGAG,0,5044362
ykgRp,0.5,1,1,TCGTGCCGCTTGTTAGTTAC,0,5035237
ykgRp,0.5,1,1,TCGTCTTATGGCGATATAAG,0,5061078
ykgRp,0.5,1,1,TCGTCTTAGGCCTATGACTA,0,5037859
ykgRp,0.5,1,1,TCGTCTAAAAACCCCGAGAT,0,5051097
ykgRp,0.5,1,1,TCGTCAAGTGTGGTTCGGGT,0,5058987
ykgRp,0.5,1,1,TCGTACCTGGGGGGATTGCT,0,5058302
ykgRp,0.5,1,1,TCGGTTGGGAAAAAAGCTCG,0,5051065
ykgRp,0.5,1,1,TCGGTTCGAGTTCTTACTGT,0,5036845
ykgRp,0.5,1,1,TCGGTCGGGATCCCGTGGTT,0,5060642
ykgRp,0.5,1,1,TCGGTCCTATCCGATTATAT,0,5039352
ykgRp,0.5,1,1,TCGGTCCGCCGTAGACGCTC,0,5049076
ykgRp,0.5,1,1,TCGGGTTGTTAGCCCTTCAG,0,5060449
ykgRp,0.5,1,1,TCGGGTTACCGGACCTAAGC,0,5051942
ykgRp,0.5,1,1,TCGGATATTGACTAAGCTGG,0,5050927
ykgRp,0.5,1,1,TCGGAAAAAGCATGGAACGG,0,5039943
ykgRp,0.5,1,1,TCGCCTCACTGCTCTAGTGT,0,5056702
ykgRp,0.5,1,1,TCGCCGCACAGTCTTTGTTC,0,5036283
ykgRp,0.5,1,1,TCGAGGGCACCGAGGCGGAT,0,5041455
ykgRp,0.5,1,1,TCGAGCTGCTGGAATCTGTG,0,5046149
ykgRp,0.5,1,1,TCGAGCTATCCTTAGGATTG,0,5045775
ykgRp,0.5,1,1,TCGAAGAGCTGTCTATATTG,0,5038354
ykgRp,0.5,1,1,TCGAAGAATATCGCATAGCG,0,5041004
ykgRp,0.5,1,1,TCGAACAGGCGTCTTCGATC,0,5059148
ykgRp,0.5,1,1,TCGAAAGTCTGCGATTCCGC,0,5051100
ykgRp,0.5,1,1,TCCTTTAAGTCCGAACCGAT,0,5050786
ykgRp,0.5,1,1,TCCTGTGACCCGTCATAGCG,0,5059200
ykgRp,0.5,1,1,TCCTGGTCTGTAAGCGCTAA,0,5035388
ykgRp,0.5,1,1,TCCTCGTCATGGCGAAACCT,0,5037650
ykgRp,0.5,1,1,TCCTCCCTAGCGGCACCGCT,0,5033934
ykgRp,0.5,1,1,TCCTCCACTAAGGTCTATGC,0,5037909
ykgRp,0.5,1,1,TCCTCCAATGGATTTGGACC,0,5042561
ykgRp,0.5,1,1,TCCTCACAGGAGTCTGGACA,0,5046721
ykgRp,0.5,1,1,TCCTATCACCTCACGGGTCA,0,5039326
ykgRp,0.5,1,1,TCCTAATGAGGTTTACAAGG,0,5032464
ykgRp,0.5,1,1,TCCGTTGCATTGCGCAGGCT,0,5039625
ykgRp,0.5,1,1,TCCGTTAGCGCAGGCCGTTT,0,5043746
ykgRp,0.5,1,1,TCCGTATAAACCCAGTGTCT,0,5047717
ykgRp,0.5,1,1,TCCGGTGGGCTATCATTTGT,0,5035065
ykgRp,0.5,1,1,TCCGGCAGGCGTGGATTTCA,0,5035360
ykgRp,0.5,1,1,TCCGCTGTTGGTACGGATCT,0,5055081
ykgRp,0.5,1,1,TCCGCTGCTCCGTGTCGCGG,0,5038588
ykgRp,0.5,1,1,TCCGCCACGACTAGACAAGA,0,5035631
ykgRp,0.5,1,1,TCCGCCACAACGGTATTGTA,0,5036275
ykgRp,0.5,1,1,TCCCGCTGGATACCGCTAAG,0,5042875
ykgRp,0.5,1,1,TCCATATGTATGCCAAATCA,0,5038069
ykgRp,0.5,1,1,TCCAGAACTGGCGTTCCAAT,0,5055276
ykgRp,0.5,1,1,TCCAACAGATACTGTTTAAT,0,5053748
ykgRp,0.5,1,1,TCATTTTAGCAGAATAATAC,0,5036930
ykgRp,0.5,1,1,TCATTGATACGTCTAATTTA,0,5053680
ykgRp,0.5,1,1,TCATGGGGAGAGTAGTCTAC,0,5040036
ykgRp,0.5,1,1,TCATGAGTTGGCCCAATAAG,0,5047913
ykgRp,0.5,1,1,TCATCAATATCCGGTAGTGA,0,5060660
ykgRp,0.5,1,1,TCATATCTTGTTGCCCTGTC,0,5057728
ykgRp,0.5,1,1,TCATACGTAGAATCTGCATC,0,5042087
ykgRp,0.5,1,1,TCAGTTTGCCGCAGTCCCGG,0,5050916
ykgRp,0.5,1,1,TCAGTGGAGTAGTGCGTCGT,0,5041788
ykgRp,0.5,1,1,TCAGGGACTTGAACCAAAAC,0,5045944
ykgRp,0.5,1,1,TCAGGCTGCGAAGATTCATA,0,5039874
ykgRp,0.5,1,1,TCAGGCGCCAATCGTTTCCC,0,5056258
ykgRp,0.5,1,1,TCAGGACGTTTCCGGTGAAG,0,5046401
ykgRp,0.5,1,1,TCAGCGTATATGCTTGTCCG,0,5032940
ykgRp,0.5,1,1,TCAGCATGCATGACTTTCCA,0,5037551
ykgRp,0.5,1,1,TCAGCACGGAAGGCGGTTTT,0,5045579
ykgRp,0.5,1,1,TCAGAGGTTGTGGCAGCTCA,0,5036141
ykgRp,0.5,1,1,TCAGACACCATGAGGCAGCA,0,5038559
ykgRp,0.5,1,1,TCAGAAAGGTGTGTGTACAG,0,5044288
ykgRp,0.5,1,1,TCACGTCTTGGTATAGTGAC,0,5049421
ykgRp,0.5,1,1,TCACGGGTGACATGGATTAT,0,5038148
ykgRp,0.5,1,1,TCACATGGGACCATCCTCAG,0,5036777
ykgRp,0.5,1,1,TCACAGTTTGCAGTATGTTT,0,5041571
ykgRp,0.5,1,1,TCACAGTGGCTTGCACATGG,0,5050743
ykgRp,0.5,1,1,TCAATGCTCGCCATATAACC,0,5055563
ykgRp,0.5,1,1,TCAAGCTACCACTCTGCCTT,0,5045209
ykgRp,0.5,1,1,TCAAGATGCGCAATCGCGGT,0,5039988
ykgRp,0.5,1,1,TCAAAGTTTCCCAGATTTTT,0,5054687
ykgRp,0.5,1,1,TATTTGAATGCGCATGCCGT,0,5038736
ykgRp,0.5,1,1,TATTGGCGAATGGATTAAGT,0,5033431
ykgRp,0.5,1,1,TATTGAATATCAGTACTCTG,0,5050648
ykgRp,0.5,1,1,TATTCTGATCGCGTTCGATG,0,5033303
ykgRp,0.5,1,1,TATTCATGGTAACTAATCTA,0,5035175
ykgRp,0.5,1,1,TATTATAGTTGTTAGCTGCG,0,5048889
ykgRp,0.5,1,1,TATGTGATACCGACCCGGGG,0,5053245
ykgRp,0.5,1,1,TATGTATACAACCTATACGA,0,5041746
ykgRp,0.5,1,1,TATGGGGTCTTTCAAGTTTT,0,5055578
ykgRp,0.5,1,1,TATGGGCAGAGAGCCGTGGG,0,5032076
ykgRp,0.5,1,1,TATGGCGGCACTCCCTGGAG,0,5055293
ykgRp,0.5,1,1,TATGGAGCAACTCTCAGCAA,0,5059630
ykgRp,0.5,1,1,TATGCATAGAGGGTACGGTA,0,5056314
ykgRp,0.5,1,1,TATGATCAACCTAGACTGGG,0,5035663
ykgRp,0.5,1,1,TATGAGTGGAGCAATGATTT,0,5061046
ykgRp,0.5,1,1,TATGAGCCCCAGCGTAGACA,0,5044764
ykgRp,0.5,1,1,TATCTCCGAACGGTAATTAA,0,5039136
ykgRp,0.5,1,1,TATCGTGGAGTCCCGGGGTG,0,5035762
ykgRp,0.5,1,1,TATCATAGTGGTAAGTACTA,0,5051738
ykgRp,0.5,1,1,TATCAGGTGTCGGCTTGCGC,0,5054001
ykgRp,0.5,1,1,TATCACTAGGACTATGTTTT,0,5041287
ykgRp,0.5,1,1,TATAGTCACTTGGTAGAGTC,0,5046439
ykgRp,0.5,1,1,TATAGTAACAATTATTTGGT,0,5047737
ykgRp,0.5,1,1,TATAGCTATCATTACTAAGT,0,5046379
ykgRp,0.5,1,1,TATAGCAAGCTAGTTGGTCG,0,5057844
ykgRp,0.5,1,1,TATAATGAGGTGAGGGATTA,0,5044278
ykgRp,0.5,1,1,TATAATCCTATACTGGCCCA,0,5045710
ykgRp,0.5,1,1,TATAAGCTCGGCGTCGGCTC,0,5052035
ykgRp,0.5,1,1,TATAACAAGGAGGGAAATCA,0,5057379
ykgRp,0.5,1,1,TAGTGGATTCCATCCAACAG,0,5042398
ykgRp,0.5,1,1,TAGTGAGGATTGTTGGCGAG,0,5047904
ykgRp,0.5,1,1,TAGGTTTGAAGCCCAAACTT,0,5040066
ykgRp,0.5,1,1,TAGGTGGTTCGGAAGACTGA,0,5031580
ykgRp,0.5,1,1,TAGGGTGACTATTGGCCATA,0,5051003
ykgRp,0.5,1,1,TAGGGTCGAACCAATAGGGA,0,5036725
ykgRp,0.5,1,1,TAGGGGGCTTGTTCTCGATG,0,5040705
ykgRp,0.5,1,1,TAGGGCTAAGGCTATGGTGC,0,5044480
ykgRp,0.5,1,1,TAGGGAGGAACTCCGATCGC,0,5058134
ykgRp,0.5,1,1,TAGGGACTAAAAACATTCCG,0,5037017
ykgRp,0.5,1,1,TAGGCAGAGTTAGGGGCAGG,0,5036708
ykgRp,0.5,1,1,TAGGAATGCGGACCCCTGGG,0,5039320
ykgRp,0.5,1,1,TAGGAAGGCAGATGAAGGAA,0,5048321
ykgRp,0.5,1,1,TAGGAAGCCTCACGGTACTA,0,5045028
ykgRp,0.5,1,1,TAGGAACGCTTTTCTAGGAT,0,5057274
ykgRp,0.5,1,1,TAGCTATGATGTAGCACACG,0,5031686
ykgRp,0.5,1,1,TAGCTACTAAAAGGCTCTAG,0,5060965
ykgRp,0.5,1,1,TAGCGAAATTGTGATAGCTG,0,5038948
ykgRp,0.5,1,1,TAGACTTTCTTTTGTTGATG,0,5048580
ykgRp,0.5,1,1,TAGACTTCAGGAACGCCGTT,0,5058777
ykgRp,0.5,1,1,TAGAATTACGCATACATAGC,0,5040038
ykgRp,0.5,1,1,TAGAAACCACTGTTAACTTT,0,5036846
ykgRp,0.5,1,1,TACTGCTGGGGACTCGGAAT,0,5039773
ykgRp,0.5,1,1,TACTCTTTGGTGGGCCTCCA,0,5049749
ykgRp,0.5,1,1,TACTACGGGTCTTACTAGCA,0,5056093
ykgRp,0.5,1,1,TACGTGGGATCATGTACGTT,0,5035584
ykgRp,0.5,1,1,TACGGGAGACCCCATCGGCC,0,5046981
ykgRp,0.5,1,1,TACGCGATTATTCGATCGAT,0,5031349
ykgRp,0.5,1,1,TACGAATATCTCTCTTCGTT,0,5031640
ykgRp,0.5,1,1,TACGAAGACTTGGGTCGTGA,0,5032422
ykgRp,0.5,1,1,TACCTGACGCTCGGACCGGT,0,5053689
ykgRp,0.5,1,1,TACCTCCTATTAGTTATGAG,0,5057500
ykgRp,0.5,1,1,TACCATTCGGATAAGGCAGC,0,5033869
ykgRp,0.5,1,1,TACCATATAGCTGAACCTGG,0,5060781
ykgRp,0.5,1,1,TACCACCGAGCTGGAGATTC,0,5053503
ykgRp,0.5,1,1,TACCACACATGGGACCACCC,0,5053299
ykgRp,0.5,1,1,TACCAAGATGCGCCCATGTT,0,5051170
ykgRp,0.5,1,1,TACACCTCTCCGCGGTGGTC,0,5053264
ykgRp,0.5,1,1,TACACATGCGGGTGACCCGC,0,5046275
ykgRp,0.5,1,1,TACAAAATACCCGGGACGTA,0,5047115
ykgRp,0.5,1,1,TAATTGATGTGTACGGACGT,0,5049804
ykgRp,0.5,1,1,TAATTAAATCAGACCTCCAG,0,5042415
ykgRp,0.5,1,1,TAATGTTAAGCACTGTAGAA,0,5058077
ykgRp,0.5,1,1,TAATGGCCAGTGACGCGTCC,0,5043188
ykgRp,0.5,1,1,TAATGCGTACCAGTCACATT,0,5061232
ykgRp,0.5,1,1,TAATCGATGTTGTAAATTTC,0,5032690
ykgRp,0.5,1,1,TAATATCTCGGTCGGGGACA,0,5059992
ykgRp,0.5,1,1,TAATAGGTTAGTTAGCTTAT,0,5039469
ykgRp,0.5,1,1,TAAGTTATTTGGCGCAACGC,0,5052690
ykgRp,0.5,1,1,TAAGTCCTCTACTTGGGTTG,0,5037624
ykgRp,0.5,1,1,TAAGTCCGTCTCCGGCCTGG,0,5056712
ykgRp,0.5,1,1,TAAGTCAGCGGTGCTACATA,0,5031362
ykgRp,0.5,1,1,TAAGTCACCCATTCGTAACC,0,5041594
ykgRp,0.5,1,1,TAAGTAGTTTCTAGGTTTCA,0,5032196
ykgRp,0.5,1,1,TAAGTACATCTTTAAGGACT,0,5052781
ykgRp,0.5,1,1,TAAGCCCTTTCACAATCAAC,0,5039398
ykgRp,0.5,1,1,TAAGAATCGTATGACCGAAG,0,5034512
ykgRp,0.5,1,1,TAACGAAGATTAACAATGTG,0,5052392
ykgRp,0.5,1,1,TAACCTGTTGGAGGAGTCTA,0,5036565
ykgRp,0.5,1,1,TAACCCGCGTGCCAAAGCTG,0,5057792
ykgRp,0.5,1,1,TAACCAACCACGCTATAGGT,0,5037180
ykgRp,0.5,1,1,TAAAGTAGCTGCCAGACAGG,0,5045063
ykgRp,0.5,1,1,TAAAGGGTGTGTACCAAGCA,0,5043344
ykgRp,0.5,1,1,TAAAGCATCAGTTTGGGTTA,0,5056978
ykgRp,0.5,1,1,TAAAGAGCCGGTTCTGCCGC,0,5031368
ykgRp,0.5,1,1,TAAAGACGCCCCAGAACGTT,0,5031481
ykgRp,0.5,1,1,TAAAATACATACTAGGACCA,0,5038371
ykgRp,0.5,1,1,TAAAAAGGTTGCCAACAGCT,0,5055579
ykgRp,0.5,1,1,GTTTTTTACACAGAGTATCC,0,5046463
ykgRp,0.5,1,1,GTTTTGTCTTCACCCCATCC,0,5037645
ykgRp,0.5,1,1,GTTTTGTATACAGTCAATAA,0,5048950
ykgRp,0.5,1,1,GTTTTCTTCCGGAGAGCAGA,0,5051881
ykgRp,0.5,1,1,GTTTTCGGTATTTGGCATCG,0,5050712
ykgRp,0.5,1,1,GTTTTCAAACCGCCAGAGGC,0,5032652
ykgRp,0.5,1,1,GTTTGTACAGTATGAGGCCC,0,5056291
ykgRp,0.5,1,1,GTTTGGTAGTTTGGTAGCAC,0,5047506
ykgRp,0.5,1,1,GTTTGAGTTAGTGCGGCGTG,0,5048829
ykgRp,0.5,1,1,GTTTGAGAAGTTGCACGCTA,0,5034645
ykgRp,0.5,1,1,GTTTCATTTGGGTAATGTCC,0,5051426
ykgRp,0.5,1,1,GTTTATGAGGAGTCAAAGGA,0,5042612
ykgRp,0.5,1,1,GTTTATCAGCAGACAGCCCA,0,5046711
ykgRp,0.5,1,1,GTTTAGAGCCAGGGGAATGG,0,5035017
ykgRp,0.5,1,1,GTTTAAAAAAGTCCTTCACG,0,5031398
ykgRp,0.5,1,1,GTTGGTATTCAGGCTAGGCG,0,5048514
ykgRp,0.5,1,1,GTTGGCGAAGCACCCGCTCA,0,5043560
ykgRp,0.5,1,1,GTTGGCCTTCGGTAACAACG,0,5037332
ykgRp,0.5,1,1,GTTGGCCGGCCTTTTCCAAG,0,5059257
ykgRp,0.5,1,1,GTTGGCATACAGATTGGGAT,0,5053701
ykgRp,0.5,1,1,GTTGGAGTGCTTAGCGAGTA,0,5040872
ykgRp,0.5,1,1,GTTGCTCGTCCATTCCGACG,0,5053730
ykgRp,0.5,1,1,GTTGCGGTGTCGTTACACCA,0,5054492
ykgRp,0.5,1,1,GTTGCGATGTACCGACCGGT,0,5048083
ykgRp,0.5,1,1,GTTCTTGCACGCTCGAATCA,0,5034743
ykgRp,0.5,1,1,GTTCTAAGGGCTGACTTGTA,0,5059610
ykgRp,0.5,1,1,GTTCGTGATGTTTCTCCAAG,0,5059312
ykgRp,0.5,1,1,GTTCATGCTTACACCAGGGT,0,5057707
ykgRp,0.5,1,1,GTTCATAGGTCCTCTGTCCG,0,5042297
ykgRp,0.5,1,1,GTTCACCGCTACATTTATGG,0,5032879
ykgRp,0.5,1,1,GTTATTCCGAATAACGACTC,0,5031841
ykgRp,0.5,1,1,GTTACGCGCGGTAACATAAT,0,5049432
ykgRp,0.5,1,1,GTTAATGTCTGGCTGTACCT,0,5045891
ykgRp,0.5,1,1,GTTAACGGCACAGGCACAGA,0,5036631
ykgRp,0.5,1,1,GTTAACCTGATCGGTTGAAC,0,5052819
ykgRp,0.5,1,1,GTGTTTCAATACATGTGCAA,0,5049160
ykgRp,0.5,1,1,GTGTGCGTGCCACTGCTCCC,0,5034277
ykgRp,0.5,1,1,GTGTGAAAGATAATACGAGC,0,5047326
ykgRp,0.5,1,1,GTGTCTGACGATTAGGTGGG,0,5045525
ykgRp,0.5,1,1,GTGTCGATGGGCCGACCGCG,0,5049414
ykgRp,0.5,1,1,GTGTAGAAGACGAGATTATT,0,5043792
ykgRp,0.5,1,1,GTGGGCGCAAGCGCAAAAGG,0,5043169
ykgRp,0.5,1,1,GTGGGCCATGAACGCTGCCT,0,5056316
ykgRp,0.5,1,1,GTGGCTTGAGCAATAACGAG,0,5039000
ykgRp,0.5,1,1,GTGGCGGGCGCTACAATTTA,0,5049968
ykgRp,0.5,1,1,GTGGCGAGTTGGCAAATATG,0,5042576
ykgRp,0.5,1,1,GTGGATTATGCTGTTGTAAT,0,5046921
ykgRp,0.5,1,1,GTGGACATCGATTCTTTCTA,0,5041220
ykgRp,0.5,1,1,GTGCTGGTCAACTTCCTTGT,0,5041026
ykgRp,0.5,1,1,GTGCTCACGACTGCGGGGGA,0,5032847
ykgRp,0.5,1,1,GTGCTAGCAGATCTCGTATG,0,5034754
ykgRp,0.5,1,1,GTGCCGAAATAGTTTAGACT,0,5044807
ykgRp,0.5,1,1,GTGCATAAGGGCCCGGTCCG,0,5034872
ykgRp,0.5,1,1,GTGCACTCGGGCTCTCGCGC,0,5058259
ykgRp,0.5,1,1,GTGCAAATCAGATGATGAAG,0,5057127
ykgRp,0.5,1,1,GTGATGACAATAACAACCTC,0,5051752
ykgRp,0.5,1,1,GTGATAATAGAGCGGGGAAG,0,5044252
ykgRp,0.5,1,1,GTGAGTAATTAATGACATTC,0,5032800
ykgRp,0.5,1,1,GTGAGGAATCGTTTTCTCTA,0,5059601
ykgRp,0.5,1,1,GTGAGATCCTGCTATCAGAC,0,5037330
ykgRp,0.5,1,1,GTGAACGTCTTATAAAAGTG,0,5042924
ykgRp,0.5,1,1,GTGAACGTAGCGATCCAAAC,0,5052283
ykgRp,0.5,1,1,GTCTTCATCCAGCTCAGCGC,0,5059607
ykgRp,0.5,1,1,GTCTGTGTCACATCAATCAA,0,5036706
ykgRp,0.5,1,1,GTCTGTCCCGCTATCGGGCA,0,5057366
ykgRp,0.5,1,1,GTCTGGACTTCAATGGGGTC,0,5049465
ykgRp,0.5,1,1,GTCTCGGTGCAGGAGGCAAA,0,5036073
ykgRp,0.5,1,1,GTCTACCCCCGCATTTCGAT,0,5040794
ykgRp,0.5,1,1,GTCGTTATCTGGATATCGCC,0,5043431
ykgRp,0.5,1,1,GTCGTGTTACCTGTCACCGG,0,5038441
ykgRp,0.5,1,1,GTCGTCACGCGCTCTGGAAG,0,5039394
ykgRp,0.5,1,1,GTCGCCTTGTGGCGCTCAAG,0,5035478
ykgRp,0.5,1,1,GTCGATGTAAGCGTAGTGAT,0,5051851
ykgRp,0.5,1,1,GTCCTTATGTGACTATACCA,0,5043291
ykgRp,0.5,1,1,GTCCTAATGCGACCACGAAC,0,5058102
ykgRp,0.5,1,1,GTCCGCGTTTTGGCGAAATA,0,5051459
ykgRp,0.5,1,1,GTCCGACCACGACCTTTGTT,0,5041235
ykgRp,0.5,1,1,GTCCCCATTGCATGATCAGA,0,5047322
ykgRp,0.5,1,1,GTCCCCACCAAAAACTCAGT,0,5047015
ykgRp,0.5,1,1,GTCCATGATAAGTCGATCTC,0,5036779
ykgRp,0.5,1,1,GTCCACATCTTCTGAGTCGC,0,5039643
ykgRp,0.5,1,1,GTCATTTGTAAAGCAGCCAC,0,5035469
ykgRp,0.5,1,1,GTCATTCGGTTATGCGGATA,0,5049404
ykgRp,0.5,1,1,GTCATGATTGTGACATACTT,0,5056719
ykgRp,0.5,1,1,GTCATAACGTCATCTGTGGT,0,5048966
ykgRp,0.5,1,1,GTCAGGGGAAGCAGTTTAGC,0,5035857
ykgRp,0.5,1,1,GTCAGGATCATTATTCGAAT,0,5058586
ykgRp,0.5,1,1,GTCAGCGATTGCCTATTCTC,0,5040931
ykgRp,0.5,1,1,GTCACTGATTGATGTATCGT,0,5034059
ykgRp,0.5,1,1,GTCACCTACATTGTCTTAAT,0,5034406
ykgRp,0.5,1,1,GTCAATCCGACTCCAAGCAA,0,5059921
ykgRp,0.5,1,1,GTATTGAGGTGCCAACAGCA,0,5032237
ykgRp,0.5,1,1,GTATGCTATCGAGTGCTCCT,0,5033652
ykgRp,0.5,1,1,GTATCTAGCCGTGGGAACAA,0,5054049
ykgRp,0.5,1,1,GTATCATAGTGGAGCGGTAG,0,5037560
ykgRp,0.5,1,1,GTATAGCGTTGCTGGCCTAG,0,5053963
ykgRp,0.5,1,1,GTAGTGATGAACGCGGATGC,0,5034772
ykgRp,0.5,1,1,GTAGTCGTACTGCGAACGGC,0,5053595
ykgRp,0.5,1,1,GTAGCTCTGTGCGAAAGGTT,0,5052646
ykgRp,0.5,1,1,GTAGCATCCCCACGATGTAC,0,5053938
ykgRp,0.5,1,1,GTAGATGCCTGTCCCGCGAT,0,5047126
ykgRp,0.5,1,1,GTAGAACAGACAGAGTAAAA,0,5031548
ykgRp,0.5,1,1,GTACCATTAGCCGAACTATC,0,5038864
ykgRp,0.5,1,1,GTACATCGTCTCTAGGATCA,0,5033878
ykgRp,0.5,1,1,GTACAAGTAAATCGCCCTGG,0,5045412
ykgRp,0.5,1,1,GTAATGACTTCTCCGATGTT,0,5040308
ykgRp,0.5,1,1,GTAACTTCTCTATCGAGTAT,0,5037220
ykgRp,0.5,1,1,GTAAAGTGAAATGCATTACA,0,5047691
ykgRp,0.5,1,1,GGTTTTCATTTCCAGGTTCT,0,5053192
ykgRp,0.5,1,1,GGTTTGCGATAGGTGTATCA,0,5032200
ykgRp,0.5,1,1,GGTTTCTTATTGCGCAGAAG,0,5033703
ykgRp,0.5,1,1,GGTTTACGCTACTGCCGAAA,0,5053127
ykgRp,0.5,1,1,GGTTGTATTAGCTGATGTGA,0,5039522
ykgRp,0.5,1,1,GGTTGCGTGGTTGGAGCTTG,0,5054203
ykgRp,0.5,1,1,GGTTGACGCACCGCACTTGT,0,5061490
ykgRp,0.5,1,1,GGTTCCTAGCAGATAAGATG,0,5051008
ykgRp,0.5,1,1,GGTTCCCCAGCGTAGCCGTT,0,5036956
ykgRp,0.5,1,1,GGTTCAGCGCACATTGTGGA,0,5032689
ykgRp,0.5,1,1,GGTTATTACCGGATCTGCTC,0,5051935
ykgRp,0.5,1,1,GGTTACTGCGTACGCTACCG,0,5056838
ykgRp,0.5,1,1,GGTTAATACGGGTTGGTGTA,0,5031952
ykgRp,0.5,1,1,GGTGTTTGCACGTGGATGTC,0,5044780
ykgRp,0.5,1,1,GGTGTGTTTTTATTAAATTT,0,5061193
ykgRp,0.5,1,1,GGTGTCAGGATGAGGTGGCC,0,5034619
ykgRp,0.5,1,1,GGTGTCACCTTGAGCCTGGC,0,5046236
ykgRp,0.5,1,1,GGTGTATAGCCTAGGCTTTG,0,5040015
ykgRp,0.5,1,1,GGTGGCTTCGGGTAGGCATA,0,5052000
ykgRp,0.5,1,1,GGTGGAAATCATAACCCCCG,0,5036046
ykgRp,0.5,1,1,GGTCTTTGCTTGTAAGTTCA,0,5035867
ykgRp,0.5,1,1,GGTCTCAGCTAGAATACCAT,0,5053807
ykgRp,0.5,1,1,GGTCTAATGTCCAGTTGCGC,0,5052687
ykgRp,0.5,1,1,GGTCTAACATCCCAATCAGG,0,5042800
ykgRp,0.5,1,1,GGTCGGTTCTAATGCCAATT,0,5059137
ykgRp,0.5,1,1,GGTCGGGGCGCTGGAATAAC,0,5036843
ykgRp,0.5,1,1,GGTCGGAGTGCCGGTGCGTT,0,5054222
ykgRp,0.5,1,1,GGTCGAGTCTCGGGGACGGC,0,5032177
ykgRp,0.5,1,1,GGTCCCTGGCGTATCTCAGC,0,5041865
ykgRp,0.5,1,1,GGTCAGGTCCGTCTGGGGTC,0,5046193
ykgRp,0.5,1,1,GGTCAAGGCGTGTTGGGTGG,0,5058955
ykgRp,0.5,1,1,GGTATCATATCGAAAGGATA,0,5039366
ykgRp,0.5,1,1,GGTATATAAAGATACGGGAC,0,5060791
ykgRp,0.5,1,1,GGTATAAATCAGGGACGGCC,0,5055000
ykgRp,0.5,1,1,GGTAGGGTTTCTTCGGCAAC,0,5060674
ykgRp,0.5,1,1,GGTAGGCGTGAATTGCGGTA,0,5060733
ykgRp,0.5,1,1,GGTACTTCTCCCATGAAAGT,0,5048285
ykgRp,0.5,1,1,GGTACATCCCATGTGTCAAA,0,5032085
ykgRp,0.5,1,1,GGTACACGACATATCACCCA,0,5043459
ykgRp,0.5,1,1,GGTAAAATATTCCGCCAAGG,0,5039284
ykgRp,0.5,1,1,GGTAAAACGACCACGTGGGT,0,5044683
ykgRp,0.5,1,1,GGGTTTAGGCAAAGGTTGGA,0,5050013
ykgRp,0.5,1,1,GGGTTCATTACGCGTTTTTT,0,5048193
ykgRp,0.5,1,1,GGGTGCCACGTAGCTACCAT,0,5049262
ykgRp,0.5,1,1,GGGTCTACCAATTGAGGGAA,0,5037916
ykgRp,0.5,1,1,GGGTCGTGCATGGTCGCGCA,0,5040441
ykgRp,0.5,1,1,GGGTATGCATCCATTCTCAC,0,5055048
ykgRp,0.5,1,1,GGGTATAGCCAATCTACACG,0,5036869
ykgRp,0.5,1,1,GGGTAGTTCAATAGGCCTAT,0,5042695
ykgRp,0.5,1,1,GGGTAACCGCCATGGGCAAG,0,5047745
ykgRp,0.5,1,1,GGGGGCGGACTGGATGTGAG,0,5054682
ykgRp,0.5,1,1,GGGGGCGAGCGGGCCGGTGA,0,5049935
ykgRp,0.5,1,1,GGGGCAGTGCCTTGTGGCAA,0,5050128
ykgRp,0.5,1,1,GGGGATGTCCTAAACCCTAA,0,5042810
ykgRp,0.5,1,1,GGGGAGAGGGAGCGTTTTAA,0,5061186
ykgRp,0.5,1,1,GGGGACTGAAATTATTTCAG,0,5055315
ykgRp,0.5,1,1,GGGGAATTGGCAATCATAAC,0,5044450
ykgRp,0.5,1,1,GGGCGGTTCTCAGAGCGGCC,0,5057632
ykgRp,0.5,1,1,GGGCGGCACAGGTACACATC,0,5050886
ykgRp,0.5,1,1,GGGCGGACAGACTTGGACAT,0,5032236
ykgRp,0.5,1,1,GGGCGACTGTATGATCTCAG,0,5036419
ykgRp,0.5,1,1,GGGCGAAACCTACTACCGAA,0,5056503
ykgRp,0.5,1,1,GGGCCTGTCTACACGACCAA,0,5039198
ykgRp,0.5,1,1,GGGCCTCGAAGATTCTAGAC,0,5037997
ykgRp,0.5,1,1,GGGCCGCATTCCTTCTAGAG,0,5055944
ykgRp,0.5,1,1,GGGCCATATGACGACTCGAA,0,5037995
ykgRp,0.5,1,1,GGGCACAGTTCTACATGGCC,0,5035389
ykgRp,0.5,1,1,GGGATCTCCATGAAGAATCC,0,5043921
ykgRp,0.5,1,1,GGGAGGTGTCACCCGCCCGT,0,5059608
ykgRp,0.5,1,1,GGGACTCTACGTCCACGCAC,0,5055353
ykgRp,0.5,1,1,GGGAATGTATCAAATCTGTA,0,5032723
ykgRp,0.5,1,1,GGGAAGACCAAATCGGGGCA,0,5055030
ykgRp,0.5,1,1,GGGAAAGATAGTGCTTTGGT,0,5038556
ykgRp,0.5,1,1,GGCTTTGGCAAAAAAGAAAT,0,5053352
ykgRp,0.5,1,1,GGCTTGCGCGTGGGAGTGTA,0,5042555
ykgRp,0.5,1,1,GGCTTCATGGTTCGTGGTGC,0,5038670
ykgRp,0.5,1,1,GGCTTAGTCTCGAGCAGGCG,0,5041309
ykgRp,0.5,1,1,GGCTCTGGCAACATAAACTC,0,5045427
ykgRp,0.5,1,1,GGCTCGTTTTGGCTTTACGA,0,5048803
ykgRp,0.5,1,1,GGCTCGGGCGACCGCCGCTA,0,5056434
ykgRp,0.5,1,1,GGCTCGGGACTTACCTTGAG,0,5054914
ykgRp,0.5,1,1,GGCTCCATATATGTACGTGG,0,5033636
ykgRp,0.5,1,1,GGCTCACGCCAGCATCCAAG,0,5042484
ykgRp,0.5,1,1,GGCTATGTTCAGGTGGGAAA,0,5039314
ykgRp,0.5,1,1,GGCTACATGTTTAGCACCTT,0,5044904
ykgRp,0.5,1,1,GGCGTGGGTGTTCTATCTCT,0,5032639
ykgRp,0.5,1,1,GGCGGTATTCAGGCCAGGTT,0,5055890
ykgRp,0.5,1,1,GGCGGCGCCTCTTATGTAGG,0,5033987
ykgRp,0.5,1,1,GGCGCAGTCGCTCGCTCTCG,0,5052470
ykgRp,0.5,1,1,GGCCTGCCCCGCGTACTCAT,0,5054553
ykgRp,0.5,1,1,GGCCTCCGGAAATAAAAGGA,0,5037215
ykgRp,0.5,1,1,GGCCTCAGAATACGATTTTA,0,5037727
ykgRp,0.5,1,1,GGCCTACCAGTTTCCCGGAT,0,5032194
ykgRp,0.5,1,1,GGCCGTTGGGCATAGCGGGA,0,5036947
ykgRp,0.5,1,1,GGCCGTCACTTGTTTTCCAG,0,5055782
ykgRp,0.5,1,1,GGCCGAGTTGCGTCCCTACC,0,5055776
ykgRp,0.5,1,1,GGCCCAGCATATGGCTCCAC,0,5035364
ykgRp,0.5,1,1,GGCCACACGTGTTTGCTTAC,0,5055181
ykgRp,0.5,1,1,GGCATGTCGTTCGATAAGAA,0,5059311
ykgRp,0.5,1,1,GGCATGACAATTGCGCTGGA,0,5054537
ykgRp,0.5,1,1,GGCAGTAGAGTACTCGAATA,0,5032889
ykgRp,0.5,1,1,GGCAGGGTGAGGGCCGCCGA,0,5055066
ykgRp,0.5,1,1,GGCACAGGTGGAAGATGACA,0,5035569
ykgRp,0.5,1,1,GGATTGCCTGAGAGTAGGCA,0,5043286
ykgRp,0.5,1,1,GGATTCCGCTCCCAGTCTGA,0,5051796
ykgRp,0.5,1,1,GGATTAGGTCACTAGGCAGA,0,5059604
ykgRp,0.5,1,1,GGATGTATCCACACTCTCCC,0,5057435
ykgRp,0.5,1,1,GGATGTACGTCGAATCTAGA,0,5055684
ykgRp,0.5,1,1,GGATGTACCCTGAGACCGTT,0,5055490
ykgRp,0.5,1,1,GGATGGGATAGCGGTTTCCG,0,5034450
ykgRp,0.5,1,1,GGATCTTGTCGTGACTGTAG,0,5038924
ykgRp,0.5,1,1,GGATCGCTAGGTAGGTTCCA,0,5052121
ykgRp,0.5,1,1,GGATCCAATTACAAAAAGGG,0,5050800
ykgRp,0.5,1,1,GGATACTGTATGGTTCTGAA,0,5052544
ykgRp,0.5,1,1,GGATACCATCTATTATGTAG,0,5055635
ykgRp,0.5,1,1,GGAGTGGACACTCAGCTCCA,0,5050629
ykgRp,0.5,1,1,GGAGTAGCAATGCTAAACGG,0,5053040
ykgRp,0.5,1,1,GGAGCTCAGAGGATGCCTGG,0,5056624
ykgRp,0.5,1,1,GGAGCTACTATATGCACCTC,0,5034579
ykgRp,0.5,1,1,GGAGAGATGAAACCGACCCC,0,5059425
ykgRp,0.5,1,1,GGACTTTAGTAAGACCGGTG,0,5058448
ykgRp,0.5,1,1,GGACTCCAGGCTCTAGGGGA,0,5037380
ykgRp,0.5,1,1,GGACTAAGCGCGGGCACGAA,0,5038663
ykgRp,0.5,1,1,GGACGACGCTAATCGCCCGT,0,5034535
ykgRp,0.5,1,1,GGACCCTTTTACGTGGTAGT,0,5038831
ykgRp,0.5,1,1,GGACCCTTAGCCCTTTCAGG,0,5047409
ykgRp,0.5,1,1,GGACCCGAATAATAGTTCGC,0,5053278
ykgRp,0.5,1,1,GGACCACTGAGTCGGCCTGG,0,5061521
ykgRp,0.5,1,1,GGACACGAGTTGTATGGTAG,0,5052169
ykgRp,0.5,1,1,GGACACAAGCCCACTTTTGA,0,5059058
ykgRp,0.5,1,1,GGACAAATCTTATGAGCCCA,0,5049789
ykgRp,0.5,1,1,GGAATGGGCCATACGGAATG,0,5053558
ykgRp,0.5,1,1,GGAAGTATACATGGTGGGAT,0,5046169
ykgRp,0.5,1,1,GGAAGGGGATGGCAATGTTG,0,5042693
ykgRp,0.5,1,1,GGAAGCTGTATTTAGACTGT,0,5054160
ykgRp,0.5,1,1,GGAAGCTGATGGCCTGGAAC,0,5035705
ykgRp,0.5,1,1,GGAAGCGTTCAGTTGGGATA,0,5033492
ykgRp,0.5,1,1,GGAAGCCGCCCCTATTGTCT,0,5060342
ykgRp,0.5,1,1,GGAAGATTGATATACCTTAA,0,5059275
ykgRp,0.5,1,1,GGAACGGCATCCCCGCGCAC,0,5058059
ykgRp,0.5,1,1,GGAACAGGCTTAGTGGTAAA,0,5053753
ykgRp,0.5,1,1,GGAACAATGGACTCGTAAAA,0,5034172
ykgRp,0.5,1,1,GGAAAAGCTTCAGTCAGTTG,0,5045038
ykgRp,0.5,1,1,GCTTTTGGACGCCGTCAAAT,0,5047012
ykgRp,0.5,1,1,GCTTGTTTTACCCTGATTCA,0,5058588
ykgRp,0.5,1,1,GCTTGTTCAAGAGTTAAAAC,0,5055800
ykgRp,0.5,1,1,GCTTGCTTGCTCAACTAACG,0,5037297
ykgRp,0.5,1,1,GCTTGATTGTAAAAGACCGT,0,5034227
ykgRp,0.5,1,1,GCTTATTCCTACCGATCTGT,0,5060350
ykgRp,0.5,1,1,GCTGGTAAGGCTAAAGCGCA,0,5039785
ykgRp,0.5,1,1,GCTGGCGTATGAACTCCCCC,0,5050434
ykgRp,0.5,1,1,GCTGGCAATGACCGCGATCT,0,5044164
ykgRp,0.5,1,1,GCTGCTACGAACGGAGGAAA,0,5033163
ykgRp,0.5,1,1,GCTGATCTCCTGTGGTATAC,0,5046798
ykgRp,0.5,1,1,GCTGAGGCAAAACGATTCGG,0,5050518
ykgRp,0.5,1,1,GCTGACGGATGTCCTATCCG,0,5051169
ykgRp,0.5,1,1,GCTGAATATCCACGCGCTGG,0,5038097
ykgRp,0.5,1,1,GCTCTCATCGGTATCACTAT,0,5038679
ykgRp,0.5,1,1,GCTCTACCCACGTTCGCAGG,0,5051413
ykgRp,0.5,1,1,GCTCGCAGAATGGATGTGTG,0,5052835
ykgRp,0.5,1,1,GCTCGAGTCTGCCGCTCAAA,0,5042537
ykgRp,0.5,1,1,GCTCATGCCGATTGGGTGTG,0,5046667
ykgRp,0.5,1,1,GCTCACGAATGGCGCGGTTG,0,5036222
ykgRp,0.5,1,1,GCTATGCAAGGAGCGTGTCA,0,5049308
ykgRp,0.5,1,1,GCTATATATGGGACCTGAGG,0,5050191
ykgRp,0.5,1,1,GCTAGGCGTTGCGCCGGTAA,0,5040778
ykgRp,0.5,1,1,GCTACATCTCATCTAATATA,0,5058091
ykgRp,0.5,1,1,GCTAACTGAGGGAACAGGTT,0,5037668
ykgRp,0.5,1,1,GCTAAAGGTGCCGGTGTGTT,0,5056480
ykgRp,0.5,1,1,GCGTTGACTCGGGAAGGTTA,0,5051325
ykgRp,0.5,1,1,GCGTGCAGTATCAAATCCAT,0,5041311
ykgRp,0.5,1,1,GCGTCTGTCCAGAGAATCAT,0,5037660
ykgRp,0.5,1,1,GCGTCGGTGCCAACGTCACT,0,5049743
ykgRp,0.5,1,1,GCGTCCGCTTCAAATGCCAG,0,5044187
ykgRp,0.5,1,1,GCGTACCCGGTCGTGTTCAC,0,5055504
ykgRp,0.5,1,1,GCGGTTGCATTGAACAGCAA,0,5038891
ykgRp,0.5,1,1,GCGGTAAAATACGAGTGTCC,0,5048302
ykgRp,0.5,1,1,GCGGGTTCTGGCCCTGGCGG,0,5051889
ykgRp,0.5,1,1,GCGGGTGGGGTTTGGGAGCA,0,5061177
ykgRp,0.5,1,1,GCGGGACAAGTCATAACAAG,0,5031554
ykgRp,0.5,1,1,GCGGGAATAAGTCTGGCCTC,0,5039653
ykgRp,0.5,1,1,GCGGCACCACTTATTAGGCG,0,5034403
ykgRp,0.5,1,1,GCGGATTGGTGGTTGGACCC,0,5032877
ykgRp,0.5,1,1,GCGGATGATGCAGATGTTGA,0,5035928
ykgRp,0.5,1,1,GCGGAAGATGTTATATCCAT,0,5045475
ykgRp,0.5,1,1,GCGCTCTATGAAGTTTTGGG,0,5040674
ykgRp,0.5,1,1,GCGCTAGTTTATGAGCATGT,0,5044224
ykgRp,0.5,1,1,GCGCGTTCAGTGCTCCTGAG,0,5045718
ykgRp,0.5,1,1,GCGCGTCCTTAGGCATACGT,0,5046816
ykgRp,0.5,1,1,GCGCGCGTGATCGGTGTACC,0,5060030
ykgRp,0.5,1,1,GCGCCGTCGTAAGCTCCATC,0,5052033
ykgRp,0.5,1,1,GCGCCAGATTTACCTGTCAC,0,5042029
ykgRp,0.5,1,1,GCGCAGGGTTCAACCGGACG,0,5050836
ykgRp,0.5,1,1,GCGCACGATAAAGGTTACTA,0,5054530
ykgRp,0.5,1,1,GCGCAAACTATGCAAAATCG,0,5038982
ykgRp,0.5,1,1,GCGATTGGAGAAACGTAAGC,0,5042532
ykgRp,0.5,1,1,GCGATATATCAATCTGAAAA,0,5053200
ykgRp,0.5,1,1,GCGAGAGGTCGGTGGGAATG,0,5046000
ykgRp,0.5,1,1,GCGACCCAGGTCAGGGTTGT,0,5038986
ykgRp,0.5,1,1,GCGAATGGGCAAATCAGCCA,0,5054344
ykgRp,0.5,1,1,GCGAATACTAGAACTAAGGC,0,5055282
ykgRp,0.5,1,1,GCGAACTAGCGTGACAGTGT,0,5040639
ykgRp,0.5,1,1,GCGAACGTTCGTCGAAGGGT,0,5058491
ykgRp,0.5,1,1,GCGAAAGAGAAGATCCCCAC,0,5050561
ykgRp,0.5,1,1,GCCTTTAATGTTCGCCCTAG,0,5054753
ykgRp,0.5,1,1,GCCTTGACATAGGAAGGTAC,0,5037614
ykgRp,0.5,1,1,GCCTGGACAGAGCGACCTTG,0,5032433
ykgRp,0.5,1,1,GCCTCAGTTAAAATAGCACT,0,5037298
ykgRp,0.5,1,1,GCCTACTTGGTTCGATCTAC,0,5046855
ykgRp,0.5,1,1,GCCGTTGTTGGTGAAGACCA,0,5060876
ykgRp,0.5,1,1,GCCGTTGTAGTGATAGGCGC,0,5058676
ykgRp,0.5,1,1,GCCGTATTGTGTGCGAAGTG,0,5061296
ykgRp,0.5,1,1,GCCGTAACCAAGTAAGATGA,0,5039974
ykgRp,0.5,1,1,GCCGGTACCTGCCTGCTCCC,0,5049166
ykgRp,0.5,1,1,GCCGCGTTACCGACCGGCTC,0,5056570
ykgRp,0.5,1,1,GCCGCCCCAAAGCGTTGGAT,0,5050228
ykgRp,0.5,1,1,GCCGCATCCAAGTCGCCCTG,0,5061590
ykgRp,0.5,1,1,GCCGATTCTGAAAATTATAT,0,5049779
ykgRp,0.5,1,1,GCCGAATGTAGAAGAGCGCC,0,5050915
ykgRp,0.5,1,1,GCCGAATCATGCTATACATT,0,5034429
ykgRp,0.5,1,1,GCCCTGTTCATTAATTCAAA,0,5033611
ykgRp,0.5,1,1,GCCCTATTTGCTATACTCAG,0,5031400
ykgRp,0.5,1,1,GCCCTAGGCCGGGGCGCTCC,0,5059776
ykgRp,0.5,1,1,GCCCGTTTTACACCAGCCGA,0,5047860
ykgRp,0.5,1,1,GCCCGCCGGGAAGTAGACCG,0,5039260
ykgRp,0.5,1,1,GCCCCATGGGGGATTTTAAT,0,5053767
ykgRp,0.5,1,1,GCCCACTGAACAACGACGGG,0,5045113
ykgRp,0.5,1,1,GCCCACTCCCATTGATAAGG,0,5037341
ykgRp,0.5,1,1,GCCAGGTGTCGTTGTGCTCG,0,5048859
ykgRp,0.5,1,1,GCCAGATTCGCGGGCACGAG,0,5032103
ykgRp,0.5,1,1,GCCACGTTGCATCCTGTATA,0,5055494
ykgRp,0.5,1,1,GCCAAGGACAAGGTCAAATA,0,5047894
ykgRp,0.5,1,1,GCCAACATTCACTACCCCTC,0,5055805
ykgRp,0.5,1,1,GCATGTAAGAATATTACGAG,0,5051864
ykgRp,0.5,1,1,GCATGGCGTCGAGGTGTTGT,0,5036329
ykgRp,0.5,1,1,GCATCTCAATAGACTTCCTT,0,5045345
ykgRp,0.5,1,1,GCATCCTACCTCCCTCCAGT,0,5031545
ykgRp,0.5,1,1,GCATCACAGGACTTACCATA,0,5050963
ykgRp,0.5,1,1,GCATACCTGACAGCCACCTA,0,5038212
ykgRp,0.5,1,1,GCAGGTTCAACATTACAATT,0,5033317
ykgRp,0.5,1,1,GCAGGGAGTATCGCCCGTGA,0,5042616
ykgRp,0.5,1,1,GCAGGGAGAGTTGCTATAAT,0,5040484
ykgRp,0.5,1,1,GCAGGGACTCGTTACGCTCC,0,5041593
ykgRp,0.5,1,1,GCAGGCATCGGGAATTGCTG,0,5059805
ykgRp,0.5,1,1,GCAGCTGGTAGCAAGTTGGT,0,5034761
ykgRp,0.5,1,1,GCAGCAAGTGGGACTACCAA,0,5039351
ykgRp,0.5,1,1,GCAGATCGGGTCTCTTCGTA,0,5050202
ykgRp,0.5,1,1,GCAGATATTGTTGTTGGCGG,0,5036816
ykgRp,0.5,1,1,GCAGACAGCTGGCACTCTAC,0,5050382
ykgRp,0.5,1,1,GCACTACCTACGATCGCCTG,0,5033393
ykgRp,0.5,1,1,GCACTAATTCTAGGTAGTGA,0,5041402
ykgRp,0.5,1,1,GCACGTATAGTGCGGTTATC,0,5037958
ykgRp,0.5,1,1,GCACCGACAAACGGTATATT,0,5037637
ykgRp,0.5,1,1,GCACCCCACAAAATAATCAG,0,5061215
ykgRp,0.5,1,1,GCACATGAAGCACGCCTCGG,0,5042840
ykgRp,0.5,1,1,GCACAGTACGTTGCCAGGGC,0,5052316
ykgRp,0.5,1,1,GCACAGGCAGGCCTAACTAA,0,5060162
ykgRp,0.5,1,1,GCACACGTGCTCCCTAGGTC,0,5038264
ykgRp,0.5,1,1,GCAATGCATGCATTAATCCA,0,5053258
ykgRp,0.5,1,1,GCAATAGAAAAATCTCATAT,0,5043153
ykgRp,0.5,1,1,GCAATACCTGTACTTTCGAC,0,5033696
ykgRp,0.5,1,1,GCAACTCAGGAGGCGCCAAC,0,5052482
ykgRp,0.5,1,1,GCAACGTCTAGTGGGCCGAA,0,5043787
ykgRp,0.5,1,1,GCAACGGCACGTTACTGCCT,0,5052440
ykgRp,0.5,1,1,GCAACCTTCAACGACCTGGT,0,5060677
ykgRp,0.5,1,1,GCAAATGGTTCGTATGAGAA,0,5060151
ykgRp,0.5,1,1,GCAAAGCCGAGCGGGATCGA,0,5045404
ykgRp,0.5,1,1,GCAAAAGTTGACTCCATATC,0,5048166
ykgRp,0.5,1,1,GATTTTTCTGGAGTCGCATA,0,5037800
ykgRp,0.5,1,1,GATTTAGCGGTTACATACTT,0,5047344
ykgRp,0.5,1,1,GATTGTTGTGGACCTGCTTT,0,5036893
ykgRp,0.5,1,1,GATTGGATACCTACTGTGTA,0,5035334
ykgRp,0.5,1,1,GATGGGCTGCTCTGTTCGCA,0,5034029
ykgRp,0.5,1,1,GATGGCAGAAACGGGCCTCT,0,5045123
ykgRp,0.5,1,1,GATGAGTTGTAATTCACCCC,0,5061070
ykgRp,0.5,1,1,GATGAGTCCTTTAAATTGAA,0,5049587
ykgRp,0.5,1,1,GATGAGGGGATAATGATAGC,0,5047515
ykgRp,0.5,1,1,GATCTTAGTGTGAATTCCCG,0,5038777
ykgRp,0.5,1,1,GATCTACCTTCTCTTCCTTC,0,5038517
ykgRp,0.5,1,1,GATCCTTTCGCTTGGCGTTT,0,5038537
ykgRp,0.5,1,1,GATCCCAAAAGAACTATTAC,0,5033701
ykgRp,0.5,1,1,GATCAAATCCACCGACAGTG,0,5050265
ykgRp,0.5,1,1,GATACGTGCGTCTGGAAACC,0,5055213
ykgRp,0.5,1,1,GATACGCGTAACGGTGGGAC,0,5040117
ykgRp,0.5,1,1,GATACCTGGCATGCAGAAAC,0,5032942
ykgRp,0.5,1,1,GATACACGTCACGATCTCTG,0,5058809
ykgRp,0.5,1,1,GATAACAGCTATCCTGGCCG,0,5037145
ykgRp,0.5,1,1,GATAAACAATCTCGCGGTGT,0,5053039
ykgRp,0.5,1,1,GATAAAAGGATGCAGATCCA,0,5034625
ykgRp,0.5,1,1,GAGTTCAATGCCATGGTCAT,0,5058048
ykgRp,0.5,1,1,GAGTGGGAAGAATTAAACTG,0,5050978
ykgRp,0.5,1,1,GAGTGAGTCTCGCTGCACTG,0,5058395
ykgRp,0.5,1,1,GAGTATCCGATCCAAAGATT,0,5049015
ykgRp,0.5,1,1,GAGTAGAGGACTCCATCATT,0,5042677
ykgRp,0.5,1,1,GAGTAGAAGACAATAGAAAC,0,5036134
ykgRp,0.5,1,1,GAGGTCCGATGTGGTATCTC,0,5054971
ykgRp,0.5,1,1,GAGGTAAGCATCGCATGAGG,0,5038021
ykgRp,0.5,1,1,GAGGGCATGGGCGAGCTAGC,0,5038522
ykgRp,0.5,1,1,GAGGCCTAGTAAAAACCTTA,0,5052686
ykgRp,0.5,1,1,GAGGCATTATTGCAACATCC,0,5043544
ykgRp,0.5,1,1,GAGGAGAGGACCAGCGCCCA,0,5057505
ykgRp,0.5,1,1,GAGGACGGATAGAACGTTAA,0,5033427
ykgRp,0.5,1,1,GAGCGGCACAATTTAAGGGT,0,5033734
ykgRp,0.5,1,1,GAGCCTAGCGTACCTACCTG,0,5041349
ykgRp,0.5,1,1,GAGCCCTTGTATAGGCCTTA,0,5051519
ykgRp,0.5,1,1,GAGCAGGGGCGGGCATCCTG,0,5057014
ykgRp,0.5,1,1,GAGCACTCAGATATTCCTTC,0,5057584
ykgRp,0.5,1,1,GAGCACATCTTCCCAACTTG,0,5057990
ykgRp,0.5,1,1,GAGATCGTTAAGTATGTGAC,0,5041828
ykgRp,0.5,1,1,GAGATAGTCGATCAGAGCCT,0,5056988
ykgRp,0.5,1,1,GAGATACTCACATGCAACAA,0,5047911
ykgRp,0.5,1,1,GAGAGGGCAACTCTCTCGGA,0,5033676
ykgRp,0.5,1,1,GAGAGCGATATTCCAGGAAG,0,5058312
ykgRp,0.5,1,1,GAGAGCGATATACCTTGCGG,0,5039350
ykgRp,0.5,1,1,GAGAGCAACGCCAGCGTGAA,0,5058913
ykgRp,0.5,1,1,GAGAATTGCACCACCCGAGC,0,5035612
ykgRp,0.5,1,1,GAGAAATTTGATTTCGATGT,0,5047063
ykgRp,0.5,1,1,GACTTCGGTCGAGGTCGAAG,0,5052067
ykgRp,0.5,1,1,GACTTATCGATTAGTCCAGG,0,5054615
ykgRp,0.5,1,1,GACTTAGACGGCACGATCGG,0,5032463
ykgRp,0.5,1,1,GACTGTCGTAGGCAACGCAT,0,5053688
ykgRp,0.5,1,1,GACTGGATGGCCACCATAAT,0,5054408
ykgRp,0.5,1,1,GACTGCTCATGTAAGCGATT,0,5060597
ykgRp,0.5,1,1,GACTCTGCACCCCCCGAGAT,0,5059755
ykgRp,0.5,1,1,GACTCATTCGCTTTCAGTTA,0,5054240
ykgRp,0.5,1,1,GACTAATTTTGGGGACGTAG,0,5042395
ykgRp,0.5,1,1,GACGCTTGGAGCTAGCGGTG,0,5031925
ykgRp,0.5,1,1,GACGCTGTCACGCCTCTATC,0,5046085
ykgRp,0.5,1,1,GACGCTAGGGTTTACGTTAT,0,5047365
ykgRp,0.5,1,1,GACGATCGCAAGCTACATCC,0,5048215
ykgRp,0.5,1,1,GACCTGGGAATTCCTGAAAA,0,5049675
ykgRp,0.5,1,1,GACCTCCTCACGTCCACTAT,0,5056391
ykgRp,0.5,1,1,GACCCCGTTCTATCCTAGGA,0,5054714
ykgRp,0.5,1,1,GACCATGCTGTTACTCACGG,0,5041384
ykgRp,0.5,1,1,GACCAATGGACGTTACAAAG,0,5052412
ykgRp,0.5,1,1,GACATGCGGCCGTTCATAGT,0,5047723
ykgRp,0.5,1,1,GACATCCACAAAAGGCTAGT,0,5042266
ykgRp,0.5,1,1,GACAGGGTCGCGCATAGCAG,0,5059406
ykgRp,0.5,1,1,GACACGGTCCAGCAGTCAAA,0,5050765
ykgRp,0.5,1,1,GAATTTGTGTGTGGGCCGGA,0,5055046
ykgRp,0.5,1,1,GAATGCATCTGGGACAATAC,0,5060204
ykgRp,0.5,1,1,GAATGATTGCATCCCTGTAG,0,5054545
ykgRp,0.5,1,1,GAATGACGTTACCCAGTCAC,0,5048221
ykgRp,0.5,1,1,GAATGAACGATTGGGTTGCA,0,5052137
ykgRp,0.5,1,1,GAATCAGAAACGTCGTGCTC,0,5053741
ykgRp,0.5,1,1,GAATCACAGTGAGCTCGCGT,0,5049120
ykgRp,0.5,1,1,GAATACAAGACAGTAGCCCC,0,5043657
ykgRp,0.5,1,1,GAAGTGTAGGGATCGTGCAA,0,5040138
ykgRp,0.5,1,1,GAAGTCTTGGTCAGTCCTAA,0,5059289
ykgRp,0.5,1,1,GAAGTCTAGACAAAACTCCT,0,5056290
ykgRp,0.5,1,1,GAAGATATGTAACTGAAAGG,0,5045233
ykgRp,0.5,1,1,GAAGAAGTGGATAAACAATA,0,5058920
ykgRp,0.5,1,1,GAACTGTGCAGTAGTGTCCC,0,5034398
ykgRp,0.5,1,1,GAACTGGCCTTCGCCTCTAC,0,5050017
ykgRp,0.5,1,1,GAACTGGCAGAGTCGGCTCT,0,5043428
ykgRp,0.5,1,1,GAACCGATGTGCGTAAGTCA,0,5050661
ykgRp,0.5,1,1,GAACATACAGGCTTCTCGAT,0,5058909
ykgRp,0.5,1,1,GAAATGCGCAGGGAGATAGG,0,5058967
ykgRp,0.5,1,1,GAAATCCAGGTGTATGTCTC,0,5052751
ykgRp,0.5,1,1,GAAATACCGTGGTTATATTT,0,5057124
ykgRp,0.5,1,1,GAAATACCGTATCATGTATA,0,5040293
ykgRp,0.5,1,1,GAAAGGAGCTCAATATCTAA,0,5058215
ykgRp,0.5,1,1,GAAAGAGTCTAGGGTCAACG,0,5042481
ykgRp,0.5,1,1,GAAACTTGGGCTATTTAAGT,0,5055644
ykgRp,0.5,1,1,GAAACCTGTTGCACGCCAAG,0,5031784
ykgRp,0.5,1,1,GAAACATGTCGGCCTTTAAC,0,5051874
ykgRp,0.5,1,1,GAAACAGTTATTTGTAAGCG,0,5052443
ykgRp,0.5,1,1,GAAACAGATTGAATCTTCTA,0,5060028
ykgRp,0.5,1,1,GAAAACGGTATCCCGGCATA,0,5049396
ykgRp,0.5,1,1,CTTTTGGTCTCCAGGCCCCG,0,5033290
ykgRp,0.5,1,1,CTTTTGCTCACCATCTCCGG,0,5059006
ykgRp,0.5,1,1,CTTTTATCGATGCTGGAATC,0,5045814
ykgRp,0.5,1,1,CTTTTACTCGTCATCCTGTG,0,5041071
ykgRp,0.5,1,1,CTTTGGGACCTTACATTAGC,0,5032635
ykgRp,0.5,1,1,CTTTGAATTCGGAGCAACGC,0,5045443
ykgRp,0.5,1,1,CTTTCTTACAAGGAACCGTA,0,5056595
ykgRp,0.5,1,1,CTTTACGCCTTTGAGACAAT,0,5033089
ykgRp,0.5,1,1,CTTTACCCTGGATCGGTAGA,0,5054063
ykgRp,0.5,1,1,CTTTAAAATCCGAGGGGCTC,0,5036190
ykgRp,0.5,1,1,CTTGTTTTTGGACCGATGAT,0,5052333
ykgRp,0.5,1,1,CTTGTGTAGTTCAAGTACAG,0,5055502
ykgRp,0.5,1,1,CTTGTCATATGTCCGATTTG,0,5056381
ykgRp,0.5,1,1,CTTGTAAGTAACCACGTAAG,0,5035023
ykgRp,0.5,1,1,CTTGGACGACGGCTTTGGTG,0,5042437
ykgRp,0.5,1,1,CTTGCGATTTAGTGATCGTT,0,5031987
ykgRp,0.5,1,1,CTTGCGAGCACCCGGCATCT,0,5061673
ykgRp,0.5,1,1,CTTGAGTATTCTTAAGGATA,0,5035189
ykgRp,0.5,1,1,CTTCTAGATTAACTTGTCCT,0,5045791
ykgRp,0.5,1,1,CTTCGTTCGGAACAGCTACA,0,5037758
ykgRp,0.5,1,1,CTTATTTTAGCAGGATCACC,0,5038172
ykgRp,0.5,1,1,CTTACCCGGCTGATGGGGAG,0,5042609
ykgRp,0.5,1,1,CTTACCACTCGGGACGAAAA,0,5033914
ykgRp,0.5,1,1,CTTACAGACTAACAGAAGTA,0,5057238
ykgRp,0.5,1,1,CTTAATTAACCAACTTTGGC,0,5041610
ykgRp,0.5,1,1,CTTAAAGCGACGAGTACCGT,0,5058562
ykgRp,0.5,1,1,CTGTTTAAGCGTACAAGATA,0,5040108
ykgRp,0.5,1,1,CTGTTGTCTGACTATAGCCC,0,5057805
ykgRp,0.5,1,1,CTGTGTTTTGTAGTATCTCG,0,5038383
ykgRp,0.5,1,1,CTGTCCGGGCAAAAGTGCGC,0,5043525
ykgRp,0.5,1,1,CTGTCAGAGACCTATGCCTC,0,5036104
ykgRp,0.5,1,1,CTGGTTGCTTTTGGTCACCA,0,5032453
ykgRp,0.5,1,1,CTGGTGTTAAAGCCATGATT,0,5037463
ykgRp,0.5,1,1,CTGGGCCACAACAAAAGCTA,0,5043085
ykgRp,0.5,1,1,CTGGCTAGGTTATGAGAATC,0,5034746
ykgRp,0.5,1,1,CTGGCCGTTGAGAAAAGAAG,0,5048287
ykgRp,0.5,1,1,CTGGCCACGACGCCAGCTGC,0,5046530
ykgRp,0.5,1,1,CTGGCATTGTGAAAAAGGGG,0,5059869
ykgRp,0.5,1,1,CTGGATATACTGCGGTACAA,0,5035366
ykgRp,0.5,1,1,CTGGAGTCCACAGAAAGACG,0,5042423
ykgRp,0.5,1,1,CTGGAAAGGTGGACGCGGAC,0,5035879
ykgRp,0.5,1,1,CTGCGGTTACCGCGAAGAAC,0,5061188
ykgRp,0.5,1,1,CTGCGCCGACCGTCTCTGCA,0,5038901
ykgRp,0.5,1,1,CTGCCAGGTAGACGGGATAG,0,5038199
ykgRp,0.5,1,1,CTGCCAAACCATCGGGGTAA,0,5032018
ykgRp,0.5,1,1,CTGAGTACGTATTGTATGCG,0,5049537
ykgRp,0.5,1,1,CTGAGGCTAGGTGGCGCGCG,0,5034018
ykgRp,0.5,1,1,CTGAGCAGGGGAAGAGGTCG,0,5057794
ykgRp,0.5,1,1,CTGAGAAATAAGTGAATTTC,0,5052014
ykgRp,0.5,1,1,CTGACTATATGACTATCGGC,0,5040155
ykgRp,0.5,1,1,CTGACCTTACCCATCGAATT,0,5037036
ykgRp,0.5,1,1,CTGACAGGGGCTTATAGTAT,0,5039572
ykgRp,0.5,1,1,CTGAAAAACGGAAGATCTAG,0,5057304
ykgRp,0.5,1,1,CTCTTGACCGTGTGACCCGT,0,5039482
ykgRp,0.5,1,1,CTCTCTAGAACAATAGGAGT,0,5038014
ykgRp,0.5,1,1,CTCTATACCGGAATTGCAGT,0,5042206
ykgRp,0.5,1,1,CTCTACGCTCCAGCCCCTAG,0,5051196
ykgRp,0.5,1,1,CTCGGGTTACTAACCAATTC,0,5059121
ykgRp,0.5,1,1,CTCGGGCTGCGCTACTGAAC,0,5033563
ykgRp,0.5,1,1,CTCGGCAATAGCCTTCCCTC,0,5051430
ykgRp,0.5,1,1,CTCGCAGTAGCATCTTCTAT,0,5031943
ykgRp,0.5,1,1,CTCGCAGGGAAACTTCGAAG,0,5044899
ykgRp,0.5,1,1,CTCGACGGCTGTCCCGGTTA,0,5037163
ykgRp,0.5,1,1,CTCGAAGACTGAGCAGAGTA,0,5039545
ykgRp,0.5,1,1,CTCCACGTCGGATGTCGAGT,0,5034358
ykgRp,0.5,1,1,CTCAGCCTAATATGAGAGCA,0,5040356
ykgRp,0.5,1,1,CTCACCTACTGGGTTTCGTA,0,5045037
ykgRp,0.5,1,1,CTCACATGAAATCTCGTGGT,0,5040542
ykgRp,0.5,1,1,CTCACAGGTAGGACGACGCT,0,5042278
ykgRp,0.5,1,1,CTCAATTGGTGTCAGAAAAG,0,5054259
ykgRp,0.5,1,1,CTCAATTAAAGTTCTAGAAA,0,5033975
ykgRp,0.5,1,1,CTCAAACTGGAGATAACCCT,0,5045864
ykgRp,0.5,1,1,CTATTTGGGTTTTCCTCAAG,0,5040325
ykgRp,0.5,1,1,CTATTTACGTCATGGCCTCA,0,5034578
ykgRp,0.5,1,1,CTATTCCTTGTACCTCGTTA,0,5043279
ykgRp,0.5,1,1,CTATTCCGCAGACCGCAAGC,0,5044491
ykgRp,0.5,1,1,CTATTCAAGTATTGATTCTT,0,5045355
ykgRp,0.5,1,1,CTATGGGGCTGGTGTGAACA,0,5055418
ykgRp,0.5,1,1,CTATGGCTGTATCTACAGTA,0,5057470
ykgRp,0.5,1,1,CTATCGCCAGCAGATTAGAT,0,5037252
ykgRp,0.5,1,1,CTATCCTCAGGTTTCCGCTA,0,5040258
ykgRp,0.5,1,1,CTATAGGGGCTACACCACCT,0,5052959
ykgRp,0.5,1,1,CTATAGGAATGTCAGGGTGG,0,5053079
ykgRp,0.5,1,1,CTATACCGTGAGAAAGAGAC,0,5054716
ykgRp,0.5,1,1,CTATAAAAAGTAGCGATTGG,0,5034931
ykgRp,0.5,1,1,CTAGTCTGTGGTCACTACTA,0,5054415
ykgRp,0.5,1,1,CTAGTAGGGAAATTATAGGG,0,5053302
ykgRp,0.5,1,1,CTAGCATTCCGTACAGTTAC,0,5059034
ykgRp,0.5,1,1,CTAGATGTGCAGCCTGTGTT,0,5031937
ykgRp,0.5,1,1,CTAGAACTGCTTCTAGCGCA,0,5049242
ykgRp,0.5,1,1,CTACTGACTCCGGTCCGAGT,0,5032017
ykgRp,0.5,1,1,CTACGAGTTCGCCGTTACAA,0,5031588
ykgRp,0.5,1,1,CTACCCGTGCCATGACGAAC,0,5034962
ykgRp,0.5,1,1,CTACAGGAGTGGAACAACTC,0,5047280
ykgRp,0.5,1,1,CTACACGCAACATTTACTTT,0,5034428
ykgRp,0.5,1,1,CTAATTCGTCTAGTTAGTAA,0,5047053
ykgRp,0.5,1,1,CTAATGGCATCTATCCCAGA,0,5043351
ykgRp,0.5,1,1,CTAATATTTGAACTTAGCAT,0,5037279
ykgRp,0.5,1,1,CTAATATCGAGGAGGTTGTA,0,5043290
ykgRp,0.5,1,1,CTAATACGCATTTGGTTAAT,0,5046191
ykgRp,0.5,1,1,CTAACTGCCCGTACCGCAGA,0,5033160
ykgRp,0.5,1,1,CTAACATGATTGGCTCACCG,0,5040507
ykgRp,0.5,1,1,CTAAAAGGGCGACCACAGAA,0,5040260
ykgRp,0.5,1,1,CTAAAAGGACCTTCACCCGG,0,5040995
ykgRp,0.5,1,1,CTAAAAACACCTTGTCTCAA,0,5038616
ykgRp,0.5,1,1,CGTTTGAGTGATCTTCTACT,0,5061059
ykgRp,0.5,1,1,CGTTTCGCGGTACGTGAGAG,0,5035313
ykgRp,0.5,1,1,CGTTGAAAGCCGACTGTAGC,0,5032824
ykgRp,0.5,1,1,CGTTATTCAGAAAATTTCAA,0,5038610
ykgRp,0.5,1,1,CGTTATCTGTATCATGTCTG,0,5057920
ykgRp,0.5,1,1,CGTTAAGCTCATCGTCTGTT,0,5055283
ykgRp,0.5,1,1,CGTTAACAGAATGTATTGGA,0,5031654
ykgRp,0.5,1,1,CGTGTTGGTGATGTGGGAGA,0,5032703
ykgRp,0.5,1,1,CGTGTGCCTCATCGCCAAGC,0,5049115
ykgRp,0.5,1,1,CGTGTGCAGAATCTGGGGTG,0,5032089
ykgRp,0.5,1,1,CGTGGGCACAATTCGTAGCC,0,5040453
ykgRp,0.5,1,1,CGTGGCCAATTTTTTCGGAG,0,5051236
ykgRp,0.5,1,1,CGTGGACGGATACCTTCTAA,0,5044127
ykgRp,0.5,1,1,CGTGCTAGTCTATGGCTTCC,0,5037537
ykgRp,0.5,1,1,CGTGCGGCCCTCCACTTCCA,0,5049184
ykgRp,0.5,1,1,CGTGAATACCCCTGAAGAGG,0,5042965
ykgRp,0.5,1,1,CGTCTTACATGGCGAGTCGT,0,5039191
ykgRp,0.5,1,1,CGTCGTGTAAGCGCTTCCTA,0,5042273
ykgRp,0.5,1,1,CGTCGTAGGACGTTATCCGA,0,5056403
ykgRp,0.5,1,1,CGTCGGCTCTACCTCGTGAT,0,5059044
ykgRp,0.5,1,1,CGTCCAGGGTGGGTTCTAAC,0,5050657
ykgRp,0.5,1,1,CGTCAGCGGTACCGAGCTAA,0,5033518
ykgRp,0.5,1,1,CGTCAAAGCCGAAATCCTGG,0,5043907
ykgRp,0.5,1,1,CGTATTAAAGACGGCTAATT,0,5036526
ykgRp,0.5,1,1,CGTAGGGCTGAGTTCCTTCA,0,5047225
ykgRp,0.5,1,1,CGTAGCAAGGCAGGGGACCG,0,5050407
ykgRp,0.5,1,1,CGTACCCGCTATGACTCAGA,0,5039554
ykgRp,0.5,1,1,CGGTTTAAATTGATGCCGGA,0,5035621
ykgRp,0.5,1,1,CGGTTGTGTCTGGCGGCGTG,0,5048411
ykgRp,0.5,1,1,CGGTTGACAAAAGGGGTCCT,0,5055842
ykgRp,0.5,1,1,CGGTGTGAGCATGTGCCATC,0,5047089
ykgRp,0.5,1,1,CGGTGCCGGTATCGTCATCT,0,5046901
ykgRp,0.5,1,1,CGGTGATTTAGTTAAAGTAC,0,5031796
ykgRp,0.5,1,1,CGGTCGGTTCTAAGCGCGGT,0,5051634
ykgRp,0.5,1,1,CGGTCCTTTTGGGGATGCAT,0,5034966
ykgRp,0.5,1,1,CGGTATTGCACCAAAGGACA,0,5057010
ykgRp,0.5,1,1,CGGGTTTCTGTGCAGTCTCG,0,5034024
ykgRp,0.5,1,1,CGGGTCGTAGGGTGGTCTGG,0,5036389
ykgRp,0.5,1,1,CGGGTAGGTAAAACATTCGG,0,5040044
ykgRp,0.5,1,1,CGGGGGGATCCCTCCGCTAT,0,5034971
ykgRp,0.5,1,1,CGGGGGAATATGCCGTCAAA,0,5040862
ykgRp,0.5,1,1,CGGGGCTGATCTGATAGTGG,0,5042455
ykgRp,0.5,1,1,CGGGGCTCGGCTGCGGTATT,0,5045462
ykgRp,0.5,1,1,CGGGCGGACTTCGCTTAGAT,0,5059232
ykgRp,0.5,1,1,CGGGACCTTAATGCCGGACG,0,5039763
ykgRp,0.5,1,1,CGGCGTCGAGGGAAACTTGG,0,5057999
ykgRp,0.5,1,1,CGGCGGTTTATACAAGTTAG,0,5042201
ykgRp,0.5,1,1,CGGCCTGTGTCGGACAGGCT,0,5043129
ykgRp,0.5,1,1,CGGCCGGATATTACCCCGGG,0,5035722
ykgRp,0.5,1,1,CGGCAGGAGCTTACAAGAAG,0,5050132
ykgRp,0.5,1,1,CGGCAAATTCTTTATTTTAG,0,5050477
ykgRp,0.5,1,1,CGGCAAATATGAATATGGAC,0,5040743
ykgRp,0.5,1,1,CGGATTGCGTATTGTTTGTA,0,5041112
ykgRp,0.5,1,1,CGGAGGGACACCAAATAGAC,0,5036877
ykgRp,0.5,1,1,CGGAGCACTACGGGAATAGA,0,5049750
ykgRp,0.5,1,1,CGGAGCAACAATATGCAGGA,0,5054226
ykgRp,0.5,1,1,CGGACTTCTGTGTGAACTCT,0,5035346
ykgRp,0.5,1,1,CGGACGTGAACTGGGGCTCG,0,5046621
ykgRp,0.5,1,1,CGGACCTCCCAATCTCTCTA,0,5043162
ykgRp,0.5,1,1,CGGACAGAGAATCTTGCCGG,0,5057340
ykgRp,0.5,1,1,CGGACACACTACGAATTTCG,0,5044995
ykgRp,0.5,1,1,CGGAATGTGGTTCTATTAAA,0,5047851
ykgRp,0.5,1,1,CGGAAGGTTGGTACCAGGAC,0,5052345
ykgRp,0.5,1,1,CGCTTTAGGGGAAAGGCTGT,0,5053889
ykgRp,0.5,1,1,CGCTTGGACCCGGTTTCGGT,0,5045115
ykgRp,0.5,1,1,CGCTTGCCGCCGATGTGAGA,0,5047973
ykgRp,0.5,1,1,CGCTGTTCGGTCTTCTGTTC,0,5047281
ykgRp,0.5,1,1,CGCTGGACAGGTCACGCTAC,0,5058355
ykgRp,0.5,1,1,CGCTCGTCATCAGCCGAAGA,0,5033584
ykgRp,0.5,1,1,CGCTATATCTTTAGGAGCTA,0,5060486
ykgRp,0.5,1,1,CGCTATAGTAAGCCACAGTA,0,5045680
ykgRp,0.5,1,1,CGCTATAACTCAACTTTTTG,0,5060141
ykgRp,0.5,1,1,CGCTACGGCCAACTCCAGCC,0,5043749
ykgRp,0.5,1,1,CGCGTTCTACCTTGTTAGGT,0,5036709
ykgRp,0.5,1,1,CGCGGGAATCATTGTCAAGT,0,5057121
ykgRp,0.5,1,1,CGCGGATGGAATTCGGGAAC,0,5036378
ykgRp,0.5,1,1,CGCCGAGTAAGTCCTTCCCT,0,5035489
ykgRp,0.5,1,1,CGCCCGCGAAGCTATGGCCT,0,5055946
ykgRp,0.5,1,1,CGCCCACGTCAGTTCATGTA,0,5043460
ykgRp,0.5,1,1,CGCATGTCATGAAGTCGTTA,0,5040531
ykgRp,0.5,1,1,CGCATGAGGACGGGGATGAG,0,5051649
ykgRp,0.5,1,1,CGCAGTAGCCTATCTGGTTA,0,5060939
ykgRp,0.5,1,1,CGCAGCCTTTCTTAGATGAA,0,5034524
ykgRp,0.5,1,1,CGCAGAGACTTAGCAGCCTA,0,5061204
ykgRp,0.5,1,1,CGCAGACCAAACCCTACGAT,0,5061672
ykgRp,0.5,1,1,CGCACCGCGCGTCTCCTAGG,0,5048470
ykgRp,0.5,1,1,CGCACATTGAAGTCGTGACC,0,5039912
ykgRp,0.5,1,1,CGCACATGGTTACCAGGAAC,0,5061558
ykgRp,0.5,1,1,CGCAATCGAGAATCTCAAAA,0,5045163
ykgRp,0.5,1,1,CGATGTTGAGGCTTAAATCG,0,5043047
ykgRp,0.5,1,1,CGATGTACTTTCACCCTGAT,0,5050870
ykgRp,0.5,1,1,CGATGTAACCATTGTGGGTT,0,5043910
ykgRp,0.5,1,1,CGATGCGCATATCATAGATG,0,5059282
ykgRp,0.5,1,1,CGATCTCGGTATTGCCGCTT,0,5059088
ykgRp,0.5,1,1,CGATATGTAACAGCTCAATC,0,5055517
ykgRp,0.5,1,1,CGATAGCCTAGGAGTTGTGA,0,5052413
ykgRp,0.5,1,1,CGATAACCTGAGCTCGCTAG,0,5048727
ykgRp,0.5,1,1,CGAGGACGTCTTAAAGCGGG,0,5041496
ykgRp,0.5,1,1,CGAGCCCAAGCGGAATCTTA,0,5040704
ykgRp,0.5,1,1,CGAGCAATCGTCAGACGCAG,0,5043637
ykgRp,0.5,1,1,CGAGATGTTTCGGGCCTCCT,0,5047282
ykgRp,0.5,1,1,CGAGAGGCATTGGCTGGACT,0,5036802
ykgRp,0.5,1,1,CGAGACGATCTTGAAATCGG,0,5058334
ykgRp,0.5,1,1,CGAGAAGCGTCTCGATAGAA,0,5045523
ykgRp,0.5,1,1,CGAGAACAGGAACCTAGACC,0,5049053
ykgRp,0.5,1,1,CGACTACGATCCGCGGAACT,0,5047347
ykgRp,0.5,1,1,CGACGTACCTTTGACGTCTC,0,5038072
ykgRp,0.5,1,1,CGACGCGGGGCGACGCCACG,0,5056192
ykgRp,0.5,1,1,CGACGACGCGCCGTTACAAG,0,5045449
ykgRp,0.5,1,1,CGACGACCAGACATACAACA,0,5039870
ykgRp,0.5,1,1,CGACCGTGTTCAGGGTTAAC,0,5052841
ykgRp,0.5,1,1,CGACCGGGCTTTGTTGTAAA,0,5032114
ykgRp,0.5,1,1,CGACCAGGAGCACAGTAATT,0,5061069
ykgRp,0.5,1,1,CGACCACGCGTTGGCGTCTC,0,5051946
ykgRp,0.5,1,1,CGACATCCAAAGGGCGAACT,0,5045633
ykgRp,0.5,1,1,CGACAGTTGCATTAGAGAAA,0,5048452
ykgRp,0.5,1,1,CGAATGGTACCATGACCCAG,0,5046126
ykgRp,0.5,1,1,CGAATAGGCGTTGTTTTACA,0,5060505
ykgRp,0.5,1,1,CGAAGCCCTCGGGGGCGGAA,0,5055949
ykgRp,0.5,1,1,CGAAATTGCTGTACTCCAAA,0,5059498
ykgRp,0.5,1,1,CGAAAGAACTCGGTGTGACG,0,5053694
ykgRp,0.5,1,1,CGAAAACACCACACCGTATT,0,5051925
ykgRp,0.5,1,1,CCTTTTCCCAGAATTCGATA,0,5034123
ykgRp,0.5,1,1,CCTTTCCATGTCACACGGCT,0,5061058
ykgRp,0.5,1,1,CCTTCATACAGTCTAGCCCA,0,5042163
ykgRp,0.5,1,1,CCTTAGTTTCGCCACGCATT,0,5048642
ykgRp,0.5,1,1,CCTGTTCACCCTCTCAGAAC,0,5035633
ykgRp,0.5,1,1,CCTGTCGCTCCAGAACTGGC,0,5060139
ykgRp,0.5,1,1,CCTGCGAGTTGTTCCGACCT,0,5039395
ykgRp,0.5,1,1,CCTGCCGTTCTATTGAGTGC,0,5046493
ykgRp,0.5,1,1,CCTGCCATGGAACCGACGGG,0,5053500
ykgRp,0.5,1,1,CCTGAGTTGGTGGGGAAATC,0,5040916
ykgRp,0.5,1,1,CCTGAGTATCAGTCTAGCTG,0,5049767
ykgRp,0.5,1,1,CCTGAGCGTCAGTCCTAGTT,0,5051117
ykgRp,0.5,1,1,CCTGAGCGGAACGTTGAACG,0,5041377
ykgRp,0.5,1,1,CCTGACGCGCGCACGATTGA,0,5044077
ykgRp,0.5,1,1,CCTCTAAAAGGTGGTGTTGA,0,5035424
ykgRp,0.5,1,1,CCTCGCCGCCCATAGAAACC,0,5040943
ykgRp,0.5,1,1,CCTCGAGAGTAAACTGGAAC,0,5045627
ykgRp,0.5,1,1,CCTCGACTCCAGGCGGGGAA,0,5040042
ykgRp,0.5,1,1,CCTCCTTATCGTGGAGCGGC,0,5032391
ykgRp,0.5,1,1,CCTCCCACTCGCAGGATCAC,0,5060310
ykgRp,0.5,1,1,CCTCCACCAAGCCAACTTTT,0,5050381
ykgRp,0.5,1,1,CCTCAACTGCCGGGCCTACG,0,5043902
ykgRp,0.5,1,1,CCTATTGGGGAAGCTACTCA,0,5041161
ykgRp,0.5,1,1,CCTATGTACTTGGCCCGTCC,0,5034824
ykgRp,0.5,1,1,CCTATGCGCATTGGCAATCT,0,5050955
ykgRp,0.5,1,1,CCTATCCGGCACATTATGAC,0,5060950
ykgRp,0.5,1,1,CCTATACACCCGACATACCA,0,5050147
ykgRp,0.5,1,1,CCTAGTGGGCTTAAATGAAG,0,5033119
ykgRp,0.5,1,1,CCTAGTCAACGATGAGGGGT,0,5050095
ykgRp,0.5,1,1,CCTAGGGGAGCGTTTGCCCT,0,5051814
ykgRp,0.5,1,1,CCTAGGCTTATACAGGTGGC,0,5058785
ykgRp,0.5,1,1,CCTACAATCGTGGGCACGCG,0,5049827
ykgRp,0.5,1,1,CCTAATCTAGGCGCCACAAT,0,5037570
ykgRp,0.5,1,1,CCTAAGTGAGGCAGTGGACA,0,5057015
ykgRp,0.5,1,1,CCTAAATCCGTCGATTATAA,0,5043914
ykgRp,0.5,1,1,CCGTGGCCGTGGGTTCTCAG,0,5058122
ykgRp,0.5,1,1,CCGTGGACCTTTTCTCTATA,0,5052678
ykgRp,0.5,1,1,CCGTCCCTTGACACTAAGTA,0,5048279
ykgRp,0.5,1,1,CCGTATGCCCCAGGACTGTT,0,5031861
ykgRp,0.5,1,1,CCGTACCCGATATAATAGAG,0,5056383
ykgRp,0.5,1,1,CCGTAATTGGCGTCATTTAA,0,5046082
ykgRp,0.5,1,1,CCGGTTTGCAAGGAACCAAT,0,5045581
ykgRp,0.5,1,1,CCGGTTCAAGGACAAGTACT,0,5034223
ykgRp,0.5,1,1,CCGGTTAAAGTGTTCACACC,0,5045473
ykgRp,0.5,1,1,CCGGTGGGGCGTCGTATTAA,0,5036999
ykgRp,0.5,1,1,CCGGGTGGCATGAGGTTAAC,0,5040290
ykgRp,0.5,1,1,CCGGGGAATACAGCTTACCG,0,5036775
ykgRp,0.5,1,1,CCGGGCGCAATAGATTCCTC,0,5051089
ykgRp,0.5,1,1,CCGGGAGGGGGATAACGGGG,0,5036780
ykgRp,0.5,1,1,CCGGCGACTCTCTTGGAGGC,0,5042458
ykgRp,0.5,1,1,CCGGAGCGAGTAGATTGTTG,0,5034108
ykgRp,0.5,1,1,CCGGACTGTTTACAACTCTA,0,5034179
ykgRp,0.5,1,1,CCGCTAGATGGTGTCATCAC,0,5038878
ykgRp,0.5,1,1,CCGCCGTACCCGAATCGAAG,0,5058119
ykgRp,0.5,1,1,CCGCCGAAGGGTCAGAGTAA,0,5038718
ykgRp,0.5,1,1,CCGCAGCTGCTGCTACTACC,0,5057956
ykgRp,0.5,1,1,CCGCAATATTAGTAGTGTCC,0,5052970
ykgRp,0.5,1,1,CCGCAATAGGTTACTACGGA,0,5060285
ykgRp,0.5,1,1,CCGAGCAGCCGAGTGGCAGA,0,5059158
ykgRp,0.5,1,1,CCGAGAGCGGAGACCACTTG,0,5034577
ykgRp,0.5,1,1,CCGAATGGTTTTGGACTCCC,0,5056162
ykgRp,0.5,1,1,CCGAAGACTGGACGGGTATT,0,5057781
ykgRp,0.5,1,1,CCGAACATGGTGTTCCTGGA,0,5060934
ykgRp,0.5,1,1,CCGAAATCTAATCGGAGCCC,0,5035058
ykgRp,0.5,1,1,CCCTTCGTTAGATCCGCATA,0,5043395
ykgRp,0.5,1,1,CCCTTCCACGAGCCGATATT,0,5043245
ykgRp,0.5,1,1,CCCTCTTTAACGTGCCTCGT,0,5040405
ykgRp,0.5,1,1,CCCTCCCATGATGAATCAGG,0,5050358
ykgRp,0.5,1,1,CCCTCACATAACTTCAACGA,0,5044011
ykgRp,0.5,1,1,CCCTATGCTTACCATGCACC,0,5034311
ykgRp,0.5,1,1,CCCTAGAACCCGATCTCTCA,0,5048971
ykgRp,0.5,1,1,CCCGTTGCATCCTGTCACAT,0,5043149
ykgRp,0.5,1,1,CCCGTTCTGATGCCTGTGGG,0,5048137
ykgRp,0.5,1,1,CCCGTCCGGAAGTTTCACGG,0,5031415
ykgRp,0.5,1,1,CCCGTAGTTTGAGTAGATGC,0,5043023
ykgRp,0.5,1,1,CCCGTAGGTCTCTGGGGTAG,0,5042135
ykgRp,0.5,1,1,CCCGTAGAGAATTCATAAAG,0,5034015
ykgRp,0.5,1,1,CCCGTACATTGGAACGTGTC,0,5049882
ykgRp,0.5,1,1,CCCGGTTTACCAATTCAGAA,0,5034908
ykgRp,0.5,1,1,CCCGGTGTGGGAAGTCTCTG,0,5051055
ykgRp,0.5,1,1,CCCGGACTCGAACCCCTGCA,0,5040316
ykgRp,0.5,1,1,CCCGCTGCTCCAGGACAGAG,0,5035211
ykgRp,0.5,1,1,CCCGCAGGACAAGGCGAACA,0,5039410
ykgRp,0.5,1,1,CCCGCAGCAAAGCAGACGTG,0,5043059
ykgRp,0.5,1,1,CCCCGGCCGAAGACAATTCG,0,5036626
ykgRp,0.5,1,1,CCCCCTGTATTTCCGATATC,0,5045207
ykgRp,0.5,1,1,CCCCAGAGTCTTTGTTGGAA,0,5042689
ykgRp,0.5,1,1,CCCATCATTGATAACCAAGA,0,5040422
ykgRp,0.5,1,1,CCCAGTTACTATCTCACATG,0,5035853
ykgRp,0.5,1,1,CCCAGAGGGACTCTATCTCA,0,5047332
ykgRp,0.5,1,1,CCCACTATGAGATGACGAAA,0,5052240
ykgRp,0.5,1,1,CCCACCGTGGAATTAAAGTC,0,5034728
ykgRp,0.5,1,1,CCATTGGACTGCGGACGACG,0,5040949
ykgRp,0.5,1,1,CCATCCTCATTATGTTTATG,0,5060277
ykgRp,0.5,1,1,CCATCCGGCGATCTCAGGCA,0,5053226
ykgRp,0.5,1,1,CCATACGTTCGTAAACAAAA,0,5055854
ykgRp,0.5,1,1,CCAGCTGAGGGCCTGACCTT,0,5055038
ykgRp,0.5,1,1,CCAGCACAATCCTCACAATT,0,5039068
ykgRp,0.5,1,1,CCAGATGCGGGATTCGGGGT,0,5040659
ykgRp,0.5,1,1,CCAGACGGGTAGATCTTGCC,0,5053699
ykgRp,0.5,1,1,CCACTTAGGATTATCCCGAC,0,5058795
ykgRp,0.5,1,1,CCACGATAGTATAGGGTGGA,0,5045507
ykgRp,0.5,1,1,CCACAGGTGTGGGAGGCGGC,0,5061730
ykgRp,0.5,1,1,CCAATTCGTGCCGATCTCAA,0,5032580
ykgRp,0.5,1,1,CCAATGTAATCTTTCCTAAG,0,5047501
ykgRp,0.5,1,1,CCAATGACTGAGCCGGTTAG,0,5051377
ykgRp,0.5,1,1,CCAATGAAGTATCCACATTT,0,5040906
ykgRp,0.5,1,1,CCAATCCCGAAACGGACCTG,0,5041347
ykgRp,0.5,1,1,CCAAGGGAACTTTAAGGCTT,0,5039108
ykgRp,0.5,1,1,CCAACCTGCTTCGCTATACT,0,5055622
ykgRp,0.5,1,1,CCAACACCGTAATTAAGAGT,0,5038678
ykgRp,0.5,1,1,CCAACAAAGGACAGGATAAG,0,5045411
ykgRp,0.5,1,1,CCAAAATGAGTCTCATAACC,0,5058827
ykgRp,0.5,1,1,CATTTTCCCACACTGTGGTA,0,5048323
ykgRp,0.5,1,1,CATTGTTCCACTTAAAACTG,0,5039597
ykgRp,0.5,1,1,CATTGCGCGAAGTAGCGCCG,0,5058420
ykgRp,0.5,1,1,CATTATAAACAGTGTGGGTG,0,5051552
ykgRp,0.5,1,1,CATTACCGCCTGTGTGAAGC,0,5047955
ykgRp,0.5,1,1,CATGTTCGATTTTACGACCA,0,5043510
ykgRp,0.5,1,1,CATGTATAGTTTCTCACGAT,0,5033935
ykgRp,0.5,1,1,CATGGGATGTTCGAGATGGC,0,5054811
ykgRp,0.5,1,1,CATGGCTGCAGCACTGACGA,0,5047996
ykgRp,0.5,1,1,CATGGAATCCGTGCGGTAGC,0,5056571
ykgRp,0.5,1,1,CATGCGTCTCGCAGACCAGG,0,5058185
ykgRp,0.5,1,1,CATGATTCCGGTACACCGCA,0,5046357
ykgRp,0.5,1,1,CATCCAGACTCACTGAAGGT,0,5038632
ykgRp,0.5,1,1,CATCAGGGATTGTAGACATC,0,5040365
ykgRp,0.5,1,1,CATATCTGTCTGACCACAAC,0,5047829
ykgRp,0.5,1,1,CATAGTCCGGCGGGCCGAGT,0,5061530
ykgRp,0.5,1,1,CATAGCTTTGGAGACTCTAT,0,5061305
ykgRp,0.5,1,1,CATACCGCTTGGAGCGGGTT,0,5055110
ykgRp,0.5,1,1,CAGTTTTAATATTTTTGAGG,0,5054567
ykgRp,0.5,1,1,CAGTTATCAATCTTCCAGAG,0,5056921
ykgRp,0.5,1,1,CAGTCTTGAGGGATGGCGGC,0,5032956
ykgRp,0.5,1,1,CAGTCTACTTTTCGGCAGAT,0,5052805
ykgRp,0.5,1,1,CAGTCGTCCGGGTCCAGAGA,0,5047847
ykgRp,0.5,1,1,CAGTCGGAACCCATAACGTT,0,5048387
ykgRp,0.5,1,1,CAGTACCGTCTCGCTACGGC,0,5050266
ykgRp,0.5,1,1,CAGGTATGGGTCTGGCGTTT,0,5043771
ykgRp,0.5,1,1,CAGGGTTTTCAAAGCACTTT,0,5035948
ykgRp,0.5,1,1,CAGGGATGACCGGTGCGCCT,0,5059408
ykgRp,0.5,1,1,CAGGCTCTATGGCGGCGGCA,0,5047957
ykgRp,0.5,1,1,CAGGCGCCTAAGGAACTCGA,0,5031760
ykgRp,0.5,1,1,CAGGCAGGCACAACGTAAGC,0,5043997
ykgRp,0.5,1,1,CAGGCAGCCCTCCAAGCTGC,0,5056065
ykgRp,0.5,1,1,CAGGATTACCGAAACTACGT,0,5041197
ykgRp,0.5,1,1,CAGGAGGCCACTTCATTTGA,0,5045287
ykgRp,0.5,1,1,CAGGAGAGAGCATATGCAGT,0,5043697
ykgRp,0.5,1,1,CAGGAAAGCTCGAACACGAA,0,5041760
ykgRp,0.5,1,1,CAGCTTTTCACCGTGGCTCT,0,5041519
ykgRp,0.5,1,1,CAGCGAATTCTCAAGGTATG,0,5034838
ykgRp,0.5,1,1,CAGCGAACGGATGAGGTGGG,0,5061254
ykgRp,0.5,1,1,CAGCCGTATATGAGGCCACA,0,5040355
ykgRp,0.5,1,1,CAGCCCATGACACTAGCGCG,0,5041554
ykgRp,0.5,1,1,CAGCCCACAAGTGGTCGGCC,0,5037309
ykgRp,0.5,1,1,CAGATTAGCGAATGCGTGTG,0,5048494
ykgRp,0.5,1,1,CAGATGGAGGCCAAAGACCT,0,5047433
ykgRp,0.5,1,1,CAGAGTCCCTGTGCCTACAT,0,5059021
ykgRp,0.5,1,1,CAGAGGGTAGGCAAGGGTTC,0,5052859
ykgRp,0.5,1,1,CAGACTGCCATCGCGCCAAT,0,5060617
ykgRp,0.5,1,1,CAGACCAACATTCAAATCCA,0,5032038
ykgRp,0.5,1,1,CAGAACCTTCGGTTGTTGAC,0,5043033
ykgRp,0.5,1,1,CAGAACAAAGGTAATGCCGT,0,5037761
ykgRp,0.5,1,1,CAGAAATCTAGGGAGTTACA,0,5037728
ykgRp,0.5,1,1,CACTTACCCCGTTTGAAGAC,0,5033956
ykgRp,0.5,1,1,CACTGATCCCCCCGTACAAC,0,5059093
ykgRp,0.5,1,1,CACTGAGATGTTCTCTCGAA,0,5042129
ykgRp,0.5,1,1,CACTCTAAAGCAATAGGAGT,0,5041689
ykgRp,0.5,1,1,CACTATGTCACCAGTTGGGG,0,5050838
ykgRp,0.5,1,1,CACGTGGTATCCCCCCCTGA,0,5043812
ykgRp,0.5,1,1,CACGTCGCACTTACTGAGGA,0,5050416
ykgRp,0.5,1,1,CACGCTATACATCACTCTTT,0,5055898
ykgRp,0.5,1,1,CACGCCCGGCATCTCTATAG,0,5050843
ykgRp,0.5,1,1,CACGCAATTAGCGTCTTATT,0,5055394
ykgRp,0.5,1,1,CACGATGCTGAGTCATTTTC,0,5056028
ykgRp,0.5,1,1,CACCTTAACGTCTGCTAACA,0,5052235
ykgRp,0.5,1,1,CACCGAGGTGCTTGCCCGCC,0,5059015
ykgRp,0.5,1,1,CACCCTGACCGGCCTAGTTA,0,5046526
ykgRp,0.5,1,1,CACCCACCCAGCTAGCGTTC,0,5050827
ykgRp,0.5,1,1,CACCACTCCACAGTGCTTGG,0,5032669
ykgRp,0.5,1,1,CACCAACCCACATATGACGG,0,5036852
ykgRp,0.5,1,1,CACATAACCAAAGGGCATGG,0,5042310
ykgRp,0.5,1,1,CACAGGTTCCCCTACCAGGT,0,5056738
ykgRp,0.5,1,1,CACAGACCGGGGGTCACACT,0,5047052
ykgRp,0.5,1,1,CACAGACCAATAGGAATGCA,0,5035570
ykgRp,0.5,1,1,CACACTTTACGTTGAAATGG,0,5044711
ykgRp,0.5,1,1,CACACTCATTCCTGTACAGA,0,5041848
ykgRp,0.5,1,1,CACACCACTTGTTAAAAGGG,0,5031413
ykgRp,0.5,1,1,CACACAGGTCACCTGTGATG,0,5048765
ykgRp,0.5,1,1,CACAAGAACGTCATCTTGGA,0,5032959
ykgRp,0.5,1,1,CAATTCTAACTATGTGCAGT,0,5048208
ykgRp,0.5,1,1,CAATTACGTCTGTTATACCA,0,5057727
ykgRp,0.5,1,1,CAATGCCCAAAGGCCATACG,0,5035680
ykgRp,0.5,1,1,CAATCGAAATACACAGGGAT,0,5037827
ykgRp,0.5,1,1,CAAGTTAAGTAGTGACCAGG,0,5032696
ykgRp,0.5,1,1,CAAGTGGGTGCTATTTAGTG,0,5044597
ykgRp,0.5,1,1,CAAGTAATCTACTCAACTGA,0,5032989
ykgRp,0.5,1,1,CAAGCCATTTGGGAATTGCC,0,5044945
ykgRp,0.5,1,1,CAAGACTTGCCAGCTCCGTA,0,5033533
ykgRp,0.5,1,1,CAACTCGGAAGCTTTTGCCA,0,5054881
ykgRp,0.5,1,1,CAACGTGGCAGGAAGCAGAA,0,5053194
ykgRp,0.5,1,1,CAACGTCACGTGTTCAAGGG,0,5047879
ykgRp,0.5,1,1,CAACGGGGTTTGGTAAGGTA,0,5033144
ykgRp,0.5,1,1,CAACACCTGCTTAATTCTGC,0,5033298
ykgRp,0.5,1,1,CAACACAAGATCGCTAGCTT,0,5034500
ykgRp,0.5,1,1,CAACAATATCAGACAGAAGT,0,5050793
ykgRp,0.5,1,1,CAAATTGGTATTATGCTGCT,0,5051124
ykgRp,0.5,1,1,CAAATGACGCTAACATGGGG,0,5033463
ykgRp,0.5,1,1,CAAATACGGCCTTGTGGCTC,0,5050127
ykgRp,0.5,1,1,CAAAGGTTTCGCCGAGGCTC,0,5042719
ykgRp,0.5,1,1,CAAAGCTTCGTTTACCAAAA,0,5038684
ykgRp,0.5,1,1,CAAAGCTCGCAAGCTGGAAG,0,5042224
ykgRp,0.5,1,1,CAAACTCCAGGTACGTGATA,0,5061761
ykgRp,0.5,1,1,CAAAACTACGCCGCCTCTTG,0,5051157
ykgRp,0.5,1,1,ATTTTGGAGAGGTTCAACGG,0,5055507
ykgRp,0.5,1,1,ATTTGTTATGTCGGTGCAGG,0,5060468
ykgRp,0.5,1,1,ATTTGTGATATCGGTGTAGC,0,5042925
ykgRp,0.5,1,1,ATTTGCTCACGCCGGCAAGA,0,5057239
ykgRp,0.5,1,1,ATTTGACACTGGTGGGAATA,0,5031332
ykgRp,0.5,1,1,ATTTCGGGTCCGTGCAACTA,0,5032055
ykgRp,0.5,1,1,ATTTCCTTCCGATGAAGTTA,0,5035813
ykgRp,0.5,1,1,ATTTAGGGAAACTTAATCGT,0,5044135
ykgRp,0.5,1,1,ATTTAAAACCAATCGCTTAC,0,5042583
ykgRp,0.5,1,1,ATTGTTCTGTTTAGAGAATG,0,5035186
ykgRp,0.5,1,1,ATTGGAATTGCCGGGATAGA,0,5032530
ykgRp,0.5,1,1,ATTGCTGCGCAGCACATGCA,0,5042993
ykgRp,0.5,1,1,ATTGCTAACGGATAGCACTT,0,5049540
ykgRp,0.5,1,1,ATTGCGAGTCACATGATAGA,0,5061431
ykgRp,0.5,1,1,ATTGCATTGCCAGAAGCCCT,0,5054406
ykgRp,0.5,1,1,ATTGATGGGTTTCAGTCTAA,0,5050557
ykgRp,0.5,1,1,ATTGAGGTTTAGCAGACCTC,0,5058584
ykgRp,0.5,1,1,ATTGAGGGCGAGTCCTCGGA,0,5032973
ykgRp,0.5,1,1,ATTGAAGCATACATCGGCGG,0,5042271
ykgRp,0.5,1,1,ATTGAAAAGTTGATCGTATT,0,5057587
ykgRp,0.5,1,1,ATTCTAAACAAACAGATAAG,0,5046389
ykgRp,0.5,1,1,ATTCGTCAACTGCAGGGCAA,0,5051499
ykgRp,0.5,1,1,ATTCGGATGTGTAGTTCCAA,0,5045273
ykgRp,0.5,1,1,ATTCGAGAAGATCACCGCGA,0,5034131
ykgRp,0.5,1,1,ATTCGACTCTTAGGAACCGT,0,5043952
ykgRp,0.5,1,1,ATTCCAGACGACCCCGTCGT,0,5055811
ykgRp,0.5,1,1,ATTCATGTAAGGACCGTATT,0,5043906
ykgRp,0.5,1,1,ATTCACAGGAAGGCATGTTC,0,5050206
ykgRp,0.5,1,1,ATTCAATCGATGTTGCAATT,0,5036350
ykgRp,0.5,1,1,ATTATACATTGCATTTGCCA,0,5049983
ykgRp,0.5,1,1,ATTAGTTACAGATCGGGGGT,0,5044240
ykgRp,0.5,1,1,ATTAGCTCATCTTTGCACGG,0,5048788
ykgRp,0.5,1,1,ATTAGAGCGCCACTCGGGGC,0,5038918
ykgRp,0.5,1,1,ATTACGGTCGGAGACGCTCG,0,5049222
ykgRp,0.5,1,1,ATTACGCCCGGCCATGAATC,0,5049374
ykgRp,0.5,1,1,ATTAATAGAATATCAAAATC,0,5035244
ykgRp,0.5,1,1,ATTAACATGTACTAGGTTGG,0,5053639
ykgRp,0.5,1,1,ATTAAATGAGTTATGCCGAC,0,5049037
ykgRp,0.5,1,1,ATGTTGATCTGTTGCAGAAA,0,5059782
ykgRp,0.5,1,1,ATGTGTTAACGGCCTCCCCT,0,5033156
ykgRp,0.5,1,1,ATGTCCTTTGTTCATACTCG,0,5043688
ykgRp,0.5,1,1,ATGTATCCAATTCGTAAGAT,0,5037227
ykgRp,0.5,1,1,ATGTAGGGTGAATCTTGCGG,0,5031624
ykgRp,0.5,1,1,ATGGTCTTTCTCCGGGCACC,0,5034709
ykgRp,0.5,1,1,ATGGTCAATCACGAATTCTT,0,5053313
ykgRp,0.5,1,1,ATGGTATTCTGCACGAAGTA,0,5034023
ykgRp,0.5,1,1,ATGGGGCTTAGGGTGAGTCA,0,5041935
ykgRp,0.5,1,1,ATGGGATTAGTCAAACCATT,0,5060242
ykgRp,0.5,1,1,ATGGCCGAGAGGACGCATGG,0,5059590
ykgRp,0.5,1,1,ATGGCCACAGCTCTGGCGTA,0,5033285
ykgRp,0.5,1,1,ATGGCAGCAGGGCTTGGATA,0,5059548
ykgRp,0.5,1,1,ATGGATAGCAGAAGGGGTGA,0,5046115
ykgRp,0.5,1,1,ATGGAGCTCGAAAATTGTGC,0,5048579
ykgRp,0.5,1,1,ATGGACGAGCCGACGGATCC,0,5039104
ykgRp,0.5,1,1,ATGGAACGCTATAAAACCTG,0,5057151
ykgRp,0.5,1,1,ATGGAAATTCACCTGGCGGT,0,5051189
ykgRp,0.5,1,1,ATGCTAACGACATACCCAAG,0,5060008
ykgRp,0.5,1,1,ATGCGCTCAATCGACGTAGT,0,5041542
ykgRp,0.5,1,1,ATGCCTTGGCGAACCTTGGT,0,5043415
ykgRp,0.5,1,1,ATGCCTTGCTGGGCCATAGC,0,5055820
ykgRp,0.5,1,1,ATGCCGATTTGAATATCTAG,0,5056520
ykgRp,0.5,1,1,ATGCATTCTTGTCTCAGGGA,0,5058778
ykgRp,0.5,1,1,ATGCACCCATCAAGCATCCG,0,5059636
ykgRp,0.5,1,1,ATGATGACACGCATCATGGT,0,5048846
ykgRp,0.5,1,1,ATGATACCGAACCAATAGTC,0,5045932
ykgRp,0.5,1,1,ATGAGAGGGGTTCGTAGAAA,0,5031944
ykgRp,0.5,1,1,ATGAATTCGCACAGATGCAA,0,5046558
ykgRp,0.5,1,1,ATGAAGTTAGAACCCGACAG,0,5044724
ykgRp,0.5,1,1,ATCTTGGTGGCGCTTCACCT,0,5054496
ykgRp,0.5,1,1,ATCTTCCTATCGCAGGAGTA,0,5054576
ykgRp,0.5,1,1,ATCTGTGGTATGTTCGGGTT,0,5047682
ykgRp,0.5,1,1,ATCTGTGGGCAAGGACTTTG,0,5060676
ykgRp,0.5,1,1,ATCTGGCTGAGCCGCCTGTC,0,5053583
ykgRp,0.5,1,1,ATCTGCATAAATCGGGCACT,0,5042177
ykgRp,0.5,1,1,ATCTGAAAAGTACAGCACGC,0,5033626
ykgRp,0.5,1,1,ATCTCAGTCGCACAGAGCGC,0,5040615
ykgRp,0.5,1,1,ATCTCAGCCCTAGTAGATCA,0,5060968
ykgRp,0.5,1,1,ATCTCAAGGATGGTACTCGA,0,5032850
ykgRp,0.5,1,1,ATCTATCCCCCGTCAGCCAG,0,5050707
ykgRp,0.5,1,1,ATCGTAACGCTAGGTCTTCT,0,5055783
ykgRp,0.5,1,1,ATCGTAAACTTGCAACAATA,0,5054733
ykgRp,0.5,1,1,ATCGGGCAATTTGTCAATCG,0,5055970
ykgRp,0.5,1,1,ATCGGCGTTAAAGGACGGTT,0,5046972
ykgRp,0.5,1,1,ATCGCAAGGCCCCGCAGGAT,0,5038775
ykgRp,0.5,1,1,ATCGAGTCCGACAATAGCGA,0,5060356
ykgRp,0.5,1,1,ATCGAGGGGTGACCGCAAGA,0,5039007
ykgRp,0.5,1,1,ATCCTCGAGATCATTAGGGG,0,5048600
ykgRp,0.5,1,1,ATCCGGCAGACGTCCCCGCC,0,5052377
ykgRp,0.5,1,1,ATCCGGAAGCTCGCCGACCA,0,5044324
ykgRp,0.5,1,1,ATCCCTTATCTCTAATGGAC,0,5035860
ykgRp,0.5,1,1,ATCCCAAGACCACAGTCAGA,0,5041167
ykgRp,0.5,1,1,ATCCATGGATTCCTATGGAG,0,5042846
ykgRp,0.5,1,1,ATCCAAGTGCCCGGGCGTCT,0,5048789
ykgRp,0.5,1,1,ATCATGGCGATGCCCGGTGG,0,5034802
ykgRp,0.5,1,1,ATCATCTCGTATTTAGGTAC,0,5047520
ykgRp,0.5,1,1,ATCACGTGCTTTTGAACGGC,0,5033680
ykgRp,0.5,1,1,ATCACCCTCTCGGCTCGAGG,0,5043630
ykgRp,0.5,1,1,ATCACATGTAGCTCCAGCGC,0,5054961
ykgRp,0.5,1,1,ATATTGATTGTTGGTGGGTA,0,5054892
ykgRp,0.5,1,1,ATATCTTCTTTCGAGCCCTC,0,5054217
ykgRp,0.5,1,1,ATATCTCAATCAAAAGTTAA,0,5059291
ykgRp,0.5,1,1,ATATCGGGGTTCTGCCTACT,0,5041866
ykgRp,0.5,1,1,ATATAGGGGGCGGCAGTGCT,0,5036430
ykgRp,0.5,1,1,ATATACGACATTGACAGCAA,0,5034263
ykgRp,0.5,1,1,ATAGTTACTGGGGATATGCT,0,5037300
ykgRp,0.5,1,1,ATAGTCAATACGCCTAACGA,0,5037559
ykgRp,0.5,1,1,ATAGGCGAGTAGGTGCACTA,0,5040238
ykgRp,0.5,1,1,ATAGATCGCGCATGATCTCG,0,5042068
ykgRp,0.5,1,1,ATAGATACGGTCGATATAAT,0,5053509
ykgRp,0.5,1,1,ATAGATACGGACGCGCCTTT,0,5055245
ykgRp,0.5,1,1,ATAGAATTTCCCCCACGTTC,0,5048019
ykgRp,0.5,1,1,ATAGAAGCGGTCCCAGCATA,0,5043097
ykgRp,0.5,1,1,ATACTGGCACCGCGATCTCA,0,5050576
ykgRp,0.5,1,1,ATACGGGATGTGGCACGTCT,0,5048073
ykgRp,0.5,1,1,ATACAGGCTTTGCTGCTGAA,0,5057968
ykgRp,0.5,1,1,ATACAGCCGTCCACCCTAAA,0,5058239
ykgRp,0.5,1,1,ATACAGCAACACAATAGCTA,0,5046696
ykgRp,0.5,1,1,ATACACGATGGCGTAGCCTG,0,5056185
ykgRp,0.5,1,1,ATACACCGTGGGGCCACAGA,0,5057915
ykgRp,0.5,1,1,ATACACCATCGAACCGTACA,0,5051030
ykgRp,0.5,1,1,ATACAACAAGGATTTATGAG,0,5057502
ykgRp,0.5,1,1,ATAATGGTCTTCCTGTCAGG,0,5038263
ykgRp,0.5,1,1,ATAAGGGGAGGTGACGGCTC,0,5043693
ykgRp,0.5,1,1,ATAACTGCTGATGGGATATT,0,5038325
ykgRp,0.5,1,1,ATAACTACCCGACGTCAGCG,0,5059934
ykgRp,0.5,1,1,ATAACGGGGTTTGTGGTTGA,0,5046466
ykgRp,0.5,1,1,ATAACCTTTCACACCTACAA,0,5047480
ykgRp,0.5,1,1,ATAACATTCCCTAGGCAGGA,0,5041144
ykgRp,0.5,1,1,ATAAAGTGTCGTGATCCCCA,0,5044039
ykgRp,0.5,1,1,ATAAAGCCAGGGGATAGTGC,0,5038869
ykgRp,0.5,1,1,ATAAACAGCAATTCCGAGTG,0,5036901
ykgRp,0.5,1,1,AGTTTTGTTCTTCCGTACAG,0,5038857
ykgRp,0.5,1,1,AGTTTTCAAAACACCTGCGA,0,5040195
ykgRp,0.5,1,1,AGTTGATGTCGGTCCCCTGG,0,5051355
ykgRp,0.5,1,1,AGTTCTTCTCTCCACAAGTA,0,5035622
ykgRp,0.5,1,1,AGTTCATAGTGGTGTAAGCT,0,5051301
ykgRp,0.5,1,1,AGTTAGGGACTGGCTCCAAT,0,5045229
ykgRp,0.5,1,1,AGTTAGCGGCCTGATCAGCA,0,5051639
ykgRp,0.5,1,1,AGTTAACTCCAGTCCTGCAG,0,5059285
ykgRp,0.5,1,1,AGTGTTGGAGCAACCCGATG,0,5050496
ykgRp,0.5,1,1,AGTGTTACACGTCTATATAA,0,5061404
ykgRp,0.5,1,1,AGTGGTTGGTTCTCATTAAC,0,5048899
ykgRp,0.5,1,1,AGTGGAGGCTCGAGTCGCTA,0,5054939
ykgRp,0.5,1,1,AGTGGACAGAGCCCGACGCT,0,5060635
ykgRp,0.5,1,1,AGTGGAATGGCCATCATAAA,0,5033266
ykgRp,0.5,1,1,AGTGATCTTCGTTCATCCAG,0,5050798
ykgRp,0.5,1,1,AGTGATAGACGGTCCCCACA,0,5033883
ykgRp,0.5,1,1,AGTGAGTCCACTAGCTCCAG,0,5043923
ykgRp,0.5,1,1,AGTGAGGACGGGCCCGGAAA,0,5034222
ykgRp,0.5,1,1,AGTCGTTGTGCTGTCGCGTA,0,5031578
ykgRp,0.5,1,1,AGTCGTCGGCTGTTCCCATC,0,5056781
ykgRp,0.5,1,1,AGTCCTGACCAGTACTTCAC,0,5035052
ykgRp,0.5,1,1,AGTCCGTATAAAGCGGGCTA,0,5053026
ykgRp,0.5,1,1,AGTCAACGGTCTACATTTCT,0,5034469
ykgRp,0.5,1,1,AGTATTTCAAGTTTCAAGTT,0,5035387
ykgRp,0.5,1,1,AGTATTCTTGGTCAGAAAGG,0,5061451
ykgRp,0.5,1,1,AGTATGAAACGGATCAGAAA,0,5036726
ykgRp,0.5,1,1,AGTATAACACCATGCTCATC,0,5054170
ykgRp,0.5,1,1,AGTAGTCGCTAGACTTTCAA,0,5032683
ykgRp,0.5,1,1,AGTACGGGGTAGGGTCCTAG,0,5033713
ykgRp,0.5,1,1,AGTACGATCTGGTCTCCATC,0,5043965
ykgRp,0.5,1,1,AGTACAGGGGGGACCTTTTG,0,5042368
ykgRp,0.5,1,1,AGTACAATTACCACTATGCC,0,5034084
ykgRp,0.5,1,1,AGTAACCACATAACGCATCT,0,5033778
ykgRp,0.5,1,1,AGGTTGTGGGGCCTCGAGAA,0,5034487
ykgRp,0.5,1,1,AGGTTATTGTCACTTATGGG,0,5037386
ykgRp,0.5,1,1,AGGTCAGGTCCTCAGCGCAG,0,5060743
ykgRp,0.5,1,1,AGGTAAGTCATTACAAAGCT,0,5042332
ykgRp,0.5,1,1,AGGTAAACCCGTCCCATAAT,0,5051842
ykgRp,0.5,1,1,AGGGTTTGTGGCGTCACTAT,0,5040521
ykgRp,0.5,1,1,AGGGTATAGTCATTACATAC,0,5059317
ykgRp,0.5,1,1,AGGGTACACACCGTTCACCT,0,5043134
ykgRp,0.5,1,1,AGGGGTGCGCCCGAACCTTT,0,5035935
ykgRp,0.5,1,1,AGGGCCTTTGCAGGCACATA,0,5057679
ykgRp,0.5,1,1,AGGGCCACAGAAGATAACCT,0,5033436
ykgRp,0.5,1,1,AGGGCAAGCCAGCGAATTTA,0,5058051
ykgRp,0.5,1,1,AGGGATTATCCACTGAATTT,0,5032450
ykgRp,0.5,1,1,AGGGACTGTCTTCGGATATA,0,5044081
ykgRp,0.5,1,1,AGGCTTGTAATCCTCATGTA,0,5034575
ykgRp,0.5,1,1,AGGCTTCTAAGGTCAGCACG,0,5040218
ykgRp,0.5,1,1,AGGCTCATAACGTATCACGG,0,5060720
ykgRp,0.5,1,1,AGGCGTCATCATGGCGGTCG,0,5047933
ykgRp,0.5,1,1,AGGCCTGGCATTGTATACAT,0,5055307
ykgRp,0.5,1,1,AGGCCGGGGCTCCAAAGACG,0,5035751
ykgRp,0.5,1,1,AGGCATCGCTACTAGGAGTG,0,5037883
ykgRp,0.5,1,1,AGGCATATAGGTTAGGCTTT,0,5060377
ykgRp,0.5,1,1,AGGCACCTTTCTCTGGGATC,0,5056468
ykgRp,0.5,1,1,AGGCAAGGGCATGAGACGGC,0,5059958
ykgRp,0.5,1,1,AGGAGTGACCTTAGGGGACT,0,5055618
ykgRp,0.5,1,1,AGGAGGTGAGCTGGGCCAAG,0,5047034
ykgRp,0.5,1,1,AGGAGGGAGTGGATAAGCCA,0,5044885
ykgRp,0.5,1,1,AGGAGCTGTCAAACCTACAT,0,5042881
ykgRp,0.5,1,1,AGGACTCAATGTGATTGAAT,0,5033026
ykgRp,0.5,1,1,AGGACGAGCCTTATGTCTAG,0,5042346
ykgRp,0.5,1,1,AGGAACAATTTAACAAGTGC,0,5050571
ykgRp,0.5,1,1,AGGAAAACGCTAGGCCTTAC,0,5042461
ykgRp,0.5,1,1,AGGAAAACCGGGATTGGAAC,0,5056075
ykgRp,0.5,1,1,AGCTTGACTTGTCGTTGGGT,0,5049130
ykgRp,0.5,1,1,AGCTGGGACTGGGGTCCCAT,0,5039346
ykgRp,0.5,1,1,AGCTGCGGGATCCACATCGA,0,5042211
ykgRp,0.5,1,1,AGCTCCGCATACGCCCAGAA,0,5051963
ykgRp,0.5,1,1,AGCTAGGGTGCTCGGCCATT,0,5038638
ykgRp,0.5,1,1,AGCGTTCTTGCGACACACAA,0,5038076
ykgRp,0.5,1,1,AGCGTTCGAGACTGGGTCCT,0,5045948
ykgRp,0.5,1,1,AGCGTTCCGTCTGTCTGATC,0,5038709
ykgRp,0.5,1,1,AGCGTATGACCCGAATTTAA,0,5037273
ykgRp,0.5,1,1,AGCGGCCATGCTGAACTAAA,0,5046962
ykgRp,0.5,1,1,AGCGCTTTGGAAGCGGGTGG,0,5031330
ykgRp,0.5,1,1,AGCGATATTTCGAGATACAC,0,5044759
ykgRp,0.5,1,1,AGCGACATAGGTTGATTTTA,0,5053778
ykgRp,0.5,1,1,AGCCTCAGGAGGCCTCATGA,0,5053830
ykgRp,0.5,1,1,AGCCGGTCAGGAGGGCAAAT,0,5061640
ykgRp,0.5,1,1,AGCCGGGTGACCCGGTCTGA,0,5055370
ykgRp,0.5,1,1,AGCCGGGATGGTGTAAGGGT,0,5044181
ykgRp,0.5,1,1,AGCCCTTAGGCGGTTTTCTC,0,5047134
ykgRp,0.5,1,1,AGCCCCTTAGGCATAAGGAG,0,5047542
ykgRp,0.5,1,1,AGCCCCAGTATGAGCGGAGG,0,5048511
ykgRp,0.5,1,1,AGCATTGGGATGTCGCTACC,0,5043465
ykgRp,0.5,1,1,AGCATCATCCCAAACGGGCA,0,5037363
ykgRp,0.5,1,1,AGCAGCGGTTGACCTCACCA,0,5040252
ykgRp,0.5,1,1,AGCACTCGTTTCTCGTTATT,0,5049602
ykgRp,0.5,1,1,AGCACGAAGAGGAGTCATCT,0,5051648
ykgRp,0.5,1,1,AGCAATGACTCTTACAATCA,0,5041696
ykgRp,0.5,1,1,AGCAAGGCGTGGGCGGAGTC,0,5060792
ykgRp,0.5,1,1,AGATTTTGAATCAAACCACA,0,5043526
ykgRp,0.5,1,1,AGATTTCCAATTTTGTAAGT,0,5061514
ykgRp,0.5,1,1,AGATTCCTGGCAGAAGCTTG,0,5032419
ykgRp,0.5,1,1,AGATGGTAGAGTATGAGGCC,0,5032385
ykgRp,0.5,1,1,AGATGGGGCACTCATAGGTC,0,5044443
ykgRp,0.5,1,1,AGATCTACCTTCTGTTAATG,0,5036382
ykgRp,0.5,1,1,AGATCGTGAATGAGCGGCAG,0,5052317
ykgRp,0.5,1,1,AGATCATAGGAGTCTCCTTA,0,5034889
ykgRp,0.5,1,1,AGATAATTTGACACGGCACG,0,5045758
ykgRp,0.5,1,1,AGAGTGGGGGTTACCTGTTG,0,5034644
ykgRp,0.5,1,1,AGAGTCGCCAGCCTGATTCG,0,5040099
ykgRp,0.5,1,1,AGAGGGTGTATCTGTGACTT,0,5045812
ykgRp,0.5,1,1,AGAGATTACTGTTAAGTCAG,0,5057533
ykgRp,0.5,1,1,AGAGACCCCGTCCAATGTCA,0,5037505
ykgRp,0.5,1,1,AGACGGAACCTACTTGCAGC,0,5037836
ykgRp,0.5,1,1,AGACCGCTCTCGATGTTGGA,0,5041720
ykgRp,0.5,1,1,AGACCGAGTCTACGTTGCTA,0,5051477
ykgRp,0.5,1,1,AGACATGGTGGGAAGGCAAG,0,5039478
ykgRp,0.5,1,1,AGACATCGTTATCGTGTCGG,0,5055690
ykgRp,0.5,1,1,AGACAGTTACACGAAACTTC,0,5042419
ykgRp,0.5,1,1,AGACAAGCCCGAAGGCCGTC,0,5035885
ykgRp,0.5,1,1,AGAATTTACCGGTCGCCTTG,0,5060815
ykgRp,0.5,1,1,AGAATATCGTGAGCCGTCTG,0,5051575
ykgRp,0.5,1,1,AGAAGGTGTGTTTTGTATGG,0,5034380
ykgRp,0.5,1,1,AGAAGATATTTTACACTATA,0,5057868
ykgRp,0.5,1,1,AGAACTGGTTGTGGTAGTTA,0,5035365
ykgRp,0.5,1,1,AGAACCGTACGGATACGGTC,0,5049981
ykgRp,0.5,1,1,AGAAACGCAGCATCCTTACA,0,5054109
ykgRp,0.5,1,1,AGAAAATTGAATATCGGCCT,0,5035363
ykgRp,0.5,1,1,ACTTTTCTGGGAATAGCAAA,0,5054070
ykgRp,0.5,1,1,ACTTTTACGTGAGATGTCCC,0,5032178
ykgRp,0.5,1,1,ACTTTATACGAGTTAAGATT,0,5061627
ykgRp,0.5,1,1,ACTTTACCGGGCGCAGCAAC,0,5039822
ykgRp,0.5,1,1,ACTTGGACACGATCTGGTTC,0,5056672
ykgRp,0.5,1,1,ACTTGCTACACGGAAGCCGG,0,5054997
ykgRp,0.5,1,1,ACTTGCCATAGGCCGACCAC,0,5056825
ykgRp,0.5,1,1,ACTTGCATCTGGGTGGTTAG,0,5046537
ykgRp,0.5,1,1,ACTTGATGCGTAGCTGAAGG,0,5055961
ykgRp,0.5,1,1,ACTTCGTTTGAGGCTCAATC,0,5053174
ykgRp,0.5,1,1,ACTTCGATCTTGAACTTAAC,0,5031448
ykgRp,0.5,1,1,ACTTCCAAAAGCCCCCAGAA,0,5037799
ykgRp,0.5,1,1,ACTTACGTTCTATGGTCCTT,0,5059912
ykgRp,0.5,1,1,ACTGCTCTTACTCCATGCAA,0,5049379
ykgRp,0.5,1,1,ACTGAATGATATTGAACGGG,0,5041833
ykgRp,0.5,1,1,ACTCTTCCGTATCTAAATCA,0,5060587
ykgRp,0.5,1,1,ACTCTCAGTATAAAAGTCTA,0,5043522
ykgRp,0.5,1,1,ACTCGAGCTTGAAATCGAAC,0,5047273
ykgRp,0.5,1,1,ACTCCCACAGAGGCACCAGT,0,5052627
ykgRp,0.5,1,1,ACTCCATCGATGAGCCTGTC,0,5045852
ykgRp,0.5,1,1,ACTCAGTAGATTGTCGTGGT,0,5038907
ykgRp,0.5,1,1,ACTATGAGGAACTAACTCCT,0,5047874
ykgRp,0.5,1,1,ACTATCAAAGATGGAGTGGA,0,5035586
ykgRp,0.5,1,1,ACTAGCGAGCGTAACCGGGT,0,5037895
ykgRp,0.5,1,1,ACTAGAGTCGGCATTGACGG,0,5042665
ykgRp,0.5,1,1,ACTAAGGGTCTGGCATGAAA,0,5057960
ykgRp,0.5,1,1,ACGTTTGTCCTAGAGCGCCA,0,5058895
ykgRp,0.5,1,1,ACGTTTCAGTGTGGACCACT,0,5035425
ykgRp,0.5,1,1,ACGTTTAGGTGGGACTGGCA,0,5053678
ykgRp,0.5,1,1,ACGTGATATGAGGCCTTCGC,0,5045143
ykgRp,0.5,1,1,ACGTCTTGAGCCCCCACTCC,0,5057240
ykgRp,0.5,1,1,ACGGTCGTCGGCCGCGCCCA,0,5056329
ykgRp,0.5,1,1,ACGGGAGGTGACAAGCGCCA,0,5039189
ykgRp,0.5,1,1,ACGGGACGCATTCTCCATAT,0,5060454
ykgRp,0.5,1,1,ACGGCGGGGAAGGGAAGGTC,0,5044327
ykgRp,0.5,1,1,ACGGCCGGGAGTTGTCGCGA,0,5031416
ykgRp,0.5,1,1,ACGGAAACCACCGGACGAAG,0,5052469
ykgRp,0.5,1,1,ACGCTCGTCGGTATTGTTAA,0,5032777
ykgRp,0.5,1,1,ACGCTAGCGCCGCTTACCGA,0,5038092
ykgRp,0.5,1,1,ACGCGGGGCAGAGTATGCAT,0,5058771
ykgRp,0.5,1,1,ACGCGCATCGGTCTTCTTAG,0,5049181
ykgRp,0.5,1,1,ACGCCTGCTCCCAGTTACAT,0,5060912
ykgRp,0.5,1,1,ACGCAATGTTAACAGCGATA,0,5046151
ykgRp,0.5,1,1,ACGCAAGGGAACGTGATGGT,0,5045996
ykgRp,0.5,1,1,ACGATCAAGCGTTCTTTCTC,0,5052122
ykgRp,0.5,1,1,ACGAGCTTCCCAGGTTCATG,0,5055011
ykgRp,0.5,1,1,ACGACCGTCTCCCTATTTTC,0,5034963
ykgRp,0.5,1,1,ACGACCCACCGGGTTTCATC,0,5038784
ykgRp,0.5,1,1,ACGAAGGGCCGATAGGGAGT,0,5054416
ykgRp,0.5,1,1,ACGAACTAGACGAATTAAAG,0,5050093
ykgRp,0.5,1,1,ACGAAATTGTCCCGCTCGCT,0,5046828
ykgRp,0.5,1,1,ACGAAAATACGGACACGGCC,0,5034004
ykgRp,0.5,1,1,ACCTCGGCTACCTGAGTCGG,0,5033498
ykgRp,0.5,1,1,ACCTCCTGCCGGGGGTACTG,0,5045526
ykgRp,0.5,1,1,ACCTCAGCTGCTGGAGCGGT,0,5050180
ykgRp,0.5,1,1,ACCTAGTTCCTCTTGTCCTG,0,5051014
ykgRp,0.5,1,1,ACCGGTGATTGGGATCTGAC,0,5037016
ykgRp,0.5,1,1,ACCGGGTGAAACCCCGAGAA,0,5051568
ykgRp,0.5,1,1,ACCGGCATGTATGGACGAGT,0,5055337
ykgRp,0.5,1,1,ACCGGAAGTTCCGGAAGGCG,0,5044357
ykgRp,0.5,1,1,ACCGCCGTACGATGTGACGT,0,5041785
ykgRp,0.5,1,1,ACCGATGGCCGTCACCACAT,0,5044378
ykgRp,0.5,1,1,ACCGACTACTAATATAGCGG,0,5048816
ykgRp,0.5,1,1,ACCCTTCAGCAGACACTACT,0,5031567
ykgRp,0.5,1,1,ACCCTCCGTTTGAGCCCGGA,0,5053274
ykgRp,0.5,1,1,ACCCGTGATAAGAAGATTAT,0,5047617
ykgRp,0.5,1,1,ACCCCGTCCCGTGCCTACGT,0,5043739
ykgRp,0.5,1,1,ACCCAACTGCGTTAGCCAAC,0,5045474
ykgRp,0.5,1,1,ACCATAGTGATTGTCCGTGA,0,5054202
ykgRp,0.5,1,1,ACCACTACTCCGCAGGAGCA,0,5052546
ykgRp,0.5,1,1,ACCACGAGTTGTACTCGATA,0,5049466
ykgRp,0.5,1,1,ACCACAGGCGCTTCTATTTA,0,5050584
ykgRp,0.5,1,1,ACCACAATCCAACCTTAAAT,0,5039692
ykgRp,0.5,1,1,ACCAAATACGTCAACACTTG,0,5031701
ykgRp,0.5,1,1,ACATTTAGCGATAGGGCTAG,0,5036450
ykgRp,0.5,1,1,ACATTGACGAACCTTAAGGG,0,5046614
ykgRp,0.5,1,1,ACATTCGAATCCGCGCCTTC,0,5031419
ykgRp,0.5,1,1,ACATTATGTGGGGGGAGGTC,0,5060671
ykgRp,0.5,1,1,ACATGGTAGTTGGCGAGAGC,0,5050481
ykgRp,0.5,1,1,ACATGACTCAAAAACAAATA,0,5032916
ykgRp,0.5,1,1,ACATGACCTCGTAAATAATC,0,5060844
ykgRp,0.5,1,1,ACAGTTTATCTGGCCATGCG,0,5047078
ykgRp,0.5,1,1,ACAGGTAAGTGGGGGCAAGT,0,5048395
ykgRp,0.5,1,1,ACAGGCGGCTCCTTCAAGTT,0,5035086
ykgRp,0.5,1,1,ACAGGACATAAACCTCACGT,0,5035552
ykgRp,0.5,1,1,ACAGCGTTAGGCATGGCCAG,0,5034571
ykgRp,0.5,1,1,ACAGCCTGTTCAAGGGCCTC,0,5042085
ykgRp,0.5,1,1,ACAGAGTCGGAGTTCGCGCC,0,5046081
ykgRp,0.5,1,1,ACACTCTATCAGAGAACTGG,0,5049380
ykgRp,0.5,1,1,ACACTCATACTTCGAATGCA,0,5044595
ykgRp,0.5,1,1,ACACTAAAAGTTGTCTCCCT,0,5054847
ykgRp,0.5,1,1,ACACGCTCCAACATCACGCA,0,5046897
ykgRp,0.5,1,1,ACACCGCGGGCTCTAGGGAA,0,5047341
ykgRp,0.5,1,1,ACACCCACGCGCCCCAAAAA,0,5047976
ykgRp,0.5,1,1,ACACCAGTGTATTGTATTAA,0,5059702
ykgRp,0.5,1,1,ACACACTTCTTATGTCCCAG,0,5044358
ykgRp,0.5,1,1,ACAAGCTTGTAGCTCTAAGC,0,5048424
ykgRp,0.5,1,1,ACAAGAGTCTTAGTCGTTGT,0,5056451
ykgRp,0.5,1,1,ACAAGAGGGGCGGTTTTTTG,0,5043095
ykgRp,0.5,1,1,ACAACTTTGGACTGTTGGAG,0,5060235
ykgRp,0.5,1,1,ACAACGCAGGTTCCGGATGG,0,5055852
ykgRp,0.5,1,1,ACAACGAATGCTCAAGCACA,0,5054289
ykgRp,0.5,1,1,ACAACAAAACGCCGGTCTTG,0,5057966
ykgRp,0.5,1,1,AATTTGTATTGGTTTAGGGA,0,5052593
ykgRp,0.5,1,1,AATTGGATTTCTGACGCAAG,0,5059997
ykgRp,0.5,1,1,AATTCTTTGTTTAACCGACG,0,5043198
ykgRp,0.5,1,1,AATTCATGCACTGCATGTAC,0,5054893
ykgRp,0.5,1,1,AATTACGCCCCTAGGCGACA,0,5036627
ykgRp,0.5,1,1,AATGGTATAGCATTATTCGT,0,5040846
ykgRp,0.5,1,1,AATGGCCCCGGACCGAAAGA,0,5035913
ykgRp,0.5,1,1,AATGACTGTACGTTTAATGC,0,5035151
ykgRp,0.5,1,1,AATGACCCTCAAGATGCATA,0,5039383
ykgRp,0.5,1,1,AATGAATTAGTATGGGCGAA,0,5053128
ykgRp,0.5,1,1,AATGAAGTATCGGAACCCTA,0,5048757
ykgRp,0.5,1,1,AATCTTATCGGAGTGTCCCC,0,5035801
ykgRp,0.5,1,1,AATCTAAATCCAAGGCACAC,0,5040636
ykgRp,0.5,1,1,AATCGTGACAAGCCTGATTT,0,5042578
ykgRp,0.5,1,1,AATCGGGGTGGTAGGGGGCA,0,5052946
ykgRp,0.5,1,1,AATCCTATGCTCGAACGGAC,0,5035646
ykgRp,0.5,1,1,AATCATGAGGCGAAAACCTA,0,5033373
ykgRp,0.5,1,1,AATCACTGGTGGGGTTCGAA,0,5036572
ykgRp,0.5,1,1,AATAGTCCTACACGTATCAG,0,5047106
ykgRp,0.5,1,1,AATAGAGAGACGGTTTATTG,0,5036554
ykgRp,0.5,1,1,AATACTCGTTCTAGAATTCC,0,5039889
ykgRp,0.5,1,1,AATACGGGTGCTCTCCGTCG,0,5061410
ykgRp,0.5,1,1,AAGTTTGTCGCGTCATTCGT,0,5039539
ykgRp,0.5,1,1,AAGTGAGCAACTGAGTCCAC,0,5056553
ykgRp,0.5,1,1,AAGTCTCCCTTTATGGTCCT,0,5055313
ykgRp,0.5,1,1,AAGTCCTGCGAATCGCACTG,0,5042836
ykgRp,0.5,1,1,AAGTCCGGTACACCATATGG,0,5037719
ykgRp,0.5,1,1,AAGTAGGCATGAAGCTCGGC,0,5055882
ykgRp,0.5,1,1,AAGTACAGTTAATTTATCAT,0,5059167
ykgRp,0.5,1,1,AAGGTTCGTAATCCGAACCT,0,5054747
ykgRp,0.5,1,1,AAGGTCTAAGCAGGAAGGGG,0,5037747
ykgRp,0.5,1,1,AAGGTCAATACGCTTCGCAA,0,5031611
ykgRp,0.5,1,1,AAGGTACCGCTAGCTTTGTT,0,5041418
ykgRp,0.5,1,1,AAGGGTGAGGGGGATTACCG,0,5051164
ykgRp,0.5,1,1,AAGGGGATTCTTCTGCCGAT,0,5041134
ykgRp,0.5,1,1,AAGGGCGTCGTGTCGGGATT,0,5046806
ykgRp,0.5,1,1,AAGGCTTATGTCCTCGGAAA,0,5044813
ykgRp,0.5,1,1,AAGGCGGCACCTAATTGGTG,0,5056581
ykgRp,0.5,1,1,AAGGCCGGAACACACCTCGG,0,5060698
ykgRp,0.5,1,1,AAGGATCTCGTGCGGAGCCT,0,5035859
ykgRp,0.5,1,1,AAGGACAATTGCATAATCCC,0,5043328
ykgRp,0.5,1,1,AAGCTTTTCACTCTGAGTTG,0,5040039
ykgRp,0.5,1,1,AAGCTATCTAAGGTCGTGGC,0,5058529
ykgRp,0.5,1,1,AAGCGCGTCCTCCTTAACAA,0,5052963
ykgRp,0.5,1,1,AAGCGACTCAGTTCAAAAGA,0,5051484
ykgRp,0.5,1,1,AAGCCCGGTATCATGTACTG,0,5048457
ykgRp,0.5,1,1,AAGCCATGCTAGTTAGCTAA,0,5036684
ykgRp,0.5,1,1,AAGAGGATGTTGTTAATTCT,0,5054860
ykgRp,0.5,1,1,AAGACTTGGGCGTGATAAAT,0,5049054
ykgRp,0.5,1,1,AAGACGTATTATCCGCTGAG,0,5038525
ykgRp,0.5,1,1,AAGAATAAACATAATAACAT,0,5061699
ykgRp,0.5,1,1,AAGAACAGGCGGTAGGCCGG,0,5039816
ykgRp,0.5,1,1,AAGAAACCGTTAGTATGACA,0,5058773
ykgRp,0.5,1,1,AACTTTATGTAATCGCCATA,0,5060302
ykgRp,0.5,1,1,AACTTGGTCTGGTTCCGGTC,0,5035130
ykgRp,0.5,1,1,AACTTCGGATAGGCATGTAA,0,5033940
ykgRp,0.5,1,1,AACTTCAAAACTAGCTAACA,0,5040895
ykgRp,0.5,1,1,AACTGAAGACAGTCATTTTC,0,5051674
ykgRp,0.5,1,1,AACTCTCCAGGGGGAGTAGG,0,5048490
ykgRp,0.5,1,1,AACTCGCAACAACATATCGA,0,5047057
ykgRp,0.5,1,1,AACTCCACGGCGATCTGCGA,0,5060978
ykgRp,0.5,1,1,AACTAGGCACACGGGTTAAT,0,5052675
ykgRp,0.5,1,1,AACGTTTAGCCCGACGCAAT,0,5041020
ykgRp,0.5,1,1,AACGTTGCATACCGTGTTAC,0,5048993
ykgRp,0.5,1,1,AACGGTATTCTGTACGTGGT,0,5031691
ykgRp,0.5,1,1,AACGGTACTACACGGGCGCA,0,5054447
ykgRp,0.5,1,1,AACGGGTCTCCACCTTAACT,0,5034780
ykgRp,0.5,1,1,AACGGCCGCGCGTGTGGGCG,0,5054398
ykgRp,0.5,1,1,AACGGCAGATCGTTGAGGCA,0,5052448
ykgRp,0.5,1,1,AACGCTCTACAAGGTTTGTC,0,5042020
ykgRp,0.5,1,1,AACGCTACAGTCCCTCTAAA,0,5051137
ykgRp,0.5,1,1,AACCGTACCTTCATGGGTAT,0,5060845
ykgRp,0.5,1,1,AACCGGTGCGGGTATGGCCA,0,5057330
ykgRp,0.5,1,1,AACCCGAGAATTCCAACCCG,0,5052054
ykgRp,0.5,1,1,AACCCAGTCCAGTTCAAAAA,0,5047084
ykgRp,0.5,1,1,AACCCACTCTTAAACGCCGC,0,5038872
ykgRp,0.5,1,1,AACCAAACACGGGCACAGGG,0,5042536
ykgRp,0.5,1,1,AACATGTCTTACGGAGGTCG,0,5058556
ykgRp,0.5,1,1,AACATCCCAAGCTTTTGGAT,0,5050120
ykgRp,0.5,1,1,AACACTAAAAGTTGGGCGAT,0,5037617
ykgRp,0.5,1,1,AACACGTTAAGACAGAGCAA,0,5032305
ykgRp,0.5,1,1,AACACGATCTGGCTAACTAA,0,5032836
ykgRp,0.5,1,1,AACACCGTGCTATGCCGATA,0,5043822
ykgRp,0.5,1,1,AACAAGGCACTTGTCGAGGG,0,5041056
ykgRp,0.5,1,1,AAATGTTTTGGAAGCGGGTA,0,5044575
ykgRp,0.5,1,1,AAATGGGAGGGACCTTCCTA,0,5034587
ykgRp,0.5,1,1,AAATGGGAGCGATCTCTACA,0,5053015
ykgRp,0.5,1,1,AAATGCAGAGTCAGGACGAT,0,5048800
ykgRp,0.5,1,1,AAATGCAAAAGTCGATTGGC,0,5045508
ykgRp,0.5,1,1,AAATGAAGTTAGAGGTCTTT,0,5060354
ykgRp,0.5,1,1,AAATCCGGGTTCGGCTCACT,0,5053645
ykgRp,0.5,1,1,AAATAGGCGCATACTTCAGG,0,5040169
ykgRp,0.5,1,1,AAATAGGCCATGCCTTAAGC,0,5033332
ykgRp,0.5,1,1,AAATAGCGCAGTGATCAGAG,0,5052523
ykgRp,0.5,1,1,AAAGTGCTCTCGGCTACAGT,0,5037627
ykgRp,0.5,1,1,AAAGTCGGTCGCACGAATCT,0,5052778
ykgRp,0.5,1,1,AAAGGGCATAAAGTGTAACA,0,5048362
ykgRp,0.5,1,1,AAAGGCGCCCCGCCCACACT,0,5052277
ykgRp,0.5,1,1,AAAGCTTACCCTCAATATTA,0,5053724
ykgRp,0.5,1,1,AAAGCCGGGTATCGGTATAG,0,5060441
ykgRp,0.5,1,1,AAAGACTTGTCCTGGAGAGT,0,5039026
ykgRp,0.5,1,1,AAAGAAGAAGTTTGCGTCAA,0,5042952
ykgRp,0.5,1,1,AAACTGTTAAGGTGATTATT,0,5061055
ykgRp,0.5,1,1,AAACTGTACCAGTCGGGCTT,0,5044492
ykgRp,0.5,1,1,AAACTGAACCAGTTTCGCGT,0,5038665
ykgRp,0.5,1,1,AAACTATTGAACTTTAATCG,0,5046460
ykgRp,0.5,1,1,AAACTATTACTTATACATTC,0,5032487
ykgRp,0.5,1,1,AAACTAATACTTAGAAGAAC,0,5061273
ykgRp,0.5,1,1,AAACGGAGTTAACAAAACGC,0,5054516
ykgRp,0.5,1,1,AAACGCGACCATTTGCGTCG,0,5055427
ykgRp,0.5,1,1,AAACGAGAGGCGCCTACTTT,0,5036587
ykgRp,0.5,1,1,AAACCCCAGTTTCGATCCAA,0,5037822
ykgRp,0.5,1,1,AAACCATAAAGTCCGGCCGG,0,5050618
ykgRp,0.5,1,1,AAACATATATTCAACCGCTC,0,5031645
ykgRp,0.5,1,1,AAACATAGGGGACTCTGGAC,0,5056122
ykgRp,0.5,1,1,AAAATTCTGCATTTTACCTG,0,5035611
ykgRp,0.5,1,1,AAAATAGGGATGGCGAGCAC,0,5033847
ykgRp,0.5,1,1,AAAACTACTTCTACAGCGGG,0,5046741
ykgRp,0.5,1,1,AAAACGGTATCAGTCACGAA,0,5043773
ykgRp,0.5,1,1,AAAACCGTGTTCAGCGGCGA,0,5031912
ykgRp,0.5,1,1,AAAACCACATTACGTCCTAA,0,5051396
ykgRp,0.5,1,1,AAAACCAAGAGCTCTTTCTT,0,5033856
ykgRp,0.5,1,1,AAAAAGCTATGCTTCTAGAG,0,5041146
ykgRp,0.5,1,1,AAAAACTGAAATACGATACC,0,5052032
ykgRp,51.0,50,0,CCAAAGTATAATACGTACGT,50,5058023
ykgRp,46.0,45,0,TCCCGAGTTTGCTCTGACGC,45,5055666
ykgRp,45.0,44,0,AGAAAGCCGTTTTAAGGAGC,44,5061565
ykgRp,40.0,39,0,GACGGCTGATGCCTATCCTT,39,5051354
ykgRp,39.0,38,0,GGTCTCTCATAGCCCTTTTC,38,5032077
ykgRp,37.0,36,0,TGAGGGTAGATATGGGCACC,36,5058015
ykgRp,34.0,33,0,TCCCACTAGATGGAAAGCTC,33,5036541
ykgRp,31.0,30,0,TGACGCTATATTAACAAGTT,30,5059012
ykgRp,31.0,30,0,CAGAAAGATGATCCCGAATT,30,5042562
ykgRp,30.0,29,0,TCCCCGTGTGGACTACGTGT,29,5058432
ykgRp,29.0,28,0,GGGTACACGCTTGTCCTCCG,28,5043961
ykgRp,28.0,27,0,CCACGTCTGGTAGGATCTGC,27,5046791
ykgRp,28.0,27,0,AGCAACGGTGCCCACATCGT,27,5033733
ykgRp,27.0,26,0,CCGGGCACCAACAAAGTCTC,26,5038004
ykgRp,27.0,26,0,ACACTTTTCGAGAATAGTTA,26,5056358
ykgRp,26.0,25,0,CCAACGTCGTTTCGAAAATG,25,5055173
ykgRp,26.0,25,0,AATTTCGACCTGGGTATTCC,25,5043151
ykgRp,25.0,24,0,GACGCTTATAGACCTTCTGG,24,5043607
ykgRp,24.0,23,0,GCTCTGTGGGGTGGAACCCT,23,5050899
ykgRp,24.0,23,0,CCGCTTAAGTCTAATGTCGT,23,5039873
ykgRp,24.0,23,0,CCACGAATAGGTACCAACAG,23,5061595
ykgRp,24.0,23,0,AGATGGCATTCGATAAAGTC,23,5055668
ykgRp,23.0,22,0,TGGAAATACGATTCTGAGAA,22,5032856
ykgRp,23.0,22,0,CAAAATCCGGCTAAGGCGGA,22,5041692
ykgRp,23.0,22,0,AGTGTCTTTTGAACATGTGA,22,5042784
ykgRp,23.0,22,0,AGGTAGCATTGGTTGCTAGG,22,5057170
ykgRp,22.0,21,0,TTCTATGTTTTAAGGTTTAA,21,5058799
ykgRp,22.0,21,0,TGCCATTGGATACCTGTTGT,21,5045484
ykgRp,22.0,21,0,TAAACGGAAGATTAGGACGT,21,5057498
ykgRp,22.0,21,0,GGCTCCGAGGCCGGGGCCTC,21,5060716
ykgRp,22.0,21,0,GAGTTTCTCAAGGCGCGTGA,21,5051890
ykgRp,22.0,21,0,ATTAAAGGGTCTCCTCATAT,21,5033959
ykgRp,21.0,20,0,TGATCCACCCCACGTTGATC,20,5060542
ykgRp,21.0,20,0,TAGTAGACACAAAGACACAT,20,5035493
ykgRp,21.0,20,0,AGGCCACCCCTTTTTTGCTT,20,5060732
ykgRp,20.0,19,0,TTCAATCATACCAGGGAAAA,19,5051661
ykgRp,20.0,19,0,TCATCGTGCCGTACGAGGAG,19,5036520
ykgRp,20.0,19,0,GGCGCGACTATAAATCTACA,19,5048099
ykgRp,20.0,19,0,AGCTTATGAAAATCTCAAGC,19,5051010
ykgRp,19.0,18,0,TTGCTGACAGTGGAACTCAA,18,5044658
ykgRp,19.0,18,0,TGTATTCCGTACCTCCAACC,18,5048672
ykgRp,19.0,18,0,TAACGCTTTACCGATTTCTA,18,5060516
ykgRp,19.0,18,0,GTCGTACAACATATGTCATT,18,5051095
ykgRp,19.0,18,0,GGCTATCGCCGTTCGCTTAC,18,5043156
ykgRp,19.0,18,0,GCCCGAAGCAACGGCTTACA,18,5052036
ykgRp,19.0,18,0,GCACTATATGTAGTCGGTGT,18,5049768
ykgRp,19.0,18,0,CATTTTCATCCTTCTCGCAA,18,5034778
ykgRp,19.0,18,0,CAGCCCGTATGGTCCTACCC,18,5057311
ykgRp,19.0,18,0,ATCGTTAGCGTATGTTCTCA,18,5032205
ykgRp,19.0,18,0,AGTGTCATCACGACGGAACT,18,5032486
ykgRp,19.0,18,0,AATCCGCGTCATCATTATCT,18,5047166
ykgRp,18.0,17,0,TCTGGTACATCTCTCACAGA,17,5047190
ykgRp,18.0,17,0,GCCGCCATGAGTGCGGTTAT,17,5052519
ykgRp,17.0,16,0,TGGGCAAAAGAACCCAGATT,16,5045728
ykgRp,16.0,15,0,TGATCTCAATCTCCTATATG,15,5034547
ykgRp,16.0,15,0,TCTAGGTGAGACAGTCACCT,15,5047197
ykgRp,16.0,15,0,GGCTCATTGTGTCATCGCGA,15,5056311
ykgRp,16.0,15,0,GCCAACTGCGGGCATATTTT,15,5060620
ykgRp,16.0,15,0,GAGACTTCAGACGCTCGCTC,15,5060321
ykgRp,16.0,15,0,CCGTCATCAGCTACTTATCC,15,5049129
ykgRp,16.0,15,0,CATCGAAAAGGTTAAGGAAG,15,5047246
ykgRp,16.0,15,0,ATGGAGGGTCCGTCTTTACG,15,5043876
ykgRp,15.0,14,0,TGTCTTCTATTTTCCATCGT,14,5046185
ykgRp,15.0,14,0,TGCCAAAGAGGGATGATTAA,14,5035679
ykgRp,15.0,14,0,TCTGGATGATGCTGGGATTC,14,5047981
ykgRp,15.0,14,0,CGATAGCCTCGTGTGGTATG,14,5038115
ykgRp,15.0,14,0,ATAACCAATAGAGTAGCGTT,14,5044387
ykgRp,14.0,13,0,TTCATAAGTTTTAAACGTCA,13,5060824
ykgRp,14.0,13,0,TACGTGTATTTCCATTCGTA,13,5055986
ykgRp,14.0,13,0,CCGTAGTAAAGCCAGGTGTA,13,5045806
ykgRp,14.0,13,0,CAGCTATCGGCGAATAATAC,13,5058908
ykgRp,14.0,13,0,ATGCCATCATACGACGCTCT,13,5045720
ykgRp,14.0,13,0,AGCAACCCATGTTGATATAC,13,5036727
ykgRp,13.0,12,0,GCGGGTTCTGTATTCAGCGC,12,5060589
ykgRp,13.0,12,0,CGTCTCTCTTCCGTTTAAAC,12,5047467
ykgRp,13.0,12,0,CGGACCTACTGTCAGCGCTG,12,5036250
ykgRp,13.0,12,0,CGATCACACCAAATTTACTT,12,5053437
ykgRp,13.0,12,0,ATAGTGTACCAGGGGTACAT,12,5033957
ykgRp,13.0,12,0,ACTAAACTGTCGTTGGAATA,12,5044936
ykgRp,12.0,11,0,GGGTACATGAGACGCAAACC,11,5043265
ykgRp,12.0,11,0,CTTCATTGTCTTATAGACTA,11,5041000
ykgRp,12.0,11,0,CCGAGTTGATGCGAAAGAGA,11,5053329
ykgRp,12.0,11,0,CCCATAGTGATGCGACATTT,11,5045736
ykgRp,12.0,11,0,ACCTTTCCGTTGAACTTTGG,11,5061173
ykgRp,12.0,11,0,AAGTCGATCGGCCCCATGTA,11,5054757
ykgRp,11.0,10,0,GGTCCCAGGAAGGCTGGTAC,10,5055670
ykgRp,11.0,10,0,GGGAGACATGGCGAGTCTAT,10,5034785
ykgRp,11.0,10,0,GGAAATACGTGTGGCCGGGA,10,5056167
ykgRp,11.0,10,0,GCGGGTGTACATGAATCCCC,10,5038116
ykgRp,11.0,10,0,GCCTCCGTAAGCGCTATGGA,10,5051932
ykgRp,11.0,10,0,CTGTGAACACTAACATAGGG,10,5037701
ykgRp,11.0,10,0,CTGTCCTCTGTATGGGGACT,10,5045352
ykgRp,11.0,10,0,CACGTCCAGGACGGATTTGA,10,5051725
ykgRp,10.0,9,0,TTTCTACGCCTTTTGGTCAC,9,5054133
ykgRp,10.0,9,0,TCTGCTCCTTGCCAGGCGTT,9,5061553
ykgRp,10.0,9,0,GGATGGGGAACAGCGCATCC,9,5041155
ykgRp,10.0,9,0,CATGTGTTGGGATAGATCGC,9,5031814
ykgRp,10.0,9,0,AATCAGTTGTGGCCAAGCCC,9,5051093
ykgRp,9.0,8,0,GCGCATGTTGCAGGGTCGAT,8,5051556
ykgRp,9.0,8,0,CCTTCTGGGGTGCCGTAGAT,8,5039908
ykgRp,8.0,7,0,GGTGGAGGGTTAGGCACATA,7,5047140
ykgRp,8.0,7,0,GATTTCGTTTATAACAACTG,7,5031483
ykgRp,8.0,7,0,CATGAAGGACTATTCAACCA,7,5041581
ykgRp,8.0,7,0,CAGAGGTTTGCAACGACTTT,7,5044346
ykgRp,8.0,7,0,ACATATTTTGTGTCCACCTT,7,5057685
ykgRp,7.0,6,0,TTTCTCTAGGTATTCTTTCG,6,5036978
ykgRp,7.0,6,0,TGCTGCCGACTGGCGCACAA,6,5045486
ykgRp,7.0,6,0,GCGGCTATAAGCGAAGTGAT,6,5041767
ykgRp,7.0,6,0,GCCTCCATCCTTTTAAACTT,6,5050523
ykgRp,5.0,4,0,TAGCCTACGGGAGCGGAATC,4,5058869
ykgRp,5.0,4,0,CATGTTTCGGTGATACGCAT,4,5032552
ykgRp,5.0,4,0,ACCAAACACATGGGCGGCAA,4,5033816
ykgRp,4.0,3,0,CCGTCCTCTCCCTCACCCTT,3,5050172
ykgRp,4.0,3,0,ATATGGCGCGCTCCCTCGGG,3,5036998
ykgRp,3.0,2,0,TAGACTCTCAAGCGCGACTT,2,5045695
ykgRp,3.0,2,0,GGGTCTTTCATTTAACATTT,2,5058894
ykgRp,2.0,1,0,TCCGTTGAGAGCTCTTATTT,1,5057822
ykgRp,2.0,1,0,TATCTTCAAGTCCGTTACCG,1,5052215
ykgRp,2.0,1,0,TAACAGCCCAACCATTGACA,1,5050230
ykgRp,2.0,1,0,GTTGACATGGCGCATCAGTG,1,5044545
ykgRp,2.0,1,0,GTATTTAAGGGCTTGATTAA,1,5034124
ykgRp,2.0,1,0,GTACAACCGTGAGTGCGGCT,1,5049695
ykgRp,2.0,1,0,GGTTTCGTCCGGACGGCGTA,1,5061541
ykgRp,2.0,1,0,GGGTAGCTCACAACCGAGTA,1,5032135
ykgRp,2.0,1,0,GGGACCTGATGTGAATTTTG,1,5060999
ykgRp,2.0,1,0,GATATGGCTTAGAATCCAGT,1,5038611
ykgRp,2.0,1,0,GATATAATTTCCTTCGGTAG,1,5040571
ykgRp,2.0,1,0,GACCTCGGCTATTACACGTT,1,5057813
ykgRp,2.0,1,0,GACCCAACAGCAAGGACTTT,1,5048173
ykgRp,2.0,1,0,CTTCGTACGATCAGCAAGGC,1,5047577
ykgRp,2.0,1,0,CTCCTGACCCTGCTCCTTGG,1,5049987
ykgRp,2.0,1,0,CGGGGCCACAAACGCGTCCC,1,5048211
ykgRp,2.0,1,0,CGCTAGATATTAAAGTCCAC,1,5057680
ykgRp,2.0,1,0,CCGGTTGCGCGCGTTCCAAT,1,5046001
ykgRp,2.0,1,0,ATTCTTTCTAAACCAGAGTT,1,5040680
ykgRp,2.0,1,0,ATCTATACACAGGCAGCCTA,1,5061220
ykgRp,2.0,1,0,AGACTTCCGATAAGACGGCT,1,5047398
ykgRp,2.0,1,0,ACGTTTATGTTTTGAAGCGG,1,5058728
ykgRp,2.0,1,0,ACAATCCTCTCTTATTCAGC,1,5057217
ykgRp,2.0,1,0,ACAAAGCTCGAGGCTACGCT,1,5040855
ykgRp,2.0,1,0,AATTAAGACGACGGCAAGTA,1,5032707
