name,relative_counts,ct,ct_0,barcode,ct_1,barcode_ind
araBp,0.4,173,124,GGTAGGAGACTGCATGCCTT,49,469959
araBp,0.3879310344827586,159,115,CATGCCTGTCTTTCTAGGTT,44,511438
araBp,1.5,263,105,AGCCATATCCAACGGAACTT,158,468486
araBp,0.6382978723404256,152,93,TGTACATCTCTACGGCAAAC,59,493462
araBp,0.6511627906976745,140,85,TCGTCACTTCCTCGTTGGAT,55,467974
araBp,0.9069767441860465,162,85,ACGGTGCGCACCCCGAGCGT,77,491328
araBp,1.3414634146341464,190,81,AAGGCGGATTCAATCAAGAT,109,510138
araBp,0.37037037037037035,109,80,ACAGCTCTCATCTCTTACGG,29,473938
araBp,0.5875,125,79,GACAAATCGATGAGGCGAAC,46,513802
araBp,0.17721518987341772,91,78,TGGTTCATGGTTAGATGAAT,13,477575
araBp,0.37662337662337664,104,76,TGTCTGTCGCAGTATGCCAC,28,522536
araBp,0.5844155844155844,120,76,AGCGAACTCTGAGCAACTAG,44,515393
araBp,0.618421052631579,121,75,TGGCTAAGGCCAAGCGCTCC,46,468208
araBp,0.9736842105263158,148,75,GCGGGTAGTGATGCCGACAT,73,467980
araBp,0.47368421052631576,110,75,CGGGGGCGACTATGCGTTTG,35,473888
araBp,0.7027027027027027,124,73,TCACTATGTGCCTAACCCCT,51,514707
araBp,0.75,124,71,TGGAGTGGTGGGCTTCGTGT,53,469420
araBp,0.2638888888888889,89,71,GGAGGCGTGACACACATCGG,18,469915
araBp,0.02857142857142857,70,69,TCCACCTTGTACCAACCGAG,1,481107
araBp,0.36231884057971014,92,68,AAAGGCTTTGTGGTAAAGGT,24,485059
araBp,2.6323529411764706,245,67,GTGACCCGCGCACCTAAGGT,178,468601
araBp,1.3970588235294117,161,67,GTCGTACGCGTGGGAGAAGC,94,468185
araBp,0.5735294117647058,105,67,CACAACCAACTCCCGCCAGG,38,513478
araBp,0.4626865671641791,96,66,TGTTGCGTACGGAGAGAGAT,30,499857
araBp,0.05970149253731343,69,66,GTAAGGGGCAAGAATCTGAT,3,468786
araBp,0.030303030303030304,66,65,CTTGACGAATGTGTTGTGTG,1,515025
araBp,0.22727272727272727,79,65,ATGGCCGCACGACGTTCACA,14,520242
araBp,0.2923076923076923,82,64,GCTATCACGATGCACCTGTT,18,492923
araBp,0.24615384615384617,79,64,AGGCCGAGTACGTTAACCAA,15,524708
araBp,0.4603174603174603,90,62,TGGTCAGATTACAACACGAT,28,472716
araBp,0.4444444444444444,89,62,AGCGCGCAAATTTGTCAAGA,27,522629
araBp,1.403225806451613,147,61,GTGAAGCCTATGATGATTTT,86,502430
araBp,0.4262295081967213,85,60,CAGTGACTTGAACCCTCTCG,25,501379
araBp,0.5166666666666667,89,59,CGTCGGACTGGTACTCCAAG,30,489575
araBp,0.05084745762711865,60,58,TATGAAATTTGCACTTGTTC,2,471445
araBp,0.4745762711864407,85,58,GGCGGGTGATTATCGCTATT,27,513590
araBp,0.288135593220339,74,58,GGCACCGTGTCCCGATACCT,16,474769
araBp,1.0,116,58,GCAGGATCGATGTTGAGCAA,58,476057
araBp,0.288135593220339,74,58,AGACGTAGTTTGTTTACCCT,16,496578
araBp,0.45614035087719296,81,56,TGTCGTGCCATTTTTGCGAT,25,485946
araBp,0.03571428571428571,56,55,GTCGTGTTTATACATCACAT,1,488407
araBp,1.3214285714285714,128,55,CGTAAAAGGTTTGCAGGGCT,73,512265
araBp,0.6,86,54,GCGAGATTGTTATGCTATTT,32,487335
araBp,0.8703703703703703,99,53,TTCGGGTACTACCAAACATC,46,522583
araBp,1.8333333333333333,151,53,TAGGGAGGTCTCTTACGGGG,98,500935
araBp,0.6666666666666666,88,53,ACCTATACTGCCTCAAGGTA,35,523003
araBp,1.150943396226415,112,52,ACAATCAGTATACCAGGATA,60,481823
araBp,0.5283018867924528,79,52,AACAAAACGGATTTCACGCT,27,473654
araBp,0.2692307692307692,64,51,TAAGGCCCCTACCGCACTCA,13,488057
araBp,0.6923076923076923,86,51,GGAGCACTGGGCTGGTCAAG,35,471568
araBp,0.5576923076923077,79,51,GCCAAGAGGTTTGCGATTCG,28,477133
araBp,0.9807692307692307,101,51,CGTGAGAGAGGTCATAATGG,50,497604
araBp,0.5192307692307693,77,51,CAGTTGAGCAGTGGACAGGG,26,520892
araBp,0.36538461538461536,69,51,ATGTCTCCGTGTGCATTGTG,18,514214
araBp,0.19230769230769232,60,51,AAGGTACAGTAGGCTTTATA,9,512054
araBp,0.39215686274509803,69,50,GAATACGTGAGCCTGGGATG,19,500894
araBp,1.0980392156862746,105,50,CTTTTTACGGATCCTTCTTC,55,497462
araBp,0.7254901960784313,86,50,CGGAATTTGAAGTCGGTCTT,36,519052
araBp,0.49019607843137253,74,50,CAGACTGTTACACTTGGAAA,24,523232
araBp,0.9411764705882353,97,50,AGTACCTGGCTATAGGAGTT,47,506048
araBp,1.3529411764705883,118,50,AGGCATCACCGGCTGGGTGA,68,477095
araBp,0.66,81,49,GATCTTTTAACTAGAGATAT,32,515825
araBp,1.26,111,49,CCGATCCAAAGGGAGACATC,62,501943
araBp,0.30612244897959184,62,48,TACATTTACTTGACGCTCGA,14,471532
araBp,0.4897959183673469,71,48,GGGTAATCGGAATTGGACTT,23,505700
araBp,3.3541666666666665,207,47,GGTCAACGGCGCATATCTAA,160,495883
araBp,0.041666666666666664,48,47,GGACCGGACCGTAGTACAGC,1,474112
araBp,0.2708333333333333,59,47,GCTTTGAGTTGATGTCCCAA,12,502427
araBp,0.0625,49,47,CGGAGGGACACGCATGCTAT,2,469199
araBp,2.7083333333333335,176,47,CCCGCCCTAGTCTCGGGCTG,129,471405
araBp,0.6666666666666666,78,47,ATCGCCTCTGTATAATCCTG,31,525084
araBp,0.9791666666666666,93,47,AACAGGTTAGTGGTCTCTTA,46,520812
araBp,1.574468085106383,119,46,TTGATCCACGAACGGTTCAA,73,480502
araBp,0.6170212765957447,74,46,GATTTTATAGCTTTTCGCAT,28,469921
araBp,0.5106382978723404,69,46,CGATGAAGACCCAATTAAAC,23,489869
araBp,0.2765957446808511,58,46,ATCGTACTTCCTTTGCGTTG,12,499856
araBp,2.0869565217391304,140,45,TACCAAAAATAGGGATCGGC,95,469919
araBp,0.30434782608695654,58,45,GTAGTGAAGGCAGTCCATCT,13,470964
araBp,0.7608695652173914,79,45,GCGAGGTAAAATCACTTTTT,34,510251
araBp,0.9565217391304348,88,45,GCATCCAAGTCGGAATATAA,43,468241
araBp,0.391304347826087,62,45,CATAGATCGAGGGCTGAATT,17,483503
araBp,0.8913043478260869,85,45,CACAGACTATCAATTGACCT,40,485451
araBp,0.5434782608695652,69,45,AAAGCCGTGGAGTAAGTACC,24,474413
araBp,0.8888888888888888,83,44,TATCGTGCCAGCTGTCGGCG,39,477579
araBp,1.4222222222222223,107,44,CTTCAGTCGGTACCGACTTT,63,494371
araBp,0.044444444444444446,45,44,ATTAGGATTTGTAGAAAACG,1,507892
araBp,1.1363636363636365,92,43,TTGATGCGCGGGTGACTGAT,49,472499
araBp,0.13636363636363635,48,43,TTCTCTTCTTGTGGAGATGG,5,485849
araBp,1.2954545454545454,99,43,TACGTACGTGCGTAACCCTA,56,481779
araBp,0.5681818181818182,67,43,CGCTGGGCAAATTGCCTGAA,24,472897
araBp,0.8863636363636364,81,43,CCCAGCTCCTTTTCCAGGGA,38,474285
araBp,0.9318181818181818,83,43,CATTCCTGGTAAGGTTACTT,40,487332
araBp,1.25,97,43,ACTTGTGGATCAATCCTTAC,54,468876
araBp,0.5116279069767442,63,42,TTCAACTAACACGCCTTAGT,21,524521
araBp,2.255813953488372,138,42,GCATTGACGCGACCCACCGT,96,471494
araBp,0.6744186046511628,70,42,GAGGCCCAGTAAAGTTCTGT,28,480402
araBp,2.6744186046511627,156,42,CCCCATGGGGAGATCATATA,114,482278
araBp,0.32558139534883723,55,42,CACATAGCGTCAGACTGACG,13,522562
araBp,3.7142857142857144,196,41,TGCACAGCCTTTCGAATCCT,155,469229
araBp,0.7857142857142857,73,41,TACCCTGCAAACACCTGTAG,32,483675
araBp,0.5238095238095238,62,41,GTGTAGCCACTGTGCTCAAA,21,493331
araBp,0.6904761904761905,69,41,GAATCACACTAAATATGGTC,28,471316
araBp,0.6190476190476191,66,41,CGGAATTGCTCAGCGGAACT,25,502570
araBp,0.42857142857142855,58,41,CCGTGCCCCCCTTGTCACAC,17,494752
araBp,0.5714285714285714,64,41,AGAACTTCCGACCGATAGAA,23,469832
araBp,0.6904761904761905,69,41,ACTCACCACTAGGTGAGTAA,28,475009
araBp,0.5238095238095238,62,41,AAAGTACGAAATCGTTGGCG,21,510049
araBp,0.35714285714285715,55,41,AAACCAGCGCCGTCGGAACA,14,511032
araBp,0.6341463414634146,65,40,TTCGTAGTCGTCATACGTTA,25,509558
araBp,0.36585365853658536,54,40,TGATGAGTAGGGATTTATGA,14,470816
araBp,0.3902439024390244,55,40,TACTCTTTGATATTCTTATC,15,504832
araBp,1.4878048780487805,100,40,GCGGGCTTGATCTTGAGGCC,60,484701
araBp,1.2682926829268293,91,40,GCACATAAATCAGATCGTTG,51,500688
araBp,1.4146341463414633,97,40,CTTGGAGCGGACCGCGGTGT,57,473656
araBp,0.34146341463414637,53,40,CGCAATACGTCAGTCACTAG,13,519975
araBp,0.6585365853658537,66,40,CCAGTCTCAAGAGATACGAT,26,495823
araBp,0.7804878048780488,71,40,CAGAGACTTGCGCATTCGGA,31,477911
araBp,0.6585365853658537,66,40,ATCCTCTTTGACCCACTACT,26,522968
araBp,0.2682926829268293,50,40,AGCGCGATACTGCAACAATC,10,483070
araBp,0.8292682926829268,73,40,ACCATAGTACTGACCTGCTT,33,468526
araBp,0.95,76,39,TTTAGCTTGGTTCGGGATAG,37,469914
araBp,0.5,58,39,TGTCATGTACTATCCGTGGC,19,499949
araBp,0.075,41,39,TACGGATTGGGAGGCGGCGG,2,491774
araBp,0.6,62,39,TAAGAAGCCCCGCTGGCGTT,23,511295
araBp,1.875,113,39,GGGAGACCACTGCTGGTATA,74,469253
araBp,0.65,64,39,GGAATTCCGACACACTTGAA,25,469647
araBp,0.825,71,39,GCGCACGTCACCGATAAACC,32,468423
araBp,2.175,125,39,CATCTATTTTTATCCGTACA,86,475301
araBp,8.4,374,39,CAGAGTGCGGTGAGCTATTT,335,517872
araBp,0.575,61,39,CAATCGGTTGATATCTGTTA,22,473930
araBp,0.35,52,39,ATCATGGTACTTGTCTAGTA,13,515334
araBp,0.4,54,39,AGATCGTTTTCCAACTCGTG,15,513500
araBp,0.675,65,39,AATAGCCACGCGTAAGCTGC,26,497978
araBp,0.725,67,39,AAGTGGTTTAACCGACGTAT,28,497897
araBp,0.55,60,39,AAGCATCGGATTAATGAGGA,21,479767
araBp,0.4358974358974359,54,38,TTTTCGAATCTACATAACTG,16,483864
araBp,0.6153846153846154,61,38,TGGAGTCCTATCAAGGGATT,23,478568
araBp,0.6410256410256411,62,38,TGCCGAGGTCGCGGTGTATG,24,474681
araBp,0.46153846153846156,55,38,TAAGATCGGTGGACCGCCGA,17,491434
araBp,0.8974358974358975,72,38,GTATCAAAGTGCCCTCGAGT,34,509826
araBp,0.28205128205128205,48,38,GGTTTGGAATCCTTCTACCG,10,479942
araBp,0.15384615384615385,43,38,GGCAACCCCACATGAAAAAA,5,494890
araBp,1.0,76,38,GCAGGTATACGCCACAAAGA,38,506028
araBp,0.46153846153846156,55,38,CTTCGTGCAGACGATATTAA,17,473414
araBp,1.7179487179487178,104,38,CGGGATTTACCAGTCATGTT,66,509419
araBp,0.7692307692307693,67,38,CGGCTACGAGTCAGAAAGTC,29,498390
araBp,0.05128205128205128,39,38,CGATGGGCCGCGTAGGGCAT,1,512683
araBp,1.2307692307692308,85,38,ACACGAAGTAATGGGGCCGT,47,472899
araBp,0.05128205128205128,39,38,AAGTGCGTCTAAAATTCTAT,1,475618
araBp,0.631578947368421,60,37,TTTTGACACGTGGGATTTTC,23,482566
araBp,0.05263157894736842,38,37,TGCGGCAGGAAGCTCGCCAA,1,496487
araBp,0.7631578947368421,65,37,TCCGGTGTCACTCAAAGGTA,28,482940
araBp,2.8947368421052633,146,37,TCCCTGTGGCAAATGCCGTA,109,495426
araBp,0.05263157894736842,38,37,TAGTCGGCTCAGGTAAAAGT,1,511429
araBp,0.5526315789473685,57,37,GTTGTGCTCTGGTGCTGTCA,20,518725
araBp,0.9473684210526315,72,37,GTATCAACCGGATCAACTGG,35,501599
araBp,0.05263157894736842,38,37,GGAGTTCGTGGGTGACGAGT,1,477510
araBp,0.5526315789473685,57,37,GACTCCGTGCAGGTTATCCA,20,519303
araBp,0.10526315789473684,40,37,CGTAAGCAGGGGGTACAAGT,3,488896
araBp,1.0789473684210527,77,37,CCGATTTATGGCAAGTTATG,40,467819
araBp,0.8157894736842105,67,37,AGGAGTTGACATCCCCCGGA,30,517793
araBp,0.42105263157894735,52,37,AGAATGAGTACATGACCAAA,15,473500
araBp,1.1081081081081081,76,36,TACAGACTTAACGTAGAATC,40,505010
araBp,1.2432432432432432,81,36,GTATGCGAACTGTCTAACAA,45,521408
araBp,0.8918918918918919,68,36,GCCTCCTTGACGGACGAGTC,32,523469
araBp,1.972972972972973,108,36,CTCCCATGCTGCTCTATTTG,72,510114
araBp,1.5135135135135136,91,36,CCGATCGACTGCCTGTTCTT,55,483806
araBp,0.972972972972973,71,36,CATAGCTCAAGCCCACATAT,35,517416
araBp,0.05405405405405406,37,36,ATGTTGCCTACCGAGAGTGC,1,501836
araBp,0.8378378378378378,66,36,ATAAATCGGCCTGGGGACTT,30,496307
araBp,0.05405405405405406,37,36,AGTGGGAAATACTACATCCC,1,503635
araBp,0.43243243243243246,51,36,ACCCCTCTCAGCGCCGATTA,15,473332
araBp,0.8378378378378378,66,36,ACAGCAGTAGCGTGGGGGAC,30,509189
araBp,1.0277777777777777,71,35,TTCTACACTATGTTGCTCTC,36,488161
araBp,0.8888888888888888,66,35,TTCGTGTGGCCGGGATCCCA,31,515097
araBp,0.6111111111111112,56,35,TCTGCCGGTGCTCCCAACTG,21,483245
araBp,0.19444444444444445,41,35,TCGTTATGTTTGTCTAAGTC,6,472637
araBp,0.8333333333333334,64,35,TCCCATGGAAGAGCTGAAGG,29,478603
araBp,1.6944444444444444,95,35,TATGTATGACCGTGGGCTAT,60,484633
araBp,0.19444444444444445,41,35,GTTTATTATCATAGGTAGAT,6,477274
araBp,1.8611111111111112,101,35,GATAGAGTTGTATTAACGTA,66,470270
araBp,0.6666666666666666,58,35,GACGATTGAAAGGAAGCATA,23,510044
araBp,0.9166666666666666,67,35,CTCCCGCACGAAGCGGGACA,32,481647
araBp,0.8888888888888888,66,35,CGTCCGATCTTAGGGCTCAT,31,471895
araBp,0.75,61,35,CGGGTGGATGGAAACCCGAC,26,517125
araBp,0.3888888888888889,48,35,CAGTAAACGTGATTAGGACA,13,468829
araBp,0.4444444444444444,50,35,AGCAGTTCAGATGTCGAAGC,15,516296
araBp,2.4444444444444446,122,35,AGACACAAGAGGACAACTGT,87,468888
araBp,0.6111111111111112,56,35,AGAATTTACATATGGTCAGT,21,483641
araBp,0.6666666666666666,58,35,AACTTTGGACTTCTAGCATT,23,492146
araBp,0.6388888888888888,57,35,AAACCCAACCGAAATGCAGT,22,479420
araBp,0.7142857142857143,58,34,TTGCAACCGTGCCGTGTAGA,24,513709
araBp,0.05714285714285714,35,34,TCAGGGTAGAAAAAAAACCA,1,485273
araBp,0.11428571428571428,37,34,TCAGCGTTATAATCTGGAAA,3,520469
araBp,0.05714285714285714,35,34,GGCAAAAGGTCATTATGTGT,1,483901
araBp,0.7714285714285715,60,34,CTGTCGCCGCATTGGTACGC,26,474690
araBp,0.05714285714285714,35,34,CAGGATGAGCCCTTCAAAGG,1,487848
araBp,0.6,54,34,ATTGGAAGTGTCCAGACCCT,20,468736
araBp,1.3714285714285714,81,34,ATACAGCTTACAAGTGATTT,47,476243
araBp,0.6571428571428571,56,34,AGTCACCAATCGTTAAGGTG,22,480762
araBp,1.9142857142857144,100,34,AGGCCAAGAGTGCGTGAGCA,66,477147
araBp,0.6571428571428571,56,34,ACCTCTAAGTCAGCCCCTTG,22,492098
araBp,0.4857142857142857,50,34,AACCCAGGACTCCCAGCCTG,16,472896
araBp,0.9705882352941176,65,33,GTGTTCGACCGCTACCTAGA,32,501159
araBp,0.4117647058823529,46,33,GTAATTCTTAGGTGCTCTCG,13,503756
araBp,0.35294117647058826,44,33,GCGCAGTTAGAAGCACGAAT,11,503828
araBp,0.4117647058823529,46,33,GCCGCCAGGGGAATGCGTAG,13,499300
araBp,0.6176470588235294,53,33,GAAACTCCAGAGCGTCCTGA,20,478646
araBp,0.9705882352941176,65,33,CTTTTGTCCTGTGCGAAGTT,32,470322
araBp,0.7058823529411765,56,33,CCTAGTGTGAGTAGACAACG,23,481196
araBp,0.7647058823529411,58,33,CAATCGGTCTCGTAATCAGG,25,494621
araBp,0.8235294117647058,60,33,CAAAGTTAACTCTCAGCAGT,27,503206
araBp,0.3235294117647059,43,33,CAAAGGAGTCCGATTAACCT,10,488671
araBp,0.7058823529411765,56,33,ATTTAACGTAAGCCGGGTAA,23,524402
araBp,0.8823529411764706,62,33,ATACCTGGTCTAGAGTCGCC,29,472548
araBp,2.235294117647059,108,33,AGTCTATCTAGCCGCGAAGA,75,491080
araBp,1.6470588235294117,88,33,AGTCACTGTGCTGATGCGTT,55,517186
araBp,0.7058823529411765,56,33,AGAGGTCTCGAGGGGTTAGA,23,477985
araBp,1.1470588235294117,71,33,ACTGGTGTCAAGCGAATTAT,38,493017
araBp,0.7941176470588235,59,33,ACGTTTGCGGCGCAACATGC,26,470219
araBp,0.6176470588235294,53,33,ACATCCTATTGCCTTTTCAG,20,512901
araBp,0.7272727272727273,55,32,TTCATGCGACTTGTCTACTC,23,477036
araBp,0.45454545454545453,46,32,TTAAGGACAGTATTGGCAAT,14,469883
araBp,1.1818181818181819,70,32,TGTCCGGGCAACTTAGTTGA,38,520734
araBp,0.3333333333333333,42,32,TATGTACAGGAATTTAGTTG,10,522327
araBp,0.6666666666666666,53,32,TAATTAAATCCAACGCCAGG,21,486842
araBp,0.5454545454545454,49,32,GTTCAGCAATAGACAGTGTA,17,512804
araBp,0.06060606060606061,33,32,GTAGGGTCACGGATATATAA,1,485945
araBp,1.3636363636363635,76,32,GCAGAACGACGGGGCAAACC,44,522429
araBp,0.6060606060606061,51,32,GAATGAAAGGAACAAGCTAG,19,504566
araBp,1.393939393939394,77,32,CTTGTTGGCGGGGAAATCTC,45,477338
araBp,0.7272727272727273,55,32,CGAAGCGGTCCACCGTTGCT,23,478728
araBp,1.2121212121212122,71,32,CCCCCGTTTTCAGCGACTGG,39,480456
araBp,0.8181818181818182,58,32,CATCTGAACCTTGAGTAATC,26,481349
araBp,1.4242424242424243,78,32,CATAAACTCGGCAGGCGGAT,46,505939
araBp,0.09090909090909091,34,32,CAGTTGTTAGAGTCCAATCG,2,478651
araBp,2.878787878787879,126,32,CAATCTATCTCGCGGATAAC,94,492815
araBp,2.8181818181818183,124,32,ATGAGGTTTTACTTGTCGTA,92,482017
araBp,0.21212121212121213,38,32,AGGAACCGTGTTACGTACAC,6,471455
araBp,0.6363636363636364,52,32,AGCGACTGTTCATTGGGTAA,20,470656
araBp,0.36363636363636365,43,32,ACCAATACAGACACGAGTAC,11,490017
araBp,2.1818181818181817,103,32,AAGTTTTCCTCACCCTGCTA,71,522218
araBp,0.06060606060606061,33,32,AAACTCACCGTTAGGTCGTC,1,486386
araBp,0.6060606060606061,51,32,AAACCGGACGACGTGACGAT,19,473560
araBp,1.09375,65,31,TTTGCCATCCTGGCGACAGA,34,491171
araBp,1.34375,73,31,TTTCTAGTATGACCACAGGT,42,481004
araBp,0.34375,41,31,TTTAGGGGGAACCTAGGGAA,10,472954
araBp,0.9375,60,31,TTAGTCGGGTTGGAGGTTAG,29,479085
araBp,0.96875,61,31,TGGATTGGCATTTCCCACGC,30,506054
araBp,3.15625,131,31,TCCTATGTCACACAAACCGG,100,472255
araBp,1.28125,71,31,TCCTAACCAGGGTTCATTCT,40,489620
araBp,0.09375,33,31,GGGTCGTAGATCTCCGGGCA,2,515380
araBp,0.65625,51,31,GGACTGAGTGGCTAACGGAA,20,507759
araBp,0.8125,56,31,GCTAGGCAGCCTGAGAATGT,25,491339
araBp,9.96875,349,31,CTTGAAGCGCTTTCGGCCGC,318,510981
araBp,1.625,82,31,CGGCCCTGGAGTAGTGGAAT,51,504378
araBp,2.6875,116,31,CGGCAACGCGAATTTACCTT,85,493143
araBp,0.6875,52,31,CGCTAAGATGAGTGATGACA,21,476509
araBp,0.875,58,31,CCGAGCTATCGTGATGTATC,27,489078
araBp,1.84375,89,31,CATTCGGGCGAACTAGTACA,58,513589
araBp,1.125,66,31,CAAGTTAATCAGGCGTTCCA,35,500252
araBp,1.65625,83,31,ATCACAATCTTAAGCCTTGT,52,492140
araBp,0.78125,55,31,ATAAAGAGTGCTTAAGGCAA,24,513913
araBp,1.5,78,31,ACACAGGTATGCATTTATAC,47,521887
araBp,3.375,138,31,AACAGGATACAATGTGAGCA,107,520535
araBp,2.193548387096774,97,30,TTGTGTTCGCCTTGCCCAGA,67,469741
araBp,1.6129032258064515,79,30,TGAATGCTGTCAAACACTAC,49,491664
araBp,1.5161290322580645,76,30,TCTTGGCAGATATCTCCACA,46,491380
araBp,0.12903225806451613,33,30,TCTCAGGTTGGAGACCTAAA,3,498731
araBp,0.12903225806451613,33,30,TCGGTCACACTGCTTTACTA,3,505848
araBp,0.06451612903225806,31,30,TATGTTGGCGGCAAAAGGGT,1,472200
araBp,0.06451612903225806,31,30,GTGGCTTTAAACCAGATCAT,1,495693
araBp,3.6129032258064515,141,30,GGTGGCACGACCCGTCAGGA,111,509825
araBp,0.8709677419354839,56,30,GATATGCAATGAATTTGGTG,26,484007
araBp,0.6451612903225806,49,30,GACGGTGGTCGAGACCTTGG,19,469201
araBp,0.5806451612903226,47,30,CTCGCAAGGTGTAGTTGGCT,17,474737
araBp,1.5483870967741935,77,30,CTCCTGATTGGATCACCTCG,47,474812
araBp,0.7419354838709677,52,30,CGCTACTAATCGCAAGTATT,22,474111
araBp,0.06451612903225806,31,30,CGCGGAAACTAAAACGTCCA,1,488058
araBp,0.2903225806451613,38,30,CGAAGGTCAGACCTGCGGAT,8,483993
araBp,0.967741935483871,59,30,CCTAGGTCGTTTTTTGCTGA,29,493483
araBp,1.4838709677419355,75,30,CCGAACCAAGGTCCAAGCGG,45,473979
araBp,0.9354838709677419,58,30,CCATTCCGGCCTACTCTATC,28,470421
araBp,0.7741935483870968,53,30,CAATTCTTGACGCCGCTAAT,23,519966
araBp,0.8387096774193549,55,30,ATAAGGGCAGGATTCTAGAG,25,503146
araBp,2.7419354838709675,114,30,AGTCTGCGAGGATTCACCGA,84,517552
araBp,0.4838709677419355,44,30,AGGCACTCCCGAGCCTCGAC,14,512249
araBp,4.903225806451613,181,30,AGCCGTCTAGAGCATGGAAT,151,482014
araBp,1.0,60,30,AGACGATTCGTCCTGAATCC,30,500561
araBp,0.0967741935483871,32,30,ACGTAGGCTTAATCAGGGAA,2,506138
araBp,0.7096774193548387,51,30,ACGAGTAAGATTCGGGCAAG,21,474876
araBp,0.06451612903225806,31,30,ACAGTCACTGTCCCGCAACT,1,511607
araBp,1.2333333333333334,65,29,TTCTGGGTATTTCACTTAAT,36,483954
araBp,1.7333333333333334,80,29,TTCGGTCAAGACGACCGGAA,51,486578
araBp,0.8333333333333334,53,29,TTAGCACCTTTGGGGCACAA,24,487378
araBp,0.06666666666666667,30,29,TTACAACCCGACCCACGTGA,1,520041
araBp,1.5,73,29,TGTGTATAAGCCTAACCGCA,44,502302
araBp,0.8,52,29,TCGGGCAATGTGTCGTGAAA,23,494613
araBp,2.7666666666666666,111,29,GGATGTTGATAATACGGTCT,82,484587
araBp,1.9,85,29,GCGATTAGGGACCTCATAGA,56,497030
araBp,0.8,52,29,GATGTGTGTCTCTGGATTCG,23,511722
araBp,0.6333333333333333,47,29,GAGTGCAAGTGTTAAACTTA,18,478093
araBp,1.7333333333333334,80,29,GACTGGACCGCGCAAGTTTG,51,491550
araBp,1.4,70,29,GACGCACCGGGCGCCTCTGC,41,492147
araBp,1.1333333333333333,62,29,CGCAACTGTACTCGTACGGG,33,507758
araBp,0.6666666666666666,48,29,CGACGCCATCGGGACAGGAC,19,493708
araBp,0.8333333333333334,53,29,CCTCGCGTCGATCATAGCGT,24,475944
araBp,1.7,79,29,CCCTGTTTTAACGGGCTGAA,50,496050
araBp,1.9666666666666666,87,29,CATTCCCCCACAGAGAGCGT,58,481434
araBp,0.9666666666666667,57,29,CAGGTGCGATACGCCGTTTC,28,487233
araBp,1.3666666666666667,69,29,CACGAAGAGAGCGAAGGGGT,40,496661
araBp,1.3,67,29,ATTCGGCCAACGAAACCCAT,38,502479
araBp,1.7333333333333334,80,29,ATCGTCGTTATATCTCCAGA,51,493779
araBp,0.9,55,29,ATCGCAACTATAGATGGGAT,26,509819
araBp,1.5333333333333334,74,29,AGACATGTGTCGCGGGTCAT,45,524898
araBp,1.0666666666666667,60,29,AGAACACTATCCTAGTTCGA,31,476825
araBp,0.06666666666666667,30,29,ACTGTCTCATCGAGTGTTCG,1,477574
araBp,1.8333333333333333,83,29,ACCGACCCTCCGCGTAAAAA,54,493493
araBp,1.8666666666666667,84,29,AACGCAGTTCCTGAATTCTC,55,513295
araBp,1.0,56,28,TTAAGGTTTTTTAGGCTCCC,28,513401
araBp,3.4482758620689653,127,28,TGGCCACTTTTTCCTGACAC,99,475815
araBp,2.0689655172413794,87,28,TCGGCTTTGACCGTTAACCT,59,468643
araBp,0.5862068965517241,44,28,TCGCCGCGGCGCACCGTGTG,16,479749
araBp,0.06896551724137931,29,28,TCCGTCAGCCTGTCATGTCA,1,505206
araBp,0.7586206896551724,49,28,TCAAGGTCGGTTTCCATCGG,21,498626
araBp,0.06896551724137931,29,28,TATAAGACGTAGGCCCAAGG,1,506961
araBp,0.7586206896551724,49,28,TACCTGCAAGACCTAGCTCG,21,510916
araBp,0.06896551724137931,29,28,GTTATCCGTCCTGGTTTAAA,1,475846
araBp,0.3103448275862069,36,28,GTTAGAGTGGTAAGAGAGCA,8,523492
araBp,0.10344827586206896,30,28,GTGGGGTAGGGATACCGACA,2,479642
araBp,0.6896551724137931,47,28,GGGACAGTGCGAGATCCACA,19,472680
araBp,1.5517241379310345,72,28,GGACTCTACCGTCATGGATC,44,494418
araBp,1.3448275862068966,66,28,GCCGATGCCAATGAGGTTCT,38,515392
araBp,0.7586206896551724,49,28,GCAATATTAAAACCTGATCC,21,494135
araBp,0.7586206896551724,49,28,GAGCTCCGTTGGAAGCAGTC,21,472006
araBp,1.2413793103448276,63,28,CTTAAGTGTGCTAAGGCCCT,35,499388
araBp,1.3448275862068966,66,28,CTCTTCGGCTTGCATGGCGC,38,487385
araBp,1.6551724137931034,75,28,CTAGGATCATGGCACAGGAT,47,489658
araBp,0.5517241379310345,43,28,CGTTGTTGCGCCCACTCCGT,15,494438
araBp,0.896551724137931,53,28,CGTCCCATCAGGGGTGGGGT,25,481519
araBp,0.06896551724137931,29,28,CGCTCAGGCTTCTAGTAGAT,1,476206
araBp,0.8620689655172413,52,28,CGCCGTACCTGGCTAACGGT,24,474846
araBp,0.5172413793103449,42,28,CCACTCACAAGTGATCAGTA,14,492554
araBp,3.310344827586207,123,28,CATGATGCATGACAGTAGTT,95,520307
araBp,1.206896551724138,62,28,CATAAAATAACTGCAATTCC,34,472869
araBp,0.6896551724137931,47,28,CAAGAAGGCCGGTGCCCAGG,19,478932
araBp,0.06896551724137931,29,28,ATTTGCGGAGCACGACTCAG,1,492493
araBp,1.1724137931034482,61,28,ATTGCAGCCTGGCCGCCTTA,33,478991
araBp,0.1724137931034483,32,28,ATGTGATCCGACGTAATTAC,4,499977
araBp,0.3793103448275862,38,28,ATAATACTAAATGTGCCGGC,10,473276
araBp,0.7586206896551724,49,28,AGTGATAGGTTCTCAGGATA,21,494358
araBp,0.9310344827586207,54,28,AGCTGCGATATGTAAACATC,26,474005
araBp,0.6551724137931034,46,28,AAGGCAGACCAACATGCCTA,18,483188
araBp,1.9642857142857142,81,27,TTGATGTGCCTGCACACAAA,54,520445
araBp,3.0357142857142856,111,27,TTCGGACGACCGGATGTCCT,84,473902
araBp,0.8571428571428571,50,27,TGTAAAGGGAGGATGATTTC,23,478459
araBp,0.07142857142857142,28,27,TGGCATCATTCGATCTTCGA,1,501587
araBp,0.07142857142857142,28,27,TCACGAAGACTCCGCGAGTG,1,517351
araBp,1.5357142857142858,69,27,TAGGTGGTGTGTACAGTATA,42,515028
araBp,1.1785714285714286,59,27,TACGCAAGTCACAAAAAGGT,32,509557
araBp,1.9642857142857142,81,27,TACCCTCATCTGAAGGGGTA,54,490185
araBp,1.2142857142857142,60,27,GTTCTGCCTCAGGGAGCTTA,33,494271
araBp,11.25,341,27,GTCTTGTAGAGTTGCGGTGG,314,511096
araBp,1.0357142857142858,55,27,GGCTCACAATAATCCTGCTT,28,488094
araBp,0.7857142857142857,48,27,GGATCGCGGCCGTTCCCCAC,21,505020
araBp,1.5357142857142858,69,27,GCAGCCGGGTAACGCCATGT,42,512655
araBp,1.0,54,27,GCACGATCAGGGATAAACGG,27,508660
araBp,0.9285714285714286,52,27,GCAAAAATACTCGCACCAGG,25,494856
araBp,2.0357142857142856,83,27,GATCCATAGACGAGCGTGTT,56,470826
araBp,1.3928571428571428,65,27,GACGAGGAACTCTACGAAAG,38,468015
araBp,0.9285714285714286,52,27,GACCCGTTGTGAAGCCAAAA,25,497194
araBp,0.6071428571428571,43,27,CTTTGAAAATCAATGTCGGT,16,481694
araBp,0.7857142857142857,48,27,CTTATGGTCGGCGCAGGTAA,21,491733
araBp,1.0357142857142858,55,27,CTGGCGACTGACTGTCTTAA,28,501412
araBp,1.2857142857142858,62,27,CTGATTGCCGTTAGGCGGCT,35,507100
araBp,0.5714285714285714,42,27,CTCCGCTGGGCCTGATTTTT,15,474455
araBp,1.4285714285714286,66,27,CGTTGGCGATAAGGTGTCAT,39,475941
araBp,1.6785714285714286,73,27,CGTCGAAAGGAGCCTAAACG,46,497237
araBp,0.5714285714285714,42,27,CGGGCGGTCATAACGGTCCT,15,516584
araBp,0.39285714285714285,37,27,CGAACTGTCAGGGTGACTCG,10,511265
araBp,0.4642857142857143,39,27,CCCATAGAGCCGCGGCCGCT,12,475485
araBp,2.607142857142857,99,27,CATGCTTGTTCTAGTAAATA,72,486943
araBp,2.142857142857143,86,27,CAGCGACGACGTGCTTTCCA,59,471015
araBp,0.6785714285714286,45,27,CAAGACGTGTGAGGCCAGGA,18,474029
araBp,0.10714285714285714,29,27,ATCGAAACATGTCTCCTAAT,2,500739
araBp,0.25,33,27,ATATTGTGTATGGACGGGTG,6,499993
araBp,1.8214285714285714,77,27,AGGTAATTTCTGGAATAGTT,50,489587
araBp,0.9642857142857143,53,27,AGCACAGCACCAGGTTTTGT,26,520123
araBp,0.10714285714285714,29,27,AGATATTTGAGTCAGCGTCA,2,511685
araBp,1.4642857142857142,67,27,ACCCATAATCTGACGAGCGT,40,472246
araBp,0.6428571428571429,44,27,AATGTCCACTGCCTAACAGT,17,515467
araBp,0.6071428571428571,43,27,AATCAATGTAAGATCAGAGA,16,493377
araBp,0.07142857142857142,28,27,AATATAGTCTGTACCGCGCT,1,478601
araBp,6.571428571428571,210,27,AAGTCCTGTCTGAGTGGAGC,183,513090
araBp,0.5714285714285714,42,27,AAAAAGATCCTGCCTGTTCG,15,518043
araBp,1.0740740740740742,54,26,TTGCCCTGCAGCGTGAGAAA,28,490330
araBp,1.037037037037037,53,26,TGTCACTGACCACTGCTGTA,27,485198
araBp,1.0740740740740742,54,26,TGTAGTATGGTGGCTTGTTT,28,475996
araBp,0.7037037037037037,44,26,TGGTCCCCTAAGCCTCACGA,18,507849
araBp,0.7037037037037037,44,26,TGCGCAAGTTGTGAGTCCCT,18,478514
araBp,1.2222222222222223,58,26,TGCGACATTCTTTATAAACG,32,491375
araBp,0.7777777777777778,46,26,TCGACTGTCTCAGTGCGAGA,20,491233
araBp,0.7037037037037037,44,26,TATTTTCCCGATCTGCACGA,18,474645
araBp,0.5555555555555556,40,26,TAGAGGAAGTCCGGGTAGTC,14,502135
araBp,0.6296296296296297,42,26,GTGGGATCACTCTGTAACAA,16,488105
araBp,1.8888888888888888,76,26,GGAGCATTTGGCGATGAGCA,50,481481
araBp,0.7037037037037037,44,26,GCGACGCTCGTCCGGATCCT,18,508685
araBp,1.6296296296296295,69,26,GCACGGAAAGGTCCAAAGAA,43,495223
araBp,4.333333333333333,142,26,GATTGGAAATGTGCCTGCGT,116,511138
araBp,0.8888888888888888,49,26,GAGGGTGAAACATTTCAAGT,23,512281
araBp,0.48148148148148145,38,26,GAAACACCAGGATGATGGAA,12,522628
araBp,0.7037037037037037,44,26,CTTACCAGCAACCCACATGG,18,471533
araBp,2.2222222222222223,85,26,CGGCAATAATCGACAATCGG,59,473589
araBp,0.9629629629629629,51,26,CGAGTCTATGGTGTAGTGAG,25,479921
araBp,1.1111111111111112,55,26,CCCTGATCTGGACTAGGTCA,29,489254
araBp,0.9259259259259259,50,26,CCATATGTGAATGGAAGCCA,24,520268
araBp,1.8518518518518519,75,26,CAACTGGCAGTTATGGAGGT,49,499871
araBp,2.6666666666666665,97,26,ATTTCTAAAAACTGTTGCAT,71,496304
araBp,2.111111111111111,82,26,ATACGTCTCTACGCGTAGTT,56,479508
araBp,1.0740740740740742,54,26,AGTCTGGGTCACGTATACTG,28,484185
araBp,0.5185185185185185,39,26,AGATGGGGCTGGTCCATCTT,13,519775
araBp,0.8148148148148148,47,26,ACTCGCCTATCTCGGCTGAA,21,481312
araBp,2.7777777777777777,100,26,ACCTATACATTGTCAGTTTA,74,510811
araBp,0.8888888888888888,49,26,ACCCCGAAGCTATCTAGGGT,23,491038
araBp,2.5185185185185186,93,26,AACTCGCATCCCGTTACGCT,67,515141
araBp,1.7307692307692308,69,25,TTGGATTCGATTCGCCGGGG,44,494543
araBp,1.3076923076923077,58,25,TTATCAGCTAGAGATGATCA,33,511172
araBp,0.6538461538461539,41,25,TGCGGAGCCGAGGATCCTTG,16,476424
araBp,1.0,50,25,TCTTCAGCGGTTCATACAAT,25,516781
araBp,0.07692307692307693,26,25,TCGCGAAACGCTAATATGGA,1,491798
araBp,1.0,50,25,TATCAGAAGAACTCTCCGAC,25,513983
araBp,0.07692307692307693,26,25,TAGGTTTAGATACGATATAG,1,501558
araBp,1.1153846153846154,53,25,TACCACTTTGGAAATAGATA,28,506288
araBp,0.5,37,25,TAAAATGTCGTGGTCCGTTA,12,475580
araBp,4.153846153846154,132,25,GTCCATGTTTAGGCCTTCAG,107,521528
araBp,1.4230769230769231,61,25,GTAGGTATTTTATCAAAATG,36,512584
araBp,0.8461538461538461,46,25,GTAGGTAGCGTCGGGAAATA,21,481649
araBp,1.0384615384615385,51,25,GGTGTGGCTGTAAATTTCAG,26,476566
araBp,1.0384615384615385,51,25,GGGGCCTCCATACCTTCTAG,26,480768
araBp,1.0769230769230769,52,25,GGGCGTAAAAAGATCTCTGC,27,506018
araBp,0.8846153846153846,47,25,GGGATTCATCAGCAGGTAGA,22,481617
araBp,0.8461538461538461,46,25,GGCCGAATTGGTCAACATAT,21,495163
araBp,1.2307692307692308,56,25,GAGGGGCATCATCTGGATGA,31,487883
araBp,0.6538461538461539,41,25,GACAGTTGCGGCGCATGAAC,16,517934
araBp,3.3461538461538463,111,25,CTGCGCTTTACACCTAGTGT,86,497960
araBp,0.46153846153846156,36,25,CTGCAGTACCACGGCTTCGA,11,514665
araBp,1.6153846153846154,66,25,CTCTAAGGTCTGTCCGCGCG,41,507799
araBp,0.15384615384615385,28,25,CGTCAGGCTATCCGATTCAT,3,484807
araBp,1.1923076923076923,55,25,CGCGTGAGGCTGTACATCTA,30,485867
araBp,0.23076923076923078,30,25,CCGTAAGTCGCTTTTGGGCG,5,471176
araBp,0.2692307692307692,31,25,CCGGTGGCCTCGCAAGTACT,6,519840
araBp,0.6153846153846154,40,25,CATGCTCACTAATGTGTTAT,15,507036
araBp,1.8076923076923077,71,25,CAGGTCTGTCTCTGTGGTGT,46,499224
araBp,1.4230769230769231,61,25,ATACGGAGGGTATGATCTAA,36,478794
araBp,1.6923076923076923,68,25,ACGACGGGCGTCGTTCCAAA,43,479516
araBp,0.5769230769230769,39,25,ACATTCTCAGAGGCCACGAA,14,471900
araBp,1.9615384615384615,75,25,ACAGTTTGCTAACGACTGGG,50,469615
araBp,0.07692307692307693,26,25,ACACATGTGGGGAATCTGCG,1,473080
araBp,1.6538461538461537,67,25,AAACGTAACATACAGCAATT,42,475942
araBp,2.28,80,24,TTCAGTCCTAACTTGATTCA,56,492340
araBp,1.04,49,24,TGTGTTACCATCTACGGTCC,25,483958
araBp,3.8,118,24,TGGGAGGGATGCACGGGCGA,94,479122
araBp,1.6,63,24,TGGATGCGCTACATGTCTTC,39,507114
araBp,1.32,56,24,TCGACTCCGTTGGCCTATGA,32,521709
araBp,2.48,85,24,TAGATACTACGGCATCCATT,61,474827
araBp,1.12,51,24,GTTAGCTGTTTTTTAGCCCG,27,521034
araBp,0.48,35,24,GTTAGCCATGCCGCCAACTA,11,497708
araBp,1.16,52,24,GTCTATACGATTACAATACG,28,482934
araBp,5.48,160,24,GTCAGGAAGACTTCAGACTA,136,517855
araBp,1.6,63,24,GTATCTCTGTTTCTAGGTTA,39,507096
araBp,0.52,36,24,GTAACGTCCAGCTAAATTTA,12,482155
araBp,0.64,39,24,GGTTATGTTCGGATGTTGAT,15,482288
araBp,0.08,25,24,GGTGGTCATAGCCGGGGTAG,1,509675
araBp,0.48,35,24,GCGTCTCCAGCTAATTACCA,11,475227
araBp,2.0,73,24,GCGGGTTCACATGCAGCAGA,49,483536
araBp,0.72,41,24,GATTAGCTTTACAGTGTTCC,17,511633
araBp,2.0,73,24,GACTCGATCGTTTGCGTCAC,49,491885
araBp,0.48,35,24,CTCGGCTGTTGAACTGATGT,11,504429
araBp,2.6,88,24,CTCACATCTATTTAGCATGG,64,520497
araBp,1.44,59,24,CTATGGTCATGTTAGCTGCA,35,521803
araBp,0.08,25,24,CGTGTGCGTAGTTTGTCATG,1,485057
araBp,0.48,35,24,CGTAACGGCCGCACTTGTTA,11,499017
araBp,0.84,44,24,CGGTGACATCTTTTGTACGG,20,496750
araBp,1.08,50,24,CGGGCTAGTTCGGATGAGTA,26,494085
araBp,0.12,26,24,CGATGGTGGCCTAAGGCTAT,2,499929
araBp,2.04,74,24,CCGCTGACATAAGTAAATGA,50,505844
araBp,1.16,52,24,CCAAGCTGCACAGCGGTTCG,28,480337
araBp,1.36,57,24,CACTCACTCGAAACGCCCTG,33,516441
araBp,0.76,42,24,ATTATAGCAATCAGCCAAGT,18,504372
araBp,1.48,60,24,ATGGGGGCGGACCCGAGTAG,36,503533
araBp,1.4,58,24,ATCGATTAATGAACTCGCTG,34,519057
araBp,2.68,90,24,ACTGGGTTTAATTGAGCAGT,66,503631
araBp,0.12,26,24,ACGGGAAGTCTCGGGGCGAT,2,506633
araBp,0.24,29,24,ACGCCGCAGTCCCGCGCGCT,5,486808
araBp,0.6,38,24,ACCGTGGCTCGCCAACGAAA,14,525176
araBp,1.2,53,24,ACCCGTGTCCCGGCCTTGTT,29,499819
araBp,0.08,25,24,ACAGAACGCCGCTCCGGACC,1,470899
araBp,0.52,36,24,AACCATCGGATCTGGAACTC,12,474547
araBp,2.24,79,24,AAATCAACTTGACAAGCGCA,55,484443
araBp,2.04,74,24,AAAACGGCTCTCGTCCGATG,50,500954
araBp,0.7916666666666666,41,23,TTTGCCCGATAGCGTCTCTT,18,505442
araBp,1.6666666666666667,62,23,TTTAAATCAGACTTTTCCTA,39,504365
araBp,1.1666666666666667,50,23,TTGACCTCCTAGGTTATGTT,27,471390
araBp,0.5,34,23,TTCGTTTACGTTCCGGCTCA,11,469376
araBp,0.08333333333333333,24,23,TTCAGTGCCGCCCGAACAAC,1,525098
araBp,1.2083333333333333,51,23,TTACCTACAACTATGATCTG,28,482314
araBp,1.0416666666666667,47,23,TGCAAGAGCGCTTGTTTCCA,24,491995
araBp,1.375,55,23,TGAAGAATATTTCTCACTTT,32,481971
araBp,0.4166666666666667,32,23,TCCAGTAGCCTGTTCAGTAC,9,471497
araBp,0.5416666666666666,35,23,TATCTGTAGCCGATCGAGGC,12,508439
araBp,0.7083333333333334,39,23,TAGATTCGTTACAATGAGCG,16,513141
araBp,2.25,76,23,TACGGCAGTTCGCTAGGGAA,53,479391
araBp,1.375,55,23,TAAGACGATCGAACTGTTGC,32,508279
araBp,0.20833333333333334,27,23,GTTCCGGAAGCACCACCATG,4,476199
araBp,0.7916666666666666,41,23,GTGCTTAGTAGATCCTAACA,18,496369
araBp,0.7916666666666666,41,23,GTCGAGCGCTAGAGATGACA,18,496804
araBp,0.08333333333333333,24,23,GTCCCATACGGCCATAATAG,1,496575
araBp,0.875,43,23,GTCAAGGTACGCTGTTATTC,20,488527
araBp,0.5833333333333334,36,23,GGTGGGGGCAACGTTTAGGT,13,483554
araBp,0.9583333333333334,45,23,GGGGGTTACATTAGCACTGC,22,483712
araBp,0.8333333333333334,42,23,GGGATGGGTGTTCATCTGAG,19,509097
araBp,0.5833333333333334,36,23,GGGAGGACAGTTGCCTAGGT,13,471016
araBp,1.3333333333333333,54,23,GGCCGAAAACTACCACATAC,31,479432
araBp,0.625,37,23,GGCAATAGCTGGTTTTCACT,14,498302
araBp,0.5416666666666666,35,23,GCATCGGACTATTGCAGGCG,12,503164
araBp,4.5,130,23,GCAGGTAGAGGATCGTCTAT,107,472628
araBp,1.875,67,23,GATTATCTAATAGTTGCTCC,44,514714
araBp,2.0416666666666665,71,23,GACCCGCGTAAGCAGCGTTA,48,499293
araBp,1.0416666666666667,47,23,GAAGGATGACGCATAGCCCC,24,473835
araBp,1.7083333333333333,63,23,CTTTTCTTGGCGAGGCGCCG,40,511386
araBp,4.375,127,23,CGGAGTGCTCGTTAGTTCTG,104,477515
araBp,0.7916666666666666,41,23,CCTTTTGTGGCCTTACTGCG,18,490562
araBp,0.4583333333333333,33,23,CCTGTGCTCCATACCTTTGT,10,482212
araBp,0.375,31,23,CCGCCTTCTCACTTCCCGTT,8,511041
araBp,1.125,49,23,CCCACAGCCTTGCGATAGAG,26,476773
araBp,1.0416666666666667,47,23,CCAACCCTTAACCTAAGGTA,24,479561
araBp,0.9166666666666666,44,23,CATCTTCGTTTCCTGTACCG,21,520933
araBp,1.375,55,23,CAGATACTAGGGTCCGCAGT,32,497875
araBp,0.875,43,23,CAACGCAACATGCAGCAGTG,20,505225
araBp,0.5833333333333334,36,23,ATTTAAGAGGTGAGGGCGGA,13,517727
araBp,0.2916666666666667,29,23,ATGTGAAATCTTAGGATGTG,6,483807
araBp,2.0833333333333335,72,23,ATGACTTTTTAGGTCGCCAT,49,520943
araBp,1.0416666666666667,47,23,AGGCTCTCCGGCCTAGGCAT,24,472292
araBp,1.2083333333333333,51,23,ACTATCCGAAAGCCAAGGAA,28,475375
araBp,0.08333333333333333,24,23,ACTAAGCCAAACCGTGGCCA,1,503257
araBp,0.4583333333333333,33,23,ACCTGGGAGTGCGCTAGCAA,10,518130
araBp,1.375,55,23,AATCGGATAGATCTGGTTAA,32,475140
araBp,0.9166666666666666,44,23,AATATGGCACATATTTGAGC,21,477264
araBp,1.5833333333333333,60,23,AAAGACGGAATCGGGGGCGT,37,518560
araBp,0.9166666666666666,44,23,AAAAGCCATTCTCATTGAGC,21,484718
araBp,0.08695652173913043,23,22,TTTACCGCGTCGAACCGGCA,1,468832
araBp,0.6521739130434783,36,22,TGCCCGCCTAGAAGAAGGAA,14,518539
araBp,1.2173913043478262,49,22,TGAACAGAGGGGCTGGTGGT,27,496110
araBp,1.0434782608695652,45,22,TCGCTACGACACCCGCAGGC,23,503799
araBp,2.391304347826087,76,22,TATTGGTGGTCTTGCGCCGA,54,478013
araBp,1.0869565217391304,46,22,TATGTGTAAAGTGCTGGCTT,24,471578
araBp,0.5652173913043478,34,22,TAGAACCGATTATTTTGAGT,12,476152
araBp,0.782608695652174,39,22,TACGCCCCTAAGTACGAGCC,17,470306
araBp,1.173913043478261,48,22,TACCACAGGACGCCGCCGGA,26,520531
araBp,0.782608695652174,39,22,TAATTTGTATTGGCCGGGAG,17,505171
araBp,2.608695652173913,81,22,TAAAGGCCCACTAGGTAGCC,59,504477
araBp,0.6521739130434783,36,22,GTTTTCTGTCTGTAGGCGTT,14,482700
araBp,1.173913043478261,48,22,GTTAGACTAACGATCAAATC,26,476316
araBp,1.3478260869565217,52,22,GTCACCACACGGGAGCTTAA,30,500197
araBp,1.3043478260869565,51,22,GGTTCGCATTGGGTACCATT,29,515697
araBp,1.1304347826086956,47,22,GGTAGCCCGCGGGAGGTGCT,25,505307
araBp,0.9130434782608695,42,22,GGGATGTGAGCAACTCAGGA,20,482888
araBp,1.9130434782608696,65,22,GGATGCGGCGCGGAGAATTA,43,471095
araBp,1.0434782608695652,45,22,GCCAGTAGTGGGCGCGTGGT,23,507206
araBp,0.9565217391304348,43,22,GACTACGCAAATACGGCGCC,21,499358
araBp,1.3478260869565217,52,22,GAAGGTCTGGACTCAGCGGA,30,483560
araBp,0.13043478260869565,24,22,GAAATACATAGGGCTTCTTT,2,519219
araBp,0.5652173913043478,34,22,CTTGACTTGCAAGGCCGGAT,12,481761
araBp,1.9565217391304348,66,22,CTGAGGTGGGTGACTTAATC,44,493339
araBp,1.2173913043478262,49,22,CTACGTGGTTGAACAAGCAA,27,478084
araBp,2.0434782608695654,68,22,CCTTTACCGCAGAAGAGGTA,46,507050
araBp,0.08695652173913043,23,22,CCTCAGACACATGCGCCAAG,1,468710
araBp,0.9565217391304348,43,22,CCGGATCGTTCACAGCCAAA,21,504116
araBp,0.08695652173913043,23,22,CCGCGCGAGATACGCGGTGC,1,475460
araBp,2.652173913043478,82,22,CCGCACTATGCTTGGCGAGA,60,471230
araBp,0.6086956521739131,35,22,CCCTTTTATTATGGGAGACA,13,505984
araBp,0.6521739130434783,36,22,CAGTCGTAGTAAATAATCCA,14,475802
araBp,0.5652173913043478,34,22,CACGAGCTTGAATAAGGGAC,12,480738
araBp,2.4347826086956523,77,22,CAAGGCTCCCGATCTCCCAC,55,502283
araBp,1.7826086956521738,62,22,ATTCTTGTCGGCGGGATCCT,40,492000
araBp,1.5217391304347827,56,22,ATCTTTTACTTCTGAAAGCA,34,505702
araBp,1.6956521739130435,60,22,ATCGCATTGCGGTAGATGAA,38,493787
araBp,1.6521739130434783,59,22,AGTGGTAGCCTATCTAGTAT,37,500426
araBp,1.0434782608695652,45,22,AGTCTGTTGTCCCCACAGAA,23,485999
araBp,1.434782608695652,54,22,AGTAGGGTGGTAGCAAATAT,32,496019
araBp,1.0434782608695652,45,22,AGGCTTAATGACTGAACAGT,23,475816
araBp,5.6521739130434785,151,22,AGCGTGTTAGTCGCAGCGGC,129,472171
araBp,1.2173913043478262,49,22,ACGGGCCAACCACAGGTAAA,27,520489
araBp,1.173913043478261,48,22,AATGTAGTTTCATACCGGGG,26,505046
araBp,0.6956521739130435,37,22,AAGCTACTTGGCGCTTTAAC,15,511861
araBp,2.782608695652174,85,22,AAGCTACCACGGCTGTCCAC,63,503658
araBp,1.5454545454545454,54,21,TTTCCATCAACCCCTAAGGC,33,487853
araBp,0.09090909090909091,22,21,TTGGGGTACGCTGAACCAGA,1,488271
araBp,1.8181818181818181,60,21,TTGGCCGGTCTTACTGTGTA,39,469563
araBp,0.09090909090909091,22,21,TTCCCAAATTGGCCTCTCGA,1,476921
araBp,1.1818181818181819,46,21,TTCAATTGGAGACGCACTTA,25,469955
araBp,0.09090909090909091,22,21,TGGGATTCGGGGCGATTGTC,1,514843
araBp,1.2727272727272727,48,21,TGGCAATTTAGAGCTTCATC,27,473310
araBp,1.6363636363636365,56,21,TGCGTTTCGCCGTTGAGTGT,35,471680
araBp,1.7272727272727273,58,21,TGCAGGGATTTTCATGTTTA,37,485510
araBp,2.727272727272727,80,21,TCATGCAGAAGATAACGGCA,59,488943
araBp,0.5,31,21,TAATATTGTAAACGCTCACG,10,508123
araBp,0.9090909090909091,40,21,TAACTCACGACTTGTAGTTT,19,492807
araBp,1.2727272727272727,48,21,TAACATACTATGTGCGCTTA,27,473829
araBp,0.5454545454545454,32,21,GTTCAGGCCCCTTCGTCCGA,11,478061
araBp,0.09090909090909091,22,21,GTCTTCCTCGTAGTCCGTCG,1,497535
araBp,3.9545454545454546,107,21,GTATCTCCAAGTTCACAACC,86,496727
araBp,0.7272727272727273,36,21,GGCCTCCATCGGTAAGAATA,15,470785
araBp,0.4090909090909091,29,21,GGCCATCTAGGGTGGGGATT,8,507385
araBp,1.2727272727272727,48,21,GCTTTTGTTCATACTTCTGG,27,469708
araBp,1.4545454545454546,52,21,GCTCAACCTTCTAAAAAAGG,31,481207
araBp,0.7727272727272727,37,21,GCCGCAATTATGCTCTAACG,16,481136
araBp,2.1818181818181817,68,21,GCAGCCACCGACGGCACTAG,47,516381
araBp,0.09090909090909091,22,21,GCAGCAACTACATTGGGTGG,1,481492
araBp,1.7272727272727273,58,21,GATGATGCGCGGCATAACTC,37,469425
araBp,1.7727272727272727,59,21,GAGAGTAGAGCCTACCTAAC,38,469973
araBp,1.7272727272727273,58,21,GACGGGATGCTCATTAATGA,37,475609
araBp,0.9545454545454546,41,21,GACGCTAATAGCGACGCTGG,20,473710
araBp,1.5,53,21,GACCCATCTTTAGTGACTCT,32,485579
araBp,1.7727272727272727,59,21,CTTGTGAGGGCAAGGGTAAT,38,503482
araBp,0.9090909090909091,40,21,CTTGACGAGGGTTCTGTGCT,19,512287
araBp,1.3636363636363635,50,21,CTGCTTTTGGGAGAGTCGCG,29,504949
araBp,0.5909090909090909,33,21,CTCTCATCATCTTGGCTTCT,12,481278
araBp,1.0909090909090908,44,21,CTAGGAGAAGGAAGTACTTG,23,510751
araBp,0.36363636363636365,28,21,CGGAGATACCAGTATCATGG,7,479227
araBp,0.45454545454545453,30,21,CGAGAGATGAAGTCGAAATT,9,501161
araBp,1.1818181818181819,46,21,CCCTAAGTTCATGTCTCAAT,25,525099
araBp,1.2727272727272727,48,21,CCCGTCCAATAACGACTGAA,27,498108
araBp,1.8181818181818181,60,21,CCCGAACCACCTATTGATAT,39,503361
araBp,0.8181818181818182,38,21,CCCATTATCGGTAAGTAGGG,17,498481
araBp,1.1818181818181819,46,21,CCCAGCTGTGGCCCTGTTTT,25,513299
araBp,1.2727272727272727,48,21,CCAGACGGAAGTTACAAGCC,27,479313
araBp,1.3636363636363635,50,21,CATTGCGTGCACGTTTCGTA,29,493895
araBp,1.3181818181818181,49,21,CATCTTTTAGTTCCTCAGGA,28,505569
araBp,0.7727272727272727,37,21,CAGGACCCTTAGTTAAACCT,16,472900
araBp,2.227272727272727,69,21,CACGGATTGAAAGATCGTCG,48,479869
araBp,1.0909090909090908,44,21,ATACAGCGACTAGGGACCCG,23,468081
araBp,1.5,53,21,AGGTGCTTATAGCGAATGAA,32,474624
araBp,0.9545454545454546,41,21,AGCCGTTGGTCCGCTACTAT,20,488089
araBp,0.8181818181818182,38,21,AGCAGGCCATGTACCATCGC,17,480992
araBp,0.9090909090909091,40,21,ACTGTGGCTAAATGCAGAGT,19,482632
araBp,0.09090909090909091,22,21,ACTAGCAGGATGTTTGCATT,1,499210
araBp,1.2272727272727273,47,21,ACGGCTGACACCGACGGCTG,26,492596
araBp,1.6363636363636365,56,21,ACGACGAGATCCTCTCGAGT,35,489060
araBp,1.6363636363636365,56,21,ACCCTGGGGATGTTGAGTAC,35,474003
araBp,1.1363636363636365,45,21,ACCCACAGTGAGATGTCATA,24,479257
araBp,1.9090909090909092,62,21,AATTATAACTGGCGGAGCGT,41,486446
araBp,0.09090909090909091,22,21,AATACGACCCGTTCGCGGTT,1,503020
araBp,1.2272727272727273,47,21,AAGACCCACTAATTACGGTT,26,485432
araBp,1.6818181818181819,57,21,AACAGTACGGGCGTGGACAG,36,485351
araBp,1.5909090909090908,55,21,AAAATAGTTTCAGGGCGTGA,34,469266
araBp,0.9523809523809523,39,20,TTTAGGTGGGGGACCACGTA,19,515148
araBp,0.8095238095238095,36,20,TTGATCAGGACCGAAGTTAT,16,509389
araBp,0.09523809523809523,21,20,TTCAACTATGTGCTCTAGAG,1,471570
araBp,1.7142857142857142,55,20,TTATATTAGTGTACGTGTTA,35,470699
araBp,3.4285714285714284,91,20,TTAGGGCGCAGAACATACAT,71,483810
araBp,0.9047619047619048,38,20,TTACAGACGTGAGCGTAGGA,18,473718
araBp,0.7142857142857143,34,20,TGGCGCACTAGTTGATAACT,14,504171
araBp,1.380952380952381,48,20,TGCGACTACCCCAGAGCACT,28,474683
araBp,0.8095238095238095,36,20,TGCAATGACTCTTAGATGTA,16,523037
araBp,0.09523809523809523,21,20,TGAGGAGAAAGGGTCCGTTG,1,483230
araBp,0.09523809523809523,21,20,TGAGCGTAAATCAAGAGAAC,1,468018
araBp,0.8571428571428571,37,20,TGAAATCGATCCGCTGGTAA,17,485592
araBp,2.1904761904761907,65,20,TCTAGAGCGTGGGCTATCAA,45,487413
araBp,1.1904761904761905,44,20,TCATCTGAGGCTGCTATTCA,24,521585
araBp,1.8095238095238095,57,20,TCAACGTGGATGAAAAAGAT,37,498985
araBp,1.9047619047619047,59,20,TAACGAGGTCAGGGCGAATG,39,482942
araBp,2.0476190476190474,62,20,TAACAAACTCAGCTGGGGTC,42,468644
araBp,2.857142857142857,79,20,TAAACGATGGTCTTAGTTAA,59,468209
araBp,1.1904761904761905,44,20,GTCTTCGAGCAAGAGTCCCT,24,488944
araBp,6.761904761904762,161,20,GTCGTAAGGTGCAATAGATC,141,475817
araBp,0.6190476190476191,32,20,GTCGCAATCTCCGACATATG,12,519213
araBp,0.42857142857142855,28,20,GTCAAACATGAGGGAGTTAG,8,497859
araBp,3.9047619047619047,101,20,GGTTAAGCTGACGTCAGGTT,81,494919
araBp,1.4285714285714286,49,20,GGTACGCGGGATTCCAAAAC,29,501567
araBp,0.9523809523809523,39,20,GGGTGACAGGACGTGCGATA,19,481913
araBp,1.380952380952381,48,20,GGCGACGCGTTGTCGTGTGG,28,469252
araBp,1.2857142857142858,46,20,GGAGGGGGTGCGGAGACTTT,26,495787
araBp,1.619047619047619,53,20,GCTTGTTGCTTCTACAGTAC,33,486003
araBp,1.0952380952380953,42,20,GCGGGCCGATGCGGTTCTGT,22,484942
araBp,0.8571428571428571,37,20,GCAGGGCTTTAGACCAGGAG,17,472242
araBp,1.0476190476190477,41,20,GCAAGAAGGTCCCGCCTCAT,21,499064
araBp,1.1904761904761905,44,20,GATTGTTTATCTGGGATGGA,24,490756
araBp,2.2857142857142856,67,20,CTTGGAACATAAGGGAGGGT,47,500736
araBp,0.09523809523809523,21,20,CTTGAGACTAAGGTCTGGTG,1,496772
araBp,1.8095238095238095,57,20,CTGGGAAACATTCTCGGGCT,37,503758
araBp,1.3333333333333333,47,20,CTCATCAGTCCTCAAGGCGT,27,474678
araBp,2.5714285714285716,73,20,CTACGGTTCTTTCGCCCGTA,53,491611
araBp,0.7142857142857143,34,20,CGTTATCGTGGTCCGTTATT,14,471261
araBp,0.09523809523809523,21,20,CGTCCGAAAAACTAGCCTCA,1,522437
araBp,0.09523809523809523,21,20,CGGGTTGATATGCGTGTCGT,1,508901
araBp,0.9523809523809523,39,20,CGATGTGACGTGGGAAGACA,19,475236
araBp,1.380952380952381,48,20,CGAGGTCGTTGCACTCACAT,28,472407
araBp,0.8095238095238095,36,20,CGAGCAACTGCGTCTTCGTC,16,504682
araBp,0.9047619047619048,38,20,CGACTCACGATGGCGGTTGT,18,478388
araBp,3.2857142857142856,88,20,CCTCAATTAGAGACGATATA,68,480504
araBp,0.7142857142857143,34,20,CCGACCATCTGAACAACCGT,14,469501
araBp,1.3333333333333333,47,20,CCCCTTGGTCCGCATCCAGG,27,489401
araBp,0.9047619047619048,38,20,CCCCGAAATTGCTACTATGG,18,484179
araBp,0.09523809523809523,21,20,CCAACGAAGTTGCCTGTGCT,1,487560
araBp,1.4761904761904763,50,20,CAGGGTGAATTATTCCATCG,30,471444
araBp,0.7619047619047619,35,20,CAGGAGTCTGCCTGGCGTGA,15,514379
araBp,1.1904761904761905,44,20,CAGCCCTGTCAAACTCTCGT,24,485119
araBp,1.619047619047619,53,20,CAACACGGAACTCGAGCTCA,33,488384
araBp,1.3333333333333333,47,20,ATTGGTTGAGCTGGCCTGCA,27,494366
araBp,1.5714285714285714,52,20,ATTGCGCCGCGCAACCAGTA,32,511679
araBp,1.1428571428571428,43,20,ATGGAGTCGCTGAGCTCGGT,23,511280
araBp,1.1904761904761905,44,20,AGTTAATTCCTTCTCATTAA,24,497411
araBp,1.0,40,20,AGGTCGTGGGGTGGGTCGGA,20,513631
araBp,0.9523809523809523,39,20,AGGGAGAGACGGCGAGAGAA,19,499077
araBp,1.1904761904761905,44,20,AGGCGTAAACATTAGCGTAG,24,479428
araBp,0.7142857142857143,34,20,AGGAAGTCTCGTCTCGCACT,14,498242
araBp,2.5238095238095237,72,20,AGCTTTAACTGGTCTGCGGG,52,485270
araBp,1.7142857142857142,55,20,AGATGGAGTGCCCTGCCTCC,35,482095
araBp,1.1904761904761905,44,20,ACGGGGGCCGAGCTCGGAGG,24,507113
araBp,1.2380952380952381,45,20,ACGATAGGGCTAGGGCCGAG,25,492044
araBp,2.1904761904761907,65,20,ACCTTCAATAAGTTCGGAGC,45,476986
araBp,0.42857142857142855,28,20,ACCTATCTAGATAGGAAGAT,8,481551
araBp,0.5238095238095238,30,20,ACCGCTCTTGGGGGGTTAGT,10,500158
araBp,2.5714285714285716,73,20,ACCACACGGGACCACAACCG,53,500361
araBp,3.761904761904762,98,20,ACACTATAAAGGCCAGTCGT,78,507541
araBp,0.9047619047619048,38,20,AAGTTATGGTAGGTAGTAGT,18,470782
araBp,1.6666666666666667,54,20,AAGTTAATCACGCACAGCAG,34,500762
araBp,1.0952380952380953,42,20,AAGATTCGGTGTAAAGCCCG,22,490183
araBp,2.1,60,19,TTGCCGTCCAAGATGTATGA,41,518625
araBp,0.75,33,19,TGGCCTCATTTTAAAGTGTT,14,489547
araBp,1.65,51,19,TGCAACCGGAGAAGTAACGT,32,499253
araBp,1.35,45,19,TGATCAACGACCAAGTGGAG,26,476144
araBp,1.5,48,19,TGAGGTAGTTACGGGCTGAT,29,477090
araBp,0.85,35,19,TGACGCTATTTCTTGTATAC,16,502973
araBp,0.75,33,19,TGAAAAGGCGTTTGAATGAA,14,513896
araBp,1.5,48,19,TCGTTGGCCACGACCGCAAA,29,475778
araBp,1.3,44,19,TCGGGAACGCATCTGATTGT,25,507066
araBp,0.95,37,19,TCGATAACATGGGCGCTGCC,18,517459
araBp,0.1,20,19,TCAGTGCCTCTCTAGAGTAT,1,487039
araBp,1.5,48,19,TATTCAGGGGTCCCTGCCAG,29,475011
araBp,0.1,20,19,TAGCATTCAGTGAGTAATGT,1,510031
araBp,1.1,40,19,TACACCGCCGAACTGAGTGA,21,512630
araBp,1.25,43,19,GTTGTTCAAAATGGCACCTT,24,483191
araBp,0.1,20,19,GTTAATCCGCACTTCTAATG,1,514886
araBp,0.8,34,19,GTAGTGATAAGTTAGACCTC,15,516675
araBp,0.1,20,19,GGTTACAAGCCATCATCAGT,1,495430
araBp,1.2,42,19,GGGTTTTACGTGAGCGTGAT,23,476992
araBp,1.55,49,19,GGGGGAAAACATGCCCGCAT,30,519304
araBp,1.75,53,19,GGGACAGCCCTATAATCGTC,34,514089
araBp,2.35,65,19,GGCCCTGGTATAGGATTCGA,46,471706
araBp,1.25,43,19,GCTTGACTGAAATTTTCTGC,24,517255
araBp,1.85,55,19,GCTCGCGTCCTCAATAATGT,36,504302
araBp,1.4,46,19,GCTCAGTGTAATGAGTTCGG,27,493469
araBp,2.0,58,19,GCTACGGAAGCATGTAGCAT,39,494321
araBp,0.1,20,19,GCGCTCGGCCAAACCCTCCG,1,498576
araBp,1.3,44,19,GCGCGAAGTGCAACACCATG,25,502040
araBp,1.15,41,19,GCCGGACATCCGGCTCATGT,22,490278
araBp,2.6,70,19,GCAGTGATTCTATGCGTATG,51,502008
araBp,1.55,49,19,GCACAAAAATTTTGCGAGGA,30,497972
araBp,1.2,42,19,GATTTATTTAGAAAGATCAT,23,520016
araBp,1.1,40,19,GATGCAACATGAGGTGCGGG,21,500902
araBp,1.9,56,19,GATCCTCCAGTCTACTTCTG,37,467910
araBp,2.3,64,19,GAGCTCGGTTTATTGGGTGA,45,476515
araBp,0.75,33,19,GAGCATGTTAAAGCCGCCAG,14,469206
araBp,2.9,76,19,GACTGGGTTAGCACGTTCCT,57,486324
araBp,0.15,21,19,GACACATGCTCGTCATAAGT,2,491418
araBp,0.45,27,19,GACAACAACCCGTGGCCAAA,8,510183
araBp,0.8,34,19,GAAGTGGTGGTCCAGCTGGG,15,484234
araBp,0.1,20,19,GAACGTTATTGACACGGTCT,1,497702
araBp,2.95,77,19,CTGTAGGAATGCAATTTCAC,58,501251
araBp,1.45,47,19,CTGCGTCCATGCTAATCCGT,28,524827
araBp,1.7,52,19,CTGCCATCACAAATTGATAT,33,493492
araBp,1.5,48,19,CTGATCCGAGTGCCACAATA,29,478193
araBp,1.1,40,19,CTCTCGTGTTGGTCTTTGCA,21,495660
araBp,1.1,40,19,CTCACGGATACCTTGCGGGA,21,503229
araBp,2.65,71,19,CTACCGGTCTACAAACACCA,52,478700
araBp,1.45,47,19,CTAACTGGCCAAGGATGAGT,28,516412
araBp,1.75,53,19,CGTGGATCACAATATGCAGG,34,474771
araBp,0.4,26,19,CGTATTCTCTCATTCCAGAC,7,499925
araBp,0.95,37,19,CGTATCTGGGTGACAAAGTT,18,476737
araBp,0.95,37,19,CGTAATCCCAGTGAAGGGGT,18,468689
araBp,1.3,44,19,CGCTCACTATTGCACTCACA,25,518882
araBp,0.1,20,19,CCCACGTTTAACTTTCTGTA,1,475424
araBp,0.1,20,19,CCCAATTAGGGCGAAGGGTA,1,503863
araBp,0.6,30,19,CCATGTTTTGGAAAGCCCAC,11,477105
araBp,0.1,20,19,CATTGATATTCAAATGTTCT,1,491173
araBp,1.05,39,19,CACTAAGAGACCGTCTTATC,20,478419
araBp,1.0,38,19,ATTGAGCAGAGTGACACCGA,19,501016
araBp,1.35,45,19,ATGTGGTGGCTCCCTGTGCG,26,484437
araBp,0.25,23,19,ATCATGTCAAAGGTCACCTC,4,515597
araBp,1.7,52,19,ATCATGGAGTGGACCGGATG,33,506967
araBp,1.6,50,19,ATACCATGGAGAACCACCTG,31,498325
araBp,2.1,60,19,AGTAGTTACTACCAGCGGGA,41,492886
araBp,1.7,52,19,AGCTGTCTTCATCTGGAAGA,33,520118
araBp,3.85,95,19,AGACTGAACCGTTCTTTAGG,76,517910
araBp,0.95,37,19,AGACGGCCCACCAGGCGCGT,18,516990
araBp,1.2,42,19,ACTTGCTGAACGTTATATAC,23,488688
araBp,1.0,38,19,ACACTTGTGACACTGTGGGC,19,475615
araBp,0.55,29,19,ACAACGAAGAGCCTTCAGCT,10,481240
araBp,1.25,43,19,AACAGTGGGGTTCGGTCAGG,24,523776
araBp,1.9,56,19,AAACGCGGAGTGCCCCTACT,37,487038
araBp,0.6842105263157895,30,18,TTTCCTACACCCCCCCGACA,12,475773
araBp,0.6842105263157895,30,18,TGGTCTGGTTACAGACGGAC,12,481784
araBp,1.0526315789473684,37,18,TGCTCCTGTGGGTAGGCGGA,19,485455
araBp,0.10526315789473684,19,18,TGAGAAATCTGGGTTCCGAG,1,520443
araBp,0.8421052631578947,33,18,TGAAGTAAAGGGCTCACACC,15,518500
araBp,0.10526315789473684,19,18,TGAACCGGGTACGAGTCACA,1,497769
araBp,0.10526315789473684,19,18,TGAAATGTTGATTGTCTCCT,1,514620
araBp,1.1578947368421053,39,18,TCTGACAATTATCGAATCAA,21,489625
araBp,1.105263157894737,38,18,TCTCAGAGTCGCTGCGGGAG,20,488168
araBp,0.7894736842105263,32,18,TCGCTTGGGTGAGCAAAATG,14,489618
araBp,0.7368421052631579,31,18,TCGATGGAATAGTCAAACGG,13,488410
araBp,0.8421052631578947,33,18,TCCGCCAATCTGCTATGACA,15,482657
araBp,1.368421052631579,43,18,TCATCAATCGTAATACGGAC,25,498277
araBp,0.10526315789473684,19,18,TCAGGGCAGGGGAAGAACGG,1,489623
araBp,0.10526315789473684,19,18,TCAGGGATTCGAGGCCGGTA,1,489517
araBp,1.1578947368421053,39,18,TATCATACTGGCCCCACTTG,21,501942
araBp,0.7894736842105263,32,18,TATAAAAGCCCCCACGAATC,14,488668
araBp,1.6842105263157894,49,18,TACTTTGTGAATCCAGGCCT,31,475729
araBp,2.8947368421052633,72,18,TACTTCCCCAAGGAAAGTAC,54,476324
araBp,0.10526315789473684,19,18,TACTCGTCCAGTCATTCTTT,1,473752
araBp,2.736842105263158,69,18,TACGCGCTTATATTACGGAT,51,470088
araBp,1.1578947368421053,39,18,TACAAATAGCATATGTTCCA,21,487123
araBp,0.5789473684210527,28,18,TAAAGGTTGGGGATTGTATA,10,481654
araBp,2.5789473684210527,66,18,GTTTCACCACTGCCTTCAAT,48,486081
araBp,0.8947368421052632,34,18,GTTCGATGCCCCTGTTGAAG,16,515270
araBp,2.0526315789473686,56,18,GTCTTGACTATTCGTTACGA,38,491734
araBp,0.9473684210526315,35,18,GTCATTTTCACCAAATCCGT,17,485026
araBp,0.10526315789473684,19,18,GTCATCTTCAACAGTAAAGA,1,477265
araBp,1.5263157894736843,46,18,GTATGGTTATTGCTAAGCAG,28,491002
araBp,1.0526315789473684,37,18,GTAGAGGCCTTTGCTACGGC,19,506496
araBp,1.631578947368421,48,18,GTACGGAAGTTCCCCCCGTA,30,494477
araBp,0.10526315789473684,19,18,GTAACATGAAACGGAAGAAT,1,489877
araBp,0.7368421052631579,31,18,GGTGCTCAGTTGCATTGACG,13,483558
araBp,3.8947368421052633,91,18,GGTACCTCTATGGACGGCTG,73,475854
araBp,1.263157894736842,41,18,GGGACAACACTCGTCGCCTA,23,474730
araBp,1.0,36,18,GGCAAACAATTAACCCTTCT,18,486050
araBp,1.736842105263158,50,18,GGATCCCTGCATCGTCTTCG,32,482564
araBp,1.2105263157894737,40,18,GCTTGGTTCCTGTGAATACT,22,495788
araBp,1.2105263157894737,40,18,GCTTGGAAGACGTCACGAGC,22,489725
araBp,0.10526315789473684,19,18,GCCGTATTAGTACGTTAGGT,1,508758
araBp,0.10526315789473684,19,18,GCATGCGGGGCTATAGAACA,1,496662
araBp,1.3157894736842106,42,18,GCAACTCCTGCGTATAACGG,24,471943
araBp,0.3157894736842105,23,18,GAGAAAAGTTGGGGCCAGCA,5,470389
araBp,1.368421052631579,43,18,GAATCTAAGCGATGCGAATC,25,509818
araBp,0.6842105263157895,30,18,CTCTAGCCACTTACTTGGTT,12,509600
araBp,0.8947368421052632,34,18,CTCCTTCGGGCGATAGGTAA,16,499304
araBp,1.1578947368421053,39,18,CTCCCGACGTACGTCAGTTA,21,516587
araBp,1.0,36,18,CTAGGCTTGACCAGGATAAC,18,509413
araBp,0.8421052631578947,33,18,CGTCTTGAGACTTGTTAAAA,15,489873
araBp,0.7894736842105263,32,18,CGTCAGGCGGATCGCAACGA,14,478873
araBp,0.10526315789473684,19,18,CGTAAATACTTTCCGGCGTG,1,491526
araBp,0.5789473684210527,28,18,CGGTTCGGAGTGGGAGAGGT,10,493124
araBp,1.2105263157894737,40,18,CGCCGATGCAGGTAAGACAA,22,486857
araBp,1.368421052631579,43,18,CGACAGGTCTGCATGATTGC,25,494524
araBp,1.5789473684210527,47,18,CCTTGGAATCATTATTCAGA,29,487600
araBp,1.1578947368421053,39,18,CCGTCGCAAATGGGGGTCAC,21,502142
araBp,0.6842105263157895,30,18,CCGGCTGCGGCTCGCCAATA,12,516417
araBp,1.894736842105263,53,18,CCGCCAGGGTGGGACTAGAG,35,498021
araBp,1.105263157894737,38,18,CCGAGTAAGACGGTTATCGC,20,480257
araBp,1.4210526315789473,44,18,CCCGTAGGCAAATGCGAGGA,26,493222
araBp,1.4210526315789473,44,18,CCATCCAGAGCTACTTCGGT,26,509569
araBp,1.631578947368421,48,18,CAGGAAGTTCCATTAACCAA,30,513638
araBp,0.6842105263157895,30,18,CACCACGTTATGTCTTTATT,12,485789
araBp,0.6842105263157895,30,18,CAAAATGGAGGCATAGCTCG,12,504167
araBp,1.7894736842105263,51,18,ATTTAATGTCTAGGCGGGGA,33,501130
araBp,0.8421052631578947,33,18,ATTGTGCGTAATACTTGGCA,15,467905
araBp,1.0,36,18,ATTGGCGGTCAGGTGAGGAC,18,470708
araBp,0.10526315789473684,19,18,ATTAATATCCCCTCGTTGTT,1,503864
araBp,1.368421052631579,43,18,ATGTTGCGTGTGACAGATCT,25,507168
araBp,0.7368421052631579,31,18,ATGCAACGCGGTAGGATACA,13,470684
araBp,2.0526315789473686,56,18,AGTCTCCGGACACGCTATAA,38,501260
araBp,1.736842105263158,50,18,AGTACTGCCATTCGCGGTGG,32,509230
araBp,1.6842105263157894,49,18,AGTAAGAAGCTGCAAAGAAA,31,503492
araBp,1.0,36,18,AGGGGCTCAACGCTCTCATG,18,490378
araBp,1.5263157894736843,46,18,AGGACCCGGCTGTCGCGTCA,28,483075
araBp,1.4210526315789473,44,18,AGCTTAGTGTGACACAGCAT,26,500216
araBp,0.7368421052631579,31,18,AGCTCTGACTGGGTCAAGCA,13,496400
araBp,0.7368421052631579,31,18,AGCCACGCCGAGCACCTGGC,13,476105
araBp,0.7368421052631579,31,18,AGACTCGCCGGTATATTGTT,13,497774
araBp,2.8421052631578947,71,18,AGAAGGACTGTGCTCACCAG,53,520895
araBp,1.5263157894736843,46,18,ACTCTAAAGAGCATTTCCGA,28,491281
araBp,2.473684210526316,64,18,ACGCGTGATTGCAGGGTGCT,46,486006
araBp,1.368421052631579,43,18,ACGAGGTCTTACTCTTCTAT,25,521561
araBp,1.368421052631579,43,18,ACCTGGGGTCCGTCTTCTTC,25,468235
araBp,1.105263157894737,38,18,ACCTATAAACCCGGATCTGC,20,512701
araBp,1.736842105263158,50,18,ACCCTTGGGCACCTTAGGTA,32,478376
araBp,2.263157894736842,60,18,ACATGTACCATTCAACTCCG,42,516469
araBp,1.2105263157894737,40,18,ACAGGTTAAGTCAGCATACC,22,488191
araBp,0.6842105263157895,30,18,ACAACAAATGCAAAGACGTT,12,484460
araBp,1.4210526315789473,44,18,AATCAGTTCAGGCTGTCCTG,26,512373
araBp,0.3157894736842105,23,18,AATATCACGATGAGCGGAGG,5,470505
araBp,0.10526315789473684,19,18,AAACGCACTGCAAACATAGT,1,475036
araBp,0.8888888888888888,32,17,TTTGTGCTCGTAGTTATTCT,15,480851
araBp,1.3333333333333333,40,17,TTCGCCAAAGCCGCGGTCAA,23,468741
araBp,0.9444444444444444,33,17,TTAGGGCGCGTAATTGTAGG,16,511089
araBp,1.3333333333333333,40,17,TGCTGAAGAGCGACTGATAT,23,516883
araBp,3.3333333333333335,76,17,TGCCTGCCTATGAAATTATT,59,511303
araBp,0.1111111111111111,18,17,TGCAGTATCAGAATGAGGAT,1,470552
araBp,1.6111111111111112,45,17,TGCAACTATAATCACTATGT,28,508854
araBp,0.9444444444444444,33,17,TGAGTACGAATTAAAACGCA,16,492888
araBp,0.8888888888888888,32,17,TCTTGGTCCGAGTAGTGATC,15,516317
araBp,0.8333333333333334,31,17,TCTGTACAGCCTGAACACCG,14,468917
araBp,1.5,43,17,TCTGGCTGTCAGTTTCTAGC,26,492150
araBp,2.5,61,17,TCTACTTCTCGCTTCGAGAT,44,492375
araBp,2.2777777777777777,57,17,TCGGGAGGGGTGGCGGGCTT,40,469567
araBp,2.2777777777777777,57,17,TCCCGATCTTATGTCTCAAG,40,476988
araBp,3.3333333333333335,76,17,TCCCCGGCGTGCCGTCAGTT,59,473996
araBp,1.1111111111111112,36,17,TCCAGCGGACACTCAGTAAA,19,517213
araBp,0.1111111111111111,18,17,TATCACATTAAAGATAAGCG,1,521190
araBp,1.4444444444444444,42,17,TAGGATTTCAAGTTCCCTGA,25,470459
araBp,4.055555555555555,89,17,TACCGCGGCACTACGCTGCG,72,514549
araBp,1.7777777777777777,48,17,GTTTGTTTCGAGCTCAAACG,31,474363
araBp,1.8333333333333333,49,17,GTTCGTGGTATACGCCGCAG,32,477449
araBp,2.388888888888889,59,17,GTGTGGTTGATCAAAATCTC,42,499586
araBp,1.1111111111111112,36,17,GTGTATACCGGCCATGCGCT,19,508889
araBp,1.3333333333333333,40,17,GTGGGGCGAATGTATAGGCA,23,486250
araBp,0.9444444444444444,33,17,GTAACAATCTGATCGGTTGT,16,506996
araBp,1.3333333333333333,40,17,GGTTGTCCCCGCTAGCTGTT,23,506030
araBp,0.8888888888888888,32,17,GGGCCGGATGCGGCCACCAG,15,480395
araBp,1.5,43,17,GGGATTTCATGTGTGCGGAC,26,485902
araBp,2.2777777777777777,57,17,GGCCAGCCTGTGTGGGAAAG,40,474131
araBp,1.3888888888888888,41,17,GGATTTAGGATTCGGTATAA,24,503055
araBp,0.9444444444444444,33,17,GGATACGCGACCCCTGCCTC,16,486245
araBp,1.1111111111111112,36,17,GGAGCATCTCCGCCCAATAT,19,511482
araBp,0.1111111111111111,18,17,GCTGCGTCTAACCTTGGCAT,1,480279
araBp,1.3888888888888888,41,17,GCGTCTGAAGTGTAGCATAT,24,486863
araBp,0.9444444444444444,33,17,GCGGTACACTAAGGTTGGAT,16,510544
araBp,1.2777777777777777,39,17,GCATTCAGTGTCCCTTAATC,22,471022
araBp,0.7222222222222222,29,17,GCACTTCCGGATATTAGCGG,12,491886
araBp,1.8333333333333333,49,17,GCACGTTCCAGACTTCGGCC,32,472887
araBp,1.5,43,17,GATTTATGTTTTTTCGCTTC,26,479754
araBp,1.3333333333333333,40,17,GATCCTCGGCTACACGTCCC,23,467975
araBp,1.0555555555555556,35,17,GAGGAATCTCGAACCTTGAA,18,504108
araBp,1.1111111111111112,36,17,GAGCTTTATATGCTAGACTG,19,470858
araBp,6.777777777777778,138,17,GAGATTCCCGTAACGGCGAA,121,479872
araBp,1.2222222222222223,38,17,GAGAGGCTCCAAAGTAGGTA,21,470045
araBp,1.6111111111111112,45,17,GAAAGCTTTACATTGACAGT,28,504223
araBp,1.5,43,17,GAAACCTGCGACCCCCGTAA,26,497694
araBp,0.1111111111111111,18,17,CTTTATTCATTCCGAGCCAG,1,491999
araBp,1.2222222222222223,38,17,CTTGGTTGAAGTCAAGCCGT,21,517669
araBp,1.0,34,17,CTTCATCCGTACCCGGCAAT,17,514163
araBp,1.2222222222222223,38,17,CTCATTTCTACCAGTCTTGT,21,490652
araBp,0.8888888888888888,32,17,CTAGGGCATCCTCGCCCATA,15,515085
araBp,1.1111111111111112,36,17,CGTCGACTATCGATGGACCT,19,522058
araBp,1.6111111111111112,45,17,CGCCTTACCTGTCGGCAGAC,28,507772
araBp,1.1666666666666667,37,17,CGCACCATACCACGGCTCCG,20,516977
araBp,1.1666666666666667,37,17,CGCAAGGTGGGGGGATAATG,20,513486
araBp,1.1666666666666667,37,17,CGAATGCCCCGAGACAATAT,20,507702
araBp,1.4444444444444444,42,17,CCTACAGATCAAACAGGGGA,25,490929
araBp,0.1111111111111111,18,17,CCGTACGCCGGGGCACACGA,1,480213
araBp,3.111111111111111,72,17,CCGAGCGAAAAAGAGATATT,55,522850
araBp,2.0,52,17,CCCGGACGATTTGATCGAAC,35,474506
araBp,1.3333333333333333,40,17,CCCGAGAGAGTCGCATCTGC,23,500135
araBp,1.1111111111111112,36,17,CCAACGACCAACCGCGATGT,19,476511
araBp,1.6111111111111112,45,17,CATTTTACCGCCCGTTTAGA,28,485765
araBp,0.7777777777777778,30,17,CATGGGCATCCGTTTCAGCG,13,523083
araBp,0.8888888888888888,32,17,CAGGGGCAGGAGGGACAAGG,15,522263
araBp,0.9444444444444444,33,17,CAGATATATTGATGCTTGTT,16,520140
araBp,0.3888888888888889,23,17,CAGAGATGCTGCTTCGGCTC,6,499160
araBp,1.5,43,17,CACCGTTCATTATGAAAGAC,26,468305
araBp,2.7777777777777777,66,17,CACCAATCGCCCAGTCGTGA,49,510434
araBp,1.8333333333333333,49,17,CACAGTTCAGGAATCCGATC,32,468375
araBp,0.1111111111111111,18,17,CAATTGTGCACTGTTACATC,1,470906
araBp,2.111111111111111,54,17,CAACCAGCAGTCAACCGGCA,37,480370
araBp,3.111111111111111,72,17,CAAAAGCTGACGACTTACCT,55,488642
araBp,1.0555555555555556,35,17,ATGCTGCGATACGCGTAGAC,18,493634
araBp,0.6111111111111112,27,17,ATCTTTTAGGCTTTTCAGGC,10,481780
araBp,0.1111111111111111,18,17,ATCTCTTAGAGTATTGATAC,1,470230
araBp,1.3333333333333333,40,17,ATCGGTACTTCGTAGCTCGT,23,524379
araBp,3.111111111111111,72,17,ATCATGGGCGTGTCCTGCAG,55,500105
araBp,1.3333333333333333,40,17,ATATGGCAGGGATAAACGGT,23,514160
araBp,1.7222222222222223,47,17,ATATCTGCTTCTCGAATCAG,30,475709
araBp,1.1111111111111112,36,17,ATATAAGGCAGGTCAGCCCT,19,479978
araBp,1.1666666666666667,37,17,AGTTGTAGGTAGCAGTGGGG,20,469711
araBp,1.8333333333333333,49,17,AGTTCCTAGCATGGGCTCGT,32,519063
araBp,1.2777777777777777,39,17,AGTAAGGGCCTGACGGTCTA,22,506740
araBp,0.2222222222222222,20,17,ACTTACAGGGCGGCGCACCA,3,490255
araBp,1.0,34,17,ACTCCGTGCCGATAGCAACG,17,483801
araBp,1.9444444444444444,51,17,ACGTTCGGTACCTGAGATGT,34,515094
araBp,2.2222222222222223,56,17,ACCGCGGAGATGACGTCTCA,39,470098
araBp,1.3333333333333333,40,17,ACCATACCTGTAGAACGCTT,23,507692
araBp,1.1111111111111112,36,17,ACATCGTACAGGTTTCTGGA,19,483611
araBp,2.3333333333333335,58,17,ACAAAACACGGGATGGGATC,41,477512
araBp,2.3333333333333335,58,17,AATTCACCCTAACAGCCGTA,41,504109
araBp,1.5555555555555556,44,17,AATGCCGAACAGTAATAGAA,27,503241
araBp,0.1111111111111111,18,17,AATGATATGAACCACGCGTC,1,479086
araBp,0.5,25,17,AATCTTTCTTATTCGGCGCG,8,488313
araBp,1.1111111111111112,36,17,AATAGTCTCGGTCATGTACT,19,491997
araBp,0.2777777777777778,21,17,AAGCCTTTTAGGCAGTCGAA,4,471375
araBp,0.1111111111111111,18,17,AAGCCAGCTCCCATAACTTA,1,503022
araBp,0.1111111111111111,18,17,AACCGCGCATTCTGCGCGCG,1,506869
araBp,0.8888888888888888,32,17,AACAGGGGATTAGTTCTAAC,15,498140
araBp,1.2777777777777777,39,17,AAATTATTCCGGCAAGTGTA,22,469491
araBp,1.6111111111111112,45,17,AAAGTAACACACGGTCCGTG,28,499282
araBp,3.1176470588235294,68,16,TTCACGATTCACACAGTTAG,52,473526
araBp,7.588235294117647,144,16,TTACGACAGCTAGCCCTCAG,128,503481
araBp,3.0588235294117645,67,16,TGTTCAGACAGCTGCACTTC,51,479349
araBp,1.2352941176470589,36,16,TGTAGGCGATTCTCCGGGTG,20,517019
araBp,1.0588235294117647,33,16,TGGTTTCGCAGTCATGCGAT,17,490435
araBp,1.2352941176470589,36,16,TGGTCCGGACAGCACCACTG,20,510333
araBp,1.1176470588235294,34,16,TGGCCTAGTGAGCATCTTCC,18,516852
araBp,3.0588235294117645,67,16,TGCTAAGGCCAAATCCCGTG,51,492435
araBp,2.5294117647058822,58,16,TCTAGGGACCCATGACCCGT,42,480209
araBp,1.2941176470588236,37,16,TCTACGATGTAGCAAAAGTC,21,515110
araBp,2.0,49,16,TCCCACGGCACACATACAAT,33,484496
araBp,1.0588235294117647,33,16,TATTAACCTTGAAGCGAATT,17,500562
araBp,2.0,49,16,TATCCGGCTGTTTTTCCAGA,33,501835
araBp,1.1764705882352942,35,16,TAGCCACAAGCCCTAACTCT,19,495356
araBp,1.7647058823529411,45,16,TACGCGTTTAAGCGGAGTCA,29,500045
araBp,0.8823529411764706,30,16,TACCCATGCCCGTTGGTAAC,14,474770
araBp,1.6470588235294117,43,16,TACAGTAGTTATCTTGGGCA,27,469009
araBp,1.3529411764705883,38,16,TAATGCGGTCTTTATAGGAA,22,510225
araBp,2.823529411764706,63,16,TAACGTGGGTCATCGCGAGT,47,490849
araBp,3.0588235294117645,67,16,TAACGTAACGTGTTACATAA,51,511170
araBp,0.5294117647058824,24,16,GTTTTGGCTGCCCGGCGTTA,8,491468
araBp,1.1176470588235294,34,16,GTTCCGCGCCATACCGAGAA,18,467775
araBp,0.9411764705882353,31,16,GTGGGGATACGGCTCCGTCA,15,470506
araBp,1.1176470588235294,34,16,GTGATAAGTACGATACCTAT,18,512409
araBp,1.1764705882352942,35,16,GTCTCATTCACCTACGCTAT,19,508362
araBp,1.1764705882352942,35,16,GTCCAGGCTCGGGTTTCTTA,19,479824
araBp,1.0588235294117647,33,16,GTACGTTTGCAGCGACCGCA,17,519563
araBp,0.35294117647058826,21,16,GGTTTCCTTCCTATTAACGT,5,467887
araBp,1.411764705882353,39,16,GGTATGCAGTCTGTGCGTCT,23,492280
araBp,0.7058823529411765,27,16,GGCTTCGTCGAAAATGCCAT,11,472065
araBp,1.8235294117647058,46,16,GGCCGCAGGATGGACATGCG,30,477233
araBp,1.0588235294117647,33,16,GGCACCTGAGTCCTCGAACG,17,520471
araBp,1.2941176470588236,37,16,GGATTGAAGGATATGTGCGA,21,511289
araBp,0.29411764705882354,20,16,GGACGGACCCGAGTACGTAG,4,469040
araBp,0.5294117647058824,24,16,GCTTTGTGTGCGATTGCGCA,8,496960
araBp,1.4705882352941178,40,16,GCTCTTAGGTGGCCGTTGTA,24,475732
araBp,2.823529411764706,63,16,GCCGATGAGGCACTACATTT,47,514165
araBp,1.0588235294117647,33,16,GCCCTCAGCCACAATCTACT,17,468431
araBp,1.8235294117647058,46,16,GATTAGTAATGATATAAGTC,30,518974
araBp,0.7058823529411765,27,16,GATGGACCTGAACCAAATGA,11,476860
araBp,1.588235294117647,42,16,GATGAAGCGAGACCAATGTA,26,497591
araBp,1.1176470588235294,34,16,GATCCTTCGTGCCAACGCCG,18,495405
araBp,0.35294117647058826,21,16,GAGACTTTGGTACGTCAATA,5,511940
araBp,0.4117647058823529,22,16,GACTTCCTCTTAGAGAGTTA,6,524356
araBp,0.4117647058823529,22,16,GACATTCAACTGGCCAAGCG,6,511734
araBp,1.2352941176470589,36,16,GAATTTTTTGGAATGACCAA,20,474777
araBp,0.11764705882352941,17,16,GAAGAGCCCTATCCGGATCT,1,521483
araBp,4.882352941176471,98,16,CTTGGTGTTCGCCCGTACCC,82,511104
araBp,0.8823529411764706,30,16,CTTCGCCCCGCTTTCTAAGT,14,519214
araBp,1.4705882352941178,40,16,CTTCGACACATTAGGTGCCT,24,525311
araBp,1.0,32,16,CTGTAAGATCAACGAAGTAA,16,494193
araBp,1.6470588235294117,43,16,CTGGCAGGAAAAAGCAGGCT,27,511332
araBp,3.0588235294117645,67,16,CTCAAACTGTCGGCGGTGGT,51,503677
araBp,0.5882352941176471,25,16,CTACGAGGTATTTTGCCGTT,9,506019
araBp,0.11764705882352941,17,16,CGTGTTAAGTGCATGGGAGT,1,482936
araBp,2.4705882352941178,57,16,CGCGGCTTCATCCGGCCATG,41,502728
araBp,2.2941176470588234,54,16,CGCGCCGCGGCACACAACCT,38,522829
araBp,1.0,32,16,CGCGATGGAGCTTCCCATGC,16,472905
araBp,1.0,32,16,CGCCCTGCGACGTACCCGTC,16,490932
araBp,0.5882352941176471,25,16,CCTAGGGTACAAGGTCAGAA,9,494492
araBp,3.588235294117647,76,16,CCGGTTCCCTTCCGGTTTAG,60,482417
araBp,0.11764705882352941,17,16,CCGGGCGGTACGCTGGCTTC,1,497527
araBp,1.0588235294117647,33,16,CCGCGCAAGGACCGAGTTAT,17,476220
araBp,2.411764705882353,56,16,CCCTGTTCGGCCGAGATCAA,40,481139
araBp,0.11764705882352941,17,16,CCCATCAGCATTACTTCCAT,1,512466
araBp,1.1764705882352942,35,16,CCAATGCTAATGGTTCTCCA,19,495964
araBp,1.2941176470588236,37,16,CACAGTTTCTTTACCCGAGC,21,508591
araBp,3.8823529411764706,81,16,CACAGGGTGTACGGACGCCC,65,497175
araBp,1.1764705882352942,35,16,ATTTGTTATAATGGGATCGG,19,498469
araBp,2.411764705882353,56,16,ATTGTTGAGATAATTTTTTA,40,522433
araBp,4.0,83,16,ATTCCGCAGCGACGGTTTGT,67,471964
araBp,2.823529411764706,63,16,ATGTAGGTGAACGCGGACAT,47,480924
araBp,3.176470588235294,69,16,ATGTACGACCTTGCTAATAG,53,521268
araBp,3.588235294117647,76,16,ATCGAAAGCTGTTTTCGCCT,60,511529
araBp,1.411764705882353,39,16,ATCAGTCCCTTCGTGGTAAT,23,499118
araBp,1.5294117647058822,41,16,ATCACCTTTGAGAGCCCCGA,25,509007
araBp,0.7058823529411765,27,16,ATATGCTCGGTTCGTTAATA,11,492631
araBp,1.4705882352941178,40,16,ATAATTGTTCAACGTCCAAT,24,476920
araBp,0.8235294117647058,29,16,ATAAACCGGGAGCAATCACT,13,502760
araBp,1.0588235294117647,33,16,AGTTCGTCATGTCCGACATG,17,524672
araBp,0.11764705882352941,17,16,AGCGCTGCTGTGTTAGTGTG,1,519180
araBp,0.8235294117647058,29,16,AGCCACAGGTCCTTGGGTTC,13,491388
araBp,2.8823529411764706,64,16,AGATTCTCTCGGCCTGTATG,48,494146
araBp,1.2352941176470589,36,16,ACTGTGAGGGTACGTTCGTT,20,522657
araBp,1.4705882352941178,40,16,ACTCGTAATCTTCGGGCTAG,24,518245
araBp,4.0,83,16,ACTCACAAATACAGCCTAGG,67,471672
araBp,1.411764705882353,39,16,ACTAAGATTAGAGACGGCAT,23,488994
araBp,2.235294117647059,53,16,ACGCTCCACCATTAGGCTTA,37,485219
araBp,2.7058823529411766,61,16,ACGCTATAGGGCAAAGGTCG,45,516780
araBp,0.9411764705882353,31,16,ACCTCGAAGAGAAAGATGGA,15,483822
araBp,2.1176470588235294,51,16,ACAGTTCGGTGAGGCGTCGG,35,493098
araBp,5.705882352941177,112,16,AATCGAACTTCTCGGAGGTG,96,517860
araBp,0.125,16,15,TTTTTGGACCTCCCAGCGGT,1,507032
araBp,2.9375,61,15,TTGGGTTATACTTAGGGGAT,46,519923
araBp,1.9375,45,15,TTCACACCTTTCCGCAAAAG,30,499220
araBp,1.0,30,15,TTATGTAAGAACCGTGTTGT,15,492316
araBp,0.125,16,15,TTATCGACACGGGTCCCTAT,1,519106
araBp,0.125,16,15,TGTTGCCTTCATGGTATGAG,1,493896
araBp,4.1875,81,15,TGCTGCATGGGGCTAACTGA,66,479393
araBp,1.625,40,15,TGCATGTCCTGGCGGGAAGT,25,522268
araBp,0.125,16,15,TGCACTTAACTTAACACAAT,1,492859
araBp,1.25,34,15,TGATTCTCTCTTCCCACATT,19,500324
araBp,1.8125,43,15,TGATGGGCTAATTAAATTGG,28,482612
araBp,0.125,16,15,TGACACGTTCGGCCCCGAGC,1,487803
araBp,1.3125,35,15,TGAACACCAAAGGGCGCGTA,20,498553
araBp,0.8125,27,15,TCTTCTCGCACCACCTGGAG,12,492832
araBp,1.25,34,15,TCTCAGGTTTTTTCTAACCT,19,475010
araBp,3.125,64,15,TCGAACGTTATATATCACAT,49,523056
araBp,0.9375,29,15,TCCAGATCCACGGCGCATGA,14,476779
araBp,1.25,34,15,TCAGGCCTTCGACCTCCCCG,19,489671
araBp,1.5,38,15,TCACATCGGCCCCGAACAGT,23,508593
araBp,0.9375,29,15,TATCCACGTAGCGGTAGGGA,14,488320
araBp,1.875,44,15,TAAAGTGACGTTCAGATTAG,29,479228
araBp,1.3125,35,15,TAAAGGATACGTAGATCAAC,20,486315
araBp,1.625,40,15,GTTTCGTATATAGGGCTACT,25,515995
araBp,1.875,44,15,GTTCGGCAGGATTTTAGAGC,29,477580
araBp,0.125,16,15,GTGGTCAGTTAAAGACCTCT,1,500689
araBp,0.125,16,15,GTGATACGGACAGATAGTGC,1,489793
araBp,1.9375,45,15,GTCTATCAGCGGAAGTCACA,30,502402
araBp,2.8125,59,15,GTCATGGTTTCGCCTGCTTG,44,508757
araBp,3.625,72,15,GTATACGTTTTACGCAGATA,57,479519
araBp,0.9375,29,15,GTAAGAGATATGGGATCTTT,14,473408
araBp,1.1875,33,15,GGGATTCATCTAATCAGATG,18,489357
araBp,0.125,16,15,GGCAAAGTGTTCGGTGAGTC,1,504125
araBp,0.125,16,15,GGAGTAAAAACACCGCAGAC,1,520630
araBp,2.5625,55,15,GCTTTCCTTCCTATTAACGT,40,467852
araBp,0.1875,17,15,GCTGTGCAGTATCACAATAG,2,495768
araBp,0.4375,21,15,GCTGGTATGAGGTAATGCAA,6,484486
araBp,2.125,48,15,GCTGGGAGGGGCCGTCATTG,33,521823
araBp,4.375,84,15,GCGTCCAAGGGGGCTGGCGA,69,471270
araBp,0.1875,17,15,GCGCGTTTCAGTCGCTCCCA,2,508430
araBp,1.4375,37,15,GCACACTGTGGGTGGATCTG,22,485553
araBp,1.9375,45,15,GATTCTTGTCGGTGCTCAGT,30,502653
araBp,1.4375,37,15,GAGCTCGGTCTGACCCAAAA,22,490971
araBp,0.125,16,15,GACTGATGCATAACAGTGGG,1,477230
araBp,2.0,46,15,GACGTGTCCTATCGGGTCGT,31,494089
araBp,1.0,30,15,GAACCACGAAGCGTATGGGG,15,502191
araBp,2.8125,59,15,GAAAGCGCGTCTGATGGTTT,44,514754
araBp,0.625,24,15,CTTTGCGTACCATGAGGGGT,9,521598
araBp,0.625,24,15,CTTCACATTTCACTCTTTGC,9,483900
araBp,3.0625,63,15,CTGGGCGGATAAATGCACCA,48,512496
araBp,0.125,16,15,CTAAAAGCTTGGAATCTTGT,1,508071
araBp,3.0625,63,15,CGTTTACTGGACTGCATACG,48,495724
araBp,1.4375,37,15,CGGGCTTGATAATGGTTTGA,22,492630
araBp,1.25,34,15,CGATTTATGAGCTTTACGGA,19,498367
araBp,1.625,40,15,CGAGAGACTCTATCCGGGTG,25,475336
araBp,1.75,42,15,CGACCAGGGCACGGCGTCTT,27,517357
araBp,0.9375,29,15,CCTTACTGGAATCAGTCTGA,14,490339
araBp,5.0625,95,15,CCGTGAACAACTAGCAGTTT,80,487408
araBp,0.625,24,15,CCGTACCTTGACGGGATACA,9,517428
araBp,2.25,50,15,CCACTAAGAACCGCTATAAG,35,523125
araBp,1.1875,33,15,CCAATCTACATACAAGTGTT,18,503386
araBp,2.625,56,15,CCAATAGGGTTTGATCAGTG,41,468426
araBp,0.875,28,15,CATTAGCCAGCCGAGATCAT,13,516431
araBp,2.875,60,15,CAGCAAGGGCACTTAGGCCT,45,478510
araBp,2.8125,59,15,CAGAATCATATATCCTCTGC,44,492961
araBp,1.375,36,15,ATTTGTGCTTCTTTTCGCCA,21,492491
araBp,0.125,16,15,ATGGATTTCCGAGACCCATC,1,468684
araBp,1.4375,37,15,ATATGCGTCATGTATTGTTC,22,474680
araBp,1.5,38,15,AGTTGATGATGCGGCAGCCC,23,484586
araBp,0.125,16,15,AGTTCCCCGTGTTCTTATGA,1,510558
araBp,1.25,34,15,AGTAGCACATGGGGGGCAGA,19,486725
araBp,0.625,24,15,AGGGAGATCAAGTGTCGTTT,9,506210
araBp,5.5,102,15,AGGATATCGCAGTAACCATA,87,496762
araBp,1.8125,43,15,AGCAATGTAATTAGATGGGT,28,491465
araBp,0.125,16,15,AGATCCTGCACTTGAGGGTA,1,488573
araBp,0.125,16,15,ACTTTACCGCACGATATTGT,1,492983
araBp,4.0625,79,15,ACTGCGAGGTAAGTGAGTAG,64,472114
araBp,1.1875,33,15,ACGCATTACTGCAGGAGCAG,18,489356
araBp,1.3125,35,15,ACGAAAGGTCACCAGCGCAA,20,488525
araBp,1.4375,37,15,ACACTCCAACGGTTGACGGG,22,487931
araBp,1.625,40,15,AATGCTCACCGGCTCGGTCT,25,475702
araBp,0.125,16,15,AAGAGCACGATCCCAGAGGC,1,495902
araBp,1.3125,35,15,AACTTCTCCCTGATTAGCGT,20,498045
araBp,4.375,84,15,AACTGGAAGCTTTTCTCGTT,69,509842
araBp,0.25,18,15,AAATTAACAGCGCAATAAAG,3,489800
araBp,3.3125,67,15,AAAACTACAGCCTTAGCGGA,52,514824
araBp,3.4,64,14,TTTTCCGGGGAGGTATGGCC,50,484654
araBp,1.7333333333333334,39,14,TTTGAAAAGGACATTCCACG,25,513399
araBp,2.533333333333333,51,14,TTCCACTTGATTGCGCTCGA,37,489191
araBp,2.6,52,14,TGTGCGTTCAGCCGGAACGT,38,522944
araBp,0.9333333333333333,27,14,TGTCCCCGATGCGGGTAATA,13,511084
araBp,1.3333333333333333,33,14,TGTACTATGTTAAGCAAAAC,19,486728
araBp,1.6666666666666667,38,14,TGGATATCAGACGCTCGCAA,24,495718
araBp,3.1333333333333333,60,14,TGGACTCCATGGCTCGATGC,46,477785
araBp,1.4666666666666666,35,14,TGCTAAATTGTCCTCTCGGG,21,517952
araBp,1.2666666666666666,32,14,TGCCAGGGTTATAGTATCGC,18,470963
araBp,0.9333333333333333,27,14,TGAGTTCGTGGGACTAGATC,13,501089
araBp,2.2666666666666666,47,14,TGAGAATGGACGATTTCGTG,33,525225
araBp,2.1333333333333333,45,14,TGACGACCGTGTATATGGAT,31,500748
araBp,1.5333333333333334,36,14,TGAACTGCGGCGTACTCCTC,22,473161
araBp,3.6,67,14,TCTAATAGCATATATTTTAG,53,513083
araBp,1.1333333333333333,30,14,TCGGGGAGATATGTCGCGCA,16,487802
araBp,4.0,73,14,TCCTACGCTGGGCACCACTG,59,480400
araBp,1.0666666666666667,29,14,TCCCATCCCTGGGAATTCGA,15,477716
araBp,1.6,37,14,TCCCAGTTCAAAAGACCATA,23,479350
araBp,3.066666666666667,59,14,TCCATGTCGCCGGTTTCGGT,45,474484
araBp,2.066666666666667,44,14,TCCAACGATACTTTTGCCAA,30,522477
araBp,3.2666666666666666,62,14,TCAGTGTGAATCGTTGACCC,48,482027
araBp,0.13333333333333333,15,14,TATTAATTTTCCACAGTTCG,1,469923
araBp,1.6666666666666667,38,14,TAGGTTCGAGAGCTGCGAAA,24,495571
araBp,3.933333333333333,72,14,TAGGGGGCAATTCCCAAGTC,58,510018
araBp,1.4666666666666666,35,14,TAGAAATGTTGTCAAAAGGA,21,512018
araBp,3.1333333333333333,60,14,TACCATTGTTCTTCTATCAG,46,484772
araBp,1.2,31,14,GTTCATTGATGACTCCCGGG,17,470143
araBp,1.6666666666666667,38,14,GTTATACCTCCTGGGGTCAT,24,477919
araBp,1.7333333333333334,39,14,GTTAGTCCTATCTAGTCCTC,25,476824
araBp,2.933333333333333,57,14,GTGTGATTCCGGCCTGGCAT,43,494534
araBp,2.066666666666667,44,14,GTGACGTCGGCAGGGTTTGG,30,502825
araBp,1.3333333333333333,33,14,GTCTCAAGCAACATAACCTT,19,469423
araBp,0.13333333333333333,15,14,GTCCCGTAATACACGGTCGT,1,468095
araBp,2.8666666666666667,56,14,GTCATCGGGGTTGCGCTGGA,42,490170
araBp,1.0666666666666667,29,14,GGTCCCAAACACTTTGGGCG,15,471745
araBp,1.4666666666666666,35,14,GGTAGGCTTGAGGTCCCAGG,21,477576
araBp,1.4666666666666666,35,14,GGGGAAGCTGCTGGAGGCAT,21,484601
araBp,3.1333333333333333,60,14,GGGATTTTTATTAGATGTGT,46,520138
araBp,1.8,40,14,GGGATCTTCACTCGACAGCA,26,513714
araBp,0.13333333333333333,15,14,GGGACCGAAGTCGTAGGCCT,1,479413
araBp,2.466666666666667,50,14,GGCTGATCCCTGGACGAGAG,36,508830
araBp,1.4,34,14,GGAGCGCAGGAATCCAAAGG,20,512716
araBp,3.2,61,14,GGAGAACCTCGCTCCAGGGA,47,480208
araBp,0.6,22,14,GGACGAGTGGGCCAGGTGAA,8,517296
araBp,3.1333333333333333,60,14,GCGCACCGCTCTACCGGAGT,46,511945
araBp,0.13333333333333333,15,14,GCGACTTTCCCCGTTGTGCG,1,507031
araBp,1.5333333333333334,36,14,GCATCTTTACCGCATGCTTG,22,507997
araBp,2.933333333333333,57,14,GCAGGACTGTAGACCGAGGC,43,494143
araBp,0.13333333333333333,15,14,GCAATGGGGTACTGTGTGAT,1,507616
araBp,0.9333333333333333,27,14,GCAAACAGCGCCAGGGAGGA,13,504176
araBp,0.13333333333333333,15,14,GATTGCCTATCGCACAGAGC,1,487406
araBp,2.2,46,14,GATTCTCGTAAGTCGTCAGT,32,470974
araBp,3.3333333333333335,63,14,GAGATCGTTCTGCAAAGGAC,49,515607
araBp,3.6,67,14,GACGCGCGAGGAGAGGCCGA,53,508833
araBp,2.466666666666667,50,14,GACCTAGGCTGGTGTTTCCT,36,525490
araBp,2.2,46,14,GAATCGACACCGCAGTTTTG,32,510919
araBp,2.466666666666667,50,14,CTTATAGTGCCTCACGAAAG,36,486778
araBp,1.3333333333333333,33,14,CTTATACAAACCGTCGCTTA,19,490350
araBp,4.8,85,14,CTCCTCAAGGGACAGATATG,71,518678
araBp,6.866666666666666,116,14,CTATCAGTGATTAATAGTCT,102,518354
araBp,0.13333333333333333,15,14,CTAGCTCTTCGCAACACAGG,1,495035
araBp,2.0,43,14,CTAGACGTATCGGAACAAGA,29,492300
araBp,2.8666666666666667,56,14,CTACAGGTGCCAAGTTCAAG,42,479993
araBp,0.13333333333333333,15,14,CGTTTTCGTCAGTCCCTGAT,1,496710
araBp,2.7333333333333334,54,14,CGTCAAAAAGTCGTCTCTAG,40,494311
araBp,1.4,34,14,CGTAATCACGATGGGTAGCG,20,504826
araBp,1.4,34,14,CGGCGTTGTGAAAAGGCGAA,20,481354
araBp,1.1333333333333333,30,14,CGGCGGCGGGTTTCGTGCCG,16,472045
araBp,1.4666666666666666,35,14,CGCGCGCCTCAGGCAGAACG,21,492157
araBp,2.933333333333333,57,14,CGCAATACGGAAATAACCCA,43,475578
araBp,1.0666666666666667,29,14,CGACGCATGATTGCTGCACG,15,520444
araBp,3.2,61,14,CCTCCCGGGCAGCACTGTCT,47,478986
araBp,0.13333333333333333,15,14,CCTAATTGGGTAGGCCCGGG,1,489303
araBp,2.8666666666666667,56,14,CCGTTTATAATTACGAATGC,42,506891
araBp,1.6666666666666667,38,14,CCGCAGTTTACTTTGTAAGA,24,516979
araBp,2.8,55,14,CCCTAAGTGTCGGGCGAGCC,41,475258
araBp,0.13333333333333333,15,14,CCCGACAAGCACTGCATTCA,1,498299
araBp,0.13333333333333333,15,14,CCCACTCCAGGCGAGGTCGA,1,470338
araBp,2.533333333333333,51,14,CCACATACTTCAAGAAAGCA,37,472602
araBp,0.13333333333333333,15,14,CCAAGATGTATAAATCCCTC,1,501837
araBp,2.2666666666666666,47,14,CATTAAAGAAAGCTCCTTTG,33,519875
araBp,0.26666666666666666,17,14,CAAAAAACCTTTAGTGTGCA,3,487975
araBp,0.13333333333333333,15,14,ATTGTGAGAGTTCCATAGTG,1,508809
araBp,0.8,25,14,ATCGTGTTAATTCCGTCCAA,11,480513
araBp,1.5333333333333334,36,14,ATCAGGTAATTACGCTGCAA,22,495024
araBp,1.4,34,14,ATCAGGGGTTTATTGCGCTT,20,524192
araBp,0.13333333333333333,15,14,ATCAAGAGGCGAATGTGTTT,1,468331
araBp,1.0666666666666667,29,14,ATAATATGGAGTCAGTATTA,15,477276
araBp,0.6,22,14,AGTAGTCCACATACAACGAT,8,509310
araBp,0.7333333333333333,24,14,AGGAGATACACTGCCACAAC,10,471185
araBp,1.0,28,14,AGCCTTAGACAGAGTTGCTC,14,510117
araBp,2.2666666666666666,47,14,ACTTGCCTCATACGCACCGA,33,509812
araBp,2.6666666666666665,53,14,ACTGGAGGATTCCGGGGGGA,39,519881
araBp,0.13333333333333333,15,14,ACGTCGATGATTTTCGGCGT,1,469819
araBp,1.7333333333333334,39,14,ACGCGGTCCAACACAGAGAA,25,469510
araBp,1.9333333333333333,42,14,ACGAGGCACCCAGGTCGTGT,28,504178
araBp,1.0,28,14,ACCTCACGGTGTCTGGTTAA,14,502022
araBp,1.2666666666666666,32,14,ACCCCTGAAAGTCGCTAAAA,18,515741
araBp,1.6666666666666667,38,14,ACCAGCCTAGAACCCAGTTC,24,480333
araBp,0.13333333333333333,15,14,ACATGCTCGAATGTCAAAAA,1,469856
araBp,1.5333333333333334,36,14,ACATACCATAGGATAATAGA,22,476172
araBp,0.13333333333333333,15,14,AAGGAAAGGGGCCAAGGTTG,1,489917
araBp,0.13333333333333333,15,14,AAGCTTTTCAGTGCATCGTG,1,469322
araBp,1.2666666666666666,32,14,AAGCTCTTTGTGACTCTCAA,18,488991
araBp,1.2,31,14,AAATGACAATTGCGGCCGCT,17,495997
araBp,1.0666666666666667,29,14,AAACATGGTTATGTATGCTT,15,492864
araBp,2.533333333333333,51,14,AAAATAGGATGCCTCGTAAA,37,480226
araBp,3.5714285714285716,62,13,TTTTCGTAGAACCGGACCGT,49,471786
araBp,2.142857142857143,42,13,TTGCTCACCCACGCCCCGCA,29,487143
araBp,0.2857142857142857,16,13,TTGCATTATTTATCGATAGT,3,468019
araBp,1.0714285714285714,27,13,TTGAATCTCTCGACCATACG,14,487679
araBp,3.7142857142857144,64,13,TTAGGGAAAAGGCCTCTCGC,51,491884
araBp,2.857142857142857,52,13,TTACCAGTTCTTTGTTTTCT,39,517392
araBp,1.5,33,13,TGTACATGGTTCGCCAGACA,20,469304
araBp,1.2142857142857142,29,13,TGTACACAGGTCTATCTAGA,16,502437
araBp,3.2142857142857144,57,13,TGGACCCGTACTAGACCGTG,44,513519
araBp,2.7857142857142856,51,13,TGCTGATTGATGCCCCTCGA,38,497201
araBp,1.5,33,13,TGCTAAGGGATGGTATCGAT,20,483719
araBp,1.7142857142857142,36,13,TGCCGAGCTAGGGCACCGGA,23,515048
araBp,1.5714285714285714,34,13,TGATACCTGTCATGTCTCTC,21,523123
araBp,2.0714285714285716,41,13,TCTCAAGGGTCAAAATGGCA,28,489910
araBp,4.928571428571429,81,13,TCGAATTACGAGACTGCTCT,68,517888
araBp,1.3571428571428572,31,13,TCCATTCAAGAAAGCTGCTA,18,509018
araBp,1.8571428571428572,38,13,TCAGTATGGGTTGCACCGGT,25,515191
araBp,1.2857142857142858,30,13,TCACTTCCATCCGTGAGCTT,17,492099
araBp,2.0714285714285716,41,13,TCACTGTATGGATGTCTTCT,28,506994
araBp,1.5,33,13,TATTATGAGATAGGTCCGGC,20,518041
araBp,1.9285714285714286,39,13,TATCTTCGCATGCCGTGAGA,26,509641
araBp,2.7857142857142856,51,13,TATCAAGCAGAAGGTAAGCA,38,470452
araBp,0.14285714285714285,14,13,TAGACAGCCAAGAATGCTAC,1,522215
araBp,1.0714285714285714,27,13,TACTCAAATCCAGGGCCTTG,14,486243
araBp,0.14285714285714285,14,13,TACCCACTGTGTGCTACGCG,1,519080
araBp,3.2857142857142856,58,13,TACCAATAGTACATATCCAA,45,509844
araBp,2.0,40,13,TACATGGTGTACCTCAGGGT,27,496052
araBp,4.357142857142857,73,13,TAATGACTTGTTTTGCACAT,60,501213
araBp,1.2857142857142858,30,13,TAATAACGCAGTCTATAAAT,17,519798
araBp,1.2857142857142858,30,13,TAAGGTATGAGACTGATCGT,17,490837
araBp,1.5,33,13,TAAGGTAGACGCAGCTTCAA,20,509527
araBp,0.14285714285714285,14,13,GTTGATGTCTTTATAGTAGA,1,496450
araBp,2.0,40,13,GTTCCGGTTGAGGTATGCGT,27,469578
araBp,3.857142857142857,66,13,GTGAATTCCAGTGGTAAGAT,53,497276
araBp,0.9285714285714286,25,13,GTCTAGAACTTAGTGCGAGG,12,472551
araBp,2.2142857142857144,43,13,GTCCAGGCAAAAGTCGGGGG,30,506826
araBp,2.357142857142857,45,13,GTCAGGTGCGCCTGGGCTAC,32,485662
araBp,0.14285714285714285,14,13,GTCAGGCATTCGGCATGACA,1,489209
araBp,0.14285714285714285,14,13,GTATATGGTTGAATTGGGGT,1,480062
araBp,0.14285714285714285,14,13,GTATAGTAGCTATGCGTGTG,1,522125
araBp,1.1428571428571428,28,13,GTAGCAAGTGACAATATGTA,15,525241
araBp,1.3571428571428572,31,13,GTAGATAACTCGAAAGATAC,18,518764
araBp,0.14285714285714285,14,13,GTACATCATACGGTCTCCTT,1,503061
araBp,0.14285714285714285,14,13,GTAAAGCCATTCTGAGGATC,1,505030
araBp,0.14285714285714285,14,13,GGTGTGACGGCTGTCCGTAG,1,508702
araBp,1.3571428571428572,31,13,GGTCCGTGGTATGAGTTTCT,18,476718
araBp,1.1428571428571428,28,13,GGGCTATTGATCCATGCTCA,15,510054
araBp,1.7857142857142858,37,13,GGGAAATGCTCTTTTATGGC,24,497126
araBp,1.3571428571428572,31,13,GGCTTGCCGGGGTGCGGATG,18,493993
araBp,1.2857142857142858,30,13,GGACTTGAGCCGCCCCGAGT,17,469279
araBp,0.14285714285714285,14,13,GGAAGATGTACTGCTCTTGA,1,480472
araBp,1.7142857142857142,36,13,GCTCGAGGACACAGTGAAAT,23,503068
araBp,2.2857142857142856,44,13,GCTCCCGATCGAGTTGACGC,31,519802
araBp,4.071428571428571,69,13,GCGGCATGAGCTTGTATGTT,56,473626
araBp,2.0,40,13,GCCCAGGCCTGTTGCGGTTG,27,472960
araBp,2.0,40,13,GCAGCCCCGGCGATAAAAGG,27,499859
araBp,2.642857142857143,49,13,GCACGCAAAGGGACTAGGTT,36,519482
araBp,1.5,33,13,GCAAGCTGCCTGAATAACGC,20,503430
araBp,1.5714285714285714,34,13,GATCAAATTGCCAAGGGCCA,21,503866
araBp,1.5,33,13,GATATGTAACGATGCGTGTT,20,493718
araBp,1.7142857142857142,36,13,GATAGTATTAAGAGAGACAC,23,471752
araBp,2.4285714285714284,46,13,GAGTGCCTTACAGTCCAGAT,33,489257
araBp,3.7142857142857144,64,13,GAGGACGTGCAATCAAAAAA,51,511755
araBp,1.4285714285714286,32,13,GAGATCCCTGGGTTTGGTGT,19,490075
araBp,1.4285714285714286,32,13,GACTTGGAGCCATCTGGAGG,19,470010
araBp,1.0714285714285714,27,13,GACTCGGGATAACGACTGGA,14,491309
araBp,1.2857142857142858,30,13,GACGTGGATCGCGTCTAAGG,17,513033
araBp,1.7142857142857142,36,13,GACGTCAGGCTCTGATTAGG,23,508055
araBp,4.142857142857143,70,13,GACGCGTTCAAGCGCGGATG,57,492341
araBp,6.5,103,13,GACAATCGACGGATCGCCGC,90,479586
araBp,4.071428571428571,69,13,GAATAACTTAAACCGTTGGT,56,524384
araBp,1.5714285714285714,34,13,GAAAGTCATTCCGTGATTCA,21,489082
araBp,3.0714285714285716,55,13,CTTTTAGCGCTGTCTTTGCA,42,518626
araBp,2.9285714285714284,53,13,CTTGCCTCTTAGGACTCCAC,40,494954
araBp,0.14285714285714285,14,13,CTTGACTCACTAACACGAAC,1,478444
araBp,1.6428571428571428,35,13,CTGCGAAGTGACATACAATG,22,498300
araBp,0.5,19,13,CTGAGTCTAGGCGGCTAAGG,6,500103
araBp,3.642857142857143,63,13,CTCAGTTTTGTCCGACGGCA,50,474511
araBp,0.5,19,13,CTAGGCGGCGAAAATCATCC,6,482790
araBp,1.0,26,13,CTAAGCAACACTCACTCTAG,13,474826
araBp,2.9285714285714284,53,13,CGTCCACGCAGAGGTAGTAA,40,516613
araBp,2.7142857142857144,50,13,CGGTTCAAAGCAGGTATAAA,37,515328
araBp,1.7142857142857142,36,13,CGGTCTTCCAATATAGGCTG,23,502811
araBp,2.0714285714285716,41,13,CGATGGGGAAAATCTCACAT,28,496784
araBp,1.5714285714285714,34,13,CGACATACGTGCAAAAGAAC,21,497172
araBp,3.5714285714285716,62,13,CGACAGAGACCTACTCACGG,49,520548
araBp,2.642857142857143,49,13,CGAAGTCTGTGCATCTATCC,36,501533
araBp,0.14285714285714285,14,13,CCTTACGGAACTCTCGCCTG,1,485131
araBp,0.14285714285714285,14,13,CCGGAATCCCAGCAATAAAG,1,484055
araBp,0.14285714285714285,14,13,CCGAGGGATCAGCCCTAGGC,1,499465
araBp,0.14285714285714285,14,13,CCGAAAACGTGTCGCTTAAC,1,515458
araBp,0.14285714285714285,14,13,CCCTTCTATACAAGGCCGAT,1,509674
araBp,1.3571428571428572,31,13,CCCTGCCCGTTCACCTCTGA,18,474687
araBp,1.7142857142857142,36,13,CCCGATGTATGCGCATTTAT,23,470271
araBp,4.642857142857143,77,13,CCCGAGGCTGGGTCTAGCGA,64,519370
araBp,1.2857142857142858,30,13,CCAGACATTAGTAACAATGG,17,478965
araBp,1.0714285714285714,27,13,CATGACTGCATTCCAGCCTT,14,486729
araBp,4.642857142857143,77,13,CATCTATCCGAATGATTTTA,64,488619
araBp,1.5714285714285714,34,13,CATCGGATAGAGGCTGAACT,21,497854
araBp,1.5,33,13,CACTGCTTTATCGTAGGCGA,20,497706
araBp,1.3571428571428572,31,13,ATGTCAAATTTTCCTACTGG,18,510182
araBp,0.8571428571428571,24,13,ATGGGCCTACCCTGGGCAAT,11,492463
araBp,1.7142857142857142,36,13,ATGAGGTTCTCCATGGAAAT,23,486252
araBp,1.1428571428571428,28,13,ATCACAAAGTAACCAGGGTG,15,491929
araBp,3.857142857142857,66,13,ATATTAAGATTAGCCGGCCA,53,517667
araBp,1.2142857142857142,29,13,ATATAGGCCAACAAACGGAA,16,516804
araBp,1.2142857142857142,29,13,ATACAGGGAAGTGTGTACTG,16,492654
araBp,1.3571428571428572,31,13,AGTTAAAGGTGTGATCTGCA,18,500484
araBp,0.14285714285714285,14,13,AGTGGCGTACGCGGCCCGAA,1,471945
araBp,2.4285714285714284,46,13,AGGGTCATTGGAGGAAGGAT,33,522124
araBp,0.7857142857142857,23,13,AGGGAGGAGCTGTGTTGCTT,10,518000
araBp,2.5714285714285716,48,13,AGGAATCAGATGGCCTTGCA,35,467960
araBp,1.2857142857142858,30,13,AGCTTCTAGTCCGCCGTAAG,17,523253
araBp,4.0,68,13,AGCGTGTCGTCGTCGGGAAA,55,502477
araBp,1.7857142857142858,37,13,AGCATATGGTAGAAGGTAAG,24,504224
araBp,0.21428571428571427,15,13,AGAGAGTACTACAAACAGTG,2,512320
araBp,2.0714285714285716,41,13,AGACTGACCCGCGTATGACC,28,481862
araBp,3.357142857142857,59,13,AGAACCCTGCAACGTTAAGT,46,516158
araBp,4.428571428571429,74,13,ACTGGACGGACGTGACTAAG,61,468572
araBp,1.1428571428571428,28,13,ACTCAGATCAGGCGGATTAT,15,502976
araBp,2.2857142857142856,44,13,ACGGTGACTACTTAACACAG,31,495299
araBp,0.5714285714285714,20,13,ACGCACAGAGGCACTTTGTT,7,486846
araBp,2.642857142857143,49,13,ACCCAAAAGGTGAACCTCAT,36,473525
araBp,4.142857142857143,70,13,ACCAGCTCAAAATTGAGGCT,57,478729
araBp,1.6428571428571428,35,13,ACATAACGGTAAAGGATTCA,22,507642
araBp,1.5,33,13,ACAGCCGCGCGGGGACGGTA,20,525087
araBp,0.9285714285714286,25,13,ACAGAATCTCGATTGGTACA,12,480455
araBp,1.4285714285714286,32,13,ACACTACGTGTTGTTGGAGG,19,521861
araBp,1.7142857142857142,36,13,ACACGAGTCGGAGCGTCTGG,23,497471
araBp,0.14285714285714285,14,13,AATCAAAGCAATTTCACTCA,1,476325
araBp,0.5714285714285714,20,13,AATATAAAGCAAGTCCCATA,7,495314
araBp,1.5714285714285714,34,13,AACGATTAATCACTGCGTAT,21,483387
araBp,1.3571428571428572,31,13,AAATGGAGGCTTGGTAGGAT,18,472049
araBp,2.2857142857142856,44,13,AAAGTTGGCTTGATGGGCTC,31,505352
araBp,3.7857142857142856,65,13,AAAGGCACGGTAAGAGGATT,52,517180
araBp,1.1428571428571428,28,13,AAACGTGAGTGAACGACTTA,15,487898
araBp,2.076923076923077,38,12,TTGTTAAACGCCGCGGCTCT,26,481583
araBp,0.15384615384615385,13,12,TTGTACGTACGGCAAGGGGT,1,522204
araBp,1.6153846153846154,32,12,TTCGCTTTCTTTTTTTATGT,20,506399
araBp,0.3076923076923077,15,12,TTCCCCGACGATTCGAACCG,3,474344
araBp,1.4615384615384615,30,12,TTCACCTTTTGTAACTTGAT,18,494533
araBp,1.8461538461538463,35,12,TTATTGGGCCTGTATAGCTG,23,498804
araBp,2.1538461538461537,39,12,TTACGTTGGCTGAGTGGATC,27,513055
araBp,0.9230769230769231,23,12,TTACCCAATTTCTGCGGCCG,11,472434
araBp,1.3846153846153846,29,12,TGTATTCATTCTTCTGCAAT,17,522090
araBp,0.15384615384615385,13,12,TGGTAACCTTTCGGTCATTT,1,469900
araBp,1.8461538461538463,35,12,TGGCTTAAATGTCGGGTGAG,23,486624
araBp,3.4615384615384617,56,12,TGCTTAAGGGAGCCGTCGTC,44,512904
araBp,1.9230769230769231,36,12,TGCGGGCGGTTTGCATTAGA,24,496993
araBp,2.3076923076923075,41,12,TGCGAGGGCAACGGATTTTG,29,486425
araBp,1.6923076923076923,33,12,TGATGCCCGTTAACGCCCGT,21,473646
araBp,0.15384615384615385,13,12,TGAGGGCGTCCACGGCGTCC,1,469105
araBp,1.9230769230769231,36,12,TGAAAGCGCTAGGTCAAAGG,24,511269
araBp,0.6153846153846154,19,12,TCGTTCAAAATCTGCTAATG,7,491273
araBp,0.15384615384615385,13,12,TCGTTATCGCGTGAGATAAA,1,518040
araBp,2.0,37,12,TCAACGCTGTGGCCTACAGA,25,475711
araBp,1.1538461538461537,26,12,TAGGTGTGTCGGGACAAGGT,14,491960
araBp,1.4615384615384615,30,12,TAGGGTAATCGTGGCTTCCA,18,509545
araBp,3.5384615384615383,57,12,TAGATATCCCGGGTAGTGAT,45,512251
araBp,1.0,24,12,TAATTACAATACACCTATGC,12,483630
araBp,1.5384615384615385,31,12,TAACAATTTGCATGAAATGC,19,489455
araBp,3.076923076923077,51,12,TAAATATCGCCAAGCCTCAC,39,497536
araBp,1.6153846153846154,32,12,TAAATAGGTGCAAATGACCA,20,510422
araBp,1.6923076923076923,33,12,GTGTGCCCGTTAAACCGCTA,21,470714
araBp,5.769230769230769,86,12,GTGTACCTGTGTGTCGATAC,74,481294
araBp,1.5384615384615385,31,12,GTGGCTGGTCTCGCATCCCG,19,475818
araBp,2.6153846153846154,45,12,GTGATTCTTAGTCACAATTA,33,491271
araBp,2.8461538461538463,48,12,GTGATCCTGCCAGCCTTAGC,36,489663
araBp,1.6923076923076923,33,12,GTCCTTGTCCGGCAGGTTGT,21,477227
araBp,0.23076923076923078,14,12,GTCCCGAAGTTGAGCTGATG,2,512623
araBp,2.076923076923077,38,12,GTATCCTTTTGAGGGAGCAT,26,483093
araBp,4.538461538461538,70,12,GTAGAAATCAAGTTACTCGT,58,517869
araBp,2.3076923076923075,41,12,GTAACCAGGGGTAAATTTCG,29,487616
araBp,1.6923076923076923,33,12,GTAAAGCATACATGTTTTAG,21,473811
araBp,0.15384615384615385,13,12,GGTTTGCGGGCTAGAGGGGT,1,483478
araBp,1.7692307692307692,34,12,GGTCTGCACTATTCTCCACT,22,485285
araBp,3.1538461538461537,52,12,GGTAGTGAGCGCGGGCGGAT,40,476442
araBp,2.076923076923077,38,12,GGTACATCAACTTAGTTGCT,26,499673
araBp,3.1538461538461537,52,12,GGGTTTGACGCAAGTTTCGC,40,493488
araBp,1.1538461538461537,26,12,GGGTTGCACTGTGCATTGGT,14,518855
araBp,3.3846153846153846,55,12,GGGTGCCGTTTTTCGCTAAC,43,506025
araBp,1.9230769230769231,36,12,GGGTGATGTCCTCGCCTAGA,24,474857
araBp,1.5384615384615385,31,12,GGGTAGTAGTGGTGCCAAAG,19,496830
araBp,1.5384615384615385,31,12,GGGTAATACAGACTTGAAAG,19,472036
araBp,4.538461538461538,70,12,GGGCGAGCAATCCAATCAGC,58,510008
araBp,2.0,37,12,GGGCCTCTTTTCGTTTCGAT,25,517720
araBp,1.3076923076923077,28,12,GGGACACCCGGACCATGCTA,16,501678
araBp,1.2307692307692308,27,12,GGCGCATGTGAGGGTGAGGT,15,475234
araBp,1.5384615384615385,31,12,GGAGTTCAGAATCACGGTTA,19,478066
araBp,0.6923076923076923,20,12,GGACTTATAGTGCTCGCCGC,8,521378
araBp,3.4615384615384617,56,12,GCTGTGGTGCGGCTCATTCA,44,517424
araBp,1.4615384615384615,30,12,GCTCCGTATATGCCCCCTAA,18,519173
araBp,1.5384615384615385,31,12,GCGGTCTGCGTAAGAAGTCC,19,475528
araBp,1.6153846153846154,32,12,GCGGGCCTAGATCTACCAGA,20,488725
araBp,1.6923076923076923,33,12,GCGATCATTTTCTGAAGGGT,21,485468
araBp,7.923076923076923,114,12,GCCTTCAAATCACTGGGACC,102,472162
araBp,1.5384615384615385,31,12,GCCCTGCGGCGCCGCTCCAA,19,517637
araBp,2.076923076923077,38,12,GATTGACGTCGTTCAATACG,26,520001
araBp,0.15384615384615385,13,12,GATACTGTCATGCAAGGACG,1,512046
araBp,4.615384615384615,71,12,GAGGGACATTCGCCTATATT,59,481840
araBp,2.4615384615384617,43,12,GAGGAGTCAATCGGATCTCC,31,517931
araBp,2.3076923076923075,41,12,GAGAAGACCCCTATGCTCGA,29,493146
araBp,1.4615384615384615,30,12,CTTAAGTGGGATCTACGGGA,18,510762
araBp,0.15384615384615385,13,12,CTGGGCCGGTACAGCTGCCG,1,487283
araBp,1.1538461538461537,26,12,CTCTTAGATACCCACCCGCT,14,474262
araBp,0.3076923076923077,15,12,CTCTATACCCATAACGCTTC,3,485120
araBp,0.15384615384615385,13,12,CTCGGTGTCAACTTTTTTAC,1,480098
araBp,3.1538461538461537,52,12,CTCGCCAATAGGCTGGTGAG,40,501919
araBp,2.3846153846153846,42,12,CTCAGTCTTTAAGGGTATAC,30,499466
araBp,1.6153846153846154,32,12,CGTTACAACGCCTCTCCTGC,20,488572
araBp,1.2307692307692308,27,12,CGTGATCATGAGTCCATTCC,15,523219
araBp,1.8461538461538463,35,12,CGGGTTTGGTTTTACAATCA,23,517877
araBp,2.3846153846153846,42,12,CGGGCAAGGGAGACACGGGC,30,493950
araBp,1.6923076923076923,33,12,CGGGATGTGGGAAGTCCTTA,21,503775
araBp,0.15384615384615385,13,12,CGGATGCGGTCCTCATCGGG,1,516718
araBp,1.8461538461538463,35,12,CGGATGATCTCGAATAGAAT,23,515494
araBp,2.1538461538461537,39,12,CGGAAGGCGAGGATGATGGC,27,479589
araBp,2.3076923076923075,41,12,CGCCAGAACAGCGGGTAATA,29,475224
araBp,1.1538461538461537,26,12,CGATTGGAGAAGTTTTAGAC,14,475853
araBp,2.6923076923076925,46,12,CGATAGCAAGGTCAGATGCT,34,505646
araBp,1.3846153846153846,29,12,CCTTGGGGCCTATCCGATAA,17,510632
araBp,0.15384615384615385,13,12,CCTTGGCGGAGGGGCGTCTA,1,475052
araBp,0.38461538461538464,16,12,CCGTTATGAGCAAGTGCATA,4,496886
araBp,1.3846153846153846,29,12,CCGGGATTCAGGCATTGCCA,17,525446
araBp,2.4615384615384617,43,12,CCGCAGGTGAACATACGATC,31,481622
araBp,5.076923076923077,77,12,CCCTCAACGACACGGTACAT,65,475780
araBp,1.6153846153846154,32,12,CCCGCAGGCAGTACGGTTAC,20,486402
araBp,0.15384615384615385,13,12,CCATCGGCACTTTGGTACTA,1,523007
araBp,1.6153846153846154,32,12,CCAGCTCTTGGAGATAGCTA,20,495741
araBp,1.6153846153846154,32,12,CCAGCCTGGGCGCCAGGCGA,20,523406
araBp,3.3846153846153846,55,12,CCACGTTCAAAGCTAGAGAG,43,524972
araBp,2.4615384615384617,43,12,CCAACTGAACTTGGCGTTGA,31,519567
araBp,2.3076923076923075,41,12,CATGAAAGCCTAGCAATAAC,29,522214
araBp,1.2307692307692308,27,12,CAGGGCATTCAAGAATCATT,15,509496
araBp,2.3846153846153846,42,12,CAGGGAAGCTGCAACCCGCT,30,481310
araBp,3.3076923076923075,54,12,CAGCTCGCACTACTCTACAG,42,491668
araBp,0.15384615384615385,13,12,CAGCCTGATGACACGACCTA,1,523152
araBp,2.1538461538461537,39,12,CACGTAGCATAGGGACGCGG,27,481352
araBp,4.0,63,12,CACATGGGGATATTCACAAA,51,485356
araBp,2.230769230769231,40,12,CAACCTATCGGATAGAGTAT,28,471065
araBp,2.6153846153846154,45,12,CAAAGGCCTACCGTGCGGAT,33,481439
araBp,1.7692307692307692,34,12,ATTTTATTCCTCATTGCGAT,22,488539
araBp,3.6923076923076925,59,12,ATTGGTGTGACTTAGCGCCA,47,472675
araBp,2.923076923076923,49,12,ATGCGTACAGAAAACGGATA,37,482883
araBp,1.8461538461538463,35,12,ATGCAATCCTGAAAAGGACG,23,487478
araBp,2.076923076923077,38,12,ATGAACAGCGTCGCGTATCG,26,508588
araBp,1.5384615384615385,31,12,ATCGTCGCGTAACCGCTTGT,19,502226
araBp,3.5384615384615383,57,12,ATCCGGGGTAACCGGCCCCT,45,477377
araBp,2.6923076923076925,46,12,AGGCTGAAGAGACCATGCGG,34,504667
araBp,2.3076923076923075,41,12,AGGCATCCCGCGCGGCCAAA,29,472187
araBp,0.15384615384615385,13,12,AGGCAACTTGCGCTTGGCGT,1,513669
araBp,1.7692307692307692,34,12,AGCTCTGCCTGCTGGCAGGT,22,478994
araBp,2.1538461538461537,39,12,AGCCACACCAACTCATAGAA,27,524490
araBp,1.3846153846153846,29,12,AGCACCTTGTGGGTTCTGTA,17,500067
araBp,3.3846153846153846,55,12,AGATCATCAATAACCCTTCA,43,476914
araBp,1.9230769230769231,36,12,AGAGTTACTCCCCCAGAGCT,24,508379
araBp,1.6923076923076923,33,12,AGACCCGGGATGACCGTGCC,21,523818
araBp,2.5384615384615383,44,12,ACTGTCGGGGGGCAGGGTCA,32,484447
araBp,5.076923076923077,77,12,ACGTTTTCAGCAAGGTTAAA,65,510416
araBp,6.3076923076923075,93,12,ACGGTCCGGTAACTGCGGAG,81,488388
araBp,1.2307692307692308,27,12,ACGGAGCCTTTTGCTTCCTT,15,489911
araBp,1.3846153846153846,29,12,ACCTCGTATTAAACGCCTAC,17,501291
araBp,2.6153846153846154,45,12,ACCGTGATCTTCCACGTAGT,33,491935
araBp,2.0,37,12,ACACACGGTTAAGTCTCGTA,25,518465
araBp,1.6153846153846154,32,12,ACAACGATTTAATGGCGGTT,20,488645
araBp,1.8461538461538463,35,12,ACAAAAATACTTTAATCACA,23,490379
araBp,1.6153846153846154,32,12,AATTTACTCTCATTTACATA,20,477379
araBp,1.5384615384615385,31,12,AATTGAGGGCCTTACTACCT,19,482310
araBp,2.769230769230769,47,12,AATGTTCCCGTCTCCGGTCT,35,490977
araBp,1.2307692307692308,27,12,AATACCAGATCGACTTATCA,15,504197
araBp,0.15384615384615385,13,12,AAGGAGCAACATCCTGGCAT,1,517080
araBp,1.6923076923076923,33,12,AACTCGCAAACGGCGTTACA,21,488720
araBp,0.38461538461538464,16,12,AACAATCGGCGTCACAGAGT,4,483312
araBp,1.2307692307692308,27,12,AAATAAGGTAATATCTAGCT,15,492469
araBp,2.230769230769231,40,12,AAACGGCCAGAACGGGCAAG,28,523122
araBp,1.0769230769230769,25,12,AAAACGGTTTTTCCGCGATA,13,468600
araBp,4.083333333333333,59,11,TTTGAACAGTAAGATCGATC,48,508053
araBp,1.1666666666666667,24,11,TTGTCATAGGCAATCTGTGA,13,496441
araBp,0.16666666666666666,12,11,TTAGGGGTTCAACCTAAGCA,1,516344
araBp,1.5833333333333333,29,11,TTAGACAGGTGCCGGTGTAT,18,516189
araBp,0.8333333333333334,20,11,TTAAACAGCTGCCTTTCCTC,9,485188
araBp,0.16666666666666666,12,11,TGTCTGCGACGGTACGAGTC,1,490893
araBp,1.6666666666666667,30,11,TGTCGAACATCAACATTCCT,19,472133
araBp,3.0833333333333335,47,11,TGTAAGACTCCGCCATCCAT,36,483959
araBp,1.0833333333333333,23,11,TGGGCCATGGTTGTGGGGTT,12,511978
araBp,0.16666666666666666,12,11,TGGCCGGGGCTGAACCGTTC,1,479363
araBp,3.75,55,11,TGGACTCACTGAGGTCTGAC,44,522842
araBp,1.6666666666666667,30,11,TGCTGGGCTACTCGGCGCAT,19,514239
araBp,2.0833333333333335,35,11,TGCGATCTGGCCTAAGAACA,24,523780
araBp,2.0,34,11,TGCCAGATATACCGAGAAGA,23,495155
araBp,2.5,40,11,TGCCACTGGAGTCTCGTGCT,29,473250
araBp,1.3333333333333333,26,11,TGCACCCCGTCAGATTGTTG,15,512289
araBp,1.75,31,11,TGAGATGCGTCGTACCTGAG,20,500063
araBp,2.6666666666666665,42,11,TCTGAACGGCCTTAGACCGT,31,499413
araBp,2.4166666666666665,39,11,TCTAACTCAAAACCCACTGG,28,493640
araBp,1.6666666666666667,30,11,TCGTACCGTGAGATAGGCCA,19,477782
araBp,2.1666666666666665,36,11,TCGTAATGTGGTAACCATAA,25,471599
araBp,1.8333333333333333,32,11,TCGGGTCAATAGCAAGTTGC,21,510850
araBp,1.8333333333333333,32,11,TCGGATAGGGCTTGCAGCTG,21,523604
araBp,2.1666666666666665,36,11,TCGAATACGATAGGATCTAC,25,491977
araBp,2.5833333333333335,41,11,TCCTGACTTATCGGATGTTA,30,484488
araBp,2.0,34,11,TCCGTAAGCCTACAGCGGTG,23,506792
araBp,1.8333333333333333,32,11,TCCGCCAGAACATATTAATC,21,507948
araBp,0.5,16,11,TCCGATATCCTATGAAATCA,5,517356
araBp,3.5833333333333335,53,11,TCCCGCGACTTCATCCTGAA,42,471087
araBp,1.75,31,11,TCCCGCCTTATAAGAAACTA,20,491996
araBp,2.0,34,11,TCCAGTCAAGCACGGGAATT,23,474220
araBp,1.8333333333333333,32,11,TCCAAAAACACTCGCAGCAG,21,486470
araBp,1.6666666666666667,30,11,TCAGAATCGGGATCGTGTCC,19,490551
araBp,2.4166666666666665,39,11,TCAACACAAAGCCACAAGAA,28,495905
araBp,4.0,58,11,TCAAAGTGTACGGTAAATGA,47,514248
araBp,3.25,49,11,TATTGCACTACATCGGAATA,38,502290
araBp,2.8333333333333335,44,11,TAGCTTACATCGATAAGGGT,33,503674
araBp,4.666666666666667,66,11,TACGGGCAACTAGACTGAGT,55,515893
araBp,2.75,43,11,TACCGACCAACGATAAAATT,32,499647
araBp,3.3333333333333335,50,11,TAATGTATACCGATCAGAGG,39,487593
araBp,1.0,22,11,GTTTCTCCTAAAACACAGTT,11,480462
araBp,1.5833333333333333,29,11,GTTGGCGAGAGGTACATTGG,18,490164
araBp,1.5,28,11,GTTGCTGGAACCTGGGCGAC,17,493256
araBp,1.25,25,11,GTTGCGACCGTAGATCACTA,14,522510
araBp,2.0833333333333335,35,11,GTTACCGCGGGCAATGTGTT,24,469271
araBp,0.16666666666666666,12,11,GTTAAGCAGCCCATAGATGC,1,517158
araBp,0.16666666666666666,12,11,GTGTTCGGCTAACTTCACCA,1,473247
araBp,3.6666666666666665,54,11,GTGCGTAGAGCGTACAAAAT,43,469093
araBp,1.3333333333333333,26,11,GTGCGGCCCACTTAGGTTCT,15,487805
araBp,3.9166666666666665,57,11,GTCTGTTCACAAAGCAAATA,46,484252
araBp,2.6666666666666665,42,11,GTCGTGTGATTACCAAGTAC,31,478511
araBp,0.6666666666666666,18,11,GTATTGATCACTGTCCCTCA,7,502006
araBp,1.5,28,11,GTATGACCTGGTCCGTGAGA,17,504341
araBp,1.25,25,11,GTATAGTATACTAATTGTCA,14,519278
araBp,1.75,31,11,GTATACATTAGGAACGAGTT,20,521227
araBp,2.8333333333333335,44,11,GTACCTAATCGCACGTTCCT,33,491527
araBp,0.16666666666666666,12,11,GTAATCCGTCAGTTTTTATT,1,519105
araBp,4.166666666666667,60,11,GGTGGCGACACATGGCGTGT,49,467952
araBp,2.9166666666666665,45,11,GGTACGGGGAAATACAAATT,34,483139
araBp,0.16666666666666666,12,11,GGGGCTCGATAATACTAAGA,1,473037
araBp,2.6666666666666665,42,11,GGGCAAAGAGCCGACAAGTA,31,470519
araBp,0.16666666666666666,12,11,GGCGTTCCTGTGCGTTAGAA,1,470802
araBp,0.9166666666666666,21,11,GGCGAGGCTCCGGTCAAAAG,10,517728
araBp,12.25,157,11,GGCCTAACGTCTCCGCTTCA,146,513087
araBp,0.16666666666666666,12,11,GGCACCGTGTGATATGCAAT,1,507803
araBp,1.9166666666666667,33,11,GGAGGCTCCCGGTCGGCAGC,22,506883
araBp,1.3333333333333333,26,11,GCTTTGTATCTTCAGCATGT,15,519825
araBp,1.75,31,11,GCTTGAGTACACGGACTGCA,20,473833
araBp,1.5,28,11,GCTTCGCATTTGATTCCAGC,17,491891
araBp,1.5833333333333333,29,11,GCTGCTGTTCGACGAAATCG,18,515301
araBp,1.3333333333333333,26,11,GCTCGACAGATCGTTGCCTA,15,473567
araBp,2.0,34,11,GCTCAGTTGTGAAGATGGAG,23,523217
araBp,2.0833333333333335,35,11,GCGGCACAGGAACAGGCGAT,24,473153
araBp,3.5833333333333335,53,11,GCGCTGAAAGTTCGACAAGC,42,505126
araBp,1.4166666666666667,27,11,GCGCTAGAAGGGCATCAGAA,16,501127
araBp,1.0,22,11,GCGATTAGATTTGGACCCGA,11,510504
araBp,1.6666666666666667,30,11,GCGATACCGGAGGGTGTTTA,19,516405
araBp,2.0833333333333335,35,11,GCCTCGGAAGCTCACTCCGC,24,510188
araBp,1.6666666666666667,30,11,GCCGTGGACATCTGATCCGG,19,479865
araBp,2.8333333333333335,44,11,GCACGATTGCAATAGATATT,33,481931
araBp,1.1666666666666667,24,11,GATAACCCGATATGGTCCGG,13,479327
araBp,0.16666666666666666,12,11,GAGTGTAATCACATTCCGCA,1,472459
araBp,3.25,49,11,GAGGGTCGCGCTGCGACCTG,38,524916
araBp,3.6666666666666665,54,11,GAGATCTTCGACCTGTTGCC,43,477984
araBp,2.3333333333333335,38,11,GAGAGAGACAGCGCCTTTAA,27,477788
araBp,2.25,37,11,GACTCCCCAATCTACCGTGA,26,471450
araBp,2.0833333333333335,35,11,GACACAAGTACAAGCAGATG,24,489205
araBp,2.9166666666666665,45,11,GAACTGCAGTAATAGGCATT,34,517810
araBp,1.8333333333333333,32,11,GAAAATGGGAACCCCTGCCA,21,493706
araBp,1.4166666666666667,27,11,CTTCTAGTTTGCTCGTATAT,16,469061
araBp,0.16666666666666666,12,11,CTTACTTCGCGGCATGAATG,1,475124
araBp,0.25,13,11,CTGTCCACGAGTCCAGCGCG,2,487849
araBp,0.16666666666666666,12,11,CTCTGACGCTTGGGCTGAGG,1,480592
araBp,1.3333333333333333,26,11,CTCTACGCTCCGGCTTATAC,15,491204
araBp,2.1666666666666665,36,11,CTCGCTGCTCGCAAACGGAA,25,519181
araBp,1.5,28,11,CTCGAATTTGCACGCAGACT,17,490302
araBp,3.5833333333333335,53,11,CGTCGGGGAAGGGGACCAAT,42,511147
araBp,1.6666666666666667,30,11,CGCTGTCCAACGCGTGCATG,19,493423
araBp,1.8333333333333333,32,11,CGCCTGCATCCGACCGCCCT,21,471675
araBp,0.16666666666666666,12,11,CGAGCACATGACGTCCTGTC,1,500218
araBp,1.6666666666666667,30,11,CGACCGTGGGAACGAGCGAT,19,506314
araBp,1.0,22,11,CGACCCCAGTATAAAGTCCG,11,471017
araBp,2.25,37,11,CGAAGCTCCCGCTTCCTGGA,26,512334
araBp,0.8333333333333334,20,11,CGAACGTACGAGCGGCGAAG,9,469827
araBp,2.3333333333333335,38,11,CCGAAGGCACTCGTTTACTC,27,517911
araBp,3.5833333333333335,53,11,CCCGTTCCGCGCTTGGAAGA,42,506589
araBp,3.1666666666666665,48,11,CCCATTCGCCCAATCCGGCA,37,519294
araBp,2.0833333333333335,35,11,CCCATGGGGGGAAAGGAGTT,24,478178
araBp,1.25,25,11,CCAATATGAGCTAGCGGGTT,14,469875
araBp,2.1666666666666665,36,11,CCAACATGTTTCATCGTCCC,25,490595
araBp,1.4166666666666667,27,11,CATTTCTGTACATCAGGACA,16,468765
araBp,5.666666666666667,78,11,CATTGGTACCGATAGCTTGA,67,510995
araBp,1.0833333333333333,23,11,CATTGCAACAACAACTGGCT,12,511908
araBp,2.25,37,11,CATAGCTTTGGCACGGGAAC,26,489239
araBp,2.0833333333333335,35,11,CAGTGGATTCTTGCTTTATT,24,519462
araBp,2.5833333333333335,41,11,CAGGGGAGAAAGTGTATGGC,30,471707
araBp,2.25,37,11,CAGAAACCATGTGCTGCCAT,26,522534
araBp,1.8333333333333333,32,11,CACAAGCCGGGCTTGACGTA,21,507804
araBp,0.16666666666666666,12,11,CAAGTAGGAACGACAAACTG,1,496335
araBp,2.3333333333333335,38,11,CAAGGGCTCTCAGCCCGCCA,27,471268
araBp,1.25,25,11,CAACGTGATCGAGGGTAGCG,14,504062
araBp,1.5833333333333333,29,11,CAAATCGTCCCAGGAATCGT,18,487672
araBp,4.583333333333333,65,11,ATTTGGATACGTCCATTCTT,54,469097
araBp,2.25,37,11,ATTTAATGATTGTAAGTCTG,26,480774
araBp,3.3333333333333335,50,11,ATTCAATAGGTGACCTCGAG,39,484591
araBp,1.0,22,11,ATGTACATTTTTGAACTATA,11,488763
araBp,4.416666666666667,63,11,ATGCCCTTGTAACTCATTCG,52,479161
araBp,1.75,31,11,ATCTTCTTTCTGTCAATTTT,20,470239
araBp,0.16666666666666666,12,11,ATCCGCCGGGGGAAACCCGC,1,504909
araBp,0.16666666666666666,12,11,ATCAGATCGATAGAGGTTAA,1,502616
araBp,1.5833333333333333,29,11,ATCAGAACGCTTGCACCGCA,18,484194
araBp,1.1666666666666667,24,11,ATAGTGTGACATTCGTGGAT,13,516067
araBp,2.5833333333333335,41,11,ATAGGTGAGAAGACTGCTTA,30,486975
araBp,2.3333333333333335,38,11,ATAATTATCGGACAGTCTTT,27,485006
araBp,1.9166666666666667,33,11,AGTGCGCAAAATCGCTCATT,22,486895
araBp,0.16666666666666666,12,11,AGGTGTATGCTCAGGTAGCT,1,500582
araBp,2.25,37,11,AGGTCGAACATTAACAACCG,26,497861
araBp,4.083333333333333,59,11,AGGTAATCGTCGCCTTAACA,48,499922
araBp,2.25,37,11,AGGCAGAGTGCATCGGACGA,26,495468
araBp,3.25,49,11,AGCTTTTTTCACGATAACGT,38,509173
araBp,0.5833333333333334,17,11,AGCTGTAACCTGAGAATGCG,6,523930
araBp,5.083333333333333,71,11,AGCAAGACAACGTGGTCTGC,60,518808
araBp,1.1666666666666667,24,11,AGATACGAGGACGGGTGGTC,13,508381
araBp,0.3333333333333333,14,11,ACTTTCTTCACTTTTCAACG,3,487778
araBp,1.5,28,11,ACTGCAAGTGTCTAAACTGT,17,521661
araBp,1.3333333333333333,26,11,ACTGATGTACAATCTCGGCT,15,499518
araBp,2.3333333333333335,38,11,ACGTCGCTGAGCAGGCATGA,27,485509
araBp,3.3333333333333335,50,11,ACGGATCACGGGCATAAAGA,39,482023
araBp,1.3333333333333333,26,11,ACCTAGTATCATGATGCATT,15,473561
araBp,0.16666666666666666,12,11,ACCGCCGACGACAACTAGGA,1,502584
araBp,1.8333333333333333,32,11,ACCCCTGGTAGGACGCCTAA,21,505775
araBp,1.5833333333333333,29,11,ACCATCTAAGGCATGGAAAG,18,494296
araBp,1.9166666666666667,33,11,ACATGGGGCGCGTGCGGCGG,22,477444
araBp,1.8333333333333333,32,11,ACAGCTGTTAATGCATGAGC,21,484484
araBp,0.16666666666666666,12,11,ACAGAACGCATGGCGCTGCG,1,499272
araBp,2.0833333333333335,35,11,AATGGGTAGGAATACTTACG,24,517811
araBp,0.8333333333333334,20,11,AATGGGGCTCAATGTGTGCA,9,486994
araBp,4.416666666666667,63,11,AATCGCAGATTCTCCAAGTA,52,519800
araBp,1.8333333333333333,32,11,AAGCGATTCAATGGTATACG,21,502393
araBp,3.6666666666666665,54,11,AAGACAGTTCTGGACAGCAG,43,515789
araBp,0.16666666666666666,12,11,AACTGAAACCAGTCGAAGGA,1,472263
araBp,5.666666666666667,78,11,AACCATCATGCACGGAATCT,67,483557
araBp,2.3333333333333335,38,11,AAATGCTTATCTTCCGTAAG,27,467898
araBp,1.0833333333333333,23,11,AAACTGACCCGGTAGATGTG,12,499463
araBp,1.5,28,11,AAACACCCTCTGTACTGAAT,17,512124
araBp,1.7272727272727273,28,10,TTTGAATCTACGGTGCTCGG,18,508141
araBp,1.0909090909090908,21,10,TTTCATCAGGAACCTAAACT,11,514179
araBp,3.090909090909091,43,10,TTTAGTTAGATGAATGTCCT,33,498470
araBp,1.7272727272727273,28,10,TTTAATCCCTTGTCTTTCGT,18,520970
araBp,1.5454545454545454,26,10,TTGTGCTCTTGTCAAAACGA,16,508859
araBp,5.090909090909091,65,10,TTGTCGAGAAAAACACATGT,55,500364
araBp,2.5454545454545454,37,10,TTGCGGTATTGCTTAGCGCA,27,513962
araBp,2.0,31,10,TTCTTAGAACCTGTGCAAAT,21,476107
araBp,2.0,31,10,TTCGGAGAAGTGTTGATTGA,21,496743
araBp,1.4545454545454546,25,10,TTCGCAGATCTAAGGCTACT,15,502109
araBp,2.6363636363636362,38,10,TTAAGCTAAGGCACTAACAT,28,511661
araBp,0.9090909090909091,19,10,TGTTTTATGTCCTGGATAGG,9,519222
araBp,2.3636363636363638,35,10,TGTGACGCTCTCTTCTAACT,25,488531
araBp,4.363636363636363,57,10,TGTCTGTGCGCTGTCCTCCT,47,481747
araBp,10.0,119,10,TGTCTCGGAGCGTCCAGCAA,109,512414
araBp,1.7272727272727273,28,10,TGTAAATTCGGTTACAGGTC,18,507724
araBp,0.18181818181818182,11,10,TGGTAAGCGCGTCACAAGAA,1,477532
araBp,1.7272727272727273,28,10,TGGGACGTCTAACTTATATT,18,484259
araBp,1.7272727272727273,28,10,TGGCGTGTAGTTACGACTAA,18,517627
araBp,1.7272727272727273,28,10,TGGCCTCTCATTTATCCTAA,18,513282
araBp,2.1818181818181817,33,10,TGAGATAAATCAGTCGATGA,23,482097
araBp,1.6363636363636365,27,10,TGACGGTTCAATGACTAGCG,17,489446
araBp,6.818181818181818,84,10,TGAATTGGGTAACACAAATT,74,472209
araBp,2.4545454545454546,36,10,TGAACTCCTGGATGCCTGCA,26,512631
araBp,2.090909090909091,32,10,TCTTCGTATGAAAACACTAG,22,480055
araBp,3.727272727272727,50,10,TCTGATGTGGTTAAGAATGA,40,478699
araBp,2.0,31,10,TCGCCACTGTGATTAGTGGA,21,511428
araBp,1.9090909090909092,30,10,TCATGTGTCCTGGGGCAGTT,20,493457
araBp,1.2727272727272727,23,10,TCATCGCGCGTCCTGACGGT,13,490077
araBp,1.2727272727272727,23,10,TCAGGGACCTCTTTAGAGGT,13,471949
araBp,1.8181818181818181,29,10,TCAGCTACGTCTGTACCCCT,19,467862
araBp,2.727272727272727,39,10,TCACGCCGGAATCTGGCCCA,29,487053
araBp,3.8181818181818183,51,10,TCAATCAGTTGGAGTAGGGA,41,476676
araBp,1.5454545454545454,26,10,TATGTCTCGCGAAACGTCAC,16,490507
araBp,1.4545454545454546,25,10,TATGATTACCGCTCGAGTCA,15,491559
araBp,0.18181818181818182,11,10,TATCCATCTACTTAACAATT,1,515896
araBp,0.18181818181818182,11,10,TACACTTACAACTCTAGCGT,1,513930
araBp,1.0909090909090908,21,10,TAAAACCAGTTGTTTTCTCT,11,496613
araBp,7.0,86,10,GTTTAGTTACCTTGGTAACG,76,475823
araBp,0.6363636363636364,16,10,GTTCGATCGTTGAGCGACGA,6,513074
araBp,2.5454545454545454,37,10,GTGGTAATCCGGTTGGCACT,27,513094
araBp,0.18181818181818182,11,10,GTGATCCATGGCCGAAGCAG,1,493939
araBp,0.18181818181818182,11,10,GTCTTTGTCCTGTACTACCG,1,486258
araBp,1.4545454545454546,25,10,GTCTAAGGGTTTGTCCACCC,15,498572
araBp,0.18181818181818182,11,10,GTCCAAACAGACAAGTGACC,1,499826
araBp,4.2727272727272725,56,10,GTCAGGCCTTGGCACCATTG,46,523305
araBp,2.909090909090909,41,10,GGTGGGTGTTAGATGAGTGT,31,512697
araBp,1.6363636363636365,27,10,GGTCTCACCTACGGAGTACC,17,501640
araBp,2.090909090909091,32,10,GGGTTTCCGCTCTACGTCGT,22,508692
araBp,1.9090909090909092,30,10,GGGGTAAGTCTATTGACCTA,20,503387
araBp,2.6363636363636362,38,10,GGCTTCGTTGGTCGTGGTGT,28,478219
araBp,3.8181818181818183,51,10,GGCCCTTACAAAAGGTTCCT,41,488770
araBp,1.4545454545454546,25,10,GGATCTATGCTAGCCCGAAT,15,525028
araBp,2.727272727272727,39,10,GGACAGAGGTTCCATCTTGT,29,474163
araBp,3.0,42,10,GCTGTTATCAATTTACCACT,32,473674
araBp,1.5454545454545454,26,10,GCTGACCGAGTGGCATTTAT,16,480625
araBp,1.3636363636363635,24,10,GCGTTGGGTATCGAGAACAG,14,512454
araBp,2.0,31,10,GCGTTCAAGCCACCTATGGG,21,488027
araBp,1.1818181818181819,22,10,GCGTTATCATGGCAAGCTCT,12,495113
araBp,0.9090909090909091,19,10,GCCGGCCTGGTCTGTTCCGG,9,520203
araBp,0.18181818181818182,11,10,GCCCCTAGTTTACGGTCCTA,1,517312
araBp,3.090909090909091,43,10,GCCATTAAATTCTAAGCACC,33,481199
araBp,1.8181818181818181,29,10,GCCACGCATTGCGAACCGGG,19,487197
araBp,2.8181818181818183,40,10,GCAGAGATCTCCCTTTGCTT,30,502953
araBp,2.5454545454545454,37,10,GCAGAACAGGCGTATGGTTC,27,504370
araBp,2.272727272727273,34,10,GATTATATTCAAGCAAGGCT,24,478941
araBp,3.727272727272727,50,10,GATCACAGACTTCCCTCTGC,40,474123
araBp,8.272727272727273,100,10,GATCAAAGCTCCGAACTCGA,90,484602
araBp,3.4545454545454546,47,10,GATATGGTCATTATCAGGGA,37,505776
araBp,4.181818181818182,55,10,GAGGCCTTACCATCGCGGGG,45,491768
araBp,0.18181818181818182,11,10,GACTCATTTAAGCTACTTCT,1,486777
araBp,1.0909090909090908,21,10,CTTTTTTAGGTGGTATATGA,11,523888
araBp,2.272727272727273,34,10,CTTGGGGCATGGCAGGTTTA,24,487850
araBp,9.818181818181818,117,10,CTGGTTGCTTAGAGTGACAT,107,507820
araBp,1.1818181818181819,22,10,CTGCTGTACACCCATCACTC,12,486592
araBp,5.636363636363637,71,10,CTGAACCTAACTTTGAAGGA,61,521118
araBp,2.090909090909091,32,10,CTCTCGCGACAATTATCCTT,22,479685
araBp,0.18181818181818182,11,10,CTCCACACTGTGGGGACGAC,1,480779
araBp,12.818181818181818,150,10,CTCAAAGCGAAGACAAGGGT,140,510967
araBp,1.7272727272727273,28,10,CTAGTTGTTGTCGCCCGCTT,18,468239
araBp,2.1818181818181817,33,10,CGTTTGCTGTCACCGTACCT,23,504142
araBp,2.1818181818181817,33,10,CGTTGTCATAAATTCCTCCA,23,478076
araBp,0.18181818181818182,11,10,CGTGGATGCAACGAAGATTC,1,511947
araBp,2.272727272727273,34,10,CGTGCATAGCCAGTCTCTAC,24,509611
araBp,1.3636363636363635,24,10,CGGCTTCCAACTGTGATTGT,14,520384
araBp,1.3636363636363635,24,10,CGGCCAAGTCACGCGGAACA,14,486805
araBp,2.090909090909091,32,10,CGGACATCTTTTACTCATGC,22,486806
araBp,0.18181818181818182,11,10,CGCTTTCAGTAACACGACGT,1,488029
araBp,2.8181818181818183,40,10,CGCGCCTACGCTTCACCCAG,30,516686
araBp,2.5454545454545454,37,10,CGCCGCCCGAGATACGCAAC,27,499705
araBp,1.7272727272727273,28,10,CGCACAGACCCCGGCGAGCG,18,482382
araBp,1.1818181818181819,22,10,CGATGGGTGCATTGGGCTGT,12,476915
araBp,1.5454545454545454,26,10,CGATGCACCATACTAATTCC,16,498298
araBp,2.5454545454545454,37,10,CGAGTTGGTCGCTGTTGCCT,27,468701
araBp,2.6363636363636362,38,10,CGAGCTTGGGTAGGTGCGAT,28,501320
araBp,1.8181818181818181,29,10,CGAATTCGAATGGTATACAT,19,503920
araBp,0.18181818181818182,11,10,CCTCGCTGTTTTACATCCGA,1,519521
araBp,2.4545454545454546,36,10,CCTCGCGGAGGCCGTTCACA,26,488834
araBp,0.9090909090909091,19,10,CCTAACGGCTTTCTTTCAGT,9,520108
araBp,17.0,196,10,CCGTGAAGGCTGCCAAAGGC,186,525379
araBp,1.2727272727272727,23,10,CCGGGCTGCCTCTTTAGGAA,13,490723
araBp,2.0,31,10,CCGGCGTTAAAACCATCCGC,21,478446
araBp,2.272727272727273,34,10,CCGCAGTACATAACAGCCGC,24,520940
araBp,3.1818181818181817,44,10,CCGCACATTGTAAACGATTG,34,513575
araBp,2.6363636363636362,38,10,CCGATATGGCCCATATTGCA,28,493767
araBp,0.18181818181818182,11,10,CCCTCGGTATGGAAAGGTTA,1,509024
araBp,1.8181818181818181,29,10,CCCGACGAGGTGAAGAACCA,19,521337
araBp,1.6363636363636365,27,10,CCCGACCTTAGATGGGGATA,17,469310
araBp,2.272727272727273,34,10,CCCCCGGGAGTGCGACGAGA,24,499368
araBp,5.7272727272727275,72,10,CCATGCTCACGATGCTGAAA,62,511016
araBp,2.0,31,10,CCATCCGCTCTATGGTTTAG,21,517015
araBp,2.5454545454545454,37,10,CCACAAAATCATGTTTCTTT,27,473277
araBp,5.363636363636363,68,10,CCAAGGCGCGGATTCTCAAA,58,494898
araBp,1.8181818181818181,29,10,CATTCATGGTGGAAATTTAA,19,488588
araBp,1.8181818181818181,29,10,CATCGAGGCTTGGCAACATA,19,490697
araBp,4.363636363636363,57,10,CAGTCCGAATTATTCTGCAT,47,518410
araBp,0.18181818181818182,11,10,CAGCGGCCCGCGGATTCGAA,1,520109
araBp,3.0,42,10,CACTTGTGAGGTAGGTTGGA,32,468211
araBp,2.090909090909091,32,10,CACTATGCGGAAGAGTGGTA,22,484316
araBp,1.9090909090909092,30,10,CACGACGTTATATCGTTGCT,20,496118
araBp,2.1818181818181817,33,10,CACCCATCTATTGGCTCCTG,23,483997
araBp,0.8181818181818182,18,10,CACAGATGGGGTTAAGCCAT,8,469850
araBp,2.0,31,10,CAATTGACACGCCCCTACCT,21,491572
araBp,1.6363636363636365,27,10,CAACCGATTAGTACCGGTTC,17,483211
araBp,2.1818181818181817,33,10,CAACAGGTCCATGGGGAGTG,23,520125
araBp,2.3636363636363638,35,10,ATTCATTTCTTGGTCCTGAT,25,496422
araBp,2.909090909090909,41,10,ATGGCGCTGAGTTCTCAAGG,31,487213
araBp,1.9090909090909092,30,10,ATGGAGCGACTTGTACCTCT,20,490116
araBp,10.0,119,10,ATGCTAGAATCTATCAGTTT,109,510968
araBp,5.636363636363637,71,10,ATGAACCTGACTTGGTAATG,61,472501
araBp,2.727272727272727,39,10,ATCTTTTGCAAGGTGACAGA,29,478607
araBp,0.8181818181818182,18,10,ATCGGGTACTATGACGCACA,8,473723
araBp,1.3636363636363635,24,10,ATCAATTCCGCGGGAGTCCC,14,511326
araBp,2.1818181818181817,33,10,ATATCTTTCCTGTCACAAAT,23,511108
araBp,1.8181818181818181,29,10,ATACCCAGGCATTACCATAC,19,522542
araBp,2.0,31,10,ATAACAGCAGTCGATATTTC,21,482385
araBp,0.18181818181818182,11,10,ATAACACGTCCAAGGCGCCA,1,481928
araBp,0.18181818181818182,11,10,AGTGAACAGGGCAATGGCCC,1,474194
araBp,0.6363636363636364,16,10,AGTAATGTAAGCTGCAATCT,6,472966
araBp,0.18181818181818182,11,10,AGGTATACGGAGAGTAGGTT,1,512132
araBp,1.5454545454545454,26,10,AGCGGCCTATTAGAAAGTGT,16,512211
araBp,2.727272727272727,39,10,AGCCCCGTTAAGAGTTTCCT,29,503494
araBp,0.18181818181818182,11,10,AGATGTTTGAAGCCCAGCTC,1,476150
araBp,1.4545454545454546,25,10,AGATGCTGTCGGGTACATGG,15,488177
araBp,3.1818181818181817,44,10,ACTTTCCCTGGTGGCACGTG,34,489244
araBp,0.18181818181818182,11,10,ACTTTAGTGATATGGAACAC,1,473048
araBp,1.2727272727272727,23,10,ACTGTTTGGCCTATGAGATG,13,482823
araBp,1.2727272727272727,23,10,ACTCTTCCCCGCAGGGGGTT,13,509289
araBp,1.9090909090909092,30,10,ACTCGCGTCACAACCCCCGA,20,477895
araBp,2.1818181818181817,33,10,ACTATGACGCGAAATCACAT,23,502071
araBp,5.2727272727272725,67,10,ACGTGGGCTGTACCGTGTTA,57,474853
araBp,2.6363636363636362,38,10,ACGAGGGAATCATCAAATAG,28,515004
araBp,1.4545454545454546,25,10,ACGAACCGCAGTGAGCTAAA,15,490549
araBp,2.6363636363636362,38,10,ACAGCTAACGGCTGTCAGTA,28,522529
araBp,0.18181818181818182,11,10,AATCTTATTCATGCACCCTA,1,499270
araBp,1.4545454545454546,25,10,AATCCTATTACTTTCAAGAA,15,493934
araBp,2.5454545454545454,37,10,AATAGGACGGGCGGCAATGA,27,485233
araBp,1.2727272727272727,23,10,AATACTTAACATGGCGCTAT,13,494529
araBp,2.1818181818181817,33,10,AACTCCCCCCTGGGTCCGTA,23,497762
araBp,3.090909090909091,43,10,AACGTGACGCAACACTTAAG,33,497980
araBp,2.6363636363636362,38,10,AACGGCGGGTTTCGTACTGT,28,502419
araBp,1.1818181818181819,22,10,AACCCCGAGTGCAATCTCGT,12,484403
araBp,1.2727272727272727,23,10,AACATCAAACACGCTCACGA,13,501708
araBp,1.4545454545454546,25,10,AACAGAAGCGGTTAGGTTTA,15,520633
araBp,1.7272727272727273,28,10,AACAATGATCCACTCAGTAC,18,476259
araBp,0.18181818181818182,11,10,AAAGGAGGCTCAAGGCACAG,1,469534
araBp,3.4,42,9,TTTCGGACCGGCGAAAAATT,33,521642
araBp,1.9,27,9,TTTCAATGTCGTACAGATAT,18,484301
araBp,4.4,52,9,TTTCAAAGGAGCGGACCTTA,43,513012
araBp,1.9,27,9,TTGTCCGCGTTTGTCTAGTG,18,469387
araBp,0.2,10,9,TTGGGGTTTCCATTTGCCTC,1,516350
araBp,1.8,26,9,TTGCGTGTTCAATGGTAGGT,17,517013
araBp,1.9,27,9,TTCCACCGTATGTGAAATAA,18,514383
araBp,0.2,10,9,TTATTTAACCTTACGGCACC,1,502622
araBp,2.5,33,9,TTATTAACATGGTCCCTCCT,24,485804
araBp,0.2,10,9,TTAGTAAGCTGCTCAGTTGT,1,498148
araBp,2.6,34,9,TTACGTAGCACGGCTTGGAC,25,473339
araBp,2.9,37,9,TTACGAGTAATACTGCCCAA,28,520676
araBp,0.2,10,9,TGTGGTTAGGGCACGCACCA,1,514289
araBp,3.5,43,9,TGTCCGTACGTCTGTGCCCA,34,469790
araBp,0.2,10,9,TGTATGCTTTAGCCATAGGC,1,476567
araBp,2.4,32,9,TGCTTGCGCTAGACTCCCCA,23,499209
araBp,1.8,26,9,TGCCATGATCCTGACTATCA,17,512379
araBp,0.2,10,9,TGATAGCTGATCGCGGTAAC,1,482939
araBp,2.0,28,9,TGAATGGGATGGAATGAGCT,19,487773
araBp,0.2,10,9,TCTGCTTACGTTATCCAACG,1,483599
araBp,2.1,29,9,TCTAGCAGGTGGTAGTAGAA,20,502334
araBp,2.6,34,9,TCGCCCGGTGGAAGGCAGGT,25,485439
araBp,2.1,29,9,TCCTTACACCATGTATCAGC,20,492036
araBp,4.2,50,9,TCCTCACGTAAGACGGGCAA,41,499771
araBp,2.9,37,9,TCATACCCGTCACTTCTTAC,28,497066
araBp,1.9,27,9,TCATAATAGGAATCTGCTGT,18,475973
araBp,2.0,28,9,TCACAAACTTCAGGTCGATA,19,502675
araBp,4.4,52,9,TATTTTGAAGCGAGTTCAAA,43,489792
araBp,1.2,20,9,TATAGGGGACGAAACGCAGG,11,498503
araBp,0.5,13,9,TATACTCGCTCATATGGGGG,4,485350
araBp,1.9,27,9,TAGCCTCAAATGTTCGAGAT,18,504463
araBp,1.7,25,9,TACGCATACCAGGGGGATTT,16,511037
araBp,0.2,10,9,TACGAATCTTCGGTGTCTGA,1,489595
araBp,1.4,22,9,TACAACGGGCTCTGGACTGA,13,503320
araBp,2.0,28,9,GTTTCCGCTCAATGTATGGT,19,522280
araBp,1.7,25,9,GTGTGCCTTGAGGCTGGTAA,16,472304
araBp,2.3,31,9,GTGCTCATCGTGTAATCTCA,22,524190
araBp,0.2,10,9,GTACGTAGGGTCTAGTAGTA,1,473289
araBp,2.6,34,9,GTACCATCATCTTCTGACCA,25,470747
araBp,2.3,31,9,GTAAGGATGCGTGCCGAGCA,22,469566
araBp,0.4,12,9,GTAAAACATCACTGCATTCC,3,510161
araBp,0.2,10,9,GGTTCATGAGGTTCCACAGG,1,477275
araBp,3.3,41,9,GGGGGGCTTTCGGAGTCAGC,32,475014
araBp,0.2,10,9,GGGGCTCGAGGGCCAAAGGT,1,493560
araBp,2.3,31,9,GGCTACGAATTACGCACCAT,22,518878
araBp,1.9,27,9,GGCGAACTTCGGACATCTCG,18,485934
araBp,1.7,25,9,GGCACAGTGCCTCGCACGGG,16,518405
araBp,1.5,23,9,GGATTAGTGTTTTATGCCAC,14,493489
araBp,7.9,87,9,GGATCGCGGGGTAGCCCCAA,78,475670
araBp,0.2,10,9,GGATCAGCTGTGGGCGTCCA,1,521331
araBp,0.2,10,9,GGAGACCCGCGCAAGACAAT,1,485967
araBp,1.2,20,9,GGACGGTACCACGAACCCCA,11,506273
araBp,8.9,97,9,GGACGCGCTGGACCCCTCCA,88,505412
araBp,0.2,10,9,GCTCCGTTGCTCTCTCCTGG,1,495961
araBp,1.8,26,9,GCTATCACGTTCCGTGAGCT,17,494253
araBp,2.2,30,9,GCGGTTCATAGCAGCAGTGC,21,483388
araBp,2.5,33,9,GCGGTTCACAGCCTAGCCGC,24,481286
araBp,2.1,29,9,GCGGTCTCAGTTTAAGAGAG,20,490554
araBp,0.2,10,9,GCGGTCGGAGCAAAACCGAG,1,518859
araBp,1.7,25,9,GCGCCTTGAGTATTTATGGC,16,518618
araBp,1.6,24,9,GCCCTTGAAAACGAGTATAC,15,502361
araBp,1.4,22,9,GCCCTACAGCGTGAGTAAGG,13,484000
araBp,2.2,30,9,GCCCGGTGAAGGCAACGTTT,21,485917
araBp,0.6,14,9,GCCCGACGCGGCGACCTGAA,5,488946
araBp,1.6,24,9,GCACTTTTGAATGCCATGCA,15,496810
araBp,1.6,24,9,GCACGTTACTTGACGAACCA,15,481925
araBp,16.8,176,9,GATGCGAGCTGAGATCAAAG,167,495876
araBp,2.2,30,9,GATCCTGGTGACTTACGAGT,21,482218
araBp,0.2,10,9,GAGTCTGGTGATCTAAATAG,1,484641
araBp,2.0,28,9,GAGGGAGCTTGAACGTTATT,19,473054
araBp,3.1,39,9,GAGGCACATACACATCACAA,30,478525
araBp,1.9,27,9,GAATTCACTATGAAAGAGGA,18,474139
araBp,1.2,20,9,GAATACGGACGTTCATTCCG,11,500814
araBp,1.5,23,9,CTTGATGGTCCAGGTATCTT,14,509342
araBp,2.9,37,9,CTGTGTGTGTGTGAGGAATC,28,513101
araBp,2.4,32,9,CTGAAGTAGTACAATTCTTC,23,473889
araBp,2.3,31,9,CTCTGGGATTGCCCATCGTA,22,480816
araBp,2.3,31,9,CTCTGACGGCTCAAATCTTA,22,518299
araBp,2.3,31,9,CTCTATTGAGGATTAGACCC,22,508275
araBp,1.3,21,9,CTCCTTTGTCAGTCGGCCAT,12,510415
araBp,1.0,18,9,CTCAGGCATTAAAGGCGCGA,9,518770
araBp,4.2,50,9,CTATTGGGTAAGCTAGACTA,41,468645
araBp,1.7,25,9,CTATCAGTACCCACCACATG,16,511751
araBp,2.6,34,9,CTAGCCGTCCATAGCGGCCG,25,473550
araBp,2.3,31,9,CGTTTAGTCAGGAGATCCTC,22,509982
araBp,3.3,41,9,CGTGACGTGATACGGCCTAT,32,517157
araBp,1.4,22,9,CGTCCACAATCAAAGTCTAT,13,481914
araBp,2.4,32,9,CGTAAGTACTCGAGCATGTG,23,506683
araBp,0.6,14,9,CGGTTGAAGTAGGTCTCCTC,5,469389
araBp,0.2,10,9,CGGGTATCGGGCTGTTTAAT,1,522561
araBp,0.2,10,9,CGGGGCTGAATAGGCCCTAA,1,515034
araBp,1.6,24,9,CGATTCAGTCGTCCGTAAGT,15,502085
araBp,1.7,25,9,CGAATACCATCCAGTATAAT,16,475474
araBp,1.8,26,9,CGAAGAACAAGCCGTACGCT,17,511939
araBp,3.6,44,9,CCTGTTAGGTGACTTAGAAT,35,520766
araBp,4.9,57,9,CCTGCCATGTTTCTCGCTAG,48,502155
araBp,0.2,10,9,CCCTGGATATGCTGCTACGA,1,484728
araBp,2.7,35,9,CCCGTTTAAGTCGCCCGCGT,26,482862
araBp,2.2,30,9,CCCGGCGCCTGCACCACAAA,21,515411
araBp,0.2,10,9,CCCGCAAGGCACCAGGTCAT,1,499700
araBp,0.7,15,9,CCCCGTCAGCCCGGAGAGCA,6,484896
araBp,3.5,43,9,CCAACGTTTGCCCGTTTCCT,34,483889
araBp,3.2,40,9,CATCTCTGCTAACAAGCCCT,31,473470
araBp,4.5,53,9,CAGTTACGCTCCAACCTGCA,44,480717
araBp,2.8,36,9,CAGATCTGGCCTCCTGGAGT,27,501229
araBp,3.5,43,9,CAGAAATCACAAGGCCAATA,34,476154
araBp,6.6,74,9,CACGGTCCTATCCGGTATTT,65,475824
araBp,2.0,28,9,CACGGTACGTGGAATAGTCC,19,489886
araBp,3.4,42,9,CACGCTAGGTCAAGTTTACT,33,482634
araBp,2.4,32,9,CACCTGATTTATCTTTTGAG,23,517211
araBp,2.6,34,9,CACAGTGGCAGTCAGGGCGG,25,469098
araBp,0.2,10,9,CAAACGTGAACTATTTGGTA,1,480405
araBp,1.9,27,9,ATTTTCGAACGTTTGCTGTA,18,477503
araBp,1.5,23,9,ATTTTCAGGACATCTTGGAT,14,506597
araBp,7.5,83,9,ATTTCGCGCAATCAGGACAC,74,476862
araBp,0.2,10,9,ATTCTGTGGAGATTTAGGCA,1,509642
araBp,2.6,34,9,ATCTTCGCTCTAGCTCGCAA,25,476314
araBp,3.0,38,9,ATCCACGACAAAAGTCCGCT,29,496799
araBp,0.2,10,9,ATCATATAGGTCGTGATTAA,1,516329
araBp,0.7,15,9,ATATAATGGGTTTTGCTCTA,6,503121
araBp,3.4,42,9,ATAGTTACAGATTGGGTGGA,33,468614
araBp,5.8,66,9,ATACGGCAAATCAGTATTGT,57,517858
araBp,0.2,10,9,ATACGAAGTACAAATACGTA,1,497715
araBp,2.0,28,9,ATAATTATTTTAGTACTCTA,19,516118
araBp,2.8,36,9,ATAAGGTAGGCCAAACTGAC,27,491003
araBp,2.1,29,9,ATAAGAATCTTTTCAGCGCT,20,492985
araBp,0.3,11,9,AGTTTCGGGGTTGCCCCCTG,2,501474
araBp,0.2,10,9,AGTAGACACTCGACATACTC,1,485739
araBp,0.7,15,9,AGGAAGGCATCGTTGGAGCA,6,494021
araBp,0.2,10,9,AGCTTAGCCGCTCTTTCCTG,1,483130
araBp,0.3,11,9,AGCTGGATGAGCGGGCATTA,2,519331
araBp,1.6,24,9,AGCGTTGGTAGGCACGGGCA,15,470615
araBp,3.0,38,9,AGCGCTTGGGCTGAAATGGA,29,486355
araBp,4.5,53,9,AGCACACCCATGCGTCAGGA,44,499900
araBp,2.8,36,9,AGATAGTCCGCACTCACTAC,27,481273
araBp,2.1,29,9,ACTGAAACGGGAGCAAGTCG,20,469674
araBp,1.9,27,9,ACCATAATTGTGCAAGAGAT,18,490552
araBp,2.4,32,9,ACACAGGATGAGAGTGTCCA,23,481020
araBp,1.9,27,9,AATTCGGCGCTTAAGTTACA,18,482631
araBp,4.0,48,9,AATTCCCGATATGGTCATTC,39,500727
araBp,4.5,53,9,AATGTGGACTTCAATCAGCT,44,472792
araBp,2.0,28,9,AATCCGCTCCCGTTGAATAG,19,506706
araBp,2.4,32,9,AATCACATTATCGTTTGGAC,23,517120
araBp,0.5,13,9,AATCAATCGGCGGATGTGTT,4,481690
araBp,2.7,35,9,AATATCGAGTACTGCGAACT,26,507148
araBp,6.6,74,9,AATAGATCGGCTACTACTTA,65,519901
araBp,2.4,32,9,AAGTAGCCTTCACGATGAGG,23,474878
araBp,0.2,10,9,AAGGTATCAGGTCTATTACT,1,492402
araBp,3.1,39,9,AAGCGGCCACATATACGCTC,30,487745
araBp,1.9,27,9,AAGCAGGCGTGGTTACAGCA,18,481686
araBp,1.9,27,9,AAGAAACTTGGTCGCGCCGA,18,484151
araBp,3.0,38,9,AACCCTCCGGGAATTAGTTA,29,494759
araBp,1.3,21,9,AACACGCATGGAGGGAAGCT,12,494687
araBp,1.5,23,9,AAATTGGATTCTGCCCTGGG,14,524073
araBp,3.1,39,9,AAATACTGCCCGTGCTTCCG,30,518407
araBp,3.8,46,9,AAAGGGAACGTGTACGTAAA,37,469869
araBp,8.333333333333334,82,8,TTTTAAATGGACAGCCATGT,74,509828
araBp,2.111111111111111,26,8,TTTCTCCGGTCGGAGACCAA,18,495624
araBp,0.2222222222222222,9,8,TTGTTTGCTGCTTCCAGTGG,1,511215
araBp,0.8888888888888888,15,8,TTGTGAGACCCGCCTAGCGT,7,503281
araBp,2.0,25,8,TTGTACCTTACCGTTACTCG,17,500831
araBp,0.3333333333333333,10,8,TTGGGGTTAGAATAGTGTCT,2,494764
araBp,1.3333333333333333,19,8,TTCCCTGTTATTGAGTGCTT,11,500034
araBp,0.3333333333333333,10,8,TTAGGTAGGTTGACTATGTC,2,506943
araBp,2.3333333333333335,28,8,TTAACCTTACAGTCGTGGAA,20,521804
araBp,1.7777777777777777,23,8,TTAAAAGAGTGGAGCTCTCG,15,468314
araBp,1.5555555555555556,21,8,TGTTCTAAACCATGGTACGC,13,522751
araBp,1.1111111111111112,17,8,TGTGAGCGTCTACCAACCGG,9,468300
araBp,3.3333333333333335,37,8,TGTGACTTGGCGGAGGCAAC,29,507035
araBp,3.3333333333333335,37,8,TGTGACTGTCTTCTAGGGCT,29,514131
araBp,2.2222222222222223,27,8,TGTCTAGAACATGTAAAAAG,19,498060
araBp,1.4444444444444444,20,8,TGGTCTAGTTGCCCCGCATT,12,500027
araBp,5.222222222222222,54,8,TGGCGCAGTCCGGACATCTA,46,473515
araBp,1.7777777777777777,23,8,TGCTGGGTACCGGCAATCAG,15,500095
araBp,1.8888888888888888,24,8,TGCTGCATATTGATATCAAT,16,513643
araBp,0.2222222222222222,9,8,TGCGTAAGGATTTTTAACAG,1,516850
araBp,1.4444444444444444,20,8,TGCCTTCCGATCTACCGGTG,12,509765
araBp,1.8888888888888888,24,8,TGCATAGCACCCTGTCTTAA,16,508656
araBp,5.222222222222222,54,8,TGAGCGGGCTTGACAAGATC,46,511099
araBp,2.3333333333333335,28,8,TGACTTCAACCGGTGGGCTA,20,519849
araBp,2.0,25,8,TGACCGCCCGCCTACTTCTT,17,503113
araBp,0.2222222222222222,9,8,TGAAAAGGGCCGCATTGTCC,1,490207
araBp,3.6666666666666665,40,8,TCTAGCGACCAGTATCGTAC,32,522627
araBp,2.5555555555555554,30,8,TCGTTGCGTCCATCCCGGCT,22,482778
araBp,2.7777777777777777,32,8,TCGTGGGCGACTTCTGTGTA,24,493637
araBp,8.88888888888889,87,8,TCGTATCGAGTAGTGTGTTT,79,510814
araBp,0.2222222222222222,9,8,TCGCCACTCTTCCCACCCGC,1,503819
araBp,1.3333333333333333,19,8,TCGATATTTTGAACTCGACA,11,491535
araBp,1.4444444444444444,20,8,TCCCTGTTTTTCTAGGAGAG,12,525042
araBp,5.888888888888889,60,8,TCCCGAAGCTACGGAGGGGA,52,480831
araBp,2.5555555555555554,30,8,TCATTACAGACTAAGCTTAA,22,520363
araBp,6.0,61,8,TCATGATGCCGTACCACGCT,53,524430
araBp,4.444444444444445,47,8,TCACACTTTTTTGGTTTCGC,39,491121
araBp,0.2222222222222222,9,8,TCAATTAGAGTGGATTCACA,1,493933
araBp,6.444444444444445,65,8,TATCCTTCGTTAACGCGCAA,57,511105
araBp,4.777777777777778,50,8,TAGCAGGAGTTTTGACAGTT,42,484648
araBp,2.4444444444444446,29,8,TAGAGGCCAACTGTTACGCT,21,508432
araBp,3.0,34,8,TACTGAGCTAATTCGACGAT,26,478624
araBp,4.666666666666667,49,8,TACCTACTTCCTCCTGTTGA,41,522006
araBp,2.4444444444444446,29,8,TAATAGGCCATCGGGCTAAC,21,480099
araBp,2.2222222222222223,27,8,TAAGCAATATTGATACAAAA,19,498940
araBp,1.7777777777777777,23,8,GTTTCTAAACATGTATTGGA,15,477107
araBp,4.333333333333333,46,8,GTTACTCCTGAGTTACCAGC,38,520859
araBp,2.3333333333333335,28,8,GTGTATCTCCCGAGGAGAAT,20,498163
araBp,2.0,25,8,GTGCAACTATCCCCGAGCGT,17,482573
araBp,2.5555555555555554,30,8,GTCATACCCACCATGGGGCT,22,502730
araBp,2.4444444444444446,29,8,GGTATTGATAGCTGTGACAC,21,472461
araBp,1.1111111111111112,17,8,GGTAGGCTGGGAGGCTTTAT,9,491562
araBp,1.1111111111111112,17,8,GGGTCGGGCACACGCTGGGA,9,484258
araBp,4.555555555555555,48,8,GGGTATTGATTCGATCACTC,40,471683
araBp,2.5555555555555554,30,8,GGGCGTGATCCGTTGACTAT,22,518406
araBp,3.888888888888889,42,8,GGGCGCATCGGGTCCGTCAA,34,468751
araBp,0.2222222222222222,9,8,GGCGCGGCATCGTGGGAAGA,1,513773
araBp,0.2222222222222222,9,8,GGCCTTAGGTTTAAAGGTTC,1,497424
araBp,2.5555555555555554,30,8,GCTTTGTCACACCTCTATCA,22,502323
araBp,8.444444444444445,83,8,GCTTGGCCCCTGCGTCCGAA,75,523090
araBp,3.0,34,8,GCTGAAGTCACAAATACGAA,26,473965
araBp,2.888888888888889,33,8,GCTCTCTATATTGCTACCAT,25,511182
araBp,9.777777777777779,95,8,GCTCATTGTGTGGAACACAA,87,518646
araBp,0.2222222222222222,9,8,GCTCATTGACATCGTAGGAG,1,513512
araBp,5.777777777777778,59,8,GCGGGGCATCACTTCCCGTT,51,494237
araBp,3.4444444444444446,38,8,GCGGAATGAGGGTGCTTAGG,30,518488
araBp,2.111111111111111,26,8,GCGACTCAGTGCGTGCCAAC,18,484472
araBp,0.2222222222222222,9,8,GCCTGTCGATACGTGTTGTG,1,495720
araBp,0.2222222222222222,9,8,GCCTCAACCCGTGTGACATG,1,510137
araBp,1.8888888888888888,24,8,GCCAACAGCCAAGCATGGAT,16,525257
araBp,1.1111111111111112,17,8,GATCCCCGAGTTCTGTCTTT,9,482812
araBp,2.2222222222222223,27,8,GAGGCGAACTTCAACCTGTT,19,518624
araBp,6.666666666666667,67,8,GAGAGGAGAAATATTACAGT,59,512594
araBp,3.2222222222222223,36,8,GACTCCCTGGCATTGATTTA,28,476133
araBp,2.888888888888889,33,8,GACGTAGGCAACCTAGAAGA,25,500882
araBp,4.333333333333333,46,8,GACCGGAAGTTCGCGGATTG,38,481157
araBp,0.2222222222222222,9,8,GAAGGTCTTTTGTAGGACGG,1,495258
araBp,1.7777777777777777,23,8,GAAAAACGCGACTCAGACGT,15,479776
araBp,1.6666666666666667,22,8,CTTCGGAATGCATACTTGCA,14,488178
araBp,2.6666666666666665,31,8,CTGTCTACTGATCTATGATC,23,478140
araBp,10.333333333333334,100,8,CTGTCGTTGGATCCTAGCAT,92,511098
araBp,0.2222222222222222,9,8,CTGGGCGCTATTATGCTATA,1,503983
araBp,3.0,34,8,CTGGGAGGACGACGAGGGCA,26,484360
araBp,1.5555555555555556,21,8,CTGCGGTAAAACAGTAGACC,13,491699
araBp,3.0,34,8,CTGAGTGCACTGGTCCCGCT,26,496408
araBp,2.7777777777777777,32,8,CTCGGTAACCGCCGAAACTG,24,520632
araBp,2.888888888888889,33,8,CTCAGATCATTGCCTGCCGT,25,507349
araBp,3.2222222222222223,36,8,CTCACGCCACTCCATCATAA,28,481972
araBp,4.555555555555555,48,8,CTCACACATCTCTTAATGTA,40,473793
araBp,0.3333333333333333,10,8,CTATTTTGATGAGGCAGTAG,2,470761
araBp,3.2222222222222223,36,8,CTAACCCAGACACCAAGGTA,28,498782
araBp,2.5555555555555554,30,8,CGTTTGGCTTACGTGGCATT,22,472912
araBp,2.6666666666666665,31,8,CGTGCTGAGCAGCCTATCGC,23,484105
araBp,2.888888888888889,33,8,CGTGAACGGGTGTTGTCCAC,25,512917
araBp,3.3333333333333335,37,8,CGTCTAGCACACAAGCGATT,29,480022
araBp,3.111111111111111,35,8,CGGTTAGCAGTCGAGTTCCT,27,486451
araBp,2.888888888888889,33,8,CGCTTTCTCAGGCGTACAAC,25,510227
araBp,0.2222222222222222,9,8,CGCAGTCATTGATTCTTTCG,1,485851
araBp,3.4444444444444446,38,8,CGCACCCTGATCCGCAACTC,30,503835
araBp,2.0,25,8,CGAGTAGGTACTAGGGACGA,17,515919
araBp,4.0,43,8,CGAGCGAAGTCCTATAGGGT,35,505977
araBp,2.7777777777777777,32,8,CGAGACCCAGTCCGGCATTA,24,469564
araBp,3.7777777777777777,41,8,CGACTTCAGACGGCTTGCAG,33,490621
araBp,1.7777777777777777,23,8,CGACCGGATTCAGACTGGGG,15,518619
araBp,2.3333333333333335,28,8,CGAAGGCTGATGAATGCTGA,20,483861
araBp,2.888888888888889,33,8,CGAAGCAAATCAATTGACGA,25,513496
araBp,2.3333333333333335,28,8,CCGATAAGGTTACGGCAGGG,20,493580
araBp,2.6666666666666665,31,8,CCCTGCTACGAAGCGGGAGG,23,510557
araBp,5.0,52,8,CCCAGATAGGTCGAGTGTAT,44,494841
araBp,2.3333333333333335,28,8,CCCAATAGATTGAACTCACG,20,499203
araBp,2.2222222222222223,27,8,CATTGTTAACGAGACAAAAA,19,484054
araBp,0.2222222222222222,9,8,CATGTTAATGCATTCCAGAG,1,492186
araBp,1.5555555555555556,21,8,CAGTGTGAGCGACGTGAAAT,13,520045
araBp,2.0,25,8,CAGTGGTCAGCAACGGTGTA,17,504237
araBp,4.444444444444445,47,8,CAGTGCAAATAATGGGACAG,39,488493
araBp,0.2222222222222222,9,8,CAGGTGAGATAGTTACGTTT,1,469013
araBp,2.5555555555555554,30,8,CAGGGCGGTACATCTCTACT,22,475776
araBp,0.2222222222222222,9,8,CAGGGAGTGCCATAGTCGTC,1,489400
araBp,2.2222222222222223,27,8,CACGGACTATACGCCTTCAC,19,513450
araBp,1.5555555555555556,21,8,CACAAGTCTATGGCCTCTGG,13,487285
araBp,7.888888888888889,78,8,CAATTCAGTAGCTGGACCTG,70,500903
araBp,2.7777777777777777,32,8,CAAACGGATTCAGGATGCCA,24,483893
araBp,2.0,25,8,ATTTCCAGAAATAACACACT,17,498589
araBp,3.0,34,8,ATTGTGGAGCCTTAAATTAC,26,483805
araBp,3.0,34,8,ATTCCGGGCTGAATAAGTAA,26,484986
araBp,2.7777777777777777,32,8,ATTCATATGTGTCAGTCGTC,24,473411
araBp,2.888888888888889,33,8,ATTAGACTCGACAATAAATA,25,480509
araBp,1.8888888888888888,24,8,ATTACACTGTTCCATAGAAG,16,498859
araBp,0.6666666666666666,13,8,ATGTGCTAATCGGCCACGCT,5,483998
araBp,2.0,25,8,ATGGAACATGTTACCGTTTA,17,501241
araBp,2.4444444444444446,29,8,ATCTGTTAAGCTTGGCTCGG,21,472112
araBp,2.888888888888889,33,8,ATCTCATACGTTCTGAATTA,25,475980
araBp,2.5555555555555554,30,8,ATCCTCTATGGGGGGCTCTA,22,498080
araBp,2.111111111111111,26,8,ATCCCCGCGTACGAACCCGT,18,517960
araBp,1.1111111111111112,17,8,ATCCATGGGTCAATGTTGTC,9,476840
araBp,0.2222222222222222,9,8,ATACACTTATCCGTTATTCC,1,509733
araBp,3.2222222222222223,36,8,ATAAGATTTCGACCGTCTCC,28,475956
araBp,0.2222222222222222,9,8,ATAACCCGAGATCAGTATAA,1,500567
araBp,1.7777777777777777,23,8,AGTTATGCCAAGGAGGTTAG,15,495073
araBp,2.2222222222222223,27,8,AGGAGATTGGTCGTGAACCT,19,480266
araBp,0.2222222222222222,9,8,AGATCAACGACAACACAATC,1,502400
araBp,0.2222222222222222,9,8,AGACAAGTACAAGGTTCACT,1,513695
araBp,2.0,25,8,ACTTAAGAAATTAGCTCGGT,17,479057
araBp,2.2222222222222223,27,8,ACTCAAGATTTCAGGCAATT,19,516109
araBp,0.2222222222222222,9,8,ACGGGGTGAGGTGCGATTGA,1,517561
araBp,0.7777777777777778,14,8,ACGCATCAGGCAAAGGACAC,6,479486
araBp,1.0,16,8,ACGATGAGGGGGTTCAGTAA,8,474603
araBp,3.2222222222222223,36,8,ACGAATGGTCCCAGATGCTT,28,510136
araBp,2.3333333333333335,28,8,ACGAACGGGCACTCCGAAAG,20,485241
araBp,4.555555555555555,48,8,ACCGCGCTCGGCCACTTCTC,40,512775
araBp,0.2222222222222222,9,8,ACATAGTGCCTCTCTGTATA,1,483598
araBp,2.111111111111111,26,8,ACACTTGTCGTTGGCCGAGT,18,479362
araBp,2.111111111111111,26,8,ACACTACAAGGTCCATAGTC,18,509068
araBp,12.222222222222221,117,8,ACAATCTAAGCTTCACGACA,109,494663
araBp,2.7777777777777777,32,8,AATGCCTTCATCAATTCAGT,24,514244
araBp,5.111111111111111,53,8,AATAGTTATATCTCGCATGC,45,475781
araBp,1.5555555555555556,21,8,AATACCTGCTCTGGTGTTCG,13,503062
araBp,0.3333333333333333,10,8,AAGTTGCTAGTGACGATACA,2,486068
araBp,2.2222222222222223,27,8,AAGCGTCAGGAACAGGGCAA,19,482343
araBp,4.444444444444445,47,8,AAGCGGTTCGCCGTGGAAGT,39,505203
araBp,0.3333333333333333,10,8,AAGATGAGATCTTCGGCCCC,2,518732
araBp,1.6666666666666667,22,8,AACTGCCGCCACCGGGTCGG,14,469300
araBp,3.3333333333333335,37,8,AACGCGCGCGAGACGTCGTA,29,524323
araBp,0.2222222222222222,9,8,AACATGACAAATTAATGCTT,1,491419
araBp,2.4444444444444446,29,8,AACAACGCTACGCCAGAAGA,21,498369
araBp,2.5555555555555554,30,8,AAATTGTGTGGGAACAGCTT,22,470400
araBp,2.0,25,8,AAAGTTACGTTACCTGTGGG,17,487571
araBp,3.7777777777777777,41,8,AAAGACAAGACCGGCTAAAC,33,468386
araBp,7.444444444444445,74,8,AAACGTTCCATACGAGGATA,66,503967
araBp,1.1111111111111112,17,8,AAACGTCTTATGGTAACTAG,9,520566
araBp,3.111111111111111,35,8,AAAAAAAATTAGGTAAGAAT,27,469147
araBp,2.75,28,7,TTTTGCCTGTGCTAATTGTG,21,497763
araBp,1.125,15,7,TTTTGCCGGCAAAGATGGTT,8,481449
araBp,3.125,31,7,TTTGATATCTAACTTCGCAA,24,519147
araBp,0.25,8,7,TTTCTAGCGAACCAGAGATC,1,486811
araBp,0.25,8,7,TTTCGAATTATAGCGAGGGC,1,484854
araBp,1.375,17,7,TTGGTTTTTCAAACCGCGCA,10,477348
araBp,2.25,24,7,TTGCCCGAACGCGCTTGGTG,17,492955
araBp,1.625,19,7,TTCTAGACGATCCTATTATT,12,469276
araBp,1.5,18,7,TTCGGATGTATGATGCGACT,11,476879
araBp,4.25,40,7,TTCCCGAGCAGTTAAGGCGA,33,520741
araBp,2.875,29,7,TTAGGCGGCCGTTCGTCACA,22,489243
araBp,2.5,26,7,TTAAGTAATTGGGAACACAT,19,511702
araBp,0.25,8,7,TGTGCAGGCAAAGGATATGG,1,492071
araBp,1.125,15,7,TGTCTTTTTGCTTTATTAAT,8,513873
araBp,2.5,26,7,TGTCGTTCCAATGGTGCCGG,19,476367
araBp,0.25,8,7,TGTAATTTTACCCCTGTAAA,1,479690
araBp,2.625,27,7,TGGTAGTTCCTCAGAATGCA,20,501476
araBp,0.25,8,7,TGGGGCGAAGCGGCAGCGGT,1,517737
araBp,6.625,59,7,TGCTATCCGAAACTCCACAT,52,498636
araBp,1.5,18,7,TGCGTAAATCGCTAAGATTA,11,509381
araBp,0.25,8,7,TGCCCGGGTTTTTGTTACCG,1,493046
araBp,2.25,24,7,TGCAACAAAAAAGATGCGCA,17,477519
araBp,2.75,28,7,TGATAATGTCTGAATGATGA,21,501600
araBp,2.625,27,7,TGACGCACGCCGCGCAGGAC,20,477141
araBp,3.375,33,7,TGAACTAACGTCCAGTGGAT,26,524443
araBp,0.25,8,7,TCGCCGTTGGATATCCGCTC,1,479060
araBp,2.375,25,7,TCCTGCATCGGGAGACTTAA,18,467977
araBp,3.125,31,7,TCCGTACCAGTGCATACACA,24,497579
araBp,8.0,70,7,TCCCTGCTAAGTAGGTTGTT,63,507408
araBp,3.125,31,7,TCCCAGGTCGCACAGCAGCA,24,504356
araBp,5.875,53,7,TCAGGTCCGGGGAGATCGTG,46,480551
araBp,9.0,78,7,TCAACCCGCACATCCGGCAA,71,521285
araBp,2.125,23,7,TATTACTTTCACCGTTAGAG,16,510538
araBp,0.25,8,7,TATGTGCAGCCATGGCGGGA,1,521893
araBp,2.375,25,7,TATCGATACCAGGGCTGATT,18,510676
araBp,3.0,30,7,TATCCCAGAAGCCATGAAGG,23,500982
araBp,2.125,23,7,TATAGAGTATTCCGTACCTG,16,487118
araBp,5.375,49,7,TAGAGGCCAGACTCTCAAAT,42,476403
araBp,6.625,59,7,TACCCACGCATGCGGCTGCT,52,502655
araBp,2.5,26,7,TAAGGGGGCCACCCGCATTC,19,502530
araBp,2.25,24,7,TAAATTTCGCTCGTACCGTG,17,481034
araBp,2.75,28,7,TAAAGAAGAGCCCGGATCTA,21,491008
araBp,0.25,8,7,GTTTCCTATTACAATCTATG,1,520012
araBp,1.25,16,7,GTTGGGCCAATAGAATCCCT,9,510096
araBp,2.5,26,7,GTTGGGACTAGGGTTAGTAC,19,494115
araBp,1.75,20,7,GTTCTTAGGGCACGTTGGCG,13,481935
araBp,1.75,20,7,GTTCTAGGACAGCGTCGTTT,13,491731
araBp,2.875,29,7,GTGTGAACGTGATAACATAT,22,475877
araBp,0.25,8,7,GTGTCGCACAAAAGTACTCC,1,507805
araBp,2.375,25,7,GTGTACCATGGAGCCTGTTG,18,521319
araBp,1.875,21,7,GTGCGGCGCTAAAAGGAAGC,14,522198
araBp,1.375,17,7,GTGCCTAAACATGTTATAGT,10,503704
araBp,1.25,16,7,GTGCCCATGATGCTGACGTG,9,484027
araBp,3.375,33,7,GTGAGCAGTGAGCCCGCCGT,26,519958
araBp,5.125,47,7,GTCTTAAGCCCAAGTGGTAG,40,478740
araBp,3.5,34,7,GTCTGTACTTACATGGTCCA,27,491667
araBp,2.25,24,7,GTCCTGCAGTCCGTCATCGC,17,513640
araBp,0.25,8,7,GTCCGCCAGCGATTATTGCA,1,482111
araBp,3.5,34,7,GTAGGAGAATGTGTAGTCGG,27,470307
araBp,4.125,39,7,GTAGATCACAGGGTGACAGG,32,491942
araBp,2.0,22,7,GTACCCAATATCTCTCGTTA,15,522586
araBp,2.625,27,7,GTACATTTAAAAGCTATGGC,20,476995
araBp,0.25,8,7,GTAAGTGGGTTTCGCTCGGC,1,503191
araBp,1.875,21,7,GGTGGTCTCAGCCGAATTGC,14,474227
araBp,1.875,21,7,GGGTGACAGCCGTGGTTATT,14,516077
araBp,1.875,21,7,GGGTCTGTGAAATCGGAAGG,14,481865
araBp,3.75,36,7,GGGGGACTCCCTTGGCGCAG,29,505284
araBp,2.625,27,7,GGGCGTGAGCATCATATTAA,20,495555
araBp,3.125,31,7,GGGCCTTGAAGAGGTCTGTA,24,487094
araBp,5.5,50,7,GGGATGGAGTCTACGCTCCT,43,501461
araBp,2.125,23,7,GGCGTAGTACTGGGCTTCGT,16,510906
araBp,1.75,20,7,GGCCGAGATTTACATGCGCA,13,468438
araBp,6.75,60,7,GGCACACCACTCGCGTTTGT,53,492366
araBp,1.375,17,7,GGAGGCTACCCAAACTCGTG,10,494402
araBp,3.0,30,7,GGAGAAATATGTCGGGTCAT,23,501887
araBp,3.5,34,7,GGACCGAGGCTTACGAAGAT,27,520705
araBp,0.25,8,7,GGAATAGCTGGTAGCCTCTC,1,513911
araBp,1.75,20,7,GGAAATGGTCCGTACTGACG,13,494020
araBp,2.125,23,7,GCTTTCGAGACTCCACTTGC,16,491689
araBp,7.625,67,7,GCTCACAGATCACAACACCT,60,508715
araBp,5.5,50,7,GCTATTTTTAATCGTCTTAT,43,510969
araBp,0.25,8,7,GCGATCAAGTTAAGTGGGAT,1,472419
araBp,0.25,8,7,GCGAGACCTATTAGATGAAG,1,472721
araBp,3.375,33,7,GCCTAGGATGCCGTCGCCTA,26,483978
araBp,0.25,8,7,GCCCCCTGGAACGAATTCCC,1,494893
araBp,5.125,47,7,GCCAGACAGGTACAACGTGT,40,477046
araBp,1.375,17,7,GCCACGGCGAGGGAGGGTCT,10,485659
araBp,0.25,8,7,GCAGCTCCTTGCGGAGGGAG,1,473447
araBp,2.0,22,7,GCAGCCGCGGGCGGTTTCGG,15,470626
araBp,1.875,21,7,GCACTGGGAGTCAGGAGCAT,14,479268
araBp,8.25,72,7,GCACTAACGAGCTGCATAGC,65,523707
araBp,1.5,18,7,GCAAGTGTGTATAAGGGCGG,11,504616
araBp,0.25,8,7,GATTAGGATCGGGCTATCCG,1,469617
araBp,2.625,27,7,GATGAAGGTCTTAGATTCGT,20,476166
araBp,1.875,21,7,GATCTAGATTGATGGGTAGC,14,495797
araBp,0.25,8,7,GATCCAGAGGGCCGATTAAA,1,490571
araBp,2.75,28,7,GATAGAGTTACCCCAGCTGT,21,514680
araBp,3.25,32,7,GAGGGATATGCCCTCTCCTA,25,501013
araBp,2.625,27,7,GACTTATCCCTAGAACAGCA,20,520044
araBp,1.25,16,7,GACCGTTGTATAGCTATGCC,9,502972
araBp,0.25,8,7,GACAGCCGCGCGTTCCCAAG,1,481873
araBp,4.375,41,7,GAACGAATATTGGGACATAT,34,492234
araBp,1.5,18,7,GAAACACACTTAAGACGGTA,11,473663
araBp,3.125,31,7,CTTGGCCGGCATATGTACAA,24,489032
araBp,1.625,19,7,CTTGCGTCCATAGACGTTGG,12,512993
araBp,2.0,22,7,CTTCCGAGGAGCCGTGCGGA,15,512689
araBp,3.625,35,7,CTGTGGAATGGACGGCTCGT,28,485799
araBp,2.625,27,7,CTGTCACTTGCTACAGGTGT,20,471626
araBp,1.875,21,7,CTGGCGTCACCAGTTCCGAC,14,500457
araBp,2.5,26,7,CTCCTCTTTTCATGTACAGC,19,499185
araBp,8.625,75,7,CTCCGTTGCGTTAATTACAC,68,504922
araBp,0.25,8,7,CTCCACCTATCTCGCATGAC,1,494695
araBp,2.0,22,7,CTCAACATTCCGGAACTGGG,15,473857
araBp,2.625,27,7,CTAGTTAATTGAACTAATTA,20,504876
araBp,1.625,19,7,CTAGTGTAGTCCTATCTTAG,12,519558
araBp,1.75,20,7,CTAGCCACACGGCTAGCGGA,13,467784
araBp,4.125,39,7,CTACCCGGGGCATTAGGAGG,32,472411
araBp,3.0,30,7,CTACACGATCTTTGCACTTG,23,495574
araBp,3.0,30,7,CTAATGCGTATAGAGGAATT,23,523250
araBp,3.625,35,7,CTAAGTTAGCTTGGCGCCTG,28,509338
araBp,0.25,8,7,CTAAATCTAATCGGTTGCAT,1,509009
araBp,1.5,18,7,CGTTGCGTGCGGTCCATTTA,11,485559
araBp,2.625,27,7,CGTTAAACCTGGGCACGCTG,20,497926
araBp,1.25,16,7,CGGGACTCTACCACACGACG,9,468244
araBp,3.75,36,7,CGGCTTCCCTGCATAGGCGT,29,480512
araBp,2.0,22,7,CGCTTTATGCAACACTGCCC,15,496666
araBp,2.75,28,7,CGCTCGAGGAGTCGCGATTA,21,489300
araBp,7.75,68,7,CGAGTGACATGCCTGACTGA,61,476687
araBp,0.25,8,7,CGAGGTCTGGTCCGTCCGCT,1,476482
araBp,4.5,42,7,CGACCAGTGCGATCAAAAGG,35,473521
araBp,0.375,9,7,CGACAGCACCGGGCTTCAGC,2,472967
araBp,4.0,38,7,CGAAGGTGTATTGCTGTATT,31,490105
araBp,2.875,29,7,CGAAGCCCACGGCGTCGCGT,22,481705
araBp,3.75,36,7,CCGTTTTAGGAATGCCCTTC,29,472955
araBp,4.0,38,7,CCGTACGACCCCAGATTCAC,31,493712
araBp,0.25,8,7,CCGGGATCTTAGATATCCTC,1,515935
araBp,0.25,8,7,CCGAGGTTAAATAGGTCCAT,1,510974
araBp,4.625,43,7,CCGAGGTGAGGCGTCCTTAT,36,498270
araBp,1.875,21,7,CCGAAGACTACGTCCTTTTA,14,519526
araBp,3.75,36,7,CCCGGCTAGGGGTTAACAGT,29,523427
araBp,3.375,33,7,CCCAGCATTGAAATGGCAAC,26,498953
araBp,0.25,8,7,CCATACCTTGAGCCCTATTC,1,512449
araBp,3.625,35,7,CCAGGTTAATTAGGTATACG,28,512302
araBp,2.0,22,7,CCACATGTGGGCAGCCGAGA,15,477914
araBp,1.0,14,7,CCAAGGATGTTATTGGCACC,7,488030
araBp,3.875,37,7,CATTTACGGATATATAAGTC,30,472479
araBp,4.375,41,7,CATAGTAGTCTTGTTGTGGC,34,505202
araBp,2.5,26,7,CAGGCTTAAGAAGTTGTAAA,19,475536
araBp,1.375,17,7,CAGCTTGCTGGTCTAGAGTT,10,471946
araBp,3.0,30,7,CACTTTCACTTCCGCGTTAA,23,505782
araBp,4.0,38,7,CACTGGTAAGTAAAGACATA,31,486257
araBp,2.375,25,7,CACCGACCCCCTTTGCCCCC,18,473423
araBp,0.25,8,7,CACAAGTGCTAGCTCTTAAG,1,497610
araBp,4.125,39,7,CACAAACTTTACTCTTACCT,32,482334
araBp,4.0,38,7,ATTTGGTCATACATACCGGC,31,521868
araBp,2.125,23,7,ATTGTCAACACGCGTTGGAT,16,509234
araBp,0.5,10,7,ATTCCATTTTTAGTGGTAGT,3,516925
araBp,3.875,37,7,ATTCAATAGTATTGGTACGC,30,525376
araBp,2.125,23,7,ATTCAAGCTGCTCGCTAAAG,16,495629
araBp,0.25,8,7,ATGCTATAGCGGAGCTCGCA,1,493732
araBp,2.75,28,7,ATGCGTCTGTGAAAACTGAA,21,474741
araBp,0.25,8,7,ATGATACCAGTAGGGCCGTG,1,522131
araBp,0.25,8,7,ATCCAAAATGAAATAGCGTA,1,480688
araBp,2.375,25,7,ATCAATACATTAGACACCGA,18,498070
araBp,1.5,18,7,ATATGATATGAGAGCTCTCT,11,484357
araBp,2.375,25,7,ATAGTTTGATCTCGTAGATG,18,500215
araBp,3.25,32,7,ATAATAGAGAGATTCCAATA,25,487680
araBp,2.625,27,7,ATAAATCACATCAATGCCTA,20,508744
araBp,0.25,8,7,AGTTGCCTGAGCCGTATCGA,1,501393
araBp,2.625,27,7,AGTGTTTGGGAACACAGCTC,20,506763
araBp,0.25,8,7,AGTGTAATCAAGAGTCGGTC,1,503503
araBp,3.875,37,7,AGTGGCAGAGTCTAAGCCCT,30,509495
araBp,2.5,26,7,AGTACCCAGATATTCAGGCA,19,486475
araBp,9.5,82,7,AGGTTCGGGTGTGTTTGCTC,75,519948
araBp,6.125,55,7,AGGTGTTTATCCCAGCCTCA,48,517859
araBp,6.25,56,7,AGGGTGAAACGAGACTAGGC,49,524934
araBp,2.125,23,7,AGGCCCTCAGGAGCCATTAT,16,503832
araBp,2.75,28,7,AGGAGTGATGGACCACTTCG,21,504784
araBp,3.25,32,7,AGCTTTAGCCTCGAAACCGG,25,513404
araBp,3.25,32,7,AGCTGGTCGCATCGATGGTA,25,493066
araBp,3.625,35,7,AGCTAGGGACGTGACTGGCA,28,494063
araBp,4.375,41,7,AGCGACCGGCTACGGGGGAC,34,510551
araBp,0.25,8,7,AGCAGGCGCCCCCAGGTTAC,1,509678
araBp,2.75,28,7,AGCACGGCACGTGTCCGGGG,21,515241
araBp,3.0,30,7,AGCACCGAAGTTCTACGAGT,23,514797
araBp,3.0,30,7,AGAGGCTGAGAGGGCATTAA,23,479546
araBp,9.5,82,7,AGAAAGTGATGGTATCGGAA,75,517102
araBp,0.5,10,7,ACTTATCTCAGGGGTCTTAT,3,505373
araBp,6.375,57,7,ACTGGCAGACTTCACAGGGC,50,516520
araBp,5.375,49,7,ACTCTAGATCTGCGTAAGGT,42,516303
araBp,2.75,28,7,ACTCATACCAGATTAACGTC,21,479511
araBp,5.75,52,7,ACGGCATCTTAGCGTCTAAG,45,477903
araBp,2.375,25,7,ACCCTCAAGCTCTGAGAGAA,18,524556
araBp,1.75,20,7,ACCACATGGGGAACCTATTA,13,522979
araBp,2.875,29,7,ACATTTTAACAGCTCATGGA,22,503540
araBp,2.875,29,7,ACATAACGAGGAATGTGTGC,22,477627
araBp,3.75,36,7,AATCGTGCGGTCTGAGCACG,29,476587
araBp,4.25,40,7,AAGGATGTTCGATCCAATAG,33,515812
araBp,0.25,8,7,AACTCAAGTGACATCTAATA,1,492772
araBp,5.125,47,7,AACGTGCACATTTTCCTAAA,40,519466
araBp,2.875,29,7,AACGCGCCGAGTCTACTACA,22,520537
araBp,3.375,33,7,AACAGACATACGAAGGTGGA,26,511511
araBp,2.875,29,7,AACAACAGAGGCACTGTCAG,22,479566
araBp,3.375,33,7,AAACAAAAGTAAATTAATGG,26,486717
araBp,3.5714285714285716,30,6,TTTTGCTGACCACTTTCCTT,24,474682
araBp,7.0,54,6,TTGTGTCTTCACATGGATAC,48,499831
araBp,4.428571428571429,36,6,TTGGCTTTAACGGGATGGGT,30,477991
araBp,1.8571428571428572,18,6,TTGCTCATAGAGCGTTCAAG,12,477271
araBp,3.4285714285714284,29,6,TTGACACAGGGCTTGCAGCG,23,472056
araBp,2.4285714285714284,22,6,TTGACAATTCGTCTTGGGCG,16,491473
araBp,6.428571428571429,50,6,TTCTGGGAAGCTCCGTGATC,44,519644
araBp,5.857142857142857,46,6,TTCGAAAAGAGCCAGAGCGT,40,479884
araBp,0.2857142857142857,7,6,TTCAGGCACATTCCGTGACA,1,519006
araBp,2.857142857142857,25,6,TTATCTCTAGTCGGGTGATT,19,482718
araBp,3.7142857142857144,31,6,TTATATCCCCAAGGGCTGCT,25,489403
araBp,5.0,40,6,TTAGTATAATCGTTGGCAAT,34,482282
araBp,5.0,40,6,TTAGCCGAAAACGAAACTTT,34,509140
araBp,4.285714285714286,35,6,TTACTACGTTTACGGAAGCA,29,524364
araBp,1.7142857142857142,17,6,TTAAACACAGGCCTTCTGAA,11,481112
araBp,7.0,54,6,TGTCGCGATCTGATTGGCTG,48,474283
araBp,3.142857142857143,27,6,TGTCGCCATATATGTCTGAG,21,475856
araBp,4.857142857142857,39,6,TGTAGGTGCGTCAGCCGAAT,33,484017
araBp,3.2857142857142856,28,6,TGCTCACTTGCGAGGGCTTA,22,484541
araBp,3.7142857142857144,31,6,TGCGAGCGCAGGCCACCTCA,25,492818
araBp,3.5714285714285716,30,6,TGCCTTCCGAGTAAAACTTT,24,505761
araBp,1.2857142857142858,14,6,TGCCTGGTGTATCCTCTTAG,8,483705
araBp,3.2857142857142856,28,6,TGCCATTTTTAGGTCACATC,22,517022
araBp,4.285714285714286,35,6,TGAGTGCATAAGAATTTGGT,29,487227
araBp,3.2857142857142856,28,6,TCTTGGCTAATGACTTACAG,22,488288
araBp,3.4285714285714284,29,6,TCTTGATCACGACTCTCTGG,23,481786
araBp,2.4285714285714284,22,6,TCTGTCTAAGCCCACAAGAA,16,508690
araBp,2.857142857142857,25,6,TCTGGTCGTGGATAACCGTG,19,502107
araBp,4.285714285714286,35,6,TCTCAGATGTTAGTATTGCT,29,490215
araBp,11.571428571428571,86,6,TCGGTTCTATCCTAAAAAAG,80,472175
araBp,6.571428571428571,51,6,TCGGCGGAACCCATCGTTAT,45,500784
araBp,2.857142857142857,25,6,TCGACTCAGCGCGGGCCGAA,19,524409
araBp,0.2857142857142857,7,6,TCAGGAAGCGGTACAGCCAC,1,486293
araBp,3.857142857142857,32,6,TCACTATTTCGGCCTTTCGA,26,500543
araBp,0.2857142857142857,7,6,TATTTGAACTGTAGTATTCA,1,475820
araBp,1.2857142857142858,14,6,TATGTTTCGTATCAGTGACG,8,506824
araBp,9.285714285714286,70,6,TATCACGGAGCCATTCCTTG,64,489789
araBp,2.4285714285714284,22,6,TATACGCCGCCGGAAAAACA,16,504522
araBp,0.2857142857142857,7,6,TAGGTTTAGCCAATATACTC,1,512811
araBp,1.7142857142857142,17,6,TACTACTAAACGGGACATGG,11,486636
araBp,3.5714285714285716,30,6,TACCCTTTCGCTATCTATGT,24,508828
araBp,0.5714285714285714,9,6,TACCATGGTGGAGGCCCGAT,3,505350
araBp,0.8571428571428571,11,6,TACCAGTTACCTCCAACTGT,5,515396
araBp,0.2857142857142857,7,6,TAATGTGACAGTAGGAATCA,1,510187
araBp,0.2857142857142857,7,6,TAAGTCCCTCCGAACGGCTC,1,472099
araBp,4.857142857142857,39,6,TAAGTCATCCCCCTCTAGAC,33,478784
araBp,2.4285714285714284,22,6,TAAGGAGCGCATCATCAGCC,16,517890
araBp,3.7142857142857144,31,6,TAAACACTTGATGCTAAGAT,25,488644
araBp,3.0,26,6,GTTTGCTGAACGAACTATAC,20,489734
araBp,4.857142857142857,39,6,GTTTCTTCGAGTTTCCTCGG,33,520544
araBp,4.285714285714286,35,6,GTTGGTTCTCGTCCTGCCGG,29,501720
araBp,0.42857142857142855,8,6,GTTCGGCTCAAATCCTCCTT,2,477876
araBp,0.7142857142857143,10,6,GTTCACGGTAAGACAATCCC,4,498508
araBp,3.2857142857142856,28,6,GTTACGTTGCTTTTTCGACA,22,470241
araBp,0.2857142857142857,7,6,GTGGAGTTGGCACGCGGCGC,1,478487
araBp,1.8571428571428572,18,6,GTGCTAACTGGCCGCTTTGG,12,494544
araBp,2.7142857142857144,24,6,GTCAGTGCCCCAGGAAAGAG,18,490023
araBp,2.5714285714285716,23,6,GTAGATCTGGGATCCAGCTA,17,480401
araBp,1.2857142857142858,14,6,GTACTAATTGATAAGCGAGG,8,489247
araBp,4.428571428571429,36,6,GTACCGTCCTCTAGTCATTT,30,500584
araBp,1.0,12,6,GTACCCCTAATGTCAATGTT,6,473620
araBp,0.2857142857142857,7,6,GTAAGGCCGGCTCACCGCAG,1,501332
araBp,0.2857142857142857,7,6,GTAAGACTTCCAAATTGCGT,1,498225
araBp,6.571428571428571,51,6,GTAACGCACACTACGCTTCT,45,523428
araBp,2.2857142857142856,21,6,GGTTCGGCTTATCGCTGCTT,15,496709
araBp,0.8571428571428571,11,6,GGTTATGAACATTTTCTAAT,5,472111
araBp,2.4285714285714284,22,6,GGTCGGGGCAAACGGGGATC,16,486481
araBp,3.857142857142857,32,6,GGTATGCGGCTGTAGTTGCT,26,478789
araBp,3.4285714285714284,29,6,GGGTTGCGATGTTGACAGTT,23,485817
araBp,0.2857142857142857,7,6,GGCATCCACCGGTTGGTTCC,1,523159
araBp,4.285714285714286,35,6,GGATGCCGGATCGATATGTT,29,502532
araBp,3.2857142857142856,28,6,GGAATGAATAGTGACCGGGA,22,511049
araBp,4.571428571428571,37,6,GGAAGAGCAGCTGAGGGATA,31,489946
araBp,4.285714285714286,35,6,GCTTACCACAACCTCCGGTC,29,486345
araBp,3.142857142857143,27,6,GCTGGCTAAGTATGATAGAT,21,467861
araBp,6.428571428571429,50,6,GCTGGCCTAACTCCCGTCCA,44,491970
araBp,5.285714285714286,42,6,GCTATGCTTATACCGTTCGT,36,485850
araBp,3.0,26,6,GCGTCCGTCACAAGAGCATT,20,511799
araBp,1.8571428571428572,18,6,GCGGCGGGCGAAACTATCGT,12,502822
araBp,4.571428571428571,37,6,GCGACCGGAACTTTAATGCT,31,488897
araBp,3.2857142857142856,28,6,GCCTCCTTCCGCAGGTGATT,22,474593
araBp,2.2857142857142856,21,6,GCCAGTGCCCGGAACAGGTC,15,481980
araBp,1.8571428571428572,18,6,GCAAGAACCGCTTAAAACGA,12,489712
araBp,2.2857142857142856,21,6,GATTCGTTCAAGTGACGAAT,15,469149
araBp,1.2857142857142858,14,6,GATGCTCTAAAATAGAGGTC,8,488276
araBp,12.0,89,6,GATCGGACAGATGGCTAGCG,83,509829
araBp,3.2857142857142856,28,6,GATCGCCGGGCTAGAAACAA,22,502767
araBp,2.5714285714285716,23,6,GATCAGACTCTGGCACCTGC,17,515754
araBp,0.2857142857142857,7,6,GATATTTGCAATCTATGGGG,1,496642
araBp,4.285714285714286,35,6,GAGTTACGCTTTTTTGGCCA,29,481491
araBp,3.0,26,6,GAGCGTCTCGGTATGCGGCG,20,517863
araBp,2.7142857142857144,24,6,GAGCGCTCTTTTCGCTAAAA,18,506487
araBp,3.7142857142857144,31,6,GACAGGATTAGATACATCAT,25,486995
araBp,3.4285714285714284,29,6,GAAGAGGATGCAAGATCTAA,23,511324
araBp,6.285714285714286,49,6,GAACATCGTCAGGGCTTTGC,43,513869
araBp,3.5714285714285716,30,6,GAAACCGCGTGATCCGAGAT,24,490098
araBp,6.571428571428571,51,6,CTTATACAGAGTTGTAATGC,45,488181
araBp,5.142857142857143,41,6,CTGTGACTAATCTACGTTTA,35,496246
araBp,3.857142857142857,32,6,CTGTAGTACACAGGCAGATA,26,502140
araBp,1.0,12,6,CTGATTCTTAGTAATCTGTG,6,502862
araBp,4.571428571428571,37,6,CTGATATTCCACATCGATCA,31,506634
araBp,3.0,26,6,CTGACAATGACTATTCATAT,20,496419
araBp,0.2857142857142857,7,6,CTCTTCTCCTGCTTTTGCTC,1,491055
araBp,4.428571428571429,36,6,CTCGGGGGGTCATCAGAGCT,30,504800
araBp,4.0,33,6,CTCGCTGTCCACTAGCTACA,27,488175
araBp,2.4285714285714284,22,6,CTCGATAATCAGGGACTCGA,16,507783
araBp,0.2857142857142857,7,6,CTCGAGTCATTCTCTTCTGC,1,481805
araBp,5.714285714285714,45,6,CTATCTTACTCACAGCATTA,39,486396
araBp,3.857142857142857,32,6,CTATCCGTACTGCCGACTCT,26,485907
araBp,4.285714285714286,35,6,CTAGGCATGCCAACTGCAAC,29,492852
araBp,3.7142857142857144,31,6,CTAGACAGATGGGGGTGCCA,25,492141
araBp,0.2857142857142857,7,6,CGTACGGTTCCGCTTTATCT,1,491329
araBp,6.142857142857143,48,6,CGGTAGTCCAATCGAGCGAG,42,518517
araBp,2.857142857142857,25,6,CGGCGTCCAAAATACCTAGG,19,503904
araBp,3.857142857142857,32,6,CGGATGAGTCACGCAAAATA,26,487417
araBp,1.5714285714285714,16,6,CGGAGCGCGGCTAAAAACCC,10,483134
araBp,4.428571428571429,36,6,CGGACCTGCCGACTCGTTTC,30,518526
araBp,4.142857142857143,34,6,CGCTCAGCGATGCACTCAAT,28,491949
araBp,0.5714285714285714,9,6,CGATGGCTCGCAAGCAGCAA,3,494103
araBp,1.4285714285714286,15,6,CGATAGAGCAGGCCGATAAT,9,491605
araBp,0.2857142857142857,7,6,CGACTCACGGTGCCGGCGTA,1,511384
araBp,7.0,54,6,CGACGATTTGCACTGCCATG,48,475835
araBp,4.285714285714286,35,6,CGAATTATAATGATCTGGGC,29,499677
araBp,0.2857142857142857,7,6,CCTTGAAGTCAGACAATCCA,1,504110
araBp,2.7142857142857144,24,6,CCTTATTCATTTTTTATCCT,18,492603
araBp,0.2857142857142857,7,6,CCTGTGCCTTGCTCCCTGAC,1,478375
araBp,5.142857142857143,41,6,CCTGGCTATCATGCTGGACA,35,497873
araBp,3.7142857142857144,31,6,CCTCGTGACCAGGGACGTAA,25,515050
araBp,3.2857142857142856,28,6,CCTCGCTCCTCCTATCACGT,22,488198
araBp,2.7142857142857144,24,6,CCTCAATGGCTTAGTTCAGT,18,484262
araBp,5.0,40,6,CCTAGCCGGAGATGAAGTAA,34,496675
araBp,3.142857142857143,27,6,CCGGCCCACGGGTTCAATTG,21,513061
araBp,2.0,19,6,CCGCCGGAAAGATTCCGCCT,13,471996
araBp,1.2857142857142858,14,6,CCGATTTGACTCGTAGGGTT,8,476740
araBp,3.4285714285714284,29,6,CCGAGCATGGTCATTTCTAA,23,474162
araBp,3.4285714285714284,29,6,CCCGCCTAATTGAAGGAAGT,23,512421
araBp,4.285714285714286,35,6,CCCCACCGAATATGGGAGCC,29,468742
araBp,0.2857142857142857,7,6,CCCATCTCTTTTAAGCCTTA,1,519064
araBp,6.285714285714286,49,6,CCCATCCAACGCCCAGGCAA,43,502510
araBp,2.0,19,6,CCAGCGTGGCTTGAGACGGT,13,517496
araBp,4.428571428571429,36,6,CCACATGGCGGAGTACCAAT,30,513170
araBp,4.0,33,6,CCAAGAGATTCCTAGCTGCC,27,520939
araBp,1.2857142857142858,14,6,CATGAGGTTTTCATTGTAGA,8,521185
araBp,4.714285714285714,38,6,CATCAGCATTCCTTCGCTCA,32,479750
araBp,3.0,26,6,CATATACGAGCTGCGCCTAG,20,477345
araBp,5.571428571428571,44,6,CATAGCCCCTTGCCCTCGAG,38,509938
araBp,7.0,54,6,CATACCCAGCGCACTCGGAG,48,479820
araBp,3.857142857142857,32,6,CATACAACGAGGATTGCATT,26,499839
araBp,2.7142857142857144,24,6,CAGTCTTATACAAGCTTGCT,18,491123
araBp,1.7142857142857142,17,6,CAGGAGCTTGTGGGATCACC,11,496624
araBp,5.714285714285714,45,6,CAGCGAGGGCGGTACTAGAA,39,494699
araBp,3.4285714285714284,29,6,CACTTCCACCGAATTCCAGC,23,508137
araBp,0.2857142857142857,7,6,CACTACTCGGGAAATCGCAA,1,487025
araBp,0.2857142857142857,7,6,CACGTGCTTCTTTCAGAAGG,1,496337
araBp,8.0,61,6,CACCATGATCCATTGTATGG,55,521902
araBp,5.142857142857143,41,6,CACAGACTAAGGTGTACTGG,35,508839
araBp,2.5714285714285716,23,6,CAAATCGAGAGGTATGTCAG,17,474119
araBp,4.571428571428571,37,6,CAAAGTAAGGCGACTAGATT,31,472005
araBp,1.5714285714285714,16,6,ATTGCGGTGCAGGTGTGGCT,10,523335
araBp,1.5714285714285714,16,6,ATTCGTGGGGCTCAACTGAG,10,479780
araBp,2.4285714285714284,22,6,ATTCATATTCTGATTCAGCA,16,493122
araBp,3.4285714285714284,29,6,ATTCACAGAGGACACTCATC,23,476957
araBp,6.285714285714286,49,6,ATGTTCCCCCAGCACGACTG,43,508835
araBp,4.285714285714286,35,6,ATGGGTCTTTAGCCGGACTA,29,510549
araBp,2.4285714285714284,22,6,ATGCAAGCATCCACGAGCGG,16,478177
araBp,2.0,19,6,ATGAAGCTGAATAGTACGAT,13,480066
araBp,4.142857142857143,34,6,ATCTCCTATGCGATTCCGAT,28,487333
araBp,1.1428571428571428,13,6,ATCTAATTTACAAGCAAATA,7,482705
araBp,3.857142857142857,32,6,ATCCCAGAATTAGAGCTCAA,26,503339
araBp,0.2857142857142857,7,6,ATCACTTTATATAGTCAGTC,1,509321
araBp,7.285714285714286,56,6,ATATAACGTCTTAATCCTGC,50,517413
araBp,2.0,19,6,ATACTTTTAGACTTCCGAGG,13,487409
araBp,0.2857142857142857,7,6,AGTTGGCCCATACTCGCGAG,1,523322
araBp,3.7142857142857144,31,6,AGTTACCAGGACCGCAATGC,25,471636
araBp,0.2857142857142857,7,6,AGTCAGAAAAACCAGGTATT,1,485392
araBp,2.142857142857143,20,6,AGTCACGAAGTCCGGGGGTC,14,480846
araBp,7.0,54,6,AGGGGGACCCCATTCTAGAG,48,491109
araBp,4.428571428571429,36,6,AGGCCCGTAAATCCGAAGGG,30,491882
araBp,5.571428571428571,44,6,AGGCACACAGCTAGATAGCA,38,481825
araBp,0.2857142857142857,7,6,AGGATAAAGGCTAAAGAACA,1,482704
araBp,3.2857142857142856,28,6,AGCGGGCTAGCGATGTGAAT,22,506865
araBp,0.8571428571428571,11,6,AGCGCAAGAATTATGACGAT,5,488753
araBp,6.285714285714286,49,6,AGAGCATGAGACCGAGCGAC,43,494956
araBp,4.142857142857143,34,6,ACTTTAGGCACGGCCACTAG,28,517892
araBp,4.571428571428571,37,6,ACTTGGAAAGGGCACTGCTC,31,523695
araBp,3.2857142857142856,28,6,ACTGCAAATCTCACACTTGT,22,519247
araBp,1.4285714285714286,15,6,ACTGATTGGTGGGCGTAGTC,9,476902
araBp,2.142857142857143,20,6,ACGTCCTTTCGCACTGTCGA,14,484585
araBp,0.2857142857142857,7,6,ACGGGGCCAATCAAATTCCC,1,470222
araBp,2.4285714285714284,22,6,ACGGGCCATCGGGGTTGACG,16,484859
araBp,1.7142857142857142,17,6,ACGCGTACTATTAATCACGA,11,503253
araBp,4.571428571428571,37,6,ACGAGACTACTATCCCCGAT,31,494205
araBp,5.428571428571429,43,6,ACGACACACCGGGCACATAA,37,496538
araBp,1.2857142857142858,14,6,ACCGTCGTTTGACTTCTGCA,8,502630
araBp,0.2857142857142857,7,6,ACCCGTATGTGCCGGCAATT,1,502903
araBp,4.714285714285714,38,6,ACAGTGAGCGTCGCGAAGCA,32,479827
araBp,2.4285714285714284,22,6,ACACACAAGACGCCTGGCAG,16,489200
araBp,7.571428571428571,58,6,ACAATACGATCGCCATCAAC,52,483493
araBp,4.142857142857143,34,6,AATAACGTATATCTGTCCTA,28,518512
araBp,5.571428571428571,44,6,AATAACGCCGATAGCAAGTA,38,520112
araBp,4.142857142857143,34,6,AAGTGGCAAAAATTCGAGTG,28,487852
araBp,0.2857142857142857,7,6,AAGCTCTGACTATGATTTAT,1,501266
araBp,4.142857142857143,34,6,AAGCGACCCATTACGTTTGG,28,506241
araBp,3.0,26,6,AAGCCCGCGATGTTGTATCA,20,507649
araBp,3.857142857142857,32,6,AAGATGGAAGTATAGCTCTA,26,503667
araBp,8.285714285714286,63,6,AAGAAACGCCGCGAGCCCTC,57,474709
araBp,3.857142857142857,32,6,AACTCCAGGTTACTTTTCTG,26,519218
araBp,4.142857142857143,34,6,AACGCGGGGACAGTAGGCCC,28,516822
araBp,2.7142857142857144,24,6,AACAGGAAAAGAATGCACCC,18,483904
araBp,0.2857142857142857,7,6,AACAATGCCAACGCTTGGAT,1,483685
araBp,6.0,47,6,AAACGCAACTCCCTCCTGGA,41,499222
araBp,2.5714285714285716,23,6,AAAACCAACGTTGATTTTAA,17,503805
araBp,2.1666666666666665,17,5,TTTTAATGTGCATTTGGGGT,12,503287
araBp,3.5,25,5,TTTGGCTCGGTTTTCGCTAG,20,468247
araBp,3.5,25,5,TTTCCCCGCAGTACACACCA,20,478283
araBp,4.5,31,5,TTTCATCTCGGCTAGACCCC,26,493395
araBp,2.5,19,5,TTTATAGCTTGGTCGAGTCT,14,522853
araBp,3.8333333333333335,27,5,TTTAATGCTCCGCGGGATTC,22,487455
araBp,2.6666666666666665,20,5,TTGTGCCATCCGTAGCTGTG,15,475232
araBp,7.166666666666667,47,5,TTGTCGGTGTGAAGAAGAAA,42,508005
araBp,3.8333333333333335,27,5,TTCTCCACGAATTTAGCGCT,22,513108
araBp,6.166666666666667,41,5,TTCGCCGAACCGTCGAGAGA,36,485615
araBp,3.5,25,5,TTCGAGCCTGATTGGACTGC,20,495491
araBp,0.3333333333333333,6,5,TTCCGCCGAGGTTATCGTCA,1,524128
araBp,5.166666666666667,35,5,TTCCCCCGGCGGCGCATGTT,30,495877
araBp,5.333333333333333,36,5,TTCAGGTAGTCTGTACACGA,31,469794
araBp,4.333333333333333,30,5,TTCACATCATACTTTGGGCA,25,513096
araBp,3.8333333333333335,27,5,TTACTGTCCAAGAAATGCCC,22,482170
araBp,4.333333333333333,30,5,TTAATAAGACTAAACCCACA,25,492233
araBp,3.5,25,5,TTAAGGCAAATATAGATTAA,20,495715
araBp,0.3333333333333333,6,5,TGTTTTTTACGAACTGCCAC,1,494854
araBp,3.8333333333333335,27,5,TGTATCGCACTCGAACGAAT,22,480712
araBp,5.166666666666667,35,5,TGGTCAAGCAACCGACACAA,30,515958
araBp,6.0,40,5,TGGGTATGGCTCGTGACTGG,35,483483
araBp,6.0,40,5,TGCGGTGGTTGCGGCCGGAC,35,479460
araBp,0.3333333333333333,6,5,TGCGGCCTGTTGCGCTAGAT,1,505638
araBp,3.3333333333333335,24,5,TGCCCATTCCCTTCGAATCT,19,476565
araBp,4.166666666666667,29,5,TGATTACAGGTAGAATTAGG,24,481485
araBp,2.3333333333333335,18,5,TGAGTCTTTGATATCGGAGC,13,492343
araBp,4.333333333333333,30,5,TGAGATAACAAGGCAGGTAT,25,487916
araBp,2.5,19,5,TGACTGTATCCCACGGAGCA,14,503830
araBp,4.0,28,5,TCTGCAGAGGGGATGGTGTT,23,522673
araBp,3.3333333333333335,24,5,TCTCTAAATGAATCTTGGGC,19,507684
araBp,0.3333333333333333,6,5,TCTCCCTGAATGGGGTTGTA,1,521395
araBp,3.3333333333333335,24,5,TCTATCTGCAACAGACGCTG,19,511218
araBp,3.0,22,5,TCCTTTATCAACAAGATCTT,17,522356
araBp,4.0,28,5,TCCTCCCGTTATTGTTAGAT,23,500548
araBp,3.8333333333333335,27,5,TCCCGGGCATTTAAGGTCGT,22,486873
araBp,3.1666666666666665,23,5,TCCCAGGACATCGGTCCTCA,18,471970
araBp,3.5,25,5,TCATTTATTCGTGGCACACT,20,499671
araBp,4.166666666666667,29,5,TCAAGAGAGGCCGAAGTCCA,24,478879
araBp,2.8333333333333335,21,5,TAGGTTTGTCGGCGTAGGTG,16,469713
araBp,5.5,37,5,TAGCGGAGGAGGTATCTGTT,32,499240
araBp,3.8333333333333335,27,5,TAGCACGTGGGTGGGAAGTA,22,504700
araBp,4.333333333333333,30,5,TAGCAACCATAAACGCATCC,25,504799
araBp,2.3333333333333335,18,5,TACTTGATTGTGCGCTACGT,13,494463
araBp,2.3333333333333335,18,5,TACTACGAATCGAATATGGA,13,505681
araBp,1.5,13,5,TACGTATTGCGTCACAACCA,8,506584
araBp,3.3333333333333335,24,5,TACGCTGGGTCCACTTAACT,19,492348
araBp,2.3333333333333335,18,5,TACGCGTACTTCATAAGGGA,13,469299
araBp,4.0,28,5,TACGACATGCCCGGCGTGGT,23,474289
araBp,4.666666666666667,32,5,TAAAATGCTGTTTAGGTGGA,27,486106
araBp,4.0,28,5,GTTTTCGGACTCGCGCCAAC,23,511886
araBp,4.0,28,5,GTTCTAGGCGCAGAGAATCT,23,476534
araBp,3.1666666666666665,23,5,GTTAATTGGGTGTACGACGC,18,478877
araBp,3.5,25,5,GTGTTGAATAGGACGTGAGG,20,519502
araBp,5.0,34,5,GTGTAGAAAGTTGCGTTTTA,29,496757
araBp,3.8333333333333335,27,5,GTCTCGTGGCTGGGATCCGC,22,483759
araBp,3.0,22,5,GTCGGACCAAGCGCCCGGAC,17,495247
araBp,3.0,22,5,GTCCTAGCTGGGTTGCGGGA,17,501911
araBp,4.0,28,5,GTCAGTGCCCCGTTAATGAG,23,520792
araBp,6.833333333333333,45,5,GTCACGATGAGTTCTCATTT,40,504400
araBp,4.5,31,5,GTAGTTTCCTCGGTGGAGAT,26,488754
araBp,3.6666666666666665,26,5,GTACGAATAATAACCTTGTA,21,480787
araBp,5.0,34,5,GTAATCTACAAGAATCGTGT,29,507297
araBp,4.833333333333333,33,5,GGTGCTTAGACGATCCACGT,28,475663
araBp,6.5,43,5,GGTATCGACCATTAGTGTAT,38,516602
araBp,4.333333333333333,30,5,GGTAATGACTGTAGCACGGT,25,476000
araBp,4.333333333333333,30,5,GGGGCGAAGTATACAATTTG,25,493770
araBp,6.666666666666667,44,5,GGGGCATGAACAAGTACACG,39,476066
araBp,6.5,43,5,GGGGAACGACGGCTTCGTTC,38,511026
araBp,4.166666666666667,29,5,GGGCAGTGTAAAACTATCTG,24,501895
araBp,3.6666666666666665,26,5,GGGACCCATGGCGTCGGCGT,21,518479
araBp,4.5,31,5,GGCTGCCGGATGCTACATAA,26,476336
araBp,11.5,73,5,GGCTAACTACACTTAGGATA,68,503308
araBp,2.0,16,5,GGCGTCGGGTTTTTCACGGA,11,477507
araBp,0.3333333333333333,6,5,GGCCCTCAGAGTCTCAAAAT,1,509575
araBp,4.333333333333333,30,5,GGCAGTATCACGCTTAACAT,25,475993
araBp,1.8333333333333333,15,5,GGCACCAATGGCACGTTTGT,10,518474
araBp,5.833333333333333,39,5,GGAACGACTGCACGGAAACC,34,477713
araBp,4.166666666666667,29,5,GCTTCAATAGTCTATAAGTC,24,468362
araBp,3.0,22,5,GCTGTGTTCTGAGTGAATGT,17,486287
araBp,1.1666666666666667,11,5,GCTGTGGGGGCCAAAAGGTT,6,472487
araBp,2.0,16,5,GCTCGAAATGATAGTTGCAT,11,501685
araBp,3.1666666666666665,23,5,GCTACCGCTTTGTAGCAGGC,18,506501
araBp,3.8333333333333335,27,5,GCGACATACTCGTCACTGTG,22,495567
araBp,4.833333333333333,33,5,GCCCTGTACAGGTGGAGGCA,28,496328
araBp,4.0,28,5,GCCCTCTACCTTGGCAGTTA,23,475850
araBp,10.333333333333334,66,5,GCCCAGCATGATCCCGATGT,61,484606
araBp,2.1666666666666665,17,5,GCATACGCGTCCAGGTGGGG,12,476338
araBp,1.8333333333333333,15,5,GCAGAGATCACACTGGGTAC,10,514703
araBp,1.6666666666666667,14,5,GATTTTTTGACGCACATTTG,9,489131
araBp,3.5,25,5,GAGGGACCACAGAAAAAACG,20,515106
araBp,6.166666666666667,41,5,GAGCGGGCAAACCGTGATAT,36,501565
araBp,0.5,7,5,GAGCGAGCAAATCCTGATCG,2,474171
araBp,4.0,28,5,GAGAATGTCAGACGTTAACT,23,480770
araBp,0.3333333333333333,6,5,GACTGGAGGTTATGCGTAGT,1,513947
araBp,2.1666666666666665,17,5,GACATACTCTGGATCGGCTA,12,486065
araBp,1.8333333333333333,15,5,GAAAGTGTGGCTGATGTTAT,10,503576
araBp,8.0,52,5,GAAAGATTCCCTATAAACAT,47,470326
araBp,3.1666666666666665,23,5,GAAACACAACACTCTCAAGT,18,475891
araBp,2.8333333333333335,21,5,CTTTGCGTGTATGTGACCCC,16,510070
araBp,3.0,22,5,CTTGTTTATGGATTCGATCT,17,492318
araBp,5.166666666666667,35,5,CTGTTGAGTGGGAGAACCTA,30,478795
araBp,5.166666666666667,35,5,CTGTGGTACGGTTTCATTCA,30,474333
araBp,3.6666666666666665,26,5,CTGGGACATGCTCCTTTTTA,21,475581
araBp,0.3333333333333333,6,5,CTGCACGGCGGCACTGGGTT,1,491056
araBp,0.3333333333333333,6,5,CTGAACACGCGAAGGTTTAA,1,511294
araBp,1.8333333333333333,15,5,CTCTCGAGTTACTACAGGTA,10,477844
araBp,3.0,22,5,CTCTACGTGGGAGGTCGCCA,17,498515
araBp,3.5,25,5,CTCTAAACAGTATCGAGGCA,20,520404
araBp,0.3333333333333333,6,5,CTCAGGTGCGAATAAGTCCT,1,498035
araBp,5.5,37,5,CTCACTTGTATAGGTGGTGA,32,504847
araBp,2.8333333333333335,21,5,CTATTGGTCTAGAACAGTTG,16,511217
araBp,0.3333333333333333,6,5,CTATGCGGACTTCAGGATAA,1,519077
araBp,0.3333333333333333,6,5,CTATCTCGAATTTTGCTGAG,1,509601
araBp,2.0,16,5,CTAGGTTTCCGATTACAGTG,11,508767
araBp,3.3333333333333335,24,5,CTAGCCCGCGGACCGAGTCC,19,525193
araBp,3.0,22,5,CGTTTTTCAGCGTGAGAGGG,17,522083
araBp,2.1666666666666665,17,5,CGTTCAGTGCATGTCATAGA,12,505656
araBp,3.3333333333333335,24,5,CGTTCAAGGTACTGCCCGGA,19,517423
araBp,1.5,13,5,CGTGGCGCTGTATGTCTTTT,8,471623
araBp,3.0,22,5,CGTCCCCTAAGTTCAATCCA,17,490025
araBp,5.0,34,5,CGTATGACGCAGGATACTTT,29,498154
araBp,2.6666666666666665,20,5,CGTATCTCAGCGACGTTTAG,15,509902
araBp,0.3333333333333333,6,5,CGGTGGCGTGGAAGGACGAT,1,478723
araBp,5.666666666666667,38,5,CGGTCCGTCGTTGCACTAAA,33,508806
araBp,2.5,19,5,CGGGCAGAGCAGTCTAGGCT,14,518155
araBp,3.8333333333333335,27,5,CGGCTATATGCCCCATATTC,22,509560
araBp,4.666666666666667,32,5,CGGATCGATGACATCTGTGG,27,486757
araBp,8.166666666666666,53,5,CGGACACCTTAAACGGCCGC,48,497461
araBp,3.6666666666666665,26,5,CGCTTCGCATCGGATAGGCT,21,485998
araBp,0.6666666666666666,8,5,CGCTGAAGGTTTCATTTATT,3,523156
araBp,5.166666666666667,35,5,CGCGCCGGACAGGGCGGGAC,30,486282
araBp,3.0,22,5,CGCCCGTCGCACGTGAACGT,17,492502
araBp,1.3333333333333333,12,5,CGACATGGAAGTATCTCCTT,7,491707
araBp,8.333333333333334,54,5,CCTGATCTGGTGCCGAACAT,49,467896
araBp,3.1666666666666665,23,5,CCGTACCCTCGGTCCGGGAA,18,468845
araBp,2.0,16,5,CCGGCCCGCCCGGGTCAGAA,11,509815
araBp,14.166666666666666,89,5,CCGACCTGCGCGGGCCTAAA,84,524346
araBp,0.6666666666666666,8,5,CCCGTTCCTGACCTATACCT,3,479282
araBp,4.666666666666667,32,5,CCCGCTTATGCACTTGTCAA,27,518623
araBp,1.6666666666666667,14,5,CCCCAGGGTCTTAACATTGA,9,490560
araBp,7.333333333333333,48,5,CCAGGGCGGATTGCATCACC,43,482105
araBp,3.5,25,5,CCACTAACTGCTTGCGGCGA,20,522380
araBp,4.0,28,5,CCAATATCTTTAACAACTGT,23,473472
araBp,1.0,10,5,CATTTCCCAGGTGAAAGTTG,5,521188
araBp,2.6666666666666665,20,5,CATCTCAAGCCAGTATTGCG,15,497573
araBp,3.8333333333333335,27,5,CATAGATGATATTATCGCGG,22,495509
araBp,0.3333333333333333,6,5,CAGGTGATCCGGTAGGCCCC,1,486333
araBp,4.333333333333333,30,5,CAGGCACCGACGTAATGTTT,25,492320
araBp,7.333333333333333,48,5,CAGCCGTTCATGCAACCCGA,43,503897
araBp,6.0,40,5,CAGAGTTTCTGCCCTTTACT,35,478786
araBp,5.166666666666667,35,5,CACGTCGTCTAGTGCCAGGT,30,470900
araBp,5.5,37,5,CACACTTCCATCAAGGTAAA,32,506397
araBp,5.333333333333333,36,5,CAAGGGGCCGGGACTCCAAC,31,485482
araBp,0.3333333333333333,6,5,CAACCTCGGACCGACAGATT,1,525397
araBp,3.6666666666666665,26,5,CAACATGAAGTGCGTATTAT,21,469545
araBp,4.333333333333333,30,5,ATTGCAGGCGAGATATAGAA,25,470012
araBp,4.0,28,5,ATGAAGTGGGCGTCGGCCAT,23,495359
araBp,2.8333333333333335,21,5,ATCTACTCGGCTTGGTCTGT,16,497061
araBp,3.8333333333333335,27,5,ATCCGCTATGTTTATAAAAA,22,482024
araBp,6.0,40,5,ATCAGTTCCTCTACTAAGAG,35,513004
araBp,2.6666666666666665,20,5,ATCAGCCACAATTAGGGTGC,15,503491
araBp,2.3333333333333335,18,5,ATCAGACCAATAGGTACGAG,13,498694
araBp,1.8333333333333333,15,5,ATATCGCAAGTTTAACTAAA,10,512239
araBp,9.333333333333334,60,5,ATATAGTCAAAGCGGTGCAG,55,517883
araBp,2.5,19,5,AGTTTCCACGGCGCATCTAT,14,497928
araBp,3.5,25,5,AGTTAATCCCTGACGATGTA,20,518377
araBp,3.5,25,5,AGGTTATTCGAAGGATCTAG,20,515333
araBp,0.3333333333333333,6,5,AGGTAACGGTTCAGTAGCCA,1,508907
araBp,3.0,22,5,AGGATGATTACGGGATGATC,17,468159
araBp,0.3333333333333333,6,5,AGCCAGGGCTGAGTGTCATG,1,492404
araBp,3.0,22,5,AGCAAGTTCGGGGCGTATGT,17,507021
araBp,4.0,28,5,AGATCCCATGGAAAAGTACT,23,476588
araBp,10.333333333333334,66,5,AGAGAGTCTAAGGCCTGTAT,61,472164
araBp,0.8333333333333334,9,5,ACTGCTCTTCTGTTTTCCGG,4,499428
araBp,12.0,76,5,ACTCCTAGGCGAATAAATGC,71,496731
araBp,0.3333333333333333,6,5,ACTCCGGCTGACAAGGTAGG,1,514846
araBp,4.5,31,5,ACGGCTCTAGAGACGTTAGT,26,509299
araBp,3.8333333333333335,27,5,ACCCCGAATGCTGCTATAGA,22,507716
araBp,4.5,31,5,ACCACAAATGGCGAGATGTA,26,505179
araBp,1.1666666666666667,11,5,ACATAATGGTGGTCAGGCGT,6,507714
araBp,2.3333333333333335,18,5,ACAGATGGGCACAACTGCCT,13,503663
araBp,4.5,31,5,ACAGAGGCCACTGCAAATTG,26,486465
araBp,12.333333333333334,78,5,ACACGGGTCTAGTCAGTCGA,73,499683
araBp,3.8333333333333335,27,5,ACAAATTCATTGTCCGACTA,22,471724
araBp,0.3333333333333333,6,5,AATTCGCTCAGACGGCTCTT,1,491376
araBp,1.5,13,5,AATTCCGCTTCGAGGTCCGG,8,481788
araBp,3.3333333333333335,24,5,AATGACGCAGCGAGCTTCAA,19,485527
araBp,4.166666666666667,29,5,AATGAAACGACAGTGGATAA,24,490083
araBp,3.1666666666666665,23,5,AATAACTCCGTATCACACTA,18,473916
araBp,2.3333333333333335,18,5,AATAAAATAGATTTCCGGTA,13,494804
araBp,8.666666666666666,56,5,AAGTTAGGCGCTGCGTCCAT,51,482305
araBp,4.5,31,5,AAGTGGCAGACATGAATATC,26,492403
araBp,4.0,28,5,AACGTTCCAGTTGGGACGAT,23,470764
araBp,5.5,37,5,AACGGCGCCAGTCGATCACT,32,485420
araBp,5.0,34,5,AACATATCTGACTAGATTCG,29,506178
araBp,4.333333333333333,30,5,AACAAAGGCATTGGACACTT,25,479040
araBp,0.3333333333333333,6,5,AAATGGCGCGCCTCACACTA,1,517676
araBp,2.6666666666666665,20,5,AAAGTATACGACTAAGTGCA,15,485208
araBp,3.3333333333333335,24,5,AAACGGGCATCCCAAGGCGT,19,513411
araBp,3.0,22,5,AAACAGGATCATTACTCAGT,17,515294
araBp,2.6,16,4,TTTTTATGTCACGCAGATCT,12,519529
araBp,2.2,14,4,TTTTGTCGCGCGTATGATTG,10,481195
araBp,5.2,29,4,TTTCCGCATTAGGTTCGATA,25,478082
araBp,4.6,26,4,TTTCACTTTGTCATAACAGA,22,485866
araBp,4.8,27,4,TTGTTTCACATTCGGATTAT,23,475315
araBp,2.0,13,4,TTGTCTAACTTATCTAAGCT,9,523576
araBp,4.6,26,4,TTGAAGACTAATCTGGGTAA,22,502704
araBp,4.2,24,4,TTCTCAAGCGCGTGAACATT,20,477298
araBp,5.4,30,4,TTCGCACCCGTTGAATATAC,26,498929
araBp,7.8,42,4,TTCCGCAAGCATTCAACGAA,38,518063
araBp,2.8,17,4,TTCAAGTACTGGGCGGTATC,13,497026
araBp,0.4,5,4,TGTTGCGTGGGCCTCAAATA,1,512520
araBp,9.2,49,4,TGTGCCGTCTCGCCCGTAAA,45,485704
araBp,3.6,21,4,TGTAGGAACTAAGCGCTTTC,17,468698
araBp,1.4,10,4,TGGGTCGGGCTGCCAACCAA,6,481974
araBp,6.2,34,4,TGGGGTTTTGGGAGCGCGTA,30,517662
araBp,0.4,5,4,TGGGGGGCGCCTGCACTGGA,1,479364
araBp,5.2,29,4,TGGCTCCGCAAGTTCTGAGA,25,485239
araBp,5.0,28,4,TGGCGAGTAGTGGATGTATA,24,500104
araBp,4.0,23,4,TGGCAAACTACTAGGGTGAA,19,516144
araBp,9.8,52,4,TGGAAGTGTGGATGGCGTCC,48,495465
araBp,10.4,55,4,TGCGTCCGGGACCGCCTGTG,51,517417
araBp,6.6,36,4,TGCAGCCTCACTTGCTGGTG,32,494088
araBp,9.8,52,4,TGACCAGTCCCTTCATGTTA,48,503444
araBp,5.2,29,4,TGAATTGGCCATGGGTGTGT,25,524345
araBp,2.0,13,4,TGAATTAGATTTTCGATACT,9,477465
araBp,11.4,60,4,TCTTGCCCAGCACGTGTCCT,56,474701
araBp,5.6,31,4,TCTAACAGTACTCCTGAGCT,27,472196
araBp,4.4,25,4,TCGTCGGTTACATTGAAGCT,21,514896
araBp,9.6,51,4,TCGTAATCCACTACGCGTTG,47,507697
araBp,10.8,57,4,TCGGAATAAGGGTGTAGCGC,53,518394
araBp,2.6,16,4,TCGAACAAAGGTAGAGCATT,12,510711
araBp,14.4,75,4,TCCTTCCCCCCAGAAGGTGT,71,496733
araBp,5.2,29,4,TCCTTCCAGCACTCCGGGGG,25,476514
araBp,4.8,27,4,TCCTTCAGTCAGCAATGTAC,23,490328
araBp,8.2,44,4,TCCTGCCCAAAGGTTGCATC,40,483615
araBp,4.2,24,4,TCCCCGGCCCGGAATAGTAG,20,486254
araBp,11.2,59,4,TCCAGCGCTGCTAGATGAGA,55,510708
araBp,3.4,20,4,TCAGTCAACCCCACGTAATA,16,483346
araBp,0.4,5,4,TCAATTCCTCTTTAAGGGCC,1,505417
araBp,4.2,24,4,TATCATCACTGGTTATTCGT,20,505197
araBp,2.6,16,4,TATCAGAAAGGGATACTCGT,12,504243
araBp,0.4,5,4,TAGGAACCTCTGTGCTTACA,1,472238
araBp,5.4,30,4,TAGGAAACTATGCGGGCCGG,26,494440
araBp,4.2,24,4,TAGCTACAGCGATCATTCGT,20,492653
araBp,1.0,8,4,TAGCACTATGGAAACGGTGT,4,481563
araBp,0.4,5,4,TAGAGCGCGGAAACAATAGT,1,498477
araBp,3.8,22,4,TACTTATATCTACCGATGTA,18,501489
araBp,4.8,27,4,TACTCTGCGCCTCCGAATGC,23,471285
araBp,0.4,5,4,TACCCACACGGAGCAGGGTT,1,486001
araBp,3.6,21,4,TAAGCATGACTTTGGGGCTA,17,489323
araBp,3.8,22,4,GTTGTTATCCCGAACCCAGT,18,506612
araBp,4.0,23,4,GTTAGGTGGCCCCAATAATC,19,507251
araBp,3.4,20,4,GTGTCGTAGAATTCGACTTT,16,492562
araBp,0.4,5,4,GTGGTTAATAACCACTATGT,1,488436
araBp,3.2,19,4,GTGGGGCGTATATGCAATAA,15,487923
araBp,7.2,39,4,GTGGCTGCATCTCGGGCGGT,35,515630
araBp,1.8,12,4,GTGGATTAGGGCGCCTCCTT,8,476831
araBp,10.4,55,4,GTGCCCGTGAAGGTAGCTGT,51,501269
araBp,3.0,18,4,GTCGACTCTATTGGTAAGTG,14,518298
araBp,4.0,23,4,GTCCCCAGCCTCGCCGCACA,19,519335
araBp,0.4,5,4,GTAGAGCATACGACCGATCA,1,482764
araBp,2.6,16,4,GGTTTTTAGACAGTGATTCT,12,507054
araBp,8.4,45,4,GGTTTGAGGCTCTGATTAGT,41,512673
araBp,1.2,9,4,GGTGCTCTTTCATCTCTAGG,5,507678
araBp,4.4,25,4,GGTGCGCTCAGCCCCGGCTC,21,471020
araBp,0.4,5,4,GGTCCTAATCGTAACATGTA,1,494429
araBp,8.4,45,4,GGTCCGTACGATAATAATGA,41,486880
araBp,6.2,34,4,GGTCATTCGATATCTATCAG,30,516066
araBp,5.0,28,4,GGTATACCAAGGAGATCATA,24,477548
araBp,7.2,39,4,GGTAACAGCGCCTGTCCTAA,35,476160
araBp,4.0,23,4,GGGGAGAAAGGGGCATATCT,19,509302
araBp,4.0,23,4,GGCTACGCCGTCTGCGACTG,19,489101
araBp,5.2,29,4,GGCCATGTTAGGGTCCACCC,25,519308
araBp,1.2,9,4,GGATACGGTTACCTCCCCTT,5,525219
araBp,7.0,38,4,GGAGCGCACTAAATGCCCGA,34,493995
araBp,3.4,20,4,GGACCTTCGTGTTCAATGGT,16,478903
araBp,16.2,84,4,GCTTCCCATCTGATTGTAAC,80,471978
araBp,0.4,5,4,GCTCGCCAACAGGCTGTACT,1,500865
araBp,5.6,31,4,GCTCCCCACTTTTACTGTCT,27,517735
araBp,5.6,31,4,GCTAGCTAACCACTTTGGTT,27,471330
araBp,1.8,12,4,GCGCACTTCCGAATCACGCC,8,505308
araBp,5.0,28,4,GCGATGTGCTTAGACGCACT,24,510323
araBp,5.8,32,4,GCGAAAGGGAAGGGGCCGGG,28,500114
araBp,5.4,30,4,GCCTCTAATGGTTGAGATGC,26,474321
araBp,4.8,27,4,GCCTCCAACTCTCCACGATA,23,515679
araBp,5.2,29,4,GCCTAGCGAAGAGCGTCTTA,25,520827
araBp,0.6,6,4,GCCCACTGATACGAGCCGGT,2,504306
araBp,5.6,31,4,GCAGTTGCAGACGAAAGCGG,27,489287
araBp,13.6,71,4,GCAGGAGGTCGTGGCTTATA,67,501361
araBp,0.4,5,4,GCACTTCAAGTGGCTCCTGC,1,515105
araBp,6.2,34,4,GCACGCCAGGCCCCATTTGC,30,520217
araBp,5.4,30,4,GCACCCGGACCAAAGGGCAT,26,510274
araBp,5.2,29,4,GCACACAGCGGTCGTGGCTC,25,484600
araBp,0.6,6,4,GCAATGGGCTAGTGCCTGGC,2,475737
araBp,5.2,29,4,GCAAGTACCACGGCGGTCGT,25,515859
araBp,3.0,18,4,GATTAATAGGCGCTTGAGAT,14,511810
araBp,5.2,29,4,GATCAATTGGATGGGGACAG,25,481655
araBp,4.2,24,4,GAGGGGTCTTGTAGTGAAGG,20,469694
araBp,1.8,12,4,GAGAGCAACGGTCTTTTGCT,8,497719
araBp,0.4,5,4,GACTTTCGAATGTAGAACCT,1,483606
araBp,3.0,18,4,GACGAGGTGTGCGGCGAGAA,14,510153
araBp,0.4,5,4,GACCGGTTTTTTACGGGGTC,1,516940
araBp,4.0,23,4,GAACTTATGATTTCTAGTCC,19,491040
araBp,6.8,37,4,GAACAACATGACTTAAACAC,33,480928
araBp,5.2,29,4,GAAACCGACATCGTACCGAT,25,500452
araBp,4.0,23,4,CTTGTCCGGATTTCTGCATA,19,504123
araBp,5.4,30,4,CTTCCGACCAAACGTCTAAT,26,476456
araBp,1.6,11,4,CTTCACCGCTTAAGACGGGA,7,492544
araBp,0.4,5,4,CTGTCACCGCGTTTTACCAA,1,507996
araBp,4.6,26,4,CTGACCCATCTGCAAGATTG,22,517726
araBp,2.4,15,4,CTCACCGTTCAATAACCGCT,11,474772
araBp,4.6,26,4,CTATTAAGGTCCTGAAGCAT,22,512585
araBp,10.8,57,4,CTATGGCGTCCTAAAGGTCT,53,517882
araBp,10.2,54,4,CTAGGAAGTCTTAGATGATC,50,519962
araBp,4.0,23,4,CTACTCATTAGAAACGGTCT,19,487667
araBp,11.0,58,4,CGTGGGAATGTATGAGCCCA,54,477649
araBp,0.6,6,4,CGTCGTCAACTTGGTGAAAA,2,513604
araBp,4.8,27,4,CGGTTGGAAGACGCATTGTT,23,518393
araBp,3.8,22,4,CGGCGGCTATTGGTCACCTT,18,507506
araBp,4.8,27,4,CGCTATTCAGGTCACCGTAC,23,478908
araBp,5.0,28,4,CGCGACTAGAAATCAGGCGC,24,485787
araBp,7.0,38,4,CGCAAAACTGAACTGGCCGA,34,511853
araBp,3.0,18,4,CGAGCCGGAAAGTGTCACTA,14,471896
araBp,3.6,21,4,CGAGCAAACTTTCCCATACA,17,516921
araBp,0.4,5,4,CGACTAACAGGAGCCGTCAT,1,513042
araBp,6.6,36,4,CCTTTGATGCCACGGCTGAT,32,478889
araBp,0.8,7,4,CCTTTATTATCTCCCTAGTG,3,524434
araBp,6.2,34,4,CCTCCTTTTATTCATTGTTA,30,470314
araBp,5.2,29,4,CCGTGGTGGGGCGATCGTAG,25,510522
araBp,4.4,25,4,CCGGGTATTAAAAACTTAGT,21,476156
araBp,2.0,13,4,CCGGCGACAGGGAACACATG,9,499702
araBp,6.2,34,4,CCGCATATCGAAGAATAGAT,30,469391
araBp,5.8,32,4,CCGATACGTATTGGTACCTC,28,516991
araBp,0.4,5,4,CCGACTTGCCCAACACAATT,1,476208
araBp,9.0,48,4,CCCTTCTGGCTCTTTAACAC,44,521864
araBp,3.4,20,4,CCCTATGATTTGACTCCTAG,16,482536
araBp,4.6,26,4,CCCGCCTGAGACATCACCCG,22,500919
araBp,3.0,18,4,CCCAAGGCCTTGGAGGTCAT,14,474458
araBp,2.0,13,4,CCATCAACCGAACTCTGCGG,9,479475
araBp,11.8,62,4,CCAGCCAGGCCAAGGTGGTC,58,511756
araBp,6.0,33,4,CCACCGGGTCCGTGTACATC,29,484186
araBp,3.8,22,4,CATGCAATTTAGTAGGATCA,18,523887
araBp,7.0,38,4,CAGTTCTATATTGGGACTTT,34,508858
araBp,18.0,93,4,CAGGAAATGACAGATGAAAT,89,517856
araBp,0.4,5,4,CAGAGGGTTACAGACCGGGT,1,498075
araBp,2.8,17,4,CAGACGAAGGATTTGTCTAA,13,500358
araBp,0.4,5,4,CAGAACTAAGATCCCCGCAC,1,484466
araBp,3.2,19,4,CACTGCCAGCGATTTTGGCA,15,494145
araBp,3.4,20,4,CACTCGTGCATGAGCCACAG,16,502305
araBp,4.6,26,4,CACAGGAGCAGAGGCTCGAT,22,507696
araBp,7.4,40,4,CACAAACCACCTCTCCGTGT,36,477179
araBp,5.6,31,4,CAACCAGGGTAGTTTGCCTC,27,498775
araBp,3.8,22,4,CAAATAGTAGCGCAAGCTGA,18,509822
araBp,7.8,42,4,CAAAGGCCTAGGATGGCGAC,38,507131
araBp,4.2,24,4,ATTTTGCGGTCTGTTGACTT,20,501208
araBp,3.2,19,4,ATTTCGTTTGAGTGCATGCA,15,471237
araBp,6.0,33,4,ATTGGATATTATATGGGCGC,29,495539
araBp,15.8,82,4,ATTCATTTTGAACTTCCAAT,78,511616
araBp,10.8,57,4,ATCTCACAATTGTAGTGCGT,53,486490
araBp,2.6,16,4,ATATAAATGGACCGCCTTTG,12,499910
araBp,5.8,32,4,ATAGGACTGCAGACAGGAGG,28,480158
araBp,3.8,22,4,ATAAGTCAAGCAGTCTAACA,18,510938
araBp,6.8,37,4,AGTGGCCGTTGTTGAGCAGG,33,508805
araBp,6.6,36,4,AGTGGCAGTCTTTGAATAAT,32,489916
araBp,0.4,5,4,AGTGATTGTCTAGTAGCTGG,1,515382
araBp,5.4,30,4,AGGCGGTTGACTTGGTATCC,26,513085
araBp,3.6,21,4,AGGCGCGTAATCCTGTACAA,17,478741
araBp,4.4,25,4,AGGAGAAGATCTTCGAGTGC,21,507398
araBp,2.6,16,4,AGCTGACCACCGCCTCATTT,12,473211
araBp,19.8,102,4,AGCTCACCGGATTTGGTGAC,98,519338
araBp,0.4,5,4,AGCGTTTCCTGGGAACGCAA,1,480272
araBp,4.8,27,4,AGCGCGTGAGCGCCCCGTAA,23,523277
araBp,7.6,41,4,AGCGAACCAGTAGTACCGGT,37,501806
araBp,4.8,27,4,AGCCCCCAGAGTCGGCTGAG,23,509225
araBp,5.2,29,4,AGATTGAGGAAAATATACCG,25,479588
araBp,5.2,29,4,AGATTCCAACGTGGTATCGA,25,493502
araBp,10.4,55,4,AGACTTTCTTACAACAGGCG,51,480630
araBp,4.8,27,4,ACTCTGCTCTTAGAGCCGAC,23,510835
araBp,5.8,32,4,ACTCCGGTAGCTCTACTTAA,28,496308
araBp,4.4,25,4,ACGTGTACTCGGAACAACGA,21,482103
araBp,4.6,26,4,ACGTGAAGTGTGGGCAAATT,22,485955
araBp,5.4,30,4,ACGGGGTTAGGGGATGGGAT,26,474168
araBp,0.4,5,4,ACGCGGCTTAGTCTCTAATA,1,470378
araBp,6.2,34,4,ACGCCATAGCGAGTGGCGCT,30,469503
araBp,6.4,35,4,ACCTTTCCTTGGATACAAGA,31,478099
araBp,4.4,25,4,ACCCGCGGTCTCGTCTACAG,21,482350
araBp,0.4,5,4,ACCCGCCGCGCATAACATAC,1,491457
araBp,2.0,13,4,ACCCCCCGGGGGAATGCCTG,9,487943
araBp,18.6,96,4,ACATGGTCGCGTTTTTCGCA,92,490342
araBp,0.4,5,4,ACATCGTCGTGAATGTTAGC,1,493294
araBp,4.4,25,4,ACAGCCAGGCCGGTCGTGCC,21,469295
araBp,10.2,54,4,ACAGACGCAATAATCAGAGC,50,501552
araBp,4.6,26,4,ACAAGCGGAGTACTCATCGG,22,470907
araBp,11.2,59,4,AATATAGAAATAGCACGAAA,55,513084
araBp,4.0,23,4,AAGTTACGATGCTAACCGCG,19,492355
araBp,4.6,26,4,AAGGTTGGACTGCTCGTGTC,22,494618
araBp,3.4,20,4,AAGCGCGTTCTGAACCAAAC,16,508488
araBp,0.4,5,4,AAGACATTTTCGGCGATCCT,1,525498
araBp,4.6,26,4,AAGAAGTTGCGCCAGTTTTA,22,477284
araBp,3.2,19,4,AACTGCAACTCAGCCAAATC,15,517879
araBp,0.4,5,4,AACCGAGCACATTGATTGAA,1,482633
araBp,0.4,5,4,AAAGCCATATTCTTGTAGTG,1,513910
araBp,0.4,5,4,AAACCTGGTGTCCCAGAAAC,1,483562
araBp,0.75,5,3,TTTATTGTATACTCTCCCCT,2,523124
araBp,6.5,28,3,TTGCGAACCACTTGCGCTGC,25,510659
araBp,5.75,25,3,TTGCCAGATATCCTGCCCTT,22,511135
araBp,2.5,12,3,TTCTGCACAAGTGATACGAT,9,480067
araBp,8.0,34,3,TTCTCTGTCAGCGCGAAGTA,31,511336
araBp,0.5,4,3,TTCGGGCTGCCTTCAGTTAA,1,507500
araBp,12.5,52,3,TTCAAGGCACGCGCAAGAAT,49,498338
araBp,0.75,5,3,TTAGACCTAGGTTAAACACA,2,498405
araBp,5.0,22,3,TTAGAACTTAGTTAGGATTG,19,498319
araBp,5.75,25,3,TTAATTTTGCGTTGGGGTTG,22,515057
araBp,9.5,40,3,TTAACCATTTCAGTTTATTG,37,510980
araBp,16.0,66,3,TTAACAGCCTTGAGGTGCAA,63,471997
araBp,4.5,20,3,TTAAAGGCGCCTGAACTGAC,17,484811
araBp,6.25,27,3,TGTTGGTGAGGGGCCCTCGT,24,518622
araBp,13.0,54,3,TGTCACGCATGGCGCTCCGC,51,486693
araBp,10.5,44,3,TGGTGACCCCATCTCGGGTT,41,518356
araBp,5.75,25,3,TGGTCAGGTCCCGGAACGGC,22,515453
araBp,0.5,4,3,TGGTATGTAATTAGACGGAG,1,523858
araBp,4.75,21,3,TGGCATTGTTTCCGTATGAG,18,494809
araBp,0.5,4,3,TGGATGCCCGGCGACATTTG,1,503228
araBp,7.5,32,3,TGCTTCTTTGAGGTGAGGGG,29,505170
araBp,0.5,4,3,TGCTGATATGAATGTTGAAA,1,514885
araBp,2.75,13,3,TGCGAGTGATTTATAGGGGT,10,505093
araBp,6.25,27,3,TGCAAGAAGCAGTACGGCCA,24,493833
araBp,3.75,17,3,TGCAAAGGTCAAGGGCCTTT,14,488827
araBp,0.75,5,3,TGATGCTAAGCGTTACGTTC,2,487144
araBp,9.5,40,3,TGAGCGGTCAGGCAAACACG,37,487972
araBp,4.5,20,3,TGAAGAGATCCGCCTTACTC,17,491850
araBp,5.25,23,3,TCTTCGTCGTCCTTTATAAA,20,493224
araBp,7.25,31,3,TCTGAGGTGGATATAGATTC,28,470070
araBp,0.5,4,3,TCTACACCGATGCCATCGCC,1,480016
araBp,5.25,23,3,TCGTGATGTAAGGACTATGC,20,484349
araBp,7.0,30,3,TCGTCTAGCCCGGCCCTGGG,27,497199
araBp,7.0,30,3,TCGCGTCTTGCTCTCAAACT,27,474528
araBp,8.0,34,3,TCGCCCGCCTGTTGTTCAGA,31,488528
araBp,2.0,10,3,TCGAGGAGCGAGAAGATCAG,7,499066
araBp,0.5,4,3,TCCTTGAACTTATAGAGGAT,1,503586
araBp,3.75,17,3,TCCTCATTGCTTCACGAGTC,14,480164
araBp,5.0,22,3,TCCGAACAGGCCTTCGATTC,19,512962
araBp,7.75,33,3,TCCCGTAAGCGAGAAATCCT,30,471629
araBp,6.5,28,3,TCCCCGGGTCTTGTATATCG,25,502295
araBp,0.5,4,3,TCATTGACCGTTGCGCAAAG,1,511337
araBp,6.5,28,3,TCAGTGAAGGACTCACGTAT,25,511776
araBp,6.75,29,3,TCAGGTAACAATGCTAACTC,26,494803
araBp,5.5,24,3,TCAGCTTACTCGACTTCGTC,21,487828
araBp,0.5,4,3,TCAGAGTAGTACGCGGCGAT,1,469217
araBp,0.5,4,3,TCAAAGGAGCGTTATTACTA,1,497906
araBp,3.25,15,3,TATCTTTTGGCAAAGCGAAG,12,505053
araBp,9.5,40,3,TATCAGTTGGTGCGTGCGTA,37,519595
araBp,13.0,54,3,TAGGGTCCGCACCAGGTCAT,51,517272
araBp,5.0,22,3,TAGCTTTATACATTCGGTGC,19,511634
araBp,0.5,4,3,TAGCATGGCAGATTGCCATA,1,513097
araBp,5.5,24,3,TAGAACGTAATTTGCGATAG,21,516038
araBp,5.0,22,3,TAGAAAGAACCCACTAGCCC,19,512580
araBp,5.5,24,3,TACTGCAGGTGTCCTACTCG,21,504426
araBp,4.5,20,3,TACGACGGAGAGACCATGAT,17,505375
araBp,4.75,21,3,TACCATCGGAGAAAATACCG,18,488963
araBp,4.25,19,3,TAATGGCGATGCTGATCTAT,16,503867
araBp,7.25,31,3,TAATGGCCATTTATGTAGGT,28,516982
araBp,8.75,37,3,TAATCAGGTACTAATGGAAC,34,486392
araBp,7.5,32,3,TAAGGCGACAACCGACGCAG,29,505172
araBp,5.0,22,3,TAAGAGGTTTGCCTAACGTG,19,494649
araBp,0.5,4,3,TAACAAGAGGGGGTCTCAAT,1,474753
araBp,0.5,4,3,TAACAACCTCAGCTGGGGTC,1,468679
araBp,7.0,30,3,GTTGTGGACACGGGCCGTAG,27,477131
araBp,5.0,22,3,GTTCCTAGCCACAGGTCCAA,19,500622
araBp,4.5,20,3,GTTCAGTAGACGGCCTTAAA,17,513686
araBp,1.75,9,3,GTGTTTGCTGGAGGGAAGTC,6,505551
araBp,5.75,25,3,GTGTAAACATGATAGGAGAA,22,487595
araBp,8.0,34,3,GTGTAAAAGGTCCACCCGAA,31,499988
araBp,6.75,29,3,GTGGGTCGCTCGTAACCCGA,26,517256
araBp,2.25,11,3,GTGCCGTCCCTGTCATATCT,8,507152
araBp,4.25,19,3,GTCGAGTTAATTGTGAAGCA,16,476635
araBp,0.5,4,3,GTCATTACGATATTGGAAAC,1,471311
araBp,3.5,16,3,GTATTGCATCCGGGACAAGG,13,524673
araBp,15.0,62,3,GTAGTGCACGGTCTAGCGTC,59,512416
araBp,6.75,29,3,GTAGCCGTCCGGCAGTGACG,26,482154
araBp,4.25,19,3,GTAAGCGTGAACCGTTGATA,16,474919
araBp,3.5,16,3,GTAACGTAAGCTTCCTTAAT,13,508944
araBp,3.25,15,3,GGTGTTAGTGCGAGAAGCGG,12,519951
araBp,6.25,27,3,GGTGTATCTGGTTGGAGAGA,24,518185
araBp,7.25,31,3,GGTGGCACAACATGCAACTA,28,503504
araBp,5.25,23,3,GGTGGATACAATTTCGGCGT,20,476547
araBp,4.75,21,3,GGTCATTTATTGTACGCTCA,18,503278
araBp,5.5,24,3,GGTAGGACGTCCTCTTCGAT,21,495246
araBp,5.0,22,3,GGGGCTAAACTGTTCACTTT,19,485017
araBp,7.75,33,3,GGGGAACCTCGAATCGACTA,30,515961
araBp,5.5,24,3,GGGCTTGCGGTCCCGCCAAA,21,471678
araBp,7.75,33,3,GGGCGTTTGGGCTTGAAGTA,30,496550
araBp,5.0,22,3,GGGCGGACGCTAGTACTACA,19,485133
araBp,9.25,39,3,GGCTTGGCTACCAGTGGCTT,36,473839
araBp,0.5,4,3,GGCCTGGTGCTTAAGAGCCC,1,517867
araBp,6.0,26,3,GGCAGGGCTGTCATTGTATT,23,478793
araBp,18.5,76,3,GGAGCGTATAAGCCTGCGCG,73,482015
araBp,11.5,48,3,GGACTCCCGAGCTCACATCT,45,472789
araBp,2.5,12,3,GGACCATAGCCCCCAGCTGG,9,515297
araBp,0.5,4,3,GGAATGCGTTCGCCCGCAGG,1,504374
araBp,2.75,13,3,GCTCTCATGACTAAGAAGTC,10,497984
araBp,2.75,13,3,GCGCTGCGCGTGCCTCCACC,10,478697
araBp,10.25,43,3,GCCTGAGTGCAAAATGAACT,40,482333
araBp,4.75,21,3,GCCCGGTCGCACTGAGCTCC,18,490978
araBp,23.75,97,3,GCCCGCGACTGGGGATACTG,94,517393
araBp,3.5,16,3,GCCACGCCGACAGTTAGATG,13,487731
araBp,9.75,41,3,GCCACCGCCGGGCGTTTTAG,38,517210
araBp,4.25,19,3,GCCACCAGACGAGTCGCTGT,16,493177
araBp,5.5,24,3,GCCAAAAGGATTATTTCCTC,21,524709
araBp,5.75,25,3,GCAGTTACTTTGACTGGTGC,22,492345
araBp,7.75,33,3,GCAGAATCCAGGGGGTCTGT,30,522883
araBp,0.5,4,3,GCAAGCTTCACAGACTTAGT,1,494527
araBp,6.0,26,3,GATCGGGGGGCACGATGCCT,23,486868
araBp,2.0,10,3,GATCCATCTGCAGATTCAAA,7,521045
araBp,5.5,24,3,GATACGTAGAGACGTCCAAC,21,475656
araBp,4.5,20,3,GATAAATGCCTCGGTGCGCC,17,471676
araBp,2.5,12,3,GAGTTGATTCCCCTATCTCT,9,488196
araBp,0.5,4,3,GAGAGGTGTGGCGTGAGTGT,1,486278
araBp,8.75,37,3,GACGGCAAAACCAAGCCCTT,34,488164
araBp,0.5,4,3,GACGAACAGATTGATGGATT,1,503108
araBp,7.0,30,3,GAAGTGGTTGTAGTGGGTCA,27,497907
araBp,5.5,24,3,GAACTCACTAAATTTTAGGT,21,522974
araBp,6.0,26,3,CTTTCCCCGAGCCGGTCGAA,23,500816
araBp,4.5,20,3,CTTGCTCCACGATGCGTCAC,17,478300
araBp,5.5,24,3,CTTGATTTGGCGTCAAAGTC,21,472168
araBp,5.25,23,3,CTTCACATTTAGCGTGCTTT,20,491603
araBp,6.25,27,3,CTGTTAACCCGCTTTACCTA,24,478891
araBp,6.25,27,3,CTGTCTCTTAATCCAAGACA,24,477757
araBp,4.75,21,3,CTGTAACGACTTACGACAGT,18,508836
araBp,3.5,16,3,CTGGCAATGTCACGCTGTAA,13,469500
araBp,5.0,22,3,CTGCGTCTACGCGACTTTAC,19,502866
araBp,0.5,4,3,CTGCGCGGACAAGTCCCAGA,1,472916
araBp,7.5,32,3,CTCCAAACGCTCAACATCCC,29,517397
araBp,0.5,4,3,CTATGTGTCACCGCCATACG,1,495228
araBp,6.0,26,3,CTATGCGGTACCTTTTACCC,23,513088
araBp,4.25,19,3,CTATCGTACTTCCCCATACG,16,513964
araBp,6.0,26,3,CTATAACAGGCCGAATATAG,23,514097
araBp,6.25,27,3,CGTTAGCTATCTCACGGCTG,24,518256
araBp,5.25,23,3,CGTCCTTCCTGTCCCCCGGC,20,484911
araBp,5.0,22,3,CGTACCCGCCTTAGTAGCTC,19,471264
araBp,2.75,13,3,CGGTGCGGAAGCTCAGCCGG,10,472420
araBp,10.75,45,3,CGGGTATCCCTCGCGGGCTC,42,480331
araBp,4.5,20,3,CGGAAGCCCAATGGGGTTGT,17,501381
araBp,10.0,42,3,CGCTACGTGGCGGTTGTGGC,39,501190
araBp,6.0,26,3,CGCTAATGCGTGGAGTCTTG,23,505056
araBp,12.75,53,3,CGCGTGAAGCCATCATCGGT,50,482018
araBp,6.5,28,3,CGCAGTGATGGGACGTAACG,25,498107
araBp,6.25,27,3,CGCAGTACACGTATAGTCAC,24,482381
araBp,0.5,4,3,CGCACAGCTATTTTTGCCTT,1,492814
araBp,1.75,9,3,CGATAGAAGCAGGGTTGGGA,6,495637
araBp,4.25,19,3,CGAGTGATGGCAATGGGGGT,16,477931
araBp,4.25,19,3,CGACCTAGGAACTGTGCACA,16,483496
araBp,6.25,27,3,CGACATAAGCGTGATCCCGA,24,500410
araBp,6.25,27,3,CGACAAGGAATGCGCACCGC,24,472413
araBp,2.75,13,3,CGAAACTCGCCGATGTTCGA,10,522033
araBp,5.25,23,3,CGAAACGCGCGTTCTTTTTA,20,493534
araBp,3.75,17,3,CCTTTTTGACTGCCACACGT,14,482534
araBp,4.25,19,3,CCTTTGAGCTGGCCAACCCT,16,523472
araBp,5.75,25,3,CCTAGACCCTATACGAGCGA,22,512165
araBp,4.5,20,3,CCGTGCCACGGCTGTTTAAC,17,511860
araBp,22.25,91,3,CCGGTCAAAGCCTTACGCGC,88,525381
araBp,4.0,18,3,CCGGTATTCGTCTTTTGTTA,15,513588
araBp,5.0,22,3,CCGGAGGTCTCACGGCATTG,19,471006
araBp,7.25,31,3,CCGCACACAGTAATACGGTG,28,523149
araBp,7.0,30,3,CCCTGCTGGATCGCACAGCT,27,510056
araBp,0.5,4,3,CCCATGGGAATCTGTAACAG,1,482844
araBp,0.5,4,3,CCATTACCTCGCACACTGAC,1,476171
araBp,5.25,23,3,CCATAGGCTTAGCCCACGAA,20,476669
araBp,5.25,23,3,CCACACGTAGCTGATCCTTC,20,507991
araBp,6.75,29,3,CCACAATCTTGCACTAAGTT,26,507037
araBp,4.0,18,3,CCAATCAAAGGACGGAGCCT,15,515399
araBp,6.0,26,3,CCAACGGCAGCTCGGTGGTC,23,503167
araBp,6.0,26,3,CATTTGCCTAGGTGTAGTGC,23,480777
araBp,3.5,16,3,CATTTCGTATGGTCTCAGCG,13,472248
araBp,7.5,32,3,CAGGTAAACTCTGGTCATGA,29,478713
araBp,6.25,27,3,CAGCCCAAGGAGTAGCCCCT,24,500430
araBp,5.25,23,3,CAGCCAGAATGTACTCCGAG,20,474792
araBp,0.75,5,3,CACTTGGACTAACTAACAAG,2,469051
araBp,9.75,41,3,CACCCGCTGGTATGCAAATC,38,503489
araBp,3.25,15,3,CAAATCCAAATCGCCTCAGC,12,477678
araBp,5.0,22,3,ATTGTAGCATTGAAGTTGGG,19,515454
araBp,4.25,19,3,ATTGTAACGTAGCATATCAA,16,489983
araBp,4.75,21,3,ATTGGTACAGGTGTAGATTG,18,493591
araBp,5.0,22,3,ATGTTTCAGTACGGGGCCAA,19,511056
araBp,0.5,4,3,ATGCGATGAGTGGGCTTGGG,1,485127
araBp,7.75,33,3,ATGATCGCCGCTACGTAATA,30,487375
araBp,4.75,21,3,ATGACCTCGCACTGTAGTGA,18,515069
araBp,1.75,9,3,ATGAATGGAAACTCTCTCCT,6,500914
araBp,0.5,4,3,ATCTCCCAGACCGTTACATC,1,474369
araBp,5.75,25,3,ATCCAGGTAATATTAGAGTC,22,474782
araBp,5.75,25,3,ATCAGTCCGCCCGGTCTGTA,22,471986
araBp,7.5,32,3,ATCAGGTACGCCCCAGTCGT,29,499491
araBp,4.5,20,3,ATACAGGGTTAGTCGGGCCA,17,487728
araBp,4.25,19,3,ATAAAGAGTGAGCTAGTCCT,16,499931
araBp,6.0,26,3,AGTTCGAGATATGTGAGGCG,23,478555
araBp,5.0,22,3,AGTGGGTCTATAAGGCCCCT,19,509598
araBp,5.75,25,3,AGTCGTACGTATGTAGATGC,22,469200
araBp,11.75,49,3,AGTCACCCACAATCACGGGT,46,489042
araBp,12.75,53,3,AGTAATAGTCAACCTAACTG,50,502681
araBp,3.5,16,3,AGGTCGCAGCTCTGCCAGCG,13,512322
araBp,6.25,27,3,AGGTAATTATATCGTCTGCA,24,525041
araBp,6.25,27,3,AGGGGGGAGCACACAAACGC,24,522192
araBp,7.25,31,3,AGGGGCGAAAAAACCGTTGC,28,477531
araBp,5.25,23,3,AGGCTATTATAACTGCACCA,20,497731
araBp,8.0,34,3,AGCTGACGCCAGTGACGATG,31,490131
araBp,4.5,20,3,AGCCCTGTTCACGAAGACCT,17,518132
araBp,7.0,30,3,AGCATGTCCGCGTATCGCAG,27,508917
araBp,0.5,4,3,AGCAATAGTGGACTGTTTGT,1,471580
araBp,0.5,4,3,AGAGCGATAGAGAGCTCAAT,1,490768
araBp,5.25,23,3,AGAGAAAGCGCGGTGCTCCT,20,497532
araBp,6.75,29,3,AGAAATTTGCCATCTAATAA,26,490841
araBp,4.5,20,3,AGAAAGGAACTCGAATGTTG,17,491439
araBp,4.5,20,3,ACTTGTCTCAGGACACGTCA,17,508849
araBp,0.5,4,3,ACTTCTCGAAGTCACATTCA,1,504467
araBp,7.0,30,3,ACGTCGCAGCACCAACGAGC,27,516135
araBp,4.75,21,3,ACGCGGCCCTGCGGAGCTTA,18,494629
araBp,7.75,33,3,ACGATACAAGAGTTCATTAA,30,519316
araBp,8.75,37,3,ACGAATCCGGGATCCAATCC,34,493499
araBp,6.75,29,3,ACCTTATAAAGTGTAGTTAG,26,473002
araBp,6.0,26,3,ACACTCTCATAGGAGCCCAC,23,488666
araBp,0.5,4,3,ACACAGACCGCGAACGGCTC,1,505496
araBp,11.0,46,3,ACAATCGTTCTGTGGTATTG,43,500616
araBp,8.0,34,3,AATTGACAAACCGATGGAAA,31,479346
araBp,6.5,28,3,AATGTAATGTATAACTCTCT,25,498388
araBp,3.25,15,3,AATCCGCGCAGAGGTGTCGG,12,475530
araBp,7.0,30,3,AACTTGCGGTGTGGCCAGAT,27,500621
araBp,0.5,4,3,AACTCAGGTGCAAGCATTTA,1,506716
araBp,0.5,4,3,AACGAGTGCGGCCCATAGGT,1,520846
araBp,0.5,4,3,AAATTAAGACAGGTTCGCTG,1,473455
araBp,1.75,9,3,AAATAGATGAGCGATCCTCA,6,484400
araBp,2.75,13,3,AAAGTATAGTATGAAATCAA,10,498027
araBp,6.75,29,3,AAACGTGAAGGACATAGACG,26,493125
araBp,7.333333333333333,23,2,TTTTCACAATTAACCGTTAG,21,519705
araBp,10.0,31,2,TTTGGGTTTTTGGCGAAAAT,29,506400
araBp,5.666666666666667,18,2,TTTATAGCGCGTCACACACT,16,496695
araBp,0.6666666666666666,3,2,TTGAGGTCAGTCCAGAATCA,1,510686
araBp,13.333333333333334,41,2,TTGACGAAGACTCAGAATGA,39,472549
araBp,16.333333333333332,50,2,TTCTCTGCTCGGTCCATTGG,48,511763
araBp,6.333333333333333,20,2,TTCCAGGGAGAGTAATGATG,18,522856
araBp,7.666666666666667,24,2,TTATTCCAGCCCTCCATGCA,22,497596
araBp,5.666666666666667,18,2,TTACTTAACACGACGAATTA,16,483999
araBp,8.666666666666666,27,2,TGTCCGCGACTCCCTCGTTC,25,509831
araBp,5.666666666666667,18,2,TGGGTCTCAATCTCTGGACA,16,483724
araBp,11.666666666666666,36,2,TGGGCGTCAATTTACGAGAG,34,498142
araBp,0.6666666666666666,3,2,TGGGCCAGCATGAAGCGCAT,1,475943
araBp,16.333333333333332,50,2,TGCGTCAGAGAGCTTCTTGG,48,498560
araBp,5.666666666666667,18,2,TGCCCTGCTGACCGGAAGAC,16,494101
araBp,8.0,25,2,TGATTAACTGTCACTTAACA,23,493036
araBp,0.6666666666666666,3,2,TGAGATGGGAACGATCGGCA,1,489960
araBp,7.333333333333333,23,2,TGAAGCCTGAGAGTCGAACT,21,510935
araBp,9.333333333333334,29,2,TCTGCGTGCCAATCGATAAA,27,472310
araBp,13.333333333333334,41,2,TCTCTACCCGTGGTAAAGCT,39,508482
araBp,4.666666666666667,15,2,TCTCGATAGACTTAACTCGG,13,512422
araBp,15.333333333333334,47,2,TCTCCACAGGCGACGATTTG,45,490969
araBp,7.666666666666667,24,2,TCTACCGCAAATATGTTCTC,22,477784
araBp,0.6666666666666666,3,2,TCGTGGCAAGAATCAACTCT,1,469833
araBp,7.0,22,2,TCGTGCTCACGGCGTTGAAA,20,511795
araBp,7.333333333333333,23,2,TCGTCCTGGGCATGGGGGAC,21,521818
araBp,0.6666666666666666,3,2,TCGCGCTTTGAATCAAATTA,1,506564
araBp,8.333333333333334,26,2,TCGAGCCGACAAGCTTACTC,24,504935
araBp,6.333333333333333,20,2,TCGAGACAGGTATTCTGGCT,18,472186
araBp,6.666666666666667,21,2,TCCTGCGTGGAGACTGTAAG,19,515088
araBp,8.666666666666666,27,2,TCCGGTTTCAGAACAGCAAG,25,521866
araBp,8.333333333333334,26,2,TCCAAGGACCGACCGCTCGA,24,479890
araBp,7.0,22,2,TCAGATCTATCTCTAGTTTA,20,505804
araBp,10.0,31,2,TCACGTTGAGCCCGTCCACT,29,511519
araBp,8.0,25,2,TATTAAAAAGGCGGACATCA,23,516690
araBp,7.0,22,2,TATATCTGGTGCATAAGAAA,20,509155
araBp,0.6666666666666666,3,2,TAGGGCAACGGCCCTGGTAT,1,498046
araBp,1.0,4,2,TAGGAGTTTCATGGCAGGTC,2,471638
araBp,7.666666666666667,24,2,TAGCACCGATCGTTACGGTT,22,487267
araBp,7.333333333333333,23,2,TACTGCCAGGCAGGTAAGGT,21,486179
araBp,18.333333333333332,56,2,TACTCGTGCTGCCTCGTGGC,54,502495
araBp,17.333333333333332,53,2,TACGGATTAAACCGTAGGGT,51,514862
araBp,8.666666666666666,27,2,TACGGAAAGCCGGGTGACAG,25,471093
araBp,8.0,25,2,TACCCCAAGAAAGGTGTGTA,23,508616
araBp,7.666666666666667,24,2,TAAGCAATAGGGGTGAATGT,22,469643
araBp,8.0,25,2,GTTTGACTGACGGAAAATAT,23,483600
araBp,8.666666666666666,27,2,GTGGCTGTTGCCACTGATCA,25,468291
araBp,4.0,13,2,GTCTATTCGGGTTCTCCTTG,11,493605
araBp,7.0,22,2,GTCGTTCCATATCCATTTGC,20,504181
araBp,7.333333333333333,23,2,GTAGTACATCCGATTAGGGA,21,478540
araBp,9.666666666666666,30,2,GTAGACAAGGCTGTGGCAAA,28,512089
araBp,7.666666666666667,24,2,GTAATTATAGAGATAATGAG,22,492267
araBp,8.0,25,2,GGTTGGAATAGTATGCCATT,23,470382
araBp,0.6666666666666666,3,2,GGTACCTGACGCAGCCCCTC,1,516322
araBp,5.666666666666667,18,2,GGGTATTCAACATTCAGATG,16,483029
araBp,12.0,37,2,GGGTATACGACAGGCAACGT,35,510971
araBp,7.0,22,2,GGGCCTATCGTCATAGATCG,20,518931
araBp,8.333333333333334,26,2,GGGCCGGGTTTACAGGAGGA,24,517254
araBp,11.666666666666666,36,2,GGGAGGGAGTTGAACGTGAC,34,524206
araBp,8.666666666666666,27,2,GGGACAGCGATCGGTTGTAT,25,494029
araBp,9.333333333333334,29,2,GGCTAAACCTGGAGGGTGAC,27,478816
araBp,6.666666666666667,21,2,GGCGTGTCGGCGACTGTTAA,19,470592
araBp,5.0,16,2,GGCGGCGCTAGTAGAAGCCG,14,523096
araBp,10.666666666666666,33,2,GGCCACAGCCGGTTCGATTA,31,497664
araBp,3.6666666666666665,12,2,GGCAGAGCCCAGGCGCAGGC,10,518002
araBp,5.0,16,2,GGAGATCGCGTTCTTCGGCC,14,470461
araBp,7.0,22,2,GGACCCCTAATGCCAGACTC,20,506789
araBp,7.0,22,2,GGAATTGAGGTCGTTCGAAG,20,520666
araBp,29.666666666666668,90,2,GCTTGGGCTACTCACGGTGA,88,472320
araBp,1.0,4,2,GCTGTTCGAGCAAACGCACG,2,506291
araBp,18.333333333333332,56,2,GCTGGAAGAACCTGTCGAGA,54,511137
araBp,5.333333333333333,17,2,GCTCGCAATACACTGGGTTT,15,502192
araBp,6.333333333333333,20,2,GCTACGTTCGCGTGATCAAT,18,522634
araBp,6.666666666666667,21,2,GCGTCAATCCCCGCCATAAG,19,481624
araBp,8.333333333333334,26,2,GCGGCACGAGAACCGTATAA,24,522304
araBp,5.333333333333333,17,2,GCGAGATCAGTGTGGGTCCA,15,510235
araBp,5.666666666666667,18,2,GCGAGAAGTGAGACAGTGGT,16,483414
araBp,11.333333333333334,35,2,GCCAGAACGGAGCACGGCAG,33,501526
araBp,2.0,7,2,GCATAGGGTCATCGTAGCGA,5,501924
araBp,8.333333333333334,26,2,GCAGGCTCCCGAAGCAGGTT,24,497767
araBp,8.666666666666666,27,2,GCAATAGCTCTTATTGCGCT,25,468467
araBp,8.333333333333334,26,2,GATGATCAAGGCGTATACGG,24,486127
araBp,4.333333333333333,14,2,GATCTGCGCCCGTGGAGAGT,12,480925
araBp,0.6666666666666666,3,2,GAGATTTCTCGCTTTCCCGT,1,498129
araBp,0.6666666666666666,3,2,GAGAGTAGATCGGCGCGTGT,1,507278
araBp,0.6666666666666666,3,2,GACTTGTTAGGTTGCCTAGT,1,525170
araBp,19.333333333333332,59,2,GAATCGGTAGGACCGTAGAG,57,517405
araBp,1.6666666666666667,6,2,GAATATACAGAGTTCCCAGG,4,504772
araBp,6.333333333333333,20,2,GAAATATGGATATCTGACGA,18,486910
araBp,10.0,31,2,GAAACCCTTCTCACACGTTA,29,512589
araBp,1.3333333333333333,5,2,CTTACGACATGGGCGTCAAC,3,495157
araBp,6.666666666666667,21,2,CTGTCCCTACCGTCAGCATA,19,484861
araBp,10.666666666666666,33,2,CTGGCACCCAGGCCTCTCGT,31,518413
araBp,0.6666666666666666,3,2,CTGCCCGAATCGAGCAAATT,1,496999
araBp,9.0,28,2,CTCTGTGATCTCTTACTGGT,26,502137
araBp,0.6666666666666666,3,2,CTCTACGGGCGTTTTTTTGC,1,484893
araBp,1.6666666666666667,6,2,CTCGTGATCCTTCTTTCATT,4,472130
araBp,9.666666666666666,30,2,CTCGGGGGACAGAACCGATG,28,511417
araBp,4.666666666666667,15,2,CTCCTAGTGCAGCTGTCGGT,13,476312
araBp,6.0,19,2,CTCCTACTCGTCACGCTGGG,17,503284
araBp,6.333333333333333,20,2,CTCAATCAGGGGATTTATAT,18,517259
araBp,37.666666666666664,114,2,CTACCCTTACTTTGGCTGAG,112,511102
araBp,5.666666666666667,18,2,CGTTAATGCGATGGATATGC,16,506609
araBp,0.6666666666666666,3,2,CGGTGATAGGTTCGGTCTTT,1,502366
araBp,6.0,19,2,CGGTGAAAGTACATGGAGTT,17,523259
araBp,3.6666666666666665,12,2,CGGCGGGAGTTTTAGTGGTT,10,470732
araBp,7.333333333333333,23,2,CGGACTTCCTCATTCATTCG,21,492446
araBp,9.0,28,2,CGGAAATTGAAGAGCTAAGA,26,513089
araBp,0.6666666666666666,3,2,CGCTTATAATGTGCAGAAGG,1,521262
araBp,8.333333333333334,26,2,CGCTCGTCAATGCCCTTACG,24,489696
araBp,8.333333333333334,26,2,CGATCGGGCAAGCTAGCACC,24,485705
araBp,0.6666666666666666,3,2,CGAGGCAATGGGATCAGTCT,1,493063
araBp,7.333333333333333,23,2,CGACACTCACAAACTACTGG,21,503047
araBp,12.0,37,2,CCTTCGCCCTGAGCTCGACT,35,506937
araBp,7.333333333333333,23,2,CCTGGACATAAGTGGATGGA,21,491476
araBp,13.333333333333334,41,2,CCTGACCAGAATCACAGCCT,39,501568
araBp,17.666666666666668,54,2,CCGTTGTCGTCTAATTGTCA,52,471690
araBp,10.666666666666666,33,2,CCGGCAATGGTCTACGAAGT,31,499837
araBp,5.333333333333333,17,2,CCGCGCGGACCTAGATAGGA,15,494212
araBp,11.666666666666666,36,2,CCGCAAACACGTACCACCGG,34,494896
araBp,5.0,16,2,CCCGGCCGCAGTCACAAGTT,14,516228
araBp,9.0,28,2,CCCATATATAGCAGTAGTCG,26,525375
araBp,13.333333333333334,41,2,CCAGGGGCACACCGCACTTT,39,491379
araBp,8.0,25,2,CCAGCTAGCTACAGCCAACC,23,479889
araBp,7.333333333333333,23,2,CCACTGGCGAGCTCACTCTA,21,495463
araBp,9.666666666666666,30,2,CCACTGATTCCGACAAACGC,28,504578
araBp,3.3333333333333335,11,2,CATTGGAAACTCAAAGGGAC,9,523757
araBp,5.666666666666667,18,2,CATGGTTGATGGTCGTCCTT,16,473546
araBp,7.666666666666667,24,2,CATCTTTCTTGCGGTTAGAT,22,510001
araBp,6.666666666666667,21,2,CATCCAAACAGTGGCCGGTA,19,506761
araBp,7.0,22,2,CATAGTTTATTATGTTTGTT,20,518574
araBp,8.666666666666666,27,2,CATAAACGTAGGGTCAAGTA,25,485191
araBp,12.666666666666666,39,2,CACGGCGTGCCCACGCATCT,37,500617
araBp,1.0,4,2,CACGCTTAAACCATATCCGT,2,505330
araBp,0.6666666666666666,3,2,CACGATCATCATTCCGCATA,1,518097
araBp,2.0,7,2,CAATAGACGCCACGATAGTT,5,514391
araBp,28.666666666666668,87,2,CAAGCCATTACAGTCTTAAG,85,516419
araBp,9.0,28,2,CAAGACAATCAGATGATTGC,26,506632
araBp,5.333333333333333,17,2,CAACCGTCCCCTGGAGGAAC,15,485319
araBp,7.0,22,2,ATTTGACCCGGCAGATAGCG,20,474881
araBp,5.0,16,2,ATTTCCCATGCGCCAGTGCA,14,513015
araBp,17.666666666666668,54,2,ATTGTAACTTTCAACATAAG,52,503612
araBp,10.0,31,2,ATTGGTTAAGATGAACAAAG,29,479372
araBp,9.666666666666666,30,2,ATTCCTCCCGTTATACTCGG,28,512020
araBp,6.0,19,2,ATTCCATAGGATCGAGCACG,17,513696
araBp,9.0,28,2,ATGGCTACTCCAAGTCACCC,26,491857
araBp,4.0,13,2,ATGCTGGGCTCGGCTCACAA,11,478063
araBp,11.0,34,2,ATCATGAGCATGCGTGAACA,32,518537
araBp,4.666666666666667,15,2,ATATGCAGGGGTTCAGACAC,13,522441
araBp,8.0,25,2,ATAGTGTCACGGAACCAGCC,23,485764
araBp,0.6666666666666666,3,2,ATAGGATTGTCCATGCGATT,1,470794
araBp,5.666666666666667,18,2,ATACGAAATGTTCCTTCGCG,16,495489
araBp,8.333333333333334,26,2,AGTTCCTGATCGCTTCAAGG,24,514675
araBp,2.3333333333333335,8,2,AGTGAGAATGAGTGCGCGAG,6,487940
araBp,18.0,55,2,AGTGACAGCATAGTGTTCTC,53,493997
araBp,7.0,22,2,AGTCGCTAACTACTAGCATG,20,511539
araBp,9.0,28,2,AGTCGAACTTTGGCATGGAG,26,506358
araBp,0.6666666666666666,3,2,AGTAGCCGCCGGCCATGAGA,1,479615
araBp,11.333333333333334,35,2,AGGATTGCAGCAGATATTAC,33,472029
araBp,6.333333333333333,20,2,AGGAGCCAGATAGTTTTTGC,18,489322
araBp,6.333333333333333,20,2,AGCTTTGCAGCGGATGGACA,18,473137
araBp,4.666666666666667,15,2,AGCATCTCCACTATGGTATA,13,475664
araBp,17.333333333333332,53,2,AGACTCAGGCCGGGGTAAAA,51,487870
araBp,25.0,76,2,AGACGGTAGGCCCGAGGGAC,74,482028
araBp,4.0,13,2,AGAATACGATCCACCGATAA,11,469177
araBp,6.666666666666667,21,2,ACGTGGATCCTATATACATG,19,497709
araBp,15.0,46,2,ACGGTCGCTGCGGATCTCTT,44,487415
araBp,8.333333333333334,26,2,ACGAATATCCCCAGGCTAGT,24,476513
araBp,11.0,34,2,ACAGACCGCTCAGCTAGCTT,32,500775
araBp,6.666666666666667,21,2,ACAAGCAATAGGCGTCCTTT,19,488656
araBp,9.0,28,2,AATTCGAGAAGCCCTTACTG,26,522830
araBp,9.333333333333334,29,2,AATTATGGGACTGGCGAAGT,27,513632
araBp,5.0,16,2,AAGTAAAATCGCCGCGTGCA,14,525058
araBp,11.0,34,2,AAGCGAGCCATTTATGGCAT,32,512929
araBp,1.0,4,2,AACGTGGGACCCGGTCGAAA,2,500706
araBp,5.333333333333333,17,2,AACCTCGGGGTGGCACGGAT,15,499592
araBp,9.0,28,2,AACCCTCCGTACATCTTGCT,26,503274
araBp,21.5,43,1,TTTCGGTGCTGGCTCAAAGA,42,509821
araBp,11.0,22,1,TTGTCTGCGGTCGGAATATT,21,524570
araBp,11.0,22,1,TTGTCGTACCTTTCGGGGAG,21,492993
araBp,8.5,17,1,TTCTTGGTTCTCCCCGTGGT,16,521036
araBp,6.0,12,1,TTCCGAACCTCTACAAGCAG,11,479771
araBp,7.0,14,1,TTATGACAGTGCACACGTTG,13,517871
araBp,9.0,18,1,TGTAGCGTTTTGTTAGCTAG,17,504377
araBp,1.0,2,1,TGGTCCTTAGGTATAGGGGG,1,506469
araBp,9.5,19,1,TGGGTAACATATAGTGAAGC,18,474405
araBp,12.5,25,1,TGGGATTGACCAGAAACCCT,24,489668
araBp,1.0,2,1,TGGCATACTGTTTATGGACT,1,468452
araBp,41.0,82,1,TGCGTAGCCTGTACACCAGC,81,480656
araBp,18.5,37,1,TGACGTCGATTATGGTTGAG,36,504648
araBp,12.5,25,1,TCTTCATCCTCCCCGCTTTT,24,478653
araBp,12.0,24,1,TCTTAAATGAGGCTTTAGGT,23,469180
araBp,9.0,18,1,TCTGTCGGGATTTACCTTAG,17,498941
araBp,19.0,38,1,TCGTTAATCCCGACGGGCTA,37,517474
araBp,23.5,47,1,TCGGCAGTCGCCCAACCATA,46,481584
araBp,1.0,2,1,TCGGACTGCGGTAGATTCCA,1,504379
araBp,1.0,2,1,TCGCGTACCGAACTCTCTGT,1,482758
araBp,9.0,18,1,TCGAATCGAATGCTTTTTAG,17,509356
araBp,12.5,25,1,TCCGTTCGTAGCCACGTAAT,24,496278
araBp,11.0,22,1,TCACAGTCAACTCCCTCGAG,21,515910
araBp,5.0,10,1,TATTAATCGAGCAGCTCCCT,9,509677
araBp,1.0,2,1,TATCCATCAGCCCTCTATCT,1,471326
araBp,13.0,26,1,TAGGCATGTTCTGTCCTGGC,25,500952
araBp,1.5,3,1,TAGCTATGCACAGAGCAAGG,2,525224
araBp,8.0,16,1,TAGCCGACTCCAGTGGGAGG,15,493766
araBp,11.0,22,1,TAGAATTAAGAACGTCAGGC,21,504008
araBp,12.5,25,1,TACCTTTGACAATCTTGATA,24,483066
araBp,11.5,23,1,TAAAAAGCGGGGACTTACAG,22,482210
araBp,8.5,17,1,GTTTTCTGTTCCTCGACGGT,16,481702
araBp,1.0,2,1,GTGGATTACGCACGTGGGGG,1,507992
araBp,6.5,13,1,GTCTGGAAACTTAGAGAACC,12,479366
araBp,26.0,52,1,GTCTCTCCGGTTATGTACGC,51,477469
araBp,16.0,32,1,GTCCGGGGCCGACGGAATAC,31,515854
araBp,6.0,12,1,GTATTTGCGCAAAGCACATG,11,472787
araBp,21.5,43,1,GTATAATCAGTGCGCTGTAA,42,523856
araBp,8.0,16,1,GTAGCGCACTCAACCGTGAT,15,497463
araBp,8.5,17,1,GTAAGTGATACAGAGGTCTG,16,479818
araBp,8.0,16,1,GTAACAACAATTGTCCACTG,15,497067
araBp,13.0,26,1,GGTTAGCGTTTGCCCGTTTC,25,517781
araBp,2.0,4,1,GGTGGTCTTTCATCTCTAGG,3,507701
araBp,27.5,55,1,GGTAGTAAACAGAAACAGCA,54,522089
araBp,10.0,20,1,GGTAAGTAGAGGAATTGATT,19,509820
araBp,8.0,16,1,GGGTCGTCTGCACTGAGGAT,15,496803
araBp,7.0,14,1,GGGGCCTGACTACTAAGGGT,13,475984
araBp,13.5,27,1,GGGCTGAGATGGTTCAGGTG,26,503878
araBp,10.0,20,1,GGGCAGCACCACGTGGACTG,19,486608
araBp,13.5,27,1,GGGACCGGTGCCCAATTTAG,26,500551
araBp,10.5,21,1,GGGACACCTGATAAAGAATT,20,487186
araBp,9.0,18,1,GGCCCACATCCTGGGAGCTC,17,480945
araBp,12.5,25,1,GGCAAAGCTACTCAGTTAGT,24,508890
araBp,21.5,43,1,GGATTCACTGAGGACCGTTA,42,480234
araBp,11.5,23,1,GGAGTTAATTACATTTTCAA,22,512444
araBp,9.5,19,1,GGAATCCATACCTACCGCTA,18,496119
araBp,6.5,13,1,GGAACTGAATTACCGATAGC,12,517129
araBp,11.0,22,1,GCTTGTATTGTGGACAAGCT,21,510564
araBp,11.0,22,1,GCTTGCTACCAAGCTAGCTA,21,521921
araBp,1.0,2,1,GCTGACTTAGTATAAGGGGG,1,478080
araBp,13.0,26,1,GCGGAGCAAGGCAGTTGAAA,25,501327
araBp,8.0,16,1,GCCTTATGGCTGGTAGATGA,15,512984
araBp,2.0,4,1,GCCTACACTGGCTTCCCCTT,3,473146
araBp,4.5,9,1,GCCCCAGCGACTGGGTATCA,8,472485
araBp,22.5,45,1,GCCAGGTTGGGTTAAAGTAG,44,478190
araBp,11.5,23,1,GATTGCCCATAGTAGCAAAA,22,494563
araBp,14.5,29,1,GATGTGTCCACGGAAGCTTG,28,501419
araBp,15.5,31,1,GATCCCTCTTACAACGAGAG,30,475939
araBp,11.5,23,1,GATCAGCGGGAACATTTCGG,22,509117
araBp,16.0,32,1,GATCAACTTACGTTTATTTA,31,473961
araBp,6.5,13,1,GATATTTCTGTGGGTCAGAA,12,512425
araBp,9.0,18,1,GACTAGGTTGTTCACCAGGT,17,510992
araBp,9.0,18,1,GACGCGGTTACGTAGCCCAC,17,471994
araBp,25.0,50,1,GACATCCGTTAAGAGGAATT,49,480926
araBp,7.5,15,1,GACAATTCACCTCCTTCAAC,14,511896
araBp,18.5,37,1,GAACACTTAACCTCCGATTT,36,508841
araBp,6.0,12,1,CTTTTGTGATGATTCTGGAG,11,516475
araBp,11.0,22,1,CTTTGGACAACATAAGGCTG,21,521329
araBp,15.0,30,1,CTTGCTAGAAGGGTCATGTC,29,477232
araBp,15.5,31,1,CTTGAATCCCTCTGATCCTA,30,483448
araBp,10.0,20,1,CTTCCCGACGATCTACGTTA,19,469943
araBp,9.5,19,1,CTTACAAGATCATTTGTGAA,18,473952
araBp,9.0,18,1,CTGCATGTAGGCGCTTAGGA,17,509945
araBp,13.0,26,1,CTGCATCTAGAGCATGAGCA,25,511140
araBp,1.0,2,1,CTGAGGTAACTCTACGCTCA,1,471156
araBp,12.5,25,1,CTCATGCGTGTCTTGACCGT,24,522450
araBp,6.0,12,1,CTCACTAACGTTACGTGGCG,11,497918
araBp,15.0,30,1,CTCAAGACCATGCTTGAAGC,29,512706
araBp,17.0,34,1,CTATGAGGAGGGCTGGCCGA,33,482102
araBp,8.5,17,1,CTATACCATAGGTCGGACCA,16,525142
araBp,2.5,5,1,CTAACTTGCTTATTCACCCT,4,495889
araBp,8.0,16,1,CGTGTACACAACCATGGACC,15,470190
araBp,14.5,29,1,CGGACTGGTCAGTGGATTCA,28,503538
araBp,7.0,14,1,CGGACGGACCGTTTTCTGGC,13,499804
araBp,19.0,38,1,CGCAGCAAAGAATATGTACG,37,475526
araBp,1.0,2,1,CGCAACGATTGGGTACGGTC,1,496248
araBp,1.0,2,1,CGAGACCGTGAAGACAGTGC,1,518467
araBp,11.5,23,1,CGACCACACGGTATGTATGA,22,472247
araBp,14.0,28,1,CGAAGAACTCTGTCATGAAG,27,472958
araBp,1.0,2,1,CCTGGGAATTAGCAACGTCG,1,501142
araBp,15.0,30,1,CCTAAGCTGAAGTGTGCACA,29,501368
araBp,9.0,18,1,CCGTTTGACTGTGGGGTTTC,17,473484
araBp,21.0,42,1,CCGTTGGGGATTAGGACTTA,41,501662
araBp,15.0,30,1,CCGTTCTTAGGCGTAACGAG,29,519961
araBp,28.0,56,1,CCGTTCGCCTGTACACGAAC,55,500991
araBp,1.0,2,1,CCGGCTAAGACTCTTTCACC,1,493938
araBp,11.5,23,1,CCGCTCGTGCGCGTCCTAGG,22,494970
araBp,1.5,3,1,CCGCACTATGCTTGGCGAGT,2,471255
araBp,10.0,20,1,CCGAGCATTTGTTCGCACGT,19,510206
araBp,12.5,25,1,CCCGCGGAACTTAGTGCCGT,24,468127
araBp,15.5,31,1,CCCGAAAGCGGTGAAGCACA,30,502764
araBp,13.5,27,1,CCATGCGCACGTCGTTGGCA,26,523434
araBp,9.0,18,1,CCATATACCTAGCCCCAAGG,17,518956
araBp,8.5,17,1,CATATTAGGAATCCTGTCCT,16,468083
araBp,13.0,26,1,CAGGTCACGCCCCTTATTAA,25,523987
araBp,17.5,35,1,CAGCTTTCGGGGTTGTCGAT,34,497341
araBp,8.0,16,1,CAGAGACAATGCTTTTGCCG,15,474563
araBp,11.0,22,1,CACCCGCCGGTAGCTCTGTT,21,505213
araBp,10.0,20,1,CACATATAAGGCGAATTTTT,19,517749
araBp,6.0,12,1,CAACGATTGCTATAATGTGT,11,481564
araBp,13.0,26,1,CAACGACGAGTAAGACGCTT,25,484852
araBp,10.5,21,1,CAACCTGTGTCGGGTCACCC,20,517011
araBp,2.0,4,1,CAAACGGGGCGAAACATTGA,3,510774
araBp,17.5,35,1,ATTTCTGGCGCAATCGGATT,34,501365
araBp,1.0,2,1,ATTAGAGGAGCCAGGTGGGT,1,480967
araBp,11.0,22,1,ATGTTATGATTATCGCTGTA,21,508313
araBp,8.0,16,1,ATGGTCAATTTGTCGGACAA,15,503808
araBp,8.0,16,1,ATCCTTGTGTCTTGCCCAAA,15,495239
araBp,14.0,28,1,ATCCCTGGTTAGTATCTCCC,27,506842
araBp,39.0,78,1,ATCCCAATGAACGATTAACA,77,492594
araBp,6.5,13,1,ATCCACAACGGGGCCCACCA,12,483058
araBp,1.0,2,1,ATACAACTGTGGCACTAACG,1,518173
araBp,9.5,19,1,AGTGGTAGCAGTGAGACAGC,18,514674
araBp,8.5,17,1,AGGGTTTACTGAGGGGAGAG,16,473660
araBp,13.0,26,1,AGGGATAGCTGATGCATACC,25,475828
araBp,5.0,10,1,AGCAGACCTTGAGGAATGTA,9,476488
araBp,8.0,16,1,AGCACTACCAGCTGCCTCCC,15,492898
araBp,7.0,14,1,AGATTTTAAGCTTTATCTGG,13,472835
araBp,11.5,23,1,AGATCTGAGCGCCCCGCGTT,22,495743
araBp,8.0,16,1,AGAGTAGCCGTATGAGCCAC,15,508718
araBp,13.0,26,1,AGAGAAGGGTACTTCTTATA,25,521532
araBp,11.5,23,1,ACTCGATCCGAGCCTTCATT,22,498044
araBp,15.5,31,1,ACTCGAGTGATATAACGTTG,30,524056
araBp,11.5,23,1,ACTATTCTGATGGCTCACAG,22,481651
araBp,26.0,52,1,ACGTTAAAGTTTTCCACGCT,51,497077
araBp,8.0,16,1,ACGTCTGGCTCATCATGCGC,15,477897
araBp,12.0,24,1,ACGTAGTTCCCACATTACAT,23,503865
araBp,12.0,24,1,ACCTTAACTCGTCTGGATAC,23,483740
araBp,12.5,25,1,ACCCAGTCCCTCAGAACGTA,24,486711
araBp,1.0,2,1,ACCACTCCTCGCGTAAACCC,1,469409
araBp,32.0,64,1,ACATGCTGTTAGAAATGAGC,63,471973
araBp,12.5,25,1,ACATCAACTATTTATCTATC,24,518978
araBp,1.0,2,1,AATTTTACACCGTTCTCATG,1,487678
araBp,1.0,2,1,AATTGGCCATTCATCACGAC,1,478030
araBp,22.5,45,1,AATGTATCTGAGCTCAATTC,44,500944
araBp,11.5,23,1,AATATCTCGTTAAATATGCA,22,490935
araBp,11.0,22,1,AATAGTACTTGGAGCCTGTT,21,517850
araBp,7.5,15,1,AAGTTACGATCTATTCGGGT,14,479598
araBp,10.5,21,1,AAGGATGATCTTTTATAAGC,20,492319
araBp,16.0,32,1,AACTTGGATTTTGGGCACGT,31,471196
araBp,14.5,29,1,AACATGTCGGCGGACTTCCG,28,478660
araBp,1.0,2,1,AAACGGGTGTTAACCTTACT,1,503426
araBp,8.5,17,1,AAACGCTTAGCGGCAGTGAC,16,518747
araBp,0.00909090909090909,109,109,TAATTAAACGGAATTCTGTG,0,481534
araBp,0.01098901098901099,90,90,AAGTGTTCAGTCGCAATGCC,0,468330
araBp,0.014084507042253521,70,70,TATAGGGACCCTCGAGTGAC,0,487449
araBp,0.015384615384615385,64,64,CCAGTTGCCTGTAAGTGCAT,0,488195
araBp,0.015625,63,63,TGAGCCACTGGCACGACCAG,0,499627
araBp,0.017241379310344827,57,57,GTAGCCAGTTCGTCGAATGC,0,468123
araBp,0.017241379310344827,57,57,AGGATTTGGTATACGGGTGT,0,474499
araBp,0.017543859649122806,56,56,TCATTTCGCGGATAATTGTA,0,507901
araBp,0.017543859649122806,56,56,AGGGCTTTTCCATCTTGGGT,0,494192
araBp,0.017543859649122806,56,56,AAATGTAATCCATCTCCACA,0,491010
araBp,0.018518518518518517,53,53,AGATTTGTCATACTAGACAG,0,482532
araBp,0.018867924528301886,52,52,AAGTACTCGATATGCCACCA,0,471051
araBp,0.019230769230769232,51,51,TGTAGGGGAGACAGCTACGG,0,472596
araBp,0.019230769230769232,51,51,GGCCGGCAGTGTCGTAGGAA,0,478053
araBp,0.019230769230769232,51,51,CGTGGTCCGACGATAAACGT,0,511181
araBp,0.0196078431372549,50,50,GGACAACAACTTAAATTCGA,0,522907
araBp,0.02040816326530612,48,48,GCGACAATGACAGGACTAAT,0,489031
araBp,0.020833333333333332,47,47,TCTTACACCAGGGCATTGAT,0,475008
araBp,0.020833333333333332,47,47,GGCACTACAGGCAGTTATTG,0,485657
araBp,0.020833333333333332,47,47,AAAACGGGGGTGTAGCGTAG,0,509005
araBp,0.02127659574468085,46,46,GCCTGGGACTGTAGGTGACT,0,499018
araBp,0.02127659574468085,46,46,CGCTCATTTCGCGACGCGAT,0,469707
araBp,0.02127659574468085,46,46,CAATAGAGCAGGAACGCCCA,0,505570
araBp,0.021739130434782608,45,45,GTACGGACTGTCTAAATTAC,0,478280
araBp,0.021739130434782608,45,45,AACGTGGCTGTTGGGAAAGT,0,473704
araBp,0.022222222222222223,44,44,TATAGGACAAATTGACGCAT,0,471351
araBp,0.022222222222222223,44,44,GCGCTTCAGACTTACAATGA,0,475974
araBp,0.022222222222222223,44,44,CTCGCTATTTACAGGGCGAA,0,475845
araBp,0.022222222222222223,44,44,CCGTTAAAGACACCAATATT,0,507094
araBp,0.022222222222222223,44,44,ACGCAACTTCTCCCGGCTGA,0,468371
araBp,0.022727272727272728,43,43,TCAAGAAATGATAAGTCGGA,0,492495
araBp,0.022727272727272728,43,43,GTTTTCGGTGCGGGTGCGCT,0,485122
araBp,0.022727272727272728,43,43,GTGCCTAAGCGGTAATCGCT,0,500958
araBp,0.022727272727272728,43,43,GGCTGTTAGTTTACGTACGT,0,517310
araBp,0.022727272727272728,43,43,CGGCGAACAATCTTCTCCGT,0,468488
araBp,0.023255813953488372,42,42,CGGCCGACAAGCGAGGATAA,0,471372
araBp,0.023255813953488372,42,42,CGCGGCTCATGCAGTAATTG,0,490836
araBp,0.023255813953488372,42,42,CAGTTAGTTAAGTGGTCGTC,0,510515
araBp,0.023809523809523808,41,41,TGCAGGAAAGGGGCGCCCCA,0,488250
araBp,0.023809523809523808,41,41,CTGTGCATTCAGCCGGCCCT,0,503753
araBp,0.023809523809523808,41,41,CTGGTTGACGCAACTGAATA,0,470605
araBp,0.023809523809523808,41,41,CGGCCGCTTACTTGAGGGTG,0,494403
araBp,0.023809523809523808,41,41,CGGAATTTAGGCAGACTAAG,0,486313
araBp,0.024390243902439025,40,40,TCGCACTCCGCATAGATGTG,0,500221
araBp,0.024390243902439025,40,40,GTACTATGAAGACAAAATGT,0,488985
araBp,0.024390243902439025,40,40,CTAGTACTTCGGCGTATCAA,0,478225
araBp,0.024390243902439025,40,40,CATGGCGATTAGGGAAGTTT,0,501163
araBp,0.025,39,39,GGCCTTGCATCAGGGTGCTT,0,519565
araBp,0.025,39,39,GGCCCCGGCGGCGGCTAAGG,0,515086
araBp,0.025,39,39,CTAGGCATCCACTTCGGGAT,0,469918
araBp,0.025,39,39,CGAAGGACCTGGGATAATGA,0,499190
araBp,0.025,39,39,CCGGGCAGCGTATTGAGCAA,0,474623
araBp,0.025,39,39,CAGGCCGGGAGATGAGGGAG,0,492816
araBp,0.025,39,39,CAACTTTTCTGCGCACCGGT,0,490128
araBp,0.025,39,39,ACAACTCCACAACCCGATAC,0,482795
araBp,0.025,39,39,AACGTATTAGGTATCCCCCA,0,476896
araBp,0.02564102564102564,38,38,TTTTAGTGGGGGACGGATCT,0,523435
araBp,0.02564102564102564,38,38,TATGGGATCTGGTTGTAGAG,0,475313
araBp,0.02564102564102564,38,38,TACAGCAAGTATGACAGAAG,0,475622
araBp,0.02564102564102564,38,38,GTATTGGGCGTCATGCAGGG,0,473468
araBp,0.02564102564102564,38,38,GCATTTCCCGTATAGGTGAA,0,514331
araBp,0.02564102564102564,38,38,CAAAGACGCTCCCGTGTTGC,0,494129
araBp,0.02564102564102564,38,38,ATTATATATTCGTCGGCTCC,0,493991
araBp,0.02631578947368421,37,37,TTCAAACGGTATCAGAGGGT,0,485771
araBp,0.02631578947368421,37,37,TCCCAAAAGGCTAGCGGCTG,0,487366
araBp,0.02631578947368421,37,37,CTACTTCGGACACGGTCGCA,0,470005
araBp,0.02631578947368421,37,37,CTACGGTGCTAATACAAGTA,0,471086
araBp,0.02631578947368421,37,37,CCTTCCTGCAACCTCGGATG,0,475886
araBp,0.02631578947368421,37,37,CACTTCGACACAACTGGTTA,0,468598
araBp,0.02631578947368421,37,37,ACAGTTAGTAGCCTTGTCTA,0,494238
araBp,0.02702702702702703,36,36,TTTAACATAAAGTCATACTA,0,515657
araBp,0.02702702702702703,36,36,TCCACAGGTGGTTGGGCACT,0,494657
araBp,0.02702702702702703,36,36,TATATTCCTTCCGGGGCTAA,0,513879
araBp,0.02702702702702703,36,36,GTTGGATTTTCAGTGTCACG,0,487496
araBp,0.02702702702702703,36,36,GGTGCATGATGTGCATAGTG,0,472008
araBp,0.02702702702702703,36,36,GACACCAGCATCATTGTATC,0,494414
araBp,0.02702702702702703,36,36,CTAACGATATTGGGCTGGCA,0,490208
araBp,0.02702702702702703,36,36,ATCTGTGAGGCAGTGTTTCC,0,498877
araBp,0.02702702702702703,36,36,ACGATACCAAATGGAAGCGT,0,519493
araBp,0.027777777777777776,35,35,TTTCTAGATGGTGCAGCAGA,0,497737
araBp,0.027777777777777776,35,35,GTGTTCGTACCATTATTAAA,0,492639
araBp,0.027777777777777776,35,35,GTCTGCCATTGGTAATTTTG,0,490962
araBp,0.027777777777777776,35,35,GTCTCGCCCTTCCCGTAAGG,0,471153
araBp,0.027777777777777776,35,35,GTCGAGCAGAGGGCCGGGGA,0,468186
araBp,0.027777777777777776,35,35,GGATCTGCGCCGAAATCAAA,0,507768
araBp,0.027777777777777776,35,35,GCTCCGTTATGGGGTTCCAC,0,474414
araBp,0.027777777777777776,35,35,CTAGTTAGCCCTCAAACGCT,0,504514
araBp,0.027777777777777776,35,35,CCCTAAACTCTAACGGAATG,0,486320
araBp,0.027777777777777776,35,35,ATAAGCCTATACAGCTCTCT,0,468914
araBp,0.02857142857142857,34,34,TTCGACGTCAAGCCGTTGGT,0,476903
araBp,0.02857142857142857,34,34,TTATTGTCCCGTCAAATCTT,0,509094
araBp,0.02857142857142857,34,34,GTATGTTTCTCGTAATAGTT,0,469562
araBp,0.02857142857142857,34,34,GTAGAAACACCTGAGCCGTT,0,499427
araBp,0.02857142857142857,34,34,CTTCGTTGCACCATCGCCAA,0,476414
araBp,0.02857142857142857,34,34,CTTAAAGATCCTTGGGAGTA,0,479649
araBp,0.02857142857142857,34,34,CGGTGGTCCACTTTTCGAGA,0,469314
araBp,0.02857142857142857,34,34,CAGTTAGCGGCAGTCGCAGA,0,473932
araBp,0.02857142857142857,34,34,ATGCATATGGACCCAATCTT,0,468126
araBp,0.02857142857142857,34,34,ATATGAGTAAGCTATTTGAT,0,515539
araBp,0.02857142857142857,34,34,AGTTCTCCCTCCACTTCAAT,0,518617
araBp,0.02857142857142857,34,34,AGGCAGCCAATTGCAAGGCA,0,506381
araBp,0.02857142857142857,34,34,ACCTTCCCTACAGTATCCCG,0,498220
araBp,0.02857142857142857,34,34,AATCCCTCTTCACGGGCTTG,0,485542
araBp,0.02857142857142857,34,34,AAAAGTCCTTAGGACTCATT,0,482735
araBp,0.029411764705882353,33,33,TTAGCCTCTAGATCGACTTG,0,487615
araBp,0.029411764705882353,33,33,TGGGCAATGGCTCGAGGTGT,0,473716
araBp,0.029411764705882353,33,33,TGATAATCGACCCGACGCTA,0,505374
araBp,0.029411764705882353,33,33,TCCTGTGGAAGGTAGCTCAA,0,493258
araBp,0.029411764705882353,33,33,TCCGTTTGCTATAGTAATAG,0,487641
araBp,0.029411764705882353,33,33,GTTCTCCTATGACCGTATAT,0,490447
araBp,0.029411764705882353,33,33,GTATAAACTTATCTCGCTTC,0,511559
araBp,0.029411764705882353,33,33,CTTCACACTTTTATTTGGGT,0,511943
araBp,0.029411764705882353,33,33,CTGGGTTCTGACCCTGGAAT,0,504382
araBp,0.029411764705882353,33,33,CCGCTTTATACAGGTATCGA,0,496011
araBp,0.029411764705882353,33,33,CATAGTTGGCCCGCTTCAAA,0,483799
araBp,0.029411764705882353,33,33,CAGGATATTGGCTGAGAAAA,0,480396
araBp,0.029411764705882353,33,33,ATATTTCAGGCGTATCAAAT,0,474364
araBp,0.029411764705882353,33,33,AGCTAAAGGTATTGTAAGAT,0,497655
araBp,0.029411764705882353,33,33,AAGCCCACCGTGGTGGTTCA,0,473625
araBp,0.029411764705882353,33,33,AAGCACATGCAGGTGATTCA,0,476145
araBp,0.030303030303030304,32,32,TGATAACTAGAGCTTCGGGT,0,496314
araBp,0.030303030303030304,32,32,GTTCTAGCATAATGAGTCAG,0,484940
araBp,0.030303030303030304,32,32,GTTCGCGTAGCTGGTAGCAG,0,473134
araBp,0.030303030303030304,32,32,GTGTATTCGCATTAATTGAT,0,519149
araBp,0.030303030303030304,32,32,GGATGCCTCTACGGGTTCCA,0,503889
araBp,0.030303030303030304,32,32,GAGCGCCCGGCCTTTTGAAG,0,475858
araBp,0.030303030303030304,32,32,CTGTTTTTGATGTGCGCTTA,0,480506
araBp,0.030303030303030304,32,32,CGTTCGTGCCGGTGCTCAGA,0,510301
araBp,0.030303030303030304,32,32,CGATTTACTAGCCCCCCCGT,0,497624
araBp,0.030303030303030304,32,32,CATCAACCAAATTTGGTATA,0,492599
araBp,0.030303030303030304,32,32,ATTCTGTTATGAATCACGAT,0,520502
araBp,0.030303030303030304,32,32,ATAGTTAGGATAGCACCTAC,0,507518
araBp,0.030303030303030304,32,32,ACCCCCGTCCCTGACAAGTT,0,472210
araBp,0.03125,31,31,TGGAGCATGCCCCCGGAAAG,0,519194
araBp,0.03125,31,31,TGATGAAGAAACCACTGCAG,0,489241
araBp,0.03125,31,31,TCTTAGCAACTAGATCCTTG,0,502392
araBp,0.03125,31,31,TAATTCGGGCGTTGCGTACG,0,472361
araBp,0.03125,31,31,GTCTGTTACACTGCGCGAAT,0,505555
araBp,0.03125,31,31,GGATTATGGGAGTCCTGATT,0,509567
araBp,0.03125,31,31,GGATGTTTTTAATTAGCTCT,0,494568
araBp,0.03125,31,31,GGAATCCTGTGAGCCGCGGA,0,475708
araBp,0.03125,31,31,GCATACATACACGCAGGCAA,0,470493
araBp,0.03125,31,31,GACACAGGATCTCTTTCCCG,0,480714
araBp,0.03125,31,31,CTGCACGATTTAAAGGACAT,0,507201
araBp,0.03125,31,31,CTCTTTACGGGACCTAGAAA,0,503313
araBp,0.03125,31,31,CGTATCTACGACAGTCCGGA,0,476470
araBp,0.03125,31,31,ATGGGATATTTTTCGCCCAA,0,513118
araBp,0.03125,31,31,ATGCGTGGGGAATCCTTGTA,0,494503
araBp,0.03125,31,31,AGTCTCAAAACTGGCTCCCG,0,475225
araBp,0.03125,31,31,ACCGCGTTTCAATCCAAGGA,0,470817
araBp,0.03225806451612903,30,30,TACGTTTGAAGCTCAGGAAC,0,470487
araBp,0.03225806451612903,30,30,GTTCGGGAGCTAGTGCCGGT,0,516142
araBp,0.03225806451612903,30,30,GTGTGCCGAAAACTTAATTC,0,501677
araBp,0.03225806451612903,30,30,GGATGGGCGGTTTCGATGTT,0,492919
araBp,0.03225806451612903,30,30,GGAAATAGCGGTGAACGTTG,0,519389
araBp,0.03225806451612903,30,30,GCTGACTCCCACCGAGCCAT,0,506211
araBp,0.03225806451612903,30,30,GAGCTCTCGGGGACCAATCA,0,503245
araBp,0.03225806451612903,30,30,CTAATGTACGGGGGAGCGGT,0,512903
araBp,0.03225806451612903,30,30,CCTCCCGTGAAAAGCGGCTC,0,515093
araBp,0.03225806451612903,30,30,CCCCGCCCAATTTCTCAATT,0,494578
araBp,0.03225806451612903,30,30,CCCACTTCCGAATAGGCTTA,0,470379
araBp,0.03225806451612903,30,30,CATAATGAATTGCCGTGTAA,0,494086
araBp,0.03225806451612903,30,30,CAGGTAGTTAGCCCGCTGTA,0,518392
araBp,0.03225806451612903,30,30,CAACCCTAATTTCTCGACTG,0,485792
araBp,0.03225806451612903,30,30,AGGGTAAAATGTGCCCATGT,0,469821
araBp,0.03225806451612903,30,30,ACATAGGGGGGCATTTAATG,0,505851
araBp,0.03333333333333333,29,29,TTTCTGATGTGTCATGGGAC,0,479740
araBp,0.03333333333333333,29,29,TGCATACGCGGACATTTTTC,0,474415
araBp,0.03333333333333333,29,29,TCGATCCCGGCTATTTAATG,0,524095
araBp,0.03333333333333333,29,29,TCAAGACCCCATTCTAAGGG,0,479427
araBp,0.03333333333333333,29,29,GTTTTGACAGTGTCATTAGA,0,480956
araBp,0.03333333333333333,29,29,GTGTCTTAAGAGGCGTGCGT,0,524622
araBp,0.03333333333333333,29,29,GTGGATGGAGCATTGGCCAG,0,477816
araBp,0.03333333333333333,29,29,GTATCCAAATAGGGCTCGAT,0,518124
araBp,0.03333333333333333,29,29,GGTTTTCGTATTTAGTGAAT,0,477827
araBp,0.03333333333333333,29,29,GCCTATATGATAAATATCTT,0,518200
araBp,0.03333333333333333,29,29,CTTCACAGATCTGCCAATGC,0,478062
araBp,0.03333333333333333,29,29,CGTTCCTCTCGGCCGGTCAA,0,496194
araBp,0.03333333333333333,29,29,CGTGAATGAGCTTCTTCCAC,0,489814
araBp,0.03333333333333333,29,29,CGGTGCGCGTGTGGCGTCTG,0,489531
araBp,0.03333333333333333,29,29,CGCCGGTCCGCAGTTCATGG,0,473664
araBp,0.03333333333333333,29,29,CCTGCGCCAGCGTCGTGGCG,0,507816
araBp,0.03333333333333333,29,29,CATGAGCACTCGTGTGAACT,0,493504
araBp,0.03333333333333333,29,29,ATTATAGTCAGACACCGGAG,0,491089
araBp,0.03333333333333333,29,29,ATTAGGTCACTGGATATTTC,0,494228
araBp,0.03333333333333333,29,29,ATCTGCCCAACAGCCTTCAT,0,488612
araBp,0.03333333333333333,29,29,ACAGTGATGTAGTGCACGGG,0,483411
araBp,0.03333333333333333,29,29,AATTCAATTGACAAACGTGT,0,476987
araBp,0.03333333333333333,29,29,AACTGGTTCGAACGTAGGGG,0,514809
araBp,0.034482758620689655,28,28,TTGTGGATCACCGCATTAGT,0,485192
araBp,0.034482758620689655,28,28,TTGAGAGTAAGGTATTCTAT,0,498847
araBp,0.034482758620689655,28,28,TGGCCCGGGGAATCCCAGTA,0,511639
araBp,0.034482758620689655,28,28,TCGGTATTTCGGCAGACAAG,0,495568
araBp,0.034482758620689655,28,28,TATTACCTGTCTCTGAGGAA,0,475302
araBp,0.034482758620689655,28,28,GGTGATGCTCCTAGCGTGAC,0,499208
araBp,0.034482758620689655,28,28,GCATCCCCGGGTTTAAAATC,0,509148
araBp,0.034482758620689655,28,28,GCACTAATGCGCAGGTCTCC,0,475077
araBp,0.034482758620689655,28,28,GATGCGTTCCTGTAGTAAAG,0,494756
araBp,0.034482758620689655,28,28,GACATTGGATTACCGCGAAC,0,486904
araBp,0.034482758620689655,28,28,GAAAATGGAAGGATCATCCA,0,519246
araBp,0.034482758620689655,28,28,CGTTGGCCCCTTTCCTCCTA,0,506088
araBp,0.034482758620689655,28,28,CGACGCCAACAGCAGTTTAT,0,490015
araBp,0.034482758620689655,28,28,CCGGTAGAGGTGGCATCTGA,0,510506
araBp,0.034482758620689655,28,28,CATGTAGATGTAGAGAGTAA,0,485018
araBp,0.034482758620689655,28,28,CACAATGGGGTCGGGCTCCC,0,520239
araBp,0.034482758620689655,28,28,ATTCTAGCGCGCAGCGTCAG,0,503829
araBp,0.034482758620689655,28,28,ATGAACAAGAACTTGTAGCC,0,483003
araBp,0.034482758620689655,28,28,ATAAAGCGGTACTGGGGATA,0,469096
araBp,0.034482758620689655,28,28,AGGCCAGTAACAGTTGGCAA,0,502489
araBp,0.034482758620689655,28,28,AGCCGACTATGGCGGTAATT,0,474242
araBp,0.034482758620689655,28,28,ACGTGCTATGACAATTGGTG,0,523992
araBp,0.03571428571428571,27,27,TGTGAGTCTCTCTTACCGTG,0,469050
araBp,0.03571428571428571,27,27,TGCTGCCGAGATGCCATTCT,0,490304
araBp,0.03571428571428571,27,27,TCGTTTGGCAAGTTCTTGAG,0,476993
araBp,0.03571428571428571,27,27,TCAGGCTCAGTGAGAAGATA,0,495762
araBp,0.03571428571428571,27,27,TATTAAGGCGATTTTTGAAA,0,518092
araBp,0.03571428571428571,27,27,TAGACGAGGAGCATTCTTAC,0,516065
araBp,0.03571428571428571,27,27,TAAAGTTACAATAGATTTGA,0,496594
araBp,0.03571428571428571,27,27,GGAGGCTAGCCCCACACACG,0,483072
araBp,0.03571428571428571,27,27,GACTCGTGGTATAATGGATT,0,505349
araBp,0.03571428571428571,27,27,GAATGCACCTAACTAGACCA,0,471373
araBp,0.03571428571428571,27,27,CTTCTAGTCGTCTCCATTGT,0,469483
araBp,0.03571428571428571,27,27,CTTCGGATTCCGTCCTCTTC,0,505094
araBp,0.03571428571428571,27,27,CTGCCAGACCTTGGCATATA,0,470614
araBp,0.03571428571428571,27,27,CTATGAGCTGCACTATTTGA,0,524034
araBp,0.03571428571428571,27,27,CTAGCATAAGACTGGCCAGA,0,488265
araBp,0.03571428571428571,27,27,CCCAGCATATACAGGGAAGA,0,483080
araBp,0.03571428571428571,27,27,ATTGACAGCCCCGGCTGTGG,0,491576
araBp,0.03571428571428571,27,27,AGGGCCTTCTTCTGTAGCTA,0,517912
araBp,0.03571428571428571,27,27,AGCGCAGCACAGTTTTCGTG,0,489320
araBp,0.03571428571428571,27,27,AGCCGAAGTGACACCCTGAT,0,469052
araBp,0.03571428571428571,27,27,ACGATCGAAGGGAGTAGTGC,0,481864
araBp,0.03571428571428571,27,27,AATTTTGAGTATCCTTGCAT,0,509112
araBp,0.03571428571428571,27,27,AAACGTCCGCAGCCTGCCCA,0,474378
araBp,0.037037037037037035,26,26,TTGGCTAGATCTTGGTTACC,0,470904
araBp,0.037037037037037035,26,26,TGTGATCGTATGTTGTGAGC,0,506636
araBp,0.037037037037037035,26,26,TGGATTAGCACGCCGAGGGG,0,475735
araBp,0.037037037037037035,26,26,TCCCATAGGCGGCGACACAC,0,502396
araBp,0.037037037037037035,26,26,TCACAGCCGTAGTTGCAGGA,0,477459
araBp,0.037037037037037035,26,26,TATCGCCCCACTCAAACAAG,0,507885
araBp,0.037037037037037035,26,26,TATATCGCCTTACCCTGTCC,0,468016
araBp,0.037037037037037035,26,26,TAAGATCACTCGTCCCGGAA,0,510763
araBp,0.037037037037037035,26,26,GTGGGGAGATTCCGTAAACG,0,470781
araBp,0.037037037037037035,26,26,GTATTGGTTGCACACTCATA,0,494413
araBp,0.037037037037037035,26,26,GTAACAAGGGAACGGAGACT,0,478515
araBp,0.037037037037037035,26,26,GGGCCTGTTCTTCTTCATAA,0,494405
araBp,0.037037037037037035,26,26,GGCTAGGTTTTAGCTGTAGG,0,518645
araBp,0.037037037037037035,26,26,GGCGAGCGCCTTAGCGGCCC,0,468737
araBp,0.037037037037037035,26,26,GGCCGTGCAACCCCGATCTC,0,494847
araBp,0.037037037037037035,26,26,GGAGGGTACGTCAATGCAAG,0,514891
araBp,0.037037037037037035,26,26,GCATACTACCGACAAGCGTC,0,473467
araBp,0.037037037037037035,26,26,GAAGGGAAAGCTACTAAGAA,0,472907
araBp,0.037037037037037035,26,26,CTATGCGCTAGGACGCGTAT,0,476839
araBp,0.037037037037037035,26,26,CTAGATTAGCGCCGGTTGAT,0,508864
araBp,0.037037037037037035,26,26,CGTTATTGGAAGAACACGGT,0,492405
araBp,0.037037037037037035,26,26,CGGATGCGCCAGGATTGGTA,0,496024
araBp,0.037037037037037035,26,26,CGATCGTTGTTCGCCAATTA,0,476895
araBp,0.037037037037037035,26,26,CCCCACCGCGCGACTTGGCG,0,519293
araBp,0.037037037037037035,26,26,ATTTCTGTGATCGCAAATCA,0,494895
araBp,0.037037037037037035,26,26,ATTTCATGGCTAATACCTTC,0,525090
araBp,0.037037037037037035,26,26,ATTCATTAATGACGCGCCGT,0,503202
araBp,0.037037037037037035,26,26,ATTACGTATCGGTTGTCGAA,0,480584
araBp,0.037037037037037035,26,26,ATGAGCGTCTATCTAAGAAT,0,499429
araBp,0.037037037037037035,26,26,ATGACGGACCTGATGCGATC,0,505897
araBp,0.037037037037037035,26,26,AGTACAAGGGACGGTGCGGG,0,510259
araBp,0.037037037037037035,26,26,AGGATGACGGGGTATCACGG,0,497024
araBp,0.037037037037037035,26,26,AGGAAGGTAGGTCCCTAGGT,0,478526
araBp,0.037037037037037035,26,26,AAGTGGGTGCAGGTCTTGCT,0,478792
araBp,0.037037037037037035,26,26,AAGGAATATTACCTCGGAAG,0,512718
araBp,0.037037037037037035,26,26,AAGAACACCGAGAGTAGTGT,0,524376
araBp,0.037037037037037035,26,26,AAAGGGTCCGACAGTAACTT,0,504939
araBp,0.038461538461538464,25,25,TTTCAGTGCAATCTCGTTCC,0,513557
araBp,0.038461538461538464,25,25,TTTACAACGTTCACCGGAGC,0,487979
araBp,0.038461538461538464,25,25,TTCAAGCCACCCGCTATTAT,0,470186
araBp,0.038461538461538464,25,25,TTAGATCAGCTTTTCCCAAT,0,524696
araBp,0.038461538461538464,25,25,TTAAATATGGATTAGTTACT,0,490013
araBp,0.038461538461538464,25,25,TGTGTCATACAGTTACACGA,0,470308
araBp,0.038461538461538464,25,25,TGCCGGTATGTAGCGTGAAC,0,495025
araBp,0.038461538461538464,25,25,TCTTCACACTCTCCATCGGA,0,503844
araBp,0.038461538461538464,25,25,TCTACACACACCTTTGCGGT,0,522932
araBp,0.038461538461538464,25,25,TCTAAACGATCTTAGAAGTG,0,470062
araBp,0.038461538461538464,25,25,TCGTAACGTTGAGTGTCTAA,0,511219
araBp,0.038461538461538464,25,25,TCCTGATAGGGGTCAGCCGC,0,489956
araBp,0.038461538461538464,25,25,TAACATGTTAGATGGTTTGA,0,487682
araBp,0.038461538461538464,25,25,GTGCCTTTCAGTCGTCGCGA,0,517123
araBp,0.038461538461538464,25,25,GGGTACAGCCGACGATGCCT,0,487334
araBp,0.038461538461538464,25,25,GGCCCAGCTTTTCTCGATCC,0,495313
araBp,0.038461538461538464,25,25,GGATTGTACATACGCAGATC,0,512219
araBp,0.038461538461538464,25,25,GCGCCTGAAGGCACCTGGAA,0,476859
araBp,0.038461538461538464,25,25,GCCACCTACAGGTCCAAAGT,0,508977
araBp,0.038461538461538464,25,25,GCAGACTAATATAGGCTCAT,0,521275
araBp,0.038461538461538464,25,25,GAAGCCCACAAATCTATCTG,0,495484
araBp,0.038461538461538464,25,25,GAACTTTAACAGATGGACTA,0,476632
araBp,0.038461538461538464,25,25,CTCTAAAGGGGGTTCAGTCC,0,479256
araBp,0.038461538461538464,25,25,CTCGAGGACAAGTTCTAACT,0,512586
araBp,0.038461538461538464,25,25,CGTAGGAAGGGGGATACCCA,0,475848
araBp,0.038461538461538464,25,25,CGTAGCCTCCACTGGGTCAG,0,515397
araBp,0.038461538461538464,25,25,CGGAGTAGGCATGAGATCGT,0,493730
araBp,0.038461538461538464,25,25,CGCATGACGACAGGATCGCT,0,489160
araBp,0.038461538461538464,25,25,CGATGGAGACACTTAAGATG,0,503410
araBp,0.038461538461538464,25,25,CCCAACCTGTCGCATTGTAT,0,478512
araBp,0.038461538461538464,25,25,CCATCATCCGGGCGATCGCA,0,517768
araBp,0.038461538461538464,25,25,CATTGGTCGTTGTTGAGCTA,0,472979
araBp,0.038461538461538464,25,25,CATATACTGCGTGTCAGGCA,0,508579
araBp,0.038461538461538464,25,25,CAGTCAGTGCCAGCAAACTA,0,468373
araBp,0.038461538461538464,25,25,CAGCACGGAGATACAATCGG,0,511431
araBp,0.038461538461538464,25,25,CACAAGAGATCAATAGAGAA,0,507467
araBp,0.038461538461538464,25,25,CAAAGCGGGGACCTCAGTAT,0,473419
araBp,0.038461538461538464,25,25,ATCTTGCTATACGTGCGTTT,0,470168
araBp,0.038461538461538464,25,25,ATAACCGAGTGGTCACGGCA,0,520771
araBp,0.038461538461538464,25,25,AGGGGTCCAATTAAGACAAA,0,479742
araBp,0.038461538461538464,25,25,ACAGCCAGTATAAAGAGGAA,0,471621
araBp,0.038461538461538464,25,25,AATTTCGGTCGAGCGTGTCT,0,505571
araBp,0.038461538461538464,25,25,AAATTCCACCTCTTCAACCT,0,510017
araBp,0.04,24,24,TTCAGCACTCCATCGTGACA,0,508188
araBp,0.04,24,24,TTATTAGCCCCGCGCGTAAA,0,489959
araBp,0.04,24,24,TGGTAGATGGGCTCGGTCTA,0,474915
araBp,0.04,24,24,TGCATACGTGGTAGCAGGTG,0,521637
araBp,0.04,24,24,TCGCTAGTCCGGTTAGGGGA,0,492496
araBp,0.04,24,24,TACGTACCCTCATGATAAAT,0,498331
araBp,0.04,24,24,TAAGACGCAGGGCTTAACTT,0,502569
araBp,0.04,24,24,GGTGGTGCAGTACGCTAACT,0,518101
araBp,0.04,24,24,GGGCGTTCCCGGCTTTCGCA,0,487857
araBp,0.04,24,24,GGAACGCTTGGGTAAGTGTA,0,520240
araBp,0.04,24,24,GCGTTTGGCCACAATTGAGG,0,472363
araBp,0.04,24,24,GCCTCTCGAGGCTGATACAC,0,478553
araBp,0.04,24,24,GCATAGCTCGAACTGCTATT,0,478142
araBp,0.04,24,24,GATTCCCGACATGGAGGCCT,0,492718
araBp,0.04,24,24,GATAGACAATTTATCTACTT,0,504835
araBp,0.04,24,24,CTTTCGCCTATGGCCCTTGC,0,494245
araBp,0.04,24,24,CTTCTGCTTCCCCCACGCCT,0,500631
araBp,0.04,24,24,CTGGCTAGGTGGATACTGTT,0,472785
araBp,0.04,24,24,CTCCGGCGTGCATAGGGACA,0,515801
araBp,0.04,24,24,CTATTGCCGTCATCCATAGG,0,489526
araBp,0.04,24,24,CGGTCATTGGGGGCGCGAGC,0,482737
araBp,0.04,24,24,CGAACAAGACTTCCAGCGTC,0,477961
araBp,0.04,24,24,CCTGGGCGGATGCAGCAGCC,0,488695
araBp,0.04,24,24,CCCCTGTCCCGGTAGAGAGT,0,524148
araBp,0.04,24,24,CCCAGGGACATTGATCGTAA,0,519058
araBp,0.04,24,24,CATTATAGATTCCGCGACAC,0,488121
araBp,0.04,24,24,CACCTTGTCCCGGCCATACA,0,467789
araBp,0.04,24,24,CAATAACGTACTGCTACGTC,0,505154
araBp,0.04,24,24,CAAGTGACCTCCTAAGATCG,0,487382
araBp,0.04,24,24,ATTCATTTCGAAAGTGAGAT,0,475774
araBp,0.04,24,24,ATCTATTAAAAAATAATAGG,0,503583
araBp,0.04,24,24,ACTCAGGTCGCCTGGGCATT,0,489267
araBp,0.04,24,24,ACGAGGTAGGATCAACGATT,0,478189
araBp,0.04,24,24,ACCGGGCTTCATGGACTGGA,0,500732
araBp,0.04,24,24,AAGTGCATTCATCGACGGAT,0,513894
araBp,0.04,24,24,AACAACAGGTTGCGCGGTCA,0,479786
araBp,0.041666666666666664,23,23,TTTGTTCGTTAACCCGTGTG,0,480764
araBp,0.041666666666666664,23,23,TTTGCTGTTACATAATAGGA,0,469532
araBp,0.041666666666666664,23,23,TTCAATGTCGCGGTACAGAT,0,492922
araBp,0.041666666666666664,23,23,TGTCGTTATTATTTCCTCAA,0,503754
araBp,0.041666666666666664,23,23,TCTAGGCTTGGTTCTATGAG,0,505449
araBp,0.041666666666666664,23,23,TCGTTGTCTCGTCCTCGCTT,0,482345
araBp,0.041666666666666664,23,23,TCGAAGTTTCAGTCTTAAAC,0,500860
araBp,0.041666666666666664,23,23,TCCTTTTAGTACAGTACGCA,0,481348
araBp,0.041666666666666664,23,23,TCACTTCCCCCTACCTTGTG,0,479817
araBp,0.041666666666666664,23,23,TATGGCCAAGACATGGATAG,0,483918
araBp,0.041666666666666664,23,23,TAGCCGAGTTCTGCGGCGCG,0,518953
araBp,0.041666666666666664,23,23,GTGTTATTCGACGCAGACCT,0,476772
araBp,0.041666666666666664,23,23,GTAAGCTGCCGTCAACTAAT,0,480323
araBp,0.041666666666666664,23,23,GGGGCTAGATGCTTCAAGAA,0,473796
araBp,0.041666666666666664,23,23,GGGCCAGAGCCAAATTGTAG,0,469390
araBp,0.041666666666666664,23,23,GGACTTCTTGTGCCGCGCCA,0,490753
araBp,0.041666666666666664,23,23,GCTGCTGTGCCTGGGTCATA,0,521291
araBp,0.041666666666666664,23,23,GCCCGGTACCCAGGTAGCTA,0,473957
araBp,0.041666666666666664,23,23,GCCCAATTACGCGACGTAGC,0,470504
araBp,0.041666666666666664,23,23,GCATCCGCAGGACGTACTGT,0,485952
araBp,0.041666666666666664,23,23,GATGTAGTGTTGGCCACTTA,0,476253
araBp,0.041666666666666664,23,23,GATGCAGAAAGCGCTGGTAG,0,475018
araBp,0.041666666666666664,23,23,GATCTGCGCAGCTGCGGTAA,0,479467
araBp,0.041666666666666664,23,23,CTTTATAAAGGTAAAAAGTT,0,493953
araBp,0.041666666666666664,23,23,CTTCGATTTGGCAGGATGTG,0,480461
araBp,0.041666666666666664,23,23,CTAGCTTAGTGCGTTTCCGC,0,510662
araBp,0.041666666666666664,23,23,CTAAGTGGGTGCGTCTCAGC,0,495240
araBp,0.041666666666666664,23,23,CGTTTTTGGTGCCGGAAGAA,0,470854
araBp,0.041666666666666664,23,23,CGTTTCACCGTATCCGACAA,0,523132
araBp,0.041666666666666664,23,23,CGTTATTGGCGGCGTGAGAA,0,469006
araBp,0.041666666666666664,23,23,CGTGGAAGAGGGAGGCCACA,0,515315
araBp,0.041666666666666664,23,23,CGTACATGCCTCGACTGCCA,0,524899
araBp,0.041666666666666664,23,23,CGGCTAGTGTCTCCGTAGGG,0,475013
araBp,0.041666666666666664,23,23,CGGATACCGAAAACAAGGTA,0,492101
araBp,0.041666666666666664,23,23,CGCATCAATATGAGTGCGAT,0,518647
araBp,0.041666666666666664,23,23,CGACATCCTCCGGCTGATTC,0,492793
araBp,0.041666666666666664,23,23,CCTACAATTCACGGTTGCTT,0,521398
araBp,0.041666666666666664,23,23,CCGAGTATGAGGAAAGATCA,0,507484
araBp,0.041666666666666664,23,23,CCCAGAGAGCGGGGAATTTG,0,491777
araBp,0.041666666666666664,23,23,CATTATGCGCACGACTAACG,0,499274
araBp,0.041666666666666664,23,23,CAGCTGGGTGAAATACGTTA,0,468597
araBp,0.041666666666666664,23,23,ATTCGACCTAGCCTAAGTTG,0,490617
araBp,0.041666666666666664,23,23,ATGTCGCACTGGACTAGATC,0,482833
araBp,0.041666666666666664,23,23,ATCTTGATAAAACGGAGCAG,0,499509
araBp,0.041666666666666664,23,23,ATCGCATACTGGACGGGATG,0,522303
araBp,0.041666666666666664,23,23,ATATCATTGAGAGCTTGGTA,0,504630
araBp,0.041666666666666664,23,23,ATAATCTTATCGGCACTCGC,0,474549
araBp,0.041666666666666664,23,23,AGCCCACACGAATACTCCCA,0,516782
araBp,0.041666666666666664,23,23,ACTGTTGAGCCCGTAAATCG,0,476631
araBp,0.041666666666666664,23,23,ACTATCGCAGGAGCCATTAT,0,491954
araBp,0.041666666666666664,23,23,ACTATAATAGCAGTGCTGGC,0,496672
araBp,0.041666666666666664,23,23,ACGCCGACACCGAAGGACGT,0,469614
araBp,0.041666666666666664,23,23,ACACCCTCTCATCTTCGGGA,0,506398
araBp,0.041666666666666664,23,23,AATGCGGGGCTGTGATGTAG,0,520594
araBp,0.041666666666666664,23,23,AAGCAGGATAATGCAGGCCT,0,475262
araBp,0.041666666666666664,23,23,AACAGTTTATCGTCCACAAA,0,510491
araBp,0.043478260869565216,22,22,TTCGCGGGTACCATCTTGAG,0,490501
araBp,0.043478260869565216,22,22,TTACCATGCGATCTCAAAGT,0,480285
araBp,0.043478260869565216,22,22,TGTTTTGACACACCGTTCAT,0,491998
araBp,0.043478260869565216,22,22,TCTGGTCCGTAGGCGCGGCT,0,517368
araBp,0.043478260869565216,22,22,TCTGCAGTATATGGCCCGCG,0,498732
araBp,0.043478260869565216,22,22,TCGTCGGATAAACCGAACTG,0,496663
araBp,0.043478260869565216,22,22,TCCTGCGGATCAGGGCAGTT,0,478078
araBp,0.043478260869565216,22,22,TCATACGTTCCCACATGCTT,0,480991
araBp,0.043478260869565216,22,22,TCAGGACTGTGCCAACGTAG,0,468349
araBp,0.043478260869565216,22,22,TATTCTGTTCACGCGGAGTT,0,492633
araBp,0.043478260869565216,22,22,TACGCTAACGTGGTCCTAGT,0,477618
araBp,0.043478260869565216,22,22,GTGTTTAATCGGGTAGGTGA,0,510297
araBp,0.043478260869565216,22,22,GTGCCTTCCGGGTAGGACAT,0,471667
araBp,0.043478260869565216,22,22,GTAGACTGTGTGGACATTCT,0,492268
araBp,0.043478260869565216,22,22,GTAAGCCACGTGATATATGT,0,479037
araBp,0.043478260869565216,22,22,GGTAAATGGTGGGTGGGATA,0,473621
araBp,0.043478260869565216,22,22,GGGAATTACCCGTTGTATTG,0,493999
araBp,0.043478260869565216,22,22,GGCTACAGGCGGCCCGTGCT,0,473753
araBp,0.043478260869565216,22,22,GGCGAATGTTCATGTATCTA,0,496798
araBp,0.043478260869565216,22,22,GGCAGGAGGGGTGTTAAGCG,0,497277
araBp,0.043478260869565216,22,22,GGAGTGAAACACCATAGTTC,0,493996
araBp,0.043478260869565216,22,22,GCCTGCCTCAGTGCGATGGT,0,505487
araBp,0.043478260869565216,22,22,GCATGACGAAATTGGGCATG,0,493196
araBp,0.043478260869565216,22,22,GCAGCGGACTCTTCCTACAA,0,517993
araBp,0.043478260869565216,22,22,GCAGATGATAACCGTCCCGC,0,520938
araBp,0.043478260869565216,22,22,GAGGCGTGACCTCTGTTGGA,0,487973
araBp,0.043478260869565216,22,22,GACTCAGGAGGGTCTATTAT,0,519220
araBp,0.043478260869565216,22,22,GAAGAGAACATGGACCCGAT,0,495026
araBp,0.043478260869565216,22,22,CTTTATATAATCGGGGGGAG,0,472293
araBp,0.043478260869565216,22,22,CTGGACGTTCCACGCAGGTT,0,486978
araBp,0.043478260869565216,22,22,CTGAAAACCCAAGTCGGCTC,0,485132
araBp,0.043478260869565216,22,22,CTCTGATACATGATCGGCTT,0,479288
araBp,0.043478260869565216,22,22,CTCCAAGCTTTTCTGCTTTG,0,494109
araBp,0.043478260869565216,22,22,CTATCGTAAGCGGCATATCT,0,499803
araBp,0.043478260869565216,22,22,CTAGCGTCCCATCACCTCGA,0,486479
araBp,0.043478260869565216,22,22,CTAAAGAAGTTGCTTCTCTC,0,479693
araBp,0.043478260869565216,22,22,CGTCGCTATTTTCGTGGTTG,0,470530
araBp,0.043478260869565216,22,22,CGGTTTTACCGTATGTGCGT,0,514375
araBp,0.043478260869565216,22,22,CGCGGTGGAAAGCTTACGAA,0,492389
araBp,0.043478260869565216,22,22,CGCCTTGAGGCATCATACAT,0,493378
araBp,0.043478260869565216,22,22,CGCACGCTAGCATGCTGGCA,0,485710
araBp,0.043478260869565216,22,22,CGAGAGACCGGGTACATCAT,0,474998
araBp,0.043478260869565216,22,22,CCTTGATTCTACGGGTAAGG,0,481355
araBp,0.043478260869565216,22,22,CCCTGTCGCTGATTTAAGCT,0,518093
araBp,0.043478260869565216,22,22,CCCCGGAACCGGAGAGCCGA,0,480259
araBp,0.043478260869565216,22,22,CCATGAGGTCCACACTGTTG,0,506209
araBp,0.043478260869565216,22,22,CATTGAATTATGCGGTAAAA,0,504986
araBp,0.043478260869565216,22,22,CATTAATATTGACGCGACAT,0,477718
araBp,0.043478260869565216,22,22,CATGGAAGGGCTGTTAGTAA,0,487505
araBp,0.043478260869565216,22,22,CAGAACGACGGGCAGTCAGT,0,523218
araBp,0.043478260869565216,22,22,CACTGCTGTTTCCCACAGTC,0,498099
araBp,0.043478260869565216,22,22,ATTTAGTTGGAGCCGACCGA,0,498117
araBp,0.043478260869565216,22,22,ATTCAGCGTCTTGCCGCAAT,0,510147
araBp,0.043478260869565216,22,22,ATGGAACAGTGGGAGTTCCC,0,474976
araBp,0.043478260869565216,22,22,ATACACAACGAGTCCCCGCC,0,477547
araBp,0.043478260869565216,22,22,AGGTGAAAAGGGTAAAGGTG,0,475383
araBp,0.043478260869565216,22,22,AGGTAATCCGCGTTAGACAT,0,510661
araBp,0.043478260869565216,22,22,AGCGCTGGTATTGACCCGCA,0,511752
araBp,0.043478260869565216,22,22,AGAGCTGTTGCTAATGTACA,0,512725
araBp,0.043478260869565216,22,22,AGACGAGGGTGCATTCGGGG,0,524403
araBp,0.043478260869565216,22,22,ACGCTAATCACCAGGTCGAA,0,471536
araBp,0.043478260869565216,22,22,ACCGCGAAATAAGCCAGAGC,0,488643
araBp,0.043478260869565216,22,22,ACCCACACATTGTCTTATAA,0,470092
araBp,0.043478260869565216,22,22,AAGGTCCGCTCAGTCTGCTA,0,470464
araBp,0.043478260869565216,22,22,AAGGATAATCAATATAGTGG,0,507897
araBp,0.043478260869565216,22,22,AAGCGTAGCGTAAGTCTGCG,0,498621
araBp,0.043478260869565216,22,22,AAGAAGGTCCCCGGCCATAA,0,477750
araBp,0.043478260869565216,22,22,AACCTCTTCACCGGCTCAAT,0,509983
araBp,0.045454545454545456,21,21,TTTAAGCCCGCAAGGTGACA,0,481250
araBp,0.045454545454545456,21,21,TTGCGTTGCCGTTACAGGGA,0,512256
araBp,0.045454545454545456,21,21,TTCTAGCCTGTAGACAATGT,0,511036
araBp,0.045454545454545456,21,21,TGGGTAAGCACTTTGACTGA,0,471058
araBp,0.045454545454545456,21,21,TGGGGCATACAACACTACAT,0,499722
araBp,0.045454545454545456,21,21,TGCCAGTCAGTTCGCATGGA,0,478282
araBp,0.045454545454545456,21,21,TCTCGGATCGAGTGTAACAA,0,480324
araBp,0.045454545454545456,21,21,TCGGATAAGGATCCCAGCTT,0,502042
araBp,0.045454545454545456,21,21,TCCATAGCGTTGATAAACAG,0,520417
araBp,0.045454545454545456,21,21,TCAGTGGTGCTACCAAAGCC,0,506754
araBp,0.045454545454545456,21,21,TAGGCTCGTGTTTTTCTACA,0,521399
araBp,0.045454545454545456,21,21,TACCCATCGCCGAGGTAGGA,0,516409
araBp,0.045454545454545456,21,21,TAATAAGACGCAACTAAGCA,0,490974
araBp,0.045454545454545456,21,21,TAAGGTAGTATCAATTTCCT,0,472457
araBp,0.045454545454545456,21,21,TAAAGGGACAAGGGGAAGGA,0,523579
araBp,0.045454545454545456,21,21,GTTTTACGTCCCTAAGGAGC,0,508464
araBp,0.045454545454545456,21,21,GTTATACGGGCAAATGCGTG,0,510363
araBp,0.045454545454545456,21,21,GTCCTTCGAATGACCTGAAA,0,511171
araBp,0.045454545454545456,21,21,GTAATCCACCTGCGTTGCCA,0,503059
araBp,0.045454545454545456,21,21,GGGCTCTAACCAAAAGGCTA,0,490615
araBp,0.045454545454545456,21,21,GGCTTAGGACCGGCGTACTC,0,491500
araBp,0.045454545454545456,21,21,GGAGGAGAGACAAGGTCTAA,0,475489
araBp,0.045454545454545456,21,21,GGAGACGGATTAACGTAAAC,0,488138
araBp,0.045454545454545456,21,21,GGAAGTCATTTGTAAGCCAA,0,504309
araBp,0.045454545454545456,21,21,GCTAGGGATGCGGAATGGTA,0,485848
araBp,0.045454545454545456,21,21,GCGTGGGTTCTAAGCGAGTA,0,498649
araBp,0.045454545454545456,21,21,GCGGGGGTCTAGCTCGCCGC,0,474676
araBp,0.045454545454545456,21,21,GCACGAACGACCTCTCCTAT,0,485700
araBp,0.045454545454545456,21,21,GAGCAGGTCTGCGGACAATG,0,497768
araBp,0.045454545454545456,21,21,GACCGACTAAACCGCGGTAC,0,496120
araBp,0.045454545454545456,21,21,GACCCTGCGGATTGACACAT,0,507401
araBp,0.045454545454545456,21,21,GACCCGGTTATAGGGGGACT,0,511328
araBp,0.045454545454545456,21,21,GAATTCCCTGTACTTCCGCA,0,517572
araBp,0.045454545454545456,21,21,GAAGTTTAAGCCTGAGTGTC,0,521437
araBp,0.045454545454545456,21,21,GAACCTGCTAATTAAACACA,0,519309
araBp,0.045454545454545456,21,21,GAAAGTCGAGAAGGCAGGAA,0,474393
araBp,0.045454545454545456,21,21,CTTTCCGGCCTAACAAGTAT,0,486890
araBp,0.045454545454545456,21,21,CTCCATGAGCGTTCCCCGGG,0,484436
araBp,0.045454545454545456,21,21,CGTGCCATCGGCCATCGCAA,0,518932
araBp,0.045454545454545456,21,21,CGTACCGTTACACTCAATCC,0,491505
araBp,0.045454545454545456,21,21,CGGTTTGCCGGGATATGTAA,0,503536
araBp,0.045454545454545456,21,21,CGGGTCTGATCCTTATAGTG,0,478874
araBp,0.045454545454545456,21,21,CGCTGAACGGAACAAAGTTC,0,479770
araBp,0.045454545454545456,21,21,CCGCAGGGGAAAAAGTGAGC,0,495353
araBp,0.045454545454545456,21,21,CCCACCAAGGACCAGGTAAG,0,485372
araBp,0.045454545454545456,21,21,CATATCCTTCAACTTAAAAA,0,487561
araBp,0.045454545454545456,21,21,CAGTTAGGCATAGAGGCGAT,0,505165
araBp,0.045454545454545456,21,21,CAGCACTTTCTAGGACACGA,0,479504
araBp,0.045454545454545456,21,21,CAGATGCCAACGGCAACGGT,0,505086
araBp,0.045454545454545456,21,21,CACTTGTTGATACCAACCTA,0,505524
araBp,0.045454545454545456,21,21,ATTGGGGTATCGTTGAGATC,0,514830
araBp,0.045454545454545456,21,21,ATTCATTCGGTCTCAGCCAG,0,515426
araBp,0.045454545454545456,21,21,ATGAGGTACGCGTAGTAGAT,0,515365
araBp,0.045454545454545456,21,21,ATCTGGTCAGGAAAGGTCAC,0,520241
araBp,0.045454545454545456,21,21,ATAGTTTGGGGATTTCTGAT,0,475998
araBp,0.045454545454545456,21,21,ATAAGATTATCAAGTTCTAC,0,513697
araBp,0.045454545454545456,21,21,AGATCACCTGTACAAGGATG,0,519877
araBp,0.045454545454545456,21,21,AGACCCATCCGGGGCACCGA,0,490066
araBp,0.045454545454545456,21,21,ACTGTAAATCGTCTAATCGT,0,504889
araBp,0.045454545454545456,21,21,ACTATTTGTATAGACCATTA,0,472808
araBp,0.045454545454545456,21,21,ACCCAGGAAACCTGATAAGT,0,475807
araBp,0.045454545454545456,21,21,ACATGAGAGACTAAGCGCGA,0,473102
araBp,0.045454545454545456,21,21,ACAATCTAATGTACGTGCTT,0,498946
araBp,0.045454545454545456,21,21,AATGAAGGGACCGCGTGAAG,0,493195
araBp,0.045454545454545456,21,21,AATCTGTAGGTCTGGCTCAC,0,477633
araBp,0.045454545454545456,21,21,AAGGGTTACGTGCAAGACAG,0,504438
araBp,0.045454545454545456,21,21,AAGCTCGATGAGTGTTGGGT,0,478097
araBp,0.047619047619047616,20,20,TTTGGTCATACCGGGGGAAT,0,509561
araBp,0.047619047619047616,20,20,TTAGATTTGAGCCATTGTAG,0,481838
araBp,0.047619047619047616,20,20,TTACCGCTATGTGTGTGTTT,0,492107
araBp,0.047619047619047616,20,20,TGGTTTCCACTTTTATGGAC,0,477880
araBp,0.047619047619047616,20,20,TGGCCGAGAGCCGCGAGCCT,0,521199
araBp,0.047619047619047616,20,20,TGCAACATACCATCACCTGA,0,468602
araBp,0.047619047619047616,20,20,TGACTACGTCTTTAGCGGGA,0,499571
araBp,0.047619047619047616,20,20,TGAACGGGATGTAAGCGTAT,0,487577
araBp,0.047619047619047616,20,20,TCTTGTATGCTTAGTGCTTT,0,471117
araBp,0.047619047619047616,20,20,TATGCCTGCGTTGTATTAGC,0,475307
araBp,0.047619047619047616,20,20,TAGAGGGTTCGCCTCGCCAT,0,520336
araBp,0.047619047619047616,20,20,TAAAATAAAGACGGACATGA,0,478091
araBp,0.047619047619047616,20,20,GTTTTTAGGGCGCGTAACGG,0,469788
araBp,0.047619047619047616,20,20,GTGCTCGTATTATCATGTAC,0,512982
araBp,0.047619047619047616,20,20,GTGCATGCCACGTGATACAC,0,476991
araBp,0.047619047619047616,20,20,GTCTCCAGGTGATGGCAATA,0,508596
araBp,0.047619047619047616,20,20,GTACTTCAAACACGTCTTTC,0,474368
araBp,0.047619047619047616,20,20,GGTTATCCAGATGACAATGC,0,502329
araBp,0.047619047619047616,20,20,GGTCCAATGAGGTATCCAAT,0,483676
araBp,0.047619047619047616,20,20,GGGAAATCAACTCGGTGTCA,0,506320
araBp,0.047619047619047616,20,20,GGATTTCAGTGAGGGAGGCG,0,499995
araBp,0.047619047619047616,20,20,GGAGATAAGGACATATCTGT,0,475948
araBp,0.047619047619047616,20,20,GCCGGTGTATGAGGGGAATC,0,474158
araBp,0.047619047619047616,20,20,GCCCCGTCGTACCTTGGGGT,0,511753
araBp,0.047619047619047616,20,20,GCAGCCGTTAGGGCACTAAT,0,500847
araBp,0.047619047619047616,20,20,GCAATCTCCGGAGCTGAATA,0,502610
araBp,0.047619047619047616,20,20,GATTGAGCCTCCGCCCAGTG,0,487980
araBp,0.047619047619047616,20,20,GATCCTATAGGGTCGATGTC,0,477617
araBp,0.047619047619047616,20,20,GAGCAAAGTCAGGGTCACAT,0,514156
araBp,0.047619047619047616,20,20,GACCCATGTTATGAATCGCA,0,523925
araBp,0.047619047619047616,20,20,GAATCCGTAGTGCGCCCTCG,0,498029
araBp,0.047619047619047616,20,20,CTTGTCTAATAAGCACCGCC,0,511534
araBp,0.047619047619047616,20,20,CTTAACAATGAGGCGAACAT,0,494273
araBp,0.047619047619047616,20,20,CTGTACTTAAGATGCAAGTA,0,494941
araBp,0.047619047619047616,20,20,CTGGTTGACTGATCTGCTAT,0,468881
araBp,0.047619047619047616,20,20,CTCGGAGGCCCGTTTTATAT,0,498437
araBp,0.047619047619047616,20,20,CTCGCTTTTACGTCATCACT,0,518620
araBp,0.047619047619047616,20,20,CTCAATTGTCGGGTGTGAGG,0,506838
araBp,0.047619047619047616,20,20,CGCCATCCTCGTATCGCGTT,0,497273
araBp,0.047619047619047616,20,20,CGACAGGAGAACGTCCATCA,0,476706
araBp,0.047619047619047616,20,20,CCTCCTGCAACATAGGACGA,0,478604
araBp,0.047619047619047616,20,20,CCTAGCTCTAGATCACGGGG,0,472256
araBp,0.047619047619047616,20,20,CCGCTTGTAAGGCTCGGCCA,0,486244
araBp,0.047619047619047616,20,20,CACTGGACCCGACAGTGAAA,0,503622
araBp,0.047619047619047616,20,20,CACAGAGAGTTTAGCATTTG,0,517916
araBp,0.047619047619047616,20,20,CAATTTATGAATCCAGACGT,0,491531
araBp,0.047619047619047616,20,20,ATTCGAAAGTCGCTTATCTC,0,481364
araBp,0.047619047619047616,20,20,ATCAGTGCGAACTAGGGTTA,0,513711
araBp,0.047619047619047616,20,20,ATATTAGCTTCAGAGCAAAT,0,477983
araBp,0.047619047619047616,20,20,ATAGTCCCGTCGTAAGTAAT,0,472901
araBp,0.047619047619047616,20,20,ATAAGAGAGTTAGGAGTCTG,0,479443
araBp,0.047619047619047616,20,20,AGCTTAACTACGTTTACTTG,0,475167
araBp,0.047619047619047616,20,20,AGCCCAGCGATAGCGAGAAG,0,472418
araBp,0.047619047619047616,20,20,AGCAGCACGCATTTTCGAGA,0,515290
araBp,0.047619047619047616,20,20,AGATCATCGGGGGATAAGTT,0,479840
araBp,0.047619047619047616,20,20,AGAGTCAATGATTACGTATT,0,491007
araBp,0.047619047619047616,20,20,ACTATTGCCACGTACTTCGC,0,472763
araBp,0.047619047619047616,20,20,ACGTCGGCGGCCTTAAAGAT,0,501950
araBp,0.047619047619047616,20,20,ACCTCGGTGCGTGAGACTTA,0,470061
araBp,0.047619047619047616,20,20,ACCCTTCTACAGTTAGCTCC,0,481135
araBp,0.047619047619047616,20,20,ACCAAAGAGTAGGCCGCATT,0,523737
araBp,0.047619047619047616,20,20,ACAGCAGGAAGTCATATCTA,0,510693
araBp,0.047619047619047616,20,20,ACACGGTTCTTAAGGAATCT,0,506499
araBp,0.047619047619047616,20,20,AATGTACCGTCGCGAAATTC,0,495318
araBp,0.047619047619047616,20,20,AACTAGCTTTGTAGGACTAC,0,493992
araBp,0.047619047619047616,20,20,AACGATAAGACCGTGTTTGT,0,500858
araBp,0.047619047619047616,20,20,AACACTTTTGAAACGATCAC,0,504058
araBp,0.047619047619047616,20,20,AACAAAAGAGTACCCATGGT,0,506418
araBp,0.05,19,19,TTGGGAAGCATCTTCGGCGG,0,497071
araBp,0.05,19,19,TTGGAAGCGAGGCACGATCA,0,502394
araBp,0.05,19,19,TTGAGTTTTCAAATGGGTGC,0,472367
araBp,0.05,19,19,TTCGCGATGCGTCAGAGGGT,0,484346
araBp,0.05,19,19,TTCGCAAACCAGGGTCAGAT,0,488109
araBp,0.05,19,19,TTATCTTTGTCAGAGTGCCT,0,485674
araBp,0.05,19,19,TGTGGTTTTCGCGCACAATG,0,499631
araBp,0.05,19,19,TGTCTCGCTACTATATGACA,0,501714
araBp,0.05,19,19,TGTCTCAATTGAGAAGTGCA,0,502287
araBp,0.05,19,19,TGCTGCCGCGTGCTTTACAG,0,497671
araBp,0.05,19,19,TGCTCAACATCTCCGTTGTT,0,514365
araBp,0.05,19,19,TGCGGAATCGTCTACCACTG,0,484658
araBp,0.05,19,19,TGACGGGGATAGGCGTTTAC,0,504045
araBp,0.05,19,19,TCGGTAATTTTAGTACGTTG,0,518207
araBp,0.05,19,19,TCGGATAGTGCTGGAGCGAG,0,487206
araBp,0.05,19,19,TCGGATACGTCATACGTTGG,0,517122
araBp,0.05,19,19,TCCTAGCGGGTCGATCTCCA,0,515700
araBp,0.05,19,19,TCCGCTGCTGATGGAAGTCA,0,505598
araBp,0.05,19,19,TCCCCCACCCTGCTGAAGAA,0,509346
araBp,0.05,19,19,TATGGATCACATGATCGCCA,0,471183
araBp,0.05,19,19,TATGCAGACTACAATGAGGG,0,516965
araBp,0.05,19,19,TATCGGGGGAAAATGGCACA,0,504729
araBp,0.05,19,19,TAGGGATACTCTTCATTTAG,0,493209
araBp,0.05,19,19,TAGGCCACAAGAGATATTTA,0,489059
araBp,0.05,19,19,TACGATTAGAGAGGAGCTAG,0,494935
araBp,0.05,19,19,TACAGTTAGAGAATGTCAGG,0,491673
araBp,0.05,19,19,TAAGAAACTCGCGTCCCAGC,0,494561
araBp,0.05,19,19,GTTAACATGTGGCGACTGGA,0,512686
araBp,0.05,19,19,GTGAGTTACATAAGCAACGA,0,524939
araBp,0.05,19,19,GTAACCAGAAGGGCAATATT,0,484289
araBp,0.05,19,19,GGTCATTGGTTAGTGAGGGG,0,500111
araBp,0.05,19,19,GGTACGCGAGTAGGATCGTT,0,495326
araBp,0.05,19,19,GGGTACGGGTGTTACGTGGG,0,521489
araBp,0.05,19,19,GGGAAGCCGCGCAGGGGTTT,0,467908
araBp,0.05,19,19,GGATTGTCATCACTTCTCTG,0,514155
araBp,0.05,19,19,GCGTGTTTGCCCAGTTCATT,0,494061
araBp,0.05,19,19,GATGCATTAATTTAACGAGT,0,525106
araBp,0.05,19,19,GATAGACATTGCCAAACGAC,0,485303
araBp,0.05,19,19,GAGGCCACGGCTTTTTAGCC,0,467774
araBp,0.05,19,19,GAGAAAGGAAGCAATTACAA,0,475654
araBp,0.05,19,19,GACTCGCGCCTAAATGTATA,0,484818
araBp,0.05,19,19,GACAAAGTGAGATAAGGTCA,0,506631
araBp,0.05,19,19,GAATGGTAGATTTATTGCTA,0,494589
araBp,0.05,19,19,GAACGGATCGAGTCGAAATT,0,483226
araBp,0.05,19,19,CTTTCTCGTCTAGGGAGATG,0,471374
araBp,0.05,19,19,CTCGGTCGCGAATGTGACCA,0,491955
araBp,0.05,19,19,CTAAAGGAAGGTATTGAATA,0,508755
araBp,0.05,19,19,CGTTACTCTACTTCTCAGCG,0,484445
araBp,0.05,19,19,CGGTTGAAAAAGTTGCGGCC,0,468527
araBp,0.05,19,19,CGGGAAAAATTTGCGTATAC,0,489664
araBp,0.05,19,19,CGATTGGGATTTACAAGGGA,0,503201
araBp,0.05,19,19,CGATACAAATGATGACGTCG,0,480587
araBp,0.05,19,19,CGAGAGATTTGTTGCCGCAG,0,469786
araBp,0.05,19,19,CGAATGCATCCCTGGCGAAC,0,525405
araBp,0.05,19,19,CCGTCCATCATAGCCGCAAT,0,502774
araBp,0.05,19,19,CCCTTAAACGTCTCTGCCGA,0,503448
araBp,0.05,19,19,CCATCTCCGATGTCGTACCT,0,505193
araBp,0.05,19,19,CCAACTCCAACTTAGACACT,0,469965
araBp,0.05,19,19,CATCATCACCGTGTAGGAGA,0,481687
araBp,0.05,19,19,CATAGAGTCGCTAAGTCGTC,0,520246
araBp,0.05,19,19,CAGTATTATCTCGGTTTGTT,0,509472
araBp,0.05,19,19,CAGCTGCCAATGGTAAGATG,0,473469
araBp,0.05,19,19,ATTAGGAAGAAAATTTATAA,0,499633
araBp,0.05,19,19,ATGTGTTATAAATGAACGTC,0,506240
araBp,0.05,19,19,ATGTACGAGGGTTATCTGGG,0,516138
araBp,0.05,19,19,ATGGGGCTTAAGCGTGAGTC,0,503021
araBp,0.05,19,19,ATGAGATGTAGCTTTTGCGA,0,477002
araBp,0.05,19,19,ATCTGAGTTCGCAAAACCAC,0,474967
araBp,0.05,19,19,ATACGGTAGTGGCAGCCATC,0,480930
araBp,0.05,19,19,AGTGGCTCACGCCTGGGCCT,0,519188
araBp,0.05,19,19,AGGGTGCCCTATTTGTAGGC,0,471622
araBp,0.05,19,19,AGGGAACCTGTCGTGGTTCT,0,519716
araBp,0.05,19,19,AGGATAACAGGATGAATACG,0,503058
araBp,0.05,19,19,AGGAGCGGTACGTACCATTC,0,473958
araBp,0.05,19,19,AGGAAGCCGTTAAGTCGCAT,0,518994
araBp,0.05,19,19,AGCACTGCTACAAGTTTTCG,0,504731
araBp,0.05,19,19,AGAACTCGAATGCAGTTAAA,0,494619
araBp,0.05,19,19,ACTCCCCCGGGCAATCAGTC,0,479506
araBp,0.05,19,19,ACTATCTCCGGGTTTAAGTC,0,514246
araBp,0.05,19,19,ACGGCGGGCTCTGTGCGTCA,0,504568
araBp,0.05,19,19,ACGATCGCCAATACTGCTAT,0,476705
araBp,0.05,19,19,ACATTTACTTTAGGTGTTCC,0,519205
araBp,0.05,19,19,AATCTGTGTGTTCCATTAGT,0,518242
araBp,0.05,19,19,AATAGGGCCGACGTAAGCCG,0,510123
araBp,0.05,19,19,AATAGGAAAAAGTTTACGAT,0,492975
araBp,0.05,19,19,AAGCGAAGACCCTGACCCAG,0,501158
araBp,0.05,19,19,AACTGTTGAAATACAATTAA,0,514182
araBp,0.05,19,19,AACTCATGACTGCGTCCTCG,0,510003
araBp,0.05,19,19,AACGAGGACCACTGATCAGT,0,509746
araBp,0.05,19,19,AAATCAATCGAATTGAGTGG,0,470460
araBp,0.05263157894736842,18,18,TTTGCATGGTTAAAGACGAC,0,472945
araBp,0.05263157894736842,18,18,TTTCCGCTTAGGATGGATTT,0,475377
araBp,0.05263157894736842,18,18,TTGAACGGATCAGCGAGGTC,0,475730
araBp,0.05263157894736842,18,18,TTCGGGCATTAGCCGAAATG,0,484487
araBp,0.05263157894736842,18,18,TTCCTTTTTGCGCGCATAGT,0,478210
araBp,0.05263157894736842,18,18,TTCCATGGGCACAGCATCGT,0,485318
araBp,0.05263157894736842,18,18,TTATCGCACAGGGGGGGAGA,0,508784
araBp,0.05263157894736842,18,18,TGTTAAATATATGTTTGGGA,0,495109
araBp,0.05263157894736842,18,18,TGGCCTTCTACCATTAAAAC,0,487187
araBp,0.05263157894736842,18,18,TGGATCACATGTGTAAAACA,0,469825
araBp,0.05263157894736842,18,18,TGCTCGACAATGCCGAGTCG,0,491952
araBp,0.05263157894736842,18,18,TCTTACGAGAGGGCGGATAA,0,510007
araBp,0.05263157894736842,18,18,TCTAGATTCGCGTAGTGTTG,0,502045
araBp,0.05263157894736842,18,18,TCGTACTCAAGATCCCTGCA,0,483151
araBp,0.05263157894736842,18,18,TCGAGGGAATTGCCAGGCGC,0,485013
araBp,0.05263157894736842,18,18,TCCGGGGGCGATTGACTTAG,0,524068
araBp,0.05263157894736842,18,18,TCACTACCACTGGTCACAAT,0,471379
araBp,0.05263157894736842,18,18,TATTTTCGTAGTGGGGCGGG,0,482598
araBp,0.05263157894736842,18,18,TATAGTCACAATGAGAATGC,0,470181
araBp,0.05263157894736842,18,18,TATACGATTGGCTACTAGAG,0,508330
araBp,0.05263157894736842,18,18,TAAAGTGCATAGCGACAGTA,0,522676
araBp,0.05263157894736842,18,18,TAAAGGAGCTTGATGTGAAG,0,500853
araBp,0.05263157894736842,18,18,GTTCCAGCGCTGGAGAACCA,0,509508
araBp,0.05263157894736842,18,18,GTTAGCTAATGACTCTCGGC,0,483132
araBp,0.05263157894736842,18,18,GTGAATCTACCAGAGAACAT,0,494692
araBp,0.05263157894736842,18,18,GTCCCCGCCACAGCCATTGG,0,499567
araBp,0.05263157894736842,18,18,GTCAGGTATTTAAGACGGAG,0,483208
araBp,0.05263157894736842,18,18,GGTTGGCCGGTACCTTTCCC,0,494660
araBp,0.05263157894736842,18,18,GGTGGAGGCCAGAGGGGCCA,0,514086
araBp,0.05263157894736842,18,18,GGTCACGGATTGCGGTGTAA,0,489084
araBp,0.05263157894736842,18,18,GGGCTGGTGAGCAATCTTTT,0,486089
araBp,0.05263157894736842,18,18,GGGATTGGGATGCATTCGAC,0,499788
araBp,0.05263157894736842,18,18,GGCCAGAAACTGCCAGCATA,0,493503
araBp,0.05263157894736842,18,18,GGATTGCGTTTTGTACTGGA,0,502472
araBp,0.05263157894736842,18,18,GGATAGCGGTCTAGGCTATT,0,523563
araBp,0.05263157894736842,18,18,GCTTATCAGGTTTTCCAGTA,0,495951
araBp,0.05263157894736842,18,18,GCTCACCACGTGATGTAGGT,0,491472
araBp,0.05263157894736842,18,18,GCGGACAGGACCGCACCCAC,0,492265
araBp,0.05263157894736842,18,18,GCCGAAACGACGTCCGACAC,0,471021
araBp,0.05263157894736842,18,18,GCATCATCAGTGTAATTGGG,0,496122
araBp,0.05263157894736842,18,18,GATGCCTTGGTTGGGTATTT,0,522502
araBp,0.05263157894736842,18,18,GATCTGGATTGTTACCTGCC,0,491614
araBp,0.05263157894736842,18,18,GATCGCTGCGAATTCAGATG,0,486471
araBp,0.05263157894736842,18,18,GATCGCGCCTCAGTGATTTA,0,489674
araBp,0.05263157894736842,18,18,GAGCGAGGTCCCCATCTGGT,0,485015
araBp,0.05263157894736842,18,18,GAGACTTCGGGGTGTAGCAA,0,502701
araBp,0.05263157894736842,18,18,GACGAGGGGAGGCGAAGTTA,0,487172
araBp,0.05263157894736842,18,18,GACCCGTGTCAAACCATTTC,0,497710
araBp,0.05263157894736842,18,18,GAATCGAGTCGCAAACGCGT,0,475525
araBp,0.05263157894736842,18,18,GAACGCCAGACATATCTCCA,0,490721
araBp,0.05263157894736842,18,18,GAAAGACGGTTGGCACCATG,0,495952
araBp,0.05263157894736842,18,18,GAAACGTTAGGCACCAGACA,0,523689
araBp,0.05263157894736842,18,18,GAAACGCCTTTGGCTGCACA,0,521586
araBp,0.05263157894736842,18,18,CTGTATAGAGTGGACTTCGA,0,494664
araBp,0.05263157894736842,18,18,CTGTACGGGAGACGTCATTG,0,488691
araBp,0.05263157894736842,18,18,CTGAGTAATGTCCAGGACGA,0,502970
araBp,0.05263157894736842,18,18,CTCGGATGAGGCCCACGCCG,0,519624
araBp,0.05263157894736842,18,18,CTAGGGACGAACACAACGAC,0,483349
araBp,0.05263157894736842,18,18,CTAAGTCAATGCAGAGTTCG,0,491174
araBp,0.05263157894736842,18,18,CGGTTGTGACGAATAGGCGA,0,508590
araBp,0.05263157894736842,18,18,CGCATGCGACCTCAGAAGCA,0,484943
araBp,0.05263157894736842,18,18,CGATTTCTCGAATGTTATAC,0,488966
araBp,0.05263157894736842,18,18,CGAGGCCGGGACCACTACAG,0,486209
araBp,0.05263157894736842,18,18,CCTCTGGGCGGGTACACTTA,0,469565
araBp,0.05263157894736842,18,18,CCGTCATGAAAGCACCTGGA,0,515452
araBp,0.05263157894736842,18,18,CCGCTCCCAGTTCGAAACTT,0,470477
araBp,0.05263157894736842,18,18,CCGAAAGGTAAACTAATACA,0,470516
araBp,0.05263157894736842,18,18,CCCGTTAGCTGCGGGTCCTC,0,488987
araBp,0.05263157894736842,18,18,CCCGTAGAAGACCGACGTTA,0,515041
araBp,0.05263157894736842,18,18,CCATTTTCCAGGGTCTAGGC,0,477758
araBp,0.05263157894736842,18,18,CCACGCTTCGAGCCCTGGAA,0,472408
araBp,0.05263157894736842,18,18,CCACCGGGAGCCCAGCGCGA,0,470275
araBp,0.05263157894736842,18,18,CCACCACTCGCTTCTTTCGA,0,493454
araBp,0.05263157894736842,18,18,CATTTATGAAGACCGTTCTC,0,523274
araBp,0.05263157894736842,18,18,CATGGGCAACACTAAACATG,0,497418
araBp,0.05263157894736842,18,18,CAGTTTACAGGCGCATGACT,0,491191
araBp,0.05263157894736842,18,18,CAATGCGTGTTCAGTGTTTG,0,497358
araBp,0.05263157894736842,18,18,CAACATTAGAACCAAAGTTT,0,490689
araBp,0.05263157894736842,18,18,CAAATGGGAGTCCCGCTCGG,0,468561
araBp,0.05263157894736842,18,18,ATTTACAAGACACTCGGGCT,0,485084
araBp,0.05263157894736842,18,18,ATTGGCACTGGTCATGCCAA,0,523778
araBp,0.05263157894736842,18,18,ATTCACGCGATATAGAGCTA,0,470290
araBp,0.05263157894736842,18,18,ATTCAAGTCTGTATTGGAAC,0,483207
araBp,0.05263157894736842,18,18,ATTACGCTGCAATTCTCGGT,0,513187
araBp,0.05263157894736842,18,18,ATTAAGAAATCAGGAGCTAT,0,525477
araBp,0.05263157894736842,18,18,ATGGGTGGAAATGGTAAAGT,0,500861
araBp,0.05263157894736842,18,18,ATCTAAGAATCGGCGACTAC,0,488518
araBp,0.05263157894736842,18,18,ATACCCTATGCTCATACCGC,0,479644
araBp,0.05263157894736842,18,18,AGTGTCTACGCTAAGCCAAT,0,519337
araBp,0.05263157894736842,18,18,AGGCCACGGGTTTAAGTCCT,0,507906
araBp,0.05263157894736842,18,18,AGCGTCCGGGGGGACGGACT,0,523382
araBp,0.05263157894736842,18,18,AGAGATATGAGTACGGGCGG,0,513848
araBp,0.05263157894736842,18,18,AGAACTTCTGCAAACACGTG,0,515939
araBp,0.05263157894736842,18,18,ACTGTAAGGGCGATTTGGGA,0,496583
araBp,0.05263157894736842,18,18,ACGTCATAGTGTACCTTTCA,0,522539
araBp,0.05263157894736842,18,18,ACAAACCTGCGTCTATCGAA,0,482890
araBp,0.05263157894736842,18,18,AATTGACTGTGAGGAATTTA,0,492887
araBp,0.05263157894736842,18,18,AATGGCTTACTGGCTTGATA,0,489666
araBp,0.05263157894736842,18,18,AAGCCGAGGTATCCTCGAGT,0,484106
araBp,0.05263157894736842,18,18,AACGTTCTTAGCTGACTTAG,0,468034
araBp,0.05263157894736842,18,18,AAATACTTAGTAATCAGTCA,0,499889
araBp,0.05263157894736842,18,18,AAATAACGGTTTTGTCAGGT,0,509607
araBp,0.05263157894736842,18,18,AAAGGGGGCAATGATTCTCA,0,478326
araBp,0.05555555555555555,17,17,TTTGGGGGTAATGCGATCCC,0,524620
araBp,0.05555555555555555,17,17,TTTATGGCTGGAGATACAAG,0,483069
araBp,0.05555555555555555,17,17,TTGAGACTCTTTCCCCGCAA,0,491575
araBp,0.05555555555555555,17,17,TTCGACCCTAGTGGCCACGT,0,474928
araBp,0.05555555555555555,17,17,TGTTTTTTGGTTATCGCGTG,0,493296
araBp,0.05555555555555555,17,17,TGTATGTGTTGCATCGTTCA,0,494873
araBp,0.05555555555555555,17,17,TGGTGTGTTTGTTTCCCATT,0,505900
araBp,0.05555555555555555,17,17,TCTTATGACGAATCTCAGTT,0,484195
araBp,0.05555555555555555,17,17,TCTAACTGTGTTTATGAAGA,0,514333
araBp,0.05555555555555555,17,17,TCGGCTGGAAGGGGGTAAAG,0,495219
araBp,0.05555555555555555,17,17,TCGAGAGGGCAACGAATTGA,0,470659
araBp,0.05555555555555555,17,17,TCGACTGGCCAGCACGAGTT,0,515137
araBp,0.05555555555555555,17,17,TCCATAGGACACAACCCCAC,0,468454
araBp,0.05555555555555555,17,17,TCCAGGAATCTGGACGGAGG,0,484491
araBp,0.05555555555555555,17,17,TATGAAAGCCACACTGGGTA,0,523546
araBp,0.05555555555555555,17,17,TATCTAGCATGCCCGGAGTG,0,524617
araBp,0.05555555555555555,17,17,TAGCTTAACCGTTTGGCCGT,0,513915
araBp,0.05555555555555555,17,17,TAGCCGACGTCTACCCGTAG,0,513145
araBp,0.05555555555555555,17,17,TACTTAGGGTGTCTCTTGGT,0,498579
araBp,0.05555555555555555,17,17,TACTGGTACCGTCTTCTGTG,0,491671
araBp,0.05555555555555555,17,17,TACGTTACATGCCCTGGGGA,0,469823
araBp,0.05555555555555555,17,17,TAACGCCGCTCGAGTGTCGT,0,488821
araBp,0.05555555555555555,17,17,TAAAGGGTGACATCTACCGG,0,525092
araBp,0.05555555555555555,17,17,TAAAACAACGGGGAACGACA,0,518961
araBp,0.05555555555555555,17,17,GTTTTTGACTCGGAGCTGCG,0,495355
araBp,0.05555555555555555,17,17,GTTAAGGTTTTTGATGGCGG,0,486129
araBp,0.05555555555555555,17,17,GTGTTCCGAAACGGAAGTTT,0,519388
araBp,0.05555555555555555,17,17,GTGTTACAGTCGAAAAGAGT,0,467951
araBp,0.05555555555555555,17,17,GTGCCACCGGGATGATGGGT,0,517814
araBp,0.05555555555555555,17,17,GTGATGATGGAGCTAGAAGG,0,485693
araBp,0.05555555555555555,17,17,GTGAGCTTAGTTTTCAATGA,0,468457
araBp,0.05555555555555555,17,17,GTCTCCTCGGATCAATTTTT,0,489621
araBp,0.05555555555555555,17,17,GTCAAAGGGAGCACGGCTTG,0,519879
araBp,0.05555555555555555,17,17,GTATTGTCATCTGTTGTAAC,0,497073
araBp,0.05555555555555555,17,17,GTACGCATCACGTAGGACTT,0,517067
araBp,0.05555555555555555,17,17,GTACCCAACGTGCATCTGTC,0,478372
araBp,0.05555555555555555,17,17,GTAAGGTACCATGTCGCGAG,0,518534
araBp,0.05555555555555555,17,17,GGTTTCCTTATACGGGACTA,0,508722
araBp,0.05555555555555555,17,17,GGTTGACTGCTACTTAGGCT,0,496002
araBp,0.05555555555555555,17,17,GGTTCTCAACGCGTGCCGTA,0,508512
araBp,0.05555555555555555,17,17,GGTGATATAGGCATCGATAT,0,508986
araBp,0.05555555555555555,17,17,GGGTACTTGTTTATAATACG,0,491607
araBp,0.05555555555555555,17,17,GGGACCTTCTAGATGAATGC,0,483853
araBp,0.05555555555555555,17,17,GGCGTCGCGCTCATACGCAA,0,485524
araBp,0.05555555555555555,17,17,GGCGGGGAAATGTTTTGGGG,0,477116
araBp,0.05555555555555555,17,17,GGCCAGCCACGCGCAATCTT,0,519635
araBp,0.05555555555555555,17,17,GGCATATGTAGGATAGGATA,0,471503
araBp,0.05555555555555555,17,17,GGCACGCACCAGGACCTTTT,0,487459
araBp,0.05555555555555555,17,17,GGACGCACCCAGCCCCACTT,0,502928
araBp,0.05555555555555555,17,17,GCTTGTAACCTTCAAGAGTT,0,475032
araBp,0.05555555555555555,17,17,GCTTATTAAGCGTTGGATGT,0,487535
araBp,0.05555555555555555,17,17,GCTGCGGAGATCTAATATTG,0,509423
araBp,0.05555555555555555,17,17,GCTGAAATAAGGCATAGCAA,0,519876
araBp,0.05555555555555555,17,17,GCGGTGTCAGTTAGGTGCTG,0,477873
araBp,0.05555555555555555,17,17,GCGGCGTCGAGTAAGCTCAG,0,517021
araBp,0.05555555555555555,17,17,GCGCAAGTCGGGCCAATCTC,0,480692
araBp,0.05555555555555555,17,17,GCCCGCGATCAGCGCAAACT,0,474461
araBp,0.05555555555555555,17,17,GCCAGGGAGGTCAGCATATC,0,470903
araBp,0.05555555555555555,17,17,GCCACCCCAATCGAACAATA,0,514942
araBp,0.05555555555555555,17,17,GCCAACGCACCCTAAAATAG,0,467820
araBp,0.05555555555555555,17,17,GCATGTTGGTGATCAAGTAG,0,486260
araBp,0.05555555555555555,17,17,GCACCGCTCACACGGTGTCT,0,484822
araBp,0.05555555555555555,17,17,GCAACTAGGATTTATAGTAC,0,515596
araBp,0.05555555555555555,17,17,GATCACGTCTCGTGGTGAAT,0,509554
araBp,0.05555555555555555,17,17,GATATCGTGTAATGCCTAGT,0,480258
araBp,0.05555555555555555,17,17,GATAATACGGAGAAAAGATT,0,497407
araBp,0.05555555555555555,17,17,GATAAACGTAGGATGTCTTG,0,471508
araBp,0.05555555555555555,17,17,GAGTGTGAGCTATTAGACCT,0,487289
araBp,0.05555555555555555,17,17,GAGTGCCGAACATCCGGGGA,0,499985
araBp,0.05555555555555555,17,17,GAGTATTCCACTGGTCAGTT,0,493943
araBp,0.05555555555555555,17,17,GAGTAAGAGTACGGCGTCTA,0,498743
araBp,0.05555555555555555,17,17,GAGGACGGAAGGCGCCAGGT,0,475219
araBp,0.05555555555555555,17,17,GAGATGCAATCATATGGGCT,0,524246
araBp,0.05555555555555555,17,17,GACTTTCGGGAGGCTGGACC,0,478135
araBp,0.05555555555555555,17,17,GAAGGTTAAAGGGCTACGGT,0,485714
araBp,0.05555555555555555,17,17,GAAGGGGTCTGGCGACCTAC,0,496933
araBp,0.05555555555555555,17,17,GAAGATCTAGCCGCCTCTGC,0,493101
araBp,0.05555555555555555,17,17,GAACCGCCAGCGGGGTGCCG,0,473437
araBp,0.05555555555555555,17,17,CTTCAGGAGGCTCGGTCCTT,0,516363
araBp,0.05555555555555555,17,17,CTGGTTATGTACACGGAGAT,0,470277
araBp,0.05555555555555555,17,17,CTGCGGGTAAGCCTTGTGCA,0,470657
araBp,0.05555555555555555,17,17,CTCGTTCAATCGGCTTCATA,0,503676
araBp,0.05555555555555555,17,17,CTCGCTAATCTAAAATTGCA,0,487119
araBp,0.05555555555555555,17,17,CTCGAGAATTCGCAGCTTCT,0,472997
araBp,0.05555555555555555,17,17,CTCAGAAACCTCAAATGACA,0,479747
araBp,0.05555555555555555,17,17,CTAGGCACAAATTTGTCGTC,0,491644
araBp,0.05555555555555555,17,17,CTAAAATAGGTTGTCTTCGT,0,499469
araBp,0.05555555555555555,17,17,CGTGCACTTGCCGGAACCAA,0,496490
araBp,0.05555555555555555,17,17,CGGTGACACCGGGGTGCCTT,0,518344
araBp,0.05555555555555555,17,17,CGACGTCATTATGTTCCTCC,0,483159
araBp,0.05555555555555555,17,17,CGAACCTGGTCCGTAGGGTC,0,497115
araBp,0.05555555555555555,17,17,CCTAGGTCACAGTAGACATG,0,481463
araBp,0.05555555555555555,17,17,CCTACTCTTTCGGGGCCTTC,0,490258
araBp,0.05555555555555555,17,17,CCCTAAGCGGCTTCAGTCTG,0,509011
araBp,0.05555555555555555,17,17,CCCCCACGGCTCCTGTAATT,0,470718
araBp,0.05555555555555555,17,17,CCATAACTCCGCTCTGGGAT,0,480813
araBp,0.05555555555555555,17,17,CATGAGGGTAGGTTGGGTAC,0,472957
araBp,0.05555555555555555,17,17,CATGAGCTACGGGATACTCT,0,470488
araBp,0.05555555555555555,17,17,CAGGTTAGCCGAGGTGAGAT,0,487670
araBp,0.05555555555555555,17,17,CAGAAAGGTTCTAGTTTCTG,0,478328
araBp,0.05555555555555555,17,17,CACTACGAGAGTATTCGTAG,0,508129
araBp,0.05555555555555555,17,17,CACCGGAAGCCCTCAAGAGA,0,506916
araBp,0.05555555555555555,17,17,CAAGCCTCGGGCTCATACGA,0,503948
araBp,0.05555555555555555,17,17,ATTGCCCTTTACCCTGCGAA,0,471460
araBp,0.05555555555555555,17,17,ATTATGTCACTACACGAAAA,0,488036
araBp,0.05555555555555555,17,17,ATGATAATGTAAGAGGCGTT,0,495023
araBp,0.05555555555555555,17,17,ATCTAGGAACAAGGGAATAA,0,498734
araBp,0.05555555555555555,17,17,ATCGTTTAAGTTGAAAGCAA,0,482694
araBp,0.05555555555555555,17,17,ATCCTAGGCTCCCATCCTTC,0,482364
araBp,0.05555555555555555,17,17,ATATCTTTCTTCTCGGGTAT,0,512084
araBp,0.05555555555555555,17,17,ATAATGATAGCGAGGTAAAA,0,510548
araBp,0.05555555555555555,17,17,AGTGTAAAATCGGGGGTAGT,0,468383
araBp,0.05555555555555555,17,17,AGTGGAGGGATCAGTTAGCA,0,498989
araBp,0.05555555555555555,17,17,AGGCTGGGTTGTAATTGTCC,0,517370
araBp,0.05555555555555555,17,17,AGGCTGACTCAAAACAGTCC,0,522764
araBp,0.05555555555555555,17,17,AGCGCCTCGCAGGGCAGCTT,0,486255
araBp,0.05555555555555555,17,17,AGATAAGTTGGGGTTCCACT,0,501990
araBp,0.05555555555555555,17,17,AGAACCCTTGTCAATACCTG,0,472696
araBp,0.05555555555555555,17,17,ACTTAGTTTCTCAACTGAAG,0,524746
araBp,0.05555555555555555,17,17,ACTGTGGCGCATTTAGGGAT,0,485283
araBp,0.05555555555555555,17,17,ACTCCCTGCAATATGTGGAA,0,469401
araBp,0.05555555555555555,17,17,ACTACCAGGAATAATGGCGT,0,493417
araBp,0.05555555555555555,17,17,ACGGTCCGCCGGGGACAGCC,0,498771
araBp,0.05555555555555555,17,17,AATTCAGCCGCGCAAATGAG,0,498839
araBp,0.05555555555555555,17,17,AATGGCTACTCTCGACCCGT,0,484561
araBp,0.05555555555555555,17,17,AATGAATCACAGGGTTGTGG,0,501561
araBp,0.05555555555555555,17,17,AAGTGGCTCTACTTCTGTCT,0,519347
araBp,0.05555555555555555,17,17,AAGTATCGCGCGCTAAGTGG,0,470712
araBp,0.05555555555555555,17,17,AAGGCTGGGGTCCTTGCAAC,0,486710
araBp,0.05555555555555555,17,17,AAGCCGCGACGGTGTGAAGG,0,471746
araBp,0.05555555555555555,17,17,AAGATACCCTTGAGTAAGAT,0,485085
araBp,0.05555555555555555,17,17,AAGAGCTTGACAGACGTGAT,0,515429
araBp,0.05555555555555555,17,17,AACTTTTTCCACTGTTCGTC,0,474880
araBp,0.05555555555555555,17,17,AACTTCAATCCGCCGTGCTA,0,478944
araBp,0.05555555555555555,17,17,AACCATGACAGAGAAGTCCA,0,519416
araBp,0.05555555555555555,17,17,AACAGGAACAACCCGAAAAA,0,503401
araBp,0.05555555555555555,17,17,AAATGTCGGTTATCCAAGTA,0,496881
araBp,0.05555555555555555,17,17,AAAGCAAGGGTCCCGTTTTA,0,489660
araBp,0.058823529411764705,16,16,TTTTGTATGCTCTGGGCATT,0,490835
araBp,0.058823529411764705,16,16,TTTGGGCTTGCGACGATTCT,0,472333
araBp,0.058823529411764705,16,16,TTTCAATGGTCTCTGCATAA,0,495245
araBp,0.058823529411764705,16,16,TTGGGACTTCGCCCAGGCTC,0,472956
araBp,0.058823529411764705,16,16,TTGGAAATAACCGTGTAGGG,0,511549
araBp,0.058823529411764705,16,16,TTGAGGCCGACCTCCCCGGA,0,494341
araBp,0.058823529411764705,16,16,TTCTTTTTTTTCGGAGGATA,0,484951
araBp,0.058823529411764705,16,16,TTCTCGGGAGACATCAGCTA,0,496195
araBp,0.058823529411764705,16,16,TTCGTACGAGGTAGCCCCTA,0,472253
araBp,0.058823529411764705,16,16,TTCGATGTTAGCCACATATC,0,500399
araBp,0.058823529411764705,16,16,TTCCTCGCGGGTTGGCCCAT,0,510115
araBp,0.058823529411764705,16,16,TTCAGGGCTCCTAGTTATGG,0,485625
araBp,0.058823529411764705,16,16,TTAGGACCCATTGATACTAC,0,514642
araBp,0.058823529411764705,16,16,TTAATCTACTAAGCACAAGC,0,498691
araBp,0.058823529411764705,16,16,TTAAGGATCGGCAAACGACT,0,477178
araBp,0.058823529411764705,16,16,TTAAATATTGAACCTTCAGT,0,499666
araBp,0.058823529411764705,16,16,TGGTCCAAATTAGAACTTGG,0,492773
araBp,0.058823529411764705,16,16,TGGGTACTAACCGAGCCACC,0,471744
araBp,0.058823529411764705,16,16,TGGGCCAGATTATTGCGTGA,0,483386
araBp,0.058823529411764705,16,16,TGGCCGCTCATTGGGAATAG,0,517348
araBp,0.058823529411764705,16,16,TGGAAAATACAAGCCACGTT,0,498395
araBp,0.058823529411764705,16,16,TGCCTACACCGCGATGTTTT,0,502668
araBp,0.058823529411764705,16,16,TGCCCTGAATTGCGGAAGGA,0,520366
araBp,0.058823529411764705,16,16,TGCCACAACACCCTGTGGGG,0,484401
araBp,0.058823529411764705,16,16,TGATCAAAAGATGGGGTTAA,0,469290
araBp,0.058823529411764705,16,16,TGACGTAGCCACTTTTAGTA,0,468691
araBp,0.058823529411764705,16,16,TGAAGCTAGTGACGGGGCTT,0,482462
araBp,0.058823529411764705,16,16,TCGTAGGGAGCCACGGTCGC,0,473281
araBp,0.058823529411764705,16,16,TCGGTGGGCAATGATGGGGG,0,486328
araBp,0.058823529411764705,16,16,TCGGCAGCATACGCAATTGC,0,468490
araBp,0.058823529411764705,16,16,TCCCATTAAGCTTTCCGTTG,0,510803
araBp,0.058823529411764705,16,16,TCATCCGATCAGCGTAAGTC,0,486722
araBp,0.058823529411764705,16,16,TCAGTCACGAAAACCGCCCC,0,507807
araBp,0.058823529411764705,16,16,TATTTCACCAGGGTCGTTTG,0,490902
araBp,0.058823529411764705,16,16,TATGTCAGGCGAACATTTGT,0,506806
araBp,0.058823529411764705,16,16,TATCGAAGCTGGGATGGTAC,0,496387
araBp,0.058823529411764705,16,16,TAGGTTGATTCCTACCACTA,0,476061
araBp,0.058823529411764705,16,16,TAGGGGTTTCGCGTTCGTGA,0,473139
araBp,0.058823529411764705,16,16,TACAAGATAAAAGATTTCAT,0,497198
araBp,0.058823529411764705,16,16,TAAGGTTTTAAGTCGTCGAG,0,522191
araBp,0.058823529411764705,16,16,GTTGTCGCTGTGGTTCTGTG,0,477837
araBp,0.058823529411764705,16,16,GTGGTTGCGAATTTCCGCAG,0,489496
araBp,0.058823529411764705,16,16,GTGGGGTCACCTCTCGAATT,0,478652
araBp,0.058823529411764705,16,16,GTGGATTTCATCTAGCAGAC,0,503409
araBp,0.058823529411764705,16,16,GTCTATCGCATTGCGATCAT,0,478203
araBp,0.058823529411764705,16,16,GTCACGTTCTAACAGAAACC,0,491693
araBp,0.058823529411764705,16,16,GTCAACTACGACGAGGGGGG,0,521876
araBp,0.058823529411764705,16,16,GTATCAAGGAGTTTCGACGA,0,522406
araBp,0.058823529411764705,16,16,GTACAATCACATTCAAGAGC,0,489355
araBp,0.058823529411764705,16,16,GTAAGTTGCTGCAGAAGCGT,0,479721
araBp,0.058823529411764705,16,16,GTAACTCCCGCACAGGGTGT,0,521005
araBp,0.058823529411764705,16,16,GGTGGCATCCCCCGATGGAT,0,476422
araBp,0.058823529411764705,16,16,GGGTCTGACGAACAGCGGGT,0,506354
araBp,0.058823529411764705,16,16,GGGTCGGTAGGAATGGGAGG,0,499065
araBp,0.058823529411764705,16,16,GGGGTGGACTTGTTCTATCG,0,507566
araBp,0.058823529411764705,16,16,GGGGAGTTAACCACTCGTCA,0,485058
araBp,0.058823529411764705,16,16,GGGAGGCTATGCCGATCGGG,0,506356
araBp,0.058823529411764705,16,16,GGCAACCGACGAGATACTGA,0,515102
araBp,0.058823529411764705,16,16,GGCAACATCGTCTATCCACG,0,468570
araBp,0.058823529411764705,16,16,GGACAAAAGGGGCGAGTAAG,0,517992
araBp,0.058823529411764705,16,16,GGAAGCGTGTCGTTGTATCT,0,495623
araBp,0.058823529411764705,16,16,GGAACTCAAGGTATATCTTG,0,522559
araBp,0.058823529411764705,16,16,GCTTGGGCCATGCGTCGTCG,0,509867
araBp,0.058823529411764705,16,16,GCTCAGGTGGCTACCCGGAG,0,475783
araBp,0.058823529411764705,16,16,GCGTAAGTGCGGGACCCGCT,0,521316
araBp,0.058823529411764705,16,16,GCGCTAGTGCTTTAGTTAAT,0,480685
araBp,0.058823529411764705,16,16,GCGAATAATGCCTGTTGTGC,0,476508
araBp,0.058823529411764705,16,16,GCCTGGAAAGGCGACGTTAA,0,500767
araBp,0.058823529411764705,16,16,GCCGTGGCTGGTATGACGTG,0,516571
araBp,0.058823529411764705,16,16,GCATGGTGAACCCGACCTCC,0,523039
araBp,0.058823529411764705,16,16,GCATCTGTTCCCCATTCGTT,0,488998
araBp,0.058823529411764705,16,16,GATTTAGTGTCGTTTGTTGT,0,520507
araBp,0.058823529411764705,16,16,GATACCAATATACTCGTGAC,0,505556
araBp,0.058823529411764705,16,16,GAGTGATTATAAAGCCCTAC,0,474166
araBp,0.058823529411764705,16,16,GAGTCAATGCCTAACGGGAA,0,520488
araBp,0.058823529411764705,16,16,GAGCAGCGCATTACGCAGGT,0,511643
araBp,0.058823529411764705,16,16,GAGAGGGTTCTAGCCCCGAG,0,474365
araBp,0.058823529411764705,16,16,GACGGGCTCAAAGTGAAGAG,0,513771
araBp,0.058823529411764705,16,16,GACCCAATTCAGACGAGCGA,0,520662
araBp,0.058823529411764705,16,16,GAACCACAGTCGCGGTATAT,0,492014
araBp,0.058823529411764705,16,16,CTTGTAAGTTCCGGCGATCA,0,501411
araBp,0.058823529411764705,16,16,CTTCAATGGTAGTGGATATC,0,496501
araBp,0.058823529411764705,16,16,CTGGTCGTGGAACCTAACTA,0,525043
araBp,0.058823529411764705,16,16,CTGGGGTCTGATAGAATGTC,0,512368
araBp,0.058823529411764705,16,16,CTGGGCACTTACCGCTTTTT,0,483639
araBp,0.058823529411764705,16,16,CTGGCAGAATGGCGTAGGGT,0,487581
araBp,0.058823529411764705,16,16,CTCCTACGTGTGTAATGGTT,0,491727
araBp,0.058823529411764705,16,16,CTCCGCAAGGGTTAGGTTGT,0,497151
araBp,0.058823529411764705,16,16,CTCCCGAGTTATGCAGGACA,0,474017
araBp,0.058823529411764705,16,16,CGTGGCACATCTGTGCTATC,0,504124
araBp,0.058823529411764705,16,16,CGTGAAGTCACTAGCGCGCA,0,488028
araBp,0.058823529411764705,16,16,CGTAGGTGCCCGGGGCAATG,0,469323
araBp,0.058823529411764705,16,16,CGGTTTACGAGCGACCCGTG,0,525023
araBp,0.058823529411764705,16,16,CGGTGAAAAGCCTGATCAAA,0,516175
araBp,0.058823529411764705,16,16,CGGGGACATTAATGGTCGCA,0,483521
araBp,0.058823529411764705,16,16,CGGGCTGGGCTGTGCTCGGA,0,469492
araBp,0.058823529411764705,16,16,CGGGACGATGAACTATACTC,0,519407
araBp,0.058823529411764705,16,16,CGGAAGTGGACTTCGGGTCT,0,488722
araBp,0.058823529411764705,16,16,CGATTGGCCCCGTGAACACA,0,499084
araBp,0.058823529411764705,16,16,CCTTTGTCTGCGTCCTTTTC,0,516510
araBp,0.058823529411764705,16,16,CCTACCCGAAATAATGTATA,0,492102
araBp,0.058823529411764705,16,16,CCGGGGAGGAGCGTCCGTAA,0,513172
araBp,0.058823529411764705,16,16,CCGGCCCGTTCCAAGACTAA,0,500557
araBp,0.058823529411764705,16,16,CCGGAAGTACAATTTCTCTC,0,494057
araBp,0.058823529411764705,16,16,CCGACGGGGCCAAACGGAGG,0,499046
araBp,0.058823529411764705,16,16,CCGAAGCTAGGGCAGTATTA,0,497577
araBp,0.058823529411764705,16,16,CCCTGAGTTGGCGGATTATG,0,497154
araBp,0.058823529411764705,16,16,CCCATCAGACCCTTGCGTCA,0,482955
araBp,0.058823529411764705,16,16,CCATTCCGTCTCGGGTCCTA,0,484463
araBp,0.058823529411764705,16,16,CCAGGGATAATTCTCTCCTA,0,479622
araBp,0.058823529411764705,16,16,CATATTCTCTTACGCTGGAC,0,518636
araBp,0.058823529411764705,16,16,CAGGACCCATGTAGCAGTAT,0,491571
araBp,0.058823529411764705,16,16,CACGCCTTGGGATCCGGCAG,0,474831
araBp,0.058823529411764705,16,16,CACAACATTCACCACGCATG,0,515790
araBp,0.058823529411764705,16,16,CAATTGGCTGATAGTCAAGT,0,518511
araBp,0.058823529411764705,16,16,CAATTCTAGACCACTGGATA,0,472243
araBp,0.058823529411764705,16,16,CAAGCACCATAGAAGTGCTC,0,523804
araBp,0.058823529411764705,16,16,ATTTAACATCACCCCTATCG,0,473562
araBp,0.058823529411764705,16,16,ATTGGCCTTACGCAGCGTAA,0,476148
araBp,0.058823529411764705,16,16,ATGCCATCGTGGAGTCTACA,0,477791
araBp,0.058823529411764705,16,16,ATCGCCCTGGATTGGCGTGG,0,494284
araBp,0.058823529411764705,16,16,ATATGGAAAAACATAAACAG,0,515740
araBp,0.058823529411764705,16,16,ATAGCGCCAGTTGCCTCCTG,0,468146
araBp,0.058823529411764705,16,16,ATACTCGTATAACGGAGATT,0,472722
araBp,0.058823529411764705,16,16,AGTGTCTAGTCGTGGCTATC,0,486944
araBp,0.058823529411764705,16,16,AGTAGACAAGGCAACAATTA,0,491669
araBp,0.058823529411764705,16,16,AGGTCCGCCAATGTGCAGGC,0,486206
araBp,0.058823529411764705,16,16,AGGTAAATTGGGGAAGGATA,0,522832
araBp,0.058823529411764705,16,16,AGGTAAAACTGTTCTAGGCT,0,486976
araBp,0.058823529411764705,16,16,AGGGTCAAAGACGCGTGGAT,0,517998
araBp,0.058823529411764705,16,16,AGGCTGACGAGGTCGGATGG,0,479660
araBp,0.058823529411764705,16,16,AGGCTCGCAAGCCCAGTATC,0,507438
araBp,0.058823529411764705,16,16,AGGAACGGGAGACACGTGAA,0,520011
araBp,0.058823529411764705,16,16,AGCTCCTGGCACAACCAGTA,0,505982
araBp,0.058823529411764705,16,16,AGCGGCTGATCTGTAATTTT,0,468191
araBp,0.058823529411764705,16,16,ACTGTGCGTCGGCCCTGACC,0,468124
araBp,0.058823529411764705,16,16,ACTCCCGGGCTAGGTTTGAT,0,490019
araBp,0.058823529411764705,16,16,ACGTTTTCAGCGTCCTCTAC,0,523433
araBp,0.058823529411764705,16,16,ACGTAGAACCCATCGCGTAT,0,522219
araBp,0.058823529411764705,16,16,ACGGGTCGGCCATCTAGCGC,0,497929
araBp,0.058823529411764705,16,16,ACGCGCAACCGTGGTTCACA,0,507364
araBp,0.058823529411764705,16,16,ACCTAAGGCACGATAAAACA,0,483032
araBp,0.058823529411764705,16,16,ACCAAAAGTCTAATCCGGTT,0,520731
araBp,0.058823529411764705,16,16,ACACGGTTCACATGTATCCA,0,494757
araBp,0.058823529411764705,16,16,AATTTCCGCGTGACCTATCT,0,499715
araBp,0.058823529411764705,16,16,AATAGTGGAAAAGAATTAAT,0,481169
araBp,0.058823529411764705,16,16,AAGGGTGCGGCACGCTACAA,0,498799
araBp,0.058823529411764705,16,16,AACTCTGGACACTATGATAG,0,507207
araBp,0.058823529411764705,16,16,AACGTCAGCCACATTGCTGC,0,482099
araBp,0.058823529411764705,16,16,AACCTTCCCTAGATCTGAGT,0,509555
araBp,0.058823529411764705,16,16,AACCCTCAGGCCTGTCCAGT,0,497076
araBp,0.058823529411764705,16,16,AAACGTGTAACTGGGACTCT,0,512025
araBp,0.058823529411764705,16,16,AAACGCCCAATTTACGCGAC,0,522638
araBp,0.058823529411764705,16,16,AAAATTGAACTATTTAGTTA,0,502385
araBp,0.0625,15,15,TTTTGTCTTTTCGATATCCC,0,481833
araBp,0.0625,15,15,TTTTGGGCATCCGACGGCCA,0,479497
araBp,0.0625,15,15,TTTCATCCTATGTCTTTAAA,0,522196
araBp,0.0625,15,15,TTTCACATTACTCTACAGGA,0,482780
araBp,0.0625,15,15,TTGGGTACTAGACTCAGTTA,0,518008
araBp,0.0625,15,15,TTGCTGTGATACCTGACTAG,0,498506
araBp,0.0625,15,15,TTGCATAGATTGCTAGTAGT,0,500580
araBp,0.0625,15,15,TTGCAGGACACAAAGATTTT,0,492180
araBp,0.0625,15,15,TTGATGATTTGAATCTGTTA,0,483744
araBp,0.0625,15,15,TTGACTGGTACGACTTGCTA,0,484008
araBp,0.0625,15,15,TTCTGACTTCGGAAGCCACC,0,479832
araBp,0.0625,15,15,TTCGATAACACGTAAGGGAT,0,499507
araBp,0.0625,15,15,TTCATATGCGATTTGGATGA,0,501762
araBp,0.0625,15,15,TTCAGGCGTTGCGATTGTTT,0,492593
araBp,0.0625,15,15,TTCACGAGCTATGGGGCCGG,0,477134
araBp,0.0625,15,15,TTAATCTTTTTATTTCACGC,0,487533
araBp,0.0625,15,15,TGTTCAAATCAATGGCAAAT,0,497025
araBp,0.0625,15,15,TGTTAAGGATCACGTCAGTA,0,496488
araBp,0.0625,15,15,TGTGAAATGTTATTAATTGA,0,500771
araBp,0.0625,15,15,TGTAATCGATAGAGAATTTT,0,511214
araBp,0.0625,15,15,TGGTAAGGTACAGCCCGGAT,0,517541
araBp,0.0625,15,15,TGGATGTTATAATGGAAGTT,0,507590
araBp,0.0625,15,15,TGGAGCTTTCAGATCGTAGA,0,517146
araBp,0.0625,15,15,TGCACGCCGCGCTTCGCGAA,0,487133
araBp,0.0625,15,15,TGACTGCCAGAGAATAACTT,0,507729
araBp,0.0625,15,15,TGACATCAGCTTTATGCACG,0,471349
araBp,0.0625,15,15,TCTTGCGAATGTCCCGGTTC,0,482948
araBp,0.0625,15,15,TCTATCCAAATTGCGGCTCA,0,492973
araBp,0.0625,15,15,TCGTCTGCAAGTATACTGCC,0,491353
araBp,0.0625,15,15,TCGGGTGCACGTAACCGGGC,0,486996
araBp,0.0625,15,15,TCGGCATCTTGAAGCAAGGA,0,498030
araBp,0.0625,15,15,TCGCAACGGCGTAGGCGAAG,0,490981
araBp,0.0625,15,15,TCGATCTTTTCATTTGATTG,0,476258
araBp,0.0625,15,15,TCCCTTAGAGTTTAGCGAGA,0,508172
araBp,0.0625,15,15,TCCCTGGGGGGTCACGGCGC,0,475451
araBp,0.0625,15,15,TCACGATTAGTGATAGTAAA,0,489529
araBp,0.0625,15,15,TCAATTCGATTCAACTGCAT,0,469125
araBp,0.0625,15,15,TATTATCCAAGCCATATTCA,0,487520
araBp,0.0625,15,15,TATGATGTGGTGAAACTATG,0,515705
araBp,0.0625,15,15,TATCTGGGTCCCGATCTAAC,0,475940
araBp,0.0625,15,15,TAGGTATTTGACGGCGCTTA,0,491332
araBp,0.0625,15,15,TAGAGCACGTAGGTTTGATA,0,519298
araBp,0.0625,15,15,TACTTAAACCAGGGCTTCAT,0,483714
araBp,0.0625,15,15,TACGCATTACGCGCCCAAGG,0,484785
araBp,0.0625,15,15,TAAATGTCGCAAACGGATGT,0,502319
araBp,0.0625,15,15,TAAAGTTCCCTTTGCCCGAC,0,507736
araBp,0.0625,15,15,GTTTTGCAATAACGCAGTAG,0,517625
araBp,0.0625,15,15,GTTGTGACGGGGACACCGGT,0,520843
araBp,0.0625,15,15,GTTGCGTCAAGGGGGCGGAA,0,510668
araBp,0.0625,15,15,GTGTGCCCCTGCTCTTCGTG,0,479743
araBp,0.0625,15,15,GTGTCCATTAGGTTGCGTCG,0,510512
araBp,0.0625,15,15,GTGACCTACCGTCCCCGCCC,0,468425
araBp,0.0625,15,15,GTGACAACCTACTTTACGTA,0,491921
araBp,0.0625,15,15,GTCTGCATATGAATGTTGTT,0,506282
araBp,0.0625,15,15,GTCTCTTCGGCTGTGTCTTA,0,480286
araBp,0.0625,15,15,GTCCTGCTTCCGAGGCCACT,0,508318
araBp,0.0625,15,15,GTATTGTTCATTAAGAAGCA,0,468699
araBp,0.0625,15,15,GTATCATAGTCTAGCTAGCG,0,508468
araBp,0.0625,15,15,GTAGCTCCTAAATGGAAAAA,0,498269
araBp,0.0625,15,15,GTACAGCTAGCCCCCCGCAT,0,521435
araBp,0.0625,15,15,GGTTGCAACGATGTCTATAA,0,521016
araBp,0.0625,15,15,GGTGGACGCGTATACCGGTA,0,493989
araBp,0.0625,15,15,GGTCTAATGCAGTAAACGCT,0,497074
araBp,0.0625,15,15,GGGGTGCATCTTCTCAGTCC,0,517187
araBp,0.0625,15,15,GGGGACGCATTGAGGGACCA,0,485511
araBp,0.0625,15,15,GGGCAAAAGAAAGAGACCTA,0,513269
araBp,0.0625,15,15,GGCTCTCACCCTGTATGATG,0,501824
araBp,0.0625,15,15,GGCCGTAGGAACGGATACCC,0,487190
araBp,0.0625,15,15,GGCCCTGTGGAAGCGGCAAA,0,493951
araBp,0.0625,15,15,GGCATAGCCAATAGTTCTTA,0,469292
araBp,0.0625,15,15,GGCACCGCCGTCAACCTGAG,0,489296
araBp,0.0625,15,15,GGAGGCGGTGTTCCGGTTTC,0,508978
araBp,0.0625,15,15,GGAAGTCATAACTGTACCGC,0,504733
araBp,0.0625,15,15,GCTTAAACAGCGTGTATTAT,0,490299
araBp,0.0625,15,15,GCTGACCCTGGGATAAAGTA,0,479003
araBp,0.0625,15,15,GCTCCGCTGGATACGGCGGA,0,511556
araBp,0.0625,15,15,GCTACGGACTCTGGGGCCGA,0,498329
araBp,0.0625,15,15,GCGGACTACTTGCTCTCGAA,0,477835
araBp,0.0625,15,15,GCCGTGGGGAACCGCTTTGA,0,523204
araBp,0.0625,15,15,GCCAAGTCTGTGCTCGCAAA,0,482419
araBp,0.0625,15,15,GCCAACACGCCTCGTTAACA,0,475527
araBp,0.0625,15,15,GCACCTAACTACGGGTCTTA,0,488733
araBp,0.0625,15,15,GATGACTGGCTAATCACAGG,0,477043
araBp,0.0625,15,15,GAGGGAGCTTCTCGCTCCCT,0,503699
araBp,0.0625,15,15,GACGAATGACCTGTTGGGCT,0,500608
araBp,0.0625,15,15,GACACGTCGATACCTAAGAT,0,485857
araBp,0.0625,15,15,GAAGGTTTAGCTACGCGGAT,0,481032
araBp,0.0625,15,15,GAACTGTTTCCTCACGCATC,0,503247
araBp,0.0625,15,15,CTTTGAACGTATTCAACACT,0,478211
araBp,0.0625,15,15,CTTTAAGGCGACATCCGTAG,0,494001
araBp,0.0625,15,15,CTTGGTGAAAGGGATAGTAT,0,469916
araBp,0.0625,15,15,CTTAGATGGCAGCGTAGGTG,0,500526
araBp,0.0625,15,15,CTGCCTACCCCGGGGGTATT,0,503568
araBp,0.0625,15,15,CTGCCCCTGACACAGGTACA,0,472688
araBp,0.0625,15,15,CTCGTATACTACTAGCCGGT,0,525460
araBp,0.0625,15,15,CTAGACAGGGGGTAGTCGAG,0,501750
araBp,0.0625,15,15,CGTGGCTCCTTTGGCTGGAC,0,504625
araBp,0.0625,15,15,CGTGCCGCAAGTATTTGATC,0,493198
araBp,0.0625,15,15,CGGTAACGTGTCTACACCGA,0,523857
araBp,0.0625,15,15,CGGGACCACCATCTTCTCAA,0,480320
araBp,0.0625,15,15,CGGAGGAGGATGCATTGTCA,0,483097
araBp,0.0625,15,15,CGCGCTCGGATGTAGCGCAG,0,513956
araBp,0.0625,15,15,CGCGAAGCGGACAGGGTTGG,0,474419
araBp,0.0625,15,15,CGCCTAAGGGTGTTTGGCTA,0,485186
araBp,0.0625,15,15,CGCAGCGATGCTGGAAGTTC,0,476716
araBp,0.0625,15,15,CGAGTGGACAGTCGAAAAAG,0,480100
araBp,0.0625,15,15,CGAGAATAGATGAAGGGAAA,0,521529
araBp,0.0625,15,15,CCTAAAAATTTAAATACTGA,0,476745
araBp,0.0625,15,15,CCCTTCCTGGACGAGCCCAT,0,523231
araBp,0.0625,15,15,CCCTTCCTAGGGCCTAATTA,0,494763
araBp,0.0625,15,15,CCCTGGAATCATTTGCCACA,0,484061
araBp,0.0625,15,15,CCCGGCTTATCAAGGGCCAT,0,489360
araBp,0.0625,15,15,CCCCGTGCCTGCGGATTCAT,0,505898
araBp,0.0625,15,15,CCCCGGCTCTTCCCACAGCC,0,483531
araBp,0.0625,15,15,CCCCATAAGAGTTAGACGTG,0,513158
araBp,0.0625,15,15,CCCATACCCGCGCTGACTCA,0,494796
araBp,0.0625,15,15,CCAGTTATGGCACCCCGCGT,0,499470
araBp,0.0625,15,15,CCAGAGCTAATGTATTCATC,0,500366
araBp,0.0625,15,15,CATTCAGCAGGCAGGTAGAG,0,485453
araBp,0.0625,15,15,CATTATGTACGGACGGGGTT,0,476517
araBp,0.0625,15,15,CATATCATGTAACCAAGTTA,0,480687
araBp,0.0625,15,15,CAGTTTTCTTCGTAATCCAG,0,490410
araBp,0.0625,15,15,CAGTTAGTCCACTAGCTCGA,0,506810
araBp,0.0625,15,15,CAGTCTCCATGGTATGAATA,0,517282
araBp,0.0625,15,15,CAGCGTGACTGGGTGACCAA,0,512284
araBp,0.0625,15,15,CAGCAGGCGTAAGCCTTCGA,0,493174
araBp,0.0625,15,15,CAGATACTTCACCCCGGCAG,0,485634
araBp,0.0625,15,15,CAGACGGGCGGAAAAAGACA,0,485965
araBp,0.0625,15,15,CACTGTTTTAACGTCCGACC,0,514083
araBp,0.0625,15,15,CACGCGGAACCGTTTGTTAA,0,492003
araBp,0.0625,15,15,CACCGACAGCGGTGTTGTGG,0,506940
araBp,0.0625,15,15,CACCCTACTAAAGTCGGAAT,0,487712
araBp,0.0625,15,15,CAAGGAGGAAGAGTTGAGGA,0,500001
araBp,0.0625,15,15,CAAAGAAGCACACGCCAGTA,0,479746
araBp,0.0625,15,15,ATTTTTTAGGAACTCTAGGC,0,479178
araBp,0.0625,15,15,ATTTACAGGGCTGGAGCGCT,0,470697
araBp,0.0625,15,15,ATTGTTTTCAGCCGCTCCGA,0,486985
araBp,0.0625,15,15,ATGTTGTCATTTGAAAGCGA,0,503264
araBp,0.0625,15,15,ATGTATATGACCTATAACTG,0,471772
araBp,0.0625,15,15,ATGCAGAGCCATACAACAGA,0,517636
araBp,0.0625,15,15,ATCACACCCTCCCGGGGGCT,0,508727
araBp,0.0625,15,15,ATACTAAACCGAAACATGAG,0,480314
araBp,0.0625,15,15,AGTTGAAGGAATGAATAACT,0,491336
araBp,0.0625,15,15,AGTGTGGGCAACGATCTTTA,0,490434
araBp,0.0625,15,15,AGTGTCCGGTATACAGGGGT,0,510782
araBp,0.0625,15,15,AGTCCGAAAGGTATACAGGA,0,489541
araBp,0.0625,15,15,AGTAACTACGGCACAGGCGC,0,468372
araBp,0.0625,15,15,AGGTCGCAGGCCACTGTATC,0,479868
araBp,0.0625,15,15,AGGTCAGTCGCTTTTCCATC,0,498939
araBp,0.0625,15,15,AGGGTGCTCCGTGGGCTTCA,0,525408
araBp,0.0625,15,15,AGGGTCACGCCCCGAAGCAA,0,476516
araBp,0.0625,15,15,AGGGCGGTAGATGTGTGAGA,0,470058
araBp,0.0625,15,15,AGGGACGACACCGGCGCTTT,0,490156
araBp,0.0625,15,15,AGCATTTGGTATGGGCTGCA,0,513629
araBp,0.0625,15,15,AGACAAGGAATTCAATTATG,0,470318
araBp,0.0625,15,15,ACTTCTAAGGCGGAACTCGT,0,483579
araBp,0.0625,15,15,ACTGGAACTCTCCATGCGCG,0,469146
araBp,0.0625,15,15,ACTACCCTGTAAGTTCGGGA,0,469397
araBp,0.0625,15,15,ACGTACCCATAAGAGGGTTT,0,488571
araBp,0.0625,15,15,ACGGGTTTCGGTTGATTGCA,0,501556
araBp,0.0625,15,15,ACGCATTTGGCTGACTGCAA,0,478602
araBp,0.0625,15,15,ACGCAGCGAGGCTTTCAGTA,0,478382
araBp,0.0625,15,15,ACGCACCTAATACGAAGAAA,0,493019
araBp,0.0625,15,15,ACGCAAAATGTTCACGGGCA,0,477257
araBp,0.0625,15,15,ACGACGGCCGCGTCTCGAAC,0,491582
araBp,0.0625,15,15,ACCTTCTTTGATTGGGTCCT,0,488605
araBp,0.0625,15,15,ACCTCAAATCGCTCAATGTT,0,499974
araBp,0.0625,15,15,ACCATTCAGGTGCCACCAGA,0,476153
araBp,0.0625,15,15,ACCAGGCGTATTTGGAATGA,0,512624
araBp,0.0625,15,15,ACATACGTGGGAGCTCGCCA,0,474848
araBp,0.0625,15,15,ACACTTACAAGGGGTCATAG,0,479338
araBp,0.0625,15,15,AATGTCACTAATACCTAAGT,0,488278
araBp,0.0625,15,15,AATGAACTGGCTTAATTTCA,0,511445
araBp,0.0625,15,15,AATACGTGTACCTCTATCTT,0,504415
araBp,0.0625,15,15,AAGGAATCGGACAACTTACT,0,473586
araBp,0.0625,15,15,AAGACAGAAAGCGCTTGGAT,0,472737
araBp,0.0625,15,15,AACTTAAGACGTGTCCTCTG,0,480394
araBp,0.0625,15,15,AACTACATCGGCACCACAAA,0,518289
araBp,0.0625,15,15,AACGTTGTTACCCCAGATCG,0,514158
araBp,0.0625,15,15,AACGTTAGAGTATGTCTCGA,0,485950
araBp,0.0625,15,15,AACGGTGGGTGTTACGCTGA,0,523332
araBp,0.0625,15,15,AACCGTGCGTGAGTTGAGGA,0,504478
araBp,0.0625,15,15,AACCGTGAGACTACCGGTTG,0,490451
araBp,0.0625,15,15,AACCCGGCGATGCTTCCGGA,0,512936
araBp,0.0625,15,15,AACACGCACATATTCGGAGG,0,498271
araBp,0.0625,15,15,AAACACCCAACGTATATACT,0,489412
araBp,0.06666666666666667,14,14,TTTTGAGGTTACGCAGCAAA,0,496546
araBp,0.06666666666666667,14,14,TTTCCACGAGCCATCGAAAA,0,477752
araBp,0.06666666666666667,14,14,TTTCAGGCTTCTCTCAGTCA,0,498482
araBp,0.06666666666666667,14,14,TTTAGCATTTATTGGTAATA,0,507030
araBp,0.06666666666666667,14,14,TTGGTTGCATCTGGAGCGCA,0,479645
araBp,0.06666666666666667,14,14,TTGGGGATAGGCATCCTTCG,0,500389
araBp,0.06666666666666667,14,14,TTCGGGGTCAGTCACGCAAC,0,511239
araBp,0.06666666666666667,14,14,TTCGGCGGAAGCGATTGAGA,0,500398
araBp,0.06666666666666667,14,14,TTAGTGTCGGGGAGCACCGT,0,505376
araBp,0.06666666666666667,14,14,TGTTCGATTGCTAGAGGGAC,0,503254
araBp,0.06666666666666667,14,14,TGCCGACCGACTCTAGCGCG,0,517274
araBp,0.06666666666666667,14,14,TGCCCTTAAAACAATATTGG,0,524846
araBp,0.06666666666666667,14,14,TGCAGCCTGTGTACTGGTCA,0,469888
araBp,0.06666666666666667,14,14,TGATGTATGTGTCAATGGAA,0,506833
araBp,0.06666666666666667,14,14,TGAGGCTCAGTATGGCGACT,0,492332
araBp,0.06666666666666667,14,14,TGAGAAACCCCCACGAGGTT,0,514979
araBp,0.06666666666666667,14,14,TCTTAGAAGGACGCAAGACT,0,499802
araBp,0.06666666666666667,14,14,TCTCCGGGTTGGCTTATCCT,0,521588
araBp,0.06666666666666667,14,14,TCGGGTATTGTATACGCTTA,0,517374
araBp,0.06666666666666667,14,14,TCGGGGAGCTTAGCCGTATT,0,515717
araBp,0.06666666666666667,14,14,TCGCCAGGAAAGTCGGCGTG,0,470375
araBp,0.06666666666666667,14,14,TCCGTCGGTTCACGTCACAT,0,511605
araBp,0.06666666666666667,14,14,TCCCGGTTAGACGCTGTGCC,0,488192
araBp,0.06666666666666667,14,14,TCCCAAGATGGGTATTTTGG,0,476970
araBp,0.06666666666666667,14,14,TCCATACGCATACCTCACAT,0,471705
araBp,0.06666666666666667,14,14,TCATCCATCTAGTTTTCCTT,0,477792
araBp,0.06666666666666667,14,14,TCATATGTCAGTGGAGTTGT,0,517518
araBp,0.06666666666666667,14,14,TCACGTAATAGACTTGAAGA,0,505613
araBp,0.06666666666666667,14,14,TCACCAATGGTCCTACTGTT,0,489662
araBp,0.06666666666666667,14,14,TATTTGGGGCACAAGGCAGG,0,518758
araBp,0.06666666666666667,14,14,TATGGTTCTAGGGGATTCAA,0,471825
araBp,0.06666666666666667,14,14,TAGAATTAGCCGGACCGGGG,0,467950
araBp,0.06666666666666667,14,14,TAGAATCGAAACGTGGAGGG,0,492721
araBp,0.06666666666666667,14,14,TACTTTAAACAGTAGGGTCA,0,482415
araBp,0.06666666666666667,14,14,TACGAGGTGGGGTTCTCAAA,0,513243
araBp,0.06666666666666667,14,14,TACATATAGAGCCACAGGGT,0,501418
araBp,0.06666666666666667,14,14,TAATAGGTCTGTGCAGCTGT,0,486721
araBp,0.06666666666666667,14,14,TAACCCTAGTCACTACCAGG,0,514721
araBp,0.06666666666666667,14,14,GTTTTTGAATCAGACACGTA,0,481244
araBp,0.06666666666666667,14,14,GTTCGCATTCCGGCGCCGTT,0,493635
araBp,0.06666666666666667,14,14,GTTCGCATTCCCGTATTCAG,0,497572
araBp,0.06666666666666667,14,14,GTTCGACAACGCTGGAGCAA,0,499785
araBp,0.06666666666666667,14,14,GTTCCTATGTCTTCAACGTC,0,502711
araBp,0.06666666666666667,14,14,GTTCCGAGTTTGTTAGAGTG,0,496280
araBp,0.06666666666666667,14,14,GTGGCCGCAGTGTCTACAAC,0,471565
araBp,0.06666666666666667,14,14,GTGCTGGAGCGTGTCTGTAG,0,472667
araBp,0.06666666666666667,14,14,GTCCCTAGACCACATGCCTA,0,502483
araBp,0.06666666666666667,14,14,GTATGTACCGGCGTGTGACG,0,478562
araBp,0.06666666666666667,14,14,GTAGTAGCCGGGCTAGGGAA,0,487724
araBp,0.06666666666666667,14,14,GTAGCAGTCGGTCTACGTGC,0,506555
araBp,0.06666666666666667,14,14,GTAATAGCCCGCGGTCCCGT,0,488189
araBp,0.06666666666666667,14,14,GGTTTCGGCGCTCACCGAAG,0,492865
araBp,0.06666666666666667,14,14,GGTTGATCAGGGCGGAGTCA,0,493674
araBp,0.06666666666666667,14,14,GGTGCTTGGGGCGTATACTC,0,470866
araBp,0.06666666666666667,14,14,GGTACGCCTACAACAGCCTC,0,504012
araBp,0.06666666666666667,14,14,GGGGGAAGGACAGTCAATGG,0,517957
araBp,0.06666666666666667,14,14,GGGATAGCCCGGACACTGAA,0,521888
araBp,0.06666666666666667,14,14,GGGAAGGTCACAGAGATTGA,0,472061
araBp,0.06666666666666667,14,14,GGCCGAGCGAGGGCGCAATC,0,498505
araBp,0.06666666666666667,14,14,GGATGATCTGACGGGAAAGG,0,475123
araBp,0.06666666666666667,14,14,GGAGCCGTCACAAGTGGCAG,0,499984
araBp,0.06666666666666667,14,14,GGAAGCGTTTACAGCAGCAA,0,510085
araBp,0.06666666666666667,14,14,GCTTTTCTACCTTAATTCGC,0,487855
araBp,0.06666666666666667,14,14,GCTTAGAGTCATTCGCAGCA,0,480624
araBp,0.06666666666666667,14,14,GCTGCATACCTATGAATGTT,0,470531
araBp,0.06666666666666667,14,14,GCTGATGCTTCCCTGCCGGT,0,516651
araBp,0.06666666666666667,14,14,GCTCGCTGGGAAGCAAAGTA,0,487339
araBp,0.06666666666666667,14,14,GCTAGGGCACAGCCACTCGG,0,475971
araBp,0.06666666666666667,14,14,GCGGGCCGACACATTATCCA,0,475366
araBp,0.06666666666666667,14,14,GCGGGAGTTTAGCGCAGTTT,0,485900
araBp,0.06666666666666667,14,14,GCATCCTGATTTTTGGTTTA,0,486156
araBp,0.06666666666666667,14,14,GCATAGTGTAACTATGACTT,0,483820
araBp,0.06666666666666667,14,14,GCATAATTAGAGATAGCTTA,0,498808
araBp,0.06666666666666667,14,14,GCAGCGAGGCGCAATGTCGC,0,523334
araBp,0.06666666666666667,14,14,GCACTGGCCATCGATGGTTA,0,512515
araBp,0.06666666666666667,14,14,GCACTGGCAAATGAGCGACG,0,504828
araBp,0.06666666666666667,14,14,GCACTGATACGATGCATAAG,0,499598
araBp,0.06666666666666667,14,14,GCACCAGGGTAAAGCCGTCT,0,502957
araBp,0.06666666666666667,14,14,GATTAAGGAAGCCGGACGCG,0,495225
araBp,0.06666666666666667,14,14,GATCCATTGCAGTGTTACAC,0,522966
araBp,0.06666666666666667,14,14,GATCAAACATCGGGGTCGGA,0,498352
araBp,0.06666666666666667,14,14,GATAGTCTTTATGTAGAAGG,0,503816
araBp,0.06666666666666667,14,14,GACTTAACCCATAGTGGCGA,0,510633
araBp,0.06666666666666667,14,14,GACGATTGGCGCATCTTGAA,0,474811
araBp,0.06666666666666667,14,14,GAACCACAGTGTCAGTGTTC,0,514628
araBp,0.06666666666666667,14,14,GAAATGCTAGTGGTGATAGG,0,500039
araBp,0.06666666666666667,14,14,GAAAGCTGCATGCCATGGCT,0,496174
araBp,0.06666666666666667,14,14,CTTGGTAGCGGACCCGGTAA,0,517650
araBp,0.06666666666666667,14,14,CTTCGGGGCAAGTAGGTACT,0,476238
araBp,0.06666666666666667,14,14,CTTACCAAGTTCTCAATGAG,0,524781
araBp,0.06666666666666667,14,14,CTGGGGCGTGCAACGGAATG,0,471771
araBp,0.06666666666666667,14,14,CTCTAAGTCTGTTACCGCTC,0,500485
araBp,0.06666666666666667,14,14,CTATCACAGATTTGCTACAA,0,490949
araBp,0.06666666666666667,14,14,CTACGAGAAATTTTGGAATG,0,498986
araBp,0.06666666666666667,14,14,CTAACGCGTAAATTGGCTCT,0,521739
araBp,0.06666666666666667,14,14,CGTGTGGTCAGTCCATTAGT,0,486920
araBp,0.06666666666666667,14,14,CGGTCAGGAACGCACCGATT,0,490717
araBp,0.06666666666666667,14,14,CGGTAGTTCTCTGCTGTATA,0,479088
araBp,0.06666666666666667,14,14,CGGTAAAAGTTCGCCGTCAT,0,523371
araBp,0.06666666666666667,14,14,CGGGTTTACAGTAATGCGTA,0,500183
araBp,0.06666666666666667,14,14,CGGGTGGGTTTCGCAAGCAA,0,496383
araBp,0.06666666666666667,14,14,CGGGTAGCGGACCCACGGTT,0,486112
araBp,0.06666666666666667,14,14,CGGCTGCCTATGTATTTGTT,0,467781
araBp,0.06666666666666667,14,14,CGGCATTCGTTTACGGCGTG,0,479691
araBp,0.06666666666666667,14,14,CGGAGATGGGAATCAAGACG,0,484808
araBp,0.06666666666666667,14,14,CGCTGCTATTGCCGCGGTTT,0,500659
araBp,0.06666666666666667,14,14,CGCGTAACGGGCTCAACATA,0,516674
araBp,0.06666666666666667,14,14,CGCAAGGAACGTCGCACGCA,0,474738
araBp,0.06666666666666667,14,14,CGAGTAATGTCATACCCTGA,0,517498
araBp,0.06666666666666667,14,14,CGACGACAAGGTCTTTAGGC,0,474732
araBp,0.06666666666666667,14,14,CGACAATTTTGTCAGGGCTA,0,474141
araBp,0.06666666666666667,14,14,CCTTCTCGATCGTAGAGTTT,0,512808
araBp,0.06666666666666667,14,14,CCTAGCGGCTCGAATCGGCT,0,479871
araBp,0.06666666666666667,14,14,CCTACGTAGAACGACGAGAA,0,514272
araBp,0.06666666666666667,14,14,CCGGGGGGTGTCGTTCCGCT,0,516320
araBp,0.06666666666666667,14,14,CCGGCGCACCTGTTGACCGA,0,496117
araBp,0.06666666666666667,14,14,CCGGATATGGTGGGGATAGA,0,487644
araBp,0.06666666666666667,14,14,CCGCCATGTTCGGACCCATG,0,485841
araBp,0.06666666666666667,14,14,CCGCAGAGCCAATAATTAAA,0,487948
araBp,0.06666666666666667,14,14,CCGCACTGGCTAGCTGCGCC,0,513188
araBp,0.06666666666666667,14,14,CCGAGTCTATCAGTACCCAC,0,472784
araBp,0.06666666666666667,14,14,CCGAGTATGGCGGCGACCCT,0,469879
araBp,0.06666666666666667,14,14,CCCCTATCCGACCCCACAGT,0,491959
araBp,0.06666666666666667,14,14,CCATTCTGCGGACTTGGTTC,0,503413
araBp,0.06666666666666667,14,14,CCACTATGGCCGATCGCACA,0,468770
araBp,0.06666666666666667,14,14,CCACTATCGGATCTTTGTAT,0,503389
araBp,0.06666666666666667,14,14,CCAAATATAACCAGATAGGG,0,506605
araBp,0.06666666666666667,14,14,CCAAAAGCTTGTAACTACTA,0,521613
araBp,0.06666666666666667,14,14,CATCCCTGGAATTTGGTGAT,0,507529
araBp,0.06666666666666667,14,14,CACGTTGACCGTCACACAGA,0,476481
araBp,0.06666666666666667,14,14,CACGCCCTTAGCTACTATTC,0,512688
araBp,0.06666666666666667,14,14,CACACGGGGTTTACAGGTTG,0,491483
araBp,0.06666666666666667,14,14,CACACCAATGAACTGGTGTA,0,516068
araBp,0.06666666666666667,14,14,CAATTTAGACTTCAGCAGGT,0,488321
araBp,0.06666666666666667,14,14,CAATACGGCATAGTTTGAAT,0,494753
araBp,0.06666666666666667,14,14,CAAGGTGCTCACCGACCCTA,0,475376
araBp,0.06666666666666667,14,14,CAAGGCACCACCGCCATCAT,0,520237
araBp,0.06666666666666667,14,14,CAAGCTATTGCTGAACCATG,0,470187
araBp,0.06666666666666667,14,14,CAACTCGTGGTCCGTGAATC,0,517765
araBp,0.06666666666666667,14,14,CAACCTGAATCATGGGTGCG,0,491435
araBp,0.06666666666666667,14,14,CAACAATCAGAAAAATAATC,0,498585
araBp,0.06666666666666667,14,14,ATTTATACTGGACGGTGGAT,0,488329
araBp,0.06666666666666667,14,14,ATTGGTAGAATCCCAGTCCT,0,520279
araBp,0.06666666666666667,14,14,ATTGGTAAGCCTTGAGCGAG,0,499173
araBp,0.06666666666666667,14,14,ATTGAAGGGAATCAATACTG,0,490553
araBp,0.06666666666666667,14,14,ATTCGGATAAGCATAATAGG,0,470597
araBp,0.06666666666666667,14,14,ATGTACTGTACGGGGCAGAT,0,504827
araBp,0.06666666666666667,14,14,ATGGTAGTCTTTCATCTTTC,0,469820
araBp,0.06666666666666667,14,14,ATGATTTGCCCCGATTGAAC,0,502395
araBp,0.06666666666666667,14,14,ATGATGGTCATAGGATTATT,0,510418
araBp,0.06666666666666667,14,14,ATGATGGACTACTCGGGCCT,0,475946
araBp,0.06666666666666667,14,14,ATCCGAGCGAGGGCTTATTT,0,501333
araBp,0.06666666666666667,14,14,ATATAGCGCCAAGGGCGCCA,0,522362
araBp,0.06666666666666667,14,14,ATACCCATATGATGAGGTTG,0,482953
araBp,0.06666666666666667,14,14,ATACCACTCGCACGTCAGCA,0,499350
araBp,0.06666666666666667,14,14,ATAAAAAGGACGGGTGACCA,0,515738
araBp,0.06666666666666667,14,14,AGTACGGCCATCACGGTTTC,0,509977
araBp,0.06666666666666667,14,14,AGGTAGACACGCTTATTACA,0,486647
araBp,0.06666666666666667,14,14,AGGGTGACTGGCTTCATGCT,0,479136
araBp,0.06666666666666667,14,14,AGGCTTCATGCTAACTCTGG,0,518466
araBp,0.06666666666666667,14,14,AGGACCTTTGTGACCATACT,0,510318
araBp,0.06666666666666667,14,14,AGCTAGTCTAGGCGGTTTCG,0,515363
araBp,0.06666666666666667,14,14,AGCCCAGGATGTAACCATAA,0,502174
araBp,0.06666666666666667,14,14,AGCATGACATGTTAGGTGCA,0,491382
araBp,0.06666666666666667,14,14,AGCAGGCATGGGCTTTTAGT,0,484067
araBp,0.06666666666666667,14,14,AGCAGCATGTCTGCGCCAAA,0,484862
araBp,0.06666666666666667,14,14,AGAGCGGGGACGCAAAATTG,0,508598
araBp,0.06666666666666667,14,14,AGAAATGATGCCAGAAGAAT,0,488703
araBp,0.06666666666666667,14,14,ACTTCGACATCAGCGCCAGT,0,482630
araBp,0.06666666666666667,14,14,ACTGGAAGTTTGTATAACCG,0,506853
araBp,0.06666666666666667,14,14,ACTATGCGGTAGATACGGCA,0,511323
araBp,0.06666666666666667,14,14,ACGTAACGAAATTGATGGGT,0,513053
araBp,0.06666666666666667,14,14,ACGATTTTTGCACATTAGCC,0,505772
araBp,0.06666666666666667,14,14,ACCGGTTACTATCCTAGTTT,0,477587
araBp,0.06666666666666667,14,14,ACCCTAGTACTGATCAAGAT,0,480351
araBp,0.06666666666666667,14,14,ACCCATGGACATCACACACG,0,474965
araBp,0.06666666666666667,14,14,ACATTACTCACTCCGTCGAC,0,483145
araBp,0.06666666666666667,14,14,ACATTAATAAATCTACGCCT,0,518677
araBp,0.06666666666666667,14,14,ACAATTCAGCTCGGCATAGT,0,483966
araBp,0.06666666666666667,14,14,AATTACGCGTGCATGGGGTT,0,499887
araBp,0.06666666666666667,14,14,AATGGAGGGATGTGGATCAA,0,511562
araBp,0.06666666666666667,14,14,AATGCTCGTTTCCCGCGTAC,0,523921
araBp,0.06666666666666667,14,14,AATCTTGTTATTGTGCCCGC,0,490963
araBp,0.06666666666666667,14,14,AATCTGCTAGTGGATCACTG,0,520181
araBp,0.06666666666666667,14,14,AATCCAACTATCTTATGTAC,0,511446
araBp,0.06666666666666667,14,14,AATATCTGTCGGCCCTGGGT,0,476808
araBp,0.06666666666666667,14,14,AAGGGTAAGGCACTTTCTTC,0,475056
araBp,0.06666666666666667,14,14,AAGCAGACTCAGTGGCCGAC,0,493724
araBp,0.06666666666666667,14,14,AAGAAGATGAATTCAATTGC,0,525493
araBp,0.06666666666666667,14,14,AAAGTACGATCGACCGTATT,0,471534
araBp,0.06666666666666667,14,14,AAACCGGGTACGGAACAGTC,0,486046
araBp,0.06666666666666667,14,14,AAAAATTGCGCTGGGAATAG,0,508987
araBp,0.07142857142857142,13,13,TTTTTCGATGCGGTAGCGTA,0,502927
araBp,0.07142857142857142,13,13,TTTTCTTGAACGCTTTGTAT,0,477958
araBp,0.07142857142857142,13,13,TTTATAAGAATAATGTTTAA,0,520396
araBp,0.07142857142857142,13,13,TTTAGCACTACGGACGGTGG,0,503166
araBp,0.07142857142857142,13,13,TTTAGACGTTAGACTGAACG,0,473418
araBp,0.07142857142857142,13,13,TTTACGCCTAACACAGCAGA,0,474239
araBp,0.07142857142857142,13,13,TTTAACTACGTACGTGGGTA,0,472170
araBp,0.07142857142857142,13,13,TTGCGCGGTTTCTATGTATA,0,474973
araBp,0.07142857142857142,13,13,TTGCCCTTGTAAGATATGGT,0,481194
araBp,0.07142857142857142,13,13,TTGACAGGAAGAAGTACAAG,0,499086
araBp,0.07142857142857142,13,13,TTCGCAGCGAACGGGCCAGG,0,506355
araBp,0.07142857142857142,13,13,TTCGATGGACGACCAAGATT,0,505382
araBp,0.07142857142857142,13,13,TTCAGACTCTGGCATCCCAG,0,473572
araBp,0.07142857142857142,13,13,TTAGCGGATTTCCTGTAGAT,0,516787
araBp,0.07142857142857142,13,13,TTACGGCCGGTACGTGGAAC,0,508316
araBp,0.07142857142857142,13,13,TGTTGGACAATGACAGAGAC,0,516522
araBp,0.07142857142857142,13,13,TGTGGGGGAGATATTCAGAT,0,490979
araBp,0.07142857142857142,13,13,TGTAAAGCAATTACCGACGC,0,468738
araBp,0.07142857142857142,13,13,TGGTTCAATTGGTGAAAGAT,0,500977
araBp,0.07142857142857142,13,13,TGGTGCAAATACAAGGTCCT,0,510483
araBp,0.07142857142857142,13,13,TGGTGAGGTCAACCCCAGAC,0,519467
araBp,0.07142857142857142,13,13,TGGCCCGGCGGAGCACCGCA,0,472597
araBp,0.07142857142857142,13,13,TGGATTCAGACAATCTCGTT,0,475543
araBp,0.07142857142857142,13,13,TGGAATGTTCTCAGCCCGGT,0,476736
araBp,0.07142857142857142,13,13,TGCTCTCAAACTAGAGATCA,0,486782
araBp,0.07142857142857142,13,13,TGCTCAACCTAAAGCCGGCC,0,487877
araBp,0.07142857142857142,13,13,TGCGCTAATAATTGTCGATC,0,503283
araBp,0.07142857142857142,13,13,TGCAGCCGAGTCCAGTATCG,0,480460
araBp,0.07142857142857142,13,13,TGCAATATGCCAAGACAATA,0,495982
araBp,0.07142857142857142,13,13,TGATTCTCTCTTAATTCTTA,0,474679
araBp,0.07142857142857142,13,13,TGATCCATTCGAAGGCACAT,0,491276
araBp,0.07142857142857142,13,13,TGAGACTGGATATAAGAGCT,0,525116
araBp,0.07142857142857142,13,13,TGACTTGGGGGCCTCAGGGT,0,479015
araBp,0.07142857142857142,13,13,TGACTTATCACGTGGTACTC,0,509300
araBp,0.07142857142857142,13,13,TCTTTGCCGTCGTAGTTACG,0,469817
araBp,0.07142857142857142,13,13,TCTACCTCACACGGAGTTGA,0,481734
araBp,0.07142857142857142,13,13,TCGCTCTATTGACTGGGCCA,0,516438
araBp,0.07142857142857142,13,13,TCGCACAAAAGGACGCGAAA,0,502238
araBp,0.07142857142857142,13,13,TCCGTTGAAATATCCTATCC,0,487235
araBp,0.07142857142857142,13,13,TCCGTGGAGTTGTTGTACCA,0,506373
araBp,0.07142857142857142,13,13,TCCGCGACAGCTTCGGGTAG,0,514444
araBp,0.07142857142857142,13,13,TCCCTCACTGCGCCTAATAC,0,492667
araBp,0.07142857142857142,13,13,TCCAAGTACCGAATGCGTAT,0,506134
araBp,0.07142857142857142,13,13,TCATCGGGCTCGGTGTCTCC,0,483348
araBp,0.07142857142857142,13,13,TCATCAAGTATACAATACAT,0,479769
araBp,0.07142857142857142,13,13,TAGTCCAGCGAACTCCGCTA,0,492855
araBp,0.07142857142857142,13,13,TAGGGTCCCGGAGGAGGATT,0,487468
araBp,0.07142857142857142,13,13,TAGACGTTTTATAAGTTACG,0,469818
araBp,0.07142857142857142,13,13,TACGTGGCAATCCACTAGGG,0,500002
araBp,0.07142857142857142,13,13,TACGGTGTTTGTCTGCCCAT,0,501298
araBp,0.07142857142857142,13,13,TACGAATGTAGTTGGTAGAA,0,508594
araBp,0.07142857142857142,13,13,TACCTTTACGGGATATGATA,0,475230
araBp,0.07142857142857142,13,13,TAAGTGAAGGGCGGCAATAA,0,492853
araBp,0.07142857142857142,13,13,TAAGGTATACGTAGTGCAAA,0,519036
araBp,0.07142857142857142,13,13,TAAGAGGACGCGCTGCCACC,0,508436
araBp,0.07142857142857142,13,13,TAAACAGGGCCTGAGGCTCA,0,485796
araBp,0.07142857142857142,13,13,GTTGACTGGTTTTGTACAAC,0,505016
araBp,0.07142857142857142,13,13,GTTCGATAAAGCTACTCGAC,0,483798
araBp,0.07142857142857142,13,13,GTGTGGCAGCACAATAGAGG,0,477059
araBp,0.07142857142857142,13,13,GTGGGGTAGGTGCCTATTTT,0,480322
araBp,0.07142857142857142,13,13,GTGGGGATGACGGAGGATTC,0,476738
araBp,0.07142857142857142,13,13,GTGGAATCGTTGCGACTTAA,0,489489
araBp,0.07142857142857142,13,13,GTGACTACGACTGACATTGC,0,500993
araBp,0.07142857142857142,13,13,GTGAAATGGACGCGCCTGAC,0,495622
araBp,0.07142857142857142,13,13,GTCTGTGCCTGTTGTCCAAT,0,507854
araBp,0.07142857142857142,13,13,GTACCTAGAGGTTTGTCAAT,0,493262
araBp,0.07142857142857142,13,13,GTACACGCGTAGTTACTCTA,0,482560
araBp,0.07142857142857142,13,13,GTAAATAGTTCTGCCTGACT,0,495270
araBp,0.07142857142857142,13,13,GGTTAAACCTAGTCTGAGTA,0,518830
araBp,0.07142857142857142,13,13,GGTGGGTTGCCTGTGCGTCA,0,498692
araBp,0.07142857142857142,13,13,GGTCCTGTGTCTTCTTTCGC,0,488574
araBp,0.07142857142857142,13,13,GGTACCTCACAACGGACAGT,0,494691
araBp,0.07142857142857142,13,13,GGGTTGACGGTCCGTATTCG,0,485910
araBp,0.07142857142857142,13,13,GGGTGGACGACAGTAAGTCG,0,520811
araBp,0.07142857142857142,13,13,GGGCTCGGAGAGGATGATTT,0,467860
araBp,0.07142857142857142,13,13,GGGCAGGATATGAGAGGAAC,0,497837
araBp,0.07142857142857142,13,13,GGCTACCAGTGCCTAATCAC,0,492980
araBp,0.07142857142857142,13,13,GGCGCACTTTATTAAGTCTG,0,511865
araBp,0.07142857142857142,13,13,GGCCCGCAACTTCAAAATTG,0,477088
araBp,0.07142857142857142,13,13,GGAGTGTACAGCCTGTCGCT,0,482094
araBp,0.07142857142857142,13,13,GGAGAAGTCATGCCCTGAAA,0,483223
araBp,0.07142857142857142,13,13,GCTTGCGAAGATGTGACCGA,0,498507
araBp,0.07142857142857142,13,13,GCTAAAGGCGTAGCTCCTCC,0,488583
araBp,0.07142857142857142,13,13,GCGTGTGCGGTGGAAGAGTT,0,485406
araBp,0.07142857142857142,13,13,GCGGCCGTGGGCGAGACCCA,0,519964
araBp,0.07142857142857142,13,13,GCGGCCCTCTAGGGTTGAGG,0,517016
araBp,0.07142857142857142,13,13,GCGCTCAACAGTAGTAATGG,0,484631
araBp,0.07142857142857142,13,13,GCGCATATCGTTGAACCTGT,0,515090
araBp,0.07142857142857142,13,13,GCGATCCTCCGCGGGCAGTA,0,486090
araBp,0.07142857142857142,13,13,GCCTCGAATTGTTGCAGTAG,0,497525
araBp,0.07142857142857142,13,13,GCCCCCGCCAACTGACGAGC,0,476474
araBp,0.07142857142857142,13,13,GCACGCTTCCGAGCCGGGAT,0,493381
araBp,0.07142857142857142,13,13,GATTCCCAGCGTCATATGGA,0,496442
araBp,0.07142857142857142,13,13,GATTCAACCGCAGCGTTAGC,0,468399
araBp,0.07142857142857142,13,13,GATGAGAGATGGTTTTAGTG,0,485777
araBp,0.07142857142857142,13,13,GATCCACGGTGACAGGGACA,0,490531
araBp,0.07142857142857142,13,13,GATAGGGACCATGTCTGGGA,0,515233
araBp,0.07142857142857142,13,13,GAGGCCTGAAACGACTCCCG,0,473624
araBp,0.07142857142857142,13,13,GAGGACGGGTCAGGGTCATA,0,503978
araBp,0.07142857142857142,13,13,GAGCCTCATTGGGGAGAGAC,0,496548
araBp,0.07142857142857142,13,13,GAGAAGTCTTAACAGGGACG,0,484906
araBp,0.07142857142857142,13,13,GACTTTTGGGATAGCGTGTT,0,479564
araBp,0.07142857142857142,13,13,GACTCGGAGCCTGCCAGGAC,0,504367
araBp,0.07142857142857142,13,13,GACGTATTTCGGAGCCAGAA,0,482104
araBp,0.07142857142857142,13,13,GACAGACGATCGACAGCACA,0,501903
araBp,0.07142857142857142,13,13,GACAATTAGCGCAAAGTACA,0,519670
araBp,0.07142857142857142,13,13,GACAAGGGCGGCTGACAGGG,0,493424
araBp,0.07142857142857142,13,13,GAATCATGGAAAGCTCCCAA,0,474733
araBp,0.07142857142857142,13,13,GAATACTGCGGGCGTTTACG,0,517507
araBp,0.07142857142857142,13,13,GAATAAGGTACCTTGAGCAA,0,483953
araBp,0.07142857142857142,13,13,GAACATCATTATAATAGGAG,0,520681
araBp,0.07142857142857142,13,13,CTTTCATAAGCATAAAATGC,0,515993
araBp,0.07142857142857142,13,13,CTTGTGTTCTCAAGATAAAA,0,475231
araBp,0.07142857142857142,13,13,CTTGTATGTTAGTCGTCCCG,0,485847
araBp,0.07142857142857142,13,13,CTTGGAGCTAGGGTCGATTT,0,509602
araBp,0.07142857142857142,13,13,CTTGCTCCGCGTGTCAGGGA,0,480430
araBp,0.07142857142857142,13,13,CTGCCCCCCGCGGTTATTTA,0,483858
araBp,0.07142857142857142,13,13,CTGACGTGTTAGCACCGGTA,0,476980
araBp,0.07142857142857142,13,13,CTCCGCAGGGAGCCGTACTC,0,468828
araBp,0.07142857142857142,13,13,CTATGAAAACTCGGTAAAAA,0,493248
araBp,0.07142857142857142,13,13,CTATCATATGAATGTATATA,0,513322
araBp,0.07142857142857142,13,13,CTACATTTTATCAGTGCTTT,0,490436
araBp,0.07142857142857142,13,13,CGTTGGCGATCTGGAAACAT,0,509960
araBp,0.07142857142857142,13,13,CGGGTGTTGCCCGTCCGAGT,0,489601
araBp,0.07142857142857142,13,13,CGGCCGAAGAGCTCTGCATC,0,491968
araBp,0.07142857142857142,13,13,CGGATTCTTAGCACGCCGCA,0,482225
araBp,0.07142857142857142,13,13,CGGAATATACACTGAGGCTG,0,485269
araBp,0.07142857142857142,13,13,CGCGAAAGCGACACAACCCC,0,470233
araBp,0.07142857142857142,13,13,CGCCCTATTTACCATTTGGA,0,481493
araBp,0.07142857142857142,13,13,CGCCCACACCACAAGTCTGC,0,481679
araBp,0.07142857142857142,13,13,CGCCAGATTCGCTATATCCC,0,501025
araBp,0.07142857142857142,13,13,CGATACCGGGACTTTGAACA,0,501553
araBp,0.07142857142857142,13,13,CGAGATTTGACTGCCGAGGA,0,493768
araBp,0.07142857142857142,13,13,CGAAAGGTGCACGATGTATC,0,498838
araBp,0.07142857142857142,13,13,CCTTTACCTACGTACATACT,0,496977
araBp,0.07142857142857142,13,13,CCTTGTGTGATTCGGGCGGA,0,496532
araBp,0.07142857142857142,13,13,CCTTGGGGTACAACGAGAGG,0,482893
araBp,0.07142857142857142,13,13,CCTTCAATACGTTTTTAGTC,0,472553
araBp,0.07142857142857142,13,13,CCTTATCCTCGGGATCGTGT,0,497497
araBp,0.07142857142857142,13,13,CCTGGGGGTTAAACTTCTTG,0,503907
araBp,0.07142857142857142,13,13,CCTCTGCCCTAGGGTTTCTT,0,472788
araBp,0.07142857142857142,13,13,CCTACGGAAACGAACAAGTT,0,518106
araBp,0.07142857142857142,13,13,CCGGCTTAAACCTGTCTGGG,0,515360
araBp,0.07142857142857142,13,13,CCGCTGCATGTGGACTGGGG,0,500014
araBp,0.07142857142857142,13,13,CCGCCGACCATTCGATGCGC,0,503787
araBp,0.07142857142857142,13,13,CCGCATGCGTTAGCACTTGG,0,510552
araBp,0.07142857142857142,13,13,CCGACGGGATGTTAGTGGAT,0,515379
araBp,0.07142857142857142,13,13,CCCGACAGTCGGCTTGAATC,0,520278
araBp,0.07142857142857142,13,13,CCCCCTGTAATTGCCGCGGG,0,487061
araBp,0.07142857142857142,13,13,CCCATGGGGACCCCAATGTT,0,516644
araBp,0.07142857142857142,13,13,CCCATGCTGATGAGCCAACA,0,502282
araBp,0.07142857142857142,13,13,CCATGACCCTGTCAGAACTG,0,512955
araBp,0.07142857142857142,13,13,CCATGACACTCGAGTACGGC,0,482779
araBp,0.07142857142857142,13,13,CCAGTAGGGCCTCGGCGTTC,0,483571
araBp,0.07142857142857142,13,13,CCAGTAAACGACCCGATGAA,0,490377
araBp,0.07142857142857142,13,13,CCAGGTGTATAGCTGCATAT,0,510433
araBp,0.07142857142857142,13,13,CCAGACACGCCCTTGTGAAT,0,484939
araBp,0.07142857142857142,13,13,CCACCGAGGCCCCGACCAAC,0,523309
araBp,0.07142857142857142,13,13,CCAAGTGCAGGGAGTGCAGA,0,523564
araBp,0.07142857142857142,13,13,CATGTACTCCTTCCCATGGG,0,496313
araBp,0.07142857142857142,13,13,CATGAGTGGGCGGATGATTG,0,515889
araBp,0.07142857142857142,13,13,CATCTGTCAAAGCCTTACTT,0,478717
araBp,0.07142857142857142,13,13,CATCTGGTTATTCGGAAGCT,0,468489
araBp,0.07142857142857142,13,13,CATCGTTGTAAGACAGGCGA,0,475436
araBp,0.07142857142857142,13,13,CATATAGAAATATTAGGCCA,0,512907
araBp,0.07142857142857142,13,13,CATACGGCAAGGTATCATAA,0,481401
araBp,0.07142857142857142,13,13,CATAATTATATCCTCCTAGA,0,491533
araBp,0.07142857142857142,13,13,CAGTCCGGTGCAGATTGAGG,0,486438
araBp,0.07142857142857142,13,13,CAGGCATTATATACGCCTCG,0,502224
araBp,0.07142857142857142,13,13,CAGCCATGACCTTCGTGAAG,0,514712
araBp,0.07142857142857142,13,13,CAGAACCCCGCGGTATATCT,0,498558
araBp,0.07142857142857142,13,13,CAGAAAGTTAATACGAGTGC,0,471819
araBp,0.07142857142857142,13,13,CACTACATGCGTGTGGCAGC,0,483674
araBp,0.07142857142857142,13,13,CACCTACACATTACTATGGT,0,488249
araBp,0.07142857142857142,13,13,CACACATTCACCCGTGGGGT,0,469151
araBp,0.07142857142857142,13,13,CAACAGATAGAGCGTTCCGG,0,480397
araBp,0.07142857142857142,13,13,ATTGTTTTGGAGTCGCCGTC,0,470784
araBp,0.07142857142857142,13,13,ATTCTAGGATCTTGTAACTA,0,517612
araBp,0.07142857142857142,13,13,ATTCCTCGGTGTTCATAAGT,0,494852
araBp,0.07142857142857142,13,13,ATTCAATTAGCTACTCAGTA,0,492598
araBp,0.07142857142857142,13,13,ATTACGCAATAATGCGTTCT,0,490333
araBp,0.07142857142857142,13,13,ATGCTCTCTAGTGAGACTGT,0,513888
araBp,0.07142857142857142,13,13,ATGATCTCAGACCGAAAGGC,0,500255
araBp,0.07142857142857142,13,13,ATCTATCGTCTTAGTGTGAT,0,524492
araBp,0.07142857142857142,13,13,ATCAGTGTCAGGCAACCTGA,0,511698
araBp,0.07142857142857142,13,13,ATCAGACCTAAGCGTTACTC,0,509199
araBp,0.07142857142857142,13,13,ATCAAACATATGGTTCGTTA,0,509337
araBp,0.07142857142857142,13,13,ATAATACCGATATCTGAAAT,0,518471
araBp,0.07142857142857142,13,13,ATAAAGCGACCGGGTGAAGC,0,478427
araBp,0.07142857142857142,13,13,AGTTCTCAGTCTTATGTTGG,0,511442
araBp,0.07142857142857142,13,13,AGTTAACAATTCGTTTAATT,0,493592
araBp,0.07142857142857142,13,13,AGTGTTAGGAACTAACTTGG,0,478650
araBp,0.07142857142857142,13,13,AGTGGTACCCTCACGAGGCG,0,500704
araBp,0.07142857142857142,13,13,AGTGATTTTCACGCTGTGGT,0,497490
araBp,0.07142857142857142,13,13,AGTGAACCGTAGAAGCTTCA,0,477456
araBp,0.07142857142857142,13,13,AGTCAGCGTAAGAGGCAAAG,0,494700
araBp,0.07142857142857142,13,13,AGGTGGGTCTACTATAGCGC,0,511221
araBp,0.07142857142857142,13,13,AGGGTATTGGATGACGTAGA,0,476104
araBp,0.07142857142857142,13,13,AGGGAAAAGGCCTGCAAACC,0,488092
araBp,0.07142857142857142,13,13,AGGATGACGGCTCGATGAAG,0,488072
araBp,0.07142857142857142,13,13,AGGATCGCCAAGCAGGAGCA,0,510626
araBp,0.07142857142857142,13,13,AGGATCCGAGACCGTGGTAC,0,478304
araBp,0.07142857142857142,13,13,AGGATACAGGAAACTGTCCA,0,483148
araBp,0.07142857142857142,13,13,AGGAGCCTGTACTCAAATTC,0,502371
araBp,0.07142857142857142,13,13,AGCGTAGCGGTAAATACGGC,0,484871
araBp,0.07142857142857142,13,13,AGCGCGCCCGCGGCCGACTC,0,484058
araBp,0.07142857142857142,13,13,AGATGTTAACTGCGCGCCAA,0,470179
araBp,0.07142857142857142,13,13,AGATACGAAGCTCTAGCGCT,0,493487
araBp,0.07142857142857142,13,13,AGAGGGCGTGGATGGTTGCA,0,469207
araBp,0.07142857142857142,13,13,AGACTAATGGGAACCACATG,0,479132
araBp,0.07142857142857142,13,13,AGACATTGGCACTGAGGGCA,0,518740
araBp,0.07142857142857142,13,13,ACTTTTTGTATTGATGGCAA,0,491991
araBp,0.07142857142857142,13,13,ACTGTTGATCAGCGAGCCAG,0,513365
araBp,0.07142857142857142,13,13,ACTGGCTCGCTGTACGGGGT,0,494408
araBp,0.07142857142857142,13,13,ACTGAGCTAGACTACGACAT,0,517696
araBp,0.07142857142857142,13,13,ACGTGGCGTTTATCGTTCAC,0,469092
araBp,0.07142857142857142,13,13,ACGTGCCTACGAGACTGATA,0,500734
araBp,0.07142857142857142,13,13,ACGTGAATCAGCGCAGGTAC,0,517926
araBp,0.07142857142857142,13,13,ACGGCATAGCATACATGGGT,0,491491
araBp,0.07142857142857142,13,13,ACGAGTGAGTATGCGCTGAC,0,492627
araBp,0.07142857142857142,13,13,ACCTTTCTTGGAACTTGCTT,0,477285
araBp,0.07142857142857142,13,13,ACCCCTGTACAGTAAAATTC,0,480825
araBp,0.07142857142857142,13,13,ACAATTTAGTTTTGCTCGTC,0,498098
araBp,0.07142857142857142,13,13,AATTTTGCGTTGTGCGATCA,0,498633
araBp,0.07142857142857142,13,13,AATGGAATTTGCCCGGGGTG,0,523934
araBp,0.07142857142857142,13,13,AATGAGAACAACAGGATTCT,0,525107
araBp,0.07142857142857142,13,13,AATCTTAGGTCATTACCGTA,0,505192
araBp,0.07142857142857142,13,13,AATCACCTCGAAGATTGACA,0,488277
araBp,0.07142857142857142,13,13,AATACTGCGGTAGTTCTGCA,0,481845
araBp,0.07142857142857142,13,13,AATAATTGCCGCATTCATAG,0,497113
araBp,0.07142857142857142,13,13,AAGTCGCTCGTAATTGTGAT,0,494677
araBp,0.07142857142857142,13,13,AAGGGATTCAGACTCAATTT,0,485417
araBp,0.07142857142857142,13,13,AAGGCCGCGCCTTTGGGAAT,0,478149
araBp,0.07142857142857142,13,13,AAGCTTAGTCGTTACAATGC,0,499752
araBp,0.07142857142857142,13,13,AAGCCGTTTATATGCAACGT,0,489450
araBp,0.07142857142857142,13,13,AAGATTTGCGTACAGGGGGT,0,523814
araBp,0.07142857142857142,13,13,AACTGTACCTTAATTTACTT,0,498634
araBp,0.07142857142857142,13,13,AACTGCTTCCCCCAAATGGG,0,487501
araBp,0.07142857142857142,13,13,AACGTTGAAGTCAGCTCCGA,0,468389
araBp,0.07142857142857142,13,13,AACCCGATCGGACAACACGA,0,490630
araBp,0.07142857142857142,13,13,AACACTGTAAAGCTAATCTT,0,481386
araBp,0.07142857142857142,13,13,AAACAACGCATCAGCTTACG,0,486974
araBp,0.07142857142857142,13,13,AAAAATAAGAACTGCATTGC,0,510646
araBp,0.07692307692307693,12,12,TTTTAGTAAAAAAAGAGGAT,0,523162
araBp,0.07692307692307693,12,12,TTTTACCGCATTACGGCGAT,0,478014
araBp,0.07692307692307693,12,12,TTTGTGAAAAGGATAGGCCA,0,482460
araBp,0.07692307692307693,12,12,TTTACTTTTAGAATGAAACC,0,524900
araBp,0.07692307692307693,12,12,TTGTGGTTTATGTCGCAAAG,0,510200
araBp,0.07692307692307693,12,12,TTGGTTTGTAGTCGCGGGAC,0,479678
araBp,0.07692307692307693,12,12,TTGGGTATCACAAGGCGCCG,0,513767
araBp,0.07692307692307693,12,12,TTGAAATAGGAAAATCTCGA,0,491144
araBp,0.07692307692307693,12,12,TTCGGCAAGAATCTAATGAC,0,490821
araBp,0.07692307692307693,12,12,TTCGAAAGCGGTCTGGCCGT,0,483678
araBp,0.07692307692307693,12,12,TTCCTTCCGACATTCGAAGT,0,495428
araBp,0.07692307692307693,12,12,TTCCGCTTCAGGGATTCCGC,0,483648
araBp,0.07692307692307693,12,12,TTCACCATGAGATGCCTTAT,0,519661
araBp,0.07692307692307693,12,12,TTATTCCAGCCATCTCACAA,0,475464
araBp,0.07692307692307693,12,12,TTAGTTCTGTAGTATGAAAC,0,505940
araBp,0.07692307692307693,12,12,TTACAGCTTGTGCGGCCGTT,0,469326
araBp,0.07692307692307693,12,12,TTAAGCAACCCATAACCTCG,0,520670
araBp,0.07692307692307693,12,12,TGTAGTAGTACTCCCTTGTG,0,484714
araBp,0.07692307692307693,12,12,TGGTTATTCTAGTAATCCGT,0,484517
araBp,0.07692307692307693,12,12,TGGTGTCTTCATGATACTAG,0,483547
araBp,0.07692307692307693,12,12,TGGTGAACGACTTGACGGAT,0,496811
araBp,0.07692307692307693,12,12,TGGTCCACACGTCGCGTTTC,0,511977
araBp,0.07692307692307693,12,12,TGGGCAGACATATGTATGTG,0,488045
araBp,0.07692307692307693,12,12,TGGGCAAAAACATTCAAGCG,0,524233
araBp,0.07692307692307693,12,12,TGGAGCCAGGCGCTGGGGGT,0,470046
araBp,0.07692307692307693,12,12,TGCGTTACACGTGTCGATCC,0,476909
araBp,0.07692307692307693,12,12,TGCGTGGTACCTTGCGGGTT,0,514010
araBp,0.07692307692307693,12,12,TGCCGCCGAGATCGGTCTCT,0,497707
araBp,0.07692307692307693,12,12,TGCCGAGTATCGAATGCTAA,0,482983
araBp,0.07692307692307693,12,12,TGAGTGCTTGAAACTTCAAC,0,480778
araBp,0.07692307692307693,12,12,TGACAGTTCATATCCACGGT,0,478934
araBp,0.07692307692307693,12,12,TGAAGAGTCTACTTGGTAGG,0,471056
araBp,0.07692307692307693,12,12,TGAACCTGAAAGTACAAACT,0,505754
araBp,0.07692307692307693,12,12,TCTTCTAAGGACCAATCAGC,0,471916
araBp,0.07692307692307693,12,12,TCTTCAAGTCGGCCCGAGGA,0,493486
araBp,0.07692307692307693,12,12,TCTGCCTATAATCACAATCA,0,483603
araBp,0.07692307692307693,12,12,TCTCTCCACTCAGCCGGGGT,0,524522
araBp,0.07692307692307693,12,12,TCTCACATTCACGTGATACG,0,513748
araBp,0.07692307692307693,12,12,TCTACGGCCTCCAGGTCTTA,0,468374
araBp,0.07692307692307693,12,12,TCGTTGCAGGGGGAATCAAA,0,510435
araBp,0.07692307692307693,12,12,TCGGTTACCTGTACCGTTAC,0,490147
araBp,0.07692307692307693,12,12,TCGGACTTCGGGGGTAAACC,0,477343
araBp,0.07692307692307693,12,12,TCGCGCCGTGCACTATTAAT,0,500368
araBp,0.07692307692307693,12,12,TCGCGATAGCGTTCCAACTT,0,505803
araBp,0.07692307692307693,12,12,TCGATGCTGACAACCGCATA,0,486615
araBp,0.07692307692307693,12,12,TCGAGATCGTGCCATGGAAG,0,522328
araBp,0.07692307692307693,12,12,TCGACGCCTCGGTAGATGCG,0,486249
araBp,0.07692307692307693,12,12,TCGACGCATTTCGCTGTATT,0,483295
araBp,0.07692307692307693,12,12,TCGAAAGCAGCCTGAGCCAA,0,478563
araBp,0.07692307692307693,12,12,TCCTTACGACGTCAACCAGT,0,524277
araBp,0.07692307692307693,12,12,TCCTCAGTGAGGGAAAATAG,0,504396
araBp,0.07692307692307693,12,12,TCCTATAACCGTTCCGCGAC,0,481443
araBp,0.07692307692307693,12,12,TCATCGATCATAGCTATATC,0,496218
araBp,0.07692307692307693,12,12,TCATCAAATCCGATCTATCA,0,488300
araBp,0.07692307692307693,12,12,TCAGGTCGGTGATGGATCTG,0,479539
araBp,0.07692307692307693,12,12,TCACGGGGCGAAACCGGTGA,0,516937
araBp,0.07692307692307693,12,12,TCAAGGGTGCTGTATCCGTA,0,507430
araBp,0.07692307692307693,12,12,TATTGCACCTTTGGCGGTCG,0,473685
araBp,0.07692307692307693,12,12,TATGTCTTGTCATTAATCGT,0,482575
araBp,0.07692307692307693,12,12,TATGTAGCAGTGGGCCGACC,0,477676
araBp,0.07692307692307693,12,12,TATCGGTGACTTCGTGGCTT,0,497400
araBp,0.07692307692307693,12,12,TATCAACAAGTCAGAACGGC,0,486472
araBp,0.07692307692307693,12,12,TATACGCAGGACGGTCGCGA,0,495027
araBp,0.07692307692307693,12,12,TAGCTAAGAGAAAAAGAGTT,0,488127
araBp,0.07692307692307693,12,12,TACTTGTGCGACGACGTAGG,0,489491
araBp,0.07692307692307693,12,12,TACTCTGTGGGATCTAGGAA,0,495917
araBp,0.07692307692307693,12,12,TACGACACAGCAGGACTGAA,0,525231
araBp,0.07692307692307693,12,12,TACCGTCGAAGATACCGAGG,0,471377
araBp,0.07692307692307693,12,12,TACAAATTCTGTGAGAGCAG,0,499317
araBp,0.07692307692307693,12,12,TAAGTCGGTGTTTTCAACTG,0,512767
araBp,0.07692307692307693,12,12,TAACGGGGCTTAGAGTTCAC,0,519406
araBp,0.07692307692307693,12,12,GTTTTATTCTTCCCGATCGG,0,517215
araBp,0.07692307692307693,12,12,GTTAACTCTTCGAATGCGCC,0,495435
araBp,0.07692307692307693,12,12,GTGGAGCCAAACATCAACTT,0,493519
araBp,0.07692307692307693,12,12,GTGAATTTTAGGGATGTCAG,0,515742
araBp,0.07692307692307693,12,12,GTCTTCAGCGGCCGAATCTA,0,515234
araBp,0.07692307692307693,12,12,GTCTGACCATCTTCGACCAA,0,478320
araBp,0.07692307692307693,12,12,GTCCATCATCTATCAACTTA,0,521767
araBp,0.07692307692307693,12,12,GTCCAACGGTGATCTGTACT,0,469877
araBp,0.07692307692307693,12,12,GTCATATAAGACAGTATGTT,0,503028
araBp,0.07692307692307693,12,12,GTCACAGTTACACGCCATTT,0,470231
araBp,0.07692307692307693,12,12,GTACCTTGGGTGGCATGGGG,0,474120
araBp,0.07692307692307693,12,12,GTAATGAACTTCTACCCGCA,0,501014
araBp,0.07692307692307693,12,12,GTAATAATCCCGAGGCACGT,0,478558
araBp,0.07692307692307693,12,12,GTAAGGACCCTTCGCGCGCG,0,505327
araBp,0.07692307692307693,12,12,GTAAACGCGCCCTTGGAGGT,0,484870
araBp,0.07692307692307693,12,12,GGTGTCGTGCACGTCTCATT,0,467900
araBp,0.07692307692307693,12,12,GGTGCTATGCGTGTCCGTCT,0,485425
araBp,0.07692307692307693,12,12,GGTGCCGGGGCACTACGCGA,0,472515
araBp,0.07692307692307693,12,12,GGTCTCAGTAAGATATTAGA,0,485896
araBp,0.07692307692307693,12,12,GGTCAGCACAGACATTTTCG,0,489527
araBp,0.07692307692307693,12,12,GGGGCGGAAAAATACTCAGT,0,505242
araBp,0.07692307692307693,12,12,GGGATCGGGCTTGTCCCTGT,0,481153
araBp,0.07692307692307693,12,12,GGCGGAGACAGTATGTTAGT,0,508425
araBp,0.07692307692307693,12,12,GGCCCTTCATTGCTTTAAAC,0,473245
araBp,0.07692307692307693,12,12,GGCCCATTATGAGACAAAAC,0,502990
araBp,0.07692307692307693,12,12,GGCCACAAGCGAAAGGTTCT,0,499122
araBp,0.07692307692307693,12,12,GGCACTAGGGGAGGGCACGA,0,485155
araBp,0.07692307692307693,12,12,GGATTGACAAGGCTACATAT,0,511629
araBp,0.07692307692307693,12,12,GGAGAACCACCTTAGCGCTC,0,489535
araBp,0.07692307692307693,12,12,GGACCCGAAGATAGGTGTCA,0,508903
araBp,0.07692307692307693,12,12,GCTGTTTCACAAGATCGATG,0,501017
araBp,0.07692307692307693,12,12,GCTCTCTTGCTATGGCGTCT,0,487193
araBp,0.07692307692307693,12,12,GCTCCCGGACCGAAAAGAAT,0,480326
araBp,0.07692307692307693,12,12,GCTCCATGGCCCTGCGCCGT,0,513559
araBp,0.07692307692307693,12,12,GCTAGCACATTCTCCGCGCC,0,508608
araBp,0.07692307692307693,12,12,GCGGAGCGCCTGATATGCGT,0,484799
araBp,0.07692307692307693,12,12,GCGCTTTCGGTATGGGGGAT,0,483258
araBp,0.07692307692307693,12,12,GCGCTCAGTGCCGTGTGCCA,0,496327
araBp,0.07692307692307693,12,12,GCGAGCCCACGGCAAACGTT,0,496151
araBp,0.07692307692307693,12,12,GCCGGGTATCTCGGTTGGCT,0,482943
araBp,0.07692307692307693,12,12,GCCCGGCATCTGTTGTCAAA,0,496958
araBp,0.07692307692307693,12,12,GCCCCACAGAAGATTGGTTA,0,468427
araBp,0.07692307692307693,12,12,GCCATTGGGGGTCATTCGAA,0,468347
araBp,0.07692307692307693,12,12,GCCATTGCAGTAATTAGGGT,0,491374
araBp,0.07692307692307693,12,12,GCCAGGGTGCTCAGCTAGGT,0,522466
araBp,0.07692307692307693,12,12,GCCAGATTCCTGAATTTGCT,0,516851
araBp,0.07692307692307693,12,12,GCATATAACTAGACTTTCAT,0,510009
araBp,0.07692307692307693,12,12,GCAGGCCGATTCTGGGTTAA,0,471059
araBp,0.07692307692307693,12,12,GCACAATTCAGCTACGAAAT,0,480589
araBp,0.07692307692307693,12,12,GATTTAAAATTAACAGGCCC,0,493961
araBp,0.07692307692307693,12,12,GATTCGCACAGACGGCATCG,0,494798
araBp,0.07692307692307693,12,12,GATTATCATCGGGGAGAGGA,0,513375
araBp,0.07692307692307693,12,12,GATGCGGCCAAACAGGCAGC,0,488068
araBp,0.07692307692307693,12,12,GATGCCTTGTCAACAAACGC,0,490300
araBp,0.07692307692307693,12,12,GATCCTGTCCATAGCGATTC,0,477712
araBp,0.07692307692307693,12,12,GATAGCTCAGCAGAGCACAG,0,522528
araBp,0.07692307692307693,12,12,GATAGAGGCACTGATCAAGG,0,479777
araBp,0.07692307692307693,12,12,GAGTCATGTGTTCTTTGCTA,0,482855
araBp,0.07692307692307693,12,12,GAGGGAGCAGATGACGCCAG,0,499704
araBp,0.07692307692307693,12,12,GAGCTTCGTGGGGGCACTTG,0,513180
araBp,0.07692307692307693,12,12,GAGCTGGTAATCTGTGCACT,0,507610
araBp,0.07692307692307693,12,12,GAGCGGGTTGGGCAATGCCT,0,520813
araBp,0.07692307692307693,12,12,GAGCGGGGAAGACTCCATAT,0,470423
araBp,0.07692307692307693,12,12,GAGAGTATCGGACAACACTT,0,496990
araBp,0.07692307692307693,12,12,GACTGTTAAAAGGAACATAA,0,474367
araBp,0.07692307692307693,12,12,GACCTGGGGATTTAGAACGG,0,489942
araBp,0.07692307692307693,12,12,GACCGACGGGGCAAAACCTG,0,503761
araBp,0.07692307692307693,12,12,GAAGCCTAATGATGACCCGA,0,505318
araBp,0.07692307692307693,12,12,GAAACACCAGGCGTGAATAT,0,515863
araBp,0.07692307692307693,12,12,GAAAACTGCTGACGAGGTGG,0,521549
araBp,0.07692307692307693,12,12,CTTTGTGCGTGCGGTGGTAC,0,477167
araBp,0.07692307692307693,12,12,CTTTAGGCAATACAGGTGTT,0,525014
araBp,0.07692307692307693,12,12,CTTGGGCGCCGATATTCAGC,0,520311
araBp,0.07692307692307693,12,12,CTTAATTTCTTACTCCTAGT,0,507643
araBp,0.07692307692307693,12,12,CTTAAGTCGATACATCAATC,0,485450
araBp,0.07692307692307693,12,12,CTGTTAAATGAGAGGAGATC,0,474284
araBp,0.07692307692307693,12,12,CTGCGGTGGCTGCTGTATAT,0,470121
araBp,0.07692307692307693,12,12,CTGAATCAGCTAGATCGGCA,0,515885
araBp,0.07692307692307693,12,12,CTGAAGTAATCGGCGGGCGC,0,471312
araBp,0.07692307692307693,12,12,CTCGTCGGTAGGACACTGGT,0,483284
araBp,0.07692307692307693,12,12,CTCGGCTGAACTTCTGTCGG,0,471207
araBp,0.07692307692307693,12,12,CTCGACAACTTGTAGTGATT,0,478373
araBp,0.07692307692307693,12,12,CTCCACGACCTATCTCACCT,0,484340
araBp,0.07692307692307693,12,12,CTATTAGATCTAGCTTGACA,0,516705
araBp,0.07692307692307693,12,12,CTATGTTTGAATCCGATACT,0,476572
araBp,0.07692307692307693,12,12,CTAGTTGGGCTCTGTGAGCA,0,490301
araBp,0.07692307692307693,12,12,CTAGGCCGGACCATTATGCC,0,491593
araBp,0.07692307692307693,12,12,CTAGATTACCTCCTATGTGG,0,470601
araBp,0.07692307692307693,12,12,CTACCGATGGCTGACCACAT,0,512116
araBp,0.07692307692307693,12,12,CTAACGCAAGAGATTCCGAG,0,482371
araBp,0.07692307692307693,12,12,CGTTGAGGGTGCCCCATGTT,0,520276
araBp,0.07692307692307693,12,12,CGTGTTGTGTTCCAGCGAAT,0,525346
araBp,0.07692307692307693,12,12,CGTGCCATTACGGCATATAT,0,477603
araBp,0.07692307692307693,12,12,CGTGATAGGACCTCGGACGT,0,486251
araBp,0.07692307692307693,12,12,CGTATAATCACGGGCCGTGC,0,523236
araBp,0.07692307692307693,12,12,CGTAGACGCCCAGTTTGGGT,0,517729
araBp,0.07692307692307693,12,12,CGTAACGGGGGAAAGAGGCG,0,509459
araBp,0.07692307692307693,12,12,CGGTTTCTCGTAAGAAATCC,0,492994
araBp,0.07692307692307693,12,12,CGGGGAACTCGTGACAAGTG,0,471174
araBp,0.07692307692307693,12,12,CGCTGTTTGGCGATCTGTTA,0,474114
araBp,0.07692307692307693,12,12,CGCATGCCACAGAGCAATCA,0,469724
araBp,0.07692307692307693,12,12,CGATAGGGCTAGTATGGCGA,0,483486
araBp,0.07692307692307693,12,12,CGAGCGGTTGCTATGAACGA,0,514805
araBp,0.07692307692307693,12,12,CCTTTCAGTCTGTGCCCCCG,0,490891
araBp,0.07692307692307693,12,12,CCTCGTTCAACGAACAGGAA,0,518716
araBp,0.07692307692307693,12,12,CCTCCCCGAAGAACGCTAGC,0,485431
araBp,0.07692307692307693,12,12,CCTAGTGCCCTGAACAGAAA,0,507850
araBp,0.07692307692307693,12,12,CCGGGGGTTGATAAACGGTT,0,501527
araBp,0.07692307692307693,12,12,CCGGATTCCTAACCAGTACA,0,479522
araBp,0.07692307692307693,12,12,CCGGATGCGTGCTACCTGTT,0,505490
araBp,0.07692307692307693,12,12,CCGATTACCGGGCATACATG,0,516139
araBp,0.07692307692307693,12,12,CCGATAGCTAACGTGCCCTT,0,480412
araBp,0.07692307692307693,12,12,CCGAGACACCGGTGCATCAT,0,510508
araBp,0.07692307692307693,12,12,CCGAACAGTTAGTTGGTTTA,0,474286
araBp,0.07692307692307693,12,12,CCCTTGCGTTCGAACCCGTC,0,476712
araBp,0.07692307692307693,12,12,CCCGCACGTGGGAGACGATA,0,494064
araBp,0.07692307692307693,12,12,CCCATCACGGCAGGGCAGAC,0,467867
araBp,0.07692307692307693,12,12,CCATTTTGAGCGACAGAGTA,0,502608
araBp,0.07692307692307693,12,12,CCACATGAATCACGGCCTTC,0,523917
araBp,0.07692307692307693,12,12,CCACACACTCAGGAGCGTTA,0,518292
araBp,0.07692307692307693,12,12,CCAACGCATTGCGAAACCAC,0,478184
araBp,0.07692307692307693,12,12,CATTGCGCTTGCGTAGATTC,0,491534
araBp,0.07692307692307693,12,12,CATTCCCCCCGAGTAATGCA,0,479106
araBp,0.07692307692307693,12,12,CATGGTGTACGTACATTGTT,0,497654
araBp,0.07692307692307693,12,12,CATGGGGGGTTTTCATCTGC,0,510721
araBp,0.07692307692307693,12,12,CATGGCCTAGATCTTAAAAG,0,479761
araBp,0.07692307692307693,12,12,CATGATTTTGTCCTACCAAC,0,477841
araBp,0.07692307692307693,12,12,CATCCATTGGCTTCATAAGA,0,502672
araBp,0.07692307692307693,12,12,CATCAACCCTGGGGTGGGAC,0,473901
araBp,0.07692307692307693,12,12,CAGTTGTATTGCGGGATCAG,0,500812
araBp,0.07692307692307693,12,12,CAGAGTCCAACCCGGCACTG,0,497735
araBp,0.07692307692307693,12,12,CAGAGGCCTTGGGGGCAGGC,0,498236
araBp,0.07692307692307693,12,12,CACGTGGGCCGACGTATGCT,0,519199
araBp,0.07692307692307693,12,12,CACGACCGACACGTTCCTTA,0,506563
araBp,0.07692307692307693,12,12,CACCGTCGCTTGTCCAACAA,0,498571
araBp,0.07692307692307693,12,12,CACATAATACCAGATGGTGT,0,487275
araBp,0.07692307692307693,12,12,CAATAGTGGCGATAGGAATA,0,503319
araBp,0.07692307692307693,12,12,CAATAGGAGGTTACGAACAT,0,489815
araBp,0.07692307692307693,12,12,ATTTCGGACGACCGATGTAT,0,513370
araBp,0.07692307692307693,12,12,ATTTAAAAATAAGCCATTAC,0,472616
araBp,0.07692307692307693,12,12,ATGTAGTTCGGAGTCCCTCT,0,523853
araBp,0.07692307692307693,12,12,ATCTGTCGAACATCCCCCTA,0,479819
araBp,0.07692307692307693,12,12,ATCGGCAGCGCCAGTGGTGT,0,515159
araBp,0.07692307692307693,12,12,ATATATTGTCTAGGCCTCAT,0,510595
araBp,0.07692307692307693,12,12,ATATAATGGGTCAGTGAAGA,0,501896
araBp,0.07692307692307693,12,12,ATAGTGCGATGCGTTTCACT,0,485630
araBp,0.07692307692307693,12,12,AGTTTGAAGTTTTCCGAGTC,0,472184
araBp,0.07692307692307693,12,12,AGTTCGGCAAACGCATGCCG,0,496888
araBp,0.07692307692307693,12,12,AGTTCGGATACGGCGGGCTG,0,475734
araBp,0.07692307692307693,12,12,AGTGAGCTAGTGGGAATACA,0,481829
araBp,0.07692307692307693,12,12,AGTGAGCCGCGCTCGGTACA,0,494620
araBp,0.07692307692307693,12,12,AGGTATCTATACATGAAGTA,0,494028
araBp,0.07692307692307693,12,12,AGGTAGACAGTGATGGGTTG,0,510526
araBp,0.07692307692307693,12,12,AGGCGAGTTGGGTTCTAGTC,0,485905
araBp,0.07692307692307693,12,12,AGGCCGACTGCGCCGGGTTC,0,483522
araBp,0.07692307692307693,12,12,AGGAGGGCGCAAGGCATAAA,0,513194
araBp,0.07692307692307693,12,12,AGCTTAGTTGAAACTGTGAT,0,472738
araBp,0.07692307692307693,12,12,AGCCTGTTTTGGACACTGAG,0,505847
araBp,0.07692307692307693,12,12,AGCCTGCCAGGAACTATTTT,0,524189
araBp,0.07692307692307693,12,12,AGCATATATAAGCCCTCATC,0,496962
araBp,0.07692307692307693,12,12,AGCAGGGTCGAACGCAAGCG,0,471197
araBp,0.07692307692307693,12,12,AGATCTGGGGGGATTTTCGA,0,492500
araBp,0.07692307692307693,12,12,AGATATTTGGTAGGCGCGAA,0,518662
araBp,0.07692307692307693,12,12,AGAGGAGTTGAGTCTCACTA,0,491140
araBp,0.07692307692307693,12,12,AGACGGTAATTATTTGTGAA,0,496368
araBp,0.07692307692307693,12,12,AGACCGCAAAACAGTTGTGA,0,477225
araBp,0.07692307692307693,12,12,AGACATGTTGCTGTCAATTG,0,477631
araBp,0.07692307692307693,12,12,AGAATATGCGTCACCATCAC,0,475977
araBp,0.07692307692307693,12,12,AGAAGTGGATGAGGGGATCG,0,508447
araBp,0.07692307692307693,12,12,AGAAGAGGCCGGGGCTGGAA,0,517842
araBp,0.07692307692307693,12,12,ACTTCGTTGGGTAACCGGCA,0,485264
araBp,0.07692307692307693,12,12,ACTGAAAGCAGGGTTACCCG,0,484946
araBp,0.07692307692307693,12,12,ACTCGAATCCTGCATGTGAT,0,485954
araBp,0.07692307692307693,12,12,ACGTTTTGGAGGGTTGAGGA,0,475532
araBp,0.07692307692307693,12,12,ACGTTGTTACGCACGTGGCA,0,507392
araBp,0.07692307692307693,12,12,ACGTGCTGGGTCCCAGTCGG,0,491956
araBp,0.07692307692307693,12,12,ACGTCTTTAAACCCAGCCCA,0,508434
araBp,0.07692307692307693,12,12,ACGTACGAGATCTGTACGAC,0,490662
araBp,0.07692307692307693,12,12,ACCGCCTTTGAGGAATCCAT,0,488926
araBp,0.07692307692307693,12,12,ACCCTACGGCATAGCACGGA,0,495040
araBp,0.07692307692307693,12,12,ACCCGAGTAGCCTTTTCCTC,0,488606
araBp,0.07692307692307693,12,12,ACCACCTTGGGTAGCGCAAG,0,505635
araBp,0.07692307692307693,12,12,ACAGTATACCCAATAATGGA,0,517544
araBp,0.07692307692307693,12,12,ACACGTTGCCATTTGCCTAT,0,499680
araBp,0.07692307692307693,12,12,ACACGGCAGAGTCGAGATAG,0,498843
araBp,0.07692307692307693,12,12,ACACGCGGTGTAGCCTTATG,0,481699
araBp,0.07692307692307693,12,12,ACAAGTGTATCTGGTACGAA,0,510931
araBp,0.07692307692307693,12,12,ACAACTAATTGGGAGCTGCA,0,510158
araBp,0.07692307692307693,12,12,ACAACACATTTTTAGTCCTG,0,480413
araBp,0.07692307692307693,12,12,AATTCGGCCGTATGTCAAAG,0,488463
araBp,0.07692307692307693,12,12,AATGGGACTGCCCCTTTTTA,0,520667
araBp,0.07692307692307693,12,12,AATACAGGTGGCCTCACTGT,0,481648
araBp,0.07692307692307693,12,12,AAGTTTGACGTACTGCTATG,0,509004
araBp,0.07692307692307693,12,12,AAGGGGGGCAGGCCTTCACT,0,469157
araBp,0.07692307692307693,12,12,AAGAGCCCACAGATTTAATC,0,508704
araBp,0.07692307692307693,12,12,AAGACGAGCCGGTACTCCAC,0,496981
araBp,0.07692307692307693,12,12,AACTGCTTCCCGGCGGCTCT,0,476260
araBp,0.07692307692307693,12,12,AACGTCAGCCTTTAATCCTT,0,523374
araBp,0.07692307692307693,12,12,AACGCCTGCTGAGAAGTTAT,0,476899
araBp,0.07692307692307693,12,12,AACAAGTTCGTTGCACCGTC,0,493315
araBp,0.07692307692307693,12,12,AAATCCCAGGGGTACGCAAC,0,479261
araBp,0.07692307692307693,12,12,AAATAGACGACATGGTCCAG,0,509377
araBp,0.07692307692307693,12,12,AAAGAGTCGAACGTGTACGG,0,489207
araBp,0.07692307692307693,12,12,AAACATCGGAAGAACTGGTA,0,493123
araBp,0.07692307692307693,12,12,AAACATAACTCGGGACATTC,0,524656
araBp,0.07692307692307693,12,12,AAAAACAACAGAGACTGGGA,0,512672
araBp,0.08333333333333333,11,11,TTTTTGGGCTTGACAGCTCA,0,473655
araBp,0.08333333333333333,11,11,TTTTTCCACGCAGGTATGGC,0,470492
araBp,0.08333333333333333,11,11,TTTTCCGGTCTACGGGAGAT,0,514802
araBp,0.08333333333333333,11,11,TTTTAAATACTTTTGTTTCC,0,506213
araBp,0.08333333333333333,11,11,TTTGTAACTAAAAATCCGGA,0,515892
araBp,0.08333333333333333,11,11,TTTGCTTACAGGTTGGGTAG,0,502478
araBp,0.08333333333333333,11,11,TTTGCAATTTTTAGGTTAGA,0,505819
araBp,0.08333333333333333,11,11,TTTCCCGGCACGGCGGTCTA,0,499436
araBp,0.08333333333333333,11,11,TTTCAATATTACTGGCACAG,0,523025
araBp,0.08333333333333333,11,11,TTTAAAACAGCGAAAGGTGA,0,510253
araBp,0.08333333333333333,11,11,TTGTGAGTATGGGAAGTAAG,0,494697
araBp,0.08333333333333333,11,11,TTGGTCGAATAAATGATTCA,0,477706
araBp,0.08333333333333333,11,11,TTGGCGTCTCAGGGGGAAAC,0,473838
araBp,0.08333333333333333,11,11,TTGCGTTGCAGCACGGTTCG,0,499254
araBp,0.08333333333333333,11,11,TTGCATAGTAGGGAGGGAGC,0,478465
araBp,0.08333333333333333,11,11,TTGATGGATCGGGCTGGCGT,0,518395
araBp,0.08333333333333333,11,11,TTGACGATTAGTATTCTGGG,0,488961
araBp,0.08333333333333333,11,11,TTCTTTGGGTGGAATACCGA,0,505371
araBp,0.08333333333333333,11,11,TTCGCCTTATTGCAGGACAG,0,480695
araBp,0.08333333333333333,11,11,TTCCTATATGCTGAAGGCCA,0,483361
araBp,0.08333333333333333,11,11,TTCCGCTGTGTATGGAAAGG,0,494659
araBp,0.08333333333333333,11,11,TTCCGACTTTTGCTCGATTG,0,473107
araBp,0.08333333333333333,11,11,TTCCACAAAGCCTTCCGGGA,0,503127
araBp,0.08333333333333333,11,11,TTCAGGGTCGTCCTCGTAAG,0,470385
araBp,0.08333333333333333,11,11,TTCAATGTTCTCCCGCAATA,0,467826
araBp,0.08333333333333333,11,11,TTCAAGTCCGTAAATAACGC,0,484004
araBp,0.08333333333333333,11,11,TTATGAGCACATTTCTATTG,0,493879
araBp,0.08333333333333333,11,11,TTAGGTCCGGGTCTCGTTAA,0,495272
araBp,0.08333333333333333,11,11,TTACTTACGAGCGCTAAAAT,0,524496
araBp,0.08333333333333333,11,11,TTAACCTACGGTGCTAGTGA,0,491536
araBp,0.08333333333333333,11,11,TGTTGAATAGGGCGGGTGTC,0,487646
araBp,0.08333333333333333,11,11,TGTCTCAAGTTTCACGGTAC,0,485556
araBp,0.08333333333333333,11,11,TGTCGGGTCTGTGTGTGTTA,0,502771
araBp,0.08333333333333333,11,11,TGTCCAGCGGCATCCTGGAA,0,483621
araBp,0.08333333333333333,11,11,TGTCACGAGGGGGCAGGTCG,0,504113
araBp,0.08333333333333333,11,11,TGTATGTGCACCTCCCTGTA,0,504235
araBp,0.08333333333333333,11,11,TGTATCCGCTTGGTCGCGTC,0,497165
araBp,0.08333333333333333,11,11,TGTATATTCAGATCCAATAA,0,467790
araBp,0.08333333333333333,11,11,TGTACGCTTTCCAAAGTTAT,0,494797
araBp,0.08333333333333333,11,11,TGGTACACTGAGGAGCTCGG,0,493328
araBp,0.08333333333333333,11,11,TGGGTTAGTCCATAGACCGG,0,512938
araBp,0.08333333333333333,11,11,TGGGTACCTTATCGACTTTA,0,492551
araBp,0.08333333333333333,11,11,TGGAGGAGCCAGGGTGGGGT,0,520365
araBp,0.08333333333333333,11,11,TGGACGGAAGCTCCCTAGAG,0,478021
araBp,0.08333333333333333,11,11,TGGACAGAATGTAGTCGCGG,0,498698
araBp,0.08333333333333333,11,11,TGCTGTTCAAGGGCTGCTGG,0,475176
araBp,0.08333333333333333,11,11,TGCGTAAGTTACTTACGATT,0,483004
araBp,0.08333333333333333,11,11,TGCCCAGGTTTTCCCCTGTA,0,496885
araBp,0.08333333333333333,11,11,TGATTATGCATTTTGTTCGT,0,477621
araBp,0.08333333333333333,11,11,TGATCGGTACGAAGATAGGG,0,501214
araBp,0.08333333333333333,11,11,TGACATCTAATCGCATACTC,0,515696
araBp,0.08333333333333333,11,11,TGAAGGGGCCTAGGTGTTAC,0,491351
araBp,0.08333333333333333,11,11,TCTTGCATCAACGGAAGCAG,0,520816
araBp,0.08333333333333333,11,11,TCTGGTCTTCTGAAGTTGTG,0,517209
araBp,0.08333333333333333,11,11,TCTGCAAGCATTGATCTCCC,0,497922
araBp,0.08333333333333333,11,11,TCTGAGACAAGGCTGTCGGA,0,520818
araBp,0.08333333333333333,11,11,TCTGAAGCGCAGTGACCTGC,0,522107
araBp,0.08333333333333333,11,11,TCTCGGTTCCTTATGCGAAG,0,486648
araBp,0.08333333333333333,11,11,TCTCCGAATAATAGGAGGGT,0,523901
araBp,0.08333333333333333,11,11,TCTACTACCTCAGTCTCAAG,0,471688
araBp,0.08333333333333333,11,11,TCGTGGCCACCGCGAGTGAC,0,477833
araBp,0.08333333333333333,11,11,TCGGTAAACCCGGTCGCTAA,0,521836
araBp,0.08333333333333333,11,11,TCGGGATCGTGTATCCGCCA,0,524377
araBp,0.08333333333333333,11,11,TCGGCCACACTATCACCGAG,0,480519
araBp,0.08333333333333333,11,11,TCGCTTGAGGGAACATGGAT,0,505390
araBp,0.08333333333333333,11,11,TCGCCAGCCTACCAGGGGGT,0,496175
araBp,0.08333333333333333,11,11,TCGATGTGACCTTCGGCATT,0,485922
araBp,0.08333333333333333,11,11,TCCTATCATATCGTAGTCGC,0,483577
araBp,0.08333333333333333,11,11,TCCCAATCATGTGCACCTAC,0,486945
araBp,0.08333333333333333,11,11,TCCACCGTAAATAAAGGAGG,0,492462
araBp,0.08333333333333333,11,11,TCATTATCGGATGGACAGGA,0,473845
araBp,0.08333333333333333,11,11,TCATCTGGTAGGGACCGAGG,0,479509
araBp,0.08333333333333333,11,11,TCAGAACAGGCTCGCTGTGT,0,523515
araBp,0.08333333333333333,11,11,TCACTTTAGCGTTAGTATCA,0,468769
araBp,0.08333333333333333,11,11,TCACCGAGAGGGTCCGGGGA,0,511550
araBp,0.08333333333333333,11,11,TCACAGTGCCACCGCCACGC,0,515522
araBp,0.08333333333333333,11,11,TCACAATAGCAAGCTTCCAG,0,514796
araBp,0.08333333333333333,11,11,TCAAGGCACAATCCGATAGT,0,520464
araBp,0.08333333333333333,11,11,TCAAAGATGTTTCACCGGGA,0,486715
araBp,0.08333333333333333,11,11,TATTGTTGTGCACCGTTGCA,0,524152
araBp,0.08333333333333333,11,11,TATCGTAGTATGCCAGCCAA,0,518811
araBp,0.08333333333333333,11,11,TATCAATAAGGTCGGAGAAG,0,523273
araBp,0.08333333333333333,11,11,TATATCCTTGACGTTACGTA,0,494810
araBp,0.08333333333333333,11,11,TATAGAGGTCATTTTAGTGT,0,479584
araBp,0.08333333333333333,11,11,TATAAGTCCGAGATCGACCT,0,485418
araBp,0.08333333333333333,11,11,TAGGCTCGGGGGACGAAATT,0,500134
araBp,0.08333333333333333,11,11,TAGCTTAAGAAGGGAGCCGG,0,478961
araBp,0.08333333333333333,11,11,TAGCCTCTTATCCTAGTATG,0,493922
araBp,0.08333333333333333,11,11,TAGCATATTGTTTAAAGGGT,0,513560
araBp,0.08333333333333333,11,11,TACTGCCGAGATATGTGAGA,0,472214
araBp,0.08333333333333333,11,11,TACTCAGGGTCCCGTGTTTG,0,491111
araBp,0.08333333333333333,11,11,TACGCTCGGCGGCCATTCTT,0,487507
araBp,0.08333333333333333,11,11,TACGAACCATGGACTCTATA,0,487997
araBp,0.08333333333333333,11,11,TACCTGTCAAGCGCGATGGT,0,483449
araBp,0.08333333333333333,11,11,TACCTGACGTATGAGGGCCG,0,469650
araBp,0.08333333333333333,11,11,TACCTCAGTCGGCGGCGGAA,0,521233
araBp,0.08333333333333333,11,11,TACAAAGCCAGGTACGTGGT,0,477808
araBp,0.08333333333333333,11,11,TAATGACCCTGGATACTAGA,0,511322
araBp,0.08333333333333333,11,11,TAATACCGCAAAAAGGGTGA,0,474819
araBp,0.08333333333333333,11,11,TAAGGGTTAGGACACATCGT,0,521499
araBp,0.08333333333333333,11,11,TAAGACACCAGCGTTAGAAA,0,506635
araBp,0.08333333333333333,11,11,TAACTATATGGATCAGGTCT,0,524930
araBp,0.08333333333333333,11,11,TAACCTCGCATACTGAACTC,0,515956
araBp,0.08333333333333333,11,11,GTTTTGGCCGCAGGCAAGGG,0,478984
araBp,0.08333333333333333,11,11,GTTTGAACGAGTGCAGGTAT,0,509107
araBp,0.08333333333333333,11,11,GTTTACGAGCTGGAGCGACT,0,525130
araBp,0.08333333333333333,11,11,GTTGTTGAATTGAATTACAC,0,470220
araBp,0.08333333333333333,11,11,GTTGGACTTCGGTACGTAGT,0,500098
araBp,0.08333333333333333,11,11,GTTCTGCAACCTTACCCTGA,0,508717
araBp,0.08333333333333333,11,11,GTGTGACTGTATTAGCAGAT,0,468236
araBp,0.08333333333333333,11,11,GTGGGTACTTAGTTTGAACG,0,491110
araBp,0.08333333333333333,11,11,GTGGGGATACCGGTGTGAAC,0,519137
araBp,0.08333333333333333,11,11,GTGACTCCTATGACATTGGA,0,483709
araBp,0.08333333333333333,11,11,GTCGCTACTAACATCCTAGA,0,505051
araBp,0.08333333333333333,11,11,GTCCCGGGGGTATGGTCAGT,0,492005
araBp,0.08333333333333333,11,11,GTATTACAGCATCCAAGTCG,0,477424
araBp,0.08333333333333333,11,11,GTATGGCCACGGCCTTCGGT,0,497155
araBp,0.08333333333333333,11,11,GTATAGTTGCTGCCATCATC,0,485014
araBp,0.08333333333333333,11,11,GTATAAATCGAACCGCATAG,0,473565
araBp,0.08333333333333333,11,11,GTAGTTTCGCAATTGAATAG,0,503587
araBp,0.08333333333333333,11,11,GTAGGATGTCTATTAAATGG,0,498878
araBp,0.08333333333333333,11,11,GTAGATAAGGCTATCTGGGA,0,486474
araBp,0.08333333333333333,11,11,GTAATACCGGCTCTATCAGT,0,489498
araBp,0.08333333333333333,11,11,GTAAACGTTATAACAAGTCA,0,500656
araBp,0.08333333333333333,11,11,GGTTGAACAGGACTGCCCGC,0,515489
araBp,0.08333333333333333,11,11,GGTTCACTATCTGGGTTTAT,0,473082
araBp,0.08333333333333333,11,11,GGTGGTCACTTTTACGTCGG,0,493579
araBp,0.08333333333333333,11,11,GGTCTAAGTTCCATATATAC,0,485933
araBp,0.08333333333333333,11,11,GGGTTCTTCATTTTAAACTG,0,516961
araBp,0.08333333333333333,11,11,GGGGGTTAGACCATCTACAC,0,503322
araBp,0.08333333333333333,11,11,GGGGGGGGTTGACTATCTCG,0,473702
araBp,0.08333333333333333,11,11,GGGGACGACATTTTGTGAAC,0,479510
araBp,0.08333333333333333,11,11,GGGCCAATCAAAACTTCGCA,0,476873
araBp,0.08333333333333333,11,11,GGCGTGTTGGAAGAGTAGAC,0,470024
araBp,0.08333333333333333,11,11,GGCGGTGTGGGACACTGCAT,0,521480
araBp,0.08333333333333333,11,11,GGCAAAGATCCAGAAAAGGT,0,476056
araBp,0.08333333333333333,11,11,GGATTTCTCGGATACAACGT,0,503081
araBp,0.08333333333333333,11,11,GGATGCATCTAGTTCGCACC,0,494801
araBp,0.08333333333333333,11,11,GGATCGGCGGGAGAGGCTCA,0,494096
araBp,0.08333333333333333,11,11,GGAACGGCGATCCTGTGAAT,0,506823
araBp,0.08333333333333333,11,11,GCTTTGATAGCGATCCGGTT,0,479352
araBp,0.08333333333333333,11,11,GCTCATCAGGTATGTTGGCA,0,482837
araBp,0.08333333333333333,11,11,GCTCACTTATCTCGCCCCTC,0,501645
araBp,0.08333333333333333,11,11,GCTAGACCATCAAGACTCGC,0,492926
araBp,0.08333333333333333,11,11,GCTACAATTGTGGGTTATTA,0,494857
araBp,0.08333333333333333,11,11,GCGTGTGATACGTCATACTT,0,515865
araBp,0.08333333333333333,11,11,GCGTCAGCATGGCCTCGTGC,0,490677
araBp,0.08333333333333333,11,11,GCGCAACTGGACCCCCAAAA,0,497571
araBp,0.08333333333333333,11,11,GCCTGCCATTCTCCACCCTT,0,483576
araBp,0.08333333333333333,11,11,GCCTAAACTTCGGCTTTCAA,0,485129
araBp,0.08333333333333333,11,11,GCCGTCTACTCAGTGATCTC,0,477987
araBp,0.08333333333333333,11,11,GCCGGATCGACTTGGACGCG,0,508946
araBp,0.08333333333333333,11,11,GCCGAAACACCTCGGAACTC,0,479392
araBp,0.08333333333333333,11,11,GCATGGAGTCAACTTTTACA,0,475138
araBp,0.08333333333333333,11,11,GCATAGATAAGCATACAATA,0,479370
araBp,0.08333333333333333,11,11,GCAGTCTGAAGTACGTATGT,0,484109
araBp,0.08333333333333333,11,11,GCAGGTACTTCCATATGAAA,0,490376
araBp,0.08333333333333333,11,11,GCAGGGCATCTGAGTTTCCG,0,468785
araBp,0.08333333333333333,11,11,GCACGGAATCGGAATCGGGG,0,522092
araBp,0.08333333333333333,11,11,GCAAAATTCGACAGTCCCGA,0,522465
araBp,0.08333333333333333,11,11,GATTGGCGAGTAAGGAGGGT,0,507173
araBp,0.08333333333333333,11,11,GATTCTGCGCAGATCCGCTA,0,478605
araBp,0.08333333333333333,11,11,GATGCAACTAACAGCGCCAC,0,500112
araBp,0.08333333333333333,11,11,GATCCACTTTAAACACCCGC,0,473832
araBp,0.08333333333333333,11,11,GATATGTGCACTTGTACAAC,0,518401
araBp,0.08333333333333333,11,11,GATATACGGCGATAGAGGAC,0,500228
araBp,0.08333333333333333,11,11,GAGTGGCGTTGACTTTATAC,0,489197
araBp,0.08333333333333333,11,11,GAGTAGTCCGATGAAATTAC,0,494760
araBp,0.08333333333333333,11,11,GAGGTACCTGAAGCATGTGA,0,495427
araBp,0.08333333333333333,11,11,GAGGGTTGTCGTTGTTTTGC,0,473827
araBp,0.08333333333333333,11,11,GAGCTCGAGTAGGACTCTTA,0,499256
araBp,0.08333333333333333,11,11,GAGCTAACTCAGTCAGGGAA,0,524211
araBp,0.08333333333333333,11,11,GAGCAGTGCACTCTCTTCGA,0,493466
araBp,0.08333333333333333,11,11,GAGAAGCAACGCGTGATCCT,0,497863
araBp,0.08333333333333333,11,11,GACTGAGCATTAGGCTGAAC,0,490910
araBp,0.08333333333333333,11,11,GACCGCAGGGTTTTATCTGT,0,483152
araBp,0.08333333333333333,11,11,GACACGCCACCCGGTGCCTT,0,506885
araBp,0.08333333333333333,11,11,GACACGCATGTATTAGATGT,0,524655
araBp,0.08333333333333333,11,11,GAATTGAACCTCCGTCTTCT,0,497179
araBp,0.08333333333333333,11,11,GAATGGGCGTGTGTACGTCC,0,468492
araBp,0.08333333333333333,11,11,GAAGCAGAGGGGTAGTTGAA,0,488338
araBp,0.08333333333333333,11,11,GAAGAATGCGTCATATGATT,0,512021
araBp,0.08333333333333333,11,11,GAAAAGGCCGGGTAGCCACA,0,521004
araBp,0.08333333333333333,11,11,CTTTTGTGGGTTAACGTGCG,0,470185
araBp,0.08333333333333333,11,11,CTTTATACATTTCTCACTAA,0,523179
araBp,0.08333333333333333,11,11,CTTGTCTTGCTCTTCCAACA,0,501218
araBp,0.08333333333333333,11,11,CTTATGCATAGAGCAATCGC,0,522934
araBp,0.08333333333333333,11,11,CTGTCTTCGCTGTCCGCTTG,0,516440
araBp,0.08333333333333333,11,11,CTGTCAATTGAGATCCCCTG,0,470235
araBp,0.08333333333333333,11,11,CTGATCATGGCGAATAGAGT,0,523349
araBp,0.08333333333333333,11,11,CTCTTGATCGGGCGGCCGTT,0,502002
araBp,0.08333333333333333,11,11,CTCTGGATGTGCATTTGCGT,0,478336
araBp,0.08333333333333333,11,11,CTCGGGTACAACTTACGCTG,0,485128
araBp,0.08333333333333333,11,11,CTCGCATGGAGTAAGATGGA,0,489524
araBp,0.08333333333333333,11,11,CTCGATTAGATACGCGGTCA,0,522435
araBp,0.08333333333333333,11,11,CTCAGAAGTGGGTTATACCA,0,504903
araBp,0.08333333333333333,11,11,CTCACGAGGATACATCCCGT,0,475913
araBp,0.08333333333333333,11,11,CTAGTCCCGATCTGGCAACT,0,478783
araBp,0.08333333333333333,11,11,CTAGTAGCGAACTAGAATAC,0,469748
araBp,0.08333333333333333,11,11,CTACAGTCCTCACCCTGGCC,0,472446
araBp,0.08333333333333333,11,11,CTACACGATTCGCACTACTT,0,481241
araBp,0.08333333333333333,11,11,CTAACTCGCACAGTGTCGTG,0,478753
araBp,0.08333333333333333,11,11,CTAACCCGGTCTAGTGCCCA,0,479357
araBp,0.08333333333333333,11,11,CGTTTGCCCGACACTACGTG,0,485832
araBp,0.08333333333333333,11,11,CGTTTCGGGGTCGTGGGTAG,0,491811
araBp,0.08333333333333333,11,11,CGTTGCGTTTCACCGAACTT,0,515372
araBp,0.08333333333333333,11,11,CGTGTACACACGTCAGACCA,0,508866
araBp,0.08333333333333333,11,11,CGTGATATGGCCCTGTTAGC,0,485730
araBp,0.08333333333333333,11,11,CGTGACTCTTGCCCGCGAGG,0,497965
araBp,0.08333333333333333,11,11,CGTCTACGGTGGGAAAAAGG,0,475190
araBp,0.08333333333333333,11,11,CGTAATGATATAGCATGCGG,0,522351
araBp,0.08333333333333333,11,11,CGGTTTACAATTTCAGATCC,0,523291
araBp,0.08333333333333333,11,11,CGGTCAGTCCTAATGGCAGG,0,491490
araBp,0.08333333333333333,11,11,CGGTCAAGGCATCAAAGGTT,0,485797
araBp,0.08333333333333333,11,11,CGGGGACAAGATGCGTCTAG,0,487121
araBp,0.08333333333333333,11,11,CGCTCGAGAAGTGAGTTACT,0,522504
araBp,0.08333333333333333,11,11,CGCCCTGAGGGCGGCCCGAT,0,512485
araBp,0.08333333333333333,11,11,CGCCAGTAAATATGAGGATA,0,490660
araBp,0.08333333333333333,11,11,CGCATTAGCTCTGCTGGCGA,0,494968
araBp,0.08333333333333333,11,11,CGCACGAATCGTGCAGGGGT,0,486135
araBp,0.08333333333333333,11,11,CGATTCTTGTCAACCGGGGA,0,474731
araBp,0.08333333333333333,11,11,CGATTCGCAGAAGGCGCGTA,0,518889
araBp,0.08333333333333333,11,11,CGAGTGCAGTTTCAAGCATT,0,516187
araBp,0.08333333333333333,11,11,CGAGGGTCGCCAGCTCCAAG,0,493040
araBp,0.08333333333333333,11,11,CGACAGCTTTCAATAGCAGC,0,480103
araBp,0.08333333333333333,11,11,CCTTTTACATTTTACAGGTC,0,502527
araBp,0.08333333333333333,11,11,CCTTTGCAGCAAAAAAGTGG,0,502727
araBp,0.08333333333333333,11,11,CCTTTGAACTCCCTAGGCTG,0,503896
araBp,0.08333333333333333,11,11,CCTTTAAGGGCGCTGTTTCG,0,492974
araBp,0.08333333333333333,11,11,CCTTCTGTGCTTTGCTGTAG,0,468090
araBp,0.08333333333333333,11,11,CCTTAACAAAGGAGCCTGTC,0,507182
araBp,0.08333333333333333,11,11,CCTCTGGGAAATCACACTAC,0,497625
araBp,0.08333333333333333,11,11,CCTAGGGGACTTCGTGCGGG,0,518757
araBp,0.08333333333333333,11,11,CCGTTCAATGATCTCAGCGG,0,480343
araBp,0.08333333333333333,11,11,CCGGTTTCCCGATGGAGTTA,0,504172
araBp,0.08333333333333333,11,11,CCGATTATCAGTGTTCAAGG,0,474353
araBp,0.08333333333333333,11,11,CCGACTCAGTCGGACATTGC,0,525022
araBp,0.08333333333333333,11,11,CCGAACACTTGTGACGTAGT,0,468568
araBp,0.08333333333333333,11,11,CCCTGGTTGCGCGCCTGCAG,0,525194
araBp,0.08333333333333333,11,11,CCCTGGTCCAACTCGACTGA,0,524021
araBp,0.08333333333333333,11,11,CCCTCAGATATTCAGGATGA,0,493636
araBp,0.08333333333333333,11,11,CCCGTCAAACTCCGTAGGGT,0,474002
araBp,0.08333333333333333,11,11,CCCCCGGGACCGTCCTAGTC,0,507118
araBp,0.08333333333333333,11,11,CCATCTGTATATTTTATCGC,0,471417
araBp,0.08333333333333333,11,11,CCATACCCTACAACGGATGG,0,497242
araBp,0.08333333333333333,11,11,CCAGGAGTATACAGGTCAGA,0,481787
araBp,0.08333333333333333,11,11,CCACGCCGGGCAAACAGTAT,0,518972
araBp,0.08333333333333333,11,11,CCACGAATTTGTTTACCGTA,0,478649
araBp,0.08333333333333333,11,11,CCACCACCAGTTCCGAACCT,0,520503
araBp,0.08333333333333333,11,11,CCAATGAGGGCCGGAAGTCT,0,467919
araBp,0.08333333333333333,11,11,CATGGAACGACATTTCTGCA,0,472500
araBp,0.08333333333333333,11,11,CATGCTTGCGTCCAGATAAG,0,516351
araBp,0.08333333333333333,11,11,CATGCTCGTCGCCTCATGGG,0,523188
araBp,0.08333333333333333,11,11,CATGCGCCTTAGCCAGCCTG,0,480115
araBp,0.08333333333333333,11,11,CATGCCCTAGACGAAACAAG,0,512516
araBp,0.08333333333333333,11,11,CATCCGTCACCTATATCAGG,0,479505
araBp,0.08333333333333333,11,11,CATAGTTCGAGTACTCGGGT,0,498043
araBp,0.08333333333333333,11,11,CAGTGTGAGGTAGATTGGCC,0,515385
araBp,0.08333333333333333,11,11,CAGGTGGATCCATAGACGAA,0,518787
araBp,0.08333333333333333,11,11,CAGGCGTACGAGCTCGGATC,0,517185
araBp,0.08333333333333333,11,11,CAGCCTGTGGTCCTTGCCAA,0,475082
araBp,0.08333333333333333,11,11,CAGCCAGGAACCGACGACTC,0,477149
araBp,0.08333333333333333,11,11,CAGACGGAGATAGTCGTTGA,0,494154
araBp,0.08333333333333333,11,11,CACTGTTTTGTGTTTTTGAA,0,513672
araBp,0.08333333333333333,11,11,CACGGTGACTGTCGTATACT,0,480214
araBp,0.08333333333333333,11,11,CACGGCTTAAACATCCGTGA,0,473658
araBp,0.08333333333333333,11,11,CACCGCCGAAATTCAGCGCA,0,504344
araBp,0.08333333333333333,11,11,CACCGATCTTCGACTGCATC,0,499893
araBp,0.08333333333333333,11,11,CACATGACTTCAGCGTGTTT,0,516555
araBp,0.08333333333333333,11,11,CACATCCTGGGCATTGATTG,0,479483
araBp,0.08333333333333333,11,11,CACACCTCCCCAAATAGGAC,0,477546
araBp,0.08333333333333333,11,11,CAAGGGGCACCCCAAGAACA,0,507425
araBp,0.08333333333333333,11,11,CAAGAGCTGGCACTCTGTGT,0,482592
araBp,0.08333333333333333,11,11,CAACCCGCGTCCCATGGGCG,0,501706
araBp,0.08333333333333333,11,11,CAAACCGGGTATCCAGAAAG,0,509744
araBp,0.08333333333333333,11,11,ATTTCACCCAGACTTCCGTG,0,472502
araBp,0.08333333333333333,11,11,ATTGGTCGGTGATAATACTT,0,473970
araBp,0.08333333333333333,11,11,ATTGCCCTTTGAGGGAAGAT,0,518546
araBp,0.08333333333333333,11,11,ATTGACACACAAATCGGGAA,0,470294
araBp,0.08333333333333333,11,11,ATTCTACCGTCTTTATTCAT,0,474787
araBp,0.08333333333333333,11,11,ATGTGGGTAACCCGCACGAT,0,510689
araBp,0.08333333333333333,11,11,ATGTCTTGGGTGGCAGGTAG,0,483824
araBp,0.08333333333333333,11,11,ATGATTGCCATCATTACTGA,0,468458
araBp,0.08333333333333333,11,11,ATGAATGGAACTGGCAGGCT,0,516784
araBp,0.08333333333333333,11,11,ATCGATTCATCGCATAGGTC,0,480921
araBp,0.08333333333333333,11,11,ATCCGTGTAGGACGGCGCGT,0,487723
araBp,0.08333333333333333,11,11,ATCACCATTAGTGTCGGCCA,0,501571
araBp,0.08333333333333333,11,11,ATATTTCCAATTCCGCGCTA,0,503419
araBp,0.08333333333333333,11,11,ATATCAAACGGCACGGGCTT,0,485768
araBp,0.08333333333333333,11,11,ATAGGCTCGTAGGACGACCC,0,523880
araBp,0.08333333333333333,11,11,ATAGACATCCACGTTTGATT,0,475028
araBp,0.08333333333333333,11,11,ATACATTGTCAATAAGCCCT,0,506840
araBp,0.08333333333333333,11,11,ATACAACTAACTGAACGCGG,0,517598
araBp,0.08333333333333333,11,11,AGTTCTCCCGACTTACGTCC,0,492447
araBp,0.08333333333333333,11,11,AGTTCGCAGCTTAAATAAGT,0,501886
araBp,0.08333333333333333,11,11,AGTGTTCGCTCGGAATCTCT,0,496223
araBp,0.08333333333333333,11,11,AGTGTGCAACGCAGCGAGGT,0,488412
araBp,0.08333333333333333,11,11,AGTGCCAGGTATTGGCCCCC,0,489325
araBp,0.08333333333333333,11,11,AGTCTAGTCTACCGTCTCGG,0,474592
araBp,0.08333333333333333,11,11,AGTCCTCTGGAAGAGTTTAA,0,509729
araBp,0.08333333333333333,11,11,AGTATGTTATGTTCAAAGTG,0,517439
araBp,0.08333333333333333,11,11,AGGTCCAGCGCCGCAAATTA,0,522774
araBp,0.08333333333333333,11,11,AGGTAGATTGAATCTTAGGG,0,486990
araBp,0.08333333333333333,11,11,AGGGTAGACCGTTCTTTGAC,0,471662
araBp,0.08333333333333333,11,11,AGGGGGCCATTAGATGCATG,0,474929
araBp,0.08333333333333333,11,11,AGGGGCTGATAGACCCGATC,0,496902
araBp,0.08333333333333333,11,11,AGGGCAAGTCGCCCGAGGTG,0,496718
araBp,0.08333333333333333,11,11,AGGCTTCCGGTCTGCTAACG,0,519311
araBp,0.08333333333333333,11,11,AGGCTTATTTATGATCTAAG,0,513029
araBp,0.08333333333333333,11,11,AGGACCCACATGCGTCGGAG,0,468616
araBp,0.08333333333333333,11,11,AGGAAAGCAGAACGGTAAAC,0,473032
araBp,0.08333333333333333,11,11,AGCTTCCTGGAAACTGCTAA,0,483385
araBp,0.08333333333333333,11,11,AGCCTGGATTTGGGTAAGTG,0,485795
araBp,0.08333333333333333,11,11,AGCCCTGACCTGGTTCAGAG,0,503429
araBp,0.08333333333333333,11,11,AGCAGACCTGATTGATGTAG,0,514834
araBp,0.08333333333333333,11,11,AGATCCAGGACTAATTGCTG,0,512293
araBp,0.08333333333333333,11,11,AGAGTGTTGACCCCGGCATC,0,474110
araBp,0.08333333333333333,11,11,AGAGTGTAGGTCTAAATCAG,0,480398
araBp,0.08333333333333333,11,11,AGAGTGGGATTATGAGCTTT,0,490198
araBp,0.08333333333333333,11,11,AGAAGGCCTGCGGGGTACCT,0,480949
araBp,0.08333333333333333,11,11,AGAACACAAGTCTATCTTTA,0,483044
araBp,0.08333333333333333,11,11,ACTGGCAGAGATCCTCTTTA,0,511083
araBp,0.08333333333333333,11,11,ACTGCGAACTAAGGTGTACC,0,520735
araBp,0.08333333333333333,11,11,ACTGACAACGGTTTAGGTCT,0,497110
araBp,0.08333333333333333,11,11,ACTCGCGCCGATGTCAGGTC,0,515553
araBp,0.08333333333333333,11,11,ACTCGATGTGATGGAGGAGT,0,489828
araBp,0.08333333333333333,11,11,ACTAACCGTGTGTCGGGTTC,0,511942
araBp,0.08333333333333333,11,11,ACGTTTTATTTAGGTTGCCC,0,487498
araBp,0.08333333333333333,11,11,ACGTTAAACCCCAGCCGGAT,0,510591
araBp,0.08333333333333333,11,11,ACGTCGATGCAAGATCGAAT,0,477089
araBp,0.08333333333333333,11,11,ACGTCACGGGCGTGGAGCTT,0,505416
araBp,0.08333333333333333,11,11,ACGGTCTATGGGTTGCCTTT,0,481827
araBp,0.08333333333333333,11,11,ACGACCCGACCTAAGGCACA,0,473305
araBp,0.08333333333333333,11,11,ACGAAAAGCCAGGTCAATCT,0,508782
araBp,0.08333333333333333,11,11,ACCGGGACTCGGCTAGTGTT,0,510510
araBp,0.08333333333333333,11,11,ACCAAAGAAAGTACCCCTGC,0,489866
araBp,0.08333333333333333,11,11,ACATTATTACAGGGGAATGC,0,507106
araBp,0.08333333333333333,11,11,ACAGTTGGAGTCTTCCTGTA,0,505946
araBp,0.08333333333333333,11,11,ACACTCACAGGGAGAACTTT,0,483180
araBp,0.08333333333333333,11,11,ACACGCTTAGAACCTTTTCG,0,480423
araBp,0.08333333333333333,11,11,ACAACAGTGCGCTTTAGTTC,0,499732
araBp,0.08333333333333333,11,11,AATTTGCATGTTTCCCCCTT,0,476256
araBp,0.08333333333333333,11,11,AATGTGACACGCACACGTAG,0,523086
araBp,0.08333333333333333,11,11,AATGGCCTACTACTGGTGCA,0,467906
araBp,0.08333333333333333,11,11,AATCGAATATTTCGTGAGCC,0,476277
araBp,0.08333333333333333,11,11,AATACGAGAGGAATAGTCTT,0,516763
araBp,0.08333333333333333,11,11,AATAAGGCAGGCAGCATGCA,0,516684
araBp,0.08333333333333333,11,11,AAGTTTTATCTAAGAAGACC,0,490557
araBp,0.08333333333333333,11,11,AAGTGTTATGCGTGTATTCT,0,485947
araBp,0.08333333333333333,11,11,AAGGGAGCCGGTCAAACGCT,0,492694
araBp,0.08333333333333333,11,11,AAGGATAATAGACGATTGTC,0,499854
araBp,0.08333333333333333,11,11,AAGGAGTCAGGATGAAGTCT,0,511252
araBp,0.08333333333333333,11,11,AAGCGATTGTACATCAGAGG,0,514888
araBp,0.08333333333333333,11,11,AAGCAATACATTGAGGCTAA,0,508315
araBp,0.08333333333333333,11,11,AAGCAACAGTTTGGCGCTAA,0,502559
araBp,0.08333333333333333,11,11,AACTGGCTTGCAGGATGTGA,0,500761
araBp,0.08333333333333333,11,11,AACGCGTTACCTGCCATTAG,0,470336
araBp,0.08333333333333333,11,11,AACGACACGCTCGAAGTCGT,0,477189
araBp,0.08333333333333333,11,11,AACAGTATCTAGAGATTTAG,0,472605
araBp,0.08333333333333333,11,11,AACACTTCGAGTAATTCAGA,0,469498
araBp,0.08333333333333333,11,11,AAACTTGAATGGTGGACCAA,0,499727
araBp,0.08333333333333333,11,11,AAACTATCGGGATTTCAGCC,0,473708
araBp,0.09090909090909091,10,10,TTTTTAGGACAGGCGCAACG,0,507128
araBp,0.09090909090909091,10,10,TTTGGCCGGTCAACTAAGGA,0,469210
araBp,0.09090909090909091,10,10,TTTCTTCCCTACAACACGGC,0,516410
araBp,0.09090909090909091,10,10,TTTCGTATAACACACGGGGT,0,518682
araBp,0.09090909090909091,10,10,TTTCGGAAGACCTCGCTTTG,0,507423
araBp,0.09090909090909091,10,10,TTGGCTGGACAAGTTCGGGA,0,486317
araBp,0.09090909090909091,10,10,TTGGCTGCACTTATGATGGA,0,474340
araBp,0.09090909090909091,10,10,TTGGATTTTGGGGGCTCGGC,0,495158
araBp,0.09090909090909091,10,10,TTGGATAGGTGTAAATTGGA,0,480690
araBp,0.09090909090909091,10,10,TTGCCTAGTCTACCGGGCTT,0,468134
araBp,0.09090909090909091,10,10,TTGAGGGTCACCGTTCGATA,0,493585
araBp,0.09090909090909091,10,10,TTGAATGAGATTGACTGTGT,0,501491
araBp,0.09090909090909091,10,10,TTCTATTCTCAAAGTGACTG,0,521890
araBp,0.09090909090909091,10,10,TTCTATATATGCATAATCTT,0,524448
araBp,0.09090909090909091,10,10,TTCCCCCCCGGCCCAGCGTC,0,516922
araBp,0.09090909090909091,10,10,TTCCACTAGAAGCCAAGCCA,0,485297
araBp,0.09090909090909091,10,10,TTATGGACCTCTCTCGCATA,0,473999
araBp,0.09090909090909091,10,10,TTAGGGTGTGGTTTAGTAGA,0,493269
araBp,0.09090909090909091,10,10,TTACTAACGAAGGTTTGAGT,0,485408
araBp,0.09090909090909091,10,10,TTACGTTCTTGGCATACAGT,0,512944
araBp,0.09090909090909091,10,10,TTACCTCTCTGCTAGGGGTA,0,483736
araBp,0.09090909090909091,10,10,TTAATTATTGGGGCCTATAC,0,470177
araBp,0.09090909090909091,10,10,TTAAAAGTGTTCGGGCGGCG,0,506963
araBp,0.09090909090909091,10,10,TGTTCGCAAAAGTCAAGCAT,0,498429
araBp,0.09090909090909091,10,10,TGTGCGTATGGAGGGTCAGC,0,471539
araBp,0.09090909090909091,10,10,TGTCCGGTCCTCCGGACCAA,0,522420
araBp,0.09090909090909091,10,10,TGTATTTGTGCTCCCGTGCC,0,474038
araBp,0.09090909090909091,10,10,TGTATCGGGGCTAATTGACC,0,517722
araBp,0.09090909090909091,10,10,TGGTGCCGCCAGCTAAGGCC,0,516895
araBp,0.09090909090909091,10,10,TGGTCCTAGCACTGGGCTTG,0,506136
araBp,0.09090909090909091,10,10,TGGTCCAAAAAGAGCGCAAC,0,513482
araBp,0.09090909090909091,10,10,TGGGTGTTTGCAATCCTAAC,0,508517
araBp,0.09090909090909091,10,10,TGGGTCAGGATAAGCTCAGG,0,512119
araBp,0.09090909090909091,10,10,TGGGGATCATTCGGTCCCCT,0,515835
araBp,0.09090909090909091,10,10,TGGCAGAGGGAGGTCGGCGA,0,502011
araBp,0.09090909090909091,10,10,TGGCACCCGTATTGGCTGAG,0,475158
araBp,0.09090909090909091,10,10,TGGATAACAGGGCTTACTGG,0,475163
araBp,0.09090909090909091,10,10,TGGACTTGTATAATTTACGT,0,479382
araBp,0.09090909090909091,10,10,TGGAACGTTCCCCAGAGGCT,0,495786
araBp,0.09090909090909091,10,10,TGGAACAAGCGGGGACTGAT,0,519531
araBp,0.09090909090909091,10,10,TGCGGTAAGATCCGTCGGCG,0,512651
araBp,0.09090909090909091,10,10,TGCGGCAAATGAAATAGAGA,0,478457
araBp,0.09090909090909091,10,10,TGCAATGGGCGCCCAGCCCG,0,490423
araBp,0.09090909090909091,10,10,TGATATCTTCGGAAACTTTG,0,483332
araBp,0.09090909090909091,10,10,TGAGGGTCACTCTATAGAAT,0,480041
araBp,0.09090909090909091,10,10,TGAGCCTAATCCCGATGTCT,0,471702
araBp,0.09090909090909091,10,10,TGACTCTTTATTCTGTCAAC,0,510609
araBp,0.09090909090909091,10,10,TGAAGGAGAATATCAGATTA,0,510128
araBp,0.09090909090909091,10,10,TGAAGACTAATCCTCATTGC,0,502859
araBp,0.09090909090909091,10,10,TGAAACTCGGTACCGCCCTT,0,478759
araBp,0.09090909090909091,10,10,TCTTGACAGCCAGCTTTCTA,0,518045
araBp,0.09090909090909091,10,10,TCTGACTCGAGATGTGGATT,0,469309
araBp,0.09090909090909091,10,10,TCTCCCGAGCTCACTGGGAT,0,485948
araBp,0.09090909090909091,10,10,TCTATGTCTGGAACTTGCAA,0,495102
araBp,0.09090909090909091,10,10,TCTAACAAGGGCATCGGGGT,0,510052
araBp,0.09090909090909091,10,10,TCGTTAAAAGGCCTCCTCTT,0,514965
araBp,0.09090909090909091,10,10,TCGTACGTGGCCAGTCTTAG,0,480334
araBp,0.09090909090909091,10,10,TCGGGTAGAAGTAACGGCTG,0,482209
araBp,0.09090909090909091,10,10,TCGGGGTCAATCTACGAGTA,0,517344
araBp,0.09090909090909091,10,10,TCGGCCATTACGCATAATAG,0,476458
araBp,0.09090909090909091,10,10,TCGGCACACGAGTTATCGGG,0,522827
araBp,0.09090909090909091,10,10,TCGCGCGCACATCTTGAGCG,0,493168
araBp,0.09090909090909091,10,10,TCGAGTTATAGATCTTTAAT,0,481548
araBp,0.09090909090909091,10,10,TCCTAGTATCGACAAAGATA,0,504227
araBp,0.09090909090909091,10,10,TCCGGTGGCATTTTCGGGGT,0,487395
araBp,0.09090909090909091,10,10,TCATTTCACAGAACCTTAAC,0,520949
araBp,0.09090909090909091,10,10,TCATCGCGTCGTGTACGGAC,0,521077
araBp,0.09090909090909091,10,10,TCATCGCCAGCTCTTTAGCA,0,496371
araBp,0.09090909090909091,10,10,TCATAAGCCTTCTCGAAAGT,0,523425
araBp,0.09090909090909091,10,10,TCAGGCGCTGTATTTTTCTA,0,504180
araBp,0.09090909090909091,10,10,TCACTGAGCATGTCGTCGCT,0,517151
araBp,0.09090909090909091,10,10,TCACCGTATGTCGGAAGCAG,0,514758
araBp,0.09090909090909091,10,10,TCAATGACAGTGATTTTGAA,0,519108
araBp,0.09090909090909091,10,10,TATTATCCTAATGCACGGCT,0,479008
araBp,0.09090909090909091,10,10,TATTATCCAGCCGTTGTACA,0,473657
araBp,0.09090909090909091,10,10,TATGTGGAAAGCCGGTGGTG,0,468937
araBp,0.09090909090909091,10,10,TATGGCTCACAAGGGGGTTA,0,510445
araBp,0.09090909090909091,10,10,TATGCACGTCACGTATAGTT,0,500915
araBp,0.09090909090909091,10,10,TATCCACACGGAGAATGGCG,0,508624
araBp,0.09090909090909091,10,10,TAGGTTTATTATGGAATTGC,0,495719
araBp,0.09090909090909091,10,10,TAGGGCCGTATCTCCAGCCC,0,495485
araBp,0.09090909090909091,10,10,TAGCGAGCAAGAGATATCTC,0,490460
araBp,0.09090909090909091,10,10,TAGCCGGCGGCAAATGTGCC,0,496542
araBp,0.09090909090909091,10,10,TAGCATTATCCTAGCAACAT,0,516824
araBp,0.09090909090909091,10,10,TACTCCTGCAGAGGCAGCTA,0,506484
araBp,0.09090909090909091,10,10,TACGGTCCCCGGACACTCAT,0,468796
araBp,0.09090909090909091,10,10,TACCATAGGCATATAAGTTT,0,522940
araBp,0.09090909090909091,10,10,TACAGGAGCTATCCGTCGGC,0,520186
araBp,0.09090909090909091,10,10,TACAAGAAGTCAATTCATTC,0,514481
araBp,0.09090909090909091,10,10,TAATACCCGGCTCGACACCG,0,491914
araBp,0.09090909090909091,10,10,TAACGATACCGCAACCCGGT,0,470760
araBp,0.09090909090909091,10,10,TAAAACAGTCTCTAGGCAGA,0,476001
araBp,0.09090909090909091,10,10,GTTTTGGCAACCCATATCGT,0,475175
araBp,0.09090909090909091,10,10,GTTTGTTCCAAGTAATACAT,0,503277
araBp,0.09090909090909091,10,10,GTTATTTTGTCATTGCCGGC,0,489677
araBp,0.09090909090909091,10,10,GTGGGCCTGTCGCGAGACCC,0,511551
araBp,0.09090909090909091,10,10,GTGGCCTGGCTTTATGATAC,0,499765
araBp,0.09090909090909091,10,10,GTGCCTCTCAAATGAACCAA,0,521451
araBp,0.09090909090909091,10,10,GTGCCCCGGGAATTACAATA,0,507877
araBp,0.09090909090909091,10,10,GTGCATCCAATCCTTGATAG,0,478404
araBp,0.09090909090909091,10,10,GTGCACATCGCACCAGAGGC,0,516276
araBp,0.09090909090909091,10,10,GTGATAAAGATGAACATCGA,0,509003
araBp,0.09090909090909091,10,10,GTCTTAGATAGTGCTTAGAA,0,518177
araBp,0.09090909090909091,10,10,GTCTCGGTCGAACGCTTAAG,0,492791
araBp,0.09090909090909091,10,10,GTCCTGAGTCTAAGCAATTG,0,474377
araBp,0.09090909090909091,10,10,GTCCTAATTGTCCCTGCAAG,0,523091
araBp,0.09090909090909091,10,10,GTCAGTCAGCAAATAACCAG,0,505850
araBp,0.09090909090909091,10,10,GTCAACTAGCGGGCATGCGA,0,474250
araBp,0.09090909090909091,10,10,GTATCCGTAATGACGTTTTT,0,500729
araBp,0.09090909090909091,10,10,GTACCGCTCACCCAGCATGA,0,485683
araBp,0.09090909090909091,10,10,GTAATTGAAAGGAGCCACTA,0,521917
araBp,0.09090909090909091,10,10,GTAATCCATTCTGAAAGAGC,0,497587
araBp,0.09090909090909091,10,10,GTAATAAGAAGTTCTGCTAA,0,499146
araBp,0.09090909090909091,10,10,GTAACGACCGTGCGGTCGAT,0,512360
araBp,0.09090909090909091,10,10,GGTTTTCAGCCGAAAATCGT,0,474323
araBp,0.09090909090909091,10,10,GGTTTAGGCCCGTGGTCTGT,0,501117
araBp,0.09090909090909091,10,10,GGTTATTGCACCATTGTGGG,0,492819
araBp,0.09090909090909091,10,10,GGTGTCGGGAGACAGATAAA,0,525156
araBp,0.09090909090909091,10,10,GGTGCTACGCATGGGAAAAA,0,488516
araBp,0.09090909090909091,10,10,GGTGCCGGAGGTACCGTGAA,0,492731
araBp,0.09090909090909091,10,10,GGTCGTGTCGTGCTCTGGAT,0,472380
araBp,0.09090909090909091,10,10,GGTCAGCGCGGTTAATTTCA,0,519569
araBp,0.09090909090909091,10,10,GGTCAATGACGCGTCTTGTG,0,517218
araBp,0.09090909090909091,10,10,GGTATTGTTAGCTCGCGATT,0,498954
araBp,0.09090909090909091,10,10,GGTATCTGTTGAACTCCGAA,0,486271
araBp,0.09090909090909091,10,10,GGTATACACTGCAGCGGGAG,0,524090
araBp,0.09090909090909091,10,10,GGTACAACCCTGGGGCTCTA,0,498997
araBp,0.09090909090909091,10,10,GGGTCAGCTACCATGCTGGT,0,517251
araBp,0.09090909090909091,10,10,GGGTAGGGACACTGCATGGT,0,487456
araBp,0.09090909090909091,10,10,GGGTAGATCGAAGCCGCTTG,0,501601
araBp,0.09090909090909091,10,10,GGGGTCGTTAAACGCTACTC,0,489447
araBp,0.09090909090909091,10,10,GGGGACAATTCTCAATGTTT,0,468883
araBp,0.09090909090909091,10,10,GGGCGCTGTCCTTCAAGGCT,0,522101
araBp,0.09090909090909091,10,10,GGGACTGATGTAGACCGGTA,0,487976
araBp,0.09090909090909091,10,10,GGCTTCGGCCTGTACATTAT,0,472672
araBp,0.09090909090909091,10,10,GGCTTATCTTACAACGGGGA,0,499398
araBp,0.09090909090909091,10,10,GGCTCGGCCGTTCTCGTCAG,0,476086
araBp,0.09090909090909091,10,10,GGCTATGACAAGAATTCCGT,0,503367
araBp,0.09090909090909091,10,10,GGCTATAAGCGGCCTCACGT,0,510553
araBp,0.09090909090909091,10,10,GGCGATAGGAGACCCTTCTA,0,502531
araBp,0.09090909090909091,10,10,GGCCGGTACCCTTGACCTTT,0,509142
araBp,0.09090909090909091,10,10,GGCCCGGAGCGCTGCCCCAC,0,521631
araBp,0.09090909090909091,10,10,GGCCCATCACGCGGTAGGCT,0,518244
araBp,0.09090909090909091,10,10,GGCCAACGCCAGCGACGTGT,0,485815
araBp,0.09090909090909091,10,10,GGCAGATGAGTTAAAAAGCA,0,511368
araBp,0.09090909090909091,10,10,GGATGCGGTGATGTTACTGA,0,490438
araBp,0.09090909090909091,10,10,GGATCTCAGTCCGGGTCGTC,0,476868
araBp,0.09090909090909091,10,10,GGATAGTGGGCACTTGGTGT,0,495111
araBp,0.09090909090909091,10,10,GGAGTTCGACGGTAAATGAT,0,522970
araBp,0.09090909090909091,10,10,GGAGTTAACCAGAGAAGCAC,0,500554
araBp,0.09090909090909091,10,10,GGAGCGCGGGGTATGAATGA,0,476961
araBp,0.09090909090909091,10,10,GCTATCCATTAAAGGCTGTC,0,487730
araBp,0.09090909090909091,10,10,GCTAAGTCGAATGCTAAAGA,0,473969
araBp,0.09090909090909091,10,10,GCTAACCCAGCCAATTCCGA,0,495717
araBp,0.09090909090909091,10,10,GCGTTTTTTTCACCTTCTGC,0,479866
araBp,0.09090909090909091,10,10,GCGTAGACGAGACCTTTAAC,0,495507
araBp,0.09090909090909091,10,10,GCGCAACAGCGACTACTCCA,0,468353
araBp,0.09090909090909091,10,10,GCGAGAAAGGACTCGCCACC,0,471267
araBp,0.09090909090909091,10,10,GCCTCAATTCGATAGCACTT,0,473973
araBp,0.09090909090909091,10,10,GCCGTAGTAACCCGCTGTGT,0,469102
araBp,0.09090909090909091,10,10,GCCGCGTAAGCACGAACGCT,0,497184
araBp,0.09090909090909091,10,10,GCAGAAATCTAGTCGCGCCA,0,479664
araBp,0.09090909090909091,10,10,GCACCGCTGGCCTGTCGTGT,0,487370
araBp,0.09090909090909091,10,10,GCACCATGTACCTTTGTGAA,0,501709
araBp,0.09090909090909091,10,10,GCAAGTAGGTGGAGAAGAAT,0,502136
araBp,0.09090909090909091,10,10,GCAAAGCATCTAAAGGGAGA,0,522662
araBp,0.09090909090909091,10,10,GATGGGGAAGTGTCTATTGA,0,492198
araBp,0.09090909090909091,10,10,GATCTAACCTCCAGCCACTT,0,471773
araBp,0.09090909090909091,10,10,GATCCGTTATTCTTTCGGCG,0,508761
araBp,0.09090909090909091,10,10,GATAGAACAATCCCGCTGGT,0,472796
araBp,0.09090909090909091,10,10,GAGGTTCCAGGCTACTAGGT,0,472999
araBp,0.09090909090909091,10,10,GAGCTTCGTATCGCATGGCG,0,497830
araBp,0.09090909090909091,10,10,GAGCTGGATTACGTGATGCT,0,483212
araBp,0.09090909090909091,10,10,GAGCCGGAAAAGCACCCTCT,0,479123
araBp,0.09090909090909091,10,10,GAGCAGGTTGGACCTTCTCT,0,485790
araBp,0.09090909090909091,10,10,GAGAATACCGGCAAGGCTGT,0,500222
araBp,0.09090909090909091,10,10,GAGAAGGCCTGCAAGCAAAG,0,501865
araBp,0.09090909090909091,10,10,GACGGAGGCCAGCGTATCTG,0,472315
araBp,0.09090909090909091,10,10,GACGGAGCAGGCCTATCACA,0,495605
araBp,0.09090909090909091,10,10,GACCTCTGTCGTGATCCCCC,0,497153
araBp,0.09090909090909091,10,10,GACCGTAGGGATATTACTCA,0,474691
araBp,0.09090909090909091,10,10,GAAGGTCCACCTGGGAATGC,0,490394
araBp,0.09090909090909091,10,10,GAAGGAGGGTGCTCATACAG,0,472129
araBp,0.09090909090909091,10,10,GAAGCTCTTCGAGCAGCCTT,0,483187
araBp,0.09090909090909091,10,10,GAAGCCTTCAGCGTACAACG,0,507525
araBp,0.09090909090909091,10,10,GAAACTCAGCGTGTAGCTAT,0,471145
araBp,0.09090909090909091,10,10,CTTTTATTCAGAGTCAGGGT,0,471446
araBp,0.09090909090909091,10,10,CTTGGTGCGAAGCATAGCGG,0,502823
araBp,0.09090909090909091,10,10,CTTGGCTTCCCCGCTCCTCC,0,520663
araBp,0.09090909090909091,10,10,CTTCTGGATGATCGAACTCT,0,484068
araBp,0.09090909090909091,10,10,CTTCCGCTCTAAAAAACTAA,0,507900
araBp,0.09090909090909091,10,10,CTTCCCACTATAGCGCATAG,0,492155
araBp,0.09090909090909091,10,10,CTTCCAAGTTTGTGGATCCG,0,503312
araBp,0.09090909090909091,10,10,CTTCAGTCACCTGTTCTCGG,0,503638
araBp,0.09090909090909091,10,10,CTGTTAGGAACCTTACCGCT,0,495785
araBp,0.09090909090909091,10,10,CTGTCACAGTGTCTCGCTTC,0,479565
araBp,0.09090909090909091,10,10,CTGGTAGGTTAACCATCGTT,0,509780
araBp,0.09090909090909091,10,10,CTGGGCAGTTGGGGGTTCAT,0,511502
araBp,0.09090909090909091,10,10,CTGGCATCATAGACCGGCTT,0,500332
araBp,0.09090909090909091,10,10,CTGGATGGCCAATACCCTAC,0,503331
araBp,0.09090909090909091,10,10,CTGGAACGTGTGTAAGCTCG,0,498917
araBp,0.09090909090909091,10,10,CTGAGTCATATTGCCGAAGT,0,506721
araBp,0.09090909090909091,10,10,CTCTCTGCCGTCGTGGAGGC,0,511033
araBp,0.09090909090909091,10,10,CTCTAGGGTAAGTTTAAAAT,0,499387
araBp,0.09090909090909091,10,10,CTCGGATCCCTTTTGACCAG,0,503019
araBp,0.09090909090909091,10,10,CTCACGAGATAGCACGGTGG,0,495117
araBp,0.09090909090909091,10,10,CTATGAGAGCTGCAAGCCGT,0,481625
araBp,0.09090909090909091,10,10,CTATCACAAGGGGTGGACTG,0,487346
araBp,0.09090909090909091,10,10,CTAGCAGAGTATGAGAGTGT,0,504222
araBp,0.09090909090909091,10,10,CTAGATATATGGACTCGGGT,0,474651
araBp,0.09090909090909091,10,10,CTACGTACCGCGAGAGCAGC,0,469287
araBp,0.09090909090909091,10,10,CTAAGTCATATGAACCCCGT,0,480102
araBp,0.09090909090909091,10,10,CGTTTTATCTGTCTATGTGT,0,498272
araBp,0.09090909090909091,10,10,CGTTGCGTTAAAGCGGTATT,0,473257
araBp,0.09090909090909091,10,10,CGTTAGGAGAAGCCCCTCAC,0,492183
araBp,0.09090909090909091,10,10,CGTGTTGACAATGAAATAGC,0,518493
araBp,0.09090909090909091,10,10,CGTGTACCTTGTGAACGCTA,0,502997
araBp,0.09090909090909091,10,10,CGTCTATATGAGTGACCAGC,0,505696
araBp,0.09090909090909091,10,10,CGTCCGGTGCGTAACACGAT,0,514791
araBp,0.09090909090909091,10,10,CGTCAGCGTGGTCTTCATAA,0,508550
araBp,0.09090909090909091,10,10,CGTAGTCTAGCAACACGCAT,0,520831
araBp,0.09090909090909091,10,10,CGGTTCCCCAAGCGAGAAAG,0,512375
araBp,0.09090909090909091,10,10,CGGTAGCTGGGTACATTCTA,0,489996
araBp,0.09090909090909091,10,10,CGGCGGTATCAGCTCGCGTA,0,470913
araBp,0.09090909090909091,10,10,CGGCCTCGTACGCTTTTTAT,0,497905
araBp,0.09090909090909091,10,10,CGCTTGTCCCCACTATTGTT,0,481662
araBp,0.09090909090909091,10,10,CGCTTAGTTACCTGGCGCAT,0,480521
araBp,0.09090909090909091,10,10,CGCTGCTGTGCTCTTATGTT,0,483608
araBp,0.09090909090909091,10,10,CGCCGGCGACTCTGGTCGGA,0,509050
araBp,0.09090909090909091,10,10,CGCAGTTGCGGGAGTCGAAT,0,499306
araBp,0.09090909090909091,10,10,CGATTACGTGGTAATTAAAT,0,512816
araBp,0.09090909090909091,10,10,CGATCCCAAGCCTCGGGGGG,0,477186
araBp,0.09090909090909091,10,10,CGAGCTTTTTGATAGCCTGT,0,521768
araBp,0.09090909090909091,10,10,CGAGATTCATCGAACTTCAC,0,508441
araBp,0.09090909090909091,10,10,CGACTTCGGCACAATCGCTA,0,520463
araBp,0.09090909090909091,10,10,CGACGGTTCGTTGCCGTGTT,0,507923
araBp,0.09090909090909091,10,10,CGACAATAGTTAGCCCGCTA,0,492040
araBp,0.09090909090909091,10,10,CGAACGGCGGACCGCGTCGG,0,476410
araBp,0.09090909090909091,10,10,CCTTCTCATACACCAATCGA,0,482635
araBp,0.09090909090909091,10,10,CCTGTAATCTGATCGCTAAT,0,481140
araBp,0.09090909090909091,10,10,CCTGTAAATCCTGGTTCATG,0,521482
araBp,0.09090909090909091,10,10,CCTCTGGCGACAGGGATGGT,0,498512
araBp,0.09090909090909091,10,10,CCTCGAATAAATTTAATAGA,0,518282
araBp,0.09090909090909091,10,10,CCGTTGAAATACATCAACAA,0,468563
araBp,0.09090909090909091,10,10,CCGTGGCGGGACAATTCTAC,0,479976
araBp,0.09090909090909091,10,10,CCGGTATCAATCCCGGCCCA,0,484867
araBp,0.09090909090909091,10,10,CCGGAATGTAAATTCAGTTA,0,477445
araBp,0.09090909090909091,10,10,CCGCCTTATGTTGAATTCCA,0,488615
araBp,0.09090909090909091,10,10,CCGCATAGAAGCGGATAGCA,0,510720
araBp,0.09090909090909091,10,10,CCCTTACGCACGATTTTAGG,0,484853
araBp,0.09090909090909091,10,10,CCCTGCGCGTTCTCCCGATG,0,471406
araBp,0.09090909090909091,10,10,CCCTGATCGGTCCTAGGCCC,0,509640
araBp,0.09090909090909091,10,10,CCCGAATAGGGATGAATCGT,0,477929
araBp,0.09090909090909091,10,10,CCCCCCGTGTGTGAGGTGTT,0,506205
araBp,0.09090909090909091,10,10,CCCCAGCCGTAGCTAAGTGA,0,483803
araBp,0.09090909090909091,10,10,CCCAGGTGCGGGAGCCCGGA,0,494195
araBp,0.09090909090909091,10,10,CCATTCCTACCACAAGACTG,0,482160
araBp,0.09090909090909091,10,10,CCAGTGATACGGCGCGCAGC,0,480536
araBp,0.09090909090909091,10,10,CCAGGCAGCAGGTCCGTCGG,0,510167
araBp,0.09090909090909091,10,10,CCAGGATAATCAGTTTCACT,0,502133
araBp,0.09090909090909091,10,10,CCACTTGGATAATCCATACC,0,497724
araBp,0.09090909090909091,10,10,CCACCTCCCTCCAGTATTTA,0,495275
araBp,0.09090909090909091,10,10,CCAACACTGATGGCATATTA,0,515966
araBp,0.09090909090909091,10,10,CATCGTCAATAGCTGTCAGG,0,504089
araBp,0.09090909090909091,10,10,CATATATGCCTCTTGAGACT,0,483209
araBp,0.09090909090909091,10,10,CAGTTAGGGATAGGAACGTT,0,507966
araBp,0.09090909090909091,10,10,CAGTGCGCAGCCCTCATAGT,0,471632
araBp,0.09090909090909091,10,10,CAGTGAGCCGCCAGCTAATC,0,497374
araBp,0.09090909090909091,10,10,CAGTCTGGTGCGAAGATCAA,0,511165
araBp,0.09090909090909091,10,10,CAGGTGTATGGATAGATTTA,0,467991
araBp,0.09090909090909091,10,10,CAGGTGTACAAACCTCAGCA,0,488272
araBp,0.09090909090909091,10,10,CAGGGTTAAACCTCCTGCGA,0,497428
araBp,0.09090909090909091,10,10,CAGGGGTTGCTCCATAGAAG,0,507894
araBp,0.09090909090909091,10,10,CAGCATCATTAACTAAGCAG,0,508291
araBp,0.09090909090909091,10,10,CAGATCTTTTCGAGCCAATC,0,524528
araBp,0.09090909090909091,10,10,CAGAGAACACATCAAAGAGA,0,474113
araBp,0.09090909090909091,10,10,CACTCGTGTAATCATTGTGG,0,470341
araBp,0.09090909090909091,10,10,CACGCCGAATGATCGGATTA,0,510190
araBp,0.09090909090909091,10,10,CACGCCACATAATGGGTCCT,0,477589
araBp,0.09090909090909091,10,10,CACCATTGATCGCTTTTCCA,0,498059
araBp,0.09090909090909091,10,10,CACAGGTGTAAGAGGCTCAA,0,505771
araBp,0.09090909090909091,10,10,CACACCGTGTGCCCAGCAAG,0,517779
araBp,0.09090909090909091,10,10,CACACACGGGCGAATACCAT,0,509457
araBp,0.09090909090909091,10,10,CAATTAGGCAAGCACTGCGC,0,524451
araBp,0.09090909090909091,10,10,CAATGACCACGAAAGTTTGC,0,467978
araBp,0.09090909090909091,10,10,CAATCGGGTTGGGTAGTTTG,0,496769
araBp,0.09090909090909091,10,10,CAAGTCGTCATCAGAGGTGC,0,488251
araBp,0.09090909090909091,10,10,CAAGGAGATGCCCCAGTGAC,0,509979
araBp,0.09090909090909091,10,10,CAAGATGATAGAGGAAAGAT,0,512478
araBp,0.09090909090909091,10,10,CAAGATCATAATGTCGCACG,0,515737
araBp,0.09090909090909091,10,10,CAACCAGCAGGACTAAACGG,0,501160
araBp,0.09090909090909091,10,10,ATTTTGTCAATATGGGGTTA,0,521949
araBp,0.09090909090909091,10,10,ATTTTCATAATGAATTGGAT,0,481678
araBp,0.09090909090909091,10,10,ATTTGAGCAGCTATACGTCT,0,519216
araBp,0.09090909090909091,10,10,ATTTACTCCGAGGGATAGCT,0,506535
araBp,0.09090909090909091,10,10,ATTGACGGCGAAAGTTGTAG,0,482743
araBp,0.09090909090909091,10,10,ATTCGCCGGCGTCTGTACAC,0,521061
araBp,0.09090909090909091,10,10,ATTCGACCCAAGCTGCATAA,0,523071
araBp,0.09090909090909091,10,10,ATTCCTGCCTTGGTATTGGA,0,487230
araBp,0.09090909090909091,10,10,ATTATAGAAGCGGTATTCTG,0,506239
araBp,0.09090909090909091,10,10,ATTAAGGCTGGCTTGGGGAG,0,489155
araBp,0.09090909090909091,10,10,ATGTGCGGATAATGCGCTGG,0,516465
araBp,0.09090909090909091,10,10,ATGGGCTATTAGATGTAAGG,0,502935
araBp,0.09090909090909091,10,10,ATGGATGACCCTGATGGGCG,0,523928
araBp,0.09090909090909091,10,10,ATGCACGGTCATGGCTGTTA,0,467828
araBp,0.09090909090909091,10,10,ATCTCAGCAACCGACTTCAT,0,499928
araBp,0.09090909090909091,10,10,ATCTCAACATTGTGTTTAAG,0,522672
araBp,0.09090909090909091,10,10,ATCGGAGGTTAGGATGTAAC,0,501650
araBp,0.09090909090909091,10,10,ATCCGATCGCTTATATACGT,0,494872
araBp,0.09090909090909091,10,10,ATCAGGGGTGTCTTCTCTGC,0,495573
araBp,0.09090909090909091,10,10,ATATGCCAGTTATATAAACG,0,514032
araBp,0.09090909090909091,10,10,ATAGTCCAGCTCACTTATAT,0,486691
araBp,0.09090909090909091,10,10,ATAGTACCCCTGGTTCCCGC,0,470825
araBp,0.09090909090909091,10,10,ATAGCGGAGGGCTGACACCT,0,488163
araBp,0.09090909090909091,10,10,ATACTCACACACTGCGGCGG,0,486172
araBp,0.09090909090909091,10,10,ATACCTGCACGGATGCACGC,0,484492
araBp,0.09090909090909091,10,10,AGTTATCGTTGAATATAGGC,0,488576
araBp,0.09090909090909091,10,10,AGTTAATAGTCACGCGTAAT,0,513313
araBp,0.09090909090909091,10,10,AGTGTTACCATAAAGTTCAC,0,513800
araBp,0.09090909090909091,10,10,AGTCGCCACCTTATTGTGTA,0,473101
araBp,0.09090909090909091,10,10,AGTCGATGGCCGTAAAAGCA,0,481990
araBp,0.09090909090909091,10,10,AGTCCGTTCATTGGGCTCGT,0,508672
araBp,0.09090909090909091,10,10,AGTCCGCGGTTCGGAGCTTT,0,478880
araBp,0.09090909090909091,10,10,AGTATGCTTAGTTGATCGAG,0,503249
araBp,0.09090909090909091,10,10,AGTATAGGTCAATTAATATG,0,522166
araBp,0.09090909090909091,10,10,AGTACGCTAGGGGTACTCTG,0,505446
araBp,0.09090909090909091,10,10,AGGTTAATAATAGACACTTC,0,473008
araBp,0.09090909090909091,10,10,AGGTAATTTAACAAGCAGGA,0,499085
araBp,0.09090909090909091,10,10,AGGCGCACCTGCTTCAGTAA,0,509145
araBp,0.09090909090909091,10,10,AGGCATAGATTCGTCATGAG,0,502864
araBp,0.09090909090909091,10,10,AGGAATCACGGGCTTGGATG,0,508814
araBp,0.09090909090909091,10,10,AGCTGGTATCTGTGGCAGCA,0,487374
araBp,0.09090909090909091,10,10,AGCTGGGACATGATCATTCA,0,493796
araBp,0.09090909090909091,10,10,AGCGTGTAAACTTATACTTC,0,489753
araBp,0.09090909090909091,10,10,AGCAGGCTGCTGAATCCCTC,0,512625
araBp,0.09090909090909091,10,10,AGCACAGTTTTCGTGTTGTG,0,471175
araBp,0.09090909090909091,10,10,AGAGCAATATTTAGTCTCAT,0,486589
araBp,0.09090909090909091,10,10,AGACGACCCCAGTCTTACCT,0,489673
araBp,0.09090909090909091,10,10,AGAATTTCTGCAACGTCCCC,0,505062
araBp,0.09090909090909091,10,10,ACTTGGAATTTCAGACGGAT,0,494013
araBp,0.09090909090909091,10,10,ACTGTTAGTTGTCTTTATGT,0,473335
araBp,0.09090909090909091,10,10,ACTGGGTTTTTGTCTAGTCT,0,514144
araBp,0.09090909090909091,10,10,ACTGGCTTTAGCTGTACGAA,0,484441
araBp,0.09090909090909091,10,10,ACTGCAAAGCGGGAATTGGA,0,490806
araBp,0.09090909090909091,10,10,ACTGAGCTAAATATGCCTGG,0,502863
araBp,0.09090909090909091,10,10,ACTGAACGCTGTGGGGCGGT,0,478031
araBp,0.09090909090909091,10,10,ACTCAGTACTGCTGAGTTCT,0,498425
araBp,0.09090909090909091,10,10,ACTATTCAGGTTAGTCTTCC,0,510878
araBp,0.09090909090909091,10,10,ACGTAGAGGCAAAAGCTGAT,0,505210
araBp,0.09090909090909091,10,10,ACGCGTTCATACCCGGACTT,0,492533
araBp,0.09090909090909091,10,10,ACGCGATGGTGGTCCATTAT,0,488549
araBp,0.09090909090909091,10,10,ACGCCCGCCTATCTAAGGGG,0,480999
araBp,0.09090909090909091,10,10,ACGATTTCGCGTCAGAGAGC,0,485409
araBp,0.09090909090909091,10,10,ACGATAACCTAAGTTTAGAT,0,509162
araBp,0.09090909090909091,10,10,ACGAGAGGATCGAACTCCAT,0,499613
araBp,0.09090909090909091,10,10,ACGAACCCTATCAGTCCCAA,0,524678
araBp,0.09090909090909091,10,10,ACCTTCAGGATTACCCATAC,0,509556
araBp,0.09090909090909091,10,10,ACCTGCGGCTGGTTATTCTT,0,469881
araBp,0.09090909090909091,10,10,ACCGTAATTGGCAACCCGTA,0,474916
araBp,0.09090909090909091,10,10,ACCGGTTACATATATTTAGG,0,481522
araBp,0.09090909090909091,10,10,ACCGCAGCATCCCGGAATTT,0,505130
araBp,0.09090909090909091,10,10,ACCGAGGGCGTTACAAATTC,0,490270
araBp,0.09090909090909091,10,10,ACCACTAAACATCTTCCTGA,0,474000
araBp,0.09090909090909091,10,10,ACATGCAGGTTAGGGCATTA,0,523405
araBp,0.09090909090909091,10,10,ACATCGGGTCCCTTCCTGTT,0,497290
araBp,0.09090909090909091,10,10,ACATCCTGGACGTCGGGAGT,0,518722
araBp,0.09090909090909091,10,10,ACAGGCATACTCGAAGACGT,0,518154
araBp,0.09090909090909091,10,10,ACACTAAGAAGCGTTGTCGC,0,509504
araBp,0.09090909090909091,10,10,ACACAAGTGAATTAACAATC,0,481683
araBp,0.09090909090909091,10,10,ACAATTATGTGTGAAATAGG,0,523436
araBp,0.09090909090909091,10,10,AATTTCCCGGGTTTTGCAGG,0,522296
araBp,0.09090909090909091,10,10,AATGGGATGCTTGTCCCCGC,0,471811
araBp,0.09090909090909091,10,10,AATGCCAAGCCTGCCTAAAT,0,477340
araBp,0.09090909090909091,10,10,AATGCATACAAGGCTGATAT,0,486583
araBp,0.09090909090909091,10,10,AATCTAACGTAGTTAACCTT,0,475414
araBp,0.09090909090909091,10,10,AATCCTAAGGCTAGTTTCTC,0,508041
araBp,0.09090909090909091,10,10,AATCATCTTTTCCAACTATG,0,510220
araBp,0.09090909090909091,10,10,AATCAAGAATTCACGATCGT,0,517991
araBp,0.09090909090909091,10,10,AATAACCTTTTCCGGTAGCT,0,471747
araBp,0.09090909090909091,10,10,AAGTAGGATAGTGAGGGAGT,0,476919
araBp,0.09090909090909091,10,10,AAGGTGGGACGCAGGAGTGT,0,491570
araBp,0.09090909090909091,10,10,AAGCGTTTTCAGCGTTCAGT,0,490930
araBp,0.09090909090909091,10,10,AAGATGACGAACGCAGCATA,0,491442
araBp,0.09090909090909091,10,10,AACTGCCTGTTTCGAATCCT,0,493518
araBp,0.09090909090909091,10,10,AACGTCTTGGCTCATTCCAA,0,507424
araBp,0.09090909090909091,10,10,AACCTAATCGCCTGGTCATG,0,505456
araBp,0.09090909090909091,10,10,AACACACAGGTCGCTAGCAG,0,514832
araBp,0.09090909090909091,10,10,AACAAATCTCGCCGTCTGAC,0,490332
araBp,0.09090909090909091,10,10,AAATCTTCCCGGCTCGTGTG,0,498334
araBp,0.09090909090909091,10,10,AAATCTAATGAAAAACCGAT,0,503129
araBp,0.09090909090909091,10,10,AAAGCACGCCTGCGACCGGG,0,521587
araBp,0.09090909090909091,10,10,AAAAGTTATCTTCAGGCTTT,0,482977
araBp,0.1,9,9,TTTTGGGGTTTTAGCTAAGT,0,491047
araBp,0.1,9,9,TTTTGCGCGCGACAAGAGTA,0,479591
araBp,0.1,9,9,TTTTGAGGTCACACGTCCGG,0,487191
araBp,0.1,9,9,TTTCTTTGACCGATCTTCCT,0,505447
araBp,0.1,9,9,TTTCGTGATCATCTTACGTG,0,485320
araBp,0.1,9,9,TTTATGCACGTCCGTAACAA,0,523126
araBp,0.1,9,9,TTTACCGGGGAATTCGGACG,0,469682
araBp,0.1,9,9,TTTAACTAATGAATACAGGT,0,516464
araBp,0.1,9,9,TTGTGTTCCGGTCAATCAAC,0,513639
araBp,0.1,9,9,TTGTAAGAAGCTCGCGCGCT,0,485459
araBp,0.1,9,9,TTGGGTCGAGTTCTGATTCT,0,475257
araBp,0.1,9,9,TTGGGTAGCAAGTCGTACAA,0,479168
araBp,0.1,9,9,TTGGCTTAAGGACCACGGGT,0,517596
araBp,0.1,9,9,TTGAGTATCTGAAGTAAGGC,0,512262
araBp,0.1,9,9,TTGAATGGGTTTTGGATCCC,0,487251
araBp,0.1,9,9,TTCTGACTCTCCAATTAAAG,0,506405
araBp,0.1,9,9,TTCGGTAGAATGGGGTTCTT,0,508985
araBp,0.1,9,9,TTCGGGGGGTCCTATGAGAT,0,483012
araBp,0.1,9,9,TTCGCTCCTAGGTCAAAACT,0,477597
araBp,0.1,9,9,TTCGCAAGTGGACATGGTAC,0,504011
araBp,0.1,9,9,TTCCTTTCACGGGTACATGT,0,493453
araBp,0.1,9,9,TTCCGGCTCTCGGATCAGTG,0,512712
araBp,0.1,9,9,TTCACGCATTTGCCGAACCC,0,481550
araBp,0.1,9,9,TTCAATACTGTGAGCTAGTA,0,512203
araBp,0.1,9,9,TTATTCGTGTTTCGGGTGTA,0,469628
araBp,0.1,9,9,TTATTCATATCGACACCAAG,0,515787
araBp,0.1,9,9,TTATAGTCGGCAGCGCTATG,0,491726
araBp,0.1,9,9,TTAGGTTTCATTTATTGAGC,0,485171
araBp,0.1,9,9,TTAGCGGCTGCTATGAGTAT,0,478742
araBp,0.1,9,9,TTACCTATGGCTAGTGTGGA,0,489020
araBp,0.1,9,9,TTAAGTCAAACCTCTGCTTC,0,504607
araBp,0.1,9,9,TGTTTTTCTATCGGCAGCAA,0,521629
araBp,0.1,9,9,TGTCTCCGATTTAGAGGCAA,0,487299
araBp,0.1,9,9,TGGTGGTACGTCGTAGTGAT,0,489199
araBp,0.1,9,9,TGGTGCAAGGCGTACCCAGC,0,491604
araBp,0.1,9,9,TGGTGAGTCCGTTGACTACT,0,470051
araBp,0.1,9,9,TGGGTCTGCGCCGGCCCGGG,0,516774
araBp,0.1,9,9,TGGGTACTCGCTTAGTATGC,0,524453
araBp,0.1,9,9,TGGGCTATTAAGAATGGAAA,0,487681
araBp,0.1,9,9,TGGGCGTGGCCGAATCTCAT,0,518056
araBp,0.1,9,9,TGGCGCGTGATCAGAAAGTG,0,507039
araBp,0.1,9,9,TGGCGAAGTTAGATTATGTG,0,493800
araBp,0.1,9,9,TGGCATGTACATATAACGGC,0,494199
araBp,0.1,9,9,TGGCAACATAAGAATGATTA,0,473669
araBp,0.1,9,9,TGGATATCCGTATAGTTATA,0,517989
araBp,0.1,9,9,TGCGTGCTCACGAATTATTG,0,514518
araBp,0.1,9,9,TGCGGGCTGCAGTCGGCTGG,0,470922
araBp,0.1,9,9,TGCCTCTGTGTCACCGTAGA,0,514167
araBp,0.1,9,9,TGCCGTGTGTGTAGCCCAAT,0,509865
araBp,0.1,9,9,TGCCATTACCACAGTTACAA,0,511747
araBp,0.1,9,9,TGCATTAAAACGGAGTCCTA,0,517744
araBp,0.1,9,9,TGCAGAATCCTTGTTAGTTA,0,504146
araBp,0.1,9,9,TGCACGCATCTAATGTTGGT,0,521827
araBp,0.1,9,9,TGATTCTGTGTTAGGGGCAA,0,513717
araBp,0.1,9,9,TGAGGGCAGAATCCCCAGGT,0,468683
araBp,0.1,9,9,TGAGGCGCGGTCTTAGCAAT,0,476263
araBp,0.1,9,9,TGAGCTCGGATGCTGCCCAT,0,492307
araBp,0.1,9,9,TGACTCCTTTGGATTCTCTT,0,482787
araBp,0.1,9,9,TGACGAATCTACGTACATCA,0,505852
araBp,0.1,9,9,TGAACGGCTGGGGTTCATAA,0,475450
araBp,0.1,9,9,TCTTATGCGGGAAGGTAATA,0,523072
araBp,0.1,9,9,TCTGTATTACGTAACAGGGT,0,469302
araBp,0.1,9,9,TCTCGGTAGTATGTTGTCCT,0,489180
araBp,0.1,9,9,TCTAATGCTTTGTTAGTTGA,0,493902
araBp,0.1,9,9,TCGGGGCTACGATGGAGCAT,0,470110
araBp,0.1,9,9,TCGGCTGAAATCACCGTTTC,0,469787
araBp,0.1,9,9,TCGCCGGCTAGGGAAAGTCG,0,521184
araBp,0.1,9,9,TCGACGGGTCATCCTGTTCG,0,504638
araBp,0.1,9,9,TCCGTCGCTATCTAAAATTG,0,501724
araBp,0.1,9,9,TCCGATGATGTCGAGTTCGT,0,483252
araBp,0.1,9,9,TCCGACCTGGGATTTCCTAG,0,474822
araBp,0.1,9,9,TCCCAAGGTGTGTGCATGGC,0,516229
araBp,0.1,9,9,TCCATGTCCTGAGGTAATTC,0,479951
araBp,0.1,9,9,TCCAGTACCGTGGCTGTTTG,0,515938
araBp,0.1,9,9,TCCAGGGCTCGGGCAGTTCA,0,517270
araBp,0.1,9,9,TCCACCCTTACAGGGAACTT,0,478948
araBp,0.1,9,9,TCATAGGGTAGTCGGCCGAG,0,494182
araBp,0.1,9,9,TCAGTGTAAGCCGCTAGAAA,0,523187
araBp,0.1,9,9,TCAGTCTTGGTTCTCAGAAA,0,493998
araBp,0.1,9,9,TCAGGGCAATAATCACTACA,0,515663
araBp,0.1,9,9,TCACTACGTCATCGACCTAG,0,491642
araBp,0.1,9,9,TCACAAGGATGTGAGATAAT,0,474089
araBp,0.1,9,9,TCAATGCCACACGTAAGGGT,0,504577
araBp,0.1,9,9,TATGTATCGATTCTTTACAG,0,500730
araBp,0.1,9,9,TATCATTACGGATCTTGCGG,0,475852
araBp,0.1,9,9,TAGGTTATTTACGCATGTAA,0,479180
araBp,0.1,9,9,TAGGTAGTGGTTTTAGTGAG,0,475454
araBp,0.1,9,9,TAGGTACCCACGCCCTGACC,0,469775
araBp,0.1,9,9,TAGGGTTGTTCCAGGGGATG,0,513912
araBp,0.1,9,9,TAGGAGGCGGATGGTTGGTA,0,508003
araBp,0.1,9,9,TAGCCTCGGACAACGCTATT,0,482484
araBp,0.1,9,9,TAGCCGCTTAATGTCCCCGA,0,492266
araBp,0.1,9,9,TACTTTGATGTACGCCCGAT,0,516053
araBp,0.1,9,9,TACTAGCTCAAATCATGCTG,0,490691
araBp,0.1,9,9,TACGCTTGCTGGGGATTGGG,0,519538
araBp,0.1,9,9,TACCGCCCGTTGTATGCGCA,0,483248
araBp,0.1,9,9,TACAGCTGGACGCCGTGCAT,0,506662
araBp,0.1,9,9,TAATGGATTTGCACGGGTAG,0,520890
araBp,0.1,9,9,TAATATGAGGGTCACCCTCT,0,475728
araBp,0.1,9,9,TAAGGTTCACGCGGAATCTC,0,504479
araBp,0.1,9,9,TAAGGCATGCCATAGGCGGT,0,472678
araBp,0.1,9,9,TAAGCTACAGGTAGGTACTA,0,482520
araBp,0.1,9,9,TAACTACGTGGCTGCTTCTA,0,505055
araBp,0.1,9,9,TAACAAATGGTCACCAGTGG,0,519143
araBp,0.1,9,9,GTTTCAAACATATAGCTTTA,0,476163
araBp,0.1,9,9,GTTTATGGCGAAACCCAGCA,0,505651
araBp,0.1,9,9,GTTGTGGTGCAGTAAAATAC,0,519448
araBp,0.1,9,9,GTTGTCGGGAATATATAACT,0,469202
araBp,0.1,9,9,GTTGGTAGACGGCACCCGAC,0,475142
araBp,0.1,9,9,GTTGCCAGAAATTAACAAAC,0,521976
araBp,0.1,9,9,GTTGACAGTCCCCGTGCCCT,0,512882
araBp,0.1,9,9,GTTCTAGAAAATCAATATGC,0,476467
araBp,0.1,9,9,GTTAGGGGGTCATCTACCGT,0,487747
araBp,0.1,9,9,GTGTTCTGCCGTTGGAATAT,0,516641
araBp,0.1,9,9,GTGTTACTAACGCTTTGGAT,0,484359
araBp,0.1,9,9,GTGGTTACAATATGGGGTTA,0,520305
araBp,0.1,9,9,GTGCTCAGAAAAACCCTCTT,0,470465
araBp,0.1,9,9,GTGAGAGTTCGACCCAATGA,0,489050
araBp,0.1,9,9,GTCGACCATGTTAGGCGATC,0,502049
araBp,0.1,9,9,GTCCATCGGCTCCGGTACGG,0,502497
araBp,0.1,9,9,GTATATGTTCCTTTCATCTA,0,487418
araBp,0.1,9,9,GTAGTGATCAAGCTTGCGAA,0,525281
araBp,0.1,9,9,GTAGCAAAGTCGTCTACTGT,0,510742
araBp,0.1,9,9,GTAGATGATCCGGAGAGGCT,0,518982
araBp,0.1,9,9,GTACTATATTTTCATGTCAC,0,480637
araBp,0.1,9,9,GTACCAAATGCGGTCTACGT,0,470805
araBp,0.1,9,9,GTAATTGATCTCGAGGGATC,0,469117
araBp,0.1,9,9,GTAAGACTAACCCTGGTTGA,0,485323
araBp,0.1,9,9,GGTTTCGAGGTTATCTGCAA,0,504765
araBp,0.1,9,9,GGTTGGTCTGTCGGATCAGC,0,519464
araBp,0.1,9,9,GGTGCGCTTTATTTCCGAGA,0,495921
araBp,0.1,9,9,GGTGCCCCGCGTTTAAAAAA,0,521577
araBp,0.1,9,9,GGTCTTGGGGGACCCCGACT,0,485628
araBp,0.1,9,9,GGGTGTCCTATGCGAGCTAC,0,468941
araBp,0.1,9,9,GGGTCTTCGGTTTGGTAAGA,0,523340
araBp,0.1,9,9,GGGTCAGAATTTATAGCCCA,0,493638
araBp,0.1,9,9,GGGTACTGAGGCAGTGATAA,0,502900
araBp,0.1,9,9,GGGGGACAAGTCTAGGTGTG,0,508684
araBp,0.1,9,9,GGGGCCTCTCTCCAGGTACG,0,483902
araBp,0.1,9,9,GGGGACTCAAGTTAGTTTCA,0,487640
araBp,0.1,9,9,GGGCTCCAGGAGAAATAGCG,0,474185
araBp,0.1,9,9,GGGATGTGGTTGTGACGCAT,0,507420
araBp,0.1,9,9,GGGATCAAGAGAAATTGTCA,0,472472
araBp,0.1,9,9,GGGACGGTTGTTTGAGCAGT,0,468342
araBp,0.1,9,9,GGCTTCGCGAAACAATTGTT,0,522584
araBp,0.1,9,9,GGCGTACTTTTAGGACGCAA,0,492858
araBp,0.1,9,9,GGCCAATGTTCGTGTAAAGT,0,472279
araBp,0.1,9,9,GGCATCGCAAACACGTCGCC,0,511079
araBp,0.1,9,9,GGCAGCAACGAGTGGTTATT,0,523527
araBp,0.1,9,9,GGCAAGAAGGCAAGGTACAT,0,517601
araBp,0.1,9,9,GGATATGCGCTTGTACTGGT,0,489730
araBp,0.1,9,9,GGAGTTCTGGCACACCCACC,0,497372
araBp,0.1,9,9,GGAGCTCCAAACGTTACAGG,0,496312
araBp,0.1,9,9,GGAGACCAGCACTAGGGGAT,0,517419
araBp,0.1,9,9,GGAAGTGTCCCTAGATTCTC,0,509456
araBp,0.1,9,9,GGAAGCGACTCCGTCCGTGA,0,493121
araBp,0.1,9,9,GCTGGGGGATTCTGTTGGGG,0,521443
araBp,0.1,9,9,GCTCTGATGCAACATGTAAA,0,521710
araBp,0.1,9,9,GCTCTCGAGGGTAAGACCGG,0,505618
araBp,0.1,9,9,GCTCGTACATCGCGGAAAGT,0,511828
araBp,0.1,9,9,GCTCCTAGGGCTGTACTCAC,0,472512
araBp,0.1,9,9,GCTAGGGTGGAGTGCTGCCA,0,493517
araBp,0.1,9,9,GCTAATTGACGGGTCAATTC,0,490550
araBp,0.1,9,9,GCGGTCAACACTTTGGGATC,0,513366
araBp,0.1,9,9,GCGGGTAGGTGAATTGTCAA,0,468618
araBp,0.1,9,9,GCGCTTACGGTCTACGAAGG,0,515794
araBp,0.1,9,9,GCGCTCTATTTTGTTATGGG,0,488033
araBp,0.1,9,9,GCGATCAGAAATTCTCACAG,0,496405
araBp,0.1,9,9,GCGAGAAGTAAGCTTCTTTT,0,477668
araBp,0.1,9,9,GCCCTTGTATTACCTTTCCG,0,471635
araBp,0.1,9,9,GCCCCTTATTATTCCGACGT,0,474979
araBp,0.1,9,9,GCCATATACAATGAAGAAGA,0,503029
araBp,0.1,9,9,GCCATAATCGGCGCGCACAA,0,477297
araBp,0.1,9,9,GCCAAGTTATGACTCAGACC,0,507217
araBp,0.1,9,9,GCATGATGCTAACGGTCCCG,0,472601
araBp,0.1,9,9,GCATAATGCAATCTGAGGAG,0,511637
araBp,0.1,9,9,GCAGCTCTAGAACCACGGAA,0,470424
araBp,0.1,9,9,GCAGATCATGCAGGAGATTG,0,493455
araBp,0.1,9,9,GCACATGAAGTTACGTAGTG,0,473041
araBp,0.1,9,9,GCAACTCCGCGGACGAACTT,0,519890
araBp,0.1,9,9,GCAAACTAACTATCGAAACA,0,495761
araBp,0.1,9,9,GCAAACCGATAGGGTGAATT,0,493023
araBp,0.1,9,9,GATTTTGCACCAAGCCGCCC,0,510494
araBp,0.1,9,9,GATTGTGGGATGTGGGACAC,0,483347
araBp,0.1,9,9,GATTGTCTTAACGGTCGCCT,0,490382
araBp,0.1,9,9,GATTGGTACGGAAGGCTGTT,0,500357
araBp,0.1,9,9,GATTCTTCGATTGAAGGTTG,0,516758
araBp,0.1,9,9,GATTCGATACCCGCCTAATC,0,484543
araBp,0.1,9,9,GATTATTTGGCAGGTACAAA,0,509052
araBp,0.1,9,9,GATCCGATGAAAAAAGATCA,0,471229
araBp,0.1,9,9,GATCAAAGATCTGGGCTACG,0,482185
araBp,0.1,9,9,GATAGTTCACCACAGTTTTG,0,473962
araBp,0.1,9,9,GATAGGGTAGGGGTCACTTG,0,471104
araBp,0.1,9,9,GATACGCTCCGGTGTCGGCG,0,487540
araBp,0.1,9,9,GAGTGGTCAGTACGGATCAA,0,512066
araBp,0.1,9,9,GAGTCCTCTAGTGAGCTTTT,0,480888
araBp,0.1,9,9,GAGGTTGCCCAGCCGTACAG,0,471546
araBp,0.1,9,9,GAGGACATTGTACGCTACCG,0,507042
araBp,0.1,9,9,GAGGAAGGAGCGGAATTCGT,0,499385
araBp,0.1,9,9,GAGCTCTACTTTCCCAGAAA,0,518509
araBp,0.1,9,9,GAGCCGCAGGTGTCACCATA,0,478480
araBp,0.1,9,9,GAGCCCGACGGGGTTAATAA,0,518048
araBp,0.1,9,9,GAGAAGCCTACAGCGAGTGG,0,499023
araBp,0.1,9,9,GACTTTTATGTCCGAGGTCG,0,474653
araBp,0.1,9,9,GACTTACCAGCACCAGGTCA,0,484059
araBp,0.1,9,9,GACTCTCAGACCGCACAAGT,0,471110
araBp,0.1,9,9,GACGAGGTGTGAAGCAGTTT,0,498181
araBp,0.1,9,9,GACATTGTACGGACAGACGT,0,489364
araBp,0.1,9,9,GACAGCGTTTGCGAATATGC,0,483772
araBp,0.1,9,9,GAAGAGCATCCACATCTCTG,0,485023
araBp,0.1,9,9,GAACTGAGGCCGAGGGCGCC,0,472902
araBp,0.1,9,9,GAACCATTAGCCGGGTGCGC,0,482080
araBp,0.1,9,9,GAACACTCGAACTCCACTTA,0,469624
araBp,0.1,9,9,GAACAACGCCGGACGGTAAG,0,523637
araBp,0.1,9,9,GAACAACCCGGCGAAGTGCA,0,471969
araBp,0.1,9,9,GAAATTGAGGGAATGCATTT,0,511666
araBp,0.1,9,9,GAAAGGTTTGTAATGTTGAA,0,505843
araBp,0.1,9,9,GAAAGGATCTAGTCAACGCT,0,491695
araBp,0.1,9,9,CTTTTCGGAAGTTGTATGTC,0,499075
araBp,0.1,9,9,CTTTGAACTGCAAAAGGTGT,0,525036
araBp,0.1,9,9,CTTTCGGTGCCAACAAAAAT,0,503702
araBp,0.1,9,9,CTTTAGAGAATGTAATTGTG,0,515788
araBp,0.1,9,9,CTTGATCGAGGACAGACCCA,0,470660
araBp,0.1,9,9,CTTGACCGACCGCACAATTA,0,510629
araBp,0.1,9,9,CTTCCCCGTGCAGGGTATAG,0,518965
araBp,0.1,9,9,CTTCCACGGTGCCAACTGGC,0,515998
araBp,0.1,9,9,CTTAGTTCCCTATGGTGGCG,0,510270
araBp,0.1,9,9,CTTAGGCCCGGCTGAGCCCA,0,482607
araBp,0.1,9,9,CTTAGAAACATCGTTAAATG,0,512823
araBp,0.1,9,9,CTGTTGTTTGGGGACCTGGG,0,506275
araBp,0.1,9,9,CTGTGTACAAGTATTCAGGG,0,480223
araBp,0.1,9,9,CTGGCAGCGGGTGGGGTGGT,0,516598
araBp,0.1,9,9,CTGCTCCTACAACCAAATAA,0,499389
araBp,0.1,9,9,CTGCCGGGCATGGGCCTTTA,0,514794
araBp,0.1,9,9,CTGCCCCCTAGGAGTCTGCA,0,501949
araBp,0.1,9,9,CTGCAGAGCCGATGGTGCAG,0,516407
araBp,0.1,9,9,CTGAAGGTGACAGGAGCTGA,0,482574
araBp,0.1,9,9,CTGAAAACCGCGAACAGTTG,0,516978
araBp,0.1,9,9,CTCTTGGATCGACGGGAATT,0,505443
araBp,0.1,9,9,CTCTCCTGTCACTCACGCGA,0,473564
araBp,0.1,9,9,CTCTAGATCAACTGGGACTT,0,507538
araBp,0.1,9,9,CTCGCTTGCTACAGTCCGAA,0,481785
araBp,0.1,9,9,CTCCTTTCAACCGACGTGGT,0,470713
araBp,0.1,9,9,CTCCCAGGCTAAAAACTCCA,0,514669
araBp,0.1,9,9,CTCATATGTGGTCCGCGTGG,0,492545
araBp,0.1,9,9,CTCACAACTGAAAGTCCGTA,0,511189
araBp,0.1,9,9,CTAGGAGGAACAGTTATCGG,0,516471
araBp,0.1,9,9,CTACGCGTAGATCCTGAGGG,0,511656
araBp,0.1,9,9,CGTTGATGACAGCCCCGCCA,0,468789
araBp,0.1,9,9,CGTGGGGTCTGTACAGGAGG,0,507993
araBp,0.1,9,9,CGTGCGGGTAGTCGTCCCAA,0,495156
araBp,0.1,9,9,CGTGATTGGATGCCCTCATC,0,524675
araBp,0.1,9,9,CGTCGTGGTACCGGATTATC,0,519041
araBp,0.1,9,9,CGTCATTTCTCCCTTGGAAA,0,489726
araBp,0.1,9,9,CGTCAGTATAGGTAAGCAGT,0,480626
araBp,0.1,9,9,CGTAGGTCTTATTTGAAAGT,0,484319
araBp,0.1,9,9,CGGTGCCTCGCCCCGCAGTC,0,515038
araBp,0.1,9,9,CGGTGCATTCGATGCACGCT,0,518853
araBp,0.1,9,9,CGGTCTGTTAGGTCACGATT,0,507185
araBp,0.1,9,9,CGGTACGGGCCTTGTCGTTC,0,485517
araBp,0.1,9,9,CGGGTACGGGTGTTGAAAAT,0,486635
araBp,0.1,9,9,CGGGTAACCGGCGGCGATTG,0,486441
araBp,0.1,9,9,CGGGGAATTTATCGGCACCT,0,487156
araBp,0.1,9,9,CGGGAGAAATTGCTTTGCCG,0,499852
araBp,0.1,9,9,CGGCTAACAGCAATCACCAC,0,469264
araBp,0.1,9,9,CGGATGCAGTTTTTGTGGTG,0,493582
araBp,0.1,9,9,CGGACGTCTGGGACTTATAG,0,496609
araBp,0.1,9,9,CGCTTGGGTCAGGGCTCTCT,0,479172
araBp,0.1,9,9,CGCGTCGAAGTACACGGTTA,0,471262
araBp,0.1,9,9,CGCGTCCAAGCAGCCTGCGT,0,481204
araBp,0.1,9,9,CGCGGCGATAATGAGGGACC,0,495913
araBp,0.1,9,9,CGCGCGGACATCCTAGAGGG,0,488348
araBp,0.1,9,9,CGCCTTATTTGATCTCGTGG,0,504037
araBp,0.1,9,9,CGCATTGGGTCACCCTTTGC,0,523503
araBp,0.1,9,9,CGCACCGCGGTGGAGCCGAC,0,470059
araBp,0.1,9,9,CGATTGGCCTATCCAACTTA,0,502327
araBp,0.1,9,9,CGATTGGAAAATCAAGTATA,0,497834
araBp,0.1,9,9,CGATCAATGTTCCGTCAGTC,0,491069
araBp,0.1,9,9,CGATACTATCACAGACGGCG,0,481132
araBp,0.1,9,9,CGAGTTTTTTTACATATAAG,0,496909
araBp,0.1,9,9,CGAGTATGACTAAAAACACT,0,519698
araBp,0.1,9,9,CGAGGTAGTACGTGGGGCCA,0,469580
araBp,0.1,9,9,CGAGCTCTTACGACCTGTGT,0,468114
araBp,0.1,9,9,CGAGACAACGGGGCAGGACA,0,518780
araBp,0.1,9,9,CGACTTGTTGGTCCATATGC,0,497349
araBp,0.1,9,9,CGACTTGCGTGAGCTGCAAG,0,507476
araBp,0.1,9,9,CGACTATGTAACATATATGC,0,475132
araBp,0.1,9,9,CGAAATAAACATGCACACAC,0,484416
araBp,0.1,9,9,CGAAACCCGGGGTTAATGTA,0,486401
araBp,0.1,9,9,CCTTGCCTTCCTCTCAGATT,0,468801
araBp,0.1,9,9,CCTTCTCCTTAACAGTAAAG,0,470279
araBp,0.1,9,9,CCTTAGTACAAACCTGGAGG,0,506766
araBp,0.1,9,9,CCTGTAACGAATGGTAAACA,0,503276
araBp,0.1,9,9,CCTGCCCGGCGTGAAGCAAA,0,488986
araBp,0.1,9,9,CCTCTATAGTTTAGATGAGC,0,522837
araBp,0.1,9,9,CCTCGAATTGCTATAACGAG,0,468025
araBp,0.1,9,9,CCTATGATCATGGGCCAGGG,0,477468
araBp,0.1,9,9,CCTATAGTTCTTTCCAACGT,0,492963
araBp,0.1,9,9,CCTATAAGCACGAATTATAA,0,498077
araBp,0.1,9,9,CCGTGACACATGCACGGATC,0,478931
araBp,0.1,9,9,CCGTATTGAGTCCTTCAGGT,0,490646
araBp,0.1,9,9,CCGGTAAGGCGCTTATTCAG,0,469012
araBp,0.1,9,9,CCGGAAAAAACTTAAAACTA,0,479325
araBp,0.1,9,9,CCGCTCTTCTGCGAACGCTT,0,507585
araBp,0.1,9,9,CCGCGGGTAACGAAATGGCA,0,478245
araBp,0.1,9,9,CCGCGCGTACTATCTCGATT,0,489670
araBp,0.1,9,9,CCGCACGCGCGTGGCGTCAC,0,502284
araBp,0.1,9,9,CCGACCCCGAGTGGCAATGT,0,480938
araBp,0.1,9,9,CCGACATGGTCGCGGGTGTT,0,513554
araBp,0.1,9,9,CCGAATTGTGCAATTTGGTT,0,520335
araBp,0.1,9,9,CCCGTTCAGTCTAGCTATCA,0,519572
araBp,0.1,9,9,CCCGGCCCGTCCTGTTCTAC,0,524455
araBp,0.1,9,9,CCCCGCGCTCCCGGCAGGCT,0,514476
araBp,0.1,9,9,CCCACTCACCAGCGCGATAT,0,507902
araBp,0.1,9,9,CCATGATAATTCCACTGCAT,0,477916
araBp,0.1,9,9,CCATCGATTTCGCAATGCTA,0,473471
araBp,0.1,9,9,CCAGTTTCGGATTTCAACGA,0,479952
araBp,0.1,9,9,CCAGTGGACAAGGGTTTATG,0,497027
araBp,0.1,9,9,CCAGGACCGTTCCGGACTTA,0,489567
araBp,0.1,9,9,CCAGCGAAGACCCGGGGGGA,0,520145
araBp,0.1,9,9,CCACGCTAAGCTAGCAGCGG,0,521062
araBp,0.1,9,9,CCACCGCAGCTTTGTAGTTC,0,507468
araBp,0.1,9,9,CATTGTGCATTGCGGGATAA,0,485104
araBp,0.1,9,9,CATGTATCGTGCGTTGTCTA,0,503414
araBp,0.1,9,9,CATGGCAGATTCGTTCCAGC,0,494068
araBp,0.1,9,9,CATGGACCCTCCCGCCAAAA,0,480548
araBp,0.1,9,9,CATCGCGAAACGACGGTATT,0,511325
araBp,0.1,9,9,CATCCGGGTGGGTAAATCAT,0,474773
araBp,0.1,9,9,CATCACTTGTGTAGGGGAAC,0,510951
araBp,0.1,9,9,CATATTTGGAGCACATAGAA,0,476457
araBp,0.1,9,9,CAGTCAACGAGATATATCTC,0,474453
araBp,0.1,9,9,CAGGGGCAACTTCCATCTTT,0,477891
araBp,0.1,9,9,CAGGGAGGGGGATATGCTAT,0,519402
araBp,0.1,9,9,CAGGCCCGGTGGGTTAGTGC,0,483447
araBp,0.1,9,9,CAGGCCAATTGGAAAGAATT,0,476532
araBp,0.1,9,9,CAGCGATCAAAACCCCTGTC,0,493376
araBp,0.1,9,9,CAGAGCCAGATCCCGGTAAA,0,473640
araBp,0.1,9,9,CACTGTTCCCGACCGGAATT,0,479717
araBp,0.1,9,9,CACTATGAAGCATCGTCCGT,0,476768
araBp,0.1,9,9,CACTATACGAGCAGGACAGT,0,516658
araBp,0.1,9,9,CACTAGACTCTGCACGTATG,0,477807
araBp,0.1,9,9,CACGGGTTGTAACACCGGTT,0,488779
araBp,0.1,9,9,CACGGCTTTCAGTTCGTTCG,0,500254
araBp,0.1,9,9,CAATCCCCAATTTGGTCTAG,0,479466
araBp,0.1,9,9,CAAGGGCTCTACGGCTACGT,0,470705
araBp,0.1,9,9,CAAGAGCCCAGAAGATGGCG,0,503892
araBp,0.1,9,9,CAACTTAAAAGCCGGAAGGC,0,503396
araBp,0.1,9,9,CAACCGTCCACTCAAATTAA,0,513456
araBp,0.1,9,9,CAAATTGAAAGCTCGGGAGA,0,481373
araBp,0.1,9,9,ATTTTTTAGGCGGTATAGAA,0,519532
araBp,0.1,9,9,ATTTGTCCGGTTTAGAAGTA,0,470861
araBp,0.1,9,9,ATTTAGGGGCTCGCGAACTG,0,521724
araBp,0.1,9,9,ATTGTTTTATGGAGGTGTTG,0,519452
araBp,0.1,9,9,ATTAGGTCACGGGGCCTGGT,0,518818
araBp,0.1,9,9,ATGTTGCATGGACTTCGCAT,0,494880
araBp,0.1,9,9,ATGTGCCAGTTAATTTTCGG,0,503980
araBp,0.1,9,9,ATGTACGCGAGGTATGCTAT,0,501870
araBp,0.1,9,9,ATGGTCCCACGGGTGGGGAA,0,521140
araBp,0.1,9,9,ATGCTGCCTAGCGCCGCTAC,0,521452
araBp,0.1,9,9,ATGCCTATGGGCGGTACACA,0,506115
araBp,0.1,9,9,ATGAACCTAGTCCCGTCGCC,0,523185
araBp,0.1,9,9,ATCTGTTAAAGTGAGGTGAT,0,472370
araBp,0.1,9,9,ATCTACGACAGGAAGGGTTA,0,475038
araBp,0.1,9,9,ATCTAACGTGAGTCTGGCGG,0,499767
araBp,0.1,9,9,ATCGTTGAGGAATGCCGTGT,0,498386
araBp,0.1,9,9,ATCGTGCGTACCCCATACGT,0,479300
araBp,0.1,9,9,ATCGTCAGTAACGTAGGTTG,0,501551
araBp,0.1,9,9,ATCCTAGCCGGGATGGTCTC,0,506277
araBp,0.1,9,9,ATCCGGGGATCGAGAAAACT,0,469841
araBp,0.1,9,9,ATCCAGCAAGGATGTCGTGG,0,488439
araBp,0.1,9,9,ATCATAGTATCATTACTCGA,0,479429
araBp,0.1,9,9,ATCAAGGGTCTCTAGAGCGC,0,510499
araBp,0.1,9,9,ATATATCCGATGCCGATCAA,0,483215
araBp,0.1,9,9,ATATATACGACTGTCATATT,0,484671
araBp,0.1,9,9,ATATAGAGCATCACCCGCTG,0,489255
araBp,0.1,9,9,ATAGTAGATACTTCGCTATC,0,471408
araBp,0.1,9,9,ATAGATTTCAACCTATGTTG,0,515719
araBp,0.1,9,9,ATAGATGGAACATCTTACGC,0,520343
araBp,0.1,9,9,ATAGAAATCCACATTGCCCG,0,483224
araBp,0.1,9,9,ATACCTTTACGAAAGTAACA,0,471897
araBp,0.1,9,9,AGTTACGTGAGGAGGAGCTG,0,469588
araBp,0.1,9,9,AGTGTAAGAACTGAACGGCT,0,522530
araBp,0.1,9,9,AGTCGTGTTGCCGGTTACGA,0,487097
araBp,0.1,9,9,AGTCGCAGTAGAGATATGCA,0,515706
araBp,0.1,9,9,AGTCCGTGGCCGGACGTAGT,0,489523
araBp,0.1,9,9,AGTAGGAACACGTGGCATTA,0,481692
araBp,0.1,9,9,AGTACCACGCGAACGTCACT,0,522347
araBp,0.1,9,9,AGTAATCCGATGCAGCATCT,0,522258
araBp,0.1,9,9,AGGTTATCACTCCTGTCTGT,0,470405
araBp,0.1,9,9,AGGGTGGGAGTCAGCTAGTG,0,493780
araBp,0.1,9,9,AGGGGGCGACTCTCACGGCA,0,515849
araBp,0.1,9,9,AGGGCGTAGATGGACGCGAT,0,470428
araBp,0.1,9,9,AGGCGGAGCTTGAATGTCGT,0,495519
araBp,0.1,9,9,AGGATTAGTCAGGCGGTATA,0,511521
araBp,0.1,9,9,AGGAATCTTATAACTTTGAA,0,483363
araBp,0.1,9,9,AGCTGGGCCGGCACCCCTGC,0,468082
araBp,0.1,9,9,AGCGTTTCAATGCGCGGTTA,0,504422
araBp,0.1,9,9,AGCGGGAGGTGAGTTCGCGG,0,477193
araBp,0.1,9,9,AGCGCAATACCTGCGGTACT,0,500274
araBp,0.1,9,9,AGCGATCGGCTTACCCTGTG,0,494802
araBp,0.1,9,9,AGCGAGGCAGGGCCTGTGTT,0,505757
araBp,0.1,9,9,AGCCATCATCGATTTTCCGG,0,498438
araBp,0.1,9,9,AGCATCCCTTCCGGAGACCG,0,507565
araBp,0.1,9,9,AGCAGGTAAAGGTGCAGTCT,0,471755
araBp,0.1,9,9,AGATGACCATTCGGATGACT,0,524572
araBp,0.1,9,9,AGAGTTAGAAGGCGGGTCAT,0,477937
araBp,0.1,9,9,AGAGGAACCTAGTCAGCTGA,0,518888
araBp,0.1,9,9,AGAGCCAAAAGTCTGGAAGA,0,472802
araBp,0.1,9,9,AGAGCAAGCAGAGCTTGAAC,0,494481
araBp,0.1,9,9,AGAGATGTTGTTGGCGAATG,0,477172
araBp,0.1,9,9,AGAGATAGTGATCATCGACA,0,512635
araBp,0.1,9,9,AGACTAACAAACGGACCGCA,0,479695
araBp,0.1,9,9,AGACCCGGTTCTCCATGTTT,0,472608
araBp,0.1,9,9,AGACAAGGGCTTGGTGCGTA,0,514443
araBp,0.1,9,9,ACTTATTGGTTACGCCCGAT,0,516443
araBp,0.1,9,9,ACTGAGCTTTTGTTTCACGG,0,496499
araBp,0.1,9,9,ACTGACGAGGCGCACAACAA,0,471944
araBp,0.1,9,9,ACTCCGGCATGACGAGGCCA,0,490966
araBp,0.1,9,9,ACTCCAGGACTCTTCACCAT,0,479748
araBp,0.1,9,9,ACTAGGGCAAGGTCTGATGC,0,512301
araBp,0.1,9,9,ACTACATGGTTGCTTGAAGT,0,469211
araBp,0.1,9,9,ACGTGGGGGCCGCATAAGGA,0,488536
araBp,0.1,9,9,ACGTGCTGGACGTCACATCC,0,483345
araBp,0.1,9,9,ACGTACTTCAAGATATATAT,0,501413
araBp,0.1,9,9,ACGGTAAAACCGCTGGCGTT,0,469830
araBp,0.1,9,9,ACGCTCAGTATGAGGTTGGT,0,492390
araBp,0.1,9,9,ACGCACTATGGTTGGATCCT,0,486473
araBp,0.1,9,9,ACGCAATACAATTAGGGGGT,0,510930
araBp,0.1,9,9,ACGCAAGGATCTTCATTAGT,0,505996
araBp,0.1,9,9,ACGAGAGAACAATATGCCCC,0,483855
araBp,0.1,9,9,ACGACTAACGCAGGCCCTCT,0,502298
araBp,0.1,9,9,ACCTGAGAGTTTTAGACCCA,0,474132
araBp,0.1,9,9,ACCTCTGGGTGCGAATTGAC,0,484803
araBp,0.1,9,9,ACCGTTTGGACGACGGGAGA,0,485971
araBp,0.1,9,9,ACCCTCGGGATAGGCTCGGC,0,507076
araBp,0.1,9,9,ACCCGATGCTCAGGGGTCAA,0,482834
araBp,0.1,9,9,ACCCAAGCAGTTGTAGGTAG,0,518553
araBp,0.1,9,9,ACCAGCCGGCTGAGTACGGT,0,485520
araBp,0.1,9,9,ACCAACGAAGGTCGCCAAGT,0,511179
araBp,0.1,9,9,ACATCGCATTGACATCGACT,0,522440
araBp,0.1,9,9,ACATCCCGGGTCTGCCAGCG,0,523532
araBp,0.1,9,9,ACATAATGGTCTTGCTCCTA,0,498938
araBp,0.1,9,9,ACAGTATCTCAGGTTTTTCA,0,505218
araBp,0.1,9,9,ACAGTACGCGACACGATACG,0,520778
araBp,0.1,9,9,ACAGCTTTGTTACTCCACCC,0,482112
araBp,0.1,9,9,ACAGCATCCAATGACAGATG,0,493814
araBp,0.1,9,9,ACAGAGAACCGTTCCGAAAC,0,513868
araBp,0.1,9,9,ACACTCTTGCGTAGCAGTCT,0,523084
araBp,0.1,9,9,ACACGAAAATTTGGACAAAC,0,470947
araBp,0.1,9,9,ACACAACCTTGGTTAGTTGA,0,507290
araBp,0.1,9,9,AATTTTGGGGAGCCACTAGA,0,473814
araBp,0.1,9,9,AATGTCTTTCATTTCCATTC,0,509227
araBp,0.1,9,9,AATGGCCATGGTGCAAGGGG,0,510546
araBp,0.1,9,9,AAGGGCCATGGATACTGTGA,0,522481
araBp,0.1,9,9,AAGGCTGATGGATCGCGAGG,0,505526
araBp,0.1,9,9,AAGCTTCCCCTCCGCCGGTC,0,517565
araBp,0.1,9,9,AAGCTGTAAGCTGAAACGCG,0,483741
araBp,0.1,9,9,AAGCCCCGAACGCCTATCAG,0,480011
araBp,0.1,9,9,AAGCAAGGGAAAAGAGTCAG,0,514082
araBp,0.1,9,9,AACTCTCCGGTATAACTTAT,0,487990
araBp,0.1,9,9,AACGGAGCAAGTTGTGCAAC,0,478985
araBp,0.1,9,9,AACGCTCATTGCGTGCATAA,0,468047
araBp,0.1,9,9,AACCGTGTACTCGGATGGTA,0,509166
araBp,0.1,9,9,AACCCGTTTGGTCTACGAAA,0,476771
araBp,0.1,9,9,AACCCGTCGAGTTCCTATAA,0,506691
araBp,0.1,9,9,AAATTAGCGCCACCATGGGT,0,512772
araBp,0.1,9,9,AAATGGCTGCTGGGGCTTAA,0,519189
araBp,0.1,9,9,AAATCGGGTCTTTGAGTATC,0,496813
araBp,0.1,9,9,AAAGTCCGGATTGGAGATCC,0,520020
araBp,0.1,9,9,AAACCAGAATCCTTTGTCTT,0,508872
araBp,0.1,9,9,AAACACCGTGTGTTCCGTGA,0,494587
araBp,0.1,9,9,AAAATCGGCATATTACTCTT,0,519415
araBp,0.1111111111111111,8,8,TTTTTTGCCAGAGTCCATTA,0,480418
araBp,0.1111111111111111,8,8,TTTTTAACGCGATTGGGCCA,0,491927
araBp,0.1111111111111111,8,8,TTTTGCGTTACAATTCATTT,0,515953
araBp,0.1111111111111111,8,8,TTTGGGGTATCTGCATCTCA,0,495154
araBp,0.1111111111111111,8,8,TTTGAGGTCTCTGTCAAACA,0,489580
araBp,0.1111111111111111,8,8,TTTCGTGGAGTGTTGTAATG,0,497484
araBp,0.1111111111111111,8,8,TTTCGTAGTCCCCAAGTTTA,0,484764
araBp,0.1111111111111111,8,8,TTTCAGCCCCACCGCGCCAT,0,518284
araBp,0.1111111111111111,8,8,TTTCACGACACATTATGCGG,0,493937
araBp,0.1111111111111111,8,8,TTTATGTACTCACCAAAATT,0,498283
araBp,0.1111111111111111,8,8,TTTATAACTAGCCTACCCAG,0,478656
araBp,0.1111111111111111,8,8,TTTAGACGAACCCACGAAGA,0,497089
araBp,0.1111111111111111,8,8,TTGTTTTGAAATGAACCCGA,0,522977
araBp,0.1111111111111111,8,8,TTGTATGCCGATTTATCGGC,0,512908
araBp,0.1111111111111111,8,8,TTGTATCTTCCCTATGCTAG,0,518773
araBp,0.1111111111111111,8,8,TTGTATCGGGCAGGCAGGTA,0,489878
araBp,0.1111111111111111,8,8,TTGTAACATAAGACGCTGCA,0,524114
araBp,0.1111111111111111,8,8,TTGGTTCGTGTACCGTTTCC,0,483943
araBp,0.1111111111111111,8,8,TTGGGTTTGCAAAAATTTAC,0,506698
araBp,0.1111111111111111,8,8,TTGGGCTCTGGGGGGAATCA,0,490892
araBp,0.1111111111111111,8,8,TTGGCACCTTCTTAGGTCTG,0,486854
araBp,0.1111111111111111,8,8,TTGCTCTGGCCCACCACGAA,0,479967
araBp,0.1111111111111111,8,8,TTGCTCTCCATTGAGAAATA,0,516653
araBp,0.1111111111111111,8,8,TTGCCAAGGCGGGTGGGTAC,0,491254
araBp,0.1111111111111111,8,8,TTGAGTAGACGCCGCTAATG,0,484662
araBp,0.1111111111111111,8,8,TTGACTACGAGCAGGAATAT,0,481795
araBp,0.1111111111111111,8,8,TTGAACGATGCTGCGTGCAA,0,482870
araBp,0.1111111111111111,8,8,TTCTCCGATCGGGAGCAGCG,0,517674
araBp,0.1111111111111111,8,8,TTCTATGCCAGGTTCGCAGT,0,486418
araBp,0.1111111111111111,8,8,TTCTAAGCCAGCGTAAAGCT,0,508086
araBp,0.1111111111111111,8,8,TTCGAATTGGATGATGCTCT,0,518730
araBp,0.1111111111111111,8,8,TTCCTGACCCAATTTGGTCG,0,503657
araBp,0.1111111111111111,8,8,TTCATTGTCCTCATTGAAGT,0,484708
araBp,0.1111111111111111,8,8,TTCAACCTCCGTTTGCAAGG,0,489826
araBp,0.1111111111111111,8,8,TTATTGCCCTCTCGGCCTTG,0,496574
araBp,0.1111111111111111,8,8,TTATTAGTCCTTCAGCACCT,0,473815
araBp,0.1111111111111111,8,8,TTATAGAAGGCTGGTACGGT,0,500100
araBp,0.1111111111111111,8,8,TTAGCCTTAATCGTGTAGTA,0,468653
araBp,0.1111111111111111,8,8,TTAGACTTCGGCAGTGGGTA,0,489661
araBp,0.1111111111111111,8,8,TTAGACAATTCGACGAAAAA,0,507274
araBp,0.1111111111111111,8,8,TTAGACAAGAACATGAAAGC,0,516110
araBp,0.1111111111111111,8,8,TTACTTGACTCTTGAGATCT,0,524040
araBp,0.1111111111111111,8,8,TTACTATATCCTACTGACAA,0,510316
araBp,0.1111111111111111,8,8,TTACCGAGACCCCAGCCACT,0,514288
araBp,0.1111111111111111,8,8,TTACCCGTTTAAGGTAAGGT,0,485676
araBp,0.1111111111111111,8,8,TTAACCACGACAATTCCAGG,0,490838
araBp,0.1111111111111111,8,8,TGTTTATACCACCTTTTACC,0,472383
araBp,0.1111111111111111,8,8,TGTTCTATCTGTTACCTATA,0,484296
araBp,0.1111111111111111,8,8,TGTTCGGGCTCTAAGGCCAT,0,517903
araBp,0.1111111111111111,8,8,TGTGTAGGACCGAGGGCCAT,0,517183
araBp,0.1111111111111111,8,8,TGTGTAGCGGACGACGTGAA,0,507038
araBp,0.1111111111111111,8,8,TGTGAGAGCATTTTGCGGAT,0,495784
araBp,0.1111111111111111,8,8,TGTGAATTACTCGATCCTCT,0,517497
araBp,0.1111111111111111,8,8,TGTCACCGGGGGCTTAACGT,0,480122
araBp,0.1111111111111111,8,8,TGTAGAACGCACCTCCGGAA,0,475490
araBp,0.1111111111111111,8,8,TGGTTTTACCATCCTTGGAT,0,468385
araBp,0.1111111111111111,8,8,TGGTTGTCAGTTGACCGAGT,0,509584
araBp,0.1111111111111111,8,8,TGGTGGATCAGCATGGAAAC,0,496111
araBp,0.1111111111111111,8,8,TGGGGGTGTGCGTTCCGTCA,0,520243
araBp,0.1111111111111111,8,8,TGGCTCACAAATAGCTATTA,0,504885
araBp,0.1111111111111111,8,8,TGGCGGGCCTAAAGAATACT,0,514757
araBp,0.1111111111111111,8,8,TGGCAGTCGGTGCCGTCCCA,0,519460
araBp,0.1111111111111111,8,8,TGGCACAACGGAAGTCTAAG,0,515848
araBp,0.1111111111111111,8,8,TGGATGATATGCTACAGTCC,0,512317
araBp,0.1111111111111111,8,8,TGGACTATGTGATGTTGGTG,0,482219
araBp,0.1111111111111111,8,8,TGGACTAGCGCGCTCCTGAA,0,473249
araBp,0.1111111111111111,8,8,TGGACCAACGCGACACAGCT,0,509267
araBp,0.1111111111111111,8,8,TGCTGATTGGTAATACATAC,0,511401
araBp,0.1111111111111111,8,8,TGCGGTGCATGCGGCCGTAA,0,503898
araBp,0.1111111111111111,8,8,TGCCTTCGCCAGAAGTTTCG,0,500975
araBp,0.1111111111111111,8,8,TGCCCCTTTGAGTAACAAGC,0,492045
araBp,0.1111111111111111,8,8,TGCCATTAGACGGGGCCTAT,0,480815
araBp,0.1111111111111111,8,8,TGCATATATTGGGGCCAATA,0,472813
araBp,0.1111111111111111,8,8,TGCAGACCTTAACTGTTCCA,0,476512
araBp,0.1111111111111111,8,8,TGCACGCATCGTGGTCAATA,0,501979
araBp,0.1111111111111111,8,8,TGATCGTAGTAGCTTGCGAT,0,514499
araBp,0.1111111111111111,8,8,TGATCCTAAGCGGATATCTC,0,515808
araBp,0.1111111111111111,8,8,TGACTTGTCCCTGTACACAC,0,500660
araBp,0.1111111111111111,8,8,TGACCGCCGAAATCGATTGG,0,494066
araBp,0.1111111111111111,8,8,TCTTTGTGTGGCGAGCCCAT,0,468500
araBp,0.1111111111111111,8,8,TCTTCTCCATTTAGCACCCT,0,476327
araBp,0.1111111111111111,8,8,TCTTACGGAGTCCTGGTCAT,0,480288
araBp,0.1111111111111111,8,8,TCTTACACCAGCCGTGAAGC,0,514646
araBp,0.1111111111111111,8,8,TCTCCAGCGGGTAGGAGCCG,0,505317
araBp,0.1111111111111111,8,8,TCTCAGTCACTGTTCTTATA,0,522553
araBp,0.1111111111111111,8,8,TCTAGAAATTAGCAGGGGGA,0,490079
araBp,0.1111111111111111,8,8,TCTACTCTCTGTAGGGCTTC,0,524977
araBp,0.1111111111111111,8,8,TCTACAATTCGCATTTACGC,0,486398
araBp,0.1111111111111111,8,8,TCGTGTGGACACGTCCTTGC,0,477100
araBp,0.1111111111111111,8,8,TCGGGTTTGGGGACCCGGGG,0,476742
araBp,0.1111111111111111,8,8,TCGGGCGGTTGAACTATCAA,0,489791
araBp,0.1111111111111111,8,8,TCGGCTGATTCACTTCGACA,0,471414
araBp,0.1111111111111111,8,8,TCGGATACAATTAGGGAACA,0,514454
araBp,0.1111111111111111,8,8,TCCTAGCCACTATCAACTCG,0,483931
araBp,0.1111111111111111,8,8,TCCGGATATTGGCCGACCGG,0,471577
araBp,0.1111111111111111,8,8,TCCGCAGCGTTTAACGGACT,0,471356
araBp,0.1111111111111111,8,8,TCCCTCACGCTTAATAATTA,0,517467
araBp,0.1111111111111111,8,8,TCCCGTTATCAGGTTTTATT,0,489459
araBp,0.1111111111111111,8,8,TCCATAGAGAGCTTCGGTTA,0,483440
araBp,0.1111111111111111,8,8,TCATAGCGTTCAGCGTAATT,0,515053
araBp,0.1111111111111111,8,8,TCAGCGCATTCCACTTGTAC,0,501725
araBp,0.1111111111111111,8,8,TCACTGAATATATCGAAAAA,0,508431
araBp,0.1111111111111111,8,8,TCAAGCTTTAATATTGAGGG,0,479299
araBp,0.1111111111111111,8,8,TATTGGGTAAAGCCAGTCTG,0,469128
araBp,0.1111111111111111,8,8,TATTATGTTATTAAGATTCC,0,506179
araBp,0.1111111111111111,8,8,TATTAGTGCTCGGAAATCTT,0,510305
araBp,0.1111111111111111,8,8,TATGTTCTGATGTAGGCAGG,0,484177
araBp,0.1111111111111111,8,8,TATCGTTACCATACTTACGT,0,493018
araBp,0.1111111111111111,8,8,TATCGGGCAATTGGTTCGAA,0,476052
araBp,0.1111111111111111,8,8,TATCAACCAATAGTCTTGAT,0,506139
araBp,0.1111111111111111,8,8,TATACGCCTTTACAAAGACC,0,496547
araBp,0.1111111111111111,8,8,TATAAAGCGGATATTTCGGT,0,473294
araBp,0.1111111111111111,8,8,TAGGGCGAAATCAGCTTATG,0,495490
araBp,0.1111111111111111,8,8,TAGCGGTGTCGCAGGGGGCT,0,493199
araBp,0.1111111111111111,8,8,TAGCATTTTTTAGGGTGTAC,0,524779
araBp,0.1111111111111111,8,8,TAGATGTTACGATGCGTAGC,0,502846
araBp,0.1111111111111111,8,8,TACTTTGTATCTAGAGGCGG,0,500742
araBp,0.1111111111111111,8,8,TACTTCTCTTACTACCGTGT,0,478057
araBp,0.1111111111111111,8,8,TACTCACTTGGAGCTCGAGT,0,524881
araBp,0.1111111111111111,8,8,TACGGTAGCACACTGCAGTC,0,468197
araBp,0.1111111111111111,8,8,TACGCTCTATAAAAGTCTTT,0,494411
araBp,0.1111111111111111,8,8,TACGCAATAATATTTGTCCA,0,480399
araBp,0.1111111111111111,8,8,TACCACCTAACGTTGAGCGT,0,477524
araBp,0.1111111111111111,8,8,TACATTGATCGCGATCCGGT,0,501131
araBp,0.1111111111111111,8,8,TACATCCAAGTCGTCGGTTA,0,489957
araBp,0.1111111111111111,8,8,TAATCGCGTCAGACTCTGCC,0,500190
araBp,0.1111111111111111,8,8,TAAGGACTTTTTACGCATAA,0,483085
araBp,0.1111111111111111,8,8,TAAGCTGTGTCTGTCACTGT,0,488255
araBp,0.1111111111111111,8,8,TAAGAACCAACGATAAATGA,0,474222
araBp,0.1111111111111111,8,8,TAACTGAGGCATGAGTGGTT,0,500323
araBp,0.1111111111111111,8,8,TAAAGTTATCCCTGTTCATC,0,510250
araBp,0.1111111111111111,8,8,TAAAGCCTGCGCTGGCAAAG,0,490852
araBp,0.1111111111111111,8,8,TAAAGCAAATGCAGGGAGTT,0,484113
araBp,0.1111111111111111,8,8,TAAAAGGGGTCGTGTCGGAG,0,471159
araBp,0.1111111111111111,8,8,GTTTTTCGGATTCTGACGAG,0,473334
araBp,0.1111111111111111,8,8,GTTTCGGCGGGTCCTCACGC,0,473253
araBp,0.1111111111111111,8,8,GTTGCTTTCTTAACTCCTTA,0,493788
araBp,0.1111111111111111,8,8,GTTGCCAATTGGCAGGCGAG,0,513570
araBp,0.1111111111111111,8,8,GTTGCAGCTCGCATGTAGAT,0,480859
araBp,0.1111111111111111,8,8,GTTGAGGCTCCTACGTGACC,0,522797
araBp,0.1111111111111111,8,8,GTTGACGTCGTACGGTCGTG,0,513821
araBp,0.1111111111111111,8,8,GTTGAACACGTAGCCAGTGG,0,480152
araBp,0.1111111111111111,8,8,GTTCTCGCTAACAACTATAG,0,518431
araBp,0.1111111111111111,8,8,GTTCTAACAATATGGACACC,0,495759
araBp,0.1111111111111111,8,8,GTTCAGCGCTGATGTGCTCG,0,488853
araBp,0.1111111111111111,8,8,GTTACTGAAGTATGTGTTCA,0,524834
araBp,0.1111111111111111,8,8,GTTAATAAAGTTGCGGTGTG,0,500487
araBp,0.1111111111111111,8,8,GTGTTACTTCTAGGAAGACG,0,516656
araBp,0.1111111111111111,8,8,GTGTATCTTGATGTACTCTT,0,502896
araBp,0.1111111111111111,8,8,GTGGTTTAAAATCTTCGGAT,0,512502
araBp,0.1111111111111111,8,8,GTGGTAACCAATTCGGGTAG,0,525132
araBp,0.1111111111111111,8,8,GTGGGCGGGGTGTTCAGGAA,0,492274
araBp,0.1111111111111111,8,8,GTGGAGGGTTTCCGCGGCGG,0,495434
araBp,0.1111111111111111,8,8,GTGGAGATCACCTGTTGCTA,0,506494
araBp,0.1111111111111111,8,8,GTCTCTCAAAGCCGAACAGG,0,486314
araBp,0.1111111111111111,8,8,GTCTAAGTCAGTCTTGTACC,0,524419
araBp,0.1111111111111111,8,8,GTCGGAATCGACTGGTCTCA,0,493973
araBp,0.1111111111111111,8,8,GTCGCAATAGACCGTGGGTT,0,520111
araBp,0.1111111111111111,8,8,GTCCCCCGGATAGCTCCCCC,0,472478
araBp,0.1111111111111111,8,8,GTCCCACCACAGCAGTGGAT,0,473436
araBp,0.1111111111111111,8,8,GTCCATTTTTTCGTGGGTTT,0,516483
araBp,0.1111111111111111,8,8,GTCATAGTTTGTGGTTAAAG,0,490572
araBp,0.1111111111111111,8,8,GTCAGTGCTCGCGACCTTTA,0,487741
araBp,0.1111111111111111,8,8,GTATTGCTATCCTACGTCCG,0,521397
araBp,0.1111111111111111,8,8,GTATGCAAGGCCTGACCGCT,0,477814
araBp,0.1111111111111111,8,8,GTATCAGAACGCAACGGTAC,0,489410
araBp,0.1111111111111111,8,8,GTATATAAAGTCCACCTTGC,0,513811
araBp,0.1111111111111111,8,8,GTAGTCTTACAGGCAGTTCT,0,493576
araBp,0.1111111111111111,8,8,GTACTGACGTGCCAAGTGGC,0,474422
araBp,0.1111111111111111,8,8,GTACATGTTAGTTGTCCGTC,0,469840
araBp,0.1111111111111111,8,8,GTACAGCCCGCTGTTGAGTT,0,468931
araBp,0.1111111111111111,8,8,GTAATTAAAGTATCAAGAAT,0,521032
araBp,0.1111111111111111,8,8,GTAAGGGCTAACGCCCCGAT,0,501221
araBp,0.1111111111111111,8,8,GTAAGAATCCAGACTACCAG,0,502228
araBp,0.1111111111111111,8,8,GTAAACAGCCGGGTATTGTT,0,522295
araBp,0.1111111111111111,8,8,GGTGTTCAGCTGTGCCGGGA,0,495122
araBp,0.1111111111111111,8,8,GGTGTAGGTGAGGAGAAAGC,0,488274
araBp,0.1111111111111111,8,8,GGTGGTGTGGGCCAGGTTAT,0,514356
araBp,0.1111111111111111,8,8,GGTCTAATATCAATAGCTGG,0,511327
araBp,0.1111111111111111,8,8,GGTCGGCTGAACGCTAATTC,0,471958
araBp,0.1111111111111111,8,8,GGTCCTTAGCCTAGTCGAAT,0,478995
araBp,0.1111111111111111,8,8,GGTCCATACATCGCGAGGCG,0,476688
araBp,0.1111111111111111,8,8,GGTATTCTCTGTCACTCGGA,0,491221
araBp,0.1111111111111111,8,8,GGTATGTTTGCTGCCACGTT,0,493426
araBp,0.1111111111111111,8,8,GGTAGGGTACGTAGTTCACA,0,485081
araBp,0.1111111111111111,8,8,GGTACAAACGGGGAGGGCCA,0,480373
araBp,0.1111111111111111,8,8,GGGTACCTCACGGAGGCCTC,0,471275
araBp,0.1111111111111111,8,8,GGGGTGTTGCGTCGAAATAG,0,475238
araBp,0.1111111111111111,8,8,GGGGGTTGATGCTGCCCGAG,0,487814
araBp,0.1111111111111111,8,8,GGGGGCCAAATTAAGATCTG,0,499626
araBp,0.1111111111111111,8,8,GGGGCATACAACGCTATCGT,0,496169
araBp,0.1111111111111111,8,8,GGGCTGTTAACATAGACTTC,0,502805
araBp,0.1111111111111111,8,8,GGGCTAACTGCTGCTCGACC,0,499508
araBp,0.1111111111111111,8,8,GGGCGGGGAGTTTTGCTTTA,0,473083
araBp,0.1111111111111111,8,8,GGGCCGAATACATCTTTACA,0,488838
araBp,0.1111111111111111,8,8,GGGCCAGGGCGTTCGATTTT,0,507621
araBp,0.1111111111111111,8,8,GGGCATTTAGGAGGTTTATG,0,509952
araBp,0.1111111111111111,8,8,GGGCACGCTGCGATGCGATT,0,514425
araBp,0.1111111111111111,8,8,GGGCAACCAGCATTCGGTGA,0,524449
araBp,0.1111111111111111,8,8,GGGATTGTCAAGTCAGTTCC,0,515430
araBp,0.1111111111111111,8,8,GGGATGCTAGACATTTTTCG,0,475159
araBp,0.1111111111111111,8,8,GGGAGCTTACAATGACTAAA,0,516385
araBp,0.1111111111111111,8,8,GGGAGCCCGGGTCGGGCGAG,0,496986
araBp,0.1111111111111111,8,8,GGCTCTCTACGCAGAAGAAA,0,508207
araBp,0.1111111111111111,8,8,GGCTAGAGTACTGGCCATGT,0,510248
araBp,0.1111111111111111,8,8,GGCGTGTAAGGTTTTCCCGA,0,512838
araBp,0.1111111111111111,8,8,GGCGTCTTCCCCAGTCTTTC,0,514627
araBp,0.1111111111111111,8,8,GGCGGTATGAGGCATTCATA,0,479842
araBp,0.1111111111111111,8,8,GGCGGGTGTTAGCGACGTAG,0,500031
araBp,0.1111111111111111,8,8,GGCGCTTGAGGCAGTTCAAA,0,489445
araBp,0.1111111111111111,8,8,GGCGCTGTACACGTATGAAT,0,504201
araBp,0.1111111111111111,8,8,GGCGAGAGCGCTATAATGTA,0,471586
araBp,0.1111111111111111,8,8,GGCCGGTGTCACCTAAGGTT,0,470703
araBp,0.1111111111111111,8,8,GGCCGGGTCCGTAGACATGG,0,509962
araBp,0.1111111111111111,8,8,GGCCCGGCAATGGTGTTTCA,0,492004
araBp,0.1111111111111111,8,8,GGCCCAGTTTCGCTGCAGCA,0,473531
araBp,0.1111111111111111,8,8,GGCCATAAGGTGTACGCAGC,0,483076
araBp,0.1111111111111111,8,8,GGCCAGGCCTACATTTAACG,0,486434
araBp,0.1111111111111111,8,8,GGCAGCGCACCATCTGACAA,0,486207
araBp,0.1111111111111111,8,8,GGCAGCATGATGATGGTTAA,0,482174
araBp,0.1111111111111111,8,8,GGATGTATCCTCCTCTGGAT,0,491618
araBp,0.1111111111111111,8,8,GGAGTGTAGATCGAGTTATG,0,483657
araBp,0.1111111111111111,8,8,GGAGGAAACTGGCGTTCATA,0,514316
araBp,0.1111111111111111,8,8,GGAGATACCGGGTCCCAGTT,0,520587
araBp,0.1111111111111111,8,8,GGAAGAGTCCGCACGTAGGA,0,516713
araBp,0.1111111111111111,8,8,GGAAACGTTCCTGCAGCCCC,0,493254
araBp,0.1111111111111111,8,8,GCTTGGGTCATTGGAGTGGG,0,512340
araBp,0.1111111111111111,8,8,GCTGTGCAGGTCTAGGCAAC,0,500454
araBp,0.1111111111111111,8,8,GCTGGTGTTCGGGCAAAGTG,0,513065
araBp,0.1111111111111111,8,8,GCTCTGCCCCGGGAGTCCCC,0,488182
araBp,0.1111111111111111,8,8,GCTCTCTGGGTGCAGCCCAT,0,521157
araBp,0.1111111111111111,8,8,GCTCGGTTTAGAATCTTGAA,0,511603
araBp,0.1111111111111111,8,8,GCTCATTTTGACCTCGCTGA,0,502729
araBp,0.1111111111111111,8,8,GCTCAGCAGTGGAGGTATGC,0,515845
araBp,0.1111111111111111,8,8,GCTCAATTCAGGTTGTGAAC,0,522913
araBp,0.1111111111111111,8,8,GCTAGCGTTCCGGAACTTGT,0,514352
araBp,0.1111111111111111,8,8,GCTAAGCGATCGTCAGAGTG,0,505208
araBp,0.1111111111111111,8,8,GCGTGATTATTTGCCGCCTT,0,514557
araBp,0.1111111111111111,8,8,GCGGTTTTCCCCGAGTCTAA,0,485407
araBp,0.1111111111111111,8,8,GCGGTGGCAATCGTCAATAC,0,472465
araBp,0.1111111111111111,8,8,GCGGTCGTGGCGCATTGCGT,0,474053
araBp,0.1111111111111111,8,8,GCGGCCCACGGTACCATGTT,0,509115
araBp,0.1111111111111111,8,8,GCGGCATGGGAATAACGCTA,0,517590
araBp,0.1111111111111111,8,8,GCGGACTCAGCGGGGGTTCT,0,519100
araBp,0.1111111111111111,8,8,GCGCGGAGTGGAAAGCGTGG,0,512178
araBp,0.1111111111111111,8,8,GCGCATCTGAAATTATCAGG,0,505256
araBp,0.1111111111111111,8,8,GCGCACGCAAGTTCTTTATG,0,478987
araBp,0.1111111111111111,8,8,GCGCACGACCGCGCGGTCAT,0,482084
araBp,0.1111111111111111,8,8,GCCTTAGTCCTTACGACTTT,0,524431
araBp,0.1111111111111111,8,8,GCCTAAATCGGAGCATTCAA,0,497734
araBp,0.1111111111111111,8,8,GCCGTATGCTGTGGCCGCTA,0,469240
araBp,0.1111111111111111,8,8,GCCGATAGTAAGACTGGGCA,0,503599
araBp,0.1111111111111111,8,8,GCCGAAGTGAATCTGCCAAT,0,520021
araBp,0.1111111111111111,8,8,GCCCCGGTCGCGTTCTCAAC,0,468194
araBp,0.1111111111111111,8,8,GCCCATCCATGATAATGCGC,0,517321
araBp,0.1111111111111111,8,8,GCCATTATTTTGCGCTTCAT,0,476207
araBp,0.1111111111111111,8,8,GCATGCACCCCGGCCAAAGA,0,478462
araBp,0.1111111111111111,8,8,GCATCTAGAGGCTAGCCAGA,0,489184
araBp,0.1111111111111111,8,8,GCAGCTTTAACGCCTGAGGG,0,521543
araBp,0.1111111111111111,8,8,GCAGCATCCCTTTCGTTTGG,0,499716
araBp,0.1111111111111111,8,8,GCACGGCGTAGCGCACTTGT,0,518470
araBp,0.1111111111111111,8,8,GCACGGAACGGTAGTGGACA,0,485284
araBp,0.1111111111111111,8,8,GCACGAACGATGTAGATATC,0,513189
araBp,0.1111111111111111,8,8,GCACACGAATAGGTACTCAC,0,498926
araBp,0.1111111111111111,8,8,GCAAGGGATACTGTTGCGTC,0,490384
araBp,0.1111111111111111,8,8,GCAAGAGCTCCGCTCAACTC,0,516340
araBp,0.1111111111111111,8,8,GATTAGTTCGTGCTTACCTC,0,476913
araBp,0.1111111111111111,8,8,GATGTATAATTGGCGTGATA,0,486300
araBp,0.1111111111111111,8,8,GATGCCCGATATTCCCGTAC,0,507497
araBp,0.1111111111111111,8,8,GATGAGTGAGGCGTAGGTGG,0,513596
araBp,0.1111111111111111,8,8,GATCTCCAGAGAATTCGAAT,0,518327
araBp,0.1111111111111111,8,8,GAGTGGCAGGTAGATACGCA,0,479041
araBp,0.1111111111111111,8,8,GAGTATATAACCGGCCATAT,0,472996
araBp,0.1111111111111111,8,8,GAGGTATCCATCGTAGAAGA,0,493133
araBp,0.1111111111111111,8,8,GAGGCCTTCCCATAGGACGC,0,484851
araBp,0.1111111111111111,8,8,GAGCTCAGTTGGTGTTGGGA,0,512533
araBp,0.1111111111111111,8,8,GAGATTGCCAGCACGACAGG,0,482707
araBp,0.1111111111111111,8,8,GAGACTCTCGCTCCAGCTAG,0,484556
araBp,0.1111111111111111,8,8,GAGAATTGTTGCCAGTGGAT,0,493169
araBp,0.1111111111111111,8,8,GAGAAACGCAAGACCGCCGG,0,494961
araBp,0.1111111111111111,8,8,GACTAAACTAGAAAAAGCCC,0,492604
araBp,0.1111111111111111,8,8,GACGAGTCAGGAACTTCCCA,0,486887
araBp,0.1111111111111111,8,8,GACGAGTAGTTGGCCACACA,0,480694
araBp,0.1111111111111111,8,8,GACCGGTTATAATCCTCCAG,0,475488
araBp,0.1111111111111111,8,8,GACCATTCGTCTTAGTCGAG,0,473474
araBp,0.1111111111111111,8,8,GACCACACGCTACCGAGCGA,0,474468
araBp,0.1111111111111111,8,8,GACAGAAGACATTGCGATTA,0,484010
araBp,0.1111111111111111,8,8,GACAACGTCGGCTCATGCAA,0,482565
araBp,0.1111111111111111,8,8,GAATTCACTTTGTCTAATTA,0,500822
araBp,0.1111111111111111,8,8,GAATCTGTTCAGCTGACAGT,0,474165
araBp,0.1111111111111111,8,8,GAATCGTAACTACATCACAC,0,500109
araBp,0.1111111111111111,8,8,GAACTCATAACTAATCGCTA,0,501398
araBp,0.1111111111111111,8,8,GAAAGTGACGCCCGCCAATG,0,511738
araBp,0.1111111111111111,8,8,GAAAGCGCATCGTCGGATTG,0,504166
araBp,0.1111111111111111,8,8,CTTTTTTTCGCTGTGCGGCT,0,491849
araBp,0.1111111111111111,8,8,CTTTGGGATTTCGCTTACAC,0,512739
araBp,0.1111111111111111,8,8,CTTTCTTAGACGTTGCGATA,0,498600
araBp,0.1111111111111111,8,8,CTTTCCGATATGCTCATACA,0,483812
araBp,0.1111111111111111,8,8,CTTTACCGGTAGGTTTGTAG,0,492052
araBp,0.1111111111111111,8,8,CTTGGTCCTGATTGCGTCCA,0,524373
araBp,0.1111111111111111,8,8,CTTGACCTTAATATGACGTA,0,513367
araBp,0.1111111111111111,8,8,CTTCTTAACGAATGAGCTCA,0,482762
araBp,0.1111111111111111,8,8,CTTCTAATGGGGCCGGTATG,0,486892
araBp,0.1111111111111111,8,8,CTTCCGTTTTCGACGGTGCA,0,497628
araBp,0.1111111111111111,8,8,CTTAGATTGTATGTTTACGA,0,506497
araBp,0.1111111111111111,8,8,CTGTTAGGAAAACAGGCCAG,0,479585
araBp,0.1111111111111111,8,8,CTGGGGTGAACCGGGAACAG,0,479688
araBp,0.1111111111111111,8,8,CTGGCTTCGGACGGGTGTTA,0,468333
araBp,0.1111111111111111,8,8,CTGCATACAGCTAAACATAA,0,498466
araBp,0.1111111111111111,8,8,CTGACGTGTGAAACCTGTGT,0,488366
araBp,0.1111111111111111,8,8,CTGAAACAAGCAGTGTTTAA,0,525108
araBp,0.1111111111111111,8,8,CTCTGGTACATCAGGCCTTC,0,500979
araBp,0.1111111111111111,8,8,CTCTGCGGGGGCCTTATGGA,0,521444
araBp,0.1111111111111111,8,8,CTCTAGGTTCGGCGCTATAC,0,494525
araBp,0.1111111111111111,8,8,CTCTACGTTGAGGGGATTAA,0,482363
araBp,0.1111111111111111,8,8,CTCGCTTTCTGGTAGCCTGC,0,477121
araBp,0.1111111111111111,8,8,CTCGACCCTCACTCGGGGCA,0,495664
araBp,0.1111111111111111,8,8,CTCCGGTACTCCTGCTCCCT,0,512979
araBp,0.1111111111111111,8,8,CTCCGGGGGATACCAGCTGA,0,494367
araBp,0.1111111111111111,8,8,CTCCCCATGCGCCTCTTGAG,0,491554
araBp,0.1111111111111111,8,8,CTCCAACCCGATCTTAGCAT,0,525276
araBp,0.1111111111111111,8,8,CTCACGCGGTGGTATCTAGG,0,496004
araBp,0.1111111111111111,8,8,CTCAAGCAGAAGGCACCCTA,0,509681
araBp,0.1111111111111111,8,8,CTATACATAGACATCAGATA,0,474930
araBp,0.1111111111111111,8,8,CTACGACTCCATGTCAACGA,0,469185
araBp,0.1111111111111111,8,8,CTAATGTACTCCCCACCGCT,0,471158
araBp,0.1111111111111111,8,8,CTAAGAGTGAGGTTGCGACA,0,504291
araBp,0.1111111111111111,8,8,CTAACCGTAAGTCCACAGCA,0,502360
araBp,0.1111111111111111,8,8,CGTTTGGTCAGCGATCTTGT,0,487255
araBp,0.1111111111111111,8,8,CGTTTAATCGGTAATACTCA,0,509535
araBp,0.1111111111111111,8,8,CGTTCCTGTGCGGTACTCGT,0,501217
araBp,0.1111111111111111,8,8,CGTTAAGGCGAGGACGAATG,0,500128
araBp,0.1111111111111111,8,8,CGTGTGTTGAGACTGATCCT,0,471498
araBp,0.1111111111111111,8,8,CGTGTGCCATTACAGACATC,0,489448
araBp,0.1111111111111111,8,8,CGTGGCTCCGTTGAAAACCA,0,518195
araBp,0.1111111111111111,8,8,CGTCGTAACCTTAAAGCAGG,0,522471
araBp,0.1111111111111111,8,8,CGTCGAAATGTTATCGACTC,0,496994
araBp,0.1111111111111111,8,8,CGTCCCCTACCGCAGTGGGT,0,500189
araBp,0.1111111111111111,8,8,CGTCAAAACTGGCAACTACT,0,489193
araBp,0.1111111111111111,8,8,CGTATTTGACAACCGTAATT,0,472989
araBp,0.1111111111111111,8,8,CGGTTAGGGTACGGCGCGTG,0,517294
araBp,0.1111111111111111,8,8,CGGTGGTGCCGTAGCGTGCC,0,490811
araBp,0.1111111111111111,8,8,CGGTGGGGCGCGTTTAGCAT,0,479773
araBp,0.1111111111111111,8,8,CGGTCGTTGATCAAATAAAC,0,498208
araBp,0.1111111111111111,8,8,CGGTCGTCCCTCCCAAATTT,0,476203
araBp,0.1111111111111111,8,8,CGGTAGAATATTAAGTCGTG,0,483825
araBp,0.1111111111111111,8,8,CGGGTTGGTTAATTTTAAAT,0,512518
araBp,0.1111111111111111,8,8,CGGGTTCGGGTGCCTATCAC,0,506724
araBp,0.1111111111111111,8,8,CGGGTTATGTAAGTGTAAGG,0,488062
araBp,0.1111111111111111,8,8,CGGGCCTAGTACTCGACTTT,0,522506
araBp,0.1111111111111111,8,8,CGGGCACATGATATCAAACA,0,523438
araBp,0.1111111111111111,8,8,CGGGATCGGTTGTATATTCC,0,514676
araBp,0.1111111111111111,8,8,CGGCTCAGCTGGGGCTATTT,0,517733
araBp,0.1111111111111111,8,8,CGGCGACTTGTTCCTTGTCG,0,492806
araBp,0.1111111111111111,8,8,CGGCCAATCACAGGCGCAAT,0,474025
araBp,0.1111111111111111,8,8,CGGCATCTATACGGCAGTGA,0,500359
araBp,0.1111111111111111,8,8,CGGATTGCTTGGCTTCACGA,0,501859
araBp,0.1111111111111111,8,8,CGGACCCTCCAAGGAGCTTA,0,515659
araBp,0.1111111111111111,8,8,CGCGCCCCGGATGTTTGCGC,0,520121
araBp,0.1111111111111111,8,8,CGCCTGTGTAATTTTATGAG,0,509920
araBp,0.1111111111111111,8,8,CGCAGGCTTGGTCCACAAGC,0,503703
araBp,0.1111111111111111,8,8,CGCAGCTCGTCAATACTGCA,0,495953
araBp,0.1111111111111111,8,8,CGCAATTAGTCCGACATAAG,0,470799
araBp,0.1111111111111111,8,8,CGATTCTCGAAACGACATGG,0,470204
araBp,0.1111111111111111,8,8,CGATGCGGGTAATTGATGTT,0,495316
araBp,0.1111111111111111,8,8,CGAGTCAACCGGCTAATCGT,0,490525
araBp,0.1111111111111111,8,8,CGACCCTACAGCTTTCCAAC,0,478416
araBp,0.1111111111111111,8,8,CGAATGAATCGACCAGCCAC,0,502708
araBp,0.1111111111111111,8,8,CGAATCTGTAGCAATCGCGG,0,513263
araBp,0.1111111111111111,8,8,CGAAGATAAATTGGACCACA,0,479449
araBp,0.1111111111111111,8,8,CCTTCATTTGCTGCCTCAAC,0,522692
araBp,0.1111111111111111,8,8,CCTTAACACCGCACTCTGCT,0,524717
araBp,0.1111111111111111,8,8,CCTGCTATTAAGTGCGTCCT,0,515755
araBp,0.1111111111111111,8,8,CCTGCGCACTGTCACGTCAG,0,469829
araBp,0.1111111111111111,8,8,CCTCTAGCCGTAACCGGCCT,0,477452
araBp,0.1111111111111111,8,8,CCTCCGGTGCCGTTCTAATG,0,492917
araBp,0.1111111111111111,8,8,CCTAGTGGCACGCGGCAAAC,0,522386
araBp,0.1111111111111111,8,8,CCTAGTAAAAACGCGCACCT,0,487049
araBp,0.1111111111111111,8,8,CCTAGAGGGAAAACGCCTCC,0,476858
araBp,0.1111111111111111,8,8,CCGTTGCTTGACGGGTTAAA,0,507917
araBp,0.1111111111111111,8,8,CCGTGACAACAAAAATTTTA,0,497819
araBp,0.1111111111111111,8,8,CCGTGAAATAATTATTCCAG,0,517298
araBp,0.1111111111111111,8,8,CCGTAACGTGATGTCACGGG,0,488212
araBp,0.1111111111111111,8,8,CCGTAAATAGAACCACATGT,0,498222
araBp,0.1111111111111111,8,8,CCGTAAACTCCGAACTTGGC,0,479045
araBp,0.1111111111111111,8,8,CCGGGCTTTGGATAACAAGG,0,475625
araBp,0.1111111111111111,8,8,CCGGCCTAACAGGTCTTCAT,0,484508
araBp,0.1111111111111111,8,8,CCGGAGTAATCCGATGTGAC,0,503532
araBp,0.1111111111111111,8,8,CCGCCTTACTTCTAAGACCT,0,481039
araBp,0.1111111111111111,8,8,CCGATCTGCGAAATCCAGCT,0,492617
araBp,0.1111111111111111,8,8,CCGAGCCAATTTTCACCTGT,0,517575
araBp,0.1111111111111111,8,8,CCGACAGACTGACTGCTTGA,0,525195
araBp,0.1111111111111111,8,8,CCGACAATCACTCGGTGCAG,0,512166
araBp,0.1111111111111111,8,8,CCGAATGCCTTGGCCGATCG,0,484070
araBp,0.1111111111111111,8,8,CCCTCGTACCCCTAAAAAGA,0,485824
araBp,0.1111111111111111,8,8,CCCTCAAGCGCTTTCATTTC,0,503765
araBp,0.1111111111111111,8,8,CCCGTTGATCACGCACGATT,0,505641
araBp,0.1111111111111111,8,8,CCCGCCCTCAAACATTTATC,0,524240
araBp,0.1111111111111111,8,8,CCCCGTATTCAAGGCCCATG,0,480434
araBp,0.1111111111111111,8,8,CCCCGCCCAAGAAGGTATCA,0,506678
araBp,0.1111111111111111,8,8,CCCCCCGGCTACAGGCGCTC,0,523036
araBp,0.1111111111111111,8,8,CCCATTAGGGTGTGTGAGTA,0,498984
araBp,0.1111111111111111,8,8,CCCACACGTGAAGCGGGCCT,0,482100
araBp,0.1111111111111111,8,8,CCATTTGGACAAGTCTATGG,0,488167
araBp,0.1111111111111111,8,8,CCATTACCACTGTCTACCCA,0,482906
araBp,0.1111111111111111,8,8,CCATGGGACGCTCCGCTATT,0,505744
araBp,0.1111111111111111,8,8,CCATGCACCTCGCACCTTCT,0,516688
araBp,0.1111111111111111,8,8,CCATAATTTGGGGGCGAAAT,0,505489
araBp,0.1111111111111111,8,8,CCAGTCACGCAAGCGCGAAC,0,485363
araBp,0.1111111111111111,8,8,CCAGCTGGGGGATGGTTGTC,0,491327
araBp,0.1111111111111111,8,8,CCACCTTCGGAAAATCAATA,0,481688
araBp,0.1111111111111111,8,8,CCAATTAGGAGCTCCATGCC,0,486187
araBp,0.1111111111111111,8,8,CCAAATGCCTGTCTCGTCCA,0,520052
araBp,0.1111111111111111,8,8,CATTTGGCTCAGCGCATATA,0,484062
araBp,0.1111111111111111,8,8,CATTACTTTACTAATCGACC,0,472532
araBp,0.1111111111111111,8,8,CATGCCCGCTTATCTTACAC,0,488252
araBp,0.1111111111111111,8,8,CATCGGTCCCCGACGTAAAG,0,478560
araBp,0.1111111111111111,8,8,CATCGGCCGGGGACAACCTA,0,475016
araBp,0.1111111111111111,8,8,CATCCCTACTATTCTTCCAG,0,477842
araBp,0.1111111111111111,8,8,CATCAGGTCAACCGGACATA,0,495028
araBp,0.1111111111111111,8,8,CAGTTGGTGCGCGGACTTAT,0,492635
araBp,0.1111111111111111,8,8,CAGTTGGACCGAAGGACGAC,0,517164
araBp,0.1111111111111111,8,8,CAGTTACGGCCAACCCAGCT,0,525333
araBp,0.1111111111111111,8,8,CAGTGTTACATTGTGCTTAG,0,499703
araBp,0.1111111111111111,8,8,CAGTGTACCGCTTATCAACA,0,475736
araBp,0.1111111111111111,8,8,CAGTGGACACGATATCGACT,0,483311
araBp,0.1111111111111111,8,8,CAGTGCGTATACCCCATTAT,0,524195
araBp,0.1111111111111111,8,8,CAGTCGTTCTACGTCCGCTA,0,488466
araBp,0.1111111111111111,8,8,CAGGGTTAGGCATAAGCCGC,0,497562
araBp,0.1111111111111111,8,8,CAGAATACATGGACATACCC,0,512057
araBp,0.1111111111111111,8,8,CAGAAAATAACTTAGGAAAT,0,473449
araBp,0.1111111111111111,8,8,CACTGAAGCTACGCCATAGT,0,496979
araBp,0.1111111111111111,8,8,CACGTTCAGGGTAAGATACG,0,501844
araBp,0.1111111111111111,8,8,CACGGTTGAGAATTGTGGAC,0,520048
araBp,0.1111111111111111,8,8,CACGGTACTTCGCTCGTCTG,0,509411
araBp,0.1111111111111111,8,8,CACGCAGGAACACACGTAAC,0,473374
araBp,0.1111111111111111,8,8,CACCTGGCAACCTGAATTTG,0,494943
araBp,0.1111111111111111,8,8,CACCCAGCAGGAATTGGTCA,0,513562
araBp,0.1111111111111111,8,8,CACCAGTCTATAAATTTTAT,0,492825
araBp,0.1111111111111111,8,8,CACAGATTTTGAACTTGGGG,0,514929
araBp,0.1111111111111111,8,8,CAATTGAGCTAGGTCGAAAT,0,523849
araBp,0.1111111111111111,8,8,CAATTAGTTGTGTTGAAAAG,0,522331
araBp,0.1111111111111111,8,8,CAATCACAGCGGAGTGCGCC,0,475316
araBp,0.1111111111111111,8,8,CAAGGTGCCTTCTACCAGTA,0,515408
araBp,0.1111111111111111,8,8,CAAGGACCTCCAAGTCATGG,0,505746
araBp,0.1111111111111111,8,8,CAAGCAACGAATAATAAGGT,0,472726
araBp,0.1111111111111111,8,8,CAACTGGTTGGGCCATCACG,0,512658
araBp,0.1111111111111111,8,8,CAACTAGGAGATAGCACCCA,0,490506
araBp,0.1111111111111111,8,8,CAACTACACAACATAAGGTA,0,483246
araBp,0.1111111111111111,8,8,CAACCTACGGCGGGACTTGC,0,500781
araBp,0.1111111111111111,8,8,CAACACTGGGTGAATGGCCG,0,508589
araBp,0.1111111111111111,8,8,CAAATTCTGAGCGCGGCGGT,0,510265
araBp,0.1111111111111111,8,8,CAAACTGGGGACCTGTTTCA,0,489087
araBp,0.1111111111111111,8,8,CAAACTACTCGACATAATAA,0,492889
araBp,0.1111111111111111,8,8,ATTTTGTTGCGCATGGAGAA,0,508500
araBp,0.1111111111111111,8,8,ATTTCACTCTAGCCGACAGT,0,503369
araBp,0.1111111111111111,8,8,ATTCTCAGTTCGCCGATTTA,0,470343
araBp,0.1111111111111111,8,8,ATTCATTTCGATCCACGGAC,0,500663
araBp,0.1111111111111111,8,8,ATTCAGGCCAAACGCCGAAG,0,515748
araBp,0.1111111111111111,8,8,ATTAGAATGTGCAGGTTCTC,0,475636
araBp,0.1111111111111111,8,8,ATTACTTGTCAGGTCAAGTC,0,520533
araBp,0.1111111111111111,8,8,ATGTTTGCACAGCCCAGTCA,0,512787
araBp,0.1111111111111111,8,8,ATGTTGTCCTTGTCCTATTT,0,513522
araBp,0.1111111111111111,8,8,ATGTGGTCCTCGCCTATACC,0,475182
araBp,0.1111111111111111,8,8,ATGTCCTGATTCCATCATCC,0,519227
araBp,0.1111111111111111,8,8,ATGTACCAACATAGCATATA,0,513666
araBp,0.1111111111111111,8,8,ATGGTTAGTACAAAATAGTT,0,496814
araBp,0.1111111111111111,8,8,ATGGTACGTCTCTATTCTAT,0,485032
araBp,0.1111111111111111,8,8,ATGATTATGTGTATCGGGGA,0,492001
araBp,0.1111111111111111,8,8,ATGAGTAGTCATAACATCGC,0,481121
araBp,0.1111111111111111,8,8,ATGAGCTGGCGAAGCGATTG,0,482879
araBp,0.1111111111111111,8,8,ATGACGAACCCATGGGCCTT,0,507169
araBp,0.1111111111111111,8,8,ATGACCCGACCCCTAGTATG,0,516027
araBp,0.1111111111111111,8,8,ATGACAGTGCTGCGATCCTA,0,499087
araBp,0.1111111111111111,8,8,ATCTTTGGTCTTAGGCTATC,0,474972
araBp,0.1111111111111111,8,8,ATCTGTCCTTGCCCTTGCCC,0,476067
araBp,0.1111111111111111,8,8,ATCTGGAAAGAGTGTCTAGT,0,477528
araBp,0.1111111111111111,8,8,ATCTCCCACATCCAGACGGA,0,470994
araBp,0.1111111111111111,8,8,ATCTATTTGGTAGGAGGTTT,0,488031
araBp,0.1111111111111111,8,8,ATCCCCCCACCTAGGTGCCG,0,501532
araBp,0.1111111111111111,8,8,ATCATTTGAAATTCCGCATT,0,520207
araBp,0.1111111111111111,8,8,ATCATCACTAAAAGGCGTGT,0,471535
araBp,0.1111111111111111,8,8,ATCACCTAGGTTAGTCCGGA,0,504999
araBp,0.1111111111111111,8,8,ATCAAGCTGTAGCCCAAGCT,0,486476
araBp,0.1111111111111111,8,8,ATATTAGTTGCTATTGGCTC,0,485065
araBp,0.1111111111111111,8,8,ATATGGAATACGATAGCACA,0,512783
araBp,0.1111111111111111,8,8,ATATGCCTGTGAGTATTTTC,0,507613
araBp,0.1111111111111111,8,8,ATAGGTGCAAGACTCTCCCC,0,473346
araBp,0.1111111111111111,8,8,ATAGGATGAGGGTAATTGGT,0,477521
araBp,0.1111111111111111,8,8,ATACGGCGTAGTGACAGTTC,0,486196
araBp,0.1111111111111111,8,8,ATACCCTTACTCAATCCGGT,0,500068
araBp,0.1111111111111111,8,8,ATACCATGAGTCGCGCAGGT,0,476412
araBp,0.1111111111111111,8,8,ATAACTTGTATAGTGGAGTA,0,483492
araBp,0.1111111111111111,8,8,ATAACGAATGCTGAGAGTTA,0,500819
araBp,0.1111111111111111,8,8,ATAACCTCTTGTTGTATACG,0,470102
araBp,0.1111111111111111,8,8,AGTTGGAAGACGTTGCCATG,0,486111
araBp,0.1111111111111111,8,8,AGTCTTGGTGTATTACTGCT,0,488508
araBp,0.1111111111111111,8,8,AGTCCCGATACAAGTGTGTA,0,510660
araBp,0.1111111111111111,8,8,AGTCCCAAGAGAGGTATAGA,0,490986
araBp,0.1111111111111111,8,8,AGTCCAGTAGCTAGGATAGA,0,495565
araBp,0.1111111111111111,8,8,AGTATGACCCTACTTCTGTT,0,474180
araBp,0.1111111111111111,8,8,AGGTTTGCTTACAGAGCTTG,0,504610
araBp,0.1111111111111111,8,8,AGGTTGGGGTCATGGACATG,0,476897
araBp,0.1111111111111111,8,8,AGGTTCGTATTCTTCCCCGG,0,511892
araBp,0.1111111111111111,8,8,AGGTGCGAAACTTGAAAGAC,0,520950
araBp,0.1111111111111111,8,8,AGGTCTCGCACCACTGCGAC,0,500779
araBp,0.1111111111111111,8,8,AGGTCTCAGCGCCTTACGGC,0,487801
araBp,0.1111111111111111,8,8,AGGGGCGCCATTTCTAATAT,0,521098
araBp,0.1111111111111111,8,8,AGGCGTCTAGTGTGGTATGA,0,521597
araBp,0.1111111111111111,8,8,AGGCGCCCCTAATGCATTAA,0,510775
araBp,0.1111111111111111,8,8,AGGATAACATTAGGACCTGC,0,508119
araBp,0.1111111111111111,8,8,AGGAGTCCTTATGGCTGGGA,0,494863
araBp,0.1111111111111111,8,8,AGGAATACGGGGGGTAGGCA,0,475704
araBp,0.1111111111111111,8,8,AGCTGTCGTAGGCAGCTCCG,0,508161
araBp,0.1111111111111111,8,8,AGCTCGGGGGTAGCCTCGAG,0,505131
araBp,0.1111111111111111,8,8,AGCTCCATTGGAGGCTTACA,0,470114
araBp,0.1111111111111111,8,8,AGCGTCCATTAGATTCATAA,0,503279
araBp,0.1111111111111111,8,8,AGCGCTTTCCGCACAGGTGA,0,475148
araBp,0.1111111111111111,8,8,AGCGCGATTGGTAAAGCATG,0,489624
araBp,0.1111111111111111,8,8,AGCCTTCGGTGTTTTCGTGT,0,496178
araBp,0.1111111111111111,8,8,AGCCTATTGACACTACGCCA,0,521870
araBp,0.1111111111111111,8,8,AGCCGGCGCGTTTCGGCAAC,0,493584
araBp,0.1111111111111111,8,8,AGCCCAGCAAAAAGTCGTAC,0,502706
araBp,0.1111111111111111,8,8,AGCATTGGTGGGCACATCAC,0,509879
araBp,0.1111111111111111,8,8,AGCATTAAGCGTTAAGCAGG,0,486980
araBp,0.1111111111111111,8,8,AGCATATTAATGGGAAAATA,0,488761
araBp,0.1111111111111111,8,8,AGATGGTAATGTGCAGTGGT,0,506247
araBp,0.1111111111111111,8,8,AGAGTCTGGTACTAATAACA,0,492670
araBp,0.1111111111111111,8,8,AGAGTCGAATCTCTCTAACC,0,479887
araBp,0.1111111111111111,8,8,AGAGGTCCACAGAGCAGTAC,0,503589
araBp,0.1111111111111111,8,8,AGAGCTGACATTATAGGTCA,0,475567
araBp,0.1111111111111111,8,8,AGACCGAGGTCCGAGCGGTA,0,503801
araBp,0.1111111111111111,8,8,AGAATAATGCACACGAGGTA,0,485189
araBp,0.1111111111111111,8,8,AGAACTGTCTCCAACAAAGT,0,492854
araBp,0.1111111111111111,8,8,ACTTAGAACTCTTAGAGTTT,0,488529
araBp,0.1111111111111111,8,8,ACTGATTAAAGTTCGCCCAC,0,516366
araBp,0.1111111111111111,8,8,ACTGACTTCGTTCGGATCCC,0,516383
araBp,0.1111111111111111,8,8,ACTCAGGCCGGACGTATACG,0,516449
araBp,0.1111111111111111,8,8,ACTCAATACTCTTTGGAAGG,0,498424
araBp,0.1111111111111111,8,8,ACTATCTCTTTCGTTCGGGA,0,489584
araBp,0.1111111111111111,8,8,ACGTTTTCTGCTGAGTCGCT,0,467907
araBp,0.1111111111111111,8,8,ACGTAGGACAGTTGACCTAC,0,487656
araBp,0.1111111111111111,8,8,ACGCTCGCCAAGGTACCCTC,0,515856
araBp,0.1111111111111111,8,8,ACGCAGGCGAGTCCAGCGTA,0,512521
araBp,0.1111111111111111,8,8,ACGCACGCCCAAGCCACAAA,0,502800
araBp,0.1111111111111111,8,8,ACGCACCTCAACGCCTGCAG,0,483422
araBp,0.1111111111111111,8,8,ACGAATTTGCAACGGCTCGT,0,517093
araBp,0.1111111111111111,8,8,ACCTTCGTGTAATACAGATA,0,513484
araBp,0.1111111111111111,8,8,ACCTGCTGATTGCCCCCAGG,0,488102
araBp,0.1111111111111111,8,8,ACCTAAGGCATCGCGATATG,0,507427
araBp,0.1111111111111111,8,8,ACCGCGGCCGGTCTCACAGA,0,513689
araBp,0.1111111111111111,8,8,ACCCGTTAGTAGGATACAGA,0,478377
araBp,0.1111111111111111,8,8,ACCATGCTATAGGGGACTAA,0,513667
araBp,0.1111111111111111,8,8,ACCACGTTGGGAGACATTTA,0,486651
araBp,0.1111111111111111,8,8,ACATTAATTTGAAGAGACAC,0,500609
araBp,0.1111111111111111,8,8,ACATGTATAGAGGCGCGCCG,0,497079
araBp,0.1111111111111111,8,8,ACATCATTACACAGATGCCC,0,496807
araBp,0.1111111111111111,8,8,ACACCCAGCGTGATATGTTA,0,482261
araBp,0.1111111111111111,8,8,AATGGGATTCAGAGATTGAA,0,519801
araBp,0.1111111111111111,8,8,AATGGAGGACCGGGTGGTAG,0,524432
araBp,0.1111111111111111,8,8,AATGGAGATATTTTTGATCC,0,486359
araBp,0.1111111111111111,8,8,AATGCCATAGTGGGTTGGAA,0,482973
araBp,0.1111111111111111,8,8,AATGCACAAAAGGGCTGAAT,0,470372
araBp,0.1111111111111111,8,8,AATGACGGCGAGCCGCGCGT,0,510596
araBp,0.1111111111111111,8,8,AATCGGCGGGGTAGCGACGA,0,515152
araBp,0.1111111111111111,8,8,AATCAGCAGAATGGTCCGTC,0,477657
araBp,0.1111111111111111,8,8,AATATATTGTACTCGACTCT,0,518563
araBp,0.1111111111111111,8,8,AATAGTCCTGTTAAGATTGT,0,492494
araBp,0.1111111111111111,8,8,AATAATAGAGACGTACCTAA,0,498810
araBp,0.1111111111111111,8,8,AAGTTCGAATGTTTACGGAT,0,503255
araBp,0.1111111111111111,8,8,AAGTGGTGGGCGTAGTGGCC,0,483788
araBp,0.1111111111111111,8,8,AAGTGATTCAGCCGGTCTCT,0,496683
araBp,0.1111111111111111,8,8,AAGTAACTTAAGGTCTGCCA,0,494701
araBp,0.1111111111111111,8,8,AAGGGTTCCTTGGTCCATAC,0,480465
araBp,0.1111111111111111,8,8,AAGGGTGGTCCTCCAGCGAG,0,495580
araBp,0.1111111111111111,8,8,AAGGGGCTCAACGATTTGGC,0,498020
araBp,0.1111111111111111,8,8,AAGGCACTCCTCGCTTTTTT,0,469688
araBp,0.1111111111111111,8,8,AAGCATTAAATGGAACAGCA,0,495908
araBp,0.1111111111111111,8,8,AAGAATGCTCTGCGCGACGA,0,497124
araBp,0.1111111111111111,8,8,AACGTATGGCCAAACGCAAG,0,503037
araBp,0.1111111111111111,8,8,AACCTACAGGTTTGTGTTAA,0,510560
araBp,0.1111111111111111,8,8,AACCCTTCGGTCACTCAATT,0,482838
araBp,0.1111111111111111,8,8,AACAGCGTGGCAAGAGATTG,0,513841
araBp,0.1111111111111111,8,8,AAATGGCCACCGGTGGGCAG,0,483487
araBp,0.1111111111111111,8,8,AAATCATCGGTCAATAAGCA,0,473519
araBp,0.1111111111111111,8,8,AAATACACCTATGTCTGAAC,0,494891
araBp,0.1111111111111111,8,8,AAAGTTGAAATAATGGTTGG,0,509158
araBp,0.1111111111111111,8,8,AAAGATGAACGGGGGCCGAT,0,480826
araBp,0.1111111111111111,8,8,AAAGATAGTTTGACCGAGTA,0,508339
araBp,0.1111111111111111,8,8,AAACTGTGGGTAATACGGAG,0,524500
araBp,0.1111111111111111,8,8,AAACGCTGCCAGGAAGCGCA,0,492515
araBp,0.1111111111111111,8,8,AAACATCGCCTAGACACGGC,0,512956
araBp,0.1111111111111111,8,8,AAAATTCTCGGGCAGGAAGG,0,500036
araBp,0.1111111111111111,8,8,AAAAGTGCCATGACGCTTGC,0,506090
araBp,0.125,7,7,TTTTATTGGTTGTGACTCTC,0,515027
araBp,0.125,7,7,TTTGGCTTCACGATAGCAGG,0,500321
araBp,0.125,7,7,TTTGGCCACTTGTATTCCGT,0,488969
araBp,0.125,7,7,TTTGCGTGCTAAAGCGAGTC,0,522432
araBp,0.125,7,7,TTTGCGACGCGATTCAGCCT,0,515902
araBp,0.125,7,7,TTTGCATGGATGCAGGTCCG,0,475453
araBp,0.125,7,7,TTTGATCGGTGTACGCACGT,0,515054
araBp,0.125,7,7,TTTGAAGTTAGTCATGGACC,0,467909
araBp,0.125,7,7,TTTCGGGTCACACGGAGATT,0,499425
araBp,0.125,7,7,TTTATGAATATATCGCTTCT,0,511230
araBp,0.125,7,7,TTTACCCTTCTCTACAATAA,0,468437
araBp,0.125,7,7,TTGTTTCAGTATCACTCAGC,0,471469
araBp,0.125,7,7,TTGTGGCCATACTACAATCC,0,493337
araBp,0.125,7,7,TTGTGAGGCACAATCCCCTG,0,472739
araBp,0.125,7,7,TTGTCAGAACAACAAGTCCA,0,497070
araBp,0.125,7,7,TTGTAACTGCAGCAATGGGT,0,501758
araBp,0.125,7,7,TTGGTCACTCCGGATAATCC,0,517689
araBp,0.125,7,7,TTGGTATACTGGCAACGGCC,0,494094
araBp,0.125,7,7,TTGGGTTGACTCATAATCAT,0,471778
araBp,0.125,7,7,TTGCCGAAACCGTGATCGCA,0,520042
araBp,0.125,7,7,TTGCCCATTTCCGTGTTACA,0,490597
araBp,0.125,7,7,TTGCATCCCGTAGCAAGGGG,0,496256
araBp,0.125,7,7,TTGCAAACATCGCTCGGCTT,0,500491
araBp,0.125,7,7,TTGATTCGCGTTGTCTGCAG,0,520634
araBp,0.125,7,7,TTGATAAAAGCTCCACAGGG,0,525226
araBp,0.125,7,7,TTGAAGTCGCCAGACGGTTG,0,493211
araBp,0.125,7,7,TTGAAGGACAGGCTACCGAA,0,512799
araBp,0.125,7,7,TTGAAAAATTGCTTGGCGAG,0,507537
araBp,0.125,7,7,TTCTACTGGACTCCACCTTC,0,470138
araBp,0.125,7,7,TTCGCCCAGGACGGTTACCC,0,477642
araBp,0.125,7,7,TTCGAAGACGGCAGCTGTAA,0,468223
araBp,0.125,7,7,TTCCGTCCCGGGTCAGTAGT,0,489339
araBp,0.125,7,7,TTCCCCTGGCCCCTAGTAAC,0,509874
araBp,0.125,7,7,TTCCCCACAGTCTGTTGTCA,0,519704
araBp,0.125,7,7,TTCCAGCTGAAGGTCGAATG,0,477802
araBp,0.125,7,7,TTCATCATGATACAAATGAT,0,489518
araBp,0.125,7,7,TTCAACAAATCTTAGCGTAA,0,506480
araBp,0.125,7,7,TTATTACATACCCGGTAAAG,0,504946
araBp,0.125,7,7,TTATGTAGGATTAATGACGC,0,493204
araBp,0.125,7,7,TTAGCTCCACGGCCAAGGAT,0,477671
araBp,0.125,7,7,TTAGCACAGTTACCTTTTGA,0,488467
araBp,0.125,7,7,TTAGAAGTATAGTAATTTTC,0,479766
araBp,0.125,7,7,TTAGAACTCGGACGGTGCTA,0,510658
araBp,0.125,7,7,TTACTTACCAGGGCGCACTG,0,520781
araBp,0.125,7,7,TTACTGGAAGTTTGACTGTA,0,507275
araBp,0.125,7,7,TTAATCGCCAGGCCCCAGGC,0,474500
araBp,0.125,7,7,TTAATACACCGCTTGTCTAG,0,488758
araBp,0.125,7,7,TTAACCAACAAAAGATGAGT,0,515862
araBp,0.125,7,7,TTAAATATTATTTGTTCTTG,0,472516
araBp,0.125,7,7,TGTTGTCAAAATTGGTGAGA,0,476933
araBp,0.125,7,7,TGTTCGAGAGTCACTCCGTT,0,469601
araBp,0.125,7,7,TGTTAAATAAGCCCGTGGAA,0,490510
araBp,0.125,7,7,TGTGTACTAGATGGGTCTCT,0,490826
araBp,0.125,7,7,TGTGGCTGATCTGGGATAAT,0,492780
araBp,0.125,7,7,TGTGACTAATCATCTTCATA,0,495661
araBp,0.125,7,7,TGTGACAATAAGGCAGCGTT,0,504884
araBp,0.125,7,7,TGTGAAAAGGAGTGAAAGCG,0,497248
araBp,0.125,7,7,TGTCTACAAGAATTCGGGTG,0,496889
araBp,0.125,7,7,TGTCACATAGGCACCGGTGC,0,479163
araBp,0.125,7,7,TGGGTTCATTCTCAAAGAAG,0,485802
araBp,0.125,7,7,TGGGTGGTTACGTAGAACGT,0,521267
araBp,0.125,7,7,TGGGGTGTGTGCTAAAATCT,0,488202
araBp,0.125,7,7,TGGGCTGCACAAGTCGGTAT,0,493941
araBp,0.125,7,7,TGGGCGGTATCGAGTGTATA,0,504173
araBp,0.125,7,7,TGGGACTTTTTCCTCCACGA,0,497279
araBp,0.125,7,7,TGGCTACATCTTCCAATTCG,0,524086
araBp,0.125,7,7,TGGCGCCCGCTTGCGCCGGG,0,493949
araBp,0.125,7,7,TGGAGAGTTTCAAATTTTAG,0,507591
araBp,0.125,7,7,TGGACGGCAGTCAATTTTCT,0,511236
araBp,0.125,7,7,TGGAATCAATCCAGTCATTA,0,479655
araBp,0.125,7,7,TGCTACATGGACACATTGCT,0,487859
araBp,0.125,7,7,TGCGTGAGCACGAGCATGGA,0,520615
araBp,0.125,7,7,TGCGGTAGCCCCAGCAGTCG,0,523410
araBp,0.125,7,7,TGCCGGGAGACTTCGTGAAA,0,468441
araBp,0.125,7,7,TGCCCCGTCCATATCGGCGT,0,497433
araBp,0.125,7,7,TGCCCCCAAGAGTCCATATG,0,484971
araBp,0.125,7,7,TGCAGATACCGGATGCTTCA,0,515209
araBp,0.125,7,7,TGCAGACTGCTTAGTGTGTC,0,500836
araBp,0.125,7,7,TGAGGAGTTTTCGGCTACAG,0,503207
araBp,0.125,7,7,TGACTTCGGTTAGAGAGCCA,0,502362
araBp,0.125,7,7,TGACTATGTGGACAGTATTT,0,471983
araBp,0.125,7,7,TGACGTAGTGCCTGGATGGT,0,491532
araBp,0.125,7,7,TGACGGGATTTCGGCCCGTC,0,499701
araBp,0.125,7,7,TGACGACCCGTCGCTTATCA,0,509171
araBp,0.125,7,7,TGACATGTTAGTAGTTATGC,0,476700
araBp,0.125,7,7,TGAAGCCAAGCAATGAACGA,0,476963
araBp,0.125,7,7,TCTTGCCGGTAAAACGAGTG,0,502762
araBp,0.125,7,7,TCTTAGGGCATCCCAATACA,0,492877
araBp,0.125,7,7,TCTTAGCCCAACCGATACGG,0,517378
araBp,0.125,7,7,TCTGTTACATACCTAAGCTG,0,503673
araBp,0.125,7,7,TCTGGTGCTCTTTCAATGGA,0,473168
araBp,0.125,7,7,TCTGGAAATAATCGGAACAA,0,501776
araBp,0.125,7,7,TCTGCTCGGCAGGGGGGACA,0,469920
araBp,0.125,7,7,TCTGCATGAACGCAACCAGT,0,484342
araBp,0.125,7,7,TCTCGCCTCCGGCGTACAAA,0,479244
araBp,0.125,7,7,TCTATTATGCGACCCCGACG,0,486579
araBp,0.125,7,7,TCTATTACAGAAGTCGGTGC,0,508475
araBp,0.125,7,7,TCTATCACGACCATAAGCTT,0,500411
araBp,0.125,7,7,TCGTATTCCGGTTTCTTAGT,0,479852
araBp,0.125,7,7,TCGTAGTGTAGTACGTGCTA,0,490805
araBp,0.125,7,7,TCGGTTAAACTCATTTTGGA,0,486686
araBp,0.125,7,7,TCGGGGTACAGCAATCGCCT,0,518180
araBp,0.125,7,7,TCGGGGCTGGGGGTAGTCAG,0,509911
araBp,0.125,7,7,TCGGCGCGGTTTCGGTCCAC,0,494590
araBp,0.125,7,7,TCGCGGACAGGTCAAGATAA,0,481824
araBp,0.125,7,7,TCGAATATAATCTTCTAATG,0,516737
araBp,0.125,7,7,TCCTAGAGGTACGGTGGGTT,0,524550
araBp,0.125,7,7,TCCGAACAGAAATGCCATGG,0,514323
araBp,0.125,7,7,TCCCTCCGTCCCTTAGCCTT,0,487057
araBp,0.125,7,7,TCCCCCCAATGTTCGTTTGT,0,468384
araBp,0.125,7,7,TCCATTTGGATAACGCTCTC,0,516080
araBp,0.125,7,7,TCCATGCGTTCCGTTTAGAG,0,489737
araBp,0.125,7,7,TCCAGGCGACTGTTCAACAC,0,478782
araBp,0.125,7,7,TCCAGAGCGGGCTCAGAGGA,0,512809
araBp,0.125,7,7,TCCAGACTCGGGGTATGCAA,0,470324
araBp,0.125,7,7,TCCACCGTACCTTGTTGACC,0,495410
araBp,0.125,7,7,TCCACCCAGCAATCAACGTA,0,516082
araBp,0.125,7,7,TCATTGCGCTCAATCGGAGA,0,493778
araBp,0.125,7,7,TCATTCAGATAGGACCCGCT,0,502876
araBp,0.125,7,7,TCATGATCGCGAACCACCGT,0,469880
araBp,0.125,7,7,TCAGGCGTAGCGGCACTTTA,0,485203
araBp,0.125,7,7,TCAGAATCAGCTCGAGTATC,0,523989
araBp,0.125,7,7,TCAGAATACGCAAGACTGTG,0,488682
araBp,0.125,7,7,TCACACGTAAACGGTTTGCC,0,499386
araBp,0.125,7,7,TCAACATCTTAACTTGGTTC,0,481314
araBp,0.125,7,7,TCAAATCTTTTACCCTCCTC,0,519811
araBp,0.125,7,7,TATTGGCTATAGTGGAAGAG,0,509676
araBp,0.125,7,7,TATTAGGACCATGGCATTCT,0,498396
araBp,0.125,7,7,TATGTCGAATTTCACACTAA,0,468608
araBp,0.125,7,7,TATGGGGGATTGTACTTACT,0,471813
araBp,0.125,7,7,TATGGACGGCATCATTGCTA,0,472023
araBp,0.125,7,7,TATGATAGCATGCAGGTACC,0,490035
araBp,0.125,7,7,TATCTACTACTATTTTGAAC,0,477342
araBp,0.125,7,7,TATAGATTAACATATGTTAT,0,511976
araBp,0.125,7,7,TATACGGAGTTTGGTAGTGA,0,482748
araBp,0.125,7,7,TAGGTAGAGCCAATCGATCG,0,506974
araBp,0.125,7,7,TAGGGGATATTTTGGTGGAA,0,492568
araBp,0.125,7,7,TAGGCAATACGCATCGTTTG,0,499080
araBp,0.125,7,7,TAGGAAGTACAAACGTCGGT,0,523115
araBp,0.125,7,7,TAGGAAATTCGGCTTAATGG,0,485921
araBp,0.125,7,7,TAGCCCTGGCTCGGATACGA,0,519248
araBp,0.125,7,7,TAGCAAGGTACGCTCTGCCT,0,510094
araBp,0.125,7,7,TAGATTTCACGGCGGTCTAT,0,486844
araBp,0.125,7,7,TAGAGTACAGGGCTGTTTAT,0,484977
araBp,0.125,7,7,TAGAGCTCCCGGAACTTTGC,0,507646
araBp,0.125,7,7,TAGAAATCAGAGATTCGATT,0,479594
araBp,0.125,7,7,TAGAAATAACATTCAAACGC,0,484230
araBp,0.125,7,7,TACTTAGAAAAGGTAGACGT,0,500869
araBp,0.125,7,7,TACTCGGGCATCCGGGAGAT,0,522791
araBp,0.125,7,7,TACTACAGGGGACACGTTAT,0,468831
araBp,0.125,7,7,TACGGGGGACTCTGCTATCA,0,495357
araBp,0.125,7,7,TACCTGTGACTCGGTTCGAG,0,484703
araBp,0.125,7,7,TACCTCCTTCCGTTGGGCCT,0,489132
araBp,0.125,7,7,TACCGGGATACGTCGGATTG,0,505849
araBp,0.125,7,7,TACCGACCAGGTGTAGGAAA,0,489385
araBp,0.125,7,7,TACACGAGCGTGGTGTTGTA,0,506972
araBp,0.125,7,7,TACAAATTTATTGGCAACGC,0,514670
araBp,0.125,7,7,TAATTGGTCTGCAACCACGA,0,493952
araBp,0.125,7,7,TAATGCCCTGCCACATAGGC,0,471019
araBp,0.125,7,7,TAATCCGCAGTCCCAAAGAG,0,497337
araBp,0.125,7,7,TAATCATCATTTGGATTTCG,0,519150
araBp,0.125,7,7,TAATATAAATGTGCAGCGGG,0,499980
araBp,0.125,7,7,TAATAGGTACTTCCAGCAGG,0,515523
araBp,0.125,7,7,TAAGTCACGCACTTGCATTG,0,498529
araBp,0.125,7,7,TAAGGTCGGAGGGGTCGAAA,0,476671
araBp,0.125,7,7,TAAGCGTGTTCAGGACATGG,0,516654
araBp,0.125,7,7,TAAGATGCATTCACTAGATC,0,520902
araBp,0.125,7,7,TAACGTTCGAGAAGGTTTCC,0,501525
araBp,0.125,7,7,TAACGTTATCAACCGGCGTT,0,501838
araBp,0.125,7,7,TAACCACTGTTTCTGCGTAA,0,515362
araBp,0.125,7,7,TAACAAATTCAGAGACAAAA,0,506521
araBp,0.125,7,7,GTTTTATTCCCATGCTGTTG,0,504371
araBp,0.125,7,7,GTTTGAATGTATTGCATTTC,0,485035
araBp,0.125,7,7,GTTTGAACAATTTGGAGGAC,0,498538
araBp,0.125,7,7,GTTTACACACCGGGACGTAA,0,504959
araBp,0.125,7,7,GTTGGGATATATGGAATCGT,0,507133
araBp,0.125,7,7,GTTGGAGCACTCATCAGATA,0,480812
araBp,0.125,7,7,GTTGAGCTACGCCTGCAGAG,0,491063
araBp,0.125,7,7,GTTCTATGATCACGGGCGAT,0,524666
araBp,0.125,7,7,GTTCGTTGGATGGTGATACA,0,522604
araBp,0.125,7,7,GTTCGTGTCAAAAGATGCTA,0,500573
araBp,0.125,7,7,GTTCAGATCACAACTCAGGC,0,506362
araBp,0.125,7,7,GTTATACTGGTAGGTTTCTC,0,479322
araBp,0.125,7,7,GTTAGATAGCGCAGGTCTGA,0,476982
araBp,0.125,7,7,GTTACAATTACGTCCGATGA,0,488136
araBp,0.125,7,7,GTTAATCCCTCTTGGGAAGT,0,482120
araBp,0.125,7,7,GTGTGGCCACCGGACCACTG,0,513398
araBp,0.125,7,7,GTGTGAACCAGAAAGACGTG,0,525309
araBp,0.125,7,7,GTGTCAGCAGGGAGGTGCTG,0,524527
araBp,0.125,7,7,GTGTATTCCAGAGCTTATTA,0,493329
araBp,0.125,7,7,GTGTAGGTAACTTCAGTCGT,0,508253
araBp,0.125,7,7,GTGTACGATACGTCCGTTTA,0,473081
araBp,0.125,7,7,GTGGTTTGTGCTAGACTCTT,0,482792
araBp,0.125,7,7,GTGGTGAGCAGACGGGAAGA,0,486763
araBp,0.125,7,7,GTGGTCCAGGCTAGTTTGTG,0,475587
araBp,0.125,7,7,GTGGGGTAATGTACGTAACC,0,472368
araBp,0.125,7,7,GTGGGGAAGTTCTTGACTCG,0,492548
araBp,0.125,7,7,GTGGGCGCTTTATCGTTCTA,0,471361
araBp,0.125,7,7,GTGGCAAGTGCTTTCTAAGT,0,483708
araBp,0.125,7,7,GTGGACGCTATGTCTACTGG,0,520674
araBp,0.125,7,7,GTGCGATGTCAGCACATACC,0,486060
araBp,0.125,7,7,GTGCAGGGTAGATGATTTGC,0,483651
araBp,0.125,7,7,GTGCAGCCCTACCTCACACT,0,479245
araBp,0.125,7,7,GTGATGATATAAGGGACTTA,0,513858
araBp,0.125,7,7,GTGAGTACGTTTGCGAGTGT,0,501921
araBp,0.125,7,7,GTGACGCATCGTTGAGACTG,0,480328
araBp,0.125,7,7,GTGAACGGCAGGGATGGTCT,0,484498
araBp,0.125,7,7,GTCTATTTGCCAGGTACCTT,0,506796
araBp,0.125,7,7,GTCTACTGGTCGAATGGTCA,0,484236
araBp,0.125,7,7,GTCTAAAGTGCTCCTCGTTT,0,471355
araBp,0.125,7,7,GTCGGGTTATCGAACGGTCC,0,475947
araBp,0.125,7,7,GTCCCTTACCTATTGAATGC,0,504984
araBp,0.125,7,7,GTCCCTCGCGAAAGCTGCGC,0,489536
araBp,0.125,7,7,GTCCCACAATACTCTGAGAA,0,492628
araBp,0.125,7,7,GTCAATTCTTAGTGTAATAT,0,505708
araBp,0.125,7,7,GTATTGTTACAACCGGTGTA,0,506177
araBp,0.125,7,7,GTATGAGGCTTAAAATTAGT,0,505654
araBp,0.125,7,7,GTATGAGACCAAAATGTCCT,0,511402
araBp,0.125,7,7,GTATATATTATCTTGAGATT,0,499147
araBp,0.125,7,7,GTAGTCCATCGGTTTTGTAT,0,521325
araBp,0.125,7,7,GTAGCTGGATATGGCCACCG,0,512805
araBp,0.125,7,7,GTAGATGCGGATGAACCACT,0,473358
araBp,0.125,7,7,GTACGACGAACTGGGTAAGT,0,482740
araBp,0.125,7,7,GTACAGCACTCGCATGCGAC,0,469587
araBp,0.125,7,7,GTACAAAGTGGTCCACGACT,0,490291
araBp,0.125,7,7,GTAATGTAGCGTTAATAACT,0,487240
araBp,0.125,7,7,GTAATGATGTCTGTGGCAGT,0,502651
araBp,0.125,7,7,GTAAGGTGTACCGAGGATGA,0,475901
araBp,0.125,7,7,GTAAAAAGGTATACGTAGAA,0,474605
araBp,0.125,7,7,GGTGTCGTTAGTCCTTTGTC,0,482540
araBp,0.125,7,7,GGTGGAGCGGGGATTACATG,0,477778
araBp,0.125,7,7,GGTGCGAGCAGAGACATCAA,0,511969
araBp,0.125,7,7,GGTGCACCACACTCAACTTA,0,512467
araBp,0.125,7,7,GGTGAGACGAAATATAATGT,0,503450
araBp,0.125,7,7,GGTCTTACATTGTGAAGGAA,0,525018
araBp,0.125,7,7,GGTCGTTTTCATCATTGAAT,0,494501
araBp,0.125,7,7,GGTCGTGTAGAAAATTGCTA,0,490548
araBp,0.125,7,7,GGTCGCTCAGCTTATATGGG,0,505418
araBp,0.125,7,7,GGTCCGATGCAGACTGCAAT,0,488377
araBp,0.125,7,7,GGTATTATTAAATGATGTAG,0,496893
araBp,0.125,7,7,GGTATGGGAATTGTCTCAGA,0,522052
araBp,0.125,7,7,GGTAGGCTTGTATCTTATGG,0,488473
araBp,0.125,7,7,GGTAGGAGTATACGAGCCGA,0,480599
araBp,0.125,7,7,GGTACGGATCTTGCACGTAG,0,501531
araBp,0.125,7,7,GGGTTGGTGGTTGTAGCGTC,0,504531
araBp,0.125,7,7,GGGTTGGATCTAGAATGCAA,0,468292
araBp,0.125,7,7,GGGTTCGACCGTACTATATA,0,524873
araBp,0.125,7,7,GGGTGCGGATCTTCAAGGTC,0,511483
araBp,0.125,7,7,GGGTCAGGCAGACCAATTGA,0,518510
araBp,0.125,7,7,GGGTCACCTTGGTCGTTCCA,0,504343
araBp,0.125,7,7,GGGTAGGTCCTGGCCTGCAA,0,467788
araBp,0.125,7,7,GGGTACAGCAGTGCAGCAGT,0,510244
araBp,0.125,7,7,GGGGGGCCGTCAGACAGCGT,0,470047
araBp,0.125,7,7,GGGGATACGTAAGTCTCAAA,0,473390
araBp,0.125,7,7,GGGCTGACTAGAACGGTTCT,0,490442
araBp,0.125,7,7,GGGCGCAAATCTCTATGCGT,0,484676
araBp,0.125,7,7,GGGCCTGGCGGACTGACCAT,0,470981
araBp,0.125,7,7,GGGCAGTAAGTGTGACACGA,0,491086
araBp,0.125,7,7,GGGAGAAGCATCCGACCATA,0,506101
araBp,0.125,7,7,GGGACCCCCCGTAGGGTTGC,0,495802
araBp,0.125,7,7,GGCTTGGCGGTGACGATTCA,0,498484
araBp,0.125,7,7,GGCTAGTTAACTAGCAGGGC,0,506151
araBp,0.125,7,7,GGCTAGCCAGAAATATACTT,0,473062
araBp,0.125,7,7,GGCGTTATATACTTGTTTGT,0,493201
araBp,0.125,7,7,GGCGGTAGTGAAAATAACCT,0,467984
araBp,0.125,7,7,GGCGGACTAGAAGGCCGGAC,0,505297
araBp,0.125,7,7,GGCCGGCAGGTGCCTTCCCA,0,479830
araBp,0.125,7,7,GGCATGATCACTTAAGCTTG,0,481242
araBp,0.125,7,7,GGCATATCCTATATCTTCGC,0,492668
araBp,0.125,7,7,GGCAGAGTCGAAGGCCACAT,0,519228
araBp,0.125,7,7,GGCACCTGCTTGGGTTGAAA,0,515014
araBp,0.125,7,7,GGCAAGTCCTTAAAACAGTA,0,485951
araBp,0.125,7,7,GGATGCGAGCAATTAGGTAC,0,500004
araBp,0.125,7,7,GGAGTTCATGCGTTAGCATA,0,472574
araBp,0.125,7,7,GGAGTTAGGAGGCTGCTCAT,0,514840
araBp,0.125,7,7,GGAGCTCCAGCTGCTGCCAG,0,477374
araBp,0.125,7,7,GGACTAGGGTACATACGAGG,0,501821
araBp,0.125,7,7,GGACCTAGTCGAGGGCCACA,0,485709
araBp,0.125,7,7,GGACCGCATGCGTAACCCGG,0,485038
araBp,0.125,7,7,GGACACCACTTCACCGCGCG,0,519301
araBp,0.125,7,7,GGAAAAACGTGCTGTATTGG,0,518494
araBp,0.125,7,7,GCTTTTCACCTGTTTCGTAG,0,511085
araBp,0.125,7,7,GCTTTTATTCCGGAGCGTTG,0,522688
araBp,0.125,7,7,GCTTCCCTGATATTGGCAGT,0,517577
araBp,0.125,7,7,GCTGTAGCTCGGTAAGAGAC,0,507367
araBp,0.125,7,7,GCTGCACCATCGTGTGTGCG,0,504107
araBp,0.125,7,7,GCTCCGCGCCAGTAGAGGTT,0,477960
araBp,0.125,7,7,GCTAGTAACCGCACAATCTA,0,520706
araBp,0.125,7,7,GCGTATATGCTCCGCAAATT,0,468754
araBp,0.125,7,7,GCGTACTGTCCACGGGCCTC,0,500896
araBp,0.125,7,7,GCGGTATTGGTCGCCGGTCG,0,514238
araBp,0.125,7,7,GCGGCGGCATATAGAATGGA,0,515292
araBp,0.125,7,7,GCGGCCGTGGTGGACCGAAC,0,499109
araBp,0.125,7,7,GCGGATTTGGAGAGTGTAAA,0,473511
araBp,0.125,7,7,GCGGACGCCAATTGCCCTTG,0,508278
araBp,0.125,7,7,GCGATTATAGCGCGGGTGCT,0,510688
araBp,0.125,7,7,GCGAGAAATCCCGGCAGCAT,0,478116
araBp,0.125,7,7,GCCTTGACGCTCGATACGGT,0,487407
araBp,0.125,7,7,GCCTGGACTTGGGTTAGTGT,0,500351
araBp,0.125,7,7,GCCGTATGGTTACAATCAGT,0,505623
araBp,0.125,7,7,GCCGGAGATAGCGGCGTCAA,0,491458
araBp,0.125,7,7,GCCGGAAGCCGCGACGTTCT,0,470498
araBp,0.125,7,7,GCCGCATATGTGTTAGTGTG,0,503425
araBp,0.125,7,7,GCCGAAGCCGCGAGCCTCGC,0,524981
araBp,0.125,7,7,GCCCACAATCACGAACGCGT,0,475772
araBp,0.125,7,7,GCCATCATTCGGGGGCGCGG,0,486157
araBp,0.125,7,7,GCCAACCCATTTTTTTCATT,0,478625
araBp,0.125,7,7,GCATTCCGCGTTGTCCAATT,0,506165
araBp,0.125,7,7,GCATGGGAATTCAGACCAAT,0,474456
araBp,0.125,7,7,GCATGCATCGGGCTTGGTCA,0,497205
araBp,0.125,7,7,GCAGTTTGGCCAGTGGTATT,0,509078
araBp,0.125,7,7,GCACCTTACAATAGATTCTG,0,469148
araBp,0.125,7,7,GCACCGCGTCGGCTACTCGC,0,474310
araBp,0.125,7,7,GCACCCTTACAGCGAATTTC,0,490032
araBp,0.125,7,7,GCACAGCTTCACAGTCAGGC,0,497576
araBp,0.125,7,7,GCACACGACGTTTTTATTCC,0,480595
araBp,0.125,7,7,GCAATCCCGGTGACCCGGGT,0,480335
araBp,0.125,7,7,GCAATCCCCAGATCCTTCGC,0,503215
araBp,0.125,7,7,GCAAGGCCTGCGGTTATCCT,0,507410
araBp,0.125,7,7,GCAACATGTAGGCCCGTAGC,0,494000
araBp,0.125,7,7,GATTATTAAGTACCAATCGG,0,479603
araBp,0.125,7,7,GATTATAGTGCGCACCGACG,0,506997
araBp,0.125,7,7,GATGTTCACGTTAAACCGCA,0,475579
araBp,0.125,7,7,GATGTCTTGTTAGAAGTTGT,0,495476
araBp,0.125,7,7,GATGCTGGACGAGAGCGGTT,0,475305
araBp,0.125,7,7,GATGCGCTGATCGAAGAAAT,0,496616
araBp,0.125,7,7,GATGATTTTTGCGTCAAATT,0,496129
araBp,0.125,7,7,GATCGATATGAAGGTAGGCG,0,472860
araBp,0.125,7,7,GATCCCGGACCCTATCTGGG,0,507261
araBp,0.125,7,7,GATCACCTTACCCTCTCAAG,0,490197
araBp,0.125,7,7,GAGTTTTGCCGCATTACCCC,0,470786
araBp,0.125,7,7,GAGTTTCTCGCCGGGAACCC,0,495758
araBp,0.125,7,7,GAGTCTCGAAGGTTTGGGTT,0,514617
araBp,0.125,7,7,GAGTCCCGACACAGAGTTCA,0,522590
araBp,0.125,7,7,GAGGTATGAATGAGGGATAA,0,495162
araBp,0.125,7,7,GAGGCCTTCTAATAAACGCT,0,517694
araBp,0.125,7,7,GAGCGGGCTGCGGCCCCGCC,0,482452
araBp,0.125,7,7,GAGCCCGTCTTTGGATGAAA,0,511241
araBp,0.125,7,7,GAGCCCGGGTCTTTCCCAGA,0,485486
araBp,0.125,7,7,GAGCCATACGGCCATTCAAG,0,491631
araBp,0.125,7,7,GAGACTCTAGGTGGTTGGCT,0,475308
araBp,0.125,7,7,GACTGGTAGACCCGCTGTCA,0,513251
araBp,0.125,7,7,GACTAGGACTGCGACCAACA,0,494487
araBp,0.125,7,7,GACGTTTGCGCCTAATTGAA,0,486199
araBp,0.125,7,7,GACGGGCTCAGGCTAGTAAC,0,499927
araBp,0.125,7,7,GACGGAGTGATTTGATGTAT,0,521318
araBp,0.125,7,7,GACGGAGCTGTCATTGCGTC,0,523339
araBp,0.125,7,7,GACGAATCGGTCAAGGCTCA,0,469793
araBp,0.125,7,7,GACCTTATGTTCCCCGGTTT,0,510277
araBp,0.125,7,7,GACCGTTTCGTGCATGGCAT,0,468915
araBp,0.125,7,7,GACCGGTGGATCGCTACAGC,0,484709
araBp,0.125,7,7,GACCGAAAGCGGATGCATCC,0,483351
araBp,0.125,7,7,GACCCCCCTAATGCTAGGGG,0,519524
araBp,0.125,7,7,GACCATCCGACCTCATTAGC,0,484370
araBp,0.125,7,7,GACCAAGAGAGAGCGGGGTA,0,477839
araBp,0.125,7,7,GACAGGACGCGGATGATAGC,0,518548
araBp,0.125,7,7,GACAATCAGGTTGGGGTTAG,0,518331
araBp,0.125,7,7,GACAACTTGTCAGCTGTGAC,0,490331
araBp,0.125,7,7,GAATTGGACTTCCTTCGGTA,0,487738
araBp,0.125,7,7,GAAGTGGGCTCGTTTGTCTC,0,471160
araBp,0.125,7,7,GAACTTATTGTCCCTTGCGT,0,495695
araBp,0.125,7,7,GAACGGCGGAGATCTGTAGG,0,475531
araBp,0.125,7,7,GAACGACTCTGTATTTTCAG,0,509101
araBp,0.125,7,7,GAACCCATCCATCGGGTCTT,0,504907
araBp,0.125,7,7,GAAAGGTTCGTGTAACTCGA,0,508693
araBp,0.125,7,7,CTTTTTCCTGAATTTCTCCT,0,504831
araBp,0.125,7,7,CTTTTGGACACTCTTGGACG,0,481043
araBp,0.125,7,7,CTTTGAAGATCCGCATTAAG,0,499021
araBp,0.125,7,7,CTTTCTACCAAAGTCGAGCG,0,508237
araBp,0.125,7,7,CTTGACATTTGCATGCACGC,0,521533
araBp,0.125,7,7,CTTCATTTTAATAAGGCTAG,0,495238
araBp,0.125,7,7,CTTATGTCTGGGTTGCCCAT,0,521324
araBp,0.125,7,7,CTTACCGAAACTTTAGCATT,0,488315
araBp,0.125,7,7,CTGTTCAATCGGGCATCCGT,0,495486
araBp,0.125,7,7,CTGTTACGTGTTGGCGAGTT,0,469968
araBp,0.125,7,7,CTGTAGAGCGGCCCTCAGGC,0,482753
araBp,0.125,7,7,CTGTACTGGTTGAGAATGGG,0,473830
araBp,0.125,7,7,CTGGTTTTAGTCATTACTAA,0,489665
araBp,0.125,7,7,CTGGGGTTTGTGCTGTCATG,0,513419
araBp,0.125,7,7,CTGGCAGTAAACGGCTCGCA,0,496681
araBp,0.125,7,7,CTGGCACTGACCGCGCGCGG,0,492041
araBp,0.125,7,7,CTGGAGCCTGTTAATGATCG,0,506562
araBp,0.125,7,7,CTGCGAATGCATTCTCCTGT,0,477636
araBp,0.125,7,7,CTGCAAGACCAGGAATCAAC,0,481782
araBp,0.125,7,7,CTGATGTCCCCTGGCAGATA,0,475187
araBp,0.125,7,7,CTGATCGTGCCATTCTGAGG,0,515525
araBp,0.125,7,7,CTGAGGCGTCTCGTTCCACA,0,482057
araBp,0.125,7,7,CTGAGCTGGCTAGGGGTGGC,0,468434
araBp,0.125,7,7,CTGAATTACTTGGCGGGAAT,0,509165
araBp,0.125,7,7,CTGAAGTGAAATCGAAGAGA,0,470317
araBp,0.125,7,7,CTCTGTAAATCCTGAGCGTT,0,521066
araBp,0.125,7,7,CTCTCGCACGTCGGTCACGA,0,499471
araBp,0.125,7,7,CTCTCCGCATTCTGCGCGAT,0,469576
araBp,0.125,7,7,CTCTCAGCATCAAATGTCTT,0,468346
araBp,0.125,7,7,CTCGGTTTCAGAACACACCA,0,482116
araBp,0.125,7,7,CTCGGACTTGCACTATTCGT,0,483485
araBp,0.125,7,7,CTCGCATTATTACTATGGTA,0,482459
araBp,0.125,7,7,CTCGCAGCAGATATAGTTAC,0,508689
araBp,0.125,7,7,CTCGAGTTACTTTTCGACAT,0,521191
araBp,0.125,7,7,CTCCGTTGTGACATTATCAC,0,520316
araBp,0.125,7,7,CTCCCCTTCTTCTGAAACAT,0,513420
araBp,0.125,7,7,CTCCCACCAGCTCTGGAGTC,0,508730
araBp,0.125,7,7,CTCCATTATAGGGCGTGTAA,0,468377
araBp,0.125,7,7,CTCACTCGATAGGTCTCGGA,0,499226
araBp,0.125,7,7,CTCAACTCTATTTAAAACAT,0,478472
araBp,0.125,7,7,CTATTCTCTAGCTTGAAAGT,0,522689
araBp,0.125,7,7,CTAGAAGCTTTTGTCAGTTA,0,506889
araBp,0.125,7,7,CTAGAAGCATTTACGACGTG,0,511651
araBp,0.125,7,7,CTACCGCGTAGGAGGCGAGG,0,507852
araBp,0.125,7,7,CTACATGTGCTACTCGAGTG,0,472463
araBp,0.125,7,7,CTACATAAAGCCCTACATCT,0,519660
araBp,0.125,7,7,CTACACTCCAGATTTCGTGG,0,482647
araBp,0.125,7,7,CTACAAAGTCTATGGGATAT,0,472607
araBp,0.125,7,7,CTAAGTATGTAGACCCGGTC,0,480997
araBp,0.125,7,7,CGTTCTTGATGCCAGAAACA,0,521031
araBp,0.125,7,7,CGTTCCGTTCACATAATCTT,0,516596
araBp,0.125,7,7,CGTGTTCACTCCGGAGGACG,0,489795
araBp,0.125,7,7,CGTGTTATTCATCTTCGGAA,0,519133
araBp,0.125,7,7,CGTGATCGAGTATGTGGGCA,0,468129
araBp,0.125,7,7,CGTCGTTAGCACCACTGGTA,0,503929
araBp,0.125,7,7,CGTCGCTATCCCCGCGTGGG,0,481518
araBp,0.125,7,7,CGTCCGACGCGATCGCACGA,0,478216
araBp,0.125,7,7,CGTCCCGTGACGATCCACGA,0,500995
araBp,0.125,7,7,CGTCAGTTTAATAAATGCGT,0,502766
araBp,0.125,7,7,CGTCAAAGTAGATGCAAGTG,0,509871
araBp,0.125,7,7,CGTATGCCAGTGAGCGAGTG,0,500322
araBp,0.125,7,7,CGTAATCAGAGCGCGTGCCG,0,487604
araBp,0.125,7,7,CGGTGTTCGTATGCAAGCTA,0,487825
araBp,0.125,7,7,CGGTGTCTAACAGCGCAAGG,0,503073
araBp,0.125,7,7,CGGGTTATTTAGTAAGGTAA,0,471541
araBp,0.125,7,7,CGGGGTATCATGTACCCTTT,0,515556
araBp,0.125,7,7,CGGGGGTATCCCCAGCAGAA,0,476381
araBp,0.125,7,7,CGGGCCGGGTGGCCCGAAGC,0,473890
araBp,0.125,7,7,CGGGAGTGTAAGAGTAGTGT,0,485293
araBp,0.125,7,7,CGGCTGGGCATAGCGCAGTC,0,474317
araBp,0.125,7,7,CGGCTACCATATTTATCCGA,0,477406
araBp,0.125,7,7,CGGCCGCGCATCCTAGCCAT,0,514673
araBp,0.125,7,7,CGGCCCGTACGAGAGGTAGA,0,511268
araBp,0.125,7,7,CGGCAGCTTGACGAGACTAC,0,483760
araBp,0.125,7,7,CGGAGTCCAAGGCCGGTTAT,0,513426
araBp,0.125,7,7,CGGAGCTAGTCAACAAACAC,0,519373
araBp,0.125,7,7,CGCTCGACGGGCAACAAGAC,0,477920
araBp,0.125,7,7,CGCTATTACATTGGGGCTCA,0,475997
araBp,0.125,7,7,CGCGACTAACCGTCTGAGTA,0,493293
araBp,0.125,7,7,CGCCTTGACTGTTGTAGAAG,0,489004
araBp,0.125,7,7,CGCCCTCCATCTCTGCAGTC,0,492453
araBp,0.125,7,7,CGCAGTCTGAGCCCGGACCA,0,506649
araBp,0.125,7,7,CGCAGCTACATCTCGCGTTC,0,524124
araBp,0.125,7,7,CGCACTCGGCAAGGTTCCGC,0,496003
araBp,0.125,7,7,CGCAAATAGCTCCCGTTTAG,0,496706
araBp,0.125,7,7,CGATTTCCTCGGTTTCGCTC,0,487895
araBp,0.125,7,7,CGATTGCACCACGTAAAAAC,0,515791
araBp,0.125,7,7,CGATCTCCCTTTTGCTTCTG,0,470910
araBp,0.125,7,7,CGATCGGGAAGCAAAGCTTC,0,524150
araBp,0.125,7,7,CGATAAGGACTGATTATCTC,0,517427
araBp,0.125,7,7,CGAGTAGCGAAATTCATCTT,0,492720
araBp,0.125,7,7,CGAGGCCTGTCGCCCAGGAA,0,482467
araBp,0.125,7,7,CGACTAACAGCGTGCAAATA,0,481177
araBp,0.125,7,7,CGACGCAAGTACTATTGCTT,0,496467
araBp,0.125,7,7,CGACCGGCGGTAAGGCCTTC,0,483031
araBp,0.125,7,7,CGAATGTGCAGCTCGCCCGA,0,507155
araBp,0.125,7,7,CGAATGTCATACAGCGAGCC,0,516508
araBp,0.125,7,7,CGAAGTGATCGTAATCTTGC,0,513016
araBp,0.125,7,7,CCTTTTCTATGCAAGAATTA,0,470792
araBp,0.125,7,7,CCTTCTAATCCTAAACAATT,0,469901
araBp,0.125,7,7,CCTGTGTCCTCCGTCGTTAG,0,470512
araBp,0.125,7,7,CCTGGGACTAACCTTATGGT,0,520283
araBp,0.125,7,7,CCTGGCACACCAGGGAACTT,0,522735
araBp,0.125,7,7,CCTGGATGCAGCGGGCACTG,0,522039
araBp,0.125,7,7,CCTGCTTTGGTAGCGGTGAA,0,521603
araBp,0.125,7,7,CCTCTTTCACAGTTCGCCGT,0,484928
araBp,0.125,7,7,CCTCTACAAAGAAGTAAGCC,0,510761
araBp,0.125,7,7,CCTCGGTTCACACGTCCTAT,0,509898
araBp,0.125,7,7,CCTATACCATCCCAGGATGT,0,525158
araBp,0.125,7,7,CCTACGTTTGAAACCCCATC,0,490889
araBp,0.125,7,7,CCTAAGACCCTGGATCATGG,0,473148
araBp,0.125,7,7,CCGTTTGAAACGGTGTTAAG,0,489033
araBp,0.125,7,7,CCGTCCCTGATACGTGTTAA,0,477185
araBp,0.125,7,7,CCGTAGACAGTATAGACATA,0,472453
araBp,0.125,7,7,CCGTACTTTTGGCATGTATA,0,523687
araBp,0.125,7,7,CCGTACAAAGCGCAAGTGTG,0,523956
araBp,0.125,7,7,CCGGTATGTAGGGCAAGGGT,0,504485
araBp,0.125,7,7,CCGGCCACTACGGGACCCCC,0,503752
araBp,0.125,7,7,CCGGACAATATGTTCTGGAC,0,487686
araBp,0.125,7,7,CCGCTTTCTCAACAAATGCT,0,480020
araBp,0.125,7,7,CCGCATGACACATGGAGCAA,0,507029
araBp,0.125,7,7,CCGATTTTGCGAAGTCCTGT,0,515490
araBp,0.125,7,7,CCGATCTTTTGCCACATCAT,0,512539
araBp,0.125,7,7,CCGATCCTCGTGCTAGAATA,0,470514
araBp,0.125,7,7,CCGATCCGAGTTTGGAGTTG,0,501272
araBp,0.125,7,7,CCGATACGTGTCGCCCGTGA,0,506305
araBp,0.125,7,7,CCGACAGATTCTCGTATTAC,0,505679
araBp,0.125,7,7,CCCTTTCGGAGTTACGTCAC,0,505123
araBp,0.125,7,7,CCCTGGGTGGTTTTATTTAA,0,504517
araBp,0.125,7,7,CCCTAGGCGCTTTACAAACA,0,470090
araBp,0.125,7,7,CCCTAAAGGTATTCAGGCAT,0,472297
araBp,0.125,7,7,CCCGTTCTTCGTGCCAATGT,0,514855
araBp,0.125,7,7,CCCGGGAGGTCTACAAGTAT,0,478150
araBp,0.125,7,7,CCCCTGCATAGTAGCCTCAT,0,494247
araBp,0.125,7,7,CCCCGACTTGGAGTAGCGTA,0,513303
araBp,0.125,7,7,CCCAGTGTGAGTGTTATTCT,0,473192
araBp,0.125,7,7,CCCAGTACCTTTCGTTGTCC,0,482665
araBp,0.125,7,7,CCCAATTCTCTAGGAAGAAG,0,509792
araBp,0.125,7,7,CCCAACCGGGCTCATTAATG,0,504443
araBp,0.125,7,7,CCCAAAGCTCCAATCGCATC,0,481028
araBp,0.125,7,7,CCATGCCCTTTCTCTATTGG,0,486839
araBp,0.125,7,7,CCATCGTTAATTTAGTCATT,0,510006
araBp,0.125,7,7,CCATAAGGCTGTTAAAATTG,0,494132
araBp,0.125,7,7,CCAGGGCAGGTGATTGTATT,0,521772
araBp,0.125,7,7,CCAGGCTTACATACGTGAGG,0,491814
araBp,0.125,7,7,CCAGCCATGCGGGACTTTAC,0,491926
araBp,0.125,7,7,CCAGCATGCGCCGGGGGTGC,0,487469
araBp,0.125,7,7,CCACTTTGGAGTGGGAATTA,0,510051
araBp,0.125,7,7,CCACCGTTGAGGTCCCTCGC,0,485597
araBp,0.125,7,7,CCACCAAAGGCCAAGAGTCG,0,474877
araBp,0.125,7,7,CCACAAGACCTTCAATCAAC,0,473931
araBp,0.125,7,7,CCAAGTGAGTCACCTAGGCA,0,497308
araBp,0.125,7,7,CATTGGGTGAGTCCATTTTG,0,501716
araBp,0.125,7,7,CATGTTAGGATAAGTTCACG,0,500066
araBp,0.125,7,7,CATGGGCCACACGTACATCT,0,491961
araBp,0.125,7,7,CATGGGATGCATACCGTGTC,0,499430
araBp,0.125,7,7,CATGATGTGCCCATCGCACA,0,525301
araBp,0.125,7,7,CATCCTAGGCGAACAGGGCT,0,512137
araBp,0.125,7,7,CATCCGTCGGCGACACGCAT,0,490700
araBp,0.125,7,7,CATAGTAGTCCCGCCCCAAA,0,484112
araBp,0.125,7,7,CATAATGAGCGGGATAGGTT,0,489157
araBp,0.125,7,7,CATAAATATCGAAATACCGG,0,491624
araBp,0.125,7,7,CAGTTTAGTTTACCTCGCGG,0,516408
araBp,0.125,7,7,CAGTGGGGAAATGTCTACGG,0,497977
araBp,0.125,7,7,CAGGGTATGGTTAAAGGAGG,0,481483
araBp,0.125,7,7,CAGCTGGTGGATTTTCAGAG,0,503700
araBp,0.125,7,7,CAGCCCGTATAAGGGAGAAG,0,498668
araBp,0.125,7,7,CAGCCATTGTAAGGATATTT,0,496404
araBp,0.125,7,7,CAGCAGGGGGCTCTTGCAAT,0,475177
araBp,0.125,7,7,CAGATGTGGGACATGCTCAG,0,488071
araBp,0.125,7,7,CACTCTGGACCAAAAAGCTA,0,481243
araBp,0.125,7,7,CACTCGAAACGCGGCGTCAA,0,489467
araBp,0.125,7,7,CACGGTTGTCGCGCGATCAA,0,476835
araBp,0.125,7,7,CACGAGCTTGAACATCTGCT,0,513981
araBp,0.125,7,7,CACCCAAGACAAGAGTCAGG,0,483013
araBp,0.125,7,7,CACCATGAGTCCAGCTAGCT,0,469056
araBp,0.125,7,7,CACATCGGTGGCTTGGTCAC,0,503655
araBp,0.125,7,7,CACAACGCATGAGTCAACTA,0,482337
araBp,0.125,7,7,CAATGGCGGGGTCGTTGGCT,0,476834
araBp,0.125,7,7,CAATGCGCTATTGCCAAGTG,0,519342
araBp,0.125,7,7,CAATGAAGCTCCGCGTGTAA,0,493434
araBp,0.125,7,7,CAATACTTTCAATAACATGA,0,516235
araBp,0.125,7,7,CAATACATCGGGTCTAGGTT,0,472599
araBp,0.125,7,7,CAATAATGGTAGCGGTGAGT,0,483612
araBp,0.125,7,7,CAAGATCAGTTTAATGTCAT,0,519968
araBp,0.125,7,7,CAACGCGTAGGATTGTAGTA,0,500570
araBp,0.125,7,7,CAAATGATGGGCCTGTCAAT,0,496854
araBp,0.125,7,7,CAAATATCATAACTGGAATG,0,498115
araBp,0.125,7,7,CAAAGAGTGGTTCGCAAACA,0,476747
araBp,0.125,7,7,CAAACCTCATACGACAGTTA,0,506082
araBp,0.125,7,7,CAAAAGGTTCATGGCAAGTA,0,470065
araBp,0.125,7,7,CAAAAGGGATTTCACTTGAG,0,487270
araBp,0.125,7,7,ATTTCCCTGGACCTTTATTA,0,489309
araBp,0.125,7,7,ATTGTGTTTTGAGAAGTTGT,0,516905
araBp,0.125,7,7,ATTGGTTTGTCCATCGTTGA,0,523199
araBp,0.125,7,7,ATTGGTTACACGAATCGCTG,0,478284
araBp,0.125,7,7,ATTGGCCAACAAGTGAATAA,0,516623
araBp,0.125,7,7,ATTGAATCCGAGCGCTCATA,0,501638
araBp,0.125,7,7,ATTCCGTTCCCGCCGTCTCA,0,512202
araBp,0.125,7,7,ATTCCGCCTATCCATTCACG,0,505716
araBp,0.125,7,7,ATTCCCAGATTATGTGAGAG,0,474116
araBp,0.125,7,7,ATTCAGTATTAGATTACGGG,0,484969
araBp,0.125,7,7,ATTATCTGTCACCGCGCCAT,0,496401
araBp,0.125,7,7,ATTAGTGGTGGTACTGTCCT,0,476110
araBp,0.125,7,7,ATTAGAAGCACTCTCTAACG,0,507305
araBp,0.125,7,7,ATGTTACGCGACATGCTCAG,0,489562
araBp,0.125,7,7,ATGTCGGGTTGTGCCATTTA,0,488326
araBp,0.125,7,7,ATGTCGCATGCAAACGGGTA,0,513504
araBp,0.125,7,7,ATGGGTATTGCAGATGTGCT,0,489285
araBp,0.125,7,7,ATGCGTCACGCTACTATTTA,0,468027
araBp,0.125,7,7,ATGCGATCGGGTTCGTATAC,0,484118
araBp,0.125,7,7,ATGCGATCACTGATGTAGAA,0,481435
araBp,0.125,7,7,ATGCCTGAGTCCGCTGTGGC,0,518778
araBp,0.125,7,7,ATGCCTATGAGAATAACGGC,0,477907
araBp,0.125,7,7,ATGAGGCGAGGGCCGGTGTT,0,470604
araBp,0.125,7,7,ATGAGCAGGTAAGGTGGAGG,0,484869
araBp,0.125,7,7,ATGACTAGAGCACTCACGAA,0,517362
araBp,0.125,7,7,ATGACACCTGACGTGCTATG,0,493397
araBp,0.125,7,7,ATCTTCCATAGAGATTCCAG,0,491786
araBp,0.125,7,7,ATCTCGCCCCCCTTCTTGTC,0,513538
araBp,0.125,7,7,ATCTCCATCTCCCCGGACAG,0,498776
araBp,0.125,7,7,ATCGTTTCGCGATGCCACCA,0,510729
araBp,0.125,7,7,ATCGGATGTCAATGTGTGGA,0,485558
araBp,0.125,7,7,ATCGCGTACCTTCCAATGCA,0,524457
araBp,0.125,7,7,ATCCGTGTTGCTTACTCGGT,0,512687
araBp,0.125,7,7,ATCCCGTGATCGAAAGGCAT,0,476617
araBp,0.125,7,7,ATCAGCCGGCAACCGTGAAC,0,519679
araBp,0.125,7,7,ATCAATCTTTGTAGGAGGAA,0,500439
araBp,0.125,7,7,ATATTCATTCGAGCTGATAC,0,487977
araBp,0.125,7,7,ATAGTAACCGGAGGCCGGCA,0,485071
araBp,0.125,7,7,ATAGGGTTCGCTCGTATTCT,0,479302
araBp,0.125,7,7,ATAGCTGCGGCTTTCAAATG,0,479600
araBp,0.125,7,7,ATAGATTTGGTTGCGCAGGA,0,499081
araBp,0.125,7,7,ATAGAGCCCTTCGGGCGCAT,0,487662
araBp,0.125,7,7,ATACTGCAAAAGAAGATATC,0,506777
araBp,0.125,7,7,ATACTAGGGGATAAGCTTGC,0,476826
araBp,0.125,7,7,ATACGTGAATTGATATTCCA,0,476023
araBp,0.125,7,7,ATACCCTTCTCATAGCTACA,0,498693
araBp,0.125,7,7,ATACCCTCCACGCGTATTGG,0,508613
araBp,0.125,7,7,ATAATTCGGGTAAACAGGAG,0,476672
araBp,0.125,7,7,ATAATGGAGTGCTCGGGATC,0,516801
araBp,0.125,7,7,ATAATAGTCAATCTGTAATG,0,473278
araBp,0.125,7,7,ATAAGGCAGAAAGAGATTTA,0,501954
araBp,0.125,7,7,ATAACACAATTGGCTGCATG,0,486104
araBp,0.125,7,7,ATAAAGCTAGATTCGGTCCT,0,472460
araBp,0.125,7,7,AGTTTCGTAATCGGTTACCA,0,524970
araBp,0.125,7,7,AGTTATAAAGATTCCCACGA,0,477673
araBp,0.125,7,7,AGTGCAGGTTGCGGTGGCGC,0,489521
araBp,0.125,7,7,AGTGAGTTTAACCCATGAGT,0,518161
araBp,0.125,7,7,AGTCTAGTCCTCCCATGCGA,0,474127
araBp,0.125,7,7,AGTCGCAAGAACGCTTAATT,0,500250
araBp,0.125,7,7,AGTCCGGGAGCAGCCGCAGT,0,479989
araBp,0.125,7,7,AGTACCTCGGCTCGTAGATG,0,469691
araBp,0.125,7,7,AGGTTCTGCCCGCCACATGT,0,521030
araBp,0.125,7,7,AGGTTCGCGTCACGCTAGAA,0,520060
araBp,0.125,7,7,AGGTCTTGCATCCAGCCCCC,0,484961
araBp,0.125,7,7,AGGTCGATCGACTGTTGGAA,0,518039
araBp,0.125,7,7,AGGTCCACAGGTCAGTACGG,0,514132
araBp,0.125,7,7,AGGTAATTTCGATTAATATG,0,477390
araBp,0.125,7,7,AGGGTTAAGACCGAGCTTCA,0,492229
araBp,0.125,7,7,AGGGTGCGTCAAGGCCATAA,0,503923
araBp,0.125,7,7,AGGGTATTTTCATCCCGCGC,0,475034
araBp,0.125,7,7,AGGGGTCGCTTAATGCCATA,0,510310
araBp,0.125,7,7,AGGGGCGTATGCGGTGGGAG,0,516466
araBp,0.125,7,7,AGGCAGCACCTTCGCTCCGC,0,484704
araBp,0.125,7,7,AGGATATGGTTGGGGTAGTG,0,512474
araBp,0.125,7,7,AGGAGGCTATGGGTTTGAAA,0,472055
araBp,0.125,7,7,AGGAGCTGCGTTTGCCTTTC,0,487804
araBp,0.125,7,7,AGCTTTGGTCACGCCTGCGG,0,498979
araBp,0.125,7,7,AGCTTTGAGCGCCTACCGCT,0,487982
araBp,0.125,7,7,AGCTGTATTCGAATGGCTAT,0,478286
araBp,0.125,7,7,AGCTGAGTCTGCGGCTGCGT,0,504940
araBp,0.125,7,7,AGCGTAACCTCTCGCGAATG,0,521918
araBp,0.125,7,7,AGCGCGGGTACGGGAGGGTG,0,496336
araBp,0.125,7,7,AGCGCACATGAGTTCATAGC,0,485411
araBp,0.125,7,7,AGCCGTGGGCACGAACACTG,0,476625
araBp,0.125,7,7,AGCCGAGAGAAACCAGCTCC,0,487028
araBp,0.125,7,7,AGCCATATACGCCATGCGGA,0,510015
araBp,0.125,7,7,AGCCACGCCACCGTTCAGGT,0,485984
araBp,0.125,7,7,AGCACTAGACCTGCCGGGTC,0,511143
araBp,0.125,7,7,AGCAATAACGATATGAACCA,0,498351
araBp,0.125,7,7,AGATTGTTTAATCACATGCA,0,522143
araBp,0.125,7,7,AGAGCTGGGAGTGTTCGAGT,0,471317
araBp,0.125,7,7,AGAGCCTTCGTCGATCGGTT,0,470616
araBp,0.125,7,7,AGAGATCAGGTGTAAATGCT,0,485060
araBp,0.125,7,7,AGACCTCCCTGTGAGCGCCT,0,501885
araBp,0.125,7,7,AGAAGCACAGTCACTGGTTA,0,498695
araBp,0.125,7,7,ACTTGTTAGCGATGGTTAGG,0,503500
araBp,0.125,7,7,ACTTCGCGATGAGCCGCGTT,0,494351
araBp,0.125,7,7,ACTTATGTAGGGTACGTACG,0,479560
araBp,0.125,7,7,ACTGTAGTAGGACAAGGTCT,0,480414
araBp,0.125,7,7,ACTGTACGATTATTAGCTGA,0,473095
araBp,0.125,7,7,ACTGAGTATTTTGTTCGAGT,0,488468
araBp,0.125,7,7,ACTCTATGCAAGAATAAGCT,0,510642
araBp,0.125,7,7,ACTCGCCCGGACCGTGTTCT,0,511434
araBp,0.125,7,7,ACTCGAGGCAATAAAATTTT,0,502901
araBp,0.125,7,7,ACTAGGAATACGGCAGTTGA,0,474015
araBp,0.125,7,7,ACTACTTCTCCTTACGCCTT,0,488894
araBp,0.125,7,7,ACTACACAAGACGGATCACA,0,498304
araBp,0.125,7,7,ACTAAGGACTTTCCAGTACC,0,519494
araBp,0.125,7,7,ACGTTAGAGGTGGCCCTCTT,0,512628
araBp,0.125,7,7,ACGTTACCTGCCGTGCCTAT,0,501490
araBp,0.125,7,7,ACGTGCTCTTGTGCATGCCC,0,510853
araBp,0.125,7,7,ACGTGCCATTATTACGTCTG,0,499510
araBp,0.125,7,7,ACGTAGAGCTAAGCTATCAG,0,520374
araBp,0.125,7,7,ACGTACATCCTGACATAGTG,0,482691
araBp,0.125,7,7,ACGGGCAACTGCTTCGGAAC,0,471192
araBp,0.125,7,7,ACGATTTACTGTAGAGGAAT,0,490569
araBp,0.125,7,7,ACGACTACATGACCTCATTA,0,480225
araBp,0.125,7,7,ACGAACTTTTACTTTAATTT,0,471108
araBp,0.125,7,7,ACGAAACCGGTATTCCGCAA,0,479415
araBp,0.125,7,7,ACCTGGAACCCGCGGGAGGC,0,482107
araBp,0.125,7,7,ACCTGCATAGAAAGGGAATA,0,523251
araBp,0.125,7,7,ACCTAGAAACAGTGACGTAT,0,522220
araBp,0.125,7,7,ACCTAATTCTCGCTAGGCGA,0,480726
araBp,0.125,7,7,ACCGTTCTATCCTATTGCAC,0,506473
araBp,0.125,7,7,ACCGGTACGCTGCATCCGAC,0,522262
araBp,0.125,7,7,ACCGAACCTGGCTGCATCGT,0,486888
araBp,0.125,7,7,ACCCGTTTGTTACGGAACAG,0,484635
araBp,0.125,7,7,ACCCGTGGATAGTTCGGCTA,0,476039
araBp,0.125,7,7,ACCCCACTTGACGTACCGTC,0,518343
araBp,0.125,7,7,ACCAGTTATTGTCAATTGAT,0,497412
araBp,0.125,7,7,ACATTTTTATAAGAAGCTTG,0,510127
araBp,0.125,7,7,ACATAGCAACGGCGGGACGC,0,483267
araBp,0.125,7,7,ACATACAAAATCTCACCTTA,0,500823
araBp,0.125,7,7,ACAGAGCCGACACATGTAGT,0,513583
araBp,0.125,7,7,ACAGAACCTATAGGAGACAT,0,491806
araBp,0.125,7,7,ACACCTGTGACTAATCCAGC,0,506214
araBp,0.125,7,7,ACACAGTGCGTTTCCGCCCA,0,506508
araBp,0.125,7,7,ACACAGCCTTGAAAGGTCCG,0,509913
araBp,0.125,7,7,ACAATTAGTAATCATCGCGC,0,511944
araBp,0.125,7,7,ACAAGAACTCTAGACTGAAA,0,476425
araBp,0.125,7,7,ACAACAGACAGGGTTACAGA,0,474583
araBp,0.125,7,7,ACAAATCTTCTCGCGGATGG,0,479231
araBp,0.125,7,7,AATGGAGCCATTTCGTGCAG,0,523432
araBp,0.125,7,7,AATGCGCCGTATGATGGTGT,0,491645
araBp,0.125,7,7,AATGCAAGTCTGTCGCATAG,0,522969
araBp,0.125,7,7,AATGAGTTCCCCGACCGGAG,0,498945
araBp,0.125,7,7,AATCTGGATGGGCGACCCTC,0,479094
araBp,0.125,7,7,AATCTCGTAAACTAATTTAA,0,507170
araBp,0.125,7,7,AATCATCTCCTGCTTACTGA,0,524085
araBp,0.125,7,7,AATATAATGTTACCCGCTAA,0,471736
araBp,0.125,7,7,AATAGTTCACCTGGGTCCTC,0,488442
araBp,0.125,7,7,AATAGTGTGTGAAATAAGCA,0,496615
araBp,0.125,7,7,AATAATGTGAAATGTATCTA,0,501819
araBp,0.125,7,7,AAGTTCCGAGCGTGGTGCAA,0,513784
araBp,0.125,7,7,AAGTGCGGCGACCTTAAATG,0,509054
araBp,0.125,7,7,AAGTAGAGGGGGTTAGCGGG,0,524039
araBp,0.125,7,7,AAGGTTAATTGAAAGTCGAA,0,482814
araBp,0.125,7,7,AAGGTTAACAGATGTATAGT,0,516167
araBp,0.125,7,7,AAGGTGGTGAAGAGATGCCC,0,500878
araBp,0.125,7,7,AAGGTGCGGGGATTAGTTAA,0,477832
araBp,0.125,7,7,AAGGCCAAGGCAGAGACCGG,0,506533
araBp,0.125,7,7,AAGCTTGGTGTGGAGGGCTT,0,488002
araBp,0.125,7,7,AAGCTCGTTTCTGCGAAAGG,0,497586
araBp,0.125,7,7,AAGCTAACAATCTGACTGAC,0,507043
araBp,0.125,7,7,AAGAGGCGGTTAGCGGGGAA,0,472533
araBp,0.125,7,7,AAGACGGGCGCACCAACTAG,0,524722
araBp,0.125,7,7,AAGACCCGACACCGAAGATT,0,473800
araBp,0.125,7,7,AACTTCCTGGGCGCCGGCTA,0,479922
araBp,0.125,7,7,AACTTAAGGTATTACTCTAG,0,477420
araBp,0.125,7,7,AACTAGGTACAGTGACCAGA,0,490973
araBp,0.125,7,7,AACGGGTGAATTCCAGCCTT,0,508256
araBp,0.125,7,7,AACGCGAACATGTACTGTAT,0,509223
araBp,0.125,7,7,AACGAGTAGGGAGTGAGCAA,0,502157
araBp,0.125,7,7,AACCTCGAGTACAACAGATT,0,521859
araBp,0.125,7,7,AACCCAGACGTTACGCCAGT,0,474263
araBp,0.125,7,7,AACCAGAATTTTCCCCCCGC,0,492228
araBp,0.125,7,7,AAATGGTAAATTGTCAGGGA,0,477989
araBp,0.125,7,7,AAATCGATATCGGGGACTTC,0,475087
araBp,0.125,7,7,AAATCCCTTAGACTCCAATA,0,517555
araBp,0.125,7,7,AAATACCCATGCTTCGACTG,0,481360
araBp,0.125,7,7,AAAGTGGTTAGATAATCTGT,0,518125
araBp,0.125,7,7,AAAGGTGCACTCGCGGTTTT,0,505743
araBp,0.125,7,7,AAAGAGTTGATCGTAGTAAC,0,470221
araBp,0.125,7,7,AAACTCGGAGCTAAGGGGTA,0,513840
araBp,0.125,7,7,AAACTACGTGAGGTACTCCT,0,515773
araBp,0.125,7,7,AAACGCCCTTTCTGATAACT,0,519921
araBp,0.125,7,7,AAAATGAATTTGGAGCAGAC,0,495700
araBp,0.125,7,7,AAAAGAGGACGTGGAACCGA,0,515729
araBp,0.125,7,7,AAAACAGAATTTTTGGATAC,0,482878
araBp,0.125,7,7,AAAAACCGATCAGGGGGTGA,0,525249
araBp,0.14285714285714285,6,6,TTTTTTTTTCAACCCGCATA,0,519156
araBp,0.14285714285714285,6,6,TTTTTGATGTTGCATGCAGC,0,514654
araBp,0.14285714285714285,6,6,TTTTCGTTGCGTCGTCATCA,0,469254
araBp,0.14285714285714285,6,6,TTTTCGCCACACGTGCTTCG,0,500990
araBp,0.14285714285714285,6,6,TTTTATCCAAAATTTGAACT,0,497409
araBp,0.14285714285714285,6,6,TTTTACCAAGACGCACTGAA,0,491443
araBp,0.14285714285714285,6,6,TTTGGATGATACGAGCACTG,0,515062
araBp,0.14285714285714285,6,6,TTTGCAATCCGTGCCTAAGC,0,484149
araBp,0.14285714285714285,6,6,TTTCTTGCCTCCGTGTGAGA,0,510080
araBp,0.14285714285714285,6,6,TTTATACTGGGTGCAAACTT,0,499954
araBp,0.14285714285714285,6,6,TTTAGGGGCATTGTTGAGAC,0,488067
araBp,0.14285714285714285,6,6,TTTACGGGCTTACCTTGTTA,0,523424
araBp,0.14285714285714285,6,6,TTTAAGCGATGTGTTTACTC,0,498082
araBp,0.14285714285714285,6,6,TTGTCTACCTATCTACAGAG,0,476634
araBp,0.14285714285714285,6,6,TTGTCATCCGCGGAGAGCAT,0,487183
araBp,0.14285714285714285,6,6,TTGTACGCCCAAAATTTGAT,0,519151
araBp,0.14285714285714285,6,6,TTGGTAGTTTTCATGCACGT,0,489190
araBp,0.14285714285714285,6,6,TTGGCTAGCTTGTAGTGTCC,0,487192
araBp,0.14285714285714285,6,6,TTGGCGTTGAAGATAAGGCC,0,488701
araBp,0.14285714285714285,6,6,TTGGAATTCAATGGGCGAAC,0,480834
araBp,0.14285714285714285,6,6,TTGCCATCGGTTAAACTATA,0,512292
araBp,0.14285714285714285,6,6,TTGATTCTGCGTAAGCATGG,0,487983
araBp,0.14285714285714285,6,6,TTGATTCGCCTGCGAGGGCG,0,513237
araBp,0.14285714285714285,6,6,TTGAGCTTACCTCATTAATA,0,478110
araBp,0.14285714285714285,6,6,TTGAGCGAAGGTTAAGGCCA,0,483769
araBp,0.14285714285714285,6,6,TTGACTTAGTCTGGATTTAC,0,485903
araBp,0.14285714285714285,6,6,TTGACTGTGAGTGAATGCGC,0,479179
araBp,0.14285714285714285,6,6,TTGACCAGATTTGGACTGGG,0,497075
araBp,0.14285714285714285,6,6,TTGAATAACTTCTGTGGATG,0,480731
araBp,0.14285714285714285,6,6,TTCTTTAAGCGCGGTAATCA,0,502072
araBp,0.14285714285714285,6,6,TTCTCGTCTCGGGTGCATAG,0,523336
araBp,0.14285714285714285,6,6,TTCTAATGCCCGCACGGGAA,0,503406
araBp,0.14285714285714285,6,6,TTCGTTGGTTAGAGTAGTTT,0,496741
araBp,0.14285714285714285,6,6,TTCGTTACTATCTGCTTATC,0,516891
araBp,0.14285714285714285,6,6,TTCGGATCGCCCCCTGATAA,0,487650
araBp,0.14285714285714285,6,6,TTCGCCAATGGTAGATCCGA,0,475869
araBp,0.14285714285714285,6,6,TTCGATGGTATTCAAAGGAG,0,514892
araBp,0.14285714285714285,6,6,TTCCTCTTGCCAGGACGGGG,0,498524
araBp,0.14285714285714285,6,6,TTCCGTCAAAGGGCTTAAAG,0,491690
araBp,0.14285714285714285,6,6,TTCCCCGAGGCAGGGATCAT,0,471154
araBp,0.14285714285714285,6,6,TTCAGTCCCGGGTCGTATAT,0,514918
araBp,0.14285714285714285,6,6,TTCACGTAGCGATTAGCCGG,0,525060
araBp,0.14285714285714285,6,6,TTATATCGCATGGAGGTGGG,0,524106
araBp,0.14285714285714285,6,6,TTAGGCATGGTACAAATATA,0,506710
araBp,0.14285714285714285,6,6,TTAGAATCCAGGGAGCGGAG,0,470031
araBp,0.14285714285714285,6,6,TTACCCACCTCGATGTCAAG,0,476900
araBp,0.14285714285714285,6,6,TTACATGGAGGCGGACTCCA,0,468776
araBp,0.14285714285714285,6,6,TTACATCTTGGTATCCTTCG,0,508659
araBp,0.14285714285714285,6,6,TTAATCATAGAACAGGGCTC,0,511658
araBp,0.14285714285714285,6,6,TTAAGTGACTTTATAGGTAG,0,480650
araBp,0.14285714285714285,6,6,TTAAAAAGGTACTAAACAGA,0,508062
araBp,0.14285714285714285,6,6,TGTTCCTCTGAATTTTATAG,0,481271
araBp,0.14285714285714285,6,6,TGTTATCTCCCGCCGGAAAT,0,514441
araBp,0.14285714285714285,6,6,TGTTAGCGGCCCACGAGGGA,0,492171
araBp,0.14285714285714285,6,6,TGTTAAGATGCCGATGGGAT,0,512551
araBp,0.14285714285714285,6,6,TGTGTCTTGTTTCAGGCTAA,0,485338
araBp,0.14285714285714285,6,6,TGTGGTCGCCGTTACCACTC,0,480771
araBp,0.14285714285714285,6,6,TGTGGGACTTCAAGGCAGAC,0,485227
araBp,0.14285714285714285,6,6,TGTGCGTGCATTAGAACCGG,0,510029
araBp,0.14285714285714285,6,6,TGTGATAGCATTAATCATGG,0,524650
araBp,0.14285714285714285,6,6,TGTGAGCGGCTCAACTATAC,0,516140
araBp,0.14285714285714285,6,6,TGTCTCAATAGATGCTTCCG,0,519286
araBp,0.14285714285714285,6,6,TGTATTAATCGTTTGGGAAC,0,500342
araBp,0.14285714285714285,6,6,TGTATAATTGCAGGGCCGCA,0,480562
araBp,0.14285714285714285,6,6,TGTACCATGGATGTTCTTAT,0,480156
araBp,0.14285714285714285,6,6,TGGTTGTTAATGCTGGCATA,0,506577
araBp,0.14285714285714285,6,6,TGGTTCAGAGGATTCTGGCT,0,525463
araBp,0.14285714285714285,6,6,TGGTGGCACGGATATATTAA,0,502415
araBp,0.14285714285714285,6,6,TGGTCTCACATGTATACAAA,0,509102
araBp,0.14285714285714285,6,6,TGGTCGAGTTATTCACAAAA,0,469659
araBp,0.14285714285714285,6,6,TGGGTGTGGCGATCAGCGTT,0,483426
araBp,0.14285714285714285,6,6,TGGGGCGGTTTCAGCTATTG,0,507815
araBp,0.14285714285714285,6,6,TGGGGCACCGGATTTGCCCC,0,501982
araBp,0.14285714285714285,6,6,TGGGCAAAGGGCAGTGTCGT,0,471918
araBp,0.14285714285714285,6,6,TGGGAGAAAGCTTCTTCCTA,0,489326
araBp,0.14285714285714285,6,6,TGGGACGCCTTGTCCACTAC,0,472261
araBp,0.14285714285714285,6,6,TGGCACCAGGTCTCGTGCGC,0,507060
araBp,0.14285714285714285,6,6,TGCTTACCGAGCACTTATGG,0,508282
araBp,0.14285714285714285,6,6,TGCTACCGTGCTATGGAGAT,0,482208
araBp,0.14285714285714285,6,6,TGCTACAGGCCAAGTACGTC,0,489492
araBp,0.14285714285714285,6,6,TGCGGCATATAACCAGAGTC,0,518979
araBp,0.14285714285714285,6,6,TGCGACCTGACAAGATGTGT,0,523500
araBp,0.14285714285714285,6,6,TGCGAACGGTAGAAGGGCGA,0,506245
araBp,0.14285714285714285,6,6,TGCCTGACTGAATGTTCATG,0,507219
araBp,0.14285714285714285,6,6,TGCCTCTCTCTGCGTCCGTT,0,519394
araBp,0.14285714285714285,6,6,TGCCGTACAGGCTTAAGGCT,0,502197
araBp,0.14285714285714285,6,6,TGCCGCTCCGAACCCGCTCG,0,494972
araBp,0.14285714285714285,6,6,TGCCCACTTTATGTGCAACA,0,487420
araBp,0.14285714285714285,6,6,TGCCATCTGTGTCCGTTGAT,0,496978
araBp,0.14285714285714285,6,6,TGCCAGTATAACACCGACTT,0,481295
araBp,0.14285714285714285,6,6,TGCCAATCCGGGCTGCAAAT,0,507715
araBp,0.14285714285714285,6,6,TGCACCCTCGTCCCACGGTT,0,490775
araBp,0.14285714285714285,6,6,TGATGTATGAAGACCCTTTC,0,472959
araBp,0.14285714285714285,6,6,TGATGCGCATGTTAACATTA,0,479612
araBp,0.14285714285714285,6,6,TGATCTGGTATTCGCCGAAG,0,504992
araBp,0.14285714285714285,6,6,TGATAGGTCGCTGATGACTG,0,511516
araBp,0.14285714285714285,6,6,TGAGTAGACGGCTCCCCCGC,0,509767
araBp,0.14285714285714285,6,6,TGAGCGCCGCAGGGGGATTT,0,499468
araBp,0.14285714285714285,6,6,TGAGCATTCGTCAGGCAGAA,0,479260
araBp,0.14285714285714285,6,6,TGAGACTTTAACGTGTTCAA,0,509970
araBp,0.14285714285714285,6,6,TGACTTATCCATCCATCGAG,0,510314
araBp,0.14285714285714285,6,6,TGACTAGCAGCGTTGTTCTT,0,499982
araBp,0.14285714285714285,6,6,TGACCGTACGGTTACCATCG,0,488365
araBp,0.14285714285714285,6,6,TGACCCCTCCATCTTCCTTC,0,518703
araBp,0.14285714285714285,6,6,TGACATGACAGGACAAGTAA,0,509249
araBp,0.14285714285714285,6,6,TGACAAAAGTAGATCGCAAT,0,519509
araBp,0.14285714285714285,6,6,TGAAATAGGCTTCTTGGGGG,0,469347
araBp,0.14285714285714285,6,6,TGAAAGTTCAACTGCCAACA,0,495939
araBp,0.14285714285714285,6,6,TGAAAGGGATCGAATGTGCT,0,506965
araBp,0.14285714285714285,6,6,TCTTTCTATGGTCCGCTAGT,0,469120
araBp,0.14285714285714285,6,6,TCTTTCCGGTATTCGACTAT,0,471352
araBp,0.14285714285714285,6,6,TCTTTAGAGTTTTACTACAC,0,513793
araBp,0.14285714285714285,6,6,TCTTGGGGTGTGCTTAATAG,0,492900
araBp,0.14285714285714285,6,6,TCTTGCGGGGCAATGAAATT,0,490282
araBp,0.14285714285714285,6,6,TCTGCTCGGACCCCATTGAT,0,521153
araBp,0.14285714285714285,6,6,TCTGCTCCTATCGCAATGAG,0,499681
araBp,0.14285714285714285,6,6,TCTGACATGATCTTCTTAAC,0,489599
araBp,0.14285714285714285,6,6,TCTCGTAGGCCGGGCTGAAG,0,517018
araBp,0.14285714285714285,6,6,TCTCGCTCGCCACATGTGTC,0,509579
araBp,0.14285714285714285,6,6,TCTCAGCAAGTCAAAGGGAA,0,510181
araBp,0.14285714285714285,6,6,TCTCACAGCCTAACGAGTTG,0,469256
araBp,0.14285714285714285,6,6,TCTAGTGTTAGAATCTGCAG,0,521292
araBp,0.14285714285714285,6,6,TCTAGGTATTGGTTACACCT,0,520961
araBp,0.14285714285714285,6,6,TCTAATCAACCGGAAACGTC,0,501485
araBp,0.14285714285714285,6,6,TCGTTTGGCCCACACAGTCG,0,509559
araBp,0.14285714285714285,6,6,TCGTTGAGGGACGACCCAAT,0,476261
araBp,0.14285714285714285,6,6,TCGTCGATACTCTGCATAAT,0,523725
araBp,0.14285714285714285,6,6,TCGTATTGCGGATATCGATG,0,489565
araBp,0.14285714285714285,6,6,TCGGCAGCAGGGATGTACGC,0,483802
araBp,0.14285714285714285,6,6,TCGGATGTGGGATGGATGAT,0,472249
araBp,0.14285714285714285,6,6,TCGGATCGAATTACACGGTG,0,471581
araBp,0.14285714285714285,6,6,TCGGAATCGAACGTACTTAT,0,483452
araBp,0.14285714285714285,6,6,TCGCCAGCGTATAGTTAGTG,0,478071
araBp,0.14285714285714285,6,6,TCGATAAGGGAGTCTCCCTT,0,492026
araBp,0.14285714285714285,6,6,TCGACGTCTTAGGGGGGTAG,0,497714
araBp,0.14285714285714285,6,6,TCGAAGCGCTTAGTGGGTTG,0,515456
araBp,0.14285714285714285,6,6,TCGAACGTTCTCCACAAAGT,0,478878
araBp,0.14285714285714285,6,6,TCCTTGACTATTTAAGGTTC,0,517415
araBp,0.14285714285714285,6,6,TCCTTCAACGCGTATTCACT,0,480689
araBp,0.14285714285714285,6,6,TCCTGTCACGTGAGAACCGC,0,511078
araBp,0.14285714285714285,6,6,TCCTGGGCAATAGCTTGATC,0,477995
araBp,0.14285714285714285,6,6,TCCTGCTGGAAAATGAACCG,0,514259
araBp,0.14285714285714285,6,6,TCCGGGTCGGCATAACTCGA,0,506087
araBp,0.14285714285714285,6,6,TCCGCGGGCTTAAACGGCCG,0,487908
araBp,0.14285714285714285,6,6,TCCACTGCGACATCACGTAA,0,500657
araBp,0.14285714285714285,6,6,TCATTCAGACCGACCAAACT,0,505739
araBp,0.14285714285714285,6,6,TCAGTACGTGAGAACAAACT,0,485362
araBp,0.14285714285714285,6,6,TCAGGTACCCACCCCGTAAG,0,491677
araBp,0.14285714285714285,6,6,TCAGGCTAGGGCAATTGTTT,0,470739
araBp,0.14285714285714285,6,6,TCACGGTCGCGCGTTAAAAC,0,508552
araBp,0.14285714285714285,6,6,TCACGAAACGATGCGTTTTC,0,480814
araBp,0.14285714285714285,6,6,TCAATCACCTTCCAAAGGGA,0,496096
araBp,0.14285714285714285,6,6,TCAAAAAATGTAAACAGATA,0,514524
araBp,0.14285714285714285,6,6,TATTGTAGTTACCTTTACAG,0,514321
araBp,0.14285714285714285,6,6,TATTGGTCAAGACATTCGGA,0,509304
araBp,0.14285714285714285,6,6,TATTGCTTATTGGTACACGG,0,477628
araBp,0.14285714285714285,6,6,TATTCGCATGGAACCTACTG,0,486756
araBp,0.14285714285714285,6,6,TATGGCCGGTAGAGATACCT,0,494778
araBp,0.14285714285714285,6,6,TATGAGTGGAATATTCGGCC,0,515888
araBp,0.14285714285714285,6,6,TATGACCGGCGTAGCGGGAC,0,470439
araBp,0.14285714285714285,6,6,TATCTGTTCCATAGCGCGGA,0,489505
araBp,0.14285714285714285,6,6,TATCTCGGTATTTGCTAGAC,0,495371
araBp,0.14285714285714285,6,6,TATCAGGGGTAGGACCTTAT,0,513305
araBp,0.14285714285714285,6,6,TATACACTTTAAGAATGTAT,0,491703
araBp,0.14285714285714285,6,6,TATAAGTCTAAGACACTCTG,0,488660
araBp,0.14285714285714285,6,6,TAGGTGCCGAATCGCCTGGT,0,513819
araBp,0.14285714285714285,6,6,TAGGTCAGCGAGGGTTTCAG,0,507825
araBp,0.14285714285714285,6,6,TAGGGTCGTCCGAAAGAAGG,0,512957
araBp,0.14285714285714285,6,6,TAGGCTTTGGTTGAGAGCAA,0,480357
araBp,0.14285714285714285,6,6,TAGGAAGCACTGCTGCATCG,0,487499
araBp,0.14285714285714285,6,6,TAGCTGATTACAGCACACTG,0,496726
araBp,0.14285714285714285,6,6,TAGCTCTAATATTGAACAGG,0,480871
araBp,0.14285714285714285,6,6,TAGCATCGAAGAGCCTATCC,0,490594
araBp,0.14285714285714285,6,6,TAGCAAGAGACACTTGTCCC,0,517325
araBp,0.14285714285714285,6,6,TAGATTTTGGATCGTACCGT,0,494641
araBp,0.14285714285714285,6,6,TAGAGGGGGTACCTCCAGGA,0,519314
araBp,0.14285714285714285,6,6,TACTGTGATAATCATCAAAA,0,490312
araBp,0.14285714285714285,6,6,TACTCGGCCTGATTCAAGGG,0,492582
araBp,0.14285714285714285,6,6,TACTATATTCGGAGAGTTAT,0,503623
araBp,0.14285714285714285,6,6,TACGTCCCGCCCGATCTAGC,0,477719
araBp,0.14285714285714285,6,6,TACGCTATGGGTGCGATAGG,0,476847
araBp,0.14285714285714285,6,6,TACGAGCCTGACTGAGGCCT,0,502320
araBp,0.14285714285714285,6,6,TACGAACCACGCGTTCGCCG,0,507428
araBp,0.14285714285714285,6,6,TACCGGTCGCGTATACGGCC,0,475610
araBp,0.14285714285714285,6,6,TACCGAGCTCCCGAGATGAT,0,507478
araBp,0.14285714285714285,6,6,TACCCACCAGAAATTGTTTA,0,487381
araBp,0.14285714285714285,6,6,TACCAGTTACTCCCCAGTGG,0,494091
araBp,0.14285714285714285,6,6,TACATTCTCGTCTTCAGGTC,0,483929
araBp,0.14285714285714285,6,6,TACAGTCCTTGGCCCAACTC,0,525169
araBp,0.14285714285714285,6,6,TACACTATGATTTGAGTTAT,0,523940
araBp,0.14285714285714285,6,6,TACAAGCTGCTTCTGTAGGC,0,468887
araBp,0.14285714285714285,6,6,TAATATGTATACATTGTCTA,0,472048
araBp,0.14285714285714285,6,6,TAATATGGTATATGGCAAAA,0,525348
araBp,0.14285714285714285,6,6,TAATATGACTGAGCATGCAG,0,497770
araBp,0.14285714285714285,6,6,TAATAAGCCACCTGGACCTT,0,498228
araBp,0.14285714285714285,6,6,TAATAACCCAAAGGTCACCA,0,505747
araBp,0.14285714285714285,6,6,TAAGGTTATCTCCGCCATAA,0,496491
araBp,0.14285714285714285,6,6,TAAGGTAATTATTCATTCGT,0,477055
araBp,0.14285714285714285,6,6,TAAGGCCAGCTGTGTGTCAA,0,513005
araBp,0.14285714285714285,6,6,TAAGCCAGAACGCGGTGCGA,0,521591
araBp,0.14285714285714285,6,6,TAAAGCCGACTCATCAGGTA,0,503212
araBp,0.14285714285714285,6,6,TAAAATCATACGAATGCCGC,0,477855
araBp,0.14285714285714285,6,6,TAAAAGTCGCAAAAGTACCC,0,513302
araBp,0.14285714285714285,6,6,GTTTTAGCGGCTCATGCCTA,0,478657
araBp,0.14285714285714285,6,6,GTTTGCGGAGGACTATAGCT,0,489151
araBp,0.14285714285714285,6,6,GTTTGCGCTGCGGCTCCTAG,0,480056
araBp,0.14285714285714285,6,6,GTTTCCTTTGTTGTGTCCGA,0,490403
araBp,0.14285714285714285,6,6,GTTTATATATCGTTAGCGCT,0,485552
araBp,0.14285714285714285,6,6,GTTGTGTGAATGTACTGCCC,0,468263
araBp,0.14285714285714285,6,6,GTTGTGGATAACGGTATTAT,0,491480
araBp,0.14285714285714285,6,6,GTTGAGAGCACGGCTATGGT,0,468703
araBp,0.14285714285714285,6,6,GTTGACGAGGGATTGCTGAC,0,482866
araBp,0.14285714285714285,6,6,GTTCTCTGCAGGGAGTCCAC,0,504455
araBp,0.14285714285714285,6,6,GTTCTAGTGGGTAGTGTTTG,0,502850
araBp,0.14285714285714285,6,6,GTTCCCAAGGCGGATTCGCT,0,518754
araBp,0.14285714285714285,6,6,GTTCACTTGGCTTTTTCAAT,0,475270
araBp,0.14285714285714285,6,6,GTTAAGATCATGCGTCGCTA,0,504751
araBp,0.14285714285714285,6,6,GTGGTTTCGTCCCCGCCCGA,0,494770
araBp,0.14285714285714285,6,6,GTGGTATGTCTAGGTATAAG,0,474479
araBp,0.14285714285714285,6,6,GTGGCGTTAAAGTGTAAAGC,0,504594
araBp,0.14285714285714285,6,6,GTGGCGCCATGGACCAGTGG,0,523292
araBp,0.14285714285714285,6,6,GTGGACGTCAGGGGTCACAC,0,490334
araBp,0.14285714285714285,6,6,GTGCATAGTGAATTTGAATC,0,471537
araBp,0.14285714285714285,6,6,GTGAGAGCCTAGAACCTACT,0,513371
araBp,0.14285714285714285,6,6,GTGACTGGGCAGTTTGGCTA,0,502475
araBp,0.14285714285714285,6,6,GTGAATGGGCTAACTTCCGT,0,479524
araBp,0.14285714285714285,6,6,GTCTGGAGATGGAAAAGAGC,0,493651
araBp,0.14285714285714285,6,6,GTCTAACTTGTAATTTACAA,0,501421
araBp,0.14285714285714285,6,6,GTCGTGTGGAGGTTCTCTCT,0,481019
araBp,0.14285714285714285,6,6,GTCGCTGAAGCTCCGACCTA,0,507673
araBp,0.14285714285714285,6,6,GTCCTTTGTTTGGGATCCCG,0,519841
araBp,0.14285714285714285,6,6,GTCCTCGTCCACCTGAGTTT,0,494003
araBp,0.14285714285714285,6,6,GTCCGTTGAAGATCTGAACT,0,503683
araBp,0.14285714285714285,6,6,GTCCGTCCATAGCTCCCACA,0,498223
araBp,0.14285714285714285,6,6,GTCCACTTACATAACGGTTT,0,523548
araBp,0.14285714285714285,6,6,GTCAGTCTGGTGAGTAGCGC,0,478483
araBp,0.14285714285714285,6,6,GTCAGTCGCAGTGGTTCAGG,0,511272
araBp,0.14285714285714285,6,6,GTCACATGCACGCGATTGCA,0,518520
araBp,0.14285714285714285,6,6,GTCACAGAAGATCAATAACC,0,474445
araBp,0.14285714285714285,6,6,GTCAATCCGGGATAAAGATT,0,501146
araBp,0.14285714285714285,6,6,GTATTTGTCGAGTACGCATA,0,500136
araBp,0.14285714285714285,6,6,GTATTCTCGAGTTACTGTTT,0,475185
araBp,0.14285714285714285,6,6,GTATAACGCACTCAATAGAT,0,521136
araBp,0.14285714285714285,6,6,GTAGGCCTATGCTCGAGGCG,0,523127
araBp,0.14285714285714285,6,6,GTAGGACGTTACCAACGGAT,0,481150
araBp,0.14285714285714285,6,6,GTAGACAATCCCAAGCACGT,0,515295
araBp,0.14285714285714285,6,6,GGTTCTTCCGCCAGAGATCT,0,517790
araBp,0.14285714285714285,6,6,GGTTAGTGCGGAGCCCTCAT,0,489683
araBp,0.14285714285714285,6,6,GGTTACAGGCGTCGGCCGGG,0,498183
araBp,0.14285714285714285,6,6,GGTGTGTGGGCGTTATCTAC,0,511681
araBp,0.14285714285714285,6,6,GGTGGTGTAGAGCCGCTCCG,0,499541
araBp,0.14285714285714285,6,6,GGTGGTAGGGTGGGCGTAAT,0,496420
araBp,0.14285714285714285,6,6,GGTGCTTAGGTGAACAGATC,0,515471
araBp,0.14285714285714285,6,6,GGTCTGAGGCATTCTGGGTA,0,469828
araBp,0.14285714285714285,6,6,GGTCCTACACTTAGGGTATT,0,475871
araBp,0.14285714285714285,6,6,GGTCCATACGCGCAACACTA,0,468495
araBp,0.14285714285714285,6,6,GGTCAATCAGGCGGAAAGCA,0,517263
araBp,0.14285714285714285,6,6,GGTAAGTGTTAGGCGAGAAG,0,515264
araBp,0.14285714285714285,6,6,GGGTTGCGTAGTAAGCAAAT,0,513890
araBp,0.14285714285714285,6,6,GGGTTAAACCCGAACCAGAC,0,517065
araBp,0.14285714285714285,6,6,GGGTCATGGCTAAGGTTAAA,0,490371
araBp,0.14285714285714285,6,6,GGGGCACTCATCCCCTGTGC,0,482938
araBp,0.14285714285714285,6,6,GGGGATCGACTGAGTGTATG,0,516299
araBp,0.14285714285714285,6,6,GGGCGTCACTGACTGTAATC,0,515759
araBp,0.14285714285714285,6,6,GGGAGACTCACACTGCCTGC,0,494636
araBp,0.14285714285714285,6,6,GGGACCGACCACGTATGTCT,0,509339
araBp,0.14285714285714285,6,6,GGGAAAAATTAACAATCGCT,0,523146
araBp,0.14285714285714285,6,6,GGCTTTCATCCTAGACGGAA,0,499287
araBp,0.14285714285714285,6,6,GGCTTCGGTGCCTACTTTTT,0,504278
araBp,0.14285714285714285,6,6,GGCTTAATAAAACTTAATAA,0,523557
araBp,0.14285714285714285,6,6,GGCTGTTGCGTGGTACGACA,0,504417
araBp,0.14285714285714285,6,6,GGCTAGGACTATGTGTGCGA,0,513059
araBp,0.14285714285714285,6,6,GGCGTGCCCGATTATCTGAT,0,477041
araBp,0.14285714285714285,6,6,GGCGGAGATTCTCTGAGAAA,0,477555
araBp,0.14285714285714285,6,6,GGCGGAAAATGGTTTGCAAA,0,500612
araBp,0.14285714285714285,6,6,GGCGAATCGGCGACAGCTCA,0,486950
araBp,0.14285714285714285,6,6,GGCCTCCAGATTGCGCAGGG,0,517677
araBp,0.14285714285714285,6,6,GGCCGCACTACGCCCGAGTT,0,497031
araBp,0.14285714285714285,6,6,GGCCCATTGGAGAGTCTCGA,0,507522
araBp,0.14285714285714285,6,6,GGCCCAAACAGCCTTGAGCT,0,472212
araBp,0.14285714285714285,6,6,GGCCAGTCACTGGAACTGTG,0,495070
araBp,0.14285714285714285,6,6,GGCCACGTCCGCCTATTCCT,0,516033
araBp,0.14285714285714285,6,6,GGATTGCAAAGCAATAGCCT,0,517071
araBp,0.14285714285714285,6,6,GGATGACTAGAATTTTGTGA,0,517679
araBp,0.14285714285714285,6,6,GGATCGCCATTTATTGAGTT,0,517431
araBp,0.14285714285714285,6,6,GGATACTACCGCTGTGCCGA,0,505042
araBp,0.14285714285714285,6,6,GGATACCCTGCCATCGTCGG,0,521323
araBp,0.14285714285714285,6,6,GGAGTGAATCCCGACAGTAT,0,522062
araBp,0.14285714285714285,6,6,GGAGGGTCGCACTGATCCTA,0,495630
araBp,0.14285714285714285,6,6,GGAGGCAACTGTTGGTATGG,0,485204
araBp,0.14285714285714285,6,6,GGAGCCGTCAAGAGTTCGGC,0,473732
araBp,0.14285714285714285,6,6,GGAGCAACGCCAGGCCATTG,0,477523
araBp,0.14285714285714285,6,6,GGAGAAGGGCTGCCTTCGAC,0,522669
araBp,0.14285714285714285,6,6,GGACTGTAAGTTGGCAAAGA,0,492238
araBp,0.14285714285714285,6,6,GGAACCATCAAACCACGTGG,0,518342
araBp,0.14285714285714285,6,6,GCTTTCTGTGTGCAAGGGAC,0,481445
araBp,0.14285714285714285,6,6,GCTTTCCAACGGTGGTAAAC,0,514283
araBp,0.14285714285714285,6,6,GCTTCCCGAGTCGGCATAGT,0,521938
araBp,0.14285714285714285,6,6,GCTTAAATCTGCCCACTACT,0,482299
araBp,0.14285714285714285,6,6,GCTCTGAGTAGAGTGTATAG,0,470943
araBp,0.14285714285714285,6,6,GCTCCTTGACCACCGTCTGG,0,521438
araBp,0.14285714285714285,6,6,GCTCACGCGGTTGGACGGGA,0,505018
araBp,0.14285714285714285,6,6,GCTATAGGATTATCGATCGT,0,500777
araBp,0.14285714285714285,6,6,GCTAAAATCCGCTTGCCTAA,0,513520
araBp,0.14285714285714285,6,6,GCGTTCCGGAGCCGTTGACC,0,489413
araBp,0.14285714285714285,6,6,GCGTGCGTTTTGCGATGCTA,0,469438
araBp,0.14285714285714285,6,6,GCGTGACCTCGCACTAACGA,0,517705
araBp,0.14285714285714285,6,6,GCGTCCTCCGTTGGGGGCCA,0,490463
araBp,0.14285714285714285,6,6,GCGTCAGATACTATCATACG,0,509464
araBp,0.14285714285714285,6,6,GCGTAGCAATAGTGGCGGTC,0,482420
araBp,0.14285714285714285,6,6,GCGGTCCCCAGACGCCATTG,0,522114
araBp,0.14285714285714285,6,6,GCGGTCACCATCTACAATGT,0,508389
araBp,0.14285714285714285,6,6,GCGGGGTCAAACTCCTCTTT,0,486358
araBp,0.14285714285714285,6,6,GCGGAGTAATGGCGGCCGCA,0,524273
araBp,0.14285714285714285,6,6,GCGATAGGGCATGTATGTAC,0,517570
araBp,0.14285714285714285,6,6,GCGAGGATAACGGGTGTCAA,0,489586
araBp,0.14285714285714285,6,6,GCGACAACTTCTAGAGCAAG,0,469464
araBp,0.14285714285714285,6,6,GCGAACCACCAGAAAGGATT,0,484497
araBp,0.14285714285714285,6,6,GCCTGGGGCACCCTCTCAAA,0,493590
araBp,0.14285714285714285,6,6,GCCTGGGAGTGCTCCTTCAG,0,523747
araBp,0.14285714285714285,6,6,GCCTGGAGATTGCCTTGTAA,0,478930
araBp,0.14285714285714285,6,6,GCCTGCTGACAGAGACGGCG,0,504520
araBp,0.14285714285714285,6,6,GCCTCAGGGACCTGTCAATA,0,522843
araBp,0.14285714285714285,6,6,GCCTAGGCCTGGCTCGTTGT,0,524618
araBp,0.14285714285714285,6,6,GCCGTTTGGGAATAGGAATG,0,507914
araBp,0.14285714285714285,6,6,GCCGGTAAAATAAAACAACC,0,496831
araBp,0.14285714285714285,6,6,GCCGAGTAAGGGTGGGGAAT,0,478022
araBp,0.14285714285714285,6,6,GCCGAGGATCAGAAAAATCT,0,489358
araBp,0.14285714285714285,6,6,GCCGACGCACTTCGATCTGT,0,467976
araBp,0.14285714285714285,6,6,GCCCGAATGTGGTGTAAAGC,0,481277
araBp,0.14285714285714285,6,6,GCCCACGTCCCTCTCAGGCC,0,513332
araBp,0.14285714285714285,6,6,GCCAGCTACATTATCGCCCA,0,508471
araBp,0.14285714285714285,6,6,GCCACGAGCCCTATGACGAC,0,475584
araBp,0.14285714285714285,6,6,GCATTAATCAATACATACCA,0,481274
araBp,0.14285714285714285,6,6,GCATGTGCACTGCGCTAGAC,0,504894
araBp,0.14285714285714285,6,6,GCAGTCTGCTCAGTCAAGGC,0,489528
araBp,0.14285714285714285,6,6,GCAGAGATCGATCTTTGATG,0,488912
araBp,0.14285714285714285,6,6,GCAGAACGGCTCAAATCGTT,0,491041
araBp,0.14285714285714285,6,6,GCACTATTCACCTTTTTCTT,0,502578
araBp,0.14285714285714285,6,6,GCACGGCTGCGTGAAGACAT,0,476518
araBp,0.14285714285714285,6,6,GCACGCATCCCGATCGTGCA,0,496557
araBp,0.14285714285714285,6,6,GCACGAAAATTAACCATTAG,0,470359
araBp,0.14285714285714285,6,6,GCAATTCCTTAAGTCTCCCG,0,474703
araBp,0.14285714285714285,6,6,GCAATGGTGAAATCTCACTC,0,495975
araBp,0.14285714285714285,6,6,GCAAACAATGTGATCGATTA,0,473068
araBp,0.14285714285714285,6,6,GATTTCGATGTATCGCACGG,0,479520
araBp,0.14285714285714285,6,6,GATTGACGTCCGCAGCTGAG,0,518960
araBp,0.14285714285714285,6,6,GATGGCCACACTATCTGTTT,0,503985
araBp,0.14285714285714285,6,6,GATGGCAAAGAAAAATCTAG,0,483133
araBp,0.14285714285714285,6,6,GATGCTTCCTACGATTTCTA,0,497659
araBp,0.14285714285714285,6,6,GATGCCGTGGTCTATCAACA,0,508274
araBp,0.14285714285714285,6,6,GATGCCGAACAGGTAGCGTT,0,500544
araBp,0.14285714285714285,6,6,GATGACGCATCAATGAACGC,0,484233
araBp,0.14285714285714285,6,6,GATCCTGCGAGGGTTAGCGG,0,523812
araBp,0.14285714285714285,6,6,GATAGTACCGCGTCGTCCCC,0,468562
araBp,0.14285714285714285,6,6,GATACGCTGCTCCTACCAGC,0,475552
araBp,0.14285714285714285,6,6,GATAACTGTCTGGCTTCTAT,0,480467
araBp,0.14285714285714285,6,6,GAGTGAAAAGCCCCATCCGA,0,481133
araBp,0.14285714285714285,6,6,GAGTCGCCTCACGCAGTAAG,0,503203
araBp,0.14285714285714285,6,6,GAGTATCCGTCCATCTTGCC,0,505351
araBp,0.14285714285714285,6,6,GAGGTGATACAGCACGTTAC,0,506261
araBp,0.14285714285714285,6,6,GAGGTCACGTCATAGGCAAG,0,504512
araBp,0.14285714285714285,6,6,GAGGCTTGGAGTGTGGGGGA,0,501321
araBp,0.14285714285714285,6,6,GAGCTATAAGGTTGCAGTAA,0,511678
araBp,0.14285714285714285,6,6,GAGACGACATTTGGTCTCTC,0,499632
araBp,0.14285714285714285,6,6,GAGAAAGACATACGCCTGCC,0,512992
araBp,0.14285714285714285,6,6,GACTGTGTAAGCGTTTTCAA,0,471290
araBp,0.14285714285714285,6,6,GACCTGGTAAAAGATGGGAT,0,498656
araBp,0.14285714285714285,6,6,GACCTGCTTTGTGTATAATC,0,515474
araBp,0.14285714285714285,6,6,GACCCTAAACCCGCCTGGAT,0,483138
araBp,0.14285714285714285,6,6,GACATGCCTGTGAAGTTCTT,0,519748
araBp,0.14285714285714285,6,6,GACACGCAGCAAGTCCGTAA,0,474278
araBp,0.14285714285714285,6,6,GACAACCACAAATCGGCTAA,0,493918
araBp,0.14285714285714285,6,6,GACAAAAGTACTTGGCATCA,0,519530
araBp,0.14285714285714285,6,6,GAATTGCCTGAAAGTTGATT,0,473977
araBp,0.14285714285714285,6,6,GAATCCGAGGAGATTTCTAA,0,517079
araBp,0.14285714285714285,6,6,GAATCCATGCTTAGTGACCC,0,522714
araBp,0.14285714285714285,6,6,GAATAACAAAATCGAAGGAG,0,475623
araBp,0.14285714285714285,6,6,GAAGATGACCTTGCTCACTT,0,490103
araBp,0.14285714285714285,6,6,GAAGAGAGTCCTTCGTGATC,0,488332
araBp,0.14285714285714285,6,6,GAAGACTCTGGATGACTCGG,0,474985
araBp,0.14285714285714285,6,6,GAACTTTTCATTCGGTCAAT,0,497888
araBp,0.14285714285714285,6,6,GAACTCTTGTTAGTTCCATT,0,471642
araBp,0.14285714285714285,6,6,GAACAAGAGCCATAGGGAGA,0,497414
araBp,0.14285714285714285,6,6,GAACAACCTCACACCGCTAT,0,521457
araBp,0.14285714285714285,6,6,GAAATACTTTCCTATATCCA,0,495631
araBp,0.14285714285714285,6,6,GAAACTATATCGCAGGACCG,0,500318
araBp,0.14285714285714285,6,6,CTTTGTTGGCGTGTGGTCAC,0,469508
araBp,0.14285714285714285,6,6,CTTTGAAAAAAGTATGAAGT,0,523150
araBp,0.14285714285714285,6,6,CTTTCGAAACCCGCAGGTCG,0,496880
araBp,0.14285714285714285,6,6,CTTCTGGTAGAGCGCGTTTT,0,492477
araBp,0.14285714285714285,6,6,CTTCGAGTCAGTGATGTCCG,0,473963
araBp,0.14285714285714285,6,6,CTTCGACTGATGCTTGAGAG,0,523205
araBp,0.14285714285714285,6,6,CTTCATAGTCTCGGACGTTT,0,495459
araBp,0.14285714285714285,6,6,CTTCACACGGTTCCATCCGA,0,499768
araBp,0.14285714285714285,6,6,CTTAGTTCACGGAACACACA,0,514036
araBp,0.14285714285714285,6,6,CTTAGTGCCGACTGAAGTGT,0,486247
araBp,0.14285714285714285,6,6,CTTACACTTAAGCGGAGGCT,0,494483
araBp,0.14285714285714285,6,6,CTTAATGTCAAACCACGAAT,0,488206
araBp,0.14285714285714285,6,6,CTTAAAGTGGTACGGCAGGC,0,508948
araBp,0.14285714285714285,6,6,CTGTGAACCCAGAACCGGCG,0,509553
araBp,0.14285714285714285,6,6,CTGTCGGTTTGAACGAGGTA,0,485803
araBp,0.14285714285714285,6,6,CTGTAGTTATATGTAATACA,0,489044
araBp,0.14285714285714285,6,6,CTGGTTTAAAGTCCTTTTAT,0,493016
araBp,0.14285714285714285,6,6,CTGGTACATAAGACAGGAGG,0,483906
araBp,0.14285714285714285,6,6,CTGGGGCGATTCCCTGTATA,0,515750
araBp,0.14285714285714285,6,6,CTGGAGGACCCGCAATATAA,0,500700
araBp,0.14285714285714285,6,6,CTGCTAGCAGTCCGAGAATG,0,519543
araBp,0.14285714285714285,6,6,CTGCGTGTTGGTAACCGAGA,0,495547
araBp,0.14285714285714285,6,6,CTGCGTATATGCGCCGCGTC,0,491415
araBp,0.14285714285714285,6,6,CTGCGGTCTTCTGGGAGTCC,0,497868
araBp,0.14285714285714285,6,6,CTGCGCTAAGGAAGGGCGTA,0,522505
araBp,0.14285714285714285,6,6,CTGCCAGCATTTCCTTATCA,0,476497
araBp,0.14285714285714285,6,6,CTGCCAGCATCCTAAGCGTT,0,470425
araBp,0.14285714285714285,6,6,CTGCATAAGTCAGGTCGTGT,0,473042
araBp,0.14285714285714285,6,6,CTGCAACCCGACTGCACCCC,0,519596
araBp,0.14285714285714285,6,6,CTGATGATGTCGAAGGTGGT,0,480958
araBp,0.14285714285714285,6,6,CTGATAATAAATTGGACTCA,0,490603
araBp,0.14285714285714285,6,6,CTGAGCTGGTGAACGTTTAT,0,490031
araBp,0.14285714285714285,6,6,CTGACTTTTCTATTATTTAG,0,505557
araBp,0.14285714285714285,6,6,CTGACCGATCATCTTAGCGT,0,492392
araBp,0.14285714285714285,6,6,CTGACAGCAGGGGCATCGAA,0,514924
araBp,0.14285714285714285,6,6,CTGAACCGAGCTGGGATGAG,0,491448
araBp,0.14285714285714285,6,6,CTCTACAGACGAGCAGTGGC,0,514091
araBp,0.14285714285714285,6,6,CTCGTTACCATTCTTTTACA,0,483078
araBp,0.14285714285714285,6,6,CTCGTATAGTAACTTTAAGA,0,478436
araBp,0.14285714285714285,6,6,CTCGGGTATCCGGTAGTTCC,0,508723
araBp,0.14285714285714285,6,6,CTCGCGCATTGTTAGACTAT,0,520083
araBp,0.14285714285714285,6,6,CTCGAATTGGCTGCAAAGAA,0,468382
araBp,0.14285714285714285,6,6,CTCCTGTCGCGAGTGGACCT,0,520764
araBp,0.14285714285714285,6,6,CTCCGTCAGCTTAGAGACGA,0,479815
araBp,0.14285714285714285,6,6,CTCCCCAACTTTCTCCCCGC,0,506596
araBp,0.14285714285714285,6,6,CTCCCAGAGACAGCAATCAG,0,471472
araBp,0.14285714285714285,6,6,CTCCCACAACACGTGCCTGT,0,503831
araBp,0.14285714285714285,6,6,CTCATTAGGCTTAATGAGTG,0,488759
araBp,0.14285714285714285,6,6,CTCAGTTAACGTAAGTAGAT,0,468293
araBp,0.14285714285714285,6,6,CTCAGGCGGAATATCATTTT,0,486319
araBp,0.14285714285714285,6,6,CTCAGCAAGGTACGAGACGG,0,521059
araBp,0.14285714285714285,6,6,CTCACCTCATTTAATAATAA,0,516355
araBp,0.14285714285714285,6,6,CTAGTTGGCTATCATGTCAT,0,501169
araBp,0.14285714285714285,6,6,CTAGTGTAGTGAATTCTGCC,0,485190
araBp,0.14285714285714285,6,6,CTAGGTAAAGCTTAGCCATA,0,500116
araBp,0.14285714285714285,6,6,CTAGACCCCTGCTCACTGGC,0,512436
araBp,0.14285714285714285,6,6,CTACTTGTCGCCGACTTGGG,0,501676
araBp,0.14285714285714285,6,6,CTACAGGCATCCTCCTTTGG,0,472669
araBp,0.14285714285714285,6,6,CTAATAACGAATGGGCGACT,0,479039
araBp,0.14285714285714285,6,6,CGTTCCTACGTGTTACTACC,0,513477
araBp,0.14285714285714285,6,6,CGTTCAGGTATACGCGCTTG,0,512172
araBp,0.14285714285714285,6,6,CGTGTCAGGCATCCTCTCGT,0,511077
araBp,0.14285714285714285,6,6,CGTGCTGTAGCGCTCGCCAC,0,495421
araBp,0.14285714285714285,6,6,CGTGCTCTTGGAATTAGTCC,0,503275
araBp,0.14285714285714285,6,6,CGTGCGTGCTTGCTCTTCAA,0,497266
araBp,0.14285714285714285,6,6,CGTGCGTCAGATCTTGGATT,0,473034
araBp,0.14285714285714285,6,6,CGTGCACGTGCGTCTCTCCA,0,478875
araBp,0.14285714285714285,6,6,CGTGAGCAGCGAAGCCAGGC,0,473798
araBp,0.14285714285714285,6,6,CGTCTCCCGAGGCAGGTGGA,0,504303
araBp,0.14285714285714285,6,6,CGTATGGTTTGAAATCACAT,0,509471
araBp,0.14285714285714285,6,6,CGTAGGCGACTAACAAAATC,0,473118
araBp,0.14285714285714285,6,6,CGTAGCCAGGTTCCTTATTA,0,491681
araBp,0.14285714285714285,6,6,CGTACAACTTCGATTGCTAA,0,507119
araBp,0.14285714285714285,6,6,CGGTTAGCGTGAGATTTAGA,0,497171
araBp,0.14285714285714285,6,6,CGGTGTCCTGGCCTTCAGGT,0,505703
araBp,0.14285714285714285,6,6,CGGTGAGTCATATGTCAGTG,0,524353
araBp,0.14285714285714285,6,6,CGGTCAGTGGTTCGGTACCT,0,518241
araBp,0.14285714285714285,6,6,CGGTATCTTTCAAGCAACGG,0,516732
araBp,0.14285714285714285,6,6,CGGTACGAGTGCGCGGCCGT,0,518577
araBp,0.14285714285714285,6,6,CGGTAATTAGGGCGTGGATC,0,488128
araBp,0.14285714285714285,6,6,CGGGGGTGGCTGCTTATTTC,0,492181
araBp,0.14285714285714285,6,6,CGGGGGCGGACATCCTGGCG,0,501882
araBp,0.14285714285714285,6,6,CGGGCCAGCTACCGCCCGGT,0,507864
araBp,0.14285714285714285,6,6,CGGGATTAAACAGTGGCGCA,0,522893
araBp,0.14285714285714285,6,6,CGGCCAAAACGGACCAGTTT,0,492009
araBp,0.14285714285714285,6,6,CGGATGTTATGGCTTGCGTC,0,513329
araBp,0.14285714285714285,6,6,CGGAAGGCAACCGGAAGAAA,0,521403
araBp,0.14285714285714285,6,6,CGGAACGCTTAGAGGACTTG,0,478711
araBp,0.14285714285714285,6,6,CGGAAATCTATCCGGCCGCA,0,518443
araBp,0.14285714285714285,6,6,CGCTTGAGGAACCGTAAGAC,0,511352
araBp,0.14285714285714285,6,6,CGCTTCGTTTCACAAGTAGA,0,509449
araBp,0.14285714285714285,6,6,CGCTGTGCGTACTCGTGATT,0,487504
araBp,0.14285714285714285,6,6,CGCTGGAAAGGTTTAGAGTA,0,484468
araBp,0.14285714285714285,6,6,CGCTGACCTGGATAGGGAGG,0,472176
araBp,0.14285714285714285,6,6,CGCTCTGGATGGCCGTTTAC,0,516141
araBp,0.14285714285714285,6,6,CGCTCCCTACCCCGGGTGGT,0,520679
araBp,0.14285714285714285,6,6,CGCTACGAAAGTAGATTAGT,0,491912
araBp,0.14285714285714285,6,6,CGCGTGGTATTACCCAGATT,0,497516
araBp,0.14285714285714285,6,6,CGCGTATTTGCTTCTTCATA,0,515918
araBp,0.14285714285714285,6,6,CGCGCCTTGGATGGGCACGA,0,505647
araBp,0.14285714285714285,6,6,CGCGCCCGTCTAAAAGCGGA,0,500397
araBp,0.14285714285714285,6,6,CGCGCCCCTCTGTTTCGGGT,0,513493
araBp,0.14285714285714285,6,6,CGCCCCGCTATGGTGAGTCA,0,473909
araBp,0.14285714285714285,6,6,CGCCAGGTTCAGGACCGGGA,0,504897
araBp,0.14285714285714285,6,6,CGCCAGGTCTAACCTTCAAA,0,506828
araBp,0.14285714285714285,6,6,CGCATCAAAATGTCAGACGG,0,491848
araBp,0.14285714285714285,6,6,CGATTGGGTGCATGTTAGTT,0,506027
araBp,0.14285714285714285,6,6,CGATCTGGCTCCAAGGGTCA,0,480161
araBp,0.14285714285714285,6,6,CGATATGAGGGTTAGGGGTT,0,515658
araBp,0.14285714285714285,6,6,CGAGTCTTCGGCCTTCCTGG,0,525268
araBp,0.14285714285714285,6,6,CGAGCGGTGGGAGTTCAGCG,0,477578
araBp,0.14285714285714285,6,6,CGACTACAACAGTGGACGAT,0,514928
araBp,0.14285714285714285,6,6,CGACATTAGGGTCTGTCTAT,0,472624
araBp,0.14285714285714285,6,6,CGACAGTTCGCCCATGTGTC,0,491257
araBp,0.14285714285714285,6,6,CGAATCGGGCATCCATTGCA,0,485454
araBp,0.14285714285714285,6,6,CGAAGCTGGTCCACAACTGC,0,500925
araBp,0.14285714285714285,6,6,CGAAGAGTATGGTGTACTTA,0,522306
araBp,0.14285714285714285,6,6,CGAACGTATCCCCCCGACGG,0,491933
araBp,0.14285714285714285,6,6,CGAACATCATTTCAATGACT,0,506248
araBp,0.14285714285714285,6,6,CCTTTTCTCGACAATAAGAG,0,507640
araBp,0.14285714285714285,6,6,CCTTGTAGTGCTAGCATAGG,0,483994
araBp,0.14285714285714285,6,6,CCTTCGAGATGTGGCTATTC,0,507341
araBp,0.14285714285714285,6,6,CCTGTGTATAGCACATCCAT,0,506417
araBp,0.14285714285714285,6,6,CCTGTCCACTAATGCGGGTA,0,514841
araBp,0.14285714285714285,6,6,CCTGAATTCACTTATTTAAC,0,505616
araBp,0.14285714285714285,6,6,CCTCTGGCACTTGCTAGCTT,0,496780
araBp,0.14285714285714285,6,6,CCTCGGACCAGTACGAACAT,0,496610
araBp,0.14285714285714285,6,6,CCTATTCAATAGTTTGCGCG,0,486924
araBp,0.14285714285714285,6,6,CCTATAAACGGTCTGCGACA,0,499396
araBp,0.14285714285714285,6,6,CCTAAGTCGTGGGTGAGTTC,0,515061
araBp,0.14285714285714285,6,6,CCTAAACAAGCGGGTATTCT,0,477967
araBp,0.14285714285714285,6,6,CCGTTTGAATTACGAGGGAT,0,488908
araBp,0.14285714285714285,6,6,CCGTCAGCGGAAGCATATAA,0,524329
araBp,0.14285714285714285,6,6,CCGTATCAAGTCGGCCTCGG,0,483006
araBp,0.14285714285714285,6,6,CCGTAGACACTTGTAACTAG,0,514748
araBp,0.14285714285714285,6,6,CCGGGTATGAGGATCATCCA,0,506369
araBp,0.14285714285714285,6,6,CCGGGCAGGCTATCAGACAT,0,477148
araBp,0.14285714285714285,6,6,CCGGGATTTTTTGTTCACAT,0,472994
araBp,0.14285714285714285,6,6,CCGGCGGAGAATTGAGAAGT,0,520824
araBp,0.14285714285714285,6,6,CCGGCCACGCGAGGGACTTG,0,501978
araBp,0.14285714285714285,6,6,CCGGACACACGCAATAGAGA,0,478191
araBp,0.14285714285714285,6,6,CCGCTAGATCCCGCATTAGG,0,468234
araBp,0.14285714285714285,6,6,CCGCATTTGGTATATGTATC,0,506964
araBp,0.14285714285714285,6,6,CCGCAGCAGTTGGCGTCCAC,0,504509
araBp,0.14285714285714285,6,6,CCGATTGGTTTCACACTAAA,0,517875
araBp,0.14285714285714285,6,6,CCGATTCCGCGTGGGCCTAA,0,505493
araBp,0.14285714285714285,6,6,CCGATGTACCACGGTAATGA,0,520087
araBp,0.14285714285714285,6,6,CCGACGATGAGTTACCTACT,0,521044
araBp,0.14285714285714285,6,6,CCCTATCCTACATTGAGTTG,0,483706
araBp,0.14285714285714285,6,6,CCCTAATTCGCCAAACGAGG,0,485508
araBp,0.14285714285714285,6,6,CCCGGTCGTCAACTTACCAA,0,488608
araBp,0.14285714285714285,6,6,CCCGGGCTAGTTCAAACAGC,0,471661
araBp,0.14285714285714285,6,6,CCCGCGTCCCGCATCTACTT,0,475456
araBp,0.14285714285714285,6,6,CCCCCCGTGAATTAGCCAAC,0,497038
araBp,0.14285714285714285,6,6,CCCCCATACAGTCACTCTCA,0,493181
araBp,0.14285714285714285,6,6,CCCATCTATGCCACACGGGA,0,523585
araBp,0.14285714285714285,6,6,CCCAGTCCCTGTTAACACAT,0,480263
araBp,0.14285714285714285,6,6,CCCACGTAAACGGGCCAGAG,0,493295
araBp,0.14285714285714285,6,6,CCCACACCTAGATTGTACAC,0,485580
araBp,0.14285714285714285,6,6,CCCAATCATAGACCATGTAA,0,475246
araBp,0.14285714285714285,6,6,CCATTTCAGGTAGCGTGTTA,0,519746
araBp,0.14285714285714285,6,6,CCATTGACATGACACTCTTT,0,481482
araBp,0.14285714285714285,6,6,CCAGTATGTGCGAGGGCTTG,0,471591
araBp,0.14285714285714285,6,6,CCAGAGTCTTAACACAGCTC,0,490656
araBp,0.14285714285714285,6,6,CCAGACAGATCCCCTACGGT,0,481870
araBp,0.14285714285714285,6,6,CCAGAATCGCTAAGCGAGTG,0,472466
araBp,0.14285714285714285,6,6,CCACTTAAGTCCCATTTAGC,0,468564
araBp,0.14285714285714285,6,6,CCACCCAGCTGCCCTATGCG,0,475599
araBp,0.14285714285714285,6,6,CCAAAATAACGTGGAGGGCA,0,525501
araBp,0.14285714285714285,6,6,CATTTGCTGCCGGAATTACA,0,471815
araBp,0.14285714285714285,6,6,CATTTCATTTGTCAGATAAG,0,524534
araBp,0.14285714285714285,6,6,CATTTACCTGCTTTTATGGG,0,488282
araBp,0.14285714285714285,6,6,CATTGGTATACCGTTGTGAC,0,496829
araBp,0.14285714285714285,6,6,CATTCTCATGCCAAGGGCTT,0,480557
araBp,0.14285714285714285,6,6,CATGTTGCGCTGGACCGTGT,0,475949
araBp,0.14285714285714285,6,6,CATGTAGCGACTGTTTCGGG,0,491723
araBp,0.14285714285714285,6,6,CATGGTCATTTAGTTGAATC,0,482956
araBp,0.14285714285714285,6,6,CATGCGATTGGCGCTGAGCA,0,478106
araBp,0.14285714285714285,6,6,CATCTCATCGGTCATACGGT,0,509410
araBp,0.14285714285714285,6,6,CATCAGGTGGCATTCAATCA,0,513739
araBp,0.14285714285714285,6,6,CATCAAAATAGAAGGAGCTG,0,490336
araBp,0.14285714285714285,6,6,CATACTCCCAGAGTTAACAG,0,504536
araBp,0.14285714285714285,6,6,CAGTTAATTTACCTTGAACG,0,509422
araBp,0.14285714285714285,6,6,CAGGCTCTCGGATGCGGGAA,0,516413
araBp,0.14285714285714285,6,6,CAGGCGTACACTCAGTCGGC,0,497927
araBp,0.14285714285714285,6,6,CAGGCCAGTCGGTTCGTCCT,0,523399
araBp,0.14285714285714285,6,6,CAGGAACATCGTACTTACCA,0,491391
araBp,0.14285714285714285,6,6,CAGCTGGGCTAATAGTTACG,0,494855
araBp,0.14285714285714285,6,6,CAGCTGCTTGGATCGGGCGT,0,512824
araBp,0.14285714285714285,6,6,CAGCGCTGGTGTATTAGTGT,0,505321
araBp,0.14285714285714285,6,6,CAGATTTTCACGCCGTCGCA,0,493495
araBp,0.14285714285714285,6,6,CAGATGTCCCCAGTGTGTCA,0,501639
araBp,0.14285714285714285,6,6,CACTGCTCAGCGCGTACCGG,0,474224
araBp,0.14285714285714285,6,6,CACTCCCGTCCACAACCCAA,0,487393
araBp,0.14285714285714285,6,6,CACTATTGCGAGTCTCACAC,0,502690
araBp,0.14285714285714285,6,6,CACGTCAGTACGCTTACATA,0,509533
araBp,0.14285714285714285,6,6,CACGGGTTTCAGCTAGTTGA,0,476108
araBp,0.14285714285714285,6,6,CACCGCCAAATTCCATCGAC,0,504549
araBp,0.14285714285714285,6,6,CACCGACGTCAAAACCTTGT,0,486850
araBp,0.14285714285714285,6,6,CACCGAAAGACACTTTTGGT,0,523420
araBp,0.14285714285714285,6,6,CACATTAAGCTGCAGGCGCG,0,509071
araBp,0.14285714285714285,6,6,CACAATAATCCCTTGCCATC,0,486217
araBp,0.14285714285714285,6,6,CAATTCGGGCAGCAACCTGT,0,496087
araBp,0.14285714285714285,6,6,CAATCGGACTCAATCGATAT,0,472679
araBp,0.14285714285714285,6,6,CAATAAGACGTTGCACTTTA,0,517671
araBp,0.14285714285714285,6,6,CAAGTCGCACATGCCATGAA,0,484190
araBp,0.14285714285714285,6,6,CAAGGACTCATTCACTGTGA,0,520966
araBp,0.14285714285714285,6,6,CAAGCGCCTCCCGGCGACTC,0,477659
araBp,0.14285714285714285,6,6,CAAGATCTTGCCCCGAGCAG,0,484344
araBp,0.14285714285714285,6,6,CAAGAATTAGTGGTTTGTGT,0,477887
araBp,0.14285714285714285,6,6,CAACTCTACTGCCTCGTTTA,0,473847
araBp,0.14285714285714285,6,6,CAACGCGGCAGGGCTCCTAC,0,510076
araBp,0.14285714285714285,6,6,CAACGCCCCACACTCGACCG,0,503591
araBp,0.14285714285714285,6,6,CAACCCCGCGCGGTAAACTT,0,493273
araBp,0.14285714285714285,6,6,CAACATATCCCCTCCACGGG,0,483381
araBp,0.14285714285714285,6,6,CAACATAGGGAACCGTTTAG,0,522348
araBp,0.14285714285714285,6,6,CAACAAGCCACGCGGATAGT,0,487188
araBp,0.14285714285714285,6,6,CAAATAGGTGCGGTGCCCCG,0,487868
araBp,0.14285714285714285,6,6,CAAAGCACATCCCTCCCAGA,0,489842
araBp,0.14285714285714285,6,6,CAAAATTGGGGTCCGTCTCC,0,511567
araBp,0.14285714285714285,6,6,CAAAAAGTGCGTACGATGAC,0,477270
araBp,0.14285714285714285,6,6,ATTTTTGGTATCTTGACGAG,0,481659
araBp,0.14285714285714285,6,6,ATTTTCAGCTGGCACGGGTC,0,468617
araBp,0.14285714285714285,6,6,ATTTTACGAGAATGCCCAAT,0,493428
araBp,0.14285714285714285,6,6,ATTTGTTCAGTCACTACACA,0,506304
araBp,0.14285714285714285,6,6,ATTTCCTATTACCACTAGAT,0,521431
araBp,0.14285714285714285,6,6,ATTTCAGTGTTGTGGAAACG,0,507953
araBp,0.14285714285714285,6,6,ATTTCACGACCTCAAACTCC,0,489952
araBp,0.14285714285714285,6,6,ATTTAGTTTTTGGACCTAAA,0,492277
araBp,0.14285714285714285,6,6,ATTTACCGGCCTATGCACGG,0,481934
araBp,0.14285714285714285,6,6,ATTGTTGGGATCGATGCCGT,0,518320
araBp,0.14285714285714285,6,6,ATTGTGAGTTTTGGGACCCT,0,494799
araBp,0.14285714285714285,6,6,ATTGGCGAGGAGTCAAACGT,0,515488
araBp,0.14285714285714285,6,6,ATTGGCCTTTGGAATGATAC,0,502156
araBp,0.14285714285714285,6,6,ATTGAATTGATTATACGTAG,0,508861
araBp,0.14285714285714285,6,6,ATTCCTCTTTTTGTTTGAGT,0,523638
araBp,0.14285714285714285,6,6,ATTCATGAGCTCTTGCCCTC,0,501224
araBp,0.14285714285714285,6,6,ATTCAAAAAGTTTTCGGGCT,0,483443
araBp,0.14285714285714285,6,6,ATTAGGTGCAACTTAACACA,0,525352
araBp,0.14285714285714285,6,6,ATTACGCAACATTACTTGTA,0,520355
araBp,0.14285714285714285,6,6,ATTAACATGCAAAACAGCAA,0,520310
araBp,0.14285714285714285,6,6,ATGTTTGAGCTGCGGGGTCG,0,480820
araBp,0.14285714285714285,6,6,ATGTTTACCAGCGAACGTCT,0,496440
araBp,0.14285714285714285,6,6,ATGTGTCGTGAGACCCTTAC,0,507856
araBp,0.14285714285714285,6,6,ATGTATATTACGATCAGAAG,0,483722
araBp,0.14285714285714285,6,6,ATGTACTCCGCTTTGGCTGA,0,468533
araBp,0.14285714285714285,6,6,ATGGTTTAAATTTAGCAAAA,0,494340
araBp,0.14285714285714285,6,6,ATGGGATTTGCTCCATCTCA,0,489846
araBp,0.14285714285714285,6,6,ATGGGATCTTCTCCCGGTTG,0,489733
araBp,0.14285714285714285,6,6,ATGGCGTGGAGAAAGGACGG,0,524375
araBp,0.14285714285714285,6,6,ATGGCCGGTGGTATATTGGT,0,519743
araBp,0.14285714285714285,6,6,ATGGATTGAAAGCTACGGAT,0,480618
araBp,0.14285714285714285,6,6,ATGGATTACTACCCCAGGTC,0,522320
araBp,0.14285714285714285,6,6,ATGGAGAGACCAGATCTTAT,0,506184
araBp,0.14285714285714285,6,6,ATGCTTCTGTTTAAGATTAC,0,498605
araBp,0.14285714285714285,6,6,ATGCGAATTCAAGTATTTTA,0,487486
araBp,0.14285714285714285,6,6,ATGCCGAGGGTGCTTGGCAT,0,512060
araBp,0.14285714285714285,6,6,ATGCCCCATCACGTTTGCCG,0,473301
araBp,0.14285714285714285,6,6,ATGCATGCATAAGTAGCACT,0,474518
araBp,0.14285714285714285,6,6,ATGATCCTACGCGTTTACCT,0,505324
araBp,0.14285714285714285,6,6,ATGAGGCACCCATCAGGTCA,0,521916
araBp,0.14285714285714285,6,6,ATGAGCGGCCCCAGAATAAC,0,474161
araBp,0.14285714285714285,6,6,ATGACGGGTGGTAGGAAGGT,0,500549
araBp,0.14285714285714285,6,6,ATGAAACGCTTATGGGCCGC,0,479096
araBp,0.14285714285714285,6,6,ATCTTTAGGTACTGCATCAG,0,504613
araBp,0.14285714285714285,6,6,ATCTTGCATTATATGGAGTC,0,479562
araBp,0.14285714285714285,6,6,ATCTACAGTATGGCTTGTAT,0,485174
araBp,0.14285714285714285,6,6,ATCGTAGTACAGCCTCACAG,0,482842
araBp,0.14285714285714285,6,6,ATCGGGCGAAGCTAGCGCTG,0,504006
araBp,0.14285714285714285,6,6,ATCGGCCGAGTGCCTGGGGC,0,480207
araBp,0.14285714285714285,6,6,ATCGCATTACAATGCCTAAA,0,470919
araBp,0.14285714285714285,6,6,ATCGCATGACTGTAGGGACA,0,499076
araBp,0.14285714285714285,6,6,ATCCGGCTGCCTGGGCACGT,0,483019
araBp,0.14285714285714285,6,6,ATCCCGGCGATCCTTATCAA,0,474861
araBp,0.14285714285714285,6,6,ATCCCGATAAGGGGACTCAG,0,484820
araBp,0.14285714285714285,6,6,ATCCACATGATAGCGCCAAC,0,483445
araBp,0.14285714285714285,6,6,ATCCAAGGGTTTTGCGTTGT,0,500962
araBp,0.14285714285714285,6,6,ATCCAACATCTATGTAAGTA,0,504706
araBp,0.14285714285714285,6,6,ATCATGCCTGAATCATATTA,0,523070
araBp,0.14285714285714285,6,6,ATCAAAGTCTTGTGGTCGTA,0,479160
araBp,0.14285714285714285,6,6,ATATTATCCTATGTGCGTCC,0,512967
araBp,0.14285714285714285,6,6,ATATCCCTCTTAGATCAGAG,0,473709
araBp,0.14285714285714285,6,6,ATAGTGTTCCTACGTCCGTT,0,507720
araBp,0.14285714285714285,6,6,ATAGTGTCTAAAGTAACGCG,0,496076
araBp,0.14285714285714285,6,6,ATAGATTCAATAGGGGCCTT,0,524519
araBp,0.14285714285714285,6,6,ATACGTGAATTCTGCAGGAT,0,485286
araBp,0.14285714285714285,6,6,ATACGGCCCTCTAAGCCTGT,0,509151
araBp,0.14285714285714285,6,6,ATACCGCAAGCATCTATTCT,0,486082
araBp,0.14285714285714285,6,6,ATAATTTCGATTTACCTACT,0,523802
araBp,0.14285714285714285,6,6,ATAAGTTACTGGGCTTCTCC,0,470280
araBp,0.14285714285714285,6,6,ATAAGCACGATTTAGAACAT,0,489522
araBp,0.14285714285714285,6,6,ATAACGAGCCGCATTCGGGG,0,518919
araBp,0.14285714285714285,6,6,AGTGGTTAGCAATTGCAGGA,0,502660
araBp,0.14285714285714285,6,6,AGTGCTAATATGTCTCCTTC,0,496310
araBp,0.14285714285714285,6,6,AGTGCGAACATTTTGTCTCT,0,476673
araBp,0.14285714285714285,6,6,AGTGCCTGCTATCGGACATC,0,474115
araBp,0.14285714285714285,6,6,AGTGCATTGGCATCACATGT,0,490309
araBp,0.14285714285714285,6,6,AGTCTCAATTAGGGGAGGAT,0,481362
araBp,0.14285714285714285,6,6,AGTCTACGCGACAGGAAAGA,0,470740
araBp,0.14285714285714285,6,6,AGTCGAAGTGCGCGGCGTAC,0,502199
araBp,0.14285714285714285,6,6,AGTCCGCACACAGCCATCAA,0,501289
araBp,0.14285714285714285,6,6,AGTCATTCTCGTCTTTAACT,0,483410
araBp,0.14285714285714285,6,6,AGTCATCTCAACACTCGCGC,0,482190
araBp,0.14285714285714285,6,6,AGTCAGCGTTACGAGGCTGT,0,481258
araBp,0.14285714285714285,6,6,AGTACGATGCAGAACGTTAG,0,493202
araBp,0.14285714285714285,6,6,AGTAAACAGTCTGCAACCGG,0,473577
araBp,0.14285714285714285,6,6,AGGTGGCTGAAGTATAGATA,0,524569
araBp,0.14285714285714285,6,6,AGGGTTAGAAGTGGGGATTG,0,472317
araBp,0.14285714285714285,6,6,AGGGTTAAAAGTTACACGTT,0,477801
araBp,0.14285714285714285,6,6,AGGGTGTAACTCCCACGAGT,0,523545
araBp,0.14285714285714285,6,6,AGGGGCTGTAAACATGACAC,0,471273
araBp,0.14285714285714285,6,6,AGGGGCAAGCCCCGAGTCCA,0,493065
araBp,0.14285714285714285,6,6,AGGGAGTGTTATGTTGTATT,0,497007
araBp,0.14285714285714285,6,6,AGGCGTTACAAACCAGTCAC,0,478859
araBp,0.14285714285714285,6,6,AGGCGCGTACGTCGTCCACG,0,469244
araBp,0.14285714285714285,6,6,AGGCCGTACAAAATCGGTAC,0,489091
araBp,0.14285714285714285,6,6,AGGCCATGTCTTGCAGGCAG,0,522399
araBp,0.14285714285714285,6,6,AGGAGGGTGAGTAGCCCCTA,0,510141
araBp,0.14285714285714285,6,6,AGGAACTTTATGGTTTAGCG,0,469026
araBp,0.14285714285714285,6,6,AGCTTATACTATGTTTCCTA,0,495600
araBp,0.14285714285714285,6,6,AGCTTAGGTCGTTACCCCAC,0,470188
araBp,0.14285714285714285,6,6,AGCTGGGTAGCACAGGGCGC,0,515026
araBp,0.14285714285714285,6,6,AGCTGGAAGAAAAGACTTGG,0,501602
araBp,0.14285714285714285,6,6,AGCTAGGCTAATATACCATT,0,484232
araBp,0.14285714285714285,6,6,AGCGGGTGCGGCGAAAGTCA,0,467876
araBp,0.14285714285714285,6,6,AGCGCCGTTCACCGAAGCGT,0,484302
araBp,0.14285714285714285,6,6,AGCGATCAGCTGAATCGCGG,0,498697
araBp,0.14285714285714285,6,6,AGCCCTGCGCAACCGGGACA,0,493968
araBp,0.14285714285714285,6,6,AGCCACTGAAGCTGGAGGAA,0,517670
araBp,0.14285714285714285,6,6,AGCATTCAGAGATGGCTACA,0,482523
araBp,0.14285714285714285,6,6,AGCATGCAGGTGGAATATGT,0,485197
araBp,0.14285714285714285,6,6,AGCATACGGCAATTCAGGAT,0,518070
araBp,0.14285714285714285,6,6,AGCAGGATGTTTGCTGGCGA,0,479422
araBp,0.14285714285714285,6,6,AGCACTCATATCTAACCTGG,0,474596
araBp,0.14285714285714285,6,6,AGATTTACCGCTGAAAGGAT,0,487492
araBp,0.14285714285714285,6,6,AGATTTAAAGTGGCGAGTTC,0,513958
araBp,0.14285714285714285,6,6,AGATCTTATAGCGTGACTGT,0,470623
araBp,0.14285714285714285,6,6,AGATCCATGCTCACTAATCA,0,505097
araBp,0.14285714285714285,6,6,AGATCATGCACGGGTACATA,0,476005
araBp,0.14285714285714285,6,6,AGATACTTGATGATACGCCA,0,475885
araBp,0.14285714285714285,6,6,AGAGGCTTCCGCACGTGCCA,0,479484
araBp,0.14285714285714285,6,6,AGAGGCATGCTGGAAAAAGT,0,522569
araBp,0.14285714285714285,6,6,AGAGGCAAGAGTGTTGTCGG,0,479485
araBp,0.14285714285714285,6,6,AGAGGACTGAGGCTGGAATC,0,522168
araBp,0.14285714285714285,6,6,AGACTCTAGGATATAGCAGC,0,502763
araBp,0.14285714285714285,6,6,AGACGCAAAGACGACGTGAT,0,479590
araBp,0.14285714285714285,6,6,AGACCGCCCTCACATCGCTT,0,513914
araBp,0.14285714285714285,6,6,AGAATGTCTTTGCTTGCCAA,0,524668
araBp,0.14285714285714285,6,6,AGAATCCTAGGTATGGCTGC,0,482892
araBp,0.14285714285714285,6,6,AGAATAAAATAGGACTTGGT,0,472192
araBp,0.14285714285714285,6,6,AGAACCCACCATAATGACAA,0,512465
araBp,0.14285714285714285,6,6,ACTTTAAGCCCCTTAGTTGC,0,483773
araBp,0.14285714285714285,6,6,ACTTCTCAACTGTACACCCC,0,473167
araBp,0.14285714285714285,6,6,ACTTCCTGTGCATGCTGGCA,0,512215
araBp,0.14285714285714285,6,6,ACTGTAGGTGATTGCGTTGA,0,505510
araBp,0.14285714285714285,6,6,ACTGCGTACCCACGTAAGAT,0,488314
araBp,0.14285714285714285,6,6,ACTGAATGTTTGGGGGCGAA,0,474523
araBp,0.14285714285714285,6,6,ACGTGCGAGCAATCAAAGTC,0,514474
araBp,0.14285714285714285,6,6,ACGTCGGCTAAGTGACGGAA,0,492714
araBp,0.14285714285714285,6,6,ACGGTGCCGTTACATCTTCA,0,477228
araBp,0.14285714285714285,6,6,ACGGCAGCATAGCATTCCTT,0,485430
araBp,0.14285714285714285,6,6,ACGGAATTACACGAGCAATG,0,489891
araBp,0.14285714285714285,6,6,ACGCCTCCCAGTAGCACGTT,0,523018
araBp,0.14285714285714285,6,6,ACGCCGTTAATCGGACATGA,0,487341
araBp,0.14285714285714285,6,6,ACGCCGGAGGAGTGTCCGAT,0,473581
araBp,0.14285714285714285,6,6,ACGCCGCCGAATACTACGGT,0,496723
araBp,0.14285714285714285,6,6,ACGCCCGCATCAAAGCCGGC,0,497415
araBp,0.14285714285714285,6,6,ACGCATCCTCGCGCGAGGTG,0,518643
araBp,0.14285714285714285,6,6,ACGACCGGCTTTAGGGCTGC,0,494310
araBp,0.14285714285714285,6,6,ACCTTCATGACAAGAAGCCT,0,512773
araBp,0.14285714285714285,6,6,ACCTCGGGTTCTAACAACGT,0,523561
araBp,0.14285714285714285,6,6,ACCTCGGGGCTTTAGGTCTC,0,519065
araBp,0.14285714285714285,6,6,ACCTCGAGGGAAGATCAATC,0,477000
araBp,0.14285714285714285,6,6,ACCGGACCTTGTCTGAAGGA,0,474330
araBp,0.14285714285714285,6,6,ACCGCTGGAACTGTGTCTGT,0,518892
araBp,0.14285714285714285,6,6,ACCCGTTCAATGCGTAATGT,0,503675
araBp,0.14285714285714285,6,6,ACCCGCTTCTGTAATAGCGC,0,497822
araBp,0.14285714285714285,6,6,ACCCCTATGTCCTGAGACTA,0,509048
araBp,0.14285714285714285,6,6,ACCCCGCTAAGGAACTCGGC,0,503250
araBp,0.14285714285714285,6,6,ACCCATGTAACGGGCAACAA,0,505231
araBp,0.14285714285714285,6,6,ACCCAGGAGGCTCCCTGGGA,0,496671
araBp,0.14285714285714285,6,6,ACCAGAGGTTCTGGGCATTG,0,525510
araBp,0.14285714285714285,6,6,ACCAAGTAATTATCTCGGGA,0,503766
araBp,0.14285714285714285,6,6,ACATTGGGTACCGTAGAGGG,0,508319
araBp,0.14285714285714285,6,6,ACATTAAACACAGAGTTATC,0,499860
araBp,0.14285714285714285,6,6,ACATAGGGCACTCGCAAGAT,0,490965
araBp,0.14285714285714285,6,6,ACAGGACAGTGTGCGGTATT,0,477858
araBp,0.14285714285714285,6,6,ACAGATCAAGACGTACCTTT,0,504586
araBp,0.14285714285714285,6,6,ACAGAGGGGGCGTGTCCCGG,0,491112
araBp,0.14285714285714285,6,6,ACACGTTATACATACGTAGG,0,518468
araBp,0.14285714285714285,6,6,ACACAGTCTCAACCTCAACA,0,475906
araBp,0.14285714285714285,6,6,ACACAGCGGTGGATGCGTTA,0,485024
araBp,0.14285714285714285,6,6,ACACACCCAAGTGCCGAATG,0,486385
araBp,0.14285714285714285,6,6,AATTTCCGCCATCACGTCTC,0,495692
araBp,0.14285714285714285,6,6,AATTCGATTGGGCTTGAAAT,0,507847
araBp,0.14285714285714285,6,6,AATTAATTCTACTTCAGCGC,0,514341
araBp,0.14285714285714285,6,6,AATGTAGCACGATCCTCTTA,0,509417
araBp,0.14285714285714285,6,6,AATGCAGCTTGCCCCCCACC,0,517160
araBp,0.14285714285714285,6,6,AATGCAGCGGCGGCTTGCCC,0,508781
araBp,0.14285714285714285,6,6,AATCGTCTTCAGCCTGGTGT,0,483082
araBp,0.14285714285714285,6,6,AATCGCCAGGTTGGAGAGAG,0,484769
araBp,0.14285714285714285,6,6,AATCCGCCCTCAAATCTTGT,0,480422
araBp,0.14285714285714285,6,6,AATCCACATCGTAAAATTGC,0,473794
araBp,0.14285714285714285,6,6,AATCATTTAGCATGGGTGCC,0,498474
araBp,0.14285714285714285,6,6,AATCAGTAGAAATTCCGCAT,0,488797
araBp,0.14285714285714285,6,6,AATAGTTACATCTGGCAGGC,0,500196
araBp,0.14285714285714285,6,6,AATAGGTTCAGACTTAGCCC,0,491284
araBp,0.14285714285714285,6,6,AATAGGACAGTTGCCAAGTG,0,501414
araBp,0.14285714285714285,6,6,AATACTCCTTAATTCCTTTA,0,471530
araBp,0.14285714285714285,6,6,AATACGGAAAGGATTGTGGT,0,487429
araBp,0.14285714285714285,6,6,AAGTGAATATTATCCAAATT,0,514655
araBp,0.14285714285714285,6,6,AAGTCTCACAGGTTTGCCAA,0,495839
araBp,0.14285714285714285,6,6,AAGGTGTCGTCCTCAGGATA,0,471909
araBp,0.14285714285714285,6,6,AAGGGATCTTCGAGTGAAGT,0,519444
araBp,0.14285714285714285,6,6,AAGGCTTATATGCTAAGTAG,0,483322
araBp,0.14285714285714285,6,6,AAGGCACAAACACCGCCGTA,0,472965
araBp,0.14285714285714285,6,6,AAGCTGGTCGGCTAGCTCGA,0,523517
araBp,0.14285714285714285,6,6,AAGCTAACGCTAAGGCCGCG,0,524563
araBp,0.14285714285714285,6,6,AAGCCGATGTAAATTTTAGG,0,496007
araBp,0.14285714285714285,6,6,AAGAGCACGCTGGCCCACAG,0,492722
araBp,0.14285714285714285,6,6,AACTGACCTCTGCAGTGCCA,0,519910
araBp,0.14285714285714285,6,6,AACTATTAGATTCCCTTCGT,0,520768
araBp,0.14285714285714285,6,6,AACTAGGAGCGTGCTTGAGG,0,512854
araBp,0.14285714285714285,6,6,AACGTTATTATCTAATATTG,0,474964
araBp,0.14285714285714285,6,6,AACGTGTACTGGACCGTTTT,0,468815
araBp,0.14285714285714285,6,6,AACGTAGGAACGAGGGGCGT,0,520446
araBp,0.14285714285714285,6,6,AACGACCAATTCCATCTGCC,0,516586
araBp,0.14285714285714285,6,6,AACCTTTTGGTAAGTGAGCG,0,502861
araBp,0.14285714285714285,6,6,AACCTCGGGGTGGAATGCGT,0,508719
araBp,0.14285714285714285,6,6,AACCTATACCCGAAACATTC,0,523976
araBp,0.14285714285714285,6,6,AACCAAGGCGTCTACCCTAA,0,472201
araBp,0.14285714285714285,6,6,AACAGGCCTCGGACCAGGTA,0,507177
araBp,0.14285714285714285,6,6,AAATTGCACGAAGTACTGGC,0,508851
araBp,0.14285714285714285,6,6,AAATGTGACCTCAAAAAAAC,0,522846
araBp,0.14285714285714285,6,6,AAATCGCAATGTGAGCGCAG,0,522311
araBp,0.14285714285714285,6,6,AAATCAAGACCGGACGGTCA,0,491381
araBp,0.14285714285714285,6,6,AAATATGCTAACTCTCCATA,0,523066
araBp,0.14285714285714285,6,6,AAATAATCTTGTGGTCTTTT,0,481589
araBp,0.14285714285714285,6,6,AAAGTTGGAGAATCTCTTTC,0,488064
araBp,0.14285714285714285,6,6,AAAGTTGACTCCGCAATATC,0,519970
araBp,0.14285714285714285,6,6,AAAGTTGAATCGGTGATCTC,0,524909
araBp,0.14285714285714285,6,6,AAAGTTCCCGCCCTCAACCA,0,501745
araBp,0.14285714285714285,6,6,AAAGTGGCCCGGGACAATTT,0,520183
araBp,0.14285714285714285,6,6,AAAGCTAAAATCGGGAATTA,0,477711
araBp,0.14285714285714285,6,6,AAACGGGCCGATAATCTTCT,0,506531
araBp,0.14285714285714285,6,6,AAACGCTTCAATGCGGTTTG,0,518572
araBp,0.14285714285714285,6,6,AAACATCCGATTCGGTTTTT,0,480173
araBp,0.14285714285714285,6,6,AAAACCGAATCGGCCCCGGG,0,484071
araBp,0.16666666666666666,5,5,TTTTTTACACAGGCGATTAA,0,516032
araBp,0.16666666666666666,5,5,TTTTTCCCTGGACCTACGGG,0,521277
araBp,0.16666666666666666,5,5,TTTTTATCTAAGGCTCCAGG,0,468567
araBp,0.16666666666666666,5,5,TTTTGTCGATATCTAGTCCA,0,511440
araBp,0.16666666666666666,5,5,TTTTGTCATAGGATGGATAT,0,467822
araBp,0.16666666666666666,5,5,TTTTGTATTGTAGTGGGTGC,0,515792
araBp,0.16666666666666666,5,5,TTTTCCCGATCTACCAATTT,0,497883
araBp,0.16666666666666666,5,5,TTTTACCGAGTACTGGTCAT,0,521954
araBp,0.16666666666666666,5,5,TTTTAATAGCGAGGTGCAAT,0,498238
araBp,0.16666666666666666,5,5,TTTGTTGGGTGCACCAAGCT,0,480415
araBp,0.16666666666666666,5,5,TTTGTGCCCCAGCGCCATAA,0,487827
araBp,0.16666666666666666,5,5,TTTGTAGACAAGCATGCCCC,0,522357
araBp,0.16666666666666666,5,5,TTTGGGTCGGGGGGGCGCTC,0,504981
araBp,0.16666666666666666,5,5,TTTGCATAGACACGACCGTG,0,486210
araBp,0.16666666666666666,5,5,TTTCTTGTGCTTCCCGCCGT,0,478380
araBp,0.16666666666666666,5,5,TTTCGTGAGAGAAGAGGAGC,0,524235
araBp,0.16666666666666666,5,5,TTTCGAATGGATTACGCAGG,0,489328
araBp,0.16666666666666666,5,5,TTTATCCAGTACCTTAGCTC,0,480957
araBp,0.16666666666666666,5,5,TTTACGTTTTTAGCGCTTTC,0,524885
araBp,0.16666666666666666,5,5,TTTAAGGAACCAGTGTTCTA,0,499033
araBp,0.16666666666666666,5,5,TTGTTTGTAACAACGTCCCC,0,519718
araBp,0.16666666666666666,5,5,TTGTTCACCCGAACCGCAAA,0,495148
araBp,0.16666666666666666,5,5,TTGTCGATGGCTCTTGCTGA,0,517349
araBp,0.16666666666666666,5,5,TTGTCAAATGGGGAGAGTTC,0,515502
araBp,0.16666666666666666,5,5,TTGGTCTCGCGCTTCCATCA,0,482073
araBp,0.16666666666666666,5,5,TTGGCTGACACTTCGGGAAA,0,525315
araBp,0.16666666666666666,5,5,TTGGAGGCAGTACGATTTCT,0,508577
araBp,0.16666666666666666,5,5,TTGCCTCGGACAGTTGATTG,0,487608
araBp,0.16666666666666666,5,5,TTGCACAGACCCTCTAAGGC,0,471451
araBp,0.16666666666666666,5,5,TTGATTCGCGAGGGGCACTT,0,474004
araBp,0.16666666666666666,5,5,TTGAGACAGGGTTTTTGACA,0,476344
araBp,0.16666666666666666,5,5,TTGAGAATTGCCTCACGGAA,0,475616
araBp,0.16666666666666666,5,5,TTGAAACGGGAACGGTTAGA,0,519369
araBp,0.16666666666666666,5,5,TTCTGCGTGTAAGGGCCTAC,0,494484
araBp,0.16666666666666666,5,5,TTCTATCCCCACTTGCGTGT,0,512916
araBp,0.16666666666666666,5,5,TTCGTTGCACGGGGCTAGAC,0,481272
araBp,0.16666666666666666,5,5,TTCGTTCGCTATCGATGGAA,0,507620
araBp,0.16666666666666666,5,5,TTCGTGGTGGGTTTCACTTC,0,472823
araBp,0.16666666666666666,5,5,TTCGTGATTGTGGAGTGTGG,0,515672
araBp,0.16666666666666666,5,5,TTCGGTGCATGTGGTGGTTG,0,507802
araBp,0.16666666666666666,5,5,TTCGGCTGATACGCACGACA,0,480807
araBp,0.16666666666666666,5,5,TTCGAGATCTCTCTGTCGGC,0,476472
araBp,0.16666666666666666,5,5,TTCGACGAGCTCCTACACTG,0,497534
araBp,0.16666666666666666,5,5,TTCGACATACTCGTTTGTGG,0,492218
araBp,0.16666666666666666,5,5,TTCGAATACCGGTAGTTCCC,0,504802
araBp,0.16666666666666666,5,5,TTCGAACCGGAATTGGTGAC,0,468721
araBp,0.16666666666666666,5,5,TTCCGTTTCTCTACAAGGTC,0,472433
araBp,0.16666666666666666,5,5,TTCCACGTGCAAACGACCCA,0,479970
araBp,0.16666666666666666,5,5,TTCAGTGTCTCCCACTGCCG,0,484324
araBp,0.16666666666666666,5,5,TTCAGCACCTTGCACATTAA,0,468538
araBp,0.16666666666666666,5,5,TTCACAGGGAGATGGCTGCG,0,478477
araBp,0.16666666666666666,5,5,TTCAAGAAACACACTTCGAT,0,491148
araBp,0.16666666666666666,5,5,TTCAACCATAAAATGCGTCC,0,471260
araBp,0.16666666666666666,5,5,TTATGTCTTCTTAATTTATT,0,500393
araBp,0.16666666666666666,5,5,TTATAGGCTCACGAAGCATC,0,519999
araBp,0.16666666666666666,5,5,TTAGCCGTATGGGAGTCAGC,0,519101
araBp,0.16666666666666666,5,5,TTAGAAGTCGTGCAGTGTTG,0,517461
araBp,0.16666666666666666,5,5,TTACTGTTTGTCCATGCTAG,0,496031
araBp,0.16666666666666666,5,5,TTACGTAGCATTTTCTTGGG,0,496342
araBp,0.16666666666666666,5,5,TTACGGCGCTTTCAGGTCAG,0,509028
araBp,0.16666666666666666,5,5,TTACCTTCTGGGCGCAAGAT,0,477359
araBp,0.16666666666666666,5,5,TTAATCACTAAACACTCAAG,0,509271
araBp,0.16666666666666666,5,5,TTAAGGACGAAAACTCAGAA,0,518735
araBp,0.16666666666666666,5,5,TTAACAGGCTGGGACAGGTC,0,474219
araBp,0.16666666666666666,5,5,TGTTTGGTCGGCTTTTAACA,0,510016
araBp,0.16666666666666666,5,5,TGTTTCCCGGTTTCCCGGGT,0,517540
araBp,0.16666666666666666,5,5,TGTTTATATTAGAGATAGAC,0,493432
araBp,0.16666666666666666,5,5,TGTTGGTGTTTAGCAAAATG,0,473891
araBp,0.16666666666666666,5,5,TGTTGCTTGCCATACCAAGA,0,487734
araBp,0.16666666666666666,5,5,TGTTCTGTGGTACCGTTAGT,0,474430
araBp,0.16666666666666666,5,5,TGTTCAGCGGGACCGATCGG,0,495030
araBp,0.16666666666666666,5,5,TGTTAGTAACCGAATGTCTG,0,481508
araBp,0.16666666666666666,5,5,TGTTAGCTTTGTCACTCATT,0,521911
araBp,0.16666666666666666,5,5,TGTGTCCTAAGAACTAACGT,0,522267
araBp,0.16666666666666666,5,5,TGTGGAAGATATCTTCACAA,0,496051
araBp,0.16666666666666666,5,5,TGTGATTTCGATCCCCCGAA,0,468635
araBp,0.16666666666666666,5,5,TGTGATCTTGTCTATTCGTC,0,490502
araBp,0.16666666666666666,5,5,TGTCTTCTTCAGTCAGTTAC,0,493691
araBp,0.16666666666666666,5,5,TGTCTGCCGGACACTATAGA,0,494041
araBp,0.16666666666666666,5,5,TGTCTCTTCTCTCACCGGCG,0,495728
araBp,0.16666666666666666,5,5,TGTCTAACCAAGAAAGAGGC,0,468242
araBp,0.16666666666666666,5,5,TGTCGGAGCGAGCGGCTTAC,0,519805
araBp,0.16666666666666666,5,5,TGTCAGCCGGAAGACAGCAA,0,507479
araBp,0.16666666666666666,5,5,TGTCAGAACGGTAACGGACA,0,473582
araBp,0.16666666666666666,5,5,TGTCAAACGATCGTGGTGCG,0,523995
araBp,0.16666666666666666,5,5,TGTATGTGCATACTGTGGAC,0,470018
araBp,0.16666666666666666,5,5,TGTAGGGAACGTCACCTTAA,0,491436
araBp,0.16666666666666666,5,5,TGTAAGTGTTTTAATTGGTG,0,514653
araBp,0.16666666666666666,5,5,TGTAAGGCGCGCTGCTCATC,0,497589
araBp,0.16666666666666666,5,5,TGGTCTGATAGGATTAGTCA,0,484982
araBp,0.16666666666666666,5,5,TGGTCGCTACGAGCCAAAGA,0,514369
araBp,0.16666666666666666,5,5,TGGGTTTGTGTAACGCAGGC,0,485825
araBp,0.16666666666666666,5,5,TGGGTGCGACGTTGCAGGGT,0,511731
araBp,0.16666666666666666,5,5,TGGGTGACACTACTCGGTGT,0,486719
araBp,0.16666666666666666,5,5,TGGGTGAAATGGCAGCACGA,0,484652
araBp,0.16666666666666666,5,5,TGGGTCTAAGGTAAGTAGTT,0,479928
araBp,0.16666666666666666,5,5,TGGGTCATCGGCTACCTTTC,0,515599
araBp,0.16666666666666666,5,5,TGGGTATTGACATAGATCTT,0,501263
araBp,0.16666666666666666,5,5,TGGGGATGTAAGCACGATTA,0,470518
araBp,0.16666666666666666,5,5,TGGGGACAGAAATCGTGACC,0,514551
araBp,0.16666666666666666,5,5,TGGGCTTTGAGTTTCCAGAT,0,525175
araBp,0.16666666666666666,5,5,TGGGATGACGAAGTCAATGG,0,506413
araBp,0.16666666666666666,5,5,TGGCTATAAAGGCGATTATA,0,503243
araBp,0.16666666666666666,5,5,TGGCGTTAGAATCGTAATAG,0,476008
araBp,0.16666666666666666,5,5,TGGCGGCCGGATATCCAGAG,0,479301
araBp,0.16666666666666666,5,5,TGGCGGAAATGCTGGGACGT,0,517430
araBp,0.16666666666666666,5,5,TGGCACCGATGACTTCTCGT,0,517131
araBp,0.16666666666666666,5,5,TGGATTACAGGGAAAGTCGG,0,511199
araBp,0.16666666666666666,5,5,TGGACTCATACCTTTGGCCA,0,499754
araBp,0.16666666666666666,5,5,TGGACGGCACGCGTTTTACA,0,486163
araBp,0.16666666666666666,5,5,TGGACCAATCCACGGCGAGC,0,510047
araBp,0.16666666666666666,5,5,TGGAATGGAAATGTTTCAGT,0,500694
araBp,0.16666666666666666,5,5,TGGAACAACAGGTCTCGTGT,0,490964
araBp,0.16666666666666666,5,5,TGCTTTGGGGGTTTCCGGAT,0,496794
araBp,0.16666666666666666,5,5,TGCTTAACGAATTCGAGAGT,0,524155
araBp,0.16666666666666666,5,5,TGCTGATTTTAAGCGTCGTA,0,521099
araBp,0.16666666666666666,5,5,TGCTCACTTGGCCCGTCTCC,0,493290
araBp,0.16666666666666666,5,5,TGCCTGCCGGATCAGCGTCA,0,478893
araBp,0.16666666666666666,5,5,TGCCGTTGTTAGTAGAAGTG,0,522456
araBp,0.16666666666666666,5,5,TGCCGTAGACTCGGTACATG,0,487508
araBp,0.16666666666666666,5,5,TGCCGATATCTAATTGCTTA,0,474118
araBp,0.16666666666666666,5,5,TGCCCTGTACATTTCTTCGT,0,479056
araBp,0.16666666666666666,5,5,TGCCCGTGACTAGAATGTGG,0,512940
araBp,0.16666666666666666,5,5,TGCCCCCCAGTTGCACGCAT,0,492977
araBp,0.16666666666666666,5,5,TGCCATCGACGACAAGTGTG,0,475742
araBp,0.16666666666666666,5,5,TGCACGCATTGTTCTTCCAG,0,513805
araBp,0.16666666666666666,5,5,TGCAAGGTTCTGTGTACTGC,0,480379
araBp,0.16666666666666666,5,5,TGCAAATTAAACTCATCGGC,0,486613
araBp,0.16666666666666666,5,5,TGATTAGGCACCGCACTACA,0,501380
araBp,0.16666666666666666,5,5,TGAGAGGGTCTCCAGGGACT,0,515155
araBp,0.16666666666666666,5,5,TGAGAGCCCGGTGAACGTGG,0,490453
araBp,0.16666666666666666,5,5,TGACTTATACCGTGAGGTGC,0,518497
araBp,0.16666666666666666,5,5,TGACCGGATTCTGATACTGC,0,471576
araBp,0.16666666666666666,5,5,TGAATTTTCGATTTAGGTGA,0,504132
araBp,0.16666666666666666,5,5,TGAATGAAGGCGATCGTACT,0,486893
araBp,0.16666666666666666,5,5,TGAACAACGTGGCCGCGCGT,0,513606
araBp,0.16666666666666666,5,5,TCTTTGGTTAATATGGTAAT,0,507322
araBp,0.16666666666666666,5,5,TCTGTTCGCCTGGCACTTTC,0,485267
araBp,0.16666666666666666,5,5,TCTGTTAGAAACATCCTGAT,0,483725
araBp,0.16666666666666666,5,5,TCTGTCACCAATCAAACCAG,0,500061
araBp,0.16666666666666666,5,5,TCTGGTAGGAGGAAGACCCC,0,489075
araBp,0.16666666666666666,5,5,TCTGGATGGGGTGCAAAGAC,0,475809
araBp,0.16666666666666666,5,5,TCTGATTTGGAGGTGCGCGT,0,511038
araBp,0.16666666666666666,5,5,TCTGACAGTTAAGGATTCGT,0,482695
araBp,0.16666666666666666,5,5,TCTCTCGGTTGTGAATGGCG,0,496018
araBp,0.16666666666666666,5,5,TCTCGCAAAAATGCTTGGTA,0,516926
araBp,0.16666666666666666,5,5,TCTCATTGGAGACAGCGTAC,0,501370
araBp,0.16666666666666666,5,5,TCTACTCACATTTGAGTTCT,0,496747
araBp,0.16666666666666666,5,5,TCTACCTGTGTTTTTCTCGA,0,510166
araBp,0.16666666666666666,5,5,TCGTGGGCTTGAACATGAGG,0,490080
araBp,0.16666666666666666,5,5,TCGTAGGTCGATCCTATTGA,0,516709
araBp,0.16666666666666666,5,5,TCGGTTGGCTAGGCAACTTA,0,498146
araBp,0.16666666666666666,5,5,TCGGGACTCCTGCCTTCAGC,0,480260
araBp,0.16666666666666666,5,5,TCGGCGAGTCACAGAATGGT,0,519560
araBp,0.16666666666666666,5,5,TCGGCATTCGCAAGTAAGAG,0,480526
araBp,0.16666666666666666,5,5,TCGGCACAAAAGGAACAATA,0,516179
araBp,0.16666666666666666,5,5,TCGGACGATTGTCGGTTTAC,0,474164
araBp,0.16666666666666666,5,5,TCGGAACGTTGGATTAGTTT,0,515439
araBp,0.16666666666666666,5,5,TCGCTATGCCCAGCCCCGGT,0,475415
araBp,0.16666666666666666,5,5,TCGCGTCCGTCTCTATATAT,0,501813
araBp,0.16666666666666666,5,5,TCGCGGGCGCCACGCTTTTT,0,477959
araBp,0.16666666666666666,5,5,TCGAGCGTATTGCCTGCCCG,0,492230
araBp,0.16666666666666666,5,5,TCGACTTACAGCGCAAAAGG,0,521287
araBp,0.16666666666666666,5,5,TCGACAGCAATAGAGAATTT,0,518575
araBp,0.16666666666666666,5,5,TCGAATCATACCTCGGTTAA,0,518681
araBp,0.16666666666666666,5,5,TCGAACATTGCTAGTTCCGT,0,497818
araBp,0.16666666666666666,5,5,TCCGGGGCCAATGCCGCTCA,0,519269
araBp,0.16666666666666666,5,5,TCCGCGGCGGGCATACGGGA,0,495114
araBp,0.16666666666666666,5,5,TCCGCGGCCGTGTACGGTCC,0,513674
araBp,0.16666666666666666,5,5,TCCGCCCAGTGGCCATAAAC,0,469296
araBp,0.16666666666666666,5,5,TCCGATCTGTGTAACGTCTT,0,493935
araBp,0.16666666666666666,5,5,TCCGAGTTCGGAGAGCTGAA,0,521664
araBp,0.16666666666666666,5,5,TCCAGCTACTTCGGGCTCAT,0,469917
araBp,0.16666666666666666,5,5,TCCAGATGAACAGCCTCAAA,0,480390
araBp,0.16666666666666666,5,5,TCCACATGCTGAGTAGGCAG,0,486671
araBp,0.16666666666666666,5,5,TCCAAAGTAACTCAAACAAC,0,484256
araBp,0.16666666666666666,5,5,TCATTCATATTGACTCCCAC,0,525330
araBp,0.16666666666666666,5,5,TCATGTGTCGCTGGTTTCTT,0,479267
araBp,0.16666666666666666,5,5,TCATCTCTAAGAACTGTTAC,0,507431
araBp,0.16666666666666666,5,5,TCAGGACCGCATAACCACAT,0,469742
araBp,0.16666666666666666,5,5,TCAGCGTCAGCTACATATGA,0,478131
araBp,0.16666666666666666,5,5,TCAGCCGGTAGTGCCGCCCA,0,485012
araBp,0.16666666666666666,5,5,TCAGAAAGGCACGCCCATGC,0,509910
araBp,0.16666666666666666,5,5,TCACCGCCGCCCGCGGTGTG,0,477478
araBp,0.16666666666666666,5,5,TCACAATACCTCCAGGAGAC,0,495536
araBp,0.16666666666666666,5,5,TCAAGATTCTTCAGCCACCA,0,516887
araBp,0.16666666666666666,5,5,TCAAAAATTTCGCCTGGTAA,0,493555
araBp,0.16666666666666666,5,5,TATTATCTAGACACGGATCA,0,481033
araBp,0.16666666666666666,5,5,TATGTAGAAATCAGCCGCAA,0,497901
araBp,0.16666666666666666,5,5,TATGCTAGTTCCACGTGAAA,0,491127
araBp,0.16666666666666666,5,5,TATGCGAGGGCTCATAATGG,0,522785
araBp,0.16666666666666666,5,5,TATGACGCCTTTACCTGTGA,0,471510
araBp,0.16666666666666666,5,5,TATCGTCAGAACAAAGGCGA,0,492325
araBp,0.16666666666666666,5,5,TATCGCGCTCTTTGACCCCA,0,508224
araBp,0.16666666666666666,5,5,TATCGATTATTCCTCTGTTC,0,514191
araBp,0.16666666666666666,5,5,TATCCGGGCCGATCGTCGGT,0,478785
araBp,0.16666666666666666,5,5,TATCCGCGATCATATTTGTT,0,522199
araBp,0.16666666666666666,5,5,TATACATTACCTCGTGACTA,0,491728
araBp,0.16666666666666666,5,5,TATAAAATCTCCTAATTGAG,0,499855
araBp,0.16666666666666666,5,5,TAGGTTACATTTTGTGGTGG,0,501847
araBp,0.16666666666666666,5,5,TAGGTATGTCGGGGATTGAA,0,489819
araBp,0.16666666666666666,5,5,TAGGAGTCTCTTCACGCTAT,0,478796
araBp,0.16666666666666666,5,5,TAGGAAATCTTCCTCCAAGA,0,503751
araBp,0.16666666666666666,5,5,TAGCGGAGCGTTAAGCGGAA,0,514588
araBp,0.16666666666666666,5,5,TAGCCTTGCAAGTCACAAAG,0,486131
araBp,0.16666666666666666,5,5,TAGCCAAGGCTTCGATCATG,0,480057
araBp,0.16666666666666666,5,5,TAGCACGTGGCAAAGTTTTG,0,477759
araBp,0.16666666666666666,5,5,TAGAATGCAAGGGGCTCAAT,0,497995
araBp,0.16666666666666666,5,5,TAGAACGGTGGGCGGAGGGA,0,484548
araBp,0.16666666666666666,5,5,TACTTTGGCGTATCTCGTGG,0,511398
araBp,0.16666666666666666,5,5,TACTTCATGCAGTACCTTTT,0,496283
araBp,0.16666666666666666,5,5,TACTTATTGCCCCCGTGGCT,0,500064
araBp,0.16666666666666666,5,5,TACGTTAGAAAGTACAATTG,0,490693
araBp,0.16666666666666666,5,5,TACGGTCTCAACCGGCATAC,0,495502
araBp,0.16666666666666666,5,5,TACGATCATAGGAGTCCCGC,0,506513
araBp,0.16666666666666666,5,5,TACGAGTGACCATAGTCGCT,0,477533
araBp,0.16666666666666666,5,5,TACCTGTGTCAAAACTGATA,0,486061
araBp,0.16666666666666666,5,5,TACCCTGCGCTCTGCTGCAG,0,489636
araBp,0.16666666666666666,5,5,TACATGAGAGCCTGGTGATC,0,476865
araBp,0.16666666666666666,5,5,TACAGTTGATCGTGTAGATA,0,517913
araBp,0.16666666666666666,5,5,TACAGGTCTGTCGCAGGGGT,0,473757
araBp,0.16666666666666666,5,5,TAATTAGATGAGACTTCGCA,0,489724
araBp,0.16666666666666666,5,5,TAATGGCTTTCGGTCCGTTT,0,503714
araBp,0.16666666666666666,5,5,TAATATCCTTGTTTCGGGCT,0,487452
araBp,0.16666666666666666,5,5,TAATAGGTACGTTTCTGTGG,0,475455
araBp,0.16666666666666666,5,5,TAATAACAATGACCGCGGGT,0,476810
araBp,0.16666666666666666,5,5,TAAGTACACTAAGCTGCTTC,0,524423
araBp,0.16666666666666666,5,5,TAAGGAGGAAAAATCGCTTT,0,509769
araBp,0.16666666666666666,5,5,TAAGCGTATAGGTTCGTGAC,0,500283
araBp,0.16666666666666666,5,5,TAAGCCGAACCCGGTAAACG,0,505789
araBp,0.16666666666666666,5,5,TAAGAGATCCACGACTTCAG,0,492271
araBp,0.16666666666666666,5,5,TAAGAAATCGGTACAGAAGT,0,469435
araBp,0.16666666666666666,5,5,TAACTTACCAACCGCGTAGA,0,497568
araBp,0.16666666666666666,5,5,TAACGCATTGTTGCCACGGC,0,470396
araBp,0.16666666666666666,5,5,TAACGAAGCTCGGCAAATGT,0,524349
araBp,0.16666666666666666,5,5,TAAATTTTCCGTCTAAAGAT,0,512252
araBp,0.16666666666666666,5,5,TAAATTTCAACTCCGTATTG,0,477516
araBp,0.16666666666666666,5,5,TAAAATGGATATAGCTCGGG,0,509779
araBp,0.16666666666666666,5,5,TAAAATAAATATCACGTCGT,0,521582
araBp,0.16666666666666666,5,5,GTTTACATAACCTTTTGTGG,0,504609
araBp,0.16666666666666666,5,5,GTTGTGTTAGGCCGTTATCT,0,480505
araBp,0.16666666666666666,5,5,GTTGCCACGCTCGTCCTGAG,0,505014
araBp,0.16666666666666666,5,5,GTTGAACCATGACGTGTGCC,0,524315
araBp,0.16666666666666666,5,5,GTTCGGGGTTTCACCTATCG,0,524945
araBp,0.16666666666666666,5,5,GTTCAAACTTGGCGATGGGT,0,476293
araBp,0.16666666666666666,5,5,GTTAGTTGTGGTATACGGGT,0,494958
araBp,0.16666666666666666,5,5,GTTAGTGATTATAGCAATCC,0,482957
araBp,0.16666666666666666,5,5,GTTAGGTTAACTAGAAGAAT,0,497495
araBp,0.16666666666666666,5,5,GTTACTTTCACCGTCCCTCT,0,473103
araBp,0.16666666666666666,5,5,GTTAATTAGCTGCGTGGTAC,0,492520
araBp,0.16666666666666666,5,5,GTTAACACTTACAGAAAGAC,0,499276
araBp,0.16666666666666666,5,5,GTGTTTTTACTCCTCCCGTT,0,523408
araBp,0.16666666666666666,5,5,GTGTCAAGCTCCATCGCTCG,0,479686
araBp,0.16666666666666666,5,5,GTGTACTAACTATCGGTCCT,0,509624
araBp,0.16666666666666666,5,5,GTGTACGAAGTTATCAGCAA,0,471448
araBp,0.16666666666666666,5,5,GTGTAAGGAGGGACACCCCA,0,522937
araBp,0.16666666666666666,5,5,GTGGTCCGAGACATTGAAGC,0,490771
araBp,0.16666666666666666,5,5,GTGGCGGCGCTCGCACGGTT,0,501782
araBp,0.16666666666666666,5,5,GTGGAGCGCCGTTATGCGTT,0,501252
araBp,0.16666666666666666,5,5,GTGCGTTTCCAGTATCCCGT,0,508027
araBp,0.16666666666666666,5,5,GTGCGCTTCCACAGTGTATA,0,499211
araBp,0.16666666666666666,5,5,GTGATGGATGCCGCCTTTGT,0,516073
araBp,0.16666666666666666,5,5,GTGAGGTTGGGTATGGCAGT,0,490341
araBp,0.16666666666666666,5,5,GTGACTTTTCAGCGGCTCTC,0,518883
araBp,0.16666666666666666,5,5,GTGACAGTCTCCCTGTCGAG,0,476341
araBp,0.16666666666666666,5,5,GTCTTGACTAAGTTCCTGAA,0,514162
araBp,0.16666666666666666,5,5,GTCTTAACGGCGGTGTTCCT,0,481723
araBp,0.16666666666666666,5,5,GTCTCCTAATTGGATCCTCA,0,510362
araBp,0.16666666666666666,5,5,GTCGGGATGTATATTCCACA,0,491261
araBp,0.16666666666666666,5,5,GTCCTCCGGTCGGGGCAAGC,0,468339
araBp,0.16666666666666666,5,5,GTCCGGAAACAATGTAGGAG,0,504805
araBp,0.16666666666666666,5,5,GTCCGCGCACATGACTTCGC,0,478094
araBp,0.16666666666666666,5,5,GTCCCATTTAAAGCGAATTT,0,519987
araBp,0.16666666666666666,5,5,GTCCATCGTCTCTCTCTCAC,0,477648
araBp,0.16666666666666666,5,5,GTCCAGTAGGCTTCGATGTA,0,482897
araBp,0.16666666666666666,5,5,GTCATCTTGGCAATCCTCGA,0,516733
araBp,0.16666666666666666,5,5,GTCACCCGTGGATAATGCTT,0,498921
araBp,0.16666666666666666,5,5,GTCAAGTCCTCAGACCGTGT,0,472131
araBp,0.16666666666666666,5,5,GTCAAGGAATTATCCAGAAC,0,482359
araBp,0.16666666666666666,5,5,GTATCATCTTAACGTGAGGG,0,479533
araBp,0.16666666666666666,5,5,GTATAGCTAGCGGGTTCTCT,0,505380
araBp,0.16666666666666666,5,5,GTAGGAGGCACTCAATAGCC,0,485762
araBp,0.16666666666666666,5,5,GTAGCAAATGGAGTAAGGCT,0,492982
araBp,0.16666666666666666,5,5,GTAGACGAAATTAACTCGTT,0,482571
araBp,0.16666666666666666,5,5,GTACGGGGCTCCCCTAAAGA,0,489682
araBp,0.16666666666666666,5,5,GTACGCCCTTGATTCATTGA,0,481722
araBp,0.16666666666666666,5,5,GTACCCAGATCCGATTCCTT,0,472555
araBp,0.16666666666666666,5,5,GTACAATATCTCGCAACAGC,0,511433
araBp,0.16666666666666666,5,5,GTAAGGGTACCGCTAAGCTC,0,490448
araBp,0.16666666666666666,5,5,GTAAGCCGCAATCTGTGCAT,0,501555
araBp,0.16666666666666666,5,5,GTAAATCACTTGCCTGGGGT,0,495572
araBp,0.16666666666666666,5,5,GGTTCTTAGGGGAGCCACCA,0,507523
araBp,0.16666666666666666,5,5,GGTTCCCAGAGTTAGAACGT,0,475544
araBp,0.16666666666666666,5,5,GGTGTCCGTCGAATATGGTC,0,468792
araBp,0.16666666666666666,5,5,GGTGGCAACACTTCGTACGC,0,473578
araBp,0.16666666666666666,5,5,GGTGCAGTCTTTAGCCCGGA,0,471114
araBp,0.16666666666666666,5,5,GGTGCAGGCATAATTAATCC,0,512669
araBp,0.16666666666666666,5,5,GGTGATCCTGACCTGGGCTA,0,505150
araBp,0.16666666666666666,5,5,GGTGAAGGTAAGATCCTTGT,0,474521
araBp,0.16666666666666666,5,5,GGTCTTCTGCAATCCTTTAT,0,500271
araBp,0.16666666666666666,5,5,GGTCTTCCGCTGCCTTCGGC,0,519838
araBp,0.16666666666666666,5,5,GGTCTAGGTTCAAACTCGTT,0,515747
araBp,0.16666666666666666,5,5,GGTCATTCGGATAGTACGGG,0,477273
araBp,0.16666666666666666,5,5,GGTATAATTGCGGTCGTGAT,0,521194
araBp,0.16666666666666666,5,5,GGTAGCGCTTTCCGTCCTCA,0,476726
araBp,0.16666666666666666,5,5,GGTAAGGTTCGTCGCTGCAG,0,476638
araBp,0.16666666666666666,5,5,GGTAAACTGCCGTGTGTAAG,0,520447
araBp,0.16666666666666666,5,5,GGGTTGGTTGTCAACCATCT,0,471968
araBp,0.16666666666666666,5,5,GGGTTCACTCTAATTTCAAA,0,476685
araBp,0.16666666666666666,5,5,GGGTGGTTTCAATAATTCAT,0,487149
araBp,0.16666666666666666,5,5,GGGTGGATTCTGTACCATAC,0,469297
araBp,0.16666666666666666,5,5,GGGTAAGGGAAAGGGAGCTC,0,519627
araBp,0.16666666666666666,5,5,GGGGTTGTTGAATTTTTTTC,0,474879
araBp,0.16666666666666666,5,5,GGGGTCTTCTCGCCTGCTAG,0,500219
araBp,0.16666666666666666,5,5,GGGGTAGACCGGGTGGCCGT,0,520814
araBp,0.16666666666666666,5,5,GGGGGAATTCTCCATTCCGA,0,506332
araBp,0.16666666666666666,5,5,GGGGCGCTTTAAGGACGGCA,0,521680
araBp,0.16666666666666666,5,5,GGGGCCAGGCTTCTAGCGTA,0,496577
araBp,0.16666666666666666,5,5,GGGCTGATGTGCGTTACGTT,0,487436
araBp,0.16666666666666666,5,5,GGGCTACAGCAGGGATTCAA,0,507117
araBp,0.16666666666666666,5,5,GGGCGTTTTGGTACCGCGTA,0,477017
araBp,0.16666666666666666,5,5,GGGCGTGTCAATCAGATTCC,0,520358
araBp,0.16666666666666666,5,5,GGGCGTACCAAGCTCACGCT,0,525157
araBp,0.16666666666666666,5,5,GGGCCAAAAGACTCATTTGA,0,477388
araBp,0.16666666666666666,5,5,GGGCATTTTGCGTCAACTTA,0,478876
araBp,0.16666666666666666,5,5,GGGAGACAACTTTAAGGGTG,0,514141
araBp,0.16666666666666666,5,5,GGGAAACTCAGATAGTACTG,0,491225
araBp,0.16666666666666666,5,5,GGCTTATCCGCATACCCTTG,0,494370
araBp,0.16666666666666666,5,5,GGCTGGTAGGAGGTCCCCCT,0,472118
araBp,0.16666666666666666,5,5,GGCTGGCTAATTAGGGCTTT,0,481255
araBp,0.16666666666666666,5,5,GGCTATGCCCCTCAGGGTCT,0,471371
araBp,0.16666666666666666,5,5,GGCTAGGGACGGGGGTTGAG,0,525075
araBp,0.16666666666666666,5,5,GGCGTTGCCGGACCACAATC,0,500241
araBp,0.16666666666666666,5,5,GGCGGGCTACAGTACAGTGT,0,510156
araBp,0.16666666666666666,5,5,GGCGCGTAAGAGGCAAATCC,0,472509
araBp,0.16666666666666666,5,5,GGCGCATCTCCGCCCTTTGC,0,511002
araBp,0.16666666666666666,5,5,GGCGAATCTGCCAATGCTAA,0,518691
araBp,0.16666666666666666,5,5,GGCGAAAGTACTTCCGAACG,0,510755
araBp,0.16666666666666666,5,5,GGCCTACTAACGTAAGGACT,0,482236
araBp,0.16666666666666666,5,5,GGCCGTCAGACTTCGCCCTG,0,506160
araBp,0.16666666666666666,5,5,GGCCGCGGGAACGATCTCAC,0,513660
araBp,0.16666666666666666,5,5,GGCCGCCAGGTCCGATCATC,0,478040
araBp,0.16666666666666666,5,5,GGCCCCGTATCCATTGGGTA,0,515298
araBp,0.16666666666666666,5,5,GGCACGGAATTTGAGTAAAT,0,513555
araBp,0.16666666666666666,5,5,GGCAACGGTTTCGCTTGAGG,0,483808
araBp,0.16666666666666666,5,5,GGATCCTGAGTGCATCCGCA,0,489278
araBp,0.16666666666666666,5,5,GGATCAGACCGGAGGTTAAT,0,507658
araBp,0.16666666666666666,5,5,GGATCAAGACCTTTTATGGG,0,499040
araBp,0.16666666666666666,5,5,GGAGTTGTTGATGGACCCGT,0,496800
araBp,0.16666666666666666,5,5,GGAGGTGGAACCCTTCGTGT,0,517925
araBp,0.16666666666666666,5,5,GGAGGTATGGTTGAGGACAT,0,505773
araBp,0.16666666666666666,5,5,GGAGGAACCCTCAGAGAGGC,0,474279
araBp,0.16666666666666666,5,5,GGACGGATCCCAAGCGTTTC,0,468700
araBp,0.16666666666666666,5,5,GGACCTGAGCCCCTGTTCGT,0,468856
araBp,0.16666666666666666,5,5,GGACCAATGATTAACATGTA,0,478385
araBp,0.16666666666666666,5,5,GGAAGGATCTCTAAGGGTAC,0,500428
araBp,0.16666666666666666,5,5,GGAACTCACAGCGGGCGTCC,0,492178
araBp,0.16666666666666666,5,5,GGAAAATGTTAGATAGCGTC,0,480344
araBp,0.16666666666666666,5,5,GCTTGCCACCGTCCCAGGAG,0,490690
araBp,0.16666666666666666,5,5,GCTTCAAGGCGTCTAAAGAT,0,486128
araBp,0.16666666666666666,5,5,GCTGGATGCCGCCATACGGA,0,500607
araBp,0.16666666666666666,5,5,GCTGCGTGCAGACACATCGA,0,505825
araBp,0.16666666666666666,5,5,GCTGCAACCGTCTTACAGCA,0,496489
araBp,0.16666666666666666,5,5,GCTCCTGTAATACGGGACAC,0,490380
araBp,0.16666666666666666,5,5,GCTCCTCTATCTTAGGGGAT,0,517227
araBp,0.16666666666666666,5,5,GCTCCGCAGCCTATATGATC,0,497472
araBp,0.16666666666666666,5,5,GCTCAAGACACGTCATGCTT,0,470771
araBp,0.16666666666666666,5,5,GCTAGTCGGATAATGTCGCT,0,474073
araBp,0.16666666666666666,5,5,GCTAATGTCGCCCAGCACAC,0,484974
araBp,0.16666666666666666,5,5,GCGTTTCGGCTATCATGAGA,0,505060
araBp,0.16666666666666666,5,5,GCGTTGTTTGCGGTAACCTA,0,495066
araBp,0.16666666666666666,5,5,GCGTTGGGTCGGTTGAGCGG,0,510185
araBp,0.16666666666666666,5,5,GCGTTGGGTCCAAAACAACA,0,508804
araBp,0.16666666666666666,5,5,GCGTGTTTACACGTGGTCTC,0,510304
araBp,0.16666666666666666,5,5,GCGTCTCGCCAAGGAGTAAC,0,481942
araBp,0.16666666666666666,5,5,GCGTCAGCCACTGCGACGAA,0,482949
araBp,0.16666666666666666,5,5,GCGGTTATCGTTGGTGTACT,0,468788
araBp,0.16666666666666666,5,5,GCGGCCTCCCTTTAGCGAAA,0,476463
araBp,0.16666666666666666,5,5,GCGGCCCGGGTGCGAGTGCC,0,503170
araBp,0.16666666666666666,5,5,GCGCTTGATGACTGCGGAAG,0,490064
araBp,0.16666666666666666,5,5,GCGCTGGTAAGTAAGGCTAT,0,514136
araBp,0.16666666666666666,5,5,GCGCTGCTGACGTATCTGAG,0,483081
araBp,0.16666666666666666,5,5,GCGCATATTGACGCCGTATA,0,516269
araBp,0.16666666666666666,5,5,GCGCAGTACTGCAATGAGTC,0,479725
araBp,0.16666666666666666,5,5,GCGATACGAGACCGTCGAGG,0,479262
araBp,0.16666666666666666,5,5,GCGACGCAAATCGAACGCGT,0,491451
araBp,0.16666666666666666,5,5,GCGACGAGATTAATACCCTT,0,510892
araBp,0.16666666666666666,5,5,GCCTTACAGAGTCGGTTCTC,0,475379
araBp,0.16666666666666666,5,5,GCCTAATTTTCATCCGCTCC,0,482060
araBp,0.16666666666666666,5,5,GCCGTGGACCAAACACAATA,0,502734
araBp,0.16666666666666666,5,5,GCCGCCTCGAAAGCTGCAAC,0,493461
araBp,0.16666666666666666,5,5,GCCCTTAAAGAGCGTCCCAT,0,503417
araBp,0.16666666666666666,5,5,GCCCTGTACTATCCGTAGGA,0,499309
araBp,0.16666666666666666,5,5,GCCCTAACAGGTTCGAAACT,0,499978
araBp,0.16666666666666666,5,5,GCCCGCGTAAGCGCTGACCA,0,486212
araBp,0.16666666666666666,5,5,GCCCGAATTTGCTCCGTATA,0,515793
araBp,0.16666666666666666,5,5,GCCAGATCTTGTATGACAAG,0,504515
araBp,0.16666666666666666,5,5,GCCAAACACACCTTGGGATC,0,488301
araBp,0.16666666666666666,5,5,GCCAAAAGTTGAATCTAGCA,0,503873
araBp,0.16666666666666666,5,5,GCATCGATTTTAACATGTCT,0,513502
araBp,0.16666666666666666,5,5,GCATCGACTTAGAAACTTTA,0,497588
araBp,0.16666666666666666,5,5,GCAGTTCGTTGTTGATCAAT,0,478426
araBp,0.16666666666666666,5,5,GCAGCCCAGGACCCTTCGCT,0,470468
araBp,0.16666666666666666,5,5,GCAGATCTCCGAAGGACCGA,0,489977
araBp,0.16666666666666666,5,5,GCAGATCCAATTGTCATAGT,0,496936
araBp,0.16666666666666666,5,5,GCACTAAAGTATCTCATGCG,0,492987
araBp,0.16666666666666666,5,5,GCACCCAATGTGAGACCTGA,0,469849
araBp,0.16666666666666666,5,5,GCACATGTCACGCCGTGTCA,0,503539
araBp,0.16666666666666666,5,5,GCAAGGAAGGTAAAGGGAAC,0,489449
araBp,0.16666666666666666,5,5,GCAAATGGCAGTCTTCGCGC,0,525240
araBp,0.16666666666666666,5,5,GATTTTTAGAGTTCTTACGA,0,484273
araBp,0.16666666666666666,5,5,GATTTTATCTACCTCAGTCC,0,514285
araBp,0.16666666666666666,5,5,GATTTGGCATTGCATGAGGA,0,500726
araBp,0.16666666666666666,5,5,GATTTGAACGTAATGACCTA,0,493358
araBp,0.16666666666666666,5,5,GATTTCGGTCATCCCTGACC,0,505414
araBp,0.16666666666666666,5,5,GATTCCTACATCGTACAAGA,0,494938
araBp,0.16666666666666666,5,5,GATTCATACGACGGTCACCT,0,468378
araBp,0.16666666666666666,5,5,GATTAGCGCCGAATGAACTC,0,469499
araBp,0.16666666666666666,5,5,GATTAACAGGGCACTACGGG,0,510129
araBp,0.16666666666666666,5,5,GATGGAAATAGGCTGTAGCG,0,503394
araBp,0.16666666666666666,5,5,GATGAAGTTCAGATAGGGAT,0,514618
araBp,0.16666666666666666,5,5,GATCTTGGGGCATCTCTGAG,0,518856
araBp,0.16666666666666666,5,5,GATCTGGTCTATATGTGTCA,0,491665
araBp,0.16666666666666666,5,5,GATCTATACCCGTGGCTTTT,0,494819
araBp,0.16666666666666666,5,5,GATCGATGCACTCTGTTTGG,0,477119
araBp,0.16666666666666666,5,5,GATCGACAGGCTGACCGGCG,0,525264
araBp,0.16666666666666666,5,5,GATCCGACTCCTGGGCTCCG,0,522967
araBp,0.16666666666666666,5,5,GATCCCCCGACTATCCATGC,0,490056
araBp,0.16666666666666666,5,5,GATCAGACTCGGGTGATCTA,0,515770
araBp,0.16666666666666666,5,5,GATCACACCGTACCTTTATT,0,475911
araBp,0.16666666666666666,5,5,GATACATAAGGTGACGCGAC,0,503057
araBp,0.16666666666666666,5,5,GATAATGATTCCGTTACGAA,0,505591
araBp,0.16666666666666666,5,5,GAGTGAAGGTACGGTCATCT,0,517641
araBp,0.16666666666666666,5,5,GAGGTGGCCTCGAACATCGG,0,478623
araBp,0.16666666666666666,5,5,GAGGTCCGCATATATCACAT,0,473379
araBp,0.16666666666666666,5,5,GAGGTCAGGTGTTATTCCAC,0,516174
araBp,0.16666666666666666,5,5,GAGGTACACTGCGAAGGTGT,0,491474
araBp,0.16666666666666666,5,5,GAGGCTAGTGATGGTAAATT,0,511449
araBp,0.16666666666666666,5,5,GAGCCTATTGGTGCATCAGG,0,468585
araBp,0.16666666666666666,5,5,GAGCACTCAGACCGGGCGTC,0,486361
araBp,0.16666666666666666,5,5,GAGAGCCGGATGTAGAAGAA,0,482731
araBp,0.16666666666666666,5,5,GAGACCGATGTAAATTTCCA,0,520899
araBp,0.16666666666666666,5,5,GACGGTGCCATTTCGACCTA,0,518210
araBp,0.16666666666666666,5,5,GACGGCGTATGGGCGCTTTC,0,510303
araBp,0.16666666666666666,5,5,GACGCGCAGCTATCACGGAA,0,507959
araBp,0.16666666666666666,5,5,GACGACGGCGCGATCTACAA,0,520410
araBp,0.16666666666666666,5,5,GACCTTACGATGACTATTTT,0,490643
araBp,0.16666666666666666,5,5,GACCTGACCATGTGAAAGTT,0,513876
araBp,0.16666666666666666,5,5,GACCTCCGCAACCTCAGGCT,0,503056
araBp,0.16666666666666666,5,5,GACCTCAATAACGAGGCAGG,0,523278
araBp,0.16666666666666666,5,5,GACCGGGATGCTTACGACTC,0,490840
araBp,0.16666666666666666,5,5,GACCCAGAAGGGGAAACTTT,0,503998
araBp,0.16666666666666666,5,5,GAATTCTAAGGCGATGGTCG,0,471063
araBp,0.16666666666666666,5,5,GAATCGCATGTACGGTAGCC,0,483313
araBp,0.16666666666666666,5,5,GAAGCAACTTTATACGGTGT,0,486649
araBp,0.16666666666666666,5,5,GAAGATCGCGACTCGCCAAG,0,486432
araBp,0.16666666666666666,5,5,GAACTGGCACAGCGGTTAGA,0,502043
araBp,0.16666666666666666,5,5,GAACTCAGCTTATCTTGGAT,0,479856
araBp,0.16666666666666666,5,5,GAACGTTTAGGGAGCTGCTG,0,502387
araBp,0.16666666666666666,5,5,GAACGTAGTCTACCGGTGAA,0,486116
araBp,0.16666666666666666,5,5,GAACGAATGGATTATAGTCT,0,524682
araBp,0.16666666666666666,5,5,GAACCCTCTCAGTCAGGCTC,0,479162
araBp,0.16666666666666666,5,5,GAAATTTACGCCAGCGGTGG,0,472225
araBp,0.16666666666666666,5,5,GAAAGGTACTCTTTGTTGCA,0,516676
araBp,0.16666666666666666,5,5,GAAACTATGGGGAACCTGTT,0,498519
araBp,0.16666666666666666,5,5,CTTTTGTTAGGGAGAATGAC,0,496344
araBp,0.16666666666666666,5,5,CTTTGTCTGACCACGTATAC,0,502813
araBp,0.16666666666666666,5,5,CTTGTGCCCATCGATGCGAC,0,495460
araBp,0.16666666666666666,5,5,CTTGTATAGGCTAGGAATAG,0,481810
araBp,0.16666666666666666,5,5,CTTGTACCACTACCGGCATA,0,514533
araBp,0.16666666666666666,5,5,CTTCGGGCTAGGTTATGCAA,0,498276
araBp,0.16666666666666666,5,5,CTTCGGGCAAGTTTACTTTA,0,473898
araBp,0.16666666666666666,5,5,CTTCGCGTGCACGGAACGAC,0,491899
araBp,0.16666666666666666,5,5,CTTCACGGAATCAACACTCT,0,494586
araBp,0.16666666666666666,5,5,CTTAGTGCCCTCTGATGGAG,0,489627
araBp,0.16666666666666666,5,5,CTTAGACGCCGAATTCATTT,0,473776
araBp,0.16666666666666666,5,5,CTTACTGAGCGTTAAAATGC,0,516593
araBp,0.16666666666666666,5,5,CTTAAGAGGCTATCACGTCG,0,510616
araBp,0.16666666666666666,5,5,CTTAAACTCGTATGGTCAAA,0,488166
araBp,0.16666666666666666,5,5,CTGTTGTGTAGTCCTGTGCC,0,499556
araBp,0.16666666666666666,5,5,CTGTGGTTGGAAGACGCGAG,0,495827
araBp,0.16666666666666666,5,5,CTGTGCCGTGATTTTAAAAA,0,478732
araBp,0.16666666666666666,5,5,CTGTCGGTATCTATCCGCAG,0,478301
araBp,0.16666666666666666,5,5,CTGTAGTCTCGCTCTCAAGG,0,477794
araBp,0.16666666666666666,5,5,CTGGGAAGATACAGCGGGAC,0,495068
araBp,0.16666666666666666,5,5,CTGGCTCAAGATGCTTCAAT,0,487685
araBp,0.16666666666666666,5,5,CTGGAGGAGGAATTACCAGT,0,513567
araBp,0.16666666666666666,5,5,CTGCTGCCACCCGAACGGGA,0,477289
araBp,0.16666666666666666,5,5,CTGCTCCTCGGCGACTCCAA,0,507553
araBp,0.16666666666666666,5,5,CTGCTATTGGTTGCTATGGG,0,489533
araBp,0.16666666666666666,5,5,CTGCGGTTTATGCCTACTTT,0,513843
araBp,0.16666666666666666,5,5,CTGCGGAGTTCCGCTAGAAG,0,515517
araBp,0.16666666666666666,5,5,CTGCGGAGCGTCTTAGGAGA,0,485870
araBp,0.16666666666666666,5,5,CTGCAATCTCCCACCAGCAG,0,486653
araBp,0.16666666666666666,5,5,CTGATGTGCTATTGGGAGTA,0,493056
araBp,0.16666666666666666,5,5,CTGAGCGTGGCATTTTTAAA,0,492921
araBp,0.16666666666666666,5,5,CTGAGCCAGCTTCGCTGAAT,0,518439
araBp,0.16666666666666666,5,5,CTGACGCAAGGGTAACAGGC,0,487611
araBp,0.16666666666666666,5,5,CTGAATTATCTCCCCCGACA,0,525173
araBp,0.16666666666666666,5,5,CTGAATACATCTCTGGTCTT,0,519333
araBp,0.16666666666666666,5,5,CTGAAAGTCGAAGTGCAGCC,0,507347
araBp,0.16666666666666666,5,5,CTCTTTTATTTCCGATCAGA,0,501103
araBp,0.16666666666666666,5,5,CTCTTCATGGAATTGGCGCT,0,490310
araBp,0.16666666666666666,5,5,CTCTTACCAGTAAGTCCCAC,0,490061
araBp,0.16666666666666666,5,5,CTCTCTCTAAGGCATCTTCA,0,497976
araBp,0.16666666666666666,5,5,CTCTCAGCTCTTCCCGGCCT,0,473190
araBp,0.16666666666666666,5,5,CTCTCAGACGCGATTGTTTG,0,497045
araBp,0.16666666666666666,5,5,CTCTACTATCGGATGTTGCG,0,483427
araBp,0.16666666666666666,5,5,CTCTAAGTTAGTGTTCCTCC,0,515049
araBp,0.16666666666666666,5,5,CTCGTAAGTAGCAGAGAAGA,0,518593
araBp,0.16666666666666666,5,5,CTCGGTAGCCTGAGCGTGAC,0,487671
araBp,0.16666666666666666,5,5,CTCGAGCGATCGTGGCTCCC,0,470438
araBp,0.16666666666666666,5,5,CTCCCTGTGCGAACATGCAT,0,507689
araBp,0.16666666666666666,5,5,CTCCCATTGTTGGCGGGTCC,0,509782
araBp,0.16666666666666666,5,5,CTCATTAGTCGTCCACACGT,0,495365
araBp,0.16666666666666666,5,5,CTCACTTATGGATCCTGTTG,0,512587
araBp,0.16666666666666666,5,5,CTCACGTTCAGGGTAGTGTC,0,514664
araBp,0.16666666666666666,5,5,CTCACCGGTGTGTGTTATGG,0,506808
araBp,0.16666666666666666,5,5,CTCACAGTACTGCTAACGCG,0,467979
araBp,0.16666666666666666,5,5,CTATGAGGGTCAAGATCGGG,0,514711
araBp,0.16666666666666666,5,5,CTATGAACCCATGTATAGTG,0,488096
araBp,0.16666666666666666,5,5,CTATCTACGTAAAGGGGAGT,0,500697
araBp,0.16666666666666666,5,5,CTATAGGGTGTTTAAGCGAC,0,467893
araBp,0.16666666666666666,5,5,CTATAGGGTAGGCGATCATT,0,487591
araBp,0.16666666666666666,5,5,CTAGGTAGATTAGGGGTTAT,0,517986
araBp,0.16666666666666666,5,5,CTAGCGATCGCTCTGGAAGG,0,488176
araBp,0.16666666666666666,5,5,CTAGATCGCGCAAGGACTGC,0,482360
araBp,0.16666666666666666,5,5,CTAGACTGTACGGTACGTCA,0,524420
araBp,0.16666666666666666,5,5,CTAGACATCGCCTTGTTTAC,0,507395
araBp,0.16666666666666666,5,5,CTACGCACATGGATCGAGGT,0,472291
araBp,0.16666666666666666,5,5,CTAAGCCGGCCTCCGCTGAG,0,474083
araBp,0.16666666666666666,5,5,CTAAGAAGCGGTGTCGAAGG,0,470850
araBp,0.16666666666666666,5,5,CTAACCCGAATTCACCGCTA,0,486502
araBp,0.16666666666666666,5,5,CGTTGAGATAGTGCTACGAT,0,477132
araBp,0.16666666666666666,5,5,CGTTCGTTAGGCACACGCTC,0,492866
araBp,0.16666666666666666,5,5,CGTTCACCGGGAGTAATTAC,0,510511
araBp,0.16666666666666666,5,5,CGTTAGGGCCTTATCCAGAC,0,478204
araBp,0.16666666666666666,5,5,CGTGTTTCAAGAGTTTTATC,0,484160
araBp,0.16666666666666666,5,5,CGTGTTCCGACCAGGAATAA,0,485711
araBp,0.16666666666666666,5,5,CGTGGTAGGCCGGGTGAGAT,0,497912
araBp,0.16666666666666666,5,5,CGTGCGGCAACTTTGATCAG,0,467821
araBp,0.16666666666666666,5,5,CGTGATTGTGTCACGATTGT,0,498582
araBp,0.16666666666666666,5,5,CGTGACCGGCTTAGCGACGG,0,482313
araBp,0.16666666666666666,5,5,CGTCGCTGCGCTTGTTAACC,0,517084
araBp,0.16666666666666666,5,5,CGTCGAGTGCGATCACCGTG,0,511890
araBp,0.16666666666666666,5,5,CGTCCCGCGCTAGACACCGG,0,501096
araBp,0.16666666666666666,5,5,CGTATTGCGGAGTCATATTA,0,482908
araBp,0.16666666666666666,5,5,CGTAGTGCTTTTACTCACTA,0,503359
araBp,0.16666666666666666,5,5,CGGTTTTGATAATGAGACTA,0,477354
araBp,0.16666666666666666,5,5,CGGTTTGGATTCTGCTAACT,0,487592
araBp,0.16666666666666666,5,5,CGGTTTGCCTCTCGTACGCT,0,521563
araBp,0.16666666666666666,5,5,CGGTCAGGGCGTAAAACAAA,0,501790
araBp,0.16666666666666666,5,5,CGGGTTAAGACAGGCATGAC,0,505553
araBp,0.16666666666666666,5,5,CGGGTCAGCGATTGTAGTAA,0,524627
araBp,0.16666666666666666,5,5,CGGGGCTTTCCACGAGGCAG,0,479462
araBp,0.16666666666666666,5,5,CGGGGCGCCTTAAGGGAGTA,0,483190
araBp,0.16666666666666666,5,5,CGGGGAGGCAATTTGGATCT,0,495033
araBp,0.16666666666666666,5,5,CGGCTTTCCATCCGACTGAA,0,496061
araBp,0.16666666666666666,5,5,CGGCCTTATGCATTAATCTT,0,522799
araBp,0.16666666666666666,5,5,CGGCCCGTATCGAGAGCAAG,0,487986
araBp,0.16666666666666666,5,5,CGGCCCGCTAGTAAGTGATG,0,523023
araBp,0.16666666666666666,5,5,CGGCATCACTTCGGCCGCGT,0,515743
araBp,0.16666666666666666,5,5,CGGCACGCAATTTCTAACGC,0,480096
araBp,0.16666666666666666,5,5,CGGAGTCGGGCCAGCTGTCA,0,517166
araBp,0.16666666666666666,5,5,CGGAGAGTTGGGATGGAACA,0,495777
araBp,0.16666666666666666,5,5,CGGAGAGACTGGCGCTCGAC,0,479433
araBp,0.16666666666666666,5,5,CGCTTTTCTACGTAATCTTG,0,518955
araBp,0.16666666666666666,5,5,CGCTTGGGCGATGCTATCGT,0,493327
araBp,0.16666666666666666,5,5,CGCTGGGTTCCTCTGGCTTT,0,524054
araBp,0.16666666666666666,5,5,CGCTGGGATCTCCGTTAAAC,0,470918
araBp,0.16666666666666666,5,5,CGCTGCGTCAATTACGGTTC,0,521749
araBp,0.16666666666666666,5,5,CGCTCGAGCACAGATAAGCT,0,470711
araBp,0.16666666666666666,5,5,CGCGGGGTTTCTTTCCGAGG,0,469675
araBp,0.16666666666666666,5,5,CGCCGCAGTGGTACCCAGGC,0,480298
araBp,0.16666666666666666,5,5,CGCCCAATAAGGGCCATAAT,0,519350
araBp,0.16666666666666666,5,5,CGCCAACGCCATCAGCGTTC,0,486219
araBp,0.16666666666666666,5,5,CGCATCTAGCAAGCATAACA,0,474375
araBp,0.16666666666666666,5,5,CGCATCAGCGCGATCGGGTC,0,506850
araBp,0.16666666666666666,5,5,CGCAGATGCGGCAAAGTAGG,0,503351
araBp,0.16666666666666666,5,5,CGCAAGTTATGAAATTGGAC,0,473971
araBp,0.16666666666666666,5,5,CGCAAACGGTAACTTATACT,0,507276
araBp,0.16666666666666666,5,5,CGATACTATAGGTTAAATCC,0,478968
araBp,0.16666666666666666,5,5,CGAGGGGATGGTCCCAATCA,0,504137
araBp,0.16666666666666666,5,5,CGAGCAGGTCACACAGGTTT,0,477375
araBp,0.16666666666666666,5,5,CGAGCAGCGTATAGTTCATG,0,491405
araBp,0.16666666666666666,5,5,CGAGCACACGTCGGTAGTGT,0,490337
araBp,0.16666666666666666,5,5,CGAGAGGATGGACAAGATTG,0,502397
araBp,0.16666666666666666,5,5,CGAGAAGACCATGTACACCA,0,467834
araBp,0.16666666666666666,5,5,CGACTCAGGTTACATGGCGA,0,519806
araBp,0.16666666666666666,5,5,CGACGCATATCTAGCTTACG,0,505983
araBp,0.16666666666666666,5,5,CGACCAGTGAAGCCGTGGAC,0,508029
araBp,0.16666666666666666,5,5,CGACACTCCAGTACAGGGAT,0,484544
araBp,0.16666666666666666,5,5,CGAAGTTGTTGTGACGGTAA,0,478806
araBp,0.16666666666666666,5,5,CGAACGGGGGTAATAGGAGC,0,498278
araBp,0.16666666666666666,5,5,CCTTTCGTCATAACCGAAGC,0,472520
araBp,0.16666666666666666,5,5,CCTTCGTGCACAGGGCGTCC,0,480144
araBp,0.16666666666666666,5,5,CCTTCGACCCTGAATTGCAT,0,508232
araBp,0.16666666666666666,5,5,CCTTAGGGCTTCGGGGGCTA,0,481494
araBp,0.16666666666666666,5,5,CCTTACGGTCCCGGGAGTCT,0,470014
araBp,0.16666666666666666,5,5,CCTTACACATCAATGGGGTG,0,505558
araBp,0.16666666666666666,5,5,CCTGTCAAACACAACCGGAT,0,512522
araBp,0.16666666666666666,5,5,CCTGTATCACATCGCAAATA,0,469021
araBp,0.16666666666666666,5,5,CCTGGTTCAGGGTATCAGGC,0,477114
araBp,0.16666666666666666,5,5,CCTGGGGATGAGCTGCCATA,0,519412
araBp,0.16666666666666666,5,5,CCTGGCATCATTGACCAGGC,0,524879
araBp,0.16666666666666666,5,5,CCTGCGTACGATAGTTTACC,0,502233
araBp,0.16666666666666666,5,5,CCTCATCGTCAGCCCTATGG,0,497817
araBp,0.16666666666666666,5,5,CCTACAATCGCAAGACTGGC,0,479351
araBp,0.16666666666666666,5,5,CCGTCATGCGGCACGATGGC,0,471664
araBp,0.16666666666666666,5,5,CCGTCAGTCTCGAATAATTT,0,516625
araBp,0.16666666666666666,5,5,CCGTCAGACTCCGCTGCTAT,0,500030
araBp,0.16666666666666666,5,5,CCGTATAGTTTGAGGGGGTA,0,477773
araBp,0.16666666666666666,5,5,CCGTAGCCGTCATAGGGTCG,0,521779
araBp,0.16666666666666666,5,5,CCGGTATTGCCTGGCGTATA,0,469422
araBp,0.16666666666666666,5,5,CCGGGGGGCACAGCTACCAA,0,499515
araBp,0.16666666666666666,5,5,CCGGCGCCGTATGACCATAG,0,497578
araBp,0.16666666666666666,5,5,CCGCTTCGACAGGAAAGCGG,0,469533
araBp,0.16666666666666666,5,5,CCGCGGGTCCATGGGCACTC,0,519403
araBp,0.16666666666666666,5,5,CCGCGCCTCCTATCGTTATA,0,492960
araBp,0.16666666666666666,5,5,CCGCGCAGCGGCGGGTACGG,0,498066
araBp,0.16666666666666666,5,5,CCGCCCGACACCGCCCCCCG,0,472381
araBp,0.16666666666666666,5,5,CCGCATTTCGAGTGACTACC,0,514302
araBp,0.16666666666666666,5,5,CCGCAGTAATGATATACCCT,0,475039
araBp,0.16666666666666666,5,5,CCGCAGCATTAGCCTAGGTG,0,485707
araBp,0.16666666666666666,5,5,CCGATGAGGAGACCGCCGTA,0,500325
araBp,0.16666666666666666,5,5,CCGATCTACGTACCTTCACA,0,478619
araBp,0.16666666666666666,5,5,CCGAGTAAGATAAGTGCCCT,0,500818
araBp,0.16666666666666666,5,5,CCCTTTTATCAGAAGATATT,0,482171
araBp,0.16666666666666666,5,5,CCCTTAAGTGATGTTGAGTG,0,514930
araBp,0.16666666666666666,5,5,CCCTGTATTGGTCGAGGGGC,0,479347
araBp,0.16666666666666666,5,5,CCCTCTCGGTTCTAGGCTTA,0,495696
araBp,0.16666666666666666,5,5,CCCTAGATTGGCACGCGAAG,0,479090
araBp,0.16666666666666666,5,5,CCCTAATGAGGAATGCAAAT,0,506760
araBp,0.16666666666666666,5,5,CCCGTTGGCCAATGTCTGGT,0,477039
araBp,0.16666666666666666,5,5,CCCGCTATGTACAGGGCCAC,0,474482
araBp,0.16666666666666666,5,5,CCCGCCTCCTGAGGATGCAT,0,490703
araBp,0.16666666666666666,5,5,CCCGAATTGTTTTGGCCTCA,0,492761
araBp,0.16666666666666666,5,5,CCCCTAAACAAAACCCAATG,0,513270
araBp,0.16666666666666666,5,5,CCCCGCCCCGATGTCTGAGC,0,512877
araBp,0.16666666666666666,5,5,CCCCCTTCCGAAGAGTAGTC,0,518058
araBp,0.16666666666666666,5,5,CCCATCGGCTCATGAGCACG,0,485801
araBp,0.16666666666666666,5,5,CCCATCAGACCTCTTAGCTC,0,507071
araBp,0.16666666666666666,5,5,CCCACGAGTTCATTTTACCT,0,482660
araBp,0.16666666666666666,5,5,CCATTTTTGACGTCGCTTTG,0,490206
araBp,0.16666666666666666,5,5,CCATTGACCCTGAGCGGCCA,0,514806
araBp,0.16666666666666666,5,5,CCATCAAGCTTTCATTAAGA,0,514835
araBp,0.16666666666666666,5,5,CCAGGGGTTGCGGCAACTTA,0,505698
araBp,0.16666666666666666,5,5,CCAGCCTACCGAGGACATCA,0,522279
araBp,0.16666666666666666,5,5,CCAGCAGGACTTCAAGGGAA,0,479416
araBp,0.16666666666666666,5,5,CCACGGCTAAATATTGATAA,0,468610
araBp,0.16666666666666666,5,5,CCACGCGCGACTGTCTCCAT,0,471189
araBp,0.16666666666666666,5,5,CCACCGCAATCGAACGTACC,0,503107
araBp,0.16666666666666666,5,5,CCAATGGTTTTAGAACGTCA,0,522300
araBp,0.16666666666666666,5,5,CCAAAGATGTTTGACCCTCT,0,473978
araBp,0.16666666666666666,5,5,CATTTATGGCCGCTCGAACA,0,481871
araBp,0.16666666666666666,5,5,CATTTAGTTAATGGAATGCA,0,504958
araBp,0.16666666666666666,5,5,CATTGGCCCGCTGAGTCGCC,0,474391
araBp,0.16666666666666666,5,5,CATTACTTATCGGGGGACGG,0,520857
araBp,0.16666666666666666,5,5,CATGTAGGCATAATTTCGCG,0,522392
araBp,0.16666666666666666,5,5,CATGGTATATTCGCCTGGGC,0,509210
araBp,0.16666666666666666,5,5,CATGGCTTGATTGAAGGAAA,0,481055
araBp,0.16666666666666666,5,5,CATGGCTCGTACGTAGGCTA,0,502139
araBp,0.16666666666666666,5,5,CATGCCGCTTCGGATTCGAA,0,506905
araBp,0.16666666666666666,5,5,CATGCCATACGAGACTTGTT,0,524203
araBp,0.16666666666666666,5,5,CATCCACTGATTTATGTTGC,0,519677
araBp,0.16666666666666666,5,5,CATAGTCAGGGGTATATCGG,0,487683
araBp,0.16666666666666666,5,5,CATAGGGCGTCGTTCCCTAT,0,476994
araBp,0.16666666666666666,5,5,CATAGCCCCTACATGACCTG,0,507683
araBp,0.16666666666666666,5,5,CATAGATCGCGTCATCTGTT,0,479468
araBp,0.16666666666666666,5,5,CATAGAAGGTGGCATCTAGG,0,511244
araBp,0.16666666666666666,5,5,CAGTATCATACTGTCGCACG,0,481525
araBp,0.16666666666666666,5,5,CAGTACGAACTAGAAGTTTC,0,512298
araBp,0.16666666666666666,5,5,CAGTACCTCCGGACCGTAGT,0,518156
araBp,0.16666666666666666,5,5,CAGGTTATTCCTTAAGTGTT,0,500719
araBp,0.16666666666666666,5,5,CAGGCATCGTGCCGAGTTCG,0,506637
araBp,0.16666666666666666,5,5,CAGGAGTCAATAGCGCAAGG,0,491964
araBp,0.16666666666666666,5,5,CAGGAATTGTTAGGAGATTC,0,504129
araBp,0.16666666666666666,5,5,CAGCTTCTTAGGGGTTGATA,0,482696
araBp,0.16666666666666666,5,5,CAGCTGCACTTGATTAGATA,0,513818
araBp,0.16666666666666666,5,5,CAGCTACCCCAGATCCCTTT,0,486664
araBp,0.16666666666666666,5,5,CAGCGGTCTAGGGCGTCCCT,0,513809
araBp,0.16666666666666666,5,5,CAGCGGCCCCCAATTCGACG,0,487497
araBp,0.16666666666666666,5,5,CAGCATGGGCGTGAATTAAA,0,478791
araBp,0.16666666666666666,5,5,CAGATTAATACAGAGAGAGA,0,486485
araBp,0.16666666666666666,5,5,CAGAGCTGCTCCAGAAAGTT,0,469213
araBp,0.16666666666666666,5,5,CAGAGCATTCGCCTGACGAT,0,471695
araBp,0.16666666666666666,5,5,CAGAAACTGTGTGAATGGGT,0,468795
araBp,0.16666666666666666,5,5,CACTTACCTTCGTAAACCCA,0,480864
araBp,0.16666666666666666,5,5,CACTCTACTCATAAAGTATT,0,514922
araBp,0.16666666666666666,5,5,CACTCGGCAAGGAAGTCTAT,0,471756
araBp,0.16666666666666666,5,5,CACTATCGGTGGACTAAAGA,0,522010
araBp,0.16666666666666666,5,5,CACGGATTGAATACTAAACT,0,485924
araBp,0.16666666666666666,5,5,CACGACTATATGGTAATAGT,0,487120
araBp,0.16666666666666666,5,5,CACGAAGTATAGGTGGAGCT,0,482909
araBp,0.16666666666666666,5,5,CACCGTGCCAAGCGCCTTTT,0,496940
araBp,0.16666666666666666,5,5,CACCGCATTTTTTGATTTTG,0,501015
araBp,0.16666666666666666,5,5,CACCCGGTGTCAATGAGCCT,0,491601
araBp,0.16666666666666666,5,5,CACCCATTGTCTCAGACGGC,0,495825
araBp,0.16666666666666666,5,5,CACCAGATTCGCTCAATCGG,0,492436
araBp,0.16666666666666666,5,5,CACCAAGAAGACCTCGACAT,0,514491
araBp,0.16666666666666666,5,5,CAATTAAGACGCTTATGTAC,0,513723
araBp,0.16666666666666666,5,5,CAATGATCATGCCGCACTTA,0,518061
araBp,0.16666666666666666,5,5,CAATAAAGTTGGTACTCGAG,0,498023
araBp,0.16666666666666666,5,5,CAAGCATGAAACCATGCGTA,0,509301
araBp,0.16666666666666666,5,5,CAAGCACTTTGTGTTGTCTG,0,483816
araBp,0.16666666666666666,5,5,CAACTGTTTGACAGGCGGAT,0,472421
araBp,0.16666666666666666,5,5,CAACTCTCCCGGGTGCAGAG,0,515605
araBp,0.16666666666666666,5,5,CAACAGTCCCACTCTTATCC,0,524368
araBp,0.16666666666666666,5,5,CAAATACTTTTATTGTTGGT,0,479521
araBp,0.16666666666666666,5,5,CAAAGGTAACTTGGAGATAT,0,494202
araBp,0.16666666666666666,5,5,ATTTGGCTGCGGGGAACGGA,0,525275
araBp,0.16666666666666666,5,5,ATTTGGCCCGGTGCTCGGAG,0,511338
araBp,0.16666666666666666,5,5,ATTTGCTCGGCAAGACTGGT,0,511644
araBp,0.16666666666666666,5,5,ATTTGACTCGGACTTAAACC,0,469890
araBp,0.16666666666666666,5,5,ATTTAGGCCCCGTGAGGCCC,0,490801
araBp,0.16666666666666666,5,5,ATTTACCGCGAACCTGCTTG,0,480998
araBp,0.16666666666666666,5,5,ATTTAACAGAAAGTGTAACG,0,505862
araBp,0.16666666666666666,5,5,ATTTAAACTTATACATGCCC,0,512806
araBp,0.16666666666666666,5,5,ATTTAAAATGGTACGGTGGT,0,473527
araBp,0.16666666666666666,5,5,ATTGTTTACGGTCACGTATA,0,518116
araBp,0.16666666666666666,5,5,ATTGTACTATTTCCAGGGGC,0,495851
araBp,0.16666666666666666,5,5,ATTGGTCACCTGCTGCCGAA,0,518012
araBp,0.16666666666666666,5,5,ATTGGAGTATGGGTGTGGGT,0,508195
araBp,0.16666666666666666,5,5,ATTGGAAGCTAACCGTGGTG,0,495358
araBp,0.16666666666666666,5,5,ATTGCCTTGCGTTACTGGCA,0,521901
araBp,0.16666666666666666,5,5,ATTGAGACATAAGCGTTTAA,0,513266
araBp,0.16666666666666666,5,5,ATTCTGACGACCTTGCAGAT,0,472251
araBp,0.16666666666666666,5,5,ATTCTCTAAGGTGAGTCGAT,0,517411
araBp,0.16666666666666666,5,5,ATTCTATATCCTGGAAAGGC,0,500451
araBp,0.16666666666666666,5,5,ATTCGTGGAGTTCAAACGAT,0,522494
araBp,0.16666666666666666,5,5,ATTCGGATTCGATCATCGCC,0,480857
araBp,0.16666666666666666,5,5,ATTCATGAATGGACTGCAAG,0,494158
araBp,0.16666666666666666,5,5,ATTCATATGCATGACGCTGG,0,469678
araBp,0.16666666666666666,5,5,ATTCAGCGAATATATAGAAC,0,469744
araBp,0.16666666666666666,5,5,ATTAGTCCGTGCGCATTTCG,0,502814
araBp,0.16666666666666666,5,5,ATTAGGTTACTTAGCGAGTA,0,478185
araBp,0.16666666666666666,5,5,ATTAGAGGCTGGAGCAGGGT,0,516885
araBp,0.16666666666666666,5,5,ATTACTTCCAAATTCACAAT,0,475541
araBp,0.16666666666666666,5,5,ATTACTGGTCTCCCCGAAAA,0,481165
araBp,0.16666666666666666,5,5,ATTACGCGTAACGGTGTTGC,0,477187
araBp,0.16666666666666666,5,5,ATTACGAATTCACGGCCAAG,0,504471
araBp,0.16666666666666666,5,5,ATGTTTGCCGAAGGCTTTGT,0,499391
araBp,0.16666666666666666,5,5,ATGTTTACGGCCGTAGCCGA,0,493881
araBp,0.16666666666666666,5,5,ATGTTGAGCCTTGTTCTGCA,0,467897
araBp,0.16666666666666666,5,5,ATGTGTACTAGGACAATAAG,0,510696
araBp,0.16666666666666666,5,5,ATGTGAGTGCTGTGATACCG,0,501129
araBp,0.16666666666666666,5,5,ATGTCCTATTGAGGCACAGA,0,513144
araBp,0.16666666666666666,5,5,ATGTCATCGAATGCGTCCAC,0,474459
araBp,0.16666666666666666,5,5,ATGTCAGATTATCCTTCATG,0,479400
araBp,0.16666666666666666,5,5,ATGTAATGACAGAGAGTTCC,0,486175
araBp,0.16666666666666666,5,5,ATGGGCATTCCCGGGCTGCA,0,493505
araBp,0.16666666666666666,5,5,ATGGGACCAAGGCTAAGTGA,0,498604
araBp,0.16666666666666666,5,5,ATGCTTCGTCTATCCTATTG,0,468802
araBp,0.16666666666666666,5,5,ATGCGTCAGGAACATTACGC,0,485719
araBp,0.16666666666666666,5,5,ATGCGGGGGGCACGCCGGAA,0,477094
araBp,0.16666666666666666,5,5,ATGCCATGAGCTCCAAGATC,0,504753
araBp,0.16666666666666666,5,5,ATGCATTTGAGACACGGAAT,0,517559
araBp,0.16666666666666666,5,5,ATGAGCCATTGAGAGCAGTA,0,496737
araBp,0.16666666666666666,5,5,ATGACCGGTGCCCTGCCCAG,0,495669
araBp,0.16666666666666666,5,5,ATGACCCCTCCTCTGAGTGC,0,497931
araBp,0.16666666666666666,5,5,ATGAATAAAACTTCACTGGG,0,519022
araBp,0.16666666666666666,5,5,ATCTCATCATTTCACGATGC,0,523789
araBp,0.16666666666666666,5,5,ATCTAGTCAACTTAGGTGAC,0,500272
araBp,0.16666666666666666,5,5,ATCGGGCTACTAATGAGATC,0,494693
araBp,0.16666666666666666,5,5,ATCGCGGAGTCTCTAAACAG,0,518094
araBp,0.16666666666666666,5,5,ATCGATCATTCAGGCAACAT,0,482349
araBp,0.16666666666666666,5,5,ATCCTACCGGAATTGATTTC,0,472364
araBp,0.16666666666666666,5,5,ATCCGGGTTAGTACTCACAG,0,470337
araBp,0.16666666666666666,5,5,ATCCCTTTTCGCGGCGGCCT,0,483489
araBp,0.16666666666666666,5,5,ATCATCTCTGCAATGGATGT,0,515416
araBp,0.16666666666666666,5,5,ATCACCATGGTAATGGAGGT,0,520584
araBp,0.16666666666666666,5,5,ATCAATGAATCCTTACAACC,0,487569
araBp,0.16666666666666666,5,5,ATCAATCGAGAGCAGGGCGT,0,489252
araBp,0.16666666666666666,5,5,ATCAAGGTGTCTTTGCGCGT,0,479741
araBp,0.16666666666666666,5,5,ATCAAGGCAACGCCATGGTT,0,515339
araBp,0.16666666666666666,5,5,ATATCGCGGGCGTGCATCCT,0,476010
araBp,0.16666666666666666,5,5,ATATCCCCATAAGGCAATCG,0,516742
araBp,0.16666666666666666,5,5,ATATCCAGTTTGTGCATATT,0,525353
araBp,0.16666666666666666,5,5,ATATAGCAATCGACACATAC,0,481324
araBp,0.16666666666666666,5,5,ATAGCCAGAGCAGCAGGTGG,0,518518
araBp,0.16666666666666666,5,5,ATAGCAGATGGACGTGCGTA,0,524491
araBp,0.16666666666666666,5,5,ATAGCACCCAGATGCAGTTA,0,522560
araBp,0.16666666666666666,5,5,ATACTGTGTTTGGTAATTCT,0,475304
araBp,0.16666666666666666,5,5,ATACGGTCGCTGGGACTGGT,0,503903
araBp,0.16666666666666666,5,5,ATACGCCTGACAGCGCGTAC,0,511826
araBp,0.16666666666666666,5,5,ATACATGATATCGTTATTCC,0,519318
araBp,0.16666666666666666,5,5,ATACACTGTCTTCTGTCGGG,0,517725
araBp,0.16666666666666666,5,5,ATACAAACACACGGCAGGGT,0,484968
araBp,0.16666666666666666,5,5,ATAAAGGCAAGTGTTTTGAG,0,484440
araBp,0.16666666666666666,5,5,ATAAACTGCTGAAATCGTTA,0,515436
araBp,0.16666666666666666,5,5,AGTTCCGAACAGTCATCAGA,0,487510
araBp,0.16666666666666666,5,5,AGTTATTCCCCAAACCATAA,0,524447
araBp,0.16666666666666666,5,5,AGTTATAAAAAAGTTCCCGC,0,507281
araBp,0.16666666666666666,5,5,AGTTACGCAATCATCTATAA,0,486086
araBp,0.16666666666666666,5,5,AGTTACCCCATCTCGTAGCA,0,501528
araBp,0.16666666666666666,5,5,AGTTACAGAACTTTTGTCCC,0,509150
araBp,0.16666666666666666,5,5,AGTGTCCACCATACCAAATA,0,516071
araBp,0.16666666666666666,5,5,AGTGGTTTGTCTGATAAGCA,0,519099
araBp,0.16666666666666666,5,5,AGTGCCGGGTCCACGTGACT,0,511732
araBp,0.16666666666666666,5,5,AGTCTCAGAAATTTCGGAGT,0,522828
araBp,0.16666666666666666,5,5,AGTCCCTGTACCCAGGGTAT,0,482356
araBp,0.16666666666666666,5,5,AGTCCACTCAAGGGTCCACT,0,520832
araBp,0.16666666666666666,5,5,AGTCATCCTCCACAGATGCG,0,472244
araBp,0.16666666666666666,5,5,AGTAGCTTCAACACCGTCTT,0,471284
araBp,0.16666666666666666,5,5,AGTACTTTTGACCCTATGTG,0,494283
araBp,0.16666666666666666,5,5,AGTACGCTGGCTCGCAGTAC,0,476147
araBp,0.16666666666666666,5,5,AGTAACACCAGCCGCAAGTA,0,482386
araBp,0.16666666666666666,5,5,AGGTTTAGTAGACCGGAACT,0,492918
araBp,0.16666666666666666,5,5,AGGTTGGTTTTCTCACAGAC,0,500671
araBp,0.16666666666666666,5,5,AGGTTCGGTAAGGGCACGAC,0,500327
araBp,0.16666666666666666,5,5,AGGGTTTCCCGCTATGAAGT,0,484883
araBp,0.16666666666666666,5,5,AGGGGTGGAAGCGCGGAGGC,0,482692
araBp,0.16666666666666666,5,5,AGGGGCACTGTTCGGTCCTG,0,500185
araBp,0.16666666666666666,5,5,AGGGGATGGTTCCAATGCTG,0,511909
araBp,0.16666666666666666,5,5,AGGGGAGCGCAGTGTTGCAG,0,480427
araBp,0.16666666666666666,5,5,AGGGGAATTCTCTAGCACTT,0,479308
araBp,0.16666666666666666,5,5,AGGGCCGGTAACGGGAAGTG,0,490858
araBp,0.16666666666666666,5,5,AGGGCACCCTCAACTGATAG,0,489174
araBp,0.16666666666666666,5,5,AGGGATTCAAGCGCTAAGGC,0,477843
araBp,0.16666666666666666,5,5,AGGCTTGATCGGCTCACGAT,0,479214
araBp,0.16666666666666666,5,5,AGGCTCGATCGATCCCAAGG,0,468125
araBp,0.16666666666666666,5,5,AGGCAAAGCGCTCCCTCCAT,0,480996
araBp,0.16666666666666666,5,5,AGGATTGTTTGTTCAGCCGT,0,473563
araBp,0.16666666666666666,5,5,AGGATCGGCTCCAGCTGTGC,0,474823
araBp,0.16666666666666666,5,5,AGGATCCACGGAGGTTAGCG,0,500961
araBp,0.16666666666666666,5,5,AGGACCCGCTTGGCGGCCGC,0,488728
araBp,0.16666666666666666,5,5,AGGACATGGGTCGTTGGCGG,0,469822
araBp,0.16666666666666666,5,5,AGGAAGCACGCCTTCCCTAT,0,499472
araBp,0.16666666666666666,5,5,AGGAACCATTAGATGATTCA,0,500483
araBp,0.16666666666666666,5,5,AGCTTTTTAGGGCTGTTACT,0,484162
araBp,0.16666666666666666,5,5,AGCTGGATCATGCAAAAGAA,0,498182
araBp,0.16666666666666666,5,5,AGCTGCAGCGTGTCCGGATC,0,480673
araBp,0.16666666666666666,5,5,AGCTGATTCACTTGATTAAT,0,478989
araBp,0.16666666666666666,5,5,AGCTCTTACGAGGAGTGGAA,0,503601
araBp,0.16666666666666666,5,5,AGCTCCGCTCTCTATGGCAA,0,475497
araBp,0.16666666666666666,5,5,AGCTCATCCATGACACCCCA,0,475611
araBp,0.16666666666666666,5,5,AGCTCAATCTCGAGCCGATC,0,497658
araBp,0.16666666666666666,5,5,AGCTACAGTCATTCCATGCC,0,477418
araBp,0.16666666666666666,5,5,AGCGTGTGGCGTCAGACCTC,0,513232
araBp,0.16666666666666666,5,5,AGCGTGTCGTCGGAGCCAAT,0,496242
araBp,0.16666666666666666,5,5,AGCGGGTCACGGTAAAGTTC,0,506287
araBp,0.16666666666666666,5,5,AGCGCAGAAGAGCGCTCTAG,0,494937
araBp,0.16666666666666666,5,5,AGCGAATACCGGACGTAGGC,0,496203
araBp,0.16666666666666666,5,5,AGCCTTAGGCGCTGCCAGGT,0,498097
araBp,0.16666666666666666,5,5,AGCCTCTGTCTATGGAATAT,0,521948
araBp,0.16666666666666666,5,5,AGCCCCGTCGCATCGCCGAG,0,505991
araBp,0.16666666666666666,5,5,AGCCAGACTTTAATTTACAG,0,481111
araBp,0.16666666666666666,5,5,AGCCACCAGACACTTAGTAA,0,478299
araBp,0.16666666666666666,5,5,AGCATGTAGTTAAAAGAATA,0,497485
araBp,0.16666666666666666,5,5,AGCAGGGTCGTTTCTTAATT,0,509650
araBp,0.16666666666666666,5,5,AGCACGACCCCACCTTTTCG,0,489543
araBp,0.16666666666666666,5,5,AGCACCGGTTCCTATAGTAG,0,516233
araBp,0.16666666666666666,5,5,AGCAATTCACTGGTTTAAAG,0,478494
araBp,0.16666666666666666,5,5,AGCAACTTCGGGCACAAGTG,0,510547
araBp,0.16666666666666666,5,5,AGAGGCAATGGCCGGTAATA,0,496402
araBp,0.16666666666666666,5,5,AGAGGATGGGCCAGGCCGAA,0,511641
araBp,0.16666666666666666,5,5,AGAGCGCTCACGATAGATGA,0,511360
araBp,0.16666666666666666,5,5,AGAGATAGGTGCCGAACGTC,0,494984
araBp,0.16666666666666666,5,5,AGACGGGGATTAAATTAGTG,0,513481
araBp,0.16666666666666666,5,5,AGACCGTCTTAGGTGTGGCT,0,487258
araBp,0.16666666666666666,5,5,AGACCGGTTCGTTATCGGTA,0,495019
araBp,0.16666666666666666,5,5,AGACACGCGAATAAATACGG,0,484409
araBp,0.16666666666666666,5,5,AGAATGGAGGGATATAGGGT,0,500328
araBp,0.16666666666666666,5,5,AGAAGGGGGTTAGGCGCGAC,0,516271
araBp,0.16666666666666666,5,5,AGAACGTCCATGATAGATGT,0,478648
araBp,0.16666666666666666,5,5,ACTTTCAAGGTAGCAAAGAG,0,486216
araBp,0.16666666666666666,5,5,ACTTTATTGCATGTCAAAAC,0,481245
araBp,0.16666666666666666,5,5,ACTTGTTGTTCAACCGACGA,0,474628
araBp,0.16666666666666666,5,5,ACTTCGGAGTTAGCTTGTAT,0,493639
araBp,0.16666666666666666,5,5,ACTTCCCCCTCGGCGGGAGG,0,519069
araBp,0.16666666666666666,5,5,ACTTCATGATAGTGAGCACA,0,525049
araBp,0.16666666666666666,5,5,ACTGCTATGTGCATGCAGGC,0,492897
araBp,0.16666666666666666,5,5,ACTCTGAGTTTAATTCCTAA,0,511480
araBp,0.16666666666666666,5,5,ACTCTATACGCTTGCTATGA,0,484804
araBp,0.16666666666666666,5,5,ACTCTAACACATACTCGAAG,0,481783
araBp,0.16666666666666666,5,5,ACTCGTATGACACACGTGTG,0,522360
araBp,0.16666666666666666,5,5,ACTCGGGTATCGGAGTTCTT,0,508551
araBp,0.16666666666666666,5,5,ACTATCGATGGTGTATTATC,0,497197
araBp,0.16666666666666666,5,5,ACTATAAGCGTAGCTATCCA,0,516302
araBp,0.16666666666666666,5,5,ACTACGAGCGTGCTGCCGTG,0,471099
araBp,0.16666666666666666,5,5,ACTAATCATGAGGCTCATGC,0,505314
araBp,0.16666666666666666,5,5,ACTAATAACGGGGTACTTCC,0,478340
araBp,0.16666666666666666,5,5,ACTAAGTGGTCTAATAAGCG,0,502961
araBp,0.16666666666666666,5,5,ACGTTGGATTACTGTACACA,0,496698
araBp,0.16666666666666666,5,5,ACGTTAGTCCAAGCTCCGGT,0,477382
araBp,0.16666666666666666,5,5,ACGTTAGAAACTCGCAGCGT,0,470905
araBp,0.16666666666666666,5,5,ACGTGTTGGCGATCGGCCAA,0,500449
araBp,0.16666666666666666,5,5,ACGTAGGTGCAGCGAGCTGA,0,507407
araBp,0.16666666666666666,5,5,ACGGTTCCTTTCGAACTGAT,0,472674
araBp,0.16666666666666666,5,5,ACGGTCCCGTCGGAATTACA,0,469231
araBp,0.16666666666666666,5,5,ACGGTCAGGCCAATATCGAC,0,489365
araBp,0.16666666666666666,5,5,ACGGGTTTTGGCAAGATCAC,0,470008
araBp,0.16666666666666666,5,5,ACGGCACAGTATCGAAGCGT,0,492118
araBp,0.16666666666666666,5,5,ACGCTAGCATCGCGATGGTC,0,495828
araBp,0.16666666666666666,5,5,ACGCGTGTTGAGGAGTCTCC,0,483912
araBp,0.16666666666666666,5,5,ACGCGCTATGCCTGCTTATG,0,467988
araBp,0.16666666666666666,5,5,ACGCCGTACCGGTCGTCAGT,0,468332
araBp,0.16666666666666666,5,5,ACGCAGTCTCAGCCGAATGA,0,494415
araBp,0.16666666666666666,5,5,ACGCAATAAGTTTAGAGGTA,0,477522
araBp,0.16666666666666666,5,5,ACGATACTGTGAAAGGACTA,0,506167
araBp,0.16666666666666666,5,5,ACGATACCCTGTTATTGGAA,0,517721
araBp,0.16666666666666666,5,5,ACGAGTAGGAAAATCATAAT,0,472189
araBp,0.16666666666666666,5,5,ACGAGCGCGCTGAATCGGGG,0,498749
araBp,0.16666666666666666,5,5,ACGACTGGGAGCGTACGTAA,0,483910
araBp,0.16666666666666666,5,5,ACGACTCAGCTCAAGATCCA,0,472087
araBp,0.16666666666666666,5,5,ACCTTGTATTACCTCCATTG,0,479648
araBp,0.16666666666666666,5,5,ACCTTCAACTGTGTTGGGTA,0,511035
araBp,0.16666666666666666,5,5,ACCTGTCTGGCTGAGCTTCC,0,483804
araBp,0.16666666666666666,5,5,ACCTCTCATCGACCTCCCCA,0,495452
araBp,0.16666666666666666,5,5,ACCTCGAGCTATACGTCAAA,0,498815
araBp,0.16666666666666666,5,5,ACCTATATGAGTGGGTGAGG,0,497503
araBp,0.16666666666666666,5,5,ACCTACTCGGTTAGACTGAC,0,475687
araBp,0.16666666666666666,5,5,ACCGTTGAGGTGCTTGTTAA,0,469962
araBp,0.16666666666666666,5,5,ACCGTGCGATCGGTTTCTGG,0,507057
araBp,0.16666666666666666,5,5,ACCGACGGCGGGATTCATCG,0,515811
araBp,0.16666666666666666,5,5,ACCCGGTGCCCGATGACTAC,0,471018
araBp,0.16666666666666666,5,5,ACCCACCGTACAGGTCAAAT,0,477396
araBp,0.16666666666666666,5,5,ACCCAAGCTGTCTATAGAGT,0,478517
araBp,0.16666666666666666,5,5,ACCCAAAGCGGAAGTCTCGT,0,521959
araBp,0.16666666666666666,5,5,ACCATGTGGTCCCCCCCACG,0,470751
araBp,0.16666666666666666,5,5,ACCACGGAAGTGGCGCCTAT,0,498645
araBp,0.16666666666666666,5,5,ACCAAGTCTGGGGTCTGAAG,0,519070
araBp,0.16666666666666666,5,5,ACATCTCGTGATGGTACACA,0,474138
araBp,0.16666666666666666,5,5,ACATCCGTGTGCCCCTTCAC,0,515710
araBp,0.16666666666666666,5,5,ACAGCTTTGACGTCTCCTCT,0,498801
araBp,0.16666666666666666,5,5,ACAGCCTGCGGGAGCTCCAG,0,470839
araBp,0.16666666666666666,5,5,ACAGAGAATACTATAGGTAC,0,499303
araBp,0.16666666666666666,5,5,ACACGTAAGAACTCCAGGGC,0,512827
araBp,0.16666666666666666,5,5,ACACGCGTAGGGCTCCGATT,0,503350
araBp,0.16666666666666666,5,5,ACACCTTTCGGGTGTATATT,0,514716
araBp,0.16666666666666666,5,5,ACACCGGAGCGTCCGTCGGA,0,497961
araBp,0.16666666666666666,5,5,ACACAAGTCGGCTGGAATAG,0,507107
araBp,0.16666666666666666,5,5,ACAACTTAGCCACTGGGGGA,0,495321
araBp,0.16666666666666666,5,5,ACAACTTAAAAAGCCGCTGG,0,500892
araBp,0.16666666666666666,5,5,ACAAACCGTGCCTGTCCGAG,0,500151
araBp,0.16666666666666666,5,5,AATTTAAAGTCATTCCGTCG,0,486984
araBp,0.16666666666666666,5,5,AATTGTGGGGGATACATTGG,0,501259
araBp,0.16666666666666666,5,5,AATTCTCATATTCGCGCGCT,0,489046
araBp,0.16666666666666666,5,5,AATTCGGTGGGTGTGCGTCG,0,483849
araBp,0.16666666666666666,5,5,AATTAAGTCTCGTAGACCAG,0,515847
araBp,0.16666666666666666,5,5,AATGTTACGGCGTTGAACGA,0,487812
araBp,0.16666666666666666,5,5,AATGCTCAGCAATATTGAAA,0,515174
araBp,0.16666666666666666,5,5,AATGCCGTTAACATCTTTAG,0,513168
araBp,0.16666666666666666,5,5,AATGACCTGAGATATGTTCA,0,517485
araBp,0.16666666666666666,5,5,AATGAATCTGACAACACCTA,0,500558
araBp,0.16666666666666666,5,5,AATCCACCGGCAAGCTTGGT,0,491521
araBp,0.16666666666666666,5,5,AATATCTCAAAATAAGTTAT,0,507899
araBp,0.16666666666666666,5,5,AATAGTAGTCGGGAAGCTCG,0,514746
araBp,0.16666666666666666,5,5,AATACGGTCAGGATCAGAGT,0,503735
araBp,0.16666666666666666,5,5,AATAACAGAGATTGCAATGT,0,470333
araBp,0.16666666666666666,5,5,AAGTTTGTAGAAGTGGAGAC,0,473707
araBp,0.16666666666666666,5,5,AAGTGTGAGTAGCTGATATT,0,479463
araBp,0.16666666666666666,5,5,AAGTGATGCCTTAGCCAAGC,0,506212
araBp,0.16666666666666666,5,5,AAGTGATGACCAAATGGGTT,0,492640
araBp,0.16666666666666666,5,5,AAGGTGGCTATAAGCTGAAA,0,525086
araBp,0.16666666666666666,5,5,AAGGTAAGGTTGGCGCGCAG,0,474474
araBp,0.16666666666666666,5,5,AAGGCGGTGCCATCGCTGTG,0,477453
araBp,0.16666666666666666,5,5,AAGGAGTTCGTTTCTGTCTG,0,524499
araBp,0.16666666666666666,5,5,AAGGAGCATCGTCGCAGGAT,0,516176
araBp,0.16666666666666666,5,5,AAGCTTGATGATACGTCATC,0,513230
araBp,0.16666666666666666,5,5,AAGCGGGAAGGTGATGTTAT,0,522756
araBp,0.16666666666666666,5,5,AAGCCGCATCAAATTTTTTC,0,519038
araBp,0.16666666666666666,5,5,AAGCAGTTTCTCCCGTCTGC,0,481549
araBp,0.16666666666666666,5,5,AAGATGCGCTGTGATTGGGT,0,498492
araBp,0.16666666666666666,5,5,AAGATATCGGTATGGCCCGG,0,479903
araBp,0.16666666666666666,5,5,AAGACCAGTTAGATAAATTA,0,484738
araBp,0.16666666666666666,5,5,AACTTATTGAAATCGCGCCT,0,518901
araBp,0.16666666666666666,5,5,AACTTACTGCATGGGCATTC,0,499892
araBp,0.16666666666666666,5,5,AACTTACGGGCAATGGGATG,0,524874
araBp,0.16666666666666666,5,5,AACTGTGAATCCTTAAACAG,0,498781
araBp,0.16666666666666666,5,5,AACTGAAGTGGGCGGCGCGG,0,490650
araBp,0.16666666666666666,5,5,AACTCTCATCTCGTACCTGT,0,499341
araBp,0.16666666666666666,5,5,AACTCGAAAGGACACTCCCT,0,469318
araBp,0.16666666666666666,5,5,AACTAAAGATATAGCTCTAA,0,525313
araBp,0.16666666666666666,5,5,AACGTTTTATGCAGCGGAGT,0,486709
araBp,0.16666666666666666,5,5,AACGTTCTTTCGTGATTAAT,0,507812
araBp,0.16666666666666666,5,5,AACGTGGCCCCAGGGTGCTA,0,506051
araBp,0.16666666666666666,5,5,AACGGACACATCCGTGCAGA,0,502853
araBp,0.16666666666666666,5,5,AACCGCCGCGAGCTCCATCA,0,481229
araBp,0.16666666666666666,5,5,AACCAAGGGTTATGCTTCAA,0,494426
araBp,0.16666666666666666,5,5,AACAGATTGCGTTGTGCGAC,0,483423
araBp,0.16666666666666666,5,5,AACAGAAGTACTTGCTTAGG,0,472025
araBp,0.16666666666666666,5,5,AACACGACCGTAAAATGACG,0,498710
araBp,0.16666666666666666,5,5,AACACGAAGCTTGACACGTG,0,492809
araBp,0.16666666666666666,5,5,AAATGGTCATCACTGCCGTC,0,497225
araBp,0.16666666666666666,5,5,AAAGTTCGGGGGCATACGCA,0,517133
araBp,0.16666666666666666,5,5,AAAGCTTATAAATTGTTCCA,0,513587
araBp,0.16666666666666666,5,5,AAAGCTGCTGCCCATAGCAT,0,519851
araBp,0.16666666666666666,5,5,AAACGGTTCGACTCACCCAT,0,470580
araBp,0.16666666666666666,5,5,AAACCGAGCACACTGCAGAA,0,514553
araBp,0.16666666666666666,5,5,AAACCAACGGGCTTCGCGAC,0,493721
araBp,0.16666666666666666,5,5,AAAAGTTCCCGAGCCACACT,0,491965
araBp,0.16666666666666666,5,5,AAAAGCGTATTAAAGTCATC,0,482813
araBp,0.16666666666666666,5,5,AAAACGGGAAAATTTCAATC,0,497481
araBp,0.16666666666666666,5,5,AAAACCCGCGCAGGCAAGAG,0,512905
araBp,0.2,4,4,TTTTGTGGAGTTTGAGTGTC,0,482042
araBp,0.2,4,4,TTTTGCAGTCGAAGAACTAG,0,512476
araBp,0.2,4,4,TTTTGACTTCTTCAACAATT,0,496535
araBp,0.2,4,4,TTTTCTGCTTAACAAGGGGG,0,480433
araBp,0.2,4,4,TTTTCTCCTGGGTTGGAATT,0,498575
araBp,0.2,4,4,TTTTCGGGCTGAACTGGCCT,0,482034
araBp,0.2,4,4,TTTTCATGCGCCAATCGAAT,0,472923
araBp,0.2,4,4,TTTGTGCGCTGCGTGATCAG,0,492528
araBp,0.2,4,4,TTTGGTGTGGTGCTTGTACG,0,472058
araBp,0.2,4,4,TTTGGGTGCGGAGGCGCCCC,0,473099
araBp,0.2,4,4,TTTGGGGCTAGCGTCCGTGC,0,502484
araBp,0.2,4,4,TTTGCTTTGGGCGTGGGATT,0,472089
araBp,0.2,4,4,TTTGCCCAATGTTGGTGCGC,0,475400
araBp,0.2,4,4,TTTGCAACATGCGAGTTTTT,0,505162
araBp,0.2,4,4,TTTCGTCACAATGCGACGCG,0,511183
araBp,0.2,4,4,TTTCGCTTGAAACGTAGGGT,0,483415
araBp,0.2,4,4,TTTCCGATTATCAAAAGGGT,0,510224
araBp,0.2,4,4,TTTCCGAACACGCTCCGGGT,0,498742
araBp,0.2,4,4,TTTATATGGGCGGACGACGT,0,481074
araBp,0.2,4,4,TTTATAAAATGTAACGTCTT,0,492838
araBp,0.2,4,4,TTTAGTTTCAAATAGCGGCA,0,517580
araBp,0.2,4,4,TTTAGTGACGGACCCTGGGT,0,509106
araBp,0.2,4,4,TTTAGATTACACCCGACAGT,0,475887
araBp,0.2,4,4,TTTACCGGAATCCGACCAGA,0,500994
araBp,0.2,4,4,TTGTTTGTGATTTATCTAAT,0,484399
araBp,0.2,4,4,TTGTTAGCACTTACGTTGTT,0,469845
araBp,0.2,4,4,TTGTGTTGGCCCTCCCTGCC,0,518283
araBp,0.2,4,4,TTGGTTAATCTTCACAGGAA,0,480024
araBp,0.2,4,4,TTGGTACATAGATTCACATA,0,497429
araBp,0.2,4,4,TTGGGCAGATGCCGTCCCGC,0,501564
araBp,0.2,4,4,TTGGCTAAAGATTGCAGGCT,0,492029
araBp,0.2,4,4,TTGGCACCGTAAGTCTACCT,0,473385
araBp,0.2,4,4,TTGGATGTTACGCGACGGTA,0,490888
araBp,0.2,4,4,TTGCTCCCGAAAATTTCCGT,0,468156
araBp,0.2,4,4,TTGCGGTAACGGTTCCTTCC,0,476031
araBp,0.2,4,4,TTGCCGAAGGTTTTACCCTG,0,473724
araBp,0.2,4,4,TTGCAGAGTGACCGCGAGCA,0,483495
araBp,0.2,4,4,TTGATTTCTATAGTTAACAA,0,499830
araBp,0.2,4,4,TTGATCATTTTGATATCGGA,0,474268
araBp,0.2,4,4,TTGATATGAACCCGATTGGC,0,501772
araBp,0.2,4,4,TTGAGCGTGTACAATGCGCA,0,486822
araBp,0.2,4,4,TTGACGACCCCAGTCGATCA,0,502974
araBp,0.2,4,4,TTGAATAATGTATGGTAGGT,0,483687
araBp,0.2,4,4,TTCTTCCATGACACAAATTT,0,515723
araBp,0.2,4,4,TTCTGCAATGTCACGTGCGT,0,490450
araBp,0.2,4,4,TTCTCGACGAGAAAGGCTTG,0,512412
araBp,0.2,4,4,TTCTAGGCATAAATTGAACG,0,471827
araBp,0.2,4,4,TTCGCCAGGAATTCCAGATA,0,507097
araBp,0.2,4,4,TTCGAGCGCTGAATCCCGGA,0,521558
araBp,0.2,4,4,TTCGAAATGTCAATCGGCTG,0,479867
araBp,0.2,4,4,TTCCTTCGTAGTCTCGAGGG,0,501022
araBp,0.2,4,4,TTCCGGGAAAAGAGACCCAG,0,501058
araBp,0.2,4,4,TTCCCGGGCTTTTCAGTCGG,0,501296
araBp,0.2,4,4,TTCCAAAGGATCAGTCGTCC,0,523082
araBp,0.2,4,4,TTCCAAAGCAGCAAAGCCTG,0,521096
araBp,0.2,4,4,TTCATGGGGGCAGCTGGACT,0,504701
araBp,0.2,4,4,TTCAGGTAATCCCTTTGCAG,0,511887
araBp,0.2,4,4,TTCAGCTAGTTTGCCTCTAC,0,499124
araBp,0.2,4,4,TTCACACGCGCAGCATCATC,0,503958
araBp,0.2,4,4,TTCAATTTGCAATACGCATC,0,473852
araBp,0.2,4,4,TTCAATGATCCCCTTATACC,0,517169
araBp,0.2,4,4,TTCAATCCGCGCTCGAACTA,0,520550
araBp,0.2,4,4,TTATTAGGAACGACTCAAGC,0,489111
araBp,0.2,4,4,TTATGATTGTCTGGTGTGCT,0,479904
araBp,0.2,4,4,TTATCTTGGCTATTGGGTTG,0,480716
araBp,0.2,4,4,TTATCCTATACCACGTTCCG,0,476595
araBp,0.2,4,4,TTATCATTAGACAAAGCGGT,0,516534
araBp,0.2,4,4,TTATCACTGATAAGATAGTT,0,489690
araBp,0.2,4,4,TTATAGGTCCATTAAACGGA,0,505986
araBp,0.2,4,4,TTATACCCTAGCGGTATTTT,0,468655
araBp,0.2,4,4,TTAGTGGTATACTAAAATTC,0,507693
araBp,0.2,4,4,TTAGGTCAATGTTGTGTGCC,0,501027
araBp,0.2,4,4,TTACTTGTACGCAAGAGAAC,0,469640
araBp,0.2,4,4,TTACTTCCCCCTGGCTATAT,0,520173
araBp,0.2,4,4,TTACCGTTTTGTCATAAGAA,0,468648
araBp,0.2,4,4,TTACAATTCTCGTGGGAGGT,0,499459
araBp,0.2,4,4,TTAATTCTGCCCGCACGTCC,0,523590
araBp,0.2,4,4,TTAAGGGGACGCATTCGAAT,0,488131
araBp,0.2,4,4,TTAACACCCGTGTATAAGAT,0,474117
araBp,0.2,4,4,TTAAATCCAATGGACACCAG,0,491580
araBp,0.2,4,4,TTAAACGGACAAGGCCTGTT,0,513363
araBp,0.2,4,4,TGTTTTTTACATGCCCTTCG,0,518727
araBp,0.2,4,4,TGTTGTCCTGTAATTAGGGA,0,510385
araBp,0.2,4,4,TGTTGTCCATCCTACGGCGG,0,479611
araBp,0.2,4,4,TGTTGCGGAGCTGTTTATTA,0,505445
araBp,0.2,4,4,TGTTCCACGCGGATATGCGC,0,497582
araBp,0.2,4,4,TGTTACCGCGAGAGGGCAGT,0,500107
araBp,0.2,4,4,TGTTAAGGCTACGACTTTGC,0,473761
araBp,0.2,4,4,TGTGTCGCTCGGCTTGCACC,0,500262
araBp,0.2,4,4,TGTCTCATCACCCATCCAAT,0,492272
araBp,0.2,4,4,TGTCGCAGACGGTAGGGCAG,0,473416
araBp,0.2,4,4,TGTCGATAGCGCCGGTTCAG,0,515749
araBp,0.2,4,4,TGTCCATTCGATCGACATGT,0,524109
araBp,0.2,4,4,TGTCCAGCTTGAAAGCCGAA,0,509870
araBp,0.2,4,4,TGTCACGTAATAACAGTACT,0,473730
araBp,0.2,4,4,TGTAGTTTTAGGAGCCTATA,0,491081
araBp,0.2,4,4,TGTACGCCCCTCCCAGTAGT,0,514050
araBp,0.2,4,4,TGTACAGCAATTGTCTCTAT,0,508799
araBp,0.2,4,4,TGTAAGAGCCCGAGTTTCGA,0,474186
araBp,0.2,4,4,TGGTTTTATGCACGCGCTTC,0,516806
araBp,0.2,4,4,TGGTTGGTTTAGTGTACCCC,0,473703
araBp,0.2,4,4,TGGTTGGTACCGTTTCCCCG,0,515462
araBp,0.2,4,4,TGGTTAGAGTTAGGGGCTAG,0,510155
araBp,0.2,4,4,TGGTTACGTTGAGCAATTGT,0,487759
araBp,0.2,4,4,TGGTCCCAGGATCAGGGTTC,0,522240
araBp,0.2,4,4,TGGTCACTCAGCTTGCAGCG,0,475419
araBp,0.2,4,4,TGGTAGCTTGCGTCTGTTTT,0,498019
araBp,0.2,4,4,TGGGTCCAAACGCATGGCTA,0,482284
araBp,0.2,4,4,TGGGTAGGGAGCTGGCATGC,0,494926
araBp,0.2,4,4,TGGGGTATTCGGTTCTCCCA,0,502571
araBp,0.2,4,4,TGGGGGGAAGTTAAACGGCT,0,517066
araBp,0.2,4,4,TGGGCATTCGAGACAACCCG,0,518160
araBp,0.2,4,4,TGGGCACCCAAACTCGCTCC,0,490696
araBp,0.2,4,4,TGGGATCCAAGGGCTGCTAT,0,488545
araBp,0.2,4,4,TGGCTCAGAGGGGCATCAAC,0,482347
araBp,0.2,4,4,TGGCACCCACAGGTGAATCA,0,511169
araBp,0.2,4,4,TGGCAAACCGCTCTCTCCAC,0,522752
araBp,0.2,4,4,TGGATGGGATCAGGCGCAGT,0,478735
araBp,0.2,4,4,TGGATCGGCCCCGTGCGAGT,0,469209
araBp,0.2,4,4,TGGAGACCTGCTAAACTCGC,0,470603
araBp,0.2,4,4,TGGAATTTATCTTGCAGTTG,0,517987
araBp,0.2,4,4,TGGAAGTGCGGGCATCTTCA,0,505812
araBp,0.2,4,4,TGGAACAGTATTCCGCCCAC,0,503594
araBp,0.2,4,4,TGCTCTACTTTGGCGGTAGA,0,497938
araBp,0.2,4,4,TGCTCCGTTTCGAAGCGGTT,0,485250
araBp,0.2,4,4,TGCTCCAAGATCACGGCGGT,0,522933
araBp,0.2,4,4,TGCGTTAAGTCTGATCTAGT,0,473535
araBp,0.2,4,4,TGCGGTGTATTCAAACTTAC,0,518765
araBp,0.2,4,4,TGCGGCCCGGACTACGTAAT,0,518579
araBp,0.2,4,4,TGCGATTTCACGTGCGAATA,0,524816
araBp,0.2,4,4,TGCGATTCCCGGCTTATCGG,0,511699
araBp,0.2,4,4,TGCCTGCCAGTGGCCAACTA,0,477015
araBp,0.2,4,4,TGCCTCGAGCTCCAGTCCCT,0,473850
araBp,0.2,4,4,TGCCGTGCAGGGCCTCTGGA,0,468108
araBp,0.2,4,4,TGCCCAGATCAGTTGGACAG,0,482793
araBp,0.2,4,4,TGCATTGGGACGGTTATGGC,0,518694
araBp,0.2,4,4,TGCATCATCATTTCGTTGGC,0,473011
araBp,0.2,4,4,TGCAGTGATGTACAGAAATC,0,494476
araBp,0.2,4,4,TGCACTGGTCAACGTTTACA,0,493203
araBp,0.2,4,4,TGCAAGAGCCGTGTAAAGCG,0,470701
araBp,0.2,4,4,TGCAACGCCACGCCACGCGG,0,485858
araBp,0.2,4,4,TGCAACAGACGGTAGTCGGA,0,496879
araBp,0.2,4,4,TGATTAAGGAAATAATCTTC,0,470541
araBp,0.2,4,4,TGATGCTAATCCTATGAGGG,0,499930
araBp,0.2,4,4,TGATAACTGATATTAATCTT,0,504881
araBp,0.2,4,4,TGATAAAGTCAATCTAGCAG,0,485722
araBp,0.2,4,4,TGAGTGAGCTTAGTGCGCAG,0,503624
araBp,0.2,4,4,TGAGTAGTTACATCGTCGGG,0,477440
araBp,0.2,4,4,TGAGTACCCGGCATCTGGCT,0,485103
araBp,0.2,4,4,TGAGCGTCCGACATGAGCAG,0,520776
araBp,0.2,4,4,TGAGCGGGATTACCTAGGGT,0,501093
araBp,0.2,4,4,TGAGCGAACGAGATAACGTT,0,497085
araBp,0.2,4,4,TGAGCAATTCCTCCTAATAA,0,509696
araBp,0.2,4,4,TGACGTCGTTTGCAAACGCA,0,491153
araBp,0.2,4,4,TGACGGCCCGGTTAAGTTAA,0,486614
araBp,0.2,4,4,TGACCCCTATAATTCGCCAA,0,512695
araBp,0.2,4,4,TGACACGTTTGATCTGGTTG,0,493069
araBp,0.2,4,4,TGAATGGGCAACATGTAATT,0,504476
araBp,0.2,4,4,TGAAGGAAAGCCGTGCAATG,0,512636
araBp,0.2,4,4,TGAAGCGAACAAAAGGTGCT,0,471899
araBp,0.2,4,4,TGAACGGAGGGTCCATGGCG,0,512991
araBp,0.2,4,4,TGAAAGCTGCGACATGCCAT,0,498221
araBp,0.2,4,4,TGAAACAGTTCGCGTTCAAG,0,519856
araBp,0.2,4,4,TGAAAAATCTCAGGTCACCT,0,476289
araBp,0.2,4,4,TCTTTTGCTAAGGGTCCACA,0,503729
araBp,0.2,4,4,TCTTTTCCCGTACCAGAGTA,0,490772
araBp,0.2,4,4,TCTTTGGATTATAAACTCGC,0,512692
araBp,0.2,4,4,TCTTCTGACTTCAATCAGCT,0,487306
araBp,0.2,4,4,TCTTATAAGCCGATTGCGAA,0,486341
araBp,0.2,4,4,TCTGGCCACTCTGCAGACTC,0,504366
araBp,0.2,4,4,TCTGCTCTTGGCAACACAGG,0,518436
araBp,0.2,4,4,TCTCCAGGTACTTTCACCCC,0,519082
araBp,0.2,4,4,TCTACGGAAGCACCTCTAGA,0,485986
araBp,0.2,4,4,TCTAAAGTTAAAATCATGAG,0,484800
araBp,0.2,4,4,TCGTGTAAGCGCAGTAAAAT,0,490822
araBp,0.2,4,4,TCGTGCTTGAACCTGTCAGC,0,470060
araBp,0.2,4,4,TCGTGAGAATGCACATAATT,0,495446
araBp,0.2,4,4,TCGTGACACTCGCCTGAGAT,0,499467
araBp,0.2,4,4,TCGTCAGCATCGCTGCTAGT,0,522925
araBp,0.2,4,4,TCGGTTCGCGTGAAAGCTTT,0,484805
araBp,0.2,4,4,TCGGACTCCCCTCCATTCCG,0,503045
araBp,0.2,4,4,TCGCGGACGGGTGTTTATAT,0,476837
araBp,0.2,4,4,TCGCGCCCTGTAACTACGCA,0,477514
araBp,0.2,4,4,TCGCGAGTTGGTCAACTCGG,0,477715
araBp,0.2,4,4,TCGCGAAGGACTTTCCCGAT,0,482416
araBp,0.2,4,4,TCGCCGGGCCACCCTCTGCT,0,495076
araBp,0.2,4,4,TCGCACCACTTAGAGAGGCT,0,510279
araBp,0.2,4,4,TCCTGGCCCGGTCTCTTCCT,0,471106
araBp,0.2,4,4,TCCTGAGCCGCTCAGGTGAG,0,491313
araBp,0.2,4,4,TCCTCACTGGATCGCCGATA,0,505461
araBp,0.2,4,4,TCCTAACGGTTACTCGTGTG,0,508124
araBp,0.2,4,4,TCCGTGGACTATGGCACCGC,0,501473
araBp,0.2,4,4,TCCCGCGCGTGGAGAACGCA,0,508602
araBp,0.2,4,4,TCCCGAGTCTCAACGTGGAC,0,517673
araBp,0.2,4,4,TCCCCTGGAAATTATAGCTC,0,510867
araBp,0.2,4,4,TCCCCGGCGATTATCGGACT,0,513844
araBp,0.2,4,4,TCCACTTTATCGCAAGGGAC,0,483196
araBp,0.2,4,4,TCATGTTGCAGAGAGAAAGG,0,476204
araBp,0.2,4,4,TCATGCGTATTCATCGTTAC,0,513323
araBp,0.2,4,4,TCATGCGATATTTCAGTGTA,0,524383
araBp,0.2,4,4,TCATGATCGAGAGGTTTAAT,0,524671
araBp,0.2,4,4,TCAGTTCGGGATCCACCAGG,0,523009
araBp,0.2,4,4,TCAGATAATATCTGAGGCGA,0,503815
araBp,0.2,4,4,TCAGACCCGATCGTGAATTA,0,475582
araBp,0.2,4,4,TCACATTGTACGTATCCAAA,0,481374
araBp,0.2,4,4,TCACAACGCTAGATGCACCA,0,508793
araBp,0.2,4,4,TCAATCCCTCTGCGTGAGTT,0,473540
araBp,0.2,4,4,TCAATATGCTCACTGCGATA,0,486173
araBp,0.2,4,4,TCAAGTCGCTGTCATCTTAA,0,494007
araBp,0.2,4,4,TCAAGTACCATCCTAAGTTA,0,482522
araBp,0.2,4,4,TCAAGGATGGAGTTCGGGCT,0,500400
araBp,0.2,4,4,TCAAATTGGATTTGCTAGTG,0,505011
araBp,0.2,4,4,TCAAATCACCCGCCGTCGCG,0,505650
araBp,0.2,4,4,TCAAAGTAGCTCGGATATCC,0,504015
araBp,0.2,4,4,TCAAACTGCTCCGTCCAAGA,0,520185
araBp,0.2,4,4,TATTTGCGGGCTAACAACCA,0,524820
araBp,0.2,4,4,TATTTCCTGTTTCTAACCGT,0,520962
araBp,0.2,4,4,TATTATGTCATTCGCGTCAG,0,478155
araBp,0.2,4,4,TATGTCCACTGCTACGGTTT,0,470746
araBp,0.2,4,4,TATGTACAGCAGCAACTATA,0,517499
araBp,0.2,4,4,TATGCCGGAATCAAGCACTC,0,473428
araBp,0.2,4,4,TATGCAACCTGGCCGATAGC,0,500942
araBp,0.2,4,4,TATCTCTTAGTACTTCCTGG,0,511608
araBp,0.2,4,4,TATCCGGCCGGACATAGCCA,0,486894
araBp,0.2,4,4,TATCAGCCCGTCTTCGTCCT,0,522449
araBp,0.2,4,4,TATATTTCCGCGTACCCAGG,0,500263
araBp,0.2,4,4,TATATGGTAGTCGTCCCCAT,0,517212
araBp,0.2,4,4,TATACTTCTGTTCTCGTCCG,0,502312
araBp,0.2,4,4,TATACGGATGGTAGGCCCTA,0,519564
araBp,0.2,4,4,TATACACCTATTCGCCGTGT,0,510311
araBp,0.2,4,4,TATAACTTTGTACGGAATTC,0,491200
araBp,0.2,4,4,TATAAAAGGGTCTCCTTCTC,0,497672
araBp,0.2,4,4,TATAAAAAAGCGACCCAAAA,0,478509
araBp,0.2,4,4,TAGGTGAAGGCATGCCATGG,0,492704
araBp,0.2,4,4,TAGGTCGTCTTACCGTGCGT,0,481359
araBp,0.2,4,4,TAGGCTCCAAACTGAAGGTT,0,504528
araBp,0.2,4,4,TAGGCGACGGCTACAGACAT,0,519809
araBp,0.2,4,4,TAGGAGGGGAGGCCCGCTGC,0,509228
araBp,0.2,4,4,TAGCTTTAGGCGCGACATCA,0,518586
araBp,0.2,4,4,TAGCCTATTCGCATAGTATC,0,514999
araBp,0.2,4,4,TAGCCGTTCGCACGAACCAA,0,490649
araBp,0.2,4,4,TAGCACAGAGGTATCAGGGA,0,502868
araBp,0.2,4,4,TAGATGTATACTAGACACTT,0,471180
araBp,0.2,4,4,TAGATAGACCAGACACCATC,0,487666
araBp,0.2,4,4,TAGACCAAGATGATCCTCAT,0,517477
araBp,0.2,4,4,TACTTATAGCGTCACAATTG,0,494811
araBp,0.2,4,4,TACTGACAGGCGAAGCCAAA,0,492270
araBp,0.2,4,4,TACTATCTCAATTGCACGGA,0,518854
araBp,0.2,4,4,TACTAGAGTCGGACTGATGT,0,468260
araBp,0.2,4,4,TACTACTCTTTGGGACCCGC,0,516980
araBp,0.2,4,4,TACGGGTTTGTCGCCTACCG,0,487929
araBp,0.2,4,4,TACGCGGTGCTCTGGCGTGT,0,498162
araBp,0.2,4,4,TACGCCTCCGCCCAGAGGAA,0,476461
araBp,0.2,4,4,TACCCGTATTTCTTTTTGTG,0,513510
araBp,0.2,4,4,TACCAGTGATACCAAGGCCT,0,508052
araBp,0.2,4,4,TACCACGGAGGCCAGGCGAC,0,474159
araBp,0.2,4,4,TACCACCCAAGCACGCGGGT,0,487350
araBp,0.2,4,4,TACCAACCGGCGGAAAGGCA,0,517923
araBp,0.2,4,4,TACATCCAATAGGAGAATGC,0,505233
araBp,0.2,4,4,TACAGCGGGAGTAATATCCA,0,484490
araBp,0.2,4,4,TACACGAAGAAATGAGTCTT,0,515702
araBp,0.2,4,4,TAATTAAGATCATCCAACGT,0,498590
araBp,0.2,4,4,TAATGACTCCCTCAAGCCGT,0,513788
araBp,0.2,4,4,TAATCTGTCGGGGGTGCGTA,0,507680
araBp,0.2,4,4,TAATATTTGCAAGTTCCACC,0,469966
araBp,0.2,4,4,TAATACTCTTACTATCTGGC,0,493497
araBp,0.2,4,4,TAACTTTCCTTGGGGAGGTC,0,498593
araBp,0.2,4,4,TAACGGCCCTATCGGGCGCC,0,505419
araBp,0.2,4,4,TAACAATGGCGCGTTATAAC,0,521740
araBp,0.2,4,4,TAACAAATGCGTAATGGATC,0,502150
araBp,0.2,4,4,TAAAGTAGATAGCACAGCAT,0,504819
araBp,0.2,4,4,TAAAGCTTATTCACTAAATA,0,469826
araBp,0.2,4,4,TAAAGCTTAGTGAGAATTGT,0,468556
araBp,0.2,4,4,TAAACCTCACCCAATTATAT,0,503358
araBp,0.2,4,4,TAAAATCCAATGTCTTCTCC,0,504796
araBp,0.2,4,4,TAAAAAAGGACATGAACCTC,0,504556
araBp,0.2,4,4,GTTTGCGGCCTACGCAGTTC,0,487629
araBp,0.2,4,4,GTTTGAGAATCTGGCAATCC,0,517634
araBp,0.2,4,4,GTTTCGATCATAAGCGCGGA,0,470309
araBp,0.2,4,4,GTTTCCGACGGACCTTAACT,0,494846
araBp,0.2,4,4,GTTTCAATATGTATAGACGT,0,510258
araBp,0.2,4,4,GTTTATTTTTAGTCCGGCGT,0,508952
araBp,0.2,4,4,GTTGTATAATCAAGTAGGAA,0,500611
araBp,0.2,4,4,GTTGGCCGGAGCGCTCGATC,0,524194
araBp,0.2,4,4,GTTGCTGAGGGTATGGTTCG,0,503901
araBp,0.2,4,4,GTTGCGATTCCAAGCGAACG,0,517638
araBp,0.2,4,4,GTTGACAACTTCCCGGTGTG,0,480023
araBp,0.2,4,4,GTTCTTACGCCAACCCAGGA,0,467918
araBp,0.2,4,4,GTTCCCTTCACTGAAATTCT,0,501486
araBp,0.2,4,4,GTTCATGGCGGGAAGCCTAG,0,485551
araBp,0.2,4,4,GTTATTCGAAGCATGTACCC,0,495164
araBp,0.2,4,4,GTTATGGTTATCCTCATGAC,0,498659
araBp,0.2,4,4,GTTAGAATGCGATCTGAAGC,0,511793
araBp,0.2,4,4,GTTACGGCAAACCCAACTTT,0,504953
araBp,0.2,4,4,GTTACCCATCGTGCATGTTG,0,518535
araBp,0.2,4,4,GTTAACTTTAGCTCGTGGTA,0,476869
araBp,0.2,4,4,GTGTTTCCTTTTTCACCCAC,0,484770
araBp,0.2,4,4,GTGTATGTCAGCGGTAGGGA,0,491452
araBp,0.2,4,4,GTGTATCCAAAAGTTGGTCA,0,494892
araBp,0.2,4,4,GTGTATAGCGAGGTGTCAGA,0,467783
araBp,0.2,4,4,GTGTAGAGGAATGCATACAG,0,494553
araBp,0.2,4,4,GTGTACCTCAGACAAGGGAA,0,498864
araBp,0.2,4,4,GTGGTGTCTATAGCGCAAGC,0,518049
araBp,0.2,4,4,GTGGTAACGGTTTTTTAACA,0,509775
araBp,0.2,4,4,GTGGGTAAAGTGGAAAAGTC,0,499958
araBp,0.2,4,4,GTGGGCCGCATCGTAGGTAA,0,524580
araBp,0.2,4,4,GTGGCATAGGATAGCTACTC,0,520581
araBp,0.2,4,4,GTGGCACCGCTCACAGCGTA,0,470688
araBp,0.2,4,4,GTGGATCAGTGTCTTAGATT,0,482591
araBp,0.2,4,4,GTGCGCGCTCCATGACACCG,0,501467
araBp,0.2,4,4,GTGCATAGCGTTAAGTACGG,0,474852
araBp,0.2,4,4,GTGCAGGAATAGCCGTCTCA,0,515528
araBp,0.2,4,4,GTGATTTCCCAGCTATAAGT,0,491116
araBp,0.2,4,4,GTGATGCGTCAAACAAGAGG,0,482004
araBp,0.2,4,4,GTGATAACAAGCGTAAGACA,0,521992
araBp,0.2,4,4,GTGAGTAGACTGTTCGCGGT,0,471452
araBp,0.2,4,4,GTGACTCGGTCTTCCCTAGG,0,512048
araBp,0.2,4,4,GTGAAACAGGCCTTACTCCT,0,475083
araBp,0.2,4,4,GTGAAAACGTCAGGAATCTT,0,503848
araBp,0.2,4,4,GTCTAGACGCCGCATAGCCC,0,521766
araBp,0.2,4,4,GTCGTCAGTTTCTGCAAATT,0,514397
araBp,0.2,4,4,GTCGGGGGGCGCTTGTATCT,0,474245
araBp,0.2,4,4,GTCGGAAATGTATTTGTGTC,0,472670
araBp,0.2,4,4,GTCGAGTCGGGGACCCAGCC,0,473371
araBp,0.2,4,4,GTCCCCATCAAACTCATGGT,0,476561
araBp,0.2,4,4,GTCCAGCCGTATGATCATCC,0,516146
araBp,0.2,4,4,GTCAGCGCCGACAAGAATCA,0,513052
araBp,0.2,4,4,GTCAAGGATCCTAACGAAGG,0,501471
araBp,0.2,4,4,GTATTTTAGTATAAAGTGGA,0,467877
araBp,0.2,4,4,GTATTAAGACATATCCGAGT,0,523501
araBp,0.2,4,4,GTATGTATGTGTGAATCCTG,0,509866
araBp,0.2,4,4,GTATCGGCTTTTAGCCAGTG,0,485589
araBp,0.2,4,4,GTATAGGTGCACGAGGGATT,0,505925
araBp,0.2,4,4,GTAGTAAGGCTTGTCACAGT,0,474756
araBp,0.2,4,4,GTAGGGCCGATGCGAAACGG,0,500188
araBp,0.2,4,4,GTAGCTTTGGCGCTATCTGT,0,496398
araBp,0.2,4,4,GTAGCGGTCACCACTAGCGA,0,509075
araBp,0.2,4,4,GTAGCCACAGCTATAAGAGG,0,477234
araBp,0.2,4,4,GTAGATTCCTTACCATAGAA,0,504128
araBp,0.2,4,4,GTACTTACTGAACAAGGTGA,0,484205
araBp,0.2,4,4,GTACGCCATTTGAGGTGGGC,0,503165
araBp,0.2,4,4,GTACCTCCTAGCTAGCGCTC,0,519332
araBp,0.2,4,4,GTACCGCGGGGGCTAGCGGA,0,498942
araBp,0.2,4,4,GTACCCCGGTCGTTTGGAGT,0,494144
araBp,0.2,4,4,GTACAGAGAAGCGGCTTCGC,0,514364
araBp,0.2,4,4,GTAATGGGTCATCCGAGTTA,0,490519
araBp,0.2,4,4,GTAACAAATTATGCTTTGTT,0,510523
araBp,0.2,4,4,GTAAAGGACGGAACAGCGTT,0,477496
araBp,0.2,4,4,GTAAAAGGAGTGCGTCCCCC,0,469166
araBp,0.2,4,4,GGTTTTTGGCCTGATACAAA,0,520013
araBp,0.2,4,4,GGTTTATGGCAGAGTCGAGG,0,495354
araBp,0.2,4,4,GGTTCGGTGCCTCCCAGGTG,0,507907
araBp,0.2,4,4,GGTTCCCCCATACGCGTGCG,0,502258
araBp,0.2,4,4,GGTTCCACTAGGCCACCCGT,0,469581
araBp,0.2,4,4,GGTGTGCAGATAACTCAAGC,0,506223
araBp,0.2,4,4,GGTGTCGGGCTTGCTGCCTA,0,507612
araBp,0.2,4,4,GGTGTAATTGAACTCGCCGA,0,512206
araBp,0.2,4,4,GGTGCACGGGATATATTGTT,0,497164
araBp,0.2,4,4,GGTCTAGGTTAATCGGATCT,0,524032
araBp,0.2,4,4,GGTCTAACCGCGTGATAATT,0,493048
araBp,0.2,4,4,GGTCCGGTCTCGATTTCACA,0,489301
araBp,0.2,4,4,GGTCCCCCGGTGCTTGGGTT,0,506594
araBp,0.2,4,4,GGTCCCACGTACGACAACGC,0,468916
araBp,0.2,4,4,GGTCAGTCTCTCTGGGGTCA,0,487860
araBp,0.2,4,4,GGTCACGCAATCCACGCTAC,0,468604
araBp,0.2,4,4,GGTCACAGTTATTCTAGAGA,0,498853
araBp,0.2,4,4,GGTCAAGTCCTCTAAATGTA,0,467832
araBp,0.2,4,4,GGTATTACATAGAGGCTCGG,0,487568
araBp,0.2,4,4,GGTAGTTTGACGATTCTACA,0,492397
araBp,0.2,4,4,GGTAGGCGGCTCAGGCATCC,0,514102
araBp,0.2,4,4,GGTAGCATCGAGTACGAAGG,0,491178
araBp,0.2,4,4,GGTAAGGTACATCCACGCGC,0,498267
araBp,0.2,4,4,GGGTGTCTTCAAGTATTCAT,0,498886
araBp,0.2,4,4,GGGTGTAAACAGGTTCCGAT,0,506572
araBp,0.2,4,4,GGGTGACCTCTGCGTGAACG,0,520142
araBp,0.2,4,4,GGGTCTATCGGGTACTAGCT,0,518499
araBp,0.2,4,4,GGGTCCAACGCGATTGTGGT,0,511966
araBp,0.2,4,4,GGGTATTTCGCCATAAGTTT,0,525162
araBp,0.2,4,4,GGGTAAATCTAGATTGCATT,0,513095
araBp,0.2,4,4,GGGGTTTGCTTAATAGGGGC,0,474427
araBp,0.2,4,4,GGGGTTTCTACTTTATTCTA,0,474815
araBp,0.2,4,4,GGGGGGTCTTAGGCGTTGGC,0,476286
araBp,0.2,4,4,GGGGGATCCAGACGCCGGCA,0,493586
araBp,0.2,4,4,GGGGCGTAATCAGCTCGTGG,0,479494
araBp,0.2,4,4,GGGGCGCGCACATGGAATGT,0,480633
araBp,0.2,4,4,GGGGCCAGCAAGGGGTCTTA,0,474376
araBp,0.2,4,4,GGGCGTTGCCCGGGACTTCT,0,512286
araBp,0.2,4,4,GGGCGTAAGCCTCGAAGGTT,0,478305
araBp,0.2,4,4,GGGCGCACGACATTCGGGGG,0,481789
araBp,0.2,4,4,GGGCGATGCCCCGAGAGCCG,0,518571
araBp,0.2,4,4,GGGCGAACATTCTTACTTAG,0,468739
araBp,0.2,4,4,GGGCAGGGGGACCGGTGGCT,0,481680
araBp,0.2,4,4,GGGATCGGGACTTCGGGTTT,0,489926
araBp,0.2,4,4,GGGATCCTGCTACCCCTGCA,0,495799
araBp,0.2,4,4,GGGATAGCGGTATTATAGGG,0,522193
araBp,0.2,4,4,GGGAGCTGAGGGAATAATAA,0,523565
araBp,0.2,4,4,GGGACATCGGGGAGGTGAAG,0,518435
araBp,0.2,4,4,GGCTTTCAGTAGTACTCATT,0,472744
araBp,0.2,4,4,GGCTTGCAGAGCATCTCTGC,0,498435
araBp,0.2,4,4,GGCTTCAGATCCGGTTGCAA,0,513523
araBp,0.2,4,4,GGCTCCGATGTAGAGGCCTG,0,475139
araBp,0.2,4,4,GGCGTTGTTTCGGAGAACGT,0,506024
araBp,0.2,4,4,GGCCTCACTACCTGTCTTCC,0,510866
araBp,0.2,4,4,GGCCGCGTGACAGCAGAGGT,0,486714
araBp,0.2,4,4,GGCCGCGGAAACTTACAGTC,0,504589
araBp,0.2,4,4,GGCCGAAATCATGTCAGGCA,0,497460
araBp,0.2,4,4,GGCCCCGCTGCTCATATAGC,0,492448
araBp,0.2,4,4,GGCCCATGACCCGTACTTCT,0,493003
araBp,0.2,4,4,GGCCACATGCAGATAGAAAT,0,514795
araBp,0.2,4,4,GGCCACAATTTTATTATTTT,0,510222
araBp,0.2,4,4,GGCCAATAGCCTACGCAGAT,0,484199
araBp,0.2,4,4,GGCCAACTGCCCTGAAATCT,0,478161
araBp,0.2,4,4,GGCATTTAAAGTATAAGCTA,0,503870
araBp,0.2,4,4,GGCATGCAGCACAGATCCTG,0,488283
araBp,0.2,4,4,GGCAGGTCAGTCCAATACGG,0,489619
araBp,0.2,4,4,GGCACCTACGAGTGTTCTTG,0,513297
araBp,0.2,4,4,GGCAATCGAGCTCGGGGTAC,0,498153
araBp,0.2,4,4,GGATTGTGACGGCTTTGTCA,0,474944
araBp,0.2,4,4,GGATGGATCAGTGCCGAGGT,0,516873
araBp,0.2,4,4,GGATCATATCAGTGCACTAT,0,472829
araBp,0.2,4,4,GGATAGGCAGTCGGCTAAGG,0,509270
araBp,0.2,4,4,GGAGTTGGGGGTCAAGAGAT,0,483453
araBp,0.2,4,4,GGAGTGCCGCGAAAAAACGC,0,493945
araBp,0.2,4,4,GGAGTGACCGTTCACTCACC,0,523955
araBp,0.2,4,4,GGAGTCCGAGGATTCAAGAC,0,506764
araBp,0.2,4,4,GGAGGACGGGAGTAACCCAA,0,485413
araBp,0.2,4,4,GGAGCGGAATTCTTCAAAGA,0,477622
araBp,0.2,4,4,GGAGACCGCCAATTCCTCGA,0,511274
araBp,0.2,4,4,GGACTCCATGGCAACCGCAT,0,482421
araBp,0.2,4,4,GGACGTTTAAACTTATCCTT,0,517599
araBp,0.2,4,4,GGACCGCATACAGTAGTATC,0,515890
araBp,0.2,4,4,GGACAGAAGTGTCGTACATT,0,496912
araBp,0.2,4,4,GGAAGTCAGTGCGGCAAAGT,0,517438
araBp,0.2,4,4,GGAACGGACCTCGTTTTACG,0,470873
araBp,0.2,4,4,GCTTCTTTCTCACATACTTA,0,506169
araBp,0.2,4,4,GCTTCGAAACCCATGTAAGG,0,483923
araBp,0.2,4,4,GCTGCACATAGCCCTCTAGG,0,471409
araBp,0.2,4,4,GCTCTGTTCACGTAGTGGTA,0,495201
araBp,0.2,4,4,GCTCCGGGTAGCATACTGGT,0,502628
araBp,0.2,4,4,GCTAGTTCTATACATCCACA,0,493292
araBp,0.2,4,4,GCTAGTCGCTGGCCGACAGC,0,469831
araBp,0.2,4,4,GCTAGGGGAGCACACTAATA,0,495738
araBp,0.2,4,4,GCTAGAATCTACAGCTATAC,0,496288
araBp,0.2,4,4,GCGTGCCGAGGGGAAGGCAG,0,469699
araBp,0.2,4,4,GCGTCTGGGAATCGAATTTA,0,478862
araBp,0.2,4,4,GCGTCAGAGTCACTATGCCT,0,470710
araBp,0.2,4,4,GCGGGTGGCTATAGCGGCTG,0,507316
araBp,0.2,4,4,GCGGGGAGGTCGCCGGTATA,0,475311
araBp,0.2,4,4,GCGGCTTTCCAAGATAACCA,0,492978
araBp,0.2,4,4,GCGGCCCACTAAAGCCAGGA,0,494431
araBp,0.2,4,4,GCGCGTGTTCTTTCATTGAC,0,517153
araBp,0.2,4,4,GCGCGGCAATAAGCTTTGGT,0,475975
araBp,0.2,4,4,GCGCGAGGAAGACGTCCACG,0,510111
araBp,0.2,4,4,GCGCCTGGGTTACCTCCCGA,0,478355
araBp,0.2,4,4,GCGCACGACTTGTGAACGGT,0,494843
araBp,0.2,4,4,GCGCAATCGGAGCCTTACCA,0,474830
araBp,0.2,4,4,GCGATTTCGCGATAATAACA,0,494969
araBp,0.2,4,4,GCGATTCTGGCTAGGAATCA,0,471791
araBp,0.2,4,4,GCGATAGTCCAGATGCTAGA,0,497722
araBp,0.2,4,4,GCGAGGAAGCCTATTGGACC,0,480693
araBp,0.2,4,4,GCGAAGACTCATGAAACAGC,0,497344
araBp,0.2,4,4,GCGAACCTTGACTGCCAATT,0,488267
araBp,0.2,4,4,GCCTGATCTGTGACGCTCTT,0,492729
araBp,0.2,4,4,GCCTCTGGAAGCGACTAGGG,0,492179
araBp,0.2,4,4,GCCTATTCGCCATGTAGGTC,0,476320
araBp,0.2,4,4,GCCGTGTGTATGGAGTTATG,0,476715
araBp,0.2,4,4,GCCGTGCCGCGAACCCCGGG,0,493308
araBp,0.2,4,4,GCCGGCGCAATTAATCTTTT,0,524188
araBp,0.2,4,4,GCCCGGGTCGCAGCATTTAT,0,467894
araBp,0.2,4,4,GCCCGCTTTTAAGGTCCAGG,0,474559
araBp,0.2,4,4,GCCCCCCATTGATGGGGCGA,0,468011
araBp,0.2,4,4,GCCCACCATAATTACTTTGA,0,493530
araBp,0.2,4,4,GCCATACCGGCACATAAGAA,0,520777
araBp,0.2,4,4,GCCATAAAACATTACTTCGC,0,485007
araBp,0.2,4,4,GCCAGAACATTCGATAAAAG,0,480966
araBp,0.2,4,4,GCCAATCGGCTTTAGTTTCT,0,516195
araBp,0.2,4,4,GCCAAGGGCCGTCTCCGTAT,0,495972
araBp,0.2,4,4,GCATTCTCTGTCGGCCTGAT,0,475278
araBp,0.2,4,4,GCATCGTGTCTCGTCGGGGG,0,524662
araBp,0.2,4,4,GCATCCTTGAGATCCAGGGT,0,507194
araBp,0.2,4,4,GCATCCCCCTGGTTATAACT,0,484765
araBp,0.2,4,4,GCATCAGCCTGGCGGGAACG,0,472676
araBp,0.2,4,4,GCATATCAAATTTCCCCCTT,0,507800
araBp,0.2,4,4,GCATAGAAGGTTGCGGGGCG,0,501629
araBp,0.2,4,4,GCATACTAGAGAAGACCGGA,0,494412
araBp,0.2,4,4,GCAGATGACAAGATTATATA,0,495923
araBp,0.2,4,4,GCAGAATAAGTGACTCCCGC,0,482815
araBp,0.2,4,4,GCACTGTCTTTTTGCGGTAC,0,508982
araBp,0.2,4,4,GCACTGAGAGATGTTAAATA,0,519011
araBp,0.2,4,4,GCACGGGTGAATCGGGTCAG,0,491222
araBp,0.2,4,4,GCAATTGACTATGGTCAGAG,0,470628
araBp,0.2,4,4,GCAATATGTCGCCCAGTTTC,0,499956
araBp,0.2,4,4,GCAAGGCGCCAGAGATGCTA,0,492298
araBp,0.2,4,4,GCAACGTGAGCTCTTGGTCT,0,477246
araBp,0.2,4,4,GATTGTTGGTCCACGTCATT,0,485687
araBp,0.2,4,4,GATTGGCAGCGCAACCTCGG,0,518496
araBp,0.2,4,4,GATTGCTGAAAATACTTACT,0,487764
araBp,0.2,4,4,GATTGCAGGTCCCGACATGT,0,468020
araBp,0.2,4,4,GATTGACCCACGGTTCAACT,0,515613
araBp,0.2,4,4,GATTCAGGGTCTTGTCAGGG,0,471282
araBp,0.2,4,4,GATTACATCTTGCCACACTG,0,482620
araBp,0.2,4,4,GATTAAACTGACAGCGTGCT,0,517763
araBp,0.2,4,4,GATGTTAGGCGAAAGACTAT,0,508714
araBp,0.2,4,4,GATGTTAACTCCCCGGGGGT,0,492050
araBp,0.2,4,4,GATGTGGGACATTAGTAGAC,0,505866
araBp,0.2,4,4,GATGTCCAATAAAGACCAGG,0,478781
araBp,0.2,4,4,GATGGCTTTAGGGGACGTAA,0,507990
araBp,0.2,4,4,GATGGCCCGTTTTTTCTAAG,0,489539
araBp,0.2,4,4,GATGCATCTACGGTACGACT,0,491342
araBp,0.2,4,4,GATGCAACTTCCTTAAAGAC,0,482230
araBp,0.2,4,4,GATGAGTCTGTCGAATCTGG,0,523950
araBp,0.2,4,4,GATGAGCGTGAGCTTAGCCT,0,495836
araBp,0.2,4,4,GATCTGTAGTCCCCTGAAAC,0,492597
araBp,0.2,4,4,GATCGATTTCCCCTTCGGGC,0,520043
araBp,0.2,4,4,GATCGAAGACGTTAAAGGGG,0,490405
araBp,0.2,4,4,GATCCTCTTCTCCCATTGGG,0,499149
araBp,0.2,4,4,GATCCCGCTCCACCACTGAC,0,491579
araBp,0.2,4,4,GATACTTCGGCTCAGGTACA,0,481484
araBp,0.2,4,4,GATAATCGACATCCCTGATG,0,486272
araBp,0.2,4,4,GATAACTCGCTGCCGAACAC,0,523381
araBp,0.2,4,4,GATAACCTTAAATGCGGTCA,0,481618
araBp,0.2,4,4,GAGTTTCGGCAAAACTAGGA,0,518704
araBp,0.2,4,4,GAGTTCGAGGGCAACCGTCC,0,488367
araBp,0.2,4,4,GAGTCGTAACATCAGGTGGG,0,500137
araBp,0.2,4,4,GAGTCAGGACCGTCGTCTTC,0,515206
araBp,0.2,4,4,GAGTATTGGCCCGTATATGG,0,520393
araBp,0.2,4,4,GAGTATGGCTATACTTTCAA,0,501542
araBp,0.2,4,4,GAGGTTGAATCGATTTTGAA,0,512996
araBp,0.2,4,4,GAGGGAGTCGCTTGCGTTGT,0,501426
araBp,0.2,4,4,GAGGCGACATCTCTTGCCAA,0,498393
araBp,0.2,4,4,GAGGCAGTTGTTATGCCCAC,0,521713
araBp,0.2,4,4,GAGGAGCTGTCTGGAAGGCA,0,481762
araBp,0.2,4,4,GAGGAGAAACTTCTCTAGTT,0,490424
araBp,0.2,4,4,GAGCTGTACTATTAGCTCCA,0,511617
araBp,0.2,4,4,GAGCGTTTACCGTCAGTCGG,0,470600
araBp,0.2,4,4,GAGCCGATACACAGGCGCGT,0,481182
araBp,0.2,4,4,GAGATGTGTATTTTAAGATG,0,479164
araBp,0.2,4,4,GAGAGTCTCTCACAGTCACG,0,483765
araBp,0.2,4,4,GAGAGGCCCCGGTTTGGTAT,0,480146
araBp,0.2,4,4,GAGACTCATTTTCGGGTTAT,0,479108
araBp,0.2,4,4,GAGAATTCACTGTACGAGCC,0,469084
araBp,0.2,4,4,GAGAAGGGTCGTAATCGCGA,0,506858
araBp,0.2,4,4,GACTTTTATGTTTCAGAACT,0,482389
araBp,0.2,4,4,GACTTGTGGGGCGCGCCACA,0,487500
araBp,0.2,4,4,GACTTGGACCTCACCTTAAG,0,516680
araBp,0.2,4,4,GACTGCTTCCACGGTCGCCC,0,492177
araBp,0.2,4,4,GACTCTCGTGTACGGGCGAT,0,478187
araBp,0.2,4,4,GACTAGCTGCGCGTCGAAAG,0,475043
araBp,0.2,4,4,GACGTCATGCAGGTCCATTA,0,505441
araBp,0.2,4,4,GACGGGCGATATAAGTCTTG,0,469154
araBp,0.2,4,4,GACGGCATGGCAGATGCTAA,0,498471
araBp,0.2,4,4,GACGCCTGGTCGTATTGGTT,0,498092
araBp,0.2,4,4,GACCTGAAGCTACGGTAGGC,0,474736
araBp,0.2,4,4,GACCGGGCAACCAAGGTTTT,0,469494
araBp,0.2,4,4,GACCGCCGTGCCCAAGCCTA,0,512173
araBp,0.2,4,4,GACCCTACGTGCTGTATGCA,0,476791
araBp,0.2,4,4,GACCCAACGTTGCGTCCCTA,0,477941
araBp,0.2,4,4,GACCATGTGTTTGTGTATAC,0,521037
araBp,0.2,4,4,GACCAGGCATGTCCATTCGG,0,510765
araBp,0.2,4,4,GACCACACCCAAGAAATTGT,0,474258
araBp,0.2,4,4,GACATGCCTGGTGAGGATAC,0,491019
araBp,0.2,4,4,GACAGCTCACCAGACACCTC,0,521802
araBp,0.2,4,4,GACAGATGATCTAAAAGATT,0,522241
araBp,0.2,4,4,GACACTAACTTTCACATCAT,0,472348
araBp,0.2,4,4,GACACGGCCTGAGTAAACGG,0,523059
araBp,0.2,4,4,GACAAAATCGTGTAGTAGTG,0,517995
araBp,0.2,4,4,GAATTTTTTAGCTTTGACGT,0,471704
araBp,0.2,4,4,GAATGACTTGTATTCCTGGC,0,507213
araBp,0.2,4,4,GAATGAAGGCCACAGCTTAC,0,475334
araBp,0.2,4,4,GAATATCAGGGTCGAAATCT,0,496884
araBp,0.2,4,4,GAAGTCAAGTGACAGGTTGC,0,517942
araBp,0.2,4,4,GAAGTAGGCAGAGGGCACTG,0,521801
araBp,0.2,4,4,GAACTTTTCTGTCGCTAAGA,0,514522
araBp,0.2,4,4,GAACTCAGTTGCGCGGAATA,0,510261
araBp,0.2,4,4,GAACCTGCCGCATTACAGCA,0,500997
araBp,0.2,4,4,GAACATTGGCAAGGGTTCCG,0,503292
araBp,0.2,4,4,GAAAGCTCTTTACTACTAAA,0,467829
araBp,0.2,4,4,GAAAGCAAAACCAGAATTAC,0,513854
araBp,0.2,4,4,GAAAATTGTGTGATGCCTTT,0,505706
araBp,0.2,4,4,CTTTTAACCTGTCTGGTAGG,0,520244
araBp,0.2,4,4,CTTTGTGATTATGTAATGTG,0,524645
araBp,0.2,4,4,CTTTGACGGGACTGGTGATC,0,514034
araBp,0.2,4,4,CTTTATTAGGTTCTAATGCC,0,503280
araBp,0.2,4,4,CTTTAGTAAAGAATAACCCG,0,512846
araBp,0.2,4,4,CTTTAGGCCGTTATCGACTT,0,473198
araBp,0.2,4,4,CTTGTTAGCTCGTGATAAGA,0,474463
araBp,0.2,4,4,CTTGTGGTACCACTCTTGCG,0,484446
araBp,0.2,4,4,CTTGGATTGCGCAGGCGTGT,0,478458
araBp,0.2,4,4,CTTGGAAGCGATCAAGTCTT,0,476996
araBp,0.2,4,4,CTTGCTTCGGAGGAAGCGTT,0,512776
araBp,0.2,4,4,CTTGCCTTGTATTACCAGGC,0,498326
araBp,0.2,4,4,CTTGAGCCAGCCAGTCTTCT,0,507645
araBp,0.2,4,4,CTTCTACAAAAGAGAAACTT,0,481446
araBp,0.2,4,4,CTTCGACGCACAAGCTAACA,0,497105
araBp,0.2,4,4,CTTCAGGTATCCTACGGGTC,0,484207
araBp,0.2,4,4,CTTCAAAGCTCTCTTAAACA,0,477188
araBp,0.2,4,4,CTTATTGGCACCGGCTCACT,0,488095
araBp,0.2,4,4,CTTATTAGAGGCTTCAAAAT,0,471573
araBp,0.2,4,4,CTTATGAAGTACACTCCTGA,0,468113
araBp,0.2,4,4,CTTATAAAATAGATCTAAAC,0,479068
araBp,0.2,4,4,CTTACCTATCGAGCATAACT,0,478396
araBp,0.2,4,4,CTTAAAGTTATAGGGGGCGG,0,474298
araBp,0.2,4,4,CTGTTAGTCACAATTCTGAT,0,470909
araBp,0.2,4,4,CTGTGTATTAACGGAAGCGT,0,511351
araBp,0.2,4,4,CTGTATGTGGATTTGGGTGA,0,470311
araBp,0.2,4,4,CTGGGCAAAATCCATCCGGA,0,515232
araBp,0.2,4,4,CTGGCGCGCAGGGGGATTCG,0,471030
araBp,0.2,4,4,CTGGCCGTCGCTATTTTTAT,0,506571
araBp,0.2,4,4,CTGCGGGGGAAAGCGTATGT,0,474128
araBp,0.2,4,4,CTGCGGAGGTCAGCTCATGG,0,472556
araBp,0.2,4,4,CTGCGCTGGAGGCCACGTCA,0,480097
araBp,0.2,4,4,CTGCGCGAACACTAGCAGCA,0,484511
araBp,0.2,4,4,CTGCGCCAAATGTATGGCTT,0,523683
araBp,0.2,4,4,CTGCCCGCCCGATACTTATG,0,473571
araBp,0.2,4,4,CTGCCATCGGAATGGGTTTG,0,494231
araBp,0.2,4,4,CTGCAAAACCATACACAGGA,0,515817
araBp,0.2,4,4,CTGATAGGGTGGACCAGAAT,0,491420
araBp,0.2,4,4,CTGACCACAGTAAGGACCGA,0,469810
araBp,0.2,4,4,CTGAACGGCTCTACTGGTTT,0,477646
araBp,0.2,4,4,CTCTGGGGTCCTGAGGTGCT,0,518712
araBp,0.2,4,4,CTCTCATGTACCAAAGAACA,0,514220
araBp,0.2,4,4,CTCTACCCCTTGAGGAAGGG,0,519144
araBp,0.2,4,4,CTCGAACAGCCGAAAGTAGG,0,490547
araBp,0.2,4,4,CTCCTAGGGAATCGTTCAGT,0,499579
araBp,0.2,4,4,CTCCGATTCAAGCCGTACAA,0,495716
araBp,0.2,4,4,CTCCGACATTGCTACAGCTA,0,509138
araBp,0.2,4,4,CTCCCGACATACTAGGGCCC,0,498476
araBp,0.2,4,4,CTCACTGATGGAGGAGCCGA,0,504097
araBp,0.2,4,4,CTATTTACTATCCTCGCCGG,0,507801
araBp,0.2,4,4,CTATTGTTCAGATGTGGATG,0,509727
araBp,0.2,4,4,CTATTCTCTGTCCACTCCAT,0,475265
araBp,0.2,4,4,CTATTAGCTTTCAGAGCGTC,0,496318
araBp,0.2,4,4,CTATGTGAGACGAGTGTACG,0,522833
araBp,0.2,4,4,CTATACCCGAGATGACCGCA,0,507769
araBp,0.2,4,4,CTAGTAACCCTGTAACATGA,0,518796
araBp,0.2,4,4,CTAGGCAGCCTCTTACCCGT,0,496034
araBp,0.2,4,4,CTAGCCCGGGACAAATTTAA,0,508104
araBp,0.2,4,4,CTACTTGTCACAGATAATTA,0,484887
araBp,0.2,4,4,CTACTGTAAGCATCCTATTT,0,469540
araBp,0.2,4,4,CTACTGGACCCCAGCCTTTT,0,485514
araBp,0.2,4,4,CTACGTAAGGCCGAAGGAAT,0,494272
araBp,0.2,4,4,CTACCAAGGCTAATATTCCT,0,478488
araBp,0.2,4,4,CTAATCCGTAACAATGTGGG,0,468433
araBp,0.2,4,4,CTAATATTATACATTCGAAC,0,491277
araBp,0.2,4,4,CTAATACTTTACCGCATACC,0,485361
araBp,0.2,4,4,CGTTTCCATTCAATACTCGA,0,473968
araBp,0.2,4,4,CGTTATAAATCGTTTTAATG,0,470077
araBp,0.2,4,4,CGTTAGCAGCGAGTTCTTAA,0,489954
araBp,0.2,4,4,CGTGTCTCGCTCCTAATCGG,0,512690
araBp,0.2,4,4,CGTGGTATATAGGATAAAAT,0,476318
araBp,0.2,4,4,CGTGGGAGGTTATCTCAGGA,0,494903
araBp,0.2,4,4,CGTGGATGACAGAGTTTCGG,0,507321
araBp,0.2,4,4,CGTGCCGCGCGTCGAGCCTA,0,494232
araBp,0.2,4,4,CGTCTCGTACCGCGTTCTGT,0,499180
araBp,0.2,4,4,CGTCTCCCCGTTATGGCGCG,0,484866
araBp,0.2,4,4,CGTCGGCGGTTTTTCGCGGT,0,482466
araBp,0.2,4,4,CGTCGGCAACCCGGACAGGT,0,485810
araBp,0.2,4,4,CGTCGCAACCTTCATGATCC,0,517148
araBp,0.2,4,4,CGTCCGGTCATGTCTACGCA,0,478900
araBp,0.2,4,4,CGTCACTGGTTACAGTGTAC,0,513449
araBp,0.2,4,4,CGTATCAGAGTAGCGTTAAC,0,482096
araBp,0.2,4,4,CGTACCCCTCAAGGCGGGAA,0,513075
araBp,0.2,4,4,CGTACAGGCCTAGACCAGCT,0,512118
araBp,0.2,4,4,CGTAATGATAAATCAATGAA,0,488817
araBp,0.2,4,4,CGTAAGGTTTGTGGTTGCCC,0,519029
araBp,0.2,4,4,CGTAAGCTTACCATACACAT,0,496707
araBp,0.2,4,4,CGTAACCATCGATATACTGT,0,504965
araBp,0.2,4,4,CGGTGGTGTATGTTGGCCAT,0,477886
araBp,0.2,4,4,CGGTGCCACGAGTTGCTCGA,0,473254
araBp,0.2,4,4,CGGTCTGCCCTGACGTTTAC,0,470528
araBp,0.2,4,4,CGGTCGGGGTAGCCAGCCAT,0,487071
araBp,0.2,4,4,CGGTCGATAGGTTCACCGAG,0,494472
araBp,0.2,4,4,CGGTCCTCATGGACAGTTAA,0,491809
araBp,0.2,4,4,CGGGTTCACTGCACAATCCA,0,488820
araBp,0.2,4,4,CGGGTCACCGACTCGGGACT,0,487775
araBp,0.2,4,4,CGGGTACAGGGTGTTCATGG,0,518064
araBp,0.2,4,4,CGGGGGTGAAACGTCAGTCC,0,499212
araBp,0.2,4,4,CGGGGGGATCCTGCTCTGAC,0,509774
araBp,0.2,4,4,CGGGCTTCTGTGCATACAAG,0,475170
araBp,0.2,4,4,CGGGCGTAATGCGGATCAGT,0,519582
araBp,0.2,4,4,CGGGCGCCTCAGTAAATTAG,0,524747
araBp,0.2,4,4,CGGCTGGCAACACCTGATAT,0,494230
araBp,0.2,4,4,CGGCAGAACATCGCTCTTAT,0,501789
araBp,0.2,4,4,CGGCACATAAATCCGTGGGG,0,511439
araBp,0.2,4,4,CGGATTTTAAGGTTTACCTT,0,477922
araBp,0.2,4,4,CGGAGTCCACCATCAGGGGT,0,509116
araBp,0.2,4,4,CGGAGCCAAGGTGATATTAT,0,504021
araBp,0.2,4,4,CGGACCCGTGATGAGTATAG,0,491852
araBp,0.2,4,4,CGGAAGTTCTGGGCTTACCA,0,508696
araBp,0.2,4,4,CGCTTTAGGGGCGCCGTTCT,0,471074
araBp,0.2,4,4,CGCTTGCTGGGTATGATTCC,0,480732
araBp,0.2,4,4,CGCTTATTTCGAATAATGAG,0,505619
araBp,0.2,4,4,CGCTGCCGCTAGTTGGTTTT,0,512939
araBp,0.2,4,4,CGCGGCCCACAACCCGAGGT,0,469173
araBp,0.2,4,4,CGCCTGTGTAACGGGAATCC,0,493769
araBp,0.2,4,4,CGCCGCTGATAGGTGTCTCG,0,476989
araBp,0.2,4,4,CGCCGAAATCCGGAACCCGT,0,480147
araBp,0.2,4,4,CGCCCTTAGACGCGGGGTCC,0,483871
araBp,0.2,4,4,CGCCATCTGTTACCAGACGT,0,495462
araBp,0.2,4,4,CGCCATACAGAATCCGGGTT,0,483581
araBp,0.2,4,4,CGCCACGTAAGAACGTACGC,0,487138
araBp,0.2,4,4,CGCCACGTAAAGTCGGGACT,0,481994
araBp,0.2,4,4,CGCACCACACGAGGCCGCAT,0,517581
araBp,0.2,4,4,CGCAAGTAGCTTACCCCTTG,0,478470
araBp,0.2,4,4,CGCAAAGGGGTTTGATGGAC,0,504511
araBp,0.2,4,4,CGATCACCAGTCGAGACCAG,0,489471
araBp,0.2,4,4,CGAGTGTAGTTTATCCGGTC,0,484515
araBp,0.2,4,4,CGAGTCAACCAGCAGCTCTC,0,518178
araBp,0.2,4,4,CGAGGGCGCGGTTCACCCGG,0,495487
araBp,0.2,4,4,CGAGCTATCATCAACAAATA,0,503415
araBp,0.2,4,4,CGAGCGTGGCAATAGCAATT,0,516463
araBp,0.2,4,4,CGACTGATGCAGGATATTCA,0,472962
araBp,0.2,4,4,CGACGCCGGCCCGTCGGGGT,0,506651
araBp,0.2,4,4,CGACCACGACACGAACTGAG,0,511321
araBp,0.2,4,4,CGAACTGGTTGCCTAAGTTA,0,520177
araBp,0.2,4,4,CCTTTTTGTCCCGGCGGGGT,0,515478
araBp,0.2,4,4,CCTTTGGTCTACGGAACACA,0,492231
araBp,0.2,4,4,CCTTCAATGAGGGAATGAGG,0,500893
araBp,0.2,4,4,CCTGATTGTCAGTAGGATTA,0,474040
araBp,0.2,4,4,CCTGAGACGTGAAGATTGAG,0,518311
araBp,0.2,4,4,CCTGACAAACACACCGTCGC,0,511479
araBp,0.2,4,4,CCTCTTTCCCGTAATTAACC,0,474595
araBp,0.2,4,4,CCTCTTCAGTCCTAAGGAGC,0,513685
araBp,0.2,4,4,CCTCGTCTGGGGTTTTGTTA,0,490413
araBp,0.2,4,4,CCTCAGCCTTTAGGTCTCGC,0,510743
araBp,0.2,4,4,CCTCAATTACTTTCTATGAA,0,471123
araBp,0.2,4,4,CCTCAACATAGGCGATCGGA,0,474810
araBp,0.2,4,4,CCTATGTGATAGACTACTCT,0,484208
araBp,0.2,4,4,CCTATGGTTACGTCATTCTA,0,479354
araBp,0.2,4,4,CCTATACTCCACGGGTCGCG,0,498657
araBp,0.2,4,4,CCTAGAATAGCAATTTAGAC,0,482056
araBp,0.2,4,4,CCTACGTTCTTAAGGAATCA,0,517128
araBp,0.2,4,4,CCTACCGGGCTTCTCGCCGG,0,489249
araBp,0.2,4,4,CCTAATTATCAGCGAGCGGT,0,512004
araBp,0.2,4,4,CCTAAAATTGCATTTTACTC,0,525072
araBp,0.2,4,4,CCGTTGCTGATCCAACTGGC,0,518557
araBp,0.2,4,4,CCGTGCGCCATATATATCAT,0,475583
araBp,0.2,4,4,CCGTGATACCACTTTCTATA,0,504879
araBp,0.2,4,4,CCGTCCGAAGCGATCTAGGA,0,495809
araBp,0.2,4,4,CCGTATACTCAGCGCGTGGA,0,517457
araBp,0.2,4,4,CCGTAATATCACGAGTCCTC,0,507084
araBp,0.2,4,4,CCGTAAGGTACTTTCTAGAT,0,479236
araBp,0.2,4,4,CCGGTGGAGTCCACTGGGAC,0,473267
araBp,0.2,4,4,CCGGTACAGCAGGTACATCG,0,519190
araBp,0.2,4,4,CCGGGCTTAGTTCACTAATT,0,504948
araBp,0.2,4,4,CCGGCTGCCAGGTTTTCGGA,0,484660
araBp,0.2,4,4,CCGCGGGGAAGCTCAGAAGG,0,515699
araBp,0.2,4,4,CCGCGCATTTGATCACTTAC,0,468436
araBp,0.2,4,4,CCGCGCATGGTACGGTAAGT,0,499651
araBp,0.2,4,4,CCGCGAACGGTTGGCCCTGA,0,519659
araBp,0.2,4,4,CCGCCCCGAGGGTACGCTAG,0,506353
araBp,0.2,4,4,CCGCATGGAGTCGGCATATC,0,500566
araBp,0.2,4,4,CCGCACTCCGGACAAGCCGT,0,510556
araBp,0.2,4,4,CCGAGTGGATTACCTAATTT,0,510317
araBp,0.2,4,4,CCGAGGATCAAATGGTACGA,0,511636
araBp,0.2,4,4,CCGACTCCTGAGTAAAATTT,0,500186
araBp,0.2,4,4,CCCTTGGCTAGAACGCTCAG,0,488913
araBp,0.2,4,4,CCCTATTGGATAGTGTTCGC,0,470602
araBp,0.2,4,4,CCCTAGATTCTCACGCAGGG,0,499019
araBp,0.2,4,4,CCCTACACGCAGCAAGGCCG,0,525250
araBp,0.2,4,4,CCCGTAACGGATCTAGAGGA,0,521367
araBp,0.2,4,4,CCCGGGTTGCACAACGTTAA,0,514085
araBp,0.2,4,4,CCCGGGATCCGCACTTGTCC,0,500133
araBp,0.2,4,4,CCCGGGAGCTCGGGTGCGCC,0,509282
araBp,0.2,4,4,CCCGCAGGCTTCAAGATTGA,0,488891
araBp,0.2,4,4,CCCGATTGCGCATACATGAG,0,506171
araBp,0.2,4,4,CCCGATCTGAGGGACGCGAG,0,473162
araBp,0.2,4,4,CCCGACCATGCAGCATCACG,0,523924
araBp,0.2,4,4,CCCCTCTGACTCTAGGAGCA,0,501840
araBp,0.2,4,4,CCCCGTGAGAATGGGATGGC,0,512384
araBp,0.2,4,4,CCCCGTCTGTGAATCGGAGT,0,486991
araBp,0.2,4,4,CCCCGGGCAGCCGGTACAGT,0,476910
araBp,0.2,4,4,CCCCGAGAGAGGAGTATCCA,0,478183
araBp,0.2,4,4,CCCCAATTTAATTCTATACT,0,492031
araBp,0.2,4,4,CCCATGTGCGGACAGGGGCA,0,504193
araBp,0.2,4,4,CCCATGATAGTGACAAATCT,0,483690
araBp,0.2,4,4,CCCAGTTGAGCCAATATTTA,0,492546
araBp,0.2,4,4,CCCAGAGCGTGATCGCCGGC,0,494936
araBp,0.2,4,4,CCCAATGGCCATCTCTTTAT,0,508395
araBp,0.2,4,4,CCATTGATGACATGGGTATA,0,488951
araBp,0.2,4,4,CCATTCCGATCGACAGAATC,0,519217
araBp,0.2,4,4,CCAGTTTACGATGGGGAATT,0,515024
araBp,0.2,4,4,CCAGGGAGCGGGCATGGCCA,0,480311
araBp,0.2,4,4,CCAGCTGTTGCGGGGATAAT,0,515911
araBp,0.2,4,4,CCAGCCGGGTTGGCGACGTG,0,481985
araBp,0.2,4,4,CCACGGTATACCGATGGACT,0,519880
araBp,0.2,4,4,CCACGCTTGGATACTGGGAC,0,505870
araBp,0.2,4,4,CCACGATCAAAAAAACTTTA,0,510988
araBp,0.2,4,4,CCACCAGGGGCAAAAGGGAA,0,498100
araBp,0.2,4,4,CCAATGCATGGGCGTACTCA,0,495255
araBp,0.2,4,4,CCAATACCTTAGAGTAGGGC,0,483723
araBp,0.2,4,4,CCAAGAGCTCTTATCGAGTA,0,503258
araBp,0.2,4,4,CCAAGACGGGAGATTTGCTA,0,485855
araBp,0.2,4,4,CCAAAGTGCGCGCGTTGAAA,0,480639
araBp,0.2,4,4,CCAAAGTCATACTGGAAGTC,0,516164
araBp,0.2,4,4,CCAAACGTTGCACGCGGGCG,0,482098
araBp,0.2,4,4,CATTTCGGATCTCTGGCATC,0,515176
araBp,0.2,4,4,CATTTAAATGCGGCCACGTA,0,468256
araBp,0.2,4,4,CATTACTCGTCGGGAAATAC,0,513179
araBp,0.2,4,4,CATGTCCAGCAACCGGGGAC,0,480352
araBp,0.2,4,4,CATGTACCCATTGAAAGTAA,0,508492
araBp,0.2,4,4,CATGGCTATGCACTTCTGGA,0,482693
araBp,0.2,4,4,CATGGAATCAGGTGTCGGAG,0,521017
araBp,0.2,4,4,CATGCAGCTTCCTCCATTTA,0,510437
araBp,0.2,4,4,CATGAGCTACGTCTACGTCT,0,523430
araBp,0.2,4,4,CATGAATGTACGGCATACTA,0,515288
araBp,0.2,4,4,CATCTTCGATAATTACCCGG,0,507644
araBp,0.2,4,4,CATCCAGGTGACGGTAAGTG,0,487347
araBp,0.2,4,4,CATCATCTAGGACCCGTACA,0,482353
araBp,0.2,4,4,CATATACTGAACTGAATCAA,0,505801
araBp,0.2,4,4,CATAGTCCAAATAGTGTAGG,0,493368
araBp,0.2,4,4,CATAGCAGTACATATCGTGT,0,510062
araBp,0.2,4,4,CATACGTTAGAAAGGGATTC,0,500363
araBp,0.2,4,4,CATAAGGTACAAGGAATATA,0,479881
araBp,0.2,4,4,CATAACGGTGCCTAGTCGAA,0,478798
araBp,0.2,4,4,CAGTTTGTAAGGGCAGAAGA,0,487668
araBp,0.2,4,4,CAGTTTCTGTAAACGACATC,0,509971
araBp,0.2,4,4,CAGTGGAGAAAGAAGCTCCA,0,503242
araBp,0.2,4,4,CAGTGAAGACAGTGGTTTTA,0,471785
araBp,0.2,4,4,CAGTCATGCAGATCTTCCGT,0,493936
araBp,0.2,4,4,CAGTAATCACTGATTCTGTC,0,470857
araBp,0.2,4,4,CAGTAAGGGTCTTTCGGTTG,0,505175
araBp,0.2,4,4,CAGGATTATCGATGCGGGTC,0,484553
araBp,0.2,4,4,CAGGAGTGAGAGGGCGCTTC,0,495841
araBp,0.2,4,4,CAGCGTTAATGTACTGAATT,0,488317
araBp,0.2,4,4,CAGATGAGCCGTACACGATG,0,468587
araBp,0.2,4,4,CAGACTTGGAGTGGGAACTA,0,513491
araBp,0.2,4,4,CAGAAGCGGCTAGAAAGATC,0,479708
araBp,0.2,4,4,CACTTTGAAGGCTCGTAGCA,0,513066
araBp,0.2,4,4,CACTTCTGCCGTGTGTTTCC,0,484469
araBp,0.2,4,4,CACTCACATAACAATGTACA,0,509376
araBp,0.2,4,4,CACTAGACCCAGTATCGTAG,0,522716
araBp,0.2,4,4,CACGTCGTTAGAGAGCTGAA,0,507010
araBp,0.2,4,4,CACGTCGCCAGAAGCAGGTG,0,479055
araBp,0.2,4,4,CACGGCCTATCAAATAATCA,0,515887
araBp,0.2,4,4,CACGATAGGGGGGCCGAGAA,0,470272
araBp,0.2,4,4,CACGAGGCGTATAGTGCGAA,0,506412
araBp,0.2,4,4,CACCTTGACATTCTCTAGAG,0,511638
araBp,0.2,4,4,CACCTTCTGTCGAAGAGAGG,0,525274
araBp,0.2,4,4,CACCAAATCGTTCTCGCCGT,0,520686
araBp,0.2,4,4,CACATATCTGATTACCACCT,0,503802
araBp,0.2,4,4,CACACTGCCACATGTCTAAC,0,495594
araBp,0.2,4,4,CACAATTGCTCTTTACTCTA,0,521039
araBp,0.2,4,4,CAATCGTTTACTAATTTATC,0,520280
araBp,0.2,4,4,CAATCGATGGACTGCGGGTT,0,516868
araBp,0.2,4,4,CAATAGAAACTACAATGATA,0,517988
araBp,0.2,4,4,CAATAAATTCGGTCCATGGT,0,512632
araBp,0.2,4,4,CAATAAAGTTGCGAGTATTG,0,479202
araBp,0.2,4,4,CAAGGCCGTCCCTGCATCCA,0,522670
araBp,0.2,4,4,CAAGCAAGCGCCTGCCCTAC,0,469892
araBp,0.2,4,4,CAACTCCACGCTATCGCTAG,0,520841
araBp,0.2,4,4,CAACTAAAGGGAGAACATCT,0,501818
araBp,0.2,4,4,CAACGTTACGAACTAGCGGG,0,496060
araBp,0.2,4,4,CAACGGAGAAGCCCGTTGTA,0,482279
araBp,0.2,4,4,CAACGCTTTTTGACTTTACA,0,518804
araBp,0.2,4,4,CAACACAGGGGGCGGTGCGC,0,491971
araBp,0.2,4,4,CAAATGTAGGACGGTGAGTG,0,521825
araBp,0.2,4,4,CAAATGAATGTACATACTGA,0,482003
araBp,0.2,4,4,CAAATCTAGCACGATCAGGC,0,474883
araBp,0.2,4,4,CAAATAGAGGATAGGTTGGG,0,479927
araBp,0.2,4,4,CAAAGCGGGTCCATGATCGT,0,521708
araBp,0.2,4,4,ATTTTTTAAAAATTCAGTAA,0,513105
araBp,0.2,4,4,ATTTTTGCTTGGAGCCCAGC,0,515753
araBp,0.2,4,4,ATTTTGGGCTTCACAGAGAT,0,511491
araBp,0.2,4,4,ATTTTAACGATGTGCCCTGA,0,473892
araBp,0.2,4,4,ATTTCTGAGCGGGCAGGTGA,0,493298
araBp,0.2,4,4,ATTTAAAGGCCTATGTAAGT,0,513569
araBp,0.2,4,4,ATTGCGTATATTGCTTCCAA,0,512764
araBp,0.2,4,4,ATTGCAGTTCTTTATACATA,0,468135
araBp,0.2,4,4,ATTGAACTCGGGACACACCT,0,476417
araBp,0.2,4,4,ATTCTAAATCGGCGATAGTC,0,492398
araBp,0.2,4,4,ATTCGGGATGTAGAATATAT,0,506598
araBp,0.2,4,4,ATTCGGCAGGGGCGTCGAGT,0,510058
araBp,0.2,4,4,ATTCGCCAAATGGGTTATGC,0,504735
araBp,0.2,4,4,ATTCGATCTCCCGATTTATT,0,522330
araBp,0.2,4,4,ATTCCGTTCCGAAACTCAAC,0,515795
araBp,0.2,4,4,ATTCACTGTAAGACAATGGC,0,472931
araBp,0.2,4,4,ATTCAATCATGGTATCGCAG,0,517302
araBp,0.2,4,4,ATTATGAATGTTCCGTCCAG,0,505048
araBp,0.2,4,4,ATTAGTACTCGTTTCACATA,0,493859
araBp,0.2,4,4,ATTACCATCTGCCTAGAGAC,0,493990
araBp,0.2,4,4,ATTAACTGCTATTTGTCATG,0,500931
araBp,0.2,4,4,ATTAACCACGAGAGCCCTAG,0,487762
araBp,0.2,4,4,ATGTGGTGCAATTTTATAGG,0,475035
araBp,0.2,4,4,ATGTCGAGTCAGGGAAATTG,0,473084
araBp,0.2,4,4,ATGTCCAGGAAGGAAGGCTA,0,499989
araBp,0.2,4,4,ATGTATGCATCGCCGTCTAA,0,505913
araBp,0.2,4,4,ATGGTGCATATACCGTTCGG,0,502190
araBp,0.2,4,4,ATGGGCATGATTATCCTGTA,0,475892
araBp,0.2,4,4,ATGGAGTTTCGTAAGTACAT,0,479878
araBp,0.2,4,4,ATGCTGGTTGGAATCGTCAG,0,525494
araBp,0.2,4,4,ATGCCGAAACTCATACCGCT,0,495418
araBp,0.2,4,4,ATGCCCAAGGTTGCGGCCGA,0,489581
araBp,0.2,4,4,ATGCCACAAGTGCAGTGCGC,0,505749
araBp,0.2,4,4,ATGCCAATATCACAGTGGCT,0,517639
araBp,0.2,4,4,ATGAGTGCAGGAGTGATGGT,0,505864
araBp,0.2,4,4,ATGAGCATATAGTGCTAGAA,0,481918
araBp,0.2,4,4,ATGACTTAGGTGGTATCCTA,0,513817
araBp,0.2,4,4,ATGACCCACGCCCCTCAACG,0,495242
araBp,0.2,4,4,ATGAATCTTCCTGCGTTGGT,0,479908
araBp,0.2,4,4,ATGAAGAACTAACGTTGCCT,0,487042
araBp,0.2,4,4,ATCTTATGTTTGAGATTCAA,0,488375
araBp,0.2,4,4,ATCTCAGTTATGGCCAGCTA,0,496883
araBp,0.2,4,4,ATCGGGTCAGTTAGGGCGGA,0,473588
araBp,0.2,4,4,ATCGCTAGGGATAATGCCAC,0,493894
araBp,0.2,4,4,ATCGCATTGTTATTTGACTT,0,481978
araBp,0.2,4,4,ATCGCAGTAGGCTATATGAG,0,475533
araBp,0.2,4,4,ATCGATTAGTGATCGGAAGA,0,519305
araBp,0.2,4,4,ATCGATCTGGTTCCCCCAGG,0,517573
araBp,0.2,4,4,ATCGACTGCCGAAAGGTTAG,0,499938
araBp,0.2,4,4,ATCGACCTCTTTCATGGTCG,0,516117
araBp,0.2,4,4,ATCCGTCAATAGGAGCCGCT,0,480723
araBp,0.2,4,4,ATCCGGATCCCATATCGAGG,0,501634
araBp,0.2,4,4,ATCCAGTTCCGTTGTCGAAT,0,478145
araBp,0.2,4,4,ATCCAACAGTCATTGCGTTG,0,495277
araBp,0.2,4,4,ATCATTGTAACTTTCAGCGA,0,490391
araBp,0.2,4,4,ATCATGGTGCGTTCTTGACA,0,514196
araBp,0.2,4,4,ATCATAGGGCGTTGCACAGC,0,482889
araBp,0.2,4,4,ATCAGGGCAACGTCAAGAGG,0,518209
araBp,0.2,4,4,ATCACGCTGATTTTAAGGTA,0,486845
araBp,0.2,4,4,ATCAAAGTCTTGTACGATAA,0,485410
araBp,0.2,4,4,ATCAAAGTAGCGGGGTAAGT,0,496934
araBp,0.2,4,4,ATATTCTATGACCTTTAGGC,0,518977
araBp,0.2,4,4,ATATGCCCCGCCTCCGGTAT,0,505138
araBp,0.2,4,4,ATATCAACTCTCCAGGCACC,0,513922
araBp,0.2,4,4,ATATAAGTGAACCAGAGTAT,0,480964
araBp,0.2,4,4,ATAGTGCAAATACTAGGACA,0,487311
araBp,0.2,4,4,ATAGGACTATGCTGCCCTCG,0,513718
araBp,0.2,4,4,ATAGCCTGTGGCAGGTATCA,0,500101
araBp,0.2,4,4,ATACTGCCCGGCTTTACACA,0,521104
araBp,0.2,4,4,ATACTAGTGGGCGTTCCTGT,0,497274
araBp,0.2,4,4,ATACTACGCGGCGTTCATGC,0,497635
araBp,0.2,4,4,ATACCCCCGTGAGCATGAAA,0,505481
araBp,0.2,4,4,ATAATCCGTGCTACGGGAGC,0,479087
araBp,0.2,4,4,ATAACCGGGTCACGAGGAAG,0,477106
araBp,0.2,4,4,AGTTTTCCGCTAAAAGTAAT,0,494771
araBp,0.2,4,4,AGTTTGAGTCGTAATGTTGA,0,523423
araBp,0.2,4,4,AGTTTAAGTTGCGTTTGGTC,0,478737
araBp,0.2,4,4,AGTTCCATTTTACCTGCTAT,0,514169
araBp,0.2,4,4,AGTGTGTGGTGAAAGTATAG,0,507319
araBp,0.2,4,4,AGTGCACGCCTGCCTCCTCA,0,518891
araBp,0.2,4,4,AGTCATAATGAAACGCTAAA,0,483263
araBp,0.2,4,4,AGTCAGTTCCTCCCGCTAAA,0,468466
araBp,0.2,4,4,AGTCAGTAATGCTATGGGCA,0,512668
araBp,0.2,4,4,AGTCAGCTCTTCGGCCTGAA,0,501876
araBp,0.2,4,4,AGTCAAGGGTTGGAGAGGGA,0,521923
araBp,0.2,4,4,AGTATCATGGTATATGCATC,0,482738
araBp,0.2,4,4,AGTATACAGAAAAAAAAGAA,0,489962
araBp,0.2,4,4,AGGTTACATCTCCCTGGGCA,0,518763
araBp,0.2,4,4,AGGTGCGAGTTTAGCAGAAC,0,475412
araBp,0.2,4,4,AGGTAAGGATTCACCGTCTC,0,511188
araBp,0.2,4,4,AGGGGTTTTACGAAAGGATT,0,521614
araBp,0.2,4,4,AGGGGCTGCATCTGACTTCA,0,489040
araBp,0.2,4,4,AGGGGATGGCAACAAACTGC,0,494465
araBp,0.2,4,4,AGGGCTACATGTATGCACGC,0,481643
araBp,0.2,4,4,AGGGCCTAGCGTCTTCCACA,0,475667
araBp,0.2,4,4,AGGGCCATCTGGCCTCTGCG,0,507277
araBp,0.2,4,4,AGGGCAGTTGAGGGCCGCAA,0,511094
araBp,0.2,4,4,AGGGCAAGATACAACATAGT,0,489868
araBp,0.2,4,4,AGGGATAAACCGTGATGACA,0,484383
araBp,0.2,4,4,AGGGACTGACCTAGATAGGG,0,511388
araBp,0.2,4,4,AGGCTTTTGTTTTTCGCAAG,0,521666
araBp,0.2,4,4,AGGCGTACCGATACGCTCGA,0,513920
araBp,0.2,4,4,AGGCCCTTGCCGGATGTATT,0,479305
araBp,0.2,4,4,AGGCCACAACGCGAAAGTTC,0,479306
araBp,0.2,4,4,AGGCCAAGTGCTCATCTCGC,0,487947
araBp,0.2,4,4,AGGCAACGCCTTGGCCCGCG,0,522981
araBp,0.2,4,4,AGGATATGTTATAATGCGTG,0,492326
araBp,0.2,4,4,AGGAGGAGGCGTTGCTAAGG,0,518759
araBp,0.2,4,4,AGGAGATGAAGAGTTATATG,0,503441
araBp,0.2,4,4,AGGAAGAGCCGAGGGTCTTA,0,468230
araBp,0.2,4,4,AGCTCCCCGTTACAATCATC,0,508683
araBp,0.2,4,4,AGCTAGTTCCAGGCTTAGCT,0,474933
araBp,0.2,4,4,AGCTACTACATACAGGTGGG,0,508378
araBp,0.2,4,4,AGCGTGTGATATAGTGTTCT,0,475586
araBp,0.2,4,4,AGCGTGTCTGAAACCGATGA,0,508289
araBp,0.2,4,4,AGCGTGGTAAAACGAGTCAG,0,524232
araBp,0.2,4,4,AGCGGTTTGCACGGTGTTGT,0,516994
araBp,0.2,4,4,AGCGGTCCAGAGTCCCAGCA,0,517463
araBp,0.2,4,4,AGCGGGGACCTGAATCCTAC,0,499312
araBp,0.2,4,4,AGCGACTGTTTCACGGGATG,0,481954
araBp,0.2,4,4,AGCCCTCGGTATTAATTTCA,0,510664
araBp,0.2,4,4,AGCACCTGTGCTTGGTATCA,0,481066
araBp,0.2,4,4,AGCAACCTACTCTGGGACAG,0,496114
araBp,0.2,4,4,AGCAAAGTAGTTGAGAGTCG,0,517377
araBp,0.2,4,4,AGATTGATCTGCCTGCTAGG,0,473035
araBp,0.2,4,4,AGATTATCTGACATTGGCCT,0,518301
araBp,0.2,4,4,AGATGTTGACCATTGAGGGG,0,501667
araBp,0.2,4,4,AGATGCGCATAATTTGTTAC,0,523547
araBp,0.2,4,4,AGATCTACTATCTCCAGGTG,0,502726
araBp,0.2,4,4,AGATCGAACGCTAGCGTGAA,0,471209
araBp,0.2,4,4,AGATATTAGCCGGGTTCTAT,0,484507
araBp,0.2,4,4,AGATACGAAACTTAAGGAAT,0,503137
araBp,0.2,4,4,AGAGTTTGCGGCATTACCCT,0,479625
araBp,0.2,4,4,AGAGTCCACAGTCACGTCTG,0,467824
araBp,0.2,4,4,AGAGTAGCCATAGTCATAGA,0,478242
araBp,0.2,4,4,AGAGGGTGAATCTCCGGGGG,0,468278
araBp,0.2,4,4,AGAGGCGATTCAATCATGTC,0,514847
araBp,0.2,4,4,AGAGACTGGGTTAGCATTCA,0,516678
araBp,0.2,4,4,AGACTAAAGACCTTCGTGAT,0,473288
araBp,0.2,4,4,AGACGGTTGTCGATTAACTT,0,522816
araBp,0.2,4,4,AGACGATCTGGGAAGGCTCT,0,486795
araBp,0.2,4,4,AGACAGCGGTAGCTCTCGGT,0,511331
araBp,0.2,4,4,AGACAAGGTGAATACTACCG,0,505818
araBp,0.2,4,4,AGAAGTTAAATAGGTGTATA,0,501315
araBp,0.2,4,4,AGAAGGTCCTGTTAGCTTCT,0,496447
araBp,0.2,4,4,AGAAGATACGGTCTTTCCAA,0,523377
araBp,0.2,4,4,ACTTCCGGAATCTGGCAGAT,0,503894
araBp,0.2,4,4,ACTTAGCGCATAGCGCATGC,0,518363
araBp,0.2,4,4,ACTGTGTCTCGATCGAGATT,0,514800
araBp,0.2,4,4,ACTGGGTATCCTGCTGAGAT,0,497417
araBp,0.2,4,4,ACTGATCGGAGTGGTTGCCA,0,512381
araBp,0.2,4,4,ACTGATCCTTCCCTGCGCAC,0,495366
araBp,0.2,4,4,ACTCTGCGGGTAGCACTGCA,0,480593
araBp,0.2,4,4,ACTCGGTCGACGCGGCTTTA,0,473523
araBp,0.2,4,4,ACTCGGATTCCCCTGGTGGG,0,516797
araBp,0.2,4,4,ACTCGCAGCATACGACATAC,0,489497
araBp,0.2,4,4,ACTCGAACGGTGTCTCTACC,0,469478
araBp,0.2,4,4,ACTCAGACCCGCCTTTAGTT,0,467868
araBp,0.2,4,4,ACTATTAGTTTCTGGGGAAC,0,488144
araBp,0.2,4,4,ACTAGCATTTAACCCAACGT,0,503979
araBp,0.2,4,4,ACTAGATATCTATCCAGGGC,0,497581
araBp,0.2,4,4,ACTAGACGCGCCGGAGACCG,0,508600
araBp,0.2,4,4,ACTACTCCTAATTGATATCA,0,503924
araBp,0.2,4,4,ACTAATCTTTCTGCATCTCT,0,471496
araBp,0.2,4,4,ACTAAAACGTGGTGGTACCA,0,473370
araBp,0.2,4,4,ACGTTGTTAGGAATATCCGT,0,509340
araBp,0.2,4,4,ACGTCTTTAGGCCATACAAA,0,474884
araBp,0.2,4,4,ACGGTGGCGAAGTTGTAGTG,0,487753
araBp,0.2,4,4,ACGGTCTTACTGGCAATGAT,0,492868
araBp,0.2,4,4,ACGGGGATGGTGTGTACTCA,0,497540
araBp,0.2,4,4,ACGGGGACAACCGCCGCCGC,0,510956
araBp,0.2,4,4,ACGGGCACATACTCCTACCA,0,513917
araBp,0.2,4,4,ACGGCTTGCATTATCGGAGC,0,489001
araBp,0.2,4,4,ACGGCTAAGCAGCGCGCAAA,0,498192
araBp,0.2,4,4,ACGGATATTTTCACATACCA,0,489687
araBp,0.2,4,4,ACGGAGATCACCGGAAGCTG,0,494914
araBp,0.2,4,4,ACGGAAAAGGGCTGGATTCC,0,510347
araBp,0.2,4,4,ACGCTTGACTGGTTTGTTCG,0,499717
araBp,0.2,4,4,ACGCTGTCATGCAATATTCG,0,517285
araBp,0.2,4,4,ACGCGGTTTGACCTGTATGT,0,488133
araBp,0.2,4,4,ACGCCGTGTATTTTCAGCTC,0,520893
araBp,0.2,4,4,ACGATTTTCTTTAGGGACTT,0,523999
araBp,0.2,4,4,ACGATTACTGTATTTTAGCA,0,502486
araBp,0.2,4,4,ACGATAGCACATTCCTGCCT,0,479900
araBp,0.2,4,4,ACGACAACCGTCCCGGAGCA,0,506695
araBp,0.2,4,4,ACGAATGTGTGCCTGATCGC,0,519915
araBp,0.2,4,4,ACCTTGCTGGCGTTTTTACG,0,493206
araBp,0.2,4,4,ACCTGTGGGGAGTGGGCTGT,0,524525
araBp,0.2,4,4,ACCTGGGCGAATGTGATTCT,0,472707
araBp,0.2,4,4,ACCTGGCTAGTGTCGGTAGA,0,470704
araBp,0.2,4,4,ACCTCTTGCAGTTTGAACCG,0,476473
araBp,0.2,4,4,ACCTCTGTGGATCCTACTCG,0,511228
araBp,0.2,4,4,ACCTCTAGATGGGAGCGAAG,0,489409
araBp,0.2,4,4,ACCTCGAAGCGCCGCCAGAG,0,484677
araBp,0.2,4,4,ACCTATATGGAATCGCTCCT,0,501554
araBp,0.2,4,4,ACCGTCGATGCTGCTCGATC,0,485472
araBp,0.2,4,4,ACCGGGCGGAGTATCATGCG,0,501167
araBp,0.2,4,4,ACCGCCGTTCCCATTTTCTG,0,507419
araBp,0.2,4,4,ACCGACGGTCGTTCATTTTG,0,498400
araBp,0.2,4,4,ACCCTCCGAACGCAGCTCGC,0,524598
araBp,0.2,4,4,ACCCGCCGTCCCATTGACCA,0,494274
araBp,0.2,4,4,ACCCCGTCGTTCTTGTAATG,0,489932
araBp,0.2,4,4,ACCCCATCCCGGGCACTGAT,0,488371
araBp,0.2,4,4,ACCCATTGGATCACCGAAGC,0,478671
araBp,0.2,4,4,ACCAGTGATTGGTCTGCGGA,0,500854
araBp,0.2,4,4,ACCACATATTGAATGGACTA,0,477878
araBp,0.2,4,4,ACATTCGTTAAATATGCGGT,0,506283
araBp,0.2,4,4,ACATGTGAGCTGTTCAGGGT,0,484588
araBp,0.2,4,4,ACATGACGAGGACTCTGTTT,0,505399
araBp,0.2,4,4,ACATGAACGCGTTACCACTT,0,490845
araBp,0.2,4,4,ACATCGCCTGGTACATAAGG,0,500815
araBp,0.2,4,4,ACATCGATCCATAGACTAAA,0,467937
araBp,0.2,4,4,ACATCAAGTACGCTCACGAC,0,495204
araBp,0.2,4,4,ACATCAAGGGTGTTGTTTAG,0,521574
araBp,0.2,4,4,ACATATTCACGTCACCCGGG,0,511222
araBp,0.2,4,4,ACAGTTATAACGGTGTGCCG,0,474420
araBp,0.2,4,4,ACAGCGACCAGGTTGCAGCA,0,499786
araBp,0.2,4,4,ACAGCACGCCCACCCCGTAA,0,511484
araBp,0.2,4,4,ACAGATATTATCCGATAATC,0,505989
araBp,0.2,4,4,ACAGATAACCTCTCCTACTC,0,519623
araBp,0.2,4,4,ACAGAAGATCTGGCACCCCA,0,523379
araBp,0.2,4,4,ACAGAACAGATCGTACGTTT,0,521922
araBp,0.2,4,4,ACACCGTGACGGTACTGGCA,0,518627
araBp,0.2,4,4,ACACCCGATTGAGCTATTTA,0,515332
araBp,0.2,4,4,ACACCAAGTTCACGGGAAAT,0,477768
araBp,0.2,4,4,ACAATTGTCCTAGAGGCACA,0,519664
araBp,0.2,4,4,ACAATTATAAGTTTATGCTT,0,519808
araBp,0.2,4,4,ACAAGGCGGACTATCTCCAT,0,491778
araBp,0.2,4,4,ACAAGATACCAGCATAAGTG,0,474693
araBp,0.2,4,4,ACAAATGCAGCCGGTGACTG,0,483952
araBp,0.2,4,4,ACAAAGGTCCATCACGGACA,0,502181
araBp,0.2,4,4,ACAAACTACCATATGGTAGA,0,489134
araBp,0.2,4,4,AATTTGTAGTGGCATGGCAA,0,479394
araBp,0.2,4,4,AATTTGGTTTGTCTTTCCTG,0,523180
araBp,0.2,4,4,AATTGCAGCGTAGCGTTGCT,0,487254
araBp,0.2,4,4,AATTGAGTTCTTTTTCTATC,0,500143
araBp,0.2,4,4,AATTGAGCACTTCCTTGTGT,0,502048
araBp,0.2,4,4,AATTAACGGCAGTCCAAAGG,0,505860
araBp,0.2,4,4,AATGGATCTGTTTTAGCTGG,0,484975
araBp,0.2,4,4,AATGAGTCGGGCTAGCCCCC,0,515547
araBp,0.2,4,4,AATGAGCCATATCCTTAGAG,0,505927
araBp,0.2,4,4,AATCTTCCACTCCTCCCCGC,0,515816
araBp,0.2,4,4,AATCTGGCCTGCCTCGTGGT,0,468140
araBp,0.2,4,4,AATCTAATTACTAGCTTCGA,0,523881
araBp,0.2,4,4,AATCGGGCGGTTTTAGTCAT,0,502018
araBp,0.2,4,4,AATCGGGCGATTCTCTACGG,0,495878
araBp,0.2,4,4,AATCGGAATTGTATATCTCC,0,468280
araBp,0.2,4,4,AATCCATTTGTGTCAGCGCT,0,514168
araBp,0.2,4,4,AATCAGGTGCAAAACTATTC,0,522790
araBp,0.2,4,4,AATCAAGGGAGAGGTTATTT,0,517817
araBp,0.2,4,4,AATCAAGATACTAGCCGGCG,0,512657
araBp,0.2,4,4,AATATTTCCCTGTCATAGGG,0,469091
araBp,0.2,4,4,AATAGCCACTCGATGCTAGG,0,507524
araBp,0.2,4,4,AATACGGGGGTGTGGTTGGC,0,509711
araBp,0.2,4,4,AATAAGACGAATTCCGTGGT,0,468264
araBp,0.2,4,4,AATAACCGTTCCATCCATGC,0,471930
araBp,0.2,4,4,AAGTTTTACAGCACTACGAT,0,483857
araBp,0.2,4,4,AAGTGTGCCAGCTCAGTGAT,0,470096
araBp,0.2,4,4,AAGTGGGACCAATGGCCTGA,0,474392
araBp,0.2,4,4,AAGTGCTGCAAGTGGATTTC,0,497900
araBp,0.2,4,4,AAGTGCCTAAAGCTCTGGGG,0,518582
araBp,0.2,4,4,AAGTCGTGGCCGGTCAAGTT,0,494978
araBp,0.2,4,4,AAGTCGGAAGTTCAATTGTG,0,515394
araBp,0.2,4,4,AAGGTGGGGGAGCCGAGTGT,0,492680
araBp,0.2,4,4,AAGGGTTTGAGCAGGATAAT,0,510879
araBp,0.2,4,4,AAGGGGAAGAACTGCGAGGT,0,517685
araBp,0.2,4,4,AAGGCCTGTGAGTGAGGAGC,0,496070
araBp,0.2,4,4,AAGGCACTCACGTCGGATGC,0,508050
araBp,0.2,4,4,AAGGCACGCGCCGGCTTTTG,0,476116
araBp,0.2,4,4,AAGGACGACATTAATACGCT,0,522882
araBp,0.2,4,4,AAGGAACACTGTATAAGTTT,0,495409
araBp,0.2,4,4,AAGCGTAGCCCTACGCCGGA,0,500552
araBp,0.2,4,4,AAGCGGCGAACATTGGTGCG,0,482168
araBp,0.2,4,4,AAGCGGAAGTATCTAATTCT,0,521217
araBp,0.2,4,4,AAGCGACGGGTCGTAGGCCA,0,505985
araBp,0.2,4,4,AAGCCGACTTTCTATTTCGA,0,519662
araBp,0.2,4,4,AAGATCTAAACCCCAAAGCG,0,509817
araBp,0.2,4,4,AAGATCAGGGAGAGCTCTTA,0,484513
araBp,0.2,4,4,AACTGGAAACGAAGTTACTC,0,481024
araBp,0.2,4,4,AACTGCTCGGCCTCCGGGGA,0,511723
araBp,0.2,4,4,AACTGAAACAAAGTAACATT,0,521671
araBp,0.2,4,4,AACGCTGCTGAGGTTCGTGG,0,521615
araBp,0.2,4,4,AACCTTCGCACAATCTGTAT,0,518095
araBp,0.2,4,4,AACCGTACGTGCAGTCTCTA,0,476342
araBp,0.2,4,4,AACCGATTCCTCAACAGCGC,0,518476
araBp,0.2,4,4,AACCGATGTCTCGGCCGCTT,0,494017
araBp,0.2,4,4,AACATTCGAGATGTGACGGG,0,503100
araBp,0.2,4,4,AACACGCAGGAGAAGATTTG,0,469204
araBp,0.2,4,4,AACAATGTGTATGGCAGCCC,0,490449
araBp,0.2,4,4,AACAAGGAGCTTCCCTTAGA,0,486841
araBp,0.2,4,4,AACAAGAGCAATGTGTCAAG,0,490257
araBp,0.2,4,4,AAATTTATTTGTGATCGTTA,0,508056
araBp,0.2,4,4,AAATTTACCCTCCACGACTT,0,506015
araBp,0.2,4,4,AAATTGTTTCTGCATCCCAT,0,499676
araBp,0.2,4,4,AAATTCGGGGTACGTGACCG,0,492413
araBp,0.2,4,4,AAATTCCGGCGCGAGGCACG,0,471901
araBp,0.2,4,4,AAATCGTGATTATCCAGCCA,0,482526
araBp,0.2,4,4,AAATAAATTCAAAGGCCGGT,0,489092
araBp,0.2,4,4,AAAGGGGCACTTTTCCAGTC,0,496771
araBp,0.2,4,4,AAAGCAAGGGTGCGTAGCAG,0,508759
araBp,0.2,4,4,AAACTTTTTTCAATGAGACG,0,510254
araBp,0.2,4,4,AAACTATAAACGAGACCCGG,0,516223
araBp,0.2,4,4,AAACTACAGGCATGGCTCGA,0,476202
araBp,0.2,4,4,AAACACTGTATGAATAGTCG,0,483604
araBp,0.2,4,4,AAACACTAACAGAAGTCATG,0,470607
araBp,0.2,4,4,AAACACAACGTATAAGAAGG,0,477577
araBp,0.2,4,4,AAAAGGAAGTTAGCGCGGAG,0,482843
araBp,0.2,4,4,AAAAAACGTGTCGGTCGCTG,0,514831
araBp,0.25,3,3,TTTTTTTCAGGAGATAGCGG,0,511948
araBp,0.25,3,3,TTTTTGAAATCCCGACCTCT,0,522848
araBp,0.25,3,3,TTTTTCAAGTGTGCTCATGT,0,516186
araBp,0.25,3,3,TTTTATTGAGTTGAGACTTC,0,520019
araBp,0.25,3,3,TTTTAGCCGCAGTGTGCTCG,0,522874
araBp,0.25,3,3,TTTTAAGGAGACTGTGGATT,0,491732
araBp,0.25,3,3,TTTGTGCTGGGCTTGATTGT,0,498944
araBp,0.25,3,3,TTTGTGAAGGCAAGATCCGA,0,492057
araBp,0.25,3,3,TTTGGTTGAAGAGATCGATG,0,494772
araBp,0.25,3,3,TTTGGTAGGAGTGATAACCT,0,513745
araBp,0.25,3,3,TTTGGGCCGTACATATAGTC,0,490611
araBp,0.25,3,3,TTTGCGCAGTCTCGGTCTCC,0,500224
araBp,0.25,3,3,TTTGACCAGTTCAATCCTAA,0,473440
araBp,0.25,3,3,TTTGAAGTGGAATACGTTTT,0,477624
araBp,0.25,3,3,TTTCGTCGTGTGAATTCGTG,0,490433
araBp,0.25,3,3,TTTCGTACTTCGTACCTCCA,0,509190
araBp,0.25,3,3,TTTCATCCGGCGCACGACGG,0,484640
araBp,0.25,3,3,TTTCAGGGGGACGGAAGTCG,0,490261
araBp,0.25,3,3,TTTCACCGGGTGCGGCACAG,0,491386
araBp,0.25,3,3,TTTCAAGGTTCGGTGTACCG,0,482791
araBp,0.25,3,3,TTTCAAAAAGCTCGAGTCTG,0,476211
araBp,0.25,3,3,TTTATTAGATGGCGCGGCTG,0,489080
araBp,0.25,3,3,TTTATACCGTTTTGTGAGGT,0,474828
araBp,0.25,3,3,TTTAGTAACTAATTTCCCGG,0,515259
araBp,0.25,3,3,TTTAGAGGGGAGCGGTTTTG,0,471027
araBp,0.25,3,3,TTTAATTCCATGGATAGTCG,0,494905
araBp,0.25,3,3,TTTAAGGGTTAGCGGTACTG,0,522648
araBp,0.25,3,3,TTTAAGCGTGGGGTCAGTAA,0,521198
araBp,0.25,3,3,TTGTTTTTTTAGTGCAAGAA,0,521261
araBp,0.25,3,3,TTGTGTTAGGGGTGCTACGA,0,477454
araBp,0.25,3,3,TTGTCTACTTATTAGATGTC,0,501498
araBp,0.25,3,3,TTGTCCTCAGGATGCGGAGT,0,482856
araBp,0.25,3,3,TTGTACGGGGTCGTTAGGGA,0,493380
araBp,0.25,3,3,TTGTAACGGGGGGTGCGTAC,0,506569
araBp,0.25,3,3,TTGGTGGAGTGGCGTATCGT,0,504683
araBp,0.25,3,3,TTGGGTTACGGTCGAAAGGA,0,505853
araBp,0.25,3,3,TTGGATGATTTGCGTTGCGT,0,500547
araBp,0.25,3,3,TTGGACAATGCACGGATACG,0,515455
araBp,0.25,3,3,TTGCTGAAACCCCGTTGCTC,0,484953
araBp,0.25,3,3,TTGCAGCCGTAACCGAGCAT,0,513999
araBp,0.25,3,3,TTGATGGATCGGGGCACCGT,0,511934
araBp,0.25,3,3,TTGAGCCTTCGCTCACATAG,0,511863
araBp,0.25,3,3,TTGACAGCGAGTTCCAGCTG,0,505163
araBp,0.25,3,3,TTGAATTAGTAAAGAAGGGG,0,481565
araBp,0.25,3,3,TTGAATCGCAGTTGTAGAAA,0,509418
araBp,0.25,3,3,TTGAACTGTACAGCATTGCT,0,480332
araBp,0.25,3,3,TTCTTGAACAAAAAGGGGGT,0,475542
araBp,0.25,3,3,TTCTTCGTCCAAAAACGAAG,0,467792
araBp,0.25,3,3,TTCTGATTTGTTCGAAATCT,0,495432
araBp,0.25,3,3,TTCTAATTTTGTGTCAAGGA,0,501325
araBp,0.25,3,3,TTCGTTGTAGGCAGCGCCTG,0,486723
araBp,0.25,3,3,TTCGTATGAAGTCAAGAGAG,0,493321
araBp,0.25,3,3,TTCGGCAAGTTTTCTTCACC,0,514033
araBp,0.25,3,3,TTCGATATCCGATCAGTAAC,0,525059
araBp,0.25,3,3,TTCCTGCCCTCACGTTGAAA,0,487211
araBp,0.25,3,3,TTCCGGCCTCCTGTACACAT,0,504848
araBp,0.25,3,3,TTCCGGCCGCTGGACAGACT,0,500470
araBp,0.25,3,3,TTCCGCCGCTTCACAGTGAC,0,497084
araBp,0.25,3,3,TTCATCTCACGGCAAATGGA,0,481137
araBp,0.25,3,3,TTCATCAATACGACTGAATG,0,475019
araBp,0.25,3,3,TTCATACGACTAGCGAGCTG,0,499439
araBp,0.25,3,3,TTCAGAGCGGTGAACAGGGT,0,475855
araBp,0.25,3,3,TTCAAGTAAGTGACGCTCAT,0,489208
araBp,0.25,3,3,TTCAACGCCGGCTAAAGCGT,0,511953
araBp,0.25,3,3,TTCAACCGAAGAAGGAGGTG,0,487573
araBp,0.25,3,3,TTATTTCTCATTAGTTGTGG,0,483425
araBp,0.25,3,3,TTATGTAGCTTCGCTCAAAA,0,485370
araBp,0.25,3,3,TTATGCGCGGAGATGCACGC,0,491466
araBp,0.25,3,3,TTATGAGGCCTTAGCTACAC,0,515574
araBp,0.25,3,3,TTATCGGCATCCACTAAGTG,0,469677
araBp,0.25,3,3,TTATAGGTTTGAAGATCAAA,0,491957
araBp,0.25,3,3,TTATACTTCGGAAGACAGGG,0,469712
araBp,0.25,3,3,TTATACTGAGGCAGCCGTGC,0,497910
araBp,0.25,3,3,TTAGTGGGCTTTACCACGGT,0,491854
araBp,0.25,3,3,TTAGTAAGCGGGCTTGTAAC,0,470511
araBp,0.25,3,3,TTAGTAAAGTGCACGCTGCA,0,481263
araBp,0.25,3,3,TTAGCCTGTAACCAGAAAAA,0,523351
araBp,0.25,3,3,TTACTTGGTAGCTGCTGCTG,0,496819
araBp,0.25,3,3,TTACTCAATAGACATGGTGT,0,482709
araBp,0.25,3,3,TTACTATCTTCAAAGCGTAA,0,491062
araBp,0.25,3,3,TTACTACCAACCACTTTGTT,0,472718
araBp,0.25,3,3,TTACGTCCTCATGCGCACAA,0,474011
araBp,0.25,3,3,TTACGGCATGCCTAATTCCC,0,500763
araBp,0.25,3,3,TTACCGGAGTCTGAATGGGT,0,503684
araBp,0.25,3,3,TTACATAACAGTGGTTCCAC,0,503211
araBp,0.25,3,3,TTACAGCATTCGCTGTCGAG,0,521439
araBp,0.25,3,3,TTAAGATGCACGGAATTGTA,0,483140
araBp,0.25,3,3,TTAACTTCAAGCCGTAGTTC,0,500338
araBp,0.25,3,3,TTAAAGCCTCCTTGGATATT,0,502189
araBp,0.25,3,3,TTAAACTTATGACTAAATAC,0,478998
araBp,0.25,3,3,TGTTTGGTTGGGTTGCCAAT,0,478655
araBp,0.25,3,3,TGTTTAACCGCGGCCAATAG,0,480190
araBp,0.25,3,3,TGTTGTTATCCCATACAGTA,0,523895
araBp,0.25,3,3,TGTTGAACATGGCGGTCCCC,0,473259
araBp,0.25,3,3,TGTTCCGTGTGGGTATCCAC,0,489750
araBp,0.25,3,3,TGTTATACGAGAGGAACTTA,0,507146
araBp,0.25,3,3,TGTTACACTGGGTACTCTGG,0,520746
araBp,0.25,3,3,TGTGGTGCTAGACGTAGGCG,0,478788
araBp,0.25,3,3,TGTGGTAGGGATTACACGGC,0,484231
araBp,0.25,3,3,TGTGCAATGGTGTGGAAAGC,0,490526
araBp,0.25,3,3,TGTGAGCCCACAGTAACAAC,0,488824
araBp,0.25,3,3,TGTGAGCCACCAGATGCAGA,0,515955
araBp,0.25,3,3,TGTGACGAGATGAGTGGCTG,0,512832
araBp,0.25,3,3,TGTGAAAACTGTCGCGGATT,0,488647
araBp,0.25,3,3,TGTCATAACGGAAGGCCCGA,0,494800
araBp,0.25,3,3,TGTCACCAGCACTCTTAGCA,0,513525
araBp,0.25,3,3,TGTCACACCTAACCTCGGGT,0,499670
araBp,0.25,3,3,TGTCAAGGCCCCGACGGTAT,0,512325
araBp,0.25,3,3,TGTATAGTAGTGCCGAAGCC,0,503814
araBp,0.25,3,3,TGTAGGGTGCTTCCAAAACG,0,493784
araBp,0.25,3,3,TGTACTTGCTTAAACTATTG,0,472173
araBp,0.25,3,3,TGTACGGTTACCAGGCACTC,0,482831
araBp,0.25,3,3,TGTACCAGGGCTCGAGCCGT,0,478296
araBp,0.25,3,3,TGGTTACTGATACTCTCGCA,0,524452
araBp,0.25,3,3,TGGTGTCGCGGGAGGCCGTC,0,472142
araBp,0.25,3,3,TGGTGGCCAGAGACGGTAGA,0,509133
araBp,0.25,3,3,TGGTGGAGGGTCGCTGACAA,0,468504
araBp,0.25,3,3,TGGTCACGACGGGTAAGAAA,0,470830
araBp,0.25,3,3,TGGTATGATTTTTCACATCA,0,523034
araBp,0.25,3,3,TGGGTGTCAGCAGTACAAGT,0,522875
araBp,0.25,3,3,TGGGTAGCGAGATCTGCCCG,0,487217
araBp,0.25,3,3,TGGGGGCATATTCGGTATTC,0,469215
araBp,0.25,3,3,TGGGGCAGTTTGGTAACTGG,0,482539
araBp,0.25,3,3,TGGGCGACAGAGTGGGCGGT,0,510486
araBp,0.25,3,3,TGGGCATGCCTCACCCTCGT,0,520602
araBp,0.25,3,3,TGGGAGTAGTGGGCAATCAC,0,498072
araBp,0.25,3,3,TGGGACAGGGCTCGTCAACT,0,491895
araBp,0.25,3,3,TGGGAATCCTATAGCCATTT,0,515818
araBp,0.25,3,3,TGGCTTCATACTAGCTCGGA,0,478162
araBp,0.25,3,3,TGGCTGCGGCATTATGGATC,0,503063
araBp,0.25,3,3,TGGCGAGTAACGATTACCCA,0,523308
araBp,0.25,3,3,TGGCCCCCATTGAGGTGAAG,0,515664
araBp,0.25,3,3,TGGCCATGTGCGCCATTGAC,0,478993
araBp,0.25,3,3,TGGCATGCCCCGACGGTCTT,0,506715
araBp,0.25,3,3,TGGCATGCACTCGTCGATGT,0,497304
araBp,0.25,3,3,TGGCAGAAACTTGTGTTGGC,0,484941
araBp,0.25,3,3,TGGCAACAAGTTATGGGACG,0,506825
araBp,0.25,3,3,TGGATTGCTGGTGGTTGTCT,0,522831
araBp,0.25,3,3,TGGATTATACGGCAGGTGGA,0,504258
araBp,0.25,3,3,TGGATCCGCTAAACATAGCG,0,512198
araBp,0.25,3,3,TGGACACGGGGCCAGAATAC,0,519593
araBp,0.25,3,3,TGGAATATTTGTAAAGTCAA,0,481451
araBp,0.25,3,3,TGCTTGTTGCAGCAACGTGA,0,510507
araBp,0.25,3,3,TGCTCTTCATCCACTGATTT,0,489161
araBp,0.25,3,3,TGCTCTACAGTTAAGAGAAC,0,471777
araBp,0.25,3,3,TGCTCCCACACGGCTCTAAC,0,493701
araBp,0.25,3,3,TGCGGTGTTCATTTACGGTG,0,468130
araBp,0.25,3,3,TGCGCATACTGCTAGTCACC,0,468119
araBp,0.25,3,3,TGCGATCGGGCGAAGGTATT,0,467807
araBp,0.25,3,3,TGCCTTGAGGAGCACGATCT,0,500106
araBp,0.25,3,3,TGCCTCCCTTATTGGGGGTG,0,478566
araBp,0.25,3,3,TGCCTAGGAAGTGTTGTTAC,0,525468
araBp,0.25,3,3,TGCCGTTCGCCATACTTAAC,0,502860
araBp,0.25,3,3,TGCCGTCGGACTCTGCTCGC,0,507471
araBp,0.25,3,3,TGCCCCGTCTGGATGATGCG,0,517142
araBp,0.25,3,3,TGCCCAGAACTCTGTTTACA,0,517741
araBp,0.25,3,3,TGCATCTCGGGTAGCAGGCG,0,498846
araBp,0.25,3,3,TGCATCTCATTGTAAGGTAC,0,485588
araBp,0.25,3,3,TGCATCGCCATTCATCTGGA,0,501637
araBp,0.25,3,3,TGCAGGCTGGCCGTACATGA,0,504127
araBp,0.25,3,3,TGCAGAATTCGAGTACTAAG,0,492225
araBp,0.25,3,3,TGATGTTATATGCTAAATGC,0,492407
araBp,0.25,3,3,TGATGTCGCGGAACGTGCCA,0,502182
araBp,0.25,3,3,TGATGTAGTAATATTGCCAG,0,500520
araBp,0.25,3,3,TGATGTACTTTAATTGTGAT,0,509231
araBp,0.25,3,3,TGATGGGGTACGAGGGGGGT,0,496573
araBp,0.25,3,3,TGATGGATACTCTACTCGAC,0,488757
araBp,0.25,3,3,TGATAGAATCCTACTTTGCC,0,468336
araBp,0.25,3,3,TGAGTTGCAGATTGGGCCAC,0,521829
araBp,0.25,3,3,TGAGTTATGTCTCTAGTCTC,0,505745
araBp,0.25,3,3,TGAGTGGCCAGATCCAGAGG,0,497590
araBp,0.25,3,3,TGAGGTATGTGAGTAGGCAA,0,469237
araBp,0.25,3,3,TGAGGATTCCCTGATGTGTA,0,496650
araBp,0.25,3,3,TGAGCTAGATCTGACCCGTC,0,487567
araBp,0.25,3,3,TGAGATAGGGCAACGTAGGC,0,485560
araBp,0.25,3,3,TGACTTTCTTTTACACTCGG,0,486273
araBp,0.25,3,3,TGACTGGGAACTACGTCCTT,0,501603
araBp,0.25,3,3,TGACGAAGTGCTCACGCCGA,0,485207
araBp,0.25,3,3,TGACACGGCGTACACCACCT,0,519020
araBp,0.25,3,3,TGAATCGAGAAAAACGGAAC,0,512254
araBp,0.25,3,3,TGAAGTGGCCGTGTTGACTT,0,500486
araBp,0.25,3,3,TGAAGTAAAACCGTACCGGT,0,518490
araBp,0.25,3,3,TGAAGGACCGTGCGTGCTAC,0,481923
araBp,0.25,3,3,TGAAGCAGTTAAGGAGCTGG,0,477692
araBp,0.25,3,3,TGAAGAACAAACCTACCTAT,0,515947
araBp,0.25,3,3,TGAACCGCACAACGAAAAGC,0,494581
araBp,0.25,3,3,TGAACAGGCTCGCGGGTGAA,0,484303
araBp,0.25,3,3,TCTTTGCCCGAGAGGGAGAC,0,487717
araBp,0.25,3,3,TCTTGGCCCCCTATGAATGC,0,497446
araBp,0.25,3,3,TCTTCGCTTCTTAGTATTCA,0,493300
araBp,0.25,3,3,TCTTATACTGCAGACGCTTT,0,488259
araBp,0.25,3,3,TCTTAGGACCTTCGCCATGC,0,492925
araBp,0.25,3,3,TCTGTGGAACTAAGAGGGGA,0,513542
araBp,0.25,3,3,TCTGTCGTAGGTGCTCGGCC,0,491851
araBp,0.25,3,3,TCTGGGATAAGTGTGATCCA,0,491114
araBp,0.25,3,3,TCTGGAACCCTAGCCTTTAC,0,486896
araBp,0.25,3,3,TCTCTTTGCAGCGCCACCCC,0,483707
araBp,0.25,3,3,TCTCGGCCACGGGTTCGTGC,0,504668
araBp,0.25,3,3,TCTCCTGGATAACATAAGGG,0,472604
araBp,0.25,3,3,TCTCCCTTTTTAGTATGATA,0,519848
araBp,0.25,3,3,TCTCCATGTGCAGAATACGA,0,472378
araBp,0.25,3,3,TCTCACCCTTTCGGTAGTGG,0,513093
araBp,0.25,3,3,TCTAGGGCTATTGCCCCCAC,0,479401
araBp,0.25,3,3,TCTAAAGTACCTGTAACTAA,0,480724
araBp,0.25,3,3,TCGTTTGGGTCCTAACACGA,0,504732
araBp,0.25,3,3,TCGTTGTCATTCCCGACTGG,0,481874
araBp,0.25,3,3,TCGTTCAGCGCACGTCTGGT,0,520545
araBp,0.25,3,3,TCGTGGGTTTGTTATCATGG,0,481693
araBp,0.25,3,3,TCGTCCGGGCAACGTGCCCG,0,514469
araBp,0.25,3,3,TCGTCAACCCAATAACTAAA,0,503529
araBp,0.25,3,3,TCGTAGCTCATAGCACAGGT,0,483233
araBp,0.25,3,3,TCGGTTCAAGCGACAAGGAG,0,510873
araBp,0.25,3,3,TCGGGGTCATAGAAGCATGA,0,472786
araBp,0.25,3,3,TCGGGCCTATCTCAGAGCAA,0,513421
araBp,0.25,3,3,TCGCGTTTGATAGATCGGGC,0,493633
araBp,0.25,3,3,TCGCGGAGGGGTTTCGGATT,0,514935
araBp,0.25,3,3,TCGCGCTCTCGATGTCGGCG,0,508225
araBp,0.25,3,3,TCGCGCTCGGAAGGATAAGG,0,474675
araBp,0.25,3,3,TCGCGCTAGTGGCTAACACA,0,484717
araBp,0.25,3,3,TCGCCGGACCGGCTTGAAAA,0,488575
araBp,0.25,3,3,TCGCCCGTTTCATCCTGGAT,0,477899
araBp,0.25,3,3,TCGCAGGCAGTATTGGCGGG,0,507843
araBp,0.25,3,3,TCGCAAGCGATTGTCCGCCA,0,484254
araBp,0.25,3,3,TCGATAAGGTTATAAGAGGT,0,515412
araBp,0.25,3,3,TCGAGAGTAGTCGAGAACGA,0,492279
araBp,0.25,3,3,TCGACTCATACCCAAGCCGC,0,487673
araBp,0.25,3,3,TCGAATTTCACCCATGAACA,0,500075
araBp,0.25,3,3,TCGAATCCCGGCTGCCCTGC,0,484057
araBp,0.25,3,3,TCCTTCTGAGAAGCTTTTGC,0,489089
araBp,0.25,3,3,TCCTCTGTGAGTGTGCGCGG,0,497127
araBp,0.25,3,3,TCCTACCCTAGGCATGTACT,0,473345
araBp,0.25,3,3,TCCGTGTGCTCGTGTTGATA,0,510296
araBp,0.25,3,3,TCCGTCGTGGGAAGCGAACC,0,511457
araBp,0.25,3,3,TCCGGCACCGGTTGTACTCA,0,476394
araBp,0.25,3,3,TCCGCGGTGCCACAGCTCGG,0,473547
araBp,0.25,3,3,TCCGCCCACTGGCATTTCAA,0,472892
araBp,0.25,3,3,TCCGAGGCATGAACAGCGAT,0,479395
araBp,0.25,3,3,TCCCTTTCGGTGGTGTTCTG,0,506771
araBp,0.25,3,3,TCCCTTCAATGGGGCTCGCT,0,467904
araBp,0.25,3,3,TCCCTGCCGAAGTCACGCTT,0,470968
araBp,0.25,3,3,TCCCTCGCTACCGTGATGGA,0,471605
araBp,0.25,3,3,TCCCGTTTCGGTCGCTGAAA,0,477838
araBp,0.25,3,3,TCCCGCTTAAAATTTATCTC,0,516113
araBp,0.25,3,3,TCCCGCCATCTGATTGGTGT,0,478392
araBp,0.25,3,3,TCCCAGGGTTTTAAAGAACA,0,515809
araBp,0.25,3,3,TCCATCAATGTTCTAAGATA,0,507718
araBp,0.25,3,3,TCCAATGTTCAAGTGCGCCT,0,470513
araBp,0.25,3,3,TCCAAGACGGGCTCTGTAGG,0,468237
araBp,0.25,3,3,TCATGGAGAAACGGAGCGTG,0,468685
araBp,0.25,3,3,TCATGCCCTCTGGGAGAGGA,0,513785
araBp,0.25,3,3,TCATCGTGTGCTACTCTATA,0,524187
araBp,0.25,3,3,TCATATCCTTAAGTATGCTG,0,501917
araBp,0.25,3,3,TCAGTGCACATACGGATGTT,0,505122
araBp,0.25,3,3,TCAGGCCAGGTACGAACGAA,0,481461
araBp,0.25,3,3,TCAGGACCAGGGGGTTTCTC,0,517631
araBp,0.25,3,3,TCAGCGAAACAAAATACTAT,0,512969
araBp,0.25,3,3,TCAGACCTTGAGCAGCACAC,0,473279
araBp,0.25,3,3,TCAGAACTGTTGGACCTTTA,0,470262
araBp,0.25,3,3,TCACTACTTGAAGGTCCGGC,0,495191
araBp,0.25,3,3,TCACAGCTCGTCTCCACCTT,0,513774
araBp,0.25,3,3,TCACACAATAAAGTACGGAA,0,472842
araBp,0.25,3,3,TCAAGATCAGCCTAGGGAGG,0,504527
araBp,0.25,3,3,TCAAGAGAAACTCTTCTCAT,0,519938
araBp,0.25,3,3,TCAACTTAGGTTCTTTGCGC,0,496818
araBp,0.25,3,3,TCAACACGTAGTGCGGTGCT,0,490987
araBp,0.25,3,3,TCAACAACCCGCGCTCTCTT,0,487858
araBp,0.25,3,3,TATTTCGATATGCAGGGGTC,0,502505
araBp,0.25,3,3,TATTTAATCTCAGCTAGTTT,0,506600
araBp,0.25,3,3,TATTGGCCAATTCTCTCATT,0,515527
araBp,0.25,3,3,TATTAGTTGTACATTAATAT,0,513236
araBp,0.25,3,3,TATGTATACATCGTACTCTC,0,513511
araBp,0.25,3,3,TATGGGTGAATTCCAACCTT,0,508092
araBp,0.25,3,3,TATGGGGTATAATGCAGGAT,0,518800
araBp,0.25,3,3,TATGGAGTATGTGGATCAAA,0,522329
araBp,0.25,3,3,TATGCTACTGGAAGTTTATA,0,473073
araBp,0.25,3,3,TATGCGTGTTCATCTGAATG,0,492437
araBp,0.25,3,3,TATGCAGTTGGTCCGAGGAC,0,468041
araBp,0.25,3,3,TATGAAAATAGATTGCCAAC,0,519167
araBp,0.25,3,3,TATCTGAGTACACCTGAAGC,0,477091
araBp,0.25,3,3,TATCTGAAGGTCACAGGAGT,0,481718
araBp,0.25,3,3,TATCTACAGAGTTACTGTGT,0,510421
araBp,0.25,3,3,TATCCGGCATCGCAGAGATT,0,510236
araBp,0.25,3,3,TATCCAACTCTGAGCACACC,0,505319
araBp,0.25,3,3,TATCATAACACAGACAAAGA,0,500329
araBp,0.25,3,3,TATAGGCAATAGTTCCAGGG,0,514327
araBp,0.25,3,3,TATACTTATCCAAGAGAGAG,0,492464
araBp,0.25,3,3,TATAAGATCGTGTGGCCCTA,0,474932
araBp,0.25,3,3,TAGTGTCCCATTCACGGTTA,0,481497
araBp,0.25,3,3,TAGTGGGCCTTTATCCAGCA,0,505255
araBp,0.25,3,3,TAGTGAAGTGAGCACCTGCG,0,490024
araBp,0.25,3,3,TAGGGTACGCACGCATGACT,0,487134
araBp,0.25,3,3,TAGGGGAAAGTTCTTCGGTT,0,502068
araBp,0.25,3,3,TAGGCTCCAAGTATCAGCGA,0,472467
araBp,0.25,3,3,TAGGCCGCCTCGGGTCGTGG,0,524539
araBp,0.25,3,3,TAGGCAGTTGCCAGGCTCCC,0,505092
araBp,0.25,3,3,TAGGAGTTCATTCAGCGGTC,0,467981
araBp,0.25,3,3,TAGGACTTGTAAGCGGATTG,0,471952
araBp,0.25,3,3,TAGGAACGTGTCATCTCGCC,0,499394
araBp,0.25,3,3,TAGCTTGCGAAAGCTAGCAT,0,502405
araBp,0.25,3,3,TAGCTTCGAGGTCGGGGATT,0,493861
araBp,0.25,3,3,TAGCGCGTGCGTCCTACGAG,0,493045
araBp,0.25,3,3,TAGCAGTCCGACACCTGACG,0,494658
araBp,0.25,3,3,TAGCAGAGAAGGCTTTCGAA,0,484287
araBp,0.25,3,3,TAGATTGCGTGTGTGATTTT,0,479369
araBp,0.25,3,3,TAGAGCCGCAACTAGATAGA,0,491808
araBp,0.25,3,3,TAGACCCGCATTTTTTCAGG,0,489036
araBp,0.25,3,3,TAGAAGAGTATTAGACCCGG,0,472314
araBp,0.25,3,3,TACTTTGGCTTTTTTGCGGC,0,516217
araBp,0.25,3,3,TACTCTAAGCGCTACGAAGG,0,500180
araBp,0.25,3,3,TACTCGCTAAAAGGGATCAT,0,523722
araBp,0.25,3,3,TACTCCGCCACGACCATCCC,0,521490
araBp,0.25,3,3,TACGTGTAACCTTTTCGACA,0,511444
araBp,0.25,3,3,TACGTGAGCGTGATTGAGGG,0,491632
araBp,0.25,3,3,TACGGTTATTTGGCCGTGAT,0,494092
araBp,0.25,3,3,TACGCCACGCCCGTTAGTCA,0,507975
araBp,0.25,3,3,TACCTTTCATCATTTGGCTT,0,468474
araBp,0.25,3,3,TACCTCAATCTGGATAAGAG,0,478275
araBp,0.25,3,3,TACCGCGCCTTCTGTGGACG,0,506135
araBp,0.25,3,3,TACCGAGGCCTCAGGATACT,0,517500
araBp,0.25,3,3,TACCGACCGAAGGCCGGCGA,0,470886
araBp,0.25,3,3,TACCCGCGCCGTCTGTGTAG,0,511733
araBp,0.25,3,3,TACCCGCACATGAAACAGCA,0,483113
araBp,0.25,3,3,TACAATGAGTTCGATTGTAT,0,489250
araBp,0.25,3,3,TACAAGTGCGTGTCGGCCCC,0,484872
araBp,0.25,3,3,TACAACCAGGTGGACAGGAT,0,500683
araBp,0.25,3,3,TAATTTTGCTGCGGGGAGCC,0,479587
araBp,0.25,3,3,TAATTTTCTCCCTCTGGCTC,0,519110
araBp,0.25,3,3,TAATGATGTCTCGGCGGGGG,0,493301
araBp,0.25,3,3,TAATCTGATAGTGAAACAGT,0,522081
araBp,0.25,3,3,TAATATGAATTAGGTTAAAG,0,506170
araBp,0.25,3,3,TAATAGCTCAAACTCTCCCC,0,513613
araBp,0.25,3,3,TAAGTTCAGGCTCTCACCGG,0,485656
araBp,0.25,3,3,TAAGTGTAAGCTGGCCGGAT,0,505234
araBp,0.25,3,3,TAAGTCTGAATCGACGGCCC,0,507964
araBp,0.25,3,3,TAAGGATTATTATATGATGT,0,468232
araBp,0.25,3,3,TAAGGACGTCGTTTTAGTCC,0,487466
araBp,0.25,3,3,TAACGGCCGCTATGACGAGA,0,522147
araBp,0.25,3,3,TAACCGGTGCGACGGAACCC,0,513335
araBp,0.25,3,3,TAAATGGATGCCGGGCCTTC,0,524584
araBp,0.25,3,3,TAAATCGAATTCAGCCTATA,0,481306
araBp,0.25,3,3,TAAAGTGGCAATAATAGCTC,0,515615
araBp,0.25,3,3,TAAAGTCGGGCGCAAGGTGC,0,498375
araBp,0.25,3,3,TAAACAAGCGGTCCCGGATT,0,488190
araBp,0.25,3,3,GTTTTTGCCGTCAGTATCTT,0,501440
araBp,0.25,3,3,GTTTTTAGAAGGAAACTCGC,0,511299
araBp,0.25,3,3,GTTTGTCGGCTGACGGAACT,0,485471
araBp,0.25,3,3,GTTTGTCATGCAAGTGAAAG,0,481868
araBp,0.25,3,3,GTTTCTGTCACGCCGTCGGC,0,478055
araBp,0.25,3,3,GTTTCTCGGCTGGCCCATGT,0,493747
araBp,0.25,3,3,GTTTCTCACAGCAGATGTTT,0,494406
araBp,0.25,3,3,GTTTCGCGTGAAGCCATAAT,0,517440
araBp,0.25,3,3,GTTTAGGGGGGGGTAGCAAT,0,479230
araBp,0.25,3,3,GTTTAGGGCTGTCTGACCTT,0,472854
araBp,0.25,3,3,GTTTAACTTTTGGTAGCACC,0,482874
araBp,0.25,3,3,GTTTAAAGTGGGACGTCGGT,0,481919
araBp,0.25,3,3,GTTGGGCGTTATAGCCTGGA,0,513820
araBp,0.25,3,3,GTTGAACATTCAAAGTTGAA,0,494452
araBp,0.25,3,3,GTTCTTGTCACCATGCGCGG,0,468609
araBp,0.25,3,3,GTTCTTCATCACCTTATAGT,0,514623
araBp,0.25,3,3,GTTCTTACAGGCTTAACCAC,0,470097
araBp,0.25,3,3,GTTCTATAGTAGGATTCTTC,0,473802
araBp,0.25,3,3,GTTCGCAGTCAATCAGTGGA,0,476083
araBp,0.25,3,3,GTTCGACCCTCCCATATCCA,0,484332
araBp,0.25,3,3,GTTCGACATATGACGAAATC,0,488659
araBp,0.25,3,3,GTTCATCCTGATCGTTTCCT,0,480481
araBp,0.25,3,3,GTTCAATCCTGGGGCATTCT,0,497081
araBp,0.25,3,3,GTTCAAAAGCATAGTGCCGC,0,508273
araBp,0.25,3,3,GTTAGGGGAGTATTCCCGGA,0,470868
araBp,0.25,3,3,GTTAGATCAATCATTGCTTT,0,490666
araBp,0.25,3,3,GTTAGACGACCTCTGGGAAG,0,523962
araBp,0.25,3,3,GTTACTACCATCAACCCGTT,0,500832
araBp,0.25,3,3,GTTACGGGAACGCATGTCGT,0,507269
araBp,0.25,3,3,GTTACGCAGCGCGGTTGAGG,0,493062
araBp,0.25,3,3,GTTACGAGCTCTAGAGCTTT,0,513069
araBp,0.25,3,3,GTTAATCCTTGGGCCGGCTT,0,507639
araBp,0.25,3,3,GTTAAGTCGATTATTGCCAT,0,504472
araBp,0.25,3,3,GTGTGTTGTCCAGTCTAGGA,0,490781
araBp,0.25,3,3,GTGTGTCGCTTTTGAGAGTT,0,517602
araBp,0.25,3,3,GTGTCCTGAGGTAGTGGTTA,0,519296
araBp,0.25,3,3,GTGTAATTGGGGGTGGCAAC,0,472259
araBp,0.25,3,3,GTGGTGACATGTCAGCAAAG,0,467932
araBp,0.25,3,3,GTGGTCCGCTACTGGTCAGG,0,523431
araBp,0.25,3,3,GTGGTCCGAAGAAGAGCACA,0,523057
araBp,0.25,3,3,GTGGTAGACGGGATCCTTCA,0,478565
araBp,0.25,3,3,GTGGCTTCAGGTATTTAAGC,0,521809
araBp,0.25,3,3,GTGCTATGCCAGTTTCGTAG,0,502091
araBp,0.25,3,3,GTGCGTACCCGACGTAGCAA,0,521462
araBp,0.25,3,3,GTGCCTTGGAGCCGCGGTCA,0,519424
araBp,0.25,3,3,GTGCCCTAAAGGGTGGGGAT,0,491581
araBp,0.25,3,3,GTGATATCGCGAGATCTAGA,0,485601
araBp,0.25,3,3,GTGACTTCAAATGATTATGT,0,524154
araBp,0.25,3,3,GTGACGTGGACCGACGTAGT,0,500524
araBp,0.25,3,3,GTGACCGGAGGCAACGTCTT,0,522438
araBp,0.25,3,3,GTCTTCCCTATCGGACGAGG,0,498511
araBp,0.25,3,3,GTCTGTTTTGAGTATCCTAA,0,482456
araBp,0.25,3,3,GTCTGGTTCGGATAACGGCT,0,507221
araBp,0.25,3,3,GTCTGCGACTGGCTAAACGG,0,473622
araBp,0.25,3,3,GTCTACTGTTGGATATTCTC,0,481832
araBp,0.25,3,3,GTCTAATGGTAGACAAACGC,0,471320
araBp,0.25,3,3,GTCTAACGGTCCCTCGTAAC,0,473033
araBp,0.25,3,3,GTCGTTGGGTAATCCGCAGG,0,477003
araBp,0.25,3,3,GTCGGCTGGAGTTACATTGA,0,478464
araBp,0.25,3,3,GTCGGCTCAACAGTGCAATA,0,498841
araBp,0.25,3,3,GTCGGATCTTTTTGAATCGG,0,512937
araBp,0.25,3,3,GTCGCTCCTTAGGGTACCCA,0,508843
araBp,0.25,3,3,GTCGCGTTCTATAAACAGGC,0,520577
araBp,0.25,3,3,GTCGCCATGTAAGTGGTTAA,0,477803
araBp,0.25,3,3,GTCGATCTCACGACATCATC,0,498103
araBp,0.25,3,3,GTCCTCGATAAGCATTCATC,0,501549
araBp,0.25,3,3,GTCCCTACCTCGCGTACGAG,0,498809
araBp,0.25,3,3,GTCCCGCAGCTCACACCGAG,0,517326
araBp,0.25,3,3,GTCCCCGCAGCTTCCTTATT,0,496497
araBp,0.25,3,3,GTCCCACACGGGCTTGGGGT,0,471947
araBp,0.25,3,3,GTCCAGCCGGATGGTCTTAT,0,521205
araBp,0.25,3,3,GTCCAAAATATCGATCCGCA,0,506350
araBp,0.25,3,3,GTCATAAGTGGACAAATCAC,0,474553
araBp,0.25,3,3,GTCACGGGCCGGTGTAAGGA,0,476060
araBp,0.25,3,3,GTCAATCTGCTGATGCGGGA,0,515997
araBp,0.25,3,3,GTCAACGGTGGGATACGCTA,0,474063
araBp,0.25,3,3,GTCAACCCAAGGGTATCGTG,0,505057
araBp,0.25,3,3,GTATGGAGCTCCATCCCTTT,0,475393
araBp,0.25,3,3,GTATGATGCCAAGTTGAGTG,0,467844
araBp,0.25,3,3,GTATATGAAGATTATGGAAG,0,511867
araBp,0.25,3,3,GTAGTGCCGAATCTCGTTGC,0,478645
araBp,0.25,3,3,GTAGTCAGTTGCCATCACAT,0,517176
araBp,0.25,3,3,GTAGTAGCGACGTATCGAAT,0,487737
araBp,0.25,3,3,GTAGGCTGGTCTGGAAGCGA,0,510302
araBp,0.25,3,3,GTAGGCCCGTTCCACAGAGA,0,478491
araBp,0.25,3,3,GTAGGAAATGGCGCACACCG,0,501254
araBp,0.25,3,3,GTAGCTTTAGTGTGGGAAGC,0,508612
araBp,0.25,3,3,GTAGCAAGTCAGGAGTTTTT,0,515329
araBp,0.25,3,3,GTAGACGCGGATAGGGGCAG,0,513680
araBp,0.25,3,3,GTAGACCCTTTGCGGGGAAC,0,477461
araBp,0.25,3,3,GTACTAGGCTGAATATGGCC,0,469728
araBp,0.25,3,3,GTACGGTAGAGGCGGATAGC,0,496806
araBp,0.25,3,3,GTACCGAGAAGGACGTAAGA,0,512372
araBp,0.25,3,3,GTAAGTTCTCTTTCAGCCGG,0,483271
araBp,0.25,3,3,GTAAGTCGATGAGGGCGCGC,0,507862
araBp,0.25,3,3,GTAACTGGCTCCATGCCAAA,0,488957
araBp,0.25,3,3,GTAACTCATAACTCCGTCAT,0,518896
araBp,0.25,3,3,GTAAATTTACGAGTTATAGC,0,501012
araBp,0.25,3,3,GTAAAGGGAACCTTCCATTG,0,506017
araBp,0.25,3,3,GTAAAGATCGAAAGTCGTCT,0,503132
araBp,0.25,3,3,GTAAACGACATGATGATGGG,0,477689
araBp,0.25,3,3,GGTTCTGAGTTGGAAACACG,0,470706
araBp,0.25,3,3,GGTTCTAGAACACATGTGTC,0,520669
araBp,0.25,3,3,GGTTCATGGTAGCAGGCATT,0,502373
araBp,0.25,3,3,GGTTAGCCGCGTGCGGGCAG,0,470508
araBp,0.25,3,3,GGTTACGGTCCGCTCAGGAG,0,492235
araBp,0.25,3,3,GGTGGACTCCAGAGAAAGGG,0,485414
araBp,0.25,3,3,GGTGCCTTGCGGAATGACAG,0,490765
araBp,0.25,3,3,GGTGATTTAACGTAATATTA,0,500458
araBp,0.25,3,3,GGTCTATATAAAGCATGGGC,0,519496
araBp,0.25,3,3,GGTCGATATCGGCTGCGATC,0,490817
araBp,0.25,3,3,GGTCGAACCAAGATTAGGAA,0,517024
araBp,0.25,3,3,GGTCCTCCTCTACTAAACGG,0,483995
araBp,0.25,3,3,GGTCAGGGTCTTGACAGAGG,0,473866
araBp,0.25,3,3,GGTCACTGCCTGTCGTTCGA,0,497195
araBp,0.25,3,3,GGTCAAAGTGTTAACCCGCG,0,476861
araBp,0.25,3,3,GGTATTATTGAAGCACTCCC,0,469377
araBp,0.25,3,3,GGTAGCATTTAAGACTGCCT,0,496381
araBp,0.25,3,3,GGTAGCAAGCGTTTGGAGAT,0,473855
araBp,0.25,3,3,GGTAGAGGTATCAGAGTGGT,0,503763
araBp,0.25,3,3,GGTAACTTCGTTCTGCTGGA,0,524741
araBp,0.25,3,3,GGTAACTGTGAAAGACAAGT,0,478413
araBp,0.25,3,3,GGTAAAAATGACTACGGACT,0,495760
araBp,0.25,3,3,GGGTTTGGTTAACCTATCGT,0,521304
araBp,0.25,3,3,GGGTTTAGGCCCCGCGCCAT,0,474855
araBp,0.25,3,3,GGGTTGGAACCCATGCAAGC,0,470282
araBp,0.25,3,3,GGGTTACCTATATTTTCGGA,0,475916
araBp,0.25,3,3,GGGTGTGTGTATAAACTTAT,0,490688
araBp,0.25,3,3,GGGTGTCTTACTTATACGAT,0,500407
araBp,0.25,3,3,GGGTGGCAGTGTCTATGCGC,0,494360
araBp,0.25,3,3,GGGTGCGTTTGCGCTGTTGA,0,523028
araBp,0.25,3,3,GGGTCTGTAGGTTTGAGAGT,0,508340
araBp,0.25,3,3,GGGTCTCGGATCTCATTGAA,0,507766
araBp,0.25,3,3,GGGTCCCGGTTATTGGCTTT,0,472686
araBp,0.25,3,3,GGGTAGAGTAGCCCGTAGGG,0,470912
araBp,0.25,3,3,GGGTAAACTCCATTAGAATA,0,506425
araBp,0.25,3,3,GGGGTGAGATTTCAGCCAAG,0,507717
araBp,0.25,3,3,GGGGTCTCTGTGCTCACAAT,0,495879
araBp,0.25,3,3,GGGGTCAGGGGCAGTTAAGA,0,479692
araBp,0.25,3,3,GGGGTAGGGTCTCGTACACA,0,501946
araBp,0.25,3,3,GGGGTAAATTCTCAACTTTG,0,481984
araBp,0.25,3,3,GGGGCAGTGTAGGGCGGCAA,0,470630
araBp,0.25,3,3,GGGCTGCTTCGGGGCTTGGA,0,473584
araBp,0.25,3,3,GGGCTCTTGGGACCCAATAG,0,468401
araBp,0.25,3,3,GGGCTAGGAAGTTGAACTGT,0,494478
araBp,0.25,3,3,GGGCGGACACATCGTTAGTT,0,476464
araBp,0.25,3,3,GGGCGACGTGTATCGTATCA,0,511680
araBp,0.25,3,3,GGGCCAAATTCGAGCATTCA,0,499944
araBp,0.25,3,3,GGGATTATGTATGCCTACTT,0,477231
araBp,0.25,3,3,GGGAGTCTCGATACCCGGTT,0,490762
araBp,0.25,3,3,GGGACGAAAGACAATAATGG,0,521434
araBp,0.25,3,3,GGGAATTACGAAGCGGGCTT,0,502227
araBp,0.25,3,3,GGGAACATCCGACTAATGTG,0,506042
araBp,0.25,3,3,GGCTTGGGGGAGCGGTTCAG,0,486934
araBp,0.25,3,3,GGCTTGAGATCGAGGACGGT,0,518398
araBp,0.25,3,3,GGCTTCATCATGCGTTAGTA,0,483225
araBp,0.25,3,3,GGCTGTCCGTCCCTGACACT,0,524266
araBp,0.25,3,3,GGCTCGATTATCATAACCAC,0,497109
araBp,0.25,3,3,GGCTCCTACCGGTAACGGGA,0,492837
araBp,0.25,3,3,GGCTCAAGACCTGATGTGTC,0,501863
araBp,0.25,3,3,GGCTCAAATTCCATGGAGCC,0,502432
araBp,0.25,3,3,GGCTAAGTACAGCAACCAGA,0,505682
araBp,0.25,3,3,GGCGTGATGCCTTGGAATTG,0,521176
araBp,0.25,3,3,GGCGCACAGTTACCTCAGGT,0,485365
araBp,0.25,3,3,GGCCGCTAGCTTGATTTTGT,0,504418
araBp,0.25,3,3,GGCCGCCTACTTGGTGGACT,0,493150
araBp,0.25,3,3,GGCCCCAAAGGTAGGGGTAC,0,474536
araBp,0.25,3,3,GGCCATTGCATTCAATGATA,0,502307
araBp,0.25,3,3,GGCCAATAGTCTGGCCCAAG,0,501264
araBp,0.25,3,3,GGCCAACCTCATAGTATACC,0,506055
araBp,0.25,3,3,GGCATTTACTAAAAAGCGCA,0,507727
araBp,0.25,3,3,GGCATCCACTGAGCGATCCA,0,522701
araBp,0.25,3,3,GGCAGGTTTCTCCTCTTCAA,0,482584
araBp,0.25,3,3,GGCAGGTATTCTGTGGCGAC,0,522346
araBp,0.25,3,3,GGCAGGCCAAGTTCATTTGT,0,484467
araBp,0.25,3,3,GGATTCTCTATCAGCCCAGT,0,470572
araBp,0.25,3,3,GGATGCAGGCCCCAAATGTG,0,518246
araBp,0.25,3,3,GGATCTCACTTCTAATATTG,0,498632
araBp,0.25,3,3,GGAGTGGGGCTAACCTGGAT,0,493758
araBp,0.25,3,3,GGAGTCCCCGGACCGACTGT,0,499672
araBp,0.25,3,3,GGAGTAGAGGCGCGGGTAAG,0,505067
araBp,0.25,3,3,GGAGGTCCCACCACATGAAT,0,507539
araBp,0.25,3,3,GGAGGCTGATGGAAGATGTA,0,474555
araBp,0.25,3,3,GGAGATCAGTCAGACTTTGA,0,512866
araBp,0.25,3,3,GGAGATATTTAATAACCAGT,0,516740
araBp,0.25,3,3,GGAGAGCATAAAGATGTCTT,0,468087
araBp,0.25,3,3,GGAGACATCCGTTATGGTCC,0,509036
araBp,0.25,3,3,GGACCCTAGAATAATACCTT,0,518004
araBp,0.25,3,3,GGACCACTTCCTCCGCAACA,0,480295
araBp,0.25,3,3,GGACCACCTAAAAAAAGAAA,0,514981
araBp,0.25,3,3,GGACCAAGGATACAACTGAG,0,523153
araBp,0.25,3,3,GGACATTTGTCGGAAGCCAC,0,502984
araBp,0.25,3,3,GGACATTGTCTCTAGACGGC,0,506423
araBp,0.25,3,3,GGACAGTGCATGATCCCTGA,0,498628
araBp,0.25,3,3,GGACACCAGTTCCTCAACCG,0,491348
araBp,0.25,3,3,GGACAATACAACAGGAACAA,0,502234
araBp,0.25,3,3,GGAAGTCTAGTGTTATGAGC,0,481499
araBp,0.25,3,3,GGAAGGCTAAATTCATACCA,0,472610
araBp,0.25,3,3,GGAAGACGCGGGGAACATCG,0,514108
araBp,0.25,3,3,GGAAAGCTTGTTGGGGAGTG,0,493571
araBp,0.25,3,3,GCTTGTCGAATTGGGACCCT,0,493049
araBp,0.25,3,3,GCTTGCTCCGATCGTTTAAA,0,499806
araBp,0.25,3,3,GCTTCTCATGTATCGCTGCG,0,502989
araBp,0.25,3,3,GCTTCAGTTACTATGCGGGG,0,485791
araBp,0.25,3,3,GCTGGATAAGTGGTCATAAT,0,511437
araBp,0.25,3,3,GCTGCTGCTGTACATGATGA,0,478821
araBp,0.25,3,3,GCTGCGATGTTTCGACAAAT,0,476911
araBp,0.25,3,3,GCTGCATTGGTGGGGGTTGT,0,524186
araBp,0.25,3,3,GCTCGTGGGCTTGTATGGAA,0,521562
araBp,0.25,3,3,GCTCGTGGCTCACTGCATAT,0,507679
araBp,0.25,3,3,GCTCGGTCGGACCTGTTAAA,0,468912
araBp,0.25,3,3,GCTCCGGATAGGTGACTAGA,0,471663
araBp,0.25,3,3,GCTCCGATATGTTTTTCTTT,0,511950
araBp,0.25,3,3,GCTCCCACGATAGGCAGTCA,0,477058
araBp,0.25,3,3,GCTCCACTGGAGCCACACAG,0,510173
araBp,0.25,3,3,GCTCAACCCTCGGGGACCAC,0,476059
araBp,0.25,3,3,GCTATGCTTGAGTCCGCTGC,0,474307
araBp,0.25,3,3,GCTATCGATGCATGGTCCAG,0,494698
araBp,0.25,3,3,GCTATCAGGTATAACCACAG,0,496628
araBp,0.25,3,3,GCTATAGGGTTCAGCTGATC,0,472852
araBp,0.25,3,3,GCTACCGGTCACCTCACGCT,0,485563
araBp,0.25,3,3,GCTACATACAATGGCGCTAG,0,496959
araBp,0.25,3,3,GCGTGTGGCCTGAGCACAAA,0,486480
araBp,0.25,3,3,GCGTGTCACAAAATTGAGAC,0,481267
araBp,0.25,3,3,GCGTGGTCAACGGATTGTCA,0,516163
araBp,0.25,3,3,GCGTGCCCGAGGAGGACTCT,0,475192
araBp,0.25,3,3,GCGTCTTTTCTCGCAAAGCT,0,469613
araBp,0.25,3,3,GCGTCCTCACCAGCGCATAC,0,514651
araBp,0.25,3,3,GCGTCCGCATGAAGGGAACA,0,471563
araBp,0.25,3,3,GCGTCACCTGAAGAATTCTA,0,479461
araBp,0.25,3,3,GCGTAGTCCTGAGGTCAGTC,0,472915
araBp,0.25,3,3,GCGTAAGAAACGTTCTGGAG,0,489872
araBp,0.25,3,3,GCGGGTGTCGTTTTGTTATG,0,506310
araBp,0.25,3,3,GCGGGCACACTATCATTCCC,0,485766
araBp,0.25,3,3,GCGGATGATAACAGGTGATT,0,470872
araBp,0.25,3,3,GCGCTTTAGTCTTCGCAGAG,0,521618
araBp,0.25,3,3,GCGCCCGTCGGAACTTGGCT,0,492242
araBp,0.25,3,3,GCGCAGTTGCGCGTAAATAT,0,501993
araBp,0.25,3,3,GCGAGTCTATGAACCACCCT,0,507954
araBp,0.25,3,3,GCGAGGGGAGGATACAGTGG,0,516042
araBp,0.25,3,3,GCGAGGATTTCTCACATCAT,0,482818
araBp,0.25,3,3,GCGACGGCCTCTTGCCGCTC,0,505959
araBp,0.25,3,3,GCCTTTCAATTCCTGTCATG,0,511888
araBp,0.25,3,3,GCCTTTAACCTAGGTCCGTA,0,518399
araBp,0.25,3,3,GCCTTGGTAGAAAATCCGTT,0,476411
araBp,0.25,3,3,GCCTGGAAAGATGGACCACA,0,519032
araBp,0.25,3,3,GCCTGCTGTTCCCGGACCTC,0,472341
araBp,0.25,3,3,GCCTATGCGACGTCATTCCA,0,496225
araBp,0.25,3,3,GCCTATCGGCCCGACTGACC,0,505156
araBp,0.25,3,3,GCCTAGCCGTACACAAATCG,0,513593
araBp,0.25,3,3,GCCGTTCCTTACAGGCCTTA,0,476335
araBp,0.25,3,3,GCCGGCCGTGTGATGCCATG,0,470566
araBp,0.25,3,3,GCCGGATGAGCCGTAACGAA,0,490924
araBp,0.25,3,3,GCCGCGTTCTATTAAAGTCC,0,502345
araBp,0.25,3,3,GCCGCGACGCCGTTGGGAGC,0,478195
araBp,0.25,3,3,GCCGCAGAGACACAATTGGA,0,522274
araBp,0.25,3,3,GCCGCAGACTATGGGGACTG,0,491378
araBp,0.25,3,3,GCCGCACAAAGCCTAGCCGA,0,523454
araBp,0.25,3,3,GCCGACGATTCCCTGGTTAC,0,505115
araBp,0.25,3,3,GCCCTTGAATCTGCGTATAA,0,471357
araBp,0.25,3,3,GCCCGTCTCGGCGGACCTGG,0,500981
araBp,0.25,3,3,GCCCGGGAAATAAATATAAT,0,491478
araBp,0.25,3,3,GCCCATTCGGTAGGTGTGTG,0,501962
araBp,0.25,3,3,GCCATGGTTTGGCTGGAGGG,0,499996
araBp,0.25,3,3,GCCAGTGAGGCAGTTCTAAA,0,488379
araBp,0.25,3,3,GCCAGTCCTTGGGGGCCAAA,0,508374
araBp,0.25,3,3,GCCAGTAAGCACGTTAAGTA,0,486600
araBp,0.25,3,3,GCCAGAGCGCCAGGCCCGGA,0,507496
araBp,0.25,3,3,GCCAGAAACAGTAGTTGCAA,0,493500
araBp,0.25,3,3,GCCACCGTAGCGCAGTGGTC,0,525412
araBp,0.25,3,3,GCCACCGAAGGAGTTCTACA,0,488496
araBp,0.25,3,3,GCCAACAGTCCTTCTGTAAT,0,500849
araBp,0.25,3,3,GCCAACAAGGCACAACGAAC,0,476648
araBp,0.25,3,3,GCCAAATGGCATGCAAGCGT,0,504081
araBp,0.25,3,3,GCATTACCGTCGCAGCCTGA,0,520490
araBp,0.25,3,3,GCATTAATTGCAGCCCCGGG,0,504247
araBp,0.25,3,3,GCATCGTATCGGGTACTCTC,0,520629
araBp,0.25,3,3,GCATCATACGCACTAGCACT,0,524975
araBp,0.25,3,3,GCATAAGTCATTTGTGTATC,0,523607
araBp,0.25,3,3,GCATAACACCGGTGAGGGCG,0,473997
araBp,0.25,3,3,GCATAAAGCCTCAACGGGTC,0,471204
araBp,0.25,3,3,GCAGTACCCAGCGTAAGAGA,0,478637
araBp,0.25,3,3,GCAGCGAGAGGCTCATTACT,0,473900
araBp,0.25,3,3,GCAGCCGCGTTACAGGAGCT,0,483961
araBp,0.25,3,3,GCAGCCCCTGGCGGGCAAGG,0,478107
araBp,0.25,3,3,GCAGAAAGGTATAATTTGAG,0,479181
araBp,0.25,3,3,GCACTCATGGGAGTATAACA,0,500406
araBp,0.25,3,3,GCACGTCGTGAGGCCGCGTA,0,499068
araBp,0.25,3,3,GCACCGATATTGCCTGATAA,0,478933
araBp,0.25,3,3,GCACAGACCCTCTCCGAGGG,0,490931
araBp,0.25,3,3,GCACAAGGTATGAACTAGCA,0,524782
araBp,0.25,3,3,GCACAAATTGCTAGAGCCGA,0,490596
araBp,0.25,3,3,GCAAGGCCCAGGGTTCGGCC,0,488254
araBp,0.25,3,3,GCAAGCTGTGACCGAGATGA,0,509046
araBp,0.25,3,3,GCAACTGATCATATAGTAAT,0,521335
araBp,0.25,3,3,GCAACGGAGGTAGGTCGGTG,0,481887
araBp,0.25,3,3,GCAACATGGCTATTGCGATA,0,481667
araBp,0.25,3,3,GCAAATGGCAGCCTCATTAA,0,509574
araBp,0.25,3,3,GCAAAGCCTCACCAATGTCT,0,505943
araBp,0.25,3,3,GCAAACAACCCGGCGCACCC,0,522698
araBp,0.25,3,3,GATTTGCGATTACTTACTAT,0,474696
araBp,0.25,3,3,GATTTCGTGAACCGATCCTG,0,522671
araBp,0.25,3,3,GATTTCGTCTTCAATAGGTG,0,508932
araBp,0.25,3,3,GATTTAGTCCAGAGGCGTAG,0,475862
araBp,0.25,3,3,GATTTACTCAGGCACTGCAA,0,495380
araBp,0.25,3,3,GATTGGTCTACCCACACGTG,0,488404
araBp,0.25,3,3,GATTGGGACTGGTGACGAAT,0,509643
araBp,0.25,3,3,GATTGCGTCGTGTGCGCAGG,0,474922
araBp,0.25,3,3,GATTGAGATTCTGGAGATGT,0,484858
araBp,0.25,3,3,GATTCTTGGAATCAGGATGC,0,502899
araBp,0.25,3,3,GATTCAATCTAAAGAGCGGG,0,482439
araBp,0.25,3,3,GATTACGCACGACGCGTCCG,0,518281
araBp,0.25,3,3,GATGTCAACTACTGATCGTC,0,511007
araBp,0.25,3,3,GATGTAAACAAATCTTGCTA,0,507967
araBp,0.25,3,3,GATGCAGAAGGCAACGCTTG,0,504248
araBp,0.25,3,3,GATGATACCCATTTTGGAAC,0,470658
araBp,0.25,3,3,GATCTTGATTAGCCACGGCT,0,482641
araBp,0.25,3,3,GATCGACTCACCCAGCTCAT,0,496531
araBp,0.25,3,3,GATCCGTAGGGTAACCGCCC,0,481981
araBp,0.25,3,3,GATCCGGTTTCAGGCGCAAG,0,507429
araBp,0.25,3,3,GATCAGTATCCCACCGACAT,0,521101
araBp,0.25,3,3,GATCAGAAGTCCAAATCAGT,0,484300
araBp,0.25,3,3,GATCACAATCGATAGCGCCC,0,471068
araBp,0.25,3,3,GATATTAGCGTCATTACTTC,0,513123
araBp,0.25,3,3,GATATGCCGTATTAGAACAC,0,469616
araBp,0.25,3,3,GATATAACGCGGTCTACGAA,0,499568
araBp,0.25,3,3,GATAGAGCCGTTAGCAGTGC,0,508760
araBp,0.25,3,3,GATACGCCCTAGGTCTGTGT,0,506293
araBp,0.25,3,3,GATAATCCCGGTGACTCTGT,0,524658
araBp,0.25,3,3,GATAACTTATGAGAATTTTG,0,477670
araBp,0.25,3,3,GAGTTTTGCCCAAGACGTCT,0,508015
araBp,0.25,3,3,GAGTTCTCGGACGTGTGTAA,0,495683
araBp,0.25,3,3,GAGTTCCCCCCGCCACGGGA,0,491414
araBp,0.25,3,3,GAGTGTACACCCCAGTTTGT,0,489626
araBp,0.25,3,3,GAGTGGCGCTCCAAACTTGC,0,513641
araBp,0.25,3,3,GAGGGAGCCTGCCATTCCGA,0,477853
araBp,0.25,3,3,GAGGCGTGCACTGGTGGGAC,0,481959
araBp,0.25,3,3,GAGGCAGCTAGGTTGCCCGG,0,499513
araBp,0.25,3,3,GAGGATTGTGCGTGTAGGTC,0,522566
araBp,0.25,3,3,GAGGATTGCATAACGTTAGG,0,493599
araBp,0.25,3,3,GAGGACCACACGCGGTTGAA,0,469466
araBp,0.25,3,3,GAGGAATGGAGGCCGCCAAG,0,508925
araBp,0.25,3,3,GAGCTTCGAACTTAGGGTCA,0,506276
araBp,0.25,3,3,GAGCTCGCCGTTGTCCCTCC,0,491193
araBp,0.25,3,3,GAGCGCCAGATGTACCTTTA,0,498064
araBp,0.25,3,3,GAGCGATGCAGCGATTTTGA,0,507158
araBp,0.25,3,3,GAGCAGTAAAACTTGCCTCG,0,513459
araBp,0.25,3,3,GAGATTGACATCAGGATAGG,0,518826
araBp,0.25,3,3,GAGATGGGGTCACTTTCCTT,0,512136
araBp,0.25,3,3,GAGACACATGTACAGGGGCT,0,474009
araBp,0.25,3,3,GAGAAGAATCGAATATGGAC,0,471323
araBp,0.25,3,3,GACTTTAGTTATAAGATTAC,0,516913
araBp,0.25,3,3,GACTGCCGGGTTCGGAGGCA,0,476852
araBp,0.25,3,3,GACTCCCTGACAACGTATAT,0,514732
araBp,0.25,3,3,GACGTGAGTTCTTGTACGGT,0,510663
araBp,0.25,3,3,GACGTATTGGCAAGTGTACA,0,498184
araBp,0.25,3,3,GACGGTTACTATGCACATTG,0,481299
araBp,0.25,3,3,GACGGATTGCGGTTCACGAG,0,493050
araBp,0.25,3,3,GACGCTTATCGTCGAGTTTC,0,511647
araBp,0.25,3,3,GACCGCTCCATACTAGGTCT,0,525343
araBp,0.25,3,3,GACCCCACTACCTTAATGTT,0,504942
araBp,0.25,3,3,GACATCACGTGTGCTATACA,0,473344
araBp,0.25,3,3,GACATAACAGAGAGTGGGTT,0,492505
araBp,0.25,3,3,GACATAAAACGTCAATGCGG,0,494704
araBp,0.25,3,3,GACAGTGGGCCGTTTTAATA,0,517471
araBp,0.25,3,3,GACAGCTGGTTTGTCATGCT,0,512844
araBp,0.25,3,3,GACAAATACGAATAGTCGAG,0,522789
araBp,0.25,3,3,GAATTATGGTCTCAGACCAG,0,498800
araBp,0.25,3,3,GAATTACGATATAAGTCCAC,0,521663
araBp,0.25,3,3,GAATCTCGCCGAGAGCGCTA,0,511989
araBp,0.25,3,3,GAATCTAAGGGGCATACGGT,0,510640
araBp,0.25,3,3,GAATCCAGGGTTTACCGCCC,0,511891
araBp,0.25,3,3,GAATATGCCCACGGCAAAAT,0,490722
araBp,0.25,3,3,GAAGTCGCATAGGCCAGTGA,0,489486
araBp,0.25,3,3,GAAGGGAACACGTCATTCTT,0,507370
araBp,0.25,3,3,GAAGGAATAGCGGGCCGGAT,0,515520
araBp,0.25,3,3,GAAGCTGTGGTGAACTTGAG,0,486820
araBp,0.25,3,3,GAAGCGGATGTAAACCTCTG,0,493817
araBp,0.25,3,3,GAAGATGTCAACACGGGGGG,0,508350
araBp,0.25,3,3,GAAGACGCAAACCCGCGTGC,0,501717
araBp,0.25,3,3,GAAGACCACCCGTCCATGAA,0,505133
araBp,0.25,3,3,GAAGAATTCAAACATAATAC,0,479248
araBp,0.25,3,3,GAAGAAGATCCGACATCGAT,0,469633
araBp,0.25,3,3,GAACAAGTCGTGACTAAGTA,0,515576
araBp,0.25,3,3,GAACAAGGGCTAGGCAAATA,0,502122
araBp,0.25,3,3,GAAATTTTTGCGCCTTACAG,0,515609
araBp,0.25,3,3,GAAATCAAGTCCGCCTCATA,0,507614
araBp,0.25,3,3,GAAACAGTCCGGTTACGCGA,0,513777
araBp,0.25,3,3,GAAAAGGGACATGATCGAAT,0,523076
araBp,0.25,3,3,GAAAAGCGGGTCCTGTAATA,0,506811
araBp,0.25,3,3,GAAAACGTCGAAGGTTGGTT,0,486998
araBp,0.25,3,3,CTTTTTTTACGACCTTCGTG,0,476999
araBp,0.25,3,3,CTTTCCAAGTATAGTGTGTT,0,487566
araBp,0.25,3,3,CTTTAGTAGGAGCCCCATTG,0,511552
araBp,0.25,3,3,CTTGTCTGAAACATCAGGCT,0,501223
araBp,0.25,3,3,CTTGCAAATCTACGGTGCCA,0,488023
araBp,0.25,3,3,CTTGACGTTTCGTGTTCCGT,0,486796
araBp,0.25,3,3,CTTGAACAAGTCCGGCTCAA,0,506162
araBp,0.25,3,3,CTTCTCCGGCGAGACCAAAT,0,503762
araBp,0.25,3,3,CTTCGGGTAAATACTTGAAC,0,505372
araBp,0.25,3,3,CTTCGCCGTCGGGACATCCT,0,505530
araBp,0.25,3,3,CTTCAGATGCAAAATCAAGA,0,468576
araBp,0.25,3,3,CTTATCACAGACGAAATAGG,0,510442
araBp,0.25,3,3,CTTAGCCGGAACGAAGAATT,0,507034
araBp,0.25,3,3,CTTAGCACGGGCAGCTTAAA,0,485712
araBp,0.25,3,3,CTTACCTGCGCCGGTGAGTG,0,473187
araBp,0.25,3,3,CTTACAAATCTAGTGGCGCG,0,505778
araBp,0.25,3,3,CTTAATTGCACGAACGTCCC,0,489015
araBp,0.25,3,3,CTTAAGATCTGTAGCCGGCG,0,517068
araBp,0.25,3,3,CTTAAATCTCGATAACGAAT,0,490504
araBp,0.25,3,3,CTTAAAGGTGGAATACATGA,0,519814
araBp,0.25,3,3,CTGTTCGATAGGCTGGCCCA,0,490827
araBp,0.25,3,3,CTGTGTATCAATGCGGTACC,0,516588
araBp,0.25,3,3,CTGTGACTTCTCTCTCCAGT,0,474788
araBp,0.25,3,3,CTGTGAATGCATATGGGAAT,0,471595
araBp,0.25,3,3,CTGTCGTAGGTAGAACACAG,0,484797
araBp,0.25,3,3,CTGTAGTGCTCCTAGCATCG,0,486213
araBp,0.25,3,3,CTGTAAGAAGTGAACACGAT,0,511693
araBp,0.25,3,3,CTGGTGCGGTCGGTGTCTGG,0,490346
araBp,0.25,3,3,CTGGGAGCAGTCACTTCTCT,0,493714
araBp,0.25,3,3,CTGGCAGCGCCTAGAGAGCT,0,471033
araBp,0.25,3,3,CTGGATTAAGTTTTGATACT,0,495884
araBp,0.25,3,3,CTGGAGTGCGTGTGATTTCC,0,523951
araBp,0.25,3,3,CTGGAGTACTCGGGCGCGAG,0,516753
araBp,0.25,3,3,CTGGAAGAGATGGGAACGTC,0,514057
araBp,0.25,3,3,CTGCTCAAAAGTTAATTTAA,0,507482
araBp,0.25,3,3,CTGCTAAAAAAATAGTTGTG,0,496226
araBp,0.25,3,3,CTGCGTGTTTGGAAGGGTTC,0,481879
araBp,0.25,3,3,CTGCGTCATAACGCAAATAG,0,520040
araBp,0.25,3,3,CTGCGAACGTGGAAAAATCA,0,510513
araBp,0.25,3,3,CTGCCTTTAACTGGGAGACC,0,495962
araBp,0.25,3,3,CTGCCTGTTCGGCGTCCCGA,0,516001
araBp,0.25,3,3,CTGCCGTATCCTTTTGTCTA,0,523361
araBp,0.25,3,3,CTGCCAAATGTACGCTAGCA,0,509274
araBp,0.25,3,3,CTGATGGTCGTGTGACTATC,0,498427
araBp,0.25,3,3,CTGATGGACAGACGATCACT,0,508332
araBp,0.25,3,3,CTGAAAATGGTTGTTACGGG,0,494849
araBp,0.25,3,3,CTCTTTGCCTACAGATCATT,0,499215
araBp,0.25,3,3,CTCTTTCGTATGACGTATCC,0,472826
araBp,0.25,3,3,CTCTTGTGAATAGCGCAAAA,0,488091
araBp,0.25,3,3,CTCTTCCGACAGTTCGAACT,0,477654
araBp,0.25,3,3,CTCTTATATGTAATCGTCCG,0,521095
araBp,0.25,3,3,CTCTGTTCTGTGAGGGAGGC,0,470153
araBp,0.25,3,3,CTCTGGGGAAACGGTCTAGA,0,472272
araBp,0.25,3,3,CTCTGACGGTTTAGTTAAAG,0,485960
araBp,0.25,3,3,CTCGTTGGTGATGCGTGGAG,0,517072
araBp,0.25,3,3,CTCGTGGACCATGCTCACCT,0,483897
araBp,0.25,3,3,CTCGTGCGGTACGCGGGTAT,0,490679
araBp,0.25,3,3,CTCGTATTAAACGAGTCGAA,0,497466
araBp,0.25,3,3,CTCGGTTTGGGGCGGTGTGT,0,472151
araBp,0.25,3,3,CTCGGTCACCCGGCGGCAAT,0,522938
araBp,0.25,3,3,CTCGCCCCCTAGATTCGCAT,0,471674
araBp,0.25,3,3,CTCGCATCGTGAGAGAGTTA,0,478311
araBp,0.25,3,3,CTCGATCACGGTAAGAGTCG,0,483352
araBp,0.25,3,3,CTCGACTTTGGCCTGACAAA,0,506085
araBp,0.25,3,3,CTCGAAACTCCCGGGGCGCC,0,524330
araBp,0.25,3,3,CTCCTGACGTTCAATTGCCA,0,504744
araBp,0.25,3,3,CTCCGAGGTACACCAGCGTA,0,523755
araBp,0.25,3,3,CTCCCTGGTATCCTCGCATG,0,512902
araBp,0.25,3,3,CTCCCCTTCCTTGCCATCCA,0,497649
araBp,0.25,3,3,CTCCCCTGGCCCTTTGTATA,0,514485
araBp,0.25,3,3,CTCCCATCTTGGAGAACGAT,0,488447
araBp,0.25,3,3,CTCCATCAGCCTTTCGTTGC,0,514537
araBp,0.25,3,3,CTCATGAGCAGTGTTTAGGG,0,484812
araBp,0.25,3,3,CTCAGTTTATAATGGGCCAC,0,512592
araBp,0.25,3,3,CTCAGTTAGAGCTCTGCCAC,0,513239
araBp,0.25,3,3,CTCAGTCCACTAAGACAAAA,0,475277
araBp,0.25,3,3,CTCAGGTCCAGACGACCATA,0,511350
araBp,0.25,3,3,CTCACTACATACGGAATTTT,0,502286
araBp,0.25,3,3,CTCACGTGTTGGTACCATGT,0,516590
araBp,0.25,3,3,CTCACGTGTCGGGTATTTTT,0,493498
araBp,0.25,3,3,CTCAAAGTCTATAAGCCAAC,0,479134
araBp,0.25,3,3,CTATTATGCAGTATCTCACC,0,472332
araBp,0.25,3,3,CTATATAGTGCTGGGGGGCA,0,496972
araBp,0.25,3,3,CTATAATACGGTATCTGACG,0,521317
araBp,0.25,3,3,CTAGTGTATAGCGTGAGACG,0,492184
araBp,0.25,3,3,CTAGTGCCAAGAATGCTCTA,0,483018
araBp,0.25,3,3,CTAGTCACGGATGTAGTACA,0,493661
araBp,0.25,3,3,CTAGGGAATAATGTTGTGGG,0,475619
araBp,0.25,3,3,CTAGGCCCGCGTTTGCCACC,0,500431
araBp,0.25,3,3,CTAGGAGTTTGTGAATGACA,0,491563
araBp,0.25,3,3,CTAGAAATGCTGGGTGTCCG,0,480638
araBp,0.25,3,3,CTACCCTCGCGTGAGGACAT,0,485061
araBp,0.25,3,3,CTAATATGGACCGCTGTCTA,0,473933
araBp,0.25,3,3,CTAAGACTTTGCGAGTGTAC,0,486625
araBp,0.25,3,3,CGTTTCAATGGTATTATCGC,0,509781
araBp,0.25,3,3,CGTTGATTGTTGGACTTCTA,0,505278
araBp,0.25,3,3,CGTTATCAAGCAGTGAGTAG,0,477056
araBp,0.25,3,3,CGTTACCCAAAGGCTGTGCG,0,512652
araBp,0.25,3,3,CGTGTTGTTTTCGTATTCAC,0,511648
araBp,0.25,3,3,CGTGTTGAACTCAATTCCTA,0,510160
araBp,0.25,3,3,CGTGGATTGTGCACACATCC,0,486429
araBp,0.25,3,3,CGTGGAGTTATTGGATAACG,0,511669
araBp,0.25,3,3,CGTGAGTTTTCGTTTCGGTT,0,482213
araBp,0.25,3,3,CGTGACTGTGGGGCATTTTG,0,505357
araBp,0.25,3,3,CGTCTTGAAACTCGGATTTA,0,476950
araBp,0.25,3,3,CGTCTGCTCTGGGTACGAGG,0,503118
araBp,0.25,3,3,CGTCCGCTTGACTGATGTTT,0,507747
araBp,0.25,3,3,CGTCCCGAAACCCTCCCCCG,0,501126
araBp,0.25,3,3,CGTATGCTGACAACGACGCT,0,481764
araBp,0.25,3,3,CGTATAGGTAAGCCCATCAA,0,524591
araBp,0.25,3,3,CGTATACGGCGCCGGCGCCA,0,523945
araBp,0.25,3,3,CGTAGTTTCCTTGGCGAATT,0,499336
araBp,0.25,3,3,CGTAGTGGGGAGCCGGCATT,0,468228
araBp,0.25,3,3,CGTAGATTACGTAGGCACCC,0,468491
araBp,0.25,3,3,CGTACTCGACGCACTGCTGC,0,501574
araBp,0.25,3,3,CGTACTACGGCTTTCTTCTA,0,492777
araBp,0.25,3,3,CGTAACAAATGCTACATAGG,0,469898
araBp,0.25,3,3,CGGTTTCCCAGGCCCCAGGG,0,518046
araBp,0.25,3,3,CGGTTGTAAAAAAGCGGTGT,0,511168
araBp,0.25,3,3,CGGTTCGCACCCTTAACGCA,0,511403
araBp,0.25,3,3,CGGTTACACTTGAATCAAAT,0,469824
araBp,0.25,3,3,CGGTGTTTTGGAATCCTCAA,0,495912
araBp,0.25,3,3,CGGTGAATCATTCCCGCATG,0,490022
araBp,0.25,3,3,CGGTGAAGAGATGTCCGAAG,0,509167
araBp,0.25,3,3,CGGTCTTGTTACGCATGAAC,0,523013
araBp,0.25,3,3,CGGTCGTTTCATCAGCGGGG,0,524842
araBp,0.25,3,3,CGGTCGTAGGGGATGGACTT,0,500156
araBp,0.25,3,3,CGGGTGCCATCTGATGAGTA,0,490386
araBp,0.25,3,3,CGGGTCGCGGGTAGGGTCGG,0,488059
araBp,0.25,3,3,CGGGTATAGATCCCACGCCT,0,478564
araBp,0.25,3,3,CGGGTAGCGGCATTTCAAGA,0,497882
araBp,0.25,3,3,CGGGGTCCTTACACTACCTT,0,503354
araBp,0.25,3,3,CGGGCATTTACTGTTCAACA,0,499684
araBp,0.25,3,3,CGGGAGGTCAGGTTTCCACT,0,475084
araBp,0.25,3,3,CGGGACATGTCATAACCGTC,0,485225
araBp,0.25,3,3,CGGCTCCGGCAATGTGGCTT,0,522130
araBp,0.25,3,3,CGGCTAAAACGCATGATTAA,0,509311
araBp,0.25,3,3,CGGCGGTACGATCTATACAA,0,499145
araBp,0.25,3,3,CGGCGGGACTAAGGAAGAAG,0,479923
araBp,0.25,3,3,CGGCGATTCATTACCAATAG,0,506892
araBp,0.25,3,3,CGGCGAATCGTGCCCATATA,0,517268
araBp,0.25,3,3,CGGCCTGTATGACACAGTCA,0,518416
araBp,0.25,3,3,CGGCCCCGCCCCTGAAGTGT,0,500334
araBp,0.25,3,3,CGGCCAGAGTCGTTACCATC,0,504893
araBp,0.25,3,3,CGGCATACACGACATGCGCC,0,501953
araBp,0.25,3,3,CGGCACCAAAGAAAGCGATA,0,467957
araBp,0.25,3,3,CGGCAACCATGTACTTACCC,0,481653
araBp,0.25,3,3,CGGATTTCTTCGAATGGAGG,0,474574
araBp,0.25,3,3,CGGATCTCCACTGCGCACTA,0,481799
araBp,0.25,3,3,CGGATCGTTGCGGAAATATG,0,487851
araBp,0.25,3,3,CGGAGTGACGTGCCTGGGCA,0,482529
araBp,0.25,3,3,CGGAGGCTTGTGGAACTTTC,0,470956
araBp,0.25,3,3,CGGACTGCGGGCTGAATGGG,0,481000
araBp,0.25,3,3,CGGAAGGCCATCTCATGGTG,0,516048
araBp,0.25,3,3,CGCTTTCCACTCCACCGTGC,0,507578
araBp,0.25,3,3,CGCTTCGGTATTAAACAGCT,0,473342
araBp,0.25,3,3,CGCTTCGCAGCTATCCAACA,0,484499
araBp,0.25,3,3,CGCTGTCGGGGGTTGCATTC,0,500776
araBp,0.25,3,3,CGCTGCCTTCGAATATAGGT,0,484972
araBp,0.25,3,3,CGCTAGATTAGAACAGCCAT,0,474785
araBp,0.25,3,3,CGCGTTGTCTCGACGTGTGG,0,508126
araBp,0.25,3,3,CGCGTTCCCGTCGTCTGCCT,0,469036
araBp,0.25,3,3,CGCGTATGCCTACTCAGGGC,0,505554
araBp,0.25,3,3,CGCGGTGCGCTTCCTAGGGG,0,484570
araBp,0.25,3,3,CGCGGCGAGCTCAGTGCGAT,0,488173
araBp,0.25,3,3,CGCGGAACGCTGGGGGGGAT,0,476780
araBp,0.25,3,3,CGCGCGGGAGGACCCGGCTT,0,507004
araBp,0.25,3,3,CGCGCGCTGGCCAAGCCCAG,0,469496
araBp,0.25,3,3,CGCCTCTATACGGTTCGCTG,0,483996
araBp,0.25,3,3,CGCCTCGCGTCAGGTTTTCT,0,510053
araBp,0.25,3,3,CGCCGTCTACACGCACGAGG,0,522170
araBp,0.25,3,3,CGCCGGCTAATGGACGTTTT,0,473347
araBp,0.25,3,3,CGCCGAGAAGGGTGCGAAGG,0,468334
araBp,0.25,3,3,CGCCCTACCTGTCCGAGTTT,0,482453
araBp,0.25,3,3,CGCCACAGTGCGGTTAACGG,0,492185
araBp,0.25,3,3,CGCATTGCCCGTTAATTATA,0,473797
araBp,0.25,3,3,CGCATGGTAAACGGCCCCAT,0,469941
araBp,0.25,3,3,CGCATCGTGCGCCGGTCTTT,0,486810
araBp,0.25,3,3,CGCATCAGTACCATAGTTCT,0,508635
araBp,0.25,3,3,CGCAGTATAGTCCTGCTGCC,0,509647
araBp,0.25,3,3,CGCACGAACACTTAGTGTCC,0,515472
araBp,0.25,3,3,CGCAATGAATGATATACAAC,0,516854
araBp,0.25,3,3,CGCAACTGAACATCGGTGTC,0,507686
araBp,0.25,3,3,CGCAAAATACAGAGTCCCGG,0,510262
araBp,0.25,3,3,CGATTAAGGTATAGGGGGCT,0,496592
araBp,0.25,3,3,CGATGTGTATGTATACTCAA,0,482189
araBp,0.25,3,3,CGATCCGACTACTAAGGCAC,0,504614
araBp,0.25,3,3,CGATCACGCAATTTATCGGG,0,494742
araBp,0.25,3,3,CGATAGAACAGGGATTATTT,0,516108
araBp,0.25,3,3,CGATACACCGGGCGCTTCTT,0,485658
araBp,0.25,3,3,CGAGTACCTGGATAATATAC,0,492758
araBp,0.25,3,3,CGAGGTATTTTCTGCAGATT,0,491675
araBp,0.25,3,3,CGAGGCCGTCATACTGCGCC,0,506357
araBp,0.25,3,3,CGAGGACTACCACGGTATGT,0,522996
araBp,0.25,3,3,CGAGCTTAGAAACCCCGTAC,0,482784
araBp,0.25,3,3,CGAGCTATTGCGTTCATCGG,0,482642
araBp,0.25,3,3,CGACTGGACGATCCTACGGG,0,522777
araBp,0.25,3,3,CGACTCCGGTTTAGAGGCTC,0,497896
araBp,0.25,3,3,CGACGGAGAGGAGTTAAGTC,0,482960
araBp,0.25,3,3,CGACAGTTTGATATTGGAGT,0,522527
araBp,0.25,3,3,CGAATGATAGCAGGTGTCGT,0,504634
araBp,0.25,3,3,CGAAGTAGGACGCTCCGAGC,0,493346
araBp,0.25,3,3,CGAAGAGGTCAAATAGGTAT,0,498453
araBp,0.25,3,3,CGAACCCCAGTGACGCTACC,0,518815
araBp,0.25,3,3,CCTTTGCAAGCTGGCATCCT,0,477393
araBp,0.25,3,3,CCTTTGACACCAGGGCCGTG,0,500811
araBp,0.25,3,3,CCTTTCCTTATCAGGACAAG,0,500443
araBp,0.25,3,3,CCTTGCAGTGGTAAGGGTTT,0,483228
araBp,0.25,3,3,CCTTGAGATCGTTGCGGCGT,0,502052
araBp,0.25,3,3,CCTTCCAGTACTGAGTATAA,0,492785
araBp,0.25,3,3,CCTGCTAGCTGCTGCTGTAC,0,473491
araBp,0.25,3,3,CCTCTGTGCTCTGTCCACAC,0,519734
araBp,0.25,3,3,CCTCTAAGGCAGGTGATCGT,0,504678
araBp,0.25,3,3,CCTCGCTGGATGGGATGTGA,0,487691
araBp,0.25,3,3,CCTCCGATTTTAGTAATTCG,0,504048
araBp,0.25,3,3,CCTCATTTCTACTTCAGCCT,0,494357
araBp,0.25,3,3,CCTCACTAATTGCTACTCAG,0,471269
araBp,0.25,3,3,CCTATGTCAGCAAAGGGCAA,0,522046
araBp,0.25,3,3,CCTATATCAGCACGTGTGCA,0,498845
araBp,0.25,3,3,CCTACATGAGCCACAATACT,0,488460
araBp,0.25,3,3,CCTAAGTTAGCACGCCCCAC,0,477620
araBp,0.25,3,3,CCTAAGACGCGGCAAATCTG,0,484449
araBp,0.25,3,3,CCGTTCCCGCAGGTGGAACG,0,493246
araBp,0.25,3,3,CCGTTCAGCATTGGAGAAGA,0,523262
araBp,0.25,3,3,CCGTCGGCAGGGAGTCTCAT,0,473893
araBp,0.25,3,3,CCGTCATATGAGGGACCGTG,0,483927
araBp,0.25,3,3,CCGTAGTTAAATCAGTGGTA,0,475026
araBp,0.25,3,3,CCGTAGTCATTCTCCAGACA,0,476827
araBp,0.25,3,3,CCGTACCGACCTTTCGGGCA,0,494628
araBp,0.25,3,3,CCGGTGCGAGCAACTTCCTC,0,479430
araBp,0.25,3,3,CCGGTCGGTCCACTGTCTGC,0,510256
araBp,0.25,3,3,CCGGCTGAGGACACTAAGCA,0,471820
araBp,0.25,3,3,CCGGCTACACCCAATCACAT,0,481696
araBp,0.25,3,3,CCGGCCCCAGTTGCAGGTTG,0,485912
araBp,0.25,3,3,CCGGACTCGGTTCCAGGAAA,0,469110
araBp,0.25,3,3,CCGGACGATGGCTGTAAAGC,0,472016
araBp,0.25,3,3,CCGGAAGAACGTGTGAAGTC,0,517745
araBp,0.25,3,3,CCGCTAGATTTACGTTGGTG,0,513795
araBp,0.25,3,3,CCGCGGCCTAGTCCGGCTAA,0,514140
araBp,0.25,3,3,CCGCAGGTGCAAGCGCTTGA,0,522664
araBp,0.25,3,3,CCGCACGGTACTTTATCTAT,0,520282
araBp,0.25,3,3,CCGCAAATCGGGTGGCACGG,0,476310
araBp,0.25,3,3,CCGAGTGATTTGTAGATCTT,0,474900
araBp,0.25,3,3,CCGAAGGCTTAACGGGGGCT,0,469247
araBp,0.25,3,3,CCGAAGGCCCGTCCCGTAAA,0,487942
araBp,0.25,3,3,CCGAAATCGTGATCCGATGC,0,516767
araBp,0.25,3,3,CCGAAAATATTGTGTCCGAG,0,522094
araBp,0.25,3,3,CCCTTGGGTTTTGTGGTTGG,0,518784
araBp,0.25,3,3,CCCTTCACACTCGCGCAGAG,0,486268
araBp,0.25,3,3,CCCTGTTCCGCAATTTTGAG,0,489817
araBp,0.25,3,3,CCCTGTGATCAGCCGGATTC,0,479386
araBp,0.25,3,3,CCCTGCGGACCACGTAGAAC,0,516514
araBp,0.25,3,3,CCCTGAAGTCTTGCGGACCC,0,475500
araBp,0.25,3,3,CCCTCGGGCGCGTACGCCGC,0,515884
araBp,0.25,3,3,CCCTCCGAGAGACTCTATTC,0,468537
araBp,0.25,3,3,CCCTCCCTAAGCACTTCAGA,0,477822
araBp,0.25,3,3,CCCGGGCTCACCGATACAAT,0,498353
araBp,0.25,3,3,CCCGGCGTTGCAGCGGTGAA,0,523014
araBp,0.25,3,3,CCCGGAAGTGTAGCCGCATG,0,493774
araBp,0.25,3,3,CCCGCTGAGCAAAAGTGAAG,0,496040
araBp,0.25,3,3,CCCGAAACGTGGGAAGCGCT,0,483260
araBp,0.25,3,3,CCCCTGACCATATTCGACTC,0,486983
araBp,0.25,3,3,CCCCGTAGGTGGGGAGGCGG,0,501823
araBp,0.25,3,3,CCCCCCGGCTATCGGGGATC,0,524173
araBp,0.25,3,3,CCCAGGGTGACAGACGAGCG,0,497376
araBp,0.25,3,3,CCCAGGGATCCAATTATGCA,0,468767
araBp,0.25,3,3,CCCACAGCTTTGATTGTAAT,0,504024
araBp,0.25,3,3,CCCAAGGTCACTGCCGCTAG,0,496544
araBp,0.25,3,3,CCCAACCGTGTAAACCGTTG,0,508057
araBp,0.25,3,3,CCCAAAAGGCATGTGCTCGG,0,500614
araBp,0.25,3,3,CCATTGGAGGTCCCTAAAAT,0,501484
araBp,0.25,3,3,CCATTAAATTTCACGGTCCT,0,512947
araBp,0.25,3,3,CCATGCTTTGGTCGTCATAA,0,514940
araBp,0.25,3,3,CCATCCCGGTGCGCCGTTGA,0,494315
araBp,0.25,3,3,CCATATGACGCGTTTACCGC,0,517231
araBp,0.25,3,3,CCATATCATCCCACCTCCCC,0,474864
araBp,0.25,3,3,CCATACGTTTAACCACCTTG,0,479205
araBp,0.25,3,3,CCATAAGTATCAGCCCAAGC,0,474558
araBp,0.25,3,3,CCAGGTTGGCAGATAGGTAA,0,506098
araBp,0.25,3,3,CCAGGCTTAGTGTGGGGAAG,0,524396
araBp,0.25,3,3,CCAGCGAAAGAAGGAAGTCC,0,517308
araBp,0.25,3,3,CCAGATGCTATCAACGATAT,0,494441
araBp,0.25,3,3,CCAGAGTTCCAGCGCACGGG,0,520472
araBp,0.25,3,3,CCACTTTTTCTGCAAACTTA,0,501739
araBp,0.25,3,3,CCACTTTCACTCCATTAACA,0,491048
araBp,0.25,3,3,CCACTGGTGGTTATTAAGTT,0,504883
araBp,0.25,3,3,CCACTCCTATAAGAACTGGT,0,516298
araBp,0.25,3,3,CCACTCATGGGTCGCCAACT,0,477655
araBp,0.25,3,3,CCACTAAAAAAGGCACTATG,0,500667
araBp,0.25,3,3,CCACGGTACTTTTCGGTGCG,0,477913
araBp,0.25,3,3,CCACGAGAAGAAAGGCACTA,0,476009
araBp,0.25,3,3,CCACACATCAGCTGGGGTTC,0,469889
araBp,0.25,3,3,CCAATCCTGCTCAGTCTATC,0,495203
araBp,0.25,3,3,CCAATCAAGCTTTTAAGGGT,0,499031
araBp,0.25,3,3,CCAAGCGATAGAGTGGGTAT,0,501178
araBp,0.25,3,3,CCAAGCACCGTCGTCAACAT,0,520817
araBp,0.25,3,3,CCAACAACTGGAATGTCATT,0,498347
araBp,0.25,3,3,CATTTTCTTTCGCTTTTCGT,0,488069
araBp,0.25,3,3,CATTTGTGCAACGTCTAAGT,0,498837
araBp,0.25,3,3,CATTATGAGGACGTCCAAGA,0,481521
araBp,0.25,3,3,CATGTTGTTATCAAGGGTAG,0,473202
araBp,0.25,3,3,CATGGTAGCGCGTATATGGC,0,510766
araBp,0.25,3,3,CATGGGATCCGCCGATAATG,0,486807
araBp,0.25,3,3,CATGGACAAATAACGGTGTT,0,496213
araBp,0.25,3,3,CATGCGGAAACCTTCCACGT,0,493334
araBp,0.25,3,3,CATGACCTAAGTAAGTTTAC,0,485906
araBp,0.25,3,3,CATCGGTACTCGCAAATCAG,0,513923
araBp,0.25,3,3,CATCGCCCCATTTCCTGAAT,0,468465
araBp,0.25,3,3,CATCCCCGGCACATTTGACT,0,478478
araBp,0.25,3,3,CATCAAACTCATTCTTATTG,0,484801
araBp,0.25,3,3,CATATTTACATAAACAGATT,0,490439
araBp,0.25,3,3,CATATGTGCACTAGCCTGTG,0,524007
araBp,0.25,3,3,CATAGGTGGTGCCGGAGTTC,0,475548
araBp,0.25,3,3,CATAGCCAAGAGTTCCAGCC,0,469876
araBp,0.25,3,3,CATACACTGAAGTGGTCATT,0,521223
araBp,0.25,3,3,CATAATTGAGCCGGGCATCA,0,476215
araBp,0.25,3,3,CATAAGTCACGGGCGGTATA,0,490951
araBp,0.25,3,3,CAGTTACAGTTCGAACTCGG,0,482327
araBp,0.25,3,3,CAGTGCGTGTTTGCCTTTCC,0,520842
araBp,0.25,3,3,CAGTGCATTGCAACACCTCA,0,508554
araBp,0.25,3,3,CAGTCTGAGCTCACCCACGT,0,483729
araBp,0.25,3,3,CAGTCGCCAGAAGCACTACA,0,484964
araBp,0.25,3,3,CAGGTGCGTCGAGAACTCAA,0,471781
araBp,0.25,3,3,CAGGTACTTCCTGGATTGTT,0,474428
araBp,0.25,3,3,CAGGTAAGGGATCTTTCAAT,0,488865
araBp,0.25,3,3,CAGGGGATTCCATAAAGTTA,0,507893
araBp,0.25,3,3,CAGGGGATAAAAGTGCGGCC,0,477250
araBp,0.25,3,3,CAGGGCTGTAAAAACATTGT,0,471974
araBp,0.25,3,3,CAGGGCCACAGTCAGCGCAC,0,506608
araBp,0.25,3,3,CAGGGATGGAAGCTAAGGGA,0,514374
araBp,0.25,3,3,CAGGCCTTTACGCAAGACGT,0,511817
araBp,0.25,3,3,CAGGCAGCAATGGCGGGACG,0,514927
araBp,0.25,3,3,CAGGATGATTGGGACCTGGA,0,476539
araBp,0.25,3,3,CAGCTGTAAAGGTGCGAATG,0,475658
araBp,0.25,3,3,CAGCGTGGATAGGCCTTTCC,0,510758
araBp,0.25,3,3,CAGCGTCAATATCGCAATTT,0,492557
araBp,0.25,3,3,CAGCGCGATACTGCAATGAT,0,486785
araBp,0.25,3,3,CAGCCTGCACACTACGGGCT,0,468066
araBp,0.25,3,3,CAGCCCTCGGAAGGTTTGGA,0,495586
araBp,0.25,3,3,CAGCATATTTCTCAATTGGA,0,490970
araBp,0.25,3,3,CAGCAAGGAGGGCGAGCAGG,0,498472
araBp,0.25,3,3,CAGAGAATTCAGACCGCGAA,0,518724
araBp,0.25,3,3,CAGACGTGGCATTCCCGGAA,0,515610
araBp,0.25,3,3,CAGAATTACCACACATATTA,0,504988
araBp,0.25,3,3,CAGAATACCTAGCAAACAGG,0,507764
araBp,0.25,3,3,CACTTGTTTCGCATGCCCTA,0,502350
araBp,0.25,3,3,CACTTGGCATTAGATGGAAT,0,504718
araBp,0.25,3,3,CACTGTCGCGCGGAGAGCCC,0,516159
araBp,0.25,3,3,CACTGCCGATACGCGGAATC,0,503584
araBp,0.25,3,3,CACTGATGCCTGGATTATCT,0,522509
araBp,0.25,3,3,CACTAATTAGCTATGATGGT,0,518570
araBp,0.25,3,3,CACGTTCGAGAGCCTTAACT,0,511686
araBp,0.25,3,3,CACGGGAGGAAAATTCCTGC,0,520963
araBp,0.25,3,3,CACGGAACCATCCATCACGG,0,522165
araBp,0.25,3,3,CACGCTATGCCTGGCAGTTG,0,476574
araBp,0.25,3,3,CACGACACAACCGCTATGTA,0,470553
araBp,0.25,3,3,CACCTTGGCGTTCAATAACA,0,523069
araBp,0.25,3,3,CACCTCAGGTGACTAGGGTC,0,495029
araBp,0.25,3,3,CACCTATCGAGAGAACTGGG,0,513476
araBp,0.25,3,3,CACCGTTTGCCCGGGCCGCA,0,476735
araBp,0.25,3,3,CACCGCCCGGACTTGGTCGA,0,515600
araBp,0.25,3,3,CACCCGGTGACCCATTAGCT,0,502992
araBp,0.25,3,3,CACCCGGCTGATCTGCTCGT,0,522646
araBp,0.25,3,3,CACCCCACGTCCCGGTTCCT,0,485718
araBp,0.25,3,3,CACCATTAGGGTAACGGGGT,0,470496
araBp,0.25,3,3,CACCAGGGTCAAACGCTGGC,0,516384
araBp,0.25,3,3,CACATTTTTCGTCGCTCACG,0,510972
araBp,0.25,3,3,CACATAGCAGCTTCGTAGTG,0,471415
araBp,0.25,3,3,CACAGTTCTCTTCACCTGTT,0,492440
araBp,0.25,3,3,CACAGGAACTCGCGAACCTG,0,493099
araBp,0.25,3,3,CACAGCCAGTGGGGCGACCC,0,521889
araBp,0.25,3,3,CACAGAGTTATTGCTATCTG,0,509265
araBp,0.25,3,3,CACACCCGCGAACTGGGGTG,0,497392
araBp,0.25,3,3,CAATTCTCACGCAGAAACAA,0,525117
araBp,0.25,3,3,CAATTCCATCGTCCGCATTG,0,494251
araBp,0.25,3,3,CAATTATCTAGTATTGCCAC,0,518833
araBp,0.25,3,3,CAATTACGACAAAAGGTGGC,0,474893
araBp,0.25,3,3,CAATGTTTTGGGCATGGTGA,0,523884
araBp,0.25,3,3,CAATGTACGCTTCATACCTA,0,504627
araBp,0.25,3,3,CAATGCGTAAGTTCTTCGCT,0,468814
araBp,0.25,3,3,CAATCTTCTGAGCACCCCAT,0,507583
araBp,0.25,3,3,CAATCGAATCTGAGCTTGGA,0,514355
araBp,0.25,3,3,CAATATCAGACGTAGGGACT,0,493419
araBp,0.25,3,3,CAATAGCGACGTCTCCCCTT,0,474735
araBp,0.25,3,3,CAAGTTCGGTACGCTCTGGA,0,515404
araBp,0.25,3,3,CAAGTATTTGAAGGGCAGCC,0,514087
araBp,0.25,3,3,CAAGGCTTGGACCCCATGCA,0,524158
araBp,0.25,3,3,CAAGGCCGCCGTCTAAGAAT,0,471959
araBp,0.25,3,3,CAAGGCCCCCTAATCAGATA,0,490695
araBp,0.25,3,3,CAAGGATTAGATGTACGCGA,0,498669
araBp,0.25,3,3,CAAGAGTGTTCATTTAAAAG,0,504722
araBp,0.25,3,3,CAAGAGAATGGGTGCGAGCC,0,494194
araBp,0.25,3,3,CAAGAACCACTACTAGACCC,0,513402
araBp,0.25,3,3,CAACGCCTATAAGAATATTT,0,523093
araBp,0.25,3,3,CAACCGGAACCACGGCTCTG,0,485901
araBp,0.25,3,3,CAACATGCTAAATGGTAGCC,0,476255
araBp,0.25,3,3,CAACATAAATATCTCCGTTA,0,520823
araBp,0.25,3,3,CAACAAACTAAAGCAACTCA,0,503310
araBp,0.25,3,3,CAAATTATCTTGGGAGCTTC,0,470328
araBp,0.25,3,3,CAAATCAAGAGGCGTACCTT,0,483607
araBp,0.25,3,3,CAAAGGCTGGACCAGGAGTC,0,476830
araBp,0.25,3,3,CAAAATCCGAGGTACGACCT,0,479053
araBp,0.25,3,3,CAAAAACTCCGCGGGAATAT,0,525123
araBp,0.25,3,3,ATTTTCTTAGGATTTAGACA,0,515558
araBp,0.25,3,3,ATTTGCTACAACTCCTGCAG,0,524743
araBp,0.25,3,3,ATTTCTTGGAGCCCATCAGA,0,496545
araBp,0.25,3,3,ATTTCGTAGACCATCTATTT,0,471263
araBp,0.25,3,3,ATTTATTGGCGTGAATGGTG,0,513831
araBp,0.25,3,3,ATTTAGTAGACAGTTTAGCG,0,520942
araBp,0.25,3,3,ATTGTTCGCGCCCAACACGG,0,477601
araBp,0.25,3,3,ATTGTTCCTGCGCCCATTGC,0,487989
araBp,0.25,3,3,ATTGTTCCAACCTGGGAAGT,0,517958
araBp,0.25,3,3,ATTGGTGGGCAAAACGGTAG,0,520245
araBp,0.25,3,3,ATTGGGTGTCTCGATAACGC,0,525499
araBp,0.25,3,3,ATTGGCGCTGGGATTGGCGC,0,490961
araBp,0.25,3,3,ATTGGAAGCCTGTGCGAAAC,0,525445
araBp,0.25,3,3,ATTCTTTCACCTCACGAGCG,0,474327
araBp,0.25,3,3,ATTCTCTGTATTGAAACGTT,0,484984
araBp,0.25,3,3,ATTCGTTGGCTCGGCCACAT,0,506509
araBp,0.25,3,3,ATTCGGGGGTGGTAGGCCCA,0,474533
araBp,0.25,3,3,ATTCGAGTGTGTTAGTACCA,0,489405
araBp,0.25,3,3,ATTCGAAATTATGACATATG,0,482937
araBp,0.25,3,3,ATTCCTCTCCTGGATCATGC,0,481108
araBp,0.25,3,3,ATTCCGAACGTGACCGCTGC,0,510116
araBp,0.25,3,3,ATTCAGTAGGTGGCAGGAAG,0,470330
araBp,0.25,3,3,ATTCAAGTAGACCGCGATGC,0,509873
araBp,0.25,3,3,ATTCAACGATAAGCGGACTC,0,474754
araBp,0.25,3,3,ATTATTTTAGTTTGGAGTCA,0,522696
araBp,0.25,3,3,ATTATTTATCTGGGCGCGTA,0,472211
araBp,0.25,3,3,ATTATTTAGAACACAAACAT,0,514566
araBp,0.25,3,3,ATTATAGGCCTCCGTTCCTG,0,480157
araBp,0.25,3,3,ATTAGTGAATCTTAGGGCCT,0,519344
araBp,0.25,3,3,ATTACGTGTGTCGCACGAGG,0,523247
araBp,0.25,3,3,ATTACACACGCAGATGTAAG,0,519605
araBp,0.25,3,3,ATTAATGACAACAGGGAAAA,0,468075
araBp,0.25,3,3,ATGTTGACAAGTCCGGAGTA,0,477731
araBp,0.25,3,3,ATGTTAACTGGCGGTCGTAA,0,468830
araBp,0.25,3,3,ATGTCTAATCCGGTGAGGTC,0,490998
araBp,0.25,3,3,ATGTCAGCGTGTGAGTCGTG,0,470625
araBp,0.25,3,3,ATGTCAACTAGGCAAGTCCT,0,484253
araBp,0.25,3,3,ATGTACACGTCATGCTAGTT,0,525335
araBp,0.25,3,3,ATGTAAACATTGTCTACAGG,0,489041
araBp,0.25,3,3,ATGGTCTCTCGTGTGCGATT,0,501598
araBp,0.25,3,3,ATGGGGAACGTAGAAGCTTT,0,515905
araBp,0.25,3,3,ATGGGAGGACGGGTAGGGAA,0,501323
araBp,0.25,3,3,ATGGGAGACCGACGAGTGAA,0,515150
araBp,0.25,3,3,ATGGCGGACCGGGTACTGCT,0,516808
araBp,0.25,3,3,ATGGACGTCGTGGACTACTG,0,490774
araBp,0.25,3,3,ATGGACGATTAATTGGTATT,0,511548
araBp,0.25,3,3,ATGCTTGAAATCGGCGTAAT,0,470495
araBp,0.25,3,3,ATGCTGCCTGATATCGTCAC,0,477562
araBp,0.25,3,3,ATGCTCGCGTGGACTTGTTT,0,484292
araBp,0.25,3,3,ATGCTATTATACCCCAGCTT,0,512306
araBp,0.25,3,3,ATGCTAGTCGATGCTTAGAG,0,484656
araBp,0.25,3,3,ATGCTAGTACATATGAGGAT,0,492547
araBp,0.25,3,3,ATGCGCCAGGCGTTTCCACG,0,520465
araBp,0.25,3,3,ATGCCTTTTACCGACGGCTC,0,469870
araBp,0.25,3,3,ATGCATTCAACGCTCCCCTA,0,468084
araBp,0.25,3,3,ATGCAGTTCGTAATCGCGTC,0,519257
araBp,0.25,3,3,ATGATGGACGTGGGATGAAC,0,486269
araBp,0.25,3,3,ATGACAGAGAACCTGTTTTG,0,467830
araBp,0.25,3,3,ATGAAACGTAACTGCTGGTC,0,498719
araBp,0.25,3,3,ATCTTCCACATATATGAGAA,0,486932
araBp,0.25,3,3,ATCTCACAGCGAGTGTCAAA,0,508564
araBp,0.25,3,3,ATCGTATATCCTAAAATAAT,0,472677
araBp,0.25,3,3,ATCGGTTTCTGCGCGCATGT,0,521530
araBp,0.25,3,3,ATCGGGGAAGTAGGACACTT,0,507574
araBp,0.25,3,3,ATCGGGAGAAGCGGTTCCAC,0,490609
araBp,0.25,3,3,ATCGCTCGGTGGTGAAGACA,0,510520
araBp,0.25,3,3,ATCGCTAGACCCTGTTCTAC,0,474886
araBp,0.25,3,3,ATCGCCTCTGCTCGGGGGGT,0,494469
araBp,0.25,3,3,ATCGCCCAACTGGGTGGACA,0,490124
araBp,0.25,3,3,ATCGCCAAATCCCCGCCCGG,0,477554
araBp,0.25,3,3,ATCGATATTATACGGACTCT,0,478730
araBp,0.25,3,3,ATCGAAGGCTAAGTAGTATG,0,485353
araBp,0.25,3,3,ATCGAAATTTGTCACCCGTT,0,487809
araBp,0.25,3,3,ATCCTTTACTAAAGGAGTGT,0,483136
araBp,0.25,3,3,ATCCTGGTTGTTACACTCTA,0,510065
araBp,0.25,3,3,ATCCGTGGAGAAGGTGGAGG,0,472037
araBp,0.25,3,3,ATCCGAGCTCTCCGCTGGCG,0,471098
araBp,0.25,3,3,ATCCCAGGAGACGCAACAAA,0,511852
araBp,0.25,3,3,ATCCACGCGCTAACTTCCTA,0,517740
araBp,0.25,3,3,ATCAGTCACTAACTATCAGC,0,500817
araBp,0.25,3,3,ATCAGCTATCGCTATAGAAG,0,492072
araBp,0.25,3,3,ATCAGCCCATAGGAGTGTAC,0,508788
araBp,0.25,3,3,ATCACGGGACGCACTAGATA,0,493648
araBp,0.25,3,3,ATCACAAGCAAACAGCGTGT,0,469802
araBp,0.25,3,3,ATCAAGCTACCGAAAATTAC,0,502244
araBp,0.25,3,3,ATCAAGCAGGGCAAAACCAG,0,505644
araBp,0.25,3,3,ATATTCTTTCACGGCAAGTT,0,474532
araBp,0.25,3,3,ATATTCGCGTTTTAGTATAA,0,503659
araBp,0.25,3,3,ATATGCATTCGTCTAGGGCT,0,486022
araBp,0.25,3,3,ATATGCAACTACTCGTCGCT,0,484683
araBp,0.25,3,3,ATATGAAACGTTGTCAAAAG,0,506280
araBp,0.25,3,3,ATATATTATACGATAGGTAT,0,480631
araBp,0.25,3,3,ATATAGCCTATTAAGGTATC,0,494637
araBp,0.25,3,3,ATAGGGTAACTCGTTATGTA,0,473427
araBp,0.25,3,3,ATAGGCCAATGCTTGCGCAA,0,500983
araBp,0.25,3,3,ATACTCAAATGCGGACAGGC,0,510365
araBp,0.25,3,3,ATACGGTGACGCACCAATGG,0,496980
araBp,0.25,3,3,ATACGCTGGGCCGGCAACGC,0,469722
araBp,0.25,3,3,ATACCGTGAGGCGACTAATT,0,473415
araBp,0.25,3,3,ATACACCCTGAAAATCTGGC,0,478012
araBp,0.25,3,3,ATAATGGTCCATTTTCTGAG,0,494002
araBp,0.25,3,3,ATAAGGGCTACGAAATACTT,0,508150
araBp,0.25,3,3,ATAAGCGTATCACTCCCCTC,0,486773
araBp,0.25,3,3,ATAAGCGCATGATCCTGCAA,0,494136
araBp,0.25,3,3,ATAACTTTGAGCGTTGACCA,0,480959
araBp,0.25,3,3,ATAACTCTGAGTTGGTGAGA,0,484299
araBp,0.25,3,3,ATAACATATCGACAAGGCTA,0,498574
araBp,0.25,3,3,AGTTCTGTATGGCCATAAGG,0,522216
araBp,0.25,3,3,AGTTCGTTTTGTGGGAGGCA,0,507214
araBp,0.25,3,3,AGTTATAGTCCTAACCTGCT,0,469437
araBp,0.25,3,3,AGTTAGAACGATGTAGTATT,0,521442
araBp,0.25,3,3,AGTGGCATCCTCGGGCGGAA,0,470758
araBp,0.25,3,3,AGTGAGGGTGGTGATCGGGA,0,488544
araBp,0.25,3,3,AGTCTCGTGACCACTTCTCG,0,522821
araBp,0.25,3,3,AGTCATAGGTAGGGAGTGGT,0,512227
araBp,0.25,3,3,AGTCAGTAGTTACATCACGG,0,507088
araBp,0.25,3,3,AGTCAAGATAGGGACGGCCA,0,475612
araBp,0.25,3,3,AGTATTCCCATCCTGTTTGT,0,487051
araBp,0.25,3,3,AGTATACAGGAGGTACAAAA,0,504760
araBp,0.25,3,3,AGTAGGGTGCTCGGAGAGTC,0,477108
araBp,0.25,3,3,AGTACAACACGATATCTAGC,0,495745
araBp,0.25,3,3,AGGTTGTGTCCAATTGACGC,0,491670
araBp,0.25,3,3,AGGTTGTACATCAGGGGAAG,0,519583
araBp,0.25,3,3,AGGTGTACAAGTGTAAGTAC,0,486360
araBp,0.25,3,3,AGGTCGCTTAGAATTCCAAC,0,502765
araBp,0.25,3,3,AGGTCGATGCTTTGCCCACA,0,519015
araBp,0.25,3,3,AGGTATCGACTGTGAGGGAC,0,497416
araBp,0.25,3,3,AGGGGGTTGTTTGAGCGCTG,0,469303
araBp,0.25,3,3,AGGGGGTACTGGGTCGCATA,0,487944
araBp,0.25,3,3,AGGGCTAAGAAAAAGGTCCT,0,487337
araBp,0.25,3,3,AGGGCCTCCTCTGGAATTAT,0,525013
araBp,0.25,3,3,AGGGCCCCCCCGTCTGCCTT,0,472409
araBp,0.25,3,3,AGGGATTGTCTCTATCGTAC,0,524520
araBp,0.25,3,3,AGGGAATTAGTCATCTTCGT,0,484589
araBp,0.25,3,3,AGGCTGTGAGAGGCCGTCAG,0,497419
araBp,0.25,3,3,AGGCTGTACCAGTGTTCACT,0,511801
araBp,0.25,3,3,AGGCTGGATAACGTGAATGG,0,498737
araBp,0.25,3,3,AGGCGCGACATCTGAATGGG,0,476776
araBp,0.25,3,3,AGGCATTTCAATACATTAGT,0,499769
araBp,0.25,3,3,AGGCACCGTAACGCAAGATT,0,490340
araBp,0.25,3,3,AGGATTCGGAGCTGCGAGTT,0,479042
araBp,0.25,3,3,AGGATGTGAAGGTGTTGTAA,0,489415
araBp,0.25,3,3,AGGAGTTTGGTCCGTTAGTT,0,524134
araBp,0.25,3,3,AGGAGTATGTGCAACATTAG,0,472202
araBp,0.25,3,3,AGGAGCGCCAACTGAAATTA,0,469218
araBp,0.25,3,3,AGGACTCGAGCTATGGAACA,0,524830
araBp,0.25,3,3,AGGACGAATAACATGGGAAA,0,481706
araBp,0.25,3,3,AGGAAGCCCAGTACCAGGGA,0,491389
araBp,0.25,3,3,AGCTTCCCGCGTACAATACA,0,507886
araBp,0.25,3,3,AGCTGGACCGCCAACCAGTT,0,507501
araBp,0.25,3,3,AGCTCCTGACGGCCCACTTA,0,523147
araBp,0.25,3,3,AGCTACACCACGGGTAAGCA,0,502474
araBp,0.25,3,3,AGCGTCTCGCATGGAGCTGT,0,508992
araBp,0.25,3,3,AGCGTCGGAACGACTGCGCG,0,476315
araBp,0.25,3,3,AGCGGTGACCCTTGTCCCTA,0,482896
araBp,0.25,3,3,AGCGGCCCTCCAGAGGCGAG,0,522239
araBp,0.25,3,3,AGCCTGTAGCCTTCTGAAAA,0,492109
araBp,0.25,3,3,AGCCGTTATATAATGATGAA,0,489203
araBp,0.25,3,3,AGCCCTTCCAACTCCGTCAA,0,502404
araBp,0.25,3,3,AGCCCGTTTTAGCGTGGCGG,0,486049
araBp,0.25,3,3,AGCCCGGCTAGAATCCACTG,0,477455
araBp,0.25,3,3,AGCCCGAACCGGCAGCTTGA,0,512222
araBp,0.25,3,3,AGCATGCTCAGACTTCACCC,0,477381
araBp,0.25,3,3,AGCAGCCGTCAGGCGCTTAT,0,473359
araBp,0.25,3,3,AGCAGACACGCGGGCTTTGG,0,481700
araBp,0.25,3,3,AGCACTGATTACGGTAATAA,0,516000
araBp,0.25,3,3,AGCACGAGCTTCTGCCGTCC,0,505033
araBp,0.25,3,3,AGCAAGCTCACAAAGACTGG,0,487207
araBp,0.25,3,3,AGCAAACAGGCTCGAAGTAT,0,475346
araBp,0.25,3,3,AGATTTTGGAAGGATTACGT,0,511034
araBp,0.25,3,3,AGATTGGGCTACGAGCCCTG,0,488967
araBp,0.25,3,3,AGATTCACACCGGTGACAGA,0,501738
araBp,0.25,3,3,AGATGTGCATCGCGAGCCAA,0,494812
araBp,0.25,3,3,AGATGCTACAAGTCGTCAGT,0,507006
araBp,0.25,3,3,AGATCTGGAGCTCCGGCTTG,0,514925
araBp,0.25,3,3,AGATCGGTGTCTGATTCAAT,0,506978
araBp,0.25,3,3,AGAGTGTATCTCCCATGGGC,0,497408
araBp,0.25,3,3,AGAGTCAAGGCAAAAATATC,0,489692
araBp,0.25,3,3,AGACTCCTTGATGCTAAACG,0,484815
araBp,0.25,3,3,AGACGTAGGGCGGTCTTCAC,0,523775
araBp,0.25,3,3,AGACCGGTATTACCGGAAGC,0,507005
araBp,0.25,3,3,AGACATTTAGGGATCTCCAG,0,497663
araBp,0.25,3,3,AGACATCATAAAGCGGGGTT,0,473522
araBp,0.25,3,3,AGAATTATATCCACGAAGGA,0,504346
araBp,0.25,3,3,AGAATGCGTCGGCTGTCCGA,0,525243
araBp,0.25,3,3,AGAAGATCGCATCTTCGTTA,0,470567
araBp,0.25,3,3,AGAAGAAGATCCTCTAAACC,0,494313
araBp,0.25,3,3,AGAAGAACAACATTTTTTAT,0,516975
araBp,0.25,3,3,AGAACGCCAAGTAGATGTTT,0,518481
araBp,0.25,3,3,AGAACGATTCCCGGGGGCAA,0,472806
araBp,0.25,3,3,AGAAATTGACGAGGCATAAT,0,508427
araBp,0.25,3,3,AGAAATACTCAGCGTTCGGG,0,467901
araBp,0.25,3,3,ACTTTCGGACGGTGTTAGAG,0,508373
araBp,0.25,3,3,ACTTTAAGGCTCGGGAAAAA,0,489659
araBp,0.25,3,3,ACTTGTACACGCTGACTCCC,0,511000
araBp,0.25,3,3,ACTTCATAGGAGTCTATCCA,0,524162
araBp,0.25,3,3,ACTTCAAGAAGATACATAGG,0,498426
araBp,0.25,3,3,ACTTAGTCCCCTAAAAAGGT,0,477551
araBp,0.25,3,3,ACTGTGGCGGTTTTGGAAAG,0,473808
araBp,0.25,3,3,ACTGGGAACATAGAGTCAGT,0,467791
araBp,0.25,3,3,ACTGCTGGCCTACTGTGCTT,0,488892
araBp,0.25,3,3,ACTGCTATTATGCATCATCT,0,476113
araBp,0.25,3,3,ACTGCGAAAGGGCACTGCAA,0,471278
araBp,0.25,3,3,ACTGCCTGACCCCGCGTATT,0,482537
araBp,0.25,3,3,ACTGAACATCTTAGATCTTG,0,500829
araBp,0.25,3,3,ACTCTTGCCCACTAACTGTG,0,469008
araBp,0.25,3,3,ACTCTATCGCCTGATATAAA,0,482022
araBp,0.25,3,3,ACTCTATCGCATGATTCAGG,0,503813
araBp,0.25,3,3,ACTCGAGAAGACATGCTCCC,0,504268
araBp,0.25,3,3,ACTCCGATTTTACGGGCCGC,0,506769
araBp,0.25,3,3,ACTCAGCCGCGCGCCATCTC,0,514621
araBp,0.25,3,3,ACTCAATAGCTACAACGTAC,0,487932
araBp,0.25,3,3,ACTAGATACAGTTCCAGAGG,0,507486
araBp,0.25,3,3,ACTAATTTCATGAAGAGTTA,0,508128
araBp,0.25,3,3,ACTAAGATACATGCTAGCTG,0,500862
araBp,0.25,3,3,ACTAAATATGTATCTGTTAG,0,492517
araBp,0.25,3,3,ACGTTGTGTTTTACAAGACT,0,522400
araBp,0.25,3,3,ACGTCGGGCTGTGGCGTGTC,0,508928
araBp,0.25,3,3,ACGTAGCAGACACAAAATTG,0,524093
araBp,0.25,3,3,ACGTAATTTAGTTCACCGTC,0,516208
araBp,0.25,3,3,ACGTAATGATCACAACGACA,0,489538
araBp,0.25,3,3,ACGGTACTCGATGACTTGAT,0,488070
araBp,0.25,3,3,ACGGGTGGGTCCAGAGCCTA,0,518862
araBp,0.25,3,3,ACGGCTATGAGTGGGTCAAG,0,503810
araBp,0.25,3,3,ACGGCAGTGGTCTAATGGCG,0,517221
araBp,0.25,3,3,ACGGAATGCATTAAAACCGA,0,519013
araBp,0.25,3,3,ACGCGTGGGCAATTCGAATT,0,490895
araBp,0.25,3,3,ACGCGGTCTGCGATGAAAGG,0,509147
araBp,0.25,3,3,ACGCGGAAAAACACAGATAC,0,484802
araBp,0.25,3,3,ACGCCCGTTTCTCATTGGTA,0,502237
araBp,0.25,3,3,ACGCATGCGTATTCAGTCCT,0,487514
araBp,0.25,3,3,ACGAGTCAGTGGACGTCTAA,0,504676
araBp,0.25,3,3,ACGAGGGTCTGGGTGAAATA,0,504075
araBp,0.25,3,3,ACGACTTCTCTAATCCGGTC,0,486274
araBp,0.25,3,3,ACGAATGTGTGGTCGCCGAT,0,495488
araBp,0.25,3,3,ACGAACGGACAGTTCATTAT,0,472985
araBp,0.25,3,3,ACCTTTTATAGACGTACGAG,0,517783
araBp,0.25,3,3,ACCTTGCGTCACCTAGCCTC,0,503185
araBp,0.25,3,3,ACCTGCCCGAGCCAATGCGA,0,475529
araBp,0.25,3,3,ACCTGACATAACCTGGATTG,0,523411
araBp,0.25,3,3,ACCTATAGTAGGGTATAACT,0,473177
araBp,0.25,3,3,ACCTATAGGACATAAGCGAG,0,473541
araBp,0.25,3,3,ACCGGCAATGGGATTGAGGT,0,502057
araBp,0.25,3,3,ACCGCGCTTTGGCGAGTAAT,0,503173
araBp,0.25,3,3,ACCGCGCGTCCAGTATAAGA,0,501336
araBp,0.25,3,3,ACCGAGTGGACCTTCAAGGG,0,516202
araBp,0.25,3,3,ACCCGTTCATTAGCCAGCCC,0,471531
araBp,0.25,3,3,ACCCGCCTCCGTGAAGTTAT,0,503291
araBp,0.25,3,3,ACCCAGTATTTGTTTCCAGC,0,512831
araBp,0.25,3,3,ACCCACCGTGATCTTGCGCC,0,482648
araBp,0.25,3,3,ACCAGGCCTAGCCGGACTCT,0,508655
araBp,0.25,3,3,ACCAGGAAAGATCATGTACT,0,484955
araBp,0.25,3,3,ACCAGACTGCCCCGCCCGGG,0,508131
araBp,0.25,3,3,ACCACTTAGAGGGCCGCTAG,0,522174
araBp,0.25,3,3,ACCACCTGCGATACTAATCC,0,471942
araBp,0.25,3,3,ACCACAGGCACGTGGAAAGG,0,469165
araBp,0.25,3,3,ACCAAAACGGCTCCCCGGTA,0,492396
araBp,0.25,3,3,ACATTTGATCCAATAAGTAT,0,470373
araBp,0.25,3,3,ACATTTCCGGCACGAGGTGT,0,477235
araBp,0.25,3,3,ACATTGGCAGACTCCTCGAA,0,469388
araBp,0.25,3,3,ACATGGTCATTGGAGGTTTC,0,502441
araBp,0.25,3,3,ACATGCTTGCCTGGAATACA,0,482118
araBp,0.25,3,3,ACATGCTCGTGGTGCCCAAA,0,475023
araBp,0.25,3,3,ACATGCCGCTAGTGGATAAT,0,493184
araBp,0.25,3,3,ACATGATGCGGGAGACTAAT,0,514864
araBp,0.25,3,3,ACATGATCGAGACGGAATAT,0,516201
araBp,0.25,3,3,ACATCGTTAAGTCCTATAAG,0,514092
araBp,0.25,3,3,ACATCAGATCTCGATTCTTC,0,523320
araBp,0.25,3,3,ACATATTCAGCACGGAGGTT,0,469471
araBp,0.25,3,3,ACAGTCGGTCCTCAAATGCG,0,471266
araBp,0.25,3,3,ACAGGTCATGTGGCGACCCA,0,496444
araBp,0.25,3,3,ACAGGACCCATCCGCGAACT,0,496311
araBp,0.25,3,3,ACAGCCTATTATGGTGATTA,0,481001
araBp,0.25,3,3,ACAGAAAATCAGCATTATGG,0,504666
araBp,0.25,3,3,ACACTGGATTCCGAACCTGC,0,512285
araBp,0.25,3,3,ACACTCCCTCCCCCGGTAAG,0,491338
araBp,0.25,3,3,ACACCACCGCGCTGGTCGTG,0,508599
araBp,0.25,3,3,ACACAACCCAGTCCCTACGG,0,486158
araBp,0.25,3,3,ACAATTCTCTTTGTCGAACG,0,512662
araBp,0.25,3,3,ACAAGGCTATCAAAAGGTTG,0,484970
araBp,0.25,3,3,ACAACTTGATAATATGTATG,0,485807
araBp,0.25,3,3,ACAACCCGCACTGTCATCAT,0,480582
araBp,0.25,3,3,ACAAACGTAAGCTTAGAGTA,0,514465
araBp,0.25,3,3,AATTTGTCGTCTATTCGTAG,0,473284
araBp,0.25,3,3,AATTTCCGCGCACGATCCAG,0,477545
araBp,0.25,3,3,AATTCGGACTTCCATGAAAG,0,512734
araBp,0.25,3,3,AATTCCTATGTACATTACGG,0,501211
araBp,0.25,3,3,AATTCAAGTTGCTCCGCGCA,0,495496
araBp,0.25,3,3,AATTATAATCGGGATCCGGA,0,518073
araBp,0.25,3,3,AATTAATGCCACAGGAATGA,0,495136
araBp,0.25,3,3,AATGTGGTGCTTCTTCTAGT,0,516188
araBp,0.25,3,3,AATGTGGTAGGACAGCACAG,0,501503
araBp,0.25,3,3,AATGTAGCATGCTTGGCCCG,0,482907
araBp,0.25,3,3,AATGGTGTAGAGTTTGCGAA,0,509200
araBp,0.25,3,3,AATGGCCGCGACATGGGTCC,0,508716
araBp,0.25,3,3,AATGCGGTGTGGCCCGGCCA,0,488413
araBp,0.25,3,3,AATCGGTGCACGAAATAGCG,0,519135
araBp,0.25,3,3,AATCCCATGCACTCTGAGTT,0,520306
araBp,0.25,3,3,AATATTTTAAAAGTAGACCG,0,475119
araBp,0.25,3,3,AATATCTAGGTGCGGCGTGT,0,505748
araBp,0.25,3,3,AATAGATGGGTAGCTGTACA,0,515581
araBp,0.25,3,3,AATAGATATAAGATGACCTA,0,521869
araBp,0.25,3,3,AATACTCCACTGCAGTTTCC,0,520073
araBp,0.25,3,3,AATAATCTCTCGATATTCAG,0,495471
araBp,0.25,3,3,AAGTTGTCTAAAGAGAATGT,0,506536
araBp,0.25,3,3,AAGTTATGAATGCATGTAGA,0,500087
araBp,0.25,3,3,AAGTTATCGGGATACGGTAG,0,472269
araBp,0.25,3,3,AAGTGGGGGAACCATGGTGT,0,512022
araBp,0.25,3,3,AAGTGGCCTCCGGTCAGAAC,0,512242
araBp,0.25,3,3,AAGTCAGATGAGAGAAAGTG,0,485584
araBp,0.25,3,3,AAGTCAAACCTTATATATTA,0,492287
araBp,0.25,3,3,AAGTAATCTCCCCTTCAGCC,0,514401
araBp,0.25,3,3,AAGGGTCCGCCTTGTTTTGT,0,506786
araBp,0.25,3,3,AAGGGATTTTCCTCATTTTG,0,484603
araBp,0.25,3,3,AAGGCCAGATGGCGTCCCGA,0,490127
araBp,0.25,3,3,AAGGATGGAGATCCTAATAG,0,493726
araBp,0.25,3,3,AAGGAGTGGTGCGGTGCCTT,0,481901
araBp,0.25,3,3,AAGGAGGGCCGGGGTTTAAA,0,519815
araBp,0.25,3,3,AAGGAAGGTTAACTAGCGTA,0,501545
araBp,0.25,3,3,AAGCTTGCAATGGATATAGT,0,472124
araBp,0.25,3,3,AAGCTTCTAATACAAGATTT,0,509263
araBp,0.25,3,3,AAGCTATCCTTCATAAAAAC,0,476302
araBp,0.25,3,3,AAGCGTCTTACCTCGTACTC,0,498547
araBp,0.25,3,3,AAGCCTCACGATCGCCAAGA,0,513713
araBp,0.25,3,3,AAGCAGTGTCCGATGTAGGC,0,494133
araBp,0.25,3,3,AAGATTTCTTTGAGAGTGGA,0,500898
araBp,0.25,3,3,AAGAGTTTGCACAAAGCCGA,0,471378
araBp,0.25,3,3,AAGACGGTGGTTTAAACTTA,0,485582
araBp,0.25,3,3,AAGAAGTCATGGCTGGCGCC,0,490395
araBp,0.25,3,3,AAGAAGCTCGAATTGAGGGA,0,520678
araBp,0.25,3,3,AACTTAGTTATTGGCAGGGG,0,471556
araBp,0.25,3,3,AACTGGAAACAACTAAGCCA,0,521284
araBp,0.25,3,3,AACGTTCATCTATCGCGATC,0,519405
araBp,0.25,3,3,AACGTACGTAGATCAGAGAA,0,485121
araBp,0.25,3,3,AACGTAATCGGTAGACGATC,0,505601
araBp,0.25,3,3,AACGGCGTTACCCAGGCCGG,0,478231
araBp,0.25,3,3,AACGCGTAACGAAACCGGAC,0,520588
araBp,0.25,3,3,AACGCCCCGGAGTTTTCGCG,0,505528
araBp,0.25,3,3,AACGCAGCAGTACTGCACCC,0,483784
araBp,0.25,3,3,AACGCACAGGACCCTAAGGG,0,494130
araBp,0.25,3,3,AACGAGGTCCTCTCGCTCCC,0,491853
araBp,0.25,3,3,AACGACTGGGACGCTAGCGT,0,523798
araBp,0.25,3,3,AACGACCTCTTGGGATCTGA,0,510335
araBp,0.25,3,3,AACCTGGATGTCGGCACGGT,0,511187
araBp,0.25,3,3,AACCTAACCGTACATCTGGT,0,513730
araBp,0.25,3,3,AACCGGTAATAGTGTTGAAG,0,513710
araBp,0.25,3,3,AACCGGCGCGATGAGCCAGT,0,509144
araBp,0.25,3,3,AACCCTCTCATGACCGGACC,0,492008
araBp,0.25,3,3,AACCAGAGTATAGCGGTGAG,0,506084
araBp,0.25,3,3,AACATTATTGAAATGGCAAA,0,505714
araBp,0.25,3,3,AACATCCTAGAGCCAAGAAG,0,488453
araBp,0.25,3,3,AACAGTAGGTTACCGTCGGT,0,497086
araBp,0.25,3,3,AACAGGTCGGAGGTTAGGGT,0,520765
araBp,0.25,3,3,AACAGGAAGGCTCGCACATG,0,493386
araBp,0.25,3,3,AACACGGTTGCGAGAATATA,0,494904
araBp,0.25,3,3,AACACGAGGTCAATGCCCCA,0,473812
araBp,0.25,3,3,AACACCGCACCGGTCAGCCC,0,504803
araBp,0.25,3,3,AAATTGAAGCCGACATCTTT,0,504806
araBp,0.25,3,3,AAATGTTATCGGCTTATACT,0,486391
araBp,0.25,3,3,AAATGGAAACTTCGCGAGTA,0,511864
araBp,0.25,3,3,AAATCTTAGTTGTGGTCGCT,0,506852
araBp,0.25,3,3,AAAGTCTCCTGTCTAACGCG,0,487367
araBp,0.25,3,3,AAAGTCCCACGCATTAATAG,0,477196
araBp,0.25,3,3,AAAGTACCTGTTGAGTATCG,0,482811
araBp,0.25,3,3,AAAGGGAGTCGCATCCTCCA,0,480196
araBp,0.25,3,3,AAAGGCAAACCAAATTTCGG,0,471575
araBp,0.25,3,3,AAAGCGGGTGAGACAGATTT,0,482300
araBp,0.25,3,3,AAAGCCGTCCTCTTTTTTAA,0,496903
araBp,0.25,3,3,AAACTCGAGCGATATCTACT,0,504423
araBp,0.25,3,3,AAACTATGGATGCTTCAAGA,0,503424
araBp,0.25,3,3,AAACTAACTGTCAGCTTGGC,0,495863
araBp,0.25,3,3,AAACGCGCCATTAGGTTGTA,0,488669
araBp,0.25,3,3,AAACCTTGGTGAGGACGGCG,0,476901
araBp,0.25,3,3,AAACACGAGTGAGTCGCTCA,0,484182
araBp,0.25,3,3,AAAAGGTCGATCAACAGGTT,0,496705
araBp,0.25,3,3,AAAACCAGTACGAGAAGTTA,0,507579
araBp,0.25,3,3,AAAACCAGGGATATTGGAAG,0,483983
araBp,0.25,3,3,AAAAATTCTGGGTAATCGGA,0,487093
araBp,0.25,3,3,AAAAAGTGCCAGAAGGACCA,0,483710
araBp,0.25,3,3,AAAAAGCGCAGTTCTTTTCA,0,490160
araBp,0.25,3,3,AAAAACTACTGGGATGTGTG,0,467856
araBp,0.25,3,3,AAAAAAGGATTACTAGCACA,0,470996
araBp,0.25,3,3,AAAAAACGCCCGTCTTCTCT,0,506361
araBp,0.3333333333333333,2,2,TTTTTTTTGACCGGTTGGCG,0,483711
araBp,0.3333333333333333,2,2,TTTTTTAGTTAGCTTTGGCT,0,481915
araBp,0.3333333333333333,2,2,TTTTTCCATAGGATCGATTT,0,468590
araBp,0.3333333333333333,2,2,TTTTTCAGACCTTCCTAGCT,0,506795
araBp,0.3333333333333333,2,2,TTTTCTTGCACTCTGTAGGA,0,482841
araBp,0.3333333333333333,2,2,TTTTCTGGGTTCGCGAGTAG,0,491122
araBp,0.3333333333333333,2,2,TTTTCTCCGATTTCGGGCAG,0,502873
araBp,0.3333333333333333,2,2,TTTTCGGGACGTGCGTCGCC,0,512654
araBp,0.3333333333333333,2,2,TTTGTTGCACAGACGGTTCC,0,498671
araBp,0.3333333333333333,2,2,TTTGTCTTGAACGAACGACC,0,478024
araBp,0.3333333333333333,2,2,TTTGGCAGCCGGGTCGCCTT,0,494006
araBp,0.3333333333333333,2,2,TTTGCTAGCTGTATTTCCTG,0,481682
araBp,0.3333333333333333,2,2,TTTGCGTTCCGTGACATAAA,0,470673
araBp,0.3333333333333333,2,2,TTTGCAGCAACAACGAAAAG,0,505410
araBp,0.3333333333333333,2,2,TTTGACGCGGGTGCCGCTTA,0,486436
araBp,0.3333333333333333,2,2,TTTGACACAACGAATGGGCG,0,521667
araBp,0.3333333333333333,2,2,TTTGAACGTTATGTGTTCGT,0,498927
araBp,0.3333333333333333,2,2,TTTCTCTAATGTGTGATCTC,0,517290
araBp,0.3333333333333333,2,2,TTTCTAATCATCATACCGGC,0,495830
araBp,0.3333333333333333,2,2,TTTCGTGCGCCAGGTTGCTA,0,471061
araBp,0.3333333333333333,2,2,TTTCGGGTCCAGGAAGATAA,0,488325
araBp,0.3333333333333333,2,2,TTTCGCAGGAGTATACAAGT,0,499437
araBp,0.3333333333333333,2,2,TTTCATTCTGGATCGCCTAT,0,504320
araBp,0.3333333333333333,2,2,TTTCAGGCCAAGCAATTCGG,0,472141
araBp,0.3333333333333333,2,2,TTTCACGCCTAACTGGTTTT,0,492452
araBp,0.3333333333333333,2,2,TTTCACATCGGGAGAAAATG,0,475037
araBp,0.3333333333333333,2,2,TTTCAAGTGTCCACACGGGC,0,490091
araBp,0.3333333333333333,2,2,TTTATCTGTGTGGCACGAAG,0,468257
araBp,0.3333333333333333,2,2,TTTATCTATGTGCAGCGTCG,0,485266
araBp,0.3333333333333333,2,2,TTTAGGGTGAACGACTGTAT,0,475129
araBp,0.3333333333333333,2,2,TTTAAGTTCGAAAGGGATCT,0,509705
araBp,0.3333333333333333,2,2,TTTAACACACGGCGGCTTGC,0,491816
araBp,0.3333333333333333,2,2,TTGTTGTTCGAAGCTGCGAT,0,492460
araBp,0.3333333333333333,2,2,TTGTTCCTTCGGGGCCTTTT,0,504465
araBp,0.3333333333333333,2,2,TTGTCGTATCGTAAGACAGC,0,519839
araBp,0.3333333333333333,2,2,TTGTCCGGCAGTGAGGAGAA,0,507393
araBp,0.3333333333333333,2,2,TTGTCACTGTGGGGAGCCTT,0,485702
araBp,0.3333333333333333,2,2,TTGTAAACGAGGTTCTAGTT,0,522309
araBp,0.3333333333333333,2,2,TTGGTTTTAGGAATCCGGTT,0,470340
araBp,0.3333333333333333,2,2,TTGGTACCATGGGTGGTCGT,0,494278
araBp,0.3333333333333333,2,2,TTGGGTTCATCCTGTTCCAG,0,505514
araBp,0.3333333333333333,2,2,TTGGGGTACGAGACTGGTAT,0,479492
araBp,0.3333333333333333,2,2,TTGGGGGTGGGCCTATGGTT,0,479368
araBp,0.3333333333333333,2,2,TTGGGAAAGGTAAGGGGGAG,0,468162
araBp,0.3333333333333333,2,2,TTGGCCCTGGCTTATAGCGT,0,521674
araBp,0.3333333333333333,2,2,TTGGATGTCCAACACGGCCG,0,470101
araBp,0.3333333333333333,2,2,TTGCTTCAGAGAGACGAAGC,0,496370
araBp,0.3333333333333333,2,2,TTGCGGGGCAATGTCAAACC,0,474170
araBp,0.3333333333333333,2,2,TTGCGGGATATTGCGGGCTT,0,518478
araBp,0.3333333333333333,2,2,TTGCGGACTTTGTGATACGT,0,505450
araBp,0.3333333333333333,2,2,TTGCCCTTGGCCCGTTTAGA,0,476226
araBp,0.3333333333333333,2,2,TTGCCCGTCGAGCGTCCGAA,0,519076
araBp,0.3333333333333333,2,2,TTGCCAAAAGAGGATCCTCA,0,505047
araBp,0.3333333333333333,2,2,TTGCAGTACATGCTATGCAG,0,512440
araBp,0.3333333333333333,2,2,TTGCAGGGGTCCGGGACATG,0,510249
araBp,0.3333333333333333,2,2,TTGATTGGGTACGGCCTGTC,0,512685
araBp,0.3333333333333333,2,2,TTGAGGTAATTGGTCCTGAA,0,481048
araBp,0.3333333333333333,2,2,TTGACGGAGCCCACCAGTGT,0,487296
araBp,0.3333333333333333,2,2,TTGACCTTTCTGCAACTGGA,0,474066
araBp,0.3333333333333333,2,2,TTGAAAATAGTAAATATGAC,0,469104
araBp,0.3333333333333333,2,2,TTCTTGGAGCACGGACCTCG,0,497538
araBp,0.3333333333333333,2,2,TTCTTGATGTTTAACGAGCT,0,487649
araBp,0.3333333333333333,2,2,TTCTTGACGGCTGGAAGATG,0,491594
araBp,0.3333333333333333,2,2,TTCTGGGTGGATTTGGAAAC,0,513791
araBp,0.3333333333333333,2,2,TTCTGGGGATATTAGCGCTT,0,522110
araBp,0.3333333333333333,2,2,TTCTCCTTGAACTTAGCAAT,0,503926
araBp,0.3333333333333333,2,2,TTCTCCGTGTCCAGCCGCGG,0,490018
araBp,0.3333333333333333,2,2,TTCTAGTGCCGTGATCTTCG,0,491573
araBp,0.3333333333333333,2,2,TTCTAGTATTCTGGGCAAAT,0,489038
araBp,0.3333333333333333,2,2,TTCGTTGGTTTGGGAATACG,0,479243
araBp,0.3333333333333333,2,2,TTCGGGATCGTACTCGACTA,0,515207
araBp,0.3333333333333333,2,2,TTCGGACGTCATTGGTCAAA,0,488622
araBp,0.3333333333333333,2,2,TTCGAGAGGTGTTTGGCCCT,0,518762
araBp,0.3333333333333333,2,2,TTCCTCCTCAGAATGATGAG,0,476959
araBp,0.3333333333333333,2,2,TTCCGTCAGACTTTGGTCCT,0,519142
araBp,0.3333333333333333,2,2,TTCCGTATTTGGGCTATGCG,0,487126
araBp,0.3333333333333333,2,2,TTCCGTATCCGCGGGCGAAA,0,473573
araBp,0.3333333333333333,2,2,TTCCCTGTTCTCGCACAAGG,0,493642
araBp,0.3333333333333333,2,2,TTCCCACTGATTGTACTCCA,0,512134
araBp,0.3333333333333333,2,2,TTCCATGAGTTGCGTTCGGT,0,514962
araBp,0.3333333333333333,2,2,TTCCAAGGAGGGCCACCAGG,0,494980
araBp,0.3333333333333333,2,2,TTCAGGCATAAATTCCTTGG,0,521097
araBp,0.3333333333333333,2,2,TTCAGCCCGTCGGTGTTGGA,0,495584
araBp,0.3333333333333333,2,2,TTCAGACGGCGTATTTGCTG,0,488530
araBp,0.3333333333333333,2,2,TTATTCCCAAGAAAGCATGA,0,521033
araBp,0.3333333333333333,2,2,TTATTAAATCCATTGCAGAC,0,470076
araBp,0.3333333333333333,2,2,TTATGCCTACATTCCTGTAG,0,521778
araBp,0.3333333333333333,2,2,TTATCGTGCAGCGAGCGACA,0,478309
araBp,0.3333333333333333,2,2,TTATATTTACCGATCACAGC,0,525221
araBp,0.3333333333333333,2,2,TTATATCCTAAGAAGGCAGT,0,511263
araBp,0.3333333333333333,2,2,TTATAACCTAGGTGCGTTGT,0,470089
araBp,0.3333333333333333,2,2,TTAGTTAAAGGCTTCGTCGG,0,477282
araBp,0.3333333333333333,2,2,TTAGTGTATACTACACGTAT,0,485590
araBp,0.3333333333333333,2,2,TTAGTAGGAGATAACGCCGA,0,470234
araBp,0.3333333333333333,2,2,TTAGGGGTGGACGTAGACGC,0,485375
araBp,0.3333333333333333,2,2,TTAGGATATTGCGCAGGCCC,0,496372
araBp,0.3333333333333333,2,2,TTAGCTTCTGGGCAACTATT,0,494500
araBp,0.3333333333333333,2,2,TTAGATTGTACCTTCCGGAA,0,521941
araBp,0.3333333333333333,2,2,TTAGATGTCAATCGAAGCCA,0,503114
araBp,0.3333333333333333,2,2,TTAGATAGATATCTGTCATT,0,496725
araBp,0.3333333333333333,2,2,TTACTTTGGATAAAGACCCG,0,515468
araBp,0.3333333333333333,2,2,TTACTTAACTTTATGTGTAA,0,485341
araBp,0.3333333333333333,2,2,TTACTCACGTTGTTCTCTGC,0,474438
araBp,0.3333333333333333,2,2,TTACGTGGGAGGCATATTGA,0,488060
araBp,0.3333333333333333,2,2,TTACGATTCTGTCTTACTGT,0,470236
araBp,0.3333333333333333,2,2,TTACCACACGTTTTCTCAGC,0,472122
araBp,0.3333333333333333,2,2,TTAATTGGATTAGGTACGTT,0,495626
araBp,0.3333333333333333,2,2,TTAATAGGCTTCGGATGATT,0,490736
araBp,0.3333333333333333,2,2,TTAAGCGCGAAGCGTCATCA,0,519284
araBp,0.3333333333333333,2,2,TTAAGAAAAGCAAAGTGGTC,0,524391
araBp,0.3333333333333333,2,2,TTAACGAGTTGTACGATGTC,0,519152
araBp,0.3333333333333333,2,2,TTAACCTTGATTCAATAGCG,0,486891
araBp,0.3333333333333333,2,2,TTAAAATACTGCGGTGCAAT,0,515796
araBp,0.3333333333333333,2,2,TGTTTGTGGCACTCGCTCAT,0,505243
araBp,0.3333333333333333,2,2,TGTTTGGTTCTGCCGTTTAT,0,485462
araBp,0.3333333333333333,2,2,TGTTGGGCGTAAGGGCTGGA,0,473764
araBp,0.3333333333333333,2,2,TGTTGGCATTTCGCCTCACA,0,478841
araBp,0.3333333333333333,2,2,TGTTGCTCTGGATGCGCCCC,0,483326
araBp,0.3333333333333333,2,2,TGTGTGTCCGGTCTCGACTT,0,514883
araBp,0.3333333333333333,2,2,TGTGTGGGTTGTGTCTGGAC,0,507898
araBp,0.3333333333333333,2,2,TGTGGGTCGAGAACTGGAGA,0,523847
araBp,0.3333333333333333,2,2,TGTGCTTCGACTCGACGAAA,0,475624
araBp,0.3333333333333333,2,2,TGTGATAAATTATCTGTGCG,0,476678
araBp,0.3333333333333333,2,2,TGTGAGGAATGTGTGGTTAC,0,502230
araBp,0.3333333333333333,2,2,TGTCTTTACCCTGACCCCGA,0,479099
araBp,0.3333333333333333,2,2,TGTCCTATACCTCTACCCAC,0,485096
araBp,0.3333333333333333,2,2,TGTCCCTGCCTGCCCATGCC,0,495691
araBp,0.3333333333333333,2,2,TGTCCACTCGCGCATTAGAA,0,478379
araBp,0.3333333333333333,2,2,TGTCCAACTCCGTAGATTTC,0,496792
araBp,0.3333333333333333,2,2,TGTCATTTGGGGGTGATAAG,0,506599
araBp,0.3333333333333333,2,2,TGTATTGTTGTAGCACGTTA,0,472668
araBp,0.3333333333333333,2,2,TGTATTCTTGCGGCTTGTGT,0,468599
araBp,0.3333333333333333,2,2,TGTATTCGGGTATCTCCAGT,0,501424
araBp,0.3333333333333333,2,2,TGTATCTATCCTAGGGGGTT,0,473575
araBp,0.3333333333333333,2,2,TGTATACGACGATTTTCGTG,0,511684
araBp,0.3333333333333333,2,2,TGTAGTACACGGCCACCGCC,0,508618
araBp,0.3333333333333333,2,2,TGTAGAAGTTGCCGTAGGCA,0,506321
araBp,0.3333333333333333,2,2,TGTACTTGTAAGTCATCGCT,0,494404
araBp,0.3333333333333333,2,2,TGGTTCGGGAGCGTTGGCTA,0,483040
araBp,0.3333333333333333,2,2,TGGTCGTATCAAAAAGTGAA,0,495996
araBp,0.3333333333333333,2,2,TGGTCCTGGTGCATAAAATA,0,508018
araBp,0.3333333333333333,2,2,TGGTCACTCGAATCTCATAC,0,510829
araBp,0.3333333333333333,2,2,TGGTAGCACGCGCCAGTAGG,0,508383
araBp,0.3333333333333333,2,2,TGGGTAAGTCCTGACAATGC,0,472524
araBp,0.3333333333333333,2,2,TGGGGTACGGAGATGGCGAG,0,497644
araBp,0.3333333333333333,2,2,TGGGGGCTGACCGGAAGGAA,0,510672
araBp,0.3333333333333333,2,2,TGGGGAAGAAGGTAAAAACA,0,507150
araBp,0.3333333333333333,2,2,TGGGCCATCCGCCGACCACG,0,502980
araBp,0.3333333333333333,2,2,TGGGATTATGCATGAGCCTA,0,487426
araBp,0.3333333333333333,2,2,TGGGAAGACGAATGGAGGAA,0,524070
araBp,0.3333333333333333,2,2,TGGCTTTGCTACGGCTCATT,0,488752
araBp,0.3333333333333333,2,2,TGGCTTATCATATGATTGCA,0,483809
araBp,0.3333333333333333,2,2,TGGCTGACCGGGTGAGAGGG,0,471713
araBp,0.3333333333333333,2,2,TGGCTCCTTGACTTGCTGAC,0,505484
araBp,0.3333333333333333,2,2,TGGCGTGGCTTATCTTGAGA,0,500828
araBp,0.3333333333333333,2,2,TGGCGGACCGCGTATTCTAC,0,513231
araBp,0.3333333333333333,2,2,TGGCGCGTCCATATGGGTCT,0,502624
araBp,0.3333333333333333,2,2,TGGCGACTGGCGTCACTGGG,0,503208
araBp,0.3333333333333333,2,2,TGGCCTGATGTCAGGCGGTG,0,503764
araBp,0.3333333333333333,2,2,TGGCCTGACTTTAGTAAGAC,0,493200
araBp,0.3333333333333333,2,2,TGGCCTAGGTGGTCCCTAGA,0,490252
araBp,0.3333333333333333,2,2,TGGCATCAGCGGGGATGTAA,0,523983
araBp,0.3333333333333333,2,2,TGGATCTCGGTCCTAAGACC,0,488694
araBp,0.3333333333333333,2,2,TGGATAGCGTTTCGTTGCAA,0,484119
araBp,0.3333333333333333,2,2,TGGATAAGGATGAAGCTATC,0,513812
araBp,0.3333333333333333,2,2,TGGAGATGTGGCATGCCCTG,0,472318
araBp,0.3333333333333333,2,2,TGGACGTCAACATCCAGCTT,0,509998
araBp,0.3333333333333333,2,2,TGGACGCGGTCAGAGTGTTC,0,511772
araBp,0.3333333333333333,2,2,TGGACCCCGACGTGACAGTT,0,519761
araBp,0.3333333333333333,2,2,TGGACATTGACAAAGACTTG,0,492606
araBp,0.3333333333333333,2,2,TGGACAGGCACCTTACCAAA,0,519737
araBp,0.3333333333333333,2,2,TGCTTTGACTCGGAGAGCGG,0,473046
araBp,0.3333333333333333,2,2,TGCTTTCAGCCATAGTTTTG,0,497204
araBp,0.3333333333333333,2,2,TGCTTAGCATGGGTCGTGAT,0,493485
araBp,0.3333333333333333,2,2,TGCTGCTGCCTCATTTTGAC,0,482821
araBp,0.3333333333333333,2,2,TGCTGCATCACCTGGGGCTC,0,479263
araBp,0.3333333333333333,2,2,TGCTGAGGATTAGGTGAGGT,0,474587
araBp,0.3333333333333333,2,2,TGCTGACAAGCAGAGTGAAC,0,502705
araBp,0.3333333333333333,2,2,TGCTAGTGTCAAGCATCTCA,0,483956
araBp,0.3333333333333333,2,2,TGCTACATCCGACCTCTGGG,0,504675
araBp,0.3333333333333333,2,2,TGCGTGCTCTAGCTAGCCAC,0,521387
araBp,0.3333333333333333,2,2,TGCGTGCGCTAAATGGGGGT,0,495671
araBp,0.3333333333333333,2,2,TGCGTACAAAAACTACGGCA,0,497035
araBp,0.3333333333333333,2,2,TGCGGGCCAAGCACATCTTC,0,514325
araBp,0.3333333333333333,2,2,TGCGGGACTTAACGATAAGA,0,505707
araBp,0.3333333333333333,2,2,TGCGGCTGACACGTCTTGGT,0,507957
araBp,0.3333333333333333,2,2,TGCGGATACAATCGGGCAAT,0,496320
araBp,0.3333333333333333,2,2,TGCGGAATCTCATTACAAAA,0,520391
araBp,0.3333333333333333,2,2,TGCGCCAGGTGTGACTAGGT,0,472436
araBp,0.3333333333333333,2,2,TGCGCAGATTGCCCCTAGTT,0,518766
araBp,0.3333333333333333,2,2,TGCGACTACTGTAAGGCAGT,0,496617
araBp,0.3333333333333333,2,2,TGCGAAATTCTGTCTGCAGA,0,504111
araBp,0.3333333333333333,2,2,TGCCGGTACTCTGGAGCATC,0,502905
araBp,0.3333333333333333,2,2,TGCCGGGACCAGTAGCCAAC,0,517906
araBp,0.3333333333333333,2,2,TGCCCTATCTATCCAAGGGA,0,523952
araBp,0.3333333333333333,2,2,TGCCCCGGGCGTATCGCGTA,0,520110
araBp,0.3333333333333333,2,2,TGCCATTCTCGATGTCATGG,0,468842
araBp,0.3333333333333333,2,2,TGCATCTCCAGAGTAGAGAG,0,516173
araBp,0.3333333333333333,2,2,TGCATCCTGAGGTAAAAGCG,0,510864
araBp,0.3333333333333333,2,2,TGCATCCGACTGTTTGGTAG,0,478485
araBp,0.3333333333333333,2,2,TGCATATACCGGTGGCGATC,0,524902
araBp,0.3333333333333333,2,2,TGCATAGTATGTCGTGGACT,0,508011
araBp,0.3333333333333333,2,2,TGCATAGGACCGCACAGGGT,0,517275
araBp,0.3333333333333333,2,2,TGCAGGGTGCCCCTGCCAAC,0,525491
araBp,0.3333333333333333,2,2,TGCAGCATGGTGGTAAGAGT,0,470286
araBp,0.3333333333333333,2,2,TGCACTCGAGAACCGAGGTG,0,503656
araBp,0.3333333333333333,2,2,TGCACTATGTTCACGGATTG,0,492646
araBp,0.3333333333333333,2,2,TGATTCTACCCGTAGAACAG,0,502399
araBp,0.3333333333333333,2,2,TGATTCGAAGAATTAAAGAA,0,488995
araBp,0.3333333333333333,2,2,TGATCCATTTTTCAACACCA,0,496224
araBp,0.3333333333333333,2,2,TGATAGTGTTAGAATACTGT,0,483250
araBp,0.3333333333333333,2,2,TGATACGTAGTTGTCCTTCT,0,510417
araBp,0.3333333333333333,2,2,TGAGTGTTAAAATTCACGCT,0,502816
araBp,0.3333333333333333,2,2,TGAGTCATTACATCTGCGTT,0,515957
araBp,0.3333333333333333,2,2,TGAGTAGAAGAGGTTTACGG,0,523613
araBp,0.3333333333333333,2,2,TGAGATGTGAGTCCTAGCCA,0,507681
araBp,0.3333333333333333,2,2,TGACTCGTTCATCCCTTTAT,0,469882
araBp,0.3333333333333333,2,2,TGACTCAGCAGGTCGTAAAG,0,499024
araBp,0.3333333333333333,2,2,TGACGCGTTGCTTTGGGCTA,0,516948
araBp,0.3333333333333333,2,2,TGACCTCAGCAACCACTACT,0,514099
araBp,0.3333333333333333,2,2,TGACCCCTCGGTTCTCCAGG,0,490584
araBp,0.3333333333333333,2,2,TGACAGGACACGTCTTCTAC,0,515532
araBp,0.3333333333333333,2,2,TGAATCCTAAATGAGACTGG,0,483539
araBp,0.3333333333333333,2,2,TGAAGGGGAACATTGCCGGG,0,519759
araBp,0.3333333333333333,2,2,TGAACCACCGAGTCCGTCCT,0,476007
araBp,0.3333333333333333,2,2,TGAAAGTAGTCGGCTTCTGG,0,506914
araBp,0.3333333333333333,2,2,TGAAAGCTTACTCATGTTTG,0,491083
araBp,0.3333333333333333,2,2,TGAAAGATAAGAAAGTACCT,0,509653
araBp,0.3333333333333333,2,2,TCTTTCGCACTCGATGTTGA,0,506215
araBp,0.3333333333333333,2,2,TCTTGTCTGGCCCGATAAGC,0,517509
araBp,0.3333333333333333,2,2,TCTTCTCGCGCAAGGGGAAT,0,491827
araBp,0.3333333333333333,2,2,TCTTCGTAGCAATAGTCATC,0,509752
araBp,0.3333333333333333,2,2,TCTTCATATTTGGTTTGTTA,0,498544
araBp,0.3333333333333333,2,2,TCTTATCACTATCCTTACTC,0,489407
araBp,0.3333333333333333,2,2,TCTTATAGGCGTGGGATGGG,0,486687
araBp,0.3333333333333333,2,2,TCTTACCAGAAGGCTAGAGG,0,505336
araBp,0.3333333333333333,2,2,TCTGTTAGGGAATATTAGAC,0,476585
araBp,0.3333333333333333,2,2,TCTGTGTTAAGGGGCCTACA,0,472033
araBp,0.3333333333333333,2,2,TCTGTCCAAGTTCCGCTTAA,0,488126
araBp,0.3333333333333333,2,2,TCTGGATATTGGCTCGCAAT,0,487293
araBp,0.3333333333333333,2,2,TCTGCCTTCGAGATTGGTAT,0,496961
araBp,0.3333333333333333,2,2,TCTCTTGCCAGTTTGAAAGG,0,476564
araBp,0.3333333333333333,2,2,TCTCTCTTGCATCGCCTGGG,0,497044
araBp,0.3333333333333333,2,2,TCTCGTACTTCCTTAAAAGC,0,522980
araBp,0.3333333333333333,2,2,TCTCAGAGGTGGAGGTTCGT,0,510150
araBp,0.3333333333333333,2,2,TCTCAATCGGTAGTATCGCC,0,482122
araBp,0.3333333333333333,2,2,TCTACTATTAAACGCTGAAT,0,510064
araBp,0.3333333333333333,2,2,TCTACGTAAGGCCCAATTAA,0,493474
araBp,0.3333333333333333,2,2,TCTACCGTGCGCCAAAGCGC,0,519749
araBp,0.3333333333333333,2,2,TCTACCACGAAGCGTAAATG,0,501620
araBp,0.3333333333333333,2,2,TCGTTTATGCGCATCATGGT,0,505281
araBp,0.3333333333333333,2,2,TCGTTGGCTCAGCATTATCA,0,484926
araBp,0.3333333333333333,2,2,TCGTGGTACTCCCCGCCCGA,0,518907
araBp,0.3333333333333333,2,2,TCGTGAGCGGGCTCACGCAT,0,505817
araBp,0.3333333333333333,2,2,TCGTGACGAAGTACGAAGTC,0,509719
araBp,0.3333333333333333,2,2,TCGTCGTCACGGGTTATTTC,0,476167
araBp,0.3333333333333333,2,2,TCGTCCTCCCCATGTGAGGA,0,484311
araBp,0.3333333333333333,2,2,TCGTCATCTTTCATGCGAAG,0,479464
araBp,0.3333333333333333,2,2,TCGTATCTCGATTGAGGGTA,0,468810
araBp,0.3333333333333333,2,2,TCGTACTAACAGATAGGCCA,0,507442
araBp,0.3333333333333333,2,2,TCGTAAGCACCGGGGGTCCA,0,519016
araBp,0.3333333333333333,2,2,TCGGTCTGGGCAATAACGGG,0,475566
araBp,0.3333333333333333,2,2,TCGGTCTCAGCGTTAGGCAT,0,474850
araBp,0.3333333333333333,2,2,TCGGGGGAGGCAACGAAACC,0,499225
araBp,0.3333333333333333,2,2,TCGGGGGACCACTAAGTATT,0,513642
araBp,0.3333333333333333,2,2,TCGGGAATCAGTCATCTATT,0,516214
araBp,0.3333333333333333,2,2,TCGGATCTGTGGAGGGCGGG,0,487661
araBp,0.3333333333333333,2,2,TCGGAACGCGCTCTAAGCAA,0,467983
araBp,0.3333333333333333,2,2,TCGCTTTCGGCTCCCGCAAG,0,512115
araBp,0.3333333333333333,2,2,TCGCTACGCACTCCGTGCGC,0,479701
araBp,0.3333333333333333,2,2,TCGCCGTGAACGGTGTAGGA,0,508335
araBp,0.3333333333333333,2,2,TCGCAGAATATGTATTAACT,0,490855
araBp,0.3333333333333333,2,2,TCGCAAGCAACATTGATAAA,0,508403
araBp,0.3333333333333333,2,2,TCGATAGCGGACGTTGGTGA,0,489266
araBp,0.3333333333333333,2,2,TCGAGTTAGTCTATAGTCAC,0,494229
araBp,0.3333333333333333,2,2,TCGAGTGGATCTTATGGACC,0,484958
araBp,0.3333333333333333,2,2,TCGAGAGTTACACATTGTAT,0,513331
araBp,0.3333333333333333,2,2,TCGAGAGGTATTCATCAACC,0,521828
araBp,0.3333333333333333,2,2,TCGACTCCGGGTCTTCAATG,0,489969
araBp,0.3333333333333333,2,2,TCGAATTTGAAAACTGTAGA,0,485515
araBp,0.3333333333333333,2,2,TCGAATCCAATTGGGTACAG,0,517252
araBp,0.3333333333333333,2,2,TCGAAGGTCTTACGTCGCCG,0,495855
araBp,0.3333333333333333,2,2,TCGAAGCGCCAGGCACGTTT,0,485475
araBp,0.3333333333333333,2,2,TCCTGGTCCCTTGGTCGAGA,0,522786
araBp,0.3333333333333333,2,2,TCCTGGGGTAGATAACTGGT,0,467949
araBp,0.3333333333333333,2,2,TCCTCAGGTCCGATAGCTGT,0,490559
araBp,0.3333333333333333,2,2,TCCTATGGACTGTGGAGGAA,0,513673
araBp,0.3333333333333333,2,2,TCCTAATCGCCCCCGTCTCA,0,493250
araBp,0.3333333333333333,2,2,TCCGTTGCGAGAAACCCTTC,0,509840
araBp,0.3333333333333333,2,2,TCCGTAGATCGATGCCTTAG,0,472107
araBp,0.3333333333333333,2,2,TCCGTAATGGTGTGGGATCG,0,489889
araBp,0.3333333333333333,2,2,TCCGCTTTTGGGAGCAAGAG,0,478617
araBp,0.3333333333333333,2,2,TCCGCTCAACTATCTCGGGG,0,519283
araBp,0.3333333333333333,2,2,TCCGCGGCGTTAGTAGTATG,0,489973
araBp,0.3333333333333333,2,2,TCCGCAGTCCTGTAAACTTG,0,476291
araBp,0.3333333333333333,2,2,TCCGACTCGGCCATGTGGCC,0,509208
araBp,0.3333333333333333,2,2,TCCGACCGGCATTGTCCAAA,0,512523
araBp,0.3333333333333333,2,2,TCCGACAGGAAAGAAAAACA,0,509869
araBp,0.3333333333333333,2,2,TCCCTGGGGAGGCCGTATCA,0,513622
araBp,0.3333333333333333,2,2,TCCCGTGCGGGGAAGCTGTC,0,521011
araBp,0.3333333333333333,2,2,TCCCGGTAAAAGAAGCTAGA,0,490641
araBp,0.3333333333333333,2,2,TCCCGATGGTATCTATAAAG,0,516869
araBp,0.3333333333333333,2,2,TCCCCCGCAAAAGACGCGAT,0,491524
araBp,0.3333333333333333,2,2,TCCCATGGGGGTCATACTCT,0,496403
araBp,0.3333333333333333,2,2,TCCCAGAGTGCGACCCTGGA,0,503930
araBp,0.3333333333333333,2,2,TCCATCGAGAGCCATGTTCG,0,521787
araBp,0.3333333333333333,2,2,TCCATAAGTTAGGATATCGC,0,506803
araBp,0.3333333333333333,2,2,TCCAATACTAGACAATAGCG,0,478597
araBp,0.3333333333333333,2,2,TCCAAGTACGAAACACCAGA,0,522057
araBp,0.3333333333333333,2,2,TCCAAACGTCCTGCGCAGTC,0,489519
araBp,0.3333333333333333,2,2,TCATTTTTCCAACTAAAACT,0,477389
araBp,0.3333333333333333,2,2,TCATTGCAACTCGTGCACAC,0,507763
araBp,0.3333333333333333,2,2,TCATGTTCATTACGACTGTG,0,515951
araBp,0.3333333333333333,2,2,TCATGGTTCTTTATCTGCTA,0,477236
araBp,0.3333333333333333,2,2,TCATGGTTCCGAAATGGAAC,0,480230
araBp,0.3333333333333333,2,2,TCATGGTCCCTGAAGAGCAT,0,478314
araBp,0.3333333333333333,2,2,TCATCATTGAATTACGGATG,0,508923
araBp,0.3333333333333333,2,2,TCATAGTTCTTCTCGCGAAA,0,498467
araBp,0.3333333333333333,2,2,TCAGTTGGAACTCTGCTCAA,0,469039
araBp,0.3333333333333333,2,2,TCAGGAGGTACCAACCAGTG,0,508299
araBp,0.3333333333333333,2,2,TCAGCGGATTAATTCAATTC,0,516791
araBp,0.3333333333333333,2,2,TCAGACGGGACCACCCGGGG,0,490069
araBp,0.3333333333333333,2,2,TCAGACGCAGGTATGCTTGT,0,504905
araBp,0.3333333333333333,2,2,TCAGACCGCACCACTCACAT,0,471422
araBp,0.3333333333333333,2,2,TCAGACCCACTGTCATCGAC,0,474546
araBp,0.3333333333333333,2,2,TCAGAATGAAGGAGGTTAGT,0,490488
araBp,0.3333333333333333,2,2,TCAGAAACATGCGAATCGCT,0,524755
araBp,0.3333333333333333,2,2,TCACTTGGACCAACGTCTAT,0,472471
araBp,0.3333333333333333,2,2,TCACGGTGCGTTTGCCTAAG,0,476841
araBp,0.3333333333333333,2,2,TCACGGGTCGTGTTTATGCG,0,469693
araBp,0.3333333333333333,2,2,TCACGGAACGGGATACTTAA,0,518987
araBp,0.3333333333333333,2,2,TCACGCTGTTGCAATCGGTT,0,470319
araBp,0.3333333333333333,2,2,TCACGCATCGTCTGCGGTGA,0,496622
araBp,0.3333333333333333,2,2,TCACGCAATAGAGTGGGCGC,0,506411
araBp,0.3333333333333333,2,2,TCACCACTGCTGCTTCAATT,0,519358
araBp,0.3333333333333333,2,2,TCACATTTGGGTGGAGGCTT,0,478945
araBp,0.3333333333333333,2,2,TCACAGAAGACTTATGATAT,0,490761
araBp,0.3333333333333333,2,2,TCAATCCTCGCGCGGGTATG,0,520769
araBp,0.3333333333333333,2,2,TCAAGTTTTCGGCAGTTCCT,0,508044
araBp,0.3333333333333333,2,2,TCAAGTTCTGCTGAGGCATG,0,489551
araBp,0.3333333333333333,2,2,TCAACTTTATCATAGCGTAA,0,506977
araBp,0.3333333333333333,2,2,TCAACTGTGCAGCTGAGGCA,0,472313
araBp,0.3333333333333333,2,2,TATTTTTCAGACTTGAAACC,0,497867
araBp,0.3333333333333333,2,2,TATTTGCAAATACCATGGTA,0,504590
araBp,0.3333333333333333,2,2,TATTTGACCTAGAGAAAATT,0,469413
araBp,0.3333333333333333,2,2,TATTTCGCGGACTCGACGTT,0,521894
araBp,0.3333333333333333,2,2,TATTTAACTAGCATGAGCCT,0,524745
araBp,0.3333333333333333,2,2,TATTGAGAAAGGTCGCGAAT,0,468026
araBp,0.3333333333333333,2,2,TATTCGCTAATTGGGTATAC,0,499514
araBp,0.3333333333333333,2,2,TATTCCTCACGCGTTCGAGG,0,488061
araBp,0.3333333333333333,2,2,TATTAACTGCTATTTCCCTG,0,506476
araBp,0.3333333333333333,2,2,TATGGTCCACCATCTTTAGT,0,522972
araBp,0.3333333333333333,2,2,TATGCTGTCGGCCGTATGCC,0,511395
araBp,0.3333333333333333,2,2,TATGCCCTTGCCTTTAATTT,0,470612
araBp,0.3333333333333333,2,2,TATGATATTTTCAGTCATGT,0,501164
araBp,0.3333333333333333,2,2,TATGAAACCTCCACGTCATT,0,506292
araBp,0.3333333333333333,2,2,TATCTATTCGTAATGTCTAG,0,515554
araBp,0.3333333333333333,2,2,TATCTATGGCGAGTTTGACG,0,474927
araBp,0.3333333333333333,2,2,TATCCACGAGTGCGCCTAGT,0,501494
araBp,0.3333333333333333,2,2,TATAGCAGAGTTCATATACG,0,471809
araBp,0.3333333333333333,2,2,TATACAACGTCAGTAAACTC,0,515012
araBp,0.3333333333333333,2,2,TATAAGGATTGTTACGTGGA,0,489451
araBp,0.3333333333333333,2,2,TAGGGTCTATCCCGGTAAAC,0,498180
araBp,0.3333333333333333,2,2,TAGGGCTCTTCACTCCGTAG,0,499573
araBp,0.3333333333333333,2,2,TAGGGCACCAAATCCAGAAG,0,516927
araBp,0.3333333333333333,2,2,TAGGAGGAAATGCGTTGCGA,0,489559
araBp,0.3333333333333333,2,2,TAGGAGCATAATACTTAAAG,0,513595
araBp,0.3333333333333333,2,2,TAGGAATGGTGCTCATAATT,0,505990
araBp,0.3333333333333333,2,2,TAGCGGTATTCTAGGATATC,0,513533
araBp,0.3333333333333333,2,2,TAGCGCTCTGAACGGACACT,0,487910
araBp,0.3333333333333333,2,2,TAGCGAGGTCTTTTATTCAG,0,508989
araBp,0.3333333333333333,2,2,TAGCCTAAGCGCCCGCTTCA,0,483605
araBp,0.3333333333333333,2,2,TAGCCCATTTGTCGCCCGAG,0,504888
araBp,0.3333333333333333,2,2,TAGCCATTATTTTCAATCGT,0,499836
araBp,0.3333333333333333,2,2,TAGATTCCTTGGGTCTAAAA,0,514756
araBp,0.3333333333333333,2,2,TAGATGCGATCAGCTGATAT,0,495570
araBp,0.3333333333333333,2,2,TAGATCTGTTGTAGCGGTGA,0,514523
araBp,0.3333333333333333,2,2,TAGAGCGAGGGCCACTTGAA,0,505876
araBp,0.3333333333333333,2,2,TAGAGAGACTAATGCGCCAT,0,511675
araBp,0.3333333333333333,2,2,TAGACTGCTCGAGGATAGGC,0,474614
araBp,0.3333333333333333,2,2,TAGACGTGGCTTATTCTTCA,0,485627
araBp,0.3333333333333333,2,2,TAGAAGTAGTGTGGATTCCG,0,508204
araBp,0.3333333333333333,2,2,TAGAAGGTGTACAGTGATTG,0,490581
araBp,0.3333333333333333,2,2,TAGAAACGTAAGGCGTGGTA,0,490647
araBp,0.3333333333333333,2,2,TACTTGTGGCAAGGTCGACG,0,493145
araBp,0.3333333333333333,2,2,TACTTAGTAGTCTGGCTGAC,0,483646
araBp,0.3333333333333333,2,2,TACTTAGGATCTAGCTGCGC,0,485069
araBp,0.3333333333333333,2,2,TACTGTCAGTCGGTAAAGCA,0,523373
araBp,0.3333333333333333,2,2,TACTGGGGACCAGAGGCCAT,0,491183
araBp,0.3333333333333333,2,2,TACTCTATGGGCTGGGATAA,0,522403
araBp,0.3333333333333333,2,2,TACTATCTATGCTGTATCGG,0,506907
araBp,0.3333333333333333,2,2,TACTACGCCTGACGGGGGTA,0,485666
araBp,0.3333333333333333,2,2,TACGTCTGGAATGTCAGTTC,0,525462
araBp,0.3333333333333333,2,2,TACGGCTCATGCGAAGAATC,0,477162
araBp,0.3333333333333333,2,2,TACGCCTCTTGGTGGGAGTG,0,501293
araBp,0.3333333333333333,2,2,TACGCATAGTCCTCAAACGT,0,502981
araBp,0.3333333333333333,2,2,TACGATATCTGGCGTATGTA,0,495412
araBp,0.3333333333333333,2,2,TACGACCAGTATAGTTAACG,0,478659
araBp,0.3333333333333333,2,2,TACGAAAGCTGGAACTAGGA,0,502772
araBp,0.3333333333333333,2,2,TACCTTGTGTCCTAACTATG,0,506279
araBp,0.3333333333333333,2,2,TACCTCTACATGGTACTGTA,0,487073
araBp,0.3333333333333333,2,2,TACCGTGCGAACCTATTAGC,0,513100
araBp,0.3333333333333333,2,2,TACCCCCCCATTGCATTGAA,0,492349
araBp,0.3333333333333333,2,2,TACCAAGGCCGATAAACTCA,0,521806
araBp,0.3333333333333333,2,2,TACAGGGTTGCACTTGCCTC,0,524459
araBp,0.3333333333333333,2,2,TACAACCTCGGGAGTGTTCT,0,510229
araBp,0.3333333333333333,2,2,TACAAAAACTCGATGGCTAG,0,504077
araBp,0.3333333333333333,2,2,TAATTTAGTTGTATGCGGTC,0,507753
araBp,0.3333333333333333,2,2,TAATTGCCGCACCTTGCTGT,0,483533
araBp,0.3333333333333333,2,2,TAATGTGCGGCGGTCCATCT,0,513458
araBp,0.3333333333333333,2,2,TAATGTCTGAGATTCCCAGA,0,482259
araBp,0.3333333333333333,2,2,TAAGGGCAAACTTGCGCGGT,0,523748
araBp,0.3333333333333333,2,2,TAAGATTTTTGAGCTTCACG,0,509571
araBp,0.3333333333333333,2,2,TAAGATGCTGGGTTGTATCA,0,496281
araBp,0.3333333333333333,2,2,TAACTGCAATCGGGGATTTC,0,467857
araBp,0.3333333333333333,2,2,TAAATTGGGTCATGACGGAT,0,480636
araBp,0.3333333333333333,2,2,TAAATCCGGACCCGTATTAC,0,514216
araBp,0.3333333333333333,2,2,TAAATATCCTTTTGATTCAA,0,489966
araBp,0.3333333333333333,2,2,TAAATAACCAAAGGACCGAA,0,498017
araBp,0.3333333333333333,2,2,TAAAGTACTCTATACATCAG,0,484450
araBp,0.3333333333333333,2,2,TAAAGTACGGGGCCTCTGCC,0,472298
araBp,0.3333333333333333,2,2,TAAAGGTAAAGCATATCTCA,0,495351
araBp,0.3333333333333333,2,2,TAAACTCTTGGAAGGATCTA,0,487808
araBp,0.3333333333333333,2,2,TAAACGGTCCCCCATGAATA,0,514936
araBp,0.3333333333333333,2,2,TAAAAGTCCTACAAGCCAAG,0,506830
araBp,0.3333333333333333,2,2,GTTTTATGTATATAGATAAG,0,513288
araBp,0.3333333333333333,2,2,GTTTGTTTCGGGAGTCCTGT,0,476064
araBp,0.3333333333333333,2,2,GTTTGTTCAGAACCAACGTT,0,507000
araBp,0.3333333333333333,2,2,GTTTGTCATCCCCTTTTTTA,0,517687
araBp,0.3333333333333333,2,2,GTTTGGCTTGTCTCCTGCAT,0,500638
araBp,0.3333333333333333,2,2,GTTTCTCTGGTTATGATTAT,0,517604
araBp,0.3333333333333333,2,2,GTTTCTCAGTTTCTTGGCGT,0,472818
araBp,0.3333333333333333,2,2,GTTTCGTTGGATATTGGCGC,0,488418
araBp,0.3333333333333333,2,2,GTTTCCTTCCGGGACGAGGT,0,519727
araBp,0.3333333333333333,2,2,GTTTATGGGTGAGGTTCCGT,0,511231
araBp,0.3333333333333333,2,2,GTTTATGGATAGGTCAGGCA,0,524407
araBp,0.3333333333333333,2,2,GTTTAGTTGGCACTCGTAAA,0,495234
araBp,0.3333333333333333,2,2,GTTTAGTAGTAGGTGTGAGT,0,518736
araBp,0.3333333333333333,2,2,GTTTAGGTTATGCATTTATG,0,500264
araBp,0.3333333333333333,2,2,GTTTACGAGACTCCGTTGCT,0,500331
araBp,0.3333333333333333,2,2,GTTGTGTGAGCGTTAATAAG,0,471545
araBp,0.3333333333333333,2,2,GTTGTCTTAGGGGCAACAAG,0,467785
araBp,0.3333333333333333,2,2,GTTGGGTGTATCCACATGAA,0,479063
araBp,0.3333333333333333,2,2,GTTGGGACCGTTGTGCTTCC,0,470105
araBp,0.3333333333333333,2,2,GTTGCTAGAAGTCGAGGTGT,0,491334
araBp,0.3333333333333333,2,2,GTTGCGGTCTGGACAATATG,0,524654
araBp,0.3333333333333333,2,2,GTTCTCAGGCTGGAGAGTCT,0,505140
araBp,0.3333333333333333,2,2,GTTCTAAGATGTCGCTAAAG,0,494661
araBp,0.3333333333333333,2,2,GTTCGTCCTGAGTGCGTGAT,0,512786
araBp,0.3333333333333333,2,2,GTTCGCCGCCACAACTTAAC,0,520508
araBp,0.3333333333333333,2,2,GTTCCTACACAACCTTCGAA,0,492391
araBp,0.3333333333333333,2,2,GTTCAATTACTAATGTGAAA,0,520774
araBp,0.3333333333333333,2,2,GTTATGGTGTGGAAAGCCTA,0,470535
araBp,0.3333333333333333,2,2,GTTAGGAGTCTTCAAACCTT,0,515703
araBp,0.3333333333333333,2,2,GTTACGGGTATTCGTATAGC,0,503550
araBp,0.3333333333333333,2,2,GTTACAGGACAGACTAGGCG,0,493533
araBp,0.3333333333333333,2,2,GTTACAAGATTTGATAAAGT,0,494334
araBp,0.3333333333333333,2,2,GTTAATGGTCAAGACCACAA,0,514226
araBp,0.3333333333333333,2,2,GTTAATGGCAAATCTATCAA,0,477795
araBp,0.3333333333333333,2,2,GTTAAGGGCGGGAATTTTCT,0,470043
araBp,0.3333333333333333,2,2,GTTAAAAGTAGTTGCGCCTC,0,470148
araBp,0.3333333333333333,2,2,GTGTTGCGCTCTTGGCTGGG,0,507848
araBp,0.3333333333333333,2,2,GTGTTCAGCATTATTTGTCA,0,517706
araBp,0.3333333333333333,2,2,GTGTGGTTCATTATAGCGTA,0,496631
araBp,0.3333333333333333,2,2,GTGTGCCGGCCCGCATGAAT,0,506408
araBp,0.3333333333333333,2,2,GTGTGCATGCTTTAATGTAC,0,509062
araBp,0.3333333333333333,2,2,GTGTGATCCCTGCCAATTCA,0,471265
araBp,0.3333333333333333,2,2,GTGTCTGTGGGTGCCTGAGA,0,474426
araBp,0.3333333333333333,2,2,GTGTCTACTGCGGCAGCTTG,0,503953
araBp,0.3333333333333333,2,2,GTGTCGTTGGCACCCTATAC,0,479199
araBp,0.3333333333333333,2,2,GTGTCATCTTTTGGTGGATA,0,483894
araBp,0.3333333333333333,2,2,GTGTCAAAATCGGGGCGCCA,0,505855
araBp,0.3333333333333333,2,2,GTGGTTTGAAATGAGTGGAT,0,518176
araBp,0.3333333333333333,2,2,GTGGTTGGGGCAAATCCTGT,0,518630
araBp,0.3333333333333333,2,2,GTGGTGTAGTTAAATGTACC,0,514245
araBp,0.3333333333333333,2,2,GTGGGGCTTAAGCGGGTCAC,0,503954
araBp,0.3333333333333333,2,2,GTGGGAATGGACGGACCCCC,0,488992
araBp,0.3333333333333333,2,2,GTGGGAACTAAATGGCGCTC,0,489512
araBp,0.3333333333333333,2,2,GTGGCGTTAGGTCCATGTAA,0,513261
araBp,0.3333333333333333,2,2,GTGGCGGAATTGTTTCAATG,0,483146
araBp,0.3333333333333333,2,2,GTGGATTTCAGGAAGACTGA,0,475309
araBp,0.3333333333333333,2,2,GTGGATGCCTTCGCTCCGGT,0,501436
araBp,0.3333333333333333,2,2,GTGGATCCTAGGGGTGAAAG,0,490522
araBp,0.3333333333333333,2,2,GTGGACGGATTCGGGACTGG,0,511613
araBp,0.3333333333333333,2,2,GTGGACAGATAAGGCGTTGT,0,484512
araBp,0.3333333333333333,2,2,GTGCGTAAGTAGGAAGACTG,0,498186
araBp,0.3333333333333333,2,2,GTGCGCAACCAGCGAATACG,0,495956
araBp,0.3333333333333333,2,2,GTGCATACAGATCTCACGAT,0,472734
araBp,0.3333333333333333,2,2,GTGCAGGCGCACTGTACGGT,0,491730
araBp,0.3333333333333333,2,2,GTGATAGCTGTCGCGAGGAC,0,480327
araBp,0.3333333333333333,2,2,GTGAGGCCTACGTTTGGCCT,0,524010
araBp,0.3333333333333333,2,2,GTGAGAGTGGACCGATGGCT,0,470636
araBp,0.3333333333333333,2,2,GTGACTCTTATGGCCAATAC,0,509374
araBp,0.3333333333333333,2,2,GTGACTAGGTCAGTAGCGAC,0,501760
araBp,0.3333333333333333,2,2,GTGACGACTGCGAATATGCA,0,502255
araBp,0.3333333333333333,2,2,GTGACATATGTGTGGTTAAC,0,492451
araBp,0.3333333333333333,2,2,GTCTTTCGGGGCAGAGATAC,0,514668
araBp,0.3333333333333333,2,2,GTCTGCTTAACGGGAGAACG,0,477915
araBp,0.3333333333333333,2,2,GTCTGCACCTGATCTAGGAA,0,494851
araBp,0.3333333333333333,2,2,GTCTGATGGTAGAGATCTCG,0,484596
araBp,0.3333333333333333,2,2,GTCTCTGCTGCGTGTATCCC,0,525496
araBp,0.3333333333333333,2,2,GTCTCAGTTTAGCTAACTAC,0,468613
araBp,0.3333333333333333,2,2,GTCGTCAACTCTATTCTGAG,0,492991
araBp,0.3333333333333333,2,2,GTCGTATCGCTGTTACCCAC,0,492503
araBp,0.3333333333333333,2,2,GTCGTATATCGGCGGTTCAA,0,485334
araBp,0.3333333333333333,2,2,GTCGGCGGCAGATGGTGTAG,0,480476
araBp,0.3333333333333333,2,2,GTCGCGCTATGATAGTGTTT,0,502223
araBp,0.3333333333333333,2,2,GTCGATGGTTGATCGGGTCA,0,485135
araBp,0.3333333333333333,2,2,GTCGATGGCTCTAAGAAAAC,0,481503
araBp,0.3333333333333333,2,2,GTCGAGGAAAAATTAAGAGT,0,477012
araBp,0.3333333333333333,2,2,GTCGAACGACGCCAAATGTT,0,473248
araBp,0.3333333333333333,2,2,GTCCTGCTATTTCAAACTAT,0,521108
araBp,0.3333333333333333,2,2,GTCCTCGATCGCTCAACGCC,0,470698
araBp,0.3333333333333333,2,2,GTCCGGAAAGTGATCAAAGT,0,489759
araBp,0.3333333333333333,2,2,GTCCGAGCGTCTCAGTATCT,0,507881
araBp,0.3333333333333333,2,2,GTCCATAGTTCTCCGTAGTA,0,504194
araBp,0.3333333333333333,2,2,GTCAGGAATCCGGTTATCCG,0,474215
araBp,0.3333333333333333,2,2,GTCAATCATCAAGAGCCTTT,0,481921
araBp,0.3333333333333333,2,2,GTCAATATTTCGCCGTACGT,0,481834
araBp,0.3333333333333333,2,2,GTCAATATCGGTAGGCAAGT,0,484828
araBp,0.3333333333333333,2,2,GTCAACGTCTGGATCGGAAA,0,468791
araBp,0.3333333333333333,2,2,GTCAAACCGCGTCATAGTAG,0,500220
araBp,0.3333333333333333,2,2,GTATTTGCCTACGTGGACGC,0,501646
araBp,0.3333333333333333,2,2,GTATTGTATCCCGACTTCCT,0,477626
araBp,0.3333333333333333,2,2,GTATTGACGTAATAGCTTGG,0,467967
araBp,0.3333333333333333,2,2,GTATTCTAGTCTTGGTGCTG,0,510759
araBp,0.3333333333333333,2,2,GTATTCTAGGGATCGAGAAA,0,487376
araBp,0.3333333333333333,2,2,GTATTCATGGTCATAGTCCT,0,507650
araBp,0.3333333333333333,2,2,GTATGTTTTAGTGCAGAACT,0,474748
araBp,0.3333333333333333,2,2,GTATGAATTGACCAGTTTAA,0,516809
araBp,0.3333333333333333,2,2,GTAGTAGCGAGATACCTCCA,0,504351
araBp,0.3333333333333333,2,2,GTAGGTGAAAAAGGAGAGTT,0,470542
araBp,0.3333333333333333,2,2,GTAGGAGAGGAATCAATTAC,0,524632
araBp,0.3333333333333333,2,2,GTAGCGGTCAGCTTCTGGCT,0,482770
araBp,0.3333333333333333,2,2,GTAGATGTGCTCAACGCGCA,0,470227
araBp,0.3333333333333333,2,2,GTACGGAATGGAGAATTATT,0,491913
araBp,0.3333333333333333,2,2,GTACCCCGTAATTCATTACC,0,508241
araBp,0.3333333333333333,2,2,GTACCAATGCATCTTCAGAT,0,472735
araBp,0.3333333333333333,2,2,GTACAAAGATGCGGGAAGGG,0,503893
araBp,0.3333333333333333,2,2,GTACAAACATATAGATAACT,0,519226
araBp,0.3333333333333333,2,2,GTAATACGGACCGAGAAGAC,0,472007
araBp,0.3333333333333333,2,2,GTAAGCTTGAAAAGGGGGCT,0,477307
araBp,0.3333333333333333,2,2,GTAAATCGCACTTCGAGGTA,0,477206
araBp,0.3333333333333333,2,2,GTAAACCCGTTTTACGATCC,0,493348
araBp,0.3333333333333333,2,2,GGTTTGCAGGTGGATCCCGC,0,518975
araBp,0.3333333333333333,2,2,GGTTTCGAGGTAGGGATCGT,0,520467
araBp,0.3333333333333333,2,2,GGTTGTGCAAATGGTGTTCA,0,507178
araBp,0.3333333333333333,2,2,GGTTGTACGTCGCAAAATTA,0,478423
araBp,0.3333333333333333,2,2,GGTTGGTTCCGCACTCCGGC,0,521366
araBp,0.3333333333333333,2,2,GGTTGGCCGGTTATTGTCCC,0,509105
araBp,0.3333333333333333,2,2,GGTTGAAGATCAGGTATTTC,0,497998
araBp,0.3333333333333333,2,2,GGTTCATGTGTTTCACCGGT,0,474429
araBp,0.3333333333333333,2,2,GGTTCACGCCCCGACAAAAT,0,515996
araBp,0.3333333333333333,2,2,GGTTATATGAGATTAACCAT,0,503942
araBp,0.3333333333333333,2,2,GGTTAGCTCCTTGGGTATGA,0,468174
araBp,0.3333333333333333,2,2,GGTGGTTTTTCTGGTGACTG,0,476069
araBp,0.3333333333333333,2,2,GGTGCTACTTCTCAGGCGAA,0,514084
araBp,0.3333333333333333,2,2,GGTGCCCACGGCGACTGGTA,0,495606
araBp,0.3333333333333333,2,2,GGTGCCACAGTAATGCCGCG,0,469755
araBp,0.3333333333333333,2,2,GGTCTCAGACTAAACCGGCC,0,491437
araBp,0.3333333333333333,2,2,GGTCTAACTATAGGATGCCT,0,510441
araBp,0.3333333333333333,2,2,GGTCGTGGTTTTTAGAATAG,0,485449
araBp,0.3333333333333333,2,2,GGTCGCGGGTTCGATTCCTT,0,519904
araBp,0.3333333333333333,2,2,GGTCGATTCAAATGGGAACC,0,518263
araBp,0.3333333333333333,2,2,GGTCCCGTGACTGACCCTAT,0,492830
araBp,0.3333333333333333,2,2,GGTCCCCAATTGTTTTGGCA,0,505899
araBp,0.3333333333333333,2,2,GGTCATACGATCATCGCGGC,0,501257
araBp,0.3333333333333333,2,2,GGTCAGCTAGCAACATTGTC,0,521350
araBp,0.3333333333333333,2,2,GGTCACAGAGGGTCCATTCA,0,507961
araBp,0.3333333333333333,2,2,GGTATCTTGGCGCCGTCTAA,0,472071
araBp,0.3333333333333333,2,2,GGTATCCACGAATTAATCAC,0,517323
araBp,0.3333333333333333,2,2,GGTAGGTAACCGTGTTACGT,0,476888
araBp,0.3333333333333333,2,2,GGTAGGGAGCAACAAAGCAC,0,476770
araBp,0.3333333333333333,2,2,GGTAGGCTGTTTCGCCAGTC,0,513428
araBp,0.3333333333333333,2,2,GGTAGGATTATAGTCGGCCC,0,515463
araBp,0.3333333333333333,2,2,GGTAGGACGAGACGCACGCT,0,503421
araBp,0.3333333333333333,2,2,GGTAGCTGACTTCGCGCGAC,0,508511
araBp,0.3333333333333333,2,2,GGTACTCATACTCCTTTTGT,0,486640
araBp,0.3333333333333333,2,2,GGTACCAGTCGCCCTTTCAG,0,504130
araBp,0.3333333333333333,2,2,GGTAATTTGGCGTCATTAGG,0,515886
araBp,0.3333333333333333,2,2,GGGTTTGACTACGGTTCGGT,0,490231
araBp,0.3333333333333333,2,2,GGGTTGCATAGTGGTAAGGG,0,502315
araBp,0.3333333333333333,2,2,GGGTTAAAATAATGCATGGA,0,516325
araBp,0.3333333333333333,2,2,GGGTGATTTCCCAGGATCCC,0,511553
araBp,0.3333333333333333,2,2,GGGTGAGTAGGTCTTGGGAT,0,477766
araBp,0.3333333333333333,2,2,GGGTCTCAGGCCGCAAAGTC,0,477291
araBp,0.3333333333333333,2,2,GGGTCTCAAAGCTGGGTCGT,0,523375
araBp,0.3333333333333333,2,2,GGGTAGATCGCATGCGACCT,0,524512
araBp,0.3333333333333333,2,2,GGGTACTCGTCGCCATATTA,0,486903
araBp,0.3333333333333333,2,2,GGGGTTCAATGTGTCCATAA,0,512918
araBp,0.3333333333333333,2,2,GGGGTAAATTACCTGTGGCA,0,491696
araBp,0.3333333333333333,2,2,GGGGTAAAGCTCTTTCCCAA,0,485042
araBp,0.3333333333333333,2,2,GGGGGTTTTCGGAAGACTTA,0,499288
araBp,0.3333333333333333,2,2,GGGGCGCGGGATTTATGCTC,0,498485
araBp,0.3333333333333333,2,2,GGGGATCGTATGTGACTTCG,0,468646
araBp,0.3333333333333333,2,2,GGGGATCATCTCGCTGCTCC,0,492002
araBp,0.3333333333333333,2,2,GGGGATCAGATCCTCCAGAG,0,493659
araBp,0.3333333333333333,2,2,GGGGAGTCGAGCCCCCACAA,0,493677
araBp,0.3333333333333333,2,2,GGGGAGCCTGCGTAAGATTA,0,513308
araBp,0.3333333333333333,2,2,GGGCTTCGGACACACGGTTC,0,504105
araBp,0.3333333333333333,2,2,GGGCTCAATTCAACTTGCAT,0,505552
araBp,0.3333333333333333,2,2,GGGCTACATTAGATTTACGC,0,501881
araBp,0.3333333333333333,2,2,GGGCGTGCGAATTTCTGTAT,0,523573
araBp,0.3333333333333333,2,2,GGGCGTCTAAATAGTTGATG,0,499348
araBp,0.3333333333333333,2,2,GGGCGATCTATTCTTAAAAA,0,523275
araBp,0.3333333333333333,2,2,GGGCCTTGTCAACTCACATG,0,522535
araBp,0.3333333333333333,2,2,GGGCATTGAATATTTTAGGT,0,500085
araBp,0.3333333333333333,2,2,GGGCATAAGTTCCGCATACG,0,508194
araBp,0.3333333333333333,2,2,GGGATCCCATGGAGGGCAGG,0,491445
araBp,0.3333333333333333,2,2,GGGATAGAGAAGCTTTAACC,0,499367
araBp,0.3333333333333333,2,2,GGGATAAAGCCTCGGTCTTC,0,478696
araBp,0.3333333333333333,2,2,GGCTCGAGGCGCCATTGGCT,0,481035
araBp,0.3333333333333333,2,2,GGCTATGGATGGTACCCGCG,0,511192
araBp,0.3333333333333333,2,2,GGCTAAACATGGACTGTTTT,0,509204
araBp,0.3333333333333333,2,2,GGCGGGACTGATACTGAGCT,0,483327
araBp,0.3333333333333333,2,2,GGCGGAGCGAGCGCCTGGCG,0,469989
araBp,0.3333333333333333,2,2,GGCGGACAGGTTTAAAGTCT,0,504957
araBp,0.3333333333333333,2,2,GGCGCTGTTTTATGACTTTG,0,487387
araBp,0.3333333333333333,2,2,GGCGAAGTGTACCTCGTCGC,0,510505
araBp,0.3333333333333333,2,2,GGCCTTAACTCTGAAACCCG,0,495634
araBp,0.3333333333333333,2,2,GGCCTGAGAGACTCTATAAG,0,516611
araBp,0.3333333333333333,2,2,GGCCTCCCGCATCCGGTACT,0,484501
araBp,0.3333333333333333,2,2,GGCCTAAGTCTTCTACGTCG,0,506142
araBp,0.3333333333333333,2,2,GGCCGAAGGGGTCAATTGTG,0,509833
araBp,0.3333333333333333,2,2,GGCCCCCTCCTTATTGGTCT,0,482853
araBp,0.3333333333333333,2,2,GGCCAGCGGGAATGAACTTC,0,503031
araBp,0.3333333333333333,2,2,GGCCACGCCGGTCCCGGTCC,0,476146
araBp,0.3333333333333333,2,2,GGCCAAAAAGCGAGCCCAAA,0,473574
araBp,0.3333333333333333,2,2,GGCATGTATTACATCACGGT,0,515101
araBp,0.3333333333333333,2,2,GGCATCGCTGTCATTTATGT,0,520451
araBp,0.3333333333333333,2,2,GGCAGATAAGGACGGCAAAT,0,525083
araBp,0.3333333333333333,2,2,GGCAATCTCGATGGATGGCA,0,502263
araBp,0.3333333333333333,2,2,GGATTTGTTGATGGGTCTGT,0,493103
araBp,0.3333333333333333,2,2,GGATTATAGTCTCGTGTCGT,0,506415
araBp,0.3333333333333333,2,2,GGATCCGGGCTGGCACAGCA,0,521972
araBp,0.3333333333333333,2,2,GGATATCTCTGGACGGTTGC,0,494528
araBp,0.3333333333333333,2,2,GGAGTTTTGATGAACTAGGA,0,522242
araBp,0.3333333333333333,2,2,GGAGTCCAGTTAGTTACGCG,0,525089
araBp,0.3333333333333333,2,2,GGAGGTTTGTAGGTACTTAT,0,502943
araBp,0.3333333333333333,2,2,GGAGGATGTTGACTAATTGC,0,478971
araBp,0.3333333333333333,2,2,GGAGGAATCCAGTAACTGGC,0,505734
araBp,0.3333333333333333,2,2,GGAGCTGTCGGGCCAGTCTC,0,477669
araBp,0.3333333333333333,2,2,GGAGCGACTGTTCTCTTCCT,0,486951
araBp,0.3333333333333333,2,2,GGAGCCTTGTAGGACTGCGC,0,507682
araBp,0.3333333333333333,2,2,GGAGCCAATTGTCAAAGCTT,0,524817
araBp,0.3333333333333333,2,2,GGAGCATCGGCGGTTCCCGA,0,515314
araBp,0.3333333333333333,2,2,GGACTTCGCGGAAGTACCAC,0,493212
araBp,0.3333333333333333,2,2,GGACTGCATGACTAACCTTT,0,484143
araBp,0.3333333333333333,2,2,GGACTAATCCATAACTTATG,0,487058
araBp,0.3333333333333333,2,2,GGACGTCCTACAGTCCACGC,0,476299
araBp,0.3333333333333333,2,2,GGACGGGAGTTGAAGAAGTG,0,509386
araBp,0.3333333333333333,2,2,GGACCCTCGTACGACTTGAT,0,496446
araBp,0.3333333333333333,2,2,GGACATAGAGTTTTGGCGCT,0,521718
araBp,0.3333333333333333,2,2,GGACAAAGTACCCAGTGAGA,0,525455
araBp,0.3333333333333333,2,2,GGAATGTGTCGCAGATTGTA,0,472505
araBp,0.3333333333333333,2,2,GGAATGATCATGGCCACGGC,0,494407
araBp,0.3333333333333333,2,2,GGAATCTTTTGCCTGCTAGG,0,481750
araBp,0.3333333333333333,2,2,GGAAGTTGGCTTGGCGTAAG,0,518402
araBp,0.3333333333333333,2,2,GGAAGTCCATGTCATGCAGA,0,472452
araBp,0.3333333333333333,2,2,GGAAGGTGAATTGACGAAGC,0,489871
araBp,0.3333333333333333,2,2,GGAAACGCGTCTTTGCGTGT,0,468354
araBp,0.3333333333333333,2,2,GCTTTAACACCGCTATTTAT,0,520918
araBp,0.3333333333333333,2,2,GCTTGTTATACTCTTTTAGC,0,482952
araBp,0.3333333333333333,2,2,GCTTGGGTTCACGCAGTGAG,0,510488
araBp,0.3333333333333333,2,2,GCTTCTAGTCGGCGACTCGA,0,520401
araBp,0.3333333333333333,2,2,GCTTATGGGCAGCCTTTTTG,0,497083
araBp,0.3333333333333333,2,2,GCTGTTGGGGATAATCGCCT,0,506391
araBp,0.3333333333333333,2,2,GCTGGTTTGGTTGGGCATCT,0,471205
araBp,0.3333333333333333,2,2,GCTGGGTTACACAGGCAAAG,0,477249
araBp,0.3333333333333333,2,2,GCTCTTCCCCTTTTAGGACC,0,483446
araBp,0.3333333333333333,2,2,GCTCGGTGGGGGTCCTTGCC,0,472331
araBp,0.3333333333333333,2,2,GCTCGGCTCGCGCTACCTGC,0,476175
araBp,0.3333333333333333,2,2,GCTATTCAGAGGCGGCACAT,0,521138
araBp,0.3333333333333333,2,2,GCTATCGATACCCTAGCACT,0,517614
araBp,0.3333333333333333,2,2,GCTACGGTCGGTGAGTGCAT,0,493491
araBp,0.3333333333333333,2,2,GCTACCTATGTGGAAAGCAT,0,491330
araBp,0.3333333333333333,2,2,GCTACCTATGTATCTCTTGT,0,478466
araBp,0.3333333333333333,2,2,GCTACCCGAATTTTGACTTG,0,501428
araBp,0.3333333333333333,2,2,GCTACATCACAGTGCATACC,0,496696
araBp,0.3333333333333333,2,2,GCTACACGGCTAACTTGCAT,0,492113
araBp,0.3333333333333333,2,2,GCGTGTGGAAGACTTACTGG,0,511167
araBp,0.3333333333333333,2,2,GCGTGGCTCCGCTGCCCATG,0,483684
araBp,0.3333333333333333,2,2,GCGTGAAGCCACGATGGCAA,0,517358
araBp,0.3333333333333333,2,2,GCGTCGCTCGCCATTCAAAT,0,482637
araBp,0.3333333333333333,2,2,GCGTCCGAATGTGGAAGAAC,0,523899
araBp,0.3333333333333333,2,2,GCGTAGGAACCAGCTTCAAC,0,504817
araBp,0.3333333333333333,2,2,GCGGGATGTCACCACGTACT,0,494814
araBp,0.3333333333333333,2,2,GCGGCTCTAGGGGCTAAAGC,0,512010
araBp,0.3333333333333333,2,2,GCGGAGACAGATGAGCCTCG,0,479891
araBp,0.3333333333333333,2,2,GCGCTAACGTTACGTATATC,0,467787
araBp,0.3333333333333333,2,2,GCGCGCAGCATTATCGGGAC,0,484597
araBp,0.3333333333333333,2,2,GCGCGAGCGGGATCTTACTT,0,491537
araBp,0.3333333333333333,2,2,GCGCATGGGCACAACGACCA,0,468411
araBp,0.3333333333333333,2,2,GCGCACAGGCATCAGGCATA,0,488655
araBp,0.3333333333333333,2,2,GCGATTGGCTTACTCCGGAT,0,497226
araBp,0.3333333333333333,2,2,GCGATTAACTGCCCGTGGCG,0,493629
araBp,0.3333333333333333,2,2,GCGATCCTACTGTATGATGC,0,491438
araBp,0.3333333333333333,2,2,GCGATATCAGAAGAGGAGTT,0,479822
araBp,0.3333333333333333,2,2,GCGAGTCTGACAGAGTGCCA,0,518477
araBp,0.3333333333333333,2,2,GCGACTTTTACTTTTGTGAG,0,468343
araBp,0.3333333333333333,2,2,GCGACAGGCACATCTCGTGT,0,501997
araBp,0.3333333333333333,2,2,GCGAATTGACACGCGGCCGA,0,513845
araBp,0.3333333333333333,2,2,GCGAACAGATAATAGTCCAA,0,493848
araBp,0.3333333333333333,2,2,GCCTTTAGTAAGAATACCCA,0,512260
araBp,0.3333333333333333,2,2,GCCTTCTTGGGAGTGAAGGC,0,514587
araBp,0.3333333333333333,2,2,GCCTGGGTCTCGTACTTCTT,0,508327
araBp,0.3333333333333333,2,2,GCCTCCAACTATGGGAGCCT,0,499649
araBp,0.3333333333333333,2,2,GCCTAGCACCACCTGTATTC,0,485643
araBp,0.3333333333333333,2,2,GCCGGCTACAGGGCAGTTGT,0,501173
araBp,0.3333333333333333,2,2,GCCGGCGTCATCCGTCCGGC,0,508028
araBp,0.3333333333333333,2,2,GCCGGCCCCCACCGTTGTTG,0,502196
araBp,0.3333333333333333,2,2,GCCGGAGATCTGGTATAACT,0,513328
araBp,0.3333333333333333,2,2,GCCGCTAGGCGTGGCTTTGA,0,490360
araBp,0.3333333333333333,2,2,GCCGCGAGGCGGCTAGGGAC,0,481979
araBp,0.3333333333333333,2,2,GCCGCATTGGTTGTATGCCA,0,521041
araBp,0.3333333333333333,2,2,GCCGCACCATCTTCCGGGAG,0,479242
araBp,0.3333333333333333,2,2,GCCGAAGTGCGGTAGATCGC,0,479707
araBp,0.3333333333333333,2,2,GCCCTTTCCTATCTGCTTCG,0,468762
araBp,0.3333333333333333,2,2,GCCCTGGGCATAGATTGACT,0,500253
araBp,0.3333333333333333,2,2,GCCCTGGACTTCAGGAGGAT,0,521229
araBp,0.3333333333333333,2,2,GCCCGCTTTCTGACTTAGCT,0,475418
araBp,0.3333333333333333,2,2,GCCCCCTCTGTACTGCTCAT,0,473807
araBp,0.3333333333333333,2,2,GCCCATAGCGTCGCGACGCT,0,476328
araBp,0.3333333333333333,2,2,GCCCAGTGGGGAAAATGCGC,0,501713
araBp,0.3333333333333333,2,2,GCCCAATAGAAGACCAACTG,0,523445
araBp,0.3333333333333333,2,2,GCCATCAACGAGCACAGGCT,0,494640
araBp,0.3333333333333333,2,2,GCCATACAGCGCGACGTTGA,0,491413
araBp,0.3333333333333333,2,2,GCCAGATTCATTTGCACTTC,0,505802
araBp,0.3333333333333333,2,2,GCCACTTTGGGGTAATGTAG,0,478554
araBp,0.3333333333333333,2,2,GCCACGTCTATCATCAACAT,0,479537
araBp,0.3333333333333333,2,2,GCCACAAATTCTATGACTTT,0,495668
araBp,0.3333333333333333,2,2,GCCAATTGACAATCCTAACA,0,500441
araBp,0.3333333333333333,2,2,GCCAATAGTTTACCTGGTCG,0,520997
araBp,0.3333333333333333,2,2,GCCAACCAGCATTCGCGATT,0,520971
araBp,0.3333333333333333,2,2,GCATTCAAGCAGCTCCCGTT,0,498951
araBp,0.3333333333333333,2,2,GCATTATCCGTACATAGGCG,0,515987
araBp,0.3333333333333333,2,2,GCATTAACTATCCAAAGTAC,0,483392
araBp,0.3333333333333333,2,2,GCATCAACGGGCATTGACTA,0,469479
araBp,0.3333333333333333,2,2,GCATAGCCTGCCATTATATG,0,501415
araBp,0.3333333333333333,2,2,GCAGTTAGGTATGTCAAATG,0,509654
araBp,0.3333333333333333,2,2,GCAGTGGGAATCATGCGGAC,0,503597
araBp,0.3333333333333333,2,2,GCAGGTGGCGGACCGAGCGT,0,472223
araBp,0.3333333333333333,2,2,GCAGGGCTTTTGACATACTC,0,482643
araBp,0.3333333333333333,2,2,GCAGGCACGGGCTTTCTAAT,0,500435
araBp,0.3333333333333333,2,2,GCAGCTGTTATGGCATACCC,0,482348
araBp,0.3333333333333333,2,2,GCAGCAGGGCAAAAAGATCA,0,476477
araBp,0.3333333333333333,2,2,GCAGAGTGCAATTGGGAGAT,0,517919
araBp,0.3333333333333333,2,2,GCAGAGGGAGGAGAAGGGCT,0,504120
araBp,0.3333333333333333,2,2,GCAGACCACGGGTACTGAGG,0,493602
araBp,0.3333333333333333,2,2,GCAGAAAGTTTGTGTATCTC,0,499356
araBp,0.3333333333333333,2,2,GCACTGTTTCACGAGAGAAA,0,499939
araBp,0.3333333333333333,2,2,GCACTATCTGGTAATAGACA,0,493439
araBp,0.3333333333333333,2,2,GCACGTTGGCGACGCCGCTA,0,519676
araBp,0.3333333333333333,2,2,GCACGCACCGTTAGTACAAA,0,518576
araBp,0.3333333333333333,2,2,GCACCGGAGGTGTAGAACTT,0,475428
araBp,0.3333333333333333,2,2,GCACCCGAACCGACAGCGCA,0,511400
araBp,0.3333333333333333,2,2,GCACATCTATTAAGGTTTTC,0,468111
araBp,0.3333333333333333,2,2,GCACACCATTCACTACAAGT,0,518885
araBp,0.3333333333333333,2,2,GCAATAGCTCCGTGCCCTGC,0,475713
araBp,0.3333333333333333,2,2,GCAAGTGTGACATGCGTCAG,0,470700
araBp,0.3333333333333333,2,2,GCAACTTCACCTGGTTAGAT,0,520921
araBp,0.3333333333333333,2,2,GATTTCTTGATCGAGCCGTA,0,481621
araBp,0.3333333333333333,2,2,GATTTCGTCGGATCTTGCGT,0,484643
araBp,0.3333333333333333,2,2,GATTTCGCACGATTGCGAGA,0,494424
araBp,0.3333333333333333,2,2,GATTGTGATTTCGGACACGA,0,504141
araBp,0.3333333333333333,2,2,GATTGGCCCGTGAAACGCTA,0,510038
araBp,0.3333333333333333,2,2,GATTGGCAACTTGTTCTTTC,0,490184
araBp,0.3333333333333333,2,2,GATTGATCATTTTACAGCTA,0,482157
araBp,0.3333333333333333,2,2,GATTGAACGCTAGGCCTGCG,0,476593
araBp,0.3333333333333333,2,2,GATTCGTTCACGGTGAATGA,0,509999
araBp,0.3333333333333333,2,2,GATTCCGAGATAGTGCCATC,0,500737
araBp,0.3333333333333333,2,2,GATTATCCACCTAGTGAAGG,0,518239
araBp,0.3333333333333333,2,2,GATGTTGCGTGCTCAAAGCA,0,504913
araBp,0.3333333333333333,2,2,GATGTACCGCATAATTGACT,0,468715
araBp,0.3333333333333333,2,2,GATGGGTTGACAGGGAGAAA,0,485194
araBp,0.3333333333333333,2,2,GATGGGAGTTAAACCTCGAA,0,470507
araBp,0.3333333333333333,2,2,GATGGCATGCTTCTTAGCTA,0,513870
araBp,0.3333333333333333,2,2,GATGCATCGCCTCCTGGCTC,0,488511
araBp,0.3333333333333333,2,2,GATGATAATGAAGGTTGATG,0,485550
araBp,0.3333333333333333,2,2,GATGAGGCTCTTTGAGGTGT,0,496623
araBp,0.3333333333333333,2,2,GATCTTACGTGGAGTATGTG,0,471418
araBp,0.3333333333333333,2,2,GATCTCGGGGAGCGAGCGAA,0,503138
araBp,0.3333333333333333,2,2,GATCCGGTGTGCAGTGGAGT,0,504186
araBp,0.3333333333333333,2,2,GATCCGCCCTACGGCTCGTT,0,500460
araBp,0.3333333333333333,2,2,GATCCATCTCACTATGTACG,0,472603
araBp,0.3333333333333333,2,2,GATCAGTATCTACGCGGACC,0,488893
araBp,0.3333333333333333,2,2,GATCAGGGACGACGTCATTA,0,516792
araBp,0.3333333333333333,2,2,GATACATGGGACCGTATTCC,0,495764
araBp,0.3333333333333333,2,2,GATAATGCATGGGCATATGG,0,468800
araBp,0.3333333333333333,2,2,GATAATATCAATACATTATC,0,472477
araBp,0.3333333333333333,2,2,GATAAGTTCCTATTTTGAGA,0,491401
araBp,0.3333333333333333,2,2,GATAAGGTCAGTCCAGACTG,0,475337
araBp,0.3333333333333333,2,2,GATAAGCAGGCTTACGAGTG,0,504198
araBp,0.3333333333333333,2,2,GATAAACATTTGGAATGTGT,0,502460
araBp,0.3333333333333333,2,2,GAGTTTCGGGTATCCAGCCA,0,495861
araBp,0.3333333333333333,2,2,GAGTTCAGACTCGATAGTTC,0,488063
araBp,0.3333333333333333,2,2,GAGTGGGGGGCTCCCACAGA,0,473384
araBp,0.3333333333333333,2,2,GAGTGGCGCATTCTCCGACA,0,503780
araBp,0.3333333333333333,2,2,GAGTCGGGGTCGCGTAATTC,0,486902
araBp,0.3333333333333333,2,2,GAGTCGGCGTAGCCCTGAAA,0,490407
araBp,0.3333333333333333,2,2,GAGTATACTGTGATCAGCTA,0,502812
araBp,0.3333333333333333,2,2,GAGTAACTAGGCTATGGCGA,0,491963
araBp,0.3333333333333333,2,2,GAGTAAACCGCTGTCTTTAG,0,518434
araBp,0.3333333333333333,2,2,GAGGTATTCGCACCAACCGT,0,474579
araBp,0.3333333333333333,2,2,GAGGTATCTGGGGTACACAG,0,525038
araBp,0.3333333333333333,2,2,GAGGTAGTATGGTTTAACCC,0,519717
araBp,0.3333333333333333,2,2,GAGGCTTGTTGCATTTGGTC,0,482742
araBp,0.3333333333333333,2,2,GAGGCTAGTTTCAAAATTTG,0,488566
araBp,0.3333333333333333,2,2,GAGGCCAACTTCCAAGGCAT,0,496030
araBp,0.3333333333333333,2,2,GAGGAAAAACAATCAAAGTA,0,494562
araBp,0.3333333333333333,2,2,GAGCTACTGTCTCTGTCGAA,0,501971
araBp,0.3333333333333333,2,2,GAGCGTGGTGGGGTGGCGTA,0,494138
araBp,0.3333333333333333,2,2,GAGCACTATGGGATGATATG,0,496324
araBp,0.3333333333333333,2,2,GAGATACGTGCCACTTGAGC,0,516622
araBp,0.3333333333333333,2,2,GAGAGTTCTACTTCTCGGGT,0,506606
araBp,0.3333333333333333,2,2,GAGAGTTATCTAGGAGAAGC,0,481831
araBp,0.3333333333333333,2,2,GAGAGATGGGCATAGGAGAT,0,488044
araBp,0.3333333333333333,2,2,GAGACGTGGTTGGCCCCACA,0,502178
araBp,0.3333333333333333,2,2,GAGAAAGCGGGGTGAGCGTG,0,501382
araBp,0.3333333333333333,2,2,GACTTATTGCCCTCAGCTAT,0,513530
araBp,0.3333333333333333,2,2,GACTCGGCGCCACACCATAC,0,487473
araBp,0.3333333333333333,2,2,GACTCAGCGGATCGTCTCAC,0,488693
araBp,0.3333333333333333,2,2,GACTCAGATGCTGCGCGGCT,0,488764
araBp,0.3333333333333333,2,2,GACGTCGAACGCGCGGGTTC,0,471060
araBp,0.3333333333333333,2,2,GACGGTGCAGAGTCGCAATT,0,521601
araBp,0.3333333333333333,2,2,GACGGGGTAAGGTCTCTCCA,0,481134
araBp,0.3333333333333333,2,2,GACGCTCCACGAGCCGTCGC,0,498736
araBp,0.3333333333333333,2,2,GACGCGTCTACTAGGTGATC,0,515797
araBp,0.3333333333333333,2,2,GACGCAATCTCCACTTCACA,0,505678
araBp,0.3333333333333333,2,2,GACGACTGGAGTGAACCGGC,0,476784
araBp,0.3333333333333333,2,2,GACCTGCTTCCACGATCGAT,0,469572
araBp,0.3333333333333333,2,2,GACCTCGTGCGGAGCGAGTG,0,483763
araBp,0.3333333333333333,2,2,GACCGTCGTACCTCGCAGTA,0,510871
araBp,0.3333333333333333,2,2,GACCGTCGGCCTTATCGGGT,0,482901
araBp,0.3333333333333333,2,2,GACCGGTTGCAAGGGTCCTT,0,522910
araBp,0.3333333333333333,2,2,GACCGGAAATTTACAGGTCT,0,512450
araBp,0.3333333333333333,2,2,GACCATAGTCAGTATGTCCA,0,501857
araBp,0.3333333333333333,2,2,GACCAGCGCACGGGCGACTC,0,492792
araBp,0.3333333333333333,2,2,GACCACTGTTTGGTAATCTT,0,515506
araBp,0.3333333333333333,2,2,GACCAAGTTGACGTGGAGGT,0,498109
araBp,0.3333333333333333,2,2,GACATCAGCGCAGATTACTT,0,468926
araBp,0.3333333333333333,2,2,GACAGGCAACCTAGCGGTTA,0,498342
araBp,0.3333333333333333,2,2,GACAGAGGTAGGGAGCGGGT,0,496614
araBp,0.3333333333333333,2,2,GACAGAGGCCTAGCCGGGGC,0,485226
araBp,0.3333333333333333,2,2,GACAGAGATTACCTTCTCTA,0,475199
araBp,0.3333333333333333,2,2,GACAACCTTCGTATTGCCTT,0,481378
araBp,0.3333333333333333,2,2,GACAACACGCCAAACTCCGG,0,522480
araBp,0.3333333333333333,2,2,GAATTATAACCGAGGTAGAC,0,476460
araBp,0.3333333333333333,2,2,GAATGGCGCCAAAGCGCTAT,0,498663
araBp,0.3333333333333333,2,2,GAATGCCATGGGCATGAGGG,0,523213
araBp,0.3333333333333333,2,2,GAATAGGGATATATCCTCGG,0,496142
araBp,0.3333333333333333,2,2,GAATAGCACCGTTCGTTGAA,0,492465
araBp,0.3333333333333333,2,2,GAATAGATTTCACGGATAGG,0,491394
araBp,0.3333333333333333,2,2,GAATACGCTTCGTCATGTAT,0,492826
araBp,0.3333333333333333,2,2,GAAGTGCGGTTAAATGAGCC,0,477009
araBp,0.3333333333333333,2,2,GAAGTACGCGAGGTATGCTA,0,487606
araBp,0.3333333333333333,2,2,GAAGTACCCCTCAATACGCG,0,476918
araBp,0.3333333333333333,2,2,GAAGGTCGGACCCACAATCC,0,473375
araBp,0.3333333333333333,2,2,GAAGCGCGCCTCCGCAAGAC,0,491584
araBp,0.3333333333333333,2,2,GAAGCCTCGTGTCACAGTCA,0,473169
araBp,0.3333333333333333,2,2,GAAGATTGTACTTCAACTCT,0,478029
araBp,0.3333333333333333,2,2,GAAGAGGGCAAGCACCTGGC,0,488958
araBp,0.3333333333333333,2,2,GAAGACTACCACCCTGGAAC,0,505560
araBp,0.3333333333333333,2,2,GAACTCCTTTAACAACCTTT,0,523894
araBp,0.3333333333333333,2,2,GAACTAGAAGCATCTATGGA,0,495589
araBp,0.3333333333333333,2,2,GAACGGGGGGTCAGCAGCCA,0,505999
araBp,0.3333333333333333,2,2,GAACGGAGAAATGGTTAATC,0,491042
araBp,0.3333333333333333,2,2,GAACCCCGACTTTAGGAGCC,0,483158
araBp,0.3333333333333333,2,2,GAACCAATCAGCCTGTATAC,0,498024
araBp,0.3333333333333333,2,2,GAACATTTGACTACTGGGGG,0,468624
araBp,0.3333333333333333,2,2,GAACATACAAAGGACAATGC,0,506430
araBp,0.3333333333333333,2,2,GAACAACGCATGGCTCGGGT,0,502112
araBp,0.3333333333333333,2,2,GAAATTCTATCGCACTCGGG,0,473637
araBp,0.3333333333333333,2,2,GAAAGTTCTATGGACGTGTG,0,496062
araBp,0.3333333333333333,2,2,GAAAGTCGGCGTACAGTTAG,0,468606
araBp,0.3333333333333333,2,2,GAAAGTAAAAAACCACTTCA,0,477767
araBp,0.3333333333333333,2,2,GAAAGCCAATGCTCTGGCCA,0,518146
araBp,0.3333333333333333,2,2,GAAACGGCGTCGTGTACCTA,0,490807
araBp,0.3333333333333333,2,2,GAAAAGTTCCCGGCCTATAT,0,519355
araBp,0.3333333333333333,2,2,CTTTTTCGTTTGGCGATTAA,0,469908
araBp,0.3333333333333333,2,2,CTTTTTATCTGTAGGCACCT,0,523087
araBp,0.3333333333333333,2,2,CTTTTGGGTCCAAGCGATAT,0,495078
araBp,0.3333333333333333,2,2,CTTTTCGGAGAGGGCTGTCA,0,475902
araBp,0.3333333333333333,2,2,CTTTTCGATCCAATTTAATC,0,491962
araBp,0.3333333333333333,2,2,CTTTGTCAAGCTCCATGTAG,0,516966
araBp,0.3333333333333333,2,2,CTTTGGTTTACCGCCTTCTG,0,470973
araBp,0.3333333333333333,2,2,CTTTGGTAAGTCTTACCGAT,0,509563
araBp,0.3333333333333333,2,2,CTTTGCGGAACTTCGACCAA,0,485512
araBp,0.3333333333333333,2,2,CTTTGATGCCGGAGCCATCG,0,494067
araBp,0.3333333333333333,2,2,CTTTGAACCGGAATAAGCCC,0,513804
araBp,0.3333333333333333,2,2,CTTTCGACATCGGAAACTCA,0,477893
araBp,0.3333333333333333,2,2,CTTTCAGTCTCTTCGCGTAT,0,486018
araBp,0.3333333333333333,2,2,CTTTATTGAGACGCGCGTAT,0,501483
araBp,0.3333333333333333,2,2,CTTTATTCGTCCTTATAGTT,0,470494
araBp,0.3333333333333333,2,2,CTTTACCGGACTGGTTGGCT,0,477783
araBp,0.3333333333333333,2,2,CTTGTTTGTCCCGTATATAG,0,476181
araBp,0.3333333333333333,2,2,CTTGGTCACCAAGCCGCATT,0,519936
araBp,0.3333333333333333,2,2,CTTGGGGAAGGCTATATCCC,0,501222
araBp,0.3333333333333333,2,2,CTTGCGGAGTCATGCGGCGG,0,520941
araBp,0.3333333333333333,2,2,CTTCGAGCGCATATCCTGTC,0,509487
araBp,0.3333333333333333,2,2,CTTCATTGAGCTTAGCCGTA,0,523809
araBp,0.3333333333333333,2,2,CTTCAAGAAGGAGATATAAC,0,506630
araBp,0.3333333333333333,2,2,CTTATTCAGCTATTTACCAG,0,518988
araBp,0.3333333333333333,2,2,CTTATTAGCCCAGGTGAAAA,0,487974
araBp,0.3333333333333333,2,2,CTTATCACGTATTCGGCGAG,0,505683
araBp,0.3333333333333333,2,2,CTTAGGATTCGTCAATTCGA,0,517819
araBp,0.3333333333333333,2,2,CTTAGCTAACTGGGGACATC,0,473333
araBp,0.3333333333333333,2,2,CTTAGAGAAATCCCTGCACA,0,475382
araBp,0.3333333333333333,2,2,CTTACGGGTATGCACTAGAG,0,517466
araBp,0.3333333333333333,2,2,CTTAATTGTGAGGATGTTAT,0,467874
araBp,0.3333333333333333,2,2,CTGTTTTTAACCCGAACGCA,0,504094
araBp,0.3333333333333333,2,2,CTGTTTTCGACTTGACTCAC,0,467994
araBp,0.3333333333333333,2,2,CTGTTTGGTGGGTTTCGTAC,0,472271
araBp,0.3333333333333333,2,2,CTGTTTCAGGCTGCGGGACC,0,484609
araBp,0.3333333333333333,2,2,CTGTTCATAGAGACCCAGCT,0,499629
araBp,0.3333333333333333,2,2,CTGTTAAACCAATAGTGAGT,0,470867
araBp,0.3333333333333333,2,2,CTGTGGGCCTGCATTACGTG,0,509615
araBp,0.3333333333333333,2,2,CTGTGGCATAGGTACCAATA,0,492201
araBp,0.3333333333333333,2,2,CTGTGATGACGAACACGGCA,0,501180
araBp,0.3333333333333333,2,2,CTGTGAGTTCGTAACTACTT,0,516416
araBp,0.3333333333333333,2,2,CTGTCCTTAAACCGTATTTG,0,489490
araBp,0.3333333333333333,2,2,CTGTCCGAATCATAGCCCCT,0,498078
araBp,0.3333333333333333,2,2,CTGTATCCGCCACGGGACGC,0,492764
araBp,0.3333333333333333,2,2,CTGTAGGAGTTCATAATCCA,0,521951
araBp,0.3333333333333333,2,2,CTGTACCGGTGAGGTTAGAA,0,468029
araBp,0.3333333333333333,2,2,CTGGTTTCCGGGGTGACGAC,0,476908
araBp,0.3333333333333333,2,2,CTGGTTCATTGTATTAAATC,0,507742
araBp,0.3333333333333333,2,2,CTGGTGTTTGAGACCTTCCC,0,500545
araBp,0.3333333333333333,2,2,CTGGGGCGTGGCGACCGGTC,0,468949
araBp,0.3333333333333333,2,2,CTGGGCATTTTCATGTCAAA,0,489672
araBp,0.3333333333333333,2,2,CTGGCGGAATCGACGGCCGT,0,468877
araBp,0.3333333333333333,2,2,CTGGCATACGGAACCGAATT,0,508222
araBp,0.3333333333333333,2,2,CTGGATCTCATGTTTAGGGC,0,497028
araBp,0.3333333333333333,2,2,CTGGAAGTATTGCGGATTCG,0,485305
araBp,0.3333333333333333,2,2,CTGCTGACGGGTCTGGGAAG,0,468107
araBp,0.3333333333333333,2,2,CTGCTCTATTCAGACACTGG,0,476377
araBp,0.3333333333333333,2,2,CTGCTCGGCTCCGGCCGAGC,0,516959
araBp,0.3333333333333333,2,2,CTGCTATGTCCAACGTTAGG,0,469083
araBp,0.3333333333333333,2,2,CTGCTAGTTACGTGCATCAC,0,507979
araBp,0.3333333333333333,2,2,CTGCGACGTGCTCAAGTCGG,0,524417
araBp,0.3333333333333333,2,2,CTGCCCGCATTTGGAAGCGG,0,485793
araBp,0.3333333333333333,2,2,CTGCAAGTAAGACCAACAGT,0,468442
araBp,0.3333333333333333,2,2,CTGATCTGATCCGTTCATGA,0,512868
araBp,0.3333333333333333,2,2,CTGAATCTGGGCTTCTGCTT,0,502785
araBp,0.3333333333333333,2,2,CTCTGTTAATGAGTAATCAG,0,469745
araBp,0.3333333333333333,2,2,CTCTCTGGTGCCGAAACTTT,0,496207
araBp,0.3333333333333333,2,2,CTCTCGGATCACGGGGTAAG,0,503120
araBp,0.3333333333333333,2,2,CTCTCATGATCGCGACAGCA,0,469069
araBp,0.3333333333333333,2,2,CTCGTTCCTGATTCGATCTG,0,497820
araBp,0.3333333333333333,2,2,CTCGTGCCACGTGCGACCGA,0,499787
araBp,0.3333333333333333,2,2,CTCGTCATGCGGGATGTGTA,0,521220
araBp,0.3333333333333333,2,2,CTCGTACGTATTACCTAAGG,0,471793
araBp,0.3333333333333333,2,2,CTCGGTCGTCTGCACGACAG,0,516731
araBp,0.3333333333333333,2,2,CTCGGGAGCAAGATATCGCA,0,492053
araBp,0.3333333333333333,2,2,CTCGGCAAAAAGATTGAATT,0,493178
araBp,0.3333333333333333,2,2,CTCGCTGTAATGAAGACTTC,0,523061
araBp,0.3333333333333333,2,2,CTCGCCGGGGCTGCCAGCGT,0,512205
araBp,0.3333333333333333,2,2,CTCGACAGCGCAATGATTCC,0,504433
araBp,0.3333333333333333,2,2,CTCGAACAGGCGACAGTCAT,0,477412
araBp,0.3333333333333333,2,2,CTCCGTAGTAGAGTGGGCAG,0,507399
araBp,0.3333333333333333,2,2,CTCCGGTAGAAGGAAAACGT,0,519221
araBp,0.3333333333333333,2,2,CTCCGGCTGGGGGACTGGCA,0,518293
araBp,0.3333333333333333,2,2,CTCCGGCGCCCTTGGAGAAC,0,525449
araBp,0.3333333333333333,2,2,CTCCGCCGGGCCTCAAGTTC,0,492623
araBp,0.3333333333333333,2,2,CTCCGAGTGGGAGAACGTAG,0,478541
araBp,0.3333333333333333,2,2,CTCCCTTAGTTAATATGTCA,0,500859
araBp,0.3333333333333333,2,2,CTCCCAATAAACCTTCACTT,0,521891
araBp,0.3333333333333333,2,2,CTCCATAAAGAACCTTTTCT,0,496241
araBp,0.3333333333333333,2,2,CTCATAGAGTGTGCTAAGCT,0,487154
araBp,0.3333333333333333,2,2,CTCAGGCCCACCTCAACTCC,0,477875
araBp,0.3333333333333333,2,2,CTCAGACGGTATCGTCATCA,0,494754
araBp,0.3333333333333333,2,2,CTCACTATTGGGTGGGGTTG,0,498829
araBp,0.3333333333333333,2,2,CTCACGGAGACGGCGTACTA,0,522104
araBp,0.3333333333333333,2,2,CTCACGAAATGTTGTATTAT,0,509178
araBp,0.3333333333333333,2,2,CTCAAGAGCTCGGAAGGTGG,0,498160
araBp,0.3333333333333333,2,2,CTATTGTCATAGCATGACCA,0,491678
araBp,0.3333333333333333,2,2,CTATTAGCCACGACGGGAAC,0,506709
araBp,0.3333333333333333,2,2,CTATCCGGCGAGCGTAAATA,0,512800
araBp,0.3333333333333333,2,2,CTATAGTATGGACTGACATT,0,487016
araBp,0.3333333333333333,2,2,CTATAGGGAGGAGTGCCTGC,0,471590
araBp,0.3333333333333333,2,2,CTAGTTTGGTGTCCGAACTA,0,475033
araBp,0.3333333333333333,2,2,CTAGTCAAAACGATCCAAAA,0,514704
araBp,0.3333333333333333,2,2,CTAGGTCCTCGCGCATTATT,0,501189
araBp,0.3333333333333333,2,2,CTAGGATTTTTTTTGGCCTA,0,521760
araBp,0.3333333333333333,2,2,CTAGGACCGGCCCTCGTGAT,0,508337
araBp,0.3333333333333333,2,2,CTAGCGGGCGGCTCCTCCGT,0,515018
araBp,0.3333333333333333,2,2,CTAGCCTGTCCGCAGCGCTT,0,468229
araBp,0.3333333333333333,2,2,CTAGACGATGTCGGATACGT,0,520862
araBp,0.3333333333333333,2,2,CTACCAGGAACTACATCGTA,0,516154
araBp,0.3333333333333333,2,2,CTACATTGATGAGGTTATGC,0,508831
araBp,0.3333333333333333,2,2,CTACAGTCTGCGATTCAAAT,0,511735
araBp,0.3333333333333333,2,2,CTAAGTGGTTTATTGGAACT,0,510723
araBp,0.3333333333333333,2,2,CTAAGAGCCTCAGGGGTGAA,0,489045
araBp,0.3333333333333333,2,2,CTAACTTCAGACCTTAGCAG,0,520946
araBp,0.3333333333333333,2,2,CTAACGTTGGGTTTTAAAGC,0,509514
araBp,0.3333333333333333,2,2,CTAACGTATCCGATAGCCAA,0,521815
araBp,0.3333333333333333,2,2,CTAAAGTAGACATCGGAAGA,0,518179
araBp,0.3333333333333333,2,2,CTAAACCGGACCATACGTAA,0,474694
araBp,0.3333333333333333,2,2,CGTTTTTTCACCTAATCCGT,0,504910
araBp,0.3333333333333333,2,2,CGTTTGCTTAGTCGTAAGCC,0,475164
araBp,0.3333333333333333,2,2,CGTTGTTCTCACACGTGGGC,0,488160
araBp,0.3333333333333333,2,2,CGTTGGGATACTTCATAACT,0,501292
araBp,0.3333333333333333,2,2,CGTTGCCCGTCTCGTAGTAC,0,501960
araBp,0.3333333333333333,2,2,CGTTCTACAAGCAATCGTGG,0,514468
araBp,0.3333333333333333,2,2,CGTGTCGCATGTTGCTGGTA,0,488996
araBp,0.3333333333333333,2,2,CGTGGGTAGCGAATATGACG,0,470017
araBp,0.3333333333333333,2,2,CGTGGCGCAAATTACTGGGT,0,470489
araBp,0.3333333333333333,2,2,CGTGGCACTTATCGGTGCCC,0,509787
araBp,0.3333333333333333,2,2,CGTGATTGGGCGCCATGCTT,0,484886
araBp,0.3333333333333333,2,2,CGTGATGCGTCCTAGAAATT,0,507394
araBp,0.3333333333333333,2,2,CGTGAGCGATCATGGAAAGC,0,500371
araBp,0.3333333333333333,2,2,CGTCGTTCGTTATGCAAGAC,0,492553
araBp,0.3333333333333333,2,2,CGTCGTCCACTGAATACGAT,0,505239
araBp,0.3333333333333333,2,2,CGTCGGTCGGGTCGCCGGAC,0,476435
araBp,0.3333333333333333,2,2,CGTCCGGCGTGTGAGTTGGC,0,489914
araBp,0.3333333333333333,2,2,CGTCCACGCGGGGCTTATAA,0,517154
araBp,0.3333333333333333,2,2,CGTCAATCCCGGGCATATTA,0,491198
araBp,0.3333333333333333,2,2,CGTATCGTGTGTTCGGTGGA,0,513154
araBp,0.3333333333333333,2,2,CGTATATCTCGGTCCGACGG,0,487694
araBp,0.3333333333333333,2,2,CGTACTTTCATCGGCCTCGA,0,467864
araBp,0.3333333333333333,2,2,CGTACTGAACCCGTGAGGAG,0,506472
araBp,0.3333333333333333,2,2,CGTACGAGCGGTGACCTTAT,0,499825
araBp,0.3333333333333333,2,2,CGTACCGCATTACGGCCACA,0,469243
araBp,0.3333333333333333,2,2,CGTACAAGCAGACTCGAAAC,0,515197
araBp,0.3333333333333333,2,2,CGTAACCGGCAGGTAACGCA,0,477918
araBp,0.3333333333333333,2,2,CGGTTTCCAGGGGTTTGATC,0,505229
araBp,0.3333333333333333,2,2,CGGTTACACTGGAATGCCGC,0,499337
araBp,0.3333333333333333,2,2,CGGTGTTGATTAACTGTGAG,0,497680
araBp,0.3333333333333333,2,2,CGGTGGACCATCAGGCTACT,0,496612
araBp,0.3333333333333333,2,2,CGGTCTGAGTTACAGATGTC,0,485083
araBp,0.3333333333333333,2,2,CGGTACAAGAGCTTGTCCAC,0,496890
araBp,0.3333333333333333,2,2,CGGTAATTCATAGTTTGGAA,0,494566
araBp,0.3333333333333333,2,2,CGGGGTATCAAGGAGGCGGA,0,484120
araBp,0.3333333333333333,2,2,CGGGGTAATACATCAGTTAG,0,509063
araBp,0.3333333333333333,2,2,CGGGCCTCATTAGCTTTTGA,0,473543
araBp,0.3333333333333333,2,2,CGGGATACCAGGGTGTTTCC,0,503654
araBp,0.3333333333333333,2,2,CGGGAGGTAGTGAACGTGTT,0,502093
araBp,0.3333333333333333,2,2,CGGCTTTGGTATATGATTTT,0,516348
araBp,0.3333333333333333,2,2,CGGCTCGTAGGGTATTCCAC,0,508019
araBp,0.3333333333333333,2,2,CGGCTACCCGGCACCATCTT,0,501852
araBp,0.3333333333333333,2,2,CGGCGCAGTCCTACATGTCA,0,479605
araBp,0.3333333333333333,2,2,CGGCGAGTGCTTTAATTTTT,0,518569
araBp,0.3333333333333333,2,2,CGGCCGTAATGAATCCGCTA,0,475547
araBp,0.3333333333333333,2,2,CGGCATTGCGATGAAATGAA,0,513191
araBp,0.3333333333333333,2,2,CGGCAGGCCCTGGCCGCCGC,0,502652
araBp,0.3333333333333333,2,2,CGGATTGTGCTGCTACCGGT,0,497627
araBp,0.3333333333333333,2,2,CGGATAGGTCTGACGAGTGG,0,474225
araBp,0.3333333333333333,2,2,CGGAGTTGCTCGCGATTGTT,0,522335
araBp,0.3333333333333333,2,2,CGGAGTTCGAGACTTCTACC,0,518105
araBp,0.3333333333333333,2,2,CGGAGGATAAGACGGTGCTC,0,478333
araBp,0.3333333333333333,2,2,CGGAGATTTCTTCGCAGATA,0,472080
araBp,0.3333333333333333,2,2,CGGAGAGGGCCAGTGTTTTG,0,521010
araBp,0.3333333333333333,2,2,CGGAGACCGTGAATGAGTTT,0,516145
araBp,0.3333333333333333,2,2,CGGACACATAACCCCCCACT,0,516776
araBp,0.3333333333333333,2,2,CGGAAACCCGCACTTAAAAG,0,484124
araBp,0.3333333333333333,2,2,CGCTTTGACAGCGAACCAGG,0,479253
araBp,0.3333333333333333,2,2,CGCTTGTCCAGCCTCGAGCG,0,500251
araBp,0.3333333333333333,2,2,CGCTGTAATAACTGATAACT,0,484729
araBp,0.3333333333333333,2,2,CGCTGCTTCCTCAGGGCTCG,0,514964
araBp,0.3333333333333333,2,2,CGCTGCCGTATCGAGCGTAA,0,493947
araBp,0.3333333333333333,2,2,CGCTCTCTACGCATGGTAAG,0,491922
araBp,0.3333333333333333,2,2,CGCTCCGAAGGATTTCACTT,0,492481
araBp,0.3333333333333333,2,2,CGCTCATATCCTCGTGCCCA,0,479213
araBp,0.3333333333333333,2,2,CGCTACGTGTCTGCACCTTT,0,506602
araBp,0.3333333333333333,2,2,CGCGTGACCTCGCGAGTCAT,0,476375
araBp,0.3333333333333333,2,2,CGCGTCCTACCATCAGCAGG,0,501851
araBp,0.3333333333333333,2,2,CGCGTAGGGTAGCGGAACCA,0,518812
araBp,0.3333333333333333,2,2,CGCGGTATGCCCTTAACGCT,0,487168
araBp,0.3333333333333333,2,2,CGCGCGTAGGGTAACAGAAG,0,508592
araBp,0.3333333333333333,2,2,CGCGACCATCCTACTGCAAG,0,476569
araBp,0.3333333333333333,2,2,CGCCTTCCTCTTCAACGATG,0,488989
araBp,0.3333333333333333,2,2,CGCCTCCAAATATCGTCCGG,0,514945
araBp,0.3333333333333333,2,2,CGCCTACCGTGTTTCCTAGT,0,483442
araBp,0.3333333333333333,2,2,CGCCCTTGTACTAGAGTCTT,0,509738
araBp,0.3333333333333333,2,2,CGCCCGTCCCTCAGGTGCTC,0,524530
araBp,0.3333333333333333,2,2,CGCCCGGATCTTGGGAGGCC,0,468878
araBp,0.3333333333333333,2,2,CGCCCCTACTTCAGGCCTAG,0,521512
araBp,0.3333333333333333,2,2,CGCATGTTATTTGATTACAA,0,501101
araBp,0.3333333333333333,2,2,CGCATAACGAACCTGAGCAA,0,520558
araBp,0.3333333333333333,2,2,CGCATAACCGTCTATCGTCA,0,512439
araBp,0.3333333333333333,2,2,CGCAGTAGGGCTCTCTTAAT,0,510592
araBp,0.3333333333333333,2,2,CGCACCGGCGGGCATGGTCA,0,469010
araBp,0.3333333333333333,2,2,CGCAATCCTTTTGTCTAGTT,0,471376
araBp,0.3333333333333333,2,2,CGCAAGGAGTTAGCACGACC,0,476123
araBp,0.3333333333333333,2,2,CGCAACAGGTAATTCCGCGC,0,512026
araBp,0.3333333333333333,2,2,CGATTGAAAGCCAATGGCAA,0,468440
araBp,0.3333333333333333,2,2,CGATTACGGATTTTGGTTTC,0,507080
araBp,0.3333333333333333,2,2,CGATCTGCGATCTGGGCCTA,0,475643
araBp,0.3333333333333333,2,2,CGATCGTCCACGAGGCGCTG,0,470327
araBp,0.3333333333333333,2,2,CGATATGAAAACTGTTACTT,0,510653
araBp,0.3333333333333333,2,2,CGATAGTCTTATTATTCCCA,0,472010
araBp,0.3333333333333333,2,2,CGAGTTTTCCTGGATTGTAG,0,475135
araBp,0.3333333333333333,2,2,CGAGTTGGGTTAGGATCCAT,0,474809
araBp,0.3333333333333333,2,2,CGAGTCGTAGGGGCTTAAGA,0,516069
araBp,0.3333333333333333,2,2,CGAGGTACTACTGCTTAGTA,0,501405
araBp,0.3333333333333333,2,2,CGAGCGGGAATATGAATTGC,0,518723
araBp,0.3333333333333333,2,2,CGAGCGCGGTGGTGATGTAT,0,510909
araBp,0.3333333333333333,2,2,CGAGCGAGAACCAATGAGCC,0,469291
araBp,0.3333333333333333,2,2,CGAGACGAGCTATGCACCCT,0,480101
araBp,0.3333333333333333,2,2,CGAGACCGCCTTGGCCAGAA,0,487743
araBp,0.3333333333333333,2,2,CGACTTTAAGTGCGTACTAT,0,523977
araBp,0.3333333333333333,2,2,CGACTGAGCTTCTGTAAATT,0,479479
araBp,0.3333333333333333,2,2,CGACTCAATACAGAAGCAAC,0,474938
araBp,0.3333333333333333,2,2,CGACGTCAATTAACACTTAG,0,512152
araBp,0.3333333333333333,2,2,CGACGCTCACTTAATGTGGT,0,511430
araBp,0.3333333333333333,2,2,CGACCTGGAGTCAAACATAA,0,486809
araBp,0.3333333333333333,2,2,CGACCGGAAGCAGCAACACA,0,467962
araBp,0.3333333333333333,2,2,CGACCGAAAACTGATCCACT,0,471574
araBp,0.3333333333333333,2,2,CGACCACACCGGCAGTAAAG,0,517568
araBp,0.3333333333333333,2,2,CGACCAATAATTCGGTTATT,0,514452
araBp,0.3333333333333333,2,2,CGACATCACACTAACTGTCA,0,502949
araBp,0.3333333333333333,2,2,CGACAAGCTCTACGATGGTG,0,474012
araBp,0.3333333333333333,2,2,CGAATGGACGTTACCTGTAA,0,483715
araBp,0.3333333333333333,2,2,CGAATGCAGGGTCATAGGAT,0,476443
araBp,0.3333333333333333,2,2,CGAATCTGGTCAAAGACAGC,0,523603
araBp,0.3333333333333333,2,2,CGAAGACAGGCGGCTGCACC,0,501133
araBp,0.3333333333333333,2,2,CGAACGCTCTCAGCCGGGAC,0,519974
araBp,0.3333333333333333,2,2,CGAACCTAGGATGTGCCGAT,0,496138
araBp,0.3333333333333333,2,2,CGAAAAGCCAGTTTGTCAGA,0,493221
araBp,0.3333333333333333,2,2,CCTTTGTTACTCTGTACGTG,0,500839
araBp,0.3333333333333333,2,2,CCTTTGCATTGTTAATGTGT,0,468911
araBp,0.3333333333333333,2,2,CCTTTATCGTACTATTTCTT,0,523421
araBp,0.3333333333333333,2,2,CCTTGTGTGATATATTTAAA,0,498209
araBp,0.3333333333333333,2,2,CCTTCTGTAGATAGCCCTTA,0,512371
araBp,0.3333333333333333,2,2,CCTTCTATATTAATCCTATC,0,497496
araBp,0.3333333333333333,2,2,CCTTCCCGTTATGTTGTCTA,0,524872
araBp,0.3333333333333333,2,2,CCTTCCCGAAAAGCTACGAG,0,487127
araBp,0.3333333333333333,2,2,CCTTAAAACATCCGCAGGAT,0,471728
araBp,0.3333333333333333,2,2,CCTGGCTCGTAGAGTTGGCA,0,489534
araBp,0.3333333333333333,2,2,CCTGAAAGTCCACACTAGGT,0,513000
araBp,0.3333333333333333,2,2,CCTCTTCATGACGTGTGGAG,0,481588
araBp,0.3333333333333333,2,2,CCTCTCGGTTCTAAATAGTA,0,484090
araBp,0.3333333333333333,2,2,CCTCGTGGATCGCATGCTGG,0,476744
araBp,0.3333333333333333,2,2,CCTCGACGCTAGTAAGCATA,0,497256
araBp,0.3333333333333333,2,2,CCTCCTAGGGCAACCTAGTG,0,516055
araBp,0.3333333333333333,2,2,CCTCACGCAGATCGTCAAAG,0,497921
araBp,0.3333333333333333,2,2,CCTAGGGGAAATATTAAAAA,0,485973
araBp,0.3333333333333333,2,2,CCTACTTGGTGTCTATATGT,0,475090
araBp,0.3333333333333333,2,2,CCTACCGTGGTCCTCCTTCG,0,512915
araBp,0.3333333333333333,2,2,CCTAATTAGGAAGGGCAAAC,0,474874
araBp,0.3333333333333333,2,2,CCTAAGAGATGAGACAGGGG,0,524342
araBp,0.3333333333333333,2,2,CCGTTTTGGCGCCGACTGGA,0,480850
araBp,0.3333333333333333,2,2,CCGTTTTAGGGGTTTGGCTA,0,478096
araBp,0.3333333333333333,2,2,CCGTTTTAGCATTGCGGTGA,0,488730
araBp,0.3333333333333333,2,2,CCGTTTCATCTGATAAACAA,0,472415
araBp,0.3333333333333333,2,2,CCGTATGCTAGATCAAAGGC,0,468923
araBp,0.3333333333333333,2,2,CCGTAGGGAACGTTACTATG,0,483854
araBp,0.3333333333333333,2,2,CCGTACCCGGGCCAGTTCAT,0,469986
araBp,0.3333333333333333,2,2,CCGGTTGATGGAAAGCCCTT,0,486712
araBp,0.3333333333333333,2,2,CCGGTGTCAGGCACATGAAC,0,499896
araBp,0.3333333333333333,2,2,CCGGTGGCAACAGGAAGGAG,0,522704
araBp,0.3333333333333333,2,2,CCGGTGACGATGAATTGCTC,0,514137
araBp,0.3333333333333333,2,2,CCGGGGTTTAACCAAAAATC,0,506004
araBp,0.3333333333333333,2,2,CCGGGGAGGACAGTGCAGTA,0,480514
araBp,0.3333333333333333,2,2,CCGGGCAGCTAGGTAAAGCT,0,513683
araBp,0.3333333333333333,2,2,CCGGGAGGCACCGTTCCGCT,0,507044
araBp,0.3333333333333333,2,2,CCGGACTCATGCCCGTGTAG,0,470822
araBp,0.3333333333333333,2,2,CCGGACCGTGTTGACGTAGC,0,488751
araBp,0.3333333333333333,2,2,CCGGAACCCACAGAAGTTCT,0,477513
araBp,0.3333333333333333,2,2,CCGCTGTTGCCAACACGATT,0,516827
araBp,0.3333333333333333,2,2,CCGCTAGAGACGGCTCTCGT,0,513162
araBp,0.3333333333333333,2,2,CCGCGGTTCATATACGGCAT,0,524388
araBp,0.3333333333333333,2,2,CCGCGCCATACTTTTAGTGG,0,521919
araBp,0.3333333333333333,2,2,CCGCCGGGATGATCCAGTTA,0,476180
araBp,0.3333333333333333,2,2,CCGCCGCATATCCGTCACCT,0,469556
araBp,0.3333333333333333,2,2,CCGCCCAAGGTAGGCGAGCA,0,508266
araBp,0.3333333333333333,2,2,CCGCACGTTAACGGGGTTTC,0,470820
araBp,0.3333333333333333,2,2,CCGCAACGGTATTGTACGGC,0,474129
araBp,0.3333333333333333,2,2,CCGCAACGACGCGTGAGCAA,0,489631
araBp,0.3333333333333333,2,2,CCGCAAAAGTCACCAATTCT,0,524415
araBp,0.3333333333333333,2,2,CCGATGGTCCTCGCAAAAAC,0,501948
araBp,0.3333333333333333,2,2,CCGATAACGCGCGGTATCAG,0,500489
araBp,0.3333333333333333,2,2,CCGAGAGCGGGTCTTTTGGC,0,496115
araBp,0.3333333333333333,2,2,CCGACTGCGCCATGCGCGCT,0,483774
araBp,0.3333333333333333,2,2,CCGACTACTATGTTGAGATT,0,469813
araBp,0.3333333333333333,2,2,CCGACAAAGGGGAGACTTAT,0,500987
araBp,0.3333333333333333,2,2,CCGAAATGCATACGCCTTTC,0,508490
araBp,0.3333333333333333,2,2,CCCTTAGTCCACCTCCTGCG,0,499899
araBp,0.3333333333333333,2,2,CCCTGGTTCCGTGGGATCGC,0,485618
araBp,0.3333333333333333,2,2,CCCTGGACACGCTGAGCGGG,0,520744
araBp,0.3333333333333333,2,2,CCCTGCCGTAAGGTCGATTT,0,521895
araBp,0.3333333333333333,2,2,CCCTGAGCAATCGGTGATCC,0,511216
araBp,0.3333333333333333,2,2,CCCTGACTTTCGTGAGAGCA,0,513148
araBp,0.3333333333333333,2,2,CCCTAGACTGGGCTTTCGCT,0,501234
araBp,0.3333333333333333,2,2,CCCTACTATCGAGCGTGATC,0,502607
araBp,0.3333333333333333,2,2,CCCTAACCTAGCTCCTTAGG,0,485357
araBp,0.3333333333333333,2,2,CCCGTGGACATTGCTACCCT,0,476783
araBp,0.3333333333333333,2,2,CCCGGCGTGTCCAGTGAAGC,0,472904
araBp,0.3333333333333333,2,2,CCCGGCGGCCAGCAGAGCAG,0,480356
araBp,0.3333333333333333,2,2,CCCGGAGATTGGCCGAAAGC,0,473188
araBp,0.3333333333333333,2,2,CCCGCTCACGCGTGGGATGG,0,515192
araBp,0.3333333333333333,2,2,CCCGCTAAGCAGGGGACCAC,0,499241
araBp,0.3333333333333333,2,2,CCCGCGCGGCTGATAATGGG,0,480071
araBp,0.3333333333333333,2,2,CCCGCGCGAACGATTCTGGG,0,468017
araBp,0.3333333333333333,2,2,CCCGCCTCAGTAGAAGGCAA,0,515495
araBp,0.3333333333333333,2,2,CCCGCCGGGGCGTCGTAGCT,0,502886
araBp,0.3333333333333333,2,2,CCCCTTTTGCCCCTGTTCGC,0,479171
araBp,0.3333333333333333,2,2,CCCCTGCACCGTCAACTTGT,0,492043
araBp,0.3333333333333333,2,2,CCCCTCGTACTGTAAAGGGC,0,493197
araBp,0.3333333333333333,2,2,CCCCGCCGGAACAAGGTTAG,0,486366
araBp,0.3333333333333333,2,2,CCCCGCCCTCATCAAACAAT,0,524493
araBp,0.3333333333333333,2,2,CCCCCTCCCGGAGTCCCAGC,0,484202
araBp,0.3333333333333333,2,2,CCCCATTAATTGCGGCACAC,0,483859
araBp,0.3333333333333333,2,2,CCCATGCATATCACTGGTCG,0,468131
araBp,0.3333333333333333,2,2,CCCAGTTCTGTCACGTCACA,0,517070
araBp,0.3333333333333333,2,2,CCCAATGGGCGAGACGGCAT,0,519239
araBp,0.3333333333333333,2,2,CCCAAGGCGCTGCTTAACCA,0,470170
araBp,0.3333333333333333,2,2,CCCAACGCAGATACCTAAAT,0,478291
araBp,0.3333333333333333,2,2,CCATTTGTCCAAAAAAAGTG,0,498489
araBp,0.3333333333333333,2,2,CCATGGTCCATGGGTTGGGA,0,513518
araBp,0.3333333333333333,2,2,CCATGGACCACCTCGACCAC,0,472307
araBp,0.3333333333333333,2,2,CCATCCATACACCACCCAGT,0,507936
araBp,0.3333333333333333,2,2,CCAGTAGGGGACGGGGTAGG,0,483619
araBp,0.3333333333333333,2,2,CCAGGGGGTATACCGGGAAC,0,503116
araBp,0.3333333333333333,2,2,CCAGGCAGGGGGTTAGGATG,0,496006
araBp,0.3333333333333333,2,2,CCAGCCTACCCCACAAACTC,0,497985
araBp,0.3333333333333333,2,2,CCAGCATGAGTATGGAGAAC,0,504421
araBp,0.3333333333333333,2,2,CCAGAGGGATAACATTGCAT,0,500906
araBp,0.3333333333333333,2,2,CCACTCTTAAGCGATCAAAG,0,479706
araBp,0.3333333333333333,2,2,CCACGGGTCCATTTATCCTA,0,498113
araBp,0.3333333333333333,2,2,CCACGCCCACACTCCTGAAT,0,524136
araBp,0.3333333333333333,2,2,CCACCATCTTAGAACGTAGA,0,470199
araBp,0.3333333333333333,2,2,CCACATTTTGGCCATGTTCT,0,480210
araBp,0.3333333333333333,2,2,CCACAAGGGTGCTACATCCA,0,519846
araBp,0.3333333333333333,2,2,CCAATATACTTCTTTCATGC,0,514059
araBp,0.3333333333333333,2,2,CCAAGCTGTACATAGACTGC,0,495254
araBp,0.3333333333333333,2,2,CCAACGGTTGAAACCTGGAG,0,484178
araBp,0.3333333333333333,2,2,CCAAATGATGTTTTGCTAAG,0,492893
araBp,0.3333333333333333,2,2,CCAAAGTTAGTTAAGACAAT,0,511514
araBp,0.3333333333333333,2,2,CCAAAATGCTTGTGGTGGCA,0,478573
araBp,0.3333333333333333,2,2,CCAAAAGTTGTACGGTTCAC,0,506190
araBp,0.3333333333333333,2,2,CCAAAAGGATTTGCACACGT,0,486626
araBp,0.3333333333333333,2,2,CATTGTTAGGTGCTTTCTTG,0,480534
araBp,0.3333333333333333,2,2,CATTGTCCTATCTGAGCGTT,0,477714
araBp,0.3333333333333333,2,2,CATTGGTTTTGCTTTCTCCA,0,513556
araBp,0.3333333333333333,2,2,CATTGACGATCTGAAATAAT,0,483814
araBp,0.3333333333333333,2,2,CATTCGCGTATAGAACCAGA,0,514833
araBp,0.3333333333333333,2,2,CATTCCAGACGAGAATAGCG,0,517778
araBp,0.3333333333333333,2,2,CATTAGGTGAATTTGGAAAA,0,508921
araBp,0.3333333333333333,2,2,CATGGTGTAATGTACATAAG,0,471953
araBp,0.3333333333333333,2,2,CATGGGGTCCACGGAAGGGA,0,497339
araBp,0.3333333333333333,2,2,CATGGGGCAGGGTCTATTGA,0,524321
araBp,0.3333333333333333,2,2,CATGCTTCCGTCTCACCAGG,0,518260
araBp,0.3333333333333333,2,2,CATGCAGCTGAGATGATCAT,0,491092
araBp,0.3333333333333333,2,2,CATGATGGCTCCAAGTTCTC,0,491441
araBp,0.3333333333333333,2,2,CATGACATTAGGCAAGGATA,0,504384
araBp,0.3333333333333333,2,2,CATGAATCGGTCATGGGGAG,0,497766
araBp,0.3333333333333333,2,2,CATCTTGTTCTGGGGCCGTA,0,500071
araBp,0.3333333333333333,2,2,CATCTTGAGGAGAGGCGACT,0,483530
araBp,0.3333333333333333,2,2,CATCTGGCATGTCGGCAGTT,0,517195
araBp,0.3333333333333333,2,2,CATCCGGCCGTCGTGAGACA,0,523477
araBp,0.3333333333333333,2,2,CATCATTGACTCTTGCGAGT,0,497196
araBp,0.3333333333333333,2,2,CATCATGTACGCACGAAGCT,0,524410
araBp,0.3333333333333333,2,2,CATCAGTATGCCAGGCATGC,0,512489
araBp,0.3333333333333333,2,2,CATATTCGATGTCACTGCGT,0,504312
araBp,0.3333333333333333,2,2,CATATGATGCGCTGCTTCTG,0,507149
araBp,0.3333333333333333,2,2,CATAGGACTACACACTATAC,0,505857
araBp,0.3333333333333333,2,2,CATAGCGTCATTATGCGCGG,0,476300
araBp,0.3333333333333333,2,2,CATAACTGGTGTGTCATAAC,0,468097
araBp,0.3333333333333333,2,2,CATAAACGGAAAAGCGCAAT,0,481991
araBp,0.3333333333333333,2,2,CAGTTCACCATCTTGTGCAT,0,475859
araBp,0.3333333333333333,2,2,CAGTGCGCGCATAATCATAG,0,500606
araBp,0.3333333333333333,2,2,CAGTCCGACCTTATTACCTT,0,492108
araBp,0.3333333333333333,2,2,CAGTCAGGTGGGCCTCAGGA,0,519843
araBp,0.3333333333333333,2,2,CAGTCAGCCAAAACTCTGAA,0,487720
araBp,0.3333333333333333,2,2,CAGTAAAAGCCTTCGGACTG,0,473475
araBp,0.3333333333333333,2,2,CAGGTTGCCTGTCAGGACCG,0,476070
araBp,0.3333333333333333,2,2,CAGGTGGGTGCACAACTTTC,0,470169
araBp,0.3333333333333333,2,2,CAGGTAAGTCAAACACGCCG,0,506058
araBp,0.3333333333333333,2,2,CAGGGGCAGCAAAAATCCAT,0,505383
araBp,0.3333333333333333,2,2,CAGGGCCACTGGCCTCAATG,0,468886
araBp,0.3333333333333333,2,2,CAGGAATATTGCGCGCCACA,0,518472
araBp,0.3333333333333333,2,2,CAGGAACCACATGTTCTGTG,0,496461
araBp,0.3333333333333333,2,2,CAGGAACATGTAGTGTTGTA,0,477419
araBp,0.3333333333333333,2,2,CAGCTGTCGCTCATCAGCGC,0,510331
araBp,0.3333333333333333,2,2,CAGCGTGGGAGGTGAAATCC,0,517295
araBp,0.3333333333333333,2,2,CAGCGGCGGGCGATCACATA,0,498339
araBp,0.3333333333333333,2,2,CAGCGCGAGCCTCGTCCCCC,0,498865
araBp,0.3333333333333333,2,2,CAGCAACGACTGTCTAGAAT,0,502702
araBp,0.3333333333333333,2,2,CAGATTCCGGCTCACATCTT,0,470801
araBp,0.3333333333333333,2,2,CAGATGCTCGGGTGCGAATC,0,502498
araBp,0.3333333333333333,2,2,CAGAGTATCAAACATACATG,0,521050
araBp,0.3333333333333333,2,2,CAGAGGAAACGTCTGTCCAT,0,468021
araBp,0.3333333333333333,2,2,CAGAGAGGGATTGTAGCTTT,0,495904
araBp,0.3333333333333333,2,2,CAGAGAGGCTCCGGGCGGAA,0,472831
araBp,0.3333333333333333,2,2,CAGACCGAACCTTCAGGAGA,0,477751
araBp,0.3333333333333333,2,2,CAGAACGCAAGTGGCCCAGG,0,512841
araBp,0.3333333333333333,2,2,CACTTGACAAGTGACCATAG,0,478290
araBp,0.3333333333333333,2,2,CACTGTTTAGTTTCAATTAG,0,503817
araBp,0.3333333333333333,2,2,CACGTTTCCATTGCCGGGAT,0,522492
araBp,0.3333333333333333,2,2,CACGGTGCGATTCTGCGGGT,0,513344
araBp,0.3333333333333333,2,2,CACGCCTATGTAGAGAGGGT,0,511090
araBp,0.3333333333333333,2,2,CACGCCAGGGATGTGTCGGG,0,490210
araBp,0.3333333333333333,2,2,CACGATAGTTTCAAATACTT,0,479874
araBp,0.3333333333333333,2,2,CACCGGCTAGACTTGGACGG,0,511655
araBp,0.3333333333333333,2,2,CACCGATTCGTATCCAAGTT,0,512980
araBp,0.3333333333333333,2,2,CACCCTCGGGAAAGCATAAT,0,516321
araBp,0.3333333333333333,2,2,CACCAGCCATATCCCTCCTC,0,469381
araBp,0.3333333333333333,2,2,CACCAACCATGGACCTATCG,0,479583
araBp,0.3333333333333333,2,2,CACAAGGCCCAAGTGACGCA,0,514589
araBp,0.3333333333333333,2,2,CACAAAATACGTTGATACGA,0,517738
araBp,0.3333333333333333,2,2,CAATGTTCCTATGGATGAGA,0,505506
araBp,0.3333333333333333,2,2,CAATCTCTTTCTACTGTATT,0,481396
araBp,0.3333333333333333,2,2,CAATCCTCAGCAGTGCGGGA,0,516306
araBp,0.3333333333333333,2,2,CAATCATTGTGTCACTCCCT,0,515029
araBp,0.3333333333333333,2,2,CAATCAGGTAATTTGGCACA,0,472858
araBp,0.3333333333333333,2,2,CAATAAGACCGAAACCGATC,0,520176
araBp,0.3333333333333333,2,2,CAAGTCGCTCTGTAGGCCGC,0,509497
araBp,0.3333333333333333,2,2,CAAGGTCTTGCCCAAACCGA,0,501400
araBp,0.3333333333333333,2,2,CAAGGACAGGTCTAGCACGT,0,512177
araBp,0.3333333333333333,2,2,CAAGCTCCCGCCAAATATTG,0,472146
araBp,0.3333333333333333,2,2,CAAGCGTTTTACCGAAGCGC,0,513040
araBp,0.3333333333333333,2,2,CAAGCGTCGTCAGTATTAGT,0,497136
araBp,0.3333333333333333,2,2,CAAGCCTCCATGTTTCAATT,0,506284
araBp,0.3333333333333333,2,2,CAAGACATAATTAGGGATAT,0,483135
araBp,0.3333333333333333,2,2,CAACTACATTTTAGTCCAGG,0,525204
araBp,0.3333333333333333,2,2,CAACGTCTTATGGCGCGGTT,0,477994
araBp,0.3333333333333333,2,2,CAACGGGGAAATTGAAATAC,0,506558
araBp,0.3333333333333333,2,2,CAACGCAGGCGTACAAGGTG,0,505596
araBp,0.3333333333333333,2,2,CAACCGTTCGCCACATAACT,0,522091
araBp,0.3333333333333333,2,2,CAACCGGGAATGCGTGGCCC,0,516318
araBp,0.3333333333333333,2,2,CAACAGCTTGTATGAGGCAA,0,516950
araBp,0.3333333333333333,2,2,CAAATCGGGCCTCGCTTTGT,0,511357
araBp,0.3333333333333333,2,2,CAAAGGGAGTACGGTGGTAC,0,498316
araBp,0.3333333333333333,2,2,CAAAGCTGGTAATAACCACG,0,470228
araBp,0.3333333333333333,2,2,CAAACTGAATAAGAAGTCAG,0,513750
araBp,0.3333333333333333,2,2,CAAACGACTGTAATGGGCAG,0,504952
araBp,0.3333333333333333,2,2,CAAACAGATACATGAGGCGT,0,476339
araBp,0.3333333333333333,2,2,CAAAACAGGTCAGCTGATAC,0,524949
araBp,0.3333333333333333,2,2,CAAAAACGAAGGCTGGCTTC,0,480404
araBp,0.3333333333333333,2,2,ATTTGGGGAGATTACCCTGT,0,519541
araBp,0.3333333333333333,2,2,ATTTGCCGCTCCAGCTCGGT,0,524274
araBp,0.3333333333333333,2,2,ATTTCTACGAAGTCATGTTC,0,494535
araBp,0.3333333333333333,2,2,ATTTATTCCAACCATAACGC,0,484571
araBp,0.3333333333333333,2,2,ATTTATGTCGGGAATGTTGC,0,511986
araBp,0.3333333333333333,2,2,ATTTAGCTTAAATAAATTAT,0,497548
araBp,0.3333333333333333,2,2,ATTGTTGTTGGATATTATCT,0,512171
araBp,0.3333333333333333,2,2,ATTGTCGTAACGTTAGACAC,0,498118
araBp,0.3333333333333333,2,2,ATTGTAAGGTTTGGCAATTT,0,521997
araBp,0.3333333333333333,2,2,ATTGGTTCTCTTTTTTGGCG,0,485196
araBp,0.3333333333333333,2,2,ATTGGGCGAGGGCATCCGCA,0,504797
araBp,0.3333333333333333,2,2,ATTGCGTACTCGTGCGCCGT,0,523929
araBp,0.3333333333333333,2,2,ATTGATACTGGATACGGGTT,0,476898
araBp,0.3333333333333333,2,2,ATTCTCGTAGCACATATTCT,0,512627
araBp,0.3333333333333333,2,2,ATTCGGCATAGGGAATGTCC,0,469928
araBp,0.3333333333333333,2,2,ATTCGCGGATTGAAAGATGC,0,513454
araBp,0.3333333333333333,2,2,ATTCCTGCGATGCGCCCCTG,0,471699
araBp,0.3333333333333333,2,2,ATTCCGTAACCTGAGCCAGT,0,476229
araBp,0.3333333333333333,2,2,ATTCCAGGCATGTTTCTCTT,0,471325
araBp,0.3333333333333333,2,2,ATTCATGAATTGGTGTTTTA,0,513903
araBp,0.3333333333333333,2,2,ATTCATATGGTCCACTTGTG,0,514565
araBp,0.3333333333333333,2,2,ATTCAGTTTACCCATAATAA,0,506023
araBp,0.3333333333333333,2,2,ATTCAATAGGTGGTTACGGT,0,474688
araBp,0.3333333333333333,2,2,ATTATTCTCGAAGAGACAAG,0,474865
araBp,0.3333333333333333,2,2,ATTATGGGCCGACGTTTTTT,0,482463
araBp,0.3333333333333333,2,2,ATTATAGGGCGCAAGGCAGA,0,479399
araBp,0.3333333333333333,2,2,ATTATACGGATGACTCACGG,0,487833
araBp,0.3333333333333333,2,2,ATTAGGGGTATGAGATAACT,0,477427
araBp,0.3333333333333333,2,2,ATTAGGAATATCAGGCGCCA,0,502203
araBp,0.3333333333333333,2,2,ATTAACGTTGGGTTCCTGTG,0,501537
araBp,0.3333333333333333,2,2,ATGTTTGCAGCTCGACTTCT,0,475703
araBp,0.3333333333333333,2,2,ATGTTCAAATTGGTATACAT,0,508576
araBp,0.3333333333333333,2,2,ATGTGTAAATATCGTGATTA,0,492062
araBp,0.3333333333333333,2,2,ATGTGCTGTATGTCGTAGCA,0,474232
araBp,0.3333333333333333,2,2,ATGTCGTAAACCTCTCGCAA,0,495652
araBp,0.3333333333333333,2,2,ATGTCGGTAATGTTTTTATC,0,474875
araBp,0.3333333333333333,2,2,ATGTCCCACTTGCTGCATTT,0,483481
araBp,0.3333333333333333,2,2,ATGTCCATCCTGGAGTGAGG,0,476525
araBp,0.3333333333333333,2,2,ATGTCATCCTTCACGTAACC,0,473216
araBp,0.3333333333333333,2,2,ATGGTTGATTCATTCACCTA,0,512792
araBp,0.3333333333333333,2,2,ATGGTCCCTGGGAATCGCCA,0,515287
araBp,0.3333333333333333,2,2,ATGGGACTTAAGCAACCGCG,0,484542
araBp,0.3333333333333333,2,2,ATGGCGGTAGTACTCGTATG,0,511786
araBp,0.3333333333333333,2,2,ATGGATCCCAGCGCACTTCC,0,477135
araBp,0.3333333333333333,2,2,ATGGATACGCGTGTCGTAGG,0,469768
araBp,0.3333333333333333,2,2,ATGGAGCACAGGGTCTCCTC,0,480885
araBp,0.3333333333333333,2,2,ATGCTGTATTCGGAGCCATG,0,500362
araBp,0.3333333333333333,2,2,ATGCGCTTTGATAGCACAAC,0,509406
araBp,0.3333333333333333,2,2,ATGCGATACAATAACTCGCT,0,507817
araBp,0.3333333333333333,2,2,ATGCCTCAGGATATATAGAT,0,485633
araBp,0.3333333333333333,2,2,ATGCCCCTCTGCTCACCGGA,0,510328
araBp,0.3333333333333333,2,2,ATGCATCCGGAGCGAACTTT,0,520175
araBp,0.3333333333333333,2,2,ATGATTCATGGGGTAAAAAA,0,520514
araBp,0.3333333333333333,2,2,ATGATCGATGCCATGGCTCT,0,493272
araBp,0.3333333333333333,2,2,ATGATAAGGGCGATGCCTCG,0,479383
araBp,0.3333333333333333,2,2,ATGAGAGGCCCATATTAACT,0,488537
araBp,0.3333333333333333,2,2,ATGACTTCAGCCCTCACGCG,0,518091
araBp,0.3333333333333333,2,2,ATGAACCATTTTTCAGATCG,0,495273
araBp,0.3333333333333333,2,2,ATGAAAGGTAAACCGTACTT,0,475208
araBp,0.3333333333333333,2,2,ATCTTCCGAGTTCATTCGGT,0,501143
araBp,0.3333333333333333,2,2,ATCTGTGTCGTAGCAAAACC,0,509341
araBp,0.3333333333333333,2,2,ATCTGCAGGTTACGCTGCAG,0,490329
araBp,0.3333333333333333,2,2,ATCTCGGAGGCGTACCTGGA,0,520505
araBp,0.3333333333333333,2,2,ATCTCGACACGAACCATGCA,0,484181
araBp,0.3333333333333333,2,2,ATCTCAATTAACGTAGTCGG,0,514215
araBp,0.3333333333333333,2,2,ATCTAGATAGGCTGCGGTTG,0,521633
araBp,0.3333333333333333,2,2,ATCGTGCCGTAGTAGAGTAC,0,495588
araBp,0.3333333333333333,2,2,ATCGTCGTTGTTCTAATAAG,0,517996
araBp,0.3333333333333333,2,2,ATCGGTGTTTGCGTATGTAA,0,506220
araBp,0.3333333333333333,2,2,ATCGCATCGCCTGGAGAGCT,0,519628
araBp,0.3333333333333333,2,2,ATCGCATCAAAAGGACTAAC,0,487648
araBp,0.3333333333333333,2,2,ATCGCAGAGGGTCTCGAAAC,0,475900
araBp,0.3333333333333333,2,2,ATCGAAAGAGGTAGAAGTGC,0,506770
araBp,0.3333333333333333,2,2,ATCCTGCACCGTCGCCCCGA,0,492202
araBp,0.3333333333333333,2,2,ATCCTCGAAGCGGGGAAATG,0,492077
araBp,0.3333333333333333,2,2,ATCCTATTGGTTCCGGTCCT,0,517545
araBp,0.3333333333333333,2,2,ATCCTATAGACACTAATCTG,0,494645
araBp,0.3333333333333333,2,2,ATCCCGAGTAGGCACAGACA,0,496290
araBp,0.3333333333333333,2,2,ATCCCAGCATGCGTTACGGG,0,511101
araBp,0.3333333333333333,2,2,ATCCCACTCGAGTTCTACTA,0,483270
araBp,0.3333333333333333,2,2,ATCCATGCCGTTGCCCCTAT,0,469679
araBp,0.3333333333333333,2,2,ATCCACGTGCGCGAAAGCTC,0,470422
araBp,0.3333333333333333,2,2,ATCAGGGTGTAGTATTAGAT,0,475632
araBp,0.3333333333333333,2,2,ATCAGACAGATTCGGTAAGG,0,486973
araBp,0.3333333333333333,2,2,ATCACATGGGGTTCGTTTTA,0,524112
araBp,0.3333333333333333,2,2,ATCAATCGGTTTCCCCATAG,0,478887
araBp,0.3333333333333333,2,2,ATCAACCGGGAAGGCCGCGA,0,511121
araBp,0.3333333333333333,2,2,ATCAAAGATTGCCCGGAACG,0,521594
araBp,0.3333333333333333,2,2,ATATGCGTCAGCTGACAATT,0,499255
araBp,0.3333333333333333,2,2,ATATAGGTGCTAATTGTCCA,0,485549
araBp,0.3333333333333333,2,2,ATATACCGTATAACCTTCGA,0,468352
araBp,0.3333333333333333,2,2,ATAGTCACGTGTTCCAAATG,0,485600
araBp,0.3333333333333333,2,2,ATAGTATCGGAGGCGGGGCT,0,495916
araBp,0.3333333333333333,2,2,ATAGAGCTCCATAAAAATGT,0,489286
araBp,0.3333333333333333,2,2,ATAGAGACTTTTCGGGACCA,0,505889
araBp,0.3333333333333333,2,2,ATAGACTAATTATTGTTAGT,0,481114
araBp,0.3333333333333333,2,2,ATAGACAACAAAGCCGTCGT,0,508360
araBp,0.3333333333333333,2,2,ATACTGATCCATAAATTGAC,0,489149
araBp,0.3333333333333333,2,2,ATACTCCCGTGTAGTGAAGT,0,484773
araBp,0.3333333333333333,2,2,ATACTATCCACATAGTCGGG,0,501294
araBp,0.3333333333333333,2,2,ATACCTTGCGACACCGGACA,0,485231
araBp,0.3333333333333333,2,2,ATACATTTCGAACGGAGTGG,0,472051
araBp,0.3333333333333333,2,2,ATAATTATTGCAACACGTAC,0,492011
araBp,0.3333333333333333,2,2,ATAAGGACGTAGGTGTGGAC,0,489667
araBp,0.3333333333333333,2,2,ATAAGCAATTGGATTAGGGA,0,472266
araBp,0.3333333333333333,2,2,ATAACTGCTCTCACGAATGA,0,519387
araBp,0.3333333333333333,2,2,AGTTTTAGCATGGAATCGTT,0,495361
araBp,0.3333333333333333,2,2,AGTTTGTTCTGGGTATAGAG,0,468929
araBp,0.3333333333333333,2,2,AGTTTGGGCCTGGTCAAAGG,0,475741
araBp,0.3333333333333333,2,2,AGTTTACTATACCATTCGAT,0,471648
araBp,0.3333333333333333,2,2,AGTTTACCGGACTTTGGATC,0,472473
araBp,0.3333333333333333,2,2,AGTTGAACATGTTTCAAAAC,0,507203
araBp,0.3333333333333333,2,2,AGTTCCTAGACAAAGGGGCT,0,515111
araBp,0.3333333333333333,2,2,AGTTACTTCCGCGCCCATGC,0,521073
araBp,0.3333333333333333,2,2,AGTTAAGCTGCGTGCCAAGA,0,484948
araBp,0.3333333333333333,2,2,AGTGTTCAGCCAGAAAAAAC,0,493349
araBp,0.3333333333333333,2,2,AGTGTTACAAAGCAGAATGA,0,505198
araBp,0.3333333333333333,2,2,AGTGCGGTGAATATCAATGA,0,475863
araBp,0.3333333333333333,2,2,AGTGCGCGGCCTATACGGCT,0,468534
araBp,0.3333333333333333,2,2,AGTGCGCATAAGGGACTGGC,0,475493
araBp,0.3333333333333333,2,2,AGTCTCTAACGGATTTATTA,0,486074
araBp,0.3333333333333333,2,2,AGTCGGTACGTTGCATCCTC,0,516134
araBp,0.3333333333333333,2,2,AGTCGCACGTCTTGGTACGT,0,509272
araBp,0.3333333333333333,2,2,AGTCCTCCACCTATATGTGG,0,496455
araBp,0.3333333333333333,2,2,AGTCCTACGTCAGAGACTAG,0,478092
araBp,0.3333333333333333,2,2,AGTCCGAACTGATTGCATGG,0,497662
araBp,0.3333333333333333,2,2,AGTCCCACTTAACTATGGGT,0,471383
araBp,0.3333333333333333,2,2,AGTCCAACGAATGGCCATTA,0,493501
araBp,0.3333333333333333,2,2,AGTCATTCCGGCGTGTGCCA,0,493587
araBp,0.3333333333333333,2,2,AGTCAAACGGGAACGAACAT,0,507994
araBp,0.3333333333333333,2,2,AGTATTCTAATACGTATGTC,0,480703
araBp,0.3333333333333333,2,2,AGTAGCCAATTATGCGGCCA,0,473156
araBp,0.3333333333333333,2,2,AGTACCTATAAGATGTCGGA,0,518847
araBp,0.3333333333333333,2,2,AGTAAAGCTGTCTGCGGGTC,0,513324
araBp,0.3333333333333333,2,2,AGGTTGAGACTTGGCTTCTG,0,477226
araBp,0.3333333333333333,2,2,AGGTTCTACGTGCTTCTTAC,0,501030
araBp,0.3333333333333333,2,2,AGGTGGGGAGAAGCCACATA,0,499813
araBp,0.3333333333333333,2,2,AGGTCCCCTATGTAACCATA,0,519382
araBp,0.3333333333333333,2,2,AGGTAGGGGGGTGCGACTTC,0,484524
araBp,0.3333333333333333,2,2,AGGTACCGTGGGGGACATTC,0,469118
araBp,0.3333333333333333,2,2,AGGGTCCTTTGTGATTGGGT,0,489875
araBp,0.3333333333333333,2,2,AGGGTCATGTGCGGTACCTG,0,520820
araBp,0.3333333333333333,2,2,AGGGGGATGTATCCAGCGTC,0,501290
araBp,0.3333333333333333,2,2,AGGGGCTAGTTTTCCGCGTG,0,474247
araBp,0.3333333333333333,2,2,AGGGGCATGTAGGTGCGCTG,0,504781
araBp,0.3333333333333333,2,2,AGGGGATCCCCTTCTGACTA,0,512052
araBp,0.3333333333333333,2,2,AGGGCTTAGACCGGGTCGGA,0,486674
araBp,0.3333333333333333,2,2,AGGGCTACCTAGATTCACAT,0,505288
araBp,0.3333333333333333,2,2,AGGGCCTTTAGAGGGCTTCA,0,519383
araBp,0.3333333333333333,2,2,AGGGCCGCACAAAGGAAAAT,0,520182
araBp,0.3333333333333333,2,2,AGGGATAACCAAGCTTCCCC,0,516738
araBp,0.3333333333333333,2,2,AGGGAGGCCGGACTCATAAG,0,507889
araBp,0.3333333333333333,2,2,AGGCGGCCGCACGAACAACG,0,478366
araBp,0.3333333333333333,2,2,AGGCCTATGTAACCCAAGCT,0,495243
araBp,0.3333333333333333,2,2,AGGCCCGGCCATATGTCGGG,0,498993
araBp,0.3333333333333333,2,2,AGGCATGGCGCTTCTGGCAA,0,519145
araBp,0.3333333333333333,2,2,AGGCAGTGCGGCATGGCGTT,0,488032
araBp,0.3333333333333333,2,2,AGGCAGGCGACTGGTTAGCC,0,493102
araBp,0.3333333333333333,2,2,AGGCACTGGCCCTTATGTGG,0,502372
araBp,0.3333333333333333,2,2,AGGCAAGGGGGTATTAGCAA,0,477644
araBp,0.3333333333333333,2,2,AGGATTCTTTCCATCCTACC,0,488369
araBp,0.3333333333333333,2,2,AGGATTAAATGATTGGTAAT,0,504651
araBp,0.3333333333333333,2,2,AGGATCCAATACTCCATCGA,0,474871
araBp,0.3333333333333333,2,2,AGGAGATCAAGCTGGGCTCC,0,512958
araBp,0.3333333333333333,2,2,AGGACGATTAGTGTTACGAA,0,505861
araBp,0.3333333333333333,2,2,AGGACAACTGTGCAAGCCGC,0,483568
araBp,0.3333333333333333,2,2,AGGAATAAGAATTCGCTCCT,0,513248
araBp,0.3333333333333333,2,2,AGGAACGGGCCTCCTCCCAT,0,508059
araBp,0.3333333333333333,2,2,AGCTTGGGTCACTCCTATGC,0,515470
araBp,0.3333333333333333,2,2,AGCTTCTTGAACATTGCGAA,0,514133
araBp,0.3333333333333333,2,2,AGCTTCTCGAGCGACGGCTA,0,484908
araBp,0.3333333333333333,2,2,AGCTTCATCGCTATCTATTC,0,509306
araBp,0.3333333333333333,2,2,AGCTGTTTGCAGCCCGAGGG,0,499864
araBp,0.3333333333333333,2,2,AGCTCGTCTCAGTAACAGGG,0,480993
araBp,0.3333333333333333,2,2,AGCTAATCCTGTTACTCTCA,0,523235
araBp,0.3333333333333333,2,2,AGCGGAGCATCGCTTGCACG,0,470007
araBp,0.3333333333333333,2,2,AGCGCGACCTCCAGTTTAGG,0,511302
araBp,0.3333333333333333,2,2,AGCGCGAAAAGTTTCGAATG,0,518408
araBp,0.3333333333333333,2,2,AGCGATCTGTCTCGTTAAAC,0,512793
araBp,0.3333333333333333,2,2,AGCCTTCTTTACGAGTGGTG,0,502195
araBp,0.3333333333333333,2,2,AGCCGTGTATCTGCTCGACA,0,489961
araBp,0.3333333333333333,2,2,AGCCGGTTAGCACGGGTTTT,0,476359
araBp,0.3333333333333333,2,2,AGCCGGCCGGGACAGAATCA,0,478473
araBp,0.3333333333333333,2,2,AGCCCCATCCAACAGACTGT,0,500695
araBp,0.3333333333333333,2,2,AGCCCATCCGCGAGTAGAGG,0,475953
araBp,0.3333333333333333,2,2,AGCATCAGTTCCCTACTAGA,0,511869
araBp,0.3333333333333333,2,2,AGCATATGATCTACGATACA,0,495769
araBp,0.3333333333333333,2,2,AGCAGGTACATCTCCGCTGC,0,473923
araBp,0.3333333333333333,2,2,AGCAGATGTTTCAACGACAA,0,478230
araBp,0.3333333333333333,2,2,AGCACTATCTTTGCACAGTT,0,501547
araBp,0.3333333333333333,2,2,AGCAATTGAATGCCTTATTT,0,513098
araBp,0.3333333333333333,2,2,AGCAACGATTGTAGCTTATT,0,480769
araBp,0.3333333333333333,2,2,AGATTCTGAAGCAGAGGCTG,0,519410
araBp,0.3333333333333333,2,2,AGATTAATTAGTACATAATA,0,495174
araBp,0.3333333333333333,2,2,AGATCACCCACACATGTAAT,0,521753
araBp,0.3333333333333333,2,2,AGATATCTCACATATTTCTG,0,512389
araBp,0.3333333333333333,2,2,AGAGGCTTCGCCTTTTTGAA,0,469014
araBp,0.3333333333333333,2,2,AGAGGAATGTTGGTGCTCAA,0,513119
araBp,0.3333333333333333,2,2,AGAGCGGAAATACACACTCC,0,478513
araBp,0.3333333333333333,2,2,AGAGCCGAGCTAGTGGCGAA,0,496116
araBp,0.3333333333333333,2,2,AGAGCCCAAGGAGCAATGGA,0,506448
araBp,0.3333333333333333,2,2,AGAGCATGCCGTTGTCCTTA,0,520739
araBp,0.3333333333333333,2,2,AGAGAACATTCGGCAGTTTA,0,488767
araBp,0.3333333333333333,2,2,AGACGGACAAGGCCGATTAT,0,507215
araBp,0.3333333333333333,2,2,AGACCGTCTGGGCATCGTGC,0,524458
araBp,0.3333333333333333,2,2,AGACCCGTTCTCTGGACTCC,0,471850
araBp,0.3333333333333333,2,2,AGACATCGACAGTTGTTTCT,0,503840
araBp,0.3333333333333333,2,2,AGACAGTGGTACGAGCTCTT,0,498952
araBp,0.3333333333333333,2,2,AGACAGGTATAGTGCGATGA,0,505483
araBp,0.3333333333333333,2,2,AGACAATCAAGGGGGGTGCA,0,499020
araBp,0.3333333333333333,2,2,AGACAAGTCCCTGCCAGGAC,0,519897
araBp,0.3333333333333333,2,2,AGACAAGCTTGCACCGAGTG,0,520086
araBp,0.3333333333333333,2,2,AGAATTTCTCAAACTTCACA,0,503818
araBp,0.3333333333333333,2,2,AGAATTCACTACACTCATTC,0,513320
araBp,0.3333333333333333,2,2,AGAACTTAACCCCCCTATTT,0,495550
araBp,0.3333333333333333,2,2,AGAACGTTGAGCGTTCGCTT,0,470467
araBp,0.3333333333333333,2,2,AGAACCTGTATGTGGCAGTC,0,504936
araBp,0.3333333333333333,2,2,AGAAACGGGTATCCAGTGGA,0,508271
araBp,0.3333333333333333,2,2,ACTTTCCTAAACTATCGCGC,0,471064
araBp,0.3333333333333333,2,2,ACTTGGTCATGGTACAACTG,0,518162
araBp,0.3333333333333333,2,2,ACTTCATTGGCATTCCAATG,0,475889
araBp,0.3333333333333333,2,2,ACTTAATGATACTCTCATAT,0,480411
araBp,0.3333333333333333,2,2,ACTGTGCACTCTTGACTGCT,0,522467
araBp,0.3333333333333333,2,2,ACTGGTCCACCCATAATTCA,0,486741
araBp,0.3333333333333333,2,2,ACTGGTAGCGGTTTCGCACG,0,472733
araBp,0.3333333333333333,2,2,ACTGGGATTAAGTGGCTAGA,0,520076
araBp,0.3333333333333333,2,2,ACTGGCGAGATTTGAAGGGG,0,487835
araBp,0.3333333333333333,2,2,ACTGCTGTACCACGTAGACT,0,513373
araBp,0.3333333333333333,2,2,ACTGATGCCCGAGTGGACCG,0,484947
araBp,0.3333333333333333,2,2,ACTGATACCGGACGCCTCTG,0,497992
araBp,0.3333333333333333,2,2,ACTGAAAAGTAATTCGGCTT,0,500574
araBp,0.3333333333333333,2,2,ACTCTCGAAGATTTATGCCC,0,513157
araBp,0.3333333333333333,2,2,ACTCTAGGTTGACTTAGTAA,0,470925
araBp,0.3333333333333333,2,2,ACTCGCTGTTATCAGTTCAA,0,522401
araBp,0.3333333333333333,2,2,ACTCGCTCGTCGGTGCCTAT,0,508449
araBp,0.3333333333333333,2,2,ACTCCTAACGAATGCATCAA,0,506360
araBp,0.3333333333333333,2,2,ACTCCCTATTTGTCCTGAGC,0,496113
araBp,0.3333333333333333,2,2,ACTCCAGCAGTTACTACTAG,0,510221
araBp,0.3333333333333333,2,2,ACTCATCGTATATGATCATG,0,521554
araBp,0.3333333333333333,2,2,ACTCACACTTGTACCACGCT,0,475303
araBp,0.3333333333333333,2,2,ACTCAAATGAATACTTACAG,0,501207
araBp,0.3333333333333333,2,2,ACTATATTCTGCACGGATTT,0,470016
araBp,0.3333333333333333,2,2,ACTAGTAGATGCCCAAGGAG,0,477446
araBp,0.3333333333333333,2,2,ACTAACCATCGAGTGTAATA,0,509188
araBp,0.3333333333333333,2,2,ACGTTTTTCATTGGACTTAG,0,507011
araBp,0.3333333333333333,2,2,ACGTTTAGTAGTCAGGTGCG,0,492393
araBp,0.3333333333333333,2,2,ACGTGTTGCGCAACTCTACG,0,485485
araBp,0.3333333333333333,2,2,ACGTGGCGACAGAGTCGATA,0,485639
araBp,0.3333333333333333,2,2,ACGTGACTTTATGGTATATC,0,497601
araBp,0.3333333333333333,2,2,ACGTCCTGGGGATGCGAGGG,0,484644
araBp,0.3333333333333333,2,2,ACGTAGGATGCGGGAGGTGG,0,491783
araBp,0.3333333333333333,2,2,ACGGTTGTACAAGTGCAAAA,0,514498
araBp,0.3333333333333333,2,2,ACGGTGTATGGATTCAAGAG,0,468702
araBp,0.3333333333333333,2,2,ACGGTCGCTTCCTTAGCACC,0,482455
araBp,0.3333333333333333,2,2,ACGGTCAGGGTACAGTAAGT,0,514274
araBp,0.3333333333333333,2,2,ACGGTAAATAGTTCCCAAGT,0,469341
araBp,0.3333333333333333,2,2,ACGGGGCCAGGGCTAAACCT,0,506437
araBp,0.3333333333333333,2,2,ACGGGCATCACAAGGCTCGG,0,489202
araBp,0.3333333333333333,2,2,ACGGCTTTAGTCGGAAACTT,0,492190
araBp,0.3333333333333333,2,2,ACGGCTTGGGAGCGTGACCT,0,502110
araBp,0.3333333333333333,2,2,ACGGCTTGGAAATCTGCTAC,0,505759
araBp,0.3333333333333333,2,2,ACGGCGACATGGTTTGGTAG,0,472932
araBp,0.3333333333333333,2,2,ACGGCCTTGTGTTTCGTGTC,0,479919
araBp,0.3333333333333333,2,2,ACGGATCATCCGCGGATAGC,0,525187
araBp,0.3333333333333333,2,2,ACGGAGGCAGAAATTCGCAT,0,491292
araBp,0.3333333333333333,2,2,ACGGAACATCCAAAGGCTAA,0,505593
araBp,0.3333333333333333,2,2,ACGCTGTCACCGCTAAGATT,0,475747
araBp,0.3333333333333333,2,2,ACGCTGCAAAAGGTGCTGAC,0,524749
araBp,0.3333333333333333,2,2,ACGCTCCTCAGCGCGGTTGG,0,513664
araBp,0.3333333333333333,2,2,ACGCGCGACTTCGCGCTGCA,0,487594
araBp,0.3333333333333333,2,2,ACGCCTATTTAAACGTTATC,0,503246
araBp,0.3333333333333333,2,2,ACGCCGTCAATATATAACCA,0,474018
araBp,0.3333333333333333,2,2,ACGCATTCGATCGGTATGGA,0,511072
araBp,0.3333333333333333,2,2,ACGCATTACATAGCTACAAG,0,492671
araBp,0.3333333333333333,2,2,ACGCAATTATAATGAAAAGG,0,512086
araBp,0.3333333333333333,2,2,ACGCAATCCGTTACAATTTC,0,507252
araBp,0.3333333333333333,2,2,ACGATTAATTATCGTTCGCT,0,522447
araBp,0.3333333333333333,2,2,ACGATGTTAATGAATGAAGG,0,490200
araBp,0.3333333333333333,2,2,ACGATGCTCCGAATTATGTG,0,468039
araBp,0.3333333333333333,2,2,ACGATGAGCTAACCTATCTG,0,486064
araBp,0.3333333333333333,2,2,ACGAGTTTGTATGTATACAT,0,524495
araBp,0.3333333333333333,2,2,ACGAGTTTAGGTAATGAGAA,0,509298
araBp,0.3333333333333333,2,2,ACGAGGTGCTCGCCCGATAA,0,494776
araBp,0.3333333333333333,2,2,ACGAGGCCTCGTCCAATGTA,0,490027
araBp,0.3333333333333333,2,2,ACGAGCGTTGTAATGCATAA,0,470790
araBp,0.3333333333333333,2,2,ACGACTTGCCCAAATATGCT,0,522857
araBp,0.3333333333333333,2,2,ACGACCCTATTTGGGTACGG,0,475282
araBp,0.3333333333333333,2,2,ACCTTTCCCCGAAGTTGCAT,0,472728
araBp,0.3333333333333333,2,2,ACCTTCCCGTATACGGCTTG,0,516234
araBp,0.3333333333333333,2,2,ACCTTACTACAATTTTGATC,0,482469
araBp,0.3333333333333333,2,2,ACCTGTAGTAACGCCTCAAT,0,474657
araBp,0.3333333333333333,2,2,ACCTGTACCACTAAGCTTAG,0,473590
araBp,0.3333333333333333,2,2,ACCTAGTGTACAACCGAATT,0,516544
araBp,0.3333333333333333,2,2,ACCGTCCGGGTGCATGGGAT,0,479980
araBp,0.3333333333333333,2,2,ACCGGACCTTGCTCCGCTAA,0,470759
araBp,0.3333333333333333,2,2,ACCGCTGATGGGCGCTTGAA,0,485236
araBp,0.3333333333333333,2,2,ACCGCGGAGCACGTACCAGC,0,499557
araBp,0.3333333333333333,2,2,ACCGCAGCGACGTGCAATCC,0,470599
araBp,0.3333333333333333,2,2,ACCGATTTTGTAACTGTCCC,0,490980
araBp,0.3333333333333333,2,2,ACCCTAAGCGATTTCGGATA,0,522844
araBp,0.3333333333333333,2,2,ACCCCGGCTAGGTCCATTCC,0,490232
araBp,0.3333333333333333,2,2,ACCCATTAGGACGCGTCGCA,0,473196
araBp,0.3333333333333333,2,2,ACCCAAGAGGGCCGCCGAGG,0,516341
araBp,0.3333333333333333,2,2,ACCATACGTTAGGATGTTGA,0,493467
araBp,0.3333333333333333,2,2,ACCAGGATATCTAGGCCAAT,0,520132
araBp,0.3333333333333333,2,2,ACCAGCATGAGATATATTGT,0,497470
araBp,0.3333333333333333,2,2,ACCACTACTCCCGGACTCAC,0,515212
araBp,0.3333333333333333,2,2,ACCAATCTATCATGGATACG,0,486054
araBp,0.3333333333333333,2,2,ACCAAATTAAGTACACCGTA,0,479447
araBp,0.3333333333333333,2,2,ACATGCACTGAGGCCGAAAG,0,469123
araBp,0.3333333333333333,2,2,ACATCTGAAAAGGCCTACAC,0,507586
araBp,0.3333333333333333,2,2,ACATAGGCGCATCCGGATAT,0,498879
araBp,0.3333333333333333,2,2,ACATAGCGCACACCCCGGAC,0,495520
araBp,0.3333333333333333,2,2,ACATAATCGGGCACTCCTAG,0,504853
araBp,0.3333333333333333,2,2,ACATAAGCAGACTTTTTCAG,0,510223
araBp,0.3333333333333333,2,2,ACAGTACCGAAATGCGAAGA,0,481198
araBp,0.3333333333333333,2,2,ACAGGCTTTTAATTTGTCGT,0,471685
araBp,0.3333333333333333,2,2,ACAGCGTGTGAGTAAGTAGA,0,472834
araBp,0.3333333333333333,2,2,ACAGCAGAGACGATGCTCGT,0,505083
araBp,0.3333333333333333,2,2,ACACTACAGGTATGGCCTCA,0,482142
araBp,0.3333333333333333,2,2,ACACTAACACCGGTACTTAC,0,493562
araBp,0.3333333333333333,2,2,ACACGTAGATATGCAGACCA,0,517997
araBp,0.3333333333333333,2,2,ACACGGCGTTGACGTGTCAT,0,508694
araBp,0.3333333333333333,2,2,ACACGGCATAATGTGTCGAA,0,523845
araBp,0.3333333333333333,2,2,ACACGCCTTTGGGGCGATGC,0,523981
araBp,0.3333333333333333,2,2,ACACATGGGAATGCCACCCT,0,524606
araBp,0.3333333333333333,2,2,ACACATCCTCTGACTTCACA,0,474889
araBp,0.3333333333333333,2,2,ACACAAGAACGCTCTCACAG,0,519008
araBp,0.3333333333333333,2,2,ACAATATCCGCTGCCCACTC,0,498366
araBp,0.3333333333333333,2,2,ACAATACCTTTGACCCAACT,0,499338
araBp,0.3333333333333333,2,2,ACAAGTTCGCATCGCAGATT,0,489701
araBp,0.3333333333333333,2,2,ACAACAAAGATTTGTAACCG,0,476068
araBp,0.3333333333333333,2,2,ACAAAATCCTAGGACCACTT,0,505389
araBp,0.3333333333333333,2,2,ACAAAAAGTTTACGCATACC,0,524756
araBp,0.3333333333333333,2,2,AATTTGGTCATCGTAACAGT,0,522993
araBp,0.3333333333333333,2,2,AATTTCAACCTCAAGTCCGT,0,485859
araBp,0.3333333333333333,2,2,AATTGCCATTAGGACAAATT,0,500074
araBp,0.3333333333333333,2,2,AATTGCCAGGTAAATCTTCC,0,472790
araBp,0.3333333333333333,2,2,AATTGACCCTGATATAATTC,0,500569
araBp,0.3333333333333333,2,2,AATTCTTCAACATTTCAACT,0,520373
araBp,0.3333333333333333,2,2,AATTCTGAGGCGACGGTATG,0,491179
araBp,0.3333333333333333,2,2,AATTCGATGGGTCACTGGCA,0,483011
araBp,0.3333333333333333,2,2,AATTCATTAACTTCGTTCTC,0,517571
araBp,0.3333333333333333,2,2,AATTACAATCACGTCCATCC,0,488726
araBp,0.3333333333333333,2,2,AATGCCCCGATAGGAAGTCT,0,495538
araBp,0.3333333333333333,2,2,AATGACGCGAGCATACTCGG,0,499221
araBp,0.3333333333333333,2,2,AATCGTTCTCAGATAAGTCA,0,511223
araBp,0.3333333333333333,2,2,AATCGGGCCATAGTAGTCCC,0,520337
araBp,0.3333333333333333,2,2,AATCCTTCCATGTGTTAGAT,0,505087
araBp,0.3333333333333333,2,2,AATCCGTCCGGTAGGAGCGA,0,521002
araBp,0.3333333333333333,2,2,AATCCAGGGTTCGTAGTCAG,0,486059
araBp,0.3333333333333333,2,2,AATATTTGACAACCTGCTAT,0,523819
araBp,0.3333333333333333,2,2,AATATTTAAACAATATTGAT,0,492205
araBp,0.3333333333333333,2,2,AATATTAATATATATGTTGC,0,485626
araBp,0.3333333333333333,2,2,AATATGGTGGGACTTCGCTT,0,516230
araBp,0.3333333333333333,2,2,AATATGCAAGGGCGCGAACT,0,487165
araBp,0.3333333333333333,2,2,AATAGGGTTATCACCGTGGT,0,507570
araBp,0.3333333333333333,2,2,AATAATTCTGTTCTAGGACT,0,523602
araBp,0.3333333333333333,2,2,AATAATATATGGATATGTCG,0,491251
araBp,0.3333333333333333,2,2,AATAAGCTATTCTCCGGATC,0,518044
araBp,0.3333333333333333,2,2,AATAAGCCTAACAAGCCCAG,0,483534
araBp,0.3333333333333333,2,2,AATAACCCCAGATGGCCGAT,0,468387
araBp,0.3333333333333333,2,2,AAGTTTTTACTTCCACGGGC,0,498211
araBp,0.3333333333333333,2,2,AAGTTGCTCAGCACAATTGA,0,474685
araBp,0.3333333333333333,2,2,AAGTTCTGACTCCTCGCCTA,0,482920
araBp,0.3333333333333333,2,2,AAGTTATGCGCTCCCATCAA,0,473544
araBp,0.3333333333333333,2,2,AAGTGTTCAGAAACTAGACT,0,472812
araBp,0.3333333333333333,2,2,AAGTGCTCCCGAGTGTTTGC,0,486654
araBp,0.3333333333333333,2,2,AAGTAGTATTGCCAGACTCG,0,496057
araBp,0.3333333333333333,2,2,AAGTAGGGCCTTTTCTCGAT,0,485798
araBp,0.3333333333333333,2,2,AAGTAAAACACGGTAAACAG,0,468380
araBp,0.3333333333333333,2,2,AAGGGTGTATCTTTGACGAC,0,475133
araBp,0.3333333333333333,2,2,AAGGCTGCTCTTGGTGTTCT,0,522385
araBp,0.3333333333333333,2,2,AAGGCATCCTGGTCCCAGAG,0,492760
araBp,0.3333333333333333,2,2,AAGGACGAGCGTCGCTTCTC,0,523578
araBp,0.3333333333333333,2,2,AAGGAAATTGTCCCTTTCCG,0,501945
araBp,0.3333333333333333,2,2,AAGCTGAGATTATTTTTTTC,0,512255
araBp,0.3333333333333333,2,2,AAGCCGGGTCGAAGCGAATT,0,479643
araBp,0.3333333333333333,2,2,AAGCCAACTAAATAGATGTT,0,518096
araBp,0.3333333333333333,2,2,AAGCATTAAAGTTTCGACAG,0,515087
araBp,0.3333333333333333,2,2,AAGCAGTGAGATCGAAGTAC,0,487598
araBp,0.3333333333333333,2,2,AAGCAACCCGGAGGATCCAT,0,473684
araBp,0.3333333333333333,2,2,AAGATCTCAAGCGCTACAAT,0,517306
araBp,0.3333333333333333,2,2,AAGATATGAATAAAATGACG,0,519758
araBp,0.3333333333333333,2,2,AAGAGGGTGACGCTTGGAAG,0,514044
araBp,0.3333333333333333,2,2,AAGACCATTGGGGAGTGCTA,0,472070
araBp,0.3333333333333333,2,2,AAGACACAAGCTCGGTAATT,0,479674
araBp,0.3333333333333333,2,2,AACTTTACAAACGTAGTTTG,0,513260
araBp,0.3333333333333333,2,2,AACTTCGTCCTTCGTACTCA,0,476478
araBp,0.3333333333333333,2,2,AACTGGGTATCATTCTAGGG,0,483437
araBp,0.3333333333333333,2,2,AACTCGGTTAGGGCGGGGGT,0,518635
araBp,0.3333333333333333,2,2,AACTACTTCGCTCTCTAAGA,0,514395
araBp,0.3333333333333333,2,2,AACTACTCGGCAGTGGTACA,0,473145
araBp,0.3333333333333333,2,2,AACTACACTGAAAACCTCTC,0,504956
araBp,0.3333333333333333,2,2,AACTAAGCCTACGGGCATTT,0,482182
araBp,0.3333333333333333,2,2,AACGTCTTACCAATGATTAA,0,483079
araBp,0.3333333333333333,2,2,AACGGCTTAGCACTCGCGAT,0,496738
araBp,0.3333333333333333,2,2,AACGGCTAGTGCCCGGGCCA,0,496221
araBp,0.3333333333333333,2,2,AACGGATCTGTTTCTCACTA,0,512096
araBp,0.3333333333333333,2,2,AACGCTGTCTGCCGTCACAC,0,468812
araBp,0.3333333333333333,2,2,AACGAACTTCTGCGTCTTGT,0,472927
araBp,0.3333333333333333,2,2,AACCTGTATTGGCATATATG,0,496054
araBp,0.3333333333333333,2,2,AACCGGGAGGTGGTATTGAG,0,474836
araBp,0.3333333333333333,2,2,AACAGGGTTCATTCAAGCGT,0,506831
araBp,0.3333333333333333,2,2,AACAGGCTGTTTACTTGCTA,0,513891
araBp,0.3333333333333333,2,2,AACAGAAGATCTAGGCCAAC,0,519973
araBp,0.3333333333333333,2,2,AACACTAACGAACTTGAAGC,0,510846
araBp,0.3333333333333333,2,2,AACACGTTGAGTGCTCTGAT,0,480900
araBp,0.3333333333333333,2,2,AACAAACAGCCATCGGGCAT,0,470995
araBp,0.3333333333333333,2,2,AAATTTACCGCAATCATGCA,0,495796
araBp,0.3333333333333333,2,2,AAATCGTGTTAATCGCGTCC,0,481791
araBp,0.3333333333333333,2,2,AAATAGCGTCATTACTGTGA,0,515317
araBp,0.3333333333333333,2,2,AAATACCCACGTCTGGTTGA,0,507502
araBp,0.3333333333333333,2,2,AAAGGTGAACTATAAGGGTT,0,472719
araBp,0.3333333333333333,2,2,AAAGGTCTAGGGTTTCACGA,0,501000
araBp,0.3333333333333333,2,2,AAAGGGTGGTACCCCTACTA,0,508472
araBp,0.3333333333333333,2,2,AAAGGGCATCCCAGCTTCTC,0,478312
araBp,0.3333333333333333,2,2,AAAGGAGGCCTGATAACGCC,0,471111
araBp,0.3333333333333333,2,2,AAAGCCCCAAAGCCCCCGTT,0,500304
araBp,0.3333333333333333,2,2,AAAGCACCGGAGTGAGCAGA,0,494410
araBp,0.3333333333333333,2,2,AAAGCACCATTACCGGCCTG,0,514322
araBp,0.3333333333333333,2,2,AAAGAGGATTGAGGCACCAG,0,474734
araBp,0.3333333333333333,2,2,AAAGAGCAGATGTAACTGTG,0,484002
araBp,0.3333333333333333,2,2,AAACTGTGATGATTTGTAAA,0,511720
araBp,0.3333333333333333,2,2,AAACGTTCCTTACTTTTCGC,0,486783
araBp,0.3333333333333333,2,2,AAACGGGATTTTCATTCGTG,0,488829
araBp,0.3333333333333333,2,2,AAACAGTCTGGATCTCATAT,0,500922
araBp,0.3333333333333333,2,2,AAAATTACGATGTGGCTCCT,0,495505
araBp,0.3333333333333333,2,2,AAAAGTAAATGGATACGGGG,0,475345
araBp,0.3333333333333333,2,2,AAAACGCACGAACGGCATGG,0,470463
araBp,0.5,1,1,TTTTTCTTTAAACTATGGAG,0,478733
araBp,0.5,1,1,TTTTTCGCACCAACTGAATC,0,474287
araBp,0.5,1,1,TTTTTCAATAGTCACCACAC,0,519934
araBp,0.5,1,1,TTTTGTTGGTGTTTGCGAAA,0,501215
araBp,0.5,1,1,TTTTCTAATAAGTCTGAGCT,0,483333
araBp,0.5,1,1,TTTTCGGGAAATGCTCATCC,0,486774
araBp,0.5,1,1,TTTTCGCTCGTGAACCTACT,0,488286
araBp,0.5,1,1,TTTTCGCCGTCTAGTATTTG,0,512911
araBp,0.5,1,1,TTTTATTTAGCTTGGGGCAC,0,494538
araBp,0.5,1,1,TTTGTTTTCTCGGGTACACT,0,508863
araBp,0.5,1,1,TTTGTTTTATAGATCCCTTG,0,502235
araBp,0.5,1,1,TTTGTTAATCGTGGTCCGTT,0,497489
araBp,0.5,1,1,TTTGTCGTTGGTGAAACATG,0,509013
araBp,0.5,1,1,TTTGGTAGGCAGTAAACTAT,0,482588
araBp,0.5,1,1,TTTGGGAAGGATTGTGAGAT,0,516786
araBp,0.5,1,1,TTTGGAGCGGAACAATGTGA,0,500184
araBp,0.5,1,1,TTTGCTTGCCCTCAGAGGGA,0,479264
araBp,0.5,1,1,TTTGCTGGATTCGTGCTCGG,0,507068
araBp,0.5,1,1,TTTGCGTTCAAATGCGTGTC,0,514934
araBp,0.5,1,1,TTTGCGTCCTTTGGGGCGGG,0,513047
araBp,0.5,1,1,TTTGCAACTAATTTAACCAT,0,491049
araBp,0.5,1,1,TTTCTTGGGAGGGATGTGGA,0,519330
araBp,0.5,1,1,TTTCTGGAGATAATGGTAGG,0,516030
araBp,0.5,1,1,TTTCTGGACCACGATTACGT,0,493816
araBp,0.5,1,1,TTTCGGGTCTATCGCGTACG,0,468944
araBp,0.5,1,1,TTTCGCGTAATTCGCAGCTA,0,505711
araBp,0.5,1,1,TTTCGCGAAGTATGTCCGTT,0,519349
araBp,0.5,1,1,TTTCGCCTACCGTAGTCGGT,0,505697
araBp,0.5,1,1,TTTCGATGCTAAGAGGAGGG,0,507951
araBp,0.5,1,1,TTTCCTTTCCCAGTCTTTCA,0,476542
araBp,0.5,1,1,TTTCAGTTACTCCATACAAG,0,510368
araBp,0.5,1,1,TTTCAGGCGTTTCTCATGAG,0,486775
araBp,0.5,1,1,TTTCACGTAATAGGAACCTC,0,478606
araBp,0.5,1,1,TTTATCGCAGCATATGATAT,0,470406
araBp,0.5,1,1,TTTATCAGGTCCCAAGACCA,0,512878
araBp,0.5,1,1,TTTAGGTTGCCTAGGTTATA,0,480971
araBp,0.5,1,1,TTTACTATGACGCCCGCGAT,0,523344
araBp,0.5,1,1,TTTAATTTATCAAGAAGATT,0,516728
araBp,0.5,1,1,TTTAATGACTTTCTTCATAC,0,486132
araBp,0.5,1,1,TTTAATCAGCAATAGTTATG,0,483340
araBp,0.5,1,1,TTGTTCGCAGCCTGACTAAA,0,486496
araBp,0.5,1,1,TTGTGAATACCCGTAAGTGG,0,506152
araBp,0.5,1,1,TTGTCTACTCTGTGCGCTTT,0,485082
araBp,0.5,1,1,TTGTCACGGAGCGTTTCCGC,0,490385
araBp,0.5,1,1,TTGTATCTTCCGTACAATAA,0,520852
araBp,0.5,1,1,TTGGTTCCAACAACCATCAT,0,512771
araBp,0.5,1,1,TTGGTGACGGGCGCCGACGA,0,475326
araBp,0.5,1,1,TTGGTACATCTGATGGACAT,0,501265
araBp,0.5,1,1,TTGGGGGAGAAAATACTAGG,0,491781
araBp,0.5,1,1,TTGGGCTGGCGAAATTAAGT,0,508869
araBp,0.5,1,1,TTGGGCGGATTGGTATACAG,0,468086
araBp,0.5,1,1,TTGGGCATAGCTGGTAGCTA,0,497833
araBp,0.5,1,1,TTGGCTTAAACTTTTCCTTG,0,514442
araBp,0.5,1,1,TTGGCGAAATATGACACCAA,0,492255
araBp,0.5,1,1,TTGGCCTTTTCGCTTAAGTC,0,523281
araBp,0.5,1,1,TTGGCATGACAAAATACTAT,0,480429
araBp,0.5,1,1,TTGGAGGGGAGCTTTACTTT,0,495429
araBp,0.5,1,1,TTGGAAAAAAAACAACTCAG,0,478864
araBp,0.5,1,1,TTGCTGCCGGATCTAGACCC,0,511060
araBp,0.5,1,1,TTGCCGAGGCCTAGCGACAC,0,495518
araBp,0.5,1,1,TTGCATAGTTGTTTCCTCGG,0,475386
araBp,0.5,1,1,TTGCATAGATATGGGATATT,0,478015
araBp,0.5,1,1,TTGCACCCCAAGAGCGTTAT,0,482860
araBp,0.5,1,1,TTGCAACCTGAAAAAGCGTA,0,509639
araBp,0.5,1,1,TTGATTAAAACACTCGGAAA,0,508725
araBp,0.5,1,1,TTGATGCCGGACAATTCGCG,0,506851
araBp,0.5,1,1,TTGATCTTTCGGTGGGTTGT,0,479957
araBp,0.5,1,1,TTGATAAGGCGAACGAGTAT,0,516511
araBp,0.5,1,1,TTGAGTGGGATACAAGTTAT,0,510692
araBp,0.5,1,1,TTGAGTGACCATCCAACTGG,0,516755
araBp,0.5,1,1,TTGACTGCCTGTTGGACTCG,0,498643
araBp,0.5,1,1,TTGACCCACAGCTAAAGGAG,0,468531
araBp,0.5,1,1,TTCTTTTGATTGCTGGGAGG,0,500141
araBp,0.5,1,1,TTCTTTGGTCTCATCTGGCT,0,522056
araBp,0.5,1,1,TTCTTACCGTGGTAGCAGCC,0,515367
araBp,0.5,1,1,TTCTGTCGGTCGTCTTGTAG,0,487914
araBp,0.5,1,1,TTCTGGTAGGACCTGGGTAG,0,472216
araBp,0.5,1,1,TTCTGCTCTCCAGTACGAAT,0,497432
araBp,0.5,1,1,TTCTCTGAATCCGGATGGCG,0,520134
araBp,0.5,1,1,TTCTCGACATGCAGAGGCGG,0,500108
araBp,0.5,1,1,TTCTATTAGACAGGCTCTCC,0,502942
araBp,0.5,1,1,TTCTATCAAAGCGGCCCGAC,0,468231
araBp,0.5,1,1,TTCTAGGAACAAAGTGCCTA,0,493425
araBp,0.5,1,1,TTCTACGGACCATGTCTGGC,0,475923
araBp,0.5,1,1,TTCGTTACTAGGTCATAGAC,0,511001
araBp,0.5,1,1,TTCGGGTAGGGCTTTCTTTG,0,518761
araBp,0.5,1,1,TTCGCTAGTAGTTACTGGGA,0,491698
araBp,0.5,1,1,TTCGCAGTCGCAAATATATG,0,471548
araBp,0.5,1,1,TTCGATTCTTGTATTGCAGT,0,476054
araBp,0.5,1,1,TTCGACTTTCCCCGGTACGC,0,520635
araBp,0.5,1,1,TTCCTTCAATAGAAAGCCGC,0,490599
araBp,0.5,1,1,TTCCGGATCTTGGTCTTGTC,0,504989
araBp,0.5,1,1,TTCCAGAGTGGTAAGGGTCG,0,512460
araBp,0.5,1,1,TTCATATACTACTCCAAAGT,0,499714
araBp,0.5,1,1,TTCATAGGTTCGGTCCGCGG,0,496229
araBp,0.5,1,1,TTCAGTAGCATTCCCGCTAG,0,502930
araBp,0.5,1,1,TTCAGCTAGGTCTTTATTAA,0,523872
araBp,0.5,1,1,TTCACGTGCACAAGCGCTAA,0,496939
araBp,0.5,1,1,TTCAATGGTTGTCCATTCAT,0,490564
araBp,0.5,1,1,TTATTGGATTAGATGACATG,0,478141
araBp,0.5,1,1,TTATTCGACCGGTCGCCGAA,0,488165
araBp,0.5,1,1,TTATGTGGTCTGGAGTATGA,0,472843
araBp,0.5,1,1,TTATGATGACGACTGATTAA,0,514035
araBp,0.5,1,1,TTATCTCAAATCGGCGTACT,0,491377
araBp,0.5,1,1,TTATCACAGTTTAGAACGAA,0,475738
araBp,0.5,1,1,TTATATGCCGGGAAGGTCAT,0,494631
araBp,0.5,1,1,TTATACGATCCCAATACGAA,0,524094
araBp,0.5,1,1,TTATAATGGGCCTTTTACAA,0,490982
araBp,0.5,1,1,TTAGTCTGTAATCCATTCTG,0,519215
araBp,0.5,1,1,TTAGTCCTCACTAATAATTT,0,506364
araBp,0.5,1,1,TTAGGGTTATGAATCCGGTG,0,507498
araBp,0.5,1,1,TTAGGCCAGTGCCGATCGCC,0,490754
araBp,0.5,1,1,TTAGGAAGAATGCTCTGCCC,0,474177
araBp,0.5,1,1,TTAGCTGGGTGGGTAACGGT,0,484634
araBp,0.5,1,1,TTAGCAATGAATAAGTCTGA,0,493180
araBp,0.5,1,1,TTAGATCAGCCAATCGGACC,0,490244
araBp,0.5,1,1,TTAGATAAACCTTGCTTCGA,0,474586
araBp,0.5,1,1,TTACGCGGATTTACGTCCTT,0,481975
araBp,0.5,1,1,TTACGCAGCGTCCTGGGACC,0,484286
araBp,0.5,1,1,TTACGAGTGTGTGTATGAAT,0,505485
araBp,0.5,1,1,TTACCGCGGTTAATCGCCGG,0,478289
araBp,0.5,1,1,TTACCAGTGGCTCCGATGCT,0,520951
araBp,0.5,1,1,TTACAGCGTGAGCCTAGAGG,0,497152
araBp,0.5,1,1,TTACAAAAGAAGATTCAGGC,0,517567
araBp,0.5,1,1,TTAATTGACAGCATCATTAA,0,477930
araBp,0.5,1,1,TTAATTCACTTAAGTTTATA,0,470990
araBp,0.5,1,1,TTAATTAAGAGCGGCCCACA,0,509307
araBp,0.5,1,1,TTAACTCGTAGCCCCATTGG,0,511175
araBp,0.5,1,1,TTAACTACGTTAAAACTGGC,0,514366
araBp,0.5,1,1,TTAAAGGTGACATATAATTG,0,477210
araBp,0.5,1,1,TTAAAGATGGGTTTTGAACA,0,486852
araBp,0.5,1,1,TTAAACCTCACATGTTCTTC,0,474236
araBp,0.5,1,1,TGTTTGGCAAGATGATTAGT,0,520209
araBp,0.5,1,1,TGTTTGCTCTCGGGAAGAAA,0,481284
araBp,0.5,1,1,TGTTTATGACTTCCTAGGCA,0,488174
araBp,0.5,1,1,TGTTGGTGGCGTCATATTCG,0,509975
araBp,0.5,1,1,TGTTGAAAGTAGTGAAGGGA,0,513535
araBp,0.5,1,1,TGTTCGTAACTCTTCTACCA,0,505088
araBp,0.5,1,1,TGTTCGGGACCGACGAGATG,0,492933
araBp,0.5,1,1,TGTTCATCGGCTCTGATGCG,0,501092
araBp,0.5,1,1,TGTTAGCCTAACACGGCATG,0,491709
araBp,0.5,1,1,TGTTAATACCAGCACGGCTC,0,498592
araBp,0.5,1,1,TGTGTTGGGTGATCCTCTTC,0,496445
araBp,0.5,1,1,TGTGGGCATAAGCCCGATGA,0,516606
araBp,0.5,1,1,TGTGGCTTTTGCATTCAACT,0,515895
araBp,0.5,1,1,TGTGCTGGATTCTGACGCAT,0,486055
araBp,0.5,1,1,TGTGCAGAAGTAGTGGAAGT,0,487194
araBp,0.5,1,1,TGTGATTGGGCGATCTGCCT,0,476520
araBp,0.5,1,1,TGTGATATCCCGTCAAACTG,0,504373
araBp,0.5,1,1,TGTGAGGATGCTGGCGCGCG,0,516898
araBp,0.5,1,1,TGTGACGCGACTTTACGTCA,0,498406
araBp,0.5,1,1,TGTGAATGCGGCATCAAGAT,0,474856
araBp,0.5,1,1,TGTGAATGAGAGCGGAGCCC,0,473975
araBp,0.5,1,1,TGTGAACCGTGGGCCGTCGC,0,478119
araBp,0.5,1,1,TGTCTTCCGGCTTATAAGTG,0,520476
araBp,0.5,1,1,TGTCGCTGACTCTCCGCCTT,0,491976
araBp,0.5,1,1,TGTCGCCTAATTGTAAAACA,0,514738
araBp,0.5,1,1,TGTCGAACGCTAACACGACA,0,476536
araBp,0.5,1,1,TGTCCGCGTCCTACGCTCTT,0,513637
araBp,0.5,1,1,TGTCACTTTGCGTCGCCTCC,0,474774
araBp,0.5,1,1,TGTCACGGTACCTATACTGC,0,489408
araBp,0.5,1,1,TGTCAAGGGGTCGCCGTCAT,0,469277
araBp,0.5,1,1,TGTAGGCTGCATAGAACTTC,0,491349
araBp,0.5,1,1,TGTACGATGGAATTTATTTT,0,494208
araBp,0.5,1,1,TGTACAAGGGAAGCCTACAG,0,472050
araBp,0.5,1,1,TGTAATTTCTGTATAGACAG,0,475041
araBp,0.5,1,1,TGTAATAGCGAGTTTGAATT,0,480349
araBp,0.5,1,1,TGTAACCCCGGGTTACGATA,0,499148
araBp,0.5,1,1,TGGTTGTGTTAATGGCTCAC,0,475102
araBp,0.5,1,1,TGGTTGCGTCCGATATTAGG,0,469467
araBp,0.5,1,1,TGGTTCTCAAGATACTCTTG,0,509946
araBp,0.5,1,1,TGGTTACGTAAAAGTGCACA,0,492892
araBp,0.5,1,1,TGGTTACAGGGAGGTTTGTG,0,482840
araBp,0.5,1,1,TGGTCTATTAGGGGGGGGTA,0,510371
araBp,0.5,1,1,TGGTCATTAATCCTCGATCA,0,524497
araBp,0.5,1,1,TGGTCAATTTGAAAAGGCGC,0,519967
araBp,0.5,1,1,TGGTACCTTTCTACTGAAAG,0,511844
araBp,0.5,1,1,TGGTACCGTAAATCGCGAAA,0,483975
araBp,0.5,1,1,TGGGTTAATGGCAGCACCTC,0,492641
araBp,0.5,1,1,TGGGTCGCAATCAGTAAGGA,0,504672
araBp,0.5,1,1,TGGGTAGGCTCCTAAGGGCA,0,512696
araBp,0.5,1,1,TGGGGGACTCTCATGAATAT,0,504118
araBp,0.5,1,1,TGGGGCCGGGAGCAGTCCCT,0,497842
araBp,0.5,1,1,TGGGCTTGCCGTAGGCAAAC,0,525331
araBp,0.5,1,1,TGGGCTTAACCACGGGGTTA,0,484590
araBp,0.5,1,1,TGGGCAAGTATGATCTGGTG,0,476466
araBp,0.5,1,1,TGGGATATGAATGTCACAAA,0,508061
araBp,0.5,1,1,TGGGACTGACCCTGTCGTAC,0,481330
araBp,0.5,1,1,TGGCTTCATTAAGCGTATCC,0,505661
araBp,0.5,1,1,TGGCTCCAATGCAGCTCGCT,0,514348
araBp,0.5,1,1,TGGCGGCATCGAGGAGCTGA,0,510050
araBp,0.5,1,1,TGGCGCGGGGACAGATCTTA,0,500166
araBp,0.5,1,1,TGGCCTAAATAACAAGATTA,0,473836
araBp,0.5,1,1,TGGCCCAGATGCACGTTCTT,0,470310
araBp,0.5,1,1,TGGATTGGGCTGTATCTGGT,0,484060
araBp,0.5,1,1,TGGATTGCGTATCCAAGGTT,0,469582
araBp,0.5,1,1,TGGATGTGCTTTGGGAAAAT,0,487706
araBp,0.5,1,1,TGGATCGTATGTCGTGTACG,0,486540
araBp,0.5,1,1,TGGAGGGTTGCTGATCTTTG,0,523239
araBp,0.5,1,1,TGGAGCCGTCCGCTCTTATA,0,469747
araBp,0.5,1,1,TGGAGCATACACTTCCGAGT,0,474493
araBp,0.5,1,1,TGGAGAGAGACCACGTGTTA,0,510366
araBp,0.5,1,1,TGGACTAAACGATGACATCC,0,494648
araBp,0.5,1,1,TGGACGCTATTCCCTCATTA,0,503989
araBp,0.5,1,1,TGGACCGCACCGCCGTGGCT,0,469746
araBp,0.5,1,1,TGGAATAGTTGTAATCCACG,0,481698
araBp,0.5,1,1,TGGAAGGAATTTTTGATTAC,0,491223
araBp,0.5,1,1,TGGAAGAGCCGTGTTCTGAA,0,521635
araBp,0.5,1,1,TGCTTCAAGGACCCAGTACC,0,500867
araBp,0.5,1,1,TGCTTATAATGGGATACGGC,0,496056
araBp,0.5,1,1,TGCTTAAACTGGCCCTGAAG,0,491928
araBp,0.5,1,1,TGCTGGCAAATCGAATGAGG,0,473960
araBp,0.5,1,1,TGCTAGACATTAGCAGGAGG,0,484723
araBp,0.5,1,1,TGCGGTCCCCATGTACCAAG,0,518446
araBp,0.5,1,1,TGCGGGAACTGTATCTGTTA,0,474275
araBp,0.5,1,1,TGCGCGAGTCTTGTTATGAG,0,473843
araBp,0.5,1,1,TGCGCGAATGTCCATGTTCG,0,473477
araBp,0.5,1,1,TGCGCCGTCCCCAGGATTAC,0,503480
araBp,0.5,1,1,TGCGATGGACACTGGTCCCG,0,520440
araBp,0.5,1,1,TGCGATCGTTTAAAAGTCGG,0,509570
araBp,0.5,1,1,TGCCTATAGACCTCTTTATT,0,524289
araBp,0.5,1,1,TGCCGGGAACCGACCTCCTC,0,505724
araBp,0.5,1,1,TGCCGCCGAGTTCGGTCTCT,0,497759
araBp,0.5,1,1,TGCCCGTCTGATAAACGGTG,0,514177
araBp,0.5,1,1,TGCCCCAGTTATTAAGTCCT,0,488990
araBp,0.5,1,1,TGCCATCCGAAAGTAGAGTC,0,489485
araBp,0.5,1,1,TGCCACTTCCACTCGTCCTA,0,476582
araBp,0.5,1,1,TGCCAAAAGTTACTAAGGTG,0,474322
araBp,0.5,1,1,TGCATTCTTTATTATCTGTA,0,502754
araBp,0.5,1,1,TGCATTACCAGTTGTTCATT,0,488066
araBp,0.5,1,1,TGCAGTTGGGATGCTCCGGA,0,500533
araBp,0.5,1,1,TGCAGTGGTGCGCTAAAGGA,0,520757
araBp,0.5,1,1,TGCAGCTCGTTGCGAAGCAG,0,516411
araBp,0.5,1,1,TGCAGCGGCATGAAGCCTCT,0,514114
araBp,0.5,1,1,TGCAGAATACACCGCTATGT,0,473115
araBp,0.5,1,1,TGCACTGCTTATTGCTTCCA,0,508999
araBp,0.5,1,1,TGCACATCTTCGTGAAGAAC,0,499808
araBp,0.5,1,1,TGCAACAGGTATTCACACCC,0,522632
araBp,0.5,1,1,TGCAAAGTCATTAGTAGTTC,0,476421
araBp,0.5,1,1,TGCAAAGAGCGGGCCGAATA,0,498434
araBp,0.5,1,1,TGATTTGTATTGCCTTTACA,0,472986
araBp,0.5,1,1,TGATTTGCTTTGCTGATTTC,0,486843
araBp,0.5,1,1,TGATGGCCTGCACGACAGGC,0,515395
araBp,0.5,1,1,TGATCTGATGGTGATGACCG,0,505705
araBp,0.5,1,1,TGATCGTTGCACATCCCTGG,0,516702
araBp,0.5,1,1,TGATAATTTACATTTAAGAG,0,518184
araBp,0.5,1,1,TGAGTCTCATAAGGCCGATT,0,511407
araBp,0.5,1,1,TGAGGGCATGAGCGGCACCT,0,497526
araBp,0.5,1,1,TGAGGCCCGAACTGTAGGTA,0,523467
araBp,0.5,1,1,TGAGCTTGTATGGCCTCATC,0,498623
araBp,0.5,1,1,TGAGCTGAACCATACGTGTA,0,487766
araBp,0.5,1,1,TGAGCGTGGTCCGAAGTCGG,0,507072
araBp,0.5,1,1,TGAGCAAGTCCATGAGTGAG,0,493484
araBp,0.5,1,1,TGAGAACTTATGTCCCTTGT,0,511512
araBp,0.5,1,1,TGACTTCAAGATTCCCCACA,0,491180
araBp,0.5,1,1,TGACTGTGGCACGCCCGACC,0,499635
araBp,0.5,1,1,TGACGTTAGTCTTTCCAGGT,0,472194
araBp,0.5,1,1,TGACGAGAGGCGAATACAGT,0,469263
araBp,0.5,1,1,TGACCTCAGTGTTGACACCT,0,470970
araBp,0.5,1,1,TGACCGGAGTCACTGAACGC,0,506033
araBp,0.5,1,1,TGACAGAGTGCGCACGTGCT,0,492981
araBp,0.5,1,1,TGACACGCATATTACTGAAG,0,472464
araBp,0.5,1,1,TGACAACACTCCTGTCAACA,0,482058
araBp,0.5,1,1,TGAATCTTAGCAGTGCACAT,0,502534
araBp,0.5,1,1,TGAATCTGTAGCGGTGCAGA,0,510192
araBp,0.5,1,1,TGAATCGGTTAGTTACATTT,0,512600
araBp,0.5,1,1,TGAATCGACGGTTGCCGGTC,0,505576
araBp,0.5,1,1,TGAAGGAACGTTGGCTGCTC,0,492701
araBp,0.5,1,1,TGAAGAATTAAGAACTTCCA,0,511988
araBp,0.5,1,1,TGAACGCGATGAAGGTTCCA,0,478678
araBp,0.5,1,1,TGAAATATTGAGCGTACACA,0,499457
araBp,0.5,1,1,TGAAAGGTTGCACATGGACG,0,507719
araBp,0.5,1,1,TGAAAGGTCGGTAGATATTG,0,474921
araBp,0.5,1,1,TGAAACCTGACAAGAGTAGT,0,505676
araBp,0.5,1,1,TCTTTGTCAGGTACCCCTCT,0,496989
araBp,0.5,1,1,TCTTTAAAGAAAGGAGTGGC,0,485021
araBp,0.5,1,1,TCTTGGCACTCTAGGTTCCT,0,493742
araBp,0.5,1,1,TCTTGAGTTAACTAGGCGCC,0,505617
araBp,0.5,1,1,TCTTCACATCGGTCTAACAT,0,478384
araBp,0.5,1,1,TCTTATAGGACAGCCTTACA,0,511895
araBp,0.5,1,1,TCTTAGGGGCTTATCCCGAA,0,518910
araBp,0.5,1,1,TCTGTTGTATCGATAGGCTC,0,512722
araBp,0.5,1,1,TCTGTTAGGATCGACAGGAC,0,500630
araBp,0.5,1,1,TCTGTCACTGGGGGGAGGCC,0,471195
araBp,0.5,1,1,TCTGTAGCTAGGACAAGGTC,0,487130
araBp,0.5,1,1,TCTGTAAGCTGAGCCCGATG,0,479985
araBp,0.5,1,1,TCTGGTAGATTCTTCTATCT,0,470064
araBp,0.5,1,1,TCTGGCATTACTGTGGGAGA,0,521100
araBp,0.5,1,1,TCTGCCAGCTCGGATCGGGT,0,483683
araBp,0.5,1,1,TCTGCAGCGATTTTCCTGAG,0,525288
araBp,0.5,1,1,TCTGACAAGTGTACGAGGAT,0,473570
araBp,0.5,1,1,TCTCTCCGCTCCGTCACGAG,0,510770
araBp,0.5,1,1,TCTCGGAAAGCAGGATTATA,0,508513
araBp,0.5,1,1,TCTCCGGTTTAACCTGTGGA,0,478523
araBp,0.5,1,1,TCTCCGGTACGAGGGAATCT,0,495900
araBp,0.5,1,1,TCTCAGAAAGGAACTTGGCC,0,480550
araBp,0.5,1,1,TCTCAATAAGGCGAAGCCTA,0,481293
araBp,0.5,1,1,TCTATATGTTGCTAGACGCA,0,500079
araBp,0.5,1,1,TCTAGTACGTTTTGACCCAC,0,470250
araBp,0.5,1,1,TCTAGACAAACGGCGGCCCT,0,520664
araBp,0.5,1,1,TCTAGAATGTTATTGTAAGT,0,495730
araBp,0.5,1,1,TCTAATACGCCATCTATGTC,0,494168
araBp,0.5,1,1,TCGTTTGTAAGTCCTTGCGT,0,478196
araBp,0.5,1,1,TCGTTGAGTGTTTAGGGGAA,0,513608
araBp,0.5,1,1,TCGTTCCTCTGGGCTACAAC,0,517426
araBp,0.5,1,1,TCGTTAGTTTTTTTTCAACA,0,517300
araBp,0.5,1,1,TCGTGTTATAAGTACTCGAC,0,507231
araBp,0.5,1,1,TCGTGGACCGTATTTGGGTT,0,520339
araBp,0.5,1,1,TCGTGATAGATAATCAAGGG,0,484868
araBp,0.5,1,1,TCGTGAAATTGCTGTGTAAA,0,492950
araBp,0.5,1,1,TCGTCAAGTCATGGAAATGT,0,498578
araBp,0.5,1,1,TCGGTTCTTTCGAGAGTTCC,0,496005
araBp,0.5,1,1,TCGGTTCGAGATGAGGAACT,0,489077
araBp,0.5,1,1,TCGGGTGCTTTATTTGAATG,0,506519
araBp,0.5,1,1,TCGGGGTCTGCGACGAGGAA,0,514554
araBp,0.5,1,1,TCGGGGGGACGCTGAGCGTT,0,483227
araBp,0.5,1,1,TCGGCTAGCATAACTCCGGT,0,473539
araBp,0.5,1,1,TCGGCGACTCAGGCCCACCT,0,511981
araBp,0.5,1,1,TCGGCATTGGCTTCTCGAAC,0,522571
araBp,0.5,1,1,TCGGCATACCCTATATTCTG,0,476746
araBp,0.5,1,1,TCGGCAGGGGAGAATCCCGA,0,515618
araBp,0.5,1,1,TCGGATGAGTGGACGAGTCG,0,505024
araBp,0.5,1,1,TCGGATGACCTTAGGTGGTA,0,515060
araBp,0.5,1,1,TCGGAGGCACATAGCTTAGA,0,472964
araBp,0.5,1,1,TCGGACGGTATTTAGCCTGG,0,508919
araBp,0.5,1,1,TCGGAACCTTATTACCAGCC,0,509288
araBp,0.5,1,1,TCGCTTTAGGTGCGAGCTTA,0,467863
araBp,0.5,1,1,TCGCTTCTAGCGATAGGGTT,0,474931
araBp,0.5,1,1,TCGCTTCAAAGGATGGCAGG,0,489955
araBp,0.5,1,1,TCGCTGCGCTACGGAAACGT,0,495441
araBp,0.5,1,1,TCGCTCCTACTGGAAGAAAG,0,486486
araBp,0.5,1,1,TCGCTCACGGTATTGAATTC,0,522847
araBp,0.5,1,1,TCGCGGATATGGGTATAAGC,0,518060
araBp,0.5,1,1,TCGCCGTCACTAAGAATTTT,0,512597
araBp,0.5,1,1,TCGCCGAGTTGCGGGTTGGT,0,499574
araBp,0.5,1,1,TCGCCCGCCAAGTTCGGTCC,0,471551
araBp,0.5,1,1,TCGCAAAGCCGCATCTCAAT,0,474160
araBp,0.5,1,1,TCGATTTGGTTCATCGGTAG,0,478065
araBp,0.5,1,1,TCGATTACTTAACGGCAGTT,0,475819
araBp,0.5,1,1,TCGATGCTTGGCACCGCACG,0,476709
araBp,0.5,1,1,TCGATGATTGAATAGTGTTC,0,498914
araBp,0.5,1,1,TCGATGAGTCCAATTTGCAT,0,522012
araBp,0.5,1,1,TCGAGTTTTTGCCGAAGATA,0,473404
araBp,0.5,1,1,TCGACGTCTATGTCCTCCTT,0,480619
araBp,0.5,1,1,TCGACGCTATCACATGGAGC,0,501710
araBp,0.5,1,1,TCGACCCGAGCTTTATCGTG,0,467924
araBp,0.5,1,1,TCGACCATGGTATCAGTTCC,0,498842
araBp,0.5,1,1,TCGACATTTGAGACTTGGTA,0,502050
araBp,0.5,1,1,TCGACATTGAAGGATTTTAC,0,492153
araBp,0.5,1,1,TCGACATCGTGCAGCACGCC,0,506765
araBp,0.5,1,1,TCGAAGACGCCGTTTGCATT,0,508606
araBp,0.5,1,1,TCGAAAAGTACACGTTCGAT,0,475186
araBp,0.5,1,1,TCCTGTCTATAATCTACGCG,0,506944
araBp,0.5,1,1,TCCGTTCCCCGGCGTTGCGA,0,523257
araBp,0.5,1,1,TCCGTACGTCGGAGGGTATG,0,488782
araBp,0.5,1,1,TCCGCGGGTCGCAGACGGCC,0,505085
araBp,0.5,1,1,TCCGCATGGTGACTTAGGTC,0,493251
araBp,0.5,1,1,TCCGACTTGTTCACTTCTAC,0,515331
araBp,0.5,1,1,TCCGACAACCAACTTGACCA,0,496584
araBp,0.5,1,1,TCCCTTTCGAATGGCTCCCC,0,493905
araBp,0.5,1,1,TCCCTTCTGCTTTGAAATTA,0,519882
araBp,0.5,1,1,TCCCTGACTACATTGCGCTG,0,486930
araBp,0.5,1,1,TCCCATCTAAGGTCGGGCAA,0,517699
araBp,0.5,1,1,TCCCAATGCGCACTGCAATC,0,524523
araBp,0.5,1,1,TCCCAACAGTGCACCGACTT,0,493333
araBp,0.5,1,1,TCCATTCTTATCTTTGCCAA,0,501697
araBp,0.5,1,1,TCCATTCATAGAGCGCGCGG,0,505791
araBp,0.5,1,1,TCCATCCGCCCTAATCCACG,0,496341
araBp,0.5,1,1,TCCATCAAACTCTCGCAATT,0,524336
araBp,0.5,1,1,TCCATAATAGTGAGTGGCAG,0,492149
araBp,0.5,1,1,TCCAGCGCGCAAAGTATCGG,0,470386
araBp,0.5,1,1,TCCACGTCGATAAGACAGAC,0,483761
araBp,0.5,1,1,TCATTTAGCGTACCGGCACA,0,497203
araBp,0.5,1,1,TCATTATTGCACGGCAGTCA,0,478698
araBp,0.5,1,1,TCATGGGCACCGAACAATCA,0,490279
araBp,0.5,1,1,TCATCGAACATTAGGACGGT,0,484657
araBp,0.5,1,1,TCATCCTTCGTTCATTCATC,0,492104
araBp,0.5,1,1,TCATAGTTGGCCGACGCCAT,0,468948
araBp,0.5,1,1,TCAGTGGTGGGCCGATTCAC,0,470155
araBp,0.5,1,1,TCAGTGCCTGTGGAACAGCC,0,515059
araBp,0.5,1,1,TCAGTCCCCCGTGGCTAGGT,0,507040
araBp,0.5,1,1,TCAGTCCAGTGTGTGTGTTT,0,482646
araBp,0.5,1,1,TCAGTAAAATCATCAAGGCC,0,475228
araBp,0.5,1,1,TCAGGTCTTGTCTGAATGGA,0,524318
araBp,0.5,1,1,TCAGCAAGTATGTGAACAGT,0,473679
araBp,0.5,1,1,TCAGACCCCGGTAATGGCCA,0,491978
araBp,0.5,1,1,TCAGAATTCATGTGGGCCCA,0,505099
araBp,0.5,1,1,TCAGAATGTCCACAGCAAAG,0,511271
araBp,0.5,1,1,TCACTGGGTCCATGTTAGGA,0,470661
araBp,0.5,1,1,TCACGCTATCCTATACTCTT,0,506083
araBp,0.5,1,1,TCACCTCAGAGGCGTAGATA,0,510059
araBp,0.5,1,1,TCACCGCTGACAAATTGTTT,0,494176
araBp,0.5,1,1,TCACCGCTCTCCATACTCGC,0,490225
araBp,0.5,1,1,TCACCCAGCTCATGAGCTAT,0,468142
araBp,0.5,1,1,TCACAGGCCGCATCTACAGA,0,497546
araBp,0.5,1,1,TCAATTGATCTCCCATCCAA,0,470374
araBp,0.5,1,1,TCAAGGCAAGTCCGAACCAT,0,471738
araBp,0.5,1,1,TCAAGCCGTTGTCCACCCGC,0,508918
araBp,0.5,1,1,TCAACACAAGAGTGGTGAAA,0,478023
araBp,0.5,1,1,TCAAAGGCCCGACCGAGGGA,0,492126
araBp,0.5,1,1,TCAAACGAGACCAACGTTGA,0,520747
araBp,0.5,1,1,TATTGTATGCCCGACGAATA,0,511452
araBp,0.5,1,1,TATTGCAAATTTTCTCTCGC,0,471761
araBp,0.5,1,1,TATTCGGTGCGTTTGTAGCG,0,511565
araBp,0.5,1,1,TATTCGGGCTCTATACAGGG,0,510827
araBp,0.5,1,1,TATTCCGTTGTTTTGAGTGG,0,514531
araBp,0.5,1,1,TATTAGTCATCGGGTGTGCC,0,502398
araBp,0.5,1,1,TATTAACCCCGCCGATTGAA,0,469320
araBp,0.5,1,1,TATGTTCCTAGATGTTCTTT,0,499228
araBp,0.5,1,1,TATGTGCGCCCTAATCGGTT,0,484014
araBp,0.5,1,1,TATGTGATACATCCATACTA,0,476498
araBp,0.5,1,1,TATGTATTCAAAAATGAAGG,0,483389
araBp,0.5,1,1,TATGGGTTGCTAAGGATAAA,0,476287
araBp,0.5,1,1,TATGGGTCGTGCTACAGGTC,0,504468
araBp,0.5,1,1,TATGGCTTCATAGACGGCAG,0,485421
araBp,0.5,1,1,TATGCTAAACATGGTTTGGG,0,520399
araBp,0.5,1,1,TATCTTGCTACAGAAAGATT,0,487246
araBp,0.5,1,1,TATCTTAGATAAAAGGGTCT,0,491175
araBp,0.5,1,1,TATCTGCGTGCTAGAGAACG,0,510022
araBp,0.5,1,1,TATCTGCACTCAAGCCTGTT,0,524640
araBp,0.5,1,1,TATCTGAATGTTGGGGGGTA,0,473760
araBp,0.5,1,1,TATCTCGGACCGGCGCCCAT,0,469411
araBp,0.5,1,1,TATCCCGCTAGCATCAAGGG,0,525464
araBp,0.5,1,1,TATCACCAAGCATAAGGTCT,0,519499
araBp,0.5,1,1,TATATATAGCCGTACAGCGG,0,478461
araBp,0.5,1,1,TATAGTCTGTTCCGTATGTA,0,521569
araBp,0.5,1,1,TATAGCGACATCCTTCAGAA,0,482595
araBp,0.5,1,1,TAGTCGTTGTCAGCAGGAGT,0,486133
araBp,0.5,1,1,TAGTCAACGAGAGTTCGAGC,0,504669
araBp,0.5,1,1,TAGGTAAAGCTTCTGGTAGA,0,513970
araBp,0.5,1,1,TAGGGTATGGGCGCCGAGTA,0,469844
araBp,0.5,1,1,TAGGGTAGGAGCCGCGGTTA,0,484451
araBp,0.5,1,1,TAGGGGGGTGTTTTTCTCGT,0,500442
araBp,0.5,1,1,TAGGCCCAGTGTGTAACCCT,0,508473
araBp,0.5,1,1,TAGGCAGCCAGGCGCTGACG,0,503376
araBp,0.5,1,1,TAGGAGTTATATCTATTCCT,0,504452
araBp,0.5,1,1,TAGGAGTCCTTTCTGGCAGA,0,502831
araBp,0.5,1,1,TAGGAACCATAACGGTGGCT,0,502845
araBp,0.5,1,1,TAGCTGTTAAATTGACTTTC,0,495566
araBp,0.5,1,1,TAGCTCGTTCCTACCTAAGC,0,505031
araBp,0.5,1,1,TAGCTCAGGCCGAGTGCAGA,0,483262
araBp,0.5,1,1,TAGCTAGGTCTAGTGTGTTT,0,516505
araBp,0.5,1,1,TAGCGAGCTCCCCGGAGAGA,0,489148
araBp,0.5,1,1,TAGCGACCTCAGTAATAGCA,0,479523
araBp,0.5,1,1,TAGCCCTCAGGTATGACGGT,0,521105
araBp,0.5,1,1,TAGCCCGTTTATCAGTGGAG,0,484891
araBp,0.5,1,1,TAGCATGTTCACCCCGATGA,0,470555
araBp,0.5,1,1,TAGCACGTGAGGGCAAAGAA,0,508380
araBp,0.5,1,1,TAGATTTTCAGCGCCGTCCT,0,511235
araBp,0.5,1,1,TAGATCTTGCTGGATTTCAG,0,481489
araBp,0.5,1,1,TAGATCGCTTTGTCCCGCAG,0,478017
araBp,0.5,1,1,TAGATACGTCATAATTGGTT,0,481411
araBp,0.5,1,1,TAGAGTGCTAGGCTCTTACT,0,476711
araBp,0.5,1,1,TAGAGGGAAGTCTGTCAGGT,0,490779
araBp,0.5,1,1,TAGACTCCGCCCCGCTTTGA,0,491574
araBp,0.5,1,1,TAGACGGACGTGGTAGGCCT,0,521931
araBp,0.5,1,1,TAGAACCGCGATCGATTCTC,0,494910
araBp,0.5,1,1,TACTTTGGCTGGATCCACAT,0,521791
araBp,0.5,1,1,TACTTCGACTCCTCGCCACT,0,524001
araBp,0.5,1,1,TACTGTCGGTACTCAAGAAT,0,496643
araBp,0.5,1,1,TACTGCCACGCACGATAACC,0,520460
araBp,0.5,1,1,TACTCGTCGAGTCATTCTTT,0,473784
araBp,0.5,1,1,TACTCGAATCGACGGCTCAC,0,478146
araBp,0.5,1,1,TACTCCGAGACGTGTTGACA,0,506118
araBp,0.5,1,1,TACTCAAGAAGCTGGCCCTG,0,478882
araBp,0.5,1,1,TACTACGGTCTTCACGCTGA,0,470613
araBp,0.5,1,1,TACTAAAGCTTTCTGATATA,0,479790
araBp,0.5,1,1,TACGTTCCTGAAGATGATCC,0,506948
araBp,0.5,1,1,TACGTGGGGTGTATCGTAAC,0,495038
araBp,0.5,1,1,TACGGGCATTCGCCGGTTAT,0,508054
araBp,0.5,1,1,TACGCTAAAGAATCCTGTTG,0,519255
araBp,0.5,1,1,TACGCGTGGCTGGAAATGAG,0,523696
araBp,0.5,1,1,TACGCGGTGGCAACTGAGTT,0,485274
araBp,0.5,1,1,TACGCACACGCACTATCACT,0,489513
araBp,0.5,1,1,TACGATGCCCAGATTTGAGC,0,474647
araBp,0.5,1,1,TACGAGTCCGAAGGTCACCA,0,491651
araBp,0.5,1,1,TACGAGAAGTCAGTATGAGA,0,519359
araBp,0.5,1,1,TACGAGAAATCTTTGCATTT,0,490437
araBp,0.5,1,1,TACCCTCGCGCCACCGGCGT,0,474432
araBp,0.5,1,1,TACCCCTACATTGCGGGTTT,0,510847
araBp,0.5,1,1,TACCCATGTTATCACAGACG,0,486977
araBp,0.5,1,1,TACCACTAATAAGATTGGAG,0,519671
araBp,0.5,1,1,TACACAATGCTAGGGGGGAT,0,518573
araBp,0.5,1,1,TACAATAACTCATATTGGCC,0,494161
araBp,0.5,1,1,TACAAGTTTTCATAAACTAT,0,519781
araBp,0.5,1,1,TAATTGGAGGCTGCGATGGA,0,469838
araBp,0.5,1,1,TAATTCAAGTCTTGTATTCG,0,490759
araBp,0.5,1,1,TAATTATTACTGCGGAATAG,0,510238
araBp,0.5,1,1,TAATGTCGTATTATACTATT,0,504168
araBp,0.5,1,1,TAATCTCCCTTATGGTATGA,0,477384
araBp,0.5,1,1,TAATCGTAGACCCGCAGCCT,0,474783
araBp,0.5,1,1,TAATCGTACGCACGGCCGGA,0,472598
araBp,0.5,1,1,TAATCCCCTCAAGGTGAACT,0,505949
araBp,0.5,1,1,TAATCCAGCCAACGCGGATT,0,505290
araBp,0.5,1,1,TAATAGTCGCTGGGGCGAAA,0,513678
araBp,0.5,1,1,TAAGTCAATCATTTAAACTG,0,499093
araBp,0.5,1,1,TAAGGGGCGACGATGCCAAA,0,468369
araBp,0.5,1,1,TAAGGGAATCCATACTCAGC,0,486601
araBp,0.5,1,1,TAAGGACTATTAGGTTCGAG,0,499555
araBp,0.5,1,1,TAAGCTGGTACGCTGCCAGA,0,523422
araBp,0.5,1,1,TAAGCGGATGCTGGCCCCGG,0,504891
araBp,0.5,1,1,TAAGCATAAGTTCAAAGTTC,0,489743
araBp,0.5,1,1,TAAGAGCGCGCGGCAACTAG,0,519299
araBp,0.5,1,1,TAAGAGCCCAATGACCATAT,0,478207
araBp,0.5,1,1,TAACTGCAATGGCATGGCGT,0,493588
araBp,0.5,1,1,TAACTCAGATATGCGTGTCA,0,508031
araBp,0.5,1,1,TAACTAAGGCCCCGCGTCCG,0,502021
araBp,0.5,1,1,TAACGGCGTTACGCTAGTCC,0,469905
araBp,0.5,1,1,TAACGGCGATTGACCAATCC,0,485635
araBp,0.5,1,1,TAACCTGCACGTACTACCCC,0,478139
araBp,0.5,1,1,TAACCGCATACCGTTGATGG,0,502179
araBp,0.5,1,1,TAACATTTCCTGGAGTAACA,0,523207
araBp,0.5,1,1,TAACAGATTACAGTTAGGCC,0,490223
araBp,0.5,1,1,TAAATGCAGTCCTCTAAGAA,0,513682
araBp,0.5,1,1,TAAAGGCGCGAAAGTTCGAA,0,490020
araBp,0.5,1,1,TAAAGGCGATACCAGTCGCC,0,507580
araBp,0.5,1,1,TAAAGGCCACCCCAGACCGA,0,490194
araBp,0.5,1,1,TAAAGATCCACAATTCAAGA,0,524213
araBp,0.5,1,1,TAAACGTCTTAGCGTGTCCT,0,510617
araBp,0.5,1,1,TAAAACTGTCGCGAGTTGAG,0,515262
araBp,0.5,1,1,TAAAAACTCCTTGATGAAAC,0,510749
araBp,0.5,1,1,GTTTTGGGTTTGTAGAGACT,0,509697
araBp,0.5,1,1,GTTTTGACTCATCGGACCAG,0,512894
araBp,0.5,1,1,GTTTTCTTCGTGCGCTCGCA,0,499229
araBp,0.5,1,1,GTTTGGCGAAACGAATTCGG,0,475466
araBp,0.5,1,1,GTTTGCACATGTATCCCCAG,0,505167
araBp,0.5,1,1,GTTTCGAATGTCATGGGCGT,0,473863
araBp,0.5,1,1,GTTTCATAAGATACTAAAAT,0,508887
araBp,0.5,1,1,GTTTATACTCGCGGTCGAGT,0,509789
araBp,0.5,1,1,GTTTAAGTAGAATTGTGGAC,0,501951
araBp,0.5,1,1,GTTGTAGTCGTTGAGATATA,0,479801
araBp,0.5,1,1,GTTGGGGCTCAACGATGTGT,0,512411
araBp,0.5,1,1,GTTCTTTGAGGACAGGAATG,0,500347
araBp,0.5,1,1,GTTCTGCTCACAAAATGATC,0,469383
araBp,0.5,1,1,GTTCTGAGCTCATAGAAGCC,0,505220
araBp,0.5,1,1,GTTCGGTTTTTCTCAAAGTT,0,496399
araBp,0.5,1,1,GTTCGCCGTCCCCGCTACTT,0,504368
araBp,0.5,1,1,GTTCGACAGGGAGAATCGTC,0,509698
araBp,0.5,1,1,GTTCGAACTCTTCAAACGGT,0,491504
araBp,0.5,1,1,GTTCCGGGAAGCGCTGCTTA,0,484421
araBp,0.5,1,1,GTTCCCCTCGACACGGAGAG,0,469131
araBp,0.5,1,1,GTTCAGTTCAGGTAGTACGT,0,472824
araBp,0.5,1,1,GTTCAACAAAGAAATTGAGA,0,471571
araBp,0.5,1,1,GTTATCTCGGCGGCGTCGGA,0,479353
araBp,0.5,1,1,GTTAGTTCCGGTTCAGGTAC,0,470967
araBp,0.5,1,1,GTTACCTAGCTTGAAATAAA,0,513842
araBp,0.5,1,1,GTTACCATTTTAGAGAGCCT,0,474568
araBp,0.5,1,1,GTTAATGTTCATAAGGGTAG,0,482408
araBp,0.5,1,1,GTTAACGTTAAGGAGTACTC,0,506021
araBp,0.5,1,1,GTTAAAGCTCCTGCTTGCTA,0,524042
araBp,0.5,1,1,GTTAAAAGATCTCGTAGGAG,0,493340
araBp,0.5,1,1,GTGTTGTCTGAGACTCGAGG,0,475249
araBp,0.5,1,1,GTGTTCTTGATCAATGTAGG,0,496711
araBp,0.5,1,1,GTGTTACTATAAGAGGGGGA,0,522687
araBp,0.5,1,1,GTGTGTCTGCATCGCCCATA,0,512951
araBp,0.5,1,1,GTGTGTAGTAGGTGCCGCAC,0,502087
araBp,0.5,1,1,GTGTGGGGAAGTACAGAGTT,0,483073
araBp,0.5,1,1,GTGTGCTTGTAGGTATCTTA,0,511893
araBp,0.5,1,1,GTGTGAGACCTTGTGCGTTG,0,499706
araBp,0.5,1,1,GTGTCTGTTGTTATTGTCAG,0,497288
araBp,0.5,1,1,GTGTCATCCGACTTACTTGA,0,507860
araBp,0.5,1,1,GTGTCACTAATTGGGCCATT,0,508561
araBp,0.5,1,1,GTGTATCTGCCCTCCTTTGT,0,510072
araBp,0.5,1,1,GTGGTCCCCCGTTAGAATTT,0,479647
araBp,0.5,1,1,GTGGTATGAGATCCGCAGGC,0,469762
araBp,0.5,1,1,GTGGTAGAGCCTGACGTTGA,0,500531
araBp,0.5,1,1,GTGGGTCACCGCCCATAAAT,0,496240
araBp,0.5,1,1,GTGGGTATTGTTATAGGCCG,0,503564
araBp,0.5,1,1,GTGGGGAGATTCCGTAACCG,0,470815
araBp,0.5,1,1,GTGGGCTCTACGCGATTTGT,0,497676
araBp,0.5,1,1,GTGGGCTATCGAGAGCTCAT,0,485586
araBp,0.5,1,1,GTGGGCGGCCCCTAGCATAG,0,498394
araBp,0.5,1,1,GTGGGCAACGTTCTCTGTTG,0,486281
araBp,0.5,1,1,GTGGGAGAATGAGGACTGGC,0,469660
araBp,0.5,1,1,GTGCTACAGAAGTGTCACCC,0,485596
araBp,0.5,1,1,GTGCTAATCTGAGCGCCTGA,0,493104
araBp,0.5,1,1,GTGCGCCTAGGGTCGATGTT,0,508323
araBp,0.5,1,1,GTGCGATAGTCATTCTAAGA,0,481720
araBp,0.5,1,1,GTGCGATAGGTTGGCTCGCT,0,479187
araBp,0.5,1,1,GTGCCTCGCCGACACGTGAT,0,485070
araBp,0.5,1,1,GTGCCGGTTAACTGTAGATT,0,513044
araBp,0.5,1,1,GTGCCCCCCAGTGCTTCCGT,0,499478
araBp,0.5,1,1,GTGCCAATTTCGAGTTCAAT,0,475849
araBp,0.5,1,1,GTGCAGAGGTATACTGCTAC,0,517584
araBp,0.5,1,1,GTGATTGATGAGGGTTCCGC,0,473507
araBp,0.5,1,1,GTGATTCAGGCAGCAGCCGG,0,521454
araBp,0.5,1,1,GTGAGGGCGGTCATAGGGTT,0,514647
araBp,0.5,1,1,GTGAGGCAGATGGATTCGCG,0,476420
araBp,0.5,1,1,GTGAGGAGCCTGAACAACCC,0,476471
araBp,0.5,1,1,GTGAGGACTTTGACCACTTG,0,485244
araBp,0.5,1,1,GTGAGAATTGGCGTTCGGAT,0,503433
araBp,0.5,1,1,GTGACGCGATTCTCCGTGTT,0,479656
araBp,0.5,1,1,GTGAAGTCTGTCCAGAATTT,0,523494
araBp,0.5,1,1,GTGAACGGGCGCACAGGTCG,0,469522
araBp,0.5,1,1,GTGAAATGTGGAGAGCTGAT,0,511292
araBp,0.5,1,1,GTCTTTGTGAGCTGTTCCCA,0,524824
araBp,0.5,1,1,GTCTTCGCATATTAAGGCAT,0,513808
araBp,0.5,1,1,GTCTTCCCGTAGGACCGTAT,0,469316
araBp,0.5,1,1,GTCTTCATGTACGACCTAAG,0,503217
araBp,0.5,1,1,GTCTGTACACAGGAGGATAA,0,473255
araBp,0.5,1,1,GTCTGGGGGGATGATAGATG,0,496457
araBp,0.5,1,1,GTCTGAGAGTTTAATTTGCC,0,513327
araBp,0.5,1,1,GTCTCTTTACAGTGTAGTAA,0,493264
araBp,0.5,1,1,GTCTCGGAAGGTTTACTATT,0,477290
araBp,0.5,1,1,GTCTCACCCGCAGCGCGCAT,0,515497
araBp,0.5,1,1,GTCTAGTACGGGTGTCGTTT,0,515669
araBp,0.5,1,1,GTCGTATTAAGCGGGTTTAG,0,500672
araBp,0.5,1,1,GTCGGTGATCGGCTATTGCA,0,480588
araBp,0.5,1,1,GTCGGGTGATGCAACATAGT,0,469019
araBp,0.5,1,1,GTCGGGCTTCGCTCCTAAAC,0,500620
araBp,0.5,1,1,GTCGCAGTACTATCAGTTTG,0,495085
araBp,0.5,1,1,GTCGAGGGCCGTTCGTGAGC,0,484108
araBp,0.5,1,1,GTCCGAGCTCAATTGGAAGT,0,474476
araBp,0.5,1,1,GTCCGACTCTGTTACAGCAA,0,481025
araBp,0.5,1,1,GTCCGAAGGCCGCAGAACTA,0,516406
araBp,0.5,1,1,GTCCAATGTACGCTTTACAG,0,483655
araBp,0.5,1,1,GTCATGTTCCAGCGCATTGT,0,517490
araBp,0.5,1,1,GTCATGGTAGGCCTCTTCAT,0,470351
araBp,0.5,1,1,GTCATGCCCAATTCTTGTTA,0,475540
araBp,0.5,1,1,GTCATACAACTTTAGCTAAT,0,497294
araBp,0.5,1,1,GTCATAAACGTGTTCGGAGC,0,474006
araBp,0.5,1,1,GTCAGTAGTCGCCTAATTGT,0,477451
araBp,0.5,1,1,GTCAGCACCGGCGGTAAGGC,0,487225
araBp,0.5,1,1,GTCACAAAAGCAGTGAGAAT,0,507808
araBp,0.5,1,1,GTCAAGCTACGGCATCACCT,0,502912
araBp,0.5,1,1,GTCAAAACAGATGATAAGTT,0,497574
araBp,0.5,1,1,GTATTGCCCCTTCGGTAGGA,0,472906
araBp,0.5,1,1,GTATGGCGCGGATACTCACC,0,467956
araBp,0.5,1,1,GTATGGATGTGTGCCAAAGG,0,497258
araBp,0.5,1,1,GTATCTAGCCGAAATGGACC,0,492789
araBp,0.5,1,1,GTATCTAAGAAAATGTCGAG,0,469805
araBp,0.5,1,1,GTATAGCGAAGGTGTTAATA,0,476490
araBp,0.5,1,1,GTATAGATAACCCCTAGTGT,0,498597
araBp,0.5,1,1,GTAGTTGGTTGCTCATACAA,0,523010
araBp,0.5,1,1,GTAGTTCGCGTCGGAGCCTC,0,487157
araBp,0.5,1,1,GTAGTAGGAAGAAGGAAACC,0,488648
araBp,0.5,1,1,GTAGTAAGAAGGTATCCGAC,0,471135
araBp,0.5,1,1,GTAGGTGTACTCACCATACT,0,507312
araBp,0.5,1,1,GTAGGTCATGAGATCACGTG,0,506249
araBp,0.5,1,1,GTAGGTATACGAGTTATCCT,0,499994
araBp,0.5,1,1,GTAGGGCCAGTAGCTCCGAC,0,506893
araBp,0.5,1,1,GTAGGACGGGCATTTGCAGC,0,484412
araBp,0.5,1,1,GTAGGAAAATTTAAACGTTA,0,513665
araBp,0.5,1,1,GTAGCTTACACGTGCGTGCG,0,511730
araBp,0.5,1,1,GTAGCTGGCACAGCAGCTCT,0,495378
araBp,0.5,1,1,GTAGCGTAGGTCATGGCCGG,0,521841
araBp,0.5,1,1,GTAGCCAGCACGGCCGATGG,0,488197
araBp,0.5,1,1,GTAGAGACCGTACTCATGGC,0,498580
araBp,0.5,1,1,GTAGACGTTCCGCGGGAGGT,0,474023
araBp,0.5,1,1,GTACTGACGTAGTCTGCGGT,0,509564
araBp,0.5,1,1,GTACTCTAGGAGGGTATCCC,0,495173
araBp,0.5,1,1,GTACTCGGTAAAACTATCGT,0,476192
araBp,0.5,1,1,GTACTACGTTTAGGCTTAGG,0,479167
araBp,0.5,1,1,GTACGAAGTGTGTCTCTTGA,0,524477
araBp,0.5,1,1,GTACCCGAGCAGTGCCTGAG,0,521989
araBp,0.5,1,1,GTAATCCGGCGTGTTCCATC,0,494243
araBp,0.5,1,1,GTAATAGATCGAAAATAGGG,0,501356
araBp,0.5,1,1,GTAAGGCATGTATGAGGTTG,0,481498
araBp,0.5,1,1,GTAAGCCACTAAAAGGATGC,0,488651
araBp,0.5,1,1,GTAACTTGCAGTGCATAGGT,0,498479
araBp,0.5,1,1,GTAACTGATCGCTGACCTGC,0,504307
araBp,0.5,1,1,GTAACCGCTGGGGAGTTGGA,0,476415
araBp,0.5,1,1,GTAACAAAGCGCAGAGGCGG,0,499042
araBp,0.5,1,1,GGTTTGTGAGGCTTGCGGGA,0,472139
araBp,0.5,1,1,GGTTTCGCATCCAAAAAATA,0,507551
araBp,0.5,1,1,GGTTTCCAGCCTCAAAGGTG,0,496687
araBp,0.5,1,1,GGTTTAGGCTGGTAAGCTCA,0,512443
araBp,0.5,1,1,GGTTGGGTCCTCGAAACGCG,0,487726
araBp,0.5,1,1,GGTTCTGCACGCGTCGTGCA,0,494899
araBp,0.5,1,1,GGTTCGGCTTAGACGGTGCG,0,505830
araBp,0.5,1,1,GGTTCGCCCTGGTTACTTTC,0,494609
araBp,0.5,1,1,GGTTCCGGAAGGTCTCGTCG,0,484639
araBp,0.5,1,1,GGTTCCACATATGCGGATTT,0,512063
araBp,0.5,1,1,GGTTCAGGGTCCTCGGGGAC,0,520300
araBp,0.5,1,1,GGTTATAACGTAGGTTTCAC,0,472833
araBp,0.5,1,1,GGTTAGGCGTATAGGAGTGT,0,473321
araBp,0.5,1,1,GGTTACCGGCCAACAATAGA,0,492822
araBp,0.5,1,1,GGTTAATTAGGGACGCGCAC,0,484290
araBp,0.5,1,1,GGTGGTAGCTGGCAATGCCG,0,482638
araBp,0.5,1,1,GGTGGTAATGAGTTGGAAAT,0,496230
araBp,0.5,1,1,GGTGGCTCACATTGCTTGGG,0,515427
araBp,0.5,1,1,GGTCTTTCGAGAGAGGCTCG,0,502322
araBp,0.5,1,1,GGTCGAGCGTCAGCTCGCCA,0,479592
araBp,0.5,1,1,GGTCGAAATGTGGTTGCTAT,0,475329
araBp,0.5,1,1,GGTCCTATGACGACCCAACC,0,504304
araBp,0.5,1,1,GGTCCATGGATTACAGACGA,0,472568
araBp,0.5,1,1,GGTCCATCTCGGCATTGAGA,0,523796
araBp,0.5,1,1,GGTCAGTATAGGTAAGCAGT,0,480663
araBp,0.5,1,1,GGTATGCTCGCTTCGGCTAA,0,504046
araBp,0.5,1,1,GGTATCCGCCGTTAACCAAG,0,483314
araBp,0.5,1,1,GGTAGTCTGCGCGGCACGTC,0,479662
araBp,0.5,1,1,GGTACTTGACGATGCTTTGT,0,494317
araBp,0.5,1,1,GGTACTGCCACCTTCAATGT,0,480936
araBp,0.5,1,1,GGTACTCCGGACCAGCCAAG,0,506475
araBp,0.5,1,1,GGTACGAGAAGTCTGTACTC,0,467903
araBp,0.5,1,1,GGTACCGAGATGATACGTCA,0,482132
araBp,0.5,1,1,GGTACCCCAAAATCCGGAGT,0,504602
araBp,0.5,1,1,GGTAACGCAACAATCCACAT,0,521634
araBp,0.5,1,1,GGTAACCGGCTTGCATGAAA,0,499295
araBp,0.5,1,1,GGTAAAGATAGTCAGTCCCA,0,490082
araBp,0.5,1,1,GGGTTGGCCATAGGCTAACT,0,524728
araBp,0.5,1,1,GGGTTATCACCTTCTTGGAC,0,486716
araBp,0.5,1,1,GGGTGTACCTGTACTACTAC,0,482464
araBp,0.5,1,1,GGGTGGCGCTGTGATTGGCT,0,503629
araBp,0.5,1,1,GGGTGCTGGCGTTGTTAAGA,0,496021
araBp,0.5,1,1,GGGTGCCGCAAAGGAATTAA,0,476967
araBp,0.5,1,1,GGGTGACTTCTAGCCAGACA,0,472815
araBp,0.5,1,1,GGGTCTTCATCCGGAAATGG,0,502232
araBp,0.5,1,1,GGGTCGGCATAAGGTCGAAG,0,483818
araBp,0.5,1,1,GGGTCCGGCTTCGACTCACA,0,484025
araBp,0.5,1,1,GGGTCAAGTAGGAAGGGCTA,0,512653
araBp,0.5,1,1,GGGTATCCATATATGCTAAC,0,519864
araBp,0.5,1,1,GGGTACAAGCATTGAACGGG,0,519252
araBp,0.5,1,1,GGGGTTGCTTAGATTACATA,0,470418
araBp,0.5,1,1,GGGGTACGGCTCAGTTACCG,0,501647
araBp,0.5,1,1,GGGGGTTGTATGCTTAAGCA,0,521643
araBp,0.5,1,1,GGGGGGTCTTCTTACTTCCA,0,524558
araBp,0.5,1,1,GGGGGGCCGCCCAGCACGAA,0,499278
araBp,0.5,1,1,GGGGGAGTAATGTCGTAGCG,0,520787
araBp,0.5,1,1,GGGGCATTTCAATGAGGCTG,0,476480
araBp,0.5,1,1,GGGGCACAGAGGGATATGAA,0,506109
araBp,0.5,1,1,GGGGAGGGACGACGCCGCCA,0,494977
araBp,0.5,1,1,GGGGAAAACCGCACGCTGGA,0,500276
araBp,0.5,1,1,GGGCTTGCCCATTAGCGAAC,0,504049
araBp,0.5,1,1,GGGCTTAGAGATGCTGGGTT,0,509834
araBp,0.5,1,1,GGGCTGCTCTAGTCATTCTA,0,490335
araBp,0.5,1,1,GGGCTAGGTATGGAGGAGTC,0,518545
araBp,0.5,1,1,GGGCCGTTTCCTTGCGTGGA,0,480058
araBp,0.5,1,1,GGGCCGCATCGCAGGGCTGC,0,487369
araBp,0.5,1,1,GGGCCCAGTTTTCGTTAAGT,0,506575
araBp,0.5,1,1,GGGCATCCCGGCGATACTAC,0,486115
araBp,0.5,1,1,GGGATTCTTCTCATGTAAAA,0,508900
araBp,0.5,1,1,GGGATGGATCACCCCTTGTA,0,486919
araBp,0.5,1,1,GGGATCTGTCGTTCTCCTGC,0,490618
araBp,0.5,1,1,GGGATAGTCAGAAACGAGAC,0,499590
araBp,0.5,1,1,GGGATAATGTCTTAGAGATG,0,508469
araBp,0.5,1,1,GGGAGGTAGGCAACATGGCT,0,509863
araBp,0.5,1,1,GGGAGGGTTCGGACAATAGT,0,521424
araBp,0.5,1,1,GGGAGCTCGATCCCCACCCA,0,510089
araBp,0.5,1,1,GGGAGAGTCTATTGCGACTC,0,482158
araBp,0.5,1,1,GGGACGTCTTCGGCCGGATA,0,474597
araBp,0.5,1,1,GGGACGGAGTTCTACCGACC,0,477373
araBp,0.5,1,1,GGGACACCCCCCCTGAGAAG,0,520342
araBp,0.5,1,1,GGGAATACGAGGGGAGTCGT,0,490162
araBp,0.5,1,1,GGGAAATGTAAGCACACCCT,0,496131
araBp,0.5,1,1,GGGAAATACCTCAGGGGACA,0,524392
araBp,0.5,1,1,GGGAAACTGGGATAATAAAA,0,493822
araBp,0.5,1,1,GGGAAAACCGGTAAGTAAGA,0,494881
araBp,0.5,1,1,GGCTTTATACACGCCTGCTT,0,473627
araBp,0.5,1,1,GGCTTTAGCACGCTGTGGAT,0,479899
araBp,0.5,1,1,GGCTTATCTGGCTACGACCA,0,514768
araBp,0.5,1,1,GGCTTAATGTTCGTAGTTGC,0,470130
araBp,0.5,1,1,GGCTGTATTATAGTCACCAA,0,501843
araBp,0.5,1,1,GGCTCTTAAACAAGGCCTTG,0,476571
araBp,0.5,1,1,GGCTCTCGCATATGCATTTT,0,471775
araBp,0.5,1,1,GGCTATATCCCACATGCAAC,0,484637
araBp,0.5,1,1,GGCTAATTCTTTCGCGCCAC,0,492120
araBp,0.5,1,1,GGCGTGTGTCGTCTTCAATA,0,497287
araBp,0.5,1,1,GGCGTGCTAATCGCACCCTA,0,476576
araBp,0.5,1,1,GGCGTGCCGATCATCGAGTA,0,508034
araBp,0.5,1,1,GGCGGTTGTCCACGCAGAGG,0,516130
araBp,0.5,1,1,GGCGGTCTACGTTTCGCGCG,0,483617
araBp,0.5,1,1,GGCGGAAACTAATAATGCCG,0,501807
araBp,0.5,1,1,GGCGCCAAGTTCTGCATGTA,0,520750
araBp,0.5,1,1,GGCCTGTAGAGACTGTCCAT,0,511987
araBp,0.5,1,1,GGCCTCATTGTCTGCGTCTC,0,479532
araBp,0.5,1,1,GGCCTAAACGGCAGCTCCTT,0,496664
araBp,0.5,1,1,GGCCGCTTTTGTGTCATACA,0,490062
araBp,0.5,1,1,GGCCGATGCAGGGTCTTTCA,0,489416
araBp,0.5,1,1,GGCCGACCCTGTCGGGGGCT,0,498826
araBp,0.5,1,1,GGCCCTTGGGCATATAAAGG,0,492686
araBp,0.5,1,1,GGCCCTTAAGAAGATTAACT,0,511393
araBp,0.5,1,1,GGCCCTGGGTCTCCTACCGG,0,473628
araBp,0.5,1,1,GGCCCGTGTTGATCTGTCAT,0,482759
araBp,0.5,1,1,GGCCCGCGTGGAAAATGTGC,0,476091
araBp,0.5,1,1,GGCCCCTGCACTTCAAACAC,0,497239
araBp,0.5,1,1,GGCCCCCAGCATTGATAAGG,0,501815
araBp,0.5,1,1,GGCCAGGTTGAACGGTCTGT,0,480466
araBp,0.5,1,1,GGCCACTTGGCGCTATTCGG,0,512204
araBp,0.5,1,1,GGCATCTTGATTTAACTGTA,0,510451
araBp,0.5,1,1,GGCATAGGCGGTGCTGTGAC,0,481828
araBp,0.5,1,1,GGCAGTAAGGAAGCCTGAGG,0,484459
araBp,0.5,1,1,GGCAGGTTTTATCACAACTT,0,499975
araBp,0.5,1,1,GGCAGGTTACTTACAGAATT,0,472653
araBp,0.5,1,1,GGCAGAGTGGATCCCGCTCG,0,475675
araBp,0.5,1,1,GGCACCTACGGATTGAACGG,0,489246
araBp,0.5,1,1,GGCACAGGTTAGCTGCATTC,0,521552
araBp,0.5,1,1,GGCACAATCCAATCCATGCG,0,498380
araBp,0.5,1,1,GGCAATAGCAAAATTGAGGA,0,472641
araBp,0.5,1,1,GGCAAGGATGCCGGCGGCGA,0,484470
araBp,0.5,1,1,GGCAACTCTCGGACCATACT,0,489039
araBp,0.5,1,1,GGATTTATTTAGGCGTACTG,0,511522
araBp,0.5,1,1,GGATTACAATCATCTTAAGT,0,511334
araBp,0.5,1,1,GGATGGCACAGGTTCTGATT,0,504427
araBp,0.5,1,1,GGATGGAACTTGGGCAATCA,0,510496
araBp,0.5,1,1,GGATCTCGTTGTATACAAAA,0,509889
araBp,0.5,1,1,GGATCAGGAGAGACAGACAT,0,491821
araBp,0.5,1,1,GGATATTGGTGCCCAATTCC,0,503244
araBp,0.5,1,1,GGATAGGTTATTTGAAACCC,0,495998
araBp,0.5,1,1,GGATAGGGATCGTTCAGTAC,0,521716
araBp,0.5,1,1,GGAGTTTCACTGGGATCTAG,0,488330
araBp,0.5,1,1,GGAGTGAGCCCAAATTACAC,0,479124
araBp,0.5,1,1,GGAGTAGCTAACCGTGCTCC,0,516444
araBp,0.5,1,1,GGAGTAACTGGTTCTCCACA,0,499257
araBp,0.5,1,1,GGAGGCTTTCCCAACTCCAT,0,516769
araBp,0.5,1,1,GGAGGCTAAATCCTACTCCT,0,483819
araBp,0.5,1,1,GGAGGACTTAACGGCGCAAT,0,514171
araBp,0.5,1,1,GGAGCTTTTGTTAAATGATC,0,521084
araBp,0.5,1,1,GGACTCGTTCGTACTAATGG,0,524474
araBp,0.5,1,1,GGACTCGGGCGCCTGCCTGG,0,503997
araBp,0.5,1,1,GGACGTACTAAGGCAGGTTA,0,496877
araBp,0.5,1,1,GGACGGTCAGCAGAACTTTT,0,490263
araBp,0.5,1,1,GGACGGAATCACCGATAGGA,0,490899
araBp,0.5,1,1,GGACCCTCGTTACTTCTGCC,0,520655
araBp,0.5,1,1,GGACAGTGGATACCTGTCAC,0,469421
araBp,0.5,1,1,GGACAGGGTGTTCCACGAGC,0,480009
araBp,0.5,1,1,GGACAACTTGCGGCATACAC,0,515975
araBp,0.5,1,1,GGAATTCTTGGCAATTGGTT,0,507288
araBp,0.5,1,1,GGAATCGGCGCGCGGCGGTA,0,519626
araBp,0.5,1,1,GGAATCACCTCCTCTTGGAG,0,503110
araBp,0.5,1,1,GGAATAGTACAGCGGGAGAA,0,486898
araBp,0.5,1,1,GGAAGCCGCCGCGTGTCTAT,0,510726
araBp,0.5,1,1,GGAAGACGAGGGGCGATAGG,0,523476
araBp,0.5,1,1,GGAACGGACCCCGTAGATCT,0,491776
araBp,0.5,1,1,GGAACAAGCGCTTGTTTATT,0,487047
araBp,0.5,1,1,GGAAACATTCTGTGCCTTGA,0,496586
araBp,0.5,1,1,GGAAAATTTCGCCGCCAAGT,0,484444
araBp,0.5,1,1,GCTTGCGGTCATCCGCCGCT,0,508724
araBp,0.5,1,1,GCTTGACCCACGCGAGGTGG,0,494361
araBp,0.5,1,1,GCTTCGGCGCGAGTAGTGAT,0,509096
araBp,0.5,1,1,GCTTCATGACCCTTGTGGAA,0,485882
araBp,0.5,1,1,GCTTCAGTGTCGGGCGGTCA,0,489639
araBp,0.5,1,1,GCTTATAGCACGAGCTGGGA,0,468261
araBp,0.5,1,1,GCTTAACCCTAGCTACCCGG,0,493170
araBp,0.5,1,1,GCTGTGCCATTAGCATGCAT,0,498443
araBp,0.5,1,1,GCTGTCACGGCCAATCACCT,0,501707
araBp,0.5,1,1,GCTGGGCACATGGAAAATGA,0,473446
araBp,0.5,1,1,GCTGGGAAGTGCGGGTCTGG,0,468880
araBp,0.5,1,1,GCTCGTCCCTACCTCAAAGG,0,494152
araBp,0.5,1,1,GCTCGATCCGGATTATTGTG,0,468619
araBp,0.5,1,1,GCTCCTTGAGTAACCTTGGA,0,487245
araBp,0.5,1,1,GCTCCGTTGGTCAAGCGCTT,0,502572
araBp,0.5,1,1,GCTCCCAGACACGATCACGA,0,485956
araBp,0.5,1,1,GCTCCACACTTAACCTGGCC,0,482935
araBp,0.5,1,1,GCTATGATCTCACGTTAGTG,0,513636
araBp,0.5,1,1,GCTATCTTAACCTCTTCCTC,0,515055
araBp,0.5,1,1,GCTATCAGCCCTCCGGGACT,0,485925
araBp,0.5,1,1,GCTAGTCATTAAAAGTGAAA,0,477097
araBp,0.5,1,1,GCTAGCTGCTTGCGCCACTT,0,514863
araBp,0.5,1,1,GCTAGCTAACTTCAATTTGT,0,494940
araBp,0.5,1,1,GCTAGACGAAGCCCAATACA,0,498026
araBp,0.5,1,1,GCGTTTCCACTCCCAACCAC,0,524637
araBp,0.5,1,1,GCGTTATCCGGAGTCGCGTT,0,475457
araBp,0.5,1,1,GCGTTAATGCGATTTGCGGT,0,514527
araBp,0.5,1,1,GCGTGCGCCATCAGTCGCGC,0,488784
araBp,0.5,1,1,GCGTGACTCTGTTCTGAGAG,0,517324
araBp,0.5,1,1,GCGTAGTTCCGCCTATCACA,0,522142
araBp,0.5,1,1,GCGTAGACAAAAGACGCACA,0,490770
araBp,0.5,1,1,GCGTACAAAGAGAATGGGAT,0,482736
araBp,0.5,1,1,GCGGTTGTGACCAGAAATGA,0,481758
araBp,0.5,1,1,GCGGTTGGTCCCCTCTCGTT,0,479304
araBp,0.5,1,1,GCGGTATTGTTGAATATCAG,0,504270
araBp,0.5,1,1,GCGGTAGGACAAATTCGGGT,0,473322
araBp,0.5,1,1,GCGGTAGATACGAAGGACCA,0,476266
araBp,0.5,1,1,GCGGGTACACCGGGGAGCAA,0,485415
araBp,0.5,1,1,GCGGCTTAGGAAAACGGGCG,0,508601
araBp,0.5,1,1,GCGGCCACTAGGGCGGCTCC,0,522750
araBp,0.5,1,1,GCGGCACCGGGGAACTCCTA,0,484957
araBp,0.5,1,1,GCGGAGATTGGGGGCAATCT,0,486277
araBp,0.5,1,1,GCGGACTTAATCAGTGGGAG,0,475319
araBp,0.5,1,1,GCGCTTTTGCGTTACCTCGA,0,505054
araBp,0.5,1,1,GCGCTGTACAGTTCTCAAAC,0,516870
araBp,0.5,1,1,GCGCTCGGTCTCCACTGACC,0,524156
araBp,0.5,1,1,GCGCTCAGGGTACGATAGTA,0,472606
araBp,0.5,1,1,GCGCCCACGACCGCAACCCC,0,485322
araBp,0.5,1,1,GCGCACTGATCTAATCATGT,0,494239
araBp,0.5,1,1,GCGCACATGACCTGTTTCTT,0,492273
araBp,0.5,1,1,GCGCAACGAATTAGCCTATA,0,470331
araBp,0.5,1,1,GCGATTCATGGTGTAGATGG,0,507422
araBp,0.5,1,1,GCGAGTTCTCTACTAGATAC,0,507475
araBp,0.5,1,1,GCGAGTGCGTTACGGGCGGA,0,507530
araBp,0.5,1,1,GCGAGCACATGACCGCCCCC,0,469931
araBp,0.5,1,1,GCGACTTATGTGTACACACG,0,491876
araBp,0.5,1,1,GCGACCCGGCGCTCCGCGAA,0,483364
araBp,0.5,1,1,GCGACCACACTACGGGGGCA,0,494584
araBp,0.5,1,1,GCGACAAATGGCTCGGCCCT,0,472138
araBp,0.5,1,1,GCGACAAATCTTATTGCCGT,0,479994
araBp,0.5,1,1,GCGAAGCGGAGCCGACGACA,0,492655
araBp,0.5,1,1,GCGAACTCGTCTGCGGCAGG,0,521003
araBp,0.5,1,1,GCCTTTGCTTGGGACACAAT,0,480403
araBp,0.5,1,1,GCCTGAGTATCTAACGGGAT,0,496621
araBp,0.5,1,1,GCCTCTACGCACGCTGCGAA,0,483256
araBp,0.5,1,1,GCCTCCGCGCCAACAAAATC,0,482159
araBp,0.5,1,1,GCCTATGCGGGTGGGATAAG,0,496827
araBp,0.5,1,1,GCCTATGAACCTTTCGGTTA,0,475318
araBp,0.5,1,1,GCCGTCAAGTCCGTCGGCCC,0,472514
araBp,0.5,1,1,GCCGTAGGAATTGTATTCGA,0,501842
araBp,0.5,1,1,GCCGTAAAAGTGGGTTGAAA,0,476966
araBp,0.5,1,1,GCCGGTACGCTCAACAACCG,0,517031
araBp,0.5,1,1,GCCGGTACCGCCTTATTTGT,0,477237
araBp,0.5,1,1,GCCGGGTACCGTCTTAGGAG,0,479610
araBp,0.5,1,1,GCCGGGGGGGTCTCAACTCG,0,468238
araBp,0.5,1,1,GCCGGGGACGCCAGGCTAAC,0,492289
araBp,0.5,1,1,GCCGCTGGGCGGATACGGGC,0,524529
araBp,0.5,1,1,GCCGAACCGGTTCGATCCCT,0,470052
araBp,0.5,1,1,GCCGAAACCAGGCTCGCTCA,0,494439
araBp,0.5,1,1,GCCCTTACCGGGCGATGAAG,0,490306
araBp,0.5,1,1,GCCCTGATTCTTACACGAAA,0,510379
araBp,0.5,1,1,GCCCTCCACTTATATACGCA,0,519528
araBp,0.5,1,1,GCCCTCATAGATTTGTAATC,0,506175
araBp,0.5,1,1,GCCCTAGGGCTATATCCATA,0,522644
araBp,0.5,1,1,GCCCGGTTGCCGCCGGCGTA,0,509396
araBp,0.5,1,1,GCCCGCGAGGCGGGTCAGAT,0,514836
araBp,0.5,1,1,GCCCGAGTCTTCGTAGAGGC,0,516931
araBp,0.5,1,1,GCCCGAAGCGAGTTACCGGG,0,481448
araBp,0.5,1,1,GCCCCAGTGTAGTTGCAATC,0,492555
araBp,0.5,1,1,GCCCAGTTGTAGTGGAGGCA,0,519747
araBp,0.5,1,1,GCCCACATGGGGCACACTAC,0,521973
araBp,0.5,1,1,GCCATGACTTTGCTTAAAAG,0,509768
araBp,0.5,1,1,GCCATGAAAGGGATAGGACG,0,523949
araBp,0.5,1,1,GCCAGTTGCATGTATTTATG,0,497160
araBp,0.5,1,1,GCCAGTCAGCGGGGATGATT,0,482913
araBp,0.5,1,1,GCCAGGGCCGAGGAGTACGT,0,508249
araBp,0.5,1,1,GCCACCTGGGCCACGGCTCC,0,517228
araBp,0.5,1,1,GCCACCAGCACCGTTGGCTA,0,500978
araBp,0.5,1,1,GCCACACTCTCAAGAAACAC,0,510252
araBp,0.5,1,1,GCATTTGATCCATGTCTCAG,0,502053
araBp,0.5,1,1,GCATTTGATCATATTATCTG,0,488988
araBp,0.5,1,1,GCATTGCGGAGCCTTGGCGG,0,500088
araBp,0.5,1,1,GCATTCTACAACGACCCAGG,0,479864
araBp,0.5,1,1,GCATCTCATGTTTCGTAGCC,0,522914
araBp,0.5,1,1,GCATCTAAGCTAGTCTCGCC,0,501530
araBp,0.5,1,1,GCATCGGGTAATTATCCGGG,0,472690
araBp,0.5,1,1,GCATCGGCAGATTCTCCAGG,0,516785
araBp,0.5,1,1,GCATCACGGTGGTTAGCTGT,0,512822
araBp,0.5,1,1,GCAGGTATACTCGCTCGCCT,0,504050
araBp,0.5,1,1,GCAGGAATATTGTGGTTTGT,0,505508
araBp,0.5,1,1,GCAGAAGACTTGGTTCAAGT,0,498955
araBp,0.5,1,1,GCACTGCCGCATGGGCCAAT,0,468707
araBp,0.5,1,1,GCACGGGCAGATACTCAAGA,0,514576
araBp,0.5,1,1,GCACGCGATAGAAAGCGTGT,0,478629
araBp,0.5,1,1,GCACGCCCAAACCAAGAGAC,0,519578
araBp,0.5,1,1,GCACGACTGCTGCTAAACGC,0,491541
araBp,0.5,1,1,GCACCTGCATTTCATATGCA,0,477248
araBp,0.5,1,1,GCACCGACTCAGCCAGGCGT,0,507073
araBp,0.5,1,1,GCACATCAAGTAGCATTTGA,0,477520
araBp,0.5,1,1,GCACAGGATCTGTTCGGGCA,0,511841
araBp,0.5,1,1,GCACACGAGCACCCCCGTAA,0,520093
araBp,0.5,1,1,GCAATTGTTCAAATACCATC,0,515213
araBp,0.5,1,1,GCAAGTTCAAGGTATCTCAT,0,477008
araBp,0.5,1,1,GCAACGTTGACATCCAGACA,0,492820
araBp,0.5,1,1,GCAACGTACTAGAGTTTTCT,0,491622
araBp,0.5,1,1,GCAACACGGGCACGACTTTA,0,481592
araBp,0.5,1,1,GATTTTAGTGACGGTTTAGG,0,514955
araBp,0.5,1,1,GATTTCGAAAGAAGGGCCTA,0,471830
araBp,0.5,1,1,GATTTATTAAACGCCCCAAG,0,518469
araBp,0.5,1,1,GATTGCTCTGGTTATCAGGA,0,501757
araBp,0.5,1,1,GATTGATAGTGTAGCAACGT,0,475201
araBp,0.5,1,1,GATTGACATTGCTAGCACCT,0,491189
araBp,0.5,1,1,GATTCCTCCTGGGGTGCCCG,0,499566
araBp,0.5,1,1,GATTCAGTCAAGAAAATATC,0,482063
araBp,0.5,1,1,GATTACCCTTTCCCTACTAG,0,488502
araBp,0.5,1,1,GATTACCCGGTAGTCACTTT,0,519920
araBp,0.5,1,1,GATGGTGCTAAACCTGGCTC,0,482398
araBp,0.5,1,1,GATGGGGCATTCGGAGTGCT,0,479715
araBp,0.5,1,1,GATGGAAGGACCGCCTAACT,0,490565
araBp,0.5,1,1,GATGCTTCGTACTCTGCGGT,0,488590
araBp,0.5,1,1,GATGCTGCGGCGCTAGGTGG,0,518108
araBp,0.5,1,1,GATGCCTCACAATCAAAGAG,0,493737
araBp,0.5,1,1,GATGCAGTTGAAGAGAGTCC,0,497135
araBp,0.5,1,1,GATGCAAGACTCGTGAGAGG,0,472638
araBp,0.5,1,1,GATGAAAGATCGGCCCACTG,0,504139
araBp,0.5,1,1,GATGAAAACCATAGTTCGAC,0,468152
araBp,0.5,1,1,GATGAAAACCATACCACCAT,0,486492
araBp,0.5,1,1,GATCTCTACCAGGGCACATC,0,504000
araBp,0.5,1,1,GATCACAATGTGTGATCATT,0,505755
araBp,0.5,1,1,GATATACTAGCAGGAGAAAC,0,477093
araBp,0.5,1,1,GATAGCACTCGCCCGCGTTA,0,488393
araBp,0.5,1,1,GATAGATCGCCAGCTCTCGG,0,488303
araBp,0.5,1,1,GATAGAGCTGGAACGAGCGC,0,503352
araBp,0.5,1,1,GATACTTTTTGGCCAGTGCT,0,512169
araBp,0.5,1,1,GATACCTCCCAAAGATACGG,0,509426
araBp,0.5,1,1,GATACATCCATTTTCTGTGC,0,510121
araBp,0.5,1,1,GATACACATAGCGTTTGACG,0,507474
araBp,0.5,1,1,GATAAAGCCGTACGCTGCGG,0,484493
araBp,0.5,1,1,GAGTTTAGGCAAAAGCAATA,0,476176
araBp,0.5,1,1,GAGTTCTGATCATTCTCATT,0,522237
araBp,0.5,1,1,GAGTTAATAGTTAAAGGGTA,0,479931
araBp,0.5,1,1,GAGTTAAGTGTTAGCCTTAC,0,504170
araBp,0.5,1,1,GAGTGGGTACGGGATCCTCT,0,521230
araBp,0.5,1,1,GAGTCGCGCTCGGGTCGTTA,0,480228
araBp,0.5,1,1,GAGTCGCCGGACCCCCTAAG,0,509012
araBp,0.5,1,1,GAGTCCGGTCTATCAACAGC,0,495662
araBp,0.5,1,1,GAGTATCCAGCTCTGTCTGA,0,499897
araBp,0.5,1,1,GAGTAGTCTCCTGCCGGCTA,0,486452
araBp,0.5,1,1,GAGGTGAGCTTCCTTTCCCG,0,485268
araBp,0.5,1,1,GAGGTCATGACAGCCGCCCT,0,491302
araBp,0.5,1,1,GAGGTCAGCTAGGAAATGCG,0,497969
araBp,0.5,1,1,GAGGTAGCACAGACTATCCG,0,508762
araBp,0.5,1,1,GAGGGTGATATGCGACATAG,0,477850
araBp,0.5,1,1,GAGGATCCTGCGGATAATTA,0,497871
araBp,0.5,1,1,GAGGAGAAGCTATTTCGTAC,0,522726
araBp,0.5,1,1,GAGGACAGGTCGTAACTCAA,0,523988
araBp,0.5,1,1,GAGCTTTGCATACCGAACTG,0,506486
araBp,0.5,1,1,GAGCTGTTAGAGTCCTGGCC,0,515056
araBp,0.5,1,1,GAGCGATTCATTAGCCTCTA,0,513227
araBp,0.5,1,1,GAGCCTAGGGTCATCTTCAC,0,469203
araBp,0.5,1,1,GAGATAGGTTGGACTCTCGA,0,516481
araBp,0.5,1,1,GAGAGTTGCCATACTCTATA,0,471350
araBp,0.5,1,1,GAGAACAGGTCACACGATAG,0,479035
araBp,0.5,1,1,GAGAAATTCTCACCGGCGAG,0,508916
araBp,0.5,1,1,GACTTGTGTGCGGTAAGGAA,0,518760
araBp,0.5,1,1,GACTTGTGCCAATCTCATGA,0,471239
araBp,0.5,1,1,GACTTGGGATTCTGCGATGA,0,477720
araBp,0.5,1,1,GACTTCTTCCGCCTGTAGCA,0,514361
araBp,0.5,1,1,GACTTCCGAATGAGCTACGA,0,486966
araBp,0.5,1,1,GACTTACTCCCATATACAGT,0,486609
araBp,0.5,1,1,GACTGAATTTCTGATTACTC,0,497312
araBp,0.5,1,1,GACTGAATGTGGGTGCATTT,0,498525
araBp,0.5,1,1,GACTCGAAGGCCCGCATAAT,0,491176
araBp,0.5,1,1,GACTCCAACCCCTCGGTTGC,0,488498
araBp,0.5,1,1,GACTCAGAGGATCGCGACTC,0,499029
araBp,0.5,1,1,GACTAGCAGTATACGCATTT,0,490010
araBp,0.5,1,1,GACTAGCACGGTTGCGGTGC,0,513082
araBp,0.5,1,1,GACGTTGTAACCGCTTGACC,0,478808
araBp,0.5,1,1,GACGGAAACCAGCTGCGTTA,0,472943
araBp,0.5,1,1,GACGCTTCGCTGAGCGTAGC,0,510002
araBp,0.5,1,1,GACGCTGTGTTGCTCGGCGC,0,512711
araBp,0.5,1,1,GACGCTCGGCGACGTCTGGC,0,488323
araBp,0.5,1,1,GACGCGGTACCCGGAATACC,0,519379
araBp,0.5,1,1,GACGACAACTATCGTCACAA,0,494622
araBp,0.5,1,1,GACGAAGCGCACACAGACCT,0,480372
araBp,0.5,1,1,GACCGTAGTCTCCATGGGTA,0,497580
araBp,0.5,1,1,GACCGCGGATGAATATGATA,0,484288
araBp,0.5,1,1,GACCGACGGCACGGCTATGT,0,512912
araBp,0.5,1,1,GACCCGGAATTTTCAGCTAC,0,514138
araBp,0.5,1,1,GACCCATTCTAGTCCTGGGG,0,509415
araBp,0.5,1,1,GACCAGGGAATGGGTTAGTA,0,472013
araBp,0.5,1,1,GACATGTTACCAAACGCCAT,0,473336
araBp,0.5,1,1,GACATCGTCCCATGCGTAAT,0,491259
araBp,0.5,1,1,GACATAACACTGAGGCGAAT,0,522659
araBp,0.5,1,1,GACAGTGTCAAATTTTACTA,0,483005
araBp,0.5,1,1,GACAGCTGGCATGGTCGTGT,0,468722
araBp,0.5,1,1,GACACGGGGTCCAGGGTAAG,0,470137
araBp,0.5,1,1,GACACGCGTCTATTTTTCTC,0,504474
araBp,0.5,1,1,GACAATAACTGAATTGGGAT,0,510149
araBp,0.5,1,1,GAATTGTTAAATGCTGGAAG,0,521537
araBp,0.5,1,1,GAATTCGATCCACACGACCA,0,491481
araBp,0.5,1,1,GAATGTTGGGAGGTGCGAGA,0,473000
araBp,0.5,1,1,GAATGTGGGATCGACAACTG,0,475473
araBp,0.5,1,1,GAATGGTTGTGATGTTTAAA,0,479051
araBp,0.5,1,1,GAATCGCGTCGCATGCAGTC,0,474849
araBp,0.5,1,1,GAAGTGTGTCAACACCAACG,0,475306
araBp,0.5,1,1,GAAGTCTCCTCACAGTAGAC,0,483244
araBp,0.5,1,1,GAAGTCGAAATGGACGCTGT,0,511560
araBp,0.5,1,1,GAAGTCATGGATATTTATAC,0,499865
araBp,0.5,1,1,GAAGTCATCTATAAGGACTG,0,498155
araBp,0.5,1,1,GAAGGGTGTAGACCATGGGG,0,495663
araBp,0.5,1,1,GAAGCTGCACCTACATTGAG,0,474706
araBp,0.5,1,1,GAAGCGGCGGTTGTATTTGA,0,489761
araBp,0.5,1,1,GAAGCGGCATTAGGATGGGA,0,491479
araBp,0.5,1,1,GAAGCGGAGACCCGGAAAAG,0,474336
araBp,0.5,1,1,GAAGCCGGCGGTGGGCGTAA,0,478027
araBp,0.5,1,1,GAAGCACAACGGTCTCGCAG,0,525046
araBp,0.5,1,1,GAAGCAACTGTCTCCGTTTT,0,500048
araBp,0.5,1,1,GAAGAGCTAGTGCGCGTTCA,0,478946
araBp,0.5,1,1,GAAGACGGTGCCTAATGAGA,0,481558
araBp,0.5,1,1,GAAGACCCTCCTTTAGGTTT,0,486218
araBp,0.5,1,1,GAACGTTGACTGCCGGGTCT,0,520904
araBp,0.5,1,1,GAACGCATCGCGGTGGTCCC,0,485963
araBp,0.5,1,1,GAACGCAAGCTCTAGGACGA,0,496164
araBp,0.5,1,1,GAACGAAGTCACATTTAAGA,0,473220
araBp,0.5,1,1,GAACCTTTGTATGTATACTT,0,494337
araBp,0.5,1,1,GAACCCTCAGCAAGATAAGA,0,518823
araBp,0.5,1,1,GAACCCGGGTGCCCAAGCCC,0,500738
araBp,0.5,1,1,GAACCCATGGTTGTATATTT,0,471753
araBp,0.5,1,1,GAACCACGGCGGAGGTCGCG,0,509066
araBp,0.5,1,1,GAACCAATGCCTGGACCACA,0,495377
araBp,0.5,1,1,GAACATAAAGTCATAGCGTC,0,472410
araBp,0.5,1,1,GAACACGTACCCGTACCAAG,0,468861
araBp,0.5,1,1,GAAATGTTGCCGGTTCATAC,0,505160
araBp,0.5,1,1,GAAATACGGTGCGCTAAATA,0,487563
araBp,0.5,1,1,GAAATACCAGTTAGGAACTC,0,514305
araBp,0.5,1,1,GAAAGGCCATTCTACACGGC,0,507725
araBp,0.5,1,1,GAAAGCGCTGCGTCCACGGG,0,498332
araBp,0.5,1,1,GAAAGAGTAACTTCATATCT,0,492094
araBp,0.5,1,1,GAAACGGACATCTGACAGAC,0,490516
araBp,0.5,1,1,GAAACCGCTCACCTGCATTT,0,483730
araBp,0.5,1,1,GAAACCAAATGCGGGAACCT,0,481556
araBp,0.5,1,1,GAAAAGAGTTTGAAGAACAC,0,486981
araBp,0.5,1,1,GAAAAAGGCTACTTGTTTGT,0,510243
araBp,0.5,1,1,CTTTTCTCATCCGGTACGGA,0,488211
araBp,0.5,1,1,CTTTTATCTATTTGTTGGAT,0,505486
araBp,0.5,1,1,CTTTTAACCATGGGTTTATA,0,476308
araBp,0.5,1,1,CTTTGTAAAGTCCAATGGAG,0,468695
araBp,0.5,1,1,CTTTGGGTTGTGCGGGGTAA,0,512176
araBp,0.5,1,1,CTTTCTAGGTGAACGATTCC,0,516028
araBp,0.5,1,1,CTTTAGATTTTATTTGCTTG,0,523429
araBp,0.5,1,1,CTTGTTTGGAGATCTGCGTG,0,484188
araBp,0.5,1,1,CTTGTGGGCGAACTGGTTGG,0,475538
araBp,0.5,1,1,CTTGTCTCGGCGATTGTAAG,0,489374
araBp,0.5,1,1,CTTGGTGAGCCAGATGTGAA,0,520718
araBp,0.5,1,1,CTTGGATGGAGTCATATTGT,0,493678
araBp,0.5,1,1,CTTGGATAACCAGGGCACCT,0,516460
araBp,0.5,1,1,CTTGGACAACTATTTAATAC,0,475893
araBp,0.5,1,1,CTTGCTATAAGTACTGTGGC,0,486908
araBp,0.5,1,1,CTTGCGGCGTAAGCTGCTTC,0,486761
araBp,0.5,1,1,CTTGCGAACATAAATCCTAA,0,490190
araBp,0.5,1,1,CTTGCCGACTTAATTCAACT,0,517767
araBp,0.5,1,1,CTTGCAGACATTTCTATAGT,0,488577
araBp,0.5,1,1,CTTGATCCTCCTTCGCGTTG,0,519886
araBp,0.5,1,1,CTTGACGCACGGTCAATGCA,0,476201
araBp,0.5,1,1,CTTCTTGCACAGCGGGCCAC,0,522835
araBp,0.5,1,1,CTTCTGTCTTAAGTCAATTT,0,498389
araBp,0.5,1,1,CTTCTGTAATTCTGGGAGAA,0,505452
araBp,0.5,1,1,CTTCTATCCGTTTACCGTCC,0,519719
araBp,0.5,1,1,CTTCGATGGTCTATCGTCCT,0,520595
araBp,0.5,1,1,CTTCCTGGGAGCCTTATGAG,0,511276
araBp,0.5,1,1,CTTCACCAGATCTCTGCGAC,0,507285
araBp,0.5,1,1,CTTCACAGCTTCAATAAGGT,0,525161
araBp,0.5,1,1,CTTCACAAGAAGCAACCTGG,0,472308
araBp,0.5,1,1,CTTCAAGGCATCCTCGTAGA,0,493304
araBp,0.5,1,1,CTTATACAGAGTTTCCTAGA,0,490789
araBp,0.5,1,1,CTTAGCTATAGTAGGCTTTT,0,475267
araBp,0.5,1,1,CTTAGCTACAATACGGATTG,0,509047
araBp,0.5,1,1,CTTAGCATGATAAGGACATA,0,473221
araBp,0.5,1,1,CTTACTTACTCCGTGTCGGT,0,498849
araBp,0.5,1,1,CTTACCGCGCTGCTGAGGAC,0,480891
araBp,0.5,1,1,CTTACCGCACTTTGGCCGGC,0,495031
araBp,0.5,1,1,CTTAAGCGGCACTGTGTGAC,0,494820
araBp,0.5,1,1,CTGTTCCATCTCGGAGAGCT,0,523241
araBp,0.5,1,1,CTGTGTGGCGATTGGTCGTG,0,519599
araBp,0.5,1,1,CTGTGTGGAGGGTAGTTCTT,0,507003
araBp,0.5,1,1,CTGTGGGTTGGATACCATGT,0,493806
araBp,0.5,1,1,CTGTCCAGATCATTAGCAAG,0,481292
araBp,0.5,1,1,CTGTCAGATAAACCTCTGGT,0,482898
araBp,0.5,1,1,CTGGTGTGATATTGTACCAG,0,518017
araBp,0.5,1,1,CTGGGGTCGCGCAGCGATAG,0,484408
araBp,0.5,1,1,CTGGGCGGAAATTTTTGATC,0,500658
araBp,0.5,1,1,CTGGAGCCGTTATCCCGGTA,0,489760
araBp,0.5,1,1,CTGGACCGCGGGAATAGATG,0,481201
araBp,0.5,1,1,CTGGAAATCCAGATTTGGTA,0,514901
araBp,0.5,1,1,CTGCTCTAGACTCCGGCCAC,0,470276
araBp,0.5,1,1,CTGCTCATAAGTGCCGTCAG,0,508179
araBp,0.5,1,1,CTGCCTGGTTAGCTTAGGCT,0,514002
araBp,0.5,1,1,CTGCCGTAGCTATGCTGGTG,0,469428
araBp,0.5,1,1,CTGCCCAGTACCATAGAGGT,0,488368
araBp,0.5,1,1,CTGATTGCTAGAAACGGCCG,0,517074
araBp,0.5,1,1,CTGATTAACCCTGAGTCCGC,0,476906
araBp,0.5,1,1,CTGAGTTTAGCGTGTGTACA,0,525048
araBp,0.5,1,1,CTGAGTCTCGAATCTCACCT,0,495139
araBp,0.5,1,1,CTGAGCTGCATTGGTAAAAT,0,484102
araBp,0.5,1,1,CTGAGCTAGTGGGGTTCACA,0,516468
araBp,0.5,1,1,CTGAGAAGGGCATTGCTCAC,0,519062
araBp,0.5,1,1,CTGACGTACTATCCGATCAA,0,475847
araBp,0.5,1,1,CTGAAGAACCCTTCTGTTGG,0,504078
araBp,0.5,1,1,CTGAAACCGAAAGTTAAATG,0,497329
araBp,0.5,1,1,CTCTGGCGATTGCGATGCGG,0,524279
araBp,0.5,1,1,CTCTGCTAAGATGGCCTAGA,0,508514
araBp,0.5,1,1,CTCTGCATCCACCCAGTATC,0,514154
araBp,0.5,1,1,CTCTGATCCTTTGGTAGGAC,0,484562
araBp,0.5,1,1,CTCTCGTATTTATGGGGCCG,0,487689
araBp,0.5,1,1,CTCTCCCAGCTTGGGTTACG,0,481537
araBp,0.5,1,1,CTCTAGCGGGATCCAGACGA,0,469432
araBp,0.5,1,1,CTCTAAACCTCATCACATGT,0,518706
araBp,0.5,1,1,CTCGTTAATCGCGGCAGTGT,0,481174
araBp,0.5,1,1,CTCGTGAATAGAATAGAAAG,0,506421
araBp,0.5,1,1,CTCGTCTTACGCCTCGCTAA,0,522469
araBp,0.5,1,1,CTCGGGAGTGGAAACATGCA,0,499196
araBp,0.5,1,1,CTCGGCCTGTCCACGTCTTC,0,524995
araBp,0.5,1,1,CTCGGAGTAGTTTACGCGGA,0,476151
araBp,0.5,1,1,CTCGGAAGTTTGAGTCTCAG,0,494100
araBp,0.5,1,1,CTCGAGTAATATCGCTCAGA,0,499308
araBp,0.5,1,1,CTCCTTTAGTGCCACACCAT,0,499153
araBp,0.5,1,1,CTCCCGGCTGTCATTCCCGA,0,524910
araBp,0.5,1,1,CTCCCGGCTAGACAACAGTA,0,493078
araBp,0.5,1,1,CTCCCGACCGGTGGGCGACC,0,469348
araBp,0.5,1,1,CTCCCATAATTAATCGGCGT,0,476925
araBp,0.5,1,1,CTCCATTGTGGTCACTTTAT,0,514329
araBp,0.5,1,1,CTCCACGATACGGCGGTACG,0,499843
araBp,0.5,1,1,CTCCAATGTTTAGCCACAAG,0,514483
araBp,0.5,1,1,CTCATCACCCCGGGGTTATT,0,481390
araBp,0.5,1,1,CTCATACGGATGTCATATCC,0,476789
araBp,0.5,1,1,CTCAGATTTATGTTTACTGA,0,506917
araBp,0.5,1,1,CTCACGTATCCCACTTTTTT,0,499744
araBp,0.5,1,1,CTCACCCCCACATATCCTCC,0,524312
araBp,0.5,1,1,CTCAAGGTAAGGTATATCAT,0,510948
araBp,0.5,1,1,CTCAACTTCAAGGTCCTGGA,0,502605
araBp,0.5,1,1,CTCAACATCTGGTCGTGCTT,0,521040
araBp,0.5,1,1,CTATTCCGAACGCCGGGTAC,0,468056
araBp,0.5,1,1,CTATGGGCCAGGACTGGCTT,0,518933
araBp,0.5,1,1,CTATCACACGGAGTAGGTAC,0,480069
araBp,0.5,1,1,CTATATCTATTTACGGCTTG,0,518295
araBp,0.5,1,1,CTATACGAGCCAAGCCAGAT,0,503705
araBp,0.5,1,1,CTAGTTCCACTGGCTACAGA,0,472377
araBp,0.5,1,1,CTAGGTGTGCTCCCAGGGAG,0,480819
araBp,0.5,1,1,CTAGGTGCTGGGACATGTAC,0,493100
araBp,0.5,1,1,CTAGGTGACTTCGCCTCGTC,0,503721
araBp,0.5,1,1,CTAGGGGCCGCGGGGACAGG,0,486979
araBp,0.5,1,1,CTAGGCAACCTGTACTTAAA,0,472875
araBp,0.5,1,1,CTAGCTGTACTTACTTAGAA,0,470019
araBp,0.5,1,1,CTACTCTGTGGAAACGCTGC,0,488280
araBp,0.5,1,1,CTACTACTGTGTGGAACGAC,0,481867
araBp,0.5,1,1,CTACGGAGTGACCAAGTGCC,0,497713
araBp,0.5,1,1,CTACGGACTTAGCCGGTGGT,0,525476
araBp,0.5,1,1,CTACGATCCCGGTCGCGCCC,0,523385
araBp,0.5,1,1,CTACGAATGATCACGTCTTT,0,475895
araBp,0.5,1,1,CTACGAAAAGAAAACACCCT,0,497675
araBp,0.5,1,1,CTACCACCCAAGTATTGCGA,0,487599
araBp,0.5,1,1,CTAATCTATGCAGGTTGGAG,0,487125
araBp,0.5,1,1,CTAAGTGGAATTGTTATGGC,0,470415
araBp,0.5,1,1,CTAACCTCTTCAGTGCCCCG,0,482761
araBp,0.5,1,1,CTAACACCCAGGCTCTCGTT,0,476887
araBp,0.5,1,1,CTAACAAGTCATGCAATTAC,0,507400
araBp,0.5,1,1,CTAAATTAGCTCGGAGCAAG,0,525222
araBp,0.5,1,1,CTAAATAATAAAGTACTGGA,0,510184
araBp,0.5,1,1,CGTTTTGTGAGAGACTGCAT,0,506449
araBp,0.5,1,1,CGTTTATTCTTTGTGTTCAC,0,471231
araBp,0.5,1,1,CGTTGCATTGCCTACCGATT,0,524218
araBp,0.5,1,1,CGTTGAGCTCTTCCACTGCG,0,514358
araBp,0.5,1,1,CGTTGAGCATTTGCAACCTC,0,467926
araBp,0.5,1,1,CGTTCCATCGTGGTCATGAC,0,523763
araBp,0.5,1,1,CGTTCAGGTACGGGTGCCCC,0,504926
araBp,0.5,1,1,CGTTATTGAAAGCGTTGTTT,0,508371
araBp,0.5,1,1,CGTTACTCGCTGAACTTTCT,0,500539
araBp,0.5,1,1,CGTTACGTGTAGTAGTTCTG,0,518750
araBp,0.5,1,1,CGTTACGGATGCCAGCAAGT,0,469346
araBp,0.5,1,1,CGTGTTCTACCGCTGACTAT,0,499642
araBp,0.5,1,1,CGTGTCGTCTTGTACTTCTA,0,503947
araBp,0.5,1,1,CGTGTCGGTTCCTACAAAAA,0,514713
araBp,0.5,1,1,CGTGGTCAACAATCGGACTA,0,503974
araBp,0.5,1,1,CGTGGTAGGGGGGCGGTCTA,0,479185
araBp,0.5,1,1,CGTGGGGCCTTTGGCAAGAT,0,480782
araBp,0.5,1,1,CGTGCTGTACAGTAAGGGTT,0,521386
araBp,0.5,1,1,CGTGCTCTCCTATGCAGCGG,0,509371
araBp,0.5,1,1,CGTGCCTGCCTCGAGGACCC,0,516180
araBp,0.5,1,1,CGTGCCTCCTGTCTCTGGCT,0,498067
araBp,0.5,1,1,CGTGCCCGGATGTACATACG,0,512056
araBp,0.5,1,1,CGTGCAAAACGAAGTCCGTG,0,515704
araBp,0.5,1,1,CGTGAGGTGTCTAATTGTAT,0,471103
araBp,0.5,1,1,CGTGAGCCTAACTTTGGAGT,0,499512
araBp,0.5,1,1,CGTCTTGTGATCCGTTGGAT,0,512463
araBp,0.5,1,1,CGTCTGCTAGGTGACGTATA,0,504245
araBp,0.5,1,1,CGTCTGAAGCCGATTTAGGG,0,471842
araBp,0.5,1,1,CGTCTAAAAGTCTGGAGCAG,0,496148
araBp,0.5,1,1,CGTCGTCGTGTGAATTTCTT,0,507411
araBp,0.5,1,1,CGTCGGGTTCACACGCAGTG,0,483703
araBp,0.5,1,1,CGTCCCCCAGCATCCCTCTT,0,482402
araBp,0.5,1,1,CGTCATTCCAATAGCAATCC,0,477701
araBp,0.5,1,1,CGTCATCCGTGGGAAGCTCA,0,494277
araBp,0.5,1,1,CGTCATAAAGAGTCAAGTCC,0,511889
araBp,0.5,1,1,CGTATGGGCCGCGACGAGGA,0,499475
araBp,0.5,1,1,CGTATGGACCAAGTCGGAAA,0,502221
araBp,0.5,1,1,CGTATGATACAGACCCGTCG,0,502623
araBp,0.5,1,1,CGTAGTTTCTTGAGTCCTAC,0,508220
araBp,0.5,1,1,CGTAGGTGAGATAGGTCGAT,0,504694
araBp,0.5,1,1,CGTAGAAACGGGAGGTAGTT,0,495473
araBp,0.5,1,1,CGTACTAATCCTTGTGATCT,0,478804
araBp,0.5,1,1,CGTAATCGTTCCTCGTCGAA,0,515566
araBp,0.5,1,1,CGTAAGGCAGGTTATAACTC,0,476793
araBp,0.5,1,1,CGTAAATGGTACCGTTACAT,0,502363
araBp,0.5,1,1,CGTAAAACCAACGCGTTCTA,0,497094
araBp,0.5,1,1,CGGTTTCCGACCTCTGGGGG,0,478823
araBp,0.5,1,1,CGGTTGGGCGCCGCACGTTT,0,500613
araBp,0.5,1,1,CGGTTCCATAAAGTGACCCT,0,478310
araBp,0.5,1,1,CGGTTAATGTTTAGGTGGTC,0,478479
araBp,0.5,1,1,CGGTGGTTTCGTCAAACATT,0,499498
araBp,0.5,1,1,CGGTGGGTCGTCTCAACAAT,0,522778
araBp,0.5,1,1,CGGTGGGCAGGGCACCATAT,0,485175
araBp,0.5,1,1,CGGTGATGCACCTAACAGAA,0,523923
araBp,0.5,1,1,CGGTCTAATGTTTAAAGCCA,0,474230
araBp,0.5,1,1,CGGTCGCAAAAACTACCCGG,0,521743
araBp,0.5,1,1,CGGTCCAACTGATGCGCAAA,0,521606
araBp,0.5,1,1,CGGTATACCAGACATGTCAT,0,486138
araBp,0.5,1,1,CGGTAGATCGAGGAGGGAGG,0,470191
araBp,0.5,1,1,CGGTAGAGGCGGGCGAGTAA,0,467831
araBp,0.5,1,1,CGGTAATCCTCAGAAAGGTG,0,509568
araBp,0.5,1,1,CGGGTTAACCGAGTCGGCAG,0,494087
araBp,0.5,1,1,CGGGTGTCTGCGTAGTTGAT,0,518174
araBp,0.5,1,1,CGGGTGGTACCATGGTCGTT,0,497962
araBp,0.5,1,1,CGGGTGCACCAAGGCCGCAT,0,512836
araBp,0.5,1,1,CGGGGGCGGAAGGTCATTCA,0,520143
araBp,0.5,1,1,CGGGGCTTGAAGATGGAGGT,0,485873
araBp,0.5,1,1,CGGGGAGCCCCTAGTCTAGC,0,503112
araBp,0.5,1,1,CGGGCTGTGCTAGTCTAGAG,0,474545
araBp,0.5,1,1,CGGGCGTGAAAAGACTAATG,0,487536
araBp,0.5,1,1,CGGGCGTAGTAAACGGTCCA,0,511961
araBp,0.5,1,1,CGGGCGGTTGGATCCGTCAT,0,497213
araBp,0.5,1,1,CGGGCGACACCACCTAGGTT,0,492976
araBp,0.5,1,1,CGGGCCCTCGCAAATGTCGC,0,513400
araBp,0.5,1,1,CGGGCAGCAGTGACACGCGT,0,481216
araBp,0.5,1,1,CGGGCAAGTCGGACCAGGCG,0,469801
araBp,0.5,1,1,CGGGCAAGATTTTCAGGGGT,0,471867
araBp,0.5,1,1,CGGGATGGGCAAACGACCGC,0,489700
araBp,0.5,1,1,CGGCTCGGGGGCGTTTTTGT,0,499918
araBp,0.5,1,1,CGGCTACGCAACAGTTCTTT,0,499665
araBp,0.5,1,1,CGGCCTGACCAAAAGCGAAT,0,519692
araBp,0.5,1,1,CGGCCGCTGTAATCGATTGT,0,511044
araBp,0.5,1,1,CGGCCGCCAGTACCACCCTA,0,498655
araBp,0.5,1,1,CGGCCCGTCAGCAAAACCAA,0,471194
araBp,0.5,1,1,CGGCCCAACGGAGGCTGGCC,0,468279
araBp,0.5,1,1,CGGCCAACAATACCTCTGAA,0,477180
araBp,0.5,1,1,CGGCCAAAAAATGAATGTGT,0,504842
araBp,0.5,1,1,CGGCAGGATGCAACTTCATC,0,494233
araBp,0.5,1,1,CGGCACGGCTGGGCAATACT,0,518523
araBp,0.5,1,1,CGGCAATCGAGTTCCAGTAG,0,494338
araBp,0.5,1,1,CGGATACTGGGGGCCGTGAC,0,522973
araBp,0.5,1,1,CGGAGTCTTCATAGCTCATA,0,507584
araBp,0.5,1,1,CGGACGCTAATGGCTATTCT,0,493620
araBp,0.5,1,1,CGGAATGCGTCGATGGATCG,0,502184
araBp,0.5,1,1,CGGAATCCCGGTTCGAAGCA,0,483413
araBp,0.5,1,1,CGGAACGTGGGAGCTCATGA,0,479052
araBp,0.5,1,1,CGGAAAAGGTCCACCTCGTA,0,495492
araBp,0.5,1,1,CGCTTTTGCCCGGCTGGCCG,0,517838
araBp,0.5,1,1,CGCTTGGTACGCCAATCGCG,0,509241
araBp,0.5,1,1,CGCTTCGGCAGGTTGCCCAA,0,477852
araBp,0.5,1,1,CGCTTATGGCTACCCTCTGG,0,497838
araBp,0.5,1,1,CGCTTAGGAGGGCCATCGTA,0,475896
araBp,0.5,1,1,CGCTCTTGTCGGGCAAGAAC,0,482312
araBp,0.5,1,1,CGCTAGAAATTTCACGATCA,0,503636
araBp,0.5,1,1,CGCGTAGGTAGTAGGAAACA,0,516617
araBp,0.5,1,1,CGCGGTATTCTATGTGAACA,0,523011
araBp,0.5,1,1,CGCGCGTTACTGCGGCGGAA,0,483992
araBp,0.5,1,1,CGCGCCGTTAATTACAAATC,0,475421
araBp,0.5,1,1,CGCGCAGCTTGGGGACCGTA,0,477493
araBp,0.5,1,1,CGCGATAGGTTAATACGGCA,0,471447
araBp,0.5,1,1,CGCGAACAAGACGAGTACCT,0,518653
araBp,0.5,1,1,CGCCGTAATGGTGTCCTATC,0,518403
araBp,0.5,1,1,CGCCCTGGAAATCGCTATGA,0,502914
araBp,0.5,1,1,CGCCATTATATAAATCTCTA,0,483625
araBp,0.5,1,1,CGCCATATTCGACCGTCCTG,0,520945
araBp,0.5,1,1,CGCCAGAATTAAGGGTAACT,0,519710
araBp,0.5,1,1,CGCATGCAGCTAATGAAACT,0,472180
araBp,0.5,1,1,CGCATCCACAGGTTCGCTGC,0,494588
araBp,0.5,1,1,CGCAGTGGGATGATTAATTG,0,517618
araBp,0.5,1,1,CGCAGTGACCTAAGGAGACC,0,496502
araBp,0.5,1,1,CGCAGAAGTCATGAATGATA,0,512344
araBp,0.5,1,1,CGCACTGATCCCGGCAACTC,0,493128
araBp,0.5,1,1,CGCAAGCGATATAGCGCAAA,0,480220
araBp,0.5,1,1,CGATCGTACGGTAACTCCCT,0,510148
araBp,0.5,1,1,CGATCGGCACGGCACGTGGT,0,478313
araBp,0.5,1,1,CGATCCTCCCGGTAACCTCA,0,492724
araBp,0.5,1,1,CGATCACACAGAGATGGTCG,0,493707
araBp,0.5,1,1,CGATAGCGACCGATAAATAG,0,469893
araBp,0.5,1,1,CGATAGCATGAGCACACCGT,0,491118
araBp,0.5,1,1,CGATACAGGCCGCTGGTCTG,0,499213
araBp,0.5,1,1,CGAGTTGCCACGCGATCGCT,0,471993
araBp,0.5,1,1,CGAGTCAGGAAACGAAAGGT,0,484215
araBp,0.5,1,1,CGAGGTACTACGGTACCCCA,0,471502
araBp,0.5,1,1,CGAGGCTCGGATATACTCAC,0,513630
araBp,0.5,1,1,CGAGGCATATGCAGGGACTT,0,476292
araBp,0.5,1,1,CGAGGATCAAATCCTTGAGA,0,499390
araBp,0.5,1,1,CGAGGAGCATAAACGCGCTA,0,516677
araBp,0.5,1,1,CGAGCAGGCCGCGGTCCTGA,0,514626
araBp,0.5,1,1,CGACTAAGGCAGCGGTATCT,0,474457
araBp,0.5,1,1,CGACGTTCAGTGTGCGAGCA,0,504830
araBp,0.5,1,1,CGACGAAGTACTGGGCAGTT,0,512417
araBp,0.5,1,1,CGACGAAACGGTCACCTAGG,0,492624
araBp,0.5,1,1,CGACCGGATAATGGAAGCGT,0,491539
araBp,0.5,1,1,CGACCCAGAATACCAGCGCC,0,512241
araBp,0.5,1,1,CGACCATTTGGAACAAGGTA,0,524831
araBp,0.5,1,1,CGACATTCGTTTACCACACC,0,506137
araBp,0.5,1,1,CGAATTCATAAAGATATTGA,0,497971
araBp,0.5,1,1,CGAAGTTATAAACCACGTTT,0,482645
araBp,0.5,1,1,CGAACCAATCAAAGTCTTCA,0,523805
araBp,0.5,1,1,CGAAATGGACGCATTTCCTT,0,516121
araBp,0.5,1,1,CCTTTGGTTACGAAATCTAA,0,516896
araBp,0.5,1,1,CCTTGTGATGACTGCCCGCC,0,476843
araBp,0.5,1,1,CCTTGTATTTAAAATGCGGG,0,488587
araBp,0.5,1,1,CCTTGGCCGACAGACTCAGG,0,481291
araBp,0.5,1,1,CCTTGAATTGGGTGCGCCCC,0,522436
araBp,0.5,1,1,CCTTCCCTATGAGGGGCGGC,0,503560
araBp,0.5,1,1,CCTTAGTGGCCTATTCGACC,0,487538
araBp,0.5,1,1,CCTTAAGAGCTGCGTGCAGC,0,502932
araBp,0.5,1,1,CCTGCTTTATCGTGTTCCAA,0,503925
araBp,0.5,1,1,CCTGCCTTCGGGATATCAGG,0,477192
araBp,0.5,1,1,CCTCTTCCGGATTTCTACTT,0,496426
araBp,0.5,1,1,CCTCTCGGTTCCCCATCTGA,0,522761
araBp,0.5,1,1,CCTCGTGAGAATCGTATAAA,0,509353
araBp,0.5,1,1,CCTCGGTTAGAGCGTAATCG,0,506039
araBp,0.5,1,1,CCTCGGGAGCTCCAAGGAAT,0,501492
araBp,0.5,1,1,CCTCCTGCTGGGTGCAGGCG,0,521833
araBp,0.5,1,1,CCTCCCCGTAATGGTCGCAG,0,508393
araBp,0.5,1,1,CCTCAATAAGGTTCTACGTA,0,482579
araBp,0.5,1,1,CCTATCGTTTGACGGAAGGA,0,472844
araBp,0.5,1,1,CCTAGGGCCTACGCTGAAGA,0,505710
araBp,0.5,1,1,CCTAGGGCCAATCTAGACGA,0,483728
araBp,0.5,1,1,CCTAGATACAGTGGCTGAGA,0,470930
araBp,0.5,1,1,CCTACCATTACCAGGTGGCA,0,469642
araBp,0.5,1,1,CCTACCACCAAAAGAGCCAT,0,478229
araBp,0.5,1,1,CCTACATTCTTTGGTGTACT,0,511290
araBp,0.5,1,1,CCTACAAAGCGGGCCTGCAG,0,518934
araBp,0.5,1,1,CCTAACTTATCGCTAGTCGA,0,484670
araBp,0.5,1,1,CCTAACGTAAACGCCTCACA,0,510042
araBp,0.5,1,1,CCGTTTTTAGGGTTACATAT,0,486905
araBp,0.5,1,1,CCGTGTGCGATTATGTGGTT,0,490387
araBp,0.5,1,1,CCGTGGGTTTAGAGCGAAAA,0,479802
araBp,0.5,1,1,CCGTGAGACGTTAATGTGCT,0,521662
araBp,0.5,1,1,CCGTCCTTAAAATTATATCG,0,519917
araBp,0.5,1,1,CCGTCAGAAGATTCTTGAGT,0,470145
araBp,0.5,1,1,CCGTACTTTCTAATGGGTAC,0,495124
araBp,0.5,1,1,CCGTACTTGTGACCCTTTCT,0,521076
araBp,0.5,1,1,CCGGTTGCGGCCTTGGGGTT,0,507156
araBp,0.5,1,1,CCGGTTGATCCCAGGGATAG,0,479544
araBp,0.5,1,1,CCGGTGGCACTTCAAACACT,0,524582
araBp,0.5,1,1,CCGGGGTGCACCGCCCATAT,0,478576
araBp,0.5,1,1,CCGGGCCATAAATGCACGGG,0,499359
araBp,0.5,1,1,CCGGGAAGTAACCGCAGGCT,0,490274
araBp,0.5,1,1,CCGGCTGATGTGGCCAGGCG,0,501958
araBp,0.5,1,1,CCGGCCTACACTCCGGCGTT,0,518632
araBp,0.5,1,1,CCGGCCGTTAAGACAATAAA,0,475181
araBp,0.5,1,1,CCGGCATGGTGCTAGCAAAC,0,515263
araBp,0.5,1,1,CCGGATGTCGCAGATCGCAA,0,492378
araBp,0.5,1,1,CCGGACCTCCTGGGGTCTTT,0,487216
araBp,0.5,1,1,CCGGAAACGTAGGATGGGTC,0,475777
araBp,0.5,1,1,CCGGAAAAGCATGTCTACGG,0,499685
araBp,0.5,1,1,CCGCTATGCTGTACGTAGCC,0,468807
araBp,0.5,1,1,CCGCTATCCCCAGAATGTTT,0,478846
araBp,0.5,1,1,CCGCTACAGGGGCTTAAGGT,0,499687
araBp,0.5,1,1,CCGCGGAGGAGTTGTTGGGT,0,501780
araBp,0.5,1,1,CCGCGGAGCGTAACAGCTTC,0,474924
araBp,0.5,1,1,CCGCGCTGTCCGTAATGGCT,0,496580
araBp,0.5,1,1,CCGCGCCCTGGTTGCGAAGA,0,469944
araBp,0.5,1,1,CCGCCGTGGAATGCAAACTT,0,494149
araBp,0.5,1,1,CCGCCGGTGCCCGTCAACTA,0,511848
araBp,0.5,1,1,CCGCCGCTTGCATTTGGGCA,0,507595
araBp,0.5,1,1,CCGCCCGGAGACGCGTTACA,0,488611
araBp,0.5,1,1,CCGAGTGGCCGAGCCTCGTT,0,506658
araBp,0.5,1,1,CCGAGTACGTGTTTGTCGGG,0,496919
araBp,0.5,1,1,CCGACAATATGACTGCCATA,0,507685
araBp,0.5,1,1,CCGAACACCTTCATCGGCTA,0,501986
araBp,0.5,1,1,CCCTTTTGGCAACCTGGATT,0,483833
araBp,0.5,1,1,CCCTTGTTCCTGAGCCCGGT,0,487372
araBp,0.5,1,1,CCCTTGTGTTTAACACTGGG,0,518870
araBp,0.5,1,1,CCCTTCCCGTTTCCGCCCCT,0,506145
araBp,0.5,1,1,CCCTGTACAGACGTGAGGAT,0,502620
araBp,0.5,1,1,CCCTGTACAATTCTACGCCA,0,473040
araBp,0.5,1,1,CCCTGCCCAGAGGTCAGGAT,0,482849
araBp,0.5,1,1,CCCTCTTTTCAGTGACTACT,0,514728
araBp,0.5,1,1,CCCTCCTTACACATGTTACC,0,492226
araBp,0.5,1,1,CCCTCCAAGGTCATGATGTC,0,487727
araBp,0.5,1,1,CCCTCAATGCGCGCACCAGG,0,517027
araBp,0.5,1,1,CCCTACTTCTAAGATATAGT,0,502881
araBp,0.5,1,1,CCCTAATTGCTCGCGCGGCA,0,503065
araBp,0.5,1,1,CCCGTTTCATGTAAAGGGGA,0,502740
araBp,0.5,1,1,CCCGTGTCCCGAAACCTGGT,0,477647
araBp,0.5,1,1,CCCGTCTAGTATCGGGTGGC,0,499079
araBp,0.5,1,1,CCCGTCCTTGTCGAGTGCGT,0,486327
araBp,0.5,1,1,CCCGGTGGAAAAGCGCAGGC,0,507998
araBp,0.5,1,1,CCCGGCCTCTGCTATAATGT,0,500394
araBp,0.5,1,1,CCCGGCAACGGAGGAGGTAA,0,510440
araBp,0.5,1,1,CCCGCTCGACCATGTCGCTA,0,498518
araBp,0.5,1,1,CCCGAATATGGAGTATCCAT,0,498631
araBp,0.5,1,1,CCCGAAAGAAACCCTATGTT,0,475749
araBp,0.5,1,1,CCCCCTGCAAGAGCTCCCGT,0,477962
araBp,0.5,1,1,CCCCCGTCAAGAACAATGTA,0,476355
araBp,0.5,1,1,CCCCCCCTGCAAACCGGGAC,0,505809
araBp,0.5,1,1,CCCCCACATAGGTTAGCAAA,0,482346
araBp,0.5,1,1,CCCCAGGGCCACAGGGCGTC,0,517124
araBp,0.5,1,1,CCCATTGGAGAAAGCATTCA,0,472643
araBp,0.5,1,1,CCCATGGATAAAGGTGGCGC,0,479713
araBp,0.5,1,1,CCCATCGGCCACAAGAAATC,0,490751
araBp,0.5,1,1,CCCATCCACTCAGTCAGCAC,0,480651
araBp,0.5,1,1,CCCAGGTCGGCTTGTCAATT,0,513479
araBp,0.5,1,1,CCCAGCCCTGACTAGCGGCA,0,515757
araBp,0.5,1,1,CCCACATCTGCTATGCTTAC,0,496253
araBp,0.5,1,1,CCCAATCGCTTTATGGATAT,0,498006
araBp,0.5,1,1,CCCAAGAAATGATAGACAGC,0,495045
araBp,0.5,1,1,CCATTTGTGGCCACCATCGA,0,487000
araBp,0.5,1,1,CCATTTCGTCGTATGTTAGA,0,493664
araBp,0.5,1,1,CCATTTAAACGTTCTAAAAC,0,502250
araBp,0.5,1,1,CCATTGTTTAATACTAGCAA,0,520088
araBp,0.5,1,1,CCATTGTTACTACTTATTCA,0,489540
araBp,0.5,1,1,CCATTATGGGAGATGCAAGT,0,497964
araBp,0.5,1,1,CCATGGGTCTGACCAACCTC,0,484398
araBp,0.5,1,1,CCATCCCACGCCACAGTCAA,0,479599
araBp,0.5,1,1,CCATCCACGTCAAATCAGTG,0,476143
araBp,0.5,1,1,CCAGGCCTACTTCGTGTCAA,0,505201
araBp,0.5,1,1,CCAGCTTGCCTGAGGTATCT,0,478746
araBp,0.5,1,1,CCAGCTGTGCTTTGGACATA,0,521581
araBp,0.5,1,1,CCAGCGTCATAACACCGTAC,0,470570
araBp,0.5,1,1,CCAGCAGGCTCATAATTCGT,0,478570
araBp,0.5,1,1,CCAGAGATCATAAACTCCTG,0,480346
araBp,0.5,1,1,CCAGACACTCTTAGTCTTAT,0,501812
araBp,0.5,1,1,CCAGAATGGGAACACGAACG,0,501866
araBp,0.5,1,1,CCACTGTTTCTGCTGTAGTG,0,500564
araBp,0.5,1,1,CCACTCTTGGCCGACGGTTC,0,524003
araBp,0.5,1,1,CCACTCCGGTCCTCCGGCTG,0,505945
araBp,0.5,1,1,CCACTAATTCACTCGTTGCC,0,478390
araBp,0.5,1,1,CCACGGATGGTGTTAAATTA,0,498918
araBp,0.5,1,1,CCACCTTTGCCCCGAGTTTC,0,514076
araBp,0.5,1,1,CCACCTTTGAGAAGATTGGT,0,492746
araBp,0.5,1,1,CCACCTTGTCAGCCCAGTCG,0,515231
araBp,0.5,1,1,CCACCTGAGTTTGAAGCTGC,0,482640
araBp,0.5,1,1,CCACCGTCATGGCGCACTGA,0,521628
araBp,0.5,1,1,CCACCACGCACTCATTTAAC,0,468196
araBp,0.5,1,1,CCACCAATTAAAATTAGTCA,0,513465
araBp,0.5,1,1,CCACATAAAGGAGATCAAAA,0,494312
araBp,0.5,1,1,CCAATTGGGTCTATTGTGGT,0,494735
araBp,0.5,1,1,CCAAGTAACATGTCTGCCAC,0,496576
araBp,0.5,1,1,CCAAGGTGTACTTCCCGGCA,0,476062
araBp,0.5,1,1,CCAAGGAGAAATAGATCCAC,0,470862
araBp,0.5,1,1,CCAAGCTGTCCAAGTTGTAA,0,517020
araBp,0.5,1,1,CCAAGCGCTGTTTTCGTCCA,0,478322
araBp,0.5,1,1,CCAACCGGGTATGAAAAAGG,0,483963
araBp,0.5,1,1,CCAACATCGAAGGGCCATGG,0,519375
araBp,0.5,1,1,CCAAAGGTGTCGGCGGTCGC,0,509941
araBp,0.5,1,1,CCAAAACTCAACAAGGCGGT,0,492016
araBp,0.5,1,1,CATTTTGAATTTTGACGGGA,0,481598
araBp,0.5,1,1,CATTTTCCCTACGTGTGCTG,0,501468
araBp,0.5,1,1,CATTTTAATTCTATGTATCC,0,474885
araBp,0.5,1,1,CATTTGTCTTGCTTCATATG,0,506684
araBp,0.5,1,1,CATTTATTGAGGGAATCAGC,0,515133
araBp,0.5,1,1,CATTGTGCGCTACTTTTGAC,0,500422
araBp,0.5,1,1,CATTGTACCAGGAATATGCA,0,478200
araBp,0.5,1,1,CATTGGTGAAATAGGATAAA,0,478005
araBp,0.5,1,1,CATTGCCGTGCCAGTCACAA,0,516157
araBp,0.5,1,1,CATTGCCCTAGTCGCGACAC,0,469575
araBp,0.5,1,1,CATTCGACTATCCGCGGTCG,0,492417
araBp,0.5,1,1,CATTCCACTGTTCCATCGGA,0,495903
araBp,0.5,1,1,CATTCATCGTAAAGTCGGAG,0,510657
araBp,0.5,1,1,CATTAGGGGCAGGCGACAAA,0,481773
araBp,0.5,1,1,CATTAGCCCCACTGTGACTC,0,495252
araBp,0.5,1,1,CATTAGAGTATGTAGGGAAA,0,491258
araBp,0.5,1,1,CATTAAGCTGCTTTATCCCT,0,481601
araBp,0.5,1,1,CATGTTCTGTTATGGGGGAT,0,473481
araBp,0.5,1,1,CATGGTACCACGCCGGGGGC,0,475972
araBp,0.5,1,1,CATGGCCGCGCGATCGATGG,0,510677
araBp,0.5,1,1,CATGCTGAGAATGGCCCCGG,0,498681
araBp,0.5,1,1,CATGCTCTAAATACCTCCTC,0,517184
araBp,0.5,1,1,CATGCGATACGCGTGGTGAT,0,493913
araBp,0.5,1,1,CATGCATACCCATGAAACTA,0,502285
araBp,0.5,1,1,CATGAATCGGGGCGGTGCCG,0,487537
araBp,0.5,1,1,CATCTTGAGCGGTGCTGAAG,0,470342
araBp,0.5,1,1,CATCTCTGGTATTCTATCTA,0,480308
araBp,0.5,1,1,CATCTCACTACTTATTGTTT,0,493216
araBp,0.5,1,1,CATCGGCCGTAGTGCAAAAG,0,521433
araBp,0.5,1,1,CATCAGCGACGCTAGTCGTA,0,494886
araBp,0.5,1,1,CATCAGACACCTGGTAAAGG,0,471258
araBp,0.5,1,1,CATCACCGAGTCGGGCGAGT,0,524435
araBp,0.5,1,1,CATATTTCGGCAGGCCAAGG,0,482468
araBp,0.5,1,1,CATATTAGCCTGATAATTAT,0,517414
araBp,0.5,1,1,CATATCACGGCAGATACAAT,0,491009
araBp,0.5,1,1,CATATATTGGAGCCGTGCTT,0,510027
araBp,0.5,1,1,CATATAGGGGGAATACACAG,0,481642
araBp,0.5,1,1,CATATAATGGCAATATCGAG,0,505527
araBp,0.5,1,1,CATATAACGCACTCTAACGT,0,519894
araBp,0.5,1,1,CATAGTTTTGATTGCGTTCG,0,479886
araBp,0.5,1,1,CATAGTGTGCTAATGACTCG,0,506864
araBp,0.5,1,1,CATAGGCCGTGATAGTTGGG,0,488406
araBp,0.5,1,1,CATAGCGCTCTATCGGTGGA,0,470332
araBp,0.5,1,1,CATAGATTTCAAGATCACTC,0,492986
araBp,0.5,1,1,CATACTTTGTTCGAATAATC,0,512519
araBp,0.5,1,1,CATACCTTAACAGTCCTACA,0,516889
araBp,0.5,1,1,CATACCCATCTTCGAAGGAT,0,506102
araBp,0.5,1,1,CATACATTCGTTAGCGCTAT,0,483652
araBp,0.5,1,1,CAGTTTTTCAACGGTCCCCA,0,474399
araBp,0.5,1,1,CAGTTGCAGAGGAGATGTAC,0,490490
araBp,0.5,1,1,CAGTTCTCCTTCGCGGATAG,0,479877
araBp,0.5,1,1,CAGTTCGAAAGGAAGACCTC,0,513668
araBp,0.5,1,1,CAGTTATAACGAAAAATCAA,0,490815
araBp,0.5,1,1,CAGTTAAGCGACATGGGCTC,0,481315
araBp,0.5,1,1,CAGTGGTGAGCAGGAAGGTG,0,500335
araBp,0.5,1,1,CAGTCGTCATACGCTAGTAA,0,499851
araBp,0.5,1,1,CAGTCCGAGCGGAGAAAAAT,0,513996
araBp,0.5,1,1,CAGTCCGAACATCCGGCGTA,0,525102
araBp,0.5,1,1,CAGTCCCCCTTGTGGACACA,0,472840
araBp,0.5,1,1,CAGTCACACCTTAATTATGG,0,503499
araBp,0.5,1,1,CAGGTTGACTCTGAATTCCC,0,471898
araBp,0.5,1,1,CAGGTCTGAAAATAAAGGAT,0,522733
araBp,0.5,1,1,CAGGTCACGGTACTACCCCC,0,515291
araBp,0.5,1,1,CAGGTAGGCAGGCTGTTTAA,0,497937
araBp,0.5,1,1,CAGGTAAGCGTTTCGGCTTG,0,509599
araBp,0.5,1,1,CAGGGCGTGATCCCGCTTAT,0,469964
araBp,0.5,1,1,CAGGGAGAGTCGCCACTGCA,0,503451
araBp,0.5,1,1,CAGGCTTCGCTACTCCCTCA,0,496507
araBp,0.5,1,1,CAGGCGACGCGATCGTCAGG,0,506036
araBp,0.5,1,1,CAGGCCTGACATCAATGAGA,0,502138
araBp,0.5,1,1,CAGGCCGTATCGGTCGCATA,0,488374
araBp,0.5,1,1,CAGGCAGGAGAGTTCAACTT,0,523646
araBp,0.5,1,1,CAGGCAGAGGGTGTAAACAA,0,516097
araBp,0.5,1,1,CAGGCACAATCAACGGTCAA,0,493182
araBp,0.5,1,1,CAGGCAAGGTTCACACCTCC,0,487930
araBp,0.5,1,1,CAGGCAAAAGTCGAGGCGTC,0,489242
araBp,0.5,1,1,CAGGATATATCGCACAACGT,0,505529
araBp,0.5,1,1,CAGGAGGTCGAGGGTGGGAA,0,495408
araBp,0.5,1,1,CAGCTTGGTGAACGCCAAAG,0,479451
araBp,0.5,1,1,CAGCGCTGCGGGGGGAACGA,0,472437
araBp,0.5,1,1,CAGCCTGTGCAAGCCGAGTA,0,514345
araBp,0.5,1,1,CAGCCGTCTGTAAGACTAGG,0,525214
araBp,0.5,1,1,CAGCATAAAACCACAGCTAC,0,481459
araBp,0.5,1,1,CAGCACGCAGAAAACTTCAA,0,497099
araBp,0.5,1,1,CAGCACAGGGGGGATCGAAA,0,509686
araBp,0.5,1,1,CAGCAAGTGGGCCGGTTCGT,0,470246
araBp,0.5,1,1,CAGCAAATGCCGCGTAAGCC,0,503286
araBp,0.5,1,1,CAGATTTATTCTGTGGACCT,0,475044
araBp,0.5,1,1,CAGATTCCTTTGAGCTGACT,0,470196
araBp,0.5,1,1,CAGAGGGAACCCTTGATCAA,0,479384
araBp,0.5,1,1,CAGAGGAGGGGACCCGTTGG,0,511744
araBp,0.5,1,1,CAGACGAGAGGCGATCCGCC,0,495882
araBp,0.5,1,1,CAGACAGTTCATCTGGATCT,0,481877
araBp,0.5,1,1,CAGAACGTAATAGATTCGGA,0,468686
araBp,0.5,1,1,CAGAAACTAAACAACATGCA,0,503023
araBp,0.5,1,1,CACTTTTTTTAGATACCTAA,0,483610
araBp,0.5,1,1,CACTTCACACCCATTGCCTC,0,490441
araBp,0.5,1,1,CACTTAGAGCTCATAAAATT,0,479831
araBp,0.5,1,1,CACTTAAGAGCCAGAGAGCA,0,503318
araBp,0.5,1,1,CACTGGTTGCTCTAGATTCG,0,514963
araBp,0.5,1,1,CACTGGTCGGTGGTATGAGA,0,519568
araBp,0.5,1,1,CACTCTCTTTTCCAAACCAA,0,483289
araBp,0.5,1,1,CACTCCCGTTCAATCACGCT,0,487101
araBp,0.5,1,1,CACTCATCCTCCCTAATGGA,0,484731
araBp,0.5,1,1,CACTAGACATTGAGTGACAC,0,518215
araBp,0.5,1,1,CACGTCCGCGGTTAACAGGC,0,488392
araBp,0.5,1,1,CACGGGCGTATGGGGGCTAA,0,504898
araBp,0.5,1,1,CACGGCGCCCAACCAATTCT,0,507528
araBp,0.5,1,1,CACGCGGTAGACTACTGAGG,0,473509
araBp,0.5,1,1,CACGCGGGGGCTTGCGCATG,0,473691
araBp,0.5,1,1,CACGCACTGTATTCACACTG,0,515116
araBp,0.5,1,1,CACGCACCATTGTTGGTAAA,0,519760
araBp,0.5,1,1,CACGATGCCGGCGTCGAGTG,0,509854
araBp,0.5,1,1,CACCTGTCACCCGGTACTTG,0,518980
araBp,0.5,1,1,CACCGAGTCCCCTGAGACTC,0,494166
araBp,0.5,1,1,CACCGACCGACACGCCAGGC,0,506762
araBp,0.5,1,1,CACCGAAGCGGCCAGTGGCA,0,490179
araBp,0.5,1,1,CACCCTTGAGGGTTCACAGG,0,491039
araBp,0.5,1,1,CACCCGCACATAGAACAGGA,0,493464
araBp,0.5,1,1,CACCAGATATCTTGTTGGAT,0,517258
araBp,0.5,1,1,CACATTCAAGCGTGGCCCTG,0,494141
araBp,0.5,1,1,CACAGGGCCAGGGCATGCTA,0,516711
araBp,0.5,1,1,CACACGTAGCGACTGGTTCT,0,492142
araBp,0.5,1,1,CACACCAGTGGTCCCGGCGG,0,488328
araBp,0.5,1,1,CACACAAAACTGAGGCATGT,0,492350
araBp,0.5,1,1,CACAATATAGCCTCTACGCT,0,484857
araBp,0.5,1,1,CAATTTACCTTGAGCATCGT,0,468318
araBp,0.5,1,1,CAATTCCTACCGTAGACTTC,0,516153
araBp,0.5,1,1,CAATTCACTGACCGTATTCG,0,516589
araBp,0.5,1,1,CAATGTGGTGAAGCCTCGGA,0,497599
araBp,0.5,1,1,CAATGCTGCAGATGTCCTTT,0,516197
araBp,0.5,1,1,CAATGCCAAGGGTGAGACCC,0,485774
araBp,0.5,1,1,CAATCTGCCCAGATGGCTGC,0,505052
araBp,0.5,1,1,CAATCTCGAGAATTGACTTT,0,491280
araBp,0.5,1,1,CAATCGACATGGGGCACTAT,0,487700
araBp,0.5,1,1,CAATAGCTCGTTGAGCCATA,0,501389
araBp,0.5,1,1,CAATAGACAGTTACAAAATG,0,517971
araBp,0.5,1,1,CAAGTTAAGGGGGTGGCAAG,0,472565
araBp,0.5,1,1,CAAGTGTTTGATTTAGACCA,0,470111
araBp,0.5,1,1,CAAGTCTACGGGGAGGACAA,0,513485
araBp,0.5,1,1,CAAGGCTGGGAAGTGTACTG,0,496595
araBp,0.5,1,1,CAAGGCGCCACTCGCAGTCT,0,468276
araBp,0.5,1,1,CAAGCGGTACATAGGTTATG,0,506798
araBp,0.5,1,1,CAAGCCTTTCCTGGGATCGC,0,471832
araBp,0.5,1,1,CAAGAAGGCACCAGGTGTGT,0,500950
araBp,0.5,1,1,CAAGAACAAATTAAACTCGG,0,525093
araBp,0.5,1,1,CAACTTAACCTTATTCCGCG,0,515092
araBp,0.5,1,1,CAACTGTCGTACAGTTTTCA,0,499067
araBp,0.5,1,1,CAACTCAGAATCGTCTTCGA,0,502338
araBp,0.5,1,1,CAACTAAAGCACAGGATATA,0,511391
araBp,0.5,1,1,CAACGTGGAATGTAAAGGAC,0,497920
araBp,0.5,1,1,CAACCTAGTCAATGTCTCAC,0,519639
araBp,0.5,1,1,CAACCAGATAGTTCGTAGCT,0,470958
araBp,0.5,1,1,CAACATCGCTGGGCAAGTGA,0,468004
araBp,0.5,1,1,CAACAGGATCCTCTAGAGTT,0,523713
araBp,0.5,1,1,CAACAAACGTGGTTGCACTA,0,487416
araBp,0.5,1,1,CAAATTGTACGAGTCTCGCA,0,519523
araBp,0.5,1,1,CAAATTAGTTAGCGCCTCCC,0,505941
araBp,0.5,1,1,CAAATCGTATATAACGACCT,0,482594
araBp,0.5,1,1,CAAATAAACCCGTTTCCGTC,0,502969
araBp,0.5,1,1,CAAACTTACGGCAATAGTTG,0,498652
araBp,0.5,1,1,CAAACTATCGAGATCACGGT,0,493581
araBp,0.5,1,1,CAAACACATTATAAACACGA,0,523984
araBp,0.5,1,1,CAAAATTATTCATACTGGTG,0,485193
araBp,0.5,1,1,CAAAACGTCCTTATGCGTAA,0,484093
araBp,0.5,1,1,CAAAACGGCCACGACGCCCG,0,521754
araBp,0.5,1,1,CAAAACCGGGTCGGTATCGT,0,475092
araBp,0.5,1,1,ATTTTTGTTTGCGTTAGCTT,0,503083
araBp,0.5,1,1,ATTTTTAAGCCGTTTGTGAG,0,523531
araBp,0.5,1,1,ATTTTGGACCCTGCGTGCTA,0,474235
araBp,0.5,1,1,ATTTTATGGCAATTACATTC,0,477138
araBp,0.5,1,1,ATTTTAGGGCCATCAAAATA,0,488193
araBp,0.5,1,1,ATTTGTGTTCCGTGGACGCT,0,517917
araBp,0.5,1,1,ATTTGGTATCGGGTTACGAA,0,514213
araBp,0.5,1,1,ATTTGCCTGGGGCTGTGTAC,0,470992
araBp,0.5,1,1,ATTTGACGGGGACAGGAATC,0,468251
araBp,0.5,1,1,ATTTGAACCGTGGGAGGCGA,0,508190
araBp,0.5,1,1,ATTTCTGACGATCGGACGAG,0,473768
araBp,0.5,1,1,ATTGTTAACCGATCGCGTTA,0,504991
araBp,0.5,1,1,ATTGGTCATAACAGCTACAA,0,483898
araBp,0.5,1,1,ATTGGGCTGGAGCTCAGCGG,0,506022
araBp,0.5,1,1,ATTGATTATTCTTTCCGAAT,0,486577
araBp,0.5,1,1,ATTGATGTCAGTTATTGTCG,0,498079
araBp,0.5,1,1,ATTCTCATAGGTCGGAAAAG,0,471354
araBp,0.5,1,1,ATTCGCCAATGGTTACCCCG,0,488652
araBp,0.5,1,1,ATTCCGGCATAATGATGTAA,0,508283
araBp,0.5,1,1,ATTCCCAGCATGTGTGTATC,0,487463
araBp,0.5,1,1,ATTCAATGAACGCTTACCCT,0,494667
araBp,0.5,1,1,ATTCAAAAGATGTCGGGGCA,0,469298
araBp,0.5,1,1,ATTATTTCTGACCTCTTAGT,0,523158
araBp,0.5,1,1,ATTATTCCATACGGTACGGT,0,483253
araBp,0.5,1,1,ATTATGGGTAGCACTCGACA,0,495444
araBp,0.5,1,1,ATTATCGCTAGTGTCCTTTC,0,500319
araBp,0.5,1,1,ATTAGATTGAACGCGCTGTT,0,498630
araBp,0.5,1,1,ATTACCATTTGTGTGGCCTT,0,492357
araBp,0.5,1,1,ATTAATTGTTTTACCCTTTC,0,499941
araBp,0.5,1,1,ATTAATGCTACTTGACACCA,0,507728
araBp,0.5,1,1,ATTAAGAGTACGTTCGAGTT,0,481714
araBp,0.5,1,1,ATTAACGTTTCGCTTAGGTA,0,472909
araBp,0.5,1,1,ATGTTGTTCACCGGAGGATT,0,519476
araBp,0.5,1,1,ATGTTCTGTTGCACAGCTCT,0,472504
araBp,0.5,1,1,ATGTTCGAACAGTCGTTCTG,0,497457
araBp,0.5,1,1,ATGTGTCCGTCACCATACCA,0,485377
araBp,0.5,1,1,ATGTGCTGAGACAGGGAATA,0,501472
araBp,0.5,1,1,ATGTCTTGACTGCTACGGCA,0,524436
araBp,0.5,1,1,ATGTCCTTAGAATCAATTTG,0,497008
araBp,0.5,1,1,ATGTCCACTCTGTTAGAAAT,0,493673
araBp,0.5,1,1,ATGTACGCGCTTACGGGAGA,0,520603
araBp,0.5,1,1,ATGGTCTGTCGTGTTCCAGG,0,469447
araBp,0.5,1,1,ATGGTCGCCATTCTTTAATT,0,490708
araBp,0.5,1,1,ATGGTAGCCAGTCCCCCAAC,0,474460
araBp,0.5,1,1,ATGGTACGCCCTATGTCGGG,0,472665
araBp,0.5,1,1,ATGGGTATCGCAACCCCGGC,0,482418
araBp,0.5,1,1,ATGGGCTGTATCGCTCGCCC,0,489264
araBp,0.5,1,1,ATGGGCTGATGCGGCAACCC,0,524750
araBp,0.5,1,1,ATGGGCTCCGCCATTAAATA,0,479360
araBp,0.5,1,1,ATGGGATGTATTGGTAATGC,0,513377
araBp,0.5,1,1,ATGGGACCATTTGGGACCCT,0,518507
araBp,0.5,1,1,ATGGCTTTGACCATACGTGC,0,501403
araBp,0.5,1,1,ATGGCGTTTCAGTTGAGGTA,0,492204
araBp,0.5,1,1,ATGGCCAATACTGGGTGGAG,0,504833
araBp,0.5,1,1,ATGGAGCCCCCGGCAACTTA,0,489228
araBp,0.5,1,1,ATGGAGCATGCTAAACGTAC,0,470011
araBp,0.5,1,1,ATGGAGAGATTCTCATACTT,0,502929
araBp,0.5,1,1,ATGGACGATGTTCCCGAAAA,0,509823
araBp,0.5,1,1,ATGCTGCGGAAATCTGGATA,0,490254
araBp,0.5,1,1,ATGCTACTCGCTGCATATCT,0,488854
araBp,0.5,1,1,ATGCCTGTAACTTGGCCTCA,0,491407
araBp,0.5,1,1,ATGCCTAAGGTGAGGTGTCT,0,470800
araBp,0.5,1,1,ATGCCACAAACTTCCTTCAT,0,499231
araBp,0.5,1,1,ATGCAATCTATTTTCCGATG,0,515009
araBp,0.5,1,1,ATGCAATACTGGGCGCGAGC,0,511461
araBp,0.5,1,1,ATGCAAGTCAAGTGTAGAGG,0,516178
araBp,0.5,1,1,ATGATTGCCCCCCAGCAACA,0,472491
araBp,0.5,1,1,ATGATAGGTGTCGGTCGCCA,0,505348
araBp,0.5,1,1,ATGAGTTTGCCTGTGAGTTT,0,497541
araBp,0.5,1,1,ATGAGCGCCTTTGTAGTATT,0,492763
araBp,0.5,1,1,ATGACTGTATGCTTGTGACT,0,514725
araBp,0.5,1,1,ATGACGGCTGAACACTTCTA,0,495726
araBp,0.5,1,1,ATGACAGTTAATGCCAGGGT,0,488199
araBp,0.5,1,1,ATGAAGCTTACTCGGCGGCT,0,509837
araBp,0.5,1,1,ATGAAACGGCCACGCTGGTA,0,513782
araBp,0.5,1,1,ATCTTGACCTGCTCTTGCCC,0,489578
araBp,0.5,1,1,ATCTTCGGGTTGTCAGACGT,0,521283
araBp,0.5,1,1,ATCTTCAAGATTATATTCAC,0,470497
araBp,0.5,1,1,ATCTTAATAAACCACAGTGA,0,525061
araBp,0.5,1,1,ATCTGGAATCCTCCGACTGC,0,492674
araBp,0.5,1,1,ATCTGAACAGACCGCTAACA,0,512567
araBp,0.5,1,1,ATCTCTGGCATTCCCTGGGA,0,503248
araBp,0.5,1,1,ATCTCGCGTAACAAAGGTAA,0,480000
araBp,0.5,1,1,ATCTAATCTCTGGCTTGGAC,0,476430
araBp,0.5,1,1,ATCGTACCTATTATTAGCAT,0,483565
araBp,0.5,1,1,ATCGGACTACAGAACAAGGC,0,474243
araBp,0.5,1,1,ATCGCTATGAATCAGGCAGA,0,497366
araBp,0.5,1,1,ATCGAGTTGGCACTACTGGT,0,500733
araBp,0.5,1,1,ATCCTGTTCTGTACTGTACA,0,516226
araBp,0.5,1,1,ATCCTCACAGGGGGTGCACT,0,473381
araBp,0.5,1,1,ATCCGGTTGAGCCATAGTAA,0,508595
araBp,0.5,1,1,ATCCCCCATAGGGAAAGGCA,0,520120
araBp,0.5,1,1,ATCCCATTCGGTTCAAATGT,0,485572
araBp,0.5,1,1,ATCCAGTGGCAGAGACACCA,0,522126
araBp,0.5,1,1,ATCATTAGAATGCGCACATG,0,512413
araBp,0.5,1,1,ATCATCAGGAATGTTTACCT,0,490157
araBp,0.5,1,1,ATCATATGACGCATTGGTAG,0,482749
araBp,0.5,1,1,ATCAGTGCTGAGCAGCTGGG,0,512462
araBp,0.5,1,1,ATCAGTCAGAGGTTGCGGTC,0,514357
araBp,0.5,1,1,ATCAGGACCAATAAAAAAGG,0,521052
araBp,0.5,1,1,ATCAGAAACCTTCGAGTGGC,0,483644
araBp,0.5,1,1,ATCAAGGTGGATGCTCAATA,0,472561
araBp,0.5,1,1,ATCAAAAGGGCTCGTAGTTC,0,480696
araBp,0.5,1,1,ATATTTTGCGAAGTCGTTAT,0,490812
araBp,0.5,1,1,ATATTTCAGTGTATCCGATA,0,512234
araBp,0.5,1,1,ATATGTAGTTGCACCGGCCC,0,503834
araBp,0.5,1,1,ATATGCACTGAATTCACTTT,0,504232
araBp,0.5,1,1,ATATCTGGGATAAGTGTTAC,0,505953
araBp,0.5,1,1,ATATCCTTTAAATAGCCAAC,0,520636
araBp,0.5,1,1,ATATCCCGACTCTCATGACG,0,502401
araBp,0.5,1,1,ATATATTCTTAATTGCCCCA,0,487242
araBp,0.5,1,1,ATATACCAGTTGTCACGGCT,0,522730
araBp,0.5,1,1,ATAGTCAGACACTGGTGTCC,0,496220
araBp,0.5,1,1,ATAGGTCGGACGGTCATCAC,0,515047
araBp,0.5,1,1,ATAGGGGTTTATGCGCCTAC,0,522223
araBp,0.5,1,1,ATAGACGGCAGTCAGTGCAT,0,490374
araBp,0.5,1,1,ATAGACACTATCATTTACCT,0,506037
araBp,0.5,1,1,ATAGAAACAAAAAAGCACTA,0,524904
araBp,0.5,1,1,ATACCCTCGTCGGATTACTC,0,507945
araBp,0.5,1,1,ATAATGCGTATGTTATGGCG,0,511583
araBp,0.5,1,1,ATAAGCTGAACAGTTGATCC,0,477422
araBp,0.5,1,1,ATAACTGTGTGGAGCCATTG,0,512821
araBp,0.5,1,1,ATAACCAGAGGCTTGGCTTC,0,523380
araBp,0.5,1,1,ATAAAAGGAGTTCGCAATGG,0,470931
araBp,0.5,1,1,AGTTTAGCGGATGAGTTACA,0,492232
araBp,0.5,1,1,AGTTTAGACCTCATCCCGGT,0,512694
araBp,0.5,1,1,AGTTGGGCTCACGGGATGTG,0,521383
araBp,0.5,1,1,AGTTGCGCATAATTTGTTAC,0,523558
araBp,0.5,1,1,AGTTGCGCAATCGGGGCAGC,0,518519
araBp,0.5,1,1,AGTTGCCAAAACCGAAGTTC,0,498345
araBp,0.5,1,1,AGTTGCACCATGTTACGTAA,0,501944
araBp,0.5,1,1,AGTTCCCTGGGAGGTTAACC,0,502055
araBp,0.5,1,1,AGTTAGTCCAATCCGCTCAA,0,470978
araBp,0.5,1,1,AGTTAATAGGCTCAGTCGGG,0,486587
araBp,0.5,1,1,AGTTAACGGCTAATATTGTT,0,510582
araBp,0.5,1,1,AGTGTGCCGGAATCCTCCAT,0,469885
araBp,0.5,1,1,AGTGTCATGATTACGTGGGT,0,500365
araBp,0.5,1,1,AGTGTACCAGCTGGCATGAT,0,474181
araBp,0.5,1,1,AGTGGGCACCACTCAAACCT,0,480886
araBp,0.5,1,1,AGTGGATGGCTGCGTTTTAT,0,470966
araBp,0.5,1,1,AGTGCTCGGGCTCCCCGCAT,0,477584
araBp,0.5,1,1,AGTGATTCTATACTCTATAA,0,505674
araBp,0.5,1,1,AGTGATGTGAGGGAATCATC,0,508442
araBp,0.5,1,1,AGTGACTTGATTATTGAAGA,0,517332
araBp,0.5,1,1,AGTCTATCCGTCAATTGTAA,0,503868
araBp,0.5,1,1,AGTCGGAAGTCTCGTCAGAT,0,485686
araBp,0.5,1,1,AGTCGAACTCAGGACGGGCT,0,523723
araBp,0.5,1,1,AGTCCGCTAGCCCCCAACGA,0,491318
araBp,0.5,1,1,AGTCCCGAGTTTCCCTTTGA,0,472918
araBp,0.5,1,1,AGTCCATTACAAGGAAGCGA,0,486784
araBp,0.5,1,1,AGTCACTACGCTAGTTTCCT,0,514480
araBp,0.5,1,1,AGTATTCGACGTGGCGCATC,0,473206
araBp,0.5,1,1,AGTATATGTGTCCGTGCAAC,0,475678
araBp,0.5,1,1,AGTATAAGGGTATATGGGGA,0,499370
araBp,0.5,1,1,AGTATAACCCCATCATAGGC,0,505253
araBp,0.5,1,1,AGTACGTAATGTTGAAGAGA,0,478281
araBp,0.5,1,1,AGTACGACCCAGTATGTTAT,0,496944
araBp,0.5,1,1,AGTACAACCATCCAGGTGTC,0,510831
araBp,0.5,1,1,AGTAAAGCGGTTAGGTGATT,0,513488
araBp,0.5,1,1,AGGTTGAATCTTTGCACGAA,0,507723
araBp,0.5,1,1,AGGTTACCATAGGCCATCTG,0,492672
araBp,0.5,1,1,AGGTGTGCGAATCAGTAGGT,0,513712
araBp,0.5,1,1,AGGTGTAGCATCCGTTGGAC,0,503289
araBp,0.5,1,1,AGGTGGTGTCTTAGGATATT,0,477315
araBp,0.5,1,1,AGGTGGGAACGCGTTAGTTG,0,470671
araBp,0.5,1,1,AGGTGATCAGAGCCCTCAGC,0,492379
araBp,0.5,1,1,AGGTCTTATACCACCATTAG,0,507257
araBp,0.5,1,1,AGGTCTCGGTTTAACCACGG,0,468050
araBp,0.5,1,1,AGGTCGTGGCAGATTGCTGG,0,498881
araBp,0.5,1,1,AGGTCCGTAGGTAACACGGC,0,509139
araBp,0.5,1,1,AGGTCAGTTGAGTCCAATTT,0,470620
araBp,0.5,1,1,AGGTCAAGTGCCGGAGGCCC,0,508837
araBp,0.5,1,1,AGGTCAAGGGATGGTGGGGC,0,478101
araBp,0.5,1,1,AGGTAGTGGGGACGTCGTCT,0,485232
araBp,0.5,1,1,AGGGTACAGATCTTGCGCGT,0,518300
araBp,0.5,1,1,AGGGGTAGTTATTATCTTTT,0,477558
araBp,0.5,1,1,AGGGGGTGCCAGCTAATCAC,0,504310
araBp,0.5,1,1,AGGGGCGGCTCCGCCCGCGA,0,522123
araBp,0.5,1,1,AGGGGCCATATGTTGCGGCA,0,496905
araBp,0.5,1,1,AGGGGAATTCTCATTTAAGA,0,481142
araBp,0.5,1,1,AGGGGAAGGGAGTAATATTG,0,472882
araBp,0.5,1,1,AGGGCAACCTGCCCTTGCAA,0,502106
araBp,0.5,1,1,AGGGAGCGAAGCCCCGAAAA,0,498447
araBp,0.5,1,1,AGGGACTTGCAAGCAAAGTG,0,482525
araBp,0.5,1,1,AGGCTTGCCAGCCGCGAAAT,0,495280
araBp,0.5,1,1,AGGCTCTGATGAGACGCAAG,0,471097
araBp,0.5,1,1,AGGCTCAATGGGCCGACGTT,0,481394
araBp,0.5,1,1,AGGCGTTGTATATCAATTAG,0,491269
araBp,0.5,1,1,AGGCGTCTATTAATCTAGTC,0,500461
araBp,0.5,1,1,AGGCGCACATCTAGAGCTCG,0,501495
araBp,0.5,1,1,AGGCGATGAAGCAATTCAGG,0,500042
araBp,0.5,1,1,AGGCGAGCATGCACAACTTT,0,519103
araBp,0.5,1,1,AGGCGACTGAGGAGATGGTC,0,504567
araBp,0.5,1,1,AGGCCTATCTGTCAGTATGA,0,519706
araBp,0.5,1,1,AGGCCTACTCCCTTACGGCC,0,510562
araBp,0.5,1,1,AGGCCCAGAGTGACAGACTG,0,470798
araBp,0.5,1,1,AGGCCAGCGCGGACAATGCG,0,515425
araBp,0.5,1,1,AGGCAGTGCTTTGGTATCAG,0,499869
araBp,0.5,1,1,AGGCACTTCCATCCGAAAAT,0,521320
araBp,0.5,1,1,AGGCAAACCGAGACCATTAT,0,493994
araBp,0.5,1,1,AGGATCTCTTTCTTTTTGAC,0,490081
araBp,0.5,1,1,AGGATACAGCCAGCTTACTT,0,505634
araBp,0.5,1,1,AGGAGAGCTCTGCCCTGAAG,0,508091
araBp,0.5,1,1,AGGAGAATATACAACTCGGG,0,497629
araBp,0.5,1,1,AGGACTTAAGGGGAGGCCTC,0,508803
araBp,0.5,1,1,AGGACGAGCTATAACCGCCC,0,470175
araBp,0.5,1,1,AGGAAGGAGGGATCAGGAGA,0,479440
araBp,0.5,1,1,AGGAAACACTGGGTCCGCAA,0,483924
araBp,0.5,1,1,AGCTTACCGCTTTCTATGTT,0,514451
araBp,0.5,1,1,AGCTTAAAAGGTATCATTCG,0,480847
araBp,0.5,1,1,AGCTGTCCTCAGACAAGTAT,0,483726
araBp,0.5,1,1,AGCTGGGCGAGTCACAGTCT,0,472805
araBp,0.5,1,1,AGCTGATTGGAGGTTTTCAG,0,476119
araBp,0.5,1,1,AGCTCTTCAGCACAAATGAC,0,510453
araBp,0.5,1,1,AGCTCGAGTGTTCGTGCCGA,0,497004
araBp,0.5,1,1,AGCTCATGGGCCATAGTCAG,0,509943
araBp,0.5,1,1,AGCGTTTCTCCGCATACCTG,0,517307
araBp,0.5,1,1,AGCGTCCGCACAGCTAGGCA,0,488646
araBp,0.5,1,1,AGCGTATATCCGGCCTGATT,0,487300
araBp,0.5,1,1,AGCGGGTATTGCACGTCGGT,0,476958
araBp,0.5,1,1,AGCGGCCCGTCATACCAGGA,0,486928
araBp,0.5,1,1,AGCGCAGGGACGACTAAAAA,0,524581
araBp,0.5,1,1,AGCGAGTCTGCCATTTGGTT,0,491773
araBp,0.5,1,1,AGCCTTAGATTTTACACCAA,0,503282
araBp,0.5,1,1,AGCCTGAGTGCATTAAGCAG,0,474602
araBp,0.5,1,1,AGCCTCAGACTAACGGAGTT,0,500826
araBp,0.5,1,1,AGCCTCAATGGCTCTGACGT,0,510630
araBp,0.5,1,1,AGCCGCCACCGGGCAAACGC,0,488658
araBp,0.5,1,1,AGCCGAACACGGAGTATTAC,0,511659
araBp,0.5,1,1,AGCCCTGTCTTGCTGGTCAG,0,488464
araBp,0.5,1,1,AGCCCGTACGGGACATCTAC,0,493382
araBp,0.5,1,1,AGCCCCAAGTAGCATTGCTT,0,505050
araBp,0.5,1,1,AGCCAGAGTTACGTCTCGTA,0,491586
araBp,0.5,1,1,AGCATTACTGGGGCTTCACG,0,479768
araBp,0.5,1,1,AGCATGGACACATGTAACGT,0,492438
araBp,0.5,1,1,AGCATACGGCACAGGCATTC,0,509352
araBp,0.5,1,1,AGCACGCTCCAGCGAACCGA,0,479273
araBp,0.5,1,1,AGCACCCACCTCGAGGGGAA,0,513146
araBp,0.5,1,1,AGCACCAGAGGATCCTTCAT,0,473706
araBp,0.5,1,1,AGCACATCGCGAATTTGGAT,0,478361
araBp,0.5,1,1,AGCACAGTGTGGATTCCTGA,0,486730
araBp,0.5,1,1,AGATTCGTATATATGACAGC,0,507434
araBp,0.5,1,1,AGATGTTTCCGGGGAATTAG,0,482551
araBp,0.5,1,1,AGATGGCCTTGTCTAGACTG,0,488697
araBp,0.5,1,1,AGATGCCTCGCTGCTAATAC,0,512258
araBp,0.5,1,1,AGATAGAACGCTGGGCCAGA,0,518197
araBp,0.5,1,1,AGATACTCCATCAACATTCG,0,469791
araBp,0.5,1,1,AGATACCCCAATCTCCACAG,0,475666
araBp,0.5,1,1,AGAGTGCTTGCATCCCTCGG,0,521322
araBp,0.5,1,1,AGAGTCTGACTCTCTATCTT,0,488481
araBp,0.5,1,1,AGAGGAGGGGCCTTGAAAAG,0,478936
araBp,0.5,1,1,AGAGGAAAGACGGGCCTTGA,0,490944
araBp,0.5,1,1,AGAGCTTGTCAGACGTCGGG,0,519198
araBp,0.5,1,1,AGAGCGAGCATCATCCGCTA,0,509742
araBp,0.5,1,1,AGAGCATGCATTTTTTTTTG,0,518555
araBp,0.5,1,1,AGAGCATAAAAATTCGGTGA,0,478731
araBp,0.5,1,1,AGAGCACCGGCATCACGGAC,0,491384
araBp,0.5,1,1,AGAGCACAATATCCGCTTTA,0,477143
araBp,0.5,1,1,AGAGATACGAGCCGGTAACA,0,471751
araBp,0.5,1,1,AGACTTCACGTCATTGTAAA,0,515095
araBp,0.5,1,1,AGACTATCACTAGCCTGTTG,0,475357
araBp,0.5,1,1,AGACGTTTAGTACGGCGGCT,0,468051
araBp,0.5,1,1,AGACGGGTTACAAGGCTCCA,0,500527
araBp,0.5,1,1,AGACCTTCCTATGAAAAGTT,0,517780
araBp,0.5,1,1,AGACCGATCAGTGCATGGCC,0,482865
araBp,0.5,1,1,AGACCGAACTCCCGGACCAT,0,476935
araBp,0.5,1,1,AGACACTGGCTCACGAAAAT,0,472177
araBp,0.5,1,1,AGACACGATGACGACGGACA,0,472922
araBp,0.5,1,1,AGACACACAGCTTGTGACCG,0,493318
araBp,0.5,1,1,AGACACAATGATCGGAAGTC,0,484146
araBp,0.5,1,1,AGAATCTACGCGTGATAATT,0,500765
araBp,0.5,1,1,AGAATCGTACCAAAATGAGG,0,511329
araBp,0.5,1,1,AGAATCACCCAGTTGTAAAG,0,499361
araBp,0.5,1,1,AGAACGTTCAGACATTGTGG,0,523714
araBp,0.5,1,1,AGAACGTGCTTACTCGGATA,0,475335
araBp,0.5,1,1,AGAACAGCCGTGAGCGCTGG,0,500073
araBp,0.5,1,1,AGAAACTACCGTTACGAGGC,0,479995
araBp,0.5,1,1,AGAAACGCACATGGTGGTAT,0,522739
araBp,0.5,1,1,ACTTTATACCGGCGAATTCA,0,472650
araBp,0.5,1,1,ACTTTACGTGCAACATACTA,0,508687
araBp,0.5,1,1,ACTTTAACGTCCCATTCGAA,0,507818
araBp,0.5,1,1,ACTTGGTAAGGCATGGGTAA,0,468032
araBp,0.5,1,1,ACTTGGGCCGGCTATCTGGC,0,476118
araBp,0.5,1,1,ACTTGGACTAATACCACCGT,0,487290
araBp,0.5,1,1,ACTTGACGATTTCAGAATAA,0,491087
araBp,0.5,1,1,ACTTCTATTAGACTTAGCCG,0,506711
araBp,0.5,1,1,ACTTCCACTTTACCGCACGT,0,506556
araBp,0.5,1,1,ACTTCAGCGAGAAGGCGTAA,0,496156
araBp,0.5,1,1,ACTTATATGATCTGAATTGC,0,472252
araBp,0.5,1,1,ACTTACCTTCACGGGGCGTC,0,487292
araBp,0.5,1,1,ACTGTTAAATTCCCTCCTTA,0,484246
araBp,0.5,1,1,ACTGGTTAAATTCAGGCTGA,0,499365
araBp,0.5,1,1,ACTGGGGCTTTGGAACGGAC,0,473364
araBp,0.5,1,1,ACTGCTTTGTAGCAGGGACG,0,520585
araBp,0.5,1,1,ACTGCTGTTAAAGGACGCCA,0,517632
araBp,0.5,1,1,ACTGCACGGTGCGCGCAATA,0,473722
araBp,0.5,1,1,ACTGATCTCCGGGTAGCCTC,0,490533
araBp,0.5,1,1,ACTGATAGCTTATCAGATAA,0,514801
araBp,0.5,1,1,ACTGAGTTTATCAGACGGAC,0,483800
araBp,0.5,1,1,ACTGACCCTTACTCGATATA,0,499280
araBp,0.5,1,1,ACTGAAAAAATGACAGATTT,0,517857
araBp,0.5,1,1,ACTCCTCGTGTAAAATACAT,0,479515
araBp,0.5,1,1,ACTCCGCGTGTGCGAGGGCA,0,504707
araBp,0.5,1,1,ACTCCCCACGTATTACCGTT,0,482851
araBp,0.5,1,1,ACTCATGTAATGGAAGTGTT,0,508775
araBp,0.5,1,1,ACTCACTGCGAATCCCTGTT,0,509006
araBp,0.5,1,1,ACTCACCTATACGGTAAGCA,0,504588
araBp,0.5,1,1,ACTCACCTAAGACGGGGGTG,0,484295
araBp,0.5,1,1,ACTATTATTGCGCACAAGAC,0,489874
araBp,0.5,1,1,ACTATGGTGTTGTACAAAGC,0,519231
araBp,0.5,1,1,ACTAGCTTTTACTGAGGGAA,0,497459
araBp,0.5,1,1,ACTACTTAACCTTCGAGTTA,0,505540
araBp,0.5,1,1,ACTACGTTGCACATTGATTA,0,521715
araBp,0.5,1,1,ACTACCCCGTTCGCACTTGC,0,502134
araBp,0.5,1,1,ACGTTTCATCGGGATTGACT,0,477996
araBp,0.5,1,1,ACGTTCATCACTAGGGGGAG,0,518167
araBp,0.5,1,1,ACGTTACCGTTCACCTCGTT,0,487351
araBp,0.5,1,1,ACGTGTCTGATATTATGAGA,0,476372
araBp,0.5,1,1,ACGTCTTGGACCACAGTCCC,0,510517
araBp,0.5,1,1,ACGTAGCTGTGGAAAGCCGG,0,520314
araBp,0.5,1,1,ACGTAGCGAGGATCTTTTGG,0,497468
araBp,0.5,1,1,ACGTAGATGGGAAACGATAT,0,507598
araBp,0.5,1,1,ACGTACCTCGCCAAGCAGAA,0,496686
araBp,0.5,1,1,ACGGTTCATCGCCAATAAGC,0,502684
araBp,0.5,1,1,ACGGTTACACTTTGATAATA,0,492295
araBp,0.5,1,1,ACGGTGAGTATCCTCCACTT,0,513229
araBp,0.5,1,1,ACGGTCTACGAACCCTCGTC,0,475030
araBp,0.5,1,1,ACGGTCATTGTAGGGTTTAC,0,516037
araBp,0.5,1,1,ACGGGTGAACTGGGGGTAGT,0,497626
araBp,0.5,1,1,ACGGGGCTAGCAAAGGTCCT,0,500575
araBp,0.5,1,1,ACGGGGATCAAGCCCGGTCT,0,521854
araBp,0.5,1,1,ACGGGAGAACTAAGCTAATT,0,491529
araBp,0.5,1,1,ACGGCGCGTACACACAGAAG,0,522363
araBp,0.5,1,1,ACGGCCCTAGTGAGCCGAGC,0,487669
araBp,0.5,1,1,ACGGCATAGTCTCCGTACAA,0,489965
araBp,0.5,1,1,ACGGATTTTAGCTCCCTGAT,0,484404
araBp,0.5,1,1,ACGCTGGTTAATCAACGGTA,0,506468
araBp,0.5,1,1,ACGCTACGACGTCGGGGATA,0,500712
araBp,0.5,1,1,ACGCTACACGTTTTATCTGG,0,500402
araBp,0.5,1,1,ACGCGCGCATATAAGAGAGT,0,509335
araBp,0.5,1,1,ACGCCGACGTTTATATCAAT,0,520958
araBp,0.5,1,1,ACGATATGGGGGTCGGCTAA,0,525070
araBp,0.5,1,1,ACGACGGTAGTGGACATCTC,0,508396
araBp,0.5,1,1,ACGAAGGACAAGAGCGACGG,0,523392
araBp,0.5,1,1,ACGAACAACCACCTAGCCCC,0,524269
araBp,0.5,1,1,ACGAAAGCTGTAGCGGGTAC,0,476469
araBp,0.5,1,1,ACGAAAACAATTTTAGGCTA,0,518220
araBp,0.5,1,1,ACCTGTTACCATTTCGTTTC,0,521242
araBp,0.5,1,1,ACCTGTCGGATTTTTTTGAA,0,481520
araBp,0.5,1,1,ACCTGTAGCACTATGATCCC,0,510025
araBp,0.5,1,1,ACCTCGTTCGCTTTTGACTT,0,493612
araBp,0.5,1,1,ACCTCGAGGGCGAAGCTATA,0,522443
araBp,0.5,1,1,ACCTCCGGGCTGAATAAGAC,0,484063
araBp,0.5,1,1,ACCTACTCCGAATCGGGCGC,0,523249
araBp,0.5,1,1,ACCTACTCATCCCGATGTAA,0,501723
araBp,0.5,1,1,ACCGGGTCACCTCCGGGTAT,0,473135
araBp,0.5,1,1,ACCGGGCAGTACACGGAAGA,0,469121
araBp,0.5,1,1,ACCGGGACGTTTTTAGTAAT,0,507202
araBp,0.5,1,1,ACCGCGCTCGCCAACACCTA,0,512789
araBp,0.5,1,1,ACCGATCGACGGGTCCCTTG,0,506693
araBp,0.5,1,1,ACCGAGCTTAGGTTACCGCA,0,483100
araBp,0.5,1,1,ACCGAGAATTTTGGGCTTTC,0,514923
araBp,0.5,1,1,ACCCGTCCACGGATATACCC,0,501002
araBp,0.5,1,1,ACCCCATTAGCAGGGCCGCT,0,487304
araBp,0.5,1,1,ACCCCAAATGGGACTCAAGT,0,482289
araBp,0.5,1,1,ACCCAGGTTGGGTCGTGACA,0,517985
araBp,0.5,1,1,ACCCAACGCAGGCCTACTTA,0,488904
araBp,0.5,1,1,ACCATTTACTTGCAACAATA,0,492605
araBp,0.5,1,1,ACCATCTGTTCTCGATCGCT,0,492236
araBp,0.5,1,1,ACCATATTCATCACTCCAGA,0,494670
araBp,0.5,1,1,ACCATACACGCCCGAAAGTC,0,481203
araBp,0.5,1,1,ACCAGTAGAGGACAGCGGTT,0,497513
araBp,0.5,1,1,ACCACCGAAGTCATTAACGT,0,524589
araBp,0.5,1,1,ACCACATAGCAGCGTGTGAT,0,502044
araBp,0.5,1,1,ACCAATGGTTCTAAGAAGCC,0,508904
araBp,0.5,1,1,ACCAATAAGACAGGGTGGCC,0,507160
araBp,0.5,1,1,ACATTCTTGAGGGAATCAAT,0,504092
araBp,0.5,1,1,ACATGTATACGTCTCATCCT,0,496968
araBp,0.5,1,1,ACATGGATGGATGCCCCAAC,0,511792
araBp,0.5,1,1,ACATGCCTCACAGCGCACCA,0,484147
araBp,0.5,1,1,ACATCGTATTTGGACAGATA,0,512766
araBp,0.5,1,1,ACATCCGGGGTTTTGTTGAG,0,472981
araBp,0.5,1,1,ACATCCAGGGGTAGGCGTAA,0,470682
araBp,0.5,1,1,ACATCCACACTAGGCCAATT,0,523004
araBp,0.5,1,1,ACATCACGACCACGACGCGA,0,480699
araBp,0.5,1,1,ACATATTCCCGTGTGGCCCC,0,473435
araBp,0.5,1,1,ACATATGGATCACGACGCCG,0,488899
araBp,0.5,1,1,ACAGTTTCAGGGCAGTACAG,0,512837
araBp,0.5,1,1,ACAGTGGTCTCTAGAAGATC,0,480765
araBp,0.5,1,1,ACAGTCGCTTTGTCCTCTAG,0,475665
araBp,0.5,1,1,ACAGTAGTGCGGACGTCTAG,0,475982
araBp,0.5,1,1,ACAGTAGGGGTATTCTCCGT,0,487474
araBp,0.5,1,1,ACAGGTGTTACGGCGGATCT,0,500629
araBp,0.5,1,1,ACAGCGTATGTATACGTCAG,0,467843
araBp,0.5,1,1,ACAGCCAGGAATTGGTACGG,0,487048
araBp,0.5,1,1,ACAGATTTGGGCAAAGCGTT,0,514326
araBp,0.5,1,1,ACAGACTCGGTGAGCTTATT,0,505125
araBp,0.5,1,1,ACAGAATGTCGGGGAATCAG,0,476465
araBp,0.5,1,1,ACACTGGTTGGGTGTTTTTG,0,514222
araBp,0.5,1,1,ACACTCGTGCCCCTTGATTA,0,525122
araBp,0.5,1,1,ACACGTGTAGGTCTCCTTTT,0,494806
araBp,0.5,1,1,ACACGGATTGGAGCACGGCC,0,512983
araBp,0.5,1,1,ACACGCGCTGGGCGGGACGA,0,524720
araBp,0.5,1,1,ACACGCCAAAGTTGATGGCC,0,484878
araBp,0.5,1,1,ACACCGGTTGTTCGCATGGT,0,500668
araBp,0.5,1,1,ACACATTTCCAGTAGGAGTT,0,478136
araBp,0.5,1,1,ACACAGTTACTATGTCCTGG,0,472723
araBp,0.5,1,1,ACACAGGGATTCCCATGAAC,0,504639
araBp,0.5,1,1,ACACAGACTCCCATTTAGGA,0,502041
araBp,0.5,1,1,ACACAAATTCTCTCAGTCCT,0,467777
araBp,0.5,1,1,ACAATGCGACTTTCTCGCAT,0,519159
araBp,0.5,1,1,ACAATCATGCTTCAATCTAG,0,507605
araBp,0.5,1,1,ACAATAACTAGCGGGATAAG,0,505444
araBp,0.5,1,1,ACAACGCCTGAGCAAAGCGA,0,511663
araBp,0.5,1,1,ACAAATGATTACCGCAAGTC,0,478041
araBp,0.5,1,1,ACAAATCCTCACCAGCTGGT,0,512121
araBp,0.5,1,1,ACAAATCCCCATATTCAGTA,0,506483
araBp,0.5,1,1,ACAAATAGGAGACCCTTGTG,0,485376
araBp,0.5,1,1,ACAAAGTCCTTCGCTGGGGT,0,481600
araBp,0.5,1,1,ACAAAATTTTTCATCCGGCA,0,510932
araBp,0.5,1,1,AATTTGAGAATTCGATCATC,0,505523
araBp,0.5,1,1,AATTTCGCCCGGTATAGGTA,0,489453
araBp,0.5,1,1,AATTTAGGTTCGATTCACTT,0,469062
araBp,0.5,1,1,AATTTAGCGTCTAAAGTACT,0,470965
araBp,0.5,1,1,AATTGGGATACGGTCTGGAG,0,514851
araBp,0.5,1,1,AATTGGAGATTTTCAAGTGC,0,512675
araBp,0.5,1,1,AATTGAGCCCAGTGATAGTC,0,478292
araBp,0.5,1,1,AATTCTGCTTTGAGCCCTGC,0,515008
araBp,0.5,1,1,AATTCTGATTCTAACAGTCC,0,503611
araBp,0.5,1,1,AATTATAACTGGCTGAGGTG,0,514362
araBp,0.5,1,1,AATTAGCTTTGGACAAATCC,0,503788
araBp,0.5,1,1,AATTAGAGGCGGACTGGTGG,0,502817
araBp,0.5,1,1,AATTACAGATCTTTAAATGT,0,486489
araBp,0.5,1,1,AATGTTAATCCGAAGGTACT,0,504663
araBp,0.5,1,1,AATGTGTGCATTCACGACAG,0,507762
araBp,0.5,1,1,AATGTAAGCACCTACCCGAA,0,490579
araBp,0.5,1,1,AATGTAAGAGGTCTCACAAC,0,513810
araBp,0.5,1,1,AATGGTTGCAGTAAATAAAG,0,474291
araBp,0.5,1,1,AATGGTGGGAGCTATTTCTC,0,471904
araBp,0.5,1,1,AATGGTCAAATCGGTATACG,0,490561
araBp,0.5,1,1,AATGGATGCTTGTGAAAGCG,0,491186
araBp,0.5,1,1,AATGGATACCATTACAGAAG,0,483189
araBp,0.5,1,1,AATGCCGTTTAGTGCCTATA,0,500708
araBp,0.5,1,1,AATGAGAAACGTATGTGGGT,0,491272
araBp,0.5,1,1,AATCTTGGGTTGTATCTAGG,0,472294
araBp,0.5,1,1,AATCTTCCTCTGGACAACTC,0,492989
araBp,0.5,1,1,AATCTCTTACAGGTTGTTAG,0,467987
araBp,0.5,1,1,AATCGTGTTACAACGAGAGC,0,523390
araBp,0.5,1,1,AATCGGGATTAACCAATGTC,0,472213
araBp,0.5,1,1,AATCGAGCGATTTGTCCTAA,0,517373
araBp,0.5,1,1,AATCCACTATTACAGTGTAT,0,496858
araBp,0.5,1,1,AATATGCCAAAGCTTGTTAT,0,521067
araBp,0.5,1,1,AATATAAATCGACGATCTGT,0,482472
araBp,0.5,1,1,AATAGGGGCTAAGATAACCC,0,502731
araBp,0.5,1,1,AATACGGGGTTCTCTATGTC,0,473854
araBp,0.5,1,1,AATACGAGTATGTACGATAA,0,517703
araBp,0.5,1,1,AATAATTTAAACGTGTTATT,0,512307
araBp,0.5,1,1,AATAAAATACTTACCGTCAC,0,513975
araBp,0.5,1,1,AAGTTCCTCTAACTCCTTGG,0,475025
araBp,0.5,1,1,AAGTGGAGAACTGGGGCGAG,0,478884
araBp,0.5,1,1,AAGTCGATAGCTTAGGGGTC,0,507726
araBp,0.5,1,1,AAGTCCGGTCCCCCGGCTGG,0,492936
araBp,0.5,1,1,AAGTCCCCATCATGGCGTGT,0,501649
araBp,0.5,1,1,AAGTCATGAAATTTCGTACC,0,507732
araBp,0.5,1,1,AAGTACGCTGACGGTACTGT,0,480211
araBp,0.5,1,1,AAGTAATCCGGCGTGCCCAT,0,523978
araBp,0.5,1,1,AAGGGTATTCTTTTTTATGT,0,495958
araBp,0.5,1,1,AAGGCTTATGGCGCCTCAGG,0,505867
araBp,0.5,1,1,AAGGCTGAAGTATCAGGCTC,0,492626
araBp,0.5,1,1,AAGGCCTCGCTCCTTCACGA,0,480655
araBp,0.5,1,1,AAGGCATATACGGCGTAAGC,0,522924
araBp,0.5,1,1,AAGGACAGTTCAAGCCAATC,0,516337
araBp,0.5,1,1,AAGCTCGCGGGCTCGCCACT,0,488256
araBp,0.5,1,1,AAGCTCCCAGATCTTGTACT,0,522084
araBp,0.5,1,1,AAGCGGTGGCCTGAGGTGAC,0,492466
araBp,0.5,1,1,AAGCGGACACCTGTAAGACT,0,473644
araBp,0.5,1,1,AAGCGCGCAGCATAAGAACA,0,475556
araBp,0.5,1,1,AAGCGCCTGAACAATACTGT,0,482757
araBp,0.5,1,1,AAGCGATGCATGAGGCTGGC,0,509100
araBp,0.5,1,1,AAGCGATCCGAGGGAATACA,0,522507
araBp,0.5,1,1,AAGCCGCGGGCATAGATTGC,0,500032
araBp,0.5,1,1,AAGCAGGGACGCTCTCCGAA,0,477921
araBp,0.5,1,1,AAGCACCAGGCGAAATTACA,0,496953
araBp,0.5,1,1,AAGCACCAATATCCTATTCC,0,488000
araBp,0.5,1,1,AAGATAAGTGTCATTGCTGA,0,484829
araBp,0.5,1,1,AAGAGCGCCAGGCTGAGAAC,0,516744
araBp,0.5,1,1,AAGAGATAAAGCACACGTAT,0,478171
araBp,0.5,1,1,AAGAGAATTTGAATGGTACC,0,490256
araBp,0.5,1,1,AAGACGCATTATGTATAGGT,0,468844
araBp,0.5,1,1,AAGACCGAGGTCAGAGCGCA,0,484719
araBp,0.5,1,1,AAGAAATTAGTCGATTACTC,0,500159
araBp,0.5,1,1,AACTGTTACACGTCAGACAC,0,478247
araBp,0.5,1,1,AACTCTCTATCCGGACGCAT,0,469945
araBp,0.5,1,1,AACTCTATATCGGGAATCAT,0,523290
araBp,0.5,1,1,AACTCTAGTTCGTCCAGATA,0,495922
araBp,0.5,1,1,AACTCGTCGAGCGTATATGC,0,483899
araBp,0.5,1,1,AACTCCATGCAATCACCCTA,0,477798
araBp,0.5,1,1,AACTACTTTGCATTGACAAG,0,471234
araBp,0.5,1,1,AACGTGTACCCTGGATCAGA,0,509120
araBp,0.5,1,1,AACGTGCCGTCTTCCCCTAT,0,521404
araBp,0.5,1,1,AACGTCCGCAGGTTCAACCA,0,474776
araBp,0.5,1,1,AACGTCCCGGCTTAGCTGCA,0,509972
araBp,0.5,1,1,AACGGTGGGCCACGATACGT,0,517647
araBp,0.5,1,1,AACGGTATTGGCCGGAATCG,0,469571
araBp,0.5,1,1,AACGGTACAGCATACGTCCA,0,505191
araBp,0.5,1,1,AACGGCATTTCTGCTGCGTA,0,516864
araBp,0.5,1,1,AACGCGCGAAATCCGACCAA,0,499426
araBp,0.5,1,1,AACGCGCCCCGCGACTAAAG,0,515099
araBp,0.5,1,1,AACGCGAAAGCCATTGAGGG,0,502946
araBp,0.5,1,1,AACGCCTCAATCCCTATAAG,0,513952
araBp,0.5,1,1,AACGCATACTCCCACCTGGT,0,480920
araBp,0.5,1,1,AACCGTTGGAAGGTATGGGA,0,500757
araBp,0.5,1,1,AACCGTAGCGTTGACGGGGG,0,484849
araBp,0.5,1,1,AACCGCCCTGACGAGGTCAT,0,491494
araBp,0.5,1,1,AACCCTTAACAATAGCGTGT,0,515434
araBp,0.5,1,1,AACCCTCACAGGGTGCCGTA,0,482868
araBp,0.5,1,1,AACCCATGACCAATCGTGAC,0,475681
araBp,0.5,1,1,AACCATACGAGATGGCGCAA,0,477721
araBp,0.5,1,1,AACATCTCGATCAACCCGAA,0,471749
araBp,0.5,1,1,AACAGGGCAGAGTCTAATAA,0,509562
araBp,0.5,1,1,AACAGGAGCCGTGAATCTCG,0,510171
araBp,0.5,1,1,AACAGATTATAAGGTTTTCG,0,520344
araBp,0.5,1,1,AACACTTCGGCTCCAATGGA,0,517920
araBp,0.5,1,1,AACACATATGGATAATAGAC,0,472046
araBp,0.5,1,1,AAATTTCGAAATGTACCCAA,0,490598
araBp,0.5,1,1,AAATTGTAAAAACTAATATA,0,504782
araBp,0.5,1,1,AAATGTGACGGGGTGAAAGA,0,523634
araBp,0.5,1,1,AAATGTACGGTGTGCCATTG,0,491771
araBp,0.5,1,1,AAATCGAGTGGCCCATATCT,0,489970
araBp,0.5,1,1,AAATCAGCTCAAGCCTGAGA,0,475125
araBp,0.5,1,1,AAATACTATTTTGGCGCATT,0,508035
araBp,0.5,1,1,AAATAAGGTCTTTTCGAGTC,0,504671
araBp,0.5,1,1,AAAGTTGTGGAACGTTTGCG,0,480232
araBp,0.5,1,1,AAAGTCCTACGCATTGCGAC,0,487355
araBp,0.5,1,1,AAAGGTAGGGGCACTTAGGG,0,522098
araBp,0.5,1,1,AAAGGCACCCCACATTCGGT,0,471868
araBp,0.5,1,1,AAAGCTGGTACGATACGACG,0,491735
araBp,0.5,1,1,AAAGCGTCCCGGTAAGGAAA,0,523617
araBp,0.5,1,1,AAAGCGGCCTTCTGAGTCGT,0,478122
araBp,0.5,1,1,AAAGCCGCTAGGTTGAAGGG,0,490432
araBp,0.5,1,1,AAAGAACGGGGTCAAGCAAT,0,498999
araBp,0.5,1,1,AAACTTTCATGGCAGGTTGG,0,507110
araBp,0.5,1,1,AAACTCAGTTGTGTCGCACG,0,483908
araBp,0.5,1,1,AAACTCAACGGTTATACTTA,0,476956
araBp,0.5,1,1,AAACGTTTGGTTTTTCGCTC,0,486101
araBp,0.5,1,1,AAACGCAGTACCCTCTACAT,0,497746
araBp,0.5,1,1,AAACGAAGTGCCAGACTGAG,0,523105
araBp,0.5,1,1,AAACCGTCGGCACACCTACT,0,502575
araBp,0.5,1,1,AAACCGACAATTGCTGGTAT,0,515891
araBp,0.5,1,1,AAACAGTGCCGGGGCAGCGA,0,514700
araBp,0.5,1,1,AAACAGTCAACGTGCAAGTA,0,471240
araBp,0.5,1,1,AAACAGGTTTGTCTACAGCT,0,490511
araBp,0.5,1,1,AAACAGGCTTAACGGTACGT,0,480074
araBp,0.5,1,1,AAACAATTCCTTTCCCTGCA,0,504244
araBp,0.5,1,1,AAACAACAGCTTGCTAGTGG,0,511691
araBp,0.5,1,1,AAAATTCATTAGTAGTCTGC,0,478522
araBp,0.5,1,1,AAAATTCACGGCCGACTCTG,0,516882
araBp,0.5,1,1,AAAATATGGAGCCGACGTTC,0,482597
araBp,0.5,1,1,AAAAGTTCGCATGGCATAAT,0,514667
araBp,0.5,1,1,AAAAGTGCATTGTTCCGAGA,0,493047
araBp,0.5,1,1,AAAAGTCTCAGCTAGCGCCC,0,520141
araBp,0.5,1,1,AAAAGCGTATTGCTTTCACT,0,511958
araBp,0.5,1,1,AAAAGACACTCTGGGTAAAG,0,502529
araBp,0.5,1,1,AAAACCGCTGATAAATGGAT,0,492757
araBp,0.5,1,1,AAAAATTTAGACCACTACGG,0,507167
araBp,0.5,1,1,AAAAATCACTCCCAATAAGT,0,478813
araBp,0.5,1,1,AAAAACGCATTTAATCCGAA,0,503355
araBp,70.0,69,0,GTATCACAATAACGTCATAG,69,492367
araBp,65.0,64,0,GTGGACAAGGAGCATTAACG,64,500910
araBp,63.0,62,0,TGTGACGAAACTTGCATGGC,62,480026
araBp,61.0,60,0,GAAACCCCAGCGTCTAAGCC,60,498789
araBp,58.0,57,0,CCAGTTGGTTTATCTTAATT,57,499433
araBp,55.0,54,0,TAACTTAATCGGAGGGCCTC,54,492344
araBp,54.0,53,0,CCAATCGGTTGGATCCGACC,53,502533
araBp,52.0,51,0,TTGTTTATCAGGTGCCCCCA,51,471972
araBp,50.0,49,0,CTGCACGCAGTCCGCCCTCC,49,488650
araBp,48.0,47,0,GGTCATAGATACACACAAGT,47,508227
araBp,47.0,46,0,CACTTAAGCTACAATTCAGT,46,484565
araBp,43.0,42,0,CAGAGGTGATGACCTGTCCA,42,476867
araBp,42.0,41,0,ATCGACACTCAGCAATCAGA,41,481993
araBp,41.0,40,0,ACGCGAGATAGTTATCTAGA,40,504481
araBp,40.0,39,0,TAGGGTTGGTTAAGGATCCC,39,494266
araBp,40.0,39,0,CGCTGCGACAGAGGACCGCC,39,503025
araBp,39.0,38,0,GTAATGCTCAAAACAGTGGA,38,507272
araBp,39.0,38,0,GATGCTAGCTCTTCCTTCAC,38,504490
araBp,37.0,36,0,CCGGTACGTAGGCTTGAGGT,36,468535
araBp,37.0,36,0,CAGACTGCTTTAGTCATTCG,36,491663
araBp,35.0,34,0,TTTAACGGTTATATGCCCAG,34,477110
araBp,35.0,34,0,TAAGCCTTATGCATCTGTAG,34,487218
araBp,32.0,31,0,TAGCCGGGTTGTATGTGATT,31,518360
araBp,32.0,31,0,CTCGGCGACTTCGGATGAGA,31,518508
araBp,31.0,30,0,GGTCACTACGGTCTCACGTT,30,481573
araBp,30.0,29,0,TCCGTACGTCTTACTAGACA,29,519922
araBp,30.0,29,0,CTGAGTCAAGGAATCCACAA,29,472794
araBp,30.0,29,0,CAAATTTGTCGTCCCGAGCT,29,487100
araBp,30.0,29,0,AAGGCTTCATACATCTCAAT,29,478486
araBp,29.0,28,0,TTCCTCTGGTGGACCCCACG,28,483768
araBp,29.0,28,0,GGGTTCGGGATATCAGTTAG,28,471780
araBp,28.0,27,0,TCCTTAACCCCGCTACGGGA,27,479512
araBp,28.0,27,0,TATTGAGGTTCCAACCGTAG,27,486010
araBp,28.0,27,0,GATGGCTGGATGATACCCCG,27,520605
araBp,27.0,26,0,TAAGCCGCGGAAAGTTTCAC,26,470344
araBp,27.0,26,0,CGTAGGCAGTGAGGGTCGCG,26,496735
araBp,27.0,26,0,AGGTACAAAGCAACAGGCAT,26,485536
araBp,26.0,25,0,TCTAAGAAACATTTAGAGAG,25,510985
araBp,26.0,25,0,TCGCTCAAACGTATATGCAA,25,475831
araBp,26.0,25,0,TAGCAAAATGCATCGGAACT,25,484608
araBp,26.0,25,0,GAACGCGACTTGCGGGGGTA,25,479166
araBp,26.0,25,0,CTCCAACTCCCCTGGCGGTT,25,505774
araBp,26.0,25,0,CATTTACAATGAAGCAACTC,25,497302
araBp,25.0,24,0,TACCGCAGGGGTGCCCGACG,24,487371
araBp,25.0,24,0,GGTACATTAATGAGGTTTTG,24,499833
araBp,25.0,24,0,GCGGAAACATTGTACGAGGT,24,502542
araBp,25.0,24,0,CTCGACAAATTTCTAATGGT,24,514624
araBp,25.0,24,0,ATCGACGTCGCATTTAGTGC,24,478449
araBp,25.0,24,0,ACACACAAATGAGAATTCGA,24,475833
araBp,25.0,24,0,AACTCGGGACATGATTCGAT,24,515261
araBp,24.0,23,0,TATCTGCGCTCTCAGTGATT,23,502023
araBp,24.0,23,0,GTGACTCTCTTACGAACCTC,23,506543
araBp,24.0,23,0,GAGCGCATGGTAACGGGAGA,23,484126
araBp,24.0,23,0,CCCCGGAGCGTGTTCTGTGA,23,502121
araBp,24.0,23,0,CACATCCTGCCAGTACTACT,23,491446
araBp,24.0,23,0,CAACGGGTAACGCTCGCGGT,23,490752
araBp,24.0,23,0,AGAGCAGATCACGTGTAGGG,23,499805
araBp,24.0,23,0,ACTGGGCAGAAAATTATTCT,23,510818
araBp,23.0,22,0,TTGCGGTATAGGCTGGTTAG,22,511927
araBp,23.0,22,0,TGGTGGACACCGACCAAGTG,22,483640
araBp,23.0,22,0,TCATCAATATTGGCTGCCAT,22,509835
araBp,23.0,22,0,TAGAATTGCGTTAGGTCGAA,22,487937
araBp,23.0,22,0,GGTGGTCCTAGCATGTCAAT,22,505893
araBp,23.0,22,0,CATAATACCCGCATTTTGTG,22,503774
araBp,23.0,22,0,ATTCCCAGGGAAAGGAACGA,22,498291
araBp,23.0,22,0,AACGTAGTGGGATCTGTCTA,22,478703
araBp,22.0,21,0,GTGGGTTAGTGGCAGCTGGC,21,487639
araBp,22.0,21,0,GCTAGGTCAAAAGACTATTA,21,513561
araBp,22.0,21,0,CCGGAAATATGGCCTCCCGG,21,513333
araBp,22.0,21,0,CCCAGCTAACGACGAAACCA,21,491672
araBp,21.0,20,0,TCAGCATAATTCAGCTGTGG,20,500223
araBp,21.0,20,0,CTTACACGGTGCTAGGAATC,20,481790
araBp,21.0,20,0,CGGACGTGCGCCCCGTAATT,20,519919
araBp,21.0,20,0,AGGGCAGCGCAAATATTCAG,20,510390
araBp,20.0,19,0,TTCTTCCATAAGGTAATTTG,19,505366
araBp,20.0,19,0,TCTATGTACTCCACGGCGAT,19,503024
araBp,20.0,19,0,GTCGCGCATTTTCGTATCAA,19,505238
araBp,20.0,19,0,GTCATACACATTTATAAGAT,19,510474
araBp,20.0,19,0,GAAATGGGCGAGGTCGCAGT,19,468508
araBp,20.0,19,0,CCGCGCCGTTGTTTTCAGGT,19,492220
araBp,20.0,19,0,CAGCTCAGGAGGTTGATAAG,19,501696
araBp,19.0,18,0,TGTCATTAGAATTTGCTCAT,18,487844
araBp,19.0,18,0,GGGCGAATCGCGGCAAGATC,18,485234
araBp,19.0,18,0,CTTAGTGTACCCCGAGTTTA,18,524341
araBp,19.0,18,0,CAAGTGGCTATGGTATTTCT,18,474993
araBp,19.0,18,0,ATGCCCGTCTCTGGGATGGT,18,496132
araBp,19.0,18,0,AGCTTGTTGGCGGACAGAGC,18,497583
araBp,19.0,18,0,AGCACTTGGGTTAACACTCG,18,498773
araBp,18.0,17,0,TTTTTGTCGGCTAATGCATA,17,475137
araBp,18.0,17,0,TCACTAAAGTTCGGTTCTCA,17,487953
araBp,18.0,17,0,TACAGGCCGTAATACGAGCT,17,508325
araBp,18.0,17,0,GGTGAAACCTAGTGACGACA,17,468794
araBp,18.0,17,0,GATCGTAATGTGCGGCCAGA,17,511113
araBp,18.0,17,0,CTTTAGTGTGTAGTCGTAGG,17,522201
araBp,18.0,17,0,CGCGTGCAAAAAGGCATGGA,17,489304
araBp,18.0,17,0,CAAAAACAGTTATTGATGGA,17,473429
araBp,17.0,16,0,TGGAGCTCAGCGTTTTGAAA,16,506242
araBp,17.0,16,0,CGCTAGGAATTGAACGGAGT,16,501644
araBp,17.0,16,0,AGGTGTTAGGTCTAGTGTTA,16,487674
araBp,16.0,15,0,TTTTGGGCGGTGATCACTCT,15,525273
araBp,16.0,15,0,TTAAGCAGGAAACCGAAACC,15,476845
araBp,16.0,15,0,TCCGGAAAGGGCCACCAGGT,15,520834
araBp,16.0,15,0,GTAACGTAATTATTCCTCTA,15,512418
araBp,16.0,15,0,CGAATGCTTTTGGTACCCGA,15,522834
araBp,15.0,14,0,TTTCACTTCGGAGTTTACAG,14,472646
araBp,15.0,14,0,TCACGCGACTTGTTGGGGGA,14,503981
araBp,15.0,14,0,GTTAGTTAGGCTCAGAAGTT,14,469574
araBp,15.0,14,0,GTATTTCACTCGCTCGGGTT,14,516928
araBp,15.0,14,0,GCGAATAATATGCTCGGGCT,14,517691
araBp,15.0,14,0,GAGCCATGCTGCTTCGGGAA,14,467992
araBp,15.0,14,0,GAACAGGGCGGGACGGCACC,14,476030
araBp,15.0,14,0,CTCGAGAGCCGGACTGAGTT,14,468202
araBp,15.0,14,0,CCTCTCATCTTGTTTAGTGG,14,490452
araBp,15.0,14,0,CACTTTATAGGCCGGTCTCT,14,514173
araBp,15.0,14,0,AGCTGCGAAACAAACGAGTT,14,514473
araBp,14.0,13,0,GTACCCAGTTCCGGCACGTA,13,468335
araBp,14.0,13,0,GGGCTACTTTCGTTTGAAGA,13,494236
araBp,14.0,13,0,GCTACCTCGCCTTGCGTTGA,13,479310
araBp,14.0,13,0,CTTGCCAAATATCATGTAAG,13,519905
araBp,14.0,13,0,CTCAACACCAAGTACTATTT,13,473756
araBp,14.0,13,0,CCTCACAGATAAGGGTGCAT,13,523048
araBp,14.0,13,0,ATTTAGTTGGGCCTCGACCG,13,501721
araBp,14.0,13,0,AACTCATCGCAAAGAGCGTA,13,474027
araBp,13.0,12,0,TTGAGTTTTTTAGTCCCATG,12,471981
araBp,13.0,12,0,ACCGCCTATGACCTCACTTC,12,484973
araBp,12.0,11,0,TTCACCACGGTCCCCTCTCT,11,521204
araBp,12.0,11,0,GTACAAGGCCCGGTGGTTTC,11,471984
araBp,12.0,11,0,GACCGCGTCGAGCCATCATA,11,525245
araBp,12.0,11,0,CTGTTGGTTGTTCCTTAAAC,11,510918
araBp,12.0,11,0,CTCCCAAATTCATCGACATC,11,520897
araBp,11.0,10,0,GACCGTTTGATATGGTTCAA,10,516156
araBp,11.0,10,0,ATCTGTGCTCCCTGCCGGTA,10,491115
araBp,11.0,10,0,AGGGCCTAGAGCTGCAGGCA,10,503468
araBp,11.0,10,0,AGATTTACTTTGGATCCATC,10,487163
araBp,10.0,9,0,GATTGAGGTCGCCATTAAGA,9,469792
araBp,8.0,7,0,TTATTATTTTCTAGGTTGAG,7,482483
araBp,8.0,7,0,TCCGAGCGCCGGCGATCGTC,7,524101
araBp,8.0,7,0,TAATCTTATTCAAGCTCCCT,7,479421
araBp,8.0,7,0,GAGCATCTCTCAGTGAGAGA,7,469903
araBp,8.0,7,0,CTATGTAACCTCTATTCCTC,7,498413
araBp,6.0,5,0,ACCCCTTCAAGCGTGTATTG,5,485011
araBp,3.0,2,0,TTCGGGCAATACTCGCTTAG,2,471975
araBp,3.0,2,0,GGCGCTTTTACTAGGTTTTA,2,513127
araBp,2.0,1,0,TTTGGAGTCTATGTCGGCAA,1,507175
araBp,2.0,1,0,TTTAGATCTCCAGTTACGCC,1,474293
araBp,2.0,1,0,TGCCCACCTATATCTAAGAG,1,507622
araBp,2.0,1,0,TGCATATTGTGCATTTATTC,1,493029
araBp,2.0,1,0,TCAGTCGTAGCTGCTAAGCT,1,498990
araBp,2.0,1,0,TATGGCAGCTTTCAAGATAA,1,523779
araBp,2.0,1,0,GGTGCTTGGGGTCGTGAGTG,1,506708
araBp,2.0,1,0,GGCTGCCATTCCTGATCGAC,1,467966
araBp,2.0,1,0,GCACTAGGGCCAGACTGTAC,1,507362
araBp,2.0,1,0,GAACACTACGTCTTCTGCTT,1,503891
araBp,2.0,1,0,CTTGAAGGGAACGTTAAGTG,1,516345
araBp,2.0,1,0,CGGACACCTTAACCGGCCGC,1,497515
araBp,2.0,1,0,CCGCCAAAATGTGTAATCGC,1,485581
araBp,2.0,1,0,CATTTGGGACAGTACCCTGC,1,483067
araBp,2.0,1,0,CAGGTCGCGTTCAGGTTGGA,1,495849
araBp,2.0,1,0,CAGCAAGACATTCTCATAGG,1,469137
araBp,2.0,1,0,CACTGATCAGCGCGCCCCTA,1,485863
araBp,2.0,1,0,CAATCACCGATTTAACCTGT,1,499534
araBp,2.0,1,0,ATGCTGCGCAGTCATCCGGG,1,490991
araBp,2.0,1,0,ATGCACATAATCTGTACCCA,1,514058
araBp,2.0,1,0,ATCCCCTACTTCTTTCACGG,1,490948
araBp,2.0,1,0,AGTCCGGGACGTAACATGTA,1,497899
araBp,2.0,1,0,AAGAGTCGAGAGCGCACTGA,1,473100
