name,relative_counts,ct,ct_0,barcode,ct_1,barcode_ind
rdlDp,0.5043859649122807,341,227,GGCTACTGGCGGTCCAGCAT,114,3164210
rdlDp,0.44545454545454544,157,109,CCGTGGATATTTAATTTTGT,48,3167622
rdlDp,0.5660377358490566,164,105,CCACTGAGGGCCGGGAGTGA,59,3166098
rdlDp,0.16037735849056603,121,105,AGCTGGTGCACTCTAAGCCC,16,3165281
rdlDp,0.5980392156862745,161,101,GGGGTCTCCGAACCAGCAAA,60,3175560
rdlDp,0.8181818181818182,178,98,GACCAGATCGCTGTTATCAG,80,3164232
rdlDp,0.29591836734693877,125,97,GCATACACCCATTAATAAAG,28,3211805
rdlDp,0.673469387755102,162,97,ACTCCTGGCCCTTGAGCTCG,65,3207663
rdlDp,0.4536082474226804,139,96,GGCGTCAGATACGTTGCTCT,43,3165151
rdlDp,0.12903225806451613,103,92,CCGGTGTACGACAGGTACAC,11,3200013
rdlDp,0.4074074074074074,112,80,TCCCAAGACTCCTCCGGTCG,32,3211801
rdlDp,0.2962962962962963,103,80,CGAGGTGGGAGAAGTCATCG,23,3206748
rdlDp,2.05,242,79,CGCGGTTTACTTCCTCACTT,163,3183461
rdlDp,0.26582278481012656,98,78,ACGATTTTAGTGAGATATGT,20,3172124
rdlDp,0.36,100,74,AGAACGCTGCTGCTTACGCT,26,3174510
rdlDp,0.4657534246575342,105,72,AACAGGGCAATGTGCACCCG,33,3199326
rdlDp,0.2777777777777778,90,71,CCGCAGGGATTTAATTACCT,19,3204350
rdlDp,1.0571428571428572,142,69,GCTCCGCTTTTCATCCTCCT,73,3167279
rdlDp,0.7571428571428571,121,69,ATGTGACCAAAGCACAAGGA,52,3206636
rdlDp,0.27941176470588236,85,67,CCCCTCAGTCGGGGGTTGCA,18,3191142
rdlDp,0.1044776119402985,72,66,TGGCGGCTCAACTCAAACAG,6,3202299
rdlDp,0.43283582089552236,94,66,TAGTCTCGGTTATGTGAAGT,28,3203464
rdlDp,0.2878787878787879,83,65,CACTTTACGCCTTTGTAATG,18,3208418
rdlDp,0.546875,97,63,CAATCGACAAACTGTGGCAT,34,3205752
rdlDp,0.546875,97,63,ATCGTGTCTCGTTACTTACA,34,3168089
rdlDp,1.3870967741935485,146,61,CTACCTGGTCAGTAGCGGTT,85,3195153
rdlDp,0.7704918032786885,106,60,TTTTAACTCGTTAGGTGATG,46,3201418
rdlDp,0.7457627118644068,101,58,GTGCAACAACGCGATGCCAT,43,3197832
rdlDp,1.2881355932203389,133,58,CATACGGAGTACAACCGCTA,75,3186678
rdlDp,0.6271186440677966,94,58,ATTTGTATGGGATCATGTAG,36,3211046
rdlDp,0.6206896551724138,92,57,CGGCTCGATCATTTGGAGCT,35,3164412
rdlDp,0.8448275862068966,105,57,ACGGGCGAGACGAGGCGCGA,48,3164977
rdlDp,0.7894736842105263,100,56,TGGGTGGTGCCAAGCCGATA,44,3187413
rdlDp,0.14035087719298245,63,56,GTGTTCAGTGCATCATCCAA,7,3165136
rdlDp,0.7192982456140351,96,56,GACTCTACTGCCTACGGCCA,40,3166729
rdlDp,0.9298245614035088,108,56,CGTTGTCCGCGGTTGGGCTG,52,3165486
rdlDp,0.2631578947368421,70,56,CAGTCAATCAAATGGGGCAT,14,3188146
rdlDp,0.5614035087719298,87,56,AATTGTTGTGATGCCGGGTC,31,3205747
rdlDp,0.35714285714285715,74,55,GTGCAAATTGTCAGAATTAA,19,3194006
rdlDp,0.3392857142857143,73,55,GTATAGGGTAGACCAGTTGT,18,3175947
rdlDp,0.35714285714285715,74,55,CTGAGTTAGACATTCACGGG,19,3181795
rdlDp,0.32727272727272727,71,54,TTCCTATAGGCTTAAAATTC,17,3208845
rdlDp,0.6,86,54,ATTCTATTGCTCCGAGGTCA,32,3175877
rdlDp,0.18518518518518517,62,53,GGCCTTCCAAATTCACGAAG,9,3194086
rdlDp,0.46296296296296297,77,53,AATATGCGCACCACTACATG,24,3175522
rdlDp,1.0,104,52,TCAGTTACAGTTTACATTTG,52,3165130
rdlDp,1.1132075471698113,110,52,TCAGCTGGCTGGTAGACGAG,58,3176640
rdlDp,0.1320754716981132,58,52,CACTCGAGCCCCGCCAGAAG,6,3172121
rdlDp,0.6981132075471698,88,52,ACGTCTGATTCGCAGCTGAA,36,3187841
rdlDp,0.11538461538461539,56,51,GGGTTTCTAAGGTCGCTGTG,5,3191001
rdlDp,0.5576923076923077,79,51,GAGAGTCGTTGGCACCTAGA,28,3167626
rdlDp,0.8076923076923077,92,51,CGACATGGTGAAGGCAAGGT,41,3172123
rdlDp,0.3076923076923077,66,51,CCATCCGGGAACCTTTGAAT,15,3188764
rdlDp,0.9411764705882353,97,50,TCGATAGCGGCAACAAATAT,47,3164981
rdlDp,1.6470588235294117,133,50,AGTGTAAAGTCGAGATTCTG,83,3212608
rdlDp,0.04,50,49,TTAAGTTGTACTAAGAGCCA,1,3174164
rdlDp,0.42,69,49,AGGCAACTGTACTGGGTGAT,20,3164515
rdlDp,0.10204081632653061,52,48,TGTAACAAGGTGGAGAGGGA,4,3169440
rdlDp,0.7959183673469388,86,48,CGATCCGCATTTTTGTGCAG,38,3176733
rdlDp,0.8571428571428571,89,48,ATCGAACGGTTCTGCCAGGT,41,3209686
rdlDp,5.729166666666667,321,47,TGGAACCAGAGACGTGGCAT,274,3191999
rdlDp,0.14583333333333334,53,47,GTGTGCCCGCAGGAGCACAG,6,3168606
rdlDp,0.6458333333333334,77,47,GTGATTAGGTCATGAAGTCG,30,3185119
rdlDp,5.0,286,47,GATATAGCTTATCAAGGCAA,239,3182160
rdlDp,0.2916666666666667,60,47,CTTCCTCAATGTTGAACGAA,13,3191656
rdlDp,1.625,124,47,CCGACTTACCGCGCCGCTAG,77,3167383
rdlDp,2.7708333333333335,179,47,CCAGGTGGAGGAGCACCCGG,132,3206507
rdlDp,1.1041666666666667,99,47,ACGAACTTCGACTACCCGAA,52,3187928
rdlDp,0.08333333333333333,50,47,AAAGGTACAGCTGTACAAAA,3,3191143
rdlDp,0.3541666666666667,63,47,AAAAGAGTCGGCCTGTTTGC,16,3165905
rdlDp,0.06382978723404255,48,46,TTGCTCTTGGGCATTATCCA,2,3185045
rdlDp,5.1063829787234045,285,46,GTTATAACTGGGATAATCGG,239,3209354
rdlDp,0.7872340425531915,82,46,GTGAACACAAACGGTTCGAC,36,3167304
rdlDp,0.425531914893617,65,46,GCGTAAGGCGCGGCGCTTGA,19,3198914
rdlDp,1.0851063829787233,96,46,ATAGTGCTGCTGTCCATATG,50,3191550
rdlDp,0.45652173913043476,65,45,TAGGGACGCCAAGCGGCAGA,20,3179551
rdlDp,0.043478260869565216,46,45,GACAGGTGACCAAAATAATG,1,3211826
rdlDp,2.0217391304347827,137,45,CCAATGTTGTCAGAACTATA,92,3183114
rdlDp,0.5,67,45,CACATATCGCCAAAGTCGCT,22,3165902
rdlDp,0.2608695652173913,56,45,AGTTCTAACTGTTGCGAAAT,11,3187180
rdlDp,0.8,79,44,TTGCCAAGGAACAACCGCGA,35,3176398
rdlDp,0.2222222222222222,53,44,TCTAGCTGGATTTCCGATAT,9,3195341
rdlDp,0.044444444444444446,45,44,GGATTCTATTATCACGTAAT,1,3164776
rdlDp,0.7777777777777778,78,44,GGAGACCCAAAGTTTCCACC,34,3173580
rdlDp,0.17777777777777778,51,44,CTCGGACCTGTCCGATTTGT,7,3182914
rdlDp,0.1111111111111111,48,44,ACCGTATTCCTTTGCTCTGT,4,3171491
rdlDp,0.29545454545454547,55,43,GGTTTTTTTCCTAGAGATCG,12,3193812
rdlDp,0.5,64,43,GGGCCCCGTGTCACTGCGCA,21,3177547
rdlDp,0.5,64,43,GAGTTGTTTTGCCCTTGTCT,21,3192518
rdlDp,0.4090909090909091,60,43,CACGAGGCGGTAGATCACAG,17,3177732
rdlDp,1.4545454545454546,106,43,CAATCCACCTTAAGTCAATT,63,3198836
rdlDp,1.4318181818181819,105,43,AGATCCAACGGCGGTTATTT,62,3181696
rdlDp,0.9302325581395349,81,42,GTCTGCTCCGCAATCCCCGT,39,3185303
rdlDp,0.27906976744186046,53,42,GGTGTTGATGGCAGTCTTCT,11,3206692
rdlDp,2.441860465116279,146,42,GCGGTTCGGATTCTCAATAT,104,3181699
rdlDp,0.13953488372093023,47,42,GAACTAAAACTCGGAGACTG,5,3193808
rdlDp,0.3023255813953488,54,42,CTTTCAACTACATGTTTAGA,12,3213288
rdlDp,0.7619047619047619,72,41,TTGACGCCAGCCTGCCGGCA,31,3169971
rdlDp,1.0714285714285714,85,41,GGCCGCATTCGACACCGATG,44,3179300
rdlDp,0.5476190476190477,63,41,GCAGTGTCTAGCGTTGATCA,22,3199333
rdlDp,0.7619047619047619,72,41,GCACCTCCTCACTAGAAAGA,31,3200648
rdlDp,1.6666666666666667,110,41,CGTTCTAATTATAATTGCGC,69,3181708
rdlDp,0.5238095238095238,62,41,CGTATGTAACCCGGCAACCT,21,3197275
rdlDp,0.8333333333333334,75,41,CACTTTAAACCGTACTTTTG,34,3164149
rdlDp,0.3333333333333333,54,41,AATTTTTTATGGTCGGGGCA,13,3190352
rdlDp,0.8095238095238095,74,41,AACCGCTATTCCCAAAAGTA,33,3178965
rdlDp,0.07317073170731707,42,40,TTGTCGTCAAGGTATTATTC,2,3179118
rdlDp,0.43902439024390244,57,40,TACTGTGCACGAGTCGAATA,17,3209688
rdlDp,0.2926829268292683,51,40,TACCACGGGGCAATTTTTAG,11,3182916
rdlDp,0.36585365853658536,54,40,GACCCGGTGCTATGCGGGGT,14,3206948
rdlDp,2.0,121,40,CTGCAGCAGTAGCGGTTCAT,81,3213478
rdlDp,1.6097560975609757,105,40,ATTCGGAGAGACCTCTTCGA,65,3207921
rdlDp,0.075,41,39,CTGTAAGAGGGAAGTGATCT,2,3180042
rdlDp,0.525,59,39,CAGTCCTCGGCCTACAGAGT,20,3183971
rdlDp,0.525,59,39,ATCCGCCAACGGTTATCACC,20,3176360
rdlDp,0.9,74,39,AAGACATGCCCACCTGTGAG,35,3168052
rdlDp,0.38461538461538464,52,38,TTTGCGTGGAGGCACATCGA,14,3201171
rdlDp,1.0512820512820513,78,38,GTTACCGCGCAAGGAACGAA,40,3176397
rdlDp,0.46153846153846156,55,38,GCTCGCTATTCCCGTTGTAG,17,3182149
rdlDp,0.3076923076923077,49,38,GCTACTGTAGGACTCTTTTC,11,3188321
rdlDp,1.1282051282051282,81,38,GATACAGATCAGCACATGTC,43,3186282
rdlDp,0.05128205128205128,39,38,GAGAGTTTCTATTATCGATA,1,3183965
rdlDp,2.923076923076923,151,38,CTAGGCGTATCGCGCTCCGA,113,3194196
rdlDp,0.7692307692307693,67,38,ATCCATGAGTTGGCCGCTGT,29,3206029
rdlDp,0.7631578947368421,65,37,TGTCAATAATTTTCCGCAAG,28,3209289
rdlDp,1.105263157894737,78,37,TGTACCTCTTCCTTATTCTA,41,3181868
rdlDp,0.5526315789473685,57,37,TGCCGCCTCACAAGCTTACG,20,3206810
rdlDp,0.42105263157894735,52,37,TCGCACTCGGGAGCCCGATG,15,3168940
rdlDp,0.8157894736842105,67,37,TAGGGGTCACGACGAGCCTG,30,3196368
rdlDp,0.42105263157894735,52,37,GCACCGATATCAATCAGTAA,15,3200672
rdlDp,0.5789473684210527,58,37,GATGTTCCACCTGAAGGAAT,21,3209429
rdlDp,0.7894736842105263,66,37,CTAGACGTCACCTTCCTTAA,29,3197655
rdlDp,1.0263157894736843,75,37,CAGTATCCAATACACGGGCT,38,3180758
rdlDp,0.8947368421052632,70,37,ATAGGACATTCAGTCCGCTC,33,3188372
rdlDp,0.5526315789473685,57,37,AGGGCAGTGCGCTGCTCACG,20,3171132
rdlDp,1.394736842105263,89,37,AGACAATCCTTCGTCTTGAA,52,3181910
rdlDp,0.2631578947368421,46,37,AATCGATTAGGTCATCGGGG,9,3182920
rdlDp,0.23684210526315788,45,37,AAGCCGAGGGCTAAGGAGAG,8,3168613
rdlDp,0.7105263157894737,63,37,AACAGACCTTAATTCACAGA,26,3191146
rdlDp,0.6216216216216216,58,36,TTTCGACGGGTGCTCAGTTG,22,3200748
rdlDp,1.2702702702702702,82,36,TCTCATTGGACATTAGCCTT,46,3164233
rdlDp,0.3783783783783784,49,36,TAGGCGCCCGGCGGCATACA,13,3201695
rdlDp,0.5675675675675675,56,36,TAATGATATGTGCTTCTAAA,20,3204620
rdlDp,0.2972972972972973,46,36,GTATGTAGGATTCCGAGTCG,10,3191747
rdlDp,0.9459459459459459,70,36,GGAGTAGACCTATCAGTAAT,34,3193774
rdlDp,0.2702702702702703,45,36,GGACCTTGCAGCGATGCCGT,9,3207493
rdlDp,1.1081081081081081,76,36,GAACGGTGATAGGTTATCCC,40,3195083
rdlDp,2.081081081081081,112,36,ACTGGGGATCTGGTCCTCGA,76,3194201
rdlDp,1.8333333333333333,100,35,CTGCAGTTTGGTCCAGGATA,65,3215408
rdlDp,0.05555555555555555,36,35,CCGCGATCTGACGATAGGTA,1,3195345
rdlDp,0.1388888888888889,39,35,CCCGGGTGTGTAAGATACAT,4,3215804
rdlDp,1.2222222222222223,78,35,CCCCTTTTTTCAGGAAATAC,43,3188387
rdlDp,0.8611111111111112,65,35,CAGCTGTAACAGTGTGAAGG,30,3188763
rdlDp,0.2777777777777778,44,35,AGCGAGCTAGAGCAGTGTGA,9,3195343
rdlDp,1.5,88,35,AGATAGGTGCGTGAGGAGTC,53,3201413
rdlDp,1.5714285714285714,88,34,TAGCGGATTACGGTCCATGA,54,3173128
rdlDp,0.42857142857142855,48,34,GTCGGCTCTTTTCTTTTTAT,14,3190422
rdlDp,0.4,47,34,GGAGGATCCGATACTCCTGT,13,3188760
rdlDp,0.37142857142857144,46,34,CTTTCAGGTGAACTTTTACA,12,3197962
rdlDp,0.6571428571428571,56,34,CGGCCACTCGAGAAGCTTAT,22,3204358
rdlDp,0.42857142857142855,48,34,CAATGCGCCGAAGAGTTCGC,14,3192825
rdlDp,0.4857142857142857,50,34,ACGCAGAAATACGATTGGGC,16,3165545
rdlDp,0.14285714285714285,38,34,ACACTTGCCTAGGTTTAGAG,4,3165295
rdlDp,0.058823529411764705,34,33,TCTTATCGGTTTTGCATAAT,1,3166566
rdlDp,0.11764705882352941,36,33,GGGGAACAGTGTCAATTCGT,3,3171708
rdlDp,0.47058823529411764,48,33,GCGTTGATACCACGGAGCTT,15,3168938
rdlDp,0.8235294117647058,60,33,GATACTGTAACTGTAAAGCG,27,3168952
rdlDp,0.3235294117647059,43,33,GAAGACCGGCTCCACCCTCA,10,3170274
rdlDp,0.23529411764705882,40,33,CTGATACTAAGGGTCCCCGT,7,3201468
rdlDp,0.11764705882352941,36,33,CTCTAGAAATCTATTAGCTA,3,3187179
rdlDp,0.3235294117647059,43,33,CTAGTTTGACGATGCAATGA,10,3195864
rdlDp,1.0,66,33,CCTTGGAGTATGTAAGCGAG,33,3194128
rdlDp,0.9705882352941176,65,33,ATTAGCCCCCACACATGGAA,32,3197446
rdlDp,0.5588235294117647,51,33,ATATCTTCCTATTTTCATGT,18,3196275
rdlDp,0.4117647058823529,46,33,AGCGAAGCAGCCAAAGCTAG,13,3183659
rdlDp,1.0,66,33,AGCACGGGATCCTCTTTTTT,33,3192405
rdlDp,0.23529411764705882,40,33,ACTGGCGATGGTAACCGGGT,7,3192953
rdlDp,0.5882352941176471,52,33,AATGAAGTGAATAATGTCCG,19,3169416
rdlDp,0.23529411764705882,40,33,AACGAGAATACATGATCAAT,7,3192519
rdlDp,0.8484848484848485,59,32,GGGTTCAGCGGAATACCCAG,27,3206682
rdlDp,0.7575757575757576,56,32,GGGCAACACCTCCCGTGTTC,24,3176863
rdlDp,0.3333333333333333,42,32,GGATTATCATTTTGTAAAAG,10,3209579
rdlDp,0.30303030303030304,41,32,GAAGACGACAAGAAAGGGTA,9,3205318
rdlDp,0.9393939393939394,62,32,CTGTCTTAGGATAATTTGAG,30,3167659
rdlDp,5.151515151515151,201,32,CCATTACGTTGTTTCATCGT,169,3215953
rdlDp,0.36363636363636365,43,32,AGGTTGACACCTTCTGTAAC,11,3190723
rdlDp,0.24242424242424243,39,32,ACGTGGGGTAGATTCTGGAC,7,3200814
rdlDp,1.0606060606060606,66,32,ACGCGTAGAGGTTTGAACGA,34,3167662
rdlDp,0.53125,47,31,TTCTCGAGAGGCATTCGCCG,16,3186780
rdlDp,1.65625,83,31,TGCTTCAAGAAGCGACAGTA,52,3173190
rdlDp,0.25,38,31,TGCCGTACCACGCTCTGTAT,7,3192110
rdlDp,1.3125,72,31,TCTACGAGGGTACGTTCTGC,41,3177561
rdlDp,0.6875,52,31,TACGCAATTTCTTCATCACA,21,3165903
rdlDp,0.3125,40,31,GTACGACTGCGCTCGGCAAT,9,3166100
rdlDp,1.96875,93,31,GCAATCCGTAATTGCGCGCA,62,3176644
rdlDp,0.53125,47,31,GATCCGGCTCAAACGATGTT,16,3200683
rdlDp,0.09375,33,31,GATATGTCTAGAGAGCTATG,2,3210350
rdlDp,0.875,58,31,GATATGGAGGTCACGCTAAC,27,3192843
rdlDp,0.8125,56,31,GACTGAACAAATGCAGTCGG,25,3172833
rdlDp,0.96875,61,31,CCCCGACCCTTCTCAGGATT,30,3175318
rdlDp,0.3125,40,31,CCACCTAGATTATGTAGAAT,9,3172122
rdlDp,0.4375,44,31,CATTCCTGGTTATCACTCTG,13,3169078
rdlDp,1.96875,93,31,CATAGCCTAAGGCCCGGAGA,62,3192955
rdlDp,0.4375,44,31,ATCAAGTTCTCTCTTGTGAT,13,3182305
rdlDp,1.5,78,31,AGGCGTAGATATTCCGGCTG,47,3208291
rdlDp,0.21875,37,31,AAACGAGGGAGGCACGGCTC,6,3201155
rdlDp,1.4838709677419355,75,30,TTGACGATCTGGGGCCTGGT,45,3208289
rdlDp,0.4838709677419355,44,30,TTACTGGCCGCGTTACCCGC,14,3200658
rdlDp,1.1612903225806452,65,30,TCCTGTAAAAGTAGCATTAG,35,3215010
rdlDp,2.225806451612903,98,30,TCATAGCATTAGATATTACT,68,3177565
rdlDp,0.3225806451612903,39,30,TATACAATTCCACTCTTGTC,9,3191366
rdlDp,0.22580645161290322,36,30,GGTCCCATGAGACTGCAACT,6,3190726
rdlDp,0.1935483870967742,35,30,GGGCATTCATGTTCACCCAT,5,3187060
rdlDp,0.4838709677419355,44,30,GGCATAATCTCACAAAGGTA,14,3205556
rdlDp,0.1935483870967742,35,30,GCTAATTTCTCCATGGCCAC,5,3182919
rdlDp,1.6129032258064515,79,30,GAGCCATCCATGGTGTCCCA,49,3212604
rdlDp,1.2903225806451613,69,30,CTTACGTTTGCGTGATATAT,39,3215628
rdlDp,0.2903225806451613,38,30,CTCGAGACTTGAAACAGTCG,8,3204193
rdlDp,1.1612903225806452,65,30,CGCAGAGGCACGCGTCGGGT,35,3195684
rdlDp,1.4838709677419355,75,30,CCATTGTATTTAAAGGCCGT,45,3176701
rdlDp,0.2903225806451613,38,30,ATTTTAGCTTGATATGGCCG,8,3191164
rdlDp,0.12903225806451613,33,30,AGGTACACTCCGCGCTTGAC,3,3187076
rdlDp,0.45161290322580644,43,30,AGCCTACTCGGGTGAATCCT,13,3193281
rdlDp,2.5483870967741935,108,30,ACCATCGTTAACAATCGGGA,78,3171201
rdlDp,0.0967741935483871,32,30,AATTTAAGAATCTCCCGTGT,2,3194015
rdlDp,0.6774193548387096,50,30,AATCATCGATTCCTGAAGGA,20,3189676
rdlDp,0.3225806451612903,39,30,AAGATAGTAGACAAGCATAT,9,3210878
rdlDp,1.0,60,30,AACGATATTCAGGACCCCGT,30,3168612
rdlDp,0.2903225806451613,38,30,AAAAGGTTGCCTGCTGGGTT,8,3182111
rdlDp,0.23333333333333334,35,29,TTTCAGGTGCTATAACAAGC,6,3166561
rdlDp,0.7666666666666667,51,29,TTAAGACTTGAAGCTAAGCA,22,3170275
rdlDp,0.43333333333333335,41,29,TGGAATAGTTCTAACTAAAG,12,3191692
rdlDp,1.0333333333333334,59,29,TGCAGGCGTGTAGAACCCAA,30,3214009
rdlDp,1.2333333333333334,65,29,TCTTTTACAGAGTGCACCGG,36,3187929
rdlDp,1.6333333333333333,77,29,TCAGTCACAATATTGGTGTG,48,3215674
rdlDp,1.0666666666666667,60,29,GTACCAAAACGCACAGCAGA,31,3211695
rdlDp,0.16666666666666666,33,29,GCGTACCCGGGTTAGCTTGC,4,3208898
rdlDp,0.6666666666666666,48,29,GCACCGGCGATCGATCATAT,19,3168244
rdlDp,0.26666666666666666,36,29,GATCACCTGTCTCTAATTAA,7,3206952
rdlDp,0.6333333333333333,47,29,GACCCACCATTAGTGAAAAC,18,3211828
rdlDp,0.8,52,29,CCCACCACGACCCAGTTTCA,23,3175523
rdlDp,1.7333333333333334,80,29,CACTTCTGTAAGCTAAGCTA,51,3199612
rdlDp,0.8333333333333334,53,29,ATTCAACCTCTAGAGTAAAT,24,3194277
rdlDp,0.1,31,29,ATGCGACGGCGGATCGGGCA,2,3188773
rdlDp,1.2,64,29,AGAGGTTACATATGTCGGAC,35,3190591
rdlDp,2.7,109,29,AAGGGCTACGGTACCGCCCC,80,3176659
rdlDp,0.4,40,29,AAGACAAGGAGGCCTGCAGC,11,3176846
rdlDp,0.36666666666666664,39,29,AAATACCCTCCACGAACCAT,10,3195457
rdlDp,2.0344827586206895,86,28,TTGGATAGAAATTTAAGAGA,58,3168123
rdlDp,1.2758620689655173,64,28,TTAGACGATGAGCGAAGGCA,36,3212603
rdlDp,1.0,56,28,TGCTTAATTCATGCGAGGGT,28,3190354
rdlDp,0.896551724137931,53,28,TGAGCCGAGTCCTCCACCAC,25,3175533
rdlDp,0.13793103448275862,31,28,TAGACACGGCTGAATTGACC,3,3185049
rdlDp,0.7931034482758621,50,28,GTGGTCGGCCAGTGGCAGCA,22,3212022
rdlDp,0.13793103448275862,31,28,GTATAAGGTGGGAGTGAGGG,3,3164884
rdlDp,0.6206896551724138,45,28,GCTGCCATTCCGGACTATGT,17,3168444
rdlDp,0.8275862068965517,51,28,GCCAGGGAGAGGGTAACGCT,23,3171214
rdlDp,0.3103448275862069,36,28,GCACTGAAGCTGCTTTCCTG,8,3193834
rdlDp,0.10344827586206896,30,28,CTTTGGTCTAATCAGCGTAA,2,3168456
rdlDp,0.6206896551724138,45,28,CCCCCATCTCAGTGTTTAGT,17,3184571
rdlDp,0.2413793103448276,34,28,CATGTTCAGACAAAGTATTA,6,3167127
rdlDp,1.1379310344827587,60,28,CAATGAACATTTCGCGTACA,32,3203465
rdlDp,0.5172413793103449,42,28,CAACAGTCTCCACTGGATCT,14,3172326
rdlDp,1.1724137931034482,61,28,ATGGGGGGTACCTGTAGGCT,33,3204144
rdlDp,1.3103448275862069,65,28,ATAAACAGATACCACTATGT,37,3188370
rdlDp,0.6206896551724138,45,28,AGCATCAGCACATCACGGCT,17,3183116
rdlDp,0.8620689655172413,52,28,AACTCCTGACCAATCATTAA,24,3188506
rdlDp,1.3571428571428572,64,27,TGGGCGGGGTACAGTAATGT,37,3176750
rdlDp,0.35714285714285715,36,27,TGGATTCGTACATGGGAGAG,9,3172837
rdlDp,0.75,47,27,TATCTGAAAATGATGGTCGC,20,3210223
rdlDp,0.35714285714285715,36,27,TACAATCGTAACGGGACATA,9,3211909
rdlDp,0.42857142857142855,38,27,TAAATGGGGACCACTTGCTT,11,3200845
rdlDp,0.9285714285714286,52,27,GTGAGGCTACATCTATCCGG,25,3196179
rdlDp,0.8928571428571429,51,27,GTCCGTGTACCTCGTATCAA,24,3199848
rdlDp,2.25,89,27,GGGCATAGGCTTAAAAACTT,62,3196787
rdlDp,0.8571428571428571,50,27,GAGTCAAATAACCGTATACG,23,3177522
rdlDp,0.8928571428571429,51,27,GAGGGAGGGGTTTGGAGCGC,24,3212008
rdlDp,0.10714285714285714,29,27,GACCTCGCTATAAATAGAGT,2,3192221
rdlDp,1.2142857142857142,60,27,CTGCACCTTCGTCATATGGG,33,3205841
rdlDp,0.10714285714285714,29,27,CGTTCATGATCCACTTCTAT,2,3191755
rdlDp,0.35714285714285715,36,27,CGGTGCCCCTACCTTCCAAA,9,3169453
rdlDp,1.1071428571428572,57,27,CGAGGCCGCGGTAACATTCA,30,3166471
rdlDp,12.464285714285714,375,27,CCTGTGGGTATGCTTTCTGG,348,3193593
rdlDp,0.14285714285714285,30,27,CCTGTCTCAGGAGTAGGTGT,3,3173401
rdlDp,1.25,61,27,CCTGACAGGTCAACAGGGTG,34,3190852
rdlDp,0.35714285714285715,36,27,CCAAGAATGCGACGCGAGCA,9,3172751
rdlDp,0.6785714285714286,45,27,AGGGGCTAGTCTCCTGCCTC,18,3202295
rdlDp,0.5714285714285714,42,27,AATGGTGTGAGCGAGAGGGT,15,3198662
rdlDp,0.8148148148148148,47,26,TTCCGCTCGGAATTTGTCTC,21,3188319
rdlDp,0.37037037037037035,35,26,TATTGAGCGCGCTGGGCAAG,9,3183468
rdlDp,0.18518518518518517,30,26,GGGTCTCTCCTGCTCCGCTT,4,3208853
rdlDp,1.0740740740740742,54,26,GGGGGGACACAACTGATAGG,28,3173327
rdlDp,3.259259259259259,113,26,GCTCCTTATTGGAGTGTCCA,87,3196646
rdlDp,2.2962962962962963,87,26,GCTAGCATGACTTCGAATTC,61,3192651
rdlDp,0.4074074074074074,36,26,GCTAACGTGTGAAGAATTGT,10,3172334
rdlDp,0.07407407407407407,27,26,GCGATGTAACCTGGAGGTGG,1,3174129
rdlDp,1.6296296296296295,69,26,GCGAGGCCCCCTGCTAAGTT,43,3176235
rdlDp,0.48148148148148145,38,26,GATTTCCGTCACTTCCCGTC,12,3171958
rdlDp,0.8148148148148148,47,26,GAGCGCGCGAGGGCCAAAAC,21,3172030
rdlDp,2.4444444444444446,91,26,CTAGCTACCGTTTGATACTA,65,3201075
rdlDp,3.2962962962962963,114,26,CTACTCTGGTTGGCTTATTC,88,3171563
rdlDp,1.2222222222222223,58,26,CGGCTAAGTATGATAATGTT,32,3201659
rdlDp,0.8518518518518519,48,26,CGATCATGAGTGAGTGGATA,22,3204973
rdlDp,0.2962962962962963,33,26,CGAGGTCTCTGCTGCAGCAG,7,3182422
rdlDp,0.7777777777777778,46,26,CCGCATATATTGCAGTTGTC,20,3205406
rdlDp,1.0,52,26,CATTTGCATCCTGTAGGTGT,26,3188828
rdlDp,0.5555555555555556,40,26,CATCGGATCGCTACAGGCGG,14,3188331
rdlDp,0.18518518518518517,30,26,CAGCATCTTTGACTCACAGA,4,3168899
rdlDp,0.6296296296296297,42,26,ATGGAAACATCAGTGCCGAG,16,3206632
rdlDp,0.4074074074074074,36,26,ATATCAATCAATGACATTCG,10,3203483
rdlDp,0.37037037037037035,35,26,ACGCTGTAGCTTTGTGGTGT,9,3173407
rdlDp,1.1481481481481481,56,26,AAAGCACGCGACCCGTGAGA,30,3172120
rdlDp,0.6153846153846154,40,25,TTGGCCCCGCATCCAGTGTC,15,3195429
rdlDp,1.4230769230769231,61,25,TCGGAGCTTAACCGGAGTAT,36,3191739
rdlDp,1.9230769230769231,74,25,TCCGTGTTGCTCACCTGGTC,49,3206785
rdlDp,0.4230769230769231,35,25,TCCCTGTACTTTCTACTAGA,10,3168787
rdlDp,0.6153846153846154,40,25,TATGTCAGTTCTTTAATGGT,15,3165132
rdlDp,0.6923076923076923,42,25,TAGACGACTAGCCTGTATTG,17,3185041
rdlDp,1.8076923076923077,71,25,TACCGAAAACTGGTCAGACA,46,3195453
rdlDp,0.5769230769230769,39,25,GTTAGCACCCAAATAAATAA,14,3171862
rdlDp,0.11538461538461539,27,25,GTGTACGTATAGGAATCTAT,2,3203711
rdlDp,0.5769230769230769,39,25,GGGGAGAAGAGGCGGGGACA,14,3177513
rdlDp,0.38461538461538464,34,25,GGGCAGGCGCAACGCTTCCA,9,3180129
rdlDp,0.8461538461538461,46,25,GCGGAGGAGCGGTTGGTGGA,21,3174397
rdlDp,1.1538461538461537,54,25,GCGGAAGTGACGACCAACTT,29,3206038
rdlDp,0.6538461538461539,41,25,GCCGACACGGCGGTGAGTTG,16,3213599
rdlDp,0.19230769230769232,29,25,GATTGGCCAATATAAGAAGA,4,3179520
rdlDp,1.2692307692307692,57,25,CTCTTGGCCCAAATTGGTAT,32,3181886
rdlDp,0.8076923076923077,45,25,CTATATTCTTATGGTGAATC,20,3176749
rdlDp,0.38461538461538464,34,25,CGTTTGCCCCCGTTGCACCT,9,3210846
rdlDp,2.3461538461538463,85,25,CCTTTGTCAGGTTGATTCAC,60,3175079
rdlDp,0.6923076923076923,42,25,CCTCACGTAGATACTTGGCC,17,3173126
rdlDp,0.23076923076923078,30,25,CCGTTAATCTACGGGTCCAA,5,3209792
rdlDp,0.6538461538461539,41,25,CAGGTTGAGGCACTAAAAGT,16,3204968
rdlDp,0.3076923076923077,32,25,CACCGAGCAACACAGGTGGT,7,3187814
rdlDp,0.11538461538461539,27,25,CACCAGGACGGCGCCTCTCA,2,3208894
rdlDp,0.15384615384615385,28,25,CACAAGGGACCAAACTGATG,3,3187811
rdlDp,1.2307692307692308,56,25,CAAGCGTTCTCCACTAGGTT,31,3167135
rdlDp,0.23076923076923078,30,25,ATGCCGATGTACTAAAGTTA,5,3185063
rdlDp,0.7307692307692307,43,25,AGTGCTCTGCATCCCCACCA,18,3171378
rdlDp,0.5769230769230769,39,25,AGTATCCGAAGTGATTAAGA,14,3201462
rdlDp,0.11538461538461539,27,25,AGTACCGATGCGAGGTAGGT,2,3187156
rdlDp,0.7692307692307693,44,25,AGGAACAGTGTCACCTTCCT,19,3181619
rdlDp,0.46153846153846156,36,25,AGAAATCTACCCAATCGGAC,11,3207642
rdlDp,0.5384615384615384,38,25,ACTGTAGAGTTAACGAGACG,13,3214560
rdlDp,0.34615384615384615,33,25,ACTAGCGGCATACTCATCGG,8,3190025
rdlDp,1.7692307692307692,70,25,AATGTGTATGGGACTTGAAG,45,3179152
rdlDp,0.6153846153846154,40,25,AAGGGTATAACATGCCATTA,15,3198996
rdlDp,0.36,32,24,TTGTGTCGATGCTCCGCTTA,8,3166958
rdlDp,0.2,28,24,TGGCTTGGAGATCGTCAGTT,4,3165632
rdlDp,0.2,28,24,TCAAGTTTAAGCCCATCCCG,4,3174405
rdlDp,0.24,29,24,TAGGTACCAGAAAATGGTTG,5,3208293
rdlDp,0.28,30,24,TAGGCTATTTCGCTAACTTA,6,3175326
rdlDp,1.04,49,24,GTCCATCCAATGTGGATGGT,25,3196789
rdlDp,0.8,43,24,GTATTCCACCACGAGTAGTA,19,3175317
rdlDp,0.28,30,24,GGTATTCGCCGATTATGAAT,6,3201467
rdlDp,0.88,45,24,GGCTGTCAAAATCTACGTTC,21,3181897
rdlDp,0.6,38,24,GGAATGAATCGGTATGCATA,14,3210301
rdlDp,1.4,58,24,GCCTGGCTTCGTGTCTCTGC,34,3201831
rdlDp,0.48,35,24,GCCTGCCTGGCGTTACATAG,11,3181793
rdlDp,0.16,27,24,CTGGTGGTAGGTATGTAGTA,3,3176282
rdlDp,1.84,69,24,CTGGCATCGCACAAAACTCC,45,3176237
rdlDp,1.6,63,24,CGGGGGTGTACCCGGGATAA,39,3170954
rdlDp,0.08,25,24,CGCAATCGGGTGGGAGCCTA,1,3184946
rdlDp,0.24,29,24,CCGCAGCCCAAGACGAGGAC,5,3187071
rdlDp,0.2,28,24,CCGATAGCCTTGTTTACTGT,4,3207499
rdlDp,0.48,35,24,CCACCAGTTCGGACAAGTGT,11,3173757
rdlDp,0.08,25,24,CAGCATACGTAGCGTTCGCG,1,3209305
rdlDp,0.64,39,24,ATCTGTTTAGGGCATTTGTT,15,3208424
rdlDp,0.44,34,24,ATATCGGGCTTTCAATTATT,10,3187810
rdlDp,0.64,39,24,ATAGTTTCTTGAGGTCGGTT,15,3184623
rdlDp,0.48,35,24,AGATAAAACTCCCCGATAAT,11,3197277
rdlDp,1.0,48,24,ACGTCTAGGTGATGCCGCCA,24,3200015
rdlDp,2.28,80,24,ACGTAGGCACATTTAGTAGT,56,3184711
rdlDp,1.16,52,24,ACGACTCGCTCGTGCAAAAA,28,3211803
rdlDp,0.48,35,24,ACCTGGGTAGTAGGTGTCCA,11,3204338
rdlDp,0.8,43,24,ACCGCTATCTCAGCTTTTAG,19,3180922
rdlDp,0.36,32,24,ACCAACTGGGGGTCAGTCTT,8,3198457
rdlDp,0.24,29,24,ACAGTTCTACTTTGTACCCT,5,3192683
rdlDp,0.52,36,24,AAGAAGTGAAGGCCCTTGTC,12,3183273
rdlDp,0.125,25,23,TTATGATGTGACCTCGGGAG,2,3167497
rdlDp,0.5833333333333334,36,23,TTACCATTCACATGTCCGCT,13,3209284
rdlDp,0.25,28,23,TTAAAGTAATCCAGTACACG,5,3189649
rdlDp,0.125,25,23,TCTGACTCCCACCCGTTTAG,2,3188868
rdlDp,0.20833333333333334,27,23,TCGGTAAGGGTTAGGTCATG,4,3178722
rdlDp,0.9583333333333334,45,23,TCACCCCGATGGTCGAAGAC,22,3192958
rdlDp,0.4583333333333333,33,23,TAGGTGAGCTGTACAGCCTG,10,3181982
rdlDp,1.75,64,23,TAGGCAACAGAGTGGTACAT,41,3215012
rdlDp,0.125,25,23,TAGCCGGAGGCAGCCGATAC,2,3187061
rdlDp,1.0,46,23,GTTACAGTTGCCCTGGTTAT,23,3177511
rdlDp,0.375,31,23,GGGTGATGTGGGAAGGACAA,8,3201766
rdlDp,0.5416666666666666,35,23,GGAATGGAGGGGGCAAATTA,12,3178070
rdlDp,0.2916666666666667,29,23,GCCCTACCACGCGCGTGGTG,6,3192203
rdlDp,0.25,28,23,GCATAAATAGCTTCAGCGAA,5,3187674
rdlDp,0.7083333333333334,39,23,GACGTGCCCTGATTCGCAGA,16,3208736
rdlDp,0.8333333333333334,42,23,GAATGGATAAGCTAATAGGT,19,3170865
rdlDp,0.20833333333333334,27,23,GAACTCGATAATTACATCTG,4,3205564
rdlDp,8.541666666666666,227,23,CTGCCCATGTTGCCGAGTAA,204,3193642
rdlDp,0.5416666666666666,35,23,CTCCCTTTGTCGATGGCAGT,12,3169199
rdlDp,1.4583333333333333,57,23,CGTGTCCCGGCGGTAGGTTG,34,3194195
rdlDp,0.5833333333333334,36,23,CGTAGTATTGTGATCGTGCT,13,3181615
rdlDp,0.9583333333333334,45,23,CGTAATGGTTTAGTTCGACC,22,3174886
rdlDp,0.4166666666666667,32,23,CGGTCGGGTCGGAAGGTACC,9,3204356
rdlDp,0.25,28,23,CGAGCATCGTGTGAGCTCCT,5,3167283
rdlDp,0.6666666666666666,38,23,CCAGTGGACTCATACTTTCC,15,3171221
rdlDp,0.4583333333333333,33,23,CCACGCCTAGCGTGATTTTG,10,3208122
rdlDp,0.75,40,23,CATATCTACCTGGCGAGTCT,17,3211865
rdlDp,0.5,34,23,CAGGCAGTGTATAAACTCGT,11,3200817
rdlDp,1.2083333333333333,51,23,CACGTCTAACTCATTGTACT,28,3209702
rdlDp,2.1666666666666665,74,23,CACACCAGAATGGTTATGGA,51,3181025
rdlDp,1.0833333333333333,48,23,ATTGATAAGGATGGCGTAGA,25,3173439
rdlDp,2.0833333333333335,72,23,AGGTGATGGGCATTTAGGCT,49,3167186
rdlDp,0.16666666666666666,26,23,AGGCCCAGCCGTGGGGGGCT,3,3187194
rdlDp,0.875,43,23,AGCCACACGTCTCAACTCGT,20,3206025
rdlDp,1.0833333333333333,48,23,AGCCAAGGATAATGTCAGGG,25,3172234
rdlDp,0.3333333333333333,30,23,AGACCATTCCTTCGGATACT,7,3199443
rdlDp,0.125,25,23,ACGAGCAAGTTCTACCATGA,2,3213286
rdlDp,1.375,55,23,ACAGGTCATTATGCGGACAT,32,3199444
rdlDp,0.375,31,23,AATTATTGGCCGTACTTAAC,8,3190729
rdlDp,2.0416666666666665,71,23,AATGGTGCCCTACTTAGGGT,48,3167658
rdlDp,0.9166666666666666,44,23,AATCGGGTCCATATCGAGGA,21,3208558
rdlDp,0.6086956521739131,35,22,TTTTGACGGTGTGTCTCTTC,13,3197276
rdlDp,0.43478260869565216,31,22,TGTTGCTAAAGGGCTTTGTG,9,3171472
rdlDp,0.391304347826087,30,22,TGTCGTGGTCGAAGACGAGC,8,3173840
rdlDp,1.5217391304347827,56,22,TGGTCACGGGTTCGTAAGGT,34,3175906
rdlDp,1.0,44,22,TGGCGTGTGAAAAACGCCAT,22,3204624
rdlDp,0.2608695652173913,27,22,TGCTCGAGGGTACTGTCCTT,5,3165920
rdlDp,1.2173913043478262,49,22,TCTCCGCTCGTCGGTTAGGG,27,3206233
rdlDp,0.6521739130434783,36,22,TCCCGGTCTATATGCTTCCA,14,3164150
rdlDp,2.5652173913043477,80,22,TCCACCTCAGAAGTAGCCAC,58,3206036
rdlDp,0.4782608695652174,32,22,TCAATTCTCATCCATCAACG,10,3197785
rdlDp,1.3478260869565217,52,22,TAGGTTTTTCACTGGTGTTG,30,3176742
rdlDp,0.4782608695652174,32,22,GTCCGGATAACTCGCGGTAG,10,3201915
rdlDp,0.17391304347826086,25,22,GGTGGGGGCTGACATGTTCA,3,3167524
rdlDp,1.6956521739130435,60,22,GGGCTGAAACCGAGCTCGGT,38,3181802
rdlDp,1.434782608695652,54,22,GGCTTGCGTACAACGGGTTG,32,3215750
rdlDp,2.260869565217391,73,22,GGCCGACGTTAAAACCAATG,51,3198052
rdlDp,0.8260869565217391,40,22,GCTGTCCCTAAAATACCTGG,18,3198520
rdlDp,0.21739130434782608,26,22,GCATAACCTAGGATGTTACA,4,3169091
rdlDp,0.13043478260869565,24,22,GATGGATTAGTGAACGATGG,2,3211868
rdlDp,2.8260869565217392,86,22,GATCGTTCGCTAATCGTAGA,64,3172887
rdlDp,1.3043478260869565,51,22,CTTCTCCGACTTCGAGTATT,29,3208014
rdlDp,0.9130434782608695,42,22,CTAAGTATATGGTACGATTG,20,3193946
rdlDp,0.21739130434782608,26,22,CGTGGTCACGTGCATCCTCA,4,3200799
rdlDp,2.5217391304347827,79,22,CCCCCGAGGACGAGAGTGGC,57,3205473
rdlDp,1.2608695652173914,50,22,CCCCAGAATCTCGTGAGAAA,28,3211211
rdlDp,2.130434782608696,70,22,CCACGTTTGACCAAATGCAT,48,3210224
rdlDp,0.7391304347826086,38,22,CAGAACGGTTGTTTGTTAGA,16,3196369
rdlDp,0.391304347826087,30,22,ATGCTTGGTTTAGGTGGCCG,8,3206646
rdlDp,2.347826086956522,75,22,ATGCTGCTCTATACCGGAAT,53,3172884
rdlDp,2.391304347826087,76,22,AGTACAGCGTGGGAAGTGTA,54,3172880
rdlDp,1.2173913043478262,49,22,AGGATAAGCCCTTAGAGCAA,27,3197287
rdlDp,0.6956521739130435,37,22,AGCTTCCTGGGGCCACTCTT,15,3179156
rdlDp,7.739130434782608,199,22,AGCGGGACGATGCACGGGAT,177,3203733
rdlDp,2.217391304347826,72,22,ACTGTGCCTGTAAATCATGT,50,3178915
rdlDp,0.08695652173913043,23,22,ACTAGCGTTTGGAGAGCCAA,1,3175345
rdlDp,0.08695652173913043,23,22,ACGCACAGCCCATGCAGCTT,1,3193284
rdlDp,1.391304347826087,53,22,ACAAGGAAGCGCTGGGTCAG,31,3204137
rdlDp,0.391304347826087,30,22,AAAGGTATGTTATACAAGAG,8,3165131
rdlDp,18.772727272727273,433,21,TTTGCACTGATGTGCCACGA,412,3193592
rdlDp,0.6818181818181818,35,21,TGTTTCATGAACGCGTCAGC,14,3202655
rdlDp,4.2727272727272725,114,21,TGCTAACTATGCAGTTATGC,93,3182159
rdlDp,0.3181818181818182,27,21,TGCGGATGTAGATTTGCTGT,6,3213868
rdlDp,0.4090909090909091,29,21,TGCACAGGGACAGGTTGTTT,8,3187186
rdlDp,5.954545454545454,151,21,TCTATGGTTGCCACTGAGCT,130,3194133
rdlDp,1.3181818181818181,49,21,TCGTGAACAATGTCACGGTA,28,3192318
rdlDp,0.5909090909090909,33,21,TCCATTCGTACCAGAGAATG,12,3168900
rdlDp,2.409090909090909,73,21,TAGGACCTTATCTGTGGCCC,52,3193616
rdlDp,0.5454545454545454,32,21,GTTGGAGAATAACACCTCCC,11,3209580
rdlDp,0.18181818181818182,24,21,GTTGCACCTACAGAAGGGAG,3,3207857
rdlDp,2.0454545454545454,65,21,GTCTCGTCTTACAGAGCCCC,44,3181794
rdlDp,0.7727272727272727,37,21,GTCACAGTCAAGTCAGACTA,16,3178723
rdlDp,0.18181818181818182,24,21,GTATATGCTTATAGCCAAGA,3,3190738
rdlDp,0.3181818181818182,27,21,GTAGGTTTAGAACACTAAGC,6,3201461
rdlDp,0.8181818181818182,38,21,GTACCAGGTCTTCCGTACGA,17,3174166
rdlDp,0.6363636363636364,34,21,GGTGCTCCTCAGCCCCGCAT,13,3177171
rdlDp,1.5909090909090908,55,21,GCGGTGCCGCTGGGAAATAG,34,3192954
rdlDp,0.18181818181818182,24,21,GCGCAATACTTATGGCGATC,3,3164780
rdlDp,0.7272727272727273,36,21,GCAACATAGGGTCGAGCATA,15,3201434
rdlDp,0.09090909090909091,22,21,GAGGGGTGACTCGAAACCCT,1,3176899
rdlDp,0.2727272727272727,26,21,GACCCGCCTAACAAACGAAA,5,3175561
rdlDp,0.7272727272727273,36,21,CTTATGCCATCTTCACGTCA,15,3175946
rdlDp,0.22727272727272727,25,21,CTCAATTTAAGTAACTGATA,4,3199346
rdlDp,1.4545454545454546,52,21,CGTGCATAAAAACAGGAGGT,31,3193807
rdlDp,1.0,42,21,CGTCCTAAAAAATTGGTGCA,21,3190353
rdlDp,0.45454545454545453,30,21,CGAGGGGTCTCTGCTTAGGA,9,3167213
rdlDp,2.1818181818181817,68,21,CCGTGTCTTTATCGGCATAA,47,3176734
rdlDp,0.8636363636363636,39,21,CCCTCTTGTACACGTGATAT,18,3191289
rdlDp,1.0909090909090908,44,21,CCCGTGTGACAATCGGAGTG,23,3191701
rdlDp,0.8181818181818182,38,21,CCCCATGACATGAGTCTTAT,17,3188949
rdlDp,0.09090909090909091,22,21,CCAGACCGTAATAACCAGCT,1,3182303
rdlDp,0.36363636363636365,28,21,CCAATAGCCGAAAGATCCGG,7,3204849
rdlDp,1.6363636363636365,56,21,CAATTCGCGTCTGTTAGCCA,35,3201358
rdlDp,1.9545454545454546,63,21,ATTCGACTATAAGACGCAGG,42,3207381
rdlDp,0.09090909090909091,22,21,ATGAATAAAACAGGCTCGAC,1,3178304
rdlDp,0.7727272727272727,37,21,ATCACCGCCACCTGTCGTCG,16,3207649
rdlDp,0.3181818181818182,27,21,ATATTAGTTGGTCGGCGAAA,6,3195674
rdlDp,1.6363636363636365,56,21,ATAGGTCCTATCAATTACTC,35,3208304
rdlDp,0.5909090909090909,33,21,AGGGGTATGCGTTGGCGTGA,12,3197795
rdlDp,0.5454545454545454,32,21,AGATTAGCATGTTTAGAGCG,11,3168939
rdlDp,0.8636363636363636,39,21,ACTGTGATAATCGGGGACGT,18,3195747
rdlDp,0.19047619047619047,23,20,TTGGGAATCGATACACTCGC,3,3192530
rdlDp,0.8095238095238095,36,20,TTAGGGATACCTAGTTTTGG,16,3181548
rdlDp,1.0,40,20,TGGCTATACTTATACTTTCT,20,3193941
rdlDp,1.9047619047619047,59,20,TGCGTCTCAGCAGCGGCCAG,39,3169601
rdlDp,0.09523809523809523,21,20,TGAGTTTCCGTACGGGGACA,1,3191761
rdlDp,1.4285714285714286,49,20,TGAAGAGGGCAAAAGTGAGC,29,3175944
rdlDp,4.9523809523809526,123,20,TCGTATAACTGGTTCTTAGT,103,3177967
rdlDp,1.4761904761904763,50,20,TCATAACCGCAGTGAATAAG,30,3188320
rdlDp,3.4761904761904763,92,20,TACGTAAGATCCCAGTCAGG,72,3207383
rdlDp,0.2857142857142857,25,20,GTTACCTTGTTACGGGTGTG,5,3172227
rdlDp,0.7142857142857143,34,20,GTATCGGTGGTATCTGCCTA,14,3192403
rdlDp,0.09523809523809523,21,20,GGTTCAAAATCCACAAGCGC,1,3206967
rdlDp,0.14285714285714285,22,20,GCGGGACTCGACCATGCCAA,2,3167931
rdlDp,0.9523809523809523,39,20,GCGCTCGCTCTCTGCTCTTA,19,3170064
rdlDp,0.38095238095238093,27,20,GATACTGTATACTTATTTTG,7,3171837
rdlDp,0.23809523809523808,24,20,GATAAATCACCTGTATTCTA,4,3180890
rdlDp,1.1428571428571428,43,20,GACTAAACTCATAGTCACCA,23,3198659
rdlDp,1.1904761904761905,44,20,GACAGGTCGCTAATCCATTA,24,3168786
rdlDp,1.6666666666666667,54,20,CTTGACGAGAGGCACCAAAC,34,3215412
rdlDp,0.2857142857142857,25,20,CTGTCCTTCCGTTTCCCATC,5,3177218
rdlDp,0.5238095238095238,30,20,CTGGTCTTGACGCCGGATGC,10,3204982
rdlDp,1.0,40,20,CTCGGTAAATTATCCATGAT,20,3164516
rdlDp,0.8095238095238095,36,20,CTACGGTAGCTTCGTTGTCG,16,3207328
rdlDp,0.23809523809523808,24,20,CGATCAAGGGGAGCCTGTTG,4,3169973
rdlDp,1.4761904761904763,50,20,CGACCGGGGTACGTAACGAC,30,3210497
rdlDp,0.23809523809523808,24,20,CGAACTCAATGTTTGTAACC,4,3191149
rdlDp,2.5238095238095237,72,20,CCGTGGCCTGTTTCTCTGAC,52,3180632
rdlDp,1.380952380952381,48,20,CCGAGATGTCCAGGCCATTA,28,3191694
rdlDp,0.5238095238095238,30,20,CCCTTACTTACAATCGGATC,10,3194601
rdlDp,0.14285714285714285,22,20,CCCCGCTCAAAATCGTACAG,2,3208755
rdlDp,0.5714285714285714,31,20,CAGATTCTTTCTGTATAATA,11,3179294
rdlDp,4.523809523809524,114,20,CACTGGTACAGGGAAGTTGA,94,3169380
rdlDp,0.8095238095238095,36,20,CACGTACGCTAAACTAGCGC,16,3201916
rdlDp,0.09523809523809523,21,20,ATTCATAGGATTGTAAGATT,1,3185121
rdlDp,1.2857142857142858,46,20,ATGCATCTTAACCTCTAATG,26,3209431
rdlDp,0.09523809523809523,21,20,AGTCAATTATGATCGGAGTC,1,3189586
rdlDp,0.9047619047619048,38,20,AGGTCTCGAAACGCACAGAA,18,3207655
rdlDp,2.3333333333333335,68,20,AGACACCCAAGCAGTTCCTG,48,3181875
rdlDp,0.6666666666666666,33,20,AGAAACACTAACTTCGGACA,13,3187066
rdlDp,1.0952380952380953,42,20,ACTGCTTACCGCGTTCCATT,22,3186297
rdlDp,1.6666666666666667,54,20,ACATTACAACTTCGTTTGCC,34,3184205
rdlDp,0.5714285714285714,31,20,AAGAATGATTAGCGGGCGCA,11,3176850
rdlDp,0.23809523809523808,24,20,AACTTTTAGTGGAAACGCCG,4,3176867
rdlDp,0.85,35,19,TTTTAGAGGTGCGCCAGGCT,16,3190026
rdlDp,0.35,25,19,TTTCGTTGCCAGATATACAA,6,3164154
rdlDp,0.65,31,19,TTGTGCCCTAGTTAGCAGAA,12,3167190
rdlDp,0.4,26,19,TTGTCTTACTTAGACTTACT,7,3172158
rdlDp,0.9,36,19,TTGTCCGGTAGGAGGTACCT,17,3194934
rdlDp,1.75,53,19,TTGCAAATCGGATTGACTGC,34,3208205
rdlDp,1.0,38,19,TTCATAGTAGGTTTAGGTCC,19,3177580
rdlDp,0.5,28,19,TGTTAAATATGAGGTTCTTA,9,3206026
rdlDp,0.3,24,19,TGTGTGCGGGCCGGCTTTCA,5,3174586
rdlDp,0.25,23,19,TGTATCATTGTATACGGTTT,4,3187819
rdlDp,0.55,29,19,TGGATTAAAAAGTGCTTGAG,10,3173400
rdlDp,1.05,39,19,TGCTTGTAATAGTCATAGTC,20,3180408
rdlDp,0.1,20,19,TCTTGGCGCATGTGTCCTTA,1,3171411
rdlDp,1.7,52,19,TCTGCCCGACCCGAATGGCT,33,3169873
rdlDp,0.4,26,19,TCCGTGGCTTCTCAGGCGTT,7,3195454
rdlDp,0.85,35,19,TCAGGTTTAAGTCGCGCCTT,16,3198195
rdlDp,1.15,41,19,TCAGGATTGGCCGTGTTCAC,22,3176752
rdlDp,2.15,61,19,TAAAGGTCCATTGAGATCCT,42,3187578
rdlDp,0.4,26,19,GTTAGTGGATTTTGAACTTA,7,3197808
rdlDp,0.8,34,19,GTCACCATTAGGCTCATGAG,15,3206915
rdlDp,0.85,35,19,GGTTTCGCTAGTCCAATGAT,16,3212044
rdlDp,0.1,20,19,GGTACGACAAAGAACTAAGT,1,3191306
rdlDp,2.25,63,19,GGCCCTCTTAATGGAGAGGT,44,3181692
rdlDp,0.3,24,19,GGCACGCGGCGCGCTGGGTA,5,3164157
rdlDp,0.2,22,19,GGATGCGGGCGACCCTTCTA,3,3175919
rdlDp,0.85,35,19,GCTTTGCCATAGTTTGGGCG,16,3197283
rdlDp,0.55,29,19,GCTGATCCAACTAGCGCTCG,10,3197294
rdlDp,0.55,29,19,GCGTTGCGCATAAACGGCCT,10,3165536
rdlDp,0.5,28,19,GCGCCATCTGACTGTTTCTC,9,3181998
rdlDp,0.45,27,19,GATCTGCCCAAGATGTATAC,8,3171043
rdlDp,0.95,37,19,GACCCGGGGACGGTGGCACG,18,3213869
rdlDp,0.1,20,19,GAAAGATGTAAGCCGGATAC,1,3190875
rdlDp,0.4,26,19,CTTCGGGACAGAGCTAGTCG,7,3169967
rdlDp,0.35,25,19,CTGATTGAGCCTCTCTAGCT,6,3201627
rdlDp,0.7,32,19,CTATTAATGGCCGCAGCCTA,13,3208416
rdlDp,4.4,106,19,CTATCCTGCGCAAGCTGGGG,87,3209363
rdlDp,0.1,20,19,CGCCCACGGATTTAGTTCGT,1,3164828
rdlDp,0.7,32,19,CCGGTCAATCTGGATGCATC,13,3188499
rdlDp,0.75,33,19,CCGGGCATAGTGAGGCGCTG,14,3209708
rdlDp,2.3,64,19,CCGCCTAGACCACCTTTCTA,45,3190724
rdlDp,0.15,21,19,CCGCCGAGATGACACCATGA,2,3193283
rdlDp,0.7,32,19,CATTCTACCGTTTCATGAGT,13,3198847
rdlDp,2.05,59,19,CAGGTAATCCCTCAAACAGT,40,3193880
rdlDp,0.65,31,19,CAGCTAGTCTTTGACACTAC,12,3164883
rdlDp,0.35,25,19,CAGACGTATTTGCCTGTAAT,6,3188950
rdlDp,0.6,30,19,CACGATGCCAATTCTGGATA,11,3168789
rdlDp,1.1,40,19,CACCGGCAATTGACAGACGG,21,3180140
rdlDp,0.45,27,19,CACCGGACACGGGTCTATCA,8,3185079
rdlDp,0.25,23,19,CAAGGCTCGCGTAGTCGGGA,4,3184920
rdlDp,6.05,139,19,CAAGCGTGCTCTCGGCGTTA,120,3168125
rdlDp,0.3,24,19,CAACCGATAGCAAGCTGTTC,5,3187672
rdlDp,1.2,42,19,ATTGCATGCATAGACCATCA,23,3176359
rdlDp,0.15,21,19,ATTAGAGATACATGAGCCCA,2,3182428
rdlDp,7.95,177,19,ATCCATAATCACGGATTCAA,158,3185093
rdlDp,1.75,53,19,AGTAGAGCACTCCTTGCGAG,34,3195633
rdlDp,0.1,20,19,AGGGGGAAACCTGCCGGCGG,1,3176737
rdlDp,0.9,36,19,AGGCTCCGATTCTATGGCAT,17,3215281
rdlDp,1.0,38,19,AGGCCCGCTAGGAGCATAAT,19,3197794
rdlDp,0.15,21,19,AGCCAAGACAAGGATTTCGT,2,3188951
rdlDp,0.9,36,19,ACTGTGGGGATGTTCACTCC,17,3190722
rdlDp,0.5,28,19,ACGGCTAAGTTCCTGTTGAA,9,3184915
rdlDp,1.65,51,19,ACGAGCATTCTAAAAAATAT,32,3202969
rdlDp,1.0,38,19,AAGCGTGTACTTAGTGATCC,19,3166108
rdlDp,0.1,20,19,AAGCAACTCTGGGAGTCAAA,1,3208031
rdlDp,0.6842105263157895,30,18,TTTGCTACAGGAAATAGTAT,12,3188100
rdlDp,2.1578947368421053,58,18,TTTACGTAACGCAGAGAGAA,40,3207675
rdlDp,0.6842105263157895,30,18,TTTACCGATTATTGCCGACG,12,3168795
rdlDp,0.15789473684210525,20,18,TGTTTAAGAGCCCAATTGGC,2,3167669
rdlDp,0.3157894736842105,23,18,TGGGATGAAATGGACACTAG,5,3185134
rdlDp,0.7368421052631579,31,18,TGATGAGTCAATGTTTGCTC,13,3208170
rdlDp,0.5789473684210527,28,18,TCTCGTTGGGGAGGAAGTGG,10,3194596
rdlDp,0.8947368421052632,34,18,TCTCAAGTTGACGTCGGAGC,16,3164234
rdlDp,1.4210526315789473,44,18,TCGCACTCAATTCCGGGGCG,26,3173510
rdlDp,0.6842105263157895,30,18,TCACAATCCACTATCCCAGG,12,3172249
rdlDp,1.1578947368421053,39,18,TATTCCTCTCATCATTCAGA,21,3202384
rdlDp,0.5263157894736842,27,18,TAATAATGCTGGATCATTCA,9,3204349
rdlDp,1.2105263157894737,40,18,GTTTTTAGCTCTCGTTTATG,22,3187167
rdlDp,0.3157894736842105,23,18,GTCCTTTGGTCCCAGCCGCA,5,3198187
rdlDp,0.8947368421052632,34,18,GGGGGATTATGCGCCAAGCA,16,3191816
rdlDp,1.894736842105263,53,18,GGGGCGTAATGATGCTCGTG,35,3181024
rdlDp,1.3157894736842106,42,18,GGCCCTGTTTGTGGAAGTGA,24,3170764
rdlDp,0.5789473684210527,28,18,GGAGGGATTGATGAAGTGAA,10,3191837
rdlDp,1.4210526315789473,44,18,GGACACAGGAGTTTAGAAAC,26,3181360
rdlDp,1.2105263157894737,40,18,GCGCCGGTAAAGGCTGGAAC,22,3189588
rdlDp,0.5789473684210527,28,18,GCCCGTTTTCTATCTGATGA,10,3168809
rdlDp,0.2631578947368421,22,18,CTGTGCATTACCATCTGGCC,4,3166116
rdlDp,1.9473684210526316,54,18,CTGCCGTTGGCCCCCCCGTG,36,3181871
rdlDp,0.2631578947368421,22,18,CTACGGAAGATCCAATCCGA,4,3203850
rdlDp,1.1578947368421053,39,18,CTAATGGAATCCTTTTGTCA,21,3175346
rdlDp,0.15789473684210525,20,18,CGTTATGTGGCCATGGAGTG,2,3193494
rdlDp,1.8421052631578947,52,18,CGGGCGGCCTCGTGCGACCT,34,3208452
rdlDp,0.10526315789473684,19,18,CGGAGGAGGAGCTGAGCTGG,1,3202456
rdlDp,0.21052631578947367,21,18,CGCTGAGACAGACTTGGCGC,3,3191658
rdlDp,1.105263157894737,38,18,CGCGCACGTACCTGCGGGCT,20,3205829
rdlDp,2.4210526315789473,63,18,CGCGACATTTGAAAGACAAA,45,3171206
rdlDp,3.210526315789474,78,18,CGAGTCCTATTAGCGAGCCT,60,3198172
rdlDp,0.10526315789473684,19,18,CCTGGAGCAGTCGGCGGTTA,1,3169174
rdlDp,0.7368421052631579,31,18,CCGCGGACAATCCTACCATA,13,3209369
rdlDp,2.0526315789473686,56,18,CCCTTGGCATTTTTAAATTT,38,3197769
rdlDp,1.6842105263157894,49,18,CATCCCCTGCGTTAGCTCCC,31,3169381
rdlDp,2.6842105263157894,68,18,CATCAAAACAGCAATAAGTA,50,3212524
rdlDp,0.21052631578947367,21,18,CACGGTTTTATAATCCGGCA,3,3188503
rdlDp,9.789473684210526,203,18,CACCCATTGTCTTGGCCCAC,185,3193609
rdlDp,0.7368421052631579,31,18,ATTCTAGGACAGAGGTATCT,13,3180101
rdlDp,0.3157894736842105,23,18,ATTAGTCCAAAGATTGGAAC,5,3182112
rdlDp,0.8421052631578947,33,18,ATGCGTGGGGTAGGCTTTCG,15,3201083
rdlDp,0.21052631578947367,21,18,AGGAAACAGCGATCGCCGTG,3,3190899
rdlDp,1.0,36,18,AGCAGGACAGTGCCCATGGG,18,3211231
rdlDp,2.473684210526316,64,18,AGAACTCCTTGCTTTCGAGA,46,3172905
rdlDp,0.3157894736842105,23,18,ACGTTCTCTCGTAGGGGATG,5,3168609
rdlDp,1.1578947368421053,39,18,ACGGGGTAGTCAGAATGTAT,21,3178744
rdlDp,5.684210526315789,125,18,ACGCGAGGTTGAGACGTCAT,107,3181335
rdlDp,1.4736842105263157,45,18,ACCTCACAGTACTAGCCTAA,27,3205399
rdlDp,0.10526315789473684,19,18,ACCGACGTAGTCCTACATCA,1,3182284
rdlDp,1.2105263157894737,40,18,ACCCGCGACGCCAGAGTTTA,22,3201683
rdlDp,1.5789473684210527,47,18,AAGTCCCGGGGCCATGGGAA,29,3175981
rdlDp,0.3157894736842105,23,18,AAGGGGTAAATACAACGTGC,5,3178754
rdlDp,4.105263157894737,95,18,AAATCGAATTGACTACGGCT,77,3179291
rdlDp,0.8888888888888888,32,17,TTTCTAACGTCCGTTTCTAC,15,3197657
rdlDp,0.5,25,17,TGATGTCTGGCAAACTATTA,8,3204685
rdlDp,0.3333333333333333,22,17,TCTTAGTGGCAAAGATCGGA,5,3207962
rdlDp,0.7777777777777778,30,17,TCTCAGCAGGGTCGTATCCA,13,3184613
rdlDp,0.2222222222222222,20,17,TCCGCTCAGGGATGATGCCC,3,3170278
rdlDp,0.4444444444444444,24,17,TCATCTCGTATGAAAGTTTA,7,3176715
rdlDp,2.8333333333333335,67,17,TAGCGTGCCGATCCCGTTGG,50,3204143
rdlDp,1.0555555555555556,35,17,TACCAATCGCACTTGTCTAA,18,3177570
rdlDp,1.5,43,17,TAACGCGTGACTAACGAGAA,26,3206774
rdlDp,0.3888888888888889,23,17,GTTTGTATAAATGTTATACA,6,3209578
rdlDp,1.0,34,17,GTGACAAAGGTGGAAACATA,17,3181672
rdlDp,1.4444444444444444,42,17,GGAGTGAGACACTTTATTAT,25,3180399
rdlDp,0.7777777777777778,30,17,GCTTGGCCTGCGACCGCCAA,13,3204969
rdlDp,0.9444444444444444,33,17,GCGCTGAACGGGATTACCGG,16,3195632
rdlDp,0.7777777777777778,30,17,GACGATCAAGCCAAAACCAT,13,3170709
rdlDp,1.6666666666666667,46,17,GAATCTACAGGTATCTCGCC,29,3196181
rdlDp,5.0,106,17,CTGCTCAACGGGAACATAGT,89,3178557
rdlDp,0.5,25,17,CTCGGTAGCTGTTAGGTCCT,8,3195637
rdlDp,5.0,106,17,CTCGATTATTGAGAGTTTCT,89,3174649
rdlDp,0.4444444444444444,24,17,CTCATCGATGAGCTTTGGGA,7,3184250
rdlDp,1.0555555555555556,35,17,CTCAGGAAGCTTACTTGGTA,18,3203591
rdlDp,0.7222222222222222,29,17,CTATTCGTAGGGTAAGAGAG,12,3177111
rdlDp,3.111111111111111,72,17,CGCGGAGACGACAGGGAGCA,55,3179298
rdlDp,0.2222222222222222,20,17,CGAGGTAAGACACCCCTTGG,3,3174132
rdlDp,0.1111111111111111,18,17,CCTGCATCATGTGCCGGACA,1,3208171
rdlDp,1.1666666666666667,37,17,CCTGAGACTGCTTTTTTGAG,20,3173586
rdlDp,1.2222222222222223,38,17,CCTGAAGGAGAGGTGGCGCG,21,3168348
rdlDp,1.8333333333333333,49,17,CCGTCACATACATGAGTACT,32,3165535
rdlDp,1.0,34,17,CCGGTCGGTATGGCCTGGGA,17,3184916
rdlDp,0.6666666666666666,28,17,CCAGGGATACCGCAGTCAAG,11,3190583
rdlDp,0.6666666666666666,28,17,CATTCTGTGGAACATATCAC,11,3205760
rdlDp,0.7777777777777778,30,17,CAGCAACGGAATACTCCTTT,13,3209102
rdlDp,0.5555555555555556,26,17,CAGACAGGGCGGGAAGGCAG,9,3177215
rdlDp,0.6666666666666666,28,17,CAAGGATACGGTCGGGCGAG,11,3198803
rdlDp,0.8888888888888888,32,17,CAAAGCACGATATTGGTGAG,15,3197957
rdlDp,3.7222222222222223,83,17,CAAACCGCTATTGTGCTCGA,66,3166112
rdlDp,0.3888888888888889,23,17,ATCGGTGCTGGAGGGAGAGA,6,3177165
rdlDp,0.1111111111111111,18,17,ATCAGACAGACCTCCGAGTC,1,3211207
rdlDp,0.8888888888888888,32,17,ATAGGTTTCAACGGGGGTGC,15,3213310
rdlDp,1.0555555555555556,35,17,ATAGCCTGGCGGCCAGGATC,18,3196656
rdlDp,0.4444444444444444,24,17,AGTTCACAACCTGGCCTAAA,7,3191740
rdlDp,0.3888888888888889,23,17,AGGGGGGTTTCATTCAGATA,6,3213578
rdlDp,0.5555555555555556,26,17,AGGATAAAAGGTTAACACCT,9,3176377
rdlDp,1.3333333333333333,40,17,AGGAAGACTTCCCAATGTGA,23,3205319
rdlDp,1.3888888888888888,41,17,AGCTTGGGTGTGCCTAATAT,24,3205358
rdlDp,0.9444444444444444,33,17,ACGGCACTCCGTACGAGTGA,16,3169444
rdlDp,1.1666666666666667,37,17,AATGGCCGGACGAGACTACA,20,3206687
rdlDp,0.1111111111111111,18,17,AAGTCATGAGTTGATCTTTT,1,3172835
rdlDp,0.9444444444444444,33,17,AAGTCAGGGTTGGGGCGTGA,16,3190443
rdlDp,1.8888888888888888,50,17,AAGACCCAGATAATCTAGGC,33,3167623
rdlDp,1.3888888888888888,41,17,AAACACCCCGTGAGCGAGCA,24,3180414
rdlDp,0.11764705882352941,17,16,TTTAGATATACGGCACGAAC,1,3177571
rdlDp,0.7058823529411765,27,16,TTGGCTGGAAGAGAGACGGA,11,3192022
rdlDp,0.5882352941176471,25,16,TTGCCAACTGCATGTGAGCT,9,3204713
rdlDp,0.8823529411764706,30,16,TTCCCGGGCTAGATGGCAAC,14,3165291
rdlDp,0.29411764705882354,20,16,TGGTCCTTGGCATCACAGTT,4,3181613
rdlDp,1.2352941176470589,36,16,TGGAAGTAATGCCACTCAGC,20,3165537
rdlDp,2.1176470588235294,51,16,TGCACGACAAATTCTAACCG,35,3207941
rdlDp,0.35294117647058826,21,16,TGATCGCAGAGGCTCGGGAA,5,3204651
rdlDp,1.1764705882352942,35,16,TCTTGGTCTGTTAATCGCAT,19,3166740
rdlDp,0.11764705882352941,17,16,TCTATAGTCCTGTCTACTCG,1,3175826
rdlDp,0.11764705882352941,17,16,TCCCGTTCGATTTTGGTGGA,1,3168969
rdlDp,0.7058823529411765,27,16,TCCCCTTAATAGGAGTCGTC,11,3176720
rdlDp,0.5294117647058824,24,16,TATTCGGGGTCAGGTCATTT,8,3190088
rdlDp,0.29411764705882354,20,16,TAATTACAACTCGACTTCGC,4,3188322
rdlDp,0.17647058823529413,18,16,TAACACAGCTTGTCGGTTCT,2,3191008
rdlDp,0.23529411764705882,19,16,GTTACGCACTTTTGTGCTTT,3,3167402
rdlDp,1.1176470588235294,34,16,GTGTAAATGTTCAGTCTAGA,18,3210447
rdlDp,1.4705882352941178,40,16,GTGCACAGACGTGAAACCTA,24,3198501
rdlDp,6.0,117,16,GTCGCCAACAAAGAAGCGGT,101,3202592
rdlDp,0.9411764705882353,31,16,GTCCTGTCACCCCCCGGCCA,15,3197057
rdlDp,1.2352941176470589,36,16,GTACTTGCCCATGCCCCTGG,20,3191925
rdlDp,1.411764705882353,39,16,GGGTAGTTAATAGTTTAGAA,23,3199648
rdlDp,0.47058823529411764,23,16,GGCTGAAAATGAATCCAACG,7,3207665
rdlDp,2.176470588235294,52,16,GGAGGGGTCTCGAACATTAT,36,3204248
rdlDp,0.4117647058823529,22,16,GGAGACACCACTCAATCACA,6,3205317
rdlDp,12.823529411764707,233,16,GGAGAACAGGCTAACGAAGT,217,3191868
rdlDp,0.5294117647058824,24,16,GGACTCAGGTGTCTCCCGCG,8,3195982
rdlDp,1.3529411764705883,38,16,GGAAGTCGAAGCATTTTTCA,22,3190367
rdlDp,0.11764705882352941,17,16,GCTGCGGGTTAGACTACAGA,1,3175319
rdlDp,0.8823529411764706,30,16,GCTACTGATCCCGTCGTTCA,14,3180123
rdlDp,0.5882352941176471,25,16,GCGGGTGATGACTGGCAATT,9,3172231
rdlDp,1.0588235294117647,33,16,GCGAGTTGTCCATCGGCGCA,17,3185064
rdlDp,0.35294117647058826,21,16,GCATAGAATATTAAAACTAA,5,3199969
rdlDp,0.4117647058823529,22,16,GCAGGTAAGAGGAGGTGCTA,6,3188507
rdlDp,0.29411764705882354,20,16,GCAACAGATTGATTGCGTCG,4,3171855
rdlDp,0.5882352941176471,25,16,GATTAGGTTTTGTGAGTGTG,9,3178721
rdlDp,1.2352941176470589,36,16,GATGTCGTATTTAAGAACAA,20,3175945
rdlDp,0.35294117647058826,21,16,GATCTGGTGTCCTGGGAACC,5,3192972
rdlDp,0.5294117647058824,24,16,GAACGGGTTGACGAAGCTAT,8,3188334
rdlDp,0.35294117647058826,21,16,CTTATGTCCCGCCCTGCTCG,5,3166932
rdlDp,0.17647058823529413,18,16,CTGGGCGATTTTCGGAAAAG,2,3197656
rdlDp,3.764705882352941,79,16,CTCTACCGCGTCGTTCAAGA,63,3207555
rdlDp,1.411764705882353,39,16,CTCTAAGACGGGATGCCATG,23,3181912
rdlDp,0.23529411764705882,19,16,CTCACTGCCAAAGAGGGTCT,3,3182427
rdlDp,0.5882352941176471,25,16,CTATCGTAAAGTTGTGAGTA,9,3201142
rdlDp,0.8235294117647058,29,16,CGGTGTTCCTGCAATCACGA,13,3211810
rdlDp,2.411764705882353,56,16,CGGTCAAATCGACTCGAATC,40,3215013
rdlDp,0.47058823529411764,23,16,CCTTCATGACACCTGCAATG,7,3181981
rdlDp,2.0588235294117645,50,16,CCTCCTCCCCGACGGTACGT,34,3167164
rdlDp,6.588235294117647,127,16,CCGTGTTGAGGTATCACGAT,111,3194450
rdlDp,0.7058823529411765,27,16,CCGGGGATATATTGCATTAT,11,3209048
rdlDp,1.588235294117647,42,16,CCAGGACTTGGGAACGGAGA,26,3169605
rdlDp,0.35294117647058826,21,16,CATTTGAGACGGCCACGCTG,5,3184630
rdlDp,1.1764705882352942,35,16,CACGTAAGGATCCCGGGTCA,19,3175956
rdlDp,4.764705882352941,96,16,CAATGTATGCGTGTTGTGTA,80,3201987
rdlDp,1.8823529411764706,47,16,ATTCCACGTTGGGGCCTACT,31,3206806
rdlDp,0.6470588235294118,26,16,ATGAGATGGCCGCAGCGAGA,10,3198181
rdlDp,3.8823529411764706,81,16,ATGACGCGAGGCGACTTCGA,65,3207380
rdlDp,1.3529411764705883,38,16,ATCGACGTGGTCTCATTGAC,22,3167185
rdlDp,0.23529411764705882,19,16,AGTAACGTACAAGCTCATCG,3,3188148
rdlDp,0.5294117647058824,24,16,AGGGGGGCTCACATAGGGCA,8,3168098
rdlDp,1.5294117647058822,41,16,AGAGCACATTCACGCGTATC,25,3168788
rdlDp,0.5294117647058824,24,16,ACTAGCGTGACTATGTGGAT,8,3183961
rdlDp,0.23529411764705882,19,16,ACGTCTAGACAAATCCGCGT,3,3179688
rdlDp,0.35294117647058826,21,16,ACGCAGCCCGCTAGCGACGG,5,3202460
rdlDp,0.9411764705882353,31,16,ACGACTTCTGACTTTCCACG,15,3208507
rdlDp,2.2941176470588234,54,16,ACCGGTGAGCCGGTTTATCT,38,3188377
rdlDp,2.411764705882353,56,16,AATGAAATGGTGTAGTAACA,40,3194456
rdlDp,0.23529411764705882,19,16,AATCGGAATTCCGGAACATG,3,3174130
rdlDp,0.4117647058823529,22,16,AAGCTACAACGTGTTATTAT,6,3182917
rdlDp,1.2941176470588236,37,16,AAGCACGTTCACGGGGCTCC,21,3200657
rdlDp,1.2941176470588236,37,16,AACGTCGGCGCGTTTTGTTG,21,3192012
rdlDp,0.25,18,15,TTTTGGGAAGATTCAGTGGA,3,3171839
rdlDp,1.25,34,15,TTTCCGGCATAAAGGCCGGT,19,3179292
rdlDp,2.0,46,15,TTTACCTTGATAACCGATTT,31,3194459
rdlDp,0.1875,17,15,TTCGCACTCGGTTAGTAGAC,2,3180913
rdlDp,1.0,30,15,TTCAACACAATCGGACGCGC,15,3203856
rdlDp,2.9375,61,15,TTAGAGAGCACATGTGGCGC,46,3211234
rdlDp,0.8125,27,15,TGTCTTGGCCCACCAAAATC,12,3180228
rdlDp,1.0,30,15,TGGGGGGCTTGAGGTTTGCA,15,3187807
rdlDp,0.625,24,15,TGCATTGAACGGCGGAACCT,9,3172844
rdlDp,1.875,44,15,TGCACACCGTTCCGCACCAA,29,3168943
rdlDp,1.125,32,15,TGAGACAAATTTGGTTTTTT,17,3178059
rdlDp,0.125,16,15,TGAAATGTGGGGGACCGCGT,1,3201141
rdlDp,1.25,34,15,TGAAAGCCGGGCATGTCAGA,19,3197844
rdlDp,1.6875,41,15,TCTCTCTGTGGAAATTAGTG,26,3194092
rdlDp,0.1875,17,15,TCATGTCGTATCCCCGCATG,2,3181805
rdlDp,0.5,22,15,TCAGGACTATCCTTGCTATC,7,3194094
rdlDp,0.25,18,15,TATTGTGAGAATATAGGTCT,3,3215889
rdlDp,0.625,24,15,TAGGTGCAAGCTAATGTGGG,9,3169600
rdlDp,1.125,32,15,GTTGTGGGGGACATCTGTAC,17,3176757
rdlDp,1.3125,35,15,GTGGGTCGTCCGCTTGCATT,20,3194530
rdlDp,0.375,20,15,GTCGAACTGTGGTCTCAATA,5,3205360
rdlDp,0.1875,17,15,GTATCTTAATGGGTAGGGTG,2,3208681
rdlDp,0.9375,29,15,GGTCACTGATCGCTCGTGCG,14,3201906
rdlDp,0.4375,21,15,GGGGCGCTAGGATGTTCGAT,6,3187812
rdlDp,1.25,34,15,GGACTTAGGAAATTACAGCT,19,3187842
rdlDp,0.625,24,15,GCTTGATTATACGAATAGCA,9,3183982
rdlDp,0.8125,27,15,GCTACCCTCATGTCAATTTA,12,3210466
rdlDp,0.25,18,15,GCGGGCCTTACATATTAACC,3,3199445
rdlDp,0.125,16,15,GCCTGAGGGAAATGGATCGT,1,3205881
rdlDp,0.3125,19,15,GCCTGAGAACGACTCGTATA,4,3175890
rdlDp,1.0625,31,15,GCCCCTCCCGCGGTGAAGGC,16,3198839
rdlDp,0.6875,25,15,GATTAGCCTAAATAGACGGA,10,3200027
rdlDp,0.25,18,15,GATAGCCTCAGCATGGTTTT,3,3196496
rdlDp,0.125,16,15,GAGATAGGTGGTAGCCCGGA,1,3183527
rdlDp,0.5,22,15,GAGACTGACAAATCGAATTA,7,3211203
rdlDp,0.125,16,15,GACTTGAATCCTAAGGAAAT,1,3168605
rdlDp,0.1875,17,15,GACAATAGGTTACCACTCAT,2,3176851
rdlDp,0.6875,25,15,GAAATTGCGACAGTGGTTGT,10,3205661
rdlDp,5.4375,101,15,GAAACCGTCGCGCTTTGCAA,86,3212495
rdlDp,0.25,18,15,CTTATAAATTTTCAGCGTTT,3,3204652
rdlDp,0.5,22,15,CTGATTGCGGGCCAGTCGTC,7,3175084
rdlDp,2.0,46,15,CTCCTATTTCAGGATTGTTG,31,3196875
rdlDp,1.4375,37,15,CGTATCCGTCGAGTGGCACG,22,3213612
rdlDp,0.5,22,15,CGTAGGCATTCGATAAATTA,7,3212451
rdlDp,1.9375,45,15,CGGTTCCAATGCGTGAGCAT,30,3164514
rdlDp,1.0625,31,15,CGGTAAGTTTTAGGGTTGCA,16,3197961
rdlDp,1.5625,39,15,CGGGCAGTGCGAGCACCTCT,24,3187806
rdlDp,0.6875,25,15,CGCTTAGGCCACCTATTCCC,10,3182311
rdlDp,1.5,38,15,CCGGCTCCATTAGCAATCAT,23,3168720
rdlDp,0.125,16,15,CCCGTGTCGTGTGCCCACTG,1,3179160
rdlDp,0.9375,29,15,CCCCATGGGGCAAATCAGCT,14,3167349
rdlDp,0.25,18,15,CATAAGAGTGTTCCGCAGGG,3,3180302
rdlDp,1.0625,31,15,CAGTCGGGTCGAACCAATAC,16,3202324
rdlDp,0.625,24,15,CACGTCATGAGTCACCCACA,9,3177559
rdlDp,0.8125,27,15,CACGCATTGCCAATGTTATG,12,3168458
rdlDp,1.0,30,15,CACGAACTAGGGGCAAGTGT,15,3172854
rdlDp,0.6875,25,15,CAATTCCGTAGTCCCATACT,10,3176686
rdlDp,2.1875,49,15,CAATGTTGGGCTTCGCGTGC,34,3185051
rdlDp,1.25,34,15,ATGTCGCACCGTTAAATTAG,19,3208301
rdlDp,2.3125,51,15,ATGAGTCTCTGTGAAGGCGT,36,3173581
rdlDp,0.625,24,15,ATCCTGATTTATTGTACAAC,9,3182936
rdlDp,0.125,16,15,ATAGGGGCGTTCAAGCCGTG,1,3188700
rdlDp,1.1875,33,15,ATACGTATCGCATAGGAGAT,18,3192057
rdlDp,1.625,40,15,ATAATACTGAAACCTTCGAT,25,3209007
rdlDp,1.625,40,15,ATAACCTGTCTTTGCTCTGA,25,3210864
rdlDp,1.125,32,15,AGGTTCCTGTGGCTACCAGC,17,3193702
rdlDp,1.4375,37,15,AGGCCCTGCTACTTTCAGTT,22,3215792
rdlDp,0.1875,17,15,AGGAGGTCATGGGATCGGCA,2,3198173
rdlDp,1.6875,41,15,AGCGTTTTGGCGTTGGTTAG,26,3204997
rdlDp,0.125,16,15,AGCGTTTACATATTTAACTG,1,3166856
rdlDp,1.3125,35,15,AGATGATTTGAACCAATATT,20,3204139
rdlDp,3.625,72,15,AGACCGTGTTAGCGCAGGAT,57,3198369
rdlDp,0.375,20,15,ACTTTAACGGTCACAGCCAC,5,3175527
rdlDp,1.4375,37,15,ACGCGTCTAGCCGTGAGCCA,22,3173847
rdlDp,0.875,28,15,ACGCAGTCACCGCTTCCGAA,13,3168049
rdlDp,0.75,26,15,ACCCGCGTCTCATAATGTCA,11,3215807
rdlDp,1.75,42,15,ACCAAGCAATTGACGAACGT,27,3210869
rdlDp,0.25,18,15,AATAACGAGTATCCATGTCG,3,3177120
rdlDp,0.6875,25,15,AAGGCCTAGCTTCATGTGAT,10,3198179
rdlDp,10.0625,175,15,AAATCAAGCAAGGATAGACG,160,3199420
rdlDp,3.1333333333333333,60,14,TTTGCGCAGAAAGGTGCACT,46,3191405
rdlDp,0.6666666666666666,23,14,TTTAGTGAACATCTAGATCC,9,3197420
rdlDp,0.4,19,14,TTTAGGAGATTCGGCCAGCG,5,3180767
rdlDp,0.6,22,14,TTGTTCCAGCTACGTTTGCA,8,3212005
rdlDp,0.6666666666666666,23,14,TTGGGCCAACTGGCCTGACA,9,3183901
rdlDp,2.4,49,14,TTGATGATGGCCCCTCGGCA,35,3209366
rdlDp,0.2,16,14,TTAAGATTTAGGGTTAAATG,2,3165912
rdlDp,1.0666666666666667,29,14,TTAAAGGGTACGGTAGAGAT,15,3204866
rdlDp,0.7333333333333333,24,14,TGGGGACACGGACCTGGCCC,10,3176740
rdlDp,0.2,16,14,TGACCAAGGGAAGCCTAATC,2,3185039
rdlDp,0.6,22,14,TCTTCTACGTAGTGAGGTTA,8,3200776
rdlDp,1.7333333333333334,39,14,TCTCTGAACGGGACCCCAAC,25,3167161
rdlDp,1.6,37,14,TCGTTCCATGCAAAACGAGA,23,3214054
rdlDp,0.2,16,14,TCGTATACCAAAATAGACAG,2,3211812
rdlDp,0.4666666666666667,20,14,TCGGCCAGATGACATAGCAC,6,3201822
rdlDp,0.6666666666666666,23,14,TCCGTTCGACCATAGTCCGG,9,3198913
rdlDp,1.2666666666666666,32,14,TCCCGACCACAAACCCAGTT,18,3168154
rdlDp,1.4,34,14,TCCACTCAGAAGTTGTATTT,20,3211808
rdlDp,0.6666666666666666,23,14,TCATAAATGAGGAACACCAA,9,3199611
rdlDp,1.3333333333333333,33,14,TCAAAACATCATATTGTGAC,19,3205270
rdlDp,1.6,37,14,TATGGCCCTATCGCCATGGT,23,3193371
rdlDp,1.3333333333333333,33,14,TATCGTGCGTCTCTGCCATG,19,3192112
rdlDp,0.3333333333333333,18,14,TACGCCCCGGATCTGACGCA,4,3173078
rdlDp,0.4666666666666667,20,14,GTCCTAAATATGTCGCATAG,6,3182490
rdlDp,0.5333333333333333,21,14,GTCCGGACAGGCGATATTCT,7,3199968
rdlDp,1.2666666666666666,32,14,GGGTGGGCGGCAGACTTAGA,18,3211406
rdlDp,1.4666666666666666,35,14,GGCTTGGGTGCAGGCGATTG,21,3190087
rdlDp,0.13333333333333333,15,14,GGCATCGGTTCGGCTGACCA,1,3206765
rdlDp,1.6,37,14,GGACGAAGCTCTTACTGGCG,23,3205921
rdlDp,0.4666666666666667,20,14,GGAACCTCGGGGGTTAGGTA,6,3201476
rdlDp,0.4,19,14,GCTATAGTTACGATTCTCGT,5,3201262
rdlDp,0.8666666666666667,26,14,GCTAATCTCGGTTTATAGTT,12,3173848
rdlDp,0.4,19,14,GCGTTCGCTGTGTGGTGTTA,5,3169554
rdlDp,2.2,46,14,GCGCCACCAGCCTCGTTCGG,32,3185789
rdlDp,0.6666666666666666,23,14,GCGACACGTTCCAGTACAGT,9,3180401
rdlDp,0.3333333333333333,18,14,GCACCGCCATTTCCGCCTTA,4,3185283
rdlDp,3.2,61,14,GATTTGCCCGCATGATAGGG,47,3194452
rdlDp,1.2,31,14,GATGGAGCGGAGCGTTCCCG,17,3175878
rdlDp,1.0666666666666667,29,14,GACATGGTCCGGACATTGGA,15,3195908
rdlDp,0.26666666666666666,17,14,GACAATGAGTACGCGTCACA,3,3177525
rdlDp,0.7333333333333333,24,14,GACAATATTTAGGATAGGGG,10,3181260
rdlDp,0.13333333333333333,15,14,GAAGTCAACACTCCCGAATA,1,3168798
rdlDp,1.2666666666666666,32,14,GAAGCGTGGTCACTTAACCA,18,3210346
rdlDp,1.8,40,14,GAAATAAGGGGGGCGTAGCG,26,3213602
rdlDp,0.8666666666666667,26,14,CTTGGAATTAGGGGGGTGCG,12,3164772
rdlDp,1.8,40,14,CTGCACAGAAACCAACGAGA,26,3196594
rdlDp,2.8666666666666667,56,14,CGTTGTCGGGCGGAAATCTA,42,3202454
rdlDp,2.8666666666666667,56,14,CGTTGCCCAATAAGGAGCTT,42,3181874
rdlDp,1.0666666666666667,29,14,CGTGCAGCCCAAGGGGTTTA,15,3175563
rdlDp,0.8666666666666667,26,14,CGGCTGGCGTCTACAGTCCC,12,3187394
rdlDp,0.6666666666666666,23,14,CGAGCGTAACCAACCCTGAA,9,3204353
rdlDp,1.6,37,14,CCTGGTAATACTCTCGCCAG,23,3166126
rdlDp,4.133333333333334,75,14,CCTATTGGTTGGCACGACGA,61,3206024
rdlDp,1.5333333333333334,36,14,CCGGCCTGGCTGCTAACGAA,22,3173161
rdlDp,1.0,28,14,CCGGCCCAACAACACAAACT,14,3176361
rdlDp,1.8,40,14,CCCGTGCTAGGATGAAAGGT,26,3208021
rdlDp,1.0666666666666667,29,14,CCCCAATATTCCCGCCGAGC,15,3184918
rdlDp,1.0,28,14,CCACCTTGCGTCGTCTGGAT,14,3166755
rdlDp,0.8,25,14,CCACATGCCCCGAATCAAAG,11,3185059
rdlDp,1.2666666666666666,32,14,CATCATCCGCGTACCGATAA,18,3166099
rdlDp,1.6666666666666667,38,14,CAGGTTCTGTGCCTTCGAGG,24,3172033
rdlDp,0.4666666666666667,20,14,CAGCGCGGTGTGATCGCGCC,6,3211599
rdlDp,0.2,16,14,CAAGCTGCGTACCTCCATAT,2,3164346
rdlDp,1.6666666666666667,38,14,ATTTCATGATTAGCTAAACT,24,3181679
rdlDp,0.7333333333333333,24,14,ATTAACTGAATGTATCGTTT,10,3180634
rdlDp,0.3333333333333333,18,14,ATGTGTACGTAGGTCCTGAT,4,3205561
rdlDp,1.5333333333333334,36,14,ATGGTCGGTGGTACGGTATT,22,3211172
rdlDp,1.2666666666666666,32,14,ATCCGCACCTCACACGCGAT,18,3214176
rdlDp,0.13333333333333333,15,14,ATCCAGATCGTCTCTGGGAT,1,3173136
rdlDp,1.2,31,14,ATCAACCCGATCAGAACGCT,17,3170527
rdlDp,2.533333333333333,51,14,ATAGGCTGAATACAGCGGCG,37,3180148
rdlDp,0.5333333333333333,21,14,ATAAGTACATCATAGCGCGT,7,3167690
rdlDp,2.466666666666667,50,14,AGTCAGCAATTCGTACCGGC,36,3186675
rdlDp,0.8,25,14,AGTATTATGGGGGCCTTGTC,11,3197960
rdlDp,0.7333333333333333,24,14,AGGTGGTAGCGCAGCCTTGC,10,3166105
rdlDp,0.13333333333333333,15,14,AGGGTACAAGAGTTAGAACG,1,3192964
rdlDp,0.4,19,14,AGCTGGTCCGGAGGCGAGTC,5,3195340
rdlDp,0.3333333333333333,18,14,AGAGCTATCAAGACAGTCCC,4,3167197
rdlDp,0.3333333333333333,18,14,AGAATTCGGTACCCGTGGAA,4,3174168
rdlDp,0.2,16,14,ACGTTTCCGTTGCCCAAGAA,2,3190878
rdlDp,2.8666666666666667,56,14,ACGTGCCAAAAACGTATACG,42,3176641
rdlDp,1.2666666666666666,32,14,ACGTGATTAATAATTCATTA,18,3194613
rdlDp,0.6,22,14,ACGGGTAGGTCAGCCCTGGC,8,3174138
rdlDp,0.6,22,14,ACGCCTGAGGCATCTGTCCC,8,3203488
rdlDp,0.9333333333333333,27,14,ACGATAATGAGGCATTTTCG,13,3191145
rdlDp,0.2,16,14,ACGACACAAATAAGCCGTAT,2,3185057
rdlDp,0.26666666666666666,17,14,ACCCGGCTTGGGTATAATTG,3,3206964
rdlDp,1.4666666666666666,35,14,AAGCACGGTCCCGATGCATG,21,3186657
rdlDp,0.13333333333333333,15,14,AAGAGGAATTTGTCCTTTAG,1,3188296
rdlDp,1.6666666666666667,38,14,AAGAATCACGACTCCTATCA,24,3196791
rdlDp,0.2857142857142857,16,13,TTTTGGGGGATCTTTCATGG,3,3187673
rdlDp,1.2857142857142858,30,13,TTTTCAATACGAGAACCTAC,17,3166332
rdlDp,7.357142857142857,115,13,TTTGACTCACTGCTCTCGTT,102,3205143
rdlDp,0.5,19,13,TTTCAGACCACTCGGGTCTC,6,3188149
rdlDp,0.35714285714285715,17,13,TTAGGTTGGTGTCTTGGTTT,4,3174432
rdlDp,0.7142857142857143,22,13,TTACTAGGCTTAGTCCAGAG,9,3190865
rdlDp,0.2857142857142857,16,13,TGTGTGTTTCCATCTAGTTG,3,3198503
rdlDp,1.7142857142857142,36,13,TGTCATTCACCGGGATGCAG,23,3201405
rdlDp,0.14285714285714285,14,13,TGGGGATAAGCTTCATGCTA,1,3176760
rdlDp,0.2857142857142857,16,13,TGCCCTAAGGGGGCAGATGT,3,3197388
rdlDp,2.142857142857143,42,13,TCTCGGGATATGACCGATGG,29,3206239
rdlDp,2.0714285714285716,41,13,TCCTCGTAGCGATAAATCCT,28,3186671
rdlDp,0.35714285714285715,17,13,TCAGATAACCCGGCCGAAGA,4,3213576
rdlDp,0.14285714285714285,14,13,TCACTTAGTGAGGTAATATA,1,3165458
rdlDp,3.9285714285714284,67,13,TCAACGGAAAAATCACTTAG,54,3203463
rdlDp,0.8571428571428571,24,13,TATGGATGGGTGGGTACAGG,11,3197848
rdlDp,1.5714285714285714,34,13,TATAGTCCTTAGGATCGCCT,21,3201821
rdlDp,1.5,33,13,TACGGCCACCCGTTGAATGT,20,3195149
rdlDp,2.142857142857143,42,13,TACCTGACTGGATGGTCTTG,29,3187591
rdlDp,0.9285714285714286,25,13,TAAACCTCAGTGTTCGTGAC,12,3182139
rdlDp,2.9285714285714284,53,13,GTTTAGTCACGTAAAACATT,40,3184206
rdlDp,3.0,54,13,GTTTAAAGCGCACCACTGTT,41,3194455
rdlDp,0.35714285714285715,17,13,GTCTCAATTGAAGGCTCTCG,4,3175951
rdlDp,0.5,19,13,GGTTCGGAAGGTGCGCTTTG,6,3206310
rdlDp,0.2857142857142857,16,13,GGTCCCTCTTCTCACGTGGT,3,3181956
rdlDp,0.21428571428571427,15,13,GGTAAAGGCATACCGACTGG,2,3200667
rdlDp,1.7142857142857142,36,13,GGGTGCGCAGCTCACATGCT,23,3167159
rdlDp,2.857142857142857,52,13,GGCGGCAAGGTACGAATACT,39,3167182
rdlDp,0.14285714285714285,14,13,GGCCTAGGGCCGCATTAGCA,1,3191715
rdlDp,0.21428571428571427,15,13,GGCCTAATTTGCCTACGGTG,2,3212452
rdlDp,0.9285714285714286,25,13,GGCCCCTCCCGAGTCCAATT,12,3176702
rdlDp,0.5,19,13,GGCCCACTGATCTGCGTCAG,6,3177574
rdlDp,1.9285714285714286,39,13,GGCATTCCTATGTAAAAAGA,26,3209008
rdlDp,1.0714285714285714,27,13,GGAACATACCGTGTTAGTCT,14,3182836
rdlDp,0.2857142857142857,16,13,GCTTTTGAGGCGCAGGTTGA,3,3184210
rdlDp,0.42857142857142855,18,13,GCTGAACACCCTGGCAAATT,5,3209687
rdlDp,0.5,19,13,GCTATGCGGACGGGTCGGGA,6,3211320
rdlDp,1.7857142857142858,37,13,GCTATCAGCAGGGATGGTTA,24,3164519
rdlDp,0.42857142857142855,18,13,GCTAAATAGATCATGCTTCG,5,3168088
rdlDp,0.9285714285714286,25,13,GCGTCCTCGATCGCGAACTC,12,3186868
rdlDp,1.0,26,13,GCGCCCCGAATGGGAGTATG,13,3167280
rdlDp,7.0,110,13,GCGCACTTATGTAAAGGTCA,97,3197256
rdlDp,1.4285714285714286,32,13,GATCATTGTCTGGCAGCCAG,19,3208423
rdlDp,0.21428571428571427,15,13,GATACCGTATTGCTTCGGCC,2,3178107
rdlDp,0.35714285714285715,17,13,GAATAGGACGCTCTAAATGT,4,3195452
rdlDp,4.0,68,13,CTGGAATTGTTTATATCCTG,55,3193721
rdlDp,0.7857142857142857,23,13,CTGCGCAGAGTATTAGCTAC,10,3191733
rdlDp,0.7857142857142857,23,13,CTCTGCGTAAGGTAGCGGCC,10,3169999
rdlDp,3.142857142857143,56,13,CTCAAATAGATCTAAGCAAG,43,3206947
rdlDp,1.2857142857142858,30,13,CTATTAAATTCCCAAAGCAG,17,3211236
rdlDp,1.5714285714285714,34,13,CGTTGCGTAGCGTCGAAGGC,21,3179078
rdlDp,0.5,19,13,CGTAATTAAGAAGACGAAGG,6,3205579
rdlDp,0.8571428571428571,24,13,CGGAGCTCCCAACTTAAGCA,11,3165686
rdlDp,17.0,250,13,CGGACAGATGCGGGCTCGGC,237,3193602
rdlDp,0.14285714285714285,14,13,CGCGAGTAATTGTTCCCTGG,1,3214610
rdlDp,1.3571428571428572,31,13,CGCCCTAGGGTTCCGGTCGA,18,3198920
rdlDp,1.5714285714285714,34,13,CGAAGTCCAGCATAGAACCG,21,3187404
rdlDp,0.7857142857142857,23,13,CGAAGGATTAGTGGAAACCA,10,3205361
rdlDp,0.21428571428571427,15,13,CCGGATTAGCGCGTGGTACA,2,3193832
rdlDp,0.14285714285714285,14,13,CCGGAGATCATGCATTGGGA,1,3191661
rdlDp,1.3571428571428572,31,13,CCATTGGAGTAAAGGGCGGC,18,3189552
rdlDp,0.14285714285714285,14,13,CATTGGGCACACTGTGCGGG,1,3178739
rdlDp,0.14285714285714285,14,13,CATGTGCTAATACAGGCACT,1,3185800
rdlDp,0.6428571428571429,21,13,CAGGGCACCGAGGATACCAA,8,3166286
rdlDp,0.2857142857142857,16,13,CAGGAATCGTGGTTCGATAT,3,3205344
rdlDp,0.21428571428571427,15,13,CAGCACGTAAGAAGATTCTA,2,3164524
rdlDp,1.8571428571428572,38,13,CAGAGCACACGCACCCGTAA,25,3189720
rdlDp,0.6428571428571429,21,13,CACTTTGGGTTTGTGACTAA,8,3211399
rdlDp,0.6428571428571429,21,13,CACTCGCCACCAGTTTAAAA,8,3181985
rdlDp,1.0,26,13,CACGTCCGTCGCGTGATTGC,13,3190585
rdlDp,0.14285714285714285,14,13,CAATATGACTGCCGACCGGT,1,3165841
rdlDp,1.2857142857142858,30,13,CAAACTCGACAACGCTGCTC,17,3181950
rdlDp,0.42857142857142855,18,13,ATGGGCTAGCGGGTTCAACC,5,3197896
rdlDp,1.0714285714285714,27,13,ATGGGATTGCTTGGCGACGG,14,3187392
rdlDp,0.42857142857142855,18,13,ATGCCTTATGTAGCAAGGTG,5,3205916
rdlDp,0.5714285714285714,20,13,ATCCCATTGGTACGAAAATA,7,3215893
rdlDp,0.8571428571428571,24,13,ATCCAAGTGCTCAATGTGGA,11,3181966
rdlDp,0.2857142857142857,16,13,ATCAATCCGGTAGCCCGATG,3,3179681
rdlDp,0.21428571428571427,15,13,AGTTGTCTTCCCTGCTCTTA,2,3215450
rdlDp,2.4285714285714284,46,13,AGTTATTGGAAATAAGAAGA,33,3201832
rdlDp,2.7857142857142856,51,13,AGGTCACCAATACATCAACA,38,3205880
rdlDp,0.35714285714285715,17,13,AGGATATTGCTCGCCCTCAC,4,3186429
rdlDp,1.5,33,13,AGCTGCAGATCAGACGGCCT,20,3215631
rdlDp,0.7857142857142857,23,13,AGCCGTCATGAAGGTACTGT,10,3183121
rdlDp,0.14285714285714285,14,13,AGCCAGACCGACATAACGCT,1,3194016
rdlDp,1.5,33,13,AGATCACGGACGGCGAGGTA,20,3166934
rdlDp,4.357142857142857,73,13,AGAGAAACCTAGGTGAGGAA,60,3215009
rdlDp,0.9285714285714286,25,13,ACTTTCGGATAGGGTCGATT,12,3210501
rdlDp,0.35714285714285715,17,13,ACTTAACTATTCATTCTACA,4,3192111
rdlDp,5.785714285714286,93,13,ACGGTTCATAGCAAGGGCCC,80,3193204
rdlDp,0.5,19,13,ACGAATAACCGTGCGGAGGT,6,3208166
rdlDp,0.42857142857142855,18,13,ACCTCTTTCTATCAAGTTTA,5,3169981
rdlDp,1.7857142857142858,37,13,AATTCATGAGGGCCTGTGGA,24,3188371
rdlDp,1.9285714285714286,39,13,AATAATGTCCATGCCTACGG,26,3203739
rdlDp,0.6428571428571429,21,13,AAGTTAGCTGTATTGAGGCA,8,3185810
rdlDp,1.3571428571428572,31,13,AAGTGACTCCGGGGCAGACT,18,3177733
rdlDp,0.5714285714285714,20,13,AAGATGAGATGCGTGCAGCT,7,3206638
rdlDp,0.8571428571428571,24,13,AACGGAAGGCCGTCGTGGCA,11,3183958
rdlDp,0.5714285714285714,20,13,AACCTTATGCTAATGGGCCT,7,3179649
rdlDp,2.7142857142857144,50,13,AAACGGAGTTGCGGCGAGAC,37,3198356
rdlDp,1.0714285714285714,27,13,AAAATTAGCGTAGGCAATAG,14,3178302
rdlDp,4.214285714285714,71,13,AAAAAGTCCCCTCGAGCTAG,58,3189748
rdlDp,0.8461538461538461,22,12,TTGTAATCAGGGCGATGCCA,10,3170867
rdlDp,0.15384615384615385,13,12,TTGCGGGCGAACCTCTCTAT,1,3212450
rdlDp,1.0769230769230769,25,12,TTGACTATACACGACAAGAC,13,3198909
rdlDp,0.8461538461538461,22,12,TTCCCTCAATAGACCCGAGT,10,3201658
rdlDp,0.46153846153846156,17,12,TTAGTGACATCATTTAATGG,5,3198220
rdlDp,0.6153846153846154,19,12,TTACCAGTACTGGGGAATTT,7,3208172
rdlDp,0.6923076923076923,20,12,TGTGGTTTCAGTAGCAGGTC,8,3205560
rdlDp,1.7692307692307692,34,12,TGCTTAGGTCGGCAGTTAGC,22,3169966
rdlDp,1.4615384615384615,30,12,TGATACTATGGGTAACTCAA,18,3207923
rdlDp,0.3076923076923077,15,12,TGAGCCCGAGGCTTCTCTTC,3,3194603
rdlDp,1.6923076923076923,33,12,TCGGGGCTATAACAACTGAT,21,3172903
rdlDp,0.15384615384615385,13,12,TCGAGCAACGACTCAGCCCT,1,3165795
rdlDp,2.5384615384615383,44,12,TCAACTGATACGACTATAGG,32,3191206
rdlDp,0.5384615384615384,18,12,TATAACATCCCAGGTCCAGT,6,3175596
rdlDp,0.6153846153846154,19,12,TAGATAATTGGTACAACGAG,7,3176738
rdlDp,0.15384615384615385,13,12,TACCAGTTCAAAGTAGCGAA,1,3211099
rdlDp,1.0,24,12,TAAAAGTTACAGTTGGATAA,12,3176703
rdlDp,0.23076923076923078,14,12,GTTTCTCGCCAAACGTCTAC,2,3182939
rdlDp,1.2307692307692308,27,12,GTTCATAGCTCCTAACACAA,15,3175912
rdlDp,0.23076923076923078,14,12,GTTCACCACTCTTCGATATT,2,3177746
rdlDp,0.6923076923076923,20,12,GTCTGGATGCGTCTTACGTA,8,3205877
rdlDp,2.1538461538461537,39,12,GTCAGCGGCAAGGCGACACA,27,3209446
rdlDp,0.9230769230769231,23,12,GTAACGCTAGTTGGAAGCGG,11,3211237
rdlDp,0.15384615384615385,13,12,GGTTCGGCTATTGCTTTCCG,1,3179131
rdlDp,1.1538461538461537,26,12,GGTGAGATAAGCTGTCCCGA,14,3189693
rdlDp,2.6153846153846154,45,12,GGTGAATTAGTAAAACTCAG,33,3198021
rdlDp,1.3846153846153846,29,12,GGTCAGTTTTCCTATTCAGC,17,3201661
rdlDp,0.8461538461538461,22,12,GGGTAACCTACCACGTCTAA,10,3178292
rdlDp,0.6923076923076923,20,12,GGCTCGACTCTTACCCTTTG,8,3192963
rdlDp,0.3076923076923077,15,12,GGCTAGAGCTAGACAGACGT,3,3166943
rdlDp,0.9230769230769231,23,12,GGCCGGCACCCTACGCATCA,11,3184728
rdlDp,2.0,37,12,GCTTACTCGGAAGCTGCCTT,25,3201411
rdlDp,2.6923076923076925,46,12,GCGGGTTCGCTAGAGGTCAA,34,3167399
rdlDp,0.3076923076923077,15,12,GCGCATCACGTGTCGGCCGA,3,3179544
rdlDp,1.1538461538461537,26,12,GCCTTGGTGAGCTCTGTGGT,14,3203198
rdlDp,0.46153846153846156,17,12,GCATAGAGTGAAGGTAGCGA,5,3186284
rdlDp,1.1538461538461537,26,12,GAGCCGTGAATGTTGCTGTA,14,3171220
rdlDp,1.1538461538461537,26,12,GACTGGTCCGAGACCAGTGT,14,3206631
rdlDp,0.6153846153846154,19,12,GACCTAGTGTAGAGGTTTTT,7,3195311
rdlDp,0.23076923076923078,14,12,GACCGTAGGAACCGGTCGCG,2,3165381
rdlDp,1.3846153846153846,29,12,GACCAGCGCTGAGGGCGAAC,17,3181184
rdlDp,0.6153846153846154,19,12,GACATTGCTATATTTTACCT,7,3180141
rdlDp,1.0,24,12,GAATCTAATCAACTGTTTAA,12,3191515
rdlDp,0.15384615384615385,13,12,CTGTGTGTTAGGTCGGCGGT,1,3202265
rdlDp,2.230769230769231,40,12,CTGGTATCCCGAGAATTGGC,28,3189012
rdlDp,1.5384615384615385,31,12,CTGCATGTAAGCTACAAATT,19,3168455
rdlDp,0.5384615384615384,18,12,CTACGCTTTGCGCGATCTTT,6,3180904
rdlDp,0.6923076923076923,20,12,CGGATCTTCCAGCCTGTCTT,8,3169442
rdlDp,0.6153846153846154,19,12,CGGAACTTTTGGACGACCGG,7,3171577
rdlDp,0.3076923076923077,15,12,CGCCTATGGGCCTAGCAACA,3,3171487
rdlDp,0.6153846153846154,19,12,CGCCCCGGGCGCTGCACATC,7,3205313
rdlDp,2.5384615384615383,44,12,CGATTTATCGGGTTAATTGA,32,3171706
rdlDp,0.23076923076923078,14,12,CGAACAGGGTCGGAAACGAC,2,3198185
rdlDp,0.7692307692307693,21,12,CCTCATTGCCATTGGCTTAG,9,3175950
rdlDp,1.3076923076923077,28,12,CCTAAGGCGTGGATCCTCCA,16,3182002
rdlDp,1.9230769230769231,36,12,CCGGTAACGTAACGATAACT,24,3209733
rdlDp,0.6153846153846154,19,12,CCGGGAATCCAGCGTGTCAC,7,3205749
rdlDp,1.0769230769230769,25,12,CCGGAGTTAATACGTTTGCA,13,3206242
rdlDp,0.3076923076923077,15,12,CCCGCATTCAATCAGTACTT,3,3180402
rdlDp,0.7692307692307693,21,12,CCAATGGCAGTCCTAAATCT,9,3169221
rdlDp,1.0769230769230769,25,12,CCAAACGGGATACGAAACTC,13,3168445
rdlDp,4.076923076923077,64,12,CATATCTAGATATCACTGAT,52,3199616
rdlDp,0.15384615384615385,13,12,CAGCCAATACTAGGGCGAAG,1,3185785
rdlDp,0.5384615384615384,18,12,CACTTTGCCGGGATGCCCCA,6,3204996
rdlDp,1.9230769230769231,36,12,CACGGACTATACCCCCTAGG,24,3197971
rdlDp,1.8461538461538463,35,12,CAATCTCAGCGGTCGCACAA,23,3176706
rdlDp,0.9230769230769231,23,12,CAATCGGGATTTAAGGATAC,11,3194176
rdlDp,0.23076923076923078,14,12,CAAGGGAGCTCCGAGCACGG,2,3168168
rdlDp,1.8461538461538463,35,12,CAAGGATCTTTGGTCGCGTT,23,3213593
rdlDp,2.0,37,12,ATTACAGTGGCGCGGCTATA,25,3170537
rdlDp,0.9230769230769231,23,12,ATGGTTAAGGAATGCAGACC,11,3184617
rdlDp,0.46153846153846156,17,12,ATCGGCGAGTGAGGTGCAGT,5,3168649
rdlDp,1.0769230769230769,25,12,ATCCGCCTGTATAAGGAGGA,13,3188833
rdlDp,0.3076923076923077,15,12,ATAGCACACGGGAGCTTGGT,3,3202647
rdlDp,3.1538461538461537,52,12,ATAGAGGGGTTAACACTAAG,40,3190902
rdlDp,1.6153846153846154,32,12,ATAATTAACCTTCCCCAGTG,20,3179302
rdlDp,0.15384615384615385,13,12,AGTTATGCACGACGAGACGA,1,3186304
rdlDp,1.4615384615384615,30,12,AGTAGACGGGATCGAAAAAT,18,3181710
rdlDp,0.38461538461538464,16,12,AGGTGCATTGGTAGTTTCAG,4,3191512
rdlDp,0.7692307692307693,21,12,AGGAATTATAGTGCCACCCA,9,3186468
rdlDp,0.6923076923076923,20,12,AGCGGTTGTACTTGTTGACA,8,3185827
rdlDp,0.15384615384615385,13,12,AGCGACAAGCTATGGGTGGG,1,3174069
rdlDp,0.15384615384615385,13,12,AGATTAAGCACAGTGTGTAC,1,3167381
rdlDp,2.0,37,12,AGACTGATGGGTTGCAACGA,25,3196273
rdlDp,0.3076923076923077,15,12,AGACGTTTCCGCTAGCGACC,3,3194026
rdlDp,0.15384615384615385,13,12,AGACGGCACGGACACTACAG,1,3194936
rdlDp,1.3076923076923077,28,12,AGAACTTATGTTCCTAAGGA,16,3188401
rdlDp,1.6153846153846154,32,12,AGAAATGGCTTATGAACAGA,20,3170864
rdlDp,0.38461538461538464,16,12,AGAAAGTGACCCTTCCCCTA,4,3181103
rdlDp,1.7692307692307692,34,12,ACTTGCGTGGGAAGAAATCT,22,3196271
rdlDp,0.9230769230769231,23,12,ACTTCGCCATGAACTATGTC,11,3187680
rdlDp,1.0769230769230769,25,12,ACTTACATAATTTCTCAATT,13,3191745
rdlDp,0.8461538461538461,22,12,ACTAGGGAGTGGTTTTGGCC,10,3204846
rdlDp,0.3076923076923077,15,12,ACGCGTATCCAATGCGCGCG,3,3165946
rdlDp,0.6153846153846154,19,12,ACCATCTAACTAACCATAGT,7,3193805
rdlDp,0.23076923076923078,14,12,AAGTTTCGCTGGGGTGAAGA,2,3201065
rdlDp,2.076923076923077,38,12,AAGGTGAGGCTGATCTCGAA,26,3191776
rdlDp,3.3076923076923075,54,12,AACGCGCCCAGTGCCCACAT,42,3198385
rdlDp,1.7692307692307692,34,12,AAAATGGCGCTACTGGAATG,22,3192828
rdlDp,0.9166666666666666,21,11,TTTTAGTTGGGCGCCCCAGT,10,3191734
rdlDp,2.5,40,11,TTGGTCTTGCCTCGTCGATA,29,3185306
rdlDp,1.5833333333333333,29,11,TTGCGGCGTGGGGATGAGAT,18,3206767
rdlDp,0.5,16,11,TTGCCGGAGTGTTACACGAG,5,3184615
rdlDp,0.4166666666666667,15,11,TTGAGTGTTCTCGGTCGAGG,4,3201102
rdlDp,0.3333333333333333,14,11,TTCGGAGACTCTGTGTAACA,3,3187286
rdlDp,1.5,28,11,TTCGAGACCTCTTTATGCTT,17,3198027
rdlDp,1.6666666666666667,30,11,TTCCTAATTATGAACAGAAT,19,3165138
rdlDp,0.4166666666666667,15,11,TGTTTAGAGGCGATTCCGAT,4,3181812
rdlDp,0.8333333333333334,20,11,TGGCCGGTCCTCCGGATGAC,9,3213771
rdlDp,1.0,22,11,TGGCCGGGCGGTAGTACCAG,11,3194510
rdlDp,1.8333333333333333,32,11,TGCTTAGTAGGCAGCGGACA,21,3186168
rdlDp,6.5,88,11,TGCGCCCTTAAAAGCCCAAA,77,3196652
rdlDp,3.25,49,11,TGCGCCCCGCGATGAGGCAA,38,3175973
rdlDp,1.25,25,11,TGCCGTTCATGCTCAGTGAT,14,3198176
rdlDp,3.0833333333333335,47,11,TGCATATCAAATCAGACACG,36,3170426
rdlDp,4.25,61,11,TGATGTTACAAGCAACCAAT,50,3188345
rdlDp,0.4166666666666667,15,11,TGAGACTTGTCCACAGGGTA,4,3182947
rdlDp,2.5833333333333335,41,11,TCGTTCTATTCTAAGATACA,30,3185799
rdlDp,1.5,28,11,TCGCGCGCCAATTAAGGACA,17,3192001
rdlDp,1.0,22,11,TCATATGGTTTAGGCGATTG,11,3172916
rdlDp,0.9166666666666666,21,11,TCAAGTCAGTCATCCACAAG,10,3198434
rdlDp,0.75,19,11,TATCTCTGATCGTGTTTTGT,8,3176710
rdlDp,2.3333333333333335,38,11,TAGGGGGACCCTCATCGTAG,27,3173836
rdlDp,0.3333333333333333,14,11,TAAGTGGGGCCTTCCTATGC,3,3164272
rdlDp,0.25,13,11,TAAGCACCAGTGAGCATAAA,2,3213263
rdlDp,0.5,16,11,TAAACAATTACTCCCGTGTT,5,3210572
rdlDp,1.3333333333333333,26,11,GTTCGACTCTCGGGCGCATA,15,3205349
rdlDp,0.16666666666666666,12,11,GTTATCGTGTGATGGCCTAC,1,3177817
rdlDp,5.833333333333333,80,11,GTGGATCGATTTGCTTTGCT,69,3186669
rdlDp,0.6666666666666666,18,11,GTGCTTGTACGGTTCCCCAA,7,3208581
rdlDp,0.6666666666666666,18,11,GTGAATTTGGGTCTACTGTG,7,3200117
rdlDp,0.4166666666666667,15,11,GTCGGTAACCTACATCGGGC,4,3175368
rdlDp,0.4166666666666667,15,11,GTCAATAGCTAACGCTCCGG,4,3208185
rdlDp,1.3333333333333333,26,11,GTAGGCCTTGTTCAGGTGAG,15,3183119
rdlDp,0.5,16,11,GTAGAAAGCTCGATCTGATT,5,3201633
rdlDp,1.75,31,11,GTACTTGTGATTGCAGACAT,20,3183360
rdlDp,0.4166666666666667,15,11,GGTTCAGTCGTGCAGGGATT,4,3194571
rdlDp,0.25,13,11,GGTCACTACGAACAGGACCA,2,3182116
rdlDp,0.3333333333333333,14,11,GGTATCGTGAATATTCACGG,3,3188330
rdlDp,0.6666666666666666,18,11,GGGTGACTCGTCGGCTTTGC,7,3165000
rdlDp,1.5833333333333333,29,11,GGATCGTTCACGTGTACGGA,18,3172898
rdlDp,3.5,52,11,GGAACTTTGCTGGGTTGAAC,41,3183393
rdlDp,1.8333333333333333,32,11,GCTGCAAGCCCCCAGAGGTC,21,3191553
rdlDp,0.5,16,11,GCGGGTCTTTCCCAGAGAAA,5,3177739
rdlDp,1.25,25,11,GCGGCTAAGAAGCTCCAGCA,14,3168621
rdlDp,1.0833333333333333,23,11,GCGATTCGCAATTACTCCTG,12,3190445
rdlDp,0.25,13,11,GCCCCTAACAGATTGACTCT,2,3167456
rdlDp,0.8333333333333334,20,11,GCAAAAGTCTTTCTGTTGGA,9,3175968
rdlDp,0.16666666666666666,12,11,GATTCATATGCACGAGCACG,1,3187232
rdlDp,1.8333333333333333,32,11,GATAGCGCCTCGCACAGTTG,21,3215632
rdlDp,0.75,19,11,GATAGAGTTTTGCGTAGGCG,8,3181295
rdlDp,0.4166666666666667,15,11,GATAGACATCGAAAAACTAA,4,3210562
rdlDp,0.8333333333333334,20,11,GAGTTTGTGAGATTGACTTA,9,3204369
rdlDp,0.6666666666666666,18,11,GAGTCCAGCCCTAAGTCGGG,7,3176372
rdlDp,0.9166666666666666,21,11,GAGGCTACTCCTTCGTAATT,10,3184894
rdlDp,9.416666666666666,123,11,GAGGAGGCGTGGTATATTGA,112,3182161
rdlDp,0.6666666666666666,18,11,GAATGATCCGTTTGCGGACT,7,3164824
rdlDp,1.25,25,11,GAATACGCTTCGCGGTTGGA,14,3192200
rdlDp,1.0833333333333333,23,11,CTTCAAAGGGTACGGGCAAT,12,3191758
rdlDp,1.0833333333333333,23,11,CTTATAATCAGAGGGTTTGA,12,3184215
rdlDp,0.6666666666666666,18,11,CTTAGTGGTCACGTGATTAT,7,3190444
rdlDp,0.6666666666666666,18,11,CTGGGCTCGCTCATCTTTGA,7,3185122
rdlDp,0.4166666666666667,15,11,CTCGTTGAGCAGTGGGGTAG,4,3198222
rdlDp,0.9166666666666666,21,11,CTAAGATGAAGACACTAAAC,10,3181610
rdlDp,0.5833333333333334,17,11,CTAACAAGGCAACGGTCGGA,6,3187563
rdlDp,3.5,52,11,CGGCTGTCGAGCGTGCACAA,41,3194207
rdlDp,0.4166666666666667,15,11,CGGCGAGTGCCAGCAGGGAT,4,3197421
rdlDp,1.0833333333333333,23,11,CGAGTCCGGTCTTCTATAGC,12,3194463
rdlDp,4.583333333333333,65,11,CGACAGTATTTTTCGTGTAT,54,3174635
rdlDp,0.75,19,11,CCTTTAGGTTATAATGGTAC,8,3197816
rdlDp,1.5,28,11,CCTCCGACGACCCCGGGGAA,17,3177181
rdlDp,0.9166666666666666,21,11,CCGGGCTAATGGTTTTGTCT,10,3172883
rdlDp,1.1666666666666667,24,11,CCGGCTAATTGCTATAGACC,13,3210338
rdlDp,1.3333333333333333,26,11,CCGCGTAAATTCTCATTCGG,15,3207390
rdlDp,0.16666666666666666,12,11,CCGAGAGCCTAGGTACGTAC,1,3193297
rdlDp,1.6666666666666667,30,11,CCGAGACTCGGCGTGTGCCC,19,3167637
rdlDp,2.0,34,11,CCGACTTGGTCCACGCTTTG,23,3198656
rdlDp,0.16666666666666666,12,11,CCCGTGAGCCTCATGAACTC,1,3187884
rdlDp,1.3333333333333333,26,11,CCCGCACGCTTTCTTCATTC,15,3201629
rdlDp,0.25,13,11,CCAAGCTTCCACGCATCGGG,2,3209520
rdlDp,1.8333333333333333,32,11,CCAAGCTTACACAGAAGGTG,21,3190361
rdlDp,0.6666666666666666,18,11,CATTGAGAGAGCACGGTTCC,7,3165290
rdlDp,0.25,13,11,CATTATGTTTCCTGGGCAGT,2,3177091
rdlDp,0.16666666666666666,12,11,CATTAGTGGCTAAGGCCCTC,1,3190586
rdlDp,1.0,22,11,CATAGTATTCCCAACGCACA,11,3202859
rdlDp,1.75,31,11,CACTCGGCTCTCGGGCATTG,20,3190871
rdlDp,0.9166666666666666,21,11,CACAACCCTACTGGTACACT,10,3200744
rdlDp,0.16666666666666666,12,11,CAACATCGACTGGGATATTC,1,3195179
rdlDp,2.0,34,11,CAAAGCGGACACCCGGCCGA,23,3168187
rdlDp,0.9166666666666666,21,11,CAAAGCCACATCACCGAGAA,10,3213702
rdlDp,0.5,16,11,ATTCTATGTGGCCACCCGGC,5,3171130
rdlDp,0.5833333333333334,17,11,ATCGTGATACTTCCCCCTTT,6,3166961
rdlDp,1.1666666666666667,24,11,ATCCTATGGGATTTGGCAAA,13,3198791
rdlDp,0.6666666666666666,18,11,ATCCTACGGAGATCAGGGGT,7,3165092
rdlDp,0.3333333333333333,14,11,ATCCAGATCTGGTGTATCAG,3,3199339
rdlDp,8.25,109,11,ATATGGACGACCCATAATCT,98,3199076
rdlDp,4.333333333333333,62,11,ATACGTGCACCTGCGGCACA,51,3204847
rdlDp,2.25,37,11,AGTTGCCAATTGCGTGGTGA,26,3204238
rdlDp,1.4166666666666667,27,11,AGTTATGGGCACCTGAGGAT,16,3170917
rdlDp,0.8333333333333334,20,11,AGGCGAATTTCCATCTTTTC,9,3190727
rdlDp,1.0833333333333333,23,11,AGGAAGCAGAATGTCGGCCC,12,3174896
rdlDp,0.9166666666666666,21,11,AGATGCGGAATAGTATTGCT,10,3191800
rdlDp,0.16666666666666666,12,11,AGAGTCTCTAACCATACAGT,1,3173487
rdlDp,0.5833333333333334,17,11,AGACCAATAGCATTTGTGAT,6,3177128
rdlDp,0.4166666666666667,15,11,AGAATCTAACTCCGCTAGTA,4,3176774
rdlDp,0.4166666666666667,15,11,AGAACAGACCTGCAACTATG,4,3191581
rdlDp,1.8333333333333333,32,11,AGAAATTGTTATACACTCTA,21,3201409
rdlDp,0.8333333333333334,20,11,ACTTAGACACGCCCTTAAGC,9,3192191
rdlDp,0.4166666666666667,15,11,ACGTTACGTTGGTCGGTACA,4,3196182
rdlDp,1.4166666666666667,27,11,ACGGATCTGAACGACTCGAA,16,3185818
rdlDp,1.1666666666666667,24,11,ACGATGCTTGGTAGTGCAAA,13,3184619
rdlDp,1.4166666666666667,27,11,AATCCGCCTCGTGCCACTTT,16,3181799
rdlDp,1.3333333333333333,26,11,AAGAAATTACGGGGATGTGT,15,3191659
rdlDp,1.5,28,11,AACTCGTGCAGGGTCTCGAG,17,3184051
rdlDp,0.25,13,11,AACGGTCCTACAAGGAGCTC,2,3168947
rdlDp,2.5833333333333335,41,11,AACGCCACTATGCTAATCTA,30,3181726
rdlDp,0.25,13,11,AAATCCGGGGTGCCAGTGTT,2,3186146
rdlDp,0.25,13,11,AAACACTGTGGAGGATACAT,2,3177745
rdlDp,0.9090909090909091,19,10,TTTGGGAGACCGGGAAATAA,9,3194722
rdlDp,0.18181818181818182,11,10,TTGCACAGCCTATGTGGAAA,1,3170283
rdlDp,0.18181818181818182,11,10,TTCTTTACGTGTCAATTCGC,1,3199465
rdlDp,0.45454545454545453,14,10,TTCGTCGGATTTGTAGTTAG,4,3197791
rdlDp,2.909090909090909,41,10,TTCGGAATTACTTTAGTGTT,31,3215144
rdlDp,0.9090909090909091,19,10,TTATGTTTTTGATAAGTACC,9,3176854
rdlDp,3.3636363636363638,46,10,TTACAGGGGAATGTGCTGTT,36,3205493
rdlDp,0.8181818181818182,18,10,TGTGCTGGCATATTGTCCGT,8,3177735
rdlDp,1.8181818181818181,29,10,TGTCCGCACCTGCTGCCCCT,19,3166811
rdlDp,6.090909090909091,76,10,TGTACACCGAACGATAGCTA,66,3192536
rdlDp,0.5454545454545454,15,10,TGGCTAGAGGGACGCGGTAA,5,3168155
rdlDp,0.45454545454545453,14,10,TGGAATCCGAACAGTGAGCC,4,3179693
rdlDp,1.0909090909090908,21,10,TGCGAGACTTGTTGATTTGG,11,3184682
rdlDp,1.0,20,10,TGATCGTTTGGGCCTGTATT,10,3171704
rdlDp,0.6363636363636364,16,10,TGAGTTCTGCTAAGCGTGGG,6,3182457
rdlDp,1.4545454545454546,25,10,TGACTCTCGAATGGGAAGTA,15,3176021
rdlDp,1.0909090909090908,21,10,TCTTTCGCGGTATTCGCGCA,11,3186702
rdlDp,2.4545454545454546,36,10,TCTGGTAGGTTCTGTATCGG,26,3195680
rdlDp,0.45454545454545453,14,10,TCTCCCAACCTTAATAAAGG,4,3186153
rdlDp,0.6363636363636364,16,10,TCGAAACTTCATAACAGCTG,6,3192682
rdlDp,0.5454545454545454,15,10,TCCTTTGAGTGTCACACCAT,5,3213574
rdlDp,1.8181818181818181,29,10,TCCTTCCCAGAAGGATATGA,19,3188375
rdlDp,0.8181818181818182,18,10,TCCGGCGCGCGTCCGCACCG,8,3187428
rdlDp,5.0,64,10,TCAGGCCCTAATTCTCTAGA,54,3168121
rdlDp,1.8181818181818181,29,10,TCAGGCATGCTGCGGAGCCT,19,3209353
rdlDp,0.2727272727272727,12,10,TCACCATAACTCGTTTGTAG,2,3182288
rdlDp,0.18181818181818182,11,10,TATGCAGTACGGGCGCGTTC,1,3192196
rdlDp,1.7272727272727273,28,10,TAGCACCGTGGCAACTCAGG,18,3166937
rdlDp,0.18181818181818182,11,10,TACGCGTATCAACCATTTTC,1,3170330
rdlDp,1.4545454545454546,25,10,TAACGCTGCAACGGTTACGA,15,3200752
rdlDp,0.36363636363636365,13,10,GTTTTGCGGTTATTAAGTAA,3,3179154
rdlDp,0.2727272727272727,12,10,GTCTGCTTCACGCGCCTACG,2,3195469
rdlDp,1.6363636363636365,27,10,GTCGGCAAAACCTTACCACT,17,3177110
rdlDp,1.2727272727272727,23,10,GTCACCAAAGCTGGCTGGAG,13,3184945
rdlDp,11.454545454545455,135,10,GTCAAAGTAACCTCGCATGG,125,3185744
rdlDp,1.2727272727272727,23,10,GTAATGAGCCTGGACTCCAT,13,3194108
rdlDp,1.7272727272727273,28,10,GGTGCTCACGAGGATTAAGG,18,3201989
rdlDp,0.7272727272727273,17,10,GGTCAAAGGGATAGAACCGT,7,3202100
rdlDp,0.18181818181818182,11,10,GGTACTTCGTTAGGTATGGT,1,3188601
rdlDp,1.3636363636363635,24,10,GGCCAAGAAAACCATGTCAA,14,3177114
rdlDp,0.45454545454545453,14,10,GGAGAAAGCAGAGTTCCCAC,4,3172900
rdlDp,2.5454545454545454,37,10,GGACGCTAAAATCGTCGAAG,27,3177112
rdlDp,1.9090909090909092,30,10,GCGTTGCCGGAAGTTTTTTG,20,3184211
rdlDp,0.18181818181818182,11,10,GCATGCTACAACATTGGGAG,1,3214365
rdlDp,0.9090909090909091,19,10,GCATCGCTAAAATTCAACTC,9,3213466
rdlDp,0.8181818181818182,18,10,GATCTTTATGGAGGTTGTTC,8,3169984
rdlDp,0.2727272727272727,12,10,GATAGACCGAGGACAAACAC,2,3167634
rdlDp,0.5454545454545454,15,10,GATAGAAGCGATTCACTTTA,5,3172857
rdlDp,1.6363636363636365,27,10,GACCGATTTAGCCCACTGTT,17,3168245
rdlDp,1.1818181818181819,22,10,GACAAGAAAGACGGATGCAT,12,3185307
rdlDp,0.36363636363636365,13,10,GAATGACGGAGGAATGCCAC,3,3199451
rdlDp,0.18181818181818182,11,10,GAAGTTAGACAGAGTTTAGG,1,3204150
rdlDp,0.9090909090909091,19,10,CTTGAAATAGTTAGAAGCCT,9,3187069
rdlDp,1.0909090909090908,21,10,CTGGTCCATTTCATAGGGAC,11,3213952
rdlDp,0.45454545454545453,14,10,CTGGAATGCAGTGCGTACTC,4,3188381
rdlDp,4.545454545454546,59,10,CTCTGGGGCGTCTCTCTGAT,49,3170073
rdlDp,1.0,20,10,CTCGGGCCGCGGGTCAAGCA,10,3187397
rdlDp,2.090909090909091,32,10,CTCGCCATTTCTTCAGAGCC,22,3179124
rdlDp,0.18181818181818182,11,10,CTCGAACCTGTTCATAAATG,1,3192404
rdlDp,6.181818181818182,77,10,CTATGGTCTAAATAAAACGG,67,3191403
rdlDp,0.36363636363636365,13,10,CTACCGTTGGTGGAGTTGAC,3,3181031
rdlDp,0.36363636363636365,13,10,CGTCTGTAGCGGCCACGCTT,3,3208295
rdlDp,0.36363636363636365,13,10,CGTCGGCCGTGCAAAGGTTT,3,3210870
rdlDp,1.1818181818181819,22,10,CGGTTCTGCGGACGAGGTTA,12,3198461
rdlDp,1.1818181818181819,22,10,CGGTCTTCAGGTCTTTTAGT,12,3164523
rdlDp,1.0,20,10,CGGCATACTGCCAGAAGCTC,10,3179119
rdlDp,7.2727272727272725,89,10,CGGAGGAGCTAATGACCGAT,79,3212435
rdlDp,1.1818181818181819,22,10,CGATCAGTCGGTCCCTTGCA,12,3195639
rdlDp,4.909090909090909,63,10,CGAGTGCCACGTCGGGGCGT,53,3207386
rdlDp,0.6363636363636364,16,10,CCTGGACCATTGCTAGCAAA,6,3166730
rdlDp,1.2727272727272727,23,10,CCTGCATATCACGTATACGT,13,3207634
rdlDp,1.8181818181818181,29,10,CCGTCGGCATTGGGTAAAAT,19,3169602
rdlDp,0.9090909090909091,19,10,CCATTATTTCCCTAGAGAAC,9,3166338
rdlDp,0.9090909090909091,19,10,CCATCTACGGTGGTTCACAG,9,3184716
rdlDp,0.5454545454545454,15,10,CCAGGGCTTTCGAATCGACA,5,3185125
rdlDp,2.4545454545454546,36,10,CCAATCAATAATATTGAAGA,26,3215787
rdlDp,0.18181818181818182,11,10,CATGACGGGAGGAGTTATAA,1,3202051
rdlDp,1.9090909090909092,30,10,CATACCGCACGCAGTATATA,20,3205286
rdlDp,0.18181818181818182,11,10,CAGTCGTATGCCTATACCAG,1,3170252
rdlDp,0.6363636363636364,16,10,CAGCGTGGAACCACAGGCGA,6,3191552
rdlDp,2.090909090909091,32,10,CAGCAGATCCTTGAGAACTA,22,3191814
rdlDp,1.4545454545454546,25,10,CACTTGGGGAGCACCTGCTT,15,3167142
rdlDp,0.6363636363636364,16,10,CACGTTAGGCACTGATGTGT,6,3176379
rdlDp,0.5454545454545454,15,10,CACACGTTAAGCGCGAATAC,5,3181978
rdlDp,0.7272727272727273,17,10,CAATATTCTAACAAAAGTAT,7,3191736
rdlDp,1.0,20,10,CAAGTCTTGCTCATCCAACT,10,3209444
rdlDp,0.7272727272727273,17,10,ATTGCTGGACTCCACCGGGG,7,3176732
rdlDp,1.3636363636363635,24,10,ATTCAGGGTAGATGTGCTTG,14,3185129
rdlDp,0.6363636363636364,16,10,ATGTGGTAACTCTTCAATCT,6,3192968
rdlDp,2.727272727272727,39,10,ATGAATCACATTTGATATAT,29,3176657
rdlDp,0.5454545454545454,15,10,ATCTGGAATTCTGGCTTGTT,5,3194199
rdlDp,0.18181818181818182,11,10,ATCTAATAGCATTGAGCTAC,1,3214845
rdlDp,2.090909090909091,32,10,ATCGTCAGGGTCTTAACGCC,22,3188324
rdlDp,0.36363636363636365,13,10,ATAGCAAGCTGTGCTTCACG,3,3166107
rdlDp,1.0909090909090908,21,10,ATAATACAGCGTGCACTGTC,11,3206699
rdlDp,0.2727272727272727,12,10,ATAAGCTAGGTTTGGACCGT,2,3201913
rdlDp,1.0909090909090908,21,10,AGTGCCGAGTCAGTAGGCCC,11,3181867
rdlDp,0.5454545454545454,15,10,AGTCGGATACGGCCGGTGTA,5,3165141
rdlDp,1.0,20,10,AGGGGTGCAAAGCTGAACTA,10,3205324
rdlDp,1.4545454545454546,25,10,AGGGGAATCTATGATGCCTT,15,3171694
rdlDp,0.2727272727272727,12,10,AGGATCAGAGTTTTCGTACG,2,3214198
rdlDp,0.2727272727272727,12,10,AGAGTTGTTCTCTGGGATTG,2,3190357
rdlDp,0.5454545454545454,15,10,AGAGGGCGCCGCCATACGTG,5,3192998
rdlDp,0.5454545454545454,15,10,ACAACCACCCCATGGGGCGT,5,3208941
rdlDp,0.7272727272727273,17,10,AATTTGGTCACTATTGAACA,7,3190883
rdlDp,4.090909090909091,54,10,AATAGCGGTGTATCATCGGG,44,3169382
rdlDp,1.6363636363636365,27,10,AATAGCCGCTTCTTGCCCGA,17,3175958
rdlDp,10.909090909090908,129,10,AAGTTAACGGGAACAACGGC,119,3185570
rdlDp,2.090909090909091,32,10,AAGGAAGCCTATTCTTATGG,22,3193852
rdlDp,0.45454545454545453,14,10,AAACCCTTAGCAAGGGGAGC,4,3215423
rdlDp,0.5,13,9,TTTGTGTAATTGATGGCTGT,4,3191759
rdlDp,0.8,16,9,TTTCAATGGTAAAGCTGCTG,7,3213960
rdlDp,1.7,25,9,TTTAGAGCTTTCCCTGAGTA,16,3167732
rdlDp,0.9,17,9,TTGACGGGGTACAAGAGTAC,8,3211699
rdlDp,2.8,36,9,TTCGCGGCTAATCCTCCATA,27,3209022
rdlDp,1.4,22,9,TTCAGCGGTCAGTTGACAAG,13,3187823
rdlDp,0.2,10,9,TGTGCAAGGCTCCAGGTACG,1,3164151
rdlDp,1.0,18,9,TGGTCTGATCACAGAATATG,9,3195348
rdlDp,0.8,16,9,TGGGTTGGGCACCGTTGTCC,7,3185127
rdlDp,0.2,10,9,TGGGTTAGGCGCAGGCGGAA,1,3208421
rdlDp,0.4,12,9,TGGCCCGGAGGAATCTAAGT,3,3177338
rdlDp,0.2,10,9,TGGAAGTTGCGCAGACGGTA,1,3214485
rdlDp,1.0,18,9,TGCCTACGCGGCATTTGAGG,9,3165137
rdlDp,1.8,26,9,TGCACGGCGACTCCACCAAA,17,3192952
rdlDp,1.0,18,9,TGAATCTCGCAATCGACATG,9,3200650
rdlDp,1.6,24,9,TGAACGGTCTAAGGTCGTTT,15,3194525
rdlDp,0.6,14,9,TCGCTCTGGGAGCCAGAATG,5,3209356
rdlDp,1.5,23,9,TCCGAGCCACCTTTCGAGGG,14,3209600
rdlDp,0.8,16,9,TCCGAAGCCAACAATTAGTT,7,3195373
rdlDp,0.2,10,9,TCCCGGGTCTGCAGGCATGG,1,3191294
rdlDp,0.4,12,9,TCCATTGTATAGGCGAGTGT,3,3197840
rdlDp,0.9,17,9,TATTTCCAAAGACTATCCCG,8,3213419
rdlDp,1.0,18,9,TATGTTCCGACATTTGTTCG,9,3195353
rdlDp,0.2,10,9,TATCGCATCGCGGCCGCGGA,1,3205408
rdlDp,1.9,27,9,TACCGTTGGGATTAATGCTC,18,3166570
rdlDp,0.2,10,9,GTGTGCCATTTTACACCCGT,1,3206440
rdlDp,2.5,33,9,GTGTAGAGAGCCGTGGGAAT,24,3208422
rdlDp,0.4,12,9,GTGGTAAACGACTCCCGAAC,3,3186139
rdlDp,0.4,12,9,GTGGAACCCGAAGAATACTC,3,3205030
rdlDp,17.5,183,9,GTGACGGACTAATCATGTGT,174,3191910
rdlDp,1.1,19,9,GTGACGAACCGTTAGGCTTT,10,3208290
rdlDp,3.8,46,9,GTGACATATGGAGGTATTGA,37,3170212
rdlDp,0.6,14,9,GTCATCGGCCAGCGCAGCGC,5,3209044
rdlDp,0.8,16,9,GTAAGTTGAATGAAAGAACA,7,3199963
rdlDp,0.8,16,9,GTAAAGAGACGCAGGCTTCA,7,3196277
rdlDp,1.0,18,9,GTAAAAGCTAGGGGTGTAGT,9,3180801
rdlDp,0.3,11,9,GGTTGGAGGCTCATGAGTTT,2,3195456
rdlDp,0.6,14,9,GGTAAAGTGACTACTGCGTA,5,3194457
rdlDp,2.9,37,9,GGGTGGTTGACATTAGCATA,28,3211513
rdlDp,0.3,11,9,GGCTTCTCTGTGCTACACTT,2,3166734
rdlDp,1.0,18,9,GGCCGTATCGCCCAGGCCTA,9,3192407
rdlDp,0.6,14,9,GGATGATGATCGGACCAACA,5,3187408
rdlDp,1.4,22,9,GGAAACCTTCGCAACACGAT,13,3175848
rdlDp,0.4,12,9,GCTTTATTAAAGTTGCTCTA,3,3200264
rdlDp,0.2,10,9,GCTCCATCAAGTTGAGAAGT,1,3212662
rdlDp,3.1,39,9,GCGTTGCTTGGGTGTCGTTG,30,3209361
rdlDp,0.9,17,9,GCGCACTTAACCTATACGAC,8,3185806
rdlDp,0.5,13,9,GCGATCGGTGGGCTCCCAGT,4,3197586
rdlDp,0.3,11,9,GCGAGTGTTCGCCGGGTAGC,2,3208739
rdlDp,0.2,10,9,GCCTAAGTTTCACTTAACTG,1,3197846
rdlDp,0.7,15,9,GCCGCAGAGCATTGCAAGTG,6,3173274
rdlDp,1.6,24,9,GCCACGTCTCCAGCTAAGGA,15,3211703
rdlDp,0.4,12,9,GCCACCGCTGGATCGGGTTT,3,3194453
rdlDp,1.9,27,9,GCACGCAAGCCCAGGGACCT,18,3199082
rdlDp,4.1,49,9,GCAAGTGACAATGTACCTCG,40,3189233
rdlDp,0.8,16,9,GATATTTTCCGAGTCACAAC,7,3173177
rdlDp,0.4,12,9,GAGAAAAAATCGCCAGCGCA,3,3201630
rdlDp,1.6,24,9,GACAGGGATCGAGGATAACT,15,3183127
rdlDp,1.1,19,9,GAAATTTCCCCTTATTTTTC,10,3190592
rdlDp,0.8,16,9,CTTGGCAAAACTTATTATCT,7,3191744
rdlDp,0.2,10,9,CTGTTGCCGCTACACTTCCT,1,3208006
rdlDp,1.8,26,9,CTGAAAGGCCTCGGAACGCA,17,3181023
rdlDp,1.9,27,9,CTCTCACTGGCTGCGGCTGC,18,3208032
rdlDp,1.4,22,9,CTCCGTGGAAGTAGTAGACA,13,3213984
rdlDp,0.8,16,9,CTCCAGAGCCCTTTTGATAG,7,3195376
rdlDp,0.2,10,9,CTATTTTCTTAAAAGCAGCT,1,3186285
rdlDp,2.1,29,9,CTAGGTACGCTCAAACCCAG,20,3211042
rdlDp,1.8,26,9,CTAGCCTAGTCACTATTGTT,17,3192229
rdlDp,0.6,14,9,CTACGGAAAGTAGGAAAACG,5,3210566
rdlDp,0.4,12,9,CGTGCATAATTAGATCGTCT,3,3185750
rdlDp,2.3,31,9,CGTCCTCAAGAGCACAGTCG,22,3172165
rdlDp,1.0,18,9,CGTCCGGAACGCACGTGGAA,9,3187943
rdlDp,0.9,17,9,CGTCAGGATTGTTTATTTTT,8,3213876
rdlDp,0.5,13,9,CGGGGAAGCTGGCAAACTGG,4,3203681
rdlDp,1.1,19,9,CGCCCTGCTGTGTTAAGTTG,10,3169968
rdlDp,1.4,22,9,CGAGGCGTTTTACTCGTCTT,13,3181850
rdlDp,0.2,10,9,CGAATGGCCAGAACTCCGTG,1,3208439
rdlDp,1.4,22,9,CCTATGGGTTACAGTGAACT,13,3168387
rdlDp,3.2,40,9,CCGCTTCGTTGCTTTTCGAC,31,3212609
rdlDp,1.6,24,9,CCGCGAAGTAGATGCCAGTT,15,3204242
rdlDp,0.4,12,9,CCCGCTCTTGTAACGGTGAG,3,3173591
rdlDp,1.5,23,9,CCCGCAAGGTATCGCCTCGT,14,3195233
rdlDp,0.6,14,9,CCCAATCGTTTCCATGGCAT,5,3181728
rdlDp,1.5,23,9,CCAGGACAGAGTAAGGGACC,14,3166946
rdlDp,0.3,11,9,CCAGCGTCGTTAACCTGAGA,2,3168631
rdlDp,2.7,35,9,CCACCTGCTCGCCCCACGAC,26,3210229
rdlDp,0.5,13,9,CATTATGAAAAGGTTTTGAG,4,3187822
rdlDp,2.8,36,9,CATCGGATTAAGAAGCCGGT,27,3193601
rdlDp,3.1,39,9,CATAAGGGGACTCAGTCAAG,30,3177115
rdlDp,0.2,10,9,CAGTGTGTAGGAGATAGAGT,1,3208336
rdlDp,0.7,15,9,CAGGTATCCCAGGAACTTCA,6,3194759
rdlDp,0.8,16,9,CAGGCGAGTTTTATTGGGCT,7,3200691
rdlDp,4.4,52,9,CACCCGGCTCTTTGTTGAGG,43,3192631
rdlDp,0.3,11,9,CAATTTCGCGGACATAGCGT,2,3191296
rdlDp,0.5,13,9,CAATGTGTAGATGAGGGCTT,4,3198850
rdlDp,5.6,64,9,CAAGGGATAAGGCGGGGCTC,55,3193940
rdlDp,2.4,32,9,CAAACGGGAAAAGGCACTAT,23,3188336
rdlDp,0.2,10,9,CAAACAGCCAACTGAAACCA,1,3175491
rdlDp,1.5,23,9,ATTGGAACCGCCCTAGCCGG,14,3207733
rdlDp,0.3,11,9,ATTGCGGCGGTGTACATACG,2,3184921
rdlDp,2.2,30,9,ATGTGTTGTCCTCCGTCGGC,21,3181821
rdlDp,0.2,10,9,ATGGCGCATGATGTCCACAC,1,3172229
rdlDp,2.2,30,9,ATGGCCCCTGTGTAGGGTTA,21,3209047
rdlDp,0.6,14,9,ATCTTTCTATGAGCTTATGT,5,3188364
rdlDp,1.8,26,9,ATCCGAAGCCGCAGATTTCT,17,3171884
rdlDp,1.1,19,9,ATCCATGGGCGGGCAACATG,10,3177126
rdlDp,0.5,13,9,ATCAATGAATTCTCTTCGGG,4,3205207
rdlDp,0.2,10,9,ATAGACTTCCGTCGGTAACG,1,3189679
rdlDp,3.9,47,9,ATACGACCTGTGGGAGGCCA,38,3207590
rdlDp,0.2,10,9,AGTTTACTCTATGGATCCTG,1,3194523
rdlDp,0.9,17,9,AGTGCTGGGGAAGGAGTCCC,8,3175499
rdlDp,1.7,25,9,AGTCGTCCACTTTGTGCCCT,16,3201855
rdlDp,3.3,41,9,AGTATCTCGTTCAAGAACTG,32,3212482
rdlDp,1.3,21,9,AGGTCAGAGGTTCCGCGAAA,12,3204972
rdlDp,4.9,57,9,AGCGTCCCGGCGCTGCGTAT,48,3168126
rdlDp,0.5,13,9,AGCGCCTCTTCAATTCTATG,4,3212012
rdlDp,0.7,15,9,AGCAGAATGAGAAAATCATT,6,3183117
rdlDp,0.9,17,9,AGATGGTTAATTAACATGTT,8,3201851
rdlDp,0.8,16,9,AGATCTTTTGAGGCTGCCAC,7,3173005
rdlDp,0.4,12,9,AGATCGTCCGTGAGTGTGAT,3,3166938
rdlDp,0.4,12,9,AGAGTGAGAAACCCGTGGTA,3,3188328
rdlDp,0.6,14,9,AGAATCGCATCCTCTCTTGG,5,3175742
rdlDp,0.4,12,9,ACTGCTTATCATATCGCGGG,3,3165735
rdlDp,2.3,31,9,ACTGAGCCAAGTATCTTCGT,22,3187575
rdlDp,2.8,36,9,ACTCATCTTCGTCGGCTTCT,27,3211238
rdlDp,0.5,13,9,ACGTCCCCCTACTCGATAAC,4,3175574
rdlDp,1.6,24,9,ACCGAAGCAATACCCCAAAG,15,3188124
rdlDp,0.6,14,9,ACAGTCGTGCTATCCGGCCC,5,3194615
rdlDp,1.6,24,9,ACAGTAGTAGCCTCGGTAAC,15,3166933
rdlDp,1.7,25,9,ACAATGCAGAGGACCTTTAT,16,3200681
rdlDp,4.0,48,9,AATATCTTACTTCTTAATGA,39,3203593
rdlDp,0.2,10,9,AAGGTGCAGCTTTCACACCA,1,3188103
rdlDp,3.7,45,9,AAGCATAAGGTTATCTACGG,36,3189754
rdlDp,0.7,15,9,AACGTTTTCGCACCGGCACG,6,3165489
rdlDp,16.5,173,9,AACAAATAACAGTGTGTGGG,164,3193596
rdlDp,0.3333333333333333,10,8,TTTTAGGATCGTGATCTATA,2,3168835
rdlDp,1.6666666666666667,22,8,TTTAGCCCTAACGTATGTTA,14,3211404
rdlDp,2.4444444444444446,29,8,TTCATTTGTGGGATCTATGT,21,3191225
rdlDp,3.111111111111111,35,8,TGTCAGTGAGGACATCGCCA,27,3167289
rdlDp,4.555555555555555,48,8,TGTAGGACGTTGACTCAACT,40,3212836
rdlDp,0.8888888888888888,15,8,TGGGTTGCACATTCTAAAAA,7,3168146
rdlDp,0.5555555555555556,12,8,TGGGCCTATCAGGGGGGTAA,4,3201416
rdlDp,6.111111111111111,62,8,TGGCGTTCCAAGCCCTCGTT,54,3190051
rdlDp,2.0,25,8,TGGCGGGCTACGAATTGGTT,17,3171224
rdlDp,2.0,25,8,TGGAATCTAATAAAACGGGG,17,3167395
rdlDp,0.8888888888888888,15,8,TCGTGCCTATACCTCTCGAG,7,3187399
rdlDp,0.4444444444444444,11,8,TCGGGGCGCCAGCACCAGGT,3,3179689
rdlDp,0.4444444444444444,11,8,TCCTCGCACAGCCGTTCGCA,3,3200690
rdlDp,2.111111111111111,26,8,TCCCGGATAGGAGTAGGGTG,18,3179126
rdlDp,1.3333333333333333,19,8,TCCAGAGATCGTTCGCAGTC,11,3193327
rdlDp,0.6666666666666666,13,8,TATTGCCAGCACGACTCAAT,5,3206514
rdlDp,0.2222222222222222,9,8,TATCTACGTCTGTATTCTTT,1,3181523
rdlDp,0.4444444444444444,11,8,TATCGTGCACCCGGAATGTC,3,3182115
rdlDp,0.2222222222222222,9,8,TATATGTTCGAATAGTCTAT,1,3170282
rdlDp,0.2222222222222222,9,8,TATACTATAGGCTGGTTCGC,1,3168109
rdlDp,9.222222222222221,90,8,TACGGTTGTTGGTCTCTCTA,82,3212480
rdlDp,1.7777777777777777,23,8,TACGGTGTTACATCCTGAGA,15,3208688
rdlDp,3.888888888888889,42,8,TAATCAACCCGTGAGGTAAA,34,3178076
rdlDp,0.2222222222222222,9,8,GTTGCGAAGTTTCCTGGCAG,1,3215832
rdlDp,4.333333333333333,46,8,GTTATGGAGAATTGACTGTT,38,3199501
rdlDp,4.666666666666667,49,8,GTGGTTCGGTCATCTGAGAA,41,3213311
rdlDp,1.2222222222222223,18,8,GTGGTACCTCTGCTGGCCAA,10,3164211
rdlDp,1.5555555555555556,21,8,GTGCTTGTGGGCAGCTGTCT,13,3174333
rdlDp,1.8888888888888888,24,8,GTCTTGGGCCGAATTTCACT,16,3215629
rdlDp,0.3333333333333333,10,8,GTCTTAGGTAAGTAACTAAG,2,3171033
rdlDp,1.0,16,8,GTCTAAGTCCCCGATGCTTA,8,3208420
rdlDp,2.2222222222222223,27,8,GTCCTACCTATTGTTCCTAT,19,3173947
rdlDp,1.7777777777777777,23,8,GTCCCCTCCAGCGGCATTAG,15,3173731
rdlDp,3.5555555555555554,39,8,GTCAGCGGGCCGTAAGCTGT,31,3170276
rdlDp,1.2222222222222223,18,8,GTCACTATGAGTCGTGAGCT,10,3205340
rdlDp,0.3333333333333333,10,8,GTCACGGGAAAGTGTCAAGT,2,3214178
rdlDp,0.3333333333333333,10,8,GTCAATGGGGTTGATGGTCA,2,3179539
rdlDp,1.8888888888888888,24,8,GTATTAAGAGCGAGAGACCA,16,3187676
rdlDp,0.2222222222222222,9,8,GTAGTGGAACCACAATTTAG,1,3210916
rdlDp,1.8888888888888888,24,8,GTAGCAATAGTGGCAACCGT,16,3189755
rdlDp,0.2222222222222222,9,8,GTACTTTTACGGCACAAGGA,1,3203485
rdlDp,2.111111111111111,26,8,GTAATTAAGCATCTCTGGCT,18,3164212
rdlDp,0.3333333333333333,10,8,GGTAATGAATCTGACCTACT,2,3211726
rdlDp,0.3333333333333333,10,8,GGGTGATTGTAGATCATACG,2,3196184
rdlDp,1.5555555555555556,21,8,GGGCTTGTCGGCACATAAAT,13,3213300
rdlDp,6.444444444444445,65,8,GGGCCAGCGAAAGTATTATA,57,3212862
rdlDp,1.2222222222222223,18,8,GGCGGATGCTGGAACTAGCA,10,3207494
rdlDp,2.5555555555555554,30,8,GGCCGTAACGTAGGCCCGCA,22,3203970
rdlDp,0.5555555555555556,12,8,GGCAGGGTATACTACGGCGG,4,3173583
rdlDp,0.7777777777777778,14,8,GGATCAGGCTGTAACCACTG,6,3194939
rdlDp,1.1111111111111112,17,8,GGATCAGCAGAATAGTGAGA,9,3168091
rdlDp,3.111111111111111,35,8,GGACTTTCAACTTATCCCGC,27,3183384
rdlDp,1.7777777777777777,23,8,GGAAAACAAGATCTCGCCAA,15,3186821
rdlDp,0.3333333333333333,10,8,GCTATCCATGTAGGGAGTGC,2,3203771
rdlDp,1.7777777777777777,23,8,GCTAGGAATAAGTCCTCCGG,15,3177519
rdlDp,0.8888888888888888,15,8,GCGTAGGATCCTAGCTCCCC,7,3192961
rdlDp,1.7777777777777777,23,8,GCCTTTATACTGGTGTACAC,15,3194937
rdlDp,2.2222222222222223,27,8,GCCGGTAGACCACGGTATGG,19,3189239
rdlDp,0.4444444444444444,11,8,GCCCAAAGACTGCTGCGAGA,3,3181572
rdlDp,0.5555555555555556,12,8,GCATGCGACCTGTATGATTG,4,3213260
rdlDp,0.3333333333333333,10,8,GCAGGACGTAAACGACACAC,2,3184599
rdlDp,2.5555555555555554,30,8,GCAGACGTGCTGCAATTTCG,22,3201081
rdlDp,2.111111111111111,26,8,GCACGACTTATAAGCGCAAT,18,3205884
rdlDp,0.3333333333333333,10,8,GATTCGGGGTAATCCCGGCA,2,3175698
rdlDp,1.3333333333333333,19,8,GATGAAATAGCAACAAACAG,11,3213577
rdlDp,0.7777777777777778,14,8,GATCGGCTGGCAATGCCCAT,6,3172739
rdlDp,1.1111111111111112,17,8,GAGATTGCCATGCTGGACTT,9,3174136
rdlDp,5.444444444444445,56,8,GACCTGTAACCGATTAGGCA,48,3202201
rdlDp,0.4444444444444444,11,8,GAAGGTACGTCCGGTTCACC,3,3184775
rdlDp,0.4444444444444444,11,8,CTTTTTCAGGCTCCCTGAGT,3,3194534
rdlDp,4.222222222222222,45,8,CTTACGGTTGCAACACCGCG,37,3166438
rdlDp,2.111111111111111,26,8,CTTAACCCGACACGTGCACG,18,3199526
rdlDp,1.7777777777777777,23,8,CTGTCCAAAAACACCATTCG,15,3177573
rdlDp,0.7777777777777778,14,8,CTGGCGCTTGGCGCAAGCGT,6,3174542
rdlDp,0.7777777777777778,14,8,CTCTAAATACTGTCGTCCCC,6,3213579
rdlDp,0.7777777777777778,14,8,CTCAGAACGGTAGGTGGATG,6,3208047
rdlDp,0.7777777777777778,14,8,CTATAACAGGCCTCTTGGTC,6,3215805
rdlDp,0.3333333333333333,10,8,CTAGACAGGCTCCGCGGATC,2,3170006
rdlDp,0.8888888888888888,15,8,CGTCATGCCCTCTAATCTCT,7,3214324
rdlDp,0.5555555555555556,12,8,CGTCAAACACTTAATAGAAG,4,3189050
rdlDp,3.3333333333333335,37,8,CGTAAAAAGCACGTCGATCC,29,3202129
rdlDp,1.3333333333333333,19,8,CGGTCCGTTTGGCCGCCATG,11,3211822
rdlDp,0.8888888888888888,15,8,CGGGCATCATCGAAGACACA,7,3167848
rdlDp,1.7777777777777777,23,8,CGCTGGGAAATTAGGCTCAT,15,3176735
rdlDp,4.666666666666667,49,8,CGCGTGGTGACCAGGCCGTT,41,3215790
rdlDp,0.5555555555555556,12,8,CGCGTCGTATTAGCTTCGCC,4,3209666
rdlDp,2.888888888888889,33,8,CGCCGCGGTAATCATGCGGG,25,3205328
rdlDp,0.5555555555555556,12,8,CGAGCTGCGATAGTGCAGGC,4,3179487
rdlDp,0.5555555555555556,12,8,CGAGCGGGAGGGCCTTGTCC,4,3176845
rdlDp,1.2222222222222223,18,8,CGACGACACAGGGGCGTTTG,10,3206560
rdlDp,0.2222222222222222,9,8,CGAACGAACGCTACAGGTGA,1,3202309
rdlDp,3.4444444444444446,38,8,CCTCCTGTTAGAAAAGTTAT,30,3166563
rdlDp,0.5555555555555556,12,8,CCCTCGGGGAACCGGTCACA,4,3175584
rdlDp,7.222222222222222,72,8,CCCGGTACCGGAAATAACGT,64,3212502
rdlDp,1.7777777777777777,23,8,CCCCCAGGGTTCGTAAACGC,15,3188605
rdlDp,1.6666666666666667,22,8,CCATTGTCTGTTTATAATTA,14,3199074
rdlDp,2.5555555555555554,30,8,CCAGCTTTATACAACTAGGT,22,3167664
rdlDp,1.0,16,8,CCACTCTATGGTGGCTTTTT,8,3177748
rdlDp,1.4444444444444444,20,8,CCACAAAATCATCCGAGACC,12,3199745
rdlDp,3.5555555555555554,39,8,CCAATGGACCCATAGCAGAA,31,3208483
rdlDp,0.6666666666666666,13,8,CATCCACCTGTGTGCTAGCC,5,3175914
rdlDp,1.1111111111111112,17,8,CAGTTTTATTGCCTAGGCTA,9,3203806
rdlDp,0.6666666666666666,13,8,CAGTTCTACTCATTATTATG,5,3200146
rdlDp,3.5555555555555554,39,8,CAGGTCTGTAACATCGCCCC,31,3195137
rdlDp,0.5555555555555556,12,8,CAGCTTGAGACACTGGCACA,4,3176745
rdlDp,0.6666666666666666,13,8,CAGAGTCGCCCGCGGAGAGT,5,3191807
rdlDp,3.0,34,8,CACTCTTCGGAAGATCGTAA,26,3168906
rdlDp,4.666666666666667,49,8,CACCATCCAGGACCGGAGCA,41,3167624
rdlDp,2.5555555555555554,30,8,CACCACCTCACGCCGAACGC,22,3213344
rdlDp,1.1111111111111112,17,8,CAAGATCATGTTCACAGACG,9,3178734
rdlDp,0.6666666666666666,13,8,CAAATCGACGCTGCTATCAA,5,3214004
rdlDp,0.8888888888888888,15,8,CAAACCCCGTTGCACTTACT,7,3208967
rdlDp,2.4444444444444446,29,8,ATTTTAGCATTCGGTTTTGC,21,3184712
rdlDp,2.7777777777777777,32,8,ATGTTAAAGCGTATCCCCGG,24,3211876
rdlDp,1.2222222222222223,18,8,ATGATTTTGGGGCAGGAGTA,10,3177332
rdlDp,0.4444444444444444,11,8,ATCTCGCCTCTTAATCTGGG,3,3181550
rdlDp,4.0,43,8,ATCACCTGAACATAAGCTAT,35,3209060
rdlDp,0.5555555555555556,12,8,ATACCTCTATTGTTTCTATA,4,3195148
rdlDp,0.3333333333333333,10,8,AGTCCCCCGGGATAAGTCGT,2,3197836
rdlDp,0.2222222222222222,9,8,AGTCCCAGAATATACTACTC,1,3200761
rdlDp,0.5555555555555556,12,8,AGTCCAGCACCACGGGATCA,4,3187932
rdlDp,0.2222222222222222,9,8,AGGGGGTAGGTCACCGGGCT,1,3202845
rdlDp,1.3333333333333333,19,8,AGCTATTTGTTTTCCCTCGG,11,3172176
rdlDp,10.88888888888889,105,8,AGCGACCTAGGCGGGTTCGC,97,3194258
rdlDp,3.4444444444444446,38,8,AGCCATATATAGGCTTCATA,30,3208173
rdlDp,2.7777777777777777,32,8,AGCAAACCCAAACTACCCAA,24,3179301
rdlDp,1.2222222222222223,18,8,AGATACGGAGGTTATGTGGA,10,3174646
rdlDp,0.4444444444444444,11,8,AGACTCTACAAGCACTTATC,3,3181393
rdlDp,1.3333333333333333,19,8,AGACTATGGTCGGGGAATTT,11,3188953
rdlDp,0.5555555555555556,12,8,ACTTTCGGAGTGGGGATTAA,4,3205927
rdlDp,1.7777777777777777,23,8,ACTACAAATGATGGCTATCC,15,3184514
rdlDp,3.111111111111111,35,8,ACGTCTCCGCATTTCTTACC,27,3191571
rdlDp,1.2222222222222223,18,8,ACGTCGGTAACGTGGCCCTC,10,3187871
rdlDp,0.4444444444444444,11,8,ACGTAGGGTTAGTCCTTCAA,3,3192688
rdlDp,0.6666666666666666,13,8,ACGGAAAGATTGTAAGCTCT,5,3173954
rdlDp,0.5555555555555556,12,8,ACGCGGCAATCGTCAACGTG,4,3192981
rdlDp,0.5555555555555556,12,8,ACGCGCATAACGTTCCATAT,4,3194903
rdlDp,3.0,34,8,ACCCCGTCTCATTTGGCCGA,26,3177883
rdlDp,1.7777777777777777,23,8,ACAGTTCTCTTGTAAACCCC,15,3184401
rdlDp,1.0,16,8,ACACGACTGTTTGTTCCCCC,8,3177113
rdlDp,1.2222222222222223,18,8,ACACCCTCAGTCTGTCATAG,10,3177903
rdlDp,0.7777777777777778,14,8,ACACACCTCATATTCATACA,6,3167145
rdlDp,2.0,25,8,ACAAGTGGCTCCTGGTCATA,17,3165972
rdlDp,3.111111111111111,35,8,ACAACCGTAATTGATCACCA,27,3183383
rdlDp,0.2222222222222222,9,8,AATCGAGGCAAAATGGGTAA,1,3185496
rdlDp,2.6666666666666665,31,8,AATCCGTCGATATTGTAAGG,23,3187557
rdlDp,1.1111111111111112,17,8,AAGTACCTTTCGCAGGCATT,9,3172908
rdlDp,0.3333333333333333,10,8,AAGGATCATTACCTGTGAAT,2,3202652
rdlDp,0.2222222222222222,9,8,AAGCAGGGTTCGGTAGGTTG,1,3189103
rdlDp,0.6666666666666666,13,8,AAGATACACTCGTCGGAGTG,5,3167663
rdlDp,0.8888888888888888,15,8,AACGTCTCCCGATCAACTGA,7,3203051
rdlDp,2.2222222222222223,27,8,AAATTATAGACTGTGCATAC,19,3207391
rdlDp,1.1111111111111112,17,8,AAAGGTGTTCGGATCGAGGT,9,3194732
rdlDp,1.5555555555555556,21,8,AAAGGCAAAATGATCTACCG,13,3191000
rdlDp,0.2222222222222222,9,8,AAACACGACAAAAGATCAAG,1,3203810
rdlDp,1.375,17,7,TTTGATGCCGGCAATACTCT,10,3200009
rdlDp,6.125,55,7,TTGGAGACAATTTGGGTAGA,48,3199376
rdlDp,2.375,25,7,TTGCCTTACGCTTTTGAACC,18,3204142
rdlDp,0.25,8,7,TTGCATGCATCCACAAGTTG,1,3194580
rdlDp,0.75,12,7,TTGCAGCGGTTGCGTAATAG,5,3210310
rdlDp,0.875,13,7,TTGATGTGGGTGGCGTAGGC,6,3175320
rdlDp,0.25,8,7,TTCCCACTCTCGCCCCTCCT,1,3174220
rdlDp,0.375,9,7,TTATCGGAAAGGCAAGGCTT,2,3167540
rdlDp,3.0,30,7,TTATACTCTCCGGCCTAGGT,23,3194221
rdlDp,2.875,29,7,TTAGTGGCTGGTTAAACATG,22,3208026
rdlDp,1.25,16,7,TTAGGTCTACAGTAATCGTG,9,3214225
rdlDp,0.75,12,7,TTACAACCCTACGGAAGTAA,5,3176849
rdlDp,0.25,8,7,TGTTACGGCCGAATTGACTA,1,3187935
rdlDp,1.5,18,7,TGTGACTGCTTACAAGCGAT,11,3173838
rdlDp,4.875,45,7,TGTAACGGTGTAAACGGCGA,38,3179478
rdlDp,3.625,35,7,TGGATGTGAGGCTGACACGT,28,3197771
rdlDp,3.25,32,7,TGCAAGGGACATCGGTCAAT,25,3168574
rdlDp,3.875,37,7,TGATCTGGCGCCAGAACATA,30,3198034
rdlDp,5.875,53,7,TGAGGGCCATGGAATAGGTA,46,3210230
rdlDp,3.75,36,7,TGACATATTGGCTCTGCGCC,29,3212602
rdlDp,0.625,11,7,TCGTAGTACGGGGCCGATGA,4,3204348
rdlDp,1.5,18,7,TCGGCTTGCATAATATGGAT,11,3192956
rdlDp,0.75,12,7,TCGCTGATTCGTACAGCACC,5,3179040
rdlDp,4.375,41,7,TCCTACTTGAACAGACTCCT,34,3165556
rdlDp,0.625,11,7,TCCACCTACAATATCTAAGT,4,3185702
rdlDp,0.625,11,7,TCAGCCCGCGGTACATCCAT,4,3193374
rdlDp,0.5,10,7,TATTTGCGGTTAGTGTTGAA,3,3171850
rdlDp,0.5,10,7,TATTGGGACCTCAGTACCTT,3,3201128
rdlDp,0.75,12,7,TATCTTTCTTTCTCGGGTCT,5,3171208
rdlDp,2.375,25,7,TAGAGAGGAATCGCAAAGCA,18,3194572
rdlDp,0.625,11,7,TACGGTCGATGGTGGGCTCC,4,3189142
rdlDp,1.125,15,7,TACATTCAAGAAGAACTCGG,8,3199464
rdlDp,1.75,20,7,TACATCCACCGCGTCCGTAA,13,3210218
rdlDp,0.5,10,7,TACATAGCGGGCTCCAACCA,3,3186398
rdlDp,0.5,10,7,TACAGGACGTGAGTGAATGA,3,3188139
rdlDp,1.0,14,7,TACAGATGCCTTACATAGCG,7,3178514
rdlDp,0.875,13,7,TAATTTGGTCATCAGTAAAA,6,3196804
rdlDp,1.125,15,7,TAAACTCACAGTTATAGGAG,8,3179076
rdlDp,0.625,11,7,TAAAATTATAGGTACTGGAC,4,3210478
rdlDp,0.375,9,7,GTTTGCTTTCCAGGGTAATG,2,3179685
rdlDp,0.5,10,7,GTTACCTCAGTTACACGACA,3,3201783
rdlDp,4.5,42,7,GTGGCCCGGGGCATGGAAAT,35,3166349
rdlDp,1.0,14,7,GTGAGCAAACCAACAGGGAT,7,3166356
rdlDp,3.875,37,7,GTCTCATTGTTATTTGCCAT,30,3167188
rdlDp,3.75,36,7,GTATCCTACTATCTAGACTT,29,3194013
rdlDp,4.375,41,7,GTAGGTCTCAGGTTCATCAC,34,3181917
rdlDp,0.5,10,7,GTAATTCGACCCATCGTATT,3,3192119
rdlDp,1.125,15,7,GTAACTGTGGCCCCTAGCCT,8,3187096
rdlDp,0.375,9,7,GTAAAACCGAAAAGGCGTGC,2,3165134
rdlDp,0.375,9,7,GGGGGCAGGAGAGTGAATCG,2,3176719
rdlDp,1.375,17,7,GGCGCAGGCAAAATTTCATA,10,3193806
rdlDp,4.75,44,7,GGCCCTCTCTTTATTGGTGA,37,3202106
rdlDp,1.25,16,7,GGCAAGGAGTGTCTGACGGC,9,3215494
rdlDp,0.375,9,7,GGATGAATCAACGGGCATTG,2,3193373
rdlDp,2.25,24,7,GGATATAGATCGTCTACTAG,17,3184572
rdlDp,1.0,14,7,GCTCGGTATGCGTGATACCC,7,3182241
rdlDp,1.375,17,7,GCTAGCATCGGGTTTTACCT,10,3203596
rdlDp,0.875,13,7,GCTACAGTAACAGCCATCTA,6,3195463
rdlDp,1.75,20,7,GCGTTCCACCATAGTAGACC,13,3169413
rdlDp,1.625,19,7,GCGTAGATGTAGCGATGTAA,12,3172917
rdlDp,2.0,22,7,GCGCTTCCAGGGGGTCTGGT,15,3200742
rdlDp,3.25,32,7,GCGATGCGTGGCCAGATATT,25,3195101
rdlDp,6.75,60,7,GCCGGACCAGTTTGGGAGGG,53,3178815
rdlDp,0.375,9,7,GCCCCTCATGGACAAACAAC,2,3169987
rdlDp,0.375,9,7,GCCAGGACCTGAATGAGAGC,2,3184729
rdlDp,0.5,10,7,GCCAGCGTCGGTGAAAACGA,3,3197813
rdlDp,2.25,24,7,GCATCACGTAGCATAGAGAT,17,3172891
rdlDp,1.25,16,7,GCAGCACGGGGGCGCTGTGG,9,3189520
rdlDp,0.875,13,7,GCAGAAACCGCCCACACAGA,6,3193947
rdlDp,3.375,33,7,GATTATCGGACCCGGTTGGA,26,3202101
rdlDp,2.375,25,7,GATCGCCATGTTTGGAAGGA,18,3174423
rdlDp,1.0,14,7,GATCCTCTAGCGTCACTTCC,7,3179432
rdlDp,2.5,26,7,GATATACTCATAACTGTCCG,19,3206689
rdlDp,0.5,10,7,GAGCGGGGTGCCATCAGCCC,3,3198363
rdlDp,0.25,8,7,GAGAGGTCCAACAACACTCT,1,3214018
rdlDp,1.375,17,7,GAGAGCGCATAATGTTTGAA,10,3198818
rdlDp,2.75,28,7,CTTGTCCCCAGAGAGAAATG,21,3172233
rdlDp,0.5,10,7,CTGCGCCCCCAACTCAAAGG,3,3198511
rdlDp,1.5,18,7,CTCTCTTAATGCGTTAATGC,11,3197792
rdlDp,2.0,22,7,CTCGGAAGGGCTCGTTGATC,15,3177764
rdlDp,0.75,12,7,CTCGAATCACTTACAATGCT,5,3193822
rdlDp,0.5,10,7,CTCAGAGCGACAGTGAACTT,3,3184713
rdlDp,1.25,16,7,CTAGGACGCCAGCTTGTGGG,9,3190970
rdlDp,3.125,31,7,CTAGACACTCGATGGCTTGG,24,3211266
rdlDp,0.75,12,7,CTACAATCAAACGTACGTTG,5,3210326
rdlDp,0.5,10,7,CTAACTCCTCTCTGGTACAC,3,3210850
rdlDp,1.625,19,7,CGTGTGAGAAGGTTGAAACC,12,3181213
rdlDp,0.25,8,7,CGTGTCGGTATTCCGTGGTG,1,3201479
rdlDp,3.25,32,7,CGTCGGTGTGACCGAACTTA,25,3169318
rdlDp,0.75,12,7,CGTCACCTATGGGGAATTGT,5,3170394
rdlDp,2.75,28,7,CGTACTCCCAGGCGAAATGA,21,3210221
rdlDp,0.25,8,7,CGGGACTAATGCGCCAGTAA,1,3179573
rdlDp,2.875,29,7,CGAGGAGCACCTGGCTGCCT,22,3189844
rdlDp,0.75,12,7,CCTCTCACCGCCGCCCAGGC,5,3177527
rdlDp,1.125,15,7,CCTCGGATGAAGCTGCTCTC,8,3208551
rdlDp,0.875,13,7,CCGTTTAAGGGGTTCAAATA,6,3164990
rdlDp,0.5,10,7,CCGTCTCAGTAGGTTACAAC,3,3198925
rdlDp,1.75,20,7,CCGCGTTGAACCTAAGAGCT,13,3198171
rdlDp,0.5,10,7,CCCTGTGTGGGGCTTGACTA,3,3185466
rdlDp,1.875,21,7,CCCTAAATGCGAAAGGAAAC,14,3179531
rdlDp,6.75,60,7,CCCGGTGACCCGGACGATAC,53,3204854
rdlDp,3.125,31,7,CCCCAGCTCTAATCTGTTTG,24,3210884
rdlDp,3.125,31,7,CCATGGTTCATTCCTGATCT,24,3192010
rdlDp,1.625,19,7,CCATCCGAGAGTCCGTCCAC,12,3216111
rdlDp,0.5,10,7,CATTCTCTTATCGCCCTAAT,3,3173003
rdlDp,14.0,118,7,CATGGGGTGAGGGCGCGTTC,111,3166598
rdlDp,2.375,25,7,CATGCCAACGACAGATCGCT,18,3169747
rdlDp,2.0,22,7,CATCTCTCGAGTCCGGCTAT,15,3184610
rdlDp,0.5,10,7,CAGTCACTATTATCTGTTTG,3,3169401
rdlDp,0.5,10,7,CAGCGGTCCTAGACGTGCCT,3,3171475
rdlDp,0.5,10,7,CACAGACTAGAATCTGTGGA,3,3199784
rdlDp,2.125,23,7,ATTTGGCAATGGGAAAGGTC,16,3172371
rdlDp,1.0,14,7,ATTACACTCGATATAGAGGC,7,3205028
rdlDp,2.5,26,7,ATGTTTCTGCTGCGTGACGA,19,3170070
rdlDp,0.875,13,7,ATGCTACCAGTGACGGGAAG,6,3205315
rdlDp,1.125,15,7,ATGCAAACTCTTGCGCAAAA,8,3185795
rdlDp,1.875,21,7,ATCTCCATTCTTGGCGTCCT,14,3193654
rdlDp,3.875,37,7,ATCTAGGCACCTGGATATTC,30,3208305
rdlDp,3.125,31,7,ATATGTGAAAGGGCACGCCA,24,3189677
rdlDp,0.625,11,7,ATATCTGGGGCGAGTCAGGC,4,3205511
rdlDp,2.625,27,7,ATACGCCCGATGTGCATAGT,20,3191314
rdlDp,1.75,20,7,ATACCAACATCAATCCTGGT,13,3165953
rdlDp,5.25,48,7,ATACATCGCGCCGCTATCCT,41,3209167
rdlDp,0.5,10,7,ATAAGCTCAGGCACACTAAG,3,3214843
rdlDp,0.5,10,7,AGTCCAGTCTAACGTCTGAC,3,3185696
rdlDp,3.0,30,7,AGGTCCTCCAGGACGCTGCT,23,3214299
rdlDp,4.0,38,7,AGGCTGGTAGTAGATAGCTG,31,3192315
rdlDp,3.375,33,7,AGGCCACGGCTCCCCAATCC,26,3179072
rdlDp,0.75,12,7,AGGCAGGTGGCGTGAATATC,5,3165916
rdlDp,1.75,20,7,AGGAGCCGCACCGAAGAATC,13,3180852
rdlDp,2.75,28,7,AGCGGCAAGTACGGCAGGAC,21,3206992
rdlDp,1.75,20,7,AGATTCGGCCGGTTCACTTA,13,3167417
rdlDp,2.5,26,7,AGATGTTTGGTGCTCAGAAA,19,3176761
rdlDp,2.0,22,7,ACTTTTCATCGCACACGTCA,15,3182144
rdlDp,2.125,23,7,ACTCTTTAGTTGAGTCGGCC,16,3186670
rdlDp,1.875,21,7,ACTAAGTGTGGCGGGGCGGC,14,3169094
rdlDp,0.75,12,7,ACGGGCTGGACGACATCTGT,5,3202123
rdlDp,2.25,24,7,ACGGCGCCTCTCTCACCGGT,17,3211400
rdlDp,1.375,17,7,ACGGCATATGCTTCTATCAT,10,3176494
rdlDp,1.875,21,7,ACGGAAATCCTCCCACATCT,14,3197653
rdlDp,0.25,8,7,ACGCTTGTATTAAAAGGTGC,1,3165284
rdlDp,2.75,28,7,ACGAGGCCAACCATACAATG,21,3204347
rdlDp,0.625,11,7,ACGAGCTGTTAAATAGTGAC,4,3208956
rdlDp,1.125,15,7,ACGAACAACTTGCCTCGGCG,8,3191660
rdlDp,2.625,27,7,ACCACTGAGTGGAGGAATAA,20,3187679
rdlDp,4.125,39,7,ACCAACGCGCAAGTACGCTC,32,3192609
rdlDp,2.75,28,7,ACAGTTAGTACGTTTCGAGT,21,3188098
rdlDp,0.5,10,7,ACAGACGCCATCCTGTGGAG,3,3202929
rdlDp,0.75,12,7,AATGTTGTTTAGTTAAACAT,5,3195152
rdlDp,6.25,56,7,AATCCACCTGGGAGAAGTAT,49,3181705
rdlDp,1.0,14,7,AAGCCTGCAATACTCTTTTG,7,3192965
rdlDp,0.25,8,7,AACATAAAGGAGTACATCGG,1,3209794
rdlDp,2.125,23,7,AAAGGTAAATGCCACGCAAC,16,3198449
rdlDp,1.0,14,7,AAAGGGCGAAACACAAGCGA,7,3207635
rdlDp,0.625,11,7,AAAACTGCCGGATGACTTTT,4,3210914
rdlDp,0.2857142857142857,7,6,TTTCGGTGATATAGATTTTT,1,3216143
rdlDp,0.7142857142857143,10,6,TTTATTATTGGGTGTTAGGA,4,3196187
rdlDp,0.7142857142857143,10,6,TTGTCAGCCTCGACCTGTGC,4,3195374
rdlDp,2.142857142857143,20,6,TTGTAATGCAGCCATTCCGT,14,3165936
rdlDp,0.8571428571428571,11,6,TTGAGTTAGCTAGATCTGGA,5,3173182
rdlDp,1.1428571428571428,13,6,TTGAGAGGGGTTGAGTGGAT,7,3210117
rdlDp,1.4285714285714286,15,6,TTGAACACCCCACAAGGAGA,9,3184546
rdlDp,1.5714285714285714,16,6,TTCGACGTATCATTTTTACA,10,3209866
rdlDp,9.714285714285714,73,6,TTCATACCAGCCCACTTAAA,67,3192017
rdlDp,1.5714285714285714,16,6,TTATGTATTGATAACGTGGG,10,3179158
rdlDp,5.428571428571429,43,6,TTAGAACCACCGCATGCATA,37,3179323
rdlDp,2.2857142857142856,21,6,TTAAGGCCCGAATGGTAAGT,15,3172915
rdlDp,0.2857142857142857,7,6,TTAAAAACCCTGCCTATCGT,1,3208942
rdlDp,0.8571428571428571,11,6,TGTCGGTGAGGACGTGTGAA,5,3203763
rdlDp,2.5714285714285716,23,6,TGTCAATCTTTGCGCGCGTG,17,3203665
rdlDp,1.0,12,6,TGGTGGGTATTCCTTGTGAG,6,3168122
rdlDp,6.0,47,6,TGGTGCTCATAGTTGCGAGG,41,3169388
rdlDp,1.0,12,6,TGGTCGTTGAGGCATGGCTG,6,3168127
rdlDp,8.857142857142858,67,6,TGCTTTGTGGCGACTAGAGG,61,3203262
rdlDp,2.0,19,6,TGCGCCGGTGGGAACCTCGT,13,3197804
rdlDp,1.1428571428571428,13,6,TGATCGCCATAGGCCCGTCT,7,3175575
rdlDp,0.7142857142857143,10,6,TGATCACCGAGCCATCCGCT,4,3184434
rdlDp,1.4285714285714286,15,6,TGACTGGAAGCGGGGGTAAG,9,3193809
rdlDp,1.2857142857142858,14,6,TGAAACCCGTGAGTACTCAC,8,3214325
rdlDp,1.2857142857142858,14,6,TCTGGATACCGGAGTCATTG,8,3212048
rdlDp,2.857142857142857,25,6,TCTGAGTAACCACTATTACA,19,3182462
rdlDp,2.7142857142857144,24,6,TCGTCTCGCCCGTGATAGTA,18,3181881
rdlDp,4.0,33,6,TCGACGAGCCTCGGGATTTT,27,3181887
rdlDp,3.142857142857143,27,6,TCCGGTCAGAAATACAGTGC,21,3201662
rdlDp,1.1428571428571428,13,6,TCCGACTCAAGAAGCCTGAC,7,3204361
rdlDp,1.1428571428571428,13,6,TCATCCGAAATCTCATCCGG,7,3212449
rdlDp,7.428571428571429,57,6,TATGTTCGGACCAATAAGCA,51,3198362
rdlDp,0.2857142857142857,7,6,TATAGATCGTGCTCGGTCCC,1,3211832
rdlDp,3.0,26,6,TAGCTTAGCACACGACGGCA,20,3181554
rdlDp,1.1428571428571428,13,6,TAGCGCGGCCAAAGCAGGGA,7,3181527
rdlDp,0.2857142857142857,7,6,TACGTTGTTCAAGCTCGTTG,1,3171202
rdlDp,5.0,40,6,TACGTACCCTCCACCGCGGT,34,3212460
rdlDp,1.1428571428571428,13,6,TACCCAAAGCCCTTGAGGGA,7,3205584
rdlDp,2.0,19,6,TAAGTGTTCGTCGAGCTTGG,13,3180649
rdlDp,17.0,124,6,TAAAGGAGGCACGCCCCTCA,118,3196433
rdlDp,6.428571428571429,50,6,GTTAAGCGGTTGAGCGGTGC,44,3211396
rdlDp,1.8571428571428572,18,6,GTGGCATTCGGTACGTGACC,12,3181882
rdlDp,3.5714285714285716,30,6,GTGGACGGCGGAACTCCAAT,24,3175565
rdlDp,1.0,12,6,GTGCCACCTTTGGAGCTCCG,6,3203590
rdlDp,2.857142857142857,25,6,GTGACTGTATATTCGCTTTA,19,3198868
rdlDp,1.1428571428571428,13,6,GTCTCATTCCCTACATTTCA,7,3210344
rdlDp,4.142857142857143,34,6,GTCGCCTAATTAAGCTCGGT,28,3204239
rdlDp,2.5714285714285716,23,6,GTCGAACGCCTCACCACAGG,17,3168129
rdlDp,0.8571428571428571,11,6,GTATTAACGCTTCCAACACT,5,3211208
rdlDp,1.0,12,6,GTAGTTGCCCGCCAATATTC,6,3176927
rdlDp,1.7142857142857142,17,6,GTACGTGACTATGTCTTAGT,11,3193013
rdlDp,2.2857142857142856,21,6,GTACCGCGTTAATACTCGTA,15,3181654
rdlDp,2.7142857142857144,24,6,GGTTAGACCGTCCTTACACA,18,3171203
rdlDp,1.8571428571428572,18,6,GGTAATATTAGCTGGGAACA,12,3180764
rdlDp,3.142857142857143,27,6,GGGTCGAGACCTGCACAGTT,21,3213600
rdlDp,1.0,12,6,GGGGAAAGACAAGTTCTATA,6,3176650
rdlDp,1.5714285714285714,16,6,GGGACGCCTAGCAGCGTGCC,10,3179683
rdlDp,0.42857142857142855,8,6,GGCTCCACTGGCCTATCTCA,2,3196930
rdlDp,0.5714285714285714,9,6,GGCGTATCGGGCACCCACTG,3,3174960
rdlDp,0.8571428571428571,11,6,GGCCGCACTGTTTTAGACCA,5,3207638
rdlDp,0.2857142857142857,7,6,GGCACGAGAGCTCTACTACC,1,3171191
rdlDp,1.0,12,6,GGACTGCTTATTCGTGTTCT,6,3168902
rdlDp,0.2857142857142857,7,6,GCTTGAGCCCCAACCTACTG,1,3183271
rdlDp,3.7142857142857144,31,6,GCTTCTTGATAGATGCCCAG,25,3198657
rdlDp,3.2857142857142856,28,6,GCTCCCAAGTCAAGCGTCCA,22,3208506
rdlDp,0.42857142857142855,8,6,GCGTAAGGGCGCAAGAGAGC,2,3201931
rdlDp,0.42857142857142855,8,6,GCGGTCCTATAGCAGGGAGA,2,3205908
rdlDp,0.42857142857142855,8,6,GCCTTAGGAGGGGGGCGCTT,2,3201825
rdlDp,5.714285714285714,45,6,GCCTACCTACTGTATATGGA,39,3198441
rdlDp,1.4285714285714286,15,6,GCCGTGTTAGGGCGTACGAG,9,3188770
rdlDp,2.0,19,6,GCCCGTCCGAATCCTCCGTA,13,3178071
rdlDp,1.4285714285714286,15,6,GCATCTCGGGCCACACTCAA,9,3181035
rdlDp,1.4285714285714286,15,6,GCAGAGGAATATTTGTGTGA,9,3187461
rdlDp,0.5714285714285714,9,6,GCAAGTTATGGCCACGTCTG,3,3180848
rdlDp,3.7142857142857144,31,6,GATCCGCGGCGTCTATGGTT,25,3194132
rdlDp,0.42857142857142855,8,6,GATCAGCAGAACGCGGAAGT,2,3202967
rdlDp,2.857142857142857,25,6,GATAGCATTTTAAATTGATG,19,3207384
rdlDp,1.7142857142857142,17,6,GAGTACCTGACGTACGCGAA,11,3188358
rdlDp,2.2857142857142856,21,6,GAGCTTACACTCCCAGGATA,15,3191556
rdlDp,0.2857142857142857,7,6,GAGACGCGTTAATTTACTAA,1,3209202
rdlDp,1.2857142857142858,14,6,GACTGCGTCCATCCTCGTGT,8,3196191
rdlDp,0.8571428571428571,11,6,GACGGTGGTCCTTAACCGGA,5,3196274
rdlDp,1.4285714285714286,15,6,GACCGCAATTGGGGTCACTT,9,3210563
rdlDp,2.7142857142857144,24,6,GACCACGACGTACATAGCCT,18,3191056
rdlDp,2.142857142857143,20,6,CTTATACGTCTACGCATACC,14,3190850
rdlDp,1.4285714285714286,15,6,CTTAGGAGGTAGCTACTGAA,9,3173754
rdlDp,1.5714285714285714,16,6,CTGGGCCACTGAGCCTCGGC,10,3181022
rdlDp,1.5714285714285714,16,6,CTGCACTCGAATATGCACCC,10,3200140
rdlDp,0.8571428571428571,11,6,CTCTATTGGTAGTGCAAAAT,5,3199329
rdlDp,1.7142857142857142,17,6,CTCTAACTATAAGCGCTATT,11,3192922
rdlDp,2.2857142857142856,21,6,CTCATACCAAGGGACGAAGT,15,3174925
rdlDp,4.857142857142857,39,6,CTAGCACATCCTTAAGAAGC,33,3198437
rdlDp,0.7142857142857143,10,6,CTAAGTATTTGACACCTCCT,4,3177088
rdlDp,1.8571428571428572,18,6,CGTTACGTTCTATATTAGTG,12,3179508
rdlDp,0.8571428571428571,11,6,CGTCTCGATCTATTAACGTG,5,3182434
rdlDp,0.8571428571428571,11,6,CGGCTCTCCCTTTTTACGGA,5,3185054
rdlDp,0.7142857142857143,10,6,CGGCTCTCAAAAGGAACACT,4,3179074
rdlDp,2.142857142857143,20,6,CGGCCTCGGGAATGTCATAA,14,3175834
rdlDp,0.7142857142857143,10,6,CGGACTACTGAAACTTTGCT,4,3208639
rdlDp,0.5714285714285714,9,6,CGCTTAACGGTCTTCCGATG,3,3197298
rdlDp,6.428571428571429,50,6,CGCTGTAAGAATATGATGTG,44,3216136
rdlDp,0.2857142857142857,7,6,CGCGTTAGTAATTGCGGGTC,1,3207670
rdlDp,2.0,19,6,CGCCCTACTTACTTACCTCG,13,3179039
rdlDp,1.4285714285714286,15,6,CGATCGAGCCCCTGAAAAAT,9,3192742
rdlDp,3.5714285714285716,30,6,CGACTGAGGATTCTAAGACA,24,3176759
rdlDp,1.5714285714285714,16,6,CGACATGGAGACTAGCAGCC,10,3215313
rdlDp,3.142857142857143,27,6,CCTGTAACGGGTGGAGGTAA,21,3191696
rdlDp,0.2857142857142857,7,6,CCTCACGAAAGTATAGTTAG,1,3209003
rdlDp,3.142857142857143,27,6,CCTAATAGTGTGGGAAAGCA,21,3215020
rdlDp,1.8571428571428572,18,6,CCGTTGGATTCTTCTCACGA,12,3182425
rdlDp,0.8571428571428571,11,6,CCGGAGGTCCGGTTGTCTTA,5,3197781
rdlDp,0.2857142857142857,7,6,CCGCGCCAGACGTTATGGCG,1,3166583
rdlDp,3.4285714285714284,29,6,CCGCGATAGCGTGACTTGTT,23,3201089
rdlDp,2.142857142857143,20,6,CCGACAGACCCTACCGGTGA,14,3196269
rdlDp,2.857142857142857,25,6,CCCTCGGGCGTACAGGACCG,19,3212531
rdlDp,1.2857142857142858,14,6,CCCAATGTGCACCTGGAGAT,8,3215785
rdlDp,1.1428571428571428,13,6,CCATATCTAGAAGAGCAATC,7,3169084
rdlDp,0.2857142857142857,7,6,CCAGATAAAATTAACGGGGG,1,3197113
rdlDp,0.8571428571428571,11,6,CATTTCCAAAACGAGTACCC,5,3195523
rdlDp,3.2857142857142856,28,6,CATTGAAGAAATTATCCTCC,22,3200176
rdlDp,0.7142857142857143,10,6,CAGTTGCCATTTAATCTAAC,4,3177160
rdlDp,0.5714285714285714,9,6,CAGTTGAAGGTCGGAACTTG,3,3174520
rdlDp,2.4285714285714284,22,6,CACTCGCGTGATTGTGCTAA,16,3191671
rdlDp,1.4285714285714286,15,6,CACCCACCAAACAAGGCTGG,9,3200800
rdlDp,0.5714285714285714,9,6,CAAAGCTCCTTGCCTGCTTT,3,3203673
rdlDp,1.4285714285714286,15,6,CAAAAGATGGCACTTTAAGT,9,3215788
rdlDp,1.5714285714285714,16,6,ATTTTCAGCACTGCTGGTAT,10,3202473
rdlDp,5.571428571428571,44,6,ATTGTCCCATCTAGAAGAAG,38,3173841
rdlDp,0.42857142857142855,8,6,ATTCCCGTGTGGTGACAAAA,2,3209698
rdlDp,1.4285714285714286,15,6,ATTCCACGCAGTCTGCGCCC,9,3187396
rdlDp,0.5714285714285714,9,6,ATTATCTAAATAAAATATTG,3,3197800
rdlDp,3.2857142857142856,28,6,ATGTTAAGCCTTACACTGTC,22,3180419
rdlDp,0.42857142857142855,8,6,ATGTAGACAAGCGGCAATGG,2,3169083
rdlDp,1.1428571428571428,13,6,ATGCTGGAAGAGATGGATGC,7,3197829
rdlDp,1.8571428571428572,18,6,ATGACAAAGAAGGTCGGACG,12,3214166
rdlDp,0.5714285714285714,9,6,ATCTGGCAGAGGTCCGCGCG,3,3201838
rdlDp,1.1428571428571428,13,6,ATCCCACGGCTTCTCTGGAT,7,3164529
rdlDp,4.857142857142857,39,6,ATCACGGGGATGTACATAGG,33,3201671
rdlDp,1.7142857142857142,17,6,ATACAGTATTACGTGTATCG,11,3203785
rdlDp,4.571428571428571,37,6,ATAAATCAGGTTTAGACCTC,31,3190906
rdlDp,15.571428571428571,114,6,ATAAAGGGCCGTTTGCGCGA,108,3186134
rdlDp,1.0,12,6,ATAAACGTAACTTGGACCTG,6,3189582
rdlDp,0.2857142857142857,7,6,AGTCGGGTTTGGACCTGCTC,1,3180413
rdlDp,0.2857142857142857,7,6,AGGTTTTATTCATACGCTTT,1,3195649
rdlDp,0.5714285714285714,9,6,AGGGGGTGGGGTAGACGGAC,3,3211245
rdlDp,1.8571428571428572,18,6,AGCTCATGGGATTCAACGTT,12,3185126
rdlDp,0.5714285714285714,9,6,AGCGCTACTTATGGCCAGGG,3,3166708
rdlDp,0.7142857142857143,10,6,AGCCGGAAATCGCGGGCTTG,4,3165146
rdlDp,3.2857142857142856,28,6,AGCATCCGTTTCAGAGAGGG,22,3200810
rdlDp,3.4285714285714284,29,6,AGAGGTCAACGAGGGTCAGT,23,3199093
rdlDp,4.428571428571429,36,6,ACTGGATCTGCCGGACGCGG,30,3176748
rdlDp,0.8571428571428571,11,6,ACTGCGGGAACCTTATTAAC,5,3207382
rdlDp,7.0,54,6,ACTAATCAAACGGCGGGATG,48,3208793
rdlDp,0.42857142857142855,8,6,ACGTTTATGCTTCATCTGAT,2,3206772
rdlDp,0.5714285714285714,9,6,ACGGCCGTCCCGATGATCGG,3,3195166
rdlDp,0.42857142857142855,8,6,ACGGCCATCGCATACCTGCC,2,3210873
rdlDp,1.7142857142857142,17,6,ACGCTTGGCAAGTGGGTGGC,11,3201533
rdlDp,0.42857142857142855,8,6,ACGCATTGACACCTCAGCGC,2,3195939
rdlDp,2.4285714285714284,22,6,ACGCAGGGCACGCGCTGCCG,16,3201153
rdlDp,5.571428571428571,44,6,ACCGCCGCAGAATAACAGTA,38,3172890
rdlDp,2.2857142857142856,21,6,ACCCACAGGACCACTTTAAT,15,3181543
rdlDp,0.5714285714285714,9,6,AATTCGAAGGCCAGCTGAAC,3,3176875
rdlDp,0.2857142857142857,7,6,AATCTCCATGTGTTTATCTT,1,3183993
rdlDp,0.8571428571428571,11,6,AACGTCCCGAGATCAGGCGA,5,3178061
rdlDp,1.0,12,6,AACCTCGGCTGTTTATTTAC,6,3178389
rdlDp,4.285714285714286,35,6,AACAGGTGCCAGACGGGAAA,29,3206039
rdlDp,0.2857142857142857,7,6,AAAGACAGGGCATGTTATCC,1,3191055
rdlDp,2.4285714285714284,22,6,AAACAATGCAACTCCTTCTT,16,3200043
rdlDp,2.0,19,6,AAAATAGGCGGTTACATCTG,13,3177558
rdlDp,0.3333333333333333,6,5,TTTTCATATCATTCGCAAAC,1,3198468
rdlDp,0.3333333333333333,6,5,TTTATGGCACCATCAGGCCC,1,3190731
rdlDp,8.5,55,5,TTGCAGCATGCGAATGCAAC,50,3185700
rdlDp,1.3333333333333333,12,5,TTGAAAATAGGAAACCGCCC,7,3168641
rdlDp,0.8333333333333334,9,5,TTCCATTTGACCATACCTCA,4,3201082
rdlDp,0.6666666666666666,8,5,TTATAGTGCAGCTCAGTACT,3,3179533
rdlDp,7.0,46,5,TTACGATTACTCCTCTAAGG,41,3179183
rdlDp,2.0,16,5,TTAAAAACCTACCATCCAAC,11,3203713
rdlDp,1.0,10,5,TGTGGGTATGTAGGCGCACA,5,3171552
rdlDp,1.0,10,5,TGTCTAAGAAGAACACTATG,5,3195556
rdlDp,12.833333333333334,81,5,TGTCAATCTGAGGCTGAATC,76,3178386
rdlDp,3.8333333333333335,27,5,TGGTAGGCCGATCCAGATGC,22,3188699
rdlDp,4.833333333333333,33,5,TGGGGATTTCAAACCTCCAG,28,3194205
rdlDp,1.5,13,5,TGGCTCTTAAAACGGCGCAA,8,3173491
rdlDp,0.3333333333333333,6,5,TGGCCGATTGGCACTGTTTG,1,3173839
rdlDp,1.5,13,5,TGGCACAGCCTATATGATAT,8,3201100
rdlDp,0.8333333333333334,9,5,TGGCAATAGCGCCTGATGTG,4,3199459
rdlDp,1.5,13,5,TGCTCTCACTCACTCATGAG,8,3206950
rdlDp,0.5,7,5,TGCCGCTCCAAACCATTCAC,2,3181478
rdlDp,4.666666666666667,32,5,TGATAGGGCGGTGATGTGCT,27,3201077
rdlDp,3.5,25,5,TGATAAATCCTGTCGATTTC,20,3179190
rdlDp,0.5,7,5,TGAGCAGAGGTTCATACGAA,2,3191820
rdlDp,2.0,16,5,TGACGTAGTGCCTCCTGCAG,11,3193943
rdlDp,1.8333333333333333,15,5,TCTGACACAGAACTATCGGA,10,3204966
rdlDp,0.6666666666666666,8,5,TCTACTGTTGGGAGACACCA,3,3180044
rdlDp,0.3333333333333333,6,5,TCGTTGGCTACATGAACCAA,1,3181984
rdlDp,0.5,7,5,TCGTGATATCTTGTGTCCAG,2,3176766
rdlDp,0.8333333333333334,9,5,TCGACCAGCAGGAATCGAGC,4,3176707
rdlDp,0.5,7,5,TCCGGGAACCGAGAGTGCAA,2,3190517
rdlDp,3.5,25,5,TCCGCCTCGCTCAAACGGTG,20,3171502
rdlDp,1.8333333333333333,15,5,TCCCGTGCCGGGGTGTTAGA,10,3203715
rdlDp,2.1666666666666665,17,5,TCCACCAATCGATTATTTGG,12,3201654
rdlDp,1.0,10,5,TCATTTCGGCTTATTGTATC,5,3200758
rdlDp,3.3333333333333335,24,5,TCATAGTTCGTTTGCAGAGC,19,3182174
rdlDp,1.0,10,5,TCAGTCAGTTCACTGATATA,5,3209684
rdlDp,3.0,22,5,TCAAGCAGCCTATTGTATGT,17,3171247
rdlDp,1.8333333333333333,15,5,TATTCGCTGCAATGAACAAC,10,3188836
rdlDp,0.3333333333333333,6,5,TAGTTTAAACCATATATAAG,1,3199857
rdlDp,0.8333333333333334,9,5,TACCCGATTTTACATTCACT,4,3164978
rdlDp,0.6666666666666666,8,5,TAATTGGCTTGCCGTATGGT,3,3195996
rdlDp,1.1666666666666667,11,5,TAATGTTATTGACCCGCCCG,6,3188323
rdlDp,1.0,10,5,TAATCATCCCGGTGGGCTGG,5,3166914
rdlDp,0.6666666666666666,8,5,GTTCGAGACTCCAGAGACAC,3,3202660
rdlDp,5.5,37,5,GTTAGGTATCCGTAGGTTAA,32,3194448
rdlDp,2.1666666666666665,17,5,GTGTGGTCCGCAGTCTGTTT,12,3189604
rdlDp,9.166666666666666,59,5,GTGTGCTGCACCGTACACCG,54,3210219
rdlDp,0.5,7,5,GTGGGGTCTACATATGGTGA,2,3204352
rdlDp,3.0,22,5,GTGGATCGAATTGTCACTCT,17,3178265
rdlDp,1.8333333333333333,15,5,GTGCATAACACAGGGACTAA,10,3169436
rdlDp,0.3333333333333333,6,5,GTGCAAATATATGTGAAGCA,1,3184966
rdlDp,9.166666666666666,59,5,GTGAGGCACAGTAGTTAGCA,54,3189767
rdlDp,0.8333333333333334,9,5,GTGACGTCCCTGCTAAGTTT,4,3203558
rdlDp,1.1666666666666667,11,5,GTCTGACCCGTCAATGCTTG,6,3172134
rdlDp,2.3333333333333335,18,5,GTCTCAGCGCACTCGCCTGC,13,3188947
rdlDp,0.6666666666666666,8,5,GTCCGAGCGTTGCAGAGCTA,3,3191003
rdlDp,1.0,10,5,GTCACCAATTTTCATTTAGG,5,3192021
rdlDp,0.8333333333333334,9,5,GTCACAGCTGTTTCCTCGTT,4,3168790
rdlDp,0.8333333333333334,9,5,GTCAAATGAAAAGCCTGTGA,4,3198684
rdlDp,2.3333333333333335,18,5,GTATCGGGGTTAAAGCAGGC,13,3169383
rdlDp,2.0,16,5,GTAGTCCTGGAGCTTTATTG,11,3166114
rdlDp,2.5,19,5,GTAGCATAGTCCAGGATACA,14,3188856
rdlDp,1.0,10,5,GTACCCCACCGAGGACTTAC,5,3209011
rdlDp,2.1666666666666665,17,5,GTAATGCGGGAGGTAACTCA,12,3203597
rdlDp,0.3333333333333333,6,5,GGTTCGCCGTCATTTAGTTC,1,3173181
rdlDp,3.0,22,5,GGGCCTGAAGCCTAGTGCTC,17,3171097
rdlDp,1.0,10,5,GGGAATGTGTCTAGTGCCTA,5,3215783
rdlDp,3.0,22,5,GGCTCTACACGTCTAGACGC,17,3205323
rdlDp,1.5,13,5,GGCGTTATCCGAAGCATACA,8,3207935
rdlDp,23.0,142,5,GGCGGCGGAACGCACGTAAT,137,3193594
rdlDp,1.1666666666666667,11,5,GGCCTTACTCCGTACCAAAT,6,3180050
rdlDp,2.5,19,5,GGCAGTAGTAGGACTGCAAC,14,3173328
rdlDp,1.6666666666666667,14,5,GGCACTCACGCTAGATTCTC,9,3207090
rdlDp,3.1666666666666665,23,5,GGACCGGGGTTATTATTGCG,18,3174634
rdlDp,2.6666666666666665,20,5,GGAACCGCACAAGAGCTGTG,15,3192002
rdlDp,2.1666666666666665,17,5,GGAAAGTACAACGAATTCCA,12,3172895
rdlDp,2.8333333333333335,21,5,GCTGTTTATGGATTGGTACT,16,3181919
rdlDp,1.3333333333333333,12,5,GCTGTGTATGTAACGGCGGA,7,3206028
rdlDp,0.3333333333333333,6,5,GCTATATACGTAACCGGCGG,1,3182479
rdlDp,2.1666666666666665,17,5,GCTAACTCGTACCCACAGGC,12,3198923
rdlDp,25.0,154,5,GCGTTCAAGCAACTGCTCGG,149,3212785
rdlDp,2.0,16,5,GCGTGTTTCATAGGGTCAGC,11,3207572
rdlDp,1.6666666666666667,14,5,GCGTCTCGGTTGCGCGCCAA,9,3187931
rdlDp,0.3333333333333333,6,5,GCGCCCCGTGGTTCGCTCCC,1,3173178
rdlDp,1.0,10,5,GCGAGCCTGCCCTGACACTC,5,3194149
rdlDp,1.5,13,5,GCCTATGCGGGAGCCAATGC,8,3208429
rdlDp,7.166666666666667,47,5,GCCGTCCTTAAGTAACTACA,42,3193598
rdlDp,0.5,7,5,GCACTCTGTACCAGATTGTA,2,3198031
rdlDp,2.0,16,5,GCACGCGCCTGTTGAGGTTC,11,3193278
rdlDp,0.8333333333333334,9,5,GCACAGATTCGTGTGCGCGT,4,3197904
rdlDp,0.3333333333333333,6,5,GCAAAAATACACGTTCGTAG,1,3175611
rdlDp,1.1666666666666667,11,5,GATTCGATTATAGCTACGGA,6,3187089
rdlDp,0.3333333333333333,6,5,GATTCGAGCGAAGAAACGTT,1,3179164
rdlDp,0.8333333333333334,9,5,GAGTTTTCGTGGTTCACAGA,4,3165933
rdlDp,1.0,10,5,GAGGAATTGCAGAAATTTCA,5,3169501
rdlDp,3.0,22,5,GAGCCTCGAGTGTGCACCTA,17,3177109
rdlDp,3.3333333333333335,24,5,GAGATGAAGTGGTACCTAAG,19,3198469
rdlDp,0.5,7,5,GACTGCGAGTAATGAATTAA,2,3170866
rdlDp,0.5,7,5,GACGGATCTGATGTCTACTG,2,3205838
rdlDp,1.1666666666666667,11,5,GACGATGCGGATCAAAATAA,6,3165860
rdlDp,1.6666666666666667,14,5,CTTGGGTCTCACGATGAAGG,9,3194097
rdlDp,0.3333333333333333,6,5,CTTCTGAGTGGGGTGCTGAC,1,3210839
rdlDp,2.0,16,5,CTTCCCAGACGTGACAGAGA,11,3201678
rdlDp,0.6666666666666666,8,5,CTGTCGTAGTCGCGTGTCTA,3,3184715
rdlDp,0.5,7,5,CTGTCCTTTGGTATGGGTAG,2,3200661
rdlDp,2.0,16,5,CTCTGACTCTCGGCGTTCAA,11,3164527
rdlDp,5.0,34,5,CTCGGTATTCGGTTTACGGT,29,3183786
rdlDp,1.5,13,5,CTCGCGGGCCACCTTTGCCA,8,3197841
rdlDp,4.166666666666667,29,5,CTCCTTCAATGTAAACCGTA,24,3186315
rdlDp,4.0,28,5,CTCAACTGCCAACCTATTAG,23,3192858
rdlDp,0.6666666666666666,8,5,CTACGGGTTACCGGTGAAGG,3,3171957
rdlDp,0.5,7,5,CTAACTCGATATAGCTTAAG,2,3181307
rdlDp,0.3333333333333333,6,5,CTAAACTAATTGCAAGTTGG,1,3181715
rdlDp,0.3333333333333333,6,5,CTAAAACCAGAGACCCCTTA,1,3176265
rdlDp,0.5,7,5,CGTTACTACCGCCCTCAACG,2,3182497
rdlDp,1.1666666666666667,11,5,CGTGTCGCGTTCCATAGTTA,6,3165477
rdlDp,0.5,7,5,CGTGATGAGGTTTGATGTTG,2,3196393
rdlDp,0.6666666666666666,8,5,CGTGAATGTCTACGTTGCCC,3,3181534
rdlDp,5.333333333333333,36,5,CGTAGCCTCCGCCCGAGCGT,31,3183970
rdlDp,0.6666666666666666,8,5,CGGCGTCGCTCGAGCTTCAC,3,3167171
rdlDp,3.0,22,5,CGCAAGGCTCAAAAAGCTCA,17,3194610
rdlDp,0.3333333333333333,6,5,CGATTGGAGCTGTAATCTTT,1,3201421
rdlDp,0.8333333333333334,9,5,CGAATGTACACTGGATAAAA,4,3209691
rdlDp,1.0,10,5,CCTTGTATCAAGATTGGGGG,5,3186190
rdlDp,0.8333333333333334,9,5,CCTTAATCAGGGGTGACCGC,4,3209486
rdlDp,1.3333333333333333,12,5,CCTACGGGGGGATCGCTGTT,7,3197695
rdlDp,0.5,7,5,CCTAAAGGCTCTTTCATAAC,2,3201942
rdlDp,2.3333333333333335,18,5,CCGTTGTCAGGCATGGGGTG,13,3190911
rdlDp,0.6666666666666666,8,5,CCGTGCGCGTACGGGATAAA,3,3188775
rdlDp,0.6666666666666666,8,5,CCGGTCTGGGCATAGAGGCT,3,3178142
rdlDp,1.1666666666666667,11,5,CCGGCATTTGTACCTGTGAA,6,3205988
rdlDp,2.3333333333333335,18,5,CCGCCCGCGGACCTAATGTG,13,3180106
rdlDp,2.5,19,5,CCGACTAAATGAGTCTTTAG,14,3192014
rdlDp,0.8333333333333334,9,5,CCCTTCGTGGTAATCGGACG,4,3206645
rdlDp,1.0,10,5,CCCTCCGTATTGGGAACCAT,5,3181537
rdlDp,17.5,109,5,CCCGGATTAGACCTTTGAGA,104,3193614
rdlDp,0.3333333333333333,6,5,CCCGCCCCTTGTATAAACCT,1,3179099
rdlDp,5.833333333333333,39,5,CCCCAGGTGATGGTCAGGAC,34,3215955
rdlDp,2.5,19,5,CCCATGTGCCGGAGGCGTGC,14,3193376
rdlDp,2.5,19,5,CCATCACCAATGTCATTTCC,14,3192592
rdlDp,0.3333333333333333,6,5,CCATCAAACGAGTAGTGACA,1,3206570
rdlDp,0.6666666666666666,8,5,CATTGCAATCACTTATCGAT,3,3208195
rdlDp,0.6666666666666666,8,5,CATGTCTCGAATGCCTTACT,3,3191376
rdlDp,1.6666666666666667,14,5,CATGGAGATCGATGTTATGT,9,3175959
rdlDp,3.1666666666666665,23,5,CATCCGCGTTCATACCTTAG,18,3183623
rdlDp,4.0,28,5,CATATGTTGGTTTTTACCTT,23,3165544
rdlDp,2.3333333333333335,18,5,CAGTCGAGATCAGAACATCA,13,3204850
rdlDp,1.8333333333333333,15,5,CAGTCACTATTATTGCTGGG,10,3172232
rdlDp,1.6666666666666667,14,5,CAGCTGGGATTCACGGTATC,9,3192422
rdlDp,2.1666666666666665,17,5,CACTAAGTTCGATGGGGCAG,12,3196206
rdlDp,0.6666666666666666,8,5,CACCCAGGAATTGAATGTCT,3,3191021
rdlDp,0.8333333333333334,9,5,CACCATCGGTCGTTCTGGGT,4,3175988
rdlDp,0.3333333333333333,6,5,CAAACATCTAAGGGGTCCGA,1,3207640
rdlDp,1.5,13,5,ATTTCTCGTGACTTCCTCAG,8,3167314
rdlDp,0.3333333333333333,6,5,ATTGTCCTCGTGTCACTAGT,1,3201483
rdlDp,2.1666666666666665,17,5,ATTCTTTGAGTACAAGTTCA,12,3216137
rdlDp,1.3333333333333333,12,5,ATTCAATGGAAGTTAAGCGT,7,3210830
rdlDp,5.333333333333333,36,5,ATTAGAGGTAGGGTAGAGGT,31,3193612
rdlDp,0.3333333333333333,6,5,ATGGTTCATCCGGGGGTTAT,1,3197292
rdlDp,2.5,19,5,ATGGTTACGGGGAGCAGCAG,14,3190362
rdlDp,2.5,19,5,ATGGCTCGAGCCTCCTTCCA,14,3214011
rdlDp,0.6666666666666666,8,5,ATCGTCAGTTCTGGGCTCGC,3,3191020
rdlDp,2.5,19,5,ATCCTATTAGATCGGATTAA,14,3209577
rdlDp,10.5,67,5,AGTTCAAGCTTCCGGCATCA,62,3193536
rdlDp,14.833333333333334,93,5,AGTGTAGGCAAGGTCAGTGA,88,3193595
rdlDp,0.6666666666666666,8,5,AGTGGTTTAGACGCGTTCAC,3,3169989
rdlDp,0.8333333333333334,9,5,AGTCGATACATCCTGCGTCT,4,3178725
rdlDp,1.0,10,5,AGGTCTTTAGCCTTGTTAGA,5,3198667
rdlDp,6.833333333333333,45,5,AGGGGCTCCTACAACACATA,40,3206196
rdlDp,1.3333333333333333,12,5,AGGGCGCCCCGAAGGGGCAA,7,3164985
rdlDp,1.8333333333333333,15,5,AGGGCCAGTGTCCATCGACA,10,3214328
rdlDp,1.3333333333333333,12,5,AGGCGACCGCCCGCATGGCT,7,3192706
rdlDp,0.5,7,5,AGGCATTGGCCTCTATTCAC,2,3191217
rdlDp,4.0,28,5,AGGATGGGTTCCACTCAAGT,23,3170277
rdlDp,0.6666666666666666,8,5,AGCGCCTGTCCAACCCTGCT,3,3173188
rdlDp,1.1666666666666667,11,5,AGCCGCGCATATGCCGTGGT,6,3179134
rdlDp,1.3333333333333333,12,5,AGAGTCGCTTCGCATGTGTT,7,3211732
rdlDp,1.5,13,5,AGAGACAGGCCTTCACGCTC,8,3210840
rdlDp,1.8333333333333333,15,5,AGAAGGCTGCTTTCGGCGAC,10,3184598
rdlDp,1.6666666666666667,14,5,ACTCGTACCCCCGATATTAA,9,3193841
rdlDp,0.3333333333333333,6,5,ACTCAGGACCGAGATCCTAA,1,3174174
rdlDp,0.6666666666666666,8,5,ACTAGGAGTTGACTCCCGAA,3,3198889
rdlDp,3.8333333333333335,27,5,ACGTTACTTGGTAGGCGTTC,22,3179717
rdlDp,1.6666666666666667,14,5,ACGTCATCCTCGGACAAGTC,9,3215875
rdlDp,1.6666666666666667,14,5,ACGGGCGCCCTGGCAGACTA,9,3201127
rdlDp,6.333333333333333,42,5,ACGGCGCGCCGGGGGGTTAT,37,3209576
rdlDp,0.6666666666666666,8,5,ACGAATTCATGTCCCCTGAG,3,3167160
rdlDp,6.5,43,5,ACCTCGGGTTAGTGGTGGCA,38,3207387
rdlDp,0.3333333333333333,6,5,ACCGCACCAGAGTTTTCCGG,1,3207680
rdlDp,2.1666666666666665,17,5,ACCCTGTTAACGGGGTTTTA,12,3210335
rdlDp,2.3333333333333335,18,5,ACAAAGCCTGAGTGCAATGG,13,3188120
rdlDp,4.5,31,5,AATTGATAGCACTGTCGGTC,26,3174160
rdlDp,0.8333333333333334,9,5,AATCTCCGAGCGTCTGTCCT,4,3191184
rdlDp,2.3333333333333335,18,5,AAGGGAACACCGACGTCATA,13,3215363
rdlDp,2.0,16,5,AACCAGATAGATTATGCGCT,11,3216096
rdlDp,0.4,5,4,TTTGGTGCCCATATCCCGAT,1,3164476
rdlDp,1.4,10,4,TTTCCTCCGAGGCGTACAAC,6,3204364
rdlDp,3.2,19,4,TTGGGTGTGTGTACAGTTAG,15,3181713
rdlDp,2.0,13,4,TTGAGACAGAGCTCTATGAC,9,3167195
rdlDp,3.6,21,4,TTCTCCTGTACGAATAAGGC,17,3164647
rdlDp,4.2,24,4,TTCTACAAAGTAATTGGAGA,20,3183987
rdlDp,1.2,9,4,TTCTAATCGAAAAACGTGTT,5,3187122
rdlDp,2.8,17,4,TTCAACGCACTACGATCACA,13,3201470
rdlDp,1.0,8,4,TTATCGGTCGGGGACCCATA,4,3211714
rdlDp,0.6,6,4,TTATAACATGGAGACTTTGA,2,3172568
rdlDp,1.4,10,4,TTACTTGTACAGAAACGGAG,6,3214451
rdlDp,0.8,7,4,TGTGTAGAGGTCACTATCAG,3,3177130
rdlDp,2.2,14,4,TGTAAGATAGCGTGCAGGTT,10,3205431
rdlDp,0.8,7,4,TGTAAACCGGATCATCCTGC,3,3187571
rdlDp,2.0,13,4,TGGTCAACCGCCGTCCACGC,9,3165437
rdlDp,1.6,11,4,TGGTACCTGCTTTAGGTCCA,7,3212471
rdlDp,3.0,18,4,TGGGAAGAACCAATTAAAAA,14,3168838
rdlDp,0.6,6,4,TGGATGGGCCTGAAGCCCAA,2,3168157
rdlDp,3.8,22,4,TGCGTACACCGAGCACGGGG,18,3171222
rdlDp,0.8,7,4,TGCCGCCAGGAACTCGTCTA,3,3208017
rdlDp,3.4,20,4,TGATAGGGCAGATTAAATGC,16,3201920
rdlDp,1.8,12,4,TGAATACTTGGTGTCGGGAC,8,3197599
rdlDp,10.6,56,4,TCGGCCAAGACAGCCTCTTG,52,3216139
rdlDp,0.6,6,4,TCGCTGGTATGTGTCGTGGG,2,3208933
rdlDp,0.6,6,4,TCGCCTCGTGGAAGCCCAAT,2,3175530
rdlDp,2.2,14,4,TCCTGCCATGCTCTTAACCG,10,3187580
rdlDp,3.0,18,4,TCCCGGATGCGACACCGGAT,14,3197842
rdlDp,1.2,9,4,TCAGCGTCGTTGCTTCATAT,5,3184576
rdlDp,3.0,18,4,TCACATGGAAGAAGGGGCGC,14,3214486
rdlDp,0.8,7,4,TCAATTTAAGGTCGATGTCC,3,3175553
rdlDp,4.0,23,4,TCAAAAACCTTATGCATCCT,19,3208757
rdlDp,0.4,5,4,TATGGGTCCATCATAGAAAA,1,3191756
rdlDp,1.4,10,4,TATGCATCTTGGTAATGCGT,6,3184722
rdlDp,1.8,12,4,TATAGTTGCGGGCATACCTC,8,3187832
rdlDp,3.0,18,4,TAGGAGTAAGGTCCAGTCGG,14,3165543
rdlDp,5.0,28,4,TACTTCAAATACTGTTCAGG,24,3198050
rdlDp,2.4,15,4,TACTTAGTCTTTACACCAAT,11,3183287
rdlDp,3.4,20,4,TACTAAGAGCCAACAAATTT,16,3181706
rdlDp,0.4,5,4,TAATCTGGTCTTTGTTAATC,1,3192052
rdlDp,0.4,5,4,TAATCCACGAGTGCATTGGT,1,3215806
rdlDp,3.4,20,4,TAAGGGTTTGCACCTGTTCA,16,3178409
rdlDp,1.2,9,4,TAAGAGGTTCTGCACAGGGG,5,3180410
rdlDp,0.4,5,4,TAACGGAGCGGAATCCACTA,1,3181010
rdlDp,5.8,32,4,GTTATCACCAGTGGTACGTG,28,3171213
rdlDp,0.6,6,4,GTGTGTGTCCCATCCGAGAT,2,3182675
rdlDp,8.0,43,4,GTGTGTATGCATGGCTACAA,39,3194194
rdlDp,0.8,7,4,GTGCTGACGAACTGTGCCCT,3,3174172
rdlDp,0.6,6,4,GTGCCCCCCCTCGGAGATAC,2,3187816
rdlDp,0.6,6,4,GTGCACGGCTCGCGAGTCAC,2,3178069
rdlDp,1.4,10,4,GTGATTTGTAGGTAGAGACA,6,3175665
rdlDp,2.6,16,4,GTGAGTCTACCACAATAGAT,12,3174104
rdlDp,1.0,8,4,GTGACGCATCTGTCATCGGC,4,3198198
rdlDp,2.4,15,4,GTCGGGGTTAGTTCCAGGGT,11,3176325
rdlDp,6.4,35,4,GTATGCGCTTTGAAGACGTA,31,3169612
rdlDp,2.2,14,4,GTAAAGATTGATGCATACGC,10,3167306
rdlDp,2.0,13,4,GGTTGCTGTACCAGCCTGTC,9,3187906
rdlDp,2.6,16,4,GGTGTGAGCAGCGGTGATAC,12,3173143
rdlDp,0.4,5,4,GGTGTCATTACAAGCATCAC,1,3195350
rdlDp,2.2,14,4,GGTGAACGATATTCCTTTTG,10,3164825
rdlDp,0.4,5,4,GGTCTGTAGATTAAGGCTTA,1,3181928
rdlDp,15.8,82,4,GGTCGCAACGGTATCCCTTG,78,3212483
rdlDp,2.4,15,4,GGTACAGCCAAAGTAATCTC,11,3176663
rdlDp,5.2,29,4,GGGCTAATTGCATTACGAAC,25,3200802
rdlDp,2.0,13,4,GGGCCGGTTGGGTTAGGGCA,9,3209448
rdlDp,1.2,9,4,GGGCCGCACGGCAATTCTAT,5,3168472
rdlDp,0.6,6,4,GGGCCATGCCAGCAAAGCAA,2,3211338
rdlDp,11.6,61,4,GGGAGCAACATCATTATTTG,57,3204811
rdlDp,2.4,15,4,GGGAGATTGGGTCAACCTTT,11,3164260
rdlDp,1.4,10,4,GGGACCGCGACCAAGCTTGC,6,3204166
rdlDp,0.6,6,4,GGCCCGAGGCTCGGACAGAG,2,3179902
rdlDp,14.0,73,4,GGCCATTGGTGATCGGGCAG,69,3199078
rdlDp,2.8,17,4,GGATTAGAGTACAAACTAGG,13,3191554
rdlDp,1.8,12,4,GGATTACATTCTGTAGAGGT,8,3214493
rdlDp,3.8,22,4,GGATCCGGCTTAACATTTCG,18,3194202
rdlDp,2.2,14,4,GGATACCTCAGTTACTTCGC,10,3194618
rdlDp,2.8,17,4,GGACGTCACCCTCAAAAAGA,13,3168202
rdlDp,1.4,10,4,GGACCATAGGGATCTTCGTC,6,3193813
rdlDp,2.2,14,4,GCGCCCACTGTGTGTTTAAT,10,3193604
rdlDp,0.8,7,4,GCGACCATTTCTATATGATC,3,3213958
rdlDp,0.4,5,4,GCCTCATATTAGGAAAAAGC,1,3195554
rdlDp,2.0,13,4,GCCCTCGAACTTGGGTCGCC,9,3203974
rdlDp,1.0,8,4,GCCCGCTGCGTCTGCATACT,4,3178879
rdlDp,1.2,9,4,GCCCCACGAACTGGATACTG,5,3167629
rdlDp,1.2,9,4,GCCATTCATGGATGGTGACA,5,3167286
rdlDp,13.6,71,4,GCATAGGCTCTCTCCGCCGA,67,3208394
rdlDp,3.6,21,4,GCAGGGTGCGAGACAAACGC,17,3203598
rdlDp,0.4,5,4,GCAATTGTTTGAGCGCTAGG,1,3204106
rdlDp,0.6,6,4,GCAAGATAGTAATATAGTGG,2,3201666
rdlDp,4.6,26,4,GCAACAGGTACTGAGATTTA,22,3196272
rdlDp,0.6,6,4,GATGCAGTCATTTCTATGCT,2,3186303
rdlDp,4.6,26,4,GATCGCGATCTAACTCCCAT,22,3171239
rdlDp,0.6,6,4,GATAATCCGGCCAGTTGGAC,2,3191168
rdlDp,0.6,6,4,GATAACATAGGTCGCTTTTA,2,3202308
rdlDp,5.0,28,4,GAGGGCACGTCGCTCGGAGG,24,3212481
rdlDp,2.6,16,4,GAGGAGGACTGCAACCTACT,12,3191560
rdlDp,1.0,8,4,GAGAGGGACAACGACACTAC,4,3180110
rdlDp,2.2,14,4,GACGCAGCCCTGGCCTACGG,10,3188698
rdlDp,5.4,30,4,GACCACCCGCTGCTGGTCAC,26,3182460
rdlDp,1.8,12,4,GACAAAAGTTGGTCACAGAA,8,3171881
rdlDp,1.2,9,4,GAAAGTAATCTGGACACTTA,5,3167282
rdlDp,2.6,16,4,CTTCGTAGGCTGGTTGGTTG,12,3165733
rdlDp,0.6,6,4,CTTCGATTTGAGCGCGTAGG,2,3168490
rdlDp,1.6,11,4,CTGTGCCGACTCTCGAGAAC,7,3186286
rdlDp,2.6,16,4,CTGTCCGTGGCGGTGAAAGA,12,3165944
rdlDp,1.4,10,4,CTGCTTTACCACGACCTGGT,6,3196188
rdlDp,5.6,31,4,CTGATCTGTTTCAAGGGTCT,27,3188389
rdlDp,1.0,8,4,CTGAGAATTTATGGGTAAAG,4,3195342
rdlDp,2.2,14,4,CTGAATTGGCTTCCGGCACA,10,3188117
rdlDp,0.8,7,4,CTCTTGCGGTAACGCATTCG,3,3182396
rdlDp,2.4,15,4,CTCGTTTGCTGATCTTGGTT,11,3199937
rdlDp,3.4,20,4,CTCGGCCTATTGACGGAAGT,16,3165299
rdlDp,1.6,11,4,CTCGGCCTAGTTCTAGAACA,7,3176660
rdlDp,1.8,12,4,CTCGCAGGAGAGGTGTATTC,8,3208550
rdlDp,2.0,13,4,CTATACTCGTGAGCAGGATG,9,3198969
rdlDp,5.8,32,4,CTAGTTGAGCAAACCGCGTG,28,3194454
rdlDp,1.0,8,4,CTAGTACGGTCGGCGTGTAG,4,3176674
rdlDp,0.8,7,4,CTAAGGATGGAGTCCAAGTT,3,3194476
rdlDp,1.6,11,4,CGTTCTTAAATACTCCGCAA,7,3176788
rdlDp,0.4,5,4,CGTGTAGGTTCTATTACAAC,1,3215598
rdlDp,1.6,11,4,CGTCGTCTTCAAAGTATGGA,7,3180104
rdlDp,2.0,13,4,CGTATCGATAATCCGTCTCA,9,3211906
rdlDp,2.6,16,4,CGGTTTAAGAGAATCAAGTG,12,3181870
rdlDp,1.4,10,4,CGGTGTGCTGCCGTCAAGTA,6,3173076
rdlDp,0.8,7,4,CGGTCTAGGTTGCGCACACA,3,3180125
rdlDp,0.8,7,4,CGGTCACGACCGGGGTACCT,3,3198182
rdlDp,1.2,9,4,CGGTATCATATCCGCAAACA,5,3179823
rdlDp,10.6,56,4,CGGGCCTAAGTAACCTCTAA,52,3193638
rdlDp,1.0,8,4,CGGATTTTACAAAGTCTCGT,4,3209304
rdlDp,1.0,8,4,CGGACAGCCGGGCTTACCAC,4,3210828
rdlDp,0.4,5,4,CGCGCGCCCTTCTGGTGCCC,1,3194095
rdlDp,4.6,26,4,CGCATTGGAGTTCGCGGGTG,22,3175924
rdlDp,1.4,10,4,CGCATCTGAAATATCGAAGT,6,3186680
rdlDp,2.4,15,4,CGATCTAGATTTGTTGGGAA,11,3179532
rdlDp,1.2,9,4,CGAGATAGTGTGGTTCGTGG,5,3182399
rdlDp,2.2,14,4,CGACTGCTTTATGTAGTTAT,10,3208178
rdlDp,6.2,34,4,CGACAGCCTTGGCCTTACGT,30,3194449
rdlDp,1.6,11,4,CCTAGGATTAGTCGCGTACG,7,3182439
rdlDp,1.4,10,4,CCTACCTGATAGGAGCCTGA,6,3182114
rdlDp,0.8,7,4,CCGACTATGACGGTAAACCT,3,3198474
rdlDp,0.4,5,4,CCCGGGGAAGGTTGATCGGG,1,3178976
rdlDp,3.6,21,4,CCCATTGAGGGGAGCCCCAA,17,3166103
rdlDp,0.8,7,4,CCCAGCAGTCACATCATGAG,3,3185061
rdlDp,1.0,8,4,CCCAGAGTTGATGGCTGCTT,4,3196651
rdlDp,3.4,20,4,CCATCTTAAGAGTTAGTTAA,16,3182597
rdlDp,0.6,6,4,CCAGAATGAACGCTCCGTAA,2,3183998
rdlDp,1.2,9,4,CCACTTAGCCGGCCGGACTC,5,3215743
rdlDp,3.0,18,4,CCACCTTATACGGACGTCAT,14,3171225
rdlDp,0.8,7,4,CATTAGATCAGACTCGCCCC,3,3167168
rdlDp,0.6,6,4,CATGGGAGCCACAGGATCGT,2,3168158
rdlDp,12.8,67,4,CATGCTCTAGTGATTGGTGT,63,3201602
rdlDp,1.4,10,4,CATGACCATGGTAGGTCACA,6,3209815
rdlDp,4.0,23,4,CATATGTAAGACTAACGCTC,19,3202323
rdlDp,1.0,8,4,CATAAGCGCTATACGTCTCA,4,3198506
rdlDp,0.8,7,4,CATAACTAGGCAACCCATGA,3,3192402
rdlDp,1.2,9,4,CAGTAATGTTGTCGGTCCTG,5,3200821
rdlDp,1.2,9,4,CAGGTCAAAGTAATAAAGAC,5,3193815
rdlDp,0.4,5,4,CAGCTTCACTTGCGCTCGTC,1,3179278
rdlDp,2.6,16,4,CAGCCTATAACGGTTGGTTG,12,3172625
rdlDp,0.8,7,4,CAGATTTCTCAGTCCTTGGA,3,3191698
rdlDp,0.8,7,4,CACTGGAACTCGTCTCGGCT,3,3185000
rdlDp,3.2,19,4,CACTGCTTAGGGTAGCGTTG,15,3174374
rdlDp,7.8,42,4,CACTAAAATCACAAGACTAT,38,3192188
rdlDp,0.4,5,4,CACGGTGTCTCCCTGGGGAC,1,3206954
rdlDp,1.8,12,4,CACCCGGGAATAGAGGAAGA,8,3197289
rdlDp,0.8,7,4,CACATGGCCTCACGGGCTCA,3,3165408
rdlDp,2.8,17,4,CAATGACCGTTGGAGCACAC,13,3186828
rdlDp,1.8,12,4,CAAGTCTTCATAGAATGGGT,8,3194682
rdlDp,7.6,41,4,CAAGACTGCTGTCACGCACA,37,3194489
rdlDp,0.8,7,4,CAAATGTAATATCAGCCGTC,3,3208650
rdlDp,0.4,5,4,CAAACGGTATCCCGCAGACA,1,3208867
rdlDp,0.6,6,4,ATTTTCCGGCGCTATCCGAG,2,3181959
rdlDp,2.8,17,4,ATTTGTTGAAAGCCCTGGCT,13,3167144
rdlDp,3.0,18,4,ATTTGTCTCTGAAGCCAGTC,14,3195284
rdlDp,4.8,27,4,ATTGCAGCGGCAATAATTAT,23,3209355
rdlDp,0.8,7,4,ATTGAAGGGGGCCAAGGGTT,3,3169994
rdlDp,0.4,5,4,ATTCTTGCCGCGCCAAATAT,1,3167627
rdlDp,3.4,20,4,ATTCGGCTCCCCCTAAAGGC,16,3177214
rdlDp,3.2,19,4,ATTAGGAGGAAGCTATGATG,15,3181989
rdlDp,5.0,28,4,ATTAGAGGGGGTTACCCAAG,24,3178880
rdlDp,3.4,20,4,ATGCTCCGTTTGTCAGGAGT,16,3186035
rdlDp,1.0,8,4,ATCCCTTGCATCGGTCGGCG,4,3169387
rdlDp,4.0,23,4,ATCACTACTTGCAATTTGGA,19,3167215
rdlDp,0.4,5,4,ATATATATCTTCAGGGACAG,1,3199790
rdlDp,2.4,15,4,ATAGGGCGATGGTGTGGCGT,11,3205280
rdlDp,0.8,7,4,ATACTGGGAGGAAAATTTCC,3,3176276
rdlDp,0.8,7,4,ATACCAATAAGGATTTCAGG,3,3215417
rdlDp,1.8,12,4,ATACAAGCAACACGCTTCGC,8,3201771
rdlDp,1.0,8,4,AGTTATCCAGCGGGCTGGTC,4,3207024
rdlDp,4.8,27,4,AGTGCGTTCATTCTACTTGT,23,3205891
rdlDp,3.6,21,4,AGTCCTCGAGAGAATGCGAC,17,3179625
rdlDp,1.8,12,4,AGTAGTGGGTCATCACCGAT,8,3185812
rdlDp,2.2,14,4,AGTAAGCTCTCTGACAGTCA,10,3171338
rdlDp,2.8,17,4,AGGTCATATTAGCTTGACAA,13,3199125
rdlDp,1.0,8,4,AGGTACTGAGTCAAACGGGG,4,3208180
rdlDp,8.2,44,4,AGGGTTAATCTCTTCCATGA,40,3210816
rdlDp,1.6,11,4,AGGGGCCATGCTCGGAAAGG,7,3196372
rdlDp,2.4,15,4,AGGCCGCAAAGGTATATCCA,11,3174915
rdlDp,2.2,14,4,AGGCAGATCTTGGATTAATC,10,3191189
rdlDp,2.2,14,4,AGGATGGGTGCGATAGTGTT,10,3210480
rdlDp,11.0,58,4,AGGACCTCAGGAGCATCGTG,54,3193600
rdlDp,1.0,8,4,AGCTATCAACTTTTAGGGTA,4,3194088
rdlDp,1.0,8,4,AGCGAACGCATTGTCTGTGT,4,3214229
rdlDp,7.2,39,4,AGCACCAACTGGACAGCAGA,35,3172575
rdlDp,1.4,10,4,AGATGATCGGTGATATGTCT,6,3179295
rdlDp,0.4,5,4,ACTGCAAAGGTCCATAACGG,1,3200747
rdlDp,0.4,5,4,ACTGAGTTCTTTACGGGGGT,1,3188141
rdlDp,3.4,20,4,ACTCTCCTCTACAAGCCGGA,16,3172433
rdlDp,5.6,31,4,ACGAGCGCATTAGTCTAGAA,27,3180782
rdlDp,1.6,11,4,ACCTGGAGAACAAGATATAC,7,3204860
rdlDp,1.0,8,4,ACCTCGCACGTCTCAAGAGT,4,3196197
rdlDp,1.2,9,4,ACCAGGGCACATTACTGCTC,5,3195580
rdlDp,0.8,7,4,ACACGGGCGCGATGTTGAAG,3,3211815
rdlDp,2.2,14,4,AATTTGACGGGGCCAGGCTC,10,3184659
rdlDp,1.6,11,4,AATGGTCCCTTTAATTTAAG,7,3204851
rdlDp,2.6,16,4,AATGGCCCCTTCGACATGAC,12,3207725
rdlDp,1.8,12,4,AATACGTGGCCGATGACCAC,8,3194715
rdlDp,2.4,15,4,AAGCCGATCGTAGGTCCTGG,11,3214195
rdlDp,9.2,49,4,AAGCACTTATACGTGCAAAT,45,3212431
rdlDp,0.6,6,4,AAGAGGCCAGTTAGGAAGCA,2,3193166
rdlDp,2.6,16,4,AACTCCTCGAACTAGATTCT,12,3171339
rdlDp,4.4,25,4,AACTCCCGCATTACTCTCAA,21,3192462
rdlDp,4.0,23,4,AACGAAACGTCATGTTTGAG,19,3175928
rdlDp,2.8,17,4,AACCTGCCACTATGTTTCAG,13,3169076
rdlDp,1.4,10,4,AACATTGTAAGCGCACCCAA,6,3201676
rdlDp,3.2,19,4,AACACCGTCCAGGACCATTC,15,3180579
rdlDp,4.0,23,4,AAAGAGTAAGTCAACAACAA,19,3184607
rdlDp,1.2,9,4,AAAGAGAATTTTGCATCCTC,5,3178060
rdlDp,7.0,30,3,TTTTGCCATAGTATCCAGCT,27,3212503
rdlDp,2.5,12,3,TTTGGCCATACCCTACGCTT,9,3167457
rdlDp,6.25,27,3,TTTCCGTTTGGGGATAATGG,24,3209998
rdlDp,2.0,10,3,TTTAGCATGGGAACTAGATT,7,3192109
rdlDp,2.25,11,3,TTGTGCCGGACGATCCTGTT,8,3205272
rdlDp,1.25,7,3,TTGTGCCATCCCGCCACCGT,4,3210477
rdlDp,4.75,21,3,TTGTGACATGGTGGGAACTC,18,3177523
rdlDp,2.25,11,3,TTGCCCTTTTTTTCGGCGGA,8,3191787
rdlDp,8.75,37,3,TTCGAACGTACAATGGCCTG,34,3180420
rdlDp,6.5,28,3,TTCCGAATGAGTCAGAATAG,25,3215022
rdlDp,7.75,33,3,TTCATGGGACGGATGGCGGA,30,3212438
rdlDp,2.75,13,3,TTATTTGGATAGCCTTGGCA,10,3170730
rdlDp,5.25,23,3,TTAAGAGTCATTGGGACCTA,20,3180436
rdlDp,5.0,22,3,TTAAGACCTTGTCAACCATT,19,3165492
rdlDp,3.75,17,3,TGTGGACCCATTCAACACAG,14,3172841
rdlDp,0.5,4,3,TGTGACGGTTGTTCCGCTTG,1,3209045
rdlDp,1.75,9,3,TGTCTTTAATGTTGTGTGGG,6,3180416
rdlDp,0.5,4,3,TGTCGTACGTCATTTCTTTT,1,3174645
rdlDp,1.5,8,3,TGTATCGGGGGGGGCACGAC,5,3168907
rdlDp,1.0,6,3,TGGTGAATTGTCCTAAGGGG,3,3187815
rdlDp,0.5,4,3,TGGTATAGACGGGCGGAAGA,1,3198208
rdlDp,2.25,11,3,TGGGCACCAGACTTGGATAT,8,3168941
rdlDp,0.5,4,3,TGAGGGCCGTCGTGTGCAGC,1,3185705
rdlDp,0.5,4,3,TGACCTAAATCATTATGGGT,1,3190366
rdlDp,3.75,17,3,TCTGAAGTTACAGTTGGACA,14,3169606
rdlDp,5.0,22,3,TCTCGAAAGGGTATAGCGTT,19,3188099
rdlDp,1.75,9,3,TCGTGTTAACATTGATCACC,6,3165552
rdlDp,3.75,17,3,TCGGTTCCGCTTTACTCGGA,14,3169403
rdlDp,3.5,16,3,TCATGTCCGGGGTTCAGGGT,13,3171237
rdlDp,1.75,9,3,TCAGGTTCTACGCCTCGACT,6,3180424
rdlDp,0.5,4,3,TCACTGCAGCAGGTCGAGCC,1,3211719
rdlDp,1.75,9,3,TCAAGTACGACATGCGCACC,6,3214882
rdlDp,2.25,11,3,TATCTTGTGTCATCTACCCA,8,3183927
rdlDp,11.25,47,3,TATCAGTGATAGGGATGGGA,44,3211233
rdlDp,2.75,13,3,TAGCTCCGGTATTCGGCTTG,10,3199619
rdlDp,4.25,19,3,TAGACCTGTTTGTTGAAACT,16,3176847
rdlDp,3.5,16,3,TACGTGGCTGTGTAATCGTC,13,3187852
rdlDp,0.5,4,3,TACCTCGTCTCGTCTCGGGT,1,3174811
rdlDp,1.5,8,3,TACCGAAAGTTTTACAGCTC,5,3190861
rdlDp,1.5,8,3,TACCCCGTTTTGTGGCCATG,5,3176368
rdlDp,2.5,12,3,TACACAACAAGGGACAAACC,9,3205917
rdlDp,6.25,27,3,TAATCGTGGTTGTCCAAATG,24,3181877
rdlDp,3.25,15,3,TAATACAGGTCTCTCGAAGG,12,3201848
rdlDp,2.5,12,3,TAAGGTTGCTATCCGCTTCA,9,3209697
rdlDp,4.5,20,3,TAAGGGACGGATGTCAGTGA,17,3187570
rdlDp,0.5,4,3,GTTCGTGGGAGACCGGGCGT,1,3166259
rdlDp,5.25,23,3,GTTCCCGGTTCGTTTGTCAC,20,3194461
rdlDp,2.75,13,3,GTTCATCATGAACCAAGCTA,10,3207056
rdlDp,2.25,11,3,GTTCACATCGCGACGGCCGT,8,3167401
rdlDp,2.25,11,3,GTTATAATTGTTGAGACGCT,8,3169455
rdlDp,1.25,7,3,GTTAGGTGCACATGCTTGCG,4,3201681
rdlDp,3.5,16,3,GTGTCCCGGCTTCCCTGATA,13,3181521
rdlDp,2.75,13,3,GTGGTTTAGTGTGAGGACCG,10,3190898
rdlDp,67.75,273,3,GTGGCGCCCATGTTAAACCT,270,3184404
rdlDp,0.75,5,3,GTGATTGAGCTGCGGCTACT,2,3215023
rdlDp,1.5,8,3,GTCGCTATATCACTACTCTA,5,3176658
rdlDp,0.75,5,3,GTCACTGTACGGAGCGTTTT,2,3204154
rdlDp,3.0,14,3,GTCAAAGTGACAAACTTCTG,11,3202949
rdlDp,3.0,14,3,GTATTGCCATTATTTAATAC,11,3195302
rdlDp,1.75,9,3,GTATTCCCGTCCCGTCGTCA,6,3190827
rdlDp,0.75,5,3,GTAGGTTAGTGCTGCTTCGA,2,3169635
rdlDp,2.75,13,3,GTAGCAGTAGGCGTAAGCGT,10,3196655
rdlDp,1.5,8,3,GTACCGACGGCGGCTGTCTG,5,3186172
rdlDp,5.25,23,3,GTACACCCGCGAGTATGGTG,20,3215973
rdlDp,4.0,18,3,GTAAGTTTGTCTGCCCGGCC,15,3204874
rdlDp,1.5,8,3,GGTCGCGAGACCTCGGACTC,5,3181873
rdlDp,4.25,19,3,GGGGCGCGCGGAATCACACG,16,3168837
rdlDp,0.75,5,3,GGGCTTACTTCAACCATGAA,2,3188909
rdlDp,0.75,5,3,GGGCATGTAGGATGCCAAAG,2,3181296
rdlDp,4.0,18,3,GGGCATGAATGCCCGATAGG,15,3181920
rdlDp,1.0,6,3,GGGAGCATCTCTTGGTGTAT,3,3183388
rdlDp,2.25,11,3,GGGAACTTTGTAGTCTGAGA,8,3209372
rdlDp,5.25,23,3,GGCATCTGGGATATGCGCCA,20,3174922
rdlDp,2.25,11,3,GGATCCTCGGGTCACCGGCC,8,3197288
rdlDp,1.25,7,3,GGAGCGCGAATATAGTGTAG,4,3178205
rdlDp,1.75,9,3,GGAATCTCTTCAGGAACCAC,6,3169389
rdlDp,0.5,4,3,GCTTGAGGATCCCCGGCACT,1,3186174
rdlDp,2.5,12,3,GCTTCTCTGGCGGTGTTTAA,9,3203676
rdlDp,2.5,12,3,GCTGAACACCCAAGGTGATT,9,3209015
rdlDp,1.25,7,3,GCTCTTTAGGCATAGGGAGA,4,3207255
rdlDp,0.5,4,3,GCGTCGTGGACAGCCGCGAG,1,3185813
rdlDp,5.25,23,3,GCGAAACTGTTGTAATACAG,20,3203800
rdlDp,0.75,5,3,GCCTTAAGCATGCCCAGAGG,2,3195681
rdlDp,7.5,32,3,GCCTCACCTCAGGATATATG,29,3180644
rdlDp,1.5,8,3,GCCCAGGCTAATAGGTAGAA,5,3204231
rdlDp,6.0,26,3,GCCACTGAGATTTAGTATAA,23,3197809
rdlDp,3.25,15,3,GCAGGCGGAGTACTGAATAG,12,3168909
rdlDp,1.25,7,3,GCAGATTTTGATTCTTTAAT,4,3179157
rdlDp,1.5,8,3,GATTTCGCATTCCGTTTATT,5,3175949
rdlDp,14.0,58,3,GATATTCGACTGACATGGTC,55,3188216
rdlDp,2.75,13,3,GAGGTCTGGTGTTGATACAT,10,3185132
rdlDp,8.0,34,3,GAGACGGCATCTTCTCCGAA,31,3194469
rdlDp,2.5,12,3,GAGACAGTACGTAAAGATAC,9,3205271
rdlDp,5.0,22,3,GACCGGCCATGGGCCTCCCC,19,3166638
rdlDp,4.5,20,3,GACACGTCCGTCCGGGGCCT,17,3169553
rdlDp,3.25,15,3,GAATGCACGGGACGAGCCAC,12,3210711
rdlDp,3.5,16,3,GAATACCCGGGGTATCAATG,13,3185621
rdlDp,4.0,18,3,GAAAACTTCCATAAGTCACA,15,3206771
rdlDp,1.0,6,3,CTTTTCAACCCTGCTCATGA,3,3203712
rdlDp,0.5,4,3,CTTCCCATAAAGCCTTACGC,1,3167140
rdlDp,1.0,6,3,CTTCAAAGCTATGCCCGCGA,3,3174667
rdlDp,4.5,20,3,CTTATTTGAAAACGACTTCG,17,3169080
rdlDp,1.0,6,3,CTTATGTGACGCGTCCGAAT,3,3164984
rdlDp,1.0,6,3,CTGTCGTGCTCGCTCCCGAT,3,3186610
rdlDp,0.75,5,3,CTGCGTTTTAAGTTTTGACT,2,3215813
rdlDp,1.0,6,3,CTGCAATAGAGACACAGTGT,3,3195347
rdlDp,9.5,40,3,CTCGTTCGGTTCTCCCGGAA,37,3212644
rdlDp,0.5,4,3,CTCGTGAAGAAGGAACCCGA,1,3180575
rdlDp,2.0,10,3,CTCGTAAGCGTTTTTCGGTA,7,3210573
rdlDp,1.0,6,3,CTCCCCCCACGATATTAATC,3,3204060
rdlDp,13.25,55,3,CTATACTTAGACACCGGAAC,52,3198019
rdlDp,2.25,11,3,CTAGCGAATTTCAACGGCCC,8,3178066
rdlDp,3.5,16,3,CGTTTTGGGGTCGCGACATT,13,3207919
rdlDp,1.25,7,3,CGTTATTCCTAATACTACAC,4,3185817
rdlDp,6.25,27,3,CGTTAGACGCGACGCATGCG,24,3188707
rdlDp,2.75,13,3,CGTTAACGCGATACCCCTGA,10,3196223
rdlDp,4.25,19,3,CGTGCTCGATTGAAGTAAGA,16,3168785
rdlDp,2.75,13,3,CGTCTAACATTCCCCGATCA,10,3205404
rdlDp,1.75,9,3,CGTAGTTTAGCAAGAACTCA,6,3190312
rdlDp,4.5,20,3,CGGTACGTGTATCTAACGTT,17,3199472
rdlDp,1.5,8,3,CGCTCTAGCCTCCCCAGAGA,5,3187448
rdlDp,0.75,5,3,CGCTCGCATGTGGCTAAGTC,2,3178502
rdlDp,1.5,8,3,CGCTACGATTGCCCTATCCC,5,3182162
rdlDp,1.75,9,3,CGCCTGGGCTTGTTTATCTT,6,3188362
rdlDp,1.25,7,3,CGCCCGGGTCTAACTGGTCG,4,3198771
rdlDp,0.75,5,3,CGATGGCCTAAAAGGCGGGG,2,3168451
rdlDp,1.75,9,3,CGACTAGAATCTGGCCGTAG,6,3189658
rdlDp,2.5,12,3,CGACCTCTTAGGCATCTGGG,9,3176400
rdlDp,2.0,10,3,CGACAGAAATCTACTCAGCA,7,3165676
rdlDp,7.25,31,3,CCTCGTGTGGACGCGTACAG,28,3205924
rdlDp,2.0,10,3,CCTCCTTTCGCATCTCCTTA,7,3215639
rdlDp,12.25,51,3,CCTAGGAGCCTCCAGACATT,48,3174633
rdlDp,2.25,11,3,CCTACGAGCAGTGGGCACAA,8,3181426
rdlDp,3.0,14,3,CCGTGTGAGACCGTGAACTT,11,3212606
rdlDp,7.25,31,3,CCGCGAAATCCTCAGTCCTA,28,3176381
rdlDp,1.25,7,3,CCGCCCTGGTAGACCACCGG,4,3171853
rdlDp,4.75,21,3,CCCGTAACCACTTCGAAGGA,18,3187677
rdlDp,7.0,30,3,CCCCTGGTTATTAACTGCCT,27,3166346
rdlDp,4.25,19,3,CCCCTATCCTAGTGTCCAGT,16,3194229
rdlDp,2.0,10,3,CCCCACTATCTACTTTGCTG,7,3180521
rdlDp,3.25,15,3,CCCACTCGATTCGTGCGGAT,12,3196294
rdlDp,1.0,6,3,CCCAACAATGAATTCGCTTT,3,3213956
rdlDp,1.25,7,3,CCAGTGTATTACTTACTATG,4,3173943
rdlDp,29.0,118,3,CCAGTGGTATTCAAGTGCGT,115,3199081
rdlDp,2.25,11,3,CCAGAATTACCGAATTGACG,8,3164531
rdlDp,1.0,6,3,CATCAAACGCCGGGCTACCT,3,3210880
rdlDp,6.25,27,3,CAGCGGTGTGTTGCGTGCAG,24,3201997
rdlDp,1.5,8,3,CAGAAGGGAACGCCACTCCA,5,3177564
rdlDp,4.25,19,3,CACTTCAATTCATCACAGCC,16,3194197
rdlDp,2.5,12,3,CACTCACGAATCCCTTGACG,9,3180124
rdlDp,0.5,4,3,CACCACTAATGGAGGAAAAA,1,3180120
rdlDp,2.5,12,3,CACAAACTCCGCCCTTGGAG,9,3187564
rdlDp,0.5,4,3,CAAGCGCGGGAAAAACTGAA,1,3200770
rdlDp,1.75,9,3,CAAAAACTGACAAAAGACTC,6,3164239
rdlDp,0.75,5,3,ATTGTTCCATAGCTAATTCA,2,3180047
rdlDp,2.0,10,3,ATTAGAGAGCATAGCCAGGA,7,3172892
rdlDp,14.25,59,3,ATGCATAACGCGAATTTCCA,56,3198359
rdlDp,5.0,22,3,ATGATCTATTCCTAGCAGGC,19,3169412
rdlDp,18.0,74,3,ATGAGGGGAGGCCCTCGACA,71,3212500
rdlDp,3.0,14,3,ATGACTTTCGCGCGTGCACG,11,3176598
rdlDp,2.75,13,3,ATCGGGCGCCGTAAGCTAGT,10,3175892
rdlDp,1.75,9,3,ATCAACAGGGCCGTGATATA,6,3206984
rdlDp,0.5,4,3,ATAGGATCGTCCAGAATTCC,1,3208296
rdlDp,1.75,9,3,ATACCCCGACGCTCAAGCGC,6,3193487
rdlDp,23.0,94,3,ATAATCACCTTCCAGTTATC,91,3196859
rdlDp,1.75,9,3,ATAAGCACTCAAGCCTATTT,6,3177975
rdlDp,1.5,8,3,ATAAACGAACTCTAACGCTA,5,3207956
rdlDp,0.75,5,3,AGTGGGACGTTGCAAGGCTT,2,3183367
rdlDp,1.25,7,3,AGTCTTCGGCCGCGAGAAAA,4,3198459
rdlDp,6.75,29,3,AGTCTAACGTCCGTATTATG,26,3176655
rdlDp,0.75,5,3,AGTCGGGCCATTGGGCCGGA,2,3181740
rdlDp,0.5,4,3,AGGTCCACAGTTTGTTACTT,1,3171254
rdlDp,0.75,5,3,AGGGGTGTTGGTAGTTCAGA,2,3178905
rdlDp,0.5,4,3,AGGATTTTCTTGGTCCAGAA,1,3198368
rdlDp,0.75,5,3,AGGATTCCATCACAATATTT,2,3169414
rdlDp,2.75,13,3,AGCTGCACGTTCTATACCAA,10,3175564
rdlDp,4.25,19,3,AGCCCGTAAAGGGTTGGTCA,16,3167382
rdlDp,2.25,11,3,AGCAGCATATCCCGACCATA,8,3182453
rdlDp,0.75,5,3,AGATTCAGATTTGGTCGCTG,2,3193843
rdlDp,1.75,9,3,AGACATATAGTACCATTGCA,6,3210742
rdlDp,0.75,5,3,AGACAAGACTGCGACCCAAA,2,3177444
rdlDp,1.0,6,3,ACTCGGTCTCATAGATAGAG,3,3189684
rdlDp,7.5,32,3,ACGTTACGGAATGCTAGTAT,29,3202099
rdlDp,13.25,55,3,ACGGGCTCTATGGACAATGT,52,3202124
rdlDp,0.5,4,3,ACGGAGTTTTTGAAGGTGGA,1,3179380
rdlDp,1.25,7,3,ACGGAGCAGCACATAGGCGC,4,3174718
rdlDp,1.5,8,3,ACGGACGGTGTAACCGGGTA,5,3215803
rdlDp,1.5,8,3,ACCTGCTGGTAGAATAGTCA,5,3177677
rdlDp,3.5,16,3,ACCTCGCTTGTTAGTCGCGT,13,3192208
rdlDp,2.5,12,3,ACCTCCCGTAGGGCATCCAA,9,3182458
rdlDp,4.0,18,3,ACCGACTTGACATGTGGGAG,15,3204869
rdlDp,4.0,18,3,ACCACCGCAAGAACGAATGA,15,3172907
rdlDp,1.5,8,3,ACACGACAACGGATCTTAAT,5,3166120
rdlDp,2.25,11,3,ACAAATTGACCCTTCGAAAT,8,3189989
rdlDp,2.25,11,3,AATTTGAAATACTACTTAAA,8,3181027
rdlDp,1.0,6,3,AATTGAGAAGGATACGCGCT,3,3171807
rdlDp,5.0,22,3,AATTGAAATAGGTCACCGTG,19,3169042
rdlDp,0.75,5,3,AATGTGATGCCTGCTGGTGC,2,3171843
rdlDp,1.0,6,3,AATGCAGCGGAGTTGTTGCA,3,3213595
rdlDp,0.75,5,3,AATGAGAGACATGGATACGG,2,3208508
rdlDp,3.25,15,3,AATCGTACCGTCCACGAGCT,12,3192283
rdlDp,1.0,6,3,AATCGACAGTTAGCGCTCCT,3,3190937
rdlDp,1.5,8,3,AAGTACTGTCAATCAAGCAA,5,3173668
rdlDp,0.75,5,3,AAGGTAATCATCCAGTCTTT,2,3200749
rdlDp,1.25,7,3,AAGGGCTCATTTACCCGCGG,4,3196648
rdlDp,0.5,4,3,AAGCCGTAGAACGTTGTGGG,1,3216047
rdlDp,1.25,7,3,AAGCAGAACAACTACGGGCA,4,3208001
rdlDp,1.0,6,3,AAGAAAGATGTCAGTAAACC,3,3192541
rdlDp,4.0,18,3,AACGGTGGGTGGGGTTAACG,15,3207570
rdlDp,3.75,17,3,AACGGGGTCGGGGTAATGTA,14,3213922
rdlDp,3.75,17,3,AACGAGTACTTGGAATCGGA,14,3191699
rdlDp,0.5,4,3,AACAATAGCTGGCGGTACGT,1,3207222
rdlDp,1.75,9,3,AAAGCCTGTGTCAGTGAATC,6,3194011
rdlDp,2.0,10,3,AAACGGGCTCAGAGGACATG,7,3165008
rdlDp,3.5,16,3,AAACACACCCTCGGGGTAAG,13,3176751
rdlDp,2.3333333333333335,8,2,TTTTAGTATCATAAGCGCAA,6,3203475
rdlDp,1.3333333333333333,5,2,TTTGTTTTTCAGCACGGGCC,3,3213247
rdlDp,1.6666666666666667,6,2,TTTGGGCCTGCGCGGGCATG,4,3173842
rdlDp,0.6666666666666666,3,2,TTTCACTAGACGGGGGTGGG,1,3184710
rdlDp,2.6666666666666665,9,2,TTTCACAAAGACCCCTAGCT,7,3208863
rdlDp,3.3333333333333335,11,2,TTTAGGTTGTACACCTTCTC,9,3198904
rdlDp,2.0,7,2,TTGCAGATTTCCCTATCCAC,5,3183390
rdlDp,2.3333333333333335,8,2,TTCGTGTATAACTTTTGGAC,6,3171882
rdlDp,1.6666666666666667,6,2,TTCCAGCCGCTGCATTCAGT,4,3191771
rdlDp,1.3333333333333333,5,2,TTCATTTTGTGTGGTGAACA,3,3186240
rdlDp,4.0,13,2,TTAGTCATTTCATGCCTCGC,11,3188626
rdlDp,7.0,22,2,TTAGGGATGATCGAGGCCTG,20,3183597
rdlDp,3.6666666666666665,12,2,TTAGGCTAGAGCCTATAGGG,10,3172237
rdlDp,1.6666666666666667,6,2,TTAACCGGTTTCCCCAGTCC,4,3197838
rdlDp,2.0,7,2,TGTTTATCAGGGTGTCACGA,5,3169452
rdlDp,1.6666666666666667,6,2,TGTTCACTATCATGTTTAAG,4,3187195
rdlDp,1.0,4,2,TGTGGACAAGTCAGGTGGGA,2,3181519
rdlDp,0.6666666666666666,3,2,TGTCGAAAATGAGTGTAAGG,1,3209374
rdlDp,0.6666666666666666,3,2,TGTACGTACTGAAGGGAGAA,1,3201652
rdlDp,2.0,7,2,TGGTTAGTGCAGCCACTTAC,5,3179033
rdlDp,1.0,4,2,TGGGGGAGACATCTGCCATC,2,3171035
rdlDp,2.3333333333333335,8,2,TGGCGGTAACGCATTTATCT,6,3188107
rdlDp,3.6666666666666665,12,2,TGGCAACTGAACAAGGTAGG,10,3205609
rdlDp,1.6666666666666667,6,2,TGGAGGGAGAGCTCCGCACG,4,3169609
rdlDp,3.0,10,2,TGGACTTAGTGCTTAGTAGC,8,3208292
rdlDp,0.6666666666666666,3,2,TGCCCCCTAAAGAATCGCGA,1,3196658
rdlDp,2.6666666666666665,9,2,TGCACTCATTTTTGACGGAA,7,3206958
rdlDp,1.0,4,2,TGATACGCACAGCCCTCAAG,2,3191331
rdlDp,2.0,7,2,TGAATCCCAGATTGTGAAAC,5,3188736
rdlDp,3.0,10,2,TCTTAGAGTGGTCTGAATGT,8,3195866
rdlDp,7.333333333333333,23,2,TCTGTTCACCACGAGCCGAC,21,3209379
rdlDp,3.6666666666666665,12,2,TCGTTTTATCCACCGTTACC,10,3187075
rdlDp,0.6666666666666666,3,2,TCGTTAATCATCTGTGCCGT,1,3191668
rdlDp,1.0,4,2,TCGTCACTAGCTCGGCAGCA,2,3199196
rdlDp,3.6666666666666665,12,2,TCGGGTCCTCGTAATGGTAA,10,3170720
rdlDp,20.333333333333332,62,2,TCGGCCGTCGTTTGTCCCAT,60,3193617
rdlDp,5.666666666666667,18,2,TCGGCATCCTTGGAACAGAC,16,3211623
rdlDp,1.6666666666666667,6,2,TCGGACTCGTATATTTGTAA,4,3214488
rdlDp,1.0,4,2,TCGCATGCCAGCAACAGCGT,2,3170352
rdlDp,9.666666666666666,30,2,TCGAGTATTCAAGCACCGGG,28,3212428
rdlDp,3.6666666666666665,12,2,TCGACTCACGTCGTGGTAAA,10,3182283
rdlDp,2.3333333333333335,8,2,TCCGACTCAGGTATCAGTCC,6,3165551
rdlDp,3.0,10,2,TCCCTGGATAATTTGTAAGC,8,3183995
rdlDp,4.0,13,2,TCCCAGTTAATTATTTAAGA,11,3179114
rdlDp,8.333333333333334,26,2,TCCCAGCACATGCATTAAGG,24,3189236
rdlDp,0.6666666666666666,3,2,TCCAACCCGGAAATTTTGTG,1,3196218
rdlDp,4.0,13,2,TCAGAGGGTGCATTTTTGCC,11,3180651
rdlDp,6.0,19,2,TCAAATACCGCTGCTTCGCC,17,3195671
rdlDp,2.6666666666666665,9,2,TATGCCAAACCTAACCCAAA,7,3194597
rdlDp,1.3333333333333333,5,2,TATCGGCACGGTCCTGAGTC,3,3167183
rdlDp,3.3333333333333335,11,2,TACTTCTCGAAACAACTTGG,9,3195244
rdlDp,5.666666666666667,18,2,TACTCCAGCAGGGGGGATTC,16,3172578
rdlDp,7.333333333333333,23,2,TACCCTTTCGACACGAGACA,21,3199845
rdlDp,3.6666666666666665,12,2,TACAAGAGTCTGATTAGGGA,10,3191718
rdlDp,0.6666666666666666,3,2,TAATTTCAACATTTAAGGGA,1,3181154
rdlDp,2.6666666666666665,9,2,TAAGCGTTTGCAGTCGCTGA,7,3184756
rdlDp,3.0,10,2,TAACACATGATGCCTTTCCA,8,3181941
rdlDp,2.6666666666666665,9,2,GTGTAGCCTCCCCCGCATAT,7,3173850
rdlDp,5.666666666666667,18,2,GTGGGATGCAACATAGCAGC,16,3181039
rdlDp,0.6666666666666666,3,2,GTCTATAATTATAAGCAGCC,1,3189072
rdlDp,4.0,13,2,GTCGGACCCGACTTTAAAGT,11,3174884
rdlDp,4.0,13,2,GTCGCCACCTCGGGTTCAGA,11,3174914
rdlDp,3.6666666666666665,12,2,GTACCCGTTAGTTTCGGAGA,10,3192000
rdlDp,2.0,7,2,GGTGCCATGCATTGACGTAG,5,3187930
rdlDp,3.3333333333333335,11,2,GGTCTGACACCGGTGCCAAG,9,3209430
rdlDp,3.0,10,2,GGTATCCTTGGTACCCAGCG,8,3201669
rdlDp,0.6666666666666666,3,2,GGGTTAATACAGCCGTTTAG,1,3166893
rdlDp,7.333333333333333,23,2,GGGTGCGATAAATATCCGAA,21,3190855
rdlDp,1.3333333333333333,5,2,GGGGGTTACTTCTGGCGTGA,3,3184941
rdlDp,1.3333333333333333,5,2,GGGCGCCCACCAAGTCCTGT,3,3169220
rdlDp,5.666666666666667,18,2,GGGCATCTCTAGTGTGCACA,16,3186283
rdlDp,0.6666666666666666,3,2,GGGATTGCAGAAGATCTTGA,1,3213160
rdlDp,1.0,4,2,GGGACGTTGTCACATGCTTG,2,3165133
rdlDp,7.0,22,2,GGCGATTTACGAGACCATGG,20,3214000
rdlDp,4.0,13,2,GGCCCGGTACTGGGATGGCT,11,3183355
rdlDp,2.0,7,2,GGCCACAGTTGGCTATTCCC,5,3176731
rdlDp,0.6666666666666666,3,2,GGATATTTGAGGCGGAAAGG,1,3205946
rdlDp,7.333333333333333,23,2,GCGTTTCCCTAAACGAGGAC,21,3169089
rdlDp,2.3333333333333335,8,2,GCGTGTTTTGACGACCCGAG,6,3208765
rdlDp,13.666666666666666,42,2,GCGGGCCGTCTTTGTCACTC,40,3212507
rdlDp,16.333333333333332,50,2,GCGGCGGTCCAGGCGCGTTA,48,3199084
rdlDp,2.0,7,2,GCGCACTGCAGAGCTCAAGA,5,3195170
rdlDp,0.6666666666666666,3,2,GCCCTTCGGGTCTAAAGCGT,1,3194623
rdlDp,0.6666666666666666,3,2,GCCCCACGTGCATATTCGCC,1,3187843
rdlDp,5.666666666666667,18,2,GCCATGCCATCATAATTTTG,16,3184620
rdlDp,1.0,4,2,GCCATGAATCTCATCCGCAG,2,3214007
rdlDp,0.6666666666666666,3,2,GCATCAGACGTAGACTGTGC,1,3213214
rdlDp,3.6666666666666665,12,2,GCATATATTATGACGACTGC,10,3178079
rdlDp,2.0,7,2,GCAGCCACCGTATGCAAAGA,5,3192009
rdlDp,1.0,4,2,GATTCCAAGTTTGCAGGAAT,2,3178732
rdlDp,2.3333333333333335,8,2,GATGTCATTCGTGCTGTATG,6,3206564
rdlDp,0.6666666666666666,3,2,GATCGACAAGGAGCTGGGTA,1,3176653
rdlDp,0.6666666666666666,3,2,GATAGCCATTTGCTAGCTGA,1,3193418
rdlDp,0.6666666666666666,3,2,GATACTCCACAGTCAAACAT,1,3215310
rdlDp,8.333333333333334,26,2,GATAATCGGCTTCCTGACTT,24,3177560
rdlDp,27.333333333333332,83,2,GAGGACCTGAGTGTACACTA,81,3212533
rdlDp,1.0,4,2,GAGAAGGCGTTACGTCAAGT,2,3167867
rdlDp,0.6666666666666666,3,2,GACCGCTTGGAGATATTAAT,1,3183125
rdlDp,2.0,7,2,GACACTTAGGGGTTGCTGCG,5,3204174
rdlDp,1.6666666666666667,6,2,GACAAAGCTAGAGCACGCCA,4,3204461
rdlDp,4.333333333333333,14,2,GAATGAATGGGTCTGCCACG,12,3185140
rdlDp,2.0,7,2,GAACGGACTGCCGGGCCGGA,5,3186031
rdlDp,2.6666666666666665,9,2,GAAAATAAGCTTAGAGGCTG,7,3203717
rdlDp,2.6666666666666665,9,2,CTTGCGTCAGTTAGGCCTGG,7,3202394
rdlDp,5.333333333333333,17,2,CTGTCTCTCTAGTTGTTTTA,15,3198045
rdlDp,7.666666666666667,24,2,CTCTGGACGCTTTAGCAAGC,22,3192787
rdlDp,0.6666666666666666,3,2,CTCTCCCTTTGTATATCCTC,1,3208308
rdlDp,2.3333333333333335,8,2,CTCATTTGGAATAAAGTCGG,6,3205833
rdlDp,4.666666666666667,15,2,CTATCCATGGTGTACTAATG,13,3195634
rdlDp,5.0,16,2,CTATAGAAATTATGGTCATA,14,3173843
rdlDp,0.6666666666666666,3,2,CTAGTAGCCGGCTAAGTCGT,1,3199478
rdlDp,1.0,4,2,CTACCGTAAATGTTATCTCA,2,3208033
rdlDp,1.6666666666666667,6,2,CTAAGCACTGGCCAGTGGAG,4,3165550
rdlDp,0.6666666666666666,3,2,CGTTGTACATCTCGTCTGAA,1,3196703
rdlDp,3.3333333333333335,11,2,CGTTCCGAGCGACGAGGGTT,9,3173415
rdlDp,0.6666666666666666,3,2,CGTGAGATGGGCCACCAAAT,1,3202102
rdlDp,1.6666666666666667,6,2,CGGTGTCCTGTGACTGAAAT,4,3181938
rdlDp,5.0,16,2,CGGTCAGGGCACGTCAGGTT,14,3213094
rdlDp,3.3333333333333335,11,2,CGGGAGTCGTTCGAGTGGCG,9,3202890
rdlDp,0.6666666666666666,3,2,CGGCTTGAGATTGTTACCGG,1,3213566
rdlDp,3.0,10,2,CGGCCCAGGGGCCAGGGTAC,8,3172902
rdlDp,2.6666666666666665,9,2,CGGAGAACAGGGTCTGGGGG,7,3214823
rdlDp,13.666666666666666,42,2,CGCTTAGCGGAAGCAAGTGG,40,3199079
rdlDp,0.6666666666666666,3,2,CGCATTTTGTCGATACATAC,1,3169461
rdlDp,1.3333333333333333,5,2,CGATTAGGTACTGAGTCCTC,3,3179334
rdlDp,3.0,10,2,CGATCGTTCATATGGACACT,8,3174171
rdlDp,0.6666666666666666,3,2,CGACAAGTGGTCCTAACCAA,1,3200651
rdlDp,1.6666666666666667,6,2,CGAAGGTACGACTTTTGTCT,4,3180062
rdlDp,1.6666666666666667,6,2,CGAAACGGGGGGCGAATGAG,4,3183385
rdlDp,1.6666666666666667,6,2,CCTGGCCACAAGGGCTGGTT,4,3178693
rdlDp,0.6666666666666666,3,2,CCTCTCCGAGTTGCATCATC,1,3200229
rdlDp,8.0,25,2,CCTACTTCCGGTGAAGGCGA,23,3194259
rdlDp,0.6666666666666666,3,2,CCGTCTGCGGTCTTCTTAAC,1,3193872
rdlDp,2.0,7,2,CCGGTTTTAGGAGATTATAG,5,3210336
rdlDp,0.6666666666666666,3,2,CCGCACGGAGTATTGGATGG,1,3189583
rdlDp,2.3333333333333335,8,2,CCGATATTGAGGCTAGAAGA,6,3170063
rdlDp,10.666666666666666,33,2,CCGAGGCATAGTCAGTTTAA,31,3194535
rdlDp,4.666666666666667,15,2,CCCTGACATATCTTATTGTG,13,3197849
rdlDp,4.666666666666667,15,2,CCCGCGATACCAAAAAACAA,13,3171236
rdlDp,3.6666666666666665,12,2,CCCCCATCTACCACGAGAAT,10,3209050
rdlDp,2.6666666666666665,9,2,CCCCATCATTTTTCGTAGCG,7,3169087
rdlDp,5.666666666666667,18,2,CCATGCGTCTCTCTTAGTAA,16,3193388
rdlDp,1.0,4,2,CCAGTGCCAAAGCCGTCCCT,2,3175881
rdlDp,1.6666666666666667,6,2,CCAGACACAGGCTTTTCGGG,4,3181809
rdlDp,2.3333333333333335,8,2,CCAATGTGGACATTTGTTGA,6,3205405
rdlDp,1.6666666666666667,6,2,CCAACTCTGACGCCCAGTAG,4,3209411
rdlDp,1.3333333333333333,5,2,CATTTCGGAAGTCTGGACAC,3,3214847
rdlDp,3.0,10,2,CATTAGCCTGCGTCCGGGTA,8,3173707
rdlDp,3.6666666666666665,12,2,CATGGGGTCCCTTGCACAGC,10,3182436
rdlDp,3.6666666666666665,12,2,CATGACTAAGAACCCAAGGA,10,3181609
rdlDp,2.3333333333333335,8,2,CAGGGTAATGCCTCAATGGC,6,3197409
rdlDp,1.0,4,2,CAGGGCTGTACATACATCTG,2,3175536
rdlDp,2.3333333333333335,8,2,CAGCGATAAACTTTCGCTCA,6,3168196
rdlDp,0.6666666666666666,3,2,CACTAGAAACCGGTCTTATA,1,3212212
rdlDp,4.333333333333333,14,2,CACCGGCGTACTATCCCATT,12,3179542
rdlDp,6.333333333333333,20,2,CACCCGGCGTCAGCTGAGGG,18,3170522
rdlDp,6.333333333333333,20,2,CACAGCCACGCCGAGATTAC,18,3194225
rdlDp,3.0,10,2,CAATTGTCGTCCCCGATTTT,8,3200746
rdlDp,3.3333333333333335,11,2,CAAGATATGCTACCTTGTCC,9,3193921
rdlDp,1.0,4,2,CAAAGCGCGAGCTACCGGTA,2,3172239
rdlDp,5.0,16,2,ATTTGACAACGTCCAAGGAG,14,3182843
rdlDp,0.6666666666666666,3,2,ATTTCTGAAGTTCCCTGGAC,1,3198846
rdlDp,7.0,22,2,ATTGGCACTCAAAACGCTAA,20,3194451
rdlDp,4.333333333333333,14,2,ATTCATGTGAGAATTAAGTA,12,3192595
rdlDp,8.0,25,2,ATTCACCCATTAGGTCCCTC,23,3174636
rdlDp,2.0,7,2,ATTAAATGGAAATTACTTAG,5,3172236
rdlDp,3.3333333333333335,11,2,ATGTGCAACGGAGCTTCAGA,9,3215984
rdlDp,0.6666666666666666,3,2,ATGGGTTGTGAGTGTCAATC,1,3169616
rdlDp,1.0,4,2,ATGGGCACTATAAGATATGG,2,3198175
rdlDp,4.0,13,2,ATCTCTGACATCCGGGATCA,11,3196793
rdlDp,4.0,13,2,ATCGCTGAGCAGAACGCTCG,11,3198819
rdlDp,1.0,4,2,ATCATATGACGTGGTTTGGC,2,3177811
rdlDp,3.3333333333333335,11,2,ATCAGCCCGCCAAGAACAAT,9,3177572
rdlDp,1.6666666666666667,6,2,ATATGTCTCATCCTGGCCTC,4,3211882
rdlDp,6.666666666666667,21,2,ATAGAAAAGCGGTCGATGTT,19,3171233
rdlDp,1.6666666666666667,6,2,ATACTCCATTTCGTTTGATC,4,3186455
rdlDp,3.0,10,2,ATACGAGCGTATGAAAGACA,8,3194242
rdlDp,3.0,10,2,AGTGAAGGTCGGACGCTAAC,8,3189388
rdlDp,1.6666666666666667,6,2,AGTCTGTTGCCCGTGTGCCT,4,3192497
rdlDp,2.3333333333333335,8,2,AGTATAGGACTCTTTGGTCT,6,3193287
rdlDp,4.0,13,2,AGTACGGGGACTCCAAAAGA,11,3211997
rdlDp,1.0,4,2,AGGGAGAATAAAAATAGTCC,2,3179682
rdlDp,1.0,4,2,AGGGAAAGCTCTGTGATAAG,2,3183137
rdlDp,2.0,7,2,AGGCATCAGGGCACATAGGG,5,3204118
rdlDp,4.333333333333333,14,2,AGCGTCCGGTCGCCACCATC,12,3168831
rdlDp,4.0,13,2,AGATGTATGTTCACAATATA,11,3184605
rdlDp,5.333333333333333,17,2,AGACCCTGTTTCTTCGCACG,15,3184994
rdlDp,4.0,13,2,AGACCCGGTCCCGTCGTTAC,11,3208685
rdlDp,1.6666666666666667,6,2,AGAATTGAATTGGGATACAT,4,3181545
rdlDp,3.6666666666666665,12,2,AGAACCTGTGCTTGTGTTAG,10,3198806
rdlDp,0.6666666666666666,3,2,AGAACCTGGCCCCGGGCTAG,1,3187072
rdlDp,0.6666666666666666,3,2,ACTTCGTCTACCTCTATCGG,1,3200797
rdlDp,0.6666666666666666,3,2,ACTTAGGCGACCGGGGTGAT,1,3179309
rdlDp,1.6666666666666667,6,2,ACTGCCAAGCCTCCTAATGG,4,3173983
rdlDp,12.0,37,2,ACTGAGCACCGCTCACGTCA,35,3202947
rdlDp,1.6666666666666667,6,2,ACTCTCGGGGACGAGAGCAC,4,3176366
rdlDp,1.0,4,2,ACTACGGGAGGCGGGCTTTA,2,3181026
rdlDp,1.0,4,2,ACGCCTCTATCGAGGAGGGA,2,3186347
rdlDp,0.6666666666666666,3,2,ACGAGCTCGCACCTTGCATA,1,3214706
rdlDp,1.3333333333333333,5,2,ACGAATGAAAGCATAGCCAG,3,3173846
rdlDp,0.6666666666666666,3,2,ACCATTCTGCCGTGCTTGAA,1,3171212
rdlDp,2.6666666666666665,9,2,ACCATCAGGCAGAAAACAGA,7,3177266
rdlDp,3.6666666666666665,12,2,ACATGTCAGTCTCCGTCTAC,10,3178726
rdlDp,6.666666666666667,21,2,ACATGGTGAGGTTTCTCAAC,19,3199936
rdlDp,2.3333333333333335,8,2,ACATCGATGACCAACACAAA,6,3178037
rdlDp,1.0,4,2,ACATATTGCTCTCCTTTCTC,2,3164910
rdlDp,0.6666666666666666,3,2,ACAGTTCACAGCTGAGTGGG,1,3173737
rdlDp,2.0,7,2,ACACACGAGAGATCGTAATC,5,3198189
rdlDp,5.666666666666667,18,2,AATTGAGGGAGTGCTACCCG,16,3213259
rdlDp,7.666666666666667,24,2,AATCATGCGTACATAGGCAG,22,3167408
rdlDp,4.0,13,2,AATACGTGGTGCTGTGCTTT,11,3205757
rdlDp,3.0,10,2,AATACCCACCGGAGGCCCAG,8,3201685
rdlDp,5.666666666666667,18,2,AAGCCGTAGTCTGCAGCGCG,16,3171230
rdlDp,0.6666666666666666,3,2,AAGACTGAAATCCACCTAAG,1,3167845
rdlDp,3.6666666666666665,12,2,AAATGCCGCCTGGCTACGTG,10,3193619
rdlDp,0.6666666666666666,3,2,AAATACCGCCTTATTGGTCG,1,3197847
rdlDp,3.6666666666666665,12,2,AAAGCCCCAAGCGACAGCAT,10,3182929
rdlDp,2.6666666666666665,9,2,AAACCCTATATCTCCCGTCT,7,3190355
rdlDp,4.0,8,1,TTTATTTATGGTATAAGCCC,7,3202820
rdlDp,1.0,2,1,TTGTCCTGGATTCAATTTTC,1,3173165
rdlDp,1.0,2,1,TTGGTCTGCTGTCACTCGTC,1,3205774
rdlDp,10.0,20,1,TTGGGTGGACTCTGAATTTG,19,3209020
rdlDp,10.5,21,1,TTCTCGTGGGGGGTCCATCA,20,3206158
rdlDp,9.0,18,1,TTCGTCGGGGGGTCTGAACA,17,3196659
rdlDp,3.0,6,1,TTCGCGTAGTCCTGTGGGAT,5,3185328
rdlDp,3.0,6,1,TTCACCTATCAGAGACCAAA,5,3174883
rdlDp,1.5,3,1,TTCAACCTGCGCACCTCAAT,2,3207989
rdlDp,2.0,4,1,TTATGTACTATGGCCTATTT,3,3190363
rdlDp,6.5,13,1,TGTTAGGGTGGGTGAGAACT,12,3189961
rdlDp,3.0,6,1,TGTGGGAACACCCCCTTCGG,5,3180766
rdlDp,2.5,5,1,TGTGAGGTTACATAGATCCC,4,3195643
rdlDp,3.5,7,1,TGTAGCTCCGAGGATCTATC,6,3176966
rdlDp,1.5,3,1,TGGTGCTTGGGGGTTTGGCC,2,3171639
rdlDp,13.0,26,1,TGGTGCCAAACTGTTATAAG,25,3174641
rdlDp,2.0,4,1,TGGGTCTGGGAGGAACCAGG,3,3195160
rdlDp,4.5,9,1,TGGCTTAAAAGAAGGGGGAC,8,3191010
rdlDp,6.5,13,1,TGCGGAAATCCCGCTCTTTT,12,3176773
rdlDp,1.0,2,1,TGATGGATCATCTCTTGCGT,1,3213315
rdlDp,7.0,14,1,TGATCCACGAAAACCTTAGC,13,3187877
rdlDp,11.5,23,1,TGATATCCGGTTTGGATTCG,22,3188645
rdlDp,6.5,13,1,TGACTGCCCCGCGAAAGACC,12,3198919
rdlDp,3.0,6,1,TGACAGCCAGTCCGGTGTAT,5,3192298
rdlDp,4.5,9,1,TCTCTGGAAGGGCGTCTACA,8,3174997
rdlDp,2.5,5,1,TCTCAGATTGCGTCAATAGG,4,3193661
rdlDp,2.5,5,1,TCTAACAGTACTGTTATTTT,4,3201824
rdlDp,4.0,8,1,TCGTCTTGTCATAATGGCTC,7,3200542
rdlDp,4.0,8,1,TCGTATATACGGCACTTTGA,7,3178432
rdlDp,8.0,16,1,TCGGCGCAATTTGACCTCAC,15,3172889
rdlDp,4.0,8,1,TCGCGTCGTCTCACTTCTGT,7,3201673
rdlDp,3.0,6,1,TCGACTGAGTTATCTTAGTT,5,3172885
rdlDp,1.5,3,1,TCCGAGTCCTCAATCCTTTG,2,3190766
rdlDp,6.0,12,1,TCCATGGGTCGAACAACTTG,11,3204560
rdlDp,4.5,9,1,TCCAGTATAAATTCTGACGA,8,3183139
rdlDp,5.0,10,1,TCATTGGCAATATGTACAAA,9,3167575
rdlDp,1.5,3,1,TCATCCTGAATTCGCCACGG,2,3214001
rdlDp,2.5,5,1,TCAGCGAGAGATCCAGAGCT,4,3171413
rdlDp,14.0,28,1,TCACAAACTTGGCGGCCTCA,27,3186596
rdlDp,2.5,5,1,TCAACACATGTCCCCTTGGC,4,3179299
rdlDp,1.0,2,1,TATTCGTGGGGTACCGCTGT,1,3180783
rdlDp,1.0,2,1,TATAATAGCCTTAAGCCACC,1,3207930
rdlDp,4.0,8,1,TAGCTAATGTGCTCAAAGTA,7,3191937
rdlDp,3.5,7,1,TAGCCCCATGGACCTTTCAA,6,3213316
rdlDp,6.5,13,1,TAGATGAGGCACGGGTATTG,12,3168030
rdlDp,1.0,2,1,TAGAGGGTCTTTACGCCTAT,1,3209487
rdlDp,4.5,9,1,TAGAGATGCACGTCTTTGCA,8,3206751
rdlDp,3.0,6,1,TACCTCCGTCGCAACATGTG,5,3210858
rdlDp,1.5,3,1,TACATTACACCGACTATGTA,2,3194471
rdlDp,3.0,6,1,TACAGTATGTATGGGACTAC,5,3212427
rdlDp,1.0,2,1,TAAGCCCCACTGTTATTATT,1,3166334
rdlDp,8.0,16,1,TAAGAGTCTAGGAAAGCCGA,15,3212430
rdlDp,5.0,10,1,TAAACGACTCAAGTCCCGGT,9,3209038
rdlDp,5.5,11,1,TAAAAGGTACAATGCGAATC,10,3198041
rdlDp,2.0,4,1,GTTGGGTAGTTTGCGCACTT,3,3193827
rdlDp,2.5,5,1,GTGACTTCCCGAGTACCTAG,4,3181701
rdlDp,6.0,12,1,GTGAAGATCGAATTTGAAAG,11,3199780
rdlDp,2.5,5,1,GTCTCAAGTTCCTTGTGTGG,4,3174341
rdlDp,6.0,12,1,GTCGTGCAACCTATCCTAAG,11,3204244
rdlDp,2.0,4,1,GTCGCCGGGAACGTTTTCTT,3,3199734
rdlDp,6.5,13,1,GTAGCTACAAATTAGGGGAT,12,3176383
rdlDp,3.0,6,1,GTACAGCCAGGGGGACTGCA,5,3200177
rdlDp,3.5,7,1,GTAACACCCATATAGTTTCT,6,3188185
rdlDp,77.0,154,1,GGTGAGGAGCCGGGAAGATA,153,3212488
rdlDp,3.5,7,1,GGTCATGGCCTTATCGTCGT,6,3173343
rdlDp,2.0,4,1,GGTACAGTCAGTCTAGTGTA,3,3198491
rdlDp,2.0,4,1,GGGGGGTGATACGCTTTTCT,3,3198510
rdlDp,3.0,6,1,GGGGATTTATAAGTCTCCCT,5,3202948
rdlDp,10.0,20,1,GGGCTTCACGACAGACGCGA,19,3215016
rdlDp,7.0,14,1,GGGAAGCATCGTTGCTTGAC,13,3195636
rdlDp,7.5,15,1,GGCTTAGATTCAGCTCGGGT,14,3190611
rdlDp,8.5,17,1,GGCGCATGGGGCAGTTTTGC,16,3183598
rdlDp,2.0,4,1,GGCCTAAGGTTGCCTAAACA,3,3182298
rdlDp,2.0,4,1,GGCAGTCTCTGGACTTATCT,3,3201640
rdlDp,1.0,2,1,GGCACGGGTCAGGAAACAAC,1,3192243
rdlDp,4.5,9,1,GGAGTACAATATGGGGTGCA,8,3184320
rdlDp,5.0,10,1,GCTTGGCCCATATCGTGCGA,9,3207727
rdlDp,2.5,5,1,GCTTGAGTACTGCATCTAGT,4,3209974
rdlDp,2.5,5,1,GCTGCGGTGGTAGGATCCAG,4,3173085
rdlDp,1.0,2,1,GCTCTATTGTACCTAACTTG,1,3167393
rdlDp,1.5,3,1,GCTCCTCTAGGGTCTAGGGT,2,3190360
rdlDp,13.0,26,1,GCTCCGGGGAACTGCCTGAT,25,3176213
rdlDp,1.0,2,1,GCGTGTCTACGAAGTCAATC,1,3168619
rdlDp,2.5,5,1,GCGGGTCACAAACCTATCGG,4,3186244
rdlDp,3.0,6,1,GCGCGTCTCCAATCCTAGGT,5,3184121
rdlDp,1.0,2,1,GCGAGGGGAGCCAGATCCTA,1,3201830
rdlDp,1.5,3,1,GCCTGTTTCGAGCAGGCTAT,2,3182806
rdlDp,20.0,40,1,GCCTGCTGCACGAACTTCTC,39,3196437
rdlDp,10.0,20,1,GCCGGGGATTCCGTATCTAA,19,3173130
rdlDp,1.5,3,1,GCCCGTGGGTCGTTTGCGGA,2,3188517
rdlDp,1.0,2,1,GCCAAGATAATCCACCCCCC,1,3167154
rdlDp,2.5,5,1,GCATGCGGGATAGAGGTCGC,4,3169079
rdlDp,5.5,11,1,GCATAAGATCAGTAGGTGGA,10,3176910
rdlDp,1.0,2,1,GCAGGGACAGCTCGAGCATT,1,3194606
rdlDp,3.0,6,1,GCACTGTTTAAGCCTTGGAA,5,3170571
rdlDp,1.0,2,1,GCACACATACTTTTTCATAT,1,3205039
rdlDp,6.5,13,1,GCACAATGATTGGTTTTGCA,12,3192970
rdlDp,8.0,16,1,GCAAACCGCTGTACCCAGGA,15,3168491
rdlDp,3.0,6,1,GATGGTTGAGGTTCGTGGTA,5,3168153
rdlDp,11.5,23,1,GAGTGGTACTTTGCTTTGGG,22,3192841
rdlDp,4.5,9,1,GAGACCCCTAGACCAGGGCT,8,3188391
rdlDp,3.0,6,1,GAGACCATTTACGAGGGAAG,5,3187190
rdlDp,3.5,7,1,GACTGTCAGCACGCCGTCCA,6,3198502
rdlDp,8.0,16,1,GACTCTTCGCATTAGCAATG,15,3176642
rdlDp,3.0,6,1,GACCACGCAGCCAAGGTGTA,5,3203863
rdlDp,28.5,57,1,GAACTCTACTTCACGATGCA,56,3181522
rdlDp,6.5,13,1,CTTTATCCCGGGCCGGGCAT,12,3190314
rdlDp,1.0,2,1,CTTGTCTGGTCGTACACTGA,1,3194470
rdlDp,4.5,9,1,CTTACCTTGAGAACATGAAT,8,3189823
rdlDp,4.0,8,1,CTGTTGGGGATCAATGGTGA,7,3181702
rdlDp,8.5,17,1,CTGGGGTCTCATATCTAAGC,16,3176744
rdlDp,21.5,43,1,CTCTCACTATACCGAGTGCC,42,3209375
rdlDp,3.5,7,1,CTCCGTAACAGGCAACGGTT,6,3191783
rdlDp,2.5,5,1,CTCCGAATACGTACAGCGGG,4,3199610
rdlDp,1.5,3,1,CTCCCCAAATATGGGTTGCT,2,3194135
rdlDp,5.0,10,1,CTCATCCGAGGATGCCGCTA,9,3192526
rdlDp,2.0,4,1,CTATTCTCTCCTCCAAATCT,3,3184955
rdlDp,12.5,25,1,CTATGTTAATTCTGGGGTCA,24,3176756
rdlDp,2.5,5,1,CTATACAGAACTCTGCCAGG,4,3174882
rdlDp,3.0,6,1,CTAGGTGCTGCCCACATAAG,5,3166578
rdlDp,2.5,5,1,CTAGCGCCTTTCTGCAGCGA,4,3196386
rdlDp,7.5,15,1,CGTTAGGGAGTAGTTTCTGG,14,3171709
rdlDp,15.0,30,1,CGTCGTACTATGTAGTTTAC,29,3195989
rdlDp,2.5,5,1,CGGGTAATAGACCGATCCAT,4,3207363
rdlDp,4.5,9,1,CGGGGCCGGGGCCTCGAAAG,8,3189776
rdlDp,9.5,19,1,CGGGATTGTAGCCAGCATCA,18,3212866
rdlDp,10.0,20,1,CGGGAGTCTCTAACGAGCGT,19,3212859
rdlDp,9.5,19,1,CGGAAACCAAATTAGAGTCA,18,3182023
rdlDp,4.5,9,1,CGCTGCTGCTCAGGCATTCA,8,3167143
rdlDp,2.5,5,1,CGCGGCTCATTCTGGTAAGG,4,3191559
rdlDp,2.0,4,1,CGCAGGGACGGGATAGACTC,3,3173582
rdlDp,2.5,5,1,CGCAATCAGGGCCGGAATGG,4,3196882
rdlDp,5.5,11,1,CGATAAATCACATGAAGTCC,10,3182173
rdlDp,3.0,6,1,CGAGATCTAGCGCGACGTTC,5,3201472
rdlDp,6.5,13,1,CCTTTGCCGCTCGTTGCCTG,12,3198450
rdlDp,7.5,15,1,CCTTCAGAAAGTCCTAACTA,14,3180400
rdlDp,2.5,5,1,CCTGGCGCGCTCGATCGCAT,4,3166571
rdlDp,3.5,7,1,CCTCTTTCTCGAGGTGAGCC,6,3196788
rdlDp,13.0,26,1,CCTCTCTCAAAGTAGCACAG,25,3171967
rdlDp,3.0,6,1,CCTAGCGCTTGCGAACATTA,5,3177146
rdlDp,1.0,2,1,CCGTCTTATTGATCGGAGTG,1,3198068
rdlDp,2.0,4,1,CCGTAATGATCTTACTGCCC,3,3188264
rdlDp,5.5,11,1,CCGATTCAGAACTAAAGACT,10,3176776
rdlDp,6.5,13,1,CCCTGTCAGTCTTTTCGGTC,12,3173598
rdlDp,7.0,14,1,CCCTGCAGCGCCTCGTTTTT,13,3173656
rdlDp,15.0,30,1,CCCCTAGCTGAGGCGGCGAG,29,3191865
rdlDp,1.0,2,1,CCCATAAAGGACGACTGTCC,1,3187860
rdlDp,3.5,7,1,CCCAGGAGACGCGATCTGTT,6,3188403
rdlDp,1.5,3,1,CCACCTGAGGCTGATTGCGG,2,3204190
rdlDp,2.0,4,1,CATGGTTAACCTACAAAGCA,3,3202952
rdlDp,1.0,2,1,CATATTTAGCCCCGAAAGAC,1,3179093
rdlDp,6.0,12,1,CATATAAGGTTTACCGATGT,11,3210471
rdlDp,1.5,3,1,CAGTTTATTACGCTGTACTC,2,3192984
rdlDp,1.5,3,1,CAGGGTTTCAATCGCTGCGC,2,3188557
rdlDp,5.0,10,1,CAGGCTAAAAGGCATAGTCC,9,3200847
rdlDp,14.0,28,1,CAGAGGGGATCTTTGGAGAC,27,3176240
rdlDp,12.0,24,1,CACGGTTGTTTCGATCGGAA,23,3204141
rdlDp,2.0,4,1,CACAGGAGCGCCCTAAGATT,3,3191562
rdlDp,12.0,24,1,CAATTCCTACGTCTTCCTAA,23,3205562
rdlDp,1.5,3,1,CAATGTCGTTTTCGAATATT,2,3166950
rdlDp,10.0,20,1,CAACGCCATTCCCCAACGGC,19,3176680
rdlDp,1.0,2,1,CAACCTAGGTCTATGAGACA,1,3201918
rdlDp,1.5,3,1,CAAAGGCGGTCTCGAGCCAA,2,3211232
rdlDp,3.5,7,1,CAAACTTTACAGGTGAAAGT,6,3190589
rdlDp,4.5,9,1,CAAACCATCGGCACAAACAT,8,3178012
rdlDp,2.5,5,1,ATTGTGACTACCCATTAATG,4,3199447
rdlDp,1.0,2,1,ATTCGCCTTCCAGGAGGTCA,1,3181501
rdlDp,3.0,6,1,ATGTCTGGCCATAACCGGGT,5,3192977
rdlDp,2.5,5,1,ATGCTATTGAGACTTACGGC,4,3192696
rdlDp,1.0,2,1,ATGCACGGCCAGGATCAGCC,1,3187390
rdlDp,1.0,2,1,ATCGCAGAGGGCCACGTGGG,1,3207730
rdlDp,1.0,2,1,ATCCCGTTCAAGGTCTGGGC,1,3210352
rdlDp,3.0,6,1,ATATTGATGAGGCTTGGACG,5,3169362
rdlDp,2.5,5,1,ATAGAGCAGCCTTGGTTTAT,4,3177901
rdlDp,2.0,4,1,ATACCTGCCTTTAGGACAAG,3,3198364
rdlDp,4.5,9,1,ATAATGACCTCCTGACACTG,8,3168173
rdlDp,12.5,25,1,AGTTTGGATGCCAGCACCAT,24,3165549
rdlDp,35.0,70,1,AGTTGCCAATTACGTATCAT,69,3210485
rdlDp,23.0,46,1,AGTTCCCCCAGAACGGGCCA,45,3214248
rdlDp,1.0,2,1,AGTGATTATCTAGCTAAGGA,1,3207283
rdlDp,2.0,4,1,AGTCCTCCACCGATTTGTGG,3,3202381
rdlDp,2.5,5,1,AGTCAAAGGCCTGTGAGTCC,4,3190374
rdlDp,1.5,3,1,AGGTCTAGTATCAGCGTTGG,2,3184227
rdlDp,2.0,4,1,AGGGCATTGCTTCGATTGTA,3,3201834
rdlDp,3.5,7,1,AGGAACTGCGATAGTCTGGC,6,3177515
rdlDp,2.5,5,1,AGCGCCAAAAGCTTAGCCTA,4,3167284
rdlDp,3.0,6,1,AGATTACAAGGCAATAGCTG,5,3172899
rdlDp,1.5,3,1,AGATGTCAATTACCGGGAAT,2,3187933
rdlDp,25.5,51,1,AGAGGGGCCGGATCCGCTGG,50,3193623
rdlDp,1.0,2,1,AGAGCACTGATGCGTGGTCG,1,3202975
rdlDp,11.5,23,1,AGACTCCAGGTGTATTAAGG,22,3207500
rdlDp,1.0,2,1,AGAAGGGATGGCACACAACG,1,3191748
rdlDp,9.0,18,1,AGAAACAGGTGGGCGTTGCT,17,3193871
rdlDp,4.0,8,1,ACTTGACTGACTACCGGCCT,7,3207398
rdlDp,1.5,3,1,ACTTATAGTATGGTCCGCTG,2,3206435
rdlDp,2.5,5,1,ACTCATAATCGAGTGAGGGT,4,3209453
rdlDp,3.0,6,1,ACTATATTAGGGATCGTAAA,5,3206508
rdlDp,3.0,6,1,ACGGACGTCATTAGGGGGAT,5,3203202
rdlDp,5.5,11,1,ACGCGACTCGCGCTACCGCG,10,3174916
rdlDp,4.0,8,1,ACGCAGCCGGGATTCCGGCA,7,3191769
rdlDp,2.0,4,1,ACGAGGAACCATAGACGTAT,3,3180426
rdlDp,15.0,30,1,ACCTCAACTCCCTTTTCCAA,29,3197826
rdlDp,6.0,12,1,ACCCTAAGGGTCGGGACTCA,11,3192274
rdlDp,4.5,9,1,ACCCGACCCCAAGGGTGTGT,8,3180639
rdlDp,1.0,2,1,ACCATTGCTCGGTTCTTCTG,1,3202082
rdlDp,3.5,7,1,ACCACGGAGCCATATATATA,6,3208298
rdlDp,2.0,4,1,ACCACATTTTTTTACGGGAC,3,3176334
rdlDp,11.5,23,1,ACATGGATTGAGACCACGAA,22,3170296
rdlDp,9.0,18,1,ACAGCCATACGATGGGTCAC,17,3187635
rdlDp,5.0,10,1,ACAAGGTAAACCTCCAAGTT,9,3187117
rdlDp,2.0,4,1,AATCAGATGTGGGTCGATAA,3,3178916
rdlDp,3.5,7,1,AAGTCGGGGGGGTTACCTTG,6,3167136
rdlDp,9.0,18,1,AAGTAAGAATCAAGCTTATA,17,3168801
rdlDp,4.0,8,1,AAGGTTAGCAAGCTGTGGTT,7,3192124
rdlDp,1.0,2,1,AAGATCTTCGCTTAAAATCA,1,3195745
rdlDp,1.0,2,1,AAGAAGAGTAATCATGTTTA,1,3197209
rdlDp,1.5,3,1,AACTGTCGCAGCTGATCTAA,2,3175539
rdlDp,3.0,6,1,AACGGAACAGTAAACAAAAA,5,3212601
rdlDp,1.0,2,1,AACCTAGGCTGCAGGGTACT,1,3174018
rdlDp,3.5,7,1,AAATTGCGGGATCGAGATCC,6,3178415
rdlDp,7.5,15,1,AAATGCCAGCTGTAATATTG,14,3195156
rdlDp,3.5,7,1,AAAGGGATGAGATGGTCCGT,6,3192995
rdlDp,5.5,11,1,AAACCCAGGGTCCACCGTAG,10,3196718
rdlDp,1.5,3,1,AAAAACGAGGCATTAACTTG,2,3206162
rdlDp,0.01639344262295082,60,60,ATTGTTAGACAGCCTCACTC,0,3208862
rdlDp,0.023255813953488372,42,42,ACACCTTAGTACAGACACCT,0,3183966
rdlDp,0.02631578947368421,37,37,TGTCGGGCAGCTATCGGACC,0,3186820
rdlDp,0.02631578947368421,37,37,AAGTAAGTGTGGTGTAACCA,0,3174396
rdlDp,0.030303030303030304,32,32,CAACGCCAACGTAGAAGGGG,0,3196922
rdlDp,0.030303030303030304,32,32,ACTGATCCGGCTTGTTACAA,0,3172159
rdlDp,0.03125,31,31,TCGGCCCTACGGTGATTGAC,0,3188380
rdlDp,0.03125,31,31,AAGTCTTTAATTGACGAGTC,0,3179079
rdlDp,0.03225806451612903,30,30,TATACAGGGAATTACAATAT,0,3168453
rdlDp,0.03225806451612903,30,30,GACACCGTTAATGAGCAGAC,0,3171380
rdlDp,0.034482758620689655,28,28,GAGTGGTGTACATAGACATG,0,3192190
rdlDp,0.03571428571428571,27,27,CTACCTAAGTACGGGGACCT,0,3172740
rdlDp,0.03571428571428571,27,27,ACCATCACAGCATGGCCGTC,0,3164803
rdlDp,0.037037037037037035,26,26,TTCGGCAGAGCAAAGGAAAT,0,3171149
rdlDp,0.037037037037037035,26,26,CTGACTATGCTCAATGACAC,0,3201632
rdlDp,0.038461538461538464,25,25,GGTAGACAATGTGATGTAAT,0,3182282
rdlDp,0.038461538461538464,25,25,CCAGGGTCGTGGCATACGTA,0,3179081
rdlDp,0.038461538461538464,25,25,ATATCCCTCAGAGGGGCGGG,0,3177509
rdlDp,0.038461538461538464,25,25,AGCTTCAATGCATATACCCC,0,3194973
rdlDp,0.038461538461538464,25,25,AATGACCGTGGAGGCAACGG,0,3194583
rdlDp,0.038461538461538464,25,25,AACCGGCTTTTAGTATTGCT,0,3212470
rdlDp,0.04,24,24,TGGCAGGATGTGTACGGTCG,0,3213303
rdlDp,0.04,24,24,TCGCATTTCCCGCCAGGTAC,0,3191016
rdlDp,0.04,24,24,GGTCAGGGCTCCAGGATGGT,0,3168159
rdlDp,0.04,24,24,AATAAACAGAAACAGGGGAG,0,3193170
rdlDp,0.04,24,24,AACCTAAAGGTGTCCTCAGG,0,3166764
rdlDp,0.043478260869565216,22,22,TACAGGACATGGAATTGAGT,0,3188758
rdlDp,0.043478260869565216,22,22,CGACATGCGGATCCGTGGGT,0,3193828
rdlDp,0.043478260869565216,22,22,AGTCAAATTGTGCAGCGACG,0,3171608
rdlDp,0.045454545454545456,21,21,TAAGCTTGGCTGATCGTGTG,0,3193679
rdlDp,0.045454545454545456,21,21,GAACTCAGAACTACATAAAT,0,3191664
rdlDp,0.045454545454545456,21,21,CCTACGAAGATCATCGTTAC,0,3205407
rdlDp,0.045454545454545456,21,21,CCGGTATGAAGCTGGGGATC,0,3165932
rdlDp,0.045454545454545456,21,21,CATGCTCATTTCTGGTGGGT,0,3192852
rdlDp,0.045454545454545456,21,21,AGCACCAATTCTGCGACCAA,0,3172839
rdlDp,0.045454545454545456,21,21,ACTGACGGAGCGTCACTAAC,0,3182291
rdlDp,0.045454545454545456,21,21,ACAGGTCTCAGAACTGGGCA,0,3204360
rdlDp,0.045454545454545456,21,21,AAATGCTTGCAAGCGAAAAT,0,3198268
rdlDp,0.047619047619047616,20,20,TGGGACAGTTAAGCCCAGAC,0,3179123
rdlDp,0.047619047619047616,20,20,GTTATGCGCCATTTTGGATA,0,3207502
rdlDp,0.047619047619047616,20,20,GATAGGCGCTAATGTTATTG,0,3168151
rdlDp,0.047619047619047616,20,20,ATCAGCGCCTTTTGAAGAAC,0,3170111
rdlDp,0.05,19,19,TGGTAGAGCCGCCGTCGTCG,0,3179147
rdlDp,0.05,19,19,TGATTCAATACATCCGGTGT,0,3187178
rdlDp,0.05,19,19,TAAACCCTTAAATACGGAAG,0,3182143
rdlDp,0.05,19,19,GGGTAGTTCAGCCTCGGCTG,0,3181923
rdlDp,0.05,19,19,GGCATGATTAAACGTCCCGT,0,3181611
rdlDp,0.05,19,19,GACTCTGACCTTGTTGGACG,0,3191662
rdlDp,0.05,19,19,GACCCAGGTCAGTATACAAT,0,3185058
rdlDp,0.05,19,19,CGCAGGGCTTACGCTGACAC,0,3173131
rdlDp,0.05,19,19,CATAGTCCTCATGGATAAGT,0,3172959
rdlDp,0.05,19,19,ATCTCAGCTATATGAGTAGT,0,3190582
rdlDp,0.05,19,19,ACCTCCGTGATGCGGTGATC,0,3174401
rdlDp,0.05,19,19,ACCGGGACCCTTGATAGCTA,0,3208009
rdlDp,0.05263157894736842,18,18,TCGTCCATATTCCTTGGCTT,0,3185304
rdlDp,0.05263157894736842,18,18,TCGGGGGTATCCGTAAGATC,0,3193282
rdlDp,0.05263157894736842,18,18,TATCTGGACCGATCTCGTAC,0,3190733
rdlDp,0.05263157894736842,18,18,GAGCATTATGGTAGATGTTC,0,3200769
rdlDp,0.05263157894736842,18,18,GAAGCAGTAGGTAGGACCTC,0,3211220
rdlDp,0.05263157894736842,18,18,CTACTACATGATGACCTCAC,0,3214188
rdlDp,0.05263157894736842,18,18,CGGTCAGGATCAAGTCAAGC,0,3172228
rdlDp,0.05263157894736842,18,18,CCACCCCATCTTATGTGTGA,0,3193664
rdlDp,0.05263157894736842,18,18,ACAGGTTTACTCGTAGATTG,0,3194616
rdlDp,0.05263157894736842,18,18,AATATAAGTCAGATCACAAT,0,3205370
rdlDp,0.05263157894736842,18,18,AAGGATACCGTGCTGGCGAT,0,3182467
rdlDp,0.05263157894736842,18,18,AAGCGTTGAAGCCAGGAGCA,0,3206633
rdlDp,0.05263157894736842,18,18,AAGAACTCTCTGGGAAGTGC,0,3202305
rdlDp,0.05263157894736842,18,18,AAAAGCCCGTCAGGCAAATC,0,3186149
rdlDp,0.05555555555555555,17,17,TGGTCCCCACTGTAAGAAGT,0,3177066
rdlDp,0.05555555555555555,17,17,TAACTGCGCCGGATAGCTCA,0,3171844
rdlDp,0.05555555555555555,17,17,GTAATTGCTACACCGTGAAC,0,3191714
rdlDp,0.05555555555555555,17,17,GGGGTCAAACCGTTCCTAAT,0,3181853
rdlDp,0.05555555555555555,17,17,CGTTGATTTTCGCTGCACGT,0,3170246
rdlDp,0.05555555555555555,17,17,CGTGGCTGGTCCCGGTAACT,0,3200682
rdlDp,0.05555555555555555,17,17,CGAGGAATACTCGTGACCGT,0,3208895
rdlDp,0.05555555555555555,17,17,ACAACCGGACATATGGGCGT,0,3191316
rdlDp,0.05555555555555555,17,17,AAGTGCTGTTCGAGGCAACC,0,3190876
rdlDp,0.05555555555555555,17,17,AACGTCATCCAGAAGTCGCA,0,3177544
rdlDp,0.05555555555555555,17,17,AACGGCTAGTTCTTATACCT,0,3174072
rdlDp,0.058823529411764705,16,16,TTTTCTACGTGATTGATACT,0,3182463
rdlDp,0.058823529411764705,16,16,TTGGGTAGTCCCTTGGTGGT,0,3167670
rdlDp,0.058823529411764705,16,16,TTGGCGACGGAGTCGGGGGT,0,3164804
rdlDp,0.058823529411764705,16,16,TTCGCGAGATGTGCGCGCGT,0,3193414
rdlDp,0.058823529411764705,16,16,TCCCTGGGATGATCCACGCA,0,3203782
rdlDp,0.058823529411764705,16,16,GGTATCTATCGTTTTTTTAC,0,3202306
rdlDp,0.058823529411764705,16,16,GGTAGGCCCTGGGCTTAACT,0,3182044
rdlDp,0.058823529411764705,16,16,GGGGATTGTACGACCCTCCA,0,3181209
rdlDp,0.058823529411764705,16,16,GCTACGCCTGCCACCTCAGC,0,3198811
rdlDp,0.058823529411764705,16,16,GAACTGGTAATGCGTTTATG,0,3187574
rdlDp,0.058823529411764705,16,16,GAAATCCTTGGACGAAGAAG,0,3169448
rdlDp,0.058823529411764705,16,16,CTTTGGGTGTTTGTACAGAA,0,3214562
rdlDp,0.058823529411764705,16,16,CTTCAGGGTCCCGTTAAGTC,0,3211339
rdlDp,0.058823529411764705,16,16,CTTATAAGTTCCAGAATCCG,0,3198180
rdlDp,0.058823529411764705,16,16,CTGACTCATTGGGCGGCAGT,0,3177217
rdlDp,0.058823529411764705,16,16,CTACTAAGTTATTCCGCACA,0,3208338
rdlDp,0.058823529411764705,16,16,CGTTGCCGTGGCGACAGTGT,0,3206976
rdlDp,0.058823529411764705,16,16,CGAGGATCAGCATTAGTCGT,0,3193830
rdlDp,0.058823529411764705,16,16,CAGCGTTGGCGCATACCCCC,0,3167392
rdlDp,0.058823529411764705,16,16,CAAGTGGTGCGTTTATAGAG,0,3184207
rdlDp,0.058823529411764705,16,16,CAAGCGATATTCAGACCAAG,0,3201124
rdlDp,0.058823529411764705,16,16,ATGTCTTCGCACAATTTTCA,0,3192401
rdlDp,0.058823529411764705,16,16,ATCAATTCGTCTAGGTAACA,0,3196879
rdlDp,0.058823529411764705,16,16,ATAGCCTGTGCACTTGAGCC,0,3166577
rdlDp,0.058823529411764705,16,16,AGGAAGGGTGCCCATGAAAT,0,3208417
rdlDp,0.058823529411764705,16,16,AGCTCTGGTTCGTTGTATCA,0,3210770
rdlDp,0.058823529411764705,16,16,ACTCTAGCAAGAGGGCCATC,0,3207659
rdlDp,0.0625,15,15,TCTCACCACGGTTTAATTAG,0,3171840
rdlDp,0.0625,15,15,GTTTATCTGGGGTCACTACT,0,3193285
rdlDp,0.0625,15,15,GGGAATGTCCATACACCTGT,0,3166731
rdlDp,0.0625,15,15,GACTGTAAAAATTATGGTAC,0,3174208
rdlDp,0.0625,15,15,GACAATAGGCATAACAACAA,0,3180574
rdlDp,0.0625,15,15,CTGGGTTGCTCGGTCTATCA,0,3182470
rdlDp,0.0625,15,15,CTCCCGATGGTTGCTTTTGT,0,3175893
rdlDp,0.0625,15,15,CTCATTCCAGCGCGCACCCG,0,3192842
rdlDp,0.0625,15,15,CTACAGCCAGTAACAGGACT,0,3209802
rdlDp,0.0625,15,15,CGATCAGTGGCAGCGAGCAA,0,3191765
rdlDp,0.0625,15,15,CCCTCGGCTTGATTGCCCTA,0,3191302
rdlDp,0.0625,15,15,CCAGACTCTGGTTTGACTCA,0,3206970
rdlDp,0.0625,15,15,CACTTTTAGGGCAAGGCGAC,0,3169976
rdlDp,0.0625,15,15,ATTAGGGTAGTTGATCCTGT,0,3172852
rdlDp,0.0625,15,15,ATAGAGGAGGGACCATAGGT,0,3201962
rdlDp,0.0625,15,15,ATAAGTTGTTCCTGTTGTAG,0,3174131
rdlDp,0.0625,15,15,AGTTAAAGGCGTGTGAGACA,0,3164789
rdlDp,0.0625,15,15,AGTAGGGGGCACATCTCACT,0,3204371
rdlDp,0.0625,15,15,AGCACACCTCGACCTAGAAG,0,3186321
rdlDp,0.0625,15,15,AACAGCTCGAGACCAAATCC,0,3174527
rdlDp,0.06666666666666667,14,14,TGCTTGGAATGTACCGTTAC,0,3194091
rdlDp,0.06666666666666667,14,14,TGACTAGGTCAGAACCTTCC,0,3181553
rdlDp,0.06666666666666667,14,14,TGACGGTGCGTCTTATAGCG,0,3181954
rdlDp,0.06666666666666667,14,14,TCCCAGTTGTACGTGGTCTA,0,3164741
rdlDp,0.06666666666666667,14,14,GTGGCGGCCCCTAGTAGCGA,0,3204052
rdlDp,0.06666666666666667,14,14,GTGAGCCGCCGAGTTTATTG,0,3206697
rdlDp,0.06666666666666667,14,14,GTCGGCCAGGCGATAGGGTC,0,3214177
rdlDp,0.06666666666666667,14,14,GAGCCTCGGTATGGAACATC,0,3200315
rdlDp,0.06666666666666667,14,14,GAATAACGCTGACTTTAATC,0,3181949
rdlDp,0.06666666666666667,14,14,CTCAAAGCTGCTGGCTACAT,0,3165803
rdlDp,0.06666666666666667,14,14,CTAACTGTTCAGGACCATAG,0,3169140
rdlDp,0.06666666666666667,14,14,CGCTTTTTCGTTTCTAGGCC,0,3197565
rdlDp,0.06666666666666667,14,14,CGACCGAGTGTTGAATTTGC,0,3175562
rdlDp,0.06666666666666667,14,14,CCTCATCGTAAGTCTGGGTA,0,3164316
rdlDp,0.06666666666666667,14,14,CATTCCCGGGGCGTCGAGTA,0,3182146
rdlDp,0.06666666666666667,14,14,CATGATACAAACCGCTCCGT,0,3208340
rdlDp,0.06666666666666667,14,14,CATATCGGCAACAATGCTCA,0,3183964
rdlDp,0.06666666666666667,14,14,ATGTTCTACTCCCGGACATC,0,3177170
rdlDp,0.06666666666666667,14,14,ATGATACTCTGATAATAAAG,0,3172762
rdlDp,0.06666666666666667,14,14,AGATCAGATGCACTCAGGTC,0,3191695
rdlDp,0.06666666666666667,14,14,ACTCGGACCGCTCTATATGA,0,3190728
rdlDp,0.06666666666666667,14,14,ACTATCTCCAGCCCGGGTCT,0,3179497
rdlDp,0.06666666666666667,14,14,AATGAAAATTCTTGTAAAGC,0,3203969
rdlDp,0.06666666666666667,14,14,AATCGTCGGCCATGCTCGGA,0,3188147
rdlDp,0.07142857142857142,13,13,TTCGCCGCCATACCTTGCCC,0,3168565
rdlDp,0.07142857142857142,13,13,TTACTACAAGTGTGGCACAA,0,3182421
rdlDp,0.07142857142857142,13,13,TATTTGCTTCAGATTCCAGC,0,3167707
rdlDp,0.07142857142857142,13,13,TACCGGGGTGACAACTAGGT,0,3194828
rdlDp,0.07142857142857142,13,13,TAATTAAAGGTCAAATTTTA,0,3192212
rdlDp,0.07142857142857142,13,13,GTTCACCGGGTAAGGAAATC,0,3200294
rdlDp,0.07142857142857142,13,13,GTATCCCGTGTAGATCGTTC,0,3177521
rdlDp,0.07142857142857142,13,13,GGTGAATGCGTCGTTCGTAA,0,3167385
rdlDp,0.07142857142857142,13,13,GGTAGCGTTAATGGCTGGAA,0,3185783
rdlDp,0.07142857142857142,13,13,GGGTGCTACGCACCGGGCGC,0,3199823
rdlDp,0.07142857142857142,13,13,GGGAACTTTTTCTGCCACTA,0,3200040
rdlDp,0.07142857142857142,13,13,GGCTGCGGCTCGAAGCTAAC,0,3198814
rdlDp,0.07142857142857142,13,13,GCTGACTCGGCTCCCTGTTG,0,3192266
rdlDp,0.07142857142857142,13,13,GCGCACACACGAAGTCCAGC,0,3179527
rdlDp,0.07142857142857142,13,13,CTTTGTTCTCGGTCCTTGCT,0,3202455
rdlDp,0.07142857142857142,13,13,CTCTGAGGTGACCCCAAGCA,0,3208587
rdlDp,0.07142857142857142,13,13,CGAATAGTGTAGCAGCGCAT,0,3185826
rdlDp,0.07142857142857142,13,13,CGAATAAGGTATTAAGTGGT,0,3188035
rdlDp,0.07142857142857142,13,13,CCCTATAGCACCTCAACGGA,0,3164522
rdlDp,0.07142857142857142,13,13,CAGTGTTCCACCAAAAACGG,0,3167544
rdlDp,0.07142857142857142,13,13,CAACATGGTAGTAATCAGCT,0,3205027
rdlDp,0.07142857142857142,13,13,ATTTGCCCGCTGTGCCGCCC,0,3185815
rdlDp,0.07142857142857142,13,13,ATTCTGTGGTGGCGAAGTGT,0,3207495
rdlDp,0.07142857142857142,13,13,ATGTGTGGTCCACAGGAGCC,0,3193945
rdlDp,0.07142857142857142,13,13,ATGCTGGTGGCATGGATCTT,0,3172633
rdlDp,0.07142857142857142,13,13,ATGCATGTCTGTCTACCTGG,0,3213963
rdlDp,0.07142857142857142,13,13,ATCGGGAAAGCATAATCAAT,0,3184808
rdlDp,0.07142857142857142,13,13,AGCAGGCTAGAATGTGGGTC,0,3187088
rdlDp,0.07142857142857142,13,13,ACTTAACGGTTCCGAGTGGG,0,3177201
rdlDp,0.07142857142857142,13,13,ACTAGCAGGATTTATCGTTA,0,3181988
rdlDp,0.07142857142857142,13,13,ACCCATGAAAGCTAACGATC,0,3210772
rdlDp,0.07142857142857142,13,13,ACAGGCTTCTAACTGCCGGC,0,3201151
rdlDp,0.07142857142857142,13,13,AACTAAAAAGGTTAAGTGGA,0,3184948
rdlDp,0.07142857142857142,13,13,AAATGGTCTTTACATCGATA,0,3165283
rdlDp,0.07142857142857142,13,13,AAAGGATACGATCAGAAATG,0,3176906
rdlDp,0.07692307692307693,12,12,TTTCCTCGACATAGGAAGAC,0,3191297
rdlDp,0.07692307692307693,12,12,TTGGGTGCCAAATGACCAAT,0,3171490
rdlDp,0.07692307692307693,12,12,TTGGCCCACAAGGCCATCGA,0,3203849
rdlDp,0.07692307692307693,12,12,TTGACCGCTTCTTGAAGTGC,0,3171512
rdlDp,0.07692307692307693,12,12,TGTCGCGCGGGATACGCGTG,0,3205316
rdlDp,0.07692307692307693,12,12,TGTAGCACGACACAAGGCAT,0,3213879
rdlDp,0.07692307692307693,12,12,TGCTCATTCGTACACTCAAG,0,3195555
rdlDp,0.07692307692307693,12,12,TGAGTCTTATTTAGAACAAG,0,3188851
rdlDp,0.07692307692307693,12,12,TCTTATTTACGCTTTGTCTG,0,3191693
rdlDp,0.07692307692307693,12,12,TCGATCATCCTAAGAGCTGG,0,3202273
rdlDp,0.07692307692307693,12,12,TCCAACGCGCCTGACGGGAG,0,3211866
rdlDp,0.07692307692307693,12,12,TCAGGTACGCAAATCGGGAA,0,3206686
rdlDp,0.07692307692307693,12,12,TCAGCGGCGGCTCATAGGGA,0,3177568
rdlDp,0.07692307692307693,12,12,TAATATTCTCCGTCAGAGCA,0,3183265
rdlDp,0.07692307692307693,12,12,GGTTTCGAGTCGCTATACGT,0,3186827
rdlDp,0.07692307692307693,12,12,GGGACCGGCGCAGACGCCCA,0,3164775
rdlDp,0.07692307692307693,12,12,GGAGCTCGGCGGGTTGCGAA,0,3170746
rdlDp,0.07692307692307693,12,12,GCCGGGCCGTAGGGAGCACG,0,3213189
rdlDp,0.07692307692307693,12,12,GCATCAGTCCAGAGTCCAAT,0,3173062
rdlDp,0.07692307692307693,12,12,GATGCCTTTGGACTTCTACA,0,3187086
rdlDp,0.07692307692307693,12,12,CTTCATTTCCCCTTCGCCGT,0,3166104
rdlDp,0.07692307692307693,12,12,CTTATCCTGGGAGCACCGGT,0,3190118
rdlDp,0.07692307692307693,12,12,CTTACCAGATGGGTAAAGCA,0,3198954
rdlDp,0.07692307692307693,12,12,CTGGAAGTAGACGCGACAGC,0,3184621
rdlDp,0.07692307692307693,12,12,CTAATACTGATTAGGCCTTA,0,3181626
rdlDp,0.07692307692307693,12,12,CGCGTGCCTTCTTTGAAAGC,0,3209763
rdlDp,0.07692307692307693,12,12,CGCACGCCTTTATGGGGGAT,0,3199739
rdlDp,0.07692307692307693,12,12,CGATCGACCGAAGATAGATA,0,3186188
rdlDp,0.07692307692307693,12,12,CGACGCTGTTCTGACGTTTT,0,3214456
rdlDp,0.07692307692307693,12,12,CCTGTGTAAAGGGGCAGACA,0,3208303
rdlDp,0.07692307692307693,12,12,CCTGGCCACTATATAGTATG,0,3212345
rdlDp,0.07692307692307693,12,12,CCATGGGATACGGAGTGTCC,0,3175524
rdlDp,0.07692307692307693,12,12,CCAATTCTTGTTCAACTGCC,0,3209282
rdlDp,0.07692307692307693,12,12,CAGGTGTGCGTTCGGTTCGG,0,3179680
rdlDp,0.07692307692307693,12,12,CAGGTGCAATCAGATTTCCC,0,3204346
rdlDp,0.07692307692307693,12,12,CAGAATGTCATCCATCGTTC,0,3193821
rdlDp,0.07692307692307693,12,12,AGGCTTAACAGACGCCCCTT,0,3195247
rdlDp,0.07692307692307693,12,12,AGAGGATCGAATCAGTACTA,0,3166336
rdlDp,0.07692307692307693,12,12,AGACCTGGTCTGAGTGTGGT,0,3186630
rdlDp,0.07692307692307693,12,12,ACAGAAAATGGAGATCTACA,0,3168955
rdlDp,0.07692307692307693,12,12,AAGTCTCTTGGACACTGTCA,0,3199523
rdlDp,0.07692307692307693,12,12,AACCATTAGCCGTTAACTCC,0,3205397
rdlDp,0.07692307692307693,12,12,AACATAGCTAGCCGCTAGTA,0,3197528
rdlDp,0.07692307692307693,12,12,AAACCGGTCTCATGGCCTAA,0,3202320
rdlDp,0.08333333333333333,11,11,TTTAAGTATTAGTCATACCT,0,3199058
rdlDp,0.08333333333333333,11,11,TTCGCACGAAATCCGGGGTT,0,3175957
rdlDp,0.08333333333333333,11,11,TTAGTGGACTACGTAGATGT,0,3186198
rdlDp,0.08333333333333333,11,11,TGTGTGCCGGCGTTGGATAT,0,3164217
rdlDp,0.08333333333333333,11,11,TGTAAAAGCCCGTCCTGCCT,0,3173129
rdlDp,0.08333333333333333,11,11,TGCTTGCTACTTCAACAGAA,0,3171838
rdlDp,0.08333333333333333,11,11,TATTGGACATCGCCATGTAC,0,3187937
rdlDp,0.08333333333333333,11,11,TAGGCGAAGCCACCTGCTAT,0,3207627
rdlDp,0.08333333333333333,11,11,TAGATTTATTCATTCACGCG,0,3207576
rdlDp,0.08333333333333333,11,11,TACCGGATCGAATTTTTTGT,0,3171851
rdlDp,0.08333333333333333,11,11,TACAAGTCCCTGTTCCATAC,0,3171870
rdlDp,0.08333333333333333,11,11,TAATTATAGATATACGCTAG,0,3209043
rdlDp,0.08333333333333333,11,11,TAAACGCCAGCCCGCCCTCC,0,3187581
rdlDp,0.08333333333333333,11,11,GTAGGAGATGCAATGAGCGT,0,3208266
rdlDp,0.08333333333333333,11,11,GGTATCTGAATCATAACCAT,0,3208931
rdlDp,0.08333333333333333,11,11,GGGCCTCCGCCTCTAAGCGA,0,3204138
rdlDp,0.08333333333333333,11,11,GCTACGGGTGAGCCACCAGG,0,3212463
rdlDp,0.08333333333333333,11,11,GCATCTCCACTACACGGTAA,0,3202293
rdlDp,0.08333333333333333,11,11,GAGGACTCACTCCTAAATCT,0,3193810
rdlDp,0.08333333333333333,11,11,GAGACGGGTCCAGTCACGAC,0,3169230
rdlDp,0.08333333333333333,11,11,CTTTGGGGCGCCACGCTTTT,0,3208846
rdlDp,0.08333333333333333,11,11,CTACATCCAGTGGTTCTTTG,0,3187865
rdlDp,0.08333333333333333,11,11,CGCGTTATCATGGGGGACTA,0,3194599
rdlDp,0.08333333333333333,11,11,CGCGCATAAGGCGGCAAGGA,0,3166101
rdlDp,0.08333333333333333,11,11,CCGTAAGTCTAACTTGGAGG,0,3201086
rdlDp,0.08333333333333333,11,11,CCGCTACGTTCACTTGCGCT,0,3179070
rdlDp,0.08333333333333333,11,11,CCAACTGGCAAGGAGGCTTC,0,3166931
rdlDp,0.08333333333333333,11,11,CAGGCAAAGGCTGTGAGTTC,0,3195150
rdlDp,0.08333333333333333,11,11,CAGCTCTTGCACAACCCCTC,0,3205923
rdlDp,0.08333333333333333,11,11,CAGACGATACACAGGAATTA,0,3206953
rdlDp,0.08333333333333333,11,11,CACATTCTGACTAGAAAGAT,0,3175341
rdlDp,0.08333333333333333,11,11,CAAAAGGTAGGGTGAAGGGC,0,3175876
rdlDp,0.08333333333333333,11,11,ATTAGGGAGTGGTAAATGAA,0,3175697
rdlDp,0.08333333333333333,11,11,ATCTATACGTTGCATGATAC,0,3188376
rdlDp,0.08333333333333333,11,11,ATCGCCTGCTGAGATGATTC,0,3186160
rdlDp,0.08333333333333333,11,11,ATCACCTACCCGCGCTGCAG,0,3183957
rdlDp,0.08333333333333333,11,11,ATAGGGTCTGAGTACACACT,0,3180008
rdlDp,0.08333333333333333,11,11,ATACCCACCCGCACCTTTAC,0,3174175
rdlDp,0.08333333333333333,11,11,AGTCGTACTGCTCGGCCCGC,0,3183972
rdlDp,0.08333333333333333,11,11,AGTCACAAAGTGCAAACAAA,0,3176405
rdlDp,0.08333333333333333,11,11,AGGTACCATGAGGAAATTTT,0,3186163
rdlDp,0.08333333333333333,11,11,AGGCCACCGGCCGTCGGTGT,0,3191480
rdlDp,0.08333333333333333,11,11,AGCACGCGTAACCTCTCAGT,0,3210867
rdlDp,0.08333333333333333,11,11,ACGTTAGCGACTCCCGTGAC,0,3195430
rdlDp,0.08333333333333333,11,11,ACGGTAACTGGAACCTGCAG,0,3205847
rdlDp,0.08333333333333333,11,11,ACATGCTTATCAGGGGCTGT,0,3180043
rdlDp,0.08333333333333333,11,11,AAGCGTACAGCAGTTCCTTC,0,3199710
rdlDp,0.08333333333333333,11,11,AAGACGGCGATTAATAAAGA,0,3195451
rdlDp,0.08333333333333333,11,11,AACTGTTTCTGCATACCACA,0,3191737
rdlDp,0.09090909090909091,10,10,TTTGGCGTCCGCCGTAGTAG,0,3182461
rdlDp,0.09090909090909091,10,10,TTTGCGGCATGCGTCTATCA,0,3207797
rdlDp,0.09090909090909091,10,10,TTTCCCCACCTCATCCATGC,0,3209584
rdlDp,0.09090909090909091,10,10,TTTAGTGTTCTGCGCGACAA,0,3200021
rdlDp,0.09090909090909091,10,10,TTGGCATCATACCGGAGGAT,0,3164807
rdlDp,0.09090909090909091,10,10,TTGCTGTCAGTTAAAGTTGT,0,3166952
rdlDp,0.09090909090909091,10,10,TTGAAGTACGATGCAATGCT,0,3181815
rdlDp,0.09090909090909091,10,10,TGCGGCTGAAGTGCTGGTGT,0,3170450
rdlDp,0.09090909090909091,10,10,TGACGCGGCTAGTGGAGGCT,0,3174161
rdlDp,0.09090909090909091,10,10,TCGCCGCATATGACATGGAT,0,3171384
rdlDp,0.09090909090909091,10,10,TCGCCATTTGCTACGTTTAG,0,3186157
rdlDp,0.09090909090909091,10,10,TCGCAATGCCGAGTTTAGGA,0,3174991
rdlDp,0.09090909090909091,10,10,TCAGTATAGAATGCAAACAT,0,3200694
rdlDp,0.09090909090909091,10,10,TAGACCCCGAGGGTCAGTAC,0,3213267
rdlDp,0.09090909090909091,10,10,TAGAACAAGTAAGGGTTCCA,0,3192219
rdlDp,0.09090909090909091,10,10,TACGCAAGTAATGCGCTTAT,0,3181801
rdlDp,0.09090909090909091,10,10,TAATGGGCGGCGGTACTGCA,0,3187407
rdlDp,0.09090909090909091,10,10,TAATGCTATCCGGCATTTAC,0,3211709
rdlDp,0.09090909090909091,10,10,TAAATATGCGGTGCTAGCAA,0,3174189
rdlDp,0.09090909090909091,10,10,GTGTCACGGACATGTGGAAA,0,3180643
rdlDp,0.09090909090909091,10,10,GTCTCGCGTATTTGCTAGTT,0,3182478
rdlDp,0.09090909090909091,10,10,GGTCATTCGAATGTAAATGG,0,3192118
rdlDp,0.09090909090909091,10,10,GGTCAGGGATCGTATGAATA,0,3205763
rdlDp,0.09090909090909091,10,10,GGGTACACCTGTCTATCCGA,0,3165293
rdlDp,0.09090909090909091,10,10,GGGGTTTGCCCGAAATAAAA,0,3164336
rdlDp,0.09090909090909091,10,10,GGGATTTGGGAGTTCGTCTC,0,3169719
rdlDp,0.09090909090909091,10,10,GGAGCAATCCGGTGTTGGCG,0,3193956
rdlDp,0.09090909090909091,10,10,GCTTTGTGGTAATTGAGGGT,0,3183055
rdlDp,0.09090909090909091,10,10,GCTACGGTACTTAGTGACGG,0,3194745
rdlDp,0.09090909090909091,10,10,GCGGCGTAGCCGGCTCTGGT,0,3197314
rdlDp,0.09090909090909091,10,10,GCCACTCACGGGTGACGGCA,0,3164823
rdlDp,0.09090909090909091,10,10,GATGTTATTCGCTTTCATGT,0,3180666
rdlDp,0.09090909090909091,10,10,GAGCAGAACTGCTAGCGTTC,0,3200011
rdlDp,0.09090909090909091,10,10,GAGATGTACGGGCGACATGT,0,3165995
rdlDp,0.09090909090909091,10,10,GAATGTAAGATCTGTCACGC,0,3208061
rdlDp,0.09090909090909091,10,10,GAACCTGGCTTCTGCGTACA,0,3213603
rdlDp,0.09090909090909091,10,10,CTTTGCGCCTTTGACCGCCC,0,3182239
rdlDp,0.09090909090909091,10,10,CGGCTGTTCGGGTTCACTAC,0,3180897
rdlDp,0.09090909090909091,10,10,CGGCAATTCTATAACCTTCT,0,3213953
rdlDp,0.09090909090909091,10,10,CGCGTCGAGGCTATCTACGA,0,3210258
rdlDp,0.09090909090909091,10,10,CGAGGGGTTATCGCAAATAG,0,3172173
rdlDp,0.09090909090909091,10,10,CGAGAGGTGGGTATACGAAT,0,3180995
rdlDp,0.09090909090909091,10,10,CCTTGAGGAGGTCGAACCCA,0,3211072
rdlDp,0.09090909090909091,10,10,CCGACCTCTCAGACATGTAT,0,3167628
rdlDp,0.09090909090909091,10,10,CCAAGCAGAACCCTATGTCA,0,3178032
rdlDp,0.09090909090909091,10,10,CAGTGGGTTTGTAGGGGGTC,0,3189596
rdlDp,0.09090909090909091,10,10,CAGGTAGGTGGGATGCCCAT,0,3214566
rdlDp,0.09090909090909091,10,10,CAGCATGTCAACCCAACGTT,0,3183391
rdlDp,0.09090909090909091,10,10,CAATGAAAACTTCGTTAAAT,0,3166935
rdlDp,0.09090909090909091,10,10,ATTTTTCCCACTGCAGGATT,0,3182113
rdlDp,0.09090909090909091,10,10,ATGAGATTTTCCATTCAGGG,0,3173399
rdlDp,0.09090909090909091,10,10,ATCCATGCATGTAGCTCCGC,0,3198980
rdlDp,0.09090909090909091,10,10,AGTCACACAACAAACGTTGC,0,3182147
rdlDp,0.09090909090909091,10,10,AGGTACCATTTTTAACGTAG,0,3187077
rdlDp,0.09090909090909091,10,10,AGGAACCGCCAGGCACGGGC,0,3195461
rdlDp,0.09090909090909091,10,10,AGATATATCTGTCCGAAAAT,0,3209084
rdlDp,0.09090909090909091,10,10,AGACCTGCTCGCAGGGTGAT,0,3171698
rdlDp,0.09090909090909091,10,10,ACTTATCCACTTTCTCATAG,0,3189630
rdlDp,0.09090909090909091,10,10,ACTACGTCTAAGGCGTCAAT,0,3189704
rdlDp,0.09090909090909091,10,10,ACTAAATGGCCCGTTTCGAG,0,3186962
rdlDp,0.09090909090909091,10,10,ACGTCTCATCCAGAACTTGA,0,3179523
rdlDp,0.09090909090909091,10,10,ACGCTCAGTTGGATCTTGAC,0,3204318
rdlDp,0.09090909090909091,10,10,ACATAGGCAGTGAGACAGAT,0,3164257
rdlDp,0.09090909090909091,10,10,ACACAGCGCGCTCGGCGCAA,0,3184953
rdlDp,0.09090909090909091,10,10,AATAGTGCTTCAGGCACCAT,0,3207738
rdlDp,0.09090909090909091,10,10,AAATTGGTGAGTGCCACGGG,0,3168147
rdlDp,0.09090909090909091,10,10,AAAAGTCATAAACATAGGAG,0,3211864
rdlDp,0.1,9,9,TTGTGTCAGGAATAAATAGT,0,3165493
rdlDp,0.1,9,9,TTGGCTCCCTTACAGCCAAC,0,3199778
rdlDp,0.1,9,9,TTCTGCTGTAAAGAGTATCG,0,3191569
rdlDp,0.1,9,9,TTCAACCCGTAAGGTGGATT,0,3214709
rdlDp,0.1,9,9,TTATTACACGGGTGCTAGGT,0,3183122
rdlDp,0.1,9,9,TTAGAGTTTTTTAGAAGGAT,0,3203071
rdlDp,0.1,9,9,TGTTACCAAACTGACTTGGC,0,3214027
rdlDp,0.1,9,9,TGGATTTCCCGGAATGCCGT,0,3207496
rdlDp,0.1,9,9,TGGAAGGCCGGGAATTAGTG,0,3184919
rdlDp,0.1,9,9,TGGAAGCCCGTAGGGAGTGG,0,3208036
rdlDp,0.1,9,9,TGAGCCAGTAATCGACGGGT,0,3202266
rdlDp,0.1,9,9,TGACATCGACGTCTGTGGGT,0,3207344
rdlDp,0.1,9,9,TCGTGTTTGGCGGTATTTCT,0,3173435
rdlDp,0.1,9,9,TATTGTCTCGGCTAGGACTA,0,3184718
rdlDp,0.1,9,9,TAGGTTGGGAGTCGCACATA,0,3185469
rdlDp,0.1,9,9,TAGCTTCCAAAAATCGAGGA,0,3191317
rdlDp,0.1,9,9,GTTTGGAAACTTCATGGTGT,0,3166988
rdlDp,0.1,9,9,GTGTGCATTACAATTCTCAA,0,3209295
rdlDp,0.1,9,9,GTGTATTACTTGGGTCGGGA,0,3166940
rdlDp,0.1,9,9,GTGAGCCACCTGCGCTTGGT,0,3192117
rdlDp,0.1,9,9,GTACGTTGCCACTGTGACGT,0,3168160
rdlDp,0.1,9,9,GGTCTGCTAAGGTTGGTCAA,0,3168090
rdlDp,0.1,9,9,GGGTGGGTAACCCGTTTTCA,0,3205904
rdlDp,0.1,9,9,GGGTGCACTACATGTAGTCA,0,3165861
rdlDp,0.1,9,9,GGAGATAGAAGTCTCCTTCA,0,3192080
rdlDp,0.1,9,9,GCTTATCCTCTGCGTCTACG,0,3175793
rdlDp,0.1,9,9,GCTGGGTATGCCCGGCCTTC,0,3175337
rdlDp,0.1,9,9,GCTGACAACTCCTAGCGGGT,0,3182476
rdlDp,0.1,9,9,GCGAACGCGAAAGAGCACTT,0,3189557
rdlDp,0.1,9,9,GCCTTTGTGATGTACCCCCC,0,3212607
rdlDp,0.1,9,9,GATTACAGGATAGCATGGGG,0,3202303
rdlDp,0.1,9,9,GACTAGACTTTAAAGTCTAA,0,3176477
rdlDp,0.1,9,9,GACAAGTTTGCCAGAAAGAC,0,3173080
rdlDp,0.1,9,9,CTGAGATCGAAGTCGCGAGT,0,3201096
rdlDp,0.1,9,9,CTAGGGGTGTTACATTCTGG,0,3196106
rdlDp,0.1,9,9,CTACCATTATTATTCAGCAA,0,3208935
rdlDp,0.1,9,9,CGTTGGCCAACGAAGTAGGA,0,3176643
rdlDp,0.1,9,9,CGGTTTAGTCTTTGACCGTG,0,3188500
rdlDp,0.1,9,9,CGAGGTGTGATTGCCGTCCG,0,3214645
rdlDp,0.1,9,9,CGAACGCAGGAAGTTAAAAG,0,3186442
rdlDp,0.1,9,9,CCTCTCTTAAGCTCGGTTCC,0,3179696
rdlDp,0.1,9,9,CCTACTGGAAGAACATGCTT,0,3204147
rdlDp,0.1,9,9,CCCGACGGCTTGCCCGTCCG,0,3175582
rdlDp,0.1,9,9,CCAACCTCGACGTATGCGGA,0,3182046
rdlDp,0.1,9,9,CAGGGCACGTCTATGAAGCT,0,3166344
rdlDp,0.1,9,9,CAAGTGTAGGGAATTTACTA,0,3191305
rdlDp,0.1,9,9,ATTCGCCCGTAGCTACTGAA,0,3188952
rdlDp,0.1,9,9,ATGCCCTAAATTTCCAATCC,0,3213038
rdlDp,0.1,9,9,ATCTCGGACGGCTGACGCGA,0,3207190
rdlDp,0.1,9,9,ATCCTCATTTGAGGAAGGGA,0,3213436
rdlDp,0.1,9,9,ATAGTCGAAATGTCCAGATG,0,3206236
rdlDp,0.1,9,9,ATACTTATGTAAAAAAAGGA,0,3209770
rdlDp,0.1,9,9,ATACTGAGAGCTTTACCGGC,0,3205768
rdlDp,0.1,9,9,ATACTCATATATACTGGTCG,0,3201943
rdlDp,0.1,9,9,AGTCACGTAGCCAGAGACCA,0,3200768
rdlDp,0.1,9,9,AGTATAGGGACAGAGGCCAA,0,3208922
rdlDp,0.1,9,9,AGTAACCTCCTTTGCATAGG,0,3207571
rdlDp,0.1,9,9,AGACGCGTCCTAGTTGGACG,0,3211705
rdlDp,0.1,9,9,AGAAACGCATCCGCGGTGGA,0,3205558
rdlDp,0.1,9,9,ACATAGTGATAACTCCGTTA,0,3194995
rdlDp,0.1,9,9,AAGCATGGGCTCCATACCTA,0,3188691
rdlDp,0.1,9,9,AAGAATGTCACGTCTAGTTA,0,3175888
rdlDp,0.1111111111111111,8,8,TTTAAGGCGTGCTAGCGCCC,0,3203976
rdlDp,0.1111111111111111,8,8,TTGCTCTCAACTAATGAGCC,0,3168131
rdlDp,0.1111111111111111,8,8,TTCGCTCACGCGGATACCCC,0,3202469
rdlDp,0.1111111111111111,8,8,TTATCACAGGGGAATGGTGT,0,3187063
rdlDp,0.1111111111111111,8,8,TTAGTCTGCGAAATTTTATG,0,3167576
rdlDp,0.1111111111111111,8,8,TGGACAAATAATCTGTTTTT,0,3173941
rdlDp,0.1111111111111111,8,8,TGACTTGTTCCGGGGGACTC,0,3179091
rdlDp,0.1111111111111111,8,8,TCTGTAGGAAGTACAGGACG,0,3183115
rdlDp,0.1111111111111111,8,8,TCGTTTGGGGCTTTAGGTTT,0,3164215
rdlDp,0.1111111111111111,8,8,TCGGTCTAGTATTGCTACTG,0,3168848
rdlDp,0.1111111111111111,8,8,TCGAGTACAGCTGCGACTAA,0,3211069
rdlDp,0.1111111111111111,8,8,TCCCAAGGGCAACACGCCGC,0,3188509
rdlDp,0.1111111111111111,8,8,TATTACGACCATATCCTGGT,0,3192876
rdlDp,0.1111111111111111,8,8,TACGCGTACACACTTCTTCC,0,3208163
rdlDp,0.1111111111111111,8,8,TAATTTGACAATACAAGCAT,0,3187559
rdlDp,0.1111111111111111,8,8,TAATACTTGGCTGAAACATA,0,3192373
rdlDp,0.1111111111111111,8,8,GTCACTTCGGGCGGCTCTAC,0,3202292
rdlDp,0.1111111111111111,8,8,GTATTAAGAGGCCTCAAGGG,0,3202294
rdlDp,0.1111111111111111,8,8,GTACCTTGCGCCCTAGGTTG,0,3164537
rdlDp,0.1111111111111111,8,8,GGTTGCCTTCCTTTTGCTCT,0,3193814
rdlDp,0.1111111111111111,8,8,GGTTCAAGAAGGCCACTGCT,0,3190358
rdlDp,0.1111111111111111,8,8,GGTAACGTTATACCAAAGCG,0,3174092
rdlDp,0.1111111111111111,8,8,GGCTTGTGCATAATCGGTTA,0,3169113
rdlDp,0.1111111111111111,8,8,GGCGTCCATAACGTATACGG,0,3189076
rdlDp,0.1111111111111111,8,8,GGATGGCAGGGTCAGGGGTT,0,3184580
rdlDp,0.1111111111111111,8,8,GGACACACAGGCAGAGCAGA,0,3198655
rdlDp,0.1111111111111111,8,8,GCTGCATCGCGGGTCAACAA,0,3166741
rdlDp,0.1111111111111111,8,8,GCTCTAGTGGTCTTGGCCGA,0,3178077
rdlDp,0.1111111111111111,8,8,GCTCGGTGGCGTGGTATTGA,0,3168148
rdlDp,0.1111111111111111,8,8,GCTACACCCACCTCGATAGT,0,3215963
rdlDp,0.1111111111111111,8,8,GCGGTTTTGACAAATTGCTG,0,3194604
rdlDp,0.1111111111111111,8,8,GCGGTAAGTACAGCTACCTT,0,3207658
rdlDp,0.1111111111111111,8,8,GCGGGCGCCAGGCACTACTA,0,3182293
rdlDp,0.1111111111111111,8,8,GCCGGTTTAGCTCTGTAACT,0,3208850
rdlDp,0.1111111111111111,8,8,GCATGAGGTCACCGGGCCGA,0,3165746
rdlDp,0.1111111111111111,8,8,GATGTCATCAATCTGGTGGA,0,3203857
rdlDp,0.1111111111111111,8,8,GAAAAGTGGGGCACCTGATT,0,3186151
rdlDp,0.1111111111111111,8,8,GAAAAACCAGAACATATCGA,0,3188184
rdlDp,0.1111111111111111,8,8,CTTTGTAGACTAGGGCTCAT,0,3209795
rdlDp,0.1111111111111111,8,8,CTTGTGTATCATTTGCTTTA,0,3200014
rdlDp,0.1111111111111111,8,8,CTCTCTGCGAGTTGTTTCTG,0,3181106
rdlDp,0.1111111111111111,8,8,CGGAAGCGAGATGATCTGTT,0,3190601
rdlDp,0.1111111111111111,8,8,CGCGCCAGCGATGCACTATA,0,3171434
rdlDp,0.1111111111111111,8,8,CGCCTTCAGCAGTAAAATTC,0,3186523
rdlDp,0.1111111111111111,8,8,CGCCCGCACTGGAAGCTATA,0,3208932
rdlDp,0.1111111111111111,8,8,CGCCACCTGGTTTGTATGGT,0,3203788
rdlDp,0.1111111111111111,8,8,CGATAACCAATATGCCAAAA,0,3191666
rdlDp,0.1111111111111111,8,8,CGAAGCGCTGCAGCCCAGGC,0,3169970
rdlDp,0.1111111111111111,8,8,CCGTCCATACTGCGCAAGGT,0,3176412
rdlDp,0.1111111111111111,8,8,CCGGGACGCCACGTGCTTGG,0,3171446
rdlDp,0.1111111111111111,8,8,CCCTGCGCTCCAGTAGAAAG,0,3181961
rdlDp,0.1111111111111111,8,8,CCCTCGGCCCACTTGAGTCG,0,3194090
rdlDp,0.1111111111111111,8,8,CCCGAGCGGACGCGTTACTC,0,3202780
rdlDp,0.1111111111111111,8,8,CCACTACACCGCTTGGAGTC,0,3169353
rdlDp,0.1111111111111111,8,8,CCAATATGTAATTTATATCT,0,3200807
rdlDp,0.1111111111111111,8,8,CATTAGTATTTATGAGGGTT,0,3194595
rdlDp,0.1111111111111111,8,8,CATCTCCATCCACGTTCCGT,0,3199479
rdlDp,0.1111111111111111,8,8,CAGTGCTACAGCAGAAAGGA,0,3190446
rdlDp,0.1111111111111111,8,8,CAGCGGGGGGCATGCGACCT,0,3167546
rdlDp,0.1111111111111111,8,8,CAGCAAGGAAATCTGTTTTT,0,3195356
rdlDp,0.1111111111111111,8,8,CAGATGTGTTTACGGTTAAT,0,3174409
rdlDp,0.1111111111111111,8,8,CAGATCCGGCCTCGACTCCC,0,3197476
rdlDp,0.1111111111111111,8,8,CAATTACTATTCGACTGAAT,0,3170483
rdlDp,0.1111111111111111,8,8,ATTTAGCAAGAGGTTGACGT,0,3185695
rdlDp,0.1111111111111111,8,8,ATTGTGTACATAAACTAGTC,0,3180788
rdlDp,0.1111111111111111,8,8,ATTAATTTGATCAGTAGGTT,0,3170157
rdlDp,0.1111111111111111,8,8,ATGCAATCCTCGATAAACTA,0,3173432
rdlDp,0.1111111111111111,8,8,ATCCGCCACCGGGCACCGGG,0,3168911
rdlDp,0.1111111111111111,8,8,ATCACAAGCGTAGCTCGAGT,0,3187250
rdlDp,0.1111111111111111,8,8,AGTTGTTATCTGGGTATCAG,0,3171846
rdlDp,0.1111111111111111,8,8,AGTGCAGAGGATCTGATCTG,0,3188558
rdlDp,0.1111111111111111,8,8,AGGGTACTTTGCAATTCGAA,0,3187808
rdlDp,0.1111111111111111,8,8,AGGCCAGTAGTAAATAGCGA,0,3180121
rdlDp,0.1111111111111111,8,8,AGCGGACAGATTAGGTAGTA,0,3191549
rdlDp,0.1111111111111111,8,8,AGCCTAGGGACGTGACATAT,0,3183663
rdlDp,0.1111111111111111,8,8,AGAAAAGCGAGAGTTCACCT,0,3170453
rdlDp,0.1111111111111111,8,8,ACGGCAAGTTAGATGAAATG,0,3179087
rdlDp,0.1111111111111111,8,8,ACGGAGTCATACGCTCCTCG,0,3207922
rdlDp,0.1111111111111111,8,8,ACGCACCCCCGATAGCGACT,0,3177080
rdlDp,0.1111111111111111,8,8,ACAGTATATCTCATGCGGTT,0,3204956
rdlDp,0.1111111111111111,8,8,ACAAGGGTAGATCGCATCCA,0,3191040
rdlDp,0.1111111111111111,8,8,ACAAAAGCAATGTTAGCCTG,0,3172156
rdlDp,0.1111111111111111,8,8,AAGCACCAAATGCGCTTATG,0,3171141
rdlDp,0.1111111111111111,8,8,AACTTGTTACCATCGTGACG,0,3195650
rdlDp,0.1111111111111111,8,8,AACCTTCGAATTCTCGTGGG,0,3164156
rdlDp,0.1111111111111111,8,8,AACAGAAGACAATTGTTCAC,0,3177336
rdlDp,0.1111111111111111,8,8,AACACGTGTGCCCCGAAGTT,0,3194543
rdlDp,0.1111111111111111,8,8,AACAACAATTTAGCCTGTAG,0,3196921
rdlDp,0.1111111111111111,8,8,AAAGCCAAATTCAAGTGCGT,0,3165906
rdlDp,0.125,7,7,TTTCCGGGTCACGAATCCAT,0,3190441
rdlDp,0.125,7,7,TTTAGTTAGGCGGATTGTGT,0,3164218
rdlDp,0.125,7,7,TTGTATAACTCAGGTGCTTA,0,3191548
rdlDp,0.125,7,7,TTGGGTCGTGATGACCCGGG,0,3164394
rdlDp,0.125,7,7,TTCGAATTTAACGTACGTCG,0,3192082
rdlDp,0.125,7,7,TTATGTGCAATTTGGCATTC,0,3167751
rdlDp,0.125,7,7,TTACTGCAGCCTTCAACCCT,0,3176496
rdlDp,0.125,7,7,TGTTGAGAGTAACGGTCCTG,0,3179535
rdlDp,0.125,7,7,TGTTCCAGAGTGATGCCGCG,0,3190872
rdlDp,0.125,7,7,TGTTCATCGCCAGTGTGAAA,0,3194010
rdlDp,0.125,7,7,TGTTAAGTGAGCGCCACCGG,0,3210259
rdlDp,0.125,7,7,TGTGTGCCCGCAACATACGA,0,3195088
rdlDp,0.125,7,7,TGTGTAACTCTATTGTTTGC,0,3212009
rdlDp,0.125,7,7,TGTGGATGCCGGGGAAGGGC,0,3179166
rdlDp,0.125,7,7,TGCTGTAATACCCTGACACA,0,3180531
rdlDp,0.125,7,7,TGCGAGTGCATAGAGTAGTA,0,3200751
rdlDp,0.125,7,7,TGCCATGACTTTGCTACCAC,0,3191746
rdlDp,0.125,7,7,TGCCACAGCAACTGATGTTT,0,3169974
rdlDp,0.125,7,7,TCTTGAGTGGACGGACAAAC,0,3202671
rdlDp,0.125,7,7,TCTGGCCGGGCTCGCCGCGC,0,3166150
rdlDp,0.125,7,7,TCGTTTTCCCGCCGGCCGCG,0,3174369
rdlDp,0.125,7,7,TCCCTTTTGGAAGCTATGAT,0,3206576
rdlDp,0.125,7,7,TCATATTATTGATACATTTG,0,3165911
rdlDp,0.125,7,7,TATTCTTTTCATACAACTTC,0,3208989
rdlDp,0.125,7,7,TAGCGGCAGTCGATGCACCG,0,3174188
rdlDp,0.125,7,7,TACTATGTCATTTGAATGGT,0,3197548
rdlDp,0.125,7,7,TAAGTCCCTGTGGGCTACGC,0,3194497
rdlDp,0.125,7,7,GTTTCGCGTAGATAGATTCT,0,3204967
rdlDp,0.125,7,7,GTTGGTCTACTTTTTCTCCC,0,3202461
rdlDp,0.125,7,7,GTTCATGAATTGTAATTGTT,0,3175053
rdlDp,0.125,7,7,GTTAGTGAAGTACGGTAAAC,0,3216138
rdlDp,0.125,7,7,GTGTCGTCCCGACCGTAAAA,0,3188054
rdlDp,0.125,7,7,GTAGATGTTTAGATCTCTAG,0,3203474
rdlDp,0.125,7,7,GGTTCCGTAACCCCGCGCCT,0,3195161
rdlDp,0.125,7,7,GGGGTAGGAATAAGCCTCAA,0,3168934
rdlDp,0.125,7,7,GGCTTCACTGCCCCCTCAAA,0,3179129
rdlDp,0.125,7,7,GGCGCGCGTTCCGGGACTGT,0,3198679
rdlDp,0.125,7,7,GGATATCGGGACAGTCTATA,0,3198968
rdlDp,0.125,7,7,GGACTCCACCGACCCGTATA,0,3206662
rdlDp,0.125,7,7,GGACAATCGCATACCGTCCG,0,3191681
rdlDp,0.125,7,7,GCGGCGCTGATCACGGGATG,0,3180332
rdlDp,0.125,7,7,GCGACAGAATGCACACTTAT,0,3167398
rdlDp,0.125,7,7,GCAGTTGCATAGGTAAACTA,0,3203478
rdlDp,0.125,7,7,GCAGGGGGGGGAGCCGTCTA,0,3204021
rdlDp,0.125,7,7,GCAGCTATTTAGAATGGTAA,0,3204378
rdlDp,0.125,7,7,GCACTTGTGTCGGAGACGAC,0,3209281
rdlDp,0.125,7,7,GCACTATGGTCACATTTCTG,0,3187098
rdlDp,0.125,7,7,GCAACTATCTGGTTTGCATG,0,3210334
rdlDp,0.125,7,7,GAGCAAGCAGCCGCCTCGAT,0,3194600
rdlDp,0.125,7,7,GAGATCGCCGTTATCCAACA,0,3210866
rdlDp,0.125,7,7,GACGTTTCGGATCTGGGCAT,0,3166953
rdlDp,0.125,7,7,GACGCTGTTTTCCCGCACGC,0,3182197
rdlDp,0.125,7,7,GACCTTACCGCGGCTAGTTG,0,3179847
rdlDp,0.125,7,7,GAAGGGGAGTAGTAGTACGT,0,3193072
rdlDp,0.125,7,7,CTTTAGCGACGAACGCCGTG,0,3175534
rdlDp,0.125,7,7,CTGTGGCATTGGAACAAGGG,0,3178755
rdlDp,0.125,7,7,CTGGGTCGTACAGTCTGCTT,0,3187191
rdlDp,0.125,7,7,CTCGCCGGCACCCCAGTCCA,0,3174098
rdlDp,0.125,7,7,CTAGGGGGGTCCGTACGTAA,0,3176404
rdlDp,0.125,7,7,CTAATGCGCCGTGAGATTGC,0,3183339
rdlDp,0.125,7,7,CTAACCGCCAACTTGCTCAT,0,3195656
rdlDp,0.125,7,7,CGTCGGCGCACTCGCGTAGT,0,3203542
rdlDp,0.125,7,7,CGTACAATGGCCCGCTCTTA,0,3187850
rdlDp,0.125,7,7,CGGGGCCGCAGGTAGGTTTC,0,3213198
rdlDp,0.125,7,7,CGGCGCCGCCGTGTTTCTTG,0,3199945
rdlDp,0.125,7,7,CGCTGGGACGTTGTAGGCTT,0,3191777
rdlDp,0.125,7,7,CCGCTGAGCGCATAGAAAAG,0,3173919
rdlDp,0.125,7,7,CCGAGGACAAGCCCTCTCGC,0,3185131
rdlDp,0.125,7,7,CCCGCCAATGCCTGAGCGGT,0,3213248
rdlDp,0.125,7,7,CCATAGCGACGATTCGACCC,0,3192121
rdlDp,0.125,7,7,CCAATTCCGGTGAGACAGTT,0,3196178
rdlDp,0.125,7,7,CATTCTTGCCGGTATAGACC,0,3203573
rdlDp,0.125,7,7,CATCTTGCCAATAACGTTCG,0,3185711
rdlDp,0.125,7,7,CAGGGGGCATGTTATCTCGA,0,3173001
rdlDp,0.125,7,7,CAATAACTTCTGAGAGAGTG,0,3188961
rdlDp,0.125,7,7,ATTTGGGTACAAAACGCATG,0,3205886
rdlDp,0.125,7,7,ATTTGACTCAAGATGGGAAT,0,3200831
rdlDp,0.125,7,7,ATTTATTGCAAAATCAGACA,0,3167404
rdlDp,0.125,7,7,ATTGTACGTCTGCCAATGAT,0,3193375
rdlDp,0.125,7,7,ATTGCCAGTGCTATCTTCAA,0,3185697
rdlDp,0.125,7,7,ATGGAGAATGCGTGGGAGAT,0,3179855
rdlDp,0.125,7,7,ATGCTTTCGGTCGTGTTCGA,0,3164797
rdlDp,0.125,7,7,ATGCCAATTAGGAGAAGCAT,0,3207578
rdlDp,0.125,7,7,ATGAGATCTCTGCGATGGAT,0,3205377
rdlDp,0.125,7,7,ATCCGTGACATTGCTTGAGA,0,3200218
rdlDp,0.125,7,7,ATCCCCCGCCCCATCAAATA,0,3167138
rdlDp,0.125,7,7,ATATGATCATGAGTCCTAGA,0,3181167
rdlDp,0.125,7,7,AGGTGACGGTTTTTATAGTA,0,3196920
rdlDp,0.125,7,7,AGGTCTGGAAGCGCTCTTAG,0,3206683
rdlDp,0.125,7,7,AGCGAACAAATGAGCTGAGA,0,3195323
rdlDp,0.125,7,7,AGCCTGCATCACAGTGTCAC,0,3167167
rdlDp,0.125,7,7,AGCCCAGTCCGTGGCGCGTG,0,3166751
rdlDp,0.125,7,7,AGCCAGAGGATTCTAATTGT,0,3208868
rdlDp,0.125,7,7,AGCAGCAAAGTCTTATCTTT,0,3195460
rdlDp,0.125,7,7,AGATAACTTGATAAGCAAAC,0,3194611
rdlDp,0.125,7,7,AGACAATCCTCTTTTTATTA,0,3166963
rdlDp,0.125,7,7,ACGAGGCGCTTTCAGAACTA,0,3176829
rdlDp,0.125,7,7,ACGAATAGTCTCCAACTGTC,0,3168106
rdlDp,0.125,7,7,ACCGGTCTCACATGGGGCTT,0,3214182
rdlDp,0.125,7,7,ACAGGTACAATCTCTGATTA,0,3203796
rdlDp,0.125,7,7,AATAATATTTACCACCCGGC,0,3192694
rdlDp,0.125,7,7,AATAATAGTTGAGTCTTCCA,0,3194224
rdlDp,0.125,7,7,AACAACGCGTCTCACCGCTT,0,3165488
rdlDp,0.125,7,7,AAATGGGTTACGGGTGCGCT,0,3182140
rdlDp,0.125,7,7,AAAGACTTACACTCCCACAT,0,3173146
rdlDp,0.125,7,7,AAACCCTCGAAGGGAGCCAA,0,3175963
rdlDp,0.125,7,7,AAAACTGATATACATGGCAT,0,3212455
rdlDp,0.14285714285714285,6,6,TTTTGCCGCGATATGTCCCC,0,3208332
rdlDp,0.14285714285714285,6,6,TTTGGATGTAAGATAGCTCC,0,3166562
rdlDp,0.14285714285714285,6,6,TTTCTCAGATCTCTAGTTAT,0,3209556
rdlDp,0.14285714285714285,6,6,TTTCCGTACTACCAGGATGC,0,3204965
rdlDp,0.14285714285714285,6,6,TTTACTGGGCTAAGTGATTG,0,3189969
rdlDp,0.14285714285714285,6,6,TTGTGGCTATCAGCGCGCGT,0,3194394
rdlDp,0.14285714285714285,6,6,TTGCACCCCGAAACTCTCAT,0,3213989
rdlDp,0.14285714285714285,6,6,TTCTCAGCACAGTTGGTTCA,0,3185312
rdlDp,0.14285714285714285,6,6,TTCGTGCTAAGTCCTCCGCG,0,3190391
rdlDp,0.14285714285714285,6,6,TTCCCTCTGATAGAACAGGA,0,3204057
rdlDp,0.14285714285714285,6,6,TTATCGCGTCCTCTGTCGGA,0,3189589
rdlDp,0.14285714285714285,6,6,TTAAGGTACCAAAGGTGGGT,0,3197845
rdlDp,0.14285714285714285,6,6,TGTCTAGGGCGGTCCACGGT,0,3206753
rdlDp,0.14285714285714285,6,6,TGTCCTCGCTCATAGAAACT,0,3195579
rdlDp,0.14285714285714285,6,6,TGTAGCATTAGCGGACACGT,0,3210649
rdlDp,0.14285714285714285,6,6,TGCTTAAGTAGCACGTCAGG,0,3176263
rdlDp,0.14285714285714285,6,6,TGCCATAGGTCTCGCCATAC,0,3175321
rdlDp,0.14285714285714285,6,6,TGACTCTAGCATCCACGATG,0,3171377
rdlDp,0.14285714285714285,6,6,TGACCGAGGACTAAACCTCT,0,3189609
rdlDp,0.14285714285714285,6,6,TGAAGAACAGACCTTGCGCG,0,3165688
rdlDp,0.14285714285714285,6,6,TGAAAGTGCGCACGTGAAAT,0,3189678
rdlDp,0.14285714285714285,6,6,TGAAACTGTACGTTAGTTAT,0,3168816
rdlDp,0.14285714285714285,6,6,TCTTTCAAGCCTCGCCACAG,0,3188343
rdlDp,0.14285714285714285,6,6,TCTGCATGGAGCACTCGGCA,0,3188505
rdlDp,0.14285714285714285,6,6,TCTAGCGGTCCTTGGGTGTC,0,3168134
rdlDp,0.14285714285714285,6,6,TCGGGCGGGAGGAATATAAA,0,3205036
rdlDp,0.14285714285714285,6,6,TCGAGAATTTTAGGAGGGTC,0,3215036
rdlDp,0.14285714285714285,6,6,TCCGGGTGATGTAAACCTGG,0,3199572
rdlDp,0.14285714285714285,6,6,TCCCTTAGCCGGGGGTAGAA,0,3208504
rdlDp,0.14285714285714285,6,6,TCCACGCACGTAAAGTCCTC,0,3210780
rdlDp,0.14285714285714285,6,6,TCCAACCAACCCTGGCTGAC,0,3203794
rdlDp,0.14285714285714285,6,6,TCAAGGTGACTCTAGCCAAT,0,3192865
rdlDp,0.14285714285714285,6,6,TATCTGATGTTGGAAATAGA,0,3165214
rdlDp,0.14285714285714285,6,6,TATACGTTGCCAGGCAATAG,0,3166947
rdlDp,0.14285714285714285,6,6,TAGGCATAATAGACGCGTAA,0,3201469
rdlDp,0.14285714285714285,6,6,TAGAGCAGTCTCTCTCTTGT,0,3205342
rdlDp,0.14285714285714285,6,6,GTAGTAACGCCTAGATCCAT,0,3168722
rdlDp,0.14285714285714285,6,6,GTAGGTTTAAGAGACCTTTA,0,3194526
rdlDp,0.14285714285714285,6,6,GTACGGGTTCTCTCCCGAAA,0,3191568
rdlDp,0.14285714285714285,6,6,GGGTGTACGTTTCGAGTCAG,0,3192538
rdlDp,0.14285714285714285,6,6,GGGCCGAATTCAGAGGAGGG,0,3195455
rdlDp,0.14285714285714285,6,6,GGGAGATGCATCGGGCAGAG,0,3191817
rdlDp,0.14285714285714285,6,6,GGCAGAATACGGCCAAATGA,0,3166163
rdlDp,0.14285714285714285,6,6,GGAATGTCCCACTGGAGCCT,0,3171847
rdlDp,0.14285714285714285,6,6,GGAAGGTATCTGAAAAAGTT,0,3165213
rdlDp,0.14285714285714285,6,6,GCTCCGTATGTCACTCATTC,0,3168446
rdlDp,0.14285714285714285,6,6,GCGGTAAGCTCGACGCGCTG,0,3209508
rdlDp,0.14285714285714285,6,6,GCGACTATGTATGACCCGAA,0,3188765
rdlDp,0.14285714285714285,6,6,GCCGTTAGTGTATACAGTTT,0,3208168
rdlDp,0.14285714285714285,6,6,GCCAAAATTTAATCAAGACG,0,3183386
rdlDp,0.14285714285714285,6,6,GCAAGCGCTCTCCACAGTGT,0,3177156
rdlDp,0.14285714285714285,6,6,GCAAAGCTATAACACGGCAA,0,3180539
rdlDp,0.14285714285714285,6,6,GATTCTAGATAAGCGGTAGG,0,3193372
rdlDp,0.14285714285714285,6,6,GATGCCCACTACCAAACACA,0,3195053
rdlDp,0.14285714285714285,6,6,GATCGGCACACGCCAAAACT,0,3203860
rdlDp,0.14285714285714285,6,6,GATATGTATAAACTCGTCGG,0,3185461
rdlDp,0.14285714285714285,6,6,GAGCACGACTGTGACCACGG,0,3177978
rdlDp,0.14285714285714285,6,6,GAGAAGCTCATCTATAAATT,0,3181909
rdlDp,0.14285714285714285,6,6,GACGCATTGGCTGCGAGCGA,0,3167563
rdlDp,0.14285714285714285,6,6,GAAATGTGCTGTGCGAAAGG,0,3173844
rdlDp,0.14285714285714285,6,6,GAAACTTGGAGTTTCGGATA,0,3171207
rdlDp,0.14285714285714285,6,6,CTTTGGACTGCAAAAAGGGG,0,3175955
rdlDp,0.14285714285714285,6,6,CTTACGGCTTAGCAAACTGA,0,3165797
rdlDp,0.14285714285714285,6,6,CTGGTCGTACGGTTCGGGGT,0,3214024
rdlDp,0.14285714285714285,6,6,CTGATCCCCCGGGATACCAA,0,3174402
rdlDp,0.14285714285714285,6,6,CTGATAACTAGCCGTAAATC,0,3197803
rdlDp,0.14285714285714285,6,6,CTCTAGTACGCAGTGCAGTA,0,3200912
rdlDp,0.14285714285714285,6,6,CTATTACCCGTGCCAGTTTT,0,3171718
rdlDp,0.14285714285714285,6,6,CTATGGAAATGCCTTCTCTG,0,3171477
rdlDp,0.14285714285714285,6,6,CGTGCAATCGGTCGCATATA,0,3182915
rdlDp,0.14285714285714285,6,6,CGTCCCTATGAGTAATTTGC,0,3172087
rdlDp,0.14285714285714285,6,6,CGTATAGACATCACGAGGCA,0,3212799
rdlDp,0.14285714285714285,6,6,CGTAAGGTTGGCGCAATTCA,0,3191809
rdlDp,0.14285714285714285,6,6,CGGGTGGCTTCTCAACGTCC,0,3181889
rdlDp,0.14285714285714285,6,6,CGGGCACGTCCGGCCATCAC,0,3195344
rdlDp,0.14285714285714285,6,6,CGCGAATAGTGCGATTCAAA,0,3212640
rdlDp,0.14285714285714285,6,6,CGCCTGGGGCAACTCGCCCG,0,3181796
rdlDp,0.14285714285714285,6,6,CGCAGATGCGTCGAGGTCCA,0,3195239
rdlDp,0.14285714285714285,6,6,CGAAGGAGTGAACTGATTGG,0,3167389
rdlDp,0.14285714285714285,6,6,CCTTTGCATCTTGTGAAAGA,0,3200617
rdlDp,0.14285714285714285,6,6,CCTCCTGCGCGCCCTTATTC,0,3188363
rdlDp,0.14285714285714285,6,6,CCTAGCTTCGCTTTGAAGAT,0,3181542
rdlDp,0.14285714285714285,6,6,CCCGCATGCGAGCGATAATT,0,3214015
rdlDp,0.14285714285714285,6,6,CCCATCACTCTGGGATGCGT,0,3196203
rdlDp,0.14285714285714285,6,6,CCATTAAAGCGGTGTAAGGG,0,3201697
rdlDp,0.14285714285714285,6,6,CCAAACCGGCGTATGTTCAA,0,3213973
rdlDp,0.14285714285714285,6,6,CATTACCGTACGTTGGTTGT,0,3180046
rdlDp,0.14285714285714285,6,6,CATACAACAATTTTCTCGGA,0,3198206
rdlDp,0.14285714285714285,6,6,CAGGCTTAAGACCGGGCTCG,0,3198841
rdlDp,0.14285714285714285,6,6,CAGAGCCGCTCCATTGTACG,0,3192855
rdlDp,0.14285714285714285,6,6,CACTACGCATATTGCCCGTG,0,3171294
rdlDp,0.14285714285714285,6,6,CACTACACGACGGCCTCGTG,0,3198235
rdlDp,0.14285714285714285,6,6,CACACGTGCTCATAAAGCTA,0,3195552
rdlDp,0.14285714285714285,6,6,CACAACTTAACCACGTTTGA,0,3167462
rdlDp,0.14285714285714285,6,6,CAAGAGAGTCGGGCTACCAC,0,3180762
rdlDp,0.14285714285714285,6,6,CAAAATAGGCGACGTGGGTA,0,3166750
rdlDp,0.14285714285714285,6,6,ATTCTCGGACGAATAACTGT,0,3200824
rdlDp,0.14285714285714285,6,6,ATTCCGGGGAATGGTATGAA,0,3210847
rdlDp,0.14285714285714285,6,6,ATGGTCATGTTCGTGATGGT,0,3197360
rdlDp,0.14285714285714285,6,6,ATGGTATCTTTCTTGGGTAC,0,3194031
rdlDp,0.14285714285714285,6,6,ATGATACTCAGTGTTATGGA,0,3207160
rdlDp,0.14285714285714285,6,6,ATGAGTTCGGACAGTGAAGT,0,3176848
rdlDp,0.14285714285714285,6,6,ATCTGTCGCGGGATGCATGT,0,3169236
rdlDp,0.14285714285714285,6,6,ATCTCGAGCAGGCAGAGTTC,0,3212843
rdlDp,0.14285714285714285,6,6,ATCTATCGTAGTACGTGTGT,0,3167631
rdlDp,0.14285714285714285,6,6,ATCGTGTGTGTAATGGTACG,0,3190423
rdlDp,0.14285714285714285,6,6,ATACCCGTGAGGCCTGAGTA,0,3176855
rdlDp,0.14285714285714285,6,6,ATACACCCTGGGGAGTGAAA,0,3178574
rdlDp,0.14285714285714285,6,6,ATAATGTCCCGACGTGGAGA,0,3189562
rdlDp,0.14285714285714285,6,6,AGTGGGAAATTCAGTTTTGA,0,3174658
rdlDp,0.14285714285714285,6,6,AGTGACCCGGCGATTAATAG,0,3195091
rdlDp,0.14285714285714285,6,6,AGTATGCTCGAATCATATTT,0,3181997
rdlDp,0.14285714285714285,6,6,AGGCATGTCCTCATATCACA,0,3185724
rdlDp,0.14285714285714285,6,6,AGAGTTGTAGACTTCTTAGG,0,3168829
rdlDp,0.14285714285714285,6,6,ACTTCCGGCCCGACATGAAT,0,3166378
rdlDp,0.14285714285714285,6,6,ACTCGTGCAAACGCGTGCAA,0,3175322
rdlDp,0.14285714285714285,6,6,ACTAAGCCGTTTAGGGATTG,0,3172057
rdlDp,0.14285714285714285,6,6,ACGTCAAGCTGACAGAGTGT,0,3185137
rdlDp,0.14285714285714285,6,6,ACGCTTTCCGGGGATTCATG,0,3171401
rdlDp,0.14285714285714285,6,6,ACGCGTCGCTCTTCACCGAA,0,3196270
rdlDp,0.14285714285714285,6,6,ACGCGAGCCTGGGACTGGGC,0,3173417
rdlDp,0.14285714285714285,6,6,ACGCCGCGCATTATCGGCCT,0,3214193
rdlDp,0.14285714285714285,6,6,ACGCATAAGTCTGGTGCGCG,0,3199609
rdlDp,0.14285714285714285,6,6,ACCGAGCGCAAAGGATAATA,0,3178735
rdlDp,0.14285714285714285,6,6,ACCCAGGCGATGTCTTGAAC,0,3189940
rdlDp,0.14285714285714285,6,6,ACATCAGCCACGCCATTTCT,0,3191683
rdlDp,0.14285714285714285,6,6,ACAGATCGGATTCTGTGTCC,0,3168607
rdlDp,0.14285714285714285,6,6,AATGTTAACCAAGTCGGAGC,0,3166102
rdlDp,0.14285714285714285,6,6,AATGGCCGCGTTCTCCCAAC,0,3204427
rdlDp,0.14285714285714285,6,6,AATACGGATCCCCTCGGCAG,0,3167137
rdlDp,0.14285714285714285,6,6,AAGGCCATCCACTCGTTGGA,0,3185722
rdlDp,0.14285714285714285,6,6,AACAGAGAGTAACGTGGTTT,0,3205239
rdlDp,0.16666666666666666,5,5,TTTGAGTGCCGGTTTGTAGA,0,3206032
rdlDp,0.16666666666666666,5,5,TTTGACGCGCACAGGGTGGT,0,3188019
rdlDp,0.16666666666666666,5,5,TTTGAATAGTGCACAATGTT,0,3171841
rdlDp,0.16666666666666666,5,5,TTTCGACCGGAAACTTATTT,0,3184995
rdlDp,0.16666666666666666,5,5,TTTAGTGTCCAGTTGCGGTT,0,3167387
rdlDp,0.16666666666666666,5,5,TTTAGGGGGCAACGGGTCAT,0,3182256
rdlDp,0.16666666666666666,5,5,TTTACGCAAACTGCGGGTGA,0,3181308
rdlDp,0.16666666666666666,5,5,TTTACAAAAATCGTCTCCGG,0,3167307
rdlDp,0.16666666666666666,5,5,TTTAACTTGTAAGCCGTATA,0,3211106
rdlDp,0.16666666666666666,5,5,TTGGACTCCGCCGGAATGTT,0,3201158
rdlDp,0.16666666666666666,5,5,TTGCTGGTTTAATTAAGAGC,0,3202532
rdlDp,0.16666666666666666,5,5,TTGCCGCACCAAGGTTCCAA,0,3177517
rdlDp,0.16666666666666666,5,5,TTCAGACAATGGCGCAAGAA,0,3208510
rdlDp,0.16666666666666666,5,5,TGTTTGTGCCTGTCTATTAA,0,3191703
rdlDp,0.16666666666666666,5,5,TGTGTGGCCCGGCCATATCC,0,3171879
rdlDp,0.16666666666666666,5,5,TGTCGTCTAGGGTAACTTCT,0,3197217
rdlDp,0.16666666666666666,5,5,TGTCGAAAAGCTCGTCAGAG,0,3186859
rdlDp,0.16666666666666666,5,5,TGTCATCTTGGGGGGGCAAA,0,3211804
rdlDp,0.16666666666666666,5,5,TGGGTTCCAGTTGTATTTTT,0,3207942
rdlDp,0.16666666666666666,5,5,TGGGTGATGGAGACAAATAT,0,3181525
rdlDp,0.16666666666666666,5,5,TGGGTGAGCGACTGTCTTGT,0,3182431
rdlDp,0.16666666666666666,5,5,TGGACGGCGCAACGGTAGAT,0,3174457
rdlDp,0.16666666666666666,5,5,TGCTCCGCTACGCATGCCAG,0,3195450
rdlDp,0.16666666666666666,5,5,TGCGGCGCGCAATCGTTCGT,0,3166591
rdlDp,0.16666666666666666,5,5,TGCCTAAACATAGTCTATTA,0,3178280
rdlDp,0.16666666666666666,5,5,TGCCCCCCCACTCTGGAACC,0,3208902
rdlDp,0.16666666666666666,5,5,TGATAAGACTATTGGTTGCG,0,3201660
rdlDp,0.16666666666666666,5,5,TGACTTTAGGTTAGGTCTGG,0,3202331
rdlDp,0.16666666666666666,5,5,TGACTATGTTATCGTCACGT,0,3200660
rdlDp,0.16666666666666666,5,5,TGAAGCCTCCGCTAATTTGA,0,3192845
rdlDp,0.16666666666666666,5,5,TCTCTGTGGAGACGGCTGGG,0,3185123
rdlDp,0.16666666666666666,5,5,TCTCGGTAACAAAGGAGATC,0,3194632
rdlDp,0.16666666666666666,5,5,TCTCGCATAACATCGTATAG,0,3188762
rdlDp,0.16666666666666666,5,5,TCGGTGACCTACTTTCTCGA,0,3208923
rdlDp,0.16666666666666666,5,5,TCGCATGCTAATCCCTGGAT,0,3201529
rdlDp,0.16666666666666666,5,5,TCGATCATAGGGTGACTGTT,0,3174067
rdlDp,0.16666666666666666,5,5,TCGAGAGGTAGGCATTTTGT,0,3205355
rdlDp,0.16666666666666666,5,5,TCCCCTCAAGAATTCTAACT,0,3174165
rdlDp,0.16666666666666666,5,5,TCCCAATTTCCGCTTGAGTA,0,3187202
rdlDp,0.16666666666666666,5,5,TCATGGGGTAGTTTAATACT,0,3198927
rdlDp,0.16666666666666666,5,5,TCATCTCATGGGGGTAAGTA,0,3194045
rdlDp,0.16666666666666666,5,5,TCAGTATTTAGAACCGTAGA,0,3166671
rdlDp,0.16666666666666666,5,5,TCAATGGCTTTCCCTTGGAC,0,3187177
rdlDp,0.16666666666666666,5,5,TATGTACACCCCATGTCTGA,0,3205371
rdlDp,0.16666666666666666,5,5,TATGATAAGTTAGTCCGGTC,0,3165967
rdlDp,0.16666666666666666,5,5,TATCATAAGTCAACTGGAAG,0,3166136
rdlDp,0.16666666666666666,5,5,TAGCGTGAGATTCTCAGAGA,0,3176652
rdlDp,0.16666666666666666,5,5,TAGACATACATGGCGGGGAG,0,3200244
rdlDp,0.16666666666666666,5,5,TACTTTACCCTCCGTTCAGA,0,3193897
rdlDp,0.16666666666666666,5,5,TACTCCGCCCAGAGTCGTAA,0,3198826
rdlDp,0.16666666666666666,5,5,TACGTTTCGAAGGCTCGCTC,0,3212629
rdlDp,0.16666666666666666,5,5,TACAGGTGACGAAACCGATA,0,3175528
rdlDp,0.16666666666666666,5,5,TACAGGGGACTTCCTTTTTT,0,3205413
rdlDp,0.16666666666666666,5,5,TACAGGCTGTTATAACCTAC,0,3185821
rdlDp,0.16666666666666666,5,5,TACAACTGGATTGGCGGATT,0,3188550
rdlDp,0.16666666666666666,5,5,TAATACCACGGCTTTCTGCC,0,3173127
rdlDp,0.16666666666666666,5,5,TAAAGAACCACATTCACCAT,0,3186177
rdlDp,0.16666666666666666,5,5,TAAAACAGGCACCGCGAGGT,0,3164812
rdlDp,0.16666666666666666,5,5,GTTTAGCTGGGCATAGATCA,0,3215397
rdlDp,0.16666666666666666,5,5,GTTATGACTGGTGCACCGCA,0,3215793
rdlDp,0.16666666666666666,5,5,GTGTGAGTCTTCATTCGGTT,0,3183270
rdlDp,0.16666666666666666,5,5,GTGCGCGCCAGGCGAGCTGT,0,3166393
rdlDp,0.16666666666666666,5,5,GTGAACTGGGATTCAGCCGA,0,3174339
rdlDp,0.16666666666666666,5,5,GTCGATCGCCACGCGTTTGG,0,3214386
rdlDp,0.16666666666666666,5,5,GTCGAGCACCGCTCCAACGT,0,3199442
rdlDp,0.16666666666666666,5,5,GTCCATATTTCCACCGGAAT,0,3181060
rdlDp,0.16666666666666666,5,5,GTACGTCGGGAGTGAGCAGG,0,3172836
rdlDp,0.16666666666666666,5,5,GTACGAGTACGAGCCTCCTC,0,3184583
rdlDp,0.16666666666666666,5,5,GGTTTAGTGCAAAGTACCGT,0,3206248
rdlDp,0.16666666666666666,5,5,GGTTCGCCCGGCCATACGAA,0,3167633
rdlDp,0.16666666666666666,5,5,GGGGCGCAAATAAGCGGGTA,0,3187856
rdlDp,0.16666666666666666,5,5,GGGGAGACACAGGAATTGGG,0,3182026
rdlDp,0.16666666666666666,5,5,GGGCTTTGGTAAACGCTGAG,0,3190824
rdlDp,0.16666666666666666,5,5,GGGCGGCGCGGCACAGATCC,0,3184649
rdlDp,0.16666666666666666,5,5,GGGCCGGTTTCATCTGCTAC,0,3192011
rdlDp,0.16666666666666666,5,5,GGGCAGATATGATCTACTCG,0,3168163
rdlDp,0.16666666666666666,5,5,GGGATAAGGCGAGACCCACG,0,3180048
rdlDp,0.16666666666666666,5,5,GGCGGCAGCAAGACCATATA,0,3188373
rdlDp,0.16666666666666666,5,5,GGCCGCATCTAAACTCCGAC,0,3191760
rdlDp,0.16666666666666666,5,5,GGCAACTTCAATTTCAGTCG,0,3199462
rdlDp,0.16666666666666666,5,5,GCTTTGGTGACCGAAGTGAA,0,3195085
rdlDp,0.16666666666666666,5,5,GCTTTCAAAAGACCTACCAG,0,3195359
rdlDp,0.16666666666666666,5,5,GCTTGCTCAGGGTAAAAAGA,0,3174398
rdlDp,0.16666666666666666,5,5,GCTCGCAGCTAATCACTATT,0,3188111
rdlDp,0.16666666666666666,5,5,GCTAAGATGATACGCTAGCC,0,3214186
rdlDp,0.16666666666666666,5,5,GCGTCGTCCCGCTAGACCAA,0,3185866
rdlDp,0.16666666666666666,5,5,GCGTAAGGAGTGAACCATGT,0,3205554
rdlDp,0.16666666666666666,5,5,GCGGGTCATCATCCGATTAA,0,3195021
rdlDp,0.16666666666666666,5,5,GCCTTCCACTTACGATTTCC,0,3169384
rdlDp,0.16666666666666666,5,5,GCCATAGGTTTATTGTTATC,0,3174173
rdlDp,0.16666666666666666,5,5,GCCAGCATCAATCTACGTCA,0,3191011
rdlDp,0.16666666666666666,5,5,GCACTCTGGAGCGCTGTGAT,0,3183397
rdlDp,0.16666666666666666,5,5,GCACAGTTGAAGTTTGGGGA,0,3184038
rdlDp,0.16666666666666666,5,5,GATTTTCCAGTGTGTAGCGA,0,3199746
rdlDp,0.16666666666666666,5,5,GATCGCGCGGTCTGCTTCAT,0,3178063
rdlDp,0.16666666666666666,5,5,GATCATAGTTACGTGTGTGA,0,3179155
rdlDp,0.16666666666666666,5,5,GATCACTGCGCGACACGATC,0,3201222
rdlDp,0.16666666666666666,5,5,GAGTATCAGGATGGGGCTGG,0,3165907
rdlDp,0.16666666666666666,5,5,GAGGCCCGACCGCAGTCGGC,0,3213301
rdlDp,0.16666666666666666,5,5,GACTGAGGGGACGGCAACAA,0,3188504
rdlDp,0.16666666666666666,5,5,GACGGGCTGGGCGATGATGA,0,3187862
rdlDp,0.16666666666666666,5,5,GACGCTCTGTACCTTGTTGG,0,3205755
rdlDp,0.16666666666666666,5,5,GACCGAATTTAATCGTTGCG,0,3205312
rdlDp,0.16666666666666666,5,5,GACAAACTACGTAATGTTAC,0,3166165
rdlDp,0.16666666666666666,5,5,CTTGCTTAGTCGATAGCATC,0,3176143
rdlDp,0.16666666666666666,5,5,CTTCGGCCGTGCGCGTCCAT,0,3168185
rdlDp,0.16666666666666666,5,5,CTTCATAATGATTGTCTGGG,0,3173877
rdlDp,0.16666666666666666,5,5,CTTACTTTTGCTCACTGAGC,0,3191564
rdlDp,0.16666666666666666,5,5,CTGTATCTTACCCGACTCAT,0,3200763
rdlDp,0.16666666666666666,5,5,CTGCTCCGTGAACGCTTTAA,0,3165877
rdlDp,0.16666666666666666,5,5,CTGATGGTGATATCAAGACT,0,3203971
rdlDp,0.16666666666666666,5,5,CTGATCGAATCCAGGGATTG,0,3214323
rdlDp,0.16666666666666666,5,5,CTGAGACGATACGTAGAGTG,0,3173852
rdlDp,0.16666666666666666,5,5,CTGACAAAGTACTGTATTCC,0,3213253
rdlDp,0.16666666666666666,5,5,CTCTTCTCCCGGGTCCCCAC,0,3205427
rdlDp,0.16666666666666666,5,5,CTCTGAAGGTTCTGATACGT,0,3190730
rdlDp,0.16666666666666666,5,5,CTCGAAGATTCTGGAACTAC,0,3193933
rdlDp,0.16666666666666666,5,5,CTATTTACGGCTGCGCGGTC,0,3180508
rdlDp,0.16666666666666666,5,5,CTATCAAAAGGTATGAAGTG,0,3198475
rdlDp,0.16666666666666666,5,5,CTAAATCTTTACTTGTATCG,0,3174203
rdlDp,0.16666666666666666,5,5,CGTGTGCCGACCGAGCCTCG,0,3168174
rdlDp,0.16666666666666666,5,5,CGTGGGCAGTTTACAATTAT,0,3209762
rdlDp,0.16666666666666666,5,5,CGTGAAAGCACACCGTCTAC,0,3179075
rdlDp,0.16666666666666666,5,5,CGTCTTGGGATCTGGAGAGA,0,3214567
rdlDp,0.16666666666666666,5,5,CGTCGGGACCGTGGAAAAAT,0,3212630
rdlDp,0.16666666666666666,5,5,CGGTCGGCACTCACGGATGA,0,3204882
rdlDp,0.16666666666666666,5,5,CGGTATCAGAGAATTTGTAA,0,3181485
rdlDp,0.16666666666666666,5,5,CGGCTCGATCGTTTCCAAGG,0,3164258
rdlDp,0.16666666666666666,5,5,CGGCCTGAGCAACGGTGTAC,0,3213809
rdlDp,0.16666666666666666,5,5,CGGAGTACTAGGTCTCCCCC,0,3182891
rdlDp,0.16666666666666666,5,5,CCTAATTGCGCAGTCTAGAC,0,3205396
rdlDp,0.16666666666666666,5,5,CCGGTGGTAATCAAATAATC,0,3175347
rdlDp,0.16666666666666666,5,5,CCCTTGACGTGTGTCGCACA,0,3177166
rdlDp,0.16666666666666666,5,5,CCCTGACTGTGGCACAATGG,0,3188513
rdlDp,0.16666666666666666,5,5,CCCTGACGCGGAAAACCCAG,0,3196388
rdlDp,0.16666666666666666,5,5,CCATAGTCAGGTCCAAACTA,0,3194605
rdlDp,0.16666666666666666,5,5,CCAGTTGAACAACGTGTGCG,0,3206247
rdlDp,0.16666666666666666,5,5,CCAAATCGATTACAGTGTAT,0,3172130
rdlDp,0.16666666666666666,5,5,CATCAGGCTCATAAAGCTTT,0,3194609
rdlDp,0.16666666666666666,5,5,CATAGACCTTTAGTACAATT,0,3208378
rdlDp,0.16666666666666666,5,5,CATACCCATTTGAAAGGCGT,0,3183522
rdlDp,0.16666666666666666,5,5,CAGGACTCTATACTTTTTAG,0,3171072
rdlDp,0.16666666666666666,5,5,CAGCTGCGCGCACTGTTCTA,0,3192849
rdlDp,0.16666666666666666,5,5,CAGCACAGTGAAGAAGGATT,0,3167750
rdlDp,0.16666666666666666,5,5,CACTGATTTCGTCTCAATCA,0,3189591
rdlDp,0.16666666666666666,5,5,CAATCGTCCCACCCCGGCGT,0,3212373
rdlDp,0.16666666666666666,5,5,CAATCCGCCTGTGCACCTGT,0,3171496
rdlDp,0.16666666666666666,5,5,CAAGTGCTGAAATAGGAAGG,0,3200020
rdlDp,0.16666666666666666,5,5,CAAGTAAGCGAAGGCTCAAT,0,3176767
rdlDp,0.16666666666666666,5,5,ATGCACTAGAGCAAACGCAT,0,3202264
rdlDp,0.16666666666666666,5,5,ATGCAACGGTGGTCGTTACT,0,3188958
rdlDp,0.16666666666666666,5,5,ATGAGTTCCAATTGGTCTGG,0,3185825
rdlDp,0.16666666666666666,5,5,ATCTGGCGTTAGAAGAATTC,0,3203595
rdlDp,0.16666666666666666,5,5,ATCCTCAGGGTGTAGGAAAT,0,3176281
rdlDp,0.16666666666666666,5,5,ATCAACGGGTAATATACTTT,0,3182918
rdlDp,0.16666666666666666,5,5,ATATGAGCGAGTTATTATCC,0,3192116
rdlDp,0.16666666666666666,5,5,ATATCCATTATACTCGGAAA,0,3206929
rdlDp,0.16666666666666666,5,5,ATATATGAGTGTGACTGTGC,0,3202667
rdlDp,0.16666666666666666,5,5,ATAGGGGTTGAGGAGACCGG,0,3206015
rdlDp,0.16666666666666666,5,5,ATACTTGTTCGTATTCCAGT,0,3179225
rdlDp,0.16666666666666666,5,5,ATACGGGCCGCGACTTCGAG,0,3188963
rdlDp,0.16666666666666666,5,5,ATACATGTCTTGCACCAGCC,0,3175952
rdlDp,0.16666666666666666,5,5,ATAATCGGCCCAATTGTTTG,0,3213770
rdlDp,0.16666666666666666,5,5,ATAACCTGACCCACCAGCTA,0,3205824
rdlDp,0.16666666666666666,5,5,AGTTCCATGTGCAAAGACAA,0,3187844
rdlDp,0.16666666666666666,5,5,AGTGCCAACCACACAAGGCC,0,3165798
rdlDp,0.16666666666666666,5,5,AGGTAGTTCCCAGCCGTGGT,0,3165490
rdlDp,0.16666666666666666,5,5,AGGGCCGTTGGGTAATGTGA,0,3174745
rdlDp,0.16666666666666666,5,5,AGGCTCTCTTGAGAGCCACT,0,3171131
rdlDp,0.16666666666666666,5,5,AGGCCCCCGCGATCTCCAGA,0,3215986
rdlDp,0.16666666666666666,5,5,AGATTCTTTCGATTAGGGGA,0,3183269
rdlDp,0.16666666666666666,5,5,AGAGTGCGGGTCTACGGCTC,0,3198917
rdlDp,0.16666666666666666,5,5,AGAAATCTTGTGGAGTGGCT,0,3179153
rdlDp,0.16666666666666666,5,5,AGAAACAGCCGCAGTTCGGT,0,3208042
rdlDp,0.16666666666666666,5,5,ACTGATAGGCGAAAAGATGT,0,3195640
rdlDp,0.16666666666666666,5,5,ACTCATAGGAACCACTCCAG,0,3197772
rdlDp,0.16666666666666666,5,5,ACTCAATGGGTACTTTCTCT,0,3171046
rdlDp,0.16666666666666666,5,5,ACGTGTGTGCTTTGAAATAC,0,3171981
rdlDp,0.16666666666666666,5,5,ACGTCCAAGGCAGCAGGCTG,0,3191822
rdlDp,0.16666666666666666,5,5,ACGATGTTAAAAATACGCTA,0,3213589
rdlDp,0.16666666666666666,5,5,ACCTATACTGTTTGGCCATT,0,3196405
rdlDp,0.16666666666666666,5,5,ACCTAACTTTGGGTCCCCGT,0,3179168
rdlDp,0.16666666666666666,5,5,ACCGCTAGTTACTATTAGGA,0,3165927
rdlDp,0.16666666666666666,5,5,ACCGCGACTGGTATTGTTGG,0,3164096
rdlDp,0.16666666666666666,5,5,ACCGCAGCATCCCATTTTGG,0,3171053
rdlDp,0.16666666666666666,5,5,ACCCAGGTGTGCAATGGTCA,0,3170454
rdlDp,0.16666666666666666,5,5,ACCAGGAGGGGCTGAGCAAG,0,3211867
rdlDp,0.16666666666666666,5,5,ACCAGACAGCGGCCATAAGG,0,3175251
rdlDp,0.16666666666666666,5,5,ACACCGCTAGAATCATTCTG,0,3208567
rdlDp,0.16666666666666666,5,5,ACAAACAGATATTTTATGTA,0,3199789
rdlDp,0.16666666666666666,5,5,AATCGCCTTAAATCCCCAAT,0,3209662
rdlDp,0.16666666666666666,5,5,AATAGTCGCGCAGGAGGCTT,0,3198527
rdlDp,0.16666666666666666,5,5,AAGAAACGTGCGTGAGACTA,0,3192695
rdlDp,0.16666666666666666,5,5,AACGACGCGATCGTGCGTGG,0,3198360
rdlDp,0.16666666666666666,5,5,AACCTCCTAGTACACGCATG,0,3203723
rdlDp,0.16666666666666666,5,5,AACAACTTGCGTGTACGCGG,0,3165185
rdlDp,0.16666666666666666,5,5,AAATACGTTTGTAGAGGGGT,0,3167285
rdlDp,0.16666666666666666,5,5,AAAGACACTAAAGTCGTCCA,0,3173419
rdlDp,0.16666666666666666,5,5,AAACGTCAGACCATAAGGAC,0,3181280
rdlDp,0.16666666666666666,5,5,AAACGCTGCAGAGGCCAGAT,0,3182722
rdlDp,0.2,4,4,TTTTTCAAATCAGGTCCAGT,0,3170438
rdlDp,0.2,4,4,TTTTAAGGTTTAAAAGCCTT,0,3187084
rdlDp,0.2,4,4,TTTGCAATCACAGAGTCATT,0,3205442
rdlDp,0.2,4,4,TTGTTTGTAGGCTTTGACAC,0,3186437
rdlDp,0.2,4,4,TTGTGGATATAGTGATAATT,0,3211070
rdlDp,0.2,4,4,TTGTGAGGCTCCGTTCGGGA,0,3206562
rdlDp,0.2,4,4,TTGTCGGTAGGGGAAATCGT,0,3189695
rdlDp,0.2,4,4,TTGGCTGACTGGTACAAAGA,0,3193709
rdlDp,0.2,4,4,TTGCTGCAGTAGCCGCACGT,0,3208040
rdlDp,0.2,4,4,TTGAGTGAGTAGACTTGTAG,0,3205398
rdlDp,0.2,4,4,TTCGGGAGCCGAGTCTTGTA,0,3171169
rdlDp,0.2,4,4,TTCGCGTCCGTGGGTGCCAA,0,3210488
rdlDp,0.2,4,4,TTCAGCTCAGCATCTACGCT,0,3190978
rdlDp,0.2,4,4,TTCAGACACATCGTTCTCCC,0,3165496
rdlDp,0.2,4,4,TTCAAAACCAGAAGCAGTTC,0,3168156
rdlDp,0.2,4,4,TTATGGGATTGGTTGACTGT,0,3164553
rdlDp,0.2,4,4,TTAAGGGTCGCGTCCAGAGT,0,3214487
rdlDp,0.2,4,4,TGTGGATGGATCCTCTAGTC,0,3200684
rdlDp,0.2,4,4,TGTCGCTGACGGGAGTGCGG,0,3202059
rdlDp,0.2,4,4,TGTAAAGAGGAGCCAACCGG,0,3201051
rdlDp,0.2,4,4,TGGTGCTAATTCTCCTGCCT,0,3165157
rdlDp,0.2,4,4,TGGGTGTACGTTCATGGGTA,0,3165706
rdlDp,0.2,4,4,TGGAGGCTCGGAACGTAGGC,0,3184234
rdlDp,0.2,4,4,TGGAGGCGTTACGACTTATA,0,3204985
rdlDp,0.2,4,4,TGCTGAAGCACCTCATGCTC,0,3187813
rdlDp,0.2,4,4,TGCTACTAAATCTCGAATAG,0,3192856
rdlDp,0.2,4,4,TGCCTTGACGGCAGCGATCG,0,3201664
rdlDp,0.2,4,4,TGCCAAAGGGCAGTTGGCCT,0,3171137
rdlDp,0.2,4,4,TGACGCGCGTGATTACGACA,0,3211270
rdlDp,0.2,4,4,TGAACCCCACGGATCAGGCC,0,3174399
rdlDp,0.2,4,4,TGAAAGGGGTTAACAGCTCG,0,3192642
rdlDp,0.2,4,4,TCTTTGTCAAAAACATGACA,0,3195482
rdlDp,0.2,4,4,TCTTGCAGGTATGTTCCCTC,0,3208899
rdlDp,0.2,4,4,TCTTGAGCTTTTTGCTTGAG,0,3170114
rdlDp,0.2,4,4,TCTCTCCTGGTAACCGTAAA,0,3188067
rdlDp,0.2,4,4,TCTCACTGAGTTAACGACCT,0,3186874
rdlDp,0.2,4,4,TCGGGTGAGGGTAGACCACC,0,3188968
rdlDp,0.2,4,4,TCGGGCAAGCTGGGCAAGAG,0,3187091
rdlDp,0.2,4,4,TCGGATAGGTACGCCTGGTA,0,3204864
rdlDp,0.2,4,4,TCGAAGGCTTTATCCGTTAG,0,3195559
rdlDp,0.2,4,4,TCCTCGACAAAGGTTTGATA,0,3191315
rdlDp,0.2,4,4,TCCTCCGACGACGAGGCCCG,0,3170284
rdlDp,0.2,4,4,TCCGTCCGGCTAAAAGTTAA,0,3167564
rdlDp,0.2,4,4,TCCGTACCCTGACATCAGTG,0,3187192
rdlDp,0.2,4,4,TCAGAAATAAAAGGAATCAT,0,3208565
rdlDp,0.2,4,4,TCAAGCTGGAGGACAGTTAC,0,3185475
rdlDp,0.2,4,4,TATTCATCTTAGTAACTTTT,0,3201149
rdlDp,0.2,4,4,TATGCGATTCCGGGATCTAA,0,3167625
rdlDp,0.2,4,4,TATAGAGTGGTTCCGAGGCG,0,3197313
rdlDp,0.2,4,4,TAGGGCTCGACGGGCATGAC,0,3167855
rdlDp,0.2,4,4,TAGCTCCGACATAATGAAGC,0,3178127
rdlDp,0.2,4,4,TAGAGGGATGCGAACTTCAC,0,3190356
rdlDp,0.2,4,4,TACTCTCCTCCGCGATCTTG,0,3200688
rdlDp,0.2,4,4,TACTAGCCATATACACTTTG,0,3180337
rdlDp,0.2,4,4,TACGCGCCCAAGGAGGTATC,0,3179034
rdlDp,0.2,4,4,TACCATGTCCGTCACCCAAT,0,3181532
rdlDp,0.2,4,4,TAAGTAAACCCACAAAACCC,0,3200035
rdlDp,0.2,4,4,TAACGGCTCTTGTCCATTCG,0,3172160
rdlDp,0.2,4,4,TAACCTGAGCATGTAGCGCC,0,3207497
rdlDp,0.2,4,4,GTTGGTCCAACGTTGCGAAG,0,3191786
rdlDp,0.2,4,4,GTTGGCAGTCATTACACACG,0,3196618
rdlDp,0.2,4,4,GTTAGCGGAGTGCTAGTCCA,0,3193698
rdlDp,0.2,4,4,GTGTCTAGTGTGTTGACTCC,0,3204509
rdlDp,0.2,4,4,GTGCGCGGTAGTCATGCATC,0,3168390
rdlDp,0.2,4,4,GTCTTCTTCGATGGTCGCTG,0,3198906
rdlDp,0.2,4,4,GTACCCTTTTCCGTGCTAAG,0,3209509
rdlDp,0.2,4,4,GTAAGTTTCTCGAGGGCCGC,0,3204362
rdlDp,0.2,4,4,GGTTCATGACGGTGTCAGGG,0,3192679
rdlDp,0.2,4,4,GGTGTTTAGGCCCAACTCCA,0,3170237
rdlDp,0.2,4,4,GGGGGATCCGAGTATTCGTA,0,3206673
rdlDp,0.2,4,4,GGGCAGTAGCAGAGCACCAT,0,3203973
rdlDp,0.2,4,4,GGGAACAGATATACCTGCCG,0,3212752
rdlDp,0.2,4,4,GGCTCATTTCGGTCCCTGAC,0,3175529
rdlDp,0.2,4,4,GGCCGACAAGGCTGTCTATT,0,3185084
rdlDp,0.2,4,4,GGCAGCAACCGATTATGCAT,0,3179037
rdlDp,0.2,4,4,GGCACAACGGGATGAAACAA,0,3215017
rdlDp,0.2,4,4,GGATATTCAACGAAGCCTAG,0,3208299
rdlDp,0.2,4,4,GGACTAAGGCAATCTATCGG,0,3181800
rdlDp,0.2,4,4,GGACACGCACAACTAGCAGG,0,3167386
rdlDp,0.2,4,4,GCTGTGAGGTAAGTAGGTTT,0,3179130
rdlDp,0.2,4,4,GCTGTCCGTGTAAGGATTCA,0,3168149
rdlDp,0.2,4,4,GCTGAAGTCCCATCACGATA,0,3166337
rdlDp,0.2,4,4,GCTACCGTACAACTAGGTGG,0,3191563
rdlDp,0.2,4,4,GCGCTGCGCGCGATATCGAA,0,3173427
rdlDp,0.2,4,4,GCCGGCCGCTTTGGCTCTCC,0,3179524
rdlDp,0.2,4,4,GCCATTGCCTCGGGGGGCAA,0,3173144
rdlDp,0.2,4,4,GCATCTCAGGTTGGCTTGAT,0,3206653
rdlDp,0.2,4,4,GCACTGTATTTAACAATTCC,0,3181717
rdlDp,0.2,4,4,GCAACTCATGAAACATACGT,0,3200753
rdlDp,0.2,4,4,GATGAGTGGCAGCGTTGCCA,0,3179521
rdlDp,0.2,4,4,GATCGCCCCGTTAGTTTTAC,0,3183960
rdlDp,0.2,4,4,GATCCAGGCGTGGGACCGTG,0,3192685
rdlDp,0.2,4,4,GACTCTAGCGATCGAATCAG,0,3194309
rdlDp,0.2,4,4,GACTCGTGTATACTGGCCAA,0,3171425
rdlDp,0.2,4,4,GACTATTTTTTGATATAGAA,0,3210220
rdlDp,0.2,4,4,GACGGGCCATGCTCGTTCAA,0,3199120
rdlDp,0.2,4,4,GACGGAAATCAATTAGGGCA,0,3169752
rdlDp,0.2,4,4,GACGACGGCGAATGCCCCTG,0,3185867
rdlDp,0.2,4,4,GACAGCTGAGATGTTTTATA,0,3168830
rdlDp,0.2,4,4,GAATGTTGTTATGCCCATGA,0,3185485
rdlDp,0.2,4,4,GAAGGAGCGAGCCAAGATGC,0,3179859
rdlDp,0.2,4,4,CTTTACTGAACTTTCGCCAT,0,3173184
rdlDp,0.2,4,4,CTTGTAAGGGTTGAGGGGCA,0,3186033
rdlDp,0.2,4,4,CTTGGTTGTCATCTGGGTAT,0,3201148
rdlDp,0.2,4,4,CTTCAACATAGTGGTACCAA,0,3182702
rdlDp,0.2,4,4,CTTACTCTTCTGGCCTGGGA,0,3179558
rdlDp,0.2,4,4,CTCGCGGAACACTCGTTATT,0,3209010
rdlDp,0.2,4,4,CTCCTGCCGTAGTTAGTGAA,0,3203862
rdlDp,0.2,4,4,CTATTAATGAGCCACCATCC,0,3208897
rdlDp,0.2,4,4,CTATATGTTTCAGGCATTAT,0,3199924
rdlDp,0.2,4,4,CTAGCAGTCTTATGCACTTC,0,3179077
rdlDp,0.2,4,4,CTACAATCCTCTCGAGGTTC,0,3198464
rdlDp,0.2,4,4,CGTTACGGACCTGGAGGGGG,0,3182937
rdlDp,0.2,4,4,CGTGTTGATATACCACGCTG,0,3189927
rdlDp,0.2,4,4,CGGTTTCCCATTGGGACTTA,0,3214846
rdlDp,0.2,4,4,CGGTCCGGGCTCTGGCGGCG,0,3186233
rdlDp,0.2,4,4,CGGCGTACCTCCGGAACTAA,0,3186312
rdlDp,0.2,4,4,CGGCGGAAGAAATGGTCGGA,0,3203719
rdlDp,0.2,4,4,CGGCCGATCTACTCGTCTCA,0,3178922
rdlDp,0.2,4,4,CGGCCAGGACTATCAGGGCT,0,3168935
rdlDp,0.2,4,4,CGGAAGGAGGGAATCGTGGC,0,3200010
rdlDp,0.2,4,4,CGCTTCTAGTTATTGTACGG,0,3198596
rdlDp,0.2,4,4,CGCGTCGATGGAGCCCACGG,0,3169456
rdlDp,0.2,4,4,CGAGCTGCTTGCGACTTTTC,0,3189465
rdlDp,0.2,4,4,CCTTGTGAGGAGGGTTGAAT,0,3185610
rdlDp,0.2,4,4,CCTCATGTACGGTCGGCCGA,0,3187102
rdlDp,0.2,4,4,CCTCAACAGTGCCACTCCCC,0,3197482
rdlDp,0.2,4,4,CCTAGAACCAGAGCCTCATG,0,3193387
rdlDp,0.2,4,4,CCTACTTTCCCTGATTTTCA,0,3215366
rdlDp,0.2,4,4,CCGTGACGAGCATCTGTGAC,0,3178608
rdlDp,0.2,4,4,CCGTAGTTGGGCTATCCGTA,0,3187377
rdlDp,0.2,4,4,CCGATATTCGAGGGAGTATT,0,3199358
rdlDp,0.2,4,4,CCGAGCGTGGCGCCTACGGT,0,3202379
rdlDp,0.2,4,4,CCCTGGCTCGTTGGGGGAGG,0,3179436
rdlDp,0.2,4,4,CCCTAACCCAGGCATCTTTG,0,3184235
rdlDp,0.2,4,4,CCCGCACGAGCCTGTGACGC,0,3213298
rdlDp,0.2,4,4,CCCAGCCCCAGATTATTTTA,0,3184677
rdlDp,0.2,4,4,CCCACCAGACGATGCTGCGT,0,3164912
rdlDp,0.2,4,4,CCATTGCATCTGCGAGGGCG,0,3203972
rdlDp,0.2,4,4,CCAGCGTCCCCCAACTGCAG,0,3167545
rdlDp,0.2,4,4,CATATATGAAGCCCGTCAGT,0,3187830
rdlDp,0.2,4,4,CATATAACGATTAGAGTCTG,0,3179127
rdlDp,0.2,4,4,CATAACAGTGTAGTAACAGA,0,3194947
rdlDp,0.2,4,4,CAGTTATGTATGATTAGCTG,0,3166707
rdlDp,0.2,4,4,CAGGGTGGTACATAAGGGAC,0,3204417
rdlDp,0.2,4,4,CAGCTAGACAAGTGAAAGGT,0,3164216
rdlDp,0.2,4,4,CACGCCTTCGGCCATAGGCT,0,3207993
rdlDp,0.2,4,4,CACCGGTAACTTTCTCTCGG,0,3164256
rdlDp,0.2,4,4,CACCACCCATGGGCGAGGTG,0,3201642
rdlDp,0.2,4,4,CACCAAAGATCACCACTTAT,0,3192189
rdlDp,0.2,4,4,CAATCCCGTGTTAATGGAGG,0,3184925
rdlDp,0.2,4,4,CAAAGGTGAATAGAGCTTCA,0,3190864
rdlDp,0.2,4,4,ATTGGTGTTTCGCCCTGGAA,0,3166855
rdlDp,0.2,4,4,ATTGGAAAACGTATCCCCTG,0,3187809
rdlDp,0.2,4,4,ATTGCAGAATAGGACGGCAG,0,3176747
rdlDp,0.2,4,4,ATTCTGTGCCCTTCGTCAAA,0,3194098
rdlDp,0.2,4,4,ATTAGAGCGGACGAAATACG,0,3188916
rdlDp,0.2,4,4,ATTAAGAATGTGCATATCAG,0,3193656
rdlDp,0.2,4,4,ATGTACTTCCTCCACACTCA,0,3166377
rdlDp,0.2,4,4,ATGCCCTCAGCGGTCGTAAG,0,3198505
rdlDp,0.2,4,4,ATGAGTTTTTCGTAGAGCGA,0,3164364
rdlDp,0.2,4,4,ATCTCGTGACCAAGCCCTCT,0,3173736
rdlDp,0.2,4,4,ATCGCCCTACACTGTTGACC,0,3188917
rdlDp,0.2,4,4,ATATTCTCCGGTAAAGTCTA,0,3169563
rdlDp,0.2,4,4,ATATAGGTGGGAATCTCGCT,0,3187695
rdlDp,0.2,4,4,ATAGTCACCAACAGCCTAGT,0,3187185
rdlDp,0.2,4,4,ATAATGACTAAGGGCTTAGG,0,3203791
rdlDp,0.2,4,4,AGTTTAAGGCTTCTATATGG,0,3173405
rdlDp,0.2,4,4,AGGTTTGTAAAGTACTACCG,0,3182307
rdlDp,0.2,4,4,AGGTTATCGTATATGATATA,0,3209204
rdlDp,0.2,4,4,AGGGTCTGGGGACAGCATGG,0,3194621
rdlDp,0.2,4,4,AGGCATCACGTCTTTGACAT,0,3168644
rdlDp,0.2,4,4,AGGCAGTTCATTCATCGAGC,0,3184050
rdlDp,0.2,4,4,AGCTGTACTCCGATAACATC,0,3203301
rdlDp,0.2,4,4,AGCGTACCCTTCTGAGTTCA,0,3178121
rdlDp,0.2,4,4,AGAGGATCTGATATGCTGCT,0,3181983
rdlDp,0.2,4,4,AGACATGAACAAATAGGACG,0,3208971
rdlDp,0.2,4,4,ACTTTTTTGTATGCTAGCGC,0,3197286
rdlDp,0.2,4,4,ACTTGTGTTTGGCCTGTAAG,0,3186154
rdlDp,0.2,4,4,ACTATGTAGGGATAACCACA,0,3168227
rdlDp,0.2,4,4,ACGCCATAACACGTGTGATT,0,3209518
rdlDp,0.2,4,4,ACGCACTTGATGATGTAATA,0,3176856
rdlDp,0.2,4,4,ACGAGTGAGGACTAGCTGCG,0,3198039
rdlDp,0.2,4,4,ACCTTGGAATTCCGCAATAA,0,3211814
rdlDp,0.2,4,4,ACCTCGTCTATGTCTCTTGG,0,3182302
rdlDp,0.2,4,4,ACCGGTAGGACGGTGTTCCA,0,3201775
rdlDp,0.2,4,4,ACCCTCGGTAGAGGACAATA,0,3173411
rdlDp,0.2,4,4,ACCCTAACACTATCGTGTTA,0,3185713
rdlDp,0.2,4,4,ACCCACGGTACACGATTAAT,0,3211071
rdlDp,0.2,4,4,ACATCGCCGTATGACCTGGC,0,3188771
rdlDp,0.2,4,4,ACATAGGTTAGTCTTATATC,0,3172672
rdlDp,0.2,4,4,AATTGGGGGGGTAATATAAG,0,3167960
rdlDp,0.2,4,4,AATGATTAGTGCTCATCAGG,0,3188156
rdlDp,0.2,4,4,AATCTGGAAATGCAAATGTG,0,3203471
rdlDp,0.2,4,4,AATCGGTCCCGCATCTTGCG,0,3195339
rdlDp,0.2,4,4,AATCACACAAGGCGAGGATG,0,3206568
rdlDp,0.2,4,4,AATAGACCCGTCTGAGGTAC,0,3182118
rdlDp,0.2,4,4,AATACGGAAAGGCGATGACT,0,3165289
rdlDp,0.2,4,4,AAGGTGCATTGTCGGACCCC,0,3170335
rdlDp,0.2,4,4,AACGTGGCGGCGACCGAGGT,0,3180775
rdlDp,0.2,4,4,AACGGGCGGGCTTGATCCGG,0,3198458
rdlDp,0.2,4,4,AACACGAACCGGAAAGGTCG,0,3189618
rdlDp,0.2,4,4,AACAAGGGATGAAACCTCTA,0,3200779
rdlDp,0.2,4,4,AAAGTCACGAGTTACAAAGA,0,3208934
rdlDp,0.25,3,3,TTTGGTGCTCACCTTCTAGA,0,3166508
rdlDp,0.25,3,3,TTTATGCTCCTAGGACGAAC,0,3202064
rdlDp,0.25,3,3,TTTACCCCACTTTTCAAGCC,0,3167665
rdlDp,0.25,3,3,TTGGATACTGCTCATGCTTT,0,3165002
rdlDp,0.25,3,3,TTCTTAGATCCTGAGACAGC,0,3179120
rdlDp,0.25,3,3,TTCTCGTGCCCTCAAGGTAC,0,3203495
rdlDp,0.25,3,3,TTCTCGACTCCGGCATTGTA,0,3176709
rdlDp,0.25,3,3,TTCGGGCGAGAGTAGGGTCT,0,3186189
rdlDp,0.25,3,3,TTAGTACCCATTCTGGTCAC,0,3214854
rdlDp,0.25,3,3,TTAGCTAGGCGACCGATTTT,0,3188393
rdlDp,0.25,3,3,TTACCAAGAGAACCTCTTCC,0,3167234
rdlDp,0.25,3,3,TGTTGAACCGCCAGCGGTGA,0,3165799
rdlDp,0.25,3,3,TGTTACGACTTCATCGTGTT,0,3167541
rdlDp,0.25,3,3,TGTGTAGCGCCTCGTTTTAA,0,3208930
rdlDp,0.25,3,3,TGTGCAGCTGGCGGCGTCCA,0,3168074
rdlDp,0.25,3,3,TGTCTAGAGCTAAGATGCGA,0,3190862
rdlDp,0.25,3,3,TGTCACCTACGCCTGTAAAT,0,3175879
rdlDp,0.25,3,3,TGTAGGCCCCTCCCAGACAC,0,3171238
rdlDp,0.25,3,3,TGGGGGCGTTATGTACGTGT,0,3187817
rdlDp,0.25,3,3,TGGGGAAGCTCATGTGTCCC,0,3206782
rdlDp,0.25,3,3,TGGGACCCGGTCCCTAGATT,0,3189174
rdlDp,0.25,3,3,TGGCTTCCTGATTTACCAAT,0,3201668
rdlDp,0.25,3,3,TGGCACTACGCGGACGACCA,0,3211734
rdlDp,0.25,3,3,TGGAGCCGATATTAGGTCCA,0,3211523
rdlDp,0.25,3,3,TGATGACTGGCGACGTGGTA,0,3165539
rdlDp,0.25,3,3,TGATACCGCAAAGCCGAACA,0,3200811
rdlDp,0.25,3,3,TGATAAGGCCGGCCGGACTA,0,3204974
rdlDp,0.25,3,3,TGACTATTCGAACTGAGCGT,0,3191706
rdlDp,0.25,3,3,TGACCAGCATCATTATCGGG,0,3179333
rdlDp,0.25,3,3,TCTTGGGCACTTAGAGGATA,0,3204656
rdlDp,0.25,3,3,TCTGTTCCACTTTCACTGTA,0,3167660
rdlDp,0.25,3,3,TCTCGGATGGCACTTGGCAT,0,3168180
rdlDp,0.25,3,3,TCTCGAGAATAGGGTTCGTA,0,3180544
rdlDp,0.25,3,3,TCTCCTCTTTTTCTGATTAA,0,3188333
rdlDp,0.25,3,3,TCTACTAAAGGCGTCTGGGT,0,3185338
rdlDp,0.25,3,3,TCTAACTTCCTGTCTCCTTA,0,3207661
rdlDp,0.25,3,3,TCTAAATTGGTATTACGAGG,0,3176858
rdlDp,0.25,3,3,TCGTATTACCGTATTTGTAG,0,3175531
rdlDp,0.25,3,3,TCGGAAACACGGAAGTTGAC,0,3198174
rdlDp,0.25,3,3,TCGAGGAGAAGTGCTTGGGG,0,3181935
rdlDp,0.25,3,3,TCCGTCCTAAACATCACAAT,0,3191762
rdlDp,0.25,3,3,TCCGGGGGCGTGTGAGTCTT,0,3199351
rdlDp,0.25,3,3,TCCCGAGCGCGTGGTCCCCT,0,3200175
rdlDp,0.25,3,3,TCCATTTTAAACCCTTGCAA,0,3208318
rdlDp,0.25,3,3,TCCATCGGCATATTATATCA,0,3191682
rdlDp,0.25,3,3,TCATCGTGTTTGGCTCACAT,0,3203600
rdlDp,0.25,3,3,TCAGTTCTTCCTGACGGGTT,0,3205901
rdlDp,0.25,3,3,TCAGTTAGCATTACAATCCA,0,3212319
rdlDp,0.25,3,3,TCACATACGTGGATCGGACT,0,3164611
rdlDp,0.25,3,3,TCAAAAAGCCGAACCGCCGT,0,3211806
rdlDp,0.25,3,3,TATTCAGTATCCGCCTTGGA,0,3191303
rdlDp,0.25,3,3,TATTAAGGGGTATGAAGTCG,0,3204309
rdlDp,0.25,3,3,TATCCGCTGTTTGCTTATGC,0,3190462
rdlDp,0.25,3,3,TAGGGGCTCCGTGTTCAATT,0,3208337
rdlDp,0.25,3,3,TACGAAACACGACCGTTGAC,0,3198490
rdlDp,0.25,3,3,TACCTCCCATACATTAGTGT,0,3202953
rdlDp,0.25,3,3,TACAGGTTACTTACTGTAGT,0,3204870
rdlDp,0.25,3,3,TACAGAAAAAACTATGCCTT,0,3181533
rdlDp,0.25,3,3,TACAAGGTTACCGGCACGTC,0,3184723
rdlDp,0.25,3,3,TAAGAGAACCGACTGCTCGT,0,3164521
rdlDp,0.25,3,3,TAACGCTCTCGTAGGCGGCA,0,3207498
rdlDp,0.25,3,3,TAACGCGAAATCAAAGCGGC,0,3172814
rdlDp,0.25,3,3,TAAAGACTTTACCGTAACCG,0,3166115
rdlDp,0.25,3,3,TAAAAGCATGTAAAAGTTCA,0,3198660
rdlDp,0.25,3,3,GTTTGAAGCGGGGGGACGCA,0,3179163
rdlDp,0.25,3,3,GTTTCCTTCACGCTTAGCGT,0,3184224
rdlDp,0.25,3,3,GTTTATGATTACGCAGGGGA,0,3178337
rdlDp,0.25,3,3,GTTGTAATATACCAGCTGCA,0,3179122
rdlDp,0.25,3,3,GTTGGGTGCGTTGCGGCGGA,0,3200141
rdlDp,0.25,3,3,GTGGTCGGAAAGGTCGAGCG,0,3180183
rdlDp,0.25,3,3,GTGGGCTCCAAAAACTATTG,0,3195560
rdlDp,0.25,3,3,GTGGCGTTTCGGGGAATTTT,0,3175921
rdlDp,0.25,3,3,GTGCGTCTGGCTGTGCCGTC,0,3205828
rdlDp,0.25,3,3,GTGCGGTTGGAATTCTTGGT,0,3164861
rdlDp,0.25,3,3,GTCTAGCGCGATTCAGTACC,0,3191465
rdlDp,0.25,3,3,GTCGCACATCTTATCTCTTA,0,3205403
rdlDp,0.25,3,3,GTACGAGATGAAGCCCAAAT,0,3186243
rdlDp,0.25,3,3,GGTTTACCAAGGAATAGGTC,0,3176714
rdlDp,0.25,3,3,GGTCACGGAGTTAGGGATCT,0,3182662
rdlDp,0.25,3,3,GGGGAAAGAGTTCCCCTAGG,0,3182426
rdlDp,0.25,3,3,GGGCCGCTCCACCGGTTGTA,0,3169218
rdlDp,0.25,3,3,GGGACCATTACCCATCGCCC,0,3178736
rdlDp,0.25,3,3,GGCTTGGCCCTAACCATGCA,0,3202554
rdlDp,0.25,3,3,GGCTCCCCATCAAAACATGC,0,3211356
rdlDp,0.25,3,3,GGCTATCATTTGGGTAAGAG,0,3191301
rdlDp,0.25,3,3,GGCTATAACTCAGTCTGGTT,0,3195369
rdlDp,0.25,3,3,GGCTAGAACGCTTGGAGTAG,0,3202850
rdlDp,0.25,3,3,GGCGAGTTCATTACGAGTCT,0,3176704
rdlDp,0.25,3,3,GGCCTTAGGATGCAGCTAAT,0,3176239
rdlDp,0.25,3,3,GGCAGAAAATTAGCGATATC,0,3182164
rdlDp,0.25,3,3,GGATGCGGGGCGGATGCTGC,0,3173166
rdlDp,0.25,3,3,GGATATCGTACACATGCCCG,0,3198837
rdlDp,0.25,3,3,GGATATACGTTCTTATGTCT,0,3180773
rdlDp,0.25,3,3,GGATAAACGGTCTGTGTCCA,0,3165448
rdlDp,0.25,3,3,GGAGGAAGCCAGAATTCGTC,0,3187558
rdlDp,0.25,3,3,GGACAGTCAGGTATTCACTA,0,3205282
rdlDp,0.25,3,3,GGACACTCCATAGGCATCGC,0,3190555
rdlDp,0.25,3,3,GCTTGGGGACAACCCGCAGT,0,3164153
rdlDp,0.25,3,3,GCTTGGAGAGAGATTGTCGC,0,3187587
rdlDp,0.25,3,3,GCTGTGGTTCAATAAAAGGT,0,3213181
rdlDp,0.25,3,3,GCTCTTCGGTTTGGATTGAC,0,3164796
rdlDp,0.25,3,3,GCTCCCAAGAACGAGTGTTC,0,3193655
rdlDp,0.25,3,3,GCTCAAAACCGGGAGTAGCG,0,3181925
rdlDp,0.25,3,3,GCGTGTGAGTTGTAACCCAT,0,3203792
rdlDp,0.25,3,3,GCGGGATGAGCGGGACCCCA,0,3192687
rdlDp,0.25,3,3,GCGGAATAGCCAGTCTTGAC,0,3165487
rdlDp,0.25,3,3,GCGACTCACACACTTTTTCA,0,3207998
rdlDp,0.25,3,3,GCCGCTGGCACCGCTTTGGC,0,3205555
rdlDp,0.25,3,3,GCCGCCAATTACATATTTCT,0,3169740
rdlDp,0.25,3,3,GCCCTTAGACGTCGAAACCT,0,3189518
rdlDp,0.25,3,3,GCCCATAGTGGCCAACGGCG,0,3202393
rdlDp,0.25,3,3,GCCATCATCAGTTGGGAAAC,0,3170364
rdlDp,0.25,3,3,GCATTTTGCTCAATCTCGAT,0,3178714
rdlDp,0.25,3,3,GCAGTTTCGGTTGCAATCTC,0,3183126
rdlDp,0.25,3,3,GCAGGTTCCGTATAACGGAA,0,3197661
rdlDp,0.25,3,3,GCAAACCCATTCAATGCCAA,0,3166573
rdlDp,0.25,3,3,GCAAAAGTATCTATCAATGA,0,3190408
rdlDp,0.25,3,3,GCAAAAAGATAGCGGGGGCG,0,3178106
rdlDp,0.25,3,3,GATTGACATGGTCGTTGAAC,0,3175650
rdlDp,0.25,3,3,GATGCATGCATTCGGTTTGT,0,3175882
rdlDp,0.25,3,3,GATAGGAAGTCGTAAGCGTC,0,3203375
rdlDp,0.25,3,3,GATAACTAATTAATAAAAGG,0,3175525
rdlDp,0.25,3,3,GAGGCCTGCGAGGTTGCTGC,0,3194537
rdlDp,0.25,3,3,GAGCCCTTAGGTGAGTCATA,0,3198529
rdlDp,0.25,3,3,GACTAATCTAGAAGAAATAA,0,3192686
rdlDp,0.25,3,3,GACGGGGGTATCTAATTTTT,0,3184578
rdlDp,0.25,3,3,GACAATGGAGCTTTGTTACG,0,3180769
rdlDp,0.25,3,3,GAAGTATTAACCCAATGACG,0,3177787
rdlDp,0.25,3,3,GAACCGGGTACACACGTGAT,0,3200689
rdlDp,0.25,3,3,GAAACAGCACGCTCCAAAAG,0,3210876
rdlDp,0.25,3,3,CTTTAGATGTGTGTAGTTTA,0,3204370
rdlDp,0.25,3,3,CTTGGCGCTAGGGACTGACC,0,3210745
rdlDp,0.25,3,3,CTTATAGCGATTTATGGGTT,0,3187678
rdlDp,0.25,3,3,CTGTTTCACCTAATATTATG,0,3197223
rdlDp,0.25,3,3,CTGGTTTAGGACTCACCCAT,0,3191723
rdlDp,0.25,3,3,CTGGTCGTGTGTCTACGTTC,0,3192222
rdlDp,0.25,3,3,CTGGCCTCAGCGAGGCATTT,0,3190378
rdlDp,0.25,3,3,CTGCGCTAGACTACTTGAAT,0,3209456
rdlDp,0.25,3,3,CTGATTGGGAGATCTGCTAT,0,3182300
rdlDp,0.25,3,3,CTGACCGGGCATCCCGGTAG,0,3169718
rdlDp,0.25,3,3,CTCGTGCGCACCATTATGGT,0,3186029
rdlDp,0.25,3,3,CTCGTCGCCATCGGGCGAAC,0,3203714
rdlDp,0.25,3,3,CTCGTATTATTTCAACAGGC,0,3190451
rdlDp,0.25,3,3,CTCCATCCAGGCCATACATA,0,3175576
rdlDp,0.25,3,3,CTCAGTCGCATCCATGGACG,0,3213961
rdlDp,0.25,3,3,CTATGCAATACTCCTTGCCC,0,3188076
rdlDp,0.25,3,3,CTAGTTTGGAATACGATATT,0,3201566
rdlDp,0.25,3,3,CTAGTAATGCGCTCGGCCGG,0,3165913
rdlDp,0.25,3,3,CGTTTTTCGCAGGCATGTGT,0,3182318
rdlDp,0.25,3,3,CGTTGTGCAGACCTCGAGAA,0,3185415
rdlDp,0.25,3,3,CGTGCTGGAACAGTGCAGAT,0,3164159
rdlDp,0.25,3,3,CGTCCATAGCGGGATTGGGA,0,3169238
rdlDp,0.25,3,3,CGTACACTTATTTTAGAAGG,0,3191911
rdlDp,0.25,3,3,CGGTTGCGTCACTGCTCAGT,0,3194938
rdlDp,0.25,3,3,CGGGAGATTCGAGGTTTCAT,0,3194104
rdlDp,0.25,3,3,CGGCAAGTCCAGCAAATGTT,0,3207585
rdlDp,0.25,3,3,CGCGTAGAGAAACGTTAGTC,0,3199577
rdlDp,0.25,3,3,CGCCCTACAAGCTCACGGGC,0,3201631
rdlDp,0.25,3,3,CGCAGCGAACATCGCCCATC,0,3167644
rdlDp,0.25,3,3,CGCACATGAGGCGGGGCTAG,0,3186322
rdlDp,0.25,3,3,CGAGATTGTTGTCGTACGCT,0,3204249
rdlDp,0.25,3,3,CGAGACGTGCAAGGATAAGC,0,3193818
rdlDp,0.25,3,3,CCTTCACAATCAGCCACCTG,0,3214553
rdlDp,0.25,3,3,CCTGGTCAAAGGCGCTGCGG,0,3213586
rdlDp,0.25,3,3,CCTATCTAGCACCTGCGTGG,0,3168973
rdlDp,0.25,3,3,CCTAGGGCACGGAATCCTGT,0,3205204
rdlDp,0.25,3,3,CCGTACGGAAAAGTTTACTG,0,3199844
rdlDp,0.25,3,3,CCGGATTTTCCTTACATCTA,0,3182446
rdlDp,0.25,3,3,CCGCTGGGACCCCGATTTAC,0,3170398
rdlDp,0.25,3,3,CCGAGCAATAGAATCCTAAT,0,3166853
rdlDp,0.25,3,3,CCGACGCATGGTCGGTTGTA,0,3188329
rdlDp,0.25,3,3,CCCTTTGTAATTTTGATTCT,0,3213113
rdlDp,0.25,3,3,CCCTCTTGACTCGGATTCCT,0,3190859
rdlDp,0.25,3,3,CCCGCGCCGCGGCGTGTTAC,0,3203479
rdlDp,0.25,3,3,CCATCTTACGGCGCCGCTGG,0,3198838
rdlDp,0.25,3,3,CCATATAGAAACGTGTGTGG,0,3183968
rdlDp,0.25,3,3,CCAGTAGGATTGATCCTGGG,0,3210767
rdlDp,0.25,3,3,CCACAGCCACTAGGGACCCT,0,3200839
rdlDp,0.25,3,3,CATTTCAGGTGTCATAATAA,0,3207732
rdlDp,0.25,3,3,CATTAGCGGGACCAGGGCAT,0,3165904
rdlDp,0.25,3,3,CATGTGACAGAAGCGTCTAC,0,3175896
rdlDp,0.25,3,3,CATGAGCTGGGCACCTATAC,0,3203853
rdlDp,0.25,3,3,CATATCTCTACACGCAAGAC,0,3180172
rdlDp,0.25,3,3,CAGGGTGGTGGTTGCCCGAT,0,3167100
rdlDp,0.25,3,3,CAGGGCGCCGAATGACAGGT,0,3166569
rdlDp,0.25,3,3,CAGCATGCGACATGGAAGTA,0,3182408
rdlDp,0.25,3,3,CAGACCTTGTAGGCCGGACG,0,3172697
rdlDp,0.25,3,3,CACGTAATGATTAAGCTCGG,0,3211049
rdlDp,0.25,3,3,CACGCTAGAGTAATCACGCC,0,3164337
rdlDp,0.25,3,3,CAATTAGGATTCACATGGAA,0,3168454
rdlDp,0.25,3,3,CAAGGAACGAGGGGTGATAG,0,3206408
rdlDp,0.25,3,3,CAAATCCCAATGCTGTCGCG,0,3198933
rdlDp,0.25,3,3,CAAATAATGCCAGCCCAAGT,0,3181694
rdlDp,0.25,3,3,ATTTTTTCACGAGTGACCGG,0,3206033
rdlDp,0.25,3,3,ATTGACGGAGTATCGCTTCC,0,3201339
rdlDp,0.25,3,3,ATTCTTGCACGCTTCGCAAA,0,3176284
rdlDp,0.25,3,3,ATTCAGGTTGTTTATTCGTC,0,3209300
rdlDp,0.25,3,3,ATTACACTCTCCGTGATAAA,0,3164248
rdlDp,0.25,3,3,ATGTTTGTTATACCAATGGG,0,3185043
rdlDp,0.25,3,3,ATGCGCCACCGAATTATGGA,0,3189759
rdlDp,0.25,3,3,ATGCCACCTCGTAAGCAGTG,0,3184708
rdlDp,0.25,3,3,ATCCTCTCGTAATGTCGCGA,0,3169972
rdlDp,0.25,3,3,ATCATCGTCGCACACACTGA,0,3215870
rdlDp,0.25,3,3,ATCACCATCTCGAGTTTTAC,0,3190338
rdlDp,0.25,3,3,ATAGACTAACAGTGAACTTA,0,3202290
rdlDp,0.25,3,3,ATACCGGCACACGTACTTAA,0,3178228
rdlDp,0.25,3,3,AGTTTCGCCCCTGGCGGGGA,0,3209937
rdlDp,0.25,3,3,AGTCGAGTAAGCTATTTGAG,0,3212461
rdlDp,0.25,3,3,AGTCCCGAGGTTCGTATGCG,0,3201481
rdlDp,0.25,3,3,AGTAGTTGGTAGCGTTACAC,0,3185708
rdlDp,0.25,3,3,AGTAGGCTAGGAGTATTGGG,0,3205773
rdlDp,0.25,3,3,AGTACATCCGAGACTAATGT,0,3205827
rdlDp,0.25,3,3,AGGTGTAGAGCCGTCTGAAC,0,3184399
rdlDp,0.25,3,3,AGGTGCCAATGCGTTAAATA,0,3174163
rdlDp,0.25,3,3,AGGTCGTCCGGACTAAATGT,0,3198987
rdlDp,0.25,3,3,AGGTATTTCGCGCTAGTCAG,0,3176108
rdlDp,0.25,3,3,AGGCTGGGATAATTCACAGG,0,3174152
rdlDp,0.25,3,3,AGGCGTCAGGCGAATTGAGT,0,3176739
rdlDp,0.25,3,3,AGGATCTTTTTTCACGTAAC,0,3183054
rdlDp,0.25,3,3,AGGAGGAATTTACTTGGAAA,0,3186141
rdlDp,0.25,3,3,AGGACTACCAGGATTAGTAC,0,3209206
rdlDp,0.25,3,3,AGCTTCACTGTTGGAAGGTA,0,3205430
rdlDp,0.25,3,3,AGCTGCTTACCCTGATGTCA,0,3188152
rdlDp,0.25,3,3,AGCTGACCACTCGACCGATC,0,3191153
rdlDp,0.25,3,3,AGCGGGTGCATAATCTTCAG,0,3206684
rdlDp,0.25,3,3,AGCGATCGTGGGGCCGCTGC,0,3194462
rdlDp,0.25,3,3,AGCAAGTGAACAGCAAAGGC,0,3196374
rdlDp,0.25,3,3,AGCAAGGCGACAAACGACTA,0,3192729
rdlDp,0.25,3,3,AGATGCCACAGGGGTATAAT,0,3169765
rdlDp,0.25,3,3,AGATATGGGGCAGTTAGGTA,0,3190869
rdlDp,0.25,3,3,AGACAGATTGGTGACTGTGA,0,3165165
rdlDp,0.25,3,3,AGAAGCGTATTTGCTAATAA,0,3185660
rdlDp,0.25,3,3,ACTTTTTCACCCGATAGTTT,0,3169524
rdlDp,0.25,3,3,ACTAAAGCTGGTGTAGGGGA,0,3190753
rdlDp,0.25,3,3,ACGTACGGTAGCCGGATTCT,0,3176342
rdlDp,0.25,3,3,ACGGTGCATACTAGACAATA,0,3211218
rdlDp,0.25,3,3,ACGGGGCTCCCCAAGCCTGA,0,3168569
rdlDp,0.25,3,3,ACGGAACCTATCGATGGGGC,0,3176244
rdlDp,0.25,3,3,ACCTGACAAGTTGGTCGGAA,0,3168418
rdlDp,0.25,3,3,ACCGTAATAAATACACGAAA,0,3189491
rdlDp,0.25,3,3,ACCGCGTGCTAAAGGTCCCA,0,3195695
rdlDp,0.25,3,3,ACATGATAAGGAGGGTTATT,0,3183402
rdlDp,0.25,3,3,ACATATTAGATCCCGAGCGG,0,3166810
rdlDp,0.25,3,3,ACATACTAGGTACACCTGCA,0,3167165
rdlDp,0.25,3,3,ACACTTTTATTAATCGACTG,0,3173185
rdlDp,0.25,3,3,ACACTTCAATGCCACTCAAA,0,3168167
rdlDp,0.25,3,3,ACACTCTATCGTAGAAACTA,0,3204879
rdlDp,0.25,3,3,ACAAGCATGCCAGTTTACTT,0,3166956
rdlDp,0.25,3,3,AATTTTTTGGAACTGCCACA,0,3187391
rdlDp,0.25,3,3,AATTGTCCCAGCGAGGTCCT,0,3197613
rdlDp,0.25,3,3,AATGATGAATACGTCTACCC,0,3179395
rdlDp,0.25,3,3,AATCTCACTTCCAACCGAGG,0,3172246
rdlDp,0.25,3,3,AATCGTGAATTCCGCGATGT,0,3166140
rdlDp,0.25,3,3,AAGTTTGAACAGATTAATAT,0,3185047
rdlDp,0.25,3,3,AAGTTCCAGTACAGGCTGTT,0,3197778
rdlDp,0.25,3,3,AAGTCTGGGAAGCGAGCTGA,0,3187824
rdlDp,0.25,3,3,AAGTATCTAAAGTAACTCCA,0,3171139
rdlDp,0.25,3,3,AAGGTCCATACTGCCGCATG,0,3208262
rdlDp,0.25,3,3,AAGCCATCAGAGTTGACTGT,0,3214010
rdlDp,0.25,3,3,AAGAATCATGTGATGCCGTT,0,3189603
rdlDp,0.25,3,3,AACGCCGCGCTAGTGCGGCG,0,3184661
rdlDp,0.25,3,3,AAAGAATTAAGCGTCTTAGG,0,3192851
rdlDp,0.25,3,3,AAAGAATGCGCCTCGAGATA,0,3207275
rdlDp,0.25,3,3,AAACGAGCCGAGCGATGGAA,0,3214569
rdlDp,0.3333333333333333,2,2,TTTTGTCGAGAGTTTAATGG,0,3187857
rdlDp,0.3333333333333333,2,2,TTTTGGCGGGTCAGTTGGTG,0,3211204
rdlDp,0.3333333333333333,2,2,TTTTGATAACCCAACCTACC,0,3178030
rdlDp,0.3333333333333333,2,2,TTTTCGTTCCGGTTACGGCG,0,3211068
rdlDp,0.3333333333333333,2,2,TTTGTTTAAAGGATACTCGT,0,3203790
rdlDp,0.3333333333333333,2,2,TTTGCCCCAATCCTTGCACA,0,3188510
rdlDp,0.3333333333333333,2,2,TTTCGAAGCGTGATCGCGCA,0,3209803
rdlDp,0.3333333333333333,2,2,TTTAGGCTGGGCGGTTTGTC,0,3171396
rdlDp,0.3333333333333333,2,2,TTTACTCCCGCAAGCTGATA,0,3181973
rdlDp,0.3333333333333333,2,2,TTGGTTCCTGCTCCAAGTCG,0,3196933
rdlDp,0.3333333333333333,2,2,TTGGTGCACCCTACATAGCC,0,3188151
rdlDp,0.3333333333333333,2,2,TTGGCTTGCGCATTGGAACG,0,3169523
rdlDp,0.3333333333333333,2,2,TTCTGAAATTATACCCTTTG,0,3199510
rdlDp,0.3333333333333333,2,2,TTCTAAGTAATGGGGTTTCA,0,3207592
rdlDp,0.3333333333333333,2,2,TTCGGAGTAATCTCTAGCCC,0,3166774
rdlDp,0.3333333333333333,2,2,TTCGATAGTAGAAATCAGAG,0,3205944
rdlDp,0.3333333333333333,2,2,TTATTAACCGTGAGCGTCTT,0,3190075
rdlDp,0.3333333333333333,2,2,TTATGGGCGATAATAGTGTC,0,3200191
rdlDp,0.3333333333333333,2,2,TTAGTAATGACTTGGATAAC,0,3213812
rdlDp,0.3333333333333333,2,2,TTACGCGCCTCAGCCCCCCT,0,3180415
rdlDp,0.3333333333333333,2,2,TTACGACGCATTCGAAGTGA,0,3197814
rdlDp,0.3333333333333333,2,2,TTAACGCGGGACCACCAGAC,0,3179653
rdlDp,0.3333333333333333,2,2,TGTTTAGGAGGCAACGATGC,0,3200260
rdlDp,0.3333333333333333,2,2,TGTCCTCTCTATCTCCCGGA,0,3166270
rdlDp,0.3333333333333333,2,2,TGTAATATATAAGTCAAGCC,0,3167406
rdlDp,0.3333333333333333,2,2,TGGTGCCCGCAGCTGTAGAA,0,3192525
rdlDp,0.3333333333333333,2,2,TGGTCCACACCGGAGACCAT,0,3199090
rdlDp,0.3333333333333333,2,2,TGGGAAGCGGCTCGCCATCA,0,3176736
rdlDp,0.3333333333333333,2,2,TGGATTCTTAGGTTATGGGA,0,3167396
rdlDp,0.3333333333333333,2,2,TGGAACGCATGGGTGTTAAC,0,3191752
rdlDp,0.3333333333333333,2,2,TGGAACACGGGGCAGGTGCT,0,3190866
rdlDp,0.3333333333333333,2,2,TGCTGTACTCTGTCTTCTCC,0,3176236
rdlDp,0.3333333333333333,2,2,TGCTCCGGAGACGTTATTCT,0,3174891
rdlDp,0.3333333333333333,2,2,TGCCGGGCATGGCATCTGCT,0,3214551
rdlDp,0.3333333333333333,2,2,TGCCCTAAAGGCCTCGCGGT,0,3169607
rdlDp,0.3333333333333333,2,2,TGCCCAAGCGGTTGCCGTGG,0,3205950
rdlDp,0.3333333333333333,2,2,TGATTTTCGTACTGGTGTCA,0,3170029
rdlDp,0.3333333333333333,2,2,TGATGCCAGACTAAGGCGTT,0,3165285
rdlDp,0.3333333333333333,2,2,TGATCCTTTGTCATACGAGA,0,3202271
rdlDp,0.3333333333333333,2,2,TGATAGAGGTAGCGTGCATG,0,3173294
rdlDp,0.3333333333333333,2,2,TGATACCCTATCGGCCCACG,0,3202267
rdlDp,0.3333333333333333,2,2,TGAGGCTGCGTGAGATTTAG,0,3181980
rdlDp,0.3333333333333333,2,2,TGACGTGGGACTTCTATGAG,0,3173255
rdlDp,0.3333333333333333,2,2,TGACGTACATGTTATGGGAT,0,3184616
rdlDp,0.3333333333333333,2,2,TGACGATCACTGTCCAATTG,0,3187682
rdlDp,0.3333333333333333,2,2,TGAACTAATATCGAAATAAG,0,3175910
rdlDp,0.3333333333333333,2,2,TGAACCCACCTTTGGAGGAG,0,3204359
rdlDp,0.3333333333333333,2,2,TCTTCGTAATTAGTCAAGAG,0,3195464
rdlDp,0.3333333333333333,2,2,TCTTACGAAACATTTAGTTT,0,3164219
rdlDp,0.3333333333333333,2,2,TCTGGTGGGTTGAAGTGTCT,0,3171398
rdlDp,0.3333333333333333,2,2,TCTGCCGCCAGGTACAGCGC,0,3168815
rdlDp,0.3333333333333333,2,2,TCTAAAGCTATAACAGATTT,0,3215798
rdlDp,0.3333333333333333,2,2,TCGGTACTAGGATTTGCATA,0,3173804
rdlDp,0.3333333333333333,2,2,TCGGTACGGGTTCTACAAAC,0,3173988
rdlDp,0.3333333333333333,2,2,TCGGGGTATACGTTCTTTGA,0,3184638
rdlDp,0.3333333333333333,2,2,TCGATCCACGGGGAATATCG,0,3173942
rdlDp,0.3333333333333333,2,2,TCGAATGTGGACCCCATGTA,0,3182468
rdlDp,0.3333333333333333,2,2,TCCTGGAGGACTGGTCACGG,0,3210862
rdlDp,0.3333333333333333,2,2,TCCTGCATAGTAGGGACAGC,0,3182631
rdlDp,0.3333333333333333,2,2,TCCGCGTACTCCAGTCCTGA,0,3193014
rdlDp,0.3333333333333333,2,2,TCCGCATTTGTAACAGGCAA,0,3195261
rdlDp,0.3333333333333333,2,2,TCCCGGGCGTTCTCTCCCAA,0,3182292
rdlDp,0.3333333333333333,2,2,TCCCATCAAGTGGAGTTCCG,0,3175469
rdlDp,0.3333333333333333,2,2,TCCACGTGAGTTATTACGAT,0,3178921
rdlDp,0.3333333333333333,2,2,TCAGTCAAGCGCCCTGGTCC,0,3193386
rdlDp,0.3333333333333333,2,2,TCACTGCTACTCGGACATAG,0,3215556
rdlDp,0.3333333333333333,2,2,TCACAAGATTCTTTTGCTCT,0,3192128
rdlDp,0.3333333333333333,2,2,TCAAAAGACTACAGTCTGGG,0,3202684
rdlDp,0.3333333333333333,2,2,TATGTAAGCACGGAAAATGT,0,3166121
rdlDp,0.3333333333333333,2,2,TATGAGTCAGCGTCGGTAGA,0,3199456
rdlDp,0.3333333333333333,2,2,TATCTCCTACGCACGGGCAA,0,3177535
rdlDp,0.3333333333333333,2,2,TATCCTTGCCCGACCATTCC,0,3198467
rdlDp,0.3333333333333333,2,2,TATCCGGATTTACCGGTCCC,0,3199852
rdlDp,0.3333333333333333,2,2,TATAGTTAAGTTGCCACATA,0,3208803
rdlDp,0.3333333333333333,2,2,TAGCCCCCGCGGATAATGCA,0,3198953
rdlDp,0.3333333333333333,2,2,TACTCAAACTGTCTAGAAAC,0,3170442
rdlDp,0.3333333333333333,2,2,TACGTAACTTATGTTCCCTA,0,3165547
rdlDp,0.3333333333333333,2,2,TACCTTAGATTTGTCATTCA,0,3184947
rdlDp,0.3333333333333333,2,2,TACCTCGAATCCAGCGTAGA,0,3207896
rdlDp,0.3333333333333333,2,2,TACAGGGCTCATTCGCAAAA,0,3212133
rdlDp,0.3333333333333333,2,2,TAATTCCCGGGAGCAGCTAC,0,3173868
rdlDp,0.3333333333333333,2,2,TAACTTTGGTTCTCTCCCCC,0,3205572
rdlDp,0.3333333333333333,2,2,TAAATGAATTGATCACATTA,0,3201767
rdlDp,0.3333333333333333,2,2,GTTCAGAGGTGAGTGTACAT,0,3169415
rdlDp,0.3333333333333333,2,2,GTTCAATCCTGGGAACCGGC,0,3172419
rdlDp,0.3333333333333333,2,2,GTTAGAGCCTCGAGATGTCA,0,3174180
rdlDp,0.3333333333333333,2,2,GTGTCACCCGAGAGATTTAC,0,3169990
rdlDp,0.3333333333333333,2,2,GTGGAACCAGTTTGGAAAAC,0,3201935
rdlDp,0.3333333333333333,2,2,GTGCTAGTGTGAATGACTAG,0,3200794
rdlDp,0.3333333333333333,2,2,GTGCCGCCGTGTTTGTAAGG,0,3200771
rdlDp,0.3333333333333333,2,2,GTGCCAGGTGGTTCCCTTTT,0,3188789
rdlDp,0.3333333333333333,2,2,GTGATGTGGTCGAAATCGGG,0,3188326
rdlDp,0.3333333333333333,2,2,GTCTCGATGGATGGGTTAAT,0,3187853
rdlDp,0.3333333333333333,2,2,GTCGAAAGCACCGGGGGCGG,0,3184885
rdlDp,0.3333333333333333,2,2,GTCCTTAGGCTAACACAGGG,0,3205894
rdlDp,0.3333333333333333,2,2,GTCCGGAATGTAGGGGTAAA,0,3212281
rdlDp,0.3333333333333333,2,2,GTCAAGATACAGCTTAGGAA,0,3179073
rdlDp,0.3333333333333333,2,2,GTATTAATGCATGCGCCGCC,0,3184450
rdlDp,0.3333333333333333,2,2,GTACCTCACTTCAATCATGG,0,3167388
rdlDp,0.3333333333333333,2,2,GTACATCGTGAAGTGTTAAT,0,3166341
rdlDp,0.3333333333333333,2,2,GTACATCACATACGCCCCGA,0,3202388
rdlDp,0.3333333333333333,2,2,GGTTTCCAATCCTGTTCAGG,0,3196950
rdlDp,0.3333333333333333,2,2,GGTTTACTAACCACCTGGCT,0,3168096
rdlDp,0.3333333333333333,2,2,GGTTGCTGGCTTTAGTGCGG,0,3172714
rdlDp,0.3333333333333333,2,2,GGTGAGTATGTCAATGATAC,0,3171836
rdlDp,0.3333333333333333,2,2,GGTCATCAATATGCGGTAAG,0,3181693
rdlDp,0.3333333333333333,2,2,GGGTTGAGCAAGATAAGTGT,0,3187187
rdlDp,0.3333333333333333,2,2,GGGTATGCGGCACCCGTCAC,0,3215872
rdlDp,0.3333333333333333,2,2,GGGGTACATAAGTTCAATCA,0,3214549
rdlDp,0.3333333333333333,2,2,GGGGAATCGGAAAACCCCGG,0,3205969
rdlDp,0.3333333333333333,2,2,GGGCCGTCGCAAACGATAAC,0,3194743
rdlDp,0.3333333333333333,2,2,GGGCAGCCAGTGAAACAAGA,0,3180757
rdlDp,0.3333333333333333,2,2,GGCTCGCCGACGTCTACACG,0,3181587
rdlDp,0.3333333333333333,2,2,GGCGTGTTTGCATGCACCTG,0,3166997
rdlDp,0.3333333333333333,2,2,GGCGTGGGGTGGTTCGGTTC,0,3213719
rdlDp,0.3333333333333333,2,2,GGCCTAATCAGGGGAGTATT,0,3193824
rdlDp,0.3333333333333333,2,2,GGCAGTTGTATCACCGCTCG,0,3210470
rdlDp,0.3333333333333333,2,2,GGATTAGCTGCCCATACAGG,0,3211240
rdlDp,0.3333333333333333,2,2,GGATGGCCATTGGGTGTGTC,0,3180308
rdlDp,0.3333333333333333,2,2,GGATGCTTTATAGCGAGATG,0,3165910
rdlDp,0.3333333333333333,2,2,GGAGGCGTCGTGTATATCGA,0,3185513
rdlDp,0.3333333333333333,2,2,GGAGCGTCAATGGGGCACTA,0,3201170
rdlDp,0.3333333333333333,2,2,GGACGGTTTGTCGATTTGGC,0,3171231
rdlDp,0.3333333333333333,2,2,GCTTTGGACAACGCTTGTGC,0,3169983
rdlDp,0.3333333333333333,2,2,GCTTTCCCGATCGGACACTA,0,3214555
rdlDp,0.3333333333333333,2,2,GCTTAGATGTAGTAATGAAG,0,3179159
rdlDp,0.3333333333333333,2,2,GCTTAATTCGGGCGGTTCTG,0,3213283
rdlDp,0.3333333333333333,2,2,GCTGCGCGCCTCCTAGCAAG,0,3208978
rdlDp,0.3333333333333333,2,2,GCGTCTGGTGTTACCACTCA,0,3166732
rdlDp,0.3333333333333333,2,2,GCGGAGCACCGTTATTTGCC,0,3175336
rdlDp,0.3333333333333333,2,2,GCGCTTGTATCGTCTGTGCT,0,3192435
rdlDp,0.3333333333333333,2,2,GCGATTGTATGAGTATCCCA,0,3175545
rdlDp,0.3333333333333333,2,2,GCGAGCCGACATCACGTAAT,0,3172139
rdlDp,0.3333333333333333,2,2,GCGAATACTCCCCTCAGAGT,0,3178729
rdlDp,0.3333333333333333,2,2,GCCCCGGAAATACGAGGTGA,0,3176672
rdlDp,0.3333333333333333,2,2,GCCAGTTGCATGTCGGGCTT,0,3169969
rdlDp,0.3333333333333333,2,2,GCCACCGAGGCGCCCGCCCA,0,3211713
rdlDp,0.3333333333333333,2,2,GCATGTACTTAGTATCTTCT,0,3206949
rdlDp,0.3333333333333333,2,2,GCATCTCAATTTAGGGTCGG,0,3189306
rdlDp,0.3333333333333333,2,2,GCATAGGTTGATCGCCAGTG,0,3168919
rdlDp,0.3333333333333333,2,2,GCAGCAAGATCGCGCTAGCT,0,3176608
rdlDp,0.3333333333333333,2,2,GCACTGGGATTTTGAACCTT,0,3193613
rdlDp,0.3333333333333333,2,2,GCACGGCGTCTGGTGCCAAG,0,3203205
rdlDp,0.3333333333333333,2,2,GCACAAACGGCGAACTGGGC,0,3206125
rdlDp,0.3333333333333333,2,2,GCAATGCGAGATCTCACCAC,0,3213197
rdlDp,0.3333333333333333,2,2,GCAAGCGTATTCGGAACACA,0,3169427
rdlDp,0.3333333333333333,2,2,GATCGCGGTGGCGATCAAAC,0,3200649
rdlDp,0.3333333333333333,2,2,GATCAGGGCTGGCGAATCCT,0,3200785
rdlDp,0.3333333333333333,2,2,GAGGCTTCGGTCCGACTAGG,0,3167001
rdlDp,0.3333333333333333,2,2,GACTGATCAAAGCTAAGTTT,0,3171635
rdlDp,0.3333333333333333,2,2,GACGGGGTGCATGGAGACCT,0,3201672
rdlDp,0.3333333333333333,2,2,GACGAAGTCCAGCAAGTGAA,0,3208164
rdlDp,0.3333333333333333,2,2,GACCGCTTTCACGCGCAATA,0,3173945
rdlDp,0.3333333333333333,2,2,GACCCGTACAATCTAAAGAG,0,3180430
rdlDp,0.3333333333333333,2,2,GACATTGTCGCCATCCGCAT,0,3176367
rdlDp,0.3333333333333333,2,2,GAATGTCAAATCTTATTCTG,0,3176252
rdlDp,0.3333333333333333,2,2,GAAGGGAGACGCATGTGCGG,0,3187675
rdlDp,0.3333333333333333,2,2,GAACTAGGCCTGATTCCAAA,0,3170845
rdlDp,0.3333333333333333,2,2,CTTTATAGGCGGATTCCCTC,0,3180004
rdlDp,0.3333333333333333,2,2,CTTGGGCCGGGCTATCTTCG,0,3171849
rdlDp,0.3333333333333333,2,2,CTTGCGCATACTGCACTAAC,0,3194864
rdlDp,0.3333333333333333,2,2,CTTGAGCAGCACTGGTCTTC,0,3208226
rdlDp,0.3333333333333333,2,2,CTTCGTTGGGGCTAGAGTGC,0,3191704
rdlDp,0.3333333333333333,2,2,CTTATTAATTTCTACAATTT,0,3213293
rdlDp,0.3333333333333333,2,2,CTGGCTATCCTACAGTCTCG,0,3174167
rdlDp,0.3333333333333333,2,2,CTGGCTAGTGAGTTTAAATT,0,3185609
rdlDp,0.3333333333333333,2,2,CTGGCGGGAAGATGCCTTTA,0,3174917
rdlDp,0.3333333333333333,2,2,CTGCCCGCTTGCTCGATTGA,0,3210923
rdlDp,0.3333333333333333,2,2,CTGATTGTGGACACTCCTTA,0,3205415
rdlDp,0.3333333333333333,2,2,CTGAGTGCTCATAGCCCGCG,0,3173176
rdlDp,0.3333333333333333,2,2,CTCCTCTACGAGGAGGGCCC,0,3195458
rdlDp,0.3333333333333333,2,2,CTATGTACATTGGGCCATCT,0,3172859
rdlDp,0.3333333333333333,2,2,CTATCTTCCTTACTTTTTTC,0,3189683
rdlDp,0.3333333333333333,2,2,CTATCTAATCACTGCCGTAC,0,3187826
rdlDp,0.3333333333333333,2,2,CTAGGTTCGGCGCGCCCAAA,0,3189777
rdlDp,0.3333333333333333,2,2,CGTTAATTCATTACGCGCGG,0,3165956
rdlDp,0.3333333333333333,2,2,CGTGCATACACTTAGAACTA,0,3190595
rdlDp,0.3333333333333333,2,2,CGTCTTCGTCAAGCCACGTA,0,3207920
rdlDp,0.3333333333333333,2,2,CGTAGAGTCCCTCTTGTGCA,0,3192415
rdlDp,0.3333333333333333,2,2,CGTACGTCACGCGCTCTTGG,0,3205440
rdlDp,0.3333333333333333,2,2,CGGGGTTCTATCCCGCTCAG,0,3200153
rdlDp,0.3333333333333333,2,2,CGGGGGCGGTCAGTTGCCAT,0,3202837
rdlDp,0.3333333333333333,2,2,CGGCGGCTGACGTCGCTTCG,0,3166974
rdlDp,0.3333333333333333,2,2,CGGAGTATCGCGGCAACGGA,0,3205842
rdlDp,0.3333333333333333,2,2,CGCCTGCGATAAGAAACCAA,0,3202749
rdlDp,0.3333333333333333,2,2,CGCCGGTTTCTTAGTACTAG,0,3178547
rdlDp,0.3333333333333333,2,2,CGCATCACATGCCGTTCATT,0,3168849
rdlDp,0.3333333333333333,2,2,CGCAAAGACTTTTAAACCAC,0,3190740
rdlDp,0.3333333333333333,2,2,CGAGGGATGCAATTTAGAGT,0,3189697
rdlDp,0.3333333333333333,2,2,CGACTAACTGTCCCAAGACA,0,3184850
rdlDp,0.3333333333333333,2,2,CGACCGGAAGATGTACTGGA,0,3171211
rdlDp,0.3333333333333333,2,2,CGACAGGGGGTCTTAGTCAA,0,3198905
rdlDp,0.3333333333333333,2,2,CGAATTAACGACTGAATCTT,0,3179136
rdlDp,0.3333333333333333,2,2,CGAAAACTATCCTACTGCAT,0,3209004
rdlDp,0.3333333333333333,2,2,CCTGTCCGTGACTCTAAGCA,0,3211825
rdlDp,0.3333333333333333,2,2,CCTGACGCTACAGTCTGCTG,0,3212024
rdlDp,0.3333333333333333,2,2,CCTCTCAGACTACACTTGAC,0,3173589
rdlDp,0.3333333333333333,2,2,CCTCCATTTATGCTTACCGG,0,3198271
rdlDp,0.3333333333333333,2,2,CCGTTCCAAATACGAGTGCG,0,3181210
rdlDp,0.3333333333333333,2,2,CCGTGGTTAGTCTCCGATTT,0,3190581
rdlDp,0.3333333333333333,2,2,CCGTCGAGGGGTTTCCAGGA,0,3205767
rdlDp,0.3333333333333333,2,2,CCGGCGGGATAATTATGATA,0,3168473
rdlDp,0.3333333333333333,2,2,CCGGAGCACAATATGTTGTT,0,3165672
rdlDp,0.3333333333333333,2,2,CCGCGCCGGCCAGTGTTTTG,0,3166744
rdlDp,0.3333333333333333,2,2,CCGAAGTTATCTCTGTTAGG,0,3170441
rdlDp,0.3333333333333333,2,2,CCCGCGCTATGGCCTCTATC,0,3208904
rdlDp,0.3333333333333333,2,2,CCCCGGCACGGTTACGCGAT,0,3177737
rdlDp,0.3333333333333333,2,2,CCCCCTCGATAAAATAGCTA,0,3188600
rdlDp,0.3333333333333333,2,2,CCCATAGGAGAGGCCTCTAC,0,3210946
rdlDp,0.3333333333333333,2,2,CCAGAGTGGCAACGGCCGAC,0,3167305
rdlDp,0.3333333333333333,2,2,CCACGGTCTGTACCTGCTTT,0,3168482
rdlDp,0.3333333333333333,2,2,CCAAATGGGGGAGGCTTTGC,0,3190888
rdlDp,0.3333333333333333,2,2,CATTTCTGTGCGGAGGAGTA,0,3175954
rdlDp,0.3333333333333333,2,2,CATTGGGGGTGACGTTGAGT,0,3211213
rdlDp,0.3333333333333333,2,2,CATATTTTGCGTTCGCGACG,0,3174404
rdlDp,0.3333333333333333,2,2,CATAAGGATGAATCGCTTTG,0,3164221
rdlDp,0.3333333333333333,2,2,CAGTTACCCGATACGACCAG,0,3211800
rdlDp,0.3333333333333333,2,2,CAGTGTCCAAACATTTTACC,0,3185120
rdlDp,0.3333333333333333,2,2,CAGCGTGCAGCGCCCGCCAA,0,3192976
rdlDp,0.3333333333333333,2,2,CAGCGGAGTTGTCTTATGAG,0,3201945
rdlDp,0.3333333333333333,2,2,CAGCGAGGTTCAACCTTAAC,0,3211697
rdlDp,0.3333333333333333,2,2,CAGATGATACCGGAATTCTA,0,3164459
rdlDp,0.3333333333333333,2,2,CACGGCTTTCATCGTCATGG,0,3194935
rdlDp,0.3333333333333333,2,2,CACGCCAATTTTCTTGATTT,0,3168806
rdlDp,0.3333333333333333,2,2,CACAATAACCGGAAGTAGTC,0,3204664
rdlDp,0.3333333333333333,2,2,CAATACATACGCCGTAAACC,0,3190856
rdlDp,0.3333333333333333,2,2,CAACTTGGAGGGATGAACTT,0,3182440
rdlDp,0.3333333333333333,2,2,ATTTCACTTCAGCTAATAAC,0,3196941
rdlDp,0.3333333333333333,2,2,ATTCTTGCCGTACTCCCGAA,0,3165224
rdlDp,0.3333333333333333,2,2,ATTATTGAAGAGTCATTTAA,0,3196797
rdlDp,0.3333333333333333,2,2,ATTACGCCCGGCAATCCAGT,0,3208341
rdlDp,0.3333333333333333,2,2,ATGTTGTACACTCTCCCAGC,0,3206796
rdlDp,0.3333333333333333,2,2,ATGGCGGTCACGCCGAGCTA,0,3175570
rdlDp,0.3333333333333333,2,2,ATGGAACTTGGGCGTTCAAT,0,3181555
rdlDp,0.3333333333333333,2,2,ATGCTTATGTGATCCGGCGT,0,3203094
rdlDp,0.3333333333333333,2,2,ATGCGTAATCGGTTTCGACG,0,3188957
rdlDp,0.3333333333333333,2,2,ATGCCAGAATCTATCATCTG,0,3209309
rdlDp,0.3333333333333333,2,2,ATGAGTTCGAATGCACCCTG,0,3204585
rdlDp,0.3333333333333333,2,2,ATGAGCTTTTACCACGGTTC,0,3167740
rdlDp,0.3333333333333333,2,2,ATGAGCGCAAGGCCTTGACA,0,3179690
rdlDp,0.3333333333333333,2,2,ATGAATACGCGTTAACATTA,0,3197550
rdlDp,0.3333333333333333,2,2,ATCGGAGTCTCTACAGGGAT,0,3196385
rdlDp,0.3333333333333333,2,2,ATCCAAAACGTAAGGTTGTG,0,3198190
rdlDp,0.3333333333333333,2,2,ATCAATCATATGCGGTGACG,0,3184377
rdlDp,0.3333333333333333,2,2,ATATTCCTACCAACGCACTT,0,3182661
rdlDp,0.3333333333333333,2,2,ATAGGACGCAGCACTCATAT,0,3187952
rdlDp,0.3333333333333333,2,2,ATACTAGGACTTGAAAGCCA,0,3208680
rdlDp,0.3333333333333333,2,2,ATAATTCGCAATGCAGTCAG,0,3207641
rdlDp,0.3333333333333333,2,2,ATAACTGGTACTAGGCTCTG,0,3178920
rdlDp,0.3333333333333333,2,2,ATAAAAGCGGGAACTTTCTG,0,3172862
rdlDp,0.3333333333333333,2,2,AGTTTATTTAACGGTATCGG,0,3168447
rdlDp,0.3333333333333333,2,2,AGTGAACCTCTTAGGTTCCT,0,3165082
rdlDp,0.3333333333333333,2,2,AGTCAAACTGGCACGTGAAG,0,3165935
rdlDp,0.3333333333333333,2,2,AGTATCTACCAGATTGCTAG,0,3196928
rdlDp,0.3333333333333333,2,2,AGTAGACATGAACTTCTTCA,0,3179549
rdlDp,0.3333333333333333,2,2,AGTAATGCAGTGCTTTCTAT,0,3188378
rdlDp,0.3333333333333333,2,2,AGGTGGCTCCGAGAATTAGC,0,3208520
rdlDp,0.3333333333333333,2,2,AGGGGGATTTGAATTGTCGT,0,3194942
rdlDp,0.3333333333333333,2,2,AGGCTGCGTAGTCACTATAA,0,3168564
rdlDp,0.3333333333333333,2,2,AGGCCTAGAACTGATCAGAT,0,3203616
rdlDp,0.3333333333333333,2,2,AGGCATTGTCTCGCCCCGGG,0,3187626
rdlDp,0.3333333333333333,2,2,AGGATAGCGTTATAGGACAG,0,3183174
rdlDp,0.3333333333333333,2,2,AGCGTGGTTAGCAGTGGCCC,0,3172882
rdlDp,0.3333333333333333,2,2,AGCAGTCTACACGAGCGGCA,0,3185077
rdlDp,0.3333333333333333,2,2,AGATGGGCTTACAGCATGCA,0,3191215
rdlDp,0.3333333333333333,2,2,AGATCATAAGGGCAGGGACG,0,3171034
rdlDp,0.3333333333333333,2,2,AGAGTCTATGTGTTAAGGAA,0,3182472
rdlDp,0.3333333333333333,2,2,AGAGGGGGGGGTCCAATGGT,0,3175286
rdlDp,0.3333333333333333,2,2,AGAGATAATACGCCTGCTGC,0,3186192
rdlDp,0.3333333333333333,2,2,AGACTGACGGCATGGTGTGC,0,3165192
rdlDp,0.3333333333333333,2,2,AGAATAGCAAGCAACCACAG,0,3190386
rdlDp,0.3333333333333333,2,2,AGAAGGCTCATAGATTCACG,0,3165914
rdlDp,0.3333333333333333,2,2,AGAAATGCTCTGCCTTATTA,0,3170823
rdlDp,0.3333333333333333,2,2,AGAAACTGACCCTGCCGCGC,0,3175568
rdlDp,0.3333333333333333,2,2,ACTTAGTTGCATCGTGTAAC,0,3205345
rdlDp,0.3333333333333333,2,2,ACTGTACCGCCAGGAGTACC,0,3207734
rdlDp,0.3333333333333333,2,2,ACTCTCGCGTCCGGATCTAT,0,3181029
rdlDp,0.3333333333333333,2,2,ACTCATGTGACACAACGAAG,0,3190757
rdlDp,0.3333333333333333,2,2,ACTACTACAGGCTACCATGG,0,3203331
rdlDp,0.3333333333333333,2,2,ACTACCATAGAGAAATGTGC,0,3176878
rdlDp,0.3333333333333333,2,2,ACGGGGCCGCAGAAACCCGG,0,3198807
rdlDp,0.3333333333333333,2,2,ACGCCACGTTTTGTAGTCTC,0,3198661
rdlDp,0.3333333333333333,2,2,ACGAATCATGGGGTCACGTG,0,3179778
rdlDp,0.3333333333333333,2,2,ACCTGGGGTGATTCACTGTT,0,3206769
rdlDp,0.3333333333333333,2,2,ACCGTCATAGTATTCTGGTC,0,3205411
rdlDp,0.3333333333333333,2,2,ACCCAGGTCGTTTTTTTCTA,0,3168823
rdlDp,0.3333333333333333,2,2,ACACTCGTGGCACGTTGCGA,0,3176045
rdlDp,0.3333333333333333,2,2,ACACATAGTTAAACCAGGGT,0,3185418
rdlDp,0.3333333333333333,2,2,ACAATGATTTCCCTCTCTGT,0,3208189
rdlDp,0.3333333333333333,2,2,ACAAATAGTCCACTGACCAT,0,3174918
rdlDp,0.3333333333333333,2,2,AATGTCTGCGAAGGAATGCT,0,3199338
rdlDp,0.3333333333333333,2,2,AATCTGGATGCAGGACCCGG,0,3209693
rdlDp,0.3333333333333333,2,2,AATCGTTTTAGAAAGATTCC,0,3199327
rdlDp,0.3333333333333333,2,2,AATAGGATGCACATTACTCA,0,3171510
rdlDp,0.3333333333333333,2,2,AATAAGCAAGTGAATTACTA,0,3195158
rdlDp,0.3333333333333333,2,2,AAGTTTGGTAAGAGATGGTC,0,3193833
rdlDp,0.3333333333333333,2,2,AAGGACTCTCGGTCGCTTCT,0,3171848
rdlDp,0.3333333333333333,2,2,AAGAGTGCCCCGGCTTTAAG,0,3187596
rdlDp,0.3333333333333333,2,2,AACGTGGTATCAAACCGGTA,0,3208946
rdlDp,0.3333333333333333,2,2,AACGTCACTACATTTCTGAA,0,3179305
rdlDp,0.3333333333333333,2,2,AACGCTGATGGCACCAGTAT,0,3201787
rdlDp,0.3333333333333333,2,2,AACGAACTCATCTCTATATC,0,3206565
rdlDp,0.3333333333333333,2,2,AACCTCCATTCATATTTCCG,0,3205372
rdlDp,0.3333333333333333,2,2,AACCAAGAATGGGGGTATGC,0,3182429
rdlDp,0.3333333333333333,2,2,AAAGTAAGCCTCTCTTCGTC,0,3197918
rdlDp,0.3333333333333333,2,2,AAAGGCGGAAAGGACGTTAT,0,3183862
rdlDp,0.3333333333333333,2,2,AAAGATGAGGCATCCACGGT,0,3188122
rdlDp,0.3333333333333333,2,2,AAACCTGGGCCTCCGACTGT,0,3179852
rdlDp,0.5,1,1,TTTTTAAATTTAGTGAAAGT,0,3207508
rdlDp,0.5,1,1,TTTTGGGCACGGTCAATTTA,0,3213979
rdlDp,0.5,1,1,TTTTCTGTTTGGCTGGGATG,0,3192697
rdlDp,0.5,1,1,TTTGGTATTTTAGAGGCGGT,0,3215964
rdlDp,0.5,1,1,TTTCTGTTTGACGACCTCGT,0,3198509
rdlDp,0.5,1,1,TTTCTGTGGCTCAGGTATCA,0,3176310
rdlDp,0.5,1,1,TTTCTAAGTACGCGGGTCTG,0,3193776
rdlDp,0.5,1,1,TTTCCTTCTGCAGTATGTTG,0,3170846
rdlDp,0.5,1,1,TTTCCACCTACTTATCTTCA,0,3185698
rdlDp,0.5,1,1,TTTATTTTTAAAACTAAAGG,0,3207992
rdlDp,0.5,1,1,TTTATAAGGGATTGACCGAT,0,3169446
rdlDp,0.5,1,1,TTTAGTCTCTTTGGTGTTCT,0,3203872
rdlDp,0.5,1,1,TTTAGTCTCGTCACAACTCA,0,3169099
rdlDp,0.5,1,1,TTGTTCCGCGGAGTTCCAAT,0,3176121
rdlDp,0.5,1,1,TTGTGGTTTGCAATCGATAC,0,3198029
rdlDp,0.5,1,1,TTGTGAAGGCTCCCCAGTTC,0,3175908
rdlDp,0.5,1,1,TTGCTTAGTACACAGTAGGA,0,3211927
rdlDp,0.5,1,1,TTGCTCGGGATCGAGCCATA,0,3203848
rdlDp,0.5,1,1,TTGCGGATACTAGCCGTCTG,0,3203784
rdlDp,0.5,1,1,TTGAATGGCGTCACAAAGGT,0,3165737
rdlDp,0.5,1,1,TTGAAATCGTTCATGAGTAG,0,3198325
rdlDp,0.5,1,1,TTCTGACCGGCGGCTACTCA,0,3189685
rdlDp,0.5,1,1,TTCTCATCTTGGTCATCTCG,0,3205274
rdlDp,0.5,1,1,TTCGAATATACGACTAATAT,0,3185305
rdlDp,0.5,1,1,TTCCGTACCCATCACAGATT,0,3208383
rdlDp,0.5,1,1,TTCCGGGGCCAGTCAAGGGT,0,3165022
rdlDp,0.5,1,1,TTCCGGACCATATCAAGTCT,0,3188858
rdlDp,0.5,1,1,TTCATTGTCGGCGTGTGTAT,0,3206764
rdlDp,0.5,1,1,TTCAGGGTGCAGGGTCTTAG,0,3186346
rdlDp,0.5,1,1,TTATGCTTTAGCGGAGGTCC,0,3187073
rdlDp,0.5,1,1,TTAGCATACGACGTCATATT,0,3206779
rdlDp,0.5,1,1,TTACCGAAGGATAATGAAGG,0,3201634
rdlDp,0.5,1,1,TTACAGCAAAGGTCTGGCTT,0,3190163
rdlDp,0.5,1,1,TTAATCCACACAGGGGCATA,0,3187248
rdlDp,0.5,1,1,TTAAGCTATAGGAGGGGGTG,0,3188860
rdlDp,0.5,1,1,TGTTTAGAATGTGCGTCATA,0,3202970
rdlDp,0.5,1,1,TGTTGTGCCGGCCTAGTAAG,0,3171204
rdlDp,0.5,1,1,TGTTGGCCGATAACGTGAAC,0,3206783
rdlDp,0.5,1,1,TGTCGTTACGCAGCATGGTG,0,3164245
rdlDp,0.5,1,1,TGTCAGGCGAATTTGCGGGA,0,3199450
rdlDp,0.5,1,1,TGGTATGCTCACCTACAGAT,0,3179540
rdlDp,0.5,1,1,TGGTATATTATGCTTGTCGC,0,3171617
rdlDp,0.5,1,1,TGGGTGGGAGGTAAATGTTA,0,3178099
rdlDp,0.5,1,1,TGGGCCGTCGAATCCACCGC,0,3166812
rdlDp,0.5,1,1,TGGGAATTCATTACGTTCAC,0,3180055
rdlDp,0.5,1,1,TGGCACGCTGGCGAAAACTA,0,3201797
rdlDp,0.5,1,1,TGGACGCAGATGAACAAGAC,0,3207385
rdlDp,0.5,1,1,TGCGGTTTGCTGCATACAAC,0,3211735
rdlDp,0.5,1,1,TGCGCACCGCTTAACCAGGG,0,3205974
rdlDp,0.5,1,1,TGCGAACGCAGCCATGGTGC,0,3164809
rdlDp,0.5,1,1,TGCCAATCTGTGAAGGCCTT,0,3185845
rdlDp,0.5,1,1,TGCCAAGCGGATTTTAATGG,0,3183963
rdlDp,0.5,1,1,TGCCAAATTCCCAACCCATC,0,3197874
rdlDp,0.5,1,1,TGCAGTGTAGCTTCGCATAT,0,3203603
rdlDp,0.5,1,1,TGCAGAGGGGTAGTTACAGG,0,3188832
rdlDp,0.5,1,1,TGCACGCGCTCAGTCTAATG,0,3189521
rdlDp,0.5,1,1,TGATAAGAGCCGATCAGTCA,0,3190297
rdlDp,0.5,1,1,TGATAAAGGGAGCCGCAAAT,0,3195479
rdlDp,0.5,1,1,TGAGGGCCATCGTTAGGCCC,0,3184881
rdlDp,0.5,1,1,TGAAAGAGTACCATTTAAAA,0,3180518
rdlDp,0.5,1,1,TCTGCTTTTGCCGGCACTAT,0,3165149
rdlDp,0.5,1,1,TCTGCGTCCCCCATTGCAAG,0,3199176
rdlDp,0.5,1,1,TCTCGAGCCGCTATGCTTCT,0,3190442
rdlDp,0.5,1,1,TCTATCGAGTTTAGGAGGTA,0,3164885
rdlDp,0.5,1,1,TCGTTGTGTTCTAGACGATA,0,3179537
rdlDp,0.5,1,1,TCGTGGGTAGCTGGGAATCC,0,3182125
rdlDp,0.5,1,1,TCGTAGTGCCGTACGTGGGT,0,3202122
rdlDp,0.5,1,1,TCGTAAGTCCGCCTTGGGTG,0,3164267
rdlDp,0.5,1,1,TCGGCCGCTCAGCCTACGAG,0,3194193
rdlDp,0.5,1,1,TCGCCCGTACTCCTGGACGC,0,3189931
rdlDp,0.5,1,1,TCGCACCTCCACGGGGAGAA,0,3188829
rdlDp,0.5,1,1,TCGAGTTTCTCCTCCAGGTG,0,3171073
rdlDp,0.5,1,1,TCGAAGGTAGCAGTTTTAGA,0,3179143
rdlDp,0.5,1,1,TCCTTTCACTGTGATAGTTG,0,3209039
rdlDp,0.5,1,1,TCCTGGACAATGTTGTCCTT,0,3204355
rdlDp,0.5,1,1,TCCGGCATGCTCGACATTGC,0,3210226
rdlDp,0.5,1,1,TCCAAGGATAGCGGCTCTGG,0,3208306
rdlDp,0.5,1,1,TCATCGACGTAGACCTGCAG,0,3175540
rdlDp,0.5,1,1,TCATATCATCGGACGTGGCA,0,3193109
rdlDp,0.5,1,1,TCATACGAACCAGCTTCAGC,0,3208849
rdlDp,0.5,1,1,TCAAGCCAATACAGAGACGC,0,3205278
rdlDp,0.5,1,1,TCAAAAATTTATCGGGCTTA,0,3187289
rdlDp,0.5,1,1,TATTTCAATAGGTCTTAAGT,0,3185042
rdlDp,0.5,1,1,TATTATTATTACGTACTTAG,0,3173825
rdlDp,0.5,1,1,TATGTTGGGGGACTGGGATC,0,3184821
rdlDp,0.5,1,1,TATATTGCCTCATAATGCAC,0,3164879
rdlDp,0.5,1,1,TAGTCGCGCCTTTCTGTCCA,0,3206246
rdlDp,0.5,1,1,TAGGGTGTGCACTAACCAAA,0,3166567
rdlDp,0.5,1,1,TAGGGGCTTCAGCTGCGCCA,0,3196183
rdlDp,0.5,1,1,TAGGCTCACGAGCAGGCTGA,0,3189749
rdlDp,0.5,1,1,TAGGCAAGTCTCGAAAAAGG,0,3182759
rdlDp,0.5,1,1,TAGCGACGGCTTCGATCTCC,0,3182481
rdlDp,0.5,1,1,TAGCCCAGCAGAATGTAATT,0,3195644
rdlDp,0.5,1,1,TAGCACTGTCCGCCACCCGG,0,3164393
rdlDp,0.5,1,1,TAGATTCGGCGGAATACTTC,0,3169497
rdlDp,0.5,1,1,TACTTTGAATAAGAAGTACA,0,3181804
rdlDp,0.5,1,1,TACTTATAGGCTCGATCTGG,0,3181038
rdlDp,0.5,1,1,TACTCAAACCAAGCGGACAA,0,3203300
rdlDp,0.5,1,1,TACCCGTGGGACTAATCGGT,0,3209298
rdlDp,0.5,1,1,TACCCATAGCCCATGTACTA,0,3197970
rdlDp,0.5,1,1,TACCAGCGATGCAAGTGGGA,0,3182430
rdlDp,0.5,1,1,TACAGTGAACGGATAGGGAC,0,3201846
rdlDp,0.5,1,1,TACACGGAAGCCAAACGTTA,0,3174156
rdlDp,0.5,1,1,TACAATTCATGCACGATACT,0,3212137
rdlDp,0.5,1,1,TAATTGTTTACACGAACGAG,0,3168903
rdlDp,0.5,1,1,TAATCGCACTAAGCTAGTGT,0,3165494
rdlDp,0.5,1,1,TAATCAATCATTCAGTCCGG,0,3166936
rdlDp,0.5,1,1,TAATAATATACAATATGAGT,0,3179088
rdlDp,0.5,1,1,TAACTTGGGTTTCTCTGCTA,0,3201474
rdlDp,0.5,1,1,TAACTCGATCACCTGATTAG,0,3171868
rdlDp,0.5,1,1,TAAAGTTCGACGCGTCTCCT,0,3191323
rdlDp,0.5,1,1,TAAAGTAATCCAGCATCTCG,0,3172161
rdlDp,0.5,1,1,TAAAATTTCTCTCTAAAGTA,0,3183191
rdlDp,0.5,1,1,TAAAATCAAACGGTGGTATG,0,3214685
rdlDp,0.5,1,1,GTTTTCCCTCACGTTGACGG,0,3164285
rdlDp,0.5,1,1,GTTGTGGTACAAAAGGTCAG,0,3213194
rdlDp,0.5,1,1,GTTCAACGTAAGCGAAGTAC,0,3188964
rdlDp,0.5,1,1,GTTAGTTGCTTTGGGTCCAT,0,3210892
rdlDp,0.5,1,1,GTTAACCAGTAGCAATCTGT,0,3165153
rdlDp,0.5,1,1,GTGGACTTCTTCATGGTGTA,0,3189601
rdlDp,0.5,1,1,GTGCTCCAGGAACATGCCAA,0,3170711
rdlDp,0.5,1,1,GTGATGATTTCTGACTAATG,0,3191665
rdlDp,0.5,1,1,GTGAGATGTATGTCTGGAAA,0,3179356
rdlDp,0.5,1,1,GTGAAGTGAAACGCGGGGTC,0,3213258
rdlDp,0.5,1,1,GTCTTTCAAGAATGGAACAT,0,3167989
rdlDp,0.5,1,1,GTCTGTTATTCTGGACGTGT,0,3170280
rdlDp,0.5,1,1,GTCTCATGCGCACCGCGAAG,0,3209705
rdlDp,0.5,1,1,GTCTCACTCTAGATTCGCAA,0,3194845
rdlDp,0.5,1,1,GTCCTGAAGGCTCATGAGGG,0,3209938
rdlDp,0.5,1,1,GTCCGTCTAGATTCTTGGGG,0,3204782
rdlDp,0.5,1,1,GTCAGATTAGCATATCGGGT,0,3208167
rdlDp,0.5,1,1,GTATTAAAATTCTTTAGCAA,0,3198521
rdlDp,0.5,1,1,GTAGTTTAACCGCAGTAAGT,0,3197986
rdlDp,0.5,1,1,GTAGTCTAACTCGTACGACC,0,3188783
rdlDp,0.5,1,1,GTACTGTTGCCTAAACGTAC,0,3182671
rdlDp,0.5,1,1,GTACAGCTATCTACGGGGAA,0,3165802
rdlDp,0.5,1,1,GTACACGGCAATGGCGGCTT,0,3191272
rdlDp,0.5,1,1,GGTTCTGGGCAGAGGTCATG,0,3209796
rdlDp,0.5,1,1,GGTTCACCACGGCCGTTCAT,0,3178728
rdlDp,0.5,1,1,GGTTCAAGGCCGTCATGCTC,0,3205696
rdlDp,0.5,1,1,GGTTAGTGTAAGCGGGCGCC,0,3207990
rdlDp,0.5,1,1,GGTGGTAGGGTACCTGTATT,0,3210841
rdlDp,0.5,1,1,GGTGAGTGTTAGGTCGAAGT,0,3198956
rdlDp,0.5,1,1,GGTCTTCTGGAGAAAGACGT,0,3186416
rdlDp,0.5,1,1,GGTCTCCATGGGATATGACG,0,3164931
rdlDp,0.5,1,1,GGTCGCCCAATCGAAAACCC,0,3208574
rdlDp,0.5,1,1,GGTCAAATTGTCTCACATGG,0,3170912
rdlDp,0.5,1,1,GGTATGGATAGGACTAGAGG,0,3214006
rdlDp,0.5,1,1,GGTACTTTTCGTGCCATTTG,0,3183250
rdlDp,0.5,1,1,GGGTTAGTTCACGTACCATG,0,3202380
rdlDp,0.5,1,1,GGGTGGGGACCGAGGTTCGC,0,3190854
rdlDp,0.5,1,1,GGGGGTAGGGTGCATTGAGT,0,3176690
rdlDp,0.5,1,1,GGGGATAAACGAGATCAGAC,0,3189928
rdlDp,0.5,1,1,GGGCGGTAGTAGACTATCGG,0,3209299
rdlDp,0.5,1,1,GGGCGCCCCCGTTGCTTCGG,0,3170133
rdlDp,0.5,1,1,GGGCCAGGTGGGCTTGGAAC,0,3195990
rdlDp,0.5,1,1,GGGAGTTTTTGGTTCTACGG,0,3195110
rdlDp,0.5,1,1,GGGACTACCCAGAGTGTCTA,0,3215956
rdlDp,0.5,1,1,GGCTTTACATTCAGACAGTC,0,3168932
rdlDp,0.5,1,1,GGCTTGATCATGATCTCCAT,0,3199646
rdlDp,0.5,1,1,GGCGCTGATATTGAAAGAAT,0,3191738
rdlDp,0.5,1,1,GGATCTCACGCCGCTGCCTC,0,3176399
rdlDp,0.5,1,1,GGAGGGCCCTTGTACAGGTT,0,3182122
rdlDp,0.5,1,1,GGAAGCCGCTGAATTGGAAG,0,3206794
rdlDp,0.5,1,1,GCTTCGCGGACAAGTCGTCC,0,3178038
rdlDp,0.5,1,1,GCTTACAAGCCCATGAACGC,0,3188158
rdlDp,0.5,1,1,GCTGTGCCATCAGTACCACC,0,3199846
rdlDp,0.5,1,1,GCTGGCAGCGTGTCCAGGCA,0,3190962
rdlDp,0.5,1,1,GCTGCGTGTGGCGTCTCGCT,0,3195352
rdlDp,0.5,1,1,GCTCGCATATTATTTAGTGC,0,3178058
rdlDp,0.5,1,1,GCTCAGGCCTTACAAACGCG,0,3180915
rdlDp,0.5,1,1,GCGGTTGAGTCTGACAGCCA,0,3181449
rdlDp,0.5,1,1,GCGGTTCTTACTAGGCGCTG,0,3195299
rdlDp,0.5,1,1,GCGCAAGTTAGCAAGCCTTG,0,3199630
rdlDp,0.5,1,1,GCGAACTGACTCACATTCTG,0,3179406
rdlDp,0.5,1,1,GCCTTATGACCCGGAAGAGT,0,3206750
rdlDp,0.5,1,1,GCCTGGCTTTCATGTATAAA,0,3194099
rdlDp,0.5,1,1,GCCGTACATGGCGGGGCTCT,0,3211718
rdlDp,0.5,1,1,GCCGGTACTTCTCTGGCCGA,0,3202392
rdlDp,0.5,1,1,GCCGCATTCAAAGGGATAAC,0,3170314
rdlDp,0.5,1,1,GCCCGATCGGTCAAATAAGC,0,3177079
rdlDp,0.5,1,1,GCCCAATTCTCTCACATTTC,0,3204303
rdlDp,0.5,1,1,GCCATCGTGTGTGCAGGACA,0,3213250
rdlDp,0.5,1,1,GCCAAGCAGATGCGCTTGGA,0,3192680
rdlDp,0.5,1,1,GCCAAACTTAAGACGCAACG,0,3171930
rdlDp,0.5,1,1,GCATCCGAGCGGTAAAAACG,0,3167379
rdlDp,0.5,1,1,GCATATCGGCCATAGTCAGC,0,3171488
rdlDp,0.5,1,1,GCAGGACCAGTTTAACCTAT,0,3199819
rdlDp,0.5,1,1,GCACGTAGACTTGCAGCGGG,0,3164214
rdlDp,0.5,1,1,GCACGGTCGAGTGGCGCGCT,0,3192936
rdlDp,0.5,1,1,GCAAGGAGGCACGGTAAACC,0,3192780
rdlDp,0.5,1,1,GCAACGGCATATACATCATC,0,3184957
rdlDp,0.5,1,1,GCAACCGAGTTCCATGGTGT,0,3172128
rdlDp,0.5,1,1,GATCTTATCTGGGAGGGCTG,0,3187067
rdlDp,0.5,1,1,GATCTGTCCCAGACCGGACC,0,3188840
rdlDp,0.5,1,1,GATCTGGCGCTAACGGGTAG,0,3199361
rdlDp,0.5,1,1,GATCCGCAACGAGCCCTACG,0,3177668
rdlDp,0.5,1,1,GATATTCTCGCCGGCGTATC,0,3198191
rdlDp,0.5,1,1,GAGTGCGTGCAAGACCTGAG,0,3164536
rdlDp,0.5,1,1,GAGTGACGCGGGTTGGAGCA,0,3214222
rdlDp,0.5,1,1,GAGTATGCCTGTCAAAATAT,0,3169610
rdlDp,0.5,1,1,GAGGTATGTTCCCACTACAA,0,3168165
rdlDp,0.5,1,1,GAGAGCCTGATCATTACTAT,0,3209648
rdlDp,0.5,1,1,GACTCACTTTACTGGTGCAG,0,3189515
rdlDp,0.5,1,1,GACTACATAGGGTTCTGACA,0,3191101
rdlDp,0.5,1,1,GACGCGGCCCTGGGGGCTTC,0,3170287
rdlDp,0.5,1,1,GACCGTCAATCTCAGGGCCT,0,3203533
rdlDp,0.5,1,1,GACCACGGACACTGGTCGGT,0,3176879
rdlDp,0.5,1,1,GACAGCAGACTCTATTGAGC,0,3175735
rdlDp,0.5,1,1,GACAGATGCACCATGGAACG,0,3183163
rdlDp,0.5,1,1,GACAACTCGTGAACGACATC,0,3191742
rdlDp,0.5,1,1,GAATTATGATGTCCGGCTTG,0,3164788
rdlDp,0.5,1,1,GAATTACGCAGGAGATGGGT,0,3185784
rdlDp,0.5,1,1,GAAGTGACCTCTTAAGGAAA,0,3170869
rdlDp,0.5,1,1,GAAGGCTGCAGTTGGGAACC,0,3213993
rdlDp,0.5,1,1,GAACTGTCCTACCGTCTGAA,0,3187224
rdlDp,0.5,1,1,CTTTGTTCACAACACGGGGA,0,3194051
rdlDp,0.5,1,1,CTTGTCATCGATAGGCCCAC,0,3209442
rdlDp,0.5,1,1,CTTGGGCAGTGTTAGCCTCT,0,3169449
rdlDp,0.5,1,1,CTTGGCTTCTACAGTGACAT,0,3172138
rdlDp,0.5,1,1,CTTGCCTCAACAGAAATTCA,0,3197926
rdlDp,0.5,1,1,CTTGATTTCCCGGTAAGCTG,0,3173410
rdlDp,0.5,1,1,CTTGACGCCGAGGCTGAATG,0,3166875
rdlDp,0.5,1,1,CTTCTAAAGGAATTACTCTC,0,3176340
rdlDp,0.5,1,1,CTTATTCCTGTCCCTTTTAT,0,3178737
rdlDp,0.5,1,1,CTTAGATTTGGCTCGCCACC,0,3202115
rdlDp,0.5,1,1,CTTACTGAAGAGCGCAGAGC,0,3186424
rdlDp,0.5,1,1,CTTACTAGCCTTAAACACAT,0,3197968
rdlDp,0.5,1,1,CTTACGTACAGGAAGCCTCC,0,3194490
rdlDp,0.5,1,1,CTTACAGGAACAGTATTTGG,0,3209760
rdlDp,0.5,1,1,CTGTTATCGGGCGAGCCCCA,0,3203647
rdlDp,0.5,1,1,CTGCTCGATCACTTCGTAAT,0,3171392
rdlDp,0.5,1,1,CTGCATTAGGGTCGCGCCGT,0,3207251
rdlDp,0.5,1,1,CTGATACGCGGCATACGGAC,0,3176892
rdlDp,0.5,1,1,CTGAAAACACACCTATGACA,0,3186155
rdlDp,0.5,1,1,CTCTACTGAATGGCCCCAAC,0,3187449
rdlDp,0.5,1,1,CTCGGTTACCTCAGAACCGG,0,3215954
rdlDp,0.5,1,1,CTCGCGGTTGTCAGTGCAAG,0,3209475
rdlDp,0.5,1,1,CTCCCTAGAACCATCACCGG,0,3166568
rdlDp,0.5,1,1,CTCCAGTACTCGAGCGCCAA,0,3185780
rdlDp,0.5,1,1,CTATATAGGCCCTCACATGT,0,3195652
rdlDp,0.5,1,1,CTAGGGGCAGATACTACAAA,0,3203466
rdlDp,0.5,1,1,CTACGGGCCACGCTGTCCGG,0,3173948
rdlDp,0.5,1,1,CGTTGGGTACTCCATTTTTC,0,3166836
rdlDp,0.5,1,1,CGTTCCGACGATCGGCCTTG,0,3177872
rdlDp,0.5,1,1,CGTTAATACCGATTCAACTC,0,3210564
rdlDp,0.5,1,1,CGTGTCCCATAGACAGAGCG,0,3200306
rdlDp,0.5,1,1,CGTGGTGTGTTACGTGAGAG,0,3195015
rdlDp,0.5,1,1,CGTGGCAGAGCTTAAGCCTT,0,3173898
rdlDp,0.5,1,1,CGTGACGCGTATAAGCAGAG,0,3168251
rdlDp,0.5,1,1,CGTCTGGGATCTTTACATTA,0,3166376
rdlDp,0.5,1,1,CGTCGTGGCCATCGCAGACA,0,3196855
rdlDp,0.5,1,1,CGTCAATGATACGATTAGGC,0,3170870
rdlDp,0.5,1,1,CGGTTTCCGCGCACTACTAA,0,3193840
rdlDp,0.5,1,1,CGGGGATGATTAGCCCAGGC,0,3212698
rdlDp,0.5,1,1,CGGGGAACGCGCCAACAGCA,0,3170028
rdlDp,0.5,1,1,CGGGCGCTATGAGTGGGGGT,0,3185514
rdlDp,0.5,1,1,CGGGACCCGGTAAAATGAGG,0,3172125
rdlDp,0.5,1,1,CGGCGACCTCTATATATAGC,0,3201422
rdlDp,0.5,1,1,CGGCCTTCATGGTCCTAGAC,0,3173201
rdlDp,0.5,1,1,CGGATGTCACAATTGTATTA,0,3175922
rdlDp,0.5,1,1,CGGAAGCGAGGCAAACCTCA,0,3204661
rdlDp,0.5,1,1,CGCTTCACGTCGAGAGTACT,0,3196799
rdlDp,0.5,1,1,CGCTATAGGTTAGCATACTT,0,3208740
rdlDp,0.5,1,1,CGCTAAGTTTAAAAACAATT,0,3182719
rdlDp,0.5,1,1,CGCGTTTCTGTAACGGGTAC,0,3211890
rdlDp,0.5,1,1,CGCGTTCTAAGCGGCGGTTG,0,3169558
rdlDp,0.5,1,1,CGCGACATGACAAAGGGAGG,0,3198928
rdlDp,0.5,1,1,CGCGACACGGGATGGCTTTG,0,3191144
rdlDp,0.5,1,1,CGCCGGACGGAGTTCAGGGG,0,3200061
rdlDp,0.5,1,1,CGCATTAATAAACTAATTCG,0,3199733
rdlDp,0.5,1,1,CGATCAGCCGACTCATTCCA,0,3205290
rdlDp,0.5,1,1,CGACCGGCAGCGACGCCAAA,0,3209714
rdlDp,0.5,1,1,CCTTCTACAATGCATACACC,0,3181118
rdlDp,0.5,1,1,CCTTAACCTACAAGACAATA,0,3205936
rdlDp,0.5,1,1,CCTCGGGATCGATTCACCTG,0,3168729
rdlDp,0.5,1,1,CCTCCTTCATTGCCCATTCA,0,3192204
rdlDp,0.5,1,1,CCTCCACGTCGTCATAGGTA,0,3189440
rdlDp,0.5,1,1,CCTAGATGGTGATTAAATTT,0,3189165
rdlDp,0.5,1,1,CCGTGATTTGCTTGCTACCA,0,3196614
rdlDp,0.5,1,1,CCGGTTACTTATGGCGTCTG,0,3208559
rdlDp,0.5,1,1,CCGGCTGGCCGCAAATCTGG,0,3187787
rdlDp,0.5,1,1,CCGGCTATATGTGCTTGTGC,0,3178926
rdlDp,0.5,1,1,CCGGCGGGTCGTGTGTAGTC,0,3188097
rdlDp,0.5,1,1,CCGGATAGCTCTTGTTCTGG,0,3191160
rdlDp,0.5,1,1,CCGCAACCGATCCGCGATCG,0,3181476
rdlDp,0.5,1,1,CCGCAACCCCGTCTTTCTGG,0,3210712
rdlDp,0.5,1,1,CCGACTGTTAGCGCCGCACG,0,3195553
rdlDp,0.5,1,1,CCCTGTGTTGTTTTTCTCAG,0,3205033
rdlDp,0.5,1,1,CCCTGTCCAGAAAATATTCA,0,3193644
rdlDp,0.5,1,1,CCCTGACCCGGGGAAGGTCA,0,3165495
rdlDp,0.5,1,1,CCCTATAGTGATATTGAAAG,0,3183242
rdlDp,0.5,1,1,CCCGTGACGGTGAATTGTTG,0,3174097
rdlDp,0.5,1,1,CCCGGAAAATTTTGTCCTAT,0,3193837
rdlDp,0.5,1,1,CCCGCAGAGAAGAGCAAAGG,0,3182781
rdlDp,0.5,1,1,CCCGATACCCAGCGCCCCCT,0,3186880
rdlDp,0.5,1,1,CCATTGGGTTAACAGTGGGT,0,3169013
rdlDp,0.5,1,1,CCAGGCAGTCTACTTGGCGG,0,3186676
rdlDp,0.5,1,1,CCAGCTTGACCAGTATCTCA,0,3213449
rdlDp,0.5,1,1,CCAACATTATCGTTATAGAT,0,3192690
rdlDp,0.5,1,1,CCAAACGGCAATACTTGCTT,0,3187183
rdlDp,0.5,1,1,CATTGTATTCTTCATAGCGC,0,3185056
rdlDp,0.5,1,1,CATGTCCATCGTTTATTAGA,0,3198184
rdlDp,0.5,1,1,CATGGTCTAAGAGAACTTTC,0,3201103
rdlDp,0.5,1,1,CATGCAATAATTCCGGTGCA,0,3201048
rdlDp,0.5,1,1,CATGACGGACCATGAGATCT,0,3215873
rdlDp,0.5,1,1,CATCATCAATATCATATTAC,0,3212050
rdlDp,0.5,1,1,CATACACACCCCGTCGTCGG,0,3177754
rdlDp,0.5,1,1,CATAAGGTACCGGAGTAGAA,0,3190986
rdlDp,0.5,1,1,CAGTGTAGCCTCTCCAGTAA,0,3194465
rdlDp,0.5,1,1,CAGGTTTTGCACTGTATACT,0,3184611
rdlDp,0.5,1,1,CAGGGCAAGAACCTTCCTTT,0,3208743
rdlDp,0.5,1,1,CAGGGAACATGACGCTCCCA,0,3195776
rdlDp,0.5,1,1,CAGGCACCATTTCTGTAGCA,0,3165541
rdlDp,0.5,1,1,CAGGCAATACGAGCAGTAAT,0,3206978
rdlDp,0.5,1,1,CAGGATAGGGGTAGAGCCAC,0,3165407
rdlDp,0.5,1,1,CAGGAAGGTTGGTGTCGGCT,0,3209428
rdlDp,0.5,1,1,CAGCTGGATGGGTCTAACAT,0,3214422
rdlDp,0.5,1,1,CAGCTATTCTCGACGCTGGT,0,3172036
rdlDp,0.5,1,1,CAGCGCCGCCACCGGACAAA,0,3176962
rdlDp,0.5,1,1,CACTTACAAGAATATCTGCT,0,3190624
rdlDp,0.5,1,1,CACTGTCAAACGTGGAGGAG,0,3173164
rdlDp,0.5,1,1,CACGGTGAAAAACGTACGGT,0,3198473
rdlDp,0.5,1,1,CACGAACCGGCCGTCGGACA,0,3168614
rdlDp,0.5,1,1,CACCATGAAGTGCGTATAAT,0,3180423
rdlDp,0.5,1,1,CAATGGTTCCTAGGTCCCAG,0,3203852
rdlDp,0.5,1,1,CAATGGCATCCGAACCACAT,0,3165832
rdlDp,0.5,1,1,CAATCGTTAATGGGCAACCG,0,3164054
rdlDp,0.5,1,1,CAATCGCTGTCGGCTTACGC,0,3197382
rdlDp,0.5,1,1,CAAGTACCTTGTGGCGGGCT,0,3184543
rdlDp,0.5,1,1,CAACCCTGCTTAGGCCTCCA,0,3169417
rdlDp,0.5,1,1,CAAATCGGCATCTCACCGGA,0,3184391
rdlDp,0.5,1,1,CAAAATATGTCGGGCTATGC,0,3196660
rdlDp,0.5,1,1,ATTTTTTGTTAACTACCAAC,0,3172716
rdlDp,0.5,1,1,ATTTTGGAAGGGAGTCGTGC,0,3173739
rdlDp,0.5,1,1,ATTTCCTTGAACGTACGGTG,0,3179140
rdlDp,0.5,1,1,ATTCGAGCCAAGCGGCCTCA,0,3191805
rdlDp,0.5,1,1,ATTCAGTTCCACTCCGGGGG,0,3199077
rdlDp,0.5,1,1,ATTAGGCGATAATCTCTGAT,0,3201085
rdlDp,0.5,1,1,ATGTTTGAAGGCATTCGGAG,0,3207671
rdlDp,0.5,1,1,ATGGCTCTGATATAGACCTC,0,3164310
rdlDp,0.5,1,1,ATGCCAATAAGGATAACAAG,0,3181691
rdlDp,0.5,1,1,ATGAATGGTCATGACCAAGT,0,3210872
rdlDp,0.5,1,1,ATCTCGTAACTTCAAATGTA,0,3180108
rdlDp,0.5,1,1,ATCTCCATTACGATGGGCAA,0,3180105
rdlDp,0.5,1,1,ATCTCAATCAATAGCATCGC,0,3168477
rdlDp,0.5,1,1,ATCGGTAGCTATTTCAGTAT,0,3193317
rdlDp,0.5,1,1,ATCACCTACTTCATCATTGC,0,3196379
rdlDp,0.5,1,1,ATCAAAAGATTATCTACAGG,0,3199087
rdlDp,0.5,1,1,ATATCTCATTCAATAGCACA,0,3181993
rdlDp,0.5,1,1,ATATCTAGAGTGTATACCCC,0,3215037
rdlDp,0.5,1,1,ATATATAAGCGGGCGGCATC,0,3180759
rdlDp,0.5,1,1,ATATAAAACTGTTGTCAGTC,0,3214384
rdlDp,0.5,1,1,ATAGGACTCGATCCTGAGTA,0,3171402
rdlDp,0.5,1,1,ATAGAACTGGCAGAATGCCA,0,3179522
rdlDp,0.5,1,1,ATACTCTTATGGCATCAGAC,0,3201950
rdlDp,0.5,1,1,ATACAGCTGCCGAGTGTTCC,0,3202282
rdlDp,0.5,1,1,AGTTTAGCTATCTGATCCAT,0,3194619
rdlDp,0.5,1,1,AGTCGCTGAGCGACCAAGCC,0,3198698
rdlDp,0.5,1,1,AGTCATAGGCGTCTCTAATG,0,3196432
rdlDp,0.5,1,1,AGGTTTATCGATGGGACGAC,0,3166758
rdlDp,0.5,1,1,AGGTTATTGTATCGTGGATT,0,3181969
rdlDp,0.5,1,1,AGGTCGCAGGATTCACGAAT,0,3167323
rdlDp,0.5,1,1,AGGGTGCAGACATATATATA,0,3198453
rdlDp,0.5,1,1,AGGGTGACTCCCTTTCCAAC,0,3175994
rdlDp,0.5,1,1,AGGGGTTTGCATGGGGCCGT,0,3192194
rdlDp,0.5,1,1,AGGCGGAACAGCTAGATGGC,0,3177563
rdlDp,0.5,1,1,AGGCCCTTCTAACAAGCTAT,0,3177749
rdlDp,0.5,1,1,AGGAGCACGCTATTTCTGTA,0,3204868
rdlDp,0.5,1,1,AGGAAGATGAGACCATTACT,0,3206634
rdlDp,0.5,1,1,AGCGCATAAAAACGCTAAAA,0,3209283
rdlDp,0.5,1,1,AGCCTACGCCATGCGACATA,0,3195349
rdlDp,0.5,1,1,AGCCCTGGGGACCTAGGTAG,0,3167904
rdlDp,0.5,1,1,AGCATTAACTCCACAGCATC,0,3200464
rdlDp,0.5,1,1,AGCATAAATGAACAGCCCGG,0,3174148
rdlDp,0.5,1,1,AGCAGTAGTGCCCTTCGTAA,0,3208522
rdlDp,0.5,1,1,AGCACAACAGCTCCCGTGGC,0,3172126
rdlDp,0.5,1,1,AGATTTGTGGTTGCAAATAG,0,3212010
rdlDp,0.5,1,1,AGAGCTGGTTTTGGGGAGAC,0,3189014
rdlDp,0.5,1,1,AGACCCCCTGGGCGTTCGAT,0,3201774
rdlDp,0.5,1,1,AGAATTGTTAAAGCAGCCGT,0,3179303
rdlDp,0.5,1,1,AGAATTGGAAGATGCCCGAG,0,3193972
rdlDp,0.5,1,1,AGAAGGTGTCACTTAAGCCA,0,3182166
rdlDp,0.5,1,1,ACTTGGTGCTTTATCTATAC,0,3211827
rdlDp,0.5,1,1,ACTTAGATATTGTAGCCAGT,0,3177871
rdlDp,0.5,1,1,ACTGTGTCTGTTCCCACCGT,0,3206766
rdlDp,0.5,1,1,ACTGTCATCCGACCAAGAGG,0,3202277
rdlDp,0.5,1,1,ACTGTCAGGAGAAAGGGTTG,0,3211512
rdlDp,0.5,1,1,ACTGGTTGTCGCCCCAGGGG,0,3210863
rdlDp,0.5,1,1,ACTCTAATGTCTAGTGCCCG,0,3180680
rdlDp,0.5,1,1,ACTCGTTAGCACTACCTTAT,0,3211206
rdlDp,0.5,1,1,ACTCGGCGCCTAGTTACAAA,0,3212612
rdlDp,0.5,1,1,ACTATCTCTTTATTGCGCTG,0,3213873
rdlDp,0.5,1,1,ACTAGGGAGCAGCAGGATTG,0,3171235
rdlDp,0.5,1,1,ACTAACGTGAATTTCCCAGG,0,3195466
rdlDp,0.5,1,1,ACGTGTCGGGCACGCACTAA,0,3173409
rdlDp,0.5,1,1,ACGGGTTTCGCACTTAGCAG,0,3174511
rdlDp,0.5,1,1,ACGGCTGAGGACATATGCAA,0,3197296
rdlDp,0.5,1,1,ACGAATCTCACCAGATCCTA,0,3209685
rdlDp,0.5,1,1,ACCTTCTCAACTCTGCTGAT,0,3184930
rdlDp,0.5,1,1,ACCCGCTCCGGAGGCGGTGC,0,3196214
rdlDp,0.5,1,1,ACCACGCACCGTACTGTACC,0,3164407
rdlDp,0.5,1,1,ACCACCTGTGCGATGGGACA,0,3181930
rdlDp,0.5,1,1,ACCAACTCCTGACATTTTCA,0,3202978
rdlDp,0.5,1,1,ACCAAATCAGGTTTGGGCGG,0,3177512
rdlDp,0.5,1,1,ACATGTACCTCGCTCCCTAT,0,3207890
rdlDp,0.5,1,1,ACATGAATGCTAATGCTTCT,0,3173180
rdlDp,0.5,1,1,ACATATGTCTATATAACTTG,0,3190389
rdlDp,0.5,1,1,ACAGATTTCTAGTGTGTCAC,0,3206030
rdlDp,0.5,1,1,ACAGAACCGGGGGTAACCAA,0,3180642
rdlDp,0.5,1,1,ACACGTCCCGGGTTATTGAC,0,3180398
rdlDp,0.5,1,1,ACACCAGTGATTGCTACTCA,0,3175339
rdlDp,0.5,1,1,ACAAGAGACACCACATGTGT,0,3204710
rdlDp,0.5,1,1,AATTTGCTTTTCAACTGCTG,0,3191767
rdlDp,0.5,1,1,AATTGTTCCTGATTAGTAAA,0,3168791
rdlDp,0.5,1,1,AATTCATACAATACTCAACA,0,3172182
rdlDp,0.5,1,1,AATGTCGCATTACCGGGACG,0,3172845
rdlDp,0.5,1,1,AATGGGGTCCGCGTGTACTT,0,3191826
rdlDp,0.5,1,1,AATGCACACAGCCAAACTAA,0,3170381
rdlDp,0.5,1,1,AATCTGTTGGATCTGCCGTT,0,3183474
rdlDp,0.5,1,1,AATCTCGATTCAATATGCAA,0,3167530
rdlDp,0.5,1,1,AATCTATACCCGGCTAGCAT,0,3212618
rdlDp,0.5,1,1,AATACCCAGCGGGCTCCGAC,0,3165216
rdlDp,0.5,1,1,AAGGTATATACTAGCACCAG,0,3210567
rdlDp,0.5,1,1,AAGGACCTCTATTACAATAA,0,3185828
rdlDp,0.5,1,1,AAGACACGCGATGGAGCTCG,0,3175098
rdlDp,0.5,1,1,AAGAAGTACGATCGCTAATT,0,3174893
rdlDp,0.5,1,1,AACCTTATCGGACAACCAAC,0,3178443
rdlDp,0.5,1,1,AACCGAATTGCCGCGATCGA,0,3205365
rdlDp,0.5,1,1,AACAGATGGGCCGCGATCAG,0,3195462
rdlDp,0.5,1,1,AAATTTTGGTACGACTAGCA,0,3215880
rdlDp,0.5,1,1,AAACTACATTACGTTTGGAA,0,3208973
rdlDp,77.0,76,0,CTACGCAACCTGACGGTTGG,76,3196868
rdlDp,68.0,67,0,GGGGACCATACGGATGTGGG,67,3212433
rdlDp,66.0,65,0,GACCGGGGGGACAAGTCCTT,65,3169181
rdlDp,58.0,57,0,CATATGAAAGTCCACCCTGC,57,3185572
rdlDp,55.0,54,0,CTGTAGTTCGATCATGGCAT,54,3196435
rdlDp,49.0,48,0,GCCGAACCCCGTGTTAAGCT,48,3211012
rdlDp,44.0,43,0,AGATGGGTGGAGTGTGGTAG,43,3211511
rdlDp,40.0,39,0,ACAATAGTAAACCCCTGCGT,39,3191411
rdlDp,39.0,38,0,CAGGGAGGACGCCAGCACTG,38,3198440
rdlDp,38.0,37,0,CAAAGTAATTTCGGCCCACA,37,3196436
rdlDp,37.0,36,0,CTTAGTAGCATAAAAAGAAA,36,3212512
rdlDp,35.0,34,0,TGTAGTCGTCGGACGAGGTG,34,3212543
rdlDp,32.0,31,0,CTCTCGTAAGACAATTCCCT,31,3194134
rdlDp,31.0,30,0,GGATCGTGGTTTGAAAACAT,30,3179322
rdlDp,30.0,29,0,GCATAGCTCCAGATAGATGT,29,3181913
rdlDp,29.0,28,0,TTCCAATCGTACAACAACAG,28,3170918
rdlDp,29.0,28,0,TGTGTCCAGTCTGGCACAAA,28,3189769
rdlDp,29.0,28,0,GTCAGTATGGGACCGTACCA,28,3198370
rdlDp,28.0,27,0,AATACTTGGGCCATCGTGTC,27,3178913
rdlDp,27.0,26,0,AGACTGGCAATATACATTGG,26,3182163
rdlDp,26.0,25,0,ATTGTCCTGCTTCGTGCTTC,25,3190588
rdlDp,25.0,24,0,TGCAATTGCATTGTTTCGGT,24,3172897
rdlDp,25.0,24,0,CGAGTGTCCTCTTTGGAGTA,24,3207462
rdlDp,25.0,24,0,CCTTTCATTGCTACCTTGGA,24,3204270
rdlDp,24.0,23,0,GGTATCCATTAGGGCGCCCT,23,3180648
rdlDp,24.0,23,0,CCACGTTCAGGTTCTCATTC,23,3193923
rdlDp,24.0,23,0,ATAGAGCGTCCTTAAATGTA,23,3215968
rdlDp,23.0,22,0,GTAATGTTGACGAAACATAC,22,3184811
rdlDp,23.0,22,0,CCACAGATCTGGACGCTCGG,22,3202959
rdlDp,22.0,21,0,GACTGCACAAGGATCGGCTT,21,3192533
rdlDp,22.0,21,0,CTCGTCGCAGTTCCTCTGGA,21,3198379
rdlDp,22.0,21,0,CCGCCGGCGAGAAGAAGTAG,21,3199431
rdlDp,21.0,20,0,CACACCTGCGCTGTTATTTG,20,3192859
rdlDp,20.0,19,0,GCCGGGTACGAGCTTCTGTT,19,3194140
rdlDp,20.0,19,0,CGGCCTACCTCCCATGGACG,19,3180404
rdlDp,19.0,18,0,TCCGTTGGTGTATCAGCTCT,18,3198033
rdlDp,19.0,18,0,GTACTATCATCCACAAGGGT,18,3203875
rdlDp,18.0,17,0,TTGATGTTCCATAAAGTCGA,17,3212489
rdlDp,18.0,17,0,GGTTTTGTGGACGGACCCTC,17,3185857
rdlDp,18.0,17,0,GGTATCGCCCTTATCAGGGG,17,3211648
rdlDp,18.0,17,0,GGCTCGTTTACGACAAGAAA,17,3181329
rdlDp,17.0,16,0,GGCTGCGCGACGCATACCAT,16,3190590
rdlDp,17.0,16,0,GGATTCGTATGCGCATCTAG,16,3198355
rdlDp,17.0,16,0,GCGATGGCTCCCGGAGAAGA,16,3201092
rdlDp,17.0,16,0,CTTGGCAATAAGTCAATTGC,16,3205050
rdlDp,17.0,16,0,ATAAAGCGGCATAAAGATTT,16,3194220
rdlDp,16.0,15,0,GTAATTCAAAGTAAATTTTC,15,3213618
rdlDp,16.0,15,0,GACGGTCAACGAGCAGTCAG,15,3211401
rdlDp,16.0,15,0,ACGCAATTGCTAAAGGGTGT,15,3209005
rdlDp,15.0,14,0,GTGGGCGAGGTCACCTAGTT,14,3215250
rdlDp,15.0,14,0,GTCTAGCGGTGCCTCCTTTG,14,3184493
rdlDp,15.0,14,0,GCTTCTCTGCATTCCCGCGG,14,3204975
rdlDp,15.0,14,0,GACAGACGATATATGCCCCA,14,3209364
rdlDp,15.0,14,0,CCCGTGATCAGGCTTGGTAA,14,3204157
rdlDp,15.0,14,0,AGTTAGGGGCCTAACAGTAG,14,3213420
rdlDp,15.0,14,0,AGACTTGATATTTAACTTTT,14,3168820
rdlDp,15.0,14,0,ACTACGTTCACCAACCGCCA,14,3183582
rdlDp,15.0,14,0,ACCCAGTTGATCCGACTTTT,14,3174640
rdlDp,15.0,14,0,AAACTATCTCTGAGCGGGTG,14,3171644
rdlDp,14.0,13,0,TTGCCGGATGTTATTAACTT,13,3168217
rdlDp,14.0,13,0,GGCTTACTAAGAACTATTAC,13,3171242
rdlDp,14.0,13,0,GGCCTAGAGGGAGGTCAGGC,13,3197777
rdlDp,14.0,13,0,GGAATACTCTCGTGTGAGAT,13,3207891
rdlDp,14.0,13,0,GCCTCATTAGGGCGCCTAAT,13,3202710
rdlDp,14.0,13,0,GCCACGAGTTGACGGGATTC,13,3189745
rdlDp,14.0,13,0,GCAAGTGCGAACAGGGCAAT,13,3168626
rdlDp,14.0,13,0,GCAAGCTTAAAAGAGAGTGA,13,3195283
rdlDp,14.0,13,0,GAAAGTGGTTAACTTTACGG,13,3189665
rdlDp,14.0,13,0,CTCTTATGCCCTGTTTGGAC,13,3202663
rdlDp,14.0,13,0,ATCCCGATTGGCAAAAGCCG,13,3209533
rdlDp,14.0,13,0,ATCAGACTACAGGTTGTATA,13,3198863
rdlDp,14.0,13,0,ACCTCACAACCGTGAGGGGA,13,3194866
rdlDp,13.0,12,0,TTCCCGGGGGCAACGTTGAA,12,3209042
rdlDp,13.0,12,0,TGTCAACGTCCGGGTACATG,12,3166489
rdlDp,13.0,12,0,GGCCTGGACCAGCGAACAAG,12,3204153
rdlDp,13.0,12,0,GCCAGGCACGGATTGTGATC,12,3197665
rdlDp,13.0,12,0,GACCCGGCTGTCTCCTCGCT,12,3178074
rdlDp,13.0,12,0,GAAGTACGCGATCCCTGGAC,12,3166268
rdlDp,13.0,12,0,CAATCTGCGCACTATAATCT,12,3209128
rdlDp,13.0,12,0,CAACGTGCACTCTGGAACCA,12,3176125
rdlDp,13.0,12,0,ATAACATATAGTCGCCCATT,12,3203594
rdlDp,13.0,12,0,AGGGCTCCGGGTAGCAGCCT,12,3214491
rdlDp,12.0,11,0,TTGTCCCATTGGCGTGATAA,11,3215249
rdlDp,12.0,11,0,TGGGTAGCAACCACCTGAGC,11,3171215
rdlDp,12.0,11,0,TCTACTCGAGCCGAGCCAGT,11,3211268
rdlDp,12.0,11,0,GACATCAGAGGTTTACAGTA,11,3172909
rdlDp,12.0,11,0,GAATGCAGTTGTTCTCGGCC,11,3215879
rdlDp,12.0,11,0,CTGTCAAGCTACCTGAAATG,11,3194206
rdlDp,12.0,11,0,CACCCGAGTTTAGGCCTCCT,11,3186159
rdlDp,11.0,10,0,TCATGGTTTAGATAATGCGC,10,3170281
rdlDp,11.0,10,0,TAGGGTAGAAGCCGGCAACT,10,3187406
rdlDp,11.0,10,0,GCTATATCAGGGCGGCTCCA,10,3186152
rdlDp,11.0,10,0,CGGCTCCGCGGAATTTCTTT,10,3201327
rdlDp,11.0,10,0,CGAATCTGTTGAGATGTTTA,10,3204156
rdlDp,11.0,10,0,ATTAAGTTAGAGGGCCGCGA,10,3180633
rdlDp,11.0,10,0,ATGCCTCGCTTTGAATTTAG,10,3212466
rdlDp,11.0,10,0,AGTGATAGTACTGCGCCCAA,10,3173339
rdlDp,11.0,10,0,AGTCTAAAAGCATTGAGACG,10,3208900
rdlDp,11.0,10,0,AGAGTTCCTGCGCGTCGCGA,10,3197260
rdlDp,11.0,10,0,AACAAGGGTAGGCTAGGGCA,10,3205321
rdlDp,10.0,9,0,TGATCCTGTTCGTACGTCCC,9,3213269
rdlDp,10.0,9,0,TCGGCCCTAAATCTCTTTGC,9,3206037
rdlDp,10.0,9,0,TATGTGCGCGCTCCCCGGAC,9,3167666
rdlDp,10.0,9,0,TAGACTCATTGTTTCGAATT,9,3169100
rdlDp,10.0,9,0,GTTTAGCGAGCCGCCCTGCA,9,3211802
rdlDp,10.0,9,0,GTTCGATCGTGGGGACAACT,9,3193597
rdlDp,10.0,9,0,GGCGCATAATATCAAGCGCG,9,3209287
rdlDp,10.0,9,0,GACTGCTACCGACACGTGAC,9,3193294
rdlDp,10.0,9,0,CTTGTCACTTGTTCACTGGT,9,3204876
rdlDp,10.0,9,0,CTTCGAAAATGGCCCGGGAC,9,3179304
rdlDp,10.0,9,0,CGCCGCAAGCTGCAGTTTGC,9,3186779
rdlDp,10.0,9,0,CAGAAGGAATTGTATCCAAC,9,3176654
rdlDp,10.0,9,0,CACTAGACGAGTACATAGGG,9,3207994
rdlDp,10.0,9,0,CAAAATTATCCCAAGAATGG,9,3165764
rdlDp,10.0,9,0,ATGTGGATCTTGGGACTTCT,9,3210467
rdlDp,10.0,9,0,ATGACGGGAACCTACGGCAT,9,3172461
rdlDp,10.0,9,0,ACGTTTAGTTGGGTATTGTC,9,3215082
rdlDp,9.0,8,0,TTGGAGCTATTACAATGGGT,8,3179686
rdlDp,9.0,8,0,TTAGCATCCGTGCCAGTGAA,8,3180638
rdlDp,9.0,8,0,TGTAGGCAACAAGTGTGCAT,8,3195508
rdlDp,9.0,8,0,TGATGATCTGACTGGCAGGA,8,3187393
rdlDp,9.0,8,0,GGGAGGTTACTGGGAGAAGG,8,3188238
rdlDp,9.0,8,0,GGCTAGAGTGAATGAAAGGC,8,3199764
rdlDp,9.0,8,0,GGAAAGTTCACCACTCGTGA,8,3176805
rdlDp,9.0,8,0,GCGCGCGCGAGACGTGGAAG,8,3207238
rdlDp,9.0,8,0,GCACTCTCGTCCGGCGCTGA,8,3164801
rdlDp,9.0,8,0,GATGGAAGGGGCCAGCTGGG,8,3164244
rdlDp,9.0,8,0,GAGTACGACCGTCTCTAATG,8,3172262
rdlDp,9.0,8,0,GACGGCTCTTAAGACCACCG,8,3182589
rdlDp,9.0,8,0,CGTACAGAGGACTCTAATGG,8,3206639
rdlDp,9.0,8,0,CCCAATGCGTTAAAGTAGCA,8,3190005
rdlDp,9.0,8,0,ATTTGCACCTACCGGGATGA,8,3166345
rdlDp,9.0,8,0,AGCTTGCTGAGCTCAGCAAC,8,3197797
rdlDp,9.0,8,0,ACCGCCTCGGGTTCCATATC,8,3191290
rdlDp,8.0,7,0,TTCGGAACCAATAGATTCGG,7,3188101
rdlDp,8.0,7,0,TGTTTTTTAAGACTGGACCT,7,3188620
rdlDp,8.0,7,0,TCTCGTTGAGCCGTTGGTTC,7,3167679
rdlDp,8.0,7,0,GTGTAATGACGGGAAGACGA,7,3201675
rdlDp,8.0,7,0,GGTTGTCTGGTGTGATAGAT,7,3201412
rdlDp,8.0,7,0,GGTTCGTCGAATCCATCCGA,7,3187251
rdlDp,8.0,7,0,GGGTCGGGTGCTTAGGTCAT,7,3214330
rdlDp,8.0,7,0,GATCTTCGATATACGCTCGT,7,3183622
rdlDp,8.0,7,0,CTGTAGGCAATGTAACGTCA,7,3209090
rdlDp,8.0,7,0,CCGAGCCTAGGAATGGTTAC,7,3215392
rdlDp,8.0,7,0,CCATGACCCACTCGGTGGTC,7,3170524
rdlDp,8.0,7,0,CAACTTCTCCGAGACAGTTT,7,3205883
rdlDp,8.0,7,0,AGGAACCCATTATTGCGTAA,7,3172212
rdlDp,8.0,7,0,ACGTGGAATGTTGAATCTAG,7,3166156
rdlDp,8.0,7,0,ACGGCCACCCGGTAAACCAA,7,3197982
rdlDp,8.0,7,0,AATTGATGGTGGTTCTAACG,7,3190381
rdlDp,7.0,6,0,TTAGACACAGTACAAAATGA,6,3197793
rdlDp,7.0,6,0,TTAAGTCCAGTGGTGCGGAC,6,3173600
rdlDp,7.0,6,0,TCGGCAAGGGCTTCAATATG,6,3205359
rdlDp,7.0,6,0,TATTTCCCTAGTAGGTCAAC,6,3175578
rdlDp,7.0,6,0,TAAGGTTGAACTGACTCCAC,6,3176866
rdlDp,7.0,6,0,GATGCGCATCAACGCGCGTT,6,3167210
rdlDp,7.0,6,0,CGCATACCTTTATTTCCGTT,6,3168796
rdlDp,7.0,6,0,CCAGCAAAACGGGGGACGTG,6,3197737
rdlDp,7.0,6,0,CCAACTACGAGGAGCATCAC,6,3189746
rdlDp,7.0,6,0,CATATCAGATCCAAGTGATC,6,3203592
rdlDp,7.0,6,0,AGGCGAGAGGCCAGCATACA,6,3209035
rdlDp,7.0,6,0,AGCTAAAAACAATCTCTCAT,6,3208174
rdlDp,7.0,6,0,AGCGGCTGGAGCCCGTGTTC,6,3190767
rdlDp,7.0,6,0,AGAGGCTCGGACTAAACCTA,6,3187948
rdlDp,7.0,6,0,ACGTAAAGGTCTGATCGATG,6,3199542
rdlDp,7.0,6,0,AAGTTAGATGTAATAGGCCG,6,3186738
rdlDp,6.0,5,0,TTTAACCTGACAGGCTGGCT,5,3175372
rdlDp,6.0,5,0,TCGATTCCGTTGGAGTTTGG,5,3176741
rdlDp,6.0,5,0,TCCATCTCGGGGCGTCACGC,5,3167632
rdlDp,6.0,5,0,TCAGTCGCGAATGTACGTTT,5,3195039
rdlDp,6.0,5,0,TAACGGGGTTACAGCCGAGG,5,3194232
rdlDp,6.0,5,0,GTTTCACGTAACATGTTTTT,5,3188339
rdlDp,6.0,5,0,GTTCATTTGCAGGGGCCGCA,5,3202960
rdlDp,6.0,5,0,GTCTGCAATAAAAAGTCGGT,5,3166081
rdlDp,6.0,5,0,GGAGAGGGAAAAAATGTCCA,5,3202979
rdlDp,6.0,5,0,GCGTTGGCAATGGGACATAG,5,3193917
rdlDp,6.0,5,0,GCATGGGAAGTACATTATAT,5,3191866
rdlDp,6.0,5,0,GCAATTTCACATTCGAATCC,5,3204987
rdlDp,6.0,5,0,GATATCCATATCCCTTCTTG,5,3198435
rdlDp,6.0,5,0,GAGCGCTGGCCGACCTACGG,5,3214745
rdlDp,6.0,5,0,CCGACCAGGCAGCGGGACGG,5,3210465
rdlDp,6.0,5,0,CCACGCTTGCGACTATTGTT,5,3174938
rdlDp,6.0,5,0,CAAGTTCCGGGCTGGTGAAG,5,3167994
rdlDp,6.0,5,0,CAACATTTGAGCGACAGCTT,5,3215306
rdlDp,6.0,5,0,ACAGAGGGATGTCGTATCTA,5,3186672
rdlDp,6.0,5,0,AATGAGGGGGCGGGACAGGG,5,3209040
rdlDp,6.0,5,0,AATCATTCCCTCACAGATGC,5,3209013
rdlDp,6.0,5,0,AAGCCACGCCTGGCCTGCAG,5,3206650
rdlDp,5.0,4,0,TGTAGCCATCGGCCTGGTGA,4,3199446
rdlDp,5.0,4,0,TCGTCTCGGACCTCGAAGAT,4,3187660
rdlDp,5.0,4,0,TCCACTGAAGCCTCGTGCGG,4,3175932
rdlDp,5.0,4,0,GTTTGCATCTATCACTTGCC,4,3164784
rdlDp,5.0,4,0,GTGTGCTCATCTTTCCGGGG,4,3181990
rdlDp,5.0,4,0,GTGCTAGGGCTTCTAGCAAC,4,3187940
rdlDp,5.0,4,0,GTCGGGGTATCCAAACGATC,4,3166151
rdlDp,5.0,4,0,GTCGAGCCGCCTGTTCATGA,4,3189756
rdlDp,5.0,4,0,GTAGGAGTAGGCGGTACATC,4,3193303
rdlDp,5.0,4,0,GGTTATTTGTGATCAGCGCA,4,3211045
rdlDp,5.0,4,0,GATCCTCAGTCATTTTCTGT,4,3194029
rdlDp,5.0,4,0,GAGGAGTATGAAGCAGCCCT,4,3166576
rdlDp,5.0,4,0,GACGACTGCCGTGGCCATTA,4,3193224
rdlDp,5.0,4,0,CTGAGCGCTCCCGGTGACAG,4,3193002
rdlDp,5.0,4,0,CGGCGCAGTAGAAGATTTGT,4,3202651
rdlDp,5.0,4,0,CGCGACGAGGCTGTGAAGGC,4,3198183
rdlDp,5.0,4,0,ATTTTCTGCTAGGATGTCCT,4,3176283
rdlDp,5.0,4,0,ATTTGCAGTGAGGCGTCCTA,4,3198943
rdlDp,5.0,4,0,ACTTGAAGATTGAGCTCCGT,4,3176753
rdlDp,5.0,4,0,ACAATACACTCGTGTACAAG,4,3173845
rdlDp,4.0,3,0,TTCAACGAGAACCCGGAGTA,3,3179554
rdlDp,4.0,3,0,TTAAATTCCGTCAATGATGG,3,3175923
rdlDp,4.0,3,0,TGTTATTAAGGGTAATATGC,3,3209001
rdlDp,4.0,3,0,TGGCGTCAGGCATGGAGGCG,3,3195467
rdlDp,4.0,3,0,TGAACTATCGACGTAGTCGC,3,3181034
rdlDp,4.0,3,0,TCTTTACAGTTCAATTATGG,3,3193819
rdlDp,4.0,3,0,TCGACTGGCGCAGTGCTATC,3,3198225
rdlDp,4.0,3,0,TCACAGAGCATACTCAACGT,3,3169975
rdlDp,4.0,3,0,TAGGGTCTAAAGTCACTTGG,3,3167414
rdlDp,4.0,3,0,TACACATGGGACAGCGACCT,3,3192053
rdlDp,4.0,3,0,GGCCTATGGCCGAGGGTTCG,3,3209433
rdlDp,4.0,3,0,GCGGCGGCCGCGCGTTATAT,3,3193817
rdlDp,4.0,3,0,GCGCGTAGCATCTTCGCGTT,3,3164567
rdlDp,4.0,3,0,GATTGTCCGTGATCATTACG,3,3176669
rdlDp,4.0,3,0,GAATTTCTGTCAGTAGACAT,3,3170031
rdlDp,4.0,3,0,CTTAAGGTGGACCACCCAGT,3,3182437
rdlDp,4.0,3,0,CTCCCTCCCCCCTTCTACTA,3,3189680
rdlDp,4.0,3,0,CGTATAACCGTCGAACGTCT,3,3182290
rdlDp,4.0,3,0,CGGGTGATACCCCTTCTGAA,3,3183967
rdlDp,4.0,3,0,CGGATTATTATAGTTTTTTA,3,3215040
rdlDp,4.0,3,0,CGAAAGGCAGCCGCAGGAGA,3,3205889
rdlDp,4.0,3,0,AGCCGGGATTGAATTATAGA,3,3194904
rdlDp,4.0,3,0,ACTTCGGATCTCTCTAGCAA,3,3208307
rdlDp,4.0,3,0,ACGCACAGATATAGTGCTGC,3,3177734
rdlDp,4.0,3,0,ACCTGTCCTGAGGGACAATG,3,3177139
rdlDp,3.0,2,0,TTTTTTTTAAATTGAATTAG,2,3174010
rdlDp,3.0,2,0,TTGATAACTTATACCACAGT,2,3208844
rdlDp,3.0,2,0,TTGACTGGTGTGTCAGCTAA,2,3175953
rdlDp,3.0,2,0,TTCTTTCCCATGCTTTCGAC,2,3199265
rdlDp,3.0,2,0,TTCCGGGTGCGGCAATCAAT,2,3170286
rdlDp,3.0,2,0,TGACGGATAGTCGAGTAGAA,2,3169940
rdlDp,3.0,2,0,TATATCTGGCAGGGTGCTTC,2,3164345
rdlDp,3.0,2,0,TAGCGAAAAGATAAGTCCAC,2,3208530
rdlDp,3.0,2,0,GTGGAAGACGGCTGACGGGG,2,3204149
rdlDp,3.0,2,0,GGCTGTCTTGCGAGCGACCA,2,3175549
rdlDp,3.0,2,0,GCCACTTAAGGACTTTATCC,2,3175579
rdlDp,3.0,2,0,GACATTTTTACCATGGACCC,2,3165417
rdlDp,3.0,2,0,GAAGGCCCCATCGCTCGACA,2,3195333
rdlDp,3.0,2,0,CGTGGTCAATTCGAGCCTCG,2,3179192
rdlDp,3.0,2,0,CGTATATGCTTGGAGAGCGG,2,3215957
rdlDp,3.0,2,0,CCTATTATTATACAGTCAAA,2,3193657
rdlDp,3.0,2,0,CAGTGGGTTTAAAGCTATCC,2,3164793
rdlDp,3.0,2,0,CACCCGGTACCAGTGCGTAG,2,3178786
rdlDp,3.0,2,0,CAACGGGCCGTTCGGGACAG,2,3184719
rdlDp,3.0,2,0,CAACACGATTCCGAATTGCA,2,3208321
rdlDp,3.0,2,0,AGGACAGCTCTAGCATCAGC,2,3209359
rdlDp,3.0,2,0,ACGATCCACAGTCAGGGAAC,2,3194680
rdlDp,3.0,2,0,ACATGGCCGGTCGTCCCTCC,2,3205071
rdlDp,3.0,2,0,ACACCTCCAGTTTACTTCGG,2,3197110
rdlDp,3.0,2,0,AAGGCAAATTAGACCAGTAT,2,3188337
rdlDp,3.0,2,0,AACTTACCAGGAAACAGGAT,2,3187533
rdlDp,3.0,2,0,AACGAAGGGTTATCGGTTAC,2,3170941
rdlDp,2.0,1,0,TTCACGTCCGGCTAGGCGTG,1,3183922
rdlDp,2.0,1,0,TTAACAAGAGTAGCGAAATA,1,3188386
rdlDp,2.0,1,0,TGTCCCCAATATTCCTGGCT,1,3201146
rdlDp,2.0,1,0,TGGTTTAAGCCGTAAAGATC,1,3208326
rdlDp,2.0,1,0,TGGTAAGATCTGATTGGGTA,1,3180909
rdlDp,2.0,1,0,TGATGATCCATAAGCGTACT,1,3206572
rdlDp,2.0,1,0,TCGACTCGGGTAGTGCGAGG,1,3209018
rdlDp,2.0,1,0,TCAGTCGAGGGATCAGAGAA,1,3201463
rdlDp,2.0,1,0,TATGGGGTAAAATGGGCCTA,1,3209804
rdlDp,2.0,1,0,TATATTTGGTGGGGATCTAT,1,3198466
rdlDp,2.0,1,0,TATACTCGGTATAAGTCGGT,1,3198907
rdlDp,2.0,1,0,TAATCATGTTCTCCCTTAAG,1,3208177
rdlDp,2.0,1,0,GTTCATTTAGTCAGTGCGAC,1,3195818
rdlDp,2.0,1,0,GTTAGCAACCCGGATTTAAT,1,3181539
rdlDp,2.0,1,0,GTGATTCACGGCCGAGTATG,1,3187955
rdlDp,2.0,1,0,GTAGCTTCCACCCAAATATC,1,3206666
rdlDp,2.0,1,0,GTACGCAGGAGCTAACTTTA,1,3189753
rdlDp,2.0,1,0,GGGGTAACAAGCGACCGCGA,1,3205997
rdlDp,2.0,1,0,GGCTTGTCTGGAGCAAAAAG,1,3184951
rdlDp,2.0,1,0,GGATGTGTCATCATCTTCCC,1,3182179
rdlDp,2.0,1,0,GCTCGAAGTTGCTTGGACAA,1,3173383
rdlDp,2.0,1,0,GCGCCTCTGGACAAAAGTGT,1,3165286
rdlDp,2.0,1,0,GATTCTAAAGCGAACCGGTC,1,3169980
rdlDp,2.0,1,0,GAAAACGAGGGCGAATTGTG,1,3206822
rdlDp,2.0,1,0,CTTCCGGGATCTACGTATAG,1,3204653
rdlDp,2.0,1,0,CTTACATAGCCTTGCACGGG,1,3181625
rdlDp,2.0,1,0,CGTCGATCACGTTGTAAGAT,1,3203607
rdlDp,2.0,1,0,CGTATTGGTTGAGCCGGTTT,1,3209445
rdlDp,2.0,1,0,CGGGAACTTCGGCGCCAGCG,1,3189023
rdlDp,2.0,1,0,CGCGGTTCCGGATTCTCATA,1,3194236
rdlDp,2.0,1,0,CGCCGAGATAATCACATACA,1,3168384
rdlDp,2.0,1,0,CCTCGATCAGACAGCGTTTT,1,3201126
rdlDp,2.0,1,0,CCTATAGGCCTATTTCGACA,1,3165931
rdlDp,2.0,1,0,CATTCCACGTCAAACCCTTT,1,3172267
rdlDp,2.0,1,0,CATGGCGTGTGGCGCAGCAA,1,3199731
rdlDp,2.0,1,0,CATGCTATCTTAGATTTACC,1,3200756
rdlDp,2.0,1,0,CAGATCGCAGTCCGTATTGT,1,3208016
rdlDp,2.0,1,0,CACGACAACTGAAGGTTTGT,1,3213795
rdlDp,2.0,1,0,ATTTCCATCACAGCACTATA,1,3183981
rdlDp,2.0,1,0,ATGTTTTGACCCGTCAGACA,1,3207400
rdlDp,2.0,1,0,ATGTCGCCCTTCATCAATAC,1,3181528
rdlDp,2.0,1,0,ATGCAATCTTACCGGAAAGG,1,3204188
rdlDp,2.0,1,0,ATCTCCGTCCTGCATTTGCG,1,3207342
rdlDp,2.0,1,0,ATCCAGCAGTTCCGGGTAGT,1,3193780
rdlDp,2.0,1,0,ATAAAGTCCTTATGTGTCAC,1,3165288
rdlDp,2.0,1,0,AGTTACCAACAAGACACATA,1,3193415
rdlDp,2.0,1,0,AGTCACAGCCGACGTCGGCA,1,3166342
rdlDp,2.0,1,0,AGGGCACCCCGGCTGTGCCT,1,3171112
rdlDp,2.0,1,0,AGAAGTCCGCCCCCGAGTTT,1,3210386
rdlDp,2.0,1,0,ACGTATCTAAGCTTCCTTTG,1,3170081
rdlDp,2.0,1,0,ACGGTAAGATATAGAGGTAT,1,3179095
rdlDp,2.0,1,0,ACAAGCCGTAAGCCTTGGAC,1,3164315
rdlDp,2.0,1,0,AAGTGAGCAGGGACCGACGG,1,3205419
rdlDp,2.0,1,0,AACTAATTACGTCAAGGGTA,1,3192520
