name,relative_counts,ct,ct_0,barcode,ct_1,barcode_ind
marRp,0.5782747603833865,492,312,GGGTATTCTGCACGGCAACG,180,2218088
marRp,0.5384615384615384,398,259,ACGCGCCAGGACCGTTACTT,139,2218109
marRp,0.5818181818181818,259,164,TTGAGCCATTTGGAAATGCA,95,2243222
marRp,0.9827586206896551,228,115,GTCTTCCTCACCATGCACGT,113,2226171
marRp,0.6857142857142857,175,104,TTTCTGCGGTAAGTACACAT,71,2218269
marRp,0.45098039215686275,146,101,CTGTTGGTGGCCACGCGAAT,45,2229290
marRp,0.9494949494949495,191,98,TCCAGCGGTAGCAGCCTTGA,93,2232845
marRp,1.0808080808080809,204,98,CCCGCATCCACGGACAACTT,106,2217944
marRp,3.2783505154639174,413,96,GGTTAGTCCGTGTGTTCTGT,317,2243143
marRp,0.34065934065934067,120,90,TAGATTGCGTCTACGAATGG,30,2242077
marRp,0.14285714285714285,102,90,CTTCCGCAGGAAGTTACTGC,12,2225729
marRp,0.43820224719101125,126,88,GAAACACAATCCCAACTCCT,38,2222658
marRp,1.388235294117647,201,84,ATTGTCAGCTCACTCCTTTG,117,2224127
marRp,1.0,168,84,ACCTCCATTCCTATAGTTCT,84,2241891
marRp,0.7560975609756098,142,81,GTTGGACAAGGCCTCGGTAA,61,2230564
marRp,11.91358024691358,1044,80,GAGGTGTGGTCCAAAGTAGT,964,2251619
marRp,1.5308641975308641,203,80,CGCTCCGGGTACTGGCGCGT,123,2224699
marRp,5.246913580246914,504,80,AAATGATACGCAGCTCGATC,424,2218011
marRp,0.26582278481012656,98,78,GTAACGGTGTTCAAACAGCG,20,2218044
marRp,0.1282051282051282,86,77,CGCGAGGCATTTGGCATATG,9,2226771
marRp,0.39473684210526316,104,75,TTGGGTCTAGATGGGAGCCA,29,2220931
marRp,1.0921052631578947,157,75,CCGTCTGAGGTGCCGCGATA,82,2239795
marRp,1.1578947368421053,162,75,ATTTTCCTCTCGTTATACCT,87,2224318
marRp,0.96,145,74,TATAATGTTAGAACCAAACT,71,2245712
marRp,0.5135135135135135,110,73,GCGGAATTGTCCCTGAATGG,37,2239952
marRp,0.5,109,73,GAGAACCCCCGGGGAAGAAT,36,2219433
marRp,0.25675675675675674,91,73,GAATGAAATGGTCAAGGTAG,18,2220665
marRp,0.2972972972972973,94,73,CTTCAGACTTGTGGCGTGTT,21,2234715
marRp,0.2361111111111111,87,71,ATGCGTTTCGAGCCCCTATA,16,2251866
marRp,0.1267605633802817,78,70,CGCAGTTGATTTCGCAAATG,8,2226422
marRp,4.605633802816901,396,70,CATGATTGCATCCTTGAAGT,326,2237538
marRp,0.22535211267605634,85,70,AGTGCGAACGGTATACTAAA,15,2234798
marRp,0.2112676056338028,84,70,AATACGCTCATTGGCATCTA,14,2253131
marRp,3.142857142857143,288,69,TGGACATTTTCGCAATCGTA,219,2224354
marRp,0.37142857142857144,94,69,CGATACTTCGAGGCTATGGT,25,2242132
marRp,1.4285714285714286,168,69,ATTCGGAGCATGTGGCAGTA,99,2257123
marRp,3.6911764705882355,317,67,TCTTTGCTGATAAAATACCT,250,2235441
marRp,0.2647058823529412,84,67,GGGACCACAGCTATCGAAGT,17,2253115
marRp,1.25,151,67,GCTGAAAGCGCAAATCTTTA,84,2223918
marRp,0.6323529411764706,109,67,CCTAAACGCAGCTATGCGTA,42,2228612
marRp,0.36764705882352944,91,67,CCAATCCAGGGACGCGATGT,24,2233038
marRp,0.5522388059701493,102,66,GTGGTTTTCCTGTACATAAT,36,2233199
marRp,1.1194029850746268,140,66,CATTTAACGAACGGCCAGGT,74,2244139
marRp,1.1492537313432836,142,66,ACAGGGAGAGCGTCAAGGAG,76,2233477
marRp,0.8484848484848485,120,65,TTTCCCCCCAGGTACTAGAA,55,2217883
marRp,1.0454545454545454,133,65,TGTGAGTCACATCGAGGTTA,68,2236322
marRp,0.10606060606060606,71,65,CGCCTAGCGAACCAAAACGG,6,2231416
marRp,0.7424242424242424,113,65,CCAATCCGCTACCTCAATTG,48,2218929
marRp,2.727272727272727,244,65,ATGGCCGTTGGCATAAGTCT,179,2225133
marRp,0.3181818181818182,85,65,AAAACGGTGTACGTGGCGTA,20,2250739
marRp,0.6153846153846154,103,64,CTGGTCTGTGGTTGATGTTT,39,2243486
marRp,0.6307692307692307,104,64,CGCCGAGCTCGCACCGTTCG,40,2221955
marRp,0.27692307692307694,81,64,CAATTCGGGTGGAGATTGGA,17,2244692
marRp,0.4307692307692308,91,64,ACTAGGAGTCTCAACTCTAA,27,2227228
marRp,0.13846153846153847,72,64,ACCGGGGTCCCAGTCCACTA,8,2234432
marRp,2.9523809523809526,247,62,TCTTATAACGCATATTAAAG,185,2217780
marRp,0.1746031746031746,72,62,AGGATGATGTGGTGGAATAA,10,2236363
marRp,1.6129032258064515,160,61,TGAGTGTCTGCCTCGGTCCG,99,2218928
marRp,2.435483870967742,211,61,TCAACACATAGCGCTGGGTG,150,2221312
marRp,0.3870967741935484,84,61,TAGGTTAATACGTCCTTCAA,23,2244317
marRp,0.16393442622950818,69,60,TGTAACAAAGTCGTCCACAT,9,2250105
marRp,1.9180327868852458,176,60,GTAGCAGCGACGTTCGTAGA,116,2222628
marRp,0.9344262295081968,116,60,AGACGTGGGAACGGTGCATG,56,2259165
marRp,0.6166666666666667,95,59,GTTAGTGGTAGCTACCTAGT,36,2221092
marRp,0.38333333333333336,81,59,CTAGCCAAGGGGTGGAGACT,22,2242475
marRp,1.1333333333333333,126,59,CTAAACCGGATGGAATCACA,67,2226170
marRp,0.7833333333333333,105,59,CGGAGACGACCTCAACACTG,46,2217809
marRp,0.7,100,59,CCCTCCGAACCGAATCGTAA,41,2219862
marRp,1.8644067796610169,167,58,ATACAAGTTTACATACAGTT,109,2254916
marRp,0.8275862068965517,104,57,TGGCGAGCCACTTGGTCCCA,47,2225875
marRp,0.27586206896551724,72,57,TCGTTGGCACGCGGTTATTA,15,2237410
marRp,0.6724137931034483,95,57,GGTACATGATGAAGCATAAA,38,2235487
marRp,1.9655172413793103,170,57,CTCCCTGTCGAAGTGAGCGT,113,2251191
marRp,0.22413793103448276,69,57,CTCCACTACATAGGATGTCT,12,2243340
marRp,0.1206896551724138,63,57,AGGCACAAACTGTCGCATTA,6,2255431
marRp,0.27586206896551724,72,57,AGATGCTGAATACCCAGACT,15,2259181
marRp,1.0689655172413792,118,57,ACACGCGGAATACACCTGAA,61,2258529
marRp,0.21052631578947367,67,56,TGTGATCGTTGTTTGCGTAT,11,2241761
marRp,1.4385964912280702,137,56,GCGATATTCTTGTGAGAGAA,81,2244092
marRp,0.8771929824561403,105,56,GACTGCTTGATAGGTCACTA,49,2232757
marRp,0.08928571428571429,59,55,GTGGCATCATAAGCTCTCGC,4,2230699
marRp,0.34545454545454546,72,54,GTCCAGCCGTGTTTTTTTAA,18,2242010
marRp,0.5272727272727272,82,54,CGGTCTTACGGTATTCAATA,28,2231716
marRp,0.8,97,54,CAGGGTCGATGTCAAGAAAT,43,2243726
marRp,0.3090909090909091,70,54,AGGGCTCTTGGGAAGGGGCA,16,2251863
marRp,0.7090909090909091,92,54,AGATATTCAACTCCTGATTA,38,2223100
marRp,1.037037037037037,108,53,GAGTAGTATCGAATAGCGGT,55,2233201
marRp,0.4074074074074074,74,53,CGGGTGGGTCATGTGAGATA,21,2236362
marRp,0.18518518518518517,62,53,ATACGCCGTCAGTCAAAGGA,9,2226414
marRp,0.3018867924528302,67,52,TAGCGCACCGCACCATTGTT,15,2251856
marRp,0.11320754716981132,57,52,TAGCAGCTTCGTCCAAACAC,5,2228415
marRp,0.4716981132075472,76,52,GGTATTACTGCCTACGCCAT,24,2224275
marRp,5.811320754716981,359,52,GCGCAAAGAGTCCGTACGGG,307,2233436
marRp,0.49056603773584906,77,52,CGATTTGGCTATTTGGGTGA,25,2219781
marRp,2.452830188679245,181,52,CAGTACACATGTTGAAACAG,129,2254123
marRp,1.169811320754717,113,52,CACTTCATCACTCAACTCCA,61,2228418
marRp,0.5094339622641509,78,52,ACGGGCAATGCAATCTCCGT,26,2233787
marRp,8.18867924528302,485,52,ACCTCTCTACGCTTGGGAAG,433,2222954
marRp,0.8461538461538461,94,51,TGGGACGCACCAATATATTT,43,2222101
marRp,0.4807692307692308,75,51,TGAGTTTCAGGTCGCTGCAG,24,2222111
marRp,3.3653846153846154,225,51,TCTATCAACGCTGTTTACTC,174,2223800
marRp,0.4807692307692308,75,51,GTCGTCCCATAGTTTCTGCC,24,2235353
marRp,0.4230769230769231,72,51,GTAATGAGATCATGTACAAT,21,2225880
marRp,0.28846153846153844,65,51,GGTGACAAGGACTTCGCAAT,14,2230920
marRp,0.25,63,51,GGGAGGTGGGTTTTATCGGT,12,2246233
marRp,0.6346153846153846,83,51,CTTGGATTTCTCATAGGGCT,32,2235538
marRp,0.38461538461538464,70,51,CTTCCCTCATAACGGTCAGA,19,2218535
marRp,1.0392156862745099,102,50,GGGTCTACTAATATCAAGTG,52,2231131
marRp,1.1176470588235294,106,50,AGTGATTCAGGGTTTCTCAT,56,2245543
marRp,0.37254901960784315,68,50,AGGTGCGGCAGGCTACGAGT,18,2230255
marRp,0.5098039215686274,75,50,AGGCCTAGGTCGTTTCCCAC,25,2228815
marRp,0.7058823529411765,85,50,ACGTTAACTGCCCACAGCAT,35,2227137
marRp,1.2549019607843137,113,50,ACGTCGCCTAGACGACGGCA,63,2237024
marRp,0.74,85,49,TCTACGAAGCCCAATCGGTA,36,2230277
marRp,0.62,79,49,GGGCACTCAATTGAGCCGGT,30,2246526
marRp,1.86,141,49,CACCTGACCCTTAAACTGCT,92,2218646
marRp,0.76,86,49,ATGCAGCAACGGTGAGCTTT,37,2247905
marRp,0.46,71,49,AGAGTCACGATTGGCGAAGT,22,2227534
marRp,0.68,82,49,AATGTTCTGATGGGTACGCT,33,2258764
marRp,1.2040816326530612,106,48,TGTAAGACATAGGTAAGGAT,58,2237080
marRp,0.22448979591836735,58,48,TGGCAGACGGTACTTACAAT,10,2217854
marRp,1.163265306122449,104,48,TCCAGATGGTGGCGGGAATA,56,2231448
marRp,1.163265306122449,104,48,GGGCTTTGTTAATTTTTCTT,56,2255207
marRp,1.0204081632653061,97,48,GGCTTCTTTGATGGCACGGG,49,2234500
marRp,0.7551020408163265,84,48,GCCAACCTATCAACGCAGAG,36,2225152
marRp,1.9387755102040816,142,48,GAGGCATCAAGCGGCGCTTA,94,2225400
marRp,0.46938775510204084,70,48,CTTAATAACCTGAATAAGTC,22,2239078
marRp,1.5510204081632653,123,48,CTCAAACTGCCTTAACTAAT,75,2244287
marRp,0.7959183673469388,86,48,ATGTGCACCTTTGAATTAAG,38,2245548
marRp,0.6938775510204082,81,48,ACCCGAGCAATACCGCAGAT,33,2229840
marRp,2.2708333333333335,155,47,TCTTGTACGTCCTCATGAGT,108,2229462
marRp,0.22916666666666666,57,47,GGGTAGGCTCTAAATTGTCT,10,2226300
marRp,0.8958333333333334,89,47,GCACGTGATGTACTGAATTC,42,2226285
marRp,0.7291666666666666,81,47,GACGAAGAGGCGAATGGTTG,34,2233667
marRp,0.0625,49,47,ATCCCCAAGGTTTAATTCTG,2,2225522
marRp,2.6875,175,47,AGCAGTCGAAATTGGATGTG,128,2252664
marRp,0.6170212765957447,74,46,TTTAGGCCCTATTTAGGGCA,28,2225772
marRp,1.0,92,46,TTACCCGGGAGACTGAGCGG,46,2252289
marRp,0.1276595744680851,51,46,TCGCAGTCGTGCGCAGAGTG,5,2232806
marRp,0.574468085106383,72,46,GAACTTATGGCGACAGGTAG,26,2236467
marRp,1.0851063829787233,96,46,CTTCCTGGACCACTACGGAA,50,2240236
marRp,0.425531914893617,65,46,CTATAGGGCAGTTTAGTCTC,19,2218271
marRp,0.10638297872340426,50,46,CGGCTGCAGGGAATCAATCG,4,2231479
marRp,0.6170212765957447,74,46,CAGAACTGCCGCCCGTGGAG,28,2227926
marRp,0.1702127659574468,53,46,AGGTTTACCGCCTATTTAAT,7,2219435
marRp,0.23404255319148937,56,46,AATTTTTAGTGAAAGGTAAA,10,2228314
marRp,0.0851063829787234,49,46,AAACAAGTAAACGCAATAAG,3,2223036
marRp,0.08695652173913043,48,45,TGTCGGTTCCGTGCTTCGCA,3,2226692
marRp,0.717391304347826,77,45,TACACGTAAGGTCCTCTAGG,32,2251091
marRp,1.7173913043478262,123,45,GTGATTAACAACTCGTGGAT,78,2222659
marRp,0.8695652173913043,84,45,GGGATACTTTGGTCGTGTTT,39,2253316
marRp,1.6521739130434783,120,45,GGCGCGCCCTGGTGCATTGG,75,2228337
marRp,0.10869565217391304,49,45,CTTTAGTAGAATTAGGTTGA,4,2249628
marRp,0.6956521739130435,76,45,CGCCCGCAGTTGGGGGGTAA,31,2232411
marRp,0.34782608695652173,60,45,CCACCTGGAGTGGACCATCT,15,2218598
marRp,0.08695652173913043,48,45,CAAGGGACGCTTCGAAGGGT,3,2226073
marRp,0.6521739130434783,74,45,ATCTAGGAGTTGGCGAGCCA,29,2227128
marRp,0.45652173913043476,65,45,AATTAGCCTGCAGAGGTACT,20,2234646
marRp,1.0444444444444445,90,44,TTCGGTAGCGTCTGCCGACA,46,2222679
marRp,0.4666666666666667,64,44,TGTCCTTGATAGATCAGCGG,20,2241837
marRp,0.2222222222222222,53,44,TGTAATGTTCGAATCAGAAG,9,2219597
marRp,2.1333333333333333,139,44,GCGTCGATGGATGCGCCTTT,95,2219560
marRp,0.8888888888888888,83,44,GAAAGTAACGAATCCGAGCG,39,2252991
marRp,0.1111111111111111,48,44,CCGATTGGGCCTAAGTGATT,4,2219860
marRp,5.133333333333334,274,44,CAGTAGCCTCCCCGGTGCAA,230,2222852
marRp,0.7777777777777778,78,44,AGGTACAAACTAGAGCCTGA,34,2235351
marRp,0.4222222222222222,62,44,AAGGACTGGGCAGGACTACT,18,2232657
marRp,1.25,97,43,TTTGGAATAGCGCAATATGA,54,2225191
marRp,0.38636363636363635,59,43,TTCTTGGACTACCCTGTCTG,16,2247638
marRp,0.36363636363636365,58,43,TTACAATTCCCGAGGAACTA,15,2231032
marRp,0.045454545454545456,44,43,TGGCCATCACGCGTCTACGT,1,2260915
marRp,0.20454545454545456,51,43,TCACGGTGCCAGGGTAGTAG,8,2220289
marRp,1.0454545454545454,88,43,TAATTCTCGTTGATATGTTC,45,2230841
marRp,0.6136363636363636,69,43,CTTTCTTGTTTTCAGTCGTT,26,2252319
marRp,0.06818181818181818,45,43,CCGTACAGTGTAGCCATAGA,2,2220595
marRp,0.5454545454545454,66,43,CCCGTCTAACAAGCAGCAGT,23,2258249
marRp,0.29545454545454547,55,43,CATACCGCTCTTGTTCAGAA,12,2222719
marRp,16.227272727272727,756,43,ATGGTTCTTACATGGTTAGT,713,2237451
marRp,0.6363636363636364,70,43,ATCACGAAGTATGACTTCCT,27,2248052
marRp,2.1818181818181817,138,43,ACTGCACGGCACTGGGCTTA,95,2223455
marRp,0.06976744186046512,44,42,TTGGCTTCTTGCGACCTGGA,2,2219846
marRp,1.4186046511627908,102,42,TTCACAGCCGAATTTGGCTT,60,2225441
marRp,1.6744186046511629,113,42,GTTGTCAATTACCATCCGCT,71,2230894
marRp,0.5348837209302325,64,42,GTTCTAACAGGGGTCTGATA,22,2226199
marRp,0.20930232558139536,50,42,GTTACGCACCCAAGGTAGTT,8,2223766
marRp,0.5813953488372093,66,42,GGGTTTATTTCGATTGGCGC,24,2254789
marRp,1.7906976744186047,118,42,GACCGACCAAACCTGTCTTT,76,2221081
marRp,2.046511627906977,129,42,GAACATGCCTACTAGGTAAC,87,2218360
marRp,1.1627906976744187,91,42,CTTACGTGAGTCCTTTACTG,49,2240727
marRp,0.7674418604651163,74,42,CCATGGTTGCACCGGGAGTC,32,2227131
marRp,0.37209302325581395,57,42,ATTTATCCGGCATATGATTG,15,2232428
marRp,0.7674418604651163,74,42,ATCTCCTACCCACCATCGTA,32,2220703
marRp,1.930232558139535,124,42,AGTCAGTGACGATGTCGCGT,82,2218016
marRp,0.3023255813953488,54,42,AGATCAAAGCTCGGCGCGGA,12,2233268
marRp,1.1395348837209303,90,42,ACTGCGGTTCGAGGGGCCGA,48,2223798
marRp,0.16279069767441862,48,42,ACCGTTACTTGTGTAATATC,6,2235620
marRp,0.18604651162790697,49,42,AATCGAGTCAAGGAGGACAC,7,2242840
marRp,1.1904761904761905,90,41,TCGCCCTTCACTCCTCGTGC,49,2238546
marRp,0.16666666666666666,47,41,TCCACTTATGGTATTGGAAT,6,2229684
marRp,1.0,82,41,TATTATGCAACTCACGTTAG,41,2245395
marRp,0.5714285714285714,64,41,GGCACACAGTAGTGACAGAC,23,2260872
marRp,0.23809523809523808,50,41,GCGGGCCTAGCGGATAGGTG,9,2222712
marRp,0.6904761904761905,69,41,GCACTCATAGTAAACGGTAT,28,2219398
marRp,0.47619047619047616,60,41,GATCCTCGCTGGAGCCTCGT,19,2257136
marRp,0.8333333333333334,75,41,CTGACACTTGATACTTCTGG,34,2243068
marRp,0.11904761904761904,45,41,CGCCAGGACTCGGAGTGTAA,4,2250744
marRp,0.3333333333333333,54,41,ATACGATAATAAAGCTTAGA,13,2220277
marRp,0.047619047619047616,42,41,ACGATCGGGGATAGTGCCCA,1,2230643
marRp,0.8095238095238095,74,41,ACCGGGGACGCGGTGGGCCT,33,2246623
marRp,1.4523809523809523,101,41,ACCGATCAGCGTGAAGTCAT,60,2224535
marRp,0.2857142857142857,52,41,AAACTTCTTGATCTCTGGAG,11,2234577
marRp,0.5853658536585366,63,40,TCTCAATCTACTAGGATTTC,23,2228295
marRp,1.4634146341463414,99,40,TCGGTATACGCCCGCACCTA,59,2236589
marRp,0.43902439024390244,57,40,TCCGGACAGAAGGTACGACA,17,2228441
marRp,0.5609756097560976,62,40,TCAACGGACTGGCCAGGCCT,22,2249888
marRp,0.12195121951219512,44,40,TAGCAGAATAGAGCTTTGGC,4,2218217
marRp,0.12195121951219512,44,40,TACGGTAATAGAGTCCGGAT,4,2232691
marRp,1.3902439024390243,96,40,GTGGTTTAGGCAATCCCCCA,56,2227049
marRp,1.0975609756097562,84,40,GTACGCGACAGACTCGGCTA,44,2225338
marRp,0.8292682926829268,73,40,GGAAGTCCGGCGAGATACAG,33,2230534
marRp,0.21951219512195122,48,40,GGAAGCGGAGAATGGAGCCT,8,2226944
marRp,0.7560975609756098,70,40,GCTGGTTGAAATCGCGCGAC,30,2235437
marRp,0.8048780487804879,72,40,GCCTGTGCATAAAGGGCCAT,32,2222083
marRp,0.7317073170731707,69,40,CGGTAGAAACTTGGGACTCA,29,2227957
marRp,0.3902439024390244,55,40,CAGTTCAATGAGCTTGCCCT,15,2244129
marRp,0.8048780487804879,72,40,CAGCACTCTTAAAGAACGCG,32,2251131
marRp,2.4634146341463414,140,40,CAAAACATCGAAAGAGTGTA,100,2254447
marRp,0.7560975609756098,70,40,ATGGTTTGCCCCTGAACGCA,30,2260143
marRp,0.1951219512195122,47,40,ATATAGGAGCCGTAATGCAT,7,2239553
marRp,3.8536585365853657,197,40,ACTCGCGAACAACGCATCGA,157,2218827
marRp,0.7317073170731707,69,40,ACCTTGGGCTACGGTTTAGC,29,2222611
marRp,1.7073170731707317,109,40,ACCGTCGCTCGGTTCCCGCA,69,2220785
marRp,0.7560975609756098,70,40,ACCCGCTTGACCAAAGGATA,30,2250494
marRp,0.17073170731707318,46,40,ACATTCGTGGTAGGATCCAG,6,2226646
marRp,0.34146341463414637,53,40,AAAACGTGTACCTAAATTTG,13,2226696
marRp,0.85,72,39,TTCGGTCTCACCTCTACAGG,33,2238352
marRp,0.35,52,39,TTAACGATTAGCCTCAAGCC,13,2250849
marRp,0.125,43,39,TGCCATCGCATCAACTATTG,4,2223712
marRp,0.925,75,39,TCGGTGCAGATATTCGTCCG,36,2257807
marRp,1.4,94,39,TCCTGATACTCCGGATCCTC,55,2233061
marRp,0.475,57,39,TCCGTGGATTTCGTTTGCGC,18,2219848
marRp,0.4,54,39,TCAGATGTCACGTACGCGTA,15,2236181
marRp,0.175,45,39,TATGCGGAGCTTTCCGTTGA,6,2221395
marRp,2.675,145,39,GTGCATCTTGGGCACCATAG,106,2232760
marRp,1.6,102,39,GGACGAAGTTACGCTACCCT,63,2219101
marRp,0.375,53,39,GCTGAAGAAGTAGTTTCGAA,14,2258039
marRp,0.9,74,39,GCGACGTTCCCTTCGGCTCA,35,2258382
marRp,0.45,56,39,CTCTCCACCGGCGGTTTAAA,17,2246509
marRp,0.575,61,39,CTCGGTATAGCAGTTGTGAT,22,2241170
marRp,0.65,64,39,ATTGAGTGACTTTAAAGCAG,25,2238190
marRp,0.925,75,39,ATGTGCACCAGGGATACATT,36,2245297
marRp,0.25,48,39,ATAGTACACCGCGACTTTTG,9,2235432
marRp,1.9,114,39,AGGGGCCAAGAGGTTATGGT,75,2252032
marRp,0.05,40,39,AGCTAATGGGTTCAGCAAAA,1,2230873
marRp,0.475,57,39,AGCAATTTCCCCCTCCGAAC,18,2259715
marRp,2.625,143,39,ACCGGTTTTGAGCGTTTCAT,104,2246127
marRp,0.325,51,39,ACCGGCGCAACGGGGGACCT,12,2233885
marRp,0.4,54,39,AATTAGAAACTTGGTGCTAA,15,2259185
marRp,0.38461538461538464,52,38,TTTGCCGTGTAGAGGATTGA,14,2253108
marRp,0.07692307692307693,40,38,TTTCGTTAAGTAGTTCAGTT,2,2220448
marRp,5.6923076923076925,259,38,TCCATTAAAGTTTGCATTCA,221,2248238
marRp,0.5641025641025641,59,38,TATTACGATTGGGTGTTCTA,21,2221349
marRp,0.5897435897435898,60,38,GTTTTTTTGTCACCACGGCG,22,2226955
marRp,0.2564102564102564,47,38,GGCAAAGCACATGGCAAAGA,9,2242279
marRp,0.7692307692307693,67,38,GATTCAGGAGAAGCTTGATT,29,2228062
marRp,0.9487179487179487,74,38,GATTCAAGCCCGGCGTTGAT,36,2241974
marRp,27.666666666666668,1116,38,GACCGGCCTGTACCGTATGT,1078,2222759
marRp,0.3333333333333333,50,38,GAAACGCTGGAAGGGGGAGG,12,2243619
marRp,9.538461538461538,409,38,CTTCGTCAGTGGTATAAATA,371,2218988
marRp,0.2564102564102564,47,38,CTTCCATAATCCATACACTC,9,2258138
marRp,0.6153846153846154,61,38,CTGATACCTGTCCCTCCTAT,23,2237092
marRp,2.7435897435897436,144,38,CTGACATAGCGCCCGGTCTT,106,2225678
marRp,0.1282051282051282,42,38,CGTGTTAAGGAACCATTCCC,4,2237252
marRp,3.4358974358974357,171,38,CGGTCAGTATCAACATACGC,133,2255950
marRp,0.4358974358974359,54,38,CGGATGGAGGATCAGTGTCG,16,2239494
marRp,0.3333333333333333,50,38,CGGATAAATTATTCCCCATT,12,2258530
marRp,5.128205128205129,237,38,CGAGATTGCCAGGAAGGAGA,199,2220550
marRp,0.07692307692307693,40,38,CCGCTCAAGCTCACCAGGAG,2,2234149
marRp,0.46153846153846156,55,38,CCGCCGGCATCTGGACACGA,17,2258261
marRp,0.46153846153846156,55,38,CAAACTTTTATAACGAGGTT,17,2254314
marRp,0.7948717948717948,68,38,ATTTCTGGATTGTCTGCTTC,30,2258589
marRp,0.717948717948718,65,38,ATGGCGGAAGGATATCCGCA,27,2242894
marRp,0.6923076923076923,64,38,AGGCTCTTACGCCACGTTTT,26,2226263
marRp,1.1538461538461537,82,38,AGCGACTCAGCGCCGTTGAC,44,2257029
marRp,2.8461538461538463,148,38,AGCCTACAGCCAGTGTTACT,110,2218890
marRp,0.5641025641025641,59,38,ACGGCCTTCGCCCCAACCGT,21,2239120
marRp,0.2631578947368421,46,37,TTAAGAGCCACCAGGTCTGA,9,2239640
marRp,0.34210526315789475,49,37,TCCGCGTGGTTGTCGTTGAA,12,2255321
marRp,1.131578947368421,79,37,TCATGTACGACGTTAGAAGA,42,2222816
marRp,0.21052631578947367,44,37,TATAAATCGTAAGTTTGCGA,7,2228869
marRp,0.7105263157894737,63,37,GTGTAGTCCTCAAGTGACAC,26,2231478
marRp,2.6315789473684212,136,37,GTGCCACCGTATTCTGCGCG,99,2246162
marRp,0.47368421052631576,54,37,GTAAGCTCTAAGGATCCGTA,17,2253134
marRp,0.18421052631578946,43,37,GCGTCCTGATGGGAAAGGGA,6,2224207
marRp,0.42105263157894735,52,37,GCGCGATAAATGTCATCATT,15,2226108
marRp,0.23684210526315788,45,37,GCAAGCTCCTTATCCATGTC,8,2242362
marRp,0.21052631578947367,44,37,GAGTAAAACCTGTCAGTTTA,7,2233267
marRp,0.868421052631579,69,37,GAAATGAACCCTCAATGAGA,32,2245581
marRp,0.5,55,37,GAAAGGTAAGACGGTGATAA,18,2256443
marRp,0.9473684210526315,72,37,CGACAGATTGATGTTGGCAT,35,2244739
marRp,0.3157894736842105,48,37,CCGGCTTCAGTCTTATGGTA,11,2224205
marRp,1.0,74,37,ATAGCTTGAGTGATGGCGTG,37,2241767
marRp,0.7894736842105263,66,37,AGTTAAGAGCGTGCCTACAT,29,2221104
marRp,0.18421052631578946,43,37,AGTGATAGCTAGCAAACATA,6,2259036
marRp,0.631578947368421,60,37,AGACGGGGAAGGTATTCAAA,23,2257806
marRp,1.0263157894736843,75,37,AACTTTGAATATCCGCCGTT,38,2222604
marRp,0.24324324324324326,44,36,TTCAAAAAAGGGACTTACTG,8,2232081
marRp,1.2702702702702702,82,36,TGCCCCTAACGCTGATCTCC,46,2235902
marRp,0.24324324324324326,44,36,TCCGGACATACCCCCGTGAA,8,2250821
marRp,5.621621621621622,243,36,TATCAGATTAAAACACGATG,207,2219071
marRp,1.2972972972972974,83,36,TAGACGTGCCTATGTATGTG,47,2227134
marRp,1.2432432432432432,81,36,TACGGCCCCGTGGATTACTG,45,2226722
marRp,9.108108108108109,372,36,GGATCGCGACTAACATGTGT,336,2245977
marRp,0.972972972972973,71,36,GGAAAAAACACCGACATATT,35,2256023
marRp,0.13513513513513514,40,36,GCTAACGCATGGCAACTTGT,4,2235208
marRp,0.7567567567567568,63,36,GCGGATGGAATCCTACGTAT,27,2221504
marRp,0.5405405405405406,55,36,GATTAAGTGGCAATATTCAC,19,2226299
marRp,1.4324324324324325,88,36,GATGCAATCACAATTGATCA,52,2234007
marRp,0.5945945945945946,57,36,GATAGCCATGAAAGGTTGAT,21,2250226
marRp,3.6216216216216215,169,36,GAGACAATCAAAAAATCTGC,133,2242217
marRp,0.5945945945945946,57,36,GACTGGTCTGTCCTTTTATT,21,2260141
marRp,2.108108108108108,113,36,CTTACGCACGATAACATTTT,77,2220130
marRp,0.7297297297297297,62,36,CTGACCCGGGACTCATGTAT,26,2232340
marRp,0.8918918918918919,68,36,CTCTTACGGTCCGGTGTGAC,32,2237580
marRp,0.1891891891891892,42,36,ATTCTTGTTAGCGGATTGGT,6,2221390
marRp,0.24324324324324326,44,36,ATCAAGCTAGAGTCATTTTT,8,2233929
marRp,0.35135135135135137,48,36,AGGTTTATTGATACGGGATT,12,2251569
marRp,0.24324324324324326,44,36,AGAACCGTATATGATGGTTC,8,2234846
marRp,0.7297297297297297,62,36,ACGCTCAGGAAATCTTATGT,26,2238767
marRp,1.2162162162162162,80,36,ACATCTAAGGGTACCGGCAT,44,2240378
marRp,2.361111111111111,119,35,TTTGCATGCTGAGGAGGGAT,84,2222162
marRp,0.16666666666666666,40,35,TTTCGGTCAGTACTGTTTAC,5,2222463
marRp,0.1388888888888889,39,35,TTTACACGTGAAAGGGTAGA,4,2237025
marRp,1.1666666666666667,76,35,TGCGTCCATGACGCGGTGTA,41,2221655
marRp,0.3888888888888889,48,35,TGAGATCTGAGAAGGGCGCA,13,2231739
marRp,0.8333333333333334,64,35,TCATAGGGGGAGTATAATGA,29,2257804
marRp,0.9166666666666666,67,35,TCATAAGCATCTCGACCCTG,32,2231483
marRp,0.8888888888888888,66,35,TACGGCTTGTCCACCTCCAT,31,2226769
marRp,0.19444444444444445,41,35,GTGTACAGTGGTTGGGGCTT,6,2252344
marRp,3.9722222222222223,177,35,GGGCCTGCCAGCGCTTTGAA,142,2246013
marRp,0.4444444444444444,50,35,GGCTGTTTCGCCTTAGGATC,15,2246506
marRp,0.9166666666666666,67,35,GGCTCGCCAATAAATGCAGT,32,2238642
marRp,1.8333333333333333,100,35,GATATCTTTTGGAGGGCACT,65,2236549
marRp,1.0555555555555556,72,35,GAGTGGACTGGTTTACCATA,37,2227229
marRp,8.083333333333334,325,35,CTCTGCTGATTGGCGGTCTG,290,2227303
marRp,0.5,52,35,CCGGCATCAGTTGCGTCTGT,17,2227441
marRp,1.5277777777777777,89,35,CCGAGAAGCGCTTAAGGGTG,54,2221310
marRp,1.1666666666666667,76,35,CCCGAATCGTCATTGGAACG,41,2248032
marRp,2.0277777777777777,107,35,ATATTCGTAGTTTGCGCTAA,72,2249538
marRp,1.4722222222222223,87,35,ATAGCCTTGCAATGCCTAGC,52,2254328
marRp,3.6666666666666665,166,35,AGGTGTCATGTATAAATGTG,131,2233680
marRp,0.6944444444444444,59,35,AGACCCTCCTATACCTCTGT,24,2220407
marRp,0.8611111111111112,65,35,AGACAAATTAAAAGCGGGAA,30,2234147
marRp,0.5555555555555556,54,35,ACCGCCCCGGACAAGTTCCG,19,2241883
marRp,0.8611111111111112,65,35,ACCATGACTCTCGCGCATCC,30,2224214
marRp,1.3611111111111112,83,35,ACAGCATCCGTTGTACCGCG,48,2230955
marRp,0.1388888888888889,39,35,AACAGTCGCCATTCGTAATA,4,2248351
marRp,0.8857142857142857,64,34,TTGTCCTACCGGTTGCGACA,30,2242371
marRp,2.3142857142857145,114,34,TTGGTGTACGTGCCCCTCAG,80,2248477
marRp,0.42857142857142855,48,34,TCCAGTTTTGTAACATAGAT,14,2257151
marRp,1.1142857142857143,72,34,TCATCCGATGAGACGGCCAA,38,2237027
marRp,1.542857142857143,87,34,TCACGTAGGGAATGTTCGAA,53,2238727
marRp,0.2,40,34,TCAATATTCCGAGACCAAAA,6,2229673
marRp,0.6571428571428571,56,34,TATCCTCTGGTTGTCAGGAA,22,2251659
marRp,1.0,68,34,TATCACAGGGGGGTTGGTCA,34,2226074
marRp,1.0857142857142856,71,34,TAAAGTAAACCCTAACGGCT,37,2247326
marRp,1.8285714285714285,97,34,GTTGATTCAAAGCGCTCGTT,63,2253389
marRp,0.9428571428571428,66,34,GTCTCAACGATGGATATATA,32,2231295
marRp,0.14285714285714285,38,34,GTACGGATTTATCGCTAAAA,4,2229676
marRp,1.0857142857142856,71,34,GCCGGGGCTGCTCAGTCTAT,37,2234231
marRp,0.8285714285714286,62,34,GCATACCGGCTTTGTGGCTA,28,2221678
marRp,0.3142857142857143,44,34,GCAGAGCTCGCTCAGCTCAG,10,2234003
marRp,1.2571428571428571,77,34,GATTGTTAAAGCGACATGTA,43,2230328
marRp,1.1714285714285715,74,34,GAACCTGTCTATATTGAAAT,40,2233588
marRp,5.542857142857143,227,34,CTGTGCGGGGTCATGAACAA,193,2233963
marRp,0.9142857142857143,65,34,CTCAGATTTAGGTTCTCACT,31,2255322
marRp,1.5714285714285714,88,34,CGTCCATGCCCGACGGTTCG,54,2219822
marRp,0.6285714285714286,55,34,CGTAATTAGATTGTTTATGA,21,2244737
marRp,0.6571428571428571,56,34,CGCGTCATACAAGCATGCTC,22,2218111
marRp,0.45714285714285713,49,34,CCCTCATTGCCGCCTAGGGT,15,2221308
marRp,3.8285714285714287,167,34,CCATTTCATAATAGATAACG,133,2231182
marRp,0.45714285714285713,49,34,CCAGGCAATCGATCAACTGA,15,2236801
marRp,0.17142857142857143,39,34,CATCCGATCGTTGTTCCTCG,5,2246237
marRp,0.05714285714285714,35,34,CAGTTCTTGGAACGATGTCA,1,2221439
marRp,0.17142857142857143,39,34,CAGTGTTGTGATAAAAGCTT,5,2253812
marRp,16.428571428571427,608,34,CAGAGGGGAGACTTAGGCGA,574,2234984
marRp,0.5142857142857142,51,34,ATTGCAATGGTATTATTTGC,17,2229121
marRp,0.11428571428571428,37,34,ATTATGGCCTTCAACCGAGT,3,2243201
marRp,2.085714285714286,106,34,ATCTTCGGTCTATTATGGAT,72,2252365
marRp,0.08571428571428572,36,34,AGGGCGAGCACTAGGAGGGA,2,2230698
marRp,1.0571428571428572,70,34,AGGACTGTGTACATTAGGCC,36,2232262
marRp,0.8571428571428571,63,34,ACGGGGCCTGCTCGGACTGC,29,2222720
marRp,0.37142857142857144,46,34,AAGGACCAGAGTAGAGACTT,12,2256606
marRp,0.17142857142857143,39,34,AAGAAATCGTTCCTTTAACG,5,2256969
marRp,0.9142857142857143,65,34,AAGAAACATGAGAGCCTGGT,31,2260198
marRp,2.857142857142857,133,34,AACGAGTACCCGCATCAACA,99,2236659
marRp,1.1764705882352942,72,33,TTTCCGGTGGCATTATGATA,39,2245102
marRp,1.6176470588235294,87,33,TGGGGGTAGTGTATGCGTAC,54,2235768
marRp,2.1176470588235294,104,33,GTTATCGAAGCTTCGATCGA,71,2229465
marRp,0.5882352941176471,52,33,GTGGATAATGTGGTGCTAGC,19,2254243
marRp,1.0294117647058822,67,33,GTACGAATAACCGATGGCCT,34,2227173
marRp,0.20588235294117646,39,33,GTACCGGCTTGCTCACAGTC,6,2221386
marRp,1.3823529411764706,79,33,GGTCATATGTTGTCGGATCA,46,2252246
marRp,0.9117647058823529,63,33,GGCGTGCGGAACTTCCTCAG,30,2227695
marRp,0.20588235294117646,39,33,GGCGCTCGCCCACAGTAGAG,6,2232451
marRp,0.11764705882352941,36,33,GGAGACGTGTTGGAAATCGA,3,2228293
marRp,1.0,66,33,GCGTCAACTCTCTTCAAAGG,33,2236126
marRp,0.5,49,33,GAGTTTGGATCGTTACTTAG,16,2225832
marRp,0.29411764705882354,42,33,CTGAGTAAGCCCGGTCGCAT,9,2248033
marRp,0.5882352941176471,52,33,CTATGTTTCCCCTGCACTCG,19,2243919
marRp,6.617647058823529,257,33,CGCTTGAGGGTGTTGTACAT,224,2229636
marRp,0.5882352941176471,52,33,CCTAGAAAGATATGTATGCC,19,2227537
marRp,0.8235294117647058,60,33,CAGAGTGGTACAGTGTCAGA,27,2245620
marRp,0.23529411764705882,40,33,ATGCGCGTCTCTCTCTCCAT,7,2226978
marRp,0.4411764705882353,47,33,ATCAGGATGAAAGGGATGGG,14,2247949
marRp,0.14705882352941177,37,33,AGTGGTCAGTCTCGCAAGTA,4,2232105
marRp,5.588235294117647,222,33,AGTGAAGTTTCCGCACTAAG,189,2224735
marRp,0.08823529411764706,35,33,ACTGAAACAAGTCTAGTAAA,2,2258156
marRp,0.058823529411764705,34,33,ACTAGAAGAGTGTACTTAGG,1,2252481
marRp,0.7647058823529411,58,33,ACGCTTATCATATAATAGCT,25,2220781
marRp,0.11764705882352941,36,33,ACGCTCCCGGAGGGCGGGGT,3,2225945
marRp,3.7058823529411766,158,33,ACGAGCGCTTCGACGTTGCA,125,2229714
marRp,1.1470588235294117,71,33,AATCACCTTAAGTTCCGACA,38,2224094
marRp,0.08823529411764706,35,33,AACTGGGATGAGTCGCCCGA,2,2234871
marRp,1.2352941176470589,74,33,AAACGCTGTCCACCGTGGTT,41,2252199
marRp,1.2727272727272727,73,32,TTTTGTGACGACGCGAGTGC,41,2257105
marRp,0.18181818181818182,37,32,TTTATAGCTGAATAATGTAA,5,2254183
marRp,1.4545454545454546,79,32,TTGGCAGACCCCCTCAGGTA,47,2237793
marRp,0.48484848484848486,47,32,TTAGGACATGCCTCCAGTGA,15,2220480
marRp,8.272727272727273,304,32,TGTGGGTACAGTGAGCATAA,272,2235253
marRp,0.48484848484848486,47,32,TGTGAGGATTGGTCCTCGCA,15,2243948
marRp,0.8484848484848485,59,32,TCAATGGTGGATTGACTCTT,27,2249117
marRp,0.42424242424242425,45,32,TATTCTGTGGGTCTTGAGGG,13,2235029
marRp,0.6666666666666666,53,32,TATGTGGTATCCAACAGTCT,21,2260190
marRp,0.45454545454545453,46,32,GTACACTTGCTAAGCAACCA,14,2219502
marRp,0.8181818181818182,58,32,GCGCGTTGATAATAAAGACA,26,2248675
marRp,0.9393939393939394,62,32,GCGCCCCTAGGAACGATGTA,30,2225950
marRp,0.9090909090909091,61,32,GCCAGCCATACCTTGAAGTG,29,2245878
marRp,0.9696969696969697,63,32,GATCTTCTGAGGAACGTACG,31,2233016
marRp,0.06060606060606061,33,32,CTTGCCGTAGAGACCACATT,1,2221311
marRp,0.6363636363636364,52,32,CTGCCGGACGGATTCAGGTA,20,2230410
marRp,0.48484848484848486,47,32,CTCTTGTTGATGCCAACACA,15,2234805
marRp,3.9696969696969697,162,32,CTATGGAACCGATCATAAGT,130,2236830
marRp,0.18181818181818182,37,32,CCCATCTGAAGCTACCATGA,5,2218116
marRp,0.8787878787878788,60,32,CCACCTTGCGCGCCTATTCA,28,2230407
marRp,1.7272727272727273,88,32,CATGGTGTCAGATGAACGAG,56,2240133
marRp,0.2727272727272727,40,32,CAATACTTCATCGCGATAGG,8,2229522
marRp,7.090909090909091,265,32,CAAATAGAGGTCACATAGCT,233,2241595
marRp,0.2727272727272727,40,32,ATTTATGTGGACGCCCTTTG,8,2217990
marRp,4.787878787878788,189,32,ATTCCAAGAGGATCGTCCAA,157,2236648
marRp,0.7575757575757576,56,32,ATGATGCCTCTGTACACGAA,24,2223961
marRp,0.8787878787878788,60,32,ATCCCATATTCCCGGTTTGA,28,2244715
marRp,0.15151515151515152,36,32,ATAGCCCCTCGCGAATTTTA,4,2222484
marRp,0.7272727272727273,55,32,ATACTGAGTTCAGTCGGCTT,23,2226746
marRp,0.42424242424242425,45,32,ATACAGGCCTTTCCTAGTGT,13,2226305
marRp,1.121212121212121,68,32,AGGCGAACTCATCCCGAGAT,36,2242306
marRp,1.0606060606060606,66,32,AGCGGGGCCGCGTGGATCTT,34,2221438
marRp,0.5757575757575758,50,32,ACTTTAGCTGGCTGACCCCT,18,2242451
marRp,5.03030303030303,197,32,ACTGCAAGTCTTGACTGGAA,165,2223577
marRp,0.7878787878787878,57,32,ACTCTAATCTCTGTTTTATA,25,2244127
marRp,0.6060606060606061,51,32,ACGTCAGGGACTCATGTTAC,19,2230555
marRp,0.06060606060606061,33,32,AAGTAGGCTCAGGGACCTCA,1,2218237
marRp,5.09375,193,31,TTTGAACCTCGCGCGGTGTT,162,2223578
marRp,0.375,42,31,TTTATGGTCCGGCGCCTTCT,11,2237678
marRp,1.09375,65,31,TCGCGTTGCATCCCTTACCG,34,2227693
marRp,0.375,42,31,TCAGTGCTACAATATACTTT,11,2220954
marRp,0.4375,44,31,TACGCTGACTTAAGAGTACG,13,2220592
marRp,0.78125,55,31,GTTTTTGTACGGTGAGCGGA,24,2243630
marRp,0.5,46,31,GTTTCGCCCTAACCAAGGAA,15,2221446
marRp,0.9375,60,31,GTTGGATGTAGTCTACACAT,29,2223481
marRp,0.96875,61,31,GTGTAATCGCTTGTTATCGC,30,2234506
marRp,1.03125,63,31,GTGCGACGGTAGTCCATCAT,32,2238607
marRp,1.09375,65,31,GTCAACGAATTAGGCGAGCA,34,2236889
marRp,0.9375,60,31,GTAAGGTCCGCACATATCAT,29,2240950
marRp,0.25,38,31,GGTCAACGACGCTCTATGCG,7,2242134
marRp,0.21875,37,31,GGGCAGAACTTTGGTCGGCT,6,2237794
marRp,0.09375,33,31,GCGTGATACATAGGCCTGGA,2,2239167
marRp,2.53125,111,31,GCATGAGACGGCATCGGCCA,80,2254353
marRp,7.8125,280,31,GAAACAGCCCTATGGATAAT,249,2224051
marRp,1.65625,83,31,CTTGTTGTGATCAGGCTTGA,52,2245794
marRp,0.59375,49,31,CTTCGTGCCGGGTGGCAGCT,18,2220131
marRp,5.21875,197,31,CTGGGCTGACTCATAATCAA,166,2231071
marRp,1.5,78,31,CTGCCTTCCTGGCGTTCTTA,47,2250015
marRp,0.9375,60,31,CTAGCGTGTCCACTGGGCTT,29,2228545
marRp,3.65625,147,31,CGGTAACAGTAACTGCCCCA,116,2248471
marRp,1.1875,68,31,CCTGCACCGTGAACTGGTAG,37,2242090
marRp,0.3125,40,31,CCATCGGTGGGCGCTACTGA,9,2257075
marRp,2.21875,101,31,CATCGACAGGCGGACATCAG,70,2224739
marRp,1.4375,76,31,CACACCTTTGCTTATGTAAA,45,2249540
marRp,0.125,34,31,CAATGGAGATGCCGTTTCAT,3,2234642
marRp,0.4375,44,31,CAATCTGTTCTTCCCCAAAC,13,2220159
marRp,0.78125,55,31,CAAGGCGGGAATAAGTCTGA,24,2228816
marRp,9.625,338,31,CAACTTGTGGAGACTTGGAA,307,2218348
marRp,2.46875,109,31,ATTCATATACCTATGTCTAA,78,2230209
marRp,0.1875,36,31,ATTAAGACTCTCTTAAAAAG,5,2233412
marRp,1.53125,79,31,ATGAAGCATAGTCACGGCCC,48,2225947
marRp,3.28125,135,31,ATCAATTGTTCAGACTGCTT,104,2226591
marRp,0.28125,39,31,ACGCTAAACTGCTCGCCAAC,8,2256025
marRp,3.28125,135,31,ACAAAGTGCTTCTAATTGGC,104,2256688
marRp,1.09375,65,31,AAAACGTCAATTCACGTCTT,34,2234662
marRp,0.8387096774193549,55,30,TTTTATGATCTAATGGAAGT,25,2227780
marRp,0.5483870967741935,46,30,TTATTGTCTCGGTCCGGTCA,16,2223919
marRp,3.032258064516129,123,30,TTACTCCCTATTCCTGCGAT,93,2218749
marRp,1.032258064516129,61,30,TGTGTCATTGGTGCGCTCAC,31,2247674
marRp,1.032258064516129,61,30,TGTACTTACTTGTTTCATAA,31,2239402
marRp,0.5483870967741935,46,30,TGGGAGAAGGCCGGACGACA,16,2253797
marRp,0.3225806451612903,39,30,TCTGTTGTTTACAGTACAGT,9,2250746
marRp,0.7419354838709677,52,30,TCTCGGTACATAAATGATAT,22,2260511
marRp,2.3870967741935485,103,30,TCCGAAGACCGACATAATTT,73,2235446
marRp,0.7419354838709677,52,30,TCCCTCTTTATGGTCATTTT,22,2227796
marRp,0.22580645161290322,36,30,TCCAAACACGTTCTATCCCA,6,2242049
marRp,1.8387096774193548,86,30,TAGGCGTAGTCCCGGAGCTA,56,2219856
marRp,2.032258064516129,92,30,TACTGGTAGCCACTTTTTTT,62,2245773
marRp,0.3225806451612903,39,30,TACACTTGTTCAGAAGTTCT,9,2221226
marRp,0.41935483870967744,42,30,TAACTCAAATCTATTGTGTG,12,2246247
marRp,3.4516129032258065,136,30,GTGGAACAATTTGGCAGTTA,106,2247362
marRp,1.4516129032258065,74,30,GTCCACTTCCTTAAAACTGT,44,2259132
marRp,0.5483870967741935,46,30,GGGTGAGATTAACCGCCCTA,16,2254618
marRp,0.1935483870967742,35,30,GGAAAGCCTGTGTACCGGCG,5,2223347
marRp,0.16129032258064516,34,30,GACTTGGAATACCAGTTAAT,4,2232894
marRp,4.483870967741935,168,30,GAACGGTACTTGTAGTATTA,138,2223411
marRp,1.064516129032258,62,30,CTTCAAGATGGCACGCGAAC,32,2227372
marRp,1.1612903225806452,65,30,CTGCGTCAATTTGGGCTAGC,35,2227393
marRp,0.25806451612903225,37,30,CTGCGAGTCCCAGGAACTTA,7,2245938
marRp,0.41935483870967744,42,30,CTGATAGCTCAGCATGAAAT,12,2257939
marRp,0.45161290322580644,43,30,CTATCCGGGAGATGGACGAC,13,2232512
marRp,0.0967741935483871,32,30,CGTTCGAAAAATATTCTACA,2,2245160
marRp,1.096774193548387,63,30,CGTTATCCAGAGTGACGAAA,33,2244697
marRp,1.4838709677419355,75,30,CGCACGGCAGCTCGGGTTTA,45,2228317
marRp,0.12903225806451613,33,30,CCTGATTGGCTAAGGCCCGA,3,2251901
marRp,2.2903225806451615,100,30,CCCTTAGCACGCGCGCGACT,70,2253392
marRp,0.3225806451612903,39,30,CCACGATACGCTTCACCCAA,9,2219477
marRp,0.3870967741935484,41,30,CATCGATCGGCACATAGGGT,11,2259189
marRp,2.3548387096774195,102,30,CAGAGGTTTATCGAGATAGG,72,2256947
marRp,0.7419354838709677,52,30,CACGGAGGGGTGGCTGCAAA,22,2240044
marRp,2.806451612903226,116,30,CACAAATAGCGCCGCGGTTG,86,2257981
marRp,2.2580645161290325,99,30,CAATTTCATAGAGAAAACAA,69,2244924
marRp,0.3870967741935484,41,30,ATGTCGGGTCCACTAGGGTG,11,2228871
marRp,0.0967741935483871,32,30,ATACGGCGTCGGGCTCTTAG,2,2230062
marRp,0.7096774193548387,51,30,ATAACAGAACCTACCTCGAC,21,2241198
marRp,0.6774193548387096,50,30,AGTCAGCCCGATTATGCCGT,20,2257833
marRp,0.5161290322580645,45,30,AGCTTGTGTGCCTCACCTTT,15,2242896
marRp,2.193548387096774,97,30,AGATATACAGATGCGATACG,67,2226745
marRp,0.06451612903225806,31,30,AGAGGATGTCTGAGTCCGAT,1,2227369
marRp,0.0967741935483871,32,30,AGACGCTATTGCTAGATCTA,2,2222189
marRp,0.3870967741935484,41,30,ACGGAAACCCTCCTGACGTG,11,2224339
marRp,1.5483870967741935,77,30,ACGATAGTTCTCTTATTATC,47,2258021
marRp,1.7741935483870968,84,30,ACATGGATAAGACTGTACGA,54,2218008
marRp,0.41935483870967744,42,30,AATTATTTTTCAAAGCCCGA,12,2236072
marRp,1.2258064516129032,67,30,AATCTCTGCCCGACGGGATA,37,2238192
marRp,0.9032258064516129,57,30,AACAACGGAGGAATACGCTG,27,2225183
marRp,1.096774193548387,63,30,AAACGGATCTGATGCTCCGA,33,2256936
marRp,1.5,73,29,TTACACGACTATGCTGGCGA,44,2224092
marRp,0.3333333333333333,38,29,TGTTTAGTTTGGAGGACTGG,9,2253553
marRp,0.6,46,29,TGTGAACGTCCGGCACGGTG,17,2254651
marRp,0.3333333333333333,38,29,TGGTTATGCGCCGACAAATA,9,2230027
marRp,0.06666666666666667,30,29,TGGGATAGTTTTAGCATAAC,1,2224396
marRp,0.4,40,29,TGGGAGTATCTTCGATGAAG,11,2231889
marRp,0.5,43,29,TGGCCCGGACTTCCACATTG,14,2218600
marRp,0.5333333333333333,44,29,TGAACCAAGCTAGTCAGAGC,15,2245646
marRp,0.9333333333333333,56,29,TCTATTCCGTTCGCGGACAT,27,2238596
marRp,24.466666666666665,762,29,TCGCAGCATTGAATCGCACA,733,2220500
marRp,1.0333333333333334,59,29,TCCCAGGTGTATACGTGGAG,30,2242169
marRp,6.633333333333334,227,29,TCACCGACCAAGCAACGGAA,198,2235244
marRp,0.4,40,29,TAGGCAAGGAAGGTTTCCAT,11,2248676
marRp,0.9666666666666667,57,29,TAGAAAGAACCTAAAGAGCG,28,2226141
marRp,0.7666666666666667,51,29,TACTCTGGTACCGGTCCCGA,22,2221626
marRp,4.933333333333334,176,29,GTTAATCTACTCTTTTTATT,147,2237119
marRp,0.6333333333333333,47,29,GGTTAGATCCTCTGTTAAGA,18,2252993
marRp,1.0,58,29,GGATCGGCAATGTAGACGTG,29,2218644
marRp,0.3333333333333333,38,29,GCGCCTTGAGCCCTGTCTGT,9,2229758
marRp,0.8,52,29,GCCTCGCATAACCTGTTCCA,23,2233608
marRp,0.7333333333333333,50,29,GCCTCGATCAAGGGGGACCT,21,2245477
marRp,3.8,142,29,GAATTGCTCACTTACGCGGT,113,2233000
marRp,1.0,58,29,GAACTTCTGTTCAGTTAGAT,29,2232690
marRp,3.3666666666666667,129,29,CTCCTATATCGGGGGTCTCT,100,2231613
marRp,0.26666666666666666,36,29,CGGCGAGACAGCGAACGTTC,7,2218465
marRp,0.4666666666666667,42,29,CGAACAATAGGTACTAGAGA,13,2223479
marRp,5.866666666666666,204,29,CCAGCGAAAGAGGCCTGTGT,175,2240747
marRp,2.6333333333333333,107,29,CAGTATAACAAGCAGAACAT,78,2237152
marRp,0.4666666666666667,42,29,CACTTTAAGGGTGCGCCAAT,13,2247667
marRp,3.8,142,29,CACGACAGGATACTCATAAT,113,2253156
marRp,3.1,121,29,CAAGTTCTCCGTGGCGCATG,92,2259445
marRp,1.9,85,29,ATTGGGACCCCTTCTCCACT,56,2232550
marRp,0.3,37,29,ATTGCGGTATCCCACATACA,8,2229499
marRp,4.866666666666666,174,29,ATGCGACCGACGAGCCACCA,145,2248849
marRp,8.3,277,29,ATCGTTTACTCACTGTCCAC,248,2240793
marRp,0.5666666666666667,45,29,AGTGGTAAAAGCATCATGGT,16,2240668
marRp,0.36666666666666664,39,29,AGGCGAGTTTCTATGGCAGT,10,2246511
marRp,0.43333333333333335,41,29,AGAGGTACAATATACCCGTC,12,2238586
marRp,1.5666666666666667,75,29,ACCGCATCGAAGGCGGTTCA,46,2224361
marRp,4.366666666666666,159,29,ACAACGATAGCAAAGCCCGG,130,2238800
marRp,0.1,31,29,ACAAATCGGTAACGGTGCAG,2,2242723
marRp,0.36666666666666664,39,29,AAGTAGGCATTATTAATCCC,10,2260238
marRp,0.13333333333333333,32,29,AACTCACCGGGTAGACACGA,3,2240065
marRp,2.7241379310344827,106,28,TTTGATGTAAGGTTCGGCAG,78,2226606
marRp,9.758620689655173,310,28,TTGAAGCCATTCCTTGCGCA,282,2218987
marRp,0.10344827586206896,30,28,TGCCTTCAGGCACGTCTAGC,2,2257808
marRp,0.9310344827586207,54,28,TCTAAACACACAATGAATCC,26,2241480
marRp,2.103448275862069,88,28,TCCCCACGGCCCACGATTAC,60,2232654
marRp,0.8620689655172413,52,28,TCACAGCCACACGGGTAGCT,24,2252466
marRp,0.2413793103448276,34,28,TATATGAGGGCTACGCCATG,6,2240211
marRp,0.6896551724137931,47,28,TAAACTACTCTCTATGCGGC,19,2217978
marRp,0.9655172413793104,55,28,GTGGTATGTTCAGCCTAGTT,27,2250916
marRp,0.4827586206896552,41,28,GTGCTAACACTGACTTTGAC,13,2222121
marRp,0.7241379310344828,48,28,GTCTTATAAGGGACTTAACA,20,2255054
marRp,0.41379310344827586,39,28,GGGAATAGGAGCAACCGGTG,11,2253425
marRp,0.3448275862068966,37,28,GGCCCTGCATCTCTATGACC,9,2249886
marRp,1.0689655172413792,58,28,GATTCACAGGAGATTGCTCA,30,2218175
marRp,0.5172413793103449,42,28,GAGGCATCTGTTGGGGTTGT,14,2228395
marRp,1.0,56,28,GAGCGACGTTGGGTTGAATT,28,2250006
marRp,1.2758620689655173,64,28,CTTAGACTAGGGCCAATGCA,36,2236747
marRp,0.7241379310344828,48,28,CTGCAACGAGCCTGGGGGCA,20,2244740
marRp,0.8275862068965517,51,28,CTGAATAGATTCCCAACCCT,23,2249212
marRp,1.8620689655172413,81,28,CTATTGGAGGTGTTCTTGCA,53,2242721
marRp,1.5517241379310345,72,28,CGTATTGTCCAGCCTGTAAA,44,2236555
marRp,0.8275862068965517,51,28,CGGTCCTCGCTACGCAGCAT,23,2247507
marRp,3.896551724137931,140,28,CGGGTTCATCGTACTCCAGT,112,2256335
marRp,0.3448275862068966,37,28,CGGATTGCGCCGTTTAGTCT,9,2220005
marRp,0.6551724137931034,46,28,CGCTCAGTACTCATACATGG,18,2243212
marRp,0.3448275862068966,37,28,CCGTGCGGGTTCGCTCTCCG,9,2218110
marRp,3.6551724137931036,133,28,CCGGAGGTCGTCCGTCGCCT,105,2240748
marRp,1.4827586206896552,70,28,CCAACGTTGAGGTCCCTGGT,42,2248639
marRp,0.8620689655172413,52,28,CAGTTATCCATTTCAATCCA,24,2251428
marRp,0.9655172413793104,55,28,ATTGATGTGGTGGTAAAGGT,27,2243001
marRp,0.3793103448275862,38,28,ATAATCCCTAAGCCCATCAA,10,2222896
marRp,0.3793103448275862,38,28,AGGTTGATTCCATATTTTAG,10,2223876
marRp,0.4827586206896552,41,28,AGCGAGCGGGCATTAACCGG,13,2258344
marRp,2.310344827586207,94,28,AGCCGCCTTCACGTTATCAC,66,2248470
marRp,0.5172413793103449,42,28,AGCAGCCTATCCGTTAGTCA,14,2233783
marRp,1.6206896551724137,74,28,ACTAAGGGCTCTGAACATAC,46,2250809
marRp,3.7241379310344827,135,28,ACGGTAATAATATCGGGGCA,107,2234776
marRp,1.1379310344827587,60,28,ACCCAATCGCGGTCTAAGCT,32,2259958
marRp,2.6551724137931036,104,28,AATAACGCTCCGGACCTCCT,76,2250424
marRp,1.8275862068965518,80,28,AACGGCGACTGTAATAGGCA,52,2231405
marRp,0.10344827586206896,30,28,AAAAACGTGATTAATAGTTA,2,2220280
marRp,0.2857142857142857,34,27,TTTGGATCCGGGGCGACTAC,7,2229505
marRp,0.2857142857142857,34,27,TTTCAGGGGTAACGCAGAGG,7,2242654
marRp,0.8928571428571429,51,27,TTTACGCATCTAGCGGCCTT,24,2237845
marRp,11.178571428571429,339,27,TTGAAGAGCTGCGGACCTCG,312,2228633
marRp,0.5714285714285714,42,27,TTCGGGTGATAGATCAACTG,15,2256442
marRp,0.6785714285714286,45,27,TTCACTCGGTGTGCGAGTCT,18,2253760
marRp,0.39285714285714285,37,27,TGGGGCTACCCGCCCGAGGT,10,2227202
marRp,0.5714285714285714,42,27,TGGGGAGACACAGGCTTTCT,15,2239187
marRp,0.2857142857142857,34,27,TCTGGTGATTCGGCTTAAAA,7,2218981
marRp,0.8571428571428571,50,27,TCTGCCGCAAGTTTATTACA,23,2229599
marRp,4.821428571428571,161,27,TCCGTCTGGCGCCCAAATTG,134,2220215
marRp,0.35714285714285715,36,27,TCCGCCCGAGGTAGCCTCGA,9,2230264
marRp,1.8928571428571428,79,27,TAGATTTTTACTTGGGCAGT,52,2260363
marRp,0.17857142857142858,31,27,TAAGTGGACGATTGGTCGGG,4,2257944
marRp,0.8214285714285714,49,27,GTTGATTGTCGATTTGAGAA,22,2219510
marRp,1.2857142857142858,62,27,GTGATATGTGCACCGCATCA,35,2248620
marRp,1.9285714285714286,80,27,GTCTATGTTTCATAGTATGA,53,2236491
marRp,3.857142857142857,134,27,GTACTTTAGCTGATTTCGCT,107,2218625
marRp,0.7142857142857143,46,27,GGCATTTCCCTGGCGCCTCG,19,2258958
marRp,0.17857142857142858,31,27,GGAGTCATTACCCACGCATT,4,2231310
marRp,0.5,40,27,GCTTGCTTGACACTTTAGGA,13,2227677
marRp,0.39285714285714285,37,27,GCTCCGCCACAGCTCTGCTT,10,2247637
marRp,3.357142857142857,120,27,GCTCACAACATGTATGATGT,93,2221069
marRp,2.0,82,27,GCTACTTACAAAGCTTCCAG,55,2244624
marRp,1.4642857142857142,67,27,GCGTCGGAGGCAGGAGACAG,40,2246447
marRp,0.32142857142857145,35,27,GCAACTCCTTTAGCGACACT,8,2248748
marRp,1.3571428571428572,64,27,GATCGGTGCCGAGATTGAGG,37,2252900
marRp,16.642857142857142,492,27,GATCAGCAGACCTGGTGTAA,465,2248455
marRp,1.7142857142857142,74,27,GAGGCGCCCCTCTTATGCCT,47,2236765
marRp,0.32142857142857145,35,27,GACAGTCCAACACGCCAGCA,8,2240138
marRp,0.8571428571428571,50,27,CTTATAGTTATTAAAACTAT,23,2226286
marRp,1.2857142857142858,62,27,CTGGCTAGTTGCTGAAGTAT,35,2258508
marRp,0.32142857142857145,35,27,CTCGGCTAAGGACCAGGTAG,8,2247523
marRp,6.178571428571429,199,27,CGTGTAAACGCTAGCTCAAT,172,2225232
marRp,0.07142857142857142,28,27,CGAATCGTGGAGCCGTAAAT,1,2224876
marRp,0.39285714285714285,37,27,CCTGGCGGAACTCACTGTGA,10,2244889
marRp,0.10714285714285714,29,27,CCATGCTCCAAAGGCGAATA,2,2251275
marRp,9.071428571428571,280,27,CCACCGAGCCTTTCTCGTCG,253,2257568
marRp,2.4642857142857144,95,27,CAGCTTAGAACCGGGCTACG,68,2221684
marRp,0.9642857142857143,53,27,ATCGGGCGGAGGTTGGTCTT,26,2241792
marRp,0.6428571428571429,44,27,AGTCGATACGTCCCTCCGTT,17,2241159
marRp,0.6428571428571429,44,27,AGTATCAGTCAATGTATTGC,17,2244265
marRp,0.8928571428571429,51,27,AGGGTTCAGGACACACGAGG,24,2255063
marRp,0.21428571428571427,32,27,AGGACGGGAACGTCAAAGGT,5,2232596
marRp,0.14285714285714285,30,27,AGCGACCAGTTTATACTATT,3,2260144
marRp,0.21428571428571427,32,27,AGCAACGCACGCCGGTCCTA,5,2240135
marRp,1.0714285714285714,56,27,AGATTTCATTCGAGGATTGC,29,2228915
marRp,0.5714285714285714,42,27,ACTATTTCACCCTGCGTGCA,15,2224322
marRp,1.9285714285714286,80,27,ACCGCCAACTAGGCACCTAT,53,2242308
marRp,0.8214285714285714,49,27,ACCCGTTCAGTCACGGGGTG,22,2238692
marRp,0.14285714285714285,30,27,ACCAATGACAGGGATCACTA,3,2222682
marRp,1.75,75,27,ACACCGATGTACTTCACCCA,48,2224669
marRp,1.0714285714285714,56,27,AATCATGCGAACGACTTGCC,29,2230785
marRp,0.25,33,27,AAGTGGTGAGACCCGGCGTT,6,2253842
marRp,0.10714285714285714,29,27,AAGAGAGAGTGTGAGAGATT,2,2253285
marRp,4.357142857142857,148,27,AAGAATTCGCCAACAAATAA,121,2244406
marRp,1.4642857142857142,67,27,AACTGATGTTCAAGGGTCTG,40,2248756
marRp,0.14814814814814814,29,26,TTTTCAGTGGTTGGATTTGC,3,2249629
marRp,0.18518518518518517,30,26,TTGCCGCTGTGGTTCCAAGT,4,2218467
marRp,0.1111111111111111,28,26,TTCATTCATGATAGGCTCTG,2,2252856
marRp,1.9259259259259258,77,26,TTAAACCCGTCGGACGGTAT,51,2241207
marRp,1.0,52,26,TGTTTCACCAAAGATAGAGA,26,2254988
marRp,4.407407407407407,144,26,TGTAAAAACGTGGAACTGTG,118,2257326
marRp,1.4074074074074074,63,26,TGGTTTCGGACGGTGTTACA,37,2235025
marRp,1.3333333333333333,61,26,TGGAAATTTAACAGTTCCTG,35,2229241
marRp,0.8518518518518519,48,26,TGCTCGCACTATTACGCGGC,22,2258190
marRp,1.1481481481481481,56,26,TGCCGGCGCAATTAGCTGCT,30,2232842
marRp,0.7037037037037037,44,26,TGATTCTCGCTAGGGGCAGC,18,2228399
marRp,2.3333333333333335,88,26,TGATAGGCATGAGTAGAGGG,62,2249147
marRp,0.4074074074074074,36,26,TCGTGGGCGGGGACGCTTTA,10,2224281
marRp,0.5555555555555556,40,26,TCCTCACAAGGACCACATCA,14,2252557
marRp,0.07407407407407407,27,26,TAGGTACACCATCCGAGCAT,1,2222071
marRp,3.3703703703703702,116,26,TACCTGCCTGTTGTTTTATA,90,2222786
marRp,0.3333333333333333,34,26,GTTGCTTTATGTGGGATAAC,8,2231294
marRp,1.4074074074074074,63,26,GTCGCTTAATTCCGAACCCT,37,2251555
marRp,1.8148148148148149,74,26,GGTCGCTAGCCGGAGATCAT,48,2221936
marRp,0.5925925925925926,41,26,GGGTGCTAACTCGACACAAC,15,2219482
marRp,5.851851851851852,183,26,GGAGCACGGACACGATCAGG,157,2235325
marRp,3.6296296296296298,123,26,GCTTTGAAGCAGAGTTACTA,97,2224053
marRp,0.07407407407407407,27,26,GCATAGATAAAGGAATGAGG,1,2239869
marRp,0.7407407407407407,45,26,GAGAGAGTATGCCAAGACCC,19,2233126
marRp,0.3333333333333333,34,26,GACATGCACGCATCTAGTGT,8,2219599
marRp,0.4074074074074074,36,26,GAACAGTCCTGACCCAGCCG,10,2242135
marRp,0.37037037037037035,35,26,CTCGTGTTCGTAGCCTGCGT,9,2220591
marRp,0.48148148148148145,38,26,CTCCTAGGAACACTCGCGAA,12,2232468
marRp,0.48148148148148145,38,26,CTAGACCCTGCCTTAGATAC,12,2246298
marRp,7.444444444444445,226,26,CTACCATGCGCTGTAAACGC,200,2231865
marRp,2.185185185185185,84,26,CGTAAGACACGCGGTTGCAT,58,2223197
marRp,0.48148148148148145,38,26,CGGTGCGGCCCTTGACAGAT,12,2224097
marRp,8.185185185185185,246,26,CGATTGTTGCATGCGATATA,220,2252406
marRp,1.4814814814814814,65,26,CCCTACGGGGTTATCTCCTG,39,2242782
marRp,0.5925925925925926,41,26,CATGTAAAAGCCATAAGGTG,15,2258565
marRp,1.1111111111111112,55,26,CACTTTACGGATATCGCGCA,29,2248428
marRp,3.7777777777777777,127,26,CACGTTGGAATTTGGAAGCA,101,2257338
marRp,0.3333333333333333,34,26,ATGGGTTCTGCCAGATACGA,8,2233591
marRp,1.5555555555555556,67,26,ATGAGAAAGGACTGTTGAGT,41,2234037
marRp,0.07407407407407407,27,26,ATCCCCAAATTTGTGGGAGA,1,2239032
marRp,0.48148148148148145,38,26,ATCACCGGGTACTCTCGTTT,12,2244091
marRp,0.48148148148148145,38,26,ATATATTTGCTGTTAAGGGT,12,2219132
marRp,0.18518518518518517,30,26,ATAGAGAGGGGCGGCGACAC,4,2232043
marRp,0.8148148148148148,47,26,ATACACCTAGGAAATTCAGA,21,2247557
marRp,2.4074074074074074,90,26,AGGAGTGGGTTGAGGTGTCT,64,2243785
marRp,15.962962962962964,456,26,AGCAGAGACTACGGTTGCTA,430,2221870
marRp,1.1111111111111112,55,26,AGACCAGGAACAGGGTATTA,29,2218112
marRp,1.1851851851851851,57,26,ACTTTGCCTTCTCTACTGCC,31,2255943
marRp,4.074074074074074,135,26,ACTGACTGTAGCGCGTGAGA,109,2224244
marRp,0.25925925925925924,32,26,ACTCGGTTCCGTCGCGCGCT,6,2247436
marRp,10.666666666666666,313,26,ACGGTGGCAGGCGGGATTTT,287,2233228
marRp,2.3703703703703702,89,26,ACACATTGGCAGCTGGAGGA,63,2226530
marRp,0.15384615384615385,28,25,TTTTCTTTGCTACTGTACAG,3,2251365
marRp,1.7692307692307692,70,25,TTTATTTTGGACACCCCGGC,45,2234453
marRp,0.46153846153846156,36,25,TTACGGCTCTCCAATGGTGC,11,2235684
marRp,0.9615384615384616,49,25,TGTTTATCCGTTAATGCTCT,24,2220783
marRp,2.8461538461538463,98,25,TGAGATCTAAACAGATCCCG,73,2226737
marRp,0.15384615384615385,28,25,TCTCGTGTTGGATTCACCGA,3,2258944
marRp,5.230769230769231,160,25,TCGACTCTACCTAGCCCGGT,135,2221070
marRp,0.46153846153846156,36,25,TCCTAGTGTTTATTGTTGCA,11,2248794
marRp,0.6538461538461539,41,25,TCAGACAGTGATGAGGTTGT,16,2225917
marRp,1.3846153846153846,60,25,TATTGGTCTGCATTACAACC,35,2235486
marRp,23.5,635,25,TATACGGCGGGGCAGGCTTG,610,2234335
marRp,0.5,37,25,TACACCGTGACTCACCGCAT,12,2228550
marRp,0.6538461538461539,41,25,GTTGGTGACGCTTCTTGTCA,16,2232943
marRp,0.8461538461538461,46,25,GTTGCAGCGAAAGGGTCGCA,21,2242322
marRp,0.6538461538461539,41,25,GTGTGCACGCGGGAAGACAA,16,2220710
marRp,1.5,63,25,GTGTCGTGCCACCAAGGCCT,38,2233855
marRp,0.38461538461538464,34,25,GTGGCCCAGTCGGACTCTAA,9,2231567
marRp,0.5769230769230769,39,25,GTCGCTTTAAAAAGTCATTA,14,2241737
marRp,0.19230769230769232,29,25,GTACCGTGCGAGATTCGGTA,4,2226986
marRp,0.6538461538461539,41,25,GGTTATGAGAGTACACGGTG,16,2242258
marRp,1.1153846153846154,53,25,GGTGTGTCCATCCCGGCAAC,28,2218957
marRp,0.4230769230769231,35,25,GGTGAGCACGAACAGTCGCG,10,2235852
marRp,5.115384615384615,157,25,GGTAGAATTTTTTTTCGGTT,132,2248006
marRp,10.115384615384615,287,25,GGGTGGTTAACCGATAACTG,262,2247449
marRp,1.3076923076923077,58,25,GGAGTACATGTGATTGGGCG,33,2243034
marRp,0.3076923076923077,32,25,GGAACGCGACTGCCGGGTAT,7,2242734
marRp,0.9615384615384616,49,25,GGAACGATGAAATACGTGCT,24,2244089
marRp,0.6538461538461539,41,25,GCTGCTGCTATCAAAATATC,16,2224102
marRp,0.15384615384615385,28,25,GCGAGACAGTCGCACACTTA,3,2254011
marRp,1.0,50,25,GCCTGCGAACTAAAATTTAG,25,2246510
marRp,3.6923076923076925,120,25,GCCTCTACCGGTGAGACATA,95,2219559
marRp,0.6923076923076923,42,25,GCACTATTACCGCAGTCGAA,17,2224405
marRp,0.5,37,25,CTGGGCACTGGACTCGGAAG,12,2220927
marRp,0.07692307692307693,26,25,CGTAGTCGGGGAATCGAGGA,1,2241245
marRp,15.153846153846153,418,25,CGATCGACCCAGGCACCCGA,393,2222340
marRp,0.5769230769230769,39,25,CCGGGATTAACTTTTCTAAG,14,2241390
marRp,0.5384615384615384,38,25,CCATGTCCCAGAAGTTATTA,13,2239762
marRp,0.19230769230769232,29,25,CCAGGAAATTTGTCACTCCT,4,2228720
marRp,0.8076923076923077,45,25,CCACGCGCTGAGTGTTTCAG,20,2219434
marRp,0.5769230769230769,39,25,CATCCTCCTTAATCACTGAG,14,2241810
marRp,0.6923076923076923,42,25,CATCCATTGTGCGGGGCAGA,17,2253434
marRp,1.1538461538461537,54,25,CATAGGGTGGCCAGGCCGAA,29,2238336
marRp,0.3076923076923077,32,25,CAGGCAGTGCCCGATCTTGG,7,2219691
marRp,0.38461538461538464,34,25,CAGCATCGTGTTGGGCAGAT,9,2233059
marRp,0.38461538461538464,34,25,CAGAAGACTGGTCGGCCACT,9,2230563
marRp,0.5384615384615384,38,25,CAAGGTTTGCCCTATCCTGG,13,2231685
marRp,1.2307692307692308,56,25,CAAGGACGTTTTAGGGTATG,31,2225383
marRp,3.8846153846153846,125,25,CAAGCGCATTTGCAGAAGAA,100,2246803
marRp,1.7692307692307692,70,25,ATTAGGTCACTGAAACCCGG,45,2245739
marRp,0.5,37,25,ATCGGCCTCGTAAGTGGCGT,12,2254670
marRp,5.461538461538462,166,25,AGGCCGGTTGGTGAAACTCA,141,2224899
marRp,0.7692307692307693,44,25,AGCTTGTCAGTAATTACAAA,19,2223108
marRp,0.19230769230769232,29,25,AGATTGACGCGCACTAGAGC,4,2229176
marRp,0.46153846153846156,36,25,AGAGATTTTTATCGCAGGAT,11,2243238
marRp,1.6153846153846154,66,25,AGAAGTGACGGGTATGTCCA,41,2239352
marRp,4.653846153846154,145,25,ACGGGGCTCATAGCGGCGTA,120,2224732
marRp,0.34615384615384615,33,25,ACCTATCTAATAAGTTTAGT,8,2243483
marRp,0.9230769230769231,48,25,ACATAGGGAGTTTAAGGTGT,23,2222815
marRp,0.6923076923076923,42,25,AAGTGTTCGTAGCGCATTTG,17,2238086
marRp,1.2307692307692308,56,25,AAGGAGCAAATAAGATCACT,31,2239615
marRp,2.8076923076923075,97,25,AAGGAATAACTTATCATTGA,72,2246126
marRp,0.3076923076923077,32,25,AAAGTCCGTTGAGCTGGGAC,7,2225472
marRp,0.19230769230769232,29,25,AAAGTCCCGCGGCGCAAGAG,4,2253254
marRp,0.6153846153846154,40,25,AAAAGAGAACATCTGCACGA,15,2232955
marRp,0.32,31,24,TTTCAATCATTACTTGGAGT,7,2255365
marRp,4.72,141,24,TTCAGTATGTCGCAGTGATA,117,2231073
marRp,4.24,129,24,TTACTGCGTTGCTGAGCGTA,105,2218791
marRp,1.92,71,24,TTAAAAGAACAGTGTTAAGA,47,2252374
marRp,1.6,63,24,TGGGTTGTAGAAGGGTAGGA,39,2244314
marRp,0.08,25,24,TGGGTCATTAAGATCGCAAT,1,2254019
marRp,0.44,34,24,TGGATGTCCTGCTGGGGGGG,10,2229436
marRp,0.88,45,24,TGGACATATACAGCCTCGAC,21,2248753
marRp,0.92,46,24,TCTTCGCTCAACGGTCATTG,22,2223935
marRp,2.24,79,24,TCGTTCCAGATATTGGAACA,55,2248435
marRp,0.76,42,24,TCGGACAGAAGTGAACGTCG,18,2232969
marRp,1.36,57,24,TCGCCTTTCGGCAGGAAGAG,33,2222536
marRp,1.0,48,24,TCGAGGGTGAATCCGTTTGG,24,2227266
marRp,0.68,40,24,TCATCCTGCGTTCCGATACT,16,2223888
marRp,0.52,36,24,TCAGGGGCAGAGGTAACATA,12,2240487
marRp,1.64,64,24,TATTTCGCTCGGTATCAGTT,40,2233484
marRp,1.96,72,24,TATCTACCCCGGGTATGAAG,48,2228753
marRp,0.96,47,24,TAGGGGGACGACCCTATTAG,23,2246430
marRp,0.68,40,24,TAGCACATCGATTATCGCGA,16,2254661
marRp,2.36,82,24,TAAAGGCGCACGGGGAGGTA,58,2233062
marRp,0.24,29,24,TAAAGCTACCCAACAGGTTA,5,2252605
marRp,2.4,83,24,TAAACATTAGGTGCTAGGGA,59,2253657
marRp,0.32,31,24,GTTTACGGGCACGGCGCGGA,7,2260522
marRp,1.48,60,24,GTTGCCGGGATACCGCGTGA,36,2243841
marRp,2.08,75,24,GTGGGGCGGAAAGAGACGGT,51,2223469
marRp,2.2,78,24,GTCTGGCCGCTCCCATGGTC,54,2219262
marRp,0.76,42,24,GGTGCGTCGAGCTCGACAGT,18,2219078
marRp,4.4,133,24,GGTAGATGGCGAATCTAATG,109,2218504
marRp,5.52,161,24,GGGCTGAGCGGAACTTCGAA,137,2222227
marRp,6.72,191,24,GGGCAATGACAGTGTCTCTT,167,2224000
marRp,12.0,323,24,GGCGTGCATGACTAGCGCAT,299,2229825
marRp,0.24,29,24,GGCCGCTTGACCTATCTCAG,5,2237962
marRp,0.36,32,24,GCCGACGCCCTCTACACAAT,8,2232424
marRp,0.56,37,24,GCCACAAAGTCAACGCAGGT,13,2250026
marRp,0.44,34,24,GAGTATTTTCACGATGATAC,10,2249972
marRp,21.88,570,24,GAGGAGTGCCCCAGTAGATA,546,2227864
marRp,0.36,32,24,GAACAGAATTAATGGATGGT,8,2223873
marRp,0.2,28,24,CTGGCAGTCTGACAGCTCGG,4,2254743
marRp,9.44,259,24,CTCAGGATCGGCTTCACAGG,235,2218731
marRp,0.08,25,24,CTAGGTGTCGGAAAAGCGGG,1,2243522
marRp,4.72,141,24,CTAGGTGGAAAGGGATAACT,117,2222238
marRp,2.12,76,24,CGTTGTAAACAACACGGCGT,52,2236739
marRp,0.52,36,24,CGTTAGGTGACATTTTGCGT,12,2240136
marRp,1.72,66,24,CGTCTCAAGTTCGGCATGTC,42,2233203
marRp,0.92,46,24,CGCCCGGGCACTCTACAAGA,22,2229486
marRp,0.24,29,24,CGCATTCGGGGCCGATACCG,5,2260159
marRp,1.52,61,24,CGACCTGTAATTGCAACTAA,37,2239122
marRp,0.2,28,24,CCTTTCAAATCAAACCTTGA,4,2233704
marRp,2.32,81,24,CCGTTGTCCCCTCGAGTAAG,57,2248719
marRp,0.28,30,24,CCGTCAGTGCGCGCCAGCCC,6,2235584
marRp,1.12,51,24,CCGCCTTTCATCCGCTCTGT,27,2223102
marRp,1.64,64,24,CCATTAGGTGGGGGTCCGGT,40,2238505
marRp,2.52,86,24,CCAGTTCTACCGTTCAGTTT,62,2236561
marRp,2.0,73,24,CCAGGAACGACGGTGGGAAA,49,2254776
marRp,0.12,26,24,CCACGTAAGTAGTACATTTT,2,2247818
marRp,5.08,150,24,CAGAGATATAGGGTAACGAG,126,2222836
marRp,1.08,50,24,CACGGATAAATGCAAACTCC,26,2231021
marRp,0.08,25,24,CAATTCGTGAACTAAGGGAA,1,2222194
marRp,0.52,36,24,CAAAGTCAATATCGGGAGGT,12,2234383
marRp,1.0,48,24,ATTTACATCGGGTCACAACT,24,2218272
marRp,0.84,44,24,ATTCATTCGGAATTCGCGCA,20,2259425
marRp,1.52,61,24,ATGTTATTACCGTCATCTAG,37,2258481
marRp,0.8,43,24,ATGGCCCTGGTCTTATGGTA,19,2219395
marRp,9.08,250,24,ATGGCCAGACGTAGCAGAGG,226,2226237
marRp,0.48,35,24,ATCCACCCGTTGACGCCATT,11,2246066
marRp,1.16,52,24,ATAGAGGCAAAATGCCCCGA,28,2249728
marRp,0.8,43,24,AGTTTACTCCCTCGCGCCCA,19,2240198
marRp,0.72,41,24,AGCTGTCTCCACGAGGCTCT,17,2231113
marRp,1.04,49,24,AGCTGAGTAGCGCCCCAGTG,25,2239404
marRp,4.36,132,24,AGCGTGTCGATGATGCAATT,108,2237631
marRp,0.56,37,24,AGAGACATTCTTGGAGGCGT,13,2231325
marRp,0.88,45,24,ACGGCCTACCACGGATTCAA,21,2248326
marRp,0.08,25,24,ACCTTGACTCTTAGCCCTGC,1,2239873
marRp,1.28,55,24,ACCGGGCAACAGTGTACGAC,31,2220794
marRp,0.88,45,24,ACATGCTCCTGTGGCAAATC,21,2232592
marRp,0.24,29,24,ACACGCAAATTTCCGCCCCT,5,2246296
marRp,1.12,51,24,AAAACATGGTTAGACGGGCA,27,2243470
marRp,0.375,31,23,TTTGGGGTCCGGCGATGCGT,8,2226395
marRp,1.5416666666666667,59,23,TTTCTTCGTTATAGCCTAAA,36,2225336
marRp,1.75,64,23,TTCCCAACGATACTCGTCGT,41,2241690
marRp,0.5416666666666666,35,23,TTCAGCTGTACGGAAGCCAT,12,2260952
marRp,0.5416666666666666,35,23,TGTCCAGCCGAACATTAGAG,12,2228443
marRp,34.583333333333336,852,23,TGGCCTAAAGGATCGACTAG,829,2245683
marRp,0.5416666666666666,35,23,TGGAGTCTAAGGGTGCCTTT,12,2230959
marRp,1.0,46,23,TGCGCCTAGATACGGAGTGG,23,2224994
marRp,0.125,25,23,TGAGGCTATTTCGTTGTACA,2,2241252
marRp,1.2916666666666667,53,23,TGACACTGATTTAATGAACA,30,2237925
marRp,4.416666666666667,128,23,TCTGCAACAGTATAATTTTC,105,2256692
marRp,0.5833333333333334,36,23,TCGTTGTATAGAAGAGTTGA,13,2247676
marRp,8.25,220,23,TCATCATGGTCTCCTGGTCC,197,2218826
marRp,0.08333333333333333,24,23,TATTGGTTAACTTTGAGATA,1,2241340
marRp,0.08333333333333333,24,23,TATAGGCGATGAATATGGCC,1,2227958
marRp,1.875,67,23,TAGGTAGTTCCGGGATGATA,44,2218779
marRp,0.125,25,23,TACAGGAGCCGCGTTGAGTC,2,2219647
marRp,0.625,37,23,TAAGTTACCGCTAGTGATAA,14,2240777
marRp,5.458333333333333,153,23,TAAAGGTTCTGGTACTGACA,130,2227257
marRp,3.0833333333333335,96,23,GTTTGTCAGGTTGGCAGTCT,73,2219720
marRp,0.4583333333333333,33,23,GTGGTAGTTCCAGAAACACA,10,2229326
marRp,6.083333333333333,168,23,GGTTAGCACTCATCCTGAAT,145,2223427
marRp,0.20833333333333334,27,23,GGTCGTGATGCACTCGTTTT,4,2227169
marRp,3.125,97,23,GGGCATAGAATTTGCATCGT,74,2254387
marRp,0.625,37,23,GGGAAGACCGGAGTACTTAG,14,2221332
marRp,0.25,28,23,GGCAAGACAGACAGCCTGTA,5,2251007
marRp,0.2916666666666667,29,23,GCTGTCACAGGCGAAAAGCC,6,2230665
marRp,0.25,28,23,GCTCAGGTAGAAACTGACAC,5,2232313
marRp,18.5,466,23,GCGTTGTTTGTTTGAGTCCG,443,2240699
marRp,1.9583333333333333,69,23,GCGTGAAAACATGGAAGGCC,46,2255211
marRp,0.25,28,23,GCGCTGTGGCGCCTTTCCTG,5,2219855
marRp,1.5833333333333333,60,23,GCGCGGTCACGGTTCGGCGC,37,2251060
marRp,4.25,124,23,GCGAACGACGATAAATTGGA,101,2228689
marRp,0.6666666666666666,38,23,GCAGGATTCCTTCAGGTTCC,15,2230922
marRp,1.7916666666666667,65,23,GATTTGATCCAAAGGCTTTG,42,2234247
marRp,0.75,40,23,GATCTGCGCAGCAGTTTTAA,17,2258670
marRp,1.2083333333333333,51,23,GAGATTCAAGCTCCTTGCAG,28,2257736
marRp,1.25,52,23,GACTTAGTATGGCCCGCTAC,29,2243961
marRp,0.2916666666666667,29,23,GACCGCGCACCTATCGATAT,6,2232437
marRp,7.166666666666667,194,23,GACCGCGAGAAATGTTAGTT,171,2223068
marRp,0.5833333333333334,36,23,GAAGTCACTCAGTTTCCGGT,13,2226994
marRp,0.125,25,23,GAACGTTAGTTGCCATACTT,2,2218974
marRp,2.2083333333333335,75,23,GAAAAGGAGCAGGTTCGGCG,52,2227644
marRp,0.7083333333333334,39,23,CTTTGTAAGTCCGACTCAGG,16,2260256
marRp,0.5833333333333334,36,23,CTTTAATGCGTTACGCCAAC,13,2219753
marRp,0.7916666666666666,41,23,CTTGTATTGTGCGCTGCCGG,18,2224540
marRp,5.25,148,23,CTTCTGGCATCAGAAGAACT,125,2222791
marRp,0.5,34,23,CTTAATACTGTATTCAGCTG,11,2244751
marRp,0.08333333333333333,24,23,CTGACGGGTCCTCGACTAGG,1,2219501
marRp,0.875,43,23,CTATGCACCGCGGTATGTCA,20,2223003
marRp,0.9583333333333334,45,23,CTATCCCTTGTTCTGCTAAT,22,2241903
marRp,4.458333333333333,129,23,CTAAGTCCAGGCACCACTTG,106,2228079
marRp,3.0833333333333335,96,23,CGTTGCTGAATAGGGGAATT,73,2257193
marRp,1.1666666666666667,50,23,CGTCAGACGCGTCGGCGCCG,27,2243501
marRp,1.9583333333333333,69,23,CGGTCGGCCCCACAGTTCGA,46,2219687
marRp,3.9166666666666665,116,23,CGGACGATGCTAGGAGAACA,93,2255021
marRp,0.125,25,23,CGCCTTATGCCTCTGTTCAT,2,2244602
marRp,1.1666666666666667,50,23,CGCCGGTTCGGTAAGCCAAG,27,2227726
marRp,0.375,31,23,CCCAGACCAATACTAAACTT,8,2254919
marRp,0.375,31,23,CCACGTAGTGATCAACGTAG,8,2224969
marRp,1.0,46,23,CATTTAAGCGGTCCTCATGG,23,2236365
marRp,0.5,34,23,CATGGAGAATGGGATCGGTC,11,2244311
marRp,0.125,25,23,CATATCATGTCAAGTGACCA,2,2241360
marRp,1.4166666666666667,56,23,CAGTGATATTATTCCCGGGG,33,2224255
marRp,0.875,43,23,CAGCGATAGAGCTCTTCAGA,20,2220405
marRp,0.16666666666666666,26,23,CAGAGGGTAATAAGCTCTAG,3,2223496
marRp,0.5,34,23,CACTCGCAGTAGAAAAGCAG,11,2241572
marRp,0.4583333333333333,33,23,CACCTGCCTAGGCATCGTTG,10,2258047
marRp,0.2916666666666667,29,23,CAAGAGTGCTCGTTCAAATG,6,2248822
marRp,0.9166666666666666,44,23,CAACTGCCCATCTCACGAAG,21,2238200
marRp,2.0833333333333335,72,23,CAAAGTGATAAGCACAGAAT,49,2234946
marRp,0.08333333333333333,24,23,CAAAGTCAGGCATTCCATAT,1,2225976
marRp,0.8333333333333334,42,23,CAAAAAGAGCTTGCACTATG,19,2250808
marRp,0.875,43,23,ATTGCTGAAAACCCCCAAAC,20,2258371
marRp,2.75,88,23,ATTGCTCTTTGCTCTAAGCT,65,2226510
marRp,1.0,46,23,ATTAGTGCTAACACTACTGT,23,2258660
marRp,2.625,85,23,ATGTCTCAAACCCGGGCCAT,62,2226337
marRp,0.2916666666666667,29,23,ATCTGACCATGCTTAGCTTT,6,2224883
marRp,1.75,64,23,ATACGTGCAGACTGCGCGGA,41,2223198
marRp,0.16666666666666666,26,23,ATAAAGTTACCCTTAAAAAA,3,2224317
marRp,0.8333333333333334,42,23,AGTCGGGTAACCTGCTTGTT,19,2244088
marRp,2.0416666666666665,71,23,AGGCACGACGAATTTGCAAA,48,2236487
marRp,9.5,250,23,AGCAGACGAAGGTTGTGCCA,227,2245238
marRp,3.1666666666666665,98,23,AGAGCGGTATCGAGATTGCA,75,2222838
marRp,0.7083333333333334,39,23,AGAAAGTGTTTATCAACTAG,16,2234005
marRp,0.4583333333333333,33,23,ACCCGGCGTCCAACTTATGA,10,2246204
marRp,0.375,31,23,ACACGTAACCACGTACAAAA,8,2234797
marRp,1.125,49,23,AATTGTCTGCAATCGGATTT,26,2255477
marRp,2.875,91,23,AATCCAGGTAACAGGAGGAG,68,2243104
marRp,0.3333333333333333,30,23,AACTGCTTGGGGGCCATACA,7,2260780
marRp,0.16666666666666666,26,23,AACGCGGCGATTAGAGTAAT,3,2229198
marRp,2.0,70,23,AAATAGTGGGCTTCGACCCG,47,2222642
marRp,14.565217391304348,356,22,TTTCTCCCACTTGTAGTGTA,334,2221484
marRp,0.8695652173913043,41,22,TTCTTATATAGGGACAAAGT,19,2219513
marRp,2.0,67,22,TTCTCATCAGGAAACACGTC,45,2257240
marRp,0.6521739130434783,36,22,TTCGGGTGCGGAGCTTGTGT,14,2227126
marRp,0.2608695652173913,27,22,TTAACGTGAGCCACACTCTG,5,2258049
marRp,0.34782608695652173,29,22,TGTTAAGAAAACGGAATTTG,7,2254013
marRp,1.1304347826086956,47,22,TGTCGAGGCCTTTGGTCGTG,25,2242719
marRp,1.391304347826087,53,22,TGTCCATTACAATATGCAAT,31,2219478
marRp,4.260869565217392,119,22,TGTAGCTGCCAGTTCATAAA,97,2235299
marRp,1.0434782608695652,45,22,TGCACACCAGAGAGCCGATC,23,2219169
marRp,0.6086956521739131,35,22,TGAGCTGTCGTACCCATCTC,13,2224967
marRp,6.217391304347826,164,22,TCTTCACCCGAATTGGAGAT,142,2233381
marRp,0.30434782608695654,28,22,TCCTCATGATCGATATGACG,6,2220179
marRp,1.565217391304348,57,22,TCCCGCAGAGTGAGGCGAGA,35,2260471
marRp,2.6956521739130435,83,22,TCCCCCGTGTGTGAGGGGGT,61,2250156
marRp,0.6521739130434783,36,22,TCCCATGGCCGACTAATTAG,14,2249100
marRp,1.1304347826086956,47,22,TCAAATCGTTGAGACCAGAG,25,2255422
marRp,0.17391304347826086,25,22,TATCGGGGCGAGAGGACTAA,3,2242373
marRp,0.391304347826087,30,22,TATCCTGAAATAAGCAGTCA,8,2254208
marRp,0.08695652173913043,23,22,TAGGAGGACACTCCTTACGT,1,2253284
marRp,1.2173913043478262,49,22,TAGCATAATCCATGTTAGAT,27,2247130
marRp,0.21739130434782608,26,22,TACTGCCTCTACAAGGATCA,4,2258485
marRp,7.434782608695652,192,22,TACTAGAATAACCGTAGGCC,170,2234988
marRp,0.9130434782608695,42,22,TAATGACGTGAAATCACTGT,20,2228579
marRp,0.13043478260869565,24,22,GTCGCTCACTGACTACCGCT,2,2238478
marRp,0.21739130434782608,26,22,GTCGATAACCGTTTGTGACT,4,2221713
marRp,4.3478260869565215,121,22,GTAGTGCCTTGTTGCAAATA,99,2256777
marRp,3.130434782608696,93,22,GTAACACACGGTCCCGATAG,71,2236769
marRp,0.17391304347826086,25,22,GGTAGTGACCACCTAGGGAA,3,2218758
marRp,1.5217391304347827,56,22,GGTACTTTGCTGGTACTTAC,34,2221968
marRp,23.26086956521739,556,22,GGTACTATCTTCCTCGACCC,534,2230370
marRp,1.3043478260869565,51,22,GGCTGGTAGTTACCGTAAAA,29,2260909
marRp,0.2608695652173913,27,22,GGCCAGGGTCCCATTCTGAG,5,2247351
marRp,0.17391304347826086,25,22,GGAATGGCTGGATGAGGTAA,3,2225562
marRp,0.8260869565217391,40,22,GGAAAGCGGGTTACTCGTGG,18,2226200
marRp,5.173913043478261,140,22,GCGGTATAGATACGTCAAAG,118,2227071
marRp,1.434782608695652,54,22,GCGCCCTCCTTCCGCATGTT,32,2226075
marRp,0.08695652173913043,23,22,GCCTATCTATGCTCATGCTT,1,2223339
marRp,3.869565217391304,110,22,GCCCGATATTTCATTTCCTT,88,2226590
marRp,0.4782608695652174,32,22,GACGCGTGACTTACCCCTCA,10,2232479
marRp,0.391304347826087,30,22,GACACTAATTGGCGCGTTGC,8,2250246
marRp,0.30434782608695654,28,22,GACACAAGGAGCGCAGGGGT,6,2258509
marRp,14.304347826086957,350,22,CTTAGGTGATCGTTCAGTTA,328,2232728
marRp,1.6521739130434783,59,22,CTGTAAACATATGGCTACCT,37,2244054
marRp,0.2608695652173913,27,22,CTCTGGCGTCCGGGGATGGG,5,2244046
marRp,0.5217391304347826,33,22,CTCCCCAGACCGCGGTTTGC,11,2224168
marRp,0.6521739130434783,36,22,CTAAACAGACGAGAATGCCA,14,2225882
marRp,0.7391304347826086,38,22,CGTCAGGTGACGTTAGCTCA,16,2253133
marRp,1.391304347826087,53,22,CGGGTGTACAAAGTGGTGGA,31,2223606
marRp,1.2173913043478262,49,22,CGGGATGGACTGCCTCTGAT,27,2234884
marRp,10.217391304347826,256,22,CGGCCAAGGAAGGGTTTTGT,234,2225329
marRp,0.2608695652173913,27,22,CGGACAGCTACACGTCGTAT,5,2231712
marRp,0.5217391304347826,33,22,CGAACCCTCCGCATCTCAAG,11,2226477
marRp,0.6956521739130435,37,22,CCTTACCAGCTAAGGTAGGC,15,2235739
marRp,14.08695652173913,345,22,CCTTAACAATTTGCTGCAGA,323,2221000
marRp,1.4782608695652173,55,22,CCGTAGCGACACCAGGTGGC,33,2231611
marRp,0.782608695652174,39,22,CCGGCTGACGGGCTGCCACG,17,2231017
marRp,0.6086956521739131,35,22,CCGACCATGGCGGTTAGGGG,13,2249073
marRp,0.2608695652173913,27,22,CCATGACTCATCATGAATCA,5,2241894
marRp,8.782608695652174,223,22,CCATCCGTCCATTAAACTAA,201,2220201
marRp,2.5652173913043477,80,22,CATGCCAGGTGGTATTCACT,58,2242191
marRp,1.1304347826086956,47,22,CATGAGCATCCGGGCAGCCT,25,2224023
marRp,1.7826086956521738,62,22,CACCCGGCCTCAGTATCCAT,40,2238324
marRp,0.30434782608695654,28,22,CACACCGGGAGCAGGGTCTC,6,2243569
marRp,0.13043478260869565,24,22,CAAGTATACGGCCGGTCATG,2,2256541
marRp,0.5652173913043478,34,22,CAAAATTACATGAAAAGAGC,12,2239503
marRp,1.3478260869565217,52,22,ATTTCTAGGTCATCAGTGTT,30,2246930
marRp,1.3478260869565217,52,22,ATTTCCGCGGGGGGCATGAT,30,2228008
marRp,0.4782608695652174,32,22,ATTTATATGTTCCCAGAGAT,10,2260381
marRp,0.6956521739130435,37,22,ATGTGAGTCGCGTCATTGGT,15,2229765
marRp,1.5217391304347827,56,22,ATGCTATCCTGGTCATGCGT,34,2221165
marRp,1.9565217391304348,66,22,ATGATGGGGCCAAGTATCAG,44,2252998
marRp,0.21739130434782608,26,22,ATAGCGGCGATCGAGTACAC,4,2222371
marRp,2.0,67,22,AGTATGAAGGACACCCGTGG,45,2222585
marRp,1.5217391304347827,56,22,AGTAAGATGTTTAAACGATT,34,2252901
marRp,0.9130434782608695,42,22,AGGTATGAGGAGCAAATTAC,20,2244222
marRp,0.4782608695652174,32,22,AGGGGCTACACCGATCAAAA,10,2259320
marRp,0.782608695652174,39,22,AGGCGACACCAATTATATCT,17,2228342
marRp,1.826086956521739,63,22,AGGCCTTTACATCCGAACTC,41,2254895
marRp,1.0,44,22,AGGCCAGGGCACGAAAGCTT,22,2237056
marRp,1.4782608695652173,55,22,AGCGTTCAGTTTTTGCTAAG,33,2250630
marRp,1.6521739130434783,59,22,AGCGATGCATTGAATGAAGT,37,2237692
marRp,0.43478260869565216,31,22,AGATACTAGCAAGTGGCCGA,9,2224401
marRp,0.17391304347826086,25,22,AGACATAAGGTCTAGCTACT,3,2254694
marRp,0.6086956521739131,35,22,AGAAGGGGCTTGGCTCGAAT,13,2233785
marRp,4.913043478260869,134,22,ACTTTTAAGTCTGAATAGTC,112,2233462
marRp,0.34782608695652173,29,22,ACTTACATGGAACTAAAGTC,7,2221051
marRp,0.7391304347826086,38,22,ACGTCCTCACACCAGGCTGA,16,2234868
marRp,0.9565217391304348,43,22,ACCGCTTATAGCCCACCCCG,21,2255680
marRp,0.08695652173913043,23,22,ACCCGTTAATTGTAGTGCTT,1,2225878
marRp,0.5652173913043478,34,22,ACCCCGGATCTTCGGTCCAG,12,2244696
marRp,2.217391304347826,72,22,ACCCACGGGAGACCGGTGGT,50,2256393
marRp,1.6956521739130435,60,22,ACAGTAGATCACGTGGGTAC,38,2229103
marRp,5.6521739130434785,151,22,ACACGTCCACCATTCCGCCA,129,2244850
marRp,0.8695652173913043,41,22,ACAATGATTTTAATATCCTT,19,2226011
marRp,1.7391304347826086,61,22,AATCGCCACAAAATTCACCA,39,2218315
marRp,0.6521739130434783,36,22,AAGTGCTAATGAACGGTCCG,14,2222605
marRp,3.5454545454545454,98,21,TTTCTAGATTGGAGACCTAG,77,2237532
marRp,1.0,42,21,TTGGGTAACCATACAGTTAT,21,2245501
marRp,4.318181818181818,115,21,TTGGATATCCCGTAATTCTC,94,2240794
marRp,3.0,86,21,TTGATGATCTCTGTACCGAT,65,2252044
marRp,0.5,31,21,TTCGTGCTTCGCAAAACTTT,10,2225676
marRp,0.9090909090909091,40,21,TTCACTCTGGCAATAGTGCT,19,2231262
marRp,1.9090909090909092,62,21,TTCAACGACCTAGCCTGGAT,41,2246574
marRp,0.2727272727272727,26,21,TTAGCAGCGTGAGGGATTAC,5,2246770
marRp,0.22727272727272727,25,21,TTACCCCTGACTCTAATGTG,4,2227744
marRp,4.7727272727272725,125,21,TGTTCGGTAAGTCAACCAAT,104,2241947
marRp,0.5454545454545454,32,21,TGTGTGGTGCTGTGGTTTCT,11,2255501
marRp,1.0,42,21,TGTGGTGGAAGCCCAGGAAT,21,2258088
marRp,0.13636363636363635,23,21,TGTAAACGGATTCAATCTGT,2,2246297
marRp,0.8636363636363636,39,21,TGGGAATGACTGTCTTTGCA,18,2227892
marRp,10.727272727272727,256,21,TGCGGTGGCTCTCTATACTT,235,2247109
marRp,0.22727272727272727,25,21,TGCATTATTGAGCCGCATCC,4,2234808
marRp,0.5909090909090909,33,21,TGATCGCAGAGGGATCAATA,12,2233598
marRp,3.590909090909091,99,21,TGACACATAATGAACAGTAG,78,2230317
marRp,0.5,31,21,TCTTGGTCCACAAGAATATA,10,2221351
marRp,0.9545454545454546,41,21,TCTCGGGGCGGGCCGTCGAT,20,2221034
marRp,0.13636363636363635,23,21,TCGTTTAGAAGCGCGTTAGG,2,2230078
marRp,0.45454545454545453,30,21,TCATTTAGCGCAGTAGTCTT,9,2226388
marRp,1.3181818181818181,49,21,TCAACCATTACCGGTAGCTT,28,2236496
marRp,0.5909090909090909,33,21,TCAAACACACAGAGACTGTG,12,2234722
marRp,0.4090909090909091,29,21,TACTCGCTGGCAATACTGGT,8,2233328
marRp,1.0454545454545454,43,21,TACTAGAGTCCTTATCACCG,22,2221174
marRp,0.2727272727272727,26,21,TACCTTTTCGGATGATAGTT,5,2244106
marRp,4.2727272727272725,114,21,TACCCCCCCTCTTGACCGGA,93,2227290
marRp,1.5454545454545454,54,21,TAATCAATCGTGATCTACGA,33,2229473
marRp,0.8636363636363636,39,21,GTTTAAGTGATTTAGGTCGT,18,2254544
marRp,0.4090909090909091,29,21,GTGTTGCACCAACCGACCCT,8,2239121
marRp,1.5454545454545454,54,21,GTGGAGCTCCGTAGGCTAGT,33,2256847
marRp,0.5909090909090909,33,21,GGCTGTCGGATTACTAAGAC,12,2227165
marRp,0.6818181818181818,35,21,GGCTCATATAATCGTAATAT,14,2224316
marRp,0.36363636363636365,28,21,GGCTAGGGTGGGCGGCATGG,7,2241208
marRp,1.0,42,21,GGCCAGGGCTCTCCATCTGA,21,2245587
marRp,1.2727272727272727,48,21,GCTGATGTACGGGCCTGCGC,27,2233668
marRp,0.8181818181818182,38,21,GCTCAAATAGTAGTTCGGCC,17,2253754
marRp,1.0,42,21,GCGTGCACTCGGCGACTGGT,21,2249046
marRp,0.36363636363636365,28,21,GCGCGGTGGTCCCTGAGAAT,7,2240347
marRp,7.909090909090909,194,21,GCGAGGAGACATCACCTCAA,173,2244553
marRp,1.0,42,21,GCGAGAGTTGGGCTCCGCCT,21,2242280
marRp,0.36363636363636365,28,21,GCCGGGGTTGGACCCCCTAA,7,2248275
marRp,0.22727272727272727,25,21,GCCCTCGATTGATTTCTTAC,4,2242574
marRp,0.9090909090909091,40,21,GCACTGCGCCTGTGCGTTTA,19,2250801
marRp,0.6363636363636364,34,21,GCAAGGGCATGCAGTATAAT,13,2244161
marRp,0.8181818181818182,38,21,GATTGATTCTAACAAACACA,17,2219293
marRp,0.6363636363636364,34,21,GATTAAGGATTCCCCTCTCG,13,2250638
marRp,2.727272727272727,80,21,GAGGTTAAGTGGCTGTAGAG,59,2259280
marRp,7.818181818181818,192,21,GAGCACCACCGCTTGGGTTA,171,2232132
marRp,1.1363636363636365,45,21,GAATGCTGACCACGAATTAA,24,2226977
marRp,0.5,31,21,CTTTGAACAAAGCGAAGCCT,10,2253549
marRp,0.13636363636363635,23,21,CTGCATGAAGGGAGCTGGCA,2,2249607
marRp,1.2272727272727273,47,21,CTCGAGAGCTATGGAAGCCT,26,2227161
marRp,0.3181818181818182,27,21,CTAGCAGGTTGTTGTGAATA,6,2245926
marRp,0.09090909090909091,22,21,CGTTGCAGGCCAACATATTT,1,2235976
marRp,0.9090909090909091,40,21,CGTTAAGGCCTGCGAAAATG,19,2242120
marRp,0.3181818181818182,27,21,CGTAGGCCGGGCGCGCCATA,6,2250601
marRp,0.7272727272727273,36,21,CGGTGCACGGTCACACGATT,15,2231577
marRp,0.45454545454545453,30,21,CGGGTTCTATTTGAAGAAGG,9,2230136
marRp,0.09090909090909091,22,21,CGGGCGCCCGGGACATTTTT,1,2242112
marRp,1.5454545454545454,54,21,CGGCGAGGCGAAAGTACATT,33,2231571
marRp,0.3181818181818182,27,21,CGGAGTCGGACTCAATTTTA,6,2219504
marRp,4.136363636363637,111,21,CGCGTTAATATCGTTAAGAG,90,2223443
marRp,4.136363636363637,111,21,CGAGGAGCAACTATATAGAT,90,2224027
marRp,1.0454545454545454,43,21,CGAATGTTTCCTCGAGTCGG,22,2232527
marRp,1.1363636363636365,45,21,CCTGGGCCGGTGGCATAATT,24,2227581
marRp,0.13636363636363635,23,21,CCTGAAAAATGCTCGACCAA,2,2251859
marRp,0.8181818181818182,38,21,CCGTTATGCAGAGCAAAGGT,17,2233636
marRp,3.0,86,21,CCCGCGGGTTCTCGCTGAAC,65,2233969
marRp,4.590909090909091,121,21,CCCCGCCACGATCTGGTCTG,100,2240692
marRp,0.5909090909090909,33,21,CCCATCGGCGGTTTGTCAGT,12,2245614
marRp,1.3636363636363635,50,21,CCCAGGTACTTGGTTGGCTT,29,2221359
marRp,0.8181818181818182,38,21,CCATAACAGTGAAAGATCCG,17,2251267
marRp,1.6363636363636365,56,21,CAGGTTACAGGCGACAAGCA,35,2252633
marRp,0.9545454545454546,41,21,CAGGGTCACCCACTCCGTGT,20,2223182
marRp,2.272727272727273,70,21,CAATGTAAGGGTCATCACGA,49,2230316
marRp,0.6818181818181818,35,21,CAATGAGTTAAGTGTCATCA,14,2225916
marRp,12.409090909090908,293,21,ATTGCGTGGGAAACTTCACT,272,2241534
marRp,2.4545454545454546,74,21,ATGGACGCTGGGGTTTGTAA,53,2255201
marRp,3.0,86,21,ATGAAAGTACCTGCCCTCTA,65,2222957
marRp,0.8181818181818182,38,21,ATCGTGTGTGGGGTCCGTAT,17,2237091
marRp,0.5909090909090909,33,21,ATACCGCGGCTCGCGGCGCA,12,2251983
marRp,0.5,31,21,AGTTCATAAGACCAGGGCGA,10,2229353
marRp,0.09090909090909091,22,21,AGAGATCCATTAAAGAATGA,1,2227547
marRp,2.0454545454545454,65,21,AGACGCAGCGTCTATCAAGA,44,2233039
marRp,1.7272727272727273,58,21,AGAACGCACTTCCTAGATGT,37,2248754
marRp,1.0454545454545454,43,21,ACGGTGTGATCGGCTATAAA,22,2242174
marRp,1.2727272727272727,48,21,ACCAGAGTCACGATTTTTAC,27,2251820
marRp,1.0454545454545454,43,21,ACAGCCCGTACAGTCTGACC,22,2242645
marRp,4.2272727272727275,113,21,ACACAAATTAATACGTCGGA,92,2224903
marRp,1.6818181818181819,57,21,AATATCTTATCTATCTCAGG,36,2239114
marRp,1.2727272727272727,48,21,AAGTCTCGAGTGGTTTTACA,27,2223962
marRp,23.636363636363637,540,21,AAGGTATGGGCGGACCAGGT,519,2221536
marRp,0.6818181818181818,35,21,AAGACACTACAGCCTCGTTG,14,2227418
marRp,0.6666666666666666,33,20,TTTCCTGGGAGCGCCCCATA,13,2227230
marRp,0.23809523809523808,24,20,TTTATAAGATGATCCCAACT,4,2227964
marRp,0.09523809523809523,21,20,TTCTTTGCAAGTTCGACCGA,1,2237981
marRp,1.3333333333333333,47,20,TTCTTATGCGTGTCACCAGA,27,2250758
marRp,6.285714285714286,151,20,TGTGGTTGAACCCGAACTCA,131,2253489
marRp,1.380952380952381,48,20,TGTACTATGTCTTCGCGCGG,28,2233491
marRp,0.7619047619047619,35,20,TGGGTAAGCTTACCCGTTCA,15,2242581
marRp,1.9047619047619047,59,20,TGGGGAGAGGTCCCTCTGGG,39,2246167
marRp,0.23809523809523808,24,20,TGACGTCGGTACGTTAGAAA,4,2233633
marRp,1.3333333333333333,47,20,TGAACGTCCTGCGCGATGGT,27,2234386
marRp,0.14285714285714285,22,20,TCTGTGTCGCGTTCATGACT,2,2238856
marRp,0.5238095238095238,30,20,TCGGTAACGAAAGTCCGTGT,10,2242212
marRp,0.09523809523809523,21,20,TCGCCATGAAGTTACATCCA,1,2256614
marRp,1.0,40,20,TCCGTGGGATGGTTGGCAAT,20,2246969
marRp,0.5714285714285714,31,20,TCCACGCATGCCCAGATGCC,11,2245648
marRp,0.5714285714285714,31,20,TCACGGGTACGCACACCCCT,11,2247093
marRp,1.0476190476190477,41,20,TATGACACATACGGGTGAAT,21,2224999
marRp,0.6666666666666666,33,20,TAGGTTGAATCGCGTCAAGT,13,2241019
marRp,0.23809523809523808,24,20,TAGCTGTGGATCAAGGGTAT,4,2242915
marRp,4.333333333333333,110,20,TACGAGGGGTGCGAAACGTG,90,2219565
marRp,0.09523809523809523,21,20,TACCGGTTATACACCCAGTA,1,2233270
marRp,0.19047619047619047,23,20,TAAGCCAATGTGTACGATGA,3,2243213
marRp,0.9523809523809523,39,20,TAACTATGCTGAAAGCGGGG,19,2247864
marRp,2.142857142857143,64,20,GTGGTGAGTCACTTAAGCGA,44,2245307
marRp,0.14285714285714285,22,20,GTCAGTGACGTCTAGTACGT,2,2220702
marRp,0.42857142857142855,28,20,GGTCGCACAAACCGTATCGT,8,2242462
marRp,0.2857142857142857,25,20,GGTCCCCCGTAACTTAAATA,5,2224537
marRp,1.0476190476190477,41,20,GGGTGTACACAGTAGGATAC,21,2240369
marRp,0.09523809523809523,21,20,GGGCCTCATGGGGACAAGAA,1,2258376
marRp,0.42857142857142855,28,20,GGATATTAGCATGTTAAACA,8,2228767
marRp,0.5714285714285714,31,20,GCGTAGCTCGGGGTCACCCT,11,2254055
marRp,1.7619047619047619,56,20,GATAGTTCTTATACCCTCTA,36,2238159
marRp,0.23809523809523808,24,20,GAGTGATGAAACCGTTAGGT,4,2235384
marRp,0.3333333333333333,26,20,GAGACTGGCCACGATTTAGG,6,2242011
marRp,0.14285714285714285,22,20,GAACGAACCCTTTATTAACG,2,2252138
marRp,0.6666666666666666,33,20,CTTTACGCGGCGCTACGAGC,13,2258991
marRp,1.4285714285714286,49,20,CTTCGCTTTGTTTAGTGTAA,29,2249632
marRp,0.7142857142857143,34,20,CTGCAAGCAAGCAATTTATT,14,2253123
marRp,1.3333333333333333,47,20,CTGAGGCCCTGATGGGCAAC,27,2255644
marRp,1.8095238095238095,57,20,CTCTGCTCAAGGGACATATC,37,2234089
marRp,2.142857142857143,64,20,CTCGGGGGAGCAGGAGAGCA,44,2252159
marRp,3.9047619047619047,101,20,CTCAAACCAGTCGCATTATT,81,2230600
marRp,0.9523809523809523,39,20,CTAGCTTAGATCTGGCAGGG,19,2234143
marRp,0.19047619047619047,23,20,CGTTCGAAGTACGCGGATGA,3,2234111
marRp,0.09523809523809523,21,20,CGTGTTAGGTTTCCCGGAAT,1,2218697
marRp,2.7142857142857144,76,20,CGTGCGCATCAAACGGCATT,56,2230109
marRp,0.38095238095238093,27,20,CGTGCCGGTTTAAGACTTAG,7,2231477
marRp,0.19047619047619047,23,20,CGTCTTGACCCTCGCATTCG,3,2241787
marRp,1.9047619047619047,59,20,CGTACAATCGAGAGCCGTTT,39,2232339
marRp,0.9523809523809523,39,20,CGTAACAGTTCGGGTGAATA,19,2239594
marRp,0.19047619047619047,23,20,CGGTCTTGCGTTATTGATTA,3,2233492
marRp,0.8571428571428571,37,20,CGGGGCGAGAATAGCTAATA,17,2232847
marRp,1.380952380952381,48,20,CGGGCGTGCATCCACTTCTG,28,2233595
marRp,0.09523809523809523,21,20,CGCTAAGCTGATTCACTTGA,1,2228500
marRp,0.6190476190476191,32,20,CGATCTGGTAGCTGAGATCC,12,2222661
marRp,1.2380952380952381,45,20,CGAATTTGTGGTAGGCTATG,25,2260077
marRp,0.38095238095238093,27,20,CGAAAGTATAGCAAGTGTTA,7,2249756
marRp,0.09523809523809523,21,20,CCTTGGCCGTCTATAGTACG,1,2237843
marRp,0.38095238095238093,27,20,CCTGTGCAGCTCTGATTACA,7,2221736
marRp,0.9523809523809523,39,20,CCGGTGTGAAAGTAACAGAT,19,2224879
marRp,1.2380952380952381,45,20,CCGATAGAAAGGGGTTGGGT,25,2245189
marRp,0.38095238095238093,27,20,CCCTCTTCAGAATAAGGAGA,7,2256179
marRp,1.7142857142857142,55,20,CCCGAGTAGATCTCGTCGTA,35,2223445
marRp,0.38095238095238093,27,20,CCCCAAAACGCCGACTTTAA,7,2254696
marRp,1.7142857142857142,55,20,CCATACTCAATTATGTGGGA,35,2226865
marRp,1.3333333333333333,47,20,CCAAGTTTGTCAGCGTAAAT,27,2227656
marRp,12.761904761904763,287,20,CATTACGATAGGACAGAGCA,267,2237340
marRp,0.5238095238095238,30,20,CATCGTAGATTAGCGCGGCT,10,2235415
marRp,0.23809523809523808,24,20,CATCAACTATCAGAGTGGAG,4,2249123
marRp,27.571428571428573,598,20,CAGTGCAATTCTGCTCACTT,578,2258406
marRp,3.142857142857143,85,20,CAGGGCGCCCTAGTGTCTTG,65,2229399
marRp,1.7142857142857142,55,20,CACTCGAGAGGATTACGTGA,35,2234502
marRp,1.0952380952380953,42,20,CACGCAGAACATCCCTATGT,22,2235536
marRp,1.9523809523809523,60,20,CACCAGTCAGCTTCATGGGA,40,2237699
marRp,0.9047619047619048,38,20,CACATTCCTAATGTTTAACA,18,2251862
marRp,4.428571428571429,112,20,CAAGGAGAGACCAGAGTGGA,92,2256092
marRp,1.1428571428571428,43,20,CAACCTAACCTCTAGAAGCA,23,2235665
marRp,10.761904761904763,245,20,ATTTAATCACGTCGAGGATG,225,2219207
marRp,0.42857142857142855,28,20,ATTGAAGGCAACAGCGTTCA,8,2250108
marRp,0.7142857142857143,34,20,ATTCGGTGTAAAAGTACCAT,14,2256397
marRp,2.3333333333333335,68,20,ATGTAGCGGTCGGGTCCCGA,48,2227508
marRp,0.23809523809523808,24,20,ATGCATTAATAATACGACGG,4,2225768
marRp,4.714285714285714,118,20,ATGAGGGACCTGGGGTATAT,98,2238955
marRp,3.7142857142857144,97,20,ATGAAAACTGTGTCGAAATC,77,2223418
marRp,0.42857142857142855,28,20,ATACGGGCGAGCGTAGAACT,8,2243392
marRp,2.5238095238095237,72,20,AGTCATTTTCCAAGGGGCTA,52,2241851
marRp,0.14285714285714285,22,20,AGTACCTATTCTTAAGTTTG,2,2255965
marRp,1.0952380952380953,42,20,AGTACAAGTTCGTAACGTTG,22,2220116
marRp,0.38095238095238093,27,20,AGGTCTCTGCCTCTTGCAAC,7,2248554
marRp,0.5714285714285714,31,20,AGGGACCTGTCGGATGTCGT,11,2228682
marRp,1.2380952380952381,45,20,AGGACATCAAATAGGGTCCC,25,2255763
marRp,6.666666666666667,159,20,AGCAAGCATCGGTCCCGGGT,139,2235097
marRp,0.42857142857142855,28,20,ACTGCAGCCAAGACGAGGAT,8,2246886
marRp,1.1904761904761905,44,20,ACGGCGTATCAACACACAAT,24,2218959
marRp,1.1428571428571428,43,20,ACGCTTACGCCCCGGATCTA,23,2241673
marRp,6.619047619047619,158,20,ACCGTGTTCCCCTGCCTTTT,138,2259768
marRp,0.23809523809523808,24,20,ACATCGAGCGTGTATAGAGA,4,2243510
marRp,4.0,103,20,AATTTTTTACCATACACCTT,83,2218821
marRp,2.0476190476190474,62,20,AATTAGAGTGGGGTTGCGAC,42,2244939
marRp,1.6666666666666667,54,20,AATCTGTGCCTCGAGTTGGA,34,2244773
marRp,0.8095238095238095,36,20,AATCCGTGCATCACTGTTGC,16,2237013
marRp,0.42857142857142855,28,20,AAGGGTGGGCTTCTATGTCC,8,2227164
marRp,7.571428571428571,178,20,AAGCTAGTTACACTCGTATA,158,2223657
marRp,1.4761904761904763,50,20,AACACGTCAAAACAGGACTT,30,2256391
marRp,2.380952380952381,69,20,AAAATGGATTTCCACAGGGT,49,2233965
marRp,0.25,23,19,TTTTGGGTGAGTCGTCCTCA,4,2242390
marRp,0.65,31,19,TTTTCCCATTCTACTAGCGT,12,2244654
marRp,0.55,29,19,TTTCAGGGCCTTGGAAGGCA,10,2256238
marRp,1.7,52,19,TTCCGGAGCTTCTATTATAG,33,2227073
marRp,0.25,23,19,TTCCCAAAATATGAAAGACC,4,2248917
marRp,0.3,24,19,TTCCACGCCGTAACTTGTAG,5,2225605
marRp,2.65,71,19,TTAGGAACATTCGCGTCTAT,52,2243984
marRp,1.15,41,19,TTAGATCCGAGCGGGTTTTG,22,2223728
marRp,0.85,35,19,TTAAAGACGCTCTGGCCAAA,16,2237841
marRp,1.0,38,19,TGTTTCTAAAGTGCGCCCAG,19,2235361
marRp,5.55,129,19,TGTCGCTCTCAGACGGAATT,110,2252033
marRp,0.55,29,19,TGTCGCTATTAATAATTTCC,10,2249074
marRp,0.4,26,19,TGGTTTCTACAGGTCGGGTC,7,2230620
marRp,0.3,24,19,TGGGTGAGCGTTATCGCACT,5,2247894
marRp,2.1,60,19,TGGGGAGCTTTGACCTGGTC,41,2257103
marRp,1.8,54,19,TGGGCAGGCCTGACCGCTAG,35,2227162
marRp,1.15,41,19,TGGCGAGGCCCACGCAGATT,22,2230895
marRp,0.85,35,19,TGGCCGGCTCCCCGGTTAGA,16,2254692
marRp,0.65,31,19,TGCGTTACATTCTACTTTGG,12,2254795
marRp,0.7,32,19,TGATTTCCCCTCATCGCTTT,13,2225107
marRp,0.5,28,19,TCGTTAACCACCTCTGACCT,9,2223233
marRp,1.25,43,19,TCGCATAACGCACAGTAAAA,24,2258924
marRp,0.45,27,19,TCGATACCGGTAGAAAAGTA,8,2223760
marRp,0.6,30,19,TCGACCTGATGAGACTAGCT,11,2222935
marRp,2.35,65,19,TCGACATGGTATATCTGCGC,46,2225390
marRp,0.6,30,19,TCGAATCATTAGGTTCTGAC,11,2258766
marRp,1.1,40,19,TCCGGGTAGTGAGTGCCGCA,21,2254573
marRp,3.3,84,19,TCCATTTTTTGGCAGGAGTT,65,2240418
marRp,1.25,43,19,TCATTGACGGGATCCTAAGG,24,2250780
marRp,0.35,25,19,TCAGCCCGGTTATGAGATTG,6,2225836
marRp,5.4,126,19,TCAACCTACGCGAAGCATTA,107,2241774
marRp,1.85,55,19,TCAACCGCTACACCCACGCT,36,2261054
marRp,1.25,43,19,TACGCAACTTTTTATCCGAT,24,2246826
marRp,2.8,74,19,TACCGCGACACCGTAGCCGT,55,2224784
marRp,0.7,32,19,TACCCATGCTTATAGAGGCT,13,2258607
marRp,2.45,67,19,TAAAAGGTGCTAATATCGTA,48,2218820
marRp,2.65,71,19,GTTGATACTCCGCTGGATTC,52,2246170
marRp,0.25,23,19,GTGAGAGCTTCGGTGGCGGA,4,2254505
marRp,2.3,64,19,GTCCTCCCCTGGTTTCGGCT,45,2249716
marRp,0.45,27,19,GTATGGTGGCGGTTGCCCTT,8,2217848
marRp,0.25,23,19,GTAGCGCAGACTGGGTCGGA,4,2226693
marRp,0.6,30,19,GTAAGGGCTGCTGGTGTCAT,11,2237855
marRp,0.65,31,19,GGTTCAGTAATGGAGGGAAC,12,2248714
marRp,3.05,79,19,GGGTGGGGAACTGTGTTAGC,60,2242602
marRp,0.1,20,19,GGGCTCTTACTAACGTGGGG,1,2217996
marRp,4.35,105,19,GGCCATTGTCATTTTCTCCC,86,2249178
marRp,1.75,53,19,GGAGTTATTAGGAACACCAC,34,2242987
marRp,1.65,51,19,GGACGTCCTGCCCATATGAT,32,2234952
marRp,2.95,77,19,GGACAGCATAAGTTCTTGTT,58,2230540
marRp,2.2,62,19,GGAAGAAGTGCGTAGTATGT,43,2237630
marRp,3.0,78,19,GCTTATACTGGTCCCGGGAG,59,2250420
marRp,0.1,20,19,GCGGTGTGTCGTGGACAGAG,1,2231890
marRp,0.15,21,19,GCGGTCGGCCACGATACGGT,2,2234144
marRp,0.6,30,19,GCATGACACAGGAGCACAGT,11,2254923
marRp,0.7,32,19,GCAGGCCCCCGCGTAGTCGC,13,2242277
marRp,0.15,21,19,GCACCGCCGGTGCGAGGATG,2,2250084
marRp,0.45,27,19,GATGGGCAAAGAAACAATAA,8,2234124
marRp,0.3,24,19,GAGTTACTATTGGGCATAAG,5,2247071
marRp,2.3,64,19,GAGCCTAGACACACGGTTCT,45,2246371
marRp,3.25,83,19,GACCTAAACGGTTCAGCGGT,64,2222199
marRp,3.45,87,19,CTTCAACCGATCCGGCGAAT,68,2229240
marRp,1.05,39,19,CTTAGGCCTCTGGGTCTTGT,20,2225773
marRp,5.4,126,19,CTGGTAGCCACCTACGGCGT,107,2236605
marRp,0.45,27,19,CTGGGTGGAAGCGAACCGTG,8,2220295
marRp,0.15,21,19,CTGGGTCGGCCTCGCATGGG,2,2238880
marRp,2.5,68,19,CTGGCCCGCGCAGCTTCATA,49,2260458
marRp,0.2,22,19,CTGGCAGGCGCTTGAGGATA,3,2248355
marRp,0.3,24,19,CTGCCGAGCCCTTTATATGA,5,2231023
marRp,0.45,27,19,CTGCAATATACCCTTTCTGC,8,2245870
marRp,1.0,38,19,CTCCCTATCGCCGTTTGTAT,19,2218316
marRp,2.2,62,19,CTAAGCGATTACGTAGATAA,43,2224054
marRp,0.75,33,19,CGTTCACAGCGATGCTGGTC,14,2251172
marRp,1.9,56,19,CGTGGGCGAGCACGGCCAAG,37,2224705
marRp,0.9,36,19,CGTGGCGCAGTCAACCACAT,17,2258302
marRp,0.1,20,19,CGTGCTTCCCGCGGCCTGTA,1,2253002
marRp,0.3,24,19,CGCTTGACCCTTTCGTAGGG,5,2231318
marRp,0.5,28,19,CGCTCCAGGCTTTAAATTCG,9,2218089
marRp,1.0,38,19,CGATCTTCGCCGGCCTTGGA,19,2231968
marRp,18.75,393,19,CGACGGTTAGGCCAGATCAG,374,2257775
marRp,0.65,31,19,CCTCCAGACGTCGTAGTTTA,12,2240638
marRp,2.25,63,19,CCTAGTCACAGGGACCATCG,44,2220828
marRp,1.3,44,19,CCGCGCGTGGTGCGATCTAT,25,2244209
marRp,2.1,60,19,CCGCACGCTATGTACTGAGG,41,2234779
marRp,0.25,23,19,CCAGTATCGAACGGCGGATT,4,2219171
marRp,6.55,149,19,CATTGGTGATTCGCGCAAAT,130,2259220
marRp,0.45,27,19,CATCATCAGACAATGTAGGA,8,2235605
marRp,0.75,33,19,CAGTTCGATAGTGCAGTGCG,14,2238889
marRp,1.95,57,19,CAGAGAAACCACAGCGCGGG,38,2235766
marRp,2.25,63,19,ATGTACTTTTTGACCAGAAT,44,2249717
marRp,1.05,39,19,ATGACCGCAAAAAATCCCGT,20,2229272
marRp,0.25,23,19,ATCTTCGCCGTTGTGGGTCA,4,2245733
marRp,0.2,22,19,ATCGATTTGGCTAGATATGA,3,2225804
marRp,0.35,25,19,ATCCGGGAGCTCGTTTGCAT,6,2255643
marRp,0.85,35,19,ATCCCGGTTGAGTATGTCCT,16,2221396
marRp,0.4,26,19,ATAGCTGATAATATGGCGAT,7,2226288
marRp,0.45,27,19,ATAGCTCCCGGGGGGAGCGA,8,2241885
marRp,0.2,22,19,AGTGGGGATCATGAAGTAAC,3,2224300
marRp,0.85,35,19,AGGTCACACATATGTCACAT,16,2241459
marRp,4.6,110,19,AGGGTAGTAACTGCGATCTC,91,2256994
marRp,1.9,56,19,AGGGGTCTTCTCAGCTTTCG,37,2232812
marRp,0.1,20,19,AGGGCGTGCCGGGCGCTTCA,1,2259529
marRp,1.15,41,19,AGGCGCTACCTTCTAAGTCC,22,2220018
marRp,0.15,21,19,AGAAACTTCAGAATGAATAT,2,2238239
marRp,0.2,22,19,ACGGTTGAGTATGCCACTCC,3,2238251
marRp,0.8,34,19,ACGGAAACATACCACCCTAG,15,2252063
marRp,0.75,33,19,ACGCCGGCAGCCACGTCAAT,14,2230782
marRp,0.15,21,19,ACCTGAGTCATCACAATTTC,2,2217857
marRp,0.15,21,19,ACCATAGGACCCGATAGTGA,2,2217859
marRp,14.25,303,19,ACAGCCACAAGACCACTGTA,284,2257396
marRp,1.5,48,19,ACAAGCTTTGAGTCGGCTTC,29,2232696
marRp,0.45,27,19,AATTCGATCCCCTTTCCTGC,8,2224397
marRp,0.2,22,19,AAGCGGTCCAGAGTGCGTTG,3,2251676
marRp,0.9,36,19,AACCACTGCGTTGATCCGGA,17,2246575
marRp,0.3,24,19,AACAGAACTGCGCCGGCCGC,5,2241235
marRp,8.4,186,19,AAAGATAGAACAAAGGAAGG,167,2244590
marRp,3.5789473684210527,85,18,TTTTAACATGTTCCTTAACG,67,2251424
marRp,1.7894736842105263,51,18,TTGCGTGTCCGCGCGTTTCC,33,2246161
marRp,0.21052631578947367,21,18,TTGCAGGGACACCATATAGG,3,2246300
marRp,0.7368421052631579,31,18,TTCGGACCGCCGTAATCGTT,13,2224544
marRp,0.15789473684210525,20,18,TTCATGCGTGGGGCGTACTT,2,2222506
marRp,0.15789473684210525,20,18,TTATTGTCAGACTATGGTAG,2,2223537
marRp,0.42105263157894735,25,18,TTAGCTCATTCTACACTAAA,7,2247753
marRp,0.2631578947368421,22,18,TTACTGCGCTAATATCACTA,4,2218456
marRp,2.0,55,18,TGTGGAGGACTCCGAGCCAA,37,2254930
marRp,2.0526315789473686,56,18,TGTGAGTCCGGCGGAGCTGT,38,2256571
marRp,1.1578947368421053,39,18,TGGGGGGGCTAGTGGCGAGG,21,2229166
marRp,1.0,36,18,TGGGCCGCTGTGGGCCGATC,18,2236673
marRp,0.10526315789473684,19,18,TGGGACAGGAGGTGCTCGCT,1,2243548
marRp,0.6842105263157895,30,18,TGCTCAGGAGGTCTGGAAAA,12,2260920
marRp,8.578947368421053,180,18,TGCGGGGGTTGAACCGTCAA,162,2235074
marRp,0.47368421052631576,26,18,TGCCGCCAATGTTAAAGGCT,8,2246100
marRp,12.526315789473685,255,18,TGCCATGGTTTTCGATCCAT,237,2219723
marRp,2.736842105263158,69,18,TGAATAGGTGACTGGCCCAC,51,2256989
marRp,0.15789473684210525,20,18,TCTACGGTTCTTGTTTGCCT,2,2241327
marRp,1.894736842105263,53,18,TCGTTGGAAAATGGTGTCAT,35,2223483
marRp,1.0526315789473684,37,18,TCCGATGAGTAGCACAACAG,19,2239455
marRp,0.631578947368421,29,18,TCCATTCACCCTGAAGTCCG,11,2242513
marRp,8.526315789473685,179,18,TCCAGCGTTCTGTAGTACAT,161,2237121
marRp,1.5263157894736843,46,18,TCAATTTCTGGCGTTGTATA,28,2240319
marRp,0.6842105263157895,30,18,TATTAGTGTCACGATAGCCT,12,2226464
marRp,1.1578947368421053,39,18,TATCCCGACCTAGCGCCGGA,21,2254454
marRp,0.7368421052631579,31,18,TATATACGGTGCATTGAAGT,13,2234917
marRp,2.0,55,18,TATAACGTCTCTCACACGGA,37,2250029
marRp,1.894736842105263,53,18,TAGCACCCCCAGTCTCTGCG,35,2228198
marRp,0.21052631578947367,21,18,TAGACTATCCATTAGGGTAC,3,2250468
marRp,0.7368421052631579,31,18,TACGTACATTTGCCGTTCAG,13,2226892
marRp,0.42105263157894735,25,18,TACGGGTGGTCTATTTCTGA,7,2239877
marRp,2.210526315789474,59,18,TACGGACTGCGGAGACTCAC,41,2224100
marRp,1.368421052631579,43,18,TACATCTGGTTGGGTTGATT,25,2249069
marRp,3.210526315789474,78,18,TAAGGCTTTCACAATAGGGA,60,2226043
marRp,0.5789473684210527,28,18,TAACGCTCGTACGTCGCAAG,10,2239265
marRp,1.105263157894737,38,18,TAACCGATACGGGTCATGAC,20,2258257
marRp,1.0,36,18,TAAATCAATACGGAGAACGG,18,2219638
marRp,0.5789473684210527,28,18,GTTTGACGGTCACTGAGGCA,10,2226625
marRp,2.1578947368421053,58,18,GTTGTAGCGAATTATTACTG,40,2242214
marRp,0.631578947368421,29,18,GTTCTCGATTAGAGAAGGCT,11,2243149
marRp,0.2631578947368421,22,18,GTTCTCATGTTCGCCAAGTG,4,2221392
marRp,3.0,74,18,GTGTGGGCAATTGTCGAGAC,56,2224752
marRp,4.0,93,18,GTGTCCACGGGATGGGACGG,75,2242205
marRp,3.1052631578947367,76,18,GTGGTAGACATCAGCAAGTT,58,2241250
marRp,1.5789473684210527,47,18,GTGGCCAGAGAACGACATCG,29,2217814
marRp,11.473684210526315,235,18,GTGGAGCGATGCGTTATGGA,217,2228170
marRp,1.263157894736842,41,18,GTGCACTCATGGCGGAGAGG,23,2222195
marRp,0.3684210526315789,24,18,GTGAAGCCATTATTTAGCAT,6,2252857
marRp,14.421052631578947,291,18,GTCGTTGGACCGAGACATTA,273,2250157
marRp,1.1578947368421053,39,18,GTCCTTCTTGGGTTGCTGGA,21,2230599
marRp,0.15789473684210525,20,18,GTCCGATCAGTACACAAACT,2,2252140
marRp,5.2105263157894735,116,18,GTACGCGGGATGAAATCGCC,98,2257482
marRp,1.894736842105263,53,18,GGTTAAGAGGAATCAAGGGA,35,2258451
marRp,0.47368421052631576,26,18,GGGTAGCATAGCTCGCCCCT,8,2232422
marRp,0.5789473684210527,28,18,GGGCACACATCCCTACCCAT,10,2257079
marRp,1.5263157894736843,46,18,GGGATCAAATCAGGCACATG,28,2218869
marRp,3.263157894736842,79,18,GGCTTGCACTGAGTTAGCCT,61,2235782
marRp,0.8421052631578947,33,18,GGCTGTGTTGTCTGATGTAT,15,2241276
marRp,0.2631578947368421,22,18,GGCTAAGCCACCTTGATTAT,4,2234713
marRp,0.7894736842105263,32,18,GGCGCTACGTTCAGCGAAAA,14,2250549
marRp,0.15789473684210525,20,18,GGCCGGGCGTGTAATAGATT,2,2253815
marRp,1.1578947368421053,39,18,GGCATACACCTTTTGCTATT,21,2235290
marRp,0.47368421052631576,26,18,GGATGTCCCCACGACGAACG,8,2232906
marRp,0.3684210526315789,24,18,GGATGAGGGCGCTTAATTAG,6,2235794
marRp,0.3684210526315789,24,18,GGATCATGGGCCACCTTTAA,6,2221696
marRp,2.0526315789473686,56,18,GGATACTGTTGTAGGTTTCG,38,2240247
marRp,0.42105263157894735,25,18,GGAGCGCTCAGCCGGCGGAT,7,2258609
marRp,0.3684210526315789,24,18,GCTTAATCACGGGAAATCGC,6,2247488
marRp,1.0526315789473684,37,18,GCTGCCTTAGAGGACGCATC,19,2237268
marRp,9.68421052631579,201,18,GCTATGATCTATGTTGGGGT,183,2220040
marRp,0.8947368421052632,34,18,GCTAGGGGGGCCATCAATCA,16,2226846
marRp,0.9473684210526315,35,18,GCGTTGCAGATGTCCAATTG,17,2232625
marRp,1.0,36,18,GCGCTATATAACCTGCAGTG,18,2219688
marRp,0.5263157894736842,27,18,GCCGGACAATATTGAGCCAG,9,2249587
marRp,0.21052631578947367,21,18,GCCCCGCCCATTGCATAAAT,3,2224178
marRp,1.0526315789473684,37,18,GCCAAAACGAAGTATTTTTG,19,2225234
marRp,0.15789473684210525,20,18,GCACAAGATACGTGAGTGAC,2,2244205
marRp,0.6842105263157895,30,18,GCAAATTCAGTGGATCATAA,12,2253748
marRp,0.6842105263157895,30,18,GAGAGAGTGTTTTGTGTGTC,12,2220424
marRp,1.631578947368421,48,18,GACTCGCGGGGAGAGGCATC,30,2251392
marRp,0.9473684210526315,35,18,GAAGGTCCCGCATTAAACAT,17,2219890
marRp,0.5789473684210527,28,18,GAAGGATGTGAGCGGCACCA,10,2222059
marRp,0.3157894736842105,23,18,GAAAGGTACACCATTAGGGT,5,2229325
marRp,1.2105263157894737,40,18,GAAAAACGCTGGATAACCGT,22,2246558
marRp,2.0526315789473686,56,18,CTTTCTTGCTGCACCTGTTT,38,2224128
marRp,1.894736842105263,53,18,CTTTCCCGTTTGTCAAGTTT,35,2233142
marRp,0.3684210526315789,24,18,CTTGGATGCCATAGCCCTCT,6,2243591
marRp,0.47368421052631576,26,18,CTGGTAGGCCGTGACCACGA,8,2247834
marRp,1.0526315789473684,37,18,CTGGAGTCATAAGTCACGGA,19,2231342
marRp,0.631578947368421,29,18,CTCGAACCTACCTCTCAGGT,11,2245937
marRp,2.526315789473684,65,18,CTCAGGTCCTGTATAGATGA,47,2257831
marRp,2.8421052631578947,71,18,CTATTGGAAAAAACTATTGA,53,2236110
marRp,0.9473684210526315,35,18,CTAGTAAAGCGCAGACGGTT,17,2258639
marRp,7.0,150,18,CGCGGGCCACCTGGTGAGGT,132,2258770
marRp,2.3157894736842106,61,18,CGCACAGCACCCAAGCGGTT,43,2249605
marRp,0.3684210526315789,24,18,CGATGACGGGGCTGGTCTCA,6,2231976
marRp,0.3684210526315789,24,18,CGAGTAGATGCTTAGTGTGT,6,2221228
marRp,0.3684210526315789,24,18,CGAGGGCTCGGGTAGCAATA,6,2243408
marRp,0.6842105263157895,30,18,CGAGCACAGGCCTTGCAAAA,12,2221991
marRp,2.0,55,18,CGAATCCCTGATCTTTATGA,37,2220107
marRp,0.7368421052631579,31,18,CCTTGTCTTTCACTGCCACA,13,2222548
marRp,0.15789473684210525,20,18,CCTGGCACTTAGACAATGCA,2,2239354
marRp,2.789473684210526,70,18,CCTGAGCGGGGCGCCTATCG,52,2229092
marRp,0.47368421052631576,26,18,CCTGAACAGTCAAATCCAAT,8,2252420
marRp,1.3157894736842106,42,18,CCTACAATGTGATTGCTAGT,24,2226289
marRp,0.8421052631578947,33,18,CCGTCCACCTGTCAGCCGAG,15,2234819
marRp,0.8947368421052632,34,18,CCGCGAACTCGCAATTTTTC,16,2251477
marRp,2.473684210526316,64,18,CCGACACGTCGGACGTGGGA,46,2255774
marRp,0.7894736842105263,32,18,CCCGGCCTCCTCCTGGAACC,14,2254333
marRp,1.368421052631579,43,18,CCCGACCTAGGGGGAAATGA,25,2221932
marRp,0.5789473684210527,28,18,CCCAAAACTCTCAACCAGTG,10,2220404
marRp,0.7368421052631579,31,18,CCATATAAATTACACATCAA,13,2233057
marRp,0.9473684210526315,35,18,CCAACACAGCAGAGGCTGTG,17,2233017
marRp,0.10526315789473684,19,18,CAGTCCACCCAATGAGACGC,1,2229761
marRp,0.5263157894736842,27,18,CAGTAATGCACACAAATTGG,9,2254397
marRp,0.631578947368421,29,18,CAGGTGCAAGGGGACCGAGT,11,2233657
marRp,0.42105263157894735,25,18,CAGCGCTATCGTGGAGAAGA,7,2222446
marRp,2.3684210526315788,62,18,CAGCCGACGCGCGGGGATAC,44,2240894
marRp,1.263157894736842,41,18,CAGAATCTGCCGGGTAGAAA,23,2219319
marRp,21.789473684210527,431,18,CACTCTGGAGGTTACATTCA,413,2239317
marRp,0.47368421052631576,26,18,CACGGTGGGGGTCGATTGAC,8,2218302
marRp,2.210526315789474,59,18,CAAGCCCACGACGGAGAGCA,41,2255277
marRp,1.0,36,18,CAAAGCACCCATGGGAGCCA,18,2221309
marRp,2.789473684210526,70,18,CAAAGACAGTAAGGAGTAAA,52,2240584
marRp,0.5263157894736842,27,18,ATTTTACTATAGTGAAATGC,9,2258085
marRp,0.10526315789473684,19,18,ATTGGATTGGGGAGGGACGA,1,2236970
marRp,1.368421052631579,43,18,ATTCTCCCCGCCCTAAGAAA,25,2222009
marRp,0.15789473684210525,20,18,ATGTGCGCGGCTACTCAGAT,2,2251476
marRp,1.263157894736842,41,18,ATGTCGATGGATGGCCTGTG,23,2230408
marRp,8.368421052631579,176,18,ATGGCCACATTCGAGTGGGT,158,2243437
marRp,2.9473684210526314,73,18,ATGGCAGTTAGGCGAATACG,55,2250341
marRp,8.842105263157896,185,18,ATGCTTATGATCAGATGCAG,167,2243004
marRp,0.8947368421052632,34,18,ATCTTTATAGTGGGCATTTC,16,2244260
marRp,5.7368421052631575,126,18,ATCAAAAGGGGGGCATAGGT,108,2226613
marRp,1.631578947368421,48,18,ATATCGCTGTCTAATGGAGT,30,2223371
marRp,0.42105263157894735,25,18,ATACACAATGACGGTGCGTC,7,2233590
marRp,3.4210526315789473,82,18,AGTGGTGCGTTACGTTAATG,64,2254971
marRp,9.842105263157896,204,18,AGGGAGCCGCCAAGGGCTGT,186,2224911
marRp,2.1578947368421053,58,18,AGCGAACAACCAAGCACGGT,40,2232948
marRp,0.15789473684210525,20,18,AGCAAAATCTGGGATGGCAT,2,2255892
marRp,3.0,74,18,AGACTTACTCCGGTGTTCGG,56,2226514
marRp,1.9473684210526316,54,18,AGAAGTAATATCCGTCTCAG,36,2243983
marRp,1.0,36,18,AGAAGCGCTAATCAGTGGCT,18,2245539
marRp,0.5263157894736842,27,18,ACTGGGAAATGCCTAAAGCT,9,2223476
marRp,0.6842105263157895,30,18,ACTGCAGTTTGCCGTACTAC,12,2250813
marRp,0.5789473684210527,28,18,ACTGAATAACTGACGATACC,10,2259259
marRp,0.8947368421052632,34,18,ACGCGGATATACGGGTTCTT,16,2232804
marRp,0.5263157894736842,27,18,ACCAGTGCTGATTATCATCT,9,2225424
marRp,0.5263157894736842,27,18,ACCACAGCTGAATATTTGCT,9,2257054
marRp,1.2105263157894737,40,18,ACATAGACGTAGTGCGCATT,22,2238246
marRp,3.6315789473684212,86,18,AATGCAAACATCCCCGAGTG,68,2254987
marRp,0.15789473684210525,20,18,AAGGTGTGGGATAAACACAA,2,2219442
marRp,1.5263157894736843,46,18,AAGGCCGGCCTAAAACGAAG,28,2255963
marRp,1.0,36,18,AAATTCATTGTTCCCTTCAT,18,2235355
marRp,2.8421052631578947,71,18,AAACTCATTGGGCGCTCACA,53,2259429
marRp,0.6666666666666666,28,17,TTTGGGTTAAAGTCACGGTA,11,2250531
marRp,1.2222222222222223,38,17,TTTGGGTCGAAACGACTCCG,21,2239493
marRp,0.2222222222222222,20,17,TTTCTTCAAATGCGGAGTCA,3,2254725
marRp,5.0,106,17,TTGTATGTTCTTATGCTATA,89,2237117
marRp,1.0,34,17,TTGCTCTGGACATACCCCGG,17,2244617
marRp,1.3333333333333333,40,17,TTCTAACCGGACTTCTTGAG,23,2258109
marRp,0.3888888888888889,23,17,TTCGGGTACCCTATAACGGC,6,2252699
marRp,0.4444444444444444,24,17,TTCCTTCGTGTTAACGGTGT,7,2228921
marRp,0.6111111111111112,27,17,TTCCCACAGAGTGCGTCATA,10,2241574
marRp,17.333333333333332,328,17,TTCAGGTCGGACCGTATGCG,311,2250829
marRp,1.0555555555555556,35,17,TTATGCACCGCTAGAGGATG,18,2235763
marRp,0.2222222222222222,20,17,TTAAGTGTGACTGAATGTGA,3,2246966
marRp,0.4444444444444444,24,17,TTAAAAGCTTCAACGATTAA,7,2224110
marRp,0.5555555555555556,26,17,TTAAAAGACGGCGCGCCGCA,9,2241689
marRp,0.6111111111111112,27,17,TGGCGATAGTACTGAGGAAC,10,2239946
marRp,0.7222222222222222,29,17,TGGCATTACGTGACCTTCGG,12,2250520
marRp,1.2777777777777777,39,17,TGAAGTGAACTCTCTCGTAA,22,2223804
marRp,4.944444444444445,105,17,TCTCTAGCAGCTTCCGAGTA,88,2256779
marRp,1.2777777777777777,39,17,TCGGTCTCGAGACCCGAGTA,22,2223061
marRp,1.0,34,17,TCGGGCTTAACGGCACAGCA,17,2226052
marRp,0.8888888888888888,32,17,TCGGAGTACAACAACTTTAG,15,2244866
marRp,0.8333333333333334,31,17,TCCCGATCCTGGCGGCTGAT,14,2255116
marRp,3.0,70,17,TCCAGATTATCCGGGTAGTT,53,2226077
marRp,1.8888888888888888,50,17,TCCACTTTTACCGTTGTAAG,33,2248476
marRp,0.16666666666666666,19,17,TCATTGCCGTACTAACATTA,2,2226417
marRp,0.6111111111111112,27,17,TCAGCACTCTTAAAGCGGTC,10,2237063
marRp,1.0,34,17,TCACGGGAGAATCAAGTTCA,17,2235492
marRp,2.0555555555555554,53,17,TCACCCGCTGGACCCTGAAA,36,2234641
marRp,1.6666666666666667,46,17,TAGGTTATACAAAAGGCCAA,29,2256233
marRp,0.2777777777777778,21,17,TAGCCAAACGGGAGAGCCAG,4,2228819
marRp,5.055555555555555,107,17,TACTCCTATGGCCCGACAGA,90,2236492
marRp,2.111111111111111,54,17,TACTCAACTGGGATACAGTC,37,2246125
marRp,0.8333333333333334,31,17,TACCGGCATGAGCTGCCGTG,14,2228324
marRp,0.16666666666666666,19,17,TAATTCATCCCCCGTGCCGA,2,2255466
marRp,0.9444444444444444,33,17,TAAGGGTCGTAAAGTCTTCA,16,2238626
marRp,0.1111111111111111,18,17,TAAGAGCGGATGGATGTAGC,1,2248175
marRp,1.0555555555555556,35,17,TAACGGGTGTCACCATTATC,18,2245732
marRp,1.9444444444444444,51,17,TAACCAGGTTACTGCTTTAG,34,2237306
marRp,0.2222222222222222,20,17,TAAACCAACCCAGGGAAGGC,3,2221385
marRp,0.1111111111111111,18,17,GTTACCCGGTTGAGGGTTGA,1,2253836
marRp,0.8888888888888888,32,17,GTGTATCTTCCCCTGGAGAG,15,2224129
marRp,1.6111111111111112,45,17,GTGCGTTCGACTGGTACTGT,28,2227239
marRp,0.7222222222222222,29,17,GTGACTGAGCGTTGGAAGTT,12,2246104
marRp,0.7222222222222222,29,17,GTGACGTTGTGGTGAGAATA,12,2254146
marRp,0.16666666666666666,19,17,GTGACGTCACATGAACTGAT,2,2251917
marRp,0.2222222222222222,20,17,GTGAATACTGTTAATCTGAC,3,2241307
marRp,0.2222222222222222,20,17,GTCTAGATCGCCAATAGACT,3,2219604
marRp,1.1111111111111112,36,17,GTCGCGAGGCTGCCAAATCA,19,2257285
marRp,0.2777777777777778,21,17,GTCCGCCCTGTTAGCTGGCC,4,2228378
marRp,12.944444444444445,249,17,GTATAAAGCGCTGCGTCCCA,232,2237236
marRp,0.4444444444444444,24,17,GTAGAAGTAGGGCGGAACCG,7,2252876
marRp,0.16666666666666666,19,17,GTAGAAGGTTCGGGATACAT,2,2252700
marRp,2.6666666666666665,64,17,GTACCGGCGAGCGGTGACTT,47,2220549
marRp,0.7222222222222222,29,17,GTAAGGCGGGATTGTTAGAT,12,2233923
marRp,0.2222222222222222,20,17,GTAAGCACGATTGATGATTA,3,2249421
marRp,0.7222222222222222,29,17,GTAACTCTAAAGGACTGTCC,12,2243090
marRp,0.2777777777777778,21,17,GGTTTCGGTTCCATCGCCGG,4,2240191
marRp,0.3888888888888889,23,17,GGGGGACCGCCGGCGACACT,6,2251935
marRp,0.2777777777777778,21,17,GGGCAGCGAGCCTACCGCTA,4,2218195
marRp,0.2222222222222222,20,17,GGCCGGTGTTTCCAAGTCGC,3,2247206
marRp,5.777777777777778,120,17,GGATATCCCGAGGGCATGCG,103,2218062
marRp,0.3888888888888889,23,17,GGAGGGATTCACAGTCCTTA,6,2256746
marRp,0.1111111111111111,18,17,GGACGCGGAAGAGCTGCCCA,1,2246238
marRp,1.1666666666666667,37,17,GGAAGACTTTGGCGATTCGG,20,2248877
marRp,2.611111111111111,63,17,GCTTGCCGTCGAAAGCGTGA,46,2227054
marRp,4.5,97,17,GCTCTTTATTGGTGCGCGCG,80,2245975
marRp,0.6111111111111112,27,17,GCTCATCCGTCTGCCGAACC,10,2224439
marRp,2.6666666666666665,64,17,GCTAGTCTCGTTGCAAGCGG,47,2225134
marRp,6.944444444444445,141,17,GCGAATCTCGGCTCTTGGGA,124,2217784
marRp,2.4444444444444446,60,17,GCCTCCAACTGCACTAGAAC,43,2253197
marRp,1.0,34,17,GCATGATAAATTGAGGGCCG,17,2250773
marRp,0.1111111111111111,18,17,GCAAGGTCACGGATAAATTG,1,2257755
marRp,0.2222222222222222,20,17,GACTGAGCGGTCTGAGATCT,3,2228447
marRp,3.7222222222222223,83,17,GACAGTTACTGTCTCTGTTT,66,2236603
marRp,0.16666666666666666,19,17,GAATCGTCATCGCGACAAGG,2,2217884
marRp,2.0555555555555554,53,17,GAAGCCTTAGACTGATCAGG,36,2257327
marRp,2.611111111111111,63,17,CTTTCAGACGTGGGAGCTCA,46,2221999
marRp,0.1111111111111111,18,17,CTTTCACATTGGTATGGGAT,1,2260380
marRp,4.611111111111111,99,17,CTTGCCATTGGGCTTCCCTA,82,2222229
marRp,23.166666666666668,433,17,CTGACGCGAGGTGTAACAAT,416,2246870
marRp,4.722222222222222,101,17,CTCTTCACGTTGTCCGAAGT,84,2252918
marRp,0.16666666666666666,19,17,CTCAGGGGCCGGAAACTTAC,2,2242897
marRp,0.3333333333333333,22,17,CTATCGGTTTTGTCGTAGGC,5,2239552
marRp,1.2222222222222223,38,17,CTAGGGTTCAACGATGGAAA,21,2232467
marRp,1.0555555555555556,35,17,CTAAGCGCCTAAAGTGTTAT,18,2241776
marRp,0.16666666666666666,19,17,CGTCATTGTCGAATGCCCGT,2,2246789
marRp,0.7777777777777778,30,17,CGTCAGGACAAGGTTAACGA,13,2230287
marRp,0.16666666666666666,19,17,CGGGCGCACTATACCTTTTT,2,2245837
marRp,1.6666666666666667,46,17,CGGACTAAATAGATGTCCTA,29,2236404
marRp,2.0555555555555554,53,17,CGCTCGCTGAGGTGACATTC,36,2222190
marRp,3.6666666666666665,82,17,CGAGTCCCGGTACGCGCCCA,65,2240485
marRp,0.8888888888888888,32,17,CGAGACAAGTTGAATTGATA,15,2260798
marRp,3.1666666666666665,73,17,CGACGCAAGACGCCATATAT,56,2251188
marRp,1.4444444444444444,42,17,CCTGGCGTATCCTTAAGTTG,25,2232689
marRp,0.3333333333333333,22,17,CCTCGGAATAGGTGTCCGCC,5,2232880
marRp,0.3333333333333333,22,17,CCTCGCTCCTTTCCGTTGCC,5,2258767
marRp,0.7777777777777778,30,17,CCTCGAGGCTGTCTCTCCCC,13,2243945
marRp,4.666666666666667,100,17,CCTCATCGATCTAGTTCAGA,83,2257724
marRp,1.9444444444444444,51,17,CCGCTCACTGCCGAAAACGT,34,2235118
marRp,1.5555555555555556,44,17,CCGCTATGGCGGTCTTAACA,27,2225199
marRp,0.1111111111111111,18,17,CCGCGTTGGGGTACTTGAGG,1,2224507
marRp,0.16666666666666666,19,17,CCGAGGCTTTTTACAAGATC,2,2222375
marRp,0.6111111111111112,27,17,CCGACAAGGCAAGTTCGTAT,10,2219662
marRp,0.5555555555555556,26,17,CCCTTTTAGGAGGCAGTCAA,9,2248179
marRp,0.1111111111111111,18,17,CCCGGCCCCTCTTGGGCATA,1,2257172
marRp,0.2777777777777778,21,17,CCCGAGGGGGGTGTGACTGG,4,2229074
marRp,0.2222222222222222,20,17,CCCGAGCGTTTGCATAACGC,3,2238774
marRp,1.3888888888888888,41,17,CCATATTCAAAAAGTCCGGG,24,2226234
marRp,1.4444444444444444,42,17,CCAGTATACGTCTACTCCGG,25,2232658
marRp,0.6111111111111112,27,17,CCAAGGGCATCCGATACCCC,10,2219966
marRp,3.8333333333333335,85,17,CATTGTAAGGGTTTTCTGTG,68,2230114
marRp,5.555555555555555,116,17,CATTAGTGGCGTCCCAGGTC,99,2234227
marRp,10.777777777777779,210,17,CATATGCTTGAGTGCCCTCG,193,2228287
marRp,2.1666666666666665,55,17,CAGTACGTTATCGGCGGATG,38,2250469
marRp,0.3888888888888889,23,17,CAGGATCCACGCAAGGGTAA,6,2233565
marRp,1.9444444444444444,51,17,CAGCTAAGGGGTACGCTTGT,34,2250295
marRp,5.888888888888889,122,17,CACTCCTAAGTGAACCCTGC,105,2219926
marRp,3.1666666666666665,73,17,CACGTTCCACTTCTCGGCTT,56,2241763
marRp,12.777777777777779,246,17,CAATGGGCAGCTAGAAACGA,229,2251247
marRp,7.888888888888889,158,17,ATTGTGCGCACTGGAAGCAT,141,2240759
marRp,0.6111111111111112,27,17,ATGTATTAATTACAGTATCA,10,2219377
marRp,0.5,25,17,ATGCGTAATGTAGGGTTCGA,8,2239038
marRp,2.0,52,17,ATGCGGATCCTAACCTTCAA,35,2239150
marRp,0.7222222222222222,29,17,ATCTTCAAGGGAGGCATAGG,12,2248873
marRp,0.2777777777777778,21,17,ATCTAGTACACAATAAACGG,4,2237304
marRp,0.5,25,17,ATCAGTGCTCTCATAGAATT,8,2260129
marRp,0.6666666666666666,28,17,ATACTAATACGGTGGGGTTT,11,2240902
marRp,0.3333333333333333,22,17,ATACAAACGGCTCGGCCGGA,5,2223297
marRp,1.1666666666666667,37,17,ATAATCCCCACAGCCGGTTA,20,2248949
marRp,0.6111111111111112,27,17,AGTGTTTGGCGCGACGCAGG,10,2242501
marRp,0.16666666666666666,19,17,AGTCAGGAAAATCAGGATTT,2,2234574
marRp,0.2222222222222222,20,17,AGGTGTGATACCCGGGTGAT,3,2238871
marRp,5.388888888888889,113,17,AGGCTAAGATTGATAAGGCT,96,2254945
marRp,0.16666666666666666,19,17,AGGCCAAATCGAAGAACTGA,2,2232805
marRp,1.5555555555555556,44,17,AGGATTCGGTCTTGTGAATC,27,2241423
marRp,1.6111111111111112,45,17,AGCGGCTAGGACCTCTGCAA,28,2251269
marRp,1.5,43,17,AGACGGTAACCTCGGGTTCA,26,2248648
marRp,7.944444444444445,159,17,AGAAATCTACCGTTCTATTA,142,2235686
marRp,0.4444444444444444,24,17,ACGAGGTAACGGCACGACTA,7,2228592
marRp,1.5555555555555556,44,17,ACCTATACATGTTTTAGGAT,27,2247636
marRp,1.0,34,17,ACCGGTCTAAACCTATTCAT,17,2251011
marRp,0.5,25,17,ACCCCATGGTACCCAGAGGC,8,2235160
marRp,1.7222222222222223,47,17,ACAATGTCAACGAAATGCCA,30,2255383
marRp,0.1111111111111111,18,17,ACAACCGTCTCAAGAGATGA,1,2247256
marRp,0.5555555555555556,26,17,AATGTTCGGAAATCACCAAA,9,2222228
marRp,0.8888888888888888,32,17,AATCTGGCGCGCCACTCCGT,15,2246749
marRp,1.2777777777777777,39,17,AAGTGAGGGCTGCGACGGAA,22,2250475
marRp,0.16666666666666666,19,17,AAGGTGGTCACAAATTTGTA,2,2223057
marRp,10.055555555555555,197,17,AAGGGTAAAACTCTCCGGAA,180,2254423
marRp,0.8333333333333334,31,17,AAGCGGCCTATCGATTGGTA,14,2241362
marRp,12.777777777777779,246,17,AACTTGAGAGTACGATGGAA,229,2244539
marRp,1.3333333333333333,40,17,AACTTATTCTTTAAGTAAAT,23,2249967
marRp,3.9444444444444446,87,17,AACTGACACAGCGCGGTGAG,70,2234285
marRp,2.3333333333333335,58,17,AAAGATGAGATGCTCACGTA,41,2242999
marRp,0.4444444444444444,24,17,AAAGAGTTTTCGCACCGAAT,7,2239510
marRp,0.7222222222222222,29,17,AAACCCCTGACCCGTATGGG,12,2219378
marRp,5.235294117647059,104,16,TTTTTCCAATGTTTTGGTCT,88,2241409
marRp,0.9411764705882353,31,16,TTTTCCAATTCCCCGCTTCG,15,2250521
marRp,0.9411764705882353,31,16,TTTTCAGTTAGTCTATAGCC,15,2237026
marRp,0.11764705882352941,17,16,TTTGCAGTTCCTTGCCATGG,1,2244211
marRp,1.8235294117647058,46,16,TTGATGCCCCAATTGGTTTT,30,2220471
marRp,2.823529411764706,63,16,TTCTTGAGCAAACACCGTCA,47,2259980
marRp,4.9411764705882355,99,16,TTATTCTCGTTAAATGGTGC,83,2233445
marRp,0.47058823529411764,23,16,TTAAGGTAACCGTGTGGCCC,7,2233054
marRp,0.17647058823529413,18,16,TGGCATCGCGTACAGTTATG,2,2239485
marRp,2.5294117647058822,58,16,TGGACAGCGCTGCAACGCGA,42,2234817
marRp,1.1176470588235294,34,16,TGAGGCAAAGTTTCGGTATA,18,2236748
marRp,3.5294117647058822,75,16,TCGTTTAAGCATCCAACCGT,59,2242438
marRp,1.9411764705882353,48,16,TCGTATGGTTCCGGACGAGA,32,2253227
marRp,0.8823529411764706,30,16,TCGGTGGCCTGTTGCAATAG,14,2242115
marRp,1.2941176470588236,37,16,TCGGTCCTCGGAGGTGCACT,21,2234461
marRp,5.705882352941177,112,16,TCGATCCGGCGCAGTGCGGG,96,2250771
marRp,0.9411764705882353,31,16,TCGAACTGGAAAAGTGAGTC,15,2249090
marRp,1.4705882352941178,40,16,TCCGTAGCGCTAGGGTGTAG,24,2225198
marRp,0.9411764705882353,31,16,TCCCGTCATGGTTGGTAGTA,15,2226622
marRp,1.1176470588235294,34,16,TCCATAAAACCGTCTTGTGA,18,2234220
marRp,0.11764705882352941,17,16,TATTGTGATATAAGCCCTCA,1,2241715
marRp,0.7058823529411765,27,16,TATGCACCGAGGACAAGGCT,11,2245582
marRp,0.11764705882352941,17,16,TATAAATGCTATAATATGCG,1,2255548
marRp,0.4117647058823529,22,16,TAGGAAGAATAGACCCATGA,6,2234853
marRp,0.9411764705882353,31,16,TAGACGGGGTCTATCCGTTG,15,2238489
marRp,4.294117647058823,88,16,TAGACGCCCATGCTAGTCCC,72,2246806
marRp,0.4117647058823529,22,16,TACTGAATCAGTGTATCGTT,6,2250983
marRp,1.0588235294117647,33,16,TACGTTTTTTGGTTCAGCCG,17,2229715
marRp,10.529411764705882,194,16,TACGTAACTTGTGCATCAGC,178,2245973
marRp,0.47058823529411764,23,16,TACATATTCCGCTGTGTTGT,7,2235245
marRp,0.4117647058823529,22,16,GTTAGAAATTGGTGCTTATG,6,2246199
marRp,3.2941176470588234,71,16,GTGTGTTATCTCTGCAGTAC,55,2258588
marRp,1.1764705882352942,35,16,GTGTATTTTGGATGGCAAAC,19,2250479
marRp,0.17647058823529413,18,16,GTGGAGTAGCCACAAGCGTT,2,2244441
marRp,0.6470588235294118,26,16,GTCTGACGGCTATTCCAATT,10,2220736
marRp,1.0,32,16,GTCCTGTGCGCCTAGAATCA,16,2220655
marRp,0.11764705882352941,17,16,GTCCGACTGGGAACATTATT,1,2247648
marRp,1.0,32,16,GTCAGCGGGATCTGAACATT,16,2230967
marRp,0.23529411764705882,19,16,GTACGCCTGGAGCTTATCAG,3,2221387
marRp,0.17647058823529413,18,16,GGTGCGGGTCAAAGCTACTT,2,2220587
marRp,9.705882352941176,180,16,GGTCTGGCGAAATACGCCTT,164,2258875
marRp,0.17647058823529413,18,16,GGGCAAATAAAGTTCATGGA,2,2234238
marRp,1.2941176470588236,37,16,GGGAGTATGTGAGGTGAGAG,21,2248384
marRp,13.588235294117647,246,16,GGCTTCCGTGTCCTCTCACA,230,2219205
marRp,5.117647058823529,102,16,GGCTGAGAGAGGCAAACTTG,86,2256845
marRp,1.9411764705882353,48,16,GGATTCCTCCGTCCAGGGGG,32,2226017
marRp,3.411764705882353,73,16,GCTAACGCGCCTTGCAATGG,57,2257387
marRp,2.411764705882353,56,16,GCGTGGTTATACGGGGGTCA,40,2238854
marRp,0.5294117647058824,24,16,GCGCTGTGTAAACGACCCGC,8,2233438
marRp,0.29411764705882354,20,16,GCGCACGGCTGGAGCGCACA,4,2219277
marRp,0.6470588235294118,26,16,GCCTTGTATAAGTGAGTCGA,10,2220615
marRp,0.23529411764705882,19,16,GCCTTCGGTTCCACTTGCTA,3,2230275
marRp,0.17647058823529413,18,16,GCCTGATAGTGCTGTTGCGA,2,2258910
marRp,1.1764705882352942,35,16,GCCATAGCGGGTTCGACTAG,19,2244206
marRp,0.6470588235294118,26,16,GCATTTGCTATTACGGTAAA,10,2233866
marRp,8.647058823529411,162,16,GCATTTAGGTCGCTACATAT,146,2233740
marRp,7.764705882352941,147,16,GCATGGCAGGAATGCACCTC,131,2257789
marRp,4.882352941176471,98,16,GCAGGGGGGTTTCGGATCTT,82,2255303
marRp,5.117647058823529,102,16,GCACAAAAGCTCACGGCTCT,86,2222421
marRp,1.0,32,16,GATTCTATACCATAGTGCCC,16,2222004
marRp,0.4117647058823529,22,16,GATATAATTTTTCAACGCTT,6,2232448
marRp,7.764705882352941,147,16,GACTTGTTTTAAAGTGTCCA,131,2232186
marRp,0.5882352941176471,25,16,GACCCGTATTGCCGGTGCAA,9,2232803
marRp,1.2941176470588236,37,16,GAAGGTAGTCAGCATAGCGG,21,2218145
marRp,6.176470588235294,120,16,GAACGTGGGTGTCATGACAG,104,2251790
marRp,1.1764705882352942,35,16,GAACGGGAATTTTAAATCAA,19,2255866
marRp,6.235294117647059,121,16,CTTCGTGGGGATCCAGCGTG,105,2222956
marRp,14.117647058823529,255,16,CTTCCGATCGGGGCAATAGT,239,2221263
marRp,3.3529411764705883,72,16,CTTCCAATAGTTACGTAGAC,56,2220706
marRp,0.4117647058823529,22,16,CTTACACGCTGATCAGAGAC,6,2242899
marRp,16.705882352941178,299,16,CTGGTTAGATATGCGGGCAT,283,2219032
marRp,0.6470588235294118,26,16,CTGGCCCCGCAATTGGGCTG,10,2247871
marRp,2.823529411764706,63,16,CTCGGTACCTAACTGTGGAT,47,2258838
marRp,1.588235294117647,42,16,CTCCGCCCTCCGGAAGAGCT,26,2218368
marRp,1.2941176470588236,37,16,CTAGTGGTGCGATTTGGTTT,21,2217970
marRp,4.470588235294118,91,16,CGTTCGCTTTGCTAGACCAA,75,2250462
marRp,0.23529411764705882,19,16,CGTATTAAGGAAGCAATCAT,3,2230270
marRp,1.0588235294117647,33,16,CGTATAACTACCCAGCGCAA,17,2228581
marRp,0.6470588235294118,26,16,CGGCGAGCAATAGCAATGTG,10,2248087
marRp,0.29411764705882354,20,16,CGCCGCGGGCTATACCTTAT,4,2247325
marRp,1.0,32,16,CGCAGGGCCATGCCTCAATC,16,2256908
marRp,0.4117647058823529,22,16,CGCAAAACTTATTATATTTG,6,2253076
marRp,0.5882352941176471,25,16,CGATCTTTTTGTTGGTGAGA,9,2219603
marRp,0.7647058823529411,28,16,CGAATTGGCCACGTTTTGAT,12,2252200
marRp,1.4705882352941178,40,16,CGAAGGTCAAGACTACGATA,24,2251322
marRp,0.5294117647058824,24,16,CCTTGAAGGAAGGAGCTGAT,8,2228425
marRp,1.1176470588235294,34,16,CCTGAGCAGGCTAGCTGCTA,18,2246549
marRp,7.0588235294117645,135,16,CCGTGGGATCATACGGTGCA,119,2220080
marRp,0.5294117647058824,24,16,CCGTCATGGTGTTACCTATG,8,2249725
marRp,0.5882352941176471,25,16,CCGTACGGCGGTGCTGCAGG,9,2218606
marRp,2.5294117647058822,58,16,CCGGGCAGAAGTTTGACAGT,42,2223947
marRp,0.8235294117647058,29,16,CCGGCGACACAGGGGACCCA,13,2228363
marRp,1.3529411764705883,38,16,CCGGATCTAAGTCATCCTGT,22,2252914
marRp,0.4117647058823529,22,16,CCGCTGTGAACCCCACATAC,6,2247639
marRp,0.4117647058823529,22,16,CCGAATACTTTTTCCACGTG,6,2238031
marRp,14.058823529411764,254,16,CCCCCGGTGATCAATGGCGT,238,2254076
marRp,0.11764705882352941,17,16,CCATTGAGTGTAGCTGGTAA,1,2219176
marRp,0.11764705882352941,17,16,CCAGGCCTAGCCGTGAGCCC,1,2237256
marRp,0.47058823529411764,23,16,CCAGATGGTTATGGTGGCAT,7,2236885
marRp,3.1176470588235294,68,16,CCACTGCAATCCAGCTTGCA,52,2251969
marRp,0.7058823529411765,27,16,CCACTAGGAGCTAGAGCATG,11,2225154
marRp,0.29411764705882354,20,16,CATTACAGAAGCTAATAGAT,4,2249498
marRp,0.5882352941176471,25,16,CAGTTCTGCTCAGGCACGAC,9,2221032
marRp,15.588235294117647,280,16,CAGGGGTGCCGGGCGTCGTA,264,2248592
marRp,3.8823529411764706,81,16,CAGGGACCGTCTACTTGTCG,65,2228768
marRp,0.7647058823529411,28,16,CAGCGACAACTCCGGGGGAG,12,2229080
marRp,0.5882352941176471,25,16,CAGCCCCACCTTAAGTGGCT,9,2241722
marRp,1.2352941176470589,36,16,CACTACTGCTGTTGCTGCCT,20,2232655
marRp,1.0,32,16,CACAGTTTCAATCTGGCCTG,16,2241461
marRp,1.0588235294117647,33,16,CAAGCCAGTCCCCTGTTGGA,17,2225030
marRp,0.29411764705882354,20,16,CAAATTAGGTCCGTCCAGAC,4,2236888
marRp,13.352941176470589,242,16,ATTGGTCCGGGGTTTAACCG,226,2221792
marRp,10.411764705882353,192,16,ATTCGGGGCAGGACACGGAC,176,2241086
marRp,1.0,32,16,ATTAGATTTTTGATCGTGAA,16,2221272
marRp,0.35294117647058826,21,16,ATTACCGCAGAATACCCCGG,5,2244132
marRp,1.5294117647058822,41,16,ATGGCCGTAAGTGAAAAAAT,25,2218312
marRp,0.5294117647058824,24,16,ATCTTACATTCTATCGTGTG,8,2245106
marRp,0.23529411764705882,19,16,ATCTGGGGACACTCTGCGTG,3,2246542
marRp,1.7647058823529411,45,16,ATCCTCATCATCCGAAATAG,29,2255485
marRp,1.7058823529411764,44,16,ATCCAGCATCGGATTGTATG,28,2220923
marRp,1.2352941176470589,36,16,ATCACCTTAGCCGCCTTAAA,20,2259175
marRp,0.5294117647058824,24,16,ATATACTTGATAGGCTAACC,8,2221515
marRp,8.764705882352942,164,16,ATAGGTTGTCCCACATACAG,148,2247296
marRp,1.1764705882352942,35,16,ATACGCTGCCTGCCGCGTGG,19,2254242
marRp,0.11764705882352941,17,16,ATACGAAAAGATAGCGCGAG,1,2247870
marRp,0.35294117647058826,21,16,AGTGTCCGCCAGCCAAGAAT,5,2228417
marRp,2.588235294117647,59,16,AGGGCATACTCCGCGTCTCT,43,2259254
marRp,0.6470588235294118,26,16,AGGCTGTATAGCAGCTCAAG,10,2236687
marRp,3.1176470588235294,68,16,AGGACACTGTGAGACGTATT,52,2220586
marRp,0.11764705882352941,17,16,AGCCTAGGGGGTCCCGCAAA,1,2234666
marRp,0.5294117647058824,24,16,AGATGGTTCTTAGCGGTAGA,8,2232571
marRp,11.117647058823529,204,16,AGAATGTTTACATAGACTAT,188,2250277
marRp,0.29411764705882354,20,16,ACTATGTTGTTCTCCGAGCC,4,2231284
marRp,0.6470588235294118,26,16,ACGGGCTGTTCTTATCTCAC,10,2255831
marRp,0.7647058823529411,28,16,ACGGCACTCTTCCCAATTCA,12,2237945
marRp,3.3529411764705883,72,16,ACGCCGCCAACACAGCAGTT,56,2226050
marRp,4.9411764705882355,99,16,ACGCCGAGATCCTGAGAAGA,83,2228137
marRp,4.764705882352941,96,16,ACGACATTGCAAGAGCGGGA,80,2220078
marRp,3.2941176470588234,71,16,ACCGTCAAAACCTCTAGAGT,55,2242535
marRp,1.0588235294117647,33,16,ACCCGCGAACACATACATGA,17,2246985
marRp,0.6470588235294118,26,16,ACCAATATGATATATCCGTG,10,2226284
marRp,2.764705882352941,62,16,ACATTGGTAGACCAAGTTTT,46,2250803
marRp,1.0,32,16,ACATTGGAGCGGTATAAGGA,16,2248429
marRp,2.7058823529411766,61,16,ACATATTAGTTCCAACAGAG,45,2246164
marRp,3.2941176470588234,71,16,ACAGCGGACTCTACGTCGTG,55,2224904
marRp,2.3529411764705883,55,16,ACACACCTCCGGGGCTGGGG,39,2255850
marRp,0.29411764705882354,20,16,AATGTCTGCTTGTCAGACCT,4,2254045
marRp,0.35294117647058826,21,16,AATGTACCTCAGCCAACGGA,5,2231891
marRp,7.882352941176471,149,16,AATCCTTAACCTCGAGATTT,133,2226616
marRp,1.2941176470588236,37,16,AAGTGATAGACGTCGCTATC,21,2242506
marRp,0.35294117647058826,21,16,AAGTAATGGTGTTCCTTGTT,5,2240148
marRp,1.5294117647058822,41,16,AAGCTAGACTCCTAAGGTCG,25,2226112
marRp,1.0,32,16,AAGAATGATAGGATGACAAC,16,2219108
marRp,1.2941176470588236,37,16,AACCTCACCGTGGCCCAACG,21,2242017
marRp,0.47058823529411764,23,16,AACAGGAACAATGAGAAAAC,7,2221442
marRp,0.11764705882352941,17,16,AAATGCACAGGATCGCCTGG,1,2243986
marRp,2.588235294117647,59,16,AAATCTGTTGACATTCAGCT,43,2247026
marRp,9.529411764705882,177,16,AAAGTATTCAAAAGACGTAT,161,2259735
marRp,0.4117647058823529,22,16,AAAGATATTGCTCTCTGTAA,6,2253232
marRp,1.8235294117647058,46,16,AAACTTCGGGGGCGTCTGGT,30,2227124
marRp,0.5294117647058824,24,16,AAAAAGCTACTGATACTATA,8,2226292
marRp,3.4375,69,15,TTTTGCATGCCTCAGTGGGT,54,2251526
marRp,2.25,50,15,TTTGCTTGATACACTAAAAG,35,2252781
marRp,1.9375,45,15,TTTCGAACGATTTCATGCGT,30,2255062
marRp,0.25,18,15,TTTAGAACTATTGGTGGTGT,3,2257143
marRp,0.3125,19,15,TTTACGTAATTTTGGCATTA,4,2221659
marRp,0.5625,23,15,TTAATTTTCTCGACATTAGA,8,2258281
marRp,1.375,36,15,TTAACAACGCATTCGGTGTG,21,2247252
marRp,1.1875,33,15,TGTAGCGCCGTAGTTCGGGG,18,2219564
marRp,1.75,42,15,TGGAGAAACCTAGGAACGCA,27,2232694
marRp,0.125,16,15,TGCTTGTCAAAAACGGGGGG,1,2241031
marRp,0.5,22,15,TGCGAGTCGCCCACTACTGG,7,2255802
marRp,1.625,40,15,TGCCACGTGTCCGGGTCCCA,25,2220409
marRp,5.75,106,15,TGAGGTTAGGCACAGACGTG,91,2260409
marRp,1.25,34,15,TGACACCAAAATTAGAACCT,19,2237795
marRp,0.8125,27,15,TCTCTAATACTCTGACAGAG,12,2243599
marRp,1.75,42,15,TCGGGTCGTTGAACTAATCC,27,2223370
marRp,3.5625,71,15,TCGGAGCAACATTATGAGCT,56,2243033
marRp,0.8125,27,15,TCGCTCGTTGTAAATCTTGA,12,2252875
marRp,0.25,18,15,TCGCGGTCTGCGGTTTAATG,3,2246217
marRp,1.0625,31,15,TCGCAAGATTAGAAAACTAT,16,2219342
marRp,1.3125,35,15,TCCTCCGGTTTTGTAGCTAG,20,2223318
marRp,0.8125,27,15,TCCTCAGAAATCACTCTATT,12,2235054
marRp,0.375,20,15,TCCTATCCTACAGTACAAAA,5,2227917
marRp,0.3125,19,15,TCCACCAGTTGTGGCTCTAA,4,2235367
marRp,0.1875,17,15,TATAGAAAACGGTATGGCAA,2,2243203
marRp,0.9375,29,15,TACCGTTTACTTCGGCTCGT,14,2222676
marRp,0.25,18,15,TACATTTGATGGGTTCCGGG,3,2236790
marRp,0.3125,19,15,TAATGTTGTGGCGAGTCCTA,4,2236080
marRp,1.0625,31,15,TAATGGATGTTCACATTGCA,16,2225185
marRp,0.125,16,15,TAATCATTAAGGACCGATGA,1,2222319
marRp,0.375,20,15,TAATAATCAGAGATCTCGGA,5,2244511
marRp,6.4375,117,15,TAAAGCACTCAGAGCGCATA,102,2235695
marRp,0.3125,19,15,GTTGGGATGAACCACACGCA,4,2247518
marRp,0.625,24,15,GTTGCGAATAAAAACAGCCT,9,2223976
marRp,3.6875,73,15,GTTGAGTTCCAAAGCGGAAC,58,2247620
marRp,0.5625,23,15,GTGGCGACTTCCGCGAAAGC,8,2226534
marRp,0.9375,29,15,GTGCGAAACATCGCGACGTC,14,2235130
marRp,0.3125,19,15,GTGAGTCTAAAACCTGATGT,4,2228937
marRp,2.3125,51,15,GTCTGATGTCCTCTAAGCAT,36,2227305
marRp,0.6875,25,15,GTCCCCATGCGTACGCGGCT,10,2225115
marRp,0.125,16,15,GTCATTCAAGTGACGACATT,1,2230240
marRp,11.125,192,15,GTCACAAGCAAGCGAGAATG,177,2259282
marRp,1.0625,31,15,GTATATTAATTAAACCAGGT,16,2250526
marRp,0.1875,17,15,GTAGTGTTGGATTGCTTACC,2,2250458
marRp,0.6875,25,15,GTACAGTGAGGCAGAAATAT,10,2219772
marRp,0.75,26,15,GTACACAATGGTCTTGCGCC,11,2253218
marRp,1.5625,39,15,GTAATGGGAACTTGCCAATT,24,2260810
marRp,0.8125,27,15,GGTGTCTTCGCAGGGTGTGT,12,2236757
marRp,7.75,138,15,GGTAGCAAGGGGGTTGTGAT,123,2256427
marRp,1.0625,31,15,GGTAATTGTCCGATGGTGGG,16,2232466
marRp,3.875,76,15,GGGATCTTGGTGAGTACGCC,61,2219300
marRp,13.75,234,15,GGGAGTCCGCGTACAGTGGA,219,2244402
marRp,0.5,22,15,GGGACCTATAGATGAAGGTA,7,2247901
marRp,0.6875,25,15,GGGAAAGAATCCTAGTCATA,10,2249697
marRp,0.125,16,15,GGCTTAGGCATGAACGGGAT,1,2236030
marRp,17.3125,291,15,GGCGATCCACGAACCACACT,276,2259746
marRp,5.9375,109,15,GGCATTGAAGGATTTGCGGA,94,2249152
marRp,0.625,24,15,GGATGATGGGGAAGTTCTTA,9,2246408
marRp,0.8125,27,15,GGATCGGTGACTCTGCACCA,12,2245021
marRp,1.625,40,15,GGACCAATCGCCAACCTGAA,25,2249922
marRp,1.0625,31,15,GGAAGCTAGGGAGCCGCGGG,16,2236803
marRp,0.3125,19,15,GGAAGACAACGGCATCACAA,4,2252637
marRp,0.3125,19,15,GGAAAATCTGCGACGGACCT,4,2235117
marRp,24.5,406,15,GCTTATGGTGAAAGTCAGTG,391,2230371
marRp,2.1875,49,15,GCTGGCCCAGGATCCTGCGA,34,2241662
marRp,0.8125,27,15,GCGTGCTGAGTGTCTACAGA,12,2260524
marRp,0.625,24,15,GCGTGCAACGTGAAGCATCC,9,2252600
marRp,8.5625,151,15,GCGTAAAGTTTCAGTTTTAC,136,2222761
marRp,1.375,36,15,GCGGCCGGCGTCGGAGAGAA,21,2219266
marRp,1.25,34,15,GCCGATATATGTACGGGGAA,19,2228109
marRp,1.5625,39,15,GCCGAGAATCATCCTCGTTT,24,2228787
marRp,0.5625,23,15,GCCCATACATGTTGCTAGTC,8,2221774
marRp,2.25,50,15,GCCCACGATCCGTATAATTT,35,2252893
marRp,0.25,18,15,GCCATCCCGGAGTTGACGTA,3,2219690
marRp,1.3125,35,15,GCATGGACAGACCGAGTAGG,20,2237443
marRp,3.9375,77,15,GCAGTGGTTTCAAACTCTGC,62,2233443
marRp,0.75,26,15,GCAGGGCTCGGTGGCAGGCG,11,2249817
marRp,16.5625,279,15,GCAATCACAGAGGGTATCGT,264,2254424
marRp,0.5625,23,15,GATTTATGGAGCGGAAAATA,8,2231133
marRp,1.875,44,15,GAGGCTAGCGCGATGTTAAT,29,2223232
marRp,1.4375,37,15,GACCCGAGTCGGGTAGGTTT,22,2219942
marRp,3.1875,65,15,GACAAGAGAGCGCTGTCGAG,50,2220838
marRp,0.125,16,15,GAAGTGGAAAAATACCCACC,1,2244087
marRp,0.5625,23,15,GAACTCCACCCAGATCTGGG,8,2247162
marRp,3.75,74,15,GAACCACCAGGGTTTGTCTG,59,2243270
marRp,1.625,40,15,CTTCCATGGTGTGTCCTTTT,25,2247188
marRp,0.8125,27,15,CTGAGGTGACGCCAGTATAT,12,2239286
marRp,1.5,38,15,CTCCTACGGGCGTCGCGTGA,23,2223237
marRp,1.5,38,15,CTATAAACTGACGTATTGGT,23,2225407
marRp,0.8125,27,15,CTAGCTGGATCGAGCTAACG,12,2249917
marRp,0.3125,19,15,CGGTTACCATTTTTGCCTGA,4,2259184
marRp,5.5,102,15,CGGGGCTAGTGACATTGAAT,87,2218742
marRp,0.8125,27,15,CGGGCGATTTGGTACCCCAA,12,2254360
marRp,1.9375,45,15,CGGCCCGGGTGCCTGACCCT,30,2219923
marRp,0.1875,17,15,CGGCCAGCATGTTTCCGTGG,2,2219353
marRp,4.9375,93,15,CGGATGTGGCTTCGAGAAGC,78,2260050
marRp,0.4375,21,15,CGCTTGAAGGAGAATTGTAG,6,2258226
marRp,0.5625,23,15,CGCCACCCGCACTGTACCCA,8,2246846
marRp,1.75,42,15,CGAACAGTGGCCCATGGTCA,27,2222743
marRp,0.5,22,15,CCTTTGGAAGTGGGACGATA,7,2234645
marRp,7.375,132,15,CCTTTACGGGTCCGACATGA,117,2252770
marRp,0.5,22,15,CCTGGTGGTTGATCAGCGGA,7,2235212
marRp,2.0625,47,15,CCTCGGCGGCGCTCCCGCGG,32,2241981
marRp,1.5625,39,15,CCTATTTGCGCTACGGCACG,24,2235977
marRp,8.25,146,15,CCGTCTCGGGCCGCCGAGGT,131,2232998
marRp,2.0625,47,15,CCCACGATGGACCAAGGTGG,32,2239915
marRp,11.4375,197,15,CCATGGCGTGGTGCGGTTCT,182,2247456
marRp,0.5625,23,15,CCAGAGGTTTCAATTATTGG,8,2220983
marRp,0.3125,19,15,CATTACACTAGCTAACTAGG,4,2221236
marRp,1.6875,41,15,CATTAATCGATTGAAACTGT,26,2225193
marRp,0.375,20,15,CATGGTTGCAGGCCAGGTGC,5,2260905
marRp,0.75,26,15,CATCGGCGAAGCTCACCGGT,11,2233635
marRp,1.0,30,15,CATACCAGCAACCTCTTCAA,15,2220452
marRp,1.0,30,15,CAGTAATGTGCATACATCCA,15,2259713
marRp,0.1875,17,15,CAGGTATGCCAATCGCCCGC,2,2252815
marRp,0.25,18,15,CAGGACACTTTGGGAATTCC,3,2249067
marRp,0.4375,21,15,CAGCGCCTGTGCAAGCTCAA,6,2258247
marRp,0.625,24,15,CACCTTTTCTAACGGTGATT,9,2222192
marRp,0.25,18,15,CACCTTTTACAGCTGACGTG,3,2226876
marRp,9.625,168,15,CAATATGCGCAGTTCGCGCG,153,2241616
marRp,0.5,22,15,CAAGGTGAAGTTCCGGAGTT,7,2217924
marRp,0.75,26,15,ATTTCACCAGGGGGGAGCTT,11,2225783
marRp,1.5,38,15,ATTTAGTATCTAGACTCGCG,23,2253351
marRp,0.5625,23,15,ATTCCTTCGGCGTGGAATTT,8,2247417
marRp,0.5625,23,15,ATTCCGAGACGAGACGCTAG,8,2247830
marRp,0.75,26,15,ATTCCAGTAAATGAGCAACT,11,2238612
marRp,5.5625,103,15,ATGTAGTTATTTGCGCGTGT,88,2220055
marRp,3.875,76,15,ATGGTCCATACCATGGGTTA,61,2252401
marRp,0.5625,23,15,ATGGGTAAGACCATTCGCCT,8,2237309
marRp,0.3125,19,15,ATGCTCGGGCTAAAACTGGA,4,2240858
marRp,6.1875,113,15,ATGATACGGCGTCGTGCCCA,98,2226235
marRp,2.25,50,15,ATCCGCCGTCCGTGTGTTCG,35,2240368
marRp,0.875,28,15,ATATGGAACGGCGCGGGATG,13,2223965
marRp,0.875,28,15,ATACGGGCGCGAAGGATCCT,13,2251023
marRp,9.375,164,15,ATAACACATTGCAAGAAGAA,149,2245684
marRp,1.125,32,15,AGTTCCGGGTCCCAATGAGT,17,2248876
marRp,0.4375,21,15,AGTTACCAAGGGAACCTAGT,6,2221627
marRp,0.5,22,15,AGTGCAAGGGGGTTAACTAG,7,2243722
marRp,4.4375,85,15,AGTCCACGATTGAGGGCGAA,70,2252915
marRp,0.125,16,15,AGTATAAAGTATTCGGTATG,1,2242994
marRp,1.3125,35,15,AGGTTATCGTGTCCGTGATA,20,2234224
marRp,0.5625,23,15,AGGTGAGTCTTGCAGTTGTT,8,2242292
marRp,1.0,30,15,AGGCGTAAACTTGATGGCCC,15,2220961
marRp,1.125,32,15,AGGCGGGTTTCCATCTTTAG,17,2224399
marRp,2.625,56,15,AGGACCTGGCTCATGGAAAG,41,2231199
marRp,1.625,40,15,AGCAATCAAGAGGCTGGGGA,25,2226334
marRp,0.125,16,15,AGACAGTCCCAGACTACGCG,1,2225812
marRp,1.6875,41,15,AGAAGAATGTTCGGGAGTGA,26,2249645
marRp,0.625,24,15,ACTTGCGGAGGCCGCCTCCT,9,2230701
marRp,4.1875,81,15,ACTGTTTACGTGTGGCGGGG,66,2222429
marRp,0.875,28,15,ACTCGTGTTGATGGGCCGAT,13,2249503
marRp,2.6875,57,15,ACTCGTCGCCAACATAGTAA,42,2230412
marRp,1.25,34,15,ACGGTCCATGCGGCCAGACT,19,2226214
marRp,1.0625,31,15,ACGCCCCAGAAGAAACTGGG,16,2220112
marRp,1.0,30,15,ACGATGTCCTTTCAAGGTTA,15,2225272
marRp,1.125,32,15,ACCTGCGAGGAGCCTCGAGT,17,2253550
marRp,9.0625,159,15,ACCGACAATCGTTGTAAATT,144,2224070
marRp,0.5,22,15,ACCCGCTCGCGGAGGCATGA,7,2228913
marRp,2.0,46,15,ACCCCCGGGGCACATCACCA,31,2238085
marRp,0.8125,27,15,ACCAGAGATTGAGGACGGAC,12,2226532
marRp,2.0,46,15,ACCAAGCGTATATTTTATAG,31,2217810
marRp,0.875,28,15,ACCAAATTAACCCAAAGTGT,13,2226010
marRp,0.375,20,15,ACATGCTCGCGCGGTATAAT,5,2235633
marRp,1.4375,37,15,ACACTCCCCGTAGTCCAGGC,22,2246530
marRp,3.125,64,15,ACAATGACTTTGTAACGGCT,49,2226727
marRp,2.4375,53,15,ACAAGCTCGTCATGGAATTT,38,2232552
marRp,0.3125,19,15,AATTTAAGTAATGCTAGAGG,4,2220578
marRp,1.3125,35,15,AATGGTAGAGCCAGCCTTCT,20,2255479
marRp,1.5,38,15,AATCCATATTGGATTATGAC,23,2246738
marRp,0.5625,23,15,AATCATCGCATGTATGCCGA,8,2220675
marRp,1.0,30,15,AAGTGGCCGTATGTTCGCGA,15,2234107
marRp,1.0625,31,15,AAGTCACCTGACCGGCGAGG,16,2249068
marRp,0.5625,23,15,AAGCTTTGCACATCTACTAT,8,2234575
marRp,0.125,16,15,AAGAGTGTTTCACTACTTGT,1,2219973
marRp,0.6875,25,15,AACTCTGGCGATTTTGGTTC,10,2241067
marRp,2.0625,47,15,AACACTAATCCGTCTAACCG,32,2221091
marRp,1.6875,41,15,AACAAATGGATCATTGGCAA,26,2245583
marRp,0.125,16,15,AAAAGCAGAGATCTAAGAAA,1,2223732
marRp,1.4375,37,15,AAAAAGTATTAGAACTGAAC,22,2229038
marRp,1.4,34,14,TTTTCTTAACGAACGTTAAA,20,2224492
marRp,0.6666666666666666,23,14,TTTTATTAACCCCTGGTGTC,9,2235260
marRp,0.2,16,14,TTTGTCCAATTGGGTGTGTG,2,2232029
marRp,3.2666666666666666,62,14,TTTACTCATGGCGTTAACAA,48,2221294
marRp,0.6666666666666666,23,14,TTTACGGGATGCTCACCCGT,9,2221095
marRp,0.8,25,14,TTGTTGCGTCGGCCCATTCG,11,2229541
marRp,1.2,31,14,TTGTTCCGTTAACGCTAGAT,17,2245832
marRp,1.0,28,14,TTGTATGTACGCCACTTATA,14,2221162
marRp,1.2,31,14,TTGTAATCGTAGGTCGCGAC,17,2231260
marRp,0.4,19,14,TTGCAGGTTATTCAGTCAAA,5,2236321
marRp,0.6666666666666666,23,14,TTGCACTATAAAATCCGGAT,9,2246072
marRp,1.2666666666666666,32,14,TTGAGGCACCACCAAGAAAT,18,2252735
marRp,1.0,28,14,TTGAATAGCCTGTACTATAA,14,2229935
marRp,3.7333333333333334,69,14,TTCGGCGCATATAGTTCCAA,55,2243974
marRp,3.8,70,14,TTCATAGAATAACCGGAATT,56,2251227
marRp,2.066666666666667,44,14,TTCACTTCCAGATCATAGCT,30,2223416
marRp,2.4,49,14,TTCAAAGTCACAAAGGGCGT,35,2249018
marRp,5.933333333333334,102,14,TTAGCTTGGATTACGCGACT,88,2256690
marRp,0.8,25,14,TTACGGCGTCTACTAGCTGG,11,2234847
marRp,0.3333333333333333,18,14,TTAATTTATCTACACTGGAA,4,2238572
marRp,1.1333333333333333,30,14,TGTGTTTAACGAGTCATAGC,16,2234008
marRp,2.0,43,14,TGTGGTCAGGCTGCTGACAT,29,2248083
marRp,1.2,31,14,TGTCGCCTAGAAACCTATGT,17,2231486
marRp,1.0,28,14,TGTCCTTTTCTAATGACAGT,14,2254613
marRp,0.5333333333333333,21,14,TGTCCGCCGCGGGGGGCGCG,7,2257464
marRp,0.26666666666666666,17,14,TGTACGGGCGACGTCGGGTC,3,2244264
marRp,5.4,94,14,TGGTAGCATGCGTCGCGGGT,80,2233967
marRp,2.2,46,14,TGGTAGATCAGCTATAAGAA,32,2243696
marRp,0.13333333333333333,15,14,TGGGTGCCCCATAAAAGATA,1,2236325
marRp,2.0,43,14,TGGGAGTTCAATCGCGTTAG,29,2245674
marRp,26.733333333333334,414,14,TGGCTCTCGCAGGAGGGAAT,400,2256413
marRp,1.0,28,14,TGGCAGTGAAGGGCTTGTGT,14,2251141
marRp,8.8,145,14,TGGAGGTGTGCCAAATGTTA,131,2232133
marRp,3.4,64,14,TGCTGTCCAGAGCCGGGACG,50,2254005
marRp,0.8666666666666667,26,14,TGCGCATACAGCAAGCAACA,12,2234458
marRp,1.6666666666666667,38,14,TGCCAAAATGACCGGTCCTG,24,2234499
marRp,1.0666666666666667,29,14,TGCACTGTAATTCGCTAGGA,15,2248914
marRp,25.8,400,14,TGAGGCGAAGTTTCGCGAAA,386,2222758
marRp,0.9333333333333333,27,14,TGAAACTAGATCATCACGTT,13,2242466
marRp,1.8,40,14,TCTTCAGCACCCCGATGTAC,26,2260344
marRp,0.7333333333333333,24,14,TCTGCGAATGCCGTCTTGTT,10,2232649
marRp,2.2,46,14,TCTCAAGGGTCACACTCTGT,32,2257730
marRp,0.8,25,14,TCGTAAATTTCCAGCTATTT,11,2221663
marRp,5.066666666666666,89,14,TCGAGGACTAATGTTCGTAC,75,2242192
marRp,0.6666666666666666,23,14,TCGACTCCCCTCGACACCGA,9,2220231
marRp,10.333333333333334,168,14,TCCGTATTGCTCGCTTGCCA,154,2218558
marRp,4.4,79,14,TCCGGTTAGTTGGGTTTTTG,65,2218927
marRp,1.0666666666666667,29,14,TCCGGGATACACAGGTTGGT,15,2250776
marRp,0.3333333333333333,18,14,TCCATGGGCTCATGGGTTGA,4,2233140
marRp,1.0666666666666667,29,14,TCCACATACGGTCTTCACCG,15,2240730
marRp,0.4,19,14,TCCAATGATCGTGTAGCCGT,5,2231198
marRp,2.6666666666666665,53,14,TCATCTGTGGGTTAGTACCT,39,2234223
marRp,1.1333333333333333,30,14,TCATAAATGCTATTCAATCG,16,2220720
marRp,2.6,52,14,TCACCTGTATCACGCCCAGT,38,2258361
marRp,0.13333333333333333,15,14,TCAACATGGAGGTGAGCCAG,1,2225999
marRp,0.4,19,14,TATTTAAATGGTGGACGCGG,5,2256739
marRp,0.4666666666666667,20,14,TATCTAGCGCCAATCCCATA,6,2219396
marRp,1.3333333333333333,33,14,TATCGATAATCAGCCGTGCT,19,2257043
marRp,0.26666666666666666,17,14,TATCCCCGGAGACAGTCAAA,3,2227973
marRp,0.2,16,14,TACTCTGAGGCCGCATAGTA,2,2246897
marRp,0.13333333333333333,15,14,TAATGGACACCTGTCTGCGT,1,2222318
marRp,5.733333333333333,99,14,TAATCTTGGCGTGGCGGCAT,85,2220748
marRp,0.7333333333333333,24,14,TAAACTTCTGACAGGGAGAA,10,2224404
marRp,3.0,58,14,GTTGAGCATACTCCAAAGAC,44,2250345
marRp,0.26666666666666666,17,14,GTTCTCGCTATACCGCGTTT,3,2252482
marRp,1.0,28,14,GTGTCATACAAATGCCACAT,14,2250575
marRp,9.933333333333334,162,14,GTGGCCCCCGGGGTCGTCCA,148,2219085
marRp,0.3333333333333333,18,14,GTGCCGCGGGAGGGATTGAG,4,2252196
marRp,1.5333333333333334,36,14,GTGCCAGTATTCTTGGCGGT,22,2247089
marRp,0.26666666666666666,17,14,GTGAGACCCACATCCCTGAG,3,2219167
marRp,4.466666666666667,80,14,GTCCAGGTATTTTAGAGATA,66,2225048
marRp,0.2,16,14,GTATGGCGGTGGTTTTAGTA,2,2246246
marRp,8.333333333333334,138,14,GTATGCCGGATATCGGTTGA,124,2218738
marRp,5.2,91,14,GTATGAATGGGGAACTACTA,77,2221314
marRp,1.3333333333333333,33,14,GTAGACACAACACAGGCGGT,19,2256139
marRp,2.533333333333333,51,14,GTAAGGCGAATTTCGAGTTA,37,2255623
marRp,0.5333333333333333,21,14,GGTTGGTATGCTGCTACTGG,7,2225776
marRp,0.9333333333333333,27,14,GGTTAGCGATCGCTCTCGAC,13,2258908
marRp,0.9333333333333333,27,14,GGTGAAACTGTCCCGTAGGT,13,2248405
marRp,0.6666666666666666,23,14,GGTAGGCTCACCTTTCTCAA,9,2224677
marRp,0.8,25,14,GGGTTGAAAATGCCCGGTGA,11,2230559
marRp,0.6,22,14,GGGCCATTTAATTTTGATCC,8,2221995
marRp,0.5333333333333333,21,14,GGGAGTGGTTGAGGCGTTAA,7,2224997
marRp,1.6666666666666667,38,14,GGCTTCCATGGGTCCTCCCG,24,2249016
marRp,1.3333333333333333,33,14,GGCTGTTAATGAGCATGGAG,19,2223920
marRp,2.1333333333333333,45,14,GGCGCGGGAACAGCTGGCCC,31,2229500
marRp,3.8666666666666667,71,14,GGCCTGATCCATGGGGCACT,57,2222737
marRp,0.9333333333333333,27,14,GGCCAATGGTATCGCAAGCA,13,2236193
marRp,0.3333333333333333,18,14,GGATGGAGTGGGCAGATAGA,4,2221405
marRp,1.2,31,14,GGATCCCTCAGTGTTTTCCA,17,2235365
marRp,3.3333333333333335,63,14,GGACGCGAATGCGGGGTACG,49,2229603
marRp,0.8,25,14,GGACAAAACGGGCAAGGAAA,11,2248534
marRp,2.933333333333333,57,14,GCTTGTCTTTGTCTAACGGT,43,2229461
marRp,1.0,28,14,GCTGGCCCATATCTCTCGAC,14,2223759
marRp,0.9333333333333333,27,14,GCTCCTTTTGTTAGCATGCA,13,2244070
marRp,0.3333333333333333,18,14,GCGGAGATGTGCATTATGTG,4,2240217
marRp,2.2666666666666666,47,14,GCCGGAAGTCGTCATGTTCC,33,2223490
marRp,0.4666666666666667,20,14,GCATACGGGAATTTAATGCG,6,2254861
marRp,0.13333333333333333,15,14,GCAGCGTACCCAGAGCTGTA,1,2241016
marRp,0.2,16,14,GCACTTAAGCGAGATGCGGC,2,2250806
marRp,0.7333333333333333,24,14,GCAAAAGCGCCCTAAATAAT,10,2221708
marRp,1.2666666666666666,32,14,GATTGGAAAAGCTCTATAAG,18,2221411
marRp,0.3333333333333333,18,14,GATGTTGTATTGTGAATTCG,4,2236455
marRp,0.7333333333333333,24,14,GATCGCTGGCAGCATCGCAA,10,2236003
marRp,1.8666666666666667,41,14,GAGACGATTCTGTAAGTCAG,27,2233446
marRp,0.2,16,14,GAGAAGCAAGCCCAATCCGA,2,2220454
marRp,0.7333333333333333,24,14,GACTGTGGGAGGGTATGGAC,10,2249255
marRp,1.0666666666666667,29,14,GACCCGTTTCGAGACTGGAG,15,2253346
marRp,2.6666666666666665,53,14,GAAGCCTGGGAACCCGTTAA,39,2260817
marRp,0.2,16,14,GAACAGGAGCGATGGGTATG,2,2235060
marRp,1.8666666666666667,41,14,CTTCGTAGTAGGGAGAGAGG,27,2234148
marRp,0.13333333333333333,15,14,CTTCGGCGCTAATGCGCATT,1,2246349
marRp,4.133333333333334,75,14,CTTCCTTTCGCCTGCTTGCA,61,2248199
marRp,0.8666666666666667,26,14,CTTCCTACTAATGACCACCT,12,2233924
marRp,1.0,28,14,CTTCCATTACTCGTATCTCG,14,2235026
marRp,1.4666666666666666,35,14,CTTCATTGTTAGAAAAGCGG,21,2252273
marRp,0.6666666666666666,23,14,CTGGTGACTTCCTAGCAGAA,9,2252742
marRp,0.4,19,14,CTGCGCTTGCCATCGCCAGA,5,2227460
marRp,0.6,22,14,CTGATTTGTGTATCCGGTGA,8,2236187
marRp,10.2,166,14,CTCTATACGGGATCTAGTAA,152,2240782
marRp,0.13333333333333333,15,14,CTCGCCGCTCCTTCGGTTAC,1,2227211
marRp,0.9333333333333333,27,14,CTCGACTGGTATACGGAACA,13,2241197
marRp,0.26666666666666666,17,14,CTCCAACCACAGAAAATCTC,3,2218375
marRp,7.933333333333334,132,14,CTAGTAATAACCCAGCGTCG,118,2250959
marRp,0.7333333333333333,24,14,CTAGGCATATCACATGCATC,10,2239046
marRp,0.4666666666666667,20,14,CTACTCTTAGTGCGGTATCC,6,2233593
marRp,0.8,25,14,CTACCTACGGTGAGATCAAG,11,2249427
marRp,3.0,58,14,CTACATCCCGTGAAAAACGA,44,2237497
marRp,0.3333333333333333,18,14,CGTTTTCTTGACGTGCAGAT,4,2218931
marRp,0.4666666666666667,20,14,CGTTTAGGGCAGGCTCTGAA,6,2251455
marRp,2.3333333333333335,48,14,CGTTGTAGACCACCGAGATT,34,2236763
marRp,0.5333333333333333,21,14,CGTTCGAGAATTTGGGCCGT,7,2242936
marRp,1.0666666666666667,29,14,CGTGTGCTAATTAGTACGGT,15,2229600
marRp,0.2,16,14,CGTGGCATTCAGCACTGTCA,2,2254495
marRp,0.26666666666666666,17,14,CGTGACATCGTGCCTGCGGA,3,2230352
marRp,7.6,127,14,CGTATGTGCTGAATTTATTT,113,2222407
marRp,3.1333333333333333,60,14,CGTAGAGAACCGGCAATATT,46,2224126
marRp,1.9333333333333333,42,14,CGGTAGCCCTACAACGATCA,28,2231400
marRp,0.5333333333333333,21,14,CGGCTTGGTGGTCAGCTAGC,7,2258104
marRp,1.6,37,14,CGGCTATCTCACCGGTTTCA,23,2248805
marRp,0.26666666666666666,17,14,CGGCCTTTCATTACCACTTA,3,2252014
marRp,4.066666666666666,74,14,CGCCCCGACCGTTTAAGGCA,60,2236039
marRp,0.6666666666666666,23,14,CGCATTAACCTTCGCTACTA,9,2242110
marRp,1.0,28,14,CGATTGTTACTCTAGGTCAT,14,2240110
marRp,1.7333333333333334,39,14,CGATTCATCTGAAATCTTTG,25,2256304
marRp,1.8666666666666667,41,14,CGATTCAAAAGTGTAACCAG,27,2237860
marRp,0.2,16,14,CGACCGGACTGCACTCTTAA,2,2247097
marRp,0.5333333333333333,21,14,CGACCAGAGTAGGCTGTAAC,7,2221844
marRp,9.066666666666666,149,14,CCTCATTACCGATGGACTCC,135,2249779
marRp,1.9333333333333333,42,14,CCGTCACGGAAAATTGCTCC,28,2235467
marRp,0.13333333333333333,15,14,CCGTATGTCCAATTCTCTCA,1,2218545
marRp,0.4,19,14,CCGTATCATCTTCCTCTATT,5,2232464
marRp,1.8,40,14,CCGCTGATATAGGAAAGGCT,26,2226142
marRp,0.3333333333333333,18,14,CCCTGGTTTTAGATTTCACT,4,2227839
marRp,0.6,22,14,CCCGGCCTTCGAGAGATACT,8,2247556
marRp,1.8666666666666667,41,14,CCCCGTCACATGGCTTGTCT,27,2218647
marRp,4.466666666666667,80,14,CCAGTTATAATCCGCAACCG,66,2222231
marRp,4.933333333333334,87,14,CCAGGATCTCCGGGTAACAA,73,2231574
marRp,0.4666666666666667,20,14,CATCCCGTGATGAATCTCTG,6,2243241
marRp,0.5333333333333333,21,14,CATATGCCGAAGTAGTAGTT,7,2218597
marRp,1.0666666666666667,29,14,CAGTACTTCTGGCGTCCAAT,15,2257821
marRp,1.5333333333333334,36,14,CAGGTATGTGATACTTCGCT,22,2221317
marRp,1.5333333333333334,36,14,CAGGGCATGAAGATGCCGAG,22,2246070
marRp,0.2,16,14,CAGCTCGCCTGCATAATGCC,2,2231965
marRp,6.6,112,14,CAGCTCCGCCCCATAGTGCG,98,2244403
marRp,1.2,31,14,CAGATGACAGATCACAGATA,17,2259618
marRp,3.4,64,14,CAGAGTCATTTCAGTCCATT,50,2223314
marRp,0.6,22,14,CACGTCGCAAAGAAGACCCT,8,2257148
marRp,17.933333333333334,282,14,CACGGGGGGTAGGCGCGACA,268,2259765
marRp,0.13333333333333333,15,14,CACCTTAGGGAAAAAGACGA,1,2237277
marRp,0.4666666666666667,20,14,CACCTTACCCGAAAACACGG,6,2230973
marRp,1.8,40,14,CACCTCTATCGGGGTTCGAA,26,2260507
marRp,4.333333333333333,78,14,CACCGCGGCGGACATCGGCA,64,2219320
marRp,3.2666666666666666,62,14,CACAAGGTATCTCAAAGGTC,48,2250850
marRp,0.3333333333333333,18,14,CAATGTTAGTTACCGCTCGT,4,2243345
marRp,3.3333333333333335,63,14,CAATGGGTTGCTGTATCAAA,49,2256985
marRp,14.4,229,14,ATTTGACCGATCGTACATGA,215,2231933
marRp,4.733333333333333,84,14,ATTCTATCGGAGAGCGGAAT,70,2246014
marRp,1.4,34,14,ATTCATTCAGCACCTCTTAT,20,2223417
marRp,1.0,28,14,ATTAATGTGTGCAAAATGTA,14,2230523
marRp,2.8,55,14,ATGTGTGGGGCTCTGCTACA,41,2244796
marRp,2.1333333333333333,45,14,ATGGCGAGGTAATTCCTATG,31,2221060
marRp,1.8,40,14,ATGCAGCCAAACGGGCTCTA,26,2228870
marRp,11.6,187,14,ATCCTTGGCCCTCCCTGTTG,173,2255994
marRp,0.4666666666666667,20,14,ATCAGTTGTGGGCGGCCTGA,6,2226216
marRp,5.533333333333333,96,14,ATCACACAGTCAGGCGACGA,82,2226601
marRp,0.3333333333333333,18,14,ATCAACAAGAACTGTTTCAT,4,2256523
marRp,0.8,25,14,ATATGGCATAGCTGTTATCT,11,2221597
marRp,1.7333333333333334,39,14,ATATATCCGGAAGCATCTTT,25,2252575
marRp,0.13333333333333333,15,14,ATAGACGCATACATACCGGT,1,2255480
marRp,0.13333333333333333,15,14,AGTTCGGCGGCGGTTAAATT,1,2245120
marRp,3.533333333333333,66,14,AGTGCGATCGTACCGGGACG,52,2219759
marRp,0.6,22,14,AGTGCCCTGGAACAGGCTAC,8,2246630
marRp,2.466666666666667,50,14,AGTCCAAGAATATGCATTCC,36,2238514
marRp,1.5333333333333334,36,14,AGTATACCTGCGGAATATGC,22,2232376
marRp,3.933333333333333,72,14,AGGAAGGCTTATTACGAGCT,58,2244007
marRp,0.9333333333333333,27,14,AGGAACTTTAGCGGGAAGTT,13,2252636
marRp,1.0,28,14,AGCTATCGTAAGAGTGCGGC,14,2254444
marRp,1.5333333333333334,36,14,AGCTAGTAAGATCAAAACAA,22,2238026
marRp,2.4,49,14,AGAAGAGGTGCGCGCGTGAG,35,2258687
marRp,1.4,34,14,ACTTTACACGGATTTAAAGT,20,2242670
marRp,0.3333333333333333,18,14,ACTTGCCCGCAAAATACAAC,4,2219671
marRp,0.6,22,14,ACTGTAATAAAGGGAAGTTC,8,2250344
marRp,1.2,31,14,ACTGATGTAGGTGCTGCTCC,17,2221225
marRp,1.0666666666666667,29,14,ACTCTAGGCTTATATCAGCT,15,2225188
marRp,0.13333333333333333,15,14,ACGTGCTTACATGAGCTATA,1,2259262
marRp,0.8,25,14,ACGTACTGACGGTAGAGATT,11,2230092
marRp,2.7333333333333334,54,14,ACGCTGCGCAGGTGAATACA,40,2246375
marRp,0.3333333333333333,18,14,ACGACATTGGCTTGACGATG,4,2250034
marRp,0.6,22,14,ACGAATCGGAGAAGCATAAT,8,2248040
marRp,0.13333333333333333,15,14,ACCTTCCCTAGAGAGGAAAG,1,2230729
marRp,2.066666666666667,44,14,ACCTATTCGTTCTCTAATGT,30,2231493
marRp,0.6,22,14,ACCTATAGAAAAATGGCGCA,8,2233671
marRp,6.666666666666667,113,14,ACCGGCCCAGGCACGGTGCC,99,2247294
marRp,6.466666666666667,110,14,ACCGACGCATCTCGCGCGGG,96,2242401
marRp,0.26666666666666666,17,14,ACAGTGGCCCGGCCCACGGA,3,2249276
marRp,0.7333333333333333,24,14,ACAGGATCCAGTATCAAGGC,10,2228687
marRp,0.26666666666666666,17,14,ACACCGTCAAGGAAGACTCG,3,2254030
marRp,5.0,88,14,ACACACTGTATTTTGCACGT,74,2233994
marRp,2.066666666666667,44,14,AATTTCATTCGCGGCAAGTT,30,2245278
marRp,4.0,73,14,AATGTTGTCCGGTATATCGT,59,2254445
marRp,2.2,46,14,AAGGGTTCGGTTAATCGATT,32,2250534
marRp,2.8,55,14,AAGAGAGGACGAGGTTTATT,41,2250162
marRp,2.1333333333333333,45,14,AACGTTGTGTACAGCCGGCT,31,2218752
marRp,4.066666666666666,74,14,AACCTAGTCGGCAGGTACCA,60,2256699
marRp,3.1333333333333333,60,14,AACCATACCGCGCATCGCCA,46,2244976
marRp,0.9333333333333333,27,14,AACACCTATACGGACCTTAA,13,2258217
marRp,1.0666666666666667,29,14,AAATGCTTCGGTATAGTGTG,15,2234609
marRp,0.2,16,14,AAATACGTATCACGCACGTG,2,2258970
marRp,2.2666666666666666,47,14,AAAGTCGTCTCAGGACTCCT,33,2224633
marRp,0.7333333333333333,24,14,AAAGCGCGGGCGGAGACGTA,10,2255666
marRp,19.266666666666666,302,14,AAAAGACCGTATGGACGACT,288,2222350
marRp,15.8,250,14,AAAACGATCACTCCGGATAC,236,2248007
marRp,0.8571428571428571,24,13,TTTTCGGGCTTCTTCCCGCA,11,2227145
marRp,1.0714285714285714,27,13,TTTGTACGGGCGGGTCGATA,14,2229012
marRp,2.7142857142857144,50,13,TTTGCAAACGAGGGTGTTTA,37,2251530
marRp,1.2857142857142858,30,13,TTGTCGATCGGGATACAGCA,17,2236541
marRp,1.2142857142857142,29,13,TTGTAACCTAAATCTGCTCT,16,2254624
marRp,2.357142857142857,45,13,TTGGTGAGATGTGCCATAAA,32,2240698
marRp,0.42857142857142855,18,13,TTGGCAAACCATAAGTCGCT,5,2258113
marRp,0.6428571428571429,21,13,TTGCTCGACTTTGAAGGTAT,8,2233356
marRp,0.9285714285714286,25,13,TTGCGCAGAGTGTTAGACGG,12,2225624
marRp,0.35714285714285715,17,13,TTGATAGAGTGAATGCGCCA,4,2233505
marRp,1.7857142857142858,37,13,TTGAGCGTTTCACTAGCTCT,24,2260010
marRp,1.0714285714285714,27,13,TTCTGCTGAATGTCTATCTT,14,2242652
marRp,0.42857142857142855,18,13,TTCGTAGTACCGGGCGCACG,5,2252608
marRp,3.857142857142857,66,13,TTCCGAAGGTAGCTGTTGTT,53,2230320
marRp,4.071428571428571,69,13,TTATAGATCGCTTGTGGTAC,56,2235300
marRp,0.21428571428571427,15,13,TTAGAATTGCCGCGAAGGCA,2,2252219
marRp,0.35714285714285715,17,13,TTAACGTAGCTCTTGCTCTA,4,2244442
marRp,1.5714285714285714,34,13,TTAAAGCCGGCCGAGCTTCT,21,2253436
marRp,0.14285714285714285,14,13,TGTTTCTAGCGGGTAAAGTG,1,2246688
marRp,0.35714285714285715,17,13,TGTTGCCAGGGGGGGAATGT,4,2227736
marRp,7.642857142857143,119,13,TGTCGTACTGGAGGGGAACT,106,2233970
marRp,0.5,19,13,TGTCCCCCTTATCTACGGGA,6,2232659
marRp,1.7857142857142858,37,13,TGTCAACGCCTTCCTTTGTA,24,2238876
marRp,0.2857142857142857,16,13,TGGTCAGCCATTGAGCGTCA,3,2230338
marRp,2.5714285714285716,48,13,TGGGAACCTGTTATTCTCAA,35,2224093
marRp,16.785714285714285,247,13,TGCTCTCACGATTACCGGTG,234,2243891
marRp,0.8571428571428571,24,13,TGCTAATCTTCGATTAGTGG,11,2237408
marRp,3.0,54,13,TGCGCCCAAACATCGACCAA,41,2228548
marRp,0.7857142857142857,23,13,TGCCCTGATATTAGGTCTCC,10,2223006
marRp,2.857142857142857,52,13,TGCCCGAACCATGCATCTTA,39,2246647
marRp,1.9285714285714286,39,13,TGATCCGAGCCGCCGGGCAA,26,2234268
marRp,0.35714285714285715,17,13,TGAGGGCATTTAGACAGTTG,4,2235990
marRp,2.0,40,13,TGAGCGGCAACTTCCCTAGC,27,2228910
marRp,0.9285714285714286,25,13,TGACGCTACCGTCCCGTCGC,12,2254922
marRp,1.2142857142857142,29,13,TCTTTTTCACGCTCTCATAG,16,2234644
marRp,2.5,47,13,TCTTATGCTAGGAAGTCTCG,34,2223380
marRp,0.14285714285714285,14,13,TCTGGGGTTGATCCATCAGT,1,2256670
marRp,1.0714285714285714,27,13,TCTCGGGGTTTCAGGCATGA,14,2246206
marRp,2.7857142857142856,51,13,TCTCATTGGTTAAACGGTAA,38,2223883
marRp,4.071428571428571,69,13,TCGGTTCACTCGCTGGGATA,56,2234324
marRp,17.928571428571427,263,13,TCGGGGTGTCAACTGTGCAT,250,2237454
marRp,0.8571428571428571,24,13,TCGGGGGTAGGGATCCGACT,11,2250590
marRp,1.9285714285714286,39,13,TCGGGAGGCATTATGGTAGT,26,2248118
marRp,1.2142857142857142,29,13,TCGGAAGTAGGTCTCGGTCG,16,2234848
marRp,0.7142857142857143,22,13,TCGCGACCCGGAGGCGGGAA,9,2226867
marRp,0.6428571428571429,21,13,TCGACCTTAACCAAAGAGTA,8,2232082
marRp,0.2857142857142857,16,13,TCGAAGGGGTAGAAAATCAG,3,2227826
marRp,0.7142857142857143,22,13,TCCCGAGAGTGGTCGCTGAG,9,2243391
marRp,0.7857142857142857,23,13,TCCAGTGGGCATAATGAACT,10,2217991
marRp,0.5,19,13,TCATCGCCTGTACAATTTTT,6,2220178
marRp,8.5,131,13,TCACTGTCATAGTAGCTCGG,118,2224830
marRp,0.5,19,13,TCACACGCCCCCAAAGGCCA,6,2238818
marRp,0.14285714285714285,14,13,TCAATTTTGGATGTTGCTGG,1,2243398
marRp,7.5,117,13,TAGGTCTTACTTCACGAGCT,104,2259655
marRp,0.9285714285714286,25,13,TAGGGCTATTATTCGTTATA,12,2244345
marRp,43.57142857142857,622,13,TAGGATGGATTGGCACGCCT,609,2240614
marRp,26.142857142857142,378,13,TAGCTAAGGCAATTAATCTG,365,2232741
marRp,0.7142857142857143,22,13,TACCTTGACCTGGGTGAGAC,9,2227553
marRp,0.21428571428571427,15,13,TACACAGATGATGGAATCTA,2,2236343
marRp,1.7857142857142858,37,13,TACAAATACAGTTGAGAACA,24,2234381
marRp,0.7142857142857143,22,13,TAAATGTTTGCTAAAGCATA,9,2225977
marRp,0.6428571428571429,21,13,TAAAGTATCGTCTCTGATAA,8,2229865
marRp,1.7142857142857142,36,13,TAAAGGCGTATTCGAGCGTA,23,2239238
marRp,5.071428571428571,83,13,GTTTTCTGTAAACAGACAAG,70,2240763
marRp,1.4285714285714286,32,13,GTTCCCCTGGCACACCGAAA,19,2246236
marRp,0.6428571428571429,21,13,GTTAGCGAAAATGAACCAAG,8,2240067
marRp,1.3571428571428572,31,13,GTGGCCTTCTGGCTTATAGT,18,2247413
marRp,0.5714285714285714,20,13,GTGACTCTCTAGACAGGTGC,7,2248684
marRp,4.357142857142857,73,13,GTGACAGACCTTAATAATGG,60,2256424
marRp,0.5714285714285714,20,13,GTCAGCGCGTCGTTGCTTAC,7,2237852
marRp,0.42857142857142855,18,13,GTCACTACTTACTCAGTGAA,5,2218208
marRp,1.7857142857142858,37,13,GTAACTTTCGACGCAGTAGT,24,2227542
marRp,0.5,19,13,GTAAATGATGGGTGCGTTTT,6,2256106
marRp,0.7142857142857143,22,13,GTAAAGGTCTGTGTGGAACT,9,2256952
marRp,0.14285714285714285,14,13,GGTTTCCAGATCATTAGTGC,1,2242813
marRp,0.2857142857142857,16,13,GGTACTCGAGAAGGCCGAAT,3,2228607
marRp,1.2142857142857142,29,13,GGTAACAGCCCAGAGACACA,16,2246646
marRp,0.14285714285714285,14,13,GGGGTTGAGCTAACCAAAGC,1,2244695
marRp,2.0,40,13,GGGGGCTATGTATCGAGTGC,27,2232629
marRp,4.142857142857143,70,13,GGGCACGACAATTGGGTCGT,57,2235288
marRp,0.14285714285714285,14,13,GGGATTCATTTCCCTAGGGT,1,2259364
marRp,1.0,26,13,GGGACAGCACTGCCGCTCAG,13,2258794
marRp,8.142857142857142,126,13,GGCTGTGAGTTCACAAGTCT,113,2232175
marRp,3.0714285714285716,55,13,GGCGGACAACATAATTGGGC,42,2237153
marRp,0.6428571428571429,21,13,GGCCCGCGACCTGTAGCCGA,8,2221842
marRp,1.1428571428571428,28,13,GGATTCCTACAGCATGCACT,15,2227578
marRp,1.5714285714285714,34,13,GGATTAGAGTCGTCTTGCAT,21,2246827
marRp,1.6428571428571428,35,13,GGAGTACCACTGAACGTCAA,22,2230803
marRp,0.2857142857142857,16,13,GCTTATTGGTTAGCTTAGTA,3,2254868
marRp,6.357142857142857,101,13,GCTGTGCAACAAAGTACGTT,88,2224907
marRp,1.2857142857142858,30,13,GCTGAGATAGAACAATTCAC,17,2256407
marRp,0.2857142857142857,16,13,GCTCCTACTGGTCGCAATGC,3,2254164
marRp,7.714285714285714,120,13,GCTCAAGAAGTTAGCGTAAT,107,2241982
marRp,2.0,40,13,GCTAGACTGGTTCCCTTAGA,27,2237191
marRp,0.35714285714285715,17,13,GCGTTGGGTTTACTAATCAG,4,2225952
marRp,2.4285714285714284,46,13,GCGTTCGGGAACCTGTACTT,33,2252910
marRp,0.2857142857142857,16,13,GCGTGTTTGGCCAAAATGTT,3,2256499
marRp,0.9285714285714286,25,13,GCGGTTATATATCTTTTCGT,12,2243614
marRp,2.0714285714285716,41,13,GCGGTCCAACCCTTGCCGAC,28,2254816
marRp,13.071428571428571,195,13,GCGGGGGGAGGCGTAGGCCC,182,2248564
marRp,9.0,138,13,GCGCTGCTCTGGTCAACGAG,125,2235685
marRp,0.42857142857142855,18,13,GCGCGTGCCCGAAGTCAAGA,5,2242318
marRp,0.21428571428571427,15,13,GCGCCTGCATACATACGAGA,2,2226461
marRp,0.5,19,13,GCGAAGAGCAGCTGGACATT,6,2232017
marRp,0.2857142857142857,16,13,GCCTTTTCCAGGTCCGAGGC,3,2226869
marRp,0.21428571428571427,15,13,GCCTGGGGACCTTACCAAGA,2,2246313
marRp,0.2857142857142857,16,13,GCCTCTATTCGTGTAGATAA,3,2249982
marRp,0.5714285714285714,20,13,GCCGGGTGGCAAAATCAGTA,7,2223709
marRp,0.5,19,13,GCCCGGAGCGTATGAAAATG,6,2224279
marRp,0.7857142857142857,23,13,GCCCCACGCTACATCAGGCC,10,2245629
marRp,7.785714285714286,121,13,GCCAGATTCGTGAGCAACTA,108,2229474
marRp,1.3571428571428572,31,13,GCATTGTTCCCCCCGTCTCT,18,2258765
marRp,0.6428571428571429,21,13,GCATGGCACGCTACATCTTT,8,2219165
marRp,0.14285714285714285,14,13,GCAGGTCGGAGAATTATTAC,1,2230026
marRp,2.7142857142857144,50,13,GCAGCGTGGCAGTCCCAAGA,37,2220045
marRp,4.214285714285714,71,13,GCACGCTGTCGCTATGGGAC,58,2231175
marRp,0.5714285714285714,20,13,GCAATTTGTTTCGGTCCATA,7,2224973
marRp,0.5714285714285714,20,13,GATTACTTTGACAATTGATA,7,2240064
marRp,1.1428571428571428,28,13,GATATGGCGCGCATTGGCCT,15,2248751
marRp,0.42857142857142855,18,13,GATAGTAGTCGCCGCTAATA,5,2258839
marRp,0.2857142857142857,16,13,GATAATGGCTCGAGCGATGT,3,2250804
marRp,3.0,54,13,GAGGACCAATCCGCGGGCGG,41,2240509
marRp,0.5,19,13,GACTTCGGGTGCCCGAATAA,6,2227972
marRp,1.8571428571428572,38,13,GACGCAATGCCAATCCCTAG,25,2249701
marRp,0.7857142857142857,23,13,GACCGTCCGAAGTCGATATG,10,2222784
marRp,0.5,19,13,GACATGGACGTAACTTCGAT,6,2227724
marRp,2.2857142857142856,44,13,GAATGCCTCGCGCCCTGGGG,31,2255346
marRp,0.7142857142857143,22,13,GAATAAGAGTTCACATCATA,9,2249256
marRp,0.42857142857142855,18,13,CTTCGGTAGCGTCTAGACAT,5,2225837
marRp,0.21428571428571427,15,13,CTTAGAAGACGACGAATAAT,2,2246234
marRp,2.5,47,13,CTTAAAGGTCCACCTCCAGA,34,2222051
marRp,0.2857142857142857,16,13,CTTAAAGATGTTGTCCCCAG,3,2219402
marRp,0.5714285714285714,20,13,CTGTGGCCATTCAACATCTA,7,2228493
marRp,1.3571428571428572,31,13,CTGGTAGTAGACAGAGATAA,18,2241779
marRp,0.42857142857142855,18,13,CTGAGCGTTATTACGCGAAG,5,2240654
marRp,0.42857142857142855,18,13,CTCCAATAGATGGGTCACGT,5,2222451
marRp,0.14285714285714285,14,13,CTCAGGGTATTTATATCGTC,1,2251567
marRp,1.2142857142857142,29,13,CTATAACAATATTCTCGGTA,16,2254358
marRp,2.857142857142857,52,13,CTAGTCATGCGATCCGAATT,39,2255936
marRp,2.7142857142857144,50,13,CTAGGGCAAGTTTGTAAAGA,37,2249544
marRp,6.571428571428571,104,13,CGTTGGACCTGTCTTCGACA,91,2229238
marRp,0.7142857142857143,22,13,CGTTATCCCAGGCTTCCTAA,9,2235904
marRp,0.6428571428571429,21,13,CGTATATCTGGTCACATGGT,8,2223731
marRp,1.7142857142857142,36,13,CGTAATTATGTATGATTAGT,23,2230319
marRp,0.6428571428571429,21,13,CGGCGATCGCCCTGGGCGAT,8,2256745
marRp,1.0,26,13,CGGACGGCGGTCACAGATCG,13,2250800
marRp,1.0,26,13,CGCTGATACCTCAATTAGCA,13,2240371
marRp,0.21428571428571427,15,13,CGCTCGTAGCTTGCGTGATA,2,2225982
marRp,0.8571428571428571,24,13,CGCGGCTTCTATGAACGTCC,11,2258118
marRp,2.5,47,13,CGCATCTGCCCGGAATTATT,34,2250358
marRp,1.0714285714285714,27,13,CGCACTGAAACGGAACACTG,14,2222474
marRp,0.7857142857142857,23,13,CGATTCAACGGTCCTCTTCG,10,2229349
marRp,0.42857142857142855,18,13,CGACCTCTTTCTTCTGACCA,5,2247941
marRp,0.9285714285714286,25,13,CGACATATCACGCGCTGCGC,12,2219180
marRp,0.5714285714285714,20,13,CGAATGGAACTCCTGAAGAA,7,2221772
marRp,2.0,40,13,CCTTACGTGGAGGTTTTTGC,27,2260695
marRp,0.42857142857142855,18,13,CCTCATAAGCGGCAACTGGC,5,2237842
marRp,0.7857142857142857,23,13,CCTCATAAGCCAAGGCGTAC,10,2248960
marRp,0.2857142857142857,16,13,CCTCACGTCGGTGAGCCAAG,3,2250030
marRp,0.5714285714285714,20,13,CCTAACGGTTATCTCTCGTG,7,2219673
marRp,1.1428571428571428,28,13,CCGCATGAAGATTTAGCAGG,15,2234775
marRp,0.42857142857142855,18,13,CCCTCCGGGCCAGTGATCCA,5,2231727
marRp,1.4285714285714286,32,13,CCCCAGTGGATGAGTCGCCA,19,2252275
marRp,0.8571428571428571,24,13,CCATGTGCCCATAAGGGCAG,11,2259163
marRp,5.357142857142857,87,13,CCATCTTAAGCTCGTTCGCT,74,2251345
marRp,0.9285714285714286,25,13,CCAGGTGGAAACCCGCGGTG,12,2229654
marRp,0.6428571428571429,21,13,CCACCTCCGGGCTAGAGTGA,8,2221398
marRp,0.42857142857142855,18,13,CCACAGAGGCCTATTGTAAC,5,2254744
marRp,1.2857142857142858,30,13,CCACACCATGGTCGGCAGGT,17,2228610
marRp,7.928571428571429,123,13,CCAATTCTGTAGTTGGGCGA,110,2233252
marRp,1.0,26,13,CATGCGGCACGACTCACGGA,13,2244510
marRp,1.3571428571428572,31,13,CATCAACACAGTCGGGCTGC,18,2221592
marRp,0.21428571428571427,15,13,CATATGCGATAAACAGCATG,2,2249071
marRp,1.0,26,13,CAGTCTGCTGGGCCTCAATA,13,2254798
marRp,1.5714285714285714,34,13,CACGGAGGGGCAGCTCAAAA,21,2247942
marRp,2.7142857142857144,50,13,CAATGTGAAAGGGGCCAGCA,37,2222292
marRp,0.5714285714285714,20,13,CAATGGGCTCGTAAGTGCCA,7,2233587
marRp,0.14285714285714285,14,13,CAATGCCACAGGGACCCACA,1,2241665
marRp,5.071428571428571,83,13,CAAGTTCGTAGGGATGTAGT,70,2245505
marRp,13.785714285714286,205,13,CAAGGACTTGTAAGATGAAT,192,2248013
marRp,1.2857142857142858,30,13,CAAAAGCCCCGGGGGCTACT,17,2232554
marRp,0.14285714285714285,14,13,ATTTGTTTGTAAATTCTCCC,1,2260009
marRp,1.4285714285714286,32,13,ATTTGACGACCCGGCCCCAC,19,2242790
marRp,0.14285714285714285,14,13,ATTACTTCACGGTCTCGCAA,1,2221841
marRp,2.857142857142857,52,13,ATGGACAGGACATGTAAGGT,39,2219479
marRp,1.1428571428571428,28,13,ATGCGTAGGGGTTAGTTATT,15,2252804
marRp,0.42857142857142855,18,13,ATGCCCTTGGCTGCCAGCAG,5,2227813
marRp,0.2857142857142857,16,13,ATGCAGTAGCTGAAGTAGAG,3,2222678
marRp,1.4285714285714286,32,13,ATGACACATGTAACGCGGGT,19,2237748
marRp,1.7142857142857142,36,13,ATCTGTTACTCTGCGCCTTG,23,2222278
marRp,2.0,40,13,ATAGGTGAAGGAATCATGCA,27,2250671
marRp,19.428571428571427,284,13,ATACACAATGGCAAGGTGGA,271,2248571
marRp,0.5,19,13,AGTTAGTTCGCAAATGGAAT,6,2251173
marRp,0.6428571428571429,21,13,AGTCAGAATCCTGGTCAGAG,8,2257243
marRp,1.7142857142857142,36,13,AGTATCGTGGAGGAGAAGGA,23,2241777
marRp,1.9285714285714286,39,13,AGTAAGTCGCTAAATGGCTG,26,2246540
marRp,0.5,19,13,AGCGATTAATATACGTCAAA,6,2222468
marRp,1.0714285714285714,27,13,AGCCTCCGGAATAGTCGTTA,14,2253837
marRp,0.7142857142857143,22,13,AGCCTAACCACAGCCCGGAG,9,2225359
marRp,0.21428571428571427,15,13,AGAGGTCATCTACTATATTA,2,2253274
marRp,0.42857142857142855,18,13,AGAGCAAACATGGACGTAGT,5,2247246
marRp,2.2857142857142856,44,13,AGAATCCGTCACCTGCAAAC,31,2222033
marRp,3.2857142857142856,58,13,AGAAGAAATCCCCTAGGTAT,45,2226156
marRp,0.6428571428571429,21,13,ACTGCGCTCTCTGGAGGAGC,8,2220472
marRp,0.21428571428571427,15,13,ACTGAAACAAGGTCACTGGC,2,2218930
marRp,0.5,19,13,ACGTTCCAATTCACACGGCT,6,2232264
marRp,0.5714285714285714,20,13,ACGTGCTGGCACGGACGGGT,7,2231225
marRp,0.2857142857142857,16,13,ACGGGAGACCGCGAAACGGT,3,2218114
marRp,0.35714285714285715,17,13,ACGGCTTTCTATACATAGAG,4,2251375
marRp,4.357142857142857,73,13,ACGCTCGTCTTGGCAGAAAG,60,2256992
marRp,0.6428571428571429,21,13,ACGATTGGATACACCGTTTA,8,2234741
marRp,2.0,40,13,ACGATGTGTCTCTCGGGCTG,27,2246527
marRp,2.0714285714285716,41,13,ACGACTCTACGCCAAGATAC,28,2238971
marRp,0.5714285714285714,20,13,ACCCATTGTGCCCCGGAGAT,7,2218459
marRp,9.642857142857142,147,13,ACCAGGGTAAACACTTTGAG,134,2223262
marRp,0.2857142857142857,16,13,ACCAGGAGGCAATAACACGA,3,2224487
marRp,0.5714285714285714,20,13,ACATATTAATCCCACGGTTA,7,2235362
marRp,3.0,54,13,ACACTTACTTGGACGGTGTC,41,2223083
marRp,8.857142857142858,136,13,ACACGGCTCTACAACACCAT,123,2228178
marRp,1.6428571428571428,35,13,ACACATGAGTGTCAGCAGAC,22,2235774
marRp,0.5,19,13,AATGGAGTGTCCTGTACGAT,6,2231268
marRp,0.42857142857142855,18,13,AATCGCCTGCGTTCGGCGAA,5,2229903
marRp,0.42857142857142855,18,13,AATATCGAGAGGGCGACCGG,5,2248927
marRp,0.2857142857142857,16,13,AAGTTGGTAGAGACGTGGAA,3,2236715
marRp,1.3571428571428572,31,13,AAGGGTGCAATAGTCTCAAC,18,2224258
marRp,1.6428571428571428,35,13,AAGGAGGATCACGTTTCCGG,22,2220664
marRp,1.0,26,13,AACTTAACAATGTTTTGATG,13,2227459
marRp,0.5714285714285714,20,13,AACCCCCTGATACAGTTTTC,7,2229773
marRp,1.0714285714285714,27,13,AACCATCATCTAGTGCTTTC,14,2228786
marRp,0.6428571428571429,21,13,AACATGTGCTCAAAGTCCAT,8,2222615
marRp,0.7857142857142857,23,13,AAATCGGGGTATATTTCTTA,10,2245941
marRp,1.0,26,13,AAATCAGACCAACAACGATG,13,2229010
marRp,4.428571428571429,74,13,AAAGTAGCTATCGACTAAGT,61,2252771
marRp,0.35714285714285715,17,13,AAAGGGTTCGTGTCAACCCG,4,2230088
marRp,0.7857142857142857,23,13,AAAAGGAGGGCACATCTAAC,10,2224716
marRp,2.5,47,13,AAAAACCCCAGTAGTATCAA,34,2240888
marRp,3.6153846153846154,58,12,TTTCGGTCCACTCTTCAAGA,46,2254466
marRp,1.3846153846153846,29,12,TTTATTTCCTCAAATGGGCG,17,2229540
marRp,1.1538461538461537,26,12,TTGCAGTCGCGCCGCCATCA,14,2234903
marRp,1.5384615384615385,31,12,TTCAAAGAACCGACCTGACG,19,2220644
marRp,0.23076923076923078,14,12,TTACTGCCCTGCGGTCAACG,2,2232656
marRp,0.23076923076923078,14,12,TTACTAAAGTCCGACACCTC,2,2220878
marRp,7.0,102,12,TTACCCACTCATGCGATGCA,90,2224742
marRp,0.5384615384615384,18,12,TGTGGTCAGCAGGGATATAT,6,2239217
marRp,0.23076923076923078,14,12,TGTGGGTGTAGCCCGGCGAC,2,2242018
marRp,13.538461538461538,187,12,TGTGGGCGCTAGCGACATCT,175,2228975
marRp,15.307692307692308,210,12,TGTATTCGGCGGGAACAGAA,198,2239316
marRp,2.230769230769231,40,12,TGGTGTTAGGTTAAGTGGTG,28,2223341
marRp,0.23076923076923078,14,12,TGGTAATTCGGCAGGAATGG,2,2246231
marRp,1.0,24,12,TGGGTGAAATGAAGCCACTG,12,2232316
marRp,4.384615384615385,68,12,TGGGTATAACCGCGGCAGAC,56,2240889
marRp,3.1538461538461537,52,12,TGGGGGGTCATGGCCGGTTA,40,2237061
marRp,1.3076923076923077,28,12,TGGCGGATATCAAACGGGTC,16,2239124
marRp,0.8461538461538461,22,12,TGCCGATAAACTGGTAACAC,10,2226048
marRp,0.6923076923076923,20,12,TGCATCGGGCTTGACTCCTA,8,2235284
marRp,3.076923076923077,51,12,TGCACATTTTCCGGTAGCGG,39,2222157
marRp,0.15384615384615385,13,12,TGATCGCCCCCAGTTTTTAT,1,2233269
marRp,2.6923076923076925,46,12,TCTTTACAACCGCAACCTAT,34,2241698
marRp,0.15384615384615385,13,12,TCTTGTGTCAACCCTATTTA,1,2254620
marRp,0.46153846153846156,17,12,TCTGGAGCAGCTATAAGCTT,5,2218303
marRp,0.5384615384615384,18,12,TCTCAACTGGGCACTTGCTT,6,2258458
marRp,1.0,24,12,TCTAGCTGGGGAGCAGTGGG,12,2243081
marRp,0.6923076923076923,20,12,TCGGCCCCGTTTGCGCCAAA,8,2227732
marRp,16.76923076923077,229,12,TCGACAGCAAATGTGCCTGA,217,2222760
marRp,0.38461538461538464,16,12,TCCACCCTCCGGTGCAAGTA,4,2225572
marRp,0.23076923076923078,14,12,TCATGGCACATTCTCTTGTA,2,2219394
marRp,0.38461538461538464,16,12,TCATCAAGGTTCGCGAAAGA,4,2231592
marRp,12.538461538461538,174,12,TCATAGTGTACGCATATGGG,162,2251788
marRp,0.3076923076923077,15,12,TCAATTGTCTGTTACTACAA,3,2218831
marRp,0.7692307692307693,21,12,TCAACCTAAAACTCATAACA,9,2227893
marRp,0.46153846153846156,17,12,TATTGGAAGGGACTGCCTTG,5,2230195
marRp,0.6153846153846154,19,12,TATTATAGATCACCGGGATA,7,2230243
marRp,1.4615384615384615,30,12,TATACACCATCAAGCCGAGC,18,2244299
marRp,0.7692307692307693,21,12,TATAATAGTTAGCCTATTGT,9,2253446
marRp,1.6153846153846154,32,12,TAGTAGGGAGCTCAATGGCT,20,2222246
marRp,4.0,63,12,TAGGTTGAGTAGTAGAGGAT,51,2241946
marRp,8.846153846153847,126,12,TAGGGCGAGTTGAATGCAAT,114,2248575
marRp,10.846153846153847,152,12,TAGGAGGCGCCATGCGCGGT,140,2227103
marRp,0.46153846153846156,17,12,TAGCGTTATATTTCCTAATA,5,2258248
marRp,0.46153846153846156,17,12,TAGATTCCGATAGGCTATTT,5,2244141
marRp,1.9230769230769231,36,12,TACATGGACCTCCCGATCTG,24,2227696
marRp,0.46153846153846156,17,12,TAATTCCTTTCAAACTGAGA,5,2237075
marRp,1.2307692307692308,27,12,TAACTTCGATATCACAGTAG,15,2247019
marRp,0.5384615384615384,18,12,TAACCTAGCGAGGGTGACTC,6,2241202
marRp,3.0,50,12,TAAAGTCGTGGCCGTGCTTT,38,2250343
marRp,0.9230769230769231,23,12,GTTTTTTCCGTCTCTTAGAG,11,2222058
marRp,0.7692307692307693,21,12,GTTTCGATAACAAACGGCAG,9,2252233
marRp,0.3076923076923077,15,12,GTTCACGCTACCCTTTCGCG,3,2220324
marRp,0.8461538461538461,22,12,GTTCACACTCACCAGGCGAA,10,2220707
marRp,4.615384615384615,71,12,GTTACGGTCAAGATGGTAAA,59,2246278
marRp,9.923076923076923,140,12,GTTACGCTTAGAGAATGCGC,128,2220193
marRp,5.923076923076923,88,12,GTTAAGGTGGGCACGCGGCA,76,2246027
marRp,0.46153846153846156,17,12,GTGCCGTTAGTCGGGGTGTA,5,2241888
marRp,3.0,50,12,GTGACTGAGATACGCCCGTT,38,2232315
marRp,0.46153846153846156,17,12,GTGACGGACCCCGGGAGCTT,5,2221094
marRp,0.23076923076923078,14,12,GTCGGGCAATAACATTGGCT,2,2247129
marRp,1.9230769230769231,36,12,GTCATTACACCGCTGGACTA,24,2231054
marRp,1.3076923076923077,28,12,GTCACAAAGGTTAGTTAGGA,16,2249438
marRp,1.0,24,12,GTATTATCCAGGGCCAAGTC,12,2257520
marRp,11.307692307692308,158,12,GTATCGGGGATCCTAGCCCT,146,2245045
marRp,5.0,76,12,GTATATGAGATTTTGAACGA,64,2230779
marRp,0.8461538461538461,22,12,GTAGGGGTAATTCCGTTAGA,10,2250854
marRp,0.38461538461538464,16,12,GTAGACGCATTATCAAGCTA,4,2242412
marRp,1.4615384615384615,30,12,GTACTTTAGCAGTTTCCTAA,18,2232444
marRp,1.0,24,12,GTACTGGTCCGATCCTCGGC,12,2228813
marRp,0.23076923076923078,14,12,GTAAGTAGTGTCCGGGCGCG,2,2230366
marRp,2.3076923076923075,41,12,GGTTTATCTGTTACCCTGAT,29,2234216
marRp,1.3846153846153846,29,12,GGTTGTTGGTCTGCTCTTTT,17,2244794
marRp,39.0,518,12,GGTTCACTTTGCATTAAGGC,506,2248581
marRp,0.3076923076923077,15,12,GGTCCGTCGGCATTTAATAT,3,2236432
marRp,3.6153846153846154,58,12,GGTAAGATAGCTTACCGATA,46,2260357
marRp,0.38461538461538464,16,12,GGGTCTTTCCGACCGACAAT,4,2249940
marRp,1.0,24,12,GGGGTGGTGATCAGCATAGT,12,2244704
marRp,0.23076923076923078,14,12,GGGCGCATGGGAGTCCTAGG,2,2221939
marRp,5.923076923076923,88,12,GGGCAGACGCGTGCATAATA,76,2245454
marRp,1.6923076923076923,33,12,GGGAACACTTCCGATCACTC,21,2221115
marRp,0.6153846153846154,19,12,GGCTTCTGACTTGCGCCTAG,7,2220474
marRp,0.15384615384615385,13,12,GGCTAGATCGTAGTTCACAA,1,2242841
marRp,11.153846153846153,156,12,GGCGCTCGTTAGAGAGGATA,144,2257484
marRp,0.8461538461538461,22,12,GGCGCTCAGGAGTTTGGCGG,10,2245100
marRp,0.38461538461538464,16,12,GGCCGGAGTAATCTAGTTCT,4,2223768
marRp,5.6923076923076925,85,12,GGCAGGTCAGGGGGAGATCA,73,2237384
marRp,2.6923076923076925,46,12,GGATGCGCAAAAGTGCACGG,34,2225409
marRp,0.5384615384615384,18,12,GGATGATTGCCTTTCCCGGC,6,2246652
marRp,0.3076923076923077,15,12,GGATCTCCGTCTCGAAGAGG,3,2242667
marRp,0.6153846153846154,19,12,GGACTTTAGAGTCATGTGAA,7,2248363
marRp,6.3076923076923075,93,12,GGAATAGTGTCATATGTCTA,81,2251641
marRp,2.6153846153846154,45,12,GGAAAGCACGGTAAGAATGT,33,2255619
marRp,3.230769230769231,53,12,GCTTGCGGCACTGGAATAGT,41,2236644
marRp,1.0769230769230769,25,12,GCTGCGCATTATTCATACAT,13,2231300
marRp,0.38461538461538464,16,12,GCTCGGCTATTGGGCGGGCT,4,2258251
marRp,1.2307692307692308,27,12,GCTAGGGTCCTATGTTTCTG,15,2239082
marRp,2.0,37,12,GCTAATTAAATGAGAGATCA,25,2233232
marRp,0.7692307692307693,21,12,GCGTATGTACGCATTTTCTA,9,2238648
marRp,2.3846153846153846,42,12,GCGGGCCGAAGTAGTCAACT,30,2244560
marRp,1.2307692307692308,27,12,GCGCTCATGATTGTCATCGT,15,2220206
marRp,0.15384615384615385,13,12,GCCTTCCCCCAAGAAAAAAG,1,2235369
marRp,0.6923076923076923,20,12,GCCGTTCGTCTTATTTTAGG,8,2228041
marRp,2.230769230769231,40,12,GCCGTCTAAGTAGTGCTGCT,28,2236836
marRp,0.38461538461538464,16,12,GCCGGCCCGAACAAATACTA,4,2254154
marRp,0.5384615384615384,18,12,GCCCGGTGCGGCCTTTAAGC,6,2237801
marRp,0.23076923076923078,14,12,GCCCATATTCATGTATAGTG,2,2255204
marRp,0.9230769230769231,23,12,GCCATGACTCCGTACGGCGA,11,2240106
marRp,3.6153846153846154,58,12,GCATACAACCGGCCGTGTTC,46,2226245
marRp,0.3076923076923077,15,12,GCACCAGGAATATCAGATGC,3,2235333
marRp,0.38461538461538464,16,12,GCACCAGAAGTTGGTATAAA,4,2229501
marRp,11.384615384615385,159,12,GATGCCTGAGCGGAATTAGA,147,2231055
marRp,0.9230769230769231,23,12,GATCTCGCCGGTACTCCTGT,11,2229484
marRp,0.15384615384615385,13,12,GATCCAAGGGAAGGCTCGGC,1,2247693
marRp,28.76923076923077,385,12,GATAGGCAAGGATGCAATAA,373,2228266
marRp,8.846153846153847,126,12,GATAGATTGTGTTTGGAACT,114,2248973
marRp,0.23076923076923078,14,12,GATACGAAGACAGTACAAAA,2,2218601
marRp,0.38461538461538464,16,12,GATAAATGGGTTTCCTGGTC,4,2226418
marRp,0.3076923076923077,15,12,GAGCCTATACAATGGGTTCA,3,2221778
marRp,0.3076923076923077,15,12,GACACATTAAGTTTTATTTA,3,2240101
marRp,0.5384615384615384,18,12,GAAGACCGCGGGAGTGACTA,6,2239200
marRp,0.23076923076923078,14,12,GAACCTGCTTGGTACAGCCA,2,2247075
marRp,3.769230769230769,60,12,CTTTTTGGGTAGCTCCGCCC,48,2236831
marRp,0.46153846153846156,17,12,CTTTGCTGTACGGGCAGTGA,5,2219451
marRp,0.5384615384615384,18,12,CTTTATTGACAATTATGCAA,6,2225467
marRp,0.46153846153846156,17,12,CTTACTGCTTAAGTCGGGAG,5,2221354
marRp,2.0,37,12,CTTAAGCGACGCATCCTTTG,25,2219745
marRp,0.15384615384615385,13,12,CTTAAATACAGGTTTAGTGG,1,2258166
marRp,0.38461538461538464,16,12,CTGTGGTTCAGCCATCACTC,4,2226296
marRp,4.538461538461538,70,12,CTGGTTCAAGACTAGACGTG,58,2243000
marRp,2.230769230769231,40,12,CTGGGTTGCGATGGGAGCTT,28,2240651
marRp,1.1538461538461537,26,12,CTGCTCCAGGTCTTTCCGAG,14,2244693
marRp,6.6923076923076925,98,12,CTGCCCCCACTGTAATGGAG,86,2259226
marRp,1.9230769230769231,36,12,CTGATGGTTCTCACAAAAAA,24,2227701
marRp,1.2307692307692308,27,12,CTGATGAATATCACTGTATT,15,2241201
marRp,0.15384615384615385,13,12,CTCGAGCAAATACGGCTCTT,1,2217960
marRp,0.8461538461538461,22,12,CTCCAATCCCGAATTGCATA,10,2260023
marRp,0.7692307692307693,21,12,CTCATGTATTAGTGGTGGGT,9,2230524
marRp,0.15384615384615385,13,12,CTAGGTCGGCACCGGGTGCC,1,2258605
marRp,1.3846153846153846,29,12,CTAGAGAAGATTCCGTGTCT,17,2248327
marRp,0.3076923076923077,15,12,CTACTAGCAGAAGCGCCACG,3,2241310
marRp,0.3076923076923077,15,12,CTACGTATTCTTCACGGCAA,3,2249365
marRp,0.8461538461538461,22,12,CTAATGTCTGGTGCGACACA,10,2229347
marRp,1.3076923076923077,28,12,CTAACACACGCGTAGAAATA,16,2253893
marRp,0.7692307692307693,21,12,CGTTTAATATGGACTTCGGA,9,2223179
marRp,8.923076923076923,127,12,CGTTGTGGCCGTGCGAGTGA,115,2248228
marRp,8.076923076923077,116,12,CGTTGTCCGCGGCTGTTTCC,104,2256478
marRp,6.846153846153846,100,12,CGGGCGGACCTTGAAGATGA,88,2256988
marRp,0.3076923076923077,15,12,CGGGATGGTTATCAGGAATG,3,2240146
marRp,0.38461538461538464,16,12,CGGGACCAAGATGCGTTAGG,4,2235778
marRp,3.0,50,12,CGGCGTAATTAATTTCTGAG,38,2246139
marRp,0.6923076923076923,20,12,CGGCGGTCACTACTAGGAGA,8,2224502
marRp,1.6153846153846154,32,12,CGGCGCGGGCTATTCTGGAA,20,2246836
marRp,3.0,50,12,CGGAGTACAGGAGCAGACGG,38,2255064
marRp,0.7692307692307693,21,12,CGGAGCCGATATCTTGTCAC,9,2227186
marRp,10.076923076923077,142,12,CGGACATTGTGATAAATGCG,130,2240975
marRp,0.46153846153846156,17,12,CGGAAAGTCTGACTGAGGAC,5,2243447
marRp,1.1538461538461537,26,12,CGCGTTTGCACTCGCTACTT,14,2236043
marRp,3.6153846153846154,58,12,CGCGGGTCCGAAACGTCCAA,46,2245906
marRp,3.8461538461538463,61,12,CGCCTGACGGGATATATAAC,49,2240891
marRp,0.38461538461538464,16,12,CGCCCTCAGCGCTGCACGAA,4,2260951
marRp,5.230769230769231,79,12,CGAAGATATATCCGCGGTGT,67,2220547
marRp,4.3076923076923075,67,12,CCTTCCAAGATGTATGTTGC,55,2245710
marRp,0.8461538461538461,22,12,CCTCGCGAGCAAGCAGCAGA,10,2253682
marRp,0.7692307692307693,21,12,CCGGTGAGAGGATAGGTGCA,9,2250222
marRp,1.4615384615384615,30,12,CCGGCAGTGTGGCTGGCAAG,18,2242787
marRp,1.6923076923076923,33,12,CCGGAGAGTCTTATTGAGAT,21,2250370
marRp,0.3076923076923077,15,12,CCGCCCCTCGGTACACACGT,3,2257458
marRp,3.6153846153846154,58,12,CCGCCACCTGCGATAGAAGA,46,2260894
marRp,0.6153846153846154,19,12,CCGATCATGAAGAATTTTAC,7,2257035
marRp,2.076923076923077,38,12,CCGAGACTGTGTTCAGGCCT,26,2234708
marRp,4.076923076923077,64,12,CCGACTTTCACTAAGCCTAA,52,2224067
marRp,0.6923076923076923,20,12,CCCTCCAAGTACTTCAGCGC,8,2229273
marRp,6.230769230769231,92,12,CCCTATATTGTTATCAGTCA,80,2244837
marRp,7.076923076923077,103,12,CCCGGATCCCCTCATGTAGC,91,2236608
marRp,36.76923076923077,489,12,CCCACATGATAGAGAGCCAG,477,2223671
marRp,2.0,37,12,CCATTAGGTTGGCTTGGGCA,25,2247424
marRp,0.3076923076923077,15,12,CCACCCGGCCTAAAGCAACT,3,2219503
marRp,7.846153846153846,113,12,CATTCCCTGGGGCAGGCTTA,101,2224056
marRp,1.3846153846153846,29,12,CATGCATCTTAGCGGTATCC,17,2258110
marRp,0.23076923076923078,14,12,CATGCAACGGCACCAGTTCC,2,2221216
marRp,1.0,24,12,CATGACCAGGCGCGTTAGGC,12,2230003
marRp,1.7692307692307692,34,12,CATATCACGGCGACGAATAA,22,2230263
marRp,1.7692307692307692,34,12,CATAGCAACGACTCATGAGA,22,2254140
marRp,1.4615384615384615,30,12,CATAATCTAACGGCACAATA,18,2234190
marRp,10.0,141,12,CAGTAAGTTCTATCGGGAGA,129,2229885
marRp,0.6923076923076923,20,12,CAGGCTTCGTATTTTGGCAA,8,2221139
marRp,1.5384615384615385,31,12,CAGCGGATCATGAATGCGCC,19,2246649
marRp,1.0,24,12,CAGCGCCACGCATTTTGGGT,12,2221182
marRp,2.3846153846153846,42,12,CAGAGACTCAACCTCATTAG,30,2254904
marRp,2.0,37,12,CAGAATTCTCGTGGACACAC,25,2221670
marRp,0.15384615384615385,13,12,CACTGGTAGAGCACATCCTA,1,2225815
marRp,14.153846153846153,195,12,CACTATCAATATTAAATTCT,183,2235106
marRp,0.7692307692307693,21,12,CACCAATAGGTCAATTAATA,9,2241200
marRp,2.3076923076923075,41,12,CAATACACGTCGGTTAGTAG,29,2236019
marRp,3.0,50,12,CAATAAGTTTCCATCTGATG,38,2235285
marRp,10.076923076923077,142,12,CAAGTCGGTCGCCACGTAGC,130,2238016
marRp,4.769230769230769,73,12,CAACGGCATATTTGGTCCTG,61,2230595
marRp,1.2307692307692308,27,12,CAACCGGCACTCGTTTGATA,15,2259518
marRp,0.38461538461538464,16,12,CAAATGTTCCGTACGCGTAG,4,2229014
marRp,4.615384615384615,71,12,ATTTGTCGAAACTTTGTAGG,59,2252083
marRp,0.23076923076923078,14,12,ATTTCCTCGTGGGCTGTTTG,2,2239596
marRp,2.8461538461538463,48,12,ATTTCAGGAGCTCCTCCACA,36,2219102
marRp,0.6153846153846154,19,12,ATTTAATATTGTACGGATTG,7,2244215
marRp,0.6153846153846154,19,12,ATTGTAGGCTCGTTTCTCAA,7,2248430
marRp,0.5384615384615384,18,12,ATTCTAGTTCTCTCGTCGTC,6,2232642
marRp,0.46153846153846156,17,12,ATTAGGAACCTGGCATCATG,5,2246941
marRp,1.6923076923076923,33,12,ATGTGTGAGAAAACCCCGTG,21,2257002
marRp,1.2307692307692308,27,12,ATGTCCGGACACAACCCGCA,15,2236009
marRp,0.15384615384615385,13,12,ATGGGTAACACGGGATACAT,1,2258659
marRp,2.0,37,12,ATGGCTAGGGCCTTTCGACA,25,2244691
marRp,0.23076923076923078,14,12,ATGGAATGGTCGCGTTAACT,2,2257901
marRp,1.8461538461538463,35,12,ATCTCCGGGGCATAAAGCGT,23,2253221
marRp,0.15384615384615385,13,12,ATCCGCAATTTTGTCGTCTA,1,2256446
marRp,16.23076923076923,222,12,ATATTCACGATGAACTGTTC,210,2245692
marRp,1.4615384615384615,30,12,ATATTACAATATGCGAGGGT,18,2236550
marRp,4.538461538461538,70,12,ATATCAGGGCGACATTATAC,58,2219110
marRp,2.4615384615384617,43,12,ATATATCCCCTTGCCTGATA,31,2222167
marRp,0.23076923076923078,14,12,ATAGGGTTTGATTCTGTCCT,2,2242055
marRp,2.0,37,12,ATACGACCTTTAGTTTTTCA,25,2252902
marRp,0.5384615384615384,18,12,AGTTCTTTATCGACCTGGGC,6,2255803
marRp,0.15384615384615385,13,12,AGTGCTACTCGGTTACTATA,1,2252249
marRp,0.15384615384615385,13,12,AGTCCGCAATTAGAGTCTTC,1,2235897
marRp,1.7692307692307692,34,12,AGTCAGTAACCGGCTCAATC,22,2248134
marRp,1.5384615384615385,31,12,AGTAGGCCCTTGCTTTGGTA,19,2244262
marRp,9.692307692307692,137,12,AGTACTGTTGGACCCTGGTG,125,2245357
marRp,2.3076923076923075,41,12,AGTAACGATGGTTTCCGTCC,29,2234371
marRp,0.23076923076923078,14,12,AGGCTGCCTGGTACGTGAAC,2,2252512
marRp,0.23076923076923078,14,12,AGGCGGCCGCCGAGGTCGTG,2,2220928
marRp,2.230769230769231,40,12,AGGCCCTCCTTACAGGCACT,28,2224916
marRp,0.3076923076923077,15,12,AGGCACATTACGGTGTTTAG,3,2244713
marRp,1.8461538461538463,35,12,AGCTTACTGGCAAAATAGAA,23,2224990
marRp,2.230769230769231,40,12,AGCGTGGGGGCCATGGGTAC,28,2235209
marRp,9.76923076923077,138,12,AGCATTTACTCGAAGTGATG,126,2256373
marRp,0.3076923076923077,15,12,AGCACTGCTTCGCAACTCTT,3,2241852
marRp,0.6923076923076923,20,12,AGATGGGGACATCCATTTGA,8,2237885
marRp,0.8461538461538461,22,12,AGATCGAGCATCACGAGCAT,10,2228656
marRp,0.3076923076923077,15,12,AGACCGTAGTGGTAGGATCT,3,2252347
marRp,0.3076923076923077,15,12,AGACCAAATTTAAGCGCGTG,3,2220876
marRp,0.7692307692307693,21,12,AGAATTTTCTCGAGCCAAAA,9,2256445
marRp,1.6153846153846154,32,12,AGAACTAAGTTCCATAGCCG,20,2221683
marRp,1.3076923076923077,28,12,ACGGTTAGTCTTTGTCGTGG,16,2221389
marRp,2.923076923076923,49,12,ACGGAGAGTGACCAGGCTAG,37,2244167
marRp,10.307692307692308,145,12,ACGACCGCACTCGAACTGGG,133,2218730
marRp,0.23076923076923078,14,12,ACCAAGCCAAGCTCTCCCTG,2,2256925
marRp,2.3076923076923075,41,12,ACATTTTATGTCGTCAGCAG,29,2223814
marRp,0.6153846153846154,19,12,ACATTCTCGGATGGTGATTG,7,2235558
marRp,3.0,50,12,ACAGTGTACGGTCTTTTCAC,38,2255349
marRp,1.7692307692307692,34,12,AATGGAATGAATGCTGCGGT,22,2254940
marRp,3.1538461538461537,52,12,AATCTGCGTGTGGCCCGGTC,40,2232044
marRp,4.0,63,12,AATACGGCACCAGCCCCGTT,51,2234850
marRp,6.615384615384615,97,12,AAGGTGAGACAAATCTGGCG,85,2221072
marRp,0.3076923076923077,15,12,AAGCTGTACGGAGCGACGTT,3,2229366
marRp,1.4615384615384615,30,12,AAGCTCAAGCTATTTACCTG,18,2258776
marRp,0.9230769230769231,23,12,AAGAGACAGCCACTTAACGT,11,2233069
marRp,11.76923076923077,164,12,AAGAGAATGCGAAAAAGTGT,152,2218999
marRp,4.384615384615385,68,12,AACGTGTTCGCGTTGCCAAT,56,2226665
marRp,0.6923076923076923,20,12,AACCGGCTTCCGCGGCATCA,8,2241559
marRp,2.076923076923077,38,12,AACAGTCCCCGGGCATCTAA,26,2219076
marRp,0.3076923076923077,15,12,AAATACTGGCCCTGGATTTT,3,2221463
marRp,1.1538461538461537,26,12,AAAATGTGGATCTACAAAGT,14,2221585
marRp,3.1666666666666665,48,11,TTTTGTCTATCTCGCGCATT,37,2238739
marRp,0.16666666666666666,12,11,TTTTCCTCCCTGTTGCTTTG,1,2236333
marRp,2.3333333333333335,38,11,TTTCCCTAGTGACGGTAATG,27,2246997
marRp,0.75,19,11,TTTACTTACGCAGTCACGAC,8,2223875
marRp,0.5833333333333334,17,11,TTGCGGTCCTCAATAGTGCT,6,2250080
marRp,5.416666666666667,75,11,TTGATGTAGGCTGACAGTCA,64,2219111
marRp,0.6666666666666666,18,11,TTCTCTCCTCTACGTACGAA,7,2248836
marRp,2.3333333333333335,38,11,TTCATGGCCTCGACCTGTAT,27,2227506
marRp,1.75,31,11,TTATTCTGGAGGGCGGTTTC,20,2227435
marRp,0.16666666666666666,12,11,TTATGTGGCGTGTGGTTCCT,1,2243516
marRp,0.5,16,11,TTATGGCCAGTTTGGCTTGT,5,2234706
marRp,2.5833333333333335,41,11,TTACGCGGTGTGTATTTATG,30,2243019
marRp,0.3333333333333333,14,11,TTACAGTTAACGTTCGAATT,3,2231002
marRp,13.833333333333334,176,11,TTAATCCATGAATCACAATA,165,2257857
marRp,6.0,82,11,TGTTATAAGATGCGCACCCG,71,2219003
marRp,1.25,25,11,TGTGGAATAATTAGCCTTAA,14,2254410
marRp,0.4166666666666667,15,11,TGTGAACGCTATTGGCTCCA,4,2252522
marRp,1.6666666666666667,30,11,TGTCCCTGGGGTCATTTGAG,19,2234777
marRp,2.0833333333333335,35,11,TGGTCAGCGGATAGCATCCA,24,2244210
marRp,2.5833333333333335,41,11,TGGTACTAGGTCATAGTTCA,30,2248525
marRp,1.3333333333333333,26,11,TGGGATTAGTTGCTTATATC,15,2234098
marRp,1.0,22,11,TGGCGGGACTAGGTCGGGCT,11,2249325
marRp,2.75,43,11,TGCTAAAAGGACTTCCAGCG,32,2236512
marRp,1.0833333333333333,23,11,TGCGCTTTTTAGAGACCCAT,12,2251553
marRp,20.416666666666668,255,11,TGCACATGGCCAACGTGTGT,244,2241522
marRp,0.9166666666666666,21,11,TGATGCGTATGGATGAAACA,10,2228644
marRp,0.16666666666666666,12,11,TCTGCGTAGACAGGCAATAA,1,2248811
marRp,0.16666666666666666,12,11,TCTCCAAAACGGGTACCGGT,1,2248271
marRp,0.3333333333333333,14,11,TCTACTATAGTCGATTATGG,3,2233368
marRp,11.583333333333334,149,11,TCGTTCCTCGGTGTCGATAC,138,2256215
marRp,0.3333333333333333,14,11,TCCTCCTTGGCGGCTCTTCC,3,2222465
marRp,2.0833333333333335,35,11,TCCTAACTACCAGAAGTAGT,24,2229467
marRp,0.16666666666666666,12,11,TCAATGTCAAAGGAGGATGA,1,2251900
marRp,0.16666666666666666,12,11,TATGTGATAATCGGAAAATG,1,2232585
marRp,0.8333333333333334,20,11,TATGATGCCTAGTCTATATT,9,2248617
marRp,0.3333333333333333,14,11,TATCTCAGACGGAACCCTAC,3,2233013
marRp,0.8333333333333334,20,11,TATCGTGATCACGTTCTTTC,9,2225146
marRp,0.4166666666666667,15,11,TATCAAAACCGTTCTGACTG,4,2250525
marRp,2.1666666666666665,36,11,TAGGCACTCCAAGGCCGCTT,25,2225156
marRp,0.25,13,11,TACGTGTACGTGGTAGCGAA,2,2247549
marRp,0.5833333333333334,17,11,TACGAAACGGGCCTGGGTCT,6,2225264
marRp,1.0833333333333333,23,11,TACCATAACTGTCGCCTATT,12,2244333
marRp,1.25,25,11,TACAGGGGCACGCTCTTTAT,14,2234949
marRp,0.5833333333333334,17,11,TACAGCTAAGCTACCACCGT,6,2249974
marRp,0.8333333333333334,20,11,TAATTTACAAAGTGATGATA,9,2250459
marRp,1.25,25,11,TAACATTGCCCTCGCTTTAT,14,2253709
marRp,1.0833333333333333,23,11,TAACATCTTCCAGTGGTGCC,12,2245618
marRp,3.3333333333333335,50,11,TAACAGTTACAGGAAGGTGG,39,2237123
marRp,13.0,166,11,TAAAGAGGGCGGACTTAACC,155,2230374
marRp,1.25,25,11,TAAACTCCACCGATTTGGTT,14,2239502
marRp,0.16666666666666666,12,11,GTTTATTTTGTCCATATGAA,1,2258979
marRp,6.666666666666667,90,11,GTTTATCCGTCGAACCGACA,79,2238432
marRp,0.4166666666666667,15,11,GTTTAGCCCGCCTTTGTGCA,4,2247163
marRp,9.416666666666666,123,11,GTTGCCCGTACTACGGTTCG,112,2248234
marRp,2.8333333333333335,44,11,GTTGCAGCGTGCAAGAACTA,33,2242138
marRp,4.583333333333333,65,11,GTTGATCTTCGGAAGAGAAA,54,2222973
marRp,0.9166666666666666,21,11,GTTGAAGCTTAAGGTTGGTT,10,2228931
marRp,0.6666666666666666,18,11,GTTCTTCACGGTCTCAAGAT,7,2253110
marRp,0.6666666666666666,18,11,GTTCCTCGGAAAGCACCATG,7,2219861
marRp,2.5,40,11,GTTACGCTGGCTCGGTTTCA,29,2240594
marRp,0.25,13,11,GTGTCTGCGAACGGACTGCA,2,2247872
marRp,2.3333333333333335,38,11,GTGGTCTCATAAGCCTGGCG,27,2251938
marRp,8.583333333333334,113,11,GTGGTCAAAGCATCAATGTC,102,2218557
marRp,0.4166666666666667,15,11,GTGGGTAGTGATTCAAGTGA,4,2246484
marRp,0.6666666666666666,18,11,GTGGATCTGGGTGCGATCAA,7,2255030
marRp,0.75,19,11,GTGCGAATCGATTAGTGCTG,8,2250510
marRp,12.833333333333334,164,11,GTGATGAATGTTTTTGACTT,153,2218562
marRp,0.25,13,11,GTGACCGGTTGCCAATCTGC,2,2246412
marRp,29.25,361,11,GTCATCAATCTATCAATAGT,350,2256805
marRp,0.75,19,11,GTCAGGGTCTTCCTGAAGAT,8,2240854
marRp,6.083333333333333,83,11,GTATTTCTCGCAGGCACCGT,72,2257565
marRp,1.0,22,11,GTATATCGTATGGTCTGGAG,11,2219443
marRp,0.75,19,11,GTAGACTTCCTGTGACAGAA,8,2245591
marRp,1.0,22,11,GTACTGTGGCCAAGTTCGAC,11,2259065
marRp,1.0,22,11,GTACGAAACTCTTCGTCCAG,11,2233637
marRp,1.5833333333333333,29,11,GTAATACCGCCGAGATTGAC,18,2222128
marRp,1.75,31,11,GTAACCCAACGGGTAAGTGA,20,2233318
marRp,1.25,25,11,GGTTCAACCTAGTGTAAATA,14,2230075
marRp,1.0833333333333333,23,11,GGTCTGCACGGCGGAGCGCT,12,2244781
marRp,7.166666666666667,96,11,GGTCGGGTTTTCCGGTGGAC,85,2237160
marRp,0.4166666666666667,15,11,GGTACATAGCCATGCTTACA,4,2220181
marRp,0.9166666666666666,21,11,GGGGCCAACCACGGCAGATA,10,2243326
marRp,3.0,46,11,GGGCGTGGCGAATCGTACCT,35,2221467
marRp,0.16666666666666666,12,11,GGGCGCCAGTTCGCCTCAGC,1,2232936
marRp,3.25,49,11,GGGAAATACACCCGGAGATT,38,2218567
marRp,0.5,16,11,GGCTCGAAACGGCACGCCTA,5,2245340
marRp,0.16666666666666666,12,11,GGCTCAGAATACGTGATCCT,1,2218462
marRp,0.75,19,11,GGCGCATGTGAGACGGCGCA,8,2233586
marRp,0.16666666666666666,12,11,GGCCGGGACGATTTGCTTCA,1,2227608
marRp,2.3333333333333335,38,11,GGCCCAAACACTGGCTACAT,27,2251422
marRp,3.5,52,11,GGATGGTTCGAGAAGCTTTG,41,2224069
marRp,0.8333333333333334,20,11,GGAGGTGATATGTGACAGTT,9,2250954
marRp,1.3333333333333333,26,11,GGAGAGATACATTATATCCC,15,2257720
marRp,0.16666666666666666,12,11,GGAATAAAAGGGTACTAGGA,1,2247249
marRp,1.4166666666666667,27,11,GGAAAGACGGCAGTACGGAA,16,2236182
marRp,0.5,16,11,GCTTTTCGGTAATCGGGTCG,5,2248232
marRp,0.9166666666666666,21,11,GCTGCCTGGGCGCGATCGCT,10,2222272
marRp,0.6666666666666666,18,11,GCGTCAATTCGGCTAAGCTA,7,2219265
marRp,9.916666666666666,129,11,GCGGGTCAGGGTTTCTATGG,118,2226481
marRp,5.916666666666667,81,11,GCCTGGTTAAGCATACCGCG,70,2223990
marRp,0.75,19,11,GCCGTCAACGGGGTAATTCG,8,2229333
marRp,4.083333333333333,59,11,GCCCGCGGGATTAACGCTAC,48,2218069
marRp,1.0833333333333333,23,11,GCCATATGCGCCAAGAGAAA,12,2227425
marRp,0.5833333333333334,17,11,GCCACGATATAGTCCTTTCC,6,2253290
marRp,12.583333333333334,161,11,GCATTCCAGTAAGTTTTGTG,150,2251062
marRp,1.4166666666666667,27,11,GCAGCCCCGTTATCGACCGA,16,2219458
marRp,0.5,16,11,GATTTTAACGGGTGTTAACC,5,2239868
marRp,8.25,109,11,GATTCGTCGGTACGACCACT,98,2229146
marRp,0.5,16,11,GATGTCATCCCTGGAGCGTG,5,2252731
marRp,0.4166666666666667,15,11,GAGTCGTGAATTCCATCGTA,4,2233163
marRp,1.1666666666666667,24,11,GAGTAGCTAACGTGGGTGAC,13,2234131
marRp,0.5,16,11,GAGATACACAGCTAGCCTGG,5,2236756
marRp,0.9166666666666666,21,11,GAGACCATCGAGGCGGGATT,10,2220787
marRp,0.3333333333333333,14,11,GAGAACTGCATGTGCAGCGT,3,2226880
marRp,0.5833333333333334,17,11,GAGAAACGGGTGACGGCACT,6,2233322
marRp,2.3333333333333335,38,11,GACCTAAATAGTTGTACTGA,27,2238193
marRp,0.3333333333333333,14,11,GACCCGCATACGTGTTCACC,3,2236139
marRp,0.5833333333333334,17,11,GACCACCTGAATTTCTATCC,6,2238697
marRp,2.0,34,11,GACAAATACTCCCCTGGTAA,23,2223188
marRp,0.9166666666666666,21,11,GACAAAACCGCCGCCGCCGG,10,2241579
marRp,0.3333333333333333,14,11,GAATAATACACATCTCATTT,3,2248369
marRp,9.25,121,11,GAAGCGGCCAGGTTTACGTC,110,2240966
marRp,1.6666666666666667,30,11,GAAACGCGTAATTAGTTTGA,19,2255248
marRp,0.75,19,11,GAAAAGGGCACAATATGAAA,8,2234025
marRp,0.3333333333333333,14,11,CTTGTGAGACCGTCCCAACA,3,2246069
marRp,2.0833333333333335,35,11,CTTGGCAGACCTCCTCCGTG,24,2240783
marRp,1.1666666666666667,24,11,CTTCCAATCCATCGTCCTGA,13,2229681
marRp,10.083333333333334,131,11,CTGGGCTATTTTTTTTGCAT,120,2224822
marRp,0.5833333333333334,17,11,CTGCGATTTTAGGTACAATG,6,2231687
marRp,3.0,46,11,CTGCGAATAGCTCAATCAAG,35,2226302
marRp,0.25,13,11,CTGAGTATAGATAATAGATT,2,2226174
marRp,0.3333333333333333,14,11,CTGAAGTAAAGTGCTAGGTT,3,2223227
marRp,0.8333333333333334,20,11,CTCTAGGTGAAAAAGCTCCA,9,2236115
marRp,0.16666666666666666,12,11,CTCGTAAGTTAAGGAAGCAA,1,2240938
marRp,1.25,25,11,CTCGCCCAGTTGCACGACTG,14,2227753
marRp,0.9166666666666666,21,11,CTCATTTTACCTTTGGACGA,10,2231286
marRp,1.3333333333333333,26,11,CTCATTGCAAGGGGGTGTGA,15,2239600
marRp,2.1666666666666665,36,11,CTCAGCGATTCGGACCGATA,25,2219933
marRp,0.3333333333333333,14,11,CTCAAATAAAAAATATATAA,3,2240348
marRp,0.5,16,11,CTATAAGGGTGCACATGTAG,5,2244058
marRp,0.75,19,11,CTACCCGCCTTTGACGCGGT,8,2233275
marRp,1.1666666666666667,24,11,CTACAGCAAACTACGGGCAA,13,2237083
marRp,0.8333333333333334,20,11,CTAAGCGGCTGTGTATACGA,9,2225523
marRp,2.4166666666666665,39,11,CGTTTGGACTGCAGCTCTAT,28,2260433
marRp,1.5,28,11,CGTTCTTTGGTGTTCCCGCA,17,2257166
marRp,1.6666666666666667,30,11,CGTGGGGTCATCGGCGTGTC,19,2221170
marRp,0.3333333333333333,14,11,CGTGGCACATGCTTATAAGT,3,2226704
marRp,3.6666666666666665,54,11,CGTGCGTTGTGCGTCTTCAG,43,2254375
marRp,1.3333333333333333,26,11,CGTCAATAGCACCACTCTCC,15,2234382
marRp,0.5833333333333334,17,11,CGTAGTAGAGTCACTACAGC,6,2259098
marRp,0.5,16,11,CGTACACCTTCTAGACGGCT,5,2236054
marRp,1.75,31,11,CGGTGATATGCCTGTCTTTA,20,2222005
marRp,2.25,37,11,CGGTCCAGCGGCTATAAAAG,26,2223243
marRp,2.25,37,11,CGGCTGATGTATAACGTTTA,26,2232835
marRp,2.5833333333333335,41,11,CGGCGTCGGAGTAGCTAGAC,30,2243271
marRp,1.8333333333333333,32,11,CGCTTGGTCGGCTTAAGGCT,21,2228828
marRp,0.6666666666666666,18,11,CGCTTGAAGCTGAACCGAAG,7,2249826
marRp,0.5833333333333334,17,11,CGCACTATAGCTGATGAAAG,6,2237918
marRp,0.4166666666666667,15,11,CGATTCTAGCTGGGCGGTGT,4,2241650
marRp,1.9166666666666667,33,11,CGATTCACACCCACTAGATG,22,2236517
marRp,1.3333333333333333,26,11,CGATATTTTTGTAAGAGTTT,15,2230828
marRp,4.416666666666667,63,11,CGAGGATGATATAAGCAGTG,52,2251712
marRp,1.5833333333333333,29,11,CGAGACGGGCAGGGTTGTTC,18,2244334
marRp,2.25,37,11,CGACCTGGCCTTCCGCAGTA,26,2244800
marRp,1.0,22,11,CCTTGAAGGCTAATTCGCGT,11,2229318
marRp,1.0833333333333333,23,11,CCTTCATCCTGTCGGACAGT,12,2258313
marRp,0.4166666666666667,15,11,CCTGGTGTGGATGGGGCAGT,4,2224874
marRp,1.25,25,11,CCTGGTGCCGCATGAGCGAA,14,2250223
marRp,1.3333333333333333,26,11,CCTGCCAGCGCCTTCGACGA,15,2238864
marRp,2.3333333333333335,38,11,CCTAGGGATGGAGGGAGATA,27,2226360
marRp,0.6666666666666666,18,11,CCGTTCGGCCTTCTGATTTT,7,2248034
marRp,5.416666666666667,75,11,CCGTATACACCAAATTAGTT,64,2249044
marRp,1.4166666666666667,27,11,CCGGGATCCCACTACGGGAC,16,2242483
marRp,1.0833333333333333,23,11,CCGGCGACTCAGATAATTGA,12,2219330
marRp,0.16666666666666666,12,11,CCGCGCCTTGACTTGACCTC,1,2242121
marRp,1.0833333333333333,23,11,CCGCGACTCCGCAAATCTAG,12,2255734
marRp,0.16666666666666666,12,11,CCGCCATGGCGGTATTGAAC,1,2243321
marRp,0.75,19,11,CCGATGCCTACAGGTTCTGT,8,2254883
marRp,0.4166666666666667,15,11,CCGACTGCCTACCAGCGGGT,4,2248542
marRp,0.8333333333333334,20,11,CCGAAGGGTGTTTGTATGTT,9,2247489
marRp,2.6666666666666665,42,11,CCGAAATGCAGGAGAGCCGT,31,2232047
marRp,1.5,28,11,CCCTCAAGGACACTGGCCAG,17,2219179
marRp,5.0,70,11,CCCGTTTGAGTGCTTCGATT,59,2254974
marRp,0.16666666666666666,12,11,CCCGCTATCATCCGGCAGTG,1,2230342
marRp,0.8333333333333334,20,11,CCCCGCAGATAACGCACCTG,9,2230999
marRp,5.0,70,11,CCCAGCGAAGAAATCAAACA,59,2225237
marRp,0.5833333333333334,17,11,CCCAGCCACCATGCCGGACT,6,2259305
marRp,2.9166666666666665,45,11,CCCAATGGAGTTGCTTATAG,34,2237613
marRp,1.5,28,11,CCACACAGATAGGTCCTATA,17,2225406
marRp,0.25,13,11,CCAAGGACGGCGCATGGTTT,2,2228868
marRp,1.5,28,11,CATTGATCGCCTTCCTATCA,17,2243618
marRp,0.16666666666666666,12,11,CATCTTGAACGGATGGGCCA,1,2221171
marRp,1.1666666666666667,24,11,CAGTATAGCCTGCGTCGTCG,13,2224671
marRp,0.5833333333333334,17,11,CAGACAGGTGGTTGTGTTGG,6,2217959
marRp,0.75,19,11,CACGTCACGATCGGAGTTGA,8,2236368
marRp,1.3333333333333333,26,11,CACGGGTCCTTCGGACGTAT,15,2255590
marRp,1.0833333333333333,23,11,CACGCCGCCCGCGTGACGCG,12,2245166
marRp,1.75,31,11,CACCCACCGCTTCAAGATAT,20,2241385
marRp,2.8333333333333335,44,11,CAATTTAGTCGCTTAGAACA,33,2222003
marRp,1.25,25,11,CAATGCATCGACGGGTCAAA,14,2231665
marRp,2.9166666666666665,45,11,CAATCTGGGAGCATTTTCAC,34,2253173
marRp,0.3333333333333333,14,11,CAATCGGACCCAAAAATTGG,3,2231481
marRp,4.416666666666667,63,11,CAAGTCGCTGTAGGTGTGAC,52,2250777
marRp,1.0833333333333333,23,11,CAAGATATGTGTCTTATTTG,12,2221453
marRp,6.416666666666667,87,11,CAAATTGGCTTGCTGGCGAG,76,2233316
marRp,2.25,37,11,ATTGGTCTTTGAAGTTGATG,26,2250778
marRp,4.5,64,11,ATTACCTAGAGCTCGGTGAT,53,2249012
marRp,0.16666666666666666,12,11,ATGCTTCCCGTATGTAGATT,1,2253708
marRp,6.5,88,11,ATGACCGATCTCACATTCCC,77,2233231
marRp,2.0,34,11,ATCTGAACCGAAGGTACTGT,23,2223702
marRp,6.833333333333333,92,11,ATCTCCGGTATCGGCACTTG,81,2224014
marRp,0.6666666666666666,18,11,ATCTAAAACACGAGCATGAA,7,2234076
marRp,2.5833333333333335,41,11,ATCGTCCTTTGAAAGCGTAG,30,2253385
marRp,0.75,19,11,ATCGACCGAGGGTCTGCTGG,8,2237316
marRp,0.3333333333333333,14,11,ATCCCCTGACACTCCCGGTA,3,2258072
marRp,0.5833333333333334,17,11,ATCAAGGTATCCAGAGAACT,6,2251164
marRp,8.0,106,11,ATATACGCCCGATCATAAGT,95,2241610
marRp,1.0,22,11,ATAGTCTTCGAGCTACTCAA,11,2219404
marRp,0.5833333333333334,17,11,ATACGGGCACGCCCGATGTT,6,2218470
marRp,4.666666666666667,66,11,ATACATGTTAATCTAGTGTC,55,2245414
marRp,3.4166666666666665,51,11,ATAAGTTATGATGGCTTACG,40,2227106
marRp,16.916666666666668,213,11,AGTTCCAGGGGAGACCTTCG,202,2220503
marRp,8.0,106,11,AGTGTCATGACCAACTAGGG,95,2236602
marRp,0.6666666666666666,18,11,AGTGTATATGTCCTGGTGAT,7,2260432
marRp,0.9166666666666666,21,11,AGTGCAGCCGCTAACCGTGT,10,2245468
marRp,4.916666666666667,69,11,AGTCTGAACGTGTACCAAGA,58,2235303
marRp,0.75,19,11,AGTCATTCGCCGTCTTGTAT,8,2259319
marRp,3.75,55,11,AGGGTGCACATCTGTGGTCG,44,2219103
marRp,13.0,166,11,AGGGATTCACTCTATGTATG,155,2238287
marRp,16.25,205,11,AGGCGTTCCGGTAAGCCCTG,194,2259773
marRp,1.1666666666666667,24,11,AGGCAGTCCCTCGAAATAGA,13,2233060
marRp,2.5833333333333335,41,11,AGGATTGGCAAGAAGACTGG,30,2258566
marRp,10.5,136,11,AGGAGCGCACTCGGTGATCA,125,2218415
marRp,1.3333333333333333,26,11,AGGACCTCATCACACACGCT,15,2240571
marRp,3.9166666666666665,57,11,AGCTGGGTTCCGTGCTCGAA,46,2218410
marRp,1.0833333333333333,23,11,AGCGGAACTCCAAGTGTGAA,12,2254142
marRp,0.3333333333333333,14,11,AGCCGTGGCTTCGACTAGCT,3,2235469
marRp,13.916666666666666,177,11,AGCCGACTCTAAGTTATATC,166,2227849
marRp,2.5,40,11,AGCAGTTTCTGCGTCGGCTC,29,2229253
marRp,2.75,43,11,AGCAGATGAGTAGGATAAGA,32,2225067
marRp,0.16666666666666666,12,11,AGACCCCTTCCTCATTAGTG,1,2244443
marRp,0.25,13,11,AGAATGCGGGTTGTGCCAAT,2,2224701
marRp,0.75,19,11,AGAACAGTTGAGTCCCGTTT,8,2218956
marRp,1.4166666666666667,27,11,ACTTGGCCGAGATCACAAGT,16,2246452
marRp,0.6666666666666666,18,11,ACTGAAGGAGAAAATCCGTA,7,2219306
marRp,1.8333333333333333,32,11,ACGGGTTGCAGCATAAAACT,21,2233383
marRp,2.5,40,11,ACGCTCGTGGTCAGGCTAGA,29,2231399
marRp,3.0833333333333335,47,11,ACGCGTCGGTCCTAGCATTG,36,2219452
marRp,6.5,88,11,ACGCGCAAGAGTCTATTAAG,77,2256785
marRp,1.75,31,11,ACGCCGGAGCACTACCTCAA,20,2237069
marRp,0.3333333333333333,14,11,ACGCCGCGTACGTAAGGTGA,3,2221931
marRp,2.3333333333333335,38,11,ACGACGCTGACATTCCATGC,27,2220956
marRp,2.5833333333333335,41,11,ACGAAAAGGCACGACTTAGG,30,2237851
marRp,0.5833333333333334,17,11,ACCTAATACTTCAGCTGGTT,6,2238819
marRp,0.6666666666666666,18,11,ACCGGTAGATGTACAGAGTT,7,2241573
marRp,25.25,313,11,ACCGGAAGTCTGCGTACAAA,302,2255121
marRp,0.6666666666666666,18,11,ACCGCTATATCACTGTAGTG,7,2258799
marRp,2.3333333333333335,38,11,ACCACGCATCGAGAATACCC,27,2259035
marRp,0.4166666666666667,15,11,ACCAACACTAAGGGGTCAGG,4,2234685
marRp,2.0,34,11,ACATCTGATAGCGTCACGAC,23,2254549
marRp,6.666666666666667,90,11,ACATCCGGGCCTATTGGCCG,79,2254523
marRp,2.0,34,11,ACAGCTCAGCGGGCCACGGA,23,2235771
marRp,1.3333333333333333,26,11,ACAATCTTACGTCGCAACGG,15,2239931
marRp,0.9166666666666666,21,11,ACAAGAAGATTCAGGGGCCA,10,2233724
marRp,3.0833333333333335,47,11,AATTCTGACCCGGGGAAGCA,36,2218018
marRp,0.5833333333333334,17,11,AATTCGCTCACCAGTCCGGC,6,2225775
marRp,0.16666666666666666,12,11,AATTACGTTCACGACCAAAT,1,2238822
marRp,20.833333333333332,260,11,AATCGTGGGGACCTGCGCTC,249,2240706
marRp,0.5833333333333334,17,11,AATCGATTGAGTTCGAGTGG,6,2229926
marRp,4.833333333333333,68,11,AATCCCCAGCATCGACGAAA,57,2247623
marRp,2.9166666666666665,45,11,AATATAACGCTTGACGAGCT,34,2239399
marRp,9.166666666666666,120,11,AAGTTGATGTAGTGACATCA,109,2244549
marRp,0.5,16,11,AAGCTTCAGCGAGCAGATGC,5,2258571
marRp,0.5833333333333334,17,11,AACGTACATGACAGGTGGAT,6,2225040
marRp,3.25,49,11,AAATGTTGCTGACAAATCGA,38,2223974
marRp,0.75,19,11,AAATGCAAGGGTCTGGAGCT,8,2243677
marRp,16.666666666666668,210,11,AAATCCGCGTTGGGTTGTTC,199,2249685
marRp,1.1666666666666667,24,11,AAAGATAATCGAAGTACCTT,13,2221101
marRp,1.25,25,11,AAACAGATGTAGACGCGCTT,14,2233012
marRp,0.7272727272727273,17,10,TTTTCTCAGAAGGACAGCTT,7,2244241
marRp,0.2727272727272727,12,10,TTTGGCATCGTATGGTTCGA,2,2227765
marRp,0.36363636363636365,13,10,TTTGATGAAATATAAGTCGG,3,2243624
marRp,14.727272727272727,171,10,TTTAGAGTTTCGTTATGAGG,161,2230394
marRp,2.090909090909091,32,10,TTGTCCTCCGCATGTACATG,22,2251127
marRp,0.5454545454545454,15,10,TTGCAACACGTACTTCCAGT,5,2230448
marRp,2.1818181818181817,33,10,TTCGGATAATGCCATTGTCG,23,2240307
marRp,0.5454545454545454,15,10,TTCGCTCTACGGGTGCTGTA,5,2257963
marRp,24.727272727272727,281,10,TTCCGGGACTGCCCAATTGT,271,2238105
marRp,1.2727272727272727,23,10,TTCATATCCGTACCTTTTGA,13,2231975
marRp,1.1818181818181819,22,10,TTCAAATGGTGGAAGAGAAA,12,2219264
marRp,1.4545454545454546,25,10,TTATAACCGTTCTTAGTCTG,15,2255735
marRp,0.5454545454545454,15,10,TTAGCGCCTGTATTAAGCGC,5,2225006
marRp,1.4545454545454546,25,10,TTACTAGGAACAACGAAGTT,15,2249508
marRp,0.2727272727272727,12,10,TTACGTGGACCAACCCTTTG,2,2250234
marRp,4.090909090909091,54,10,TTACGGAAGTCATTCCGTGT,44,2242482
marRp,0.8181818181818182,18,10,TGTTTATATCGGTGGGAAGT,8,2220255
marRp,3.090909090909091,43,10,TGTTGCGCGAATTTGTCAGC,33,2252772
marRp,2.090909090909091,32,10,TGTCCCGTATCACCCAGGTT,22,2256850
marRp,2.090909090909091,32,10,TGTCACCGGGAACGGTCAAG,22,2221126
marRp,2.3636363636363638,35,10,TGTAACTTTTTCGTTAGACA,25,2233041
marRp,0.5454545454545454,15,10,TGGGTCCGATGTAGGCACCA,5,2243568
marRp,13.090909090909092,153,10,TGGGATTAGTTTGCTTGAGA,143,2220502
marRp,3.090909090909091,43,10,TGGCTCCCCCGTGCATCGCA,33,2253041
marRp,0.8181818181818182,18,10,TGGATCATTAGGCTGAAAAT,8,2231692
marRp,2.4545454545454546,36,10,TGGACCAGAAACATACCGGG,26,2221629
marRp,0.36363636363636365,13,10,TGCTGGTTTTTCGCGACATA,3,2252899
marRp,0.5454545454545454,15,10,TGCTAGAATCTAGCAGGTGG,5,2258117
marRp,19.636363636363637,225,10,TGCGGGATGGGGTAATATTG,215,2257783
marRp,0.2727272727272727,12,10,TGCGATTGCGTGATGCTCGA,2,2235122
marRp,1.0,20,10,TGCCCCGGACTCGAATTGCC,10,2248437
marRp,5.363636363636363,68,10,TGCCAAGGTACTAATGGTCA,58,2234818
marRp,6.090909090909091,76,10,TGATGCCTCACATACCTTGT,66,2234265
marRp,0.18181818181818182,11,10,TGATCAGTCCCGATTCGTAG,1,2237920
marRp,0.45454545454545453,14,10,TGATATAGCAGATGTGTATA,4,2253132
marRp,1.8181818181818181,29,10,TGAGGTGTCGCGATGGGTTG,19,2219978
marRp,0.6363636363636364,16,10,TGACGAATTCCAGGTAAAGG,6,2241489
marRp,1.0,20,10,TGACCGCACTGAGTGGACCT,10,2220651
marRp,7.363636363636363,90,10,TGAATATATCAAGGTTAGTG,80,2238974
marRp,4.636363636363637,60,10,TGAACCTAGTGTCTATGAAG,50,2228129
marRp,1.3636363636363635,24,10,TCTTCGCATCCAACAATCTT,14,2248713
marRp,1.7272727272727273,28,10,TCTGATCAGTCAGCAGGTGT,18,2219337
marRp,3.909090909090909,52,10,TCTCGGCGCAGTTAGATTTG,42,2259402
marRp,1.0909090909090908,21,10,TCTCGACGTTACAAAGTCGG,11,2242406
marRp,0.36363636363636365,13,10,TCGGTGGACGATCAAAAGGG,3,2244610
marRp,1.2727272727272727,23,10,TCGGTGCTAATCGTAACGAA,13,2251397
marRp,1.9090909090909092,30,10,TCGGTCGTTTCACGCCGGAT,20,2246023
marRp,1.2727272727272727,23,10,TCGGCAACAATAGGCCGTTT,13,2226515
marRp,0.18181818181818182,11,10,TCGGAGAAGCGAAGAATACT,1,2241669
marRp,1.4545454545454546,25,10,TCGCCGTACAGCCAGGTGAT,15,2235033
marRp,0.2727272727272727,12,10,TCGATTGGGTATCGCCTGCA,2,2255805
marRp,0.18181818181818182,11,10,TCGATAATTTTCACTCCTAA,1,2253387
marRp,2.4545454545454546,36,10,TCCGGGATAAGATTTGCCAT,26,2240656
marRp,1.7272727272727273,28,10,TCCGAAGGTTGTTAGTGTTC,18,2229545
marRp,11.818181818181818,139,10,TCCCTTTTTCGAGATCCGAT,129,2253982
marRp,0.6363636363636364,16,10,TCCCAGCAACCAAGTTCGCT,6,2253704
marRp,1.1818181818181819,22,10,TCATGCTTGGACTTATGTAA,12,2251101
marRp,5.636363636363637,71,10,TCATAGATTGGAGGGGTTTT,61,2221581
marRp,5.909090909090909,74,10,TCAGGGGACCAGTAAAACTT,64,2259150
marRp,0.5454545454545454,15,10,TCAGGACAGAAGTTCAAATG,5,2251426
marRp,1.1818181818181819,22,10,TCAGCAGGCTGTGTCGCAAA,12,2253223
marRp,2.8181818181818183,40,10,TCAATTATACGGCGGCCACA,30,2256987
marRp,2.1818181818181817,33,10,TCAACTACGACGTTCTGAGC,23,2224351
marRp,8.454545454545455,102,10,TATTGGCCCGAGAAGCTATA,92,2224920
marRp,2.090909090909091,32,10,TATGGCGCGCTTTATTTGAG,22,2226730
marRp,2.5454545454545454,37,10,TATGGATCCTGAAATTTATC,27,2234951
marRp,0.36363636363636365,13,10,TATCACAATGAGAATAACGA,3,2244661
marRp,3.3636363636363638,46,10,TAGGTTCACTATCTAAGTTG,36,2227041
marRp,0.5454545454545454,15,10,TAGGCCGTGGTTGGAACGTT,5,2244339
marRp,0.2727272727272727,12,10,TAGATCGATCGCGTTGAAAC,2,2247128
marRp,18.181818181818183,209,10,TAGAGCAAAAGGGAAGATCG,199,2250707
marRp,0.36363636363636365,13,10,TACTTTAGACGTTGGCAAGC,3,2230336
marRp,0.6363636363636364,16,10,TACTGAAGGAACGATCATGC,6,2241640
marRp,1.6363636363636365,27,10,TACTCGGAACACGGTTGGCC,17,2251182
marRp,0.7272727272727273,17,10,TACGGACTCAGAATTGTGTT,7,2252185
marRp,3.1818181818181817,44,10,TACCGATATTAGGTGGGTGG,34,2228241
marRp,2.4545454545454546,36,10,TACAAATTGGGGCTGTGGGG,26,2217785
marRp,0.6363636363636364,16,10,TAATATGAGGCGAACGGAAA,6,2245846
marRp,0.45454545454545453,14,10,TAATAAGTTAGACACAAATA,4,2234796
marRp,0.36363636363636365,13,10,TAACTTCATAGTATAGGAAG,3,2227558
marRp,4.545454545454546,59,10,TAACGTCTGAGAGGCTCGGT,49,2241980
marRp,0.2727272727272727,12,10,TAACCCATAGGCCTGGTGTT,2,2244261
marRp,2.8181818181818183,40,10,TAAAGTAAATAGGGCGATTG,30,2260615
marRp,17.272727272727273,199,10,GTTAGCGTCAGAGTTATAAA,189,2249471
marRp,0.8181818181818182,18,10,GTGTTTCGAGTTTGAATGAT,8,2257331
marRp,1.0,20,10,GTGGTGCTGTCCATCAGATA,10,2233099
marRp,1.3636363636363635,24,10,GTGGGTGTACATATGGAAAA,14,2229175
marRp,1.0909090909090908,21,10,GTGGGCACTCTTAAACTTCA,11,2224753
marRp,3.1818181818181817,44,10,GTGGACGCCAAAACTCAAGT,34,2238271
marRp,0.9090909090909091,19,10,GTGGAAAAGAAGGTTTACAC,9,2246852
marRp,0.6363636363636364,16,10,GTGCGTACCTTGGGGGCTAT,6,2258142
marRp,1.0,20,10,GTGAGTGACGTCGCTGTCTT,10,2235483
marRp,2.0,31,10,GTATTTGTGGCCAACGAAAC,21,2237910
marRp,1.2727272727272727,23,10,GTATGTGCGGACCCAGTATA,13,2225127
marRp,0.36363636363636365,13,10,GTAGAGTCGGTGACTTGTAC,3,2228486
marRp,1.0909090909090908,21,10,GTAGACTAACAAACCCCCGT,11,2238225
marRp,1.5454545454545454,26,10,GTACTACGCATCGGGTCCAG,16,2237806
marRp,0.7272727272727273,17,10,GTACGTCGTTCCATGCTTTA,7,2259548
marRp,0.9090909090909091,19,10,GTACATAGGACCATTTGGAC,9,2225108
marRp,2.1818181818181817,33,10,GTACAGTACCGCAATGTGTG,23,2226113
marRp,0.45454545454545453,14,10,GTAATGGATTGGTTTAAGAA,4,2218372
marRp,11.636363636363637,137,10,GGTGTTGTTTATCGGTGATA,127,2240968
marRp,0.18181818181818182,11,10,GGTGATTAGTCGTCTAGTCT,1,2239871
marRp,1.2727272727272727,23,10,GGTAACCGCTCGAGGTTTAA,13,2219508
marRp,3.1818181818181817,44,10,GGGTTGTTCTTAGGACATTT,34,2248843
marRp,1.3636363636363635,24,10,GGGTCTTAATAGCCCGGTCG,14,2221188
marRp,0.8181818181818182,18,10,GGGTCATGGTACGATCCAAA,8,2245506
marRp,1.0909090909090908,21,10,GGGTACTATTCCTTTGTGAG,11,2234970
marRp,1.5454545454545454,26,10,GGGTAAGGTTCGGGCGGTTA,16,2219994
marRp,0.45454545454545453,14,10,GGGGCTATCTACGTCGGTCA,4,2223236
marRp,2.4545454545454546,36,10,GGGCTGAGGGCCTTGGACAT,26,2232235
marRp,6.090909090909091,76,10,GGGCGCCTAATCCAAGGCCT,66,2237122
marRp,1.4545454545454546,25,10,GGGCGCCCGCGCTCAAGGGA,15,2235041
marRp,0.5454545454545454,15,10,GGGCATAGCAGCGGCCTATG,5,2229526
marRp,1.6363636363636365,27,10,GGGACCCGCAGGTGAAGAGG,17,2224106
marRp,10.363636363636363,123,10,GGCTTTGGTATCTATGAGAA,113,2229899
marRp,0.9090909090909091,19,10,GGCCTAGTGTTCATTAGTCG,9,2237911
marRp,2.5454545454545454,37,10,GGCAGCTGTCTTTGGTAGTG,27,2235286
marRp,0.9090909090909091,19,10,GGCACCATTAGACTCATTCC,9,2260699
marRp,1.0,20,10,GGAGCACTCCTCACCCGGAT,10,2222387
marRp,1.0,20,10,GGAGATCGGGTTCGCTGGGA,10,2233669
marRp,0.45454545454545453,14,10,GGAGATATTGCTTTACTATG,4,2248803
marRp,2.0,31,10,GGACTAACACGCTGGAATGA,21,2250855
marRp,0.2727272727272727,12,10,GGAAAACGATTCACCAGCCG,2,2253226
marRp,0.18181818181818182,11,10,GCTTTGAGATAAAAGAGGTG,1,2250119
marRp,9.363636363636363,112,10,GCTTCCAGTCTTCATCGTGG,102,2226504
marRp,1.8181818181818181,29,10,GCTCTCAGGCTTACTTGCGT,19,2260142
marRp,4.7272727272727275,61,10,GCTACCCAACAACTCGCGGA,51,2240988
marRp,2.0,31,10,GCTACAGTTAATGGGAATTC,21,2247211
marRp,0.2727272727272727,12,10,GCTAAATGACGCAGGCCGTA,2,2243523
marRp,0.2727272727272727,12,10,GCGGTACCTATCGGAGAAAG,2,2236049
marRp,0.6363636363636364,16,10,GCGGGTTCACGAGGTTAAAT,6,2248406
marRp,1.4545454545454546,25,10,GCGGATTTGCGCGGTATGCG,15,2221604
marRp,1.0,20,10,GCGCATCCCGGAACAGGACC,10,2232338
marRp,0.6363636363636364,16,10,GCGATCCTGGGACCATTGCC,6,2249658
marRp,0.8181818181818182,18,10,GCGAGGTCAGGGTACAGACA,8,2224583
marRp,12.818181818181818,150,10,GCGACTGATATTTAGGAGGC,140,2255285
marRp,0.9090909090909091,19,10,GCCCTGGGGGACACCGATGT,9,2232080
marRp,1.0909090909090908,21,10,GCCCTGCCGGTAAAATACAG,11,2245876
marRp,0.2727272727272727,12,10,GCCCCCGGGGCCGACCATAA,2,2232618
marRp,1.0,20,10,GCCATTGCGCAACATACAGT,10,2249695
marRp,1.3636363636363635,24,10,GCCAGTGGGTAGCATTGATA,14,2254900
marRp,0.36363636363636365,13,10,GCCAGATCTCATGAACCAGT,3,2230728
marRp,0.9090909090909091,19,10,GCCACTCTCAGACATGGCCG,9,2229307
marRp,3.727272727272727,50,10,GCATACCGGTTCAATGGCCA,40,2245262
marRp,1.0,20,10,GCACCTACAAGATACTCTTT,10,2224584
marRp,1.6363636363636365,27,10,GCACCAATCAGGAGTAAGAC,17,2241990
marRp,1.2727272727272727,23,10,GATTCGCGGGATCGCTTCAC,13,2242655
marRp,0.18181818181818182,11,10,GATTAGGTCTTGAGGTGGAG,1,2244738
marRp,2.4545454545454546,36,10,GAGTTATCATGCCTTACTCG,26,2233472
marRp,0.7272727272727273,17,10,GAGTCTTTCGTTCGTGTAAA,7,2218702
marRp,3.0,42,10,GAGGTATGGAGTAGAGCCCT,32,2223583
marRp,1.5454545454545454,26,10,GAGGTAAGACTTCTTCGTGT,16,2229120
marRp,10.636363636363637,126,10,GAGGGTATGGGCCAGGACAG,116,2249683
marRp,0.9090909090909091,19,10,GACTGTATTCAGTTCCTGCA,9,2254938
marRp,0.18181818181818182,11,10,GACCTGAGGATCCCCGTGCC,1,2230278
marRp,2.272727272727273,34,10,GAATTTTGTTCCGCTGAGTT,24,2241900
marRp,0.6363636363636364,16,10,GAAGTTCCAAAAAGTCCCTT,6,2256235
marRp,11.454545454545455,135,10,GAACTCAATAATACTGCATG,125,2240267
marRp,14.818181818181818,172,10,GAACGTCGCGCGGGCAATTA,162,2223259
marRp,0.5454545454545454,15,10,GAACAGTATTTTCTTTGGCA,5,2254034
marRp,0.36363636363636365,13,10,GAAATCGTCATGCTCTTACG,3,2219976
marRp,12.454545454545455,146,10,CTTTAGAAGAAGGCACAGTC,136,2247055
marRp,0.9090909090909091,19,10,CTTCATGGGCATTAAGCCAT,9,2234619
marRp,8.909090909090908,107,10,CTTAGTGGATTCTCCCCCGC,97,2248600
marRp,0.5454545454545454,15,10,CTTAGCTTATGTCGAATACA,5,2224889
marRp,6.2727272727272725,78,10,CTGTATAATAGCCTAAGGAG,68,2247056
marRp,2.4545454545454546,36,10,CTGTAACCGGAAGGATTTAG,26,2243272
marRp,0.18181818181818182,11,10,CTGGTGCAGTAGAGACACGA,1,2245746
marRp,0.7272727272727273,17,10,CTCTCGAGGGGAACCCTGAA,7,2236438
marRp,2.5454545454545454,37,10,CTCGGGAATGGGCATTGAAG,27,2244216
marRp,1.0,20,10,CTCCGGTTTTCTATCGTCAT,10,2239682
marRp,1.7272727272727273,28,10,CTCCGGTAAACAGCTACATT,18,2232566
marRp,0.36363636363636365,13,10,CTCAGCAGCGGGAGCTTGAG,3,2241628
marRp,6.545454545454546,81,10,CTAGTGACGGTCGAGGGCTC,71,2255174
marRp,2.4545454545454546,36,10,CTACAGCACGACTCACGCTG,26,2225050
marRp,0.36363636363636365,13,10,CTAATCCGCGGTGGGGGAAC,3,2261103
marRp,0.7272727272727273,17,10,CTAAACTGCGGCTTTCTGTG,7,2235534
marRp,1.0,20,10,CGTTTTTAGCCGACTCAGGG,10,2223103
marRp,1.2727272727272727,23,10,CGTGTTAGATTGGCTCGTGT,13,2225944
marRp,1.0909090909090908,21,10,CGTGTAAGTGATGTTCGAGC,11,2238155
marRp,6.0,75,10,CGTGATTTTCTTCAACAGCA,65,2230892
marRp,0.7272727272727273,17,10,CGTCTCTATATCGTCAAAGT,7,2244040
marRp,1.1818181818181819,22,10,CGGTGCGACGTATTTTCCTA,12,2238618
marRp,0.6363636363636364,16,10,CGGCTGTGCAGCAACTTCCC,6,2253745
marRp,1.6363636363636365,27,10,CGGATGGAGTGGGGTATCCC,17,2229119
marRp,0.6363636363636364,16,10,CGGAGAATAGGCCCCTTGGA,6,2227754
marRp,0.9090909090909091,19,10,CGCGCTCACGATGCAACAGC,9,2237578
marRp,0.45454545454545453,14,10,CGCCGCATGAATGTCATGCG,4,2225873
marRp,0.6363636363636364,16,10,CGCAGGGGGTTCACCAGCGT,6,2228641
marRp,1.0909090909090908,21,10,CGCAGGCGAGTAACGAAACC,11,2249079
marRp,4.7272727272727275,61,10,CGATTGGCGGCATTAGGAGT,51,2235108
marRp,16.727272727272727,193,10,CGAGTTACGGTGGGGATTCA,183,2232727
marRp,0.18181818181818182,11,10,CGAGATTCCGGTTTTCTAGT,1,2257080
marRp,0.36363636363636365,13,10,CGACTTGCCGGTAATTCAGC,3,2251276
marRp,0.8181818181818182,18,10,CGACGGATGTGGGAGATATG,8,2223890
marRp,3.0,42,10,CGACGCATCATACCATCGTG,32,2251707
marRp,2.8181818181818183,40,10,CGAATGAATTACGAGGCTAA,30,2259407
marRp,1.1818181818181819,22,10,CCTTGTCCTGGTTAGCCTCG,12,2225579
marRp,5.090909090909091,65,10,CCTGGGGCCGGGGCACTTGA,55,2257669
marRp,0.36363636363636365,13,10,CCTGCTCGTTCGTTCTCAAG,3,2234192
marRp,0.5454545454545454,15,10,CCTGCTCGTAGACCGTTTTG,5,2232953
marRp,5.090909090909091,65,10,CCTGAGAATAGACGTACTTT,55,2256242
marRp,2.5454545454545454,37,10,CCTCGCTGACTTTTGGATGC,27,2258815
marRp,1.1818181818181819,22,10,CCTACATAGTCTTTTGTCTG,12,2240102
marRp,0.9090909090909091,19,10,CCGTAGACTCGGATTACCCT,9,2246451
marRp,0.9090909090909091,19,10,CCGCCTACAGCGTAACTTAA,9,2250677
marRp,1.6363636363636365,27,10,CCGAATATTTGGCGCTGCCT,17,2222448
marRp,1.6363636363636365,27,10,CCGAAATTCACATTCTGGGG,17,2251937
marRp,12.909090909090908,151,10,CCCTGCGTAGGATTCGATAA,141,2233743
marRp,2.4545454545454546,36,10,CCCTATGGTTGCGCTTTAGT,26,2256846
marRp,0.18181818181818182,11,10,CCCGAATGGCGTCGAGACGG,1,2232862
marRp,2.272727272727273,34,10,CCCCAGAGGCGATCCGAGAG,24,2243724
marRp,2.1818181818181817,33,10,CCCACGACCTTAGTATTGAC,23,2233098
marRp,1.6363636363636365,27,10,CCATTGAGGGACGTCTATCT,17,2234202
marRp,0.18181818181818182,11,10,CCATTCACGGCCCGTCCTAA,1,2250247
marRp,0.5454545454545454,15,10,CCACACCACGATAGGTAAGT,5,2257162
marRp,0.6363636363636364,16,10,CCACAAGGATCTTGGAGCTG,6,2249724
marRp,1.0,20,10,CCAAGAGTAGCACTGCTAGA,10,2242367
marRp,5.090909090909091,65,10,CCAAGACGTCGGTGTATTGT,55,2254385
marRp,5.090909090909091,65,10,CATTTGGAGTTAGTATGTGA,55,2246802
marRp,10.363636363636363,123,10,CATTGTCACGCGGCGTCGGA,113,2233395
marRp,17.181818181818183,198,10,CATTCTAGTAACCAGGACTA,188,2227072
marRp,3.909090909090909,52,10,CATCCTACTTGGGCCACGAG,42,2220057
marRp,1.7272727272727273,28,10,CATCAAGCCTTATCACAATC,18,2224647
marRp,0.36363636363636365,13,10,CATATAGAAAGCGGAAGAGA,3,2243955
marRp,0.6363636363636364,16,10,CATACCAGAGATCTCCTGTG,6,2237127
marRp,1.2727272727272727,23,10,CAGGTTCCAGGGTATTGCTT,13,2250025
marRp,0.9090909090909091,19,10,CAGGTGAGGGCACTTCCTGT,9,2226269
marRp,3.8181818181818183,51,10,CACGCCACTCCTTCGATCGT,41,2240785
marRp,0.7272727272727273,17,10,CACGACAGACGAGCTCACAG,7,2249548
marRp,2.272727272727273,34,10,CACCCGAAGATCCGCAACTA,24,2230969
marRp,2.909090909090909,41,10,CACACTTTCTTCTATCCGGA,31,2234457
marRp,6.090909090909091,76,10,CAATAGATAAAAGCGCTGAG,66,2235254
marRp,1.3636363636363635,24,10,CAAGCGGGTCCGCGATGGCT,14,2257325
marRp,1.1818181818181819,22,10,CAAATGTGCACTTTGGACCT,12,2251046
marRp,0.8181818181818182,18,10,CAAAGTCTTGCTCTCTTGAC,8,2231549
marRp,2.6363636363636362,38,10,CAAACTCGGGACAGGATAGC,28,2237037
marRp,0.2727272727272727,12,10,ATTTACCGTAGGGTTCTTGA,2,2246071
marRp,0.36363636363636365,13,10,ATTGTTCGTCTCTGTGTCTC,3,2242597
marRp,0.9090909090909091,19,10,ATTGCTCGCATGTCCAAAAA,9,2247195
marRp,3.272727272727273,45,10,ATTCCTTTGTAGGAGCCGTC,35,2246269
marRp,0.7272727272727273,17,10,ATTATGGGGCGTGTGCCAGG,7,2244623
marRp,0.2727272727272727,12,10,ATTAACTGTTGTTGCGAACC,2,2226344
marRp,8.0,97,10,ATGGTTTCACCCAGGGTACT,87,2225231
marRp,1.6363636363636365,27,10,ATGGTTGAAGATGTAGCGCA,17,2242625
marRp,0.9090909090909091,19,10,ATGCTTGTCTCTCTGGCATA,9,2253752
marRp,0.8181818181818182,18,10,ATGCGCTACACGGGTCTCGT,8,2239755
marRp,0.2727272727272727,12,10,ATGCACTACTAGATCAATTC,2,2225024
marRp,1.4545454545454546,25,10,ATGATTCACCGGACAATATG,15,2223939
marRp,1.1818181818181819,22,10,ATGACCCAGCCTTCCGACTT,12,2229933
marRp,2.272727272727273,34,10,ATGAAATCGAGACACGGCGT,24,2234250
marRp,8.909090909090908,107,10,ATGAAATCCTGGTTAAAATC,97,2224898
marRp,1.7272727272727273,28,10,ATCGACCGACATCACGTATT,18,2252453
marRp,6.363636363636363,79,10,ATCGAAGTAGTTGAAACCAT,69,2219927
marRp,60.09090909090909,670,10,ATCCGCTCCTGGTCGCCGAT,660,2234533
marRp,0.36363636363636365,13,10,ATCCAGCTTAAAGCGACATG,3,2255693
marRp,1.5454545454545454,26,10,ATCACCGCCACTCGTTTACG,16,2247205
marRp,1.0,20,10,ATATCGGGCGTTGCAATCGA,10,2243917
marRp,0.7272727272727273,17,10,ATAGGCGTGCTTAAGTAGCT,7,2249163
marRp,4.181818181818182,55,10,ATAGAGCTCGCAGCATGAAA,45,2236490
marRp,11.454545454545455,135,10,ATACGGTATACCAAAAGACG,125,2237459
marRp,1.6363636363636365,27,10,ATAAAGCTTATGCTTTTCAC,17,2259658
marRp,3.909090909090909,52,10,AGTAGTCGTTCCGACGCCCA,42,2221685
marRp,1.0909090909090908,21,10,AGGTTAACCGCAAGATAAAT,11,2238245
marRp,2.727272727272727,39,10,AGGGTCGCCTATAGAAATTC,29,2221848
marRp,2.3636363636363638,35,10,AGGCTCAGAAGCCAGCGGTG,25,2246755
marRp,0.9090909090909091,19,10,AGGCGCTGAGAAGTCCCGTT,9,2257218
marRp,1.1818181818181819,22,10,AGGCAACCTTTTGCGGGTGA,12,2224698
marRp,0.2727272727272727,12,10,AGGACTTATAAAGGATCTCT,2,2228219
marRp,0.8181818181818182,18,10,AGGAAGCCGTTGAGTCAGAA,8,2227530
marRp,3.8181818181818183,51,10,AGGAACTAAAGGAAGCCAGC,41,2255582
marRp,1.0,20,10,AGCTGCGTAACGTTAGACAC,10,2233478
marRp,1.1818181818181819,22,10,AGCTACCAGCCCCGTTCGTC,12,2223764
marRp,0.36363636363636365,13,10,AGCCGCGTCAAGCGAACGCT,3,2254355
marRp,0.18181818181818182,11,10,AGCATTTCGTAGTACCGCAA,1,2242374
marRp,0.6363636363636364,16,10,AGATTTGACACCGCGCCTTT,6,2219150
marRp,0.5454545454545454,15,10,AGACCATGAACTAAGGCCAT,5,2247831
marRp,2.3636363636363638,35,10,ACTTGCGTTACGCGTAATCT,25,2256433
marRp,0.6363636363636364,16,10,ACTTGACTAGCGCGCAGTGG,6,2227034
marRp,0.6363636363636364,16,10,ACTTACTATCCACACGAGGG,6,2260236
marRp,2.0,31,10,ACTGTTAAGCGGGTTCGGTT,21,2225970
marRp,6.363636363636363,79,10,ACTGTGTCTCTCAATCCGGT,69,2233409
marRp,0.7272727272727273,17,10,ACTGCCTGGATACATAAGTT,7,2255273
marRp,0.18181818181818182,11,10,ACTAACATTTTATCTCGACG,1,2245387
marRp,1.0,20,10,ACTAACAACGTCCTACCGGA,10,2254144
marRp,0.5454545454545454,15,10,ACGGCCCTCCATCAAGGGGT,5,2234093
marRp,37.72727272727273,424,10,ACGCACTTCGCGCCATACGG,414,2230372
marRp,17.90909090909091,206,10,ACGAGCGTCCCATGTACTAG,196,2240001
marRp,8.636363636363637,104,10,ACGAGCAGAGCGTCTGGTGT,94,2241091
marRp,0.8181818181818182,18,10,ACCAGACCGAGAAAAGGCCC,8,2237503
marRp,2.6363636363636362,38,10,ACCACCCACCTAATAACGTT,28,2230121
marRp,1.6363636363636365,27,10,ACACTCGTGGCTGTCCCGCA,17,2250460
marRp,1.0909090909090908,21,10,ACAATTAGTTCCGGCAATAA,11,2239876
marRp,5.0,64,10,AATTGTAAGTCTGTTCTAAA,54,2242614
marRp,5.0,64,10,AATCCTATGGGTATGCTCAA,54,2243042
marRp,3.272727272727273,45,10,AATCCCCGCGGGTTCGAAAA,35,2234424
marRp,4.909090909090909,63,10,AATCACTGGGGCCGATTGAA,53,2238440
marRp,7.909090909090909,96,10,AATATTGGGCGGTAGATATA,86,2247111
marRp,9.727272727272727,116,10,AAGCCCAACCAGCTGGGTAC,106,2228974
marRp,0.5454545454545454,15,10,AAGAGTTGCTACAGACCCCC,5,2236125
marRp,0.18181818181818182,11,10,AAGACTAAAACAGACAATGA,1,2258549
marRp,0.5454545454545454,15,10,AAGACGACTTTGATACGAAT,5,2220432
marRp,0.45454545454545453,14,10,AAGAAAGTATGATGCTTGTG,4,2230961
marRp,7.454545454545454,91,10,AAGAAACCGCGGGAGGAATT,81,2223320
marRp,3.8181818181818183,51,10,AACTCTCTCGTTAGAAGGCC,41,2250304
marRp,2.272727272727273,34,10,AACTAAAATATGATGATAGA,24,2223615
marRp,1.2727272727272727,23,10,AACCGGGCTCAACAAAGTTT,13,2238272
marRp,1.3636363636363635,24,10,AAAGTCACTCTCAAGTAGTG,14,2242689
marRp,0.36363636363636365,13,10,AAAGTAGGTGAAGTAAAGTC,3,2219900
marRp,15.636363636363637,181,10,AAACGCATACTTTACTACTT,171,2250326
marRp,0.6363636363636364,16,10,AAAAGCTAGGGGCCAAATTT,6,2231018
marRp,0.18181818181818182,11,10,AAAAAATGACATCGGTGGGT,1,2259524
marRp,6.9,77,9,TTTTCGGGGACAGAACAGCA,68,2261080
marRp,0.8,16,9,TTTGTGACCGGGTTGGTTCT,7,2238550
marRp,0.6,14,9,TTTGCTTCGACGCCTACTGT,5,2231973
marRp,1.8,26,9,TTTCTCCCAAGTGCTGACGG,17,2219269
marRp,0.4,12,9,TTTCATGACTTCCGCGAAGG,3,2237159
marRp,1.0,18,9,TTTAAGGAAGGGTATCCCAC,9,2220579
marRp,1.7,25,9,TTGTTGGACCTCAAGCAGCT,16,2238463
marRp,1.0,18,9,TTGTGCACTTTTTCCGCCTA,9,2258385
marRp,1.4,22,9,TTGGATATGCACCGCACCAA,13,2244086
marRp,0.3,11,9,TTGGAGGTATATGGGAGGTG,2,2218201
marRp,6.2,70,9,TTGCTTCGCCGCCTACTGTC,61,2251644
marRp,0.4,12,9,TTGCACCCTGACGGTCCAAG,3,2242231
marRp,1.3,21,9,TTGATACTATCGTGCTTCAT,12,2235360
marRp,3.3,41,9,TTCTTTGGTGTATATATTTA,32,2233439
marRp,0.4,12,9,TTCTTCGGCGTCCAATACCG,3,2235443
marRp,9.0,98,9,TTCTTCAAGTTATGTAGCCT,89,2229884
marRp,31.9,327,9,TTCCTGCTTGGTGCGCGCGA,318,2248974
marRp,1.5,23,9,TTCCATGTATCAGTCAATGA,14,2229633
marRp,3.0,38,9,TTCACGGACCATCCGAGGGA,29,2224376
marRp,0.6,14,9,TTCACCACTTAGCCGTCAGG,5,2246220
marRp,10.6,114,9,TTATTTCGAGCCCCACTTTT,105,2229826
marRp,0.6,14,9,TTATCGTGTGTAGGAATGAT,5,2242577
marRp,1.5,23,9,TTACTTGCTGGCGACAACTA,14,2249366
marRp,0.6,14,9,TTAACGCGAGGAGGCGGCCC,5,2230670
marRp,0.4,12,9,TTAAATATTAGGATCGGCAT,3,2243756
marRp,0.5,13,9,TTAAACCAGGGTGGAAGCCA,4,2234503
marRp,6.2,70,9,TGTTCCGCTTCTCCTTTTCT,61,2251719
marRp,15.7,165,9,TGTGATGCTGCCATCGTTAA,156,2218584
marRp,1.5,23,9,TGTAACTCGGGTAGAACCCT,14,2256042
marRp,2.0,28,9,TGGTTAATACGCGCTGGTAC,19,2237758
marRp,2.4,32,9,TGGTCTAAATACAGTGGGAT,23,2225575
marRp,5.9,67,9,TGGGTCACGTTTAACCTGTT,58,2229652
marRp,4.5,53,9,TGGGAATCTAGACTGCCTAA,44,2257923
marRp,0.7,15,9,TGGAATATAAGCAGGACTTT,6,2245320
marRp,6.1,69,9,TGCTTCAAATGAATCAGGGA,60,2232052
marRp,0.6,14,9,TGCGACAAACCACTAGGATG,5,2246051
marRp,3.0,38,9,TGCCCACGGAGATATTGTCA,29,2248458
marRp,11.4,122,9,TGCCCAACATTGGGATAGTT,113,2226508
marRp,1.2,20,9,TGCCAGGTATAAGCCCCTGT,11,2259562
marRp,9.1,99,9,TGCAGGATCCAAATATACCT,90,2238032
marRp,5.8,66,9,TGCAAGACTGACTACGTTAA,57,2253388
marRp,2.5,33,9,TGATCAGTCGAGGGGATATA,24,2222848
marRp,2.1,29,9,TGAGGTTAGCGGCAAGCTCA,20,2221185
marRp,1.9,27,9,TGAGGTGACGACTTGTGCGA,18,2253843
marRp,0.7,15,9,TGAGCCATTGCGAGGGCGAT,6,2256669
marRp,1.8,26,9,TGAGAGCTGCCATTGGGTCA,17,2240641
marRp,2.1,29,9,TGAATTAGGTCATGAACGGC,20,2234651
marRp,5.4,62,9,TGAAGCTGGGAATCACTCGC,53,2218818
marRp,0.4,12,9,TCTGGATGGCGTAATTGGCA,3,2234916
marRp,2.3,31,9,TCTGCCAGGGTTGATTTTAT,22,2238379
marRp,0.2,10,9,TCTAGGCGTTATTATAGACA,1,2239056
marRp,4.8,56,9,TCGTTAACGGATTGTGAGCG,47,2223797
marRp,6.7,75,9,TCGTGTGCTAGTACGGAGTA,66,2230755
marRp,1.0,18,9,TCGTGATTGTGTGCCGCACT,9,2243570
marRp,10.8,116,9,TCGTCTCTTGTCTAGCAAAA,107,2243416
marRp,6.1,69,9,TCGCCTCCGTGGGTTGAACC,60,2255621
marRp,0.4,12,9,TCCAGCATCCAGTAGCGAGT,3,2220704
marRp,0.8,16,9,TCCACTTATAAGATAAAAAA,7,2255524
marRp,0.7,15,9,TCCAATGGCATGTCTAAAGG,6,2233065
marRp,1.2,20,9,TCCAAATCTATTGTGGTACT,11,2250045
marRp,4.8,56,9,TCACAGCTCGGCCCCACCGA,47,2222657
marRp,0.9,17,9,TCACAATGAGAAGTTATCCT,8,2220648
marRp,20.4,212,9,TATGTGAGCACGACGCAGAG,203,2254843
marRp,0.3,11,9,TATGATCCTACTCCAGTCAA,2,2244871
marRp,1.2,20,9,TATGACTGCACACACAGCAT,11,2241018
marRp,3.1,39,9,TAGGGGGCGTCGGTTGGAAC,30,2236064
marRp,4.3,51,9,TAGCTTTAGGCCCACCGGGT,42,2227310
marRp,0.6,14,9,TAGCTGAGCGGGGCCGGACT,5,2240678
marRp,0.7,15,9,TAGCTAGCCTGCGACGATCA,6,2256749
marRp,0.7,15,9,TAGATACTATTTGTGTTACC,6,2241308
marRp,3.0,38,9,TACGCCCTTTGTCTGAGCAT,29,2254956
marRp,3.7,45,9,TACGCCCCCATTCTAGTATT,36,2224105
marRp,8.9,97,9,TACGATGAGTCCCAAGTCTC,88,2251793
marRp,0.8,16,9,TACCTAAGCCTGGATCACCT,7,2242611
marRp,3.9,47,9,TACCCGGTGATACAAGGGTA,38,2218892
marRp,0.2,10,9,TAATGTTAAAGCCGCGCCAC,1,2237838
marRp,0.6,14,9,TAAGTGCTTTCCTATATAAC,5,2246357
marRp,1.7,25,9,TAAGGCCGTCCCTGGCGGAG,16,2242228
marRp,4.2,50,9,TAAGACCCGGCGTTAGGAGT,41,2240974
marRp,0.7,15,9,TAACTGCTCTCCTTCGAGAA,6,2233899
marRp,6.5,73,9,GTTGAGAGAGTTCGGCCAAG,64,2247970
marRp,0.8,16,9,GTTCGGAGGACTGTCAAAGG,7,2238509
marRp,1.1,19,9,GTTATACAAGTAGAGTCGCA,10,2236077
marRp,3.8,46,9,GTGTAAAGCTATACTGATAT,37,2237173
marRp,1.2,20,9,GTGGCAATATACGTATTGAA,11,2259459
marRp,0.9,17,9,GTGAGGACAGAGGGGGACGT,8,2218113
marRp,22.0,228,9,GTCGGCGCACCGAGATTAGG,219,2245046
marRp,0.2,10,9,GTCCTATTCCTGCACCGTTG,1,2258545
marRp,0.6,14,9,GTCCCGCCGACTTCGTGATT,5,2229011
marRp,3.9,47,9,GTCCACTGCCGAGCGTTGTA,38,2249704
marRp,1.5,23,9,GTCACTATCCGTTACATTTG,14,2252602
marRp,2.9,37,9,GTAGGCTATCGGTCAAACGA,28,2234229
marRp,0.3,11,9,GTAGCACCACCCTATCCTTG,2,2246579
marRp,0.8,16,9,GTAAAAAGAGTTCCCAGACA,7,2237703
marRp,3.0,38,9,GGTGGTTGCAACTAGACTTA,29,2236760
marRp,1.5,23,9,GGTGGAGTCCCTCTGGTCCA,14,2222798
marRp,0.2,10,9,GGTCTTTTGCGGAAATATGC,1,2256186
marRp,0.8,16,9,GGTCGTCGCACAGTCTCACT,7,2231717
marRp,3.1,39,9,GGTATTGCCGGTCATCGATA,30,2221075
marRp,1.7,25,9,GGGTACTAGGAGGGCCTACG,16,2230318
marRp,0.6,14,9,GGGGTATAGAGTGGACTGCT,5,2241238
marRp,0.2,10,9,GGGCTTGAAGTCAGTTATCC,1,2244621
marRp,0.3,11,9,GGCGCTAAAACTCTCGCGAT,2,2260560
marRp,3.2,40,9,GGCCTAACCATAGCTTGAAG,31,2219993
marRp,0.3,11,9,GGCCGCTTTGGGCCATCAGT,2,2232699
marRp,1.0,18,9,GGCCACTTATGAGTCATCAT,9,2220843
marRp,1.5,23,9,GGCATAACCGAGAGGCCCCA,14,2245423
marRp,7.7,85,9,GGCAGTTCCTTACTATTGCT,76,2259229
marRp,2.4,32,9,GGCAATTAGTATCTTACGGC,23,2250605
marRp,0.9,17,9,GGATTGGTCGGACCTAGGTG,8,2230526
marRp,1.0,18,9,GGATTCGTTCCTCTAGTGGT,9,2219888
marRp,0.3,11,9,GGATCCGCAGCCTGGCTATA,2,2248918
marRp,3.4,42,9,GGATAGCGAATCTTTTCAGG,33,2220752
marRp,0.4,12,9,GGAGGCGAGGGGACTCAATA,3,2255331
marRp,1.1,19,9,GGAGATTAAAGAGCACATCC,10,2219318
marRp,1.2,20,9,GGAAGCATTTATAGTCAAAG,11,2219441
marRp,1.7,25,9,GGAACGGCCGTTAGCAAAAC,16,2257621
marRp,0.2,10,9,GGAACCTCCGCGAGTAAGTG,1,2243329
marRp,0.7,15,9,GGAACCCTGTAGGCAATGCA,6,2222897
marRp,1.3,21,9,GGAAAGAGGGATTGTGTGGA,12,2226051
marRp,1.6,24,9,GCTTACTTGAAACAGGACGC,15,2236220
marRp,1.8,26,9,GCTGTTGCTCCTTACTTCTT,17,2218515
marRp,0.3,11,9,GCTCTGGCGGGCCGTGAATT,2,2238455
marRp,0.9,17,9,GCTCTCTACCAATGTGGACG,8,2247775
marRp,1.7,25,9,GCGCGGTAATGTTTAAACGT,16,2219971
marRp,0.4,12,9,GCGAGAGTCAGGGATAGGAC,3,2239499
marRp,0.5,13,9,GCCGAATAAAGAATACGGTA,4,2233564
marRp,0.2,10,9,GCCCGGTTCCCTGTCCAGTA,1,2253547
marRp,4.6,54,9,GCCCGATTACGGGCACAGAA,45,2240454
marRp,5.7,65,9,GCCCCAAAAATCTTTGCTGT,56,2222181
marRp,3.8,46,9,GCCAGCCTAGTGTCCTCGCA,37,2257592
marRp,5.3,61,9,GCATCGCATCACCATTGCAA,52,2219072
marRp,1.0,18,9,GCATCAGCGAGGGTGCTCGA,9,2249566
marRp,1.7,25,9,GCAGGGCAATTTAGCGTGTA,16,2237579
marRp,2.6,34,9,GCAGCCTCGCACTGGATATC,25,2244619
marRp,1.9,27,9,GATCGCTCCGAGGAGGTTTG,18,2250133
marRp,2.5,33,9,GAGCTCCTAGTGCCTTGTCA,24,2255776
marRp,1.3,21,9,GAGATCAGGCGTCAGTCACT,12,2228588
marRp,0.2,10,9,GAGACCAATCTAGTCCACCT,1,2240380
marRp,0.2,10,9,GACTTCACACATCGTCTGGT,1,2227739
marRp,11.0,118,9,GACTGTATCCTAGCGATATA,109,2248011
marRp,1.0,18,9,GACAGTGCAAAAGCCCAGGC,9,2233711
marRp,1.5,23,9,GAATCGAGGTACCAGTTAGT,14,2227924
marRp,0.9,17,9,GAATATGATACTCGCTCATT,8,2256339
marRp,2.6,34,9,GAAGTACACATTTGAATGTA,25,2237603
marRp,2.3,31,9,GAACTCAAACGGCTTTGGTT,22,2253638
marRp,0.2,10,9,GAACCAAACGCGGCTGTCTG,1,2257241
marRp,0.7,15,9,GAACAGTCTCCCGGTATAAC,6,2229495
marRp,0.4,12,9,GAAATAATACCCGCTCGAAG,3,2245661
marRp,1.8,26,9,GAAAGTATTGTTAATCGAGC,17,2256147
marRp,2.9,37,9,GAAAAAGATCGCCGTGACTA,28,2250770
marRp,15.2,160,9,CTTTGGTGGGCTAGGAGAGT,151,2255290
marRp,0.6,14,9,CTTTGAATAGGAGACGGTGT,5,2225886
marRp,0.3,11,9,CTTCAGCCTCGTCCAGTAGC,2,2231804
marRp,0.8,16,9,CTTCAATTATTAGTTCGGGT,7,2244401
marRp,1.3,21,9,CTTAGAAGCGAAGGTCTTTT,12,2257756
marRp,0.6,14,9,CTTACGTAAGTTCTCAGTCC,5,2241336
marRp,1.1,19,9,CTTAAAATACTTAAGGAAAG,10,2224609
marRp,0.2,10,9,CTGTGGTCTCGATATGGACG,1,2231981
marRp,8.2,90,9,CTGTCCCACTTGCGGAGGAG,81,2229974
marRp,0.9,17,9,CTGTATTCCCAGGGAAGTCA,8,2229864
marRp,3.2,40,9,CTGGGCAGCAATCTGTGGGA,31,2225054
marRp,29.9,307,9,CTGGGCAAATCGTGTCTGCA,298,2242341
marRp,0.9,17,9,CTGGGATCCCGTTCATTGTT,8,2258139
marRp,0.8,16,9,CTGGCTCAGTGGGTAAGTAG,7,2254632
marRp,1.5,23,9,CTGCTGAGAAGTATTGCTAC,14,2240151
marRp,9.0,98,9,CTGCTCGGCTATGCTAGATA,89,2233255
marRp,2.3,31,9,CTGCACGAGTAACACGGTGC,22,2246429
marRp,6.4,72,9,CTGCACCAAACACTGACGGA,63,2235490
marRp,1.1,19,9,CTGAAGCCAGGACTCAGACG,10,2223249
marRp,4.2,50,9,CTCTTCTAGCAGAAGTGGAA,41,2244926
marRp,0.6,14,9,CTCTGTCACTTATATTAGAC,5,2253447
marRp,1.9,27,9,CTCCGTTACTACATCCCACG,18,2250036
marRp,1.1,19,9,CTCCGCAATGTTGGGCTTAT,10,2228561
marRp,0.2,10,9,CTCAGTCAAGAATCGTCTAT,1,2239860
marRp,10.0,108,9,CTCAGTATCATCGAAAACTA,99,2224736
marRp,2.2,30,9,CTATCCATTAGGGCGTATGG,21,2260688
marRp,3.1,39,9,CTAGATTTGGGGTCCATCAT,30,2240350
marRp,10.5,113,9,CTAGATGTACAGAAGCGGAT,104,2222865
marRp,1.1,19,9,CTAGAAGTCGGGCGTTATAC,10,2244208
marRp,4.5,53,9,CTAACGTCCCGTCAGGGTGT,44,2222516
marRp,30.2,310,9,CGTTCCGAAGAGTAGTCAAA,301,2248572
marRp,1.0,18,9,CGTTACATTAAACGTCCGTA,9,2230896
marRp,0.7,15,9,CGTGTCGCTTTACAATAATA,6,2259328
marRp,1.2,20,9,CGTCGGCAAAGGGCTAGGCC,11,2248907
marRp,3.6,44,9,CGTCCGTTACCGTTCCTTAA,35,2223454
marRp,0.8,16,9,CGTATCCTGTATTCGAGTTG,7,2235786
marRp,1.2,20,9,CGGTTTTAGGCAGGCACAAA,11,2234628
marRp,9.8,106,9,CGGTGCGGACAAAGAATTAT,97,2223130
marRp,0.6,14,9,CGGCGGCACCGAGCGATCGG,5,2244874
marRp,2.0,28,9,CGGCACTGGATCTCGGGAAT,19,2235270
marRp,0.3,11,9,CGGAGTAGCCGTGCAGATAA,2,2245006
marRp,0.3,11,9,CGGACTCCTTACTGGGAGAT,2,2231269
marRp,1.7,25,9,CGCTGCAAACAGACTCTCTA,16,2221679
marRp,3.9,47,9,CGCTCTCCAACGGTTCATGA,38,2224968
marRp,0.2,10,9,CGCTATATGGCATTCCAGAT,1,2227561
marRp,1.9,27,9,CGCAGGGCTCTCCTCATGCA,18,2254955
marRp,0.5,13,9,CGCAGACAAATGACGGATCT,4,2238208
marRp,5.4,62,9,CGATGGCGGAGGGTATCGAC,53,2224235
marRp,2.4,32,9,CGATCGACCTTTTAGCCTTA,23,2255828
marRp,2.2,30,9,CGATCAACAGCTGTATGGGT,21,2243018
marRp,2.8,36,9,CGATAGGGTTTAACTTTTCT,27,2224684
marRp,12.9,137,9,CGAGGCGACCCTAACGGACT,128,2238107
marRp,3.2,40,9,CGACTGTCTCCGTTAGTAGT,31,2238511
marRp,7.5,83,9,CGACCTTTGAGATCTAGTCT,74,2235255
marRp,0.2,10,9,CGAATCCTGCTACGTCCGGA,1,2246968
marRp,0.3,11,9,CCTTGTATTAAGGAACAGCG,2,2251176
marRp,2.1,29,9,CCTTGGCATGCCGAACACTC,20,2227430
marRp,0.6,14,9,CCTGCTTAGTCCGTTCAAAA,5,2225629
marRp,0.3,11,9,CCGGTCACATTCCGGGCAAA,2,2243323
marRp,5.5,63,9,CCGGCTACGAGGTTGCACTC,54,2243821
marRp,3.7,45,9,CCGGAACGCCTGGTTCTAAG,36,2242139
marRp,0.2,10,9,CCGCTGCCAGTTTTTTTTAC,1,2229785
marRp,0.5,13,9,CCGCGGGATGTCTTTATAGA,4,2249676
marRp,3.2,40,9,CCGCAACTCGGTGATGGATG,31,2236474
marRp,0.5,13,9,CCGATCTCGTTATTAGTACT,4,2218751
marRp,5.1,59,9,CCGAGAGAGAAACACGGCAA,50,2241474
marRp,2.9,37,9,CCGAAGCTGCCCTCGCCGAC,28,2250672
marRp,7.9,87,9,CCGAACCGTATGCCACTTCC,78,2257406
marRp,1.1,19,9,CCCTCTTAGCAACATAAGTA,10,2223044
marRp,0.6,14,9,CCCTAGCTCGGGCTATGGTA,5,2237199
marRp,0.3,11,9,CCCGTGGTCCCCTAACGTCA,2,2233181
marRp,1.1,19,9,CCCGGTCTCCACTATGGCTC,10,2224880
marRp,1.1,19,9,CCCGGTACCGGCCGGGTGCT,10,2239971
marRp,0.5,13,9,CCCGGGACAGTCAGAAACGA,4,2238643
marRp,1.7,25,9,CCCCGATAGTCATAGCGCCT,16,2248266
marRp,0.7,15,9,CCCCAACTATTTTTATGTTT,6,2230350
marRp,7.7,85,9,CCCATCTGGGACGTGCTGTA,76,2235326
marRp,1.4,22,9,CCATTAGCTCCTTCCGGTCC,13,2221194
marRp,16.1,169,9,CCAGCCTACATGATGCTCAT,160,2240297
marRp,1.6,24,9,CCACATAGGTGGCATAAAGA,15,2225245
marRp,1.9,27,9,CATGTTTCCGCCATCAAACT,18,2255804
marRp,4.1,49,9,CATGGTGACCCCCTAAGGCA,40,2224620
marRp,2.9,37,9,CATCTGGATTCTAGTGCCCC,28,2245719
marRp,1.8,26,9,CATCCAATAAATTCCGTCAC,17,2241772
marRp,1.3,21,9,CATATTATGCGGGACTGCAA,12,2220460
marRp,0.3,11,9,CATAGGCCAGAGCCCATTAA,2,2222818
marRp,1.0,18,9,CATAACTAACAGACGTATTC,9,2256241
marRp,2.1,29,9,CAGTTTGATGAGCACCGTCC,20,2224355
marRp,0.9,17,9,CAGTCAGGTGTGGAAACCCT,8,2243697
marRp,2.8,36,9,CAGGCGGTCCCTAGATGTGG,27,2223633
marRp,1.0,18,9,CAGGCCCTAACCAGATGCCT,9,2251845
marRp,0.2,10,9,CAGGCAGGCGATGTACTGCA,1,2243623
marRp,5.5,63,9,CAGCGTAGACGGTTGAAATG,54,2220789
marRp,1.0,18,9,CAGCAACAGCAGCCTGTGAA,9,2248991
marRp,6.6,74,9,CAGATATTCCCGCAAATTGT,65,2258795
marRp,6.0,68,9,CACTTTCGGGTAGGAACTAA,59,2222175
marRp,1.3,21,9,CACTCAAAGTATTGGATCGC,12,2231529
marRp,8.2,90,9,CACGACGGAAAACATGAAGT,81,2221430
marRp,0.2,10,9,CACGAACCCTTTAGTTGTCG,1,2253881
marRp,2.8,36,9,CACCTTTCAGCTTAACAGGC,27,2257100
marRp,0.9,17,9,CACCTATTGAGTCATAACGC,8,2249726
marRp,12.9,137,9,CACCGCCTGTGTACTAGGTA,128,2243915
marRp,0.8,16,9,CACCCGCGAGACACGGGCTC,7,2249083
marRp,0.5,13,9,CACAGAGTGAAAATGGCCAC,4,2226435
marRp,0.4,12,9,CAATGGGACCAATCGCGACG,3,2235372
marRp,2.0,28,9,CAATCTCGGGTGACGAGCAT,19,2239881
marRp,3.0,38,9,CAAGTGAATTGGCGTCTCGG,29,2255937
marRp,12.7,135,9,CAAGAAAACACGAAAGACAG,126,2260539
marRp,2.3,31,9,CAACCTGGGTAAGAGGTGTC,22,2247017
marRp,0.6,14,9,CAAATAGTAAACAATGGGGT,5,2248484
marRp,1.8,26,9,ATTTGGCGCTGACTCTCTTC,17,2233213
marRp,4.0,48,9,ATTGAAGGGGAGCCACTAGA,39,2227432
marRp,0.8,16,9,ATTCGGTGTCCCATGCGCCC,7,2244297
marRp,1.1,19,9,ATTCAGGTCTTTTTCCTTTC,10,2223840
marRp,4.8,56,9,ATTATCGCACAACTCACATT,47,2238156
marRp,0.2,10,9,ATTAGTAGCTAAGTCGAGGG,1,2249431
marRp,2.2,30,9,ATGTGGCCAATTTTGAGCGA,21,2249614
marRp,0.3,11,9,ATGTACGCGTATCTGTAAGC,2,2254688
marRp,0.3,11,9,ATGGGGCAGCTGATACCTGG,2,2225620
marRp,5.1,59,9,ATGGGACCGACATCACTTAC,50,2224646
marRp,0.6,14,9,ATGCTGAACACTTCGCAGAC,5,2255657
marRp,11.8,126,9,ATGAGTGCCGATTTCGTTAA,117,2232179
marRp,0.4,12,9,ATGAAAAACCTATTGCGAAT,3,2253810
marRp,1.1,19,9,ATCTTCTTGACGCTACTGTT,10,2236551
marRp,0.4,12,9,ATCTGGGTAGTGACATGGTG,3,2241322
marRp,1.9,27,9,ATCTGATCGTACGACGTTTC,18,2237970
marRp,0.3,11,9,ATCGTGCTTAGAATATGATC,2,2237267
marRp,0.4,12,9,ATCGCCGTAACTGGACCTAT,3,2254351
marRp,0.3,11,9,ATCCGTTGTATGAGTGAATA,2,2237938
marRp,0.7,15,9,ATCCGGAGTTAGGGATTCAA,6,2245742
marRp,0.3,11,9,ATCCCGAAGTAACGCTTGGT,2,2220934
marRp,5.9,67,9,ATCCAATTCACGGCCACTTG,58,2221264
marRp,0.9,17,9,ATATGCATAGCTGAACCCGG,8,2256396
marRp,1.4,22,9,ATAGTTGACATACTGGCCAT,13,2244096
marRp,0.5,13,9,ATACTCAGCGTGAGTACATC,4,2250799
marRp,0.4,12,9,ATACCTGTCGGGGCATATTC,3,2252288
marRp,1.1,19,9,ATAAGACAAGGCGGTAAATG,10,2226531
marRp,0.6,14,9,ATAACAGAGGCTCGTCGGGG,5,2246830
marRp,0.3,11,9,AGTGTGGGTTAATGAAGGAT,2,2253789
marRp,6.5,73,9,AGTGGTCCTGTAGTTTCTGA,64,2252782
marRp,10.6,114,9,AGTGACATCTCGCGATTTAT,105,2249185
marRp,0.5,13,9,AGTCGTGTCTTTGTATCTGG,4,2242439
marRp,0.8,16,9,AGTCCTGTCTCAAATATAAA,7,2237517
marRp,1.3,21,9,AGTCCATTCGTAAAGAATCA,12,2253294
marRp,0.2,10,9,AGTCAAACCTATCTGCCAAC,1,2228558
marRp,1.0,18,9,AGTATAGAAGGGTCTTACCA,9,2255391
marRp,2.1,29,9,AGTAGGCCTCTCTGATGGAC,20,2239927
marRp,0.5,13,9,AGTACGACGTCGCGCACTCA,4,2253421
marRp,0.3,11,9,AGGGGAGGCGCGGGTTCCTA,2,2250750
marRp,4.0,48,9,AGGAGTCTGGTCAACGGCCT,39,2219263
marRp,1.5,23,9,AGCTTCACTCATTGAGTGTG,14,2229016
marRp,2.2,30,9,AGCTCGCGCGTCCCGCTAAC,21,2219948
marRp,0.4,12,9,AGCGTCCCCCAAGGCGTCAC,3,2248712
marRp,2.5,33,9,AGCGAACCCAGATCCGGTGA,24,2234849
marRp,0.9,17,9,AGCCTTTTGTCAGGATAGAT,8,2219968
marRp,1.3,21,9,AGCCCCGAGGAATGGACACT,12,2250670
marRp,1.4,22,9,AGCCACTTATTAATCGTTGT,13,2220871
marRp,1.8,26,9,AGCCAAGTATGATGAAAAAC,17,2229300
marRp,1.9,27,9,AGAGTTGATGGGTGGCATAT,18,2252339
marRp,0.2,10,9,AGACAAACAATTCATTCAAG,1,2245331
marRp,0.3,11,9,ACTTAAACCTAGGGTCAAGG,2,2224478
marRp,6.5,73,9,ACTGTCTTGCAGACATCCTA,64,2237124
marRp,1.1,19,9,ACTCATTATAGGAGGGGATA,10,2260502
marRp,7.9,87,9,ACGTGTCCCTGGGCATCTGT,78,2222230
marRp,7.5,83,9,ACGTGAAGCTCCGGTTGGAT,74,2222783
marRp,0.3,11,9,ACGTCCTTAAACGGACCGGT,2,2250980
marRp,0.4,12,9,ACGTAGCTCAAGGCTTAATG,3,2244378
marRp,4.3,51,9,ACGGTTGGTGATGCGGTCTT,42,2243784
marRp,17.8,186,9,ACGGTTACCGCAGCCGGCCC,177,2249483
marRp,0.2,10,9,ACGGACGGTAATGAACACTA,1,2259852
marRp,0.7,15,9,ACGCTGGACTGGTCTCCGTT,6,2233371
marRp,1.7,25,9,ACGACCGTGTATTACTAAGT,16,2246786
marRp,1.3,21,9,ACCTTTTGTAGGTTCAAGTG,12,2251341
marRp,0.3,11,9,ACCTTACGGCACTGCATGAG,2,2254610
marRp,0.2,10,9,ACCGACGGCCTGGTGGGTTA,1,2251183
marRp,2.1,29,9,ACCCTAGCGGCGCAGGTTGT,20,2249789
marRp,15.7,165,9,ACCCGATGGAATATGTGTTG,156,2223658
marRp,9.5,103,9,ACCCAGCGAATAGATTGGCT,94,2256425
marRp,7.8,86,9,ACCATGTTAGATGAGGAGAA,77,2247383
marRp,1.0,18,9,ACCAATGAGTACTAAATCTA,9,2237881
marRp,2.0,28,9,ACCAACTCGATGAGAAGAGC,19,2259285
marRp,4.4,52,9,ACATTCTTTGCATGATAAGA,43,2254332
marRp,1.3,21,9,ACATGCGCACGTTTACGTCG,12,2241471
marRp,1.6,24,9,ACAGCTGCCTGTTAAGTTTC,15,2219985
marRp,4.6,54,9,ACAGAAGTCATTGTACGAAG,45,2250346
marRp,0.2,10,9,AATTGGTATATACGAAACGG,1,2225971
marRp,6.1,69,9,AATGGGCACTCGTAAGGCAT,60,2257201
marRp,0.8,16,9,AATCCGACCTTGCGTGACAT,7,2226873
marRp,0.3,11,9,AATCATCACCCCAATGAAGC,2,2230720
marRp,0.2,10,9,AATCACGCCAGCCATCCTTG,1,2251979
marRp,1.4,22,9,AATATCCTCGATTGATCACA,13,2237928
marRp,1.1,19,9,AAGTCATCGATCCTACCATA,10,2244405
marRp,0.5,13,9,AAGTATGGCATCTACTGAAT,4,2223503
marRp,1.1,19,9,AAGTACGTATCAGAACACCC,10,2235028
marRp,2.6,34,9,AAGCAGTCAAGTTCGGCGCA,25,2220196
marRp,9.2,100,9,AAGAAATCCGCTAGGTTTGG,91,2237140
marRp,0.2,10,9,AACCTAGAAAGCGTTTCGAA,1,2256138
marRp,0.3,11,9,AACCCCCGAGTTCTGTACAT,2,2227241
marRp,2.2,30,9,AACCAGTTCGCGCAGTAAAT,21,2230733
marRp,0.8,16,9,AACAACTGGAGAGCGAGGTT,7,2258959
marRp,0.7,15,9,AAAGACTTCACACGTTTTAG,6,2254357
marRp,1.6,24,9,AAACCCACGGACCAAGCCCA,15,2249879
marRp,9.2,100,9,AAAATGCAAACGTCTTTTGG,91,2231763
marRp,4.6,54,9,AAAAGCCAGGTATACTCGTG,45,2251513
marRp,0.2222222222222222,9,8,TTTTTTTGGAACTCCCCGCC,1,2245291
marRp,0.2222222222222222,9,8,TTTTTTATAGATGGATAGAG,1,2252485
marRp,0.8888888888888888,15,8,TTTTAGCCGAATCCCGTGCA,7,2220897
marRp,1.3333333333333333,19,8,TTTTAAACTTCTTAGTTGTG,11,2229859
marRp,2.2222222222222223,27,8,TTTGGCTTTTTTTGCCTCAT,19,2218836
marRp,1.5555555555555556,21,8,TTTCCTGGCTGATGCGGGTG,13,2236797
marRp,4.666666666666667,49,8,TTTATTCGAGACAACATGTG,41,2243897
marRp,11.444444444444445,110,8,TTGTCGTGTGAGTGCGCCGC,102,2240274
marRp,2.7777777777777777,32,8,TTGTCGGCCACATTCCGGAT,24,2224554
marRp,1.2222222222222223,18,8,TTGCCCGCTTCCAGAACTAT,10,2226479
marRp,4.888888888888889,51,8,TTGCCCCGGCTCTACTGTTC,43,2223203
marRp,1.3333333333333333,19,8,TTCTTTAGGCGTTTTGGTGA,11,2235740
marRp,7.555555555555555,75,8,TTCTGTCTTTTATACGGACG,67,2256712
marRp,7.111111111111111,71,8,TTCTCGCCGCGTCTCTGTGT,63,2237675
marRp,1.7777777777777777,23,8,TTCGTATTTTTCGTGGGTCC,15,2235035
marRp,1.0,16,8,TTCGATATGCCCAAGTTACT,8,2219698
marRp,7.444444444444445,74,8,TTCCGTCTCGGGCTTCACTT,66,2245693
marRp,3.7777777777777777,41,8,TTCCGACTGTCGGGGGATGG,33,2238411
marRp,1.1111111111111112,17,8,TTAGGTGTCGTGACTTGTGA,9,2223482
marRp,10.444444444444445,101,8,TTACCACATCACACGATGTG,93,2218063
marRp,29.11111111111111,269,8,TGTTGCACCGTGCACGGGTG,261,2250268
marRp,14.777777777777779,140,8,TGTTGACGTGCGGGGTGCTC,132,2247583
marRp,2.0,25,8,TGTTATTCATTCGAGGTAAA,17,2250775
marRp,2.0,25,8,TGTGTCAGTAACGCACCCTA,17,2223205
marRp,0.5555555555555556,12,8,TGTCGGACTAAACGGAGCGG,4,2252210
marRp,0.5555555555555556,12,8,TGTATAGCGGCTTTATACAT,4,2255040
marRp,14.222222222222221,135,8,TGGTACATAGATCCTAACCT,127,2243289
marRp,24.666666666666668,229,8,TGGGGGGTTCGAATTGCAAT,221,2255148
marRp,0.3333333333333333,10,8,TGGGGCTCTTAATGCGGTAG,2,2220564
marRp,16.444444444444443,155,8,TGGGCACGTTTCGCAGTAAA,147,2250385
marRp,0.2222222222222222,9,8,TGGCGCTTCTTGATTCCCCC,1,2241389
marRp,2.2222222222222223,27,8,TGGCACCGACGCTACGCCCA,19,2244971
marRp,2.7777777777777777,32,8,TGGAGTCGCGGTGGTTCTCT,24,2261037
marRp,7.666666666666667,76,8,TGGAGGGGGTCCAATGCAAA,68,2220849
marRp,5.333333333333333,55,8,TGCGCATCGCGAGTCACGGG,47,2253325
marRp,0.2222222222222222,9,8,TGCCTGCCGTCATCAGCCTA,1,2255673
marRp,1.0,16,8,TGCCACCGGGTCCCGGGTGC,8,2218715
marRp,1.0,16,8,TGCATCTTTAGGGCAGACTA,8,2238394
marRp,0.2222222222222222,9,8,TGCAACGGTTACGCGTGAGC,1,2241234
marRp,0.2222222222222222,9,8,TGCAACCGAGACCACACTTT,1,2228097
marRp,0.5555555555555556,12,8,TGAGAAGACGAGGTATCGCA,4,2260574
marRp,1.1111111111111112,17,8,TGACTACATGTGGTTAGCGT,9,2249620
marRp,2.7777777777777777,32,8,TGACGTGACCCGCCTAACAA,24,2253330
marRp,1.1111111111111112,17,8,TCTTTGAACGCCTAACACGA,9,2220376
marRp,7.444444444444445,74,8,TCTGTTTGGTGGAGCACTGT,66,2224643
marRp,0.4444444444444444,11,8,TCTGCATCTTATTACGCCTC,3,2232824
marRp,2.7777777777777777,32,8,TCTCTGTGAATATCACTCGC,24,2220431
marRp,4.777777777777778,50,8,TCTAGAGCGGGGGGTCAAAC,42,2231364
marRp,0.5555555555555556,12,8,TCGCGATTAGATTGGCGGGG,4,2248172
marRp,2.4444444444444446,29,8,TCGACAATTAGACCGCGGTC,21,2245988
marRp,1.8888888888888888,24,8,TCGAACAAAGGTCACTTCAC,16,2254767
marRp,0.3333333333333333,10,8,TCCTACTACTTTACTGGATG,2,2254596
marRp,4.111111111111111,44,8,TCCGCGCAAATCAAGTGTTG,36,2259426
marRp,14.11111111111111,134,8,TCCATCACGTCTTGTGGTCT,126,2248568
marRp,1.3333333333333333,19,8,TCCAGAACGCACGCCTCGCA,11,2249783
marRp,0.7777777777777778,14,8,TCAGCATATCTTAACACGGT,6,2237880
marRp,1.7777777777777777,23,8,TCAATGGTTCCTTCATCCAT,15,2226878
marRp,1.3333333333333333,19,8,TCAAATTTTGAGCCACCTTA,11,2227478
marRp,0.8888888888888888,15,8,TATTTGATGATTGATTCGTG,7,2243513
marRp,0.6666666666666666,13,8,TATTATTATAAACATCCTCC,5,2253847
marRp,3.0,34,8,TATGTGGGTATCTTAGTGCA,26,2233964
marRp,0.6666666666666666,13,8,TATCGCCATTAGTTGTAAAC,5,2252085
marRp,10.666666666666666,103,8,TAGCTTCGTGCCGATAGCAA,95,2233962
marRp,8.0,79,8,TAGCATATATTCCCACGTGA,71,2218565
marRp,3.0,34,8,TAGACTTCCATTAAAAGGCT,26,2239959
marRp,0.5555555555555556,12,8,TACTGTCAGATGGTGTCGCG,4,2246904
marRp,7.222222222222222,72,8,TACTGAGGTAGTGTGTAATT,64,2243003
marRp,3.2222222222222223,36,8,TACTATACGAATGTAATTAG,28,2221242
marRp,2.111111111111111,26,8,TACTACGTCCACCGTTTCTC,18,2228814
marRp,0.2222222222222222,9,8,TACATTTGGAAACAAGCGAA,1,2234016
marRp,2.3333333333333335,28,8,TACATTGATGACATCCTAGA,20,2226460
marRp,2.6666666666666665,31,8,TACACGCACCTTATGAGGGG,23,2242748
marRp,0.2222222222222222,9,8,TACAAGATTGAATTCATGTA,1,2238275
marRp,0.6666666666666666,13,8,TAATAAGATAGCTATGCCAG,5,2239818
marRp,4.555555555555555,48,8,TAAGCTTCATTGTTAACAGG,40,2236251
marRp,5.444444444444445,56,8,TAAAAGTGACCGACGAGAGA,48,2241958
marRp,1.2222222222222223,18,8,GTTCGACGTCAAATCCACTA,10,2229568
marRp,0.8888888888888888,15,8,GTTCAGTGATGATTCTCACC,7,2236219
marRp,5.888888888888889,60,8,GTTAAACGTGCGTCAAAACA,52,2220195
marRp,1.1111111111111112,17,8,GTGTGGAGTTTCTTTAAGCA,9,2254566
marRp,2.0,25,8,GTGTCAGCTAGTATTTGATT,17,2246833
marRp,1.1111111111111112,17,8,GTGTATTGAAATGATATGCA,9,2259866
marRp,0.8888888888888888,15,8,GTGCGAACCCTTCCTCATTG,7,2221873
marRp,0.2222222222222222,9,8,GTGCCGGTAGCCTCAATATG,1,2229559
marRp,6.777777777777778,68,8,GTGCACTCGCAAGTCTCTGA,60,2218830
marRp,0.8888888888888888,15,8,GTGAAGATGTACTAAATTTT,7,2239953
marRp,2.2222222222222223,27,8,GTCTGGGTCAGCTCGTAGCT,19,2259087
marRp,1.3333333333333333,19,8,GTCTCCCCAAGGTTGTACGT,11,2225810
marRp,1.3333333333333333,19,8,GTCTATCACGATTAAGGCGC,11,2239603
marRp,1.7777777777777777,23,8,GTCCGGTGGACCCCAGAAGG,15,2235447
marRp,0.2222222222222222,9,8,GTCCCATGTGTCCCGTTGGA,1,2217812
marRp,1.2222222222222223,18,8,GTCACCCTTTGCCGCGGAAC,10,2223973
marRp,0.3333333333333333,10,8,GTCAATTTCGACACCTCTCC,2,2232954
marRp,0.6666666666666666,13,8,GTATTCATTTCGACTGCGAA,5,2219606
marRp,3.2222222222222223,36,8,GTATGACGAGCAGACTACGG,28,2234376
marRp,1.0,16,8,GTATATAAGACCCCTGTTGG,8,2242133
marRp,1.3333333333333333,19,8,GTAGGATTGTCTTACCGTTT,11,2218093
marRp,0.4444444444444444,11,8,GTACGACATCTAAAATCATT,3,2251366
marRp,5.555555555555555,57,8,GTACCATCGGGAGCGCGCCC,49,2259878
marRp,2.3333333333333335,28,8,GGTTCTACTCCTAGGAGCTT,20,2251436
marRp,1.1111111111111112,17,8,GGTTCAGTAGTGCAGCAAGC,9,2230014
marRp,1.1111111111111112,17,8,GGTTAGGCTCAGTCATTGTG,9,2244290
marRp,0.7777777777777778,14,8,GGTCTTCTGATTTGGCGGGG,6,2257306
marRp,0.5555555555555556,12,8,GGTCTGAGGCTCCGTGTGCC,4,2236390
marRp,2.111111111111111,26,8,GGTAAGCAGCCGGCCACGTG,18,2241022
marRp,0.6666666666666666,13,8,GGGTTCCGAAGTGAGTAGGG,5,2240731
marRp,1.6666666666666667,22,8,GGGTTAGGGTACTGGAATGA,14,2250753
marRp,1.0,16,8,GGGTCAAAGCCTCTCACTGG,8,2257410
marRp,13.555555555555555,129,8,GGGGTCACGACAATCACTCC,121,2234344
marRp,2.3333333333333335,28,8,GGGCTGCGAAGTCCCCAGTA,20,2224906
marRp,0.6666666666666666,13,8,GGGCTCTGCTATGGAAGCGG,5,2239801
marRp,2.4444444444444446,29,8,GGGATGACTGAAAGCTTCTC,21,2255700
marRp,4.888888888888889,51,8,GGCTCTCTGGTAATTCAACG,43,2235960
marRp,0.2222222222222222,9,8,GGCTCCTGAGACAGGGCTGA,1,2231155
marRp,6.666666666666667,67,8,GGCTCATCAGCGCGGTCTCA,59,2241130
marRp,0.3333333333333333,10,8,GGCGCTCATCAGAGTTGCAG,2,2243264
marRp,2.3333333333333335,28,8,GGCGAGTCGCCCTCAATAGA,20,2224130
marRp,0.4444444444444444,11,8,GGCCTCGCGGTCTACTGACA,3,2258058
marRp,0.6666666666666666,13,8,GGCCCGGGAGCTCTCGCGGA,5,2227759
marRp,0.2222222222222222,9,8,GGCCACAGAGCGGAGCTTTT,1,2242113
marRp,0.3333333333333333,10,8,GGCATAGAGAGCCTCTAGAA,2,2223880
marRp,7.666666666666667,76,8,GGATGGTAAGCAGTATCACG,68,2259767
marRp,3.0,34,8,GGACGTCGTTCCGGACGCAA,26,2248953
marRp,2.0,25,8,GGACAGTGTATAAACTAAGC,17,2228340
marRp,2.2222222222222223,27,8,GGAAGTAGTGATGCTCAACT,19,2221866
marRp,9.0,88,8,GGAAGCACGTGTACCCCGGT,80,2259339
marRp,0.6666666666666666,13,8,GCTTCGATTAATGGGCCTAA,5,2244620
marRp,0.7777777777777778,14,8,GCTTATATGGTTCCTTACCA,6,2237608
marRp,10.0,97,8,GCTTAGGAATCTACGGCTTT,89,2240815
marRp,4.111111111111111,44,8,GCTCCATTCTATTAAAACTC,36,2250676
marRp,1.7777777777777777,23,8,GCTACGAGGGTTTTGGGGTA,15,2254546
marRp,2.6666666666666665,31,8,GCGTCATTGGTGTGTGACGG,23,2237882
marRp,3.2222222222222223,36,8,GCGCCGCTAAACGCTTGAGT,28,2236044
marRp,3.6666666666666665,40,8,GCCGTCTGTGGTTGGCACCA,32,2260024
marRp,0.2222222222222222,9,8,GCCGACAGTTGCTCCATTAG,1,2230855
marRp,5.333333333333333,55,8,GCATTGACGTTTGGTCGAAC,47,2247393
marRp,0.8888888888888888,15,8,GCACGAATATAGCGTGGGGT,7,2250864
marRp,2.2222222222222223,27,8,GCACATAGGGCGTTCTATAA,19,2237840
marRp,0.3333333333333333,10,8,GCAATATTAGGCGAAGATCC,2,2255646
marRp,1.1111111111111112,17,8,GATTGATAGGCACGGGCATG,9,2232272
marRp,1.0,16,8,GATGCCACACTAGGTCCCAC,8,2258990
marRp,0.2222222222222222,9,8,GATGACTTGCGAGTCCACTG,1,2221213
marRp,0.8888888888888888,15,8,GATGACCTCATACATTTGCA,7,2220311
marRp,0.2222222222222222,9,8,GATAGTAAATAACTGAGGAG,1,2222629
marRp,1.1111111111111112,17,8,GATAGCAAGGCTTTTGCTAC,9,2257090
marRp,1.6666666666666667,22,8,GATACATTGGTAAGCCTATC,14,2248224
marRp,1.7777777777777777,23,8,GAGTAAAAGAGGGCACACCG,15,2224702
marRp,3.4444444444444446,38,8,GAGGTAGTATCCCACTTGCA,30,2223183
marRp,2.0,25,8,GAGGAAGGCTATTCTGTTTC,17,2246295
marRp,3.111111111111111,35,8,GAGCCTGATGAGGGTATGTG,27,2251950
marRp,19.666666666666668,184,8,GAGCACATAAGAGCTGCTGG,176,2244835
marRp,13.0,124,8,GAGACAGCCTTTTGCCACAG,116,2239321
marRp,2.111111111111111,26,8,GACCAAGGGGCCTGCTGTTT,18,2231816
marRp,2.5555555555555554,30,8,GACAATGTGCCAGACTGTAA,22,2235277
marRp,7.666666666666667,76,8,GAATGTTAGATGCAGGCCCT,68,2259945
marRp,2.0,25,8,GAACGGTTGGGCAGGCGCCT,17,2222482
marRp,14.777777777777779,140,8,GAACAGGTGTGGACTCGCAC,132,2249469
marRp,2.5555555555555554,30,8,GAAAGCTTTCTAGCTGGTGG,22,2247174
marRp,0.4444444444444444,11,8,GAAACGAGTCACGAAACCTC,3,2258643
marRp,0.2222222222222222,9,8,CTTTGCAGCCTAGCTTCGCA,1,2244607
marRp,1.7777777777777777,23,8,CTTTGATAATCTGGGAGATA,15,2236569
marRp,4.888888888888889,51,8,CTTTACCACGGGCTGTGTGC,43,2230964
marRp,0.2222222222222222,9,8,CTTGGCTAATACAATGGATG,1,2246834
marRp,11.11111111111111,107,8,CTTGACAGGAACCCAGAACC,99,2230384
marRp,0.7777777777777778,14,8,CTTCGACTATAGGACCCATA,6,2228108
marRp,0.7777777777777778,14,8,CTCTTCGGACGCCCGACAGT,6,2252360
marRp,6.777777777777778,68,8,CTCGTTGGTTGTTTTGAAAG,60,2223076
marRp,1.3333333333333333,19,8,CTCGGATACTGGAAACACGG,11,2231828
marRp,0.5555555555555556,12,8,CTCCCGTGTAGTGCAAATTC,4,2237060
marRp,0.4444444444444444,11,8,CTCAGTTGCCTAGGCATGCT,3,2247742
marRp,0.6666666666666666,13,8,CTCACTAGAATTATTCACCG,5,2226015
marRp,1.5555555555555556,21,8,CTCACGCTCCACTATGTACG,13,2260162
marRp,7.222222222222222,72,8,CTATCAGACGGGAAGAGGAA,64,2238765
marRp,0.3333333333333333,10,8,CTATAGTTAAACTGGTATAC,2,2220476
marRp,2.7777777777777777,32,8,CTACAAAGGGCTCGTACTGT,24,2219870
marRp,1.7777777777777777,23,8,CTAAGTGGGCGTTAAAGAGT,15,2251017
marRp,2.111111111111111,26,8,CTAAGTGGGATGCAGTAATG,18,2242313
marRp,2.888888888888889,33,8,CTAAGTCCGACCTTAATCGA,25,2224476
marRp,58.77777777777778,536,8,CGTTTGAAGACCGTAGCTCA,528,2225316
marRp,0.3333333333333333,10,8,CGTTGGAAATACTTAAGTTC,2,2258658
marRp,0.6666666666666666,13,8,CGTTGCCGAGACGCGTATAG,5,2240851
marRp,2.7777777777777777,32,8,CGTTCCGGTGCACATAATTA,24,2245860
marRp,4.777777777777778,50,8,CGTCACGAGTATTTCCAGTT,42,2225244
marRp,0.4444444444444444,11,8,CGTAGGTAGTAAAGTCCGCT,3,2221210
marRp,9.0,88,8,CGTAAAGACGGGAAGGTCAC,80,2235251
marRp,0.2222222222222222,9,8,CGGTTAACGCGTCTTAATAA,1,2227415
marRp,2.888888888888889,33,8,CGGTGTTCGGTCATAGGCCA,25,2220128
marRp,1.6666666666666667,22,8,CGGTGGGGTTAACGGAAATA,14,2232317
marRp,0.6666666666666666,13,8,CGGTGATACTTTTGTTAAGA,5,2229232
marRp,0.7777777777777778,14,8,CGGTACCCCTGGTTGATTTT,6,2234217
marRp,2.7777777777777777,32,8,CGGGGTGTATACGGGCACAC,24,2232507
marRp,1.8888888888888888,24,8,CGGGCGGACACTAGCTGGGT,16,2257517
marRp,3.3333333333333335,37,8,CGGCTGTTCTTAAGTAGGAG,29,2225186
marRp,7.444444444444445,74,8,CGGCTGTGACTCAAGTGGGA,66,2242402
marRp,1.0,16,8,CGGACCTCTACGAAGCGCCC,8,2258849
marRp,1.1111111111111112,17,8,CGGACAGGTTGACGGCCACA,9,2222568
marRp,7.222222222222222,72,8,CGGACAAGTTACTGTGAATG,64,2218406
marRp,0.6666666666666666,13,8,CGCAGAAGCAAGCATACGAT,5,2259195
marRp,1.1111111111111112,17,8,CGATCCGGTTGCTGCAGCAT,9,2239886
marRp,3.5555555555555554,39,8,CGAGTTAGTACCCACAGTAT,31,2250693
marRp,1.6666666666666667,22,8,CGAGACAGAAAACCGCCACG,14,2236439
marRp,0.2222222222222222,9,8,CCTGTCTAAGAGTTCTCCGA,1,2256608
marRp,0.2222222222222222,9,8,CCGTTTTATGGGTTAATGTT,1,2221448
marRp,1.1111111111111112,17,8,CCGTGCGTAGTTTGCTTCCT,9,2251689
marRp,1.5555555555555556,21,8,CCGTAGCAAGCGCGTGGAAC,13,2232601
marRp,26.666666666666668,247,8,CCGGTGATTCGGGCCGGCCC,239,2243419
marRp,16.11111111111111,152,8,CCGGCTCCGTGTCATCTGAT,144,2250279
marRp,1.2222222222222223,18,8,CCGCTTGGGTCGGCGGACAG,10,2239378
marRp,2.3333333333333335,28,8,CCGCGGGGGAGTTCATCTGA,20,2222179
marRp,0.4444444444444444,11,8,CCGAACGACATGCGTCCAAT,3,2217921
marRp,12.0,115,8,CCCTCATTCGCCGTGCTGGA,107,2222839
marRp,1.1111111111111112,17,8,CCCGCGTGTGTGTGATTACG,9,2228818
marRp,0.2222222222222222,9,8,CCCACTGGAGTGCTGGTCTT,1,2257803
marRp,1.5555555555555556,21,8,CCATTCTTCAGGAGTTCAAC,13,2246205
marRp,1.6666666666666667,22,8,CCATTATGTATGATAGGCCT,14,2236279
marRp,2.3333333333333335,28,8,CCACGGAAGAGTGCCATATT,20,2233943
marRp,1.8888888888888888,24,8,CCACGCTTTGTTTGAGTCGG,16,2219889
marRp,0.5555555555555556,12,8,CCACCCCATACGAGTCGTCG,4,2233604
marRp,0.8888888888888888,15,8,CCACATATAGATCTATCGGG,7,2239058
marRp,1.2222222222222223,18,8,CATGTTATAGACCTTTAATT,10,2237642
marRp,4.777777777777778,50,8,CATGAAAAAATCCGCGGGGA,42,2257656
marRp,0.6666666666666666,13,8,CATCTACGAGCTGGTCTTGC,5,2229320
marRp,1.6666666666666667,22,8,CAGTTTAGGACTGCGTATCT,14,2232587
marRp,3.6666666666666665,40,8,CAGTGAAGCACCGGTTCCGA,32,2251638
marRp,3.888888888888889,42,8,CAGTCACTCAATGATCGGTA,34,2239117
marRp,2.7777777777777777,32,8,CAGGTCACACCAGTGCGGTC,24,2255081
marRp,1.0,16,8,CAGGCAGTCTAGCGCCGCGT,8,2244412
marRp,1.2222222222222223,18,8,CAGCCGAATCAGCCCCGCTA,10,2223844
marRp,1.0,16,8,CAGAGGTAATGGGCCGACCT,8,2260957
marRp,2.4444444444444446,29,8,CACGGCAAAGCACTTTAGCT,21,2243517
marRp,3.111111111111111,35,8,CACGCCACTAACCTACCTAA,27,2241444
marRp,55.55555555555556,507,8,CACGCCACCAGGCGCGGTGA,499,2221537
marRp,0.4444444444444444,11,8,CACCGAGTCGTCTAACGTAG,3,2253819
marRp,2.111111111111111,26,8,CACCCATAGTGGAACTCAAC,18,2246631
marRp,4.111111111111111,44,8,CACCACTGTGACACGCCAGG,36,2220759
marRp,6.0,61,8,CACACAAGCGCCCGACATCT,53,2230893
marRp,0.2222222222222222,9,8,CAATGATTGTTTTTGCGACG,1,2235710
marRp,0.8888888888888888,15,8,CAAGCTAACCCCGCTATCAC,7,2242290
marRp,0.2222222222222222,9,8,CAAGAGGGCGCCTTCTCAAA,1,2234909
marRp,2.0,25,8,CAACTTATGCCACTGGAGTC,17,2259451
marRp,15.88888888888889,150,8,CAACCGAGGAGTGACAGTAA,142,2240455
marRp,0.8888888888888888,15,8,ATTTAAGCAGATCGAGTTGT,7,2254695
marRp,2.111111111111111,26,8,ATTGTAGTATCGCTGGGGTA,18,2256886
marRp,0.7777777777777778,14,8,ATTGTACTGGCTGGCTCTAT,6,2230780
marRp,1.1111111111111112,17,8,ATTGGCGCGACCATCGATTG,9,2244318
marRp,0.3333333333333333,10,8,ATTGCGTTAATCTTCCCCAG,2,2231037
marRp,0.5555555555555556,12,8,ATTCAAACTTCAGTACGAGA,4,2231142
marRp,0.4444444444444444,11,8,ATTATTCCCTTTAACGTCTT,3,2241726
marRp,0.7777777777777778,14,8,ATGTTGTACTGTAGAGACTG,6,2218014
marRp,2.0,25,8,ATGTGTCGAAGTTGAATTAT,17,2232344
marRp,0.3333333333333333,10,8,ATGTCTTGGTCGATACACCC,2,2250979
marRp,2.0,25,8,ATGTACGAAATACGGCCTGC,17,2223423
marRp,1.4444444444444444,20,8,ATGGATAAGAGGGTGACTCA,12,2225005
marRp,2.888888888888889,33,8,ATGCTGCATGGGCTACCGCG,25,2246449
marRp,4.666666666666667,49,8,ATCCGGTGCCAGTGGACAGC,41,2223073
marRp,1.3333333333333333,19,8,ATCCGGAGTAAGCAGACTGA,11,2229439
marRp,3.6666666666666665,40,8,ATCCGCAAGTGAATCCCATT,32,2249184
marRp,1.5555555555555556,21,8,ATCCGATTTTGCAAAGTCTA,13,2250858
marRp,1.2222222222222223,18,8,ATCACGGGCTATATGATTTA,10,2242950
marRp,12.444444444444445,119,8,ATCACCTCTAAGAGTGATTA,111,2236997
marRp,12.11111111111111,116,8,ATCAAAAGAGCACTAAAGCA,108,2233961
marRp,0.7777777777777778,14,8,ATATTGAGTCGAAAGAAGCC,6,2238483
marRp,8.555555555555555,84,8,ATATGGAAGAGCGATGCTTC,76,2257407
marRp,15.444444444444445,146,8,ATATGAGTGACACGTGTGTA,138,2234562
marRp,1.4444444444444444,20,8,ATATCGTACAGGAATGGTCA,12,2248718
marRp,0.6666666666666666,13,8,ATAGATGTACGCACCGGATT,5,2240827
marRp,3.111111111111111,35,8,ATACGGGTTAAGCGTGCATT,27,2259403
marRp,0.7777777777777778,14,8,AGTTGTGTTCTCCCGGGAGA,6,2232631
marRp,11.666666666666666,112,8,AGTGCAGCTTCAAGGAAAGA,104,2223133
marRp,4.222222222222222,45,8,AGTCGTGAAACGCCTAATTC,37,2249182
marRp,25.77777777777778,239,8,AGTCGTCTGCCGCGAAGAAA,231,2248576
marRp,2.0,25,8,AGTCCCTCCAAGGGGGGTAA,17,2234090
marRp,2.7777777777777777,32,8,AGTCACGATCTTGAGGGTGC,24,2236639
marRp,0.2222222222222222,9,8,AGTAGATACGTTAGTGCCAC,1,2219730
marRp,0.2222222222222222,9,8,AGTAATAGTTTAAGCATAAG,1,2228587
marRp,0.4444444444444444,11,8,AGGTTTTTCGGAAAGGTATA,3,2221667
marRp,4.444444444444445,47,8,AGGTTGGAAGTATCATGGTA,39,2218068
marRp,2.0,25,8,AGGTGGACAGCAGGAGGTGT,17,2239000
marRp,18.11111111111111,170,8,AGGTAGGCTAGTGCACCTCG,162,2234339
marRp,1.7777777777777777,23,8,AGGGCTCTGGACGTCGTAGG,15,2222850
marRp,1.4444444444444444,20,8,AGGCTCGTCGTACATTTTAA,12,2241817
marRp,0.7777777777777778,14,8,AGGATTAATCGTGAAACCTT,6,2249089
marRp,5.0,52,8,AGGAGTTCCCAGCCTCCAAT,44,2249149
marRp,0.2222222222222222,9,8,AGGAGTCCTACACTAAGCAG,1,2240313
marRp,3.0,34,8,AGGAGATGAGTCTATTGCCT,26,2257575
marRp,3.5555555555555554,39,8,AGGAGAAGTATATATGTGTA,31,2257528
marRp,0.7777777777777778,14,8,AGGAACTACCCTTCCCCGGA,6,2250538
marRp,1.0,16,8,AGCGTGCTCGTGCAGCAGAC,8,2253869
marRp,0.3333333333333333,10,8,AGCGTGCCGAACCATATTGA,2,2242851
marRp,2.6666666666666665,31,8,AGCCTGCCGTATAAGGAAGG,23,2256919
marRp,1.2222222222222223,18,8,AGCCAGCCTTCTGAGGCCGA,10,2225211
marRp,1.5555555555555556,21,8,AGCACTAACGGTAGTCGATC,13,2225243
marRp,9.444444444444445,92,8,AGATCCCCCAGTATTGCTCT,84,2250961
marRp,1.8888888888888888,24,8,AGAGGGGGGACGTTGTCCAT,16,2258982
marRp,0.4444444444444444,11,8,AGAGGGGAGCTATTATCACG,3,2233229
marRp,1.8888888888888888,24,8,AGAGGCTGCGACCTGCGTGT,16,2241734
marRp,0.8888888888888888,15,8,AGAGATGATTCATACCTTAT,7,2221840
marRp,4.333333333333333,46,8,AGACAGCACAGCCCATTACA,38,2242203
marRp,8.11111111111111,80,8,AGAACTGCCTGGAGAGTCCT,72,2226574
marRp,1.3333333333333333,19,8,ACTTCTGGAGGGGCCGAAGC,11,2235551
marRp,2.6666666666666665,31,8,ACTATCTGTTCAAAGCTTAT,23,2260887
marRp,6.111111111111111,62,8,ACGTTTGACGCCCCTCGGCC,54,2226139
marRp,3.0,34,8,ACGGATGTATGCCTATTGTC,26,2221925
marRp,8.666666666666666,85,8,ACGGAATATCGTGGTGATTA,77,2254118
marRp,2.111111111111111,26,8,ACGCGCCTGATGTAATGAAT,18,2242260
marRp,4.222222222222222,45,8,ACGCCCGGGATGTAACGCCT,37,2236254
marRp,12.444444444444445,119,8,ACGAGTTTTGCAGGCTGACA,111,2258397
marRp,6.111111111111111,62,8,ACCTGAGTCCAAGCCTAAGA,54,2246148
marRp,22.333333333333332,208,8,ACCATAGTCAGTATACGACG,200,2226571
marRp,7.444444444444445,74,8,ACCATACGCCCGAAGAAAAA,66,2242557
marRp,35.55555555555556,327,8,ACATCGGTCGTCTACAAGAT,319,2226825
marRp,5.0,52,8,ACATCGAGCACTAAGGCATA,44,2247468
marRp,0.2222222222222222,9,8,ACATAGGATAACGCCTATGA,1,2227123
marRp,0.4444444444444444,11,8,ACATAAGGCTCCACTGCTTA,3,2241272
marRp,3.2222222222222223,36,8,ACAGGTACGCCGAACGCCAC,28,2247010
marRp,10.333333333333334,100,8,ACAGATGTATGTTGAGGCCA,92,2221483
marRp,7.444444444444445,74,8,ACAAAGTCGATGGGCTACGC,66,2228138
marRp,6.444444444444445,65,8,ACAAAAAGGATTGTGTCATG,57,2223074
marRp,0.2222222222222222,9,8,AATTCATATATGTAAGACGA,1,2224115
marRp,0.2222222222222222,9,8,AATTAACGTTCCCCCTGGGG,1,2250082
marRp,1.7777777777777777,23,8,AATGACAAGTTCGGAACACT,15,2223452
marRp,0.7777777777777778,14,8,AATCGCATCAGGGTGGCAAG,6,2259401
marRp,0.4444444444444444,11,8,AATCGATGCTGCCCTCTCGG,3,2226204
marRp,1.0,16,8,AATAAGCGTCGGGTCAGTTC,8,2243739
marRp,0.5555555555555556,12,8,AAGTTTGCAAGCAGTATTAG,4,2232910
marRp,1.5555555555555556,21,8,AAGTGTCCCGGACACAACCT,13,2246521
marRp,2.0,25,8,AAGTACACGATGCGGCATGT,17,2258224
marRp,15.666666666666666,148,8,AAGGCTTGCGAAACTGGGGC,140,2247060
marRp,0.8888888888888888,15,8,AAGCGTATGTCATTCATGGT,7,2235442
marRp,1.6666666666666667,22,8,AAGCGATCAGTCAAGTGGCC,14,2251284
marRp,1.2222222222222223,18,8,AAGATCCTGCCATCATGGTA,10,2256527
marRp,1.2222222222222223,18,8,AACTTGAATGAATGTCCACA,10,2256482
marRp,14.777777777777779,140,8,AACTAACGCTGAATCCGGTG,132,2247595
marRp,1.0,16,8,AACGGGTTTCTGCCAATTCT,8,2235559
marRp,0.4444444444444444,11,8,AACGGGTTGGGGATATCCGG,3,2253880
marRp,0.7777777777777778,14,8,AACGCAGTTCGATAATTCAA,6,2227237
marRp,5.111111111111111,53,8,AACCTTTCAGATTCCCTCTA,45,2222959
marRp,0.7777777777777778,14,8,AACACAAGTGTACAATAGGA,6,2232648
marRp,0.7777777777777778,14,8,AAATTAAAGGGGGAACTTGG,6,2253163
marRp,3.888888888888889,42,8,AAATGCTCAATAAATTGACG,34,2231623
marRp,25.11111111111111,233,8,AAATCTTCGAGGACCGAGAT,225,2259733
marRp,0.3333333333333333,10,8,AAAGGCATTATGCCGATTTG,2,2234710
marRp,0.5555555555555556,12,8,AAACTGGGAGATACGTTGAT,4,2245624
marRp,0.5555555555555556,12,8,AAACAGTACCTTGAAACCTG,4,2228503
marRp,0.6666666666666666,13,8,AAAACAGATCCCCTGAATCC,5,2236466
marRp,1.375,17,7,TTTTCTAGTTGCAGTCACAA,10,2253841
marRp,0.875,13,7,TTTGTACACAGATTCGTGAC,6,2256666
marRp,6.125,55,7,TTTGCCAGGAATCGTACCAT,48,2243109
marRp,3.0,30,7,TTTGACATGGTACTTTACTG,23,2221076
marRp,1.0,14,7,TTTCTGCATTGGACAACCAA,7,2231863
marRp,0.25,8,7,TTTCGTGAATAGCAAAATAT,1,2252016
marRp,0.375,9,7,TTTCACTCATCTTTCCACGT,2,2221247
marRp,4.0,38,7,TTTATACTACCAAGGGGGGG,31,2222285
marRp,2.75,28,7,TTTACATTGCTACTGAGCTA,21,2259497
marRp,1.0,14,7,TTGTGAATGGGTCTCCTCAG,7,2244152
marRp,2.0,22,7,TTGGGTTGCACTTCTGACAT,15,2249115
marRp,3.75,36,7,TTGCTGGAAGGTGGGATCCC,29,2230988
marRp,1.0,14,7,TTGCTAAAAAAAGTTCCTAT,7,2226340
marRp,0.5,10,7,TTGCGTGTGTATTAGGCTTG,3,2220721
marRp,0.625,11,7,TTCGTCCCTCCCAGCCGTCG,4,2229786
marRp,3.875,37,7,TTCGCTGCCTCCATTTGATG,30,2260993
marRp,1.875,21,7,TTCGATATCGTCTGTACGGG,14,2234470
marRp,4.5,42,7,TTCGAGTAGAGCACTTAATA,35,2234927
marRp,3.0,30,7,TTCGAGACTGAGCCACATAT,23,2220304
marRp,1.375,17,7,TTCCACGACGAAACACCTTC,10,2250428
marRp,0.25,8,7,TTCAGGAAGCTCCCCCACAG,1,2253043
marRp,1.125,15,7,TTCAAGAACGAAGAACGGAT,8,2233119
marRp,0.75,12,7,TTATGTCGAGCTGCGCTTCT,5,2247728
marRp,0.375,9,7,TTATGTAGTAAGCAAGTTCT,2,2235153
marRp,0.75,12,7,TTATAGATGCTGGCCCACCC,5,2236613
marRp,1.875,21,7,TTATAAAGAGACCTGACGGT,14,2230976
marRp,1.0,14,7,TTAGCCTGGCGAGGTAAAAT,7,2235553
marRp,15.875,133,7,TTAGCCGCCCAGGCTGACTT,126,2257786
marRp,3.125,31,7,TTAAAGGTACTCAACATGAT,24,2254231
marRp,0.75,12,7,TGTTTAGGTTCGGGCTGTGA,5,2240430
marRp,7.375,65,7,TGTTGGGACTTACATCCCAC,58,2252413
marRp,0.75,12,7,TGTTAACCATCTCCGTTTCA,5,2227895
marRp,0.875,13,7,TGTGAACTGGAGTATCAATT,6,2239923
marRp,1.125,15,7,TGTCCTAGATTCATACCTTA,8,2239621
marRp,3.25,32,7,TGGCTGGCCTTCTATTCGTT,25,2260682
marRp,3.875,37,7,TGGCTCTTACCGGATCACTA,30,2222075
marRp,0.625,11,7,TGGCTCTAGGCGAAGGCCAG,4,2227242
marRp,1.75,20,7,TGGCAGATAGTGGTCTGACG,13,2225240
marRp,6.5,58,7,TGCTAAACGACACACGTGCT,51,2218839
marRp,33.5,274,7,TGCGTAGACGTACTTCCGTC,267,2256802
marRp,10.5,90,7,TGCGATCAATCTCGAAAAGA,83,2220538
marRp,2.875,29,7,TGCAGTTAACTTGCGCAATG,22,2238154
marRp,1.625,19,7,TGCAGGCAGGGTAAACACCT,12,2218507
marRp,16.375,137,7,TGATCGTCCTAATGGGGACG,130,2218564
marRp,3.875,37,7,TGATCGCGCGAGTGAGGTTG,30,2218304
marRp,1.375,17,7,TGATACGGGCTTTGCAAAAA,10,2229050
marRp,4.875,45,7,TGAGATATGTAAGCCCTGAA,38,2255012
marRp,3.0,30,7,TGAGAGTGACCGCTAGCCCG,23,2238500
marRp,27.125,223,7,TGACGCATAATCTACTTTGG,216,2260495
marRp,8.875,77,7,TGACATTAACAGATCCTAGT,70,2233251
marRp,6.75,60,7,TCTTCTTCGAGGACTTCTTT,53,2244618
marRp,1.5,18,7,TCTTCTGGGTGCGAATGAGA,11,2246061
marRp,10.0,86,7,TCTCCCCAGGCTACCGCTTG,79,2219397
marRp,7.75,68,7,TCTAGCAACTAGGGTTAGTA,61,2235294
marRp,3.625,35,7,TCGGTACAGTCTTGGGTGGG,28,2259427
marRp,9.875,85,7,TCGGATAAGCGCACGGGTGT,78,2229977
marRp,0.25,8,7,TCGGAGGTGTCAGACAGGTA,1,2247273
marRp,2.5,26,7,TCGACAGTCCGGAGCGTCTC,19,2241412
marRp,0.75,12,7,TCCTTATTGCGTGGATAGAC,5,2251706
marRp,1.5,18,7,TCCTGTGTCATATGCACTCT,11,2243525
marRp,4.375,41,7,TCCGTATCTTGAACGCGATC,34,2231943
marRp,0.625,11,7,TCCGCTCCCGGGCTTTCAAA,4,2251688
marRp,4.5,42,7,TCCCTTCCCAGAGCTAGAGC,35,2229406
marRp,1.125,15,7,TCCCATGTTGTAGGCAACGG,8,2227825
marRp,0.875,13,7,TCCACTCGAGGAATCATGCG,6,2230987
marRp,2.125,23,7,TCCACAGGTGACTGAGCGAG,16,2259457
marRp,0.5,10,7,TCAGCGATCATATCTCTAAG,3,2219970
marRp,3.0,30,7,TCAGATCCCGCACGTTATCT,23,2223549
marRp,0.875,13,7,TCACAGTAAGACATCTCAGA,6,2260193
marRp,3.5,34,7,TCACAATCATCTATTCTCGA,27,2232248
marRp,0.5,10,7,TCAACTTCGCCCCTGCGAAA,3,2222723
marRp,12.0,102,7,TATGGGAGGTTGAGGTCAGA,95,2237494
marRp,0.625,11,7,TATGCGCCCGTTCGCCGGTG,4,2229071
marRp,0.25,8,7,TATCGAGTCCGAGTGCCTAG,1,2250919
marRp,1.25,16,7,TATCCCCCATTTCGGTGACT,9,2244668
marRp,0.5,10,7,TATCCATAGGTTCTAGTGAT,3,2249091
marRp,1.0,14,7,TAGCTCATCTACGAGATTTT,7,2220285
marRp,0.75,12,7,TAGCCTAGCTAAGCGGGTGC,5,2223429
marRp,2.5,26,7,TAGCACGTATAGCGATGGTC,19,2227896
marRp,2.875,29,7,TAGAGAAATATCGCGGGCCT,22,2259860
marRp,0.25,8,7,TAGAATGTATGTTGCGCGCG,1,2229081
marRp,2.875,29,7,TACTTTCTCAGGCTTTGCCA,22,2244541
marRp,0.25,8,7,TACTATATGTTTAGCTGAAG,1,2227729
marRp,5.875,53,7,TACGACCGTGGGAGAAAACT,46,2243786
marRp,4.875,45,7,TACCGGCACCACTGCGCGCA,38,2236271
marRp,1.375,17,7,TACCCAGGGCGCGACATGGT,10,2229551
marRp,0.625,11,7,TACATCGCTAACCGGCGCGG,4,2223703
marRp,0.25,8,7,TACAGCTGTCGAGAAAATTC,1,2231568
marRp,0.375,9,7,TACAACGGGTCAAATCATTA,2,2258666
marRp,5.375,49,7,TAATTACATCCTGAAAGCGA,42,2237495
marRp,9.875,85,7,TAACACTCTTAGCGGGCCGA,78,2259981
marRp,1.5,18,7,TAAACTGCTCTCTAAGTGCC,11,2233488
marRp,1.125,15,7,TAAAACTACCCTGATATGCC,8,2234599
marRp,2.25,24,7,GTTTCCCTAAGGCGCAAGAT,17,2242898
marRp,2.25,24,7,GTTTAAGATTGACTGACATC,17,2236489
marRp,3.5,34,7,GTTGTGCAGGCCTTGCAGAA,27,2257220
marRp,0.625,11,7,GTTGTCCTCATTGCCAGGGA,4,2232323
marRp,0.5,10,7,GTTGGTCCCTGCTTTGCTCA,3,2244053
marRp,47.0,382,7,GTTGATGCGCATCATACTGG,375,2220236
marRp,2.0,22,7,GTTGACTGATACGCTAGCCT,15,2219619
marRp,0.875,13,7,GTTGAACCCCTGGGGTCCAT,6,2238695
marRp,15.125,127,7,GTTCATTTCGTTTTACACAT,120,2230480
marRp,12.375,105,7,GTGTTTATCCTGACTCCGCA,98,2249454
marRp,6.625,59,7,GTGTTCTCTATAGACGGGAT,52,2244543
marRp,0.25,8,7,GTGGTGTGAGTTGGTGCCGG,1,2256991
marRp,15.5,130,7,GTGGGAGGCGTTTTCGGCGT,123,2226505
marRp,5.125,47,7,GTGGAGAGAGTTAGATCGAC,40,2236414
marRp,0.375,9,7,GTGCTTGAAACATTACACCA,2,2228480
marRp,1.5,18,7,GTGAGCATCCGTCTGCCGGT,11,2237822
marRp,5.375,49,7,GTCTTCAAGTGCGCGTGTAG,42,2235694
marRp,1.125,15,7,GTCGGCCACCTTGTTTATGC,8,2242725
marRp,27.75,228,7,GTCGCTCGCGATCCTTAAGA,221,2229972
marRp,2.625,27,7,GTCCTTCTCTTTATCAACCA,20,2225274
marRp,2.125,23,7,GTCCTCATTCGCCGATTTCT,16,2227259
marRp,3.125,31,7,GTCATTATGTTATCATATCA,24,2226120
marRp,0.25,8,7,GTATTCAAATCACAGCGAGT,1,2241711
marRp,6.25,56,7,GTATTAATCGTGTAGTAGCT,49,2223069
marRp,1.75,20,7,GTATATAACAGCAAGTAGTC,13,2222054
marRp,3.0,30,7,GTATACTTCATTGAACTGAC,23,2227694
marRp,0.25,8,7,GTAGCCGGGGACTCAACAGT,1,2246362
marRp,1.0,14,7,GTAGCAGGATCAATCAAAGA,7,2248690
marRp,2.125,23,7,GTAGAGTGGGGTCTCTATAG,16,2250088
marRp,1.75,20,7,GTACGATCCGCGTTTGGTTA,13,2234813
marRp,0.625,11,7,GTACACAAAGGGACTAGCTT,4,2219792
marRp,1.125,15,7,GGTTGGGCAGGGTATTCTAC,8,2259017
marRp,3.625,35,7,GGTTGACCCACTACCTTTGT,28,2249820
marRp,7.0,62,7,GGTGGGTTGGATGGAACCAC,55,2255294
marRp,0.375,9,7,GGTCTTAAACAGTTCACCCA,2,2237278
marRp,2.75,28,7,GGTCAGGAACATCGATGTCA,21,2254986
marRp,1.0,14,7,GGTCAGCTGGTCTAAGTGCC,7,2236590
marRp,0.75,12,7,GGGTTTAGAGAGGTCGTTTT,5,2228341
marRp,0.5,10,7,GGGTTGTCTCCTGGGAGTGA,3,2224446
marRp,0.5,10,7,GGGTTCATCCCCTGGGCAAA,3,2237518
marRp,1.75,20,7,GGGTACATTTTTGACCTGTA,13,2233715
marRp,0.25,8,7,GGGTAAATTAGGGTCACCCG,1,2231134
marRp,0.875,13,7,GGGCGTCCGCGTAGGGCACT,6,2242993
marRp,2.25,24,7,GGGCAAGCCGCCCTGAAGTT,17,2219457
marRp,0.5,10,7,GGGACAATCTAGGGTGAATA,3,2234690
marRp,3.125,31,7,GGCTTGGTGGTCGTGCGTCG,24,2248149
marRp,0.25,8,7,GGCGTCTTATGCGTTTTACA,1,2223492
marRp,0.25,8,7,GGCGTCCTAATACAAGTGTC,1,2234380
marRp,54.25,440,7,GGCGGGTACTGCCGTTCAAT,433,2255995
marRp,8.125,71,7,GGCCGCTTCTTAGCAGTGGT,64,2251224
marRp,10.25,88,7,GGCCCATAAACATGGATCCA,81,2245974
marRp,0.375,9,7,GGCATAAGCTACGCCCCGGT,2,2231335
marRp,0.375,9,7,GGCACTGAGGCTTAAAGAGG,2,2239788
marRp,3.5,34,7,GGAGTTCCCAACGAGCATGG,27,2229252
marRp,4.5,42,7,GGAGGTAAGATCGTGTTGGA,35,2229830
marRp,36.0,294,7,GGAGCGATTAGAAAAGGATT,287,2220240
marRp,0.25,8,7,GGACGACAAAGAACATTCGT,1,2240193
marRp,2.25,24,7,GGAAAGTGTGACATGATGCA,17,2243633
marRp,0.75,12,7,GCTGGTCGGGACCGGACTTT,5,2238585
marRp,2.125,23,7,GCTGGGAACGTAACTCGACT,16,2220290
marRp,1.875,21,7,GCTGCGTTATGCACGTGGGT,14,2254693
marRp,9.75,84,7,GCTCGGGTCAAATTTACTAA,77,2228962
marRp,0.25,8,7,GCTCGCTAGCCACTTCATAT,1,2230968
marRp,6.125,55,7,GCTAAACTGCTTTGAATCTA,48,2232192
marRp,0.875,13,7,GCGTTCTCCCATCCTACCTA,6,2239119
marRp,1.25,16,7,GCGTACAATGTTACGCAACA,9,2228449
marRp,3.5,34,7,GCGGTGGCGATGTAGTAAGG,27,2260351
marRp,4.0,38,7,GCGGGCGGGGGGCACAACAA,31,2237212
marRp,2.625,27,7,GCGGCGCAGAATTGTCACTC,20,2227890
marRp,0.5,10,7,GCGGATAAGGTGCTTGCATC,3,2236323
marRp,2.625,27,7,GCGCCTACGGGATGTTGGGC,20,2231223
marRp,0.75,12,7,GCGCCGTCGGCATCCGACGC,5,2226016
marRp,0.25,8,7,GCGATGTGATTAACGCAAAA,1,2236002
marRp,2.0,22,7,GCCTGATAGCCCGAGGTCTG,15,2238565
marRp,6.625,59,7,GCCCGTGATGCCCGATTGTG,52,2252046
marRp,10.5,90,7,GCCATAGAGTTTTCTGGTGA,83,2246042
marRp,0.625,11,7,GCCAGGGCCAAGCGCGCCTA,4,2227905
marRp,0.25,8,7,GCATCTCAATCCGACACCTC,1,2222504
marRp,4.125,39,7,GCATCCCTAGCGGCATAACT,32,2235311
marRp,3.75,36,7,GCAGGGCAGTCTGCTCGATT,29,2243298
marRp,3.0,30,7,GCACCCTCGCTAGTGTAAGT,23,2234270
marRp,0.625,11,7,GCACACGTTAGAGAAATTGG,4,2247368
marRp,2.25,24,7,GCACAAGTCTAGCACTGGAC,17,2237546
marRp,0.375,9,7,GCAATTCAGTTAGTTCGCCT,2,2249388
marRp,17.5,146,7,GATTCTCGGCTTAGAGGTTA,139,2249458
marRp,0.5,10,7,GATTCAACGTTACACTAGGT,3,2236320
marRp,0.25,8,7,GATTAAAAGACAGAAAAACG,1,2238376
marRp,0.75,12,7,GATGGACGAAGGGATGGTCA,5,2220676
marRp,0.75,12,7,GATGAGAGCAAAGGCGTGTG,5,2232837
marRp,1.75,20,7,GATCTGCAACCAGACGCTAA,13,2231490
marRp,0.625,11,7,GATATATACCGGATCCTCTT,4,2241633
marRp,0.75,12,7,GAGTCTTGGCAATTCAATAG,5,2243032
marRp,0.75,12,7,GAGGTCCGTCACGAGTATCC,5,2256973
marRp,0.625,11,7,GAGCATAGTGTCACTAAATT,4,2228222
marRp,0.875,13,7,GACGGTACTGCGGAATATGC,6,2223926
marRp,0.25,8,7,GACGGCCCAGTATGTGAGAG,1,2244274
marRp,4.125,39,7,GACGCCCGACTGGGTCATAG,32,2223104
marRp,0.75,12,7,GACCGCACGGCGTCTCCACT,5,2225806
marRp,5.0,46,7,GACCAATCTCAATCGTGGCT,39,2254450
marRp,0.75,12,7,GACATTTATTTCATGCATGC,5,2231733
marRp,0.375,9,7,GAAGGACTGCGGTAATCATG,2,2232551
marRp,1.125,15,7,GAACTTCCACAAAACATTCA,8,2249865
marRp,1.25,16,7,GAACACATTAAGCACACTGA,9,2227046
marRp,0.375,9,7,GAAAGGCGGTTAAGCCCTAC,2,2226966
marRp,0.5,10,7,GAAAAGGAAGCCCCGGGTTA,3,2233793
marRp,0.75,12,7,CTTTGCGGCCTCTGAACCCC,5,2258951
marRp,1.75,20,7,CTTCTGACTCCAGTCGCGTA,13,2225941
marRp,1.625,19,7,CTTCGTAGATAGACGAGGTA,12,2240642
marRp,2.25,24,7,CTTCACTCTCGAATAGGATA,17,2226548
marRp,1.25,16,7,CTTATACTTGTGGCACGTCC,9,2253356
marRp,2.25,24,7,CTTAGGGTGGGGGCGATCAT,17,2240057
marRp,0.5,10,7,CTTAGCCTGGACTGGAGAAG,3,2236992
marRp,0.625,11,7,CTTAATATCACGTCTTGTGA,4,2224024
marRp,1.375,17,7,CTTAAGGCAGCCCACGCTAC,10,2234671
marRp,1.875,21,7,CTGTATCGCCCAGCGCCCGT,14,2245259
marRp,0.875,13,7,CTGTAAAAGATATGGTTCGA,6,2228061
marRp,0.75,12,7,CTGGTAGACAGCACCCCGAG,5,2249612
marRp,0.625,11,7,CTGGTACTATAGCGGTTCGG,4,2236513
marRp,1.0,14,7,CTGGGAGAACGTTTACCCAC,7,2246380
marRp,0.625,11,7,CTGGCGTCTAAATACAATTA,4,2245760
marRp,1.375,17,7,CTGGATTTTGCGACTTCGTG,10,2241790
marRp,2.0,22,7,CTGGAGCGGAACAGACCAAT,15,2241631
marRp,2.75,28,7,CTGGAGACAGAGCTCTAAAG,21,2237729
marRp,2.125,23,7,CTGCTTTCTTGCCGTTAGGG,16,2238409
marRp,1.25,16,7,CTGCTAGCCACGGTGAAATG,9,2223968
marRp,1.375,17,7,CTGATGATTGCACGTATCTA,10,2227055
marRp,0.5,10,7,CTGATATGTCGCTTACACGT,3,2256514
marRp,2.75,28,7,CTGATAATTGCCTATCTAGT,21,2221065
marRp,1.0,14,7,CTCTTGCAAGGCCACGGTCC,7,2235161
marRp,3.75,36,7,CTCGCAGACCATTTAAAGTG,29,2242785
marRp,1.0,14,7,CTCCTATACACCAGCGATAC,7,2223485
marRp,1.0,14,7,CTCAACTTGGGGGCTTCTTA,7,2223644
marRp,1.875,21,7,CTCAACGGCTTACATGGACA,14,2253538
marRp,15.375,129,7,CTCAAATATGACGCTCCCGA,122,2220249
marRp,1.0,14,7,CTATAAATTTTTGGCGGTTA,7,2228311
marRp,1.0,14,7,CTACCATTCGTATCTTAGAA,7,2235676
marRp,0.375,9,7,CGTTGTAGCTATATGGTATC,2,2237106
marRp,12.125,103,7,CGTTGAATGAAGGTTTGATG,96,2223665
marRp,0.625,11,7,CGTTCGCATCCTTCCTAGAG,4,2251982
marRp,2.375,25,7,CGTGGCTGCGCGGGACAATA,18,2232769
marRp,15.125,127,7,CGTCTGCATGGCGGTATAAT,120,2257677
marRp,5.875,53,7,CGTCTCACGCGTCAGAGGCG,46,2231930
marRp,1.0,14,7,CGTCATGTTATCATCTACCT,7,2227045
marRp,0.5,10,7,CGTAGGAATCAAGTGGCGAA,3,2232473
marRp,1.125,15,7,CGTAAGCTAGATGGGTCGCA,8,2226044
marRp,1.125,15,7,CGTAAAGGGGTTACGGTAAG,8,2242552
marRp,0.25,8,7,CGGTTTAATAGGTTGCCACA,1,2222714
marRp,0.5,10,7,CGGGTATCCACCGGTACTGA,3,2241895
marRp,2.125,23,7,CGGGGGCGAAAATCGTCCAA,16,2235563
marRp,13.625,115,7,CGGGCTCCTGGCGGCACGTC,108,2238728
marRp,10.625,91,7,CGGCTGTCATTTCACTGTTG,84,2221797
marRp,1.75,20,7,CGGATACCAGCACCATCAGC,13,2227206
marRp,28.75,236,7,CGGAATAAGGAGCGGAGCTT,229,2226833
marRp,2.5,26,7,CGGAAAGAACACGTAGAGTC,19,2248672
marRp,13.375,113,7,CGCTATATTTTTGTTATGTA,106,2237343
marRp,2.0,22,7,CGCGACGAAAGCTTATCGCA,15,2224636
marRp,0.25,8,7,CGCCTATTCGATTATCAACA,1,2248682
marRp,1.125,15,7,CGCCCGCTGGTATTTGGGAT,8,2222492
marRp,4.5,42,7,CGATACTCTTTGACTGACAT,35,2241977
marRp,24.25,200,7,CGAGCGATGCCTGGTGGATC,193,2219035
marRp,0.625,11,7,CGACTTGCTGAAAGGCTCGT,4,2225732
marRp,15.625,131,7,CGACGTCCGGCCTTCGGCTT,124,2218989
marRp,0.75,12,7,CGAATAACCGGATATCTGTA,5,2243967
marRp,1.25,16,7,CGAAATGGTTAACCACGTGC,9,2249404
marRp,2.875,29,7,CCTTGTAGGAGTTATGCAAA,22,2254521
marRp,2.5,26,7,CCTGGCGTTGCAAGTCCCTA,19,2252387
marRp,6.0,54,7,CCTCCGCACTCTATACCGGA,47,2224250
marRp,2.0,22,7,CCGGTGGTAGCCAACCCGGT,15,2221742
marRp,1.25,16,7,CCGGGGTCTTTTGTGGAAGG,9,2252992
marRp,7.125,63,7,CCGGCTGAGCACCACGGTTC,56,2231953
marRp,1.875,21,7,CCGGCCAATTCTGTCAGGGG,14,2259453
marRp,8.375,73,7,CCGGCACAGTTCGGCTTACG,66,2244567
marRp,1.125,15,7,CCGCATCATAATCATGTCAT,8,2223730
marRp,3.875,37,7,CCGACTTCTTCAAATAAAGA,30,2223258
marRp,0.625,11,7,CCCTACGCTGTTGCTAGTCT,4,2219773
marRp,3.125,31,7,CCCGCTTGCGAATGACGTAT,24,2250729
marRp,0.375,9,7,CCCGCGGATGGCGGTAGGCC,2,2253786
marRp,2.25,24,7,CCCAGTCCATGTGGGTGCCT,17,2250823
marRp,0.375,9,7,CCCAATGCCTATTTCGTCAG,2,2254334
marRp,8.75,76,7,CCATTTTGAGTTAGTAAGTT,69,2231169
marRp,13.25,112,7,CCATGATCGGTGGGGTGGTG,105,2232144
marRp,0.75,12,7,CCAGGGTCACCACCTATGAT,5,2238691
marRp,1.375,17,7,CCACTATATCCGGTCTGTAG,10,2226553
marRp,3.125,31,7,CCAAATTTGGGGCATGACCA,24,2221945
marRp,0.5,10,7,CATTTACTATGTCTCATAAT,3,2242664
marRp,0.375,9,7,CATTGACGGACAGTTTTTCG,2,2237275
marRp,6.75,60,7,CATTCGAGGGATCGCCGTCA,53,2223663
marRp,1.0,14,7,CATTAGTCCGGAGCACAGCC,7,2233272
marRp,24.75,204,7,CATTACAACCGGTCCCTCAG,197,2240964
marRp,17.625,147,7,CATGTAAAGTGGGAATGAGC,140,2236294
marRp,10.125,87,7,CATCATCGGGCGATTTGTTC,80,2224914
marRp,2.125,23,7,CATATTAAGTATTCCTGTGA,16,2218381
marRp,7.0,62,7,CATACTGGGCGCATTGTTTT,55,2221898
marRp,0.875,13,7,CATAATTAGGCGACACCTTA,6,2261069
marRp,2.875,29,7,CAGTGTAGACAGCGCTAGTG,22,2239710
marRp,9.0,78,7,CAGGTTTACTTAACGGGGTG,71,2221538
marRp,1.25,16,7,CAGCGCACTCCCCCGGATGC,9,2230531
marRp,0.75,12,7,CAGAATCGGCAGTCCCGAGC,5,2235713
marRp,1.125,15,7,CAGAAGAGCCCGTAAATCCT,8,2221229
marRp,3.125,31,7,CACTGCTCATCCCCTGATGG,24,2220784
marRp,0.75,12,7,CACGTTATAACGTCCGCACC,5,2259133
marRp,0.25,8,7,CACCTGGTAGTCGCCCGAGT,1,2229433
marRp,1.875,21,7,CACCCTAACGCCAAAACTTT,14,2242759
marRp,12.625,107,7,CACCAATGGCCCGTGTACCA,100,2229235
marRp,2.0,22,7,CACACCACACCTCTTTATCA,15,2256758
marRp,2.0,22,7,CAATGATCTGAGCTTCGAGA,15,2237752
marRp,1.25,16,7,CAATCCGGGAGACCTAGCGG,9,2252364
marRp,0.875,13,7,CAATATGCTCATCACGACTG,6,2247324
marRp,4.0,38,7,CAATAGGATTGTCCCGCTGA,31,2227261
marRp,22.375,185,7,CAAGAGCATGCTGGGCTTTA,178,2227850
marRp,1.5,18,7,CAACAAAAGGCACAAGCGTG,11,2219142
marRp,12.75,108,7,CAAATAGTAGGCCGACAAAC,101,2254079
marRp,1.125,15,7,ATTTTGCTTATCGAGTCTCT,8,2219777
marRp,24.0,198,7,ATTTGGTTTGCAAATTGGCT,191,2240004
marRp,10.5,90,7,ATTTAGATGGTAGGTATCAA,83,2245997
marRp,2.625,27,7,ATTTACGACTAAAACCTACG,20,2236250
marRp,0.625,11,7,ATGTTATGTGGACGTGATGG,4,2247361
marRp,1.125,15,7,ATGTGTTAAGTCCCGGTAGT,8,2219211
marRp,12.25,104,7,ATGTATCACGACCGACACAA,97,2245367
marRp,3.0,30,7,ATGTAGCATCGAGCACGAAA,23,2238754
marRp,3.375,33,7,ATGGAGGCACTACGTACCGA,26,2250514
marRp,0.25,8,7,ATCTCTTGTCTAGCCGGTGG,1,2234617
marRp,1.375,17,7,ATCTCATTGCGCCAAATGGT,10,2223372
marRp,2.0,22,7,ATCTAGTCTTACCGAAAAAT,15,2234464
marRp,10.25,88,7,ATCTAAAACTCCGAGACCTG,81,2247291
marRp,7.75,68,7,ATCGGTTACTCGCATGAGAT,61,2247467
marRp,0.5,10,7,ATCCGCGCCAACTACATTCC,3,2240768
marRp,8.5,74,7,ATCCACGCTACAGCTACACA,67,2241923
marRp,5.0,46,7,ATCAAGATTACGGAGGTTTG,39,2258768
marRp,1.75,20,7,ATATGATGAGTTTTCCTGCA,13,2232218
marRp,2.5,26,7,ATAGCTACTGGTCCACTCGT,19,2250532
marRp,1.25,16,7,ATACTGCCCAATTACGTCTT,9,2237251
marRp,2.75,28,7,ATACCTGGAGTTTGGATGAT,21,2260838
marRp,1.5,18,7,ATACCGTTTACGAGACGCGG,11,2228147
marRp,0.25,8,7,ATACCGGATAAGTAATTATT,1,2222744
marRp,4.125,39,7,ATACCAGAGTCTGATGCCAG,32,2234947
marRp,1.125,15,7,ATAAAACGGACTAACACGAT,8,2234907
marRp,1.75,20,7,AGTTGTTGCTGCTGAATTTA,13,2231111
marRp,1.125,15,7,AGTTGCTACGCATTGTGCCT,8,2239290
marRp,1.375,17,7,AGTGGGGCGGCTTTAGACAG,10,2236676
marRp,7.625,67,7,AGTAGCAGCCTTGCGTAGCA,60,2258429
marRp,1.5,18,7,AGGTCCGTGGATTCATAGAA,11,2222797
marRp,13.0,110,7,AGGGTCGTTCGACGTACTTT,103,2256798
marRp,14.75,124,7,AGGGGGCCTTCATTAACTAC,117,2218559
marRp,5.625,51,7,AGGGCCTCGGTTGTCTAGTG,44,2226511
marRp,2.375,25,7,AGGGCCGGGAGAACAGGGTT,18,2222306
marRp,0.375,9,7,AGGGCACGTCACGCCCCGTT,2,2221903
marRp,1.25,16,7,AGGCGTCTAGATATCAATAT,9,2259535
marRp,3.375,33,7,AGGCCCTTCACTCGTTGATT,26,2219924
marRp,0.875,13,7,AGGCAGTGCCGTTTAGGGCG,6,2254211
marRp,1.75,20,7,AGGATGGCCGAGCGGTCACC,13,2246095
marRp,0.625,11,7,AGGAGGCTTAACATACAAGG,4,2252491
marRp,2.5,26,7,AGCTACTAAGGGTTACTATC,19,2240050
marRp,1.625,19,7,AGCGAGTGGCCTCCTATAGC,12,2259450
marRp,2.125,23,7,AGCAGCAAAACATTCTGTGG,16,2241077
marRp,0.625,11,7,AGCAGAAGTAGCAATTCATT,4,2259861
marRp,0.375,9,7,AGCAAATCTAATCTCCGTTA,2,2236543
marRp,3.0,30,7,AGATTGTAGAGTAAACTTGT,23,2254723
marRp,6.5,58,7,AGATGCCACCTGCGCAGAGG,51,2259881
marRp,1.75,20,7,AGATAGGGCTGATCTTGACA,13,2257570
marRp,0.875,13,7,ACTTCCCAGGAAGGCCATGA,6,2243729
marRp,1.75,20,7,ACTGCGACTTTTAAGTGCTT,13,2244169
marRp,0.25,8,7,ACTGACCGGGCCGGCTCTCA,1,2257140
marRp,1.0,14,7,ACTCTCAGTTTTTGTCTCAA,7,2257635
marRp,0.75,12,7,ACTAGGGGACATGGCCACAA,5,2218698
marRp,9.5,82,7,ACGTGCCTGCTCAATCCTAT,75,2229987
marRp,2.625,27,7,ACGTCGCGTAGGCGGCAGGA,20,2238704
marRp,6.875,61,7,ACGGGAACTGATCATGAACA,54,2217795
marRp,14.25,120,7,ACGCATCTCGGGTCGTCGAA,113,2227007
marRp,6.125,55,7,ACGAGTGATGATTTCCATGC,48,2219818
marRp,1.5,18,7,ACGAGGCACTACCGGCAGCT,11,2244901
marRp,0.25,8,7,ACGAGAACTAGGGTGGTATG,1,2228608
marRp,4.0,38,7,ACGAATTGTTCAGGGCGTGT,31,2260396
marRp,1.625,19,7,ACCGCCAATCGATTACAGTT,12,2247732
marRp,2.25,24,7,ACCACATCACATGCGGTGGG,17,2227805
marRp,0.375,9,7,ACATGAGGCTTCAGAAGGGT,2,2218274
marRp,0.75,12,7,ACATCTAAGCTCCGTGCAGC,5,2221970
marRp,0.5,10,7,ACAGACGGCCTTGGGCCATG,3,2218781
marRp,0.5,10,7,ACACCGAGCTCGAGATGTTC,3,2245294
marRp,3.25,32,7,ACACCCGACCAAACTTTTAT,25,2227548
marRp,1.625,19,7,ACACACTATAGTTTTCTATC,12,2227659
marRp,13.5,114,7,AATGGAGCCTTTTATTGCCA,107,2254101
marRp,0.375,9,7,AATGCATCTCAACTTGGCCT,2,2229415
marRp,0.25,8,7,AATGACTCGCTATGGGGGAG,1,2229425
marRp,0.625,11,7,AATCGCGACTGCTCAAAATA,4,2239403
marRp,1.0,14,7,AATACGTATTGCGTTCCCAA,7,2230753
marRp,0.25,8,7,AAGTCATGTTTCTGGGCAAC,1,2221140
marRp,2.125,23,7,AAGGGAAACTAGAGACTAAT,16,2250454
marRp,5.75,52,7,AAGAGTCTCCCGTTACACCC,45,2226240
marRp,1.875,21,7,AAGAGACTGCAGAATTGATG,14,2258592
marRp,5.125,47,7,AAGAATCCATCCCGGGCGAT,40,2248130
marRp,10.375,89,7,AACTCTTTGAAACACCGCGA,82,2222053
marRp,1.25,16,7,AACGCCCTCAGGAGCGGCTC,9,2227477
marRp,0.5,10,7,AACCTCCCAACGCTAGGTGC,3,2220079
marRp,0.25,8,7,AAATTTGTTCGAGCGCCCGT,1,2244753
marRp,0.25,8,7,AAATTTGCTAGTAGCCCTGG,1,2251309
marRp,1.375,17,7,AAATAAATATAAAGTCGTGC,10,2236996
marRp,1.125,15,7,AAAGTTGGACGGTTCGTTAA,8,2223809
marRp,13.625,115,7,AAAGTTGCTTTACCAAAGAG,108,2236247
marRp,4.5,42,7,AAACCTCGCTCGAGAGAAAA,35,2223377
marRp,21.625,179,7,AAAATTGGGAGGGCTAAAGT,172,2257856
marRp,14.125,119,7,AAAATTGAATAGCCCAATAT,112,2236863
marRp,0.375,9,7,AAAACAGGACTTTATTCCAA,2,2229221
marRp,3.2857142857142856,28,6,TTTTTACGCTGGTTGCCCCT,22,2251819
marRp,15.714285714285714,115,6,TTTTCAGGTGATGAGATGAT,109,2236867
marRp,0.7142857142857143,10,6,TTTTAGCGATACGACACGTG,4,2243834
marRp,0.2857142857142857,7,6,TTTTAAGAGACTTCAGGCCG,1,2244521
marRp,1.4285714285714286,15,6,TTTGGTTAAGCGCATTCTGT,9,2260928
marRp,4.571428571428571,37,6,TTTGCCAACCTGCCCCCCTA,31,2235316
marRp,4.857142857142857,39,6,TTTCTTGTTCTCACATTCCG,33,2223893
marRp,1.7142857142857142,17,6,TTTCGACCATGATACCAATC,11,2245831
marRp,1.2857142857142858,14,6,TTGTGCAAAAGGAGTGAATA,8,2225559
marRp,0.2857142857142857,7,6,TTGTCTGATATGAAAGTAAG,1,2255716
marRp,2.857142857142857,25,6,TTGTACCGAGGTGGAACTGG,19,2259464
marRp,0.5714285714285714,9,6,TTGGAGTGGAATACTGCAGC,3,2227831
marRp,6.428571428571429,50,6,TTGCGTGCACATGAATGGAC,44,2258832
marRp,12.142857142857142,90,6,TTGCACCGTCGCTTCGTCAG,84,2252776
marRp,0.7142857142857143,10,6,TTGCACAGACCGTCCGTTCC,4,2233448
marRp,4.857142857142857,39,6,TTGAGTCGCGGGTCTCACCC,33,2256704
marRp,2.0,19,6,TTGAGATCGGCTTTTGACAA,13,2243994
marRp,0.42857142857142855,8,6,TTGAAGTATGGTTTTCTACT,2,2253046
marRp,3.5714285714285716,30,6,TTCGTTTATATCAAATGGCG,24,2238584
marRp,3.4285714285714284,29,6,TTCGGCTGAATCGCATACTT,23,2246512
marRp,1.1428571428571428,13,6,TTCCTTTAGAATCGGCTAAT,7,2220924
marRp,1.0,12,6,TTCCCGCGCCATCTTATCAG,6,2234587
marRp,0.5714285714285714,9,6,TTATTGGTAGAAAATAGGTA,3,2250214
marRp,0.8571428571428571,11,6,TTATGCTTCCGCAGGTTCAA,5,2233209
marRp,2.4285714285714284,22,6,TTAGCACACCCATTCCTTTG,16,2247785
marRp,4.0,33,6,TTACGTCACATATACAGTCA,27,2246999
marRp,1.4285714285714286,15,6,TTACAAGCGCATTAGTGACT,9,2234896
marRp,0.8571428571428571,11,6,TTAATACATTCAGGCGAAGA,5,2249721
marRp,2.857142857142857,25,6,TTAAGTCAAGGGCAGATCAT,19,2220980
marRp,10.571428571428571,79,6,TTAACAATGGTATTTGGGAA,73,2232188
marRp,6.857142857142857,53,6,TTAAACCCACCAAAGTTCAT,47,2223184
marRp,2.5714285714285716,23,6,TGTTTTGGTTCAGATACAGT,17,2250166
marRp,0.2857142857142857,7,6,TGTTTGCGACCACTGGCGCG,1,2244487
marRp,2.0,19,6,TGTTGGTACTGGTATCTGAG,13,2230110
marRp,0.2857142857142857,7,6,TGTTGAGCCATTCAACTGTG,1,2259362
marRp,2.142857142857143,20,6,TGTTCCTGCAGCAGCGCCTA,14,2237747
marRp,3.7142857142857144,31,6,TGTTACTAGACTGGCAACAA,25,2235784
marRp,2.142857142857143,20,6,TGTGCCTCACCTTGGGGGCT,14,2251582
marRp,7.142857142857143,55,6,TGTGAATTTTTGGGTCATTT,49,2260303
marRp,0.5714285714285714,9,6,TGTCTGTCTTCCTTTTGAAC,3,2245296
marRp,1.5714285714285714,16,6,TGTCTGGTGGGGTTCCAGAG,10,2250774
marRp,4.857142857142857,39,6,TGTCCTGATACGGGATAGTT,33,2256926
marRp,9.285714285714286,70,6,TGTCCAAGCCATACCCAGTG,64,2244838
marRp,1.4285714285714286,15,6,TGTATCTTGGGACATTCACG,9,2229725
marRp,0.42857142857142855,8,6,TGTAGAGTGACGAGGCAGGG,2,2233543
marRp,18.714285714285715,136,6,TGGTTAGAACTTGCAGTCAT,130,2221278
marRp,13.285714285714286,98,6,TGGTGCCTGTATTGGATACT,92,2249474
marRp,0.42857142857142855,8,6,TGGTGCCTAGCCATAAAGCA,2,2231203
marRp,1.5714285714285714,16,6,TGGTGCAGCTCGGTAGGGTC,10,2225637
marRp,2.4285714285714284,22,6,TGGGTGTCGTGATTTTTAGG,16,2235773
marRp,3.7142857142857144,31,6,TGGATAAGGGGACATCGTTT,25,2230786
marRp,0.5714285714285714,9,6,TGGACTGAAAGCTTGGGGAC,3,2231691
marRp,12.0,89,6,TGCTTCTGTCATCGTGGTGG,83,2257867
marRp,1.2857142857142858,14,6,TGCTGCCCAATCGTCTACCA,8,2256848
marRp,0.7142857142857143,10,6,TGCTCGGTAGGTCCAATAAT,4,2256083
marRp,0.2857142857142857,7,6,TGCTCCTCCCTCAAACACCT,1,2258280
marRp,0.42857142857142855,8,6,TGCGGCCGCGCATAGCGCGA,2,2219930
marRp,0.42857142857142855,8,6,TGCCTGCGAGCAACACGTGC,2,2228907
marRp,7.571428571428571,58,6,TGCCCGGTCCTCAGGTGGAT,52,2256986
marRp,1.1428571428571428,13,6,TGCCAGGAGCGGACAAAGGC,7,2234183
marRp,6.142857142857143,48,6,TGATTCCACACAACAACCAC,42,2220544
marRp,1.5714285714285714,16,6,TGAGTTAGCGGATTTCCGGC,10,2258847
marRp,0.42857142857142855,8,6,TGACTTTAGCAATCCGTGGG,2,2240038
marRp,4.285714285714286,35,6,TCTTTCCAGATGACGATCCG,29,2231267
marRp,3.857142857142857,32,6,TCTTGCGGTATCTGAATGGG,26,2229892
marRp,13.428571428571429,99,6,TCTTCCGACACGCGTGGATG,93,2229410
marRp,0.42857142857142855,8,6,TCTCGTGAGGCCGCCGACAA,2,2238894
marRp,3.5714285714285716,30,6,TCTCGTAAGTTACCACCGTG,24,2225560
marRp,1.0,12,6,TCTATAATTTTCTTCTCCCG,6,2228298
marRp,3.5714285714285716,30,6,TCTAATGTAGCCCATTAACA,24,2237006
marRp,2.2857142857142856,21,6,TCGGGCTCCAGGTTGCTTTG,15,2251229
marRp,0.2857142857142857,7,6,TCGGATGCAATAACATGCAT,1,2255256
marRp,0.42857142857142855,8,6,TCGCAGAAAGGACACGTGAG,2,2239837
marRp,1.4285714285714286,15,6,TCGAGCACCCCAGAAGTCCT,9,2224745
marRp,2.5714285714285716,23,6,TCCTGTACCAGGACGTAGCA,17,2224445
marRp,3.2857142857142856,28,6,TCCTATAGCGGGTACGGACT,22,2245156
marRp,4.714285714285714,38,6,TCCGTGTTATGCTAGAAGTG,32,2219558
marRp,0.42857142857142855,8,6,TCCCGTTACCATCTGTCTAC,2,2249361
marRp,1.5714285714285714,16,6,TCCAATTTGTTGTCGGCGTG,10,2239099
marRp,21.142857142857142,153,6,TCCAAAGGCCCGGAACCTAA,147,2226840
marRp,0.2857142857142857,7,6,TCATTGCCCTGGGTGCGTCT,1,2238674
marRp,1.4285714285714286,15,6,TCATACCACTACCCGTCGTG,9,2247418
marRp,2.142857142857143,20,6,TCAGCTATATGGCTCAACTC,14,2238356
marRp,0.7142857142857143,10,6,TCAGCGTCCGCCATATTAGA,4,2237808
marRp,0.7142857142857143,10,6,TCACTGGTCTTGGAACGGAA,4,2246979
marRp,1.2857142857142858,14,6,TCAATGCGCAAGGTACTCTA,8,2240941
marRp,8.0,61,6,TCAATCCTCAACTCCCATCC,55,2231944
marRp,0.2857142857142857,7,6,TCAACTGGCCGAAGACTCGT,1,2221730
marRp,0.8571428571428571,11,6,TCAACGGCTTTACTTGCGGT,5,2234418
marRp,1.4285714285714286,15,6,TATTAGCAGTTACGTCTTAG,9,2221456
marRp,1.8571428571428572,18,6,TATTAAGAGGCTATTCCAAT,12,2235241
marRp,3.7142857142857144,31,6,TATGTATAGATAGGGAGCTA,25,2258057
marRp,10.714285714285714,80,6,TATGGAAAGTAGTATTTATT,74,2256810
marRp,0.2857142857142857,7,6,TATGATGCTCGTATTATTGC,1,2226125
marRp,1.2857142857142858,14,6,TATCGTCGCTCCATCCTTGG,8,2241309
marRp,2.7142857142857144,24,6,TATCCTCAAGCTCCCAGCCC,18,2232722
marRp,0.8571428571428571,11,6,TAGGGCGGTTTAGTAAGATC,5,2244783
marRp,1.8571428571428572,18,6,TAGCTTTTTTCGATACCCAC,12,2244921
marRp,6.714285714285714,52,6,TAGCGGGCCCGTTCAGTCTA,46,2233440
marRp,1.0,12,6,TAGACGGTGCCCCATAAGCG,6,2240060
marRp,0.7142857142857143,10,6,TAGACAATAAAGTTTTTCTA,4,2233550
marRp,1.0,12,6,TACGTAATAGTAGAATAAAA,6,2244932
marRp,0.5714285714285714,9,6,TACGCAGACCATGTTTACGC,3,2250636
marRp,0.42857142857142855,8,6,TACCGCGGCAGCCCGTGGCA,2,2244749
marRp,1.0,12,6,TACATGTCTAATTGGGTATC,6,2236347
marRp,1.4285714285714286,15,6,TACATAGATATATTAGCGCA,9,2251722
marRp,0.42857142857142855,8,6,TACAGTCTACTCCCATTGGC,2,2258602
marRp,0.7142857142857143,10,6,TACAGCCTACTCACACAAGT,4,2228663
marRp,1.7142857142857142,17,6,TACACCAGGCTAACGAGATT,11,2227664
marRp,2.857142857142857,25,6,TAACGCCTAATCAATGCTTG,19,2260596
marRp,3.857142857142857,32,6,TAAATGCGGATATTCATCAG,26,2225273
marRp,3.142857142857143,27,6,GTTTAGTTACATAGGCGTAA,21,2245761
marRp,5.285714285714286,42,6,GTTGTAGCTAATATTAACGC,36,2241098
marRp,8.428571428571429,64,6,GTTGGGGCAGACATGGTGGT,58,2236864
marRp,23.857142857142858,172,6,GTTCGTTGCCAAGTGGAGAT,166,2240005
marRp,1.7142857142857142,17,6,GTTCGCACGTAGGTCCGTCC,11,2233585
marRp,1.2857142857142858,14,6,GTTAAAAATGGATTACAATA,8,2223588
marRp,1.8571428571428572,18,6,GTGTCCCGTTACACCTGAAG,12,2228382
marRp,0.42857142857142855,8,6,GTGGGGCATGTTGCCGTCTC,2,2253092
marRp,0.2857142857142857,7,6,GTGCTGAGGTCCTTAACTTC,1,2232051
marRp,4.857142857142857,39,6,GTGCTAGAGCCATCCTACGA,33,2238018
marRp,0.5714285714285714,9,6,GTGCACGGGGATACATGGTC,3,2250238
marRp,3.0,26,6,GTGAGCTAAGGCTAGGGTGC,20,2220203
marRp,1.5714285714285714,16,6,GTGACGGATCACCTTACGAT,10,2244799
marRp,0.5714285714285714,9,6,GTCTGCGGGCCCAGACAAGA,3,2248394
marRp,6.428571428571429,50,6,GTCGTTAAAATTTGTCTCTG,44,2229625
marRp,1.7142857142857142,17,6,GTCGCATATATCAGTCATGA,11,2244714
marRp,1.7142857142857142,17,6,GTCCTCACCGGTGCACAGAT,11,2234465
marRp,13.714285714285714,101,6,GTCATGCTTCGGCTTTTGTT,95,2225317
marRp,3.0,26,6,GTCATGCTAGAAAAGTTCAT,20,2256722
marRp,0.7142857142857143,10,6,GTCATCGTACGTAGTTAGAG,4,2224982
marRp,0.42857142857142855,8,6,GTATTTTTCTGTGGGCGGAT,2,2227197
marRp,0.2857142857142857,7,6,GTATTGTGCTAATACGACGC,1,2253835
marRp,10.142857142857142,76,6,GTATTGACAACCTTCAGCTT,70,2236637
marRp,1.1428571428571428,13,6,GTATGCTGTAATGGTAGAAA,7,2254921
marRp,29.285714285714285,210,6,GTATGATGCGAAACCCCGCT,204,2220239
marRp,0.2857142857142857,7,6,GTAAGGGCAAAGCGCGGCCA,1,2242463
marRp,0.8571428571428571,11,6,GGTTGTAATGAACGAGGGGT,5,2227195
marRp,7.285714285714286,56,6,GGTTGCAACACCCACCGTCT,50,2248241
marRp,3.0,26,6,GGTTGACTTGGAGAAAGGTA,20,2246839
marRp,13.571428571428571,100,6,GGTTCCTTCAATGAGTTAAG,94,2245356
marRp,0.8571428571428571,11,6,GGTCTGCCACTTTCGAAGTT,5,2250293
marRp,0.42857142857142855,8,6,GGTCGGCTGATCGTCTGATT,2,2224314
marRp,2.2857142857142856,21,6,GGTCGGATGGGTCTGCCCGT,15,2255736
marRp,0.2857142857142857,7,6,GGTCACCTTGGGACACACTA,1,2229502
marRp,3.0,26,6,GGTACTCCACCTACTGATTT,20,2256872
marRp,3.4285714285714284,29,6,GGTAATCGGGCCTTTCCACT,23,2234451
marRp,4.0,33,6,GGTAATCCCTATTAATCCAC,27,2238523
marRp,12.0,89,6,GGGGTGTCGCGGTAAGCCCT,83,2240982
marRp,3.5714285714285716,30,6,GGGGGTGGCAGTTATGGATC,24,2230820
marRp,4.142857142857143,34,6,GGGCAGTTTAGGCATAACAA,28,2244212
marRp,4.857142857142857,39,6,GGGCAGGGTGACCGCTCTGA,33,2240577
marRp,2.0,19,6,GGGAGTAGTTGAAACACTAT,13,2243334
marRp,4.571428571428571,37,6,GGGAGGCTGCATATTTTCGC,31,2236579
marRp,3.7142857142857144,31,6,GGCTGAGGTGATCAACCGGG,25,2245479
marRp,0.7142857142857143,10,6,GGCTGACCCGTGGATTCCAA,4,2240372
marRp,11.142857142857142,83,6,GGCTCTGGCTGGACGAGGCG,77,2257694
marRp,0.5714285714285714,9,6,GGCGCTTCCGCGTTGCCGCT,3,2246468
marRp,1.4285714285714286,15,6,GGCCCCCGGAAGCTGGATAT,9,2242751
marRp,0.2857142857142857,7,6,GGCCAACTGCCACTTACAAT,1,2249602
marRp,1.0,12,6,GGATCTACTGGCTACAAGAG,6,2228022
marRp,41.857142857142854,298,6,GGATATACCTGTGGCTCATA,292,2239244
marRp,10.714285714285714,80,6,GGAGCCGAGTGAGGTACGGG,74,2242340
marRp,0.2857142857142857,7,6,GGAGAGTCACATTGAACCCC,1,2253943
marRp,0.5714285714285714,9,6,GGACGTGCTGCAAGAATGCA,3,2233205
marRp,3.142857142857143,27,6,GGACACATCTTGCTGTGAAA,21,2230843
marRp,8.0,61,6,GGACAAAAGGAGTGTCACTC,55,2259783
marRp,2.857142857142857,25,6,GGAATGCGTTAACCCCGGTA,19,2242316
marRp,0.5714285714285714,9,6,GGAATAAAGATAACTGTAAT,3,2224761
marRp,1.4285714285714286,15,6,GCTTGGTGTTATATTGTTGC,9,2256896
marRp,0.42857142857142855,8,6,GCTGCGATCCCCTTTGGAAC,2,2245958
marRp,1.2857142857142858,14,6,GCTGCAGACACTCGCTGAAA,8,2218888
marRp,3.142857142857143,27,6,GCTAAGAATGGGGCATTTTC,21,2251467
marRp,0.8571428571428571,11,6,GCGTTTCCCCAATGTTTACA,5,2234036
marRp,18.714285714285715,136,6,GCGTCTTAAGGCAGAAGTTA,130,2232126
marRp,0.2857142857142857,7,6,GCGTACGCCTTGACACAGTC,1,2227168
marRp,43.285714285714285,308,6,GCGGTTCAGTGGCCCCGCGT,302,2243371
marRp,1.1428571428571428,13,6,GCGGTGTTACCGTGGGGCCT,7,2255217
marRp,1.2857142857142858,14,6,GCGGTAATTGGGTGTAAGTA,8,2224418
marRp,1.1428571428571428,13,6,GCGGGACTGTACACCTATAA,7,2254202
marRp,0.5714285714285714,9,6,GCGCCCTGGGACCGGAAATG,3,2226230
marRp,33.142857142857146,237,6,GCCTTGCGACTACGCGCACC,231,2255987
marRp,2.4285714285714284,22,6,GCCTGTCGTGCGTGCGATAT,16,2258933
marRp,4.0,33,6,GCCCGAGTCCACCGCAATGA,27,2248153
marRp,5.571428571428571,44,6,GCCCAGTACGAGTGTTGAGG,38,2238112
marRp,0.5714285714285714,9,6,GCATTCATAATCAGGCGTTA,3,2234289
marRp,2.7142857142857144,24,6,GCATTAGATTTCGTTAGAAA,18,2259936
marRp,1.8571428571428572,18,6,GCATAAGGTGGATGAAAATT,12,2222863
marRp,4.428571428571429,36,6,GCAGGCTCAACGAGATCAAA,30,2220853
marRp,0.2857142857142857,7,6,GCAGACTTAGTACCCGGACA,1,2224167
marRp,1.4285714285714286,15,6,GCACGCGGATAGATGTGCGG,9,2252011
marRp,4.857142857142857,39,6,GCAATATATGAATGATGGGA,33,2220841
marRp,1.0,12,6,GCAAGAGCTTTATGTGATTC,6,2231661
marRp,3.0,26,6,GCAAAAAGGTGTTTTAAGCT,20,2253438
marRp,0.2857142857142857,7,6,GATTTTTAGAGCTCTGAAAA,1,2226184
marRp,2.7142857142857144,24,6,GATGTTAGCCAGAAAAATTA,18,2238977
marRp,0.2857142857142857,7,6,GATGACCCAATAATACATGA,1,2235491
marRp,0.42857142857142855,8,6,GATCTTTCCTAAACAATTTC,2,2255663
marRp,0.2857142857142857,7,6,GATCGCGTAGCGTATGATAA,1,2253289
marRp,0.42857142857142855,8,6,GATATCAATCGATCTAACTG,2,2245848
marRp,2.142857142857143,20,6,GATACTCTTCTGGATCCATT,14,2226872
marRp,0.2857142857142857,7,6,GATAATATAAGAACCGAAGT,1,2228305
marRp,1.1428571428571428,13,6,GAGGGTTCTCGGGCTTCCTT,7,2238372
marRp,1.5714285714285714,16,6,GAGGGGTCAAACACTCTCAT,10,2218242
marRp,3.142857142857143,27,6,GAGCAGGATGATGATGTGTG,21,2223610
marRp,0.2857142857142857,7,6,GAGAGTAAGGCCCACACTTA,1,2222681
marRp,1.4285714285714286,15,6,GAGACCGCTTGGTAGATGTC,9,2232301
marRp,3.7142857142857144,31,6,GAGAAGTAAAATGTTAAGGG,25,2240490
marRp,1.5714285714285714,16,6,GACGTTCACGGGATACGGCA,10,2253319
marRp,3.857142857142857,32,6,GACGTGGCGGTATGCAGGAC,26,2250545
marRp,3.2857142857142856,28,6,GACGCGGCCGGCTACAAGAG,22,2242624
marRp,61.42857142857143,435,6,GACCACGAGAAGAGGGATTT,429,2242343
marRp,4.142857142857143,34,6,GACACCTGGTTCGCCCGTGC,28,2232184
marRp,0.8571428571428571,11,6,GACAATGTGGATTTCCTTGC,5,2222609
marRp,1.5714285714285714,16,6,GAATTCCCCTGTGTATTACA,10,2221954
marRp,0.7142857142857143,10,6,GAATATATTAACGATCTTTT,4,2259544
marRp,0.2857142857142857,7,6,GAAGTCCGCAGAGGCTGAGA,1,2231724
marRp,12.285714285714286,91,6,GAAGGAAAAGGGCATACCAT,85,2243869
marRp,7.571428571428571,58,6,GAAGCACCGTTTACACACTG,52,2254540
marRp,0.42857142857142855,8,6,GAAGAGGGGACACCCCACTG,2,2250781
marRp,1.2857142857142858,14,6,CTTTGAAGGTGAAGAATCGT,8,2229994
marRp,0.5714285714285714,9,6,CTTGGAGGCTGTACAGACCC,3,2235423
marRp,4.857142857142857,39,6,CTTCTAGGCACTGTTGCTAG,33,2219291
marRp,5.571428571428571,44,6,CTTCGTCACATAGTGACACA,38,2246131
marRp,3.142857142857143,27,6,CTTAGCGCACAGTCAACCTC,21,2229995
marRp,0.7142857142857143,10,6,CTGTTGGGGCTCGCCTACGG,4,2250898
marRp,5.571428571428571,44,6,CTGGCTGGGTTTCATTACAT,38,2242196
marRp,2.2857142857142856,21,6,CTGGCGCCGCTCGTGCTCGG,15,2239219
marRp,1.2857142857142858,14,6,CTGGATCGATCGAATGCGAC,8,2222286
marRp,1.1428571428571428,13,6,CTGCGTCGCGGCCCCCGGAT,7,2220013
marRp,16.428571428571427,120,6,CTGACCCGATTCTGTAGAGC,114,2256724
marRp,0.42857142857142855,8,6,CTGACATCGGGCCAGGCTTT,2,2224198
marRp,9.0,68,6,CTCCGCATCACAGGCTGGAG,62,2252907
marRp,9.142857142857142,69,6,CTATGGTTCACAAGGGAACA,63,2221686
marRp,7.0,54,6,CTATACAGGCGAATTCTAAT,48,2250070
marRp,4.0,33,6,CTAGTAGGTATCCGTAGCAG,27,2252371
marRp,1.2857142857142858,14,6,CTAGAATAGGGTGCAAAGTA,8,2226592
marRp,12.428571428571429,92,6,CTAACTGAATCAGTGACATA,86,2221544
marRp,10.714285714285714,80,6,CGTTCAGGGTTGGAAGTTCC,74,2224919
marRp,0.42857142857142855,8,6,CGTGGAAACCGAAGTCTATA,2,2221773
marRp,5.0,40,6,CGTCGTTCGAAGTCTGCAAC,34,2229147
marRp,1.5714285714285714,16,6,CGTCGCTGGATGCGATTGAT,10,2226623
marRp,1.5714285714285714,16,6,CGTCGCAGTGCCGCCCATTG,10,2220006
marRp,24.285714285714285,175,6,CGTCAGGCCTGACAATCTGA,169,2231365
marRp,25.857142857142858,186,6,CGTAGTGAATCTTACGCCCT,180,2259481
marRp,0.2857142857142857,7,6,CGTAGCTGAGGTCACGCGGG,1,2244029
marRp,1.4285714285714286,15,6,CGGGCTGGCGGTGCTGTGAA,9,2253945
marRp,1.0,12,6,CGGCTGAAATATCCTAGTGC,6,2224055
marRp,1.1428571428571428,13,6,CGGCCTATAGTTCACGAACT,7,2233011
marRp,21.714285714285715,157,6,CGGAGTTCCCTCGTCTCCCA,151,2227869
marRp,6.857142857142857,53,6,CGGAAGCCAATTCATCATTT,47,2241914
marRp,1.1428571428571428,13,6,CGCTCGCCGACGGGAGAATA,7,2230476
marRp,0.5714285714285714,9,6,CGCTCCTCGACGTTGGACGC,3,2249215
marRp,4.428571428571429,36,6,CGCGGACGCTATTACTGTAG,30,2235673
marRp,0.5714285714285714,9,6,CGCGCGAACTTCTAAACGGC,3,2233108
marRp,0.42857142857142855,8,6,CGCAGTCCTGACCCATTTAG,2,2247158
marRp,1.5714285714285714,16,6,CGCAGCTCAGCCATGAAGTT,10,2219350
marRp,3.7142857142857144,31,6,CGCAGACTAGGTTGGTTTTA,25,2259997
marRp,0.42857142857142855,8,6,CGCACTATGGGAACATTATG,2,2257455
marRp,19.285714285714285,140,6,CGCAAGTTTACCGACAATCA,134,2260316
marRp,7.428571428571429,57,6,CGATTGCTGAGAGACGCAAA,51,2243014
marRp,11.142857142857142,83,6,CGATGTGACATAACGTGGGA,77,2240691
marRp,19.0,138,6,CGATAGCTCGGTGGTCGGCA,132,2245064
marRp,3.4285714285714284,29,6,CGAGGTTTCGGAATTGACTT,23,2229846
marRp,24.857142857142858,179,6,CGAGGCGTTCCGATTGATAA,173,2260053
marRp,1.0,12,6,CGACATGATGGAGCGCAGTA,6,2228861
marRp,14.0,103,6,CGAACCATCGGGGACGCGTG,97,2229626
marRp,0.2857142857142857,7,6,CGAACAAGTAGAGCAGCTGT,1,2253318
marRp,0.8571428571428571,11,6,CCTTGGCTATGTATTCGCCC,5,2229759
marRp,0.2857142857142857,7,6,CCTGGTTATAAATATAGAAT,1,2226624
marRp,0.42857142857142855,8,6,CCTGGCTAGTCACGTTTTTC,2,2239446
marRp,0.2857142857142857,7,6,CCTCTGCCGTGCGCAATGTA,1,2251266
marRp,0.7142857142857143,10,6,CCTCGAATAATTGCACATTG,4,2218380
marRp,21.142857142857142,153,6,CCTCATCAGAGCGCTCAATA,147,2232182
marRp,3.2857142857142856,28,6,CCTATTCTCACAAAGAGGAG,22,2238415
marRp,0.2857142857142857,7,6,CCGTGTGGTGTCCCCGATGT,1,2230954
marRp,4.857142857142857,39,6,CCGTCCAGCTGTTATAGGAC,33,2234456
marRp,0.8571428571428571,11,6,CCGGCAGGCAATCTCCATTA,5,2253523
marRp,11.714285714285714,87,6,CCGCTCCGCGGAGAGACGCA,81,2240792
marRp,2.0,19,6,CCGCCCTGCCGGCGAATCAG,13,2260467
marRp,0.8571428571428571,11,6,CCGCAACTTGCCAATGCACA,5,2240073
marRp,0.7142857142857143,10,6,CCGAACTGTATAATGCGTAT,4,2254817
marRp,0.7142857142857143,10,6,CCGAAACCCAGAAACCTTTA,4,2255432
marRp,1.5714285714285714,16,6,CCCTGAATGATACGGGTAAA,10,2221116
marRp,1.8571428571428572,18,6,CCCCTGAATTGATTGTCCAA,12,2226648
marRp,1.8571428571428572,18,6,CCCATCCAGGGGGATAACAA,12,2232462
marRp,1.4285714285714286,15,6,CCCACACGAATTTCTCTGGC,9,2251312
marRp,1.5714285714285714,16,6,CCCAAAATGTCCTCGTGATC,10,2256043
marRp,1.7142857142857142,17,6,CCCAAAAGTCCTGTCCGGAC,11,2230512
marRp,1.8571428571428572,18,6,CCATCCATTAGTTGCGCTTG,12,2252137
marRp,0.2857142857142857,7,6,CCATATAAGTTGTAGGCGCA,1,2228820
marRp,0.5714285714285714,9,6,CCAGGTGTACAACGATATAT,3,2247881
marRp,4.571428571428571,37,6,CCAGCCCGGCGTTATTCAAA,31,2240575
marRp,1.2857142857142858,14,6,CCACCTACCGCCTGATATGC,8,2235775
marRp,4.714285714285714,38,6,CCAACCAGGCATGTCGAATA,32,2245049
marRp,48.42857142857143,344,6,CATGTGTTTTTTCTGGCACC,338,2234544
marRp,5.0,40,6,CATGCTATGATTTTCATACT,34,2242195
marRp,1.1428571428571428,13,6,CAGTGTTTTTTTTGGGAAGA,7,2235509
marRp,2.857142857142857,25,6,CAGTGGGGGTTTGTAGTAAT,19,2251520
marRp,1.7142857142857142,17,6,CAGTAGTGAGCAAACGGCGG,11,2244972
marRp,9.428571428571429,71,6,CAGGGAAAGACACGCGACCT,65,2251620
marRp,1.2857142857142858,14,6,CAGCGTACCTCAACGCTGAT,8,2238077
marRp,0.2857142857142857,7,6,CAGCGGACGGCGCCAACTCC,1,2245805
marRp,0.7142857142857143,10,6,CAGACGTCGCAGGGTATACA,4,2232530
marRp,0.2857142857142857,7,6,CACTTGAGCGGATCGGACAT,1,2219172
marRp,2.0,19,6,CACTGTCGAACACATGGTTG,13,2249506
marRp,3.857142857142857,32,6,CACTGGCAGGTACCTACTTT,26,2236260
marRp,12.428571428571429,92,6,CACGTTTAGCGCCATCATTG,86,2247314
marRp,2.5714285714285716,23,6,CACCTCATTATAAGCCCTCA,17,2229543
marRp,0.7142857142857143,10,6,CACCCCATGAGAAGGTCTAT,4,2242165
marRp,0.5714285714285714,9,6,CACATTCGGCCTCCTAGCGG,3,2234910
marRp,55.714285714285715,395,6,CACATGGCCCTCTTTGGAGA,389,2236873
marRp,0.7142857142857143,10,6,CAATCGCATTCAGCCAGGGA,4,2248173
marRp,2.2857142857142856,21,6,ATTTCGCGAATTACTTCGGA,15,2255584
marRp,4.0,33,6,ATTGGGTTTAGCGTTGTCGG,27,2251236
marRp,1.8571428571428572,18,6,ATTCTGGAGTATAAAGTCGG,12,2239804
marRp,9.714285714285714,73,6,ATTATGATGACCAGACGAGT,67,2251779
marRp,0.5714285714285714,9,6,ATGTTCACTTTCACTCTAAG,3,2245011
marRp,5.857142857142857,46,6,ATGGTAATGTCTGGGGGTGT,40,2247982
marRp,8.428571428571429,64,6,ATGGGTGGCTGCGCCCTGCT,58,2248226
marRp,2.5714285714285716,23,6,ATGGACCTAAACTGATTTCT,17,2250572
marRp,9.857142857142858,74,6,ATGCGATGCTTCCGCCAAAC,68,2252034
marRp,0.5714285714285714,9,6,ATGCCGAAGTGTTCCCACCT,3,2241306
marRp,2.0,19,6,ATCTCGTCAAGCGACCGCCA,13,2220621
marRp,19.0,138,6,ATCGTTTCCCCCCATCGCAT,132,2235066
marRp,0.5714285714285714,9,6,ATCGTTAAAAGCTTGGGACT,3,2248874
marRp,4.714285714285714,38,6,ATCGTCTCGGATTAGGTGGT,32,2237537
marRp,0.8571428571428571,11,6,ATCGGTGTGTGTATGCGTAT,5,2247244
marRp,18.571428571428573,135,6,ATCGGGCACCTGTGAAAGAG,129,2245689
marRp,7.428571428571429,57,6,ATCGGATCAGGAAGTTCCGC,51,2240456
marRp,0.2857142857142857,7,6,ATCGCCACTGTCGAGTACCT,1,2255424
marRp,2.0,19,6,ATCGCACAGCAGAGGCCCTA,13,2223317
marRp,4.142857142857143,34,6,ATCCGCGGAATGTGAAGATG,28,2237478
marRp,0.7142857142857143,10,6,ATCCGCACTCCCCACGTCAG,4,2244596
marRp,0.7142857142857143,10,6,ATCCCGCTGGTTGGAGACTG,4,2250432
marRp,0.5714285714285714,9,6,ATCAGTATCCGGCCTCCACA,3,2226413
marRp,11.571428571428571,86,6,ATCAGCAGAAGCCCCGCATG,80,2218505
marRp,1.7142857142857142,17,6,ATCACCGCGATTCGTAGAGT,11,2226290
marRp,1.0,12,6,ATATGATAATGCTTTCTGGC,6,2242909
marRp,1.0,12,6,ATAGGGTCCTGGAGGGTCTA,6,2235354
marRp,3.857142857142857,32,6,ATAGCAGCAAGAACGTATGA,26,2220296
marRp,36.42857142857143,260,6,ATACTCCCGCAACGTGTCAT,254,2234534
marRp,1.0,12,6,ATACAGAATCAAGGGCGGTT,6,2245109
marRp,1.0,12,6,ATAACAAAAATTGGAGAAGG,6,2231049
marRp,1.1428571428571428,13,6,AGTTGCGGAGATAAGGATCA,7,2227963
marRp,1.7142857142857142,17,6,AGTGGTGAGCGCATCTTCGT,11,2229447
marRp,14.571428571428571,107,6,AGTGGGCACAGGTGTACACC,101,2227100
marRp,16.428571428571427,120,6,AGTGCGTCTTTTGGGGTAAC,114,2255993
marRp,3.142857142857143,27,6,AGTCGGCTCCCCGGAGCGCT,21,2240077
marRp,0.42857142857142855,8,6,AGTATATGATGGGCGCTGAA,2,2248012
marRp,4.285714285714286,35,6,AGGTTGTATCATGTTTGTAT,29,2257791
marRp,10.571428571428571,79,6,AGGTGCACACGATAGTACGC,73,2244840
marRp,0.8571428571428571,11,6,AGGGTTTGCACAACGGGCAT,5,2234408
marRp,2.142857142857143,20,6,AGGGTCTACGGTTCAGACGC,14,2249445
marRp,1.8571428571428572,18,6,AGGGGTGACGTCAATCTTAG,12,2257529
marRp,1.5714285714285714,16,6,AGGGGTAAATAAAGTCTATG,10,2231104
marRp,2.2857142857142856,21,6,AGGGGGCATGATGCCCACCA,15,2224971
marRp,0.8571428571428571,11,6,AGGGGGAACCGAGCCGCTTG,5,2246389
marRp,4.142857142857143,34,6,AGGGAGTCCGTATTGCTGGT,28,2230762
marRp,21.857142857142858,158,6,AGGGAAATGACAAACGCTGC,152,2218591
marRp,1.1428571428571428,13,6,AGGCTTGGAACTTGGAGTTG,7,2248475
marRp,2.0,19,6,AGGCCTGTGTACCTCGAGTA,13,2257737
marRp,0.2857142857142857,7,6,AGGCCGACCTGAGATTTAGG,1,2233719
marRp,0.5714285714285714,9,6,AGGACTAGGAACGTCTCAAG,3,2220408
marRp,0.5714285714285714,9,6,AGGAAGTCATTTTCGCGATC,3,2221593
marRp,0.5714285714285714,9,6,AGCTTACCGTCAATGCGGTC,3,2222281
marRp,3.142857142857143,27,6,AGCTGACTTGGTGTCATAAT,21,2219201
marRp,3.5714285714285716,30,6,AGCTCGTCGCCGTACCGGCA,24,2250461
marRp,25.142857142857142,181,6,AGCGTGTTTTCGCAAGTTTG,175,2238290
marRp,2.0,19,6,AGCGCGGTTGTACGGCCCTT,13,2228695
marRp,1.0,12,6,AGCGACCTAGTGTAGCCTTT,6,2248433
marRp,2.5714285714285716,23,6,AGCGAAAGTTTATGCGAAAG,17,2235352
marRp,26.285714285714285,189,6,AGCATGTACGCGTGCCGTAT,183,2240563
marRp,1.7142857142857142,17,6,AGATTACTCCGACAAAGGGC,11,2224870
marRp,20.142857142857142,146,6,AGATGCAGCTCGGAGGCATG,140,2232739
marRp,2.5714285714285716,23,6,AGAGGTTTCTCGAAGAGGTG,17,2233217
marRp,1.5714285714285714,16,6,AGACTATTACAATGCCAGAT,10,2229942
marRp,1.8571428571428572,18,6,AGACCCTTGTACGCCCTTCC,12,2256262
marRp,1.7142857142857142,17,6,AGACAAAGGTTCTGGTAGTC,11,2242095
marRp,4.285714285714286,35,6,AGAAAAGTGATGCCTTGTCC,29,2226494
marRp,0.2857142857142857,7,6,ACTTGTTTAATAAAAGCCTG,1,2233167
marRp,0.8571428571428571,11,6,ACTGTGAACACGGGCATGCC,5,2253352
marRp,2.5714285714285716,23,6,ACTCTGCGCCAATCCCATCA,17,2230241
marRp,1.2857142857142858,14,6,ACTCGTCATTCACCAGGTTG,8,2258721
marRp,9.857142857142858,74,6,ACTCGATCTATTCCCACATT,68,2247452
marRp,4.571428571428571,37,6,ACTCCATCATTAAAAATAAA,31,2239420
marRp,2.7142857142857144,24,6,ACTACAACAGACGGCTAAGT,18,2219727
marRp,0.42857142857142855,8,6,ACGTTTTACGGGATATAAGC,2,2241890
marRp,0.42857142857142855,8,6,ACGTCTTATCTATGTCCTAG,2,2241699
marRp,0.5714285714285714,9,6,ACGTAGCGGCGAATGCTAGA,3,2243734
marRp,0.42857142857142855,8,6,ACGTACTTAAGTGAATGTTG,2,2231451
marRp,1.0,12,6,ACGGGCGGCCGACAGTGTCT,6,2229641
marRp,2.142857142857143,20,6,ACGGCAGAACCCCGGGCATG,14,2226173
marRp,0.2857142857142857,7,6,ACGCGAGCCACGACCTCATA,1,2224720
marRp,3.5714285714285716,30,6,ACGCCATATGAGGGGGCCTT,24,2227270
marRp,2.4285714285714284,22,6,ACGCATACTTTCGGCTTTCA,16,2231326
marRp,1.2857142857142858,14,6,ACCTCGCTTCAAGGTACGGA,8,2257016
marRp,1.2857142857142858,14,6,ACCGGTCATGCCGAACTGCT,8,2240200
marRp,32.0,229,6,ACCCATCGCTTGGTGACCGA,223,2235073
marRp,0.7142857142857143,10,6,ACCAGACTAGCAGCTTCCCC,4,2219419
marRp,8.571428571428571,65,6,ACCACTGGCAGTGGTGGGAG,59,2221796
marRp,1.4285714285714286,15,6,ACATTCCATTGGGCTTCAAA,9,2252628
marRp,0.42857142857142855,8,6,ACATGGCCGCCTCGTTGAAA,2,2255696
marRp,0.2857142857142857,7,6,ACAGCTCCGTGTTTTAATGC,1,2219609
marRp,1.7142857142857142,17,6,ACAGCAATAACGTGGTTCAG,11,2241629
marRp,1.4285714285714286,15,6,ACAGAATTAGTTCGACGGAA,9,2244974
marRp,1.0,12,6,ACAACGGTTTAGATCATGGG,6,2227936
marRp,1.4285714285714286,15,6,ACAAAAATGTGTATAGCAAC,9,2257696
marRp,1.2857142857142858,14,6,AATTTAGCCGATGAACGGGT,8,2219037
marRp,2.5714285714285716,23,6,AATTGGCCCGTGGTAGGAAG,17,2239707
marRp,14.571428571428571,107,6,AATGTGGGAATCTTGTTTCA,101,2256369
marRp,11.857142857142858,88,6,AATGGATTAACAGCTCGAGT,82,2237237
marRp,7.428571428571429,57,6,AATCGAATGAGGCCTACAAA,51,2218896
marRp,1.7142857142857142,17,6,AATCCTAAGCACTCTAGGCA,11,2220118
marRp,0.2857142857142857,7,6,AATCCCCCGAACGTAGTAAA,1,2227130
marRp,1.1428571428571428,13,6,AAGTTGGCTAGCCCGGGCAT,7,2261041
marRp,2.4285714285714284,22,6,AAGGGCTCCCGCTGGCGTAG,16,2236225
marRp,0.5714285714285714,9,6,AAGGGCGCGTTCCGGGAGCA,3,2260997
marRp,8.714285714285714,66,6,AAGGCACGGGAGCTTACTCT,60,2243002
marRp,0.42857142857142855,8,6,AAGGAGGCTACGACTCGATC,2,2225420
marRp,2.0,19,6,AAGATTTACTTAACATTAGT,13,2230049
marRp,3.4285714285714284,29,6,AACTATTGAAGACCAATGCC,23,2256144
marRp,0.5714285714285714,9,6,AACGGGGTTCAGTTTCTCGG,3,2226080
marRp,3.7142857142857144,31,6,AACGAGAAGCCTTCCCGATA,25,2244930
marRp,1.0,12,6,AACCGGCTGAAGAGAGGGTG,6,2239215
marRp,3.0,26,6,AACCGCTATACATGGAAAAG,20,2246648
marRp,12.142857142857142,90,6,AACATAAGGAGTATGTAATA,84,2251221
marRp,0.7142857142857143,10,6,AAATGCGCGCGTGCGACTTC,4,2242749
marRp,1.4285714285714286,15,6,AAAGTTGTCTTGCAGATATC,9,2235293
marRp,1.2857142857142858,14,6,AAAGTCAGTCCCGTGGTCAG,8,2226879
marRp,0.2857142857142857,7,6,AAAGGTACCTGCGACTTCTC,1,2259695
marRp,2.142857142857143,20,6,AAAGATGATGCGCCACCACA,14,2235131
marRp,4.428571428571429,36,6,AAACCCGAGAAGAGAACCGA,30,2240757
marRp,13.428571428571429,99,6,AAACAAGTTCAGGAAGGGCA,93,2259941
marRp,0.8571428571428571,11,6,AAAACGTTTAGCGTGTTCGA,5,2230996
marRp,3.7142857142857144,31,6,AAAAAGACCCTAGTGCGTAT,25,2259217
marRp,1.8333333333333333,15,5,TTTGTCACTGGGGTTGATTA,10,2243818
marRp,6.833333333333333,45,5,TTTACTATTCCGGCCCCAAT,40,2242434
marRp,2.5,19,5,TTGTCTGTTAGGCACGTAAT,14,2246996
marRp,16.5,103,5,TTGTCAAACCAGGTAGGAAT,98,2260407
marRp,3.3333333333333335,24,5,TTGTAAGAGCGGCCGGACAG,19,2243710
marRp,1.1666666666666667,11,5,TTGCGGAAACTAACGCCTAT,6,2245080
marRp,18.833333333333332,117,5,TTGCGACGATCAAGTAACCA,112,2259483
marRp,0.3333333333333333,6,5,TTGCCTACGCGGCCGAGGGA,1,2221163
marRp,0.3333333333333333,6,5,TTCTTAGCCATTTATAAACG,1,2252492
marRp,6.0,40,5,TTCTTAAGGTAATTTCTGGG,35,2230470
marRp,4.0,28,5,TTCTATTTCGTGTACCATGC,23,2219074
marRp,3.6666666666666665,26,5,TTCGTGTTCTGCAGCCCAGG,21,2226306
marRp,1.5,13,5,TTCGGACTCAACCCTGACAC,8,2228200
marRp,0.5,7,5,TTCCTTCAAAAGTAAATGTT,2,2228096
marRp,0.8333333333333334,9,5,TTCCTGTATCAATCGCTTGC,4,2260075
marRp,1.6666666666666667,14,5,TTCCTCGCCCGACTCATTAC,9,2251792
marRp,3.1666666666666665,23,5,TTCACGGAGATAGTGATATT,18,2242167
marRp,12.5,79,5,TTCAACTGGCCTCCCTGCAG,74,2224918
marRp,1.6666666666666667,14,5,TTCAACATCCAACGATTGCC,9,2229044
marRp,8.5,55,5,TTCAAAGGGGCATCAGAATC,50,2255577
marRp,2.0,16,5,TTATGTGTAACTTCGGTGCA,11,2235377
marRp,0.5,7,5,TTATGTCAGTTCCGTGCTGA,2,2222462
marRp,0.6666666666666666,8,5,TTACCGAGGAGGACCTGGAT,3,2225673
marRp,2.6666666666666665,20,5,TTAATAGACATCTGTTCACT,15,2259146
marRp,25.0,154,5,TTAACCATGCTCCACGTGTA,149,2260227
marRp,2.5,19,5,TGTTGAAGCATTTTAATGGA,14,2238866
marRp,2.1666666666666665,17,5,TGTTCTAGCGACGCATCGGT,12,2225621
marRp,0.6666666666666666,8,5,TGTTAGATGAAGCCAGGGTC,3,2249254
marRp,1.5,13,5,TGTTACACTCAGCACGGAAG,8,2241724
marRp,4.166666666666667,29,5,TGTGTTGAATGGAAACAGGC,24,2255176
marRp,2.1666666666666665,17,5,TGTGGGCCATGTACTATACT,12,2229383
marRp,3.6666666666666665,26,5,TGTGCTGATGTTGTTGTGGC,21,2255120
marRp,11.166666666666666,71,5,TGTGACTCAAAGGTCCTTTT,66,2227256
marRp,13.166666666666666,83,5,TGTCTAGTTCTTTGTACTTA,78,2254428
marRp,3.6666666666666665,26,5,TGTATTTAGGCACTAGACAA,21,2251951
marRp,4.333333333333333,30,5,TGGTCTCGTTTAATGCGGGA,25,2222163
marRp,0.8333333333333334,9,5,TGGGGTCTATTCCCCGGGGC,4,2235672
marRp,2.8333333333333335,21,5,TGGGATGAGGCGAACAGCCC,16,2257606
marRp,4.166666666666667,29,5,TGGAGCGGAGCGTGTTGAGG,24,2256477
marRp,2.8333333333333335,21,5,TGCGATGATCGGCTCTATAA,16,2255581
marRp,4.5,31,5,TGCCTAACTTATATGGGTTC,26,2224908
marRp,22.166666666666668,137,5,TGCCAAATCCGCCGTTCTTC,132,2227881
marRp,1.6666666666666667,14,5,TGCATAATCGCCATGGAGCT,9,2225364
marRp,12.333333333333334,78,5,TGCAAAACACTCCGCCGACA,73,2260306
marRp,1.6666666666666667,14,5,TGATACGCGACTGAGCGTAA,9,2233975
marRp,1.1666666666666667,11,5,TGAGTGGCGGGATAAGGTCG,6,2227490
marRp,5.833333333333333,39,5,TGAGCGGTGCTTCGCTTCCT,34,2238668
marRp,2.0,16,5,TGACGCCAGACTATTTGTCT,11,2235562
marRp,0.8333333333333334,9,5,TGACATGCTCGTAACTTGCA,4,2232522
marRp,3.0,22,5,TGACAAAATCTCTTCTTAAA,17,2260107
marRp,3.0,22,5,TGAAAGTCCCTCGATGATTC,17,2221067
marRp,0.8333333333333334,9,5,TCTTACCTCCCTTCCAAGAC,4,2231482
marRp,0.3333333333333333,6,5,TCTGGACGGAGCGCCACACT,1,2248094
marRp,1.6666666666666667,14,5,TCTGCGCTATCGGAAAGACT,9,2238771
marRp,2.5,19,5,TCTGCCAGCAAATGTCCGCG,14,2248759
marRp,2.1666666666666665,17,5,TCTGAAATGTAAGGTGCCGG,12,2243829
marRp,18.0,112,5,TCTCGTTGGGGTGTCCTTAT,107,2240612
marRp,2.5,19,5,TCTATCATATCCACGGCTAA,14,2254914
marRp,0.5,7,5,TCTACCGACTTCATGTCACA,2,2239572
marRp,4.5,31,5,TCGTTTGACATATTCTCAAA,26,2232555
marRp,1.3333333333333333,12,5,TCGTACGTTTACGTAGAAAC,7,2223315
marRp,3.5,25,5,TCGGGCTGAGAATTCTTGCC,20,2225233
marRp,1.8333333333333333,15,5,TCGGAAAGATGTCGCTTCGC,10,2225828
marRp,1.1666666666666667,11,5,TCGCTGGTGACGCCCAAACA,6,2251308
marRp,0.5,7,5,TCGCGTCGGTGACGCTGCTC,2,2221743
marRp,5.333333333333333,36,5,TCGAGTTCGACGAGGTTAAA,31,2221888
marRp,2.8333333333333335,21,5,TCGAGTGGTTCACTTAGCGG,16,2233482
marRp,1.3333333333333333,12,5,TCGAGATTCTTATAGGACGC,7,2252734
marRp,1.1666666666666667,11,5,TCCGTTCAATGGGTCATAGC,6,2236108
marRp,0.8333333333333334,9,5,TCCGCGTTACGATTAATTAG,4,2243809
marRp,6.5,43,5,TCCGCGTGCCCCGGGATGGA,38,2222261
marRp,0.6666666666666666,8,5,TCCACCGGAATAAGGGAATT,3,2227925
marRp,1.1666666666666667,11,5,TCATTCCCTGCAATCTCTCT,6,2222315
marRp,1.5,13,5,TCATGTTAGAAATCTGCTTC,8,2227398
marRp,7.0,46,5,TCATGGCGTCAATTCGGAGG,41,2230819
marRp,1.3333333333333333,12,5,TCATGCCGGCTCTTCACTCA,7,2250369
marRp,6.5,43,5,TCAGTAGAACAGACGGCTCT,38,2219082
marRp,0.8333333333333334,9,5,TCAGGATACTACGCATTACA,4,2256187
marRp,3.3333333333333335,24,5,TCAGAATCGCTGATAGGTAT,19,2255177
marRp,2.8333333333333335,21,5,TCACCGACGCGAAGTCACCC,16,2233139
marRp,0.8333333333333334,9,5,TCAATGTTTGTTAGCTTACT,4,2242928
marRp,1.6666666666666667,14,5,TCAACAAACGGCCAGAAGTC,9,2246307
marRp,1.0,10,5,TATTCCGTATCACATCTCTC,5,2250719
marRp,1.1666666666666667,11,5,TATGTGCCCCGGGGGGCCTA,6,2232676
marRp,2.6666666666666665,20,5,TATGTCAGCGTACCCTGTGC,15,2229158
marRp,1.1666666666666667,11,5,TATGCTGATCACGGGTCAGA,6,2242407
marRp,0.6666666666666666,8,5,TATGCGGACGGAAGCCCGTG,3,2223199
marRp,7.333333333333333,48,5,TATCTGAGTCGTAGAAAATC,43,2247578
marRp,2.5,19,5,TATCAGGTGGCCCGCAAGGT,14,2253168
marRp,0.8333333333333334,9,5,TATACAGCCACTACACTGAG,4,2235214
marRp,2.1666666666666665,17,5,TAGGATCAAACTTATTCCCG,12,2244365
marRp,0.3333333333333333,6,5,TAGCTAAATAGACAAGCACG,1,2237698
marRp,5.166666666666667,35,5,TAGCGGAAAGGTCTGGTAAC,30,2228161
marRp,107.5,649,5,TAGCAGCCATCGGCATGATC,644,2248560
marRp,1.0,10,5,TAGAGTAGGCCGTGTGATTC,5,2258474
marRp,0.8333333333333334,9,5,TACTTCTGGTCGTTCTGTAA,4,2229611
marRp,9.5,61,5,TACTCTCTTCCAGACCGGCA,56,2250720
marRp,8.166666666666666,53,5,TACGAACCCTATTGAAAGAG,48,2231776
marRp,3.3333333333333335,24,5,TACCCACACATCCCTTCACA,19,2224676
marRp,3.5,25,5,TACCAGGAGTGACCGTGTCC,20,2244994
marRp,2.0,16,5,TACAGATATTGGTGATATGT,11,2250886
marRp,0.6666666666666666,8,5,TACACGCGTTATTTCATGTT,3,2221746
marRp,1.1666666666666667,11,5,TAATTCGATCTTTGAAATCA,6,2245763
marRp,0.8333333333333334,9,5,TAAGTATCATGTTTAGTTGC,4,2250603
marRp,1.0,10,5,TAAGAATTTCTTCCTGAGAA,5,2239413
marRp,0.6666666666666666,8,5,TAACTGTGTGCAATATACAG,3,2225626
marRp,3.3333333333333335,24,5,TAACGTCTCTCTACAATTTT,19,2224681
marRp,1.3333333333333333,12,5,TAACATTAGGGATGAGTGCA,7,2241233
marRp,1.1666666666666667,11,5,GTTTATCGCCCTCGCTAGAA,6,2233708
marRp,3.8333333333333335,27,5,GTTCCGCGCGACGGGCTCAG,22,2225089
marRp,1.1666666666666667,11,5,GTTACGGCCCAGCGTTCGGT,6,2260990
marRp,2.5,19,5,GTTACGAGACGGAGTCCACA,14,2233995
marRp,4.0,28,5,GTGTTTAGGGGCATCCAACC,23,2230822
marRp,17.5,109,5,GTGGGAGCGCCGAAAGTGAT,104,2244832
marRp,6.833333333333333,45,5,GTGGCGGAGGAAATCGGCCA,40,2259759
marRp,0.3333333333333333,6,5,GTGCTTCCATTCCCGGGACC,1,2242442
marRp,7.333333333333333,48,5,GTGCAAGCACTCGGTTTTTG,43,2224366
marRp,10.0,64,5,GTGATAAAATGATGATGGGG,59,2234369
marRp,0.5,7,5,GTGAGGGGTCATATCGCCCC,2,2219715
marRp,0.8333333333333334,9,5,GTGACTTAAATAATTTGTTG,4,2231224
marRp,8.166666666666666,53,5,GTCTTATGTACCGTGGCCAT,48,2257658
marRp,1.1666666666666667,11,5,GTCTCAGAAGATCCGCTGGT,6,2257740
marRp,2.6666666666666665,20,5,GTCCTAGTTGTTTTGAGATT,15,2245954
marRp,1.0,10,5,GTCCTACTCAACTGTTCGAA,5,2233058
marRp,8.666666666666666,56,5,GTCCCCGCCGATGTGGCAAA,51,2223415
marRp,4.333333333333333,30,5,GTCAGGCGAAATTATTGCTT,25,2231615
marRp,1.6666666666666667,14,5,GTATGGAGCGGAGTACATAA,9,2238388
marRp,6.333333333333333,42,5,GTATCGCATACAAATAATAC,37,2235100
marRp,2.0,16,5,GTAGGGACCCATCTCAGTGG,11,2218612
marRp,1.1666666666666667,11,5,GTAGATCGTTCCACCACGTG,6,2233037
marRp,1.0,10,5,GTAACCCTTGCGAGTGATAA,5,2251617
marRp,1.0,10,5,GGTTTAACAGACCTAGCAGT,5,2254912
marRp,4.5,31,5,GGTTCTTCAATGCAATGCCC,26,2229908
marRp,0.8333333333333334,9,5,GGTTCGACTCGCTGTACTTG,4,2226217
marRp,0.3333333333333333,6,5,GGTGTCTACATGTTACCAAT,1,2223971
marRp,1.3333333333333333,12,5,GGTGGGGGTCTGGCCAAGCA,7,2231244
marRp,1.5,13,5,GGTGGCTCCCTCGTTGCAAC,8,2232378
marRp,1.1666666666666667,11,5,GGTCTGTGCGGGAACCGATG,6,2250302
marRp,0.8333333333333334,9,5,GGTCTCGGTATGTCTACTGA,4,2225986
marRp,2.1666666666666665,17,5,GGTCCGGATTTTCGTTAAGG,12,2229361
marRp,0.8333333333333334,9,5,GGTCCATGACACTCATCTTT,4,2237696
marRp,12.166666666666666,77,5,GGTCAGATATAGTTGACGCA,72,2255350
marRp,3.1666666666666665,23,5,GGTAGCTGCGCACGCGGAGT,18,2236832
marRp,6.666666666666667,44,5,GGTAAATAAATCACTATTGG,39,2247288
marRp,6.166666666666667,41,5,GGGTCAGCAATTACACTCGA,36,2218675
marRp,0.3333333333333333,6,5,GGGTATCAGACTATAAGCAT,1,2230505
marRp,0.3333333333333333,6,5,GGGGGTCAAGGTGCCACTCG,1,2249323
marRp,2.8333333333333335,21,5,GGGGCGAGTACGTACGGCGC,16,2245487
marRp,2.0,16,5,GGGGCAAGACGACCGCCTAG,11,2249368
marRp,1.0,10,5,GGGGAGCTCCTCGCAGCGAT,5,2225931
marRp,0.5,7,5,GGGCTAAACGCTTCTCGTAT,2,2256490
marRp,2.1666666666666665,17,5,GGGCCTACAGTTAACCCGTC,12,2222955
marRp,0.5,7,5,GGGCAACTCGTTAGATTGGT,2,2249552
marRp,0.3333333333333333,6,5,GGGAACCGTCTCCATTCTCC,1,2256744
marRp,3.3333333333333335,24,5,GGCTTGAACCGGCGAGTAGG,19,2243244
marRp,2.3333333333333335,18,5,GGCTGCCCATAAGTGACCGC,13,2236547
marRp,7.5,49,5,GGCTCGGAGCCGAGTTAACA,44,2245038
marRp,3.8333333333333335,27,5,GGCGGGTTTAGATAACGCGG,22,2254929
marRp,1.3333333333333333,12,5,GGCGGGTCACACAATTCGGT,7,2227629
marRp,0.5,7,5,GGCGGGCCTATCTTGAGGCT,2,2230194
marRp,2.1666666666666665,17,5,GGCCTTCGGTCCAACCATGG,12,2239131
marRp,1.1666666666666667,11,5,GGCCCTCGAACATAGACGCA,6,2243922
marRp,9.166666666666666,59,5,GGCATGGCACGACTGAAGAA,54,2233437
marRp,1.8333333333333333,15,5,GGCATCAGTGACATTGATTC,10,2234254
marRp,11.666666666666666,74,5,GGCATAGGGATCAATATTTG,69,2221018
marRp,1.0,10,5,GGATCTTTGGCCTTCCTAAA,5,2230074
marRp,2.3333333333333335,18,5,GGATCTAGATGGTCAAGCGA,13,2234196
marRp,0.8333333333333334,9,5,GGAGTAAGGTAGCCCAAAAA,4,2225827
marRp,0.3333333333333333,6,5,GGAGAAACCTAGGAGTTGCT,1,2246097
marRp,3.3333333333333335,24,5,GGAAGATGTCTCGTTAACAA,19,2229404
marRp,0.3333333333333333,6,5,GGAAGATAGTGTACACGGCA,1,2237054
marRp,1.0,10,5,GGAAAAGTAGCTCCACATCG,5,2235132
marRp,2.1666666666666665,17,5,GCTGGTTTTTTAATTTAAGC,12,2259816
marRp,1.5,13,5,GCTGAAACTCAAACAAGATT,8,2251585
marRp,1.1666666666666667,11,5,GCTCGTACATTATACTTCTA,6,2256573
marRp,1.3333333333333333,12,5,GCTCGGTTTCAGTCTGTGTG,7,2247003
marRp,7.833333333333333,51,5,GCTCCTTAAACACGGCACCA,46,2226492
marRp,3.8333333333333335,27,5,GCTACACGTCACGGCGGTCT,22,2234657
marRp,2.1666666666666665,17,5,GCGTTCTTCAACCACCTTGC,12,2227423
marRp,11.0,70,5,GCGGTGTGGTTGGAGAAGGA,65,2224812
marRp,1.6666666666666667,14,5,GCGCGCGTGGATCCAAGCTC,9,2258570
marRp,4.666666666666667,32,5,GCGCAACACCCGGTTTGCTT,27,2255966
marRp,0.3333333333333333,6,5,GCGACTGTTAGTATCCCACA,1,2242111
marRp,9.333333333333334,60,5,GCGACCAGCTTTACGCATCA,55,2221490
marRp,8.0,52,5,GCGACAATTAGGCGCCGAAA,47,2231864
marRp,0.8333333333333334,9,5,GCGAATCGTTCACTAGTCAC,4,2223551
marRp,0.3333333333333333,6,5,GCGAATATAATGTGCTAGAG,1,2251148
marRp,0.5,7,5,GCCTCACAAGCAACAGTGAG,2,2251760
marRp,3.6666666666666665,26,5,GCCTATTGCCTGTAAAAGCC,21,2259909
marRp,0.5,7,5,GCCTAGTAGCACTGAGTACT,2,2241893
marRp,1.6666666666666667,14,5,GCCTAGCGATGATGTACGAT,9,2229244
marRp,3.5,25,5,GCCGCTTTGCGGAATCCCCC,20,2237530
marRp,2.3333333333333335,18,5,GCCCTTCTATTAGCATGCTT,13,2231136
marRp,0.6666666666666666,8,5,GCCCGCACGCGCTGAAGCAT,3,2257459
marRp,2.3333333333333335,18,5,GCCCGCAATCGGGTTGGTAT,13,2227039
marRp,5.0,34,5,GCCCCGGTGCCGTCTATTAA,29,2260633
marRp,1.0,10,5,GCCCCCCCCTCTGGTATTTC,5,2220208
marRp,1.3333333333333333,12,5,GCCCCACAACAGCCACAACA,7,2257299
marRp,6.833333333333333,45,5,GCCATTTCAGAGCAGTCAGC,40,2241766
marRp,1.3333333333333333,12,5,GCCAGCTGCATATAGACGCA,7,2255329
marRp,4.5,31,5,GCCACGACCTGGATCCTGCA,26,2241688
marRp,1.6666666666666667,14,5,GCATGCAAACAAATCTTGTT,9,2226175
marRp,0.8333333333333334,9,5,GCATCAAAAGTCTTCATGCT,4,2221391
marRp,0.8333333333333334,9,5,GCAGGTGAACGTCTCAGTTT,4,2243947
marRp,3.0,22,5,GCAACCAGCGAATTTGAATT,17,2254462
marRp,5.666666666666667,38,5,GATTTCGGGGCGGAACTCTT,33,2226242
marRp,2.0,16,5,GATGCGAACATGATGCCGGT,11,2246668
marRp,0.3333333333333333,6,5,GATCTTTGTATTCCGGTTTT,1,2261068
marRp,5.166666666666667,35,5,GATCATATGAGCCACCGACA,30,2229519
marRp,1.8333333333333333,15,5,GATCAGCTAAAATCCAGTGA,10,2261099
marRp,0.8333333333333334,9,5,GATAGTAAGTCTCCATCAAC,4,2252496
marRp,0.3333333333333333,6,5,GATACGCCGGGGGTTCCTTA,1,2231821
marRp,1.0,10,5,GATACAATGAATGCGTCAGG,5,2222902
marRp,3.5,25,5,GAGTGTTCGCGACTATTGCA,20,2217913
marRp,2.5,19,5,GAGTCGTCTCGGAGCCCTGG,14,2246377
marRp,0.3333333333333333,6,5,GAGGTTCATGCCACTGTTTA,1,2255847
marRp,0.3333333333333333,6,5,GAGGACACGATCTCGCCTCT,1,2230554
marRp,2.1666666666666665,17,5,GAGCGCTAACTGCTTTTACG,12,2229387
marRp,1.5,13,5,GAGAGCTAATGATACCCTCA,8,2258848
marRp,8.166666666666666,53,5,GAGACTAAATCGGACTGGGT,48,2242533
marRp,6.333333333333333,42,5,GAGACATTGAATATTGAAGT,37,2228132
marRp,0.8333333333333334,9,5,GACTACCACGGGGGCTCGTC,4,2236335
marRp,11.166666666666666,71,5,GACGAGCCCAGGCGCTCCCA,66,2232128
marRp,3.6666666666666665,26,5,GACCAGGCAGCCACTAGCGA,21,2250158
marRp,8.0,52,5,GACCAGATCTAATGTATGAA,47,2218513
marRp,2.6666666666666665,20,5,GACCAGAAAGCGGAGTTTGA,15,2218421
marRp,1.8333333333333333,15,5,GACCACCAAGTACGCTTAGT,10,2235258
marRp,4.333333333333333,30,5,GAATGGAAATACTAGCAAAA,25,2236304
marRp,0.8333333333333334,9,5,GAATGCTGTAAATTTACTAC,4,2218942
marRp,3.1666666666666665,23,5,GAACGGCTTTCTTAAGTAGC,18,2240439
marRp,12.333333333333334,78,5,GAACGGCGAGTGAATCAGGT,73,2245233
marRp,1.0,10,5,GAACCACCTCCTATGGACAA,5,2245593
marRp,0.8333333333333334,9,5,GAAAGGGCTGGTAATAATGC,4,2222100
marRp,2.6666666666666665,20,5,CTTTGGTTGGTCGGTGGCCT,15,2245881
marRp,3.5,25,5,CTTTCCATGTATGGAGGGTA,20,2236330
marRp,2.1666666666666665,17,5,CTTTACAATTCACCGGAATT,12,2240460
marRp,5.0,34,5,CTTTAACTTGTTGGGATATT,29,2220553
marRp,19.666666666666668,122,5,CTTGTCGTACAGCATCTAGT,117,2231170
marRp,13.833333333333334,87,5,CTTGGCCATAACTGCGCCGA,82,2246011
marRp,0.3333333333333333,6,5,CTTGAGGTAAATTGTCTGCG,1,2250712
marRp,1.1666666666666667,11,5,CTTGACCTCAGGGTTGTTCG,6,2236834
marRp,3.3333333333333335,24,5,CTTCGAAATCTAGGCTCGTA,19,2243125
marRp,0.3333333333333333,6,5,CTTCATCGCACCAGATTTCC,1,2250421
marRp,1.5,13,5,CTTATCAACACAGCATACTA,8,2258335
marRp,7.0,46,5,CTTACATGAGGAGTCGCGAT,41,2236114
marRp,2.0,16,5,CTGTAGGCTGGGATCTAGCT,11,2255672
marRp,0.5,7,5,CTGGTTCTGGGCAACCTCAA,2,2231029
marRp,1.6666666666666667,14,5,CTGGACGCTCGAGGCCTTAC,9,2254580
marRp,3.1666666666666665,23,5,CTGCGCTGTAAATTAATTAA,18,2245718
marRp,4.166666666666667,29,5,CTGCCCTCGGGCTAAGCCCT,24,2250989
marRp,1.3333333333333333,12,5,CTGAGTCGGCCCCCGACATC,7,2230666
marRp,1.3333333333333333,12,5,CTGAAGAGCGCGGTGATACT,7,2255677
marRp,5.166666666666667,35,5,CTCTGTACGGGGATACCGAC,30,2254884
marRp,4.166666666666667,29,5,CTCGCGTTTGGTCGCCAGGA,24,2231523
marRp,0.3333333333333333,6,5,CTCCTAGGATGGATAATAGC,1,2246613
marRp,4.833333333333333,33,5,CTCCGGCGTGTTGGGGAAGA,28,2230522
marRp,49.0,298,5,CTCCCGCTACACATGACTTA,293,2257855
marRp,6.166666666666667,41,5,CTCCAGGCTGAAGCCGAGCC,36,2224600
marRp,0.8333333333333334,9,5,CTCATCGTGGTCATCCTTTA,4,2242932
marRp,0.3333333333333333,6,5,CTCACGCGTAAACCTGGGCC,1,2245888
marRp,1.8333333333333333,15,5,CTAGGTTTTCAGGTTAGATT,10,2252467
marRp,16.166666666666668,101,5,CTACGGGGAAGGCTACGGTG,96,2256809
marRp,8.666666666666666,56,5,CTACGCGAGGCGGGATCCTA,51,2244797
marRp,1.3333333333333333,12,5,CTACGACTCGTCCAATTATA,7,2258221
marRp,5.833333333333333,39,5,CGTTTGGATCCGACGGTGAT,34,2219761
marRp,0.5,7,5,CGTTGGCATTTGTAAACAAT,2,2253718
marRp,26.5,163,5,CGTGGAGGCGGCACTGAAAA,158,2237339
marRp,1.5,13,5,CGTCTATATAGAAGGCCTGG,8,2256615
marRp,3.0,22,5,CGTAGTCGATGCTCAAAAAT,17,2244404
marRp,2.6666666666666665,20,5,CGTAGAAGTTTAGTGCATAT,15,2222794
marRp,1.6666666666666667,14,5,CGTACTGAGTGATCACCCGC,9,2220879
marRp,0.5,7,5,CGGTTAGCTCGCTGGCCGCA,2,2225622
marRp,4.666666666666667,32,5,CGGTCGCGGTCGGCCGCTAC,27,2241449
marRp,23.833333333333332,147,5,CGGTCCCAGGGGCCTGGAAG,142,2237341
marRp,1.1666666666666667,11,5,CGGGGGAGATGGGCTCCTAT,6,2252429
marRp,2.1666666666666665,17,5,CGGGGAGAATTCTTATCAGA,12,2244485
marRp,1.6666666666666667,14,5,CGGCGGTATTTTACAAGGCA,9,2243547
marRp,2.8333333333333335,21,5,CGGCAATGTAAGCAAATCCA,16,2244307
marRp,1.3333333333333333,12,5,CGGACTTAGTGTGCGAGCTC,7,2249997
marRp,5.666666666666667,38,5,CGGAATGGCGTGGGTTGCAT,33,2238344
marRp,13.0,82,5,CGCTAAAAATGGTGCCTGAT,77,2254982
marRp,2.1666666666666665,17,5,CGCGTAAGACCCCTTAGGTA,12,2247778
marRp,5.5,37,5,CGCGCTTGCGTATTAAAACA,32,2257566
marRp,1.3333333333333333,12,5,CGCGCCCTCTAGTCCAGTGC,7,2222369
marRp,2.8333333333333335,21,5,CGCACGCGCGGGTATTGAGT,16,2245020
marRp,6.666666666666667,44,5,CGATTATCTGGCCTTGTAAC,39,2220545
marRp,1.6666666666666667,14,5,CGAGTATGCTCCTGGCCCCC,9,2247569
marRp,0.5,7,5,CGAGGGTTGTATTTGCCGAC,2,2258167
marRp,1.8333333333333333,15,5,CGAGACAGCTAACTTCGTGT,10,2243732
marRp,3.5,25,5,CGAGACAATCGGTATCTATG,20,2256458
marRp,2.0,16,5,CGACTGTCCGCACTCGTTTC,11,2245104
marRp,0.8333333333333334,9,5,CGAATAGTGGGCGGTCTTTA,4,2224604
marRp,5.0,34,5,CCTTCAAGGGCGTTTTTTTT,29,2242189
marRp,2.5,19,5,CCTGGGAGCCTGGGAAGGTT,14,2221267
marRp,6.333333333333333,42,5,CCTCTGAGAACACTTAGATC,37,2245322
marRp,0.5,7,5,CCTCGAATGCCTTGTCTTAT,2,2245393
marRp,2.0,16,5,CCTCAAAAAAATCGGGTAAT,11,2242048
marRp,1.1666666666666667,11,5,CCGGTATACGAGCTCCGTCT,6,2254662
marRp,1.1666666666666667,11,5,CCGGATCACGCGCAGTGCTG,6,2220425
marRp,0.8333333333333334,9,5,CCGCTCGACAACCCTTGGCT,4,2238592
marRp,25.0,154,5,CCGCGGAGGTATCCCAAGTT,149,2247969
marRp,8.333333333333334,54,5,CCGAAGTGAGGACTGTTGCA,49,2232145
marRp,0.5,7,5,CCCGCTAAAGGGGGGGTGTC,2,2231612
marRp,5.333333333333333,36,5,CCCCTTTGTACATAATCGGC,31,2220081
marRp,8.5,55,5,CCCCGTACCGTAGAGGTCCA,50,2244432
marRp,2.6666666666666665,20,5,CCCACTATGGTTTGGTCCCT,15,2249008
marRp,1.1666666666666667,11,5,CCAGGCAAGCTCCGCGATAG,6,2230556
marRp,2.1666666666666665,17,5,CCACAGCTTGTGGACTCCTC,12,2246191
marRp,7.0,46,5,CCAATACCGCAGTGTAACTG,41,2224912
marRp,0.5,7,5,CCAAGATTCATGTTCGGACA,2,2259326
marRp,1.5,13,5,CCAAGAAGCATTGTATTTGT,8,2249570
marRp,0.3333333333333333,6,5,CATTTTCCCATCATTATGTT,1,2220972
marRp,0.3333333333333333,6,5,CATTTCTGGAATTACGATCC,1,2247243
marRp,2.5,19,5,CATTGAAAGGAACTCCTTTA,14,2220660
marRp,0.8333333333333334,9,5,CATTAAAGTATGCTGCCGAA,4,2258100
marRp,0.6666666666666666,8,5,CATCCGAATTCTTCTAAGTT,3,2225743
marRp,0.3333333333333333,6,5,CATAGGATTGCCAATTCGAA,1,2233096
marRp,2.3333333333333335,18,5,CAGTTAGTGCAAACGGCAGA,13,2238775
marRp,0.3333333333333333,6,5,CAGTGACGCGGAAAGTGTGC,1,2219748
marRp,5.166666666666667,35,5,CAGTCATCTGCCAGCCTTCA,30,2244627
marRp,1.1666666666666667,11,5,CAGTCACACATGAACCTTAC,6,2254311
marRp,0.8333333333333334,9,5,CAGTACTCGCTGTGCTCACC,4,2255262
marRp,19.833333333333332,123,5,CAGTAACCCCGTTGAAGACA,118,2228281
marRp,0.5,7,5,CAGGTTTCATATACACACTC,2,2234462
marRp,3.6666666666666665,26,5,CAGGTCCGGAACTAGCAAGT,21,2225196
marRp,0.5,7,5,CAGGGGCAACAGGACTCAAC,2,2228488
marRp,7.833333333333333,51,5,CAGCCTGCTGAAGTGTCTGA,46,2219008
marRp,2.6666666666666665,20,5,CACTGCCTCCATTCGAAGCC,15,2240574
marRp,0.5,7,5,CACGTAGGGGCGAAAAACGG,2,2258769
marRp,1.3333333333333333,12,5,CACGCCGGAGATGCTACACT,7,2254951
marRp,8.0,52,5,CACACTGTAAATTCCATACT,47,2259233
marRp,2.0,16,5,CACACTCACTTCTATTTAGT,11,2259594
marRp,8.833333333333334,57,5,CACACGTATGCGTAAGACGG,52,2246257
marRp,0.6666666666666666,8,5,CACACGCACGGGACTTTGTT,3,2239884
marRp,1.1666666666666667,11,5,CACAAGATGACAAAGGCCTC,6,2219843
marRp,2.6666666666666665,20,5,CACAACTGCTCGCCCAGTGC,15,2243038
marRp,5.5,37,5,CAATGTCTGAAAATGGTTCG,32,2223374
marRp,2.0,16,5,CAATGGTGCTACACAATAGG,11,2249727
marRp,0.8333333333333334,9,5,CAAGAGACTGGTAGATACAT,4,2258426
marRp,19.333333333333332,120,5,CAACTTTTGAGGACTCACGA,115,2226826
marRp,0.6666666666666666,8,5,CAACACCGGCAGACAGTGCT,3,2235556
marRp,0.8333333333333334,9,5,CAAATGTGTTGGTTTAATGC,4,2258488
marRp,6.0,40,5,ATTTTACACCGCCCTAAACT,35,2239872
marRp,0.3333333333333333,6,5,ATTTGAAGTCTCTTGACGGT,1,2239410
marRp,1.6666666666666667,14,5,ATTGTTTCCGCAAACGTGCT,9,2257607
marRp,4.333333333333333,30,5,ATTGTTAATAGCGCTCTAGG,25,2227899
marRp,0.8333333333333334,9,5,ATTGTGGCCCCGCTTTGATT,4,2225235
marRp,2.3333333333333335,18,5,ATTGTCGGCATGCCTCTGCT,13,2258804
marRp,2.0,16,5,ATTGGGCTCGTCCCAGAAAA,11,2236222
marRp,2.6666666666666665,20,5,ATTCTGCTGAAGTGTTAGCT,15,2255041
marRp,4.833333333333333,33,5,ATTCCAGTGCTGCACCAGTA,28,2236791
marRp,4.666666666666667,32,5,ATTCAAACTCCTACCATGAA,27,2223201
marRp,0.3333333333333333,6,5,ATTATATGGCCGCGCGTGAA,1,2253332
marRp,1.6666666666666667,14,5,ATTAACAGAGTCTTATTCCG,9,2231418
marRp,2.8333333333333335,21,5,ATGTATCGGCCGTGACGGCC,16,2237632
marRp,7.666666666666667,50,5,ATGGGTAAGCTATGGGAAGA,45,2250649
marRp,13.666666666666666,86,5,ATGGGAGCGAGGGTTTTTTT,81,2245284
marRp,2.3333333333333335,18,5,ATGCCTTTTCTGGTGTGTTA,13,2218682
marRp,2.5,19,5,ATGAGCTCCCGGTCAGGCGA,14,2246811
marRp,4.333333333333333,30,5,ATGAAGGAACGGGTCCGTAA,25,2218585
marRp,1.6666666666666667,14,5,ATCTGTTGTTAAATAAAAGG,9,2247631
marRp,0.8333333333333334,9,5,ATCTGTATTCTAACAGCGAG,4,2219351
marRp,0.3333333333333333,6,5,ATCTGGAGAGCAGAGTTGTT,1,2238312
marRp,3.1666666666666665,23,5,ATCGATCCCGTAGGTATTTT,18,2243837
marRp,2.1666666666666665,17,5,ATCCATGGTCATATGTTTCC,12,2246453
marRp,0.3333333333333333,6,5,ATCAATGAATTACGCGCGAT,1,2251038
marRp,3.3333333333333335,24,5,ATATTGGGTTAGGTAGCCTT,19,2255087
marRp,1.3333333333333333,12,5,ATATGGACTTCTTCGCAACT,7,2224560
marRp,6.333333333333333,42,5,ATATGAAACTCCTGTCGCAT,37,2246156
marRp,23.5,145,5,ATATACTCCAGGTGTAGAAT,140,2237376
marRp,4.166666666666667,29,5,ATAGACACAGTTCTTCTACG,24,2258330
marRp,0.3333333333333333,6,5,ATACCATTCAGCATTATATT,1,2249237
marRp,14.666666666666666,92,5,ATACAGATAAAATGTCCCCT,87,2250709
marRp,1.3333333333333333,12,5,ATAAGCTTTCGCGCGTCTCG,7,2219453
marRp,9.666666666666666,62,5,AGTTTCGCCAACCAGTCCAC,57,2218819
marRp,3.5,25,5,AGTTCGTACCCAGTTACATG,20,2236636
marRp,1.5,13,5,AGTTCCATTAATATTAATTT,8,2241812
marRp,5.0,34,5,AGTTACCTATACCACTTGTA,29,2241415
marRp,1.3333333333333333,12,5,AGTGTGTGTGAAGTTCCCTC,7,2248667
marRp,1.5,13,5,AGTGTGCATAATTAGGGTAC,8,2221638
marRp,2.8333333333333335,21,5,AGTGTCGTATTATGCTAGTA,16,2224238
marRp,4.5,31,5,AGTGTCGGCGTCTCACCCTA,26,2251334
marRp,0.3333333333333333,6,5,AGTGGTCTCTTGTATCTAAA,1,2243615
marRp,9.5,61,5,AGTGCAAGTGCCTGTAGTTA,56,2228131
marRp,0.8333333333333334,9,5,AGTCGCTAATATTATATTCT,4,2245801
marRp,0.5,7,5,AGTCCTGGGATTTAGCCATG,2,2258672
marRp,2.1666666666666665,17,5,AGTCACTATTACCGAGAGGA,12,2260922
marRp,0.6666666666666666,8,5,AGTCACCTGGGCGGAGTAAT,3,2256964
marRp,2.8333333333333335,21,5,AGTCAAACTTTGAATCCTCT,16,2257015
marRp,2.1666666666666665,17,5,AGTAAATGCGACGAGGCCAA,12,2235215
marRp,3.8333333333333335,27,5,AGGTCTGGGTCAGCGTAACT,22,2260345
marRp,0.3333333333333333,6,5,AGGTAATCATGGGCCGAGAA,1,2232112
marRp,1.1666666666666667,11,5,AGGGTTTAGAGAAGGCGATG,6,2242647
marRp,4.0,28,5,AGGGTCTTAGACTTAGCCAA,23,2239922
marRp,1.8333333333333333,15,5,AGGCTGCCAGCTGTACGTCC,10,2255864
marRp,5.833333333333333,39,5,AGGCCATGGCTGCACACACG,34,2259279
marRp,0.8333333333333334,9,5,AGGAGGGGTTCGTAAATCAG,4,2233889
marRp,0.5,7,5,AGGACAGTATAGGGTAATTG,2,2236582
marRp,3.3333333333333335,24,5,AGCTTGGGGTCGAGAATTTG,19,2248472
marRp,2.0,16,5,AGCTTGCCGGAAGCCATCTC,11,2235878
marRp,0.5,7,5,AGCTCTGACCATATCCGTCA,2,2233283
marRp,1.5,13,5,AGCTCCTTGCGCAGCCTAAT,8,2247277
marRp,3.8333333333333335,27,5,AGCTCCCCACGTCAACTGAT,22,2230765
marRp,1.5,13,5,AGCTCATATCGCTTGAACTC,8,2257622
marRp,0.8333333333333334,9,5,AGCGTCTGGTGCGAACTTCT,4,2258197
marRp,1.8333333333333333,15,5,AGCGACCAGCCCAAGTGTTG,10,2238726
marRp,3.1666666666666665,23,5,AGCCCAACTATGTACTTGGG,18,2250679
marRp,0.8333333333333334,9,5,AGCAGCCGCTATGCTAAGAA,4,2218115
marRp,35.666666666666664,218,5,AGCAGAAGCACCTAGGTTTT,213,2245227
marRp,6.666666666666667,44,5,AGATTCCCGTAGAATGATTG,39,2235327
marRp,0.6666666666666666,8,5,AGATGTTAGAACCGATGTTA,3,2222380
marRp,0.5,7,5,AGATCGGCCTCCTTCTGGGG,2,2219134
marRp,1.1666666666666667,11,5,AGAGGTGGTCATACGGGTGG,6,2250371
marRp,1.1666666666666667,11,5,AGAGCTCGCAGGCCGTGCTA,6,2257363
marRp,4.0,28,5,AGAGCCTAACTTAGTCCTCA,23,2253405
marRp,6.5,43,5,AGAGCATTCCAACGTGTAAC,38,2226569
marRp,1.6666666666666667,14,5,AGACTGACTAGCCCGGACTA,9,2221992
marRp,0.6666666666666666,8,5,AGACGCCAAACAAATAGAAA,3,2258777
marRp,0.8333333333333334,9,5,AGAACATGTTCTGAAGGCAG,4,2237519
marRp,2.6666666666666665,20,5,ACTTTGCCGCGGCGGAGGTG,15,2218351
marRp,1.3333333333333333,12,5,ACTTGCGACAGTGGTGGCAA,7,2228555
marRp,0.3333333333333333,6,5,ACTTCATTGAAACCCAATCC,1,2249903
marRp,0.6666666666666666,8,5,ACTTACATTAGTCCCTCAGT,3,2261106
marRp,1.8333333333333333,15,5,ACTGTGACAGAGGTGTTCCT,10,2247091
marRp,2.1666666666666665,17,5,ACTGGGCAGGCAGGACAGCA,12,2226014
marRp,0.5,7,5,ACTGAACTTCAACCAGAAGG,2,2235671
marRp,7.5,49,5,ACTCTCAGGACTGCGCCGGT,44,2229233
marRp,0.5,7,5,ACTCCTGATAACGTATTCCG,2,2248538
marRp,0.3333333333333333,6,5,ACTAGGTATTACCGGGCGAC,1,2255425
marRp,24.0,148,5,ACTAAAGACCACCATAGGAA,143,2222840
marRp,1.1666666666666667,11,5,ACGTAGAGTTGAGTTTCAAG,6,2222612
marRp,0.8333333333333334,9,5,ACGGTTGATGTTCACGGTAC,4,2223805
marRp,2.3333333333333335,18,5,ACGGGGATCCCGGTTTTGGG,13,2255964
marRp,14.833333333333334,93,5,ACGCCTTTCCTTCTCCACAA,88,2221871
marRp,2.5,19,5,ACGCCGGAGGGGAGCCCCAT,14,2226533
marRp,0.3333333333333333,6,5,ACGACCTTTAAGTCCAGAGA,1,2254186
marRp,8.5,55,5,ACCTAAGCGGTGCCTATCCA,50,2240701
marRp,9.833333333333334,63,5,ACCGTTCGATCCGAATATAG,58,2227300
marRp,5.0,34,5,ACCGTGATGAAAACCGGAGA,29,2230759
marRp,7.833333333333333,51,5,ACCGGGAAGCGGGACCGTGG,46,2223684
marRp,6.166666666666667,41,5,ACCCGACCGAGTGGAGGAGC,36,2249537
marRp,0.3333333333333333,6,5,ACATTCTAGGGCCTCTACAT,1,2244254
marRp,9.333333333333334,60,5,ACATCAGTTTTATCTTGCGA,55,2221897
marRp,3.1666666666666665,23,5,ACAGCACGCTCTCCGGCCAA,18,2227221
marRp,4.833333333333333,33,5,ACAGAAAGTCAAATAGCGAG,28,2243519
marRp,1.1666666666666667,11,5,ACACACATTCTGTGGACACC,6,2223219
marRp,7.5,49,5,ACAATCCTGTCCCCGCACCG,44,2249150
marRp,0.5,7,5,ACAACGAAAAGTAACTTAAT,2,2219940
marRp,0.6666666666666666,8,5,AATTTGCTGGTAGTACCTCG,3,2257839
marRp,4.5,31,5,AATGTGGGTTCTAAGGTATT,26,2231652
marRp,3.1666666666666665,23,5,AATCCTTGATGAGGGTATAA,18,2226236
marRp,3.0,22,5,AATACTGTCTGCCACGCGTC,17,2218645
marRp,1.3333333333333333,12,5,AAGTACATTCGGTCTTGGAC,7,2227040
marRp,0.5,7,5,AAGGGCGGTTGTCTTTTATT,2,2238608
marRp,5.833333333333333,39,5,AAGGGAGATACTTCTGACAA,34,2238712
marRp,1.8333333333333333,15,5,AAGGCAATAGGACTGTGTTA,10,2235586
marRp,0.5,7,5,AAGGACAAGACGTGAACAGA,2,2233097
marRp,5.666666666666667,38,5,AAGCGGCAGTACTGGGGGAG,33,2250160
marRp,1.1666666666666667,11,5,AAGCGACAGCCAAGCGTACT,6,2235811
marRp,12.833333333333334,81,5,AAGAGAGATATTTCTCACCA,76,2259942
marRp,0.6666666666666666,8,5,AAGACACACCAGTCCAGGGG,3,2236234
marRp,1.5,13,5,AACTGTTCTGGCCTGGCCTG,8,2232556
marRp,1.0,10,5,AACTAGGCAACCTCCCAAAT,5,2248955
marRp,6.666666666666667,44,5,AACTACGTACGGATCAAATC,39,2247480
marRp,0.3333333333333333,6,5,AACCGATTGTGTCGATCGGT,1,2255169
marRp,1.0,10,5,AACCCTGGGGAATCGAAACA,5,2229308
marRp,0.3333333333333333,6,5,AACATCCATCATGGGGTTAT,1,2228456
marRp,4.333333333333333,30,5,AACAGACGCCAGGCGGAACA,25,2224635
marRp,0.3333333333333333,6,5,AACACAATTTTTCTAAGCGA,1,2260883
marRp,1.8333333333333333,15,5,AAATCTCCCGATTACTGGGA,10,2232083
marRp,2.8333333333333335,21,5,AAATAATTTATTAAGGTCCA,16,2218449
marRp,1.1666666666666667,11,5,AAACTCTGGCCACTACGGGA,6,2247341
marRp,13.666666666666666,86,5,AAACCCTTGATGCGTTCCAT,81,2248016
marRp,11.0,58,4,TTTTTCAGGAGAGCGTCAGT,54,2221828
marRp,1.6,11,4,TTTTGTATGCAAACTGCTTG,7,2233080
marRp,0.6,6,4,TTTTAACAAAGTCAGGATCG,2,2242616
marRp,0.8,7,4,TTTGGGTCTCAGTTTGTCTA,3,2218117
marRp,24.6,126,4,TTTGGAGCATCACTTTAAGG,122,2244831
marRp,1.0,8,4,TTTGATCTCGGTGCAACATG,4,2230648
marRp,2.0,13,4,TTTGAGGTCTGTACCTACCT,9,2255551
marRp,2.6,16,4,TTTCTAGCCCTGTCCAGTTG,12,2234045
marRp,0.4,5,4,TTTCGTCGATAGGCGGAAAG,1,2219762
marRp,2.6,16,4,TTTCGCATCCGGTTCTAGTT,12,2260681
marRp,2.4,15,4,TTTCCGTGGTGGGAACGAGT,11,2258253
marRp,1.2,9,4,TTTAGTTGGAAACGCGCTAA,5,2253879
marRp,2.0,13,4,TTGGGCACCCGTCAACTTTG,9,2252656
marRp,2.4,15,4,TTGGGCAAGGTTGGCACGGC,11,2259801
marRp,14.8,77,4,TTGCTGAGAGCGGACCCCTG,73,2240781
marRp,1.4,10,4,TTGCATTCTTTACTCTTGGT,6,2223268
marRp,0.6,6,4,TTGATCGGCAATTGACGTGC,2,2227727
marRp,5.2,29,4,TTGAGTCAACGCGAAAGAAA,25,2255051
marRp,1.2,9,4,TTGAGGATCCACATCTCTCT,5,2228472
marRp,4.0,23,4,TTGACGGAAAAGTATGGGAT,19,2219726
marRp,2.4,15,4,TTGAAACAAAGCACGGCAGA,11,2244448
marRp,0.4,5,4,TTCTTGTGTTTGTTATTTGA,1,2232866
marRp,9.0,48,4,TTCTAAATTCACTCCTAGGC,44,2238957
marRp,8.2,44,4,TTCGTGGGGACCGTTTTATA,40,2236047
marRp,1.0,8,4,TTCGGCAAACCTAATTTCGC,4,2256718
marRp,3.6,21,4,TTCGACGCAGCCCAGCGGGA,17,2257838
marRp,4.0,23,4,TTCATGTTGTGGAGGCAGAT,19,2235812
marRp,8.4,45,4,TTCACTGTAAGTTGTTCGTG,41,2260067
marRp,11.8,62,4,TTCACCTGGGGTAGCGACAT,58,2251636
marRp,3.0,18,4,TTCAACCTGAGACCGGGCTC,14,2256297
marRp,3.2,19,4,TTATTGATTCACACGACTAT,15,2246809
marRp,31.2,159,4,TTATTATTCGGCTAACGACA,155,2236868
marRp,5.8,32,4,TTATGGAATGGCATAAGCTC,28,2248490
marRp,0.4,5,4,TTATCGCTCAGTGGAAGGAT,1,2248209
marRp,0.4,5,4,TTATACTAGCTGGTCGTTTG,1,2235413
marRp,0.6,6,4,TTAAAAGATCCACTGTACAT,2,2249736
marRp,4.8,27,4,TGTTCAAATTCGCTCCTTTC,23,2239846
marRp,0.6,6,4,TGTTAGTATATAAAATGTCT,2,2243629
marRp,4.2,24,4,TGTGGTGGGAAACGAACGCC,20,2228153
marRp,1.8,12,4,TGTCGCCCAAGTTCATCCAT,8,2239089
marRp,1.4,10,4,TGTCCGCGCTTACCGGGTGG,6,2222373
marRp,0.6,6,4,TGTCCAATCGCGCGCTGAGA,2,2239080
marRp,0.6,6,4,TGTCCAACATGCTTCCCATT,2,2221166
marRp,13.4,70,4,TGGTGGGCATGTGGGTCTCT,66,2221283
marRp,1.6,11,4,TGGTCCCCACAGAGCAGATC,7,2221938
marRp,6.6,36,4,TGGGTATTTATTGTGGTTGC,32,2239318
marRp,0.4,5,4,TGGGGGGGGCTCGACTTTAC,1,2242860
marRp,2.0,13,4,TGGGACGAGCTGATGTAATT,9,2243997
marRp,1.8,12,4,TGGCCCTACTTAAAGGTATA,8,2251512
marRp,2.4,15,4,TGGCCCCCGGTATTGTTTCT,11,2244016
marRp,4.8,27,4,TGGAGATGTTTGCAGGTGAG,23,2248073
marRp,0.8,7,4,TGGACTGAAACAGTTTATTG,3,2225344
marRp,0.6,6,4,TGGAATATCCTACCAACCAT,2,2257943
marRp,0.8,7,4,TGCTGGGCTAAGAAGATGTA,3,2254476
marRp,0.8,7,4,TGCGGTGATTTTAGCCATTA,3,2256466
marRp,0.4,5,4,TGCCTAGGTCCCTGAATCGG,1,2220788
marRp,17.4,90,4,TGCATGAGGGCTATTTGCCA,86,2222343
marRp,3.2,19,4,TGCATAGAATAGCCCTGTGT,15,2227706
marRp,0.4,5,4,TGATCTCTCCGTCGAATGGG,1,2248080
marRp,3.8,22,4,TGATAGGGTTGCCGTTCCTG,18,2242799
marRp,2.6,16,4,TGATACGCCTCACAGAGTGC,12,2220953
marRp,12.6,66,4,TGAGTTCGTGACAGATAGCC,62,2219729
marRp,0.6,6,4,TGAGTCTGTTAAGACGATAT,2,2248590
marRp,9.2,49,4,TGACTTTTGTATAGGACCTT,45,2254095
marRp,5.0,28,4,TGACTGCATCAATGGTATGA,24,2248839
marRp,5.8,32,4,TGACGGGAGACTTGCGCAAA,28,2236514
marRp,2.4,15,4,TGAAGTTGTCATGGGAACTC,11,2256334
marRp,0.6,6,4,TCTTTTGCTAGATCATAAAC,2,2234647
marRp,2.2,14,4,TCTTGCTGCGCGAATCACGG,10,2246653
marRp,4.8,27,4,TCTTAGCCCCGCATTCTTGA,23,2223922
marRp,6.2,34,4,TCTGAGGTGGTGTAATTAGG,30,2242141
marRp,6.2,34,4,TCTCTGACCAAATTCTATCT,30,2259240
marRp,1.2,9,4,TCTCGATTCCGGAGGTACAG,5,2247215
marRp,0.8,7,4,TCTATTTCCCGAACAGAGTA,3,2234058
marRp,11.2,59,4,TCTATTCTTTTCCATTTCAC,55,2234985
marRp,0.8,7,4,TCTATGTAATAATCCTTTAA,3,2220945
marRp,1.8,12,4,TCTAATTCCTGTACAACTCA,8,2219857
marRp,32.6,166,4,TCGTCAGATTGATCGCACAT,162,2257780
marRp,2.2,14,4,TCGTAACAGGCACTGGGCAT,10,2239587
marRp,2.4,15,4,TCGGGTATCCTAACATGGGT,11,2221033
marRp,0.4,5,4,TCGGAGCGGGCTGTCATGTG,1,2237914
marRp,0.8,7,4,TCGCGGTCCCTCAACATTCA,3,2236298
marRp,3.4,20,4,TCGCGCCGACGTTACGCATG,16,2224140
marRp,0.4,5,4,TCGCCACCTACGGCCTAGTA,1,2219224
marRp,4.0,23,4,TCGCCAAAAATGGGAGTATC,19,2256997
marRp,4.6,26,4,TCGCAAGGTTTTTCATCGGA,22,2220417
marRp,0.8,7,4,TCGAGACTGGGCCTATGCAG,3,2256519
marRp,0.6,6,4,TCGAGACGCAAACCTAAGGC,2,2221222
marRp,2.6,16,4,TCCTGGAGATTCATGATCAA,12,2245300
marRp,2.8,17,4,TCCCTCTGTGCGTCCCCATA,13,2257106
marRp,3.0,18,4,TCATTGCAGCCGGCCATTGT,14,2227420
marRp,12.0,63,4,TCATCACTTACTAAATTTGC,59,2245042
marRp,4.0,23,4,TCAGTTTTCACTAACCGATC,19,2221729
marRp,2.8,17,4,TCAGTTGCGAAAGCTGTTAG,13,2248233
marRp,0.6,6,4,TCAGTCTAGGTTAGCCCACT,2,2251754
marRp,1.2,9,4,TATTTAGCGGAGGTCTCTTC,5,2218090
marRp,1.4,10,4,TATGGGTCCTCTTGATGGGA,6,2225429
marRp,1.6,11,4,TATCTTTTACACGTGGCGTC,7,2251035
marRp,3.6,21,4,TATACCGACAGCCCTGTGTC,17,2225670
marRp,0.4,5,4,TAGTCAAAGTTACTCCTGTG,1,2257181
marRp,1.4,10,4,TAGGTGCTAATCCAGACACC,6,2234926
marRp,0.8,7,4,TAGGTCGCAGGCAGTCAACG,3,2229236
marRp,2.0,13,4,TAGGGCCCCCGTTAGGACTA,9,2233605
marRp,0.8,7,4,TAGGCTCTATATGCTAAACT,3,2227622
marRp,0.6,6,4,TAGCGCCTTACAACCAGTCT,2,2239136
marRp,8.2,44,4,TAGCGAAGATGTGTTCCACT,40,2223603
marRp,14.4,75,4,TAGCCGGTGATAGAGTCTTA,71,2240647
marRp,2.6,16,4,TAGATCATACTCGAATGTTT,12,2257704
marRp,3.0,18,4,TAGACGTGAGTTGTCTTCAT,14,2242835
marRp,7.0,38,4,TACTTCCCACTCCCTGGGCG,34,2251222
marRp,4.0,23,4,TACTACACTCGGGGTGGCAA,19,2228978
marRp,1.4,10,4,TACGTGGCATGCACAGAACG,6,2237068
marRp,2.4,15,4,TACGCGTCGCGTCGGTCGCC,11,2231645
marRp,53.0,268,4,TACGATACCTGGCACTATTT,264,2250395
marRp,0.6,6,4,TAACTCCTAGACCCCCCCTG,2,2232940
marRp,11.0,58,4,TAACCACCGGAGCTCTACGT,54,2218412
marRp,3.8,22,4,TAAAGGTTAGTGGTACCCCG,18,2224917
marRp,7.4,40,4,GTTTTTTTGGATCCTTCTAA,36,2259476
marRp,5.2,29,4,GTTGTTATAGTGACGAGCCA,25,2221505
marRp,0.4,5,4,GTTGGCGCAGAACCTAGTAT,1,2256394
marRp,4.0,23,4,GTTCGCAGAGAGGCATACCA,19,2238543
marRp,1.0,8,4,GTTATTTTGAGGTTCTGTGT,4,2222308
marRp,2.4,15,4,GTTATGTTTTTAATTACAGA,11,2260334
marRp,1.8,12,4,GTTAGACAAGACAAGTCCAA,8,2235263
marRp,4.2,24,4,GTGTGCTATGACTTGCGCGT,20,2246838
marRp,0.4,5,4,GTGTCAGTAAAAACAATTTG,1,2233601
marRp,9.0,48,4,GTGTAGGTGTATTAGCTGTC,44,2258395
marRp,0.8,7,4,GTGCTTGGCTACTGATTTTT,3,2223378
marRp,0.4,5,4,GTGCCATTGTAATAACAGTC,1,2224706
marRp,5.6,31,4,GTGATTTAAGCGTCCTCCTG,27,2230667
marRp,4.8,27,4,GTGAACTCAGCGTAAAATAA,23,2243009
marRp,5.0,28,4,GTCTGGCCTTCTCCCTTCTG,24,2227507
marRp,2.2,14,4,GTCTGCATCACTTCACCTTG,10,2238171
marRp,6.0,33,4,GTCTCTTTCGCCGGGCTCGG,29,2243798
marRp,3.6,21,4,GTCTCGGGCGTTGCAAGGTG,17,2227263
marRp,0.8,7,4,GTCTAGAAAGGTGACTATCC,3,2219370
marRp,0.4,5,4,GTCGGTGGGTCTAAAGGCTT,1,2235741
marRp,8.0,43,4,GTCGATGTATGAGCTTAGCG,39,2235067
marRp,7.4,40,4,GTCCTCGAGAGAACTCTGAA,36,2244925
marRp,1.8,12,4,GTATGGGTGTTCTTCGCCTC,8,2250551
marRp,1.2,9,4,GTATATCGTTAGTCTTGTGT,5,2248729
marRp,0.8,7,4,GTAGGTCATCTTTAACGATC,3,2223729
marRp,28.6,146,4,GTACGAAGTGCGTACCTTAA,142,2238929
marRp,1.2,9,4,GGTTTATGTCATAAATTAAA,5,2249005
marRp,0.4,5,4,GGTTGGCTCCTTAGGGTCTG,1,2237755
marRp,33.6,171,4,GGTTGGATCGGGGACAACCC,167,2243879
marRp,4.8,27,4,GGTTATCGGTACGGAGCGTT,23,2219751
marRp,3.0,18,4,GGTGCTTGTCTGTCTCTATG,14,2246590
marRp,1.4,10,4,GGTCTGGAGACGGACCTGGC,6,2252854
marRp,2.6,16,4,GGTCCGGCTAGCCCCTCTCC,12,2243571
marRp,0.4,5,4,GGTCAGCCCCGACCGAAGTG,1,2243469
marRp,53.6,271,4,GGTCAAACGAGGGTACGCTC,267,2255998
marRp,5.0,28,4,GGTATGTAGCGAGAAGTTTG,24,2230135
marRp,17.0,88,4,GGTATCTTTACACAACGTAC,84,2228240
marRp,2.8,17,4,GGTAGTCTGAGGGGCCGTAG,13,2223316
marRp,1.0,8,4,GGGGGATCGGAGATCTTTAT,4,2225473
marRp,2.4,15,4,GGGGATGTCGTGAACGTGAT,11,2234480
marRp,0.6,6,4,GGGCGATGATCTGCTCCGGC,2,2254361
marRp,3.8,22,4,GGGCAACACTAGGATAGATA,18,2235795
marRp,13.6,71,4,GGCTTGGAGTTTATAGTTGA,67,2248599
marRp,0.8,7,4,GGCTGCCGGACGTGCAAGGA,3,2233865
marRp,2.2,14,4,GGCTGAGAGCCAGATCCAGT,10,2228532
marRp,3.2,19,4,GGCGTTGACCCCAGCTTCCC,15,2223608
marRp,2.0,13,4,GGCGCGAACCACCAGACCTG,9,2223210
marRp,1.8,12,4,GGCCTGACACCATAGAATGC,8,2229041
marRp,0.6,6,4,GGCCGGCGTGCACCGAGAGT,2,2244514
marRp,2.8,17,4,GGCCATGTTTATTTATCATA,13,2222411
marRp,1.6,11,4,GGCATACCGTAGGACAATAC,7,2255031
marRp,3.0,18,4,GGCAGGTCCACCGACTCGTT,14,2218657
marRp,2.0,13,4,GGCACACGTTCTCGGCACAC,9,2252784
marRp,9.8,52,4,GGATGTGAGTGTGTGCAGTA,48,2222964
marRp,5.4,30,4,GGATCGAGGACCGTCCTATG,26,2233386
marRp,3.0,18,4,GGATACGACATCATAATTTT,14,2246937
marRp,4.0,23,4,GGAGATCATAGTCTGCCCGA,19,2236741
marRp,2.2,14,4,GGAGAATGACCTTGGCTAAT,10,2243110
marRp,0.8,7,4,GGACCAAACCATCCCGGTTT,3,2226228
marRp,57.2,289,4,GGACAGCCCCAGAGAGTTAA,285,2234546
marRp,0.4,5,4,GGACACACTGCCCGGCCGCG,1,2238068
marRp,0.4,5,4,GGAATCGATATATCAATGAC,1,2249076
marRp,5.0,28,4,GGAATAGCCCTATTACGGTG,24,2228684
marRp,12.6,66,4,GGAACGCTCCTGCGCCTCAA,62,2218024
marRp,3.4,20,4,GGAAAATGCTGTCTGTCAGG,16,2227132
marRp,4.2,24,4,GCTTGCAGTAATCGCGGTCG,20,2220568
marRp,1.6,11,4,GCTTATTTTATTATTACGAC,7,2223927
marRp,1.0,8,4,GCTTACTTCCCGTAACTCCC,4,2217816
marRp,5.8,32,4,GCTGGTCACTAGAGTACCAT,28,2249295
marRp,3.2,19,4,GCTCCCTAGGTTACCGAAAT,15,2219738
marRp,1.2,9,4,GCTCATGCGTTCAGGAGGAC,5,2229734
marRp,3.0,18,4,GCGTATGCGTGAAGCGCACT,14,2249745
marRp,5.4,30,4,GCGTAGGTGAGTACACTGAA,26,2233453
marRp,1.4,10,4,GCGGCCTCATTTAAAGCGTT,6,2244761
marRp,0.4,5,4,GCGGCACCATTTCCAATCCA,1,2243156
marRp,4.4,25,4,GCGCGTGGGCCGTTAGGTAT,21,2240804
marRp,2.2,14,4,GCGACATGTCGATCTCCGGA,10,2245658
marRp,4.6,26,4,GCGAACGTCATTTCTAATTC,22,2242222
marRp,1.6,11,4,GCGAAAGCCGCTTCCATCTG,7,2224592
marRp,1.8,12,4,GCCTTATCGGGCCGAGCTAA,8,2256027
marRp,4.0,23,4,GCCTCAAAGGGCGTGTCAGG,19,2245282
marRp,0.8,7,4,GCCGTTAGGTGTGTTTGCGC,3,2253509
marRp,2.6,16,4,GCCGTGGGGCGTACTGCTAG,12,2252421
marRp,0.4,5,4,GCCGTCTCAGGCATTATTGG,1,2257578
marRp,0.8,7,4,GCCGTCTAGAGCTGCTCCAT,3,2234611
marRp,1.2,9,4,GCCGTACTGGATTAAATATT,5,2245695
marRp,1.8,12,4,GCCGCCAGCGTGGCCGGCAG,8,2260176
marRp,3.2,19,4,GCCCTTGTTGGCCCGCAATC,15,2225555
marRp,3.4,20,4,GCCCTGCGTGTTCAAACTAA,16,2258567
marRp,2.0,13,4,GCCATATGCTAAGATCCGCA,9,2243976
marRp,0.8,7,4,GCATTTTCGTAATTCAACTC,3,2218299
marRp,1.6,11,4,GCATGGTTTGCCAGAGTGCA,7,2245544
marRp,2.0,13,4,GCATATTTACACTTTAGTAT,9,2222345
marRp,1.0,8,4,GCATACCTAGCAGTTGATAT,4,2247415
marRp,2.8,17,4,GCAGGTCGTAACCGATGCTC,13,2218174
marRp,0.4,5,4,GCAGCATCGGCCTAGGAAAC,1,2250870
marRp,1.2,9,4,GCAGAGAGATTGTGACTGTA,5,2226047
marRp,0.6,6,4,GCACTTATGAGTACGGTACA,2,2222239
marRp,2.0,13,4,GCACTCCCCGGACGTTGTGA,9,2235228
marRp,1.8,12,4,GCACAAGCGGCGTGAAACTC,8,2226563
marRp,1.4,10,4,GCAACGCGAAGTAGATCGGG,6,2254648
marRp,2.6,16,4,GCAAATAGGCTTCGAACCAC,12,2230561
marRp,3.0,18,4,GATTTTCAGCCGGGGCGGTG,14,2230283
marRp,2.2,14,4,GATGGCCAATGATCGCCAGG,10,2227251
marRp,0.6,6,4,GATGAACCTTTGAGAGCACA,2,2236476
marRp,3.2,19,4,GATCCTCATCGCCACCATAT,15,2249971
marRp,1.0,8,4,GATCAAGTTCAAAGCCAACC,4,2219896
marRp,1.4,10,4,GATATTAGAGGAATCTTGCA,6,2234928
marRp,10.8,57,4,GATATGTGAATTCGTCCCGT,53,2257413
marRp,1.8,12,4,GATAACGTGCAGGGGATTGC,8,2223101
marRp,1.4,10,4,GATAAATAACGTTGCAGCTC,6,2241044
marRp,4.6,26,4,GAGTTATGTTGGGGAGAAGT,22,2248491
marRp,2.2,14,4,GAGTGCGGAGCTAGTGATAT,10,2243189
marRp,7.0,38,4,GAGTGATTGAAGGTCAGAGG,34,2244563
marRp,3.2,19,4,GAGTCGTGCCTTGGGGTTAT,15,2221031
marRp,6.8,37,4,GAGTCGAGTCTCAGAATGGG,33,2247974
marRp,3.0,18,4,GAGGGATAGATACTGTGTAA,14,2256395
marRp,0.8,7,4,GAGGCGGTATCGAGCTACAC,3,2219383
marRp,8.2,44,4,GAGGCACCGGTCGGCACTAG,40,2219931
marRp,1.6,11,4,GAGGAGGGAAACTTCACACC,7,2229466
marRp,0.6,6,4,GAGGAAACTTTTGAGAAGAG,2,2237439
marRp,5.0,28,4,GAGCCTTGTATAGGTCAGGT,24,2240262
marRp,5.0,28,4,GAGAGATGGAGTGAGAGTAA,24,2256586
marRp,1.2,9,4,GACTTCCGTCAATTACGCGA,5,2237536
marRp,11.4,60,4,GACTTCAATCGTACACGCTC,56,2249190
marRp,3.0,18,4,GACTACTTGTCTTTTGGCGT,14,2245101
marRp,2.2,14,4,GACGCCGGCCCAAGTTGACA,10,2222188
marRp,1.4,10,4,GACCGGGCTAACCGTCTGCC,6,2239231
marRp,1.4,10,4,GACCCTTCCGCGGATGGAAA,6,2227686
marRp,0.8,7,4,GACAGGCATAAAGGCGTACC,3,2230124
marRp,2.4,15,4,GACAACCGCACGATCTCTTT,11,2237414
marRp,2.4,15,4,GAATTTGCGATGTATAGGCA,11,2237929
marRp,0.4,5,4,GAATGGGATGCGCGAGAATT,1,2224292
marRp,0.6,6,4,GAATGAGCGCATCAGACAAA,2,2256951
marRp,3.8,22,4,GAATACGCCCGCCTGCTCTT,18,2218035
marRp,3.0,18,4,GAAGGCCATAGAGCACCGTT,14,2229730
marRp,1.4,10,4,GAAGCTGGCAAGGGCAACTA,6,2245654
marRp,0.4,5,4,GAACTGGTCAGGCGCCATGG,1,2248622
marRp,2.6,16,4,GAACTACCGTCGTATACATC,12,2255853
marRp,6.0,33,4,GAACAGCTCGTAAAGTGGGT,29,2259886
marRp,1.6,11,4,GAAATGCTGTTCCGTGGCGT,7,2249336
marRp,0.4,5,4,GAAACTGTGATTTCTCTAGT,1,2244818
marRp,0.8,7,4,GAAACTCGCATGTAGTGGTG,3,2247531
marRp,12.2,64,4,CTTTTGTTTAAGGCGTCTTA,60,2251616
marRp,33.8,172,4,CTTTTACCCGGAATTAAAGC,168,2260223
marRp,5.4,30,4,CTTTAAACCACCATAAGCTT,26,2231298
marRp,13.0,68,4,CTTGTCACTGGCGAGGCAAA,64,2234340
marRp,5.2,29,4,CTTCGCAGTGTCGCCGCGTG,25,2248125
marRp,3.6,21,4,CTTCGCAAGATCCCTCTCTT,17,2224350
marRp,0.8,7,4,CTTCATTATTGTTAGCGACT,3,2220858
marRp,7.0,38,4,CTTAGGTAGTGACGGTCACT,34,2252774
marRp,1.6,11,4,CTTAATGCCAACTAATGGAG,7,2250132
marRp,12.4,65,4,CTGTGATGGGCAGTGCGAGC,61,2220766
marRp,0.8,7,4,CTGTATCGACATAAGTTAGG,3,2245131
marRp,0.4,5,4,CTGGGCCTGACTGCGTGTAA,1,2253715
marRp,5.6,31,4,CTGGAGCCCTTCAGTGTTAG,27,2241418
marRp,2.6,16,4,CTGGAACTGCCCCACTAATA,12,2241396
marRp,2.6,16,4,CTGCTTAGCAATTGACGCAG,12,2255762
marRp,8.4,45,4,CTGCTAGGTATAAGAGACAA,41,2238993
marRp,1.0,8,4,CTGAACCCTAGAGCTCTGAA,4,2258014
marRp,1.8,12,4,CTGAACAGTGGTTTAGCGGA,8,2224703
marRp,5.2,29,4,CTCTGCACGATTTTAAAAAG,25,2238740
marRp,0.8,7,4,CTCTATCTACACCACGCGCA,3,2230115
marRp,1.4,10,4,CTCGACGTGGACCTAACCTG,6,2256240
marRp,1.2,9,4,CTCGAAACCATGGCTAGGGT,5,2233372
marRp,1.2,9,4,CTCCCTCCTATTATTTTGTT,5,2245802
marRp,1.4,10,4,CTCCCGGTTGAAGAAAGATT,6,2250539
marRp,2.0,13,4,CTCATAGGTGCGGCGCGTCT,9,2222705
marRp,1.4,10,4,CTATTAGCGCTTCTTACCAG,6,2250887
marRp,3.6,21,4,CTATAAGGAGATGCGTAATC,17,2242595
marRp,0.6,6,4,CTAGAAAGTCTTCTATCCGG,2,2258137
marRp,1.4,10,4,CTACTGCTTAAACCCTGTGT,6,2237502
marRp,5.2,29,4,CTACCCGCACGGAATCTCGT,25,2224808
marRp,9.8,52,4,CTAAGTCATCCCATGCCTTA,48,2218688
marRp,0.4,5,4,CTAACCTTAGGGCGTCCGAA,1,2241804
marRp,1.0,8,4,CTAACCCCCTGAATTATCCA,4,2219113
marRp,1.8,12,4,CTAAATTACATCACGATTCA,8,2255522
marRp,4.8,27,4,CTAAAGTGTAGGCAGGCAAT,23,2252224
marRp,1.0,8,4,CGTTGGGGGATTACAAATCG,4,2242757
marRp,0.8,7,4,CGTTCGCCTGTTCTCTAGCG,3,2248354
marRp,16.8,87,4,CGTGACCGGTATTCCTGGAC,83,2237461
marRp,2.8,17,4,CGTGAAAAACCAGAGGAGTC,13,2224585
marRp,3.8,22,4,CGTCTCCGGGGTTATCTGGC,18,2232945
marRp,0.8,7,4,CGTCTCCACGGAAGGATCTA,3,2258061
marRp,1.4,10,4,CGTCGGCCATGTATGTGGGG,6,2218365
marRp,1.2,9,4,CGTCGGCCAAGATCTGGCGG,5,2248090
marRp,2.2,14,4,CGTCGGACTACAATTGAGGC,10,2218182
marRp,5.6,31,4,CGTCCTACCCAGAACCCTCT,27,2223584
marRp,4.6,26,4,CGTCCGCCTAGCCGTTGTCA,22,2226540
marRp,4.2,24,4,CGTCCACCGGCCGATAGGTA,20,2244310
marRp,1.0,8,4,CGTCAGTGATCGTGGTCTTT,4,2227657
marRp,2.2,14,4,CGTCACATGTACCAGCTAGT,10,2229471
marRp,5.8,32,4,CGTATTTCTTGTGTCTCCCA,28,2235937
marRp,0.6,6,4,CGGTCAGGGTTATGGGATAT,2,2251369
marRp,0.8,7,4,CGGTATCTTTGATCATTGGG,3,2257188
marRp,1.4,10,4,CGGTATACGTGGCTACACTT,6,2225466
marRp,1.6,11,4,CGGGTGGCTACTACAACTCT,7,2254847
marRp,2.0,13,4,CGGGGTGCGCCGAAGGCTCC,9,2223767
marRp,6.8,37,4,CGGGGCGAACCATGGCGGGT,33,2218425
marRp,8.6,46,4,CGGGGAAGCCATGAAGACGT,42,2234989
marRp,2.0,13,4,CGGGCCAAGGGAATTTGTTC,9,2251647
marRp,0.8,7,4,CGGGAAGACGCTTCTAAGAA,3,2219945
marRp,0.8,7,4,CGGGAACTAAGTGTATGATA,3,2245108
marRp,4.0,23,4,CGGCTACAAGCCAACGGTAT,19,2245499
marRp,1.0,8,4,CGGCCGCAAAATGACGTACC,4,2247234
marRp,0.6,6,4,CGGAAATCCACGCGGCTGTC,2,2243493
marRp,2.6,16,4,CGCTACGTCCTAGTGTCCGA,12,2229717
marRp,8.6,46,4,CGCGTGGGCCGGACAACATG,42,2221804
marRp,2.2,14,4,CGCGTGCCCCAGAGACGACA,10,2231305
marRp,6.2,34,4,CGCGTAGGCCCCAAGCGTAC,30,2222166
marRp,1.2,9,4,CGCGGCAAGAAAGCGTTGGT,5,2245911
marRp,4.0,23,4,CGCGCGATTGCGTTGCACTT,19,2242019
marRp,2.4,15,4,CGCCGATGGAACTTTAACGG,11,2226868
marRp,1.8,12,4,CGCACCGTGAGTGGGGGACC,8,2234841
marRp,1.0,8,4,CGCAACTGTTGTGGCATGGC,4,2243084
marRp,42.6,216,4,CGATAGGTACATGGATCCTA,212,2225318
marRp,5.0,28,4,CGAGTGTTGGCGTACACGCG,24,2239775
marRp,1.8,12,4,CGAGCTCCTTACGCAGCGGG,8,2250574
marRp,2.6,16,4,CGACTGATCCACTCATGATA,12,2228397
marRp,6.6,36,4,CGACTAGCGGGCACCGGCGT,32,2242327
marRp,2.0,13,4,CGACGCCATGCTGGTCTATC,9,2221526
marRp,4.0,23,4,CGACGAACCCATACGGCTAG,19,2239834
marRp,2.2,14,4,CGAATGGTCAACTGTCCCAC,10,2253524
marRp,6.4,35,4,CGAATCCATTAGGCTCTAGA,31,2235582
marRp,2.0,13,4,CGAAATGAATTCAGCAAGTG,9,2219572
marRp,2.8,17,4,CCTTTGTGTCTGCTACGCGT,13,2239874
marRp,18.0,93,4,CCTTGAGTCACGAGTAGTTA,89,2229655
marRp,11.6,61,4,CCTGTACCCCTTAGCTGTGA,57,2246012
marRp,3.8,22,4,CCTGATCCGCGTTGTTCGCA,18,2255376
marRp,13.6,71,4,CCTGAGCAGCAATTTACACA,67,2241598
marRp,1.6,11,4,CCTCTCCAATACATTAATTT,7,2217942
marRp,5.8,32,4,CCTCAATGAATAGTCATAGA,28,2219721
marRp,0.4,5,4,CCTAGAAACCGTGCATTATC,1,2246820
marRp,17.0,88,4,CCGTGTCGCAACGAGCACGA,84,2236308
marRp,15.4,80,4,CCGGTATCGTTACTTGGTGG,76,2249007
marRp,1.2,9,4,CCGGGTAGAGTATATGGAAC,5,2257342
marRp,8.6,46,4,CCGGCGAGACTTGAGCCAGG,42,2222893
marRp,0.6,6,4,CCGGCCTTGGGACCATGTAG,2,2228234
marRp,0.4,5,4,CCGGCAGGTGAGGTGGTCAC,1,2236437
marRp,4.2,24,4,CCGGCAACAAGAGCGTTGGG,20,2245550
marRp,2.6,16,4,CCCTTGCTGAGGTTTTCACC,12,2234244
marRp,1.4,10,4,CCCTCACCAAGAGATGAAAT,6,2232439
marRp,0.4,5,4,CCCCCTGTTAGGGTGGGGGT,1,2259700
marRp,1.8,12,4,CCCCCGAACGTGGACCCGGT,8,2232357
marRp,1.8,12,4,CCCATTTTGGCCTCTGGTGG,8,2232600
marRp,1.0,8,4,CCATCTGAAAAATCCAACAT,4,2244875
marRp,1.6,11,4,CCATCGGGGCGTATGCCCTC,7,2221323
marRp,1.6,11,4,CCATAACGGGATTCGCACTA,7,2247414
marRp,7.2,39,4,CCAGTACTCGTCGGCCATCT,35,2238165
marRp,1.8,12,4,CCAGGCCTATCTTCGGGTTG,8,2259633
marRp,1.6,11,4,CCAGGAAGAATAAGGGGCGC,7,2242630
marRp,10.4,55,4,CCAGCGCGAGGCGTTCCGAA,51,2246708
marRp,48.6,246,4,CCAGATTACTCAGGGGTTCA,242,2226844
marRp,1.6,11,4,CCAGAGGAGTGTAAGCGGTT,7,2247402
marRp,19.0,98,4,CCAAGTGGACGCGGTGAGGA,94,2258405
marRp,5.8,32,4,CCAAGCCACACAAACAGGCT,28,2220086
marRp,4.8,27,4,CCAAGCAGGCAAGTCGAATT,23,2245737
marRp,8.2,44,4,CATTGTAGGCACAGTAGTAA,40,2240270
marRp,2.2,14,4,CATGGGTCCTACGTTTTCGT,10,2235444
marRp,2.8,17,4,CATCGTTGTGACATATGGAA,13,2234226
marRp,7.4,40,4,CATCCTTTATCCGGAATGTG,36,2240280
marRp,6.4,35,4,CATATCGCTAACGAATCAAA,31,2237180
marRp,1.6,11,4,CAGTTTATGGGCTTACAAGC,7,2250848
marRp,4.4,25,4,CAGTTCCAAATGTCTTCAGG,21,2256812
marRp,7.6,41,4,CAGGTTTTACTGGTTGTGTC,37,2231174
marRp,5.8,32,4,CAGCTTCTGCTCGCGGGTTT,28,2223398
marRp,1.0,8,4,CAGCTTACGAATACAAGAGT,4,2242963
marRp,1.4,10,4,CAGCGGGAGGATGTTTCCCC,6,2233410
marRp,0.6,6,4,CAGCAGGGAGATAAGGCACT,2,2220456
marRp,4.4,25,4,CAGAGTGCCAGCATTGGGGT,21,2240817
marRp,1.0,8,4,CAGACGGCATCAGGGCGAAA,4,2218270
marRp,1.4,10,4,CAGACCCCGGCAAGACGAAC,6,2257739
marRp,5.2,29,4,CAGAAGATTCTCTCGGTCCA,25,2219437
marRp,1.4,10,4,CACTGCATACAACGTTACGT,6,2233128
marRp,5.6,31,4,CACTATGCTGCAAGCTGGAA,27,2237644
marRp,0.6,6,4,CACTAGACCCGTTGCCGCCC,2,2244067
marRp,3.2,19,4,CACGTGTACGAGCGTTTCAT,15,2229280
marRp,0.4,5,4,CACGCTATCCCCGGATTACT,1,2220693
marRp,0.4,5,4,CACGATAGGAAAGTCCGTAT,1,2217963
marRp,1.4,10,4,CACCTTTATATGATCTCCAG,6,2252341
marRp,49.8,252,4,CACCGCGCTGAAGAGTACTA,248,2224948
marRp,10.6,56,4,CACCCCCCGGTACGATTAAG,52,2253259
marRp,0.8,7,4,CACCAGATACACGGGTGTTT,3,2255800
marRp,2.8,17,4,CACATCCTACGGCTACGGCC,13,2242543
marRp,3.6,21,4,CAATGATACGGAGAGCGACC,17,2241881
marRp,1.2,9,4,CAATCGATGGTAGCGATTTA,5,2244047
marRp,7.6,41,4,CAAGTCAAATAGAGTCCCCA,37,2258401
marRp,1.4,10,4,CAAGAGGTCGGTGTTTCATG,6,2248037
marRp,1.4,10,4,CAACTTTGTGACATATGAAT,6,2244093
marRp,1.0,8,4,CAACGTCTCGGTAATCCTGA,4,2230797
marRp,4.2,24,4,CAACAATCGCGCGGCCTCAC,20,2255942
marRp,2.4,15,4,ATTTCGCTGGACGTCCACTT,11,2230071
marRp,0.4,5,4,ATTTCGATGTTGGTTTCGGG,1,2251954
marRp,5.4,30,4,ATTGCATGCTGATTGGCGTG,26,2248088
marRp,1.6,11,4,ATTGACGACAAGGATTGGTA,7,2233809
marRp,0.4,5,4,ATTGAAAAGTGGTTCCGTAT,1,2238383
marRp,0.4,5,4,ATTCTGAAAACCCAATGAAA,1,2245916
marRp,1.8,12,4,ATTCTATTGCCTATAAAACT,8,2221800
marRp,5.0,28,4,ATTCTAGTATCGGATTGGAT,24,2223669
marRp,0.8,7,4,ATTCGTGCTCTCATCTCCCG,3,2225642
marRp,12.8,67,4,ATTCCTTAATGTTTCGGCAA,63,2237120
marRp,0.4,5,4,ATTCCCCACGGGCGGGTCAG,1,2229746
marRp,3.0,18,4,ATGTTGCATTTGTCCCCACT,14,2236969
marRp,1.2,9,4,ATGTTCTCGTGCTCGAGTGT,5,2257834
marRp,6.0,33,4,ATGTGAGGCAGTTTCACGTG,29,2252368
marRp,4.0,23,4,ATGTCTCCCCTATCCGTGCA,19,2249801
marRp,12.4,65,4,ATGGTGAGTGCCTTCGTGAA,61,2254374
marRp,1.6,11,4,ATGGTAGAACAGCCCGGATT,7,2241667
marRp,4.0,23,4,ATGGTAACACCGTCGATCAA,19,2246714
marRp,1.2,9,4,ATGGGCTAGAACTACGCAAC,5,2256643
marRp,5.8,32,4,ATGGCTATCAGGCTTATTAT,28,2218450
marRp,0.4,5,4,ATGGATCGGCCCTAGTAAGT,1,2238647
marRp,11.6,61,4,ATGCTCCGGATGTATGGGCT,57,2260550
marRp,0.4,5,4,ATGCGTCCTGAATCTTATTC,1,2226295
marRp,1.8,12,4,ATGCGGTTAGCTAATGAAAT,8,2237417
marRp,5.0,28,4,ATGCCTGTCTCGAAGTAGTC,24,2243136
marRp,1.2,9,4,ATGCCACATAGTGATTGATA,5,2237754
marRp,5.4,30,4,ATGCAGAACGAGCGAAGTCA,26,2241602
marRp,4.0,23,4,ATCTTGCAGACAAGCTTTCG,19,2240271
marRp,3.2,19,4,ATCTTCAAAGCGGGACGCGG,15,2250193
marRp,6.2,34,4,ATCGTTCCGCATTAACTGTA,30,2225046
marRp,2.0,13,4,ATCGCCCTTGCAAAGGTTTG,9,2230321
marRp,13.6,71,4,ATCGCAACTATACCAGAGAA,67,2232185
marRp,3.2,19,4,ATCCTGTATAAGTTCAACAT,15,2248439
marRp,4.4,25,4,ATCCGCACCTGTTTAGGCAA,21,2235008
marRp,2.4,15,4,ATCCCTCGCTACGCAAGCGG,11,2244371
marRp,20.6,106,4,ATCCAGGGGTTAAGACAACG,102,2257861
marRp,1.8,12,4,ATATTTTCCACAGCCCCAAT,8,2235516
marRp,1.8,12,4,ATATCCTTCCTTGTACAAAT,8,2222444
marRp,2.0,13,4,ATAGTACGGCAAGACTGCTG,9,2233997
marRp,0.6,6,4,ATAGGCTTTCCAACTACCTG,2,2255055
marRp,1.6,11,4,ATAGCTGGCGGGTTAGTCTT,7,2225826
marRp,1.8,12,4,ATAGCATCGATTCACCGATT,8,2228598
marRp,1.0,8,4,ATACTAGACACGTTGAGGGG,4,2236829
marRp,2.0,13,4,ATACAATTCCTTATGATCCA,9,2224670
marRp,2.8,17,4,ATAAGTTAATCGTCGTGATT,13,2224734
marRp,0.8,7,4,ATAAATCAAGTAGCGTCGTG,3,2242717
marRp,14.2,74,4,AGTTGGAGAGCAACGCGATA,70,2250715
marRp,9.0,48,4,AGTTCGTTGGATGCGCAAGT,44,2241599
marRp,1.6,11,4,AGTTATCGTAATTCTATGTT,7,2243700
marRp,1.0,8,4,AGTGCGTGCCCGCCGATAGT,4,2249086
marRp,0.6,6,4,AGTCGTCATAACGAGAGCGA,2,2257753
marRp,15.4,80,4,AGTCAACTAATAACTGTAGT,76,2222843
marRp,1.8,12,4,AGTATTGCTTACGTGTGGAG,8,2243181
marRp,2.4,15,4,AGGTGTCCCCAAGTCCAAAC,11,2244572
marRp,1.2,9,4,AGGTAGCCACCGTCCTTTCA,5,2248840
marRp,36.8,187,4,AGGTACTCGTGTGGTCTAAA,183,2240010
marRp,0.8,7,4,AGGGTAGTGTCTCACTAGAT,3,2248086
marRp,2.2,14,4,AGGCGGCTATCCTTTAAAGA,10,2246450
marRp,3.6,21,4,AGGCCTGTTGGGACCTTCAT,17,2254595
marRp,0.8,7,4,AGGAGGATCAGGATAATACC,3,2238351
marRp,6.6,36,4,AGGACTGAACATGGGGTTGT,32,2251708
marRp,3.0,18,4,AGCTCCCTGGACAAAAAGTC,14,2219274
marRp,2.0,13,4,AGCTATCTGGAAGGCTAGCT,9,2253753
marRp,3.6,21,4,AGCGTACGCCTGTGTCATAG,17,2235107
marRp,3.8,22,4,AGCCGGAAAGGAAAGAGTCC,18,2244616
marRp,1.8,12,4,AGCCCTAGGGCGTGCCTTCC,8,2223528
marRp,5.8,32,4,AGCAGGCTGTAGTACGATCA,28,2235152
marRp,0.4,5,4,AGAGTTTGACTAAAACCGGG,1,2258631
marRp,8.2,44,4,AGAGCGTACACCTCACAAGG,40,2248977
marRp,2.4,15,4,AGACTCCAGCGGCGAGATTT,11,2221350
marRp,0.4,5,4,AGACGATCAACGCGACGGAG,1,2233826
marRp,22.4,115,4,AGAAGCTGCGTAAAGGCTAA,111,2247582
marRp,0.8,7,4,AGAACGCTACTCCGCCCGAA,3,2226809
marRp,17.8,92,4,AGAAAATGAGAAATAGTTGT,88,2231168
marRp,12.4,65,4,ACTTATAATTGTGACCTGAT,61,2243295
marRp,0.8,7,4,ACTGGATACGGTATCTACGC,3,2222898
marRp,0.6,6,4,ACTATGGTAAGAAACAAGGA,2,2249507
marRp,2.6,16,4,ACGTATATGGGACTCTAGTG,12,2228212
marRp,6.2,34,4,ACGGGGTCGTGAAACTGCTT,30,2235973
marRp,0.4,5,4,ACGGGCTCCCAAAGAGAAGC,1,2260195
marRp,3.8,22,4,ACGGATGTTGGCTAATTGGA,18,2249186
marRp,0.4,5,4,ACGCGGAATCGATCGTAGAG,1,2229790
marRp,1.4,10,4,ACGCCCACTCCCCTAGCAAA,6,2254749
marRp,2.4,15,4,ACGACGAATTTAATGGGCAG,11,2243167
marRp,18.6,96,4,ACCTTATTGCTGGTTCGATG,92,2247457
marRp,0.4,5,4,ACCTTACTTCGAGCTGTACT,1,2217969
marRp,0.8,7,4,ACCTATCCGTCACGAGTCCC,3,2225677
marRp,2.4,15,4,ACCCCCCGCAACTTGAAGAC,11,2223649
marRp,2.6,16,4,ACCAGTGTACAGGTTCTCAG,12,2260287
marRp,0.8,7,4,ACCACCGACCTCCTACAGAT,3,2255819
marRp,3.8,22,4,ACCAAGGACTCCAGCAAGAC,18,2254905
marRp,2.2,14,4,ACCAAAATGGAGAGAGTGTT,10,2248380
marRp,108.6,546,4,ACATGGAAAAGCTCCAAGAT,542,2254097
marRp,222.2,1114,4,ACATCCTAAACCAGTGGTAT,1110,2224947
marRp,27.4,140,4,ACACTGCTTGTGGGACGCAT,136,2228081
marRp,9.2,49,4,ACACACTGCTAGGATATCAG,45,2220052
marRp,4.2,24,4,ACAATGGCGAACCCTTAAAA,20,2220940
marRp,3.4,20,4,ACAACAGCCGCACGTCTCCT,16,2233454
marRp,5.2,29,4,ACAAATGCTCCAGTTACCAT,25,2252905
marRp,4.6,26,4,AATGTGTTGCTTGAAACGGA,22,2225419
marRp,1.0,8,4,AATGGTATCTGTCGTCACCA,4,2238772
marRp,2.2,14,4,AATGGGTGGTTAAGTTGCTT,10,2230141
marRp,17.0,88,4,AATGGCGGGGACACGAAGTA,84,2259731
marRp,0.4,5,4,AATGATACCTCGCGTGCTTG,1,2236934
marRp,0.6,6,4,AATCTATCAAATGCCCCTCT,2,2247073
marRp,3.8,22,4,AATCGTTGCTGAAGTGGCGG,18,2244848
marRp,3.6,21,4,AATCGCCGTGTGATAGTTCC,17,2253749
marRp,1.8,12,4,AATCAAGCAGCCAGGCAGTG,8,2247245
marRp,17.4,90,4,AATATCCGCAATCTAGATGT,86,2219050
marRp,1.4,10,4,AATAGTAAACACGTGAGAAG,6,2236847
marRp,0.8,7,4,AATAGGCATTCAGTATCAGA,3,2227654
marRp,1.6,11,4,AAGTTATATGGGGCAAGGTG,7,2255208
marRp,7.8,42,4,AAGTGCGGGGTATACGGATG,38,2221698
marRp,15.8,82,4,AAGTACGCAAACATTCAAGA,78,2237560
marRp,2.2,14,4,AAGGTAAGGCTTCCCCTAGA,10,2223716
marRp,28.0,143,4,AAGGGGTAGATAGTTTGTTG,139,2228236
marRp,5.0,28,4,AAGGATAGTGCGCCCTTACA,24,2220309
marRp,3.0,18,4,AAGCGGCCTCCATTATCAGT,14,2232487
marRp,2.0,13,4,AAGACGAGAATGCACTTACA,9,2218072
marRp,0.6,6,4,AAGAACGGCTTGCCCAGAAC,2,2248126
marRp,1.8,12,4,AACTGGGGCTCGATCACCAT,8,2244755
marRp,8.0,43,4,AACGTTTAGGCGAGCCACAT,39,2233382
marRp,4.8,27,4,AACGTAACTAGACGTGCACC,23,2230840
marRp,2.4,15,4,AACCAGACCTAACTCTCTAA,11,2218022
marRp,9.6,51,4,AACACGCAAGATAAGGGGCT,47,2226882
marRp,1.8,12,4,AAATTGCACTGTGCGCGGCC,8,2258749
marRp,3.2,19,4,AAATGATTGATAATTTTATA,15,2235857
marRp,2.6,16,4,AAATCCTAACCATTTCACGA,12,2235191
marRp,8.2,44,4,AAATAAGATGAAGACGGTTG,40,2229150
marRp,3.8,22,4,AAACCTGTATGGTTAATCCG,18,2253171
marRp,1.2,9,4,AAACAGTTAACAGTGAGACT,5,2218894
marRp,15.6,81,4,AAACAGGACGACCGCGATCG,77,2231173
marRp,3.5,16,3,TTTTCAGCAAAAACTGCCCT,13,2242440
marRp,3.5,16,3,TTTTAGGGGTTATGATGGAG,13,2249551
marRp,1.75,9,3,TTTCGTCCATGGGGAACTTC,6,2252925
marRp,3.75,17,3,TTTCGCTAACTTGTCTTTTC,14,2253251
marRp,7.25,31,3,TTTCGATCTCTGGGGTAAAA,28,2236643
marRp,3.0,14,3,TTTCGACCCTGATGTGACGT,11,2218392
marRp,20.25,83,3,TTTCCCTATCACAGCGCGGA,80,2246879
marRp,3.25,15,3,TTTATACGCGTCTCTCCAGG,12,2256882
marRp,2.25,11,3,TTTAGTCAGAAAATGGTAGG,8,2244470
marRp,8.75,37,3,TTTAGAATTCTCCATTTTCG,34,2260305
marRp,1.0,6,3,TTTACTTGGATGGGAGGAAA,3,2235498
marRp,1.0,6,3,TTGTTATGCACGAGGACGCC,3,2230784
marRp,5.25,23,3,TTGTCTCCTCGGTTCAACTG,20,2238917
marRp,0.5,4,3,TTGTCGGTAGTTTATCGAAA,1,2234421
marRp,0.75,5,3,TTGTATTGAACATTACGTTT,2,2256694
marRp,4.5,20,3,TTGGGTAAGGTTCTTCTTTA,17,2234234
marRp,3.5,16,3,TTGGATTTAAGTTATAAAAA,13,2248107
marRp,2.0,10,3,TTGGAGCGGGAATATTGCCT,7,2226005
marRp,6.25,27,3,TTGGAGCACGCCCGGACGGC,24,2259340
marRp,3.5,16,3,TTGATTATACGCATCCCATT,13,2249829
marRp,0.75,5,3,TTGAGTCTACCACGTACTCA,2,2248310
marRp,3.75,17,3,TTGAACCACAGTCTCCTCAA,14,2252156
marRp,2.5,12,3,TTCTTACTCGGATAAGAAAA,9,2248504
marRp,3.0,14,3,TTCTAGATTAAGGGCGTGTA,11,2236336
marRp,0.75,5,3,TTCGTTTTATGCTCGCACGG,2,2237730
marRp,5.0,22,3,TTCGACTGCAATCTGTCTTA,19,2231556
marRp,4.0,18,3,TTCCTTCCGCAATGAAGCGC,15,2232046
marRp,2.5,12,3,TTCCGTCTTATTCCGTATCA,9,2227264
marRp,4.5,20,3,TTCCCCGGTGGGTGTCTGGG,17,2226196
marRp,13.75,57,3,TTCCAAGGCATCCAACCCTA,54,2224612
marRp,1.5,8,3,TTCATTCGAACCGGATCTCT,5,2235422
marRp,4.5,20,3,TTCAGACGTAATTAAACGTC,17,2222000
marRp,1.5,8,3,TTCACATTAACTCTCGTGTA,5,2235459
marRp,5.25,23,3,TTCACATGTCGAACGGGTGA,20,2227374
marRp,0.75,5,3,TTCAACGGGAATAGGGACTT,2,2218178
marRp,1.5,8,3,TTATTCGAGCGGCAAAGACT,5,2233827
marRp,0.5,4,3,TTATGCCAGAGTGAGTAGTC,1,2222323
marRp,7.5,32,3,TTAGCTCTAACGCGGAAGCT,29,2242538
marRp,0.75,5,3,TTACTAAGGCTCTTAGTTAT,2,2244756
marRp,2.5,12,3,TTACACGGAACATGCGCCAT,9,2237312
marRp,1.25,7,3,TTAAGCCGGGATCGAAGTTT,4,2239382
marRp,4.5,20,3,TTAAGATACCGGGACTCCTC,17,2236504
marRp,7.25,31,3,TTAACGTATTTCAGCTGCTC,28,2248249
marRp,4.75,21,3,TTAACGCAGGAAGTCTGTAT,18,2246145
marRp,4.75,21,3,TTAACAGCTAGGAGACCCAT,18,2240798
marRp,1.25,7,3,TGTTTTCATTAGCGTGAGTG,4,2239118
marRp,2.75,13,3,TGTTCACTTGTAAATGACGG,10,2230464
marRp,8.25,35,3,TGTTATGCGCCCACATGTCA,32,2260066
marRp,4.0,18,3,TGTGTGCAAGGCGGCATCTT,15,2229858
marRp,4.25,19,3,TGTGCGGCGTTATCCAATTT,16,2260793
marRp,4.75,21,3,TGTCGTTCGTGTAGGAACAA,18,2238506
marRp,0.5,4,3,TGTCCAGGTCTGGAATCGTG,1,2249860
marRp,1.0,6,3,TGTAGCCATACAGAGATGTC,3,2259162
marRp,3.25,15,3,TGTACTAAATGATTGGGAAA,12,2247007
marRp,4.25,19,3,TGGTGTAGCATTGCATCTAA,16,2259748
marRp,9.5,40,3,TGGTGGTCTCAAAAAAGTTA,37,2228275
marRp,1.0,6,3,TGGTGACGCTTAGAAGGGTT,3,2225597
marRp,4.25,19,3,TGGCTAACCATGGTATCCCT,16,2249890
marRp,0.5,4,3,TGGCCGTACTAACCGTCATG,1,2249395
marRp,5.75,25,3,TGGATTGAGGGAAATCACCC,22,2256544
marRp,7.25,31,3,TGCTCTGTCAATTACAAGCG,28,2244437
marRp,4.0,18,3,TGCTAGCCAGGTCCTAGAAA,15,2221220
marRp,6.0,26,3,TGCGGAATTGCGAGACATGA,23,2224052
marRp,2.5,12,3,TGCGCAGAGCTTGAATGGTC,9,2223011
marRp,11.25,47,3,TGCGACCCAAACGACGCGGC,44,2260051
marRp,1.0,6,3,TGCGAATGCGTTAATAGCGT,3,2244192
marRp,8.5,36,3,TGCCGGACGCAGAGGAGACG,33,2219922
marRp,8.0,34,3,TGCCGAAAGGTAAGCAGCTT,31,2227618
marRp,0.5,4,3,TGCACAAGGTTTCGTAAGTT,1,2245908
marRp,1.25,7,3,TGCAACTCTCGCTATAACCG,4,2252675
marRp,2.25,11,3,TGCAACCGGACCCCGGGGTA,8,2244900
marRp,4.0,18,3,TGATAATGGCAAAAACCGCC,15,2243819
marRp,1.5,8,3,TGAGGCGTATGGCATCAGTA,5,2255351
marRp,2.5,12,3,TGACCACCCACCTTGTGCGC,9,2251367
marRp,13.75,57,3,TGACAACCTAGGATCCCAAG,54,2227419
marRp,0.75,5,3,TGAATGGGGAACCACTTTCC,2,2239282
marRp,2.25,11,3,TGAAGCCACTCGTCGCACAT,8,2218786
marRp,5.5,24,3,TGAACGAGGCGCGCTATGCA,21,2227491
marRp,0.5,4,3,TGAACGAGCAGTGCCTGTTC,1,2255837
marRp,0.5,4,3,TCTATAGCTGTCATAGATAT,1,2234954
marRp,3.5,16,3,TCTAGAGCGGAACGAGGCTC,13,2230956
marRp,19.25,79,3,TCGTATCAGCTATGCACACT,76,2258703
marRp,2.75,13,3,TCGGTGCTGGGGCCTAGGTT,10,2219379
marRp,2.0,10,3,TCGGTCGGTTTCTAGATATC,7,2238693
marRp,5.25,23,3,TCGGGGCATCCTTGGGTTGA,20,2241686
marRp,0.5,4,3,TCGCAGGTGATTTGGGCAAC,1,2240643
marRp,1.0,6,3,TCGAGGTATCCTACCCCAAC,3,2253080
marRp,0.75,5,3,TCGAGACGCGAGAGCAAGCT,2,2225894
marRp,1.75,9,3,TCGACTGCAGCCAACGCCGG,6,2238431
marRp,2.5,12,3,TCCCCAGCGTGCAACCAGTG,9,2217946
marRp,1.25,7,3,TCCCAGCTTCTCCAGGATAA,4,2221285
marRp,3.0,14,3,TCCATTAAATCTATCACCGA,11,2226110
marRp,9.0,38,3,TCATTGCGTACCTACCGTGG,35,2257697
marRp,8.0,34,3,TCATTGACGTGGTAGATTCT,31,2231940
marRp,3.25,15,3,TCATGTAACAAGGCCGACAT,12,2230155
marRp,1.5,8,3,TCATCTCTATTGAGGAAGGT,5,2236079
marRp,23.25,95,3,TCATACCAACGCGACCCGTA,92,2227289
marRp,9.0,38,3,TCAGGCGTTTGGTATACACC,35,2240790
marRp,1.5,8,3,TCACATAAAGCCTTCCGCGG,5,2250705
marRp,0.75,5,3,TCAAGCGTTATGTAGAGAAA,2,2223546
marRp,3.0,14,3,TATTCAGAGCCGCCTCTATG,11,2242550
marRp,0.5,4,3,TATTATAGGTCGTCACCCAG,1,2253312
marRp,2.0,10,3,TATGTTCGCATTCGGTAGCA,7,2241823
marRp,0.5,4,3,TATGCCGTGCTAACAAATAT,1,2242333
marRp,1.75,9,3,TATCGTTCATTGATTTTTGG,6,2223842
marRp,0.5,4,3,TAGGCCCAAGTTACGCACAC,1,2251579
marRp,0.75,5,3,TAGGAGTTGTAGCCACCGCT,2,2218609
marRp,0.75,5,3,TAGCTTGTATGTGGGCGCCG,2,2229247
marRp,3.0,14,3,TAGCCGCAAATCTCCTACGA,11,2222971
marRp,0.5,4,3,TAGCAGTAACCAAGAACCAG,1,2260664
marRp,10.75,45,3,TAGCACCATCCGCATACATA,42,2240450
marRp,0.75,5,3,TAGATCGCAATCGGAGCAGC,2,2227541
marRp,3.25,15,3,TAGAATGTCATATTTATATC,12,2256781
marRp,8.25,35,3,TAGAACCTAAGTATATGCTA,32,2259064
marRp,1.0,6,3,TACTTTCAGCAGGGGCTTTT,3,2258664
marRp,3.5,16,3,TACTGTCAGAGTTGCCCCTA,13,2236402
marRp,17.0,70,3,TACGTCATCACGTTGCATCG,67,2240265
marRp,2.0,10,3,TACGAATCTTGCGGCCAGCC,7,2259454
marRp,0.75,5,3,TACCAGGGTAAGCATGTACG,2,2227646
marRp,2.25,11,3,TACATCCCGTGACACACAGT,8,2251559
marRp,0.5,4,3,TACAGAAATGTCGTGATGTC,1,2253676
marRp,7.25,31,3,TACAATAGACCAGGGGTACA,28,2260353
marRp,0.5,4,3,TAATTTCAAAGTAGCGGTCA,1,2254687
marRp,0.5,4,3,TAATACTCGAGAACGTAGGA,1,2222438
marRp,15.5,64,3,TAAGACTTGGGTGGTGATAT,61,2230369
marRp,1.25,7,3,TAACCTCGCCAGTACTGAGT,4,2221942
marRp,3.5,16,3,TAACCGATACATTACTCTGG,13,2247371
marRp,48.75,197,3,TAAACTCTGGTGGGATTACT,194,2246868
marRp,1.25,7,3,GTTTTTTGTCTTAGACTCCT,4,2251285
marRp,17.75,73,3,GTTTGGTGCGGTTTGGGTCA,70,2239330
marRp,5.0,22,3,GTTTCAGTATTTTGGGGCTT,19,2239542
marRp,4.75,21,3,GTTTAGTCTGATTGTGTAAC,18,2251335
marRp,4.75,21,3,GTTGCCCGGTACAGGCATTT,18,2229601
marRp,3.0,14,3,GTTCCGGTGACTCCCAGCTA,11,2252971
marRp,3.5,16,3,GTTCCGACTGAATCGCATCA,13,2231074
marRp,54.75,221,3,GTTAATGCTGTACTTTTTAG,218,2252952
marRp,3.25,15,3,GTTAAAGGTTTCCGTACAGT,12,2228165
marRp,1.5,8,3,GTTAAAGCATGGGTTGTTTA,5,2235211
marRp,12.25,51,3,GTGTCCCCATGGGAGAATGT,48,2233230
marRp,5.25,23,3,GTGGCCGCGATGCGTTCCCC,20,2227141
marRp,0.75,5,3,GTGGCAGACGGGGCCTTCGT,2,2243324
marRp,15.5,64,3,GTGGATGATTCGGTTCCGCG,61,2221877
marRp,7.0,30,3,GTGGAGAGCCCCCGAGCGGC,27,2235698
marRp,30.5,124,3,GTGCTCGGGTCACTAACAAA,121,2221540
marRp,6.25,27,3,GTGCGAATCAGATCCGTCTA,24,2259884
marRp,2.25,11,3,GTGCCCTAAGGTTGGTGGTA,8,2235304
marRp,15.75,65,3,GTGCAGATTACTTAACCACG,62,2227010
marRp,1.5,8,3,GTGCACTCCCGGCGGATCGG,5,2247251
marRp,10.5,44,3,GTCGGTTCGTCGATTTCGGT,41,2237647
marRp,3.0,14,3,GTCATCGTCTTACGGCACAA,11,2222525
marRp,5.25,23,3,GTCACACCGTGGTACAGGAA,20,2222927
marRp,6.25,27,3,GTATCCCCTAGGATGAGAAC,24,2258438
marRp,5.0,22,3,GTAGTTAACTGGTTTCGGTT,19,2242129
marRp,4.5,20,3,GTAGGGGTAGACGTAGCCCT,17,2238970
marRp,7.0,30,3,GTAGCGGACGGCGGCTTTCC,27,2238525
marRp,2.75,13,3,GTAGAAAGGACGTGGAACTA,10,2229107
marRp,0.75,5,3,GTAATAGCTACGCTGGTATG,2,2223375
marRp,0.5,4,3,GTAATAGAACAGGTCTCGCG,1,2243727
marRp,1.5,8,3,GTAAGTTAAGTGCGGCAAGG,5,2229854
marRp,2.0,10,3,GTAAATGCTACGAGACCCAC,7,2219705
marRp,0.5,4,3,GTAAATACGCGTGTCGATAC,1,2234915
marRp,2.5,12,3,GTAAACTTCAGATGCCGCCT,9,2235158
marRp,41.0,166,3,GGTTTTAGTGGATAGGAGAT,163,2257502
marRp,1.5,8,3,GGTTCTATGACGCAGTGAGG,5,2240312
marRp,2.25,11,3,GGTTAAGACCGGAATTCGCA,8,2242871
marRp,4.0,18,3,GGTGTCGCAGGATGAGGGAC,15,2234253
marRp,17.5,72,3,GGTGTCGATAGAGTTGTGAT,69,2228253
marRp,15.0,62,3,GGTCACTAATTCTAGCCGCC,59,2247396
marRp,0.5,4,3,GGTATAGCGGCTCAGTGTTG,1,2234189
marRp,1.0,6,3,GGTAGGATCCACGTCAGCGG,3,2244309
marRp,3.5,16,3,GGGTTAGAGTCTTGTGGATT,13,2231319
marRp,1.25,7,3,GGGTTACTGTTTTGGGGTTG,4,2244795
marRp,8.25,35,3,GGGTCGTTTAAATGTAATTG,32,2238574
marRp,27.0,110,3,GGGGATTGGCCAATGAGAGT,107,2260217
marRp,0.5,4,3,GGGCGGAGAAGCCCGGCACA,1,2244975
marRp,1.25,7,3,GGGCCTATGTTCCCACGTAA,4,2225888
marRp,2.25,11,3,GGGCCGATGTTGCACCAGTC,8,2224741
marRp,0.75,5,3,GGGCATCCATGGTTAATGAT,2,2240165
marRp,3.5,16,3,GGGACTTCGCCAATGGCACC,13,2240944
marRp,9.75,41,3,GGCTGATCATGGGGTGCCCG,38,2241411
marRp,3.0,14,3,GGCGCTGTTGGTTGGTGATT,11,2243139
marRp,0.5,4,3,GGCCTATTTGAGCCCAAGAA,1,2247069
marRp,1.5,8,3,GGCCGGGTCACCGCAAATGT,5,2222477
marRp,43.5,176,3,GGCCGCGTAGGGGAGCCTTA,173,2248979
marRp,3.25,15,3,GGCCAGTGATCGTCATGTAA,12,2223181
marRp,1.25,7,3,GGCATGCCCCAAGGTATCGC,4,2237155
marRp,5.75,25,3,GGCATCGTCCGATATCCCGT,22,2251514
marRp,5.25,23,3,GGATTCGATCTGTGTCAATG,20,2221803
marRp,0.75,5,3,GGATTACGTAGGATATCGTA,2,2223917
marRp,3.75,17,3,GGATCCGGATTCCCTCCAAA,14,2233597
marRp,0.5,4,3,GGAGCTTTTAGTTGGACCCC,1,2237701
marRp,1.0,6,3,GGACGGGCAGGAGCCATGCA,3,2234906
marRp,5.0,22,3,GGACACTACCGATCCATCAC,19,2237533
marRp,9.0,38,3,GGACACCGACACATCGAGCA,35,2247290
marRp,0.75,5,3,GGAACTTGTGGGACTACGGG,2,2218188
marRp,6.5,28,3,GGAAAGGAGTAGACACTTGT,25,2223664
marRp,9.25,39,3,GCTTTGCCCGGCCGGATATC,36,2252912
marRp,3.5,16,3,GCTTGTATAGGTGGTGATTA,13,2218216
marRp,2.5,12,3,GCTTCAGAACTCACTGCTCA,9,2237767
marRp,13.5,56,3,GCTTCACAAATGCATGTTCT,53,2227307
marRp,0.5,4,3,GCTGTATTTATTGCCAGGGA,1,2254007
marRp,2.0,10,3,GCTGGAGCGAGTTCCCGCTA,7,2259760
marRp,8.75,37,3,GCTGGACGTTCGGGTCGCAT,34,2244566
marRp,1.25,7,3,GCTGCTGTACTGCTCCCGGT,4,2248734
marRp,10.25,43,3,GCTGCTGGAATTTGGTTAAT,40,2257475
marRp,1.5,8,3,GCTGCGGCGTGGGTGGCGTT,5,2251361
marRp,4.0,18,3,GCTCGAGATAAGGACATTTC,15,2227976
marRp,0.75,5,3,GCTCCTTGGTTCCCCTTCAT,2,2260778
marRp,3.25,15,3,GCTAGACCATCGAGCATTGG,12,2235199
marRp,2.75,13,3,GCTAATGCCTCGATCTTTTG,10,2237504
marRp,1.0,6,3,GCGTTGTACGGTCCACGTGT,3,2226725
marRp,12.0,50,3,GCGTGCAAGACCGACGACCC,47,2228244
marRp,14.75,61,3,GCGGGCGGTTCAATGTACTC,58,2247110
marRp,8.0,34,3,GCGCAGATTAACTGGGCAAA,31,2225509
marRp,4.0,18,3,GCGCAGATAAAATCATCCCT,15,2238168
marRp,2.75,13,3,GCCTGCCGAACGCTTGTTCC,10,2226780
marRp,1.0,6,3,GCCGTTTTCGCGGCTAAACG,3,2256309
marRp,1.0,6,3,GCCCCAGGCATATAAGGACA,3,2258683
marRp,2.25,11,3,GCCATACCTGGATTTTCGCT,8,2243793
marRp,40.5,164,3,GCCACGATTAGGGAATTAGA,161,2219038
marRp,5.0,22,3,GCATACGTTCATAAGTAGAT,19,2225382
marRp,0.75,5,3,GCAGCTACACCGTCTGGTGC,2,2238895
marRp,0.5,4,3,GCAGAGCAGAGCTACATTCT,1,2230411
marRp,4.25,19,3,GCACTACCTACCAGAGCCAA,16,2235978
marRp,0.75,5,3,GCACGCGGAAACCTAGGCGC,2,2234136
marRp,7.75,33,3,GCACATCGAGGTATGGAACA,30,2225373
marRp,0.75,5,3,GCAAGGGGGTGTTGAGCAAC,2,2251479
marRp,1.25,7,3,GCAAAGCGGACTCGTTGGGA,4,2246753
marRp,34.0,138,3,GATTGATGTAATAGTCTGTA,135,2256367
marRp,0.5,4,3,GATTCCCTTTTGTCAAGTCA,1,2254497
marRp,0.5,4,3,GATTATGCTATTCTCGTATG,1,2251184
marRp,4.25,19,3,GATGATAGGCCTAGTGTGAG,16,2242780
marRp,5.75,25,3,GATCTGTAGCTGTTTTATCG,22,2238053
marRp,1.0,6,3,GATCGCCGACGTACAGAAGC,3,2224277
marRp,1.25,7,3,GATCGACGCTTCCTCGACTT,4,2231895
marRp,40.75,165,3,GATCCTACAACTCGTGCGGT,162,2250397
marRp,5.0,22,3,GATCCGTCACCTTATCAGCT,19,2234799
marRp,27.5,112,3,GATCATATCCGGACCTGGGA,109,2220747
marRp,1.25,7,3,GATCAGGCCGGTGGGTACCC,4,2219268
marRp,1.75,9,3,GATAAAGGTCAGGGAGGCAG,6,2225063
marRp,6.5,28,3,GATAAAGAAGTGCGAAGCTT,25,2236051
marRp,1.75,9,3,GAGTTCCAAAAAAGGGCTAA,6,2217886
marRp,2.0,10,3,GAGTGCCTCTCTGCGGTTAC,7,2248716
marRp,0.5,4,3,GAGGGGGAGATGGGGTTCAT,1,2242084
marRp,1.5,8,3,GAGCAAAGGGTCGGATACCT,5,2239041
marRp,15.5,64,3,GAGATCAAACTCATAGGACA,61,2251075
marRp,12.75,53,3,GACGCGCGGGCGGACTAATT,50,2222849
marRp,3.5,16,3,GACCTCGCCCATGAGATCGC,13,2255578
marRp,1.0,6,3,GACCGGAAGGACGATTTAAC,3,2243702
marRp,0.75,5,3,GACCCTGACCAATTTCGGCG,2,2257405
marRp,0.5,4,3,GACCCGCGTAAGTGTGTCTT,1,2251762
marRp,12.25,51,3,GACATCATCTTGCTGCATGT,48,2259077
marRp,2.25,11,3,GACACAAATAAGCAAGCACT,8,2221682
marRp,4.25,19,3,GACAATGGGGTGGGTACCTA,16,2225683
marRp,5.5,24,3,GAAGTTTACTGCCGCGAGCG,21,2236249
marRp,2.5,12,3,GAACGTATTACCCCGGCCTA,9,2249800
marRp,10.0,42,3,GAACACGCAAAACACCTCGG,39,2257001
marRp,3.75,17,3,GAAAGTAGGTATTCGTGCCA,14,2250478
marRp,5.25,23,3,GAAAGAAGACGGGCAGTTTC,20,2222888
marRp,3.0,14,3,GAAACGTGCAAGACTATCGC,11,2253546
marRp,4.5,20,3,GAAAACCATTATCTGATCGA,17,2244409
marRp,2.75,13,3,CTTTCTTTAGGATCTAATAT,10,2255684
marRp,2.5,12,3,CTTTCTGGATGAACTTGCAA,9,2241224
marRp,2.5,12,3,CTTTATGGCCATTCCACCTA,9,2245604
marRp,1.25,7,3,CTTGCCACAACGTGCCGCAT,4,2250732
marRp,0.5,4,3,CTTCTGCGTCATTTGGACGT,1,2230279
marRp,0.5,4,3,CTTCGAGTAGGTTCCTTTTG,1,2240242
marRp,1.25,7,3,CTTCCGGGCTTATATCAATA,4,2234654
marRp,3.0,14,3,CTTCCCGGATGACGAGGGCT,11,2218599
marRp,2.25,11,3,CTGTGTCGCTTCGTCCTTTC,8,2233303
marRp,0.5,4,3,CTGTACGAGAAGCTACACCT,1,2236730
marRp,6.25,27,3,CTGGGCACTGGACGCGGGAG,24,2226525
marRp,4.25,19,3,CTGGCTCGTAAGGCGGCTCA,16,2239359
marRp,3.75,17,3,CTGGAACAGAGACGATAGTG,14,2241803
marRp,1.25,7,3,CTGACATTCTGACGCGCTAG,4,2239557
marRp,2.0,10,3,CTCTTCATTCAGAAAAGGAA,7,2232224
marRp,8.75,37,3,CTCGAGGTGCCGGGAACGCT,34,2246804
marRp,12.75,53,3,CTCCGGGGGCGACGGTGCTA,50,2237370
marRp,2.0,10,3,CTCCCGTCGCCGGTATCTTA,7,2246344
marRp,0.75,5,3,CTCCCAGTAATAGGAATCGG,2,2244214
marRp,16.25,67,3,CTCATTCCAATAGAGGGGGC,64,2226486
marRp,2.0,10,3,CTCAATGAGGAGCGCCATTC,7,2245662
marRp,2.75,13,3,CTATAGTTGAACTACGACTT,10,2225474
marRp,0.75,5,3,CTATAGTGTGCCCAAGCTTT,2,2246074
marRp,33.5,136,3,CTATACCAAGCATGTGCCCA,133,2221874
marRp,15.0,62,3,CTAGTCAGCGAGGGACACCA,59,2245431
marRp,2.0,10,3,CTAGTAATATTAGAAATCCG,7,2236267
marRp,1.25,7,3,CTAGACATCTAACACCTGAG,4,2259922
marRp,1.25,7,3,CTACGGTACCGGGTTATACA,4,2257667
marRp,2.0,10,3,CTAAGTCTCGAGTTGGTCTG,7,2249634
marRp,9.75,41,3,CTAAGTCATCGTCATAAATC,38,2218405
marRp,0.5,4,3,CTAAGCGTCGTATGGATGGA,1,2242285
marRp,1.25,7,3,CTAACCAGAAATGGGCTCAT,4,2251665
marRp,2.75,13,3,CTAAAAGTATTTGATTCCAT,10,2259160
marRp,1.5,8,3,CGTTTGATGGGTGCATCTAA,5,2241127
marRp,11.75,49,3,CGTTAAGGCACTAGGACATT,46,2241087
marRp,5.0,22,3,CGTGCGCGATGTACTTACGC,19,2228773
marRp,2.75,13,3,CGTGCATATATGTCCGGAGA,10,2218329
marRp,2.0,10,3,CGTGAGGGCTTATCCTAGTA,7,2220199
marRp,1.0,6,3,CGTCTGACAACTATGGATGA,3,2228757
marRp,2.0,10,3,CGTCCTAAATGTTGTTCAGC,7,2245682
marRp,1.75,9,3,CGTCACCTTAGCTATATGCT,6,2228134
marRp,3.0,14,3,CGTATGTCAGTCCTTTGGCA,11,2222900
marRp,0.5,4,3,CGTATGAATGCCGTCCGGAT,1,2234000
marRp,0.5,4,3,CGTAACTAAACTATGTGCCG,1,2259067
marRp,0.5,4,3,CGGTTTTCCTCGAGGTACAG,1,2225410
marRp,3.5,16,3,CGGTCTCTTAGCGCTACGAT,13,2224327
marRp,4.0,18,3,CGGTACTCAGGCGCAGGCTA,15,2243962
marRp,11.5,48,3,CGGGTTCACATGGGAGTTCG,45,2241780
marRp,1.25,7,3,CGGGCCGCTTTTTCCCACGA,4,2232485
marRp,1.75,9,3,CGGCGTTTGTCGTCTGAGCC,6,2239796
marRp,3.0,14,3,CGGCATCCGGTTTAAGAGGT,11,2246813
marRp,6.25,27,3,CGGCAGCTAGTTACATAGGC,24,2251226
marRp,3.25,15,3,CGGACTTATCTACGTCTTCA,12,2239113
marRp,6.5,28,3,CGGACAGCACGGGAGCGATT,25,2244561
marRp,15.0,62,3,CGCTGAATTTGCCATGTAAT,59,2219086
marRp,6.5,28,3,CGCGATGCATGGGCTTGTAG,25,2226356
marRp,0.5,4,3,CGCCTGAATTGACAGTGAAC,1,2229756
marRp,20.0,82,3,CGCCGGATGTTCATTGTAAC,79,2220501
marRp,4.0,18,3,CGCCCAGGGCCGGCGTCCAA,15,2237581
marRp,1.0,6,3,CGCAGGCGCAGGTCCGTTCA,3,2245074
marRp,1.25,7,3,CGATGGATTAGAAGCCGCCT,4,2250331
marRp,1.0,6,3,CGAGTCAACCAGTATGACAA,3,2230906
marRp,3.25,15,3,CGAGATATGTGATGTGCAAC,12,2226065
marRp,0.75,5,3,CGACTCGGAGCGTGCCAACA,2,2220334
marRp,0.5,4,3,CGACCTAAGGCTCCCGGGTG,1,2233802
marRp,6.0,26,3,CGACCACAACGCCGGTCGTT,23,2231196
marRp,2.75,13,3,CGAAGTGTTTAAGCGCCCGA,10,2255160
marRp,2.0,10,3,CGAAGTGGTCAGGCACCCAT,7,2251737
marRp,6.0,26,3,CGAAGGATAGCCAGAGGGCA,23,2224417
marRp,0.5,4,3,CGAACGGGTTCCTTTTCTAG,1,2239052
marRp,1.25,7,3,CGAACCTAGGTGCACTTCAC,4,2260093
marRp,38.75,157,3,CCTGTGGCCCCAGCTGGCTT,154,2223668
marRp,14.5,60,3,CCTGTATCCTCCCGGGCCTT,57,2228976
marRp,1.0,6,3,CCTGAGATTATCGCTCTGGA,3,2256639
marRp,2.75,13,3,CCTGACTGAATTTTGAATGG,10,2229722
marRp,0.5,4,3,CCTGACTACCAAACCTCCTT,1,2234280
marRp,2.25,11,3,CCTGAACCATTCGCCTCTCT,8,2234820
marRp,5.25,23,3,CCTCTCGCAATTGCGATGCG,20,2236735
marRp,4.75,21,3,CCTCCGCATTGCCAGAAGTG,18,2242992
marRp,1.25,7,3,CCTATCACAAACCGAGTTTG,4,2225720
marRp,5.0,22,3,CCTACTCATTATCTACATAC,19,2252950
marRp,11.0,46,3,CCGTGATGATTCTCGTTAGC,43,2248089
marRp,1.25,7,3,CCGTAAATGAGTGGGCTAGT,4,2222697
marRp,1.0,6,3,CCGGTCCACCCCATGGTTGA,3,2242319
marRp,4.0,18,3,CCGGAAATCGATATTACAGC,15,2260943
marRp,2.5,12,3,CCGCTTCTCGTTTAGGTTCC,9,2228210
marRp,2.0,10,3,CCGCGCGGACCGAGCACCGC,7,2227933
marRp,4.75,21,3,CCGCCGTACCGGAGAGTGAT,18,2259515
marRp,0.75,5,3,CCGAGCAGGTCTATTGTCAA,2,2225568
marRp,1.75,9,3,CCCTCATAACGTGCAACGTA,6,2242658
marRp,3.0,14,3,CCCGGCTCAACCAGTGATTG,11,2227978
marRp,5.5,24,3,CCCGCTCGATTACGACATTG,21,2232404
marRp,2.25,11,3,CCCCGGGCAATTCCAACGTG,8,2230737
marRp,1.5,8,3,CCCCCGATCGTGTCCTACGA,5,2233127
marRp,1.25,7,3,CCCAAGCTTTAACGTTATCG,4,2232863
marRp,7.0,30,3,CCATTTCACGTAGAACTCAG,27,2217782
marRp,0.75,5,3,CCATGGTTGTCCATCATGAC,2,2233868
marRp,13.0,54,3,CCATGAGATCCAATTGAAAA,51,2256426
marRp,1.0,6,3,CCAGTAGGCGCAAGTGAGTA,3,2220182
marRp,2.75,13,3,CCAGCGGAACAAAATATTGG,10,2248119
marRp,23.75,97,3,CCACTGTACGCCAATCGGGT,94,2231778
marRp,0.5,4,3,CCACAAGCTCGATAACGGTC,1,2242208
marRp,1.0,6,3,CCAATCCACTCTGGGACCAA,3,2250273
marRp,5.5,24,3,CCAACCGACCAAACTATAGT,21,2231184
marRp,2.25,11,3,CCAAACGCGGGGCGACTTCC,8,2236558
marRp,23.25,95,3,CATGGTTTACTCATCTAGGT,92,2226830
marRp,1.25,7,3,CATGCAGGGCAACCCGCAGT,4,2235296
marRp,4.75,21,3,CATCTTTCTTGGCCACGCAA,18,2250814
marRp,0.5,4,3,CATCTGATGGAAATAATTTT,1,2228750
marRp,28.75,117,3,CATCCCGGTAAACTAACCGG,114,2227846
marRp,14.75,61,3,CATCACGTAGCATTATTGAC,58,2250409
marRp,2.5,12,3,CATACTTTCCGCTCGTAGAC,9,2260371
marRp,5.75,25,3,CATACGAACACCGTGAGTTG,22,2248221
marRp,6.0,26,3,CATACAACTGGGGGAGAGGT,23,2254881
marRp,0.75,5,3,CATAAGGTCATACCCCAGTA,2,2259605
marRp,3.25,15,3,CAGGGGCTCCCCCGTTAAGA,12,2226207
marRp,2.0,10,3,CAGGCGGGGTTCTACTTCTT,7,2249408
marRp,0.5,4,3,CAGGATAATATATGTCAAAA,1,2238778
marRp,5.0,22,3,CAGCCCGTACGAAGCCTAAT,19,2256569
marRp,3.0,14,3,CAGAGTTACGACGCACGTTA,11,2242547
marRp,11.25,47,3,CACTTTGTGACCAGGTAGTC,44,2228523
marRp,13.0,54,3,CACTCTGGGTAAGGCAAGCT,51,2241441
marRp,1.25,7,3,CACGTTCATAGCGTGGGCGC,4,2250805
marRp,0.5,4,3,CACGTGATCGGTAATCGGGT,1,2233931
marRp,5.25,23,3,CACGTCGAAAAATGGCGGGG,20,2240531
marRp,4.75,21,3,CACGTAAGCTGTAAGCGAGA,18,2245981
marRp,3.5,16,3,CACCTGATAAGCTGTGGCAA,13,2243182
marRp,4.0,18,3,CACCGTTAATCTGCGGAACT,15,2259802
marRp,17.75,73,3,CACCGGTGGAGAGAGCCTCT,70,2234346
marRp,1.25,7,3,CACATACTTTGCGTTTTACT,4,2242078
marRp,2.0,10,3,CAATCGGTCAGTCCATCCCG,7,2248122
marRp,1.0,6,3,CAATCAAAGCTTTAAACCAA,3,2229246
marRp,2.75,13,3,CAATACCCAACGCGGGGAAG,10,2232572
marRp,1.25,7,3,CAAGTTTATGTAACAAAATA,4,2246990
marRp,16.25,67,3,CAACACTCCCGAGATCTACT,64,2256488
marRp,20.25,83,3,CAACAATCCGCGTACAGTAT,80,2235687
marRp,35.0,142,3,CAAATCGTGGGCAAGACGGG,139,2221867
marRp,39.75,161,3,ATTTGTCCTAGTGAGAAAGT,158,2232176
marRp,5.0,22,3,ATTGGTTGTCAGGGTCAGAT,19,2247581
marRp,2.25,11,3,ATTGGGTGCCGGGGGGATGT,8,2233450
marRp,47.5,192,3,ATTGCCTCACATCGGATTGA,189,2253976
marRp,2.75,13,3,ATTCATTCCGCTACTCCCTC,10,2242781
marRp,1.25,7,3,ATTATTTACATTGCGATTTC,4,2225717
marRp,0.75,5,3,ATTACATATGAGCACTTTCT,2,2250470
marRp,7.0,30,3,ATGTGAGGACCCTCCGAATT,27,2253512
marRp,6.5,28,3,ATGGCAAAAGACATGTGTGA,25,2219728
marRp,6.5,28,3,ATGGACTCACTCCTTCTACG,25,2231872
marRp,3.25,15,3,ATGGAATGACCCACGATATG,12,2223025
marRp,1.5,8,3,ATGCTCGGTACGCCTGCAAG,5,2233470
marRp,1.25,7,3,ATGCTCATAACAAAGTAAAG,4,2222384
marRp,10.25,43,3,ATGCGCGTTAGGCAATTCTA,40,2223269
marRp,9.0,38,3,ATGCGCGCTGTCTGTCAGGC,35,2237385
marRp,0.75,5,3,ATGCCAGCATCTCATTGACC,2,2258284
marRp,0.5,4,3,ATGACAGCAATGTGCCAGTC,1,2220582
marRp,3.5,16,3,ATCTCCTGTACCCTTGAATT,13,2254764
marRp,1.0,6,3,ATCTCACGCGTATTCGCTCG,3,2246745
marRp,8.25,35,3,ATCTCAATACGCTACCTGTG,32,2243036
marRp,1.5,8,3,ATCGGTCACACTGGATAAGA,5,2260282
marRp,1.5,8,3,ATCGGCTTAGGCACTTATTG,5,2259858
marRp,2.25,11,3,ATCGCATTTTGACGTTTGCT,8,2248190
marRp,39.0,158,3,ATCGAGGTTCTCTTGGTGAT,155,2251063
marRp,18.25,75,3,ATCCGGAGCAAGGATGTTCC,72,2244564
marRp,0.75,5,3,ATCCCTTCCAACTTTACCTA,2,2228080
marRp,2.25,11,3,ATCCCTGGTTTTATGGCGTA,8,2254114
marRp,0.75,5,3,ATCCCCGTGTTTACTCGCCC,2,2238679
marRp,10.0,42,3,ATCCATATTATCGATTGGGG,39,2240973
marRp,2.75,13,3,ATCCAACAGGTATGGCCCGT,10,2247255
marRp,1.25,7,3,ATCAGGTCCGGGACTGGGCG,4,2224503
marRp,0.5,4,3,ATATTGACCCGGTAAAACTA,1,2249294
marRp,23.5,96,3,ATATGCCCTCTCGATTGAGA,93,2223265
marRp,1.5,8,3,ATATGAGCTATTACCGTTTA,5,2217874
marRp,0.75,5,3,ATATCTGCCCAACCAGGTTG,2,2245766
marRp,8.5,36,3,ATAGGGCGTGATGTTGCTGA,33,2222342
marRp,1.5,8,3,ATAGAGGTTATCATTAGCAG,5,2243956
marRp,2.5,12,3,ATACCGAAAATCAAGTTATG,9,2232854
marRp,3.5,16,3,ATACCCAGCTCGTAGCTAAC,13,2218785
marRp,3.5,16,3,ATACCCAACACGAGATGTTG,13,2234368
marRp,1.0,6,3,ATAAGTTAGCAACGGTTGCT,3,2242965
marRp,3.75,17,3,ATAACGATCCTAGGCCCCTC,14,2260358
marRp,0.75,5,3,AGTTTTAGTAAAACTGAAGA,2,2226261
marRp,1.75,9,3,AGTTGAGCGGGTGATCAGAG,6,2229330
marRp,13.5,56,3,AGTTCATCACGTTGGAAGAT,53,2236833
marRp,1.75,9,3,AGTGGGAGTAAGGGAACCCT,6,2227486
marRp,8.75,37,3,AGTGCGGCAAACGCAATGCA,34,2259404
marRp,4.0,18,3,AGTGCATACTGGTATAGGTT,15,2256128
marRp,3.75,17,3,AGTGAGCGCCGCAGCATCAC,14,2253794
marRp,4.5,20,3,AGTCGAAAGTCAGGGCTGCG,17,2228084
marRp,2.0,10,3,AGTACAGTGCAGATGGTATC,7,2231094
marRp,6.5,28,3,AGTAAGAAGCATCAAATCGA,25,2254890
marRp,1.0,6,3,AGGTCGCACTTGGAGCGTCC,3,2258200
marRp,5.0,22,3,AGGGGTATACCTCGCTCCAA,19,2232539
marRp,2.75,13,3,AGGGGTACCATAGGGCTACT,10,2239026
marRp,4.25,19,3,AGGCTGGCCTCGTTCTCTAA,16,2239833
marRp,1.5,8,3,AGGCTCTCAGTGTGAACCGA,5,2247504
marRp,1.0,6,3,AGGCGTCCCGCGCCTGAATG,3,2232287
marRp,7.5,32,3,AGGCGGGACGGCAGGGTCCT,29,2247392
marRp,1.0,6,3,AGGCGCGCAGGCAAGAACTA,3,2241557
marRp,0.75,5,3,AGGCAGACTGCGAGGGTTAA,2,2243105
marRp,1.0,6,3,AGGCAATATTGGTGCTCGAA,3,2238622
marRp,2.5,12,3,AGGAGAGGGTCCTACGATGG,9,2254003
marRp,2.0,10,3,AGGACAGAAGCATCCCTGAG,7,2228383
marRp,1.75,9,3,AGCTTATGCATCTGGCAGTC,6,2230323
marRp,4.75,21,3,AGCGTTTCCGTCATTAGAAG,18,2239534
marRp,0.5,4,3,AGCGCCTGCTTCAAGAGCGT,1,2233480
marRp,6.25,27,3,AGCGCCACTGACGATCGAAC,24,2257263
marRp,5.75,25,3,AGCCCGTGACAATCATGTAT,22,2258662
marRp,11.5,48,3,AGCAGCTTTCTTTTTTCTGA,45,2223287
marRp,9.75,41,3,AGATGACTTTGTGTGGACAG,38,2256849
marRp,16.0,66,3,AGAGTGCTCGCTCTCCGCCG,63,2226823
marRp,1.25,7,3,AGAGTATACGTCCTTCATCT,4,2227231
marRp,1.0,6,3,AGAGGGCTACAATTATGTCC,3,2257567
marRp,7.5,32,3,AGAGGGCCACCTCATCGCAT,29,2259500
marRp,0.75,5,3,AGAGGGAGGCGAGAAACCGT,2,2256500
marRp,2.5,12,3,AGAGGACGTTTTATAACAAC,9,2235743
marRp,5.0,22,3,AGAGCGTCATCGAGGATCTA,19,2253498
marRp,1.5,8,3,AGAGAATCTGTCCTGAGTGT,5,2254065
marRp,1.25,7,3,AGACCTTCGAGCTCGATTAA,4,2255323
marRp,9.5,40,3,AGACCATGGCTGCTGCACGG,37,2238020
marRp,2.75,13,3,AGACAAATGCATGGAGTGAT,10,2255071
marRp,2.75,13,3,AGAAGGCGAGAAGATAATTA,10,2219831
marRp,4.0,18,3,AGAAAAGTCTCCATCCCGTG,15,2240834
marRp,0.75,5,3,ACTTGGCTGATCTTGCTTGT,2,2243964
marRp,9.75,41,3,ACTTCCGATGATCTAGCAAG,38,2218331
marRp,3.75,17,3,ACTTCAAGGGACGCCAGGGC,14,2247989
marRp,4.5,20,3,ACTGCTACCGGCGCGGAATT,17,2222494
marRp,2.5,12,3,ACTGATGCTTCAACCCTCGC,9,2253039
marRp,0.75,5,3,ACTCCCCGGGTAGAAGGTGA,2,2237520
marRp,4.5,20,3,ACTCCCACTTAAGCTGCGCG,17,2257527
marRp,13.25,55,3,ACTCATAACCTTATCAGAGC,52,2222961
marRp,1.25,7,3,ACTATGTTTACAAGAATATA,4,2241707
marRp,7.0,30,3,ACTACCAGTCACTTTACTAT,27,2238465
marRp,1.5,8,3,ACGTTTTAGCCCAGCGTGGG,5,2230337
marRp,4.0,18,3,ACGTCCAGGGTCTCATCGGA,15,2228204
marRp,1.5,8,3,ACGTATTCGGTCGGCTGACA,5,2243529
marRp,0.5,4,3,ACGGCGAATGAACGGGCGGT,1,2237082
marRp,2.25,11,3,ACGCGAAGCATTCTCGGAGT,8,2246293
marRp,5.5,24,3,ACGCCGGTGCCCGGGGAGTT,21,2229605
marRp,39.0,158,3,ACGCCCTCACGTACAAGTAA,155,2247592
marRp,4.75,21,3,ACGCAGCTAGAACTTGACAA,18,2229100
marRp,0.5,4,3,ACGAGGGTAGAAACCGCGAT,1,2243279
marRp,2.25,11,3,ACGAGACACGGCCGGTGGTT,8,2232840
marRp,3.25,15,3,ACCTGTCTATAATCCGGAGG,12,2257729
marRp,2.5,12,3,ACCTCTTCAGACAGGGAACT,9,2249499
marRp,1.75,9,3,ACCGGGGATCGGGAGTACCA,6,2246103
marRp,5.25,23,3,ACCGCCTGAAGTGGGCTGCT,20,2246028
marRp,3.25,15,3,ACCCACTAGGAACGGCGCTG,12,2226999
marRp,1.5,8,3,ACCACTCGGGCGACCGACAC,5,2224185
marRp,0.75,5,3,ACCACGTAGAATATAGATGT,2,2248773
marRp,0.5,4,3,ACCACGACCGAGCCCTTTAG,1,2246598
marRp,0.5,4,3,ACCACAGCTCTTCCACCGGA,1,2230712
marRp,5.75,25,3,ACCAACGTCCATACCGACCC,22,2252898
marRp,5.5,24,3,ACATTTGCGTTATGTCTGTC,21,2242317
marRp,3.5,16,3,ACAGTGCGCTGGGGACTGCA,13,2257087
marRp,12.0,50,3,ACAGTAGGTGTATCCGGGCG,47,2251261
marRp,3.25,15,3,ACAGCGGCTGTACGAGCTAA,12,2248419
marRp,2.25,11,3,ACAAGTGTTAGATGAAATCA,8,2245711
marRp,34.25,139,3,ACAAGCACCCGAACAAAATA,136,2221543
marRp,1.25,7,3,ACAAGATCACCTCGCGTAAA,4,2228876
marRp,2.0,10,3,ACAAGAGGGAGCCCAGCAGT,7,2225136
marRp,6.25,27,3,ACAAAGCCAGGGACTAATGT,24,2233191
marRp,4.0,18,3,AATTTTAGAAACAAGGCACA,15,2243833
marRp,0.75,5,3,AATTTCACAGCTATTGAGCG,2,2228348
marRp,1.0,6,3,AATTCTCGGTCTTCCTCCTG,3,2240524
marRp,0.75,5,3,AATTCAATCTTGTGGGGTAC,2,2252812
marRp,3.75,17,3,AATTACAGCATAGTCCAACC,14,2229079
marRp,5.5,24,3,AATGTATGACATACGTTGCT,21,2229093
marRp,0.75,5,3,AATACGCTGGATTTCACCAC,2,2232756
marRp,0.75,5,3,AATACCAGACGTCTATACCG,2,2244308
marRp,2.0,10,3,AAGTTCAAAGATCGTCCTTA,7,2239018
marRp,1.0,6,3,AAGTCATGTCCAAGAGCAAG,3,2220917
marRp,0.5,4,3,AAGTATGTGCCTGGGCAGTT,1,2221630
marRp,1.25,7,3,AAGTACACTCTAATTGGCAG,4,2229124
marRp,1.5,8,3,AAGGGAGACGGTGATGCACA,5,2239739
marRp,1.75,9,3,AAGCGTTAACGATACTTGGT,6,2251547
marRp,3.25,15,3,AAGCGGGCATTACTCCCGTT,12,2225877
marRp,5.0,22,3,AAGCGGACCGGTAAGTCAAT,19,2227960
marRp,10.0,42,3,AAGCAGTCACACGTGTTCCC,39,2221268
marRp,7.0,30,3,AAGATGGTGGTGCCTTCTAC,27,2248353
marRp,6.75,29,3,AAGACGCCCACTTGTTACCC,26,2222471
marRp,1.75,9,3,AACTCAGCGTTGTTCGAACA,6,2246200
marRp,10.75,45,3,AACGGTTGGTGCACGTGTAC,42,2220848
marRp,6.0,26,3,AACGGCGGGCTAACAATTAT,23,2223275
marRp,1.0,6,3,AACGAAAGCTGGGCACATAT,3,2258091
marRp,3.0,14,3,AACCTATGCGCTTATGAGAT,11,2225781
marRp,2.0,10,3,AACCAATAGATGGGAGTGGG,7,2246018
marRp,3.0,14,3,AACACCAGCGACGTGTAAAG,11,2225686
marRp,1.5,8,3,AAATGGTCAATCAACGGCTA,5,2237995
marRp,3.0,14,3,AAATCCGGGCTAGACCTTCT,11,2222404
marRp,2.0,10,3,AAAGATCCATCCTTAGCAGG,7,2218407
marRp,5.75,25,3,AAACTGTCGGTCATCATACG,22,2249690
marRp,12.25,51,3,AAACGTGTACCTCTGACTCT,48,2243874
marRp,0.75,5,3,AAAAGCAACCGGAACCAAGT,2,2238801
marRp,5.5,24,3,AAAAGAGCTTAAACAGCTGG,21,2239662
marRp,2.25,11,3,AAAAAGTTCGGGAGTACCGT,8,2232778
marRp,1.3333333333333333,5,2,TTTTTCACTTTGGGAATATA,3,2251233
marRp,7.0,22,2,TTTGTCATCGCCGAAATCTT,20,2258218
marRp,1.6666666666666667,6,2,TTTGCGACGATAATCTACTA,4,2239297
marRp,2.6666666666666665,9,2,TTTGAGCCCAGTGACGCCAC,7,2227511
marRp,4.0,13,2,TTTGACGGTTAACATAAGGT,11,2223527
marRp,0.6666666666666666,3,2,TTTCCTTATGTCAGGCAACT,1,2221322
marRp,3.0,10,2,TTGTTCAGGGAGACACATTA,8,2220211
marRp,2.6666666666666665,9,2,TTGTCTGCGCCGCTGAAACA,7,2252659
marRp,22.333333333333332,68,2,TTGTACAGAATCCGTCGTAA,66,2257655
marRp,1.0,4,2,TTGTAAATGAATGGGCGAAT,2,2255688
marRp,38.333333333333336,116,2,TTGGTAACCTACCTGTCGCC,114,2228235
marRp,1.6666666666666667,6,2,TTGGTAAATACCAGATGGAA,4,2255494
marRp,3.0,10,2,TTGGAGGGATGATGATGGAC,8,2259575
marRp,9.0,28,2,TTGCCACCGGCACTGGCGAC,26,2238390
marRp,15.333333333333334,47,2,TTGCAGCGGCTTTGGTATAC,45,2256378
marRp,2.0,7,2,TTGCACTTTAAAGGATAAAT,5,2245168
marRp,6.666666666666667,21,2,TTGCACTGTTTTCTGTTAGG,19,2255908
marRp,4.0,13,2,TTGCAACTCTCCTTTAGTAA,11,2218147
marRp,2.0,7,2,TTGATTTTGCCGGGCGTAGC,5,2234122
marRp,3.0,10,2,TTGATTATTTAATTTCGGAA,8,2229650
marRp,4.333333333333333,14,2,TTGATAAAGCAAAGTAGCAT,12,2227625
marRp,17.0,52,2,TTGAGTGAGCTGAGGAGTCT,50,2251073
marRp,17.666666666666668,54,2,TTGAGAAAATTGATTTAGTA,52,2246702
marRp,7.0,22,2,TTGACTTGAATTGGTCGAAA,20,2253488
marRp,4.0,13,2,TTGACAATATCGGCATGGGA,11,2256737
marRp,5.333333333333333,17,2,TTCTGCGGGATTTATGCTTT,15,2257408
marRp,1.6666666666666667,6,2,TTCTGATATATGTAGTTTCT,4,2233254
marRp,60.666666666666664,183,2,TTCTCACGGACACAGAGGAC,181,2253462
marRp,40.666666666666664,123,2,TTCGGTGCAGGCGTTTCCTG,121,2256594
marRp,0.6666666666666666,3,2,TTCATCCGTACGATGCTGTC,1,2252120
marRp,6.333333333333333,20,2,TTATGACCGGATACGCATCT,18,2244496
marRp,8.0,25,2,TTATACGGAATTGATCTTAT,23,2252904
marRp,4.0,13,2,TTAGGGGTGTGGAAGCAAAT,11,2259647
marRp,1.0,4,2,TTAGATACACACTCCTCGTA,2,2250168
marRp,2.3333333333333335,8,2,TTAGACTTTGATCTCTGAAC,6,2223012
marRp,16.666666666666668,51,2,TTACTTTCAAGTACATGGGT,49,2240573
marRp,0.6666666666666666,3,2,TTACTTAGGCAAACCGCCTA,1,2252483
marRp,8.333333333333334,26,2,TTACTGAGTATTTATCAATT,24,2235009
marRp,0.6666666666666666,3,2,TTACTCTGTCGGATAATTCA,1,2228530
marRp,14.0,43,2,TTAAGTACGCGTAAGGGGAA,41,2229976
marRp,4.666666666666667,15,2,TTAACACTCTCTTCCATTAG,13,2249512
marRp,2.6666666666666665,9,2,TTAAATCGATTGCGATGACT,7,2255402
marRp,18.666666666666668,57,2,TGTTATCCTGCCCAAAAGGA,55,2222164
marRp,2.6666666666666665,9,2,TGTGCGCCGCTCATCTGGGT,7,2232677
marRp,5.333333333333333,17,2,TGTCGATTGTAATGGGCGAC,15,2253034
marRp,4.666666666666667,15,2,TGTCCCATGTGTTTCATATT,13,2243951
marRp,1.0,4,2,TGTAGCTATCACGATTCGTA,2,2244512
marRp,13.0,40,2,TGTAACGCGGGCTGAATTTC,38,2225052
marRp,4.0,13,2,TGGTTTACTAGCTAATCCCA,11,2238694
marRp,5.666666666666667,18,2,TGGTTGTACGTACGGGCCTA,16,2259276
marRp,3.3333333333333335,11,2,TGGTATTTCTTAAGATCCCT,9,2249723
marRp,6.333333333333333,20,2,TGGTAGTAGTTTTTGTAAAG,18,2240721
marRp,45.666666666666664,138,2,TGGGCAAGGAAGGGATTTGC,136,2222771
marRp,0.6666666666666666,3,2,TGGGATTTGCCCCCGAAGAC,1,2234489
marRp,7.333333333333333,23,2,TGGCGCCAATCCACGCCAGG,21,2236355
marRp,3.3333333333333335,11,2,TGGATACGCGTCTCGAAGCC,9,2260558
marRp,9.333333333333334,29,2,TGGAGATTGGGTAGGTCTAG,27,2224746
marRp,7.666666666666667,24,2,TGCTGTCCGTAAGGCTCCGT,22,2224902
marRp,7.333333333333333,23,2,TGCTGCGAGGTGGATTTTCA,21,2226429
marRp,8.666666666666666,27,2,TGCTACATCAGGAAACGCAT,25,2238519
marRp,1.3333333333333333,5,2,TGCCGGCGGGATATATGAGA,3,2243823
marRp,3.3333333333333335,11,2,TGCAGAGCCTGCAACCCTCT,9,2223387
marRp,15.333333333333334,47,2,TGATTAAGCGGCCAGGGGAA,45,2235952
marRp,11.0,34,2,TGATGCCCAGTCCTTCTTCT,32,2260859
marRp,1.0,4,2,TGATCCATGACGGCCGGGGT,2,2238635
marRp,13.666666666666666,42,2,TGATAACAAGCTTGTTTAAA,40,2231092
marRp,17.0,52,2,TGAGCGTGTTGAGGATATAG,50,2232725
marRp,5.333333333333333,17,2,TGAGATTTGGTTGAGCCGCT,15,2256924
marRp,2.6666666666666665,9,2,TGACTGGTAAACTCCCGGTA,7,2219934
marRp,1.0,4,2,TGACTGACCTTAGGAGTGAC,2,2254556
marRp,2.3333333333333335,8,2,TGACTCACTTTTGCTTTCTC,6,2249831
marRp,30.666666666666668,93,2,TGACGTCGGAATAGGATCCT,91,2228972
marRp,13.666666666666666,42,2,TGACCGTTATTGAGGTATCG,40,2250281
marRp,0.6666666666666666,3,2,TGACCGCGGTACGTACTCGT,1,2245382
marRp,7.0,22,2,TGAATAAATCCCGATAGGAC,20,2260038
marRp,21.333333333333332,65,2,TGAAAGTTTGATCCAGTGGC,63,2233451
marRp,3.6666666666666665,12,2,TCTTGGGTCGGCAGTGGTGA,10,2235742
marRp,5.0,16,2,TCTTGATAGCTCTCAGGGTT,14,2258431
marRp,4.333333333333333,14,2,TCTTCTGTAAATTAAAACAA,12,2248489
marRp,4.0,13,2,TCTTACCATATGTAAAGCTT,11,2249927
marRp,9.666666666666666,30,2,TCTGCAGTTCTAATATTGGA,28,2223662
marRp,2.3333333333333335,8,2,TCTGCAAATCGGAGGTGCAG,6,2220475
marRp,2.3333333333333335,8,2,TCTGAAAATGTGCACCTGTG,6,2234990
marRp,0.6666666666666666,3,2,TCTCTACTGTGTGCGATTGC,1,2226998
marRp,10.333333333333334,32,2,TCTCACGCATATGAACCAAG,30,2252775
marRp,8.0,25,2,TCTAGTCGCGGACGTCTGCT,23,2252099
marRp,3.3333333333333335,11,2,TCTAGGTAAGCCTAAACAAC,9,2241465
marRp,0.6666666666666666,3,2,TCGTTGCGTGCATATCCGGA,1,2221444
marRp,64.33333333333333,194,2,TCGTAAGCCCCATGGGTGGT,192,2221562
marRp,0.6666666666666666,3,2,TCGTAAAGTTACTAGCGGAG,1,2243096
marRp,12.333333333333334,38,2,TCGGTTTGATATACGTGCTT,36,2247455
marRp,3.3333333333333335,11,2,TCGGGAATATGACTGTCTTT,9,2260890
marRp,2.0,7,2,TCGGATCCAATAAGGTAACT,5,2219732
marRp,5.333333333333333,17,2,TCGCGTCTCGAGACACCGGT,15,2255897
marRp,2.3333333333333335,8,2,TCGCAGGCACTCATCAACGA,6,2234262
marRp,3.6666666666666665,12,2,TCGAGGAGGAAAATATCGTC,10,2254443
marRp,8.0,25,2,TCGAGAACGCTTTCAGTCCT,23,2218162
marRp,2.3333333333333335,8,2,TCCTGTTTGTTTCACAGTCA,6,2257171
marRp,16.666666666666668,51,2,TCCTGTAGTCGGTCACGATT,49,2257386
marRp,1.3333333333333333,5,2,TCCTGACGTTGCGTTCTCAT,3,2228569
marRp,4.333333333333333,14,2,TCCTCATTACGTGGTATGCG,12,2236542
marRp,7.666666666666667,24,2,TCCGTGAATTTGAACAGATA,22,2224356
marRp,0.6666666666666666,3,2,TCCGGCCCCTCAACATCACA,1,2233320
marRp,1.6666666666666667,6,2,TCCGAGCTGCCTCATGTCAT,4,2226265
marRp,4.0,13,2,TCCATTATTTATTATGGGTA,11,2256806
marRp,8.333333333333334,26,2,TCATTGGGAGTTTAAAGTAG,24,2246022
marRp,2.6666666666666665,9,2,TCATGTAGGATGTCGTCGCG,7,2221331
marRp,0.6666666666666666,3,2,TCATCTTCGCATTCCGTTGA,1,2256225
marRp,2.3333333333333335,8,2,TCATCCAAGCTTTTTCTCAT,6,2255814
marRp,1.6666666666666667,6,2,TCAGTTGGTGGCAACCAGTG,4,2248747
marRp,1.3333333333333333,5,2,TCAGCCGCGGCAATGAATCA,3,2226916
marRp,2.6666666666666665,9,2,TCACTGAACAAGATTCTGTA,7,2260124
marRp,1.3333333333333333,5,2,TCACGGGTGTCATGTGGGAC,3,2247796
marRp,6.666666666666667,21,2,TCACCATGGGACCTGTTCTC,19,2224107
marRp,3.0,10,2,TCAAAGCCTGGTCTATACTT,8,2257042
marRp,5.0,16,2,TCAAACGCCGGTGGAGTAGC,14,2248140
marRp,1.6666666666666667,6,2,TATTTTGACTTTCGACTCTT,4,2233064
marRp,8.666666666666666,27,2,TATTTATCAATATGCACGAG,25,2220192
marRp,2.6666666666666665,9,2,TATTCTGGCACGTCACGAGG,7,2219349
marRp,0.6666666666666666,3,2,TATGTGGGCCCCATACTTTT,1,2218371
marRp,1.3333333333333333,5,2,TATGCACGTTATCGGTTTAA,3,2244988
marRp,0.6666666666666666,3,2,TATGAATATTTACCCCCTAG,1,2219483
marRp,3.3333333333333335,11,2,TATCTTATCCTAGTCCAAGT,9,2230290
marRp,2.6666666666666665,9,2,TATCTACGGAGACCCCCACC,7,2256190
marRp,0.6666666666666666,3,2,TATCGGAAATCGCTCCTCCA,1,2235995
marRp,1.0,4,2,TATCCGCATGTAGTAAGAGT,2,2234668
marRp,1.3333333333333333,5,2,TATATTAAAGTTCGTCGGGA,3,2243013
marRp,19.666666666666668,60,2,TATATCAGAATCTTGTAAGA,58,2238932
marRp,2.0,7,2,TATAGATATTTGAATCGGCT,5,2246316
marRp,2.0,7,2,TATAAACCCTGTGATCCCTA,5,2233960
marRp,2.6666666666666665,9,2,TAGGGTAACAATCGATATGG,7,2240919
marRp,2.3333333333333335,8,2,TAGGCACGCAGAGTTGCGTG,6,2228315
marRp,6.666666666666667,21,2,TAGCCGTATTGTATGGGCTC,19,2236580
marRp,11.333333333333334,35,2,TAGCATCCGATCAGCTGTCG,33,2245483
marRp,20.666666666666668,63,2,TAGACGTCAGGTTGTTTTCG,61,2233972
marRp,3.3333333333333335,11,2,TAGACCTGGGAGGCTCATTA,9,2243878
marRp,14.0,43,2,TACTTTGGGGGCAACGAGAA,41,2247983
marRp,5.0,16,2,TACTTAATGGACATATTCTT,14,2220113
marRp,1.3333333333333333,5,2,TACTGGTTTGTAGGCGGTGA,3,2256417
marRp,4.0,13,2,TACTCAAATCTTGATACACA,11,2218573
marRp,4.333333333333333,14,2,TACTACAACGATCGACAGGA,12,2222470
marRp,3.3333333333333335,11,2,TACGTGATCTGTTTTATTCT,9,2257781
marRp,17.333333333333332,53,2,TACGTGAGGTTCGCGTTATC,51,2240976
marRp,1.0,4,2,TACGGATTCGCAGTCAATAA,2,2250982
marRp,3.0,10,2,TACGGATGGGACATACCAGC,8,2227965
marRp,10.666666666666666,33,2,TACCCTCCCCCGTGATGTGA,31,2232049
marRp,2.0,7,2,TACCCCCTCTGAGCCGGAGG,5,2228099
marRp,1.0,4,2,TACACATTGTTACTAGAAGG,2,2243979
marRp,5.333333333333333,17,2,TACAAATCCACTCATGGAAG,15,2233211
marRp,6.666666666666667,21,2,TAATTTAAGATTTTATGCCT,19,2259478
marRp,4.333333333333333,14,2,TAAGGCCCGGCATTATAGTG,12,2236398
marRp,5.0,16,2,TAAGGATAAGTGCGAGACCA,14,2254001
marRp,2.6666666666666665,9,2,TAACTTGCATTAGGTGGGCA,7,2248337
marRp,2.0,7,2,TAACCTTAACAGGTCCGCTC,5,2249099
marRp,6.333333333333333,20,2,TAAATCCACTGTTTTATGCT,18,2239415
marRp,0.6666666666666666,3,2,TAAAACCTAGGTTGTATGGC,1,2220581
marRp,8.666666666666666,27,2,GTTTTTGACTTATTCTCCCT,25,2258722
marRp,0.6666666666666666,3,2,GTTGATAAAAAATACCTGCC,1,2240189
marRp,24.0,73,2,GTTGAATTAGACGATTCGTA,71,2243875
marRp,0.6666666666666666,3,2,GTTCGGGTCCATTTGGTCCC,1,2222687
marRp,1.0,4,2,GTTCGGACACTTACGGGAAT,2,2218282
marRp,24.666666666666668,75,2,GTTATCAGTAAATGTGACCG,73,2237233
marRp,42.333333333333336,128,2,GTTACAGTACAAATCCAGAA,126,2235085
marRp,1.3333333333333333,5,2,GTTAATCCCCGGGAGCTATG,3,2230991
marRp,0.6666666666666666,3,2,GTGTTCCATGAATCTCACAA,1,2218128
marRp,7.666666666666667,24,2,GTGTTAGCCAATAAACCTAC,22,2250065
marRp,2.0,7,2,GTGTGGAGATGCAATTACGT,5,2231402
marRp,4.0,13,2,GTGTCTTCTTTCCTTCATGT,11,2254946
marRp,0.6666666666666666,3,2,GTGTAAACGCAGACGTGGCG,1,2237168
marRp,3.3333333333333335,11,2,GTGGTCAAGAGCTGGTATGT,9,2219001
marRp,5.666666666666667,18,2,GTGGTATGTGCCGAAAGTGG,16,2248761
marRp,1.6666666666666667,6,2,GTGGTATCAGTGGATGACAA,4,2248730
marRp,1.6666666666666667,6,2,GTGGGCCAAATGGAGGGTGT,4,2222809
marRp,16.0,49,2,GTGGGATGATAAAGAATTAC,47,2260548
marRp,2.6666666666666665,9,2,GTGGCATCTCAATCGGCCTA,7,2252293
marRp,1.3333333333333333,5,2,GTGCGGTGGATTTCCCCCCC,3,2229464
marRp,16.0,49,2,GTGCCGTGGCACGATCCGAC,47,2221004
marRp,40.333333333333336,122,2,GTGAGCAGCTCTTGGTACTG,120,2240620
marRp,6.666666666666667,21,2,GTGACGGCGTGGAGGCCTCA,19,2238893
marRp,5.333333333333333,17,2,GTCTCTTTGCTTCTTCCGTA,15,2247656
marRp,1.0,4,2,GTCGTGATTACAGAGCGCAG,2,2253275
marRp,3.3333333333333335,11,2,GTCGTATAAAACTGTAGTCT,9,2237969
marRp,14.333333333333334,44,2,GTCACTTTGTGACGCGTGGT,42,2236612
marRp,3.3333333333333335,11,2,GTCACTCCAATGAAGTTGTA,9,2236533
marRp,1.0,4,2,GTCACGGATGAGCTAGATTT,2,2258106
marRp,4.333333333333333,14,2,GTATTGAAGCTTGGCGAAGA,12,2230217
marRp,0.6666666666666666,3,2,GTATTATGCCGAGTCCGGGT,1,2249279
marRp,3.0,10,2,GTATGTCGATAAGTTTTAAG,8,2232129
marRp,0.6666666666666666,3,2,GTATAACATTTGGCTTACTA,1,2235752
marRp,3.0,10,2,GTAGTTCAGCCCCACCAATT,8,2247161
marRp,8.333333333333334,26,2,GTAGCTACCGCGGTTTGTAC,24,2256214
marRp,1.0,4,2,GTAGATTTCTCTAAACGGTG,2,2245449
marRp,1.6666666666666667,6,2,GTAGAGCGCATCCCTCCGGG,4,2252269
marRp,1.6666666666666667,6,2,GTACTTATTGCGTGCGTCAT,4,2221737
marRp,67.33333333333333,203,2,GTACACGTTCATCTAACGCT,201,2248969
marRp,3.0,10,2,GTAATTGCCCCAGCGGTAGC,8,2218714
marRp,1.0,4,2,GTAATGGCGTCACTTAGATC,2,2226143
marRp,15.333333333333334,47,2,GTAAGCATCTTACATTAATC,45,2256374
marRp,1.3333333333333333,5,2,GTAACACCCAGTGGTATGCT,3,2256453
marRp,1.0,4,2,GTAAAGGTTAACTCTAGGGC,2,2225167
marRp,3.6666666666666665,12,2,GTAAACAGGGCGTAAGATAG,10,2247040
marRp,16.333333333333332,50,2,GGTTTACGGGGAAACCAATG,48,2240754
marRp,8.666666666666666,27,2,GGTGAAATGTGGATTTGATC,25,2238434
marRp,7.333333333333333,23,2,GGTCTACGCACACAGTCCTA,21,2244633
marRp,7.333333333333333,23,2,GGTCACTCTAGGCTGTGTCC,21,2245152
marRp,1.0,4,2,GGGTGAAGCTCTGAAAGGGA,2,2232023
marRp,1.6666666666666667,6,2,GGGTCTAGGCCTCGCGCCTA,4,2249955
marRp,3.3333333333333335,11,2,GGGTCCGGATGTTGCACTTC,9,2234552
marRp,0.6666666666666666,3,2,GGGTCAGCGTCGAATCTTAA,1,2239729
marRp,5.333333333333333,17,2,GGGTAGGGACCATAGAGCCC,15,2254522
marRp,8.333333333333334,26,2,GGGGTGTTAATTCGCGGGCG,24,2259739
marRp,11.0,34,2,GGGGGAAAACTGGGCATTAT,32,2256599
marRp,5.666666666666667,18,2,GGGGCGCATTCCACGTATCT,16,2229468
marRp,4.0,13,2,GGGGCCTCGTGGGATGTTCA,11,2254269
marRp,39.0,118,2,GGGGAGCAAGTAACGCTCTA,116,2255299
marRp,10.666666666666666,33,2,GGGGAGACAGAGAGCCTAGT,31,2224900
marRp,2.0,7,2,GGGCAGCCGCAGTAAATACC,5,2260074
marRp,2.3333333333333335,8,2,GGGATACATAATGAACTAGA,6,2242604
marRp,10.333333333333334,32,2,GGCGTATATCATAGATGGTG,30,2254943
marRp,6.0,19,2,GGCGCTCCAGTTGCTCGGAA,17,2229742
marRp,1.3333333333333333,5,2,GGCCCGCAATCAGTGGACTA,3,2236805
marRp,1.6666666666666667,6,2,GGCCCCTCTCCTGGTAGAAG,4,2237895
marRp,9.666666666666666,30,2,GGCAGTCCGCCCTGGCGTGC,28,2235776
marRp,0.6666666666666666,3,2,GGCAGGATGATATTTGAACA,1,2229456
marRp,3.0,10,2,GGCAGCATTATGATAGTTCT,8,2252909
marRp,5.333333333333333,17,2,GGCAGCAATTAGGGCGCTTG,15,2248296
marRp,1.0,4,2,GGATTTTGGCTTCGGGTCGG,2,2256392
marRp,2.0,7,2,GGATGAGCTTGAATCGCAAT,5,2242555
marRp,0.6666666666666666,3,2,GGATCGGGGGTTAGCTGGCG,1,2254962
marRp,5.0,16,2,GGATCCTTCTTAGTGTTCTG,14,2259697
marRp,13.333333333333334,41,2,GGATACAAATCGCTCCTCAT,39,2226507
marRp,29.0,88,2,GGATAAGCGTGGGAGAGAAG,86,2235696
marRp,4.0,13,2,GGAGGGGTCCAAGCCAATAT,11,2238473
marRp,10.0,31,2,GGAGACAGTCATGAGATAGC,29,2230172
marRp,1.6666666666666667,6,2,GGACGCTTTTTCCGTAGTGA,4,2246382
marRp,7.666666666666667,24,2,GGACCGGGAGTCTCCGAACT,22,2257703
marRp,7.333333333333333,23,2,GGACATCAGCGCCGCGCTTA,21,2229389
marRp,6.0,19,2,GGACAATTAGGCTGGCTGGT,17,2237553
marRp,2.0,7,2,GGAAATTAGTCCGTTACTCA,5,2242272
marRp,2.3333333333333335,8,2,GCTTTGCCGCGTAAGATCTT,6,2247004
marRp,13.666666666666666,42,2,GCTTCTACAACGAAGAGATT,40,2223999
marRp,1.3333333333333333,5,2,GCTTCCTTTCCAATCGAATT,3,2218630
marRp,0.6666666666666666,3,2,GCTTAATAGTGAGACGTGGT,1,2256635
marRp,4.333333333333333,14,2,GCTGTGTGGGCGCAACCTGA,12,2233817
marRp,6.333333333333333,20,2,GCTGCGGGTTCCTGAAAGAC,18,2246988
marRp,2.3333333333333335,8,2,GCTAGGTTTGGCGGGTGGTA,6,2230853
marRp,1.3333333333333333,5,2,GCTACCTAGGGGCATAAGTA,3,2232758
marRp,39.666666666666664,120,2,GCGTTAACGTGCCTCATCAA,118,2248577
marRp,69.33333333333333,209,2,GCGTCTGCCTCCTGGATCGC,207,2232721
marRp,1.6666666666666667,6,2,GCGGCTAGGCTCACTCGGCT,4,2229239
marRp,1.6666666666666667,6,2,GCGGCTAATGGCTCTACAAC,4,2253457
marRp,4.0,13,2,GCGGACTACTCACGAACCCG,11,2224440
marRp,16.666666666666668,51,2,GCGCTTTCAATTTCTTAACT,49,2245984
marRp,5.666666666666667,18,2,GCGCTGAACCTCGGAGCGTT,16,2236503
marRp,2.6666666666666665,9,2,GCGCCTCCGTTCATATTGTA,7,2231591
marRp,1.0,4,2,GCGCCTCCGCACCCATCACA,2,2260272
marRp,3.3333333333333335,11,2,GCGAGAAGGCTAGTGTCCTC,9,2237677
marRp,1.3333333333333333,5,2,GCCTTCCCAAGCATCTTCCT,3,2258279
marRp,0.6666666666666666,3,2,GCCTTCAGCGAACCTCCAGG,1,2219498
marRp,11.0,34,2,GCCTGATCTATTATGAGCGG,32,2225236
marRp,75.66666666666667,228,2,GCCTCGGCGATCTAGGACAA,226,2241499
marRp,23.666666666666668,72,2,GCCTCCGCCATGCGTGTCAT,70,2243873
marRp,7.0,22,2,GCCTAATGGATTAGAACTCT,20,2228709
marRp,2.6666666666666665,9,2,GCCGTTCATACAGACCATGA,7,2256535
marRp,3.6666666666666665,12,2,GCCGATTTAGGTGTGAGTCC,10,2233856
marRp,9.666666666666666,30,2,GCCCTCTGTATGATTGCTTT,28,2260069
marRp,38.0,115,2,GCCCTAGCAAAAAGGATTAG,113,2238927
marRp,10.0,31,2,GCCATGTAAGCGTGGCCGTC,29,2222249
marRp,2.3333333333333335,8,2,GCCAAGTCTGGCGCACGTCC,6,2221102
marRp,2.0,7,2,GCATTCCGACCGGCACGAAC,5,2229721
marRp,1.0,4,2,GCATCGCTTCTCTCCGCGAT,2,2233645
marRp,0.6666666666666666,3,2,GCAGGGGAAGGGTAGAAGCG,1,2221262
marRp,7.0,22,2,GCAGGGCTCCTGGGGTCCTC,20,2259321
marRp,10.333333333333334,32,2,GCAGCTTTGCGAAGCCTCAC,30,2248450
marRp,2.6666666666666665,9,2,GCACTCAAGTACACAATAAG,7,2242329
marRp,11.0,34,2,GCACAGTAAGGTGATTCTCA,32,2249496
marRp,19.666666666666668,60,2,GCACACCCTGATATACCCGT,58,2240704
marRp,2.3333333333333335,8,2,GCAAACCCATGAGCTTAGGG,6,2226600
marRp,1.3333333333333333,5,2,GATTCGGTTCACTGGAGAGA,3,2224517
marRp,17.666666666666668,54,2,GATTATATTAGCCGTCAGTG,52,2245055
marRp,2.3333333333333335,8,2,GATGCTAGAGACACATCGGT,6,2250807
marRp,2.3333333333333335,8,2,GATGAACTATACGAGGTACG,6,2259273
marRp,0.6666666666666666,3,2,GATATCCAACCGGCCAGGGA,1,2247835
marRp,0.6666666666666666,3,2,GATACGGCGCAGCAGTGTTA,1,2254043
marRp,1.6666666666666667,6,2,GAGTATTTACCGTCTTCTAC,4,2253839
marRp,0.6666666666666666,3,2,GAGGTCTCTTTCATGGGTTA,1,2254539
marRp,6.0,19,2,GAGGAGTGTATATTAGAACT,17,2259950
marRp,3.3333333333333335,11,2,GAGGACACTTACAATAACTC,9,2257974
marRp,3.6666666666666665,12,2,GAGCTTTGGGGCGTTAGGAT,10,2222425
marRp,0.6666666666666666,3,2,GAGATAACCTCGACGGTACA,1,2233074
marRp,8.333333333333334,26,2,GAGAATTGTGCTGCTTGGGA,24,2231642
marRp,12.333333333333334,38,2,GAGAATGAGGTGGGTTCGGC,36,2221271
marRp,25.666666666666668,78,2,GAGAAAGTGATTGTGCATGT,76,2248230
marRp,1.0,4,2,GACTGCAGGCGGCATCAAGA,2,2250466
marRp,20.333333333333332,62,2,GACCCGCATGGCTTACTTTT,60,2250422
marRp,5.666666666666667,18,2,GACCCGAGTCGGGTAGGTCT,16,2219944
marRp,0.6666666666666666,3,2,GACCCAATCTACTGCCAATA,1,2227364
marRp,33.666666666666664,102,2,GACCACCGAGTGAGTGCGGA,100,2220054
marRp,23.666666666666668,72,2,GACAGGCACTGGCTACGTGT,70,2235098
marRp,9.0,28,2,GACACTTTCTTTGCGATATT,26,2249192
marRp,13.333333333333334,41,2,GAATTTACCGACGTAAATGA,39,2219336
marRp,6.333333333333333,20,2,GAATCGGGCACGTTGCCCTA,18,2231521
marRp,34.333333333333336,104,2,GAAGTGTCACCACATCGAGT,102,2241088
marRp,4.0,13,2,GAAGGTGATTCCTTGATCTA,11,2256878
marRp,2.6666666666666665,9,2,GAAGGTAGGTATACATACAC,7,2248536
marRp,5.666666666666667,18,2,GAACGTCGCTGGTACGTCCA,16,2224237
marRp,7.333333333333333,23,2,GAACGCCGAGACATTGGGAC,21,2246107
marRp,5.666666666666667,18,2,GAACCAGATTACCGACTCCG,16,2247817
marRp,0.6666666666666666,3,2,GAAATTTGAACGTGAGGTGC,1,2238544
marRp,3.3333333333333335,11,2,GAAATTGAACGCCATTTCAG,9,2231822
marRp,5.666666666666667,18,2,GAAACTCTTTCATTCCCTAA,16,2240497
marRp,2.3333333333333335,8,2,CTTTTTGCCGACATCTGCGT,6,2248265
marRp,5.666666666666667,18,2,CTTTGGGCTGCTGGAGGTTC,16,2248193
marRp,10.333333333333334,32,2,CTTTGGGCTATCAAAGGCAA,30,2218153
marRp,0.6666666666666666,3,2,CTTGAAACATAACCCAATAA,1,2253941
marRp,24.666666666666668,75,2,CTTCTCAGGGAAGCACCGGT,73,2240015
marRp,41.0,124,2,CTTCTCAGGGAACTGCGTCA,122,2248971
marRp,9.0,28,2,CTTCGGTGGCCTCTGGCTCC,26,2223694
marRp,13.666666666666666,42,2,CTTATCGCTGCGGGTCAGAG,40,2247448
marRp,2.3333333333333335,8,2,CTTACCCCCACATCCATGTG,6,2224823
marRp,7.333333333333333,23,2,CTTAAGGAACTAGCGACCGT,21,2232861
marRp,13.0,40,2,CTTAACACTCGGCTTTTACC,38,2249180
marRp,10.666666666666666,33,2,CTGTTGAGGGTGGAAGAAGG,31,2228524
marRp,2.3333333333333335,8,2,CTGTTGAATAGCACGTGCCT,6,2222244
marRp,1.0,4,2,CTGTGCCTGGTTCCCTACTG,2,2226314
marRp,6.0,19,2,CTGGGCCACATGCAGGACGG,17,2228705
marRp,3.0,10,2,CTGGATGCACTGGACTGGCG,8,2246741
marRp,2.3333333333333335,8,2,CTGCCGACGGCTAGTCGATA,6,2242716
marRp,18.333333333333332,56,2,CTGCAATGATAGATCACGAT,54,2245239
marRp,10.666666666666666,33,2,CTGATCTTTCGCCTGCAACA,31,2224811
marRp,9.333333333333334,29,2,CTCTTGAAATTCTCCGACCC,27,2236296
marRp,1.6666666666666667,6,2,CTCTCGCAGGCCATGAAGGT,4,2241448
marRp,30.333333333333332,92,2,CTCGTGGCCGAATATAGGTC,90,2248454
marRp,14.0,43,2,CTCGCTCAAGACTAGATGAA,41,2224593
marRp,0.6666666666666666,3,2,CTCCGTTAAATAGATCGTCC,1,2246958
marRp,26.666666666666668,81,2,CTCCGGAAGAAGGGTAGAAG,79,2221265
marRp,1.3333333333333333,5,2,CTCCCGTCGTACTTCTCTAT,3,2234957
marRp,4.333333333333333,14,2,CTCAATTTAGATAAACCACA,12,2219122
marRp,4.666666666666667,15,2,CTATGTAGAGCGGAGCAATG,13,2251248
marRp,0.6666666666666666,3,2,CTATCTCAAGACAAAAAACA,1,2227485
marRp,2.0,7,2,CTATCTAGGGGTGTATGGTT,5,2259342
marRp,19.0,58,2,CTATCGATTTGCGTTGTGCA,56,2220209
marRp,0.6666666666666666,3,2,CTAGTATCAATACGCCGTTT,1,2235941
marRp,23.0,70,2,CTACGTCTGATACTATTCCC,68,2251639
marRp,8.333333333333334,26,2,CTACGATTCGCGTTCCCTGG,24,2238073
marRp,13.666666666666666,42,2,CTAATGAGAGCAATCCGACT,40,2259757
marRp,4.333333333333333,14,2,CTAAGCCAGTTAGCATACAC,12,2225059
marRp,15.333333333333334,47,2,CGTTGTCATAGATCCCGCGT,45,2226483
marRp,1.3333333333333333,5,2,CGTTGGCTTACTTAGCGAGC,3,2250633
marRp,1.6666666666666667,6,2,CGTGGTGGACAATAGACTCT,4,2246046
marRp,10.333333333333334,32,2,CGTGACTATCCTATCTTTCC,30,2244548
marRp,2.0,7,2,CGTGACCGCCCGGAGGAGAT,5,2256885
marRp,4.0,13,2,CGTCGTTGTAACGACAATAT,11,2220095
marRp,3.0,10,2,CGTATAACATCGCTCGCAGT,8,2224571
marRp,10.333333333333334,32,2,CGTAGCTGTGTTGATTACTT,30,2242788
marRp,2.3333333333333335,8,2,CGTACGTCAGGCTGAAAATT,6,2219077
marRp,1.0,4,2,CGTAAGACCTCTTTCACAAC,2,2219290
marRp,2.0,7,2,CGTAAATGGACACTAACGGA,5,2259154
marRp,3.0,10,2,CGGGTATCGCTCATCGCAGG,8,2252863
marRp,0.6666666666666666,3,2,CGGGCAAGTCGCCACGTAAA,1,2241838
marRp,14.0,43,2,CGGGATATCTAAATAAAACC,41,2248452
marRp,5.666666666666667,18,2,CGGCGGTAACCGCATCCCAT,16,2241556
marRp,3.6666666666666665,12,2,CGGCCACTTCTTGATCGGGG,10,2237861
marRp,8.333333333333334,26,2,CGGCAAGTGAGCCTCAGTTC,24,2247975
marRp,4.666666666666667,15,2,CGGATTAAGGGTTTACGGTA,13,2259047
marRp,3.6666666666666665,12,2,CGGAGGTCACATACCACCTC,10,2246025
marRp,6.666666666666667,21,2,CGGAGCCGCTTTTCCTTGGT,19,2243524
marRp,8.0,25,2,CGGAGATTCGAGTTGCTCCT,23,2229630
marRp,1.0,4,2,CGCTTCCAACGAAAATAGAG,2,2258833
marRp,9.333333333333334,29,2,CGCTATCAAGGTGCCCGATA,27,2234550
marRp,24.666666666666668,75,2,CGCTAGGTGCCCCCGTGGAT,73,2254075
marRp,2.0,7,2,CGCGTTCTGAAGACCGGACG,5,2233444
marRp,4.0,13,2,CGCCGTCGTTTTCTGGGTCC,11,2219828
marRp,1.6666666666666667,6,2,CGATCATGAGAGGTTGTCTT,4,2229257
marRp,5.333333333333333,17,2,CGAGTACTCGGCATGATACG,15,2229602
marRp,2.6666666666666665,9,2,CGAGGAAAAGTCCGCAATCG,7,2253862
marRp,6.0,19,2,CGAGCTACGCGGAATTATTA,17,2252390
marRp,24.333333333333332,74,2,CGAGACGTTCAGCATAGGGT,72,2221541
marRp,10.0,31,2,CGACTCGGGCGGTATTTCTC,29,2228252
marRp,2.3333333333333335,8,2,CGACGCGGGTTGTTTGATCC,6,2249797
marRp,1.6666666666666667,6,2,CGACACGGCACGAGACGTAT,4,2227177
marRp,7.333333333333333,23,2,CGAATGCTGCGACCCCTGGT,21,2218508
marRp,6.666666666666667,21,2,CGAAGGAAGTAGTCTTTGTA,19,2240943
marRp,3.6666666666666665,12,2,CGAAAGGCTTGCGAAGAGCT,10,2227347
marRp,0.6666666666666666,3,2,CGAAACTGAGTTTTGGCAGA,1,2235421
marRp,3.0,10,2,CCTTCAACCATACAAGTAGC,8,2238042
marRp,4.333333333333333,14,2,CCTGCAAAATCGACATCTCG,12,2224809
marRp,5.666666666666667,18,2,CCTCGGGAATCCGGCACGTG,16,2241855
marRp,3.3333333333333335,11,2,CCTCGAGCGCCGCGTGGAAG,9,2228604
marRp,2.3333333333333335,8,2,CCTCCCGTGGGTGATCGTAG,6,2239416
marRp,3.3333333333333335,11,2,CCTCACAACGCGCGAAAAGA,9,2233447
marRp,12.666666666666666,39,2,CCTATGTGAACGCCGAGAGA,37,2235256
marRp,4.666666666666667,15,2,CCTATACTGGTGTGTGACCC,13,2246194
marRp,4.333333333333333,14,2,CCTAACGTGGCCCGCGGACT,12,2226849
marRp,6.0,19,2,CCGTCAAAGAGACCTTAGTG,17,2255221
marRp,4.0,13,2,CCGGTTCGAACGAGACAGAA,11,2234341
marRp,10.0,31,2,CCGGTGAGGCTCAGTGCGCA,29,2254339
marRp,26.0,79,2,CCGGGGCGAATTTGCGAGAC,77,2231934
marRp,10.333333333333334,32,2,CCGGGAACGCAAGGTAGCAT,30,2229936
marRp,3.6666666666666665,12,2,CCGGCGTAATTGTTGTGTTC,10,2254150
marRp,19.333333333333332,59,2,CCGGCCTCGACTGCTTTACT,57,2258716
marRp,3.0,10,2,CCGGAGACGTCCACTAGCCC,8,2255545
marRp,16.333333333333332,50,2,CCGCTGCAAGAATCGCTGGA,48,2259567
marRp,3.3333333333333335,11,2,CCGCGATTGGGTCTTTATGC,9,2234184
marRp,3.6666666666666665,12,2,CCGCACGATGGGTTTTCTCC,10,2221876
marRp,20.666666666666668,63,2,CCGCAATTAGTTAACTAGCT,61,2219006
marRp,2.0,7,2,CCGCAATCGATGGCTAATCG,5,2230660
marRp,1.3333333333333333,5,2,CCGATTTAAGGTGGTTGCCT,3,2242540
marRp,20.666666666666668,63,2,CCGAGGGAGAATCAACGGGA,61,2248859
marRp,3.3333333333333335,11,2,CCGAGGCTGAAGAACCCGTC,9,2248802
marRp,2.0,7,2,CCGAAAAGAATTGGCTCAAA,5,2234683
marRp,9.0,28,2,CCCTGTCCATGGGTCCGTCG,26,2219343
marRp,7.333333333333333,23,2,CCCTCGGTCCGGAACAGTAC,21,2224074
marRp,2.3333333333333335,8,2,CCCGTCCGCGAATTTTTAAG,6,2234885
marRp,3.6666666666666665,12,2,CCCGTATAAGGGTGTCAGCA,10,2257000
marRp,1.3333333333333333,5,2,CCCGATCTTTAACTCTTGAA,3,2258140
marRp,15.333333333333334,47,2,CCCATCCTACACTCCCGACT,45,2238115
marRp,4.333333333333333,14,2,CCCATATAAATGAGAGGGGG,12,2258884
marRp,3.3333333333333335,11,2,CCCAGCGAGGATTATCGTCT,9,2242880
marRp,52.333333333333336,158,2,CCCACGCACTCGAAGCTTGA,156,2221833
marRp,11.666666666666666,36,2,CCATTCCTCACGCGCCGCCA,34,2237638
marRp,11.666666666666666,36,2,CCATCATTCCAAACCAGACA,34,2246258
marRp,4.0,13,2,CCATATCCACCTCGCCCGTC,11,2220082
marRp,1.6666666666666667,6,2,CCATAACTTTAGTGCGAAAC,4,2241965
marRp,2.6666666666666665,9,2,CCAGGGGCCACAGTATCTTG,7,2240733
marRp,2.3333333333333335,8,2,CCACTCTGGTACGTTCATAC,6,2239685
marRp,52.0,157,2,CCACTCGCAGACTCACCGGT,155,2239245
marRp,1.0,4,2,CCACTCACCGGTTGGAAAAT,2,2227436
marRp,0.6666666666666666,3,2,CCAATGTTTTGCTACCCCTA,1,2224737
marRp,1.0,4,2,CCAATATCACAAAACTATGC,2,2225312
marRp,4.0,13,2,CCAAGTCTTTATTAGAAGTG,11,2225071
marRp,0.6666666666666666,3,2,CCAACTAATGGCGTGGTGAC,1,2250471
marRp,10.666666666666666,33,2,CCAACGATGTTCTGAACTGA,31,2251250
marRp,1.0,4,2,CCAACATCCGTTTCCCTAAC,2,2246232
marRp,0.6666666666666666,3,2,CATTGAACGGGCTTCAGAAG,1,2229096
marRp,0.6666666666666666,3,2,CATTCCGAGGCATGACGCCA,1,2249795
marRp,2.3333333333333335,8,2,CATTATTACTGGGTAGGGTG,6,2236185
marRp,4.666666666666667,15,2,CATTAGTGTGATACCGTATT,13,2241317
marRp,3.3333333333333335,11,2,CATGTCAGGCTCCCAAACTA,9,2248838
marRp,19.333333333333332,59,2,CATGATGGAGCAGGCGTATG,57,2251242
marRp,6.0,19,2,CATGACAAGGTTCCTGACTT,17,2253972
marRp,2.0,7,2,CATCTGATGAGTGCCCCGGC,5,2242216
marRp,3.6666666666666665,12,2,CATCCCCTTCGATAACGCGT,10,2240541
marRp,0.6666666666666666,3,2,CATCCACCAGCACGAGTCCA,1,2227903
marRp,2.0,7,2,CATATGTCGCATAATTTACC,5,2238953
marRp,7.0,22,2,CATAGGTCCAGGATTATGTT,20,2252407
marRp,1.0,4,2,CAGGTGGTAAGGCCATAAAG,2,2240849
marRp,4.666666666666667,15,2,CAGGCAGGGTTCAACACACA,13,2246173
marRp,2.6666666666666665,9,2,CAGCGGGCGTCTCCCACACA,7,2253422
marRp,1.3333333333333333,5,2,CAGCCCCCCACGCCGGGGTA,3,2233876
marRp,7.333333333333333,23,2,CAGCATGATGAACGCTCACA,21,2233460
marRp,2.6666666666666665,9,2,CAGATGTTCAAGCAGAACAA,7,2222196
marRp,4.0,13,2,CACTAGGCATCTTTCCAATC,11,2244920
marRp,3.0,10,2,CACGATGTCGTAGTAGGAGT,8,2224970
marRp,45.0,136,2,CACGAGGCAGCGCCCGCCGG,134,2226822
marRp,7.0,22,2,CACCGTGTATGTCTGTGACC,20,2229271
marRp,18.333333333333332,56,2,CAAGGACCGTTCCGGCACGG,54,2221001
marRp,2.3333333333333335,8,2,CAAGATAGAAGGGAGAAAGG,6,2242789
marRp,3.0,10,2,CAAGAGGGATCCCCCCAGCA,8,2227607
marRp,19.0,58,2,CAACGCCGCACTGAGATCTG,56,2227014
marRp,1.6666666666666667,6,2,CAACCTCGATTTGTTTCCGC,4,2229122
marRp,6.333333333333333,20,2,CAACAGACTGAGTTAGAACC,18,2232177
marRp,3.3333333333333335,11,2,CAACACCGGGCACTTTGACT,9,2239445
marRp,3.0,10,2,CAAATGACCTAACGAGGTTA,8,2245480
marRp,1.3333333333333333,5,2,CAAAGTGAAATTTGGTGAAA,3,2250740
marRp,3.0,10,2,CAAACTAGGTGCGGCTCGAT,8,2223826
marRp,5.666666666666667,18,2,ATTTGTGTCAGTGCGAGCGC,16,2242413
marRp,3.0,10,2,ATTTAGAGGCTAGTTATTTG,8,2253001
marRp,1.3333333333333333,5,2,ATTTAACTATGTTTCGGATG,3,2233697
marRp,2.6666666666666665,9,2,ATTGTAACGCCCGATTAATA,7,2238025
marRp,0.6666666666666666,3,2,ATTGGGTGACGTCCCAGTTC,1,2250327
marRp,4.0,13,2,ATTGGGGAGGCGGACAGACC,11,2237232
marRp,0.6666666666666666,3,2,ATTGCAGGATGGTGATCTAT,1,2226467
marRp,1.6666666666666667,6,2,ATTGAGCGTGAATGTCACTG,4,2224825
marRp,7.666666666666667,24,2,ATTCGATTCTGACGTCGGTG,22,2241984
marRp,22.0,67,2,ATTCCACGTCTGGTCTACCC,65,2231860
marRp,2.6666666666666665,9,2,ATTCAACCGCGGCCCTCGTC,7,2231197
marRp,3.3333333333333335,11,2,ATTATACGCTAGGTTGCGGC,9,2224157
marRp,3.6666666666666665,12,2,ATTACTTTCGATTGGGCTTA,10,2245178
marRp,2.6666666666666665,9,2,ATTAACACATCGCATCGGAA,7,2248357
marRp,0.6666666666666666,3,2,ATGTTGAATGCTTCTAGTGT,1,2239126
marRp,1.0,4,2,ATGTCCATCTGAAGGACGTG,2,2251126
marRp,3.0,10,2,ATGGCAGCACTCTTGATAAA,8,2244833
marRp,8.0,25,2,ATGCCTTGGTTATACGATCA,23,2245566
marRp,7.0,22,2,ATGCCAAAGGATCGGGTCCT,20,2257970
marRp,1.0,4,2,ATGATATCCGCCGATCCACT,2,2252163
marRp,1.0,4,2,ATGAGTTGTCGGTTCCTTAT,2,2230032
marRp,54.0,163,2,ATGAACGCTCTATCTCAGAG,161,2234560
marRp,3.3333333333333335,11,2,ATGAAACTCTCACGAGCGCG,9,2247090
marRp,1.0,4,2,ATCTTTTGGGTCGTTTAAGA,2,2245666
marRp,2.6666666666666665,9,2,ATCGCAAACGATGCTGTATA,7,2219232
marRp,1.6666666666666667,6,2,ATCCTGGTTGGGTCTTCGCG,4,2221514
marRp,3.0,10,2,ATCCGCTTGAGGTGGGGCGA,8,2258837
marRp,9.666666666666666,30,2,ATCCCTGCCAGAAATTTCAA,28,2256853
marRp,2.0,7,2,ATCCACGCCGTGTGTATACT,5,2238961
marRp,1.6666666666666667,6,2,ATCCAATTATTTCCCTTCAA,4,2228367
marRp,8.333333333333334,26,2,ATCAGCATTGTTATCAAGTC,24,2252115
marRp,1.6666666666666667,6,2,ATATAACATATGCAAATCGT,4,2224763
marRp,3.6666666666666665,12,2,ATAGATGGAGTTTTAAGATC,10,2234921
marRp,14.333333333333334,44,2,ATACGAAACGACAGATCGAC,42,2249788
marRp,2.6666666666666665,9,2,ATACCTCCCCTTACAGTGGT,7,2224421
marRp,0.6666666666666666,3,2,ATAATAGCCCGTAGCAGTTC,1,2220393
marRp,1.0,4,2,ATAAATCCCGGGGACAAATC,2,2238358
marRp,2.3333333333333335,8,2,ATAAAGATGCAAATTCATTT,6,2232026
marRp,6.333333333333333,20,2,AGTTTTCGCCCTCCGACTCG,18,2250723
marRp,2.3333333333333335,8,2,AGTTGTAGAGTCCGGGTAAT,6,2243930
marRp,4.666666666666667,15,2,AGTTGGTTCCTGAGCATATG,13,2243825
marRp,4.333333333333333,14,2,AGGGCGGGAGCAAAGTCCCG,12,2227640
marRp,1.6666666666666667,6,2,AGGCTTCTCTGGCTACAGGC,4,2234894
marRp,11.333333333333334,35,2,AGGCGCTCTATCCAACCGTG,33,2259205
marRp,10.0,31,2,AGGCGAGAAGATAATTCATA,29,2244856
marRp,4.0,13,2,AGGCCGATTCTTAAGGGGGC,11,2238052
marRp,3.0,10,2,AGGCCAGCAGAGGGATTTGG,8,2233706
marRp,3.3333333333333335,11,2,AGGCAGGGAGTTCCCGGCAT,9,2227219
marRp,1.0,4,2,AGGATGTATTCAACGTCCCG,2,2235193
marRp,0.6666666666666666,3,2,AGGATGGCCAAGGTACTTTG,1,2247108
marRp,3.0,10,2,AGGAACAGCCGCTTTACTCG,8,2236488
marRp,4.0,13,2,AGGAACAAAATGCCATTAAT,11,2250957
marRp,5.0,16,2,AGCTTTAAAGAATGGCCCAC,14,2231798
marRp,44.666666666666664,135,2,AGCTTCAAGGTAAGGAGCTG,133,2223693
marRp,4.333333333333333,14,2,AGCTTACGATAGGTCCTTTA,12,2257735
marRp,1.3333333333333333,5,2,AGCTATACCCCACTATACGA,3,2236930
marRp,13.333333333333334,41,2,AGCGTTAGGCCATTGCACTA,39,2254898
marRp,9.0,28,2,AGCGCTGTATTTGCTCATAT,26,2249485
marRp,1.3333333333333333,5,2,AGCCTTTACGAAGAGTTGAC,3,2248449
marRp,1.6666666666666667,6,2,AGCCTGGTGTGATTTGGCAA,4,2235064
marRp,5.666666666666667,18,2,AGCATTTTTCAGATGAGATC,16,2222184
marRp,1.6666666666666667,6,2,AGCAAACGGGTGAAAGGCGA,4,2257571
marRp,5.0,16,2,AGATTTTCTGTTGATAAACA,14,2232138
marRp,30.0,91,2,AGATGAGTGGATATGTGCCT,89,2253019
marRp,1.3333333333333333,5,2,AGATAGAACCCAACCATGAA,3,2249845
marRp,11.666666666666666,36,2,AGAGTGCTCAGTGATCATCG,34,2249177
marRp,6.0,19,2,AGAGAAACTCTTGCATTGGC,17,2254122
marRp,6.333333333333333,20,2,AGACTGGACGTAATGTAAAC,18,2238413
marRp,1.0,4,2,AGACTACAGCTGCTGATGTC,2,2236736
marRp,16.333333333333332,50,2,AGACGCGTTTGTCGATACAT,48,2231180
marRp,4.333333333333333,14,2,AGACCTAAACCGAGTAGTGA,12,2253270
marRp,2.3333333333333335,8,2,AGACCGTACAAAACGTGGAT,6,2221243
marRp,3.3333333333333335,11,2,AGACCATAGGAAGTGCTGCG,9,2237441
marRp,3.0,10,2,AGAATTGTATACCTCTCTGC,8,2257358
marRp,1.0,4,2,AGAACCACTTATCCTTATGA,2,2243451
marRp,2.6666666666666665,9,2,AGAAACTGGTGCTGTCTCCG,7,2248414
marRp,1.0,4,2,AGAAAACGCGGTTTTTGGTA,2,2244502
marRp,1.0,4,2,ACTTGTTTTGTATTGGAGGA,2,2225634
marRp,9.0,28,2,ACTTCGAATCCCATTTTTAT,26,2233449
marRp,8.0,25,2,ACTTAAGTGTATTCGAACAG,23,2257310
marRp,4.333333333333333,14,2,ACTGTTCGCCCAAACGCCGA,12,2256336
marRp,4.333333333333333,14,2,ACTGGTACTGTGGGCACCAG,12,2249806
marRp,6.666666666666667,21,2,ACTGGCGGGTTTTCATGAAA,19,2230376
marRp,7.666666666666667,24,2,ACTGGACTCACGATATAATT,22,2238569
marRp,2.6666666666666665,9,2,ACTATGATATCTTGAGTGGT,7,2226551
marRp,9.666666666666666,30,2,ACGTAATGCAAGCGATCTTG,28,2232705
marRp,3.6666666666666665,12,2,ACGGCTTTCCAAACGTCCGC,10,2241995
marRp,0.6666666666666666,3,2,ACGCCTTCACACGTACGGGT,1,2239812
marRp,1.3333333333333333,5,2,ACGCAGCAATGTGAGTAGCG,3,2223080
marRp,1.6666666666666667,6,2,ACGCACCGGGTCTGCTAGCA,4,2231455
marRp,3.0,10,2,ACGATGGACCTTGAGACTAG,8,2245819
marRp,4.666666666666667,15,2,ACGATCTACTCACCCGCGAT,13,2228525
marRp,7.666666666666667,24,2,ACGAGCGTGAAACTCGATAG,22,2234366
marRp,3.6666666666666665,12,2,ACCTTTCACTCAGGCCACGG,10,2245472
marRp,33.0,100,2,ACCTTCTCACCATGCTATAA,98,2227862
marRp,3.0,10,2,ACCTGGATTGCATCTTATCA,8,2251346
marRp,3.3333333333333335,11,2,ACCGCGTAAACGGGTCAGCC,9,2223929
marRp,3.6666666666666665,12,2,ACCGATGTCTTTTGAGAACC,10,2238987
marRp,12.666666666666666,39,2,ACCCGTTAAGGCCCTGGGTA,37,2242403
marRp,36.0,109,2,ACCCGCTAGATCGGGTGTTA,107,2238111
marRp,1.6666666666666667,6,2,ACCCATGTCTGGTGCAGTTA,4,2260092
marRp,2.6666666666666665,9,2,ACCATGTCGGTACAAATCTC,7,2226852
marRp,1.6666666666666667,6,2,ACCAGCATTCTGGCCTTTTA,4,2232240
marRp,13.333333333333334,41,2,ACCAAACCCCTTAAAAAATC,39,2251230
marRp,3.3333333333333335,11,2,ACATTACAGGATCCACAAAT,9,2226195
marRp,10.333333333333334,32,2,ACATGTAGGGTGGCTAGCAG,30,2225691
marRp,36.0,109,2,ACATCTGCGGGGCCGTGCAA,107,2258831
marRp,1.3333333333333333,5,2,ACAGGTTTAACCTCAGACAA,3,2219174
marRp,6.333333333333333,20,2,ACAGCAAAAGAGCGTACCAC,18,2223992
marRp,8.333333333333334,26,2,ACACGGGGCCATCAGACATG,24,2221879
marRp,2.0,7,2,ACACGCCCGTAGTTGGAATT,5,2226752
marRp,9.333333333333334,29,2,ACACGACTTATACCTTTATA,27,2233238
marRp,20.333333333333332,62,2,ACACGAACTACTTGACACTC,60,2240618
marRp,3.3333333333333335,11,2,ACACACAGAAACCCGTCGCT,9,2218310
marRp,4.333333333333333,14,2,ACAACTCGGTTGCCGTCCAG,12,2259452
marRp,2.0,7,2,AATTTTCTGGATACGCATGG,5,2240294
marRp,7.333333333333333,23,2,AATTAATAAAGTTAACTTCC,21,2260354
marRp,20.0,61,2,AATGGTCCCAGCATCGCCGG,59,2221281
marRp,2.0,7,2,AATGAGTATGATCGCGCGGT,5,2258692
marRp,1.0,4,2,AATCCGGTCGCGGGCTATAG,2,2243649
marRp,7.0,22,2,AAGTTGAGTTGAATAGACTA,20,2230171
marRp,5.333333333333333,17,2,AAGTTCCCTCTTAAGTAATG,15,2226731
marRp,5.333333333333333,17,2,AAGTCCGTAGAACTTTCCCA,15,2225973
marRp,1.0,4,2,AAGTATGAAGTAGTTGTTCA,2,2251854
marRp,6.333333333333333,20,2,AAGTATCCGGTTGCACAATT,18,2227112
marRp,0.6666666666666666,3,2,AAGTACAGGAGCCATCCATA,1,2258482
marRp,0.6666666666666666,3,2,AAGGGTTTCTATTCCATGAA,1,2222925
marRp,1.6666666666666667,6,2,AAGGCCTCTTTTAGTGTCAA,4,2224288
marRp,6.0,19,2,AAGCTTTTGCGTCCGTAGCG,17,2234218
marRp,3.6666666666666665,12,2,AAGCGGCGCGGCGTCCACTC,10,2256689
marRp,18.0,55,2,AAGCCGACTAGCGTAGTGCG,53,2253994
marRp,1.6666666666666667,6,2,AAGCCCGACCTGTTTGAAAA,4,2231936
marRp,2.6666666666666665,9,2,AAGCACTGGCGAACTCGTGT,7,2228785
marRp,4.333333333333333,14,2,AACTTATAAAGGTTACTCTT,12,2230772
marRp,0.6666666666666666,3,2,AACTTAGCCCGAGAATCCTA,1,2260094
marRp,1.0,4,2,AACTACGTCTCATATTTCCC,2,2256165
marRp,1.6666666666666667,6,2,AACGGCTCTGAGCAAATTAT,4,2221595
marRp,3.0,10,2,AACGCTACGGTTCCAGGATC,8,2225811
marRp,7.333333333333333,23,2,AACGCGGGCCGCCCGCCACT,21,2234020
marRp,2.0,7,2,AACCAGATTACTCAAGGGGA,5,2250109
marRp,2.0,7,2,AACAAATTTGCTTAGCACGG,5,2239811
marRp,0.6666666666666666,3,2,AACAAAGTTTGTGTCGCCTC,1,2244762
marRp,0.6666666666666666,3,2,AAATTAGTAACCCGCTCTCT,1,2220955
marRp,2.0,7,2,AAATGGTGTCTATCGAAGCA,5,2229719
marRp,10.0,31,2,AAATCAGAGTTCGACATTAA,29,2236048
marRp,1.0,4,2,AAATAGGGCTTTGCAAATGG,2,2244286
marRp,2.6666666666666665,9,2,AAATACTGGCGCAACTAAGT,7,2238962
marRp,25.666666666666668,78,2,AAAGGAATTATCCGGTTGGT,76,2223661
marRp,2.3333333333333335,8,2,AAACGTCGGTAAACCGCCAT,6,2255756
marRp,3.0,10,2,AAACACGTTCGACGGGCTTA,8,2248324
marRp,1.3333333333333333,5,2,AAAATTTGTATATCACGCCA,3,2237750
marRp,45.333333333333336,137,2,AAAAGCAGTGATGGGTAGTG,135,2219043
marRp,30.0,60,1,TTTTTTACGGGGGTTCCAGA,59,2228987
marRp,3.0,6,1,TTTTCTAACCTTGAATGGCA,5,2256414
marRp,9.5,19,1,TTTTCGTAAAGCTAGATATC,18,2260547
marRp,3.0,6,1,TTTTAGCTTTATCCGAAAGG,5,2240610
marRp,7.5,15,1,TTTGTCCGCACTGTCTCGCT,14,2254436
marRp,1.5,3,1,TTTGGTAACATCAAAGCCTA,2,2234830
marRp,3.0,6,1,TTTGGAACTTGGATTCCGAG,5,2237386
marRp,1.0,2,1,TTTGACCCCCTAGCCAGCGG,1,2226455
marRp,9.5,19,1,TTTCTCGGAATTGGGCAGCG,18,2218824
marRp,4.0,8,1,TTTCTCACTGAGGGAAGGTG,7,2256176
marRp,11.0,22,1,TTTCGGGGTACAAGTAAACC,21,2250802
marRp,12.5,25,1,TTTCCAAGTTAATGTCCATC,24,2255778
marRp,4.0,8,1,TTTCAACCATTCGCCGATTT,7,2225377
marRp,4.0,8,1,TTTACTCACCTCCGCTCTGG,7,2227204
marRp,9.0,18,1,TTTACCTATGGTGCCCAGGA,17,2257719
marRp,3.0,6,1,TTGTTCGTAACTTTCCGTCC,5,2245436
marRp,16.5,33,1,TTGTATACTCAACACAATGT,32,2242876
marRp,2.0,4,1,TTGGTTTGACAGGCTACGTA,3,2235561
marRp,2.0,4,1,TTGGTTCGCCGGCTGTGCGT,3,2218541
marRp,18.0,36,1,TTGGTCTCAGCTTCCAACAT,35,2251628
marRp,1.0,2,1,TTGGTCCTCGTTAAACCTTC,1,2220046
marRp,2.5,5,1,TTGGTCATACGACGGCGCAG,4,2236328
marRp,2.5,5,1,TTGGTCAGATGGTAAACACG,4,2222589
marRp,2.0,4,1,TTGGGCTGCCATCTACGGTT,3,2230065
marRp,1.0,2,1,TTGGCGTAGGTCTGGGTCTG,1,2230877
marRp,33.0,66,1,TTGGCAAGGAGGAAGCAGGA,65,2250412
marRp,1.0,2,1,TTGGAACTGCTACGTCAGCG,1,2259095
marRp,1.5,3,1,TTGCTAAAAAGGCTTCGAAT,2,2229299
marRp,12.0,24,1,TTGCGCATCGGTCGTGGAGG,23,2239504
marRp,9.0,18,1,TTGCGAGTCGTGATTCAGAT,17,2226498
marRp,1.0,2,1,TTGCCGACACCAAGCCAAGC,1,2226487
marRp,9.5,19,1,TTGCCATGATAGAAGGTACA,18,2219079
marRp,1.0,2,1,TTGATATCCCAGAACGGCCG,1,2249798
marRp,31.5,63,1,TTGACTGACGTTAATCTGGC,62,2252404
marRp,6.0,12,1,TTGACCGGACACAGCAAGAC,11,2249338
marRp,2.0,4,1,TTGAATGACCCGATGCTCCC,3,2253850
marRp,2.5,5,1,TTCGGCACACTTTGTCGCCG,4,2261065
marRp,11.0,22,1,TTCGAGAGGATGCCAGACGT,21,2225769
marRp,12.5,25,1,TTCCTCTCTTCCAGTTCTGT,24,2230754
marRp,2.5,5,1,TTCCTCAGGGACCGCCTTCA,4,2242443
marRp,3.5,7,1,TTCCGTTTCTCACCTGAGAA,6,2224991
marRp,1.5,3,1,TTCCGAAGGGAAATTCTTCT,2,2225349
marRp,17.5,35,1,TTCCCTATGATTCGTTCCGC,34,2221793
marRp,54.0,108,1,TTCCAGGGGGCTCCCCCAGA,107,2226480
marRp,10.0,20,1,TTCCAGCGGCATTCATACCG,19,2233709
marRp,5.0,10,1,TTCATGGTCGCATATAGTCT,9,2255445
marRp,1.0,2,1,TTCAGGGTAGATTAGAGGGA,1,2251832
marRp,7.5,15,1,TTAATGAATTACTTAAGCAT,14,2222862
marRp,2.5,5,1,TGTTTTAGTAGAATAATAGA,4,2250338
marRp,7.5,15,1,TGTTTTACCCAAGAAGAATT,14,2225320
marRp,12.0,24,1,TGTTTAGATGTCCTGATATA,23,2224744
marRp,5.5,11,1,TGTTATCGAAACCATCGGAT,10,2247792
marRp,2.0,4,1,TGTGGCGGCGGTGCACAGAC,3,2222625
marRp,1.5,3,1,TGTCGTAACATCGATGTCTC,2,2239213
marRp,4.0,8,1,TGTCCTCGGCCAGGAACTCC,7,2258343
marRp,1.5,3,1,TGTCCAACTTTGGAGATTCG,2,2226932
marRp,5.0,10,1,TGTAAAGATCTGGTTGGTTC,9,2254909
marRp,1.5,3,1,TGGTTCTCACCAGGTGCAAT,2,2244784
marRp,35.5,71,1,TGGTATACCTTTCTGGTCAT,70,2226490
marRp,18.0,36,1,TGGTAGATAGGGAGCCGCGG,35,2259764
marRp,1.0,2,1,TGGTAATGCAGTGTGAATGT,1,2247375
marRp,1.0,2,1,TGGGGTAGCCAGATGATATA,1,2242575
marRp,3.0,6,1,TGGGGCCACCACGGTATGCT,5,2229683
marRp,4.5,9,1,TGGGGATGCAGACATGATAA,8,2229999
marRp,4.5,9,1,TGGGCCTAATGCTAGCGGCC,8,2225403
marRp,2.0,4,1,TGGGAGTATGCATCTGCTCG,3,2232858
marRp,6.5,13,1,TGGCTACTGCTCTATAAGTT,12,2238616
marRp,3.5,7,1,TGGCGTACACAATCTCGTTC,6,2234454
marRp,8.5,17,1,TGGCGGGTAGGTTGACCAGG,16,2241773
marRp,47.0,94,1,TGGCGCGACAGCTCTCATAC,93,2227867
marRp,5.5,11,1,TGGCCGACTTTATCACGGTC,10,2226681
marRp,11.0,22,1,TGGCATTTTGGAGTGCAGAG,21,2218693
marRp,6.5,13,1,TGGACTCCCCTCACGGAACC,12,2235297
marRp,24.5,49,1,TGGAAACGCATGCTCCCTCG,48,2218994
marRp,1.5,3,1,TGCTTAAATACAATGCATGT,2,2256613
marRp,11.5,23,1,TGCTCGGCCGGACCTCGGCT,22,2240892
marRp,1.5,3,1,TGCTAGTATGCCGTTCACCT,2,2227437
marRp,3.5,7,1,TGCGAAGATACTACTCCCAC,6,2234243
marRp,1.0,2,1,TGCCGGAAGGAAACGTACGA,1,2250301
marRp,1.5,3,1,TGCCGAAAGGCAGACTGGTC,2,2219450
marRp,5.0,10,1,TGCCCCTGTATGGTATAGGG,9,2239668
marRp,15.0,30,1,TGCCATTGTGTGGGGCCTCT,29,2228528
marRp,5.5,11,1,TGCCAGTTAGAGTAAGAATC,10,2227424
marRp,6.0,12,1,TGCCAATATCGCCATCTTGG,11,2247584
marRp,7.0,14,1,TGCAGCATGGACCCCCGGTG,13,2242502
marRp,1.0,2,1,TGCAGAAGGTTCTGTAACTG,1,2246670
marRp,7.5,15,1,TGCACAGCGGTATCCATCAG,14,2260769
marRp,1.0,2,1,TGATCGATAGGTTCGGCCCT,1,2256956
marRp,20.0,40,1,TGATATACGGAAACAGAAAA,39,2249054
marRp,5.0,10,1,TGAGTCGTGATGAGAACGGT,9,2231884
marRp,8.0,16,1,TGAGGATATGGTGGTAAGTG,15,2228737
marRp,2.5,5,1,TGAATTTCCTCGGTGTGTGT,4,2236497
marRp,1.0,2,1,TGAAGACCACCGATGAAGAC,1,2255686
marRp,4.5,9,1,TGAAAGCGGAGCAAACTTTC,8,2246123
marRp,3.5,7,1,TCTTTCCCACCGTTCGGGCA,6,2230865
marRp,9.0,18,1,TCTTGGTGCCGAGGAATACC,17,2230484
marRp,12.5,25,1,TCTTGACCTGTGGTACCGCA,24,2252921
marRp,9.0,18,1,TCTTAGCGCAATGAGAATAG,17,2255392
marRp,2.0,4,1,TCTGTCGTAAACGCTCGTAG,3,2234718
marRp,3.5,7,1,TCTGGCGCATCGGTTCACTG,6,2256589
marRp,9.0,18,1,TCTGCTTAGTGCATCCACCA,17,2229888
marRp,1.0,2,1,TCTCGACGGCGGACACACGT,1,2260593
marRp,5.5,11,1,TCTATAGCGCTGGACTGATC,10,2236975
marRp,7.5,15,1,TCTAATTTGTATGTCCGCTA,14,2240762
marRp,2.5,5,1,TCGTGCCGGACGTAGTCTCT,4,2240848
marRp,6.0,12,1,TCGGTATAAAGTGAGTAAAT,11,2219850
marRp,19.0,38,1,TCGGCGCGTGCAGCGCGTGG,37,2250328
marRp,3.0,6,1,TCGGCCTTATCCGAGATCCC,5,2248879
marRp,79.0,158,1,TCGGAAGTCAGGCAGAACGA,157,2225326
marRp,1.5,3,1,TCGCTCGCGTGAAAGGTGTT,2,2220667
marRp,1.5,3,1,TCGCCGTAGAACTTGGCACA,2,2226365
marRp,13.0,26,1,TCGAGGTCGTTGCCCGAGGC,25,2257506
marRp,14.0,28,1,TCGACGTAACAGCTAAGTCC,27,2245360
marRp,1.5,3,1,TCGACACGCTTGAGCTTGGT,2,2258773
marRp,3.5,7,1,TCCTGCTTGTTATTAGTTAT,6,2259660
marRp,22.5,45,1,TCCTGATTTCCAAAGATGAA,44,2243870
marRp,17.0,34,1,TCCTAAATCATAATTGCGCT,33,2253714
marRp,6.5,13,1,TCCCGGGGTAGAGCGCGTGC,12,2227365
marRp,2.5,5,1,TCCCGCTTCAAAGCATGGCA,4,2254448
marRp,5.0,10,1,TCCCCAGAACGTCAACGGTA,9,2248511
marRp,1.0,2,1,TCCACGTACAGCTCAATACA,1,2228669
marRp,1.5,3,1,TCCAAAATTGTGTAGTCGGA,2,2252801
marRp,1.0,2,1,TCATAAGATTGTAATGTTCT,1,2248647
marRp,39.5,79,1,TCAGGACGACTGTCTTTGTA,78,2239250
marRp,2.0,4,1,TCAAGGATACATTTGTTACG,3,2236745
marRp,13.0,26,1,TCAAATGGATCACAACCGCC,25,2244804
marRp,11.5,23,1,TATGTTTAGGGGGGTTGAAA,22,2261016
marRp,6.5,13,1,TATGGGTGTAGGCTCGCACC,12,2241942
marRp,7.0,14,1,TATGGGTGAAGGTTACATTC,13,2251225
marRp,7.0,14,1,TATGCCGTCTATTACCTTTA,13,2247048
marRp,7.5,15,1,TATGCATAGATGCGACATCA,14,2238568
marRp,3.5,7,1,TATCTTCCCCGTGGACGAAC,6,2228731
marRp,8.5,17,1,TATCTAGGTCGTGCTATCCC,16,2252036
marRp,2.5,5,1,TATCGGGCTGGATATCTCAA,4,2222941
marRp,15.0,30,1,TATCGCTAGAATATATGCCT,29,2247451
marRp,44.5,89,1,TATCATTCACTGATTAAGAC,88,2238933
marRp,17.5,35,1,TATATCACTCCGACTCGGGG,34,2248003
marRp,3.5,7,1,TATAGTCATCGTCAGTTAGT,6,2256883
marRp,9.0,18,1,TATACCCTTCGGTATTAGAG,17,2240240
marRp,14.0,28,1,TATAAGCCGCCAAGATAATG,27,2257434
marRp,8.5,17,1,TATAAAGATCGAACTTGCTG,16,2228688
marRp,1.0,2,1,TATAAAGAGGTAACTGCGAT,1,2225891
marRp,6.5,13,1,TAGGTCACTGTTGTGGTCAG,12,2239348
marRp,3.0,6,1,TAGGATTCTGCATTGGTTAA,5,2261058
marRp,1.0,2,1,TAGCTTCGTCCTTTACCAAG,1,2249979
marRp,9.5,19,1,TAGCGGAGCATGCTGACAGC,18,2243030
marRp,5.5,11,1,TAGCGCATTACGTCCCATGT,10,2258222
marRp,1.0,2,1,TAGCCTGAACTTACGTGGGA,1,2245552
marRp,1.5,3,1,TAGCCTCACGGCTTTTCGTG,2,2254941
marRp,1.0,2,1,TAGAGGCGTGTGGTAAATCG,1,2251839
marRp,1.0,2,1,TAGAGCTAATACGCATGGAC,1,2232597
marRp,3.5,7,1,TACTGCCATTAGCGAGTTGG,6,2251427
marRp,2.0,4,1,TACTACTTGAGGGTGCTTTT,3,2247566
marRp,3.5,7,1,TACTACCGCCTTCTGCTATA,6,2218833
marRp,13.0,26,1,TACTACAGAAATTTCTTTTA,25,2259648
marRp,31.0,62,1,TACGTGCGAGGGTTTTCTGA,61,2238946
marRp,6.0,12,1,TACGGATTCGCCTTTCGGGT,11,2244843
marRp,8.0,16,1,TACGCTATACACAGCGTCAG,15,2226351
marRp,4.5,9,1,TACGCACTGTTAGGGCGTGT,8,2260012
marRp,19.0,38,1,TACATTACCGGTCCTGGGAC,37,2257473
marRp,1.0,2,1,TACATCGCATGACGAAGGGA,1,2233327
marRp,4.0,8,1,TACACCCGCGATCCAAAGGG,7,2220213
marRp,2.5,5,1,TACACCCGCATAAAGTACTC,4,2250027
marRp,1.5,3,1,TAATTCCACGCCTAAGCCTC,2,2246948
marRp,6.0,12,1,TAAGGCAACAAGGGATTCGT,11,2251531
marRp,5.5,11,1,TAAGCACAAGGTGTCCGTAT,10,2258980
marRp,15.5,31,1,TAAGCAAGGAGAGGCTACGA,30,2246539
marRp,52.5,105,1,TAACTGTTTTAGGCGGGGCT,104,2238104
marRp,3.0,6,1,TAACCAATGTTTCCTGGGTG,5,2239214
marRp,23.5,47,1,TAAATGGCGTGCGTTCTCCT,46,2245234
marRp,1.0,2,1,TAAATCAGGATCGGATCATA,1,2242093
marRp,4.0,8,1,TAAAGTAAATGAATGGGGGG,7,2249694
marRp,10.0,20,1,TAAAAGAGCCTTGGCCTTTT,19,2222926
marRp,1.0,2,1,GTTTGAGTCCGTTGTCGTGT,1,2243989
marRp,5.0,10,1,GTTTGAGGGACCGATAATGA,9,2250745
marRp,6.0,12,1,GTTTAGTGAGAATATTATGC,11,2229791
marRp,16.0,32,1,GTTGTGGCCGGGCTTAGGAC,31,2240592
marRp,3.0,6,1,GTTGTATGGAAAGCACTGGA,5,2218146
marRp,1.0,2,1,GTTGGTGGCGCTCAGGAGAG,1,2232341
marRp,6.5,13,1,GTTGCATGCCACGGAAATAC,12,2221934
marRp,9.5,19,1,GTTGATATCAGGGTTGCAAT,18,2235000
marRp,61.0,122,1,GTTCTATAGGCTGGTATAAT,121,2250837
marRp,3.5,7,1,GTTCATGTTTTCGAGTCGAT,6,2259021
marRp,1.0,2,1,GTTATGCTTTACCTTAATAT,1,2253640
marRp,9.5,19,1,GTTATACCTCGTAGTACCGA,18,2219821
marRp,65.5,131,1,GTTACGGTTCCGGCTTCCTT,130,2220528
marRp,3.0,6,1,GTTACGACTGTCTGTCAGAC,5,2257604
marRp,10.5,21,1,GTGGTTCTAGGGACCCGCGT,20,2258834
marRp,3.0,6,1,GTGGTGGGTTCGGAGCTCAG,5,2225174
marRp,17.0,34,1,GTGGTCAGTGTGCACCAGTA,33,2227879
marRp,1.0,2,1,GTGGGTTCTAGCGGGCTAAT,1,2221521
marRp,4.0,8,1,GTGGGATGGCCTATTGACGG,7,2257811
marRp,3.5,7,1,GTGCTTTGCATATGTCTCTG,6,2255278
marRp,2.0,4,1,GTGCCCTCAAGCTGTAGCGC,3,2259734
marRp,7.0,14,1,GTGAGCTCTTTAGCCGGAGA,13,2222224
marRp,29.0,58,1,GTGAGCGCGTATAACGTATC,57,2255989
marRp,34.5,69,1,GTGAACAGGGGCCGTCTCCC,68,2221799
marRp,15.5,31,1,GTCTTCGCGCGGGTGAACAG,30,2236881
marRp,2.0,4,1,GTCTCTAAATTAAGGGGCTC,3,2245198
marRp,3.0,6,1,GTCTACTCGCCCTAGTTTAC,5,2234950
marRp,1.0,2,1,GTCGTGGCCCCTCGGTAGGC,1,2255631
marRp,5.5,11,1,GTCGGCTGCAGCTTTTTGGC,10,2250194
marRp,9.0,18,1,GTCGCTGTCGTAGTCACCAC,17,2236616
marRp,15.0,30,1,GTCGATCGCAAACATAACAA,29,2249504
marRp,44.5,89,1,GTCCTGTACGTGATCGATGG,88,2231932
marRp,13.0,26,1,GTCCTGAGGGCCAACATGTG,25,2223263
marRp,10.5,21,1,GTCCGGCAATAACATTACTA,20,2225346
marRp,7.0,14,1,GTCCAGAACAGTCTCTGACA,13,2225353
marRp,64.0,128,1,GTCCACAATTCCGGGCAAAC,127,2233742
marRp,4.0,8,1,GTCATAATCAGATTAAACTT,7,2247397
marRp,2.0,4,1,GTCAGTCACCATTAGTGCTT,3,2251988
marRp,9.5,19,1,GTCACTGCCAACTTTGTGTT,18,2222987
marRp,10.0,20,1,GTCAAAACTGTAAAACTCCG,19,2249969
marRp,1.5,3,1,GTATCTCTAGTAGCGCCTCG,2,2246822
marRp,4.0,8,1,GTATCACAACCAACGAACAG,7,2238857
marRp,26.5,53,1,GTAGGAGCCCGGCTGGCATG,52,2240703
marRp,12.0,24,1,GTAGAACGGACCACCCCCCG,23,2255216
marRp,8.0,16,1,GTACTTTGGACCTTTACCGC,15,2223180
marRp,8.0,16,1,GTACTGCAGTGAGTTTTCAT,15,2226970
marRp,4.5,9,1,GTACGGTTGATACCTGGCTT,8,2259164
marRp,22.5,45,1,GTACAGTTGTATGTGCACAC,44,2227431
marRp,7.0,14,1,GTAAGCCCGATAGGGAAAAA,13,2239385
marRp,40.0,80,1,GTAAGATCCCGGCTGGACAT,79,2260745
marRp,5.5,11,1,GTAAGATCATCTTGCACTTG,10,2236318
marRp,2.0,4,1,GTAACCCGACTAGAGGTTAC,3,2228527
marRp,1.0,2,1,GGTTTAAGACGCGAGAACGG,1,2261064
marRp,6.0,12,1,GGTTAGATTCCATGTACTTC,11,2245229
marRp,6.0,12,1,GGTTACCTGGTGACACTGCG,11,2234911
marRp,8.0,16,1,GGTGTATCCGGGTCCTAAAC,15,2233684
marRp,1.0,2,1,GGTGGTCGCGAGACTTATTT,1,2248861
marRp,10.0,20,1,GGTGGATGAGAAAGCGAACA,19,2238919
marRp,6.0,12,1,GGTGAGGTGTATAACACAGC,11,2250041
marRp,15.5,31,1,GGTGAGGCCCCCTCAGACTT,30,2251432
marRp,11.0,22,1,GGTCAGCGATCGCTTTATAT,21,2237887
marRp,17.0,34,1,GGTCAAGTTGTTCACAGATG,33,2221297
marRp,1.5,3,1,GGTCAACTGGTAGGTGTAAT,2,2240595
marRp,11.0,22,1,GGTATATACCGGATTACCAG,21,2223139
marRp,3.0,6,1,GGTACAGGGCATGACCACTT,5,2222377
marRp,7.0,14,1,GGGTGTCGCTTTGTATCGGT,13,2254526
marRp,7.0,14,1,GGGTGCACGTTCAAGTACAC,13,2230781
marRp,34.5,69,1,GGGTCCCCGACCCAGGATTA,68,2230385
marRp,1.0,2,1,GGGTATTCGGGATCACTCAG,1,2254704
marRp,18.0,36,1,GGGGTGGAGAGTACTTACCT,35,2231861
marRp,20.5,41,1,GGGGGCGTGACTCACTCACT,40,2254524
marRp,5.0,10,1,GGGGACGGTCGGGTTAATCA,9,2218019
marRp,8.5,17,1,GGGCGTTCAAGACTCAGGAT,16,2226604
marRp,35.0,70,1,GGGCGTACTCCTCTCGCGGG,69,2243865
marRp,134.5,269,1,GGGATCATACCTGCTGTTTA,268,2222776
marRp,12.5,25,1,GGGATACCTGCGAAGACGAT,24,2256696
marRp,1.5,3,1,GGGACCGACCCCTTTTCCCT,2,2222966
marRp,17.5,35,1,GGCTTCCGGATCACAACATA,34,2228172
marRp,7.0,14,1,GGCTGTACAGTTCCCTACCT,13,2229429
marRp,1.5,3,1,GGCGCAAATTTCATCGGCTA,2,2250198
marRp,5.0,10,1,GGCCGCCATTAAGTGTACCT,9,2249302
marRp,1.5,3,1,GGCCGAACCCGAACCATACA,2,2230327
marRp,4.5,9,1,GGCCCCTACAGATTTTTTAG,8,2250907
marRp,2.0,4,1,GGCCAGCCGCGGCAGATTCA,3,2223234
marRp,2.0,4,1,GGCCACTTGAACTACCCGTC,3,2245812
marRp,4.0,8,1,GGCCACATCCGAGAGGGCAT,7,2245638
marRp,5.5,11,1,GGCATTTTATTTAGCTGAGT,10,2232373
marRp,3.0,6,1,GGCATTAAAACCCTCAACAC,5,2240168
marRp,1.0,2,1,GGCATACGCAATCTTGCACT,1,2248824
marRp,4.5,9,1,GGCAATTCAAGATTCCCGCC,8,2250439
marRp,11.0,22,1,GGCAATAGCCAGAAATTTAT,21,2233501
marRp,1.0,2,1,GGCAAGTGGCGTTGAGGGGT,1,2220709
marRp,1.0,2,1,GGATGCTGATATTAACACGA,1,2219393
marRp,6.0,12,1,GGATCCAAATTGTGGCCATC,11,2240448
marRp,6.5,13,1,GGATAATGTAATTTCATTGA,12,2230382
marRp,31.5,63,1,GGAGTCCCCAGCGGCCTTTA,62,2251791
marRp,2.5,5,1,GGAGTAGTCAGTTTGCCAGT,4,2239350
marRp,18.0,36,1,GGACGTTATCAATGGATTGA,35,2244936
marRp,32.0,64,1,GGACGCCCGCTCGGTTCAAA,63,2251781
marRp,26.5,53,1,GGACGATAGGTGAGCCCGCT,52,2240788
marRp,65.5,131,1,GGACGACTTTACCGAAAAAT,130,2253904
marRp,2.0,4,1,GGACAGAGTACAGGTGAAGG,3,2247105
marRp,9.0,18,1,GGACACATTAGCTAAGTCGA,17,2251797
marRp,5.5,11,1,GCTTCGTGTTTCGTTATTAG,10,2218346
marRp,1.0,2,1,GCTGCTCGTTGTGGCCATAC,1,2258715
marRp,2.5,5,1,GCTGATGTGAAGTGCATCGT,4,2226180
marRp,14.5,29,1,GCTGATACATTTATAACAAA,28,2245694
marRp,1.5,3,1,GCTCGTACGAGAAACTCCAC,2,2239507
marRp,4.0,8,1,GCTCGGGTACGTTGGTACTG,7,2250362
marRp,12.0,24,1,GCTCGAGACACGCCCATACA,23,2257725
marRp,1.0,2,1,GCTCAGGATCGTGACCAAGC,1,2236949
marRp,4.5,9,1,GCTATTCCTTTAGATGAATA,8,2232868
marRp,18.0,36,1,GCTATCGGATTTTCCTTGCG,35,2246378
marRp,2.5,5,1,GCTAGCCAGCCCCAGTGTTC,4,2229180
marRp,5.0,10,1,GCGTGACTTGTGGGATTATA,9,2244792
marRp,13.0,26,1,GCGTAGAAGAAGGTAGACAT,25,2258882
marRp,1.0,2,1,GCGTAACTAGCCCTTGCATG,1,2236156
marRp,3.0,6,1,GCGGTCAACAGCACAGTGTA,5,2226243
marRp,1.5,3,1,GCGGGGCTCGTATGCTATCC,2,2223607
marRp,2.5,5,1,GCGGCCAGATAGTACTTGAA,4,2221669
marRp,3.5,7,1,GCGCTCGAAGCCCCGAATTT,6,2256047
marRp,3.0,6,1,GCGCGTGTTACCCCCTTTAC,5,2240852
marRp,1.5,3,1,GCGCGCCTCAGGTGACGGAC,2,2258234
marRp,3.0,6,1,GCGCGCATCACCGGGCGGTA,5,2244293
marRp,5.5,11,1,GCGCAGTACTGTTAGTCAAT,10,2234070
marRp,1.0,2,1,GCGATAGAGCGCGTGAAAAG,1,2229754
marRp,7.5,15,1,GCCTTCGCTACCTTTGCCGT,14,2220700
marRp,3.5,7,1,GCCTCGAAGCGCTCATGCGT,6,2242649
marRp,1.5,3,1,GCCTATATCATCTGGACTCG,2,2226595
marRp,1.0,2,1,GCCTAACGGGATGTGTCGAA,1,2222069
marRp,1.0,2,1,GCCGTATTGGGGGGAATCGG,1,2226982
marRp,2.0,4,1,GCCGCGTGGTATGCATGGGG,3,2248920
marRp,1.0,2,1,GCCGCCGCAGCAATGCCGAA,1,2230835
marRp,4.0,8,1,GCCGATCCTCAGTTTTTACA,7,2240796
marRp,22.0,44,1,GCCGACAGGTTCCTAGCGAT,43,2223997
marRp,3.5,7,1,GCCCCAGCTGAGTCTCTAAT,6,2218518
marRp,2.5,5,1,GCCCAGTTCTGATTATGTCC,4,2257210
marRp,5.0,10,1,GCCCAAATAAGTCACCCAAC,9,2227088
marRp,1.0,2,1,GCCAATATGGAAAACGCATT,1,2218904
marRp,24.5,49,1,GCATTGACTCGTCGAAGACA,48,2260756
marRp,5.0,10,1,GCAGACGCAAGATATCAGAC,9,2255296
marRp,2.5,5,1,GCACAACCTCACAGTTACCC,4,2233858
marRp,1.0,2,1,GCACAAAACGCACCATACGT,1,2222539
marRp,1.5,3,1,GCAAGGTTTCGAGTGGATAT,2,2251717
marRp,6.0,12,1,GCAACTCGCGGAACCCCCTA,11,2251404
marRp,3.5,7,1,GCAACCGAGGTTGCACTGGT,6,2243790
marRp,30.0,60,1,GCAACAAGGGATCTATTCGC,59,2221556
marRp,6.5,13,1,GCAAAAGCCGGTCAAAATCC,12,2225045
marRp,4.0,8,1,GCAAAAGATAGAAGGCCTCA,7,2227880
marRp,16.0,32,1,GATTATTACGCCCACGACGG,31,2256695
marRp,29.5,59,1,GATTAGGTGCCAGTTGTCCC,58,2240613
marRp,1.0,2,1,GATGTATGACCAGTGTTCGG,1,2255178
marRp,6.5,13,1,GATGGAGGCTTGACTCGCCC,12,2248693
marRp,3.0,6,1,GATGCAACAGCTTAAGGTGT,5,2229053
marRp,6.0,12,1,GATCGCGAGGTGGTCCTGTT,11,2238293
marRp,2.5,5,1,GATCCTCGATCGGCAGTTCG,4,2252777
marRp,13.0,26,1,GATACTTTCAAATGGGTGGT,25,2247776
marRp,2.0,4,1,GAGTGGGTGCTCTCATTAAT,3,2241513
marRp,9.0,18,1,GAGGGGCCCTCCCTGTTATA,17,2253643
marRp,29.0,58,1,GAGGGCGACATCGAAATAGG,57,2229612
marRp,1.0,2,1,GAGGGACACCTTTTCAAACT,1,2225979
marRp,2.5,5,1,GAGCTGGTTTATGGATCGGT,4,2258741
marRp,3.0,6,1,GAGCCTTTAAGCTAACCAGT,5,2240511
marRp,4.5,9,1,GAGCCCGATTTCTGGAATTT,8,2260171
marRp,4.0,8,1,GAGCCAGCTTGTAAATTTCC,7,2222739
marRp,64.5,129,1,GAGATGCAACTAACGCTATC,128,2256371
marRp,2.0,4,1,GAGAATAGAGATCAAGCCAC,3,2226165
marRp,33.0,66,1,GACTGCCGTGCTTGATCCAA,65,2250169
marRp,2.0,4,1,GACTGCATCTCGTTCATTTG,3,2228177
marRp,59.0,118,1,GACGCCATCCGACCAGCGGA,117,2253896
marRp,2.0,4,1,GACCTGAGTCTCCCCTCGGT,3,2218203
marRp,3.5,7,1,GACCGACAAGGATAGGTGTA,6,2259643
marRp,3.5,7,1,GACCCCGTTCCGGAACTTAT,6,2245759
marRp,50.5,101,1,GACCCAGACTATCATAGCCC,100,2238123
marRp,7.5,15,1,GACCATCTATCGCTACTTGC,14,2240290
marRp,11.0,22,1,GACAGCGTGATAGTGTTAGG,21,2219007
marRp,3.0,6,1,GAATGGTAAGCAGCATATAT,5,2229111
marRp,18.0,36,1,GAATACCCGGAGATAACTCA,35,2257664
marRp,2.5,5,1,GAAGTTCCTAGCGTTAGAGT,4,2224369
marRp,8.5,17,1,GAAGGCTCAGTCACTCCCTG,16,2243670
marRp,6.0,12,1,GAAGACGGAACAGTACCATC,11,2224622
marRp,27.0,54,1,GAACGCATAGGCGTAAGCGC,53,2234987
marRp,4.0,8,1,GAACGAGAGATGGATGATGT,7,2221005
marRp,6.5,13,1,GAAATTATGTGCCTTAAGCT,12,2237394
marRp,3.0,6,1,GAAACTTTCACATCCCCGAT,5,2232273
marRp,5.0,10,1,GAAACATACCCTTTTCTCCA,9,2247295
marRp,9.5,19,1,GAAACAGGCATTGATGTGTG,18,2255945
marRp,1.0,2,1,GAAAAGCCAGAGCATCGGAA,1,2220737
marRp,3.0,6,1,CTTTTTACGGCTGGTCATCC,5,2221712
marRp,4.0,8,1,CTTTGAACCCAAGCCTCTAG,7,2223849
marRp,5.0,10,1,CTTGTCTCACGTCTTACAAG,9,2231814
marRp,2.5,5,1,CTTGCCAGACCAATGCGCGG,4,2253793
marRp,23.0,46,1,CTTGCAATAACAGCCGCTCT,45,2254892
marRp,1.0,2,1,CTTCTGAAGATTTAAATCAT,1,2244060
marRp,8.5,17,1,CTTCCTTCCGCGGACCGGTA,16,2230788
marRp,6.0,12,1,CTTATGTCCGAGTTGCCACA,11,2253544
marRp,4.0,8,1,CTTAGTCTGAACTGCATCAT,7,2220554
marRp,10.0,20,1,CTGTGCGAATGCGTTATTAT,19,2242615
marRp,84.5,169,1,CTGTCATGGTGTAAATGGCC,168,2251079
marRp,3.0,6,1,CTGTCAGTGCGACCGCAAAA,5,2224661
marRp,6.5,13,1,CTGTCAAGGGGCAGGCCCCA,12,2234467
marRp,8.0,16,1,CTGGTGTACCTTAACGGATA,15,2224932
marRp,30.0,60,1,CTGGGGTACCTGACAACATC,59,2244576
marRp,8.0,16,1,CTGGCTCAGGATGTGCAATC,15,2221066
marRp,7.0,14,1,CTGCTTGGATCTATTTTTGG,13,2248227
marRp,9.0,18,1,CTGCGAACTAGGTATAGGTC,17,2236495
marRp,4.0,8,1,CTGCCTTTGTGGGTGGCAAA,7,2247435
marRp,10.5,21,1,CTGCCCTTATTATCCGTATA,20,2238595
marRp,1.5,3,1,CTGATTGTAAGGAGTGCTGG,2,2246970
marRp,40.5,81,1,CTGAGACTGCCACGCGAGGC,80,2222341
marRp,1.0,2,1,CTGAGACAAACTGGTGGAAA,1,2220687
marRp,9.5,19,1,CTGACTACACTGTACAGCCT,18,2233506
marRp,2.0,4,1,CTGACCTGTTCTGCTGTATT,3,2226144
marRp,4.0,8,1,CTCTTGGCCTATTTCAGCGG,7,2231664
marRp,4.5,9,1,CTCTGGATGACCGGAAAGCC,8,2237648
marRp,14.0,28,1,CTCTGCCTTTTCATTCCTGT,27,2257681
marRp,6.0,12,1,CTCTGATCGTAGTATCCGGG,11,2260225
marRp,12.5,25,1,CTCTACCCACCAGGTGAACC,24,2235243
marRp,25.0,50,1,CTCGGAGTTCTGTTCCTGGA,49,2237465
marRp,17.5,35,1,CTCGCGACTCAACAGTAATG,34,2240008
marRp,3.5,7,1,CTCGCAATAAGGCTTGGACT,6,2258812
marRp,4.0,8,1,CTCCAAATTAAACCACTTAC,7,2219602
marRp,1.5,3,1,CTCATTTTTTCACCATAAAC,2,2250398
marRp,3.5,7,1,CTCAGGTGTGCAAGCAATCG,6,2235898
marRp,4.5,9,1,CTCACGGATGGGATAGTCAA,8,2244989
marRp,1.0,2,1,CTCAACCGCGCTATTACACC,1,2237923
marRp,4.0,8,1,CTATGATTCTTAACTACATA,7,2229768
marRp,2.0,4,1,CTATACTTATCTTGAAGTGG,3,2249755
marRp,15.0,30,1,CTAGTAAACAGAAAGACCTA,29,2237475
marRp,4.5,9,1,CTAGGGTCGCTAAAATGCTT,8,2239512
marRp,3.0,6,1,CTAGAGTGGCCCGTGGCACA,5,2236722
marRp,5.0,10,1,CTAGAGTGCTTACGCGGGAC,9,2249763
marRp,1.0,2,1,CTACGGATGGCCTGGCTGCT,1,2230212
marRp,20.0,40,1,CTAACTCGATCATCTTGTTG,39,2220526
marRp,40.0,80,1,CTAACGCTGTTATCGTACAG,79,2251783
marRp,43.5,87,1,CTAAACGTAGGGCAAGCTGG,86,2255309
marRp,3.5,7,1,CGTTGTTGCTTACCGTCCAG,6,2253391
marRp,16.0,32,1,CGTTGAATAGAATGACCATG,31,2240787
marRp,3.5,7,1,CGTTCATATCTAGTGTAGTT,6,2249056
marRp,21.0,42,1,CGTTATACGGATCACTGGAA,41,2219025
marRp,2.0,4,1,CGTGTTTGGCCGGTTGGGAT,3,2234727
marRp,1.0,2,1,CGTGCTATCGATGCCCAGGA,1,2222513
marRp,1.5,3,1,CGTGCAAGAGCAATGTCCGC,2,2223801
marRp,5.5,11,1,CGTGACTTCAAACGACCTAT,10,2257588
marRp,3.5,7,1,CGTCTACTTAGCGAGCGACG,6,2241225
marRp,1.5,3,1,CGTCGGTCGAGCCGCGGCTT,2,2230514
marRp,18.5,37,1,CGTAGCCCAGGGGACGTTTC,36,2238670
marRp,3.5,7,1,CGTACAGTCGTGTGGTCCTT,6,2232870
marRp,26.0,52,1,CGTAAAATTCTCGCGTAGCA,51,2223290
marRp,1.5,3,1,CGGTTTCTAGCGGGGTGTAC,2,2254835
marRp,2.5,5,1,CGGTTGTATAGCTCAACCGG,4,2258294
marRp,12.5,25,1,CGGTTGGAAGCGTCCGACCC,24,2228963
marRp,11.0,22,1,CGGTGGCGTAGCGCTGAAGG,21,2221413
marRp,10.0,20,1,CGGTAATGGAACTCAAGGTA,19,2227044
marRp,14.5,29,1,CGGGGTGAGTTACTCTTGGA,28,2236574
marRp,9.5,19,1,CGGGGCAGACTCAGCACGCG,18,2252400
marRp,30.0,60,1,CGGGACGACGTGTCTGTCGT,59,2259491
marRp,1.0,2,1,CGGGACCGGTGCCTATCGGA,1,2245585
marRp,3.0,6,1,CGGGAATTCTCATCCGGCAA,5,2260280
marRp,1.5,3,1,CGGCTTACGTGTTCTCAAGC,2,2256333
marRp,126.5,253,1,CGGCTCGTGTAAATAGACAA,252,2250835
marRp,1.0,2,1,CGGCGTGGCTCGAACGGGTC,1,2222489
marRp,7.0,14,1,CGGCCGATTATAAGTAGGTA,13,2253380
marRp,2.5,5,1,CGGAGGCATTCGATCAGGTG,4,2252610
marRp,12.5,25,1,CGGACTCCGATTAACATCCC,24,2258872
marRp,1.5,3,1,CGCTCTTGTAGTATTTTTCA,2,2225558
marRp,13.5,27,1,CGCTCAGCCAGTTCAGAGGC,26,2236357
marRp,5.5,11,1,CGCTACACGTTAGGGACTGC,10,2242797
marRp,16.5,33,1,CGCGTCCACGACCGCGACTA,32,2220506
marRp,31.0,62,1,CGCGGCCTCAGCTAAACATG,61,2241503
marRp,10.0,20,1,CGCGCACGAGTGTTTTAAAT,19,2242207
marRp,5.5,11,1,CGCGAACACGTCATTCGTAA,10,2249161
marRp,7.0,14,1,CGCCCTACAATGAGTCCCCT,13,2254262
marRp,15.5,31,1,CGCCCCTTGTCTTCGGCTCC,30,2222876
marRp,2.0,4,1,CGCAAAAGGCGCATGGTACT,3,2235335
marRp,11.0,22,1,CGATTGATTGTTCATATTTT,21,2247976
marRp,2.5,5,1,CGATTGATCCGAGCATGATC,4,2228339
marRp,6.0,12,1,CGAGCCGCAGATAGTGATCA,11,2251029
marRp,4.0,8,1,CGAGATTCGTCGTGGAGGGA,7,2224470
marRp,9.0,18,1,CGAGATACAACATTCGTTAC,17,2227248
marRp,4.0,8,1,CGACTGCCCGAAGCGCAAGG,7,2242283
marRp,3.5,7,1,CGACTCTCTATATTGGGAAA,6,2232997
marRp,15.5,31,1,CGACCTTCAGAGACCTTTGT,30,2238132
marRp,16.0,32,1,CGACAGGGTGTCCCGTTTAA,31,2234992
marRp,6.0,12,1,CGACACCCGGTGGTTGCTCG,11,2218306
marRp,9.5,19,1,CGACAATTTCAACTCTACCG,18,2257412
marRp,18.5,37,1,CGAATCTCGCTGTCAGGGCG,36,2223307
marRp,8.5,17,1,CGAATCCGGGAGACCGGACG,16,2226903
marRp,2.0,4,1,CCTTTTTCGCGCTGCAATGA,3,2259982
marRp,2.0,4,1,CCTGTACAAACCAGAAGCCC,3,2231526
marRp,2.5,5,1,CCTGATTGAAGTTGAACGGC,4,2237637
marRp,3.5,7,1,CCTGAAGCAAGGCAAAGGGC,6,2225049
marRp,9.5,19,1,CCTCAGTAAAATGTGTGACA,18,2223456
marRp,12.5,25,1,CCTATTGATATGGATTTGTC,24,2247598
marRp,4.5,9,1,CCGTTGTTGCATTGGCGTAG,8,2256352
marRp,21.5,43,1,CCGTTGGTTCTTAGAGACAT,42,2242864
marRp,3.0,6,1,CCGTGCATCATGCTCAATGC,5,2238477
marRp,6.5,13,1,CCGTCGTACGCGATGCTGTG,12,2226513
marRp,15.0,30,1,CCGTCAAAGCAGCCCTCTGA,29,2223126
marRp,1.0,2,1,CCGTATCTCTAGCTAGAGAG,1,2259444
marRp,2.5,5,1,CCGTAGGGGCGGCTATGATC,4,2225702
marRp,6.5,13,1,CCGGGTTAGGACTGTACACA,12,2234128
marRp,1.0,2,1,CCGGGTCCAGAAGGCTACGT,1,2246113
marRp,7.0,14,1,CCGGGGCCATAGGGTAGAGC,13,2259081
marRp,17.0,34,1,CCGGGGATGGTCGCTAGATT,33,2259566
marRp,5.5,11,1,CCGCTACTTATTCGTTCCCT,10,2251704
marRp,3.0,6,1,CCGCGGGCTTTCGTTGGGAG,5,2248832
marRp,2.5,5,1,CCGCCCATGCTGGGAGCGCT,4,2254303
marRp,6.0,12,1,CCGCCATTCACTCAAGAACT,11,2244934
marRp,18.5,37,1,CCGACAGTAGGTCACACCAA,36,2235019
marRp,3.5,7,1,CCCTTTTGATGGACGTATGT,6,2222415
marRp,2.5,5,1,CCCTTTCTGGCAGTCGTATG,4,2245023
marRp,3.5,7,1,CCCTCACCTCTCCCTGTATA,6,2225197
marRp,5.0,10,1,CCCTAGTAGAAGCAATGGTG,9,2255364
marRp,4.5,9,1,CCCTAATATCAGCCTTGACA,8,2231164
marRp,9.0,18,1,CCCGTTTTTGATTAACTGGT,17,2231931
marRp,1.0,2,1,CCCGTTTGTGATCATAAGTT,1,2234080
marRp,41.5,83,1,CCCGTAGTTTGTCCGCAGAA,82,2230473
marRp,5.5,11,1,CCCGGGGACCCCCAACGCTC,10,2248686
marRp,1.0,2,1,CCCGGGCCATATAACAGTAT,1,2237552
marRp,17.0,34,1,CCCGGCGGGTTCTGGTGCTC,33,2222037
marRp,18.0,36,1,CCCGGCCACGCACCGGGGTA,35,2256727
marRp,14.0,28,1,CCCCTATGCAGTACCGGAAA,27,2260535
marRp,8.5,17,1,CCCCGGGCTCTCACTCGTTA,16,2247033
marRp,18.0,36,1,CCCCGCCCTAATCAGCAACT,35,2228249
marRp,15.0,30,1,CCCCCTCTCCTAAATCCACG,29,2231093
marRp,1.5,3,1,CCCCCATCTTGCCGCTGCAA,2,2249934
marRp,6.5,13,1,CCCAGTCGCTACCAAGAATA,12,2227804
marRp,5.0,10,1,CCCAATTTGCTGGTTCTTGG,9,2249305
marRp,1.0,2,1,CCCAAATTTAACATCAGGAT,1,2224234
marRp,20.5,41,1,CCATTGCAACTTGCAGATAC,40,2250716
marRp,8.0,16,1,CCATGGGGTTTATCTTGATG,15,2245099
marRp,7.5,15,1,CCATATTTGAAATGTTTCTT,14,2248095
marRp,4.0,8,1,CCATATCGCTAACGGGCGGT,7,2219608
marRp,2.5,5,1,CCATAACACCTTCATGGCAT,4,2253706
marRp,1.0,2,1,CCACTTGCTGACATATCCGC,1,2253510
marRp,4.0,8,1,CCACTACGCCGGAAACGCCA,7,2260123
marRp,1.5,3,1,CCACGCTCTCTACTGGGACC,2,2227583
marRp,1.5,3,1,CCACGCGTCCCTACGACGAA,2,2260921
marRp,1.5,3,1,CCACCCTCACGGGGGCGCTT,2,2221896
marRp,6.0,12,1,CCAATACTTGGGTACAAACA,11,2238783
marRp,7.0,14,1,CCAAGGTTTGAAGGGTGAAT,13,2220791
marRp,4.5,9,1,CCAAGGTGAACGTACAGCTA,8,2260503
marRp,2.0,4,1,CCAAGCGGCTTTGTTCGTTT,3,2227661
marRp,41.5,83,1,CCAAGAGTTCAACGATCGGG,82,2235289
marRp,2.5,5,1,CCAACTGGCCTCTGGGGGCA,4,2225137
marRp,3.5,7,1,CCAACTAACCCGTCAGGGTT,6,2240422
marRp,8.5,17,1,CATTTATATCAGTTCGAACT,16,2255737
marRp,9.5,19,1,CATTCTCAAGCTACATGCAT,18,2234908
marRp,1.5,3,1,CATTCCGCGTAAATTCCTAT,2,2232055
marRp,1.5,3,1,CATGTGCCTAAATTGCCTTT,2,2258641
marRp,4.0,8,1,CATGGTAAAAGCGAGGAAGA,7,2243160
marRp,3.5,7,1,CATGGGGCTGATCATACTAC,6,2231056
marRp,4.0,8,1,CATGGGAATCAGTCTGCCTG,7,2247696
marRp,3.5,7,1,CATGGATGTTAATCCGCCGC,6,2233007
marRp,4.0,8,1,CATGACGTTCTCATATGTCA,7,2248519
marRp,6.5,13,1,CATCCTGGGAAATGCGAACC,12,2226901
marRp,6.5,13,1,CATCCGAGTGTCGATGGGGC,12,2224957
marRp,2.5,5,1,CATACGGTCCGACAGGGTAC,4,2255642
marRp,5.0,10,1,CATACACACGTAAAGGTTCT,9,2230763
marRp,2.5,5,1,CAGTGGCGGTATCTCATGGC,4,2235235
marRp,6.5,13,1,CAGTCCCCCGTCTACTGTAT,12,2243422
marRp,15.5,31,1,CAGTCAACTGCGAAGATCTA,30,2244977
marRp,6.0,12,1,CAGTACTTCATCGTGATGGT,11,2226804
marRp,17.5,35,1,CAGGTTTTGTACGTACTTAT,34,2235938
marRp,11.0,22,1,CAGGTTCCTTACCGATGCGC,21,2220083
marRp,5.0,10,1,CAGGTTAATCCATCGGGGTT,9,2221215
marRp,4.5,9,1,CAGGTGGATCTTAAAAGCCA,8,2236501
marRp,37.5,75,1,CAGGGTTCGTTCGTCCCAAT,74,2257779
marRp,5.0,10,1,CAGGGTCCGCCGGTCCCTGC,9,2257637
marRp,3.5,7,1,CAGGATTTTGAAAATTCTAC,6,2227182
marRp,2.5,5,1,CAGCTGTCGATCGTGTAGGG,4,2243642
marRp,3.5,7,1,CAGCATCTGACCGTGGCGGT,6,2222713
marRp,28.0,56,1,CAGATGTGTTCAAATGCTAG,55,2243438
marRp,26.5,53,1,CAGACCCTCTCAACTGGTTA,52,2241915
marRp,9.5,19,1,CAGACACTTGGGTGGGGCGA,18,2237192
marRp,7.0,14,1,CAGAATCTTATAGCTGCAAA,13,2221429
marRp,5.5,11,1,CACTATTCGATGAGAGTTAA,10,2239531
marRp,17.5,35,1,CACTAAACAGAAAGTTTTTG,34,2218732
marRp,2.0,4,1,CACGTCCCGCTTGAACTAGG,3,2254953
marRp,9.5,19,1,CACGTCAGGGATTATAGGTT,18,2241454
marRp,1.0,2,1,CACGTAGAGGTACTTGCGTT,1,2239049
marRp,12.0,24,1,CACGGTAAGGTGCGTCCTGT,23,2254525
marRp,12.0,24,1,CACGCGGTATCTGAACCAAG,23,2255184
marRp,24.0,48,1,CACGATACGATTTTATTGGT,47,2257017
marRp,49.5,99,1,CACGAACTGCGGGCGGGTTA,98,2257022
marRp,5.5,11,1,CACCATGTCCTGCCGAGCAT,10,2237543
marRp,2.5,5,1,CACAAAAGTTGATAAGCTCA,4,2237201
marRp,22.5,45,1,CAATTGGAAGAGGCAGAGCA,44,2245062
marRp,2.5,5,1,CAATTCTATTATGAATGAGT,4,2253035
marRp,25.5,51,1,CAACTTGTGGAATCTTGTAA,50,2241597
marRp,8.0,16,1,CAACTGATCGTCTTGAGGAT,15,2259893
marRp,13.0,26,1,CAACTGAGAAAACTCAAATA,25,2247591
marRp,32.5,65,1,CAACGGATACGGGACCATCA,64,2246869
marRp,3.0,6,1,CAACCTGCCGTACTTATGAA,5,2225058
marRp,26.5,53,1,CAAATAACGTCACCGAACTG,52,2238114
marRp,6.0,12,1,CAAAGCAGGGAAATTGCCAG,11,2233200
marRp,5.5,11,1,CAAACTAAGCGACACTCGAC,10,2221327
marRp,23.5,47,1,CAAACAAGCTGGCACTCGCA,46,2245690
marRp,1.0,2,1,ATTTGTTACGTCTGCACCAG,1,2226415
marRp,8.5,17,1,ATTTCAGCGGTTTTCTGGCT,16,2254109
marRp,20.0,40,1,ATTTAACATCGAACGGAACA,39,2246701
marRp,29.0,58,1,ATTTAAATGCACCCACTGTT,57,2258710
marRp,9.5,19,1,ATTGTTGGTGTGCATATGTA,18,2235248
marRp,10.0,20,1,ATTGTTCAGTGGTTCCGGTA,19,2241583
marRp,15.5,31,1,ATTGTGTTAACACTGAATTG,30,2251064
marRp,3.0,6,1,ATTGTGATGCAGATACAAGA,5,2254735
marRp,2.0,4,1,ATTGTATTAAGGGGACAGTC,3,2236223
marRp,2.0,4,1,ATTGAAACGGTTGAAACTGC,3,2239275
marRp,20.0,40,1,ATTCTCCGTGCATCCCCCTA,39,2256941
marRp,6.5,13,1,ATTCTAATCAGCCTGGCTCA,12,2257145
marRp,7.5,15,1,ATTCGTGGGCGGTGCTACAA,14,2240374
marRp,14.5,29,1,ATTCGCTAACCTGGAACTCC,28,2245415
marRp,4.0,8,1,ATTAGGTTGTCTTGCTTACA,7,2250960
marRp,2.5,5,1,ATTAGCTGTATTGGTTCGTA,4,2235791
marRp,6.0,12,1,ATTAGCACGCGCATACCTAT,11,2257462
marRp,3.0,6,1,ATTAACCTGTATTCTATGTG,5,2227863
marRp,5.0,10,1,ATGTGTTATCGGCGCTAGGA,9,2258729
marRp,3.0,6,1,ATGTCTGTGGCTGCGTTGAC,5,2220679
marRp,21.5,43,1,ATGTCCGGAGATAGTGTTCG,42,2239333
marRp,19.5,39,1,ATGGGTCCTTGCGGAGTTCG,38,2228630
marRp,13.0,26,1,ATGGGAGCGTCCTATGTTTG,25,2218305
marRp,2.0,4,1,ATGGCGTTCGAGGGACCAGT,3,2242539
marRp,3.5,7,1,ATGGCCCGGTTGGGCCACGC,6,2230030
marRp,15.0,30,1,ATGGAAAAACCGCGAGCCGC,29,2232630
marRp,1.0,2,1,ATGCTTATTCGTCTACTTAG,1,2256193
marRp,6.5,13,1,ATGATAGTACCAAGGCTCGG,12,2225408
marRp,11.0,22,1,ATGAAAAAATGCTGTTATAT,21,2251813
marRp,30.0,60,1,ATCTCCAAAGGTGGATGGGT,59,2222958
marRp,9.0,18,1,ATCTCAATCACTGCTCTCTT,17,2242875
marRp,5.5,11,1,ATCGTACTGGCCGTTAGTAA,10,2247551
marRp,1.5,3,1,ATCGGCTGTATCTTAGGGTA,2,2218149
marRp,6.0,12,1,ATCGCGGTTCCTAGGGTGGA,11,2235075
marRp,18.5,37,1,ATCCTTACACTGCCGAGAGA,36,2259740
marRp,15.5,31,1,ATCCTATGGGCATTAATGGC,30,2218739
marRp,6.5,13,1,ATCCTATATTAATTTACCAT,12,2247046
marRp,9.5,19,1,ATCCTACAGGCGCTGGAATA,18,2236835
marRp,12.5,25,1,ATCCGTTAGACGGCTATCAT,24,2240984
marRp,11.5,23,1,ATCCGTCGCCTTGCTCTAGC,22,2241929
marRp,1.0,2,1,ATCCATGAGTCTTTGCTCCA,1,2241730
marRp,3.0,6,1,ATCCACTTAGCATTATTTGG,5,2242094
marRp,18.0,36,1,ATCATCTAGATTGTCTTATT,35,2249926
marRp,3.0,6,1,ATCAGTATGAGGCGCGCCCA,5,2237935
marRp,16.5,33,1,ATCAAGGGCATGAAAAACGT,32,2258194
marRp,4.0,8,1,ATATGTGATCTGACAAGCCC,7,2239235
marRp,3.5,7,1,ATATGAGTTCACGAGAAAAG,6,2255037
marRp,2.0,4,1,ATATCGGCGTTTACAAAACC,3,2223109
marRp,1.5,3,1,ATATCCAGTCGGACCTACCT,2,2247966
marRp,12.0,24,1,ATATAGTTTCCCAGCAGCGT,23,2253848
marRp,3.5,7,1,ATAGGTGGGAACGGTGGAAC,6,2239599
marRp,1.0,2,1,ATAGGCCAGCACTCTGTTCT,1,2242493
marRp,1.0,2,1,ATAGCACGCCGTTGCGACCA,1,2238484
marRp,6.5,13,1,ATAGCAATACGGGCGTGGCT,12,2237565
marRp,2.5,5,1,ATACTTGAGTGCAAGTGGAT,4,2256348
marRp,7.5,15,1,ATACGTGAAGCTAGCAATCT,14,2259650
marRp,24.5,49,1,ATACGATTTTCAGTTCGGTT,48,2238991
marRp,2.5,5,1,ATACGAGGGGGGTGCATTGC,4,2226920
marRp,5.5,11,1,ATAAGGGACCAGATACCGGG,10,2229844
marRp,3.5,7,1,ATAAATCTGGGAATTCGTAT,6,2221421
marRp,2.0,4,1,AGTTGCGAGGTGGTTGCAAT,3,2226740
marRp,8.5,17,1,AGTGAGGCTTGTGTAGAATT,16,2252495
marRp,5.5,11,1,AGTCTCCATGGGATTCGGTG,10,2240478
marRp,1.5,3,1,AGTCGTGTCGATACACGTTC,2,2246933
marRp,2.0,4,1,AGTATCGGGCTTGCGTCCGT,3,2239723
marRp,4.0,8,1,AGTACCGGCGCTTCGTACCC,7,2240629
marRp,12.5,25,1,AGTAAGTGTCATAATTCTTG,24,2234375
marRp,6.5,13,1,AGGTCGCATGCTAAGGTTCG,12,2227516
marRp,5.5,11,1,AGGTAAAGTCGCGCGCATTG,10,2258748
marRp,6.0,12,1,AGGGTTCCTGCGCGTACCAG,11,2244941
marRp,1.5,3,1,AGGGGTCAACTGGGGGAGCC,2,2244973
marRp,7.5,15,1,AGGGCACTCAAGAGGATGAA,14,2242768
marRp,2.5,5,1,AGGGACATACAAAATCACTA,4,2229157
marRp,8.0,16,1,AGGCGTCTAACCGGATAAAT,15,2226456
marRp,9.0,18,1,AGGCGGGCGCTTACTACCCT,17,2224648
marRp,13.0,26,1,AGGCCACCGATATGACCGAA,25,2248993
marRp,8.5,17,1,AGGATTTTGCTAGCTATCAC,16,2260746
marRp,5.0,10,1,AGGATTTGAGGTTGCATTCA,9,2245232
marRp,1.0,2,1,AGGAGTGACGTCTATAGTAT,1,2226950
marRp,4.0,8,1,AGGAGGAGGAGGGTTAAGAT,7,2226239
marRp,10.0,20,1,AGGACACAGAAGGTGACGAC,19,2217786
marRp,1.5,3,1,AGGAAAGATACTTCCTCTTT,2,2229126
marRp,3.0,6,1,AGCTTTCGGATCGCATTCTA,5,2219438
marRp,6.0,12,1,AGCTCTGATTTTAATTCCTC,11,2254845
marRp,21.5,43,1,AGCTCCAGTATGCTTGTTAG,42,2240517
marRp,13.0,26,1,AGCTAAATGCTATACGACAT,25,2219004
marRp,16.5,33,1,AGCGGGGGTATCACGCTGAT,32,2234961
marRp,8.5,17,1,AGCGGAAGCCAGTACCGGAC,16,2245713
marRp,5.0,10,1,AGCGATTTCCATCGTAGAGT,9,2223267
marRp,3.0,6,1,AGCCGTATTCTTTCGTAGCC,5,2246374
marRp,8.0,16,1,AGCCCATCGATCGTATAATA,15,2243452
marRp,34.5,69,1,AGCCATTCGGTGGTACTGAA,68,2226572
marRp,28.0,56,1,AGCACACGGTTCATGACAGA,55,2254975
marRp,4.5,9,1,AGCAAATACACAACGGTGAT,8,2235451
marRp,9.5,19,1,AGAGTAGGTAGATCGACGGC,18,2246132
marRp,4.0,8,1,AGAGTAACTCGTTTCAGGCT,7,2221324
marRp,1.0,2,1,AGACCCATAGAGTTCGCTTG,1,2254255
marRp,2.0,4,1,AGACAGGCGAGGCTGTAGCC,3,2224586
marRp,6.5,13,1,AGAATCTGTGGACTACCTGC,12,2230826
marRp,2.5,5,1,AGAATACGTCTCGCCGTGCA,4,2257249
marRp,32.0,64,1,AGAACATACGCGACATAGTG,63,2231368
marRp,6.5,13,1,ACTTGGGAGCACGATTAGAC,12,2232686
marRp,4.0,8,1,ACTTCAAGGGTGAGTTCTAG,7,2250978
marRp,12.5,25,1,ACTGGGTACAGTACTGGGTG,24,2222594
marRp,24.5,49,1,ACTCTGCTGGTTGGCCGAGC,48,2221010
marRp,2.0,4,1,ACTCCATCTGCAAGGGGCCG,3,2254455
marRp,11.5,23,1,ACTAGACACTCAATGGGTAA,22,2242420
marRp,4.0,8,1,ACTACCCGGACTGAGTCTAC,7,2224642
marRp,12.5,25,1,ACTACAAACTAGCTGAGCTG,24,2219935
marRp,4.0,8,1,ACGTGTCAGGAATTCAACGA,7,2227476
marRp,5.0,10,1,ACGGGGGGACCTGCAAACAG,9,2255888
marRp,3.0,6,1,ACGGGCAGCTCACATGGCTA,5,2250810
marRp,8.5,17,1,ACGGGATCTCGTACTCACTC,16,2222523
marRp,4.5,9,1,ACGGCGCCGGGTGTAGCGGC,8,2234655
marRp,10.0,20,1,ACGGAGGTACCTTTATCGTG,19,2226832
marRp,3.5,7,1,ACGGAAGGTGATCGGCAGCA,6,2260355
marRp,4.0,8,1,ACGCTCGACACACAAACTCA,7,2243016
marRp,3.0,6,1,ACGATTGGGGGAGATCCGTT,5,2242309
marRp,18.0,36,1,ACGATTCGACACACCCAAGG,35,2234347
marRp,4.5,9,1,ACGACGCCTGCCGCCGGAGA,8,2223582
marRp,9.5,19,1,ACGACCAGGGGAGACACCAG,18,2227260
marRp,2.5,5,1,ACCTTGTATATTAACATCAC,4,2219925
marRp,6.0,12,1,ACCGCGGTTACGCTAGAATG,11,2238048
marRp,7.5,15,1,ACCGCGCGGCGTCCACCGAG,14,2247935
marRp,15.5,31,1,ACCCTTCTGTACAGTTAATA,30,2221493
marRp,3.5,7,1,ACCCCATGTTCGGCCACCAC,6,2233442
marRp,3.5,7,1,ACCAGGTGGGGCATAAGGGT,6,2233678
marRp,1.0,2,1,ACCACCGTGAACGTTGGAAC,1,2252068
marRp,3.5,7,1,ACATTTCTGTATTTTTCTTA,6,2250297
marRp,31.0,62,1,ACATTCCGGAAGAGCGGGCA,61,2224057
marRp,2.5,5,1,ACATTCCCGGGCCGGTGGAA,4,2240945
marRp,4.5,9,1,ACATATATGCGTACGCTAAG,8,2225709
marRp,1.0,2,1,ACATAGGTCTTTCTCGGTGG,1,2249162
marRp,8.0,16,1,ACAGTTTCATGATCAGGATT,15,2245757
marRp,10.5,21,1,ACAGTGATAGTCTTCAATAT,20,2233387
marRp,14.5,29,1,ACAGTGAAAGCCCCGTGGCA,28,2220556
marRp,30.0,60,1,ACAGGGGGCTTTAAAAGTGA,59,2225230
marRp,2.5,5,1,ACAGGCTGGCGCGCACACAC,4,2254765
marRp,3.0,6,1,ACAGGAGTAAGTGCCCTACA,5,2254483
marRp,4.5,9,1,ACAGACGTTCAGGTAGCAGT,8,2259222
marRp,9.0,18,1,ACACTCCATGTTTAAAACCC,17,2218690
marRp,13.0,26,1,ACACGGTCAAACCACGTTTC,25,2223807
marRp,1.5,3,1,ACACCGCAGGCCAGGCGTAT,2,2227941
marRp,9.0,18,1,ACACCACGAGGATCAGCCGG,17,2248445
marRp,9.0,18,1,ACACAACCATAAAGGAATCA,17,2224062
marRp,14.0,28,1,ACAATAGGACCGCTTTCAGC,27,2251880
marRp,1.0,2,1,ACAAGGACCCGTACCGGGCA,1,2242627
marRp,14.0,28,1,AATTTATGAATAGCGACAAG,27,2224595
marRp,3.0,6,1,AATTCGGAGGATAGCTGGCC,5,2245919
marRp,6.0,12,1,AATTATTTTTGTTTATCGGC,11,2223686
marRp,6.5,13,1,AATTAGCCCACAATGGTACA,12,2226177
marRp,9.5,19,1,AATTAACTTGTAAGTCTAGC,18,2234207
marRp,4.0,8,1,AATCTCCGGGCGTGCGCCGA,7,2230692
marRp,4.5,9,1,AATCCTCGCCTGGATGTCCA,8,2256454
marRp,16.0,32,1,AATCAGGAGTCGTATTAAGA,31,2218875
marRp,3.5,7,1,AATCAACGTCAAATGCGATA,6,2259517
marRp,22.5,45,1,AATATCGTAATTTAGACAGG,44,2247012
marRp,7.5,15,1,AATATCCTATGTGAACATAT,14,2258689
marRp,7.5,15,1,AATATAAGCTAAGTTAACCG,14,2260148
marRp,1.5,3,1,AATAGTTCAGACTTTCCAAG,2,2237400
marRp,2.0,4,1,AAGTTGCATCACGCGTGCTA,3,2243108
marRp,2.5,5,1,AAGGCCTTTTATGAACTCAT,4,2250425
marRp,7.0,14,1,AAGGAACATCCTTTGGAGAC,13,2231078
marRp,10.5,21,1,AAGGAAAATGGGTGCTCGTC,20,2254329
marRp,6.5,13,1,AAGCTTTAGACGCAATTAAG,12,2255183
marRp,11.5,23,1,AAGCTCTGAGGCCGGACTCT,22,2260370
marRp,4.5,9,1,AAGCTCGGGTAAAAAGCATT,8,2220833
marRp,4.5,9,1,AAGCGGTGAGCGGGTATCCC,8,2240268
marRp,6.5,13,1,AAGCATTAGCGAGCCCGACT,12,2242265
marRp,3.0,6,1,AAGCATGCAATTTGTGGCAG,5,2255180
marRp,2.5,5,1,AAGACTGATAATATCTCGTG,4,2232091
marRp,3.0,6,1,AAGAATCTCGATCTTAGCAG,5,2255520
marRp,1.5,3,1,AAGAATAATTGCTGACGCTT,2,2218941
marRp,5.5,11,1,AACGGAGTGTCAAAAGCCAT,10,2236102
marRp,3.5,7,1,AACGGAGCCCTGGTGAGGGC,6,2223414
marRp,28.5,57,1,AACGCTTACCAGTATTGTGC,56,2254529
marRp,2.5,5,1,AACGAGAATCAATCGTGTGA,4,2248299
marRp,6.0,12,1,AACCTGGGATTTTATGAACG,11,2258410
marRp,1.0,2,1,AACCGCCTATGCCTAAACAA,1,2225187
marRp,1.5,3,1,AACCACGCTTTCCCGTTGCC,2,2240479
marRp,3.0,6,1,AACCACCCGGTTATCCCACC,5,2241428
marRp,7.5,15,1,AACATTGAATTTTTGCTCAC,14,2224840
marRp,1.0,2,1,AACATCAGAAGTAAATGGCA,1,2248289
marRp,1.0,2,1,AACATAGCCGTCGAACGGAT,1,2241710
marRp,1.5,3,1,AACAAACTTTTCATGATAGC,2,2251560
marRp,7.0,14,1,AAATCCTTAAGTAGAGTACA,13,2236493
marRp,22.5,45,1,AAAGTCAGGCGACTACTGGC,44,2259732
marRp,4.0,8,1,AAAGTCAAGAGCAACCACAG,7,2228605
marRp,10.0,20,1,AAAGAAGTTCAAGACTGGCC,19,2253978
marRp,110.5,221,1,AAACGGAATCTCGCCGGAAT,220,2256382
marRp,4.5,9,1,AAACGAGATGGATCAATAGC,8,2224364
marRp,3.5,7,1,AAACAGCTAGCGGTTAATAC,6,2256112
marRp,9.0,18,1,AAACAGCGGCCCTCGGGCGT,17,2247051
marRp,2.5,5,1,AAAATACTGGCTGTATACTG,4,2221409
marRp,0.016666666666666666,59,59,TTCGGCGACCGCGACAGAAT,0,2249558
marRp,0.019230769230769232,51,51,TTTCCGTAATCGTACCGGTT,0,2256441
marRp,0.0196078431372549,50,50,CCTTGTCTCGGATTAGTCAC,0,2238590
marRp,0.021739130434782608,45,45,ACAGCGGGGATTCACGAAAG,0,2233824
marRp,0.022727272727272728,43,43,TGGAGATAGCGGTTTCGTCC,0,2229348
marRp,0.022727272727272728,43,43,AGGTAGTATTTCATTGATAT,0,2250224
marRp,0.023255813953488372,42,42,ATAAAGCGCTGCGACTTTCT,0,2244242
marRp,0.023809523809523808,41,41,TCGTGCACTTCCGGTCCATG,0,2235621
marRp,0.024390243902439025,40,40,ACCGATTGCGCTTGTATTAC,0,2226009
marRp,0.02631578947368421,37,37,AACAGATACACTGTAATTTA,0,2217885
marRp,0.02702702702702703,36,36,CACGCGGTAGCCCAGCTTGA,0,2220002
marRp,0.027777777777777776,35,35,TACGTATGCGCTTGACAGTG,0,2229371
marRp,0.02857142857142857,34,34,GCCAGCGTCCGGGAGAACAG,0,2232399
marRp,0.029411764705882353,33,33,TCGGACGCTACGCGAGGGAG,0,2224536
marRp,0.030303030303030304,32,32,TCTACAGGTGCGTTTACATA,0,2246478
marRp,0.030303030303030304,32,32,CCTTACCGATTGTGCCGAGT,0,2252806
marRp,0.03125,31,31,TAAGCTGGCCGGATGCGTGA,0,2221378
marRp,0.03333333333333333,29,29,TCCTGAACCGTGCGGTTTAA,0,2245330
marRp,0.03333333333333333,29,29,GTTGGTGTAAAGCCGCGCTA,0,2219677
marRp,0.03333333333333333,29,29,GAGTTAAAGAATGAGAGAGG,0,2222368
marRp,0.03333333333333333,29,29,CGGCGGTACCTTCCACGGAA,0,2235869
marRp,0.03333333333333333,29,29,ACACGCCCTGTGTCGTCATA,0,2248781
marRp,0.034482758620689655,28,28,TGTCCGTGGAGATGCCTCGT,0,2246193
marRp,0.034482758620689655,28,28,TAGACAGAGGCCTAGCTCGT,0,2240144
marRp,0.034482758620689655,28,28,GGATGGACAAAGTTTTCGCA,0,2232350
marRp,0.03571428571428571,27,27,GCGGTCTCACCGTTGCTGAT,0,2242812
marRp,0.03571428571428571,27,27,AGGGGTGGAGTATGCAGTAT,0,2233648
marRp,0.03571428571428571,27,27,AGAGGCTAAAAAGGGTATTT,0,2248677
marRp,0.037037037037037035,26,26,TGGCGGTTATCAGTCCAATG,0,2231327
marRp,0.037037037037037035,26,26,TATTTATGGTTACTCGTCAA,0,2244656
marRp,0.037037037037037035,26,26,GTTTGTGCAGGTGAGTGACG,0,2238768
marRp,0.037037037037037035,26,26,GAGTGAGGATTGCTTGTGTA,0,2232586
marRp,0.037037037037037035,26,26,ATACGGGGTACGTGGGCCGA,0,2257091
marRp,0.037037037037037035,26,26,AGTTCGTAATAGTGGTCTAC,0,2228420
marRp,0.038461538461538464,25,25,TTATCTTATATATTAGGCTA,0,2244700
marRp,0.038461538461538464,25,25,GAGGAGACCCCATCGGCTAA,0,2223969
marRp,0.038461538461538464,25,25,CGCCTGGATTAAGACACCGA,0,2219177
marRp,0.038461538461538464,25,25,CCCGGCCGCTAGGTTCAGGA,0,2229072
marRp,0.038461538461538464,25,25,AGCTCAAGCGGACGTAGGCT,0,2221739
marRp,0.04,24,24,TGGTCCACAGTATCGTTGCC,0,2227543
marRp,0.04,24,24,TGACATGAGTGGGAGCGGAA,0,2221209
marRp,0.04,24,24,GTTCCAGAGAATGCGCTAAC,0,2229178
marRp,0.04,24,24,GGCTTCTCCGCCAGTTAATT,0,2230553
marRp,0.04,24,24,GGAGTAAACGAAAATGACAG,0,2236926
marRp,0.04,24,24,GCCCCTGCTTTTAGCCAATA,0,2235594
marRp,0.04,24,24,CGAGGATTACTCTAGGCACT,0,2218119
marRp,0.04,24,24,CCAGGACCTAATGTAAATCC,0,2228919
marRp,0.04,24,24,CAAAAGATCCATGTTTTGTA,0,2251570
marRp,0.04,24,24,ATTTTCTTGGCAAAGTGGTA,0,2235649
marRp,0.04,24,24,AGTCTACGTGTACGCTTGCA,0,2246308
marRp,0.04,24,24,AAGACTTTGAGCCGTATGTA,0,2235828
marRp,0.041666666666666664,23,23,TTACTAGGATCTTCTCTTCA,0,2235985
marRp,0.041666666666666664,23,23,TCCAAAGTAGGCCATGGGGA,0,2244959
marRp,0.041666666666666664,23,23,GTCTCGGAACCGGACTTTGT,0,2220160
marRp,0.041666666666666664,23,23,GTATAGGGTCAGTCCTTGGA,0,2230644
marRp,0.041666666666666664,23,23,GCCGGTGATAACAATCTGCG,0,2234960
marRp,0.041666666666666664,23,23,GCACCCCGCCCGTAGAAAAG,0,2226953
marRp,0.041666666666666664,23,23,GATACTCTGTCGGCAATCCA,0,2229291
marRp,0.041666666666666664,23,23,AGAACACAAGTGCACCCCAG,0,2257037
marRp,0.041666666666666664,23,23,AATCCATTAGAATGCGGCTA,0,2234415
marRp,0.041666666666666664,23,23,AACCGGGCTCCTTAAGAACA,0,2225930
marRp,0.043478260869565216,22,22,TTGGCTCAGCCCGCTCTTCG,0,2254741
marRp,0.043478260869565216,22,22,GTGTCAGTGGGCTCAGATAA,0,2225471
marRp,0.043478260869565216,22,22,GGAATCTTGTACTTATAAAT,0,2225630
marRp,0.043478260869565216,22,22,GCTCTAACGTGCATTTGAGA,0,2226291
marRp,0.043478260869565216,22,22,GCAAAGCTGTGCCCTCGATG,0,2244735
marRp,0.043478260869565216,22,22,GATGAGATATCTTTTAAGGC,0,2237985
marRp,0.043478260869565216,22,22,CCCCCCAGCGCCAACTACAA,0,2252511
marRp,0.043478260869565216,22,22,CACGCTAGTTTACACACCTA,0,2222370
marRp,0.043478260869565216,22,22,ATCAGGTCCTGTATGCGGGT,0,2248804
marRp,0.043478260869565216,22,22,AGTTACCCTACCGTGTAGGA,0,2258231
marRp,0.045454545454545456,21,21,TGCCCAGAGGTAACTTAATA,0,2243366
marRp,0.045454545454545456,21,21,TAATGTTCTGCGAGAGAACA,0,2254474
marRp,0.045454545454545456,21,21,GTGGATGTAGTAGGTGTTTA,0,2249542
marRp,0.045454545454545456,21,21,GGTCAGCTCGGAGGTTACAA,0,2257121
marRp,0.045454545454545456,21,21,GCGCCCGCGAGTGGAGGTAA,0,2252814
marRp,0.045454545454545456,21,21,GCCGCTCTACTGGAAAATGT,0,2217837
marRp,0.045454545454545456,21,21,GAGGCTTCTGCGTAGCAGTA,0,2218756
marRp,0.045454545454545456,21,21,ATCTCGCATCTCCACTCTGA,0,2236173
marRp,0.045454545454545456,21,21,ATAGAATGGCGATCGTATGA,0,2220288
marRp,0.045454545454545456,21,21,ACAAGCCAAATCCATGTTTA,0,2222833
marRp,0.045454545454545456,21,21,AATGCCTTCTGAGGCGTGGC,0,2241035
marRp,0.047619047619047616,20,20,TTAGCACTGCATGCCTATCT,0,2221711
marRp,0.047619047619047616,20,20,TACACCATTCCCGTCCAAGC,0,2221656
marRp,0.047619047619047616,20,20,GTGTGACTCCTTATAGCGGC,0,2242852
marRp,0.047619047619047616,20,20,GGCGGGATCTTTTCCGGCTG,0,2233839
marRp,0.047619047619047616,20,20,GCCGGAGGCGTCTTGGAGCT,0,2251374
marRp,0.047619047619047616,20,20,CTTCGTCAGTGCACTTTCCT,0,2248909
marRp,0.047619047619047616,20,20,CTAGAAATCCGACTCTAAGC,0,2253561
marRp,0.047619047619047616,20,20,CGGGACCGCTGTTCTTAGTA,0,2230640
marRp,0.047619047619047616,20,20,CGCGAGATGGGTAGTACAGG,0,2220669
marRp,0.047619047619047616,20,20,CAGTCGCAACAGGGCCTAAT,0,2225728
marRp,0.047619047619047616,20,20,CAGGATAGGCTGATACTTTA,0,2242016
marRp,0.047619047619047616,20,20,AGGCCATCTATCATTAAACG,0,2227733
marRp,0.047619047619047616,20,20,AGCCAAAGGCGGTTAGAGAT,0,2229386
marRp,0.047619047619047616,20,20,AAGGCCGTCCCCACAATGTG,0,2231893
marRp,0.05,19,19,TGTCCAGCGAACATAACGTC,0,2248723
marRp,0.05,19,19,TGTCATACCCTGCCTCGGTT,0,2239911
marRp,0.05,19,19,TGGGGTGGAAAAAGTGCCCC,0,2256901
marRp,0.05,19,19,TCTGTATACTTTGCTCGGTA,0,2241467
marRp,0.05,19,19,TCGGGGCCAGCGTGATCATT,0,2252810
marRp,0.05,19,19,TCGATATAAAATATATTTGT,0,2219887
marRp,0.05,19,19,TCACCAGTTGCCGAACTCAT,0,2251571
marRp,0.05,19,19,TAGAAGTGATTCGGCCGTAA,0,2245019
marRp,0.05,19,19,GTCCTCGAAGCTGATTGGGT,0,2249339
marRp,0.05,19,19,GGGTTGGTGAGGTAAGAGAT,0,2258461
marRp,0.05,19,19,GGCATATAGTTAGCTATATC,0,2259020
marRp,0.05,19,19,GGAGCGATACTAGAGTGGGG,0,2228105
marRp,0.05,19,19,GATTTCAGAGATACGCTTCT,0,2261095
marRp,0.05,19,19,GACGCGATCTCGCATTCGAT,0,2221196
marRp,0.05,19,19,CTATGGGGTCAGGAAGGTTC,0,2244956
marRp,0.05,19,19,CGGGAACTAAGGAACGGCGG,0,2223733
marRp,0.05,19,19,CCAGTTCGGCCAGATTGCAT,0,2234733
marRp,0.05,19,19,CCACGCGCTGAGTACGGTGA,0,2233276
marRp,0.05,19,19,CCACGAGGGCACTTGGGCTA,0,2244655
marRp,0.05,19,19,CATTTGCGCGGCCCTCAGCA,0,2246531
marRp,0.05,19,19,ATTACTTCCAGTTTCTGCAA,0,2227520
marRp,0.05,19,19,ATGAATGTCCACCGACAGGG,0,2252976
marRp,0.05,19,19,ATGAATAGGGCTCCATTAAG,0,2232310
marRp,0.05,19,19,ACTCACACGATGTTAACGAT,0,2220455
marRp,0.05,19,19,ACGGTCATGGGTCACTTGTG,0,2232018
marRp,0.05,19,19,ACGGCCTCGAGCACTTGCTG,0,2250115
marRp,0.05,19,19,ACCGGGGGTCTAAGTGTCTA,0,2221360
marRp,0.05,19,19,ACCGCGTTCGGATCGGCAAT,0,2234721
marRp,0.05,19,19,AAGTCTTTGGATACACTAAT,0,2224166
marRp,0.05263157894736842,18,18,TCCAGTTGAAATCGCTGGTT,0,2219842
marRp,0.05263157894736842,18,18,TCACGCCCCGTGCCTAACGA,0,2234513
marRp,0.05263157894736842,18,18,TCAAGGTCGTAGAGGGAGTG,0,2235402
marRp,0.05263157894736842,18,18,TAACGGTTATACGCTCATTG,0,2255270
marRp,0.05263157894736842,18,18,GTTCATGTACACCCCTCTGG,0,2218126
marRp,0.05263157894736842,18,18,GCGGCTCCGAGAAGGTGGCG,0,2246226
marRp,0.05263157894736842,18,18,GCGCCTTGTTTGGAACGTTG,0,2222547
marRp,0.05263157894736842,18,18,GAGGACTCGGATATTGAGCT,0,2230415
marRp,0.05263157894736842,18,18,CGTTCTCCTTTCATATGGGT,0,2254732
marRp,0.05263157894736842,18,18,CGATAGGGCATCATGTGCGG,0,2259381
marRp,0.05263157894736842,18,18,CAGAACCGGGGAATCAGCGG,0,2261105
marRp,0.05263157894736842,18,18,CAGAAAGCCCGGTAATCCAA,0,2257620
marRp,0.05263157894736842,18,18,ATGGTACAAATCTAAGCAGA,0,2256652
marRp,0.05263157894736842,18,18,ATCACGGTGAGCCGATGGAG,0,2259910
marRp,0.05263157894736842,18,18,ATAGTGTCACGCTTGAGTAT,0,2238640
marRp,0.05263157894736842,18,18,AGTACTTTTTATAGAATTAG,0,2232836
marRp,0.05263157894736842,18,18,AGTAATCAACGTGTTGCATT,0,2242724
marRp,0.05263157894736842,18,18,AGATTAGAACGTAAGGTAAG,0,2248548
marRp,0.05263157894736842,18,18,AATCTCCGGTGCGGATAGCG,0,2221661
marRp,0.05263157894736842,18,18,AAATATAGGTCACGAGGTAT,0,2240140
marRp,0.05555555555555555,17,17,TTTGGCGTTAATGGGACGTA,0,2243551
marRp,0.05555555555555555,17,17,TTCTACCGATTCCTCAAACT,0,2219436
marRp,0.05555555555555555,17,17,TGTATTGAAGGCCAGAAACA,0,2258903
marRp,0.05555555555555555,17,17,TCGGAGTTTGGCCCAAGGAA,0,2225968
marRp,0.05555555555555555,17,17,TCCCGTTGCCACGGCGCATC,0,2242569
marRp,0.05555555555555555,17,17,TCAGGATGGAAATAACATCA,0,2225712
marRp,0.05555555555555555,17,17,TATCATGGCGGCCTTCCGAT,0,2243952
marRp,0.05555555555555555,17,17,TAGCGCGATTAGCCTACTCT,0,2233922
marRp,0.05555555555555555,17,17,TAGCATGCACGATGGTCGGC,0,2234882
marRp,0.05555555555555555,17,17,TAGACACGTTCGGGACAAGT,0,2249116
marRp,0.05555555555555555,17,17,GTGCGCTGACCATATCTGGT,0,2232609
marRp,0.05555555555555555,17,17,GGGATATGAGTGTTACTTGC,0,2230064
marRp,0.05555555555555555,17,17,GAGTGGCTTAAGGAAGGGTG,0,2220630
marRp,0.05555555555555555,17,17,GAGTGAGGTGTCTTTACAAG,0,2243853
marRp,0.05555555555555555,17,17,CTTCTTTCACTGCGTTTGCC,0,2251443
marRp,0.05555555555555555,17,17,CTGTGCAAATCCTTGGTCTT,0,2240141
marRp,0.05555555555555555,17,17,CTCGCCCAGAATGACATTCA,0,2225619
marRp,0.05555555555555555,17,17,CTAGATTTCGTCGTCCCAGG,0,2222102
marRp,0.05555555555555555,17,17,CTAAATAGTTCCCTGACAAG,0,2225816
marRp,0.05555555555555555,17,17,CGCAGGTAGCGATGTGGTAC,0,2257228
marRp,0.05555555555555555,17,17,CGCAACGCATCAGGTGCTTC,0,2237584
marRp,0.05555555555555555,17,17,CGACAGCAGTTCGCTGGTTT,0,2228642
marRp,0.05555555555555555,17,17,CCGCAGGCTTTCACATTAAC,0,2226211
marRp,0.05555555555555555,17,17,CCCTGGTGCTTTCAGCCCCG,0,2253142
marRp,0.05555555555555555,17,17,CCCCCGAAATCGTAAGAATT,0,2246887
marRp,0.05555555555555555,17,17,CCATGCCAAACCGAGAGAGA,0,2233428
marRp,0.05555555555555555,17,17,CCATCAAAGTGAGCAACGAT,0,2236389
marRp,0.05555555555555555,17,17,CATAAGTTAATCGTCATTTA,0,2257830
marRp,0.05555555555555555,17,17,CACCTCGTTTGTTTTATGCA,0,2243489
marRp,0.05555555555555555,17,17,CACAGGGTTTAAGAAAGTCG,0,2218236
marRp,0.05555555555555555,17,17,ATGAAGACGGGAGTTCCGAT,0,2259526
marRp,0.05555555555555555,17,17,ATAGCGACATGGGGGGGTTA,0,2240105
marRp,0.05555555555555555,17,17,AGTCCCCGGATTCAAGACTA,0,2227961
marRp,0.05555555555555555,17,17,AGCTGATATAGATAGATTAG,0,2239015
marRp,0.05555555555555555,17,17,ACTCAGCTCGGGGACGTAGT,0,2232474
marRp,0.05555555555555555,17,17,ACAGGTAGAATCAGACCGTA,0,2239763
marRp,0.05555555555555555,17,17,AAGAGGCGCTGCTTGTACCG,0,2252680
marRp,0.058823529411764705,16,16,TTGACTAACGTGATCCCGAA,0,2256447
marRp,0.058823529411764705,16,16,TTCATAGAGTTTGAATGTTT,0,2234200
marRp,0.058823529411764705,16,16,TGCGAGCCTGCGGAAGGTGT,0,2256285
marRp,0.058823529411764705,16,16,TCTTTGGGCGGTAGCAGGTT,0,2230730
marRp,0.058823529411764705,16,16,TCATGAATTTTTATGCAGGC,0,2219407
marRp,0.058823529411764705,16,16,TCAATGGCTTTTGGGGAGAC,0,2240190
marRp,0.058823529411764705,16,16,TAGATACGTGGATATTACCA,0,2239484
marRp,0.058823529411764705,16,16,GTCATGCCGGAACCCCGCCA,0,2248217
marRp,0.058823529411764705,16,16,GTACTCTTGGGCATCGATGC,0,2260924
marRp,0.058823529411764705,16,16,GGTTAATGAAAGGTTAGGAT,0,2235426
marRp,0.058823529411764705,16,16,GGCGAGGATAACGAATGAAA,0,2241041
marRp,0.058823529411764705,16,16,GGATGAGCTTGCTTCGGCGC,0,2221765
marRp,0.058823529411764705,16,16,GGATACTCAGTTAAGCCGTA,0,2223898
marRp,0.058823529411764705,16,16,GCACTGCACAAAGGCACTAT,0,2246292
marRp,0.058823529411764705,16,16,GATTTGCGAAAAGTTGCATA,0,2249924
marRp,0.058823529411764705,16,16,GAGGGATACAGGTAGTGCCC,0,2242029
marRp,0.058823529411764705,16,16,CTAGCTACCCCGACGTCGGG,0,2257460
marRp,0.058823529411764705,16,16,CGTACTTCTGGTAATGCAGC,0,2248168
marRp,0.058823529411764705,16,16,CATCACATTAAGCACACGAT,0,2230997
marRp,0.058823529411764705,16,16,CATAGCGGAACAACTCTTAT,0,2220010
marRp,0.058823529411764705,16,16,CATAAAGTGCACGGTGGTAA,0,2228445
marRp,0.058823529411764705,16,16,ATGACTCTTCAGCTGCTATA,0,2254617
marRp,0.058823529411764705,16,16,ATATTGTCGATTTAATGTAT,0,2227801
marRp,0.058823529411764705,16,16,AGCGGCTGTCGGTAGATTAG,0,2224877
marRp,0.058823529411764705,16,16,ACTGAGTACGAATTGTGCTG,0,2258603
marRp,0.058823529411764705,16,16,AATAGACTCAACCCTGGTCC,0,2228668
marRp,0.0625,15,15,TTGGTACCTGCAGTCGGAGA,0,2255724
marRp,0.0625,15,15,TTGACGTCGCGTCCGCAACA,0,2260191
marRp,0.0625,15,15,TTCGCGTTAGGCTATCACAA,0,2256046
marRp,0.0625,15,15,TTCACAGATAGGACGTTACA,0,2247820
marRp,0.0625,15,15,TGTTTTTGAGATAGCATGCT,0,2225716
marRp,0.0625,15,15,TGGTGTCCGTCTATAAGCAG,0,2220918
marRp,0.0625,15,15,TGACGGGTGGTCTCATCCGG,0,2246750
marRp,0.0625,15,15,TCCGAAGTTGCTTTCTCACA,0,2233930
marRp,0.0625,15,15,TCCCAGATCGATCATACATC,0,2252452
marRp,0.0625,15,15,TCACTAATTCTCGACGTTCA,0,2256743
marRp,0.0625,15,15,GTTCGAACTGGAAACTTGAA,0,2237859
marRp,0.0625,15,15,GTGGTCAGGAGGGGCTGCTA,0,2243153
marRp,0.0625,15,15,GTGAGTTTGTCTCGTGGAAC,0,2259309
marRp,0.0625,15,15,GTACTCTGCGTCAACTTCAC,0,2223749
marRp,0.0625,15,15,GGTTTCGCACTTTGTGATTG,0,2220115
marRp,0.0625,15,15,GGTTCGATTGCGTTTGGCAA,0,2235366
marRp,0.0625,15,15,GGGCTCACCACGCCGGGGTC,0,2223043
marRp,0.0625,15,15,GGGAAGAACGACACCCTTAT,0,2248800
marRp,0.0625,15,15,GGCATTGCCCCCTTCTTTGA,0,2256554
marRp,0.0625,15,15,GATTGCGTAACGCTAATGCA,0,2255526
marRp,0.0625,15,15,GATCCGTCCCGCCAGTCATG,0,2236130
marRp,0.0625,15,15,GACTGTTAGTGAAGAAGATT,0,2253658
marRp,0.0625,15,15,GACGTCGTGGATTTTTCGAC,0,2253165
marRp,0.0625,15,15,CGGCCGCGTGCATCTAGCAT,0,2258162
marRp,0.0625,15,15,CGCTGTTGTGGGCAGTCGAT,0,2255641
marRp,0.0625,15,15,CGCGCGCCATAATGCGAGGT,0,2245807
marRp,0.0625,15,15,CGCAATCTCGCACTCCCGCA,0,2252303
marRp,0.0625,15,15,CGATAGTTGAAATGCAGTGC,0,2221399
marRp,0.0625,15,15,CGAAAAATTTTCCTTGAAGG,0,2225744
marRp,0.0625,15,15,CCTCTCGGGTAGCTACCCTG,0,2240154
marRp,0.0625,15,15,CCCCCGGACGTTAAAGCGGG,0,2229793
marRp,0.0625,15,15,CCCATCAGTTGTCTACCTGT,0,2230467
marRp,0.0625,15,15,CCAGACCCAGAAGGGAGCCT,0,2231839
marRp,0.0625,15,15,CCAATCGCTCACCTGTCAGG,0,2232801
marRp,0.0625,15,15,CATTTTGCCGGAGGCAGAAA,0,2219222
marRp,0.0625,15,15,CAGGTGCCGAAGCTTTAAAG,0,2259317
marRp,0.0625,15,15,CAGGGTCTCCCGATACGGAA,0,2246190
marRp,0.0625,15,15,CACTACTCTTGCGCTAAGCC,0,2258920
marRp,0.0625,15,15,ATGCGACATGCCGAGGCTCT,0,2256954
marRp,0.0625,15,15,ATCTACCGCAGCGGAATTGC,0,2221388
marRp,0.0625,15,15,AGTGGTACCGCCGAATCACT,0,2256900
marRp,0.0625,15,15,AGCGATCTTGGTTTCCAATA,0,2243595
marRp,0.0625,15,15,ACTGATAGGCCGGACTTAAA,0,2235233
marRp,0.0625,15,15,ACAGAGCAAATCCGCCGTGC,0,2223343
marRp,0.0625,15,15,AATATTTACAATAACAGGGA,0,2241158
marRp,0.0625,15,15,AACTGCCTATACGTGACGAC,0,2237700
marRp,0.0625,15,15,AACGCCGATCGGTAATACTA,0,2225360
marRp,0.06666666666666667,14,14,TTTCCTTGATCATGTCAGGG,0,2234972
marRp,0.06666666666666667,14,14,TTGGAAAGCTAGCTTGGACA,0,2236431
marRp,0.06666666666666667,14,14,TTGAATGGAACACAGAAACC,0,2245626
marRp,0.06666666666666667,14,14,TGTCATTATAGCAACAAAGT,0,2246303
marRp,0.06666666666666667,14,14,TGTAAATATTGATCGAAGTA,0,2238862
marRp,0.06666666666666667,14,14,TGACCGCGCACATCTAGACT,0,2226287
marRp,0.06666666666666667,14,14,TCTTGCTGGAAAAGGATCGG,0,2241826
marRp,0.06666666666666667,14,14,TCTGGCTTAAAGCTGTTACA,0,2224468
marRp,0.06666666666666667,14,14,TCCTGTGGGGCAATCATATG,0,2226163
marRp,0.06666666666666667,14,14,TCCCTCACGTTGAGTATGAT,0,2257003
marRp,0.06666666666666667,14,14,TATTTTGTACATGTTCCGCA,0,2255191
marRp,0.06666666666666667,14,14,TATTTATCCACCGCGGCCCA,0,2220163
marRp,0.06666666666666667,14,14,TATTCCGTATCGAAATTTTT,0,2222638
marRp,0.06666666666666667,14,14,TACACCAGACGCGGAGGCCG,0,2220580
marRp,0.06666666666666667,14,14,TAACAAGTGCACCTGCATTC,0,2235772
marRp,0.06666666666666667,14,14,GTTTCAAACACAGATCGTCA,0,2251175
marRp,0.06666666666666667,14,14,GTTATACGAGTGGTAAAGCA,0,2236470
marRp,0.06666666666666667,14,14,GTGGTTGAAAAATACATTTT,0,2242956
marRp,0.06666666666666667,14,14,GTCTTCACACGGAGGTAGTT,0,2225784
marRp,0.06666666666666667,14,14,GTATTAGATCGGGGTGCTCA,0,2231226
marRp,0.06666666666666667,14,14,GGTTATTAAGATACAAATGA,0,2245835
marRp,0.06666666666666667,14,14,GGTATTCGCTATTACCCCCG,0,2241213
marRp,0.06666666666666667,14,14,GGGTCAACATGGTACCACTG,0,2249275
marRp,0.06666666666666667,14,14,GGGCCTGTTATAGCAGGCCA,0,2227570
marRp,0.06666666666666667,14,14,GGGATCAGAGCTATGCCTGG,0,2243992
marRp,0.06666666666666667,14,14,GGGATAACGGGGAGACCCGT,0,2248812
marRp,0.06666666666666667,14,14,GGGAACAGCGTGGCTAAAAG,0,2252455
marRp,0.06666666666666667,14,14,GGAGAACAGCGAAAAGGAGG,0,2239654
marRp,0.06666666666666667,14,14,GGACTGTACCGTGATTCTAG,0,2243485
marRp,0.06666666666666667,14,14,GCTGTGGTACACAGTTAAAT,0,2225405
marRp,0.06666666666666667,14,14,GCGTCAGCTTGGTGTTATCT,0,2231810
marRp,0.06666666666666667,14,14,GCGGCTACATGCACGGCACG,0,2235331
marRp,0.06666666666666667,14,14,GCCTGCTTTAACAGCCATGC,0,2253241
marRp,0.06666666666666667,14,14,GATAAGGTCATTCTTGTAGA,0,2230028
marRp,0.06666666666666667,14,14,GAGACATCGAACAAGTCAGA,0,2224286
marRp,0.06666666666666667,14,14,GAATTAGGCGTAAACTGCCG,0,2254800
marRp,0.06666666666666667,14,14,CTGGGTCTACTTTTCTCTGC,0,2257832
marRp,0.06666666666666667,14,14,CTAGCTTGGCAAAGGGGGGA,0,2218543
marRp,0.06666666666666667,14,14,CGGCGGAGAGGGACCATGCT,0,2223340
marRp,0.06666666666666667,14,14,CGGATTCCTAACCTGCCGCA,0,2226117
marRp,0.06666666666666667,14,14,CGCTAGAATTGGCTGGTTGG,0,2220356
marRp,0.06666666666666667,14,14,CGCGTGTCAGTGGTTCGGTG,0,2220583
marRp,0.06666666666666667,14,14,CCTTAGCTAAACGTCTCCTT,0,2225966
marRp,0.06666666666666667,14,14,CCAGAGATGAAACTACTGGG,0,2233869
marRp,0.06666666666666667,14,14,CAGTTGCTAAACTGCAAATA,0,2246684
marRp,0.06666666666666667,14,14,CAAGTGTAATTTAGGAGGCT,0,2243079
marRp,0.06666666666666667,14,14,CAAGGAAGTAAGCTCAAATA,0,2256894
marRp,0.06666666666666667,14,14,CAAATTGGTAACATCCGCCG,0,2217981
marRp,0.06666666666666667,14,14,ATGTAATAGCTCCAGTTCGT,0,2248947
marRp,0.06666666666666667,14,14,ATGAGCCGGGAAGCTGCTAT,0,2253343
marRp,0.06666666666666667,14,14,ATACGGGAGGATCCATGCAG,0,2252693
marRp,0.06666666666666667,14,14,AGTTGGTTGCACGAGAAAGG,0,2227036
marRp,0.06666666666666667,14,14,AGTTGAGGACGAATCACGTT,0,2219249
marRp,0.06666666666666667,14,14,AGTGTTGTAATAAACGAGAC,0,2257829
marRp,0.06666666666666667,14,14,AGGATCAATACTGTGTCTCT,0,2254745
marRp,0.06666666666666667,14,14,AGCACCGCGAAAATAGGGTC,0,2242924
marRp,0.06666666666666667,14,14,ACTTACAACAGGGGGTTCGC,0,2233854
marRp,0.06666666666666667,14,14,ACCTTTTGACTAATTGCATA,0,2260580
marRp,0.06666666666666667,14,14,ACAGCACGTCTATCAGCGTA,0,2252802
marRp,0.06666666666666667,14,14,AACTCCATACTCTGTTCTGC,0,2259965
marRp,0.06666666666666667,14,14,AACTACGAGTTTGCGGGGAT,0,2240734
marRp,0.07142857142857142,13,13,TTTTTAACCATGGTTGTGCA,0,2228556
marRp,0.07142857142857142,13,13,TTATTTGGCCGTTTTGCACA,0,2259688
marRp,0.07142857142857142,13,13,TGTGTAATGTGGGGTTCCCC,0,2222608
marRp,0.07142857142857142,13,13,TGTATTTACACAACGGCGGC,0,2238481
marRp,0.07142857142857142,13,13,TGGTCGTTGCAGATTAAGGG,0,2248035
marRp,0.07142857142857142,13,13,TGGGTCACTGAACGAAATGC,0,2247694
marRp,0.07142857142857142,13,13,TGCGGTCGCACCGCAAGAAC,0,2234398
marRp,0.07142857142857142,13,13,TGCCACAAAAGACATTTTCA,0,2231137
marRp,0.07142857142857142,13,13,TGAACTTCATGGGATTAGAT,0,2225755
marRp,0.07142857142857142,13,13,TCGGCGACGGTCCGACCGGG,0,2223719
marRp,0.07142857142857142,13,13,TCCTCCGGGGTTTCTGTATT,0,2242917
marRp,0.07142857142857142,13,13,TCAGTGCCCTGAAAACACTC,0,2229061
marRp,0.07142857142857142,13,13,TATGCTAAAGGCTCCATGTC,0,2244104
marRp,0.07142857142857142,13,13,TAGCGCAGGGCACATTGAAG,0,2239880
marRp,0.07142857142857142,13,13,TAGCATGCTAATGCGCCAGG,0,2252457
marRp,0.07142857142857142,13,13,TACGGATGATTGTTGATTTC,0,2233828
marRp,0.07142857142857142,13,13,TAACTCGCGTGGGTGCGTCA,0,2257169
marRp,0.07142857142857142,13,13,GTTAAAGTGGAGACCTCGTA,0,2256640
marRp,0.07142857142857142,13,13,GGTGGTCTCTGTCCCTGCCC,0,2247911
marRp,0.07142857142857142,13,13,GGGTTGGCACACTGGTAGCC,0,2260155
marRp,0.07142857142857142,13,13,GGGATGCTATAGGTGCGCGA,0,2245412
marRp,0.07142857142857142,13,13,GGCTAGTCCCTCGCTGAGAG,0,2235848
marRp,0.07142857142857142,13,13,GGCCTGATCACCGACACGCG,0,2245940
marRp,0.07142857142857142,13,13,GCTGCAACAGCGATTTGTCT,0,2255419
marRp,0.07142857142857142,13,13,GCCGTTGCACAAAGCGAAGA,0,2259818
marRp,0.07142857142857142,13,13,GCACCACACAATCAAGATAA,0,2231494
marRp,0.07142857142857142,13,13,GCAAGGCGTTAATGGACGAG,0,2233863
marRp,0.07142857142857142,13,13,CTTGGTTACTTAAAGCTGTT,0,2232285
marRp,0.07142857142857142,13,13,CTGCGTCCAAATTAGTGTTA,0,2260172
marRp,0.07142857142857142,13,13,CTCGCGGTCCCTGGCGGCAG,0,2228416
marRp,0.07142857142857142,13,13,CTCCTGGAAAAAGTTACGGT,0,2221040
marRp,0.07142857142857142,13,13,CTAGTGCATTACCAGAGGCT,0,2231515
marRp,0.07142857142857142,13,13,CGTGTGCCTATGTTTCCTAC,0,2248263
marRp,0.07142857142857142,13,13,CGTACGGTGTGGGATTGGTA,0,2253567
marRp,0.07142857142857142,13,13,CGGAGTAAATGCGCGGCCCT,0,2237210
marRp,0.07142857142857142,13,13,CGATTGTGTGCCTAACCAAG,0,2253840
marRp,0.07142857142857142,13,13,CGAGGGTGCCGTGGGTTGAT,0,2249858
marRp,0.07142857142857142,13,13,CCGGGACATTGCACGGTACA,0,2258574
marRp,0.07142857142857142,13,13,CACGCAAGCTAATGAATTAA,0,2251480
marRp,0.07142857142857142,13,13,CAACAATGCATACGTCCGTT,0,2255769
marRp,0.07142857142857142,13,13,ATTGTTATTATTATTTCTCA,0,2227721
marRp,0.07142857142857142,13,13,ATCATAAAGCTAGTCTCAAC,0,2258158
marRp,0.07142857142857142,13,13,ATATGCTAACTGGTAATCCA,0,2218045
marRp,0.07142857142857142,13,13,ATAGTATGGGTAGCAAGGGA,0,2254204
marRp,0.07142857142857142,13,13,ATAGTAAAAAAGCCATGGTT,0,2231008
marRp,0.07142857142857142,13,13,ATACTGGTAGCGTGTAGTTT,0,2245887
marRp,0.07142857142857142,13,13,AGTTGAGTTTGCTCTGGTTA,0,2245076
marRp,0.07142857142857142,13,13,AGCTATGTGCCCACCGGATA,0,2225276
marRp,0.07142857142857142,13,13,AGCTAATAGCGATCAAGGAC,0,2224425
marRp,0.07142857142857142,13,13,AGATGGCCCAACGCTGCAAA,0,2230276
marRp,0.07142857142857142,13,13,AGATACTTGGTGCGAAATCT,0,2236896
marRp,0.07142857142857142,13,13,ACTCGGGGAACATCAGTCTT,0,2228918
marRp,0.07142857142857142,13,13,ACTAGACGTGTGTTCATTCA,0,2250981
marRp,0.07142857142857142,13,13,AATGAGGGCCTCTGACTGGA,0,2244218
marRp,0.07142857142857142,13,13,AAGCTTTCCCCGAGTTCAGT,0,2253130
marRp,0.07142857142857142,13,13,AAATGCGGCCAAACGTCTCG,0,2258547
marRp,0.07142857142857142,13,13,AAACCCGAGCTGGCGCAGAG,0,2239798
marRp,0.07692307692307693,12,12,TTGTGCGTTGAGGTCCCGAG,0,2251575
marRp,0.07692307692307693,12,12,TGTAGTGCCGGTTAATCCCA,0,2220375
marRp,0.07692307692307693,12,12,TGGGACCGGATCCGCTCGGG,0,2246365
marRp,0.07692307692307693,12,12,TGGAAAGTATTTACGTCGCG,0,2224210
marRp,0.07692307692307693,12,12,TGCTCCGCTACGAGTAGTAC,0,2230727
marRp,0.07692307692307693,12,12,TGCAGGTTTCTCGTGCAGGT,0,2245811
marRp,0.07692307692307693,12,12,TGCAGGGCACAAAAAACGTT,0,2252529
marRp,0.07692307692307693,12,12,TGATCGGCAAATATTCTTCA,0,2221168
marRp,0.07692307692307693,12,12,TGACTCGTCCCAATACCATC,0,2255514
marRp,0.07692307692307693,12,12,TCTCCCCGGATTAATGGTTT,0,2228470
marRp,0.07692307692307693,12,12,TCTACTTCGTACAGTAACAT,0,2237058
marRp,0.07692307692307693,12,12,TATTCACCCGATCGGGTGCG,0,2227166
marRp,0.07692307692307693,12,12,TATCTTTTCCAGTGGCTTTG,0,2249244
marRp,0.07692307692307693,12,12,TAGGATGGGAGGGTCCAGGG,0,2251097
marRp,0.07692307692307693,12,12,TACCGTGGTATTTGAAGAGT,0,2231820
marRp,0.07692307692307693,12,12,TACACCTTGCAATAGATAAA,0,2221776
marRp,0.07692307692307693,12,12,TAAGGGATATGAACGCATTC,0,2228481
marRp,0.07692307692307693,12,12,TAAGGAGATGTGAACGGATT,0,2222665
marRp,0.07692307692307693,12,12,GTTCGCGGGAGGTACACGCA,0,2246192
marRp,0.07692307692307693,12,12,GTGTCCCGTGTCGTAGGAGG,0,2253585
marRp,0.07692307692307693,12,12,GTGGGGGGTTAGACAGACGT,0,2259840
marRp,0.07692307692307693,12,12,GTGATAACCTTGTTAGGGTA,0,2222099
marRp,0.07692307692307693,12,12,GTCGACCGTATTACTCTCCG,0,2225574
marRp,0.07692307692307693,12,12,GTCCTTTAGCCAGATGGCGT,0,2238203
marRp,0.07692307692307693,12,12,GTAGATCGGGGCGTGCCTGT,0,2235859
marRp,0.07692307692307693,12,12,GGTGGAACGTGGTCGAAGTT,0,2231994
marRp,0.07692307692307693,12,12,GGTAACGAAACCTACATTAG,0,2231718
marRp,0.07692307692307693,12,12,GGCTACAAACTGTTGCTTAG,0,2240308
marRp,0.07692307692307693,12,12,GGAGAGGTATGGCCTATAGG,0,2234658
marRp,0.07692307692307693,12,12,GGAGAGGCGAGGTGATGTTA,0,2243920
marRp,0.07692307692307693,12,12,GGAAATAAGCAGCGCTACGG,0,2245384
marRp,0.07692307692307693,12,12,GCTTGCCATACCTTATAGAC,0,2261108
marRp,0.07692307692307693,12,12,GCGCGCGGGGACCGGGCCTA,0,2246480
marRp,0.07692307692307693,12,12,GCAAAGCCCGTCTGAACTAT,0,2223513
marRp,0.07692307692307693,12,12,GATTTTGTATAGCGATGTCG,0,2234803
marRp,0.07692307692307693,12,12,GAGACGGACGCAGGTAGTTA,0,2239608
marRp,0.07692307692307693,12,12,GACTTGTAAGCTCACGCGGT,0,2254151
marRp,0.07692307692307693,12,12,GACAGTCCCAACCGTCATGT,0,2243668
marRp,0.07692307692307693,12,12,CTTTTTTTTCTTACAATTCG,0,2257053
marRp,0.07692307692307693,12,12,CTGTCTGGTAGTTGGCGAGA,0,2249951
marRp,0.07692307692307693,12,12,CTGGTGTTATTAGGTAAGCT,0,2258978
marRp,0.07692307692307693,12,12,CTCTCTTGTCGTCGTCACAA,0,2240139
marRp,0.07692307692307693,12,12,CGTTCCTACACGATGGCGGT,0,2257640
marRp,0.07692307692307693,12,12,CGTTATAAGGCGACATGAAC,0,2232325
marRp,0.07692307692307693,12,12,CGTGGCAGTTGTAGGAAGTC,0,2219271
marRp,0.07692307692307693,12,12,CGGGGCGTCAAGGCGGCAGA,0,2240042
marRp,0.07692307692307693,12,12,CGCTACGAGTTTTTGGAAAA,0,2226298
marRp,0.07692307692307693,12,12,CGCATCGGGTTATGGGCCGA,0,2219854
marRp,0.07692307692307693,12,12,CGACGGATATATTCGATGCT,0,2250891
marRp,0.07692307692307693,12,12,CCTGTCTCGGGAGGTAGTAC,0,2225468
marRp,0.07692307692307693,12,12,CCGCGCAGTGGCACGGTCTA,0,2237093
marRp,0.07692307692307693,12,12,CATTTCAAGGGATATTAGAT,0,2232896
marRp,0.07692307692307693,12,12,CAGTAAATCCAGGACTGAGG,0,2228563
marRp,0.07692307692307693,12,12,CACTTGGTCACTTTGTTTCA,0,2245809
marRp,0.07692307692307693,12,12,CACTACGCCTCCTCTCGGAG,0,2227273
marRp,0.07692307692307693,12,12,CACAGACCTCATCGTCCAAA,0,2250941
marRp,0.07692307692307693,12,12,ATTTAATCTAATTATAGTGG,0,2259041
marRp,0.07692307692307693,12,12,ATTTAATCCGCAACTAAAGA,0,2225284
marRp,0.07692307692307693,12,12,ATTCCAATGAGACAGAAACA,0,2232421
marRp,0.07692307692307693,12,12,ATTACTTGTAACAGGCTCAT,0,2230930
marRp,0.07692307692307693,12,12,ATGTTAAAGCTAACTAGACC,0,2225402
marRp,0.07692307692307693,12,12,ATGTGTAGGTCGGCTATGTT,0,2246594
marRp,0.07692307692307693,12,12,ATGTCGCTTTCCCAATATCA,0,2259701
marRp,0.07692307692307693,12,12,ATCTAGAATCCGTCATGAAA,0,2227904
marRp,0.07692307692307693,12,12,ATCAGTTTTTCTTAAGTGTT,0,2251313
marRp,0.07692307692307693,12,12,AGTTTGACGGCATGTCCAAA,0,2257587
marRp,0.07692307692307693,12,12,AGGGCGGTATCTAAATCGCA,0,2260573
marRp,0.07692307692307693,12,12,AGGCCTATTTGATCTACAGG,0,2258585
marRp,0.07692307692307693,12,12,AGGCCGAGCAACCACGTCAA,0,2261047
marRp,0.07692307692307693,12,12,AGGCACAGGCGGGAGGAATA,0,2226027
marRp,0.07692307692307693,12,12,AGGATATAACGGCCACTCAA,0,2223964
marRp,0.07692307692307693,12,12,ACCCTTTGCGGGGAAATTTT,0,2252723
marRp,0.07692307692307693,12,12,ACCACGTCCAAATCGCCATT,0,2234146
marRp,0.07692307692307693,12,12,ACATTAGGATCGTAACGACG,0,2250607
marRp,0.07692307692307693,12,12,AAGGTACATCGACGTACTTT,0,2251036
marRp,0.07692307692307693,12,12,AAGCTTTGTATAAAGGCGCG,0,2225737
marRp,0.07692307692307693,12,12,AAGACTCGTGGGACTGTTGT,0,2221450
marRp,0.07692307692307693,12,12,AAGACACTGCTAGATTACTT,0,2222911
marRp,0.07692307692307693,12,12,AAACCGCGCATATTATCATT,0,2256750
marRp,0.08333333333333333,11,11,TTGAAATGGACAGTACAGAC,0,2234881
marRp,0.08333333333333333,11,11,TTCTCCCGCCCACAATGGGA,0,2256206
marRp,0.08333333333333333,11,11,TTCGGGGTGCAGGGGGAATG,0,2243490
marRp,0.08333333333333333,11,11,TTCAACTGTTTATCCACTAG,0,2242166
marRp,0.08333333333333333,11,11,TTACCCGCGACTTTGCTTGG,0,2247497
marRp,0.08333333333333333,11,11,TTACATAGTAACAGGATTTC,0,2239666
marRp,0.08333333333333333,11,11,TGTCCTTGGTGACGTGTGCG,0,2229760
marRp,0.08333333333333333,11,11,TGCCGGGACATCCCGACAAT,0,2233592
marRp,0.08333333333333333,11,11,TGCCGAGCGGTAAGGATGGT,0,2253172
marRp,0.08333333333333333,11,11,TGCACTACGAGAGTAGTACT,0,2255381
marRp,0.08333333333333333,11,11,TGAACATATTCCGCAGACTG,0,2239974
marRp,0.08333333333333333,11,11,TCTGGGAGCCAGCCATGTGG,0,2238609
marRp,0.08333333333333333,11,11,TCTGGAAGCTTTTTCTGGCA,0,2224743
marRp,0.08333333333333333,11,11,TCTCTTGGTTTCAATGCATT,0,2226983
marRp,0.08333333333333333,11,11,TCTCGCTTGAGCACTTTCCA,0,2259361
marRp,0.08333333333333333,11,11,TCGGTATCTTGAACGGAAGG,0,2219795
marRp,0.08333333333333333,11,11,TCGGCTTCCGCCTTCCTTAG,0,2247157
marRp,0.08333333333333333,11,11,TCCCGCCTGCTTCCTTTTAC,0,2257047
marRp,0.08333333333333333,11,11,TATCCAATGTCCAATGGCTA,0,2252977
marRp,0.08333333333333333,11,11,TATCATCTCCGCTGGCCAAG,0,2248062
marRp,0.08333333333333333,11,11,TAGCATCACCTCCACGGTCT,0,2247181
marRp,0.08333333333333333,11,11,TACCCCCCTCTCAGCCCATC,0,2239488
marRp,0.08333333333333333,11,11,TAAGCATAAGCAATCAGCAA,0,2236426
marRp,0.08333333333333333,11,11,TAAACTTCTATTTGTGAAGC,0,2223038
marRp,0.08333333333333333,11,11,TAAAATCAACCGCGGCTACT,0,2220603
marRp,0.08333333333333333,11,11,GTTCTTGTGGGATGAGATCG,0,2251855
marRp,0.08333333333333333,11,11,GTTCTCTCCCAGGGCGACAT,0,2224357
marRp,0.08333333333333333,11,11,GTGGAACGTACCGGTATTTT,0,2233727
marRp,0.08333333333333333,11,11,GTGCTTAACACTTGCATCAA,0,2233610
marRp,0.08333333333333333,11,11,GTGACGAACATCACCCCATG,0,2254586
marRp,0.08333333333333333,11,11,GTGAAGGACCCATCCGCGCC,0,2242989
marRp,0.08333333333333333,11,11,GTCTTTCAACCCAATAGTGA,0,2227376
marRp,0.08333333333333333,11,11,GTCTAGAGGTTAAGATAGCA,0,2241253
marRp,0.08333333333333333,11,11,GTCAAGTGGATCGTGAATTG,0,2224871
marRp,0.08333333333333333,11,11,GTAAATCATAGAAAGTTCAC,0,2227802
marRp,0.08333333333333333,11,11,GGGTTTGCGCAATTATTACA,0,2253751
marRp,0.08333333333333333,11,11,GGGGTCCCCCGGATGAGAGC,0,2225282
marRp,0.08333333333333333,11,11,GGGGGGACAGTCATCAATCT,0,2220379
marRp,0.08333333333333333,11,11,GGGCAGTGTTATCCCGCAAG,0,2220701
marRp,0.08333333333333333,11,11,GGGATACCCACCCATATAAT,0,2251306
marRp,0.08333333333333333,11,11,GGCCAGTAATCGGTCAGTAC,0,2225530
marRp,0.08333333333333333,11,11,GGCACTCAGTATCTCTGTGG,0,2251867
marRp,0.08333333333333333,11,11,GGAGGGTAGTAGTCGAGCAT,0,2249918
marRp,0.08333333333333333,11,11,GCTTTGAAACCAAATGCGTT,0,2243348
marRp,0.08333333333333333,11,11,GCTTAAACCGGGTGGAAAGA,0,2241725
marRp,0.08333333333333333,11,11,GCTGTTCACTAAGGTGTTGC,0,2258136
marRp,0.08333333333333333,11,11,GCTGTCAGTATAAGGAAGGT,0,2243342
marRp,0.08333333333333333,11,11,GCTGTCAGGGTAGGGTCCAT,0,2243148
marRp,0.08333333333333333,11,11,GCGTAATAGGGAAAGTTGGA,0,2246662
marRp,0.08333333333333333,11,11,GCAGCTCGTAACGCGTAGAG,0,2220821
marRp,0.08333333333333333,11,11,GCAGCAATACCACATGATAA,0,2259253
marRp,0.08333333333333333,11,11,GCAATCACCGCGATTCGCCC,0,2220024
marRp,0.08333333333333333,11,11,GATAACAAGGACACGAGCTG,0,2238815
marRp,0.08333333333333333,11,11,GAGGACTTCGAAAGGGTCCC,0,2227512
marRp,0.08333333333333333,11,11,GACTCACCCGGTGGGAAGTC,0,2239202
marRp,0.08333333333333333,11,11,GACGAAGCCCAGGCTTTGGT,0,2243209
marRp,0.08333333333333333,11,11,GACACAGGCGTTCAAATGCC,0,2228648
marRp,0.08333333333333333,11,11,GAACGCGCCTATGGTGAATA,0,2259044
marRp,0.08333333333333333,11,11,CTTTTTCACAGAGCCAATAG,0,2234151
marRp,0.08333333333333333,11,11,CTGTAACGATACTGATAGTC,0,2252978
marRp,0.08333333333333333,11,11,CTCCCGCCCGGCGGGCAAAA,0,2259275
marRp,0.08333333333333333,11,11,CTCATGATGTAAGTCCAAAT,0,2239349
marRp,0.08333333333333333,11,11,CTCAGACGCGGCATCGCCGC,0,2232781
marRp,0.08333333333333333,11,11,CTAAAACATACGTCAGTGGG,0,2236477
marRp,0.08333333333333333,11,11,CGGGCGATTGAGGAGACTAG,0,2247360
marRp,0.08333333333333333,11,11,CGCAACGAAATTTGACATAC,0,2230703
marRp,0.08333333333333333,11,11,CGCAACACCAGGCCATGTAG,0,2251663
marRp,0.08333333333333333,11,11,CGAGCTTCAGCGTCTACCAC,0,2221771
marRp,0.08333333333333333,11,11,CGAATTTCTATCCACAAAAC,0,2227708
marRp,0.08333333333333333,11,11,CCTCATTTCCCCAATTGGAA,0,2235414
marRp,0.08333333333333333,11,11,CCGGCCCCGGCCTGTATGTA,0,2251683
marRp,0.08333333333333333,11,11,CCATCTAGACGGTTAGCTTC,0,2228208
marRp,0.08333333333333333,11,11,CATTGTGGCTTTCAATCAAT,0,2244680
marRp,0.08333333333333333,11,11,CATGGTTGTTAAAGAAGTAC,0,2228482
marRp,0.08333333333333333,11,11,CAGCATTCATTACACTTTCG,0,2248318
marRp,0.08333333333333333,11,11,CAGAGAAGGATGAGCGCGAT,0,2220449
marRp,0.08333333333333333,11,11,CACGGGTAATTATTCCGCCA,0,2257605
marRp,0.08333333333333333,11,11,ATTGCTTTGAACTTTTAGGG,0,2256888
marRp,0.08333333333333333,11,11,ATGCTCGACCCTTCGGCAAG,0,2250866
marRp,0.08333333333333333,11,11,ATCCACGATCTAACGGTGAC,0,2231123
marRp,0.08333333333333333,11,11,ATCCAAAAAGGCTGCCCGCC,0,2230428
marRp,0.08333333333333333,11,11,ATCAGTAAATCTTCCCATTA,0,2251566
marRp,0.08333333333333333,11,11,ATAACGGCCAGTCTCAATGA,0,2220889
marRp,0.08333333333333333,11,11,ATAAAATGGGCTAAGTAAAT,0,2243395
marRp,0.08333333333333333,11,11,AGTTTGGTCTAGTTAAGCCC,0,2253684
marRp,0.08333333333333333,11,11,AGTATACAATACGTGACTGG,0,2258830
marRp,0.08333333333333333,11,11,AGGTCTTTATATTCTGTATA,0,2251456
marRp,0.08333333333333333,11,11,AGGGTGCTCTAGTAAACAGG,0,2219486
marRp,0.08333333333333333,11,11,AGGACTGCGCGGTCAGTGTA,0,2228201
marRp,0.08333333333333333,11,11,AGCCTTACAACCGAGTCAAA,0,2248885
marRp,0.08333333333333333,11,11,AGATCTACGGTTGCAATAGA,0,2242229
marRp,0.08333333333333333,11,11,AGACCCATATTTGCGACAGC,0,2242847
marRp,0.08333333333333333,11,11,AGAACACCAGGTAGTGTCAC,0,2224980
marRp,0.08333333333333333,11,11,ACGGCGGTTGACCTTGAGAT,0,2245953
marRp,0.08333333333333333,11,11,ACGCTTCGTGCGCCGGATGC,0,2243713
marRp,0.08333333333333333,11,11,ACCATTTTTTATTCAAGCGG,0,2228653
marRp,0.08333333333333333,11,11,ACCAGCTGCGATCCGCCCCC,0,2255899
marRp,0.08333333333333333,11,11,ACCACCGGGAGGTGGACCGC,0,2243144
marRp,0.08333333333333333,11,11,AATTCTAGTGCAGAAACGTG,0,2218135
marRp,0.08333333333333333,11,11,AACGGGGCCATTCAAGGGTT,0,2247814
marRp,0.08333333333333333,11,11,AACCGACCGCAGGCCATAAC,0,2260269
marRp,0.08333333333333333,11,11,AAAGTCTCTGTGAACAGGGG,0,2251277
marRp,0.08333333333333333,11,11,AAACAGCGACCGGGATGGAT,0,2252065
marRp,0.09090909090909091,10,10,TTTTCTGCTCACGACTAGAC,0,2260374
marRp,0.09090909090909091,10,10,TTTGTCTATTATGCAAATTA,0,2245795
marRp,0.09090909090909091,10,10,TTTAGCAAAAACCCGCCTTA,0,2252736
marRp,0.09090909090909091,10,10,TTGGCTGACCTTGACGGGAA,0,2220283
marRp,0.09090909090909091,10,10,TTCTGTATAACCTTTAAAAC,0,2240188
marRp,0.09090909090909091,10,10,TTCTCGCCTCACTATCCACC,0,2253800
marRp,0.09090909090909091,10,10,TTATGCGGGCTCAAACAAGT,0,2231723
marRp,0.09090909090909091,10,10,TTATCCAGTCCGAATCCGAA,0,2230015
marRp,0.09090909090909091,10,10,TTAGGAAGTCACGGCCCCCA,0,2229564
marRp,0.09090909090909091,10,10,TTAATCCGAGGTTGCCAATC,0,2258983
marRp,0.09090909090909091,10,10,TGGTTACCATACTCAATGCC,0,2221241
marRp,0.09090909090909091,10,10,TGGGCAGCCCCTTTGGCTGG,0,2227798
marRp,0.09090909090909091,10,10,TGCGGGTGTTAAAGGCATTG,0,2239168
marRp,0.09090909090909091,10,10,TGCCTTCCACGGGCCGTAGT,0,2246448
marRp,0.09090909090909091,10,10,TGAGTCATTAGCTATTTTAT,0,2242508
marRp,0.09090909090909091,10,10,TCTTTAACTCCGCATTCGTA,0,2240353
marRp,0.09090909090909091,10,10,TCGTTCCGAAGGGGCTCGGG,0,2241053
marRp,0.09090909090909091,10,10,TCCGAAGGGCAGCTGCTAAT,0,2240903
marRp,0.09090909090909091,10,10,TCAGTGCGTGAGTCTATCAG,0,2237071
marRp,0.09090909090909091,10,10,TCAGCGCTTTGCCTAGCGGT,0,2221727
marRp,0.09090909090909091,10,10,TCAAGGCATCCTTCGTACGG,0,2233129
marRp,0.09090909090909091,10,10,TATGCGTATTCCCCGACACT,0,2225713
marRp,0.09090909090909091,10,10,TATCTGCGGCACCTACGTAT,0,2248910
marRp,0.09090909090909091,10,10,TATCGCGTTGGTCTGAGGTA,0,2241273
marRp,0.09090909090909091,10,10,TACTTTTTGGTGGTTACGGG,0,2225736
marRp,0.09090909090909091,10,10,GTTAGGATTATTTTGTTCCC,0,2229051
marRp,0.09090909090909091,10,10,GTGAATTACCGTAGCTTTTG,0,2224236
marRp,0.09090909090909091,10,10,GTCTCGGCGTTGACGTCTGA,0,2239176
marRp,0.09090909090909091,10,10,GTCGTCGGAAACAGGTAGCT,0,2218285
marRp,0.09090909090909091,10,10,GTCGAAGTGCGGTCTCGGTT,0,2255330
marRp,0.09090909090909091,10,10,GTCCCGTACCGGGACAACGA,0,2226045
marRp,0.09090909090909091,10,10,GTATGGATCGTGATCTCTGG,0,2250253
marRp,0.09090909090909091,10,10,GGTTAAAATGAGGTGAAACC,0,2251006
marRp,0.09090909090909091,10,10,GGTACGGATTCCCGAACGAC,0,2227234
marRp,0.09090909090909091,10,10,GGGTTTCGGCCGTCGCGTCA,0,2242069
marRp,0.09090909090909091,10,10,GGGCTGGCTAGAGACGAGGA,0,2227922
marRp,0.09090909090909091,10,10,GGCTCCATCAGTTTCTCCGT,0,2253859
marRp,0.09090909090909091,10,10,GGCGTCTGAGTTTTTTCTTC,0,2238706
marRp,0.09090909090909091,10,10,GCTAAGGGCGACTTTCCTGA,0,2220608
marRp,0.09090909090909091,10,10,GCGGCAACGTAAGTTAGTCG,0,2237966
marRp,0.09090909090909091,10,10,GCCGTGATTTACGTGCATTG,0,2232603
marRp,0.09090909090909091,10,10,GCCCGGATCCAACCTCCGAC,0,2252456
marRp,0.09090909090909091,10,10,GCCCGCGTGAGCGAAATAAC,0,2222502
marRp,0.09090909090909091,10,10,GCATCGTCCAATATATTGCC,0,2247492
marRp,0.09090909090909091,10,10,GCAATCCGAAGCAATATGAA,0,2232909
marRp,0.09090909090909091,10,10,GATTTCTAATTCCCCGAAGG,0,2252291
marRp,0.09090909090909091,10,10,GATCAGACCTGAGGTCTTGA,0,2226779
marRp,0.09090909090909091,10,10,GACCGAAACGTGCAAGATTT,0,2247442
marRp,0.09090909090909091,10,10,CTTTCCTAACATTGGAGACA,0,2248300
marRp,0.09090909090909091,10,10,CTTGCCATTAGATTTAATAC,0,2252419
marRp,0.09090909090909091,10,10,CTTCCCGGCGACTAAGGAAG,0,2234714
marRp,0.09090909090909091,10,10,CTTATTTCGTTTAGTTTGCT,0,2250002
marRp,0.09090909090909091,10,10,CTTATCGGCGCAGCCGGTGA,0,2229755
marRp,0.09090909090909091,10,10,CTGTTGTCTCACCGGGCCGG,0,2252423
marRp,0.09090909090909091,10,10,CTGTGGAAAGAGTCAAATGC,0,2249394
marRp,0.09090909090909091,10,10,CTGTACGGGGCATGGGATTC,0,2232857
marRp,0.09090909090909091,10,10,CTCTCGCCACGTTACCGCTG,0,2254194
marRp,0.09090909090909091,10,10,CTCGTTCCTTCAGCATCCAT,0,2228478
marRp,0.09090909090909091,10,10,CTCGCCGAGCTCCCCCCACA,0,2250643
marRp,0.09090909090909091,10,10,CTCACTAGAGAGAGAAAACA,0,2251271
marRp,0.09090909090909091,10,10,CTCAAAGGACACACTTTTTT,0,2237524
marRp,0.09090909090909091,10,10,CTACCTAAATCGACTTTGGT,0,2257542
marRp,0.09090909090909091,10,10,CGTGGTCCAAAGGAAGGAGG,0,2217811
marRp,0.09090909090909091,10,10,CGTCTATACTCAACAATGGT,0,2250894
marRp,0.09090909090909091,10,10,CGTCGCTGTATCTCCCCGAG,0,2257077
marRp,0.09090909090909091,10,10,CGGCAGGAATAATGAGGCAG,0,2228477
marRp,0.09090909090909091,10,10,CGCGGTTGCCAAATAGAACG,0,2236369
marRp,0.09090909090909091,10,10,CGCCTACCTTAATCCTAATG,0,2248994
marRp,0.09090909090909091,10,10,CCGGATTGGCTAAAACGTTT,0,2231107
marRp,0.09090909090909091,10,10,CCGCACGGGAAGATACTCAG,0,2226795
marRp,0.09090909090909091,10,10,CCCTCGGAGTATCGTGCGCC,0,2235386
marRp,0.09090909090909091,10,10,CCCGAGAAGATGCGCCGAGC,0,2231658
marRp,0.09090909090909091,10,10,CCCAGAGCTTAGGAAAGACA,0,2247338
marRp,0.09090909090909091,10,10,CCATGGGTTACTAATGGCGA,0,2247679
marRp,0.09090909090909091,10,10,CCATAGGTGTTTCGTGAGAC,0,2227918
marRp,0.09090909090909091,10,10,CCACCCTACACGGGGGGGTA,0,2229285
marRp,0.09090909090909091,10,10,CAGGGCGGACTTCGAAGTAG,0,2258372
marRp,0.09090909090909091,10,10,CAGCCGGCAGAAAGATTTAG,0,2233578
marRp,0.09090909090909091,10,10,CACCGCCTATCTGAGTGGGT,0,2251756
marRp,0.09090909090909091,10,10,CACCAATTTGGATCGGTTCG,0,2242507
marRp,0.09090909090909091,10,10,CACAAAAATTCGGTGAAATA,0,2249417
marRp,0.09090909090909091,10,10,CAACATGTTTCTCAATATTG,0,2258808
marRp,0.09090909090909091,10,10,ATTGGGTTTGTTGGTGCTCG,0,2248679
marRp,0.09090909090909091,10,10,ATTCTTAGTTCGTTGTGACC,0,2237770
marRp,0.09090909090909091,10,10,ATTATGGCTCGGACAAATAA,0,2219771
marRp,0.09090909090909091,10,10,ATGTGACGACTCAGGCACGA,0,2227345
marRp,0.09090909090909091,10,10,ATGGGCCAGGCCTCCGTGGT,0,2246533
marRp,0.09090909090909091,10,10,ATCCGAGTCCGTGGAACCAG,0,2246417
marRp,0.09090909090909091,10,10,ATCACCGTTAAGATAGTTCC,0,2222905
marRp,0.09090909090909091,10,10,ATAGTAGACGGGAAGGTTCG,0,2256673
marRp,0.09090909090909091,10,10,ATAAGAAGTCAGGTATTCTG,0,2253222
marRp,0.09090909090909091,10,10,AGTTGGAAGACAGGATGCCG,0,2254306
marRp,0.09090909090909091,10,10,AGTCACATCACTTATGGTTT,0,2259019
marRp,0.09090909090909091,10,10,AGGTGGGATGGCCTCGGCCC,0,2225116
marRp,0.09090909090909091,10,10,AGGTCCAGGGACTTAATATA,0,2219778
marRp,0.09090909090909091,10,10,AGGCAAGGCGGATGAGGGAA,0,2229810
marRp,0.09090909090909091,10,10,AGCTGGCGGTATCTTCACAT,0,2217827
marRp,0.09090909090909091,10,10,AGCCCCTTTCGTCAGTGTAT,0,2247365
marRp,0.09090909090909091,10,10,AGATCAGCGGTCGCGACACG,0,2219191
marRp,0.09090909090909091,10,10,ACTTACTGATGGCAGTAAAG,0,2248717
marRp,0.09090909090909091,10,10,ACTGTACAATTCCGGATTGC,0,2225289
marRp,0.09090909090909091,10,10,ACTAAGCGCCACCCATGCAA,0,2258680
marRp,0.09090909090909091,10,10,ACGTTAGTCTTTCTCCTCAG,0,2224326
marRp,0.09090909090909091,10,10,ACGCGGACGTAATACGGGTG,0,2229417
marRp,0.09090909090909091,10,10,ACCGGTTTACAGCTCCGTCT,0,2221741
marRp,0.09090909090909091,10,10,ACATGTTGACTGTCTGATGT,0,2251162
marRp,0.09090909090909091,10,10,AAGTGGAAGCGTGTGAGGGG,0,2256063
marRp,0.09090909090909091,10,10,AAGGTTCGAAGGCAAATATA,0,2229948
marRp,0.09090909090909091,10,10,AAGCAGACATTATATCTATT,0,2254698
marRp,0.09090909090909091,10,10,AAATATTGTATATGACTAAC,0,2243678
marRp,0.09090909090909091,10,10,AAAGGGTGTCAGCGAGCATA,0,2218605
marRp,0.09090909090909091,10,10,AAAGGCTGGGGAACGGGCGA,0,2259212
marRp,0.09090909090909091,10,10,AAAGAATGGCATCTGTACTA,0,2253724
marRp,0.09090909090909091,10,10,AAACAAGGACTGGCTGAGAC,0,2258779
marRp,0.1,9,9,TTTTTAGTCGAACTCGCGTT,0,2218975
marRp,0.1,9,9,TTTCTCCGGACGATCACCGT,0,2250915
marRp,0.1,9,9,TTGTGGGTTTGACAGCAATC,0,2218120
marRp,0.1,9,9,TTCGTCATAATCACAAATTC,0,2225764
marRp,0.1,9,9,TTCCGTATGCCTGAGACTAC,0,2235630
marRp,0.1,9,9,TTCCAGACATTGCACATTGT,0,2240853
marRp,0.1,9,9,TTCAGCAGATGCGTCACTGT,0,2242146
marRp,0.1,9,9,TGTTATTAAACTAAGGTACA,0,2248301
marRp,0.1,9,9,TGTGGTTCCTGTTACTCAGA,0,2250258
marRp,0.1,9,9,TGTCTCAATATTCTTGATGC,0,2219168
marRp,0.1,9,9,TGTAAATGACGTATTACATA,0,2256966
marRp,0.1,9,9,TGGGGCGTCGTAGCACAAGA,0,2249497
marRp,0.1,9,9,TGGCCGAGAGAATTTCCATA,0,2239182
marRp,0.1,9,9,TGGATGTGGACGGGGAAGTA,0,2234264
marRp,0.1,9,9,TGGATAGGCCTTGCTACGAC,0,2254633
marRp,0.1,9,9,TGGACTGGTCGCTGGATTAG,0,2227428
marRp,0.1,9,9,TGCTCGCGTTCCGTACGGTG,0,2238652
marRp,0.1,9,9,TGCTCCATGAAATTGCTGGA,0,2224974
marRp,0.1,9,9,TGCCTAGGCCTTAGGGCGGA,0,2222901
marRp,0.1,9,9,TGACGGCCCAATAGGACCTT,0,2235389
marRp,0.1,9,9,TCTCCGGTCTCCGGCATCGT,0,2229229
marRp,0.1,9,9,TCGGGGATTATTCCTTCGCA,0,2219776
marRp,0.1,9,9,TCGAGGGTGGAAGAATAGAG,0,2223770
marRp,0.1,9,9,TCGACCAGCGTAAGGAGCGA,0,2229422
marRp,0.1,9,9,TCCGAGATATGGTCCTGTTG,0,2250028
marRp,0.1,9,9,TAGTGGTAGGTAGAACTGGA,0,2256185
marRp,0.1,9,9,TAGGATACGCGACCTCGGAT,0,2237679
marRp,0.1,9,9,TAGGAATAAGGCAGGAACAA,0,2259265
marRp,0.1,9,9,TAGGAAGCACATCTGCACCT,0,2223544
marRp,0.1,9,9,TAGCAGCAAATGAATATGAT,0,2249210
marRp,0.1,9,9,TAGATCTTGCCGGCTCCCGA,0,2251751
marRp,0.1,9,9,TACAGTCAACTAGCTTTATG,0,2224436
marRp,0.1,9,9,TACACTCGCATTCATTCCCA,0,2241160
marRp,0.1,9,9,TAAGGTACGATGTTATCGCC,0,2219507
marRp,0.1,9,9,TAAGATATCACCTGTCTCAT,0,2258954
marRp,0.1,9,9,TAAATTAGCAACGTGTCACC,0,2250081
marRp,0.1,9,9,GTTTCGTCTGTAGCAGCAGT,0,2240182
marRp,0.1,9,9,GTGACGGTACCGAGGTACAA,0,2225110
marRp,0.1,9,9,GTCGCAGACAGATTCACATA,0,2247070
marRp,0.1,9,9,GTCACATTAAAAGGGCCAAA,0,2235383
marRp,0.1,9,9,GTACCTGCGCTACTTATGTG,0,2220389
marRp,0.1,9,9,GTAAGCTTGCTGTGACGAGT,0,2238549
marRp,0.1,9,9,GGGGCGTCTAAGTCAACTAT,0,2227544
marRp,0.1,9,9,GGGAGGGAGTATGGCAACTT,0,2240039
marRp,0.1,9,9,GGGACGCGCGGAGCTGAATT,0,2253105
marRp,0.1,9,9,GGCCAGCCTCCCGGGCCTCT,0,2239417
marRp,0.1,9,9,GGATACAACCGCAGCTGGTG,0,2245149
marRp,0.1,9,9,GGAGGATCTAGATTGTATAC,0,2254703
marRp,0.1,9,9,GCTCGAACCAGGGTAAAAAT,0,2238611
marRp,0.1,9,9,GCCCATAAGTGCCCCAAAGA,0,2217957
marRp,0.1,9,9,GCAGCGTGAGGTCCCATCGT,0,2229362
marRp,0.1,9,9,GATTCGGGTTGTCTAGACCA,0,2260738
marRp,0.1,9,9,GATGCTTAAGGTTCACGTCG,0,2233168
marRp,0.1,9,9,GATAGGCTAACTTATTGTGT,0,2244035
marRp,0.1,9,9,GAGTTGCAAGATCGCGTAGG,0,2255531
marRp,0.1,9,9,GAGGGGTCTGGAATGATTTC,0,2224589
marRp,0.1,9,9,GACTTCAGCCGGTCATTTAT,0,2257841
marRp,0.1,9,9,GACAACAGTACTAGCCCGGG,0,2258522
marRp,0.1,9,9,GAATTTGACTCGGAAAGGGA,0,2227133
marRp,0.1,9,9,GAACCGTCTTAGTACAGCTG,0,2227465
marRp,0.1,9,9,GAAACGCGACAGCGGAAGGT,0,2255316
marRp,0.1,9,9,CTGCAATCGGTAACTTCAGA,0,2228361
marRp,0.1,9,9,CTCGTGGTATGCTACTGCGG,0,2256547
marRp,0.1,9,9,CTCGCTTAATCCCGAAGCAG,0,2236798
marRp,0.1,9,9,CTATGAGCACCCGAGAATAG,0,2231966
marRp,0.1,9,9,CTACCGTGTACCGGCTCATC,0,2260979
marRp,0.1,9,9,CTAAGCTGTCTCACTGACAA,0,2244099
marRp,0.1,9,9,CGTAGTCGTTGGTAACCGGT,0,2256135
marRp,0.1,9,9,CGGGGATCCGTTCATAGACA,0,2233673
marRp,0.1,9,9,CGGATAAACTCTAGTGCGAT,0,2242096
marRp,0.1,9,9,CGATTTGCACAGCCCCCCGG,0,2235334
marRp,0.1,9,9,CGATGGCGATTAAAAGCGTC,0,2217834
marRp,0.1,9,9,CGATCGCAAAGGGATGTTTC,0,2231219
marRp,0.1,9,9,CCTTAGGTTGTACGGGGATT,0,2226012
marRp,0.1,9,9,CCTCCTTCGGAACTTAGCCG,0,2227401
marRp,0.1,9,9,CCGAACACGATAATTCATTC,0,2258141
marRp,0.1,9,9,CCATCGTGATCTTCACAGAA,0,2252117
marRp,0.1,9,9,CCAACGACCGAGTTTGAAAT,0,2223843
marRp,0.1,9,9,CAGGTCAGGCGGTCACATAA,0,2231967
marRp,0.1,9,9,CAGAACAATGAGTATTCATT,0,2252970
marRp,0.1,9,9,CAAGTGCGAGGTGGTAGTTG,0,2223349
marRp,0.1,9,9,CAAGGAGTCAACCGCAGAAT,0,2243635
marRp,0.1,9,9,CAAGAAGACGTGAGATAATG,0,2259193
marRp,0.1,9,9,CAACCCTGTTGATTGTTTAA,0,2247822
marRp,0.1,9,9,ATTTTCTGGAATGAGCGATG,0,2253681
marRp,0.1,9,9,ATTTGACTTAGTCGGGTGCT,0,2223850
marRp,0.1,9,9,ATTGTCAATTATCAGCAAAT,0,2251089
marRp,0.1,9,9,ATTCGGGGGTGTAGCTTGTA,0,2221652
marRp,0.1,9,9,ATTCAAGAATACTGTTGTTA,0,2232483
marRp,0.1,9,9,ATTAGCGGGAAACAGCTAGT,0,2255484
marRp,0.1,9,9,ATTACAAAACGGTTAGCTCG,0,2231105
marRp,0.1,9,9,ATGGTTATGTTATAATCAAC,0,2228930
marRp,0.1,9,9,ATGCGCGTTGCCCTTACAGT,0,2257353
marRp,0.1,9,9,ATGCGAACAGTTCCCATGGC,0,2231841
marRp,0.1,9,9,ATGATTACTCGCATTTACTC,0,2259042
marRp,0.1,9,9,ATCGCTCTTGGCGAGCATAT,0,2252994
marRp,0.1,9,9,ATCCGTCATAAGTCGCCCAA,0,2256079
marRp,0.1,9,9,ATCATTGCGTCCGGCCGGCG,0,2247725
marRp,0.1,9,9,ATATCAACTTCTTTGTTAAC,0,2230201
marRp,0.1,9,9,ATATAAGATCACGAGATCGA,0,2247750
marRp,0.1,9,9,ATACAAGTCATTAGACCGGG,0,2257958
marRp,0.1,9,9,ATACAACATCGAAAGAGCCT,0,2243514
marRp,0.1,9,9,ATAAATCCGACTGCCGACAC,0,2252849
marRp,0.1,9,9,AGTATCCGTAACCTTGAGAA,0,2224174
marRp,0.1,9,9,AGGTTATTGAGACAAGATTA,0,2242845
marRp,0.1,9,9,AGGTGCCTTTTTGCTGTTAT,0,2252635
marRp,0.1,9,9,AGGGTTTAACTTTTATTCAA,0,2224035
marRp,0.1,9,9,AGGGATAATCTGTTGTGCCA,0,2242933
marRp,0.1,9,9,AGGCTCTCTACCCGTGCTAT,0,2221976
marRp,0.1,9,9,AGCATGGGAAGAGCCTGGGG,0,2253287
marRp,0.1,9,9,AGCATGATTTCAAGTGGGTT,0,2256521
marRp,0.1,9,9,AGAATTTCGGTTGTCTTGGA,0,2251578
marRp,0.1,9,9,AGAACACACATCTTTTCCGG,0,2251489
marRp,0.1,9,9,ACTTATATCATTCCCGGCCG,0,2232452
marRp,0.1,9,9,ACTCGTCACATGTATGATAG,0,2229993
marRp,0.1,9,9,ACGTGGGCCTTAGTCCCGAT,0,2241204
marRp,0.1,9,9,ACGTCTCGTGTTAATCTAGC,0,2218958
marRp,0.1,9,9,ACGGGGAAAGACTTTAAAGA,0,2221513
marRp,0.1,9,9,ACGCAGGCCGAAGCTTCGCT,0,2246077
marRp,0.1,9,9,ACCCTCTTTTATCAGTTGAC,0,2217821
marRp,0.1,9,9,ACCCGCGGGGACGCAACCCC,0,2220650
marRp,0.1,9,9,ACATACGTCCAGGAGTTTGG,0,2232534
marRp,0.1,9,9,AATTACGGGACCAACAGACT,0,2244031
marRp,0.1,9,9,AAGTGTTGGTACCCAGCCTA,0,2255033
marRp,0.1,9,9,AAGGTTCAAGGCTCGGTGCT,0,2258392
marRp,0.1,9,9,AAGCTTGGTCGATGTAAATG,0,2256665
marRp,0.1,9,9,AAGCCCATATCAATAAGCTT,0,2221372
marRp,0.1,9,9,AAATCTTGTCCGGAGAATTT,0,2217902
marRp,0.1,9,9,AAAGGTAGCCCTAGGAAGCG,0,2224208
marRp,0.1111111111111111,8,8,TTTTTGTATTAATTTTCACA,0,2231519
marRp,0.1111111111111111,8,8,TTTTCGAAACGAGGCATTTC,0,2252213
marRp,0.1111111111111111,8,8,TTTTACGTTGGATTGTTGCA,0,2253954
marRp,0.1111111111111111,8,8,TTTGCTAAACTATAACATCA,0,2222437
marRp,0.1111111111111111,8,8,TTTGCCACCACCAGACTCGG,0,2245502
marRp,0.1111111111111111,8,8,TTTCAGGTCCGGGTTGCTAC,0,2243768
marRp,0.1111111111111111,8,8,TTTACCCTGCGAAAAGAAGG,0,2227808
marRp,0.1111111111111111,8,8,TTGGGTCACCTTGGTAGCGT,0,2241660
marRp,0.1111111111111111,8,8,TTGAGTTTGGGCCTTAGACC,0,2238276
marRp,0.1111111111111111,8,8,TTCTGCGCTATCCGGCCTAT,0,2231299
marRp,0.1111111111111111,8,8,TTCTCTATCAAGGCGACTTT,0,2254499
marRp,0.1111111111111111,8,8,TTCCTACGTACCACGCCTGT,0,2225598
marRp,0.1111111111111111,8,8,TTCCGGACGGTCTTCTCGAG,0,2225949
marRp,0.1111111111111111,8,8,TTATTCCAGTGTTGAACGCA,0,2231154
marRp,0.1111111111111111,8,8,TTATGTTGAGTACCTATAGT,0,2243776
marRp,0.1111111111111111,8,8,TTATATCATGTCCCTTTCGT,0,2253668
marRp,0.1111111111111111,8,8,TGTTGGAGCACGGCGAGTCT,0,2238187
marRp,0.1111111111111111,8,8,TGTGATTGCCTTCTCTCAGA,0,2260819
marRp,0.1111111111111111,8,8,TGTACGTATTCTCTTTCTGC,0,2240908
marRp,0.1111111111111111,8,8,TGGCACGAGAAACAGGTGTC,0,2243327
marRp,0.1111111111111111,8,8,TGCGAGTTTAATGCCCAGAT,0,2232511
marRp,0.1111111111111111,8,8,TGCGACTGCTTAACGGGGGT,0,2234002
marRp,0.1111111111111111,8,8,TGCGACAATGAACCAGATAA,0,2221366
marRp,0.1111111111111111,8,8,TGCCTAACGGCAAGCTAGTT,0,2242130
marRp,0.1111111111111111,8,8,TGCAGCGATCAGCAGCTAAA,0,2222442
marRp,0.1111111111111111,8,8,TGACTGTAACCAAATTATAA,0,2251933
marRp,0.1111111111111111,8,8,TCTCTGGTTAAGGGTTACAT,0,2220979
marRp,0.1111111111111111,8,8,TCGTAACTAGCTAGTATGGT,0,2246432
marRp,0.1111111111111111,8,8,TCGGGGGACGGTGATAGACG,0,2232425
marRp,0.1111111111111111,8,8,TCCATGGAGTTTGCGTCGTC,0,2231404
marRp,0.1111111111111111,8,8,TCCATATGAAAGTTTGTAAG,0,2246736
marRp,0.1111111111111111,8,8,TCAGGTTGTCTCGCGCCCTT,0,2228836
marRp,0.1111111111111111,8,8,TCACCGTCCATCATTCCAGA,0,2232371
marRp,0.1111111111111111,8,8,TCAAGCCATATAACAACACA,0,2237205
marRp,0.1111111111111111,8,8,TCAACGCAATGGTAGGAAAG,0,2227404
marRp,0.1111111111111111,8,8,TCAACACTTAGCTGCTATTG,0,2256070
marRp,0.1111111111111111,8,8,TATGGTCAGTGATGAGAAGT,0,2220473
marRp,0.1111111111111111,8,8,TAGGTGACCTGCAAACGGGG,0,2251093
marRp,0.1111111111111111,8,8,TAGGTGAATCAGAGCCTTAT,0,2231426
marRp,0.1111111111111111,8,8,TAGGTAAAGATGAATGCCAG,0,2251394
marRp,0.1111111111111111,8,8,TAGGCGAGTTCGGTGACTGT,0,2244639
marRp,0.1111111111111111,8,8,TAGCACAGGTAGTCAACTCT,0,2243491
marRp,0.1111111111111111,8,8,TAGATATCAGAGTATGGTAC,0,2248797
marRp,0.1111111111111111,8,8,TAGACTCAGGCGGCGCCCAT,0,2229842
marRp,0.1111111111111111,8,8,TAGACGGCATCACGTCTAAG,0,2249990
marRp,0.1111111111111111,8,8,TACTACCGAACATCCCCATA,0,2244778
marRp,0.1111111111111111,8,8,TACGTGTATAAGGGAACATT,0,2230090
marRp,0.1111111111111111,8,8,TACGCGTCGAAACAGCAGAC,0,2229195
marRp,0.1111111111111111,8,8,TAAGCTCATGCATGAGTCCA,0,2250654
marRp,0.1111111111111111,8,8,TAACCGGTCCCTGCCAACAG,0,2231908
marRp,0.1111111111111111,8,8,GTTCAATACTATTTGGACTA,0,2221706
marRp,0.1111111111111111,8,8,GTGGTGGAAGTACCCAACTG,0,2243991
marRp,0.1111111111111111,8,8,GTGGCAGGGGACCGAAGGTA,0,2255320
marRp,0.1111111111111111,8,8,GTGACCCCATGGGCGCAGTG,0,2228501
marRp,0.1111111111111111,8,8,GTCTCTCGGCCCATACATCA,0,2230717
marRp,0.1111111111111111,8,8,GTCGGCAAAAATCAGATCAT,0,2253347
marRp,0.1111111111111111,8,8,GTAGGGTGCGGTGTAGGTTA,0,2222671
marRp,0.1111111111111111,8,8,GTAGCTGCGTCCAAATATCA,0,2242288
marRp,0.1111111111111111,8,8,GTAGATAACCATAGATGTCT,0,2251324
marRp,0.1111111111111111,8,8,GGTTCCAGGTCTGAAGACCA,0,2245105
marRp,0.1111111111111111,8,8,GGTTCCAGCAGTCACTACTA,0,2260569
marRp,0.1111111111111111,8,8,GGTTCAGACTGACACACACT,0,2251140
marRp,0.1111111111111111,8,8,GGTCGCTCACCTTACCCACA,0,2219188
marRp,0.1111111111111111,8,8,GGTAATTCTTGGCCAAAACT,0,2252822
marRp,0.1111111111111111,8,8,GGGGCCATCCACTATAGTCA,0,2246406
marRp,0.1111111111111111,8,8,GGGGATTAGCATTTTTCAGC,0,2228338
marRp,0.1111111111111111,8,8,GGGCCGCAGACCCGGGTGTT,0,2223058
marRp,0.1111111111111111,8,8,GGGCAATGCACTGGGTTAGC,0,2225849
marRp,0.1111111111111111,8,8,GGCCAGGCATGCTAACCATA,0,2225745
marRp,0.1111111111111111,8,8,GGCATCTTTGGGGCGAGGTA,0,2235514
marRp,0.1111111111111111,8,8,GGCAACGGATCGACTTCCGT,0,2228332
marRp,0.1111111111111111,8,8,GGATATACGTGGCGTATTTA,0,2258911
marRp,0.1111111111111111,8,8,GGAGCGCATTATTGACGGCC,0,2247490
marRp,0.1111111111111111,8,8,GGAGATAGCACCTTACGATA,0,2253097
marRp,0.1111111111111111,8,8,GGACTTAAATCAAATAGTCA,0,2239803
marRp,0.1111111111111111,8,8,GCTAACTAGGACCGTGTCTG,0,2236388
marRp,0.1111111111111111,8,8,GCGTTCTAGCATAGGTGTAC,0,2258778
marRp,0.1111111111111111,8,8,GCGGTCCACTTTATGTGCGT,0,2245647
marRp,0.1111111111111111,8,8,GCGGGATCAGCATTACATAG,0,2218176
marRp,0.1111111111111111,8,8,GCGGACCAATGTGCCGCATA,0,2218133
marRp,0.1111111111111111,8,8,GCGCGCGCGTGGGCTAGGGA,0,2224276
marRp,0.1111111111111111,8,8,GCGCCCCTTGCGTGAAGCTT,0,2229941
marRp,0.1111111111111111,8,8,GCCGTCGCAGATTTAGAGTG,0,2260240
marRp,0.1111111111111111,8,8,GCCCGCCCCCTTAGAAGACT,0,2241805
marRp,0.1111111111111111,8,8,GCCCAAATCTGTGCCATGCT,0,2235887
marRp,0.1111111111111111,8,8,GCCAGGTGCGAAAGAGTACT,0,2228614
marRp,0.1111111111111111,8,8,GCCAACCATGCACATTGGGT,0,2232913
marRp,0.1111111111111111,8,8,GCACTCGGTACTAACTGGCC,0,2255101
marRp,0.1111111111111111,8,8,GCAACCGTCGGAGTTCGTGA,0,2243492
marRp,0.1111111111111111,8,8,GATTTACGTGGGGCACCTCG,0,2233934
marRp,0.1111111111111111,8,8,GATTAGAAGCGCCCACCAAA,0,2221753
marRp,0.1111111111111111,8,8,GATGAAGAAGCCTGACGCCA,0,2239295
marRp,0.1111111111111111,8,8,GAGGCAAGCAACTCGGTCTT,0,2253257
marRp,0.1111111111111111,8,8,GAGGATTACAATCTCGATAG,0,2218934
marRp,0.1111111111111111,8,8,GACGAAAAATCGTAGCAAGT,0,2254366
marRp,0.1111111111111111,8,8,CTCACGTTATATGGGGCTTG,0,2235641
marRp,0.1111111111111111,8,8,CTATTACGGGCGGTTCAGAT,0,2223624
marRp,0.1111111111111111,8,8,CTAGTTAAGTCGTATATTTG,0,2233717
marRp,0.1111111111111111,8,8,CGTGGATTTATTTCGGAAGT,0,2260106
marRp,0.1111111111111111,8,8,CGTAAGGCCAAGTACCCAAT,0,2242525
marRp,0.1111111111111111,8,8,CGGTTAAATTGTTGGGTCGT,0,2228461
marRp,0.1111111111111111,8,8,CGGTCCGTCGGCACATCATC,0,2235155
marRp,0.1111111111111111,8,8,CGGCCCAAATGATAAATGAG,0,2242476
marRp,0.1111111111111111,8,8,CGCTCCGTGAATTGTCATCA,0,2253376
marRp,0.1111111111111111,8,8,CGCGTATTGCCCGTCCTGTT,0,2250613
marRp,0.1111111111111111,8,8,CGCGGGATCTTGTAATATTA,0,2228887
marRp,0.1111111111111111,8,8,CGATTAGTCAGTATGGAGAA,0,2233499
marRp,0.1111111111111111,8,8,CGACACTACTTCCCGATGCC,0,2223477
marRp,0.1111111111111111,8,8,CCTACAAAAGTCGTTCATTT,0,2258460
marRp,0.1111111111111111,8,8,CCGTGTTATTTTGCAGTGCT,0,2260934
marRp,0.1111111111111111,8,8,CCGGTTAGGCGAAGCAATGG,0,2241806
marRp,0.1111111111111111,8,8,CCGGAGCGTTTTGTCGCGTG,0,2222276
marRp,0.1111111111111111,8,8,CCGGACTTGAAGGCAGTAAC,0,2226380
marRp,0.1111111111111111,8,8,CCGGACGGGGAACAGCCACC,0,2221959
marRp,0.1111111111111111,8,8,CCCCTCAAAGCGGAAGGGAT,0,2238644
marRp,0.1111111111111111,8,8,CCATGATGGGCCGTGCGGGA,0,2252147
marRp,0.1111111111111111,8,8,CCAGGCGCGGTCGGTGCTCC,0,2227683
marRp,0.1111111111111111,8,8,CCAGCCATCTTGGGTTATGG,0,2245466
marRp,0.1111111111111111,8,8,CCAGAGGGTTACCCTGACAA,0,2224993
marRp,0.1111111111111111,8,8,CCACTCAGAGCGTTTGGTAG,0,2236157
marRp,0.1111111111111111,8,8,CCAATTGCCATTCCGTCCTA,0,2239598
marRp,0.1111111111111111,8,8,CCAACCGGACGAAGGAACCA,0,2228817
marRp,0.1111111111111111,8,8,CATGATGAACGGCGCAATAA,0,2225667
marRp,0.1111111111111111,8,8,CATCCAAGTTCAGACTGGTG,0,2230868
marRp,0.1111111111111111,8,8,CATATGGCTCCCCACGAGCG,0,2219989
marRp,0.1111111111111111,8,8,CATATACAATCTATGTGGCT,0,2235358
marRp,0.1111111111111111,8,8,CAGGTGGCTCACAACGTTCG,0,2220963
marRp,0.1111111111111111,8,8,CAGCTGCACCCGGGTACCGT,0,2251816
marRp,0.1111111111111111,8,8,CAGCAAGTTTTAAACATAAC,0,2258661
marRp,0.1111111111111111,8,8,CACGGGGGAGACAAGTATTA,0,2231344
marRp,0.1111111111111111,8,8,CACGAAAAAGATAGACACTT,0,2225675
marRp,0.1111111111111111,8,8,CACCTCATGATCCAGGAAAC,0,2246577
marRp,0.1111111111111111,8,8,CACCTAGGCAGTCTGTCTAC,0,2221657
marRp,0.1111111111111111,8,8,CAAGGTCATGCGGAAATACT,0,2231277
marRp,0.1111111111111111,8,8,CAAAGGCAACTTTTCTTTAA,0,2259182
marRp,0.1111111111111111,8,8,CAAAATGATGGATCTAGTCA,0,2239050
marRp,0.1111111111111111,8,8,ATTGGGTGGTATCGACGTCA,0,2239805
marRp,0.1111111111111111,8,8,ATTGAGGTAACAGCCACACG,0,2232698
marRp,0.1111111111111111,8,8,ATGGCACCCCTATATATTCA,0,2242792
marRp,0.1111111111111111,8,8,ATCTCCGAGCTGGTCACCTG,0,2256232
marRp,0.1111111111111111,8,8,ATCGGGTCCACTGTGCGGAG,0,2238188
marRp,0.1111111111111111,8,8,ATCGATATAATGAGTAGTGC,0,2246088
marRp,0.1111111111111111,8,8,ATCCACGTGAGGTGCCCTAC,0,2217945
marRp,0.1111111111111111,8,8,ATATACATAAATAAAAACTC,0,2248635
marRp,0.1111111111111111,8,8,ATAAAGTTAGGCCGTGTAAG,0,2237697
marRp,0.1111111111111111,8,8,AGTTCAGACTCCTCGTTTTT,0,2256955
marRp,0.1111111111111111,8,8,AGTTAATCTGTTAGGTGGTT,0,2230998
marRp,0.1111111111111111,8,8,AGTGTATTCCAGGGTCGTTG,0,2218480
marRp,0.1111111111111111,8,8,AGTGAGCGAGGGGCTCTTCG,0,2237203
marRp,0.1111111111111111,8,8,AGTCACTTCGATGAACACTA,0,2256828
marRp,0.1111111111111111,8,8,AGGGCCTATCGAAACAGTTG,0,2250875
marRp,0.1111111111111111,8,8,AGGCTGTTTCGGATCCGTAC,0,2230181
marRp,0.1111111111111111,8,8,AGGCTGATTATGGTCAACAT,0,2230947
marRp,0.1111111111111111,8,8,AGGACGGACTAGGATTAAAC,0,2230076
marRp,0.1111111111111111,8,8,AGCTCCCGCGTGACTGTTTG,0,2233712
marRp,0.1111111111111111,8,8,AGATGCTACGAGCCCTGTCG,0,2258998
marRp,0.1111111111111111,8,8,AGATCTGGCAGGCAAGCTCA,0,2253162
marRp,0.1111111111111111,8,8,AGACGACGCGTCTGAATCAG,0,2233489
marRp,0.1111111111111111,8,8,ACTCTAGAATAGGTGCCGAC,0,2218912
marRp,0.1111111111111111,8,8,ACTCATATCCGCTTTCCTCA,0,2226387
marRp,0.1111111111111111,8,8,ACTCACCAAATTGGCGACAA,0,2237253
marRp,0.1111111111111111,8,8,ACGTATAATACACGAACGAT,0,2218458
marRp,0.1111111111111111,8,8,ACGGGGAATGGAGTTCAGAA,0,2227235
marRp,0.1111111111111111,8,8,ACGCTATGAAAGCAAGAGCT,0,2239069
marRp,0.1111111111111111,8,8,ACCTTGGACCGGGTAAAGAG,0,2240037
marRp,0.1111111111111111,8,8,ACCAGCGGTACGTCGGCCTT,0,2247438
marRp,0.1111111111111111,8,8,ACATGCTTGTGATCGGATTA,0,2226020
marRp,0.1111111111111111,8,8,ACAAGCATGCGCTCAACACC,0,2258809
marRp,0.1111111111111111,8,8,AAGTTATCGCGTCAAATTGC,0,2236893
marRp,0.1111111111111111,8,8,AAGCAAGCCGGTATTTGCTG,0,2228066
marRp,0.1111111111111111,8,8,AACGGTTTGTTTCTGTCGAT,0,2260121
marRp,0.1111111111111111,8,8,AACAGATTTCGTTGCTCTTG,0,2223980
marRp,0.1111111111111111,8,8,AAATTCACCCAGACTTCACC,0,2249765
marRp,0.1111111111111111,8,8,AAATCGATTGAATTTCGACC,0,2244037
marRp,0.1111111111111111,8,8,AAACCTCGGTAGTTCTCTGC,0,2220628
marRp,0.125,7,7,TTTTGGGTTCCATGCTTCAG,0,2223040
marRp,0.125,7,7,TTTTAGAGATTCTAAAGAAT,0,2260000
marRp,0.125,7,7,TTTTACGATGCATGTCTTGC,0,2251814
marRp,0.125,7,7,TTTGCGTAAGCGGGGGCGAT,0,2245329
marRp,0.125,7,7,TTTGCAGTATTCTCTTCTTG,0,2258250
marRp,0.125,7,7,TTTATGGGGTGAGCGTCCGC,0,2225984
marRp,0.125,7,7,TTTACCTACCACCATCTCTC,0,2218245
marRp,0.125,7,7,TTGTTTTAAGGAAACGCCAG,0,2230972
marRp,0.125,7,7,TTGTCATATGTCCCCGTTTG,0,2222267
marRp,0.125,7,7,TTGGCAAATAGTGGTAGCCT,0,2227463
marRp,0.125,7,7,TTGCGTGGGACATCCAGGTC,0,2256740
marRp,0.125,7,7,TTGACTGGATAGTACTATAG,0,2250602
marRp,0.125,7,7,TTGACTCTTTTGCTAATTGC,0,2234043
marRp,0.125,7,7,TTCTGTTTTGGAGCATATTA,0,2230704
marRp,0.125,7,7,TTCCCGATGTATAGTGCCTC,0,2236135
marRp,0.125,7,7,TTATCATTTGAGCGCGTTGT,0,2249298
marRp,0.125,7,7,TTAGGAGTATAAAATGTTGT,0,2259315
marRp,0.125,7,7,TTAGATTGGTTAATCTGGTC,0,2227519
marRp,0.125,7,7,TTAATAAACGGGCGAAAAGA,0,2250948
marRp,0.125,7,7,TTAAGTGCGTACGGGAATGG,0,2255354
marRp,0.125,7,7,TTAAGTCTGGTTGTTAATCT,0,2258669
marRp,0.125,7,7,TGTAATAGGATAGCCGTATT,0,2231332
marRp,0.125,7,7,TGGTCCGCTTCGACGGTCGT,0,2232469
marRp,0.125,7,7,TGGATTATAGGGAGGGGGTT,0,2226408
marRp,0.125,7,7,TGGAACGGTTCGTTGTTTGG,0,2237800
marRp,0.125,7,7,TGGAACAACCGCTTATCGAT,0,2239771
marRp,0.125,7,7,TGCTTTGGGAAAGTTATGAA,0,2226390
marRp,0.125,7,7,TGCTTACGTCAGCTGGGGGG,0,2241388
marRp,0.125,7,7,TGCGTCTTTGTATTTGTCAG,0,2225946
marRp,0.125,7,7,TGCACAAATCTTATTTCGGT,0,2229860
marRp,0.125,7,7,TGAGTTCCACCTCGGATCAT,0,2242942
marRp,0.125,7,7,TGAGCGAGATTTGAGGCGAA,0,2221046
marRp,0.125,7,7,TGAATCGCGCCTACGCTTTA,0,2227178
marRp,0.125,7,7,TCTAAATCAAGCTCCGACGC,0,2231069
marRp,0.125,7,7,TCGTGGTGTCGGTCCAAAAC,0,2241860
marRp,0.125,7,7,TCGTCAGTAATTCAACTTCG,0,2251495
marRp,0.125,7,7,TCGGGTGATAAATCGGAACC,0,2222917
marRp,0.125,7,7,TCGCGATTGGCCCGGGATCA,0,2251483
marRp,0.125,7,7,TCACGCGCACCAGGAATGTA,0,2258259
marRp,0.125,7,7,TCACCGGGTTAGCTGAATTA,0,2231530
marRp,0.125,7,7,TCAATGAGGGCTGTAGGCGT,0,2246196
marRp,0.125,7,7,TCAACAGAAGGCACCTGTGA,0,2226781
marRp,0.125,7,7,TATTGTTTGGACCGATGCGT,0,2233714
marRp,0.125,7,7,TATTGCCAAAGCCTTAAATA,0,2221252
marRp,0.125,7,7,TAGGGGGACAAGTGCAGCGA,0,2221709
marRp,0.125,7,7,TAGCTATGGACCTTTTAGGA,0,2233574
marRp,0.125,7,7,TAGATCTCAGGTCTCCAGAT,0,2218650
marRp,0.125,7,7,TAGAGCGAAGTATGTCTAGT,0,2242170
marRp,0.125,7,7,TAGAATGTTCATACTCGACC,0,2220699
marRp,0.125,7,7,TACTCGCTAGATTAAATCCA,0,2239189
marRp,0.125,7,7,TACTCAGTACATGGGCGCTG,0,2251860
marRp,0.125,7,7,TAATGCTGGCGATTCAGCGG,0,2247874
marRp,0.125,7,7,TAATGCTGCACCAGCTCCAC,0,2247077
marRp,0.125,7,7,TAAGTGGAAGATCGCCGAGT,0,2224443
marRp,0.125,7,7,TAACAAGTGGTTTTGGTCGC,0,2254010
marRp,0.125,7,7,GTTCAAGGCGCTACAACTTA,0,2223051
marRp,0.125,7,7,GTTATGTGGGGCTAAACTTA,0,2254752
marRp,0.125,7,7,GTTATAGAAGCTTCGGCCCG,0,2220325
marRp,0.125,7,7,GTTAGAGCTGGGATCGCGAT,0,2228479
marRp,0.125,7,7,GTGTGTTAGGAGTCAATATC,0,2259914
marRp,0.125,7,7,GTGTGCTCAAGGAACAGCCA,0,2228716
marRp,0.125,7,7,GTGGTGAAATTGTCGTTGAT,0,2257034
marRp,0.125,7,7,GTGGCAGTTATGTCGCTTGT,0,2246431
marRp,0.125,7,7,GTGACTTGTTCCACACCTAG,0,2236326
marRp,0.125,7,7,GTCTGGTGACCCGGCCTGCG,0,2231230
marRp,0.125,7,7,GTCTGATAAGACACCCGCCC,0,2228512
marRp,0.125,7,7,GTCGTCATGCTGGGTATTGA,0,2224474
marRp,0.125,7,7,GTCGTAGGTGTAAGGGTCAA,0,2255333
marRp,0.125,7,7,GTCGGCACCGTAGTGCGGCT,0,2244986
marRp,0.125,7,7,GTCCGACAGGACTCATATGT,0,2237308
marRp,0.125,7,7,GTCCAAGACGTACGGGGCAT,0,2237602
marRp,0.125,7,7,GTCCAAAAAATAGGTAATGG,0,2246663
marRp,0.125,7,7,GTCAGCCACGGATAAGTTTC,0,2240202
marRp,0.125,7,7,GTATCTTAGGGGGGAGTCGG,0,2243949
marRp,0.125,7,7,GTAGACTGTAAGCCCCGAAG,0,2236024
marRp,0.125,7,7,GTAGAAACCGGTTAACATCA,0,2245879
marRp,0.125,7,7,GTAAGTGAGGTCAAGGCGAA,0,2246581
marRp,0.125,7,7,GGTCAGTAAGTGTCACATCT,0,2249661
marRp,0.125,7,7,GGGTAAGGAGTTAACGTAAT,0,2244370
marRp,0.125,7,7,GGGGGATAATCGACACGTAT,0,2240388
marRp,0.125,7,7,GGGAGGGTGTTCACCATTGG,0,2241661
marRp,0.125,7,7,GGGACGCCAACCTTCATGAC,0,2218277
marRp,0.125,7,7,GGCTAGGACGGCGTCAGATA,0,2233180
marRp,0.125,7,7,GGATTCGCGCGATACGATTC,0,2242669
marRp,0.125,7,7,GGATGCGATAGCCGTAGAGA,0,2217956
marRp,0.125,7,7,GGATCCAACTGTGAATCTGA,0,2258161
marRp,0.125,7,7,GGACGGGTCGATAATAGGTG,0,2247441
marRp,0.125,7,7,GGACGCGCAAACCTCTGTGT,0,2254189
marRp,0.125,7,7,GCGTTCAAATGTCAACAGTG,0,2230421
marRp,0.125,7,7,GCGGAGGGTCGGGGCCTCTA,0,2250037
marRp,0.125,7,7,GCGGACCTCATATCTGAGTA,0,2223784
marRp,0.125,7,7,GCGAATATAGGCAAAGGTTC,0,2255721
marRp,0.125,7,7,GCGAATAAAATGTTTACACG,0,2221517
marRp,0.125,7,7,GCCGTCAGATTGTCTCTTCG,0,2255645
marRp,0.125,7,7,GCCCCATGACAGACTTCCGG,0,2257758
marRp,0.125,7,7,GCATATAGTAAAGACCCAAG,0,2231331
marRp,0.125,7,7,GCACTCACTGTGTAAAACTG,0,2222710
marRp,0.125,7,7,GATTATCTACCGTGGGGACA,0,2221043
marRp,0.125,7,7,GATTATATGCGGGTGAGTTG,0,2245078
marRp,0.125,7,7,GATGGATCCATTCAGTCCAT,0,2219241
marRp,0.125,7,7,GAGCGTCGTTTGAGCTAGTG,0,2230664
marRp,0.125,7,7,GAGCACGGACGGTCGGTGGC,0,2234627
marRp,0.125,7,7,GAGAAGGATTCATAGATAAA,0,2243444
marRp,0.125,7,7,GACTGTCTGGTACCAGTGAG,0,2259266
marRp,0.125,7,7,GACGTAGTTCAGTGCAGATT,0,2228306
marRp,0.125,7,7,GACCCCTAAAAGCTATCAGA,0,2231222
marRp,0.125,7,7,CTTTGTGTGCGCCATCCGGA,0,2234971
marRp,0.125,7,7,CTTACACGCAGGGCTCTGAG,0,2221315
marRp,0.125,7,7,CTGTGTGCAATAAGCTATTG,0,2247347
marRp,0.125,7,7,CTGATCGGTAAGCTTCTAAT,0,2221178
marRp,0.125,7,7,CTGAGAGAAAGGTCGTTTTG,0,2226976
marRp,0.125,7,7,CTCTTATTACGGATGTCTAA,0,2253971
marRp,0.125,7,7,CTCGTCACCGAACGGCATGT,0,2237858
marRp,0.125,7,7,CTATATCTACATGAACGTCG,0,2221958
marRp,0.125,7,7,CTAAGGACGCCACATCGGAC,0,2254520
marRp,0.125,7,7,CGTGGCGGCGACTGATGAAA,0,2239937
marRp,0.125,7,7,CGTATCGCGACACCGATGTC,0,2252009
marRp,0.125,7,7,CGTAATGAGGTACCCTAAAC,0,2227579
marRp,0.125,7,7,CGGTTGATCCGTATATCTAT,0,2243728
marRp,0.125,7,7,CGGTCCGGGACCGATATAAG,0,2228741
marRp,0.125,7,7,CGGGTTGGTACAGTGTATGC,0,2236982
marRp,0.125,7,7,CGGCGGTGAGCTTATCCGCG,0,2224682
marRp,0.125,7,7,CGGCCGCAACATGACAGTTA,0,2236469
marRp,0.125,7,7,CGGAGCATCATAGATATATC,0,2249762
marRp,0.125,7,7,CGCTGGCATAATGAGGGTTA,0,2226194
marRp,0.125,7,7,CGCGTCTAGAAGGCACTCGT,0,2233643
marRp,0.125,7,7,CGCATAGGTTGGCTCTACTG,0,2247784
marRp,0.125,7,7,CCTGCCTGGACGTTTCGCCT,0,2218464
marRp,0.125,7,7,CCTACCCTTACAGTATGTCC,0,2228733
marRp,0.125,7,7,CCGCGAGGATCCGCTTCTTA,0,2238204
marRp,0.125,7,7,CCGCCGCGACATAACAGCGT,0,2243352
marRp,0.125,7,7,CCGCCAGAAGGACCTTGCAA,0,2250852
marRp,0.125,7,7,CCCGCCTGCTACTGTGGGAG,0,2227125
marRp,0.125,7,7,CCCGAGACGGTGGGCGAATA,0,2252850
marRp,0.125,7,7,CCCAGAAAGACCCTAAGTGT,0,2236472
marRp,0.125,7,7,CCATTAGTGTGGTCTCGGTA,0,2234707
marRp,0.125,7,7,CCAGGTAAAGGCCCCAGGAG,0,2223252
marRp,0.125,7,7,CCACTCTCCAAAGTGCGCGT,0,2257268
marRp,0.125,7,7,CATTGATTCTGTGCGGGTGA,0,2218199
marRp,0.125,7,7,CATTACCAGATATTCTCTCG,0,2222537
marRp,0.125,7,7,CATCCAAAAGCGCATGTGCG,0,2228795
marRp,0.125,7,7,CAGGATCACTTACGTTCTAA,0,2229998
marRp,0.125,7,7,CAGCGTTCGGACATGTCCAA,0,2233629
marRp,0.125,7,7,CAGCATTACGGGATGGCCGC,0,2249075
marRp,0.125,7,7,CACTTGTTAGAGGGCTACAA,0,2259060
marRp,0.125,7,7,CACTAGGCCCTTGCAGTCCA,0,2244095
marRp,0.125,7,7,CACGCGCGTCTGTTGAATTA,0,2226079
marRp,0.125,7,7,CACCCTGCCACTTTCTGCGT,0,2224672
marRp,0.125,7,7,CACAGTACTCACCCGTGCGG,0,2220336
marRp,0.125,7,7,CAATCGCCGCTGTACTTTCA,0,2227503
marRp,0.125,7,7,ATTGTTCGCCACAAACGACA,0,2220960
marRp,0.125,7,7,ATTCAGGTCAAAATAAGAAT,0,2246327
marRp,0.125,7,7,ATTATTCCGACTATCACGTC,0,2227188
marRp,0.125,7,7,ATTATAGGTCAGTAGGGTAA,0,2228954
marRp,0.125,7,7,ATTACACGGACGAACAAAGT,0,2259300
marRp,0.125,7,7,ATGTCTGCTACAATCCACAG,0,2230707
marRp,0.125,7,7,ATGGTTAGTCTTTGTCAAGT,0,2244632
marRp,0.125,7,7,ATGGGGAGTATTAGTCTTTG,0,2251124
marRp,0.125,7,7,ATGCCTTGTATCGTAAAAGT,0,2248757
marRp,0.125,7,7,ATGAGGTCTGTAATTTGAAC,0,2222204
marRp,0.125,7,7,ATCTTCAAAGCAAGAGGCTG,0,2255555
marRp,0.125,7,7,ATCTGTGAAATTGATCTTTC,0,2234580
marRp,0.125,7,7,ATCTCCGGACAACTCGTCGA,0,2220419
marRp,0.125,7,7,ATCGTATGAATTGGCTGGCC,0,2247880
marRp,0.125,7,7,ATCGAGATATCTGCGTGTCA,0,2250031
marRp,0.125,7,7,ATCAACCGCTTTACCCCTAG,0,2243394
marRp,0.125,7,7,ATATCTACAGGGTCTGGTAG,0,2260803
marRp,0.125,7,7,ATATACAAAAGTCAATTCAT,0,2236013
marRp,0.125,7,7,ATACCACAACCTAGAATGGG,0,2233212
marRp,0.125,7,7,ATACAAGCTTGCTCGTGACA,0,2253937
marRp,0.125,7,7,ATAAGTATGAGATAGCTGAA,0,2223530
marRp,0.125,7,7,ATAAGTACCGCCACATACTT,0,2244221
marRp,0.125,7,7,ATAACAGACTCTATGTTATA,0,2233589
marRp,0.125,7,7,AGTTATGCTTACGGGGCTAT,0,2250317
marRp,0.125,7,7,AGTCAAGCCGGCCTACAGTA,0,2259366
marRp,0.125,7,7,AGTAGGTGATCGAAATATCA,0,2251679
marRp,0.125,7,7,AGGTGGTCTCCACGCGCATA,0,2243546
marRp,0.125,7,7,AGGCGTGACACTGTGGTTGT,0,2252685
marRp,0.125,7,7,AGGCGAGGGGAGGTGCAAAG,0,2252790
marRp,0.125,7,7,AGGAGTTGTCCCGTCCGCAG,0,2260098
marRp,0.125,7,7,AGGAGCTGGATCCTACTAGG,0,2242570
marRp,0.125,7,7,AGCTTAATCCCTCACGGGCA,0,2223053
marRp,0.125,7,7,AGCTAGCTGTCCGAGTACAG,0,2229420
marRp,0.125,7,7,AGCCTGTAAATGCATTGCGA,0,2253949
marRp,0.125,7,7,AGCAGTTATTGGATGACCCT,0,2220877
marRp,0.125,7,7,AGCACTTTCGTTTACAAATG,0,2252164
marRp,0.125,7,7,AGATCCTCGATTGATATAAG,0,2248789
marRp,0.125,7,7,AGAGTACTGCCACATTCCGG,0,2238615
marRp,0.125,7,7,ACTGTAAAGGGGAAAGTTTA,0,2260237
marRp,0.125,7,7,ACTCGTGAACATACGCTCAA,0,2258468
marRp,0.125,7,7,ACGGTTGACCTGGACTAAGC,0,2248878
marRp,0.125,7,7,ACGGCAGACTTCCACGTGGC,0,2226392
marRp,0.125,7,7,ACGGAGTGGCGGTCAGTAAT,0,2218180
marRp,0.125,7,7,ACGCCTCATGCTCCGCACGT,0,2252712
marRp,0.125,7,7,ACCTGGCCACGCCCATCGCG,0,2259859
marRp,0.125,7,7,ACCTGCCACCGCTGCTGTTT,0,2246905
marRp,0.125,7,7,ACCGGGAGTAACTCACAGGT,0,2237610
marRp,0.125,7,7,ACCGATGGAACTAGCATTCT,0,2228788
marRp,0.125,7,7,ACCCGGCGTCCACAATTGCC,0,2246219
marRp,0.125,7,7,ACCCGGCGAACGTGTATTGA,0,2251687
marRp,0.125,7,7,ACATTGGGTGATATAAACTT,0,2258030
marRp,0.125,7,7,ACAGTTCATATGATACGATC,0,2236936
marRp,0.125,7,7,AATATTGGGAGGCCTCTAAA,0,2219495
marRp,0.125,7,7,AATATCTCTCTATCTGCGAT,0,2224992
marRp,0.125,7,7,AATAGCACGTTAGCTCCCAC,0,2253750
marRp,0.125,7,7,AAGTGCAAAGTGACGGCAAA,0,2244868
marRp,0.125,7,7,AAGGTATAATCTTCCCATCG,0,2248758
marRp,0.125,7,7,AAGATTCCAGTGTATTCAAC,0,2221217
marRp,0.125,7,7,AAGACTACCTCTTCCTGAAA,0,2225576
marRp,0.125,7,7,AACTTCAGCATGGAAAAAAC,0,2257052
marRp,0.125,7,7,AACCTTATACCGTACCCGGC,0,2234744
marRp,0.125,7,7,AACACGGGTCAGACCTCGTA,0,2228466
marRp,0.125,7,7,AACACAGACATGTGTCACCT,0,2220880
marRp,0.125,7,7,AAAATGCATGGGTCTGCGGT,0,2218469
marRp,0.14285714285714285,6,6,TTTGTACGAGATATTTGAAT,0,2219992
marRp,0.14285714285714285,6,6,TTTGCTGTCCGAAGGTGGCG,0,2219114
marRp,0.14285714285714285,6,6,TTGTTAGCGACTGGATGCAA,0,2219170
marRp,0.14285714285714285,6,6,TTGTAGCTAAACCGCCCAGC,0,2257757
marRp,0.14285714285714285,6,6,TTGCGTTTGAGTTAGAAGGG,0,2231979
marRp,0.14285714285714285,6,6,TTCTCCCATTGGGCTAATAT,0,2251739
marRp,0.14285714285714285,6,6,TTCCTGGGATTGTGCACTCA,0,2252897
marRp,0.14285714285714285,6,6,TTCCTAAAATCTGCTTACTC,0,2259299
marRp,0.14285714285714285,6,6,TTAGGAGGGGTCCTGGTAGA,0,2248828
marRp,0.14285714285714285,6,6,TGTTTCATCGTTTCCGATGT,0,2234023
marRp,0.14285714285714285,6,6,TGTTGCTCGTCCTGGCGCAA,0,2232594
marRp,0.14285714285714285,6,6,TGTTCACACGAGACTCCGTA,0,2235356
marRp,0.14285714285714285,6,6,TGTGTTGTGCCCCGGCATTG,0,2226529
marRp,0.14285714285714285,6,6,TGTGACTTGTCCGTCGCAGC,0,2231505
marRp,0.14285714285714285,6,6,TGTAAGGGTCCCAATCAAAT,0,2246956
marRp,0.14285714285714285,6,6,TGGTTGAAAGCTTTGGTCAT,0,2255905
marRp,0.14285714285714285,6,6,TGGTGGCGGTCGTACCTTAT,0,2217952
marRp,0.14285714285714285,6,6,TGGTCCACTCAGCGTTGATT,0,2236448
marRp,0.14285714285714285,6,6,TGGGTGAAAACAGGAGTCTA,0,2246087
marRp,0.14285714285714285,6,6,TGGGGCATAGCCTGAGTTGC,0,2239170
marRp,0.14285714285714285,6,6,TGGAGAGCGGCTATTGGGGA,0,2235592
marRp,0.14285714285714285,6,6,TGGAACACCCCGTGGTTATC,0,2226635
marRp,0.14285714285714285,6,6,TGCTTGATTGGGGCATGATA,0,2244775
marRp,0.14285714285714285,6,6,TGCGCTCCAACGTGGAAATC,0,2227462
marRp,0.14285714285714285,6,6,TGCCTAAATTTTCGCCCGCA,0,2242651
marRp,0.14285714285714285,6,6,TGCCGTGTCCCGCCCACGGT,0,2249662
marRp,0.14285714285714285,6,6,TGAGAGACGGCGTTTTGACC,0,2258189
marRp,0.14285714285714285,6,6,TGACTGGGCCTCTAACCGGC,0,2233416
marRp,0.14285714285714285,6,6,TGAAGAACCCACTTTCGGTA,0,2258360
marRp,0.14285714285714285,6,6,TCTTGTAAAAATGGGGAGCG,0,2257934
marRp,0.14285714285714285,6,6,TCTTCGAGGCCAAATCACGG,0,2255532
marRp,0.14285714285714285,6,6,TCTTAGATTACTACATATCT,0,2233557
marRp,0.14285714285714285,6,6,TCTCCGTATTCTAGTAAAGG,0,2240739
marRp,0.14285714285714285,6,6,TCTAGAGTTATTCAGTACTA,0,2219704
marRp,0.14285714285714285,6,6,TCTAACGTTGTGGGCAATCA,0,2237057
marRp,0.14285714285714285,6,6,TCGTTGCCGTGTGTAAATTT,0,2225449
marRp,0.14285714285714285,6,6,TCGCTCATTACCACGAGTGC,0,2254667
marRp,0.14285714285714285,6,6,TCGATTGACTATAGGAGCCT,0,2253552
marRp,0.14285714285714285,6,6,TCCGTCGAACCCTGCTTCCA,0,2241274
marRp,0.14285714285714285,6,6,TCCAGTCGTCGGGCAGAGGA,0,2226089
marRp,0.14285714285714285,6,6,TCAGTGCTTGCGTCCCGTCC,0,2259959
marRp,0.14285714285714285,6,6,TCACCTCTCGCGGTGTATAG,0,2249598
marRp,0.14285714285714285,6,6,TCAACAAGGCAGGCGGCTAT,0,2243737
marRp,0.14285714285714285,6,6,TATGGAGTCACCGGATATTC,0,2217896
marRp,0.14285714285714285,6,6,TATGCCAAATAGTCGGCCGA,0,2238277
marRp,0.14285714285714285,6,6,TATCTACAGTCGATATTCGG,0,2237196
marRp,0.14285714285714285,6,6,TATCGGTATCGTTAACCACG,0,2245024
marRp,0.14285714285714285,6,6,TATACCAATGCGGGCGTGGG,0,2247812
marRp,0.14285714285714285,6,6,TAGAGCACCGCACGCGAATC,0,2219448
marRp,0.14285714285714285,6,6,TAGAGACCTAGATCCATGCC,0,2229853
marRp,0.14285714285714285,6,6,TACTCGTGGAAGAAAGAGCG,0,2219281
marRp,0.14285714285714285,6,6,TACGTGTATACGCACTGGCA,0,2259823
marRp,0.14285714285714285,6,6,TACCTTATAGAACCCGGCTA,0,2252490
marRp,0.14285714285714285,6,6,TACACACAAGAAGAGTAGTC,0,2220382
marRp,0.14285714285714285,6,6,TAAGGCGCCGCTTAGCTCCC,0,2238641
marRp,0.14285714285714285,6,6,GTTTGACAGTAAAGCGAGAG,0,2255518
marRp,0.14285714285714285,6,6,GTTCTGAGCCTTTGCAGTTG,0,2233786
marRp,0.14285714285714285,6,6,GTTATCGTCCCTACGGGGCA,0,2254158
marRp,0.14285714285714285,6,6,GTGTGGTGAGCCATTTTGTA,0,2246209
marRp,0.14285714285714285,6,6,GTGTGGTCAGGGTTCACATA,0,2254584
marRp,0.14285714285714285,6,6,GTGTATGATGCGGGTCACGA,0,2238013
marRp,0.14285714285714285,6,6,GTGGTATGGTACCTGGGTCA,0,2236005
marRp,0.14285714285714285,6,6,GTGCTGTGGGGCTCTACTCG,0,2234675
marRp,0.14285714285714285,6,6,GTGCAGCGTGGAGCCTCATG,0,2252674
marRp,0.14285714285714285,6,6,GTGAGCTAGCGCGGTCTATA,0,2231904
marRp,0.14285714285714285,6,6,GTCTGAAGTGCAGTGAGCGT,0,2252017
marRp,0.14285714285714285,6,6,GTCGCCCAGTAGCCGGTCCA,0,2236985
marRp,0.14285714285714285,6,6,GTCGAGGATAGTTCTTTAAT,0,2243344
marRp,0.14285714285714285,6,6,GTCCATTACGAAGCACGTGA,0,2218181
marRp,0.14285714285714285,6,6,GTATTACACATCTGATACAT,0,2232580
marRp,0.14285714285714285,6,6,GTATCATGCATGAGCTGTGC,0,2234062
marRp,0.14285714285714285,6,6,GTATAACTGATGATCATGCA,0,2253545
marRp,0.14285714285714285,6,6,GTAGTTGGTGGCTCACGCAG,0,2253264
marRp,0.14285714285714285,6,6,GTAGGTAATGTGTACAGGCG,0,2224209
marRp,0.14285714285714285,6,6,GTACTGCAGTTTCGGAGTCA,0,2229424
marRp,0.14285714285714285,6,6,GTACAGTGTTATTCGGACTG,0,2233374
marRp,0.14285714285714285,6,6,GTAAGAATTCCAGGGAGATA,0,2254289
marRp,0.14285714285714285,6,6,GTAAACTTAGAAGTGGAGTA,0,2254203
marRp,0.14285714285714285,6,6,GGTGTAATGAGAGACCGTAC,0,2245776
marRp,0.14285714285714285,6,6,GGTGCGCGGTGCAGAACTTG,0,2243161
marRp,0.14285714285714285,6,6,GGTCTAGAGGGCGCCGGGTA,0,2260087
marRp,0.14285714285714285,6,6,GGTCCCGCTTGTTAACCGCA,0,2244130
marRp,0.14285714285714285,6,6,GGTAGCGTTCCTATTGGGCA,0,2248205
marRp,0.14285714285714285,6,6,GGGGCAAATCCAGAGGAATG,0,2240068
marRp,0.14285714285714285,6,6,GGGCCTTGAATCTAGTGGAT,0,2224196
marRp,0.14285714285714285,6,6,GGCCCAATGCTCTATGGGGA,0,2248798
marRp,0.14285714285714285,6,6,GGCAGGTTAGCGTGATCGGA,0,2243249
marRp,0.14285714285714285,6,6,GGATTTGCATCAGGTACTTC,0,2220383
marRp,0.14285714285714285,6,6,GGATCGTGTCAATAGAATGT,0,2258199
marRp,0.14285714285714285,6,6,GGAGGACGAATGTATCTCCG,0,2227479
marRp,0.14285714285714285,6,6,GGAGCCCACAGTCATAATCG,0,2252827
marRp,0.14285714285714285,6,6,GGACTTCAGAGCGCATTCAG,0,2256879
marRp,0.14285714285714285,6,6,GGAATGGGCTGATATCATTA,0,2221965
marRp,0.14285714285714285,6,6,GGAACCGGGACGTGTTGAGT,0,2246489
marRp,0.14285714285714285,6,6,GCTGTCGTGGAATCAACCGC,0,2219829
marRp,0.14285714285714285,6,6,GCTGACCGACACGTGCGTAC,0,2254925
marRp,0.14285714285714285,6,6,GCTCTCCAGACGGTATGAAC,0,2231892
marRp,0.14285714285714285,6,6,GCTCAACGGAGCCGAAAAGC,0,2248799
marRp,0.14285714285714285,6,6,GCTATGCATGGCCACAGGAC,0,2260177
marRp,0.14285714285714285,6,6,GCTATATAACCGTAGGTGCC,0,2245397
marRp,0.14285714285714285,6,6,GCTAGCGTCGTGATCGTCCG,0,2243240
marRp,0.14285714285714285,6,6,GCTAATCGGTACGACGTCAT,0,2246690
marRp,0.14285714285714285,6,6,GCGGCTGGGCAGATTGATAG,0,2255705
marRp,0.14285714285714285,6,6,GCGGAGTTCCGCCCAGACGT,0,2242009
marRp,0.14285714285714285,6,6,GCGGAGGCAAGTGTCTCGCA,0,2220692
marRp,0.14285714285714285,6,6,GCGCTTAGGAGGGCAGGCGA,0,2217982
marRp,0.14285714285714285,6,6,GCGCGCGGCGATGTGATTCT,0,2246617
marRp,0.14285714285714285,6,6,GCCTGTGTACGTCAAAAGAC,0,2256637
marRp,0.14285714285714285,6,6,GCCGCCCCATGAAAAATGAG,0,2237311
marRp,0.14285714285714285,6,6,GCCGATAAAACTCAGGTGAG,0,2244958
marRp,0.14285714285714285,6,6,GCCCCTTCGACGCTCCCAGC,0,2221451
marRp,0.14285714285714285,6,6,GCCCAAAATCCATTCCCACC,0,2232544
marRp,0.14285714285714285,6,6,GCCATCATGGAGATTTTAGG,0,2227586
marRp,0.14285714285714285,6,6,GCCAGGGGACATTCTCCTTA,0,2239232
marRp,0.14285714285714285,6,6,GCATTAAAGAGGCGACCGGT,0,2222724
marRp,0.14285714285714285,6,6,GCATCCCGGGAGACGCTCTT,0,2230169
marRp,0.14285714285714285,6,6,GCAGTTTGTATGAAGCTAGG,0,2222018
marRp,0.14285714285714285,6,6,GCAATAGTTCGGCACCCAGC,0,2226979
marRp,0.14285714285714285,6,6,GCAAGATGCTCGGCATCTGG,0,2252294
marRp,0.14285714285714285,6,6,GATTACGGACGTATCAGGTG,0,2233907
marRp,0.14285714285714285,6,6,GATGTACAATGTAAGATGAG,0,2237714
marRp,0.14285714285714285,6,6,GAGTGTTGGGCGTATGGGGT,0,2259188
marRp,0.14285714285714285,6,6,GAGTCATGACGAGTAGCAGG,0,2225609
marRp,0.14285714285714285,6,6,GAGTAGAAACCCGATCAGGA,0,2225662
marRp,0.14285714285714285,6,6,GAGGTCTCCCGTGATAATCT,0,2254594
marRp,0.14285714285714285,6,6,GAGGCACAGTAACGCGATCT,0,2237270
marRp,0.14285714285714285,6,6,GAGAGTTCGGGTCATGCGGC,0,2244902
marRp,0.14285714285714285,6,6,GACTGGGAAATGAACCAAAA,0,2228554
marRp,0.14285714285714285,6,6,GACGCACCGGCATATTTATA,0,2250509
marRp,0.14285714285714285,6,6,GAAGATTGAGCTTTAGGGGT,0,2233808
marRp,0.14285714285714285,6,6,GAAAGGCCCGTTCCCGGGTT,0,2235717
marRp,0.14285714285714285,6,6,CTTTGTCCGACTCCTGCCAA,0,2254180
marRp,0.14285714285714285,6,6,CTTGTAAAAATTACCTAAAC,0,2235622
marRp,0.14285714285714285,6,6,CTTGGGTTCCAGGTAAGTCT,0,2245623
marRp,0.14285714285714285,6,6,CTTCCAGCAGACCCACGGTA,0,2247727
marRp,0.14285714285714285,6,6,CTTCAGACTGGAACCCTCAG,0,2245113
marRp,0.14285714285714285,6,6,CTTCACGCATCTTGGCAAAG,0,2259689
marRp,0.14285714285714285,6,6,CTTAAAATATTATCAATATC,0,2226326
marRp,0.14285714285714285,6,6,CTGTTTACTCGTGGAATCGG,0,2246105
marRp,0.14285714285714285,6,6,CTGTTCTTTCATTCGTCCTT,0,2238430
marRp,0.14285714285714285,6,6,CTGTTCATAATGGGTGGCTT,0,2228101
marRp,0.14285714285714285,6,6,CTGGCCACGCCGTAATCACC,0,2251681
marRp,0.14285714285714285,6,6,CTGGACTTTCGTCATCGCCA,0,2260987
marRp,0.14285714285714285,6,6,CTGGACCCAATGGCCGGTTG,0,2243617
marRp,0.14285714285714285,6,6,CTGCAGAGAAACTGGCAATG,0,2248441
marRp,0.14285714285714285,6,6,CTGATCTGAGTCTACATATA,0,2254607
marRp,0.14285714285714285,6,6,CTCTCACCGCAAAGTTTGAC,0,2249541
marRp,0.14285714285714285,6,6,CTCCCACCGTAGACCGCTCA,0,2255066
marRp,0.14285714285714285,6,6,CTCACGTATGCCGCTGTAAA,0,2225919
marRp,0.14285714285714285,6,6,CTATCCTCTGATGGTCTTTA,0,2222293
marRp,0.14285714285714285,6,6,CTATCAGCGGTTCTTATTCC,0,2232372
marRp,0.14285714285714285,6,6,CTATACGGAGCTAGCTATGG,0,2222914
marRp,0.14285714285714285,6,6,CTAGTTCAATGTGAATTTCG,0,2233333
marRp,0.14285714285714285,6,6,CTACTCGTGTTCGTAACATC,0,2230507
marRp,0.14285714285714285,6,6,CTACGTGATATGGATGTATA,0,2225080
marRp,0.14285714285714285,6,6,CTAATTGGGCTTGCAATATT,0,2224139
marRp,0.14285714285714285,6,6,CTAACACCGCTCCTCAGGGG,0,2231730
marRp,0.14285714285714285,6,6,CTAACAAGCCTTCTAGCTAC,0,2241206
marRp,0.14285714285714285,6,6,CTAAAGTTACGCGGCACTAA,0,2239924
marRp,0.14285714285714285,6,6,CGTTTTCATAACACGTCTCC,0,2227342
marRp,0.14285714285714285,6,6,CGTTGAGGTAGGCGCGTGTG,0,2258170
marRp,0.14285714285714285,6,6,CGTCGGGGGGAAGCCTTAAG,0,2258964
marRp,0.14285714285714285,6,6,CGTCGAACTAGAGGTCGGAG,0,2241036
marRp,0.14285714285714285,6,6,CGGTGTGGAATACATGAACT,0,2229849
marRp,0.14285714285714285,6,6,CGGGTATTTATAGTAAGAAA,0,2218049
marRp,0.14285714285714285,6,6,CGGCCGGTTCATCAATGCTA,0,2234653
marRp,0.14285714285714285,6,6,CGCTAGAGAAAAGCATATGA,0,2244335
marRp,0.14285714285714285,6,6,CGCGATATCGAGGTGATTCT,0,2249584
marRp,0.14285714285714285,6,6,CGATGCAAACCAACAGTGGC,0,2255535
marRp,0.14285714285714285,6,6,CGATCGGACACGCAGGTCAA,0,2257836
marRp,0.14285714285714285,6,6,CGAGCAACCCCGCAGCGGGT,0,2218362
marRp,0.14285714285714285,6,6,CGACCTAAGCAAAACAGAAC,0,2234416
marRp,0.14285714285714285,6,6,CGACCGAATTTGGTCTAGTT,0,2220601
marRp,0.14285714285714285,6,6,CCTTATGGTCCCACCCTATG,0,2219797
marRp,0.14285714285714285,6,6,CCTTAGCACCACAATCAGGA,0,2220370
marRp,0.14285714285714285,6,6,CCTGCCCTAGAGAAAATGGA,0,2223611
marRp,0.14285714285714285,6,6,CCGGACAGACTTCTCAGCTG,0,2260086
marRp,0.14285714285714285,6,6,CCGAGTAGTAAATTCAATCT,0,2244372
marRp,0.14285714285714285,6,6,CCGAGCCGTACAGTCTGTTC,0,2247183
marRp,0.14285714285714285,6,6,CCGAACACCCCCCCTTAGTA,0,2258905
marRp,0.14285714285714285,6,6,CCCGTAGACTCCTTAATACT,0,2227179
marRp,0.14285714285714285,6,6,CCCGACCGTAAGCGAGTTAT,0,2244173
marRp,0.14285714285714285,6,6,CCCGAAGTCTTCATCGCCGT,0,2252321
marRp,0.14285714285714285,6,6,CCCCTATAATTCCTTATGTC,0,2230710
marRp,0.14285714285714285,6,6,CCCCCGGCCCAATCTCACTA,0,2239976
marRp,0.14285714285714285,6,6,CCAGGGAGATGTTCAGATGT,0,2242116
marRp,0.14285714285714285,6,6,CCACACCTTCGCGGAGCTCA,0,2227703
marRp,0.14285714285714285,6,6,CATACCGTTAACCATCGTAG,0,2256572
marRp,0.14285714285714285,6,6,CATAAACTATAGGATCCGGA,0,2257050
marRp,0.14285714285714285,6,6,CAGCCTCAACCGCGGGTCCA,0,2218461
marRp,0.14285714285714285,6,6,CACTTAGAGATTCCCCTATC,0,2219511
marRp,0.14285714285714285,6,6,CACTGTTCGGGAAACGCTAT,0,2250522
marRp,0.14285714285714285,6,6,CACTACGGTAGTAAGCGAAG,0,2239063
marRp,0.14285714285714285,6,6,CACGCGTGCAAGGTTGTCCT,0,2245842
marRp,0.14285714285714285,6,6,CACCCTATGTACGGAAAACT,0,2254215
marRp,0.14285714285714285,6,6,CACATTGCGGCTTAGACCAG,0,2227894
marRp,0.14285714285714285,6,6,CACAGCACTGCAAGTCAGCC,0,2227546
marRp,0.14285714285714285,6,6,CAAGCACCCGTGTAAACAGG,0,2225892
marRp,0.14285714285714285,6,6,ATTTGATCAGTCGGGAGTCT,0,2238377
marRp,0.14285714285714285,6,6,ATTTCGCTACCGTACTATCC,0,2222662
marRp,0.14285714285714285,6,6,ATTTAGACCGCTATCGATAT,0,2245524
marRp,0.14285714285714285,6,6,ATTGGTGTTGTAACCGGCCG,0,2234616
marRp,0.14285714285714285,6,6,ATTGGTGAAGGTTCCTCGGA,0,2254730
marRp,0.14285714285714285,6,6,ATGTTGGGGACTGTGTAGAT,0,2252579
marRp,0.14285714285714285,6,6,ATGTGGGGAGCGTCCCGAGT,0,2248434
marRp,0.14285714285714285,6,6,ATGGGTCCGCGCTATAGATT,0,2248681
marRp,0.14285714285714285,6,6,ATGCCCCGCAACGTCCGACA,0,2238201
marRp,0.14285714285714285,6,6,ATGCAAATGAACTATATCGT,0,2252678
marRp,0.14285714285714285,6,6,ATGAACGGGACTGCCTGGTA,0,2226904
marRp,0.14285714285714285,6,6,ATCTGCTCCCTCGGTGTTCA,0,2241649
marRp,0.14285714285714285,6,6,ATCGATTCCTCGTTTTCCAG,0,2252098
marRp,0.14285714285714285,6,6,ATAGTGAAGGCTGGCACCAC,0,2252168
marRp,0.14285714285714285,6,6,ATAGGAGGGGCTCAATGAGC,0,2235624
marRp,0.14285714285714285,6,6,ATAGCTGCTATGAGTAAACT,0,2247001
marRp,0.14285714285714285,6,6,ATAAATAACATGGGAAATTG,0,2220491
marRp,0.14285714285714285,6,6,AGTCTAAGGGTCAGGCCGTA,0,2246515
marRp,0.14285714285714285,6,6,AGTCGCTAAGCGCGGAACCT,0,2245818
marRp,0.14285714285714285,6,6,AGTCCCCAGGTCACAGGGTC,0,2248285
marRp,0.14285714285714285,6,6,AGTACGGCGCGCGCAGAATA,0,2253109
marRp,0.14285714285714285,6,6,AGTAAGCAGCACGTAATACA,0,2248913
marRp,0.14285714285714285,6,6,AGGTGTGTGCCAGCGTCAAA,0,2258573
marRp,0.14285714285714285,6,6,AGGTCTTCCTAGATTTCCCA,0,2242114
marRp,0.14285714285714285,6,6,AGGGTTCCGACTACCTCTTT,0,2233063
marRp,0.14285714285714285,6,6,AGGCCAGTTAACTGCCAGCC,0,2253252
marRp,0.14285714285714285,6,6,AGGATGGTCGAATCCCGACG,0,2260734
marRp,0.14285714285714285,6,6,AGCTCGGTGACATTCCTGTT,0,2247209
marRp,0.14285714285714285,6,6,AGCGGACAGAAAACGTTTTG,0,2235379
marRp,0.14285714285714285,6,6,AGCCCGTATTTTCCCGGAAA,0,2258516
marRp,0.14285714285714285,6,6,AGCAACCCTGTGTGGCTGGT,0,2237048
marRp,0.14285714285714285,6,6,AGATAAAGCGACGGTGTAAC,0,2219650
marRp,0.14285714285714285,6,6,AGAACACTAGCAAAGGGGAA,0,2241988
marRp,0.14285714285714285,6,6,AGAAACAACATATCTGACCG,0,2230511
marRp,0.14285714285714285,6,6,ACTTTCGGTAGTGCCCGGGA,0,2243145
marRp,0.14285714285714285,6,6,ACTACAGTTCAGACTCTTTA,0,2251865
marRp,0.14285714285714285,6,6,ACGGACTCTCAACCCTCGAA,0,2237320
marRp,0.14285714285714285,6,6,ACGCTGGTATCGATAACTGG,0,2231575
marRp,0.14285714285714285,6,6,ACGACTGATGCAGCGTTGGT,0,2255166
marRp,0.14285714285714285,6,6,ACCTTACGATGAATTCCTTG,0,2223553
marRp,0.14285714285714285,6,6,ACCTGTTGATTAGACACTGC,0,2248513
marRp,0.14285714285714285,6,6,ACCATAAGAGCCTTTCGGCT,0,2255877
marRp,0.14285714285714285,6,6,ACCACCCAGGAGAGAGCTTG,0,2221218
marRp,0.14285714285714285,6,6,ACATTGTCGAGATCGCTGCC,0,2249599
marRp,0.14285714285714285,6,6,ACATAGCGGCCAGGTTTCGA,0,2231411
marRp,0.14285714285714285,6,6,ACAAAGGCAGCCACGTCTGA,0,2228916
marRp,0.14285714285714285,6,6,ACAAAAAAGTTGACGTCTTG,0,2222606
marRp,0.14285714285714285,6,6,AATTGGTGATTGGAGGTATA,0,2257247
marRp,0.14285714285714285,6,6,AATATGTCGGTGACAACGTG,0,2232978
marRp,0.14285714285714285,6,6,AAGTTGGGCCATATGTCGCC,0,2251037
marRp,0.14285714285714285,6,6,AAGGAGAAACGTATCTGGTA,0,2250005
marRp,0.14285714285714285,6,6,AAGAATTCGTTAGGGGTCTG,0,2248711
marRp,0.14285714285714285,6,6,AACCCGTTGTTAAACCTTCA,0,2231307
marRp,0.14285714285714285,6,6,AACACTGTATATGGCGGTAA,0,2238412
marRp,0.14285714285714285,6,6,AAAGGTGTTAATAGGGTAGT,0,2235639
marRp,0.14285714285714285,6,6,AAAGGTAAGCCGTACCGTCG,0,2225481
marRp,0.14285714285714285,6,6,AAAGATACAGAGGCACCGGA,0,2227368
marRp,0.14285714285714285,6,6,AAACGTGTAAAGATCATTGC,0,2234388
marRp,0.14285714285714285,6,6,AAACGGTTGCTGGCTATCAT,0,2260180
marRp,0.14285714285714285,6,6,AAAATATCGTGCGTTAGGCC,0,2239365
marRp,0.14285714285714285,6,6,AAAAGAGTAAATTTGGTAGG,0,2251857
marRp,0.16666666666666666,5,5,TTTTGAAGCGTAGCAATGGT,0,2237606
marRp,0.16666666666666666,5,5,TTTGATAAATGTTATGAATC,0,2228582
marRp,0.16666666666666666,5,5,TTTCAAGACCTAAAGCAACT,0,2249840
marRp,0.16666666666666666,5,5,TTGGAGATTAACCCTCTCCT,0,2245298
marRp,0.16666666666666666,5,5,TTGCGCTGCGCTTTCCAGAT,0,2230580
marRp,0.16666666666666666,5,5,TTGCCTGCTCTGCAAGGGAC,0,2241221
marRp,0.16666666666666666,5,5,TTGCCATATAGAATGGGAAA,0,2245883
marRp,0.16666666666666666,5,5,TTCTTTCCAGTTGAGCTACA,0,2252607
marRp,0.16666666666666666,5,5,TTCTTAACGAAGGGAATCAT,0,2247538
marRp,0.16666666666666666,5,5,TTCGGGGTCGCAGTGCGCGT,0,2254173
marRp,0.16666666666666666,5,5,TTCGAATGAGCGGTATGGGG,0,2225029
marRp,0.16666666666666666,5,5,TTCGAAGAACGTCTTACGGT,0,2246488
marRp,0.16666666666666666,5,5,TTCCAGCCTAAGCGACCCCA,0,2241218
marRp,0.16666666666666666,5,5,TTAGTGATGTCCCCGGCCAA,0,2241319
marRp,0.16666666666666666,5,5,TTACGACTGTTAATCCGCCA,0,2233862
marRp,0.16666666666666666,5,5,TTACCAGTGAGCATTATCTA,0,2225442
marRp,0.16666666666666666,5,5,TTACAGTTAAGGGACTATGA,0,2244098
marRp,0.16666666666666666,5,5,TTAAACAGAGTCGCCTTTGG,0,2246600
marRp,0.16666666666666666,5,5,TGTGCGCTCCCTGGCAGATC,0,2248498
marRp,0.16666666666666666,5,5,TGTGACAGTACGGTGTCTAT,0,2237601
marRp,0.16666666666666666,5,5,TGTATTCGGCTCATGTTCGT,0,2237431
marRp,0.16666666666666666,5,5,TGTAGATACCCTGCTAAATG,0,2254748
marRp,0.16666666666666666,5,5,TGTACCATAGGCTTTCATGT,0,2236887
marRp,0.16666666666666666,5,5,TGGGTATTGGTTGAGGCGAC,0,2234795
marRp,0.16666666666666666,5,5,TGGCGATATACCGTAGCGGC,0,2223037
marRp,0.16666666666666666,5,5,TGGCATTCATCAAACAGGTA,0,2237087
marRp,0.16666666666666666,5,5,TGGATTTGGGCTGGATAAAA,0,2236434
marRp,0.16666666666666666,5,5,TGGATGGTAAACTGCGTCCA,0,2256747
marRp,0.16666666666666666,5,5,TGGACTATTGGAACTTTTCA,0,2220339
marRp,0.16666666666666666,5,5,TGCTTACCGATCTTCTGACC,0,2246381
marRp,0.16666666666666666,5,5,TGCCGTGGAAGCTGGGAACT,0,2221447
marRp,0.16666666666666666,5,5,TGCCGCGCTGATCGCTTCTG,0,2226233
marRp,0.16666666666666666,5,5,TGATTGGAGTTAAATTTCAG,0,2233021
marRp,0.16666666666666666,5,5,TGATCATTTCACTTAGCCCA,0,2245797
marRp,0.16666666666666666,5,5,TGAGATGGGAGCGTCCGGCG,0,2231030
marRp,0.16666666666666666,5,5,TGACTTAAAAACTCTATCGG,0,2245833
marRp,0.16666666666666666,5,5,TGAAGTGATGGAACCATCTA,0,2253138
marRp,0.16666666666666666,5,5,TCTTCCCAAAAAAGTGGGGC,0,2218276
marRp,0.16666666666666666,5,5,TCTTACTTATCCCTAAGAGA,0,2230668
marRp,0.16666666666666666,5,5,TCGTTTTTCAGTTCGCAGGT,0,2239057
marRp,0.16666666666666666,5,5,TCGGTCCTCTAGTAGTTGTG,0,2252631
marRp,0.16666666666666666,5,5,TCGGGAACGTCACAATTCCG,0,2255895
marRp,0.16666666666666666,5,5,TCGCAATTCTATGCGACTAT,0,2226723
marRp,0.16666666666666666,5,5,TCGCAAAGAAGCGGCGCATA,0,2238823
marRp,0.16666666666666666,5,5,TCCTTGACGGCGCGGCTCGT,0,2218367
marRp,0.16666666666666666,5,5,TCCGGATTAGTGCCTATTAG,0,2255167
marRp,0.16666666666666666,5,5,TCCGGATCGGTTTCTATTTT,0,2254807
marRp,0.16666666666666666,5,5,TCCCGGCGTATACTAGGCGT,0,2218901
marRp,0.16666666666666666,5,5,TCATGTCACTTAGATACGAT,0,2249015
marRp,0.16666666666666666,5,5,TCACCCTACTTGTCATAATG,0,2233421
marRp,0.16666666666666666,5,5,TCAATGCGTCTCCGACTCTG,0,2231982
marRp,0.16666666666666666,5,5,TCAATAGGACGTTTCCGATT,0,2236583
marRp,0.16666666666666666,5,5,TCAAGTAACACTGCGGATAC,0,2219975
marRp,0.16666666666666666,5,5,TCAACCCCCGCTGCTTTGTT,0,2224645
marRp,0.16666666666666666,5,5,TCAAATTGTAGCGCTCTGTC,0,2220413
marRp,0.16666666666666666,5,5,TATTCATTAAGGTGATGTCA,0,2246726
marRp,0.16666666666666666,5,5,TATGGAGAAGCTGGATAGTT,0,2254818
marRp,0.16666666666666666,5,5,TATGAAGGTGTTTTATCGCT,0,2254057
marRp,0.16666666666666666,5,5,TATCTCTATCCCCAATAGCT,0,2239764
marRp,0.16666666666666666,5,5,TATAGATAATCCTGCGGCCA,0,2242172
marRp,0.16666666666666666,5,5,TAGGGTTCTATGATTCATGC,0,2224477
marRp,0.16666666666666666,5,5,TAGGGGCGGATATAGGGAGA,0,2227935
marRp,0.16666666666666666,5,5,TACTTGCGGAGGTGGTTAGT,0,2238703
marRp,0.16666666666666666,5,5,TACGTCCTGGCGCACTGAAT,0,2261042
marRp,0.16666666666666666,5,5,TACGGCAACCATTCTACACT,0,2252391
marRp,0.16666666666666666,5,5,TACGGATCCGCATTCCTCAT,0,2258817
marRp,0.16666666666666666,5,5,TACGACGGGCACCTGTTTCA,0,2233547
marRp,0.16666666666666666,5,5,TACGAAATTACGATTATGCG,0,2227789
marRp,0.16666666666666666,5,5,TACCTCTGGGCGCCGCGCTT,0,2238769
marRp,0.16666666666666666,5,5,TACCGGAGTGCCTTTCTTCA,0,2233030
marRp,0.16666666666666666,5,5,TACAGGGGCTACAACTTGGA,0,2239967
marRp,0.16666666666666666,5,5,TAAGTTTCGTTTGTATCGGA,0,2251749
marRp,0.16666666666666666,5,5,TAAGGGTATTGGGGCGTAGC,0,2226210
marRp,0.16666666666666666,5,5,TAACTGGTACGGATGCTGAA,0,2239288
marRp,0.16666666666666666,5,5,TAACATCTGGCAAAAGAACT,0,2247348
marRp,0.16666666666666666,5,5,GTTGGACGAAATCTAGGACT,0,2219624
marRp,0.16666666666666666,5,5,GTTCTGTCAGAGGGGTCTTG,0,2225106
marRp,0.16666666666666666,5,5,GTTAGGCCCAGTCATAGCAA,0,2226364
marRp,0.16666666666666666,5,5,GTGTGCATCATGGGGCTAGT,0,2236346
marRp,0.16666666666666666,5,5,GTGTGACTTCCTACGCTTCC,0,2219819
marRp,0.16666666666666666,5,5,GTGCACAACGCCTCTGGGGA,0,2253224
marRp,0.16666666666666666,5,5,GTCTTTTCGCTATTACACTC,0,2247099
marRp,0.16666666666666666,5,5,GTCTTGCTACGAATATGTAG,0,2252489
marRp,0.16666666666666666,5,5,GTCTCTTCTAGCGTCGCTTC,0,2253354
marRp,0.16666666666666666,5,5,GTCTCTATATAAGGTTGAAG,0,2248078
marRp,0.16666666666666666,5,5,GTCTACTGTAGTTATTTGAT,0,2232695
marRp,0.16666666666666666,5,5,GTCGTTGACATTGGCAACCG,0,2259495
marRp,0.16666666666666666,5,5,GTCGTCGTATACTTCAAACC,0,2252160
marRp,0.16666666666666666,5,5,GTCGTCAGGCTTATGGTGCG,0,2248402
marRp,0.16666666666666666,5,5,GTCGGAGACTGAACCTTGCG,0,2218614
marRp,0.16666666666666666,5,5,GTCGCATCCGGTTCATGACG,0,2247337
marRp,0.16666666666666666,5,5,GTATTTATTGTCTTCCAATT,0,2228325
marRp,0.16666666666666666,5,5,GTACTGAACGTCAAGGCATG,0,2250083
marRp,0.16666666666666666,5,5,GTAAGAGATTGGTGTCTGGC,0,2225148
marRp,0.16666666666666666,5,5,GTAACAATGGAGGAGGGACA,0,2242902
marRp,0.16666666666666666,5,5,GTAAAGGCATGTTTATGCCT,0,2244879
marRp,0.16666666666666666,5,5,GTAAAGACGTAGTGTTCAGC,0,2231971
marRp,0.16666666666666666,5,5,GGTTCTAATGCCCTTGCGAG,0,2256100
marRp,0.16666666666666666,5,5,GGTGTAGGGGGGATAGAAGA,0,2244134
marRp,0.16666666666666666,5,5,GGTCTGAAAAGTTGCGGAGG,0,2225951
marRp,0.16666666666666666,5,5,GGGGAGTTGAGAATTACTCG,0,2248891
marRp,0.16666666666666666,5,5,GGGGACTGGCTAATCGATGT,0,2247257
marRp,0.16666666666666666,5,5,GGGCCGCATACTAAAGTTAT,0,2256157
marRp,0.16666666666666666,5,5,GGGAGGGAGGATTATACCGC,0,2259171
marRp,0.16666666666666666,5,5,GGGAGGACATATCTACTCCA,0,2221707
marRp,0.16666666666666666,5,5,GGCTTTCGATGTGTTCTCTT,0,2255423
marRp,0.16666666666666666,5,5,GGCTTTATTATCCGTCAATG,0,2259564
marRp,0.16666666666666666,5,5,GGCGAATCGTGATCTCATTA,0,2229784
marRp,0.16666666666666666,5,5,GGCCGAGGTTCCTTGTTGAC,0,2237812
marRp,0.16666666666666666,5,5,GGCAGGACCTAGATCCAAGT,0,2234648
marRp,0.16666666666666666,5,5,GGCACGCGCAGGGGAACACG,0,2232570
marRp,0.16666666666666666,5,5,GGATTCGAAAAATTGCGCGC,0,2219991
marRp,0.16666666666666666,5,5,GGAGCGGATACTTGCAGGGT,0,2260029
marRp,0.16666666666666666,5,5,GGAGAGTGCACGGCTCGTCA,0,2225165
marRp,0.16666666666666666,5,5,GGACCGGGGGGGCGTCGCTA,0,2225066
marRp,0.16666666666666666,5,5,GGACAGTATCACCCCGGTTG,0,2260239
marRp,0.16666666666666666,5,5,GGAATTGACCCTGAAGACGG,0,2252811
marRp,0.16666666666666666,5,5,GGAAAATGCGACAGGTCATG,0,2225577
marRp,0.16666666666666666,5,5,GCTTTTCCGCCGTATTGCAT,0,2229929
marRp,0.16666666666666666,5,5,GCTTCCGGCTGGTTCCTAAG,0,2230569
marRp,0.16666666666666666,5,5,GCTCGCAGTCAGAAGTTTTA,0,2237332
marRp,0.16666666666666666,5,5,GCTCATACCCTACATAATGA,0,2234728
marRp,0.16666666666666666,5,5,GCTATATCAGATAATATATT,0,2253939
marRp,0.16666666666666666,5,5,GCGTCCAGAACCGTGGTCAT,0,2230870
marRp,0.16666666666666666,5,5,GCGGATACTGAGTAATCGCT,0,2246739
marRp,0.16666666666666666,5,5,GCGCACGCCATATTAGGGTG,0,2239521
marRp,0.16666666666666666,5,5,GCGACATTTGCTAATCGGGA,0,2256825
marRp,0.16666666666666666,5,5,GCCTTAAGACTGAAGAAGTT,0,2240169
marRp,0.16666666666666666,5,5,GCCCATTTCCGTATCGTGGC,0,2217824
marRp,0.16666666666666666,5,5,GCCAGTCAGTCTTGAAACCA,0,2254036
marRp,0.16666666666666666,5,5,GCCAAAGAAAGACTTCCTAA,0,2235746
marRp,0.16666666666666666,5,5,GCATGCTCATGGTGTTGCAA,0,2238892
marRp,0.16666666666666666,5,5,GCAGCTCACGGCAACTGGCT,0,2242958
marRp,0.16666666666666666,5,5,GCAAGGCGTAAACCTACACG,0,2222376
marRp,0.16666666666666666,5,5,GCAAGCAAAGAGCCTGCTAA,0,2243446
marRp,0.16666666666666666,5,5,GCAAAGAAGTGTCCATCTCT,0,2255492
marRp,0.16666666666666666,5,5,GATTTGGGGGTATTAGTTTC,0,2241584
marRp,0.16666666666666666,5,5,GATTATCGACTATCTAAAGT,0,2246053
marRp,0.16666666666666666,5,5,GATTAACAGACATAAGGTCT,0,2243689
marRp,0.16666666666666666,5,5,GATAATCTGCCTTAGCATGA,0,2218152
marRp,0.16666666666666666,5,5,GAGGAGGAGTGAAGGATCGA,0,2229234
marRp,0.16666666666666666,5,5,GAGCATGATTTTTCTAATGA,0,2251544
marRp,0.16666666666666666,5,5,GACGTAGTGTTGTCGATGCG,0,2219403
marRp,0.16666666666666666,5,5,GACGACTTGCGAGTTCCTCA,0,2252169
marRp,0.16666666666666666,5,5,GACCGCTGCTACCCAGTCGG,0,2252351
marRp,0.16666666666666666,5,5,GACCGCGGGGCGTTTACCCC,0,2250086
marRp,0.16666666666666666,5,5,GACCACCAACCTATAATCGT,0,2221610
marRp,0.16666666666666666,5,5,GACAGGTAAAGCGCGTAGTT,0,2229279
marRp,0.16666666666666666,5,5,GAATTCCGCGTTGTGGAACC,0,2236684
marRp,0.16666666666666666,5,5,GAATCACGGCTTCCACTTCT,0,2233264
marRp,0.16666666666666666,5,5,GAAGTGCTTGGACAGATTAT,0,2248535
marRp,0.16666666666666666,5,5,GAAGGCACTTTCACTTATAG,0,2232433
marRp,0.16666666666666666,5,5,CTTGGGGTCCTATGTGCTCG,0,2226203
marRp,0.16666666666666666,5,5,CTTCATTAGGGTCTAGAGCA,0,2239929
marRp,0.16666666666666666,5,5,CTTATGCCACACCAATGGGG,0,2245470
marRp,0.16666666666666666,5,5,CTGTTCGTATTGGAATTCGT,0,2244772
marRp,0.16666666666666666,5,5,CTGTCCTTGGGTATTGGCAT,0,2238870
marRp,0.16666666666666666,5,5,CTGGGATCGCGCCCAAGCAT,0,2241756
marRp,0.16666666666666666,5,5,CTGGAGTCGTAAGGTTTCAA,0,2225969
marRp,0.16666666666666666,5,5,CTGCATCGAAAGGATGAAAG,0,2241592
marRp,0.16666666666666666,5,5,CTGACTTTTAATGTATGTTG,0,2240905
marRp,0.16666666666666666,5,5,CTCTTACGAGGGCCGAGGTG,0,2252673
marRp,0.16666666666666666,5,5,CTCCCTCCTATGTCTGAGCG,0,2219648
marRp,0.16666666666666666,5,5,CTCCACGAATCCACAGCGCC,0,2232219
marRp,0.16666666666666666,5,5,CTCATAGTCAGTCCCCAGAC,0,2220126
marRp,0.16666666666666666,5,5,CTATGAGAGGCCACACCAGC,0,2256239
marRp,0.16666666666666666,5,5,CTAGCGGGCAGTGCAGGGGA,0,2234712
marRp,0.16666666666666666,5,5,CTACTGTTCAGTATAGTTGA,0,2232092
marRp,0.16666666666666666,5,5,CTACCATATGGAATGCGCAG,0,2258993
marRp,0.16666666666666666,5,5,CGTGTCGCAGCGCGCTCCTC,0,2219461
marRp,0.16666666666666666,5,5,CGTGTCCCTGTGATCGGAGA,0,2249947
marRp,0.16666666666666666,5,5,CGTGTCATTGCGCGCGTGTA,0,2221325
marRp,0.16666666666666666,5,5,CGTGTACTTGTGTGCGTCGT,0,2257033
marRp,0.16666666666666666,5,5,CGTGCATTTTTCCCCTGCAG,0,2239791
marRp,0.16666666666666666,5,5,CGTCTAGATCTCGCACAGGC,0,2243960
marRp,0.16666666666666666,5,5,CGTATGAAGCGCCGCCGCGT,0,2260925
marRp,0.16666666666666666,5,5,CGTAGGCGTGGCTGAACACC,0,2237314
marRp,0.16666666666666666,5,5,CGTACAATTCCGAGATTGGA,0,2232932
marRp,0.16666666666666666,5,5,CGGTTCCAGGAACGTGTTCT,0,2254268
marRp,0.16666666666666666,5,5,CGGGTCCTTCCATACTAACA,0,2251597
marRp,0.16666666666666666,5,5,CGGGCGATGGTTGGTAGCCG,0,2252109
marRp,0.16666666666666666,5,5,CGGGACTTCGTTGGACGGCT,0,2235378
marRp,0.16666666666666666,5,5,CGGCTCGAACATAGTTAGGC,0,2226076
marRp,0.16666666666666666,5,5,CGCATGGAGCGACAGGTAAT,0,2221054
marRp,0.16666666666666666,5,5,CGAGTACTCGTGCTATCTAC,0,2232103
marRp,0.16666666666666666,5,5,CGAGCGTACCCTCACTTCTG,0,2223845
marRp,0.16666666666666666,5,5,CGAAAACTCAGTTTCTTACA,0,2251134
marRp,0.16666666666666666,5,5,CCTTGGGCTTATTATCGCTC,0,2253637
marRp,0.16666666666666666,5,5,CCTTCCCTTGTAGCCAGCAG,0,2259211
marRp,0.16666666666666666,5,5,CCTTAAAGCCTAGGAGAACT,0,2242735
marRp,0.16666666666666666,5,5,CCTGCTCCGCCAGATCCAGT,0,2247186
marRp,0.16666666666666666,5,5,CCTAGTCAGAGCCTATGGAC,0,2238780
marRp,0.16666666666666666,5,5,CCGTTGAGTGGGCTATTAAT,0,2259207
marRp,0.16666666666666666,5,5,CCGTTCCTCAGCGCTCGGCT,0,2256136
marRp,0.16666666666666666,5,5,CCGTAGGACTCCGCCGATAG,0,2252161
marRp,0.16666666666666666,5,5,CCGGTGCTAGCGGGGCGTGC,0,2256471
marRp,0.16666666666666666,5,5,CCGCTCACGAACTTCAAGTG,0,2231407
marRp,0.16666666666666666,5,5,CCGCGCAAAAGGAGCGGCAG,0,2224510
marRp,0.16666666666666666,5,5,CCGAGTCTGCGTGCGTAAGG,0,2231555
marRp,0.16666666666666666,5,5,CCCTTGAGGGCGCCTGTCAA,0,2240872
marRp,0.16666666666666666,5,5,CCCTAGTGGAACTTCATATG,0,2257752
marRp,0.16666666666666666,5,5,CCCGTAGACGTGGAAACCGC,0,2247868
marRp,0.16666666666666666,5,5,CCATTAGAATAGCGCCCGTA,0,2231275
marRp,0.16666666666666666,5,5,CCATCCCGCCCGCCTAGAGA,0,2239086
marRp,0.16666666666666666,5,5,CCATAGAGGCTGCGATCCAG,0,2240116
marRp,0.16666666666666666,5,5,CCAGCTTAGGGTTGGCCTTA,0,2252010
marRp,0.16666666666666666,5,5,CCAGACCGATTCTGGACTCC,0,2217849
marRp,0.16666666666666666,5,5,CCACGGTAATTAGTAACCGA,0,2249975
marRp,0.16666666666666666,5,5,CCACGACCCTACAGATATCT,0,2250749
marRp,0.16666666666666666,5,5,CCACCTGGCTTCGGCCAGTA,0,2231997
marRp,0.16666666666666666,5,5,CCACAATACAGCGAGCTCCC,0,2250504
marRp,0.16666666666666666,5,5,CCAACATTCAGGCATGTCGT,0,2235488
marRp,0.16666666666666666,5,5,CATTGGAAACGCGAGAGCCG,0,2229739
marRp,0.16666666666666666,5,5,CATTATCCTTTAAGGTAAGT,0,2221035
marRp,0.16666666666666666,5,5,CATGACACCCCTATTTTTAG,0,2224278
marRp,0.16666666666666666,5,5,CATCCGGATAGCGTACAATA,0,2242784
marRp,0.16666666666666666,5,5,CATATACTGCTGTTTTGAAG,0,2228909
marRp,0.16666666666666666,5,5,CATAGTCCTCAAATTTGCGC,0,2226208
marRp,0.16666666666666666,5,5,CAGCTCTGCACCTTCAGGCA,0,2260246
marRp,0.16666666666666666,5,5,CAGATCAAACCTATGCTGTA,0,2234034
marRp,0.16666666666666666,5,5,CACTGACCCTTTCGTATTCA,0,2231596
marRp,0.16666666666666666,5,5,CACTCTGACGGTGCAACCCA,0,2240437
marRp,0.16666666666666666,5,5,CACGCCAACTTCCTCTCGTA,0,2247649
marRp,0.16666666666666666,5,5,CACCGTATTGTTTCGACCTG,0,2232848
marRp,0.16666666666666666,5,5,CACCCGTATCCATTACCTCC,0,2237931
marRp,0.16666666666666666,5,5,CACAGTTGGGCAGCCACGGA,0,2242722
marRp,0.16666666666666666,5,5,CAAACACGTGCACTACTCCT,0,2251987
marRp,0.16666666666666666,5,5,ATTTAGTCAGGTGTCAATTG,0,2224707
marRp,0.16666666666666666,5,5,ATTGTCATGCCTTCGGGCTA,0,2226733
marRp,0.16666666666666666,5,5,ATTGTAGCTTCTACAGGCCT,0,2258536
marRp,0.16666666666666666,5,5,ATTCAATGCCGGTGCTCACA,0,2245318
marRp,0.16666666666666666,5,5,ATTATAGACAGTTGGTTGGT,0,2247813
marRp,0.16666666666666666,5,5,ATTAATGATTTGCTAATTTC,0,2248626
marRp,0.16666666666666666,5,5,ATGTGTGAGAGGTATTCTAT,0,2218091
marRp,0.16666666666666666,5,5,ATGGTCTACGATTCAGTTTC,0,2254989
marRp,0.16666666666666666,5,5,ATGGTCCACATGAAGCAGCT,0,2255243
marRp,0.16666666666666666,5,5,ATGGAAGGCTCTATGACAGA,0,2231003
marRp,0.16666666666666666,5,5,ATCTTAGTGGGCCAGAGACA,0,2237009
marRp,0.16666666666666666,5,5,ATCTAGGCGGGCACTACAGT,0,2246376
marRp,0.16666666666666666,5,5,ATCATTTCTACATGTCTATA,0,2231024
marRp,0.16666666666666666,5,5,ATCACCTAGATATAGGTAGA,0,2235166
marRp,0.16666666666666666,5,5,ATCAAAGATGCCCCCGACAG,0,2251946
marRp,0.16666666666666666,5,5,ATATTCTCAGATTAACTGGG,0,2221643
marRp,0.16666666666666666,5,5,ATATGCTCTATTGTCTCACA,0,2224221
marRp,0.16666666666666666,5,5,ATACCCTATGTCGGAATGTG,0,2245851
marRp,0.16666666666666666,5,5,ATAAGTTTCTATACCTAGAT,0,2228613
marRp,0.16666666666666666,5,5,ATAAACTGTGCGATTAAGCA,0,2221861
marRp,0.16666666666666666,5,5,AGTGGAAAATCGTGGGTGTC,0,2222580
marRp,0.16666666666666666,5,5,AGTCAGGGCTTCCTAACCTC,0,2255985
marRp,0.16666666666666666,5,5,AGTCAAGAGCCGAGTCCGAT,0,2239366
marRp,0.16666666666666666,5,5,AGTATTTATTCAGATGTGTA,0,2237409
marRp,0.16666666666666666,5,5,AGGGATGTCTTAACGAGCCA,0,2224206
marRp,0.16666666666666666,5,5,AGGGACGCTTCAATAGCTAG,0,2258232
marRp,0.16666666666666666,5,5,AGGCGGTCTCGCGCGCAATT,0,2222616
marRp,0.16666666666666666,5,5,AGGCATTCCCGCATACGCGG,0,2229925
marRp,0.16666666666666666,5,5,AGGATTATTTGGCTTGCCCC,0,2246505
marRp,0.16666666666666666,5,5,AGGAAAGTCCACACGAGATT,0,2223363
marRp,0.16666666666666666,5,5,AGCTTTGAGGCCATTTGGAA,0,2230575
marRp,0.16666666666666666,5,5,AGCTCAGTGGACCGTCAGAC,0,2249430
marRp,0.16666666666666666,5,5,AGCTACTTAAGCTTACGACC,0,2240875
marRp,0.16666666666666666,5,5,AGACTTGAACGAGCCTCGGC,0,2226343
marRp,0.16666666666666666,5,5,AGACGCTCTTTTTCTTTGTG,0,2237449
marRp,0.16666666666666666,5,5,AGACGCACGGGGTTAAGCAT,0,2221110
marRp,0.16666666666666666,5,5,AGACGAATGCGAGAAGTATG,0,2244957
marRp,0.16666666666666666,5,5,AGACATTCTGAAAAGAAACC,0,2226188
marRp,0.16666666666666666,5,5,AGACAGCTAGGGGTCCGAAA,0,2221340
marRp,0.16666666666666666,5,5,AGACACACTACCGGGAAGCT,0,2228549
marRp,0.16666666666666666,5,5,AGAAGTTGTCTTGAACGCCG,0,2246073
marRp,0.16666666666666666,5,5,AGAACCGTGCGAAAGCAGTC,0,2221640
marRp,0.16666666666666666,5,5,ACTTACCACCCGATCCGTTC,0,2233818
marRp,0.16666666666666666,5,5,ACTGGTTCGTGACGCTGTAA,0,2256107
marRp,0.16666666666666666,5,5,ACTCTATGCAGTGCCCCGAC,0,2241023
marRp,0.16666666666666666,5,5,ACTCGGGGACCGGTCCGGTG,0,2222072
marRp,0.16666666666666666,5,5,ACTCATAGGGTTATGACGGT,0,2253011
marRp,0.16666666666666666,5,5,ACTATCGGTCATCCTTTATC,0,2243733
marRp,0.16666666666666666,5,5,ACTACGAGTGTGGGGCAGGG,0,2248813
marRp,0.16666666666666666,5,5,ACGCATCCTACTGGCTTTAT,0,2243101
marRp,0.16666666666666666,5,5,ACGAGTACACAAAGGTGCCA,0,2237305
marRp,0.16666666666666666,5,5,ACCGTCGGTAAATGTAAATG,0,2245820
marRp,0.16666666666666666,5,5,ACCGGATCAAGGCGAGGACC,0,2234032
marRp,0.16666666666666666,5,5,ACCGCCTGTCCGGCGGGATT,0,2238273
marRp,0.16666666666666666,5,5,ACCCTAAGCGACGCGAGGCA,0,2259920
marRp,0.16666666666666666,5,5,ACCCCAGGCTGCACTTTCTC,0,2242811
marRp,0.16666666666666666,5,5,ACAGGCGCTAATGGCGGGGC,0,2233273
marRp,0.16666666666666666,5,5,ACAGGATATACACGGGGACT,0,2243731
marRp,0.16666666666666666,5,5,ACACGGTAAAATATAACTGA,0,2247184
marRp,0.16666666666666666,5,5,ACAAGCTAAAGGGGGGTTTT,0,2230035
marRp,0.16666666666666666,5,5,AATTGCGCGAGTAGATGGGA,0,2234649
marRp,0.16666666666666666,5,5,AATGCATGAGCATGCTGGTT,0,2229557
marRp,0.16666666666666666,5,5,AATGAACATAAGACCCGCGT,0,2230066
marRp,0.16666666666666666,5,5,AATCAGTGAATACATTCTTT,0,2221710
marRp,0.16666666666666666,5,5,AATAGCTATGAACTGTCGCA,0,2246310
marRp,0.16666666666666666,5,5,AATAGATCCCCTTTGGAGAG,0,2252071
marRp,0.16666666666666666,5,5,AATACTACGGCAGGAGTTGT,0,2227691
marRp,0.16666666666666666,5,5,AAGTACGCTCGAAGAAGTAA,0,2258269
marRp,0.16666666666666666,5,5,AACTTTCTCTCTGTTATTCA,0,2250048
marRp,0.16666666666666666,5,5,AACGTGGGGACATAGCCCAT,0,2249732
marRp,0.16666666666666666,5,5,AACGGTGAATGCGCACTCCC,0,2239083
marRp,0.16666666666666666,5,5,AACCTGAATTGACGAACCCG,0,2256516
marRp,0.16666666666666666,5,5,AAATCGGTGTTACGCTTGAC,0,2247537
marRp,0.16666666666666666,5,5,AAAGGATTTAAGCTCGACGT,0,2232484
marRp,0.16666666666666666,5,5,AAACTTGATGGAGGCGTTCT,0,2237932
marRp,0.16666666666666666,5,5,AAAATTCACGGTTTAGGAGA,0,2218364
marRp,0.16666666666666666,5,5,AAAAGTAAGGGTCAGCCAGT,0,2252672
marRp,0.16666666666666666,5,5,AAAAGCTATCCGGGATTCCG,0,2217962
marRp,0.2,4,4,TTTAGATCGGATACATAACG,0,2243526
marRp,0.2,4,4,TTGTATATCTCTGGTGCTTT,0,2221928
marRp,0.2,4,4,TTGTAGGAGGTCATCACGAT,0,2249420
marRp,0.2,4,4,TTGGGTGTTTCTCTGGATGT,0,2241364
marRp,0.2,4,4,TTGGGCAGTGAAGGATCTCA,0,2248872
marRp,0.2,4,4,TTGGAACATTAAGGCATCAA,0,2224260
marRp,0.2,4,4,TTGCATCCTCGACTACTAGA,0,2221037
marRp,0.2,4,4,TTGCAAAGTAAGCCCTGGTG,0,2251837
marRp,0.2,4,4,TTCTACTGCTCTGTAGTCAC,0,2237681
marRp,0.2,4,4,TTCCGCTCCCTAAAATGGAA,0,2249326
marRp,0.2,4,4,TTCCACATCTCCAGCTGCGG,0,2239990
marRp,0.2,4,4,TTCAGGTTGCCCCCGCGGAG,0,2253838
marRp,0.2,4,4,TTCACGACATATTGCTGAAT,0,2256143
marRp,0.2,4,4,TTCAACGACGTCGTGGCGAC,0,2232441
marRp,0.2,4,4,TTATCCCGCGCGTCAGTCAG,0,2249815
marRp,0.2,4,4,TTATAGGACTAGCAGTCAAC,0,2219601
marRp,0.2,4,4,TTATACCGAACCTTGAATTT,0,2231668
marRp,0.2,4,4,TTATAACGCGCCCAGCGCAG,0,2241871
marRp,0.2,4,4,TTAGCGGCCCCAGCCACCTG,0,2236626
marRp,0.2,4,4,TTACTTCGTAGCCCGCCGTG,0,2243946
marRp,0.2,4,4,TTACGTCCAACAGTGGCGTA,0,2227051
marRp,0.2,4,4,TTACCCGGGTAGTTCCAAGA,0,2236553
marRp,0.2,4,4,TTACACGGGTTCACAGAGGA,0,2223107
marRp,0.2,4,4,TTAATGCGGCTTAAATGTGA,0,2234596
marRp,0.2,4,4,TTAACAGTCAAAATCCTTAA,0,2236928
marRp,0.2,4,4,TGTGATTGTAGTGTTCCAAC,0,2250019
marRp,0.2,4,4,TGTCGGCTTTTCTGCGTGAG,0,2224165
marRp,0.2,4,4,TGTATAGGGGTACATTACTA,0,2253791
marRp,0.2,4,4,TGGTTAAGGCTACAGAATGT,0,2246348
marRp,0.2,4,4,TGGTGGAGCTGAATGCAGAT,0,2239840
marRp,0.2,4,4,TGGGGCCGGTGTGCACGGGT,0,2256714
marRp,0.2,4,4,TGGCGTCTTTAGCCCATAGA,0,2259913
marRp,0.2,4,4,TGGCGCAAAATAAACTTTCA,0,2245408
marRp,0.2,4,4,TGGATGCCTGGTTCCAACGT,0,2249120
marRp,0.2,4,4,TGGACTGGGATAGAGTAAAC,0,2229335
marRp,0.2,4,4,TGGAATACCCATGTTTAAGC,0,2239722
marRp,0.2,4,4,TGGAAGGGCATTACAGTATC,0,2250191
marRp,0.2,4,4,TGCTGATCTATGCCAGCGTT,0,2255667
marRp,0.2,4,4,TGCGGATGTCGGTACCACGG,0,2230572
marRp,0.2,4,4,TGCGGAAGCACAGCCAAGAA,0,2258116
marRp,0.2,4,4,TGCCCGTGTCTGGGGTACCC,0,2227167
marRp,0.2,4,4,TGCATCTGCAAGCAAGGCAA,0,2258108
marRp,0.2,4,4,TGCATCGGCAAGACTTGTAA,0,2243130
marRp,0.2,4,4,TGCAGTGTGGCGCCCTGTGC,0,2221516
marRp,0.2,4,4,TGCAGGAACCCGGTGCCCGC,0,2219892
marRp,0.2,4,4,TGCAGCAGTCTGAGTTAGAA,0,2252337
marRp,0.2,4,4,TGATCTCATCGACCGTCGAG,0,2218936
marRp,0.2,4,4,TGATATTCCTGGCTCTCTGT,0,2220373
marRp,0.2,4,4,TGAGGTGATGCTCGCGAACT,0,2225974
marRp,0.2,4,4,TGAGGAGCAGTTAGATTCTC,0,2223937
marRp,0.2,4,4,TGACGCTTGGTTGGGGCTAA,0,2236749
marRp,0.2,4,4,TGAAGGATCATTAACAGCCA,0,2231702
marRp,0.2,4,4,TCTGCGGGTGGCGTTAGACT,0,2226109
marRp,0.2,4,4,TCTGCACGCGGTAGAGTAAT,0,2254630
marRp,0.2,4,4,TCTCTTGAATAGCGGACGGC,0,2237162
marRp,0.2,4,4,TCTATTCAGATGGTCTCGAC,0,2256329
marRp,0.2,4,4,TCGTCCTTGCACGACGTGGA,0,2232537
marRp,0.2,4,4,TCGGGTTTGTTTCGTAATCT,0,2253220
marRp,0.2,4,4,TCGGGCGTAGCAACGAGTAC,0,2222307
marRp,0.2,4,4,TCGGCTGACCGCAGTCATTG,0,2258534
marRp,0.2,4,4,TCGGCATATAGCTCTACGTA,0,2255503
marRp,0.2,4,4,TCGCTTCTGGAGGGGTTGGG,0,2240221
marRp,0.2,4,4,TCGCTTCAGTTGAATCCTCA,0,2251677
marRp,0.2,4,4,TCGCGAGCGGGTGCAGAGTG,0,2254488
marRp,0.2,4,4,TCGCATTCGGTTATCAATCT,0,2257940
marRp,0.2,4,4,TCGAACGTTCCGGGCGGCTC,0,2226341
marRp,0.2,4,4,TCCTGGGCATTTAACAATTT,0,2255894
marRp,0.2,4,4,TCCGTTAGCTAGCGCTTATA,0,2251401
marRp,0.2,4,4,TCCGGCAGGGAAAGTGCGTA,0,2220890
marRp,0.2,4,4,TCCGAAGCACTATCATTCGC,0,2230044
marRp,0.2,4,4,TCCCTCTGTTCGGCCTTAGA,0,2235357
marRp,0.2,4,4,TCCCGAGGAGTTGTTCGTTT,0,2222374
marRp,0.2,4,4,TCCATCCCATACAACCATCA,0,2223022
marRp,0.2,4,4,TCATGGGCGCGAGGTAGCCT,0,2242364
marRp,0.2,4,4,TCATCCATAAAATGAGTTTT,0,2248933
marRp,0.2,4,4,TCAGTCAGCAGGAAGGCTAC,0,2236370
marRp,0.2,4,4,TCAGGAATATCCAAATGGCC,0,2232271
marRp,0.2,4,4,TCACTAGGCCCTTCATGTTC,0,2218349
marRp,0.2,4,4,TATTCAGGGCGTCTGGAAAG,0,2235628
marRp,0.2,4,4,TATCGATGCACTCAGACCTA,0,2234717
marRp,0.2,4,4,TATACGGCTGTAGTTAAAAT,0,2245891
marRp,0.2,4,4,TAGGTCAGGCAAGGGGCCAC,0,2244077
marRp,0.2,4,4,TAGGATAATAAGGAGGTACT,0,2246508
marRp,0.2,4,4,TAGGACAAGCCCCTTGTCCG,0,2245839
marRp,0.2,4,4,TAGCTGAGAGAGCACGGGGG,0,2231270
marRp,0.2,4,4,TAGCATCTTGAACAATCAGC,0,2219859
marRp,0.2,4,4,TAGCATCGTTTACACTAGAT,0,2222045
marRp,0.2,4,4,TACTGCTCCTCCAGACAGAG,0,2254690
marRp,0.2,4,4,TACGCGCGTGGTCTGGCGTT,0,2228374
marRp,0.2,4,4,TACACTGAGCTTAATGAAGC,0,2243265
marRp,0.2,4,4,TAAGCGGTCAGCCCTCCGGA,0,2241361
marRp,0.2,4,4,TAACGCAGGCGGCGTACCTT,0,2222187
marRp,0.2,4,4,TAAACGGTAATAGCTTTCAT,0,2229470
marRp,0.2,4,4,TAAACCCTACATAAACGCTC,0,2225730
marRp,0.2,4,4,GTTTTTCCAGCTTAGATCTG,0,2239380
marRp,0.2,4,4,GTTTGAGGCTCAATTCAGCT,0,2237820
marRp,0.2,4,4,GTTGAGCTCCTGCATCCAAG,0,2243150
marRp,0.2,4,4,GTTATTATCGGCGTTCGCTA,0,2234105
marRp,0.2,4,4,GTTACCAAGCACCCGTACGT,0,2230527
marRp,0.2,4,4,GTGTGGAGAACGGGCGCTAC,0,2237760
marRp,0.2,4,4,GTGTCTACAATAGGCCAGTT,0,2231969
marRp,0.2,4,4,GTGTCCAAAGGCTATAACTG,0,2224922
marRp,0.2,4,4,GTGGCCATGTTCTGGGTAAT,0,2220901
marRp,0.2,4,4,GTGGAGCAGAGGACTTCAGT,0,2229351
marRp,0.2,4,4,GTGGAAGGACTAGCATGAGT,0,2231501
marRp,0.2,4,4,GTGCCGGCTAGCCTGTATCG,0,2257609
marRp,0.2,4,4,GTGCATTGGACCCCGTATGC,0,2241149
marRp,0.2,4,4,GTGAGCGTAAAAGTTGAATT,0,2238298
marRp,0.2,4,4,GTCTGATACGAGTGTGGTTC,0,2228872
marRp,0.2,4,4,GTCGATGTGGTTTATAGGCT,0,2224172
marRp,0.2,4,4,GTCGAGGAATACGCCCCGTT,0,2219652
marRp,0.2,4,4,GTATATCTGACAAGATTCTG,0,2239047
marRp,0.2,4,4,GTAGTATAATCGGCTAGTTG,0,2241349
marRp,0.2,4,4,GGTTTTGAACGGGTCATCAC,0,2254726
marRp,0.2,4,4,GGTTGCCGTTCCGCTGTCAC,0,2240040
marRp,0.2,4,4,GGTGTGGAACTGCTAGGGCT,0,2250219
marRp,0.2,4,4,GGTGAGTCGCGCGAAACTCC,0,2239656
marRp,0.2,4,4,GGTCTACAGGTCGAATGGCT,0,2223529
marRp,0.2,4,4,GGTCAATTGATCTTGCGACA,0,2249095
marRp,0.2,4,4,GGTAGTTTGCATGGAGGGGG,0,2257124
marRp,0.2,4,4,GGGTTGGGATGAGCAAAGAG,0,2252458
marRp,0.2,4,4,GGGGGTGAGACTTCTACTAG,0,2231461
marRp,0.2,4,4,GGGGGCATCAAGTTAACTTA,0,2240173
marRp,0.2,4,4,GGGCCAAAGCCTGAAGCTAA,0,2241884
marRp,0.2,4,4,GGGAGGGTAATTATTGAATA,0,2226178
marRp,0.2,4,4,GGCGAACGTCAGGACTAGCG,0,2246458
marRp,0.2,4,4,GGCGAAATGAGCGCCGATGA,0,2243826
marRp,0.2,4,4,GGCCGTCCCATCAGACGGTG,0,2257286
marRp,0.2,4,4,GGCCCCGAGGATAATGGCGT,0,2243757
marRp,0.2,4,4,GGCCACACGTGTACAGTGTA,0,2260201
marRp,0.2,4,4,GGCAATCGGCACGCCCTGTA,0,2245783
marRp,0.2,4,4,GGATTGCCGGTGTAGCAAGA,0,2249973
marRp,0.2,4,4,GGATGTACAGTGCTGTGGTA,0,2238632
marRp,0.2,4,4,GGATGTAAGGCCCGCTGGTA,0,2246742
marRp,0.2,4,4,GGATCCGCGCTAACCTTTAT,0,2226056
marRp,0.2,4,4,GGATACCGATGAACCTCTTT,0,2228553
marRp,0.2,4,4,GGAGGATATACGGATCTCAG,0,2232509
marRp,0.2,4,4,GGACCTACGCGGTCTCATCA,0,2245836
marRp,0.2,4,4,GCTTGTTTCTACGCCATGCG,0,2244271
marRp,0.2,4,4,GCTTATTCCGAGCTAGTGTA,0,2242337
marRp,0.2,4,4,GCTATTAGTTTTAGGCAACC,0,2218388
marRp,0.2,4,4,GCTATATATTCGGTTACTCC,0,2233796
marRp,0.2,4,4,GCTACTGCCGTAATTAAGTA,0,2233567
marRp,0.2,4,4,GCTACGCGTGTACAGTGCTC,0,2236339
marRp,0.2,4,4,GCTAACTGTAGATGTCTGTG,0,2243665
marRp,0.2,4,4,GCGTGGGTGTTCCTAGTACC,0,2236682
marRp,0.2,4,4,GCGTGCCTGGCTGCTTTTCA,0,2228567
marRp,0.2,4,4,GCGGTGTAAAGGTACACGAC,0,2239203
marRp,0.2,4,4,GCGGGCGTCTATTGTGGTCC,0,2228796
marRp,0.2,4,4,GCGGCGACCTGACCACCAAG,0,2229277
marRp,0.2,4,4,GCGGACTATGCTTGCAATGA,0,2235715
marRp,0.2,4,4,GCGCGACGCTAACTCGTCTT,0,2250127
marRp,0.2,4,4,GCGCCTATTTCAATGCCGAT,0,2218150
marRp,0.2,4,4,GCGATGTGCTCACGGCAGCG,0,2234578
marRp,0.2,4,4,GCGACGTAGCGCGTCACCGT,0,2223220
marRp,0.2,4,4,GCGAAAAGTCTGATGTTTGG,0,2226013
marRp,0.2,4,4,GCCTAGTGGTTAATTCTCCT,0,2218286
marRp,0.2,4,4,GCCGCTTTGGGGGGAGATAC,0,2226338
marRp,0.2,4,4,GCCGATCAACTTAAGGGGTT,0,2230031
marRp,0.2,4,4,GCCGACGTCCAGTTTCGTCT,0,2227538
marRp,0.2,4,4,GCATTTTTGATGTGTTCAGT,0,2245841
marRp,0.2,4,4,GCATTATGGGCCGACGTCAG,0,2231606
marRp,0.2,4,4,GCATCTCACGGTTAGAGCGA,0,2226694
marRp,0.2,4,4,GCAGGGAGGGGGGCGAAATT,0,2242939
marRp,0.2,4,4,GCAGCTGGTGTTTGCATAGA,0,2258054
marRp,0.2,4,4,GCAGACTGGGCAGCATTATC,0,2258119
marRp,0.2,4,4,GCACGCGGTAGAGGATGTGT,0,2241704
marRp,0.2,4,4,GCACCAATTGGACCTCAAGT,0,2247642
marRp,0.2,4,4,GCAAGAATTGTGACTGGAGC,0,2260869
marRp,0.2,4,4,GCAAAAGCCTCTTGGCGATA,0,2223776
marRp,0.2,4,4,GATGCTTTGTCCCGTCAAGG,0,2245112
marRp,0.2,4,4,GATGATGGAAGGGGCATTAT,0,2236705
marRp,0.2,4,4,GATCCGGCTTCGAGCGTCAT,0,2251685
marRp,0.2,4,4,GATCCCCAACTATGGGTATG,0,2228812
marRp,0.2,4,4,GATCCATCCAGCCCTGATAC,0,2238202
marRp,0.2,4,4,GATATTCGGAAACAGGTCCC,0,2237193
marRp,0.2,4,4,GATATCGTTGAACTTCGTGA,0,2232263
marRp,0.2,4,4,GAGTGGTAACAAACATATGC,0,2226770
marRp,0.2,4,4,GAGGTACCTTGGCCACGTTT,0,2239607
marRp,0.2,4,4,GAGGGGTGAGTGGAAGGGTA,0,2258258
marRp,0.2,4,4,GAGCGGACCAGTCCGAAGTC,0,2220279
marRp,0.2,4,4,GAGCATATTTGTATTAATAA,0,2249659
marRp,0.2,4,4,GACATCTAGGATTATGGGAT,0,2232435
marRp,0.2,4,4,GACACACGATGACTAGGTGA,0,2227238
marRp,0.2,4,4,GAATGGGGCACGGTTCCTCG,0,2227584
marRp,0.2,4,4,GAAGTAGGGCGGCCGCAGAG,0,2225018
marRp,0.2,4,4,GAACCTCGCTTTGGGTATTA,0,2258543
marRp,0.2,4,4,GAACACTGAATTCAACGGCC,0,2218952
marRp,0.2,4,4,CTTTTCGCCCTTATTGAGTT,0,2259209
marRp,0.2,4,4,CTTTCTAATTTGTGTTATCA,0,2244899
marRp,0.2,4,4,CTTCTGGGTCTCGCACAAAT,0,2242922
marRp,0.2,4,4,CTTCGTCGTAAATAGTGGTA,0,2248671
marRp,0.2,4,4,CTTCAATCGCGGCCGTTTCG,0,2235411
marRp,0.2,4,4,CTTCAAATTACCGCATGGAA,0,2222555
marRp,0.2,4,4,CTGTTATTGTTGAACCCACA,0,2224171
marRp,0.2,4,4,CTGTGACTGCTCTGGCTGCG,0,2234672
marRp,0.2,4,4,CTGTCATGGAAGAGGCAAGA,0,2225010
marRp,0.2,4,4,CTGGTTTAATTTTAGCAGGT,0,2218542
marRp,0.2,4,4,CTGGGTCATGATCGCACCAG,0,2253784
marRp,0.2,4,4,CTGGGCTTTTACCTCTCATA,0,2237987
marRp,0.2,4,4,CTGGCGCTTTATCTGTCAGG,0,2254008
marRp,0.2,4,4,CTGAGGTCATGGAAAATCAG,0,2241729
marRp,0.2,4,4,CTCTTGTCAATCGCCACTTA,0,2244479
marRp,0.2,4,4,CTCGGTATCTCAATACCTTA,0,2226348
marRp,0.2,4,4,CTCCGTCATAGCCCTTCATC,0,2250628
marRp,0.2,4,4,CTCCGATGCATCGCACCGGC,0,2243558
marRp,0.2,4,4,CTCCCAAAGTTATCGTAGCA,0,2229805
marRp,0.2,4,4,CTCATCGCACTACCGTGGGT,0,2240325
marRp,0.2,4,4,CTCACTACGGTGATAAAGTG,0,2235851
marRp,0.2,4,4,CTCACGTAAACGGTGAATAC,0,2224338
marRp,0.2,4,4,CTCAAACCCGACGAGAGAGA,0,2237215
marRp,0.2,4,4,CTACGAGCGTCATCCGCACA,0,2251572
marRp,0.2,4,4,CGTTTCCTAGGAAGCGTTCA,0,2225526
marRp,0.2,4,4,CGTCGGTCTCGATAGCGGTC,0,2249129
marRp,0.2,4,4,CGTCGCAGGGTATTCGCCGT,0,2245326
marRp,0.2,4,4,CGGTTCTCGTCATATAGGTC,0,2233707
marRp,0.2,4,4,CGGTGTATTTTTATCTTGCT,0,2228590
marRp,0.2,4,4,CGGTCCGGGCAAATTCTTCA,0,2233352
marRp,0.2,4,4,CGGTCCATATTGGATCACTG,0,2232488
marRp,0.2,4,4,CGGTAGTACGTGGACTTGTC,0,2232841
marRp,0.2,4,4,CGGGTTTTATAGAGGTTGAT,0,2254609
marRp,0.2,4,4,CGGGTACATGAGTACAGTCT,0,2245621
marRp,0.2,4,4,CGGGGTAACTTCATGCGCGG,0,2218047
marRp,0.2,4,4,CGGCGGTTGTTATACCTAGA,0,2221090
marRp,0.2,4,4,CGGCCTATGGCGGTGGCAAA,0,2222310
marRp,0.2,4,4,CGGATGCATTCGCTCCGGAG,0,2218971
marRp,0.2,4,4,CGCTCTTGCGTGTGGAGAAT,0,2245176
marRp,0.2,4,4,CGCTCAGGTTCTGGTGGGAG,0,2248935
marRp,0.2,4,4,CGCGCGAGGAGATGCTTAAG,0,2219400
marRp,0.2,4,4,CGCCTGTCAGAACCGGATTC,0,2245562
marRp,0.2,4,4,CGATTTTTCAAGGTATCTAT,0,2229565
marRp,0.2,4,4,CGATTTGTCTCGCCCGGCTA,0,2236423
marRp,0.2,4,4,CGATAGTCGGCGATGCTTCG,0,2225206
marRp,0.2,4,4,CGATACCCGTTAGGCCACAG,0,2227678
marRp,0.2,4,4,CGAGCAACTGTACATACGCC,0,2241150
marRp,0.2,4,4,CGACAACCCACCTAAGCCAA,0,2256958
marRp,0.2,4,4,CGAAGTTGAGGAGAGGTAGC,0,2218095
marRp,0.2,4,4,CCTTTGAACCCTGTGCACAA,0,2232755
marRp,0.2,4,4,CCTTTCCTCATATCCTAGGC,0,2220003
marRp,0.2,4,4,CCTTGTGACATCAAAAGCAG,0,2217876
marRp,0.2,4,4,CCTGCCATAGTCTCCAATGG,0,2245734
marRp,0.2,4,4,CCTATATCATAGGTCGAAAG,0,2256905
marRp,0.2,4,4,CCTAGGGATGTTCGGCACGT,0,2256759
marRp,0.2,4,4,CCGTGTTGGACTCACACTGT,0,2240114
marRp,0.2,4,4,CCGTAGTGCGGAACCTCCAA,0,2238513
marRp,0.2,4,4,CCGTAACAGGATTTCCGCGA,0,2233552
marRp,0.2,4,4,CCGGGGGCGTCTTTATTCGC,0,2235631
marRp,0.2,4,4,CCGGAGAAGTCCTGTCCCCC,0,2243787
marRp,0.2,4,4,CCGCCGACCGGTCCTCGCCA,0,2233843
marRp,0.2,4,4,CCGCACGTCTCTGAGCAAGG,0,2247334
marRp,0.2,4,4,CCGATAGCTCCAGGCATAAA,0,2240142
marRp,0.2,4,4,CCGAATGGGACGATGAGGGA,0,2220298
marRp,0.2,4,4,CCCGTGCGTTCGCATGCCGA,0,2219237
marRp,0.2,4,4,CCCGATTGAAGCCCTCCGTT,0,2237853
marRp,0.2,4,4,CCCCGATCTAATATGTGAAT,0,2223869
marRp,0.2,4,4,CCCATGCCCGGATCTAAATC,0,2228428
marRp,0.2,4,4,CCCACTCCGCGATAGGGGAG,0,2248180
marRp,0.2,4,4,CCATCCGATCACACGTCTCT,0,2239659
marRp,0.2,4,4,CCATCAGCTGTGTGTGAAGT,0,2224996
marRp,0.2,4,4,CCAGTTTTAGCACTGTGTTT,0,2218608
marRp,0.2,4,4,CCACCTATCGACGTGTAAAA,0,2254560
marRp,0.2,4,4,CCACATGTATGACTGGACTG,0,2259016
marRp,0.2,4,4,CCACAGCCCCAGTAGTATTA,0,2218361
marRp,0.2,4,4,CCAATTTGTTATATAAACAG,0,2234943
marRp,0.2,4,4,CCAATCGTCGGTGCACATCG,0,2226391
marRp,0.2,4,4,CCAACTACCGTACTCACTGA,0,2241736
marRp,0.2,4,4,CCAACGCTGCTAGAAGTAAA,0,2236259
marRp,0.2,4,4,CATTTTTTGACAGCCCGACG,0,2225434
marRp,0.2,4,4,CATGGGTTATATAGCCTAGA,0,2222923
marRp,0.2,4,4,CATGCAGTGGAGGGGCCAGT,0,2221393
marRp,0.2,4,4,CATGAGTCAATTTCGGTGTG,0,2240046
marRp,0.2,4,4,CATCTCATCCGAGTTGGCTA,0,2248763
marRp,0.2,4,4,CATCTAAGGTGACCCAACGA,0,2246619
marRp,0.2,4,4,CATCGCCATCCCCCCGCTGG,0,2247652
marRp,0.2,4,4,CATCAGCTTCAGATGGAGCT,0,2244780
marRp,0.2,4,4,CATCACATATCAGATTAGGA,0,2255592
marRp,0.2,4,4,CATAATGAAATTAGCTAATT,0,2250010
marRp,0.2,4,4,CAGGGTCATTAAGGAGAAGA,0,2232374
marRp,0.2,4,4,CAGGGCATGATTGGGTCATG,0,2217830
marRp,0.2,4,4,CAGGAGCTCCAGTAGCGAAT,0,2228594
marRp,0.2,4,4,CAGATTGTGCGTACCCCGAT,0,2231285
marRp,0.2,4,4,CAGATCGAGTGGCCAGAGCG,0,2252698
marRp,0.2,4,4,CACGGGGCTCGCTCAGCTGA,0,2233357
marRp,0.2,4,4,CACGCATGCAGCTCCAACCC,0,2251192
marRp,0.2,4,4,CACGACAGCCCTTTCAGTGG,0,2218662
marRp,0.2,4,4,CACCTGCAAGCCCTCATGTG,0,2253795
marRp,0.2,4,4,CACCGCTAGTCATAGGAACG,0,2255378
marRp,0.2,4,4,CACAGGTCTTAGATGTCCCG,0,2222107
marRp,0.2,4,4,CAATGGTGATGTCGAAAGTT,0,2256610
marRp,0.2,4,4,CAAGAGTGAGATTGGTTTGT,0,2234761
marRp,0.2,4,4,CAACCCATATATAGTTGGAG,0,2247134
marRp,0.2,4,4,ATTTTCAGTGGGGGATCTAT,0,2252402
marRp,0.2,4,4,ATTTTATTGCTAAATATCCC,0,2239653
marRp,0.2,4,4,ATTGTCCCAACGGCGCATGC,0,2220167
marRp,0.2,4,4,ATTGCTGATAAAGACATTAC,0,2227746
marRp,0.2,4,4,ATTCGAGAAGGGCGTCAAGA,0,2235499
marRp,0.2,4,4,ATTATATTTGGTTTATCTGT,0,2243346
marRp,0.2,4,4,ATTAGGAGGGGGGGATCATA,0,2234420
marRp,0.2,4,4,ATGGGATGACGGGGGGAGCT,0,2245900
marRp,0.2,4,4,ATGCGTAACTTCGAGGTATA,0,2239694
marRp,0.2,4,4,ATGCGGGAGGAGTTAGCCAT,0,2229359
marRp,0.2,4,4,ATGCGAGCTATACTAAATGA,0,2249387
marRp,0.2,4,4,ATGATGTGATTTTGCCAACT,0,2247434
marRp,0.2,4,4,ATGAGGACTCGGTCATAGCG,0,2219363
marRp,0.2,4,4,ATGACCTGCACGCAACGAGT,0,2227341
marRp,0.2,4,4,ATCTTGGGTCGTCATCTCGG,0,2239293
marRp,0.2,4,4,ATCTGGGCTAGTGACTTGAG,0,2250527
marRp,0.2,4,4,ATCTAACGGTCAGAGTGGGA,0,2233215
marRp,0.2,4,4,ATCGTGCTAGAGCAACCCAC,0,2236983
marRp,0.2,4,4,ATCGTCACAATTGCACAACC,0,2223522
marRp,0.2,4,4,ATCGCATTCCTTGCGGGCTC,0,2246746
marRp,0.2,4,4,ATCCAGAGTGATACTCGGTA,0,2240234
marRp,0.2,4,4,ATCAGGGTGCGAGATGAATT,0,2231212
marRp,0.2,4,4,ATCAGGGGGGCGCACGATTC,0,2233705
marRp,0.2,4,4,ATCAAACAATAGGATAATGT,0,2258984
marRp,0.2,4,4,ATATTGCTTTCCGATCTGAT,0,2221587
marRp,0.2,4,4,ATATAGCTTCTAAGAAGGCT,0,2222824
marRp,0.2,4,4,ATATAGCATATAATTACGCC,0,2249228
marRp,0.2,4,4,ATAGGGAACACCACCGCGGT,0,2246249
marRp,0.2,4,4,ATAGGCTCCCCCATGGGAAT,0,2246252
marRp,0.2,4,4,ATACTACGGGCTGAGTTGTC,0,2234384
marRp,0.2,4,4,ATAAATATTCCGTTGTATCA,0,2228389
marRp,0.2,4,4,AGTTTAAAGCCTCCCAAATA,0,2234405
marRp,0.2,4,4,AGTTCCCAGATAGGGTTAAC,0,2239848
marRp,0.2,4,4,AGTGGGGACCACATTTTGTC,0,2258163
marRp,0.2,4,4,AGTCTCGTGGAAAGCAAGTG,0,2249568
marRp,0.2,4,4,AGTCGGGCGTGGACGTAACT,0,2234038
marRp,0.2,4,4,AGTCCCCGATCACTGAAAGA,0,2234890
marRp,0.2,4,4,AGTAGAATTCCCTGTCAACG,0,2259520
marRp,0.2,4,4,AGGTTTGAATAATTAAGGTC,0,2225195
marRp,0.2,4,4,AGGTCCGGCGGGCTCACAAC,0,2228732
marRp,0.2,4,4,AGGTCACGCAAAACGAGCCC,0,2224995
marRp,0.2,4,4,AGGGTCCTAGGGCTTTTCGT,0,2230971
marRp,0.2,4,4,AGGGGGAGTTGCTTAGGTGA,0,2258311
marRp,0.2,4,4,AGGGACGTAGCCGACGTTTG,0,2251543
marRp,0.2,4,4,AGGATCGTGAGATACTTTGC,0,2245504
marRp,0.2,4,4,AGGACGGTGGACCGCCGGCA,0,2218230
marRp,0.2,4,4,AGGACCACGAGTGGGTGTTA,0,2242153
marRp,0.2,4,4,AGCTCGCCACAGGAACGTAC,0,2227580
marRp,0.2,4,4,AGCGCCTCTTGATGCCTTTA,0,2253770
marRp,0.2,4,4,AGCCTTCTCCTACTTTTGTC,0,2234852
marRp,0.2,4,4,AGCCTACGTGTTCGTGTTGC,0,2247944
marRp,0.2,4,4,AGATGGTCAACAGTTGTCAC,0,2239839
marRp,0.2,4,4,AGATGCTGTACTTCGTGCCG,0,2227749
marRp,0.2,4,4,AGATCGGAATAATTATGTTG,0,2241912
marRp,0.2,4,4,AGATCCTGAAGAGGAGCTGC,0,2236221
marRp,0.2,4,4,AGATAACGTTCTTAGTTGAT,0,2241237
marRp,0.2,4,4,AGACTGTATCACTGCGAGGG,0,2222105
marRp,0.2,4,4,AGACTCTCGCGTCATGATTA,0,2241344
marRp,0.2,4,4,AGAAGGGGGGATCGTAGAGT,0,2252853
marRp,0.2,4,4,ACTTCTGGAACGTTCCATGT,0,2252334
marRp,0.2,4,4,ACTTCCGCTGCCTCTTCGGA,0,2246415
marRp,0.2,4,4,ACTTAAAGTTTCCATGAACA,0,2239875
marRp,0.2,4,4,ACTGTCTGCGGACGAGTGTA,0,2225985
marRp,0.2,4,4,ACTGCAACGAGGATACCTCC,0,2224131
marRp,0.2,4,4,ACTAGATTAGCCGTGGTCGT,0,2257135
marRp,0.2,4,4,ACGTTTCCTGGATTGAGACG,0,2233490
marRp,0.2,4,4,ACGGTAGCCCTTAACAGAGC,0,2242961
marRp,0.2,4,4,ACGGGCCGATATCGGCCCAG,0,2243180
marRp,0.2,4,4,ACGGAATTGTTAGTGTAAAT,0,2246761
marRp,0.2,4,4,ACGCGTTACTCGATACTATT,0,2240946
marRp,0.2,4,4,ACGCAGTGGGGATACGCCGC,0,2240913
marRp,0.2,4,4,ACGAGCGATTGTCGGGCGAA,0,2219969
marRp,0.2,4,4,ACGAGCCGCCTCCGACATTC,0,2252232
marRp,0.2,4,4,ACCTATAATCGGGTTGCCAT,0,2230673
marRp,0.2,4,4,ACCGTGTGTGTACGCTTGGT,0,2236465
marRp,0.2,4,4,ACCCCATATACGCAGGACGT,0,2240513
marRp,0.2,4,4,ACCCCACCGAACCTGAGTAG,0,2257911
marRp,0.2,4,4,ACCCACGTTCGCGGTGGTTG,0,2240181
marRp,0.2,4,4,ACCAAGGTATCCTGTCCCTC,0,2231819
marRp,0.2,4,4,ACAGTTACATTATGTTAGGA,0,2219539
marRp,0.2,4,4,ACACGCCTCGACTTGAGAGG,0,2220421
marRp,0.2,4,4,ACACCCCATCCTCCACTGAG,0,2223446
marRp,0.2,4,4,ACAATTCTCCCAATTCCTAG,0,2235738
marRp,0.2,4,4,ACAATAATCAATGGAGCTCG,0,2239807
marRp,0.2,4,4,AATGGCATCATATAGTAGGT,0,2230761
marRp,0.2,4,4,AATCAAGGGTATCCGCTCCG,0,2256444
marRp,0.2,4,4,AATACCAAAGCAATTGCCTT,0,2247645
marRp,0.2,4,4,AATAACCGGGTTGGATTATA,0,2244249
marRp,0.2,4,4,AAGGGCACATGCAAGGAGAC,0,2222389
marRp,0.2,4,4,AAGGAGTCTACTTAAAGTAG,0,2222639
marRp,0.2,4,4,AAGCACAAAGGTTGAATGGC,0,2244267
marRp,0.2,4,4,AAGCAAGGCAGGTTGCCAGC,0,2229047
marRp,0.2,4,4,AACTCAGGGGCACTTTGTTT,0,2237869
marRp,0.2,4,4,AACTAAGGTACGGCATCGTA,0,2219535
marRp,0.2,4,4,AACTAAATGGGTACATTTTG,0,2223847
marRp,0.2,4,4,AACGGTTACGCGTAACGCCT,0,2238732
marRp,0.2,4,4,AACCGCCAGTCAGAATCATA,0,2242908
marRp,0.2,4,4,AACCCGGCGATAAGTCGGGA,0,2241015
marRp,0.2,4,4,AACATCCGCGTAACGCTAAT,0,2228934
marRp,0.2,4,4,AACAACTGGGCGCACAACAT,0,2239513
marRp,0.2,4,4,AACAACCGAACATAAAGATT,0,2246473
marRp,0.2,4,4,AAATTCCCAAATTGCGTTGT,0,2225138
marRp,0.2,4,4,AAAGGAGTACCGTCCTTCGC,0,2221401
marRp,0.2,4,4,AAACTGGAAACAAGGAGTGT,0,2232765
marRp,0.2,4,4,AAACCAGGTCGCAGGGAAGC,0,2258171
marRp,0.2,4,4,AAACATTGCCCCGTTTGGAA,0,2254475
marRp,0.2,4,4,AAACAAGCTGGTGAGAATCT,0,2237977
marRp,0.2,4,4,AAAATGGATATCCCAAGTGT,0,2255068
marRp,0.25,3,3,TTTTGTTTTTTTAAAGCTTG,0,2244978
marRp,0.25,3,3,TTTTGACAGATGCGTGAGGG,0,2226202
marRp,0.25,3,3,TTTGTCCCGGAGTAGCCGGC,0,2232584
marRp,0.25,3,3,TTTGCGCAATCGTATAGGTA,0,2258952
marRp,0.25,3,3,TTTCTTCAGTTATTGCGGAT,0,2252820
marRp,0.25,3,3,TTTCACTAACCATTTCCATT,0,2227550
marRp,0.25,3,3,TTTCAAAAGGACTCCATTGT,0,2252630
marRp,0.25,3,3,TTTATAACAGTTACTGGCGA,0,2223769
marRp,0.25,3,3,TTGTTACACTTCTAAGTAGT,0,2239893
marRp,0.25,3,3,TTGTCAGACCTGCGATTGTC,0,2234120
marRp,0.25,3,3,TTGTATATCTTTCGAAACAG,0,2232471
marRp,0.25,3,3,TTGGTCAATAGTTTGTTTTT,0,2244235
marRp,0.25,3,3,TTGGCAAACTGCTCGGAGTC,0,2233411
marRp,0.25,3,3,TTGCGGGACATTGCGGTACA,0,2249757
marRp,0.25,3,3,TTGCGATTGGTATCTCAGCT,0,2259324
marRp,0.25,3,3,TTGATGCTATTACACAGGCT,0,2260733
marRp,0.25,3,3,TTGAGGTACAGCGACGCTTA,0,2235170
marRp,0.25,3,3,TTGAACTCATGGCCTGGGTT,0,2256510
marRp,0.25,3,3,TTCGGATGCAACTATTTCTC,0,2249638
marRp,0.25,3,3,TTCGCTCTCCGGGAGAAATC,0,2242503
marRp,0.25,3,3,TTCCTGGCCCTTAGTTCAAT,0,2248845
marRp,0.25,3,3,TTCACTTAGTTCGCACCCAT,0,2253586
marRp,0.25,3,3,TTCAAAGGTGACTACCGAGA,0,2231227
marRp,0.25,3,3,TTATTGCAATTGGGGCTGTG,0,2238066
marRp,0.25,3,3,TTATTGACTGCGGCGCCGAT,0,2246250
marRp,0.25,3,3,TTATGCCAGGGTCAGAGGAT,0,2239774
marRp,0.25,3,3,TTATGATAGCTGATGGCCTG,0,2257147
marRp,0.25,3,3,TTATAATGCAGCCCACCGCA,0,2235569
marRp,0.25,3,3,TTAGGGCAAATGACCGTCGC,0,2217860
marRp,0.25,3,3,TTACGTCGTTACTCGAGCGA,0,2244323
marRp,0.25,3,3,TTACGGAAGCATGTCATAAG,0,2236905
marRp,0.25,3,3,TTAACGGTAAGGTATAACTA,0,2234650
marRp,0.25,3,3,TTAACAGTGTTGAAGATGCC,0,2226640
marRp,0.25,3,3,TGTCTAGGTCAACACGCTGT,0,2240149
marRp,0.25,3,3,TGTCAGGCGCTACGCTACGC,0,2221167
marRp,0.25,3,3,TGTCAATACCACTCAAGCGA,0,2243273
marRp,0.25,3,3,TGTATTGGGACTTTATGTTT,0,2239901
marRp,0.25,3,3,TGTACCCCCGAAAGGTCATC,0,2223055
marRp,0.25,3,3,TGGTGCGGAACTAATGGAGA,0,2230641
marRp,0.25,3,3,TGGTAGCGCCAAGCGGCCTA,0,2245738
marRp,0.25,3,3,TGGGAGTAGATGCATTGACT,0,2248524
marRp,0.25,3,3,TGGCGAGAAATTATAAGGAG,0,2242895
marRp,0.25,3,3,TGGCAAGTGCCTCTTGACCA,0,2248268
marRp,0.25,3,3,TGGAGAGGTCGAGGCAGGCT,0,2230880
marRp,0.25,3,3,TGGAAAAGTATGTTTCCTGA,0,2255525
marRp,0.25,3,3,TGCTGTGAGTTCGGTAGCGG,0,2255129
marRp,0.25,3,3,TGCTCAGCGACGGACACGCA,0,2226355
marRp,0.25,3,3,TGCTAGGTCCGACCGTATAA,0,2234920
marRp,0.25,3,3,TGCTAGAACATTTGTTTGAT,0,2247640
marRp,0.25,3,3,TGCGGTAATAGGCCTGTTTA,0,2241674
marRp,0.25,3,3,TGCGGGCCACAGAAAGTCCC,0,2241281
marRp,0.25,3,3,TGCGCCCCTAAGGGGCCAAG,0,2246492
marRp,0.25,3,3,TGCGAGTTTACTTGGGATTC,0,2228911
marRp,0.25,3,3,TGCCTTTTCCCGTCATGGCG,0,2220037
marRp,0.25,3,3,TGCCTGGAAGGTACACTACA,0,2235213
marRp,0.25,3,3,TGCCTCGCTAAGTACCGACC,0,2220584
marRp,0.25,3,3,TGCCTCCCCCTGGGCAGCAT,0,2219488
marRp,0.25,3,3,TGCCAATCCCGTTCATGCCT,0,2233725
marRp,0.25,3,3,TGCATTCCAGGAGGGGAACA,0,2236989
marRp,0.25,3,3,TGCAGGCGCGTCACCGGTGT,0,2247191
marRp,0.25,3,3,TGCAATCTGGGTGGATTCGC,0,2246410
marRp,0.25,3,3,TGATCCACTCTTACACCAAT,0,2242714
marRp,0.25,3,3,TGAGTCAAGAGGATTTCTTT,0,2259671
marRp,0.25,3,3,TGAGGGCGGGAGGCGCACGA,0,2255276
marRp,0.25,3,3,TGAGGGAGGTACACGTAGGT,0,2234610
marRp,0.25,3,3,TGAATGCAGCAGGATCTTTA,0,2236570
marRp,0.25,3,3,TGAAATGTAGATTCACCAGT,0,2235125
marRp,0.25,3,3,TGAAAATGCCTGGGGTTAAC,0,2244288
marRp,0.25,3,3,TCTTTCACTGCGTCAGTTCT,0,2251904
marRp,0.25,3,3,TCTTCGGTCAACAACTCGGC,0,2222270
marRp,0.25,3,3,TCTGCGAGGGTCTAGGTTGA,0,2256048
marRp,0.25,3,3,TCTGAGGGGAACCCTAATTA,0,2242022
marRp,0.25,3,3,TCTGACTACAAAAAATATCT,0,2248651
marRp,0.25,3,3,TCTCAGTAAGGCGGATGCGC,0,2243593
marRp,0.25,3,3,TCTATTGTCGGTAATAAGGC,0,2243725
marRp,0.25,3,3,TCTAGTGGGTAGCACTGTGA,0,2232312
marRp,0.25,3,3,TCTAGTATAGTCCCGGGCGA,0,2249743
marRp,0.25,3,3,TCGTTGTGTCGGTCCCAGCC,0,2242500
marRp,0.25,3,3,TCGTAGCGACGTGGTAATGG,0,2236074
marRp,0.25,3,3,TCGGTCGCGACTCCCATGAG,0,2233638
marRp,0.25,3,3,TCGGTATTTCAAACTAATGC,0,2233716
marRp,0.25,3,3,TCGGGCAAGAATGAGTCTGG,0,2253273
marRp,0.25,3,3,TCGCAAAGCGGCTGTGTTCT,0,2247677
marRp,0.25,3,3,TCGAGGCGTAATGTTAAGAC,0,2244176
marRp,0.25,3,3,TCGAAAATTCTACGGTCATG,0,2245815
marRp,0.25,3,3,TCCTGACGCAAACGGCGAAT,0,2253641
marRp,0.25,3,3,TCCTCCGGAGTTTTCAAGAT,0,2235445
marRp,0.25,3,3,TCCTACGTCTGCATCTCCGG,0,2251395
marRp,0.25,3,3,TCCGTTCTAGGGAGAACTAT,0,2251696
marRp,0.25,3,3,TCCCACGGTCTGCTAATAAT,0,2234930
marRp,0.25,3,3,TCATATTATATTTGCGTCTG,0,2258308
marRp,0.25,3,3,TCAGTCCACTAAGCGCTTGA,0,2233271
marRp,0.25,3,3,TCAGGGCACTGTGGAGTACA,0,2245882
marRp,0.25,3,3,TCAGAGGGTGAGGCTATTCA,0,2247783
marRp,0.25,3,3,TCACCTCGATTGGAAGGCTC,0,2237765
marRp,0.25,3,3,TCAATGCAAGCCGTTCATGC,0,2252821
marRp,0.25,3,3,TCAAGAGCGGAACGTGTCTC,0,2229380
marRp,0.25,3,3,TCAACCCACTCATTAACTAG,0,2253720
marRp,0.25,3,3,TCAAAATCCACACTTGTCGT,0,2228304
marRp,0.25,3,3,TATGTTAGTATGCTCCAAGA,0,2238593
marRp,0.25,3,3,TATGTATGTAAAAACATGGA,0,2240208
marRp,0.25,3,3,TATGTAGTCCTTGATTATTA,0,2242366
marRp,0.25,3,3,TATCTGTTCGGCAGACGATT,0,2220716
marRp,0.25,3,3,TAGCAGCATGGTATAATCAC,0,2243604
marRp,0.25,3,3,TAGAGTAGGTCCACATGTTC,0,2221142
marRp,0.25,3,3,TAGACTTTGAGTGAGAGGGA,0,2245173
marRp,0.25,3,3,TAGACCTGTAACGTTTAAAC,0,2248649
marRp,0.25,3,3,TACGGCAACCCTCGCCCCGT,0,2240216
marRp,0.25,3,3,TACGCGGCTGGTATGCCCAG,0,2224442
marRp,0.25,3,3,TACGAACTGTTTTAGAAAGA,0,2224132
marRp,0.25,3,3,TACCGTGAGGGGTTGCATCA,0,2257615
marRp,0.25,3,3,TACACGCCAGACATGCGGTT,0,2245869
marRp,0.25,3,3,TAATCGGTTATTCATTATCA,0,2252641
marRp,0.25,3,3,TAATAGTGCTGGCTGCAGAC,0,2252860
marRp,0.25,3,3,TAAGTTACTGCAGGTGTCCC,0,2238558
marRp,0.25,3,3,TAAGGATTCCATAATAGCGG,0,2228419
marRp,0.25,3,3,TAAGCGACCCCGCTAATATA,0,2253228
marRp,0.25,3,3,TAAGCCATCTCATTCTAAAT,0,2246596
marRp,0.25,3,3,TAACAGTAAAAATGTCAGGA,0,2241304
marRp,0.25,3,3,TAAAGGCCCGGCGAAGGCCG,0,2243069
marRp,0.25,3,3,TAAAAATCCTAATCATAGAG,0,2259678
marRp,0.25,3,3,GTTTTCCATCGGAAGCAATG,0,2221715
marRp,0.25,3,3,GTTTGAGGCTGAAAGATCTG,0,2251750
marRp,0.25,3,3,GTTTCAGGGTAGTAGCCTGA,0,2234576
marRp,0.25,3,3,GTTCAAGGCCATATCAACAA,0,2240049
marRp,0.25,3,3,GTTCAACGTGATGTTGAGAT,0,2228044
marRp,0.25,3,3,GTTACGATTTTTTTAAGAAT,0,2228047
marRp,0.25,3,3,GTGTGTTGAGGATAGTGGCA,0,2229019
marRp,0.25,3,3,GTGGTGAGGGCCGTGCTGTC,0,2227617
marRp,0.25,3,3,GTGGAAGTCCGTCATTGTAA,0,2222503
marRp,0.25,3,3,GTGCGATATCGGTTGAGATT,0,2246479
marRp,0.25,3,3,GTGACCACACGGCCATTTCA,0,2252813
marRp,0.25,3,3,GTCTTGTCGGAGTACTCTCG,0,2254734
marRp,0.25,3,3,GTCTTGACCTTACGGCCTCC,0,2250380
marRp,0.25,3,3,GTCGGTTGCTTGCGTCACAC,0,2256448
marRp,0.25,3,3,GTCGGGGGATCGTCACCTTT,0,2234300
marRp,0.25,3,3,GTCCTCTTGTAGGCGCCACT,0,2235587
marRp,0.25,3,3,GTCATAAGACCTTTGTATTA,0,2225653
marRp,0.25,3,3,GTCAGCAGCAGATAGATCGG,0,2258568
marRp,0.25,3,3,GTCACCCACTGACCGCTCAA,0,2242795
marRp,0.25,3,3,GTATGTGAATAGTTTCTGGT,0,2254799
marRp,0.25,3,3,GTACTCATAGCGGGTCGGTA,0,2255738
marRp,0.25,3,3,GTACGAGGATCGGGCAGCAT,0,2246963
marRp,0.25,3,3,GTACCTGTCCAACGTAGCTA,0,2255074
marRp,0.25,3,3,GTACAACGTTAAGCTTAGTA,0,2253863
marRp,0.25,3,3,GTAATTGCTGCCCGGGCGTA,0,2239963
marRp,0.25,3,3,GTAATTCGACTCTACCCGCC,0,2249211
marRp,0.25,3,3,GTAATACGCCTTATAGTGGG,0,2228316
marRp,0.25,3,3,GGTTGGATACCCACTCGGTG,0,2238347
marRp,0.25,3,3,GGTTAGGTGAAAGCAAAGGG,0,2231913
marRp,0.25,3,3,GGTTAACTCGTAAATCACGA,0,2237990
marRp,0.25,3,3,GGTGCGTTGTGACTGACTAG,0,2219893
marRp,0.25,3,3,GGTGATTAGGCGGGTGACGT,0,2245808
marRp,0.25,3,3,GGTGATCCCAAAATTTTCGA,0,2228364
marRp,0.25,3,3,GGTCTTGGACATGTCCGCTA,0,2247226
marRp,0.25,3,3,GGTATAGGTGGTAGGTTACA,0,2247586
marRp,0.25,3,3,GGTACATCATAAAGTATGGG,0,2237888
marRp,0.25,3,3,GGGTCGAATCTAAGGAGTCG,0,2246972
marRp,0.25,3,3,GGGGTGGGCTACACCCTGGT,0,2251125
marRp,0.25,3,3,GGGGTGGAAGGGATGGGTAG,0,2244342
marRp,0.25,3,3,GGGGTCGCACTGGTTCCCGT,0,2242311
marRp,0.25,3,3,GGGGGAGCTGAGTCTTATTG,0,2233630
marRp,0.25,3,3,GGGCTCTCAACAAAGCCAAG,0,2231485
marRp,0.25,3,3,GGGCCTGGCGGCAACTGCGG,0,2247558
marRp,0.25,3,3,GGGCAGTACGTGGGATTACG,0,2255904
marRp,0.25,3,3,GGGCAACTTTGCGTCATGCC,0,2237742
marRp,0.25,3,3,GGGAATGTATGATGGTTCAG,0,2235196
marRp,0.25,3,3,GGCTGGCGATCCCCTGCTAT,0,2243554
marRp,0.25,3,3,GGCTCTTCCCTCCTGGTTGT,0,2235368
marRp,0.25,3,3,GGCGTAACGCATCGAGTTGT,0,2244248
marRp,0.25,3,3,GGCCTCAGACCCGAGAGAGA,0,2218607
marRp,0.25,3,3,GGCCGTGGGGAGCAGCCGTG,0,2256096
marRp,0.25,3,3,GGCAACGATCCTTGCGAGTT,0,2252292
marRp,0.25,3,3,GGCAAATAGCGGTGATGTGG,0,2219651
marRp,0.25,3,3,GGATCTGGTAGCATATGTGA,0,2246240
marRp,0.25,3,3,GGATACCATGTGAAGCTAGT,0,2236475
marRp,0.25,3,3,GGAGCATTTGTCCATACAGG,0,2224411
marRp,0.25,3,3,GGACTACTTACCGGAGCGTA,0,2230261
marRp,0.25,3,3,GGACCCTATGGCTTCGGGAG,0,2223397
marRp,0.25,3,3,GGACAGGCTGCTGGCAGTAT,0,2250046
marRp,0.25,3,3,GGAAGGGGCTCATAATAGTT,0,2230568
marRp,0.25,3,3,GGAACTGCGCTAGTGTAAAT,0,2257661
marRp,0.25,3,3,GCTTATACGATTTTTGTTGC,0,2257914
marRp,0.25,3,3,GCTGGCCTAACGCAGATCTC,0,2241828
marRp,0.25,3,3,GCTGGACGAACAAAATCATG,0,2251693
marRp,0.25,3,3,GCTCGAGAGCCATAAATCGA,0,2245114
marRp,0.25,3,3,GCTCACAGGGACGTACACGT,0,2218466
marRp,0.25,3,3,GCTATTAGGGCTCGACTTCC,0,2241663
marRp,0.25,3,3,GCTAGACTGTGGGACGCTGG,0,2259822
marRp,0.25,3,3,GCTACTTGGATAGTTTTACC,0,2256609
marRp,0.25,3,3,GCTAATATTCAGCCCTACGA,0,2230671
marRp,0.25,3,3,GCGTCGAATACACAAGAAGA,0,2254550
marRp,0.25,3,3,GCGGTCATGAGTCTTAGATA,0,2226816
marRp,0.25,3,3,GCGGATCAATACCAAAAGCA,0,2224884
marRp,0.25,3,3,GCGCACTACGCCGGGCGGCT,0,2257223
marRp,0.25,3,3,GCGAATACGGCGCCGCCGAA,0,2230455
marRp,0.25,3,3,GCGAACTCTGTCAAGGATCC,0,2243996
marRp,0.25,3,3,GCCTGGTCTCCCATTATTCC,0,2244030
marRp,0.25,3,3,GCCGTGCTCCTGAGGACCAC,0,2251021
marRp,0.25,3,3,GCCAGCAGGGAAGATCCCCT,0,2219880
marRp,0.25,3,3,GCCACCTGGGGAAGAGTCCA,0,2242930
marRp,0.25,3,3,GCATCACTAGCAGGCCAATG,0,2246109
marRp,0.25,3,3,GCATACCCGGATGGAGAACT,0,2249222
marRp,0.25,3,3,GCAGAAGCACTAATGAACAA,0,2219649
marRp,0.25,3,3,GCACGCAGCCTCTCAAGGTG,0,2243567
marRp,0.25,3,3,GCACCGGTGCCAGCATGATT,0,2217833
marRp,0.25,3,3,GCACATCATGGGATTAACCG,0,2258024
marRp,0.25,3,3,GATTGTAGTACGTGTTTACT,0,2258345
marRp,0.25,3,3,GATCTTACCCGGCAATGGCT,0,2237784
marRp,0.25,3,3,GATCGCACACGGGTTGACTT,0,2246740
marRp,0.25,3,3,GATCCCACGGTAAACCTAAG,0,2226454
marRp,0.25,3,3,GAGGTATGTTATCCTACTCC,0,2250639
marRp,0.25,3,3,GAGCGGCGTTGACAAGAAAT,0,2260874
marRp,0.25,3,3,GAGCCGTTCTTCCACCTGGA,0,2242969
marRp,0.25,3,3,GAGCCCAGTGGCTGTTAGTA,0,2251387
marRp,0.25,3,3,GAGAAGGCATAATACTGCGT,0,2233548
marRp,0.25,3,3,GACTCCTCGTGACGCCGCAA,0,2228368
marRp,0.25,3,3,GACCGGGGACTGTTGGCGGG,0,2233510
marRp,0.25,3,3,GACCATTTATAGACGTCGCA,0,2228826
marRp,0.25,3,3,GACCAATCCGTGTCGAGCCG,0,2233611
marRp,0.25,3,3,GACATATACCGCACAGCTGA,0,2228585
marRp,0.25,3,3,GACAAACGTGCATATGCTGG,0,2239031
marRp,0.25,3,3,GAATTCCGAGCAGTGGACGC,0,2257133
marRp,0.25,3,3,GAATTATTCTCGGGTGCCGT,0,2227400
marRp,0.25,3,3,GAATCGTAAACTTGCCGTTC,0,2244730
marRp,0.25,3,3,GAATCCAATTGTACAGGCAT,0,2228571
marRp,0.25,3,3,GAATATGATAACAGCCGGAT,0,2232113
marRp,0.25,3,3,GAATAAATCAGTCCCTCTTT,0,2249633
marRp,0.25,3,3,GAAGTGCCGCTGGATACTGG,0,2236028
marRp,0.25,3,3,GAAGGGTTTGCCCCGGTCGT,0,2228369
marRp,0.25,3,3,GAAGGGCCTTCTAGGTTCAT,0,2244698
marRp,0.25,3,3,GAACTACTCACCAGGATATG,0,2257186
marRp,0.25,3,3,GAACGGTGGTCGAGGTTCCC,0,2240310
marRp,0.25,3,3,GAACGGCTCAGTCCAGACAA,0,2226706
marRp,0.25,3,3,GAACCTTAGCGCCACGAGTG,0,2232780
marRp,0.25,3,3,GAACCTGTATGTAGGTAAGT,0,2255766
marRp,0.25,3,3,GAACCGGGAACTCGACTCTA,0,2247494
marRp,0.25,3,3,GAACATTGGAGCTACTGGTC,0,2225368
marRp,0.25,3,3,GAACAGCCCTGGGTACGGCT,0,2220974
marRp,0.25,3,3,GAAAGCAGACGCGGCCAGCA,0,2255481
marRp,0.25,3,3,GAAACTGAATTCTCTATCTA,0,2227919
marRp,0.25,3,3,GAAAAGATTAAATCAATGGT,0,2244664
marRp,0.25,3,3,CTTTACTTGTAAGACTATAT,0,2243401
marRp,0.25,3,3,CTTGTCAAAGCCAGTAACAT,0,2225925
marRp,0.25,3,3,CTTGGTACGTCGATATAACG,0,2222222
marRp,0.25,3,3,CTTGCAGCCGGCGCATCTTT,0,2235227
marRp,0.25,3,3,CTTGAATTGCACTTTGGCTA,0,2218183
marRp,0.25,3,3,CTTCCCACGGTCGTTGGGCA,0,2225275
marRp,0.25,3,3,CTTATTTTGGACCGTACTCG,0,2223400
marRp,0.25,3,3,CTTATCTGGCCATGGTACCC,0,2242754
marRp,0.25,3,3,CTTAACTCGCGAGGCCCGCT,0,2251411
marRp,0.25,3,3,CTGTACCAATTCTGCAAGAT,0,2247786
marRp,0.25,3,3,CTGGTGCACTAAATGTCACC,0,2259136
marRp,0.25,3,3,CTGGTCTAGATGGCGTGGAG,0,2256188
marRp,0.25,3,3,CTGGGGCTTAGGCAGCCATT,0,2227999
marRp,0.25,3,3,CTGGCCGCCGACTTGTCTTA,0,2231713
marRp,0.25,3,3,CTGGATGCGTTTCCGGTGTA,0,2235802
marRp,0.25,3,3,CTGCGGTTAGCTTTACAGGC,0,2242505
marRp,0.25,3,3,CTGAGTAGCCACCTGCGCTG,0,2258965
marRp,0.25,3,3,CTGAGATGGACCAATCAACA,0,2244625
marRp,0.25,3,3,CTGAAACTCCGCTACGAGAG,0,2218278
marRp,0.25,3,3,CTCGAGCTTGGGTTTGGCGA,0,2243095
marRp,0.25,3,3,CTCATCCTATGATGAGTTGG,0,2220646
marRp,0.25,3,3,CTCAAGGCAGAATTTCGGCG,0,2251817
marRp,0.25,3,3,CTCAAACGTTCGTCTGCTGT,0,2223853
marRp,0.25,3,3,CTATGAGCTTTGCGGCTATG,0,2245945
marRp,0.25,3,3,CTATCTAGCTCTAGAATAAT,0,2221071
marRp,0.25,3,3,CTAGCTACGCTGGCTGCTGC,0,2227370
marRp,0.25,3,3,CTAGCATAGTTGTTCCGCAT,0,2254783
marRp,0.25,3,3,CTACGGACAGGAGGCAAATC,0,2250851
marRp,0.25,3,3,CTACCCGCTGGGTTGCGTTG,0,2232766
marRp,0.25,3,3,CTAATGATGGTCACTGTATA,0,2227609
marRp,0.25,3,3,CGTTCCACGGATCTCGACGA,0,2253864
marRp,0.25,3,3,CGTGTAGTGGGTGCTACGGT,0,2245592
marRp,0.25,3,3,CGTCGTTGTCTAGTCCCCCC,0,2248810
marRp,0.25,3,3,CGTCGAGGTTCATGAGTCTT,0,2252514
marRp,0.25,3,3,CGTCCGGTGTTCTGTATACT,0,2246560
marRp,0.25,3,3,CGTATGCCCTTACACCCAAT,0,2252295
marRp,0.25,3,3,CGGTTGACCATAGCTTTGGT,0,2249611
marRp,0.25,3,3,CGGTTCCCCAGTATGTCGGA,0,2234048
marRp,0.25,3,3,CGGTTACATTCGGGCGGCCC,0,2231719
marRp,0.25,3,3,CGGTCCCTCGTCTCTAAGCA,0,2248297
marRp,0.25,3,3,CGGTATACGGAGCAATAGTG,0,2228424
marRp,0.25,3,3,CGGGTCGGGTTCAGGTAGAG,0,2254086
marRp,0.25,3,3,CGGGATCCCGTCACTCGTTT,0,2251496
marRp,0.25,3,3,CGGGAGATAGTAAATAGCGG,0,2259386
marRp,0.25,3,3,CGGCTGGCATAGGCCCCTGA,0,2230420
marRp,0.25,3,3,CGGCGAGAACGGCGTCCTGA,0,2252037
marRp,0.25,3,3,CGGCGAATGGACACATTGAT,0,2217851
marRp,0.25,3,3,CGGCAGGTAGCTGCCTATTT,0,2253548
marRp,0.25,3,3,CGGAATAGAGTCTTTGTTAT,0,2254855
marRp,0.25,3,3,CGGAACCGGTGCTTTACCCT,0,2256899
marRp,0.25,3,3,CGCTTGCAGTGGTAAATCCT,0,2231499
marRp,0.25,3,3,CGCTTAACATAATCGGTATG,0,2219358
marRp,0.25,3,3,CGCTGTTCCTATAGGAGAGG,0,2239766
marRp,0.25,3,3,CGCTCTCTTGTCCCGGATTC,0,2222792
marRp,0.25,3,3,CGCGTAGGTGAACGTCACAT,0,2235619
marRp,0.25,3,3,CGCGGAACAGGATCCTCCAG,0,2247422
marRp,0.25,3,3,CGCGCGGCATTTATTATGCC,0,2235188
marRp,0.25,3,3,CGCGATCACTTTCAGCATTG,0,2247412
marRp,0.25,3,3,CGCCTGTCACCTAATCCTGG,0,2253292
marRp,0.25,3,3,CGCCTGATGAAAGATATGTT,0,2245625
marRp,0.25,3,3,CGCCAGGAAAGTTACATGGA,0,2226790
marRp,0.25,3,3,CGCAGGGACCCCACAGCCAG,0,2253219
marRp,0.25,3,3,CGAGTGCGAGTCGTGGCAAG,0,2255979
marRp,0.25,3,3,CGACGCACAAAAGCTCCCAG,0,2225283
marRp,0.25,3,3,CGACCCGATGCTGCGGCTGT,0,2253323
marRp,0.25,3,3,CGAATCAGATCAGAGTAGAA,0,2247439
marRp,0.25,3,3,CGAACTGTCAGTATTGTCTC,0,2241045
marRp,0.25,3,3,CGAAATTCACGTGCGGCGTT,0,2236966
marRp,0.25,3,3,CCTTGAATTAATGGTGAGAC,0,2240003
marRp,0.25,3,3,CCTTACTTCAGACTTACCCA,0,2238345
marRp,0.25,3,3,CCTCCACTTCTCATTCAGGG,0,2248678
marRp,0.25,3,3,CCTAGGGCGATTTGTACGAC,0,2242783
marRp,0.25,3,3,CCTACTGAGCATGAAATAAT,0,2260088
marRp,0.25,3,3,CCGTTATTGCCTACCGCTAG,0,2255379
marRp,0.25,3,3,CCGTTATGGTAACTGTTGCA,0,2226425
marRp,0.25,3,3,CCGTAAAGTAAACTATCATC,0,2256181
marRp,0.25,3,3,CCGGAACTCTAGGACGGCCA,0,2222145
marRp,0.25,3,3,CCGGAAATAGTTCTCATCGT,0,2253186
marRp,0.25,3,3,CCGCCTTGAGATGGGTCGTG,0,2234918
marRp,0.25,3,3,CCCTTTGGGAATTGTAGATT,0,2248760
marRp,0.25,3,3,CCCTATCGGTTTACTTCTCA,0,2257096
marRp,0.25,3,3,CCCGTTTAGTTGCTAAATTA,0,2228388
marRp,0.25,3,3,CCCGTTGAGACGGTTCGTAG,0,2258533
marRp,0.25,3,3,CCCGGAGGACACAGTCAAAT,0,2225457
marRp,0.25,3,3,CCCGCTCGTAGACACTGCAG,0,2228912
marRp,0.25,3,3,CCCGACGCTCAGGGCACTAG,0,2249309
marRp,0.25,3,3,CCCCGGACAGGACGGCTCTA,0,2255245
marRp,0.25,3,3,CCCACTTTAGTGCAGCTTTT,0,2250945
marRp,0.25,3,3,CCCACACTGTATTCATAGAC,0,2220612
marRp,0.25,3,3,CCATGTAGTTTTCCCGGAAT,0,2222115
marRp,0.25,3,3,CCATCCGCCGCTATCAGGGT,0,2251016
marRp,0.25,3,3,CCAGTAAAGTTTTGTAGGCG,0,2228693
marRp,0.25,3,3,CCAGAGCTGGATTGTGGGCG,0,2218198
marRp,0.25,3,3,CCACGTGAGCACCATTCAGA,0,2254702
marRp,0.25,3,3,CCACGCGGGAGACGTACCAG,0,2242514
marRp,0.25,3,3,CCAAGAAAGAAGTGCGATTA,0,2233596
marRp,0.25,3,3,CCAACAGTGGATCACACATA,0,2236453
marRp,0.25,3,3,CATTGCGTTGACTAGGTCAG,0,2220464
marRp,0.25,3,3,CATTCCCGATCCCGATGAGT,0,2229511
marRp,0.25,3,3,CATTAGCTACGCGATCAGTC,0,2237688
marRp,0.25,3,3,CATGTGCATGGAACGCCAAC,0,2220335
marRp,0.25,3,3,CATGTCCAGGTTGGTGAAAG,0,2219780
marRp,0.25,3,3,CATGGACTACAGAGTAGAGT,0,2250863
marRp,0.25,3,3,CATCCTATCGATTCACGGTA,0,2254718
marRp,0.25,3,3,CATATAAGGGATACGCCACC,0,2220326
marRp,0.25,3,3,CAGGGGTGCTGCTCCACTGG,0,2225219
marRp,0.25,3,3,CAGGCTTCTGGCTTATATGT,0,2231491
marRp,0.25,3,3,CAGGAAGCCCTGTATTGGTG,0,2251991
marRp,0.25,3,3,CAGCAAGGGAGGGAGATAAC,0,2219380
marRp,0.25,3,3,CAGACCTTAGCAGTAGTGTG,0,2218225
marRp,0.25,3,3,CACTCGGATCGACGAGGGCA,0,2235044
marRp,0.25,3,3,CACTCGCATCAACAGCTTTG,0,2240212
marRp,0.25,3,3,CACTCACCTCCGAGTCCACG,0,2226465
marRp,0.25,3,3,CACGTGGTCCGCACTCGTAC,0,2220884
marRp,0.25,3,3,CACGATGCTGGTGGTAAACT,0,2235364
marRp,0.25,3,3,CACCTATATTCGGGCGTAGA,0,2228463
marRp,0.25,3,3,CACCGGGCCGGAAAGACTGC,0,2229720
marRp,0.25,3,3,CACCGGATACAGGATCCATA,0,2255761
marRp,0.25,3,3,CACCGAGGACTTGTTTGAGG,0,2252430
marRp,0.25,3,3,CACACGTCTAGGGGCCCACT,0,2228547
marRp,0.25,3,3,CACACCTCTGTTGTGGAGGA,0,2217958
marRp,0.25,3,3,CAATCTCCTAAAATCTCGAG,0,2224479
marRp,0.25,3,3,CAATATTCAAGAAATAACTA,0,2234194
marRp,0.25,3,3,CAATACACAGATCATCCCAC,0,2246678
marRp,0.25,3,3,CAAGTTCAATTTGACGCCCA,0,2242977
marRp,0.25,3,3,CAAGTTAAGGTGGCTAGGAG,0,2232815
marRp,0.25,3,3,CAAGGGTGATAGACAACACC,0,2238288
marRp,0.25,3,3,CAAGCGACATTTCCTAGCCT,0,2238270
marRp,0.25,3,3,CAAGATGCGCCATATTCGCT,0,2247697
marRp,0.25,3,3,CAAACGACTGTCGAACGCTG,0,2251581
marRp,0.25,3,3,CAAAATGTGTGGTGATGACA,0,2220329
marRp,0.25,3,3,ATTTTAAAATAAAGATGCTC,0,2226099
marRp,0.25,3,3,ATTTGGATATATAGAGCTCA,0,2230247
marRp,0.25,3,3,ATTCGGTACAAACGCACACT,0,2230793
marRp,0.25,3,3,ATTCCTTTACATGGAATGGC,0,2225943
marRp,0.25,3,3,ATTCCGCCGCGTGGCCAAAT,0,2258009
marRp,0.25,3,3,ATTCCAGGAGGCAGTCCCTC,0,2225636
marRp,0.25,3,3,ATTCATACGTTTGATCTGAC,0,2255500
marRp,0.25,3,3,ATTCAACCAATCGGCGCGGT,0,2254068
marRp,0.25,3,3,ATTAGCTTCAAGTGGTCAAA,0,2251278
marRp,0.25,3,3,ATTAGAACCCATAAAATCCG,0,2255967
marRp,0.25,3,3,ATGTTTATTTGCGACCCCCC,0,2243830
marRp,0.25,3,3,ATGGGAATACGCAAACCTCC,0,2229274
marRp,0.25,3,3,ATGCATCGGGGCTGAACCAC,0,2225073
marRp,0.25,3,3,ATGCAAGCTTGGGATGGCTA,0,2239061
marRp,0.25,3,3,ATGATTTTCTTATGATCCTT,0,2218048
marRp,0.25,3,3,ATGAGGATCACGTTGCAACG,0,2219267
marRp,0.25,3,3,ATGAGCGTTTTGGGAGCTGA,0,2228552
marRp,0.25,3,3,ATGAGATAGGTACTAAGGGA,0,2222133
marRp,0.25,3,3,ATGACGTGTAGGGAGCGATG,0,2225774
marRp,0.25,3,3,ATGACCCACATTACGTCCAA,0,2250888
marRp,0.25,3,3,ATCTCTGTAAAGTAGGTCAC,0,2235896
marRp,0.25,3,3,ATCTCGGGCGGCGGTTTTTG,0,2246788
marRp,0.25,3,3,ATCTCAATAACATAGACGCC,0,2253811
marRp,0.25,3,3,ATCTAATTGCCGAGCCATCT,0,2224768
marRp,0.25,3,3,ATCGGTCCGTGGACATAAAC,0,2225763
marRp,0.25,3,3,ATCGATTCCAGTCTGATAGG,0,2255093
marRp,0.25,3,3,ATCGATACTCGCTCAGCACT,0,2225014
marRp,0.25,3,3,ATCCGGGCGGCATTCTATCC,0,2229301
marRp,0.25,3,3,ATCCACTTGCTTCGTTCAGA,0,2260178
marRp,0.25,3,3,ATCATGCATGCGGAGCCCGC,0,2239550
marRp,0.25,3,3,ATCAGTGACGTGGATATATG,0,2252182
marRp,0.25,3,3,ATCACGTCGTTCGTCACGCG,0,2218905
marRp,0.25,3,3,ATATGGACTACGACGATTGG,0,2223629
marRp,0.25,3,3,ATATACCCCGTTTATAGCGT,0,2243747
marRp,0.25,3,3,ATATAATACCGGTCGCGCCC,0,2229690
marRp,0.25,3,3,ATAGTACGGGCGTTGTGTAA,0,2238657
marRp,0.25,3,3,ATAGCAACCTGTGGGTTTGC,0,2234904
marRp,0.25,3,3,ATACTAAGGACCTGAATTCT,0,2239287
marRp,0.25,3,3,ATAATTGACCTGTGGGTGGG,0,2244940
marRp,0.25,3,3,ATAATAACGTTTTGGTCCAT,0,2238675
marRp,0.25,3,3,ATAAATGGTATTAATTATCA,0,2223042
marRp,0.25,3,3,ATAAACTTATAGGTCCACGT,0,2258489
marRp,0.25,3,3,AGTTCACCAACATGATAGGA,0,2228875
marRp,0.25,3,3,AGTTCAACTTTCGTACAGAG,0,2248364
marRp,0.25,3,3,AGTTAATGACTATAGACTGA,0,2239311
marRp,0.25,3,3,AGTGGGGTGGTGTTCGATAC,0,2227959
marRp,0.25,3,3,AGTGATGACCCTACAGTAAA,0,2253662
marRp,0.25,3,3,AGTCTTCCGAAAAGCACAGC,0,2259086
marRp,0.25,3,3,AGTAGCTAATGGGTACGACG,0,2225150
marRp,0.25,3,3,AGGTTCATTTCAGAACCTGT,0,2258262
marRp,0.25,3,3,AGGTCCGCCCACTACGGGCT,0,2253885
marRp,0.25,3,3,AGGTATGTATTATATGATTA,0,2256522
marRp,0.25,3,3,AGGGTTGACCGGCGCGCCAG,0,2220450
marRp,0.25,3,3,AGGGGGGAAGGGGCACTCAT,0,2239221
marRp,0.25,3,3,AGGGGAGTCGGACTAACTCT,0,2244717
marRp,0.25,3,3,AGGCTTTGCTAGAATCAACG,0,2238858
marRp,0.25,3,3,AGGCCTAAATCTTAGGCGTT,0,2227585
marRp,0.25,3,3,AGGACGCTGGACTTTGTCCT,0,2249649
marRp,0.25,3,3,AGGAAATTTAGAGTTGACAC,0,2259286
marRp,0.25,3,3,AGCTAGGTTGCCCCGGCAAG,0,2235668
marRp,0.25,3,3,AGCGGGGACTTGTTGCGTAT,0,2247799
marRp,0.25,3,3,AGCGAGCCGTCGGAATAGCA,0,2240772
marRp,0.25,3,3,AGCCCCCTGCCAAGTTGTCT,0,2235470
marRp,0.25,3,3,AGCATTACCTCTCAGCAGCC,0,2253032
marRp,0.25,3,3,AGCAGGTGGGCAGCTCCATG,0,2242796
marRp,0.25,3,3,AGCAAGTAGGCCGTACTCGT,0,2258681
marRp,0.25,3,3,AGATTAGGGTGAGCTCTTCT,0,2229435
marRp,0.25,3,3,AGATATAGTGCGCCCGTCCG,0,2231489
marRp,0.25,3,3,AGAGTCACACAGTGGAGGAT,0,2241062
marRp,0.25,3,3,AGAGCAATTATACTTGTGTG,0,2231010
marRp,0.25,3,3,AGACTGTGAGGGAGGGGCGA,0,2247819
marRp,0.25,3,3,AGACGGGGGACTAGCAATAT,0,2219679
marRp,0.25,3,3,AGACGCTCGTGAACCTCCAC,0,2224335
marRp,0.25,3,3,AGACGCACGACCTTTTGGTG,0,2219141
marRp,0.25,3,3,AGACGAGGCGTCCAGCACTT,0,2252590
marRp,0.25,3,3,AGACCCAGATATGCACTGGG,0,2220135
marRp,0.25,3,3,AGAATGAGTATTTGACTACT,0,2259545
marRp,0.25,3,3,AGAAGGTTTATACCGAGCAT,0,2243248
marRp,0.25,3,3,AGAACCGTACAAGTACGGCT,0,2228572
marRp,0.25,3,3,AGAAAGTCTGATATAGCTTA,0,2224309
marRp,0.25,3,3,ACTTCATGCCGGCCAGGTAT,0,2236433
marRp,0.25,3,3,ACTTATTGATCGTTGTGTAA,0,2223235
marRp,0.25,3,3,ACTGTCATTCAATCGCATCC,0,2246637
marRp,0.25,3,3,ACTGACGGGCCTGGGACGAT,0,2219646
marRp,0.25,3,3,ACTCTATCCCTGGCCCGAGC,0,2260207
marRp,0.25,3,3,ACTCTATAAAGCTGACATGC,0,2246576
marRp,0.25,3,3,ACTAGACTTCGTGGCACTGA,0,2233323
marRp,0.25,3,3,ACTAACGAGTACGGGCGACT,0,2240930
marRp,0.25,3,3,ACGTTGGGAACAGACCCGCG,0,2231559
marRp,0.25,3,3,ACGGTATCCACAGCCACTAA,0,2252459
marRp,0.25,3,3,ACGGGTCATCTCTCGGCGAA,0,2239022
marRp,0.25,3,3,ACGGCCCGGCGCCGTTTTAC,0,2250741
marRp,0.25,3,3,ACGCTCAAGGAGATCTATGT,0,2252228
marRp,0.25,3,3,ACGAATCGCCCACGGATGCT,0,2228018
marRp,0.25,3,3,ACCGAGAGCATATCCGGACC,0,2222736
marRp,0.25,3,3,ACCCCTCCTTATTTAACCAA,0,2236979
marRp,0.25,3,3,ACCAATTGCTTGGGCTCCTG,0,2237064
marRp,0.25,3,3,ACATGTACCAGTCGTGCAGG,0,2238328
marRp,0.25,3,3,ACATGGACAGGTGCAGTTAT,0,2257699
marRp,0.25,3,3,ACATACGACTAAGTCCTTAC,0,2227035
marRp,0.25,3,3,ACAGGTCGTTGGAATCTACA,0,2251268
marRp,0.25,3,3,ACAGGGTTCCTCCTGCGGCG,0,2227827
marRp,0.25,3,3,ACAGCATCACAGAACCGTGT,0,2219359
marRp,0.25,3,3,ACAGATAACAGGTGATTACA,0,2253040
marRp,0.25,3,3,ACAGAGAATATTCACATCGA,0,2244133
marRp,0.25,3,3,ACACTGTACAAACTCCTGAT,0,2246782
marRp,0.25,3,3,ACAACTTACTCCATCTCACC,0,2257108
marRp,0.25,3,3,ACAAATTATGGGGCAAACTG,0,2230702
marRp,0.25,3,3,AATTTTGTTTTACCGATGGT,0,2242057
marRp,0.25,3,3,AATTTTACGAGCCGACATAG,0,2253857
marRp,0.25,3,3,AATTTACTAGACCTTGAAGC,0,2254866
marRp,0.25,3,3,AATGTATGTGATCGAACCGA,0,2242056
marRp,0.25,3,3,AATGGCTCGGCGTGCACACG,0,2232508
marRp,0.25,3,3,AATGCGGGCGATTTAGAGCT,0,2241060
marRp,0.25,3,3,AATGATCCCCACACACATCT,0,2227395
marRp,0.25,3,3,AATGAGTTGTCAAGCGCTCC,0,2221589
marRp,0.25,3,3,AATCGACTTCTAGAAAGGGT,0,2232007
marRp,0.25,3,3,AATCCAATTTATTAAAGTGT,0,2240732
marRp,0.25,3,3,AATCAAGATGCCGACTTAAG,0,2238210
marRp,0.25,3,3,AATAGTCAACGTGAGGTTCT,0,2247080
marRp,0.25,3,3,AATACTCGTTTTTTGTTTGG,0,2230072
marRp,0.25,3,3,AATACTCATGGGATTTCTAA,0,2252562
marRp,0.25,3,3,AATAATTCGTTCGGACGAAA,0,2246743
marRp,0.25,3,3,AAGTTGATCTCAGACACAGT,0,2245489
marRp,0.25,3,3,AAGGTCTCATTTCTGCTGCG,0,2249332
marRp,0.25,3,3,AAGGGCTCCATTAGGTCTGG,0,2238403
marRp,0.25,3,3,AAGGCTAGGGAACAAGTATT,0,2229851
marRp,0.25,3,3,AAGGCGCGGATACCAATGGT,0,2224025
marRp,0.25,3,3,AAGACTCATGGTCGAGGGCA,0,2243622
marRp,0.25,3,3,AAGACGGATAGAATTTGATG,0,2238645
marRp,0.25,3,3,AAGACCTCACGTTTGAGGTT,0,2224162
marRp,0.25,3,3,AAGACCGTCTCAAAGGCGGA,0,2247182
marRp,0.25,3,3,AAGACAATAAGATACTTGCC,0,2258893
marRp,0.25,3,3,AAGAAGGTCAACGGATCGAT,0,2221534
marRp,0.25,3,3,AACTACGGGGCTAACGGAAA,0,2234652
marRp,0.25,3,3,AACGAACGTGAAAGAGATGG,0,2237683
marRp,0.25,3,3,AACACCCACCTTTCTGGCGC,0,2243637
marRp,0.25,3,3,AAATGGGAGATATGTGCAGC,0,2225751
marRp,0.25,3,3,AAATGCACGCTGCACCCATA,0,2253345
marRp,0.25,3,3,AAATCGTACCTGCACTTCAT,0,2218763
marRp,0.25,3,3,AAATAGGATCAGTTACAAGA,0,2235858
marRp,0.25,3,3,AAAGTCTGGAATCTGAGGAC,0,2248031
marRp,0.25,3,3,AAACTATGTCGTACAGTAGT,0,2239423
marRp,0.25,3,3,AAACGAAACGATCATGAGTT,0,2218766
marRp,0.3333333333333333,2,2,TTTTCCCTCTACATTATGAT,0,2222696
marRp,0.3333333333333333,2,2,TTTGTTTAAATGATCGAGTG,0,2241634
marRp,0.3333333333333333,2,2,TTTGTGCTTTATTAATACTC,0,2250892
marRp,0.3333333333333333,2,2,TTTGCGTTAGCTCCGGCATC,0,2225155
marRp,0.3333333333333333,2,2,TTTGACGAGGTAATACAATT,0,2253518
marRp,0.3333333333333333,2,2,TTTCCCCGGTCTTAGGAGAT,0,2218961
marRp,0.3333333333333333,2,2,TTTATCAACGCATGGCGCAA,0,2247889
marRp,0.3333333333333333,2,2,TTTACGAGACGTCCCGTTCG,0,2242681
marRp,0.3333333333333333,2,2,TTTAAGGCGGCATGTCAGGG,0,2237680
marRp,0.3333333333333333,2,2,TTGTTCGAACAGGATAATCT,0,2255683
marRp,0.3333333333333333,2,2,TTGTGTTTTGCATGGACGGA,0,2226695
marRp,0.3333333333333333,2,2,TTGTCTTGTTGTATGTAAGG,0,2253813
marRp,0.3333333333333333,2,2,TTGGTTATCTTCCCCAAAAT,0,2234474
marRp,0.3333333333333333,2,2,TTGGGGGATGGTGCGGGGTG,0,2248264
marRp,0.3333333333333333,2,2,TTGGGCGATCAAACAGCTGT,0,2248302
marRp,0.3333333333333333,2,2,TTGCTAATTGGTGAAAGTCA,0,2242906
marRp,0.3333333333333333,2,2,TTGCGGGCTACCCAGTTGAT,0,2242825
marRp,0.3333333333333333,2,2,TTGAGGGAGTTTGAGGTCTA,0,2236399
marRp,0.3333333333333333,2,2,TTCTGCAGCTCGGGAAAATA,0,2231462
marRp,0.3333333333333333,2,2,TTCTACGCAGGTTATACGCA,0,2258095
marRp,0.3333333333333333,2,2,TTCGGTGAAACTTGGCCCGG,0,2251985
marRp,0.3333333333333333,2,2,TTCGGGACGACTACCTCACT,0,2243598
marRp,0.3333333333333333,2,2,TTCGCATCTATTTGATGAAT,0,2237706
marRp,0.3333333333333333,2,2,TTCGAAGGTGATATTCCGCT,0,2234955
marRp,0.3333333333333333,2,2,TTCCTTTGCGCCGGATACAG,0,2231453
marRp,0.3333333333333333,2,2,TTCCTGTCGGGCAGCTGCGC,0,2229378
marRp,0.3333333333333333,2,2,TTCCTACTAACTCACACGTT,0,2230995
marRp,0.3333333333333333,2,2,TTCCGTCATCAGAGCCCGTA,0,2240831
marRp,0.3333333333333333,2,2,TTCCACCTCATACGGGGCCA,0,2244439
marRp,0.3333333333333333,2,2,TTCCAAACGAGACAGCCCTG,0,2249948
marRp,0.3333333333333333,2,2,TTCAGTTGCATGAAAACGGG,0,2240702
marRp,0.3333333333333333,2,2,TTCACCGTTCCTCGAGCATC,0,2244494
marRp,0.3333333333333333,2,2,TTCAAACGCAATTCATTTCT,0,2237213
marRp,0.3333333333333333,2,2,TTATTCAAGATGTCGTCTCT,0,2258634
marRp,0.3333333333333333,2,2,TTATCTGGCGGCGACGGAGG,0,2246769
marRp,0.3333333333333333,2,2,TTATAGGCAGATGCCGCGAT,0,2237151
marRp,0.3333333333333333,2,2,TTATACTAGCCCAACGAAGA,0,2251325
marRp,0.3333333333333333,2,2,TTAGTTCCTAGTTAGTTGTT,0,2247876
marRp,0.3333333333333333,2,2,TTAGCTCCGGTCAGAGTTAA,0,2239918
marRp,0.3333333333333333,2,2,TTAGATCAATGGGCTGTTCA,0,2222486
marRp,0.3333333333333333,2,2,TTACTGTTGTAGTCGGGTTA,0,2254124
marRp,0.3333333333333333,2,2,TTACTCTTTCAGGATATTAT,0,2234385
marRp,0.3333333333333333,2,2,TTACAGCCAGGGGGCAAGGA,0,2242014
marRp,0.3333333333333333,2,2,TTAATGAGAAGAGGGACTAA,0,2219148
marRp,0.3333333333333333,2,2,TTAAACGCTGACTGGCCTGA,0,2242047
marRp,0.3333333333333333,2,2,TTAAAAGTGGCTGCTAACAT,0,2246644
marRp,0.3333333333333333,2,2,TGTTTGCTAAGTTAGCTCTC,0,2235734
marRp,0.3333333333333333,2,2,TGTTCTGGCAGGACAAATAA,0,2240194
marRp,0.3333333333333333,2,2,TGTTCTATATATTTGCGCTA,0,2247350
marRp,0.3333333333333333,2,2,TGTGTTAGCGGCTTGTCGAG,0,2240877
marRp,0.3333333333333333,2,2,TGTGATTCTGCACAGTTCGA,0,2258772
marRp,0.3333333333333333,2,2,TGTCTCTATGTATGGGCAGA,0,2229997
marRp,0.3333333333333333,2,2,TGTCCTAAGCCAGCTTAGAC,0,2254145
marRp,0.3333333333333333,2,2,TGTCCATGGTGTCCCGTCAC,0,2238781
marRp,0.3333333333333333,2,2,TGTCCAATTTTCGAAAACAG,0,2238284
marRp,0.3333333333333333,2,2,TGTAACTGGGTGGGCCATAT,0,2252090
marRp,0.3333333333333333,2,2,TGTAACCTGCCTGGGATTCT,0,2256897
marRp,0.3333333333333333,2,2,TGGTCCTTATAAATTTATCA,0,2225184
marRp,0.3333333333333333,2,2,TGGTATTTTGAGGCAGGAAA,0,2257129
marRp,0.3333333333333333,2,2,TGGTACCCCCCCGATTCGTC,0,2235991
marRp,0.3333333333333333,2,2,TGGGTGGTACAGTGTGCAAC,0,2225293
marRp,0.3333333333333333,2,2,TGGGATTCTTTTCAGAGCGT,0,2243175
marRp,0.3333333333333333,2,2,TGGGAGGAAACCCGCTCCAC,0,2233529
marRp,0.3333333333333333,2,2,TGGGAAGCATATATTAAGGA,0,2236159
marRp,0.3333333333333333,2,2,TGGCGGGCCTCATCAGGGGA,0,2253359
marRp,0.3333333333333333,2,2,TGGCGCAACGTCAGGACTCT,0,2220453
marRp,0.3333333333333333,2,2,TGGAGCGAGTTTAGAGGGCG,0,2217855
marRp,0.3333333333333333,2,2,TGGACTTTTTAGGAGTCAAG,0,2258114
marRp,0.3333333333333333,2,2,TGGACGGGATCCCGATATCG,0,2219505
marRp,0.3333333333333333,2,2,TGGAATCCGCACGTGCACCT,0,2224218
marRp,0.3333333333333333,2,2,TGCTTAACATCGGTTGGACG,0,2248820
marRp,0.3333333333333333,2,2,TGCTGAGATAATATGTTAAG,0,2255941
marRp,0.3333333333333333,2,2,TGCTCCTCAGAGTATGGCAT,0,2238214
marRp,0.3333333333333333,2,2,TGCCTTTACGTGGTTCCATA,0,2232526
marRp,0.3333333333333333,2,2,TGCCAGCGACACTCACGACA,0,2252066
marRp,0.3333333333333333,2,2,TGCCACATTGCGTCTCCAGC,0,2225112
marRp,0.3333333333333333,2,2,TGCATTCCCTCTGGCACCTC,0,2242178
marRp,0.3333333333333333,2,2,TGCAATTTATGGATAGTTAG,0,2259379
marRp,0.3333333333333333,2,2,TGAGTCAATCTAACTCCCAA,0,2223500
marRp,0.3333333333333333,2,2,TGACACAAGAAAAGACTGGC,0,2228735
marRp,0.3333333333333333,2,2,TGAACACGTGAGCGCTTGGA,0,2219231
marRp,0.3333333333333333,2,2,TCTTCTATATATTTGCGCTA,0,2247327
marRp,0.3333333333333333,2,2,TCTTCGGTGAAATACAGTAT,0,2218796
marRp,0.3333333333333333,2,2,TCTCTGGATAATTAAGCGTG,0,2233893
marRp,0.3333333333333333,2,2,TCTACGGCAAAGCCGTATCG,0,2248385
marRp,0.3333333333333333,2,2,TCGTTTCACGTCATTCTCAT,0,2257438
marRp,0.3333333333333333,2,2,TCGGCGGCCGACAGGATCCA,0,2236468
marRp,0.3333333333333333,2,2,TCGCTTGGGTTACGTGCCGG,0,2221662
marRp,0.3333333333333333,2,2,TCGCTCGGATACTTCTGTTT,0,2225924
marRp,0.3333333333333333,2,2,TCGCATCATTTTCGTGGTGC,0,2229428
marRp,0.3333333333333333,2,2,TCGCACACCGCAAGGCGGAA,0,2247440
marRp,0.3333333333333333,2,2,TCGCAAAATCAGATATGACT,0,2245709
marRp,0.3333333333333333,2,2,TCGAGTGATTGGTTTTAAAT,0,2235126
marRp,0.3333333333333333,2,2,TCGAGTACCAAGACTTTGCA,0,2225719
marRp,0.3333333333333333,2,2,TCGAGCGTAGCCGGTGCTCA,0,2237735
marRp,0.3333333333333333,2,2,TCGAAGTTTTCTTGGGCATT,0,2260274
marRp,0.3333333333333333,2,2,TCGAACGAGTCTGCCCGGTA,0,2232232
marRp,0.3333333333333333,2,2,TCCTTGAAGGCATGTAATTC,0,2228299
marRp,0.3333333333333333,2,2,TCCTTATAAAAAGGCCCGCA,0,2220342
marRp,0.3333333333333333,2,2,TCCTGCTGAGTCTGATCTCC,0,2254453
marRp,0.3333333333333333,2,2,TCCTGATACAGGGCCGCAAC,0,2237227
marRp,0.3333333333333333,2,2,TCCTCGCCTCGTAACTCAAG,0,2245390
marRp,0.3333333333333333,2,2,TCCGGTGTGACAACCGACGG,0,2256137
marRp,0.3333333333333333,2,2,TCCGGAACGCCCGGAAAGGG,0,2240667
marRp,0.3333333333333333,2,2,TCCGACCGCGTGCGGTTGGT,0,2259166
marRp,0.3333333333333333,2,2,TCCCTCGAACGCGACCGACA,0,2235457
marRp,0.3333333333333333,2,2,TCCCGTGCATGATTTCTAAG,0,2224323
marRp,0.3333333333333333,2,2,TCCATTGTGCAGTTTTACGA,0,2218185
marRp,0.3333333333333333,2,2,TCCATCGCGCTCATAGACTC,0,2217891
marRp,0.3333333333333333,2,2,TCATCAGGGTTTCGTGTAAG,0,2250949
marRp,0.3333333333333333,2,2,TCAGTTTTTAAGGATATACC,0,2255175
marRp,0.3333333333333333,2,2,TCAGGACTAATCGTATGGTT,0,2239606
marRp,0.3333333333333333,2,2,TCAGCATTTCAAAATTCATT,0,2235777
marRp,0.3333333333333333,2,2,TCACTTTTAGAGCATCTCGG,0,2242713
marRp,0.3333333333333333,2,2,TCACGTTGGCTTTCTCCGTT,0,2244064
marRp,0.3333333333333333,2,2,TCACGCGTAGCCCCCTACTC,0,2226870
marRp,0.3333333333333333,2,2,TATTGGAGAATTTGGTCCTT,0,2255675
marRp,0.3333333333333333,2,2,TATGTTAGCTTGCGGAACAA,0,2234166
marRp,0.3333333333333333,2,2,TATGAAGCACACGAAAAGGA,0,2227181
marRp,0.3333333333333333,2,2,TATGAAATAGAGTAATCGGT,0,2252354
marRp,0.3333333333333333,2,2,TATCGGTTATAGTCAGCGTT,0,2234198
marRp,0.3333333333333333,2,2,TATATAATAATCATATTCCT,0,2255430
marRp,0.3333333333333333,2,2,TATAGGCCACTAACATCGGC,0,2229328
marRp,0.3333333333333333,2,2,TATAGCGCCGCATTGGGAGG,0,2233937
marRp,0.3333333333333333,2,2,TATAGAATCCTCGTTTCACA,0,2235120
marRp,0.3333333333333333,2,2,TATACGCTGGAACGCGCCAC,0,2249935
marRp,0.3333333333333333,2,2,TAGCTGGCCAGTATTAACAA,0,2258478
marRp,0.3333333333333333,2,2,TAGCTAAGACCGCCGTATAA,0,2223486
marRp,0.3333333333333333,2,2,TAGATGGGCCGCATTTCACA,0,2236417
marRp,0.3333333333333333,2,2,TAGAGTTTCCGCATGTGGGC,0,2232217
marRp,0.3333333333333333,2,2,TAGAATTGCCGGCGTGGTAC,0,2231729
marRp,0.3333333333333333,2,2,TACTTGGGGTGTTGACCGAA,0,2259604
marRp,0.3333333333333333,2,2,TACTTAACTACAGAGGCAAG,0,2257078
marRp,0.3333333333333333,2,2,TACTGGGTCCGAAATGTCGT,0,2231616
marRp,0.3333333333333333,2,2,TACTGCGTTCCGGGATTGAG,0,2228835
marRp,0.3333333333333333,2,2,TACTGAATGCGAAAAATATA,0,2234601
marRp,0.3333333333333333,2,2,TACGGTTAATATGCTGCCCG,0,2252487
marRp,0.3333333333333333,2,2,TACGGGGGATGGCATATGCG,0,2258300
marRp,0.3333333333333333,2,2,TACGCGTAATGCAAAGTTTC,0,2260245
marRp,0.3333333333333333,2,2,TACGATTTGTGTTGAGCGGC,0,2234948
marRp,0.3333333333333333,2,2,TACCGCAACGGGAAAAATGT,0,2255725
marRp,0.3333333333333333,2,2,TACATCCCGCAAGTGTAGGA,0,2235173
marRp,0.3333333333333333,2,2,TACAGTTGTACAAGTAGCGG,0,2230791
marRp,0.3333333333333333,2,2,TACAGGATCTCAGGCCGCGA,0,2231218
marRp,0.3333333333333333,2,2,TACACGCCACAACTTTGTGT,0,2243299
marRp,0.3333333333333333,2,2,TACACAGGGGATCTGTTATA,0,2239141
marRp,0.3333333333333333,2,2,TACAAGTAGGTCTTTAGGGG,0,2250815
marRp,0.3333333333333333,2,2,TACAAACCACGGGCTTCGCC,0,2219481
marRp,0.3333333333333333,2,2,TAATTTAGTTTATACTTGCC,0,2230177
marRp,0.3333333333333333,2,2,TAATTGCTATCTACACATTG,0,2246754
marRp,0.3333333333333333,2,2,TAATCTTATCGCAGGCTCCG,0,2224409
marRp,0.3333333333333333,2,2,TAAGGAGGCAGCACGATATT,0,2218479
marRp,0.3333333333333333,2,2,TAAGCATTCTCAAGAGCATA,0,2232763
marRp,0.3333333333333333,2,2,TAACTAGGGACCCGAGATAA,0,2245281
marRp,0.3333333333333333,2,2,TAACGGCACGCAGGCGTGTA,0,2239781
marRp,0.3333333333333333,2,2,TAACCTATCGGTTTAAGATG,0,2248288
marRp,0.3333333333333333,2,2,TAAAATAATTTAGAAGTGAA,0,2222450
marRp,0.3333333333333333,2,2,TAAAAAGCGACGTTCTTACT,0,2247185
marRp,0.3333333333333333,2,2,GTTTGTACAAGTTTTATATG,0,2258115
marRp,0.3333333333333333,2,2,GTTTAGACCTTATTTGTACT,0,2252503
marRp,0.3333333333333333,2,2,GTTTACGAATGAAGAGTCGG,0,2228551
marRp,0.3333333333333333,2,2,GTTTACAGTTGAGGACCGGC,0,2218978
marRp,0.3333333333333333,2,2,GTTTAAAGAGTGCCTGATGA,0,2246949
marRp,0.3333333333333333,2,2,GTTGTACGTCTATGTATCCT,0,2242712
marRp,0.3333333333333333,2,2,GTTGGTCAACGGGCAACAAA,0,2232608
marRp,0.3333333333333333,2,2,GTTGGATCTTCCGTTAAGCA,0,2261052
marRp,0.3333333333333333,2,2,GTTGATTTAACTAGCATGCA,0,2236200
marRp,0.3333333333333333,2,2,GTTGATTAGTTGCGAGCAGA,0,2226913
marRp,0.3333333333333333,2,2,GTTCGTTAGTCGTCAAGGGC,0,2220666
marRp,0.3333333333333333,2,2,GTTCGGGTAATGAGGCTCCC,0,2248048
marRp,0.3333333333333333,2,2,GTTCGACGTAGGGACCCACC,0,2251999
marRp,0.3333333333333333,2,2,GTTCCACCGCGCACTTTCCA,0,2249920
marRp,0.3333333333333333,2,2,GTTCATGTTCAAATGATGGA,0,2252807
marRp,0.3333333333333333,2,2,GTTCAGCTTGAGCCTACACA,0,2252166
marRp,0.3333333333333333,2,2,GTTCAATAGCCGATGCCCGA,0,2242579
marRp,0.3333333333333333,2,2,GTGTTTCTAACACTATCACA,0,2241464
marRp,0.3333333333333333,2,2,GTGTTAAACGGTTTCCTCGT,0,2232400
marRp,0.3333333333333333,2,2,GTGGATGAGGGACAATGAAC,0,2220465
marRp,0.3333333333333333,2,2,GTGGACGCCGTGCAGCTACC,0,2233329
marRp,0.3333333333333333,2,2,GTGCGTGACCTCGTCTCGCT,0,2230020
marRp,0.3333333333333333,2,2,GTGCCGCTCCTATCATCCTT,0,2219221
marRp,0.3333333333333333,2,2,GTGATTGGGTTCCGAATATG,0,2227050
marRp,0.3333333333333333,2,2,GTGATGGGTGTAACGTCTGA,0,2254377
marRp,0.3333333333333333,2,2,GTGAGGTCTTTTTGAGGTTC,0,2233040
marRp,0.3333333333333333,2,2,GTGAGACATTTAGACCCCAA,0,2241731
marRp,0.3333333333333333,2,2,GTCTTCTCCTTTCATTCCCC,0,2253716
marRp,0.3333333333333333,2,2,GTCTCCAGGGTAATCCCTTG,0,2238279
marRp,0.3333333333333333,2,2,GTCTAGCCTTACCATGGCTC,0,2222936
marRp,0.3333333333333333,2,2,GTCGTGAGAATGCAGTAAGT,0,2239283
marRp,0.3333333333333333,2,2,GTCGTCTGAGACGTCGAGAA,0,2247846
marRp,0.3333333333333333,2,2,GTCGGTTGCAGTTAAGGGTA,0,2239977
marRp,0.3333333333333333,2,2,GTCGCCCGTCATTCACCCCG,0,2235627
marRp,0.3333333333333333,2,2,GTCGCCAGGGCGGCGGCGTG,0,2245351
marRp,0.3333333333333333,2,2,GTCCTGGACCAATCTCTGGT,0,2220805
marRp,0.3333333333333333,2,2,GTCCATTAAGACGGGGGGAG,0,2247126
marRp,0.3333333333333333,2,2,GTCCAGATGGGAGAAAAGAC,0,2247946
marRp,0.3333333333333333,2,2,GTCCAGACGCACTGGGACCT,0,2218656
marRp,0.3333333333333333,2,2,GTCATCTGAAACGGTCAGCT,0,2226726
marRp,0.3333333333333333,2,2,GTCACGAGTGGTATAGGGGG,0,2254310
marRp,0.3333333333333333,2,2,GTCAACGCGTTAACCCTGAT,0,2258196
marRp,0.3333333333333333,2,2,GTCAAAGATGACTCTATCAC,0,2251666
marRp,0.3333333333333333,2,2,GTATGTCCAGCCACCCTTGA,0,2226549
marRp,0.3333333333333333,2,2,GTATGGCATTGGGTCCAGTA,0,2241460
marRp,0.3333333333333333,2,2,GTATCCGAATGAAAGGCCCA,0,2249257
marRp,0.3333333333333333,2,2,GTATAACGTACTCCGGTAAA,0,2252606
marRp,0.3333333333333333,2,2,GTAGTATCCAGGTCGAGCTT,0,2236754
marRp,0.3333333333333333,2,2,GTAGATCAAGAGCAGGCTCG,0,2246543
marRp,0.3333333333333333,2,2,GTACTCAAAGGTAAGGAGAA,0,2244059
marRp,0.3333333333333333,2,2,GTACCCGCTTACAGCAAATT,0,2218370
marRp,0.3333333333333333,2,2,GTAATATCGTTGATCGGGAG,0,2241370
marRp,0.3333333333333333,2,2,GTAAGGGTTGATTCGGGTCT,0,2231233
marRp,0.3333333333333333,2,2,GTAACCTTGGCCGAGAGGCA,0,2240428
marRp,0.3333333333333333,2,2,GGTTTGCGTGGGTCCTTTAT,0,2223274
marRp,0.3333333333333333,2,2,GGTTTAGGCAGCGTCCAGAC,0,2246612
marRp,0.3333333333333333,2,2,GGTTGTTTCGGTTTGTAGTT,0,2253169
marRp,0.3333333333333333,2,2,GGTTGCACTCACGATGGTAG,0,2250203
marRp,0.3333333333333333,2,2,GGTGCATACATTGCTGGCAG,0,2220427
marRp,0.3333333333333333,2,2,GGTGCACAAACTATCGTGTC,0,2224977
marRp,0.3333333333333333,2,2,GGTCGCACACTCCCACTCAC,0,2246737
marRp,0.3333333333333333,2,2,GGTCAAGGACATTTATAGGT,0,2226358
marRp,0.3333333333333333,2,2,GGTATTAGATGTCAGTACAT,0,2232495
marRp,0.3333333333333333,2,2,GGTATAGGTATTAGCGAGAA,0,2231204
marRp,0.3333333333333333,2,2,GGTAGTGGGTACGATTGTCG,0,2232622
marRp,0.3333333333333333,2,2,GGGTGGTTAGGACCTGTGGC,0,2249968
marRp,0.3333333333333333,2,2,GGGGGTCCTCCGGACGGGTT,0,2231985
marRp,0.3333333333333333,2,2,GGGGGGAAGATACAATAGGG,0,2244376
marRp,0.3333333333333333,2,2,GGGGCACGCGGACTGACTAA,0,2221509
marRp,0.3333333333333333,2,2,GGGGAAGTAGTGATCCACTA,0,2233330
marRp,0.3333333333333333,2,2,GGGCTCGTCGTTCCCCTTGA,0,2225955
marRp,0.3333333333333333,2,2,GGGCTCGGGTAACTGAGCCT,0,2218876
marRp,0.3333333333333333,2,2,GGGCGTGTGTGCATGTGCGG,0,2234199
marRp,0.3333333333333333,2,2,GGGCCAGATAGTTAACTACC,0,2230878
marRp,0.3333333333333333,2,2,GGGCCAACCCGTTCGCACCT,0,2226787
marRp,0.3333333333333333,2,2,GGGATATTCGTCGGCTATTT,0,2246685
marRp,0.3333333333333333,2,2,GGGAAACCAGGGCACCGTTC,0,2217894
marRp,0.3333333333333333,2,2,GGCTGAAGCGATGTTTCTGC,0,2242914
marRp,0.3333333333333333,2,2,GGCCTATTATCGTCGGTGAT,0,2223762
marRp,0.3333333333333333,2,2,GGCCTATGCATAAGAGCTAA,0,2226699
marRp,0.3333333333333333,2,2,GGCACTGAAGGGGCACGGGT,0,2225765
marRp,0.3333333333333333,2,2,GGCACGCAGAGATGGGATCC,0,2221041
marRp,0.3333333333333333,2,2,GGATCTGTCCACAGAAACTA,0,2258016
marRp,0.3333333333333333,2,2,GGATCAGGCTAATAGGAAGA,0,2244387
marRp,0.3333333333333333,2,2,GGATATATTAAACGTATTGT,0,2241126
marRp,0.3333333333333333,2,2,GGAGTTAGTATAAACTAGGT,0,2258492
marRp,0.3333333333333333,2,2,GGAGGCTTAATTTGAGCCCT,0,2248280
marRp,0.3333333333333333,2,2,GGAGCACACCAGGGGTTGGT,0,2227747
marRp,0.3333333333333333,2,2,GGAGAGAAAATCGCAGCGAC,0,2239627
marRp,0.3333333333333333,2,2,GGACGTGTAGCCGTGCTGAC,0,2239233
marRp,0.3333333333333333,2,2,GGAATTAATTTTCGAAGTAG,0,2241878
marRp,0.3333333333333333,2,2,GGAATCAGCAGCCGCGAAAG,0,2222981
marRp,0.3333333333333333,2,2,GGAAGTGTAGCATGAGATCA,0,2233928
marRp,0.3333333333333333,2,2,GGAACCAGACACGTTATGAT,0,2220929
marRp,0.3333333333333333,2,2,GCTTTAATCTCTTCGTTCCA,0,2224283
marRp,0.3333333333333333,2,2,GCTTAAAACGGACTTCTGGT,0,2258334
marRp,0.3333333333333333,2,2,GCTGTCGAGCATCCTGTGGT,0,2258338
marRp,0.3333333333333333,2,2,GCTGGTGGGTGTAGAATGAT,0,2232472
marRp,0.3333333333333333,2,2,GCTGGTAATGGACTTCGTAG,0,2243066
marRp,0.3333333333333333,2,2,GCTGCACGGTCTGTGCCGAA,0,2236454
marRp,0.3333333333333333,2,2,GCTGATTGATCTACATTTTT,0,2246294
marRp,0.3333333333333333,2,2,GCTGAGCACACAACCTATGA,0,2218163
marRp,0.3333333333333333,2,2,GCTGAACGCTCATGGTACAA,0,2244341
marRp,0.3333333333333333,2,2,GCTCTGGCCGTTTTACGAGC,0,2256607
marRp,0.3333333333333333,2,2,GCTCTATTATTTAGATGCCA,0,2242109
marRp,0.3333333333333333,2,2,GCTCCGCCTTCAATACTATT,0,2255254
marRp,0.3333333333333333,2,2,GCTCATTGTGAACTTGTGAG,0,2260435
marRp,0.3333333333333333,2,2,GCTCATCCCATGCCAGGTAA,0,2251529
marRp,0.3333333333333333,2,2,GCTCACGTTACGCCGTAGTT,0,2260742
marRp,0.3333333333333333,2,2,GCTACTCAAGCAACGGGACG,0,2224134
marRp,0.3333333333333333,2,2,GCGTTCACTCATGGAATGGT,0,2249439
marRp,0.3333333333333333,2,2,GCGTGCGGCTCGAGAACCCT,0,2239898
marRp,0.3333333333333333,2,2,GCGGTGTTAGAACTCAAAAC,0,2236194
marRp,0.3333333333333333,2,2,GCGGTAATGGTTAGACGGGA,0,2223444
marRp,0.3333333333333333,2,2,GCGGGTCTGGAAAGGTCCAT,0,2241021
marRp,0.3333333333333333,2,2,GCGGGCTCCCTGGCCGGCCC,0,2220625
marRp,0.3333333333333333,2,2,GCGGCAGGGGGGCGGGTCTG,0,2247833
marRp,0.3333333333333333,2,2,GCGGATACACATGTAAAAAA,0,2236939
marRp,0.3333333333333333,2,2,GCGATATGTTTCGATGATGA,0,2252497
marRp,0.3333333333333333,2,2,GCGAGTAGACTCTCTCCCCA,0,2252005
marRp,0.3333333333333333,2,2,GCGACCCCTATAGGATCTCT,0,2219109
marRp,0.3333333333333333,2,2,GCGACAGTATACCAGGACAT,0,2257164
marRp,0.3333333333333333,2,2,GCCTTTTACGGTCCAGTGAG,0,2247150
marRp,0.3333333333333333,2,2,GCCTTGATAGTCGGATGACG,0,2239185
marRp,0.3333333333333333,2,2,GCCTCGGTTCGGCGACGATA,0,2243518
marRp,0.3333333333333333,2,2,GCCGTTGTTGAGATGCGGTC,0,2260314
marRp,0.3333333333333333,2,2,GCCGTTGGTCAGACGGTTTA,0,2249306
marRp,0.3333333333333333,2,2,GCCGTGGTGCCGGGGCCGGA,0,2223464
marRp,0.3333333333333333,2,2,GCCGTAAATCACCTCGCCTC,0,2230760
marRp,0.3333333333333333,2,2,GCCGCAAGACCATATGCTGG,0,2237597
marRp,0.3333333333333333,2,2,GCCGACAGATGGGCCAGCTA,0,2259584
marRp,0.3333333333333333,2,2,GCCCTACAGGGAGGCGGTGA,0,2248103
marRp,0.3333333333333333,2,2,GCCCGCGTAGGACCTTACAG,0,2251105
marRp,0.3333333333333333,2,2,GCATGGCCAGTGTGTAGCCA,0,2236697
marRp,0.3333333333333333,2,2,GCATCGATGGCGGTTATCCT,0,2227216
marRp,0.3333333333333333,2,2,GCAGTTGTCATCTAAGCGTA,0,2241732
marRp,0.3333333333333333,2,2,GCACATTCACCGGCTTAGGG,0,2251376
marRp,0.3333333333333333,2,2,GCAAGGGCGACGTGTCATAC,0,2232589
marRp,0.3333333333333333,2,2,GCAACGCGCTCTAGCAGATC,0,2249299
marRp,0.3333333333333333,2,2,GATTGGGAACGACGCGTGAT,0,2223526
marRp,0.3333333333333333,2,2,GATTACAATAGCCTACGGAC,0,2242144
marRp,0.3333333333333333,2,2,GATTAAGGTCGTGGAATTGT,0,2236744
marRp,0.3333333333333333,2,2,GATGGTCGGTCCAGTCTATT,0,2253157
marRp,0.3333333333333333,2,2,GATGGATGTAACATTAGAAT,0,2221074
marRp,0.3333333333333333,2,2,GATGCCCCGCCAGGGAAACC,0,2243657
marRp,0.3333333333333333,2,2,GATGCAGACCTAATGGGTGA,0,2239301
marRp,0.3333333333333333,2,2,GAGTTATGAGGCAATGGGCA,0,2219119
marRp,0.3333333333333333,2,2,GAGTTAATTGAAACACACGT,0,2255347
marRp,0.3333333333333333,2,2,GAGTCGCCCATGCAGTCTGC,0,2245889
marRp,0.3333333333333333,2,2,GAGTACTACCGCGCGCCACT,0,2235370
marRp,0.3333333333333333,2,2,GAGGTGGTCTAAGGCAGGTG,0,2239838
marRp,0.3333333333333333,2,2,GAGGCATGGACAATATCTCG,0,2250114
marRp,0.3333333333333333,2,2,GAGCTCCTGCAGACGATCTT,0,2235082
marRp,0.3333333333333333,2,2,GAGCGAGTTGTTATGGGCCT,0,2260161
marRp,0.3333333333333333,2,2,GAGCACCGACATTTGTGGAT,0,2223565
marRp,0.3333333333333333,2,2,GAGAGTAGGTATAATATGCA,0,2261071
marRp,0.3333333333333333,2,2,GAGAGGCTTGTACCTCCATT,0,2245293
marRp,0.3333333333333333,2,2,GACGTAGAAGGAGGGACGAG,0,2235767
marRp,0.3333333333333333,2,2,GACCCCTGCGAGTACGGCGG,0,2258785
marRp,0.3333333333333333,2,2,GACCCAGCTACATCCCTTCC,0,2218764
marRp,0.3333333333333333,2,2,GACAGCACCCAGTCAAGTTG,0,2224239
marRp,0.3333333333333333,2,2,GACAAGCCGAGTGCCGCATG,0,2233631
marRp,0.3333333333333333,2,2,GACAAGATCTCCATGAGAAG,0,2234781
marRp,0.3333333333333333,2,2,GACAAACCTCGTATACCGCT,0,2247892
marRp,0.3333333333333333,2,2,GAATCTTTGTTATTTTTCAT,0,2257960
marRp,0.3333333333333333,2,2,GAAGGCCTCCGCGAATCATT,0,2228606
marRp,0.3333333333333333,2,2,GAAGGCATCTAGCGAGCATT,0,2254510
marRp,0.3333333333333333,2,2,GAACGGTACGTGGAACTGAA,0,2257349
marRp,0.3333333333333333,2,2,GAACCTATTGCACTGAGGGC,0,2224547
marRp,0.3333333333333333,2,2,GAAATTGGCAATCAACTCAC,0,2252209
marRp,0.3333333333333333,2,2,GAAATCAGACTGTAGCCGCT,0,2225607
marRp,0.3333333333333333,2,2,GAAACACACTTCGAACCCAA,0,2236971
marRp,0.3333333333333333,2,2,GAAACAAGAGTTAGGAACGA,0,2243924
marRp,0.3333333333333333,2,2,GAAAAGGGCCTCTGAATCGG,0,2217813
marRp,0.3333333333333333,2,2,CTTTGTTTTGGTGCTGCCTA,0,2258131
marRp,0.3333333333333333,2,2,CTTTGCTATTAATGAAGTGG,0,2249238
marRp,0.3333333333333333,2,2,CTTTCCAGAGGAGCGGGACA,0,2252250
marRp,0.3333333333333333,2,2,CTTGGACCCAATCCGAGCGC,0,2217927
marRp,0.3333333333333333,2,2,CTTGCTTTTATAAGTAGTTC,0,2239787
marRp,0.3333333333333333,2,2,CTTGATCTCGTTCCAGAAGC,0,2258637
marRp,0.3333333333333333,2,2,CTTCTCCACAATATGACAGC,0,2248922
marRp,0.3333333333333333,2,2,CTTCAGCGGTTGTCGGACGT,0,2234524
marRp,0.3333333333333333,2,2,CTTATCGACAGAAAAAAGGA,0,2232937
marRp,0.3333333333333333,2,2,CTTAAATTAGTTGTAGGGCT,0,2226929
marRp,0.3333333333333333,2,2,CTGTCTTCCAAAGTAAGCGC,0,2231528
marRp,0.3333333333333333,2,2,CTGTATGACAATGTAATCTT,0,2218649
marRp,0.3333333333333333,2,2,CTGGCATCCAGCGTTACGCT,0,2237774
marRp,0.3333333333333333,2,2,CTGCGGTAATCTCCCAGGAG,0,2239183
marRp,0.3333333333333333,2,2,CTGCCTAGAGAATAGTTAAG,0,2229043
marRp,0.3333333333333333,2,2,CTGCATGATAGGCTGGCGAT,0,2235712
marRp,0.3333333333333333,2,2,CTCTTTCCACTAAGGGTCAT,0,2239851
marRp,0.3333333333333333,2,2,CTCTTGATTTTAGAGACCTT,0,2218273
marRp,0.3333333333333333,2,2,CTCTTGACCGCGACTACAGG,0,2226262
marRp,0.3333333333333333,2,2,CTCTGTACATAAGGAGGCAA,0,2259974
marRp,0.3333333333333333,2,2,CTCTCAGTAAAAGATCTAAA,0,2243503
marRp,0.3333333333333333,2,2,CTCTATTGCGCGAGCATGTA,0,2246744
marRp,0.3333333333333333,2,2,CTCTAAGTCCGCACAGCGTA,0,2236207
marRp,0.3333333333333333,2,2,CTCGGTCTTCAGTTAGGATT,0,2227800
marRp,0.3333333333333333,2,2,CTCGGCTTGTACTACGAGGT,0,2249722
marRp,0.3333333333333333,2,2,CTCGCGAGAGATTCGCTTCC,0,2251344
marRp,0.3333333333333333,2,2,CTCGAGGCGCAGGGATGTTG,0,2234071
marRp,0.3333333333333333,2,2,CTCCTGCGGATTTGTCGATT,0,2224176
marRp,0.3333333333333333,2,2,CTCCGGTGTTGATAAACAAT,0,2222701
marRp,0.3333333333333333,2,2,CTCCCTAACAACCCCCATGT,0,2239540
marRp,0.3333333333333333,2,2,CTCCCGCGGTTCAAAGAACC,0,2245912
marRp,0.3333333333333333,2,2,CTCAGGTAATCGGTTACACT,0,2230681
marRp,0.3333333333333333,2,2,CTCAGCGCATATGTGCTGCC,0,2228925
marRp,0.3333333333333333,2,2,CTCACAGACATCTTGTGCGG,0,2252629
marRp,0.3333333333333333,2,2,CTATTTTTGTGCTAATCGTG,0,2246081
marRp,0.3333333333333333,2,2,CTATGCTTGGGTAGTGTCCG,0,2226118
marRp,0.3333333333333333,2,2,CTATGCTGGGTGATGTGATG,0,2247540
marRp,0.3333333333333333,2,2,CTATGCTGACTTCCTACCCG,0,2235836
marRp,0.3333333333333333,2,2,CTAGGGGCATATCCTCCATT,0,2231040
marRp,0.3333333333333333,2,2,CTAGAGCTCGTCTATTCGGA,0,2235464
marRp,0.3333333333333333,2,2,CTACATTGGTATCCACCTGC,0,2220598
marRp,0.3333333333333333,2,2,CTACACCGGCCTCTGTCCCA,0,2223004
marRp,0.3333333333333333,2,2,CTAAGACGAAGCAAAGGGCG,0,2220886
marRp,0.3333333333333333,2,2,CTAAAGCGTTAAGCGACGGG,0,2258223
marRp,0.3333333333333333,2,2,CGTTTCTGTTTAACATGACA,0,2241042
marRp,0.3333333333333333,2,2,CGTTGAAGAGGAGTAATGCG,0,2238067
marRp,0.3333333333333333,2,2,CGTTATCGAAACCCCGCTGT,0,2245616
marRp,0.3333333333333333,2,2,CGTGTCTGCCCTGGAGCTAT,0,2235156
marRp,0.3333333333333333,2,2,CGTGTATCAGTACCTATCTT,0,2246407
marRp,0.3333333333333333,2,2,CGTCTGTGAACCCATTGAGT,0,2255907
marRp,0.3333333333333333,2,2,CGTCTATTTTTTTACTTAAG,0,2242091
marRp,0.3333333333333333,2,2,CGTAGCTTGACCTCAACAAG,0,2227146
marRp,0.3333333333333333,2,2,CGGTGAATAGGACGTCACAT,0,2225628
marRp,0.3333333333333333,2,2,CGGTCTCTTTTTGGTCTCCA,0,2223554
marRp,0.3333333333333333,2,2,CGGTAAAGTTGCCAGGCGAC,0,2236007
marRp,0.3333333333333333,2,2,CGGGTTCCAAGATACTAGGT,0,2259037
marRp,0.3333333333333333,2,2,CGGGGGGTTCGGACAGTACC,0,2230451
marRp,0.3333333333333333,2,2,CGGGCTACGAGACTAGGCGG,0,2259261
marRp,0.3333333333333333,2,2,CGGGCCAACCCTCTACCTAC,0,2242903
marRp,0.3333333333333333,2,2,CGGGACTATAGGTTTTGAAA,0,2250533
marRp,0.3333333333333333,2,2,CGGCGTTGCACTACCCTAAC,0,2238551
marRp,0.3333333333333333,2,2,CGGCCTCACCCTTATACTTT,0,2231480
marRp,0.3333333333333333,2,2,CGGATTGTACAGACATTCTG,0,2230837
marRp,0.3333333333333333,2,2,CGGACCGCATGCCTCATACT,0,2252393
marRp,0.3333333333333333,2,2,CGGAAGTCGTCTCGAGGAGA,0,2233223
marRp,0.3333333333333333,2,2,CGCTGGTCCTCCGGGGCTCA,0,2240195
marRp,0.3333333333333333,2,2,CGCTACCTTTTAAATTGGGT,0,2255394
marRp,0.3333333333333333,2,2,CGCGTCTCGTTAACGGCAAA,0,2258881
marRp,0.3333333333333333,2,2,CGCGGTCGTTGTGCACGGGA,0,2257244
marRp,0.3333333333333333,2,2,CGATTACGCTCGGCATCCGC,0,2255767
marRp,0.3333333333333333,2,2,CGATGTGCATAAGTTTGCAT,0,2231696
marRp,0.3333333333333333,2,2,CGATGCCTCGGGCCGGCGCC,0,2237751
marRp,0.3333333333333333,2,2,CGAGTGATAGTAATGGGAAA,0,2255653
marRp,0.3333333333333333,2,2,CGAGGTTCTGACCGTTATTG,0,2245402
marRp,0.3333333333333333,2,2,CGACTCCCCGGCTGACCCAG,0,2242287
marRp,0.3333333333333333,2,2,CGACCACCGGGAGTTATGAT,0,2242659
marRp,0.3333333333333333,2,2,CGACAACCACCGGCGCTGGT,0,2237844
marRp,0.3333333333333333,2,2,CGAAGGGATCTAGGCAATGC,0,2228926
marRp,0.3333333333333333,2,2,CGAACCCCTTCTCCAAGTCA,0,2249432
marRp,0.3333333333333333,2,2,CGAAAGAGCACTTGCGGGGA,0,2223854
marRp,0.3333333333333333,2,2,CCTTTGTGACCACTTTAATG,0,2238198
marRp,0.3333333333333333,2,2,CCTTTGGCGTACATGCACAC,0,2258518
marRp,0.3333333333333333,2,2,CCTGTTAGAAAATACAATAC,0,2220392
marRp,0.3333333333333333,2,2,CCTGTGACGCCCCAATTAGG,0,2254376
marRp,0.3333333333333333,2,2,CCTGTCACTGATTCACCTAC,0,2258463
marRp,0.3333333333333333,2,2,CCTCGCATACGCTCGGGTCG,0,2243147
marRp,0.3333333333333333,2,2,CCTCGAAGGCATCAGGTTCA,0,2254509
marRp,0.3333333333333333,2,2,CCTATAAAGGGACATGGCTT,0,2239767
marRp,0.3333333333333333,2,2,CCTACTCCCGAGTAAATTGT,0,2240192
marRp,0.3333333333333333,2,2,CCTACAGGTCCGAGAATGGT,0,2257564
marRp,0.3333333333333333,2,2,CCTAAACGAGGGATACTGGC,0,2253113
marRp,0.3333333333333333,2,2,CCGTGCTTACGAAGCCATCC,0,2260976
marRp,0.3333333333333333,2,2,CCGGGCAATTTTCACACGGC,0,2252613
marRp,0.3333333333333333,2,2,CCGGAAGCTGGATGATGATG,0,2237980
marRp,0.3333333333333333,2,2,CCGGAAGACTTGGGCTTATG,0,2231694
marRp,0.3333333333333333,2,2,CCGCTGCTTGATATCTCCCA,0,2244379
marRp,0.3333333333333333,2,2,CCGCTGAAAACGGTTGTTGA,0,2226874
marRp,0.3333333333333333,2,2,CCGACCGTCTCGTGTAGTAA,0,2236127
marRp,0.3333333333333333,2,2,CCCTGTATCCTGGCGAATAG,0,2248809
marRp,0.3333333333333333,2,2,CCCTGCGCTCGGGGTATCGG,0,2226335
marRp,0.3333333333333333,2,2,CCCTGCACTTTTCATACATA,0,2225902
marRp,0.3333333333333333,2,2,CCCTATTGAAGCGCATACCG,0,2222729
marRp,0.3333333333333333,2,2,CCCTAGCCAGGTATAGTACG,0,2229338
marRp,0.3333333333333333,2,2,CCCCTTTTCACTTATAATCC,0,2229035
marRp,0.3333333333333333,2,2,CCCCTCACCCATTAGTATGC,0,2244061
marRp,0.3333333333333333,2,2,CCCCGTTGCGCCTACCACAC,0,2233569
marRp,0.3333333333333333,2,2,CCCCGAGGGCATAATGAACA,0,2222666
marRp,0.3333333333333333,2,2,CCCCGACGCACGAGAAGTGG,0,2220461
marRp,0.3333333333333333,2,2,CCCCAAAATAGGGCTTTTGA,0,2229444
marRp,0.3333333333333333,2,2,CCCATCGGTTAGATTAGGCG,0,2224524
marRp,0.3333333333333333,2,2,CCCACGGTATGCGTAAAGTG,0,2227518
marRp,0.3333333333333333,2,2,CCCACGCGGTGGTGTGCACA,0,2229529
marRp,0.3333333333333333,2,2,CCATATCTTCTGTTGTGCGT,0,2229946
marRp,0.3333333333333333,2,2,CCATACGTTTTCAAATCCAA,0,2229183
marRp,0.3333333333333333,2,2,CCATACGTTCGACAATGTTT,0,2234589
marRp,0.3333333333333333,2,2,CCAGTAATGTGGACCTTTGT,0,2249223
marRp,0.3333333333333333,2,2,CCAGGGGATTGGAATCTCGG,0,2258899
marRp,0.3333333333333333,2,2,CCAGGCGAGTAAATGTAAAC,0,2234427
marRp,0.3333333333333333,2,2,CCACATGGGGGATAGGCAGG,0,2251047
marRp,0.3333333333333333,2,2,CCAAGGAGTATTAAAAGACA,0,2247972
marRp,0.3333333333333333,2,2,CCAAACCGATTTTTACTGGA,0,2228799
marRp,0.3333333333333333,2,2,CATTTGATGATGCGATTTGT,0,2241664
marRp,0.3333333333333333,2,2,CATTTCATGGGTATCCTTCA,0,2220015
marRp,0.3333333333333333,2,2,CATTGACCGTACGGCAAGAG,0,2218825
marRp,0.3333333333333333,2,2,CATTCTTCACTAATAAAAAT,0,2258309
marRp,0.3333333333333333,2,2,CATGTTCAGGGCCGCTCGCG,0,2249096
marRp,0.3333333333333333,2,2,CATGTGACAACCGCAGTAGG,0,2222650
marRp,0.3333333333333333,2,2,CATCGAGCATGCGTTGATCC,0,2225643
marRp,0.3333333333333333,2,2,CATCGAGAACACCTATGTAG,0,2251318
marRp,0.3333333333333333,2,2,CATCCAGAACCCAGCACATC,0,2258981
marRp,0.3333333333333333,2,2,CATCATCGCGGGCGGCGTGC,0,2223024
marRp,0.3333333333333333,2,2,CAGGTTGGAGCGTACTTCAT,0,2223921
marRp,0.3333333333333333,2,2,CAGGTAGTATGTGGCATGTT,0,2222802
marRp,0.3333333333333333,2,2,CAGGACGAGTTAATCCGAGC,0,2251864
marRp,0.3333333333333333,2,2,CAGAGTGGATCTCGCGAATA,0,2241859
marRp,0.3333333333333333,2,2,CAGAGGGACTCTACACAGTA,0,2224495
marRp,0.3333333333333333,2,2,CAGAAGGCCGACAGGGCAAA,0,2244444
marRp,0.3333333333333333,2,2,CACTTTAATACACGCGGCGG,0,2238248
marRp,0.3333333333333333,2,2,CACGTGCGTAGGTTTCTGGG,0,2231467
marRp,0.3333333333333333,2,2,CACGGTGTCATCATTCAACA,0,2240108
marRp,0.3333333333333333,2,2,CACGCTGGTACACAGCATAC,0,2243918
marRp,0.3333333333333333,2,2,CACCAGGCTCAATTCTGTCG,0,2232666
marRp,0.3333333333333333,2,2,CACATCAACGGCAACAGTCA,0,2255561
marRp,0.3333333333333333,2,2,CACAGTTGTTCCCCTGTCGG,0,2221605
marRp,0.3333333333333333,2,2,CACAACCCTAGCCTTGAATA,0,2258971
marRp,0.3333333333333333,2,2,CAATGGCCTAGGGACGAAGC,0,2240670
marRp,0.3333333333333333,2,2,CAATCAGCTACTGTCAGCAA,0,2234883
marRp,0.3333333333333333,2,2,CAAGTTCCCACCTGAACTTC,0,2221141
marRp,0.3333333333333333,2,2,CAAGGAAAGGTCTGTTTATT,0,2252867
marRp,0.3333333333333333,2,2,CAACTGGGTACTACCGGGTA,0,2248638
marRp,0.3333333333333333,2,2,CAACTCCGAAAGATCATCTG,0,2253683
marRp,0.3333333333333333,2,2,CAACGGTACTTACCACAGGT,0,2258317
marRp,0.3333333333333333,2,2,CAACAGTGGATCGCCGACTT,0,2252148
marRp,0.3333333333333333,2,2,CAAATCCAGCTCTACGGTCC,0,2253563
marRp,0.3333333333333333,2,2,CAAATCACAGGGGCGTCATA,0,2255327
marRp,0.3333333333333333,2,2,ATTTGGTCCGCCCGGCATTA,0,2254120
marRp,0.3333333333333333,2,2,ATTTCCGGGGTAATTGGCAG,0,2223473
marRp,0.3333333333333333,2,2,ATTTACTGTCTGCATCGGAC,0,2258491
marRp,0.3333333333333333,2,2,ATTGCTACATCGATTGTTGT,0,2238278
marRp,0.3333333333333333,2,2,ATTGAGTTTTCATCAGGTGT,0,2251457
marRp,0.3333333333333333,2,2,ATGTGTTGAGCGAACGACTA,0,2250189
marRp,0.3333333333333333,2,2,ATGTGAGCTCACGGCGCGTA,0,2227448
marRp,0.3333333333333333,2,2,ATGTAATTCTTCCGTAAGCA,0,2233807
marRp,0.3333333333333333,2,2,ATGGGTGTTGATGCAAAACC,0,2246529
marRp,0.3333333333333333,2,2,ATGGGCCATAACAGCAGTTA,0,2247147
marRp,0.3333333333333333,2,2,ATGGCTAAATTAGATAGATG,0,2240179
marRp,0.3333333333333333,2,2,ATGGATTCACAGGCCCGTGG,0,2259373
marRp,0.3333333333333333,2,2,ATGGATAACCGCGACTCCGA,0,2239269
marRp,0.3333333333333333,2,2,ATGCTGGAGTTTCGTGCTGC,0,2229852
marRp,0.3333333333333333,2,2,ATGCCAAAGTCAACACTACT,0,2250023
marRp,0.3333333333333333,2,2,ATGATACAACGGCACTACCA,0,2239709
marRp,0.3333333333333333,2,2,ATGACGACTAGCGTACTGAC,0,2222372
marRp,0.3333333333333333,2,2,ATGAAGGTAACTCGGTTAAT,0,2247869
marRp,0.3333333333333333,2,2,ATCTTATTCTATACAGAATT,0,2257324
marRp,0.3333333333333333,2,2,ATCTGTGTAGTTTAGTCTCT,0,2241856
marRp,0.3333333333333333,2,2,ATCGCGGGATGATTTCAATC,0,2229863
marRp,0.3333333333333333,2,2,ATCGCGGAGTCGGGCGGTGC,0,2225567
marRp,0.3333333333333333,2,2,ATCGAGGTATCGCCCAGTCG,0,2219605
marRp,0.3333333333333333,2,2,ATCGAGCATCTGGGAATCTC,0,2238255
marRp,0.3333333333333333,2,2,ATCCAGATCCGTTTGATCCT,0,2238349
marRp,0.3333333333333333,2,2,ATCCAGAGTAGTGCAAAGGG,0,2219386
marRp,0.3333333333333333,2,2,ATCATACCGATGGAAAGGTT,0,2252322
marRp,0.3333333333333333,2,2,ATCAGGATTTGTTCGTAAGG,0,2242206
marRp,0.3333333333333333,2,2,ATCAGCTCTGCCAGAATTCC,0,2224614
marRp,0.3333333333333333,2,2,ATATTGAGCTTGCTATGGGG,0,2241103
marRp,0.3333333333333333,2,2,ATATGGCATCTATTTGGATG,0,2223041
marRp,0.3333333333333333,2,2,ATATGAGGCTTCCCTGGGTT,0,2260385
marRp,0.3333333333333333,2,2,ATAGCTCCAAAGCGTCGCTC,0,2239486
marRp,0.3333333333333333,2,2,ATACTCTGTATGTCTTATGG,0,2254871
marRp,0.3333333333333333,2,2,ATACGGCCCGAGTAATCCGT,0,2223019
marRp,0.3333333333333333,2,2,ATACGGACGAGCGGTTCTCT,0,2256507
marRp,0.3333333333333333,2,2,ATACGCTGATCATGCCTACG,0,2222929
marRp,0.3333333333333333,2,2,ATACCAAAACCTTGGAATTC,0,2252808
marRp,0.3333333333333333,2,2,ATACAGGGGCCGTGTCCGAG,0,2254197
marRp,0.3333333333333333,2,2,ATAAGATTAAGTCCCTAGAT,0,2247491
marRp,0.3333333333333333,2,2,ATAAACGTTAGCCTTCCCTG,0,2244594
marRp,0.3333333333333333,2,2,AGTTCTAGCTAACGATAAGT,0,2229292
marRp,0.3333333333333333,2,2,AGTGTCCAAGTCTGGAAATT,0,2220952
marRp,0.3333333333333333,2,2,AGTGATAACTGACGCTTTGA,0,2250250
marRp,0.3333333333333333,2,2,AGTCACCTAGTCCGCGGGAT,0,2234731
marRp,0.3333333333333333,2,2,AGTAGCGTAGGGGACGTGCG,0,2226995
marRp,0.3333333333333333,2,2,AGGTTTATGTCGGGTACCAA,0,2245028
marRp,0.3333333333333333,2,2,AGGTTCCAACGGGCAAATCA,0,2229042
marRp,0.3333333333333333,2,2,AGGTCAAGGCTCCATAAATG,0,2256182
marRp,0.3333333333333333,2,2,AGGGCTCGGCCGTCCCCCTG,0,2248643
marRp,0.3333333333333333,2,2,AGGCTCGCTGTAGGCCAGAG,0,2224873
marRp,0.3333333333333333,2,2,AGGCCAGTTGGTCCTTGGAC,0,2218192
marRp,0.3333333333333333,2,2,AGGCAATTTCCAGCAGTTAG,0,2238315
marRp,0.3333333333333333,2,2,AGGATTAACGGGTTTCATCA,0,2245947
marRp,0.3333333333333333,2,2,AGGAGTAGTTATATATGTTT,0,2227487
marRp,0.3333333333333333,2,2,AGCTTATCAGGGTCTTTTGC,0,2257945
marRp,0.3333333333333333,2,2,AGCTCTGAACGGCGAGGTTG,0,2226336
marRp,0.3333333333333333,2,2,AGCTCCACGCTTTTGGTGCA,0,2241481
marRp,0.3333333333333333,2,2,AGCTCATGTCGTTTCCCAAC,0,2241814
marRp,0.3333333333333333,2,2,AGCTATGCGCGATTTGTTAC,0,2248404
marRp,0.3333333333333333,2,2,AGCCGCACAGCGTCAACAAA,0,2221138
marRp,0.3333333333333333,2,2,AGCCATGCGTGCTATGTCCG,0,2237839
marRp,0.3333333333333333,2,2,AGCATGAGCTCTCAAACCCT,0,2227176
marRp,0.3333333333333333,2,2,AGCAGTTTCGCTTCAGCTGA,0,2218430
marRp,0.3333333333333333,2,2,AGCACCCGCTCAAACGCGCT,0,2236929
marRp,0.3333333333333333,2,2,AGCACATTATGTATTCCCAG,0,2240538
marRp,0.3333333333333333,2,2,AGATTTGCAATGTCATCTTG,0,2225895
marRp,0.3333333333333333,2,2,AGATTCCGGTTCCCATTTTA,0,2252197
marRp,0.3333333333333333,2,2,AGAGTCTTCAGGGCATGTCT,0,2227346
marRp,0.3333333333333333,2,2,AGAGGCCGAAACGCACTTCT,0,2240671
marRp,0.3333333333333333,2,2,AGACTGGATCAGGTGAGCCC,0,2241271
marRp,0.3333333333333333,2,2,AGACCTAAGAGTGATTGCAA,0,2238980
marRp,0.3333333333333333,2,2,AGACCGACACGTCCCTACGA,0,2241387
marRp,0.3333333333333333,2,2,AGACAGGGGGTTGAAATGGT,0,2248696
marRp,0.3333333333333333,2,2,AGAACAGCACTACCAGAAGG,0,2225335
marRp,0.3333333333333333,2,2,ACTTTATTTTTTGTGGTATA,0,2243852
marRp,0.3333333333333333,2,2,ACTGTAGAAGATCTGTTACA,0,2238986
marRp,0.3333333333333333,2,2,ACTGGTATTATCAGTCGGAC,0,2238518
marRp,0.3333333333333333,2,2,ACTGCTTTAGGGCGGACCTT,0,2251014
marRp,0.3333333333333333,2,2,ACTGCCTAAGGGGTGCGCAT,0,2219238
marRp,0.3333333333333333,2,2,ACTGCAGTAGAGGGGTTAGT,0,2218669
marRp,0.3333333333333333,2,2,ACTCTAGATGTTGACGACCT,0,2250140
marRp,0.3333333333333333,2,2,ACTCCACCATTTCGAGAAAA,0,2258097
marRp,0.3333333333333333,2,2,ACTCACTGTCAGCTTCTGGT,0,2259380
marRp,0.3333333333333333,2,2,ACTCAATGGTATTGCGTCAG,0,2239296
marRp,0.3333333333333333,2,2,ACTAAGATACCATTGACCCA,0,2230068
marRp,0.3333333333333333,2,2,ACGTTTGACGCTGCTTCGAA,0,2231720
marRp,0.3333333333333333,2,2,ACGTGGGGCTGCCGACGAGG,0,2251494
marRp,0.3333333333333333,2,2,ACGGGTCGCCACGGGGCCTA,0,2219724
marRp,0.3333333333333333,2,2,ACGGGGGAAATCGGTGCATG,0,2237442
marRp,0.3333333333333333,2,2,ACGGCAGTAGGTCCAAATGT,0,2247611
marRp,0.3333333333333333,2,2,ACGCCCTTGGGAAAGCAATC,0,2222692
marRp,0.3333333333333333,2,2,ACGCATTCCGTCACCTCATG,0,2254229
marRp,0.3333333333333333,2,2,ACGAGTGGAGACTCCGGATT,0,2245407
marRp,0.3333333333333333,2,2,ACCTTCTCGTTCGGAGCACA,0,2249641
marRp,0.3333333333333333,2,2,ACCTTCGCATGAGCATTGTC,0,2257051
marRp,0.3333333333333333,2,2,ACCTGGAATGGGTTAAGGGT,0,2249672
marRp,0.3333333333333333,2,2,ACCTACTATTGAGGGGATGG,0,2229009
marRp,0.3333333333333333,2,2,ACCGTTACTCCCTGAACCGA,0,2225153
marRp,0.3333333333333333,2,2,ACCGAGGATCTTCTCGGAGC,0,2246469
marRp,0.3333333333333333,2,2,ACCCCGTCACAGTCGCATTA,0,2246083
marRp,0.3333333333333333,2,2,ACCCAGGGCTCCCTGGAATC,0,2256021
marRp,0.3333333333333333,2,2,ACCCAGAGCGCTTCCGATCC,0,2228114
marRp,0.3333333333333333,2,2,ACATTGTGTCGGTATAACCT,0,2226426
marRp,0.3333333333333333,2,2,ACATGTCTTTTAATCATGGT,0,2244013
marRp,0.3333333333333333,2,2,ACATCGGCCGGTGCACTATC,0,2244923
marRp,0.3333333333333333,2,2,ACAGGGCGACGCGGATCCCT,0,2254724
marRp,0.3333333333333333,2,2,ACAGCTGAGCCTTGTCTAGG,0,2244056
marRp,0.3333333333333333,2,2,ACAGCCTGAGGGTCGCCTGT,0,2230734
marRp,0.3333333333333333,2,2,ACAGAGAAATACACCAGGCC,0,2217916
marRp,0.3333333333333333,2,2,ACACTGGAGGCTTCTTCACT,0,2241994
marRp,0.3333333333333333,2,2,AATGTAGTCGATGCTATTTT,0,2223239
marRp,0.3333333333333333,2,2,AATGCATAATTTGGTGCTGT,0,2224986
marRp,0.3333333333333333,2,2,AATGATATTCTATGTCGTGG,0,2232423
marRp,0.3333333333333333,2,2,AATGAAGATTTCCTTAGGCA,0,2244313
marRp,0.3333333333333333,2,2,AATCACACGATAGGAGTGTA,0,2253328
marRp,0.3333333333333333,2,2,AAGTTGTAGTACACGGGTGG,0,2227711
marRp,0.3333333333333333,2,2,AAGTTCGAGTTAGGTCGAGG,0,2238972
marRp,0.3333333333333333,2,2,AAGTGAGTGTGACTTGTATC,0,2225843
marRp,0.3333333333333333,2,2,AAGTCCGGGTATTACAATGA,0,2241765
marRp,0.3333333333333333,2,2,AAGCTACAAGACCCCCTCCA,0,2252572
marRp,0.3333333333333333,2,2,AAGCACACCCTTGAGGCCGT,0,2230063
marRp,0.3333333333333333,2,2,AAGATCTCAATACCGCAGAT,0,2223739
marRp,0.3333333333333333,2,2,AAGAAAATCCGGAGGCTAGG,0,2260182
marRp,0.3333333333333333,2,2,AACTTTCTCAGTTTTTTGAA,0,2224136
marRp,0.3333333333333333,2,2,AACTACGTATATCATGAGAA,0,2249970
marRp,0.3333333333333333,2,2,AACGTAGGACGTCTTAATAG,0,2224138
marRp,0.3333333333333333,2,2,AACGTAACCCTGTTTTCCTA,0,2235583
marRp,0.3333333333333333,2,2,AACGGGATCTGGACGCAATG,0,2241825
marRp,0.3333333333333333,2,2,AACGGCAATAGATCAACCTG,0,2244459
marRp,0.3333333333333333,2,2,AACGAACGATGACCACCAGC,0,2228063
marRp,0.3333333333333333,2,2,AACCTGGAACAGAGGGTCTT,0,2226311
marRp,0.3333333333333333,2,2,AACCTAGTAATCGGTTGCTG,0,2224200
marRp,0.3333333333333333,2,2,AACAGGCGACGCTAGTAATC,0,2229930
marRp,0.3333333333333333,2,2,AACAGCGAGTAGTATTGATA,0,2239276
marRp,0.3333333333333333,2,2,AACACTATTATCGGCGCTAC,0,2226957
marRp,0.3333333333333333,2,2,AACACCAACGTCCGGTATCA,0,2235388
marRp,0.3333333333333333,2,2,AAATAACCCCCGAACGAAGG,0,2240516
marRp,0.3333333333333333,2,2,AAAGCACACGTTGCTCAACC,0,2255633
marRp,0.3333333333333333,2,2,AAAGAGCGTCATCGTGCAAT,0,2218627
marRp,0.3333333333333333,2,2,AAACCTACGACCGTATCTCT,0,2228371
marRp,0.3333333333333333,2,2,AAACATACGAAATTCGAGTA,0,2259527
marRp,0.3333333333333333,2,2,AAAATGCAGACAATAATTTA,0,2235994
marRp,0.3333333333333333,2,2,AAAAATCTTGTCCACAGTGG,0,2230073
marRp,0.3333333333333333,2,2,AAAAAAGCAGGTCAGGTAGA,0,2236010
marRp,0.5,1,1,TTTTTATGCTCACCGACTTC,0,2222932
marRp,0.5,1,1,TTTTATGTTTGTTGTCTGGG,0,2229375
marRp,0.5,1,1,TTTTATACCTCGATCCTAAT,0,2227740
marRp,0.5,1,1,TTTGTGCTTGGGTACTGGAT,0,2222947
marRp,0.5,1,1,TTTGAGATCAATGTCCGGTC,0,2256306
marRp,0.5,1,1,TTTGAAAATTCGCACACTAG,0,2252601
marRp,0.5,1,1,TTTCTGGACTCTGGTCGAGT,0,2220907
marRp,0.5,1,1,TTTCTGACACTGATCACCGG,0,2246650
marRp,0.5,1,1,TTTCCCGCGCGCAGCGAACT,0,2229781
marRp,0.5,1,1,TTTCACGGGGATACAGGCAT,0,2247095
marRp,0.5,1,1,TTTAGTGACCGCTACCTTCT,0,2237857
marRp,0.5,1,1,TTTACCATTGCGCATGAGAT,0,2251168
marRp,0.5,1,1,TTTAAATATGCCGGAGGCCA,0,2242363
marRp,0.5,1,1,TTGTGTATGGAAGTAGGTTT,0,2231813
marRp,0.5,1,1,TTGTGCTATACTTTCAGGCA,0,2219774
marRp,0.5,1,1,TTGTCGAGGTCTTCGTACAT,0,2251033
marRp,0.5,1,1,TTGGTCAAAAAAAATAGGGT,0,2260151
marRp,0.5,1,1,TTGGCAATGTCGTGTATTTG,0,2255650
marRp,0.5,1,1,TTGGACGCCTTGCTACGGCC,0,2248619
marRp,0.5,1,1,TTGGACAGTTCGGGCAACGA,0,2245664
marRp,0.5,1,1,TTGCCTTCGGCGATCAACTA,0,2224679
marRp,0.5,1,1,TTGCCGCGATACATGCGCGT,0,2248940
marRp,0.5,1,1,TTGCACTTGCTAAGTATGAA,0,2246481
marRp,0.5,1,1,TTGATCCGTGCAAACCACAA,0,2253873
marRp,0.5,1,1,TTGATAAAGCGTTAGGAGAG,0,2231126
marRp,0.5,1,1,TTGACTTAGAAGGTTTTACG,0,2246538
marRp,0.5,1,1,TTGACCTGGATAGACGAGGC,0,2242912
marRp,0.5,1,1,TTCTTGGGTTAAGGGTGGAT,0,2255082
marRp,0.5,1,1,TTCTCTCCCTTGTAACGTCT,0,2219598
marRp,0.5,1,1,TTCTCCGGGCGGGCCAAACT,0,2225647
marRp,0.5,1,1,TTCGCTGATTGGTATGTGCA,0,2247781
marRp,0.5,1,1,TTCGCGGTACTGTAGCAGGA,0,2223975
marRp,0.5,1,1,TTCGATAAGAGGTGACCGAG,0,2222052
marRp,0.5,1,1,TTCCTGTCCACTCCCCCATA,0,2237599
marRp,0.5,1,1,TTCCAATCTGAGCACCAGTT,0,2235890
marRp,0.5,1,1,TTCACCGGGTGCCAGTCGTT,0,2232995
marRp,0.5,1,1,TTCAAGACAACCCTGCCGGA,0,2236337
marRp,0.5,1,1,TTCAAAGCGCGCTACCGCGT,0,2251370
marRp,0.5,1,1,TTATTATCCCTAAAAAATTT,0,2247774
marRp,0.5,1,1,TTATTACGACATGCCGCTAA,0,2239746
marRp,0.5,1,1,TTATGGGTCGAGGCTGGGTA,0,2223887
marRp,0.5,1,1,TTATGCGGTCGGAACTTGTT,0,2252153
marRp,0.5,1,1,TTATCGGGCTTCAACAGCTC,0,2243723
marRp,0.5,1,1,TTATCATACTGGGACAAAAA,0,2222170
marRp,0.5,1,1,TTATAGCAGCGCATTATTCA,0,2228426
marRp,0.5,1,1,TTATAACTCGCCTACTCAGC,0,2221412
marRp,0.5,1,1,TTAGGTGCATGAAATCTTGC,0,2218700
marRp,0.5,1,1,TTAGGATAGGCAGAATCCAT,0,2220422
marRp,0.5,1,1,TTAGCGGAAATGGTCTACAA,0,2244338
marRp,0.5,1,1,TTAGCCCCCAGCAGCTAGGT,0,2229674
marRp,0.5,1,1,TTACGACCCGGGTAGCTCCA,0,2239711
marRp,0.5,1,1,TTACGACAAGCGATTCCCAT,0,2232707
marRp,0.5,1,1,TTACCCGGATAGGATATCGT,0,2249093
marRp,0.5,1,1,TTACATAGGAAAGGCTCGGA,0,2237661
marRp,0.5,1,1,TTAATGCCCTGATATTCGAC,0,2237254
marRp,0.5,1,1,TTAACCAGTGGTTTCAGGAT,0,2258008
marRp,0.5,1,1,TGTTAGACGAGCGGACCGTC,0,2235190
marRp,0.5,1,1,TGTGGGGCTGCTTCCTAATG,0,2233853
marRp,0.5,1,1,TGTGCGCTGTCGCTGACAAC,0,2260559
marRp,0.5,1,1,TGTGCCCAGGTCGGACCATA,0,2250068
marRp,0.5,1,1,TGTGCACAAAAGAGGGTTGA,0,2243674
marRp,0.5,1,1,TGTGAGCATGGTTGAACGAA,0,2244876
marRp,0.5,1,1,TGTGAACGGTGAATGGCACG,0,2252298
marRp,0.5,1,1,TGTCTGATACTGCCAAGTCC,0,2233768
marRp,0.5,1,1,TGTCGCCCCCATTCTAACCG,0,2251758
marRp,0.5,1,1,TGTCACTCTAGAGGCGGCAA,0,2242935
marRp,0.5,1,1,TGTCACACATAGTAGACACG,0,2252874
marRp,0.5,1,1,TGTCAACTTCGCCAGACTAC,0,2238748
marRp,0.5,1,1,TGTACCACAACGCGGGTTTC,0,2231338
marRp,0.5,1,1,TGTAACGGTCATGATGCTTG,0,2225141
marRp,0.5,1,1,TGGTGATATATATAGTGCGT,0,2244337
marRp,0.5,1,1,TGGTCCCCGTGTCACGATAG,0,2244103
marRp,0.5,1,1,TGGTACAGATTTTTTATCTA,0,2231414
marRp,0.5,1,1,TGGGTTTTACGTCATCCACC,0,2253711
marRp,0.5,1,1,TGGGTATGAACAAATTTATG,0,2229416
marRp,0.5,1,1,TGGGCTGATCCGTACGTGTT,0,2244189
marRp,0.5,1,1,TGGGCGTGGGCCTCTCAAGT,0,2222202
marRp,0.5,1,1,TGGGACTCGAGACCGGACTT,0,2259824
marRp,0.5,1,1,TGGCTTAATATTGTTTGGTC,0,2244165
marRp,0.5,1,1,TGGCGGTTATAAAAAATCTG,0,2244903
marRp,0.5,1,1,TGGCAAATGTTTGGTGAAAA,0,2250499
marRp,0.5,1,1,TGGATCGAACTTCCCTGATC,0,2222201
marRp,0.5,1,1,TGGACGAGGGCGTGGCATCC,0,2236394
marRp,0.5,1,1,TGGAATCTCCGAACAGCAAG,0,2245086
marRp,0.5,1,1,TGCTCAAGCAATGTCCTCTT,0,2223841
marRp,0.5,1,1,TGCTAGCTCATAGGCGGAGA,0,2249209
marRp,0.5,1,1,TGCGGCGGCCTTTGTCAACA,0,2245391
marRp,0.5,1,1,TGCGGATCGTTGCGTAGTAA,0,2235846
marRp,0.5,1,1,TGCGAACTTGACTGTTGTGC,0,2241236
marRp,0.5,1,1,TGCCCTTAGCATCATGATGG,0,2235789
marRp,0.5,1,1,TGCCAGATAGATTTCTTAGC,0,2234892
marRp,0.5,1,1,TGCATATGTTTGATGATACG,0,2232876
marRp,0.5,1,1,TGCAGGATCTCGTCATGGAT,0,2255421
marRp,0.5,1,1,TGCACAGGAGAGTCGTTACG,0,2232370
marRp,0.5,1,1,TGATTCTCAACAGAAGCATA,0,2231264
marRp,0.5,1,1,TGATCGACTCAATGGCGCTG,0,2225478
marRp,0.5,1,1,TGAGGTGACAACAACATCTT,0,2234860
marRp,0.5,1,1,TGAGGCGGTGCCAGCAAATA,0,2242033
marRp,0.5,1,1,TGACTCTCTGGATTGCCCCC,0,2237896
marRp,0.5,1,1,TGACGGACCCCGTACTACAT,0,2255529
marRp,0.5,1,1,TGACCATAGTCTAAACTTAC,0,2238197
marRp,0.5,1,1,TGACACCGGCGAGGATGGGT,0,2238378
marRp,0.5,1,1,TGACACAAACATTACTACTC,0,2226980
marRp,0.5,1,1,TGAAGAGCAAAGGTGACCAA,0,2242959
marRp,0.5,1,1,TGAACGACGTCAGAGGCGGT,0,2226220
marRp,0.5,1,1,TGAACCTACTGCGCTCAAGA,0,2258610
marRp,0.5,1,1,TCTTTGTATACAAATTAATT,0,2229097
marRp,0.5,1,1,TCTTGTTCACTGTTCGTTGT,0,2235793
marRp,0.5,1,1,TCTTGCGCACAGTTCTTGCT,0,2225859
marRp,0.5,1,1,TCTTATCTTTATAGGAATCA,0,2231001
marRp,0.5,1,1,TCTGTGATGTTGGTACTGCT,0,2236980
marRp,0.5,1,1,TCTGGACTTGGAGAATGTTC,0,2221221
marRp,0.5,1,1,TCTGCTGCTTGTGGCCTTCG,0,2220620
marRp,0.5,1,1,TCTGATTACTCGTAGACAGG,0,2239769
marRp,0.5,1,1,TCTGATGCAGTTTTAGTTAC,0,2252569
marRp,0.5,1,1,TCTCGGACTAGCTGTGAATA,0,2254316
marRp,0.5,1,1,TCTCCACGACGGGTGCTGCT,0,2247287
marRp,0.5,1,1,TCTATTTCGAGGCAGGATTT,0,2230867
marRp,0.5,1,1,TCTAGGTCCATATGAAACAT,0,2242194
marRp,0.5,1,1,TCTACGCCCCTAGAGCTTCA,0,2255450
marRp,0.5,1,1,TCGTTCGCACTTCTGCATGT,0,2246440
marRp,0.5,1,1,TCGTGTAGTTACAATTCGTT,0,2260368
marRp,0.5,1,1,TCGTACGATTAGAGGTCAGT,0,2240867
marRp,0.5,1,1,TCGTAATATGGCATGCCATA,0,2242801
marRp,0.5,1,1,TCGGTGACTACTACTAAAGA,0,2230809
marRp,0.5,1,1,TCGGGACTATCTTGCTCCTA,0,2231106
marRp,0.5,1,1,TCGCTACGAGCCAGCAATTG,0,2240459
marRp,0.5,1,1,TCGCCTGGGTAAGAACCGTA,0,2241367
marRp,0.5,1,1,TCGCACTCCGGAGGACCCAC,0,2248715
marRp,0.5,1,1,TCGCACGGTGTAAGCCTCTA,0,2254710
marRp,0.5,1,1,TCGAGTAAAAGTCAAGTCCC,0,2260640
marRp,0.5,1,1,TCGACTCTTGGGATACAATT,0,2258820
marRp,0.5,1,1,TCGACAGTGTTGATGGACAA,0,2259614
marRp,0.5,1,1,TCGACACCTGGCCACGGTGA,0,2252327
marRp,0.5,1,1,TCCTGTTTACACGGTCTTCT,0,2242368
marRp,0.5,1,1,TCCTAGTTAACCCCGAAGGT,0,2221641
marRp,0.5,1,1,TCCGTTAAAGACGTGTTGCA,0,2238699
marRp,0.5,1,1,TCCGTAATAGGGAAGTACGT,0,2257853
marRp,0.5,1,1,TCCGGGGGTCTAGGACCACT,0,2226193
marRp,0.5,1,1,TCCGACGTGGGCATGATCGT,0,2221966
marRp,0.5,1,1,TCCCTTTTGCTTACCGCACA,0,2234504
marRp,0.5,1,1,TCCCTCTTTCGGTACTCTGC,0,2252894
marRp,0.5,1,1,TCCCGGCAGAACAGTCCATA,0,2217993
marRp,0.5,1,1,TCCCCGTAGAACGTCGAACG,0,2219722
marRp,0.5,1,1,TCCCCCGCTGGCACAAAGCA,0,2260156
marRp,0.5,1,1,TCCCCAGCTTAAGCGTCAGA,0,2245125
marRp,0.5,1,1,TCCCATACGGGGCTCGCACT,0,2230150
marRp,0.5,1,1,TCCAATGACACCTGTAGGGC,0,2226945
marRp,0.5,1,1,TCATTTTTAACTTAGGTGAT,0,2255869
marRp,0.5,1,1,TCATTGGGGTGACAGAATCA,0,2220009
marRp,0.5,1,1,TCATGGTGTATATAGTTCAA,0,2237884
marRp,0.5,1,1,TCATGGCAGGGATACTTGGT,0,2253772
marRp,0.5,1,1,TCATGGAGAGCTGGATGCGG,0,2254706
marRp,0.5,1,1,TCAGTACATCGGTACTGTCG,0,2243688
marRp,0.5,1,1,TCAGGTACGCCTTATTAGAT,0,2231667
marRp,0.5,1,1,TCAGCCCCCCAGTCATGGGT,0,2247525
marRp,0.5,1,1,TCACTGGGCAAGACGTACAG,0,2242025
marRp,0.5,1,1,TCACGGGATCACTGGGAAGT,0,2253301
marRp,0.5,1,1,TCACGACGTCCGTCCGTCTG,0,2226750
marRp,0.5,1,1,TCACACTGCACGGCAATCGG,0,2220331
marRp,0.5,1,1,TCAACAGTAGCGCCATGTTT,0,2253279
marRp,0.5,1,1,TCAAAGGTTCGTTTTCTAGG,0,2219411
marRp,0.5,1,1,TATTGTTCGCCTTACAACGG,0,2239852
marRp,0.5,1,1,TATGTGGCAAGAGAAATTGG,0,2248157
marRp,0.5,1,1,TATGCGGAACTCCGACCAGT,0,2238680
marRp,0.5,1,1,TATGCGCGGATATTACCCCT,0,2248408
marRp,0.5,1,1,TATCGTGTCACCAGTTTTGA,0,2251834
marRp,0.5,1,1,TATCGGTGAACTACGAGAAG,0,2220117
marRp,0.5,1,1,TATATTCGATGTTAGTCATA,0,2241585
marRp,0.5,1,1,TATACGGTACTGATTCGTGG,0,2234171
marRp,0.5,1,1,TAGGTAAATGAGACGATACT,0,2238747
marRp,0.5,1,1,TAGGACACGAGGTTAAGTCT,0,2230461
marRp,0.5,1,1,TAGGAAACTTGGTGTGAGAC,0,2236716
marRp,0.5,1,1,TAGCTGTGTCAATGACCGTT,0,2230080
marRp,0.5,1,1,TAGCGGTATATCTGCAAGGG,0,2241393
marRp,0.5,1,1,TAGCGAGATGATCCGGGACT,0,2241676
marRp,0.5,1,1,TAGCAGATGCAGTGACAATT,0,2221639
marRp,0.5,1,1,TAGCAATGCGTGAAGTCGTA,0,2230642
marRp,0.5,1,1,TAGCAAATCTAGCATAATCA,0,2255927
marRp,0.5,1,1,TAGCAAAAGAGTAATCGTGA,0,2233355
marRp,0.5,1,1,TAGAGTTCGTGTCCTTTTAG,0,2243080
marRp,0.5,1,1,TAGACGCGCTAAGTGTAGCA,0,2249329
marRp,0.5,1,1,TAGAAGGATGTTTCATTAGT,0,2230010
marRp,0.5,1,1,TACTGTTCTGCACGATATGG,0,2239806
marRp,0.5,1,1,TACTGGGGCGATAGGACAGA,0,2223570
marRp,0.5,1,1,TACTCATGGATCGTTAACGG,0,2221073
marRp,0.5,1,1,TACGGCGTGTAGTTGCATGA,0,2260800
marRp,0.5,1,1,TACGAGTCATACCATAGGCA,0,2256054
marRp,0.5,1,1,TACCTTGAACACTTCAAGAA,0,2254854
marRp,0.5,1,1,TACCCCTTATGACGGGAGAT,0,2224727
marRp,0.5,1,1,TACACAGACCCGCTTAAGCA,0,2232856
marRp,0.5,1,1,TAAGGTCCCAACGGACGCCA,0,2232938
marRp,0.5,1,1,TAAGAGTGGGTGATATAATA,0,2222648
marRp,0.5,1,1,TAAGAGGGTACACGGTAGGA,0,2259400
marRp,0.5,1,1,TAAGAAGGGCCTAGGCGTCG,0,2244741
marRp,0.5,1,1,TAACTTAGTTCACCAGGATA,0,2237522
marRp,0.5,1,1,TAACGCCCGTCTGCGGCCAG,0,2239916
marRp,0.5,1,1,TAACACAATGGCAGTCTATA,0,2242661
marRp,0.5,1,1,TAAAATGACTCGAGGCATGT,0,2229855
marRp,0.5,1,1,TAAAACTACATCGTTCAAGA,0,2234821
marRp,0.5,1,1,GTTTGAGGTGCCTGTAACCC,0,2220387
marRp,0.5,1,1,GTTTCTGTCGCCTTAAGCAG,0,2229390
marRp,0.5,1,1,GTTTCGCCTATTGGAAAGAT,0,2224285
marRp,0.5,1,1,GTTTCGAACTGCGTGTGGCT,0,2259138
marRp,0.5,1,1,GTTTCCTTTTACTCCTACTA,0,2250135
marRp,0.5,1,1,GTTTCATGGGCCAAGCAGAT,0,2255723
marRp,0.5,1,1,GTTGGTTCAATCGGCGTGCT,0,2220965
marRp,0.5,1,1,GTTGGGGCAGGTGGTACGAG,0,2244416
marRp,0.5,1,1,GTTGGCCTTTGATCGCGGGG,0,2225192
marRp,0.5,1,1,GTTGAATTAGTACTTGTGGC,0,2229996
marRp,0.5,1,1,GTTCGTCCCAAGCGTACACT,0,2247335
marRp,0.5,1,1,GTTCGCACAATTTGGTCCGA,0,2225445
marRp,0.5,1,1,GTTCGAATGAATCATGACAA,0,2258090
marRp,0.5,1,1,GTTCCCAAGTGCCAGCCCTT,0,2242286
marRp,0.5,1,1,GTTCAGAAACGCGTTAAAGA,0,2256824
marRp,0.5,1,1,GTGTTGACAGTATCAGCGCC,0,2219952
marRp,0.5,1,1,GTGTGAACTGCTATGGGACT,0,2233566
marRp,0.5,1,1,GTGGTGTTTAGAACATATCT,0,2245967
marRp,0.5,1,1,GTGGTGGACTAGGTTTTTAC,0,2252488
marRp,0.5,1,1,GTGGTAAGAGCTTCAATAGT,0,2253888
marRp,0.5,1,1,GTGGGCGACTACCCAATCCG,0,2225291
marRp,0.5,1,1,GTGGCGCCGAATAATAGAGA,0,2226339
marRp,0.5,1,1,GTGGCATGACCTAAACTCTT,0,2239436
marRp,0.5,1,1,GTGGACTAGCGTCTGAAAAA,0,2225978
marRp,0.5,1,1,GTGCAGTGGTTGGATCAATT,0,2237953
marRp,0.5,1,1,GTGAGTCCAAACGCAGAAGG,0,2260364
marRp,0.5,1,1,GTGAGGTGCCGCCGTCTCAC,0,2242445
marRp,0.5,1,1,GTCTCGCCTCTGTTAGTGAC,0,2247900
marRp,0.5,1,1,GTCTAAGTTCGCTACTGGAT,0,2258005
marRp,0.5,1,1,GTCGTGTGAGGACATGATCA,0,2222064
marRp,0.5,1,1,GTCGCGGTTCCTATTGGGGG,0,2230932
marRp,0.5,1,1,GTCGCCCTGTGTTTCGCAGA,0,2254446
marRp,0.5,1,1,GTCGAAGTGTTGCCATGGTT,0,2220908
marRp,0.5,1,1,GTCCTTGACTTTTCATTTCT,0,2241681
marRp,0.5,1,1,GTCCTCCACATGGTTTATCG,0,2253423
marRp,0.5,1,1,GTCCTAGTAACCAATCGGCA,0,2256960
marRp,0.5,1,1,GTCCGGCGTGTGTCCTCGAA,0,2249921
marRp,0.5,1,1,GTCCCCGACTTAAGATTCCG,0,2240669
marRp,0.5,1,1,GTCCAGCCGCGAGTCAGTTG,0,2224398
marRp,0.5,1,1,GTCATGGACAACTGATCGGC,0,2245087
marRp,0.5,1,1,GTCATCCAGGCATGGTTGTC,0,2251909
marRp,0.5,1,1,GTCAGACCTATGGGGATGAT,0,2226345
marRp,0.5,1,1,GTCACCTAGCGCGACTTACC,0,2244909
marRp,0.5,1,1,GTCAACCCTACAATTTAGAA,0,2258011
marRp,0.5,1,1,GTATGGTAACGGTTTTCAAG,0,2227704
marRp,0.5,1,1,GTATCATTTAGTGCGCGTTT,0,2227969
marRp,0.5,1,1,GTAGTGAAACGCATTGCTAT,0,2225809
marRp,0.5,1,1,GTAGGTCTCAGACTCCAAAA,0,2239508
marRp,0.5,1,1,GTAGGGATGATCGACGAGAT,0,2239496
marRp,0.5,1,1,GTAGACATGGCTCTCGGCAA,0,2220944
marRp,0.5,1,1,GTACTCTGCTCCCGCCGCTG,0,2234590
marRp,0.5,1,1,GTACGATTCGGTCATTTGTT,0,2244808
marRp,0.5,1,1,GTACCTTAGGGTTGGCAAAC,0,2227089
marRp,0.5,1,1,GTACCGAATATACTTAAACC,0,2232612
marRp,0.5,1,1,GTACCCTCTGCCCCATTCCA,0,2261059
marRp,0.5,1,1,GTACCCCTTTTAACCGCCCC,0,2224145
marRp,0.5,1,1,GTAAGGGGTTTGCCACCACT,0,2249369
marRp,0.5,1,1,GTAACGGTGTTCAACCAGCG,0,2218060
marRp,0.5,1,1,GTAACCGGTAGGGGGACACA,0,2247560
marRp,0.5,1,1,GTAAATTCCTATTGCTCAGC,0,2219526
marRp,0.5,1,1,GGTTGCTGTGTTTCGAGGTG,0,2259776
marRp,0.5,1,1,GGTTGCCTGGGGTCAGGCGG,0,2234001
marRp,0.5,1,1,GGTTGCATATTCCAAAGTAG,0,2256117
marRp,0.5,1,1,GGTTCAGGTACGACACATAT,0,2235871
marRp,0.5,1,1,GGTTATCTTCGTACCACAAA,0,2243478
marRp,0.5,1,1,GGTGCCCGGCGCGCCTGTAA,0,2224793
marRp,0.5,1,1,GGTCTTCCATCATGCGCGAA,0,2238583
marRp,0.5,1,1,GGTCTGAACTGACGTACTCG,0,2230725
marRp,0.5,1,1,GGTCGGGCCTCGCGGGAGTA,0,2243106
marRp,0.5,1,1,GGTCCGGGGTAGAGTATTTG,0,2248546
marRp,0.5,1,1,GGTCAGTTACCACAGCGCAA,0,2242677
marRp,0.5,1,1,GGTATTCGGAATAACCCCTC,0,2260479
marRp,0.5,1,1,GGTATACCCCAATTGTTTGA,0,2222060
marRp,0.5,1,1,GGTAGTCTCTCTAACAAGTC,0,2258642
marRp,0.5,1,1,GGTACTCCTCGGCCGGATGG,0,2239887
marRp,0.5,1,1,GGTACCTGCATATTGGCTAT,0,2218092
marRp,0.5,1,1,GGTAATGTGGGGGAAGGGCT,0,2257256
marRp,0.5,1,1,GGGTTATAAGGTCTTCAGAA,0,2238963
marRp,0.5,1,1,GGGTATTATGCACGGCAACG,0,2218105
marRp,0.5,1,1,GGGTATGGTGGCATGCATTC,0,2237803
marRp,0.5,1,1,GGGTACTGGGGATAGACAGC,0,2232429
marRp,0.5,1,1,GGGGCACCTTTTCATATGCT,0,2239696
marRp,0.5,1,1,GGGCTTGCCTTGCGCTAACC,0,2248637
marRp,0.5,1,1,GGGCGGCCTCGATATTCAAT,0,2232540
marRp,0.5,1,1,GGGCATGACGTCATGACAAG,0,2249583
marRp,0.5,1,1,GGGCACTCCCAGTTAGTGAT,0,2239055
marRp,0.5,1,1,GGGATAGCTGAGGGTTCTAT,0,2226303
marRp,0.5,1,1,GGGAGACAGACCTCGACTCT,0,2245796
marRp,0.5,1,1,GGGACATGCCAGTGATCAAG,0,2232972
marRp,0.5,1,1,GGGAAGATGAGTTATTTTAA,0,2255360
marRp,0.5,1,1,GGCTTGATGTATAGAACGAG,0,2240376
marRp,0.5,1,1,GGCTGTGTACTACAGGTGGT,0,2251674
marRp,0.5,1,1,GGCTCGTGTAACTCCATGGT,0,2256405
marRp,0.5,1,1,GGCTCCGATATCTAACTTGC,0,2237595
marRp,0.5,1,1,GGCTAGCCCTATAATAGACA,0,2236206
marRp,0.5,1,1,GGCGTTAATCGTCTGCCCTC,0,2231750
marRp,0.5,1,1,GGCGTCTACCCATTTACTCT,0,2224082
marRp,0.5,1,1,GGCGGCCAGTTCCCGTTTTG,0,2243704
marRp,0.5,1,1,GGCGAGTCACAAATACACCA,0,2247977
marRp,0.5,1,1,GGCGAGAGCTTCCGATAAGG,0,2219863
marRp,0.5,1,1,GGCCCGTGAACCGAAATGGG,0,2220168
marRp,0.5,1,1,GGCCACTCGCTGAGATTGTT,0,2250220
marRp,0.5,1,1,GGCCAACGCGCCCTATGCTA,0,2246629
marRp,0.5,1,1,GGCATCTACCTTTAAGGCTC,0,2234656
marRp,0.5,1,1,GGCAGAAGTTTGGGGCTCAC,0,2239492
marRp,0.5,1,1,GGCAAGGTTTCAAGCTCGTT,0,2239426
marRp,0.5,1,1,GGATGCAAACAAACGATTTT,0,2245584
marRp,0.5,1,1,GGATAGGAAAATTTCAACTT,0,2255806
marRp,0.5,1,1,GGAGTCTAGTGGTGTTCATA,0,2233603
marRp,0.5,1,1,GGAGGTATAGTCATTAATGC,0,2238241
marRp,0.5,1,1,GGAGCGTGCGTCACGTACGC,0,2226906
marRp,0.5,1,1,GGAGAATAACTAGATGGAGC,0,2253322
marRp,0.5,1,1,GGACTACCCTAAGCGCCACG,0,2220590
marRp,0.5,1,1,GGACGCGATGGACTATGCGT,0,2230535
marRp,0.5,1,1,GGAAGGTGCCCGACCCATAG,0,2261043
marRp,0.5,1,1,GGAAGCCGCAGGTGCGCGGA,0,2260785
marRp,0.5,1,1,GGAAAGGACCCTTGTCGTCC,0,2223112
marRp,0.5,1,1,GGAAAAGTTGCCATGCGGAT,0,2239667
marRp,0.5,1,1,GCTTGTATCAATACATGTCA,0,2244682
marRp,0.5,1,1,GCTTGTACTATGCTTGTCTT,0,2231855
marRp,0.5,1,1,GCTTGGTAGAGGGTCCCAAT,0,2227172
marRp,0.5,1,1,GCTTCGGTAGTTACTACAAT,0,2260103
marRp,0.5,1,1,GCTTCGAACCTCGCAAAAAA,0,2227624
marRp,0.5,1,1,GCTTACACGTGAATTATCCC,0,2234419
marRp,0.5,1,1,GCTGATCGATTTTCAAAACC,0,2247207
marRp,0.5,1,1,GCTCTTAGGGTCAACCCTTC,0,2222475
marRp,0.5,1,1,GCTCCGCTGAATCGGTTCAA,0,2239401
marRp,0.5,1,1,GCTCCGCCGGGTTGGAGACA,0,2228611
marRp,0.5,1,1,GCTCCCATGGTTACCTAATG,0,2259597
marRp,0.5,1,1,GCTACAAGTCGCTGCGTACG,0,2227509
marRp,0.5,1,1,GCGGTCACCGCTAGGCCTCG,0,2252474
marRp,0.5,1,1,GCGGGGTACCGGACGGCTGG,0,2231995
marRp,0.5,1,1,GCGGGGGTTTGCGAAGCACG,0,2222245
marRp,0.5,1,1,GCGGGGCGAGACGCTTGAGC,0,2231682
marRp,0.5,1,1,GCGGCTGACCCGCTAATATG,0,2236000
marRp,0.5,1,1,GCGGATTAACTCTCGGATGA,0,2251748
marRp,0.5,1,1,GCGCTTCGCAGCCTACCACG,0,2229827
marRp,0.5,1,1,GCGCGTAGAAGTGCCACCAA,0,2235425
marRp,0.5,1,1,GCGCAGTTTAGCGCCTCGAT,0,2248669
marRp,0.5,1,1,GCGCAAACAAGAATTTTTTC,0,2255580
marRp,0.5,1,1,GCGATTCGTGGGAAGTCGTC,0,2247203
marRp,0.5,1,1,GCGATCTCACGTAAGTTGCT,0,2248733
marRp,0.5,1,1,GCGAGTCCTAACCTCAATAG,0,2256545
marRp,0.5,1,1,GCGAGGATTACTGAGGTCAC,0,2234152
marRp,0.5,1,1,GCCTTTACGGAGGAATATTC,0,2236084
marRp,0.5,1,1,GCCTACGTTCTATCATGTGG,0,2227367
marRp,0.5,1,1,GCCTAATTGTAACCCGGGTA,0,2254254
marRp,0.5,1,1,GCCGTGAGTCGTCCGACCTA,0,2232463
marRp,0.5,1,1,GCCGTCTAGCGACACGCCAG,0,2260197
marRp,0.5,1,1,GCCGTACCAGCTCCTCTTCC,0,2238206
marRp,0.5,1,1,GCCGGTTACCCTGTGTTATG,0,2252873
marRp,0.5,1,1,GCCGATACACTTTCCACGTA,0,2237927
marRp,0.5,1,1,GCCGACCCAGCGCTCGGCAC,0,2244183
marRp,0.5,1,1,GCCCGTCCAGTTGGGACTAA,0,2234112
marRp,0.5,1,1,GCCCACAAGGAGAGACTCTG,0,2259356
marRp,0.5,1,1,GCCACTTCCGCTGAGGGTGT,0,2246436
marRp,0.5,1,1,GCCACTAGGTATAAACAATT,0,2247723
marRp,0.5,1,1,GCCACGTACCGGCTGCGCTA,0,2250311
marRp,0.5,1,1,GCCACACAGTGTAATCGGGG,0,2231237
marRp,0.5,1,1,GCATTGGCAATATAACAATT,0,2233384
marRp,0.5,1,1,GCAGAGAAAAGCTAGGCTGT,0,2229682
marRp,0.5,1,1,GCACTTTCTCTAGGGGGTGT,0,2236854
marRp,0.5,1,1,GCACAGGGTGACACTTTATT,0,2257457
marRp,0.5,1,1,GCACAAAAGAATCTTTAAAT,0,2257889
marRp,0.5,1,1,GCAATAACAGCATCTGACTT,0,2248923
marRp,0.5,1,1,GCAAGCGCAGACAGGTTTGA,0,2234197
marRp,0.5,1,1,GCAAAGAAACTGTTCAGGAA,0,2239617
marRp,0.5,1,1,GATTTTGTGCGAGCCACATC,0,2236158
marRp,0.5,1,1,GATTTGAAAATTACGCGGTT,0,2233169
marRp,0.5,1,1,GATTGCGTTCCGGCATCGGT,0,2230259
marRp,0.5,1,1,GATTGAACTACAGAGGCCTT,0,2259895
marRp,0.5,1,1,GATGGCTATAATCTGCTTAC,0,2234395
marRp,0.5,1,1,GATATGGTTGTTTAGCGGTA,0,2240214
marRp,0.5,1,1,GATAAATGGAATGTAGGGTT,0,2218234
marRp,0.5,1,1,GAGTTGTCCTCGAAAAGCGG,0,2218460
marRp,0.5,1,1,GAGTTCCTAACCATTACTTA,0,2229385
marRp,0.5,1,1,GAGTTAATGTCCAGTCTAAG,0,2219106
marRp,0.5,1,1,GAGTCCGCCTACGTGCTACA,0,2240855
marRp,0.5,1,1,GAGTAAGCTGAACCTGCTTA,0,2230931
marRp,0.5,1,1,GAGGTGATTAGGGACTTAGG,0,2241468
marRp,0.5,1,1,GAGGGGAACACTAACGATCC,0,2218046
marRp,0.5,1,1,GAGGAATTTGTTTTACTCCT,0,2245467
marRp,0.5,1,1,GAGGAATCGTCCAAGTGCAT,0,2253303
marRp,0.5,1,1,GAGCGATGGGTTCGTGCCGA,0,2256520
marRp,0.5,1,1,GAGCCCCGTCGTTCAGCCGT,0,2241174
marRp,0.5,1,1,GAGAGATACCTCTTCGAAGG,0,2236327
marRp,0.5,1,1,GAGACAGGTTAGGCCCCCCC,0,2249328
marRp,0.5,1,1,GAGAAGTAGTACAACAGACG,0,2259826
marRp,0.5,1,1,GACTCTAGCATGAGTTGCAC,0,2225527
marRp,0.5,1,1,GACTCAGGGTGGTTAGCTAT,0,2234709
marRp,0.5,1,1,GACGGTCCCAAAGACTCGGA,0,2220597
marRp,0.5,1,1,GACGGGTGCAATTTCACTAA,0,2244873
marRp,0.5,1,1,GACGGAGCATCACTGGTGCG,0,2225967
marRp,0.5,1,1,GACATTACAGCCATCTCTCA,0,2226022
marRp,0.5,1,1,GACAGTCTACTATATAGGGA,0,2236191
marRp,0.5,1,1,GACAGCCAATCGGCACTTAA,0,2254181
marRp,0.5,1,1,GAATTAGTTGGATTTATTGA,0,2221810
marRp,0.5,1,1,GAATTACATCTAAGGGAGCC,0,2242679
marRp,0.5,1,1,GAATCGAATTTATATAGCAC,0,2258842
marRp,0.5,1,1,GAAGCGGTCTACGCTTGATC,0,2219807
marRp,0.5,1,1,GAAGAGCATCTAGCCCAGGC,0,2235374
marRp,0.5,1,1,GAAGACCAACTCACTCTACT,0,2225538
marRp,0.5,1,1,GAACTGGCAACACTCTTTTT,0,2227953
marRp,0.5,1,1,GAACTCCCGCATCAGGCACA,0,2251163
marRp,0.5,1,1,GAACGTAATACTTACCTGGC,0,2257184
marRp,0.5,1,1,GAACGGCGCTCACGGTGTTT,0,2253884
marRp,0.5,1,1,GAACCCGTGTCCTCCGTAGC,0,2221352
marRp,0.5,1,1,GAAATCCAATGTGATAGGTG,0,2246350
marRp,0.5,1,1,GAAACGCCCTCATAGCTCAC,0,2239655
marRp,0.5,1,1,GAAAAAGAAGCGGTGGAAAA,0,2222610
marRp,0.5,1,1,GAAAAACTGCCTCACACCTC,0,2255455
marRp,0.5,1,1,CTTTGTGGGTACCGTGGAAC,0,2243685
marRp,0.5,1,1,CTTTGTAAACTTTAAAGACA,0,2249923
marRp,0.5,1,1,CTTTCGCGGTGCCAGCGCTG,0,2223449
marRp,0.5,1,1,CTTTCGCATTGCAAGTTGAT,0,2250609
marRp,0.5,1,1,CTTTATTGTCATGTTCTACC,0,2247116
marRp,0.5,1,1,CTTTATCTTATGACTTCTCA,0,2257776
marRp,0.5,1,1,CTTTAAGTCAGTAAGGGACT,0,2250292
marRp,0.5,1,1,CTTGGTATTGTATAACACTA,0,2227272
marRp,0.5,1,1,CTTGGATCCACGCTGTTAGC,0,2255102
marRp,0.5,1,1,CTTGACTGCACAGAACGTCC,0,2254277
marRp,0.5,1,1,CTTGACACACGCTGACGCAA,0,2220355
marRp,0.5,1,1,CTTCGCGTAGTGAAGTACTC,0,2254141
marRp,0.5,1,1,CTTCGCACGGAACGGCGGAT,0,2240681
marRp,0.5,1,1,CTTCAATGGAATGAACTGGA,0,2226546
marRp,0.5,1,1,CTTATGGCAGACATGCGGGT,0,2239054
marRp,0.5,1,1,CTTAATTCCAGTGGATCGTT,0,2225476
marRp,0.5,1,1,CTGTTTACCTTGAAATGAAG,0,2244186
marRp,0.5,1,1,CTGTGCAGAATGGTTCATTC,0,2219522
marRp,0.5,1,1,CTGTGATCTGCCACATTGCA,0,2237589
marRp,0.5,1,1,CTGTCTTGTTTTGAACTCGC,0,2222913
marRp,0.5,1,1,CTGTCTGGAGGGACCTGTCC,0,2230888
marRp,0.5,1,1,CTGTAGACGGGCCTGACAGC,0,2240421
marRp,0.5,1,1,CTGGTTGCATTATAGACAGC,0,2222512
marRp,0.5,1,1,CTGGTTCGCCGGAGTTCCAT,0,2251196
marRp,0.5,1,1,CTGGTGTGTGCATTGGCTAT,0,2224154
marRp,0.5,1,1,CTGGTAGCTGTTGATATTTC,0,2225948
marRp,0.5,1,1,CTGGGCCTCTCCCATAAGTA,0,2252201
marRp,0.5,1,1,CTGGATCGCGCAGCTAAGAA,0,2225286
marRp,0.5,1,1,CTGCTTCCGTGGGGCTAAGT,0,2247443
marRp,0.5,1,1,CTGCGCCCGCCCCACTATCT,0,2260140
marRp,0.5,1,1,CTGCGCCAGGAGCCCGGAAA,0,2236436
marRp,0.5,1,1,CTGCCGTGCACTGAGAAGTA,0,2238346
marRp,0.5,1,1,CTGCAACATCGCTGTTCAGC,0,2220174
marRp,0.5,1,1,CTGATTACGGTGCATGCATG,0,2236761
marRp,0.5,1,1,CTGAGCGTTACTTGAGAATG,0,2260581
marRp,0.5,1,1,CTGACCGTAGGTCCATTTAC,0,2236891
marRp,0.5,1,1,CTGACAATACCATTAAGAAG,0,2224985
marRp,0.5,1,1,CTGAAGCGGCTGCCGTCCCG,0,2260908
marRp,0.5,1,1,CTCTTTTGGACAGGTACCGA,0,2228011
marRp,0.5,1,1,CTCTTGAATCGCGGCTTCTT,0,2229735
marRp,0.5,1,1,CTCTTCTATCCTCTTATAGT,0,2237499
marRp,0.5,1,1,CTCTTCATCGAATCGGGATA,0,2226858
marRp,0.5,1,1,CTCGGGATCGAACCCATTAC,0,2247275
marRp,0.5,1,1,CTCGGAAAGGCATACAGGGC,0,2254498
marRp,0.5,1,1,CTCGCCTGAGTCAGGTACAG,0,2229132
marRp,0.5,1,1,CTCGATATTCGAGATACGCA,0,2252975
marRp,0.5,1,1,CTCGAACGACCCACTGTTGT,0,2251433
marRp,0.5,1,1,CTCCTTAGTCTAGGGGTTCT,0,2255075
marRp,0.5,1,1,CTCCTGCGTTGTAACGCTTT,0,2258025
marRp,0.5,1,1,CTCCCTGCGTTAGGAATAGA,0,2242021
marRp,0.5,1,1,CTCCAGAGAGTCATGGCCTG,0,2254865
marRp,0.5,1,1,CTCACGACTTGACTTAACTG,0,2230792
marRp,0.5,1,1,CTCAAGCAGAGACATCATTG,0,2244110
marRp,0.5,1,1,CTCAAGATGTAATGAGATCA,0,2220338
marRp,0.5,1,1,CTCAAAATCCACCTGGGTCT,0,2247541
marRp,0.5,1,1,CTATGGATCTTGCGCTGCGC,0,2252591
marRp,0.5,1,1,CTATCTGTTAAGAGGACTAT,0,2222493
marRp,0.5,1,1,CTATAACCAGAAGCATGTAG,0,2251280
marRp,0.5,1,1,CTAGGCGGTGCAATGAGCGC,0,2260436
marRp,0.5,1,1,CTAGGAAGTGGTGCTGGTAG,0,2225808
marRp,0.5,1,1,CTAGATGATAAACGCATAAC,0,2259716
marRp,0.5,1,1,CTACGAGCGCACCGCCACGG,0,2257551
marRp,0.5,1,1,CTACCCAGGGGGTTGAGCTA,0,2226294
marRp,0.5,1,1,CTAATACATGGGAGCACGGC,0,2235674
marRp,0.5,1,1,CTAAGTATTACACGCTTTCG,0,2239622
marRp,0.5,1,1,CTAAGGTACCTCAAGACAAC,0,2249218
marRp,0.5,1,1,CTAAGAATCTTTCTTCACGT,0,2249976
marRp,0.5,1,1,CGTTCACTCACTTCCCAAAA,0,2226103
marRp,0.5,1,1,CGTGTTACAATCAGCAATCT,0,2247878
marRp,0.5,1,1,CGTGTCACTTGGCAGGGGCT,0,2254860
marRp,0.5,1,1,CGTGTCAACTAGATCAAAGG,0,2233044
marRp,0.5,1,1,CGTGGGTGATTATCATAGGT,0,2225207
marRp,0.5,1,1,CGTCTTGATTAGAGCTCAAA,0,2238207
marRp,0.5,1,1,CGTCTGAGGGCACATCATCA,0,2224978
marRp,0.5,1,1,CGTCTCAATATGTTTCTATA,0,2254621
marRp,0.5,1,1,CGTCGTAACCATCTAAAGTG,0,2234581
marRp,0.5,1,1,CGTCCTAGAGACGGCGGTGA,0,2255625
marRp,0.5,1,1,CGTCACCATAAACCATAGCG,0,2227730
marRp,0.5,1,1,CGTATTTGCTTTCTTAGACT,0,2236273
marRp,0.5,1,1,CGTATGGCTTAACCTCCTGA,0,2242504
marRp,0.5,1,1,CGTATCACCCGTCACAGGCT,0,2256315
marRp,0.5,1,1,CGTAGATGCCGGCGGTGAGC,0,2241205
marRp,0.5,1,1,CGTACTCCCGGGTCATGAGC,0,2259456
marRp,0.5,1,1,CGTACCTGGGCCGTATGTCC,0,2227379
marRp,0.5,1,1,CGGGCTTCATTGACCTTTTT,0,2223848
marRp,0.5,1,1,CGGGAGTATCGCGTGAAGGG,0,2244490
marRp,0.5,1,1,CGGCTGGCAATCGGACAGAT,0,2219112
marRp,0.5,1,1,CGGCCCGTTGTCATAAACCA,0,2223613
marRp,0.5,1,1,CGGCCACTACCTCCCCCGTA,0,2233457
marRp,0.5,1,1,CGGCAAACCTGACTCGCCTT,0,2223705
marRp,0.5,1,1,CGGATCGCGTTCCTACAAGG,0,2240132
marRp,0.5,1,1,CGGATCCTTGCCCAGCCCAA,0,2259413
marRp,0.5,1,1,CGGACATTAGCAGCTTATAG,0,2254192
marRp,0.5,1,1,CGCTGTGCGGGTCGATCAAA,0,2246936
marRp,0.5,1,1,CGCGCGTGCCCTGCAATACA,0,2249214
marRp,0.5,1,1,CGCCGCAGGTAGGGGAACCG,0,2226990
marRp,0.5,1,1,CGCCCACAACTATCCAGGAG,0,2252768
marRp,0.5,1,1,CGCCATGGCAGTGCAAGACG,0,2242819
marRp,0.5,1,1,CGCCACTACCTTACTGCAGT,0,2230047
marRp,0.5,1,1,CGCATGGTAGCGAGGGAGTA,0,2258256
marRp,0.5,1,1,CGCAGCGATCCTCCCGGAAT,0,2228775
marRp,0.5,1,1,CGCACGGTAAGACCGGACTA,0,2219209
marRp,0.5,1,1,CGCACCTTTTGCTTAAAGGT,0,2239956
marRp,0.5,1,1,CGCAATGACAGCTGCGGATT,0,2234887
marRp,0.5,1,1,CGCAAGACGCGTTAAGCCTT,0,2222346
marRp,0.5,1,1,CGCAACCTGGATGATTCTAT,0,2242143
marRp,0.5,1,1,CGATTATGCAACTCCAGACG,0,2247867
marRp,0.5,1,1,CGATGTTCCCCCACTTGTCA,0,2237901
marRp,0.5,1,1,CGATAAAACAAGTTATTGAC,0,2257242
marRp,0.5,1,1,CGAGGGCTCTCTATAGCTCA,0,2258895
marRp,0.5,1,1,CGAGGGCACGGACCGCGGCA,0,2224280
marRp,0.5,1,1,CGAGCGTTCCGTAAATTCGG,0,2227540
marRp,0.5,1,1,CGACTTACTTGAATCTACGC,0,2249589
marRp,0.5,1,1,CGACTGCTGGAAGGCGGCGT,0,2223547
marRp,0.5,1,1,CGAAACATATTTCTAGATCC,0,2223480
marRp,0.5,1,1,CCTTTCAAAAACAGGCTCTA,0,2260684
marRp,0.5,1,1,CCTTATGCTAACGGTATCCG,0,2223010
marRp,0.5,1,1,CCTTAATGACCTAGTGCTAT,0,2260079
marRp,0.5,1,1,CCTGATGCTGGATGGCTAAC,0,2254947
marRp,0.5,1,1,CCTCGTGCAACCTATTTTGT,0,2242761
marRp,0.5,1,1,CCTCACTGTCAATGGACCTT,0,2256508
marRp,0.5,1,1,CCTCAATCCTTTCCCCAAAG,0,2225542
marRp,0.5,1,1,CCTAGTGTGTTGACGAACAT,0,2251022
marRp,0.5,1,1,CCTAGGAACGGACCTGGGGC,0,2251660
marRp,0.5,1,1,CCTAGAGCATACCCAGCGAG,0,2247437
marRp,0.5,1,1,CCTACGGGCGGCAGGTGAGC,0,2253433
marRp,0.5,1,1,CCTACACAACCGCCCATGCT,0,2241275
marRp,0.5,1,1,CCGTGTTATGGGAGCCGCCT,0,2246309
marRp,0.5,1,1,CCGTGTACCATTTTCTTTAA,0,2248049
marRp,0.5,1,1,CCGTGCTGGATGTCAAACTC,0,2239193
marRp,0.5,1,1,CCGTACAAGGCGCCAGGTTC,0,2246483
marRp,0.5,1,1,CCGGTAAGGATAGCAAGCCA,0,2231132
marRp,0.5,1,1,CCGCTTCCGCCGTGCCAACA,0,2249242
marRp,0.5,1,1,CCGCTCTCGGAGCAACCCCA,0,2259514
marRp,0.5,1,1,CCGCTATACTGACCAATACG,0,2226948
marRp,0.5,1,1,CCGCTAGTGAGCCCCCGGCC,0,2239879
marRp,0.5,1,1,CCGCGTACTCCCTTACCGAG,0,2232979
marRp,0.5,1,1,CCGACCGTACTAAAACGAGG,0,2223552
marRp,0.5,1,1,CCGACATACGGAGGAGGTGT,0,2237973
marRp,0.5,1,1,CCGAATGAAGGACTCAAACA,0,2243246
marRp,0.5,1,1,CCCTCGAACCCAACCTCGAC,0,2225834
marRp,0.5,1,1,CCCTCAGATTAACTGGGTCA,0,2229675
marRp,0.5,1,1,CCCTCAAGCGCGTCACCAGC,0,2224256
marRp,0.5,1,1,CCCGCCCGCCTGTGCGATAT,0,2249330
marRp,0.5,1,1,CCCCTATCAATGGGACAGTG,0,2247423
marRp,0.5,1,1,CCCCCAGGAACCGTGTTTTC,0,2233104
marRp,0.5,1,1,CCCCAGGGTCCCACGAGGCA,0,2220430
marRp,0.5,1,1,CCCCAACTGGACAGGGTCTT,0,2230324
marRp,0.5,1,1,CCCATTTGTTGTATGACGAA,0,2236886
marRp,0.5,1,1,CCCATCGATGTGAGAAATGG,0,2246927
marRp,0.5,1,1,CCCAGGGAGCCCTCCCCTAA,0,2237065
marRp,0.5,1,1,CCCACGTACCCAAGATCGCT,0,2238806
marRp,0.5,1,1,CCCACGGACGGCACTCAGCA,0,2257531
marRp,0.5,1,1,CCCACCGTTGTATACTGTGT,0,2228376
marRp,0.5,1,1,CCCAACTCGTGCTTCCAGCG,0,2240351
marRp,0.5,1,1,CCATTCCGGAGGTCCATTCA,0,2233710
marRp,0.5,1,1,CCATCAGGGATGACTCCATT,0,2243840
marRp,0.5,1,1,CCATACACCCATCTGTGAAT,0,2222960
marRp,0.5,1,1,CCAGGCGGGTACTGGTGCTT,0,2241216
marRp,0.5,1,1,CCAGCGACCACGTTAGCACT,0,2247323
marRp,0.5,1,1,CCACTTGGCACGATAATCGC,0,2237307
marRp,0.5,1,1,CCACTAGAGTCTACGTCCCC,0,2245890
marRp,0.5,1,1,CCACCCCACGGTGAAACTGT,0,2241421
marRp,0.5,1,1,CCAATCAGTACTCGCGTCAC,0,2258613
marRp,0.5,1,1,CCAAGTTATATATCCTATTA,0,2246320
marRp,0.5,1,1,CCAACCTTATATGGTGGAAC,0,2252638
marRp,0.5,1,1,CCAACCTGGGATGGAAAATG,0,2249671
marRp,0.5,1,1,CCAAAGCACTACCATTTATT,0,2218793
marRp,0.5,1,1,CATTTGGGCCTCACAGCCAA,0,2225782
marRp,0.5,1,1,CATTTAGGATGGCAATCGAA,0,2219512
marRp,0.5,1,1,CATTGTCGCCTGGACAATCG,0,2238603
marRp,0.5,1,1,CATTGGCCCTACAAGGAATG,0,2254563
marRp,0.5,1,1,CATTCACATAAAGATTGTCT,0,2231228
marRp,0.5,1,1,CATTCAAGGATTGCCGGTAA,0,2231760
marRp,0.5,1,1,CATTAGAACACTGCGAGTTT,0,2231261
marRp,0.5,1,1,CATTACCACAGGCGGACAGT,0,2251695
marRp,0.5,1,1,CATGTAGTCGTGGTACCGCT,0,2236001
marRp,0.5,1,1,CATGCCGTATGCATCAGTGT,0,2223982
marRp,0.5,1,1,CATGAGACTAATTTCTATGA,0,2249586
marRp,0.5,1,1,CATCAAGGTCCTTATGGATA,0,2243072
marRp,0.5,1,1,CATAGTATTCATTTCGCGGG,0,2234276
marRp,0.5,1,1,CATAAGTCCCCGCACCAATG,0,2259797
marRp,0.5,1,1,CAGTGAGCGGCAACCTAACC,0,2228103
marRp,0.5,1,1,CAGTACTTAGGGAGTGAAGG,0,2225748
marRp,0.5,1,1,CAGTACTCGACATGGGATTC,0,2221620
marRp,0.5,1,1,CAGGTTGCGTCAGGTACTGA,0,2233250
marRp,0.5,1,1,CAGGTGTAATCTGGACTTGC,0,2248992
marRp,0.5,1,1,CAGGGTGACGCAGAAAATTG,0,2220062
marRp,0.5,1,1,CAGGGGTTTAGGATCAGGAG,0,2244217
marRp,0.5,1,1,CAGGGATCGTAAGTGTTCAG,0,2237055
marRp,0.5,1,1,CAGGCGGACCAGAGATCTCC,0,2258179
marRp,0.5,1,1,CAGGCCGGAGCTCAGGAGCC,0,2257452
marRp,0.5,1,1,CAGGCAAGATGTTAGCAGGA,0,2223548
marRp,0.5,1,1,CAGGACGGAAACTTACCGAC,0,2251273
marRp,0.5,1,1,CAGCTTTTACAGTGACATTG,0,2230001
marRp,0.5,1,1,CAGCGTCCTAGGCGGGGCTT,0,2224325
marRp,0.5,1,1,CAGCCGACCATACGGCAATT,0,2228923
marRp,0.5,1,1,CAGCCATCTTCCCCGATTAC,0,2221522
marRp,0.5,1,1,CAGCAAAGAGAAGTCGTGGT,0,2257092
marRp,0.5,1,1,CAGATCCCGGACTGAGTGTA,0,2242957
marRp,0.5,1,1,CAGAGTTTGGATGCGCTGAT,0,2224060
marRp,0.5,1,1,CAGAACGGCATAACATGTAG,0,2259851
marRp,0.5,1,1,CAGAACACGCCACGGCTGCT,0,2239965
marRp,0.5,1,1,CAGAAAACAGTTCTCGTCTG,0,2231870
marRp,0.5,1,1,CACTTCACATTGCACCTAGC,0,2252454
marRp,0.5,1,1,CACTGGATCCTCCCGATAAT,0,2226628
marRp,0.5,1,1,CACTAGAAACTCGCAGGCCA,0,2253196
marRp,0.5,1,1,CACGGTTTCATCAGACGTTA,0,2255758
marRp,0.5,1,1,CACGGCCGCATTATGGCGTA,0,2238410
marRp,0.5,1,1,CACGATTGAACTAGCAAGTT,0,2226959
marRp,0.5,1,1,CACGACTCAACGGACCTGTT,0,2235435
marRp,0.5,1,1,CACGAATGATCTGCAACAGC,0,2235179
marRp,0.5,1,1,CACCAGCACAGATGACTCCC,0,2229426
marRp,0.5,1,1,CACACCGGAGCGCTCCATTG,0,2226909
marRp,0.5,1,1,CACACCAATCGCCCGCATTC,0,2223383
marRp,0.5,1,1,CACAACTGTCTGAATACGAG,0,2236978
marRp,0.5,1,1,CACAAACAAAGAGCTACAGA,0,2228457
marRp,0.5,1,1,CAATTCCCAGAGCGACAGTT,0,2224109
marRp,0.5,1,1,CAATTATGTTTAATCAGGTC,0,2250039
marRp,0.5,1,1,CAATCCCAATTTCAGGGCAT,0,2219908
marRp,0.5,1,1,CAAGGGATCAACCGCAGGTA,0,2230179
marRp,0.5,1,1,CAAGGAGGCAGTTCTGACTT,0,2255759
marRp,0.5,1,1,CAAGCCAGATACCTCATGTA,0,2220887
marRp,0.5,1,1,CAAGAGTAAGTGTAGGCGGG,0,2235979
marRp,0.5,1,1,CAAGAGACAGGGAATGCCTC,0,2249352
marRp,0.5,1,1,CAACGATAGTCTGGGGATAA,0,2245154
marRp,0.5,1,1,CAACCTGTGCCACCTTGATC,0,2244509
marRp,0.5,1,1,CAACCAGTCCGTAGTACTAG,0,2246871
marRp,0.5,1,1,CAAATATTGGCCCGGCCTTT,0,2236063
marRp,0.5,1,1,CAAATACATCGCACGCCGTG,0,2256189
marRp,0.5,1,1,ATTTTTTGTAGATTAAGGCA,0,2251993
marRp,0.5,1,1,ATTTGTTCTTCGTGTAAATC,0,2233317
marRp,0.5,1,1,ATTTGGGTATCGCGGCATTA,0,2224406
marRp,0.5,1,1,ATTTGATGCCTATCGATCCA,0,2257721
marRp,0.5,1,1,ATTGGAGTCATTGCACGGGC,0,2231306
marRp,0.5,1,1,ATTGATCGCGCGATATTTTC,0,2233132
marRp,0.5,1,1,ATTCTCGGATCGCAATTCAG,0,2248954
marRp,0.5,1,1,ATTCGTTTCCTGTGTTGCTT,0,2259412
marRp,0.5,1,1,ATTCGCTTAGAAAAAAGAAC,0,2254591
marRp,0.5,1,1,ATTCCTCATTCTTACAAGAA,0,2255095
marRp,0.5,1,1,ATTCCATGGGGTCACCCCCA,0,2257415
marRp,0.5,1,1,ATTCAACAGCTTAGATATTT,0,2237033
marRp,0.5,1,1,ATTATGAAGCAACAACGGCC,0,2220755
marRp,0.5,1,1,ATTATACGTTTCTCTTGGCG,0,2246805
marRp,0.5,1,1,ATTAGGGTGTTGCGACGTTG,0,2256034
marRp,0.5,1,1,ATTAATTGGCAGGGTGTGAG,0,2218626
marRp,0.5,1,1,ATGTGTAGTATGTGCCGAGT,0,2246747
marRp,0.5,1,1,ATGTGCTTTTTCATGTACTC,0,2243816
marRp,0.5,1,1,ATGTGCCTACGAGAGACTAG,0,2254578
marRp,0.5,1,1,ATGTCTGGCTCTGTGGACTT,0,2232962
marRp,0.5,1,1,ATGTCACCACCCTATGACAT,0,2232104
marRp,0.5,1,1,ATGGTACCTTAAGTACGTGT,0,2251767
marRp,0.5,1,1,ATGGGATTAGTATTCTTTGG,0,2253106
marRp,0.5,1,1,ATGGGAAACAGAGCTGGAAC,0,2253686
marRp,0.5,1,1,ATGGCGCCCTGACCACATTG,0,2222561
marRp,0.5,1,1,ATGGCCTACACACAGGTTCA,0,2225111
marRp,0.5,1,1,ATGGACCTTGTAGTACTTGG,0,2243550
marRp,0.5,1,1,ATGCTCGTCTCCGGGTTCCC,0,2239975
marRp,0.5,1,1,ATGCTAAGCGGTCGGGCCAG,0,2224298
marRp,0.5,1,1,ATGCGTCTGTGGTGATGCAT,0,2228499
marRp,0.5,1,1,ATGCGCTTCCTAGGTAGAGC,0,2244162
marRp,0.5,1,1,ATGCCTGATCGGGCACCGTC,0,2251545
marRp,0.5,1,1,ATGCCAATGTCTGGGCGGCC,0,2240311
marRp,0.5,1,1,ATGCAGAAGCATCTGCAAAG,0,2254469
marRp,0.5,1,1,ATGCAATGAGCCGACCACAT,0,2245406
marRp,0.5,1,1,ATGATGTATCAAGGTACACC,0,2233326
marRp,0.5,1,1,ATGAGTATACAAACTCGTAC,0,2257167
marRp,0.5,1,1,ATGAATAAGATCGCGTGTCC,0,2228102
marRp,0.5,1,1,ATCGTAAGCTAATACTAAGA,0,2218148
marRp,0.5,1,1,ATCGGCCATCGTTCGACATT,0,2256210
marRp,0.5,1,1,ATCGATGCTACCAACTTGTA,0,2228790
marRp,0.5,1,1,ATCGAGTAACCCCGACACCA,0,2241463
marRp,0.5,1,1,ATCGAGGGGCCAAACCTAAA,0,2252972
marRp,0.5,1,1,ATCCTGTTTTTACATCACTC,0,2257653
marRp,0.5,1,1,ATCCTGAGGGGGAGGACCCT,0,2258375
marRp,0.5,1,1,ATCCGGCCGCTCGCACCCTC,0,2235663
marRp,0.5,1,1,ATCCCGTCTGTCCCATTTAT,0,2226991
marRp,0.5,1,1,ATCACAAGCAGCGTCGTGGC,0,2222766
marRp,0.5,1,1,ATATTATACTCAAGCTGATA,0,2251782
marRp,0.5,1,1,ATATCATCCTTGAACCCACA,0,2245082
marRp,0.5,1,1,ATATACGTGGGCGTAGCAAA,0,2225118
marRp,0.5,1,1,ATAGGGAGTACACTCGCTAA,0,2224836
marRp,0.5,1,1,ATACCGGCGTGTCTTAGGGG,0,2256069
marRp,0.5,1,1,ATACCATCATGGCAGTAGAG,0,2221038
marRp,0.5,1,1,ATACCACTAACTAACAGGTA,0,2234237
marRp,0.5,1,1,ATACATATGGCCGTACTTCT,0,2239700
marRp,0.5,1,1,ATAAGTGTTATTGAGATGGA,0,2260020
marRp,0.5,1,1,ATAAGGGACAACATCCTGCA,0,2222907
marRp,0.5,1,1,ATAAACGGCAGTGCATGGGT,0,2223851
marRp,0.5,1,1,AGTTAAGAAGTCGGCCACTG,0,2232946
marRp,0.5,1,1,AGTGTGTCAATCCCTCATAT,0,2254562
marRp,0.5,1,1,AGTGTGAACCAAGCGATCTG,0,2241910
marRp,0.5,1,1,AGTGTAACATCTGGTTGCGA,0,2222825
marRp,0.5,1,1,AGTGGGTCGCGTCGAAGTCC,0,2225863
marRp,0.5,1,1,AGTGGACGGTCTGCGCCAAC,0,2220312
marRp,0.5,1,1,AGTGAGATGATAGCAGTAGG,0,2218472
marRp,0.5,1,1,AGTCAAACAGGTGTTCAATC,0,2241027
marRp,0.5,1,1,AGTAGGGCTAAGTAATGTGT,0,2236128
marRp,0.5,1,1,AGTAATCTCAAGGCCTGTTA,0,2235037
marRp,0.5,1,1,AGGTTCGAAATACAGCGAAT,0,2247719
marRp,0.5,1,1,AGGTGTGGATCCGCGTAGCT,0,2256938
marRp,0.5,1,1,AGGTCGTAGGGGACTTAGTC,0,2252995
marRp,0.5,1,1,AGGGTTGGTCTAGTACGTGG,0,2243455
marRp,0.5,1,1,AGGGTGCTTTCAAGGGACTG,0,2231231
marRp,0.5,1,1,AGGGAATTCCGCGACATCAG,0,2234585
marRp,0.5,1,1,AGGCTTTGTAGCAACACTTC,0,2241155
marRp,0.5,1,1,AGGCTAGGTACGTAAAGCCC,0,2260776
marRp,0.5,1,1,AGGCGCCTACTAGGTTTCAA,0,2233570
marRp,0.5,1,1,AGGCCTTTCCTGGCCCCAAA,0,2257270
marRp,0.5,1,1,AGGATGGGTAAGCAAGCGGA,0,2240588
marRp,0.5,1,1,AGGACGCACATAGATGAGTC,0,2254742
marRp,0.5,1,1,AGGACATCAACATAGACACT,0,2236731
marRp,0.5,1,1,AGGACAGCAATTAGGAGAAC,0,2243325
marRp,0.5,1,1,AGCTTTACATAGCTCAGGAT,0,2254113
marRp,0.5,1,1,AGCTTGCCGATTAGTGGATC,0,2224582
marRp,0.5,1,1,AGCTTGATCATAGTCTACGG,0,2236506
marRp,0.5,1,1,AGCTGATCTAGTAATCATAC,0,2219981
marRp,0.5,1,1,AGCTGAATGCATTGGACGTC,0,2259839
marRp,0.5,1,1,AGCTCTTTTGGTGTCATTAG,0,2221107
marRp,0.5,1,1,AGCTAGGTGGCGAGATGCGG,0,2247943
marRp,0.5,1,1,AGCGTGATGATGCATTGCCG,0,2256103
marRp,0.5,1,1,AGCGGGCGCGGCATGGGATT,0,2232553
marRp,0.5,1,1,AGCGGATTGTCTTCGGCTCA,0,2246940
marRp,0.5,1,1,AGCGCACTTACGGCGTTTAA,0,2222698
marRp,0.5,1,1,AGCCGAGCTTAGAAGAATGT,0,2241386
marRp,0.5,1,1,AGCATGCACGCGTTAAACCC,0,2260281
marRp,0.5,1,1,AGCATGCAAGATCGATGCCC,0,2258604
marRp,0.5,1,1,AGCATCGGTTTTATTGCACC,0,2244140
marRp,0.5,1,1,AGCAGTTAATTGGGGTATCA,0,2248017
marRp,0.5,1,1,AGCACGGCCCTTCTCCAGTT,0,2240576
marRp,0.5,1,1,AGCACCTTTAATGGATTATT,0,2256671
marRp,0.5,1,1,AGCAAATTCATTAGTCAGGA,0,2226457
marRp,0.5,1,1,AGATTAATCGATTCTTTCAT,0,2256957
marRp,0.5,1,1,AGATGCAGTCATAACCATTC,0,2252248
marRp,0.5,1,1,AGATAGGACAATACGTCGTC,0,2221983
marRp,0.5,1,1,AGATACCAGTGCCGTAACTT,0,2239309
marRp,0.5,1,1,AGAGTTGTGTTGACGACACA,0,2235338
marRp,0.5,1,1,AGAGCCCCCTCTATACTATA,0,2241654
marRp,0.5,1,1,AGACTGTGACAAAGATTGAG,0,2225303
marRp,0.5,1,1,AGACATCTGCCGTTTACACA,0,2220165
marRp,0.5,1,1,AGACAGGCTGCTTCTGGCTC,0,2236169
marRp,0.5,1,1,AGAACTGAAGCAAAGTTGTA,0,2259360
marRp,0.5,1,1,AGAACCACTCTAGGGCCGTG,0,2237197
marRp,0.5,1,1,AGAAATCAGTGATCTAGGAG,0,2245385
marRp,0.5,1,1,ACTTTCGGCGGAATTATACA,0,2257451
marRp,0.5,1,1,ACTTTCCCATGCCATACCTA,0,2256565
marRp,0.5,1,1,ACTTGTGTCTAGTGAGTGTT,0,2253141
marRp,0.5,1,1,ACTTGTCTCTCCCACCTCCA,0,2244068
marRp,0.5,1,1,ACTTCCACGGACCGTGTGTT,0,2231297
marRp,0.5,1,1,ACTTCACTCTGTTAGTCCGC,0,2260868
marRp,0.5,1,1,ACTTACGCTCGCGGATTCTC,0,2254256
marRp,0.5,1,1,ACTGTGACGACTGTCTGTTT,0,2261112
marRp,0.5,1,1,ACTGTCTGCCTCCGTTTAGA,0,2241648
marRp,0.5,1,1,ACTGTCAATCTGGGGGAAAA,0,2240203
marRp,0.5,1,1,ACTGTAAAATTTGTGCATCA,0,2225208
marRp,0.5,1,1,ACTGGTCTATGCGAGCCTAA,0,2220964
marRp,0.5,1,1,ACTGGGTGAGCTGGCCATTG,0,2222297
marRp,0.5,1,1,ACTGCCCCCAACAAGGATAC,0,2259528
marRp,0.5,1,1,ACTGAAGAAAGCAATTCGAT,0,2223924
marRp,0.5,1,1,ACTCTTCATCGAAGCCCAGG,0,2237022
marRp,0.5,1,1,ACTCTAGAGTCATCCGCCAT,0,2229295
marRp,0.5,1,1,ACTCAAGCCCCAGTATTGTC,0,2220714
marRp,0.5,1,1,ACTATGGGCCACAGCTTACT,0,2219676
marRp,0.5,1,1,ACGTCAACCCGTAGAGTACG,0,2219233
marRp,0.5,1,1,ACGTAAAGCAGGGGACCCCT,0,2241470
marRp,0.5,1,1,ACGGTTAGTGTCTCTTTCAT,0,2255367
marRp,0.5,1,1,ACGGGTGACTGTGGCACCAC,0,2229045
marRp,0.5,1,1,ACGGGGGTAGACGTATCCAT,0,2249331
marRp,0.5,1,1,ACGGAGGAATCGCTTAGAAG,0,2241507
marRp,0.5,1,1,ACGGAAAGACCTTAGATCTT,0,2250145
marRp,0.5,1,1,ACGCACTTCTACTGCCTGTG,0,2247659
marRp,0.5,1,1,ACGATCGAGAATGGCCATTT,0,2222313
marRp,0.5,1,1,ACGAACGCGTGAACCAGAGC,0,2236040
marRp,0.5,1,1,ACGAACCGAACGAGCCAACT,0,2255889
marRp,0.5,1,1,ACCTGCGAGCGTCACGGCCC,0,2223609
marRp,0.5,1,1,ACCTACCTCCAATGCTCTGT,0,2244812
marRp,0.5,1,1,ACCGTTCACGTTTTAGCTGC,0,2223501
marRp,0.5,1,1,ACCGGGTTGCGGGGTACATG,0,2252498
marRp,0.5,1,1,ACCGGGCAACTATCCGTTTA,0,2246588
marRp,0.5,1,1,ACCGGCCGGGGGCGCGATCT,0,2222538
marRp,0.5,1,1,ACCGCATTATTCTTGGGGTG,0,2223054
marRp,0.5,1,1,ACCCGCCGCGGTAAAAGGGT,0,2245992
marRp,0.5,1,1,ACCAATAGCGTTCAGAATAG,0,2247839
marRp,0.5,1,1,ACCAAGTCGTAAGTTAGACA,0,2240675
marRp,0.5,1,1,ACATTGGGGGAGTTCCCAAC,0,2259738
marRp,0.5,1,1,ACATTCTCGGCCGCGGTGCA,0,2230216
marRp,0.5,1,1,ACATTCAATGATTTACCTTG,0,2218240
marRp,0.5,1,1,ACATGTCAATCTTGGCCAGT,0,2236073
marRp,0.5,1,1,ACATGCACCGCCAAGTAAAT,0,2226468
marRp,0.5,1,1,ACAGTTCCCCGCGTCAAACT,0,2256074
marRp,0.5,1,1,ACAGCTCTAATGATGGACGG,0,2260540
marRp,0.5,1,1,ACACTGTTCCTTGGCTGGTA,0,2227907
marRp,0.5,1,1,ACACGGTTATAATCGGTGCG,0,2230101
marRp,0.5,1,1,ACACATGGCGACTTAAACGA,0,2243574
marRp,0.5,1,1,ACACAGGCCCGCCTGTGAAT,0,2229015
marRp,0.5,1,1,ACAAGTCATCTACACAGAAC,0,2220260
marRp,0.5,1,1,ACAAGCAAGATTCTGACTCA,0,2256053
marRp,0.5,1,1,ACAAAGTGCGTGTAATTATT,0,2241179
marRp,0.5,1,1,ACAAAGCGGTTGATCAAGAT,0,2226537
marRp,0.5,1,1,AATTTGCTTGCTCTGTTCCC,0,2233641
marRp,0.5,1,1,AATTTCGAACTCTGCATCAC,0,2254689
marRp,0.5,1,1,AATTGGTTCTCTTCAGCTAC,0,2229212
marRp,0.5,1,1,AATTGGGTCGATGGGAGAGA,0,2259693
marRp,0.5,1,1,AATTGCTAGTGGAGAGGCGG,0,2246603
marRp,0.5,1,1,AATTCGGGAAAGGAGTCGGA,0,2220016
marRp,0.5,1,1,AATTCGACCCAGCCCCGGCA,0,2227193
marRp,0.5,1,1,AATTCAGTCGCTCTGTATCC,0,2251459
marRp,0.5,1,1,AATTAATCAAGCATGATACA,0,2258901
marRp,0.5,1,1,AATTAAACTATAAAAGCCAC,0,2226917
marRp,0.5,1,1,AATGTTCGAAGTCAACAAGG,0,2246354
marRp,0.5,1,1,AATGGTGTTGGACGGCGATC,0,2256677
marRp,0.5,1,1,AATGGGCGGACCATAGGACA,0,2260891
marRp,0.5,1,1,AATGCGGATTGAGATCTAAG,0,2219408
marRp,0.5,1,1,AATGCCTTCAGATGCGAAAT,0,2257894
marRp,0.5,1,1,AATGCATCAAGGCCCACTGC,0,2238770
marRp,0.5,1,1,AATCTACAACCGGGCTTCAT,0,2246625
marRp,0.5,1,1,AATCAGAGGGCCGCTTAACT,0,2227208
marRp,0.5,1,1,AATATGTGGACTCACGTAGG,0,2221417
marRp,0.5,1,1,AATATAGTGGTCGGATGGTT,0,2255109
marRp,0.5,1,1,AATATAGATGGACGGACCGG,0,2230166
marRp,0.5,1,1,AATAGTACTATGTGGGAGTT,0,2239605
marRp,0.5,1,1,AATAGGTGTATAGTAGGGAC,0,2248919
marRp,0.5,1,1,AAGTTGTTCCGCCGAGCCCT,0,2254031
marRp,0.5,1,1,AAGTTGGCCCCGGTGAAATG,0,2221364
marRp,0.5,1,1,AAGTTACAGCTCTATGTCTA,0,2227545
marRp,0.5,1,1,AAGTCGGGTAAAGAGGCCCA,0,2244048
marRp,0.5,1,1,AAGTATGCCAGTTTATATCG,0,2246054
marRp,0.5,1,1,AAGTAAAGTTCAGGCCACTG,0,2260904
marRp,0.5,1,1,AAGGTCCGTGCGATTAGGCT,0,2219637
marRp,0.5,1,1,AAGGTAAGGAAGGCACGTAG,0,2248818
marRp,0.5,1,1,AAGGGGCGTAATAAACATCG,0,2231674
marRp,0.5,1,1,AAGCTGCAGTAATGAGCCCT,0,2251656
marRp,0.5,1,1,AAGCTAGACCTTGACGGAAA,0,2254228
marRp,0.5,1,1,AAGCCGGTTTTCCTAAGATG,0,2235427
marRp,0.5,1,1,AAGCCGACCTAAACCCGTCA,0,2222549
marRp,0.5,1,1,AAGATTGGAAAGTATACCGT,0,2233544
marRp,0.5,1,1,AAGACGGGGCGGGCCAAACA,0,2241220
marRp,0.5,1,1,AAGACCTGAGTTGCTCGCAG,0,2231449
marRp,0.5,1,1,AAGACATTTGTCTTATTGTG,0,2233137
marRp,0.5,1,1,AACTTTCTAACTATCGTCTG,0,2250228
marRp,0.5,1,1,AACTGGTCGGCTACGAGCAA,0,2259948
marRp,0.5,1,1,AACTCTTCTACAGGAACTTT,0,2228439
marRp,0.5,1,1,AACTCTATTGCGGGAGGTCC,0,2218699
marRp,0.5,1,1,AACGTCGGGTGCCGAAAAAA,0,2239132
marRp,0.5,1,1,AACGGTGCAGTAAACCCAGA,0,2257248
marRp,0.5,1,1,AACGGCTATTCGAATCACGC,0,2226331
marRp,0.5,1,1,AACGAAGCCGGTTCGTTGCT,0,2243363
marRp,0.5,1,1,AACGAACCGCGCGCGTGTTT,0,2230060
marRp,0.5,1,1,AACCTCAACGGAACGACGAC,0,2238486
marRp,0.5,1,1,AACCCCTGGGTTCCACGTTA,0,2253756
marRp,0.5,1,1,AACCCCCGCCTGTTTACCCG,0,2250146
marRp,0.5,1,1,AACCAGGGGTAACATCACAA,0,2259168
marRp,0.5,1,1,AACAGATGTCGAAGGTATCA,0,2249517
marRp,0.5,1,1,AAATTCCAGCCCTGTTAATC,0,2227343
marRp,0.5,1,1,AAATGTCTAACACAACAATA,0,2231896
marRp,0.5,1,1,AAATACTACACCCGGCAGTG,0,2240318
marRp,0.5,1,1,AAAGATAACGGAGTGTGTCC,0,2225922
marRp,0.5,1,1,AAAGAGACCCTCTTCCTGCG,0,2249201
marRp,0.5,1,1,AAACGCGCTCAGAATCAGTA,0,2234719
marRp,0.5,1,1,AAACCGTGTACGCCGCACTT,0,2248544
marRp,0.5,1,1,AAACACAGTTTCAACCATTT,0,2252247
marRp,0.5,1,1,AAAATGCCTTGTCTATGAGG,0,2256104
marRp,0.5,1,1,AAAACCCGGAGGCAGCCGCT,0,2249267
marRp,0.5,1,1,AAAACACAAGCTGTGGGCAG,0,2222540
marRp,0.5,1,1,AAAAAATACATACCCCATCG,0,2253743
marRp,293.0,292,0,GATGCCAGCCAAAGGGAGGT,292,2252960
marRp,223.0,222,0,CGGTGCGCACCTCTCAATCT,222,2227848
marRp,195.0,194,0,CCTGCGGGTTGTCTGCGAAC,194,2224950
marRp,179.0,178,0,TTGCAGAGGACTTTACAAGC,178,2227847
marRp,177.0,176,0,CGGTGGGAAGGTGGGGTCTC,176,2226842
marRp,175.0,174,0,CCCCAACGTTCTTCCGAATT,174,2230380
marRp,161.0,160,0,CGTCGCACGATCAATGCAGA,160,2246697
marRp,141.0,140,0,ACCGACGAGTGCGTTGTGCT,140,2253899
marRp,132.0,131,0,CTAAGTATGCTGCGCACGGG,131,2236876
marRp,118.0,117,0,CCGGAGTTGCGAACAATGCG,117,2221553
marRp,115.0,114,0,GGTAGGATGAGATCGGCCTT,114,2253056
marRp,113.0,112,0,ATCGCAAGGGCAATCGGCGT,112,2243369
marRp,112.0,111,0,CGCACTTCTGGGGTCAACCG,111,2238126
marRp,107.0,106,0,CTCCCTTTTGTCTCCTATGC,106,2257854
marRp,106.0,105,0,AGTCAGCAACGTACAGTCAT,105,2222763
marRp,104.0,103,0,ATCAAAAGGGTTAATAGGGG,103,2243375
marRp,102.0,101,0,TCTATCGCAGTCCTTTTCTT,101,2242344
marRp,98.0,97,0,TGGTATATGAACCAACCAAA,97,2221535
marRp,98.0,97,0,TCGGTTGTGCCTGGTAGTAT,97,2239248
marRp,98.0,97,0,GCCCGAAACATAGTCATTAG,97,2246694
marRp,96.0,95,0,CAAGAGTTTGACGGTGCATA,95,2228269
marRp,92.0,91,0,TTTAGCGAACGCAGTACCGA,91,2246700
marRp,90.0,89,0,CACGGCGCTCTAACCTTGAA,89,2244836
marRp,89.0,88,0,CTGATGCGCAGGCAACGGGG,88,2253059
marRp,86.0,85,0,GTACGAGTACGCGCGGCCGG,85,2232999
marRp,84.0,83,0,CTTGGCTCCTCCGTGGCATG,83,2240625
marRp,84.0,83,0,CCCCATGAGGTGCTAAAGAA,83,2218990
marRp,82.0,81,0,CATCGACTGGGATTAGGAGT,81,2248567
marRp,81.0,80,0,CTCTACACGGCGGCGTCCCA,80,2254085
marRp,79.0,78,0,AATAGCTGCATCAGGGGGGC,78,2260710
marRp,77.0,76,0,CAAGGCTAGCTCCACCGTCT,76,2240539
marRp,72.0,71,0,TCTCAACCGCAGCAATCGGT,71,2226831
marRp,72.0,71,0,GCTCTGGAGAAATGATGCCG,71,2226578
marRp,71.0,70,0,TGTTACTCCGAGGAATTCAG,70,2222847
marRp,70.0,69,0,ACACCTCGTACCTCAGCACC,69,2221573
marRp,68.0,67,0,CGTGGCCCCAACGTGTTTGT,67,2220508
marRp,66.0,65,0,CTTGAGGCCTGACCTGTCGG,65,2231181
marRp,64.0,63,0,TTCTGCGGTTAATCTACCCC,63,2248968
marRp,63.0,62,0,AATGTATGTGGTCTGCCGGG,62,2238119
marRp,62.0,61,0,TTGCAGAAAAGCCAGGGTGA,61,2255292
marRp,62.0,61,0,ATGCATAGAGGTGTTTGTTC,61,2260666
marRp,61.0,60,0,GTGGAGATACCATCTTGGTA,60,2228136
marRp,60.0,59,0,TATATCGAAAAGGCCTGTAC,59,2233971
marRp,60.0,59,0,CCCCCAGAATACGCAGTCAG,59,2228180
marRp,60.0,59,0,ATGCGTAGCTACGGTGTGTT,59,2261078
marRp,59.0,58,0,TGGAGTACCCACACACGTTC,58,2231859
marRp,58.0,57,0,CGGCTGTGCAAGACGGGCTC,57,2219041
marRp,57.0,56,0,TGGGTACAAAACATGTGGAG,56,2230471
marRp,57.0,56,0,TCTTTCCGGCATGTGCAAGT,56,2221872
marRp,57.0,56,0,CTGAACTTATCTTACAATAA,56,2232724
marRp,57.0,56,0,CAACATTCAAGGCTGCAACC,56,2230469
marRp,55.0,54,0,TACCACGAGGAAATGAACGA,54,2220238
marRp,55.0,54,0,GCACGTGAAACGTGGCCCGC,54,2246866
marRp,55.0,54,0,AGGAACCCCACAATGATCAA,54,2251721
marRp,55.0,54,0,AAGTTCACCGAATTCGCCTA,54,2248610
marRp,54.0,53,0,TTCACCTTGTTGTCACGTGA,53,2255990
marRp,53.0,52,0,CAGACTTAGGTTTTCTCGGC,52,2228088
marRp,52.0,51,0,TGGCAGTCTATATTCGGGAT,51,2221273
marRp,51.0,50,0,GCCTGACCCTAATGAACGTG,50,2240803
marRp,51.0,50,0,ATGTATTCTGACGTCCGGAC,50,2261024
marRp,50.0,49,0,TAAAATTGGGCCTGAGATTA,49,2227104
marRp,50.0,49,0,CATCCATAATAGGACTTTAG,49,2247043
marRp,49.0,48,0,GTGGATCTGTGGTAGGTTCA,48,2234563
marRp,49.0,48,0,CGGATGAGGCAATGACCCAT,48,2224619
marRp,49.0,48,0,CCAACGTAGTGCTCGATCGG,48,2231376
marRp,49.0,48,0,AAAGTGAAGGATGGACAGTA,48,2257972
marRp,48.0,47,0,GGTTTAGCCTGGTAGCAGCT,47,2241925
marRp,48.0,47,0,GGACATCGACAGCCCATCAT,47,2248093
marRp,48.0,47,0,AGGTTTCTTTACACATCTCG,47,2248566
marRp,47.0,46,0,GCCGCCTGACACATATTCTT,46,2223685
marRp,47.0,46,0,AGCTGTAAACCAAGGTACAG,46,2240263
marRp,46.0,45,0,GAGATAGAGCTCCGCCACCC,45,2234338
marRp,46.0,45,0,GAAGGACACAGGGGAATGAT,45,2246002
marRp,46.0,45,0,CGTAGGCGTTGAACTCTGCT,45,2246016
marRp,46.0,45,0,AATCAAGGCTGTAACTTCGC,45,2241543
marRp,45.0,44,0,TTAAACTGTTAAATTCTCCA,44,2253069
marRp,45.0,44,0,TGTTCTGTCCCGGATAGTGT,44,2260055
marRp,45.0,44,0,TGTAACTCACAGGCAGAGCT,44,2257501
marRp,45.0,44,0,TCCCCGGACGTGTAGTTTGT,44,2254083
marRp,45.0,44,0,GACGCAAGTGCCTGATAGGT,44,2222356
marRp,44.0,43,0,TTGTCTAAGTGTGTGCGGCT,43,2225205
marRp,44.0,43,0,GCGAGTAGGCTCTAATGTAA,43,2255600
marRp,44.0,43,0,CCAGGCCGCCGTGGACTGAC,43,2241600
marRp,43.0,42,0,TCGGGGTCCCCGGTTCTAGG,42,2227096
marRp,43.0,42,0,TACCAAACCCGATACATTAT,42,2240630
marRp,43.0,42,0,GCTATAGCAGCCGCGTAGTG,42,2232124
marRp,42.0,41,0,ACTAAGGGGGAGCTCCATAA,41,2232216
marRp,41.0,40,0,TTGATGGACGTCGGCACCCT,40,2252091
marRp,41.0,40,0,CGAACGCACGACTATTTGGA,40,2221564
marRp,41.0,40,0,CCACCAGAACCAGAGATCTC,40,2227016
marRp,40.0,39,0,GTCCCGAGTAGAGGCAATGA,39,2243417
marRp,40.0,39,0,CTCTCCGAAATTACTGTGGC,39,2251615
marRp,40.0,39,0,CGTTTTATATGGTATGAAAC,39,2246712
marRp,40.0,39,0,ACGTCTCTCCGAGGCACAAA,39,2237458
marRp,39.0,38,0,CGCTCCTCCCAAACGTCCGA,38,2223261
marRp,39.0,38,0,AGTCTCCACCGACCGGGTTT,38,2241416
marRp,39.0,38,0,ACTCCCGCCGTTTGGGGTAA,38,2240784
marRp,38.0,37,0,TGTGCCACGTGGCTCGGTGT,37,2247045
marRp,38.0,37,0,TCTTGACCAGGCTGAATGTG,37,2254427
marRp,38.0,37,0,GAATACGGGCTCGTGGCACT,37,2222845
marRp,38.0,37,0,GAAACTCAGCAGAGACACAA,37,2239328
marRp,38.0,37,0,CTGGTATGAGATCATCGCCA,37,2232171
marRp,38.0,37,0,CGATCAGGTATGAACTTTAT,37,2236869
marRp,38.0,37,0,ATCGCAGCTTCCGTGGGCAT,37,2232726
marRp,38.0,37,0,AGGTTACAGGAATATTATTC,37,2256368
marRp,38.0,37,0,ACGACCTACTAGGGTCTAAA,37,2228964
marRp,37.0,36,0,GTTACCCGCCCCGGTCCAGT,36,2241432
marRp,37.0,36,0,GTATTGAGTCCCGAAAAGAA,36,2241129
marRp,37.0,36,0,GCAATAAGAAGGCGCGCATG,36,2233681
marRp,37.0,36,0,CGTATTGTGAATTACTGGAG,36,2257782
marRp,37.0,36,0,CGAGACGCCCTTCCAACTCA,36,2238947
marRp,36.0,35,0,TCTTGTACCGATGAGTATTG,35,2240021
marRp,36.0,35,0,TCGTTCACTGGTATACTAGA,35,2224818
marRp,36.0,35,0,TCGCGCAAAATCGGGGTCAA,35,2245039
marRp,36.0,35,0,TCCAGTCGCACGGGAGTATA,35,2232742
marRp,36.0,35,0,CAGTTTTTTCAATTCTTGCT,35,2253057
marRp,36.0,35,0,AGATGTAATTGAGTAAAAGA,35,2240619
marRp,36.0,35,0,AAGGCTTTACACTGGAGGCC,35,2228239
marRp,35.0,34,0,TGATAAAGGGGAGCAAGATG,34,2233744
marRp,35.0,34,0,TAATGCATAAGCACTGAGTT,34,2218653
marRp,35.0,34,0,GGGGGGACGCGTCCCTCCTA,34,2227018
marRp,35.0,34,0,CCCCAAGCGCTTAAATCGAA,34,2238308
marRp,35.0,34,0,CACCTAATCGAGACTTCTGC,34,2259729
marRp,35.0,34,0,CAACAATTTAAACCAAGCAA,34,2258403
marRp,35.0,34,0,ATTCTCCGAATTGCTTGGGA,34,2228629
marRp,35.0,34,0,ACGCTAGGCTCTGGGTAGCT,34,2256026
marRp,34.0,33,0,TGCTCCGTGGGTCGGCAACC,33,2256387
marRp,34.0,33,0,TATGCCATCATGCGGAACTA,33,2260542
marRp,34.0,33,0,CTTGTGCATGGGTAAAGTGA,33,2227102
marRp,34.0,33,0,CAACATTCAGTGTGGATCTA,33,2249530
marRp,34.0,33,0,AGTTTTCCAATCGCGATGTC,33,2222795
marRp,34.0,33,0,AGAAATGGGGACCGCTCTCG,33,2258296
marRp,34.0,33,0,ACAGTGGAAAATTTCCGCTA,33,2249043
marRp,33.0,32,0,TCGACAACGCGCGTTACAGG,32,2247744
marRp,33.0,32,0,GCTAGCCATACCTGCGGGAG,32,2234367
marRp,33.0,32,0,GAGGTTCAGGCCACTGCATC,32,2245999
marRp,33.0,32,0,CTGCGAATGTGTAGCATGGT,32,2247120
marRp,33.0,32,0,CTAATGTTGTTGACTAGGAT,32,2237452
marRp,33.0,32,0,AGGAGGTCTGCCTTTATTCT,32,2243305
marRp,32.0,31,0,CTCTTGAGCATTTGCGAGCG,31,2227859
marRp,32.0,31,0,CTCGCGCATTACAAGCGACG,31,2223677
marRp,32.0,31,0,CACTTGAAACGGCAAACAGG,31,2227037
marRp,32.0,31,0,AACCTGGCGTGGGGTTTTTC,31,2258443
marRp,31.0,30,0,TCGTTGACGAATGGGACTCA,30,2251223
marRp,31.0,30,0,GATACCAATATTGGGTGACT,30,2229989
marRp,31.0,30,0,CGTTGTTCCGTTTCCGCGGA,30,2252045
marRp,31.0,30,0,CGTGCAAAATCCGTTGCAAT,30,2257778
marRp,31.0,30,0,CGTAACCGACCAAGTTTATA,30,2248002
marRp,31.0,30,0,CAGATTGGAGACATGTCGCC,30,2220757
marRp,31.0,30,0,ACGCCTTCTTACTCGCTTAA,30,2229631
marRp,31.0,30,0,ACATGGATCAATTCGCCAAT,30,2240690
marRp,31.0,30,0,AATTACAACGGCGGTGAGGT,30,2240978
marRp,30.0,29,0,GGCCCGATCCAGCCCGTTCA,29,2245942
marRp,30.0,29,0,GCTTCATATTTTTGCCTTAT,29,2248453
marRp,30.0,29,0,GAGACTGTTCGGAAACTCAA,29,2255775
marRp,30.0,29,0,CTAGGGGGATTTGCAGTCGT,29,2255140
marRp,30.0,29,0,CGGATCAATGATTCTGACGG,29,2234540
marRp,30.0,29,0,CCACTCTCGTTCGCTGTATT,29,2222424
marRp,30.0,29,0,AGTCGCATGTCGCTGGACGC,29,2252783
marRp,29.0,28,0,TTTCGCATCAGACTTCCAGG,28,2232127
marRp,29.0,28,0,TGTAGTGATGTGTATGGAGT,28,2223228
marRp,29.0,28,0,TCTAGTCATGGTTAGGGAAG,28,2247622
marRp,29.0,28,0,GGCCTATCTTAACCGATGTA,28,2245052
marRp,29.0,28,0,GCTAGGACCGCAACAACCTC,28,2227853
marRp,29.0,28,0,ACAATGGTCTTATGGTTGTG,28,2246259
marRp,29.0,28,0,AATAGCCGTCCAATGAGACG,28,2243868
marRp,29.0,28,0,AACCCATACTAAGCTCTAGA,28,2251061
marRp,28.0,27,0,TTCTGGGCGACGGCGAAGCT,27,2237380
marRp,28.0,27,0,TGTCCCCTATTGACTTTCCA,27,2259747
marRp,28.0,27,0,TGAAAGCGGCCACGAGCACT,27,2243037
marRp,28.0,27,0,GACAAGCGGCAAGGTTCAGT,27,2230823
marRp,28.0,27,0,CGGCGGGTGTAACACGAGGA,27,2247253
marRp,28.0,27,0,CAGGAGCAAGGAGAAGTGCG,27,2257868
marRp,28.0,27,0,ATTTGTACCTCGTTCCAAAA,27,2254535
marRp,27.0,26,0,TGGTCTGATCGCTCACATTA,26,2218847
marRp,27.0,26,0,GTCCATAGTTTAGATAGTTC,26,2228973
marRp,27.0,26,0,GCGCCTGTGATTGGACAACT,26,2247968
marRp,27.0,26,0,GATTCGGATATTGTATTTTT,26,2245425
marRp,27.0,26,0,CGAAAATACCGAGGGAAGTG,26,2225885
marRp,27.0,26,0,CAAGGACTGATTATGTTCCT,26,2242348
marRp,27.0,26,0,AGGAGTTTTGCTAGTGGGCA,26,2242342
marRp,27.0,26,0,ACGGCGTACACCGGCTTGAA,26,2234336
marRp,27.0,26,0,AATAGGCCCACCTGTTCCTT,26,2239346
marRp,27.0,26,0,AACGAAAATAAATAGGACCT,26,2246867
marRp,26.0,25,0,TTTGCAGGACCTATTCCGGA,25,2244996
marRp,26.0,25,0,TAAAGCCTCAATCGGCATTG,25,2247113
marRp,26.0,25,0,GTACCTTACTGTGGGTGGTA,25,2218578
marRp,26.0,25,0,GGCTATGGATCTTCGGCACC,25,2253044
marRp,26.0,25,0,GCTGCGCCCTGGTTCCTGTT,25,2231877
marRp,26.0,25,0,GCGGCGATTACCAAGTCGAA,25,2228989
marRp,26.0,25,0,GATGTTTGCAACAGCCGAAT,25,2248537
marRp,26.0,25,0,CTAGTAGGCTGACGCCCCAT,25,2227098
marRp,26.0,25,0,CCGATTACAATTGTGCGTAC,25,2242190
marRp,26.0,25,0,CCAGAAACGTATAATTACGC,25,2256431
marRp,26.0,25,0,AGGCCTCTGGAGCATACCGG,25,2243297
marRp,26.0,25,0,AACATTTCTTCGTAAAGCTC,25,2253214
marRp,25.0,24,0,TGTATAGTATCCTAGCCGTA,24,2240547
marRp,25.0,24,0,TGGCGGAGCGCTGGCGTCCC,24,2255139
marRp,25.0,24,0,TCCGCTTGCCTTGCACCGAC,24,2223128
marRp,25.0,24,0,GTTTATCTCTTCGGCCGTCA,24,2235266
marRp,25.0,24,0,GGCACCCCGGGTTCATTAGT,24,2224616
marRp,25.0,24,0,CGTACATAAAGCGAAAAATT,24,2251637
marRp,25.0,24,0,CAAGTTATGGCAACTCGACA,24,2241008
marRp,25.0,24,0,CAACATATGCGGGCGTTAAC,24,2223075
marRp,25.0,24,0,ATGTTACATCTGCGACTCAG,24,2222409
marRp,25.0,24,0,ATGGCTTCCGCCACTATGCC,24,2238918
marRp,25.0,24,0,AGTATGAAAAGTGACAACCT,24,2237535
marRp,25.0,24,0,AAACCTTGCGGGTACGGGGA,24,2231888
marRp,24.0,23,0,TGTCTCCCTTTGCTGGTTCG,23,2232561
marRp,24.0,23,0,TGGGTTCGGCTTAGCATATT,23,2219005
marRp,24.0,23,0,TGCGAGATCCACATGGCTGT,23,2257381
marRp,24.0,23,0,TAGCCAGGGGGTGAGTGCAG,23,2220243
marRp,24.0,23,0,GACAATATAAATATGGCGAC,23,2250403
marRp,24.0,23,0,CTGACCTGTAGTCTTAAATC,23,2253897
marRp,24.0,23,0,CTCATAGACTCTATGCCGCA,23,2245048
marRp,24.0,23,0,CCCTTGGTCGCATGGGCGAT,23,2251738
marRp,24.0,23,0,CCCCAGGACAGTTAATCGTA,23,2240243
marRp,24.0,23,0,CCAGCTCTAATATCTTGGAT,23,2226249
marRp,24.0,23,0,CAGCGCAACGCCTTTCGAAC,23,2260365
marRp,24.0,23,0,ATACCGATCGACGTTTGGTG,23,2257345
marRp,24.0,23,0,AGGAAATGGTGTGAAGAGTA,23,2256999
marRp,24.0,23,0,AGCAGAGTGAAACTCACCGA,23,2240717
marRp,24.0,23,0,ACGCTTCGCAAGTATCGCGA,23,2237547
marRp,24.0,23,0,AACGTTTTAACCACCTAGAT,23,2251548
marRp,23.0,22,0,TTCACGACGGTCGTCCGTAT,22,2252903
marRp,23.0,22,0,TGCGTGTTTACGATTTCGCT,22,2259349
marRp,23.0,22,0,TGCCGCTTGGCCCGCCATGC,22,2229973
marRp,23.0,22,0,GTGAAACTTAGGTGGCCACT,22,2229463
marRp,23.0,22,0,GAGGTAGTCAGCAGTAGTAG,22,2260814
marRp,23.0,22,0,GACCTAGAACTGGCCAGGCG,22,2233296
marRp,23.0,22,0,CGCGTTCGACCTGATCAATA,22,2254080
marRp,23.0,22,0,CGCACTTCAGGAACTACTAA,22,2252655
marRp,23.0,22,0,CCAGTTGGGGGGCAGTCCGG,22,2256703
marRp,23.0,22,0,CATACACGCGCCGAGTTTAT,22,2222785
marRp,23.0,22,0,ACAGGTCAAGGCTGAGATCT,22,2235954
marRp,23.0,22,0,AAGCCAATGTCTCGGATGAT,22,2241040
marRp,22.0,21,0,TCTTAATGATAGTATGTCCT,21,2232201
marRp,22.0,21,0,TCGTCACATCGATCATCATG,21,2241509
marRp,22.0,21,0,TATCACCGTTAAGGTGCCAA,21,2235104
marRp,22.0,21,0,TAGGAAATCGAAACCTTAAC,21,2241143
marRp,22.0,21,0,TACCTAGGCCCAAGATTTAA,21,2223812
marRp,22.0,21,0,GGGGAGGCAAAGCTTGGAAG,21,2253033
marRp,22.0,21,0,GGCTGATGCGCTCGCATGCA,21,2232180
marRp,22.0,21,0,CTGTTTGTTCTACATATTTA,21,2227008
marRp,22.0,21,0,CTAACAAAGCCTATTGCGTT,21,2237554
marRp,22.0,21,0,CGGCCTTGGGCCACGTCGTT,21,2246698
marRp,22.0,21,0,CCTCAAAGGGGTGCCTGGCC,21,2239048
marRp,22.0,21,0,CATCGTTACCATCTACGGCG,21,2236499
marRp,22.0,21,0,ATGGCGGTGCTCTCCAAATG,21,2260755
marRp,22.0,21,0,ATGGAGGCCATCCCGAAAAC,21,2237464
marRp,22.0,21,0,ATGGAGAACGTAGGCCGTGG,21,2223413
marRp,22.0,21,0,AGTGTCCGTTCCTAAAAAAG,21,2228197
marRp,22.0,21,0,ACTTCTGCGACCTGATTAGT,21,2260635
marRp,22.0,21,0,ACCACACTTCCGATTCAGAC,21,2253911
marRp,22.0,21,0,AATGGAGAACATGAGTGGTA,21,2235683
marRp,21.0,20,0,TTCGGCATGATGTACCATGA,20,2260536
marRp,21.0,20,0,TGTAGCGAGTGTTTACATGC,20,2241897
marRp,21.0,20,0,TCGGCATTGTTTAACAAAGG,20,2247453
marRp,21.0,20,0,TCCTATGCCCTCACACTAAG,20,2234998
marRp,21.0,20,0,GCTATACGGAGATGTGGTCA,20,2230831
marRp,21.0,20,0,GAAAATGCGTCACGAACGCT,20,2252942
marRp,21.0,20,0,CCTCGGAGCAACAGATCTCA,20,2224858
marRp,21.0,20,0,CCGTTTTACGGCCGATTCTA,20,2256946
marRp,21.0,20,0,CAGCGGACAAGCGGGTGCTT,20,2252379
marRp,21.0,20,0,AGGGACATAGAACTTGCTTT,20,2219206
marRp,21.0,20,0,ACATGAAGCGCTGCCAGATA,20,2256866
marRp,21.0,20,0,ACAGTGAACGAGCCGAGACG,20,2235322
marRp,21.0,20,0,AATGCGAGTTCGTTTCTCAC,20,2245420
marRp,20.0,19,0,TTAAGACGTCCGATCCTATC,19,2241957
marRp,20.0,19,0,TGTTATGGGGACATCGCCTC,19,2245334
marRp,20.0,19,0,TCACACCATCGGTCTCCACT,19,2248156
marRp,20.0,19,0,TAATTGAACGAGTGGACGTG,19,2234542
marRp,20.0,19,0,GTCTTGCAGAGGACTCCAGT,19,2231221
marRp,20.0,19,0,GGTGCGTGTCCCGGAGAAGA,19,2229148
marRp,20.0,19,0,GGTAGCCCAAACATCATGGT,19,2237000
marRp,20.0,19,0,GATATTTATTGCTAAGTGAT,19,2220751
marRp,20.0,19,0,CTAACGCCTGCCGGGGCGCC,19,2227075
marRp,20.0,19,0,CGCGGTTCGGTTTCAGTGGT,19,2253260
marRp,20.0,19,0,AGCATAATTCAATACGCACG,19,2239053
marRp,20.0,19,0,ACTTCTGGTCCGGCGGATAG,19,2242551
marRp,20.0,19,0,ACTGCGAGGGATTAGGAATC,19,2230226
marRp,20.0,19,0,ACCTGCGATACTCTGGGATC,19,2257472
marRp,20.0,19,0,ACCCTGGGTGTTGAATACCG,19,2227070
marRp,20.0,19,0,ACATTCTGGTCAGGGCACGT,19,2243788
marRp,20.0,19,0,AAAGGAATCGTCTGGTAAGG,19,2230242
marRp,19.0,18,0,TTAACGGCCACCCCATTATT,18,2253968
marRp,19.0,18,0,TGTTAGGTAGGGCAGTATGT,18,2231084
marRp,19.0,18,0,TGCCGGCGCACCGCTAGGAT,18,2259238
marRp,19.0,18,0,TGACAATTAAAGACTACATA,18,2225412
marRp,19.0,18,0,TCGAATCTGCCGTTAGCTTC,18,2258719
marRp,19.0,18,0,TCCCAATCGGTGTCTACCGA,18,2254849
marRp,19.0,18,0,TAAAAATGAATACATCGCCA,18,2228250
marRp,19.0,18,0,GTAATCGTGTTGCTGGAACT,18,2260398
marRp,19.0,18,0,GGGGCTATGCCTCGAGTAGC,18,2251538
marRp,19.0,18,0,GAGTCTAATAACTCCGCCTT,18,2241784
marRp,19.0,18,0,GAACTGCGGACACCTGAACA,18,2236865
marRp,19.0,18,0,CGGAAAGCTGGTGAGTTGGT,18,2249539
marRp,19.0,18,0,CCTGCCACGAGCCAGTTAGG,18,2249766
marRp,19.0,18,0,CATAGGTAGCCGGACGAATG,18,2238043
marRp,19.0,18,0,CAATTAGCTTGGCATTATTG,18,2221794
marRp,19.0,18,0,ATTACTCCAGGCATTGGGTT,18,2224805
marRp,19.0,18,0,ATGTTAATGAGGGGAACCAA,18,2240899
marRp,19.0,18,0,ATGCTTCCTTGGCCATAGAG,18,2226154
marRp,19.0,18,0,AGTTTAAAGTAAGGTGAATA,18,2234561
marRp,19.0,18,0,AGGAAAAATCCCCAGGAGGA,18,2251718
marRp,18.0,17,0,TTGGGACGGCCGTATCGGCC,17,2219073
marRp,18.0,17,0,TTGGCCTTCATGGCAATTGG,17,2240617
marRp,18.0,17,0,TTCAAATGGGTGGTAGCGAG,17,2236306
marRp,18.0,17,0,TTACGACTACGGATCATACG,17,2257414
marRp,18.0,17,0,TGGTCAAAGGCGGGGGCGGT,17,2250165
marRp,18.0,17,0,TGGACCTAGGCTAAGTGACG,17,2248586
marRp,18.0,17,0,TGACGGTCTACTGCAAGGTA,17,2243296
marRp,18.0,17,0,TCTCCGTGACTGGACCGTAT,17,2248976
marRp,18.0,17,0,TATGGACTATAGTGCAGATG,17,2220792
marRp,18.0,17,0,TAGAAACCGTCTCGTGTAGG,17,2221795
marRp,18.0,17,0,GTTTGGCACAGCATAGAGAG,17,2248138
marRp,18.0,17,0,GGCTCAATGTGACGTGACCC,17,2217980
marRp,18.0,17,0,GGCGAGGGAAACGGGTTAAG,17,2243684
marRp,18.0,17,0,GGCCCTTCTGGATGTTTTTA,17,2236609
marRp,18.0,17,0,GATTAAACTCTGCGTAACAC,17,2243420
marRp,18.0,17,0,CTTCCAGAGGACAGCATACG,17,2226743
marRp,18.0,17,0,CTCTCTGTAAAGGTGACACC,17,2243804
marRp,18.0,17,0,CGTGGTACGTTAGTCGAATA,17,2241478
marRp,18.0,17,0,CGGTGGCATCTAGTCGAGAA,17,2240714
marRp,18.0,17,0,CGGCGGGAGAGCTATCTGTA,17,2231374
marRp,18.0,17,0,CCAGTAGTTTGCTTGAGCAT,17,2235194
marRp,18.0,17,0,ACGCGTAGATTAGGAAGGTT,17,2240034
marRp,18.0,17,0,ACCATTGTTGAGCGTGGTCG,17,2222275
marRp,18.0,17,0,AAGTTGCCAATTCCACGTGA,17,2237596
marRp,18.0,17,0,AAGGTCGGTGCCAACAGAAC,17,2260122
marRp,18.0,17,0,AAGCGAACGTGAGGCAACCA,17,2224546
marRp,17.0,16,0,TCTACTCCCCAGAGTTTTAC,16,2246994
marRp,17.0,16,0,TCGCATTCCTTGAGTGACTC,16,2237492
marRp,17.0,16,0,TCGATCGTGCGAGTGCGCGG,16,2220607
marRp,17.0,16,0,TATCGTTAACTCCATGCATG,16,2236275
marRp,17.0,16,0,GTACGGTCCGGTGTGTTTCA,16,2250842
marRp,17.0,16,0,GGTTGATTCGCGGTAGAATA,16,2229469
marRp,17.0,16,0,GGTGAATAGGACTCCAAGAT,16,2255627
marRp,17.0,16,0,GGCTCACGTCAAGTAGTTGA,16,2258590
marRp,17.0,16,0,CTGGGACAGACAGGGTCCTG,16,2258694
marRp,17.0,16,0,CGCGTCGTTTACGTCAACGA,16,2252949
marRp,17.0,16,0,CGCGGGCAATGCGGGAATGG,16,2242356
marRp,17.0,16,0,CCGATCTTTGCTCGGTAGTT,16,2252570
marRp,17.0,16,0,CCAGGGTTGGCTAATATCTT,16,2241596
marRp,17.0,16,0,CAGTATCGTGAAATGAAGCT,16,2257663
marRp,17.0,16,0,ATTGTGTCTTCTTGGATCAG,16,2252363
marRp,17.0,16,0,ATTCACTGAGCATGTACTGA,16,2250674
marRp,17.0,16,0,ATATGCGTGGGGGAACGCTG,16,2259281
marRp,17.0,16,0,ATATCCTAGGTTACGCCCCA,16,2222767
marRp,17.0,16,0,AGTGTTTACCCAGGTTCGTA,16,2226140
marRp,17.0,16,0,AGCTGTACGGGGCCAAGCGG,16,2220241
marRp,17.0,16,0,AGAGGCCGGATGGTTTTTTG,16,2218780
marRp,17.0,16,0,AAAGTTGGGATAAGACCTCA,16,2237245
marRp,16.0,15,0,TGATTGTCGTATTTTATCAG,15,2256379
marRp,16.0,15,0,TCCCCAGTCCGCACCTGTCC,15,2235287
marRp,16.0,15,0,TAAATTAGGGCATGTGAGCA,15,2226570
marRp,16.0,15,0,GTTGGATTTGAAGAATTTGG,15,2258404
marRp,16.0,15,0,GTGCCCAAAAGCTCCACAAA,15,2256331
marRp,16.0,15,0,GTCGCGGGGCGGTCAAGGTC,15,2224852
marRp,16.0,15,0,GTATTGGTTAGTCTAGCTTT,15,2236559
marRp,16.0,15,0,GGGGCATCGCGACACCCGTA,15,2218434
marRp,16.0,15,0,GCACTGGATTAGTTGGCTGT,15,2226594
marRp,16.0,15,0,GAGAATCGGTATAGGCGAGT,15,2237164
marRp,16.0,15,0,CCTAGACTGGCGGGCCTTCC,15,2239925
marRp,16.0,15,0,CCAGGCGCACCATGTAGCTC,15,2236816
marRp,16.0,15,0,CATCAGTAAATAATTCGTTA,15,2248005
marRp,16.0,15,0,ATTAGTCTATAGGATCGGCG,15,2219075
marRp,16.0,15,0,AGTCCGCCCGCATTATCGTT,15,2238106
marRp,16.0,15,0,ACGGTGGCAGATTCTTTTTA,15,2227648
marRp,16.0,15,0,ACGGCTTAGCAAGAAGCCCA,15,2251713
marRp,16.0,15,0,ACGGCAGTGGCTATGCCTTC,15,2235013
marRp,16.0,15,0,ACGCGGTAACGGGAATGGCG,15,2248481
marRp,16.0,15,0,ACGAGGCCGGGGCGACGAAA,15,2241505
marRp,16.0,15,0,ACCAAGGCCCGTTGTACAGT,15,2217964
marRp,16.0,15,0,ACCAACGTCATGTGTCGTGC,15,2249429
marRp,16.0,15,0,AATGGCCCCTCGGGGATGTG,15,2231758
marRp,15.0,14,0,TTCTGCTATAACACTACGGG,14,2225252
marRp,15.0,14,0,TTAGAGGCCTACCTCCCGAA,14,2230139
marRp,15.0,14,0,TGGTGCGGGAAACGGTTCAC,14,2226547
marRp,15.0,14,0,TGGGCCGCATACGAATGCCT,14,2247928
marRp,15.0,14,0,TCGCTATTTTTTCGCCCAAG,14,2255606
marRp,15.0,14,0,TAAGTTTAGTACGGCCGATA,14,2250298
marRp,15.0,14,0,GTGTGTGTTTTCTCTAAATG,14,2235638
marRp,15.0,14,0,GTGCTGGAGAGGGTGTCACA,14,2238307
marRp,15.0,14,0,GTCTCGTGTAAGCACATTAG,14,2258623
marRp,15.0,14,0,GTATACTGCGCGGTCCTATT,14,2223396
marRp,15.0,14,0,GGGAGGTAGTACAAGTCTGA,14,2248578
marRp,15.0,14,0,GGACACGCCGTTTAATAGTT,14,2240011
marRp,15.0,14,0,GCCCATAGAACAGGCGGCAT,14,2220786
marRp,15.0,14,0,GATGCCACCTGTTCGCCGGG,14,2250472
marRp,15.0,14,0,GACAACTCGACACTATATGT,14,2235249
marRp,15.0,14,0,CTATCGATCCGTGGAGCCTG,14,2229691
marRp,15.0,14,0,CGCAGGGGGTCATTGATAGG,14,2229632
marRp,15.0,14,0,CGAGTGAGTTTCATCTGATG,14,2237732
marRp,15.0,14,0,CCAGACCGGACCCGCCCTGG,14,2225700
marRp,15.0,14,0,CCAAAGGACTCGAAGTCGTA,14,2218246
marRp,15.0,14,0,CATTTATTCCTACTATAGGA,14,2221016
marRp,15.0,14,0,CAGTTGAGGACTCTTGCAAA,14,2238995
marRp,15.0,14,0,CACAGACATTCACTACGGTG,14,2224065
marRp,15.0,14,0,ATTCCCGAGGAGTCTAGGCT,14,2252287
marRp,15.0,14,0,ATGAGGTTCTGTCCTCCTCG,14,2242534
marRp,15.0,14,0,ATCCATCGCTCGACATACTC,14,2252916
marRp,15.0,14,0,AGTTCGTGAAGGGCAGAAAG,14,2260614
marRp,15.0,14,0,AGACTCTTTCATATTTTCTT,14,2236954
marRp,15.0,14,0,AAAAGAGGGCTTGTTTAAAG,14,2218333
marRp,14.0,13,0,TTTTCGTATTAGTATTCCAT,13,2245067
marRp,14.0,13,0,TTCATGTGCAGACCAGGATT,13,2229628
marRp,14.0,13,0,TGTGGTGTCTAAAAACGGTA,13,2245426
marRp,14.0,13,0,TGGTGCAGGGTTTCTATTTT,13,2245650
marRp,14.0,13,0,TGGGCTCGGTTTGCCACACT,13,2247366
marRp,14.0,13,0,TCGTTGCGTCATAGGTTAGG,13,2250547
marRp,14.0,13,0,TACGGGATAAGTCTGAAGCT,13,2237463
marRp,14.0,13,0,TACCTCACCGTTTAAGAGAA,13,2236548
marRp,14.0,13,0,GGGGATCGGCGATACGTTTC,13,2257862
marRp,14.0,13,0,GGAGCGAAGAGTGTTGTCGC,13,2228091
marRp,14.0,13,0,GCGTTACTCATTCCTCTGAA,13,2221579
marRp,14.0,13,0,GCAGGTTGTAAGTAATCATC,13,2230061
marRp,14.0,13,0,GCACACAGGTGACAAATTGA,13,2245688
marRp,14.0,13,0,GATCTCAGGCAATTTTTCAC,13,2240269
marRp,14.0,13,0,GATACGTCTGGGCACGATGG,13,2221455
marRp,14.0,13,0,GACCGCACGCAGCATGTTTC,13,2255312
marRp,14.0,13,0,GACAGACTCCGTGGCCCCAT,13,2251171
marRp,14.0,13,0,GACACTATGGTAGTCCTTGC,13,2221993
marRp,14.0,13,0,CTCCCCTACTGTGGCGTCAC,13,2259599
marRp,14.0,13,0,CGGCTGCTTTCTATTGAGCG,13,2254384
marRp,14.0,13,0,CCTGCCGTCTGGTACGCTAG,13,2233784
marRp,14.0,13,0,CCGCTCTCGCTCGCGTCAAT,13,2218829
marRp,14.0,13,0,CCGATAGACCCGTTCTAGCC,13,2254942
marRp,14.0,13,0,CAGCGCGATCTTATTCGGCA,13,2240623
marRp,14.0,13,0,CACCACCACCTGACTGGCAG,13,2231945
marRp,14.0,13,0,ATGTCACTGCTAATGCTCAT,13,2258507
marRp,14.0,13,0,ATCTGAATTAGCAAACGAAG,13,2247621
marRp,14.0,13,0,ATCCACAGCTTGCGCAAGGT,13,2251523
marRp,14.0,13,0,AGGGCTACATGTTTCCGGAT,13,2235664
marRp,14.0,13,0,AGACCCGCACTTAGTTAGGG,13,2258220
marRp,14.0,13,0,ACTTTCTTAGATAGCAGTGG,13,2257122
marRp,14.0,13,0,ACGGGAATCGTTCCCCTCAC,13,2247394
marRp,13.0,12,0,TTGCGGTTTGGAGCACTGAT,12,2256921
marRp,13.0,12,0,TGGCTCAAACACAGGAGTAA,12,2238205
marRp,13.0,12,0,TGCGATACAGAGCCTGAGGA,12,2247459
marRp,13.0,12,0,TGCCATGACTGAGTCCCCCA,12,2248225
marRp,13.0,12,0,TCTAAGCACGTCAACGCGGG,12,2260404
marRp,13.0,12,0,TAAAACACAACAAGTGAGGT,12,2229237
marRp,13.0,12,0,GTTTAATGGCTATAGTTAAT,12,2254977
marRp,13.0,12,0,GTTACCGGTCATCAGGACAC,12,2246858
marRp,13.0,12,0,GTACGTCCCATATTCTAGGC,12,2257485
marRp,13.0,12,0,GTACCAACGGCCGCCCAGTT,12,2249705
marRp,13.0,12,0,GGGTCATTGGCTTGATGTAG,12,2241527
marRp,13.0,12,0,GGCTACAGGGGTTCTGCGAA,12,2231488
marRp,13.0,12,0,GACACTACGCTATGCCCGGA,12,2222990
marRp,13.0,12,0,GACACCGTCAAGAATATATT,12,2237785
marRp,13.0,12,0,CTTAACGGTGCGTCTCGCAG,12,2225259
marRp,13.0,12,0,CTGCCAGCAGGCTTTCTTGG,12,2231363
marRp,13.0,12,0,CTCCTCTTGCCGTCCTTAGA,12,2260645
marRp,13.0,12,0,CTAAGTGCGGTACCTATGAT,12,2224610
marRp,13.0,12,0,CCTCAACAGCCATTCACACT,12,2227619
marRp,13.0,12,0,CCGAAGCAACTAAACCGCCG,12,2231377
marRp,13.0,12,0,CCCGCGCGTACGAGACGCCA,12,2233687
marRp,13.0,12,0,CCCCGTAACAGTGCATAAAT,12,2251165
marRp,13.0,12,0,CCCAAAGTGATAATTTAGCT,12,2238437
marRp,13.0,12,0,CATTGTCTTTAGCTCGAAGC,12,2228624
marRp,13.0,12,0,ATTGTAAAAAAGTTCAACGG,12,2233263
marRp,13.0,12,0,ATATATCGGGCGATTGCTAT,12,2236050
marRp,13.0,12,0,ATAGCTCTGATAAACGAAGA,12,2247308
marRp,13.0,12,0,AGGTCGAAGTACTTGGACTC,12,2245978
marRp,13.0,12,0,ACGTACGGGCTCAGGCCTCG,12,2243288
marRp,13.0,12,0,ACGCTCGTGCGAGGAGTGTC,12,2238181
marRp,13.0,12,0,ACGCGTAGTGGTACTTGGGG,12,2242492
marRp,13.0,12,0,AAATAAATGAGTCGTCCCTC,12,2231083
marRp,12.0,11,0,TTTCTTACGCTAACGGCTCT,11,2232581
marRp,12.0,11,0,TTATGCTTGTGCGGTTATTC,11,2221918
marRp,12.0,11,0,TCTCGAATTCGTCTCATTAA,11,2240871
marRp,12.0,11,0,TCATTGGCTAGTGTTGTAAC,11,2224613
marRp,12.0,11,0,TATTTCCTGTCGCGGATTAG,11,2225672
marRp,12.0,11,0,TAGGCTAGCCTTCTGAATGT,11,2223385
marRp,12.0,11,0,TAGGCATCGGTGGAGGAATT,11,2257483
marRp,12.0,11,0,TACGGCAGACATTTTTAACT,11,2218561
marRp,12.0,11,0,GTTCAGGTCCAAACCTGCGG,11,2228793
marRp,12.0,11,0,GGTTTTGCCTTCCGGAGGAT,11,2236053
marRp,12.0,11,0,GGTAACGGTTATAGGCGTAC,11,2259789
marRp,12.0,11,0,GGCGCGGATGCCGGCCTGAG,11,2249189
marRp,12.0,11,0,GGAGCCGGTAGACGCGCAAA,11,2255123
marRp,12.0,11,0,GCCGCCATGCGAATTAGATG,11,2237741
marRp,12.0,11,0,GCCACAAGTGCTTAGTTCTC,11,2240518
marRp,12.0,11,0,CTCGTTAAAAGAAGCTGTCG,11,2244538
marRp,12.0,11,0,CTACGATCTGTCGGCTCTGC,11,2238348
marRp,12.0,11,0,CTAAAACGTGTTTCTCCGAG,11,2219607
marRp,12.0,11,0,CGTTACGTGGAGCGAACCTA,11,2228917
marRp,12.0,11,0,CGGGAGACTGGGTATGGCAG,11,2246705
marRp,12.0,11,0,CGGACACGGCAAGAAGCCAT,11,2241231
marRp,12.0,11,0,CCGAACTAATGTCATGTGTC,11,2248853
marRp,12.0,11,0,CACCGCAGTACACAACAGAC,11,2233300
marRp,12.0,11,0,CACCGAGCAGGCCTCAATCA,11,2221548
marRp,12.0,11,0,CACCCCAGTACTCTTTGCAC,11,2239714
marRp,12.0,11,0,CAATCGGTCGCTGGGGTAGT,11,2246283
marRp,12.0,11,0,ATTCTTCGATCATAGCATAC,11,2242596
marRp,12.0,11,0,ATGGATTTGAATCGCCTGAG,11,2233755
marRp,12.0,11,0,AGTTACATGGTTCAAGTTCA,11,2257675
marRp,12.0,11,0,AGTCCATTAAAAAGGACCAG,11,2254110
marRp,12.0,11,0,AGTAGTTGTATAGGTGTGGT,11,2254430
marRp,12.0,11,0,AGGCTAATTTTACGTTAGCC,11,2241950
marRp,12.0,11,0,AGCAAAAATTTTTATACCAT,11,2218843
marRp,12.0,11,0,ACCTCACGCGGGTGTTTCTA,11,2241232
marRp,12.0,11,0,AATGTAGAGTAACAGTTCAG,11,2221880
marRp,12.0,11,0,AAGTTCGCAATCGTGCAGGG,11,2249684
marRp,12.0,11,0,AACTGCGAATGTGGTCGTGG,11,2259161
marRp,11.0,10,0,TTTGTTAGTCTCTCAGGATA,10,2238920
marRp,11.0,10,0,TTGGTTTCTAGGCCTATTAG,10,2222158
marRp,11.0,10,0,TGTACTCCATACGGTCCGAA,10,2250477
marRp,11.0,10,0,TGGTGGCGTAGCCAAGGTGC,10,2256804
marRp,11.0,10,0,TGGGCTAACAAACCCTCCGG,10,2220197
marRp,11.0,10,0,TCGGGTTTTAAACCCCGGTA,10,2243421
marRp,11.0,10,0,TCCGTCTAGTGATTATGCTC,10,2257481
marRp,11.0,10,0,TCACCTGGACAGCCCGTCGT,10,2241918
marRp,11.0,10,0,TCAAGCGACTGGGGAAGATG,10,2237731
marRp,11.0,10,0,TAGCCAGGTGGATATACTCA,10,2252573
marRp,11.0,10,0,TAGACCCCTGCGGTGTTCGG,10,2221266
marRp,11.0,10,0,TAATGAAGATCCTTCTTTTC,10,2219739
marRp,11.0,10,0,GTAAGCTTCTTGAGGCCTAT,10,2253900
marRp,11.0,10,0,GGGTATACGACCGAAGGTTG,10,2257290
marRp,11.0,10,0,GGCTAGAACGCGCAGACCGG,10,2245542
marRp,11.0,10,0,GGCAAGCTTGTACAGGCGCT,10,2230389
marRp,11.0,10,0,GGATCAAGCCTCTGTATCGT,10,2234557
marRp,11.0,10,0,GCGGCAAAGATGCACGTTCA,10,2257969
marRp,11.0,10,0,GCATTCTTCCGAACCCAGGT,10,2251613
marRp,11.0,10,0,GAGGGGTTGGGAACGTTTGA,10,2258510
marRp,11.0,10,0,GAGGGCAACACTCAGTGTGT,10,2226774
marRp,11.0,10,0,GAGATAGATGATCGAGGGGT,10,2224829
marRp,11.0,10,0,GACGCGAGGGTTTCATACCA,10,2226838
marRp,11.0,10,0,GACCCGCTTCCGTGAAATGC,10,2231793
marRp,11.0,10,0,CTTGTTCTTCAGATGAACCT,10,2261110
marRp,11.0,10,0,CTCAATTTCGGCCTGTGTGA,10,2223412
marRp,11.0,10,0,CCATTGCCAGACAATGGAAC,10,2255926
marRp,11.0,10,0,CCATACCGCGTAACCTTGGG,10,2256865
marRp,11.0,10,0,CCAGATTTTTTTGCAATACT,10,2238294
marRp,11.0,10,0,AGAATGGTTCGGAAGGGAGG,10,2258399
marRp,11.0,10,0,ACTTCTCGGAAATTCGCACA,10,2244575
marRp,11.0,10,0,ACCATAAGTCGCAGTCTTGT,10,2235113
marRp,11.0,10,0,ACAATAGTACTGCAGTTGTG,10,2243703
marRp,11.0,10,0,AACCAAAGAGCAATTGGGAG,10,2245286
marRp,10.0,9,0,TTTCTAATTCCACGTGCGTG,9,2259284
marRp,10.0,9,0,TTGTCCTTGATCACGGGTCT,9,2222860
marRp,10.0,9,0,TTGGTGGCGAAGATCTACTC,9,2221280
marRp,10.0,9,0,TTCTCAGCTCACTCTCTAAC,9,2228396
marRp,10.0,9,0,TTAGGTCGATTCTTCAGCGT,9,2250351
marRp,10.0,9,0,TGTTCACAGGTCAGCGTTTC,9,2220138
marRp,10.0,9,0,TGTACGTGGCGGGATGCAGT,9,2223512
marRp,10.0,9,0,TGGGTGAGGCAAAGAATAAG,9,2254449
marRp,10.0,9,0,TGCGTCTAAAGATTTATCGT,9,2251444
marRp,10.0,9,0,TGAGGGCCGAGAGTGTCTTC,9,2231847
marRp,10.0,9,0,TCTGCCCTCACCATGTGCGC,9,2251650
marRp,10.0,9,0,TCCGCGGCCGGGGCATCTGT,9,2249112
marRp,10.0,9,0,TCCCCACCAGATCAGGCCAA,9,2242369
marRp,10.0,9,0,TACTTGCTAAACCAATCGCA,9,2226729
marRp,10.0,9,0,GTTGTGGTACGTAGGGCGCA,9,2254907
marRp,10.0,9,0,GTGAACGCTCACGTAGATTA,9,2221837
marRp,10.0,9,0,GTCTACGGGTGGTTGGGCCA,9,2224618
marRp,10.0,9,0,GTCACAGGAGTCTCCACCTG,9,2224637
marRp,10.0,9,0,GGTAGGGTCCAACCATACCA,9,2233523
marRp,10.0,9,0,GGCTTTAACCCCCTTCATCT,9,2254078
marRp,10.0,9,0,GGCATAAGGACTTGAACAGC,9,2218417
marRp,10.0,9,0,GCTAAAGGAGGTGTTTTTGC,9,2218664
marRp,10.0,9,0,GCGTAAGTAGGTCGTTTCAG,9,2218797
marRp,10.0,9,0,GCCCGTCCCGGTCGATGGTG,9,2239251
marRp,10.0,9,0,GCCAGAGCCTAGTACCGCTT,9,2257654
marRp,10.0,9,0,GCCACTCACGTGGGAAAGAA,9,2246052
marRp,10.0,9,0,GATCGGCGGTGATCCCGGTG,9,2244429
marRp,10.0,9,0,GATCCGTATTGGATGGTTTA,9,2222488
marRp,10.0,9,0,GATAGACGGCGCGACCAATG,9,2221269
marRp,10.0,9,0,GAGCATCTTGTAAGCTCTGA,9,2220246
marRp,10.0,9,0,GACAAACTAACCGTGACTAC,9,2246422
marRp,10.0,9,0,GAATGGCACGGATCCTCCGG,9,2222159
marRp,10.0,9,0,GAAAGGTTTCGCACCCACCT,9,2257497
marRp,10.0,9,0,CTTTAGACGTAAGGACGTTG,9,2232221
marRp,10.0,9,0,CTAGCGATTCAAATGAAAAA,9,2228150
marRp,10.0,9,0,CTACGCCATTGCCTCTCTGT,9,2221288
marRp,10.0,9,0,CTAAATACGTCGGTTATCCA,9,2251349
marRp,10.0,9,0,CGGGCGACTAGCCCGGCCAA,9,2225921
marRp,10.0,9,0,CGGCTTTCCGAGGGGAGACT,9,2248912
marRp,10.0,9,0,CGGCACCACGGTTCGTGTAG,9,2260792
marRp,10.0,9,0,CGACAGGTAGACCGTCTCGT,9,2223808
marRp,10.0,9,0,CGAACATCGCTATTCCCGCG,9,2229890
marRp,10.0,9,0,CCTAGCCGGGCATCGCTACA,9,2256998
marRp,10.0,9,0,CCGGGGGGGGCCGCGCGGAC,9,2254119
marRp,10.0,9,0,CCAGACGGCGCCCAGTGTGA,9,2223491
marRp,10.0,9,0,CCAATAAGAGTAAGTCTTAC,9,2235291
marRp,10.0,9,0,CATTGGGAATCTACAACCGC,9,2237377
marRp,10.0,9,0,CATCCTGGCAACTCCTTATC,9,2246372
marRp,10.0,9,0,CATATGTACAGTTAACTACG,9,2231759
marRp,10.0,9,0,CAGGAGGTACTTTTTGTGAT,9,2218064
marRp,10.0,9,0,CACTGTATCAACTGCTCCAA,9,2236629
marRp,10.0,9,0,ATTAGATCGGTCTTGCGCCT,9,2232567
marRp,10.0,9,0,ATGATCCGGCTGTGTTATTT,9,2221631
marRp,10.0,9,0,ATCTAGGAAAACGATCAGGC,9,2256483
marRp,10.0,9,0,ATAGGAATGACGTAGATGAT,9,2238139
marRp,10.0,9,0,AGTTATGTGCGGCTCATTAC,9,2222191
marRp,10.0,9,0,AGGTCCTAGACGATATCCAG,9,2230818
marRp,10.0,9,0,AGGGTACGACCTGGGAGCGT,9,2220042
marRp,10.0,9,0,AGATCCCTGACCGGAGCCAA,9,2259585
marRp,10.0,9,0,AGAGTTGCCCGTTCATCCGT,9,2244418
marRp,10.0,9,0,AGAGCGTCTTATGGGCAACC,9,2251959
marRp,10.0,9,0,ACTCCTCTACAGTTAGCAAA,9,2222740
marRp,10.0,9,0,ACCTGAACGAATTTTGTAAT,9,2222856
marRp,10.0,9,0,AAGTGGCAACTTCCCTAACT,9,2260616
marRp,10.0,9,0,AAGGCTGAACGAGGTCAAGT,9,2236270
marRp,10.0,9,0,AAGCGTGTTGGATAGAAACA,9,2231986
marRp,10.0,9,0,AAACTGAGAATGTACTCCTA,9,2236633
marRp,9.0,8,0,TTTGGTGGGCAATGACATAA,8,2227069
marRp,9.0,8,0,TTCTAATCATAGGCTATACA,8,2255182
marRp,9.0,8,0,TGGTCGAAGATTCATCTAGC,8,2250416
marRp,9.0,8,0,TGCCGACTAATCGGGAAGTT,8,2230732
marRp,9.0,8,0,TCGGAGCCATACTTCTCGCG,8,2233291
marRp,9.0,8,0,TCCGAGTCTGAGCGTGAAGA,8,2235504
marRp,9.0,8,0,TCCCCACACAATAATGCATG,8,2247971
marRp,9.0,8,0,TCCCACGAAGCAGCGCGCTC,8,2253680
marRp,9.0,8,0,TAGACGTCGTCTATCGGCAG,8,2240536
marRp,9.0,8,0,TACTTGAGCGATTCCATTAT,8,2256330
marRp,9.0,8,0,TACCTGAGTCATTATGGCGG,8,2254346
marRp,9.0,8,0,TAATGTCGAGAGTTGCGTTC,8,2252008
marRp,9.0,8,0,TAAACACGCGTCCCGTAAGC,8,2253013
marRp,9.0,8,0,GTTTCCTGGCCTCACTACCA,8,2227113
marRp,9.0,8,0,GTTAGCAGCTGTCGTGCGGG,8,2223586
marRp,9.0,8,0,GTGTACGTGGAGTCGAGCGA,8,2226923
marRp,9.0,8,0,GTACAGAGGCAATCGGGGTC,8,2219107
marRp,9.0,8,0,GTAACGACGGCTTTCTACCA,8,2248636
marRp,9.0,8,0,GGGTGGGAGAATGGGACTGG,8,2250269
marRp,9.0,8,0,GCGTTGGCGAGCATCCTTAT,8,2240381
marRp,9.0,8,0,GCGGGCCTGAAGGAAATGCC,8,2260672
marRp,9.0,8,0,GCCCAACACGGTTAAATGCA,8,2225319
marRp,9.0,8,0,GCATTGTTCGTTCGACTAAA,8,2235838
marRp,9.0,8,0,GCAATTCAGTTGGCGGGTCC,8,2259877
marRp,9.0,8,0,GAGTGCGCAGGACCACAGAG,8,2232734
marRp,9.0,8,0,GAATGCGGTCCGTGGGGACC,8,2236961
marRp,9.0,8,0,CTGCTACCAATTCAAATCCG,8,2256592
marRp,9.0,8,0,CTCTTGTCGTGGAGAAATCC,8,2256245
marRp,9.0,8,0,CTCGACCGCGTGCTGTGGAT,8,2246015
marRp,9.0,8,0,CTATTCGTGTCGTGCTGTCC,8,2224362
marRp,9.0,8,0,CTAGTTGGCAATGTCCCCAT,8,2234570
marRp,9.0,8,0,CGTGAACTCATCGTCCGGAA,8,2233413
marRp,9.0,8,0,CGTCTACAGCTAGAGAACGT,8,2229346
marRp,9.0,8,0,CGTCGAATCCTTCATCACCT,8,2229747
marRp,9.0,8,0,CGAGGTAGCCGAGAAAACTG,8,2238690
marRp,9.0,8,0,CCAGACCGTATTCTTTTTAT,8,2245243
marRp,9.0,8,0,CATGTAAAACCGCTAGTAGG,8,2253607
marRp,9.0,8,0,ATGGCTTATTGTAATGAAGA,8,2233101
marRp,9.0,8,0,ATGGCATGCACGGTCCATGT,8,2236430
marRp,9.0,8,0,ATAATGGTAAGGGCATCTTA,8,2243126
marRp,9.0,8,0,AGTCCAACTAGAGGATCTGC,8,2258484
marRp,9.0,8,0,AGTACCTCGCTCATCCACCC,8,2229506
marRp,9.0,8,0,AGGGAGAATGTAAGTTACGG,8,2253205
marRp,9.0,8,0,ACTATCCGTGGGTCTGACAG,8,2248309
marRp,9.0,8,0,ACGTGTAATTGGGCGCGTAT,8,2235506
marRp,9.0,8,0,ACGTGCGGCTGCATACTTAC,8,2249536
marRp,9.0,8,0,ACCGTTATTATGCCAAACAC,8,2228736
marRp,9.0,8,0,ACCCCACCGTGGAGCTGATG,8,2258731
marRp,9.0,8,0,ACAGCTTCTACGCTAACAGC,8,2225371
marRp,9.0,8,0,ACAGACTGGTCATAAAGGGC,8,2251028
marRp,9.0,8,0,AAAATCTAGGGGACGTCATC,8,2243864
marRp,9.0,8,0,AAAACTGTACTGTGAGTCTG,8,2240537
marRp,8.0,7,0,TTCCGGGTGACTATCAGATC,7,2219830
marRp,8.0,7,0,TTCACATTCGAAGCAAACAG,7,2245500
marRp,8.0,7,0,TTAGGTCTAGAACTGAGGCA,7,2233235
marRp,8.0,7,0,TTACTTATCTTTTGTTCTTG,7,2225874
marRp,8.0,7,0,TGTGCGAGGACATAAGTGAT,7,2221977
marRp,8.0,7,0,TGGTTGGAGGTGGCAACAGT,7,2224638
marRp,8.0,7,0,TGGGGGTGCGCATCACACTG,7,2218568
marRp,8.0,7,0,TGGCCCCCATAGGCACCTCT,7,2231367
marRp,8.0,7,0,TGGATAATGGCCACCACGAC,7,2248563
marRp,8.0,7,0,TGCGGGTATGCGTAGACTGT,7,2248975
marRp,8.0,7,0,TGCCGATCTTCCCTAACCGA,7,2220734
marRp,8.0,7,0,TGCCACTGACCTCCGGGGAC,7,2253016
marRp,8.0,7,0,TGCAAATTCCGACGGGACGT,7,2240127
marRp,8.0,7,0,TCCATGGTGCCTTATCGGGG,7,2219299
marRp,8.0,7,0,TCATCACCTTCACCGAACAA,7,2257492
marRp,8.0,7,0,TAGGTAGCAGATACTCGCTT,7,2259293
marRp,8.0,7,0,TAGATAGCAACTACTTATTC,7,2260622
marRp,8.0,7,0,GTTTGGACTTATGGCGGAAG,7,2241554
marRp,8.0,7,0,GTTCCGGTAGTTTCTTATTG,7,2237381
marRp,8.0,7,0,GTGACTATTCGAGTCTCATA,7,2219210
marRp,8.0,7,0,GTCATCCACTATGCGAACGC,7,2229154
marRp,8.0,7,0,GTAGCTCCTGGCAGTTGCGT,7,2239934
marRp,8.0,7,0,GTAGCGACTTTTCGTATTAC,7,2223550
marRp,8.0,7,0,GGTTTCAATTGATTAAAGGT,7,2254386
marRp,8.0,7,0,GGTCGTATTGTCTTTCACTA,7,2240921
marRp,8.0,7,0,GGTATGATCTAGGTGGGGAT,7,2222742
marRp,8.0,7,0,GGTAGGCTCGTCTGACGTAT,7,2242261
marRp,8.0,7,0,GGTAAGGAGAGAAGGCCGAG,7,2241161
marRp,8.0,7,0,GGGGCTAGTGAGTCGGCTTA,7,2229222
marRp,8.0,7,0,GGAGACGTAGTGGATGGAGT,7,2249453
marRp,8.0,7,0,GGAGACCGTGGTAAGAACCA,7,2235519
marRp,8.0,7,0,GGAACCTCACAGAGATTCAA,7,2219036
marRp,8.0,7,0,GCGTTCCTTTGCTTATTGGC,7,2231147
marRp,8.0,7,0,GCCTTCAAACGTGGTTCTAA,7,2251932
marRp,8.0,7,0,GCCTGTCCCGCCCGTCTGCC,7,2218419
marRp,8.0,7,0,GCACCCTCCTTGCTCGGACA,7,2222591
marRp,8.0,7,0,GCAAACGACAGGGGTTAGGC,7,2250583
marRp,8.0,7,0,GATGCTAGTTGTTATTAGGC,7,2250885
marRp,8.0,7,0,GATGATGAGGGCGTCCCTAG,7,2236045
marRp,8.0,7,0,GACTTGCACTCCCGGGGAAC,7,2250077
marRp,8.0,7,0,GACTCTCCCCCCCCAAAAGA,7,2222747
marRp,8.0,7,0,GACGCGTTTCGCGGCATAAT,7,2236165
marRp,8.0,7,0,GACAAATCCTAATACTTCCA,7,2231722
marRp,8.0,7,0,CTTAACGTACTTTTACGTCC,7,2242642
marRp,8.0,7,0,CTGGTTTCATCGCCTTAACA,7,2241601
marRp,8.0,7,0,CTCAAACGGCACAGAATTCA,7,2257900
marRp,8.0,7,0,CGTTCCTAGAGATCGTTCAC,7,2222607
marRp,8.0,7,0,CGAGGGTCCCATACCAAGAT,7,2224519
marRp,8.0,7,0,CGAACCGGCCATGGCGCCTG,7,2221981
marRp,8.0,7,0,CCTCGCTTTCAGGGTCATGT,7,2255141
marRp,8.0,7,0,CCCATATTCGGTCCCGGGTT,7,2250427
marRp,8.0,7,0,CCCAGCACGTGCCCCGGAAA,7,2223247
marRp,8.0,7,0,CATGAACGGCGTTCATACAT,7,2228398
marRp,8.0,7,0,CATCTCGGACTCGTGAGACG,7,2233401
marRp,8.0,7,0,CATCCATTATAACTGATAGG,7,2235790
marRp,8.0,7,0,CATACTCATACTAAGCCTCT,7,2234991
marRp,8.0,7,0,CAGCACCTCGGTCGTATTCG,7,2226985
marRp,8.0,7,0,CACCAAGTTTGGAGCAGACG,7,2224952
marRp,8.0,7,0,CAAGTGTGTGTATTGCGGGG,7,2245983
marRp,8.0,7,0,CAAGGCGTGATGGACTAGCG,7,2245910
marRp,8.0,7,0,ATTTTCTCACACGGCCTTCA,7,2260403
marRp,8.0,7,0,ATGTGCCGGATTCATAATGA,7,2251045
marRp,8.0,7,0,ATCTCATGTACGGCCACTTG,7,2225425
marRp,8.0,7,0,ATCAAAGTTAACAGCACGTT,7,2222970
marRp,8.0,7,0,ATATTTCCTGTTCTGCACGA,7,2227340
marRp,8.0,7,0,ATAGCAGACATGGCTCTGTA,7,2228526
marRp,8.0,7,0,ATAAGGTCTAGCATACCTGA,7,2224651
marRp,8.0,7,0,AGTCCCCGACGGCCATCCAA,7,2220237
marRp,8.0,7,0,AGCCCACCGCCTTTCCCTCA,7,2227535
marRp,8.0,7,0,ACCGGTTCCAACAGCCCCAG,7,2236995
marRp,8.0,7,0,ACAAGCTGCGGATACCAGGC,7,2230403
marRp,8.0,7,0,AATGGATCTGGATCTCCTTC,7,2224901
marRp,8.0,7,0,AAATCTAGAAGATTGTCTGC,7,2256342
marRp,7.0,6,0,TTTGGCACTATCTAGGGTCT,6,2242335
marRp,7.0,6,0,TTTACGCAATTCCTAAGCTC,6,2239169
marRp,7.0,6,0,TTGATACGGTTGCCCATGTG,6,2223322
marRp,7.0,6,0,TTATCTAACTTACATCCCCC,6,2233408
marRp,7.0,6,0,TGGGTCTCGCTCATTTGACC,6,2238821
marRp,7.0,6,0,TGAGCATAGCATATCACCTG,6,2228535
marRp,7.0,6,0,TCGATACCTAAGGGGAAAAC,6,2238548
marRp,7.0,6,0,TCAGGCCCCCCTAGTATCTC,6,2245177
marRp,7.0,6,0,TATGACACATTATGCTCGTA,6,2240986
marRp,7.0,6,0,TACATCCAGAAAGCGTGGCG,6,2224910
marRp,7.0,6,0,GTGTATATGGCTATGCCTGG,6,2221542
marRp,7.0,6,0,GTGGTATACATGCACTATAA,6,2225238
marRp,7.0,6,0,GTGCATAGGATGTAAAAGGC,6,2246808
marRp,7.0,6,0,GTCGGCGATACCAGCGATGT,6,2250511
marRp,7.0,6,0,GTCAGGAACGCGTGTAAATA,6,2239320
marRp,7.0,6,0,GGATGGAAACGTGTAGAAAG,6,2260423
marRp,7.0,6,0,GGAGTTACGGACTTAAAATG,6,2233295
marRp,7.0,6,0,GCTGACCACGCCCAACAGAA,6,2236283
marRp,7.0,6,0,GCGACCTCGGCGGTCTAGCC,6,2251892
marRp,7.0,6,0,GAGCGCCTCAAGTACCCAAG,6,2244984
marRp,7.0,6,0,GACGATGAAACCGCGTGTAT,6,2219311
marRp,7.0,6,0,GAACCGGTCTAGGCAGTTCT,6,2232482
marRp,7.0,6,0,CTTTTGTACACTTTACGGGA,6,2255083
marRp,7.0,6,0,CTGTAGACAGTCATGGAGGT,6,2231874
marRp,7.0,6,0,CTCAGCCGAGTGGACGCAAC,6,2224819
marRp,7.0,6,0,CGTTACTGTGTGTCTCGCCT,6,2227074
marRp,7.0,6,0,CGTATATGGCCTAAGCGAGG,6,2253022
marRp,7.0,6,0,CGGTACGCGGAGTGGGTGCT,6,2261104
marRp,7.0,6,0,CGGAGTTTGAGTAACTACGA,6,2250342
marRp,7.0,6,0,CGCCGGCGCCTCGAGGGCAA,6,2219033
marRp,7.0,6,0,CGACCCGAGGCCTCTGTGAA,6,2238479
marRp,7.0,6,0,CGACAAGTATATCAACCAAA,6,2257110
marRp,7.0,6,0,CCTGCGATGGATAACGTATA,6,2220770
marRp,7.0,6,0,CCTACTTAAGATCCCTGTTA,6,2256748
marRp,7.0,6,0,CCCACGGGATAGGTTCAAAC,6,2242215
marRp,7.0,6,0,CCCAACGATTGGTAAGAACA,6,2221813
marRp,7.0,6,0,CCAGTCATGTCTAAATATAG,6,2219894
marRp,7.0,6,0,CCACGTATGTATATATGACT,6,2234245
marRp,7.0,6,0,CCACCGAACAAATACCATCA,6,2244166
marRp,7.0,6,0,CCACAGTTCCGAGAACGCAT,6,2232200
marRp,7.0,6,0,CAGACCCTTAGGTGCAGTCC,6,2223993
marRp,7.0,6,0,CACTAGCCGACGATTCCTAA,6,2223855
marRp,7.0,6,0,ATGGTGGGTATGTTAGACTT,6,2244933
marRp,7.0,6,0,ATCGCGCACCCTGACCCCAA,6,2242370
marRp,7.0,6,0,ATAAGAACTTCTTTGAGTAC,6,2250696
marRp,7.0,6,0,AGTCAATATGCCTTTCGGAG,6,2230229
marRp,7.0,6,0,AGGGCCACCTGTCATTGGGT,6,2227615
marRp,7.0,6,0,AGGACGCTAGATAGCAAATT,6,2230899
marRp,7.0,6,0,ACTTAGGTAGCCGGGATAAG,6,2241222
marRp,7.0,6,0,ACTGTTTGTATCGATAACTG,6,2224801
marRp,7.0,6,0,ACGGCGATTCACATTGGGCT,6,2225337
marRp,7.0,6,0,ACGGCGATCGCATGTTCTTT,6,2218841
marRp,7.0,6,0,ACGGACTAGGGAGTTGTTCA,6,2228746
marRp,7.0,6,0,ACCTATGCATTCTCTGACGT,6,2252304
marRp,7.0,6,0,ACCAATCTGGAATTAGGTTG,6,2260567
marRp,7.0,6,0,ACATATGCCCCGTTTAATCC,6,2253466
marRp,7.0,6,0,AATATACAAGCCACGATGTA,6,2251942
marRp,7.0,6,0,AAGGGGGCCGTTAGGGCGCG,6,2235063
marRp,7.0,6,0,AACGTTGCCACTAGCGTGTA,6,2219587
marRp,7.0,6,0,AAATTCAAATAAGTTCAAGT,6,2245589
marRp,6.0,5,0,TTTTCCCTCAAGATACAGCC,5,2254059
marRp,6.0,5,0,TTGTTGTCATCTAGCTATAG,5,2225201
marRp,6.0,5,0,TTGGCAGGTTAACTGTCCGT,5,2227163
marRp,6.0,5,0,TTCGCTATGTGGTCGAGGAC,5,2249799
marRp,6.0,5,0,TTCCGTGTCCAGCACTGGGA,5,2219844
marRp,6.0,5,0,TTCATAATGCAAATTGACGT,5,2225013
marRp,6.0,5,0,TTATTCCTTAGCCTGCACTC,5,2232740
marRp,6.0,5,0,TTACGGTGCCCCGGCACCAG,5,2260889
marRp,6.0,5,0,TGTTGGATCCCCCCAGGACT,5,2257526
marRp,6.0,5,0,TGTATATAGCGTAAAACGCC,5,2253021
marRp,6.0,5,0,TGGGGACCGGCCCGCTCGCA,5,2255925
marRp,6.0,5,0,TGGATGAAGCCGGATTCGGA,5,2254456
marRp,6.0,5,0,TGGACAGAACCCCGAAGACT,5,2245285
marRp,6.0,5,0,TGCCTTTTTTCCGGAGGAAA,5,2247577
marRp,6.0,5,0,TCCTGGCTCGAGATCGACGA,5,2235595
marRp,6.0,5,0,TCCGTATGGTACGCAAAGCG,5,2228157
marRp,6.0,5,0,TCCAAAGGACTAACGGCGCG,5,2218318
marRp,6.0,5,0,TCAGGCTAAACAACCGGAAA,5,2248640
marRp,6.0,5,0,TCACCGGGCGGAGGGATACA,5,2243199
marRp,6.0,5,0,TCAAGCCGATTGCTGGTTTC,5,2255006
marRp,6.0,5,0,TATTCATAGGAACGACTTTG,5,2228845
marRp,6.0,5,0,TATATGAAGCTTGGGTGATC,5,2256473
marRp,6.0,5,0,TAGGGGTCAGCTCCAGGCTT,5,2231689
marRp,6.0,5,0,TACGAGAAGTCCCTGATTTG,5,2231178
marRp,6.0,5,0,TACCGGAGGGGGGCACGAAC,5,2259986
marRp,6.0,5,0,TAAGGACCTTTCCTCGTCAA,5,2244807
marRp,6.0,5,0,TAAGCTCATGAGACTTGGAC,5,2245047
marRp,6.0,5,0,GTTAGTGCTCGACTGCTGGC,5,2218426
marRp,6.0,5,0,GTGGGTTAAGTGTCTCGTAA,5,2252687
marRp,6.0,5,0,GTGCGTTCAGAGATCGTTTA,5,2229887
marRp,6.0,5,0,GTGAATTCCGTAGAGGGGGG,5,2257429
marRp,6.0,5,0,GTCCCTTCAGTCCTAAAGCA,5,2239533
marRp,6.0,5,0,GTCAGGGATACTGATATTTT,5,2256383
marRp,6.0,5,0,GTAAATGCCTCCCTTCACAA,5,2218377
marRp,6.0,5,0,GGTCGGGTCCCTAATGTTTT,5,2239549
marRp,6.0,5,0,GGGGGGCTGCTCATTTCGAT,5,2238959
marRp,6.0,5,0,GGCCTCTGCGGTGGACTCAC,5,2251934
marRp,6.0,5,0,GGCCCACCAAGCCCACCACT,5,2248136
marRp,6.0,5,0,GGATGCGAACCAGTCTTGGT,5,2251066
marRp,6.0,5,0,GGATCCTAGTTAACGCACCT,5,2235034
marRp,6.0,5,0,GGAGAGCGGGACCCCCATAC,5,2240495
marRp,6.0,5,0,GCGGTACCTTCGCGAATCGC,5,2235069
marRp,6.0,5,0,GCCGTATATTCTGTGTGCGG,5,2218524
marRp,6.0,5,0,GCCGCGAATCGCACCGGCCC,5,2224831
marRp,6.0,5,0,GCCACGTTATTTCTACTTAA,5,2260643
marRp,6.0,5,0,GCATATTTAATTCTAGGGGA,5,2260689
marRp,6.0,5,0,GAGACTGATCGAGCTGTCGT,5,2257521
marRp,6.0,5,0,GACCGAACGGTGTGGTTCAT,5,2241986
marRp,6.0,5,0,GACACGATCCAACGCGCAGT,5,2243140
marRp,6.0,5,0,GAACACGCGTCGCCCCCGCC,5,2238673
marRp,6.0,5,0,CTGCCCTGCTTACCTAAATT,5,2232878
marRp,6.0,5,0,CTGCCACCAAATTGTACAAT,5,2248598
marRp,6.0,5,0,CTCAGGTCGAGAGGAGAGCC,5,2247450
marRp,6.0,5,0,CTAACGAGGAAGTAGGTAAG,5,2245765
marRp,6.0,5,0,CGTATAAAATCCACTGTTTA,5,2226629
marRp,6.0,5,0,CGGCCTTATTCTCCATTCTT,5,2218189
marRp,6.0,5,0,CCGGCGGGGTACCCCTCGAT,5,2230040
marRp,6.0,5,0,CCGCGGAGAAGCTTCTGCTC,5,2227943
marRp,6.0,5,0,CCCGGGTTCAAACATATCGG,5,2260011
marRp,6.0,5,0,CCCGGCTAGTTGCGACTATT,5,2235799
marRp,6.0,5,0,CCCCATTGCTGTGAGGCTGT,5,2248921
marRp,6.0,5,0,CCAGGATAGCAAGTTGATGG,5,2257478
marRp,6.0,5,0,CCAATGAATTTAGTTCCGTC,5,2249491
marRp,6.0,5,0,CATTCCTGCAGCCACACTCC,5,2244533
marRp,6.0,5,0,CAGGGTATAACCTGGCAGCG,5,2259477
marRp,6.0,5,0,CACGCGCGCTCTCAGTTTGT,5,2241511
marRp,6.0,5,0,ATTAGGAATAAACTTAGTGT,5,2245434
marRp,6.0,5,0,ATGGCTCTGCTTGTTGATAT,5,2247370
marRp,6.0,5,0,ATGCTGAGTCTTTGGCTACG,5,2257419
marRp,6.0,5,0,ATAAGGGCGCGTTAACAAAA,5,2235046
marRp,6.0,5,0,AGGGGTCGGACTATAATACT,5,2260333
marRp,6.0,5,0,AGGGGACACCAGCGAAGTGC,5,2217947
marRp,6.0,5,0,AGGCCTGGAAGTCCGCCTCA,5,2224710
marRp,6.0,5,0,AGGAAGACCATAGTTATTGG,5,2236268
marRp,6.0,5,0,AGAGTGGCACTTGAATGAAA,5,2248570
marRp,6.0,5,0,AGAACGGATGGTTTGTCAGT,5,2248765
marRp,6.0,5,0,ACTGTTGACGTAGGACGGCT,5,2237821
marRp,6.0,5,0,ACTGTGGCAATCTGAGAGTA,5,2258535
marRp,6.0,5,0,ACTGCACCAGTTAGCCGTAT,5,2237473
marRp,6.0,5,0,ACGTCTGATTACAGGCCGGG,5,2223581
marRp,6.0,5,0,ACGGGAAACGTAATTTGTAC,5,2254869
marRp,6.0,5,0,ACGCAAAGTGGCGCGTTGCA,5,2223516
marRp,6.0,5,0,ACACGTTACTACCCAGGGCA,5,2242347
marRp,6.0,5,0,AAGATCCTGAATCCCCGGGG,5,2249524
marRp,6.0,5,0,AAGAGCTACAGCTCCTGACG,5,2258739
marRp,6.0,5,0,AACGTTAGATTCCGCTCTCA,5,2218382
marRp,6.0,5,0,AACGCCCCGTCTAGAATTTC,5,2223882
marRp,6.0,5,0,AACCGCAAGGCTAAATAGGA,5,2233391
marRp,6.0,5,0,AAAACTCAGGTTGGCAGAAT,5,2228248
marRp,5.0,4,0,TTTTGTTTGTCTACATGACA,4,2245427
marRp,5.0,4,0,TTTCCAGCAAGATTACTCAT,4,2222180
marRp,5.0,4,0,TTTAACTACCAGACACCACT,4,2225482
marRp,5.0,4,0,TTGTCTCCAAGTGTGTATAC,4,2224096
marRp,5.0,4,0,TTGTACCCCGGGCCAGGTTC,4,2228496
marRp,5.0,4,0,TTAGCACAAGGGTCAACGTC,4,2258374
marRp,5.0,4,0,TTAACGCAAAAAGGAATCTA,4,2220219
marRp,5.0,4,0,TGTTGTCTAGGATCTAACGG,4,2261097
marRp,5.0,4,0,TGGGTTTAGCAGGACTTGAC,4,2245462
marRp,5.0,4,0,TGATTACATAACCGATCAGT,4,2241672
marRp,5.0,4,0,TGAGGCTTGTGCTGAAAAGT,4,2231014
marRp,5.0,4,0,TGAGGAAAGTTAGCCGGGGT,4,2232148
marRp,5.0,4,0,TCTTATGCAAATTTGGGGGT,4,2259841
marRp,5.0,4,0,TCCTATTAGTAAATGAGATA,4,2259568
marRp,5.0,4,0,TATCTGGAGGGAGCATATCA,4,2252660
marRp,5.0,4,0,TAGGTACAGCAAGTCGGGAG,4,2218358
marRp,5.0,4,0,TAATCAAGACTGAGATGGGA,4,2222237
marRp,5.0,4,0,TAATAGCAGCCTCCCACGTT,4,2228130
marRp,5.0,4,0,GTTCCCCAGCCGTACGTCCA,4,2259213
marRp,5.0,4,0,GTGCAGTTCTCATCATGGTC,4,2238213
marRp,5.0,4,0,GTCTTTCGGTGCAATGGTCA,4,2254004
marRp,5.0,4,0,GTCCTCGAGGATGTCGGTAC,4,2247411
marRp,5.0,4,0,GTATTACTCAAAAGTTCTGT,4,2245388
marRp,5.0,4,0,GTAGTGCATCAACCCGCCTA,4,2220806
marRp,5.0,4,0,GGTGAACTAGCCTGGCTATC,4,2233351
marRp,5.0,4,0,GGTCGCATAAAACGTCTCTA,4,2232671
marRp,5.0,4,0,GGGGGTAGGAAACGCAGATC,4,2228483
marRp,5.0,4,0,GGCTTCTGCAATCACATGTA,4,2222007
marRp,5.0,4,0,GGCTCCAGCCGGGGGCCTCC,4,2243954
marRp,5.0,4,0,GGCTAGATTGCTTTGAAAAA,4,2242045
marRp,5.0,4,0,GGCGTATTGCAGCCTAAGAG,4,2233297
marRp,5.0,4,0,GGAAACGGACCCGGAAGTTG,4,2233292
marRp,5.0,4,0,GCGTGCTTGATTTGCAGGAT,4,2239919
marRp,5.0,4,0,GCGTCTACAGCAGCCGCAAC,4,2243107
marRp,5.0,4,0,GCGGCGCTAGTCTAGCCGCG,4,2224375
marRp,5.0,4,0,GCGGCCCTGTCGCTCCGGAT,4,2241833
marRp,5.0,4,0,GCGCCGTGGGTAAAACGAAG,4,2239003
marRp,5.0,4,0,GCCCTCTTACGTGTGAACTT,4,2253050
marRp,5.0,4,0,GCAAATACAGAAGCACTCTC,4,2219825
marRp,5.0,4,0,GATGTCCTATGAGAGGCGCA,4,2239625
marRp,5.0,4,0,GATCACTGCCAACCATACCA,4,2257985
marRp,5.0,4,0,GAGTCGAGGCCGTTTGCTCA,4,2236068
marRp,5.0,4,0,GAGTCAATTTACCTCTACCT,4,2234547
marRp,5.0,4,0,GAGACTCAGGCTAGTTCGAA,4,2240860
marRp,5.0,4,0,GACAAGTAAATGATTAAGGT,4,2247000
marRp,5.0,4,0,CTTGGGCATTAGTGTAGCGT,4,2243871
marRp,5.0,4,0,CTTGGAGCACGTGGCGAAGA,4,2225190
marRp,5.0,4,0,CTTGCTAGGGCCTATTTTGG,4,2230962
marRp,5.0,4,0,CTTCTGTACAATGTACGAGC,4,2225694
marRp,5.0,4,0,CTGCTGTCAATAGATCATGT,4,2252743
marRp,5.0,4,0,CTCCGGGGTGGCGGTGAAAA,4,2219046
marRp,5.0,4,0,CGGTTTGGTCCCACCTACTT,4,2218317
marRp,5.0,4,0,CGGGATAACTTGGGATTTCC,4,2230672
marRp,5.0,4,0,CGGCAATCTTCAACAATTGT,4,2252809
marRp,5.0,4,0,CGCCCGGCATACGAATCTAA,4,2253348
marRp,5.0,4,0,CGATCTTAATGTACCTTCTT,4,2229288
marRp,5.0,4,0,CGAAGTTTGATGACACGGCT,4,2238623
marRp,5.0,4,0,CCTGGCTGTTCCCCCTGGAG,4,2251333
marRp,5.0,4,0,CCGGTGCCCTGGCACTCACC,4,2236870
marRp,5.0,4,0,CCAGTTCCCTAGCGCGCTAC,4,2256929
marRp,5.0,4,0,CATCAGGTACCACGCGATTT,4,2228791
marRp,5.0,4,0,CAGGGACAATACCTTGTTAC,4,2240382
marRp,5.0,4,0,CAGCCCCTTTCAGTCCAATT,4,2222417
marRp,5.0,4,0,CAGCAACATCTAAACGCTTA,4,2226215
marRp,5.0,4,0,CACGTAGTAGAGTTTGTGGC,4,2218038
marRp,5.0,4,0,CACGGGGGGTTTGCCGTGGG,4,2260967
marRp,5.0,4,0,CAAAAGAAATGATTCTGTTG,4,2241618
marRp,5.0,4,0,CAAAACTAGAATCCCATAAG,4,2220210
marRp,5.0,4,0,ATGTGAACGATCAATGGGGC,4,2229560
marRp,5.0,4,0,ATGGGGAAAAATCTATCACT,4,2251185
marRp,5.0,4,0,ATCTGGCTTTATACGCAAGG,4,2238022
marRp,5.0,4,0,ATCTACTGCGGATGTTCGCC,4,2251373
marRp,5.0,4,0,ATCCGGCAACAGCTTACCCC,4,2253520
marRp,5.0,4,0,ATATAAGGCATTCGGACAGG,4,2241827
marRp,5.0,4,0,ATACTATTTAAAACTATTTC,4,2222846
marRp,5.0,4,0,ATAAGGGGCTCAGATTTAGC,4,2257728
marRp,5.0,4,0,AGTTGGAGAGCGGCCAAGCC,4,2254470
marRp,5.0,4,0,AGACATCCAGCCTTGGTAAT,4,2260628
marRp,5.0,4,0,AGACAATGGCGCGTTGAAGG,4,2233996
marRp,5.0,4,0,ACGTTAAGATTTCGTCCGTT,4,2233748
marRp,5.0,4,0,ACCGATAGGTCAAAGTACGC,4,2247726
marRp,5.0,4,0,AATACGCCGATACGTGACTG,4,2253464
marRp,5.0,4,0,AAGGTCTATGTTTGGTCTAT,4,2243691
marRp,5.0,4,0,AAGGGGTTATTGAAGAGTTT,4,2230771
marRp,5.0,4,0,AAGCGGTTCAAGTTGGAGGA,4,2231958
marRp,5.0,4,0,AAGCGGCAAGAAAGGCCCCG,4,2257494
marRp,5.0,4,0,AACGATGGTAAGGTGGTGCA,4,2219040
marRp,5.0,4,0,AACCTAGAAACCAGAAGTCC,4,2251090
marRp,4.0,3,0,TTTCCTGCCAGTTGGCGACA,3,2248269
marRp,4.0,3,0,TTGTTGTCCTGAGATTTTTG,3,2239452
marRp,4.0,3,0,TTCCGTCAAATTAGCTTCTT,3,2236085
marRp,4.0,3,0,TTCCCCGAGTGTATGCCAAA,3,2224080
marRp,4.0,3,0,TTCAGTCAGGTGCGTAACCA,3,2260706
marRp,4.0,3,0,TTATGCCTGGGAAAGGACGA,3,2233400
marRp,4.0,3,0,TTATACAGCCTATATTAGAG,3,2229281
marRp,4.0,3,0,TTAGGTATATGAAGGCATAT,3,2255125
marRp,4.0,3,0,TTAGGCCACATCAATTGGAC,3,2248036
marRp,4.0,3,0,TTAGAGCGCCATCTTGCGAA,3,2241326
marRp,4.0,3,0,TGTCAGGATGCCAGATGGCA,3,2217793
marRp,4.0,3,0,TGCCTTCACACATACCCCCC,3,2225321
marRp,4.0,3,0,TGATTCCTGTTAGGGATTTC,3,2251440
marRp,4.0,3,0,TCGTGGACGCATAGACGGGG,3,2226875
marRp,4.0,3,0,TCCTAACCATAAGTGACCAA,3,2238130
marRp,4.0,3,0,TCATTTTTCGTGAAAGGTTT,3,2227705
marRp,4.0,3,0,TCATAGCAACATGGCTGAGC,3,2219133
marRp,4.0,3,0,TATAAACCGATCCTTCTCAA,3,2221807
marRp,4.0,3,0,TAGGGCTGTATAGTGTTGGC,3,2223632
marRp,4.0,3,0,TAGAAAGTCCTTCCTGTTTG,3,2253256
marRp,4.0,3,0,TAACAATGACATATTAGTTA,3,2240694
marRp,4.0,3,0,GTTGCCAAATGTTGGCAAGA,3,2256590
marRp,4.0,3,0,GTTCGCATGATAGGTAGGAA,3,2237558
marRp,4.0,3,0,GTGCGAGTAGAACGGCGGTT,3,2222965
marRp,4.0,3,0,GTGACGCTCAGGGTCTAAAC,3,2234257
marRp,4.0,3,0,GTCGGTCATTGCCTGAGGTT,3,2256620
marRp,4.0,3,0,GTCCGTGCGACGGCTAGTAA,3,2231862
marRp,4.0,3,0,GTCATATTCTTTCCTCGAAG,3,2240264
marRp,4.0,3,0,GTATCAGGCTAATTCGCCCA,3,2241809
marRp,4.0,3,0,GTACGCTAGCAATTTCTGTA,3,2244858
marRp,4.0,3,0,GGTTAAATTAGTTCCAATCC,3,2241347
marRp,4.0,3,0,GGTGTACCGCGGACTCGCGA,3,2248574
marRp,4.0,3,0,GGTATCCTCATAACCCATAT,3,2254666
marRp,4.0,3,0,GGGTCGATGTAGTTCATAAT,3,2254472
marRp,4.0,3,0,GGGGCGGCGACGGGGCATGG,3,2248188
marRp,4.0,3,0,GGGACATAGGTATCCGTGGA,3,2223094
marRp,4.0,3,0,GGCTTACTTGCCCGATGATT,3,2247217
marRp,4.0,3,0,GGCTGAATCGGTTAAGATCC,3,2218309
marRp,4.0,3,0,GGAGGAAATACGTACTAGGA,3,2221121
marRp,4.0,3,0,GGAGCGCTATAGGTTCCATC,3,2226244
marRp,4.0,3,0,GGAATATCTTCAAAGTAAAA,3,2235942
marRp,4.0,3,0,GCTGCCGTGTCAGGTGGTGT,3,2224598
marRp,4.0,3,0,GCGGACGAAGCCTCAGGCGG,3,2252222
marRp,4.0,3,0,GCGCCTGGTACTGTTTTATC,3,2246881
marRp,4.0,3,0,GCATTCATACGCTATGTTTC,3,2243293
marRp,4.0,3,0,GATTTGCCACGACATTCGGT,3,2223580
marRp,4.0,3,0,GATTGCTATCTTACTTGTCC,3,2231906
marRp,4.0,3,0,GATCACTTCAGAATAATGGT,3,2245221
marRp,4.0,3,0,GAGGTCAATCTGTCTCGTTA,3,2251474
marRp,4.0,3,0,GACGCACAGTTTTCAGTTTA,3,2220023
marRp,4.0,3,0,CTTTGCGTACGTTAAGTAAC,3,2220194
marRp,4.0,3,0,CTTAGTCATGACCACACCTG,3,2241162
marRp,4.0,3,0,CTTAAGCTGGAAGGCTCTCT,3,2245444
marRp,4.0,3,0,CTGCCGTCGAACGGGCAGCT,3,2232157
marRp,4.0,3,0,CTCCGTTGTGATTATGCGTA,3,2226516
marRp,4.0,3,0,CTCCGGGGATGTTAACGGGA,3,2237640
marRp,4.0,3,0,CGTAAGGGGACTTAAATTTT,3,2249010
marRp,4.0,3,0,CGGGAGACTGATTCTCTCAG,3,2223020
marRp,4.0,3,0,CGGCACCTGGACTCCCACAA,3,2244263
marRp,4.0,3,0,CGGAATAAAAACGAGGTTCC,3,2222441
marRp,4.0,3,0,CGCTATCGGGTATCGACCCA,3,2243008
marRp,4.0,3,0,CGCGCCGATCGGAACTTGGG,3,2258727
marRp,4.0,3,0,CGCAAAAGGTCCATTGATTA,3,2259656
marRp,4.0,3,0,CGATTACTCTAGTCGCTGAA,3,2242882
marRp,4.0,3,0,CGATCAGATGGTGTATCTTA,3,2260994
marRp,4.0,3,0,CGACTGGTGGTAAACTCGTA,3,2238700
marRp,4.0,3,0,CCTGATAAGATCTTCCCGAA,3,2257977
marRp,4.0,3,0,CCTAGGCTCGAGCGTAAGTC,3,2230390
marRp,4.0,3,0,CCTAGCGCACCAATCGGCCA,3,2220252
marRp,4.0,3,0,CCACGAAGCAAAGCGACTTA,3,2228758
marRp,4.0,3,0,CCACCTCTAGGAACCTGCCG,3,2238305
marRp,4.0,3,0,CATCTCACGAGACCAATAAT,3,2221143
marRp,4.0,3,0,CATCACACATTAGGATCCTG,3,2229764
marRp,4.0,3,0,CAGAGGGTCAGGTACATCAG,3,2257465
marRp,4.0,3,0,ATGTGCTCGGGAAAGTGGCT,3,2259085
marRp,4.0,3,0,ATGTATTCCGCTCGACCCAC,3,2259778
marRp,4.0,3,0,ATGGGATCTTTCGCCACCTA,3,2240457
marRp,4.0,3,0,ATGGCCATAGTAAGCAATTG,3,2258803
marRp,4.0,3,0,AGTCCTACTGATTGGTCCCA,3,2217919
marRp,4.0,3,0,AGTATGGTTAGGAAGTTAAG,3,2256811
marRp,4.0,3,0,AGGCGAAAGATTCGTGGTCA,3,2256854
marRp,4.0,3,0,AGCGTTTCATGTGGCGGGTG,3,2220247
marRp,4.0,3,0,AGCAGAGGGGGACCAGCATT,3,2228350
marRp,4.0,3,0,AGATATCGCCCTAGGCTCGG,3,2219974
marRp,4.0,3,0,AGAATGGATTGATCTTATCT,3,2243119
marRp,4.0,3,0,AGAACAGCTGGCTTCCTTCC,3,2243043
marRp,4.0,3,0,ACTCCTGGTACAGCTGACGG,3,2255559
marRp,4.0,3,0,ACGTTCTATAGGCCAATAGG,3,2226482
marRp,4.0,3,0,ACCTGTGCCTTCGTACCACG,3,2223388
marRp,4.0,3,0,ACCGCGTAAATTTGGTTTTC,3,2224965
marRp,4.0,3,0,ACCAAGCCACTCATAACCCT,3,2240622
marRp,4.0,3,0,ACACACTACTGCCTAATATT,3,2259939
marRp,4.0,3,0,ACAAACGGTAAGCTGTGTGG,3,2228841
marRp,4.0,3,0,AAGGTTTCGTCAGGTCCGAC,3,2223447
marRp,4.0,3,0,AAGGGTTCGAGTTTCGGAAA,3,2234039
marRp,4.0,3,0,AAGGCTCGAAGTCATTTTGG,3,2233813
marRp,4.0,3,0,AAGGCGTGAAATTATTCAAT,3,2251823
marRp,4.0,3,0,AAGGCAGGGATAGTGGAGTG,3,2222853
marRp,4.0,3,0,AACGGTCTGTGTACAGCTCA,3,2248390
marRp,4.0,3,0,AAAACTAATTACAGAAGTCC,3,2236012
marRp,3.0,2,0,TTTTGCACTCTCTTCCGTTC,2,2240962
marRp,3.0,2,0,TTTGTCATCTTAGACCAACA,2,2219105
marRp,3.0,2,0,TTGTTAATATCGACTAACCA,2,2243368
marRp,3.0,2,0,TTGGCTCACACTGCGGTATC,2,2231171
marRp,3.0,2,0,TTCTTGTAACCACCAGGTCT,2,2247685
marRp,3.0,2,0,TTCGTGCGATTCACGATCTA,2,2218794
marRp,3.0,2,0,TTCATGGTGATTCGTTTGGT,2,2260192
marRp,3.0,2,0,TTATGCGCACCCTCAAGAAC,2,2252039
marRp,3.0,2,0,TGTGTCGCCTACCACATGGT,2,2259730
marRp,3.0,2,0,TGGTACTCGCCTTTGGACTG,2,2224658
marRp,3.0,2,0,TGGGTATCTATATCCGTAGC,2,2253344
marRp,3.0,2,0,TGCGCAGTAACCGAAAAGAT,2,2221904
marRp,3.0,2,0,TGATGGACGGATGCGCCTCC,2,2242650
marRp,3.0,2,0,TGAGAAACTACTCGTGATTC,2,2246699
marRp,3.0,2,0,TCTGACTGACCGACAGTAAG,2,2259473
marRp,3.0,2,0,TCGCAGCGAGATTGGACCCT,2,2250066
marRp,3.0,2,0,TCCGGTGACATGTTACATGT,2,2237764
marRp,3.0,2,0,TCCAACCGGGGCTGGGGCCT,2,2237383
marRp,3.0,2,0,TCAGTGTCGAACTCTTATGC,2,2243027
marRp,3.0,2,0,TCACATAGTGCCCGGTCTGA,2,2234787
marRp,3.0,2,0,TATTATTCTACCAGTGAGGA,2,2236352
marRp,3.0,2,0,TATGCTGACGATCCATTCCG,2,2249050
marRp,3.0,2,0,TATATCTATCACCCCAGCCT,2,2221695
marRp,3.0,2,0,TACGCAATTTCCCTGATGCA,2,2257888
marRp,3.0,2,0,GTTTCGCTATTTCTACCTTA,2,2237775
marRp,3.0,2,0,GTTGAGGAGCTGCAAAACCT,2,2227334
marRp,3.0,2,0,GTTACGCTACGGCGCGCACC,2,2232088
marRp,3.0,2,0,GTGTGTTCTTTCCTTCATGT,2,2254968
marRp,3.0,2,0,GTGTCGAAGAGAGAAACGGC,2,2244970
marRp,3.0,2,0,GTGGGCGGGCCTCTTCGTAT,2,2251174
marRp,3.0,2,0,GTATGGGTTATTTGTAATCT,2,2221549
marRp,3.0,2,0,GGTGTGCAGGAAGGGGCGCA,2,2259499
marRp,3.0,2,0,GGTATACACACTTGAGCATT,2,2223305
marRp,3.0,2,0,GGTAGCCAGTAACGCAATGG,2,2251315
marRp,3.0,2,0,GGGTAACGATGGTAGGTTAG,2,2230562
marRp,3.0,2,0,GGCTCCCACGGGTGTCACTC,2,2243795
marRp,3.0,2,0,GCTTGCGCCGGCTAGAACTT,2,2225202
marRp,3.0,2,0,GCGTTCTACGACATACCCTT,2,2229640
marRp,3.0,2,0,GCGGTCGTGTAACACAGATT,2,2236334
marRp,3.0,2,0,GCGGGTCGCACATGAAGGAT,2,2220019
marRp,3.0,2,0,GCGGAACAACCGGCGAACTT,2,2246915
marRp,3.0,2,0,GCCTTGGTGCTGATGATCAG,2,2237073
marRp,3.0,2,0,GCCGGAGGGCTGTCCTTCCT,2,2254478
marRp,3.0,2,0,GCCCGACGTCTGTAGAAACA,2,2223863
marRp,3.0,2,0,GCAATGGGGGATTGAAACGT,2,2218745
marRp,3.0,2,0,GCAACCATGGACTAACCTGT,2,2234682
marRp,3.0,2,0,GAGGTCAACCTCATTTCGGA,2,2236640
marRp,3.0,2,0,GAGGGGACATACTTCCTCCT,2,2220589
marRp,3.0,2,0,GAGGGAAGACAATAAACCGT,2,2239072
marRp,3.0,2,0,GAGAGAACAATTCAGCATCC,2,2254660
marRp,3.0,2,0,GAGACGTCCTTAGCCGAGGC,2,2249456
marRp,3.0,2,0,GACTGGCCTATGATCTGATC,2,2228245
marRp,3.0,2,0,GAATTACGGATTGATACAAT,2,2258877
marRp,3.0,2,0,CTTGGTCTGTGCATACATGA,2,2221806
marRp,3.0,2,0,CTCGTGAACCACAAGTGTGA,2,2260145
marRp,3.0,2,0,CTAGTTTCCTCAAGTGGAGA,2,2252309
marRp,3.0,2,0,CTAGATTGATAAAGCCTCCA,2,2237133
marRp,3.0,2,0,CGTGCTAACCGGTAATTTCA,2,2237912
marRp,3.0,2,0,CGGCCCACGGCTCTCGCGCG,2,2220423
marRp,3.0,2,0,CCTTTCCGCTATGAACTGCC,2,2249630
marRp,3.0,2,0,CCTGGTACAGGAGTATCTCG,2,2221440
marRp,3.0,2,0,CCTAGCGGCAGAATACATGA,2,2219737
marRp,3.0,2,0,CCTACATAGCAAGGATCTGT,2,2251794
marRp,3.0,2,0,CCTAACTGACCCGCTCCAAT,2,2246414
marRp,3.0,2,0,CCTAACCATTCCCATATTTT,2,2225631
marRp,3.0,2,0,CCTAACAACAGGGTTGGGCA,2,2221164
marRp,3.0,2,0,CCGGATACGAGTTAAGTCCA,2,2259248
marRp,3.0,2,0,CCGGAGGTTCCCAGAGTTAA,2,2250938
marRp,3.0,2,0,CCGGAATCGGCTGGTAGATA,2,2251521
marRp,3.0,2,0,CCCTGTAACGTTCTCCGTCC,2,2249194
marRp,3.0,2,0,CATCTGCTCAGAGAAGTTAT,2,2239535
marRp,3.0,2,0,CATATCACAGGGCTAAACAA,2,2254918
marRp,3.0,2,0,CAGCTACCTGTTGGCGGATG,2,2219820
marRp,3.0,2,0,CACTGGTATCTCGATGTAAT,2,2227929
marRp,3.0,2,0,CACCGTGTAGGTTTCGTTTT,2,2232633
marRp,3.0,2,0,CAATCGTTTGCGTGGGATAC,2,2235925
marRp,3.0,2,0,ATTCCCTGAAATCGATGAAC,2,2247748
marRp,3.0,2,0,ATTCATATTGAACATAGGTG,2,2239986
marRp,3.0,2,0,ATGTACTGGTTCTCGCGAGC,2,2223131
marRp,3.0,2,0,ATGGCTACGTCGTACAGCAA,2,2256001
marRp,3.0,2,0,ATCTGTAAGAGCTCAGAAGT,2,2218319
marRp,3.0,2,0,ATCACTGTCGCAGACTCTCG,2,2255747
marRp,3.0,2,0,ATACCACCTCGGCTCGAAAT,2,2237468
marRp,3.0,2,0,ATACACGTAGCTCACCGGTA,2,2218164
marRp,3.0,2,0,AGTTTTCGAGATATTTGCAA,2,2239253
marRp,3.0,2,0,AGTGTTTAAAACCGAACAAC,2,2245979
marRp,3.0,2,0,AGGCGATACGCCGTTTTCTC,2,2232064
marRp,3.0,2,0,AGCTTTGTGGCCACACCTCC,2,2237156
marRp,3.0,2,0,AGCTCGACAGTACTCGTAAA,2,2226581
marRp,3.0,2,0,AGCAATCGGCATTGAATCTT,2,2239989
marRp,3.0,2,0,AGAGCCAGGTCCCGTTTAAG,2,2232838
marRp,3.0,2,0,ACGTGCTGGGGCCAGCTCAC,2,2257750
marRp,3.0,2,0,ACGCGCGACGCCTGTGACAA,2,2226732
marRp,3.0,2,0,ACAGGTGTCGTTAAGGCGCG,2,2243867
marRp,3.0,2,0,AATTTACTTTTCACCCTCAG,2,2239263
marRp,3.0,2,0,AATCAAAACGAATACCTTGC,2,2224657
marRp,3.0,2,0,AATATAAGTCCAACAATAAT,2,2245994
marRp,3.0,2,0,AAGGTTACACGTTGACGTCG,2,2256693
marRp,3.0,2,0,AAGGTGGGGGCATCTTGCCG,2,2234843
marRp,3.0,2,0,AAGGATTTGAATTGTTGGTA,2,2232181
marRp,3.0,2,0,AAGCCGGTAACGGCCAGGTC,2,2246114
marRp,3.0,2,0,AACCTCTGATCCCTTCACTT,2,2224066
marRp,3.0,2,0,AAATGCCTGGCCTTTTGCCC,2,2238306
marRp,2.0,1,0,TTTTCTTAGGAAGCGTGTTC,1,2241337
marRp,2.0,1,0,TTTCGGGGATCGTGGCCTCA,1,2225490
marRp,2.0,1,0,TTTAGGAGCGAACTAGAATA,1,2225687
marRp,2.0,1,0,TTGGTATTAGGGAGTACGGT,1,2225194
marRp,2.0,1,0,TTGAGCGTTTCGCTGTCGGT,1,2259786
marRp,2.0,1,0,TTCGGGACGACTAACTCACT,1,2243611
marRp,2.0,1,0,TTAGCCCCCTGGCGCCATCA,1,2235454
marRp,2.0,1,0,TTACTACTACTCATGCATCA,1,2238250
marRp,2.0,1,0,TTACACCGATAACTAGTTTG,1,2235750
marRp,2.0,1,0,TGTGGATCAGCAATTCCCCG,1,2222017
marRp,2.0,1,0,TGTAGGTCCAGAAGGAACGA,1,2223461
marRp,2.0,1,0,TGGTGATAGTCGTGGATCCA,1,2221590
marRp,2.0,1,0,TGGGCTAAGGATCACTAGGT,1,2240443
marRp,2.0,1,0,TGGCACATAGCGTACACGAT,1,2257995
marRp,2.0,1,0,TGCGTTAAGCGCCAGGTTTT,1,2249452
marRp,2.0,1,0,TGCATTGGGCAACCGGTATG,1,2226087
marRp,2.0,1,0,TGCAGCTTTCTTCGCGTCTC,1,2223190
marRp,2.0,1,0,TGCACGTGCGCAGCGCTACT,1,2243695
marRp,2.0,1,0,TGAGGCGAGAGGGTGCGCGA,1,2218020
marRp,2.0,1,0,TGAGATTAAAAAGTGAAGTA,1,2248722
marRp,2.0,1,0,TCTTCGGCACACCGATTTGA,1,2232309
marRp,2.0,1,0,TCTTAATCATGCAACGTTTA,1,2240277
marRp,2.0,1,0,TCTGCGGGGGGACTCATCCC,1,2225257
marRp,2.0,1,0,TCTGCACTGTGGCTCTACAT,1,2228842
marRp,2.0,1,0,TCTGATGTCGTGTTCTTGCA,1,2252410
marRp,2.0,1,0,TCGTAAACAGGTAAGGTCCA,1,2218909
marRp,2.0,1,0,TCCGAGGACTTATTCCCCTC,1,2232971
marRp,2.0,1,0,TCCCAATTATCAACGCTGGC,1,2256922
marRp,2.0,1,0,TCCCAATACCCGCTCCTTCC,1,2253147
marRp,2.0,1,0,TCCAGTTAATGATAAAACAG,1,2223536
marRp,2.0,1,0,TCCAGACAAGGTCACACGCG,1,2226772
marRp,2.0,1,0,TCAGCAAACTGAATGGTCCA,1,2219468
marRp,2.0,1,0,TCACGCATTAGGTTGGGTGA,1,2234905
marRp,2.0,1,0,TCAACGCTCGTAGGGGTATG,1,2231579
marRp,2.0,1,0,TATTGAGGATTGACGCGAAG,1,2237357
marRp,2.0,1,0,TATGGGTACTGCTCGCGTCA,1,2221869
marRp,2.0,1,0,TATGGGCGGGCTAAAGGGAG,1,2228237
marRp,2.0,1,0,TATCGCATAGGAGTGCTTTC,1,2244678
marRp,2.0,1,0,TATCCATCGGCAGAACAAGG,1,2222977
marRp,2.0,1,0,TAGCAGGATAACTGCGGTGA,1,2231385
marRp,2.0,1,0,TACTAAAGCAATCCTTTCCT,1,2228406
marRp,2.0,1,0,TAAGTCGTGGGACAGACTTT,1,2238296
marRp,2.0,1,0,TAAGGAGTTTCAGTGAGATA,1,2248517
marRp,2.0,1,0,TAACTATTGTAGCGGTGCCA,1,2238651
marRp,2.0,1,0,TAAATCTAGGTCTGAATGGG,1,2260896
marRp,2.0,1,0,GTTTAGCAAGCGCCACAGCG,1,2220286
marRp,2.0,1,0,GTTCTAATTCTACGACCCTT,1,2243828
marRp,2.0,1,0,GTGAACCACCTCACGTACCG,1,2234711
marRp,2.0,1,0,GTCTTCGGACTGTGCAGGAT,1,2240795
marRp,2.0,1,0,GTCTAGAGTCAATCGCGGGC,1,2248381
marRp,2.0,1,0,GTCGGGGAACCCAATGAACA,1,2229149
marRp,2.0,1,0,GTCCTTGTCATGGGCTGATA,1,2243763
marRp,2.0,1,0,GTATGTTTTAGTAATGTAAA,1,2257593
marRp,2.0,1,0,GTATCGTAGGTCACGATGGA,1,2230477
marRp,2.0,1,0,GTACTGCAATGCCAATGGTC,1,2251936
marRp,2.0,1,0,GGTCGTCTACGTAGGCGATA,1,2234040
marRp,2.0,1,0,GGTCCGCTTTCTTATGGAGT,1,2221764
marRp,2.0,1,0,GGGTTGAGCTTTCTTATGCC,1,2221658
marRp,2.0,1,0,GGGCGGGGCAAAGGTATTTT,1,2229549
marRp,2.0,1,0,GGCGATCTTGACAATCATTT,1,2255779
marRp,2.0,1,0,GGCAGCCCAAATGGCGATAT,1,2248688
marRp,2.0,1,0,GGACCCGTGACGCACGCTAG,1,2241265
marRp,2.0,1,0,GCTTCCCTCCACAGATAACA,1,2245026
marRp,2.0,1,0,GCTACGAGCTTGCTCGCACG,1,2237453
marRp,2.0,1,0,GCGGCGCCCAATCTCAGAAG,1,2249510
marRp,2.0,1,0,GCCTTGGCCCTAATGGGAGC,1,2253190
marRp,2.0,1,0,GCCAACAAATGAAAAACACT,1,2257018
marRp,2.0,1,0,GCATTATTTTTATCGTCATC,1,2250688
marRp,2.0,1,0,GCATGCATGACTGTTGGGAG,1,2255785
marRp,2.0,1,0,GCATACTGGTTAAGCATACT,1,2247067
marRp,2.0,1,0,GCAGTTCAGCTAAATTGGTA,1,2239559
marRp,2.0,1,0,GCACCTAATGTAGGCCTCTT,1,2229829
marRp,2.0,1,0,GCAAATAGCTGTCGGACCCT,1,2238301
marRp,2.0,1,0,GATTACAACGCCTAATCTTC,1,2221770
marRp,2.0,1,0,GATACGCAATACTTCCTATT,1,2243314
marRp,2.0,1,0,GAGTATTCTGCACGGCAACG,1,2218108
marRp,2.0,1,0,GAGTATTCGGGTACGCTTGT,1,2257045
marRp,2.0,1,0,GAGCGGGTCACGGTACAGGA,1,2234295
marRp,2.0,1,0,GACTTTCACAGCGCACAAGA,1,2260674
marRp,2.0,1,0,GACTACGTATCGACCTTACT,1,2236525
marRp,2.0,1,0,GACGGCAGCTTTTTAGGCGC,1,2219010
marRp,2.0,1,0,GAATTCAAACCAGCGTAACG,1,2225189
marRp,2.0,1,0,GAATAGAATTGGTTCTACAC,1,2245904
marRp,2.0,1,0,GAACTTATCGGTTCCGACTA,1,2218993
marRp,2.0,1,0,CTTTTCGTACCTCCTACCCT,1,2255147
marRp,2.0,1,0,CTTTCTCCGGGGGGGCACCC,1,2244716
marRp,2.0,1,0,CTTTCGATATGGCCGTCCCT,1,2222253
marRp,2.0,1,0,CTTTCACCCGATTAGCCCGT,1,2230137
marRp,2.0,1,0,CTTGGCTTTTACCATAGGTT,1,2244417
marRp,2.0,1,0,CTTATGTGTCAGCTTAGACC,1,2255300
marRp,2.0,1,0,CTTAGATGCTAGACACGATT,1,2241935
marRp,2.0,1,0,CTGGACGATTTGTTGCTAGC,1,2240624
marRp,2.0,1,0,CTCTGCGCTTGGCATCTTCA,1,2254504
marRp,2.0,1,0,CTCCTGTGTCATGACGTTCA,1,2252177
marRp,2.0,1,0,CTCATACTGATCGGGGAAGC,1,2252480
marRp,2.0,1,0,CTATGGACCCTAGGACATCC,1,2221714
marRp,2.0,1,0,CTATCAGGAGTAATTAACCA,1,2222420
marRp,2.0,1,0,CTAATAATTGGCGGGCGGTG,1,2234677
marRp,2.0,1,0,CTAAGTTAGGTAGTTTTACT,1,2219979
marRp,2.0,1,0,CGTGGTTCCGGAAACGATTA,1,2259586
marRp,2.0,1,0,CGTGGGGGTATCTGTTGATC,1,2259100
marRp,2.0,1,0,CGTACGGCGAGATAGGCATG,1,2225135
marRp,2.0,1,0,CGGAAACACGGCTAAACCCT,1,2231430
marRp,2.0,1,0,CCTTGACAGTAGCATAGCCA,1,2237406
marRp,2.0,1,0,CCTTCGCAATAAATGACACC,1,2236046
marRp,2.0,1,0,CCTCCGCGAACAATATTTTT,1,2227315
marRp,2.0,1,0,CCGTCGTAGATGGTGTCTGC,1,2225778
marRp,2.0,1,0,CCGGCCCCCTAGTCTACTGC,1,2221611
marRp,2.0,1,0,CCCTCGGATTTGGGGCAACA,1,2223523
marRp,2.0,1,0,CCCGTCCCAGTCCGTACCCA,1,2244135
marRp,2.0,1,0,CCAATAGTATCCTGTGCTCG,1,2234370
marRp,2.0,1,0,CATAGTTGTTTGGCGACGTT,1,2250430
marRp,2.0,1,0,CAGTATACTATCGACTAATT,1,2252417
marRp,2.0,1,0,CAGGAGGACGGGGCTTGGAC,1,2219770
marRp,2.0,1,0,CACTGTATAGTATTGACAAA,1,2253324
marRp,2.0,1,0,CACGCTATCGTATTCACTAA,1,2225753
marRp,2.0,1,0,CACACCAGCACGTCGCTTTG,1,2231518
marRp,2.0,1,0,CAATGACTCGTGTCTTCAAC,1,2246766
marRp,2.0,1,0,CAAAATTACGCCGACAGCTA,1,2240514
marRp,2.0,1,0,ATTTTTGAGCCATGAGTAAT,1,2222118
marRp,2.0,1,0,ATTTTCCTGGTCTTCGAATA,1,2234541
marRp,2.0,1,0,ATTCCAAAGACGGTCCTTGA,1,2229608
marRp,2.0,1,0,ATGTACATTTCGTCGGTTGA,1,2239491
marRp,2.0,1,0,ATGGCGGCAAGTGTCAAGGG,1,2229077
marRp,2.0,1,0,ATGCTCTGGTTGGCAGGCTC,1,2244032
marRp,2.0,1,0,ATCTCAGTAACGGAGCCAGA,1,2235839
marRp,2.0,1,0,ATAGCATGCGATGTTCAAGT,1,2245236
marRp,2.0,1,0,ATAGAAAGCGTGAGTGCAAG,1,2254178
marRp,2.0,1,0,ATAAACCGATTACTAGAGCT,1,2245985
marRp,2.0,1,0,AGTGAAGGCCAAATAGTATT,1,2223775
marRp,2.0,1,0,AGTCAGGCATACTTGCCATA,1,2258398
marRp,2.0,1,0,AGGCATGTACTTCAGGGCAT,1,2252125
marRp,2.0,1,0,AGCGATTCTTTAGGTTAAGC,1,2256803
marRp,2.0,1,0,AGAGTTGTGGGGCACTGAAC,1,2239835
marRp,2.0,1,0,AGACCGAGTAAAGTAGTTGA,1,2254082
marRp,2.0,1,0,ACTTTATCTATGTTATATTC,1,2228970
marRp,2.0,1,0,ACTAGCTCGTCCCCAGAATT,1,2248245
marRp,2.0,1,0,ACGGTAACACGGTAGTTGTC,1,2225033
marRp,2.0,1,0,ACGGGCATTATCGCTGAGCT,1,2259837
marRp,2.0,1,0,ACGGGATATCGTATCAGTCT,1,2258436
marRp,2.0,1,0,ACGGAATAGGGTGTAGTTTA,1,2245541
marRp,2.0,1,0,ACGCCCGAACGGGTGAGTTC,1,2223369
marRp,2.0,1,0,ACCGGGCTCTACTCGTTGAA,1,2234631
marRp,2.0,1,0,ACCGCTTATAGCAGTAGCGA,1,2236241
marRp,2.0,1,0,ACATGTTGGAGTGGTAGTCG,1,2223110
marRp,2.0,1,0,ACATAGCAGAAAGAGCATAG,1,2228822
marRp,2.0,1,0,ACAGACAATTCATAGTGGCT,1,2224009
marRp,2.0,1,0,ACACTCACCTCTCGTGCCTC,1,2219455
marRp,2.0,1,0,AATTTGCGCAACTATTGTAC,1,2255839
marRp,2.0,1,0,AATCATGCACTAACATCGGG,1,2225596
marRp,2.0,1,0,AATCAACTTCGGATAGGATC,1,2230236
marRp,2.0,1,0,AACGGCAGGAAGTGCGTTCC,1,2243720
marRp,2.0,1,0,AACAAAGAGTCGCTGGACCT,1,2220064
marRp,2.0,1,0,AAATGCACGTCCGGCGCCCG,1,2229712
marRp,2.0,1,0,AAACAACGTTGGCCTCAAAT,1,2235697
marRp,2.0,1,0,AAAAGCCGGTCTAAACATCG,1,2246036
