name,relative_counts,ct,ct_0,barcode,ct_1,barcode_ind
hyuA_predicted,0.6060100166944908,960,598,CCAGGAAGCTACGGCGTAGA,362,1840782
hyuA_predicted,0.48623853211009177,808,544,TCGTTTGGAACGGTAGGCAG,264,1852122
hyuA_predicted,0.358974358974359,157,116,CTTAAGGTATTAATTGGCCT,41,1840052
hyuA_predicted,0.6770833333333334,159,95,CTATAGATAGGCCCAACCTA,64,1842598
hyuA_predicted,0.021505376344086023,93,92,CCGTACGCACCAATGAGATT,1,1828936
hyuA_predicted,0.7802197802197802,160,90,GCAGTCCCTAAAAACCCCCG,70,1848554
hyuA_predicted,0.2875,101,79,AAGATCGAGCTGCAAGGGCA,22,1849233
hyuA_predicted,0.2727272727272727,96,76,ATTGCTCAGTTTGGTACTTA,20,1872536
hyuA_predicted,0.5657894736842105,117,75,CCTGTCCTGCTGGGCAATGC,42,1829318
hyuA_predicted,0.4666666666666667,108,74,GCAGCATTAGTAACATTCTA,34,1862228
hyuA_predicted,0.3466666666666667,99,74,GATTCTCCCAACAGAAGGAC,25,1833075
hyuA_predicted,0.7733333333333333,131,74,ACTGAGTGTGGTCCCTTCTT,57,1837092
hyuA_predicted,1.0434782608695652,139,68,TTCACCGCGAGTAGGAATAA,71,1863904
hyuA_predicted,0.7727272727272727,115,65,TAGATCGTGTCCAGTGCCCC,50,1852377
hyuA_predicted,0.23076923076923078,78,64,TCAAGTTGGGGCGTATGTCG,14,1854780
hyuA_predicted,0.7076923076923077,109,64,ACGTAGGAGCATTTGCTGAT,45,1831985
hyuA_predicted,0.296875,81,63,GCACTGGGAATAAGATAAGT,18,1830088
hyuA_predicted,0.873015873015873,116,62,GTCACAAACCTTTCGGCCTT,54,1832287
hyuA_predicted,0.29508196721311475,77,60,TGAGTTAAAGGTTCATTGTA,17,1863863
hyuA_predicted,0.38333333333333336,81,59,TCAGCCCTTTGGTTTATTTA,22,1850404
hyuA_predicted,1.4,142,59,GCGTCATCGTGTAACCTCCA,83,1829828
hyuA_predicted,0.5166666666666667,89,59,CCCGAAGTCCGTCACTGGCA,30,1860984
hyuA_predicted,0.6666666666666666,98,59,CAGACGCTCGCCTAGAAGTA,39,1832788
hyuA_predicted,0.25,73,59,ATCGTTATATCGCCCGCCAG,14,1831012
hyuA_predicted,0.3220338983050847,76,58,CATCAGTCAAATCGCGCGAC,18,1839062
hyuA_predicted,0.8135593220338984,105,58,AGTGGATCGGCCGCTATTAA,47,1836881
hyuA_predicted,0.4827586206896552,84,57,AGCGGGGTTATCTTACGCAG,27,1839382
hyuA_predicted,0.034482758620689655,58,57,AGCCTGGAGCCGCTGGGACG,1,1839559
hyuA_predicted,0.5964912280701754,89,56,GGTGAACAGGCCATGTGGGT,33,1830487
hyuA_predicted,0.7719298245614035,99,56,GGCGGTCAGGCGTAGACCTA,43,1855298
hyuA_predicted,0.2631578947368421,70,56,CTGAAAAAGCGCGCTCGCAG,14,1834007
hyuA_predicted,0.625,89,55,GTCTACATGAGTCAACCTGT,34,1843982
hyuA_predicted,0.7678571428571429,97,55,CGCTACTCACAAGAAAGAAA,42,1830583
hyuA_predicted,1.3214285714285714,128,55,ACCTTTCGTTACTTGGATTA,73,1839668
hyuA_predicted,0.42592592592592593,75,53,TTTGTCTGCTGGAGGTGAAG,22,1829803
hyuA_predicted,0.11538461538461539,56,51,TCCGATAACGGATCTCAAAC,5,1829097
hyuA_predicted,0.36538461538461536,69,51,GGTAGGATAAACTCGGCCAC,18,1853689
hyuA_predicted,0.21568627450980393,60,50,CCTTGCATGCACCAGTGACA,10,1832613
hyuA_predicted,0.52,74,49,GCTTTAACTCAAATTTAAAT,25,1857026
hyuA_predicted,0.88,92,49,CTGCCCTCACTCCGTTCTGT,43,1860084
hyuA_predicted,0.22448979591836735,58,48,TGGCTTGGCTCGCGCACCTT,10,1829679
hyuA_predicted,1.3265306122448979,112,48,GTTTTTAATGTCCTCCCAAT,64,1871198
hyuA_predicted,0.5510204081632653,74,48,GCTATACGGCCAAATAACTA,26,1843493
hyuA_predicted,0.5102040816326531,72,48,CTGTTGCGTGTCCTGGTAAA,24,1830309
hyuA_predicted,0.40816326530612246,67,48,CTCCATGACAAAAGACTTAT,19,1847998
hyuA_predicted,0.3125,61,47,TTGTTCGTAGAGGGGTAAAT,14,1841005
hyuA_predicted,1.3333333333333333,110,47,CCCGTCAGGGGTCCATCCAA,63,1835780
hyuA_predicted,0.7708333333333334,83,47,CCAAGACTTTTGGTAGGGAA,36,1831442
hyuA_predicted,1.125,100,47,CAGGGGTATCCTTTATGTGG,53,1841668
hyuA_predicted,0.2553191489361702,57,46,GGGGGACCCAGCTAAGTGAA,11,1845533
hyuA_predicted,0.8723404255319149,86,46,GCTCCCATACTAGGTCATGT,40,1859037
hyuA_predicted,0.10638297872340426,50,46,AGACGGACTTCAAGGTCTTT,4,1854570
hyuA_predicted,0.4782608695652174,66,45,TCCCACATACTTAGCGTCGT,21,1833043
hyuA_predicted,1.608695652173913,118,45,GTCGCCCTTACGACCTCAAA,73,1853329
hyuA_predicted,0.2826086956521739,57,45,CTGCCGAAAATCAAAGCAAA,12,1839673
hyuA_predicted,0.08695652173913043,48,45,CGTAAGTGCGAGCCTATACC,3,1873499
hyuA_predicted,1.173913043478261,98,45,CCCTATTTACCCTGTTTCGC,53,1830169
hyuA_predicted,0.45652173913043476,65,45,AGTCGCAAAACGGATATGGT,20,1846010
hyuA_predicted,0.6956521739130435,76,45,AAACACTTACCGTAGTTAAT,31,1843392
hyuA_predicted,0.9555555555555556,86,44,TCTCAGACGTGCCGAAGGTT,42,1857780
hyuA_predicted,0.5777777777777777,69,44,GATTATAACCTCTCAATTAA,25,1856675
hyuA_predicted,0.7777777777777778,78,44,GACGAGGTAAGCACCGGCCA,34,1844245
hyuA_predicted,0.5111111111111111,66,44,GAAATGAGGGCTACGTGCTT,22,1843235
hyuA_predicted,0.28888888888888886,56,44,CCCACCCGTAAGCGGCGCGC,12,1833746
hyuA_predicted,1.3636363636363635,102,43,TGTCGGATTACGCTATACAG,59,1835823
hyuA_predicted,0.7045454545454546,73,43,TGATCGATGGATGTTGACGT,30,1844255
hyuA_predicted,0.75,75,43,GTAACAGTGCGTTACATTAC,32,1831925
hyuA_predicted,0.29545454545454547,55,43,GCGGGTTTGCGATCCGGCAA,12,1857054
hyuA_predicted,0.5227272727272727,65,43,GCCGATTCCTCGCTCCGTAA,22,1843850
hyuA_predicted,0.6363636363636364,70,43,CCTTAGAGCGTTCCAGTTAG,27,1836723
hyuA_predicted,0.8409090909090909,79,43,AGCACTACTACACACTCCAT,36,1866923
hyuA_predicted,0.5454545454545454,66,43,AACGTGTGTGAGCCTCGTTG,23,1857870
hyuA_predicted,0.5348837209302325,64,42,CGCTTGGAAGGCCTGCGGGG,22,1837973
hyuA_predicted,0.7209302325581395,72,42,CAATAACCCACATAGGCCTA,30,1850224
hyuA_predicted,0.046511627906976744,43,42,ATAGGTGATCGCCCACGTTG,1,1836640
hyuA_predicted,0.9761904761904762,81,41,TCTTTTCGACTAAATGACTA,40,1875707
hyuA_predicted,0.7380952380952381,71,41,TCCGATTAAATGTAGTGCGG,30,1874896
hyuA_predicted,0.21428571428571427,49,41,GGGTGACATATTCGTGGTTA,8,1858802
hyuA_predicted,0.6904761904761905,69,41,CTCGGGGTTTCGGTGACGGT,28,1849152
hyuA_predicted,0.7142857142857143,70,41,CGTCCCCAATAGAAGACATT,29,1840822
hyuA_predicted,0.9523809523809523,80,41,CATACACCATCGTGTTCCTA,39,1840583
hyuA_predicted,0.6190476190476191,66,41,CACCAGACCACAGGCCCGAT,25,1835855
hyuA_predicted,0.16666666666666666,47,41,ATGGAGTTGGTACGTCTGTT,6,1838326
hyuA_predicted,0.36585365853658536,54,40,TTTTTGGTATCAACGGAGGA,14,1865851
hyuA_predicted,0.5853658536585366,63,40,TGCTAGTTTGTTTATATATG,23,1837643
hyuA_predicted,0.2926829268292683,51,40,TCGGCATCTCGGCAGACTAT,11,1843893
hyuA_predicted,1.2439024390243902,90,40,TCAAGACAATGGAGCTTGCT,50,1851720
hyuA_predicted,0.07317073170731707,42,40,TATACTCTCAAGTGTAGAGT,2,1838642
hyuA_predicted,0.04878048780487805,41,40,GTCGGCGCTATGGGATCAGT,1,1865726
hyuA_predicted,0.8536585365853658,74,40,CTCCAGACCCAAAGGTTAAA,34,1858951
hyuA_predicted,0.12195121951219512,44,40,CCGCGAGGTGAATTTTAACA,4,1853134
hyuA_predicted,1.5609756097560976,103,40,CCACTAATTTCAATTCCCGA,63,1848298
hyuA_predicted,0.12195121951219512,44,40,ATATACATAACTACCATACA,4,1835880
hyuA_predicted,0.5121951219512195,60,40,ACATACTCAGTGCTCGGAAA,20,1835562
hyuA_predicted,0.125,43,39,TTGCTATAACGTCATTTCTA,4,1865199
hyuA_predicted,1.05,80,39,GTCCTCTACCTCCTTTGCTA,41,1870296
hyuA_predicted,0.55,60,39,GGCCTCAGGGAGGTAGGCTA,21,1840222
hyuA_predicted,0.05,40,39,GCGTGGACACGTAAACGATG,1,1859422
hyuA_predicted,0.45,56,39,GAGCTGTTGGGCATAGGTTT,17,1846096
hyuA_predicted,0.375,53,39,CTACTATAGACTGAGCCTGA,14,1837797
hyuA_predicted,0.425,55,39,CGGAGGGCTTCCCGCCTAAC,16,1837420
hyuA_predicted,0.725,67,39,CCTTAAGGCTATGGAGTCCA,28,1834556
hyuA_predicted,0.05,40,39,CCATTCGGGCGAAGGGGGAT,1,1861265
hyuA_predicted,0.2,46,39,AGATGAAAATTGGTACCTCA,7,1832695
hyuA_predicted,0.3333333333333333,50,38,TCCCCCTTTAGTCAGAACTG,12,1872617
hyuA_predicted,0.5128205128205128,57,38,GCGGCACTTAGGCAAGCCCA,19,1830681
hyuA_predicted,1.2564102564102564,86,38,CTGCTGTGGTAAGACGCGGT,48,1833229
hyuA_predicted,0.7948717948717948,68,38,CTACGCCGGGTCACCCCACT,30,1829119
hyuA_predicted,0.3333333333333333,50,38,CCAGGCCCAAGCGCGTTGGG,12,1860650
hyuA_predicted,0.20512820512820512,45,38,ACAGGAGTCAGCTAGATAAT,7,1859477
hyuA_predicted,1.1025641025641026,80,38,AAGATAACTCGACTTTGTGC,42,1834943
hyuA_predicted,0.868421052631579,69,37,TGTCATGGCCTGATTTAGTT,32,1872818
hyuA_predicted,0.10526315789473684,40,37,TCGTGATACGCCCGCTCCAA,3,1833237
hyuA_predicted,0.39473684210526316,51,37,TCCAACTGTTAACAAATTCG,14,1842096
hyuA_predicted,0.10526315789473684,40,37,TCAATCGAAGATCCAGGTGT,3,1855355
hyuA_predicted,0.8157894736842105,67,37,TACGGGAAATTCGAGCGGAA,30,1862159
hyuA_predicted,0.42105263157894735,52,37,GTTCACGATGGAACGATCGT,15,1861099
hyuA_predicted,0.10526315789473684,40,37,GTGTCCATCTTTGGCCCGTA,3,1846518
hyuA_predicted,0.13157894736842105,41,37,GCGCACTCCATCTGTTAGAA,4,1866246
hyuA_predicted,0.7631578947368421,65,37,GAGATATAGTCGTTCAACCT,28,1839334
hyuA_predicted,0.10526315789473684,40,37,CTGACGGCAGAGGCTGTCTA,3,1851222
hyuA_predicted,0.13157894736842105,41,37,CTATCGGGCACGCTAGGGGA,4,1867804
hyuA_predicted,0.9736842105263158,73,37,CGGAGTGACCGCAAAACTTG,36,1844674
hyuA_predicted,0.7631578947368421,65,37,CGAAGAGGTGATCGTACGGG,28,1832075
hyuA_predicted,1.2105263157894737,82,37,CCCGGTTCTGGCAGGATTAT,45,1849968
hyuA_predicted,0.8421052631578947,68,37,CCCGAACATGTCGTACTTAT,31,1836238
hyuA_predicted,0.8157894736842105,67,37,CCATGAACCATACAGTGTTT,30,1842636
hyuA_predicted,0.2631578947368421,46,37,ACTACCCGCGGCGAATAGTT,9,1845014
hyuA_predicted,0.972972972972973,71,36,TTCCGTCAGGCAGTCGGTAG,35,1848464
hyuA_predicted,0.24324324324324326,44,36,TCAAGCTTGGTTCCTACCAG,8,1869528
hyuA_predicted,0.2972972972972973,46,36,TAGCGATGGAGTGAGAATGA,10,1844423
hyuA_predicted,0.8918918918918919,68,36,GTGATTGTTCTTATCCCGGT,32,1854226
hyuA_predicted,0.24324324324324326,44,36,GTAGAAGGATCACCTAGCGA,8,1835779
hyuA_predicted,0.4594594594594595,52,36,GTACAACGGCAAATATACGC,16,1834986
hyuA_predicted,0.2702702702702703,45,36,GGAATATCTAGTTTGTACCA,9,1846288
hyuA_predicted,0.8648648648648649,67,36,GCTTCACTCATGCGTACGTG,31,1854978
hyuA_predicted,0.8648648648648649,67,36,GAGAACCGCTACATGGCCGA,31,1834528
hyuA_predicted,0.5405405405405406,55,36,CTCTAGTGGATCCTTAATTA,19,1840165
hyuA_predicted,1.4054054054054055,87,36,CTAAGGATCCGGTCGGGATA,51,1831251
hyuA_predicted,0.6756756756756757,60,36,CGGTAGGTACCATGGCAGTA,24,1851030
hyuA_predicted,0.32432432432432434,47,36,CGGATGATGGATTTATGGGA,11,1855592
hyuA_predicted,0.7837837837837838,64,36,CATTTACGGGTTGGAAGAGC,28,1851056
hyuA_predicted,0.32432432432432434,47,36,ATGGTGTGGCTCGCTTGAGA,11,1835414
hyuA_predicted,0.08108108108108109,38,36,AGTGGTCTTCAGTCTGGTAT,2,1835461
hyuA_predicted,1.0,72,36,AGGGACCTGAGAGCGCTTCA,36,1830718
hyuA_predicted,0.3888888888888889,48,35,TTCTGTCACGGGGTTAAAAT,13,1856910
hyuA_predicted,0.16666666666666666,40,35,TTATCTGCCCAGTTTGGATT,5,1836209
hyuA_predicted,1.2777777777777777,80,35,TGTAGGGTGCCACCCTGGTT,45,1871796
hyuA_predicted,0.6944444444444444,59,35,TGACGCCGCCTCGGATCGCG,24,1832443
hyuA_predicted,0.5,52,35,TCCGCTTTCCTTCAGCGAAG,17,1841172
hyuA_predicted,1.3333333333333333,82,35,TCCCGTGGAACTGCCCGTAA,47,1831401
hyuA_predicted,0.08333333333333333,37,35,TACGTCTTATCGCGTTCCGG,2,1855439
hyuA_predicted,0.8055555555555556,63,35,GGAAATTATGGAGCAACTAG,28,1830241
hyuA_predicted,1.8333333333333333,100,35,GACACCTCCTCGTTAGCTAG,65,1858434
hyuA_predicted,0.9166666666666666,67,35,CTCTGATCGCAGGTTCGTTT,32,1830966
hyuA_predicted,0.08333333333333333,37,35,CGTGGCACAACATCCCGCTT,2,1829105
hyuA_predicted,2.7777777777777777,134,35,CGGTGTAGCCACTGCTTCTT,99,1850636
hyuA_predicted,0.6111111111111112,56,35,CCTCAAAAACGAAAAATGGT,21,1842638
hyuA_predicted,0.8333333333333334,64,35,CCGAAACGATACCAGCTCTA,29,1839134
hyuA_predicted,0.6388888888888888,57,35,ATCATAATAATGGGCTGCCT,22,1860572
hyuA_predicted,2.861111111111111,137,35,AGGGTTTACATGGCAAACCT,102,1835464
hyuA_predicted,0.6388888888888888,57,35,ACTGGGGAGACTAGGCATAT,22,1831334
hyuA_predicted,0.25,43,35,ACCTTTTAATATGGAGACGT,8,1838703
hyuA_predicted,0.05555555555555555,36,35,AATGACAGTCTTAGGGGGCT,1,1864343
hyuA_predicted,0.5555555555555556,54,35,AAAGGCGCCGCTTAGGCAGA,19,1862945
hyuA_predicted,0.6571428571428571,56,34,TTTTGAACGTGGTCAAGCAA,22,1848785
hyuA_predicted,0.7714285714285715,60,34,GCAGAACGTGCCCAAAGTAA,26,1837453
hyuA_predicted,0.05714285714285714,35,34,GACTTATGCCAGGAATTCTC,1,1846519
hyuA_predicted,0.6,54,34,CGGGTAAGCCGAGCTCAAGT,20,1867147
hyuA_predicted,0.4857142857142857,50,34,CGCGGTAAAGCTGCTTATAA,16,1847146
hyuA_predicted,0.9142857142857143,65,34,CCTCTGAGGTATTGTGAAAT,31,1867984
hyuA_predicted,1.9714285714285715,102,34,CCGTCCTACGTCCGGTTGCT,68,1846464
hyuA_predicted,0.3142857142857143,44,34,CCAGCCCGGTTGCCGCTCAC,10,1875208
hyuA_predicted,0.11428571428571428,37,34,CATCGCCAGATCAAAACTTG,3,1841496
hyuA_predicted,2.142857142857143,108,34,CAGCCCCTTCTTTTTTTCTG,74,1830039
hyuA_predicted,1.457142857142857,84,34,ACACCAACTCCTATTCGAGG,50,1836364
hyuA_predicted,0.7714285714285715,60,34,AACCTTACCCCGCGCAGGCC,26,1853635
hyuA_predicted,0.45714285714285713,49,34,AAAGTCGAGTTATTCAGAGT,15,1862447
hyuA_predicted,0.35294117647058826,44,33,TTTTCTGCTGAGGTTTGTTG,11,1867001
hyuA_predicted,0.8235294117647058,60,33,TTGTACGCTAATCTTGCCTA,27,1841924
hyuA_predicted,0.058823529411764705,34,33,TTGCTACCTGAATTGAAAGA,1,1837362
hyuA_predicted,0.5,49,33,TGTTGTCGCTTCGCAACTAG,16,1843069
hyuA_predicted,0.5882352941176471,52,33,TGGACAACGGGTTGTTTATT,19,1863203
hyuA_predicted,0.17647058823529413,38,33,TCTTTTCCATAGTGGACGTT,5,1840938
hyuA_predicted,0.23529411764705882,40,33,TCGGTGAGCTCTGTCACTCA,7,1852467
hyuA_predicted,0.23529411764705882,40,33,TCGATTTCGGCAGTCCCGAC,7,1867626
hyuA_predicted,0.6470588235294118,54,33,GTTAGGGCAAGTGGCATGTA,21,1867506
hyuA_predicted,0.35294117647058826,44,33,GTCTTGGCAGACACTCGGTT,11,1866054
hyuA_predicted,2.088235294117647,103,33,GTCTGCCAAAAAAGGGTCTC,70,1859876
hyuA_predicted,0.9705882352941176,65,33,GTATACGACGCCCAGGCACA,32,1873969
hyuA_predicted,1.2941176470588236,76,33,GAGTGAATGTCAGAGCGATT,43,1835739
hyuA_predicted,1.7352941176470589,91,33,CTCCGTTAGGGGTGACGCCC,58,1861095
hyuA_predicted,0.20588235294117646,39,33,CGGCGGACAGATTCTGCACC,6,1836241
hyuA_predicted,0.7352941176470589,57,33,CGCTATTCGGTCCTCGCTAT,24,1833671
hyuA_predicted,0.29411764705882354,42,33,CACGACCAACAGTGTGCCCT,9,1842989
hyuA_predicted,0.47058823529411764,48,33,CACCAGCTCGGGCCTCACGA,15,1869009
hyuA_predicted,1.0294117647058822,67,33,ATGGCAGAATACCTAAATCC,34,1829371
hyuA_predicted,0.6764705882352942,55,33,AGCGTAATAACGTATCCTTT,22,1835903
hyuA_predicted,0.9411764705882353,64,33,ACTGATGAACCCCTAGAGTC,31,1854951
hyuA_predicted,0.3235294117647059,43,33,ACGTGCACCTAAGAAATAGT,10,1851089
hyuA_predicted,0.35294117647058826,44,33,ACATACATTTGCGGGGGAAT,11,1832322
hyuA_predicted,0.17647058823529413,38,33,ACAGGCTGCAATCCTGGTCC,5,1871624
hyuA_predicted,0.2727272727272727,40,32,TTTTGTACTACTTCACATGA,8,1838798
hyuA_predicted,1.0909090909090908,67,32,TTACTATCCGTCACAGTGCT,35,1853880
hyuA_predicted,0.6666666666666666,53,32,TGGGTACTAATCAGGGCTCA,21,1863382
hyuA_predicted,0.24242424242424243,39,32,TGATTGTCTCTCATGGGGTA,7,1855409
hyuA_predicted,0.09090909090909091,34,32,TGACAGGGCATACAGCCACG,2,1837476
hyuA_predicted,0.2727272727272727,40,32,GTCTCGACTCGACTTCGCAA,8,1865004
hyuA_predicted,1.121212121212121,68,32,GTATCCAGACAAGGCGATCT,36,1838264
hyuA_predicted,1.121212121212121,68,32,GGTGGATGTAAGAATGCGGT,36,1837341
hyuA_predicted,0.5151515151515151,48,32,GACAGGTTTGTCACCTGTAT,16,1831695
hyuA_predicted,0.15151515151515152,36,32,CTTCAGTGTATGCGCAAGAG,4,1870582
hyuA_predicted,0.5454545454545454,49,32,CGTTGCCCAATGAGCGTCGT,17,1848153
hyuA_predicted,0.09090909090909091,34,32,CGGTTGTGCACATTGTCCCA,2,1845595
hyuA_predicted,0.06060606060606061,33,32,CCCTCTGAGCCGATAGTAGG,1,1836644
hyuA_predicted,1.121212121212121,68,32,CATGGGTTCATGGCGGTTTT,36,1838541
hyuA_predicted,0.18181818181818182,37,32,ATGTCAGAAGTAGATAAACT,5,1857876
hyuA_predicted,0.6363636363636364,52,32,ACTGAGTACCCGAGAGACTG,20,1842014
hyuA_predicted,0.45454545454545453,46,32,ACCAGACAGCAAGTACTCTG,14,1851512
hyuA_predicted,0.18181818181818182,37,32,ACAGGTACGTTGGGCTTGAT,5,1860798
hyuA_predicted,0.15151515151515152,36,32,ACAATCGTACAACTTCATGG,4,1858946
hyuA_predicted,0.12121212121212122,35,32,AAAGTCGTTTTCGTTGGAAT,3,1838098
hyuA_predicted,0.9696969696969697,63,32,AAACCAGGATAAGTCGTCAA,31,1834097
hyuA_predicted,0.0625,32,31,TTATTACGGGCCGGCAGAAC,1,1838383
hyuA_predicted,0.0625,32,31,TGAGAAGCCGATTCGGCGAA,1,1835950
hyuA_predicted,0.1875,36,31,TCGTCTGGTCACGTGATGGC,5,1835796
hyuA_predicted,1.34375,73,31,TAACGTTCCTTTGCACACGT,42,1838094
hyuA_predicted,0.1875,36,31,GTTTGCGACTCTCTGGGTGT,5,1874534
hyuA_predicted,0.5,46,31,GTCGAGTCAAGGCTACGCTA,15,1849983
hyuA_predicted,0.28125,39,31,GTCCGACCTTGCGCATCCCG,8,1835937
hyuA_predicted,0.125,34,31,GTAATTTTTTTTGTCAAGCT,3,1871777
hyuA_predicted,0.4375,44,31,GTAAGCATGCTTCTCGCCAG,13,1829659
hyuA_predicted,1.0,62,31,GGGGAATGCCTCGAGCATGT,31,1831008
hyuA_predicted,0.09375,33,31,GGACCTCTCACGCCTACATC,2,1877844
hyuA_predicted,0.1875,36,31,GCTTGATCGGCTCTTACAAT,5,1847618
hyuA_predicted,0.28125,39,31,GCGATTTTACCGTCCTCGAT,8,1832497
hyuA_predicted,0.40625,43,31,GCATTCTGACCCTCTGCATA,12,1852091
hyuA_predicted,1.28125,71,31,CTCGAATATTGCCGGCAAGT,40,1867155
hyuA_predicted,0.375,42,31,CGTTTCGTTGAGTTGTTTAA,11,1840260
hyuA_predicted,0.46875,45,31,CGGTAGTCTATACTACCGCC,14,1846827
hyuA_predicted,0.28125,39,31,CGGCGGGACGCTTGGGTGGT,8,1832246
hyuA_predicted,0.28125,39,31,ATGGCACCCGCACTCCGACT,8,1838117
hyuA_predicted,1.59375,81,31,AGCCAAAAGTGCAGCAAGAA,50,1837943
hyuA_predicted,0.9375,60,31,AGAGACATGCGACTGAGACA,29,1868437
hyuA_predicted,0.625,50,31,ACAAGATTGGCCCGGTATTT,19,1858977
hyuA_predicted,0.53125,47,31,AAATCTGAATATGTGAGCTA,16,1845938
hyuA_predicted,0.16129032258064516,34,30,TTGGACTCGTAATCAGAACA,4,1849339
hyuA_predicted,0.12903225806451613,33,30,TTGCTGTGCAAGTAGATTTT,3,1834988
hyuA_predicted,0.16129032258064516,34,30,TGTATGGTATAAAGTGATAC,4,1853300
hyuA_predicted,1.0,60,30,TGGTTAGCAATACGTGCTCG,30,1833268
hyuA_predicted,0.4838709677419355,44,30,TGACCTCGCCAATCGAATCA,14,1831255
hyuA_predicted,1.2258064516129032,67,30,TCGGCTTCATCTAGTAACAG,37,1837634
hyuA_predicted,0.41935483870967744,42,30,TCACGATCCACTCCATGAGA,12,1852916
hyuA_predicted,0.6129032258064516,48,30,TACCGACCGGTGGCGATCTG,18,1849276
hyuA_predicted,0.6129032258064516,48,30,TAACAGAGGGGCTCGCTCAA,18,1834220
hyuA_predicted,0.6774193548387096,50,30,GTGTGTTGGAACGATGACTC,20,1854937
hyuA_predicted,0.6774193548387096,50,30,GTCCGTCCTTGGCGGCAGTT,20,1854131
hyuA_predicted,0.12903225806451613,33,30,GCGTATGATATTAAGATCCT,3,1855784
hyuA_predicted,0.12903225806451613,33,30,GCATAACGAAGCGTGTCTAT,3,1839354
hyuA_predicted,0.9032258064516129,57,30,GCACACACTTGCATAGATAA,27,1841246
hyuA_predicted,0.45161290322580644,43,30,GACAGTTATCCGGGCCGTGG,13,1839774
hyuA_predicted,0.8709677419354839,56,30,CTGTCCTGTTGAGCATGAGA,26,1845398
hyuA_predicted,0.06451612903225806,31,30,CTCAGACTCGGTCTTCTCAA,1,1858092
hyuA_predicted,0.16129032258064516,34,30,CTAGGTCATTGCAACGTCAA,4,1838664
hyuA_predicted,0.25806451612903225,37,30,CGACGCGCCCATGGTTGTAG,7,1849736
hyuA_predicted,0.5483870967741935,46,30,CCATCTTCACCGACTGTCCA,16,1860389
hyuA_predicted,0.16129032258064516,34,30,CCACGATTTGACCCCGGTGG,4,1859071
hyuA_predicted,0.06451612903225806,31,30,CATAAAGCATCCAAATCTGG,1,1848146
hyuA_predicted,0.41935483870967744,42,30,CAGCCAACCGTTGGTCGTTA,12,1873483
hyuA_predicted,0.16129032258064516,34,30,CACCATACCTTCTAATTATT,4,1869565
hyuA_predicted,0.3225806451612903,39,30,ATGTATAAACGGTGCTTGTG,9,1840695
hyuA_predicted,1.6129032258064515,79,30,AGTATAATTTACTTAGGGAT,49,1855217
hyuA_predicted,0.4838709677419355,44,30,AGCGCACCGTCCGAGCAGAA,14,1836210
hyuA_predicted,0.25806451612903225,37,30,AGCCGAGCTCGTAGGGGGGA,7,1869270
hyuA_predicted,0.16129032258064516,34,30,AGCCCCGGAATCCAGAAAAT,4,1873001
hyuA_predicted,0.22580645161290322,36,30,AGCATGCCTATAACTAAGAA,6,1840957
hyuA_predicted,1.064516129032258,62,30,AGACTTTATCATCTTTAACT,32,1840163
hyuA_predicted,0.5161290322580645,45,30,AGACGCCTACTAGACAAATT,15,1850228
hyuA_predicted,0.6129032258064516,48,30,ACACACCGAATATGCACAGG,18,1839848
hyuA_predicted,0.25806451612903225,37,30,AACTTGCGATTGCCCAACTT,7,1839385
hyuA_predicted,1.1935483870967742,66,30,AAACGTGGAGCTGGATTGCT,36,1846821
hyuA_predicted,1.6,76,29,TTTAATTCGACACCTCCTCA,47,1856798
hyuA_predicted,0.16666666666666666,33,29,TTGACAGGTTCCTCAATACT,4,1849883
hyuA_predicted,0.1,31,29,TTCGGGACTTCACACCAAGA,2,1870192
hyuA_predicted,0.06666666666666667,30,29,TGATGCCCACCCAAGGTCTA,1,1865504
hyuA_predicted,0.9,55,29,TGAGATGCAGTTGTCTTCGT,26,1854173
hyuA_predicted,0.1,31,29,TCAGGCAGTTCCTAAGTCTT,2,1848665
hyuA_predicted,0.9,55,29,TAATGTATTGCTCGGAACAT,26,1857238
hyuA_predicted,0.6666666666666666,48,29,GTCTTAAGGTTAGCCCTTTA,19,1861191
hyuA_predicted,0.9666666666666667,57,29,GTACTTAAACCAGTGCTCTA,28,1867717
hyuA_predicted,0.1,31,29,GGGTCCACTATCGCCGTTTT,2,1864766
hyuA_predicted,0.5333333333333333,44,29,GGCCACCTGAGACATTCAAG,15,1842990
hyuA_predicted,1.1333333333333333,62,29,GCAGAATCAACTTTCCATTC,33,1853330
hyuA_predicted,0.8666666666666667,54,29,GATACTCGACGAATTCGCTG,25,1845717
hyuA_predicted,0.4,40,29,GACCCGTGCAAAGCGCTCAT,11,1839949
hyuA_predicted,0.06666666666666667,30,29,GAACTGTCCGGCCGTGTTCC,1,1839878
hyuA_predicted,0.3,37,29,CTGGTGGTAGTAGAGGTACA,8,1857398
hyuA_predicted,1.0666666666666667,60,29,CTCCGCGATCGCCCAATGGT,31,1859324
hyuA_predicted,0.6333333333333333,47,29,CGTTAAGTAACGAACGTTTT,18,1833227
hyuA_predicted,0.13333333333333333,32,29,CGCGCGTATAAGGCAATCGG,3,1857746
hyuA_predicted,1.0,58,29,CCTTCTGGGAGCGATTTCAA,29,1830623
hyuA_predicted,1.8666666666666667,84,29,CCTGCCTATTCGAAAAGAAT,55,1830905
hyuA_predicted,0.06666666666666667,30,29,CCCGGGAGATTTGCCTTCTT,1,1855552
hyuA_predicted,1.1,61,29,CAGGCCGGAATTACGACGGA,32,1860133
hyuA_predicted,0.6,46,29,CACTGGACTAACGATACTAT,17,1830283
hyuA_predicted,0.16666666666666666,33,29,ATTAGGATGCCTTCCTATCA,4,1847069
hyuA_predicted,0.16666666666666666,33,29,ATGGGTGCTACTGCGTCGAG,4,1839940
hyuA_predicted,0.3,37,29,ATCCAGGCTCCTTTTCCTTA,8,1860447
hyuA_predicted,0.23333333333333334,35,29,AGGTCATGAATCCTCTCGTT,6,1846822
hyuA_predicted,1.8333333333333333,83,29,AGCTGCATTTCATTGTTCTC,54,1866378
hyuA_predicted,0.4,40,29,ACGGCTATTTCTTAGGGTCA,11,1833482
hyuA_predicted,1.6666666666666667,78,29,ACGCACCGATTGTACTCAAC,49,1853375
hyuA_predicted,1.0,58,29,ACAGGAGCTTACCTCTAATG,29,1865327
hyuA_predicted,0.43333333333333335,41,29,ACAGCGGCAGGCAAAGTGTA,12,1873512
hyuA_predicted,0.23333333333333334,35,29,AAAGTCGTAGGGGGGGTTTT,6,1864722
hyuA_predicted,0.23333333333333334,35,29,AAAGGCAGGGTTATATAGTA,6,1871591
hyuA_predicted,0.06896551724137931,29,28,TTGATCTTGGTGTAAATCAA,1,1869306
hyuA_predicted,0.06896551724137931,29,28,TGGGCGGCCCGCTACTGGCT,1,1841918
hyuA_predicted,0.6206896551724138,45,28,TGCAACCCATAAAATCGATA,17,1830613
hyuA_predicted,1.4137931034482758,68,28,TCTCAATGTGGGACCCCCAA,40,1852470
hyuA_predicted,0.20689655172413793,33,28,TCGACTTAAAGCGTCCATGT,5,1852956
hyuA_predicted,0.9310344827586207,54,28,TACGCGGAAATACGAAGCTA,26,1842573
hyuA_predicted,1.4137931034482758,68,28,TACAGGAGCGATCTTGCCTG,40,1872857
hyuA_predicted,0.3448275862068966,37,28,GTCAACAGTACATGGACCGG,9,1834985
hyuA_predicted,1.4482758620689655,69,28,GTACACCAAGGCTTGTCAAT,41,1846468
hyuA_predicted,0.13793103448275862,31,28,GGTTAGATCAGGTGAGGGTA,3,1847809
hyuA_predicted,1.4482758620689655,69,28,GGGCCTCCTTGGTAGAGAAT,41,1873042
hyuA_predicted,0.5172413793103449,42,28,GGCTACGAATACGTCGATGT,14,1866648
hyuA_predicted,0.3103448275862069,36,28,GGAGGTGAAGAGAGCGCTTA,8,1834861
hyuA_predicted,0.5517241379310345,43,28,GGAGCTACTCATTCAAGACC,15,1838042
hyuA_predicted,0.4827586206896552,41,28,GCGCGCTCATTGATACGCTT,13,1845512
hyuA_predicted,1.2758620689655173,64,28,GCGCATGGTAATATTCAGAA,36,1841431
hyuA_predicted,0.4482758620689655,40,28,GCCGCGACGCTAGTCTAGGT,12,1856489
hyuA_predicted,0.6896551724137931,47,28,GCCCAAAGCTTCGTGTTCCT,19,1866092
hyuA_predicted,0.4827586206896552,41,28,GCAAGGGCGACCCAAATTGA,13,1868366
hyuA_predicted,0.5862068965517241,44,28,GAATTCATGCGGCGTTTGCC,16,1842417
hyuA_predicted,0.41379310344827586,39,28,CTTTTTAATATTATGGGGTG,11,1828973
hyuA_predicted,1.1724137931034482,61,28,CTGGAAGGGATAACAGATCG,33,1849778
hyuA_predicted,0.20689655172413793,33,28,CGTTAGATCCCTTGGGCCAT,5,1875323
hyuA_predicted,1.4482758620689655,69,28,CGTGGACACGCAACTTCTAG,41,1836021
hyuA_predicted,0.7241379310344828,48,28,CGCCGCTAGTCGTTTAGGCG,20,1840665
hyuA_predicted,0.06896551724137931,29,28,CGATAAACGGTGGTTGCCCT,1,1873184
hyuA_predicted,0.10344827586206896,30,28,CGACCGGGAGCAATCATGCT,2,1840264
hyuA_predicted,0.41379310344827586,39,28,CCTGGACGTACGATCAATTT,11,1851799
hyuA_predicted,1.5172413793103448,71,28,CCTCTCATTGTGCACACCCA,43,1833770
hyuA_predicted,0.5517241379310345,43,28,CCATTGTGTAGTCTCCTTTC,15,1833359
hyuA_predicted,0.5172413793103449,42,28,CATGGTGGGCAGATTTCGTT,14,1841213
hyuA_predicted,0.3448275862068966,37,28,CAGTTACACCTTTTAATAAC,9,1860321
hyuA_predicted,0.7241379310344828,48,28,ATTTAGCGCGGCCGTCCATT,20,1834399
hyuA_predicted,0.6896551724137931,47,28,AGTCGTTCCGACGCCAATCA,19,1856327
hyuA_predicted,0.5517241379310345,43,28,AGGGACGATACAGTATCGGA,15,1831333
hyuA_predicted,0.41379310344827586,39,28,AGCTATCAGGATTTTCCAGT,11,1839921
hyuA_predicted,0.3103448275862069,36,28,AGCATATACTTAGTTTATCA,8,1848696
hyuA_predicted,0.20689655172413793,33,28,ACGCCCGGGAAGCTAGCCGA,5,1861053
hyuA_predicted,0.10344827586206896,30,28,ACGCCCGCTGGTCTGGGTTA,2,1834123
hyuA_predicted,0.06896551724137931,29,28,ACATGTCCCTTTCTGCAAAA,1,1836363
hyuA_predicted,0.07142857142857142,28,27,TTGTGGGCCAGTTAAGTGAG,1,1864566
hyuA_predicted,0.07142857142857142,28,27,TTCGATATGACTCGGGAGTA,1,1835253
hyuA_predicted,0.25,33,27,TTAGTACTGATCGCCGTGAC,6,1840298
hyuA_predicted,0.35714285714285715,36,27,TCGGTTCACACAGTCGCGAC,9,1857239
hyuA_predicted,0.35714285714285715,36,27,TCAACCTGCTGATCCAACTT,9,1845679
hyuA_predicted,0.9642857142857143,53,27,TAGAGCTGGTTTACCAGATG,26,1842667
hyuA_predicted,1.1428571428571428,58,27,GTTAAGTAAGACTCATCGAT,31,1838419
hyuA_predicted,0.6785714285714286,45,27,GTGCAGTAAGCTGACCCTTG,18,1856939
hyuA_predicted,1.5,68,27,GTATCCCGCCTTGGACAACT,41,1850597
hyuA_predicted,0.35714285714285715,36,27,GTAATGTGCTGTCGTAGGCT,9,1864158
hyuA_predicted,0.6428571428571429,44,27,GTAAGTTGGGATTAGAGGGA,17,1838043
hyuA_predicted,0.25,33,27,GGTACGGTAGGGTAAAACCG,6,1840777
hyuA_predicted,0.14285714285714285,30,27,GCTCGGCCGATGGATCCCAA,3,1852970
hyuA_predicted,0.9642857142857143,53,27,GAAACGAACTTGCCAACTTA,26,1853789
hyuA_predicted,2.5357142857142856,97,27,CTGTCGGATCGGCAGATTGA,70,1829835
hyuA_predicted,0.8214285714285714,49,27,CTCCGCGGAGTTGTTTCTTT,22,1837247
hyuA_predicted,0.7142857142857143,46,27,CTATTCATCTAGTGTAACGT,19,1837893
hyuA_predicted,0.21428571428571427,32,27,CTAGCTCGAGTCTAGGTATA,5,1864254
hyuA_predicted,0.5714285714285714,42,27,CGTAGGAATAGTACCGCCAT,15,1840493
hyuA_predicted,1.1785714285714286,59,27,CGGGCTTACACCTTGGGGAT,32,1852441
hyuA_predicted,0.5714285714285714,42,27,CGCCACCGAGGATACCGTTA,15,1838378
hyuA_predicted,0.17857142857142858,31,27,CGATTACACATAAGACTTCC,4,1847070
hyuA_predicted,0.07142857142857142,28,27,CCTTCTCCGCAATCACTGCT,1,1875824
hyuA_predicted,0.07142857142857142,28,27,CCTGATCCTGGTTGCTGAGA,1,1842517
hyuA_predicted,1.6071428571428572,71,27,CCTAGATGACTTTCGCGTGT,44,1835169
hyuA_predicted,0.5,40,27,CCCGGTTAACCCGACAAGTC,13,1841648
hyuA_predicted,0.07142857142857142,28,27,CCCGCAGCTTCTACTGAGTG,1,1828906
hyuA_predicted,0.7857142857142857,48,27,CCATAAGCGCTCGGACTACT,21,1844643
hyuA_predicted,0.17857142857142858,31,27,CAGTGTCTCCAGTTATGCGT,4,1842773
hyuA_predicted,0.35714285714285715,36,27,ATTTGAGCGCCGCTCAAGCG,9,1849947
hyuA_predicted,0.07142857142857142,28,27,ATTACGGAGTAGGTAAATCA,1,1876484
hyuA_predicted,0.35714285714285715,36,27,ATGTTCGGAGCCACACTATC,9,1833257
hyuA_predicted,2.4642857142857144,95,27,ATCGTCGCAAGGCCCTCGTA,68,1870394
hyuA_predicted,0.8571428571428571,50,27,ATATCCCCATGAAAGCCGCT,23,1832910
hyuA_predicted,0.8214285714285714,49,27,ATAGGATCCAGCTGGGACAT,22,1850405
hyuA_predicted,0.10714285714285714,29,27,AGGGATGCACGTTACGTGAG,2,1877856
hyuA_predicted,0.5357142857142857,41,27,AGCGTTTTTAGCTAACGCTT,14,1863631
hyuA_predicted,0.75,47,27,ACCCGTAGGTTTGCTCGCTG,20,1838992
hyuA_predicted,0.7142857142857143,46,27,ACCAGACGGAAACTACTTTT,19,1858160
hyuA_predicted,0.07142857142857142,28,27,AATAGTCATCTGTGTTTGAT,1,1840891
hyuA_predicted,0.42857142857142855,38,27,AAGGGCTTGGTGCGTGATTC,11,1848505
hyuA_predicted,0.25,33,27,AACAGGGCATACGCAGGTTT,6,1851990
hyuA_predicted,2.0357142857142856,83,27,AAATGGGGCTGGCGTGTTTA,56,1831541
hyuA_predicted,0.4444444444444444,37,26,TTCCTCCTTCCCACTATTAG,11,1857273
hyuA_predicted,0.07407407407407407,27,26,TTAATTTCGTTTCCGGCTGT,1,1835179
hyuA_predicted,0.3333333333333333,34,26,TGTCGAGGCCGTGACCCTAC,8,1829319
hyuA_predicted,0.07407407407407407,27,26,TGGTACACCCATTCCAAACA,1,1836639
hyuA_predicted,0.48148148148148145,38,26,TGGGGACCCCCTTACAGTAC,12,1835170
hyuA_predicted,0.25925925925925924,32,26,TGGATAGTGCTCCAAGTCAT,6,1863206
hyuA_predicted,0.07407407407407407,27,26,TGATTTGTCGCCTCACTCAG,1,1843150
hyuA_predicted,0.07407407407407407,27,26,TCCGACGGTACATTTTCTTA,1,1871598
hyuA_predicted,0.6666666666666666,43,26,TACGGCCTGCTTAAGAATAT,17,1868014
hyuA_predicted,0.8148148148148148,47,26,TAATCGTAGCTTACTGTATA,21,1836396
hyuA_predicted,1.037037037037037,53,26,GTTGATTCCCTCATTGTCCC,27,1841916
hyuA_predicted,0.5555555555555556,40,26,GTGTTTTTCCGGTAAATGGA,14,1861857
hyuA_predicted,0.8518518518518519,48,26,GGTTCATTACCACGGAAATG,22,1856606
hyuA_predicted,4.185185185185185,138,26,GGCCTCACCATCTTACGTCT,112,1856240
hyuA_predicted,0.9259259259259259,50,26,GGATCCCTTGATCGCAGATA,24,1835520
hyuA_predicted,0.37037037037037035,35,26,GGAGGATGGAGCCCACTGAG,9,1829881
hyuA_predicted,0.4444444444444444,37,26,GCGGTTAGATCTGCGGTCTA,11,1831217
hyuA_predicted,1.2592592592592593,59,26,GCACAGCAACAGTCTGCGAT,33,1844238
hyuA_predicted,0.3333333333333333,34,26,GATTCCGGATGGACTCATTA,8,1834162
hyuA_predicted,1.4074074074074074,63,26,GAGCGGTTGTATCTCCGGGC,37,1850406
hyuA_predicted,2.7777777777777777,100,26,GAATAATGCTTTCAGAACCT,74,1845929
hyuA_predicted,0.2962962962962963,33,26,GAACTGATAAGGACTGGTGT,7,1874741
hyuA_predicted,0.6296296296296297,42,26,CTTCTCGGTGGTACGATAAC,16,1862029
hyuA_predicted,0.8148148148148148,47,26,CTCCGGAGTCAATCTGCGTT,21,1835743
hyuA_predicted,2.8518518518518516,102,26,CTCCCATGCCCTAACAATTG,76,1852609
hyuA_predicted,0.7037037037037037,44,26,CGTACCAGGCGGATGCGAGT,18,1828905
hyuA_predicted,0.6666666666666666,43,26,CGGCCTGGCCCTCTACGGAA,17,1868554
hyuA_predicted,1.1851851851851851,57,26,CGAGTCTACGGTTAAGGCGT,31,1842016
hyuA_predicted,0.2222222222222222,31,26,CCTTTCTTCGACCGTTGGCA,5,1862226
hyuA_predicted,0.9629629629629629,51,26,CCTTCTCATCGCAGGTCTAT,25,1841178
hyuA_predicted,0.3333333333333333,34,26,CCTAGGTCCAGGATGTACAA,8,1864023
hyuA_predicted,0.5555555555555556,40,26,CCCGAACGTAAACGCAAGAA,14,1841211
hyuA_predicted,0.07407407407407407,27,26,CCACTGCATTTAGCGGCGTG,1,1831335
hyuA_predicted,0.2222222222222222,31,26,CCACCTGTGGATTTGATGGA,5,1861919
hyuA_predicted,1.1111111111111112,55,26,CATGACCAAGTGTCTTAGCC,29,1837545
hyuA_predicted,0.6666666666666666,43,26,CACGTCCGCTTGAGTACCAG,17,1835904
hyuA_predicted,0.1111111111111111,28,26,CACGGTCATTGTCATATCGT,2,1829360
hyuA_predicted,0.1111111111111111,28,26,CAACGGTAACGCAGACCGTT,2,1863406
hyuA_predicted,0.8518518518518519,48,26,ATGGTCTGCATGGGTCACAC,22,1834382
hyuA_predicted,0.8148148148148148,47,26,ATCCATTGAACAGCGGTTGT,21,1846907
hyuA_predicted,1.0,52,26,ATCATGTTCGCAAATGCGTA,26,1867179
hyuA_predicted,1.6296296296296295,69,26,AGTCTTCGATCGCAAGTTGA,43,1856393
hyuA_predicted,0.6666666666666666,43,26,AGGTAGGAGCTTACCGTAAT,17,1836681
hyuA_predicted,0.6296296296296297,42,26,AGGGGGAATACGCGACCCGG,16,1846802
hyuA_predicted,1.037037037037037,53,26,AGAGGGGCGGTCCTAGCCCA,27,1832841
hyuA_predicted,0.5925925925925926,41,26,ACCTACCGGGCTGGGGGCGG,15,1869910
hyuA_predicted,0.5925925925925926,41,26,ACATCTCTAACATCTTAGGT,15,1866754
hyuA_predicted,0.7777777777777778,46,26,AATTCCCCCATCTTGATGAC,20,1830547
hyuA_predicted,1.037037037037037,53,26,AACTGCAATATCGGAAGTAC,27,1846529
hyuA_predicted,0.5384615384615384,38,25,TTCAACTAAATATATATCTA,13,1839114
hyuA_predicted,0.07692307692307693,26,25,TGTCTCTCACATTCCGTTTA,1,1850763
hyuA_predicted,0.6923076923076923,42,25,TGTCAGTGTATACCTCTCGA,17,1834120
hyuA_predicted,2.1923076923076925,81,25,TGGATAGCATGTCAGTTGGA,56,1830572
hyuA_predicted,0.5384615384615384,38,25,TGCTTTTTTTCGATAAGGTC,13,1858133
hyuA_predicted,0.46153846153846156,36,25,TGATACGCGAGGCCTCTCCC,11,1845882
hyuA_predicted,1.4615384615384615,62,25,TCGGCACTTAGAAAAAAGCA,37,1835336
hyuA_predicted,0.34615384615384615,33,25,TCGCAGAGTAGGTCGTACTG,8,1842599
hyuA_predicted,0.46153846153846156,36,25,TCGCACCCAAAGTATGGAAT,11,1874991
hyuA_predicted,0.7307692307692307,43,25,TCCTCCGCACATAACTCGTT,18,1876783
hyuA_predicted,0.34615384615384615,33,25,TCCAGTCGCCCAGCGCCGAT,8,1877857
hyuA_predicted,0.4230769230769231,35,25,TCATATTACCCCAGGGATAT,10,1860976
hyuA_predicted,1.6538461538461537,67,25,TCAGCGGGGATTAGGTCATC,42,1846336
hyuA_predicted,0.07692307692307693,26,25,TAATTGGCAATGGTGGACTA,1,1841472
hyuA_predicted,0.5384615384615384,38,25,TAATCCGCAAGGGTCAACAA,13,1853770
hyuA_predicted,0.3076923076923077,32,25,TAACGTTTGACATGTATATG,7,1833146
hyuA_predicted,0.5769230769230769,39,25,TAACACGCTGACAGAAACGA,14,1869767
hyuA_predicted,0.07692307692307693,26,25,GTTAACCCGTGCATCCGAGG,1,1829060
hyuA_predicted,0.38461538461538464,34,25,GTCACGTTAGGGGGGTAAAG,9,1841771
hyuA_predicted,1.1538461538461537,54,25,GGTATACCTGAAACCTCTGC,29,1854155
hyuA_predicted,1.3846153846153846,60,25,GGGAATGTTCGTAACGGTTT,35,1835689
hyuA_predicted,0.07692307692307693,26,25,GCTTTTCGTTAGATAATGTG,1,1867474
hyuA_predicted,0.2692307692307692,31,25,GCTGTCGGTCTCGCGTTTAT,6,1850296
hyuA_predicted,0.07692307692307693,26,25,GCGAGGGACTGTATAGCGTC,1,1845451
hyuA_predicted,0.19230769230769232,29,25,GCATGAAATAGGAGAATGTC,4,1848114
hyuA_predicted,0.19230769230769232,29,25,GAGGACATATACCCAGGAAC,4,1869339
hyuA_predicted,2.769230769230769,96,25,GACTAACAAGCTTAGCGTCG,71,1839564
hyuA_predicted,0.34615384615384615,33,25,GAAAACAGTGGGAGTCTCTA,8,1835679
hyuA_predicted,0.5,37,25,CTTCGTCCGACCATAGTAAC,12,1855549
hyuA_predicted,0.23076923076923078,30,25,CTCTGAGTCGAGGCTCAAGA,5,1857752
hyuA_predicted,0.7692307692307693,44,25,CTCACGGACAGGTGCTCGAA,19,1866756
hyuA_predicted,1.4615384615384615,62,25,CGTGCTGCCATGGCTTTATA,37,1860405
hyuA_predicted,0.2692307692307692,31,25,CGTAAAGTTATCGATGTTCC,6,1836769
hyuA_predicted,0.38461538461538464,34,25,CGCTCAGAAAACGTCCACGG,9,1856089
hyuA_predicted,0.8076923076923077,45,25,CGAACACGGGGAATAAAACC,20,1834316
hyuA_predicted,0.5769230769230769,39,25,CCCGCCGGGGTGTCTTGGTT,14,1837754
hyuA_predicted,0.23076923076923078,30,25,CCCACCCTGATGCGAGACGT,5,1870037
hyuA_predicted,0.3076923076923077,32,25,CCACTCGCCCAGCAGTTTTG,7,1861723
hyuA_predicted,0.6538461538461539,41,25,CACGTGTCTATGCGGAGCTT,16,1836462
hyuA_predicted,0.9230769230769231,48,25,ATCTAGGCAGCATATGCGAT,23,1851031
hyuA_predicted,0.9230769230769231,48,25,ATCCAAAATTAGGGATGACG,23,1847124
hyuA_predicted,0.5769230769230769,39,25,ATATTCGACAAGAGTCCGTC,14,1861563
hyuA_predicted,0.4230769230769231,35,25,AGTTGTAGGGGACGGGGTCA,10,1860031
hyuA_predicted,0.11538461538461539,27,25,AGTGTTCTTCTAGAAGAGAG,2,1841139
hyuA_predicted,0.2692307692307692,31,25,AGTGATTTGTGAGCAGCTAC,6,1864395
hyuA_predicted,0.5384615384615384,38,25,AGTAAGAGTGCGGGGTCGAT,13,1851621
hyuA_predicted,0.07692307692307693,26,25,AGGTGGCCTTCATCCGAATC,1,1840922
hyuA_predicted,0.6538461538461539,41,25,AGGAAGGCAGTTGCCCGAGA,16,1865003
hyuA_predicted,0.8846153846153846,47,25,ACTGTAGAGGGTCGCTATCT,22,1852998
hyuA_predicted,0.7307692307692307,43,25,ACGAGGTAGAATACGAGTTA,18,1854480
hyuA_predicted,1.2692307692307692,57,25,ACCGTAGTGCAATCCTGGGG,32,1837499
hyuA_predicted,1.0384615384615385,51,25,ACCATGAGTTCTTCAAAACA,26,1854777
hyuA_predicted,0.46153846153846156,36,25,ACACTTGCTACTGATTTAAT,11,1849482
hyuA_predicted,3.8846153846153846,125,25,AATTGCCCGGAGAACATACG,100,1831951
hyuA_predicted,0.6538461538461539,41,25,AACGCTATGGGGATGCACAA,16,1830644
hyuA_predicted,1.8076923076923077,71,25,AACATGTGTGTTCGAACCCA,46,1841210
hyuA_predicted,2.28,80,24,TTTTCCAGGTGAGCCATTAG,56,1849074
hyuA_predicted,0.08,25,24,TTCCGAGGGCTAGAAACATA,1,1847117
hyuA_predicted,1.96,72,24,TTCCACTACTGCAAGGTACT,48,1864763
hyuA_predicted,0.96,47,24,TGCTCAGGGCGACTGCGGAA,23,1854308
hyuA_predicted,0.24,29,24,TGCGGATTGCAGTTACCATC,5,1832406
hyuA_predicted,0.6,38,24,TGACGTGCTACCGATACCAA,14,1868860
hyuA_predicted,1.28,55,24,TCAGAAAGTTTTATAGAAAC,31,1873272
hyuA_predicted,0.36,32,24,TCACCTGGGTTCTGCATTTT,8,1835938
hyuA_predicted,0.36,32,24,TAGACCTAGCTTCATGGAGC,8,1850544
hyuA_predicted,0.64,39,24,TAAGGTATGATAGTAAGCTT,15,1867982
hyuA_predicted,1.48,60,24,GTTGCCACTCTGTCGTTCAA,36,1872268
hyuA_predicted,0.64,39,24,GTGATCTACCATCAACTCGC,15,1859754
hyuA_predicted,0.6,38,24,GTCACATTATGGGACGGCGC,14,1836384
hyuA_predicted,0.2,28,24,GGAGATAGAGTTGCACGGTT,4,1845538
hyuA_predicted,0.08,25,24,GCTTGTAGGTCGTCCTTAAC,1,1843079
hyuA_predicted,1.08,50,24,GCTTGGTTTAGTATGGGGCA,26,1859669
hyuA_predicted,0.24,29,24,GCTCATACTCCGGTGTTGAT,5,1832908
hyuA_predicted,0.64,39,24,GCTCAGACCCCTGGGATTTA,15,1843623
hyuA_predicted,0.08,25,24,GCCTGTGGTTGTGTCGTTGC,1,1873602
hyuA_predicted,2.56,87,24,GCAGCGGTCGGGTTCGGTAA,63,1870801
hyuA_predicted,3.08,100,24,GATCTCGATGTATCTGCGGT,76,1844285
hyuA_predicted,0.56,37,24,CTAGTCGGGGTCGTTAGGAG,13,1863927
hyuA_predicted,0.52,36,24,CGTTATAGGCGCCAAGTTCA,12,1831654
hyuA_predicted,0.16,27,24,CGGTCGAATCGCATCTTGGA,3,1844977
hyuA_predicted,0.72,41,24,CGCGGCGGTACCGCCTCTAG,17,1829640
hyuA_predicted,0.68,40,24,CGCCCCTACTCGGAAACGCG,16,1853593
hyuA_predicted,0.16,27,24,CCGATGCGATGAACTGTTGG,3,1831830
hyuA_predicted,0.44,34,24,CCCCTGACAAGGAGGAACGT,10,1870856
hyuA_predicted,2.56,87,24,CCAGGCTTGCAATGGGCCAT,63,1848952
hyuA_predicted,0.16,27,24,CCACGGGTGGCCGAAATGGT,3,1863243
hyuA_predicted,0.28,30,24,ATTTCGCGGAACTCATTATG,6,1862438
hyuA_predicted,2.2,78,24,ATTGCGTTTGTAGCCCCCTT,54,1830240
hyuA_predicted,0.2,28,24,ATTGCAACGGATTCCGGCCC,4,1841615
hyuA_predicted,0.2,28,24,ATCGATAACGAAGGGCCGGC,4,1862262
hyuA_predicted,0.08,25,24,ATAGCGGGGCGAAATCATGT,1,1845017
hyuA_predicted,0.08,25,24,AGGGTAGTCACGAATTTCAA,1,1862947
hyuA_predicted,0.6,38,24,AGCCGTTTGGTGCACAGAGT,14,1832653
hyuA_predicted,0.88,45,24,AGCCCCGATCCAAGCAGTTA,21,1837960
hyuA_predicted,0.16,27,24,AGCCCCCTATTGGGGTGCGG,3,1829840
hyuA_predicted,0.84,44,24,ACGGTAGGTTTTTGTCTTAT,20,1847476
hyuA_predicted,0.08,25,24,ACGGGGGATCGATCACAATT,1,1859466
hyuA_predicted,0.28,30,24,ACGGCGGTACGTTGGTGCCT,6,1834529
hyuA_predicted,0.36,32,24,ACGCCGTTCAATATGTTGTT,8,1855354
hyuA_predicted,0.2,28,24,ACGCCAAGTTACCCTACACT,4,1861670
hyuA_predicted,0.24,29,24,AATTGAAGATGGTGTATACT,5,1835600
hyuA_predicted,0.4,33,24,AATACCGATAACGGCCCGAC,9,1839451
hyuA_predicted,0.56,37,24,AACGATGATTTGCTGGATAC,13,1876344
hyuA_predicted,0.48,35,24,AACGAAGTATTCGCCAATCA,11,1848117
hyuA_predicted,0.68,40,24,AACCCGCCTGACACCAGTTA,16,1846040
hyuA_predicted,0.32,31,24,AAATAAATTCCCGATCGAAA,7,1862655
hyuA_predicted,0.6666666666666666,38,23,TTGGCCCCAGATTTTCCTAA,15,1849620
hyuA_predicted,0.4583333333333333,33,23,TGGTGTCTTATAGAATTCAC,10,1871656
hyuA_predicted,0.875,43,23,TGGTGACAGCCCGAATAAAA,20,1870779
hyuA_predicted,2.3333333333333335,78,23,TGACCCTGTATCAAGAATGT,55,1847773
hyuA_predicted,0.6666666666666666,38,23,TCTGAACCCGAACTCGCGCT,15,1864869
hyuA_predicted,3.0416666666666665,95,23,TCGACTCGTCACTATTCTCA,72,1851421
hyuA_predicted,0.375,31,23,TAACGCGCATGGCATGCTAT,8,1869752
hyuA_predicted,3.4166666666666665,104,23,GTTCCGTGTATCCTCCTCTG,81,1850669
hyuA_predicted,1.375,55,23,GTGTGATACGTATCCATGCT,32,1863443
hyuA_predicted,0.2916666666666667,29,23,GTGGCTTTATGGGTGTGCGA,6,1874879
hyuA_predicted,0.4583333333333333,33,23,GTGGCTGAATCTTGACGCAA,10,1859650
hyuA_predicted,0.7083333333333334,39,23,GTGGAGGGGTTACCAAACGT,16,1857312
hyuA_predicted,0.6666666666666666,38,23,GTGCCTCCAGACTTCCAAGG,15,1838397
hyuA_predicted,2.0833333333333335,72,23,GTCCGTCTATTTAGCCCGGG,49,1830967
hyuA_predicted,0.9166666666666666,44,23,GTCCGGCGTTTAGATGTAGT,21,1829581
hyuA_predicted,0.125,25,23,GTATTACGGTTGAGGCTTGA,2,1836646
hyuA_predicted,1.2083333333333333,51,23,GTAGCTCGGCTCCAACCAAA,28,1860567
hyuA_predicted,0.3333333333333333,30,23,GTAGCGAACACTTTGCCCTT,7,1862876
hyuA_predicted,0.5,34,23,GGTAATACTCACACCACGCG,11,1844462
hyuA_predicted,0.6666666666666666,38,23,GGGCACATATTCAGTGGGTC,15,1849800
hyuA_predicted,0.7083333333333334,39,23,GGCCTTACCGAGTCTATATA,16,1849301
hyuA_predicted,0.7916666666666666,41,23,GGAATCGGTCATCTTTTTGG,18,1842246
hyuA_predicted,0.125,25,23,GCTTAAATATTGCGCTTCTC,2,1837090
hyuA_predicted,1.5,58,23,GCTCGGGGCATTTTACAGGA,35,1857567
hyuA_predicted,0.8333333333333334,42,23,GCTAAGAAATTTTGTTCTTT,19,1866401
hyuA_predicted,0.6666666666666666,38,23,GCGGACTCCGTCTTATTCGC,15,1839486
hyuA_predicted,0.08333333333333333,24,23,GCCTCATAACGCAGCAGTAT,1,1838294
hyuA_predicted,0.3333333333333333,30,23,GCCCATCGGTGGAATGGGCT,7,1844465
hyuA_predicted,0.4583333333333333,33,23,GCCATCTGTAGTCACATTCT,10,1865822
hyuA_predicted,0.125,25,23,GCACGACGCTAAATCATTAG,2,1855555
hyuA_predicted,0.25,28,23,GATTGCTCCGGTGACTGGTT,5,1839158
hyuA_predicted,2.125,73,23,GAGGACGAGTGGTAGTATTA,50,1852971
hyuA_predicted,0.125,25,23,GAGCAACCATCTATGCGAGT,2,1833669
hyuA_predicted,0.5416666666666666,35,23,CTGTGTGGCTGATCCCGCTC,12,1828847
hyuA_predicted,0.08333333333333333,24,23,CTGCCGGACTACTATATAGG,1,1868557
hyuA_predicted,0.7083333333333334,39,23,CTCGTGTTTGTCAAGTGCTT,16,1860426
hyuA_predicted,0.16666666666666666,26,23,CTATTTGCCTGCAGTGAAGG,3,1829185
hyuA_predicted,0.8333333333333334,42,23,CGGTCGAGGATAATCCTACT,19,1876544
hyuA_predicted,0.5833333333333334,36,23,CGGCTTCTGTTGTATCGAGT,13,1848985
hyuA_predicted,1.5416666666666667,59,23,CGAATGGAGCCTAACCGCAA,36,1870777
hyuA_predicted,1.0,46,23,CCCTTACGGGCGTCTGTTAC,23,1842477
hyuA_predicted,1.5416666666666667,59,23,CCCGGTCAGCGCCCGTTGAG,36,1876674
hyuA_predicted,0.2916666666666667,29,23,CATATCATGCCAAGCTACTG,6,1857271
hyuA_predicted,0.6666666666666666,38,23,CAGGTAGCTGCGTCTTCGGT,15,1875787
hyuA_predicted,0.4166666666666667,32,23,CACGCGCGTGAGAAGTCCTC,9,1841422
hyuA_predicted,0.75,40,23,CACACAGTTCCGATCCACAG,17,1854488
hyuA_predicted,1.0,46,23,CAAGGGGTTGGTAATGGTGT,23,1855913
hyuA_predicted,1.1666666666666667,50,23,CAAGCTTGTGAGCTCGCGAA,27,1851084
hyuA_predicted,2.25,76,23,CAAGAGTGCAGATATTTCAT,53,1848557
hyuA_predicted,1.125,49,23,ATGATAGTGGTGCTTGTCGC,26,1859354
hyuA_predicted,0.2916666666666667,29,23,AGTTCGTACAAAGGCAAGAG,6,1838870
hyuA_predicted,0.08333333333333333,24,23,AGGCACAGTGGCCCAATCCT,1,1835301
hyuA_predicted,0.16666666666666666,26,23,AGATTTGTCAGGACGCACGT,3,1873190
hyuA_predicted,0.08333333333333333,24,23,AGAACCTGTTATCCCCTGTG,1,1832200
hyuA_predicted,0.43478260869565216,31,22,TTCGATGCACACGGCAGCCG,9,1837234
hyuA_predicted,0.7391304347826086,38,22,TTAACTCAGGATCGTTGCGC,16,1829363
hyuA_predicted,0.34782608695652173,29,22,TGTTCCCAGAAGAGGATGCT,7,1864828
hyuA_predicted,0.7391304347826086,38,22,TGTCCATGCCAGTCCCCAGG,16,1873724
hyuA_predicted,0.5217391304347826,33,22,TCGGAGAGTTTCTCGTAGTC,11,1844847
hyuA_predicted,0.2608695652173913,27,22,TCGAATGCGATGATATCCAG,5,1854129
hyuA_predicted,0.13043478260869565,24,22,TCCCCACCGGATCACCGTAC,2,1873941
hyuA_predicted,0.21739130434782608,26,22,TCCACCGAACCAGTGCGGGT,4,1828976
hyuA_predicted,2.0869565217391304,69,22,TCACGTCTCCTGTGGATCAT,47,1831730
hyuA_predicted,0.8695652173913043,41,22,TCAACATAACCGGTTACCAT,19,1870577
hyuA_predicted,0.9130434782608695,42,22,TATGGGAGCGGCTACTGCCC,20,1857014
hyuA_predicted,0.13043478260869565,24,22,TATAAACCGGCTCATGCTTG,2,1862084
hyuA_predicted,0.2608695652173913,27,22,TACCGGTGCCGGTGGTGTAA,5,1833443
hyuA_predicted,0.782608695652174,39,22,TACCATATGATTATTCGTTT,17,1854020
hyuA_predicted,0.30434782608695654,28,22,TAAGTTCTCAAACGAAGGAG,6,1852706
hyuA_predicted,0.6086956521739131,35,22,TAAGTATAATGAGGTCATGT,13,1843817
hyuA_predicted,0.08695652173913043,23,22,TAAGCTAGACGTACGCACCA,1,1877315
hyuA_predicted,0.43478260869565216,31,22,TAACTCTTACTCTCGCTTCA,9,1876370
hyuA_predicted,0.08695652173913043,23,22,GTTAGGCTCTTGTTTATAGT,1,1837546
hyuA_predicted,0.2608695652173913,27,22,GTGGACTTATCACGGGACTG,5,1845409
hyuA_predicted,0.08695652173913043,23,22,GGTTTCAACTAGCGAGGCCA,1,1835438
hyuA_predicted,2.347826086956522,75,22,GGTGCACAGTGAGCACTTAG,53,1858257
hyuA_predicted,0.782608695652174,39,22,GGTCCGCAGCTCGGGTTTGT,17,1837664
hyuA_predicted,0.08695652173913043,23,22,GGTAAAAGGGGCGAGTGTTG,1,1829949
hyuA_predicted,0.21739130434782608,26,22,GGGTGTCGCTGGTTTGCTCA,4,1835302
hyuA_predicted,0.4782608695652174,32,22,GGCTGCAACTGTTGGTTGAG,10,1860907
hyuA_predicted,0.08695652173913043,23,22,GGCGGACTCAGATGGAGCAA,1,1853602
hyuA_predicted,0.13043478260869565,24,22,GGCGCCTAAGACAGACTTGT,2,1853652
hyuA_predicted,0.34782608695652173,29,22,GCTACGGTAACCGGGGGATA,7,1855245
hyuA_predicted,0.34782608695652173,29,22,GCGCTAACCAACGAGTAGAG,7,1848188
hyuA_predicted,0.08695652173913043,23,22,GCCGACTTTTAACCTGTGAT,1,1861569
hyuA_predicted,0.17391304347826086,25,22,GCACCATATTGTATAGGAGA,3,1871228
hyuA_predicted,2.260869565217391,73,22,GCAAGGCTGTAACTGAGCGT,51,1871143
hyuA_predicted,0.43478260869565216,31,22,GAGTCGTCCATGTCCGTCTT,9,1834091
hyuA_predicted,0.5217391304347826,33,22,GAGCTGTTAACGTTGGTACC,11,1847331
hyuA_predicted,1.2608695652173914,50,22,GAAGTGCTATACGGCTTTTT,28,1840210
hyuA_predicted,0.17391304347826086,25,22,GAAATTTTAATGGACACATG,3,1835211
hyuA_predicted,0.5652173913043478,34,22,CTATAAAGAGCTACGCAACT,12,1844185
hyuA_predicted,0.21739130434782608,26,22,CGGGGAGGGCGGGGACAGTT,4,1833092
hyuA_predicted,1.9130434782608696,65,22,CCGAAGGTCCCCAAGGTACG,43,1854230
hyuA_predicted,0.6956521739130435,37,22,CATTAAAATTTAGCCGTACT,15,1829193
hyuA_predicted,0.13043478260869565,24,22,CAGCGTCGGGAAGCTTCGAT,2,1845021
hyuA_predicted,0.2608695652173913,27,22,CACCATGAGACCAAGCACAA,5,1857115
hyuA_predicted,0.21739130434782608,26,22,CAAAGGTCCAAAGCCGGCCA,4,1830778
hyuA_predicted,0.17391304347826086,25,22,ATTTTGCACTGCTAAGGGAG,3,1866970
hyuA_predicted,1.391304347826087,53,22,ATGAAGGACACAGGCGCCCT,31,1841704
hyuA_predicted,0.43478260869565216,31,22,ATCCCGCCTGCTCATACTAT,9,1834183
hyuA_predicted,1.5217391304347827,56,22,AGCTTGTACTGCGCAAGCTC,34,1843324
hyuA_predicted,0.08695652173913043,23,22,ACGAGGCAGCCTCAGAAGAA,1,1845654
hyuA_predicted,1.173913043478261,48,22,AATCTAGTTGTCTGTGCCCC,26,1876023
hyuA_predicted,0.21739130434782608,26,22,AATCGACAGGCTGGGCCATG,4,1861600
hyuA_predicted,0.34782608695652173,29,22,AAGCATTAGAGAGTGGAAAA,7,1832500
hyuA_predicted,1.6363636363636365,56,21,TTGGCAGTCAGACGTGAGAG,35,1846603
hyuA_predicted,0.45454545454545453,30,21,TTCACTGGGGACGAACCTCG,9,1871565
hyuA_predicted,0.13636363636363635,23,21,TGATCTGGGTCCCAAGCCCG,2,1857448
hyuA_predicted,0.6818181818181818,35,21,TCGACTCAATCGTCCCAAGC,14,1864437
hyuA_predicted,0.8181818181818182,38,21,TCCCCTTTCCAAAACAGGGT,17,1836397
hyuA_predicted,0.22727272727272727,25,21,TCACGGACGGGTATGTCACT,4,1839389
hyuA_predicted,0.5,31,21,TATCGCGAGCATTATGGCTA,10,1868481
hyuA_predicted,0.18181818181818182,24,21,TACGCCTACGGAGTGCTATG,3,1870717
hyuA_predicted,3.227272727272727,91,21,GTCCTCTCACCAACGGTTAT,70,1852670
hyuA_predicted,0.22727272727272727,25,21,GTAGGGTAATTTTGATGAAT,4,1836308
hyuA_predicted,0.7272727272727273,36,21,GGGTACAATTCACCGCGGGG,15,1871500
hyuA_predicted,0.09090909090909091,22,21,GGGCGTACGCGAAAATCATC,1,1857303
hyuA_predicted,0.45454545454545453,30,21,GCTGGTCGATCCAAGAGGAC,9,1849554
hyuA_predicted,0.2727272727272727,26,21,GAACACGAGTCCAAGGGGAT,5,1829796
hyuA_predicted,0.8636363636363636,39,21,CTTTCCTGACCCACAGTAGA,18,1863354
hyuA_predicted,0.9090909090909091,40,21,CTTAAAACGCCCGGAAGGGC,19,1829579
hyuA_predicted,0.6818181818181818,35,21,CTGTCACGCCTCCCGGTGAG,14,1834087
hyuA_predicted,0.6363636363636364,34,21,CTGGTAAAGTACTTCTGCGT,13,1869968
hyuA_predicted,0.6818181818181818,35,21,CTGGGGGCCGCCAGAATTCT,14,1874384
hyuA_predicted,0.6818181818181818,35,21,CTGACTTCGAGAGAGAATGA,14,1870129
hyuA_predicted,0.5,31,21,CTCGGCGATAGAATTGTAAG,10,1843593
hyuA_predicted,1.5454545454545454,54,21,CTAGCCCATGCAGTTCACGC,33,1845094
hyuA_predicted,0.8636363636363636,39,21,CGTGATTTAAAGAGCTGCTA,18,1833677
hyuA_predicted,0.2727272727272727,26,21,CGTACACAGAATGAATCACG,5,1856124
hyuA_predicted,0.22727272727272727,25,21,CGGTGTCCAGACACAGACAG,4,1831128
hyuA_predicted,0.8181818181818182,38,21,CGGTCAGGACTATGAGTGAA,17,1868786
hyuA_predicted,0.8636363636363636,39,21,CGGCCTTCTTTGATGTTCAC,18,1850576
hyuA_predicted,0.8636363636363636,39,21,CGGATTTAGTGTGATACCTG,18,1842162
hyuA_predicted,1.0909090909090908,44,21,CGCTCGCATAGGCGTAACGA,23,1856740
hyuA_predicted,0.5,31,21,CGCCCGAGCATTCTCCGGTT,10,1831010
hyuA_predicted,0.8636363636363636,39,21,CGCATATTCACTGAGGTGCC,18,1870119
hyuA_predicted,0.5,31,21,CGCATATAGAATACTCCCGG,10,1830773
hyuA_predicted,0.45454545454545453,30,21,CGACTGTTTTGAGTGTCCGC,9,1863653
hyuA_predicted,0.09090909090909091,22,21,CGACAGCTTGTAATCCCGGT,1,1847827
hyuA_predicted,1.5909090909090908,55,21,CGAACACAGGGCAATTCCAG,34,1833357
hyuA_predicted,1.2727272727272727,48,21,CCGGACCGCGGATACCGTTT,27,1831412
hyuA_predicted,0.9090909090909091,40,21,CCGCAAAGCCTCATCGTCTA,19,1831039
hyuA_predicted,0.45454545454545453,30,21,CCAGCTTATGGCCGACGGGT,9,1846473
hyuA_predicted,2.409090909090909,73,21,CATCTCACTTGACTCCTATA,52,1874790
hyuA_predicted,0.09090909090909091,22,21,CAGGTATTTTTGCTAAAAGG,1,1850949
hyuA_predicted,3.772727272727273,103,21,CACTGAGGCAAGCAGGGTAC,82,1830906
hyuA_predicted,0.7272727272727273,36,21,CACGGTACCGAATGATCGAA,15,1877056
hyuA_predicted,0.7727272727272727,37,21,CACCTTTAGTGGAAGATATT,16,1871686
hyuA_predicted,1.0909090909090908,44,21,CAACCCTCCACTCTAATATC,23,1843935
hyuA_predicted,0.13636363636363635,23,21,CAACAACGCAACCCTTGGTA,2,1853370
hyuA_predicted,0.6363636363636364,34,21,ATTCGCCGTGATACAAACAT,13,1856673
hyuA_predicted,0.09090909090909091,22,21,ATCCAGCCGTTGCCCTGCGT,1,1855782
hyuA_predicted,0.45454545454545453,30,21,ATCAACATCGGGCTAATAAT,9,1865616
hyuA_predicted,0.2727272727272727,26,21,AGTCGCAGTGGTCTGAACGC,5,1877451
hyuA_predicted,0.4090909090909091,29,21,AGGTATGGCTATATGTTTAT,8,1845019
hyuA_predicted,0.2727272727272727,26,21,AGGAAGCGGACACAGCAGGA,5,1855966
hyuA_predicted,0.13636363636363635,23,21,AGCTAAATCAATCCATTCCA,2,1870373
hyuA_predicted,1.0,42,21,AGCCTAGCCATGAGGGGCAG,21,1875772
hyuA_predicted,0.5,31,21,AGATGAATTAAGGGATAGAT,10,1877858
hyuA_predicted,0.13636363636363635,23,21,ACTGTTTTCACACCCACGTC,2,1872856
hyuA_predicted,0.09090909090909091,22,21,ACGTGATACACAGGGACAAT,1,1861375
hyuA_predicted,0.09090909090909091,22,21,ACAGCCAAATCCATCGCGAA,1,1855557
hyuA_predicted,0.13636363636363635,23,21,AAGTTTTCCCGGGACGGGGT,2,1862890
hyuA_predicted,1.1363636363636365,45,21,AACCCAAATGTGAACTCGGG,24,1849402
hyuA_predicted,0.5714285714285714,31,20,TTTGCGGCCCACCCGGGTCA,11,1841882
hyuA_predicted,1.4761904761904763,50,20,TTCTACCAAATCTATGGTCT,30,1861679
hyuA_predicted,0.7142857142857143,34,20,TGTGGCTTGCAGTCATATTT,14,1874602
hyuA_predicted,0.2857142857142857,25,20,TGGGGCGTATTCGGATGAAA,5,1840172
hyuA_predicted,0.8571428571428571,37,20,TGCGAGTTTCGGTTTTGATA,17,1852607
hyuA_predicted,0.2857142857142857,25,20,TCTAGAATCAGTAAGCGGCA,5,1837595
hyuA_predicted,0.7619047619047619,35,20,TCCGGGTCTATATTGCTGCA,15,1872425
hyuA_predicted,2.9523809523809526,81,20,TCCATTCGCTTTGGTGAGTC,61,1829400
hyuA_predicted,0.14285714285714285,22,20,TATGAGGTTACCCTACCTTC,2,1854224
hyuA_predicted,0.8095238095238095,36,20,TATCCAGCAGACTTCAAAAT,16,1856986
hyuA_predicted,0.3333333333333333,26,20,TAGAGAGAGGTAGTCGTTAA,6,1861721
hyuA_predicted,2.857142857142857,79,20,GTTCGCTGAATCCATGCTAA,59,1832748
hyuA_predicted,2.3333333333333335,68,20,GTCGGTGCGTACGCTGCGTT,48,1844906
hyuA_predicted,0.3333333333333333,26,20,GTCATTAGCGGAATTCATGT,6,1857755
hyuA_predicted,0.3333333333333333,26,20,GGTCTACTCGAGCACCCTTA,6,1852051
hyuA_predicted,1.2380952380952381,45,20,GGCGTCAATGGCCGTGCCAT,25,1844343
hyuA_predicted,0.09523809523809523,21,20,GCTCGTGGCTCTATCAATTT,1,1841186
hyuA_predicted,1.4285714285714286,49,20,GCTAGGGGTTGTGATGAAGT,29,1839045
hyuA_predicted,0.09523809523809523,21,20,GCCTATCTTGGATTGTAAAT,1,1875553
hyuA_predicted,0.19047619047619047,23,20,GCACCGGATGATCACGTGGT,3,1833096
hyuA_predicted,0.9523809523809523,39,20,GAGTAGACATACATCCTCGC,19,1835644
hyuA_predicted,0.14285714285714285,22,20,GAGCTGACAAGCATCACTGT,2,1850595
hyuA_predicted,0.47619047619047616,29,20,GACTGATGGTCGCTGTGTCC,9,1864902
hyuA_predicted,0.3333333333333333,26,20,GACGCCTAGCATCCCCACGA,6,1830489
hyuA_predicted,1.4761904761904763,50,20,GACATGTCCCATAGGACAAC,30,1851282
hyuA_predicted,0.47619047619047616,29,20,GACAAAATTTGACGTGTTTG,9,1877250
hyuA_predicted,0.8571428571428571,37,20,GAATAAGCTGTTCAGGAGCT,17,1845653
hyuA_predicted,0.09523809523809523,21,20,GAACGCCCCTTAGGAACGAC,1,1837372
hyuA_predicted,0.9523809523809523,39,20,GAACATCCGTTCTAGCGGGC,19,1845062
hyuA_predicted,0.09523809523809523,21,20,CTTTTTGTTGCGGAATATTC,1,1865039
hyuA_predicted,0.3333333333333333,26,20,CTTCGCCAGAGGATATGAGA,6,1851183
hyuA_predicted,0.5714285714285714,31,20,CTGCTTCGGGCAACCCCACT,11,1876416
hyuA_predicted,0.8571428571428571,37,20,CTCTGTATCCCTAGCCGGTC,17,1862000
hyuA_predicted,0.38095238095238093,27,20,CTAGGGTACCGATGTCAATT,7,1867895
hyuA_predicted,0.9047619047619048,38,20,CGTGCGTTCTCCTCCCTAAA,18,1869912
hyuA_predicted,0.2857142857142857,25,20,CGTCCTCCCTCGATCAGTCG,5,1847717
hyuA_predicted,0.42857142857142855,28,20,CGGCCGGGCGAGGGGGTACT,8,1853686
hyuA_predicted,1.5714285714285714,52,20,CGCGTATGACTACCCTCGCG,32,1862944
hyuA_predicted,1.2857142857142858,46,20,CGAAGTCGAAAACTGCAAAG,26,1840299
hyuA_predicted,0.5238095238095238,30,20,CCGACCGGCCCACTTGCCTT,10,1840693
hyuA_predicted,0.8571428571428571,37,20,CCCGTGTTACGTGACGCTCG,17,1866281
hyuA_predicted,1.1428571428571428,43,20,CCCCAGTGAATGTTGCTGCG,23,1845282
hyuA_predicted,0.3333333333333333,26,20,CCCAGTTATTGTACGGCAGC,6,1861597
hyuA_predicted,0.6190476190476191,32,20,CATTCGAGAGACCCTACATT,12,1829680
hyuA_predicted,3.2857142857142856,88,20,CATCTCTCCTCAAGTAAAAG,68,1841912
hyuA_predicted,0.8095238095238095,36,20,CATCGGGACTACTGTCTCGG,16,1829248
hyuA_predicted,0.19047619047619047,23,20,CATCCCAGTGACCTTGGCGT,3,1842245
hyuA_predicted,0.7142857142857143,34,20,CAAAATATTTGGTGAGTTTA,14,1837064
hyuA_predicted,1.2857142857142858,46,20,ATTCCAGACTTAATTCACCT,26,1868196
hyuA_predicted,0.42857142857142855,28,20,ATGACATTTGTTCACCATCC,8,1860060
hyuA_predicted,0.09523809523809523,21,20,ATCAACGACCGTTGGGGGTC,1,1876083
hyuA_predicted,0.5714285714285714,31,20,ATACGAGAACGGACAAACCC,11,1838945
hyuA_predicted,1.2380952380952381,45,20,AGTTCAGTGCCTGGGGGATG,25,1835004
hyuA_predicted,0.09523809523809523,21,20,AGTCTTAGGTTGAGGTACGT,1,1830356
hyuA_predicted,0.7142857142857143,34,20,AGTATCTACGAACCTTTAAC,14,1867035
hyuA_predicted,0.9047619047619048,38,20,AGGTGAACATCGGTCAAAGT,18,1864826
hyuA_predicted,0.42857142857142855,28,20,AGCATTTACCAGGAACCTCT,8,1838017
hyuA_predicted,0.9523809523809523,39,20,AGAGGGCACTTTTAGAGGTC,19,1829179
hyuA_predicted,0.14285714285714285,22,20,AGACGTATGAGGAAGGGCGA,2,1866094
hyuA_predicted,0.14285714285714285,22,20,ACGTGCGCGTATGTCAAGGT,2,1835692
hyuA_predicted,0.42857142857142855,28,20,ACCATGCGGGAATACCGGCT,8,1840304
hyuA_predicted,0.42857142857142855,28,20,ACAGATCAAGAACTTATAGG,8,1844641
hyuA_predicted,0.23809523809523808,24,20,AAGGCTACGTATTGTTCCGT,4,1872823
hyuA_predicted,0.8095238095238095,36,20,AAAGCCAGATCTCCGATCTT,16,1837954
hyuA_predicted,0.7619047619047619,35,20,AAACAAGTAAGTGGGTCCAG,15,1852487
hyuA_predicted,0.1,20,19,TTTTGTTAGGGGATCGCCAT,1,1843904
hyuA_predicted,0.1,20,19,TTGTCCTCTGGTTTCATCAT,1,1843710
hyuA_predicted,0.35,25,19,TTCGGTGGGGGAGTCGGTTA,6,1864798
hyuA_predicted,0.25,23,19,TGGTGGCGCTCCCAGGTAGG,4,1853950
hyuA_predicted,1.9,56,19,TGCCTTGAACCCTGCGCTGA,37,1847077
hyuA_predicted,0.65,31,19,TGCCTCCGTTCACCAAACGT,12,1864351
hyuA_predicted,0.4,26,19,TGAATCTCGTTGGTTCAGGA,7,1872721
hyuA_predicted,2.0,58,19,TCGTGGGCGTAAGAGGTTAA,39,1838886
hyuA_predicted,1.35,45,19,TCGATCCCCTTTGTTGATAG,26,1862456
hyuA_predicted,0.75,33,19,TCACTACATCGAAATCCGTC,14,1834121
hyuA_predicted,0.1,20,19,TCACATAAACAAGGCAACCC,1,1841250
hyuA_predicted,1.7,52,19,TAGGGATGTTGGTTTATACT,33,1865384
hyuA_predicted,2.65,71,19,TACTTGATCTTCTTCACTTA,52,1837027
hyuA_predicted,0.2,22,19,TACCGTACTCATACCAAGTA,3,1849727
hyuA_predicted,1.3,44,19,TAAGTGCCGTTGTATACCAT,25,1854783
hyuA_predicted,0.85,35,19,GTGATTACTAAGACTTTGGT,16,1850836
hyuA_predicted,1.0,38,19,GTCGTTTTGTAAAAAGGGGA,19,1849056
hyuA_predicted,0.9,36,19,GTCCCGTTGCGTAGTCAGAT,17,1850525
hyuA_predicted,1.1,40,19,GTATCCTCCGTACTGACGAT,21,1839772
hyuA_predicted,1.25,43,19,GTAGGCTAATAGACTGTCCA,24,1859143
hyuA_predicted,0.8,34,19,GGTGGGTGAATCTGCCTCTT,15,1868124
hyuA_predicted,0.45,27,19,GGTAGATTTCAGGGTTTCTA,8,1835332
hyuA_predicted,0.4,26,19,GGGGCGCTATGTCGGAATCA,7,1845977
hyuA_predicted,0.6,30,19,GGGGACCGTGCAACACACCT,11,1853405
hyuA_predicted,0.65,31,19,GGCTCGTGGATCCCTGGCAG,12,1832206
hyuA_predicted,1.75,53,19,GGCATCATAGATCCACACCA,34,1867423
hyuA_predicted,1.0,38,19,GCTGTTAAGTTTGGACCAAT,19,1848288
hyuA_predicted,0.55,29,19,GCTCCCGCCGCTCGTACTTT,10,1845424
hyuA_predicted,0.2,22,19,GCTAATGTGAGGCCTTGCAA,3,1841724
hyuA_predicted,1.6,50,19,GCGCTACACAGTTAACGGGT,31,1852983
hyuA_predicted,0.1,20,19,GCCCTCGAACCACCACTAAT,1,1847348
hyuA_predicted,1.45,47,19,GATTGTTGATATTCTATGTA,28,1845258
hyuA_predicted,0.6,30,19,GAGTAGCACTTCACTAATAA,11,1857683
hyuA_predicted,0.1,20,19,GACTTGTCGCCACTGTAGTG,1,1846361
hyuA_predicted,0.85,35,19,GACAGAGCAGTGCCACCGTG,16,1835570
hyuA_predicted,0.1,20,19,GAATAGTGAGCATCCTGGGC,1,1874678
hyuA_predicted,1.4,46,19,GAACTGGCTAAAGCCGGATA,27,1849263
hyuA_predicted,0.15,21,19,GAACGTCAGGGCCTCACACG,2,1867133
hyuA_predicted,1.1,40,19,CTTATCAGGTTAAGCGGACT,21,1860836
hyuA_predicted,0.4,26,19,CTGGACTCGTGGGCGACCAG,7,1866016
hyuA_predicted,0.3,24,19,CTGATCCAGTACTACTGCGC,5,1839399
hyuA_predicted,0.65,31,19,CTACTCGCTGGACGTTTGGG,12,1828937
hyuA_predicted,0.15,21,19,CGTTGCTATATACGGTCTAA,2,1836645
hyuA_predicted,0.65,31,19,CGTTAGGTTACAACTGCACT,12,1844003
hyuA_predicted,2.0,58,19,CGTGGGGCACCACATAGACT,39,1875512
hyuA_predicted,1.65,51,19,CGGACGTCAATTGTGGTATA,32,1836213
hyuA_predicted,1.5,48,19,CGATGTTGGTCCCGTAATCT,29,1847477
hyuA_predicted,1.2,42,19,CGACGGCTGGGGATTCGATC,23,1869602
hyuA_predicted,1.25,43,19,CGAAGCGCTCGTTACACTAT,24,1841808
hyuA_predicted,0.9,36,19,CCTGGGGGAGGGCGCTCGAT,17,1841071
hyuA_predicted,0.4,26,19,CCCACCACTATGGAGTAGCA,7,1854576
hyuA_predicted,0.9,36,19,CATTAGCGCTCATGTATACT,17,1859134
hyuA_predicted,0.35,25,19,CATAAACTCTGTGGCTGTTG,6,1877342
hyuA_predicted,2.85,75,19,CAGTAGGCTATAGAGAGCTT,56,1832129
hyuA_predicted,0.3,24,19,CAGGCAAGAACATTGTTGCT,5,1861296
hyuA_predicted,0.2,22,19,ATTCCTCAGTAAAACACATT,3,1857920
hyuA_predicted,0.6,30,19,ATGGTGTCGGTATTCTATTA,11,1848716
hyuA_predicted,0.1,20,19,ATGAGCCCTGAAGCTCTGTG,1,1874267
hyuA_predicted,0.1,20,19,ATGACTGGATGCCTTATAAT,1,1842179
hyuA_predicted,0.15,21,19,ATATGCCGCTCAGCGGGCAG,2,1837897
hyuA_predicted,1.0,38,19,AGTGGGTGCGGTTTCGTTAC,19,1831575
hyuA_predicted,1.6,50,19,AGTCGCATTGGCACAGCTCG,31,1834421
hyuA_predicted,1.5,48,19,AGAGATTAACAGTGGAGAAA,29,1837682
hyuA_predicted,1.4,46,19,ACTATGAAAATCATACATTG,27,1842936
hyuA_predicted,0.2,22,19,ACTACGCAAGGACGAGAACT,3,1875790
hyuA_predicted,0.5,28,19,ACGATTATAAAGTTCGGGGA,9,1852087
hyuA_predicted,1.4,46,19,ACGATAACACGGCAAAGTGA,27,1873106
hyuA_predicted,1.85,55,19,ACCCTGTAATATCGCCCTGT,36,1840497
hyuA_predicted,0.4,26,19,ACCCGCTTGGCGACCGTTAT,7,1837669
hyuA_predicted,0.7,32,19,ACATCTATCTACATGACCAA,13,1875216
hyuA_predicted,0.7,32,19,ACAAAACCGCCGAACGCTGC,13,1840551
hyuA_predicted,0.15,21,19,AATGGCCATCTAGAATGGAG,2,1845499
hyuA_predicted,0.65,31,19,AAGGGGCGCAGGTCTATCAC,12,1865914
hyuA_predicted,1.05,39,19,AACAAGACAAAGATCGCATT,20,1832216
hyuA_predicted,0.7894736842105263,32,18,TTTCTTCTGCGTAGCTTGTG,14,1838401
hyuA_predicted,2.8947368421052633,72,18,TTGTCGCGATTATGTAAACA,54,1847324
hyuA_predicted,0.2631578947368421,22,18,TTGACTCTGCGGTCTGTGTA,4,1874654
hyuA_predicted,0.21052631578947367,21,18,TTCCTACAACGCAAAGGAAG,3,1830649
hyuA_predicted,1.6842105263157894,49,18,TTATATGCGCTACATCTAGA,31,1857410
hyuA_predicted,0.9473684210526315,35,18,TGGGTGTACATGTTTTGAAA,17,1857840
hyuA_predicted,0.631578947368421,29,18,TGGGGCCGGTGGGAATGAGA,11,1846488
hyuA_predicted,0.10526315789473684,19,18,TGCGACGCATGAACGTGCGG,1,1860055
hyuA_predicted,1.3157894736842106,42,18,TCTCTAAATCGGCGCCCCGG,24,1850631
hyuA_predicted,0.47368421052631576,26,18,TCTCAGCTTAGGCAGTAAGC,8,1840121
hyuA_predicted,0.10526315789473684,19,18,TCGGGTACGTGTCCTACCCT,1,1847060
hyuA_predicted,0.21052631578947367,21,18,TCGCGTTCCCGCGGGGGTAA,3,1840664
hyuA_predicted,0.42105263157894735,25,18,TCGAACACGGTATACGTCTG,7,1854311
hyuA_predicted,0.7368421052631579,31,18,TCCATCGTAGGGCGAAGCGT,13,1837034
hyuA_predicted,1.631578947368421,48,18,TCATCTATAATCCAGCTCTG,30,1855314
hyuA_predicted,0.5263157894736842,27,18,TAGAGCGCGAGGGGTGTTGT,9,1852208
hyuA_predicted,1.4210526315789473,44,18,TAATTCGTGTACAGCCCTCC,26,1862982
hyuA_predicted,0.631578947368421,29,18,TAATACTTCATCTGCGATTA,11,1839187
hyuA_predicted,0.3157894736842105,23,18,GTTGCTACACTAGGCTGAAT,5,1838801
hyuA_predicted,1.631578947368421,48,18,GTCTGTGTACATAGTGGTTA,30,1870748
hyuA_predicted,0.8947368421052632,34,18,GTCGGTCTCAGAGTAATCAA,16,1844346
hyuA_predicted,1.3157894736842106,42,18,GTCCGTGTACGGATCAGTTA,24,1830720
hyuA_predicted,0.42105263157894735,25,18,GGGTACGGCATGTTCTCCCA,7,1867977
hyuA_predicted,0.7894736842105263,32,18,GGGCGCCAGTGGAGGGCACC,14,1839260
hyuA_predicted,0.42105263157894735,25,18,GGCCTGGTCAATGGTATGAA,7,1849262
hyuA_predicted,0.21052631578947367,21,18,GCGACCGCTATTTAAAACTC,3,1872643
hyuA_predicted,1.0526315789473684,37,18,GCCTGATTGATTAGGGCTGC,19,1864718
hyuA_predicted,0.15789473684210525,20,18,GCCCAGTTATGTCGCGTCAT,2,1856285
hyuA_predicted,0.3157894736842105,23,18,GATCTTAAAATGGGCCTCCC,5,1858819
hyuA_predicted,0.9473684210526315,35,18,GAGTAGGTTCCTCTTGATCA,17,1843938
hyuA_predicted,0.15789473684210525,20,18,GAGAGATATTCTCTGGGAGA,2,1865579
hyuA_predicted,1.0526315789473684,37,18,CTTTAACCTCCCTGTCGTTC,19,1868875
hyuA_predicted,0.10526315789473684,19,18,CTTGTCCCGAACTTAAGAAC,1,1871007
hyuA_predicted,1.4736842105263157,45,18,CTTCCTAAGGTTCGAGATTG,27,1845219
hyuA_predicted,0.5789473684210527,28,18,CTGTTGACGGACAGAAACAT,10,1871152
hyuA_predicted,0.47368421052631576,26,18,CTGTAATTCGATTCGATCAC,8,1843863
hyuA_predicted,0.42105263157894735,25,18,CTGGAGGTTCGTAATAGATT,7,1865459
hyuA_predicted,0.5789473684210527,28,18,CTGAAGGTGAGTAGACCCGG,10,1871680
hyuA_predicted,0.7368421052631579,31,18,CTACGGCGGTGTGCGCTCTT,13,1870685
hyuA_predicted,0.42105263157894735,25,18,CGTTTGGGTCGCCCGACCTA,7,1841500
hyuA_predicted,1.8421052631578947,52,18,CGTAAAAATTACGAGGAGAT,34,1836211
hyuA_predicted,1.0526315789473684,37,18,CGGCGAACGAGCCGCCGACG,19,1857837
hyuA_predicted,0.2631578947368421,22,18,CGGCAAGGACGGTCTTTATT,4,1851801
hyuA_predicted,0.15789473684210525,20,18,CGCCCCCCTTCGGGCTAAGA,2,1859229
hyuA_predicted,0.21052631578947367,21,18,CCGGCGTGGAGGTTCAGCTG,3,1843821
hyuA_predicted,2.473684210526316,64,18,CCCGATAGCTGTGCATTATA,46,1869272
hyuA_predicted,0.21052631578947367,21,18,CCCCATACGGGGATTCTTGA,3,1868336
hyuA_predicted,0.47368421052631576,26,18,CCCCACTCTGTTGGGCAACT,8,1841370
hyuA_predicted,0.7368421052631579,31,18,CCATCGTGATCTATGGATGC,13,1838396
hyuA_predicted,0.6842105263157895,30,18,CCAACCCTTCGCCGGGTTAA,12,1842501
hyuA_predicted,0.15789473684210525,20,18,CCAAACAGCTACTTTGAAAT,2,1862232
hyuA_predicted,1.8421052631578947,52,18,CATTTTCGTGGCAACACTCA,34,1851654
hyuA_predicted,0.8947368421052632,34,18,CATGAACTTATTGAAAGCCG,16,1850647
hyuA_predicted,1.4736842105263157,45,18,CATAGCCAACCCGCTAGTAG,27,1844184
hyuA_predicted,0.2631578947368421,22,18,CACTTAGCCCTCTATCCACG,4,1838080
hyuA_predicted,0.8421052631578947,33,18,CACCTGCCCAAGCAAATACT,15,1842942
hyuA_predicted,0.42105263157894735,25,18,CAATTGTCAAAGGGCAAGGC,7,1842153
hyuA_predicted,5.157894736842105,115,18,CAATAGATAGTCGCACTGTC,97,1834558
hyuA_predicted,1.7894736842105263,51,18,ATGCTACTATTATACGCCGT,33,1850670
hyuA_predicted,0.8421052631578947,33,18,ATCGGCTATGCATATAATGC,15,1871595
hyuA_predicted,0.2631578947368421,22,18,ATACGTCCGAAGTGGAATTC,4,1847975
hyuA_predicted,0.631578947368421,29,18,AGGTAACATGGTGCTCTTAG,11,1831224
hyuA_predicted,1.631578947368421,48,18,AGGGTAGTGTTAGCCGTTTA,30,1837979
hyuA_predicted,0.15789473684210525,20,18,AGGGCCAGGGCGTTTCCTGA,2,1858816
hyuA_predicted,0.6842105263157895,30,18,AGGCAAATCCGAGGCCAGTG,12,1855286
hyuA_predicted,0.10526315789473684,19,18,AGCGTTTGAAGTTGATCACA,1,1858264
hyuA_predicted,0.8421052631578947,33,18,AGCACTAGACACATGTTGTA,15,1833715
hyuA_predicted,0.15789473684210525,20,18,AGCACGAACATCATGTACAA,2,1853468
hyuA_predicted,0.10526315789473684,19,18,AGATACGCTCCTAGGCCCAA,1,1868025
hyuA_predicted,0.10526315789473684,19,18,AGACTGCCGATCTCCTATAT,1,1862274
hyuA_predicted,0.8421052631578947,33,18,AGAAAAGTATCCTCGCTAAT,15,1844092
hyuA_predicted,0.2631578947368421,22,18,ACTACCTCCCTACTATTAAA,4,1873322
hyuA_predicted,1.736842105263158,50,18,ACCGTTTCGGCTCATTACAG,32,1837845
hyuA_predicted,0.2631578947368421,22,18,ACAGTTTCAGTCAGATTATC,4,1861891
hyuA_predicted,0.8947368421052632,34,18,ACACCGATACTAAGCTCATA,16,1840431
hyuA_predicted,0.5263157894736842,27,18,AATTCGTAACCTTGGGAGAC,9,1838261
hyuA_predicted,0.47368421052631576,26,18,AAGTATAACAGCCGTCGATT,8,1845495
hyuA_predicted,1.5263157894736843,46,18,AAGGGCCTCTTAATCGGCCC,28,1839595
hyuA_predicted,1.368421052631579,43,18,AAGATGTATCCGGTTGTTGC,25,1837708
hyuA_predicted,0.2631578947368421,22,18,AACCCGACGCCGGGTACGAT,4,1832224
hyuA_predicted,0.3888888888888889,23,17,TTAGGGATTGGTCGGAACTA,6,1846496
hyuA_predicted,1.4444444444444444,42,17,TTACTCAGATGTTATGTTAC,25,1862948
hyuA_predicted,0.6666666666666666,28,17,TGTCCGGCTGGGTACCGTAT,11,1854353
hyuA_predicted,1.5555555555555556,44,17,TGGTGCGCGTGCGCATGCGA,27,1871760
hyuA_predicted,0.2222222222222222,20,17,TGGCGAGTATCGCAAAGTCA,3,1836274
hyuA_predicted,0.6111111111111112,27,17,TGGAATACGGGGAGGTCGCT,10,1834778
hyuA_predicted,0.5,25,17,TGCCTTTCTATTAGACATCT,8,1874786
hyuA_predicted,0.1111111111111111,18,17,TGCAGAGGAACCTAGATGAG,1,1842378
hyuA_predicted,2.388888888888889,59,17,TCTCTCTTTTTACGTTCCCC,42,1841681
hyuA_predicted,2.611111111111111,63,17,TCACGGCATATACCTATGCT,46,1841214
hyuA_predicted,1.2222222222222223,38,17,TCAAGACTGTGCTGGACCGT,21,1829063
hyuA_predicted,1.3333333333333333,40,17,TATTTCTTGTACGTGTACCC,23,1870404
hyuA_predicted,0.2777777777777778,21,17,TATCACCTGGATAGGTAGTA,4,1845059
hyuA_predicted,2.0555555555555554,53,17,TACGGGACATATTCGTTAAA,36,1852281
hyuA_predicted,1.1111111111111112,36,17,TAATTGTTAAACGGCCCTAT,19,1849560
hyuA_predicted,0.1111111111111111,18,17,GTCTAGAATGGTGCGTATGT,1,1859467
hyuA_predicted,0.1111111111111111,18,17,GTCCTCATCATGGGGTTGAC,1,1866990
hyuA_predicted,0.2777777777777778,21,17,GTCACCCCTGTGATGCTCGA,4,1874376
hyuA_predicted,1.6111111111111112,45,17,GTATTTCACTTCGGTTCGGC,28,1832106
hyuA_predicted,1.2777777777777777,39,17,GTACGACTCAAAGCAGGGTG,22,1856477
hyuA_predicted,0.5,25,17,GGTGGAAAACCGGGGCAGCT,8,1838543
hyuA_predicted,0.8333333333333334,31,17,GGGGCCTCTGGCAGGCAAAA,14,1848326
hyuA_predicted,1.1111111111111112,36,17,GGGCCTATCGAGATCGGAAG,19,1846347
hyuA_predicted,0.16666666666666666,19,17,GGCGCCGCGTGGGGTCTAGC,2,1833395
hyuA_predicted,0.1111111111111111,18,17,GGCCTGGGGCTTGGGTGCAG,1,1872802
hyuA_predicted,2.7222222222222223,65,17,GGCCGTGATCGGCTCGTGCC,48,1866370
hyuA_predicted,1.0,34,17,GCTTTGCCGTATACTGGTCA,17,1850519
hyuA_predicted,0.7222222222222222,29,17,GCTTGTACTGTTGTAAGATG,12,1867416
hyuA_predicted,0.1111111111111111,18,17,GCCGAACGTATTTATAAGTA,1,1840385
hyuA_predicted,1.0,34,17,GCAGAGAACCCTCAAGCAGG,17,1845649
hyuA_predicted,0.3888888888888889,23,17,GCACGCTTTGATAGAGATTC,6,1830202
hyuA_predicted,0.3333333333333333,22,17,GATATAAGTGGCCCTTTCAA,5,1849641
hyuA_predicted,0.3333333333333333,22,17,GACGGACCGTCGCCCCCTTC,5,1848930
hyuA_predicted,2.5555555555555554,62,17,GACGGAAAGTAGTGTCGGTC,45,1853178
hyuA_predicted,1.7222222222222223,47,17,GACACTACTGCACTTTGATG,30,1832470
hyuA_predicted,0.2777777777777778,21,17,GAAGGGCTTTATTATTCTAC,4,1830170
hyuA_predicted,0.5,25,17,GAACCCGCCGCAGAACAAGT,8,1876809
hyuA_predicted,0.7777777777777778,30,17,CTTTCACTTATGGTATTCTT,13,1839879
hyuA_predicted,0.2222222222222222,20,17,CTTCTTTTCGCGAACGGAGC,3,1865383
hyuA_predicted,0.5,25,17,CTTAATGGGCTCGACCCGTT,8,1844902
hyuA_predicted,1.2222222222222223,38,17,CTGGAGGGTATAAACTAAGT,21,1869130
hyuA_predicted,0.9444444444444444,33,17,CTGCGTTTAGGTTCCACTAT,16,1851619
hyuA_predicted,0.3333333333333333,22,17,CTGCAGTCACCTCCCGGCAA,5,1838189
hyuA_predicted,2.7777777777777777,66,17,CTCTTGAAACGTACGATCAA,49,1871227
hyuA_predicted,0.3333333333333333,22,17,CTCCGCGCTGTTAAAAGGTG,5,1828960
hyuA_predicted,1.3888888888888888,41,17,CTCAGGGTGCTAGCAGATGT,24,1839151
hyuA_predicted,0.1111111111111111,18,17,CTACCAAGTCGATGCTACTG,1,1850541
hyuA_predicted,1.8888888888888888,50,17,CTACACTGTCCCGCCGTTTT,33,1873479
hyuA_predicted,0.2222222222222222,20,17,CGGTGAAGGAATTCGGGATG,3,1875218
hyuA_predicted,0.2777777777777778,21,17,CGGTACAATAAATAACACCT,4,1851907
hyuA_predicted,1.0555555555555556,35,17,CGGCTGGGTCCGCCGGTGCG,18,1877571
hyuA_predicted,1.1666666666666667,37,17,CGCGAGCGTGATTATGCTGG,20,1839728
hyuA_predicted,0.5,25,17,CGCCTGTTTTGTCGAATTCA,8,1874675
hyuA_predicted,0.7222222222222222,29,17,CGCATGGTACTGAGGTACCT,12,1831927
hyuA_predicted,0.2777777777777778,21,17,CGACAGACAATATCCAGATG,4,1864136
hyuA_predicted,0.8333333333333334,31,17,CCTGTTGCATGCTCGGCGCC,14,1861106
hyuA_predicted,1.4444444444444444,42,17,CCGTGGCCAACGTCTTACTG,25,1834187
hyuA_predicted,0.7777777777777778,30,17,CCGTCATGTTACTTTCTCGT,13,1874845
hyuA_predicted,0.6666666666666666,28,17,CCGTATCGCACCGTCTAATT,11,1865427
hyuA_predicted,0.3333333333333333,22,17,CCGCACTAGGCCACCCAGCA,5,1845505
hyuA_predicted,0.16666666666666666,19,17,CCCTGCTGGAGTTGCGCGCA,2,1841723
hyuA_predicted,0.3333333333333333,22,17,CCCCTTCGTCGAGCAATACC,5,1832201
hyuA_predicted,0.5555555555555556,26,17,CATATTCCATAAAGAAGGAG,9,1829686
hyuA_predicted,0.1111111111111111,18,17,CATACATTGAACCAGTTGAA,1,1871339
hyuA_predicted,0.16666666666666666,19,17,CAGTGCTGGAAGGATGCGAG,2,1838482
hyuA_predicted,1.1111111111111112,36,17,CAGTAGTGCCCAAGCGGGTG,19,1837769
hyuA_predicted,0.6666666666666666,28,17,CAGGCCAAGTTTTGTTGATT,11,1831573
hyuA_predicted,0.7222222222222222,29,17,CACTGCAGATCTACTCACGT,12,1832217
hyuA_predicted,1.0555555555555556,35,17,CAATAACTATACTCGAACGT,18,1867134
hyuA_predicted,0.5,25,17,ATCTAATGATTAGAAGATCC,8,1859223
hyuA_predicted,0.3333333333333333,22,17,ATCCCTTCGGTTTATTAAAA,5,1835052
hyuA_predicted,1.1666666666666667,37,17,ATATTGGGCATCAAGCGCTC,20,1848238
hyuA_predicted,1.1666666666666667,37,17,AGTAATATTCCCTTAACTCT,20,1841805
hyuA_predicted,0.4444444444444444,24,17,AGGTTCGTTGACGAACGGGG,7,1852427
hyuA_predicted,0.16666666666666666,19,17,AGGTATGTGCGGTCCGTCAA,2,1834046
hyuA_predicted,1.3888888888888888,41,17,AGGACCCATTGATGTCCCTA,24,1870177
hyuA_predicted,0.1111111111111111,18,17,AGGAAAATCTTGAAACCTTG,1,1866712
hyuA_predicted,0.16666666666666666,19,17,AGCTCTTCGGACTTGAACGC,2,1833543
hyuA_predicted,1.5555555555555556,44,17,AGCTCCCTGGCATGTCTTGT,27,1845592
hyuA_predicted,0.2777777777777778,21,17,AGCCAGAGTACGGTTACTCT,4,1849306
hyuA_predicted,1.0,34,17,AGCATCGTACACGCTCGAAT,17,1877090
hyuA_predicted,0.16666666666666666,19,17,AGCAGTGAGCGCAAGGCCGC,2,1850328
hyuA_predicted,1.3333333333333333,40,17,AGAAGCAAAACATATAGACA,23,1841915
hyuA_predicted,0.8888888888888888,32,17,ACTGTTGGGGCGATTATCTA,15,1852769
hyuA_predicted,2.0,52,17,ACTATGCTGATCAGATACAT,35,1864929
hyuA_predicted,1.5555555555555556,44,17,ACGGAGAGTGAAGGAGGTGA,27,1850910
hyuA_predicted,0.16666666666666666,19,17,ACGCAGAACTAAATCTTGTA,2,1833144
hyuA_predicted,0.7777777777777778,30,17,ACGACGGGGGCCTCCTTAGT,13,1859012
hyuA_predicted,0.6111111111111112,27,17,ACCCGTATTCGGCACGGCAG,10,1859162
hyuA_predicted,0.16666666666666666,19,17,ACAGCGGCCATTGCGACACA,2,1829633
hyuA_predicted,0.2222222222222222,20,17,AATCGATTCGGCAGGGTAAA,3,1870174
hyuA_predicted,1.0,34,17,AAGCTGAATGCCGTCTGATA,17,1847713
hyuA_predicted,1.4444444444444444,42,17,AAGCGATAAGCATTTGAATT,25,1868718
hyuA_predicted,0.1111111111111111,18,17,AAGATTGCGTCACGATCAGA,1,1857643
hyuA_predicted,0.11764705882352941,17,16,TTTTACACTCTGGCTATAAC,1,1869281
hyuA_predicted,0.7647058823529411,28,16,TTGTTAGCCTGGCTTACGTT,12,1856446
hyuA_predicted,0.8823529411764706,30,16,TTGTAGTTGTGTCTGCCATG,14,1850385
hyuA_predicted,0.4117647058823529,22,16,TTGAGATAGTCGTTCCCATA,6,1834474
hyuA_predicted,0.47058823529411764,23,16,TTCGACGCCCTATAGACGTA,7,1844844
hyuA_predicted,0.7058823529411765,27,16,TTCCGCTCAACGAAGAGCGC,11,1829356
hyuA_predicted,0.17647058823529413,18,16,TTCCCTCAGGCAACGCTCTT,2,1848129
hyuA_predicted,1.411764705882353,39,16,TTCACCGCAGCGCTATGCTT,23,1838081
hyuA_predicted,0.11764705882352941,17,16,TTAGTACTCGACGCGCCCAA,1,1866053
hyuA_predicted,0.35294117647058826,21,16,TGTGTAGAGGAAGGCAGGCT,5,1846008
hyuA_predicted,0.7647058823529411,28,16,TGGGCTTTTTCCCGACCAGT,12,1856248
hyuA_predicted,0.17647058823529413,18,16,TGGCCATTTCCGAGCTCATG,2,1850889
hyuA_predicted,0.8823529411764706,30,16,TGGCAGATACCCCAACACAA,14,1830370
hyuA_predicted,0.23529411764705882,19,16,TGCTCGCGAATGATTAATGT,3,1842838
hyuA_predicted,0.4117647058823529,22,16,TGCTAGCTAACAATCCGAGT,6,1841420
hyuA_predicted,0.4117647058823529,22,16,TGCCATTCTGCGGGACCGAC,6,1858458
hyuA_predicted,0.6470588235294118,26,16,TGCAGGTCCATAGAGTGTTC,10,1831991
hyuA_predicted,0.4117647058823529,22,16,TGATTTCGACTATTTCCAAT,6,1873631
hyuA_predicted,0.35294117647058826,21,16,TGAGAATCGTAGCAGTAATG,5,1853406
hyuA_predicted,0.23529411764705882,19,16,TGAACGCCACGGAGTTAGAT,3,1848093
hyuA_predicted,0.5294117647058824,24,16,TGAACCCCTATGCGTCTTAA,8,1872102
hyuA_predicted,1.588235294117647,42,16,TCGGGTCTTAAGCAACAGAT,26,1847905
hyuA_predicted,2.235294117647059,53,16,TCCGCACTCTCGATCCACTT,37,1873311
hyuA_predicted,0.29411764705882354,20,16,TCCGATTGACAACATAGCCA,4,1865612
hyuA_predicted,0.6470588235294118,26,16,TCATGACTGCTTCCCCTTAT,10,1848752
hyuA_predicted,1.0588235294117647,33,16,TCAGTATTTGGCACGGGTTA,17,1872430
hyuA_predicted,0.7647058823529411,28,16,TCACTCAGGACTCCATCTTA,12,1846017
hyuA_predicted,1.7058823529411764,44,16,TCACAGACGCTCTCCGATAA,28,1868992
hyuA_predicted,0.5882352941176471,25,16,TCAAGCACCCCTGGCGAGGA,9,1848788
hyuA_predicted,0.47058823529411764,23,16,TATCCACCGCACTTGGAGAT,7,1855073
hyuA_predicted,1.2352941176470589,36,16,GTTATTATCTGCCTGTTAGG,20,1872682
hyuA_predicted,0.9411764705882353,31,16,GTGTCAGGGACGCATTCCTT,15,1842944
hyuA_predicted,0.7647058823529411,28,16,GTCCATAGCGGGGCGAGGAC,12,1842190
hyuA_predicted,0.29411764705882354,20,16,GTATAGGCTGTGTGCGGAAA,4,1829384
hyuA_predicted,0.7647058823529411,28,16,GGTTGTGGTCGGGTGGAGCA,12,1831732
hyuA_predicted,0.5882352941176471,25,16,GGCTGTAGGTGGGAACGACT,9,1829120
hyuA_predicted,0.11764705882352941,17,16,GGCGTAGGTAACACGAATTG,1,1831252
hyuA_predicted,0.29411764705882354,20,16,GGCAGTGTGAGCTATCGACA,4,1841177
hyuA_predicted,1.411764705882353,39,16,GCTTACCCTCCCCACTCAAG,23,1845483
hyuA_predicted,0.5294117647058824,24,16,GCTGCCAGGGTAATACCAAT,8,1833182
hyuA_predicted,0.35294117647058826,21,16,GCCGTTGTAAGCTTCGGGAT,5,1831895
hyuA_predicted,0.11764705882352941,17,16,GCCGGTAAGGTGAATTACCA,1,1832906
hyuA_predicted,0.47058823529411764,23,16,GCCCAGAGTCCCCAAATCTA,7,1856649
hyuA_predicted,0.8823529411764706,30,16,GCCAGATCCATAGAGGCCTT,14,1837806
hyuA_predicted,1.8235294117647058,46,16,GCATGAAGTGAAGGTGCCTA,30,1832971
hyuA_predicted,1.2352941176470589,36,16,GCAGGAAATAACGAAGAAAC,20,1866368
hyuA_predicted,2.176470588235294,52,16,GCACGCTCCTCTGCATATCT,36,1862499
hyuA_predicted,4.764705882352941,96,16,GATTAACACGTACGACCCGA,80,1831574
hyuA_predicted,0.7647058823529411,28,16,GAGGAAGAATGTCATGTTTG,12,1854271
hyuA_predicted,0.5882352941176471,25,16,GACAACCAGCGAAAGTCTTG,9,1849155
hyuA_predicted,0.11764705882352941,17,16,GAACACCCATGATGGTGGTT,1,1849274
hyuA_predicted,1.3529411764705883,38,16,CTTTTCTAGGTTCGACATAA,22,1830654
hyuA_predicted,0.5882352941176471,25,16,CTTTTAAGTTCCTACCCTTG,9,1866406
hyuA_predicted,0.23529411764705882,19,16,CTTCTTGGAGATGGTGACCA,3,1861091
hyuA_predicted,1.1176470588235294,34,16,CTTCCAAACTGGGACGTCAG,18,1864100
hyuA_predicted,0.8235294117647058,29,16,CTGTGCAGGTTGTCACGTTG,13,1864197
hyuA_predicted,1.1176470588235294,34,16,CTCTTTCCGCGGCCTTGAAA,18,1872989
hyuA_predicted,2.0588235294117645,50,16,CTCTCTCCTGTTACCTCTAT,34,1846717
hyuA_predicted,0.29411764705882354,20,16,CTCGCATCGGGTCAAAACTG,4,1839771
hyuA_predicted,0.11764705882352941,17,16,CGTCCGCGGTTTGCCAGAGC,1,1859913
hyuA_predicted,0.11764705882352941,17,16,CGGCCGGCCAGTCGGGAACA,1,1853072
hyuA_predicted,0.17647058823529413,18,16,CGGACTCACATTTCTAGGCC,2,1856860
hyuA_predicted,0.17647058823529413,18,16,CGCTCCGGCTAAAGCAGTAC,2,1839838
hyuA_predicted,0.9411764705882353,31,16,CGCGCATTTCACGGCGTAAT,15,1873998
hyuA_predicted,1.4705882352941178,40,16,CGCACTAGAGGATTGCCGGT,24,1876805
hyuA_predicted,2.0588235294117645,50,16,CGATTCATGCGGAACGACGC,34,1870065
hyuA_predicted,1.3529411764705883,38,16,CGATAGTGAAGCTGGTACTT,22,1858603
hyuA_predicted,0.17647058823529413,18,16,CGACGACAATACTCAGAGTT,2,1867248
hyuA_predicted,0.17647058823529413,18,16,CGAACCGCATGCTTTAGGCT,2,1840550
hyuA_predicted,0.7647058823529411,28,16,CCGGCATGGTGCCCGGATTG,12,1855152
hyuA_predicted,0.7058823529411765,27,16,CCAAGGCTCGGTGCTCCACA,11,1846630
hyuA_predicted,1.1176470588235294,34,16,CCAAAGGGGGGCGCATTACA,18,1867337
hyuA_predicted,2.0,49,16,CATCTGCATGACTAGACCTT,33,1872805
hyuA_predicted,0.6470588235294118,26,16,CATACCCTCTGTACGAGGGT,10,1871015
hyuA_predicted,0.17647058823529413,18,16,CAGGCGTTGCCGTACTGATA,2,1835256
hyuA_predicted,1.0588235294117647,33,16,CACGCCCATGTTTGGGTTAA,17,1838564
hyuA_predicted,3.7058823529411766,78,16,CACCCGAGCCGCTCTCGAAA,62,1829253
hyuA_predicted,2.7058823529411766,61,16,CACATAAGTTGTCTTGGATT,45,1849679
hyuA_predicted,1.7647058823529411,45,16,CAAGGTACCGCGTCTTTTGA,29,1836459
hyuA_predicted,0.6470588235294118,26,16,CAAGGAACGATATATACTGT,10,1875732
hyuA_predicted,1.1176470588235294,34,16,CAAGCGTTGAAAAGGGCGCT,18,1871569
hyuA_predicted,0.17647058823529413,18,16,CAAAGCATTTGTTTCGATAG,2,1846461
hyuA_predicted,1.411764705882353,39,16,ATTCTCAGAATGGCACGAGG,23,1851369
hyuA_predicted,1.588235294117647,42,16,ATGTTCGATGCCGCGGTATC,26,1877438
hyuA_predicted,2.5294117647058822,58,16,ATGAACAGACACCAAGATTC,42,1837213
hyuA_predicted,0.17647058823529413,18,16,ATCCGACCGCTAAGGTATTA,2,1865057
hyuA_predicted,0.29411764705882354,20,16,ATAGGTTTTTTGAGCCCTGA,4,1843579
hyuA_predicted,0.4117647058823529,22,16,ATAAGGATGATTCGAATTGT,6,1847119
hyuA_predicted,0.9411764705882353,31,16,AGTCACGCGGTATTCCGATG,15,1835751
hyuA_predicted,0.6470588235294118,26,16,AGGTTGACCACGAGCAATTG,10,1833382
hyuA_predicted,0.5294117647058824,24,16,AGGGCGTGGAGACATTCTTC,8,1833408
hyuA_predicted,3.0,66,16,AGGCGCGGTACGGTAAGTAA,50,1850902
hyuA_predicted,0.17647058823529413,18,16,AGCTAGCTGTAGCAACTGTC,2,1844088
hyuA_predicted,0.17647058823529413,18,16,AGATCGCAGCGTCGCAGCGG,2,1872936
hyuA_predicted,1.8235294117647058,46,16,AGACCTCATTGACTGAAACC,30,1876896
hyuA_predicted,0.47058823529411764,23,16,ACGTTTACATTGAGCCCAAT,7,1856300
hyuA_predicted,0.8235294117647058,29,16,ACGTGAGTGCGGGAATCTCA,13,1861750
hyuA_predicted,0.7058823529411765,27,16,ACGCTTGTCCTCCGGCTGTT,11,1859081
hyuA_predicted,1.3529411764705883,38,16,ACGCGGACCCATCCTGCACA,22,1876755
hyuA_predicted,1.0,32,16,ACGAGTCTACCCCAGCACGT,16,1841907
hyuA_predicted,0.8823529411764706,30,16,ACGACATAAACATATGCCGT,14,1837533
hyuA_predicted,2.9411764705882355,65,16,ACCACTCGGTTTGGTGACGC,49,1872560
hyuA_predicted,0.17647058823529413,18,16,ACCACGGCCGAAGATAAATC,2,1840823
hyuA_predicted,2.588235294117647,59,16,ACCACAGCTCAAATACAGGC,43,1870618
hyuA_predicted,0.8823529411764706,30,16,AATCAGTTACTGAAGCCTCG,14,1857910
hyuA_predicted,1.6470588235294117,43,16,AAGTCGCAGCTCTTCCAGTA,27,1851232
hyuA_predicted,0.8235294117647058,29,16,AAGTATGGATTATTCTGCTC,13,1850456
hyuA_predicted,0.5882352941176471,25,16,AAGCATAACAGGTAGTCATT,9,1848744
hyuA_predicted,1.0588235294117647,33,16,AAGCAGACGTCTCGAAGCAG,17,1861655
hyuA_predicted,3.7058823529411766,78,16,AAACCCTCTGGCGGTTACAA,62,1858507
hyuA_predicted,0.8125,27,15,TTGTTTCAGCGCCACGGTAT,12,1856886
hyuA_predicted,2.0625,47,15,TTGTATGGATCTTAGTTAGG,32,1877750
hyuA_predicted,2.75,58,15,TTGCTCGCGAACGGAGGACC,43,1844342
hyuA_predicted,0.5,22,15,TTGCTAGACGTGTGACAGCT,7,1856985
hyuA_predicted,0.125,16,15,TTGAACGGAGAAGTCTGGCT,1,1835255
hyuA_predicted,1.9375,45,15,TTGAAAACAAATATATAGCA,30,1854274
hyuA_predicted,2.625,56,15,TTCTGGCAATAACGTACAGT,41,1857766
hyuA_predicted,0.1875,17,15,TTCCGTTAGCTTCAGAAGTA,2,1851224
hyuA_predicted,1.5,38,15,TTATGGCAGGAGAGTCTGAC,23,1855246
hyuA_predicted,4.5625,87,15,TTATATCCATGGATCATAGA,72,1838675
hyuA_predicted,0.125,16,15,TGTTGTCCTTAGGGCTTTTC,1,1849606
hyuA_predicted,0.125,16,15,TGTAGGAAATGGTTAATACT,1,1841255
hyuA_predicted,0.1875,17,15,TGGTGCTGTGTGGGTTTGAT,2,1850567
hyuA_predicted,0.5625,23,15,TGGTCCCTGAGGGTTATTAG,8,1848034
hyuA_predicted,0.5625,23,15,TGGACAGGTAGGCCAGCGAA,8,1836511
hyuA_predicted,0.75,26,15,TGAATAATGAAGGTACAAGG,11,1873873
hyuA_predicted,0.1875,17,15,TGAACTTTGCCGCGGTATCT,2,1865834
hyuA_predicted,1.375,36,15,TCTATCTAGCATTTCTCGCT,21,1830243
hyuA_predicted,1.375,36,15,TCGTATGTGTAACGCATAGA,21,1861123
hyuA_predicted,0.3125,19,15,TCGGGGTCATTGGACGACGC,4,1850913
hyuA_predicted,0.125,16,15,TCGCTGATATTAGCTGACGG,1,1830979
hyuA_predicted,0.3125,19,15,TCGCGTGCTGCCTTTCAGAG,4,1863504
hyuA_predicted,1.0625,31,15,TCCTGGCTGCGGGGCAGTTA,16,1858342
hyuA_predicted,0.125,16,15,TCCCCAGGGTTGACTTGACT,1,1839687
hyuA_predicted,3.5,70,15,TCCAATTGGACTAACAAACC,55,1848506
hyuA_predicted,0.875,28,15,TCATAATCATAGTTACTCCA,13,1833252
hyuA_predicted,0.875,28,15,TCAGGTGTCCCGCTACGTCC,13,1865426
hyuA_predicted,1.375,36,15,TCAGCGATTTGGTTCTCGCA,21,1861601
hyuA_predicted,1.0,30,15,TCACTTCCGTGGGCCAAAAT,15,1833228
hyuA_predicted,0.125,16,15,TCAACCGTGACACGGTCTCT,1,1871427
hyuA_predicted,2.0625,47,15,TATCTACCATTCTCCAACGC,32,1846345
hyuA_predicted,0.375,20,15,TATATTCACGACGGGTATAT,5,1872193
hyuA_predicted,0.6875,25,15,TATATGGGAGCGAATGCTCT,10,1870797
hyuA_predicted,0.375,20,15,TAGGGTTGCTTAGCATTTTG,5,1840824
hyuA_predicted,0.5625,23,15,TAGCATTTCGTCGGGCCAAA,8,1860833
hyuA_predicted,0.25,18,15,TAGATCTCGACTCGCCAAGT,3,1852839
hyuA_predicted,0.125,16,15,TACTGTGTAGATAATTGGAC,1,1869408
hyuA_predicted,1.5,38,15,TACTGGAGAGGCCGGCACGG,23,1831582
hyuA_predicted,1.0625,31,15,TACGCCGGGACGTTGGTCTA,16,1853449
hyuA_predicted,0.8125,27,15,TACGAGCACCATGTACACAA,12,1869600
hyuA_predicted,0.375,20,15,TACCCGTCTGCAACGAAGAC,5,1840421
hyuA_predicted,1.875,44,15,TAAGGTCCCTCGATATGGTT,29,1834037
hyuA_predicted,0.4375,21,15,TAACAGGGGTGTAACCGAGG,6,1848732
hyuA_predicted,0.75,26,15,GTTTTAATCTGTACCTCATC,11,1876497
hyuA_predicted,0.5625,23,15,GTTTCCCTTTTTTCGAGATG,8,1829099
hyuA_predicted,0.25,18,15,GTTAAGGGGCAAGCCTGTCT,3,1865708
hyuA_predicted,0.1875,17,15,GTGCGCGCACCAGCTACCTT,2,1872893
hyuA_predicted,0.75,26,15,GTCTACAGGGCTCGCAGAGG,11,1877106
hyuA_predicted,0.625,24,15,GTCGCTTCTTACTGCGACGA,9,1834810
hyuA_predicted,3.375,68,15,GTCCCAGAATGGAAGCCCCA,53,1832199
hyuA_predicted,1.5,38,15,GTCCCAATGCGCCCGGGTGT,23,1838516
hyuA_predicted,0.375,20,15,GTCAGCGGAACCTGGTAAAC,5,1855785
hyuA_predicted,0.125,16,15,GTAAAGGCAATAGCGACATA,1,1852351
hyuA_predicted,0.1875,17,15,GGTGATTGCGGGAGAGTGAT,2,1862900
hyuA_predicted,0.5625,23,15,GGTCTCAGAATGTTTCGTTA,8,1854133
hyuA_predicted,0.9375,29,15,GGGCATAAATATGACAGCGA,14,1841802
hyuA_predicted,0.4375,21,15,GGCCCAAGACTGTCTCCTGC,6,1839024
hyuA_predicted,1.4375,37,15,GGATGCCGTAAATCTGGTCA,22,1844472
hyuA_predicted,1.0625,31,15,GGAGGTATGGGAAATGGAGT,16,1837456
hyuA_predicted,1.5,38,15,GGACAGAAGGCTGTCAGTAA,23,1829681
hyuA_predicted,0.1875,17,15,GCGTAGTCAAAGTTCACACA,2,1844079
hyuA_predicted,0.625,24,15,GCCGTTGTGCGGTTGACTTT,9,1848160
hyuA_predicted,1.3125,35,15,GCCCGGTTACTTGAATGATT,20,1840581
hyuA_predicted,0.9375,29,15,GCCAGTATTCACGCAGAGAT,14,1863750
hyuA_predicted,0.6875,25,15,GATCCCGTCACCAAATCGGT,10,1860974
hyuA_predicted,1.375,36,15,GATAGCCGAGTACGTTGCGT,21,1838542
hyuA_predicted,0.25,18,15,GAGTTGTGCACTCGTACGAA,3,1844463
hyuA_predicted,0.6875,25,15,GAGGGCCGTAAACATCGGCT,10,1842929
hyuA_predicted,0.125,16,15,GAGCCTGGAGGAGCCGGGCA,1,1862235
hyuA_predicted,0.4375,21,15,GAGAGCTGACTACTATCAGA,6,1858332
hyuA_predicted,0.1875,17,15,GACTGTGTCGGATTGACTTG,2,1862761
hyuA_predicted,0.125,16,15,GACCTTCCTCAGCCCCAGAC,1,1860091
hyuA_predicted,1.5,38,15,GACCACCAACTATTGTTCCT,23,1835044
hyuA_predicted,0.5,22,15,GACACTCAGCCGATTATTCT,7,1864221
hyuA_predicted,0.375,20,15,GAATAGTTTAGGACCAACCT,5,1835857
hyuA_predicted,0.125,16,15,GAAATGGTGTATGTAGTGTA,1,1834991
hyuA_predicted,0.5625,23,15,CTTTCTGGACAGGACCTACT,8,1836638
hyuA_predicted,1.5,38,15,CTTGTCTGGCGTACATGTAT,23,1876306
hyuA_predicted,0.4375,21,15,CTGGTTAAAGTTTCTCGGAT,6,1862946
hyuA_predicted,0.8125,27,15,CTGGTCACCTCTGGCTTCTA,12,1870990
hyuA_predicted,1.4375,37,15,CTGCGGGAGTAATCTGAGAG,22,1853653
hyuA_predicted,0.125,16,15,CGTTGGGTGGATAGTTGTCC,1,1845489
hyuA_predicted,2.0625,47,15,CGTTCACAAACAAACCTTCA,32,1859994
hyuA_predicted,1.25,34,15,CGGATGTTTCACCCCTTGTA,19,1872756
hyuA_predicted,1.5,38,15,CGCTTAACCGGCTTCCTGCA,23,1863601
hyuA_predicted,0.75,26,15,CGCTATACCCCAGATCGCTC,11,1829605
hyuA_predicted,1.875,44,15,CGCTAGGATTATGTAACGAC,29,1835740
hyuA_predicted,0.875,28,15,CGCTACCAGTTAACAAAGGC,13,1844227
hyuA_predicted,0.625,24,15,CGCGGGGGCGGGAAACGCAG,9,1864015
hyuA_predicted,4.8125,91,15,CGCCTCGCCTCAAACATTGC,76,1832665
hyuA_predicted,0.125,16,15,CGCATAACTTTGCATCTCTC,1,1872492
hyuA_predicted,0.625,24,15,CGAGCGCCGTGTTCTCGATT,9,1847819
hyuA_predicted,1.0,30,15,CCTCCCCGGCGACCGTATGG,15,1837491
hyuA_predicted,0.125,16,15,CCGGGGCCATCTTTCTGTCT,1,1874315
hyuA_predicted,1.9375,45,15,CCGGATTGCCAGGCTTTGAC,30,1861244
hyuA_predicted,0.25,18,15,CCGAGTGATATATGCACCAT,3,1838119
hyuA_predicted,1.0625,31,15,CCCTCCGACCGTGGTGAGAC,16,1864281
hyuA_predicted,0.875,28,15,CCCGTGCCAGGCCAGTTTCG,13,1846873
hyuA_predicted,0.625,24,15,CCACATGTCTGGTTTCGGGA,9,1838398
hyuA_predicted,1.5,38,15,CATTGTTTCTCCCCGGAATT,23,1834808
hyuA_predicted,0.875,28,15,CATCCTTTATTACTAAGATG,13,1832618
hyuA_predicted,1.125,32,15,CATATAACTATAGACAGAAA,17,1873707
hyuA_predicted,0.875,28,15,CATAGACTTTTAATAATCCT,13,1862097
hyuA_predicted,1.5625,39,15,CACGGGTGCATGCACAGCGT,24,1833787
hyuA_predicted,1.6875,41,15,CACGAGTCCTAATCGCCTCA,26,1860165
hyuA_predicted,0.6875,25,15,CACAGATCTGCAAATTGGGT,10,1867070
hyuA_predicted,0.1875,17,15,ATTTCTTTTCCTAATACGGA,2,1855192
hyuA_predicted,0.3125,19,15,ATTTAATTGCCAAGGTTCGT,4,1830464
hyuA_predicted,0.625,24,15,ATTGAGTCCACATCCTTAAT,9,1865418
hyuA_predicted,0.5625,23,15,ATGTACGCGTCACACAGGAT,8,1841009
hyuA_predicted,0.1875,17,15,ATGGATGAGCATTGGCCTTA,2,1849192
hyuA_predicted,1.25,34,15,ATGCGGTCTAGCGATGGTTA,19,1852093
hyuA_predicted,0.25,18,15,ATCGAGTGACATTAGCTGTT,3,1856126
hyuA_predicted,2.625,56,15,ATCCTCCGGTCCGGCATGGG,41,1840029
hyuA_predicted,1.625,40,15,ATCATTGCCGAGGTAAGGTA,25,1863676
hyuA_predicted,0.375,20,15,ATATTCGTTTAATTCAAAGC,5,1856167
hyuA_predicted,1.25,34,15,ATAAGATAATCCGGAAGGCT,19,1836166
hyuA_predicted,0.25,18,15,AGGTTGGTGTACTATGAAGA,3,1844351
hyuA_predicted,0.1875,17,15,AGGCCGGGACAATGAGTTGG,2,1852090
hyuA_predicted,1.4375,37,15,AGGATCCGCATCATACGGGA,22,1844607
hyuA_predicted,1.375,36,15,AGACCAGGCTGTACAGTAGC,21,1853408
hyuA_predicted,1.0,30,15,ACTGCGGAACACGAGATCAA,15,1844513
hyuA_predicted,0.1875,17,15,ACTATTCCGCCGAGACGAAA,2,1860834
hyuA_predicted,0.6875,25,15,ACTATCTACGGTAAAGGAAA,10,1837030
hyuA_predicted,1.4375,37,15,ACGTACAGGGCCATCGGGAG,22,1856607
hyuA_predicted,0.9375,29,15,ACGGCGCAGGTCCGCAGTCC,14,1854280
hyuA_predicted,0.25,18,15,ACCAACCTATCCCGCTATCA,3,1830807
hyuA_predicted,1.5,38,15,ACATAGGCCCCATAGATCGT,23,1858498
hyuA_predicted,0.3125,19,15,ACAGGGAGGGCTACCTAATT,4,1864727
hyuA_predicted,1.125,32,15,ACACCGGTTGTCCGATGGTG,17,1863497
hyuA_predicted,1.75,42,15,AATTCGTGGTGCATTTTCGG,27,1842283
hyuA_predicted,0.3125,19,15,AATTCAAATGCAGGTTAAAC,4,1843435
hyuA_predicted,1.0625,31,15,AATATCCACCCAATCATACC,16,1857998
hyuA_predicted,2.3125,51,15,AATACGCCTGTGCCAAAGTC,36,1860251
hyuA_predicted,1.0625,31,15,AATACAGCACTTGGACGCTC,16,1844985
hyuA_predicted,0.25,18,15,AAGTCAGTCTTATGCTTAAA,3,1871196
hyuA_predicted,2.5,54,15,AAGTCAGGCCGAACACTCTG,39,1848462
hyuA_predicted,0.6875,25,15,AAGGTTACCGTATACCCACG,10,1873175
hyuA_predicted,0.1875,17,15,AAGGCATAAGCTATATGGTG,2,1868626
hyuA_predicted,2.375,52,15,AAGAGACGCGATTTCAGTGC,37,1870586
hyuA_predicted,0.3125,19,15,AACCTACCCGGGGCGTATAT,4,1845425
hyuA_predicted,0.1875,17,15,AAATCGCACACCTCGAACGG,2,1838055
hyuA_predicted,1.875,44,15,AAAACTGAAGGGCAAGCTAC,29,1864069
hyuA_predicted,0.4,19,14,TTTCCGATCTGTAGGCAAAC,5,1856977
hyuA_predicted,0.2,16,14,TTGTATTACGTGTATTAACG,2,1846681
hyuA_predicted,1.7333333333333334,39,14,TTGGCTATGGCGTTTGAAAT,25,1830135
hyuA_predicted,0.6666666666666666,23,14,TTCGCGGCCGGAGTATGTCG,9,1854382
hyuA_predicted,1.8666666666666667,41,14,TTAGCGCAGGCGGTGTGAAC,27,1845488
hyuA_predicted,1.0,28,14,TTACCGGGCCAGAAAACTTA,14,1844761
hyuA_predicted,0.2,16,14,TGTGGGACTTCTTGAGACTG,2,1849268
hyuA_predicted,1.5333333333333334,36,14,TGTCGTAGCTCATGCTTGCG,22,1855214
hyuA_predicted,0.6,22,14,TGTAATGTGATACAAGTGCA,8,1845569
hyuA_predicted,0.2,16,14,TGGTTGCCATGGTGCATCGT,2,1857568
hyuA_predicted,1.1333333333333333,30,14,TGGGGACCGGTTTGTAAATA,16,1871305
hyuA_predicted,0.8666666666666667,26,14,TGCCACAGGTTTATGAGGAG,12,1860296
hyuA_predicted,2.1333333333333333,45,14,TGAGGAGGAATGTGACGATG,31,1865350
hyuA_predicted,1.0,28,14,TGAGCAGCCAAATTTTACAT,14,1847931
hyuA_predicted,2.933333333333333,57,14,TGACCACAGCGGGAGCCACA,43,1844575
hyuA_predicted,0.4666666666666667,20,14,TGAAATATCGGGCAAGGTGA,6,1858432
hyuA_predicted,0.8666666666666667,26,14,TCTTATCGGGAACTGAGCCC,12,1832790
hyuA_predicted,1.4,34,14,TCTGTGACAAGATGCTAATG,20,1875921
hyuA_predicted,0.2,16,14,TCTCTGACCGTAGCTTCTTG,2,1845091
hyuA_predicted,2.066666666666667,44,14,TCTCTCTCGCCTGTACGACA,30,1841801
hyuA_predicted,0.2,16,14,TCTCCGTGCCTAAGTCAGAT,2,1869018
hyuA_predicted,0.3333333333333333,18,14,TCTAAGGATCGGTGTAAGTG,4,1833274
hyuA_predicted,0.6,22,14,TCGCATACGGGTCCTCGCCA,8,1854075
hyuA_predicted,0.26666666666666666,17,14,TCGAAAACTTTCACTCGCGA,3,1869911
hyuA_predicted,1.5333333333333334,36,14,TCCGATAAGATAACTTGGCT,22,1870745
hyuA_predicted,0.13333333333333333,15,14,TCCCACGGGTGTCGATACCC,1,1850759
hyuA_predicted,1.1333333333333333,30,14,TCCAAGGTCGGGTCCATATT,16,1877553
hyuA_predicted,0.5333333333333333,21,14,TCAGCGTGTTCTCTAACGCC,7,1858258
hyuA_predicted,1.4,34,14,TCAGCGCGCTGGTCCTCGAT,20,1855296
hyuA_predicted,0.2,16,14,TCACTGGATCCCCCCCTCAC,2,1836680
hyuA_predicted,0.26666666666666666,17,14,TCAACTCGAGTACGCCCAGC,3,1864772
hyuA_predicted,0.7333333333333333,24,14,TATTCTCGGGGCCGCGTCAG,10,1862173
hyuA_predicted,1.0666666666666667,29,14,TACCGGTACCGGAAGTATTT,15,1833828
hyuA_predicted,0.8,25,14,TAAGCTCCCCACAGTGTGCT,11,1840464
hyuA_predicted,0.8,25,14,TAAAGCGTATCCCGAGCTTA,11,1838056
hyuA_predicted,2.6666666666666665,53,14,GTTCGAAATCTTGTCCTCAC,39,1837275
hyuA_predicted,0.7333333333333333,24,14,GTTCCACTTTAGGAAGGGTT,10,1832266
hyuA_predicted,1.8666666666666667,41,14,GTGATCGAGTTGAACCGTTT,27,1841543
hyuA_predicted,0.13333333333333333,15,14,GTCGTGAACAGGTTAAGGGT,1,1831999
hyuA_predicted,0.2,16,14,GTCGCATTGCATCAGTACAT,2,1839566
hyuA_predicted,0.2,16,14,GTACGAGTGCGGGAAGTTGA,2,1844900
hyuA_predicted,1.6,37,14,GGTTCGCTAACCCGGGTCGT,23,1875555
hyuA_predicted,1.3333333333333333,33,14,GGTCTTGGCATATTTCTCCC,19,1859865
hyuA_predicted,1.0,28,14,GGTATAAGAGAACATTCCTA,14,1832890
hyuA_predicted,0.6666666666666666,23,14,GGGTCGAGCACAATTTGCCC,9,1831671
hyuA_predicted,0.2,16,14,GGGTAGCTGCCACCGACTCG,2,1862374
hyuA_predicted,0.13333333333333333,15,14,GGGATTGGATCAATCAAGGA,1,1855154
hyuA_predicted,1.2666666666666666,32,14,GGAGGCGAAATAAGGCTAGT,18,1844114
hyuA_predicted,0.6666666666666666,23,14,GGAGCAGAAACGGGCTAGAA,9,1856832
hyuA_predicted,0.7333333333333333,24,14,GGAAGGGCGGTCATCTCTGG,10,1855035
hyuA_predicted,0.9333333333333333,27,14,GCTTGTTTGTTTGCCCCCGC,13,1852625
hyuA_predicted,0.3333333333333333,18,14,GCTGGGCTGTTCTTTCCATT,4,1862031
hyuA_predicted,1.4,34,14,GCTAGGTGTCATTTGTAGCA,20,1865887
hyuA_predicted,0.9333333333333333,27,14,GCGTGACATAACCTAGGGTA,13,1847345
hyuA_predicted,0.4666666666666667,20,14,GCCTATTAGGTGCCCCAGCC,6,1864544
hyuA_predicted,2.533333333333333,51,14,GCCCGTGACCGCTATCATGC,37,1873884
hyuA_predicted,0.3333333333333333,18,14,GCATTTTTATACAAAGCACT,4,1876534
hyuA_predicted,0.13333333333333333,15,14,GAGTTTCTAAGGACTCTGGC,1,1856619
hyuA_predicted,0.7333333333333333,24,14,GAGTGAGTCTCAGTCCGCTT,10,1839059
hyuA_predicted,2.8,55,14,GAGGCTTGTACGGTAAAGTC,41,1829320
hyuA_predicted,0.6666666666666666,23,14,GAGCAAGATATGTCGGGCCA,9,1861227
hyuA_predicted,0.13333333333333333,15,14,GACTTGAATGGGCAGGACTG,1,1845618
hyuA_predicted,2.1333333333333333,45,14,GAACTTTGCGCTAGAGGGTG,31,1829328
hyuA_predicted,0.26666666666666666,17,14,GAACGCGTATGCGTCCTCAT,3,1856604
hyuA_predicted,0.5333333333333333,21,14,GAAACTAGAAGTTATGTCAT,7,1837451
hyuA_predicted,0.7333333333333333,24,14,CTTGGGAGTTAACACACAGA,10,1863338
hyuA_predicted,0.3333333333333333,18,14,CTTCTTGCGAAACGTTAAGG,4,1857444
hyuA_predicted,0.6,22,14,CTTCGCGGTCAGCTTACTCG,8,1861672
hyuA_predicted,1.2,31,14,CTGTAGGCAGCATAGCTAGT,17,1829743
hyuA_predicted,0.4666666666666667,20,14,CTGCTCCCAGGCTTGTCTAT,6,1876478
hyuA_predicted,0.26666666666666666,17,14,CTCTTGCTTGGTTAGGGCAA,3,1863940
hyuA_predicted,0.13333333333333333,15,14,CTCTACTGTCCTTTGGCATG,1,1844633
hyuA_predicted,0.26666666666666666,17,14,CTCACCCGGGTCAAGGCTAG,3,1847388
hyuA_predicted,0.9333333333333333,27,14,CTATACTGGGATAGTTAATT,13,1874329
hyuA_predicted,0.26666666666666666,17,14,CGTCACTCTATAGCATACGA,3,1844373
hyuA_predicted,0.8666666666666667,26,14,CGTAAATTAGTAACATCCAA,12,1876031
hyuA_predicted,0.8,25,14,CGCCTTTCCTAGCCATTAGT,11,1838573
hyuA_predicted,0.6,22,14,CGCCTTCTGCCCTGCACTCA,8,1872995
hyuA_predicted,0.6,22,14,CGCAGAGGCCGGTAGAGTAT,8,1843819
hyuA_predicted,0.6,22,14,CGATACCTCGTTCAGTGGAA,8,1829373
hyuA_predicted,1.8666666666666667,41,14,CGACTCCCTAAGGTCACTCG,27,1836306
hyuA_predicted,1.1333333333333333,30,14,CGACCTGGGATAAGGAGGGT,16,1863930
hyuA_predicted,0.7333333333333333,24,14,CCTTACTGTTGTTGGGTTTG,10,1864720
hyuA_predicted,1.9333333333333333,42,14,CCGTCCCACTATTTTGTTCA,28,1843371
hyuA_predicted,2.066666666666667,44,14,CCATATCTACCTTAAGTAAT,30,1839955
hyuA_predicted,2.066666666666667,44,14,CCAGGTTATGGCCGATTGCA,30,1847578
hyuA_predicted,0.8666666666666667,26,14,CCAATTACTTGTACGGGGTC,12,1863424
hyuA_predicted,0.5333333333333333,21,14,CCAACCGGATTCTCTAAGAA,7,1842724
hyuA_predicted,0.13333333333333333,15,14,CAGACGATACGAAGTGCCAA,1,1831655
hyuA_predicted,2.2666666666666666,47,14,CACGTGTATCTTTTAGGCCA,33,1856073
hyuA_predicted,0.13333333333333333,15,14,CACGGCTGCAGATCTAAGCC,1,1855502
hyuA_predicted,1.7333333333333334,39,14,CAAGTATCTGTACCCAAAAG,25,1866618
hyuA_predicted,1.5333333333333334,36,14,ATGGTGTGGTAGCCATGAGT,22,1876632
hyuA_predicted,1.7333333333333334,39,14,ATGACAAGAACGTATGGAGT,25,1841850
hyuA_predicted,0.26666666666666666,17,14,ATAGTATATGTCAATAACGG,3,1845893
hyuA_predicted,0.4,19,14,AGTCTGGATCCACAGTATAA,5,1837843
hyuA_predicted,0.8666666666666667,26,14,AGCGTTTGGAGACACAGCCA,12,1852807
hyuA_predicted,0.7333333333333333,24,14,AGCGAGAATGGTAATCGAAA,10,1846886
hyuA_predicted,0.8666666666666667,26,14,AGATCTTACTCCGCGCTTCC,12,1848164
hyuA_predicted,1.2666666666666666,32,14,AGATCCTCGCGTGAAATTTT,18,1841914
hyuA_predicted,2.8,55,14,ACTACCGGAATGCTGGTTCA,41,1840939
hyuA_predicted,1.4666666666666666,35,14,ACAGGAGCCAGAAAACACTA,21,1848559
hyuA_predicted,2.066666666666667,44,14,ACACGATTGTTCTTTAGCCG,30,1859216
hyuA_predicted,0.4,19,14,ACACCCGGAACGCATGACAG,5,1853979
hyuA_predicted,1.0666666666666667,29,14,ACACAGCAGCGAGAAGCGTA,15,1871301
hyuA_predicted,0.2,16,14,AATTTACACGGAGTGCTTGC,2,1873775
hyuA_predicted,1.0666666666666667,29,14,AAGTTGTATAGTTCTTTTAA,15,1831891
hyuA_predicted,0.4666666666666667,20,14,AAGCAGTGTCTACGTTATCA,6,1842027
hyuA_predicted,1.0666666666666667,29,14,AACTCGGGGTCCCATCGTGA,15,1872716
hyuA_predicted,0.13333333333333333,15,14,AACTCAGACCTATTCTCCGG,1,1868957
hyuA_predicted,0.8666666666666667,26,14,AAACTGGCATCCGGGGATCC,12,1875276
hyuA_predicted,0.5714285714285714,20,13,TTTGCGGCGCATCGGGCGTG,7,1872411
hyuA_predicted,0.7142857142857143,22,13,TTTGAGGCTCGACCCCGTGA,9,1829523
hyuA_predicted,0.9285714285714286,25,13,TTGCAGGCCTGCAAGCCGTA,12,1839333
hyuA_predicted,0.6428571428571429,21,13,TTGCACCGGCGCATTCTGCA,8,1838774
hyuA_predicted,1.4285714285714286,32,13,TTGATTTCCACGATTTCGGA,19,1877565
hyuA_predicted,1.5714285714285714,34,13,TTGAGTAAAACTAATTCGGA,21,1870095
hyuA_predicted,0.8571428571428571,24,13,TTCTTGGGGCCGCTCCAGGT,11,1855334
hyuA_predicted,0.7142857142857143,22,13,TTCATAAGGCCACACGCGAT,9,1844676
hyuA_predicted,0.6428571428571429,21,13,TTACACCTGCGGATCCAGGG,8,1840950
hyuA_predicted,0.14285714285714285,14,13,TGTTTCTGTCAATGAGTCGG,1,1865023
hyuA_predicted,0.5,19,13,TGTGATTTGAGAAGCCGAAC,6,1876004
hyuA_predicted,0.9285714285714286,25,13,TGTCCCCTCATAATGCCGAT,12,1851225
hyuA_predicted,0.6428571428571429,21,13,TGGTTTCTCATAGCATCCGA,8,1847178
hyuA_predicted,0.42857142857142855,18,13,TGGATTCAAGCCTAATTTCC,5,1832848
hyuA_predicted,0.7142857142857143,22,13,TGGAGACCCATACAAGGAGG,9,1838773
hyuA_predicted,0.7857142857142857,23,13,TGCCTCCCGCGCGGCATCGT,10,1845709
hyuA_predicted,0.14285714285714285,14,13,TGAGGAACAGACGCGGCTTC,1,1863205
hyuA_predicted,0.21428571428571427,15,13,TGAGCAGCAAAGAGTTAATG,2,1860255
hyuA_predicted,2.5714285714285716,48,13,TGACGTACGTCTGCCGCTTC,35,1835778
hyuA_predicted,0.42857142857142855,18,13,TGAATGAGTACGCCCACGGT,5,1846246
hyuA_predicted,2.142857142857143,42,13,TCTTATGCATGTACTGGCGT,29,1843999
hyuA_predicted,2.642857142857143,49,13,TCGGACCATTAAAGACTCCC,36,1852611
hyuA_predicted,0.14285714285714285,14,13,TCGCCTTTGACCCGCGGCGT,1,1863558
hyuA_predicted,0.21428571428571427,15,13,TCGCCTAGGGCTGTGAACCA,2,1834655
hyuA_predicted,1.5714285714285714,34,13,TCGACAGAGAAAAATTTGCA,21,1839509
hyuA_predicted,0.5714285714285714,20,13,TCCGTTAACTACGGTGGCTT,7,1857202
hyuA_predicted,0.2857142857142857,16,13,TCCGAGGTGACGTCACCGTT,3,1842152
hyuA_predicted,0.35714285714285715,17,13,TCATGCGTCCGCCGGATATC,4,1841649
hyuA_predicted,0.8571428571428571,24,13,TATGACCGTGGCATGCCAGA,11,1834471
hyuA_predicted,0.7142857142857143,22,13,TAGCTCGTGGGAAGCCACAC,9,1862844
hyuA_predicted,2.9285714285714284,53,13,TAGCAACTCACGACGAAACA,40,1835663
hyuA_predicted,0.21428571428571427,15,13,TAGAAGAGACATCTGTGTAC,2,1835333
hyuA_predicted,2.142857142857143,42,13,TACTGGCTAGTGGACACGCT,29,1843622
hyuA_predicted,0.14285714285714285,14,13,TACCATGAGTATCACAGCAT,1,1854356
hyuA_predicted,0.14285714285714285,14,13,TACCAGTTATAACTCTGTCT,1,1869575
hyuA_predicted,0.35714285714285715,17,13,TAAGCTAGCTGTGGGCCAAC,4,1854949
hyuA_predicted,1.1428571428571428,28,13,TAACACTCCATCACGATGCA,15,1832044
hyuA_predicted,0.21428571428571427,15,13,GTTCATCCAAACGTACGATC,2,1840372
hyuA_predicted,1.0,26,13,GTTATTAAGTAGAGCTGCTA,13,1843501
hyuA_predicted,0.14285714285714285,14,13,GTGGGTCTTCGCGAACTTTA,1,1846830
hyuA_predicted,0.42857142857142855,18,13,GTCTTGCTGGCCCAGAATCA,5,1862366
hyuA_predicted,0.8571428571428571,24,13,GTCCGCTGACCGAGTTCTCA,11,1854312
hyuA_predicted,0.8571428571428571,24,13,GTCATGCTTCACTGTCACTG,11,1859464
hyuA_predicted,1.2857142857142858,30,13,GTACAAGTTCTGAGCGCGGT,17,1869906
hyuA_predicted,0.14285714285714285,14,13,GTAATCTATAATGTTCCTAA,1,1843395
hyuA_predicted,0.6428571428571429,21,13,GTAAAGTAGTGTCGTTCGAT,8,1837751
hyuA_predicted,0.9285714285714286,25,13,GGTTTTCCTTCATGCTCCAA,12,1876396
hyuA_predicted,0.7857142857142857,23,13,GGTCCCCGCTTCTCACTATG,10,1858217
hyuA_predicted,1.5714285714285714,34,13,GGTCAGTAGGCGGCAGGCTC,21,1841212
hyuA_predicted,2.142857142857143,42,13,GGTAGTCATTATTGGTCTAA,29,1847320
hyuA_predicted,0.5,19,13,GGTACGCACAAATGCGTCTG,6,1831145
hyuA_predicted,0.21428571428571427,15,13,GGGTCCTCTAGTCGATCCTT,2,1860259
hyuA_predicted,0.14285714285714285,14,13,GGGGGGGATCTTAAAACTAT,1,1833120
hyuA_predicted,0.8571428571428571,24,13,GGGGGCGGCTCGCCCTCTTG,11,1859441
hyuA_predicted,0.35714285714285715,17,13,GGGCACTTCATCGACAGGGA,4,1869805
hyuA_predicted,1.0,26,13,GGCTAAGCTTGCGAATGAGT,13,1848783
hyuA_predicted,2.2857142857142856,44,13,GGAGGGAAGAGGATGCGATT,31,1834012
hyuA_predicted,0.2857142857142857,16,13,GCTTCCAAATCACCGAGGTT,3,1845077
hyuA_predicted,0.35714285714285715,17,13,GCTGTCATGGCGGGGCTCGA,4,1833409
hyuA_predicted,0.21428571428571427,15,13,GCTGGCGCTATGATTCTATA,2,1876851
hyuA_predicted,1.0,26,13,GCTCGGAGGTTTCTAAACCT,13,1835212
hyuA_predicted,1.1428571428571428,28,13,GCCTCTACCAGCCTTAACCT,15,1845154
hyuA_predicted,1.0714285714285714,27,13,GCATTATTCGAGACCTCGTC,14,1859414
hyuA_predicted,0.5,19,13,GCAGAATCGGCTGGAATGTT,6,1851563
hyuA_predicted,0.5714285714285714,20,13,GCACTCGGAAATAACTTATT,7,1854912
hyuA_predicted,0.5714285714285714,20,13,GCAACTCTACCATCTGTCTC,7,1853935
hyuA_predicted,2.2142857142857144,43,13,GATGCTACTTAGTAGGACCA,30,1870064
hyuA_predicted,0.8571428571428571,24,13,GAGAAACGGAGCTATGTCAC,11,1850138
hyuA_predicted,2.4285714285714284,46,13,GACTCTGCAAGATAGCCGTC,33,1877403
hyuA_predicted,1.1428571428571428,28,13,GACTCGGTGTGGTCATAAAA,15,1872894
hyuA_predicted,0.9285714285714286,25,13,GACTCCTGGTTGTAATTCAG,12,1863027
hyuA_predicted,1.2857142857142858,30,13,GACCTGCAATAGCAACGAGT,17,1863207
hyuA_predicted,0.9285714285714286,25,13,GACCATTGTGAGAATTTCAC,12,1863900
hyuA_predicted,0.5714285714285714,20,13,GACAGTGTGAGCTTATCCCT,7,1864510
hyuA_predicted,2.7142857142857144,50,13,GAACTCCAAATACAGGTAGT,37,1848244
hyuA_predicted,0.5,19,13,GAACCAATTATATGTCGGCG,6,1850719
hyuA_predicted,0.5714285714285714,20,13,GAAAGTGCATTAAATCAGGA,7,1837184
hyuA_predicted,0.21428571428571427,15,13,GAAAGACGTTATAATAGACA,2,1875994
hyuA_predicted,4.5,75,13,CTTTCATCGTCCCCCCGTCT,62,1852566
hyuA_predicted,0.2857142857142857,16,13,CTGGAAGTAGAAAATCCATT,3,1858266
hyuA_predicted,1.5714285714285714,34,13,CTGGAACGTAAGAGAACGTT,21,1841499
hyuA_predicted,1.0,26,13,CTGCGCTTATTTGGGCCTGT,13,1876077
hyuA_predicted,1.2142857142857142,29,13,CTGAGGCCGTTACACATAGG,16,1839821
hyuA_predicted,1.0714285714285714,27,13,CTGAATACGTCCTGGCGTGG,14,1856945
hyuA_predicted,0.14285714285714285,14,13,CTGAAGGAGTTCGCCAAGCT,1,1860601
hyuA_predicted,1.5,33,13,CTGAACATGCGGTTTGACGA,20,1838147
hyuA_predicted,0.7142857142857143,22,13,CTCTCAAATCGGTTGTCTCG,9,1844422
hyuA_predicted,2.2142857142857144,43,13,CTCGCAGCCCTCCGTAATGA,30,1846268
hyuA_predicted,1.0,26,13,CTCGAATAAATACCCGGGTT,13,1849551
hyuA_predicted,0.6428571428571429,21,13,CTCCGGGTTTCAGGCCAAAC,8,1832357
hyuA_predicted,1.4285714285714286,32,13,CTCCCAGAACCCTGGCCAGC,19,1855163
hyuA_predicted,0.6428571428571429,21,13,CTCACGCCAAACCGATGAAC,8,1834297
hyuA_predicted,1.5,33,13,CTCAAAGTTGGAACGGCGTG,20,1857032
hyuA_predicted,2.2857142857142856,44,13,CTATGCTCGTGTCATTGACA,31,1841868
hyuA_predicted,0.5714285714285714,20,13,CTAGATTACAGGCTTGCGGT,7,1857512
hyuA_predicted,0.6428571428571429,21,13,CTACTGGCTTTGCACGGACC,8,1860796
hyuA_predicted,0.42857142857142855,18,13,CGTTGTCCCACTTTTTTCAC,5,1855825
hyuA_predicted,0.21428571428571427,15,13,CGTCGCTCATCATGCGGAGC,2,1853459
hyuA_predicted,1.4285714285714286,32,13,CGGGGCCTAACCTAACTTGT,19,1848052
hyuA_predicted,3.142857142857143,56,13,CGGCTACGGTACTCCCTTTA,43,1836627
hyuA_predicted,1.6428571428571428,35,13,CGGCGTTGCGCAGGCATACG,22,1840244
hyuA_predicted,1.0714285714285714,27,13,CGGAGTCCCTTCGAAGGCAT,14,1869144
hyuA_predicted,0.7857142857142857,23,13,CGCTAGTATCATTGATCTCT,10,1864628
hyuA_predicted,0.2857142857142857,16,13,CGCGGGAAAATGACCTTAAT,3,1833012
hyuA_predicted,0.14285714285714285,14,13,CGCACTGTTCTATCACGAGT,1,1865734
hyuA_predicted,0.14285714285714285,14,13,CGCAATAAGTAACTCCTTGG,1,1852951
hyuA_predicted,0.7857142857142857,23,13,CGAGTCGGAAGGCCACTCGG,10,1848986
hyuA_predicted,1.1428571428571428,28,13,CGACGACACATACAAGGTTT,15,1856304
hyuA_predicted,1.1428571428571428,28,13,CCTTGGGAGAGTTGCTCGAA,15,1858672
hyuA_predicted,1.5714285714285714,34,13,CCTTGACGAGAACGCAGATT,21,1842211
hyuA_predicted,4.0,68,13,CCTCCTATGAAAGTTCAAGG,55,1840892
hyuA_predicted,0.35714285714285715,17,13,CCTAGTTTCCGCCTTCAATT,4,1863353
hyuA_predicted,1.5714285714285714,34,13,CCCTGGTCACCGGTCGGAAG,21,1861718
hyuA_predicted,2.2857142857142856,44,13,CCCGTCCAACCTAGTACCTG,31,1838045
hyuA_predicted,0.9285714285714286,25,13,CCCCCCAGGTACTGGGACAT,12,1840955
hyuA_predicted,1.5,33,13,CCCCAGCGCCTCAGACGGTC,20,1830904
hyuA_predicted,1.7857142857142858,37,13,CCAGGTCCACCCACGGAATG,24,1830545
hyuA_predicted,0.35714285714285715,17,13,CCACGGGTTGTTGTGTAATA,4,1873134
hyuA_predicted,2.0714285714285716,41,13,CCAACCAGGAGGTATTCTTG,28,1857990
hyuA_predicted,1.0,26,13,CATTCTATCAGCCCTGCGGT,13,1835082
hyuA_predicted,0.2857142857142857,16,13,CATGTCCTTCAAACTCCTAT,3,1874996
hyuA_predicted,0.5,19,13,CATGTCCGCACGCTACAGCA,6,1866687
hyuA_predicted,0.7857142857142857,23,13,CATGCCCCATGGGACGGCGG,10,1850951
hyuA_predicted,0.14285714285714285,14,13,CATGAATATGCTTTCCGCTA,1,1847574
hyuA_predicted,1.2857142857142858,30,13,CATCGACTTTGGGTCCTTCT,17,1867552
hyuA_predicted,0.35714285714285715,17,13,CATATAGTTGGGGTGGACCA,4,1867308
hyuA_predicted,2.7857142857142856,51,13,CATACCTGTTGTAATCTTTC,38,1854383
hyuA_predicted,0.5714285714285714,20,13,CAGGGGTATCACGCGACAGA,7,1845826
hyuA_predicted,2.357142857142857,45,13,CAGCCGGCGTTGAGAGGGCA,32,1840075
hyuA_predicted,4.214285714285714,71,13,CACAGGAGGTAGTGGTGAAG,58,1860041
hyuA_predicted,0.21428571428571427,15,13,CAATCAGTGTGGTTCAGAGC,2,1835373
hyuA_predicted,0.7857142857142857,23,13,CAACGGGTCTGTTGGCCCCA,10,1846227
hyuA_predicted,0.35714285714285715,17,13,CAAATCAAGGGGAAGGATCC,4,1872712
hyuA_predicted,0.21428571428571427,15,13,CAAACTCCATAAGTTTAAAA,2,1862172
hyuA_predicted,1.5714285714285714,34,13,ATTTGCTTAGCGAAGATTTG,21,1861613
hyuA_predicted,1.5,33,13,ATTGCGGATTGAATATTTTA,20,1861295
hyuA_predicted,0.14285714285714285,14,13,ATTCGGAGAAGCCACATGGA,1,1840988
hyuA_predicted,1.0,26,13,ATGGATTTGGAATTTGCACT,13,1863509
hyuA_predicted,1.9285714285714286,39,13,ATGATTACATCGGTGGAGTC,26,1832519
hyuA_predicted,1.3571428571428572,31,13,ATCCTTGGATTCACGAGTAT,18,1859693
hyuA_predicted,1.3571428571428572,31,13,ATCATATCGGTGGTTCCACA,18,1845863
hyuA_predicted,1.2857142857142858,30,13,ATACCAGCAGCAATTACCTT,17,1860703
hyuA_predicted,4.214285714285714,71,13,ATACAGACTGGTAATCATAA,58,1877671
hyuA_predicted,0.2857142857142857,16,13,ATAACTGCGAGGTTTGGAAA,3,1862536
hyuA_predicted,2.0714285714285716,41,13,AGTAGCGCATCACTCAAGAG,28,1838680
hyuA_predicted,0.2857142857142857,16,13,AGGAATTAGATAGCCCGGAG,3,1846372
hyuA_predicted,0.14285714285714285,14,13,AGCTGTGGACGCTCCAGCAA,1,1848463
hyuA_predicted,0.6428571428571429,21,13,AGCTACGTCCTGCCCGCCAG,8,1863448
hyuA_predicted,1.5714285714285714,34,13,AGCGTCTGCGAGAGCTGTAA,21,1848287
hyuA_predicted,1.7142857142857142,36,13,AGCAATGTGAATGTAAAGAA,23,1833402
hyuA_predicted,1.1428571428571428,28,13,AGCAACCTTTCCTCGAAAAA,15,1845683
hyuA_predicted,0.14285714285714285,14,13,AGACGGGGTCCATACCCGAA,1,1877060
hyuA_predicted,0.5,19,13,ACTGCCAGAAGATCATTATC,6,1850045
hyuA_predicted,0.5714285714285714,20,13,ACATGAGGAATTTACGCTGA,7,1860134
hyuA_predicted,1.3571428571428572,31,13,ACAGAGAACTCAAAGATCAT,18,1860814
hyuA_predicted,0.2857142857142857,16,13,ACACTCAAATACATCAAAAT,3,1829720
hyuA_predicted,0.21428571428571427,15,13,AATGTTCCTCACTGCAGGCT,2,1862491
hyuA_predicted,1.1428571428571428,28,13,AAGTATCTAACCAGAACATT,15,1841015
hyuA_predicted,0.14285714285714285,14,13,AAGTACTCGCACAAAATCAG,1,1876606
hyuA_predicted,0.2857142857142857,16,13,AAGGTTTTCCGGTACATTTA,3,1839453
hyuA_predicted,0.5714285714285714,20,13,AAGCGTTCCATTATCCGAGT,7,1839592
hyuA_predicted,1.7857142857142858,37,13,AACTGCTATTCCACAAAGCC,24,1843915
hyuA_predicted,0.14285714285714285,14,13,AACTCCGCGTGCAGCGGTTG,1,1860166
hyuA_predicted,0.14285714285714285,14,13,AAATAATGGGGCCGTCGGCT,1,1871665
hyuA_predicted,0.46153846153846156,17,12,TTTAATGTCGCAACTCCTGT,5,1841435
hyuA_predicted,0.6923076923076923,20,12,TTGTATGAGTTGTGGGAACA,8,1862596
hyuA_predicted,0.6923076923076923,20,12,TTGGGTTGAGTGAGGCGTTA,8,1862442
hyuA_predicted,0.6153846153846154,19,12,TTGCGATGTTAACGCATCAA,7,1850470
hyuA_predicted,0.15384615384615385,13,12,TTCGCCTACGAGAGGGTCAT,1,1873535
hyuA_predicted,2.1538461538461537,39,12,TTCGAGTCCGATACATCTTG,27,1847019
hyuA_predicted,3.769230769230769,60,12,TTCCGGGTTTTAACAGCAAG,48,1840228
hyuA_predicted,2.6153846153846154,45,12,TTCAAGTGCAGTTTCTTCGA,33,1841404
hyuA_predicted,0.9230769230769231,23,12,TTATGCCAATCCCTAACTTC,11,1863534
hyuA_predicted,1.4615384615384615,30,12,TTAGTCCGCCCGACCGGCAA,18,1856546
hyuA_predicted,1.0,24,12,TTAGGTGTCCGTTATTATGG,12,1837836
hyuA_predicted,0.7692307692307693,21,12,TGTTGACAATATGACGCCCC,9,1853676
hyuA_predicted,2.076923076923077,38,12,TGGTACGATCATCGATGCAA,26,1848407
hyuA_predicted,2.0,37,12,TGGCTCAGACAATCAGGGAA,25,1849164
hyuA_predicted,3.230769230769231,53,12,TGCGGTTCAATTATAGGCCC,41,1831064
hyuA_predicted,0.15384615384615385,13,12,TGCCTAACCGAGCCATTTGG,1,1859365
hyuA_predicted,0.15384615384615385,13,12,TGCCGGTTGTGTCCTTGGTC,1,1838373
hyuA_predicted,1.2307692307692308,27,12,TGACAAGCCCCCAAAAGCCT,15,1853534
hyuA_predicted,2.076923076923077,38,12,TCTGCTGGTGGTATGGTAGT,26,1867782
hyuA_predicted,1.6923076923076923,33,12,TCCTGACTTCTATATGACGT,21,1867293
hyuA_predicted,0.38461538461538464,16,12,TCCGTCAGGCTTCTCGGAAT,4,1849044
hyuA_predicted,1.0769230769230769,25,12,TCCGAGGACACGGTATCCCC,13,1866364
hyuA_predicted,1.7692307692307692,34,12,TCAAGTGCGACTATTGCGTA,22,1833127
hyuA_predicted,0.23076923076923078,14,12,TCAAAGCGCATATGCGCTTC,2,1852361
hyuA_predicted,0.7692307692307693,21,12,TATCATCGTTTTCTCCCTAA,9,1868125
hyuA_predicted,1.2307692307692308,27,12,TAGGACTCTTATACTAAGGT,15,1867807
hyuA_predicted,0.6153846153846154,19,12,TAGCATTCAGTTACGCTAAT,7,1833369
hyuA_predicted,1.3076923076923077,28,12,TACGTAAGTTTACAGCTCAG,16,1849043
hyuA_predicted,0.15384615384615385,13,12,TACGCGTTACGTACGACAAT,1,1843075
hyuA_predicted,0.23076923076923078,14,12,TAATCCTCCTGGGCTGGGTG,2,1838869
hyuA_predicted,0.15384615384615385,13,12,TAAACTATCGTCTTCAACAC,1,1849900
hyuA_predicted,0.23076923076923078,14,12,GTTCTCTCTTCTCCGGTCGT,2,1828985
hyuA_predicted,0.15384615384615385,13,12,GTTAAGCTCGGGCCAGCGAT,1,1851901
hyuA_predicted,0.23076923076923078,14,12,GTGATTAAGCATTGTTCTAA,2,1835650
hyuA_predicted,0.7692307692307693,21,12,GTGAGTCTAAAAAGGAATGG,9,1863451
hyuA_predicted,0.38461538461538464,16,12,GTCGCGTAGAGCCTTGGCGT,4,1843261
hyuA_predicted,1.4615384615384615,30,12,GTCCCGACGTATCGACTAGC,18,1865420
hyuA_predicted,0.3076923076923077,15,12,GTCAGGTTCACGGCACACCT,3,1863813
hyuA_predicted,0.15384615384615385,13,12,GTCACTAGGGACGCCGAAAA,1,1838033
hyuA_predicted,0.23076923076923078,14,12,GTAGGCCTGAGTAGAAGAGA,2,1852030
hyuA_predicted,1.6923076923076923,33,12,GTAAATTCCGGGGCGAAGAA,21,1854481
hyuA_predicted,0.15384615384615385,13,12,GGTTACGCACTGTCGGTACT,1,1861317
hyuA_predicted,0.23076923076923078,14,12,GGTGTCACCGTGTTGCGGTC,2,1849609
hyuA_predicted,0.15384615384615385,13,12,GGTAACTTAGTAGGGCCGAT,1,1840378
hyuA_predicted,1.2307692307692308,27,12,GGGCTGAGTTGCACTTTATC,15,1863398
hyuA_predicted,2.1538461538461537,39,12,GGGCGGTGTGGTCTATGTGC,27,1860799
hyuA_predicted,1.5384615384615385,31,12,GGGCCTCCCCCGTTATATGG,19,1836601
hyuA_predicted,2.8461538461538463,48,12,GGCGGGACCGTAGCTCGAGA,36,1829833
hyuA_predicted,2.769230769230769,47,12,GGCAACTAAAAGGCTTGACA,35,1858059
hyuA_predicted,0.15384615384615385,13,12,GGATCATATATTATAGCATT,1,1829683
hyuA_predicted,0.5384615384615384,18,12,GGAGGGTTGGTATTTCAGAA,6,1845252
hyuA_predicted,3.5384615384615383,57,12,GGAGCTTGGCGGTAGAGCTA,45,1874577
hyuA_predicted,0.38461538461538464,16,12,GGACGGTCTGCGGAACTCCC,4,1855320
hyuA_predicted,0.6153846153846154,19,12,GGAATATGATCAGTCCTGAT,7,1829876
hyuA_predicted,0.15384615384615385,13,12,GCTTTGTGTTCCCGCGGCTC,1,1838325
hyuA_predicted,0.23076923076923078,14,12,GCTCTATGTCTCCGGTTACA,2,1842243
hyuA_predicted,1.4615384615384615,30,12,GCTAAAGTTTGTCCAATAGA,18,1833263
hyuA_predicted,1.9230769230769231,36,12,GCGGGGAAAGGGATCCGTTC,24,1829443
hyuA_predicted,2.923076923076923,49,12,GCCGGGTGGCGTGATAAAGA,37,1862048
hyuA_predicted,0.23076923076923078,14,12,GCCAAACCATAGTCCATAAT,2,1845201
hyuA_predicted,0.38461538461538464,16,12,GCATCATCGTCCGTGCTGCC,4,1857395
hyuA_predicted,0.46153846153846156,17,12,GCACCGCTGTCGTAACCAAG,5,1856043
hyuA_predicted,2.923076923076923,49,12,GATTTGCGTAGTACCCTGCA,37,1845961
hyuA_predicted,0.15384615384615385,13,12,GATGTAGCCGACGTACGTCT,1,1846439
hyuA_predicted,0.46153846153846156,17,12,GATGCTTACATGGCATGATA,5,1862610
hyuA_predicted,0.15384615384615385,13,12,GATCATGTCTGCGGCCCAAG,1,1845140
hyuA_predicted,0.6923076923076923,20,12,GATAACGCTCCGCACGACAC,8,1830167
hyuA_predicted,0.23076923076923078,14,12,GAGTAGAATTCAAATTATCT,2,1860256
hyuA_predicted,1.3076923076923077,28,12,GAGGCTCGGCGTGAGTGAAA,16,1834992
hyuA_predicted,0.6153846153846154,19,12,GAGAAGATCAGTATAGGGCT,7,1869569
hyuA_predicted,0.15384615384615385,13,12,GACTCATGGCTGAATTTCGT,1,1854089
hyuA_predicted,2.0,37,12,GACTCACTTATACTAGAATG,25,1853981
hyuA_predicted,0.15384615384615385,13,12,GAAGTACGCGCTGTTGAACG,1,1861466
hyuA_predicted,0.6923076923076923,20,12,GAACTTGTCATATGATCCGG,8,1854529
hyuA_predicted,2.6153846153846154,45,12,CTTCGGTCATGGCGCTGCAT,33,1862546
hyuA_predicted,0.23076923076923078,14,12,CTTCAGTAGGGCAGTACCGC,2,1860381
hyuA_predicted,1.0,24,12,CTTAAGTGTCGAAAGCCTTT,12,1857583
hyuA_predicted,1.0769230769230769,25,12,CTGGGTGACGTTGAGCCCGA,13,1831118
hyuA_predicted,0.38461538461538464,16,12,CTGGGCGCATTCAAGGCACT,4,1845907
hyuA_predicted,3.4615384615384617,56,12,CTGGCGGTACAGGGAGTAGA,44,1835808
hyuA_predicted,1.2307692307692308,27,12,CTCCTTGAAGTACAATTAGT,15,1851729
hyuA_predicted,0.6923076923076923,20,12,CTCCGTCGGATGTAAATGTG,8,1846556
hyuA_predicted,0.7692307692307693,21,12,CTCATTGGCTATAACCGTGA,9,1839149
hyuA_predicted,0.15384615384615385,13,12,CTCACTTATCCAGCGCCTCA,1,1837494
hyuA_predicted,0.23076923076923078,14,12,CGTGGGTTCATCTGGAATGT,2,1849291
hyuA_predicted,1.5384615384615385,31,12,CGTCTGAGACCAACGTATAT,19,1858604
hyuA_predicted,1.9230769230769231,36,12,CGTCGTACACAACCTAATGG,24,1830495
hyuA_predicted,0.7692307692307693,21,12,CGTCGGTCCCTTCGTAGCCT,9,1842518
hyuA_predicted,0.7692307692307693,21,12,CGGCCTGGGGAGCAATCAAA,9,1848171
hyuA_predicted,1.8461538461538463,35,12,CGGATACGCCCTAATTTCAT,23,1860293
hyuA_predicted,0.3076923076923077,15,12,CGGAGCGATTTTCTAAGGTC,3,1852969
hyuA_predicted,2.230769230769231,40,12,CGCGGCGAACAGATGGAGCT,28,1874916
hyuA_predicted,0.15384615384615385,13,12,CGCATCTCTTTGGGGGAAAT,1,1866326
hyuA_predicted,1.5384615384615385,31,12,CGATGCTATCATCACGGCGT,19,1852614
hyuA_predicted,0.23076923076923078,14,12,CGAGGGCCGGCATACGCTGG,2,1845396
hyuA_predicted,1.0769230769230769,25,12,CGAGGGACGTGGCTCTCTCA,13,1838260
hyuA_predicted,0.8461538461538461,22,12,CGACTCATCATGAGGACAGC,10,1846758
hyuA_predicted,1.1538461538461537,26,12,CGACGTTGTAGCCAGACGCA,14,1847619
hyuA_predicted,1.1538461538461537,26,12,CGAAGTTTATATAATCGCCT,14,1860881
hyuA_predicted,1.2307692307692308,27,12,CCTTACACTGTCCCATAGAA,15,1864594
hyuA_predicted,0.23076923076923078,14,12,CCGTTGTGGGTGTCGCATAT,2,1851184
hyuA_predicted,0.6923076923076923,20,12,CCGATGACGCCCAATAAGGC,8,1874286
hyuA_predicted,0.15384615384615385,13,12,CCCTAAGATGGAGTAAATGT,1,1834947
hyuA_predicted,0.6153846153846154,19,12,CCCAACTCGCACTACGTATT,7,1852092
hyuA_predicted,0.15384615384615385,13,12,CCACCGTGGGTGGGCCGACA,1,1834948
hyuA_predicted,1.0769230769230769,25,12,CATCGCTAGTAGGAGCCAAC,13,1855794
hyuA_predicted,0.7692307692307693,21,12,CATCAGCGTCGTATGCTTCA,9,1847245
hyuA_predicted,0.23076923076923078,14,12,CATATGATGCACCATAAACT,2,1857124
hyuA_predicted,1.6923076923076923,33,12,CAGTGGCAGAGTTGACTTGA,21,1836214
hyuA_predicted,0.46153846153846156,17,12,CAGTCCCGGGTAGGCTTAAC,5,1830446
hyuA_predicted,2.0,37,12,CAGTCACGTGTCAGTATGAC,25,1847415
hyuA_predicted,0.8461538461538461,22,12,CAGGGATGGTACAACGGGGG,10,1861380
hyuA_predicted,0.15384615384615385,13,12,CAGCTGAGAATAGTTTAAGG,1,1863814
hyuA_predicted,0.46153846153846156,17,12,CAGACAGCCCACACTAGCGA,5,1843133
hyuA_predicted,0.38461538461538464,16,12,CACTCGGCGAACGATTGTGC,4,1837208
hyuA_predicted,2.3076923076923075,41,12,CACGCTGAGCCATCTAGAAG,29,1839037
hyuA_predicted,2.6153846153846154,45,12,CACCACTACGACTAATGTTC,33,1834178
hyuA_predicted,0.3076923076923077,15,12,CAATCGATATTGCTAGGGAC,3,1846240
hyuA_predicted,0.8461538461538461,22,12,CAAGGATAATAATGACGATC,10,1844345
hyuA_predicted,4.0,63,12,CAAACTTCTGGCTTGGCAAA,51,1861626
hyuA_predicted,0.3076923076923077,15,12,ATTTAAGTTTCCTCATTAGC,3,1857597
hyuA_predicted,0.6923076923076923,20,12,ATTCGTGTCGTCTGGCCTGA,8,1855595
hyuA_predicted,0.3076923076923077,15,12,ATTCGAACCACAAACTTTCC,3,1874514
hyuA_predicted,1.5384615384615385,31,12,ATGGGAACTCGAGGTTCGCT,19,1877417
hyuA_predicted,0.46153846153846156,17,12,ATCCTGCTTGTGTGTTGCGT,5,1872354
hyuA_predicted,1.2307692307692308,27,12,ATCATTGCCAGACTACGTCA,15,1851007
hyuA_predicted,1.0769230769230769,25,12,ATATGTTAGGGGGTCGGGAC,13,1855551
hyuA_predicted,1.6153846153846154,32,12,ATACCTGTGGAGCTGTTACG,20,1847092
hyuA_predicted,0.23076923076923078,14,12,AGTGGCCTATAGAGGAATAA,2,1862109
hyuA_predicted,0.15384615384615385,13,12,AGTACCTGCTCGGATACCAT,1,1867184
hyuA_predicted,0.6923076923076923,20,12,AGGTGGGACACTGTGAACCA,8,1837344
hyuA_predicted,0.3076923076923077,15,12,AGGGGCCGATCCAGGTGTGC,3,1840579
hyuA_predicted,0.15384615384615385,13,12,AGGGACCGATAGCCAACCGA,1,1871597
hyuA_predicted,0.23076923076923078,14,12,AGCACTTAATGTCCCGTATA,2,1861768
hyuA_predicted,1.1538461538461537,26,12,AGATTGCGCAAGAGCCTGGC,14,1838776
hyuA_predicted,0.15384615384615385,13,12,AGAGTGGACATTACGTCAGA,1,1835741
hyuA_predicted,1.3846153846153846,29,12,AGAGCTCTGCCTATCAGCTG,17,1871707
hyuA_predicted,2.230769230769231,40,12,ACTTTGACTGTTTGCGACAG,28,1865326
hyuA_predicted,1.0769230769230769,25,12,ACTTGGACTCTGCCCGCCGA,13,1862587
hyuA_predicted,0.23076923076923078,14,12,ACTGCGCAGACGATGCTCTG,2,1839249
hyuA_predicted,0.46153846153846156,17,12,ACTGAGAATCTGATGGGTGA,5,1845971
hyuA_predicted,0.3076923076923077,15,12,ACTATAAGAAGCTGGCTTCG,3,1832499
hyuA_predicted,2.230769230769231,40,12,ACGCACAACTGACTTTCTTA,28,1872986
hyuA_predicted,0.38461538461538464,16,12,ACCTCAGCCCATGAGGAAAA,4,1852388
hyuA_predicted,1.7692307692307692,34,12,ACCGTGTGGGCTTTTATCAT,22,1868268
hyuA_predicted,0.38461538461538464,16,12,ACATAGCCCCAAATTGCGCG,4,1840459
hyuA_predicted,3.076923076923077,51,12,ACACCTACCCTGTTCCCCAT,39,1870747
hyuA_predicted,0.9230769230769231,23,12,ACAAAATGACGCTGTTGTTA,11,1874674
hyuA_predicted,0.15384615384615385,13,12,AATGGATACGGTCTCCACGA,1,1853530
hyuA_predicted,1.1538461538461537,26,12,AATCCCATAATTTAAACTAT,14,1833011
hyuA_predicted,2.230769230769231,40,12,AATACAGCCGACTAACTGTG,28,1864006
hyuA_predicted,0.46153846153846156,17,12,AAGTTGACACAAACAGCAAC,5,1830037
hyuA_predicted,1.3076923076923077,28,12,AACCCATCGGTGTGAGCTGC,16,1836150
hyuA_predicted,1.3846153846153846,29,12,AAATGTTTCCTCCGTTCACA,17,1868165
hyuA_predicted,1.1538461538461537,26,12,AAATACCATCACCCAGAATT,14,1848394
hyuA_predicted,0.3333333333333333,14,11,TTTTTTTCACAAAGACGCTA,3,1845018
hyuA_predicted,0.5,16,11,TTTTTAGTAAGTTTGTTTAT,5,1834573
hyuA_predicted,1.1666666666666667,24,11,TTTTTACACCATCTGGCCTC,13,1877130
hyuA_predicted,0.8333333333333334,20,11,TTTTCAATCTAATACGTTTG,9,1841232
hyuA_predicted,0.75,19,11,TTTTACTGGAGACCTTGGCA,8,1857921
hyuA_predicted,0.16666666666666666,12,11,TTTGGGATACTACTCAATCG,1,1849517
hyuA_predicted,0.9166666666666666,21,11,TTTAGGACTCCTTGGACTCG,10,1849116
hyuA_predicted,0.3333333333333333,14,11,TTTAAACGCTACTTCGCTAA,3,1869105
hyuA_predicted,0.5,16,11,TTGTGATCCCGAGAAGGTGT,5,1839397
hyuA_predicted,1.8333333333333333,32,11,TTCCTCCGCCTTCTGTTACT,21,1867240
hyuA_predicted,1.1666666666666667,24,11,TTCCGTTCCCCCACTTCGAA,13,1847343
hyuA_predicted,0.4166666666666667,15,11,TTCACGGATGACAGCTTCCT,4,1854938
hyuA_predicted,0.6666666666666666,18,11,TTAGTCCGATTGGTACCAGT,7,1833420
hyuA_predicted,0.25,13,11,TGTTTCACTGTGGCATGATC,2,1858369
hyuA_predicted,0.16666666666666666,12,11,TGTTAGAAACAAACACTTGT,1,1836916
hyuA_predicted,0.3333333333333333,14,11,TGTGCTGGTACCGGTAGCCA,3,1853160
hyuA_predicted,1.3333333333333333,26,11,TGTCGTGACCGCAAAGGAAG,15,1835130
hyuA_predicted,1.0833333333333333,23,11,TGTAGGGGTTCAATGTACAT,12,1875855
hyuA_predicted,1.5,28,11,TGGTTACGACGACAACGCCA,17,1868253
hyuA_predicted,3.9166666666666665,57,11,TGGGACGGGCACTCTGATGA,46,1873310
hyuA_predicted,5.083333333333333,71,11,TGCTGTTACGATCCGCGTCA,60,1833756
hyuA_predicted,2.25,37,11,TGCGTAAACTTAAGCATGAC,26,1845617
hyuA_predicted,1.25,25,11,TGACCCGATATGGTTGTTAA,14,1841598
hyuA_predicted,2.0,34,11,TGAATGTTTCGATACCAATA,23,1848074
hyuA_predicted,0.16666666666666666,12,11,TCTCTCGTGCCGTATGTGTT,1,1855153
hyuA_predicted,0.9166666666666666,21,11,TCTACTCGAATCACGAACTG,10,1835220
hyuA_predicted,0.8333333333333334,20,11,TCGCTATAGGGCCTCGTCCG,9,1861299
hyuA_predicted,0.16666666666666666,12,11,TCCTGGGCTGGAACCCTCCA,1,1853598
hyuA_predicted,1.0833333333333333,23,11,TCCAGCCACCGTAAGCCCGC,12,1838918
hyuA_predicted,1.5,28,11,TCATACAAGAGCCAGTGTAT,17,1843873
hyuA_predicted,0.4166666666666667,15,11,TCAGATGTACTTCGGCACAC,4,1852326
hyuA_predicted,0.4166666666666667,15,11,TCAGAGATGACCCTCTCCTG,4,1839854
hyuA_predicted,0.4166666666666667,15,11,TATGAAGTGTTTCCTCATAT,4,1853597
hyuA_predicted,2.0833333333333335,35,11,TATCCGATAAGAAACGCTTA,24,1854530
hyuA_predicted,0.3333333333333333,14,11,TATCAGAGAGTTATGGGGTC,3,1841393
hyuA_predicted,3.5833333333333335,53,11,TATATCGCTCCTATATTCCT,42,1873910
hyuA_predicted,1.6666666666666667,30,11,TAGAGGGGTCGGTGCATGTA,19,1872819
hyuA_predicted,0.8333333333333334,20,11,TACTATGCACGACAAACAGC,9,1842535
hyuA_predicted,0.16666666666666666,12,11,TACGTTCCACATATCTTCCC,1,1854083
hyuA_predicted,0.25,13,11,TACACGCAATGCACCTCGTG,2,1873153
hyuA_predicted,1.8333333333333333,32,11,TAATGGTGAGCCCCAGTATA,21,1851869
hyuA_predicted,1.75,31,11,TAAGCGCCCCTAACCTTACA,20,1846595
hyuA_predicted,0.25,13,11,TAACCGTTCCGTCCTAAAGG,2,1837405
hyuA_predicted,0.4166666666666667,15,11,GTTTTGTAATAGTTGTGTTT,4,1845935
hyuA_predicted,1.25,25,11,GTTGGTGATCAATGTCCAAG,14,1829682
hyuA_predicted,1.6666666666666667,30,11,GTTCATCAGACCACCAACTG,19,1874970
hyuA_predicted,1.1666666666666667,24,11,GTGTGGTCCATTCCGCTTAC,13,1829101
hyuA_predicted,1.3333333333333333,26,11,GTGAGTCGTACTTAGGATGT,15,1866735
hyuA_predicted,0.3333333333333333,14,11,GTCTTACCATAACCCGAGGG,3,1872061
hyuA_predicted,1.0,22,11,GTCTGGGTGCGCGCTTGGCG,11,1851360
hyuA_predicted,1.9166666666666667,33,11,GTCCACGAGGTCTTCGAAAG,22,1870098
hyuA_predicted,0.16666666666666666,12,11,GTCACTTGATGTAACTGATG,1,1847620
hyuA_predicted,0.25,13,11,GTAGCAATCAGTAAGCGCCC,2,1863208
hyuA_predicted,0.16666666666666666,12,11,GTAAGCGGTTCAACCCACTG,1,1842448
hyuA_predicted,1.0833333333333333,23,11,GGTTTGGTTCATTAAGTAAG,12,1851693
hyuA_predicted,1.0833333333333333,23,11,GGTTATGCACTCCGTTGAAG,12,1835129
hyuA_predicted,1.5833333333333333,29,11,GGTCTATACACTCCCAACCA,18,1863677
hyuA_predicted,1.1666666666666667,24,11,GGTCGATTCTAACTAGATAC,13,1856857
hyuA_predicted,0.25,13,11,GGTCGAGGATTGCGTATACC,2,1859147
hyuA_predicted,3.9166666666666665,57,11,GGGTATAATTCATTGCTTGC,46,1834669
hyuA_predicted,1.9166666666666667,33,11,GGGTAATGCTTCTGCAAAGA,22,1865890
hyuA_predicted,0.4166666666666667,15,11,GGGGTTTCAGCCGAGTAACG,4,1848935
hyuA_predicted,0.75,19,11,GGGCGTCAGCGTTACGGTTG,8,1846942
hyuA_predicted,2.0833333333333335,35,11,GGCGTGTTACTTTCACATAG,24,1847829
hyuA_predicted,1.25,25,11,GGCGATCATCTGGTGGAAGT,14,1841327
hyuA_predicted,0.25,13,11,GGCCCCTATCAGAGCGTCGA,2,1835418
hyuA_predicted,0.25,13,11,GGCAATGCAGGCCGAATCAA,2,1874453
hyuA_predicted,2.3333333333333335,38,11,GGATAGGTGAACGCCAGTGT,27,1857105
hyuA_predicted,2.4166666666666665,39,11,GGAAATACGCAGCATGATGT,28,1853369
hyuA_predicted,0.4166666666666667,15,11,GCTGGTCGCTGATAATTCGT,4,1841320
hyuA_predicted,2.75,43,11,GCTGGGGGGGATGGTTGGGG,32,1829042
hyuA_predicted,0.16666666666666666,12,11,GCTGCTGCCCTCGATTCAGA,1,1830341
hyuA_predicted,0.3333333333333333,14,11,GCTCGTTGGTCATGTCCGTT,3,1869980
hyuA_predicted,1.0,22,11,GCTATACGCACGGTTTGTAA,11,1872171
hyuA_predicted,0.5833333333333334,17,11,GCTACTTCCGGTGGGACAGA,6,1866891
hyuA_predicted,0.16666666666666666,12,11,GCGTAGATGCTGCCTGCGGG,1,1830129
hyuA_predicted,0.5,16,11,GCGGTTACAAGGGAATAAGC,5,1844801
hyuA_predicted,0.6666666666666666,18,11,GCGCGAAAGGCCTCGCAGCA,7,1861822
hyuA_predicted,0.3333333333333333,14,11,GCCTGGTGCAGATAGCCTGA,3,1857923
hyuA_predicted,1.0833333333333333,23,11,GCCTCGAACCGACCGGGAGC,12,1841568
hyuA_predicted,0.8333333333333334,20,11,GCCAGCGCGGTCTACAACTT,9,1860734
hyuA_predicted,2.5833333333333335,41,11,GCATTTAACCATAGTACACA,30,1837598
hyuA_predicted,0.5833333333333334,17,11,GCAACGAAATTTTCCCGCTC,6,1837346
hyuA_predicted,1.0833333333333333,23,11,GATGGCTCCTGCACCTACAC,12,1832511
hyuA_predicted,0.16666666666666666,12,11,GAGTGTAGACTAGGCGTTCA,1,1838820
hyuA_predicted,0.5,16,11,GAGGGTATTTAGCACGCCCT,5,1852166
hyuA_predicted,3.5833333333333335,53,11,GAGCCGTAAATCCCATGAAA,42,1834027
hyuA_predicted,0.25,13,11,GACGCGTCGCTCTTTAAACG,2,1840223
hyuA_predicted,2.25,37,11,GACATCAATTGCACCTAAAC,26,1862776
hyuA_predicted,0.3333333333333333,14,11,GAAGGGGGCGCGGTCATCAG,3,1840392
hyuA_predicted,1.75,31,11,GAACCGCCGCATTTATTGGT,20,1865901
hyuA_predicted,1.75,31,11,GAAACGAGGCCGGGTCTAAA,20,1847900
hyuA_predicted,2.0,34,11,GAAAATAGGAAAGACGATTC,23,1856817
hyuA_predicted,0.75,19,11,CTTATTAACCGCTTGGGTAT,8,1860086
hyuA_predicted,0.25,13,11,CTGTTAATGTGAAATCTCTA,2,1828889
hyuA_predicted,1.9166666666666667,33,11,CTGTGTTAGTGCTCAATCTG,22,1843119
hyuA_predicted,0.5,16,11,CTGAAGAGCGTGTTTAGTAA,5,1843678
hyuA_predicted,1.0833333333333333,23,11,CTCGCGTTGCGGTCTACTAT,12,1864318
hyuA_predicted,0.6666666666666666,18,11,CTCCTGCCAAGTGTGCACGT,7,1873459
hyuA_predicted,0.16666666666666666,12,11,CTATAATATTCATCTCTTAT,1,1860516
hyuA_predicted,0.25,13,11,CTAGTTCACCAATATGGGAA,2,1830684
hyuA_predicted,0.16666666666666666,12,11,CGTTGCGACAAGCTGCTGTG,1,1865266
hyuA_predicted,0.5833333333333334,17,11,CGTGTCTTCTAGTAGTCTCT,6,1834281
hyuA_predicted,1.25,25,11,CGTGCTGGAGAAGAAGTCTT,14,1858128
hyuA_predicted,1.25,25,11,CGTCAGGGTCACGGCTGGCA,14,1863897
hyuA_predicted,1.0,22,11,CGTATGAATTTGGGTACTCG,11,1839573
hyuA_predicted,1.5833333333333333,29,11,CGGTGGGAGTTTCCCGTAAC,18,1838684
hyuA_predicted,0.6666666666666666,18,11,CGGGTCCTGGTGAGATGATT,7,1861122
hyuA_predicted,1.5833333333333333,29,11,CGGATTAGGCCACGGTAAGA,18,1866678
hyuA_predicted,1.9166666666666667,33,11,CGGAGTTATATAAACTATTG,22,1832970
hyuA_predicted,0.4166666666666667,15,11,CGGAGAATTCTATATACTTG,4,1872096
hyuA_predicted,1.0,22,11,CGCCGGCTTAGGACCCGGTG,11,1850791
hyuA_predicted,0.4166666666666667,15,11,CGCCACAATTCCCGTCCTTA,4,1874119
hyuA_predicted,1.5,28,11,CGACTTAAGAAGCGGCATCA,17,1850552
hyuA_predicted,0.25,13,11,CCTCCCCACAGGTGTCTCCA,2,1843394
hyuA_predicted,0.9166666666666666,21,11,CCTCATATTGGTGTTACGGT,10,1829874
hyuA_predicted,0.5833333333333334,17,11,CCGCTGGGCTGCCGACCAGT,6,1858431
hyuA_predicted,2.5833333333333335,41,11,CCGCGCCCGCTCAAGCCTCT,30,1869431
hyuA_predicted,0.5833333333333334,17,11,CCGCCGGATTGGTGTTAGTC,6,1867764
hyuA_predicted,1.0,22,11,CCCTTGTAGGTAATTAGCGG,11,1854904
hyuA_predicted,0.16666666666666666,12,11,CCAGTTATCAACATTGATTG,1,1837542
hyuA_predicted,0.16666666666666666,12,11,CCACCAACAGATTTTAAGCA,1,1841910
hyuA_predicted,2.8333333333333335,44,11,CCACAGCAAGAGCGGTGAAA,33,1861373
hyuA_predicted,2.1666666666666665,36,11,CATTTATTGGACTACTTCCT,25,1863157
hyuA_predicted,0.9166666666666666,21,11,CATGACTGGGCTGAAACTAA,10,1868270
hyuA_predicted,1.5,28,11,CATAGACGTTGAAGTACCAA,17,1840134
hyuA_predicted,2.3333333333333335,38,11,CATAACAGGGTACCGAGCTT,27,1862715
hyuA_predicted,1.8333333333333333,32,11,CAGTGACAGCGATGTCCGTA,21,1864010
hyuA_predicted,0.25,13,11,CAGAAATTAAGGCAGGGCTG,2,1864166
hyuA_predicted,1.25,25,11,CACCCATGGAGCACGGACTA,14,1850758
hyuA_predicted,1.5,28,11,CACAGGCGGGACCGTAATAT,17,1846374
hyuA_predicted,2.0833333333333335,35,11,ATTGGAAGTCTACCTTTAGC,24,1873892
hyuA_predicted,0.75,19,11,ATTCGTCGGCTTACTGGCCA,8,1866774
hyuA_predicted,0.16666666666666666,12,11,ATTATGCTGGCTATTACCTG,1,1850939
hyuA_predicted,1.3333333333333333,26,11,ATTACTCGGTGGAAACTGTG,15,1831062
hyuA_predicted,0.25,13,11,ATGTGTATATGAGTGAGCCT,2,1877257
hyuA_predicted,0.16666666666666666,12,11,ATGTCGAAGTTTACAAATCA,1,1861209
hyuA_predicted,0.4166666666666667,15,11,ATGGTACACATGTAGCGATA,4,1869275
hyuA_predicted,0.16666666666666666,12,11,ATGCAATCACATTAGCCCCT,1,1874563
hyuA_predicted,1.5,28,11,ATCTATCTCTTAATTCACTG,17,1862504
hyuA_predicted,2.0,34,11,ATCTAGCTCGAGTCCACTCC,23,1849995
hyuA_predicted,1.0833333333333333,23,11,ATCGGCTTGGTCGATAACCC,12,1832496
hyuA_predicted,0.75,19,11,ATCGATAAGGCGCCCTGGAA,8,1868473
hyuA_predicted,0.16666666666666666,12,11,ATATTTGTGTCACTGACCTT,1,1838418
hyuA_predicted,1.5,28,11,ATAGGTGATATGGCAGTAGT,17,1869446
hyuA_predicted,1.5833333333333333,29,11,ATAGGATATCACTGGCTTCT,18,1846043
hyuA_predicted,0.8333333333333334,20,11,ATAGCAGTCTTGACCTTGAA,9,1832535
hyuA_predicted,0.16666666666666666,12,11,ATACCGCTTATGTCAACACA,1,1840773
hyuA_predicted,5.25,73,11,AGTTTCATCCTCTCATGACA,62,1838920
hyuA_predicted,0.16666666666666666,12,11,AGTTAAGTTCAGTAAGGCCT,1,1873600
hyuA_predicted,0.8333333333333334,20,11,AGTGAGAATCCGGTAAACCC,9,1857379
hyuA_predicted,2.3333333333333335,38,11,AGCTGTCCGTGCAAGACATT,27,1839907
hyuA_predicted,2.9166666666666665,45,11,AGCGGAATCAAACTCGATGT,34,1870013
hyuA_predicted,0.3333333333333333,14,11,AGCGCAATTACACGTAAACT,3,1833486
hyuA_predicted,0.25,13,11,AGCCCAGGAACAGGTTACAA,2,1832972
hyuA_predicted,1.1666666666666667,24,11,AGCCAGCGAGAGATCTAAAA,13,1877181
hyuA_predicted,1.6666666666666667,30,11,AGCCACTCTGGGGGATAAGG,19,1874660
hyuA_predicted,1.25,25,11,AGCAGTTGGTGCCATTTAAA,14,1852744
hyuA_predicted,0.16666666666666666,12,11,AGATTTGCCCGACACCCAAA,1,1862657
hyuA_predicted,0.4166666666666667,15,11,AGAGTCCCGCCTGGGTTGCA,4,1868056
hyuA_predicted,0.4166666666666667,15,11,AGACTTAATTAGTGTGGCGG,4,1861393
hyuA_predicted,1.0,22,11,AGAACCCTTTGTTGGCGCAT,11,1844678
hyuA_predicted,1.0,22,11,AGAAACGAGCCGGCTTAGTT,11,1865011
hyuA_predicted,1.25,25,11,ACTTCCTACTTTACAGGTAT,14,1846819
hyuA_predicted,1.1666666666666667,24,11,ACTTCCCGTGGACAGTCCTA,13,1853674
hyuA_predicted,1.3333333333333333,26,11,ACTCTTAGTTATGGGAAGGG,15,1846124
hyuA_predicted,1.5833333333333333,29,11,ACTACACTGTCCTCCCAGTG,18,1852253
hyuA_predicted,0.25,13,11,ACGGTTGATCCATCGTTTAC,2,1871349
hyuA_predicted,1.1666666666666667,24,11,ACGCTTATGGAGTAATCGCA,13,1834099
hyuA_predicted,0.3333333333333333,14,11,ACGCAGGCCCAGTCGGTAAC,3,1848948
hyuA_predicted,0.25,13,11,ACGAGCAACGCTTCGAAGAG,2,1860738
hyuA_predicted,1.5,28,11,ACCTTGGTGTGCGACCTCGT,17,1838451
hyuA_predicted,0.5833333333333334,17,11,ACCGTGAGTGATGCCTCGAG,6,1859492
hyuA_predicted,0.9166666666666666,21,11,ACCAAATAACCAAGGTGCCA,10,1862868
hyuA_predicted,2.3333333333333335,38,11,ACATGCTGGGGGAGCGGATC,27,1862658
hyuA_predicted,1.0,22,11,ACAGGGAACGCCTCGTACCT,11,1855792
hyuA_predicted,0.3333333333333333,14,11,ACAAGTTGTATTAATGAGCA,3,1871804
hyuA_predicted,0.5833333333333334,17,11,AATTCCCTATGACTGTCGTC,6,1838148
hyuA_predicted,3.0,46,11,AATTCACCATTTTCTTGATA,35,1830940
hyuA_predicted,0.4166666666666667,15,11,AATTACTGTCATTGCAGTTC,4,1868940
hyuA_predicted,0.16666666666666666,12,11,AATACCCGAGAACACGACAA,1,1864389
hyuA_predicted,1.5,28,11,AAGGGTCATGAGACCTGCGA,17,1854977
hyuA_predicted,0.16666666666666666,12,11,AAGGCCCCCGAGGCAGGTCC,1,1869140
hyuA_predicted,0.16666666666666666,12,11,AACTTTGGCAACATTCGGGA,1,1861648
hyuA_predicted,0.6666666666666666,18,11,AACCGGGATCTTTCCACCGA,7,1836108
hyuA_predicted,0.9166666666666666,21,11,AACCGCGGTCTTTCCCTTTT,10,1870470
hyuA_predicted,2.3333333333333335,38,11,AACCATTTGCTAGGCCAAGC,27,1859132
hyuA_predicted,0.5,16,11,AAATGACGAGCATTCCAGTA,5,1844908
hyuA_predicted,0.45454545454545453,14,10,TTTTTGGTATGTTCACGAGC,4,1829410
hyuA_predicted,0.5454545454545454,15,10,TTTTGAGTGACAGCCCCTTA,5,1869102
hyuA_predicted,0.5454545454545454,15,10,TTTTACACGCTGTGAAGAGT,5,1872878
hyuA_predicted,1.4545454545454546,25,10,TTTGTCTGATATTCTATGGC,15,1844867
hyuA_predicted,0.18181818181818182,11,10,TTGTCTGGCAACAACCGGGA,1,1831817
hyuA_predicted,3.0,42,10,TTGTCACGGCACTGGGTACC,32,1854248
hyuA_predicted,2.5454545454545454,37,10,TTGTACGCGCGTAAGTCCTG,27,1851622
hyuA_predicted,0.18181818181818182,11,10,TTGGATTGCGCAAAACAGAA,1,1855156
hyuA_predicted,0.18181818181818182,11,10,TTCTCTCGCTATTGATATGA,1,1846790
hyuA_predicted,1.8181818181818181,29,10,TTCAGCAAATGGTGCTGGTA,19,1853429
hyuA_predicted,0.18181818181818182,11,10,TTAGTCTGATTGTACAAGTG,1,1874437
hyuA_predicted,0.45454545454545453,14,10,TTAGTACGATTTAAGCTAGC,4,1866501
hyuA_predicted,0.18181818181818182,11,10,TTACTGTCGAAAGCCTGCGA,1,1829836
hyuA_predicted,2.3636363636363638,35,10,TGTGAGTAGCCCACAATTAA,25,1832719
hyuA_predicted,2.0,31,10,TGTATTCCTAGTGAAGCAGA,21,1870356
hyuA_predicted,1.0,20,10,TGTACGCATGCACACGCCCT,10,1862899
hyuA_predicted,0.5454545454545454,15,10,TGGGTGTCTAAATCCGGCCC,5,1849726
hyuA_predicted,0.6363636363636364,16,10,TGGCCCTTAGACGACGACGT,6,1834944
hyuA_predicted,0.8181818181818182,18,10,TGGACACCTATTGTGATATA,8,1836317
hyuA_predicted,0.6363636363636364,16,10,TGCCCGCTAAAAGTCCGAGA,6,1875023
hyuA_predicted,1.8181818181818181,29,10,TGACAAACAGGGCGGCTCTT,19,1861394
hyuA_predicted,4.7272727272727275,61,10,TCTGTATTCCCTGCCACCCC,51,1844757
hyuA_predicted,0.45454545454545453,14,10,TCTCATGCCTTACTCACGGC,4,1841726
hyuA_predicted,1.9090909090909092,30,10,TCGTTGTTCTCCTTAGCCCT,20,1869377
hyuA_predicted,0.7272727272727273,17,10,TCGGACCGCAAGTTCCAGGT,7,1841589
hyuA_predicted,0.18181818181818182,11,10,TCGCCCAGGGGTAATGAATC,1,1861680
hyuA_predicted,1.3636363636363635,24,10,TCGCCACTAGCGTGTCTGAT,14,1874825
hyuA_predicted,2.4545454545454546,36,10,TCCTACTGTGGTTCTAGGGT,26,1871337
hyuA_predicted,2.4545454545454546,36,10,TCCGTTCCTCCTAACGGTGT,26,1834013
hyuA_predicted,0.7272727272727273,17,10,TCAGGTTAGCCGCAACCCAT,7,1867377
hyuA_predicted,1.9090909090909092,30,10,TCAGGGCTGCGAGGCGCTCA,20,1830371
hyuA_predicted,1.0909090909090908,21,10,TCACAGAACTTCTTGCAGTT,11,1854171
hyuA_predicted,2.090909090909091,32,10,TATGCGCGGTCAAACCGACG,22,1848198
hyuA_predicted,0.36363636363636365,13,10,TATCGCTTGATACAGATGAG,3,1864593
hyuA_predicted,0.5454545454545454,15,10,TACTTCTTGTCTTACTGAAT,5,1855386
hyuA_predicted,0.2727272727272727,12,10,TACTCCGGCGACGATTAAGA,2,1849487
hyuA_predicted,1.2727272727272727,23,10,TAATTCAACGATATTGCTCT,13,1836365
hyuA_predicted,0.18181818181818182,11,10,TAAAGCATTCAAACCCTGCA,1,1876064
hyuA_predicted,0.18181818181818182,11,10,GTTTCTTATACTACCTGATA,1,1853594
hyuA_predicted,0.18181818181818182,11,10,GTTTCTACGGTCGAGAGGAA,1,1830453
hyuA_predicted,2.272727272727273,34,10,GTTGGGATCGCCGTGCGGGA,24,1843993
hyuA_predicted,1.0909090909090908,21,10,GTTCATACCTTCTCCTGAGG,11,1835440
hyuA_predicted,1.8181818181818181,29,10,GTTACTTCTTTGAGTACGGA,19,1847349
hyuA_predicted,2.5454545454545454,37,10,GTGTGGGGACCGTTGGCGGG,27,1863533
hyuA_predicted,1.3636363636363635,24,10,GTGTAGATACTCCAAAGACA,14,1855429
hyuA_predicted,2.5454545454545454,37,10,GTGGCGCGTCCTAGTGCCCA,27,1832572
hyuA_predicted,0.18181818181818182,11,10,GTGCTATATTACGCATTAAG,1,1831897
hyuA_predicted,2.1818181818181817,33,10,GTGACGGCGCATGTCGAGCG,23,1837005
hyuA_predicted,0.36363636363636365,13,10,GTCTTGTAAGGTTGTCACTC,3,1833151
hyuA_predicted,1.0,20,10,GTCGCCCGCGGGTACTTGAT,10,1841892
hyuA_predicted,0.7272727272727273,17,10,GTACCGTAACGGCCTTTGTG,7,1844236
hyuA_predicted,2.3636363636363638,35,10,GTAAGTTTGTATTATATTCG,25,1835564
hyuA_predicted,0.5454545454545454,15,10,GTAAAGATGTCCTAGAATCC,5,1867767
hyuA_predicted,0.2727272727272727,12,10,GGTGAGAAGATAGTTCGGGA,2,1866742
hyuA_predicted,3.727272727272727,50,10,GGTGACATCCGTCGTTATCA,40,1858343
hyuA_predicted,0.2727272727272727,12,10,GGTATTCAGAAATATTCTTT,2,1872665
hyuA_predicted,2.0,31,10,GGTAACGGGGATAAGAATCA,21,1830036
hyuA_predicted,0.6363636363636364,16,10,GGGTGTGAATACAGATCGAA,6,1866527
hyuA_predicted,0.18181818181818182,11,10,GGGGTCATATCTTTCTCTTA,1,1845981
hyuA_predicted,0.6363636363636364,16,10,GGGGCCATGCGCTTAAATTG,6,1871323
hyuA_predicted,1.0,20,10,GGCTGCTGACAGTCTTTCGT,10,1861895
hyuA_predicted,1.6363636363636365,27,10,GGCGTGTAAATACTCGCTGT,17,1874268
hyuA_predicted,1.2727272727272727,23,10,GGCGTGGTAATCAGGGCCTC,13,1877802
hyuA_predicted,0.6363636363636364,16,10,GGCGCTGGTCCCGGATCTAA,6,1870137
hyuA_predicted,1.0909090909090908,21,10,GGCGCGGTACCCCAATGATT,11,1846692
hyuA_predicted,2.5454545454545454,37,10,GGCCGGTTGGTACAGGGAGT,27,1856298
hyuA_predicted,0.8181818181818182,18,10,GGCCGACTATTGCTCTCTAT,8,1867768
hyuA_predicted,0.5454545454545454,15,10,GGATCTAATGCCGCATGTCC,5,1835063
hyuA_predicted,0.2727272727272727,12,10,GGATCGGCCATGTCATCCCT,2,1835567
hyuA_predicted,0.18181818181818182,11,10,GGATAGTGGGAAGTAATATA,1,1855715
hyuA_predicted,1.6363636363636365,27,10,GGATACGAGGCGGTACTGTC,17,1839248
hyuA_predicted,1.0,20,10,GGACCGGAAGCCGCATTAAT,10,1841779
hyuA_predicted,2.0,31,10,GGACATCCCGTTAATCATGC,21,1841006
hyuA_predicted,1.0909090909090908,21,10,GCTCATACTTCTTACGGCGT,11,1846419
hyuA_predicted,1.2727272727272727,23,10,GCTAGAACCTTAAGCCTAGA,13,1863840
hyuA_predicted,1.8181818181818181,29,10,GCTACCTACTGTAGACTCGA,19,1834860
hyuA_predicted,0.45454545454545453,14,10,GCTACCGCGCAGCACCCGGA,4,1861292
hyuA_predicted,1.2727272727272727,23,10,GCTAAGGCTCCTGTGGATCT,13,1831656
hyuA_predicted,1.5454545454545454,26,10,GCGTAGTTTGCCTACGGGAC,16,1835218
hyuA_predicted,1.1818181818181819,22,10,GCGTAGACCGTTCCCGTCCC,12,1845279
hyuA_predicted,0.2727272727272727,12,10,GCGGGTACAACCGCGTAATA,2,1855593
hyuA_predicted,0.18181818181818182,11,10,GCGGCTTTGAGCTTGGATCT,1,1856383
hyuA_predicted,0.2727272727272727,12,10,GCGGACGAGATGTGGGTAAA,2,1869949
hyuA_predicted,1.8181818181818181,29,10,GCGACCTGTCGGACATGCCT,19,1835681
hyuA_predicted,0.45454545454545453,14,10,GCCTGCGGGAGGTATCGCCA,4,1832574
hyuA_predicted,5.636363636363637,71,10,GCCAACACAAACGCGGAGGA,61,1876660
hyuA_predicted,0.18181818181818182,11,10,GCAGACCCAGAGCAAGCATC,1,1832014
hyuA_predicted,0.36363636363636365,13,10,GCAAATTACCAAAATGGCAA,3,1860100
hyuA_predicted,1.4545454545454546,25,10,GATGGCGTCCCATCGCTTAC,15,1835181
hyuA_predicted,0.18181818181818182,11,10,GATACCAGGACGACGAAAAG,1,1839178
hyuA_predicted,1.0909090909090908,21,10,GAGTGCCGACATATGTATAA,11,1873830
hyuA_predicted,1.5454545454545454,26,10,GAGTAAGTAAGGAGAGTCCA,16,1860686
hyuA_predicted,1.7272727272727273,28,10,GAGGACTATCAGACATGCGT,18,1830542
hyuA_predicted,0.18181818181818182,11,10,GAGCTCTAACGCTGATCCGT,1,1832863
hyuA_predicted,0.6363636363636364,16,10,GAGCTAAATGACTAACTCTC,6,1834266
hyuA_predicted,1.1818181818181819,22,10,GACCTTTTAAGTCTTAACAA,12,1848471
hyuA_predicted,1.5454545454545454,26,10,GACCCTCGGGGATGATTCCA,16,1848621
hyuA_predicted,0.8181818181818182,18,10,GACAAGAACTAATCGACATG,8,1865527
hyuA_predicted,2.3636363636363638,35,10,GAATCCCGGACTCTCTCACC,25,1859915
hyuA_predicted,0.5454545454545454,15,10,GAAGGCTTTTGTCCTGATTG,5,1853561
hyuA_predicted,0.2727272727272727,12,10,GAAGAATTATAAAGATTGCA,2,1869867
hyuA_predicted,0.7272727272727273,17,10,GAAGAAGTGTGCTCTATATG,7,1859755
hyuA_predicted,0.5454545454545454,15,10,GAACTAGCTGTGCAATACTT,5,1871563
hyuA_predicted,3.4545454545454546,47,10,GAACGGGTTGGCATAGGACG,37,1833789
hyuA_predicted,0.18181818181818182,11,10,CTTTAAGTACATTAGGGACT,1,1844592
hyuA_predicted,1.5454545454545454,26,10,CTTGCTTCCAGCTATGTCAG,16,1877255
hyuA_predicted,0.5454545454545454,15,10,CTTCACGTGCCCAAAACGAT,5,1857598
hyuA_predicted,1.2727272727272727,23,10,CTTAATTCTCTCTGGTTTGC,13,1844052
hyuA_predicted,0.18181818181818182,11,10,CTGGTCCGGATGCGCTCACC,1,1829359
hyuA_predicted,0.18181818181818182,11,10,CTGCTACATACGCATGTTTA,1,1837497
hyuA_predicted,1.5454545454545454,26,10,CTCTACTTTCGCGCTTCCAC,16,1832502
hyuA_predicted,1.0,20,10,CTCCGACAGAATTTCAGCGT,10,1843524
hyuA_predicted,1.5454545454545454,26,10,CTCCACTTACTCATAACACA,16,1834204
hyuA_predicted,0.45454545454545453,14,10,CTCCAAGCCGTTTCGTCGCT,4,1860452
hyuA_predicted,1.5454545454545454,26,10,CTATGCGGTCTCTAGTCGCC,16,1876758
hyuA_predicted,0.2727272727272727,12,10,CTAGTTCGAAGGATAGGGAG,2,1853934
hyuA_predicted,0.18181818181818182,11,10,CTAGTATGCTCTCTGGGTAG,1,1837026
hyuA_predicted,0.5454545454545454,15,10,CTACTGCGTCTACGGAATGA,5,1848511
hyuA_predicted,2.8181818181818183,40,10,CGTTTGTGTAGATAACGGTC,30,1848359
hyuA_predicted,0.7272727272727273,17,10,CGTTACTGCTCGCGAGGTTT,7,1867158
hyuA_predicted,0.6363636363636364,16,10,CGTGCCAGGTACGCACACTT,6,1867259
hyuA_predicted,0.18181818181818182,11,10,CGTAACGAGTTAAATATTTA,1,1844466
hyuA_predicted,0.18181818181818182,11,10,CGGTTCGCCGTGCGAGGTGA,1,1876945
hyuA_predicted,1.0,20,10,CGGTGGGAGATTTCCACTGT,10,1840320
hyuA_predicted,0.2727272727272727,12,10,CGGGTTGGGACAAAAAATCG,2,1846558
hyuA_predicted,1.1818181818181819,22,10,CGGGGGCAATTGCACCCCTC,12,1839670
hyuA_predicted,0.36363636363636365,13,10,CGGGGCCTCAAAGGGTCGGT,3,1838276
hyuA_predicted,4.7272727272727275,61,10,CGGGGATGTTCGCTAAAATC,51,1839737
hyuA_predicted,0.9090909090909091,19,10,CGGCGTACCGTGCGTACCGT,9,1836506
hyuA_predicted,1.5454545454545454,26,10,CGGCAGGGTGGAGTGTGTTT,16,1848678
hyuA_predicted,4.818181818181818,62,10,CGGCACACCGAGGCAGTCCT,52,1847715
hyuA_predicted,0.18181818181818182,11,10,CGGAACAGGACAGGCCCGAT,1,1858542
hyuA_predicted,1.0909090909090908,21,10,CGCTTATCCATAGGAAACCG,11,1867241
hyuA_predicted,1.8181818181818181,29,10,CGCTTACGTATAGGTGATCA,19,1874444
hyuA_predicted,1.3636363636363635,24,10,CGCGTGGGCGTCACAGTGAT,14,1863182
hyuA_predicted,2.1818181818181817,33,10,CGCGACCTTATGTGTGGTGG,23,1858834
hyuA_predicted,0.6363636363636364,16,10,CGCACAGCGTCAGTCCAACT,6,1874273
hyuA_predicted,1.1818181818181819,22,10,CGAGGGGACCTCTCGCTGGT,12,1852622
hyuA_predicted,0.2727272727272727,12,10,CGAGGCATTCCGTTCGCTAA,2,1835224
hyuA_predicted,0.7272727272727273,17,10,CGACGGCAATTTGGTGGGTG,7,1852797
hyuA_predicted,2.5454545454545454,37,10,CCTTTGCACGTTAGGTCGTA,27,1831836
hyuA_predicted,4.2727272727272725,56,10,CCTTCTCAGGAAGCGTTAAC,46,1869279
hyuA_predicted,1.8181818181818181,29,10,CCTGCCCCACGAGCTCCGAG,19,1843788
hyuA_predicted,0.36363636363636365,13,10,CCTCTGTAGATGAGCGGAAT,3,1872275
hyuA_predicted,3.5454545454545454,48,10,CCTCTCTTTGACTAATCACA,38,1829797
hyuA_predicted,3.0,42,10,CCTATAATGGTTTCCTACGA,32,1845934
hyuA_predicted,1.1818181818181819,22,10,CCTAGTCTACTGTGGTCCAC,12,1839567
hyuA_predicted,0.6363636363636364,16,10,CCGTCGGCAGCCGTTCCCTT,6,1867131
hyuA_predicted,2.4545454545454546,36,10,CCGGCTTTGCGAGGTTTCGT,26,1828942
hyuA_predicted,0.2727272727272727,12,10,CCGCTATCCCCGTTGTCTTC,2,1852801
hyuA_predicted,1.3636363636363635,24,10,CCGCGCGTTCACAAGGCTCT,14,1831060
hyuA_predicted,1.1818181818181819,22,10,CCGCGCCGGCATGTTGCCAT,12,1862602
hyuA_predicted,0.8181818181818182,18,10,CCCGACGCGGCCTTGGGCCG,8,1869823
hyuA_predicted,1.1818181818181819,22,10,CCCAGCTCTTCCTATAAAAC,12,1854455
hyuA_predicted,0.6363636363636364,16,10,CCAGGCAGCGATCGGGTTTT,6,1859074
hyuA_predicted,1.1818181818181819,22,10,CCAGAGGCAGGCCCTTAACG,12,1875846
hyuA_predicted,1.5454545454545454,26,10,CCACTAGCGAGATACCAGTA,16,1846256
hyuA_predicted,0.36363636363636365,13,10,CCACCTCGTCATGAAAAGTG,3,1853620
hyuA_predicted,0.5454545454545454,15,10,CCACCTAAGGGAGAGGGCAT,5,1839301
hyuA_predicted,2.6363636363636362,38,10,CCAAAGGGAAGATAATATAT,28,1846826
hyuA_predicted,1.0,20,10,CATTTTGGACTAGCGACACA,10,1834124
hyuA_predicted,0.5454545454545454,15,10,CATTGCAGTGTACTCCTTCG,5,1876931
hyuA_predicted,0.8181818181818182,18,10,CATCTATCGCAAGGCTAAAT,8,1858812
hyuA_predicted,2.0,31,10,CAGGGGAACCTGCCGAAAAA,21,1836642
hyuA_predicted,0.5454545454545454,15,10,CAGCTGTAATACCTGGCCAC,5,1848356
hyuA_predicted,1.0909090909090908,21,10,CAGCGAATCAGATATATGGA,11,1842690
hyuA_predicted,0.18181818181818182,11,10,CAGCCTCCACGCCCGTGGCG,1,1850396
hyuA_predicted,0.18181818181818182,11,10,CAGATTCTACGCGCGGAAGA,1,1861467
hyuA_predicted,0.18181818181818182,11,10,CAGAGGACGACGTAGATGTA,1,1853465
hyuA_predicted,1.8181818181818181,29,10,CACGGATAGATCGTGTTTTA,19,1852465
hyuA_predicted,0.18181818181818182,11,10,CACCTTACAGACCTTGCTGG,1,1836091
hyuA_predicted,1.3636363636363635,24,10,CAAATCAGACGATGACCCGC,14,1852701
hyuA_predicted,1.9090909090909092,30,10,ATTGTTGTACGGTCTGATGC,20,1846485
hyuA_predicted,1.0909090909090908,21,10,ATTATAGATAAACCGTTGCT,11,1840300
hyuA_predicted,0.9090909090909091,19,10,ATGCGCTAAAGATCGGGGTA,9,1869034
hyuA_predicted,1.2727272727272727,23,10,ATCTGAACGTCTCGTAGTGT,13,1846436
hyuA_predicted,0.2727272727272727,12,10,ATCTATAGCAACATCGCTCT,2,1864427
hyuA_predicted,1.0,20,10,ATCGCCTGTCCCTTGGACCA,10,1838800
hyuA_predicted,0.2727272727272727,12,10,ATATCATGCGTAAGAACATA,2,1874400
hyuA_predicted,1.2727272727272727,23,10,ATAGGGTGAAGGGTTTTATA,13,1844975
hyuA_predicted,0.18181818181818182,11,10,ATAGCCTTGATGACACGTCC,1,1856438
hyuA_predicted,0.8181818181818182,18,10,ATAGCCTCTGTCATCGGGGG,8,1850449
hyuA_predicted,1.8181818181818181,29,10,ATACCCCAGTAGCCCCCGTT,19,1849055
hyuA_predicted,2.090909090909091,32,10,AGTTAAGCCCACGCATCGAC,22,1874037
hyuA_predicted,6.454545454545454,80,10,AGTGTCCCGGACTGCAGCTC,70,1877213
hyuA_predicted,0.9090909090909091,19,10,AGGGCCGTTAGCATATTACG,9,1858974
hyuA_predicted,0.6363636363636364,16,10,AGGGACATAATCTGCGACAT,6,1832128
hyuA_predicted,1.9090909090909092,30,10,AGGCTAAAGCCGTACGCTAT,20,1857068
hyuA_predicted,0.5454545454545454,15,10,AGGCCTTCTGGCTGCACTAC,5,1853180
hyuA_predicted,1.8181818181818181,29,10,AGCTCTGGCAGCCCTTCCTA,19,1836081
hyuA_predicted,0.2727272727272727,12,10,AGCTATACAATTATTGGTAA,2,1875536
hyuA_predicted,0.2727272727272727,12,10,AGCACGTATAACATTTCAAG,2,1855048
hyuA_predicted,1.0909090909090908,21,10,ACTTAACATCGATTTCGTTC,11,1873675
hyuA_predicted,0.2727272727272727,12,10,ACTGTTTATTAGCGAGGATC,2,1833163
hyuA_predicted,0.5454545454545454,15,10,ACTGTAAGCCGACCTTAACT,5,1843923
hyuA_predicted,0.18181818181818182,11,10,ACTCTGCGACCAATTTTTTA,1,1858393
hyuA_predicted,1.4545454545454546,25,10,ACTCGCTCCTTATTACGGTA,15,1860946
hyuA_predicted,0.18181818181818182,11,10,ACTCCTATACTACAATCCAT,1,1830213
hyuA_predicted,1.5454545454545454,26,10,ACGTGTCGCGTATTGAAAGA,16,1831892
hyuA_predicted,0.7272727272727273,17,10,ACGTCCCAGACGGCTTATGT,7,1868052
hyuA_predicted,0.8181818181818182,18,10,ACGGCTGTCAACCTTTCGCC,8,1868631
hyuA_predicted,1.0,20,10,ACGCGGGGGCTTCATACGCT,10,1846820
hyuA_predicted,3.1818181818181817,44,10,ACCTCTATCACGCGAAAATT,34,1850322
hyuA_predicted,0.2727272727272727,12,10,ACCCGTGAGTGGTATCGGTG,2,1874664
hyuA_predicted,3.090909090909091,43,10,ACCCGTCTGGTCCGCCCTGT,33,1858049
hyuA_predicted,6.0,75,10,ACATTTGCTACCCACAACCT,65,1845746
hyuA_predicted,2.0,31,10,ACATTTCATCGAACGGTCCT,21,1870962
hyuA_predicted,0.36363636363636365,13,10,ACATCATACGACCACATATG,3,1857902
hyuA_predicted,1.4545454545454546,25,10,ACATACGATCTCCTGTCAGA,15,1868944
hyuA_predicted,0.36363636363636365,13,10,ACAACGCGAATGGTGTATTA,3,1871282
hyuA_predicted,0.18181818181818182,11,10,ACAAAAAGCCCCAGGAGGGG,1,1855486
hyuA_predicted,2.6363636363636362,38,10,AATGCGTCGCACCAGCCAGA,28,1850055
hyuA_predicted,0.36363636363636365,13,10,AATGACGGAGTCTCGACATA,3,1857214
hyuA_predicted,1.1818181818181819,22,10,AAGCAATGCAGTATCGCGCG,12,1873247
hyuA_predicted,2.5454545454545454,37,10,AAAGGTCGTCACGCTTGTAC,27,1852613
hyuA_predicted,0.8181818181818182,18,10,AAAGGGCATTTGATCAGAGT,8,1865948
hyuA_predicted,0.5454545454545454,15,10,AAACCGATCTCACCGGGATG,5,1840284
hyuA_predicted,0.9,17,9,TTTTGCCAAATATTAAAAAC,8,1852624
hyuA_predicted,2.4,32,9,TTTCTTGGTTCAACCGTGGA,23,1847689
hyuA_predicted,0.6,14,9,TTTCGGTCCTAAAATCTAAT,5,1856466
hyuA_predicted,0.2,10,9,TTTCCCTTACGAGGTCCTTA,1,1847997
hyuA_predicted,1.9,27,9,TTTACAAAAGTGTACGGAAA,18,1834058
hyuA_predicted,0.7,15,9,TTGGTAGAGGTTTACTTTGG,6,1870511
hyuA_predicted,1.9,27,9,TTGGCCATCCCAAATATCCA,18,1874868
hyuA_predicted,0.6,14,9,TTGAGGCTAAAATTCAAATT,5,1865888
hyuA_predicted,0.5,13,9,TTGAGAAGGGACCCAAAATC,4,1846594
hyuA_predicted,0.8,16,9,TTCTTTGAGATTTTAAGGAA,7,1831382
hyuA_predicted,0.4,12,9,TTCTTCTGTGATGGGCCGAT,3,1833277
hyuA_predicted,0.3,11,9,TTCTGTCCCACACATCTCTA,2,1877390
hyuA_predicted,4.0,48,9,TTCTCATGCCTGCGGCGAGC,39,1840091
hyuA_predicted,1.3,21,9,TTCCTTGGACTCCTCATAGG,12,1861204
hyuA_predicted,0.2,10,9,TTCCAATCGAAATCTCATTC,1,1855710
hyuA_predicted,0.6,14,9,TTATAGTGCGGGTGGGGTTA,5,1856753
hyuA_predicted,0.2,10,9,TTATAAGTCTCCGGGCGCAT,1,1847668
hyuA_predicted,1.3,21,9,TTAGCATTCCATCTTCAATC,12,1864960
hyuA_predicted,0.3,11,9,TTACCCATCAACATATTCCA,2,1877235
hyuA_predicted,0.2,10,9,TTAACGATAAATCCATACCT,1,1857107
hyuA_predicted,0.4,12,9,TGTTACGACGTTGTCTTGTC,3,1855691
hyuA_predicted,1.4,22,9,TGTGCCTAAGCCGCTTTACT,13,1874144
hyuA_predicted,2.2,30,9,TGGTCAAGTCGATTTTCGGT,21,1860911
hyuA_predicted,1.8,26,9,TGGACGAAGTGATCGACCCA,17,1852708
hyuA_predicted,1.0,18,9,TGCTCGCATCCGCACAGAGC,9,1847695
hyuA_predicted,0.3,11,9,TGCCAGTGGCGCATGACACG,2,1831886
hyuA_predicted,1.3,21,9,TGCCAATCTTATGAGTCACT,12,1837343
hyuA_predicted,0.9,17,9,TGAGCATCGTATCGTCAGTC,8,1861236
hyuA_predicted,1.6,24,9,TGACGGTCATGTTACTGATA,15,1831448
hyuA_predicted,0.3,11,9,TGAAGTTCGAACCAAGGTTC,2,1846486
hyuA_predicted,0.2,10,9,TCTACGAATTGTAGACGCCT,1,1832638
hyuA_predicted,3.6,44,9,TCGCCGAGGCTTCACACCGA,35,1840422
hyuA_predicted,3.5,43,9,TCGCCATTGAAAGTAAGTGA,34,1829606
hyuA_predicted,1.7,25,9,TCGCCATTAGTCACTGTTGC,16,1862710
hyuA_predicted,2.2,30,9,TCGCCATACCTCTTGAGCTC,21,1864490
hyuA_predicted,0.8,16,9,TCGATGTGGGCTTACGGTCT,7,1846134
hyuA_predicted,0.3,11,9,TCCTTATTCGGACCGTCTTC,2,1834557
hyuA_predicted,2.8,36,9,TCCGAACAGGATCTTACAAA,27,1854443
hyuA_predicted,0.2,10,9,TCAGCGAATTTAGGTACCGT,1,1873487
hyuA_predicted,3.9,47,9,TCACCCATGGGGGTGCCCCG,38,1836746
hyuA_predicted,3.6,44,9,TCAAATCCGCGCAGGGCGCA,35,1862905
hyuA_predicted,3.5,43,9,TATTCGTACCGTGCGCGCCC,34,1836491
hyuA_predicted,0.2,10,9,TATCCGGCACTTGCCGCGTT,1,1867533
hyuA_predicted,3.8,46,9,TATATGCTACCGCTTGGACC,37,1833648
hyuA_predicted,1.5,23,9,TATAGGCACCGCCACCTCTC,14,1865151
hyuA_predicted,1.4,22,9,TAGCCAAACTCTAACACTAC,13,1845100
hyuA_predicted,2.6,34,9,TACTCCTGGAATACGCCCGG,25,1861929
hyuA_predicted,0.4,12,9,TACGTAACATCGAATTGGAT,3,1873361
hyuA_predicted,0.2,10,9,TACCGACGTTTCTATCACAT,1,1835365
hyuA_predicted,1.0,18,9,TACCGAAACGTTGGATTAGA,9,1835781
hyuA_predicted,0.2,10,9,TACCATTACTAGCATGGAAG,1,1845830
hyuA_predicted,0.5,13,9,TAAACTCCTCTGGTGGTAGT,4,1871388
hyuA_predicted,1.3,21,9,TAAAAATGATCTGGAAACAA,12,1830454
hyuA_predicted,0.2,10,9,GTTCGGCAGAAACTCCCAAA,1,1861717
hyuA_predicted,0.3,11,9,GTGATTATCTGGCACTCACT,2,1863062
hyuA_predicted,0.2,10,9,GTGAGCATAGAAGCTGCGCT,1,1844001
hyuA_predicted,1.4,22,9,GTCTCCGCATCAATCAGGTA,13,1846608
hyuA_predicted,0.4,12,9,GTCAGAGTCCTTAAGTACTG,3,1838770
hyuA_predicted,0.2,10,9,GTATCGAGGGACCAAGCTAA,1,1875801
hyuA_predicted,1.5,23,9,GTATCATTTACAAATAGACT,14,1854418
hyuA_predicted,0.5,13,9,GTATCAATTGCACCCGTCTG,4,1864932
hyuA_predicted,0.5,13,9,GTAGGTTAGTAGGCCTGCTA,4,1845896
hyuA_predicted,2.2,30,9,GTAGAAGCTAGCTTTTCTAT,21,1871962
hyuA_predicted,3.2,40,9,GGTTCTATAAACAATAAAAG,31,1863848
hyuA_predicted,0.5,13,9,GGTTACGGCGTCTGGACGGC,4,1874088
hyuA_predicted,1.5,23,9,GGTGTCAAGGTCGGCTAGGT,14,1854461
hyuA_predicted,1.4,22,9,GGTCTCCTGCTTTCGGAGTA,13,1870751
hyuA_predicted,0.2,10,9,GGTATAAGCCTGACAAACTG,1,1832570
hyuA_predicted,1.4,22,9,GGGTTTGGAAAGCACCTGTA,13,1836978
hyuA_predicted,0.3,11,9,GGGTGCCTGTAAGTGAGACA,2,1836157
hyuA_predicted,0.8,16,9,GGGGGGAGTGGTCGTAATTC,7,1837860
hyuA_predicted,0.7,15,9,GGGCGTTTAATTGCGTCCAC,6,1854039
hyuA_predicted,1.4,22,9,GGGCCTCGATTTCTTATGGA,13,1848260
hyuA_predicted,0.5,13,9,GGCTGGTGGAAAGCCCAAAC,4,1866175
hyuA_predicted,3.2,40,9,GGCTCATGCGTTCGCTGACT,31,1866495
hyuA_predicted,1.3,21,9,GGCGTTAAAAATGTTCTCCT,12,1871969
hyuA_predicted,1.0,18,9,GGCCGACAAAGACACAGTCT,9,1863449
hyuA_predicted,0.6,14,9,GGCCATCCGTGGTAGCGTAG,5,1866695
hyuA_predicted,2.8,36,9,GGATGGGATCGTCACTATGT,27,1842572
hyuA_predicted,0.8,16,9,GGATCTATGTCTCATGCTGG,7,1874700
hyuA_predicted,1.1,19,9,GGAGGCGCTCGTTCAAGTAT,10,1842122
hyuA_predicted,2.1,29,9,GGAAGGCCCAATATGCATTC,20,1877258
hyuA_predicted,0.2,10,9,GGAACAGGACCTTATTTTTA,1,1876749
hyuA_predicted,1.2,20,9,GGAAATAACTGTGTCAGTAC,11,1841008
hyuA_predicted,0.3,11,9,GCTTTCATAACGGGCAGTTA,2,1835756
hyuA_predicted,1.1,19,9,GCTTGGTTAGAGAGGAAGAA,10,1841507
hyuA_predicted,1.6,24,9,GCTGTATCGGGCTGTCCCGT,15,1867336
hyuA_predicted,1.1,19,9,GCGTTTCGTGGCCCCAATGG,10,1870517
hyuA_predicted,2.6,34,9,GCGGAGCAACCTATGTCCTA,25,1854849
hyuA_predicted,0.3,11,9,GCGCTGCCTAGCGGGGGTAT,2,1861832
hyuA_predicted,0.3,11,9,GCGCCACCCGAGGCGCTCCG,2,1851572
hyuA_predicted,1.4,22,9,GCCTATGTCGCATGCAAAGT,13,1829885
hyuA_predicted,0.5,13,9,GCCTAATCGCAGGTGCAGAA,4,1841583
hyuA_predicted,0.7,15,9,GCCATCACGGTCTAACGCTA,6,1866554
hyuA_predicted,0.2,10,9,GCCAACGCGGGCTTTCAGTA,1,1854180
hyuA_predicted,0.7,15,9,GCATGTATAGACACGGATCT,6,1838445
hyuA_predicted,1.3,21,9,GCAGTGCTCTCTATTAGCTC,12,1869126
hyuA_predicted,2.8,36,9,GCAGTAAGAGCTCAATTATA,27,1834490
hyuA_predicted,2.0,28,9,GCACCACTCCCCTCCTAAAT,19,1877119
hyuA_predicted,1.5,23,9,GCACACGAGGAAGTAGTACA,14,1868641
hyuA_predicted,1.2,20,9,GCAAGTACAGGGTAGCGTAA,11,1857458
hyuA_predicted,2.3,31,9,GCAACCTAGCATTACGTACT,22,1852483
hyuA_predicted,0.2,10,9,GATTTGCGAGCGCCGTCTCA,1,1873020
hyuA_predicted,0.9,17,9,GATGTGGACCCGGGTGAGTA,8,1858497
hyuA_predicted,0.5,13,9,GATGACATAGTCAAACGAAT,4,1856745
hyuA_predicted,10.5,113,9,GATCGGTGTTGGCGTACCCA,104,1831580
hyuA_predicted,0.2,10,9,GATCCGCACCACAAAAGCGC,1,1840987
hyuA_predicted,1.0,18,9,GAGGTCAAAGGTGGCTCAAG,9,1842377
hyuA_predicted,1.3,21,9,GAGGATTACAGGTTGACCCG,12,1852660
hyuA_predicted,1.2,20,9,GAGGAGTTGCGGAACCTCGA,11,1864377
hyuA_predicted,0.8,16,9,GAGCAGATTGTCAGACCTCG,7,1852770
hyuA_predicted,2.5,33,9,GACTGCGTGCGGGAACCGGG,24,1835259
hyuA_predicted,1.1,19,9,GACTCGCATCAGGCATGGCA,10,1850323
hyuA_predicted,0.2,10,9,GACTCAAGTTCCACAGCTGC,1,1877607
hyuA_predicted,0.3,11,9,GACTATTGCTCGCAATATTT,2,1856992
hyuA_predicted,0.8,16,9,GACGGGTTGCATTACCCCCG,7,1861712
hyuA_predicted,1.4,22,9,GACCGGACGTAGTCTCACCA,13,1871460
hyuA_predicted,1.2,20,9,GACCATGGGCGCCAGAGTGA,11,1862604
hyuA_predicted,1.9,27,9,GACCAAGGGGCGGCCTTCAA,18,1870361
hyuA_predicted,1.1,19,9,GACATGAGTATTGCCAACCT,10,1842103
hyuA_predicted,2.0,28,9,GACAGATTCCTCACTTGCCT,19,1862722
hyuA_predicted,1.2,20,9,GAAGTAAGGGCGATCATTTT,11,1854490
hyuA_predicted,0.9,17,9,GAAGCTAGATACCCCAGTGT,8,1831041
hyuA_predicted,1.4,22,9,GAAGATTAAAGAACTAAAGC,13,1843430
hyuA_predicted,1.0,18,9,GAACTCGAAACAGTCCCAAT,9,1829041
hyuA_predicted,0.7,15,9,CTTCTCCAAGACTCCGGAGC,6,1855934
hyuA_predicted,2.1,29,9,CTTCCCATCGCTGAAAAAGC,20,1854080
hyuA_predicted,0.5,13,9,CTGTTCTAGTTGGGGCCTAG,4,1859419
hyuA_predicted,1.7,25,9,CTGTTATGTCTGCTGTAGAT,16,1834811
hyuA_predicted,3.2,40,9,CTGTCATCGTGATTAATTAT,31,1866844
hyuA_predicted,0.4,12,9,CTGGTCAACTCGCCTGTTTT,3,1859072
hyuA_predicted,0.2,10,9,CTGCTATCCGGTGCACCCCC,1,1839926
hyuA_predicted,0.8,16,9,CTGCCCGACCGGAGCATAAA,7,1865460
hyuA_predicted,0.2,10,9,CTCTCCCCGGATCATCATCG,1,1830821
hyuA_predicted,0.7,15,9,CTCGCGAGACTGGTTCTTAG,6,1854609
hyuA_predicted,0.6,14,9,CTCCTCCTTACCGCCTAACT,5,1835265
hyuA_predicted,2.9,37,9,CTCCGGCAGCGTTAATTGGG,28,1868438
hyuA_predicted,1.1,19,9,CTCAGATACGTATATGTGAG,10,1847037
hyuA_predicted,1.7,25,9,CTATCGGAAGGGACGACATC,16,1837920
hyuA_predicted,0.5,13,9,CTATAGCGTTTCGGCTTTTG,4,1845251
hyuA_predicted,2.2,30,9,CTACGTACAAAACGTTTGCT,21,1863720
hyuA_predicted,0.2,10,9,CTACCCCGATTCCGCGCGTG,1,1839927
hyuA_predicted,1.5,23,9,CTAAACCTTGCTCGGTGCCG,14,1868209
hyuA_predicted,0.8,16,9,CGTTGCTATACGAACCGTAG,7,1874821
hyuA_predicted,2.4,32,9,CGTGCAGTTAAGGTGATAAA,23,1867370
hyuA_predicted,2.2,30,9,CGTCTTGGAAATCAGCGAAC,21,1841732
hyuA_predicted,2.5,33,9,CGTCTACGGAGGAGCTTGAG,24,1834963
hyuA_predicted,0.2,10,9,CGTAATCGTAGAGCTTGCAT,1,1840776
hyuA_predicted,0.3,11,9,CGGGTGGGTAGGGGGTTTAT,2,1876353
hyuA_predicted,0.3,11,9,CGGGCTACAACACCTCGGGA,2,1873947
hyuA_predicted,1.1,19,9,CGCAGGTTAAGTAAGTTGGT,10,1834620
hyuA_predicted,0.5,13,9,CGCACGTTCACGGCAACGGA,4,1830357
hyuA_predicted,1.0,18,9,CGATTCCCCTTAGGCGCGTG,9,1876712
hyuA_predicted,0.9,17,9,CGAACTCTCTCGAGCGCAGG,8,1861598
hyuA_predicted,0.5,13,9,CGAAATATAGATAGCTGTCA,4,1865349
hyuA_predicted,0.2,10,9,CGAAAGGCAGATATCCTAGA,1,1847372
hyuA_predicted,1.6,24,9,CCTCCTGGCTTAAAAATAAT,15,1853177
hyuA_predicted,0.6,14,9,CCTACCAGTCTGGGTCCTCG,5,1829198
hyuA_predicted,0.6,14,9,CCGTGTACACACACATGGAA,5,1843155
hyuA_predicted,1.1,19,9,CCGGGGAAGGCGGGTGTCTG,10,1832615
hyuA_predicted,1.0,18,9,CCGGCCCGTGTCGAACGATC,9,1829957
hyuA_predicted,0.2,10,9,CCGCGCATGCACCCGGCGTA,1,1843514
hyuA_predicted,2.4,32,9,CCGAGAACAATCTAAAGATA,23,1836606
hyuA_predicted,36.7,375,9,CCCTCCTGTCATCGGGGATC,366,1860211
hyuA_predicted,2.0,28,9,CCCGCAACAGATTGGGTGTT,19,1859221
hyuA_predicted,1.1,19,9,CCCATCTAACTATGGCACCT,10,1858691
hyuA_predicted,1.6,24,9,CCCAGCACGTACCCGGATAT,15,1860661
hyuA_predicted,8.0,88,9,CCATTGAGGCTTTGATTGTA,79,1870014
hyuA_predicted,1.7,25,9,CCAGAGTGTTAAGGCGTGGC,16,1869127
hyuA_predicted,1.3,21,9,CCAATGTCAGAAAATCGATG,12,1865072
hyuA_predicted,4.0,48,9,CCAACGTCCTGCGTGGATTA,39,1877223
hyuA_predicted,3.7,45,9,CCAAAACTAAAAGGGGTGTC,36,1860056
hyuA_predicted,0.3,11,9,CATGTTTCGCCAGGATCTAG,2,1865021
hyuA_predicted,0.3,11,9,CAGGGGAACGTCAAGATCAT,2,1851975
hyuA_predicted,1.0,18,9,CAGGGATAGTAAACCCTTGC,9,1837601
hyuA_predicted,0.2,10,9,CAGCAACCCAAAGATCTCGA,1,1855988
hyuA_predicted,3.5,43,9,CAGACGGTAGTACATTGTCA,34,1857400
hyuA_predicted,2.0,28,9,CAGAACGCTTCGTAAGCCGT,19,1860281
hyuA_predicted,0.4,12,9,CACCGGTAGACCCAGTCGTA,3,1877840
hyuA_predicted,0.3,11,9,ATTTTTTATATACGGTCCGA,2,1836024
hyuA_predicted,1.8,26,9,ATTCTGGCCCAGTCTAATAA,17,1856286
hyuA_predicted,1.0,18,9,ATTATTGCATCGCACAACCC,9,1837368
hyuA_predicted,2.5,33,9,ATGCTGGTCTTGGAATGCAA,24,1857599
hyuA_predicted,0.4,12,9,ATGCAGGGCTATTTTTGGTT,3,1833912
hyuA_predicted,2.6,34,9,ATGCACACAGTGTTTGGTAT,25,1850919
hyuA_predicted,0.2,10,9,ATGAATCGATCAGTCTTAAA,1,1859670
hyuA_predicted,0.5,13,9,ATCGGACAGCTGTCCATAGT,4,1847996
hyuA_predicted,1.6,24,9,ATCGACCCTGCTGGCGCCGG,15,1836023
hyuA_predicted,1.4,22,9,ATCATATGCACCCCCGGTGT,13,1860977
hyuA_predicted,0.2,10,9,ATAGCAATATGACCCTATCA,1,1876479
hyuA_predicted,0.9,17,9,AGTGGTGCAGCTTCGGTGCT,8,1860205
hyuA_predicted,0.7,15,9,AGTATTTTGATTGTAGTTCA,6,1871880
hyuA_predicted,0.5,13,9,AGGTCACGCGCTTAGCTGAG,4,1831887
hyuA_predicted,2.9,37,9,AGGGAGTAGTAGAAACCGAT,28,1867347
hyuA_predicted,0.4,12,9,AGGGACAGTGACCCCCTTCT,3,1838571
hyuA_predicted,1.2,20,9,AGGCTCGAATAAGGGGTTGG,11,1846718
hyuA_predicted,3.4,42,9,AGCTTAGGGGTCTCGCACCT,33,1836615
hyuA_predicted,2.2,30,9,AGCTTAGGGCCTCCGGATGT,21,1843625
hyuA_predicted,1.0,18,9,AGCTGGTCAACCTCTGGTAA,9,1852494
hyuA_predicted,1.3,21,9,AGCTAGCTCTATGGAAAGAA,12,1877773
hyuA_predicted,0.5,13,9,AGCAATTTGATGCCGTGGCT,4,1844301
hyuA_predicted,1.0,18,9,AGATGCATAGGTAGAATGTA,9,1834870
hyuA_predicted,0.3,11,9,AGACTCCTAAATCTAAACGC,2,1859586
hyuA_predicted,1.7,25,9,AGAAACACCAGCATAACGAC,16,1856577
hyuA_predicted,0.7,15,9,ACTTTGGCAGGTGCACGGAC,6,1866737
hyuA_predicted,0.7,15,9,ACTGGGTGAACTAGCGGGAA,6,1858127
hyuA_predicted,1.2,20,9,ACTAGGTATCACGGGAAAGT,11,1843504
hyuA_predicted,1.1,19,9,ACGTTACATTAGTCACGACC,10,1838417
hyuA_predicted,0.9,17,9,ACGGTAGTGAAATCTCGTGC,8,1840738
hyuA_predicted,0.2,10,9,ACGGGCGACGCCGGTTTCTA,1,1873556
hyuA_predicted,1.8,26,9,ACGGCAATATCATTTCTGTC,17,1843362
hyuA_predicted,0.3,11,9,ACGCATTTCCCCATGTTTGT,2,1861473
hyuA_predicted,0.2,10,9,ACCGCATTATCTATCCGGAA,1,1835909
hyuA_predicted,1.1,19,9,ACCCTCACTGGTTATAATTC,10,1874765
hyuA_predicted,0.2,10,9,ACAGTGCGGAGTCTGGGCTT,1,1868834
hyuA_predicted,3.4,42,9,ACACGCCCCCGTTCGGCTCA,33,1844816
hyuA_predicted,0.9,17,9,ACAAGTCTGCGACACTGTGT,8,1874655
hyuA_predicted,2.1,29,9,AATTGGTCTGACCGAACCCC,20,1868807
hyuA_predicted,0.8,16,9,AATCTGTCCCCACGGCGCCC,7,1838663
hyuA_predicted,2.0,28,9,AATCGATTTCTTTAAGAAGC,19,1843429
hyuA_predicted,0.2,10,9,AAGTTTGAAATGGAGAGGAG,1,1838020
hyuA_predicted,0.2,10,9,AAGTCGTGGAAAAAACTTCT,1,1843786
hyuA_predicted,2.5,33,9,AAGGGAGGAATGTCTCTTGA,24,1867784
hyuA_predicted,0.3,11,9,AAGCGCCCTAGGTACGAAGC,2,1842454
hyuA_predicted,0.2,10,9,AAGATTTGCATGTGGCCCCT,1,1829843
hyuA_predicted,0.6,14,9,AACATGCCGTAAAGGCGCGG,5,1837930
hyuA_predicted,1.6,24,9,AACATCTAGACGTATATTCC,15,1846421
hyuA_predicted,1.7,25,9,AAATTAGACTAAGCCGTCGG,16,1832446
hyuA_predicted,1.1,19,9,AAACCCCCTATACCACCCTA,10,1852814
hyuA_predicted,4.777777777777778,50,8,TTTGTAGTACCATGCGTATA,42,1867501
hyuA_predicted,1.8888888888888888,24,8,TTTCCTGCTATACCTGGGAA,16,1835807
hyuA_predicted,2.2222222222222223,27,8,TTTAACGCTCGATCGCAACT,19,1847645
hyuA_predicted,2.5555555555555554,30,8,TTGCCCACCTTGGTCCCATT,22,1837691
hyuA_predicted,0.7777777777777778,14,8,TTCTCGGAAACGATATTTCG,6,1865739
hyuA_predicted,0.7777777777777778,14,8,TTCGGGGCGACTAGCTTCTT,6,1851365
hyuA_predicted,0.3333333333333333,10,8,TTCAGAAATCGAGACAAAAG,2,1844469
hyuA_predicted,1.0,16,8,TTATATTGATTGCGTGTGTC,8,1853048
hyuA_predicted,0.5555555555555556,12,8,TTAGTTATAGACAAGCAGTC,4,1829733
hyuA_predicted,2.3333333333333335,28,8,TTAGGTGATGGACGTCTCCG,20,1843985
hyuA_predicted,0.4444444444444444,11,8,TTAGAGGCCGGGGATACCTT,3,1853535
hyuA_predicted,0.2222222222222222,9,8,TTACGACAAGCGTCATCACC,1,1830769
hyuA_predicted,0.7777777777777778,14,8,TTAACTTCTGTGCTACGTAA,6,1864047
hyuA_predicted,0.2222222222222222,9,8,TGTTTGGTCTCGCGGGTTCT,1,1855065
hyuA_predicted,0.2222222222222222,9,8,TGTTTGACTGTACACGGCAG,1,1871873
hyuA_predicted,1.5555555555555556,21,8,TGTTCCTAGCTTTCACGTTT,13,1853577
hyuA_predicted,1.1111111111111112,17,8,TGTAGTTCATCCAAAAAAGC,9,1870191
hyuA_predicted,0.2222222222222222,9,8,TGGTGTTGTCATCATCATGA,1,1852610
hyuA_predicted,0.4444444444444444,11,8,TGGAGCGAGGTACGGATTAA,3,1868107
hyuA_predicted,3.4444444444444446,38,8,TGGAATGTCAGTCCTAACAA,30,1841551
hyuA_predicted,2.111111111111111,26,8,TGCTCCGGCGTTTGCCCGAA,18,1861055
hyuA_predicted,1.3333333333333333,19,8,TGCGGCCCCTGCTATGTTTG,11,1855503
hyuA_predicted,1.0,16,8,TGCGAAGGCCTCAAATCCTT,8,1850675
hyuA_predicted,2.7777777777777777,32,8,TCTTATTTGTTCATAAAAAC,24,1855790
hyuA_predicted,0.4444444444444444,11,8,TCTCCTACGTGCAAACTCGC,3,1862245
hyuA_predicted,3.3333333333333335,37,8,TCTCATTTGCGGAAGTCCCA,29,1841628
hyuA_predicted,1.1111111111111112,17,8,TCTCACGGCCCGCTAGGATT,9,1860687
hyuA_predicted,1.4444444444444444,20,8,TCGTGTACCGGCTTTCAGCA,12,1868552
hyuA_predicted,1.7777777777777777,23,8,TCGGGAGTGGAGCTATGTAG,15,1843910
hyuA_predicted,1.2222222222222223,18,8,TCGCACCATCGGGCAGTAGT,10,1868981
hyuA_predicted,0.2222222222222222,9,8,TCGATATATGCGCACTAAGT,1,1834151
hyuA_predicted,0.2222222222222222,9,8,TCCTTCAACGATCGTCGATG,1,1852127
hyuA_predicted,2.111111111111111,26,8,TCCTAACCCTCCGTTTCATG,18,1839703
hyuA_predicted,2.0,25,8,TCACATGTCTGACCCACGTT,17,1830173
hyuA_predicted,1.2222222222222223,18,8,TATTTCAGTCACTTCTCGAC,10,1869131
hyuA_predicted,0.5555555555555556,12,8,TATCTGATACTTCCCAAACC,4,1875317
hyuA_predicted,1.3333333333333333,19,8,TATCCTCTATACAGAACTTT,11,1844377
hyuA_predicted,1.3333333333333333,19,8,TATCCGAAGGGCTGAGCTAG,11,1840122
hyuA_predicted,1.2222222222222223,18,8,TAGTCTCGTTTAAGCACGTA,10,1856690
hyuA_predicted,1.3333333333333333,19,8,TAGTCATTCTCAAGTTGGAA,11,1835085
hyuA_predicted,0.6666666666666666,13,8,TAGCTGCTTTGGGGTCCCCT,5,1855793
hyuA_predicted,2.4444444444444446,29,8,TACTGTTGAGAAAACTGAAG,21,1866901
hyuA_predicted,0.8888888888888888,15,8,TACTGAGCGATTAGCAACAA,7,1849061
hyuA_predicted,0.3333333333333333,10,8,TACGTCGATAGACTAGATGA,2,1834192
hyuA_predicted,0.8888888888888888,15,8,TACGTACTCTGAGTGTTAGG,7,1849166
hyuA_predicted,1.5555555555555556,21,8,TACGGTGCCGCGAGATGGGA,13,1854491
hyuA_predicted,0.8888888888888888,15,8,TACGCCGGGAACCTAGTGGG,7,1836887
hyuA_predicted,2.0,25,8,TACAACACGTGGCACGCCGA,17,1857338
hyuA_predicted,2.0,25,8,TAACGCTATGCTTTGCCACT,17,1836399
hyuA_predicted,1.3333333333333333,19,8,GTTCCCTGGGAGCTTTTGGA,11,1865322
hyuA_predicted,0.3333333333333333,10,8,GTGGTGTTATCCGAGCGTTC,2,1859357
hyuA_predicted,3.3333333333333335,37,8,GTGGGCCAGACGAGAAGCAT,29,1869831
hyuA_predicted,0.2222222222222222,9,8,GTGGAATAGGTATACAGAAC,1,1830968
hyuA_predicted,0.3333333333333333,10,8,GTGAGGCTATCCACAACACG,2,1872424
hyuA_predicted,0.5555555555555556,12,8,GTGAGACTCCGCCGTGGCCA,4,1829839
hyuA_predicted,0.2222222222222222,9,8,GTCGTTCTGATTGTAAAGGG,1,1860986
hyuA_predicted,0.7777777777777778,14,8,GTCGTGGGTTTGTGGAGAGA,6,1863156
hyuA_predicted,1.1111111111111112,17,8,GTCCGTACATTACCTTGCAA,9,1874956
hyuA_predicted,1.0,16,8,GTCCGAAATCCAATGTGCTG,8,1846634
hyuA_predicted,1.7777777777777777,23,8,GTCATGGCAGCTTCGGTTAG,15,1857652
hyuA_predicted,2.0,25,8,GTCACGTAGGACGATGCGTT,17,1877018
hyuA_predicted,0.4444444444444444,11,8,GTAGTTCCGTCTAACTTCAC,3,1844081
hyuA_predicted,0.6666666666666666,13,8,GTAACAAAAATGCGTCTCTT,5,1841845
hyuA_predicted,0.6666666666666666,13,8,GGGTTCTGCGCCGGCGGCCC,5,1841216
hyuA_predicted,0.3333333333333333,10,8,GGGTGATGCGCGACCACGGC,2,1853378
hyuA_predicted,2.7777777777777777,32,8,GGGTCTAGCGAGTAGGTCCG,24,1868900
hyuA_predicted,0.2222222222222222,9,8,GGGTCGAGACTAGGCGTCAT,1,1867669
hyuA_predicted,2.3333333333333335,28,8,GGCTTTCGGGTTATCAAGGC,20,1857443
hyuA_predicted,0.4444444444444444,11,8,GGCGCTCCCTGGCCTGGACC,3,1833442
hyuA_predicted,0.2222222222222222,9,8,GGCGAAACCAGTGGGGACTA,1,1870994
hyuA_predicted,0.3333333333333333,10,8,GGCAGCTTCTGTAAGTCCCT,2,1863681
hyuA_predicted,1.5555555555555556,21,8,GGCACTCATTAAAAGGTACT,13,1850297
hyuA_predicted,2.0,25,8,GGCACTAAAATATACTGTAT,17,1831020
hyuA_predicted,2.2222222222222223,27,8,GGCACGGGAATTGGATGGCT,19,1829075
hyuA_predicted,2.111111111111111,26,8,GGCACCTAGGACTACGGACA,18,1849106
hyuA_predicted,0.5555555555555556,12,8,GGACAGGGATAAAGTATTAG,4,1873729
hyuA_predicted,2.0,25,8,GCTGTTAGTGCGGATTGACG,17,1845684
hyuA_predicted,1.0,16,8,GCTGTATTTCCTTTAACCAG,8,1830488
hyuA_predicted,1.6666666666666667,22,8,GCTGCACGGACGGGCCGCGC,14,1877198
hyuA_predicted,0.7777777777777778,14,8,GCTCCTTGACTAAACATGCT,6,1873523
hyuA_predicted,2.6666666666666665,31,8,GCGGCTGCAACTTTGCTTTG,23,1829607
hyuA_predicted,0.6666666666666666,13,8,GCGGCATCATATAAAAAGAA,5,1836509
hyuA_predicted,0.8888888888888888,15,8,GCGGAGCGTCACTCCAGACA,7,1855572
hyuA_predicted,1.1111111111111112,17,8,GCGCTGGGTCGGATAGATTG,9,1854038
hyuA_predicted,1.5555555555555556,21,8,GCGCTACCGCCTTGGGTAGA,13,1866560
hyuA_predicted,2.6666666666666665,31,8,GCGCAATCCATAGGGGCTTT,23,1864350
hyuA_predicted,2.2222222222222223,27,8,GCGAGAGATGCTCATTGCTC,19,1853568
hyuA_predicted,0.3333333333333333,10,8,GCCGTCTTCACTTAGCCAAA,2,1851053
hyuA_predicted,0.2222222222222222,9,8,GCCATAAGACCGTCTGTCAC,1,1873888
hyuA_predicted,1.3333333333333333,19,8,GCACTTAATAGTAATGATCT,11,1849602
hyuA_predicted,2.0,25,8,GCACAATAATGGAACACGTA,17,1862373
hyuA_predicted,2.3333333333333335,28,8,GATTACATCTTTCTGTGAGG,20,1829244
hyuA_predicted,0.7777777777777778,14,8,GAGGGACAGGCAAACAGTGA,6,1855754
hyuA_predicted,0.4444444444444444,11,8,GAGGCTGGCGCTTCTTTTCT,3,1847323
hyuA_predicted,1.2222222222222223,18,8,GAAGCGAGGTCAGGTGTGAG,10,1836771
hyuA_predicted,0.2222222222222222,9,8,GAACGTGGGTCATTCGGCGT,1,1867340
hyuA_predicted,1.0,16,8,GAAAACCTTATATGGTTACT,8,1854643
hyuA_predicted,1.2222222222222223,18,8,CTTTCACTCTAGGGGGCGGT,10,1834987
hyuA_predicted,2.0,25,8,CTTAGTACTGGGCTGTAGTG,17,1855033
hyuA_predicted,0.5555555555555556,12,8,CTGTGCTCAGGAGTCTATTA,4,1861012
hyuA_predicted,0.4444444444444444,11,8,CTGTCGAGGCCATTGAGGAC,3,1851569
hyuA_predicted,1.3333333333333333,19,8,CTGTATTAAAGTGAGAAGTT,11,1866985
hyuA_predicted,1.2222222222222223,18,8,CTGGTAGCATATCTATGTAT,10,1853322
hyuA_predicted,2.888888888888889,33,8,CTGGATAGAACCATTCTAGA,25,1873127
hyuA_predicted,2.6666666666666665,31,8,CTGCTCACCACTCCCGTGAA,23,1839923
hyuA_predicted,2.2222222222222223,27,8,CTGACCACCAGCGACATCAC,19,1876703
hyuA_predicted,0.8888888888888888,15,8,CTCGGGCACATGGAAGTATA,7,1853244
hyuA_predicted,0.3333333333333333,10,8,CTCCAGTATCCCCAACTTAT,2,1872968
hyuA_predicted,0.3333333333333333,10,8,CTCATCAGTAGTTACAGCGT,2,1841253
hyuA_predicted,0.2222222222222222,9,8,CTATGTCACATCTTGCTTTG,1,1865780
hyuA_predicted,4.333333333333333,46,8,CTAGCCTTGTATTGAATCCT,38,1870142
hyuA_predicted,2.4444444444444446,29,8,CTACTGGCTGTTCACAGAAG,21,1865081
hyuA_predicted,0.2222222222222222,9,8,CTAAGGGACTTTCACATCTT,1,1871590
hyuA_predicted,0.2222222222222222,9,8,CGTCAAGGGTGTCCCTTCCC,1,1834422
hyuA_predicted,2.7777777777777777,32,8,CGTATAACCACGTCTTACGA,24,1854437
hyuA_predicted,1.2222222222222223,18,8,CGGGACACGAGGGTATAGAG,10,1862154
hyuA_predicted,0.8888888888888888,15,8,CGGCTCGCCCCAGTAGGCTG,7,1849919
hyuA_predicted,0.7777777777777778,14,8,CGCTACCTTTTAGACGGGCT,6,1871016
hyuA_predicted,1.5555555555555556,21,8,CGCCTGATGGGCTCCATTGA,13,1836321
hyuA_predicted,1.2222222222222223,18,8,CGCCGCTACGCGACGTCGGA,10,1865999
hyuA_predicted,3.3333333333333335,37,8,CGCCAAGGGCACATAGGACA,29,1829183
hyuA_predicted,0.6666666666666666,13,8,CGAGGGGCAACAAGTGTGTA,5,1859362
hyuA_predicted,1.1111111111111112,17,8,CGACTGACTCTACGAAAAAT,9,1871027
hyuA_predicted,0.4444444444444444,11,8,CGAATGTCCTCCGGGCAGCC,3,1868248
hyuA_predicted,0.4444444444444444,11,8,CCTCCGGTCAGCCAAAATCT,3,1844500
hyuA_predicted,0.4444444444444444,11,8,CCTCACGCGAGTCCAGACGA,3,1864765
hyuA_predicted,0.2222222222222222,9,8,CCGTTTGCGTTTTACAGCAG,1,1860210
hyuA_predicted,1.3333333333333333,19,8,CCGTCGAAGCTGGGCTCCCC,11,1833508
hyuA_predicted,1.3333333333333333,19,8,CCGTAAGTACCGGCTGGCGT,11,1847456
hyuA_predicted,1.1111111111111112,17,8,CCGGCTGGCGCCTTCCGGCT,9,1866218
hyuA_predicted,0.4444444444444444,11,8,CCGCTCAGAAAAGTATCACT,3,1871054
hyuA_predicted,1.0,16,8,CCCTGAAATAACCTTGGCTG,8,1859758
hyuA_predicted,0.5555555555555556,12,8,CCCGGCTTGATCTTATTAGG,4,1853083
hyuA_predicted,2.7777777777777777,32,8,CCCGCCAGGGCGCCCCGTGG,24,1840173
hyuA_predicted,0.8888888888888888,15,8,CCCCTTGGTACGGCGAGTCA,7,1858562
hyuA_predicted,0.8888888888888888,15,8,CCCCGTACGGGGCGCCAGTC,7,1849169
hyuA_predicted,1.2222222222222223,18,8,CCCAGGACGTTCGTAGTGCT,10,1857759
hyuA_predicted,0.6666666666666666,13,8,CCATCTGTTGCCTCATACCC,5,1873182
hyuA_predicted,2.6666666666666665,31,8,CATTTTTGCCCGTCGGCAAA,23,1840269
hyuA_predicted,0.6666666666666666,13,8,CATTGGGGGTGGTTCCAAGT,5,1829121
hyuA_predicted,0.2222222222222222,9,8,CATTCGAGTGAGCACAAGTA,1,1854932
hyuA_predicted,0.3333333333333333,10,8,CATGCACCGGAAGTTCATGT,2,1857206
hyuA_predicted,2.3333333333333335,28,8,CAGAGAAGACGTGGCCCCAT,20,1864284
hyuA_predicted,2.111111111111111,26,8,CAGAAAGTAAGCAAGCACTA,18,1860883
hyuA_predicted,0.6666666666666666,13,8,CACCGGACAGTTCATCCACT,5,1866256
hyuA_predicted,0.2222222222222222,9,8,CACCCGCTTAAGCCCGATCA,1,1831689
hyuA_predicted,0.4444444444444444,11,8,CACCAACGCTATCGGTATAA,3,1860003
hyuA_predicted,2.111111111111111,26,8,CAATGTAAATTTCGTCAGGT,18,1830217
hyuA_predicted,5.111111111111111,53,8,CAAGCACGCCGCAACATTGC,45,1849889
hyuA_predicted,3.6666666666666665,40,8,CAACAACTCCTTCGAAGAAA,32,1864201
hyuA_predicted,1.5555555555555556,21,8,CAAATCCTACTCATTTTGTT,13,1876909
hyuA_predicted,0.7777777777777778,14,8,ATTGAGCGGTTCAGCACATC,6,1861819
hyuA_predicted,3.7777777777777777,41,8,ATGTTGTTCGATGGTATGTT,33,1856926
hyuA_predicted,1.8888888888888888,24,8,ATGTGCATTAGGCTAGCTAG,16,1865294
hyuA_predicted,0.3333333333333333,10,8,ATGGCTAGAGGGCCATCCGT,2,1869739
hyuA_predicted,4.333333333333333,46,8,ATGCGAGGTACCACCACCAA,38,1877027
hyuA_predicted,0.4444444444444444,11,8,ATGAAAGACAAGTCTGGCGT,3,1861267
hyuA_predicted,0.3333333333333333,10,8,ATCTAAGTCCTGCGCATAGA,2,1850421
hyuA_predicted,3.111111111111111,35,8,ATCGACAAAATAAGGTTACG,27,1838857
hyuA_predicted,1.2222222222222223,18,8,ATCCGAGGGTGTGCTACTAG,10,1862937
hyuA_predicted,2.4444444444444446,29,8,ATCCAGGGAAGCGTCAGGGT,21,1866806
hyuA_predicted,0.3333333333333333,10,8,ATCCAGCGTGCACGATTCGG,2,1834044
hyuA_predicted,1.6666666666666667,22,8,ATCATTTGATCGAGGACGGT,14,1859119
hyuA_predicted,0.3333333333333333,10,8,ATCAGATCGGTGCACTCGTT,2,1850650
hyuA_predicted,2.2222222222222223,27,8,ATATTGTCACTGAGTGTTTG,19,1849730
hyuA_predicted,0.8888888888888888,15,8,ATATGACAGTTCGCGACTAG,7,1857582
hyuA_predicted,0.4444444444444444,11,8,ATAGGTGTAGCATATAGCAG,3,1845720
hyuA_predicted,1.3333333333333333,19,8,ATACCTGATGCCCCGTGGTG,11,1830724
hyuA_predicted,0.4444444444444444,11,8,ATAAGGACTTGCCCAAGAGA,3,1845914
hyuA_predicted,0.4444444444444444,11,8,AGTTTTGGGGGGGATTCCTA,3,1844759
hyuA_predicted,0.4444444444444444,11,8,AGTGATAGACGACATCTCAG,3,1874055
hyuA_predicted,2.2222222222222223,27,8,AGTACGTTGTCCTTTTATTA,19,1877159
hyuA_predicted,3.0,34,8,AGGTACGACGATATTTCGAT,26,1856694
hyuA_predicted,0.2222222222222222,9,8,AGGGACATGCGCGCAACCTT,1,1860922
hyuA_predicted,1.4444444444444444,20,8,AGGACAAGTTTATTGCTCAA,12,1829714
hyuA_predicted,0.5555555555555556,12,8,AGCTTATAGCGAGGCATGTA,4,1841425
hyuA_predicted,1.0,16,8,AGCCTCGAGATGCGGGACAT,8,1869137
hyuA_predicted,1.2222222222222223,18,8,AGAGAGTAGCTATTCTGCTG,10,1849182
hyuA_predicted,2.0,25,8,ACTTGTAGGTCTATTATTTT,17,1839181
hyuA_predicted,0.6666666666666666,13,8,ACTTAATCATAGCCTTGACT,5,1864604
hyuA_predicted,3.5555555555555554,39,8,ACTGTCCAAGCTCACAGTAG,31,1867397
hyuA_predicted,0.8888888888888888,15,8,ACTGCCGTGAAAGCCAATTT,7,1865498
hyuA_predicted,0.7777777777777778,14,8,ACTGCACTCATCGGTGAGAT,6,1875117
hyuA_predicted,1.4444444444444444,20,8,ACTGACATCATTATGTCCTT,12,1830181
hyuA_predicted,1.3333333333333333,19,8,ACGGGTTCCCCGAGATCGCA,11,1831009
hyuA_predicted,1.0,16,8,ACGGGACGGCTTCGAGACCC,8,1866059
hyuA_predicted,1.0,16,8,ACGGGAACCACAGCTAACCT,8,1856288
hyuA_predicted,1.8888888888888888,24,8,ACGCGTTGATTCCAGCACTA,16,1829445
hyuA_predicted,3.3333333333333335,37,8,ACCTTATTAATCGACCCTTT,29,1834376
hyuA_predicted,4.111111111111111,44,8,ACCGCTTCCATCATTCAAGG,36,1859698
hyuA_predicted,0.5555555555555556,12,8,ACCATATTCATTGAGATCGG,4,1866288
hyuA_predicted,0.3333333333333333,10,8,ACATAGATACGGCCTCCCTG,2,1837192
hyuA_predicted,0.2222222222222222,9,8,ACACCAGAATGTGATCTGTT,1,1863047
hyuA_predicted,3.7777777777777777,41,8,ACACATGCTTAGCGATTCAG,33,1851722
hyuA_predicted,0.4444444444444444,11,8,ACAATGACATGAGATAGGAA,3,1877816
hyuA_predicted,4.333333333333333,46,8,ACAATCTTAGACTAACAGTG,38,1874351
hyuA_predicted,3.888888888888889,42,8,AAGTTTACCCGGGCACTCAC,34,1851560
hyuA_predicted,0.2222222222222222,9,8,AAGTCAGCATGGTCCGCTTT,1,1831956
hyuA_predicted,0.2222222222222222,9,8,AAGCTCTCGACTCGGCGACT,1,1837314
hyuA_predicted,0.5555555555555556,12,8,AAGATACCCTTATTCATGCT,4,1828949
hyuA_predicted,1.3333333333333333,19,8,AACCTGTGTGTAAACCCTGG,11,1833173
hyuA_predicted,3.5555555555555554,39,8,AACCTGCCAACCGGACGAAG,31,1861749
hyuA_predicted,0.4444444444444444,11,8,AACCGTACTGTATGTTGGTT,3,1848163
hyuA_predicted,0.2222222222222222,9,8,AACCACTGTTAGAACGGACT,1,1835519
hyuA_predicted,1.5555555555555556,21,8,AACACGGATGATTTTGTAGA,13,1875775
hyuA_predicted,5.333333333333333,55,8,AAATCACTCTCGCGTAGTCC,47,1836322
hyuA_predicted,2.6666666666666665,31,8,AAAACATTTGGTTGGGGGCA,23,1846371
hyuA_predicted,2.4444444444444446,29,8,AAAAAGTGGTGACAAAGCAA,21,1860982
hyuA_predicted,1.0,14,7,TTTTTTATTCCGCTCACCTC,7,1865777
hyuA_predicted,0.25,8,7,TTTTGACTCCCATTCAAACC,1,1830126
hyuA_predicted,0.5,10,7,TTTTCGGAATGATGACACAT,3,1832290
hyuA_predicted,0.375,9,7,TTTGCGTGGGGCCAAACGGC,2,1839464
hyuA_predicted,0.25,8,7,TTTCTCCATTTAGCGAAGGA,1,1866810
hyuA_predicted,2.375,25,7,TTGTTTGTCGTCAGTCCTAG,18,1841919
hyuA_predicted,0.375,9,7,TTGGAAGATAATTCCGACAA,2,1849480
hyuA_predicted,0.25,8,7,TTGCCGCGCGCCACGAATAA,1,1845458
hyuA_predicted,4.625,43,7,TTCTTGTATGTGCGCCTAGA,36,1832047
hyuA_predicted,0.25,8,7,TTCTTAAAGCTGAGGGAATC,1,1875933
hyuA_predicted,3.375,33,7,TTCTGTCTGCCAGGTTCTTA,26,1860681
hyuA_predicted,1.25,16,7,TTCTCGCTTGACGTCTGATA,9,1829942
hyuA_predicted,1.25,16,7,TTCGGGGAGCATTTCTGATT,9,1843992
hyuA_predicted,1.125,15,7,TTCACGTCTTGATAACCTTG,8,1873797
hyuA_predicted,2.375,25,7,TTAGGTCGAGGGAACAGTGG,18,1835527
hyuA_predicted,1.75,20,7,TTAGCGATAAATTTCGTATC,13,1876827
hyuA_predicted,0.375,9,7,TTAAGCCAGTTCTTTTGGGA,2,1847629
hyuA_predicted,6.75,60,7,TGTCTGCGTGAGGTAGTCGG,53,1830657
hyuA_predicted,0.625,11,7,TGTATACTGATCTTTTGAGG,4,1838395
hyuA_predicted,2.0,22,7,TGTATAATGTCTCTGTACCA,15,1836221
hyuA_predicted,1.0,14,7,TGGTCTTCCCCGGGCGGTGC,7,1871700
hyuA_predicted,0.5,10,7,TGGCGATTTGTAGGGTCAAG,3,1861386
hyuA_predicted,3.25,32,7,TGGCGAGTGCCGTATTCCGA,25,1859807
hyuA_predicted,0.75,12,7,TGGATGGTCCGTACGACCCC,5,1832917
hyuA_predicted,4.875,45,7,TGGATCCAGCAACATCCTGT,38,1848827
hyuA_predicted,0.5,10,7,TGCTGGGCAAAAGAGACAGT,3,1830617
hyuA_predicted,0.25,8,7,TGCGACGGTGAGGCGTAGTC,1,1863574
hyuA_predicted,2.125,23,7,TGACTACGCTGGGCGTGGAA,16,1871003
hyuA_predicted,0.25,8,7,TGAATCATGGAGACAGGAGT,1,1863911
hyuA_predicted,1.25,16,7,TCTTCCAATTTGCTAGCCTA,9,1836619
hyuA_predicted,1.375,17,7,TCTCTGCCACACCAATACTC,10,1856158
hyuA_predicted,0.625,11,7,TCTCCGGAGCTCAATACTTG,4,1841143
hyuA_predicted,0.875,13,7,TCGTTTTAGGTCCTGATATT,6,1848262
hyuA_predicted,0.5,10,7,TCGTCGATACCGTAACGAGA,3,1864553
hyuA_predicted,2.125,23,7,TCGGTCTAGCGAATTACGGA,16,1866590
hyuA_predicted,2.375,25,7,TCGGTCGGGAACGGCTAGGA,18,1835263
hyuA_predicted,1.625,19,7,TCGGTAAGTGGGAACACGAG,12,1848152
hyuA_predicted,4.125,39,7,TCCCTTGGTACGTAATCTCT,32,1855952
hyuA_predicted,0.25,8,7,TCCACTCATGATTTATATCT,1,1871542
hyuA_predicted,2.125,23,7,TCATTTCCCGGCTTAAACTT,16,1833673
hyuA_predicted,1.875,21,7,TCATCGTCCTCCCATAACCG,14,1853288
hyuA_predicted,0.5,10,7,TCATCCATTAACAATCTTTA,3,1832771
hyuA_predicted,2.125,23,7,TCACGTGGTTGTCGATCCAA,16,1842176
hyuA_predicted,1.625,19,7,TCACGTCGTGGATCGTGGCA,12,1866155
hyuA_predicted,0.625,11,7,TCACGACCATGCAGTATACT,4,1845421
hyuA_predicted,0.25,8,7,TCAACCGGCAGCAGCCTAAC,1,1847825
hyuA_predicted,2.25,24,7,TCAACCGAGATAACACTAGC,17,1839242
hyuA_predicted,2.125,23,7,TATTTGGCAGCACTTCATCC,16,1843837
hyuA_predicted,0.625,11,7,TATTGTCTTGGGTAACGAAA,4,1866407
hyuA_predicted,0.75,12,7,TATGAGCTGAACAACATTCA,5,1857654
hyuA_predicted,0.5,10,7,TATGAGCGAAACGATGGCAG,3,1835376
hyuA_predicted,2.375,25,7,TATCGTACCTTTATGAGAGT,18,1841887
hyuA_predicted,0.625,11,7,TATCCGGTTACGGCATTGGC,4,1863594
hyuA_predicted,0.375,9,7,TATCAGTGCCCGGGTTAAGT,2,1855594
hyuA_predicted,0.25,8,7,TATACACAGATAATAGTTAA,1,1839343
hyuA_predicted,1.625,19,7,TAGGGGTATGCGATGTTCTC,12,1869047
hyuA_predicted,0.5,10,7,TACGACAGGTACTATGGTAT,3,1831234
hyuA_predicted,0.25,8,7,TACATGAAAGGAGTCTCGGA,1,1861576
hyuA_predicted,1.625,19,7,TACAACACCATATACTGCGT,12,1843861
hyuA_predicted,1.25,16,7,TAATTCCATGACTCGGCAGC,9,1838211
hyuA_predicted,0.625,11,7,TAAGATCATTGTTTTAAAAG,4,1870559
hyuA_predicted,1.875,21,7,TAACCGGCGAGGGTAGAGCA,14,1829212
hyuA_predicted,3.0,30,7,GTTCTGGTATACGCCTCTCG,23,1855508
hyuA_predicted,1.625,19,7,GTTCACGCCACCTCATGACA,12,1864178
hyuA_predicted,0.75,12,7,GTTATGAGTGTCGAGGTTGC,5,1834231
hyuA_predicted,0.25,8,7,GTGGCTAGGTACGGCGCCAT,1,1855721
hyuA_predicted,1.875,21,7,GTGCACCTGTACCATTGGTA,14,1839154
hyuA_predicted,2.125,23,7,GTCGAGGCCACTCGGTCGTA,16,1852980
hyuA_predicted,0.25,8,7,GTACCCGTTCGACGACTAGG,1,1859638
hyuA_predicted,3.5,34,7,GGTTGTGAGATGCTGCGGTC,27,1835143
hyuA_predicted,1.5,18,7,GGTTGCACATCGAGGCAGCT,11,1841619
hyuA_predicted,0.875,13,7,GGTGTATGGTTTTTGAGTAA,6,1848699
hyuA_predicted,1.125,15,7,GGTGATCTCGCGTTATAGCA,8,1846294
hyuA_predicted,0.75,12,7,GGTAGTTTCTCTCTCCGTTA,5,1832882
hyuA_predicted,0.875,13,7,GGTAAGAGCGGAATGAAGCC,6,1830383
hyuA_predicted,0.625,11,7,GGGTGATACTAGAATTTGAG,4,1866650
hyuA_predicted,0.375,9,7,GGGTCGCTATGCAGGGCTCA,2,1838140
hyuA_predicted,0.375,9,7,GGGGCTTGGGGGAGGACCAC,2,1844955
hyuA_predicted,3.5,34,7,GGCTTTTCAGGCCGCCATGT,27,1841449
hyuA_predicted,2.0,22,7,GGCTGCCGCAGCTGTTCGGC,15,1845462
hyuA_predicted,0.75,12,7,GGCTAAGGGATCAAGACTGT,5,1866621
hyuA_predicted,1.875,21,7,GGCGGAACCTATCTGGCGTA,14,1860118
hyuA_predicted,2.625,27,7,GGCGCGTGCACGGTTGTTGT,20,1863591
hyuA_predicted,0.75,12,7,GGCACGGAACATGAGCATCA,5,1838747
hyuA_predicted,0.5,10,7,GGATAACTGTCATGGATAGG,3,1861405
hyuA_predicted,2.0,22,7,GGACTTTGTAGATATAACCT,15,1862144
hyuA_predicted,0.25,8,7,GGAATGCATCTGATTATCAG,1,1837215
hyuA_predicted,0.25,8,7,GCTGAAAGCGTTGTTCGTAT,1,1833507
hyuA_predicted,1.25,16,7,GCTCATTTTTAAAACTGGAT,9,1865827
hyuA_predicted,1.0,14,7,GCTATTAGGGGCTTTGCGGA,7,1855938
hyuA_predicted,0.25,8,7,GCTACGAGATTTCACACCTT,1,1844865
hyuA_predicted,0.25,8,7,GCGCGCTGCTACTCTTCCGT,1,1875646
hyuA_predicted,2.25,24,7,GCGCGAGTCTACAAGCCAGT,17,1868061
hyuA_predicted,0.375,9,7,GCGACCACAGATTTCAACGA,2,1856214
hyuA_predicted,1.75,20,7,GCCCTGTCAATGCTGTACGA,13,1869386
hyuA_predicted,0.375,9,7,GCCCTCGAGTTTAGAGATCA,2,1873135
hyuA_predicted,0.5,10,7,GCCCCTTCTCACTGCTATGG,3,1868302
hyuA_predicted,0.375,9,7,GCCCATACCCGGTCAATTAG,2,1842253
hyuA_predicted,2.25,24,7,GCCATGTTATACAAGTACCA,17,1831345
hyuA_predicted,5.75,52,7,GCCAACCTGGAATATGCGTA,45,1834040
hyuA_predicted,1.625,19,7,GCAGTTTAGTCTGCGTCGTA,12,1854874
hyuA_predicted,0.625,11,7,GCAATCGTGCCCGCATCGCA,4,1837752
hyuA_predicted,4.0,38,7,GATTCTTAAATCAGGAACGC,31,1851054
hyuA_predicted,1.5,18,7,GATAGTCAGGCGACCAACAC,11,1856952
hyuA_predicted,4.75,44,7,GATACAAGACTTTGCGTCAC,37,1864009
hyuA_predicted,2.625,27,7,GAGTGTCCATTGGCGTCGTT,20,1855787
hyuA_predicted,2.25,24,7,GAGGGCTTTACTGACAGATG,17,1829273
hyuA_predicted,1.125,15,7,GAGGCGTCCGGTCATCTACT,8,1838051
hyuA_predicted,0.875,13,7,GAGCGCCTTCAATTTCGTAT,6,1848669
hyuA_predicted,5.875,53,7,GAGACTTGTCTTCCTGACTC,46,1832747
hyuA_predicted,0.875,13,7,GACTTCTTCGCATGGCACAC,6,1849446
hyuA_predicted,2.375,25,7,GACTCGTTGGGGCCGCACCA,18,1847911
hyuA_predicted,0.5,10,7,GACTCCTAAAAGGTCAAGCT,3,1837547
hyuA_predicted,0.75,12,7,GACGAAAAGGTTACTTGTAT,5,1846564
hyuA_predicted,1.0,14,7,GACCGACCGCGCGTCGCATT,7,1832150
hyuA_predicted,1.75,20,7,GACACGCGTGCTAAGCTGGG,13,1851988
hyuA_predicted,1.625,19,7,GACAAACGGGGGAAACGGTT,12,1866332
hyuA_predicted,2.125,23,7,GAATGCGGTATGAATCCAGT,16,1861711
hyuA_predicted,0.25,8,7,GAAATGGGAAGTATGTGGCT,1,1847726
hyuA_predicted,0.25,8,7,CTTTTTGCGGCACCCGGCGC,1,1870455
hyuA_predicted,2.0,22,7,CTTTAAGCGCCCTTATTGAA,15,1844115
hyuA_predicted,0.5,10,7,CTTCTCGAGAAAAAAACTGA,3,1835716
hyuA_predicted,0.5,10,7,CTTCAGCGATTATTCGGGCT,3,1856869
hyuA_predicted,2.375,25,7,CTGGTTGAACGATAATACAA,18,1860006
hyuA_predicted,0.375,9,7,CTGGAGGGCACTTCGTTGTA,2,1838442
hyuA_predicted,1.625,19,7,CTGAGCGATCGATTTCCGCT,12,1835080
hyuA_predicted,0.25,8,7,CTGAGAGCTTCCTATTCCAA,1,1845314
hyuA_predicted,1.25,16,7,CTCGAAGTACCTCATCGTCT,9,1846296
hyuA_predicted,3.125,31,7,CTATTTGCCGGACATGGAGG,24,1844254
hyuA_predicted,0.375,9,7,CTATACGTCAACTCGGGTAA,2,1861892
hyuA_predicted,2.875,29,7,CTACGCCGTAAATGCTGGAT,22,1842306
hyuA_predicted,1.875,21,7,CTAATGCGATTAGTATGCCT,14,1856911
hyuA_predicted,5.5,50,7,CGGTCAGGGATCGCTTCGGT,43,1850231
hyuA_predicted,0.5,10,7,CGGGCATGCCAAACCAACTT,3,1834357
hyuA_predicted,0.375,9,7,CGGCCTGACCGTGAGGCGTA,2,1858090
hyuA_predicted,2.125,23,7,CGGCCCTGGACCTTGCGGTT,16,1862402
hyuA_predicted,0.625,11,7,CGCTACGGACTCTTCCAATC,4,1860087
hyuA_predicted,0.875,13,7,CGCGTGGTCTAGAGCTTCAA,6,1848641
hyuA_predicted,0.25,8,7,CGAGCGAGCGGGAACCTTAT,1,1846520
hyuA_predicted,0.5,10,7,CGAGCAAACTAACCATCAAT,3,1845337
hyuA_predicted,1.875,21,7,CCTTTTGAACGGCTCTATTT,14,1868376
hyuA_predicted,2.0,22,7,CCTTGGCCGTTTTAGATTCG,15,1847864
hyuA_predicted,0.875,13,7,CCTGGTCAGTACATAATCGA,6,1829727
hyuA_predicted,2.0,22,7,CCTGCTCTGCTCAGGACATT,15,1850897
hyuA_predicted,0.75,12,7,CCTGATCCCTTAACGGACCT,5,1863842
hyuA_predicted,2.0,22,7,CCTCAGGATATCTTCGCAAA,15,1848101
hyuA_predicted,0.25,8,7,CCTCACGCCCCAAGGCAAGT,1,1842672
hyuA_predicted,2.125,23,7,CCTACCCGTCACTGGCTCCG,16,1830770
hyuA_predicted,2.625,27,7,CCTAACGTAACTCGAGCAAG,20,1853636
hyuA_predicted,4.125,39,7,CCTAACACATAGCAGTAGTT,32,1871659
hyuA_predicted,0.25,8,7,CCGACAGAAGAGTCGGGGCT,1,1832872
hyuA_predicted,2.625,27,7,CCGAACCTGCGACCCTGTTG,20,1831150
hyuA_predicted,2.25,24,7,CCCCGAGCGTGTTACCTGGA,17,1857569
hyuA_predicted,2.75,28,7,CCCCCGTTCATGGCGCTGTC,21,1841194
hyuA_predicted,1.5,18,7,CCCCCGGTATATAAGCTGGG,11,1876720
hyuA_predicted,0.75,12,7,CCCCATTTACATCGGGTCGT,5,1860098
hyuA_predicted,0.25,8,7,CCCATGTGATGGGGTCGATG,1,1839372
hyuA_predicted,1.875,21,7,CCCATCAAGTTCCGTCACAG,14,1868550
hyuA_predicted,1.5,18,7,CCCAAGGGTTTGCCGGCCCT,11,1865112
hyuA_predicted,3.0,30,7,CCATTCCGACACGAAACTCG,23,1875556
hyuA_predicted,1.75,20,7,CCAGGTAGGACAGTCGGGCT,13,1833483
hyuA_predicted,1.125,15,7,CCACTAGATCAGTTTAGGAG,8,1869947
hyuA_predicted,0.75,12,7,CATAGCGGTACCCCCGCCCA,5,1849942
hyuA_predicted,3.0,30,7,CATAAAACGGCGCTTAGGGT,23,1844802
hyuA_predicted,3.0,30,7,CAGTTGGGAGCGTGGGCTAT,23,1867526
hyuA_predicted,4.5,42,7,CAGTAGGTTATGAACGGATT,35,1863096
hyuA_predicted,3.125,31,7,CAGCCTTCTCTAATATGAAG,24,1873271
hyuA_predicted,3.75,36,7,CACTTTGGTTGCGACCTCTG,29,1874616
hyuA_predicted,2.875,29,7,CACGTGGACGCGAATACTAC,22,1836242
hyuA_predicted,0.375,9,7,CACCGTCTAAGAGGGGGCGG,2,1867470
hyuA_predicted,0.25,8,7,CAATCTACTGCGCTATGGTG,1,1877520
hyuA_predicted,0.625,11,7,CAAAAGGCATGAGGAATACG,4,1854134
hyuA_predicted,2.375,25,7,ATTGATCTTGGGGGAAGAGA,18,1833073
hyuA_predicted,1.25,16,7,ATTCTTAGCATGAAGGGGGT,9,1875983
hyuA_predicted,2.375,25,7,ATTCTTACGACAGGAAGCCC,18,1845565
hyuA_predicted,3.625,35,7,ATTCAGCCTTTGAAAGTTGT,28,1861482
hyuA_predicted,7.75,68,7,ATTACCAGGCTCGGGAAGGT,61,1876220
hyuA_predicted,1.125,15,7,ATGGGGGATCATACTACCGA,8,1833341
hyuA_predicted,1.75,20,7,ATGGCTAATCGTGCGTGAGA,13,1868387
hyuA_predicted,2.375,25,7,ATGACAGTTGAGTGAATTTC,18,1834862
hyuA_predicted,0.75,12,7,ATCTTAACCTATGGACTTTA,5,1869059
hyuA_predicted,0.75,12,7,ATCTATGACAATTCGCACTG,5,1858642
hyuA_predicted,2.375,25,7,ATCGTAGGACATCAGAGTGT,18,1876812
hyuA_predicted,0.625,11,7,ATCCTGTGTATGCCTCGGGA,4,1837435
hyuA_predicted,1.625,19,7,ATCCATGCCGATTTGACCGC,12,1864874
hyuA_predicted,1.375,17,7,ATCCACTTACGGCGACCGAG,10,1862680
hyuA_predicted,0.875,13,7,ATCATAGTTCGCAGCGTACA,6,1873210
hyuA_predicted,1.75,20,7,ATATCCCGGACTCTGGCTGC,13,1857446
hyuA_predicted,1.5,18,7,AGTTTGTGTATGTAGACGAC,11,1834148
hyuA_predicted,0.375,9,7,AGTCGTCCGGCAACCCCTGG,2,1864466
hyuA_predicted,1.625,19,7,AGTCAATTGTGGGGTGCCAA,12,1845715
hyuA_predicted,0.625,11,7,AGTAGGTTCACCTCAGCGAA,4,1849969
hyuA_predicted,0.25,8,7,AGTAGACCACGATATTAAAG,1,1855444
hyuA_predicted,2.25,24,7,AGTAACGTTTCCAGTCCACT,17,1874216
hyuA_predicted,2.375,25,7,AGGGGGTGTCATGGCCGGCT,18,1869654
hyuA_predicted,0.25,8,7,AGGATGCCACGTCGTCTCCC,1,1860906
hyuA_predicted,0.5,10,7,AGGATGCCAAAAGTGACTAA,3,1849866
hyuA_predicted,1.0,14,7,AGCTTTACCATGGCGCGGGA,7,1838123
hyuA_predicted,1.625,19,7,AGCCTGGGGACTACAAATAA,12,1846752
hyuA_predicted,0.25,8,7,AGCCTATAAGTCAAGTAGGT,1,1859084
hyuA_predicted,1.0,14,7,AGCCAGCGGGTCTGTGGCAT,7,1870289
hyuA_predicted,0.25,8,7,AGCATTATGCCGCTACTGTC,1,1852438
hyuA_predicted,0.75,12,7,AGAAATGACTCCCTGTTTTT,5,1848255
hyuA_predicted,1.875,21,7,ACTCGTTAAGGTGTATTTGG,14,1829257
hyuA_predicted,0.375,9,7,ACTCCAATCAAGAGACATGA,2,1832826
hyuA_predicted,0.625,11,7,ACGCGGTGGAGCACGAACGT,4,1873039
hyuA_predicted,1.5,18,7,ACGAAGCAGAGTCCCATCCA,11,1854407
hyuA_predicted,0.25,8,7,ACCTGTACACCCCTAAAGTA,1,1877029
hyuA_predicted,2.25,24,7,ACCTCCACCCGGGTCCTTAG,17,1872077
hyuA_predicted,0.625,11,7,ACCTAGGGTGCATCCGAGTA,4,1847352
hyuA_predicted,0.875,13,7,ACCGTTGTGTGCGACTCTCT,6,1844910
hyuA_predicted,2.125,23,7,ACCGGACCGTGAAATACCTT,16,1829588
hyuA_predicted,1.25,16,7,ACCCAGTTAGCGCGCCGCTT,9,1855786
hyuA_predicted,3.375,33,7,ACATACGAAGGCCTCCGGGT,26,1873246
hyuA_predicted,3.5,34,7,ACACACCACAGCATTTATGA,27,1872906
hyuA_predicted,2.75,28,7,ACAATATTGTTCACACACCT,21,1858344
hyuA_predicted,0.75,12,7,ACAAGGGAGCTCCGATTGTT,5,1846100
hyuA_predicted,0.375,9,7,AATTATACGGGGATAATCTT,2,1839137
hyuA_predicted,1.375,17,7,AATGTCGGCTCGTCATGTTA,10,1872289
hyuA_predicted,1.125,15,7,AATGACATGGGCAGGCCTTC,8,1833727
hyuA_predicted,2.5,26,7,AATCTTGGGCGGTGTCCCAT,19,1839823
hyuA_predicted,0.375,9,7,AAGTTAACAACCTCTCGGCA,2,1870918
hyuA_predicted,0.375,9,7,AAGTAGGTGAGCACTCCGCG,2,1834433
hyuA_predicted,0.25,8,7,AAGGGTCCCTCAGAATGCCA,1,1838858
hyuA_predicted,0.25,8,7,AAGGGTAAGGCAACGAGAAA,1,1830509
hyuA_predicted,0.25,8,7,AAGAGATGTGGGCTTAGGTA,1,1839331
hyuA_predicted,0.625,11,7,AACCCTTGACCGATCGGTTC,4,1847325
hyuA_predicted,2.5,26,7,AACAATCGTAGCGAGGGGCA,19,1875272
hyuA_predicted,0.875,13,7,AAACACGGTCGGGAGACGCA,6,1839121
hyuA_predicted,1.2857142857142858,14,6,TTTTCACTCGTTTGCGTCTA,8,1847025
hyuA_predicted,4.714285714285714,38,6,TTTTCACCGCATCGTTCTCT,32,1866254
hyuA_predicted,1.1428571428571428,13,6,TTTACGGATCTACGTTATCG,7,1853996
hyuA_predicted,1.0,12,6,TTGTCCGTCTGCCCTCAAAA,6,1872537
hyuA_predicted,4.0,33,6,TTGGGTCGGCTCTTTCATAT,27,1862666
hyuA_predicted,0.2857142857142857,7,6,TTGGACACAGGAAATCAGAT,1,1868238
hyuA_predicted,0.5714285714285714,9,6,TTGCGGCCGTCACACCCCCG,3,1838403
hyuA_predicted,2.2857142857142856,21,6,TTGCATATACTTTGGTGCCG,15,1842705
hyuA_predicted,2.2857142857142856,21,6,TTGATTAGTGCCATATCCAT,15,1874948
hyuA_predicted,4.857142857142857,39,6,TTGAGCTCCGGCCTTGCCCT,33,1852987
hyuA_predicted,0.8571428571428571,11,6,TTCTTAGTCAACACGGGCTA,5,1833862
hyuA_predicted,0.5714285714285714,9,6,TTCTGGCTTTCTATTTACAG,3,1863049
hyuA_predicted,1.2857142857142858,14,6,TTCGGTTACGCACGTCGGTC,8,1837004
hyuA_predicted,3.0,26,6,TTCAGGATACGCGGCAGGCC,20,1869864
hyuA_predicted,1.7142857142857142,17,6,TTATACTCTGACAGGTAGAA,11,1840982
hyuA_predicted,0.2857142857142857,7,6,TTACGCTTTATCCACACCTT,1,1857836
hyuA_predicted,0.7142857142857143,10,6,TTAAGCGTTCAGATCGTTAT,4,1864900
hyuA_predicted,0.5714285714285714,9,6,TTAAGCCTGTCTCTCCGAAA,3,1846247
hyuA_predicted,0.2857142857142857,7,6,TGTTGCATTTTCGGCTTGTT,1,1838568
hyuA_predicted,0.8571428571428571,11,6,TGTGCCCACCTGGGTCAGGG,5,1835463
hyuA_predicted,0.2857142857142857,7,6,TGTCGAGTACGTTGACCGTT,1,1850549
hyuA_predicted,0.5714285714285714,9,6,TGTCAATAATATATGCGCCA,3,1842644
hyuA_predicted,1.1428571428571428,13,6,TGTAGGCATGCAGACCTAGT,7,1854019
hyuA_predicted,3.5714285714285716,30,6,TGGGTTTTTGTCATCAATAA,24,1872866
hyuA_predicted,0.5714285714285714,9,6,TGGGGCGCGAGACCTTGGGG,3,1837462
hyuA_predicted,4.857142857142857,39,6,TGGACACGACTGGTCCCACA,33,1846057
hyuA_predicted,0.2857142857142857,7,6,TGCTTTTACGCACAAGCCTC,1,1841908
hyuA_predicted,0.2857142857142857,7,6,TGCGACAAGCCGGCTGAGAA,1,1848084
hyuA_predicted,1.4285714285714286,15,6,TGCAGGGACTCCGAGAGCAA,9,1856247
hyuA_predicted,2.2857142857142856,21,6,TGATTCGTACCTCAAGCTCC,15,1873593
hyuA_predicted,1.1428571428571428,13,6,TGAGAGCATCATTTATCGTG,7,1848482
hyuA_predicted,2.4285714285714284,22,6,TGACCTATACGTAGTTCAAT,16,1838387
hyuA_predicted,3.0,26,6,TGACAGACATTGGGCCTTAA,20,1836080
hyuA_predicted,0.7142857142857143,10,6,TGACAAACCTTGCTCTTCCT,4,1870723
hyuA_predicted,0.5714285714285714,9,6,TGAAGGCAAGAACACTCGTA,3,1854482
hyuA_predicted,0.5714285714285714,9,6,TGAAGGAATAAAAACTCAAG,3,1845620
hyuA_predicted,0.5714285714285714,9,6,TGAAGATTACTCTTCTAGCC,3,1844618
hyuA_predicted,2.857142857142857,25,6,TCTTGGATAGGAGACCCATT,19,1869977
hyuA_predicted,0.2857142857142857,7,6,TCTTAATATAAACGACAATG,1,1856676
hyuA_predicted,3.0,26,6,TCTATAGACAAACTGCCTAG,20,1876152
hyuA_predicted,0.5714285714285714,9,6,TCGTCTGTGGCAAACTGATG,3,1853251
hyuA_predicted,1.1428571428571428,13,6,TCGTCGGTCATGAATGGTGA,7,1853372
hyuA_predicted,0.2857142857142857,7,6,TCCGCAAATCTCGCTAGGCT,1,1853471
hyuA_predicted,0.2857142857142857,7,6,TCCGACACGCGTAAGCGAAC,1,1832235
hyuA_predicted,2.4285714285714284,22,6,TCCCTCCCGCGTCACCGTGA,16,1861061
hyuA_predicted,0.7142857142857143,10,6,TCCACAGTAAGTACGTCCGG,4,1833861
hyuA_predicted,1.4285714285714286,15,6,TCAGGTTTGGCGGGTCTGAA,9,1864999
hyuA_predicted,1.1428571428571428,13,6,TCACTCGCTTGCGTACATTC,7,1875124
hyuA_predicted,0.2857142857142857,7,6,TCAAGATAAAAATATCGCAA,1,1842456
hyuA_predicted,0.5714285714285714,9,6,TATTCAAAGCTAGTCCCGCA,3,1856329
hyuA_predicted,3.142857142857143,27,6,TATGCTACCAGATATGCATC,21,1840692
hyuA_predicted,0.42857142857142855,8,6,TAGAATACCCTACGATTCAA,2,1842850
hyuA_predicted,2.4285714285714284,22,6,TACGGCGCTACGCGCCATTA,16,1836947
hyuA_predicted,2.142857142857143,20,6,TACCTCGTTTCATGTGGAGC,14,1843983
hyuA_predicted,0.2857142857142857,7,6,TACCCGTTTTGAGGTTCGGT,1,1835189
hyuA_predicted,2.2857142857142856,21,6,TACCAGCGGACTGCCAATAG,15,1870656
hyuA_predicted,2.857142857142857,25,6,TACATTTTCAAGTCCTCCAC,19,1855243
hyuA_predicted,1.4285714285714286,15,6,TAATAGGTATGTCAGGATTT,9,1856920
hyuA_predicted,10.142857142857142,76,6,TAAGGTCCCACAACCTTTCT,70,1857241
hyuA_predicted,1.4285714285714286,15,6,TAAAGCACCTCCCCAGGTGT,9,1829648
hyuA_predicted,2.4285714285714284,22,6,TAAAAACTTAAGATTCGGCT,16,1853836
hyuA_predicted,1.4285714285714286,15,6,GTTCTGATCCCATCGCTGAG,9,1855665
hyuA_predicted,1.7142857142857142,17,6,GTTCAAAGGTCAGTTGTAAA,11,1840184
hyuA_predicted,1.7142857142857142,17,6,GTTATAATCGTTCAAACGGA,11,1837483
hyuA_predicted,1.1428571428571428,13,6,GTTACAGACGGGCTTAGTTA,7,1855249
hyuA_predicted,1.0,12,6,GTGTTGGGTAGCTTTTTGTG,6,1867737
hyuA_predicted,2.5714285714285716,23,6,GTGTGTCCGCTCAGGACAAC,17,1871029
hyuA_predicted,3.857142857142857,32,6,GTGTGGAGAGCACGGGGGTA,26,1868738
hyuA_predicted,3.142857142857143,27,6,GTGTCTATTCCCGATGTTAC,21,1871439
hyuA_predicted,1.1428571428571428,13,6,GTGTCATTATACCCCTCATC,7,1833976
hyuA_predicted,0.2857142857142857,7,6,GTGCTTATTATCATGTACGG,1,1872895
hyuA_predicted,0.2857142857142857,7,6,GTGCAGACTAGAGCTAAAAA,1,1851062
hyuA_predicted,0.7142857142857143,10,6,GTGAACCTCAAGAAGAAGCA,4,1868318
hyuA_predicted,0.8571428571428571,11,6,GTCTTTACGTAGGTAATTAC,5,1866025
hyuA_predicted,3.4285714285714284,29,6,GTCGCCCTATGATCTAAAAT,23,1853364
hyuA_predicted,2.4285714285714284,22,6,GTCCATACATCTGTGACGGC,16,1859573
hyuA_predicted,3.142857142857143,27,6,GTCATCTACCCCCCGCTCGA,21,1851223
hyuA_predicted,0.5714285714285714,9,6,GTATGGGTTCGCGTCTTAGA,3,1844084
hyuA_predicted,0.2857142857142857,7,6,GTATCAGCGCATTAGATCAC,1,1831771
hyuA_predicted,3.4285714285714284,29,6,GTATAAGTATATGGAGCTAG,23,1836398
hyuA_predicted,1.0,12,6,GTAGTTTCCGAGACGCTGAG,6,1863249
hyuA_predicted,0.5714285714285714,9,6,GTAGGGTATACCGGCAGAAT,3,1856617
hyuA_predicted,0.7142857142857143,10,6,GTAGGATCGTCTAAGGTGGT,4,1860745
hyuA_predicted,0.8571428571428571,11,6,GTAATGGCGCGACTTGTAGG,5,1874517
hyuA_predicted,2.7142857142857144,24,6,GTAAGGTTATCAAGCTAACG,18,1845696
hyuA_predicted,0.2857142857142857,7,6,GTAAAACGGGCCGCTAGGAG,1,1868683
hyuA_predicted,1.7142857142857142,17,6,GGTGAGTGGGTGGAATTGGA,11,1843956
hyuA_predicted,2.4285714285714284,22,6,GGTGACTCTGCATGTGGTAC,16,1842666
hyuA_predicted,1.7142857142857142,17,6,GGTGAACGCTAGAGAGGAGA,11,1870796
hyuA_predicted,0.2857142857142857,7,6,GGTCTATGGTCACTTTCAGT,1,1862461
hyuA_predicted,0.2857142857142857,7,6,GGTATTACGGCTCGGATATA,1,1861766
hyuA_predicted,0.42857142857142855,8,6,GGTACACGGGGGTCCAATGC,2,1847837
hyuA_predicted,8.0,61,6,GGGTTAACGAATCGTGCGGC,55,1852615
hyuA_predicted,2.0,19,6,GGGTAAATAGGCGGGAGATG,13,1873141
hyuA_predicted,2.5714285714285716,23,6,GGGGTATTTCGGTCTGACAG,17,1829955
hyuA_predicted,6.714285714285714,52,6,GGGGCCATGCCGCACGGGCT,46,1862718
hyuA_predicted,4.714285714285714,38,6,GGGGCACGCTTCAATTCTAG,32,1849654
hyuA_predicted,1.5714285714285714,16,6,GGGACGAGTGCAAACGCTCC,10,1862572
hyuA_predicted,0.2857142857142857,7,6,GGCTTGGCAGTTTGCAAGAA,1,1829411
hyuA_predicted,4.285714285714286,35,6,GGCTGAACCGGATAAGAGGG,29,1848964
hyuA_predicted,0.8571428571428571,11,6,GGCATTCACATCTCGGTCTT,5,1877684
hyuA_predicted,0.5714285714285714,9,6,GGCAGTTTGTCGGACCCGGC,3,1859918
hyuA_predicted,2.5714285714285716,23,6,GGATCTAAGGGTACAACCAC,17,1855889
hyuA_predicted,0.7142857142857143,10,6,GGAAGCAACTGAAGGGTTGA,4,1869603
hyuA_predicted,3.142857142857143,27,6,GCTTGTTCCGCTCGTGGATA,21,1869958
hyuA_predicted,1.8571428571428572,18,6,GCTGCAGGTCCCATGGTCCC,12,1840869
hyuA_predicted,0.2857142857142857,7,6,GCTGCAAAAGAAACGTGGTG,1,1832444
hyuA_predicted,1.4285714285714286,15,6,GCTCTGGTGATTCTGGAGGG,9,1869802
hyuA_predicted,3.7142857142857144,31,6,GCTATCAACAACGGAAACAT,25,1852965
hyuA_predicted,2.7142857142857144,24,6,GCTAGCCGGAGCCCCACCTA,18,1862156
hyuA_predicted,0.2857142857142857,7,6,GCTACGCGACTAACCTTCCA,1,1832078
hyuA_predicted,1.0,12,6,GCTACATGCGCTGAAATTCG,6,1841465
hyuA_predicted,0.42857142857142855,8,6,GCGTTAGCCGGCTCTTATCG,2,1861562
hyuA_predicted,1.7142857142857142,17,6,GCGTATTGTTAACGGTGATC,11,1873283
hyuA_predicted,0.7142857142857143,10,6,GCGGACTTTATTATTTTCAC,4,1847631
hyuA_predicted,0.42857142857142855,8,6,GCGGACTTCTCTAGGTCTTA,2,1849236
hyuA_predicted,2.142857142857143,20,6,GCGGACCCCAGTGACTCTTC,14,1866239
hyuA_predicted,1.5714285714285714,16,6,GCGCCTCGGTGGCCGATGCT,10,1859764
hyuA_predicted,3.2857142857142856,28,6,GCGCCAACAACGTAGAACAA,22,1860756
hyuA_predicted,1.0,12,6,GCCGTTTAGCTGAACATCGT,6,1845334
hyuA_predicted,0.2857142857142857,7,6,GCCGCTCCACGATTTTTCGG,1,1859919
hyuA_predicted,1.4285714285714286,15,6,GCCAGGCTAGGTCGGAACTA,9,1829004
hyuA_predicted,1.2857142857142858,14,6,GCCAATCAAGTGGTGATGTC,8,1874735
hyuA_predicted,1.0,12,6,GCACTCACAGTCAGTCCTCC,6,1832401
hyuA_predicted,0.5714285714285714,9,6,GCACCGTGGGACTACCACGG,3,1856026
hyuA_predicted,3.2857142857142856,28,6,GATTGAGGCGGTTACCTCGT,22,1833816
hyuA_predicted,1.1428571428571428,13,6,GATGGCATAACGGGAGGCTC,7,1859932
hyuA_predicted,0.2857142857142857,7,6,GATGCAGCCCTCTTACATAG,1,1829017
hyuA_predicted,4.857142857142857,39,6,GATATGGACACGCATTAAAC,33,1838324
hyuA_predicted,8.428571428571429,64,6,GATAGATTTGAGCGTTAAGG,58,1851562
hyuA_predicted,2.0,19,6,GAGTTTACGAACAGCCAGGT,13,1870458
hyuA_predicted,2.142857142857143,20,6,GAGTTCCACTATTCTGGCTA,14,1862654
hyuA_predicted,2.7142857142857144,24,6,GAGGTTTCACGGAAATCCAG,18,1837248
hyuA_predicted,0.8571428571428571,11,6,GAGGGCCTGTATCGACGCTC,5,1862030
hyuA_predicted,6.285714285714286,49,6,GAGGCCCCTTGAAGATAGTA,43,1847589
hyuA_predicted,6.714285714285714,52,6,GAGCCGGATCTTTCTTAGCC,46,1845089
hyuA_predicted,1.0,12,6,GACTCCGTCCAAGACGGAGT,6,1831402
hyuA_predicted,0.7142857142857143,10,6,GACGGAACGCCATTCGTAGG,4,1851570
hyuA_predicted,0.42857142857142855,8,6,GACACGCAACCCGTAGATAT,2,1840899
hyuA_predicted,1.4285714285714286,15,6,GAATGTTCGCTTTTCTGGCG,9,1852031
hyuA_predicted,0.42857142857142855,8,6,GAATGACTGCAGTATCTGTC,2,1849880
hyuA_predicted,1.2857142857142858,14,6,GAACGGGTTTTCATAGCCTA,8,1849161
hyuA_predicted,1.4285714285714286,15,6,GAACAGATTCAATGAAACTC,9,1852558
hyuA_predicted,2.142857142857143,20,6,GAAATTACCTTGGTCACGGG,14,1861011
hyuA_predicted,0.7142857142857143,10,6,GAAACCCACGGCTCGTTTTA,4,1831416
hyuA_predicted,0.5714285714285714,9,6,GAAACAAAGCATGCGCGTAT,3,1833244
hyuA_predicted,1.8571428571428572,18,6,GAAAAGTCCTCCTTAAGCGT,12,1863777
hyuA_predicted,1.1428571428571428,13,6,CTTGGATATCCTGCCAGCAA,7,1843539
hyuA_predicted,0.42857142857142855,8,6,CTTACACTGTATGGCGCAAT,2,1841952
hyuA_predicted,4.285714285714286,35,6,CTGTCTACTGGAGTTATTCT,29,1843433
hyuA_predicted,1.8571428571428572,18,6,CTGTCTACGCTTTTTTCGAT,12,1866174
hyuA_predicted,1.7142857142857142,17,6,CTGTCGTATTGCTCCTAGCG,11,1830874
hyuA_predicted,0.8571428571428571,11,6,CTGTCCACTATTGAACCACG,5,1861754
hyuA_predicted,0.5714285714285714,9,6,CTGCGATCACTGCGAGGGTT,3,1861859
hyuA_predicted,0.42857142857142855,8,6,CTGATACCCGTGTTAAATAT,2,1856960
hyuA_predicted,0.8571428571428571,11,6,CTGACTACCCACACGCGAGT,5,1841958
hyuA_predicted,0.5714285714285714,9,6,CTGAACACTGTCTGCGAAAG,3,1855358
hyuA_predicted,0.8571428571428571,11,6,CTCCTTTGCCCGACTTCACG,5,1860357
hyuA_predicted,0.42857142857142855,8,6,CTCCGGTCTGATCGCAATAC,2,1864012
hyuA_predicted,0.5714285714285714,9,6,CTCCGCGGAAGAACCACGAA,3,1874657
hyuA_predicted,2.142857142857143,20,6,CTCAAGAATCCACCATCTGT,14,1867840
hyuA_predicted,1.7142857142857142,17,6,CTACGTGGTTCGAGCCGTGG,11,1867341
hyuA_predicted,0.5714285714285714,9,6,CGTTTTGATCAAACTGGAAC,3,1849159
hyuA_predicted,0.7142857142857143,10,6,CGTTTATGACTGTACCCCGC,4,1868943
hyuA_predicted,0.42857142857142855,8,6,CGTTGACGGCTTGCACTAAA,2,1872527
hyuA_predicted,0.2857142857142857,7,6,CGTTCGAACCGGTTCATCGT,1,1863688
hyuA_predicted,1.5714285714285714,16,6,CGTCTTAAGCCAGCACACTC,10,1872760
hyuA_predicted,3.7142857142857144,31,6,CGGTGAAGGTCAGCACGACC,25,1837185
hyuA_predicted,3.2857142857142856,28,6,CGGGCTTGGCATCGTTGGCA,22,1839055
hyuA_predicted,0.2857142857142857,7,6,CGGCTCTTATAACGGATGGC,1,1856053
hyuA_predicted,2.4285714285714284,22,6,CGGCCCCCACATCGATACGG,16,1847579
hyuA_predicted,0.7142857142857143,10,6,CGGATAGCATACAACAAGAC,4,1859937
hyuA_predicted,1.8571428571428572,18,6,CGGACACAGGCTTTTAACTA,12,1874196
hyuA_predicted,2.5714285714285716,23,6,CGCTGCGACGCTAACTATCG,17,1855331
hyuA_predicted,1.7142857142857142,17,6,CGCGGTTAAACATGCAGTAC,11,1838855
hyuA_predicted,1.5714285714285714,16,6,CGCGACATGTGGGGCGGAAA,10,1832654
hyuA_predicted,1.0,12,6,CGCCGGTCTGGTATTTAGAA,6,1844294
hyuA_predicted,2.2857142857142856,21,6,CGATTTACTCGCCTGAATCC,15,1850455
hyuA_predicted,5.285714285714286,42,6,CGATTGTGGCGCGAACGAGG,36,1848418
hyuA_predicted,5.285714285714286,42,6,CGATTGGTGGTCCTGGATAT,36,1868551
hyuA_predicted,6.0,47,6,CGATGGATCATGGGATGGGC,41,1865116
hyuA_predicted,0.2857142857142857,7,6,CGAGCGGGTTGGGTTAATTG,1,1875920
hyuA_predicted,1.8571428571428572,18,6,CGACGCTTGTAGCGTATTAA,12,1856718
hyuA_predicted,0.2857142857142857,7,6,CGACCTTCAGAGAAAACCTT,1,1852443
hyuA_predicted,5.142857142857143,41,6,CGAACTGTATAACCGGTCAG,35,1845596
hyuA_predicted,1.5714285714285714,16,6,CGAACGTTACTCTTACGAGA,10,1846762
hyuA_predicted,0.8571428571428571,11,6,CCTTTACGATTGTCCAGAAG,5,1839182
hyuA_predicted,1.2857142857142858,14,6,CCTTGGCTTCGTGCGCTTTG,8,1840498
hyuA_predicted,1.0,12,6,CCTTCTACTAGGGAATCACT,6,1847304
hyuA_predicted,4.571428571428571,37,6,CCTTCGTTAACCGTTATCCT,31,1849622
hyuA_predicted,0.2857142857142857,7,6,CCTACGCTCTAGCTACAGGC,1,1846626
hyuA_predicted,1.0,12,6,CCGTGTTGTTATCCCCAGGA,6,1840263
hyuA_predicted,1.0,12,6,CCGTGGTGCCATTATGATCC,6,1831080
hyuA_predicted,0.7142857142857143,10,6,CCGCTCCGAAGGTAGGAGAC,4,1841438
hyuA_predicted,2.4285714285714284,22,6,CCGAGTTCCAAAGCGGATCT,16,1834711
hyuA_predicted,1.8571428571428572,18,6,CCGACAAAGCACCGTCTGGC,12,1871771
hyuA_predicted,2.7142857142857144,24,6,CCGAAGTATAGCGCGGGTAC,18,1875937
hyuA_predicted,2.7142857142857144,24,6,CCCTGGCATGATAAATACGC,18,1842675
hyuA_predicted,0.2857142857142857,7,6,CCCGCATAATCCAGTAATAC,1,1853722
hyuA_predicted,1.8571428571428572,18,6,CCCGATTCCCGTGCAACGTA,12,1856396
hyuA_predicted,0.2857142857142857,7,6,CCCGACTCAACATGGAAAGA,1,1850686
hyuA_predicted,0.5714285714285714,9,6,CCATCGGGGAAGTCTCTGTC,3,1848619
hyuA_predicted,0.8571428571428571,11,6,CCATCCGATATTGGTTGGCT,5,1848800
hyuA_predicted,1.0,12,6,CCAGGGCACGAATCACTTCT,6,1852193
hyuA_predicted,1.0,12,6,CCACGCCTGGGGCGCTATTT,6,1872155
hyuA_predicted,0.7142857142857143,10,6,CCACACTATTTTTGGAAATT,4,1834582
hyuA_predicted,2.5714285714285716,23,6,CCAAGCGCGTGGCGTGTGGA,17,1854489
hyuA_predicted,0.8571428571428571,11,6,CCAACTTGTCCCTCCTAGGT,5,1869443
hyuA_predicted,0.42857142857142855,8,6,CATTTCACATTACGTTAGAG,2,1854270
hyuA_predicted,2.142857142857143,20,6,CATTGGCATAAACGTTGCAG,14,1869601
hyuA_predicted,0.2857142857142857,7,6,CATTGAGGTGGTATTGATTC,1,1863806
hyuA_predicted,1.0,12,6,CATGATTTATACCACACAAC,6,1850331
hyuA_predicted,1.1428571428571428,13,6,CATGAGAAGATCCAAGGTAA,7,1837279
hyuA_predicted,0.2857142857142857,7,6,CATGAATACTGGTGCAAATT,1,1860736
hyuA_predicted,1.1428571428571428,13,6,CATCTCTCGCCCATCCTTTT,7,1830876
hyuA_predicted,2.857142857142857,25,6,CATCACGCATGACGAGTCCC,19,1864139
hyuA_predicted,1.1428571428571428,13,6,CATACTTCGAATTTTATCGT,7,1853815
hyuA_predicted,0.42857142857142855,8,6,CATACGTACCCGATAAAGAC,2,1866270
hyuA_predicted,4.714285714285714,38,6,CAGCATACGTTGTGATGGAG,32,1859515
hyuA_predicted,2.857142857142857,25,6,CAGCACAGTACTATCATTGT,19,1855607
hyuA_predicted,2.7142857142857144,24,6,CAGCACACGCGATCTCTGGA,18,1852877
hyuA_predicted,3.2857142857142856,28,6,CAGATCCACAGTTGATAGAA,22,1877423
hyuA_predicted,1.7142857142857142,17,6,CAGAGCAAACTACAACGCGT,11,1846456
hyuA_predicted,3.0,26,6,CAGAACCATTTACTATGGTA,20,1856166
hyuA_predicted,4.285714285714286,35,6,CACTGAGAGCTGGATGTTAC,29,1836340
hyuA_predicted,2.5714285714285716,23,6,CACTAACATGCTGTCATGGT,17,1863177
hyuA_predicted,0.42857142857142855,8,6,CACGCAATAGAATACGTTAG,2,1857405
hyuA_predicted,3.5714285714285716,30,6,CACGCAAACGATCTGGACAA,24,1875804
hyuA_predicted,1.8571428571428572,18,6,CACCTCGATTCTGCGGGCGG,12,1837425
hyuA_predicted,4.714285714285714,38,6,CACCTCAGAGTGACTTAATG,32,1831445
hyuA_predicted,0.42857142857142855,8,6,CACCGTGCGCTAATGGTTGA,2,1871931
hyuA_predicted,1.7142857142857142,17,6,CACCGCAGAGATAGACTACA,11,1855818
hyuA_predicted,2.7142857142857144,24,6,CACCACCTGGGTGACGCTCT,18,1852130
hyuA_predicted,1.0,12,6,CACATGGTTTCAGGCAGTGT,6,1857714
hyuA_predicted,1.0,12,6,CAATTCGGGTTGGTATTTAT,6,1832509
hyuA_predicted,4.142857142857143,34,6,CAATCGGCTACTCCCACGTT,28,1852035
hyuA_predicted,1.2857142857142858,14,6,CAATATGAGGCCAGAGCACA,8,1834703
hyuA_predicted,0.7142857142857143,10,6,CAAGTCTATGAGGTCTCATG,4,1862875
hyuA_predicted,1.2857142857142858,14,6,CAACATATCTTACCGGTTCT,8,1863996
hyuA_predicted,1.8571428571428572,18,6,CAAAGCCTTTCAGACACTGT,12,1855953
hyuA_predicted,0.7142857142857143,10,6,ATTGCGGAATGACTGGGGGC,4,1829102
hyuA_predicted,0.42857142857142855,8,6,ATTCTCATAGCATTATTACA,2,1865972
hyuA_predicted,0.5714285714285714,9,6,ATTCCCCGATATACGGTAGG,3,1868242
hyuA_predicted,2.0,19,6,ATGTGTCTATGCGGATGCGT,13,1872311
hyuA_predicted,0.2857142857142857,7,6,ATGGGCGGGTCCGTGCTCAG,1,1861302
hyuA_predicted,2.5714285714285716,23,6,ATGCTGCCCAATTAGTCCAT,17,1837596
hyuA_predicted,0.5714285714285714,9,6,ATCTTTTTCAATGTGGTGGA,3,1837271
hyuA_predicted,0.5714285714285714,9,6,ATCTAGAAACGCATCAGGAC,3,1876528
hyuA_predicted,3.857142857142857,32,6,ATCGTGGCATTCAATGTGCG,26,1870104
hyuA_predicted,0.8571428571428571,11,6,ATCGGTCATCATTACTGTAA,5,1855808
hyuA_predicted,1.2857142857142858,14,6,ATCGCATAGCTCATCAAATT,8,1869548
hyuA_predicted,0.7142857142857143,10,6,ATCCCTCTCGAGTTCGGTTT,4,1854641
hyuA_predicted,2.142857142857143,20,6,ATCAAGCGGCGACAGTACGA,14,1829444
hyuA_predicted,1.2857142857142858,14,6,ATCAAATGAGGCTCACTGCC,8,1870022
hyuA_predicted,0.5714285714285714,9,6,ATATGCGGGTCGAGCTCGCT,3,1839620
hyuA_predicted,0.2857142857142857,7,6,ATATATGCAGACACCTTGTA,1,1869432
hyuA_predicted,0.2857142857142857,7,6,ATAGAAGACTTGGATCACCG,1,1872593
hyuA_predicted,2.4285714285714284,22,6,ATACGGCTAGGTCCAGTGGG,16,1850474
hyuA_predicted,0.2857142857142857,7,6,AGTTAGACTGCACATGGCGT,1,1875005
hyuA_predicted,0.2857142857142857,7,6,AGTGCGAACTCCAGGACCTC,1,1862593
hyuA_predicted,0.2857142857142857,7,6,AGTAGGTCCACGGGAGCGAT,1,1833471
hyuA_predicted,0.2857142857142857,7,6,AGTAAGTCGGCGCACGTTCG,1,1848664
hyuA_predicted,6.0,47,6,AGGTCACCGCTATGGATCTA,41,1848115
hyuA_predicted,1.0,12,6,AGGTCACAGAACGCCAGACA,6,1832791
hyuA_predicted,0.2857142857142857,7,6,AGGGGTCCAGATAGGGGTAT,1,1842871
hyuA_predicted,1.4285714285714286,15,6,AGGGGCTTTGCGTTTTTTGC,9,1861016
hyuA_predicted,0.5714285714285714,9,6,AGGGCCTGCGCTGGGTTTCA,3,1868301
hyuA_predicted,1.1428571428571428,13,6,AGGCTTTGTACGAATAAATT,7,1865663
hyuA_predicted,1.4285714285714286,15,6,AGGCTCGCAACCTGTCCTTT,9,1856364
hyuA_predicted,0.5714285714285714,9,6,AGGCGGAAATCCATTTGCGC,3,1854462
hyuA_predicted,0.2857142857142857,7,6,AGGACGCCTGCGCTTTTCAT,1,1852400
hyuA_predicted,0.2857142857142857,7,6,AGGAACTACTCGTGCTGAAG,1,1839183
hyuA_predicted,6.0,47,6,AGGAAAGCCTTCAACTATCT,41,1871284
hyuA_predicted,0.2857142857142857,7,6,AGCTTTTACGCTAGAGTGTT,1,1829773
hyuA_predicted,0.5714285714285714,9,6,AGCTGCGCGACAGCGATGGT,3,1852798
hyuA_predicted,0.7142857142857143,10,6,AGCGGTGCAAGTGGGGCGAA,4,1857123
hyuA_predicted,0.2857142857142857,7,6,AGCCTGCACCACCGAAGAGG,1,1853883
hyuA_predicted,1.8571428571428572,18,6,AGCCGTAAAGACGTGTCCCA,12,1833014
hyuA_predicted,1.5714285714285714,16,6,AGATAAGCCCGAAGACCTAA,10,1849920
hyuA_predicted,1.0,12,6,AGAGCACATTGCCGCTGAGG,6,1829033
hyuA_predicted,0.7142857142857143,10,6,AGACACCAGCTGAAGTCCCG,4,1859866
hyuA_predicted,2.2857142857142856,21,6,AGAAACACTCCAATATTTAT,15,1830804
hyuA_predicted,0.8571428571428571,11,6,ACTGGGACAGTTCGGAAGAT,5,1829103
hyuA_predicted,5.0,40,6,ACTGAGGCCGACGAGGGGGA,34,1829362
hyuA_predicted,4.571428571428571,37,6,ACTGACCCACGAGCCATAGT,31,1854252
hyuA_predicted,0.2857142857142857,7,6,ACTCTGGCTTTGAATAGTTT,1,1829122
hyuA_predicted,2.2857142857142856,21,6,ACTAAATCGGTATTGTCAGA,15,1866100
hyuA_predicted,0.7142857142857143,10,6,ACGTGTCTAAAGCAGCACAG,4,1873456
hyuA_predicted,5.428571428571429,43,6,ACGCTCATACTAGGACATGG,37,1832359
hyuA_predicted,1.5714285714285714,16,6,ACGAGTACCTTATGTTTGAT,10,1873533
hyuA_predicted,0.42857142857142855,8,6,ACCGCTCCGGCCCGGTAAGT,2,1836103
hyuA_predicted,2.4285714285714284,22,6,ACCAGGTTATCTACACCGCT,16,1848622
hyuA_predicted,0.42857142857142855,8,6,ACAGAGCGGAGGGACGCACA,2,1861592
hyuA_predicted,2.0,19,6,ACAAGCTCAGATACTGTGAC,13,1854459
hyuA_predicted,0.42857142857142855,8,6,AATTCCCGGGCGTCAAAGTG,2,1842609
hyuA_predicted,1.2857142857142858,14,6,AATTCCCCTTGTGCACCCCT,8,1831731
hyuA_predicted,0.2857142857142857,7,6,AATTCACAGGGACTTCATAG,1,1865113
hyuA_predicted,1.0,12,6,AATTACACTGGCCAGCTAGT,6,1859505
hyuA_predicted,2.4285714285714284,22,6,AATGCGCCAAAAATGGCCGT,16,1874515
hyuA_predicted,1.4285714285714286,15,6,AAGTTTAGGCCGTACTGAAA,9,1836920
hyuA_predicted,0.8571428571428571,11,6,AAGTGGGCCATGAATTTCGT,5,1856642
hyuA_predicted,0.2857142857142857,7,6,AAGTCGCCGCATAACGTTAA,1,1871195
hyuA_predicted,2.5714285714285716,23,6,AAGGGACTGGGGTTGGAGCG,17,1839672
hyuA_predicted,0.42857142857142855,8,6,AAGGCTCCCTTGCCTCGAAC,2,1844725
hyuA_predicted,1.2857142857142858,14,6,AAGGCGTTTGCTATAGTGTG,8,1865292
hyuA_predicted,0.2857142857142857,7,6,AAGCTTCCATGCACTTACTG,1,1876195
hyuA_predicted,2.0,19,6,AAGCTAACGAGTAAGACATG,13,1857327
hyuA_predicted,1.2857142857142858,14,6,AAGACGTGTCTGGACGGCCA,8,1872042
hyuA_predicted,2.4285714285714284,22,6,AACTTCCATACAAAATTCTC,16,1833723
hyuA_predicted,2.857142857142857,25,6,AAAGGTAAAAGATCGATAAA,19,1858814
hyuA_predicted,0.2857142857142857,7,6,AAAGAGTTATTCATCCTATT,1,1834223
hyuA_predicted,0.2857142857142857,7,6,AAAGAATGAATCTACACCAT,1,1842254
hyuA_predicted,0.6666666666666666,8,5,TTTTGGTTTCAGGGTATGAA,3,1834571
hyuA_predicted,0.3333333333333333,6,5,TTTTCTTATGAGTCTTAATA,1,1873207
hyuA_predicted,0.3333333333333333,6,5,TTTGAGGGAGTCGATAATCC,1,1833358
hyuA_predicted,0.5,7,5,TTTCGTCCGTTTTCAACACT,2,1839734
hyuA_predicted,0.3333333333333333,6,5,TTTCAGGGACGAAGCCATGG,1,1840371
hyuA_predicted,5.833333333333333,39,5,TTTCACGTTGGCTGAGACTG,34,1837686
hyuA_predicted,0.5,7,5,TTGTTTTACAATCGCAGATT,2,1854479
hyuA_predicted,1.1666666666666667,11,5,TTGGTACAGGAGGGATGTGG,6,1846915
hyuA_predicted,1.1666666666666667,11,5,TTGGCTCCAGGCTCGGACAA,6,1835840
hyuA_predicted,2.3333333333333335,18,5,TTGCTCTCGGCGACTAACGG,13,1846756
hyuA_predicted,0.3333333333333333,6,5,TTGCTCATTTCCTGAACCCA,1,1847874
hyuA_predicted,0.6666666666666666,8,5,TTCTCGCTTGCTTTAAGTGG,3,1832474
hyuA_predicted,1.1666666666666667,11,5,TTCGCTTATTGGCTGGGTAA,6,1833472
hyuA_predicted,0.3333333333333333,6,5,TTCGCGAGTTGAGGCGGTTC,1,1847729
hyuA_predicted,0.3333333333333333,6,5,TTCGACCGTTGACAGTTGGC,1,1836643
hyuA_predicted,4.0,28,5,TTCACGGTGAACACTTAGTT,23,1830774
hyuA_predicted,2.0,16,5,TTCAAGTAATTCCTTAGAAT,11,1873005
hyuA_predicted,1.3333333333333333,12,5,TTATTTGAATAGCCTGTCCT,7,1850003
hyuA_predicted,5.5,37,5,TTATTTAACCATACTCGTTT,32,1840580
hyuA_predicted,3.8333333333333335,27,5,TTATTAAGAGCTTAATCACC,22,1852968
hyuA_predicted,1.0,10,5,TTATGCATTAATACGATCAT,5,1835685
hyuA_predicted,1.6666666666666667,14,5,TTAGCGTTGTACCTCGCCCT,9,1870606
hyuA_predicted,7.333333333333333,48,5,TTAGAGGATGTAGGCGGACA,43,1869392
hyuA_predicted,1.8333333333333333,15,5,TTAAAAGCACAAAGGTGAAA,10,1849001
hyuA_predicted,0.3333333333333333,6,5,TGTTTTGTGATAAAAGTGAA,1,1833674
hyuA_predicted,0.5,7,5,TGTTTGCCGTCACTGTATCA,2,1847714
hyuA_predicted,2.6666666666666665,20,5,TGTGGCTATAGCGAGCCTGC,15,1866927
hyuA_predicted,0.3333333333333333,6,5,TGTATTACTGCACTAGGAGA,1,1871850
hyuA_predicted,3.8333333333333335,27,5,TGTAAACCAGGGCATTAAGG,22,1869345
hyuA_predicted,0.3333333333333333,6,5,TGGGGTAGCAGCTCCGCACT,1,1854760
hyuA_predicted,0.6666666666666666,8,5,TGGCGTCTTTACGCGTACGG,3,1841149
hyuA_predicted,2.1666666666666665,17,5,TGGCCCACGGGTAAATACAT,12,1846200
hyuA_predicted,1.8333333333333333,15,5,TGGAATGGTAATGTGGCGGC,10,1872081
hyuA_predicted,0.3333333333333333,6,5,TGGAATACTTATGTTTATAG,1,1873716
hyuA_predicted,0.3333333333333333,6,5,TGCTTATCGTTTGGGGTTAT,1,1835906
hyuA_predicted,0.3333333333333333,6,5,TGCTAGCAATGCGATGCATG,1,1846774
hyuA_predicted,4.0,28,5,TGCGTTTCACGTAGAAGCGT,23,1844512
hyuA_predicted,0.3333333333333333,6,5,TGCCACTATGCCAGAAGCAC,1,1864448
hyuA_predicted,4.333333333333333,30,5,TGCCACGCACGGCTAAACAA,25,1844308
hyuA_predicted,1.6666666666666667,14,5,TGCAGGTATCGCGGGTCTCT,9,1831579
hyuA_predicted,2.6666666666666665,20,5,TGATTACATGCCCTTAAAAT,15,1852148
hyuA_predicted,3.5,25,5,TGATGAAACGGTTCCCGCCA,20,1861068
hyuA_predicted,1.3333333333333333,12,5,TGAGGCGGTCCTCAAATGAG,7,1856242
hyuA_predicted,0.3333333333333333,6,5,TGAGGCATTTGCGATCTGGG,1,1864903
hyuA_predicted,1.3333333333333333,12,5,TGACATTTCATCTAGAACTA,7,1839243
hyuA_predicted,0.5,7,5,TGAAGCATGGTCGCTGGCTC,2,1829723
hyuA_predicted,2.0,16,5,TGAACAGATATCTTTTCCAG,11,1850756
hyuA_predicted,1.8333333333333333,15,5,TCTTTACAGTTCGCAAGTCC,10,1844843
hyuA_predicted,2.1666666666666665,17,5,TCTCGAGTTGAGCAATGCAT,12,1865871
hyuA_predicted,12.333333333333334,78,5,TCTCGAGGCTGACAGAAACC,73,1853760
hyuA_predicted,0.3333333333333333,6,5,TCTCCGCTCAGGTGCAGCGG,1,1843928
hyuA_predicted,1.8333333333333333,15,5,TCTCAGTAGCACAGGGATTA,10,1854528
hyuA_predicted,2.1666666666666665,17,5,TCTATCTGCGCCTCAACTCA,12,1849083
hyuA_predicted,0.3333333333333333,6,5,TCTAATTAGTTGACGTATTA,1,1838259
hyuA_predicted,3.0,22,5,TCGGGCCTGATGTCTTAGTT,17,1870311
hyuA_predicted,5.333333333333333,36,5,TCGGCTAGCCTTCGCGAATG,31,1869378
hyuA_predicted,1.6666666666666667,14,5,TCGAAATGATCCGACCGGTG,9,1869589
hyuA_predicted,0.6666666666666666,8,5,TCCTCAATACAATCCGGGGA,3,1844997
hyuA_predicted,1.3333333333333333,12,5,TCCGATATAGGTCATCGTGA,7,1876704
hyuA_predicted,1.3333333333333333,12,5,TCCGAGGATAAACTCTCGAG,7,1870553
hyuA_predicted,2.0,16,5,TCCCTTTACCCGTTAGAGTG,11,1866719
hyuA_predicted,1.5,13,5,TCCCCTAATATGACCTCAAT,8,1863051
hyuA_predicted,1.6666666666666667,14,5,TCCATTAGAGTCAGCATGTG,9,1831555
hyuA_predicted,0.8333333333333334,9,5,TCCAATGCGTGAACACGGGT,4,1829642
hyuA_predicted,1.1666666666666667,11,5,TCATGATACAAGTGGGCACA,6,1851221
hyuA_predicted,0.6666666666666666,8,5,TCAGAAAATATGTGTAGGGA,3,1848354
hyuA_predicted,0.8333333333333334,9,5,TCAACTCGGCCCTACCGAGC,4,1839236
hyuA_predicted,0.5,7,5,TCAAAGCGAGCGGGACCATA,2,1864637
hyuA_predicted,2.1666666666666665,17,5,TCAAACCGGCACGGCTGGTC,12,1867431
hyuA_predicted,3.0,22,5,TATGTACGGCAGCCCAATGC,17,1841197
hyuA_predicted,1.1666666666666667,11,5,TATGGCGTTGACAACGTGAC,6,1876536
hyuA_predicted,0.5,7,5,TATGCGTGCACATGAATATT,2,1830105
hyuA_predicted,3.3333333333333335,24,5,TATCTTTTGCCAGGTAGTTG,19,1859076
hyuA_predicted,1.8333333333333333,15,5,TATCCAACGGTATGCTATGT,10,1861671
hyuA_predicted,0.3333333333333333,6,5,TATCACATAGTTTCTCTTTA,1,1837423
hyuA_predicted,4.833333333333333,33,5,TATATCGCTGTGGCGCTCCC,28,1849241
hyuA_predicted,2.8333333333333335,21,5,TATAATGGAAACAGACTGAT,16,1863826
hyuA_predicted,3.6666666666666665,26,5,TAGATAATGACCCCTGGGTT,21,1837813
hyuA_predicted,1.3333333333333333,12,5,TAGAGCTTTGGATGTTGGAA,7,1848602
hyuA_predicted,0.3333333333333333,6,5,TAGACATTATTCCTAAGGAT,1,1856280
hyuA_predicted,1.3333333333333333,12,5,TACGTAGTCTTCGTGAATAT,7,1853796
hyuA_predicted,2.8333333333333335,21,5,TACCGGTCGAAAGGACCGGT,16,1849935
hyuA_predicted,1.5,13,5,TACCATTACGGAACTTCTTG,8,1852464
hyuA_predicted,0.6666666666666666,8,5,TACAATCGAACAAACCTCTA,3,1856994
hyuA_predicted,0.3333333333333333,6,5,TAATGGCTACAGGACGGTCT,1,1841280
hyuA_predicted,2.5,19,5,TAACCTACGTCACGTTGCAT,14,1848397
hyuA_predicted,1.1666666666666667,11,5,TAAATCCGAGACCACTTTGT,6,1832591
hyuA_predicted,3.5,25,5,GTTTTATCGTAGTAAAGTAG,20,1872012
hyuA_predicted,0.3333333333333333,6,5,GTTTAGTCCCCCCGTCTGGG,1,1835836
hyuA_predicted,2.1666666666666665,17,5,GTTGTTCCACGCGGGACTGC,12,1836853
hyuA_predicted,1.1666666666666667,11,5,GTTGAGGTAACCATTTGCTT,6,1858678
hyuA_predicted,1.5,13,5,GTTGACCCTGGGGTCACCCT,8,1845984
hyuA_predicted,0.3333333333333333,6,5,GTTCGTAGCCCCATATGTAA,1,1867674
hyuA_predicted,1.0,10,5,GTTCCCGCTACTGTTCAGGT,5,1831902
hyuA_predicted,1.0,10,5,GTTCCCGCCGTTGTCGGGTG,5,1874995
hyuA_predicted,2.5,19,5,GTTCCCATCCTTATTGATAT,14,1864376
hyuA_predicted,0.5,7,5,GTTATTGAGACAACTCTAGC,2,1838892
hyuA_predicted,1.5,13,5,GTTATGAATAAGTGGTTAGC,8,1845931
hyuA_predicted,2.6666666666666665,20,5,GTTATCTGTAAAACCTACGT,15,1868193
hyuA_predicted,4.166666666666667,29,5,GTTAGCCGGCTATTGACTTT,24,1857651
hyuA_predicted,1.6666666666666667,14,5,GTGCTACCGGCTATGCCCCT,9,1844682
hyuA_predicted,2.0,16,5,GTGCCAATAGCTAGGCGATG,11,1844993
hyuA_predicted,5.166666666666667,35,5,GTGCACAGTTGTAGACTCAT,30,1863151
hyuA_predicted,2.1666666666666665,17,5,GTGAGATATATCGATATACG,12,1873990
hyuA_predicted,0.3333333333333333,6,5,GTCTTCTCTGTTTCAGGTAA,1,1857662
hyuA_predicted,2.1666666666666665,17,5,GTCTGGTGGCGCAAGTTGTG,12,1877843
hyuA_predicted,0.3333333333333333,6,5,GTCGGTAATCACGAATGATG,1,1849475
hyuA_predicted,6.333333333333333,42,5,GTCCAATTCACACCCCCCCA,37,1875796
hyuA_predicted,1.0,10,5,GTCATCGCGTTTGATATCCC,5,1868123
hyuA_predicted,1.3333333333333333,12,5,GGTGTTAGACAAAGCTGTAA,7,1865778
hyuA_predicted,0.8333333333333334,9,5,GGTGTCATGGGTTGCTGCGT,4,1854685
hyuA_predicted,0.6666666666666666,8,5,GGTCTGGGACAATGAAGTGT,3,1841257
hyuA_predicted,3.0,22,5,GGTCCACCCTCTTGTTCGCG,17,1855428
hyuA_predicted,3.0,22,5,GGTAGCCCGGTCAGAATAAT,17,1843134
hyuA_predicted,2.5,19,5,GGGGGTGTCAATCCGGGACC,14,1860456
hyuA_predicted,1.1666666666666667,11,5,GGGGACCCACACACCGTTAG,6,1833718
hyuA_predicted,4.0,28,5,GGGCGTGAGAAACTCAGGGC,23,1854282
hyuA_predicted,0.5,7,5,GGGCGCGTTTGTGTGATCAA,2,1839342
hyuA_predicted,3.3333333333333335,24,5,GGCGGTTTTGCGAGCGCTCC,19,1834649
hyuA_predicted,5.666666666666667,38,5,GGCAGCGTTATTGGGTAGTG,33,1847923
hyuA_predicted,1.0,10,5,GGATGGCTGCTTTGAGAATC,5,1838666
hyuA_predicted,2.1666666666666665,17,5,GGATCAAAAGACTCTTCTTT,12,1849621
hyuA_predicted,0.3333333333333333,6,5,GGATAGGGAAACAGTGCTCT,1,1844250
hyuA_predicted,5.333333333333333,36,5,GGAGTCTCGTTCGGCGCTAA,31,1846366
hyuA_predicted,0.3333333333333333,6,5,GCTTAGAAGTCTCGCCTACC,1,1846401
hyuA_predicted,1.6666666666666667,14,5,GCTGGCTTGTGGATCGACTT,9,1838854
hyuA_predicted,1.1666666666666667,11,5,GCTGCATCTGCTCATGGGTT,6,1855979
hyuA_predicted,2.5,19,5,GCTAACGCGAAACCGCCGTG,14,1860202
hyuA_predicted,0.6666666666666666,8,5,GCGTTTATGTGTCGGTAGTA,3,1867135
hyuA_predicted,1.0,10,5,GCGCTGCTAACTTCATCTAG,5,1868247
hyuA_predicted,1.1666666666666667,11,5,GCGATAAGTACATCGGATGG,6,1870454
hyuA_predicted,2.0,16,5,GCCTAGGCTAAACAGGATAT,11,1852472
hyuA_predicted,1.3333333333333333,12,5,GCCGCAGCAGACATTAGGCG,7,1876509
hyuA_predicted,4.833333333333333,33,5,GCCCTTCTTCGATGTGGGTA,28,1848806
hyuA_predicted,2.6666666666666665,20,5,GCATCCCATTTACGAACCGA,15,1832884
hyuA_predicted,2.3333333333333335,18,5,GCATATGCTCCCCCTGAGGT,13,1838544
hyuA_predicted,1.6666666666666667,14,5,GCATACGCGCGTTACAGATT,9,1864725
hyuA_predicted,1.0,10,5,GCAGTTGGAATGCACCATAT,5,1841683
hyuA_predicted,1.8333333333333333,15,5,GCAGACTCCGCTTGGCTTCG,10,1850546
hyuA_predicted,0.3333333333333333,6,5,GCACCGTCCAGATCTGTTTA,1,1835571
hyuA_predicted,1.5,13,5,GCAAAGGCTACGGAGGTCAA,8,1844912
hyuA_predicted,3.0,22,5,GATTTGGTTACCGCCACCTA,17,1852796
hyuA_predicted,0.5,7,5,GATAGACGACTTACGAGTCC,2,1874816
hyuA_predicted,2.0,16,5,GAGTTCTGGGCACCCCAATT,11,1850140
hyuA_predicted,1.6666666666666667,14,5,GACTTGCCTCACTCGGAGTA,9,1829721
hyuA_predicted,2.0,16,5,GACTACTCAGCGACCTAGCA,11,1837502
hyuA_predicted,1.0,10,5,GACCGCTACACACTTGACGT,5,1867562
hyuA_predicted,1.3333333333333333,12,5,GACCGAGGATGCAGCTTGAT,7,1835515
hyuA_predicted,0.5,7,5,GACATGGATCATGCACCGAA,2,1853246
hyuA_predicted,3.8333333333333335,27,5,GACATCGCTTTAGTAAGACA,22,1835477
hyuA_predicted,4.833333333333333,33,5,GACACTAACCATGGTCGACC,28,1848246
hyuA_predicted,2.6666666666666665,20,5,GAATCTCAACCGTAGTCATC,15,1843862
hyuA_predicted,4.333333333333333,30,5,GAAGGTTGAACGAAGAGGCT,25,1844980
hyuA_predicted,2.0,16,5,GAAGCGGGGCGCACATCGCA,11,1848203
hyuA_predicted,1.6666666666666667,14,5,GAAGAGCGCTAGTCACCTGT,9,1840745
hyuA_predicted,1.6666666666666667,14,5,CTTTCGGCCCTAGAGGCACT,9,1828977
hyuA_predicted,0.3333333333333333,6,5,CTTATTTCTGAGGCAGGTTG,1,1848704
hyuA_predicted,2.6666666666666665,20,5,CTGTGGAGCCCATACGATCT,15,1876500
hyuA_predicted,0.3333333333333333,6,5,CTGTCGCCAATATACACCGA,1,1863657
hyuA_predicted,0.5,7,5,CTGTAGCAGGCGAAGAGACA,2,1857315
hyuA_predicted,1.3333333333333333,12,5,CTGCTGCGGAAGTGGTTATC,7,1850736
hyuA_predicted,0.3333333333333333,6,5,CTGCGTAGGTCTTGCTCCTT,1,1836000
hyuA_predicted,5.333333333333333,36,5,CTGCCGACTCAATAAGAAGG,31,1853493
hyuA_predicted,3.5,25,5,CTGCAAAAAGATTCTCTATC,20,1860547
hyuA_predicted,0.8333333333333334,9,5,CTGATTCTACGCGGTTTCTC,4,1857270
hyuA_predicted,4.166666666666667,29,5,CTGACTTACGGTTTCATGGC,24,1833752
hyuA_predicted,5.333333333333333,36,5,CTGACCCATCTGTTCTTCAA,31,1838667
hyuA_predicted,0.5,7,5,CTGAAAATTTAGTGGGACGT,2,1838090
hyuA_predicted,3.1666666666666665,23,5,CTCGTCGCAGGAAACTGAAT,18,1857370
hyuA_predicted,2.5,19,5,CTCGCGCCGTTTTACAGGGT,14,1834583
hyuA_predicted,1.3333333333333333,12,5,CTCCGGGTTGACGTAGGCGC,7,1832130
hyuA_predicted,1.5,13,5,CTCCCGTTTGCCGACGTCGC,8,1860240
hyuA_predicted,1.1666666666666667,11,5,CTCCCACCAGACGATAATTG,6,1849981
hyuA_predicted,3.1666666666666665,23,5,CTCCATAGTGCAGCAAGATG,18,1863783
hyuA_predicted,1.0,10,5,CTCCAGGCGGGCAATCATTA,5,1870206
hyuA_predicted,1.1666666666666667,11,5,CTCACTCACATACCCGCTTA,6,1845044
hyuA_predicted,2.6666666666666665,20,5,CTATATGCCAACCCGAGCCA,15,1867857
hyuA_predicted,2.3333333333333335,18,5,CTATATGACCCGTCATTTTG,13,1836647
hyuA_predicted,3.0,22,5,CTAGGAATCGGCTGACCACC,17,1866129
hyuA_predicted,0.8333333333333334,9,5,CTAGACGTGTAGACGGTTAC,4,1865352
hyuA_predicted,0.3333333333333333,6,5,CGTTTTTTGTTTGCTAGCGT,1,1833908
hyuA_predicted,1.8333333333333333,15,5,CGTTTATGGTATTAAGCCGA,10,1853474
hyuA_predicted,0.3333333333333333,6,5,CGTTGTTTCTGGAGCACTGT,1,1835976
hyuA_predicted,0.3333333333333333,6,5,CGTTCGTCGGATCTAGACCA,1,1855558
hyuA_predicted,5.166666666666667,35,5,CGTGAAGATCCTCAGTTGTC,30,1846108
hyuA_predicted,3.3333333333333335,24,5,CGTAGGAGGACCTAGGGTCT,19,1857161
hyuA_predicted,0.3333333333333333,6,5,CGGTGCGCGTAGAGTCGCCT,1,1874755
hyuA_predicted,2.1666666666666665,17,5,CGGTACACGTGGTTTCCGCT,12,1848596
hyuA_predicted,0.6666666666666666,8,5,CGGGGGTGGCAGGAGTGGGA,3,1844744
hyuA_predicted,1.1666666666666667,11,5,CGGGATATGCTAGTCCACCC,6,1861523
hyuA_predicted,0.8333333333333334,9,5,CGGAAAGGAGGCACTTTTTA,4,1845722
hyuA_predicted,2.8333333333333335,21,5,CGCTAACAACTACATGGGCT,16,1863638
hyuA_predicted,1.5,13,5,CGCGGGACACATCGAGAATG,8,1829729
hyuA_predicted,0.8333333333333334,9,5,CGCCGTCATGTAGTTTCGAA,4,1846871
hyuA_predicted,0.3333333333333333,6,5,CGCCCTTGTAAGCGAGAATG,1,1841531
hyuA_predicted,1.1666666666666667,11,5,CGCATCCCGTCCAAAACAAT,6,1841285
hyuA_predicted,1.3333333333333333,12,5,CGCAATGTTTTCTTGTACAT,7,1861531
hyuA_predicted,1.0,10,5,CGCAAGAACAACATCTATGT,5,1852716
hyuA_predicted,3.1666666666666665,23,5,CGATCGAAACGCCTGTACTA,18,1858537
hyuA_predicted,0.3333333333333333,6,5,CGATAGTCCCGTCGCACGTG,1,1847256
hyuA_predicted,4.666666666666667,32,5,CGAGCCAATGTGTATAATAG,27,1870578
hyuA_predicted,0.5,7,5,CGACTGGCTATTGACCCGTA,2,1833711
hyuA_predicted,0.3333333333333333,6,5,CGAAGGAAGGGGTCCTGTAG,1,1855519
hyuA_predicted,1.6666666666666667,14,5,CCTTGGTAAGATTAGCAACG,9,1848170
hyuA_predicted,0.8333333333333334,9,5,CCTTATAGAGTTCTCCTTAC,4,1859872
hyuA_predicted,5.333333333333333,36,5,CCTGCACGTCCCGGCAAACT,31,1843262
hyuA_predicted,0.3333333333333333,6,5,CCTGACAACCGAGCCTGGAG,1,1853601
hyuA_predicted,4.5,31,5,CCTCGCCGGCGTCCCTGCAT,26,1872719
hyuA_predicted,2.6666666666666665,20,5,CCTCACTGCATAATTTACGT,15,1874750
hyuA_predicted,0.3333333333333333,6,5,CCTATCGCCACAAATACCAC,1,1860279
hyuA_predicted,1.0,10,5,CCTACGCGAGACACAACACC,5,1864113
hyuA_predicted,3.3333333333333335,24,5,CCGTCAAGGGCAGTTACAGC,19,1832521
hyuA_predicted,0.3333333333333333,6,5,CCGGTCGCGTTCGGGGACAA,1,1866475
hyuA_predicted,3.5,25,5,CCGAAAAGTAATCTGTCATC,20,1841400
hyuA_predicted,4.833333333333333,33,5,CCCCACAAATGCACTCTATA,28,1858368
hyuA_predicted,2.5,19,5,CCCATTAACCGGGGAGCACT,14,1866240
hyuA_predicted,4.5,31,5,CCCATCATAGTGTCGCGATA,26,1868131
hyuA_predicted,3.8333333333333335,27,5,CCCAGGGGAACCCGATTATT,22,1840667
hyuA_predicted,0.8333333333333334,9,5,CCATGGGTCGCTGCTCGGCT,4,1867000
hyuA_predicted,2.0,16,5,CCATGCTATCTGCTGCCGCG,11,1868832
hyuA_predicted,1.3333333333333333,12,5,CCATCTAGATAAAGTGTGCG,7,1837318
hyuA_predicted,0.3333333333333333,6,5,CCACTCGGGTCACGGTTGAC,1,1846588
hyuA_predicted,1.6666666666666667,14,5,CCACCAGCCCACAGGTTGCT,9,1866438
hyuA_predicted,0.3333333333333333,6,5,CCAAACTTGTACACACCTTG,1,1841501
hyuA_predicted,3.5,25,5,CATTTCTCGGCTTGGTCGAT,20,1858613
hyuA_predicted,5.0,34,5,CATCGTGTCGGTCTGCCCGA,29,1867985
hyuA_predicted,0.3333333333333333,6,5,CATAGTCTATTGCGGAGTGG,1,1834051
hyuA_predicted,0.5,7,5,CAGTTCGGGACATAACTAAC,2,1852191
hyuA_predicted,2.0,16,5,CAGTAAAAAATGGTATCCTT,11,1851058
hyuA_predicted,0.3333333333333333,6,5,CAGGCAGTGCTTAAATGGCG,1,1868754
hyuA_predicted,1.8333333333333333,15,5,CAGCCCAGCCTTGCGGCAGA,10,1867232
hyuA_predicted,1.1666666666666667,11,5,CAGCAGCGTTACACGGGCAA,6,1853334
hyuA_predicted,1.1666666666666667,11,5,CAGCACCTGTATCGCTGTAG,6,1846791
hyuA_predicted,1.8333333333333333,15,5,CAGATGGATGCTCCGACGCA,10,1838947
hyuA_predicted,0.3333333333333333,6,5,CAGATAATAAAAATGGGGCT,1,1860469
hyuA_predicted,0.6666666666666666,8,5,CAGACCAGTGTGACGTTACT,3,1876100
hyuA_predicted,4.666666666666667,32,5,CACTGGGTTGCTTGGTATGG,27,1868030
hyuA_predicted,0.6666666666666666,8,5,CACCAACTCGCTATGCATCA,3,1864803
hyuA_predicted,1.0,10,5,CAATTCATTATAAATGGTAT,5,1861504
hyuA_predicted,3.6666666666666665,26,5,CAATCGGGCTGGTCTTAGAA,21,1847772
hyuA_predicted,2.8333333333333335,21,5,CAAGTCTACCGAGGTCCCGT,16,1858402
hyuA_predicted,0.5,7,5,CAAGGTGGGACTTCCGCTGC,2,1844229
hyuA_predicted,1.1666666666666667,11,5,CAAATTACGACATCCTTTAG,6,1861480
hyuA_predicted,0.6666666666666666,8,5,CAAATGTAACAGCCAGATCA,3,1853797
hyuA_predicted,0.6666666666666666,8,5,CAAAGCGTATGATGCTTCCT,3,1875938
hyuA_predicted,1.6666666666666667,14,5,ATTCTCATATATCACAAGAT,9,1843194
hyuA_predicted,1.6666666666666667,14,5,ATTACGGGAAAAGCCCGACC,9,1863305
hyuA_predicted,1.3333333333333333,12,5,ATTAATGGGAGACAGACGAA,7,1875694
hyuA_predicted,4.333333333333333,30,5,ATGTGCTTACAGAACGCGGT,25,1875506
hyuA_predicted,0.3333333333333333,6,5,ATGCTGTTACGAACGCACTC,1,1865969
hyuA_predicted,1.1666666666666667,11,5,ATGCTCCCTTTATCGAGCGG,6,1863787
hyuA_predicted,3.3333333333333335,24,5,ATGAAATGCCGAATGTCCGG,19,1836473
hyuA_predicted,0.3333333333333333,6,5,ATCTACATAACTGGATAAAG,1,1872132
hyuA_predicted,0.3333333333333333,6,5,ATCGGATCTTGAACCAGTGG,1,1857308
hyuA_predicted,0.5,7,5,ATCCGGGATATGACATAATG,2,1868567
hyuA_predicted,6.0,40,5,ATCATAAGGGCACGGTCACA,35,1861603
hyuA_predicted,0.3333333333333333,6,5,ATCAGCAGTAGAGCAAGAGA,1,1836168
hyuA_predicted,2.0,16,5,ATCACTGATGTAAGGTTCCT,11,1833859
hyuA_predicted,2.0,16,5,ATCAAGGGCCACTCTCGGAA,11,1861158
hyuA_predicted,4.0,28,5,ATCAAGCTACGGACAGCCGT,23,1855711
hyuA_predicted,1.3333333333333333,12,5,ATATTTCCTAAGGATTCGAT,7,1857017
hyuA_predicted,0.8333333333333334,9,5,ATATCCAACGCAAGTCCATA,4,1856365
hyuA_predicted,3.6666666666666665,26,5,ATAGCCTTCCAGGGGTTGCA,21,1837459
hyuA_predicted,1.6666666666666667,14,5,ATAAGGTTCTCAACGTGACC,9,1846987
hyuA_predicted,5.5,37,5,ATAACGTTCGTGTATTGATG,32,1840959
hyuA_predicted,1.6666666666666667,14,5,AGTTTTGGCGGATATTGGTA,9,1835174
hyuA_predicted,2.8333333333333335,21,5,AGTGTCGGTCTGCAAGTTTA,16,1860941
hyuA_predicted,1.1666666666666667,11,5,AGTGCTATGATCTTTATCTT,6,1847481
hyuA_predicted,0.6666666666666666,8,5,AGTGAGTAAACCGACAGGAA,3,1875684
hyuA_predicted,1.3333333333333333,12,5,AGTGACATAGATGGAGGTTC,7,1829256
hyuA_predicted,2.6666666666666665,20,5,AGTCAGGTGGGGGTTTACAT,15,1845357
hyuA_predicted,6.666666666666667,44,5,AGTAGGGAACTTTCATGCAT,39,1839832
hyuA_predicted,0.3333333333333333,6,5,AGGTTACGGCACTCCAGTAT,1,1848190
hyuA_predicted,0.5,7,5,AGGGGCGGAAAACCTGTGCA,2,1836610
hyuA_predicted,2.5,19,5,AGGGCGCCCCAGCACTGGTG,14,1874767
hyuA_predicted,1.0,10,5,AGGGCCAGATGGAAGCGCCA,5,1877482
hyuA_predicted,0.3333333333333333,6,5,AGGCGCCGCAACTTCGGCAA,1,1872579
hyuA_predicted,3.3333333333333335,24,5,AGGAGCATGATTCCGAGGGC,19,1842513
hyuA_predicted,2.3333333333333335,18,5,AGGAATGACCGTCCTAATAG,13,1849135
hyuA_predicted,0.3333333333333333,6,5,AGCTGGTGTTCCGTCTGATA,1,1864141
hyuA_predicted,3.8333333333333335,27,5,AGCTACTTCTCAGATCAGAT,22,1833763
hyuA_predicted,1.3333333333333333,12,5,AGCCAGATTATACTGACGTG,7,1862838
hyuA_predicted,2.0,16,5,AGCAGGAAGAGCGGTTCATA,11,1854907
hyuA_predicted,1.5,13,5,AGATAGTAGTGCCAGGCCAG,8,1843178
hyuA_predicted,1.8333333333333333,15,5,AGACTCCGCCCACGCGGTTT,10,1865253
hyuA_predicted,2.5,19,5,AGACGCGCAGGAACGGTGTA,14,1871014
hyuA_predicted,1.6666666666666667,14,5,AGACCTTGGAGACTTCTCAA,9,1853456
hyuA_predicted,1.1666666666666667,11,5,AGAACCCTCCCACTAACCGG,6,1843968
hyuA_predicted,0.6666666666666666,8,5,ACTTTCTTAATACTGTGCAT,3,1861856
hyuA_predicted,0.6666666666666666,8,5,ACTTAAGCCAACAGTCAGCC,3,1854048
hyuA_predicted,1.1666666666666667,11,5,ACTGTCTCAAGCCGGACTCT,6,1854853
hyuA_predicted,0.3333333333333333,6,5,ACTGCTGGATGCAAGCCACC,1,1831409
hyuA_predicted,1.5,13,5,ACTGCCCAATATCCCTAGAA,8,1855007
hyuA_predicted,1.6666666666666667,14,5,ACTAGCTTAACCTCAACAGC,9,1831123
hyuA_predicted,3.3333333333333335,24,5,ACTAGAAACCCCACTTGTAC,19,1866727
hyuA_predicted,0.5,7,5,ACGTTTCGAGGTATGTGAGG,2,1865213
hyuA_predicted,2.1666666666666665,17,5,ACGGATAACTGGAACATGAA,12,1873012
hyuA_predicted,4.0,28,5,ACGCATTGAAGTATCCACAA,23,1872323
hyuA_predicted,4.333333333333333,30,5,ACGACCAGTCTCGCTTCAGT,25,1833573
hyuA_predicted,2.0,16,5,ACCTTATGTGGAAGGTTCGA,11,1840744
hyuA_predicted,3.5,25,5,ACCACGGCGATGGTAGACCA,20,1838704
hyuA_predicted,0.3333333333333333,6,5,ACAGTCAACCGGAATTAAGG,1,1876923
hyuA_predicted,1.6666666666666667,14,5,ACAGCTAACCGCGAATCAAG,9,1844065
hyuA_predicted,1.6666666666666667,14,5,ACAATACTAAGCCCTACCAT,9,1847514
hyuA_predicted,1.5,13,5,ACAAGTGCAAAGGCAGTTAG,8,1862625
hyuA_predicted,0.5,7,5,AATTTGACTAGATATATTAC,2,1839845
hyuA_predicted,0.3333333333333333,6,5,AATGTATTGTTACCTATCGT,1,1832063
hyuA_predicted,1.8333333333333333,15,5,AATGGCGGGCCTAAGAAGTA,10,1850165
hyuA_predicted,2.5,19,5,AATCTGGCATAACGACGGCA,14,1852729
hyuA_predicted,3.1666666666666665,23,5,AATCGGGAGGTTATGGAATG,18,1860105
hyuA_predicted,0.8333333333333334,9,5,AATCCTGGGCTTTGCTTCCC,4,1840430
hyuA_predicted,1.0,10,5,AATCCGACGTGGAAGCAACC,5,1874558
hyuA_predicted,3.3333333333333335,24,5,AAGTATGCCAATAAACACTC,19,1846398
hyuA_predicted,0.3333333333333333,6,5,AAGGCGTAACTATGTGTGGC,1,1847147
hyuA_predicted,3.6666666666666665,26,5,AAGGAACCTGCTCAATTCGC,21,1863819
hyuA_predicted,3.6666666666666665,26,5,AAGCTACGTGCCTAGCCAGA,21,1877725
hyuA_predicted,5.5,37,5,AAGCGCTTGTGCGCAGAGCT,32,1846943
hyuA_predicted,0.3333333333333333,6,5,AAGATCTTTGTCTAGTGCGT,1,1844113
hyuA_predicted,1.5,13,5,AAGAGCTGGGACGTCCGGAA,8,1831405
hyuA_predicted,0.3333333333333333,6,5,AACTGAATGTCCCACCCCGC,1,1862757
hyuA_predicted,0.3333333333333333,6,5,AACTATTATCGGCGCTTAGC,1,1868872
hyuA_predicted,0.3333333333333333,6,5,AACGACCATAGCAGTGGCCG,1,1841030
hyuA_predicted,7.5,49,5,AACCATTAATGAGGTCGCAA,44,1855250
hyuA_predicted,0.8333333333333334,9,5,AACAGTTGCCGCACGCTACC,4,1866981
hyuA_predicted,2.6666666666666665,20,5,AACAATGCAAACAATCCGAT,15,1832079
hyuA_predicted,0.6666666666666666,8,5,AAATGTTTTGCCTTAGATTT,3,1863162
hyuA_predicted,1.3333333333333333,12,5,AAAGTCTTGATGACACCCCT,7,1839563
hyuA_predicted,3.6666666666666665,26,5,AAACTCGGGGTCTATCGTGT,21,1832518
hyuA_predicted,2.0,16,5,AAACACGACAGACTCGCTAA,11,1873453
hyuA_predicted,1.5,13,5,AAAACGCACGGACCTCTAGT,8,1842219
hyuA_predicted,0.4,5,4,TTTTTGTGTTTAAGTCTCCC,1,1864638
hyuA_predicted,1.2,9,4,TTTGAACGGGGAGTGATCGT,5,1862007
hyuA_predicted,3.2,19,4,TTTAGACAACTGACGGCTTC,15,1852800
hyuA_predicted,0.4,5,4,TTGTCAGTAGAATGCAAAGA,1,1834482
hyuA_predicted,2.8,17,4,TTGTACTGAAGAAGCGAGTA,13,1855829
hyuA_predicted,0.4,5,4,TTGGGGCGGTAGAGAGCAAT,1,1836361
hyuA_predicted,0.4,5,4,TTGAGAGGCCGTGACCTAAA,1,1832471
hyuA_predicted,2.4,15,4,TTCTCAGAGGCCCTAACAAT,11,1841249
hyuA_predicted,1.2,9,4,TTCGCCCAATTAAGCGGGAA,5,1840723
hyuA_predicted,1.8,12,4,TTCCCACGTATTTACCCTTA,8,1848962
hyuA_predicted,2.6,16,4,TTCATTTTCACGTCGTTTAT,12,1838198
hyuA_predicted,2.0,13,4,TTCAGTGAGGCGCCCACTAA,9,1875173
hyuA_predicted,1.4,10,4,TTAGTTTGTGGCTCTGTCGT,6,1843917
hyuA_predicted,3.8,22,4,TTAGGTGCAATTCGGCATAG,18,1833580
hyuA_predicted,5.6,31,4,TTAGGGGCGACGCCGACACA,27,1848742
hyuA_predicted,1.0,8,4,TTAGGCAGATGTTACAGTAT,4,1834874
hyuA_predicted,3.0,18,4,TTAAGAAGTAGTTGGTAGTA,14,1840073
hyuA_predicted,2.0,13,4,TGTTGTTTTATTTTGCCGAT,9,1877405
hyuA_predicted,0.6,6,4,TGTTATTACGATTGATGCAA,2,1839383
hyuA_predicted,0.6,6,4,TGTTATCGCAGATATAGCTT,2,1853290
hyuA_predicted,7.2,39,4,TGTGTTCCTTTCGGATCAGA,35,1831392
hyuA_predicted,2.2,14,4,TGTGGATAACGTACAGACTG,10,1830121
hyuA_predicted,4.4,25,4,TGTATGTATGTGCACTTGTC,21,1860043
hyuA_predicted,6.6,36,4,TGTAGATCACTTTCTGCCCC,32,1850431
hyuA_predicted,0.6,6,4,TGGTGTGTACAATATTTCAC,2,1846243
hyuA_predicted,1.0,8,4,TGGTAGGAGGGGGTCCGCCA,4,1853943
hyuA_predicted,3.6,21,4,TGGGAGCCCTTTTATCAACT,17,1843963
hyuA_predicted,7.2,39,4,TGGCATTGGTCAGCTCTGCG,35,1836599
hyuA_predicted,3.6,21,4,TGCTTATCCTCATAGTATAA,17,1873270
hyuA_predicted,1.4,10,4,TGCTAGGCTGGTTATCGGCT,6,1848072
hyuA_predicted,2.2,14,4,TGCCGCCTGGACTTATACAA,10,1831406
hyuA_predicted,2.2,14,4,TGCCAAGCCTAATCCAACAC,10,1870920
hyuA_predicted,3.0,18,4,TGCACTCGTCGTAAACGCAG,14,1867726
hyuA_predicted,0.4,5,4,TGCAAGAGGTAGGCTCTCGC,1,1835744
hyuA_predicted,1.0,8,4,TGATCGGCTCGCCCCACATA,4,1830251
hyuA_predicted,2.2,14,4,TGATCCAGTGTGAATGATCA,10,1869442
hyuA_predicted,0.4,5,4,TGAAGCTCGCACTTGTGCCC,1,1863613
hyuA_predicted,0.6,6,4,TCTTGATTCGACGAAGGAAT,2,1855336
hyuA_predicted,4.0,23,4,TCTTCACCCGTCTGCCTACA,19,1875520
hyuA_predicted,2.4,15,4,TCTGCCGTATGTTGGCATCT,11,1855707
hyuA_predicted,0.6,6,4,TCTCTTTGCAGACGGCCGCT,2,1855749
hyuA_predicted,0.6,6,4,TCTAGTTGTTGGTCTTGAAA,2,1865356
hyuA_predicted,0.4,5,4,TCGGTCCCGGACATCTGCGT,1,1853758
hyuA_predicted,4.0,23,4,TCGGGTCCGGGCTCTTAGGA,19,1873192
hyuA_predicted,1.2,9,4,TCGAACCTGCTTCATAGTGT,5,1847688
hyuA_predicted,4.8,27,4,TCCTTTACATAGCTAGCTCG,23,1859889
hyuA_predicted,0.4,5,4,TCCGCGACGAAGGTTAAAGC,1,1851273
hyuA_predicted,1.0,8,4,TCCGAAGGTGAACGCTGGAG,4,1853203
hyuA_predicted,2.8,17,4,TCCCTATACTACGAAAATAA,13,1830257
hyuA_predicted,3.0,18,4,TCCCCTCGCAGGTCGTTATT,14,1838460
hyuA_predicted,1.2,9,4,TCCCCACGATCGAATATACT,5,1846044
hyuA_predicted,2.4,15,4,TCATCCAAGTGAGCGAATTA,11,1837798
hyuA_predicted,0.8,7,4,TCAGTTCTACGAGCAGTTTG,3,1831015
hyuA_predicted,1.6,11,4,TCAGTGTGATCGAGTGATCT,7,1864025
hyuA_predicted,4.0,23,4,TCAGTCGAAAACTCGCAACA,19,1876317
hyuA_predicted,0.4,5,4,TCAGACACAATACGGCTCCA,1,1846126
hyuA_predicted,1.6,11,4,TCAAGGGTTCTGATATCTCA,7,1853693
hyuA_predicted,1.6,11,4,TCAACACGCCCTCAAAACCC,7,1858008
hyuA_predicted,3.6,21,4,TATTTACCTTATATCAGTAC,17,1839727
hyuA_predicted,0.8,7,4,TATTCTTGAGTCTAATTCTA,3,1850807
hyuA_predicted,5.6,31,4,TATTACTCGTGGAACTTAAC,27,1862445
hyuA_predicted,8.4,45,4,TATGCTACAGGTGGCTTACT,41,1848700
hyuA_predicted,4.2,24,4,TAGGGCGTAGGTTTAGTCTC,20,1858359
hyuA_predicted,0.6,6,4,TAGATTAATGTTGAGGAAAT,2,1840446
hyuA_predicted,3.2,19,4,TACTTGCAAACTGGGAGAGC,15,1862482
hyuA_predicted,2.2,14,4,TACTTAAACTCACCGTCAAA,10,1858265
hyuA_predicted,1.2,9,4,TACCTGATTTAGTCAACGAG,5,1861224
hyuA_predicted,2.4,15,4,TAATGGTAATGGTATAGGAA,11,1835956
hyuA_predicted,1.8,12,4,TAAAGGGTTTATACGCGGAC,8,1875291
hyuA_predicted,2.2,14,4,GTTTCCAGATGCGCATGATA,10,1838717
hyuA_predicted,1.2,9,4,GTTGTAGTAGCGCAAAGCTA,5,1846463
hyuA_predicted,0.4,5,4,GTTGGCAGAGGCGAGGTATG,1,1843331
hyuA_predicted,2.4,15,4,GTTGACGTGTCTGACTGCCC,11,1863527
hyuA_predicted,6.4,35,4,GTTCGAAGGCATCGTGTCGT,31,1832844
hyuA_predicted,0.4,5,4,GTTATTATTCTGTCTGACTC,1,1852435
hyuA_predicted,0.4,5,4,GTTATCGACTTAGTGCTTAG,1,1843336
hyuA_predicted,4.6,26,4,GTTACTGCACCTCCTTCGGT,22,1860704
hyuA_predicted,3.0,18,4,GTTAAGTATTGTATCGCTCT,14,1830315
hyuA_predicted,3.6,21,4,GTGTGGCAGATCACCACTTC,17,1873912
hyuA_predicted,1.6,11,4,GTGTAAAACAGAGATACAGT,7,1866198
hyuA_predicted,0.4,5,4,GTGGGTGTAACGCGCCTAAA,1,1841311
hyuA_predicted,1.4,10,4,GTGCACCTATGCGCGGCTAC,6,1835870
hyuA_predicted,1.4,10,4,GTGACTCAACATTTTCAGTA,6,1853947
hyuA_predicted,1.2,9,4,GTCTTCTGTGCGGTGCATAG,5,1874663
hyuA_predicted,5.8,32,4,GTCTGGGAATGGTCTACATC,28,1862880
hyuA_predicted,0.8,7,4,GTCTCACATGAACGCATACT,3,1873086
hyuA_predicted,1.0,8,4,GTCGCCATTGTAATGTCACA,4,1843814
hyuA_predicted,0.4,5,4,GTCACCCCGAATTGCTGTGG,1,1845200
hyuA_predicted,3.6,21,4,GTACAGGAGTCGCATCAGCT,17,1854983
hyuA_predicted,0.6,6,4,GTAACACACATTCGTCGTTT,2,1872510
hyuA_predicted,0.4,5,4,GGTTGTGTGGATTTCGATTA,1,1849235
hyuA_predicted,0.6,6,4,GGTGTCCACATGGCAACCTC,2,1861823
hyuA_predicted,1.0,8,4,GGTGGTTTTGTCACCTGACA,4,1834039
hyuA_predicted,0.8,7,4,GGTGAAAACCCTTAGTAGTT,3,1851486
hyuA_predicted,9.2,49,4,GGTCGAGGGCATATTACGCT,45,1837956
hyuA_predicted,1.0,8,4,GGTACACTGCTCGGTCGCGA,4,1849784
hyuA_predicted,0.8,7,4,GGGTTGTACGGCGGGCAGGA,3,1868390
hyuA_predicted,2.6,16,4,GGGTGGACAATCTTATTCGT,12,1845371
hyuA_predicted,0.6,6,4,GGGTATCTGACCCACAGGTG,2,1856674
hyuA_predicted,2.4,15,4,GGGCGTTAGCTGAGCCGAAT,11,1872804
hyuA_predicted,1.8,12,4,GGGCGCACTGCGTACTCAAG,8,1837236
hyuA_predicted,7.2,39,4,GGGAGCCCTATCTCGGGAAA,35,1850835
hyuA_predicted,3.0,18,4,GGGAATGTAACTATCTAGCG,14,1867395
hyuA_predicted,5.8,32,4,GGCGTAAGCACCCACACCAA,28,1844426
hyuA_predicted,3.0,18,4,GGCGGGTCGTAGGGGACAGT,14,1846271
hyuA_predicted,1.6,11,4,GGCGGAAACTTGTCTAATGC,7,1830588
hyuA_predicted,0.8,7,4,GGCCTTGAGTGATGAGTTAT,3,1858221
hyuA_predicted,2.4,15,4,GGCCAAACTTACAGCAGGCA,11,1834643
hyuA_predicted,1.4,10,4,GGATCAACGATTTTCAGAAA,6,1838989
hyuA_predicted,2.0,13,4,GGAGTCACTCATTAATCTGC,9,1860987
hyuA_predicted,1.6,11,4,GGACTGGGAATCTCTAGGCT,7,1846460
hyuA_predicted,2.0,13,4,GGACGTTCCACGCTGTCGGA,9,1861084
hyuA_predicted,4.2,24,4,GCTTTTACCTTCACAGTGAA,20,1838266
hyuA_predicted,0.4,5,4,GCTGTAACTCCACTAGATTA,1,1874585
hyuA_predicted,3.4,20,4,GCTGGATAGGTATTGCTTCC,16,1866304
hyuA_predicted,2.8,17,4,GCTATTCACCCACCGCTATG,13,1868827
hyuA_predicted,1.4,10,4,GCTAATCCGTGCATCGTATA,6,1853298
hyuA_predicted,2.6,16,4,GCTAAGATCCGGGATCGAAG,12,1843453
hyuA_predicted,0.6,6,4,GCTAAGAAACAGCCTGAAAT,2,1839648
hyuA_predicted,2.4,15,4,GCGTCCGGAGCGAAGATACT,11,1863937
hyuA_predicted,0.8,7,4,GCGTAACGGCTGCTGGACAG,3,1856347
hyuA_predicted,0.8,7,4,GCGGGTGATGCCAGATGTTC,3,1860658
hyuA_predicted,4.2,24,4,GCGGCGCGGACTGTGCACAA,20,1843790
hyuA_predicted,0.4,5,4,GCGGCCTTCCCCAAAAACAT,1,1848118
hyuA_predicted,0.4,5,4,GCGCGATTCCCCAACTAACA,1,1875100
hyuA_predicted,0.8,7,4,GCCTGTCCTTCGAGGGCACT,3,1834575
hyuA_predicted,0.4,5,4,GCCAGAGGTTGTAAAAAGAT,1,1850570
hyuA_predicted,2.8,17,4,GCACTTCTTTGTCTGGTAGC,13,1870659
hyuA_predicted,0.4,5,4,GCACGAGGTAAGCACCAACA,1,1845500
hyuA_predicted,0.6,6,4,GCACGAGCGTGGACTTTCCT,2,1852620
hyuA_predicted,0.8,7,4,GCAACCAGTGTAGTGTGCCC,3,1851251
hyuA_predicted,0.6,6,4,GATCCATATGGTCTGCCGTC,2,1844813
hyuA_predicted,2.2,14,4,GATCAGACGCAACGTGCCCT,10,1866149
hyuA_predicted,0.8,7,4,GATACGGCAACCCCAACTGG,3,1861673
hyuA_predicted,2.4,15,4,GAGTAAAAAATTCAAAGTGA,11,1858436
hyuA_predicted,4.6,26,4,GAGGTAAAACCCATGTTGAA,22,1858304
hyuA_predicted,1.2,9,4,GAGCTGGCATAGGGAATAGT,5,1843264
hyuA_predicted,1.2,9,4,GAGATACAATCCGCGGAGGA,5,1850483
hyuA_predicted,4.8,27,4,GACTATTCATACGAGTCGTT,23,1835524
hyuA_predicted,0.4,5,4,GACTATCAGGCCAAGATTTG,1,1830345
hyuA_predicted,4.6,26,4,GACAACTGTACGCTAGCCCT,22,1854249
hyuA_predicted,1.2,9,4,GAATACAAGAGGTTACAGCA,5,1853359
hyuA_predicted,0.4,5,4,GAACAGAATGTAATGGATCA,1,1869008
hyuA_predicted,0.6,6,4,GAAAGCGACGCATGCGGGAG,2,1829580
hyuA_predicted,2.8,17,4,CTTGGGGTACATGTTCTACA,13,1837214
hyuA_predicted,6.4,35,4,CTTGGCGGTCCCCTCGCCGA,31,1870274
hyuA_predicted,3.2,19,4,CTTCTCTCGCCGCAACGTCC,15,1871863
hyuA_predicted,0.4,5,4,CTTCTCATAACGCTACATTA,1,1835291
hyuA_predicted,4.2,24,4,CTTCGACTTTTAGAGTACGT,20,1842796
hyuA_predicted,4.4,25,4,CTGTCTATACCAGCGATGCC,21,1834381
hyuA_predicted,2.6,16,4,CTGGTGTACAACGTTCTGCA,12,1861240
hyuA_predicted,0.6,6,4,CTGCGAGTTTTTGCTACAAG,2,1874607
hyuA_predicted,2.8,17,4,CTGCCATCGACCTTGTGTAC,13,1846470
hyuA_predicted,2.0,13,4,CTGCCACGATTAACTCGGGG,9,1832982
hyuA_predicted,0.4,5,4,CTGCAACACAAGCTTTATGG,1,1859916
hyuA_predicted,0.6,6,4,CTGACAGGTTCAGAATATTC,2,1870432
hyuA_predicted,0.8,7,4,CTGAAGGCCGCTCAAGCTGA,3,1859711
hyuA_predicted,1.4,10,4,CTCTTCCCCGAAATGAGAGT,6,1859998
hyuA_predicted,4.0,23,4,CTCGTATCGTCCAGCATGGA,19,1858800
hyuA_predicted,4.6,26,4,CTCGCGCACCCGGACTGTAC,22,1851997
hyuA_predicted,1.8,12,4,CTCCTCTGCTCTGGCAATTC,8,1848759
hyuA_predicted,2.2,14,4,CTCCTAGCAAGTAAATCTGT,10,1837179
hyuA_predicted,2.2,14,4,CTCCTACAGTGGGGTAACAG,10,1834566
hyuA_predicted,2.8,17,4,CTCCGTATAACGATTCCCCT,13,1837111
hyuA_predicted,2.6,16,4,CTCCCTAGCCGAGCATCGAC,12,1859224
hyuA_predicted,0.4,5,4,CTCCCGCGGTAGGGTGCGAT,1,1857128
hyuA_predicted,3.6,21,4,CTCCAAACGCCAATCGTTGG,17,1837641
hyuA_predicted,5.0,28,4,CTCAGTGCAGATTTAAAAAC,24,1869642
hyuA_predicted,4.6,26,4,CTCAGGATTAGGCTTCGTCA,22,1833137
hyuA_predicted,1.6,11,4,CTCACCATAACAACGTCCTC,7,1839197
hyuA_predicted,3.0,18,4,CTAGTTACTTACTAGGTTAA,14,1835151
hyuA_predicted,0.8,7,4,CTAGTCCGAAGCACTTCTAG,3,1866921
hyuA_predicted,0.6,6,4,CGTTCGTCTGATTCGTTAGC,2,1848947
hyuA_predicted,0.6,6,4,CGTGGACGGGACTGCTGGTC,2,1856746
hyuA_predicted,2.4,15,4,CGTGCTAAATTGCAGGAACT,11,1854675
hyuA_predicted,0.4,5,4,CGTGCCTAAGCCGCAGGCTG,1,1860854
hyuA_predicted,0.6,6,4,CGTGACCGGTATAGGCTAGA,2,1861739
hyuA_predicted,4.2,24,4,CGTATTAGCGGAGAGAAGTT,20,1866021
hyuA_predicted,0.4,5,4,CGTAGCTCCTTATCCTCGAA,1,1857919
hyuA_predicted,1.8,12,4,CGTAATTCCCGAATTGCAAT,8,1846177
hyuA_predicted,2.2,14,4,CGGTTGTAGACCCCTTTGCT,10,1867144
hyuA_predicted,1.2,9,4,CGGATCTACGACTGTAAAGC,5,1849737
hyuA_predicted,3.6,21,4,CGCTTCCAGGCTTCGGTCTC,17,1849984
hyuA_predicted,4.8,27,4,CGCGTCCTCCGACTCACGGG,23,1845393
hyuA_predicted,2.2,14,4,CGATTTGTAACTCGGCCTAA,10,1872330
hyuA_predicted,0.4,5,4,CGATGCTACCAACTTAGGCT,1,1830395
hyuA_predicted,7.2,39,4,CGAGTTGGAAAGGTAACGCT,35,1857673
hyuA_predicted,2.4,15,4,CGAGGTGCGCGTTTACAGTA,11,1869903
hyuA_predicted,2.2,14,4,CGACCATATCTGAAATTAGT,10,1855514
hyuA_predicted,2.0,13,4,CGAAGGGCACCGCTGACAGA,9,1867799
hyuA_predicted,0.4,5,4,CGAACCTACAATGCATCTGG,1,1858576
hyuA_predicted,1.0,8,4,CCTGGGCCGGTGGCCCATTA,4,1860512
hyuA_predicted,1.2,9,4,CCTCACGCAAAGTGCACTCC,5,1864708
hyuA_predicted,0.4,5,4,CCTATATACAGTCGAGAGGC,1,1837029
hyuA_predicted,4.8,27,4,CCGTAAGCCACGGGTGGACA,23,1835568
hyuA_predicted,0.6,6,4,CCGGAAAGTGCTCCGCTAGT,2,1863263
hyuA_predicted,0.6,6,4,CCGCGGGAATCTCGACTCGA,2,1871491
hyuA_predicted,1.2,9,4,CCGCCGATAGCACGTCCGAC,5,1843657
hyuA_predicted,0.4,5,4,CCCGGACCAAGGAGCCCATA,1,1842987
hyuA_predicted,2.0,13,4,CCCCTAGCTTGTCTTAAGCT,9,1834389
hyuA_predicted,4.0,23,4,CCATTGGTCTTCGGCAGCGT,19,1862571
hyuA_predicted,2.2,14,4,CCAGGTAGATGCGACTACTT,10,1835947
hyuA_predicted,2.8,17,4,CCAGCGGCTTTAGTTTGGCA,13,1869760
hyuA_predicted,2.0,13,4,CATTCAATAGTTGACTTAAT,9,1844875
hyuA_predicted,3.0,18,4,CATTATAGGAAATATTCAGG,14,1835809
hyuA_predicted,3.4,20,4,CATGCGCGAACGTGAACTCT,16,1844387
hyuA_predicted,4.2,24,4,CATGCAGTCATTCCTGCCTG,20,1833672
hyuA_predicted,1.4,10,4,CATGACGAGAGCAGCCGGAG,6,1861962
hyuA_predicted,1.0,8,4,CATCTAAAGATTTGTGCTGT,4,1833239
hyuA_predicted,5.2,29,4,CATATTGACATACTGCTATT,25,1841021
hyuA_predicted,0.6,6,4,CAGTCGTAGATTCGCCCATC,2,1830497
hyuA_predicted,0.4,5,4,CAGTCACGAGCCCCCAGCTA,1,1860942
hyuA_predicted,2.8,17,4,CAGGGCTTAAATAGGATATG,13,1837985
hyuA_predicted,3.8,22,4,CAGGACGCCAGTGTTCCCTC,18,1842997
hyuA_predicted,7.2,39,4,CAGCTTTAGTTCAGGCGCCC,35,1863500
hyuA_predicted,7.8,42,4,CAGCCTCCACGCCCGTGGCC,38,1850389
hyuA_predicted,1.8,12,4,CACGGTGCGGCTATGTCACT,8,1832697
hyuA_predicted,4.2,24,4,CACATCCGGTATTCCACGAA,20,1860243
hyuA_predicted,4.6,26,4,CACACCTTGGTGCGCCGCTC,22,1846689
hyuA_predicted,2.0,13,4,CAACTTCAGCACGACAGGCA,9,1841728
hyuA_predicted,4.8,27,4,CAACTCAGAAGTTCAAGATG,23,1847074
hyuA_predicted,0.4,5,4,ATTTTGTGTATCCTGTACGT,1,1829323
hyuA_predicted,3.2,19,4,ATTTCTCCACTTGGCTCGAG,15,1874742
hyuA_predicted,0.4,5,4,ATTTAAAAAACTATCACCTC,1,1838243
hyuA_predicted,0.4,5,4,ATTGGATTGCTTCCTGCGTA,1,1843219
hyuA_predicted,0.6,6,4,ATTCCGCGTTTTACCCGATG,2,1838807
hyuA_predicted,4.4,25,4,ATTAATGGACTAGGGCGTGG,21,1871811
hyuA_predicted,0.4,5,4,ATTAAATGTGTTCTCTACCC,1,1862781
hyuA_predicted,0.4,5,4,ATGTGGTCGTTCTCCTCAAC,1,1832977
hyuA_predicted,6.6,36,4,ATGCTCGGTCGCAACATGTA,32,1844612
hyuA_predicted,7.8,42,4,ATGACCGGGCAAGATTGAGT,38,1865101
hyuA_predicted,6.4,35,4,ATCTCACCAGCATGGGAGTA,31,1835738
hyuA_predicted,1.6,11,4,ATCGTTGGGCAGGGATCCCT,7,1842163
hyuA_predicted,1.2,9,4,ATCGCTGACACTTGCTAGTC,5,1832506
hyuA_predicted,1.4,10,4,ATCGCGCAACTCCTCACCTA,6,1859810
hyuA_predicted,1.0,8,4,ATCCGTGGTTGGATTAATTT,4,1839244
hyuA_predicted,1.4,10,4,ATCCACTGAAGAGGTACGTA,6,1849196
hyuA_predicted,1.0,8,4,ATATGAACCTACTGATTGCG,4,1864833
hyuA_predicted,1.0,8,4,ATAGTTGGCGGTTCTCCGCA,4,1872663
hyuA_predicted,2.6,16,4,ATAGCTAAAGGGGCATAACC,12,1850094
hyuA_predicted,0.8,7,4,ATAGCCTCCGGGGTCTTCGG,3,1873410
hyuA_predicted,4.8,27,4,ATAGATACAATCTCCCATGA,23,1841373
hyuA_predicted,0.8,7,4,ATACGGGAAAGCGAGTGGAG,3,1873882
hyuA_predicted,1.8,12,4,AGTTGCCCTCAGTTCAACAG,8,1873955
hyuA_predicted,0.8,7,4,AGTTGACACTGAGTACGCAA,3,1833044
hyuA_predicted,1.4,10,4,AGTTCAGCGATGTTAGATGA,6,1873045
hyuA_predicted,2.6,16,4,AGTGTGAGATTAAGAGTAGC,12,1877873
hyuA_predicted,1.4,10,4,AGTGCGGTTTTGACCTTGAT,6,1850678
hyuA_predicted,7.4,40,4,AGGTTCGTGAGGCCCGCTTT,36,1866972
hyuA_predicted,0.6,6,4,AGGTGTGCAATAACAGACAG,2,1846885
hyuA_predicted,1.6,11,4,AGGCGGTGGCTCCGCACTAA,7,1873119
hyuA_predicted,2.8,17,4,AGGCCCCGCGGTTTACACAT,13,1866312
hyuA_predicted,3.4,20,4,AGGAAAGGCAAAGGTAGGGG,16,1829952
hyuA_predicted,3.8,22,4,AGCCTATGTATTAGCGGCGG,18,1874946
hyuA_predicted,2.6,16,4,AGCCGGGTCTTTAGGGAATG,12,1844547
hyuA_predicted,4.6,26,4,AGCCCAATTCTGCAAGTTAC,22,1853800
hyuA_predicted,0.8,7,4,AGCAGAAGAGGCCTTAGCCA,3,1855989
hyuA_predicted,0.4,5,4,AGATTTGTTGACGGCTTGGG,1,1846046
hyuA_predicted,7.6,41,4,AGATTGCTGAAGTTACCCTG,37,1839450
hyuA_predicted,3.6,21,4,AGATATCATCGAATGTTTAT,17,1842294
hyuA_predicted,0.4,5,4,AGAGCACTTAACTAACGTGT,1,1847918
hyuA_predicted,3.4,20,4,AGAATTCTCAATGCTATGAC,16,1873430
hyuA_predicted,1.6,11,4,AGAACCAGTCAAAGTGGCGC,7,1847367
hyuA_predicted,0.6,6,4,ACTTAGGGTGATAGCTGAGG,2,1860184
hyuA_predicted,0.6,6,4,ACTGGCGAGAGAGGTACAAC,2,1864319
hyuA_predicted,0.4,5,4,ACTGAGAACCCATGCCTATC,1,1843228
hyuA_predicted,3.2,19,4,ACTCGCCAGAGAGCGGGCTA,15,1854284
hyuA_predicted,4.8,27,4,ACTCGACTATTTCGCCGTCT,23,1874335
hyuA_predicted,1.2,9,4,ACTCAGCGGCGGCATCGTAT,5,1864140
hyuA_predicted,2.4,15,4,ACTCAATCGTACTTTCACTC,11,1856152
hyuA_predicted,0.8,7,4,ACTATAGTTCTCGAGAGACA,3,1853901
hyuA_predicted,1.8,12,4,ACGTTGAACAGGGGGGCCAA,8,1833150
hyuA_predicted,6.0,33,4,ACGTCTCTCTGTTCGTGGGC,29,1847524
hyuA_predicted,2.0,13,4,ACGGTCCATATCATCAATTG,9,1843496
hyuA_predicted,1.2,9,4,ACGGGGCAGGCCCGGACTTT,5,1869649
hyuA_predicted,1.4,10,4,ACGGGGAGGTTATGGACCAA,6,1851926
hyuA_predicted,5.4,30,4,ACGGCAGCCCGGTGCTAACA,26,1867382
hyuA_predicted,0.4,5,4,ACGCTCGACTGCGGGTTTGA,1,1873481
hyuA_predicted,2.2,14,4,ACCCGATAGATTCCCGGGTT,10,1877058
hyuA_predicted,1.8,12,4,ACCCCAGGTCCAGTGATTCT,8,1873839
hyuA_predicted,1.0,8,4,ACCCAGCCCGGATTCCGGAT,4,1865898
hyuA_predicted,1.6,11,4,ACCCAATGCCCCCTACCTGC,7,1867672
hyuA_predicted,1.2,9,4,ACATTTCGATGCTCTTTCAC,5,1844672
hyuA_predicted,3.0,18,4,ACATGCTCTTCAATTTGTAT,14,1862595
hyuA_predicted,0.6,6,4,ACATATACGACATTGAATTC,2,1836921
hyuA_predicted,1.0,8,4,ACAGTAAAGCACCTTATTGT,4,1871150
hyuA_predicted,0.4,5,4,ACAACGACCTAAATTAAAGT,1,1857869
hyuA_predicted,3.6,21,4,ACAAATTCCGCAGCTAAGTT,17,1837685
hyuA_predicted,0.4,5,4,AATTTGGTCTGTCCCAGCGT,1,1854174
hyuA_predicted,2.6,16,4,AATTGTGCCTCCGGGCTTTC,12,1855997
hyuA_predicted,1.6,11,4,AATGTCATGGAGATATCAAG,7,1860129
hyuA_predicted,1.0,8,4,AATAGTCGTGTCCGGAGACC,4,1871510
hyuA_predicted,1.2,9,4,AATACTTAAAGCGGCCTAAA,5,1867093
hyuA_predicted,1.2,9,4,AAGTTCTTACTCATCGGCGA,5,1831737
hyuA_predicted,2.2,14,4,AAGTATGACGGCGCGGGGTA,10,1844393
hyuA_predicted,1.6,11,4,AAGTAACCGCAAGCTTCCAT,7,1829195
hyuA_predicted,1.0,8,4,AAGCACACCTTCGGCGTAAT,4,1848434
hyuA_predicted,0.4,5,4,AAGATTAGTTCTCTCGGCCG,1,1869901
hyuA_predicted,5.2,29,4,AAGATATTGTCACAGTCAGA,25,1856641
hyuA_predicted,0.4,5,4,AAGAAGCAGTTTCTCATCTC,1,1858631
hyuA_predicted,1.0,8,4,AACGGGTCCACTGCTCTGGC,4,1871102
hyuA_predicted,4.0,23,4,AACCTGCTATATCCAACGGG,19,1861511
hyuA_predicted,3.4,20,4,AACCCATTGGGCAATGGTTT,16,1877271
hyuA_predicted,2.4,15,4,AAATTCGAAGAGGGGTCCAC,11,1874143
hyuA_predicted,0.6,6,4,AAAGTTCGTAGATCGGAGTT,2,1831692
hyuA_predicted,0.8,7,4,AAAAAGGCAGTACGGTCTGT,3,1873900
hyuA_predicted,1.0,6,3,TTTGTTCCCGGGGCGCCGTG,3,1838861
hyuA_predicted,2.5,12,3,TTTGTTAACAGCATATTCAA,9,1870456
hyuA_predicted,6.5,28,3,TTTGTGCGGCGCTCGACAGT,25,1866812
hyuA_predicted,3.0,14,3,TTTCAAAATTTATCAGATTA,11,1842020
hyuA_predicted,3.5,16,3,TTTATCTCCTTCCCCCCAGA,13,1846971
hyuA_predicted,5.5,24,3,TTTAGGGTTGTACAGGCTCA,21,1836265
hyuA_predicted,1.0,6,3,TTTAAGGTACCCTTCATTGT,3,1833497
hyuA_predicted,6.25,27,3,TTGGATGACTGCGTAATCCT,24,1867789
hyuA_predicted,1.25,7,3,TTCTCTGAGGATGACCGGCA,4,1864993
hyuA_predicted,0.5,4,3,TTCATCAGCCGCACCATGTG,1,1846995
hyuA_predicted,2.25,11,3,TTCATCACTTTTGGAGGACC,8,1832108
hyuA_predicted,2.0,10,3,TTCAGTTTGAGCGACTGAAA,7,1858575
hyuA_predicted,4.0,18,3,TTCAATTCATTCCGAGGCTT,15,1873630
hyuA_predicted,1.25,7,3,TTATTTTCCTCACGTTCTAT,4,1844408
hyuA_predicted,3.5,16,3,TTAGTAAGTTTTTTTTTCCT,13,1836461
hyuA_predicted,5.5,24,3,TTAGGCTCCTCGGCCCCTAT,21,1849519
hyuA_predicted,1.5,8,3,TTACGGACCCTGATTGCTTA,5,1850578
hyuA_predicted,1.0,6,3,TGTTGCCGGTGAAGAAGCAT,3,1866150
hyuA_predicted,1.5,8,3,TGTTCAGGGGCGACTCCGGT,5,1847530
hyuA_predicted,4.0,18,3,TGTGACCACGTAATTGAAAT,15,1832744
hyuA_predicted,4.25,19,3,TGTCCAACGCGGATGATTTA,16,1867103
hyuA_predicted,2.0,10,3,TGTACGGAACCAGAGACACA,7,1843039
hyuA_predicted,5.0,22,3,TGGGGGTAGTAGTTTTAGGT,19,1858896
hyuA_predicted,1.75,9,3,TGGGCAGTACGTCTTTCGTG,6,1829196
hyuA_predicted,0.5,4,3,TGGGACTTGTACTTGCGTAG,1,1847520
hyuA_predicted,7.25,31,3,TGGCTGGGTAATCAGATCCG,28,1847692
hyuA_predicted,0.5,4,3,TGGATGTATAGCGGATCTTA,1,1854967
hyuA_predicted,1.25,7,3,TGGATCTTACGAACGGGCGT,4,1870660
hyuA_predicted,0.75,5,3,TGGAGTGACAAAGAGGGGAG,2,1840241
hyuA_predicted,9.0,38,3,TGCGCCCGGTAGTTCGGCTT,35,1868471
hyuA_predicted,0.75,5,3,TGCATGCCAGCTGTAAGAGG,2,1861301
hyuA_predicted,0.5,4,3,TGATTTCATGCTCTCCTCTA,1,1859868
hyuA_predicted,0.75,5,3,TGATACTTTCCAAGGGGAGA,2,1841653
hyuA_predicted,3.75,17,3,TGACAGCACGGACTCATTAA,14,1831778
hyuA_predicted,2.75,13,3,TCTTGTTAGTTATAGCCGAT,10,1847458
hyuA_predicted,2.5,12,3,TCTTAGTGGTGGATCAGGCT,9,1832360
hyuA_predicted,2.75,13,3,TCTGGGGAATGGCCCGTTGT,10,1864397
hyuA_predicted,8.0,34,3,TCTCTCATCGAGGTTCTGAA,31,1862721
hyuA_predicted,0.5,4,3,TCTCACGCGCAGCTAGAAAC,1,1871263
hyuA_predicted,4.75,21,3,TCGTTTGGTCCCACAATTAA,18,1853862
hyuA_predicted,4.0,18,3,TCGGCAATCTGTGATGATAG,15,1856179
hyuA_predicted,1.0,6,3,TCGCGGGTCCAAGTAGACAG,3,1837399
hyuA_predicted,2.5,12,3,TCGAATTCGTGTGGGGGAGC,9,1866876
hyuA_predicted,7.5,32,3,TCCTGGGAGCGTGAACGAGT,29,1866811
hyuA_predicted,1.75,9,3,TCCTGGCAGAGGTTGGGCTA,6,1867654
hyuA_predicted,1.25,7,3,TCCTCAATGCTTTTAAATGT,4,1828962
hyuA_predicted,14.0,58,3,TCCCTTCATAAGCCTAATTG,55,1873653
hyuA_predicted,3.25,15,3,TCCCCTCGGCAAACCCAACC,12,1841610
hyuA_predicted,2.25,11,3,TCCAGTAGCCCCGATGGCTA,8,1847093
hyuA_predicted,0.5,4,3,TCCAGCTTTTGACATCTATA,1,1853276
hyuA_predicted,9.5,40,3,TCATTCGGACTCTACCATCT,37,1860348
hyuA_predicted,2.75,13,3,TCAGGGCTGCAGGGGATAAA,10,1831837
hyuA_predicted,1.25,7,3,TATTATAGGGCCGTGCCTGA,4,1840704
hyuA_predicted,1.0,6,3,TATCCGAAAGCCTTCGACGT,3,1870970
hyuA_predicted,2.5,12,3,TATCAGTTTGCGCGTCATAG,9,1836453
hyuA_predicted,2.0,10,3,TATAGTTCATCGGTGATACA,7,1866848
hyuA_predicted,5.0,22,3,TATACGGTGATCTGGCTCCT,19,1830264
hyuA_predicted,2.75,13,3,TAGGAAGAGGACGGCAGATC,10,1853092
hyuA_predicted,0.75,5,3,TAGCTGCGATCCGCCACCAG,2,1844559
hyuA_predicted,2.5,12,3,TAGCAACACACAGTGACTTT,9,1843779
hyuA_predicted,1.25,7,3,TAGAGAAACCCAGGAGACGG,4,1856287
hyuA_predicted,7.25,31,3,TACTTACTGCGTGTGCATTT,28,1834063
hyuA_predicted,0.75,5,3,TACTCCCGCAAAGGACCTCA,2,1850179
hyuA_predicted,3.25,15,3,TACGCATGCTACAAACGCTT,12,1864352
hyuA_predicted,1.0,6,3,TACATTCGTGGGCAAGGACT,3,1856665
hyuA_predicted,3.5,16,3,TACAAGAACGGGAATTTGTA,13,1859653
hyuA_predicted,0.75,5,3,TAATGCTACCAAGAGGATGT,2,1870070
hyuA_predicted,1.75,9,3,TAATCTGGCCATCCCTAAGC,6,1848789
hyuA_predicted,1.25,7,3,TAAGGCCCGTCGAGACCTGT,4,1861926
hyuA_predicted,2.0,10,3,TAAGCTCGCTAATTCCCCGT,7,1863450
hyuA_predicted,3.5,16,3,TAAGCACGACAGGGACTCAC,13,1875662
hyuA_predicted,0.75,5,3,TAACTGATTTCGTCTGTCCG,2,1855264
hyuA_predicted,1.0,6,3,TAAAAGGGCAGTATGGGGGA,3,1856747
hyuA_predicted,0.5,4,3,GTTGGTGTGCCCACGGAGGG,1,1841612
hyuA_predicted,1.25,7,3,GTTATGCATGTTCCATAGTT,4,1829993
hyuA_predicted,1.25,7,3,GTGTGGTCCGTGGCCCACCC,4,1839788
hyuA_predicted,1.25,7,3,GTGTGGCTTCATCTTAAGTA,4,1859935
hyuA_predicted,0.75,5,3,GTGTCATAAACCAGGTAAAG,2,1831222
hyuA_predicted,1.0,6,3,GTGGACTCTGAGTGTTATGT,3,1869518
hyuA_predicted,1.25,7,3,GTGCTCCTCAGACGATTCCC,4,1842754
hyuA_predicted,0.5,4,3,GTCTGCGCTAGCTTATAGCG,1,1857639
hyuA_predicted,1.0,6,3,GTCCTTGTTAGGATCTTCAC,3,1853331
hyuA_predicted,2.75,13,3,GTCCGTCACGGACTACACCG,10,1864564
hyuA_predicted,2.75,13,3,GTCCCTCCAGTCTATAAATA,10,1870453
hyuA_predicted,0.75,5,3,GTCAGTGTTGCGATGGAAAT,2,1868936
hyuA_predicted,1.25,7,3,GTCACGAGACCGCGTCACAG,4,1850338
hyuA_predicted,2.5,12,3,GTATTACGGGGTAAGGAACC,9,1835330
hyuA_predicted,2.75,13,3,GTAAGTTCTGATTAACCTAG,10,1840020
hyuA_predicted,1.75,9,3,GTAACTCTGAAGCCAATCTT,6,1847082
hyuA_predicted,1.0,6,3,GTAACAGCCAGTGTGCGAAC,3,1834890
hyuA_predicted,0.5,4,3,GGTTGGTACACATCTGCATA,1,1847557
hyuA_predicted,5.75,25,3,GGTGCGCACCAGTGTCATTA,22,1870999
hyuA_predicted,0.5,4,3,GGTCTTGGTTCTTGTTCCAT,1,1832669
hyuA_predicted,0.5,4,3,GGTAGAACAACGCTTAAAGA,1,1869615
hyuA_predicted,0.5,4,3,GGGTGATATGTTACCACCCG,1,1854948
hyuA_predicted,1.0,6,3,GGGTCCTTTTCCCCAAATTT,3,1873889
hyuA_predicted,0.75,5,3,GGGGTGTTACTAGGCTGCGT,2,1877866
hyuA_predicted,3.0,14,3,GGGGTCGTCTATCACGATTC,11,1872532
hyuA_predicted,0.75,5,3,GGGGCTACTGGCAATCAGGC,2,1840844
hyuA_predicted,2.75,13,3,GGGATCCCTAAACCAGCCCC,10,1852462
hyuA_predicted,1.75,9,3,GGCTCACAACAACAGAGCAA,6,1839457
hyuA_predicted,3.5,16,3,GGCGGGACCTCTGTAGAAAA,13,1864454
hyuA_predicted,0.5,4,3,GGCGCACTGAAGATGGAGCC,1,1831693
hyuA_predicted,1.0,6,3,GGCACGCAGAACCGGCGCAA,3,1853793
hyuA_predicted,2.0,10,3,GGAGTATTGTTTGTGAATGT,7,1847479
hyuA_predicted,3.0,14,3,GCTTGAGTGACGACGCGTAG,11,1853655
hyuA_predicted,2.25,11,3,GCTCGTGCGTTATGGACATG,8,1859478
hyuA_predicted,0.75,5,3,GCTCGGAGGGAGATACTCTT,2,1872471
hyuA_predicted,0.75,5,3,GCTCCGTCTTGGTGAGCCCT,2,1834438
hyuA_predicted,3.25,15,3,GCTATTTCCACCCTATACGA,12,1833492
hyuA_predicted,2.0,10,3,GCTATACGACTCCTAATGTT,7,1841424
hyuA_predicted,1.5,8,3,GCTAGACCTGTCTCTGCAAA,5,1841380
hyuA_predicted,1.25,7,3,GCGTTACGTGGCTTCCGGCC,4,1841377
hyuA_predicted,12.0,50,3,GCGGTAGTACACGGAACTCT,47,1834129
hyuA_predicted,1.0,6,3,GCCTTAGGGATGGTGGGTAG,3,1867631
hyuA_predicted,0.5,4,3,GCCTATTCTGTGGTGAACAA,1,1865510
hyuA_predicted,1.75,9,3,GCCTAGCGTTTCTTTCGTAG,6,1849817
hyuA_predicted,4.75,21,3,GCCGTAGCCAGGCTCTTTCT,18,1870391
hyuA_predicted,0.5,4,3,GCCGGAATATTCTATCATTT,1,1864144
hyuA_predicted,0.5,4,3,GCCACCTGCCCATGATCAGT,1,1853729
hyuA_predicted,0.5,4,3,GCCAATGGAATAGGGCCTGC,1,1867164
hyuA_predicted,4.25,19,3,GCAGTCTTTTTCCCACTAGA,16,1829494
hyuA_predicted,0.75,5,3,GCAAGACTAAGAAGCCAATT,2,1855227
hyuA_predicted,2.75,13,3,GATTCAGCATGCTATCCGCT,10,1855809
hyuA_predicted,3.75,17,3,GATCGGGGACAGAACGTTCT,14,1866594
hyuA_predicted,2.25,11,3,GAGTGTAGGAACAAGCCCTA,8,1862299
hyuA_predicted,1.0,6,3,GAGTCATATTGAATTATAAG,3,1867122
hyuA_predicted,0.5,4,3,GAGTAACCTAGATTGGGCGC,1,1875135
hyuA_predicted,7.0,30,3,GAGGCCGGCGTGTGGGTCCT,27,1871613
hyuA_predicted,1.0,6,3,GAGCAATAACCTCCGTCTCT,3,1840262
hyuA_predicted,9.0,38,3,GAGACGAAGAAGTAAACCTC,35,1845281
hyuA_predicted,0.75,5,3,GACTGCAGATTCCATCTCCT,2,1840301
hyuA_predicted,2.0,10,3,GACTACGCGGGCAACATCAC,7,1832334
hyuA_predicted,1.25,7,3,GACCTGGTAGCAATCTTCCT,4,1865458
hyuA_predicted,0.5,4,3,GACCTCAGAGAGTTAGTCAT,1,1831514
hyuA_predicted,0.75,5,3,GAATTTAGGTGGAGGAGGTT,2,1841042
hyuA_predicted,4.0,18,3,GAATCATCGAGTATCTGCAT,15,1829722
hyuA_predicted,7.75,33,3,GAAGGCAAAAAAGAATTCAG,30,1839395
hyuA_predicted,3.0,14,3,GAAGCCCCTTGGTTAAATTG,11,1833343
hyuA_predicted,0.5,4,3,GAAGAGGTTTCATGAATTCG,1,1861343
hyuA_predicted,7.5,32,3,GAACCGGCTGGCACAGCAAT,29,1844542
hyuA_predicted,0.5,4,3,GAAATTCAGCGAGCTCGTCA,1,1863929
hyuA_predicted,1.75,9,3,GAAAGGTAAACCCGCCGCCA,6,1856402
hyuA_predicted,5.25,23,3,GAAACCATAATGTTCGGGCT,20,1869754
hyuA_predicted,2.5,12,3,GAAAACATTTTACGTTTCCT,9,1852473
hyuA_predicted,0.75,5,3,CTTTTGGTTTCTCATTCTAT,2,1865656
hyuA_predicted,1.5,8,3,CTTTATTCCTCCTCCCCTCA,5,1869570
hyuA_predicted,7.0,30,3,CTTTAGACCAATTTGCTGAG,27,1866243
hyuA_predicted,3.25,15,3,CTTAACCCCGGCCTTACCCA,12,1871065
hyuA_predicted,0.5,4,3,CTGGGCTAACGCAGCTCATT,1,1842843
hyuA_predicted,1.25,7,3,CTGCAATTGTCCAGCGGAAA,4,1857106
hyuA_predicted,4.25,19,3,CTGATAGGATCCAATGGTTC,16,1847833
hyuA_predicted,0.5,4,3,CTCTACAAGGGCCAGGCCAT,1,1835007
hyuA_predicted,0.5,4,3,CTCGGGTGCGTCTCGCGGAT,1,1873869
hyuA_predicted,0.5,4,3,CTCCAGCTCACCTTGCGCTT,1,1832928
hyuA_predicted,2.0,10,3,CTATGTGCTCTGGTCGCTAT,7,1871149
hyuA_predicted,2.25,11,3,CTAGATTTCGTGTATTTGCA,8,1859149
hyuA_predicted,4.5,20,3,CTAGAGAAAGGAAGGTGCAG,17,1864991
hyuA_predicted,3.25,15,3,CTACCAGCGCGACGAGCAGT,12,1876322
hyuA_predicted,2.75,13,3,CTACAAACTTTATTATTCCA,10,1850006
hyuA_predicted,3.75,17,3,CGTTGGTCTATGGAGCGCGG,14,1833591
hyuA_predicted,0.5,4,3,CGTGTCGTACGTAACGTCCT,1,1838728
hyuA_predicted,4.75,21,3,CGTCCCCTAGAGGCGCACAA,18,1831450
hyuA_predicted,0.75,5,3,CGTCCCAGCATCGTATACCT,2,1836419
hyuA_predicted,1.75,9,3,CGTATACACAAACGGGGCTG,6,1854435
hyuA_predicted,2.25,11,3,CGGGAGCTCGACTGAGAAGA,8,1847398
hyuA_predicted,2.0,10,3,CGGGAAGACACCTCGAGACC,7,1876705
hyuA_predicted,0.75,5,3,CGGAGCTCTGCCTCCCCGCT,2,1873185
hyuA_predicted,0.5,4,3,CGGAAGAGTAACCGGGACCT,1,1849703
hyuA_predicted,0.5,4,3,CGCTTTTTGTCCCGGGAAGT,1,1840986
hyuA_predicted,9.25,39,3,CGCTCGTCAGATATCCCCTG,36,1874096
hyuA_predicted,1.25,7,3,CGCCGTCATGTTAGTGGCAT,4,1850865
hyuA_predicted,2.0,10,3,CGCCCGAAGGCGTGGCCATT,7,1869945
hyuA_predicted,5.75,25,3,CGATTGTAAATTATCGGTGT,22,1845469
hyuA_predicted,0.5,4,3,CGATTACCTCCATTCAGCAG,1,1865387
hyuA_predicted,5.25,23,3,CGATCGTCAGGTGTAACGTC,20,1833405
hyuA_predicted,5.0,22,3,CGAGGCGGACTCGATGTGCT,19,1867508
hyuA_predicted,2.25,11,3,CGACGAAGCTGAGGAGGCCC,8,1835398
hyuA_predicted,3.0,14,3,CGACATGCTATGCAGCATTT,11,1834336
hyuA_predicted,1.25,7,3,CGAATGTTGTATCGAGCTGC,4,1857918
hyuA_predicted,3.0,14,3,CGAATATTCGACGACTGGTA,11,1871651
hyuA_predicted,1.25,7,3,CCTTTAGCGCAACGTCACAT,4,1836791
hyuA_predicted,2.75,13,3,CCTGTCGGTCAATTACTACT,10,1833685
hyuA_predicted,1.25,7,3,CCGTTAATCGCCGGGTGGTT,4,1831931
hyuA_predicted,7.0,30,3,CCGTGGCGCCCAATTCAACG,27,1857913
hyuA_predicted,1.75,9,3,CCGTCCAAGAAAGCCGTGGC,6,1854275
hyuA_predicted,2.0,10,3,CCGTATCTGGTTTCGTTCGG,7,1837516
hyuA_predicted,1.0,6,3,CCGGTCTGTTGTCTTATCTT,3,1844611
hyuA_predicted,6.0,26,3,CCGGAGAGCCAGCGCATGTT,23,1870372
hyuA_predicted,0.5,4,3,CCGCGCTCGACACCATCCTG,1,1843716
hyuA_predicted,1.75,9,3,CCGCCTAGTAGGGCCGGTAA,6,1865018
hyuA_predicted,0.75,5,3,CCGATACCCGCAAGCGGGCA,2,1843987
hyuA_predicted,5.5,24,3,CCCGGAAATTATGGGAACCT,21,1866331
hyuA_predicted,0.5,4,3,CCCGACCAGAATTAGCCCCT,1,1831688
hyuA_predicted,3.75,17,3,CCCGAACCTGTTGGACAATG,14,1860842
hyuA_predicted,3.0,14,3,CCCCTTAAGCGTACGAGCCC,11,1844608
hyuA_predicted,4.75,21,3,CCCCCGTGCCTTGGGTTATA,18,1867464
hyuA_predicted,2.0,10,3,CCCACTTAGTACCATGATGA,7,1835150
hyuA_predicted,3.25,15,3,CCATGTTCAGATTAAGCTCA,12,1830312
hyuA_predicted,0.75,5,3,CCATCTGGCGTGGTATATAG,2,1846045
hyuA_predicted,4.0,18,3,CCATACATTTCTTCCCTCTT,15,1869076
hyuA_predicted,1.5,8,3,CATTTCGGGGCGGAGCGGGC,5,1847500
hyuA_predicted,0.5,4,3,CATGTCTTATCATTTATAAC,1,1859496
hyuA_predicted,0.5,4,3,CAGTGGTGGCGTGTAAAACA,1,1831668
hyuA_predicted,1.25,7,3,CAGGCGGGAGCAGAGGGGAA,4,1868673
hyuA_predicted,3.25,15,3,CAGCTCTGCTAGTTGGCTTC,12,1864035
hyuA_predicted,2.75,13,3,CACTAAAAACATAGTTCATG,10,1842681
hyuA_predicted,1.5,8,3,CACCCCCATATGTCGTTACC,5,1864650
hyuA_predicted,6.25,27,3,CACCAGCAACTCGAGAAGCA,24,1870480
hyuA_predicted,0.75,5,3,CACAGGGGTCATTTCCGTAA,2,1842422
hyuA_predicted,2.0,10,3,CACACGCTTCGTCGTCACGT,7,1835532
hyuA_predicted,2.25,11,3,CAATACGTCGAAGTCCGAAT,8,1867295
hyuA_predicted,10.25,43,3,CAAGCGAAACGTATGCTATT,40,1870336
hyuA_predicted,5.75,25,3,CAAGAGAAATCTACAGCGCG,22,1838448
hyuA_predicted,0.5,4,3,CAACCCAGCGCTGGTGTAAC,1,1862591
hyuA_predicted,3.75,17,3,CAACCAAGGGTGTTACTCTC,14,1861620
hyuA_predicted,5.0,22,3,CAAACTCACCTGCGTTTGAT,19,1855484
hyuA_predicted,1.75,9,3,CAAACGCCGCTATCCTGCGT,6,1867976
hyuA_predicted,1.25,7,3,ATTTTTTAATCCGGGTAAGA,4,1874612
hyuA_predicted,2.25,11,3,ATTTAGGGCTTATGCTCATA,8,1846524
hyuA_predicted,5.75,25,3,ATTTACAAGCACATTAGGGA,22,1841353
hyuA_predicted,0.75,5,3,ATTGGCGTTTCTAAGAATAG,2,1854749
hyuA_predicted,1.0,6,3,ATTCGGTGGACAGCCCCGTC,3,1829061
hyuA_predicted,3.75,17,3,ATTCGGAACTTTAGAGTCAT,14,1836654
hyuA_predicted,2.25,11,3,ATTAGATATGAATACGGAAC,8,1857658
hyuA_predicted,3.25,15,3,ATTAACCTTGTGCGCGCTAT,12,1830220
hyuA_predicted,3.0,14,3,ATGTTTAGAGGTGAGAGCAG,11,1847412
hyuA_predicted,0.5,4,3,ATGTTCTCGTGGCGGTATCA,1,1855418
hyuA_predicted,5.75,25,3,ATGTGACGGGATAATCTGTC,22,1833284
hyuA_predicted,3.25,15,3,ATGTAGGTCAATCCTCGCGG,12,1847690
hyuA_predicted,2.25,11,3,ATGTAAGCCGACGCCAACAC,8,1831818
hyuA_predicted,2.75,13,3,ATGTAAATTTCTCGGGGAAC,10,1839364
hyuA_predicted,0.5,4,3,ATGGTTCAAACAGGCCGATT,1,1848154
hyuA_predicted,2.75,13,3,ATGCAGTTAGGATGTGGACG,10,1874334
hyuA_predicted,5.5,24,3,ATCTTGGTATCGCCAGCTTA,21,1835612
hyuA_predicted,0.5,4,3,ATCTAGTATTACACTCACGT,1,1836082
hyuA_predicted,3.75,17,3,ATCGGATCATAAGAAGAATG,14,1843230
hyuA_predicted,2.0,10,3,ATCGCCCTGCCCTGGGTTGG,7,1866535
hyuA_predicted,2.0,10,3,ATCAGCCTCGGATGTGTCCA,7,1849578
hyuA_predicted,0.5,4,3,ATCACATCGATCCGCAATAG,1,1837518
hyuA_predicted,2.0,10,3,ATATCAGCGCCACGATTTAT,7,1835186
hyuA_predicted,1.0,6,3,ATAGTTACGACATTGATCGT,3,1857066
hyuA_predicted,0.75,5,3,ATAACGTCCTCGGGGCGTCA,2,1850721
hyuA_predicted,2.0,10,3,ATAAAGTCACGTAAGGTCAT,7,1868612
hyuA_predicted,3.25,15,3,AGTTTCCCTGGAGAAGCCCT,12,1877590
hyuA_predicted,9.5,40,3,AGTTATAGTTATGCCCGAGC,37,1837419
hyuA_predicted,4.5,20,3,AGTGAACGACGGGACCCAAT,17,1877171
hyuA_predicted,2.25,11,3,AGTCGCATAACGGCCTATGC,8,1868212
hyuA_predicted,2.75,13,3,AGTATTGGTGGCCACCCAGA,10,1833251
hyuA_predicted,8.0,34,3,AGTAAACAGTCATTTATTCA,31,1851969
hyuA_predicted,0.75,5,3,AGGGTTGCCCGAGAAACACT,2,1832604
hyuA_predicted,6.5,28,3,AGGGCTGGTGGTCTCGTTGT,25,1844353
hyuA_predicted,1.0,6,3,AGGGACCCCAGTCAATTAGT,3,1842116
hyuA_predicted,1.75,9,3,AGGCACGTTAATTGACCTCC,6,1839924
hyuA_predicted,1.75,9,3,AGGCACGACCCTTCATACCC,6,1873004
hyuA_predicted,4.5,20,3,AGGCACCAATAGTACCGTGG,17,1859631
hyuA_predicted,2.25,11,3,AGGACAGATCTACCTAAAAC,8,1843476
hyuA_predicted,0.75,5,3,AGCTGTAGGGAGTTGTCACC,2,1869337
hyuA_predicted,0.5,4,3,AGCTCTCCTCCCTCTGACTA,1,1840785
hyuA_predicted,0.75,5,3,AGCGGGGACTCTCCGTCATT,2,1834745
hyuA_predicted,1.25,7,3,AGCATCGGACACGCATCTGT,4,1831381
hyuA_predicted,3.0,14,3,AGATTAATGCCGGGGCATTA,11,1871461
hyuA_predicted,0.75,5,3,AGATGTAATCCATTAGAGCC,2,1833680
hyuA_predicted,2.25,11,3,ACTTGAGGGTATCCGGAGAT,8,1871161
hyuA_predicted,1.0,6,3,ACTGATACATGTCATCAATC,3,1834378
hyuA_predicted,3.0,14,3,ACTGACGGTTCTCAATGTCG,11,1836885
hyuA_predicted,1.0,6,3,ACTAATCTGAGCCATTGTAC,3,1844505
hyuA_predicted,1.0,6,3,ACTAATAAGATAAGCCCGTT,3,1837311
hyuA_predicted,3.0,14,3,ACGTTCTAAGGGCAGCAGCA,11,1860978
hyuA_predicted,8.25,35,3,ACGTTCCTTAACTATGGCAC,32,1870314
hyuA_predicted,4.25,19,3,ACGTGGATAATCTCCTCATA,16,1861223
hyuA_predicted,0.75,5,3,ACGTCGCAATTGTATGAATT,2,1873113
hyuA_predicted,0.5,4,3,ACGGCGGTATAAGGACGTGC,1,1841614
hyuA_predicted,0.5,4,3,ACGGCCCTACGGCGCAATCC,1,1860938
hyuA_predicted,1.0,6,3,ACGCTGTTATGTCTGGAATA,3,1839159
hyuA_predicted,2.5,12,3,ACGCCTTTACGTTGCCCGTT,9,1874974
hyuA_predicted,3.25,15,3,ACGCCTCACTGATGTAGTGA,12,1840261
hyuA_predicted,2.25,11,3,ACGCAGCCAAGGCACGGCGA,8,1837531
hyuA_predicted,2.5,12,3,ACGATAATTACGCTCTAATC,9,1873704
hyuA_predicted,7.0,30,3,ACGAAGCCAGATACGGAGAA,27,1862762
hyuA_predicted,0.5,4,3,ACCTTGGTGCCCCCCTCAAG,1,1851366
hyuA_predicted,0.5,4,3,ACCTCTAATGCAGGGGCCAC,1,1846977
hyuA_predicted,2.75,13,3,ACCTCCCGCCGGAATTCCTC,10,1847908
hyuA_predicted,2.0,10,3,ACCTATGTAGCGAGGGAAAT,7,1868189
hyuA_predicted,3.25,15,3,ACCTAACTGGCCCAGGTACG,12,1853859
hyuA_predicted,0.75,5,3,ACCGCCTTAAGCCAGATGGT,2,1859883
hyuA_predicted,6.0,26,3,ACCGAACAATAGAGATTGGA,23,1846872
hyuA_predicted,0.5,4,3,ACCCCGTCAGATCACAGTAT,1,1830270
hyuA_predicted,0.5,4,3,ACCACCTTCGCGTATGGTAA,1,1862882
hyuA_predicted,3.25,15,3,ACCAAACTTTACCCCCAGCA,12,1844686
hyuA_predicted,4.5,20,3,ACATGAAGACCGCGTACAAC,17,1863711
hyuA_predicted,4.5,20,3,ACATCTCCAAGTCGCGAGAA,17,1868937
hyuA_predicted,1.5,8,3,ACATCACGAAATTTTAGTCT,5,1869998
hyuA_predicted,0.5,4,3,ACAGTAACGGTGGGAGTTTA,1,1855506
hyuA_predicted,4.0,18,3,ACAGGGAATCCGCCCATAGA,15,1859247
hyuA_predicted,3.75,17,3,ACACACTGTTTCTTTTATAT,14,1831050
hyuA_predicted,0.75,5,3,ACACAATGGGAAGGCCGTGA,2,1871657
hyuA_predicted,2.0,10,3,ACAATTACTAGCTTAACCAC,7,1834518
hyuA_predicted,0.75,5,3,ACAATCACGAGTACCTGTCT,2,1851082
hyuA_predicted,0.75,5,3,ACAATACGGGGGCTCGAGGG,2,1845979
hyuA_predicted,2.0,10,3,ACAACTCGACGGATCGTTAT,7,1857916
hyuA_predicted,3.5,16,3,AATGCGGGAGTCCTTCCTCC,13,1858216
hyuA_predicted,2.75,13,3,AATATCACAACTACAATGAC,10,1840970
hyuA_predicted,2.0,10,3,AATATAAGTGTCGTTGACTT,7,1851417
hyuA_predicted,0.75,5,3,AATAAACGAAGGAGCTGGGT,2,1868475
hyuA_predicted,3.5,16,3,AAGTAGAAACCGTCGCTGTC,13,1852198
hyuA_predicted,1.5,8,3,AAGTACAAGATCGGATATAG,5,1877485
hyuA_predicted,6.0,26,3,AAGGCGCATAGAATAAACGC,23,1869011
hyuA_predicted,1.0,6,3,AAGCAATCTACTCTCTGGGA,3,1869422
hyuA_predicted,6.5,28,3,AACGCTGTGTAGCGGGTTCT,25,1865026
hyuA_predicted,3.75,17,3,AACGATTGGTGGTCGAGTTT,14,1839629
hyuA_predicted,4.5,20,3,AACGACTTTCTCCTATTCTT,17,1877621
hyuA_predicted,0.5,4,3,AACCGATACGTTAACAGGGG,1,1873853
hyuA_predicted,2.5,12,3,AACAGACGGGGGGTAAACTC,9,1867267
hyuA_predicted,1.0,6,3,AAATCTAACAAGCGAGACCA,3,1837570
hyuA_predicted,0.5,4,3,AAAGGCGAACTAGACACACA,1,1836930
hyuA_predicted,0.75,5,3,AAAGCGGACGTGAATTCTTC,2,1832118
hyuA_predicted,3.5,16,3,AAACTCAAGGCGCAATGCTA,13,1860989
hyuA_predicted,2.5,12,3,AAACTAGACGACGAATGTCA,9,1830811
hyuA_predicted,6.5,28,3,AAAATCGCTACGGGACGAGC,25,1872141
hyuA_predicted,5.5,24,3,AAAAGAATCGCCCTCGACAC,21,1869782
hyuA_predicted,5.333333333333333,17,2,TTTTTTCAATTCGTCCTGTT,15,1855387
hyuA_predicted,1.3333333333333333,5,2,TTTTGGCCGCTGGTCATCAA,3,1864624
hyuA_predicted,6.333333333333333,20,2,TTTCTGCGGTACGTGGGGCT,18,1861248
hyuA_predicted,4.333333333333333,14,2,TTTACGGGAAACATGAGTTC,12,1873640
hyuA_predicted,8.0,25,2,TTGTTTCAGCCGGTGTCTAC,23,1856598
hyuA_predicted,12.333333333333334,38,2,TTGTGAGGTAAAGGGAATTT,36,1850755
hyuA_predicted,1.6666666666666667,6,2,TTGGGTGGTCAACGGATGAC,4,1860713
hyuA_predicted,5.666666666666667,18,2,TTGGATGACATTTCGATCGT,16,1834989
hyuA_predicted,2.3333333333333335,8,2,TTGCTAATCGGGACTCAATC,6,1854273
hyuA_predicted,4.333333333333333,14,2,TTGCCGTCAAACCGTGGCTT,12,1830727
hyuA_predicted,1.0,4,2,TTCTGTTCGGAAATGGGGTA,2,1843086
hyuA_predicted,4.666666666666667,15,2,TTCGGTCATTTTGTGTTCTC,13,1845099
hyuA_predicted,0.6666666666666666,3,2,TTCGATTCGAGACGGCTTTC,1,1843311
hyuA_predicted,1.3333333333333333,5,2,TTCCAAGAGAATGACCACTA,3,1863041
hyuA_predicted,1.6666666666666667,6,2,TTAGCCTCGTGAAAACGCAA,4,1841429
hyuA_predicted,5.0,16,2,TTACGACTTGGTCACAGAGG,14,1875827
hyuA_predicted,4.0,13,2,TTAATACGAGACGTCAGAGG,11,1867565
hyuA_predicted,6.333333333333333,20,2,TTAAGCCAGCGGTAAAATGA,18,1866530
hyuA_predicted,6.333333333333333,20,2,TGTTGCGCAGAGCAGCAGAA,18,1852976
hyuA_predicted,1.6666666666666667,6,2,TGTCGTAGACGAGGGATATT,4,1853321
hyuA_predicted,6.333333333333333,20,2,TGTCCCGATAGATGCAGTGG,18,1842627
hyuA_predicted,1.6666666666666667,6,2,TGTAATGGAGCAAAATGTCG,4,1832414
hyuA_predicted,5.0,16,2,TGGTTGACGATGAGCCGTGT,14,1874158
hyuA_predicted,3.0,10,2,TGGTGGCTCTGGTCGATTAC,8,1834998
hyuA_predicted,1.3333333333333333,5,2,TGGGGACCACGGTTAGAAGA,3,1830737
hyuA_predicted,3.6666666666666665,12,2,TGGGCATTGTGAGAGGTATT,10,1856612
hyuA_predicted,1.0,4,2,TGGCCCGTAGTTATGCTTGC,2,1832907
hyuA_predicted,4.333333333333333,14,2,TGGCAAATCTGCTAGTGGGG,12,1864540
hyuA_predicted,5.666666666666667,18,2,TGGCAAAGTCTCCATGAATA,16,1874054
hyuA_predicted,3.0,10,2,TGCTTATACGATGGCGTTCA,8,1858102
hyuA_predicted,0.6666666666666666,3,2,TGCGGTACCAATTATACGTC,1,1836336
hyuA_predicted,6.666666666666667,21,2,TGCGGGTTCTTTGATAAGGA,19,1838950
hyuA_predicted,2.6666666666666665,9,2,TGCGCCTTTATCATATCAGA,7,1851306
hyuA_predicted,0.6666666666666666,3,2,TGCCCCTCAGGCGAACTGGA,1,1857624
hyuA_predicted,2.0,7,2,TGCCAGCCATAGGGTGCCCG,5,1833545
hyuA_predicted,1.6666666666666667,6,2,TGCAAACTTCGTCAACACGC,4,1833361
hyuA_predicted,4.333333333333333,14,2,TGACCTTCTGCACGCACTGA,12,1854321
hyuA_predicted,0.6666666666666666,3,2,TCTTACAGCTATTACCCGAA,1,1853220
hyuA_predicted,1.0,4,2,TCTGTGTTGGTCTTTATAGA,2,1869948
hyuA_predicted,3.3333333333333335,11,2,TCTGTCAGCTTTTTGTGAAA,9,1844293
hyuA_predicted,5.333333333333333,17,2,TCGTGGAGCTTCATGTGAGA,15,1849319
hyuA_predicted,8.666666666666666,27,2,TCGTGACTACGACACCGTTT,25,1866046
hyuA_predicted,7.666666666666667,24,2,TCGGACCCTCGTCGGCGTCC,22,1837186
hyuA_predicted,7.0,22,2,TCGCAGCTGTCCGGATTGGA,20,1856491
hyuA_predicted,1.6666666666666667,6,2,TCGAGTCTGTTCACGACCTG,4,1835706
hyuA_predicted,0.6666666666666666,3,2,TCGACTGTGGGATAAGCTAG,1,1835318
hyuA_predicted,3.0,10,2,TCGACGTGATCCTCCAGGAA,8,1872808
hyuA_predicted,4.0,13,2,TCCGGTAAATATAACGCTTG,11,1872263
hyuA_predicted,5.666666666666667,18,2,TCCATTATGCGCCAAAGTAT,16,1862573
hyuA_predicted,2.6666666666666665,9,2,TCCATGATAGCAACATTGCT,7,1829898
hyuA_predicted,3.6666666666666665,12,2,TCCACTTGTTTGTTCTCTGA,10,1855898
hyuA_predicted,6.666666666666667,21,2,TCATGAATGTCGATAACGAT,19,1833797
hyuA_predicted,4.666666666666667,15,2,TCATAGTGAAAGGTTGCGTC,13,1839932
hyuA_predicted,5.333333333333333,17,2,TCAGTGGCTAGCCGATGTTT,15,1861699
hyuA_predicted,0.6666666666666666,3,2,TATTTTGAATCACCGCAAGG,1,1854328
hyuA_predicted,12.0,37,2,TATTTCCTTCGTATCCGGAA,35,1870125
hyuA_predicted,6.0,19,2,TATGCCCGGACGTCCCACAA,17,1863178
hyuA_predicted,1.0,4,2,TATCTTTAACTGGGGCGTTG,2,1861009
hyuA_predicted,0.6666666666666666,3,2,TATATAGTTGCAGTGGGGTA,1,1850095
hyuA_predicted,5.0,16,2,TATAGGTCCGGGACACCTGT,14,1853858
hyuA_predicted,3.3333333333333335,11,2,TAGTAGAAGGCGAGTCTTTA,9,1849559
hyuA_predicted,5.0,16,2,TAGATGTGCTCTTGTACCTG,14,1833448
hyuA_predicted,3.0,10,2,TACGGATTAGAACCAAGGAG,8,1863997
hyuA_predicted,1.3333333333333333,5,2,TACCCCCTCCGACGTTAGTG,3,1853874
hyuA_predicted,2.3333333333333335,8,2,TACCCAAATCGGCCCCTTAA,6,1846337
hyuA_predicted,9.666666666666666,30,2,TACCAACACTGGTGAGGGAA,28,1859988
hyuA_predicted,3.0,10,2,TAAAGAGGTGCTTCAATCCA,8,1838041
hyuA_predicted,2.6666666666666665,9,2,GTTTGAGCTGAAGCACCATA,7,1835811
hyuA_predicted,1.6666666666666667,6,2,GTTTGACTGGTGGCCATTGC,4,1831165
hyuA_predicted,1.0,4,2,GTTACTTACCCCGCTTCATT,2,1853533
hyuA_predicted,5.333333333333333,17,2,GTTACCGGTGGGCCTATGAC,15,1845363
hyuA_predicted,7.0,22,2,GTTAAAAATGAGTAAGGGTT,20,1858757
hyuA_predicted,1.0,4,2,GTGTCCGCGACACCCGCGGT,2,1865265
hyuA_predicted,11.333333333333334,35,2,GTGGCTGAAGGACGTCTGAA,33,1831855
hyuA_predicted,4.666666666666667,15,2,GTGGCCGGGGCGTTGGCGAA,13,1863828
hyuA_predicted,1.6666666666666667,6,2,GTGCCCTAAAGTCACTATCG,4,1833349
hyuA_predicted,3.0,10,2,GTGAGGTTATATGCGATGCC,8,1853873
hyuA_predicted,0.6666666666666666,3,2,GTCTGGCGTCATTTGATGAC,1,1852354
hyuA_predicted,2.3333333333333335,8,2,GTCTATACAAGTACCGGGTC,6,1858325
hyuA_predicted,1.6666666666666667,6,2,GTCCTCGTCCGAACGAGGAT,4,1874768
hyuA_predicted,2.6666666666666665,9,2,GTCCTAAACTCAAACAAGTA,7,1863431
hyuA_predicted,13.333333333333334,41,2,GTCACTGGGACTTGGTGCAA,39,1862042
hyuA_predicted,4.0,13,2,GTAGTTATTTTACAATGCCC,11,1864198
hyuA_predicted,1.6666666666666667,6,2,GTAGCAAGCGGGCGTTATTG,4,1871115
hyuA_predicted,6.333333333333333,20,2,GTAACTTTTTTTCACGGCCT,18,1831415
hyuA_predicted,0.6666666666666666,3,2,GTAACGTTCCACATCGTATC,1,1839284
hyuA_predicted,3.3333333333333335,11,2,GGTGGATGAAGCTATGGGTA,9,1837996
hyuA_predicted,3.3333333333333335,11,2,GGTGCTGGAGTCCCGATTTC,9,1853579
hyuA_predicted,2.6666666666666665,9,2,GGTAGATGGGCGGTGTAACT,7,1867080
hyuA_predicted,11.666666666666666,36,2,GGGTATACTTGTCAAGTTGA,34,1837188
hyuA_predicted,9.0,28,2,GGGGGGAGGAGGAGGTCACT,26,1839407
hyuA_predicted,11.333333333333334,35,2,GGGGGCGTCGGGTCTGCGCA,33,1837210
hyuA_predicted,5.666666666666667,18,2,GGGCTGAGAGTCCCGCAAGC,16,1867225
hyuA_predicted,11.666666666666666,36,2,GGCTTACACTCATCCAATTT,34,1859230
hyuA_predicted,4.0,13,2,GGCGGCAAGCGTCGGGTCTT,11,1841358
hyuA_predicted,7.0,22,2,GGCGCTACGTATCGTGCGCT,20,1848444
hyuA_predicted,0.6666666666666666,3,2,GGCCGATTGAGAGGGGCCTA,1,1852928
hyuA_predicted,10.666666666666666,33,2,GGCCCAGCTAGTCCCCATAA,31,1833570
hyuA_predicted,0.6666666666666666,3,2,GGCCCAACTATTCTGCGACT,1,1850167
hyuA_predicted,1.0,4,2,GGCAGTGAAGGTGTTTTACT,2,1856125
hyuA_predicted,1.0,4,2,GGATGTTGGAACGCAAGTAT,2,1853751
hyuA_predicted,7.333333333333333,23,2,GGATGCCAGGGGAATACTTT,21,1865706
hyuA_predicted,0.6666666666666666,3,2,GGAGCCCGCTTATCTACGGC,1,1829921
hyuA_predicted,0.6666666666666666,3,2,GGAAATTCGGGTAGGTCTTC,1,1829960
hyuA_predicted,8.666666666666666,27,2,GCTTCAGCTCGCTTCTCCCC,25,1855060
hyuA_predicted,3.0,10,2,GCTGTGCCTTGTGGTAAGTA,8,1872463
hyuA_predicted,4.666666666666667,15,2,GCTCCGGTAGGGGCTCGCGA,13,1846526
hyuA_predicted,1.0,4,2,GCTATCCCGTCTGGATGTCG,2,1863703
hyuA_predicted,8.0,25,2,GCTACTGGGATAGGAAACTG,23,1849266
hyuA_predicted,0.6666666666666666,3,2,GCTAAGACGTGCAGCAAAAC,1,1854277
hyuA_predicted,4.0,13,2,GCGTTCGCCAAAATGCGGAA,11,1852050
hyuA_predicted,7.0,22,2,GCGTTATGCCAGTCCACTTT,20,1862727
hyuA_predicted,0.6666666666666666,3,2,GCGGTCTGACCATAATATGC,1,1840000
hyuA_predicted,4.333333333333333,14,2,GCGCTCAATGTGGCAGCCCA,12,1866328
hyuA_predicted,3.6666666666666665,12,2,GCGCACTCCTGGATGTGACA,10,1833048
hyuA_predicted,2.3333333333333335,8,2,GCGAGCTATATAGAGGATCA,6,1850808
hyuA_predicted,19.333333333333332,59,2,GCGAGAGTCCCGTTGCTGTA,57,1850682
hyuA_predicted,13.333333333333334,41,2,GCCTCGGCGGCCCCCAGATG,39,1839886
hyuA_predicted,0.6666666666666666,3,2,GCCGCGTCTAATTATGCCGA,1,1856543
hyuA_predicted,1.3333333333333333,5,2,GCCCTGTTACTACCGTCTCC,3,1834560
hyuA_predicted,2.6666666666666665,9,2,GCATTCCGCGTGGGCGGGGT,7,1853441
hyuA_predicted,2.6666666666666665,9,2,GCATGGTGATGCTGCACAGC,7,1832220
hyuA_predicted,2.6666666666666665,9,2,GCATATCATCGGATCCGGGT,7,1856895
hyuA_predicted,0.6666666666666666,3,2,GCAGCACGGGTTCTTTTCTT,1,1874104
hyuA_predicted,3.3333333333333335,11,2,GCAGATTGGAGAAATCGTGC,9,1869751
hyuA_predicted,0.6666666666666666,3,2,GCACGGGGGACTACTAGACG,1,1832485
hyuA_predicted,6.333333333333333,20,2,GCAACGGTTTTTACGGAGCG,18,1877262
hyuA_predicted,0.6666666666666666,3,2,GATTCAATAAGAAAACAAAC,1,1847030
hyuA_predicted,0.6666666666666666,3,2,GATGTGTCTGTGAGGGGGAG,1,1842865
hyuA_predicted,9.0,28,2,GATATCGTGTGATGTGCCAC,26,1859276
hyuA_predicted,3.3333333333333335,11,2,GAGTTGCCTGGCTAGACGTC,9,1866437
hyuA_predicted,10.333333333333334,32,2,GACTGGACTGTTAAGGGTGC,30,1863422
hyuA_predicted,2.0,7,2,GACTGATGACTTACATGGAT,5,1865465
hyuA_predicted,1.0,4,2,GACTATGTAAGACCGATTTC,2,1849084
hyuA_predicted,0.6666666666666666,3,2,GACCACCCCTCTGGACCCTA,1,1857109
hyuA_predicted,2.6666666666666665,9,2,GACATCGATAAAGAACACAA,7,1850729
hyuA_predicted,5.666666666666667,18,2,GACATAAACTTGATCTACCT,16,1837309
hyuA_predicted,0.6666666666666666,3,2,GAATTAGCGGTGGGAAACCG,1,1853135
hyuA_predicted,4.0,13,2,GAATGTTACATTGTCCTGAG,11,1872319
hyuA_predicted,5.333333333333333,17,2,GAACCTCACGGCTAGGTATG,15,1860143
hyuA_predicted,2.6666666666666665,9,2,GAACACCCCCTGCGACACCC,7,1871429
hyuA_predicted,0.6666666666666666,3,2,GAAATGCCTCGGCACACCTG,1,1830992
hyuA_predicted,0.6666666666666666,3,2,CTTTCTCTCGAGCTCCAGTG,1,1846806
hyuA_predicted,3.0,10,2,CTTTCCGTGTAGCGTCTGGA,8,1839503
hyuA_predicted,2.0,7,2,CTTGATCACAGAAGCTCTGA,5,1871699
hyuA_predicted,1.0,4,2,CTTGACTCACTATTATGACT,2,1840774
hyuA_predicted,4.666666666666667,15,2,CTTCTCGCTATCGGTTTCAG,13,1832293
hyuA_predicted,5.0,16,2,CTTAGCGTGATAGCCCAATT,14,1851502
hyuA_predicted,9.666666666666666,30,2,CTGACTCTTGTTGTAGTGAC,28,1869523
hyuA_predicted,3.6666666666666665,12,2,CTGACGTGTGACAGGTCCAT,10,1846356
hyuA_predicted,1.3333333333333333,5,2,CTGAAAGCAGTCATTGCAAG,3,1839750
hyuA_predicted,2.6666666666666665,9,2,CTCGTTGATCGTTACTAAGG,7,1856510
hyuA_predicted,1.0,4,2,CTCCGGCGGGAGATCGACCG,2,1853503
hyuA_predicted,2.6666666666666665,9,2,CTCCGGAAGCGGCAAGGCTT,7,1875122
hyuA_predicted,3.3333333333333335,11,2,CTCCGATGTGTTCGGTAACC,9,1869343
hyuA_predicted,0.6666666666666666,3,2,CTATCTGAACGTCTGGGATA,1,1845697
hyuA_predicted,7.0,22,2,CTATCATGGAACGGGAACGC,20,1850453
hyuA_predicted,1.3333333333333333,5,2,CTAGCCAACATATACACAGT,3,1847003
hyuA_predicted,1.3333333333333333,5,2,CTACTTTCTGTTACAAGGAA,3,1861205
hyuA_predicted,1.0,4,2,CTACCGACTGCCCATTGACG,2,1842418
hyuA_predicted,1.6666666666666667,6,2,CTAAGCTCATTCTTAAGATC,4,1858038
hyuA_predicted,1.3333333333333333,5,2,CTAACCAAGGAGCGCGATGG,3,1849899
hyuA_predicted,4.0,13,2,CGTGGTGCTTTGGTTGTTCC,11,1855746
hyuA_predicted,5.333333333333333,17,2,CGGTCGTCGTTAAGTGGATG,15,1861760
hyuA_predicted,3.3333333333333335,11,2,CGGTAGACGGCAATAATAGA,9,1829821
hyuA_predicted,8.666666666666666,27,2,CGGGTGTGTCGAATAATAGC,25,1861637
hyuA_predicted,0.6666666666666666,3,2,CGGGTCCTAAAAGTGCGGCA,1,1856264
hyuA_predicted,2.0,7,2,CGGGTCATATTACGACTGCC,5,1876403
hyuA_predicted,3.3333333333333335,11,2,CGGCTTTGAAGGAGAAACTT,9,1840843
hyuA_predicted,6.333333333333333,20,2,CGGCAAAGAGTTATGGGTTA,18,1866715
hyuA_predicted,0.6666666666666666,3,2,CGGATATGATGCACTGACAG,1,1844529
hyuA_predicted,0.6666666666666666,3,2,CGGACCACATAAGCGCTTCG,1,1847418
hyuA_predicted,4.0,13,2,CGGACACAACATAGAACGTT,11,1860667
hyuA_predicted,4.666666666666667,15,2,CGGAATTTCCGCGGGCGTTG,13,1852768
hyuA_predicted,1.0,4,2,CGGAAGCGCGCAGCCCATCA,2,1873679
hyuA_predicted,1.3333333333333333,5,2,CGCGTCATATAACATGCGCC,3,1872107
hyuA_predicted,3.3333333333333335,11,2,CGCGGACCGTAGCGGTGATG,9,1853930
hyuA_predicted,9.333333333333334,29,2,CGCCTCTATGAAGTGCTGCT,27,1870607
hyuA_predicted,3.0,10,2,CGCCGGCATTCTCCCAGACT,8,1860835
hyuA_predicted,5.666666666666667,18,2,CGCATGGGGTGCTACACAAC,16,1869307
hyuA_predicted,4.0,13,2,CGCAATCCATGTGAATTTAA,11,1833675
hyuA_predicted,1.0,4,2,CGATTGTTTGCGTGCGGGCT,2,1865689
hyuA_predicted,2.0,7,2,CGATGTAATCAGTAGGGCCA,5,1873554
hyuA_predicted,5.333333333333333,17,2,CGATATTTGCTAGTATACTA,15,1832792
hyuA_predicted,0.6666666666666666,3,2,CGACTTGCGGTGCCACTGAG,1,1872952
hyuA_predicted,1.6666666666666667,6,2,CGACTATGTCAACCGTTCGG,4,1835530
hyuA_predicted,0.6666666666666666,3,2,CGACATTGGACATTATTGCT,1,1858581
hyuA_predicted,6.666666666666667,21,2,CGAAACGTAAGAGGTTGTCT,19,1839070
hyuA_predicted,3.0,10,2,CCTGCAGATGGGTAAGCTTT,8,1854991
hyuA_predicted,4.333333333333333,14,2,CCTCGCCGCGCTGGCTGGGT,12,1871681
hyuA_predicted,2.3333333333333335,8,2,CCTATCCAGACCATACCTCA,6,1877195
hyuA_predicted,3.3333333333333335,11,2,CCGTTGGTTTGCGACATTAT,9,1833171
hyuA_predicted,4.0,13,2,CCGTCAGTTTCTGGCATTGC,11,1848568
hyuA_predicted,4.0,13,2,CCGGCCTCACCGCATCTATC,11,1834480
hyuA_predicted,2.0,7,2,CCGCTCGGTTTTGCCCTCAC,5,1870001
hyuA_predicted,1.3333333333333333,5,2,CCGCAATCCCCGAGTGGAGA,3,1875299
hyuA_predicted,0.6666666666666666,3,2,CCCTTGGTTAGTCTCCACCA,1,1855362
hyuA_predicted,0.6666666666666666,3,2,CCCTGATCCCTCAGTTTTGA,1,1831962
hyuA_predicted,10.0,31,2,CCCCGTAACCGTCGCGTCAA,29,1867866
hyuA_predicted,1.3333333333333333,5,2,CCCCGCAGACGCAAATGTGT,3,1855049
hyuA_predicted,5.333333333333333,17,2,CCCACAAGTTGCCCACTCGG,15,1833010
hyuA_predicted,3.6666666666666665,12,2,CCATTTCTGGAGGTACGACT,10,1852320
hyuA_predicted,8.333333333333334,26,2,CCAGTTAACTACCGTTAAAA,24,1849562
hyuA_predicted,13.666666666666666,42,2,CCACGTTGTGGCGTTGTTTT,40,1855652
hyuA_predicted,2.6666666666666665,9,2,CCAAGATTCAATTCCAGACC,7,1877770
hyuA_predicted,0.6666666666666666,3,2,CCAAGAGATGTGATAGTACT,1,1842575
hyuA_predicted,4.333333333333333,14,2,CATTGTTCCTCAGGCATGAT,12,1858051
hyuA_predicted,0.6666666666666666,3,2,CATGATGCGTTTGCAAGAGA,1,1846999
hyuA_predicted,6.0,19,2,CATAATACTCGAATCTGCCG,17,1857299
hyuA_predicted,0.6666666666666666,3,2,CATAAAACAGCCTGTATCTG,1,1852532
hyuA_predicted,5.0,16,2,CAGTCGTTCTTAGGGCCGTG,14,1852972
hyuA_predicted,0.6666666666666666,3,2,CAGGATCCCGGTTCTCCGGA,1,1854499
hyuA_predicted,1.6666666666666667,6,2,CAGGAAGTATAGGGGCTGGG,4,1834964
hyuA_predicted,8.0,25,2,CAGCTACTGCCCGCATCTTA,23,1863575
hyuA_predicted,6.666666666666667,21,2,CACTAAGTGTTGATAGAGTG,19,1848179
hyuA_predicted,2.0,7,2,CACGTCCATGCATTTCAGGG,5,1835183
hyuA_predicted,6.666666666666667,21,2,CACGGCCCCTGCCGTCGGTG,19,1833155
hyuA_predicted,0.6666666666666666,3,2,CACGGAAGAGGTCTCGCGGT,1,1856441
hyuA_predicted,3.3333333333333335,11,2,CACGCAGTTTCCACCACCTG,9,1845836
hyuA_predicted,1.6666666666666667,6,2,CACCGCGACCGGTTGTTGAA,4,1861049
hyuA_predicted,2.6666666666666665,9,2,CAAGCTCAGCGCTCTTCTTC,7,1868118
hyuA_predicted,0.6666666666666666,3,2,CAAGAAGCACTTTTATATAG,1,1849571
hyuA_predicted,6.666666666666667,21,2,CAAATCCGTTGTAAGTCGTC,19,1869019
hyuA_predicted,2.0,7,2,ATTTTGGTTTACCGAATTTC,5,1845115
hyuA_predicted,6.333333333333333,20,2,ATTTCCGATAAGCACGAGAG,18,1841355
hyuA_predicted,2.3333333333333335,8,2,ATTACCTGGGGTGGAGTTCC,6,1834150
hyuA_predicted,1.6666666666666667,6,2,ATGTCCCTTACTGCGGTTGT,4,1856312
hyuA_predicted,3.3333333333333335,11,2,ATGTCCATGCCAAACCCCGT,9,1862145
hyuA_predicted,0.6666666666666666,3,2,ATGGCGTTGCTCTGTTTTTT,1,1862155
hyuA_predicted,6.333333333333333,20,2,ATGCCCCGGGTCGCGCACTT,18,1833360
hyuA_predicted,8.666666666666666,27,2,ATGACGTCTGCCGGGCGAAC,25,1855459
hyuA_predicted,0.6666666666666666,3,2,ATGAAGCGTCCCTCAACATT,1,1852636
hyuA_predicted,5.333333333333333,17,2,ATCTCGCCGAACAGGCAGCT,15,1848828
hyuA_predicted,11.0,34,2,ATCGTGCGATGAATCTGTGT,32,1868911
hyuA_predicted,1.6666666666666667,6,2,ATCGGGTGAGTCCAGTGAGC,4,1856066
hyuA_predicted,1.6666666666666667,6,2,ATCCCTGAATCGCTAGGTTC,4,1843676
hyuA_predicted,4.666666666666667,15,2,ATATACATTGTTCACCATTT,13,1859636
hyuA_predicted,0.6666666666666666,3,2,ATAGGCTGCGCGATTAGACG,1,1831507
hyuA_predicted,2.6666666666666665,9,2,ATACGTACAATTTGGTCGGC,7,1846896
hyuA_predicted,1.3333333333333333,5,2,ATACCGTTGACGGATAAGTA,3,1843918
hyuA_predicted,1.6666666666666667,6,2,ATACCGGGTATGTCCACCTA,4,1858545
hyuA_predicted,3.6666666666666665,12,2,AGTTTATACTACTGCCTAAC,10,1866813
hyuA_predicted,4.666666666666667,15,2,AGTTGCCTGCCGGTCCCACA,13,1850838
hyuA_predicted,0.6666666666666666,3,2,AGTATTAAAGGTATAGTTAC,1,1853828
hyuA_predicted,0.6666666666666666,3,2,AGGGCTGCCTTTCAACCGAT,1,1833574
hyuA_predicted,3.3333333333333335,11,2,AGGGCTGAGTCTCCGTATGC,9,1857465
hyuA_predicted,4.0,13,2,AGGCCTACGGATGGTATAGG,11,1858267
hyuA_predicted,4.0,13,2,AGGACATAGCGCTCGCACGG,11,1874565
hyuA_predicted,6.333333333333333,20,2,AGGAAGGGGTGCCGGCTTTT,18,1835534
hyuA_predicted,9.333333333333334,29,2,AGCTAGCGGTCGAGTTGGGG,27,1847725
hyuA_predicted,1.3333333333333333,5,2,AGCGCATGCCCTGAAATGTC,3,1861164
hyuA_predicted,1.0,4,2,AGCCCGCCGTTTATTTCTAA,2,1832823
hyuA_predicted,1.6666666666666667,6,2,AGCATCTGATACCGTGCGAA,4,1836342
hyuA_predicted,0.6666666666666666,3,2,AGCATAAGTTCCCCCTTCTC,1,1851052
hyuA_predicted,1.6666666666666667,6,2,AGCAGCGCAGGGACATGGAA,4,1840053
hyuA_predicted,1.0,4,2,AGAGGGAGGCATCAATAACG,2,1869141
hyuA_predicted,1.3333333333333333,5,2,AGAGATTAGTCCCTGGGGCA,3,1874583
hyuA_predicted,4.0,13,2,AGACCATTCTGTGGCGTTTT,11,1840395
hyuA_predicted,0.6666666666666666,3,2,AGACATCGCACAGTGGGTGT,1,1845397
hyuA_predicted,4.333333333333333,14,2,AGACACTCTGGGAACATAAC,12,1867774
hyuA_predicted,12.666666666666666,39,2,AGAAGCCTCGATTTATACTC,37,1848825
hyuA_predicted,1.6666666666666667,6,2,ACTCTCCTGTGAGGCCTCCA,4,1865111
hyuA_predicted,12.333333333333334,38,2,ACTCATGTGATGCTTTTTGT,36,1836178
hyuA_predicted,3.3333333333333335,11,2,ACTACTGCAGAAGAGTTGGA,9,1855892
hyuA_predicted,0.6666666666666666,3,2,ACGTCTTTCTTTTCATCTGA,1,1861519
hyuA_predicted,0.6666666666666666,3,2,ACGGGTAGTGCGGTGAGAAC,1,1859911
hyuA_predicted,15.333333333333334,47,2,ACGCGGTGTGAAGATTCCGG,45,1832341
hyuA_predicted,1.3333333333333333,5,2,ACCTAATGCCTGAGATGCAA,3,1870457
hyuA_predicted,7.666666666666667,24,2,ACCGGTGCGCGGTTCAATGT,22,1839738
hyuA_predicted,3.3333333333333335,11,2,ACATAATCTGTCAAGGTCAT,9,1874665
hyuA_predicted,1.3333333333333333,5,2,ACAGTGTCAGGGCGACGGAA,3,1860167
hyuA_predicted,1.6666666666666667,6,2,ACAGCATCGGTGGTGTCCGG,4,1862914
hyuA_predicted,2.0,7,2,ACACGAATTGACCTCTTGCA,5,1852684
hyuA_predicted,4.0,13,2,ACAATTGTGGGCGAATATCT,11,1832207
hyuA_predicted,3.0,10,2,AATCTCCCGCGGGGGGAATG,8,1876375
hyuA_predicted,0.6666666666666666,3,2,AAGTTTGATTAGTCGTGAAA,1,1872847
hyuA_predicted,0.6666666666666666,3,2,AAGTTAGGACGGACAAGTAG,1,1866797
hyuA_predicted,0.6666666666666666,3,2,AAGTACCTCCGTGGGCCGCA,1,1873677
hyuA_predicted,4.0,13,2,AAGAGTGATGGTGTTAGGTG,11,1867079
hyuA_predicted,2.0,7,2,AAGACCTACATGTGGCCCGC,5,1864227
hyuA_predicted,1.0,4,2,AACTGTCGGTAATAGCGTGT,2,1861290
hyuA_predicted,4.0,13,2,AACTACTTTTATTACCTGAT,11,1871537
hyuA_predicted,12.666666666666666,39,2,AACCTAATGTAGGGTCGGAC,37,1873465
hyuA_predicted,4.666666666666667,15,2,AACCGCGGGTGTGGGCAAAA,13,1847644
hyuA_predicted,2.3333333333333335,8,2,AAATGATAAACTTTGCCGTA,6,1851231
hyuA_predicted,4.333333333333333,14,2,AAAGCACGCTTCTCGTACGA,12,1876728
hyuA_predicted,11.0,34,2,AAACGCGAGGATACAAATTC,32,1857284
hyuA_predicted,1.0,4,2,AAAATCCGGGTGTCTTTATC,2,1877434
hyuA_predicted,5.333333333333333,17,2,AAAAAACAAATTGCTAATAT,15,1875376
hyuA_predicted,2.0,4,1,TTTTGTCGTGAGTGGAACAG,3,1849853
hyuA_predicted,15.0,30,1,TTTATCGAGGTCGAAAAAGT,29,1834008
hyuA_predicted,3.5,7,1,TTGTTTACGAAGCGATGGAC,6,1876926
hyuA_predicted,22.5,45,1,TTGTCACCGCTCTGTTGCCT,44,1852870
hyuA_predicted,3.0,6,1,TTGTAGTCCCTACTGCGCCG,5,1839163
hyuA_predicted,1.5,3,1,TTGCCAACCTTTATATGTAG,2,1841734
hyuA_predicted,4.0,8,1,TTGCATCTCATTCATCTTGG,7,1857108
hyuA_predicted,9.0,18,1,TTGATATAGGCCTTTAAAAT,17,1848294
hyuA_predicted,8.0,16,1,TTGAGTTACGGGTACTTAAT,15,1864913
hyuA_predicted,1.0,2,1,TTGAGGGGCGCCCCGCTTCG,1,1855945
hyuA_predicted,18.0,36,1,TTCTCCTCGGCAAAATCCTG,35,1844460
hyuA_predicted,1.0,2,1,TTCGGAAAACCACTAGAGTT,1,1869010
hyuA_predicted,1.0,2,1,TTCCTTTGTCCGACGCTTCT,1,1868229
hyuA_predicted,7.5,15,1,TTCCTTCTGAGTTAAGATTG,14,1862904
hyuA_predicted,7.0,14,1,TTCACCATATGCGAGCACTA,13,1861098
hyuA_predicted,2.5,5,1,TTAGACTCTAAAAACATCGA,4,1870550
hyuA_predicted,1.0,2,1,TTAGACGGCGTGTTTTAAGC,1,1845224
hyuA_predicted,4.5,9,1,TTAAGCCTTCAGCCCACGCT,8,1866024
hyuA_predicted,1.0,2,1,TTAACTTACGATAAGCTCCC,1,1844926
hyuA_predicted,1.0,2,1,TGTTTTGTCTCTCTAACGTT,1,1875822
hyuA_predicted,3.0,6,1,TGTCTGACTTAGTCAACGGT,5,1837687
hyuA_predicted,8.5,17,1,TGTCTCTTCGACAGTAATCC,16,1841421
hyuA_predicted,15.0,30,1,TGTCAGGTGCGCGTCCACCT,29,1842621
hyuA_predicted,1.0,2,1,TGTAGCTTCGGGCGACCAAC,1,1849244
hyuA_predicted,1.5,3,1,TGGTTGGCCAGCTTCTTAAG,2,1853523
hyuA_predicted,11.0,22,1,TGGTTATGGTGCAATGTAGT,21,1854828
hyuA_predicted,7.0,14,1,TGGTGCTGATGTTGTTAGGT,13,1858785
hyuA_predicted,9.5,19,1,TGGGCACTGTACTTGAGGGT,18,1848226
hyuA_predicted,5.5,11,1,TGGCAAACAAAGCGCGCGAA,10,1858980
hyuA_predicted,1.0,2,1,TGGAAAAGTCAGACGAGGGG,1,1872158
hyuA_predicted,4.0,8,1,TGCTGCATGTTCTGTCGGCC,7,1851858
hyuA_predicted,2.0,4,1,TGCGGATCCGATTATCTCGT,3,1864666
hyuA_predicted,14.5,29,1,TGCCTTCAAAATACGGCTGC,28,1854365
hyuA_predicted,4.0,8,1,TGATCGGAATCTCGAGTACG,7,1855498
hyuA_predicted,1.0,2,1,TGAGATGAGCATCAATTGTG,1,1852726
hyuA_predicted,3.5,7,1,TCTGCGAGCGTTTGGGATTG,6,1876311
hyuA_predicted,7.0,14,1,TCTCTGACGTTATCGTGGAG,13,1856720
hyuA_predicted,35.5,71,1,TCTATTACCCCCCAGGTGCA,70,1835462
hyuA_predicted,9.5,19,1,TCGTGAGACAGGGTTCAGTA,18,1856208
hyuA_predicted,5.0,10,1,TCGTCATTGTTATCACCGAC,9,1866528
hyuA_predicted,2.0,4,1,TCGGGTGGGCTTCGTAGTGG,3,1868290
hyuA_predicted,1.0,2,1,TCGGCTATTTTGGCTCAGCT,1,1857956
hyuA_predicted,17.0,34,1,TCGCTCTAGAATCGTCTATT,33,1839160
hyuA_predicted,2.0,4,1,TCGATGCGTCTTAGAAGGGA,3,1860886
hyuA_predicted,5.0,10,1,TCGAGCACCAAGGGCTCCGG,9,1842671
hyuA_predicted,6.5,13,1,TCGAGAAGATATTCAGAAGC,12,1834864
hyuA_predicted,15.5,31,1,TCCGGTCAGGCCGTAATCCG,30,1833462
hyuA_predicted,3.0,6,1,TCCGGGCGGCCTATTCCCGG,5,1870973
hyuA_predicted,2.5,5,1,TCCGCGGCACGATGTTCTCA,4,1849393
hyuA_predicted,4.5,9,1,TCCGCGCGGGGGAGCGGTTC,8,1861825
hyuA_predicted,4.5,9,1,TCATTTATGCCTAACTTGCT,8,1847944
hyuA_predicted,2.0,4,1,TCATTACTGTTACAACAGTT,3,1860358
hyuA_predicted,8.5,17,1,TCATGCGAACCGTCCTTTTG,16,1864629
hyuA_predicted,5.0,10,1,TCATCCTTATCTCTGAACGT,9,1851691
hyuA_predicted,17.5,35,1,TCAGTTTATCTGGTCTCTGG,34,1842529
hyuA_predicted,7.5,15,1,TCAGTACTGGTTCGGTCCGT,14,1836512
hyuA_predicted,17.5,35,1,TCAGCTGTTTCCTTGTAGTT,34,1840088
hyuA_predicted,14.5,29,1,TCAGACGTTGACCGTTGGAA,28,1874953
hyuA_predicted,10.5,21,1,TCAAGGCGCTCCTGTGACAG,20,1855526
hyuA_predicted,7.0,14,1,TCAACCAACACTAAGTAATG,13,1865488
hyuA_predicted,1.5,3,1,TATTTCACCGGGATGGTAAA,2,1846068
hyuA_predicted,1.0,2,1,TATTGGTTAGCTGCAATCTA,1,1857526
hyuA_predicted,6.5,13,1,TATTGGCAGATGTTTTGAGT,12,1862175
hyuA_predicted,12.0,24,1,TATCGGCATGGTGGACACGG,23,1872100
hyuA_predicted,1.5,3,1,TATATCGATTAGCCATAATT,2,1867278
hyuA_predicted,1.0,2,1,TAGGTAAGAAATCCCCTCCA,1,1872454
hyuA_predicted,4.0,8,1,TAGGGCTATGAGTGTCAGGG,7,1860322
hyuA_predicted,3.5,7,1,TAGCGCTTCACAACCTTGTC,6,1862272
hyuA_predicted,5.0,10,1,TAGAATTAACCAGTTCTGTT,9,1867646
hyuA_predicted,7.0,14,1,TACGCCTGCACAGCGCGCAT,13,1863762
hyuA_predicted,1.0,2,1,TACGATACCTATCCCAACCT,1,1870688
hyuA_predicted,4.0,8,1,TACATGATTTTACTACAGCA,7,1853964
hyuA_predicted,4.0,8,1,TAATGTCAAGTGAACTCTGC,7,1839050
hyuA_predicted,1.5,3,1,TAACAGAAAGCCACTTACGA,2,1872450
hyuA_predicted,1.0,2,1,TAACACATCAATTTTACTTC,1,1861354
hyuA_predicted,1.0,2,1,TAAAGGAATCTCTCTAGCGT,1,1856129
hyuA_predicted,1.5,3,1,GTTTATAGCAGCTAAGGATT,2,1843368
hyuA_predicted,6.5,13,1,GTTGTTCTCGATAGCTGCCG,12,1869576
hyuA_predicted,12.0,24,1,GTTGCGTAAAGTGCATACAA,23,1876723
hyuA_predicted,12.0,24,1,GTTCGTCTGGGGATGGCCGT,23,1845086
hyuA_predicted,7.5,15,1,GTTCCACTGAAACATTTCGC,14,1843535
hyuA_predicted,17.0,34,1,GTTCCAAATCACGCATACTC,33,1845261
hyuA_predicted,1.5,3,1,GTTAGCAGATATGATAGTTA,2,1862093
hyuA_predicted,1.0,2,1,GTTACTTCTATGGCTGTCGC,1,1868910
hyuA_predicted,5.0,10,1,GTTACGGTCCCAAAGGGTTT,9,1857399
hyuA_predicted,2.5,5,1,GTGTAATTCTCCTTGTGCAA,4,1867610
hyuA_predicted,1.0,2,1,GTGGCTCCGTATGTCCTCAA,1,1857183
hyuA_predicted,7.5,15,1,GTGGAGTATTGTGCGTTTGT,14,1854487
hyuA_predicted,2.5,5,1,GTGCCCAACTCTCAGGCATC,4,1858826
hyuA_predicted,5.0,10,1,GTGCCAAAATAGCTCGGCCG,9,1873537
hyuA_predicted,1.0,2,1,GTGCATCTCTGGTAAGTCTG,1,1856955
hyuA_predicted,10.5,21,1,GTGCAAGTAAGCCCAAGAGG,20,1850092
hyuA_predicted,1.0,2,1,GTGAGGATAGGAAAGCTCAG,1,1834708
hyuA_predicted,5.0,10,1,GTCTGGAAAGTTATGTAAAC,9,1874561
hyuA_predicted,1.0,2,1,GTCTCGCTGTGTCAGACTGA,1,1874365
hyuA_predicted,3.5,7,1,GTCGGCCCCGCGTGCCTCTT,6,1829770
hyuA_predicted,2.5,5,1,GTCAATGAGCGATGCAGTCG,4,1842223
hyuA_predicted,4.0,8,1,GTCAACTTAGGTGTTGGTGT,7,1852679
hyuA_predicted,1.0,2,1,GTATGCTTGAGCGCGACCTA,1,1844957
hyuA_predicted,13.5,27,1,GTATCTTCCAGGCTTGTCTA,26,1849696
hyuA_predicted,3.5,7,1,GTATATTGAAGCCTTGTATT,6,1843664
hyuA_predicted,1.0,2,1,GTAATTCAGAGGCGTGGTCT,1,1831583
hyuA_predicted,2.5,5,1,GGTGAGTGCAGAGAAACAAT,4,1840031
hyuA_predicted,4.5,9,1,GGTCGCATTGCTGTTGAGTT,8,1857886
hyuA_predicted,1.5,3,1,GGTCATCATATTATGTGGGA,2,1861042
hyuA_predicted,6.0,12,1,GGTAGTACGGGATTCCTTTC,11,1875017
hyuA_predicted,1.0,2,1,GGTACTGGACCCTGATTAAA,1,1861924
hyuA_predicted,3.0,6,1,GGGTTTCTCTTGTAAAAAAA,5,1846437
hyuA_predicted,1.0,2,1,GGGGGAGATTGACTTGACAG,1,1830515
hyuA_predicted,1.0,2,1,GGGCGTACCAAAACTGGACT,1,1853164
hyuA_predicted,1.0,2,1,GGGCGGTGAGTTCCGCCGTT,1,1840649
hyuA_predicted,5.5,11,1,GGGAAACCCTCAGTCACATT,10,1843617
hyuA_predicted,3.5,7,1,GGCTTCGCGGAATGCTCATT,6,1854941
hyuA_predicted,5.0,10,1,GGCTCACATATTAGATAAGA,9,1864260
hyuA_predicted,1.0,2,1,GGCTATTATATGGGTATGGC,1,1870763
hyuA_predicted,12.0,24,1,GGCGTAGAGGCGTCTACTTT,23,1843016
hyuA_predicted,1.0,2,1,GGCCCGTCTCAACACGTCGC,1,1870390
hyuA_predicted,9.0,18,1,GGATTTCTTTATGCCACGTG,17,1865750
hyuA_predicted,1.5,3,1,GGATGAGTCAGTTCCCCTTC,2,1845942
hyuA_predicted,3.5,7,1,GGAGTCATTGTCCAACACAC,6,1875564
hyuA_predicted,9.0,18,1,GGAGTAATCAGCGGCCGTTG,17,1852180
hyuA_predicted,8.0,16,1,GGAGGAGGCATGTGGGGACA,15,1831281
hyuA_predicted,2.5,5,1,GGAGCAAAGCAAAGATCTAG,4,1846131
hyuA_predicted,1.5,3,1,GGAGATCTGGCCAAGGTACT,2,1846565
hyuA_predicted,2.5,5,1,GGACTTGCGAAATTGTGATG,4,1838465
hyuA_predicted,1.0,2,1,GGACGTTTATACGAAATCGT,1,1849122
hyuA_predicted,2.0,4,1,GCTTGCCTTCCCCTTACGTT,3,1876682
hyuA_predicted,3.5,7,1,GCTGTATACATATAACACCG,6,1863149
hyuA_predicted,4.5,9,1,GCTGATTAGCCAATTTATGT,8,1834406
hyuA_predicted,4.0,8,1,GCTCGCTGATCACCGAACAA,7,1861126
hyuA_predicted,1.0,2,1,GCTAGCCCGAGAGGCAATGC,1,1862460
hyuA_predicted,1.5,3,1,GCTAGAAGGCAACGTATCAT,2,1830125
hyuA_predicted,11.5,23,1,GCTAGAAATTAGCGTGAGTT,22,1837908
hyuA_predicted,2.0,4,1,GCGTCTTTAGTACTTGCCTC,3,1846775
hyuA_predicted,5.0,10,1,GCGGCCCCGCGGCCACGGGT,9,1864382
hyuA_predicted,1.5,3,1,GCGATTTCTCGTCCAAGTCA,2,1858587
hyuA_predicted,3.0,6,1,GCGAAGTCCAGAACTGTAGA,5,1837463
hyuA_predicted,8.0,16,1,GCCTGCGAACGGTACAGTAA,15,1840175
hyuA_predicted,1.0,2,1,GCCTACTCAGGGCCAAACCT,1,1830580
hyuA_predicted,1.5,3,1,GCCGTCTTAATAGTTACAGT,2,1832986
hyuA_predicted,1.0,2,1,GCCCTTTACGTCTCATACCC,1,1845754
hyuA_predicted,1.5,3,1,GCCCAATTGGGCTCGTGGAT,2,1857302
hyuA_predicted,1.0,2,1,GCCAGCTAACACTGGGTAAA,1,1836219
hyuA_predicted,1.0,2,1,GCAGTGCCGTCAATGTGGCT,1,1846076
hyuA_predicted,1.0,2,1,GCAGGGTCCATTATTTACGA,1,1845655
hyuA_predicted,3.5,7,1,GCAGATTAGGAGAAAATTCA,6,1829132
hyuA_predicted,11.5,23,1,GCACGTCCGAAATTCTGTCC,22,1863966
hyuA_predicted,1.0,2,1,GCACGTATCTCGGGTGCCAC,1,1864505
hyuA_predicted,1.0,2,1,GCAATAGCATATTATCGCAA,1,1841141
hyuA_predicted,8.0,16,1,GCAACGGTGAAACTTAGAAG,15,1871334
hyuA_predicted,14.5,29,1,GCAACATAAGCGCAATAGGC,28,1852039
hyuA_predicted,2.5,5,1,GATTTGTATTTAGAAGAGGG,4,1856887
hyuA_predicted,2.5,5,1,GATCGCGTGCCTGAGTTATT,4,1864669
hyuA_predicted,2.0,4,1,GATCGACGAATGCAGAATCT,3,1839616
hyuA_predicted,1.0,2,1,GATCACCTCGAAGCCCCGGT,1,1846543
hyuA_predicted,1.5,3,1,GAGTACCCAGATGATATACA,2,1842972
hyuA_predicted,1.0,2,1,GAGTACATAAATATAGGATT,1,1846340
hyuA_predicted,4.0,8,1,GAGGTTATGCGCCCGTTTTA,7,1832113
hyuA_predicted,5.0,10,1,GAGGTGAGGGTGGGAAGGTG,9,1852112
hyuA_predicted,2.5,5,1,GAGGTCCACGCAGGGACAAT,4,1859285
hyuA_predicted,2.5,5,1,GAGCTTGAGGAGCCGATCTG,4,1868202
hyuA_predicted,6.0,12,1,GAGAGACAGTCACTACGAAG,11,1866408
hyuA_predicted,1.0,2,1,GACGTGGCCAATGAGTTGAC,1,1869042
hyuA_predicted,4.0,8,1,GAATACTTGTCATCTAATCC,7,1839569
hyuA_predicted,2.0,4,1,GAAGTTATGCGAGCCGAGAT,3,1829838
hyuA_predicted,2.0,4,1,GAACTACTGCACGCAAACGC,3,1845113
hyuA_predicted,1.0,2,1,GAAACATGACCTCGGGTTAC,1,1876204
hyuA_predicted,5.0,10,1,CTTGCGTACCCAAGAGTAGC,9,1871335
hyuA_predicted,16.5,33,1,CTTCATTAGTACTTAACTAA,32,1832116
hyuA_predicted,26.0,52,1,CTTCATAACTCAGGCGTCTG,51,1866018
hyuA_predicted,10.5,21,1,CTTCACGTCGTTATCTAGGG,20,1830324
hyuA_predicted,2.5,5,1,CTTAGGTGGTTAGGTCTGAA,4,1856957
hyuA_predicted,1.5,3,1,CTTACTATGAACCTCTCGTC,2,1843751
hyuA_predicted,5.0,10,1,CTTAACTAATATGCAATAGG,9,1862723
hyuA_predicted,3.0,6,1,CTTAAAACCGTTGGGTTTGG,5,1852286
hyuA_predicted,7.5,15,1,CTGGCGTCCGGTACTAAATT,14,1877853
hyuA_predicted,5.5,11,1,CTGGCGGCTCGTGGGGCATT,10,1840866
hyuA_predicted,1.5,3,1,CTGCTAGACACACTGTCATT,2,1831796
hyuA_predicted,5.5,11,1,CTGCGTGAGCGATCGATGTG,10,1852052
hyuA_predicted,7.5,15,1,CTGCCCACGATGTCGCGGGG,14,1876421
hyuA_predicted,3.5,7,1,CTGCACCTCACCAACTCCTC,6,1849761
hyuA_predicted,6.0,12,1,CTGAACATATGCCTACTATG,11,1851085
hyuA_predicted,1.0,2,1,CTCTGGTATGACCTCCTTCG,1,1846868
hyuA_predicted,1.0,2,1,CTCTGGAAGGTTGTTAGGGG,1,1829409
hyuA_predicted,1.0,2,1,CTCATCGGTCATCGAACGCC,1,1861713
hyuA_predicted,3.5,7,1,CTCACACGGTTCTGGCTCAC,6,1862230
hyuA_predicted,6.0,12,1,CTCAAGCCTGGACGCAGGGT,11,1860884
hyuA_predicted,2.0,4,1,CTATTTCGGTAGTTACCCTC,3,1830782
hyuA_predicted,2.0,4,1,CTATATTAATTGGAGGTAAT,3,1839275
hyuA_predicted,3.5,7,1,CTATACTGGCCTTTTATTTT,6,1840731
hyuA_predicted,6.0,12,1,CTAAGGGGCGAGGCAGTGCT,11,1869568
hyuA_predicted,3.0,6,1,CTAACATTGGAACCAAGCTT,5,1853142
hyuA_predicted,16.0,32,1,CGTCAGCCACAGTACGCAGA,31,1835338
hyuA_predicted,9.5,19,1,CGTCAAGCGATGCGAATCAC,18,1833373
hyuA_predicted,10.5,21,1,CGGCGGCCAGCGGGGATCCG,20,1859908
hyuA_predicted,1.0,2,1,CGGCCTCGGAACTACCGTGA,1,1862324
hyuA_predicted,12.0,24,1,CGGCCAGGCTGGAAGCGCAA,23,1861676
hyuA_predicted,1.5,3,1,CGGATAGGCTATGGATGGTA,2,1862178
hyuA_predicted,10.0,20,1,CGGACACGAGTCACAACTGA,19,1837114
hyuA_predicted,4.5,9,1,CGCTCTTGCCATAGTCGGCC,8,1837739
hyuA_predicted,3.0,6,1,CGCTCAGCCCTGTTGAATCA,5,1829245
hyuA_predicted,3.5,7,1,CGCGCTGCTAGAATGGGGGG,6,1852143
hyuA_predicted,7.0,14,1,CGCCCAAAATTGCGGCCTTG,13,1848720
hyuA_predicted,1.0,2,1,CGCAGCAGCCGGACCCAAAC,1,1858773
hyuA_predicted,1.0,2,1,CGATTCATGGATTGCATAAT,1,1854872
hyuA_predicted,1.0,2,1,CGATCGATAACAAGTGACAC,1,1840953
hyuA_predicted,2.5,5,1,CGAATTGTTCAGGTTGCGAA,4,1840656
hyuA_predicted,16.5,33,1,CGAACGCAGTTTTGGTTTCA,32,1865977
hyuA_predicted,7.0,14,1,CGAAAATAATACTCAGAGAT,13,1864567
hyuA_predicted,6.5,13,1,CCTTTCTGGTCAGGAAATGT,12,1832789
hyuA_predicted,11.0,22,1,CCTGTTGTACCCACAAGTTA,21,1876807
hyuA_predicted,1.0,2,1,CCTATGAATCGGATTCAGTT,1,1865843
hyuA_predicted,4.5,9,1,CCTAGTGCTCGCGGTAGGAT,8,1830246
hyuA_predicted,4.5,9,1,CCTAAACACTCACGTTCCAA,8,1844381
hyuA_predicted,11.0,22,1,CCGTATCTGCCCCGGGGCTA,21,1864033
hyuA_predicted,2.5,5,1,CCGGTTCAAGTGAGGGTAGA,4,1853944
hyuA_predicted,7.5,15,1,CCGGGTACGTTCCCTACTGG,14,1849650
hyuA_predicted,1.0,2,1,CCGGCTTAGCGGTCAACCCC,1,1877741
hyuA_predicted,4.5,9,1,CCGGACCCTGCTTCACAGTA,8,1849499
hyuA_predicted,4.5,9,1,CCGACCAGGCATTGTTGACT,8,1838308
hyuA_predicted,3.5,7,1,CCCTTCTAGTATGGGCCTAC,6,1828865
hyuA_predicted,4.0,8,1,CCCTGCTTTCATAACGATCG,7,1853755
hyuA_predicted,5.0,10,1,CCCGTCCGTCTGGCCCGACC,9,1841769
hyuA_predicted,5.0,10,1,CCCCCGCTATCCATACCTGT,9,1855981
hyuA_predicted,3.0,6,1,CCCAGAGAAAGCATCCTGGC,5,1875480
hyuA_predicted,6.0,12,1,CCCACATTTACGAAAGTTAG,11,1876560
hyuA_predicted,13.5,27,1,CCATATTACCTCGGACAATG,26,1833873
hyuA_predicted,6.5,13,1,CCAGCTATAGGAAGCCCCAC,12,1847176
hyuA_predicted,5.5,11,1,CATGGAGGTGGGTAATATTT,10,1836249
hyuA_predicted,4.5,9,1,CATGAGTACCATTTCTTTTG,8,1838273
hyuA_predicted,7.5,15,1,CATCACCCGAATTAAGGCGT,14,1840509
hyuA_predicted,1.0,2,1,CATCAAGGCCCGCACTAAGA,1,1876869
hyuA_predicted,1.0,2,1,CATACACCGTACTGCTTCAC,1,1833177
hyuA_predicted,2.5,5,1,CATAAGATGTATGTTTCTCA,4,1829989
hyuA_predicted,1.0,2,1,CAGTGCCTTAAAGTTCGTAT,1,1866157
hyuA_predicted,13.5,27,1,CAGTGCACCCCACTTCAGCC,26,1852676
hyuA_predicted,4.5,9,1,CAGGTGAACGCGGTGTAAAC,8,1856163
hyuA_predicted,13.0,26,1,CAGGCACAAACTGTTTGTGG,25,1847768
hyuA_predicted,2.5,5,1,CAGCATCGATCGTCCTCCGA,4,1860057
hyuA_predicted,2.5,5,1,CAGCACCCTGGGCTGAATCG,4,1832975
hyuA_predicted,12.0,24,1,CAGATTCTCAGTTTCATGTA,23,1838498
hyuA_predicted,7.0,14,1,CAGACAACACGTTTACAAAA,13,1847655
hyuA_predicted,4.5,9,1,CACTCACCTGGGCAAGCAAA,8,1877010
hyuA_predicted,12.0,24,1,CACCTAAGTTCGCCTTGTTA,23,1873776
hyuA_predicted,9.5,19,1,CACCTAAAAAGTATAATTAC,18,1846062
hyuA_predicted,3.0,6,1,CACAGTAATATTTCTGACAA,5,1853619
hyuA_predicted,1.5,3,1,CAATACGCGTAGCGCAATCT,2,1840302
hyuA_predicted,2.0,4,1,CAAGAAAAGCCGCCACGTTG,3,1847981
hyuA_predicted,7.5,15,1,CAACAGATCAATGACGACCT,14,1861247
hyuA_predicted,2.5,5,1,ATTTCCTCTGTTCCGCTATG,4,1847354
hyuA_predicted,2.0,4,1,ATTTAACGGTATTAACGCTA,3,1853052
hyuA_predicted,6.0,12,1,ATTGAAGGGCAAGCCCAGGT,11,1850879
hyuA_predicted,1.5,3,1,ATTATTACATGGAGCTTACG,2,1847980
hyuA_predicted,5.0,10,1,ATTACCGCCTTGTATGCTTA,9,1834752
hyuA_predicted,5.0,10,1,ATGTTTGGAGCTCGCTTTAA,9,1858098
hyuA_predicted,5.5,11,1,ATGGGGTCCCTGTACCGACG,10,1854650
hyuA_predicted,8.0,16,1,ATGGGCTGACATGATGTTTT,15,1851823
hyuA_predicted,10.0,20,1,ATGGGAGTGACTTCGTCATT,19,1874321
hyuA_predicted,1.0,2,1,ATGGCGTTAGAGATACCCTT,1,1855590
hyuA_predicted,4.0,8,1,ATGGCCTAAGGTGCGCTGGG,7,1857930
hyuA_predicted,11.0,22,1,ATGGCAACCGCGGCATAACT,21,1860353
hyuA_predicted,3.0,6,1,ATGACACGGGGGACTAGATT,5,1864834
hyuA_predicted,6.5,13,1,ATCTTTATCTTGTGATCCCT,12,1877601
hyuA_predicted,4.0,8,1,ATCTCGGGTGCTGGGTAAAA,7,1869441
hyuA_predicted,11.0,22,1,ATCTCCACGTAACCCCTTCT,21,1834565
hyuA_predicted,1.0,2,1,ATCTCAGTCGCGCTCCTTAA,1,1853502
hyuA_predicted,4.0,8,1,ATCTAAATCTACCCACCTCC,7,1867142
hyuA_predicted,1.5,3,1,ATCAGTATCCGGATGGACCT,2,1863914
hyuA_predicted,1.0,2,1,ATCAGATAAAGTTTACATAC,1,1843398
hyuA_predicted,1.0,2,1,ATATTAGTACAGATAGGGCA,1,1836750
hyuA_predicted,4.0,8,1,ATATCCGCTCGCTCGGACTA,7,1846846
hyuA_predicted,1.5,3,1,ATATATGTACGACAGTCCCT,2,1862275
hyuA_predicted,4.5,9,1,ATAGAGAGAGATACAGGTTG,8,1844406
hyuA_predicted,1.0,2,1,ATACGAATGAAGGTCTACAT,1,1851140
hyuA_predicted,3.5,7,1,ATAATGTGCCACTGAACTCT,6,1853661
hyuA_predicted,12.5,25,1,ATAACTCTAGGCCTCGCTCT,24,1832674
hyuA_predicted,2.0,4,1,ATAACAAGAGCCACCCTAAC,3,1872414
hyuA_predicted,4.0,8,1,AGTGGCCAACAGTGGGAATA,7,1877667
hyuA_predicted,2.5,5,1,AGTCAATGACGGCTTTGCCC,4,1841953
hyuA_predicted,11.5,23,1,AGGTCGTCCCGTACATTAAC,22,1831256
hyuA_predicted,1.0,2,1,AGGTCAGCGCTCGCCGATCT,1,1849272
hyuA_predicted,5.0,10,1,AGGGTGTGTGGCCGGAGATA,9,1864738
hyuA_predicted,4.5,9,1,AGGGTAGGCGGCCACACTGG,8,1866619
hyuA_predicted,4.0,8,1,AGGGGGATTGTGGGTTGGTC,7,1873294
hyuA_predicted,1.5,3,1,AGGGGGAGATGTTCAGTTTA,2,1853036
hyuA_predicted,18.5,37,1,AGGCGCGGGACATAGAGTTA,36,1858400
hyuA_predicted,6.5,13,1,AGGATGGAACGGTCTCACAT,12,1861374
hyuA_predicted,4.5,9,1,AGCTTCATTCACAAACAGTA,8,1831792
hyuA_predicted,3.0,6,1,AGCTGGGCGCGGCAGCAAAT,5,1854659
hyuA_predicted,6.5,13,1,AGCTACGCGCTGGAGCCCGA,12,1850770
hyuA_predicted,3.0,6,1,AGCGTCACGCGGGTTTTCCA,5,1863331
hyuA_predicted,7.0,14,1,AGCCCAACTGATTTCAATCA,13,1866974
hyuA_predicted,5.5,11,1,AGCCAGCTACGATGGTAAGG,10,1874736
hyuA_predicted,3.0,6,1,AGCAGAGCACCTATGCTCAT,5,1840558
hyuA_predicted,1.0,2,1,AGCAGACTTGGTAAGCGTCG,1,1837202
hyuA_predicted,11.0,22,1,AGATGTGGTCTCGTAGATGG,21,1862121
hyuA_predicted,12.0,24,1,AGATAAAGCGATGGTGCAGG,23,1862128
hyuA_predicted,1.0,2,1,AGAGCTTGTGGAAGAATGTT,1,1874566
hyuA_predicted,1.0,2,1,AGAGCTAGTATCCATGGTCC,1,1836616
hyuA_predicted,1.0,2,1,AGACTCACCCCGACTCTGTT,1,1862972
hyuA_predicted,13.5,27,1,AGAAATGTGGCCCACGTGAG,26,1839671
hyuA_predicted,6.5,13,1,ACTTGTTGTGCTACTCTGAT,12,1870912
hyuA_predicted,7.0,14,1,ACTCGTGCTACTTATAATCG,13,1852771
hyuA_predicted,1.5,3,1,ACTCGCTCTAATGAAGGGGG,2,1838906
hyuA_predicted,4.5,9,1,ACTCGACGTTCCCTCAGACA,8,1860706
hyuA_predicted,7.0,14,1,ACGTTGGTTGACTGCGGTGC,13,1853181
hyuA_predicted,5.0,10,1,ACGTTATAACCGGTCTCCCG,9,1859923
hyuA_predicted,3.0,6,1,ACGGGGTTGCGCCGTTATGT,5,1869069
hyuA_predicted,1.5,3,1,ACGGCTTCTTACTCTACCTA,2,1848043
hyuA_predicted,6.0,12,1,ACGGCATATACTCTAGCCGA,11,1863812
hyuA_predicted,16.0,32,1,ACGCTCCAGTGTCCAATGTA,31,1845063
hyuA_predicted,3.0,6,1,ACGCACTGATAGCGACCACC,5,1847081
hyuA_predicted,3.5,7,1,ACGATTGGGATCATGTGGAT,6,1869902
hyuA_predicted,2.0,4,1,ACGACCCATACTTGGTTACA,3,1849601
hyuA_predicted,5.5,11,1,ACGACATAATTATTGGAATA,10,1851626
hyuA_predicted,16.0,32,1,ACCCTTTGTCCTGGTAGCAG,31,1841073
hyuA_predicted,10.5,21,1,ACCATTGTCGTTAACGATCT,20,1870661
hyuA_predicted,7.5,15,1,ACATTTAATAATCTCGCTGT,14,1842926
hyuA_predicted,7.0,14,1,ACATGATTCCCGATCAGTAG,13,1853195
hyuA_predicted,4.0,8,1,ACATGATGTAGCTATCCCAT,7,1846369
hyuA_predicted,7.0,14,1,ACATCCGTCTCGGTTGGAGT,13,1839432
hyuA_predicted,6.0,12,1,ACATACTTATGACAAATTAA,11,1873583
hyuA_predicted,1.0,2,1,ACAGTTTGGTCATGCAAGGT,1,1867458
hyuA_predicted,1.0,2,1,ACACTGGGTATAAGTCACCA,1,1852799
hyuA_predicted,2.0,4,1,AATTAATGTGGTAGGTAAGC,3,1866014
hyuA_predicted,1.5,3,1,AATAAGGTATTGGGCCTCCT,2,1834954
hyuA_predicted,1.0,2,1,AAGTCCGGAGGTCCACTAGC,1,1865799
hyuA_predicted,1.0,2,1,AAGGTTCTAATTATCGATAA,1,1863992
hyuA_predicted,1.0,2,1,AAGGGTAGTACGGAAACGTC,1,1839281
hyuA_predicted,5.0,10,1,AAGGGCTCAGCTCGACTCTA,9,1842643
hyuA_predicted,2.0,4,1,AAGCATGGGTAATGTTCGAA,3,1874120
hyuA_predicted,13.0,26,1,AAGAGAATCCTGCCTTGCCA,25,1840681
hyuA_predicted,5.0,10,1,AAGACAACTGATTCTAGCCC,9,1852476
hyuA_predicted,8.0,16,1,AAGACAACGTTCAATCATAG,15,1877041
hyuA_predicted,3.5,7,1,AAGAATAAACAGTTCCGACG,6,1859857
hyuA_predicted,1.0,2,1,AAGAACTTTCAAAGACGGTG,1,1865849
hyuA_predicted,4.5,9,1,AACTTCGGGTTGTGCCATTA,8,1841873
hyuA_predicted,2.5,5,1,AACCGTGCGCATTCCTATAA,4,1865571
hyuA_predicted,11.0,22,1,AACCGACCAGTGTGAGGGTG,21,1843822
hyuA_predicted,1.5,3,1,AACAGTATTGGAAAGAGTGG,2,1847798
hyuA_predicted,12.0,24,1,AAATCAGCGAACAGCGTCCC,23,1866130
hyuA_predicted,8.0,16,1,AAATAGCGGCCCTAAACGTT,15,1849731
hyuA_predicted,0.018867924528301886,52,52,ATGATAATTTCGGTCTGGTC,0,1862087
hyuA_predicted,0.0196078431372549,50,50,GGACATCGCATTGGCTTCAT,0,1864592
hyuA_predicted,0.02,49,49,GGAGGGGTAGATATACTGGA,0,1831007
hyuA_predicted,0.02127659574468085,46,46,AGTGGGGGTTGGAAGGGAGT,0,1832820
hyuA_predicted,0.022222222222222223,44,44,CTTACTTACTGGGGCCATCA,0,1834531
hyuA_predicted,0.022727272727272728,43,43,ACAAGGAGCTTAGTACAGGA,0,1860298
hyuA_predicted,0.023255813953488372,42,42,CAGAAGCTGATCATGCTACT,0,1841466
hyuA_predicted,0.023809523809523808,41,41,TAATATGGTTAGGTGGACGC,0,1868267
hyuA_predicted,0.024390243902439025,40,40,CGGTTAGAAATATAAGGCGT,0,1834909
hyuA_predicted,0.024390243902439025,40,40,ACTCTCGGCGGGAGTAAAAT,0,1828908
hyuA_predicted,0.024390243902439025,40,40,AAGTCCTATGGCTGTGGGCG,0,1856648
hyuA_predicted,0.024390243902439025,40,40,AACACACTGGCCCCTGGGAC,0,1865727
hyuA_predicted,0.025,39,39,CCCAGGGTCACCTATGGCGT,0,1837065
hyuA_predicted,0.02631578947368421,37,37,GAACGCTGAGGGGTACACAC,0,1853616
hyuA_predicted,0.02631578947368421,37,37,CGCTTCGTAACGGGTCTATC,0,1861647
hyuA_predicted,0.02631578947368421,37,37,CGCGTTCTGTGTTTGGGAAT,0,1858358
hyuA_predicted,0.02702702702702703,36,36,CTTAATCCGTAGAAGTGAAG,0,1870348
hyuA_predicted,0.02702702702702703,36,36,ATGGTAGAAATGAACGCCTT,0,1838001
hyuA_predicted,0.027777777777777776,35,35,TCGATTCTGCTACCCACGTC,0,1836990
hyuA_predicted,0.027777777777777776,35,35,GAAATATCTGCGTCGCACGT,0,1862231
hyuA_predicted,0.027777777777777776,35,35,AAGCGGCGGCCCATGCAGCT,0,1875001
hyuA_predicted,0.027777777777777776,35,35,AAAACCGGGGGCGGGACAAG,0,1836312
hyuA_predicted,0.02857142857142857,34,34,GTCTCCACTCAACGCGGGTA,0,1850164
hyuA_predicted,0.02857142857142857,34,34,CTTAATCGCTCGGTCATGTG,0,1867738
hyuA_predicted,0.02857142857142857,34,34,CAAGCCGTGAGTGATCATGA,0,1833973
hyuA_predicted,0.029411764705882353,33,33,TTTGAGACGACTTCCGGTCT,0,1862765
hyuA_predicted,0.029411764705882353,33,33,ATGGATAGGGTGCACTCAGG,0,1833362
hyuA_predicted,0.029411764705882353,33,33,ACTTTTCACTCGTCAAACAG,0,1846654
hyuA_predicted,0.030303030303030304,32,32,CGACTCCAAGCCACCGTCTT,0,1849198
hyuA_predicted,0.030303030303030304,32,32,CCAAAGATTTACGCACGGCA,0,1841248
hyuA_predicted,0.030303030303030304,32,32,CACGTGTAAATTGAACTACT,0,1856478
hyuA_predicted,0.030303030303030304,32,32,AATCCACATTCAATATGTAA,0,1830772
hyuA_predicted,0.030303030303030304,32,32,AACAACAGCCCGGTGATAAC,0,1843526
hyuA_predicted,0.03125,31,31,TAATGCGGGTTTCGGTTCTG,0,1856123
hyuA_predicted,0.03125,31,31,GTAGCTCATCAGTGATGTGA,0,1854169
hyuA_predicted,0.03125,31,31,GCGTAGGTTGATAGCCGTGT,0,1862267
hyuA_predicted,0.03125,31,31,AGGTATTCCACATTGTTCAT,0,1854043
hyuA_predicted,0.03125,31,31,AAGTGGCTACGTTTCCATGC,0,1840549
hyuA_predicted,0.03225806451612903,30,30,TTACAGATTCCCTGAATCTT,0,1876442
hyuA_predicted,0.03225806451612903,30,30,TTACACGTTGCCAACAGATG,0,1840212
hyuA_predicted,0.03225806451612903,30,30,GCGAAGAAAGGGTCCGGCAA,0,1862907
hyuA_predicted,0.03225806451612903,30,30,CTGTTTCCCGTTAGGGGTGT,0,1872872
hyuA_predicted,0.03225806451612903,30,30,CCTCGCGTGTATGCCGGCAA,0,1868370
hyuA_predicted,0.03225806451612903,30,30,CAGCCGGTGTCATTATATAT,0,1868823
hyuA_predicted,0.03225806451612903,30,30,ACTAGGAATAGGTGCTGATC,0,1832114
hyuA_predicted,0.03333333333333333,29,29,TCTCTACTGTCAGCCTGGTG,0,1846559
hyuA_predicted,0.03333333333333333,29,29,TATGGTGAACGCCCGTTATA,0,1837594
hyuA_predicted,0.03333333333333333,29,29,GTCGAGGCAGCTTAAGGGAT,0,1863423
hyuA_predicted,0.03333333333333333,29,29,GCTAGCGGCATGGCTTTGCA,0,1860161
hyuA_predicted,0.03333333333333333,29,29,GCCGGTCCTGCGTTCTAATA,0,1833398
hyuA_predicted,0.03333333333333333,29,29,GAACAGGACGATCAATTCCA,0,1845023
hyuA_predicted,0.03333333333333333,29,29,CAATTTTGGGCCGTACAAAC,0,1849767
hyuA_predicted,0.03333333333333333,29,29,ACCTGTATGCCGTAAAAGTA,0,1853004
hyuA_predicted,0.03333333333333333,29,29,AATCTAGTTGAGTATATGGT,0,1875895
hyuA_predicted,0.03333333333333333,29,29,AAAAGCGAGGCTGTAAAGGC,0,1832202
hyuA_predicted,0.034482758620689655,28,28,TGTTGAAACGAGGATTCGCT,0,1854997
hyuA_predicted,0.034482758620689655,28,28,TATACGCAGACCAAATCAAT,0,1841396
hyuA_predicted,0.034482758620689655,28,28,GCAAGATGACCCCGGTGCAA,0,1873651
hyuA_predicted,0.034482758620689655,28,28,GATGTGCCGGGTGGCTACCA,0,1839361
hyuA_predicted,0.034482758620689655,28,28,GATGGTTTGCGTGGGTGTGA,0,1845015
hyuA_predicted,0.034482758620689655,28,28,GAATGAAGTGGGATGGACTT,0,1836688
hyuA_predicted,0.034482758620689655,28,28,CTAAACAGGGTATACGGGAT,0,1845930
hyuA_predicted,0.034482758620689655,28,28,CCTAACTATCCAACGGGACT,0,1876342
hyuA_predicted,0.034482758620689655,28,28,CATACATCAGCAAGGCCAAG,0,1832127
hyuA_predicted,0.034482758620689655,28,28,ATCCAAAGGATCCTCGAACT,0,1844244
hyuA_predicted,0.034482758620689655,28,28,AGGGTGGTCAGGAGTACACG,0,1837976
hyuA_predicted,0.03571428571428571,27,27,TTGTGGTGATGGGTGCGGGG,0,1855706
hyuA_predicted,0.03571428571428571,27,27,TTGCAAAATCTGCTCTCTAC,0,1877206
hyuA_predicted,0.03571428571428571,27,27,TGTGAAGCGAGCGCGTTCCG,0,1874137
hyuA_predicted,0.03571428571428571,27,27,TGAAGGATAGTTGAAGGTAA,0,1834219
hyuA_predicted,0.03571428571428571,27,27,TCTCCCTGTGTATGGCGCAG,0,1870955
hyuA_predicted,0.03571428571428571,27,27,TCCCACTATGCGGGTCGAAA,0,1875685
hyuA_predicted,0.03571428571428571,27,27,TATGGTCCGACCCGTGCCTT,0,1869424
hyuA_predicted,0.03571428571428571,27,27,TAGGCAGGAATCGCTCGAGC,0,1842507
hyuA_predicted,0.03571428571428571,27,27,GGTACCCTTGACGGATTGGA,0,1868239
hyuA_predicted,0.03571428571428571,27,27,GGCAACTGTCAATCACGGAC,0,1837755
hyuA_predicted,0.03571428571428571,27,27,CTCATTTCCGCTTCCGACAA,0,1869211
hyuA_predicted,0.03571428571428571,27,27,CGGTGTAGGTACCGTAACAC,0,1839358
hyuA_predicted,0.03571428571428571,27,27,CGGCGCACACGATGCTGGTT,0,1844877
hyuA_predicted,0.03571428571428571,27,27,CGCAAACTCTAGGATAGAAA,0,1854573
hyuA_predicted,0.03571428571428571,27,27,CCCGAGGCACAGAATGAGAG,0,1859809
hyuA_predicted,0.03571428571428571,27,27,ATGGATTTCACCTACTGTCG,0,1833795
hyuA_predicted,0.03571428571428571,27,27,AGAGGATACTCAACGGTCCT,0,1874249
hyuA_predicted,0.03571428571428571,27,27,AAGTGTCACTCATCACAGTT,0,1859871
hyuA_predicted,0.03571428571428571,27,27,AAGTCGAAACGGGGGTGCCT,0,1858126
hyuA_predicted,0.037037037037037035,26,26,TGCTCGGAGTGCCGGGTCGT,0,1840162
hyuA_predicted,0.037037037037037035,26,26,TCTTGTGATTTTCGAACGGC,0,1861379
hyuA_predicted,0.037037037037037035,26,26,TCTAACTGCGCGTTAGTATA,0,1862662
hyuA_predicted,0.037037037037037035,26,26,TCCGATTCATGGAATTTTGG,0,1858677
hyuA_predicted,0.037037037037037035,26,26,TATCAATAACGGCTACCAGA,0,1872644
hyuA_predicted,0.037037037037037035,26,26,TAGCCAGTCTCTATTGTCGT,0,1837369
hyuA_predicted,0.037037037037037035,26,26,GTCCATCGGCTCTCCTATGG,0,1853725
hyuA_predicted,0.037037037037037035,26,26,GACGTACTGAGTACAGCAGA,0,1852309
hyuA_predicted,0.037037037037037035,26,26,CTCAGTGTAAATTGCATCGT,0,1861817
hyuA_predicted,0.037037037037037035,26,26,ATGGACAGTGTTCTGCATTC,0,1829128
hyuA_predicted,0.037037037037037035,26,26,ATAACATCGTTTAAAGTGTG,0,1838710
hyuA_predicted,0.037037037037037035,26,26,AATGTCAGCTCATCTGAACG,0,1864263
hyuA_predicted,0.037037037037037035,26,26,AAGTTCATCGCTTCGGCGGT,0,1838772
hyuA_predicted,0.038461538461538464,25,25,TTTGAATAAACATTGGAGCG,0,1869526
hyuA_predicted,0.038461538461538464,25,25,TGGGTCTGTGCTGTTCGCCA,0,1829831
hyuA_predicted,0.038461538461538464,25,25,TGGCTTTTTGGCTCATTCAG,0,1841709
hyuA_predicted,0.038461538461538464,25,25,TCACTTCCCCATGGGTTTTT,0,1829127
hyuA_predicted,0.038461538461538464,25,25,TCACCCCTTATTGATGCTCG,0,1872049
hyuA_predicted,0.038461538461538464,25,25,TAGGGATTATAGAGCCTGTC,0,1844086
hyuA_predicted,0.038461538461538464,25,25,TAGGACGGCACATGAATTTG,0,1837439
hyuA_predicted,0.038461538461538464,25,25,GATACCGAGCCGTGCTTTCA,0,1870204
hyuA_predicted,0.038461538461538464,25,25,CTCCGCGGGTTCGGTAGTTA,0,1851640
hyuA_predicted,0.038461538461538464,25,25,CGGTTCTTTGACAGCGGTAC,0,1856356
hyuA_predicted,0.038461538461538464,25,25,CGGTAAAAGTGCATGGGTCT,0,1829327
hyuA_predicted,0.038461538461538464,25,25,CATTATGGTGCGATTTAGGC,0,1830089
hyuA_predicted,0.038461538461538464,25,25,AGTACACAATGAGGCCTTGA,0,1833145
hyuA_predicted,0.038461538461538464,25,25,AGCGCCCCGGAGCAACGCCT,0,1839108
hyuA_predicted,0.038461538461538464,25,25,AGCCTCATCGACCCGAGCCT,0,1837207
hyuA_predicted,0.038461538461538464,25,25,ACGTGCATTGACGTAAGGTA,0,1870859
hyuA_predicted,0.038461538461538464,25,25,ACGGTCAGCGGAACCTCCTA,0,1877527
hyuA_predicted,0.038461538461538464,25,25,ACAAGAGCGCAGGGAGGTCA,0,1835955
hyuA_predicted,0.04,24,24,TTGATCGTCCAGGGTCCTAG,0,1828886
hyuA_predicted,0.04,24,24,TAAATTCGGGTCAGTCAGTA,0,1855119
hyuA_predicted,0.04,24,24,GGGTTTAGAGAATATGAGAC,0,1843890
hyuA_predicted,0.04,24,24,GGGAGGCGCTAGTCCTCTGT,0,1845228
hyuA_predicted,0.04,24,24,GGACTGTGCGTCCCTTGCCA,0,1863212
hyuA_predicted,0.04,24,24,GCCCCCCTCGTATAGCTCTG,0,1838715
hyuA_predicted,0.04,24,24,GCATCCAAGTTCATACGTTT,0,1836600
hyuA_predicted,0.04,24,24,GAGTTAACCTATCCCGAAAC,0,1836995
hyuA_predicted,0.04,24,24,GAGAGCTTGCATTTCGGTGG,0,1838262
hyuA_predicted,0.04,24,24,GAGACAGTGTAGTAATGCAG,0,1833370
hyuA_predicted,0.04,24,24,CTCTAGGATCAAATCGATTG,0,1836917
hyuA_predicted,0.04,24,24,CTATGGTCATAAAGAAAGCG,0,1839390
hyuA_predicted,0.04,24,24,CGTGGCCGCGTAAGACTTTA,0,1833544
hyuA_predicted,0.04,24,24,CGCTTTAGCCGAGGTTAGGC,0,1842988
hyuA_predicted,0.04,24,24,CGCTGCTTAAGCAGGTATAA,0,1857701
hyuA_predicted,0.04,24,24,CGAATAAATTGGAAGGAGTA,0,1829367
hyuA_predicted,0.04,24,24,CATAAGACGGCTAAGCATTG,0,1860201
hyuA_predicted,0.04,24,24,AGGAAAATGGCGCACGAAGA,0,1843003
hyuA_predicted,0.04,24,24,AGATAGGGGGAATTCCGGGT,0,1860683
hyuA_predicted,0.04,24,24,ACTGCAGGGGATGAACAGCA,0,1844341
hyuA_predicted,0.04,24,24,ACGAACGAATACGCCTGTCG,0,1844383
hyuA_predicted,0.04,24,24,ACCCACTTACGTCAGTGAAA,0,1837850
hyuA_predicted,0.04,24,24,ACACGTAAAACCTACGTACA,0,1858990
hyuA_predicted,0.04,24,24,AATCCATCAGAAAAGGCCGT,0,1853664
hyuA_predicted,0.041666666666666664,23,23,TTGCGGAGTCCAGGGATTTA,0,1860200
hyuA_predicted,0.041666666666666664,23,23,TTCGCTTGCGTTGCTGTCGT,0,1851826
hyuA_predicted,0.041666666666666664,23,23,TGGAGACAAATTTAATGGTA,0,1856118
hyuA_predicted,0.041666666666666664,23,23,TGAAAACAGCGCATGTACTT,0,1870016
hyuA_predicted,0.041666666666666664,23,23,TGAAAACAACCGGCGCTTTA,0,1842723
hyuA_predicted,0.041666666666666664,23,23,TCTCTTCATGGTCGAGAGTA,0,1830462
hyuA_predicted,0.041666666666666664,23,23,TACGTGGTGAATTATTGATG,0,1838929
hyuA_predicted,0.041666666666666664,23,23,TAATCCGTTTACGGGTCACA,0,1875210
hyuA_predicted,0.041666666666666664,23,23,GTAAAAAGTTAGTGGTAAGT,0,1853494
hyuA_predicted,0.041666666666666664,23,23,GCGTTCGAGAATATTGGTGA,0,1852915
hyuA_predicted,0.041666666666666664,23,23,GCGCCAGGGGCTTATGTGGT,0,1842252
hyuA_predicted,0.041666666666666664,23,23,GCGACTTCTATTCAACTCTT,0,1859910
hyuA_predicted,0.041666666666666664,23,23,GAGGAGCTCGTCGCAGATAA,0,1842745
hyuA_predicted,0.041666666666666664,23,23,CTTTCCAATAGACCCCGCTG,0,1857529
hyuA_predicted,0.041666666666666664,23,23,CGTGGGTAGGGGACTGGCAG,0,1835835
hyuA_predicted,0.041666666666666664,23,23,CGCTCGAATAAATGGAAGAG,0,1843852
hyuA_predicted,0.041666666666666664,23,23,CCGTAATCCTTTAATACAAA,0,1851852
hyuA_predicted,0.041666666666666664,23,23,ATGCTACGAGTTTCAGTGAG,0,1873886
hyuA_predicted,0.041666666666666664,23,23,ATGCGTGCGCCCCCGGCGAG,0,1869068
hyuA_predicted,0.041666666666666664,23,23,ATCGCGTACTTTGATAAATA,0,1838511
hyuA_predicted,0.041666666666666664,23,23,ACTCTTGTGTCAACTTGGAT,0,1873709
hyuA_predicted,0.041666666666666664,23,23,ACATGTGGCGGCCTAGATAC,0,1870623
hyuA_predicted,0.041666666666666664,23,23,AAAGCCTGTGGCCGTTCCCA,0,1843067
hyuA_predicted,0.041666666666666664,23,23,AAACTGCATAAAGCGTATCC,0,1837361
hyuA_predicted,0.043478260869565216,22,22,TTTGCACACTTCTCAAGTCG,0,1849472
hyuA_predicted,0.043478260869565216,22,22,TTGACAAAGAGTAGGCGGAA,0,1829495
hyuA_predicted,0.043478260869565216,22,22,TTCTAGGGGTTACGTTATAC,0,1832965
hyuA_predicted,0.043478260869565216,22,22,TTCAAACCCGGCCCGGCAGA,0,1840123
hyuA_predicted,0.043478260869565216,22,22,TTACCGAGCGCATACACTCA,0,1875318
hyuA_predicted,0.043478260869565216,22,22,TGGACATGGGGGGAGCGGCA,0,1875351
hyuA_predicted,0.043478260869565216,22,22,TGCATTCGAAACTGATACAA,0,1855160
hyuA_predicted,0.043478260869565216,22,22,TGATTCATTTATGGCTAGAT,0,1843410
hyuA_predicted,0.043478260869565216,22,22,TCGTAACTCACCCTTTACAG,0,1843131
hyuA_predicted,0.043478260869565216,22,22,TCCGACTCTATGGGTATTTC,0,1860908
hyuA_predicted,0.043478260869565216,22,22,TCACACAGGGGTAAGAACCT,0,1861893
hyuA_predicted,0.043478260869565216,22,22,TCAACGGGCACCCTACTTCG,0,1872444
hyuA_predicted,0.043478260869565216,22,22,GTTGTGCCCTTTTCATGTGA,0,1834899
hyuA_predicted,0.043478260869565216,22,22,GTTATCAGACCGGTGGGTCT,0,1851725
hyuA_predicted,0.043478260869565216,22,22,GTGACAAGCCGGCGTGTGTT,0,1869348
hyuA_predicted,0.043478260869565216,22,22,GTCATTCTCGGGACTGCACG,0,1830964
hyuA_predicted,0.043478260869565216,22,22,GGTATGGACAAATGGACACT,0,1837974
hyuA_predicted,0.043478260869565216,22,22,GGGACGATGGTGTGCTGCCC,0,1858040
hyuA_predicted,0.043478260869565216,22,22,GCTTGCTATTGTGCGGGACT,0,1841142
hyuA_predicted,0.043478260869565216,22,22,GCCATCATCATGAGTTGCTG,0,1841885
hyuA_predicted,0.043478260869565216,22,22,GAACATCACTGGGAATCCGT,0,1854914
hyuA_predicted,0.043478260869565216,22,22,CTGGGTGGTAAGCCCCGGAA,0,1867078
hyuA_predicted,0.043478260869565216,22,22,CTCGGAACAGCCGACGGATT,0,1857057
hyuA_predicted,0.043478260869565216,22,22,CCTCAGACGAATATATCCGA,0,1862775
hyuA_predicted,0.043478260869565216,22,22,CCTATCTTGGGCATGACATA,0,1833166
hyuA_predicted,0.043478260869565216,22,22,CCGGAAGGATTGGTACATAG,0,1864658
hyuA_predicted,0.043478260869565216,22,22,CAGAAGAAGAAATGTTCAGT,0,1856497
hyuA_predicted,0.043478260869565216,22,22,CACTAAGTAGTTCTAGGAGA,0,1841749
hyuA_predicted,0.043478260869565216,22,22,ATTTCTGGAAACGCGAAGGT,0,1833106
hyuA_predicted,0.043478260869565216,22,22,ATTTAACACACTTACTGGTG,0,1855151
hyuA_predicted,0.043478260869565216,22,22,ATCCTGGCGCACCTAGAGAG,0,1850543
hyuA_predicted,0.043478260869565216,22,22,AGGTCACCTCGTAGCGATAG,0,1853918
hyuA_predicted,0.043478260869565216,22,22,AGGGACACGCTCTGAACGCT,0,1863078
hyuA_predicted,0.043478260869565216,22,22,ACAAGGTATCGCGCGCATTT,0,1871401
hyuA_predicted,0.045454545454545456,21,21,TTTCACTTAACTCAGAGTCG,0,1870963
hyuA_predicted,0.045454545454545456,21,21,TGCTATGCCTGACTTCTGAC,0,1850716
hyuA_predicted,0.045454545454545456,21,21,TCTTTGGGGCGAGAAACTGT,0,1843120
hyuA_predicted,0.045454545454545456,21,21,TCGTAGTTAAGAACTAACTC,0,1852136
hyuA_predicted,0.045454545454545456,21,21,TCCTTAGAGGAGTTCCTTAT,0,1831860
hyuA_predicted,0.045454545454545456,21,21,TCCCGGGGGACCACCTATTA,0,1870219
hyuA_predicted,0.045454545454545456,21,21,TATTAGCGGAAAAACGGCTA,0,1833494
hyuA_predicted,0.045454545454545456,21,21,GTGTCCATACCGCCAAACCT,0,1832571
hyuA_predicted,0.045454545454545456,21,21,GTCTGTACGCGGGGGTCGCA,0,1832916
hyuA_predicted,0.045454545454545456,21,21,GTCAATTGGCAAGCAGGTGT,0,1856475
hyuA_predicted,0.045454545454545456,21,21,GGTTCAGTTTGTAAGGTACT,0,1853480
hyuA_predicted,0.045454545454545456,21,21,GCTCCTCGTCAAGTTGGGTT,0,1864591
hyuA_predicted,0.045454545454545456,21,21,GCGCGTAACTGGACAGGTGG,0,1868286
hyuA_predicted,0.045454545454545456,21,21,GCCCGGGCAGGTTACGTTGT,0,1832326
hyuA_predicted,0.045454545454545456,21,21,GACTCTGAGTTACCGATCAA,0,1848730
hyuA_predicted,0.045454545454545456,21,21,GAACTGGTGGGTACGTGGAC,0,1851061
hyuA_predicted,0.045454545454545456,21,21,CTTGGTATACTTAAATAATC,0,1875489
hyuA_predicted,0.045454545454545456,21,21,CTTACAGATTCCAGCTATCA,0,1863225
hyuA_predicted,0.045454545454545456,21,21,CTGGTTTTGAATGATGTAGT,0,1842019
hyuA_predicted,0.045454545454545456,21,21,CTGCGGCACCCCGCAAGCCC,0,1864063
hyuA_predicted,0.045454545454545456,21,21,CTCCCAGGCCACGGGCTTAC,0,1844232
hyuA_predicted,0.045454545454545456,21,21,CGTTTTTCACTATCACTGAG,0,1838485
hyuA_predicted,0.045454545454545456,21,21,CGGATCGGCGGGGTTAAATT,0,1856326
hyuA_predicted,0.045454545454545456,21,21,CGCAATTGTGTAATTTGATT,0,1856131
hyuA_predicted,0.045454545454545456,21,21,CGAACAACGAGTCAGCGGGG,0,1864256
hyuA_predicted,0.045454545454545456,21,21,CAGTTTGTGCCGCCTAAGGG,0,1831815
hyuA_predicted,0.045454545454545456,21,21,AGTATACGGATTGTGAACGG,0,1867459
hyuA_predicted,0.045454545454545456,21,21,AGGGCGCAGTCGAGTTGCTG,0,1829124
hyuA_predicted,0.045454545454545456,21,21,AGCTTCATATACAACAGGTA,0,1841660
hyuA_predicted,0.045454545454545456,21,21,AGCATCTAGGTCCTTTAAGT,0,1855511
hyuA_predicted,0.045454545454545456,21,21,ACGCGGGCTGGATAAACCTT,0,1872099
hyuA_predicted,0.045454545454545456,21,21,AATCTAATTGAATGCGTAAC,0,1857392
hyuA_predicted,0.045454545454545456,21,21,AACTGTAGAACCGGTAGAAT,0,1835321
hyuA_predicted,0.045454545454545456,21,21,AAAGGTGGAGCTTAAGGGGT,0,1852666
hyuA_predicted,0.045454545454545456,21,21,AAAGAGATTATTAGGCTCGA,0,1863526
hyuA_predicted,0.045454545454545456,21,21,AAACTGGCGGACGTGTTACA,0,1848031
hyuA_predicted,0.045454545454545456,21,21,AAAAGGACAAAGACCCGCCG,0,1845330
hyuA_predicted,0.045454545454545456,21,21,AAAACCAGTTCATATAGCGT,0,1856948
hyuA_predicted,0.047619047619047616,20,20,TTTTAATTAGAGGCAAATAT,0,1870226
hyuA_predicted,0.047619047619047616,20,20,TTCCTTCGGTTCAGTTACAA,0,1862898
hyuA_predicted,0.047619047619047616,20,20,TTAGAAAGTGCGGGTGCCTA,0,1839560
hyuA_predicted,0.047619047619047616,20,20,TGTTACTACAGCTTATTATC,0,1859628
hyuA_predicted,0.047619047619047616,20,20,TGTAGTGTAGCACGGGATTG,0,1866524
hyuA_predicted,0.047619047619047616,20,20,TGACTTTCATGCACTGCGAA,0,1839063
hyuA_predicted,0.047619047619047616,20,20,TCTACGGATGAAATGAGCGT,0,1841302
hyuA_predicted,0.047619047619047616,20,20,TCTACAATCAAGCGCTGATG,0,1836840
hyuA_predicted,0.047619047619047616,20,20,TCCGATGCTACTACGATGTT,0,1845229
hyuA_predicted,0.047619047619047616,20,20,TCCCTTTTTTTAGGAGATCC,0,1850181
hyuA_predicted,0.047619047619047616,20,20,TCAACTGAATGGATTTAATT,0,1839348
hyuA_predicted,0.047619047619047616,20,20,TAGCGGGATATTAGGGGTTA,0,1849009
hyuA_predicted,0.047619047619047616,20,20,TACTAAGTCAATGTGATCAT,0,1860491
hyuA_predicted,0.047619047619047616,20,20,GTTTTACCAAAGCAATGAGG,0,1850223
hyuA_predicted,0.047619047619047616,20,20,GTCCGCACCTCGATGTAACG,0,1838047
hyuA_predicted,0.047619047619047616,20,20,GGTGGACGCCAGCACCAGTT,0,1872935
hyuA_predicted,0.047619047619047616,20,20,GGTCCACTCATAGGGTCCTC,0,1873844
hyuA_predicted,0.047619047619047616,20,20,GCCCGCACTAGAAGTTAGAC,0,1848123
hyuA_predicted,0.047619047619047616,20,20,GCATATCATACAGACTCGTC,0,1858262
hyuA_predicted,0.047619047619047616,20,20,GAGTTGGAGGGCTCTTATAC,0,1858076
hyuA_predicted,0.047619047619047616,20,20,GAATGACAGCTTGAGCTAAC,0,1875018
hyuA_predicted,0.047619047619047616,20,20,GAATGAATGGGGTGCAGCTC,0,1866718
hyuA_predicted,0.047619047619047616,20,20,GAACGTCTCAGGTAATTGTT,0,1848746
hyuA_predicted,0.047619047619047616,20,20,GAAAACCCAAGATTTGGGCT,0,1877400
hyuA_predicted,0.047619047619047616,20,20,CTATTGTAGTTGTTCATTTC,0,1853292
hyuA_predicted,0.047619047619047616,20,20,CTAGTAGATACCCAATTGTA,0,1873502
hyuA_predicted,0.047619047619047616,20,20,CTACTGATCCGATGGCGCCA,0,1841869
hyuA_predicted,0.047619047619047616,20,20,CGCGGCCAAACGCAAGGGGA,0,1873228
hyuA_predicted,0.047619047619047616,20,20,CGACGGACGTTAGGAAACAT,0,1839029
hyuA_predicted,0.047619047619047616,20,20,CGAATTGCTATTCGACTTTC,0,1843876
hyuA_predicted,0.047619047619047616,20,20,CCTCGAGGTTGCCCATACGT,0,1863886
hyuA_predicted,0.047619047619047616,20,20,CAGACCGCCTCACACCGCGA,0,1873455
hyuA_predicted,0.047619047619047616,20,20,CAATACGTATGGGTTTTTTC,0,1877014
hyuA_predicted,0.047619047619047616,20,20,ATTTACACTGGTATGAATAT,0,1840694
hyuA_predicted,0.047619047619047616,20,20,ATTACAGCATTAGAGATCTG,0,1864997
hyuA_predicted,0.047619047619047616,20,20,ATATGGCAGCTTCTGACGGA,0,1841647
hyuA_predicted,0.047619047619047616,20,20,ATATCTAGGTGTAGAACTTA,0,1869135
hyuA_predicted,0.047619047619047616,20,20,AGGTCAGTCGGCCAAACATG,0,1853878
hyuA_predicted,0.047619047619047616,20,20,AGATTGCTTAGTGTCCAGTG,0,1831055
hyuA_predicted,0.047619047619047616,20,20,ACAGAGAGGGGCGACTGCGT,0,1844525
hyuA_predicted,0.047619047619047616,20,20,AATTAGCAAGATTCGAGTGC,0,1868709
hyuA_predicted,0.047619047619047616,20,20,AAGGCCAGTATGGGAAAAGG,0,1851285
hyuA_predicted,0.047619047619047616,20,20,AACGTACCCACTGCGAAATT,0,1834790
hyuA_predicted,0.047619047619047616,20,20,AACGGCGCACAGTTGCAGGC,0,1831083
hyuA_predicted,0.047619047619047616,20,20,AAACAGTATTGGCTAGGCGT,0,1858665
hyuA_predicted,0.05,19,19,TTTCGATAATTCCTGGGTGA,0,1831115
hyuA_predicted,0.05,19,19,TTATATGTGATAGCGAATAT,0,1833568
hyuA_predicted,0.05,19,19,TTAGGCCATATAAAAGGGAT,0,1865846
hyuA_predicted,0.05,19,19,TTAAAGCTCGTAAGAGTTAT,0,1872718
hyuA_predicted,0.05,19,19,TGTATAGCGTCGGCGGAGGA,0,1851659
hyuA_predicted,0.05,19,19,TGGTCTCGATCGCTAGAAAA,0,1871790
hyuA_predicted,0.05,19,19,TGGTATATCGAGAGAGTCCG,0,1837593
hyuA_predicted,0.05,19,19,TGGGACAGTAGACTAGAATT,0,1872370
hyuA_predicted,0.05,19,19,TGGAGACTTTAGAACTGCGT,0,1868152
hyuA_predicted,0.05,19,19,TGCTGGGAACTCTTCTGCAT,0,1830616
hyuA_predicted,0.05,19,19,TCCACGACTTACCTAGAGGC,0,1837971
hyuA_predicted,0.05,19,19,TATTTGTCATGTTGCCACGG,0,1832875
hyuA_predicted,0.05,19,19,TACTATCCTGGCTGCGGGAG,0,1839250
hyuA_predicted,0.05,19,19,TAAGCGTGGGCTAGTATGGT,0,1867681
hyuA_predicted,0.05,19,19,TAACATGAAGGGCAGTCATT,0,1846545
hyuA_predicted,0.05,19,19,TAAATTGTCAAGGCAAAGGA,0,1843322
hyuA_predicted,0.05,19,19,GGTTTTCGGTGAGGCGCCCG,0,1853284
hyuA_predicted,0.05,19,19,GGATTGCGCCGGGCACGCGT,0,1865570
hyuA_predicted,0.05,19,19,GCTTTATATCGTTGGAGCTG,0,1871230
hyuA_predicted,0.05,19,19,GCGCATCTACGCATAGACCA,0,1863340
hyuA_predicted,0.05,19,19,GCGACTCATAATAACTTAAA,0,1872351
hyuA_predicted,0.05,19,19,GCCGGCGCAGGGCAGTTCAT,0,1842787
hyuA_predicted,0.05,19,19,GCCAATACCACTAATTTGCA,0,1848508
hyuA_predicted,0.05,19,19,GCATTAGGGGTTTGGCGCCA,0,1866269
hyuA_predicted,0.05,19,19,GAGGCTAACCAGATTACGTA,0,1852188
hyuA_predicted,0.05,19,19,GAGCCTGGTCTGGCATCATA,0,1839356
hyuA_predicted,0.05,19,19,GACGGCCGTGGTTTCGCATG,0,1862950
hyuA_predicted,0.05,19,19,GACCTTGTCTGCTGCGGGTC,0,1834613
hyuA_predicted,0.05,19,19,CTGTTTCACATGAAGAGTGG,0,1851854
hyuA_predicted,0.05,19,19,CGGCCGCTGTATTAATAGGC,0,1833183
hyuA_predicted,0.05,19,19,CCTTTATCACCATAAGAAAG,0,1844849
hyuA_predicted,0.05,19,19,CCTTATCAAGTATCATGTAT,0,1854225
hyuA_predicted,0.05,19,19,CCTGCTGCGCTTTGTAATGT,0,1876169
hyuA_predicted,0.05,19,19,CAACCCGTTCGGTGGCAGGA,0,1838566
hyuA_predicted,0.05,19,19,ATTGGGGTATCGTAGTAGCA,0,1833344
hyuA_predicted,0.05,19,19,ATTGATAGGCCACAATACTG,0,1858986
hyuA_predicted,0.05,19,19,ATTCCGCTTCCGTTGCCAAA,0,1867269
hyuA_predicted,0.05,19,19,ATTCACGCTGTGAGCAATAA,0,1851164
hyuA_predicted,0.05,19,19,AGGCGGTTACAATTATTTCT,0,1865416
hyuA_predicted,0.05,19,19,AGCCGGAAACTTCTCTACGA,0,1863341
hyuA_predicted,0.05,19,19,AGAGTATATTCCCCGTGGTT,0,1864127
hyuA_predicted,0.05,19,19,ACTTAGAGTGTAGGGGCAGG,0,1846164
hyuA_predicted,0.05,19,19,ACTACAAAGACAGGGCCAAC,0,1876876
hyuA_predicted,0.05,19,19,ACCATAGATGCCAGTTTGTG,0,1847902
hyuA_predicted,0.05,19,19,AATAAGTGGCTCCGTAGGTC,0,1829366
hyuA_predicted,0.05,19,19,AAGCAAGCTTCGTATGTAGC,0,1846683
hyuA_predicted,0.05,19,19,AACCCGACTGGAACACTCGT,0,1861858
hyuA_predicted,0.05263157894736842,18,18,TTTTATTACTTGTATGACTT,0,1864649
hyuA_predicted,0.05263157894736842,18,18,TTTTAATTACGGATTGCGAG,0,1844644
hyuA_predicted,0.05263157894736842,18,18,TTGAAACGCTTCACGCGACT,0,1845060
hyuA_predicted,0.05263157894736842,18,18,TTCTGATGGGGACGGTCAAC,0,1830343
hyuA_predicted,0.05263157894736842,18,18,TTATCTAATGACAGAAGAGG,0,1833210
hyuA_predicted,0.05263157894736842,18,18,TTAAGGGCGAGCGCAGCATA,0,1853826
hyuA_predicted,0.05263157894736842,18,18,TGGGTTATGGCGCATGCGCG,0,1830612
hyuA_predicted,0.05263157894736842,18,18,TGCCAACATACCGCGTCTAA,0,1842841
hyuA_predicted,0.05263157894736842,18,18,TCTGAAGCTCGGCATCTGGC,0,1868187
hyuA_predicted,0.05263157894736842,18,18,TCTATACTGTTCCCGACTCC,0,1839071
hyuA_predicted,0.05263157894736842,18,18,TCGCAAATCCTACAAAGTTT,0,1836372
hyuA_predicted,0.05263157894736842,18,18,TCCCAATTCGCCGTATATGG,0,1854059
hyuA_predicted,0.05263157894736842,18,18,TATCGTGGAAGCTATACAAA,0,1831253
hyuA_predicted,0.05263157894736842,18,18,TAGGAGTGGCAATGAGGAAG,0,1869136
hyuA_predicted,0.05263157894736842,18,18,TACGGACACTAGCACCTTGG,0,1872680
hyuA_predicted,0.05263157894736842,18,18,TACACTTCCGTTTCTGGAAC,0,1862638
hyuA_predicted,0.05263157894736842,18,18,TAAGCATCGAATGAGTATGT,0,1838327
hyuA_predicted,0.05263157894736842,18,18,TAAACGTCCCGGCATACCGT,0,1847254
hyuA_predicted,0.05263157894736842,18,18,GTGTCTCGCCATCCCTGTGT,0,1851097
hyuA_predicted,0.05263157894736842,18,18,GTCCGATCTAAAGTTTTTGA,0,1830934
hyuA_predicted,0.05263157894736842,18,18,GTAGTTTGAAATCCGGATTT,0,1870834
hyuA_predicted,0.05263157894736842,18,18,GTAGAATAGCACGTGGTGTG,0,1842883
hyuA_predicted,0.05263157894736842,18,18,GGTAGCCAGTAGCATATGCA,0,1851657
hyuA_predicted,0.05263157894736842,18,18,GGTAATTACTCGCCTACCGC,0,1868274
hyuA_predicted,0.05263157894736842,18,18,GGGCTTTTGTACCCAGTCAC,0,1854574
hyuA_predicted,0.05263157894736842,18,18,GGATGGAAAGATTTGGCATA,0,1866717
hyuA_predicted,0.05263157894736842,18,18,GCTGGCCCACCGGGATTCGC,0,1840849
hyuA_predicted,0.05263157894736842,18,18,GCGTTCACACTTAGAAAGCC,0,1864096
hyuA_predicted,0.05263157894736842,18,18,GCCAGGCTGATCAAAGCTAC,0,1864563
hyuA_predicted,0.05263157894736842,18,18,GCATGAAGTTCTCCCCAGGA,0,1861577
hyuA_predicted,0.05263157894736842,18,18,GACGTTTAGTGGGTGTAATG,0,1835110
hyuA_predicted,0.05263157894736842,18,18,GAACTGTTACAGTGTTTCTC,0,1874187
hyuA_predicted,0.05263157894736842,18,18,CTGGTTCTAAAGTTATAAAT,0,1840466
hyuA_predicted,0.05263157894736842,18,18,CTGCTGCGCGAGGCCTGTCA,0,1867301
hyuA_predicted,0.05263157894736842,18,18,CTATTCCGAACTCGCCGGAG,0,1841587
hyuA_predicted,0.05263157894736842,18,18,CTATGCGATCCTCAGTCACA,0,1868315
hyuA_predicted,0.05263157894736842,18,18,CTACTCAGGTATTGAGGTAG,0,1861238
hyuA_predicted,0.05263157894736842,18,18,CTACTAGAGGATTACGGTCC,0,1857844
hyuA_predicted,0.05263157894736842,18,18,CGCAAAGTGGTGGAAGCATG,0,1859094
hyuA_predicted,0.05263157894736842,18,18,CATTAGGAACTACAGACCCT,0,1840751
hyuA_predicted,0.05263157894736842,18,18,CATACGCGCGGCGGGAGGAA,0,1844768
hyuA_predicted,0.05263157894736842,18,18,CACCTCTGGGTTACGGATAT,0,1832662
hyuA_predicted,0.05263157894736842,18,18,CAATAAGGCTCAAAGGAAAG,0,1851137
hyuA_predicted,0.05263157894736842,18,18,ATTTATTTCAAAAACAGTTG,0,1856437
hyuA_predicted,0.05263157894736842,18,18,ATTGTCTATGGCAGAGCACA,0,1875378
hyuA_predicted,0.05263157894736842,18,18,AGTGGAGTTAAAACATGCTC,0,1850974
hyuA_predicted,0.05263157894736842,18,18,ACGGGGTTACAACCGGGGTG,0,1869218
hyuA_predicted,0.05263157894736842,18,18,AATCGATCAACGCTATGGAC,0,1856023
hyuA_predicted,0.05263157894736842,18,18,AAGTTTTCCTACTCCGCGTG,0,1847999
hyuA_predicted,0.05263157894736842,18,18,AACTGGGAGCGTGGATAGGT,0,1874633
hyuA_predicted,0.05263157894736842,18,18,AACTGGCGACGGGGAGAGGG,0,1837178
hyuA_predicted,0.05263157894736842,18,18,AACCTCCACAACAGTCTGCT,0,1876665
hyuA_predicted,0.05263157894736842,18,18,AACCTCAGTTGCTACAGCCA,0,1873016
hyuA_predicted,0.05263157894736842,18,18,AAACAGGATAGTTTTTGGCC,0,1830916
hyuA_predicted,0.05555555555555555,17,17,TTTGCACCATCTGGCCGTTC,0,1831509
hyuA_predicted,0.05555555555555555,17,17,TTTCGCGACCGCATAGCAAG,0,1860139
hyuA_predicted,0.05555555555555555,17,17,TTTAACGCAGGCGTACACCT,0,1843815
hyuA_predicted,0.05555555555555555,17,17,TTGCCCGGTGCACTACCTAC,0,1846972
hyuA_predicted,0.05555555555555555,17,17,TTCTTGTGGTGCCGGTGGCA,0,1860446
hyuA_predicted,0.05555555555555555,17,17,TTCTAGTTTCGAACAGCGTT,0,1831989
hyuA_predicted,0.05555555555555555,17,17,TTCGTCCCTTAGGCCCCTAA,0,1860349
hyuA_predicted,0.05555555555555555,17,17,TTCGGACGATGCAACAGAGG,0,1874650
hyuA_predicted,0.05555555555555555,17,17,TTCCACCATTGACTGGGAAA,0,1851416
hyuA_predicted,0.05555555555555555,17,17,TTATATCCTTTTGTGCCGAT,0,1854132
hyuA_predicted,0.05555555555555555,17,17,TTAGAGTATTAGGTTCACTG,0,1854385
hyuA_predicted,0.05555555555555555,17,17,TGTGCATCAGGAGGCATCCG,0,1831449
hyuA_predicted,0.05555555555555555,17,17,TGGGGCCAAGGTGACAGAGC,0,1850513
hyuA_predicted,0.05555555555555555,17,17,TGGCACCTAGATATCAACTT,0,1852132
hyuA_predicted,0.05555555555555555,17,17,TCTCGTTTTAGTGATCCTAG,0,1868272
hyuA_predicted,0.05555555555555555,17,17,TCTAAGTCAGCGTTAAAATA,0,1859675
hyuA_predicted,0.05555555555555555,17,17,TCGGTCCTTTCTATGAAATA,0,1849818
hyuA_predicted,0.05555555555555555,17,17,TATAGAGACGTTGAAGTGGT,0,1837306
hyuA_predicted,0.05555555555555555,17,17,TAATTCGGGGACGCACGAGT,0,1834330
hyuA_predicted,0.05555555555555555,17,17,TAATTCGGATTTTACTCCAC,0,1862543
hyuA_predicted,0.05555555555555555,17,17,GTTCACATATAGCACCGTGT,0,1852704
hyuA_predicted,0.05555555555555555,17,17,GTGTTAGCCACCGCCTAGTT,0,1852426
hyuA_predicted,0.05555555555555555,17,17,GTGATGCAGGGACCTCGCAA,0,1856742
hyuA_predicted,0.05555555555555555,17,17,GGGGCAACTGCTGGACGAGG,0,1868086
hyuA_predicted,0.05555555555555555,17,17,GGGGATTAATACACCTGCAT,0,1832372
hyuA_predicted,0.05555555555555555,17,17,GGGACTACAGACCTTCTAGT,0,1865015
hyuA_predicted,0.05555555555555555,17,17,GCGTATGGGCTCCCTGCATG,0,1861733
hyuA_predicted,0.05555555555555555,17,17,GCGGACTGGCATCTGCTAGG,0,1830377
hyuA_predicted,0.05555555555555555,17,17,GCGAATGTATGTCAAAGTAT,0,1849408
hyuA_predicted,0.05555555555555555,17,17,GCATCTCGGCTCATCGGCTC,0,1848612
hyuA_predicted,0.05555555555555555,17,17,GCAAACGGGAGCAACTTGAT,0,1856460
hyuA_predicted,0.05555555555555555,17,17,GATGGACAGGCAGGCGGCGC,0,1852327
hyuA_predicted,0.05555555555555555,17,17,GAGTGGTTTTCGGACACACT,0,1847525
hyuA_predicted,0.05555555555555555,17,17,CTTAGAAAGCCGTCGGAGAT,0,1847933
hyuA_predicted,0.05555555555555555,17,17,CTGTAAGGTAGCCGCTTTTG,0,1845166
hyuA_predicted,0.05555555555555555,17,17,CTGGCGTCCAACCTTGCCTA,0,1855185
hyuA_predicted,0.05555555555555555,17,17,CTGCGTGCAACCACAGATGG,0,1846165
hyuA_predicted,0.05555555555555555,17,17,CTGCGGTTAGTCGGGATCCA,0,1859694
hyuA_predicted,0.05555555555555555,17,17,CTATTTACCTCCGTGGTGAA,0,1830284
hyuA_predicted,0.05555555555555555,17,17,CTATCGCGGCCACGGGTCCT,0,1849078
hyuA_predicted,0.05555555555555555,17,17,CGCTAATTTGGCGCTGTAAA,0,1864311
hyuA_predicted,0.05555555555555555,17,17,CGACGTCTAATTTATTTGAG,0,1868696
hyuA_predicted,0.05555555555555555,17,17,CCTGGTTACAGGTTTCTGTA,0,1845959
hyuA_predicted,0.05555555555555555,17,17,CCTCTACATGGTTGTGCAAA,0,1875341
hyuA_predicted,0.05555555555555555,17,17,CCGGCCTAGGTCAAAGCAGG,0,1831307
hyuA_predicted,0.05555555555555555,17,17,CATTTGCACCTTGATGTAAC,0,1849819
hyuA_predicted,0.05555555555555555,17,17,CAGTCCCAGTTTGTTTAAGT,0,1876971
hyuA_predicted,0.05555555555555555,17,17,CAGCGCGCGCGAAGTTTTTG,0,1874849
hyuA_predicted,0.05555555555555555,17,17,CAACACGCGGACCCAAAATA,0,1870252
hyuA_predicted,0.05555555555555555,17,17,ATTATACAGTAGACGTGGGT,0,1835569
hyuA_predicted,0.05555555555555555,17,17,ATGCGCGGTCACGTTATGTA,0,1876935
hyuA_predicted,0.05555555555555555,17,17,ATGCAAATTTGCGTGGGACA,0,1849250
hyuA_predicted,0.05555555555555555,17,17,AGTTAACTCCATAGGCGACT,0,1833722
hyuA_predicted,0.05555555555555555,17,17,AGGACGGCGCTGTATAAACT,0,1842196
hyuA_predicted,0.05555555555555555,17,17,AGCGCGGTTAGCGGAGGTCG,0,1863879
hyuA_predicted,0.05555555555555555,17,17,AGAGGCGGTAGACAGGGGGT,0,1853726
hyuA_predicted,0.05555555555555555,17,17,ACTTCATTCCGCAATATGTA,0,1860651
hyuA_predicted,0.05555555555555555,17,17,ACTATGAGCCAATTACCCCA,0,1852308
hyuA_predicted,0.05555555555555555,17,17,ACTATAAAGAATCCGTACGT,0,1853084
hyuA_predicted,0.05555555555555555,17,17,ACCATAGTCAACTCGCCTCG,0,1846098
hyuA_predicted,0.05555555555555555,17,17,AATCTGCGGTCGGTAGTAAG,0,1830873
hyuA_predicted,0.05555555555555555,17,17,AATCCTCGGTAAGCATCAAG,0,1853498
hyuA_predicted,0.05555555555555555,17,17,AATACTTCATGTCAGACGGG,0,1848297
hyuA_predicted,0.05555555555555555,17,17,AAAGGGTGAACATGTTAGAC,0,1856984
hyuA_predicted,0.058823529411764705,16,16,TTTGTTTTTTGACGCAGGGG,0,1853609
hyuA_predicted,0.058823529411764705,16,16,TTTCAAGTGAGGTTCTCGCG,0,1867041
hyuA_predicted,0.058823529411764705,16,16,TTGTGGATGGGGGGTGCGTT,0,1853366
hyuA_predicted,0.058823529411764705,16,16,TTGGGCGAATACACAAAGAG,0,1869525
hyuA_predicted,0.058823529411764705,16,16,TTCTGCGGAGATAGATTGGT,0,1845092
hyuA_predicted,0.058823529411764705,16,16,TTCTCATTGCGACTATTTGG,0,1857681
hyuA_predicted,0.058823529411764705,16,16,TTCCACCACCGAGCATGAAG,0,1856870
hyuA_predicted,0.058823529411764705,16,16,TTATCCCATAATTTGTTGGT,0,1838782
hyuA_predicted,0.058823529411764705,16,16,TGTCATTTGACACCACGCGT,0,1859700
hyuA_predicted,0.058823529411764705,16,16,TGGTAATGAATGCCATCTGG,0,1873774
hyuA_predicted,0.058823529411764705,16,16,TGGTAAGAGTACTTCATCAA,0,1846048
hyuA_predicted,0.058823529411764705,16,16,TGGCTGTGACACGTCGCTCT,0,1857606
hyuA_predicted,0.058823529411764705,16,16,TGCTAGACCCAGCCGAAATA,0,1852570
hyuA_predicted,0.058823529411764705,16,16,TGCGAATGGGATAGTCGGAA,0,1877517
hyuA_predicted,0.058823529411764705,16,16,TGCCGTTCTTACACCATTGC,0,1838903
hyuA_predicted,0.058823529411764705,16,16,TGATTATTGTATTACCACGG,0,1833639
hyuA_predicted,0.058823529411764705,16,16,TCTCAGGGTACAGAGATGCA,0,1830648
hyuA_predicted,0.058823529411764705,16,16,TCTAACCTCGCCAATATCGC,0,1851363
hyuA_predicted,0.058823529411764705,16,16,TCGGGTGTCACGGGCCACAG,0,1847677
hyuA_predicted,0.058823529411764705,16,16,TCCTGGGATAAGGTTAGCGT,0,1852396
hyuA_predicted,0.058823529411764705,16,16,TAGGGGGCCGTCACGTGGCG,0,1835561
hyuA_predicted,0.058823529411764705,16,16,TAGGGACAGGATACACTTTT,0,1873233
hyuA_predicted,0.058823529411764705,16,16,TACGCCAGGGTAATTGACAG,0,1874528
hyuA_predicted,0.058823529411764705,16,16,TAACATTTAAACGAGAACGG,0,1829983
hyuA_predicted,0.058823529411764705,16,16,GTTTTAAAGCTTACCGGCTC,0,1860002
hyuA_predicted,0.058823529411764705,16,16,GTGTCCGGTGCCGAGGCAAG,0,1868935
hyuA_predicted,0.058823529411764705,16,16,GTGACGGTCATCTTGACAGC,0,1866689
hyuA_predicted,0.058823529411764705,16,16,GTAACCCGTGTATAAGCAAA,0,1860351
hyuA_predicted,0.058823529411764705,16,16,GGTGCCTCGGATATCATGCT,0,1833005
hyuA_predicted,0.058823529411764705,16,16,GGGTCAAAGACTGTCAGGAG,0,1831849
hyuA_predicted,0.058823529411764705,16,16,GGGATTATTCGCCACGTTGA,0,1836273
hyuA_predicted,0.058823529411764705,16,16,GGGATGCGTGTCAGCGAGTG,0,1871454
hyuA_predicted,0.058823529411764705,16,16,GGCTACGGACAAAATAAGAA,0,1855058
hyuA_predicted,0.058823529411764705,16,16,GGCAGCTACATTTCATTGTT,0,1872736
hyuA_predicted,0.058823529411764705,16,16,GGACGTTCGTCCGTTATCAC,0,1856058
hyuA_predicted,0.058823529411764705,16,16,GGACGTCCAGGACTCCGGGA,0,1870861
hyuA_predicted,0.058823529411764705,16,16,GCGGTGCCAAAAAACATCGG,0,1876532
hyuA_predicted,0.058823529411764705,16,16,GCCTGCACACGGGTACGTAT,0,1866551
hyuA_predicted,0.058823529411764705,16,16,GCAGGAGGGAACATTATTTG,0,1875884
hyuA_predicted,0.058823529411764705,16,16,GATTAGAGTAAACCTTCGTG,0,1828997
hyuA_predicted,0.058823529411764705,16,16,GATGTGGACACGCTTGTTTT,0,1866521
hyuA_predicted,0.058823529411764705,16,16,GAGTTAATTCTTTCAGAAAA,0,1861646
hyuA_predicted,0.058823529411764705,16,16,GAGGTGCAAAAGAGTTCTGT,0,1869416
hyuA_predicted,0.058823529411764705,16,16,GAGGCAGTACGAATTAAGAG,0,1869217
hyuA_predicted,0.058823529411764705,16,16,GACTGGCACTCGGAGTAGCT,0,1832528
hyuA_predicted,0.058823529411764705,16,16,GACCACTTGGAACTGTTGTT,0,1858222
hyuA_predicted,0.058823529411764705,16,16,GAACCAGTCGGGACGGCACT,0,1829402
hyuA_predicted,0.058823529411764705,16,16,CTGGACCCGTGTACGGTAGG,0,1875927
hyuA_predicted,0.058823529411764705,16,16,CTGATTAACCCTGCGCGGCC,0,1845356
hyuA_predicted,0.058823529411764705,16,16,CTGACGGCTAGTCCCAAAGT,0,1842766
hyuA_predicted,0.058823529411764705,16,16,CTAGCCGTAGGTTTAAAAGC,0,1863245
hyuA_predicted,0.058823529411764705,16,16,CGTAACGGACGGAAATCATC,0,1863082
hyuA_predicted,0.058823529411764705,16,16,CGGTCTTCATTTGAAGGGAT,0,1846059
hyuA_predicted,0.058823529411764705,16,16,CGGCCTAGGACTCTGGAAAT,0,1852673
hyuA_predicted,0.058823529411764705,16,16,CGACCAGCCCGTAAGTCTGT,0,1832076
hyuA_predicted,0.058823529411764705,16,16,CGAAAAATGGGTGACTTAAA,0,1867462
hyuA_predicted,0.058823529411764705,16,16,CCGGTGCTAACCAAAACGTT,0,1874987
hyuA_predicted,0.058823529411764705,16,16,CCGATTGGGACATCCGCCAT,0,1845223
hyuA_predicted,0.058823529411764705,16,16,CCGATACGGCGGTAGCTTAA,0,1864728
hyuA_predicted,0.058823529411764705,16,16,CCCGCATCCGCAATGGACGT,0,1847321
hyuA_predicted,0.058823529411764705,16,16,CCCCTCGGCGGAAGCTAGAT,0,1833396
hyuA_predicted,0.058823529411764705,16,16,CCAGTTTGTTTGTGAGCTTA,0,1842504
hyuA_predicted,0.058823529411764705,16,16,CCACTTACGAGTGTCGCACT,0,1874609
hyuA_predicted,0.058823529411764705,16,16,CCAAACGCTAGTACCTCGAA,0,1830344
hyuA_predicted,0.058823529411764705,16,16,ATTTGGTCGTGTTCGCTCAC,0,1859990
hyuA_predicted,0.058823529411764705,16,16,ATTCAGTCGGTACTCGTTAT,0,1837454
hyuA_predicted,0.058823529411764705,16,16,ATTAGTTTTCCAGGTGTTGT,0,1855161
hyuA_predicted,0.058823529411764705,16,16,ATGAAAGCCGCACCGTTGAT,0,1832196
hyuA_predicted,0.058823529411764705,16,16,ATCACGATACGGTGGGTTGC,0,1841427
hyuA_predicted,0.058823529411764705,16,16,ATAATCGCGCGCGGGAGTCT,0,1872508
hyuA_predicted,0.058823529411764705,16,16,AGTTGCTGCCACGCGGTGCC,0,1849479
hyuA_predicted,0.058823529411764705,16,16,AGTCGCCCACATTTGGTCTT,0,1860500
hyuA_predicted,0.058823529411764705,16,16,AGGTCAGGATTCCCGGCTGA,0,1863788
hyuA_predicted,0.058823529411764705,16,16,AGGACGCAGGGACCTTCGCC,0,1833276
hyuA_predicted,0.058823529411764705,16,16,AGGACCGATGTAAGGCCACG,0,1863442
hyuA_predicted,0.058823529411764705,16,16,AGCTCGGGGGTTAATTCGGT,0,1861235
hyuA_predicted,0.058823529411764705,16,16,AGCGCGGCGCTGTGAGTTTT,0,1833858
hyuA_predicted,0.058823529411764705,16,16,AGATCGATGGAACGGGGATG,0,1853295
hyuA_predicted,0.058823529411764705,16,16,AGAGGATAGATGTGGCGGAA,0,1875964
hyuA_predicted,0.058823529411764705,16,16,ACTGCTCCGCCCACAGCGAT,0,1866245
hyuA_predicted,0.058823529411764705,16,16,ACTCGCCCACGGCTCCTAAA,0,1832628
hyuA_predicted,0.058823529411764705,16,16,ACTCATAGAGTGGTCGTGAA,0,1859226
hyuA_predicted,0.058823529411764705,16,16,ACGGGGTAAAGCTGCCGAGT,0,1849010
hyuA_predicted,0.058823529411764705,16,16,ACAGTTCGGTTGCTACACGA,0,1830470
hyuA_predicted,0.058823529411764705,16,16,AATCAAGCCTCCTGCGTCCA,0,1843875
hyuA_predicted,0.058823529411764705,16,16,AAGGGCGACGACTTTGCCGG,0,1833074
hyuA_predicted,0.058823529411764705,16,16,AAAGCGGTGTTGGGCGACAT,0,1875209
hyuA_predicted,0.0625,15,15,TTTTTACGGGATCGTCGGAA,0,1833403
hyuA_predicted,0.0625,15,15,TTGCAGGGGAAAGTTGCTAA,0,1833813
hyuA_predicted,0.0625,15,15,TTATTCTCGAAAGTCAGAAT,0,1830041
hyuA_predicted,0.0625,15,15,TTAGTCACTGGAGGAAAGAG,0,1857364
hyuA_predicted,0.0625,15,15,TTAAGTACGATCTCCAGTTG,0,1830609
hyuA_predicted,0.0625,15,15,TTAACAATCTGCTCCAGTCA,0,1853959
hyuA_predicted,0.0625,15,15,TGGGTACGAGGTAAGCCGGT,0,1852710
hyuA_predicted,0.0625,15,15,TGGACAGCGTCTTCGAGTCT,0,1848003
hyuA_predicted,0.0625,15,15,TGAAACCGCTCACCCTGTTC,0,1832573
hyuA_predicted,0.0625,15,15,TCTTGTATCGTACAAGGTAA,0,1853080
hyuA_predicted,0.0625,15,15,TCGGGCAGTTCGCCTGTTAT,0,1857145
hyuA_predicted,0.0625,15,15,TCCGTAGTTGTTGTTTATTT,0,1868733
hyuA_predicted,0.0625,15,15,TCAGGTTTAAGCACGTCGCA,0,1841402
hyuA_predicted,0.0625,15,15,TCACCGGGTCGGTTGAGGAG,0,1859217
hyuA_predicted,0.0625,15,15,TAGATGTCGCACAACGCGAA,0,1874465
hyuA_predicted,0.0625,15,15,TAGACGAAGCTCTCTAGCGT,0,1873571
hyuA_predicted,0.0625,15,15,TACAGGATAAGTACTGCGGT,0,1847347
hyuA_predicted,0.0625,15,15,TACAATCGGTAATGTGTAAC,0,1863964
hyuA_predicted,0.0625,15,15,TAAGAGACGATCGGAGCCCT,0,1840901
hyuA_predicted,0.0625,15,15,GTTGTTCAATATTCTACTTT,0,1867136
hyuA_predicted,0.0625,15,15,GTTGTCGGGTCCTAAACTAT,0,1836105
hyuA_predicted,0.0625,15,15,GTTGGCACTGGCGCTTCAGG,0,1859375
hyuA_predicted,0.0625,15,15,GTTCCTTTTTGAAGCTCTAG,0,1854010
hyuA_predicted,0.0625,15,15,GTGGGATTCTCACCAGCTTC,0,1848253
hyuA_predicted,0.0625,15,15,GTGATTGGGGGTCGCGGGGA,0,1835284
hyuA_predicted,0.0625,15,15,GTATAACGCAGCGTGATCAT,0,1851162
hyuA_predicted,0.0625,15,15,GTAGATCGTAGCATACCTGC,0,1867003
hyuA_predicted,0.0625,15,15,GGTTATCGAGAGCGTGCTTG,0,1835795
hyuA_predicted,0.0625,15,15,GGTTAAGCGCCAGGAGGCAA,0,1842728
hyuA_predicted,0.0625,15,15,GGTAACCTCGAAGCTACCGC,0,1849340
hyuA_predicted,0.0625,15,15,GGCCCCCCGGGGAACACGAA,0,1839392
hyuA_predicted,0.0625,15,15,GGAGAAGCCACACGGCTCAG,0,1851153
hyuA_predicted,0.0625,15,15,GGACCGAGCAATAGAGCCGG,0,1832537
hyuA_predicted,0.0625,15,15,GGAACGTCTAGGCGCACGTT,0,1834824
hyuA_predicted,0.0625,15,15,GCTTTGCACACACCTACGAT,0,1876454
hyuA_predicted,0.0625,15,15,GCGTCCGTCCAGGACCGGTG,0,1847560
hyuA_predicted,0.0625,15,15,GCGACGTTGATGGGGCCCTG,0,1850040
hyuA_predicted,0.0625,15,15,GCCAGTCCGACTCTGAAACA,0,1876698
hyuA_predicted,0.0625,15,15,GCCAGTCAACGATAGGAACT,0,1852554
hyuA_predicted,0.0625,15,15,GCAGTTCATTTATACTGAAT,0,1875206
hyuA_predicted,0.0625,15,15,GCACGCTCCATCACGCTGAA,0,1854770
hyuA_predicted,0.0625,15,15,GATCCTAGTAACGGCTAAGG,0,1829768
hyuA_predicted,0.0625,15,15,GATCCACTTTACAGGCCGTG,0,1862627
hyuA_predicted,0.0625,15,15,GAGTGCTCTTTTTGTCAGCG,0,1843996
hyuA_predicted,0.0625,15,15,GAGTAAATCGCTCGGGCTAG,0,1841684
hyuA_predicted,0.0625,15,15,GAGGCAGCCCTCCTGTGCCC,0,1838194
hyuA_predicted,0.0625,15,15,GAGCGACGACGGTTACGAAG,0,1874904
hyuA_predicted,0.0625,15,15,GAGACAGCTCCTGGAATGAA,0,1868470
hyuA_predicted,0.0625,15,15,GACGTTACATGGGTTGCTTG,0,1874276
hyuA_predicted,0.0625,15,15,GACGCCTCGGCATGGCCCGG,0,1852038
hyuA_predicted,0.0625,15,15,GACCAGCTTAGGCGGGCAAA,0,1846917
hyuA_predicted,0.0625,15,15,CTTGTCGTGTATTGCGGGAA,0,1848041
hyuA_predicted,0.0625,15,15,CTTAGTATGTAGTGGGTAAT,0,1854041
hyuA_predicted,0.0625,15,15,CTGGGCGAAAATGCTCAATA,0,1841929
hyuA_predicted,0.0625,15,15,CTGCGGCAGGATCTACAGTA,0,1868507
hyuA_predicted,0.0625,15,15,CTGCCGTTGGACGTCTGCGG,0,1844425
hyuA_predicted,0.0625,15,15,CTCAGAACCAAACAATAGGG,0,1854870
hyuA_predicted,0.0625,15,15,CTATGTCTAAGATACGTGGA,0,1836243
hyuA_predicted,0.0625,15,15,CTACTCGACCCATTGAATTC,0,1852997
hyuA_predicted,0.0625,15,15,CTACGGCACACAGGTAGGGA,0,1867638
hyuA_predicted,0.0625,15,15,CGTTGGCAGCACGGGAGGTA,0,1869650
hyuA_predicted,0.0625,15,15,CGTGTAGGGCAGGCCGATGA,0,1851655
hyuA_predicted,0.0625,15,15,CGTGCATCGGCATAACGCTG,0,1871258
hyuA_predicted,0.0625,15,15,CGGTCGATACGCCTCTGTAA,0,1848727
hyuA_predicted,0.0625,15,15,CGGGCTCAGTGCCGGCTTGT,0,1840376
hyuA_predicted,0.0625,15,15,CGGGACTCGATGTCTTTGAG,0,1836923
hyuA_predicted,0.0625,15,15,CGGACGCTGTCCACACGATT,0,1835863
hyuA_predicted,0.0625,15,15,CCTTTCTTACTAGAGATCCC,0,1830541
hyuA_predicted,0.0625,15,15,CCTTCACTTGCTCACCGGAG,0,1875980
hyuA_predicted,0.0625,15,15,CCCCCAAATCCATTGGCTAT,0,1845886
hyuA_predicted,0.0625,15,15,CCACCGTTTGGGAGAGCCAT,0,1839030
hyuA_predicted,0.0625,15,15,CACAACCGAGTACATTTTGC,0,1833187
hyuA_predicted,0.0625,15,15,ATTAGCACCTTGGACGACGT,0,1839840
hyuA_predicted,0.0625,15,15,ATGGTTGTCTCGTGTGATTA,0,1869165
hyuA_predicted,0.0625,15,15,ATCGTTGGTAGACAGGTAAT,0,1841874
hyuA_predicted,0.0625,15,15,ATCGCGACCCGCCGAAATAG,0,1851163
hyuA_predicted,0.0625,15,15,ATCCGGCACTCATCTGGGCA,0,1858309
hyuA_predicted,0.0625,15,15,ATCCGATTTTGGGCTCTTTT,0,1838889
hyuA_predicted,0.0625,15,15,AGTTGTTTCAGAACACAATG,0,1841367
hyuA_predicted,0.0625,15,15,AGGTTTCCATCTTTGCGCGA,0,1870044
hyuA_predicted,0.0625,15,15,AGGTTTCAAACAGTCGAGTA,0,1870050
hyuA_predicted,0.0625,15,15,AGGTTAGTTGACGCTGGTGA,0,1866478
hyuA_predicted,0.0625,15,15,AGGCTGATTTTTAGGACCAG,0,1873632
hyuA_predicted,0.0625,15,15,AGGCAAACGCTCGTGTAGGG,0,1829950
hyuA_predicted,0.0625,15,15,AGGAATGTACTGAATCGTTC,0,1840739
hyuA_predicted,0.0625,15,15,AGGAACGGTGGTTATCCATC,0,1832316
hyuA_predicted,0.0625,15,15,AGCAAGTTTTATATAAGTGT,0,1860497
hyuA_predicted,0.0625,15,15,AGATTGGGGTTTCTTTTGAT,0,1870101
hyuA_predicted,0.0625,15,15,AGACCTCTGATAGGCAAACA,0,1855438
hyuA_predicted,0.0625,15,15,ACTTCTGGGCGCATGTGACC,0,1833098
hyuA_predicted,0.0625,15,15,ACTGAGCTGGGTTAATCAGC,0,1871139
hyuA_predicted,0.0625,15,15,ACGCTGTAGGAACGAACAGA,0,1859468
hyuA_predicted,0.0625,15,15,ACGCCACTCAGGGTTGCGCA,0,1841773
hyuA_predicted,0.0625,15,15,ACCCTGGATACAAAGCGTCG,0,1849201
hyuA_predicted,0.0625,15,15,ACAGGCGGAACGTTAACACA,0,1840995
hyuA_predicted,0.0625,15,15,ACAGGAGGACAGTGAGTTTG,0,1835784
hyuA_predicted,0.0625,15,15,ACACTCCCTGGGAAAAGAAT,0,1862163
hyuA_predicted,0.0625,15,15,AATGTTAGAGCAACCTTGGT,0,1833168
hyuA_predicted,0.0625,15,15,AATCGCGCCTGATTCTAGCA,0,1842840
hyuA_predicted,0.0625,15,15,AATCCCGATGTATGAGGTCA,0,1840273
hyuA_predicted,0.0625,15,15,AATCAGAATAAAACGGACAA,0,1833019
hyuA_predicted,0.0625,15,15,AAGTCGGGAATCGTAAATAG,0,1871026
hyuA_predicted,0.0625,15,15,AAGACTCCTCTTTGCTAGGA,0,1854908
hyuA_predicted,0.0625,15,15,AACGAACTGATGCGTGTCAG,0,1830360
hyuA_predicted,0.0625,15,15,AAAAAGCTACCTGGGTGCGT,0,1855713
hyuA_predicted,0.06666666666666667,14,14,TTTTCCGTACGGGCAGAGGA,0,1850460
hyuA_predicted,0.06666666666666667,14,14,TTTAGCATATATGCTGAACT,0,1845947
hyuA_predicted,0.06666666666666667,14,14,TTGTCAGCTGGACGCAATCG,0,1867010
hyuA_predicted,0.06666666666666667,14,14,TTGGGCGGGGCACCCTGAAG,0,1872977
hyuA_predicted,0.06666666666666667,14,14,TTCCAAGCCCCGAGTGGGTA,0,1847507
hyuA_predicted,0.06666666666666667,14,14,TTATGGAGTTTCGTTTGGAA,0,1835742
hyuA_predicted,0.06666666666666667,14,14,TTACGTCTAGAGGCTCGCAA,0,1853736
hyuA_predicted,0.06666666666666667,14,14,TGGTCGGCAGGTCAAAATGT,0,1835883
hyuA_predicted,0.06666666666666667,14,14,TGGGCGAGACGTGTGGCGTT,0,1839454
hyuA_predicted,0.06666666666666667,14,14,TGGGCAGTTCCAATTTTTAG,0,1829832
hyuA_predicted,0.06666666666666667,14,14,TGGAAGGATAGGTTCAGGAT,0,1873315
hyuA_predicted,0.06666666666666667,14,14,TGCAACGCCCAGTTTGCGAC,0,1848227
hyuA_predicted,0.06666666666666667,14,14,TGAGCCTTGCGCATAACGAA,0,1858836
hyuA_predicted,0.06666666666666667,14,14,TGAGAGCAGTTAGCGCTAGA,0,1845839
hyuA_predicted,0.06666666666666667,14,14,TCTGCCAACACTCGGGTCGG,0,1831458
hyuA_predicted,0.06666666666666667,14,14,TCTGATTAGCTTAATGAGGT,0,1862542
hyuA_predicted,0.06666666666666667,14,14,TCTCTAAGGTATTTCGTACA,0,1874629
hyuA_predicted,0.06666666666666667,14,14,TCGCTGTATGGTCCCTCTGA,0,1847871
hyuA_predicted,0.06666666666666667,14,14,TCGACCACTCAATTCAAGCT,0,1833484
hyuA_predicted,0.06666666666666667,14,14,TCCTCCTCAGACGAAGTTGC,0,1849662
hyuA_predicted,0.06666666666666667,14,14,TCCTAGCCACTAATCCTAAT,0,1871941
hyuA_predicted,0.06666666666666667,14,14,TCCGGCCCTTAGCATGTCAT,0,1837091
hyuA_predicted,0.06666666666666667,14,14,TCCGCATAGGAGGCATATTG,0,1831011
hyuA_predicted,0.06666666666666667,14,14,TCCGAAGGGGAAGGCTCGTG,0,1870066
hyuA_predicted,0.06666666666666667,14,14,TCAGTTGCGCGTCCTGAAGC,0,1850103
hyuA_predicted,0.06666666666666667,14,14,TCACAGTTGGTCGGGGAATG,0,1865325
hyuA_predicted,0.06666666666666667,14,14,TCAAGGCGTGCGTTCGAAAT,0,1838270
hyuA_predicted,0.06666666666666667,14,14,TATTCATATGCGTTAACGAG,0,1831040
hyuA_predicted,0.06666666666666667,14,14,TAGGATCTTTTGGGAGACTG,0,1846041
hyuA_predicted,0.06666666666666667,14,14,TAGAGCAGGGGAGCTCAATG,0,1859491
hyuA_predicted,0.06666666666666667,14,14,TAGACTTCTAGTGGCCGCGT,0,1848970
hyuA_predicted,0.06666666666666667,14,14,TACGCGGGTGAATTCTAGAG,0,1845758
hyuA_predicted,0.06666666666666667,14,14,TAAACTAGACGGCAGGTCAA,0,1834678
hyuA_predicted,0.06666666666666667,14,14,GTGGCTGGAGACAATGACTT,0,1851420
hyuA_predicted,0.06666666666666667,14,14,GTGGCGCCCCCCGCGTTAGA,0,1852337
hyuA_predicted,0.06666666666666667,14,14,GTGCGTGGATGATACTTCCT,0,1863154
hyuA_predicted,0.06666666666666667,14,14,GTCCCTCAAGCCCAGCAAGG,0,1837219
hyuA_predicted,0.06666666666666667,14,14,GTCAGTGAGCCGCCAGTGTA,0,1846450
hyuA_predicted,0.06666666666666667,14,14,GTACCGCAGGGGGTCAGTGG,0,1840964
hyuA_predicted,0.06666666666666667,14,14,GTAACTTTATTTGCTCGATC,0,1846127
hyuA_predicted,0.06666666666666667,14,14,GGTCCTGCGTCCCGCGGATA,0,1844447
hyuA_predicted,0.06666666666666667,14,14,GGTATTTGTGTCCTCAGGAA,0,1860241
hyuA_predicted,0.06666666666666667,14,14,GGGTGATCGGCCTGATAGTT,0,1834425
hyuA_predicted,0.06666666666666667,14,14,GGGTAGGCTCCTGAGGTCGT,0,1863661
hyuA_predicted,0.06666666666666667,14,14,GGGGACTGGGTACGTTACCT,0,1847724
hyuA_predicted,0.06666666666666667,14,14,GGGCTCTTAGGATTCGTCAC,0,1873347
hyuA_predicted,0.06666666666666667,14,14,GGCTGAAGTGGAGTATGCCA,0,1855302
hyuA_predicted,0.06666666666666667,14,14,GGCTATAACTTCCGACAGAA,0,1834181
hyuA_predicted,0.06666666666666667,14,14,GGCAGCACTAAGAGGCACTG,0,1876656
hyuA_predicted,0.06666666666666667,14,14,GGCACGGATAGTATCACGAG,0,1850134
hyuA_predicted,0.06666666666666667,14,14,GGCAATAGGAGTGGTGTATC,0,1837093
hyuA_predicted,0.06666666666666667,14,14,GGCAAGCTAGTGGAGGTGCT,0,1864209
hyuA_predicted,0.06666666666666667,14,14,GGATAACCGTCAAGCGGGGA,0,1877338
hyuA_predicted,0.06666666666666667,14,14,GGAACGATGGGGTATGATGG,0,1833438
hyuA_predicted,0.06666666666666667,14,14,GCTCCGTGGATTTCTATGTG,0,1872445
hyuA_predicted,0.06666666666666667,14,14,GCTCACAGGTTGCAATCAGC,0,1838016
hyuA_predicted,0.06666666666666667,14,14,GCTCAAGGTAGTGGGTTTTC,0,1877791
hyuA_predicted,0.06666666666666667,14,14,GCTATTTATTCGGATGGCGG,0,1862909
hyuA_predicted,0.06666666666666667,14,14,GCGTGTAAGCTGCCAATCGG,0,1877384
hyuA_predicted,0.06666666666666667,14,14,GCGTCACCGCATCTTCAGCA,0,1853211
hyuA_predicted,0.06666666666666667,14,14,GCGCTGAGCAAAACGCTCTC,0,1846601
hyuA_predicted,0.06666666666666667,14,14,GCGACGCAATCCGGTGGTCG,0,1863593
hyuA_predicted,0.06666666666666667,14,14,GCCTAGTCAGTCCGTATTCC,0,1856941
hyuA_predicted,0.06666666666666667,14,14,GCCGCAACTCCTGAATAAGA,0,1859356
hyuA_predicted,0.06666666666666667,14,14,GCATTACGCCTCTATCAGTA,0,1859673
hyuA_predicted,0.06666666666666667,14,14,GCAGGGCAACAGGGCTAGAT,0,1839646
hyuA_predicted,0.06666666666666667,14,14,GATTAGGTGCAACGGCGTAA,0,1830373
hyuA_predicted,0.06666666666666667,14,14,GATGGCGGGAGAATTGGTCG,0,1846299
hyuA_predicted,0.06666666666666667,14,14,GATAGGACCAGTAATGTTTG,0,1829877
hyuA_predicted,0.06666666666666667,14,14,GAGTCTGTGGGATACTCTGC,0,1844468
hyuA_predicted,0.06666666666666667,14,14,GAGGTTCGAGCTTCGCTCCG,0,1857210
hyuA_predicted,0.06666666666666667,14,14,GAGACGACCGGGTGACGATG,0,1842510
hyuA_predicted,0.06666666666666667,14,14,GAGACCATACAGACCCAATA,0,1872101
hyuA_predicted,0.06666666666666667,14,14,GACGGATGGCCATAACTACA,0,1849300
hyuA_predicted,0.06666666666666667,14,14,GACATAGTACCGTCAACCGA,0,1858543
hyuA_predicted,0.06666666666666667,14,14,CTGTGCACGCGAAAAGTTTC,0,1855127
hyuA_predicted,0.06666666666666667,14,14,CTGGGCGGTTTGGCGACGAC,0,1858824
hyuA_predicted,0.06666666666666667,14,14,CTATGTGTTTGGTAGCCCAT,0,1832736
hyuA_predicted,0.06666666666666667,14,14,CTATCGGCTTCCGACCACGG,0,1865353
hyuA_predicted,0.06666666666666667,14,14,CTATATACAGTGCTAGGTTC,0,1854572
hyuA_predicted,0.06666666666666667,14,14,CTAGGCCGGGGACCGGTCAT,0,1850227
hyuA_predicted,0.06666666666666667,14,14,CTAGCCACGAATCAGCATCT,0,1861501
hyuA_predicted,0.06666666666666667,14,14,CGTTCCATTACGGTTCTTAA,0,1830948
hyuA_predicted,0.06666666666666667,14,14,CGTATTCATTCTCCAGTCGG,0,1865500
hyuA_predicted,0.06666666666666667,14,14,CGTAGGCCGAAGTATGTAAC,0,1836772
hyuA_predicted,0.06666666666666667,14,14,CGGGTGTACCTTCCAAGGCT,0,1867979
hyuA_predicted,0.06666666666666667,14,14,CGGCTCATAATCGTGTAAGG,0,1833164
hyuA_predicted,0.06666666666666667,14,14,CGGATGTTCGGAGCGGAATA,0,1874811
hyuA_predicted,0.06666666666666667,14,14,CGAACTCAGGTCACGGGTGT,0,1843428
hyuA_predicted,0.06666666666666667,14,14,CCGCGAGCGGCCTTTAAAAG,0,1829924
hyuA_predicted,0.06666666666666667,14,14,CCATATGAAGGACCAATCAA,0,1847350
hyuA_predicted,0.06666666666666667,14,14,CATGTGCACGTCAACCTTAA,0,1853854
hyuA_predicted,0.06666666666666667,14,14,CATGTCGTTCTCTGTTTGAG,0,1858019
hyuA_predicted,0.06666666666666667,14,14,CATGGTAAATCAGATCTGAG,0,1837637
hyuA_predicted,0.06666666666666667,14,14,CATACGGGAGAGAAAGAGGA,0,1868874
hyuA_predicted,0.06666666666666667,14,14,CAGGTAAGGAGTCGCAACCT,0,1875522
hyuA_predicted,0.06666666666666667,14,14,CAGGCATCGATCATTGCGGT,0,1836307
hyuA_predicted,0.06666666666666667,14,14,CAGACCGATACTGTGCGTAC,0,1856999
hyuA_predicted,0.06666666666666667,14,14,CACGGCAATAGGTTGTGGAG,0,1841433
hyuA_predicted,0.06666666666666667,14,14,CACCCTTTCCCCCTAATGCA,0,1846914
hyuA_predicted,0.06666666666666667,14,14,CACCCCGCGCACCGTCAGGC,0,1852825
hyuA_predicted,0.06666666666666667,14,14,CACACGTAGGGGGTAGCGGG,0,1869653
hyuA_predicted,0.06666666666666667,14,14,CAACTTGCCTTATCGCCTTT,0,1863679
hyuA_predicted,0.06666666666666667,14,14,CAAATAGTACTGGGATCCAC,0,1870335
hyuA_predicted,0.06666666666666667,14,14,ATTAATCGCGTCTCAACGAA,0,1830629
hyuA_predicted,0.06666666666666667,14,14,ATGTATACGCGGTTCTTATT,0,1863724
hyuA_predicted,0.06666666666666667,14,14,ATCTAAGGTGGTTGGTTGGC,0,1871232
hyuA_predicted,0.06666666666666667,14,14,ATATATAGTCATCTGATTGC,0,1865970
hyuA_predicted,0.06666666666666667,14,14,ATACACCGAGGTAGCTGGTG,0,1844112
hyuA_predicted,0.06666666666666667,14,14,AGTCTGGGGAAAAGAGTCTC,0,1863085
hyuA_predicted,0.06666666666666667,14,14,AGGTCTTCTTTCACGACGCG,0,1841049
hyuA_predicted,0.06666666666666667,14,14,AGGCGCTGATCCCCGGTTGA,0,1867621
hyuA_predicted,0.06666666666666667,14,14,AGGATGTTTTTTTTATGAAA,0,1855618
hyuA_predicted,0.06666666666666667,14,14,AGCTTCGGACGGCTCGTGTT,0,1838240
hyuA_predicted,0.06666666666666667,14,14,AGCTTATACGTACTTAGGTT,0,1850387
hyuA_predicted,0.06666666666666667,14,14,AGATCGCCGTACGACTTGAG,0,1874162
hyuA_predicted,0.06666666666666667,14,14,AGAGCAGCTCGTGGCACAGG,0,1872187
hyuA_predicted,0.06666666666666667,14,14,ACTGGGGTAAAGGGGCGAAC,0,1875766
hyuA_predicted,0.06666666666666667,14,14,ACGGTAGTGACGCAGTGACA,0,1865592
hyuA_predicted,0.06666666666666667,14,14,ACGATTAACTAAGTCTCTGA,0,1869759
hyuA_predicted,0.06666666666666667,14,14,ACGATAAGCAAACGCCCATC,0,1873643
hyuA_predicted,0.06666666666666667,14,14,ACCTCCCCGATGGGTGTAAA,0,1873511
hyuA_predicted,0.06666666666666667,14,14,ACCGCACCTAAGTACGAACT,0,1860097
hyuA_predicted,0.06666666666666667,14,14,ACCCCCACGGTTGTCCCGGG,0,1875273
hyuA_predicted,0.06666666666666667,14,14,AATTAGAGTGAAGGAATCGC,0,1834863
hyuA_predicted,0.06666666666666667,14,14,AAGTTTGTGGAATTAGTATA,0,1837063
hyuA_predicted,0.06666666666666667,14,14,AAGGATCGCCCCGGCTTAAC,0,1871572
hyuA_predicted,0.06666666666666667,14,14,AAGCGATTCCTCGCTGCAAA,0,1839667
hyuA_predicted,0.06666666666666667,14,14,AACTGCCGCTAGGGCAATAT,0,1839386
hyuA_predicted,0.06666666666666667,14,14,AACGTGAAAGAGGTGCAACT,0,1836603
hyuA_predicted,0.06666666666666667,14,14,AACGCAGCGGTTGGATCAAG,0,1847546
hyuA_predicted,0.07142857142857142,13,13,TTTTAATGACCCTGGAAGCA,0,1840033
hyuA_predicted,0.07142857142857142,13,13,TTTGGGCAGTATCTTCTAAG,0,1848290
hyuA_predicted,0.07142857142857142,13,13,TTTAGCACATCCATTGCATA,0,1858949
hyuA_predicted,0.07142857142857142,13,13,TTTACGGCCATATGGCTGGG,0,1830777
hyuA_predicted,0.07142857142857142,13,13,TTGGGTGTGTATACAGGTCA,0,1871900
hyuA_predicted,0.07142857142857142,13,13,TTGGAGTGGTGACGCGGGGG,0,1835599
hyuA_predicted,0.07142857142857142,13,13,TTATATGAATGACATACTAA,0,1859469
hyuA_predicted,0.07142857142857142,13,13,TTACTATAATCCGGGTATTA,0,1846202
hyuA_predicted,0.07142857142857142,13,13,TGTCGCATGTAGAGCTCTCT,0,1856424
hyuA_predicted,0.07142857142857142,13,13,TGGCGCATGGCGGGCTTTAT,0,1875479
hyuA_predicted,0.07142857142857142,13,13,TGCTCCAATGCAGGACCGCA,0,1834911
hyuA_predicted,0.07142857142857142,13,13,TGCACCATGTTGTCTGACGT,0,1838025
hyuA_predicted,0.07142857142857142,13,13,TGCAACTCCTGCGTTCGCAG,0,1845041
hyuA_predicted,0.07142857142857142,13,13,TGACGCCGCTACGGGTTTCT,0,1841324
hyuA_predicted,0.07142857142857142,13,13,TCTTAGTTTGCGGAACAGGT,0,1846645
hyuA_predicted,0.07142857142857142,13,13,TCTATGCTACGGGCATTTGC,0,1853639
hyuA_predicted,0.07142857142857142,13,13,TCGGTCACGTATAAAAAACT,0,1849481
hyuA_predicted,0.07142857142857142,13,13,TCATTCGACCCGACGATATG,0,1844907
hyuA_predicted,0.07142857142857142,13,13,TCATGGCGGCAGCATACCTA,0,1873000
hyuA_predicted,0.07142857142857142,13,13,TCAATTCTTCGACTTCGCGA,0,1853514
hyuA_predicted,0.07142857142857142,13,13,TCAAGTCCCTCAAGTGTTTC,0,1868669
hyuA_predicted,0.07142857142857142,13,13,TATTTGCTAAAAAGGAGATT,0,1842376
hyuA_predicted,0.07142857142857142,13,13,TATTAGTAGTGTTGTTGGAT,0,1868188
hyuA_predicted,0.07142857142857142,13,13,TATGATACATTACGTGTCGT,0,1836682
hyuA_predicted,0.07142857142857142,13,13,TAGCTGGCCCCCCCATGACA,0,1852463
hyuA_predicted,0.07142857142857142,13,13,TAGATATACCATCAAAACGT,0,1876436
hyuA_predicted,0.07142857142857142,13,13,TAGACGCCCCGAACAGGAAG,0,1864286
hyuA_predicted,0.07142857142857142,13,13,TACGTGATCATGCAACTGCA,0,1856693
hyuA_predicted,0.07142857142857142,13,13,TACCCTAAGTAGTCCAGACA,0,1860587
hyuA_predicted,0.07142857142857142,13,13,TACCAAGTGCTTCGTATAAT,0,1864963
hyuA_predicted,0.07142857142857142,13,13,TAACATTGCTCGTTGGTACA,0,1864517
hyuA_predicted,0.07142857142857142,13,13,GTTTACCTGGCAAACGCCTT,0,1859655
hyuA_predicted,0.07142857142857142,13,13,GTTCGAAAGCATCGGGTAAA,0,1839067
hyuA_predicted,0.07142857142857142,13,13,GTTAGGATTTGGCACACATG,0,1846789
hyuA_predicted,0.07142857142857142,13,13,GTGTCAACACTGTTCTGGCG,0,1855434
hyuA_predicted,0.07142857142857142,13,13,GTGGAACCCTTGTAAGGCAT,0,1869762
hyuA_predicted,0.07142857142857142,13,13,GTCGAAGACGCTTTAACGAT,0,1871028
hyuA_predicted,0.07142857142857142,13,13,GTATTAAACAGTCACCCCCG,0,1859319
hyuA_predicted,0.07142857142857142,13,13,GTATACATGGCGTTGTCCAG,0,1848379
hyuA_predicted,0.07142857142857142,13,13,GTACTGTATCGTCGGCTTGC,0,1874829
hyuA_predicted,0.07142857142857142,13,13,GGTCTGGGCTAAATGGTCAA,0,1830803
hyuA_predicted,0.07142857142857142,13,13,GGGTACGGCGTACTTTATTA,0,1863665
hyuA_predicted,0.07142857142857142,13,13,GGGCCGGGGGCTTGCTTATG,0,1863053
hyuA_predicted,0.07142857142857142,13,13,GGGAAGCTGCCCAACGTGCG,0,1875657
hyuA_predicted,0.07142857142857142,13,13,GGCGTGTGTCGCATATGAAG,0,1868154
hyuA_predicted,0.07142857142857142,13,13,GGCCTTGTCCACGGATGTTG,0,1850380
hyuA_predicted,0.07142857142857142,13,13,GGCCATCCTCGTCTCTGCTT,0,1871767
hyuA_predicted,0.07142857142857142,13,13,GGCACTATATAGGACAACAA,0,1858972
hyuA_predicted,0.07142857142857142,13,13,GGATGCGGCTGAACTGAGAC,0,1860662
hyuA_predicted,0.07142857142857142,13,13,GGAGTAATGGGTCGTGCCGA,0,1837310
hyuA_predicted,0.07142857142857142,13,13,GGAAGATGTTTGGGCGGATA,0,1854484
hyuA_predicted,0.07142857142857142,13,13,GCTAGTTGCTGCCTCGTTAA,0,1863288
hyuA_predicted,0.07142857142857142,13,13,GCGAACAATCGGACATGGGA,0,1838077
hyuA_predicted,0.07142857142857142,13,13,GCCATCAATCGGGAGTCCTC,0,1867699
hyuA_predicted,0.07142857142857142,13,13,GCCACGTAAATCGCGCCATA,0,1864312
hyuA_predicted,0.07142857142857142,13,13,GCATTCGGGTCACGCCTTAA,0,1872359
hyuA_predicted,0.07142857142857142,13,13,GCAGTTCCTGGACCCTCTGA,0,1830865
hyuA_predicted,0.07142857142857142,13,13,GATGGTCTGCGTAGAGGTTG,0,1844379
hyuA_predicted,0.07142857142857142,13,13,GATGGCTCTCCTACGAGTCA,0,1873877
hyuA_predicted,0.07142857142857142,13,13,GAGGACGATCTGCTCGCATA,0,1835598
hyuA_predicted,0.07142857142857142,13,13,GAGAATCGAGCGAACGTCTA,0,1836977
hyuA_predicted,0.07142857142857142,13,13,GACGGCAATCCGTAGTTGAT,0,1830249
hyuA_predicted,0.07142857142857142,13,13,GACAAGTTTATCTACGACCA,0,1856269
hyuA_predicted,0.07142857142857142,13,13,GAATTAAGACAGGATCTGGG,0,1865124
hyuA_predicted,0.07142857142857142,13,13,GAATCGGTTTTTCCGTCTCA,0,1843295
hyuA_predicted,0.07142857142857142,13,13,GAAGTCCACGGAACAGCGAT,0,1844054
hyuA_predicted,0.07142857142857142,13,13,GAAAGCCCATGTGTTTATCG,0,1829083
hyuA_predicted,0.07142857142857142,13,13,CTTGGTGTTCAGGGTCCAAG,0,1866734
hyuA_predicted,0.07142857142857142,13,13,CTTGGTCGGTAACCTTCCAA,0,1833342
hyuA_predicted,0.07142857142857142,13,13,CTTCGGAGTACCTATCCCTG,0,1865736
hyuA_predicted,0.07142857142857142,13,13,CTGGTCTTGTACGGTTAGGT,0,1834472
hyuA_predicted,0.07142857142857142,13,13,CTGGATCGGGTGGTCTTCTT,0,1831121
hyuA_predicted,0.07142857142857142,13,13,CTCCTACTGCACTAGCGATC,0,1830915
hyuA_predicted,0.07142857142857142,13,13,CTCCCAAGTATAGGATTTGC,0,1873050
hyuA_predicted,0.07142857142857142,13,13,CTATCTCCTTTTTTCAGTCC,0,1839112
hyuA_predicted,0.07142857142857142,13,13,CTATCCGCTCGAATTTGTTT,0,1861967
hyuA_predicted,0.07142857142857142,13,13,CTAGTCTATGCCTAAGCACA,0,1868277
hyuA_predicted,0.07142857142857142,13,13,CTAATGTCTTAAAACCAGAA,0,1865437
hyuA_predicted,0.07142857142857142,13,13,CGTCTACGCTACAAGGTGGC,0,1846560
hyuA_predicted,0.07142857142857142,13,13,CGTACTAAGGAATGGGAATA,0,1846225
hyuA_predicted,0.07142857142857142,13,13,CGGGGCAAACGACGTGCTCA,0,1846688
hyuA_predicted,0.07142857142857142,13,13,CGGGAAATTGGAATCTACGG,0,1852203
hyuA_predicted,0.07142857142857142,13,13,CGGCATCGCGCCTTAGTACA,0,1870497
hyuA_predicted,0.07142857142857142,13,13,CGCTGCCCCCTTGGAGACAT,0,1842868
hyuA_predicted,0.07142857142857142,13,13,CGCGTCAATACATATCTTGT,0,1829396
hyuA_predicted,0.07142857142857142,13,13,CGCATCGTGACTATTAAAAT,0,1857610
hyuA_predicted,0.07142857142857142,13,13,CGACAACGAAGGCACTCGCG,0,1867208
hyuA_predicted,0.07142857142857142,13,13,CGAATTTTGACCCTGAAGAA,0,1877622
hyuA_predicted,0.07142857142857142,13,13,CGAACGCTGTCTCCTTAAGG,0,1875232
hyuA_predicted,0.07142857142857142,13,13,CGAACCCATAATTGGCTACG,0,1877224
hyuA_predicted,0.07142857142857142,13,13,CCTCGATGGTCTAACTGAAC,0,1847917
hyuA_predicted,0.07142857142857142,13,13,CCTAAAAGAATTAGTGCCAA,0,1875734
hyuA_predicted,0.07142857142857142,13,13,CCGGTATTGCTGGTACAAGT,0,1836641
hyuA_predicted,0.07142857142857142,13,13,CCGGGACCCCGACAAAGGTA,0,1850042
hyuA_predicted,0.07142857142857142,13,13,CCGGCCTTGACAACAGCTGC,0,1874525
hyuA_predicted,0.07142857142857142,13,13,CCGATTTTTAATCTCCTGTA,0,1852892
hyuA_predicted,0.07142857142857142,13,13,CCCGTAGACAGGACCATGCA,0,1846169
hyuA_predicted,0.07142857142857142,13,13,CCCAGCATATCAGGGATTAC,0,1831088
hyuA_predicted,0.07142857142857142,13,13,CCATCTTATGAGCCACGTTA,0,1857415
hyuA_predicted,0.07142857142857142,13,13,CCAGGTACCCCACTAATGCG,0,1830910
hyuA_predicted,0.07142857142857142,13,13,CCAGGCACTGACTCGGGTAA,0,1833595
hyuA_predicted,0.07142857142857142,13,13,CCACCATTCGTAACATCCGA,0,1877548
hyuA_predicted,0.07142857142857142,13,13,CATCATATCGTACTTGGGAG,0,1849739
hyuA_predicted,0.07142857142857142,13,13,CATATCCGGCAGTTGCATGA,0,1875133
hyuA_predicted,0.07142857142857142,13,13,CATACACGGACAGTGCCAAA,0,1861347
hyuA_predicted,0.07142857142857142,13,13,CAGCTTGTCATGACCGGGCA,0,1861761
hyuA_predicted,0.07142857142857142,13,13,CAGCTGACGACCTATCCCCA,0,1866627
hyuA_predicted,0.07142857142857142,13,13,CAGCGTGTCGGTACTTTAAA,0,1848293
hyuA_predicted,0.07142857142857142,13,13,CACTGACAGTCCTTACGATC,0,1833195
hyuA_predicted,0.07142857142857142,13,13,CACACTCGACGCTGAGTAGA,0,1863735
hyuA_predicted,0.07142857142857142,13,13,CAATTCTCTTATAATTAATC,0,1846516
hyuA_predicted,0.07142857142857142,13,13,ATTGGGACTAAGTTTATAAA,0,1874998
hyuA_predicted,0.07142857142857142,13,13,ATTACGAGCGCAGGTCTAAA,0,1835138
hyuA_predicted,0.07142857142857142,13,13,ATCATGCCGACCCGCTTCAA,0,1835261
hyuA_predicted,0.07142857142857142,13,13,ATATGTGTGGTGTTTCGTGC,0,1846631
hyuA_predicted,0.07142857142857142,13,13,ATATGTGCATATGTGAGGAC,0,1833576
hyuA_predicted,0.07142857142857142,13,13,ATAAGTAGGCCGTGTCCTGC,0,1834781
hyuA_predicted,0.07142857142857142,13,13,AGTTTAGCGTAGCTGCACGA,0,1832829
hyuA_predicted,0.07142857142857142,13,13,AGTTCGTGTCACATGTGCAA,0,1860873
hyuA_predicted,0.07142857142857142,13,13,AGTGGTATGGCGCATCGACC,0,1851995
hyuA_predicted,0.07142857142857142,13,13,AGTCTTCGTAGGGTGCTCCA,0,1864064
hyuA_predicted,0.07142857142857142,13,13,AGGCGAAGTTCGAGTAGGAA,0,1829251
hyuA_predicted,0.07142857142857142,13,13,AGCTCGAGGCAGGCATTATC,0,1869756
hyuA_predicted,0.07142857142857142,13,13,AGCCGTTATGGGAATATTAA,0,1873392
hyuA_predicted,0.07142857142857142,13,13,AGATGTAACTGGTGCTCCCA,0,1867670
hyuA_predicted,0.07142857142857142,13,13,AGAGGAGGGGGCAGATTCAC,0,1835745
hyuA_predicted,0.07142857142857142,13,13,AGAGCTCACCCATAGTTGTT,0,1837738
hyuA_predicted,0.07142857142857142,13,13,AGAATTGTGGTATCGCTAGT,0,1855224
hyuA_predicted,0.07142857142857142,13,13,AGAAGGAACCCCCGTGTAGG,0,1873047
hyuA_predicted,0.07142857142857142,13,13,ACTTTGAGCGGAAACTCTGA,0,1851040
hyuA_predicted,0.07142857142857142,13,13,ACTCACTGCGTCGATGACAG,0,1854290
hyuA_predicted,0.07142857142857142,13,13,ACGCGCCTCTAGAGTGACAG,0,1875491
hyuA_predicted,0.07142857142857142,13,13,ACGAGCGGAGTCCCTCATCA,0,1871347
hyuA_predicted,0.07142857142857142,13,13,ACCTCATCCTATTAAAACAA,0,1862356
hyuA_predicted,0.07142857142857142,13,13,ACCGTCAACCTACGCCCTGA,0,1834834
hyuA_predicted,0.07142857142857142,13,13,ACAGGCGGGGGCGTGCTCAG,0,1832365
hyuA_predicted,0.07142857142857142,13,13,AATACCGACCCCCACAAGGC,0,1850373
hyuA_predicted,0.07142857142857142,13,13,AAGTCTAGAGTGCGCTCGAC,0,1856057
hyuA_predicted,0.07142857142857142,13,13,AAGCTAGGGTTCCAACACAG,0,1851832
hyuA_predicted,0.07142857142857142,13,13,AAAGGAAGAACCAACGCTTG,0,1874065
hyuA_predicted,0.07142857142857142,13,13,AAAGCCGATGGACGTTTGTA,0,1852471
hyuA_predicted,0.07142857142857142,13,13,AAACCATTCAGTTGTATAGC,0,1841811
hyuA_predicted,0.07142857142857142,13,13,AAAAGACTAAACGACGCAAT,0,1842736
hyuA_predicted,0.07692307692307693,12,12,TTTCTTGTATATTCTCGTGG,0,1862498
hyuA_predicted,0.07692307692307693,12,12,TTGGGTACGATCCAGGGGTA,0,1864473
hyuA_predicted,0.07692307692307693,12,12,TTGCCGTACTTATCTACGAA,0,1864506
hyuA_predicted,0.07692307692307693,12,12,TTGACTATACGGCTGGGTCG,0,1857775
hyuA_predicted,0.07692307692307693,12,12,TTCTACTAGCGCAAGCCTCC,0,1844530
hyuA_predicted,0.07692307692307693,12,12,TTCCGTTTTAGGCCGACCCA,0,1860760
hyuA_predicted,0.07692307692307693,12,12,TTATTAAGGTGCGAGCAATC,0,1844741
hyuA_predicted,0.07692307692307693,12,12,TTACTGCAAATCATGTGCTA,0,1847649
hyuA_predicted,0.07692307692307693,12,12,TGTACGCGGCAGCTGGATAC,0,1838106
hyuA_predicted,0.07692307692307693,12,12,TGGTACCTCTTTGTCCACAG,0,1830492
hyuA_predicted,0.07692307692307693,12,12,TGCACAGAGTCACATTCTAG,0,1833785
hyuA_predicted,0.07692307692307693,12,12,TGAATTGATCCAGGATCCAG,0,1873943
hyuA_predicted,0.07692307692307693,12,12,TGAAGGCCCCCCTTATTATC,0,1859576
hyuA_predicted,0.07692307692307693,12,12,TCTTAGCAGTTGTTTCTCCA,0,1842852
hyuA_predicted,0.07692307692307693,12,12,TCTGGGTGCGGGCTGTACAC,0,1846948
hyuA_predicted,0.07692307692307693,12,12,TCTAACGGAATTTACTTCCG,0,1868220
hyuA_predicted,0.07692307692307693,12,12,TCTAAAGACTCGGATACGTC,0,1842641
hyuA_predicted,0.07692307692307693,12,12,TCGTTACCTCGGCGCGAAGG,0,1865873
hyuA_predicted,0.07692307692307693,12,12,TCGTCACCGTTCTTTCTACT,0,1849881
hyuA_predicted,0.07692307692307693,12,12,TCGACGTAAGTCGGAGAGGT,0,1835415
hyuA_predicted,0.07692307692307693,12,12,TCCCAGTAAACAGTTTTCGT,0,1871876
hyuA_predicted,0.07692307692307693,12,12,TCCATCCGTCGGGGAGCCAA,0,1872054
hyuA_predicted,0.07692307692307693,12,12,TCAAAGCCCTATTTCTTTGA,0,1870952
hyuA_predicted,0.07692307692307693,12,12,TATTAATGAAGCGGGTGAAC,0,1860254
hyuA_predicted,0.07692307692307693,12,12,TATAAATGGCGTGCGCATTG,0,1840737
hyuA_predicted,0.07692307692307693,12,12,TAGACAGAGTTGCCGGACGT,0,1875151
hyuA_predicted,0.07692307692307693,12,12,TACACGTATAAGGGAAATTT,0,1835472
hyuA_predicted,0.07692307692307693,12,12,TAACTGCCGGAAGGTATCTT,0,1836031
hyuA_predicted,0.07692307692307693,12,12,TAACGATTTACATCGGCAGT,0,1865904
hyuA_predicted,0.07692307692307693,12,12,TAACGATTATACCGATTCAC,0,1848291
hyuA_predicted,0.07692307692307693,12,12,TAAACTGAGAGTCTAGCTCT,0,1856114
hyuA_predicted,0.07692307692307693,12,12,GTGCTCGTTCGGGATGGCGT,0,1850895
hyuA_predicted,0.07692307692307693,12,12,GTCCTCGGAGACCCCTTCAA,0,1837636
hyuA_predicted,0.07692307692307693,12,12,GTCCAAGTTGGTCCCCCACA,0,1845246
hyuA_predicted,0.07692307692307693,12,12,GTCATCAGACAGGGGGCAAT,0,1876900
hyuA_predicted,0.07692307692307693,12,12,GTCATAGCTTAGTTCTTTTA,0,1835907
hyuA_predicted,0.07692307692307693,12,12,GTCATACGCATTTGAAAGTC,0,1855401
hyuA_predicted,0.07692307692307693,12,12,GTCAGGATTGAGTAGACGAA,0,1842220
hyuA_predicted,0.07692307692307693,12,12,GTATTGCTTTGTTGATTAGG,0,1849515
hyuA_predicted,0.07692307692307693,12,12,GTATTGATAAACTCGACCAC,0,1841705
hyuA_predicted,0.07692307692307693,12,12,GTATGGGAGTGCATACCCAA,0,1854496
hyuA_predicted,0.07692307692307693,12,12,GTAGATAGATGCGAGGCTAT,0,1846869
hyuA_predicted,0.07692307692307693,12,12,GGTGGGAGCGAAAACGGGTA,0,1839612
hyuA_predicted,0.07692307692307693,12,12,GGTGCGCTGGTAATATAGCT,0,1858411
hyuA_predicted,0.07692307692307693,12,12,GGTGCAATAGCAGGTACCTT,0,1862874
hyuA_predicted,0.07692307692307693,12,12,GGGTCTAAGGCACCAGGTCA,0,1847930
hyuA_predicted,0.07692307692307693,12,12,GGGGTTTTACTCTATGGTGT,0,1840735
hyuA_predicted,0.07692307692307693,12,12,GGGGGATTTGTACAGAGGCG,0,1842445
hyuA_predicted,0.07692307692307693,12,12,GGGGCGGGCGTGCGTGTAAG,0,1839136
hyuA_predicted,0.07692307692307693,12,12,GGGATAATCGGACAATGTCG,0,1868379
hyuA_predicted,0.07692307692307693,12,12,GGCTGGCCCAGGCCCTTGCA,0,1858933
hyuA_predicted,0.07692307692307693,12,12,GGCCGAAAGAGTACTCAATG,0,1844109
hyuA_predicted,0.07692307692307693,12,12,GGATAGCTTCGCAACCCGTA,0,1841046
hyuA_predicted,0.07692307692307693,12,12,GGAGCACCTCGGGCATTAGT,0,1875049
hyuA_predicted,0.07692307692307693,12,12,GGACTAACACATTGGCGGGC,0,1877737
hyuA_predicted,0.07692307692307693,12,12,GGAAGGCGGTCCAGAACTTC,0,1857249
hyuA_predicted,0.07692307692307693,12,12,GGAAAGGGAATATATCAGCG,0,1834273
hyuA_predicted,0.07692307692307693,12,12,GCTGGGCAGTCAACGTGTCG,0,1859116
hyuA_predicted,0.07692307692307693,12,12,GCTGGCTATCCACTGCACTC,0,1837211
hyuA_predicted,0.07692307692307693,12,12,GCCTGGGGATTCCCGGATGA,0,1876203
hyuA_predicted,0.07692307692307693,12,12,GCCTCTTAGGGCAGATTCCC,0,1837688
hyuA_predicted,0.07692307692307693,12,12,GCCCATTAAGTCAGCCGTGC,0,1862455
hyuA_predicted,0.07692307692307693,12,12,GCCCACATGTGTGTTCAGGT,0,1848242
hyuA_predicted,0.07692307692307693,12,12,GCCAAATTGCATGTGGGTTT,0,1840566
hyuA_predicted,0.07692307692307693,12,12,GATTGCCGTGGGAACTATAC,0,1843390
hyuA_predicted,0.07692307692307693,12,12,GATTCTTAAGGAGAACCAAT,0,1831116
hyuA_predicted,0.07692307692307693,12,12,GATTCCGCGCTAACAGTATG,0,1864310
hyuA_predicted,0.07692307692307693,12,12,GATTAGTCCTCATAGATAAG,0,1860473
hyuA_predicted,0.07692307692307693,12,12,GATCTTTGTGGTGTGTGAGG,0,1876159
hyuA_predicted,0.07692307692307693,12,12,GATCTCACGTGTTATTTCGC,0,1842545
hyuA_predicted,0.07692307692307693,12,12,GATCGGTCGGTGACAAGAGT,0,1842793
hyuA_predicted,0.07692307692307693,12,12,GATAATATAGGGCTGACATG,0,1832517
hyuA_predicted,0.07692307692307693,12,12,GAGTTTGTTGTGAACCTACG,0,1846341
hyuA_predicted,0.07692307692307693,12,12,GAGATGCCAGGCATCGATCC,0,1859421
hyuA_predicted,0.07692307692307693,12,12,GACTTACCACCTCAAGCTAT,0,1832909
hyuA_predicted,0.07692307692307693,12,12,GACGGATAGCGCGCGAGAGC,0,1829201
hyuA_predicted,0.07692307692307693,12,12,GACGCGGGAAATTTGAATAA,0,1858159
hyuA_predicted,0.07692307692307693,12,12,GACGAGAGTGATACCGCTGA,0,1855357
hyuA_predicted,0.07692307692307693,12,12,GACGACAGGGGCAGTCGTGT,0,1877824
hyuA_predicted,0.07692307692307693,12,12,GACACAAGCACCCCGGACCT,0,1828952
hyuA_predicted,0.07692307692307693,12,12,GAATGCTAGGAAGTGAAATT,0,1841828
hyuA_predicted,0.07692307692307693,12,12,GAACATTCTTGAGCGCTTGT,0,1836451
hyuA_predicted,0.07692307692307693,12,12,GAAAAAGAATCTTGCAGTCA,0,1832830
hyuA_predicted,0.07692307692307693,12,12,CTTCGAGCTTGATAGACAGG,0,1861336
hyuA_predicted,0.07692307692307693,12,12,CTTATAAGACTTTCTTGCGG,0,1857684
hyuA_predicted,0.07692307692307693,12,12,CTGGGCATCATTTCAAAGAA,0,1831475
hyuA_predicted,0.07692307692307693,12,12,CTGGATCGAAGTATGGGGTA,0,1863444
hyuA_predicted,0.07692307692307693,12,12,CTGCTGAGTCGGAGCACCAA,0,1854355
hyuA_predicted,0.07692307692307693,12,12,CTCTTTGTCAGGTGGCCGAA,0,1846923
hyuA_predicted,0.07692307692307693,12,12,CTAGATGTCTTCTCAACCTT,0,1837990
hyuA_predicted,0.07692307692307693,12,12,CGTTAGTCGCCATGCAGAGA,0,1852447
hyuA_predicted,0.07692307692307693,12,12,CGTGGTTTAGGGTCCCTGCA,0,1840190
hyuA_predicted,0.07692307692307693,12,12,CGTGGCAATAAATATCAGAG,0,1863974
hyuA_predicted,0.07692307692307693,12,12,CGTCCGCACTGTTGTTTGAG,0,1839950
hyuA_predicted,0.07692307692307693,12,12,CGTACTCCCAGGGCACGAAG,0,1834967
hyuA_predicted,0.07692307692307693,12,12,CGGTGCGGTCCGGGTAGAGT,0,1831053
hyuA_predicted,0.07692307692307693,12,12,CGGAATCGAGGACGACTCGA,0,1856120
hyuA_predicted,0.07692307692307693,12,12,CGCTGGTCGTCATTTTGCTT,0,1843495
hyuA_predicted,0.07692307692307693,12,12,CGCGTGAAAAATTATCATTG,0,1870213
hyuA_predicted,0.07692307692307693,12,12,CGCCAGGCCGATATTAATAT,0,1835432
hyuA_predicted,0.07692307692307693,12,12,CGATCTAGATTTATGCAATA,0,1874330
hyuA_predicted,0.07692307692307693,12,12,CGACTCTCTAGCGGTCTTCG,0,1834221
hyuA_predicted,0.07692307692307693,12,12,CGACCCTGCCCAGGCCCACC,0,1854868
hyuA_predicted,0.07692307692307693,12,12,CGAAGTCTCAATCATTGCGC,0,1841497
hyuA_predicted,0.07692307692307693,12,12,CCTGGTCCCCCGTTAATGTA,0,1862239
hyuA_predicted,0.07692307692307693,12,12,CCGATTTCGTGGTGTTGCAT,0,1868117
hyuA_predicted,0.07692307692307693,12,12,CCCGTTACGGTCAGAAGGCG,0,1849526
hyuA_predicted,0.07692307692307693,12,12,CCATGACTTCGCATGCCGGA,0,1846629
hyuA_predicted,0.07692307692307693,12,12,CCATATCCAGGCGAATACGG,0,1864560
hyuA_predicted,0.07692307692307693,12,12,CCACGCGAAATGTCCGAGTA,0,1839302
hyuA_predicted,0.07692307692307693,12,12,CATTAAATACTAAGGATACC,0,1837360
hyuA_predicted,0.07692307692307693,12,12,CATCCTGCTAAACCATTGAA,0,1857544
hyuA_predicted,0.07692307692307693,12,12,CAGAACGCGAAGGTTTCACT,0,1830120
hyuA_predicted,0.07692307692307693,12,12,CACCGGGGTTGGCCTCCCTG,0,1876810
hyuA_predicted,0.07692307692307693,12,12,CAAGTCGAGCAACTCACGAC,0,1873755
hyuA_predicted,0.07692307692307693,12,12,CAAGGCAGGCCAGACAAATC,0,1855880
hyuA_predicted,0.07692307692307693,12,12,CAAGAAATCAGGAAGCGGCG,0,1854939
hyuA_predicted,0.07692307692307693,12,12,CAAAGAAACTGGAGTGCCGT,0,1839730
hyuA_predicted,0.07692307692307693,12,12,CAAACGGCTTCGCGTCGCAA,0,1864080
hyuA_predicted,0.07692307692307693,12,12,ATTGAGTAGTGATGCTTATT,0,1865424
hyuA_predicted,0.07692307692307693,12,12,ATTACCAATCGTACGGAACG,0,1871786
hyuA_predicted,0.07692307692307693,12,12,ATGGGGTAAGGCACTAGCCC,0,1868939
hyuA_predicted,0.07692307692307693,12,12,ATGCTCCAGTAGTAGGTTGA,0,1865394
hyuA_predicted,0.07692307692307693,12,12,ATCATTAGTATATGTGTGCA,0,1832749
hyuA_predicted,0.07692307692307693,12,12,ATATTAGCGCGCTTGAGAGG,0,1841917
hyuA_predicted,0.07692307692307693,12,12,ATATGCAGACGTGCAGGAGA,0,1866404
hyuA_predicted,0.07692307692307693,12,12,ATAGTCATAGAGGAAACAAG,0,1853529
hyuA_predicted,0.07692307692307693,12,12,ATAGGCATCAATTAAATTGA,0,1829688
hyuA_predicted,0.07692307692307693,12,12,ATACTCAGTAGGGGAGCATA,0,1850093
hyuA_predicted,0.07692307692307693,12,12,ATACGGCACGAAGGGAAGCT,0,1841827
hyuA_predicted,0.07692307692307693,12,12,AGGTGCAGGCGGTGCTTAGT,0,1850589
hyuA_predicted,0.07692307692307693,12,12,AGGGACTGTGACCGAGGTGG,0,1837313
hyuA_predicted,0.07692307692307693,12,12,AGGATGCCGGCGTCGTCATA,0,1867223
hyuA_predicted,0.07692307692307693,12,12,AGCGGCGCAATGAAGGGTTT,0,1865221
hyuA_predicted,0.07692307692307693,12,12,AGCATAAAGAATGGCAGGGT,0,1862370
hyuA_predicted,0.07692307692307693,12,12,AGATTATTCATGCGGCGGAA,0,1838956
hyuA_predicted,0.07692307692307693,12,12,AGATAAGCCGTGGTAGGGAC,0,1848670
hyuA_predicted,0.07692307692307693,12,12,AGAGTCACCTCTCATCGAAA,0,1845691
hyuA_predicted,0.07692307692307693,12,12,AGACGGGCTTTGTACGTACT,0,1872873
hyuA_predicted,0.07692307692307693,12,12,ACTGGTCTCGGATAAATGCT,0,1850097
hyuA_predicted,0.07692307692307693,12,12,ACTGGAGTAAGCCTATTAGT,0,1858074
hyuA_predicted,0.07692307692307693,12,12,ACTCACTACGTCGAACCACC,0,1831157
hyuA_predicted,0.07692307692307693,12,12,ACGTGTAAATGGCTGGTTGA,0,1861266
hyuA_predicted,0.07692307692307693,12,12,ACGCTAGAGCACTGTAGCTT,0,1831949
hyuA_predicted,0.07692307692307693,12,12,ACCTCGCTAGGGAGGAGTTG,0,1856721
hyuA_predicted,0.07692307692307693,12,12,ACCCCCAACTAAGTCAGACC,0,1856408
hyuA_predicted,0.07692307692307693,12,12,ACCATAACTGCGGGGGCTGG,0,1843358
hyuA_predicted,0.07692307692307693,12,12,ACATTTAGCACTAAAACCTA,0,1845652
hyuA_predicted,0.07692307692307693,12,12,AATTGACGGGGTCATGATTC,0,1867300
hyuA_predicted,0.07692307692307693,12,12,AATGCTCGTGGGTGCTGGTA,0,1848831
hyuA_predicted,0.07692307692307693,12,12,AATCCTCGGGGGGACCTACA,0,1864597
hyuA_predicted,0.07692307692307693,12,12,AAGTTACCGAACGCAAACAT,0,1844922
hyuA_predicted,0.07692307692307693,12,12,AAGTACGAATCAAGCAGAGC,0,1870154
hyuA_predicted,0.07692307692307693,12,12,AAGCAAAGTCATATGTAATC,0,1862463
hyuA_predicted,0.07692307692307693,12,12,AACGTCGAAGACACGATAAG,0,1867098
hyuA_predicted,0.07692307692307693,12,12,AACGACGTATGTATGGATTC,0,1829338
hyuA_predicted,0.07692307692307693,12,12,AACAAAAGTGGTGGCTTAGT,0,1870683
hyuA_predicted,0.07692307692307693,12,12,AAATTCTTCCACTGAAGGCG,0,1860737
hyuA_predicted,0.07692307692307693,12,12,AAACTCGGATAAAGTCATCA,0,1850104
hyuA_predicted,0.08333333333333333,11,11,TTTGGGGATCACGCCTGTTG,0,1877372
hyuA_predicted,0.08333333333333333,11,11,TTTGACTCGGGTAATCGAGT,0,1836022
hyuA_predicted,0.08333333333333333,11,11,TTGGGGCAGAGCGGGGTGTG,0,1830614
hyuA_predicted,0.08333333333333333,11,11,TTGGGACAATGGCTTACTGT,0,1829632
hyuA_predicted,0.08333333333333333,11,11,TTCTCTAATGCGGTACCTTT,0,1857550
hyuA_predicted,0.08333333333333333,11,11,TTATCCGTCGGATTGTAGCA,0,1849732
hyuA_predicted,0.08333333333333333,11,11,TTATCATGGGGGGGTGGCAG,0,1841084
hyuA_predicted,0.08333333333333333,11,11,TTATCACAGAAGGGTAGGAA,0,1876617
hyuA_predicted,0.08333333333333333,11,11,TTATATGGTCGTGGAAGAAA,0,1841376
hyuA_predicted,0.08333333333333333,11,11,TTAGGATTACGATCCCCTTA,0,1843296
hyuA_predicted,0.08333333333333333,11,11,TTAGATCGTTCGATGACGTC,0,1835219
hyuA_predicted,0.08333333333333333,11,11,TTAATCGCTCCTGACCTATA,0,1831149
hyuA_predicted,0.08333333333333333,11,11,TTAAGAGATCCTGCGAGTAC,0,1829741
hyuA_predicted,0.08333333333333333,11,11,TGTTTAATTGTTTTTAGGGA,0,1852100
hyuA_predicted,0.08333333333333333,11,11,TGTGTGGCATCCGTATTAAT,0,1855120
hyuA_predicted,0.08333333333333333,11,11,TGGTGGAACAGGCGAACAGG,0,1873364
hyuA_predicted,0.08333333333333333,11,11,TGGGTAAGAATATATCGTCA,0,1842277
hyuA_predicted,0.08333333333333333,11,11,TGGACCGGGGAATGCACGCT,0,1840035
hyuA_predicted,0.08333333333333333,11,11,TGCATTAGGACAAAGGCGCG,0,1860589
hyuA_predicted,0.08333333333333333,11,11,TGATCTATAGTGTGCTCTAT,0,1835812
hyuA_predicted,0.08333333333333333,11,11,TGAGTGTGTGACCTACCTAA,0,1840387
hyuA_predicted,0.08333333333333333,11,11,TCTTTATCATCAACGGTTAA,0,1850651
hyuA_predicted,0.08333333333333333,11,11,TCGTTGTGCTCGGTAGACGG,0,1833935
hyuA_predicted,0.08333333333333333,11,11,TCGTGAGCAACTAAACGATG,0,1833273
hyuA_predicted,0.08333333333333333,11,11,TCGGTCGCGGGACCAACCCT,0,1868726
hyuA_predicted,0.08333333333333333,11,11,TCGGAATAATCATGGGAATA,0,1845274
hyuA_predicted,0.08333333333333333,11,11,TCCTTTTTTCCACATCGTGA,0,1851865
hyuA_predicted,0.08333333333333333,11,11,TCCCGGGGATAAGGGCGCGC,0,1839933
hyuA_predicted,0.08333333333333333,11,11,TCCCCAACTCCATCCGAATC,0,1835951
hyuA_predicted,0.08333333333333333,11,11,TCATATTAGAGTCAAGAAAG,0,1845141
hyuA_predicted,0.08333333333333333,11,11,TCAGAGAGGGGAGACTTCGG,0,1867414
hyuA_predicted,0.08333333333333333,11,11,TCACGTCTGCCGGCGAATAT,0,1840202
hyuA_predicted,0.08333333333333333,11,11,TCACCTGTGTGACAGCAAGT,0,1874669
hyuA_predicted,0.08333333333333333,11,11,TATTGTCTAACCCTGTCCTA,0,1860299
hyuA_predicted,0.08333333333333333,11,11,TATTACAGGAGCGTTACGGA,0,1849360
hyuA_predicted,0.08333333333333333,11,11,TATGCCTGGTCAACTGGCTG,0,1871233
hyuA_predicted,0.08333333333333333,11,11,TATGCAGGGCGTAGAGGAGT,0,1870584
hyuA_predicted,0.08333333333333333,11,11,TATGAGTTCGGTATCGCATG,0,1853917
hyuA_predicted,0.08333333333333333,11,11,TATAAGGCCCATCACTTTCG,0,1833885
hyuA_predicted,0.08333333333333333,11,11,TAGGTTTACACAGGTTCCTT,0,1848192
hyuA_predicted,0.08333333333333333,11,11,TAGGCTGATGACAATGCGAT,0,1840789
hyuA_predicted,0.08333333333333333,11,11,TAGGCCTTGGGGGTTAGTAG,0,1850403
hyuA_predicted,0.08333333333333333,11,11,TAGGATTCGCAAGGGTCTGA,0,1855614
hyuA_predicted,0.08333333333333333,11,11,TAGCGGCTGCGGATTAGCTG,0,1830973
hyuA_predicted,0.08333333333333333,11,11,TACGCAGATGCCCGCGAAAG,0,1875044
hyuA_predicted,0.08333333333333333,11,11,TACAACGAGTGTTGTATCAC,0,1850090
hyuA_predicted,0.08333333333333333,11,11,TAAAGTTTGACCTCGTGATT,0,1840588
hyuA_predicted,0.08333333333333333,11,11,TAAAAGGTAAACGCTTGTAA,0,1858536
hyuA_predicted,0.08333333333333333,11,11,GTTTACAGGAGAAGCGACCA,0,1873685
hyuA_predicted,0.08333333333333333,11,11,GTTGTAGCAGACCCGAGATA,0,1837759
hyuA_predicted,0.08333333333333333,11,11,GTTAGTAAGGTGGATGAGTC,0,1850522
hyuA_predicted,0.08333333333333333,11,11,GTTACAAGTTCGTCTGTTAG,0,1866238
hyuA_predicted,0.08333333333333333,11,11,GTTAAGAATTGCCGCATTCG,0,1869578
hyuA_predicted,0.08333333333333333,11,11,GTGGTGTTGTTAAATCGTTA,0,1846015
hyuA_predicted,0.08333333333333333,11,11,GTGCTGGTCAGGCTTTTTAA,0,1871437
hyuA_predicted,0.08333333333333333,11,11,GTGCGTTCGGCGTTACAAGA,0,1872373
hyuA_predicted,0.08333333333333333,11,11,GTCGTGAGTCTCCCGGGGTA,0,1874160
hyuA_predicted,0.08333333333333333,11,11,GTATTTATCGAATCTACTAT,0,1868942
hyuA_predicted,0.08333333333333333,11,11,GTAGGTCCCGCACTACTGTC,0,1871203
hyuA_predicted,0.08333333333333333,11,11,GGTTTTTCGCGCTGGCTGAC,0,1864937
hyuA_predicted,0.08333333333333333,11,11,GGTGTCTTCATTACGGTATC,0,1847549
hyuA_predicted,0.08333333333333333,11,11,GGTGCAACTATGTAATAAGT,0,1861686
hyuA_predicted,0.08333333333333333,11,11,GGTGAGTCCGGCATCGCGTT,0,1874447
hyuA_predicted,0.08333333333333333,11,11,GGTCCTATCGCATTATGTCA,0,1831711
hyuA_predicted,0.08333333333333333,11,11,GGTCCGCAGCGGTAGTATGC,0,1837445
hyuA_predicted,0.08333333333333333,11,11,GGTCAGAAAAGCACATATCG,0,1832842
hyuA_predicted,0.08333333333333333,11,11,GGTAGTCCGTGCGCGCGCGC,0,1846521
hyuA_predicted,0.08333333333333333,11,11,GGTAGGAATGATCTGGACAG,0,1870687
hyuA_predicted,0.08333333333333333,11,11,GGGTTGCACGTCAACAGAGA,0,1857764
hyuA_predicted,0.08333333333333333,11,11,GGGTCTCGAGTCACAATGGT,0,1835306
hyuA_predicted,0.08333333333333333,11,11,GGGGGCCAAACCGGTATTGC,0,1863639
hyuA_predicted,0.08333333333333333,11,11,GGGGAAATTAAGGAGGTCAG,0,1866552
hyuA_predicted,0.08333333333333333,11,11,GGGCTAATCGTACACTCCTT,0,1866905
hyuA_predicted,0.08333333333333333,11,11,GGGAAATGTTGTTCATCCCC,0,1833490
hyuA_predicted,0.08333333333333333,11,11,GGCCCCGCTCAGGTACCCCG,0,1870182
hyuA_predicted,0.08333333333333333,11,11,GGCCATAAGTGAGCTTCGCG,0,1876983
hyuA_predicted,0.08333333333333333,11,11,GGATGACGGATATTTTCTCT,0,1838548
hyuA_predicted,0.08333333333333333,11,11,GGACGAGCGAATGAGGGGCT,0,1835283
hyuA_predicted,0.08333333333333333,11,11,GGAATCTCGGTAAAGTTAAC,0,1877385
hyuA_predicted,0.08333333333333333,11,11,GGAAATACGGTGTGACTATG,0,1861472
hyuA_predicted,0.08333333333333333,11,11,GCTCTTTGGCTCAATGTTAC,0,1861664
hyuA_predicted,0.08333333333333333,11,11,GCTAAAACATCACGTGATGA,0,1877256
hyuA_predicted,0.08333333333333333,11,11,GCGTTGTTGTGTACGGACGA,0,1853037
hyuA_predicted,0.08333333333333333,11,11,GCGGGCCGCCCGGTGTTTTA,0,1857928
hyuA_predicted,0.08333333333333333,11,11,GCGGCATTTCATATCACGGC,0,1854240
hyuA_predicted,0.08333333333333333,11,11,GCCTGATCGGTGCATCTTCT,0,1849518
hyuA_predicted,0.08333333333333333,11,11,GCCTCATGGGGGATGCAACA,0,1862656
hyuA_predicted,0.08333333333333333,11,11,GCCCAGAGCAAAGGGTTTCA,0,1868623
hyuA_predicted,0.08333333333333333,11,11,GCCATTGAGCACGGAACGTA,0,1876440
hyuA_predicted,0.08333333333333333,11,11,GCCATTCTGCCTTCCATCGA,0,1858926
hyuA_predicted,0.08333333333333333,11,11,GCCATCAGGGGGGAATTCGT,0,1867268
hyuA_predicted,0.08333333333333333,11,11,GCCAGTTCTAGAAGCATATC,0,1865176
hyuA_predicted,0.08333333333333333,11,11,GCAGCGTATTTAAGGGGGAT,0,1860260
hyuA_predicted,0.08333333333333333,11,11,GCAGAGCATACAGAGCTTAA,0,1831893
hyuA_predicted,0.08333333333333333,11,11,GCAACTCCTCGTGTTACTCT,0,1833569
hyuA_predicted,0.08333333333333333,11,11,GCAAATGAATGAGTGAAGTA,0,1832974
hyuA_predicted,0.08333333333333333,11,11,GATGGAATATCCATTCTTTC,0,1866599
hyuA_predicted,0.08333333333333333,11,11,GATCATGCCTAGCAATTGAA,0,1860781
hyuA_predicted,0.08333333333333333,11,11,GAGTGGGCCGATGCCTTACT,0,1857729
hyuA_predicted,0.08333333333333333,11,11,GAGAAAACACTCTCACATGT,0,1842725
hyuA_predicted,0.08333333333333333,11,11,GACTTTTTCATTCGGGGTAG,0,1862401
hyuA_predicted,0.08333333333333333,11,11,GACGGGCTACTGGACCTACT,0,1837773
hyuA_predicted,0.08333333333333333,11,11,GACACAACTATATTGAAATT,0,1855831
hyuA_predicted,0.08333333333333333,11,11,GAATTAAAACTCGCCAGAAG,0,1854751
hyuA_predicted,0.08333333333333333,11,11,GAACGTGCAGCGTCCCTTCC,0,1832969
hyuA_predicted,0.08333333333333333,11,11,GAACGGCTATGCGTAGGCCA,0,1866234
hyuA_predicted,0.08333333333333333,11,11,GAAATGTCGTTACTACGATT,0,1866861
hyuA_predicted,0.08333333333333333,11,11,GAAATGGGCAAGTGAGACGA,0,1864210
hyuA_predicted,0.08333333333333333,11,11,CTTTCGACGCCTAAAATCGT,0,1834090
hyuA_predicted,0.08333333333333333,11,11,CTTTCATGGAAATGTACCAG,0,1850927
hyuA_predicted,0.08333333333333333,11,11,CTTCCAAACTCACAATCGCG,0,1873731
hyuA_predicted,0.08333333333333333,11,11,CTTCAGTTTATTAACAGACA,0,1846983
hyuA_predicted,0.08333333333333333,11,11,CTTCAGTGACGACGGGTTGA,0,1852010
hyuA_predicted,0.08333333333333333,11,11,CTTCAGAGGGGCAATTGGAG,0,1834092
hyuA_predicted,0.08333333333333333,11,11,CTTACGTTAGTTATAAAAGC,0,1844763
hyuA_predicted,0.08333333333333333,11,11,CTGCGGCATAAAAGGGCTGA,0,1840663
hyuA_predicted,0.08333333333333333,11,11,CTGAATGACACTAATGTGGA,0,1866237
hyuA_predicted,0.08333333333333333,11,11,CTCACTGATAGCGCATGGAA,0,1856368
hyuA_predicted,0.08333333333333333,11,11,CTCACGTTCTGTATGTCACA,0,1867132
hyuA_predicted,0.08333333333333333,11,11,CTAGGGCTTTACCACGAGGG,0,1836492
hyuA_predicted,0.08333333333333333,11,11,CTACTCGCCACGGGGTTGAA,0,1864052
hyuA_predicted,0.08333333333333333,11,11,CTAACCCGTTCCATTGAAGT,0,1864881
hyuA_predicted,0.08333333333333333,11,11,CGTTGGGCTTGCGATTAAGT,0,1875357
hyuA_predicted,0.08333333333333333,11,11,CGTCTGTGGGACCTGATTTT,0,1855943
hyuA_predicted,0.08333333333333333,11,11,CGTAGCGCACGGGCTGACGG,0,1850556
hyuA_predicted,0.08333333333333333,11,11,CGGGTATTTCCCCGTTGTGC,0,1831403
hyuA_predicted,0.08333333333333333,11,11,CGGGCGTCCAATTTACGTAT,0,1865502
hyuA_predicted,0.08333333333333333,11,11,CGGCATAATATATCTCCTAT,0,1830286
hyuA_predicted,0.08333333333333333,11,11,CGGAAAGCTTTATCACGTAT,0,1834533
hyuA_predicted,0.08333333333333333,11,11,CGCGCATTGGCCTCTCCTGA,0,1864440
hyuA_predicted,0.08333333333333333,11,11,CGACTTATAAGCGTACAGGT,0,1842248
hyuA_predicted,0.08333333333333333,11,11,CGAATGAAGTAGACGCTCTA,0,1840561
hyuA_predicted,0.08333333333333333,11,11,CGAAGGGATCTTGGGGATAT,0,1866862
hyuA_predicted,0.08333333333333333,11,11,CGAACAACACATACGCCCAC,0,1875976
hyuA_predicted,0.08333333333333333,11,11,CCGCTCTCGCTATAAGACCC,0,1865123
hyuA_predicted,0.08333333333333333,11,11,CCGCGGCCAATTTTTCTATG,0,1861031
hyuA_predicted,0.08333333333333333,11,11,CCCTTGGTAGTATGCAAACT,0,1870205
hyuA_predicted,0.08333333333333333,11,11,CCCTATTCAGATCCGTCGCT,0,1850642
hyuA_predicted,0.08333333333333333,11,11,CCCGCGTACCCTACTTGGGT,0,1873914
hyuA_predicted,0.08333333333333333,11,11,CCCGCCCGAGTACGTGAAAC,0,1870746
hyuA_predicted,0.08333333333333333,11,11,CCCAAGTCTGGTGCACCAAA,0,1854651
hyuA_predicted,0.08333333333333333,11,11,CCAACGCTCATCAGCCTTGC,0,1839694
hyuA_predicted,0.08333333333333333,11,11,CCAACGACCTAAGACACGGT,0,1869622
hyuA_predicted,0.08333333333333333,11,11,CATTTTAGGTCTCGGCTCTA,0,1871338
hyuA_predicted,0.08333333333333333,11,11,CATTTCGCCCTGCGGACATT,0,1840390
hyuA_predicted,0.08333333333333333,11,11,CATTCGCCATTCGTGTCGAA,0,1833800
hyuA_predicted,0.08333333333333333,11,11,CATTCAAAGACAGTCACCAT,0,1835962
hyuA_predicted,0.08333333333333333,11,11,CATTAGACACGAGCTCAAAC,0,1863761
hyuA_predicted,0.08333333333333333,11,11,CATGTAAGTTGCTCATATGA,0,1859465
hyuA_predicted,0.08333333333333333,11,11,CAGTTCGAAGTACAGCCGGG,0,1829104
hyuA_predicted,0.08333333333333333,11,11,CAGTAGGGGCCGGGGGGACA,0,1856689
hyuA_predicted,0.08333333333333333,11,11,CAGCACGACTCTGCAAGCCC,0,1831339
hyuA_predicted,0.08333333333333333,11,11,CAGAGTCTTAGTTCAGTTCC,0,1859519
hyuA_predicted,0.08333333333333333,11,11,CACGCGCTGGTACGGTTTAA,0,1868699
hyuA_predicted,0.08333333333333333,11,11,CAACGGGCCAGTATACTACT,0,1865673
hyuA_predicted,0.08333333333333333,11,11,CAAAATTTGCCGCGGTTCAG,0,1832210
hyuA_predicted,0.08333333333333333,11,11,CAAAATATATGACCGTCTGG,0,1870227
hyuA_predicted,0.08333333333333333,11,11,ATTGTTGCGAGGACACGTTC,0,1864097
hyuA_predicted,0.08333333333333333,11,11,ATTGGCTTGGCGGGGACATA,0,1845843
hyuA_predicted,0.08333333333333333,11,11,ATGCTTAACTACCTGAGTAA,0,1842603
hyuA_predicted,0.08333333333333333,11,11,ATGAATTTACGAAGGAAGTC,0,1834910
hyuA_predicted,0.08333333333333333,11,11,ATCTTTTAAGGACTAAGCTG,0,1856862
hyuA_predicted,0.08333333333333333,11,11,ATCTCCGCCAAATACTGCTG,0,1837929
hyuA_predicted,0.08333333333333333,11,11,ATCGTCCCGATTCCAGCCTT,0,1852745
hyuA_predicted,0.08333333333333333,11,11,ATCCTCGAGGCCTCTACACA,0,1833275
hyuA_predicted,0.08333333333333333,11,11,ATCCGGAGAGCGACAAAAGG,0,1852955
hyuA_predicted,0.08333333333333333,11,11,ATATTTGCGAGCACGTCAAA,0,1837700
hyuA_predicted,0.08333333333333333,11,11,ATAGTACCTACAGAGGTCGT,0,1862067
hyuA_predicted,0.08333333333333333,11,11,ATAGCCGAATTTCGGGCAGG,0,1831297
hyuA_predicted,0.08333333333333333,11,11,ATACATCCGTTAGTCACGTT,0,1874127
hyuA_predicted,0.08333333333333333,11,11,AGTTAGCGATAGAAGCAAAT,0,1839861
hyuA_predicted,0.08333333333333333,11,11,AGTGTAAGGTACTACTAAGA,0,1863844
hyuA_predicted,0.08333333333333333,11,11,AGGGGCGCAAGAACGTTGGG,0,1847545
hyuA_predicted,0.08333333333333333,11,11,AGGCGGATCTTCACAGTATT,0,1864784
hyuA_predicted,0.08333333333333333,11,11,AGGCCGTGACGCAAAGAGTA,0,1875182
hyuA_predicted,0.08333333333333333,11,11,AGATTTGTGAGTCTCGTATG,0,1861199
hyuA_predicted,0.08333333333333333,11,11,AGATTGAACTTCGCGGAGGC,0,1829037
hyuA_predicted,0.08333333333333333,11,11,AGATTACCCGTGTTCCCGTT,0,1841222
hyuA_predicted,0.08333333333333333,11,11,AGAAGCGGCCTTGCCGGTAA,0,1856207
hyuA_predicted,0.08333333333333333,11,11,AGAACCGCTTACGGCGGCAT,0,1840511
hyuA_predicted,0.08333333333333333,11,11,AGAAAGTTCGTCCGTGTGAT,0,1861564
hyuA_predicted,0.08333333333333333,11,11,ACTGTTAGTGGGGCGGCGTC,0,1837667
hyuA_predicted,0.08333333333333333,11,11,ACTCTCTAGCTTTATTACAT,0,1867721
hyuA_predicted,0.08333333333333333,11,11,ACTCATCTCATGGAAAATAC,0,1862001
hyuA_predicted,0.08333333333333333,11,11,ACTCAGAGAGCCTTCCTCTG,0,1873794
hyuA_predicted,0.08333333333333333,11,11,ACGTACTGCTAATTTAAATG,0,1849433
hyuA_predicted,0.08333333333333333,11,11,ACGCTCCTCAATCATCAAGT,0,1852712
hyuA_predicted,0.08333333333333333,11,11,ACCTCCGTCCTAATCGGGAT,0,1865486
hyuA_predicted,0.08333333333333333,11,11,ACCCGGAAGGAAGACTAAGA,0,1868811
hyuA_predicted,0.08333333333333333,11,11,ACCCGAGTCGCCATTCGATC,0,1842669
hyuA_predicted,0.08333333333333333,11,11,ACCATCTCTTGTGGTACGGT,0,1863908
hyuA_predicted,0.08333333333333333,11,11,ACCATCAAAGTACAGGTACC,0,1828972
hyuA_predicted,0.08333333333333333,11,11,ACCAGCTCCGCCGTACTGCT,0,1838803
hyuA_predicted,0.08333333333333333,11,11,ACATTTGACGGTGAAGAGTC,0,1849649
hyuA_predicted,0.08333333333333333,11,11,ACATGTTCGGTACGAGGTTA,0,1850892
hyuA_predicted,0.08333333333333333,11,11,ACATGACCCTCAATCGCGAT,0,1871391
hyuA_predicted,0.08333333333333333,11,11,ACAGGTAGGTCCAGAACGAC,0,1842600
hyuA_predicted,0.08333333333333333,11,11,ACACAATTTAGCCCCCGTTA,0,1872404
hyuA_predicted,0.08333333333333333,11,11,ACAACTTATCTATCGAAACA,0,1851397
hyuA_predicted,0.08333333333333333,11,11,ACAAACCTCCGTGTGATGTA,0,1832512
hyuA_predicted,0.08333333333333333,11,11,AATTCTGAAAGCCTCATACA,0,1859575
hyuA_predicted,0.08333333333333333,11,11,AATCTCAAGGGCGCTGTCAG,0,1875303
hyuA_predicted,0.08333333333333333,11,11,AATAGTCTGTCGCCTCTACA,0,1833485
hyuA_predicted,0.08333333333333333,11,11,AAGCATGAGGGCTTGGTCGT,0,1836058
hyuA_predicted,0.08333333333333333,11,11,AACTAGAGGGCAAACTTTAT,0,1877392
hyuA_predicted,0.08333333333333333,11,11,AACCGGTAGGCTGGACCAAT,0,1868869
hyuA_predicted,0.08333333333333333,11,11,AACATACTTTCTGCTGCTTC,0,1844576
hyuA_predicted,0.08333333333333333,11,11,AAATTGCTCCATAGGATATT,0,1841886
hyuA_predicted,0.08333333333333333,11,11,AAACTTTGTCGTAAGGAAAT,0,1834036
hyuA_predicted,0.08333333333333333,11,11,AAACCCGTCACCAGATTGGA,0,1868409
hyuA_predicted,0.09090909090909091,10,10,TTTTGCAGAGGTTCGAGGGT,0,1876592
hyuA_predicted,0.09090909090909091,10,10,TTTGCACTCGAAAAGTTCAG,0,1876433
hyuA_predicted,0.09090909090909091,10,10,TTTACGGTCTGATTCGCAAA,0,1852352
hyuA_predicted,0.09090909090909091,10,10,TTGTTCTCAGTTAACTGGTT,0,1843286
hyuA_predicted,0.09090909090909091,10,10,TTGGAGCGAGAAATTGGTCA,0,1869645
hyuA_predicted,0.09090909090909091,10,10,TTGATACTATTGGTACAACT,0,1835839
hyuA_predicted,0.09090909090909091,10,10,TTGAGATACAACTAGGATGC,0,1852283
hyuA_predicted,0.09090909090909091,10,10,TTCGTCGATTGTGAAACACT,0,1834487
hyuA_predicted,0.09090909090909091,10,10,TTCGGAAAAGGAGTGCTCCA,0,1861615
hyuA_predicted,0.09090909090909091,10,10,TTCATGCCAGTCCGCACGGA,0,1835126
hyuA_predicted,0.09090909090909091,10,10,TTCAAGGGACTCAAACGTAT,0,1836318
hyuA_predicted,0.09090909090909091,10,10,TTAGTGCAAGACGGGTAGGG,0,1845964
hyuA_predicted,0.09090909090909091,10,10,TTACTTTCTTCAACGTGCAT,0,1874661
hyuA_predicted,0.09090909090909091,10,10,TTACCAGCGGCCGCCATACT,0,1852098
hyuA_predicted,0.09090909090909091,10,10,TTACACTTGATGCACTCTAC,0,1870407
hyuA_predicted,0.09090909090909091,10,10,TTAAAGTCCTTTCCCTCCAC,0,1835637
hyuA_predicted,0.09090909090909091,10,10,TGTTGCTCTAGTACGCTCAC,0,1848728
hyuA_predicted,0.09090909090909091,10,10,TGTTAGAATATGAGTTACGT,0,1843594
hyuA_predicted,0.09090909090909091,10,10,TGTGCGCCAGTGTAAATATA,0,1876217
hyuA_predicted,0.09090909090909091,10,10,TGTGCGCAAGCCGATTGTTG,0,1874630
hyuA_predicted,0.09090909090909091,10,10,TGTCCCGGGTTCAGTATCAG,0,1845096
hyuA_predicted,0.09090909090909091,10,10,TGTATGAAGGGACGCTGTGG,0,1868882
hyuA_predicted,0.09090909090909091,10,10,TGGGTTGATCATTACATCGT,0,1850547
hyuA_predicted,0.09090909090909091,10,10,TGGGCGCAACATATTTGCCA,0,1831093
hyuA_predicted,0.09090909090909091,10,10,TGGCCTGCCATGTTTTGTTA,0,1844355
hyuA_predicted,0.09090909090909091,10,10,TGGCCTACCTTATGGCCAGA,0,1840015
hyuA_predicted,0.09090909090909091,10,10,TGGAACGTCGTCCACAATGG,0,1840380
hyuA_predicted,0.09090909090909091,10,10,TGCCACGGGGAAGACTCATA,0,1870678
hyuA_predicted,0.09090909090909091,10,10,TGCATGCCATCGAACTAGCT,0,1863753
hyuA_predicted,0.09090909090909091,10,10,TGCACGCGATTGTCCTTGAA,0,1845427
hyuA_predicted,0.09090909090909091,10,10,TGATTTGTGAGGAAAATTAC,0,1853356
hyuA_predicted,0.09090909090909091,10,10,TGATGACAGACTTCGCGGCT,0,1864471
hyuA_predicted,0.09090909090909091,10,10,TGAATGATAACTGATAAGAT,0,1832080
hyuA_predicted,0.09090909090909091,10,10,TCTTGGGGCTTGGTGAAAGC,0,1874867
hyuA_predicted,0.09090909090909091,10,10,TCTAGGCCCATTCAGAGCTT,0,1870393
hyuA_predicted,0.09090909090909091,10,10,TCGTAGTGGTCCTTCTATAG,0,1874220
hyuA_predicted,0.09090909090909091,10,10,TCGGTAATTTCCACCAGGTT,0,1869435
hyuA_predicted,0.09090909090909091,10,10,TCGATACGATCCTGCTTCAC,0,1840305
hyuA_predicted,0.09090909090909091,10,10,TCATGCGTATGGGCTTTTGA,0,1835115
hyuA_predicted,0.09090909090909091,10,10,TCATAGCTGCGCGCTATTGA,0,1864206
hyuA_predicted,0.09090909090909091,10,10,TCAATGTGCCGTAGGCGCCA,0,1830155
hyuA_predicted,0.09090909090909091,10,10,TCAAATCGCCTGTGTGGTGT,0,1849265
hyuA_predicted,0.09090909090909091,10,10,TATCTTGCGGGAATACCTCA,0,1840026
hyuA_predicted,0.09090909090909091,10,10,TATCTGCCATACTTTTGGTA,0,1869274
hyuA_predicted,0.09090909090909091,10,10,TAGACAAATATATTTACTTG,0,1830180
hyuA_predicted,0.09090909090909091,10,10,TACTTAACTAAGTTCTAGGA,0,1833578
hyuA_predicted,0.09090909090909091,10,10,TACGGGGCAACAGAATCACG,0,1874435
hyuA_predicted,0.09090909090909091,10,10,TACCTTGGCGCAGCCGCAGA,0,1829884
hyuA_predicted,0.09090909090909091,10,10,TACCGGATGAGTTGCGTATT,0,1854863
hyuA_predicted,0.09090909090909091,10,10,TAATGGACGGCCTATTAATT,0,1834879
hyuA_predicted,0.09090909090909091,10,10,TAACTCAGATGCTGAACTAC,0,1872170
hyuA_predicted,0.09090909090909091,10,10,TAAACTTTGTTGTCGGTCTT,0,1841725
hyuA_predicted,0.09090909090909091,10,10,GTTTGAATCTTTCGGCCAGT,0,1870243
hyuA_predicted,0.09090909090909091,10,10,GTTCCCGTTCAGTGTCTAGA,0,1846620
hyuA_predicted,0.09090909090909091,10,10,GTGTGCCTGGCAGTTACGTG,0,1856791
hyuA_predicted,0.09090909090909091,10,10,GTGTGATGTGCAGGGGTTGA,0,1839143
hyuA_predicted,0.09090909090909091,10,10,GTGGCCGCAACCGTGGAACG,0,1874375
hyuA_predicted,0.09090909090909091,10,10,GTGATACAACCTGGTCCTCC,0,1852252
hyuA_predicted,0.09090909090909091,10,10,GTGAGTTTCTCGCAGGGTAC,0,1831673
hyuA_predicted,0.09090909090909091,10,10,GTCGGGTAAAAAAGGTATTT,0,1873183
hyuA_predicted,0.09090909090909091,10,10,GTCGACACCACTGGCCGGGG,0,1869320
hyuA_predicted,0.09090909090909091,10,10,GTCGAAGTTCACATTGCCGT,0,1843265
hyuA_predicted,0.09090909090909091,10,10,GTCCCTCGGTGTTTTAAGCG,0,1837662
hyuA_predicted,0.09090909090909091,10,10,GTCCACGGTAGGGCTTTTCA,0,1865238
hyuA_predicted,0.09090909090909091,10,10,GTCCACCCCCCAAACAGCAT,0,1859914
hyuA_predicted,0.09090909090909091,10,10,GTCAGGCGGACTTGCCCAGA,0,1857776
hyuA_predicted,0.09090909090909091,10,10,GTCAGCTAGTTGCGGTGCAG,0,1844978
hyuA_predicted,0.09090909090909091,10,10,GTCAGCCGATGTGAACACTG,0,1836777
hyuA_predicted,0.09090909090909091,10,10,GTCACTTGAATGGTGTACTA,0,1873676
hyuA_predicted,0.09090909090909091,10,10,GTATCAGGGGTAAAGGCATG,0,1839571
hyuA_predicted,0.09090909090909091,10,10,GTAGGTTAAGTGTTCGCCCA,0,1850689
hyuA_predicted,0.09090909090909091,10,10,GTACTGCGTACTTGACTCAT,0,1867847
hyuA_predicted,0.09090909090909091,10,10,GTACTAGCCCAACATATCTG,0,1847909
hyuA_predicted,0.09090909090909091,10,10,GTAACGTGCAGTCGTTAAGA,0,1841835
hyuA_predicted,0.09090909090909091,10,10,GTAAAGTCTCTCGGCAGCCG,0,1857079
hyuA_predicted,0.09090909090909091,10,10,GTAAACCCGAGTAGGGGGTC,0,1865501
hyuA_predicted,0.09090909090909091,10,10,GGTTTACATATCGAATGTAT,0,1836323
hyuA_predicted,0.09090909090909091,10,10,GGTTACCTCCGCTCATGTGG,0,1869450
hyuA_predicted,0.09090909090909091,10,10,GGTACAAACGGGAGTAAATA,0,1872988
hyuA_predicted,0.09090909090909091,10,10,GGGTTCTCATAAATCTAAGA,0,1873952
hyuA_predicted,0.09090909090909091,10,10,GGGGTTCGTGCGCACGTTGC,0,1843660
hyuA_predicted,0.09090909090909091,10,10,GGGGTGGACATGTGGACTGA,0,1832396
hyuA_predicted,0.09090909090909091,10,10,GGGGGGTCACACTCATCTTG,0,1875709
hyuA_predicted,0.09090909090909091,10,10,GGGGACTGAGTCTAGCCGTG,0,1832247
hyuA_predicted,0.09090909090909091,10,10,GGGACAGGTATCCCCGTTCG,0,1865170
hyuA_predicted,0.09090909090909091,10,10,GGGAAGCCGCTGGGTTATGG,0,1863951
hyuA_predicted,0.09090909090909091,10,10,GGCTCGGCGGCGCTAACCGG,0,1867008
hyuA_predicted,0.09090909090909091,10,10,GGCGCTACCACACGTTTCTA,0,1857688
hyuA_predicted,0.09090909090909091,10,10,GGCGACATATAGAGACGTTT,0,1842571
hyuA_predicted,0.09090909090909091,10,10,GGCCGAGCCAGAGATAATTT,0,1840753
hyuA_predicted,0.09090909090909091,10,10,GGCCCGTCGGTTGCAAGATT,0,1859485
hyuA_predicted,0.09090909090909091,10,10,GGCATTTGAATCCAAAGGGA,0,1846128
hyuA_predicted,0.09090909090909091,10,10,GGCACGACACCTTAGCGTAT,0,1861314
hyuA_predicted,0.09090909090909091,10,10,GGAGTCCAGGCAACTAGAGA,0,1829358
hyuA_predicted,0.09090909090909091,10,10,GGAGCACTAATATACCTGGC,0,1836856
hyuA_predicted,0.09090909090909091,10,10,GGAGCAATTAAGGATAACGG,0,1839157
hyuA_predicted,0.09090909090909091,10,10,GGAACGGCGTTTTAGATGAA,0,1840940
hyuA_predicted,0.09090909090909091,10,10,GCTGTTGCTCGCCGGTGACC,0,1833894
hyuA_predicted,0.09090909090909091,10,10,GCTGTCATGGCGAGTGAGAT,0,1856915
hyuA_predicted,0.09090909090909091,10,10,GCTGTCATATCTGATCACGC,0,1872764
hyuA_predicted,0.09090909090909091,10,10,GCTGGCCGGTGTCGTATTTA,0,1858636
hyuA_predicted,0.09090909090909091,10,10,GCTCACTACCTTAACGCTTT,0,1875116
hyuA_predicted,0.09090909090909091,10,10,GCTAAATGGCTCCCCGCGGA,0,1873819
hyuA_predicted,0.09090909090909091,10,10,GCGGCCTGTCTTTTGAAGTA,0,1863293
hyuA_predicted,0.09090909090909091,10,10,GCGGACACAGCATGGATTGT,0,1874278
hyuA_predicted,0.09090909090909091,10,10,GCGCGCTCTGCATCTTAATC,0,1865338
hyuA_predicted,0.09090909090909091,10,10,GCGCCTAGAGCAACACACGG,0,1864878
hyuA_predicted,0.09090909090909091,10,10,GCGCCGGCCCTAGAGCGGCC,0,1860983
hyuA_predicted,0.09090909090909091,10,10,GCGCCACGCATGGGGAAGAC,0,1829875
hyuA_predicted,0.09090909090909091,10,10,GCGACGCTAAACGATGCAGC,0,1866503
hyuA_predicted,0.09090909090909091,10,10,GCGACCCGGGGCCACCAGTT,0,1829374
hyuA_predicted,0.09090909090909091,10,10,GCCGGAACGCCCATAGTCTG,0,1832237
hyuA_predicted,0.09090909090909091,10,10,GCCCCGTCATGGCAGTGGCG,0,1874340
hyuA_predicted,0.09090909090909091,10,10,GCATCCGGGAACATTGGAAG,0,1844962
hyuA_predicted,0.09090909090909091,10,10,GCAGCCATATCTCGTTTACA,0,1869859
hyuA_predicted,0.09090909090909091,10,10,GCAGATTCCGAGCATCTCAG,0,1872326
hyuA_predicted,0.09090909090909091,10,10,GATTTAACTGTGGCACAACT,0,1872875
hyuA_predicted,0.09090909090909091,10,10,GATCTACTGCAGCCTGCCAC,0,1863596
hyuA_predicted,0.09090909090909091,10,10,GATCGGCCTCCGCGATGTAA,0,1845997
hyuA_predicted,0.09090909090909091,10,10,GATCATCACCCTACCGGCCA,0,1873368
hyuA_predicted,0.09090909090909091,10,10,GATATCTTATGCACTATGCG,0,1867770
hyuA_predicted,0.09090909090909091,10,10,GATAAAGGGACCTGCTAGAG,0,1859361
hyuA_predicted,0.09090909090909091,10,10,GAGTTGGCCGCGCGCATCGG,0,1838802
hyuA_predicted,0.09090909090909091,10,10,GAGTTGAACTTTGGTGTAGA,0,1865695
hyuA_predicted,0.09090909090909091,10,10,GAGTTCTTATGCGTCGGAGA,0,1832579
hyuA_predicted,0.09090909090909091,10,10,GAGTTATCATTTTTACACAA,0,1840036
hyuA_predicted,0.09090909090909091,10,10,GAGGTGGGCATGGTGCGGTC,0,1839676
hyuA_predicted,0.09090909090909091,10,10,GAGGTCTGGATGTTTGCTAC,0,1858056
hyuA_predicted,0.09090909090909091,10,10,GAGACATGTCAGCCATAAGG,0,1862759
hyuA_predicted,0.09090909090909091,10,10,GACGGGTTTGGGGATGCGAT,0,1860369
hyuA_predicted,0.09090909090909091,10,10,GACGGCGCTAATATGATCCA,0,1877158
hyuA_predicted,0.09090909090909091,10,10,GACCGACAACGGATAAGTCG,0,1834859
hyuA_predicted,0.09090909090909091,10,10,GACCCCTACTAAAACGACGA,0,1870033
hyuA_predicted,0.09090909090909091,10,10,GACCACGTTACCTCACACTG,0,1866052
hyuA_predicted,0.09090909090909091,10,10,GACAACACGGGGACCTCTTC,0,1854965
hyuA_predicted,0.09090909090909091,10,10,CTTTTCCCAACGCACCGGCT,0,1870303
hyuA_predicted,0.09090909090909091,10,10,CTTTCGGCGAAGTAGAAGCG,0,1867563
hyuA_predicted,0.09090909090909091,10,10,CTTGTCCGAACCCAGCCACG,0,1830171
hyuA_predicted,0.09090909090909091,10,10,CTTCCGTGTATCGCAGGACA,0,1860541
hyuA_predicted,0.09090909090909091,10,10,CTTCAGCCATCCGGAAGGCA,0,1841344
hyuA_predicted,0.09090909090909091,10,10,CTTAAGAACAGTTCGTGAAT,0,1841776
hyuA_predicted,0.09090909090909091,10,10,CTGTTCCGAGGCGCCGCGCA,0,1847691
hyuA_predicted,0.09090909090909091,10,10,CTGCTAGAGTAGTTAAAGGG,0,1866571
hyuA_predicted,0.09090909090909091,10,10,CTGACGTGGCTCGGGGGCCT,0,1872432
hyuA_predicted,0.09090909090909091,10,10,CTCGCGAAGCACAGGACTTT,0,1844186
hyuA_predicted,0.09090909090909091,10,10,CTCCACAGGGTCTCGAAGAG,0,1849989
hyuA_predicted,0.09090909090909091,10,10,CTATTACCAAAAATAATAGG,0,1845949
hyuA_predicted,0.09090909090909091,10,10,CTATGTAGAGGGAAGCAATA,0,1843787
hyuA_predicted,0.09090909090909091,10,10,CTATGGTGAGAATGCTATTA,0,1832739
hyuA_predicted,0.09090909090909091,10,10,CTATACGGTACAGAACTCGA,0,1850152
hyuA_predicted,0.09090909090909091,10,10,CTAGGGATGTGGTGTTGAAA,0,1851376
hyuA_predicted,0.09090909090909091,10,10,CTACCCTACTCTTTGATGGA,0,1846723
hyuA_predicted,0.09090909090909091,10,10,CTACACCGGCCAAAGTGCGT,0,1851394
hyuA_predicted,0.09090909090909091,10,10,CTAATGGCGAATGTGGCGTT,0,1833260
hyuA_predicted,0.09090909090909091,10,10,CTAATATAGCTGCCTTCGTT,0,1860244
hyuA_predicted,0.09090909090909091,10,10,CTAACCTCTTTGCCGACTTG,0,1859325
hyuA_predicted,0.09090909090909091,10,10,CTAACAAACCGTGTGGAGGG,0,1855657
hyuA_predicted,0.09090909090909091,10,10,CTAAACTGGGGGGGCTAGGA,0,1848177
hyuA_predicted,0.09090909090909091,10,10,CGTTATTGGCGTATTTAAGT,0,1851828
hyuA_predicted,0.09090909090909091,10,10,CGTCACTATCCGGGCGAGCA,0,1853114
hyuA_predicted,0.09090909090909091,10,10,CGTACGCGTCGCTTTAACGA,0,1851800
hyuA_predicted,0.09090909090909091,10,10,CGGTTTAGCACGGGTAGTTC,0,1865084
hyuA_predicted,0.09090909090909091,10,10,CGGTGTGTGTAAAGGTACCC,0,1859839
hyuA_predicted,0.09090909090909091,10,10,CGGTGGTCTATGTTAAATTT,0,1857396
hyuA_predicted,0.09090909090909091,10,10,CGGTCGCAGTTCTCCTGATA,0,1847180
hyuA_predicted,0.09090909090909091,10,10,CGGTCCGGCATCGGAGTATC,0,1858350
hyuA_predicted,0.09090909090909091,10,10,CGGTAGTTCGGTGGTTTACA,0,1848794
hyuA_predicted,0.09090909090909091,10,10,CGGTACCTGGGCAAGGCGTT,0,1850306
hyuA_predicted,0.09090909090909091,10,10,CGGTAAAGATAATAACACAT,0,1840863
hyuA_predicted,0.09090909090909091,10,10,CGGGAGGCTGAGCACAATGA,0,1830147
hyuA_predicted,0.09090909090909091,10,10,CGGCGAACGGATACACGCAA,0,1858410
hyuA_predicted,0.09090909090909091,10,10,CGGCGAAACCACATGCGTCC,0,1832033
hyuA_predicted,0.09090909090909091,10,10,CGCTTCTTCCGCGCAGCAAG,0,1872679
hyuA_predicted,0.09090909090909091,10,10,CGCGCACTACAGAAGCACTT,0,1864145
hyuA_predicted,0.09090909090909091,10,10,CGCCGTTTCCTTGGACTATA,0,1844726
hyuA_predicted,0.09090909090909091,10,10,CGCCGCTACATTTAACTATT,0,1863202
hyuA_predicted,0.09090909090909091,10,10,CGCCCACATTTTCACCAGTC,0,1861572
hyuA_predicted,0.09090909090909091,10,10,CGCCATGCATCGCTACATCT,0,1854954
hyuA_predicted,0.09090909090909091,10,10,CGCATCTAATCCAACTTATG,0,1855426
hyuA_predicted,0.09090909090909091,10,10,CGCAAGCTCCATCTCGGACC,0,1848125
hyuA_predicted,0.09090909090909091,10,10,CGCAAATGCGCACAGCCTTT,0,1833749
hyuA_predicted,0.09090909090909091,10,10,CGATTGTATGAACTTACGGC,0,1867379
hyuA_predicted,0.09090909090909091,10,10,CGAACCTTTGTACTGACACT,0,1872927
hyuA_predicted,0.09090909090909091,10,10,CGAAAGTAAACTGCGGTTCC,0,1845504
hyuA_predicted,0.09090909090909091,10,10,CCTTTCTATACGGTCGTTTT,0,1836371
hyuA_predicted,0.09090909090909091,10,10,CCTTAAGTACCAGTGCACTA,0,1843471
hyuA_predicted,0.09090909090909091,10,10,CCGTCCGGGTCCGTCCGAAT,0,1874950
hyuA_predicted,0.09090909090909091,10,10,CCGCGAGCAGCGAAAGGGAA,0,1866403
hyuA_predicted,0.09090909090909091,10,10,CCCTTGCAGAAATTTTCACG,0,1873863
hyuA_predicted,0.09090909090909091,10,10,CCCTCTGGCGGTTCTAAACT,0,1845206
hyuA_predicted,0.09090909090909091,10,10,CCCGTTTGGCGCCAAGGCTT,0,1844916
hyuA_predicted,0.09090909090909091,10,10,CCCGCCTAAAAATCCCGGAC,0,1869193
hyuA_predicted,0.09090909090909091,10,10,CCCCCAGTGTGGAAACGATG,0,1876229
hyuA_predicted,0.09090909090909091,10,10,CCCAGCGGTGGAAGAGACCA,0,1832445
hyuA_predicted,0.09090909090909091,10,10,CCCAATCGTAAACGCAGGCA,0,1858801
hyuA_predicted,0.09090909090909091,10,10,CCAAGGGAGGATTGCTTACT,0,1862986
hyuA_predicted,0.09090909090909091,10,10,CCAACCCCTTGCTGGGTCTT,0,1831784
hyuA_predicted,0.09090909090909091,10,10,CCAACAAGAAATAAGGTGCA,0,1847079
hyuA_predicted,0.09090909090909091,10,10,CATTTAGGGCAGGCAGTCCA,0,1846440
hyuA_predicted,0.09090909090909091,10,10,CATTAAGTCGGGTAGCCATT,0,1861865
hyuA_predicted,0.09090909090909091,10,10,CATGGTTTAATCAGTTATGA,0,1877558
hyuA_predicted,0.09090909090909091,10,10,CATGCTGCGTATATCCAAGG,0,1843166
hyuA_predicted,0.09090909090909091,10,10,CATGAACGGGAGGGGTGCTT,0,1862457
hyuA_predicted,0.09090909090909091,10,10,CATACGTATCGAAGATGCTA,0,1830321
hyuA_predicted,0.09090909090909091,10,10,CATACGCAAAACCTTCCGGG,0,1876346
hyuA_predicted,0.09090909090909091,10,10,CAGGTTTCAAGCGCATTTGC,0,1853733
hyuA_predicted,0.09090909090909091,10,10,CACCGGCCCGTCAGGCGGCA,0,1858959
hyuA_predicted,0.09090909090909091,10,10,CAATTATTTAACTGTTATAG,0,1834622
hyuA_predicted,0.09090909090909091,10,10,CAATGCGTACTCAATCTATG,0,1832340
hyuA_predicted,0.09090909090909091,10,10,CAATATACCTAGTACCAACA,0,1869346
hyuA_predicted,0.09090909090909091,10,10,CAAGCAGTCTACCCAGGGCA,0,1855573
hyuA_predicted,0.09090909090909091,10,10,CAACGTTTTCTGTATAACTT,0,1865331
hyuA_predicted,0.09090909090909091,10,10,CAACGGTTCCAGTGGAGAAG,0,1870355
hyuA_predicted,0.09090909090909091,10,10,CAACATAGAGGCTGCGTGAG,0,1860314
hyuA_predicted,0.09090909090909091,10,10,ATTTTTTATCTGCCTAGTGG,0,1853410
hyuA_predicted,0.09090909090909091,10,10,ATTGGACACTGCTGCAGGAT,0,1871874
hyuA_predicted,0.09090909090909091,10,10,ATGTCAAAGATGATATAGTG,0,1834623
hyuA_predicted,0.09090909090909091,10,10,ATGGGTTTACCGTCCTTACA,0,1854966
hyuA_predicted,0.09090909090909091,10,10,ATGGGCTCAGTTTGGGCGTA,0,1874667
hyuA_predicted,0.09090909090909091,10,10,ATGGCAACATTGGTTCCTTT,0,1836283
hyuA_predicted,0.09090909090909091,10,10,ATGCTGGCATGCCGAGCGGA,0,1840016
hyuA_predicted,0.09090909090909091,10,10,ATGCCAAGGAGAACAGGCTT,0,1853235
hyuA_predicted,0.09090909090909091,10,10,ATGCATCAGCTTTTGGGGTT,0,1835433
hyuA_predicted,0.09090909090909091,10,10,ATGCAAAGGTGAGTCAGTTC,0,1873491
hyuA_predicted,0.09090909090909091,10,10,ATGATCTTCTGCCATTTCCG,0,1875487
hyuA_predicted,0.09090909090909091,10,10,ATCTCAGCGAAAGGGGGGTA,0,1841909
hyuA_predicted,0.09090909090909091,10,10,ATCGTCTCTGTCCGGGTTTT,0,1846534
hyuA_predicted,0.09090909090909091,10,10,ATCGCCTCGAAAAGCAACGC,0,1854288
hyuA_predicted,0.09090909090909091,10,10,ATCCTCCTAGGAGCACAGCG,0,1868170
hyuA_predicted,0.09090909090909091,10,10,ATCCCGATCGAAACATAGCG,0,1867338
hyuA_predicted,0.09090909090909091,10,10,ATCATTAGTCCTACCAGAAC,0,1876417
hyuA_predicted,0.09090909090909091,10,10,ATCAGTTTATAGAGTGCGCC,0,1871566
hyuA_predicted,0.09090909090909091,10,10,ATAGTGGTACGCGTTTCGCA,0,1847122
hyuA_predicted,0.09090909090909091,10,10,ATAGGCGATTAACTTGTCTT,0,1850528
hyuA_predicted,0.09090909090909091,10,10,ATAGCGCCGACCCCAAGAGT,0,1831151
hyuA_predicted,0.09090909090909091,10,10,ATAGCAGTGACCTAAACGGG,0,1856493
hyuA_predicted,0.09090909090909091,10,10,ATACCATACAGGTACTGTAT,0,1841608
hyuA_predicted,0.09090909090909091,10,10,ATACAGCCAGTTCGCAATAA,0,1836457
hyuA_predicted,0.09090909090909091,10,10,ATAAGCGGCAGGACGGAACA,0,1829799
hyuA_predicted,0.09090909090909091,10,10,AGTTGATTTTCGCTGGCAAA,0,1831074
hyuA_predicted,0.09090909090909091,10,10,AGTCTACGTCTTCACGCTAC,0,1848325
hyuA_predicted,0.09090909090909091,10,10,AGTAGTTTAGTCTTATACAT,0,1868261
hyuA_predicted,0.09090909090909091,10,10,AGTAACGTTTGAGAAGCGAT,0,1868560
hyuA_predicted,0.09090909090909091,10,10,AGGTTGGAAAGGGACTCGAC,0,1831385
hyuA_predicted,0.09090909090909091,10,10,AGGTCACGCGGAGCACTAAA,0,1872730
hyuA_predicted,0.09090909090909091,10,10,AGGGGCTTGTATCAGGTGAA,0,1849032
hyuA_predicted,0.09090909090909091,10,10,AGGAGGGCCTTAACTAAAAA,0,1858641
hyuA_predicted,0.09090909090909091,10,10,AGCCCTATCGGGAAGAGACC,0,1866582
hyuA_predicted,0.09090909090909091,10,10,AGCATTTATGAAATCGTGAC,0,1857423
hyuA_predicted,0.09090909090909091,10,10,AGCACTATAGACTACTGTTA,0,1833095
hyuA_predicted,0.09090909090909091,10,10,AGCAATCCCTCGCACAAATA,0,1834621
hyuA_predicted,0.09090909090909091,10,10,AGATCAGGCCAGTAACAAAG,0,1855453
hyuA_predicted,0.09090909090909091,10,10,AGAGGGGTGTGCTGAGCTTA,0,1870392
hyuA_predicted,0.09090909090909091,10,10,AGAGGAAACCTGTTTCCCCG,0,1876166
hyuA_predicted,0.09090909090909091,10,10,AGAACGGGTCGGACGTTCTG,0,1860753
hyuA_predicted,0.09090909090909091,10,10,ACTTAGGGGGGACCCGCATC,0,1842699
hyuA_predicted,0.09090909090909091,10,10,ACTGTCCGACGTAAGAAGCT,0,1865580
hyuA_predicted,0.09090909090909091,10,10,ACTCTCGGGTTAGCTAGCCA,0,1877740
hyuA_predicted,0.09090909090909091,10,10,ACGGCGTGTCGCTCAGACAA,0,1871505
hyuA_predicted,0.09090909090909091,10,10,ACGCCGTACACCACGGTGAT,0,1863705
hyuA_predicted,0.09090909090909091,10,10,ACCCGCCTACCGACGCGGTA,0,1860382
hyuA_predicted,0.09090909090909091,10,10,ACATTCTACCACATGCAGCC,0,1864830
hyuA_predicted,0.09090909090909091,10,10,ACAAGATACATCAAGTCGAA,0,1851996
hyuA_predicted,0.09090909090909091,10,10,AATTGTCGAACGGAAAATCA,0,1858777
hyuA_predicted,0.09090909090909091,10,10,AATTACTCGCATCAGACATG,0,1862700
hyuA_predicted,0.09090909090909091,10,10,AATGTTATCATCCCTCTTCT,0,1843404
hyuA_predicted,0.09090909090909091,10,10,AATGCTTGCCTTTATCAGAA,0,1875454
hyuA_predicted,0.09090909090909091,10,10,AATGCATGGAGAGTCACAGC,0,1839839
hyuA_predicted,0.09090909090909091,10,10,AATCACGCCTACGCGAGTAT,0,1853531
hyuA_predicted,0.09090909090909091,10,10,AATAGTCATTTTGGTTTTAC,0,1833287
hyuA_predicted,0.09090909090909091,10,10,AATACTTGGCATTTTCTCGG,0,1868115
hyuA_predicted,0.09090909090909091,10,10,AATAACACATGGGGCGGGGG,0,1840131
hyuA_predicted,0.09090909090909091,10,10,AAGGTTGTAATTGACTTGTC,0,1854538
hyuA_predicted,0.09090909090909091,10,10,AAGATTGCCCTTCAGGGGTG,0,1844063
hyuA_predicted,0.09090909090909091,10,10,AAGAGTACACATTTTCGTCG,0,1847036
hyuA_predicted,0.09090909090909091,10,10,AAGAGGCTTCTTTATTCGTA,0,1848950
hyuA_predicted,0.09090909090909091,10,10,AACTTCGACTGAGTCCCAGT,0,1843536
hyuA_predicted,0.09090909090909091,10,10,AACATTCGGCTATTATGCAT,0,1842309
hyuA_predicted,0.09090909090909091,10,10,AACATGGTATGGGGTACCGA,0,1837703
hyuA_predicted,0.09090909090909091,10,10,AACACAAACCTGGTCCGCCT,0,1875153
hyuA_predicted,0.09090909090909091,10,10,AAAGTTTGTACGTTTAAAGC,0,1871725
hyuA_predicted,0.09090909090909091,10,10,AAACAGCTAGGAGCGAAATG,0,1859136
hyuA_predicted,0.09090909090909091,10,10,AAAATTTGTTCGTGCTAGCA,0,1840433
hyuA_predicted,0.09090909090909091,10,10,AAAAGCTGTTGTATTCGAGC,0,1837055
hyuA_predicted,0.1,9,9,TTTTTATAGTACTTCCTAGA,0,1863838
hyuA_predicted,0.1,9,9,TTTTATAGATGACAGATTGT,0,1876863
hyuA_predicted,0.1,9,9,TTTGGCTGTGCATCTTTCGC,0,1864154
hyuA_predicted,0.1,9,9,TTTGCGCCACACTATGACGA,0,1863602
hyuA_predicted,0.1,9,9,TTTGCCCGGGACATAATAAA,0,1830719
hyuA_predicted,0.1,9,9,TTTCGTTACCGGGAAACGCA,0,1848735
hyuA_predicted,0.1,9,9,TTTCCTATCTGGAAGTCGGT,0,1843462
hyuA_predicted,0.1,9,9,TTTACCTGTGTTCTCAGGGA,0,1872526
hyuA_predicted,0.1,9,9,TTTAATTGCACAGGGGCTAT,0,1861136
hyuA_predicted,0.1,9,9,TTGTTCCTCCTATGGCGAGT,0,1849491
hyuA_predicted,0.1,9,9,TTGAATGGGAAGGAAACAGT,0,1863722
hyuA_predicted,0.1,9,9,TTGAAGTTGGCCGTGAGTCT,0,1830018
hyuA_predicted,0.1,9,9,TTCTGCTGGACGAGTCAAGA,0,1877627
hyuA_predicted,0.1,9,9,TTAGTTAAGGAACGTAACAA,0,1829629
hyuA_predicted,0.1,9,9,TTAGTCCGCGGCTGAATGGG,0,1836847
hyuA_predicted,0.1,9,9,TTAGAGAAGCGGCCGCAGTC,0,1855445
hyuA_predicted,0.1,9,9,TTAACGTAAACAAGCGCAGA,0,1875095
hyuA_predicted,0.1,9,9,TGTTGCCGGTTGTTTCTTAA,0,1847587
hyuA_predicted,0.1,9,9,TGTTATTTTTGCGGGGGCAT,0,1869955
hyuA_predicted,0.1,9,9,TGTGGAACACTAACACTAGC,0,1830965
hyuA_predicted,0.1,9,9,TGTGATTCTGTGGAGGTGCG,0,1856394
hyuA_predicted,0.1,9,9,TGTCTGTGTCGGGCGTGGAT,0,1871534
hyuA_predicted,0.1,9,9,TGTAGACTTTTACGGACCGA,0,1832255
hyuA_predicted,0.1,9,9,TGGTGTCAGAACTATTCTTT,0,1843416
hyuA_predicted,0.1,9,9,TGGCGAAGATCCATACAGCG,0,1841122
hyuA_predicted,0.1,9,9,TGGACGTACGGCTGGTATTA,0,1870996
hyuA_predicted,0.1,9,9,TGCTTTGTAGATATTGAAAA,0,1850600
hyuA_predicted,0.1,9,9,TGCGGACGGCTACCGCTGTA,0,1845355
hyuA_predicted,0.1,9,9,TGATTGGCTAGAATACTGGC,0,1837800
hyuA_predicted,0.1,9,9,TGACGACCGAGACGGTTATA,0,1874023
hyuA_predicted,0.1,9,9,TCTTTGAAACGCAAACCTAC,0,1868241
hyuA_predicted,0.1,9,9,TCTCTGAGAGTGCGTTAAGG,0,1840946
hyuA_predicted,0.1,9,9,TCTCGCCCAAAGGTTTTTCA,0,1860511
hyuA_predicted,0.1,9,9,TCTATAGTGTTTGTCTAGCA,0,1850656
hyuA_predicted,0.1,9,9,TCTAGCAGGATCCTTTCCCA,0,1863318
hyuA_predicted,0.1,9,9,TCGGGTCAGGCACGCGAAAC,0,1835782
hyuA_predicted,0.1,9,9,TCGGCACATCGCTATCGTGT,0,1836275
hyuA_predicted,0.1,9,9,TCGAGACGGAACAACAAATA,0,1829582
hyuA_predicted,0.1,9,9,TCGACCGGGCCTTCCCCTGG,0,1830263
hyuA_predicted,0.1,9,9,TCGAAGTTGTGAATCTGTAT,0,1863017
hyuA_predicted,0.1,9,9,TCCTTAAGTAAGATAGCTGG,0,1838922
hyuA_predicted,0.1,9,9,TCCTGGGCAGGTTGCCACCG,0,1874406
hyuA_predicted,0.1,9,9,TCCGAAGTATGCTGATTATA,0,1833248
hyuA_predicted,0.1,9,9,TCCCGTTTTGGCCCTTGCCT,0,1839031
hyuA_predicted,0.1,9,9,TCCCGGCCGATAAACCGGGC,0,1875928
hyuA_predicted,0.1,9,9,TCCAAGGGTGTACAAACCGT,0,1855510
hyuA_predicted,0.1,9,9,TCACTCCAAATTTGGACTAG,0,1834714
hyuA_predicted,0.1,9,9,TCACACGGCGGTGACAAGTC,0,1840424
hyuA_predicted,0.1,9,9,TCACAATGATTCTTAAATCT,0,1833943
hyuA_predicted,0.1,9,9,TCAACAAACTGCAGGTGTCG,0,1854212
hyuA_predicted,0.1,9,9,TATGCCGCATGTCATGAACT,0,1867765
hyuA_predicted,0.1,9,9,TATGAAGGGAGTTTAGACTC,0,1837251
hyuA_predicted,0.1,9,9,TATCGTGTGTATTCATATTT,0,1847901
hyuA_predicted,0.1,9,9,TATCAACGGGTCTGGCGCTA,0,1845567
hyuA_predicted,0.1,9,9,TATAGAATGGACTAAACAGC,0,1843856
hyuA_predicted,0.1,9,9,TAGGGTGTATAGAGCAGAAA,0,1871392
hyuA_predicted,0.1,9,9,TAGGCATGCTGAGTCCGTAT,0,1839495
hyuA_predicted,0.1,9,9,TAGCGTAATTACCAGGTGTA,0,1846272
hyuA_predicted,0.1,9,9,TAGCGCTTTTGTGATAGATG,0,1855932
hyuA_predicted,0.1,9,9,TACTGCCGTCGTACGCCGTG,0,1867253
hyuA_predicted,0.1,9,9,TACTATATTTTAGGGTCGCC,0,1848507
hyuA_predicted,0.1,9,9,TACTACAGAGTCAACTCCGG,0,1832119
hyuA_predicted,0.1,9,9,TACTAAGTTTCCCTCTGGCG,0,1849154
hyuA_predicted,0.1,9,9,TACCAGTTAAGGACTGAGGG,0,1859905
hyuA_predicted,0.1,9,9,TAACTGCCCGGAGCGCGTAG,0,1862338
hyuA_predicted,0.1,9,9,TAACGAAAAGTCAGATGAGG,0,1866977
hyuA_predicted,0.1,9,9,TAAACTAGCGGTACGGATGT,0,1831988
hyuA_predicted,0.1,9,9,GTTTGGATGTAACCGCTCAT,0,1872892
hyuA_predicted,0.1,9,9,GTTCCTACACGTAGTTCTTA,0,1867531
hyuA_predicted,0.1,9,9,GTTACACGGCACACAATTTG,0,1836770
hyuA_predicted,0.1,9,9,GTGTCGATGGTGATGCATAT,0,1852986
hyuA_predicted,0.1,9,9,GTGGCATGTGGGAGGTCGAA,0,1873027
hyuA_predicted,0.1,9,9,GTGCTATAAGAGTGCAGTGA,0,1860749
hyuA_predicted,0.1,9,9,GTGACTAGATCTATATCTAT,0,1865593
hyuA_predicted,0.1,9,9,GTCGCTGCGGTTAAGTATGT,0,1866180
hyuA_predicted,0.1,9,9,GTCCATCCGGGTCGGATATG,0,1854486
hyuA_predicted,0.1,9,9,GTCAGTGACCAACGCCGAAC,0,1859501
hyuA_predicted,0.1,9,9,GTCACGCGCAAGGTAGTGTC,0,1863884
hyuA_predicted,0.1,9,9,GTCAAGGCCCTCTTCGCAAC,0,1864521
hyuA_predicted,0.1,9,9,GTATGCAGAGCAATTAAGAT,0,1856473
hyuA_predicted,0.1,9,9,GTAGCTATTTGCAACTCAGG,0,1861896
hyuA_predicted,0.1,9,9,GTAGATCTGGCGCTGTAGAA,0,1872113
hyuA_predicted,0.1,9,9,GTACAAGCCGGCTACAACCA,0,1840085
hyuA_predicted,0.1,9,9,GGTTGAGGGCTTCCAGGAAT,0,1858285
hyuA_predicted,0.1,9,9,GGTTCGTACGACGTTGTTCG,0,1859647
hyuA_predicted,0.1,9,9,GGTGCCACCGACATCATGCC,0,1834466
hyuA_predicted,0.1,9,9,GGTGACTTTTCACATGCGCT,0,1872840
hyuA_predicted,0.1,9,9,GGTCTTTCATTGAAGGTCGT,0,1830329
hyuA_predicted,0.1,9,9,GGTCGGTGCATTATACAAAT,0,1843759
hyuA_predicted,0.1,9,9,GGTCGGCCGTTGCGCCGGTG,0,1851233
hyuA_predicted,0.1,9,9,GGTCCGGCCCTTGAGCTAGT,0,1860915
hyuA_predicted,0.1,9,9,GGTCCAGTACCAGGAAGGGG,0,1847932
hyuA_predicted,0.1,9,9,GGTCACCGCAGTAAACAACT,0,1869803
hyuA_predicted,0.1,9,9,GGTACGCACTGATTAGAAAA,0,1858506
hyuA_predicted,0.1,9,9,GGGGATCTTCATCGCATCGT,0,1861125
hyuA_predicted,0.1,9,9,GGGATACTTCGTACCGTATC,0,1853849
hyuA_predicted,0.1,9,9,GGGAGTGATGAATCCGCCAT,0,1857756
hyuA_predicted,0.1,9,9,GGGACGATCCACACGGTAAT,0,1870778
hyuA_predicted,0.1,9,9,GGCTGGGCCGATAGGGCTTC,0,1861602
hyuA_predicted,0.1,9,9,GGCTGAGCCATAAGCTGCAA,0,1832773
hyuA_predicted,0.1,9,9,GGCTCGGTCGTTTAGAACAT,0,1841076
hyuA_predicted,0.1,9,9,GGCTCAGGGTCGCCCCCGGG,0,1829502
hyuA_predicted,0.1,9,9,GGCGTCTCCCGGCCGCTGAT,0,1870272
hyuA_predicted,0.1,9,9,GGCCGTCCTACGTATGGTTC,0,1868190
hyuA_predicted,0.1,9,9,GGCATGAGAGTTGGGTATTT,0,1848240
hyuA_predicted,0.1,9,9,GGATTTTACAAAGACACGGG,0,1843403
hyuA_predicted,0.1,9,9,GGACGCCATGACCATGCTAA,0,1850803
hyuA_predicted,0.1,9,9,GGAATGACAGAGCAGAACTA,0,1861308
hyuA_predicted,0.1,9,9,GGAACTACCTACATGAAATG,0,1854138
hyuA_predicted,0.1,9,9,GGAAATGTACAAGAACGTGA,0,1877564
hyuA_predicted,0.1,9,9,GCTTCATCCCATAAGATCGG,0,1857116
hyuA_predicted,0.1,9,9,GCTATAGGGGTTAGTCACCG,0,1832737
hyuA_predicted,0.1,9,9,GCGTGGTTTTCGTCTGATAT,0,1845832
hyuA_predicted,0.1,9,9,GCGCTTTCTTCCCGTTTCGG,0,1833556
hyuA_predicted,0.1,9,9,GCGCCATTGACTTTCTTTCG,0,1839253
hyuA_predicted,0.1,9,9,GCGCCAAAAACAGGCAAGAT,0,1865791
hyuA_predicted,0.1,9,9,GCGCATCCGGAGTGCAGAAG,0,1846014
hyuA_predicted,0.1,9,9,GCGAATTGCCTTTTGCCAAG,0,1834618
hyuA_predicted,0.1,9,9,GCCTCTTGATCGCAACGCTA,0,1863713
hyuA_predicted,0.1,9,9,GCCTAACTGCTACAATCATG,0,1860778
hyuA_predicted,0.1,9,9,GCCGTGTAGTTTCTAAACAA,0,1838850
hyuA_predicted,0.1,9,9,GCCAGGAAGCAGGATCCCTA,0,1842182
hyuA_predicted,0.1,9,9,GCCAATCGTAGGCCGTTGTC,0,1838409
hyuA_predicted,0.1,9,9,GCCAAGTAGCAATACCTACC,0,1872199
hyuA_predicted,0.1,9,9,GCATGGAACGATGGAACGTT,0,1835109
hyuA_predicted,0.1,9,9,GCAGGCGCGACCTTCTGGTA,0,1840568
hyuA_predicted,0.1,9,9,GCAGCCCACATGCCATCGTA,0,1838175
hyuA_predicted,0.1,9,9,GCACTGATGTCTACATAGGT,0,1847859
hyuA_predicted,0.1,9,9,GCACGATCGGCCCTGGGTGT,0,1850166
hyuA_predicted,0.1,9,9,GCACACCTGTGGGTCTTCCA,0,1850671
hyuA_predicted,0.1,9,9,GCAAGCGCACGATCTTAGCC,0,1865497
hyuA_predicted,0.1,9,9,GCAAAGCAGCGTAGAGTACC,0,1849162
hyuA_predicted,0.1,9,9,GATTGGTATTTAGACCGGAA,0,1866673
hyuA_predicted,0.1,9,9,GATGGGCAGCGTTAGTAAAA,0,1848748
hyuA_predicted,0.1,9,9,GATATGATCGCGACAAACTC,0,1858214
hyuA_predicted,0.1,9,9,GATATCGGTGTGAACTGCCT,0,1871761
hyuA_predicted,0.1,9,9,GATATCGAGTCGCGGAAATT,0,1838768
hyuA_predicted,0.1,9,9,GAGTCCGTTCTAGCGGTTAC,0,1845952
hyuA_predicted,0.1,9,9,GAGGTCCGACGTAAATGCCA,0,1844615
hyuA_predicted,0.1,9,9,GACGGTTTGGGGTGGTTTGG,0,1841047
hyuA_predicted,0.1,9,9,GACGCGTGGTTTTAGCGCTT,0,1834226
hyuA_predicted,0.1,9,9,GACGCAGCGAGAAAGACAAA,0,1837934
hyuA_predicted,0.1,9,9,GACCGGAGTAAGCTAACATC,0,1846599
hyuA_predicted,0.1,9,9,GACCACCACTACGGTACTCC,0,1853354
hyuA_predicted,0.1,9,9,GACATAACGTAGGGTGCATG,0,1852201
hyuA_predicted,0.1,9,9,GACAGACCTGATGGCGCGCA,0,1865485
hyuA_predicted,0.1,9,9,GAATGGATTGGGGAGTTCAT,0,1870402
hyuA_predicted,0.1,9,9,GAATCTCAGCCAAAGTGTTC,0,1844935
hyuA_predicted,0.1,9,9,GAAGCGCCCCACTGGGGCCT,0,1866809
hyuA_predicted,0.1,9,9,GAAGAGGCGTAAATGTGCCA,0,1836341
hyuA_predicted,0.1,9,9,GAAGAGCTCCCATAGATGGC,0,1837597
hyuA_predicted,0.1,9,9,GAACAAGAGATTAGTATAAG,0,1861753
hyuA_predicted,0.1,9,9,CTTTTCCGCGCATGCTGGAG,0,1831820
hyuA_predicted,0.1,9,9,CTTTTCATCGGATCCTTACA,0,1857838
hyuA_predicted,0.1,9,9,CTTTGCACATCGACGCGTAG,0,1870294
hyuA_predicted,0.1,9,9,CTTCTCCTCTGCACAAATAC,0,1835232
hyuA_predicted,0.1,9,9,CTGTCACACAGGGACGGATA,0,1875134
hyuA_predicted,0.1,9,9,CTGCTTAGGACTTAGTAGAC,0,1849178
hyuA_predicted,0.1,9,9,CTGCGAGATTTCTGCATGTC,0,1849553
hyuA_predicted,0.1,9,9,CTCTGTTGCTCGCGGGGCAT,0,1831810
hyuA_predicted,0.1,9,9,CTCGGCGTGCCGACGTCGTT,0,1844992
hyuA_predicted,0.1,9,9,CTCCGATGTGAGTCCAAACC,0,1830662
hyuA_predicted,0.1,9,9,CTCAAGATTGGGTTGTTGTC,0,1872934
hyuA_predicted,0.1,9,9,CTATTTACAGTGGCGGGACA,0,1855968
hyuA_predicted,0.1,9,9,CTATGGGTCGCCCCGCACCT,0,1874997
hyuA_predicted,0.1,9,9,CTATCAGTATAAGCTACAAC,0,1832416
hyuA_predicted,0.1,9,9,CTATACGGATTCCTCGACGA,0,1841710
hyuA_predicted,0.1,9,9,CGTTCGGCGCATCACGCAGT,0,1847865
hyuA_predicted,0.1,9,9,CGTGTATGGGTAGGTATCTA,0,1867978
hyuA_predicted,0.1,9,9,CGTATTACACGCTCCCAGAC,0,1855359
hyuA_predicted,0.1,9,9,CGTATAAACGAACCCAGGAT,0,1868345
hyuA_predicted,0.1,9,9,CGGTGGAATAGCGGAGACAC,0,1852486
hyuA_predicted,0.1,9,9,CGGTCCTGGCGTTTGGTTTT,0,1834155
hyuA_predicted,0.1,9,9,CGGGTCCGAGAGTTAACTAC,0,1877624
hyuA_predicted,0.1,9,9,CGGGTAACAAAGGAGTTGGA,0,1853367
hyuA_predicted,0.1,9,9,CGGGGTATACACTAGCGGGT,0,1853028
hyuA_predicted,0.1,9,9,CGGGGCGGGCACTATCTATG,0,1835975
hyuA_predicted,0.1,9,9,CGGGCCATTCTGCTTCACGT,0,1842194
hyuA_predicted,0.1,9,9,CGGGCAAATAAAGACCATGG,0,1835579
hyuA_predicted,0.1,9,9,CGGCCGCTAAGGAGGAGGGA,0,1842764
hyuA_predicted,0.1,9,9,CGCTTCTGAGCCTTCCATTT,0,1851726
hyuA_predicted,0.1,9,9,CGCTAGGCTTTAACCCGGCA,0,1855295
hyuA_predicted,0.1,9,9,CGCCGGGCCACATCGAAGGT,0,1841256
hyuA_predicted,0.1,9,9,CGCCGATTGATTACCCGAGG,0,1834816
hyuA_predicted,0.1,9,9,CGATTGTTCCAGGGTGTAAG,0,1872830
hyuA_predicted,0.1,9,9,CGATCGAGCACTAATGAGCC,0,1871683
hyuA_predicted,0.1,9,9,CGATAATACATCAACCTGGC,0,1837727
hyuA_predicted,0.1,9,9,CGACCTTAAGCAGAGAGTAA,0,1869101
hyuA_predicted,0.1,9,9,CGAAGGAAGCGGGCCAGCGG,0,1836291
hyuA_predicted,0.1,9,9,CGAAGACGTGATGGCAAAAC,0,1834153
hyuA_predicted,0.1,9,9,CGAACTGCTGGGCAGTAAGT,0,1862570
hyuA_predicted,0.1,9,9,CCTACATTATTGAGAGTTAT,0,1828892
hyuA_predicted,0.1,9,9,CCGGGGAGTTGCAATGCCCA,0,1860445
hyuA_predicted,0.1,9,9,CCGATAAGACCCAGCATTAA,0,1846975
hyuA_predicted,0.1,9,9,CCCTGCACTTCGTCGATTGG,0,1848083
hyuA_predicted,0.1,9,9,CCCTCTGGAAGAGGCTTGGG,0,1856874
hyuA_predicted,0.1,9,9,CCCTAAAGATTCTCTATCGA,0,1856174
hyuA_predicted,0.1,9,9,CCCGGGTACATACTTGCCGG,0,1855082
hyuA_predicted,0.1,9,9,CCCGCGCCGTAATGTAGACT,0,1868344
hyuA_predicted,0.1,9,9,CCCAAGTGCCAAGAGGCTGG,0,1873411
hyuA_predicted,0.1,9,9,CCAGTGTTGTATCAGCTTTC,0,1868120
hyuA_predicted,0.1,9,9,CCAGATCACGGGGTGTTTCT,0,1868595
hyuA_predicted,0.1,9,9,CCAGAACCGAGATGAGGCTT,0,1849851
hyuA_predicted,0.1,9,9,CATTCGCTTCGTTTCGGCGC,0,1831119
hyuA_predicted,0.1,9,9,CATGTGCTAAGCACGGCTCA,0,1856395
hyuA_predicted,0.1,9,9,CATGTATGTATGAGATTGGA,0,1842731
hyuA_predicted,0.1,9,9,CATGTATAATTTAATGAAAG,0,1849483
hyuA_predicted,0.1,9,9,CATCATTAAGACTATGGAAT,0,1830907
hyuA_predicted,0.1,9,9,CAGTCTGCGTCTGCATACGA,0,1865764
hyuA_predicted,0.1,9,9,CAGTCTACTCAATGTAGATA,0,1865114
hyuA_predicted,0.1,9,9,CAGTCCGTAATTCAACTATC,0,1839853
hyuA_predicted,0.1,9,9,CAGTAACGAATCACTGGGAA,0,1863696
hyuA_predicted,0.1,9,9,CAGGGGCTTCACAAACTTCA,0,1873030
hyuA_predicted,0.1,9,9,CAGCTGGTTCTGACGTAGCA,0,1841182
hyuA_predicted,0.1,9,9,CAGATCAGGGGGAGTATATG,0,1872558
hyuA_predicted,0.1,9,9,CAGAGGCGCCGGGAAGCGTA,0,1839936
hyuA_predicted,0.1,9,9,CAGAGCGGTAGGGGCCATGG,0,1869023
hyuA_predicted,0.1,9,9,CACTATCATAGTCTGTCCCG,0,1837028
hyuA_predicted,0.1,9,9,CACGGACGTGTGACGTGTCA,0,1874792
hyuA_predicted,0.1,9,9,CACGAGTTCAACCGAACCTC,0,1873725
hyuA_predicted,0.1,9,9,CAACGTTTCTACATACCGAG,0,1853589
hyuA_predicted,0.1,9,9,CAACAAGGCTGAGCCGCCGT,0,1874716
hyuA_predicted,0.1,9,9,CAAATGACAAGTATAGTGAC,0,1843892
hyuA_predicted,0.1,9,9,CAAAAGGCCAATCGGAGAGC,0,1830585
hyuA_predicted,0.1,9,9,ATTTTCGCATAGGAGGATCC,0,1856744
hyuA_predicted,0.1,9,9,ATTTTCCTAAATGCGGTAGA,0,1868743
hyuA_predicted,0.1,9,9,ATTGTATAATAAGACCTTGG,0,1843914
hyuA_predicted,0.1,9,9,ATTGAGCTGGGTAGCGTGTA,0,1830875
hyuA_predicted,0.1,9,9,ATTCTTCTAAGCATGGGTAC,0,1850962
hyuA_predicted,0.1,9,9,ATTCGCCTGCGTTGAAACTA,0,1871395
hyuA_predicted,0.1,9,9,ATTCCGTTGACGTGTGCTTA,0,1841939
hyuA_predicted,0.1,9,9,ATTAAAGCTAGACTGTCGTC,0,1871812
hyuA_predicted,0.1,9,9,ATGTTGGCGCACCGCAGATC,0,1846877
hyuA_predicted,0.1,9,9,ATGTTCCCCCTGGGGTGGCC,0,1860702
hyuA_predicted,0.1,9,9,ATGTTCACGGGAAAGATTTA,0,1835502
hyuA_predicted,0.1,9,9,ATGGTTTTCATACTGGCTAG,0,1841532
hyuA_predicted,0.1,9,9,ATGGCCAAACCCGTGGACGC,0,1862473
hyuA_predicted,0.1,9,9,ATGATTACCTTGGGGTGTCA,0,1867534
hyuA_predicted,0.1,9,9,ATCGTCTCGCAACAGGCCCT,0,1861400
hyuA_predicted,0.1,9,9,ATCCCCGGGTGTACTAGATG,0,1829649
hyuA_predicted,0.1,9,9,ATCATGCGTAGTAGGGCCTC,0,1874170
hyuA_predicted,0.1,9,9,ATCATAATTACCCCCAAATA,0,1864802
hyuA_predicted,0.1,9,9,ATCAGTAAAAGATAATCGTC,0,1865615
hyuA_predicted,0.1,9,9,ATCAATGCGCCGGAGCCGTA,0,1859493
hyuA_predicted,0.1,9,9,ATATGGCAATTCTATCGCGG,0,1838665
hyuA_predicted,0.1,9,9,ATATGGACGCGTACGTTCGA,0,1877334
hyuA_predicted,0.1,9,9,ATATGAGTGCAATCCCGTTG,0,1841796
hyuA_predicted,0.1,9,9,ATAGCACGTTAGTGCTCTCC,0,1867559
hyuA_predicted,0.1,9,9,ATACCTGAGGAACTGATCAA,0,1845502
hyuA_predicted,0.1,9,9,ATACACATAATAGGCTAGCA,0,1871894
hyuA_predicted,0.1,9,9,ATAAATGCTGCGTGGCTGGG,0,1836516
hyuA_predicted,0.1,9,9,AGTTTGTGCATCTACTCGCT,0,1845253
hyuA_predicted,0.1,9,9,AGTTCCTGTCGGACGGTCTA,0,1851968
hyuA_predicted,0.1,9,9,AGTTAGTTCTGCCGTTGCGT,0,1841969
hyuA_predicted,0.1,9,9,AGTGTTAAGTCGGGAATCGT,0,1872828
hyuA_predicted,0.1,9,9,AGTCTAATCATATGGCACTA,0,1843126
hyuA_predicted,0.1,9,9,AGTACGGACGATTAGCTTCC,0,1832821
hyuA_predicted,0.1,9,9,AGGTTTGTGAAACCAACCGA,0,1841872
hyuA_predicted,0.1,9,9,AGGTGGTCTCGGGGGAGACG,0,1856030
hyuA_predicted,0.1,9,9,AGGTCAGCATCGGTACAGCG,0,1832124
hyuA_predicted,0.1,9,9,AGGTCAACATGGGCGAGGAA,0,1835946
hyuA_predicted,0.1,9,9,AGGTACCCACAATACACCAA,0,1838767
hyuA_predicted,0.1,9,9,AGGGTATCGCGCGCAGGTCA,0,1851701
hyuA_predicted,0.1,9,9,AGGGCCAGAGACGTGCGGAT,0,1852135
hyuA_predicted,0.1,9,9,AGGCAGTACGTGCGCTGTGA,0,1862168
hyuA_predicted,0.1,9,9,AGCTCAATACAATGGACAGT,0,1831961
hyuA_predicted,0.1,9,9,AGCCGGTGCCTGGGTCGCAG,0,1837249
hyuA_predicted,0.1,9,9,AGCCAGGTATCACGAGTCTT,0,1832096
hyuA_predicted,0.1,9,9,AGCCACGACATCAATTCCCA,0,1844066
hyuA_predicted,0.1,9,9,AGCACCCGCACACTCTACGC,0,1864573
hyuA_predicted,0.1,9,9,AGCAAACTGATGTCCTAATG,0,1872130
hyuA_predicted,0.1,9,9,AGACGTCTAGTGATGGGCAT,0,1855483
hyuA_predicted,0.1,9,9,AGACGCCGAGTTGTCAAGCT,0,1833154
hyuA_predicted,0.1,9,9,AGACGAACGGCTTTTGGGGG,0,1855591
hyuA_predicted,0.1,9,9,AGAATGAAACGGAGTAAAAA,0,1857304
hyuA_predicted,0.1,9,9,AGAAAGGTATCACGCGCAAC,0,1837418
hyuA_predicted,0.1,9,9,AGAAAGCAGTTTACCCGCAG,0,1861505
hyuA_predicted,0.1,9,9,AGAAACGGTGAATTGGGGAA,0,1830358
hyuA_predicted,0.1,9,9,ACTGGAAGTAGTCCTGACCA,0,1842769
hyuA_predicted,0.1,9,9,ACTCTGAGCTGCAATGTTTA,0,1837022
hyuA_predicted,0.1,9,9,ACGTTGCGGAGCCCTACGTC,0,1863854
hyuA_predicted,0.1,9,9,ACGTTCGAGACCTATTGAGA,0,1849933
hyuA_predicted,0.1,9,9,ACGGACGTGCCCATTGGCGC,0,1853608
hyuA_predicted,0.1,9,9,ACGCAAGTTGTAACGCTACG,0,1863592
hyuA_predicted,0.1,9,9,ACGAACGTCGTGCTACGCCC,0,1835493
hyuA_predicted,0.1,9,9,ACCTCTTGGATCTTTACTTG,0,1836997
hyuA_predicted,0.1,9,9,ACCTCTAGGTACATACTACG,0,1839075
hyuA_predicted,0.1,9,9,ACCGAGGACGCACATTCGGT,0,1836813
hyuA_predicted,0.1,9,9,ACCATATTTTGTTTTCGCCA,0,1859648
hyuA_predicted,0.1,9,9,ACCAGCTATCTCAGAGTTAA,0,1845203
hyuA_predicted,0.1,9,9,ACATTGTCCAGGGTTTCTAT,0,1845148
hyuA_predicted,0.1,9,9,ACACTTGTTGAGCTTCGGCG,0,1837543
hyuA_predicted,0.1,9,9,ACAATAAGATTAAGAATGCA,0,1859692
hyuA_predicted,0.1,9,9,ACAAGCGCGTTTATGGCTGA,0,1842950
hyuA_predicted,0.1,9,9,AATTCCGGACAATACTATTT,0,1870658
hyuA_predicted,0.1,9,9,AATGACTTATCAAACGCGAG,0,1859248
hyuA_predicted,0.1,9,9,AATCGCTACCTGCGAGCGTT,0,1860373
hyuA_predicted,0.1,9,9,AATCCCGGTTTACATGGACG,0,1858565
hyuA_predicted,0.1,9,9,AAGTTGCCTTGTCACAGGGG,0,1870993
hyuA_predicted,0.1,9,9,AAGTTAGCGTTAACCGCTGC,0,1854940
hyuA_predicted,0.1,9,9,AAGTCGTGGGTATGCCACAG,0,1857167
hyuA_predicted,0.1,9,9,AAGTCATCGTCGTTCCGGGT,0,1838292
hyuA_predicted,0.1,9,9,AAGGTCGCTAAGTCTACTGG,0,1852606
hyuA_predicted,0.1,9,9,AAGGTAAACTCATCCCGTGT,0,1862227
hyuA_predicted,0.1,9,9,AAGGCCCTGACTTACAGTTG,0,1867178
hyuA_predicted,0.1,9,9,AAGGCATGATTAGGTCTACA,0,1862264
hyuA_predicted,0.1,9,9,AAGGATTCAGTCCGGAAAGC,0,1871789
hyuA_predicted,0.1,9,9,AAGGATACACCCGATAGGTC,0,1834829
hyuA_predicted,0.1,9,9,AAGGAGTATCTTTTTACACG,0,1844860
hyuA_predicted,0.1,9,9,AAGGAATGACGACTCGCCAG,0,1854454
hyuA_predicted,0.1,9,9,AAGCTGCTCGAACCATTCGT,0,1865347
hyuA_predicted,0.1,9,9,AAGCTATCCACTCTTAATAT,0,1835601
hyuA_predicted,0.1,9,9,AAGCGTAATATTTAGCGGTT,0,1847739
hyuA_predicted,0.1,9,9,AAGCCGAGCTCCTAACCAAG,0,1867818
hyuA_predicted,0.1,9,9,AAGATGCCTTAAGGGGGCCT,0,1868372
hyuA_predicted,0.1,9,9,AACTGCCTATGTTACGTCCA,0,1873626
hyuA_predicted,0.1,9,9,AACCTTGCCAGGAGGGACAC,0,1847162
hyuA_predicted,0.1,9,9,AACCCGGGGCTCATCACTTG,0,1845714
hyuA_predicted,0.1,9,9,AACACGCCAGGGGGAAGGGA,0,1857520
hyuA_predicted,0.1,9,9,AAATTTGCACTGCAGTCGGC,0,1843463
hyuA_predicted,0.1,9,9,AAATGTGCATCTTTGCCGCT,0,1829694
hyuA_predicted,0.1,9,9,AAAGCTGCAACCATACTTAT,0,1846252
hyuA_predicted,0.1,9,9,AAAAGTCCCCTTTGCCAGTA,0,1870802
hyuA_predicted,0.1111111111111111,8,8,TTTTAAGAAAAAGGATACTT,0,1858164
hyuA_predicted,0.1111111111111111,8,8,TTTGGGGTGGAAGGTAACGT,0,1847168
hyuA_predicted,0.1111111111111111,8,8,TTTCTGTGCAGCTTCACGAA,0,1831336
hyuA_predicted,0.1111111111111111,8,8,TTTAAGGTGAGCTTCAGCTT,0,1839963
hyuA_predicted,0.1111111111111111,8,8,TTGTCTGGACCTGAATACCA,0,1829584
hyuA_predicted,0.1111111111111111,8,8,TTGTAACTAGCAATTGCTCA,0,1864904
hyuA_predicted,0.1111111111111111,8,8,TTGGCCCATAACGATTTCTG,0,1852211
hyuA_predicted,0.1111111111111111,8,8,TTGGATGCGGGGACATAAGT,0,1841714
hyuA_predicted,0.1111111111111111,8,8,TTGGAAGCCCCAGCGGTATC,0,1848001
hyuA_predicted,0.1111111111111111,8,8,TTGGAACTCCTCTAGCGCCA,0,1861358
hyuA_predicted,0.1111111111111111,8,8,TTGCCGGTCGGAAAACATAC,0,1862600
hyuA_predicted,0.1111111111111111,8,8,TTGATTATGCCTAGTGGTCT,0,1842026
hyuA_predicted,0.1111111111111111,8,8,TTGACTTGGCGATCATGTCC,0,1865174
hyuA_predicted,0.1111111111111111,8,8,TTGACATAGCAAGTGTTCTA,0,1877473
hyuA_predicted,0.1111111111111111,8,8,TTGAAGTATTGTCCAAGCGG,0,1845490
hyuA_predicted,0.1111111111111111,8,8,TTGAACTTGGATCCACTACT,0,1839598
hyuA_predicted,0.1111111111111111,8,8,TTGAAATCGCGTGACGTTAA,0,1833451
hyuA_predicted,0.1111111111111111,8,8,TTCTTTGGAGAAGAAGATAG,0,1873158
hyuA_predicted,0.1111111111111111,8,8,TTCTTTACAAGTTTTGTAAA,0,1857159
hyuA_predicted,0.1111111111111111,8,8,TTCGGGTCTCTCTCTCAGAT,0,1842450
hyuA_predicted,0.1111111111111111,8,8,TTCCGGTGATTAGGGCGCAT,0,1846106
hyuA_predicted,0.1111111111111111,8,8,TTCACACTTGCATTATTCCA,0,1868904
hyuA_predicted,0.1111111111111111,8,8,TTAGTATCACTATTGGTGTA,0,1836683
hyuA_predicted,0.1111111111111111,8,8,TTAGTAGCATAAGCAAGGCC,0,1832295
hyuA_predicted,0.1111111111111111,8,8,TTAGGCCGGCGGCAGCAATT,0,1876188
hyuA_predicted,0.1111111111111111,8,8,TTACCTGATCGTGTTTAGGC,0,1866298
hyuA_predicted,0.1111111111111111,8,8,TTAAGGACCGGCCGTGCTTT,0,1849936
hyuA_predicted,0.1111111111111111,8,8,TTAACGAACAGTCGTGGTAA,0,1844055
hyuA_predicted,0.1111111111111111,8,8,TTAAATAGGTTCTGCTCCGT,0,1838594
hyuA_predicted,0.1111111111111111,8,8,TTAAAGGCTGGTCGGACCAT,0,1846102
hyuA_predicted,0.1111111111111111,8,8,TTAAACGTTAATTTTGTGGG,0,1839877
hyuA_predicted,0.1111111111111111,8,8,TGTGGGTTACCACGGTAGGG,0,1877678
hyuA_predicted,0.1111111111111111,8,8,TGTGAGATCCGTATGTGATC,0,1848829
hyuA_predicted,0.1111111111111111,8,8,TGTGACAGAGTTGTTCGCAA,0,1833259
hyuA_predicted,0.1111111111111111,8,8,TGTGAATTCGCGCGGGTATC,0,1850336
hyuA_predicted,0.1111111111111111,8,8,TGTACGGCGGGTACAAACGG,0,1871556
hyuA_predicted,0.1111111111111111,8,8,TGGTAGCGGACGAGCACTCC,0,1871766
hyuA_predicted,0.1111111111111111,8,8,TGGTACCGGCTCCCGGGGAA,0,1841538
hyuA_predicted,0.1111111111111111,8,8,TGGCCTCCATCGCCTGATCC,0,1837377
hyuA_predicted,0.1111111111111111,8,8,TGGCCGAGAGGAGGTATCAA,0,1850950
hyuA_predicted,0.1111111111111111,8,8,TGGCCCTTCGTCGTACGCCT,0,1857403
hyuA_predicted,0.1111111111111111,8,8,TGGCAACATCGAGATTGGGA,0,1873619
hyuA_predicted,0.1111111111111111,8,8,TGGAGTTATCGTTAGGCTTT,0,1831417
hyuA_predicted,0.1111111111111111,8,8,TGCTGAGCTCTATCGTGCAT,0,1846404
hyuA_predicted,0.1111111111111111,8,8,TGCGGCTACCAGGATATTCG,0,1832660
hyuA_predicted,0.1111111111111111,8,8,TGCCTTAGTGTCCTAATGGG,0,1855527
hyuA_predicted,0.1111111111111111,8,8,TGCCCGCTGGTAGGCCGCGG,0,1865937
hyuA_predicted,0.1111111111111111,8,8,TGCCAAGATTGGGTTTGCAG,0,1848204
hyuA_predicted,0.1111111111111111,8,8,TGCATGATCAGTTATTTCCT,0,1845593
hyuA_predicted,0.1111111111111111,8,8,TGCAGCTGCGGCAAATCACA,0,1873552
hyuA_predicted,0.1111111111111111,8,8,TGATAGCCCAAGGTAGGGCA,0,1832431
hyuA_predicted,0.1111111111111111,8,8,TGAGTAAATACCAGCAACAA,0,1870971
hyuA_predicted,0.1111111111111111,8,8,TGACGCGTGACGCAGCCGCG,0,1839776
hyuA_predicted,0.1111111111111111,8,8,TGACCACGTGAGCCGGCAGG,0,1845205
hyuA_predicted,0.1111111111111111,8,8,TGAAAATACGCCACCGAAAA,0,1876490
hyuA_predicted,0.1111111111111111,8,8,TCTTGTTTAATCGCTTGCCC,0,1840243
hyuA_predicted,0.1111111111111111,8,8,TCTGGGAGGAACTGCATCCA,0,1852649
hyuA_predicted,0.1111111111111111,8,8,TCTGGACAAGGGGATTATTT,0,1832840
hyuA_predicted,0.1111111111111111,8,8,TCTGCGTCAACCCGTAAGAT,0,1874522
hyuA_predicted,0.1111111111111111,8,8,TCTCTTTGTGGGGCAGTTGA,0,1863926
hyuA_predicted,0.1111111111111111,8,8,TCTCGAGGAAATTGTTAATT,0,1854677
hyuA_predicted,0.1111111111111111,8,8,TCTATTTGGTGTTTCAGATT,0,1861725
hyuA_predicted,0.1111111111111111,8,8,TCTACGGCACTGTATATACT,0,1841054
hyuA_predicted,0.1111111111111111,8,8,TCTACCGCGAAGGATAGCAT,0,1863850
hyuA_predicted,0.1111111111111111,8,8,TCGGTTGGTCACCCGTTGAA,0,1852004
hyuA_predicted,0.1111111111111111,8,8,TCGGTCGCGGAGGAGTCCTT,0,1843523
hyuA_predicted,0.1111111111111111,8,8,TCGGCCTCGACTGTCTAACT,0,1867050
hyuA_predicted,0.1111111111111111,8,8,TCGGCAATACACGTCCTGCT,0,1848327
hyuA_predicted,0.1111111111111111,8,8,TCGCGTTAAGTTTGCTTACC,0,1877210
hyuA_predicted,0.1111111111111111,8,8,TCGATGGGGCTTTGATTCAC,0,1874020
hyuA_predicted,0.1111111111111111,8,8,TCCTCATAATTAGTCATTGA,0,1853876
hyuA_predicted,0.1111111111111111,8,8,TCCGGTCCCCAATTATGATT,0,1844790
hyuA_predicted,0.1111111111111111,8,8,TCCGGGTGAAGTGCTTCTCC,0,1849309
hyuA_predicted,0.1111111111111111,8,8,TCCGGCGTTTCGCCTAATGT,0,1832455
hyuA_predicted,0.1111111111111111,8,8,TCCGCGTACCGACCGGTAAC,0,1860588
hyuA_predicted,0.1111111111111111,8,8,TCCCTCGAAAAGCAATATTT,0,1875277
hyuA_predicted,0.1111111111111111,8,8,TCCCGGTGTCCATGTAGATG,0,1856040
hyuA_predicted,0.1111111111111111,8,8,TCCAGAGATCAGGACCTATA,0,1833466
hyuA_predicted,0.1111111111111111,8,8,TCCAGAACATGTACTGGATA,0,1872863
hyuA_predicted,0.1111111111111111,8,8,TCAGATGCAGCCCTTAGGAC,0,1856162
hyuA_predicted,0.1111111111111111,8,8,TCACGCAAGGGCTGAACGGA,0,1856680
hyuA_predicted,0.1111111111111111,8,8,TATTGTGGGCTTCGTGCAGT,0,1875798
hyuA_predicted,0.1111111111111111,8,8,TATTGACAATTAGCCACCGT,0,1836343
hyuA_predicted,0.1111111111111111,8,8,TATTATACCAATCCTGTCAG,0,1832514
hyuA_predicted,0.1111111111111111,8,8,TATCTGGGACAAGTACGTAG,0,1835087
hyuA_predicted,0.1111111111111111,8,8,TATAATGATGTTTCTGTTCT,0,1876350
hyuA_predicted,0.1111111111111111,8,8,TAGGTACGCATTGAAGTGAG,0,1856566
hyuA_predicted,0.1111111111111111,8,8,TAGGGCTACGTCGTACTGAA,0,1850248
hyuA_predicted,0.1111111111111111,8,8,TAGGCGCGAAAGACCCTTCA,0,1843895
hyuA_predicted,0.1111111111111111,8,8,TAGCGCGTCGAAGGTGGGCA,0,1846344
hyuA_predicted,0.1111111111111111,8,8,TAGATGATGGCTAATAGAGA,0,1877208
hyuA_predicted,0.1111111111111111,8,8,TAGAGGCAGGACACCGTATG,0,1846402
hyuA_predicted,0.1111111111111111,8,8,TACTGTTATGGCTAACCTCC,0,1870295
hyuA_predicted,0.1111111111111111,8,8,TACTCCGGTGACGACAAACG,0,1856623
hyuA_predicted,0.1111111111111111,8,8,TACGACGGGAACTTCAAATG,0,1875175
hyuA_predicted,0.1111111111111111,8,8,TACAATTTCAGCACGGAGTT,0,1855091
hyuA_predicted,0.1111111111111111,8,8,TAATTTTCTAGTAGATGTAC,0,1866801
hyuA_predicted,0.1111111111111111,8,8,TAATCTGCTCCTGTAGGGGC,0,1832170
hyuA_predicted,0.1111111111111111,8,8,TAATCAGGATCTGATCCGAA,0,1855942
hyuA_predicted,0.1111111111111111,8,8,TAAGTACCTTGCCTGCGAGC,0,1847129
hyuA_predicted,0.1111111111111111,8,8,TAAGGTTATTCGCTTTGTAA,0,1863079
hyuA_predicted,0.1111111111111111,8,8,TAACTTTCCAGCCCAATTGA,0,1854417
hyuA_predicted,0.1111111111111111,8,8,TAAAGCGCCGAATGGGAGAA,0,1851418
hyuA_predicted,0.1111111111111111,8,8,GTTTTCAACGAAAAAGATGT,0,1850550
hyuA_predicted,0.1111111111111111,8,8,GTTTGTCAACATACGAGGTT,0,1866760
hyuA_predicted,0.1111111111111111,8,8,GTTTGCTCTCTTGGTTCGGC,0,1836700
hyuA_predicted,0.1111111111111111,8,8,GTTGTCGCATCCGTCCGAGT,0,1862954
hyuA_predicted,0.1111111111111111,8,8,GTTGTAAAGGTTACCGCTTA,0,1869577
hyuA_predicted,0.1111111111111111,8,8,GTTGATTAGTGAAACCGAAC,0,1855517
hyuA_predicted,0.1111111111111111,8,8,GTTAAGAACCAATCCGGGCA,0,1853365
hyuA_predicted,0.1111111111111111,8,8,GTTAAACTACGGTCTATGGT,0,1864626
hyuA_predicted,0.1111111111111111,8,8,GTGTATGCAGCAATGGGACG,0,1864321
hyuA_predicted,0.1111111111111111,8,8,GTGTATACTCAGTGCGTGAG,0,1835862
hyuA_predicted,0.1111111111111111,8,8,GTGGTTAAGAATAACAAGAT,0,1835467
hyuA_predicted,0.1111111111111111,8,8,GTGGAAGTTAAAGTCAGAAT,0,1868434
hyuA_predicted,0.1111111111111111,8,8,GTGCGGTAGCCGTTTCAAGC,0,1829079
hyuA_predicted,0.1111111111111111,8,8,GTCGGTTTCTTCCTGGGCCA,0,1860887
hyuA_predicted,0.1111111111111111,8,8,GTCCCTCACCACCTGTTAAT,0,1858775
hyuA_predicted,0.1111111111111111,8,8,GTCATTGCCCTGTCGCAACG,0,1866209
hyuA_predicted,0.1111111111111111,8,8,GTCACTCAATTTAAGGCCAT,0,1850798
hyuA_predicted,0.1111111111111111,8,8,GTATTCAAGGCTACTTGTAG,0,1840698
hyuA_predicted,0.1111111111111111,8,8,GTACTAGGGTATATCCCCTG,0,1834184
hyuA_predicted,0.1111111111111111,8,8,GTACGACCTTTAGATGCAGG,0,1839339
hyuA_predicted,0.1111111111111111,8,8,GTAATCACTCAAAAGATCAC,0,1861570
hyuA_predicted,0.1111111111111111,8,8,GTAACTAGCTCCGTGTAAGC,0,1877541
hyuA_predicted,0.1111111111111111,8,8,GTAAAGGAGCCCTCTGTCAG,0,1869574
hyuA_predicted,0.1111111111111111,8,8,GGTTGACAGTCACAAGGGCC,0,1870697
hyuA_predicted,0.1111111111111111,8,8,GGTCATCCGCCCATCTCGGT,0,1855155
hyuA_predicted,0.1111111111111111,8,8,GGTCAGGCCTGTACCCGGTG,0,1843434
hyuA_predicted,0.1111111111111111,8,8,GGTACGACTCTGCGTATAAA,0,1876601
hyuA_predicted,0.1111111111111111,8,8,GGTACCGCCGCAAGCTTACT,0,1870208
hyuA_predicted,0.1111111111111111,8,8,GGGTTTTTATTTTTAAGCGG,0,1861759
hyuA_predicted,0.1111111111111111,8,8,GGGTTTCAGATACCCTACCT,0,1839549
hyuA_predicted,0.1111111111111111,8,8,GGGTCTCCTTTGTCGGAAAG,0,1873432
hyuA_predicted,0.1111111111111111,8,8,GGGTCATCATATGCGCCATA,0,1857603
hyuA_predicted,0.1111111111111111,8,8,GGGTAGGCTTAATTCAAAAT,0,1844851
hyuA_predicted,0.1111111111111111,8,8,GGGGAGTACGCTACATAGGG,0,1840130
hyuA_predicted,0.1111111111111111,8,8,GGGCTTATAAATGCCCTGCC,0,1848558
hyuA_predicted,0.1111111111111111,8,8,GGGCGACCTTATGTATTGCG,0,1829018
hyuA_predicted,0.1111111111111111,8,8,GGGACAGAAATGAGCTGGGT,0,1837894
hyuA_predicted,0.1111111111111111,8,8,GGGACACGGGTCCCACCGGT,0,1843008
hyuA_predicted,0.1111111111111111,8,8,GGCTGTACGCAACGCTCGAT,0,1866761
hyuA_predicted,0.1111111111111111,8,8,GGCTGAAAGCTGCGAACACA,0,1832367
hyuA_predicted,0.1111111111111111,8,8,GGCGTGGGTCGATTGTAGCA,0,1853323
hyuA_predicted,0.1111111111111111,8,8,GGCGTAGTTAAAAACAGGGC,0,1852321
hyuA_predicted,0.1111111111111111,8,8,GGCGCATACGTGCTAGAACG,0,1864906
hyuA_predicted,0.1111111111111111,8,8,GGATGTCTCTACGTGGCTCG,0,1863546
hyuA_predicted,0.1111111111111111,8,8,GGATGACACGGGCATAAAGG,0,1835288
hyuA_predicted,0.1111111111111111,8,8,GGAGAAGTGCCATATATCGT,0,1847120
hyuA_predicted,0.1111111111111111,8,8,GGACGTTAAGGCTCCTCTTG,0,1836964
hyuA_predicted,0.1111111111111111,8,8,GGACGCGACGCCAATTAAGG,0,1855500
hyuA_predicted,0.1111111111111111,8,8,GGACAGATGTGGCCGCCTTT,0,1873214
hyuA_predicted,0.1111111111111111,8,8,GGAATGTTGATAACGGGCGT,0,1833017
hyuA_predicted,0.1111111111111111,8,8,GGAAGTCTGCATAGGGTTGT,0,1860892
hyuA_predicted,0.1111111111111111,8,8,GGAACAGTCGTGGGATTGTT,0,1864721
hyuA_predicted,0.1111111111111111,8,8,GCTGGGGATCGCGGGAGGAG,0,1861527
hyuA_predicted,0.1111111111111111,8,8,GCTGGGGATCCAGTCGTCTT,0,1870224
hyuA_predicted,0.1111111111111111,8,8,GCTCTTACCGTGGTCGATGG,0,1830793
hyuA_predicted,0.1111111111111111,8,8,GCTATTGAGCTGGATTCTCT,0,1858354
hyuA_predicted,0.1111111111111111,8,8,GCTAAGCGTGCGACATCTCA,0,1869093
hyuA_predicted,0.1111111111111111,8,8,GCGTTGCGAACTCGGGTTGG,0,1847624
hyuA_predicted,0.1111111111111111,8,8,GCGTTCCATCGATTTGAGCT,0,1859451
hyuA_predicted,0.1111111111111111,8,8,GCGTCTGGTGGATCTAGTGC,0,1831389
hyuA_predicted,0.1111111111111111,8,8,GCGTCGGAGTGATCCTGTGA,0,1864930
hyuA_predicted,0.1111111111111111,8,8,GCGGTCGATGCCCCTTATGG,0,1840018
hyuA_predicted,0.1111111111111111,8,8,GCGGGCTAAAGGCTCGCAAT,0,1839268
hyuA_predicted,0.1111111111111111,8,8,GCGACGGTAGATGCGTAGGT,0,1853469
hyuA_predicted,0.1111111111111111,8,8,GCGAAGATACTGACTGAATC,0,1860685
hyuA_predicted,0.1111111111111111,8,8,GCCTGGTATGAGTAAGAACT,0,1845833
hyuA_predicted,0.1111111111111111,8,8,GCCTCAACCTACTAATGCCT,0,1860838
hyuA_predicted,0.1111111111111111,8,8,GCCTACGCGGTTAGGCTGCC,0,1853078
hyuA_predicted,0.1111111111111111,8,8,GCCGTAGTATCTCCTTGCCA,0,1865658
hyuA_predicted,0.1111111111111111,8,8,GCCGTAAATGTACTGCAAGT,0,1861470
hyuA_predicted,0.1111111111111111,8,8,GCCGAATGCTCTGTAGAGCG,0,1843298
hyuA_predicted,0.1111111111111111,8,8,GCCAGGTTGCGCTGCGATCT,0,1856205
hyuA_predicted,0.1111111111111111,8,8,GCCAACCGGGTTTCTGCTGT,0,1868867
hyuA_predicted,0.1111111111111111,8,8,GCCAACAGCCGGACCTGCGG,0,1859232
hyuA_predicted,0.1111111111111111,8,8,GCATGCTTTGATCTCCCGAC,0,1840330
hyuA_predicted,0.1111111111111111,8,8,GCATCTCGCCGTGTGGGTCA,0,1842579
hyuA_predicted,0.1111111111111111,8,8,GCATAAGGGGTGAGTCAGTC,0,1873764
hyuA_predicted,0.1111111111111111,8,8,GCACTCAATAGGTGATATTA,0,1856583
hyuA_predicted,0.1111111111111111,8,8,GCACACAACGGCTTTATGAA,0,1833949
hyuA_predicted,0.1111111111111111,8,8,GCAATAGGTTCGTAGTTGAT,0,1873876
hyuA_predicted,0.1111111111111111,8,8,GCAACAGAAGTCTGGAACTA,0,1834782
hyuA_predicted,0.1111111111111111,8,8,GATTTGGCAATTGCCGGCCC,0,1862500
hyuA_predicted,0.1111111111111111,8,8,GATTGGGAGCCGAGCTAGCC,0,1873555
hyuA_predicted,0.1111111111111111,8,8,GATTAGCTAGACATGCGCCA,0,1855967
hyuA_predicted,0.1111111111111111,8,8,GATGGAGATCCTGAATATCG,0,1855171
hyuA_predicted,0.1111111111111111,8,8,GATCTAACCTTGCTACGGAG,0,1829404
hyuA_predicted,0.1111111111111111,8,8,GATCGTCCAGTCGGGTCAAT,0,1859776
hyuA_predicted,0.1111111111111111,8,8,GATCCGATGGACTCCCGTAT,0,1845511
hyuA_predicted,0.1111111111111111,8,8,GAGTCCAAAAGGCGGACAGT,0,1835957
hyuA_predicted,0.1111111111111111,8,8,GAGGCCCGTCGTTTTTCGCG,0,1841432
hyuA_predicted,0.1111111111111111,8,8,GAGGCCAAGTCGCATCCAGA,0,1840697
hyuA_predicted,0.1111111111111111,8,8,GAGCCCCCGGCCATTCCATT,0,1841158
hyuA_predicted,0.1111111111111111,8,8,GAGATAAATGGCAGCTTGGC,0,1847038
hyuA_predicted,0.1111111111111111,8,8,GAGAGTGTAATGGCTTCTCA,0,1837424
hyuA_predicted,0.1111111111111111,8,8,GACTAAAAGCTGGCAGGTTA,0,1859777
hyuA_predicted,0.1111111111111111,8,8,GACGGGAGCTCTAGTTCCAT,0,1876661
hyuA_predicted,0.1111111111111111,8,8,GACGCGCAGGTCCTCGATGG,0,1851893
hyuA_predicted,0.1111111111111111,8,8,GACCTGTTTAGTGAGGCGCG,0,1867328
hyuA_predicted,0.1111111111111111,8,8,GACACTCTGCCGATAGCCAA,0,1864674
hyuA_predicted,0.1111111111111111,8,8,GAATTTCCTGCATACCCATG,0,1856568
hyuA_predicted,0.1111111111111111,8,8,GAATTCGTCAGTACGGGCGT,0,1847929
hyuA_predicted,0.1111111111111111,8,8,GAATGTAAGCAGAGATCCCC,0,1855783
hyuA_predicted,0.1111111111111111,8,8,GAATCTTCGAGCATTAACAT,0,1869014
hyuA_predicted,0.1111111111111111,8,8,GAATCGTCTTCGTAAATCGA,0,1867405
hyuA_predicted,0.1111111111111111,8,8,GAAGGTTGAGTAGCAACACT,0,1867335
hyuA_predicted,0.1111111111111111,8,8,GAAGACAAGAAGACTACTCC,0,1868233
hyuA_predicted,0.1111111111111111,8,8,GAACTGGTGCCACCTCTATG,0,1870097
hyuA_predicted,0.1111111111111111,8,8,GAACACGTACTCACAGTTGG,0,1869354
hyuA_predicted,0.1111111111111111,8,8,GAAAGTAGCCAGCCACTAAT,0,1829279
hyuA_predicted,0.1111111111111111,8,8,CTTTCGAAGGTCTAAAAAGC,0,1835254
hyuA_predicted,0.1111111111111111,8,8,CTTTATATAGAGCCGTCCGT,0,1863306
hyuA_predicted,0.1111111111111111,8,8,CTTTACTTCCAGAATGGGCT,0,1831084
hyuA_predicted,0.1111111111111111,8,8,CTTGTGCGCACATTGCGCTG,0,1849476
hyuA_predicted,0.1111111111111111,8,8,CTTGTGAAATGTAGATGACC,0,1845985
hyuA_predicted,0.1111111111111111,8,8,CTTCAGTACGGCTAGTGTAA,0,1852163
hyuA_predicted,0.1111111111111111,8,8,CTTCAGAGTGTCTTAGTCAG,0,1844151
hyuA_predicted,0.1111111111111111,8,8,CTTACAGGGGCTGGCTTGTT,0,1830242
hyuA_predicted,0.1111111111111111,8,8,CTGTCCAGGTCTGGTAGCTT,0,1862540
hyuA_predicted,0.1111111111111111,8,8,CTGTACTTCGGAAGCACGTC,0,1851532
hyuA_predicted,0.1111111111111111,8,8,CTGTAATCAACGTCGATTTG,0,1847745
hyuA_predicted,0.1111111111111111,8,8,CTGGTAACGAATCTCAGAGG,0,1854698
hyuA_predicted,0.1111111111111111,8,8,CTGGCATTGGACTATCTATC,0,1830403
hyuA_predicted,0.1111111111111111,8,8,CTGATTATATGTCCTCGGAG,0,1853437
hyuA_predicted,0.1111111111111111,8,8,CTGAGCGTAAGATCTAATGT,0,1857692
hyuA_predicted,0.1111111111111111,8,8,CTCTTTGCGTTAGTCATTAC,0,1863562
hyuA_predicted,0.1111111111111111,8,8,CTCTTAATTAGAATCGAGGG,0,1846125
hyuA_predicted,0.1111111111111111,8,8,CTCCGTCGCAAACCGCCCTA,0,1834185
hyuA_predicted,0.1111111111111111,8,8,CTCCGGGTCCGTAGAGTCCA,0,1846636
hyuA_predicted,0.1111111111111111,8,8,CTCCAGACATTTGTACTATG,0,1844358
hyuA_predicted,0.1111111111111111,8,8,CTCAAAAGCGGTCCATTCCT,0,1857275
hyuA_predicted,0.1111111111111111,8,8,CTAGCTTGCACTCGGCCTCT,0,1856052
hyuA_predicted,0.1111111111111111,8,8,CTAGAACTTGAAATCAACGC,0,1832327
hyuA_predicted,0.1111111111111111,8,8,CTACTATGTCGGAAGTCTGT,0,1832169
hyuA_predicted,0.1111111111111111,8,8,CTAATTTGCAGAACGACCCG,0,1877786
hyuA_predicted,0.1111111111111111,8,8,CTAAAAATGCTGGTCCTTCT,0,1856366
hyuA_predicted,0.1111111111111111,8,8,CGTGGTTCGAGAATGACTTT,0,1864008
hyuA_predicted,0.1111111111111111,8,8,CGTGGAGATAACAGTATGTG,0,1876135
hyuA_predicted,0.1111111111111111,8,8,CGTGATATCTTTAGCATTAT,0,1842683
hyuA_predicted,0.1111111111111111,8,8,CGTGAGAGTTCCGGTATTCA,0,1852299
hyuA_predicted,0.1111111111111111,8,8,CGTCTCGCATACTCGCCCAA,0,1843413
hyuA_predicted,0.1111111111111111,8,8,CGTCGCTCAAAGGGATCGCA,0,1855705
hyuA_predicted,0.1111111111111111,8,8,CGGTTTCCATACGGTGAAGT,0,1832144
hyuA_predicted,0.1111111111111111,8,8,CGGTCGTAGTAGCGGTTTAT,0,1854409
hyuA_predicted,0.1111111111111111,8,8,CGGTCACCCAGTGGAATGTG,0,1871036
hyuA_predicted,0.1111111111111111,8,8,CGGGGGTATATGTCCAAGTA,0,1838848
hyuA_predicted,0.1111111111111111,8,8,CGGGGGGAACGCAATGGCGC,0,1831047
hyuA_predicted,0.1111111111111111,8,8,CGGGATGAGGCTTCCTGTCT,0,1858916
hyuA_predicted,0.1111111111111111,8,8,CGGCTTTTTCCACCAGCCAC,0,1844684
hyuA_predicted,0.1111111111111111,8,8,CGGCAAGGTACGGGCGCGGA,0,1844195
hyuA_predicted,0.1111111111111111,8,8,CGCTTTACCATATATGGCGC,0,1836049
hyuA_predicted,0.1111111111111111,8,8,CGCTTGAGGACTGGTACCGT,0,1850955
hyuA_predicted,0.1111111111111111,8,8,CGCTTATCTTTAATGCAGGG,0,1853294
hyuA_predicted,0.1111111111111111,8,8,CGCTGCAGCAGCTACCTAAC,0,1842154
hyuA_predicted,0.1111111111111111,8,8,CGCGACACGGTCCACGGGGA,0,1832358
hyuA_predicted,0.1111111111111111,8,8,CGCCGGTCGCCACTAGAAAT,0,1864807
hyuA_predicted,0.1111111111111111,8,8,CGCCAGGCAGAGTGGTGGCC,0,1845680
hyuA_predicted,0.1111111111111111,8,8,CGCCAACAGTACGTCCGGTG,0,1869992
hyuA_predicted,0.1111111111111111,8,8,CGATGGCAGGCAGTCATTGC,0,1830134
hyuA_predicted,0.1111111111111111,8,8,CGAGTCGCTTTGAAACGAGT,0,1836411
hyuA_predicted,0.1111111111111111,8,8,CGAGGTCTCTTACGCATGAT,0,1866096
hyuA_predicted,0.1111111111111111,8,8,CGACTCGGGTAGAAGTTTGT,0,1837352
hyuA_predicted,0.1111111111111111,8,8,CGACCTTTGACCCTGGCAAA,0,1846779
hyuA_predicted,0.1111111111111111,8,8,CGAATTTGGACACAGGGTGG,0,1868413
hyuA_predicted,0.1111111111111111,8,8,CGAAGGGGAACACGTGCGGG,0,1840586
hyuA_predicted,0.1111111111111111,8,8,CGAAGCATGCATCTTGGTCC,0,1854841
hyuA_predicted,0.1111111111111111,8,8,CGAAAATTGTGGAGAGCTCT,0,1834536
hyuA_predicted,0.1111111111111111,8,8,CGAAAAAAAGTGGGTTTGTC,0,1852746
hyuA_predicted,0.1111111111111111,8,8,CCTTTCGGTGTGGACTGCAA,0,1855166
hyuA_predicted,0.1111111111111111,8,8,CCTTCCGCCTACTTCAAATT,0,1871600
hyuA_predicted,0.1111111111111111,8,8,CCTTACATCAGCCAGTCCAG,0,1848666
hyuA_predicted,0.1111111111111111,8,8,CCTCGACCATCCGCGTACCT,0,1867221
hyuA_predicted,0.1111111111111111,8,8,CCTCAAACCCAATTTTGAGA,0,1828882
hyuA_predicted,0.1111111111111111,8,8,CCTACAATCTCAGAGGCATA,0,1852990
hyuA_predicted,0.1111111111111111,8,8,CCTAACGAATCTGGTGCGCG,0,1860262
hyuA_predicted,0.1111111111111111,8,8,CCGTCTAGTAGTCTTGTTAG,0,1873701
hyuA_predicted,0.1111111111111111,8,8,CCGTCCCAGCCGGATCCTAT,0,1847118
hyuA_predicted,0.1111111111111111,8,8,CCGTAGTGGATGATTGTGAT,0,1876476
hyuA_predicted,0.1111111111111111,8,8,CCGGCTATACCCAACTGCAA,0,1837429
hyuA_predicted,0.1111111111111111,8,8,CCGGCCGGCAAGGCTACGTC,0,1858821
hyuA_predicted,0.1111111111111111,8,8,CCGCCCATCCCGGTACTTGA,0,1851951
hyuA_predicted,0.1111111111111111,8,8,CCGCCACCGCTCCAGTTACA,0,1840082
hyuA_predicted,0.1111111111111111,8,8,CCGCAGAGCTCGCACAAGCG,0,1841814
hyuA_predicted,0.1111111111111111,8,8,CCGAGTGCAAAGAACCGGTG,0,1844839
hyuA_predicted,0.1111111111111111,8,8,CCGAGGAAACGGAGTCTAGG,0,1849678
hyuA_predicted,0.1111111111111111,8,8,CCGAGCGTTTCGGTGGGAGA,0,1856258
hyuA_predicted,0.1111111111111111,8,8,CCGAGAGGCACTTAGCGGTC,0,1833167
hyuA_predicted,0.1111111111111111,8,8,CCGACGGCACGTTCAGGGGA,0,1831026
hyuA_predicted,0.1111111111111111,8,8,CCCTGGCGCAAGCAAGCCAG,0,1845662
hyuA_predicted,0.1111111111111111,8,8,CCCTAGGGGCGTGACTCACA,0,1861352
hyuA_predicted,0.1111111111111111,8,8,CCCTAGCATAAGAAACATCT,0,1854649
hyuA_predicted,0.1111111111111111,8,8,CCCTACATGAAAGCGTGAAT,0,1869189
hyuA_predicted,0.1111111111111111,8,8,CCCGATCATCATCCCGGATT,0,1847251
hyuA_predicted,0.1111111111111111,8,8,CCCCTAGTATTACGCCTCGG,0,1862346
hyuA_predicted,0.1111111111111111,8,8,CCCCGAGCCACATTTCTGGA,0,1835213
hyuA_predicted,0.1111111111111111,8,8,CCCCCCAACATGAGGAGGTC,0,1832698
hyuA_predicted,0.1111111111111111,8,8,CCCATAGAGTCAATGGGCAT,0,1835954
hyuA_predicted,0.1111111111111111,8,8,CCCAGAGAAGGGGATACTTT,0,1876092
hyuA_predicted,0.1111111111111111,8,8,CCATCGGCAGTGTGTGTACG,0,1865569
hyuA_predicted,0.1111111111111111,8,8,CCATAACGCAGGGCTAACAC,0,1865160
hyuA_predicted,0.1111111111111111,8,8,CCAGGGCTCTTGGTAATAAC,0,1842900
hyuA_predicted,0.1111111111111111,8,8,CCACTGTCGTCCGCAGTGTC,0,1852349
hyuA_predicted,0.1111111111111111,8,8,CCACGGTAATGTCGAGATGA,0,1870026
hyuA_predicted,0.1111111111111111,8,8,CCAATGGATTGCGAGAAGGA,0,1862635
hyuA_predicted,0.1111111111111111,8,8,CCAATCCTCGCGTTGCTGGA,0,1873504
hyuA_predicted,0.1111111111111111,8,8,CCAAAATTCACTGCTATCTT,0,1865728
hyuA_predicted,0.1111111111111111,8,8,CATTATAACAGATTTCGGAC,0,1855036
hyuA_predicted,0.1111111111111111,8,8,CATTAGCGTCCAACATCTCC,0,1872016
hyuA_predicted,0.1111111111111111,8,8,CATGTCTTCGGGGTCGCATC,0,1832325
hyuA_predicted,0.1111111111111111,8,8,CATCTTTGCCCCGGCTTAAG,0,1853442
hyuA_predicted,0.1111111111111111,8,8,CATCAGTCCCCACAACAGAA,0,1870998
hyuA_predicted,0.1111111111111111,8,8,CATCACTGAAAGCCAGAAAG,0,1845238
hyuA_predicted,0.1111111111111111,8,8,CATATGTCTTTCATGTTTTC,0,1837480
hyuA_predicted,0.1111111111111111,8,8,CATAGCGGCTAATGCACAGC,0,1838976
hyuA_predicted,0.1111111111111111,8,8,CATACGAGAGACAGTATCTA,0,1837958
hyuA_predicted,0.1111111111111111,8,8,CAGTCCTGTGGGGACCGGTG,0,1841403
hyuA_predicted,0.1111111111111111,8,8,CAGTCACTAGGATTATACGA,0,1838441
hyuA_predicted,0.1111111111111111,8,8,CAGGCTCCAGAGCTTTTACA,0,1854183
hyuA_predicted,0.1111111111111111,8,8,CAGGAACGTTCGCCCCTAAA,0,1829511
hyuA_predicted,0.1111111111111111,8,8,CAGCGGAACACTACAAGGCA,0,1854913
hyuA_predicted,0.1111111111111111,8,8,CAGCCAGTGACTATAAGGGG,0,1838957
hyuA_predicted,0.1111111111111111,8,8,CAGATACACGTAGTATCTTG,0,1841661
hyuA_predicted,0.1111111111111111,8,8,CACGGCCATATCGAATTCTA,0,1863993
hyuA_predicted,0.1111111111111111,8,8,CACGCTGTGCTTGGGTATGA,0,1851876
hyuA_predicted,0.1111111111111111,8,8,CACCGCTGATACGTTATGAG,0,1867199
hyuA_predicted,0.1111111111111111,8,8,CACCGATTTTTAAGCGCAAG,0,1874394
hyuA_predicted,0.1111111111111111,8,8,CACCCGCCCCGGGCTTTATT,0,1836653
hyuA_predicted,0.1111111111111111,8,8,CACCCAACCGATCTTTCGGC,0,1866584
hyuA_predicted,0.1111111111111111,8,8,CACATCACGGCGTCGCGTAA,0,1839707
hyuA_predicted,0.1111111111111111,8,8,CAATCTAAGGCGCGGAGGGC,0,1846257
hyuA_predicted,0.1111111111111111,8,8,CAATCCCGGGAGGTGCGGGG,0,1837665
hyuA_predicted,0.1111111111111111,8,8,CAATATCGCAAGCCGTGTCT,0,1857342
hyuA_predicted,0.1111111111111111,8,8,CAAGGGCATGGCTAGTGCAA,0,1871739
hyuA_predicted,0.1111111111111111,8,8,CAAGATCAGATAGAATAGAA,0,1877470
hyuA_predicted,0.1111111111111111,8,8,CAAGAATCTCTCACGAGTAT,0,1876097
hyuA_predicted,0.1111111111111111,8,8,CAACTGACATCAGTACGAAA,0,1849454
hyuA_predicted,0.1111111111111111,8,8,CAACATTACGTTATAGCACT,0,1861900
hyuA_predicted,0.1111111111111111,8,8,ATTTACGCTGTTTTAAGAGG,0,1838926
hyuA_predicted,0.1111111111111111,8,8,ATTGGGGTCTATTGCGATTA,0,1870677
hyuA_predicted,0.1111111111111111,8,8,ATTGATGGGGCAGATCATAA,0,1842482
hyuA_predicted,0.1111111111111111,8,8,ATTCCAGTCATGTTTAGGCT,0,1830595
hyuA_predicted,0.1111111111111111,8,8,ATTCACCGGCAACATATAGT,0,1863055
hyuA_predicted,0.1111111111111111,8,8,ATTAGTCCGAATCGCCTAGG,0,1840093
hyuA_predicted,0.1111111111111111,8,8,ATTAGGCGTGTTATTCACGA,0,1872129
hyuA_predicted,0.1111111111111111,8,8,ATGGTAGCCTCAACTAAATT,0,1865529
hyuA_predicted,0.1111111111111111,8,8,ATGGCAGTCACAATCAATAT,0,1851542
hyuA_predicted,0.1111111111111111,8,8,ATGGAACCGTTTTTTCGGGA,0,1876315
hyuA_predicted,0.1111111111111111,8,8,ATGCGACAAGTTTCTGGGTG,0,1856062
hyuA_predicted,0.1111111111111111,8,8,ATGCCATGATGCGTTAACGG,0,1852226
hyuA_predicted,0.1111111111111111,8,8,ATGAGTGCAAGACCAAGGCA,0,1862910
hyuA_predicted,0.1111111111111111,8,8,ATCTGCCATATTCACTATAC,0,1834189
hyuA_predicted,0.1111111111111111,8,8,ATCTGAATTCTGGATCTATG,0,1844424
hyuA_predicted,0.1111111111111111,8,8,ATCGTCCTCAGGTTATCGTC,0,1850953
hyuA_predicted,0.1111111111111111,8,8,ATCGGGTATGAAGGAGCTTA,0,1838651
hyuA_predicted,0.1111111111111111,8,8,ATCGGCTGCCGACCACACGT,0,1865126
hyuA_predicted,0.1111111111111111,8,8,ATCCCGCTGTGAGTGTTCTA,0,1868104
hyuA_predicted,0.1111111111111111,8,8,ATCAGACGGGTATTTCCCAG,0,1876170
hyuA_predicted,0.1111111111111111,8,8,ATCACGCCCTTGGGGTCTAT,0,1875463
hyuA_predicted,0.1111111111111111,8,8,ATATAATTGGAGATTCTTGG,0,1870428
hyuA_predicted,0.1111111111111111,8,8,ATAGCCAAAGGATGGATTGC,0,1840736
hyuA_predicted,0.1111111111111111,8,8,ATAGAGCGGTACCTGCATTT,0,1869651
hyuA_predicted,0.1111111111111111,8,8,ATAGAACGTTTATAAGAGGT,0,1829369
hyuA_predicted,0.1111111111111111,8,8,ATACCAGCGTAAGCGATGCA,0,1843432
hyuA_predicted,0.1111111111111111,8,8,ATACCAACCCGTGGGCCGAA,0,1846434
hyuA_predicted,0.1111111111111111,8,8,AGTGTTCTAAATTCTTAGGC,0,1839851
hyuA_predicted,0.1111111111111111,8,8,AGTGATTCCGGGTGTTGCAA,0,1861450
hyuA_predicted,0.1111111111111111,8,8,AGTGAACGATTCGCCCGTTC,0,1842916
hyuA_predicted,0.1111111111111111,8,8,AGTCCGGTTCCCAAGACGGT,0,1844941
hyuA_predicted,0.1111111111111111,8,8,AGTCCGCGCCGTAATGAGTA,0,1835969
hyuA_predicted,0.1111111111111111,8,8,AGTCAGACCGCACCGCGGAG,0,1863902
hyuA_predicted,0.1111111111111111,8,8,AGTACTGAGCACGCGTGATG,0,1845574
hyuA_predicted,0.1111111111111111,8,8,AGTAAAGTTCTAACGTGCCA,0,1864877
hyuA_predicted,0.1111111111111111,8,8,AGGTGCACAGGAGCCGGATG,0,1867237
hyuA_predicted,0.1111111111111111,8,8,AGGTCCTATTTATGTCGAGG,0,1856216
hyuA_predicted,0.1111111111111111,8,8,AGGTAGGACGGAGCAGGCGT,0,1863357
hyuA_predicted,0.1111111111111111,8,8,AGGGTCCACAATTTATTTCA,0,1852137
hyuA_predicted,0.1111111111111111,8,8,AGGGGATATTGGAATGTACC,0,1860420
hyuA_predicted,0.1111111111111111,8,8,AGGGAGACCGATGAATCACG,0,1868389
hyuA_predicted,0.1111111111111111,8,8,AGGCTCTGGGGGTGCCCTCG,0,1853049
hyuA_predicted,0.1111111111111111,8,8,AGGCGAATGCTGGAAGATAC,0,1867314
hyuA_predicted,0.1111111111111111,8,8,AGGCCTTAGATTTCGCCATG,0,1843708
hyuA_predicted,0.1111111111111111,8,8,AGGAGTGGGTAGGCGGAAAC,0,1869909
hyuA_predicted,0.1111111111111111,8,8,AGCTTCCAATAGGTTCTATA,0,1853281
hyuA_predicted,0.1111111111111111,8,8,AGCTGCAAAAATTCCTACGA,0,1866199
hyuA_predicted,0.1111111111111111,8,8,AGCTATCAGTCTTTCTGAGG,0,1859811
hyuA_predicted,0.1111111111111111,8,8,AGCGGCTTCACTGAGACAAA,0,1829829
hyuA_predicted,0.1111111111111111,8,8,AGCGAGCCCTGAAGTAAGGG,0,1860094
hyuA_predicted,0.1111111111111111,8,8,AGCCGTTCATGCCACATCAT,0,1872563
hyuA_predicted,0.1111111111111111,8,8,AGCCGGTGGGATCTGAAGAC,0,1840893
hyuA_predicted,0.1111111111111111,8,8,AGCATCGGCAACGCGCATCG,0,1877851
hyuA_predicted,0.1111111111111111,8,8,AGCATACTGGACACTTGATG,0,1875521
hyuA_predicted,0.1111111111111111,8,8,AGCATAAGAAGATATGGTGC,0,1871986
hyuA_predicted,0.1111111111111111,8,8,AGCAATGGCGCTATGAAGGC,0,1866870
hyuA_predicted,0.1111111111111111,8,8,AGATTTGGACGATAGTCGCA,0,1873652
hyuA_predicted,0.1111111111111111,8,8,AGATGGACAAGATAACTGTG,0,1834715
hyuA_predicted,0.1111111111111111,8,8,AGACGTGGTGAGGTTATGCT,0,1865117
hyuA_predicted,0.1111111111111111,8,8,AGACCATTCGAGGAATTTCG,0,1864439
hyuA_predicted,0.1111111111111111,8,8,AGAATCGGATTCTTTATGTT,0,1856788
hyuA_predicted,0.1111111111111111,8,8,AGAAGCGATGTGGTGTACCT,0,1829976
hyuA_predicted,0.1111111111111111,8,8,AGAAGACACCTTTCTGGAAT,0,1846742
hyuA_predicted,0.1111111111111111,8,8,AGAAGAACTCCGATACCTGT,0,1876600
hyuA_predicted,0.1111111111111111,8,8,ACTTTACTCGTACTAAGACC,0,1843749
hyuA_predicted,0.1111111111111111,8,8,ACTGTCGCTATCGCGATCAG,0,1869840
hyuA_predicted,0.1111111111111111,8,8,ACTGGGCTGGTTTAGACGGT,0,1852104
hyuA_predicted,0.1111111111111111,8,8,ACTCGCGTGCTGTACGTAAA,0,1863646
hyuA_predicted,0.1111111111111111,8,8,ACTCGCACGGCCTCTTGTTA,0,1844774
hyuA_predicted,0.1111111111111111,8,8,ACTACGGCTGAGCGGCAGGA,0,1858805
hyuA_predicted,0.1111111111111111,8,8,ACGTTACGAGGGACACTGTT,0,1839822
hyuA_predicted,0.1111111111111111,8,8,ACGTCATGGTCATTACATAA,0,1876447
hyuA_predicted,0.1111111111111111,8,8,ACGTCACACCTAGGTTTCGG,0,1835523
hyuA_predicted,0.1111111111111111,8,8,ACGCGTCTTGGGTAGCTTAG,0,1867339
hyuA_predicted,0.1111111111111111,8,8,ACGCGTAAACTGAGTGTGTT,0,1854190
hyuA_predicted,0.1111111111111111,8,8,ACGATTTACTACACATTGCC,0,1875027
hyuA_predicted,0.1111111111111111,8,8,ACCTTTTAGACTACGCTGAT,0,1874652
hyuA_predicted,0.1111111111111111,8,8,ACCTCGCGCAATCAGGTTTT,0,1869605
hyuA_predicted,0.1111111111111111,8,8,ACCGTACGATTTTCATTTAC,0,1838864
hyuA_predicted,0.1111111111111111,8,8,ACCGAATTATTCAATATGTC,0,1837353
hyuA_predicted,0.1111111111111111,8,8,ACCATGGAGGTCTGGTCGAT,0,1862321
hyuA_predicted,0.1111111111111111,8,8,ACATGGTCCCATAGTCAGGT,0,1831687
hyuA_predicted,0.1111111111111111,8,8,ACATCTAAGTTTAGGAGGAA,0,1858630
hyuA_predicted,0.1111111111111111,8,8,ACATATTACATCGTGGAATT,0,1833965
hyuA_predicted,0.1111111111111111,8,8,ACAGGTGAGTTGATTTCGCT,0,1861092
hyuA_predicted,0.1111111111111111,8,8,ACAGGGTTGCAACGGCCCGT,0,1853879
hyuA_predicted,0.1111111111111111,8,8,ACAACCCACGTGGGTAGATT,0,1852298
hyuA_predicted,0.1111111111111111,8,8,ACAAAGTTGTGGATGGGTCC,0,1860126
hyuA_predicted,0.1111111111111111,8,8,ACAAACCGCGTCTTTAGTGA,0,1848064
hyuA_predicted,0.1111111111111111,8,8,ACAAACATGGTGTCGATCGG,0,1830239
hyuA_predicted,0.1111111111111111,8,8,AATTTGACTTTTGGACTAAT,0,1840492
hyuA_predicted,0.1111111111111111,8,8,AATTGTTTCATCACGATCTA,0,1831270
hyuA_predicted,0.1111111111111111,8,8,AATTCGTCCATCGCTTGCGT,0,1851809
hyuA_predicted,0.1111111111111111,8,8,AATCTTTTAACATTGTGTTT,0,1833978
hyuA_predicted,0.1111111111111111,8,8,AATAGAGCGGTTGCCCGGGA,0,1852844
hyuA_predicted,0.1111111111111111,8,8,AATAAGGACCGATTGACCCA,0,1853497
hyuA_predicted,0.1111111111111111,8,8,AAGTTGAGTCACTATTACGA,0,1836045
hyuA_predicted,0.1111111111111111,8,8,AAGTTATGACTTTCTTCTGT,0,1853877
hyuA_predicted,0.1111111111111111,8,8,AAGTTAATGTGCCAGGTAGT,0,1830584
hyuA_predicted,0.1111111111111111,8,8,AAGTGAAGCCGCCGGAGCAA,0,1859633
hyuA_predicted,0.1111111111111111,8,8,AAGTCTATTGGATTTTGGCG,0,1834128
hyuA_predicted,0.1111111111111111,8,8,AAGGTGTGTATCTATTTTTA,0,1838095
hyuA_predicted,0.1111111111111111,8,8,AAGGGGGTCGAGACACCGTC,0,1867803
hyuA_predicted,0.1111111111111111,8,8,AAGGAACTCTGCGGTAAGCG,0,1845535
hyuA_predicted,0.1111111111111111,8,8,AAGCGGCCTCGTGGGCACCC,0,1854626
hyuA_predicted,0.1111111111111111,8,8,AAGCGGAATAGATTATGAAA,0,1866925
hyuA_predicted,0.1111111111111111,8,8,AACTTTAAAGTGGCTAACTT,0,1844442
hyuA_predicted,0.1111111111111111,8,8,AACGCCGGAGATGAGGTATC,0,1850715
hyuA_predicted,0.1111111111111111,8,8,AACATTTCTGCTCAGTTGTG,0,1853086
hyuA_predicted,0.1111111111111111,8,8,AAATCGTGCTAGGGCGCGGC,0,1865968
hyuA_predicted,0.1111111111111111,8,8,AAAGGGCCTTACAGCCTAGG,0,1834735
hyuA_predicted,0.1111111111111111,8,8,AAACTCAATTTTTAAGGGGA,0,1841534
hyuA_predicted,0.1111111111111111,8,8,AAACGACCAGACTGCGGGCA,0,1864255
hyuA_predicted,0.1111111111111111,8,8,AAAACAGACCGGGCCATAAC,0,1874254
hyuA_predicted,0.125,7,7,TTTTTGACAAAGTTTGCGTA,0,1876232
hyuA_predicted,0.125,7,7,TTTTTACTAGACGCATTGAA,0,1834615
hyuA_predicted,0.125,7,7,TTTTGGACATCTCATAGTCT,0,1829269
hyuA_predicted,0.125,7,7,TTTGGGGCCGCTCGGGCGCA,0,1830342
hyuA_predicted,0.125,7,7,TTTGGAGAAACGCATGATGC,0,1831320
hyuA_predicted,0.125,7,7,TTTCATATGACTATGGATAG,0,1865290
hyuA_predicted,0.125,7,7,TTTAGCCGTGCGAATGAACT,0,1865918
hyuA_predicted,0.125,7,7,TTTACCCTTACTGAGGAGGA,0,1832347
hyuA_predicted,0.125,7,7,TTGTTTTAGAGTACAACAGG,0,1831728
hyuA_predicted,0.125,7,7,TTGTCATCTATTAGGCAAGA,0,1842249
hyuA_predicted,0.125,7,7,TTGGTTGGACAGGCCCGCCC,0,1861294
hyuA_predicted,0.125,7,7,TTGGACCGCATGATAGATAA,0,1861035
hyuA_predicted,0.125,7,7,TTGCATATTTTATAACCAGC,0,1836389
hyuA_predicted,0.125,7,7,TTGAGGCTCCGATAAGTGGA,0,1857531
hyuA_predicted,0.125,7,7,TTGAGCCCGAATTTCTTGGC,0,1840373
hyuA_predicted,0.125,7,7,TTCTTCAATTTTACCTCTCT,0,1866805
hyuA_predicted,0.125,7,7,TTCTTAAAAATCTTGACGGA,0,1850497
hyuA_predicted,0.125,7,7,TTCTGCAACGGGTCTCCCTT,0,1872192
hyuA_predicted,0.125,7,7,TTCTATCCAGTAACGGAAAG,0,1868969
hyuA_predicted,0.125,7,7,TTCGTCGTTCGGATTGCGGC,0,1832291
hyuA_predicted,0.125,7,7,TTCGGCGGCCGGATACGAGC,0,1834589
hyuA_predicted,0.125,7,7,TTCGAGCCCATGCCTTCATC,0,1868762
hyuA_predicted,0.125,7,7,TTCGAACGATAAGGATAGAG,0,1858136
hyuA_predicted,0.125,7,7,TTCCACTTGAGAAAGGCAAA,0,1862234
hyuA_predicted,0.125,7,7,TTCAATCGAACATCTGAGCT,0,1869117
hyuA_predicted,0.125,7,7,TTATCTTATCGTGCAACCAG,0,1849831
hyuA_predicted,0.125,7,7,TTAGTCGTAGTCATCCGGGA,0,1858349
hyuA_predicted,0.125,7,7,TTAGTCCAGGAGCCACCGAA,0,1870276
hyuA_predicted,0.125,7,7,TTAGCATGCGCTAAAGTAAA,0,1839455
hyuA_predicted,0.125,7,7,TTAGAGTACTCCCAACTGAA,0,1863086
hyuA_predicted,0.125,7,7,TTACGGCGTTAAGGCACCAA,0,1858540
hyuA_predicted,0.125,7,7,TGTTGCCTCTTTTACCAATT,0,1875029
hyuA_predicted,0.125,7,7,TGTTCTGGGATAACTACAGA,0,1874007
hyuA_predicted,0.125,7,7,TGTTCATCAGCTCGAAGATG,0,1840307
hyuA_predicted,0.125,7,7,TGTGGAGAGGTCTGCGGGGA,0,1844067
hyuA_predicted,0.125,7,7,TGTCTGCACTGATCAGTATG,0,1859168
hyuA_predicted,0.125,7,7,TGTCATGTAGGCAAGGCGTT,0,1868680
hyuA_predicted,0.125,7,7,TGTCAGGCACAATTAGATGT,0,1871898
hyuA_predicted,0.125,7,7,TGTACTCTAACACACGCGGA,0,1865543
hyuA_predicted,0.125,7,7,TGTAATAAGTGTCTCTAAAA,0,1832614
hyuA_predicted,0.125,7,7,TGTAAGTCTAGGGTCGCTGT,0,1838303
hyuA_predicted,0.125,7,7,TGGTGCCCGGGAGACATGAT,0,1864353
hyuA_predicted,0.125,7,7,TGGCCGCATATACAAACGCT,0,1835081
hyuA_predicted,0.125,7,7,TGGCCAATCAGTGTTGACCA,0,1866160
hyuA_predicted,0.125,7,7,TGCTTACCCGGCCATGCTGT,0,1838190
hyuA_predicted,0.125,7,7,TGCCTACGCAAACTCCCCAA,0,1842399
hyuA_predicted,0.125,7,7,TGCCGGTCCTCTCTAATGTG,0,1852287
hyuA_predicted,0.125,7,7,TGCCGCTTTACACTGCAGAG,0,1865665
hyuA_predicted,0.125,7,7,TGCCCGGCTGCACATGGTGC,0,1858756
hyuA_predicted,0.125,7,7,TGCCCCCTAGGATGTCATTC,0,1838363
hyuA_predicted,0.125,7,7,TGATCCTGCTTGCTCGTTCC,0,1839234
hyuA_predicted,0.125,7,7,TGATCATCGCGATGTGGTTA,0,1861028
hyuA_predicted,0.125,7,7,TGAGCATTGTTTCATTGATA,0,1836053
hyuA_predicted,0.125,7,7,TGACTGCGTGTACGGAGGAA,0,1870923
hyuA_predicted,0.125,7,7,TGACGGGTGTTTTTCGACCC,0,1863928
hyuA_predicted,0.125,7,7,TGACATAGAAAAGATACGAC,0,1833684
hyuA_predicted,0.125,7,7,TGAACTGGATCGACCGGGAA,0,1841539
hyuA_predicted,0.125,7,7,TGAAAAACTCGACCTGGTCA,0,1868810
hyuA_predicted,0.125,7,7,TCTGTTTACGGACAGGGTTT,0,1833713
hyuA_predicted,0.125,7,7,TCTGGTCAGGAAGGGTCCAA,0,1865528
hyuA_predicted,0.125,7,7,TCTGATCAGGCTTTTTAGGT,0,1832666
hyuA_predicted,0.125,7,7,TCTGACTCCGGGGAGGACCA,0,1838385
hyuA_predicted,0.125,7,7,TCTCTTTTGTCAACTCTAGG,0,1834224
hyuA_predicted,0.125,7,7,TCTCTTTACGTACCGGGGTA,0,1842350
hyuA_predicted,0.125,7,7,TCTCTTGCACGGAGAATCAG,0,1834677
hyuA_predicted,0.125,7,7,TCGTCTCCGCTCTCGGCTCG,0,1845584
hyuA_predicted,0.125,7,7,TCGTAGACGGCTTCGACGCC,0,1840177
hyuA_predicted,0.125,7,7,TCGTACACTATCTGGTGGAC,0,1832839
hyuA_predicted,0.125,7,7,TCGTAAATCGATATAAGGCT,0,1836691
hyuA_predicted,0.125,7,7,TCGGTCCTGCAAGCTGCATG,0,1852815
hyuA_predicted,0.125,7,7,TCGGTAGGACTTCCTTTAAT,0,1850108
hyuA_predicted,0.125,7,7,TCGGCGGCAGATAGCGGAAA,0,1829159
hyuA_predicted,0.125,7,7,TCGGCCACGGGTCGCGCCGG,0,1835715
hyuA_predicted,0.125,7,7,TCGCTGGTGTTAGGCATTCC,0,1846101
hyuA_predicted,0.125,7,7,TCGCACCGCATTAACTCTAT,0,1840460
hyuA_predicted,0.125,7,7,TCGATGGGCCATGTCATGCA,0,1860404
hyuA_predicted,0.125,7,7,TCGAGGGACGTTGGTATTGC,0,1863343
hyuA_predicted,0.125,7,7,TCGAGGATGAGCGCGCGACG,0,1841430
hyuA_predicted,0.125,7,7,TCCTTGGTTATACGGTCTCT,0,1860483
hyuA_predicted,0.125,7,7,TCCTGGTCTTGCAAACGCTA,0,1875091
hyuA_predicted,0.125,7,7,TCCTGCCTTCCGCGGTGCTT,0,1854998
hyuA_predicted,0.125,7,7,TCCCTTATTCCACGCGCTAG,0,1847949
hyuA_predicted,0.125,7,7,TCCCTCAACATCGGCGCACT,0,1852795
hyuA_predicted,0.125,7,7,TCCCGTGTTAAACCGATTTC,0,1838431
hyuA_predicted,0.125,7,7,TCCCGAGAGGGGAGTTTGAG,0,1857460
hyuA_predicted,0.125,7,7,TCCATCCCGGCCATAGCCAA,0,1829880
hyuA_predicted,0.125,7,7,TCATGTATATAGGCTTCTTA,0,1863851
hyuA_predicted,0.125,7,7,TCATCATGGGTAGCGCATGG,0,1868656
hyuA_predicted,0.125,7,7,TCAGCGGATATCGATTAAAA,0,1869311
hyuA_predicted,0.125,7,7,TCACTTGCATGGCCATTAAG,0,1863654
hyuA_predicted,0.125,7,7,TCAATCTCGCCCTGCGGCTC,0,1868979
hyuA_predicted,0.125,7,7,TATTTTCGGTACAATCGTTC,0,1875384
hyuA_predicted,0.125,7,7,TATTGTACTCCCCCCGCGTC,0,1858538
hyuA_predicted,0.125,7,7,TATTGCAGGCACCAGAGGAA,0,1831663
hyuA_predicted,0.125,7,7,TATGTATAGCGGACAAAGAC,0,1834625
hyuA_predicted,0.125,7,7,TATGGACCCTCGCGTTCACT,0,1861695
hyuA_predicted,0.125,7,7,TATGCACGGCTCTCAGTAAT,0,1849197
hyuA_predicted,0.125,7,7,TATCCAAGTCCGTGCCATCA,0,1859925
hyuA_predicted,0.125,7,7,TATACCAGCGGGCAGTTAAG,0,1849474
hyuA_predicted,0.125,7,7,TATAATGGCGCATCGGAGAA,0,1852886
hyuA_predicted,0.125,7,7,TAGGCAGATATCTGTGCCTA,0,1854921
hyuA_predicted,0.125,7,7,TAGAGACGGCGCGTGCCGAG,0,1856609
hyuA_predicted,0.125,7,7,TAGAACATATTCGGGGTATC,0,1846198
hyuA_predicted,0.125,7,7,TACGTCCCGTAGGCTGCTAT,0,1861169
hyuA_predicted,0.125,7,7,TACCGTCGGCGACAAGTTCT,0,1874798
hyuA_predicted,0.125,7,7,TACCGGAAATACGTTGGAAT,0,1849905
hyuA_predicted,0.125,7,7,TACAGTCATGGAGCATCAGC,0,1870424
hyuA_predicted,0.125,7,7,TAAGGATCTGTGTGAACCTG,0,1855985
hyuA_predicted,0.125,7,7,TAAGGACAATCCTCAGGATA,0,1833056
hyuA_predicted,0.125,7,7,TAAAGGTATGGTGTCAGTAT,0,1862458
hyuA_predicted,0.125,7,7,TAAACGGCAACCACAAATTG,0,1850866
hyuA_predicted,0.125,7,7,TAAAAGCGCCTCTCACAGCA,0,1866038
hyuA_predicted,0.125,7,7,GTTTTAAGGGGTCTTCTAGC,0,1855034
hyuA_predicted,0.125,7,7,GTTTCTGTATCGACTCGGGC,0,1843303
hyuA_predicted,0.125,7,7,GTTTACTCTCTCAGCGACTA,0,1853786
hyuA_predicted,0.125,7,7,GTTGTGTCCTCATGTCGGCG,0,1870350
hyuA_predicted,0.125,7,7,GTTGGGCTGCTGGTCCCCCA,0,1855974
hyuA_predicted,0.125,7,7,GTTGCTGACTTGCTGGTTGA,0,1842606
hyuA_predicted,0.125,7,7,GTTGAACCTTCCAAGCACAT,0,1856168
hyuA_predicted,0.125,7,7,GTTCTGTAGGGAACCAATCT,0,1876949
hyuA_predicted,0.125,7,7,GTTCGGTCGTATACACACAA,0,1844407
hyuA_predicted,0.125,7,7,GTTCCAGAGGCACTTCTGCC,0,1831801
hyuA_predicted,0.125,7,7,GTTACGGTCTGGCTATCTGT,0,1869732
hyuA_predicted,0.125,7,7,GTTACAATGCCCGGAGACAC,0,1859476
hyuA_predicted,0.125,7,7,GTGTTGTGGTGGTAGTCAAT,0,1868016
hyuA_predicted,0.125,7,7,GTGTTCTGGGAGGCGGTAAC,0,1838184
hyuA_predicted,0.125,7,7,GTGTCCCCCGGATCGCTTCC,0,1828947
hyuA_predicted,0.125,7,7,GTGGTGCCTAATATAACAAT,0,1871946
hyuA_predicted,0.125,7,7,GTGGGAGGCTCTATCAACGT,0,1838209
hyuA_predicted,0.125,7,7,GTGGCCTGGGGTCCCAGCAG,0,1845545
hyuA_predicted,0.125,7,7,GTGGACCTCTATAGGACGGT,0,1875157
hyuA_predicted,0.125,7,7,GTGGAAGATAATTTATAATA,0,1842640
hyuA_predicted,0.125,7,7,GTGCGCAAAGAACCCGGCAG,0,1870892
hyuA_predicted,0.125,7,7,GTGCATCATCAGAACGGTGT,0,1862389
hyuA_predicted,0.125,7,7,GTGACTCTCGCGTACATTGT,0,1845536
hyuA_predicted,0.125,7,7,GTGAACGTTTTGCAAACTAC,0,1862763
hyuA_predicted,0.125,7,7,GTCTAGGGTCAGGGGCTTTG,0,1844213
hyuA_predicted,0.125,7,7,GTCGGAATCAGTTACTACGC,0,1850757
hyuA_predicted,0.125,7,7,GTCGAAAGCCAAGCGGTTGG,0,1857024
hyuA_predicted,0.125,7,7,GTATCAACCTTTCTTGTAAC,0,1866060
hyuA_predicted,0.125,7,7,GTATAGCATTCCCCTGCCTG,0,1854710
hyuA_predicted,0.125,7,7,GTAGGATGCTACCCTATGCA,0,1830073
hyuA_predicted,0.125,7,7,GTAGATTGTGGACGAAGAGC,0,1832109
hyuA_predicted,0.125,7,7,GTACTGCCGACCTTGGCACT,0,1854460
hyuA_predicted,0.125,7,7,GTACTAATGGTGCTTCTAGC,0,1868421
hyuA_predicted,0.125,7,7,GTACGCCCGCTGGAGTCTAG,0,1830653
hyuA_predicted,0.125,7,7,GTACATCTACGTGTATCTTA,0,1834038
hyuA_predicted,0.125,7,7,GTAATGATCACTAATATATG,0,1874295
hyuA_predicted,0.125,7,7,GTAATAATAACACCGCAGGG,0,1866235
hyuA_predicted,0.125,7,7,GTAAATGTTGGCAGCGTGGC,0,1837778
hyuA_predicted,0.125,7,7,GTAAAGGATGGACGTTATCC,0,1867809
hyuA_predicted,0.125,7,7,GGTTATGATCTCGTGGCCAA,0,1856055
hyuA_predicted,0.125,7,7,GGTGTGCGGGGTACAGATCG,0,1841922
hyuA_predicted,0.125,7,7,GGTGACTTTGGTGTGAAGTT,0,1850794
hyuA_predicted,0.125,7,7,GGTCGTCAGTGGCAGCAGCT,0,1864156
hyuA_predicted,0.125,7,7,GGTAACTCCACCCCTTTGTT,0,1856783
hyuA_predicted,0.125,7,7,GGGTTTTACCTCCGTTAGAA,0,1851303
hyuA_predicted,0.125,7,7,GGGTTGCTACAGCACAGGCG,0,1867088
hyuA_predicted,0.125,7,7,GGGGTCTCGTACACCCATGA,0,1856523
hyuA_predicted,0.125,7,7,GGGGTAAAGTGTCTCCAAAC,0,1832600
hyuA_predicted,0.125,7,7,GGGGCTAGGAAACATAAAAT,0,1829726
hyuA_predicted,0.125,7,7,GGGGCGACCGCAATTCTTCT,0,1837250
hyuA_predicted,0.125,7,7,GGGGCCGATAGTTGGACAAG,0,1844190
hyuA_predicted,0.125,7,7,GGGGAGAAAGCGATTATCGC,0,1863023
hyuA_predicted,0.125,7,7,GGGGACGGCTGTTACAGGAC,0,1840285
hyuA_predicted,0.125,7,7,GGGCCAACGTATGTCTTAAA,0,1850672
hyuA_predicted,0.125,7,7,GGGATAGTTCAGGGTCCCAC,0,1837972
hyuA_predicted,0.125,7,7,GGGAATTGTCTTTCGCGTGA,0,1872619
hyuA_predicted,0.125,7,7,GGGAATTATCTTAACCCGAA,0,1835083
hyuA_predicted,0.125,7,7,GGCTCATTTGAATACTTGGG,0,1843227
hyuA_predicted,0.125,7,7,GGCGGTGGGCGAGTTCTGCT,0,1862115
hyuA_predicted,0.125,7,7,GGCGGGGTCTGCCACGATGG,0,1855550
hyuA_predicted,0.125,7,7,GGCGGATTGTTCTAATTAGT,0,1844882
hyuA_predicted,0.125,7,7,GGCGATCACTGAGGATACGC,0,1843457
hyuA_predicted,0.125,7,7,GGCCTCATCTGACCCAGAGT,0,1849549
hyuA_predicted,0.125,7,7,GGCCGAGTGTGGTTTATATG,0,1852508
hyuA_predicted,0.125,7,7,GGCCAAGTCGCAGGTTTCTG,0,1851961
hyuA_predicted,0.125,7,7,GGCATCCACGTGGGAAAGTC,0,1868711
hyuA_predicted,0.125,7,7,GGCACTCTTTCATTCAACGT,0,1841004
hyuA_predicted,0.125,7,7,GGCACAAGGAGGGTTGAGCG,0,1855482
hyuA_predicted,0.125,7,7,GGCAAAGCTGTGAATGCTAA,0,1866897
hyuA_predicted,0.125,7,7,GGAGGGCAGTGCGGACTCCA,0,1848574
hyuA_predicted,0.125,7,7,GGAGGACAGCAACTCTGCAA,0,1834591
hyuA_predicted,0.125,7,7,GGAGATCTAGTCTAAAACGG,0,1832011
hyuA_predicted,0.125,7,7,GGACGACAACCACTGAACGG,0,1871831
hyuA_predicted,0.125,7,7,GGAATGGGTGAACACATTCC,0,1870145
hyuA_predicted,0.125,7,7,GGAAGCCCCGCGCGATCTCT,0,1875640
hyuA_predicted,0.125,7,7,GGAACGGATCTGGCCACTAA,0,1857894
hyuA_predicted,0.125,7,7,GGAAAGATAGCTTGCATATA,0,1831659
hyuA_predicted,0.125,7,7,GCTTCACCGGCGCAACGAGG,0,1866073
hyuA_predicted,0.125,7,7,GCTACGATCCCGGCGGCGGA,0,1872415
hyuA_predicted,0.125,7,7,GCGGGAAGGTTTCTCAGATC,0,1864279
hyuA_predicted,0.125,7,7,GCGCGTTCTCTGGGGAACAT,0,1842426
hyuA_predicted,0.125,7,7,GCGCATCCGAACGCGATGGA,0,1852559
hyuA_predicted,0.125,7,7,GCGAATACTGGTGTACACTG,0,1830738
hyuA_predicted,0.125,7,7,GCCGTGAACAAAACGACCGT,0,1853980
hyuA_predicted,0.125,7,7,GCCCCGAGGGCGGATGGAAT,0,1877185
hyuA_predicted,0.125,7,7,GCCCCACCTAGACCTAAAAC,0,1838569
hyuA_predicted,0.125,7,7,GCCCAGGGAATGGCCTCTCA,0,1838951
hyuA_predicted,0.125,7,7,GCCATTCACATCGGCAATAG,0,1841629
hyuA_predicted,0.125,7,7,GCCATTATGTACGTTCAGTA,0,1869543
hyuA_predicted,0.125,7,7,GCATTGCCTGCGGGAAGGGG,0,1865638
hyuA_predicted,0.125,7,7,GCATTCCAGCAGACGGACCC,0,1833439
hyuA_predicted,0.125,7,7,GCATGCGATGAGGGATCCAA,0,1867060
hyuA_predicted,0.125,7,7,GCATACTCGCGAAGGACTAT,0,1834135
hyuA_predicted,0.125,7,7,GCAGATTATCTAGATGATTA,0,1832741
hyuA_predicted,0.125,7,7,GCACGGGCATTACGTCAGCA,0,1874102
hyuA_predicted,0.125,7,7,GCACCGCCCTCTATATGACC,0,1848392
hyuA_predicted,0.125,7,7,GCACAGAATTTCTATCCGAT,0,1863429
hyuA_predicted,0.125,7,7,GATTTCCCATAGGGGGAGTA,0,1846061
hyuA_predicted,0.125,7,7,GATTCGCATGAATCTTGGGA,0,1870370
hyuA_predicted,0.125,7,7,GATTAGAGGAGGGAGTTCAT,0,1867182
hyuA_predicted,0.125,7,7,GATGGTTAATCAGTAACCTT,0,1843142
hyuA_predicted,0.125,7,7,GATCTCTAAATAGAACCGTG,0,1847192
hyuA_predicted,0.125,7,7,GATCAACATCGCTCCATGGT,0,1852257
hyuA_predicted,0.125,7,7,GATAAATAGGCACAAAATGT,0,1843827
hyuA_predicted,0.125,7,7,GAGTTGCCAATCTGAAATGT,0,1850430
hyuA_predicted,0.125,7,7,GAGCGGCAGAGATCACGCAA,0,1868663
hyuA_predicted,0.125,7,7,GAGCCACAATTGTGTCGTGT,0,1848786
hyuA_predicted,0.125,7,7,GAGAATTCTGTTAGATGAAA,0,1856249
hyuA_predicted,0.125,7,7,GAGAACCACGTCAATAGCTC,0,1847181
hyuA_predicted,0.125,7,7,GACTTGAAGGGGTTGATGAA,0,1836154
hyuA_predicted,0.125,7,7,GACTCCGCATTTTTGCGTAT,0,1869755
hyuA_predicted,0.125,7,7,GACGGGCACTGCCACCATCT,0,1873388
hyuA_predicted,0.125,7,7,GACGATCTGTTTTGAAACGT,0,1831740
hyuA_predicted,0.125,7,7,GACCGGCTAGATTAGGTAAA,0,1838353
hyuA_predicted,0.125,7,7,GAATCCGGCCGTTGTAGAGA,0,1846290
hyuA_predicted,0.125,7,7,GAATAAATTTGTTATGACAT,0,1834951
hyuA_predicted,0.125,7,7,GAAGTAGTCGGCTTTCGCCA,0,1839352
hyuA_predicted,0.125,7,7,GAAGGGAAAAGATGCGAGAA,0,1831997
hyuA_predicted,0.125,7,7,GAAACCGTGGGAAACAACCC,0,1868273
hyuA_predicted,0.125,7,7,GAAAATTCAGTTTCCAGCTG,0,1870043
hyuA_predicted,0.125,7,7,GAAAAGGACGTTGGGACTAG,0,1846114
hyuA_predicted,0.125,7,7,GAAAAGCATATTCTCGTGCG,0,1866440
hyuA_predicted,0.125,7,7,CTTGAGCGTTCAGTGACACC,0,1875939
hyuA_predicted,0.125,7,7,CTTATTGGGTGATGGGTAAC,0,1853222
hyuA_predicted,0.125,7,7,CTTAGGCCTTTGAGTGGTTT,0,1852500
hyuA_predicted,0.125,7,7,CTGTGTAGGGGTTCAAATAA,0,1847826
hyuA_predicted,0.125,7,7,CTGTGACGTTTTATGGAGTA,0,1834170
hyuA_predicted,0.125,7,7,CTGTAGATTGTGATCGATCA,0,1862266
hyuA_predicted,0.125,7,7,CTGTAAGCCAGGCAGGCAGT,0,1833822
hyuA_predicted,0.125,7,7,CTGGACACTCAGACTAGCCC,0,1853060
hyuA_predicted,0.125,7,7,CTGAGCCTTTTGCCCGCAAA,0,1845202
hyuA_predicted,0.125,7,7,CTCTTTGTTGATGCCAATAG,0,1831888
hyuA_predicted,0.125,7,7,CTCTGGCGACGTGTATTTCG,0,1840942
hyuA_predicted,0.125,7,7,CTCTATTCCTGAACGGTCTG,0,1860054
hyuA_predicted,0.125,7,7,CTCGGACTGAAAGTTCAGTC,0,1852194
hyuA_predicted,0.125,7,7,CTCGCTCAGGAATGTCTACC,0,1857375
hyuA_predicted,0.125,7,7,CTCAGGGTGTGATAAGACTC,0,1832524
hyuA_predicted,0.125,7,7,CTCAAACGTAACTTGTTCTA,0,1869384
hyuA_predicted,0.125,7,7,CTATGTCTTTGGCGTTGGCA,0,1845835
hyuA_predicted,0.125,7,7,CTAGGATAGATATGATTTGC,0,1853231
hyuA_predicted,0.125,7,7,CTACGACTCTTTTTTGCAAT,0,1856544
hyuA_predicted,0.125,7,7,CTAAGGAGGCGAGAGTTAAC,0,1847451
hyuA_predicted,0.125,7,7,CTAAGAACTCCCTCAGCAGC,0,1848842
hyuA_predicted,0.125,7,7,CTAACATGACGATACAATCC,0,1870867
hyuA_predicted,0.125,7,7,CGTTTTTCCGTTCAATAAAC,0,1864426
hyuA_predicted,0.125,7,7,CGTTGGGATTCAATTTGACT,0,1852065
hyuA_predicted,0.125,7,7,CGTGTTAGAGGGTAGTCGCG,0,1857451
hyuA_predicted,0.125,7,7,CGTGCCATAAGACTTCCGGT,0,1870181
hyuA_predicted,0.125,7,7,CGTGCATGCTGTATGGGACT,0,1854347
hyuA_predicted,0.125,7,7,CGTGACTGGGCGCGACTGAC,0,1863531
hyuA_predicted,0.125,7,7,CGTGAAATTGCCATCGGAGC,0,1868079
hyuA_predicted,0.125,7,7,CGTCAGATGGCAGAATCCCG,0,1852474
hyuA_predicted,0.125,7,7,CGTAAAGTTGGACTAGGGCA,0,1860427
hyuA_predicted,0.125,7,7,CGGTCTACTGGTGATGCGAA,0,1864348
hyuA_predicted,0.125,7,7,CGGTCAGATTACGCTCTACA,0,1857936
hyuA_predicted,0.125,7,7,CGGTACGTTGCCTCAGGGCA,0,1870333
hyuA_predicted,0.125,7,7,CGGGCTACTGTCTTACTCTG,0,1831512
hyuA_predicted,0.125,7,7,CGGGCCGTCCGTACCTGCTT,0,1838575
hyuA_predicted,0.125,7,7,CGGGAGCTAAGTGTGCTATA,0,1829135
hyuA_predicted,0.125,7,7,CGGCGTTCATGTATACATTT,0,1877418
hyuA_predicted,0.125,7,7,CGGCGCCGTTTTGGGCACTA,0,1846465
hyuA_predicted,0.125,7,7,CGCTTCCTTCCGCACACTTA,0,1846967
hyuA_predicted,0.125,7,7,CGCTTAAGCAATGCGGAGTA,0,1853671
hyuA_predicted,0.125,7,7,CGCTCAGATCCGCAGACAGG,0,1847605
hyuA_predicted,0.125,7,7,CGCGTTGATGAGTACTGTCC,0,1854791
hyuA_predicted,0.125,7,7,CGCGCCAGTACCTATCGGGA,0,1831357
hyuA_predicted,0.125,7,7,CGCCGTCCGCCGTCACGCGA,0,1870634
hyuA_predicted,0.125,7,7,CGCCGAATGACGTACGGCTA,0,1860192
hyuA_predicted,0.125,7,7,CGCCCCCTGCCCGCTGACCC,0,1845816
hyuA_predicted,0.125,7,7,CGCCATCTGGATTACTCTAC,0,1840961
hyuA_predicted,0.125,7,7,CGCATGGTGTCCCGTAATGA,0,1863355
hyuA_predicted,0.125,7,7,CGCATCCGGGCGTATTCTAC,0,1837730
hyuA_predicted,0.125,7,7,CGCAACGACCCAATGACAAG,0,1857450
hyuA_predicted,0.125,7,7,CGATTCCTTAGTGCTGGGAC,0,1835320
hyuA_predicted,0.125,7,7,CGATATCTAGGCGCCACGTA,0,1837757
hyuA_predicted,0.125,7,7,CGAGAATGCCCTAATCTGAA,0,1845031
hyuA_predicted,0.125,7,7,CGACTCAGTTCTCGAAGACT,0,1835607
hyuA_predicted,0.125,7,7,CGAATATGCATGGGTCGGTG,0,1869080
hyuA_predicted,0.125,7,7,CCTTAACCTGTGAAAGGCTC,0,1860663
hyuA_predicted,0.125,7,7,CCTGGGCTAACTCACCACTC,0,1861020
hyuA_predicted,0.125,7,7,CCTGCGATGGGCCACGTATG,0,1866526
hyuA_predicted,0.125,7,7,CCTGAATTCCTCGCGTAGCA,0,1856119
hyuA_predicted,0.125,7,7,CCTCGGGTGATCGTGTGTTC,0,1873528
hyuA_predicted,0.125,7,7,CCTAGTCGTCTGAACTCTCT,0,1863611
hyuA_predicted,0.125,7,7,CCGTTTGCCTATGACTTACA,0,1831926
hyuA_predicted,0.125,7,7,CCGTTATGAAAGACTACAGG,0,1829129
hyuA_predicted,0.125,7,7,CCGTAGCTACCTTAACTTGA,0,1830551
hyuA_predicted,0.125,7,7,CCGTACGGGACAATTTCGAC,0,1877182
hyuA_predicted,0.125,7,7,CCGTACGCACTCCCGACGCG,0,1836338
hyuA_predicted,0.125,7,7,CCGGTGCACGGGTGTTACAG,0,1836239
hyuA_predicted,0.125,7,7,CCGGCTATTTCAGATTCCGT,0,1866877
hyuA_predicted,0.125,7,7,CCGCTAGGCATGTAGCACTT,0,1860227
hyuA_predicted,0.125,7,7,CCGCGTGGCCTACTTTGCAA,0,1830426
hyuA_predicted,0.125,7,7,CCGCCATTTAGAAGTTTCCA,0,1857668
hyuA_predicted,0.125,7,7,CCCTCTTCTTCGCCTTAAGA,0,1851987
hyuA_predicted,0.125,7,7,CCCGGGGATGGCTTCTGCAG,0,1839273
hyuA_predicted,0.125,7,7,CCCCTGAATTAAACATCAGG,0,1864199
hyuA_predicted,0.125,7,7,CCCCCAGCCATTCAAGCTTC,0,1875624
hyuA_predicted,0.125,7,7,CCCCATGACACATTGACTGA,0,1871416
hyuA_predicted,0.125,7,7,CCCCAAGACACCCTGCGCCA,0,1846301
hyuA_predicted,0.125,7,7,CCCATGGCCTCATACAAGCT,0,1863536
hyuA_predicted,0.125,7,7,CCATCAGATGTGGTTGTTAT,0,1877525
hyuA_predicted,0.125,7,7,CCATATAGGGCTGTGTATAT,0,1859122
hyuA_predicted,0.125,7,7,CCATAACTGTGCACCAGAAT,0,1841013
hyuA_predicted,0.125,7,7,CCAGTCCGTCTGCTCAATCT,0,1845331
hyuA_predicted,0.125,7,7,CCACTTCTAGCTCGGTCTGA,0,1868497
hyuA_predicted,0.125,7,7,CCACTCGCGCTGTCAGTAGA,0,1839194
hyuA_predicted,0.125,7,7,CCACTCCGTTTAATACTTAA,0,1863687
hyuA_predicted,0.125,7,7,CCACGTTACGGCTGATTTAT,0,1856687
hyuA_predicted,0.125,7,7,CCAAAGTGAGTTCATGCGGC,0,1852954
hyuA_predicted,0.125,7,7,CCAAACGCGTGGTGTATCAT,0,1849208
hyuA_predicted,0.125,7,7,CATTGGGGGAGCTCTCAAGA,0,1833377
hyuA_predicted,0.125,7,7,CATGTTCCAGGAAGTATAAT,0,1845230
hyuA_predicted,0.125,7,7,CATGTCTAGGGGATGGCTCT,0,1845723
hyuA_predicted,0.125,7,7,CATGCGCGACGGGAGACGTC,0,1850874
hyuA_predicted,0.125,7,7,CATGCATTGGTAGGTGTGAT,0,1838894
hyuA_predicted,0.125,7,7,CATATACTTTCGAACTGAAA,0,1851696
hyuA_predicted,0.125,7,7,CATAGATCCACTAGGAGGCT,0,1851514
hyuA_predicted,0.125,7,7,CAGGTACTTTTTCCCTGCAT,0,1858553
hyuA_predicted,0.125,7,7,CAGGGGAACGCACTATTGCT,0,1849459
hyuA_predicted,0.125,7,7,CAGCTTGACGCCTGGCCGTT,0,1849575
hyuA_predicted,0.125,7,7,CAGATTTCCCGCGTGTGTCG,0,1861681
hyuA_predicted,0.125,7,7,CACGTAGGGACTGGGTCGGG,0,1838297
hyuA_predicted,0.125,7,7,CACGGTGTCTAAGCTGGATC,0,1838867
hyuA_predicted,0.125,7,7,CACGACATGAAAGGATGCCA,0,1843323
hyuA_predicted,0.125,7,7,CACCGGGGATCAGTCGCGGA,0,1843212
hyuA_predicted,0.125,7,7,CACCCCTCTTAGCAGCGGTA,0,1838150
hyuA_predicted,0.125,7,7,CACATGGACCCCATGGAGTG,0,1864737
hyuA_predicted,0.125,7,7,CACAAGGGATTAGCACGTAA,0,1865857
hyuA_predicted,0.125,7,7,CAATATGGCCCGGTACGAGG,0,1854354
hyuA_predicted,0.125,7,7,CAAGCCTCTTCCGGAAAACT,0,1850354
hyuA_predicted,0.125,7,7,CAAGCCAAAATGACTACAGA,0,1876032
hyuA_predicted,0.125,7,7,CAAGAACGCACCAACGGCAT,0,1858650
hyuA_predicted,0.125,7,7,CAAATCGCCGGCCCATCAAT,0,1851370
hyuA_predicted,0.125,7,7,CAAACTCAGGTACCTGTCCG,0,1870220
hyuA_predicted,0.125,7,7,CAAAACTTCTGGCCAGTGCG,0,1870591
hyuA_predicted,0.125,7,7,ATTTGCAGTTCGTAGTCGCT,0,1866595
hyuA_predicted,0.125,7,7,ATTGTGGCTTCCCACGCTGG,0,1850351
hyuA_predicted,0.125,7,7,ATTATCTTCTAGACTCCGAT,0,1867887
hyuA_predicted,0.125,7,7,ATTAGCGAATCCCGTTTCTA,0,1853527
hyuA_predicted,0.125,7,7,ATGTGGTTCTCAATTGGCAT,0,1857459
hyuA_predicted,0.125,7,7,ATGTACGGGTCTGTTTGGCA,0,1829424
hyuA_predicted,0.125,7,7,ATGGCGACGTGGGAAACTCT,0,1842457
hyuA_predicted,0.125,7,7,ATGGCACGTAGGGTTCAAAT,0,1835331
hyuA_predicted,0.125,7,7,ATGCAGAGCCACAATAAGGG,0,1831726
hyuA_predicted,0.125,7,7,ATCTGCACTCGAGGGATATA,0,1852919
hyuA_predicted,0.125,7,7,ATCCATCAACATAATCAGGT,0,1874332
hyuA_predicted,0.125,7,7,ATCATCGGGATTAATTTAAG,0,1871300
hyuA_predicted,0.125,7,7,ATCACTGTCAATGAGGTATC,0,1845123
hyuA_predicted,0.125,7,7,ATATCGTTGTTTAGGATAAG,0,1846913
hyuA_predicted,0.125,7,7,ATATCACTGCAAACGTTCTT,0,1875115
hyuA_predicted,0.125,7,7,ATATCACGCGCAAGTAACGA,0,1834634
hyuA_predicted,0.125,7,7,ATAATTAATCGCAATTAGAG,0,1875883
hyuA_predicted,0.125,7,7,ATAAGGCCAACTGCCCTAGT,0,1868300
hyuA_predicted,0.125,7,7,ATAAACCTTGGACGAGGTCT,0,1848473
hyuA_predicted,0.125,7,7,AGTTTTCCCAGCGTCATAGT,0,1857839
hyuA_predicted,0.125,7,7,AGTTCTCGAAGACTCAGTTG,0,1846597
hyuA_predicted,0.125,7,7,AGTTACCCCCTGCGTGGTGG,0,1868938
hyuA_predicted,0.125,7,7,AGTGCAGTTTGGACACTCTG,0,1828939
hyuA_predicted,0.125,7,7,AGTGATTATGGTAGTACATG,0,1858577
hyuA_predicted,0.125,7,7,AGTCTTTATTTATTCGGGGT,0,1854189
hyuA_predicted,0.125,7,7,AGTCTGATATGGGTCTGCAA,0,1871400
hyuA_predicted,0.125,7,7,AGTCGCACATTGTATACATG,0,1829736
hyuA_predicted,0.125,7,7,AGTCAGGTCACATCGACTCG,0,1870487
hyuA_predicted,0.125,7,7,AGTAGCTTTGATGCTGCATC,0,1842112
hyuA_predicted,0.125,7,7,AGGTGGTGCCAGATGGGATT,0,1832370
hyuA_predicted,0.125,7,7,AGGTCTGAGGGCCTGGCCTT,0,1874793
hyuA_predicted,0.125,7,7,AGGGATCCAGTCGCCTCCAC,0,1859369
hyuA_predicted,0.125,7,7,AGGCGCATTCAATTGGGGCG,0,1864068
hyuA_predicted,0.125,7,7,AGGATCAGCTTGATAGGTCA,0,1872400
hyuA_predicted,0.125,7,7,AGGACCCCTCAGCTGTGTCT,0,1858104
hyuA_predicted,0.125,7,7,AGCTCGGCCAGCGCAGTTTT,0,1829583
hyuA_predicted,0.125,7,7,AGCCTGGACGGGTACGAGGA,0,1836846
hyuA_predicted,0.125,7,7,AGCATTTAGCTCAGAGACTG,0,1872280
hyuA_predicted,0.125,7,7,AGCATTGGCGATAGTCGGAC,0,1831162
hyuA_predicted,0.125,7,7,AGCAGCACGTAGGACATTGA,0,1846788
hyuA_predicted,0.125,7,7,AGATTCTACGGACGGGTTCG,0,1834328
hyuA_predicted,0.125,7,7,AGAGTGACCGGGTAGCTTCA,0,1842032
hyuA_predicted,0.125,7,7,AGAGCTGGCTTAGCAGACTA,0,1847301
hyuA_predicted,0.125,7,7,AGAGCCTAGTATTCGCACAC,0,1835597
hyuA_predicted,0.125,7,7,AGAGATTTTTCTTCTAATTT,0,1836118
hyuA_predicted,0.125,7,7,AGACCTTTGAGATCATCTCG,0,1847718
hyuA_predicted,0.125,7,7,AGAATGCAGGGGACCGATGA,0,1838757
hyuA_predicted,0.125,7,7,AGAACATGTGTCGGAGAGCT,0,1853256
hyuA_predicted,0.125,7,7,AGAAAGGTTAGTGTGTGATG,0,1873478
hyuA_predicted,0.125,7,7,AGAAAGGCTTGTCTAAACGT,0,1831745
hyuA_predicted,0.125,7,7,ACTTTGTTTCCGGTCAACGT,0,1859486
hyuA_predicted,0.125,7,7,ACTGTCAGTCACAATCGGAG,0,1834193
hyuA_predicted,0.125,7,7,ACTCTAAACCACCAGGGCGT,0,1869436
hyuA_predicted,0.125,7,7,ACTAAACAGGGGAACCGATC,0,1841394
hyuA_predicted,0.125,7,7,ACGTAGTCGCCTACTGATTG,0,1830728
hyuA_predicted,0.125,7,7,ACGGTTTGGCTGGAGTACAA,0,1835698
hyuA_predicted,0.125,7,7,ACGGGTGCGCAGAGCCTTGA,0,1874568
hyuA_predicted,0.125,7,7,ACGGGCCATTTGAGAACTCG,0,1860257
hyuA_predicted,0.125,7,7,ACGCGTCCAGCAGAGTGAAT,0,1858294
hyuA_predicted,0.125,7,7,ACGAGTGTGCAATAGTTCTC,0,1874269
hyuA_predicted,0.125,7,7,ACGAACAGGTGGAATGGACA,0,1871602
hyuA_predicted,0.125,7,7,ACCTTAGGGCTCTAGCCTTG,0,1844679
hyuA_predicted,0.125,7,7,ACCTATGGCCTCCCACATGA,0,1851081
hyuA_predicted,0.125,7,7,ACCTAATCGTTAGGATATCT,0,1873727
hyuA_predicted,0.125,7,7,ACCCCATTGGAGTTAAATCC,0,1847364
hyuA_predicted,0.125,7,7,ACATGCCGGGTGTTGGAGAT,0,1843905
hyuA_predicted,0.125,7,7,ACAGGCAGAGATATGGCGAG,0,1843151
hyuA_predicted,0.125,7,7,ACAGGAGGTACAAACTAATG,0,1838315
hyuA_predicted,0.125,7,7,ACACGACGGCAGATTCGACA,0,1856289
hyuA_predicted,0.125,7,7,ACACCGCCCTCGAAACATAC,0,1849550
hyuA_predicted,0.125,7,7,AATTGTACTATTCTCTCATG,0,1840030
hyuA_predicted,0.125,7,7,AATGTCATTCGTGAAGAGCC,0,1863847
hyuA_predicted,0.125,7,7,AATGGGGCGAGAGCTAAGTG,0,1846572
hyuA_predicted,0.125,7,7,AATGCTTTGAACCGACGGAC,0,1856871
hyuA_predicted,0.125,7,7,AATGAAGGTCCTGGGTGGAA,0,1853850
hyuA_predicted,0.125,7,7,AATAGATTGACATTATAGTC,0,1862782
hyuA_predicted,0.125,7,7,AATAATTCTGGGCGCGTGGA,0,1842198
hyuA_predicted,0.125,7,7,AATAAGGTCAAACGGCTGCG,0,1875194
hyuA_predicted,0.125,7,7,AATAACTGTCCGCCTCCTCA,0,1833970
hyuA_predicted,0.125,7,7,AAGTGACCTCGAATACATGA,0,1862644
hyuA_predicted,0.125,7,7,AAGTAATCTACTCGGTCGCT,0,1848355
hyuA_predicted,0.125,7,7,AAGGTCTTGAGCAGGACCGA,0,1845455
hyuA_predicted,0.125,7,7,AAGGTACTACTGAAAAAGTC,0,1864262
hyuA_predicted,0.125,7,7,AAGGATCGGCGACGGGTCCC,0,1870960
hyuA_predicted,0.125,7,7,AAGATGATCTGTAAGCTTAT,0,1834952
hyuA_predicted,0.125,7,7,AAGATATGTGGGTTTCGTGG,0,1834426
hyuA_predicted,0.125,7,7,AAGAGTTCGGGCGAGGAACT,0,1868668
hyuA_predicted,0.125,7,7,AACTTTGCTGATGGCAGACC,0,1865980
hyuA_predicted,0.125,7,7,AACTAAACTGATACCACGCG,0,1857104
hyuA_predicted,0.125,7,7,AACGTAGGTAAATTTTAAAG,0,1830207
hyuA_predicted,0.125,7,7,AACCTGCGGCGGAAGAGCTG,0,1854177
hyuA_predicted,0.125,7,7,AACCGGGAATTCTTCCCCAA,0,1847633
hyuA_predicted,0.125,7,7,AACAAAACGGGCCTGGACCA,0,1831468
hyuA_predicted,0.125,7,7,AAACTGGACGGGCGTAGTAA,0,1856610
hyuA_predicted,0.125,7,7,AAACAGGCAGCTTCGTCCAC,0,1832429
hyuA_predicted,0.125,7,7,AAACAGAATTGAATAATGAC,0,1860514
hyuA_predicted,0.125,7,7,AAAATCTAGTGATGCGAATG,0,1865826
hyuA_predicted,0.14285714285714285,6,6,TTTTTCAGTGCGAACGGCAA,0,1849623
hyuA_predicted,0.14285714285714285,6,6,TTTTTATAACCGAGCCGCAT,0,1869027
hyuA_predicted,0.14285714285714285,6,6,TTTTCCTCGGACTTCATTTA,0,1857103
hyuA_predicted,0.14285714285714285,6,6,TTTTAAGTTTCTAACCCAAA,0,1865949
hyuA_predicted,0.14285714285714285,6,6,TTTGTGAATGGCTACGTGGT,0,1873826
hyuA_predicted,0.14285714285714285,6,6,TTTGTCAGGTATCCGTCCAT,0,1841691
hyuA_predicted,0.14285714285714285,6,6,TTTGACAAAAGGTTAGGCTC,0,1830451
hyuA_predicted,0.14285714285714285,6,6,TTTCCAGCTTGGATGGAGAT,0,1872745
hyuA_predicted,0.14285714285714285,6,6,TTTCAGGTCAAAGAGGGAGG,0,1863266
hyuA_predicted,0.14285714285714285,6,6,TTTATTTCAAAAGCATAACT,0,1844310
hyuA_predicted,0.14285714285714285,6,6,TTTAGACTCGCTTGTACCTT,0,1846241
hyuA_predicted,0.14285714285714285,6,6,TTTACCTGTGTAAGCCCTGT,0,1864539
hyuA_predicted,0.14285714285714285,6,6,TTTAATAACGGTCTGTCTTA,0,1855723
hyuA_predicted,0.14285714285714285,6,6,TTGTAATTGCATGACGTGGA,0,1868983
hyuA_predicted,0.14285714285714285,6,6,TTGGGGTGCACAATGAAGGA,0,1860730
hyuA_predicted,0.14285714285714285,6,6,TTGGCTAGCACACTACGTTT,0,1844807
hyuA_predicted,0.14285714285714285,6,6,TTGCCGCTGTAATATTCATG,0,1870780
hyuA_predicted,0.14285714285714285,6,6,TTGCCCTCGCCTCGCGCGAA,0,1837277
hyuA_predicted,0.14285714285714285,6,6,TTGCCCGTCGCAATTCCTAG,0,1837388
hyuA_predicted,0.14285714285714285,6,6,TTGATATATACGCGGGAGGT,0,1855789
hyuA_predicted,0.14285714285714285,6,6,TTCTATAATTACCTGTGCTG,0,1843122
hyuA_predicted,0.14285714285714285,6,6,TTCGATTAGCCCATTTTGGG,0,1831811
hyuA_predicted,0.14285714285714285,6,6,TTCCTGCTTTGATCTGGCAC,0,1873376
hyuA_predicted,0.14285714285714285,6,6,TTCCGTTTGGTCGCGTCCAG,0,1862037
hyuA_predicted,0.14285714285714285,6,6,TTCCAAGTGGAACCTATGTT,0,1842177
hyuA_predicted,0.14285714285714285,6,6,TTATGATCTCTGAAGGTAGT,0,1847860
hyuA_predicted,0.14285714285714285,6,6,TTATCTTAGACAGGAGGAGT,0,1867779
hyuA_predicted,0.14285714285714285,6,6,TTATCCCTGATTTCCGTGCG,0,1848743
hyuA_predicted,0.14285714285714285,6,6,TTAGTCACAGCAGGTAAATG,0,1837312
hyuA_predicted,0.14285714285714285,6,6,TTACGAAATGTCTTTAAGAT,0,1861659
hyuA_predicted,0.14285714285714285,6,6,TTAATAGGCATTTCAGATGG,0,1833753
hyuA_predicted,0.14285714285714285,6,6,TGTTGGAGCGACTACTGCTT,0,1829815
hyuA_predicted,0.14285714285714285,6,6,TGTTCTGGTTCCCAATGTTT,0,1874092
hyuA_predicted,0.14285714285714285,6,6,TGTTCTCCATCGTCGGGTCG,0,1875274
hyuA_predicted,0.14285714285714285,6,6,TGTGTTTGTCCACATTTTAA,0,1865171
hyuA_predicted,0.14285714285714285,6,6,TGTGTATTCAGCGAACACGA,0,1829651
hyuA_predicted,0.14285714285714285,6,6,TGTGGCGGAAGCTGACTCCC,0,1832800
hyuA_predicted,0.14285714285714285,6,6,TGTGGCAGAGAATTGTAATA,0,1858767
hyuA_predicted,0.14285714285714285,6,6,TGTGGATCCTGCCTTACACT,0,1876307
hyuA_predicted,0.14285714285714285,6,6,TGTCGCTGTGCACTAATCTA,0,1868752
hyuA_predicted,0.14285714285714285,6,6,TGTCAAGCTCATTCAATGTC,0,1845231
hyuA_predicted,0.14285714285714285,6,6,TGTAGCCTCACAATATGACC,0,1830477
hyuA_predicted,0.14285714285714285,6,6,TGGGCTGGGTTGTACGAGAT,0,1845199
hyuA_predicted,0.14285714285714285,6,6,TGGGCATGATCATATGGGTT,0,1847083
hyuA_predicted,0.14285714285714285,6,6,TGGGAATCCTGGACCTGTTC,0,1846064
hyuA_predicted,0.14285714285714285,6,6,TGGCTTACAATCTGTGCATA,0,1869606
hyuA_predicted,0.14285714285714285,6,6,TGGCTAGGTTTAGGAAGGGA,0,1834432
hyuA_predicted,0.14285714285714285,6,6,TGGCCAAGTCGGAAGAACTA,0,1847653
hyuA_predicted,0.14285714285714285,6,6,TGGCAGAAAAGGAAGTGACG,0,1863538
hyuA_predicted,0.14285714285714285,6,6,TGCGTCCTCCAGAGCCGGCG,0,1869757
hyuA_predicted,0.14285714285714285,6,6,TGCGCGTAGGGAGGTCTAAA,0,1856818
hyuA_predicted,0.14285714285714285,6,6,TGCGCGGTAACGCGGAGGAC,0,1871458
hyuA_predicted,0.14285714285714285,6,6,TGCGCCTACGCTTTTAACGG,0,1874581
hyuA_predicted,0.14285714285714285,6,6,TGCGAGTAAAACGGATCTTG,0,1849901
hyuA_predicted,0.14285714285714285,6,6,TGCAAGTTTGTAACCGGTAC,0,1854447
hyuA_predicted,0.14285714285714285,6,6,TGCAACGTGGCGTAGCCCAT,0,1843599
hyuA_predicted,0.14285714285714285,6,6,TGAGAGCGACAACAGGCTGG,0,1837924
hyuA_predicted,0.14285714285714285,6,6,TGACGGAATAGGGCACCTCT,0,1865110
hyuA_predicted,0.14285714285714285,6,6,TGAAGCCAGTCCCGGGGATG,0,1832793
hyuA_predicted,0.14285714285714285,6,6,TGAAAGAACGCTGGCAACCC,0,1873911
hyuA_predicted,0.14285714285714285,6,6,TCTTCTGGGGTGAGGATACT,0,1833233
hyuA_predicted,0.14285714285714285,6,6,TCTTCGTATGGAGGGTACAT,0,1853756
hyuA_predicted,0.14285714285714285,6,6,TCTGCATTGGCAGTGAATCC,0,1840569
hyuA_predicted,0.14285714285714285,6,6,TCTCTACGTCAAGCACGAAT,0,1876378
hyuA_predicted,0.14285714285714285,6,6,TCTAGAGTGGTTCTGTAGGC,0,1839168
hyuA_predicted,0.14285714285714285,6,6,TCTAAGTGATACAGGACACC,0,1856646
hyuA_predicted,0.14285714285714285,6,6,TCTAAGCCGAGTAGACAGTC,0,1875626
hyuA_predicted,0.14285714285714285,6,6,TCGTTGTAGACAGTTACAGA,0,1859440
hyuA_predicted,0.14285714285714285,6,6,TCGTGTCCCGGGGCAGCTCT,0,1836269
hyuA_predicted,0.14285714285714285,6,6,TCGTGACGGCAGATTTGACT,0,1837070
hyuA_predicted,0.14285714285714285,6,6,TCGGGGGGCCACACGCGAAA,0,1841657
hyuA_predicted,0.14285714285714285,6,6,TCGGGGACCCTCACCTTATA,0,1831427
hyuA_predicted,0.14285714285714285,6,6,TCGCGGGAGCAGTCGTTTGT,0,1852975
hyuA_predicted,0.14285714285714285,6,6,TCGCGGCGCCTTTTGGCTCC,0,1848509
hyuA_predicted,0.14285714285714285,6,6,TCGCGCACTATTATCAGCGT,0,1839338
hyuA_predicted,0.14285714285714285,6,6,TCGCGAGACGAAGAAGGCGA,0,1864623
hyuA_predicted,0.14285714285714285,6,6,TCGCCTAGTGGCAGTCGCTC,0,1865964
hyuA_predicted,0.14285714285714285,6,6,TCGCATTTAATTTACTGTCT,0,1830091
hyuA_predicted,0.14285714285714285,6,6,TCGATTTTTCGGGAATTCTC,0,1836945
hyuA_predicted,0.14285714285714285,6,6,TCGATGTGCGACTATGAACA,0,1838946
hyuA_predicted,0.14285714285714285,6,6,TCCTCATGTGTTTAGGTGTG,0,1855905
hyuA_predicted,0.14285714285714285,6,6,TCCTCAGTCAAGGCCCAGAG,0,1869308
hyuA_predicted,0.14285714285714285,6,6,TCCTAAAGGTATCCAGTCTT,0,1835266
hyuA_predicted,0.14285714285714285,6,6,TCCGATGGGCGATTTAAAAC,0,1855412
hyuA_predicted,0.14285714285714285,6,6,TCCGAGCTGTTCGTATGCCA,0,1858356
hyuA_predicted,0.14285714285714285,6,6,TCCGAGATTTGAAGCTGCAG,0,1838296
hyuA_predicted,0.14285714285714285,6,6,TCCAGTACCTAGTCGTTTAG,0,1867156
hyuA_predicted,0.14285714285714285,6,6,TCCAGGACTACTGCGTATCT,0,1850191
hyuA_predicted,0.14285714285714285,6,6,TCATTACACCACTGTTACCA,0,1872706
hyuA_predicted,0.14285714285714285,6,6,TCATTAAGATTGTCCACATG,0,1832505
hyuA_predicted,0.14285714285714285,6,6,TCATGAAGCCTGCCCGCCAT,0,1843520
hyuA_predicted,0.14285714285714285,6,6,TCATCTCTTTAATGGTGATC,0,1858041
hyuA_predicted,0.14285714285714285,6,6,TCATCCCGAGTACCTGACCA,0,1864841
hyuA_predicted,0.14285714285714285,6,6,TCAGTTATCTTTATACAAAA,0,1835974
hyuA_predicted,0.14285714285714285,6,6,TCAGAGCGCCGGAACAAACT,0,1840918
hyuA_predicted,0.14285714285714285,6,6,TCACATTTTGCATGTGATCG,0,1861728
hyuA_predicted,0.14285714285714285,6,6,TCACATGCGCACCTAACGTC,0,1852953
hyuA_predicted,0.14285714285714285,6,6,TCAATAAGTTAGCGGAGATT,0,1864018
hyuA_predicted,0.14285714285714285,6,6,TCAAGGAGCGCCAAATCGAC,0,1830097
hyuA_predicted,0.14285714285714285,6,6,TCAAGGAAGCCATGGACATC,0,1869347
hyuA_predicted,0.14285714285714285,6,6,TATGCATTATCGGGGTTATA,0,1828909
hyuA_predicted,0.14285714285714285,6,6,TATCCTCCTACTAGCAGACT,0,1871641
hyuA_predicted,0.14285714285714285,6,6,TATCCCGCCACACATTGTAC,0,1830723
hyuA_predicted,0.14285714285714285,6,6,TATATAGGCGCGGCCGGCGG,0,1858504
hyuA_predicted,0.14285714285714285,6,6,TATATAGCGTCTACGCATTG,0,1870277
hyuA_predicted,0.14285714285714285,6,6,TATACGAGATAGTATACATT,0,1844762
hyuA_predicted,0.14285714285714285,6,6,TAGTCCTAGATCGTCAAAGA,0,1873312
hyuA_predicted,0.14285714285714285,6,6,TAGGTGTCCATCTACCTTAA,0,1867318
hyuA_predicted,0.14285714285714285,6,6,TAGGGCAATGACAGCATGTA,0,1874870
hyuA_predicted,0.14285714285714285,6,6,TAGGAGCGGATCCACTGGGT,0,1833247
hyuA_predicted,0.14285714285714285,6,6,TAGCGCGCATTCTCGAGTGG,0,1844347
hyuA_predicted,0.14285714285714285,6,6,TAGATCGCTCTATATCAGGT,0,1863277
hyuA_predicted,0.14285714285714285,6,6,TAGATATACGTTGCTGCGTA,0,1833206
hyuA_predicted,0.14285714285714285,6,6,TACTCCCTTGGTACCGAGAT,0,1874022
hyuA_predicted,0.14285714285714285,6,6,TACGCATTACGAGTTGACCG,0,1858808
hyuA_predicted,0.14285714285714285,6,6,TACGCACCATTCCGGGCGAT,0,1869326
hyuA_predicted,0.14285714285714285,6,6,TACGATGTCATGAGTCATAT,0,1842494
hyuA_predicted,0.14285714285714285,6,6,TACCCGGTTTGGTAGAAGGG,0,1876222
hyuA_predicted,0.14285714285714285,6,6,TACCCCCCGGGTAAATCTTA,0,1840270
hyuA_predicted,0.14285714285714285,6,6,TACATGCAAGGAGCCATGTT,0,1838814
hyuA_predicted,0.14285714285714285,6,6,TACAGTCGCTGATGACAGAG,0,1858345
hyuA_predicted,0.14285714285714285,6,6,TACACGCTAGGGCGGCCGAA,0,1837276
hyuA_predicted,0.14285714285714285,6,6,TAATCTTCTATGTGGAACGT,0,1869299
hyuA_predicted,0.14285714285714285,6,6,TAATATGGCCAGACTCGTAT,0,1835748
hyuA_predicted,0.14285714285714285,6,6,TAATACGACTCATGACCATG,0,1872393
hyuA_predicted,0.14285714285714285,6,6,TAAGGTTATTGTCGGAGGTA,0,1839699
hyuA_predicted,0.14285714285714285,6,6,TAAATACACCGGGGCCATGA,0,1842508
hyuA_predicted,0.14285714285714285,6,6,TAAAGGCAGATGAGATACGC,0,1830766
hyuA_predicted,0.14285714285714285,6,6,GTTGGCGACCCCGTCCGAAC,0,1872459
hyuA_predicted,0.14285714285714285,6,6,GTTAGGTCCTGCAGAAAAGC,0,1830290
hyuA_predicted,0.14285714285714285,6,6,GTGTTGAGATACTTGGTGTG,0,1851374
hyuA_predicted,0.14285714285714285,6,6,GTGTCCTCTACTCCATTAAG,0,1857119
hyuA_predicted,0.14285714285714285,6,6,GTGTATCGGATTGGTAGGTC,0,1850041
hyuA_predicted,0.14285714285714285,6,6,GTGTAGACATGCATCCCGTT,0,1855074
hyuA_predicted,0.14285714285714285,6,6,GTGGGCACTGTGCCTCGATG,0,1849781
hyuA_predicted,0.14285714285714285,6,6,GTGGCCCCCCGAGCAGAAAC,0,1839350
hyuA_predicted,0.14285714285714285,6,6,GTGCTGCATGACCATCGATC,0,1839849
hyuA_predicted,0.14285714285714285,6,6,GTGCGATGGATCAGGTTGAA,0,1866951
hyuA_predicted,0.14285714285714285,6,6,GTGATTTGTCTTCAATACAT,0,1861340
hyuA_predicted,0.14285714285714285,6,6,GTCTGCGACATTAGCGAATT,0,1843841
hyuA_predicted,0.14285714285714285,6,6,GTCTGAATAGTCGAGTTCGC,0,1869530
hyuA_predicted,0.14285714285714285,6,6,GTCTAGCGGTGGATCCGTCC,0,1847765
hyuA_predicted,0.14285714285714285,6,6,GTCGTAATTGCGATGGTAAA,0,1839784
hyuA_predicted,0.14285714285714285,6,6,GTCGGCATCGAAGGGAGGCC,0,1851647
hyuA_predicted,0.14285714285714285,6,6,GTCGGATAGCCGCAACAAGA,0,1857023
hyuA_predicted,0.14285714285714285,6,6,GTCGGACATGGGACGGCGGA,0,1867064
hyuA_predicted,0.14285714285714285,6,6,GTCCTTATTGGGCTTGAGCT,0,1851186
hyuA_predicted,0.14285714285714285,6,6,GTCCTGGAACGTTTCAGAAA,0,1867706
hyuA_predicted,0.14285714285714285,6,6,GTCCGGGGCGCGTACTACGA,0,1852255
hyuA_predicted,0.14285714285714285,6,6,GTCCGGAAGTCCCATGCTGA,0,1858156
hyuA_predicted,0.14285714285714285,6,6,GTCCATACAAATTTTTTGCA,0,1870514
hyuA_predicted,0.14285714285714285,6,6,GTCATGTTTCCACAAGATCG,0,1839502
hyuA_predicted,0.14285714285714285,6,6,GTCAGCTTAAGATTTCGCTC,0,1868469
hyuA_predicted,0.14285714285714285,6,6,GTATCAATCATGCGTCTGTC,0,1871402
hyuA_predicted,0.14285714285714285,6,6,GTAGTACACGATCCAGGCAA,0,1848512
hyuA_predicted,0.14285714285714285,6,6,GTACTACGTTGTTGCAGAGG,0,1853347
hyuA_predicted,0.14285714285714285,6,6,GTAAGTTACCGCAAAGAGTG,0,1848119
hyuA_predicted,0.14285714285714285,6,6,GTAAGCCAACAGGTACCTGT,0,1842995
hyuA_predicted,0.14285714285714285,6,6,GTAACCTTTATCGCAACGAA,0,1873280
hyuA_predicted,0.14285714285714285,6,6,GTAAATGAGGGTGCGTGAGA,0,1843170
hyuA_predicted,0.14285714285714285,6,6,GGTTGGGCCGCGAAGGATAA,0,1856210
hyuA_predicted,0.14285714285714285,6,6,GGTTGACATGCGCGCCGCAT,0,1840996
hyuA_predicted,0.14285714285714285,6,6,GGTGTCACCCCGTGCCCCGC,0,1862108
hyuA_predicted,0.14285714285714285,6,6,GGTGGCTTTGTTCGGTATAA,0,1834673
hyuA_predicted,0.14285714285714285,6,6,GGTCTGGGTCCTCCAACATA,0,1847769
hyuA_predicted,0.14285714285714285,6,6,GGTCTGCGGCAAGAGGCCCT,0,1834408
hyuA_predicted,0.14285714285714285,6,6,GGTCGGTGATGACCGCGTAA,0,1842058
hyuA_predicted,0.14285714285714285,6,6,GGTCGGGGCCGCAGGAGTTA,0,1832740
hyuA_predicted,0.14285714285714285,6,6,GGTCCTGAGGGAGGGTGTCA,0,1863968
hyuA_predicted,0.14285714285714285,6,6,GGTCCACGGCCAGTTGTAGG,0,1838160
hyuA_predicted,0.14285714285714285,6,6,GGTAGGTAGCTTTACTGCTG,0,1851891
hyuA_predicted,0.14285714285714285,6,6,GGTACTGGGTTTTGGTTGAA,0,1848467
hyuA_predicted,0.14285714285714285,6,6,GGTACCCCACACCTCGACTG,0,1858447
hyuA_predicted,0.14285714285714285,6,6,GGGTTAATCTGGTGGAACCA,0,1841408
hyuA_predicted,0.14285714285714285,6,6,GGGTGACATTATCTGTATGG,0,1851474
hyuA_predicted,0.14285714285714285,6,6,GGGTCGTTTTCACTATAAGT,0,1873369
hyuA_predicted,0.14285714285714285,6,6,GGGTACCACCTCGCCTAAGG,0,1840865
hyuA_predicted,0.14285714285714285,6,6,GGGGGAATTTCTGATCGATT,0,1861168
hyuA_predicted,0.14285714285714285,6,6,GGGGCCTAAAAGAAATTGGA,0,1864639
hyuA_predicted,0.14285714285714285,6,6,GGGCGTTTACGTCAGTGCTT,0,1871302
hyuA_predicted,0.14285714285714285,6,6,GGGCCACCCCACCGCGACAT,0,1868036
hyuA_predicted,0.14285714285714285,6,6,GGGCATTTAATGCATGTGAA,0,1834888
hyuA_predicted,0.14285714285714285,6,6,GGGATTTAAGGTTACATTGC,0,1832968
hyuA_predicted,0.14285714285714285,6,6,GGGAGTTCGTTAGTATAGAG,0,1856290
hyuA_predicted,0.14285714285714285,6,6,GGGAGTATTACCTGTATTCT,0,1834534
hyuA_predicted,0.14285714285714285,6,6,GGGAGATGCGACCTACGAAA,0,1841032
hyuA_predicted,0.14285714285714285,6,6,GGCTCACAGAACTTAGGCAA,0,1835050
hyuA_predicted,0.14285714285714285,6,6,GGCGCTTATCCGGGGGGGAT,0,1846011
hyuA_predicted,0.14285714285714285,6,6,GGCCTGTGATGATTGGGTGC,0,1874253
hyuA_predicted,0.14285714285714285,6,6,GGCCTCGGGGTTCGCACGGG,0,1869720
hyuA_predicted,0.14285714285714285,6,6,GGCAGTGGTAGACACGGGGA,0,1833491
hyuA_predicted,0.14285714285714285,6,6,GGATTTACAGTCAAGATACG,0,1865167
hyuA_predicted,0.14285714285714285,6,6,GGATGAGGTCAAATCAATCC,0,1843797
hyuA_predicted,0.14285714285714285,6,6,GGATACGTCTTTTCGAGGTT,0,1849710
hyuA_predicted,0.14285714285714285,6,6,GGAGTTTGAATTCGCCTCAC,0,1855895
hyuA_predicted,0.14285714285714285,6,6,GGAGACTACGATGTGATCCC,0,1846563
hyuA_predicted,0.14285714285714285,6,6,GGACTCCGACGTTAAACGAG,0,1872153
hyuA_predicted,0.14285714285714285,6,6,GGACAAGGTGGCTTTACTAT,0,1844315
hyuA_predicted,0.14285714285714285,6,6,GGAATGCCTTTGATGAGAGT,0,1847935
hyuA_predicted,0.14285714285714285,6,6,GGAAGGTTGCACTTCAGTAG,0,1871231
hyuA_predicted,0.14285714285714285,6,6,GGAACTTTGTTTCGTGATCC,0,1872529
hyuA_predicted,0.14285714285714285,6,6,GGAACACGAACCCAGAGCCA,0,1859487
hyuA_predicted,0.14285714285714285,6,6,GCTTGGGTTCCTTGGCAAAA,0,1833400
hyuA_predicted,0.14285714285714285,6,6,GCTTGAACAGCACCCGCCAG,0,1868283
hyuA_predicted,0.14285714285714285,6,6,GCTGGGTCTTATTGCGCACG,0,1867422
hyuA_predicted,0.14285714285714285,6,6,GCTGGCAAGGTATGTTCCCG,0,1833701
hyuA_predicted,0.14285714285714285,6,6,GCTCGGCTCTCAGGGAGGTT,0,1857277
hyuA_predicted,0.14285714285714285,6,6,GCGTTGGGCACACATCAGGG,0,1854979
hyuA_predicted,0.14285714285714285,6,6,GCGTGCAGTTGAGCGCTAGA,0,1864282
hyuA_predicted,0.14285714285714285,6,6,GCGTGCACTCCACCAGGTGA,0,1864388
hyuA_predicted,0.14285714285714285,6,6,GCGTATCGCGGCACAAGTCA,0,1873821
hyuA_predicted,0.14285714285714285,6,6,GCGTATATCTCTCAATGCCT,0,1838707
hyuA_predicted,0.14285714285714285,6,6,GCGTAGTTATAGTCTTGTCA,0,1873269
hyuA_predicted,0.14285714285714285,6,6,GCGGTTTTATATCTGGACCA,0,1849990
hyuA_predicted,0.14285714285714285,6,6,GCGGCTTGACACTTGCGCTG,0,1860803
hyuA_predicted,0.14285714285714285,6,6,GCGCTCCTGCTGGACCCGGG,0,1867394
hyuA_predicted,0.14285714285714285,6,6,GCGCCGTCGAGAACGAGGGA,0,1841590
hyuA_predicted,0.14285714285714285,6,6,GCGCATGGGATTGCTCGTTA,0,1833374
hyuA_predicted,0.14285714285714285,6,6,GCGCACTTACACAATTCAGC,0,1842580
hyuA_predicted,0.14285714285714285,6,6,GCGCACCATTGACTTCATTG,0,1831786
hyuA_predicted,0.14285714285714285,6,6,GCGAGTTTGAAGCTTGCTTA,0,1861124
hyuA_predicted,0.14285714285714285,6,6,GCGACCGGAGTGAACCCAAA,0,1843750
hyuA_predicted,0.14285714285714285,6,6,GCCTTACTTCAGGGCCTCCG,0,1857779
hyuA_predicted,0.14285714285714285,6,6,GCCTAGGCATTGAATTCAGG,0,1849193
hyuA_predicted,0.14285714285714285,6,6,GCCGGCGGCAAGTCACGTCA,0,1854162
hyuA_predicted,0.14285714285714285,6,6,GCCGCCACTCACCTCACCGT,0,1876510
hyuA_predicted,0.14285714285714285,6,6,GCCCACAGCCGACTCTGAGC,0,1855800
hyuA_predicted,0.14285714285714285,6,6,GCCATTCTAATCTCACAAAC,0,1856456
hyuA_predicted,0.14285714285714285,6,6,GCCATCGGACTTCTTGAGAG,0,1865953
hyuA_predicted,0.14285714285714285,6,6,GCCAGCAGATTACGTTTTAT,0,1833115
hyuA_predicted,0.14285714285714285,6,6,GCCAATCGAAGGAAGACTCA,0,1834473
hyuA_predicted,0.14285714285714285,6,6,GCATTACCTTTCCAGGTGTA,0,1851603
hyuA_predicted,0.14285714285714285,6,6,GCATACTATGTTAAACTGAA,0,1863425
hyuA_predicted,0.14285714285714285,6,6,GCAGTGGAAAGAACAGACCA,0,1829956
hyuA_predicted,0.14285714285714285,6,6,GCAGGTATAGGCCGTACGCC,0,1842121
hyuA_predicted,0.14285714285714285,6,6,GCAGCTCATTCCGATGTTTT,0,1850411
hyuA_predicted,0.14285714285714285,6,6,GCAGACATGTGCCTTCCCGA,0,1869430
hyuA_predicted,0.14285714285714285,6,6,GCACTGATAGTAAGCGAACG,0,1867511
hyuA_predicted,0.14285714285714285,6,6,GCAAAGGTAATACAAAACGG,0,1852032
hyuA_predicted,0.14285714285714285,6,6,GCAAAGCAGCGCCTCTGGGA,0,1872545
hyuA_predicted,0.14285714285714285,6,6,GATTAATAGCCAGGAGGACA,0,1844141
hyuA_predicted,0.14285714285714285,6,6,GATGTTCTAATCCGTACAAT,0,1873060
hyuA_predicted,0.14285714285714285,6,6,GATGGTTCCACAAAACTCAA,0,1853637
hyuA_predicted,0.14285714285714285,6,6,GATCTGCGCATGTACGCGAA,0,1840670
hyuA_predicted,0.14285714285714285,6,6,GATCTAGATTCCTATAGTGG,0,1863752
hyuA_predicted,0.14285714285714285,6,6,GATCGCGAGGCCGCAAGGCC,0,1849552
hyuA_predicted,0.14285714285714285,6,6,GATCATAGGAATCTGGCAGC,0,1867772
hyuA_predicted,0.14285714285714285,6,6,GATCAGAAGGACAGACCCTA,0,1845943
hyuA_predicted,0.14285714285714285,6,6,GATATGTGATCGGACAGTCT,0,1846522
hyuA_predicted,0.14285714285714285,6,6,GATATACAAACGTATCTTCG,0,1852017
hyuA_predicted,0.14285714285714285,6,6,GATAATGGTAATGCATATAG,0,1834010
hyuA_predicted,0.14285714285714285,6,6,GAGTTTGCAGTTGAGAATAT,0,1856614
hyuA_predicted,0.14285714285714285,6,6,GAGTTCAAGGTCGGATTAAT,0,1849390
hyuA_predicted,0.14285714285714285,6,6,GAGTCATGCCCGACTGCCCT,0,1847322
hyuA_predicted,0.14285714285714285,6,6,GAGTACGCCTCTTCTGAGAC,0,1863645
hyuA_predicted,0.14285714285714285,6,6,GAGGTAAGAATTTCAGACAT,0,1865128
hyuA_predicted,0.14285714285714285,6,6,GAGGACACTCACACGGTTGG,0,1852246
hyuA_predicted,0.14285714285714285,6,6,GAGGAAGGTGGTATGGTGGT,0,1832676
hyuA_predicted,0.14285714285714285,6,6,GAGCTTATTTGGGTCATCAT,0,1836894
hyuA_predicted,0.14285714285714285,6,6,GAGCCGATCCGGTCCGATTA,0,1859146
hyuA_predicted,0.14285714285714285,6,6,GAGCATTCGTCTGCGGAATA,0,1845400
hyuA_predicted,0.14285714285714285,6,6,GAGAGCTTCGCTCATCGTCT,0,1860164
hyuA_predicted,0.14285714285714285,6,6,GAGACATCTGGATAGTGCTA,0,1867247
hyuA_predicted,0.14285714285714285,6,6,GACTTGTAGGAGGACGTTCC,0,1845624
hyuA_predicted,0.14285714285714285,6,6,GACTTGAATTATCGTGAACT,0,1870396
hyuA_predicted,0.14285714285714285,6,6,GACTATGAGCCAAATTTTCT,0,1863862
hyuA_predicted,0.14285714285714285,6,6,GACTACCAATGGCCACGGCT,0,1849893
hyuA_predicted,0.14285714285714285,6,6,GACGTGAGACAGTGCGTATT,0,1833088
hyuA_predicted,0.14285714285714285,6,6,GACGGGGGCATAAACTAAGT,0,1843551
hyuA_predicted,0.14285714285714285,6,6,GACGGCGTTGGCGTAAATTA,0,1868572
hyuA_predicted,0.14285714285714285,6,6,GACGATTCTCTGGCGCTACT,0,1849435
hyuA_predicted,0.14285714285714285,6,6,GACGAGATTAGAAGTAAGAT,0,1846795
hyuA_predicted,0.14285714285714285,6,6,GACCCGTAGTCACACCAAGG,0,1834009
hyuA_predicted,0.14285714285714285,6,6,GACATCTGGATAAAGTCAAG,0,1868119
hyuA_predicted,0.14285714285714285,6,6,GACACCATTGTTTGGGGGTA,0,1854832
hyuA_predicted,0.14285714285714285,6,6,GAATGGATATACACGTTTGG,0,1863000
hyuA_predicted,0.14285714285714285,6,6,GAAGGAATTTAGGGCACGTC,0,1864208
hyuA_predicted,0.14285714285714285,6,6,GAACTAAAACACGAATTTGT,0,1830516
hyuA_predicted,0.14285714285714285,6,6,GAAATTAACTCGAATTAAAC,0,1863372
hyuA_predicted,0.14285714285714285,6,6,GAAAGCTAGCCGGCCCCCCA,0,1855067
hyuA_predicted,0.14285714285714285,6,6,GAAAACGCCTTAAAGCTGTT,0,1834104
hyuA_predicted,0.14285714285714285,6,6,CTTTGTTTCTTACTACTCTG,0,1863362
hyuA_predicted,0.14285714285714285,6,6,CTTTGTAATACATGATGGCC,0,1835111
hyuA_predicted,0.14285714285714285,6,6,CTTTAAGAACGCGCCCGCTG,0,1867150
hyuA_predicted,0.14285714285714285,6,6,CTTGTCCGGCAGACTTGTCT,0,1856094
hyuA_predicted,0.14285714285714285,6,6,CTTGGCTACTTTTCGATTCA,0,1847179
hyuA_predicted,0.14285714285714285,6,6,CTTGACGAAATCAAAATCCA,0,1858925
hyuA_predicted,0.14285714285714285,6,6,CTTGACCGCGCGTGAGGGGT,0,1869164
hyuA_predicted,0.14285714285714285,6,6,CTTCACAAGGTGGATAAGGC,0,1867527
hyuA_predicted,0.14285714285714285,6,6,CTTATTGTTATGCATACCGT,0,1856581
hyuA_predicted,0.14285714285714285,6,6,CTTAGATTAAGCTGATCGAG,0,1850799
hyuA_predicted,0.14285714285714285,6,6,CTTACTGGTTTGCCTCTTGG,0,1845725
hyuA_predicted,0.14285714285714285,6,6,CTGTTACATTTTAATCGAAA,0,1834630
hyuA_predicted,0.14285714285714285,6,6,CTGTGTGTTATATATCAGCT,0,1851253
hyuA_predicted,0.14285714285714285,6,6,CTGTGGGTGGTACACCGACT,0,1862459
hyuA_predicted,0.14285714285714285,6,6,CTGTAGAATTTATCTCGTTC,0,1849404
hyuA_predicted,0.14285714285714285,6,6,CTGTAGAATCCGCTCTAGTC,0,1870708
hyuA_predicted,0.14285714285714285,6,6,CTGTAAAATGTAATAACAGT,0,1859707
hyuA_predicted,0.14285714285714285,6,6,CTGGTTCTTTAATGTCTCCC,0,1843369
hyuA_predicted,0.14285714285714285,6,6,CTGGTGCAAGCTATTTTCGT,0,1828912
hyuA_predicted,0.14285714285714285,6,6,CTGGGTGTTGTCCGTTCACC,0,1851851
hyuA_predicted,0.14285714285714285,6,6,CTGGGATTAGCAAGATTCGT,0,1859472
hyuA_predicted,0.14285714285714285,6,6,CTGGAAGATTTGCTTGTAGT,0,1851519
hyuA_predicted,0.14285714285714285,6,6,CTGCTTGAGGAGGTATTGGT,0,1861303
hyuA_predicted,0.14285714285714285,6,6,CTGCGGTCATTGCAATTGGG,0,1874598
hyuA_predicted,0.14285714285714285,6,6,CTGCGCTTCCCTTCAGCTCC,0,1850723
hyuA_predicted,0.14285714285714285,6,6,CTGAAGGACTATCGACTCAA,0,1852412
hyuA_predicted,0.14285714285714285,6,6,CTGAACGCAAGCAGATTAAG,0,1830123
hyuA_predicted,0.14285714285714285,6,6,CTCTGCTGGCACTTCTGTGT,0,1864921
hyuA_predicted,0.14285714285714285,6,6,CTCGTCTTGATATACGGTTC,0,1871441
hyuA_predicted,0.14285714285714285,6,6,CTCGCCTACTAGGCGCCTTT,0,1871637
hyuA_predicted,0.14285714285714285,6,6,CTCCTCGGAGTGGACGGTGA,0,1877269
hyuA_predicted,0.14285714285714285,6,6,CTCCGGACGGTATAGATCCT,0,1829776
hyuA_predicted,0.14285714285714285,6,6,CTCAGATAACCGAGATCTGT,0,1845286
hyuA_predicted,0.14285714285714285,6,6,CTCACCCCGTCAACGTATCC,0,1846694
hyuA_predicted,0.14285714285714285,6,6,CTATTGCGAGGGCGGCCAGG,0,1836054
hyuA_predicted,0.14285714285714285,6,6,CTATGGAAGTTCAACACTTC,0,1837467
hyuA_predicted,0.14285714285714285,6,6,CTAGTGATATGGGGGAATGT,0,1877117
hyuA_predicted,0.14285714285714285,6,6,CTAGGTTACACGTTCGAAGA,0,1844415
hyuA_predicted,0.14285714285714285,6,6,CTAGGAGTGCAGGCGGCCTG,0,1872881
hyuA_predicted,0.14285714285714285,6,6,CTAGGAGCTTATTCATCGGT,0,1868964
hyuA_predicted,0.14285714285714285,6,6,CTAGCAGCCTGAAAACAGAA,0,1860576
hyuA_predicted,0.14285714285714285,6,6,CTACTCCCCAAACGACGTGA,0,1860090
hyuA_predicted,0.14285714285714285,6,6,CTACCCATAAGCGTGCCATT,0,1834048
hyuA_predicted,0.14285714285714285,6,6,CTACCCACTCTCTATAGAGA,0,1856509
hyuA_predicted,0.14285714285714285,6,6,CTAAAGTTATCACGGGGAAG,0,1834550
hyuA_predicted,0.14285714285714285,6,6,CTAAAGGTGGCCTCGTGCTT,0,1864663
hyuA_predicted,0.14285714285714285,6,6,CGTTTGGGGCGTACGTCAAA,0,1868782
hyuA_predicted,0.14285714285714285,6,6,CGTTAACGTGCTTGGTTCGT,0,1843431
hyuA_predicted,0.14285714285714285,6,6,CGTGTATGATCAAAGAAGTT,0,1872352
hyuA_predicted,0.14285714285714285,6,6,CGTGGTTATGCACAGCGGGA,0,1842526
hyuA_predicted,0.14285714285714285,6,6,CGTGATTTATGCCCTTGTGG,0,1864489
hyuA_predicted,0.14285714285714285,6,6,CGTGACGTTCGTCGTTCGTG,0,1846612
hyuA_predicted,0.14285714285714285,6,6,CGTCGTGGTCCAAAAGCGTT,0,1868180
hyuA_predicted,0.14285714285714285,6,6,CGTCCCGGCGGCGCCAGTGT,0,1847576
hyuA_predicted,0.14285714285714285,6,6,CGTCCAGACCTTCCCATCAT,0,1840671
hyuA_predicted,0.14285714285714285,6,6,CGTATTTTTAAATGTAATCT,0,1838162
hyuA_predicted,0.14285714285714285,6,6,CGTATCTGGAGCTTACCGTG,0,1849216
hyuA_predicted,0.14285714285714285,6,6,CGGTGCTGCAAACATAGGCT,0,1877863
hyuA_predicted,0.14285714285714285,6,6,CGGTGACGACGACAGCAAGA,0,1876369
hyuA_predicted,0.14285714285714285,6,6,CGGTCCAGCGATTTCTTAGA,0,1828980
hyuA_predicted,0.14285714285714285,6,6,CGGCTTGTATGATACGAGTG,0,1852749
hyuA_predicted,0.14285714285714285,6,6,CGGCGTCGTCAGCACGCGTG,0,1843743
hyuA_predicted,0.14285714285714285,6,6,CGGACCGGGGTGACAGAATG,0,1859384
hyuA_predicted,0.14285714285714285,6,6,CGCTTACGTAACTCATGCCC,0,1834570
hyuA_predicted,0.14285714285714285,6,6,CGCTGTACTGTCTTAAAAAT,0,1829662
hyuA_predicted,0.14285714285714285,6,6,CGCGTCGTCCATGTAGCAGG,0,1848082
hyuA_predicted,0.14285714285714285,6,6,CGCGCAGTGGCTTAGGTGGG,0,1851694
hyuA_predicted,0.14285714285714285,6,6,CGCCTTTTTGATCCGCTGAG,0,1862319
hyuA_predicted,0.14285714285714285,6,6,CGCCTGTTCGAGGCCGATGC,0,1867102
hyuA_predicted,0.14285714285714285,6,6,CGCCCTAATTTACGTGTTTG,0,1856375
hyuA_predicted,0.14285714285714285,6,6,CGCAGATGTCCAATGTAGTC,0,1829958
hyuA_predicted,0.14285714285714285,6,6,CGCACGGGCAATCTTTATAT,0,1867302
hyuA_predicted,0.14285714285714285,6,6,CGCACCCTAGCCGACTATGT,0,1853411
hyuA_predicted,0.14285714285714285,6,6,CGATGCGTCCGCGCATAATT,0,1849305
hyuA_predicted,0.14285714285714285,6,6,CGATCAGTCCTATTGATTCA,0,1870880
hyuA_predicted,0.14285714285714285,6,6,CGAGGGATTCTTGGCCTTAA,0,1847097
hyuA_predicted,0.14285714285714285,6,6,CGAGCAAGTTTGCACCTGAT,0,1861917
hyuA_predicted,0.14285714285714285,6,6,CGACTTAGCCTTGATGGACT,0,1843580
hyuA_predicted,0.14285714285714285,6,6,CGACTGTACTGCCCCCTTTA,0,1868102
hyuA_predicted,0.14285714285714285,6,6,CGACAACCGGATGACGGTGC,0,1871504
hyuA_predicted,0.14285714285714285,6,6,CGAATCACATTAACGGTATT,0,1842134
hyuA_predicted,0.14285714285714285,6,6,CGAAATACGAGCTCTGTCAG,0,1829822
hyuA_predicted,0.14285714285714285,6,6,CCTTTTTGATTTCGTTGGAT,0,1846732
hyuA_predicted,0.14285714285714285,6,6,CCTTCGTTGTAAATTTGACT,0,1872720
hyuA_predicted,0.14285714285714285,6,6,CCTTATGAGCATTGGAAGGC,0,1851170
hyuA_predicted,0.14285714285714285,6,6,CCTGGCCAGTGTAGGGTATG,0,1851974
hyuA_predicted,0.14285714285714285,6,6,CCTGGCACGATTTAATATAA,0,1829587
hyuA_predicted,0.14285714285714285,6,6,CCTGCAGAGCCACCTACTTG,0,1834380
hyuA_predicted,0.14285714285714285,6,6,CCTGAAGAACTTATTGGTAA,0,1836608
hyuA_predicted,0.14285714285714285,6,6,CCTCTTTGTAGCGTCGGCTC,0,1875333
hyuA_predicted,0.14285714285714285,6,6,CCTCTTTGCTATACGGATCT,0,1848604
hyuA_predicted,0.14285714285714285,6,6,CCTCGTGCGGTCTACTGCAG,0,1875162
hyuA_predicted,0.14285714285714285,6,6,CCTATTATATCTGCTGTCCT,0,1869406
hyuA_predicted,0.14285714285714285,6,6,CCTAAGCCATCGAGAACCGT,0,1868400
hyuA_predicted,0.14285714285714285,6,6,CCGTGAGAATATACCCGCCG,0,1862158
hyuA_predicted,0.14285714285714285,6,6,CCGGGTGACGGGAGGTGCAC,0,1836450
hyuA_predicted,0.14285714285714285,6,6,CCGGGGTTCAGCTTGTTTAT,0,1862671
hyuA_predicted,0.14285714285714285,6,6,CCGGCGCCTCATGTGCTCGG,0,1846487
hyuA_predicted,0.14285714285714285,6,6,CCGGATGCCTCCAGACGGTA,0,1842607
hyuA_predicted,0.14285714285714285,6,6,CCGCGGTTGCGCTCTCAATC,0,1843332
hyuA_predicted,0.14285714285714285,6,6,CCGCGGCGCGAGTCTCGGCA,0,1840784
hyuA_predicted,0.14285714285714285,6,6,CCGATCAAATTACGGTGCTT,0,1854425
hyuA_predicted,0.14285714285714285,6,6,CCGACTTCGCCTAAGGGCGG,0,1876130
hyuA_predicted,0.14285714285714285,6,6,CCGACCTTGTGAAGTTACAA,0,1859416
hyuA_predicted,0.14285714285714285,6,6,CCGAATCAGCCCTTAACGTA,0,1830494
hyuA_predicted,0.14285714285714285,6,6,CCCTGCACTGGGACCATGCC,0,1852477
hyuA_predicted,0.14285714285714285,6,6,CCCGAAGTATCGACAGGACG,0,1875020
hyuA_predicted,0.14285714285714285,6,6,CCCCGCAGCTATTTAACCTA,0,1844811
hyuA_predicted,0.14285714285714285,6,6,CCCCCTGTGAGAATACATTA,0,1853510
hyuA_predicted,0.14285714285714285,6,6,CCCAGAGAATGTATCCAGTG,0,1847183
hyuA_predicted,0.14285714285714285,6,6,CCATGCTTCGCGTGGGATTG,0,1862090
hyuA_predicted,0.14285714285714285,6,6,CCATCGTTACCAATGCTCAG,0,1846684
hyuA_predicted,0.14285714285714285,6,6,CCAGTTTACTGGGCAGCAGC,0,1846304
hyuA_predicted,0.14285714285714285,6,6,CCAGTCTTGGAGCCGGTGGC,0,1863529
hyuA_predicted,0.14285714285714285,6,6,CCAGTAGATTTCGTTTACAA,0,1836087
hyuA_predicted,0.14285714285714285,6,6,CCAGCATAGCGAGTGTGATC,0,1846160
hyuA_predicted,0.14285714285714285,6,6,CCAGACAGGGATTAGGGGTA,0,1835049
hyuA_predicted,0.14285714285714285,6,6,CCACGACCGTCGATCCGCCG,0,1829888
hyuA_predicted,0.14285714285714285,6,6,CCACATTAGGGCATATGTAT,0,1861014
hyuA_predicted,0.14285714285714285,6,6,CCAATGGAGGTAATACCAAC,0,1851213
hyuA_predicted,0.14285714285714285,6,6,CCAAGGCTGGATTAACGGAT,0,1859148
hyuA_predicted,0.14285714285714285,6,6,CATGCTGACATATCAAAATA,0,1842880
hyuA_predicted,0.14285714285714285,6,6,CATGCGTTCCCAGTGTCCGA,0,1871654
hyuA_predicted,0.14285714285714285,6,6,CATGCATTTTAGTACTAGCT,0,1837977
hyuA_predicted,0.14285714285714285,6,6,CATCGCAATTTAAGCACAGC,0,1854875
hyuA_predicted,0.14285714285714285,6,6,CATCCCGTCCTATGAATCTC,0,1861715
hyuA_predicted,0.14285714285714285,6,6,CATCCACCGAGTGTGTACGG,0,1858220
hyuA_predicted,0.14285714285714285,6,6,CATATCCCGGTGAGTACGTA,0,1873480
hyuA_predicted,0.14285714285714285,6,6,CATACACCTTCAAAGCAGCG,0,1834423
hyuA_predicted,0.14285714285714285,6,6,CAGTTTAACAGGGAACCCTC,0,1834277
hyuA_predicted,0.14285714285714285,6,6,CAGTTAACAGGGGAGAGAGG,0,1851886
hyuA_predicted,0.14285714285714285,6,6,CAGGTAATGGGTGAGTGCAT,0,1841140
hyuA_predicted,0.14285714285714285,6,6,CAGGACGCATCACCACGCGA,0,1835533
hyuA_predicted,0.14285714285714285,6,6,CAGCTCACCCAGCGGACTTT,0,1830124
hyuA_predicted,0.14285714285714285,6,6,CAGAGTCTAGGATGACGCAG,0,1831832
hyuA_predicted,0.14285714285714285,6,6,CAGAAACCCCTATGGCATGC,0,1867091
hyuA_predicted,0.14285714285714285,6,6,CACTTTAAAGCGGTCAGGGA,0,1856155
hyuA_predicted,0.14285714285714285,6,6,CACTGATAGGTGATGCCGCG,0,1863609
hyuA_predicted,0.14285714285714285,6,6,CACTGAGCCGGGGTATGTCG,0,1855433
hyuA_predicted,0.14285714285714285,6,6,CACTCTTCAGATCGAACACG,0,1862167
hyuA_predicted,0.14285714285714285,6,6,CACTCTCCCAAAGCGTAGAT,0,1830590
hyuA_predicted,0.14285714285714285,6,6,CACTAACTATAGCGACCTGA,0,1871793
hyuA_predicted,0.14285714285714285,6,6,CACATGGGACTGCCCTGCTG,0,1832802
hyuA_predicted,0.14285714285714285,6,6,CACAGCGTGAAGTTGCTGGG,0,1869951
hyuA_predicted,0.14285714285714285,6,6,CAATGAGGTCTCAAACGCGC,0,1863494
hyuA_predicted,0.14285714285714285,6,6,CAATCGGCAAACTCAGGCGG,0,1841198
hyuA_predicted,0.14285714285714285,6,6,CAATCAGTCAGCTAGTCGAA,0,1859236
hyuA_predicted,0.14285714285714285,6,6,CAACCTTGTTGATGGGCGAA,0,1834427
hyuA_predicted,0.14285714285714285,6,6,CAACCTCCGCACCGCCTCGA,0,1863456
hyuA_predicted,0.14285714285714285,6,6,CAAATAGCGTACTGTCAGTA,0,1868215
hyuA_predicted,0.14285714285714285,6,6,CAAAGATACTTGCACACAGT,0,1857170
hyuA_predicted,0.14285714285714285,6,6,CAAAAGTACGGTAGTAGGGG,0,1860238
hyuA_predicted,0.14285714285714285,6,6,ATTTTCCGCAAGGGCTAATG,0,1846363
hyuA_predicted,0.14285714285714285,6,6,ATTTTACAAATTGGATGGCA,0,1860991
hyuA_predicted,0.14285714285714285,6,6,ATTTCGCTCTTGACTAGAAT,0,1865396
hyuA_predicted,0.14285714285714285,6,6,ATTGGGCCAATTACTCACGG,0,1861451
hyuA_predicted,0.14285714285714285,6,6,ATTGGCTCATTACGGACGGA,0,1861720
hyuA_predicted,0.14285714285714285,6,6,ATTCTTGCCGACGGCGTGAG,0,1841803
hyuA_predicted,0.14285714285714285,6,6,ATTCGGTCTTGAGGAATATC,0,1839647
hyuA_predicted,0.14285714285714285,6,6,ATTCGGTCGATGCGTTTCTG,0,1837647
hyuA_predicted,0.14285714285714285,6,6,ATTCGATGTCATGCCAATGG,0,1874651
hyuA_predicted,0.14285714285714285,6,6,ATTACGGGTAGGTCTTTAGT,0,1853267
hyuA_predicted,0.14285714285714285,6,6,ATTAATGTTAATGCGAGAGT,0,1871080
hyuA_predicted,0.14285714285714285,6,6,ATGCGATTGACCCACGGTCC,0,1862563
hyuA_predicted,0.14285714285714285,6,6,ATGAGAGGCGCGTACGGGGG,0,1857369
hyuA_predicted,0.14285714285714285,6,6,ATCTGCATTAGAAATCACAC,0,1845098
hyuA_predicted,0.14285714285714285,6,6,ATCGTCCATCTATCATTTCA,0,1867665
hyuA_predicted,0.14285714285714285,6,6,ATCGGAAGGCACCAACATCG,0,1866469
hyuA_predicted,0.14285714285714285,6,6,ATCGAGAGGACTTGAGGATT,0,1852823
hyuA_predicted,0.14285714285714285,6,6,ATCGACTGAATATTGTGCAA,0,1843361
hyuA_predicted,0.14285714285714285,6,6,ATCGAATAGTCCACAAGTTC,0,1833050
hyuA_predicted,0.14285714285714285,6,6,ATCCGGCCGGAGGTACCGTC,0,1843712
hyuA_predicted,0.14285714285714285,6,6,ATCATCATGCAGGATGGGTG,0,1870459
hyuA_predicted,0.14285714285714285,6,6,ATCATAAGGCTGTCTAGTAA,0,1857160
hyuA_predicted,0.14285714285714285,6,6,ATATAGCTCCTGGGTTTTTT,0,1849771
hyuA_predicted,0.14285714285714285,6,6,ATAGTTTGTCTGAACACCAG,0,1843273
hyuA_predicted,0.14285714285714285,6,6,ATAGTTACATAGCGTAACTC,0,1870522
hyuA_predicted,0.14285714285714285,6,6,ATAGGTTCTGGGTAGATAGT,0,1850622
hyuA_predicted,0.14285714285714285,6,6,ATAGACTGTACTGAATACGG,0,1864369
hyuA_predicted,0.14285714285714285,6,6,ATACGCTGTAGGTTATCCAC,0,1855212
hyuA_predicted,0.14285714285714285,6,6,ATACCTCTGCTCAGTCACGG,0,1863345
hyuA_predicted,0.14285714285714285,6,6,ATAAGGGCGTAAGCTGGTTA,0,1860109
hyuA_predicted,0.14285714285714285,6,6,ATAAAACACGGGTTAGACTA,0,1834190
hyuA_predicted,0.14285714285714285,6,6,AGTTGACGAGTAGATACCAC,0,1836962
hyuA_predicted,0.14285714285714285,6,6,AGTTATCCGATCAGCCTTAC,0,1839792
hyuA_predicted,0.14285714285714285,6,6,AGTTACTGTTTTATAGATAG,0,1841548
hyuA_predicted,0.14285714285714285,6,6,AGTGCAAGGACCTGGATTAG,0,1830261
hyuA_predicted,0.14285714285714285,6,6,AGTCTCCGCATAAAAGGTTT,0,1849934
hyuA_predicted,0.14285714285714285,6,6,AGTCGTTACTAGAAAGGGGA,0,1855424
hyuA_predicted,0.14285714285714285,6,6,AGTATAGCTAAGTTGTAGTC,0,1872725
hyuA_predicted,0.14285714285714285,6,6,AGTAGTTGTTACGGTCTGCA,0,1853075
hyuA_predicted,0.14285714285714285,6,6,AGTAGGATATGACTCAAGCC,0,1861755
hyuA_predicted,0.14285714285714285,6,6,AGTACTGTCAACCCGCTTAC,0,1875758
hyuA_predicted,0.14285714285714285,6,6,AGGTTATCACAGTCATTTGG,0,1848157
hyuA_predicted,0.14285714285714285,6,6,AGGTTAGAAAAAACTTCACA,0,1853566
hyuA_predicted,0.14285714285714285,6,6,AGGTACGCGGGGACACGATT,0,1867201
hyuA_predicted,0.14285714285714285,6,6,AGGTACCCTAGGGAAGTTCT,0,1849743
hyuA_predicted,0.14285714285714285,6,6,AGGGTTTTATCCGACAAGCA,0,1841593
hyuA_predicted,0.14285714285714285,6,6,AGGGCCTACATCCCTATGGA,0,1842842
hyuA_predicted,0.14285714285714285,6,6,AGGGAGGAGTGGAGGGGCGG,0,1830405
hyuA_predicted,0.14285714285714285,6,6,AGGGAAAGCCTCTAGTCATA,0,1862371
hyuA_predicted,0.14285714285714285,6,6,AGGCGGGAAGTTGATGGTCG,0,1839277
hyuA_predicted,0.14285714285714285,6,6,AGGCCGGTAACGCCGAGGAA,0,1856696
hyuA_predicted,0.14285714285714285,6,6,AGGCACCCGGGCCGATGAAT,0,1870273
hyuA_predicted,0.14285714285714285,6,6,AGCCGGCGAAAGATAATGGT,0,1871983
hyuA_predicted,0.14285714285714285,6,6,AGCCGCTCCTTCCCATACCT,0,1848933
hyuA_predicted,0.14285714285714285,6,6,AGCATCACGCTAGCTAGAAT,0,1876070
hyuA_predicted,0.14285714285714285,6,6,AGCACGGGTCTTGGGGTCGA,0,1845426
hyuA_predicted,0.14285714285714285,6,6,AGCACACGGGATATATGATA,0,1863400
hyuA_predicted,0.14285714285714285,6,6,AGCAAACCGGCTAACATTGG,0,1863246
hyuA_predicted,0.14285714285714285,6,6,AGATTGGATCGCGTGTCAGT,0,1866286
hyuA_predicted,0.14285714285714285,6,6,AGAGTAACGTGTCAGCTATT,0,1847116
hyuA_predicted,0.14285714285714285,6,6,AGACCGACGAAGGGGTGCGA,0,1876010
hyuA_predicted,0.14285714285714285,6,6,AGACACGCCACGAGATACCT,0,1877064
hyuA_predicted,0.14285714285714285,6,6,AGAAACGGTGTCGTGTCCGA,0,1871639
hyuA_predicted,0.14285714285714285,6,6,AGAAAACGAGTGGCCATGTC,0,1856241
hyuA_predicted,0.14285714285714285,6,6,ACTTGGTGGACATAGTTATA,0,1850632
hyuA_predicted,0.14285714285714285,6,6,ACTTCCATGGGGCTATCGAC,0,1872803
hyuA_predicted,0.14285714285714285,6,6,ACTTAGTGAAGCAGGCCATT,0,1866177
hyuA_predicted,0.14285714285714285,6,6,ACTGTGTCGGTTCCACCCCC,0,1849910
hyuA_predicted,0.14285714285714285,6,6,ACTCACGAGGTAGAGCTCCA,0,1865172
hyuA_predicted,0.14285714285714285,6,6,ACTAGCTCAGTAGGTCTTGG,0,1831259
hyuA_predicted,0.14285714285714285,6,6,ACGTTATGTTTAGTCTAATG,0,1873273
hyuA_predicted,0.14285714285714285,6,6,ACGTGCGTTGTTTTTCATAA,0,1854071
hyuA_predicted,0.14285714285714285,6,6,ACGTCTCACACGGATACGAA,0,1848357
hyuA_predicted,0.14285714285714285,6,6,ACGTCTAACGCATGCAGCGG,0,1844069
hyuA_predicted,0.14285714285714285,6,6,ACGTATCTATCCCTGCATTA,0,1862349
hyuA_predicted,0.14285714285714285,6,6,ACGGAGAGCATCCAGACGAT,0,1835297
hyuA_predicted,0.14285714285714285,6,6,ACGCTTTAAGATATCGACGT,0,1860149
hyuA_predicted,0.14285714285714285,6,6,ACGCCTTACAAATACCGTAA,0,1872189
hyuA_predicted,0.14285714285714285,6,6,ACGCCGGGCGAAACCCGACG,0,1849349
hyuA_predicted,0.14285714285714285,6,6,ACGCATTGAGGTGGGCATGC,0,1834363
hyuA_predicted,0.14285714285714285,6,6,ACGCAGCTGGTCAGCACAAT,0,1844533
hyuA_predicted,0.14285714285714285,6,6,ACGATTAGACTATTGCTTCT,0,1861816
hyuA_predicted,0.14285714285714285,6,6,ACAGGTCGGGGCCTCTGAAA,0,1863290
hyuA_predicted,0.14285714285714285,6,6,ACACGGAAAGCCGTTAAATG,0,1847544
hyuA_predicted,0.14285714285714285,6,6,ACAATTTCCTATTATTAAGT,0,1863409
hyuA_predicted,0.14285714285714285,6,6,ACAACTTGAATACTCACTGT,0,1835236
hyuA_predicted,0.14285714285714285,6,6,ACAACAGTTCATTAGGACCA,0,1866208
hyuA_predicted,0.14285714285714285,6,6,ACAAATCCATCTACGCCGGT,0,1851398
hyuA_predicted,0.14285714285714285,6,6,ACAAACGAAATTGGTTGATG,0,1864496
hyuA_predicted,0.14285714285714285,6,6,ACAAACACTTTTGACATATG,0,1832621
hyuA_predicted,0.14285714285714285,6,6,ACAAAACCCGGGTGTCCTCT,0,1834916
hyuA_predicted,0.14285714285714285,6,6,AATTCCGGGGCTTACTGTGG,0,1850596
hyuA_predicted,0.14285714285714285,6,6,AATGGGTTTCTGCCTACGGG,0,1858707
hyuA_predicted,0.14285714285714285,6,6,AATGCACTGAGCCAGGTTTA,0,1844409
hyuA_predicted,0.14285714285714285,6,6,AATCGAGATTTTTAGCTGTT,0,1870980
hyuA_predicted,0.14285714285714285,6,6,AATCATAATCCCTGAGTCTT,0,1853763
hyuA_predicted,0.14285714285714285,6,6,AATATTTCCGGCCTTCATGT,0,1850518
hyuA_predicted,0.14285714285714285,6,6,AATACCTAATAAGTAATGTC,0,1874751
hyuA_predicted,0.14285714285714285,6,6,AATAATCTAGACTCATGCGG,0,1830012
hyuA_predicted,0.14285714285714285,6,6,AATAAACCGCGCGCACCCTC,0,1840399
hyuA_predicted,0.14285714285714285,6,6,AAGTGTCTTGTTTAGCGAAG,0,1876505
hyuA_predicted,0.14285714285714285,6,6,AAGTGGCGTTTAGGTGTACT,0,1865711
hyuA_predicted,0.14285714285714285,6,6,AAGTGAGTCCTCTGAAGAGG,0,1829399
hyuA_predicted,0.14285714285714285,6,6,AAGGCTGCGTACACGGTGGT,0,1836611
hyuA_predicted,0.14285714285714285,6,6,AAGGCCAGTATCTGGTTGAA,0,1833788
hyuA_predicted,0.14285714285714285,6,6,AAGGATAGGTTTAAATACCG,0,1870473
hyuA_predicted,0.14285714285714285,6,6,AAGGAACGGTCTAACTTAAG,0,1871200
hyuA_predicted,0.14285714285714285,6,6,AAGGAAATTATGCCTAGGAT,0,1842431
hyuA_predicted,0.14285714285714285,6,6,AAGCACCTGATGACAGTCGG,0,1863525
hyuA_predicted,0.14285714285714285,6,6,AACTTGAATTCCGAAGTGCA,0,1838815
hyuA_predicted,0.14285714285714285,6,6,AACTGCGGCTATGCTACGAC,0,1851362
hyuA_predicted,0.14285714285714285,6,6,AACGCGCGCATCACTTTCCA,0,1865847
hyuA_predicted,0.14285714285714285,6,6,AACGCGCGATGTGCTGCGGG,0,1875113
hyuA_predicted,0.14285714285714285,6,6,AACGATATCTTGCTTATATG,0,1867661
hyuA_predicted,0.14285714285714285,6,6,AACGAGGTGGGGACCCTATG,0,1833939
hyuA_predicted,0.14285714285714285,6,6,AACCTGGACACTTCAATAGG,0,1838742
hyuA_predicted,0.14285714285714285,6,6,AACCCGAAAGTTCAAGCACA,0,1856054
hyuA_predicted,0.14285714285714285,6,6,AACAGGTCATGTATGGAGCT,0,1847141
hyuA_predicted,0.14285714285714285,6,6,AAATGTAGGGACCACATTTC,0,1857030
hyuA_predicted,0.14285714285714285,6,6,AAATGGACGATGTGTTAGAC,0,1870579
hyuA_predicted,0.14285714285714285,6,6,AAATCCGCTTCCTAGCCCAC,0,1854436
hyuA_predicted,0.14285714285714285,6,6,AAATATCCATGATCGGTTTT,0,1855933
hyuA_predicted,0.14285714285714285,6,6,AAATACAAGGCTGGGTCTTT,0,1869964
hyuA_predicted,0.14285714285714285,6,6,AAAGCGTATCCCGTAATCAT,0,1870161
hyuA_predicted,0.14285714285714285,6,6,AAAGACCCAACCTTTTAGGC,0,1860385
hyuA_predicted,0.14285714285714285,6,6,AAACCAACGGCGCACGGATA,0,1850821
hyuA_predicted,0.14285714285714285,6,6,AAAATCGACACAAGTTTAAA,0,1846903
hyuA_predicted,0.14285714285714285,6,6,AAAAGGTACTCCGTAGTACA,0,1830002
hyuA_predicted,0.16666666666666666,5,5,TTTTTTGCATAAACCTCCTC,0,1833575
hyuA_predicted,0.16666666666666666,5,5,TTTTGCTTGCTAAGCTATAG,0,1856333
hyuA_predicted,0.16666666666666666,5,5,TTTTATATACTTTTCCCACG,0,1855132
hyuA_predicted,0.16666666666666666,5,5,TTTGTCTGTAATGCTGGACA,0,1876371
hyuA_predicted,0.16666666666666666,5,5,TTTGGGCGCTATGCGATATA,0,1834127
hyuA_predicted,0.16666666666666666,5,5,TTTGGAAATATTAATCCCCG,0,1830946
hyuA_predicted,0.16666666666666666,5,5,TTTGAGTGACCGCGGACGGA,0,1831240
hyuA_predicted,0.16666666666666666,5,5,TTTCTTTGTGAAGTTGTCGT,0,1875331
hyuA_predicted,0.16666666666666666,5,5,TTTCTATAAGTGGAATGGGG,0,1859222
hyuA_predicted,0.16666666666666666,5,5,TTTCTAAGGTTATGCCACAA,0,1834850
hyuA_predicted,0.16666666666666666,5,5,TTTCGTTACCATTCATCCAA,0,1848997
hyuA_predicted,0.16666666666666666,5,5,TTTCCTTGGCTAGGAACGAA,0,1839565
hyuA_predicted,0.16666666666666666,5,5,TTTAGCCCGTAGAGTGGTCG,0,1870799
hyuA_predicted,0.16666666666666666,5,5,TTTACTGGTGACGAATGCGT,0,1834960
hyuA_predicted,0.16666666666666666,5,5,TTTAATCTCTATAAGTGAAA,0,1860444
hyuA_predicted,0.16666666666666666,5,5,TTGTGTGGTTCTCATCCCGG,0,1832404
hyuA_predicted,0.16666666666666666,5,5,TTGTAGCTATCTCACGCTAT,0,1870049
hyuA_predicted,0.16666666666666666,5,5,TTGGCGCAGGTGTCGAGTAT,0,1835046
hyuA_predicted,0.16666666666666666,5,5,TTGGCGACCGTAGTTCTTAA,0,1858429
hyuA_predicted,0.16666666666666666,5,5,TTGGAGGGTCGCAGATTGGT,0,1860309
hyuA_predicted,0.16666666666666666,5,5,TTGCTGTTAATCTCGTTATC,0,1840673
hyuA_predicted,0.16666666666666666,5,5,TTGCTACCAAACCTTCTCAT,0,1839153
hyuA_predicted,0.16666666666666666,5,5,TTGCCAGAGAGTGAAGGAGC,0,1864627
hyuA_predicted,0.16666666666666666,5,5,TTGAAGGGGCGCGACACTTG,0,1861385
hyuA_predicted,0.16666666666666666,5,5,TTGAAAATAGAAGATGGTTC,0,1852360
hyuA_predicted,0.16666666666666666,5,5,TTCTTCCCATTTCCAGCACT,0,1831443
hyuA_predicted,0.16666666666666666,5,5,TTCTGTGCCAGTTCCTCCCC,0,1836280
hyuA_predicted,0.16666666666666666,5,5,TTCGTTCCTCAGGACCAAGC,0,1851724
hyuA_predicted,0.16666666666666666,5,5,TTCGTCCGATGGGTCGGTAT,0,1841613
hyuA_predicted,0.16666666666666666,5,5,TTCGTAGCGAGTTTCACTTA,0,1834395
hyuA_predicted,0.16666666666666666,5,5,TTCGGTCTTATCACGTTTAG,0,1835572
hyuA_predicted,0.16666666666666666,5,5,TTCGGGGCAACATCAATACA,0,1860384
hyuA_predicted,0.16666666666666666,5,5,TTCGACCGCGAGTTATATCC,0,1856858
hyuA_predicted,0.16666666666666666,5,5,TTCCTCGCAATGTCTATTTG,0,1873926
hyuA_predicted,0.16666666666666666,5,5,TTCCGGTGGTGGCAGCGTGC,0,1858362
hyuA_predicted,0.16666666666666666,5,5,TTCATTGTAACGCAAATTCG,0,1860479
hyuA_predicted,0.16666666666666666,5,5,TTCATTCATGATGCACTGCT,0,1853353
hyuA_predicted,0.16666666666666666,5,5,TTCAAGACCTCCAACTGCGA,0,1835178
hyuA_predicted,0.16666666666666666,5,5,TTATTCGGGACTTAGCCCCG,0,1863779
hyuA_predicted,0.16666666666666666,5,5,TTATTACATGCAATTTAAAT,0,1875579
hyuA_predicted,0.16666666666666666,5,5,TTATCCCGACTGACCCACAG,0,1859018
hyuA_predicted,0.16666666666666666,5,5,TTAGTGTACGAGGACCGGAT,0,1848036
hyuA_predicted,0.16666666666666666,5,5,TTAGTGGCTGTGACGGGCAT,0,1834392
hyuA_predicted,0.16666666666666666,5,5,TTAGTAGACATTGGCCCTCT,0,1843125
hyuA_predicted,0.16666666666666666,5,5,TTAGGCAGGAGTTAGTAGCG,0,1852893
hyuA_predicted,0.16666666666666666,5,5,TTAGGCACCCGTCTGATATA,0,1847646
hyuA_predicted,0.16666666666666666,5,5,TTACGGCACAGCTACTCGTT,0,1870713
hyuA_predicted,0.16666666666666666,5,5,TTACATTTGCGTCTTTGGAC,0,1864933
hyuA_predicted,0.16666666666666666,5,5,TTAAGCAGATCACTCAGCAT,0,1859993
hyuA_predicted,0.16666666666666666,5,5,TTAAAGTCATTTTCACGAAT,0,1865676
hyuA_predicted,0.16666666666666666,5,5,TTAAAACCGGGAACGAGTAA,0,1860807
hyuA_predicted,0.16666666666666666,5,5,TGTTTGAGGGATATATGATA,0,1834055
hyuA_predicted,0.16666666666666666,5,5,TGTTGTGATAGTCGCATCGA,0,1835516
hyuA_predicted,0.16666666666666666,5,5,TGTGTTTGCGACCAATTCTG,0,1838923
hyuA_predicted,0.16666666666666666,5,5,TGTGTTCGAACCTTGATCAG,0,1861112
hyuA_predicted,0.16666666666666666,5,5,TGTGCTTTCCTTTTAAACTG,0,1829388
hyuA_predicted,0.16666666666666666,5,5,TGTCAGGTCACCGCTTGTCC,0,1860546
hyuA_predicted,0.16666666666666666,5,5,TGTCAGATGTAGGAAATTGG,0,1852124
hyuA_predicted,0.16666666666666666,5,5,TGTATTGTTGTAGCGAGACG,0,1876191
hyuA_predicted,0.16666666666666666,5,5,TGTACTGAAGCCTATAGTGG,0,1861532
hyuA_predicted,0.16666666666666666,5,5,TGTACCGTAATGCCGTTAAC,0,1841658
hyuA_predicted,0.16666666666666666,5,5,TGTACCGATCGAGTTGCATT,0,1865152
hyuA_predicted,0.16666666666666666,5,5,TGTAAGGTTCCTCTTTATCT,0,1834965
hyuA_predicted,0.16666666666666666,5,5,TGGTTTTACCGTACACCGTT,0,1841923
hyuA_predicted,0.16666666666666666,5,5,TGGTTCCCGGAATGGGTTCA,0,1852355
hyuA_predicted,0.16666666666666666,5,5,TGGTGTCGTCCGCTCTTATA,0,1870275
hyuA_predicted,0.16666666666666666,5,5,TGGTGAACGACCGCTCATGT,0,1874905
hyuA_predicted,0.16666666666666666,5,5,TGGTCTTTCGCGGCACGCTC,0,1857016
hyuA_predicted,0.16666666666666666,5,5,TGGTCCAACGGTACGAGAAC,0,1838374
hyuA_predicted,0.16666666666666666,5,5,TGGTAACGCCTAGTTGGCGA,0,1870110
hyuA_predicted,0.16666666666666666,5,5,TGGGGGGTAGGATGGGTACA,0,1836127
hyuA_predicted,0.16666666666666666,5,5,TGGCGCCAATCCTGCGACAC,0,1847329
hyuA_predicted,0.16666666666666666,5,5,TGGCGAGTAGTTTCACCGAC,0,1854534
hyuA_predicted,0.16666666666666666,5,5,TGGAGGAGCACCCATATCTA,0,1841935
hyuA_predicted,0.16666666666666666,5,5,TGGACTCCCTAGGTGATTTG,0,1859473
hyuA_predicted,0.16666666666666666,5,5,TGGACAAACGTAACGGAGGG,0,1856987
hyuA_predicted,0.16666666666666666,5,5,TGGAACCAATTATGCAGATA,0,1851721
hyuA_predicted,0.16666666666666666,5,5,TGCGTTTAGACTCTTGACCC,0,1864196
hyuA_predicted,0.16666666666666666,5,5,TGCGCTCAACAATACTACTT,0,1842839
hyuA_predicted,0.16666666666666666,5,5,TGCGATAGTGCCGGCCATTC,0,1874895
hyuA_predicted,0.16666666666666666,5,5,TGATTACACTCTATATCAAA,0,1840984
hyuA_predicted,0.16666666666666666,5,5,TGATGGAAGGAGGTGTTGTA,0,1834541
hyuA_predicted,0.16666666666666666,5,5,TGATCACATTAATGCAGCGC,0,1868019
hyuA_predicted,0.16666666666666666,5,5,TGATATAACCAAGTTGTGGA,0,1843255
hyuA_predicted,0.16666666666666666,5,5,TGAGGCGGATTCGGATCGCT,0,1846360
hyuA_predicted,0.16666666666666666,5,5,TGAGCCCTAGTTCTGGCATT,0,1835659
hyuA_predicted,0.16666666666666666,5,5,TGAGAATCTACTTCGGGTGG,0,1860347
hyuA_predicted,0.16666666666666666,5,5,TGACTGGAGGACCTTTGATC,0,1874662
hyuA_predicted,0.16666666666666666,5,5,TGACAGCGGACTAGCATTAC,0,1843109
hyuA_predicted,0.16666666666666666,5,5,TGAAGCGCCTCTTATATATG,0,1833112
hyuA_predicted,0.16666666666666666,5,5,TGAACGGGGCTTGGGAAGTC,0,1836515
hyuA_predicted,0.16666666666666666,5,5,TGAAAAGGGTGAAGCCGGGA,0,1876085
hyuA_predicted,0.16666666666666666,5,5,TGAAAAGGATGAGCTAGTCA,0,1854055
hyuA_predicted,0.16666666666666666,5,5,TCTCTACCTATCTGAACCGG,0,1869970
hyuA_predicted,0.16666666666666666,5,5,TCTCGACGGCCCTTGGCGGG,0,1862577
hyuA_predicted,0.16666666666666666,5,5,TCTCAAGATCGCGACGCATG,0,1875898
hyuA_predicted,0.16666666666666666,5,5,TCTATTGGGGCAGAGCCGAT,0,1838954
hyuA_predicted,0.16666666666666666,5,5,TCTAGTCGTTTTCAACGGGA,0,1844777
hyuA_predicted,0.16666666666666666,5,5,TCTACGTAATTTGTGGCTTA,0,1861925
hyuA_predicted,0.16666666666666666,5,5,TCTACGGCCTAGCACTCGCA,0,1840148
hyuA_predicted,0.16666666666666666,5,5,TCTAAGGGAATAGTGACGAA,0,1850422
hyuA_predicted,0.16666666666666666,5,5,TCGTGGGGATTAGCTTGGCT,0,1868724
hyuA_predicted,0.16666666666666666,5,5,TCGTCGGGAGGGACTCGAAT,0,1851496
hyuA_predicted,0.16666666666666666,5,5,TCGTCCGTCCGGTATGAGCT,0,1849473
hyuA_predicted,0.16666666666666666,5,5,TCGTAATATCCATGCAAGGA,0,1874015
hyuA_predicted,0.16666666666666666,5,5,TCGGTCCGTCAGGCGTGGTA,0,1846053
hyuA_predicted,0.16666666666666666,5,5,TCGGGTTGGACGTCGTAGTA,0,1837852
hyuA_predicted,0.16666666666666666,5,5,TCGGGTACTGTTTCAACCAT,0,1859678
hyuA_predicted,0.16666666666666666,5,5,TCGGCTCATTGGGTCTTGGT,0,1863155
hyuA_predicted,0.16666666666666666,5,5,TCGGAAACACTAGCGCAAGA,0,1843481
hyuA_predicted,0.16666666666666666,5,5,TCGCTGTGGGTCATCACGCT,0,1841440
hyuA_predicted,0.16666666666666666,5,5,TCGCTGTGCATCATAATACT,0,1862806
hyuA_predicted,0.16666666666666666,5,5,TCGCTGAATGACTTAGTGTG,0,1864495
hyuA_predicted,0.16666666666666666,5,5,TCGCTAAAGCCATTTACGAT,0,1843401
hyuA_predicted,0.16666666666666666,5,5,TCGACATCCGTTAAATGTCG,0,1844375
hyuA_predicted,0.16666666666666666,5,5,TCGAATTATAAGGGATTTGT,0,1865279
hyuA_predicted,0.16666666666666666,5,5,TCGAAGCTCTTCAACTATTT,0,1858263
hyuA_predicted,0.16666666666666666,5,5,TCGAACTCGGCGGTAAGGGG,0,1854706
hyuA_predicted,0.16666666666666666,5,5,TCCTTAGGGGGGGCGTCCAT,0,1832142
hyuA_predicted,0.16666666666666666,5,5,TCCTCAGGATATATCATTTG,0,1873065
hyuA_predicted,0.16666666666666666,5,5,TCCGTCTCTACGCAGGAGGC,0,1836650
hyuA_predicted,0.16666666666666666,5,5,TCCGTATATTATTGCACAGG,0,1866181
hyuA_predicted,0.16666666666666666,5,5,TCCGCGAAAGGAGGTAAATT,0,1861399
hyuA_predicted,0.16666666666666666,5,5,TCCCTGTGATACTCTCAAAA,0,1861605
hyuA_predicted,0.16666666666666666,5,5,TCCCTGCGAATAGTTCGCAA,0,1862384
hyuA_predicted,0.16666666666666666,5,5,TCCCGGCACTCGACTACGAG,0,1875437
hyuA_predicted,0.16666666666666666,5,5,TCCCGGAGGCCACTACCGGA,0,1860301
hyuA_predicted,0.16666666666666666,5,5,TCCCAGATACGGAACCTCAA,0,1841751
hyuA_predicted,0.16666666666666666,5,5,TCCAGAACGGATTGTTCACA,0,1875456
hyuA_predicted,0.16666666666666666,5,5,TCCACGTTTTCGTCTCCTGC,0,1845909
hyuA_predicted,0.16666666666666666,5,5,TCATTGCAGGACGGGTCCTC,0,1859098
hyuA_predicted,0.16666666666666666,5,5,TCATTACGGGACCTAGTCAT,0,1838919
hyuA_predicted,0.16666666666666666,5,5,TCATGTGTTAGCTGTAGGAA,0,1854594
hyuA_predicted,0.16666666666666666,5,5,TCATGAACTATTAGATGAAT,0,1859681
hyuA_predicted,0.16666666666666666,5,5,TCATAAACAAGATATCGTTT,0,1858633
hyuA_predicted,0.16666666666666666,5,5,TCATAAAACATTATATGCTG,0,1849695
hyuA_predicted,0.16666666666666666,5,5,TCAGGTCGTAAGTAGAAGAT,0,1864334
hyuA_predicted,0.16666666666666666,5,5,TCACCTTATAGGTCAAAACA,0,1860591
hyuA_predicted,0.16666666666666666,5,5,TCACAGAATCTTTATATCGG,0,1849516
hyuA_predicted,0.16666666666666666,5,5,TCACAAAATGTCTAGACCTG,0,1855435
hyuA_predicted,0.16666666666666666,5,5,TCAATCAACCCGCATGTGAC,0,1861744
hyuA_predicted,0.16666666666666666,5,5,TCAAGGGGAACCGCATCCAT,0,1853461
hyuA_predicted,0.16666666666666666,5,5,TCAAGCGGGGTCTCGAACAA,0,1868292
hyuA_predicted,0.16666666666666666,5,5,TATTGTGTGTCGGGAAGGTC,0,1840952
hyuA_predicted,0.16666666666666666,5,5,TATTGGTTGACTCGCGCGCA,0,1868950
hyuA_predicted,0.16666666666666666,5,5,TATTGACACCCAGCTCCGGC,0,1838234
hyuA_predicted,0.16666666666666666,5,5,TATGTCAGCTTCATAAGATG,0,1871038
hyuA_predicted,0.16666666666666666,5,5,TATGTATGCTACCAGGGCGC,0,1867851
hyuA_predicted,0.16666666666666666,5,5,TATGGACATTACTTATTTTT,0,1845280
hyuA_predicted,0.16666666666666666,5,5,TATGCAGGGTCAGCATCGTG,0,1858009
hyuA_predicted,0.16666666666666666,5,5,TATGACTACCGGCAATCGTC,0,1854223
hyuA_predicted,0.16666666666666666,5,5,TATGAAAAGAGGGCCATCAG,0,1861894
hyuA_predicted,0.16666666666666666,5,5,TATCCTTAATTCTCCATAAG,0,1859417
hyuA_predicted,0.16666666666666666,5,5,TATCAAAATGCCTGTATGCA,0,1869036
hyuA_predicted,0.16666666666666666,5,5,TATATTCGGGCGGATTTTTG,0,1832449
hyuA_predicted,0.16666666666666666,5,5,TATATGAGAGAGCCCCAGTT,0,1850135
hyuA_predicted,0.16666666666666666,5,5,TATAGAGGTCCGGGTAGTAG,0,1876919
hyuA_predicted,0.16666666666666666,5,5,TATAACATTCGGACTGCTAG,0,1848002
hyuA_predicted,0.16666666666666666,5,5,TAGGTCTATGCGTGCCTAAG,0,1855623
hyuA_predicted,0.16666666666666666,5,5,TAGGTATCCTCGGATTCAGC,0,1852055
hyuA_predicted,0.16666666666666666,5,5,TAGGGGGGAACGGGATCTGT,0,1858106
hyuA_predicted,0.16666666666666666,5,5,TAGACCCTGGAGGGTGCCGT,0,1856921
hyuA_predicted,0.16666666666666666,5,5,TACTACGTCTTGCTGTATGG,0,1841340
hyuA_predicted,0.16666666666666666,5,5,TACGTTCTCGCTTGGTATGA,0,1833446
hyuA_predicted,0.16666666666666666,5,5,TACGTGGTTTGTTAGGTGTA,0,1849050
hyuA_predicted,0.16666666666666666,5,5,TACGTAATTTCATAACTTGC,0,1858036
hyuA_predicted,0.16666666666666666,5,5,TACGATCTTCACCCATCATT,0,1861507
hyuA_predicted,0.16666666666666666,5,5,TACGAGTAGTTTATGATGCT,0,1855748
hyuA_predicted,0.16666666666666666,5,5,TACCTCCTGTAGGGAGGACG,0,1856332
hyuA_predicted,0.16666666666666666,5,5,TACCGTCTTGAATGATTACC,0,1843159
hyuA_predicted,0.16666666666666666,5,5,TACCGGTGGTCTCCACGCTA,0,1877174
hyuA_predicted,0.16666666666666666,5,5,TACCGCACAAGGGAAGCCCA,0,1847153
hyuA_predicted,0.16666666666666666,5,5,TACACGATACCTGTTTTATA,0,1836967
hyuA_predicted,0.16666666666666666,5,5,TACAAACGTTTATACTACGA,0,1859904
hyuA_predicted,0.16666666666666666,5,5,TAATTCTTCCCAGAGGGATG,0,1857731
hyuA_predicted,0.16666666666666666,5,5,TAATTAGACGGGCCGTTATC,0,1841118
hyuA_predicted,0.16666666666666666,5,5,TAATCGCACATTAATCAGTC,0,1830301
hyuA_predicted,0.16666666666666666,5,5,TAAGGCAGATTCCTGCACTG,0,1863994
hyuA_predicted,0.16666666666666666,5,5,TAAGCGTCACATCTCCATTT,0,1869404
hyuA_predicted,0.16666666666666666,5,5,TAAGCCAAAGCCAAATATGT,0,1837750
hyuA_predicted,0.16666666666666666,5,5,TAAGATGCGCAGGTTTTTGA,0,1847080
hyuA_predicted,0.16666666666666666,5,5,TAAGAGGACCTTATTCAGCG,0,1838333
hyuA_predicted,0.16666666666666666,5,5,TAAGAAGTACGAGGGGAGAA,0,1865823
hyuA_predicted,0.16666666666666666,5,5,TAACTTTCGCCCTGGCGATG,0,1863402
hyuA_predicted,0.16666666666666666,5,5,TAACTGGAGCGGTTCGAGTT,0,1835942
hyuA_predicted,0.16666666666666666,5,5,TAAATCCACTGCAGTAGTAA,0,1830822
hyuA_predicted,0.16666666666666666,5,5,TAAAGTTGTTAGTGGACAGG,0,1851187
hyuA_predicted,0.16666666666666666,5,5,GTTTTCCGCATTAGTGAATG,0,1856825
hyuA_predicted,0.16666666666666666,5,5,GTTTTAGCAGAGGTCGTCCT,0,1844443
hyuA_predicted,0.16666666666666666,5,5,GTTTCCATGAAACCGAATAC,0,1831102
hyuA_predicted,0.16666666666666666,5,5,GTTTATGTATTGATGCCGAA,0,1852128
hyuA_predicted,0.16666666666666666,5,5,GTTGAGGTAAATCTCAGCTG,0,1875031
hyuA_predicted,0.16666666666666666,5,5,GTTCGCTGTATTCACGGGCT,0,1846462
hyuA_predicted,0.16666666666666666,5,5,GTTCCGGGCGTGAATCTGAA,0,1828940
hyuA_predicted,0.16666666666666666,5,5,GTTCATGGCCCCCTCAGATT,0,1868371
hyuA_predicted,0.16666666666666666,5,5,GTTAGAACAGGTTCTTGAGG,0,1859490
hyuA_predicted,0.16666666666666666,5,5,GTTACTGCAGTGCGCGATTC,0,1838481
hyuA_predicted,0.16666666666666666,5,5,GTTAATTGTGGTTTCATGGG,0,1848834
hyuA_predicted,0.16666666666666666,5,5,GTTAACTAATTTTGCAGAAT,0,1831383
hyuA_predicted,0.16666666666666666,5,5,GTGTTTCCACGGATCAATGT,0,1850419
hyuA_predicted,0.16666666666666666,5,5,GTGTTAACAAACCATCAGAT,0,1849104
hyuA_predicted,0.16666666666666666,5,5,GTGGGTCGTTTAGAGCCTGT,0,1844966
hyuA_predicted,0.16666666666666666,5,5,GTGGACTTTCGTGGTGGTCC,0,1869452
hyuA_predicted,0.16666666666666666,5,5,GTGGACCAGACCTCAGAGCA,0,1840256
hyuA_predicted,0.16666666666666666,5,5,GTGGAACGTAGTTAGGGGAA,0,1831120
hyuA_predicted,0.16666666666666666,5,5,GTGCTGGCCCCCGGCCTGAT,0,1845405
hyuA_predicted,0.16666666666666666,5,5,GTGCGGGGACTAGTCACGTT,0,1859007
hyuA_predicted,0.16666666666666666,5,5,GTGATTGTGCACATGGCCTG,0,1851283
hyuA_predicted,0.16666666666666666,5,5,GTGATCTGGAGTATCGTGCA,0,1842519
hyuA_predicted,0.16666666666666666,5,5,GTGATCTGCCCTCCGCCCAG,0,1855581
hyuA_predicted,0.16666666666666666,5,5,GTGAAACGACTCGTCGCCTA,0,1862798
hyuA_predicted,0.16666666666666666,5,5,GTGAAAACTGTCCACGGGGA,0,1832545
hyuA_predicted,0.16666666666666666,5,5,GTCTTCTAGTAGGTTTTCTG,0,1876697
hyuA_predicted,0.16666666666666666,5,5,GTCTAGGACGATTTACGAGC,0,1841651
hyuA_predicted,0.16666666666666666,5,5,GTCTAGACAGAGAGATGTAA,0,1865657
hyuA_predicted,0.16666666666666666,5,5,GTCGTTCGAGATTCGCTACA,0,1855585
hyuA_predicted,0.16666666666666666,5,5,GTCGTCAAGGGGATTGGTGC,0,1850864
hyuA_predicted,0.16666666666666666,5,5,GTCGGCGCGATAGTCCAATG,0,1833804
hyuA_predicted,0.16666666666666666,5,5,GTCCTGCCACTCTGTACCTT,0,1860699
hyuA_predicted,0.16666666666666666,5,5,GTCCTCTGCGAATATTGTCG,0,1848932
hyuA_predicted,0.16666666666666666,5,5,GTCCATATAAAGAAGGCGCA,0,1840772
hyuA_predicted,0.16666666666666666,5,5,GTATTTCACCCCCGCTGGGT,0,1840065
hyuA_predicted,0.16666666666666666,5,5,GTATTGGACGCGCGCTAAAG,0,1877398
hyuA_predicted,0.16666666666666666,5,5,GTATAGTCACTCGGAACCCC,0,1856108
hyuA_predicted,0.16666666666666666,5,5,GTATAGAAATGAATAAGCTA,0,1857059
hyuA_predicted,0.16666666666666666,5,5,GTAGTGAGGCCCAGATGTGC,0,1829609
hyuA_predicted,0.16666666666666666,5,5,GTAGTGACCTAAGCGACTGA,0,1873227
hyuA_predicted,0.16666666666666666,5,5,GTAGCCCTTCCCGGAATTGA,0,1835638
hyuA_predicted,0.16666666666666666,5,5,GTACTGAAGCCTGTACTCCA,0,1870542
hyuA_predicted,0.16666666666666666,5,5,GTACTACAATGCATATACCG,0,1834820
hyuA_predicted,0.16666666666666666,5,5,GTACCTTGCCAGTTAGTAAT,0,1854568
hyuA_predicted,0.16666666666666666,5,5,GTACATCATATAGGAACATG,0,1872062
hyuA_predicted,0.16666666666666666,5,5,GTAATGTAGGCAGATATTGG,0,1860772
hyuA_predicted,0.16666666666666666,5,5,GTAAGCTATATAGGTCGGGC,0,1844901
hyuA_predicted,0.16666666666666666,5,5,GGTTGGCACGTATGCGAAGG,0,1848766
hyuA_predicted,0.16666666666666666,5,5,GGTTGATTGTGCTCTTGTAC,0,1844014
hyuA_predicted,0.16666666666666666,5,5,GGTTACACGCTCAGCTGCCT,0,1871046
hyuA_predicted,0.16666666666666666,5,5,GGTGTCATATAATACCTTTG,0,1844683
hyuA_predicted,0.16666666666666666,5,5,GGTGGGGTCAAGTTCTCGAC,0,1861675
hyuA_predicted,0.16666666666666666,5,5,GGTGCCCATGCTAAGCTCGA,0,1865346
hyuA_predicted,0.16666666666666666,5,5,GGTGCATAGACTGTACTGTA,0,1876829
hyuA_predicted,0.16666666666666666,5,5,GGTCTCGATTCTGGGTACAC,0,1836104
hyuA_predicted,0.16666666666666666,5,5,GGTCCAGAGCCAGTAATAGT,0,1872378
hyuA_predicted,0.16666666666666666,5,5,GGTCATCAGGCGGCGGGCAT,0,1839691
hyuA_predicted,0.16666666666666666,5,5,GGTATGTATCGGGGTTAGCG,0,1855742
hyuA_predicted,0.16666666666666666,5,5,GGGTTTCTTATGCACAGTGA,0,1872133
hyuA_predicted,0.16666666666666666,5,5,GGGTTATCTGGAAACTCGAT,0,1849346
hyuA_predicted,0.16666666666666666,5,5,GGGTGCAGGGGCCTGTTAGA,0,1872501
hyuA_predicted,0.16666666666666666,5,5,GGGTCCCAGATCTCGAATTA,0,1870515
hyuA_predicted,0.16666666666666666,5,5,GGGTCAGCATTTAGCCGGAA,0,1842479
hyuA_predicted,0.16666666666666666,5,5,GGGTATATGCGTGATCTTCC,0,1834139
hyuA_predicted,0.16666666666666666,5,5,GGGTAGGTGTCAAAATACTA,0,1858806
hyuA_predicted,0.16666666666666666,5,5,GGGGTATCCTCTACGTTCGC,0,1850926
hyuA_predicted,0.16666666666666666,5,5,GGGGGACAGCTGCGTGACCC,0,1835683
hyuA_predicted,0.16666666666666666,5,5,GGGCTTCTTTGGACGGCTGT,0,1829324
hyuA_predicted,0.16666666666666666,5,5,GGGCTCAGCAATAGACCCCT,0,1868334
hyuA_predicted,0.16666666666666666,5,5,GGGCGTGACAGTTACCATCA,0,1841187
hyuA_predicted,0.16666666666666666,5,5,GGGCGGACCGGAAAGTGTCT,0,1828887
hyuA_predicted,0.16666666666666666,5,5,GGGCAAAATCTTGCTTAGGC,0,1845233
hyuA_predicted,0.16666666666666666,5,5,GGGATAACCAGCGCACAGGT,0,1829190
hyuA_predicted,0.16666666666666666,5,5,GGGACTCGCTTTAGAGCAAG,0,1829508
hyuA_predicted,0.16666666666666666,5,5,GGGACCAGACTTATCGCCCC,0,1871864
hyuA_predicted,0.16666666666666666,5,5,GGGAAACATTATTCCAGCGG,0,1865360
hyuA_predicted,0.16666666666666666,5,5,GGCTCTGCAGACGTTCTCTA,0,1864240
hyuA_predicted,0.16666666666666666,5,5,GGCTCGCACCTGCGTTCTCA,0,1841591
hyuA_predicted,0.16666666666666666,5,5,GGCGTTTCCGTATCATGCAA,0,1844390
hyuA_predicted,0.16666666666666666,5,5,GGCGATTATTCTATAAAATG,0,1832307
hyuA_predicted,0.16666666666666666,5,5,GGCGATATGTACGGGAATGT,0,1866849
hyuA_predicted,0.16666666666666666,5,5,GGCCCGCATGAGGATGAAAA,0,1848812
hyuA_predicted,0.16666666666666666,5,5,GGCCATTCCTACCGATCGAT,0,1834676
hyuA_predicted,0.16666666666666666,5,5,GGCACTTACAATGGGGACCA,0,1853679
hyuA_predicted,0.16666666666666666,5,5,GGCACCGAGCCGGGATTTCT,0,1861561
hyuA_predicted,0.16666666666666666,5,5,GGATGGGCTGGATCCCTTTA,0,1875205
hyuA_predicted,0.16666666666666666,5,5,GGATCTCAGAAAACCCATCA,0,1863210
hyuA_predicted,0.16666666666666666,5,5,GGATCGTCGCATTGGTATTG,0,1872050
hyuA_predicted,0.16666666666666666,5,5,GGAGTGAGGCAAGGGTACCA,0,1829453
hyuA_predicted,0.16666666666666666,5,5,GGAGTAAACGCACAGGATCC,0,1869484
hyuA_predicted,0.16666666666666666,5,5,GGAGGCGGAAGGCCGAAAGG,0,1853532
hyuA_predicted,0.16666666666666666,5,5,GGAGACCCGCAGGGGGCAGA,0,1844449
hyuA_predicted,0.16666666666666666,5,5,GGAATTCTCTTTCACCTAAG,0,1859275
hyuA_predicted,0.16666666666666666,5,5,GGAATGGTCCCTCTACCTAA,0,1869200
hyuA_predicted,0.16666666666666666,5,5,GGAACGTAGATGAGCCGACG,0,1839591
hyuA_predicted,0.16666666666666666,5,5,GGAACCAGGCGTAGGTATGG,0,1839651
hyuA_predicted,0.16666666666666666,5,5,GGAAATCTACTGCTTGGCAA,0,1857877
hyuA_predicted,0.16666666666666666,5,5,GCTTGCTCTAAATGGGATCA,0,1848929
hyuA_predicted,0.16666666666666666,5,5,GCTTGAGCGTTGTCAGATCC,0,1873975
hyuA_predicted,0.16666666666666666,5,5,GCTGACAGAGTGGTAGCTTT,0,1844380
hyuA_predicted,0.16666666666666666,5,5,GCTCGGCGTTTTTCGCCGGA,0,1852344
hyuA_predicted,0.16666666666666666,5,5,GCTCATTTGATACTGCCTGT,0,1847416
hyuA_predicted,0.16666666666666666,5,5,GCTAATCTACAATACGGACA,0,1856022
hyuA_predicted,0.16666666666666666,5,5,GCTAAGGTCCGACATCGAGA,0,1847246
hyuA_predicted,0.16666666666666666,5,5,GCGTTCCCCATGTAATGCAT,0,1845501
hyuA_predicted,0.16666666666666666,5,5,GCGTCATGGCGAGTACGGGC,0,1836686
hyuA_predicted,0.16666666666666666,5,5,GCGTAAACGGTTATCGTATG,0,1845693
hyuA_predicted,0.16666666666666666,5,5,GCGGGCTTACCTATACAGCA,0,1841110
hyuA_predicted,0.16666666666666666,5,5,GCGCTGAGGGTGTAACCCCT,0,1852923
hyuA_predicted,0.16666666666666666,5,5,GCGAACCGCATATAACCGAG,0,1850377
hyuA_predicted,0.16666666666666666,5,5,GCCTATTACGATCCTGCAAT,0,1855554
hyuA_predicted,0.16666666666666666,5,5,GCCGGACGACTCAGGTGATT,0,1831086
hyuA_predicted,0.16666666666666666,5,5,GCCGCTCAGGCAAAGAGTAT,0,1839039
hyuA_predicted,0.16666666666666666,5,5,GCCGATCCTGGTTTCAATCC,0,1863430
hyuA_predicted,0.16666666666666666,5,5,GCCCTTCGATAAGACCGACA,0,1849052
hyuA_predicted,0.16666666666666666,5,5,GCCCATTACATATGCTGAGC,0,1833878
hyuA_predicted,0.16666666666666666,5,5,GCCAGTCGGACGTCAGCATT,0,1852757
hyuA_predicted,0.16666666666666666,5,5,GCCAACTCGCATCATTTTTC,0,1874842
hyuA_predicted,0.16666666666666666,5,5,GCATCTATCAGAACACAAAT,0,1864195
hyuA_predicted,0.16666666666666666,5,5,GCAGTCCCGTCACCCGGGAT,0,1856227
hyuA_predicted,0.16666666666666666,5,5,GCAGTCCCATAGGGTCTTAT,0,1873218
hyuA_predicted,0.16666666666666666,5,5,GCAGTAGGGAATGAGCGTCG,0,1835496
hyuA_predicted,0.16666666666666666,5,5,GCAGGCGCTCTTGCCAAATA,0,1844030
hyuA_predicted,0.16666666666666666,5,5,GCAGATCGAATTGATTGATG,0,1842866
hyuA_predicted,0.16666666666666666,5,5,GCACGTGGGACCTTCTGGCG,0,1839977
hyuA_predicted,0.16666666666666666,5,5,GCACGGCGATGGGAGTAGGC,0,1858259
hyuA_predicted,0.16666666666666666,5,5,GCACCCGATACTGAGTACCA,0,1859272
hyuA_predicted,0.16666666666666666,5,5,GCAATGCGGTAGAGGGCGCA,0,1869017
hyuA_predicted,0.16666666666666666,5,5,GCAATATGTCGATCAGGATG,0,1838372
hyuA_predicted,0.16666666666666666,5,5,GCAAGTGATGGGCAGTAGTT,0,1870992
hyuA_predicted,0.16666666666666666,5,5,GCAAGTACCAGCCGCCGATC,0,1840438
hyuA_predicted,0.16666666666666666,5,5,GATTGGGGAATGTTTAATTA,0,1846916
hyuA_predicted,0.16666666666666666,5,5,GATTAGCGCGCCGGATAGTG,0,1863169
hyuA_predicted,0.16666666666666666,5,5,GATGTACATCTCGTAGGCGG,0,1841405
hyuA_predicted,0.16666666666666666,5,5,GATGGCAGTGCTGAAATCTT,0,1871141
hyuA_predicted,0.16666666666666666,5,5,GATCTTACCGACGGACAAAA,0,1856996
hyuA_predicted,0.16666666666666666,5,5,GATCTCGTAGAGAATAAGTC,0,1851825
hyuA_predicted,0.16666666666666666,5,5,GATATAATAGATATTAAGAA,0,1830320
hyuA_predicted,0.16666666666666666,5,5,GATACATATCAAGAGACCAA,0,1830063
hyuA_predicted,0.16666666666666666,5,5,GAGTCGATTTAAACGCCAAG,0,1854831
hyuA_predicted,0.16666666666666666,5,5,GAGGCCCGGCCTCGATGACG,0,1877861
hyuA_predicted,0.16666666666666666,5,5,GAGGCCAAAGCCGGACTTAA,0,1864200
hyuA_predicted,0.16666666666666666,5,5,GAGACGCCGGATCCTCTCCA,0,1853179
hyuA_predicted,0.16666666666666666,5,5,GAGACGAGTAGTCGAAAGTT,0,1847575
hyuA_predicted,0.16666666666666666,5,5,GAGAAGAGTTCTCGGGTCCT,0,1834532
hyuA_predicted,0.16666666666666666,5,5,GACTGCCTCCCAATGTGAAA,0,1873516
hyuA_predicted,0.16666666666666666,5,5,GACTGCCAATGGAAAAATTC,0,1863636
hyuA_predicted,0.16666666666666666,5,5,GACTCGAGTGGTACGACTCA,0,1840178
hyuA_predicted,0.16666666666666666,5,5,GACTATTTGCGCATTGACTT,0,1845102
hyuA_predicted,0.16666666666666666,5,5,GACGTTGAGGAGGATCTAAT,0,1869072
hyuA_predicted,0.16666666666666666,5,5,GACGGCCTGGCAGCTAACTA,0,1846888
hyuA_predicted,0.16666666666666666,5,5,GACCTGCAGCATGTAACTGT,0,1859912
hyuA_predicted,0.16666666666666666,5,5,GACCGAACCTCTTTCGGATG,0,1831696
hyuA_predicted,0.16666666666666666,5,5,GACCCCGCACCCTGACTGCA,0,1831842
hyuA_predicted,0.16666666666666666,5,5,GACATTGGGCCTTCACAACC,0,1856644
hyuA_predicted,0.16666666666666666,5,5,GACAGTGCCGGGTTCCCATT,0,1858991
hyuA_predicted,0.16666666666666666,5,5,GACACATGTAGGTCCACTCA,0,1832874
hyuA_predicted,0.16666666666666666,5,5,GACAAGCATTAAAGCGCCAT,0,1860875
hyuA_predicted,0.16666666666666666,5,5,GAATTGACGAAGCGACTACC,0,1849307
hyuA_predicted,0.16666666666666666,5,5,GAATGGAGTAACTTGGGACA,0,1845057
hyuA_predicted,0.16666666666666666,5,5,GAATCGGTTTAAGTCTAGTG,0,1856907
hyuA_predicted,0.16666666666666666,5,5,GAATACAGGCTTAACAGAAT,0,1875544
hyuA_predicted,0.16666666666666666,5,5,GAAGCGACCGATGCTTGATC,0,1853116
hyuA_predicted,0.16666666666666666,5,5,GAAGCCAACCACGAGTCAAC,0,1862883
hyuA_predicted,0.16666666666666666,5,5,GAACTTGCAGTTTGCCTAAC,0,1841192
hyuA_predicted,0.16666666666666666,5,5,GAAATGTAAGTCTTTTAAGG,0,1852101
hyuA_predicted,0.16666666666666666,5,5,GAAAGGGGAGGATCATTCGG,0,1863081
hyuA_predicted,0.16666666666666666,5,5,GAAAGGGAGATGGGTAACTT,0,1854829
hyuA_predicted,0.16666666666666666,5,5,GAAAGCAGTCTAGAACCTCG,0,1868508
hyuA_predicted,0.16666666666666666,5,5,CTTTCTTTCGAGGTTATGGG,0,1846297
hyuA_predicted,0.16666666666666666,5,5,CTTTCTAAGGTGTTATTCCA,0,1860916
hyuA_predicted,0.16666666666666666,5,5,CTTGGGAAATGTGCCTGGAG,0,1829904
hyuA_predicted,0.16666666666666666,5,5,CTTGCGTTAATCACTTTGAT,0,1873191
hyuA_predicted,0.16666666666666666,5,5,CTTCTTTTTACAGGTGCAAC,0,1860701
hyuA_predicted,0.16666666666666666,5,5,CTTCACTACTGCAGGTTCGG,0,1850535
hyuA_predicted,0.16666666666666666,5,5,CTTAGCTTTCGTGGGCTATT,0,1844994
hyuA_predicted,0.16666666666666666,5,5,CTGTTCCACACTCTTCTTGT,0,1874653
hyuA_predicted,0.16666666666666666,5,5,CTGTGTGCCTTGCGGTAAAA,0,1832620
hyuA_predicted,0.16666666666666666,5,5,CTGTGTCCATGGGAATGCCA,0,1873834
hyuA_predicted,0.16666666666666666,5,5,CTGTGAAATTTTCGCTCAAC,0,1854618
hyuA_predicted,0.16666666666666666,5,5,CTGGTTAAACGGGTTGCAGT,0,1876789
hyuA_predicted,0.16666666666666666,5,5,CTGGTCTAGGCGTCGCGTTA,0,1873208
hyuA_predicted,0.16666666666666666,5,5,CTGGCCAAAGGGTGAAGCGA,0,1833175
hyuA_predicted,0.16666666666666666,5,5,CTGAAGTTTCGGCCTACTTT,0,1850239
hyuA_predicted,0.16666666666666666,5,5,CTCTGCGTAGAATCAGAAAC,0,1845036
hyuA_predicted,0.16666666666666666,5,5,CTCTAGACGGCGGCACACTC,0,1855565
hyuA_predicted,0.16666666666666666,5,5,CTCGTATTTGCAATCCCTTG,0,1846728
hyuA_predicted,0.16666666666666666,5,5,CTCCGAGAATCTGTTTATGT,0,1840501
hyuA_predicted,0.16666666666666666,5,5,CTCCCTAGGTCAAGCCCACT,0,1837668
hyuA_predicted,0.16666666666666666,5,5,CTCATTACGCGAGTTGCCAC,0,1849633
hyuA_predicted,0.16666666666666666,5,5,CTCAGGTCGTTTTCACCTGT,0,1856571
hyuA_predicted,0.16666666666666666,5,5,CTCACTACGTTCGCAGGAAT,0,1864968
hyuA_predicted,0.16666666666666666,5,5,CTCAATTCGTTTATACCATT,0,1849109
hyuA_predicted,0.16666666666666666,5,5,CTCAAGGACCATGACGAGGG,0,1831545
hyuA_predicted,0.16666666666666666,5,5,CTATCTAAGGTCTGAGGATC,0,1834813
hyuA_predicted,0.16666666666666666,5,5,CTATCGCGCTGGGCGCATAC,0,1868130
hyuA_predicted,0.16666666666666666,5,5,CTATACAGTTGTCGGGCCAT,0,1864381
hyuA_predicted,0.16666666666666666,5,5,CTATAAGGAGATCTTACTTC,0,1857841
hyuA_predicted,0.16666666666666666,5,5,CTAGGCGACCGGTAACCTAA,0,1856439
hyuA_predicted,0.16666666666666666,5,5,CTAGGCACAGTAGAGTGCAA,0,1850548
hyuA_predicted,0.16666666666666666,5,5,CTAGGAGTTCATGGTACCTG,0,1870259
hyuA_predicted,0.16666666666666666,5,5,CTAGGAATAAGCTAAGCACA,0,1854712
hyuA_predicted,0.16666666666666666,5,5,CTAGGAACCACAGCGTGGAA,0,1832434
hyuA_predicted,0.16666666666666666,5,5,CTAGCAAACGAATTCCCGTT,0,1845430
hyuA_predicted,0.16666666666666666,5,5,CTAGACCCCTACAGCCCGCC,0,1859579
hyuA_predicted,0.16666666666666666,5,5,CTACTTGAATGGCAAGGCTA,0,1873536
hyuA_predicted,0.16666666666666666,5,5,CTACGCGTGCCATGCGTATC,0,1843359
hyuA_predicted,0.16666666666666666,5,5,CTACACCAAAGCGTATTTAT,0,1866592
hyuA_predicted,0.16666666666666666,5,5,CTAATATTTAGGCGATATTC,0,1865083
hyuA_predicted,0.16666666666666666,5,5,CTAACCGACGTGCTTCAATC,0,1877187
hyuA_predicted,0.16666666666666666,5,5,CTAAATCTTGCGTTATCCAG,0,1864516
hyuA_predicted,0.16666666666666666,5,5,CGTTTAACACTTGACGTATG,0,1850073
hyuA_predicted,0.16666666666666666,5,5,CGTTGTCATCCCCTCGAGTA,0,1845329
hyuA_predicted,0.16666666666666666,5,5,CGTTCAGGGGATAATGGACG,0,1864432
hyuA_predicted,0.16666666666666666,5,5,CGTGCTTACTTAGGGACCCG,0,1850423
hyuA_predicted,0.16666666666666666,5,5,CGTCTCTACCTAAGAACATC,0,1873087
hyuA_predicted,0.16666666666666666,5,5,CGTCGCCACATTAGGGGGAG,0,1862811
hyuA_predicted,0.16666666666666666,5,5,CGTCCGCTCATCGACCGGTC,0,1870854
hyuA_predicted,0.16666666666666666,5,5,CGTCAAAGTATCGGCATTGG,0,1868346
hyuA_predicted,0.16666666666666666,5,5,CGGTATATATTGATCCTGCC,0,1844352
hyuA_predicted,0.16666666666666666,5,5,CGGGTGTTACCAGCTCATGA,0,1849764
hyuA_predicted,0.16666666666666666,5,5,CGGGCCCTCTGTCAACATGT,0,1855157
hyuA_predicted,0.16666666666666666,5,5,CGGGACCTCACAAAAATAGC,0,1843456
hyuA_predicted,0.16666666666666666,5,5,CGGCTACCTTATAATATGGA,0,1848539
hyuA_predicted,0.16666666666666666,5,5,CGGCGCAGCATAAAGATAGC,0,1856225
hyuA_predicted,0.16666666666666666,5,5,CGGCCTGTTACGGAATATAT,0,1874827
hyuA_predicted,0.16666666666666666,5,5,CGGCATTTCGGCAGGAGTAC,0,1838674
hyuA_predicted,0.16666666666666666,5,5,CGGATGCGACACCTCGCTAT,0,1851831
hyuA_predicted,0.16666666666666666,5,5,CGGACGCCTGTCATCTTTCG,0,1865660
hyuA_predicted,0.16666666666666666,5,5,CGGACACTGTCGATAAAGTA,0,1843986
hyuA_predicted,0.16666666666666666,5,5,CGCTTTATCAGATTCTGCAA,0,1832193
hyuA_predicted,0.16666666666666666,5,5,CGCTCAAGTAGAGGAACAGA,0,1838602
hyuA_predicted,0.16666666666666666,5,5,CGCGTAGTAGCGAATCTCGG,0,1837765
hyuA_predicted,0.16666666666666666,5,5,CGCGGCAGCGACTTCTGTAC,0,1831238
hyuA_predicted,0.16666666666666666,5,5,CGCGGAAATTCGAGATCGTG,0,1837771
hyuA_predicted,0.16666666666666666,5,5,CGCGCGTATACTGGCTATAG,0,1849801
hyuA_predicted,0.16666666666666666,5,5,CGCCTAACCGCCATCATTCG,0,1872604
hyuA_predicted,0.16666666666666666,5,5,CGCCGAAAAACATCTCGGTC,0,1846199
hyuA_predicted,0.16666666666666666,5,5,CGCCCCGTAGCTCACGGATA,0,1867920
hyuA_predicted,0.16666666666666666,5,5,CGCCACGTACTGCTACTCCC,0,1841469
hyuA_predicted,0.16666666666666666,5,5,CGCAAGCAGAGCAGCCTCCG,0,1854610
hyuA_predicted,0.16666666666666666,5,5,CGATCGACAAATTCTACTTT,0,1869822
hyuA_predicted,0.16666666666666666,5,5,CGATAGATGCACTCAGCGCA,0,1842423
hyuA_predicted,0.16666666666666666,5,5,CGAGGCATTTTCCCTTCATT,0,1857511
hyuA_predicted,0.16666666666666666,5,5,CGAGCGGCACGCACCCCTCC,0,1841423
hyuA_predicted,0.16666666666666666,5,5,CGAGACTCTCGTTTTCATAC,0,1829922
hyuA_predicted,0.16666666666666666,5,5,CGAGAACCGAGCTATCTATT,0,1873092
hyuA_predicted,0.16666666666666666,5,5,CGAGAACATGTGCAGTATCG,0,1842569
hyuA_predicted,0.16666666666666666,5,5,CGACGTGACCCGATGGCCTC,0,1877467
hyuA_predicted,0.16666666666666666,5,5,CGACGTCGGCAGAATTTTAG,0,1877702
hyuA_predicted,0.16666666666666666,5,5,CGACAGAAAGGGGTCACTAG,0,1866418
hyuA_predicted,0.16666666666666666,5,5,CGACACGTACCCGAAAAACA,0,1870482
hyuA_predicted,0.16666666666666666,5,5,CGAATTAGCCAAAATGTGGC,0,1864425
hyuA_predicted,0.16666666666666666,5,5,CGAACTCTCCTTGATGACTC,0,1866690
hyuA_predicted,0.16666666666666666,5,5,CGAACAACGTTGTTCAAACT,0,1873006
hyuA_predicted,0.16666666666666666,5,5,CGAAAGCAACTGCTGTGGAG,0,1856096
hyuA_predicted,0.16666666666666666,5,5,CGAAACTCTTGTTAGACTGC,0,1849545
hyuA_predicted,0.16666666666666666,5,5,CGAAACGTCCCGCTACGATA,0,1844695
hyuA_predicted,0.16666666666666666,5,5,CCTTGGAATTCTTTCCGTTT,0,1829281
hyuA_predicted,0.16666666666666666,5,5,CCTTGCATACACTATCACCA,0,1851051
hyuA_predicted,0.16666666666666666,5,5,CCTTAATTGATTTATTACAA,0,1865515
hyuA_predicted,0.16666666666666666,5,5,CCTGACTACAGTGTATAAGG,0,1858433
hyuA_predicted,0.16666666666666666,5,5,CCTCTGGTTCCAGGAATGGA,0,1874379
hyuA_predicted,0.16666666666666666,5,5,CCTCTATATAACGTTTGGGG,0,1838577
hyuA_predicted,0.16666666666666666,5,5,CCTCAAGCGTACTTGCCCAG,0,1849627
hyuA_predicted,0.16666666666666666,5,5,CCTATCGAGAATCTGACTCT,0,1865178
hyuA_predicted,0.16666666666666666,5,5,CCTACAACGTAAAAACCCTA,0,1866532
hyuA_predicted,0.16666666666666666,5,5,CCGTTCGTTTGGCGGGTAGC,0,1847208
hyuA_predicted,0.16666666666666666,5,5,CCGTGGGGTTTACGCTCGAT,0,1833147
hyuA_predicted,0.16666666666666666,5,5,CCGGAAACGTGCACACTGTT,0,1830490
hyuA_predicted,0.16666666666666666,5,5,CCGCTCCTCAGTAGAGGGCT,0,1863215
hyuA_predicted,0.16666666666666666,5,5,CCGCTATGGACCAAGGATAG,0,1834854
hyuA_predicted,0.16666666666666666,5,5,CCGCGAACCCAACCATGGTT,0,1839463
hyuA_predicted,0.16666666666666666,5,5,CCGCCTATATCCGCACGAAT,0,1852580
hyuA_predicted,0.16666666666666666,5,5,CCGCCGGCCCAGAAGGGTAA,0,1875319
hyuA_predicted,0.16666666666666666,5,5,CCCTTGAGCGCCACTTTTAT,0,1862630
hyuA_predicted,0.16666666666666666,5,5,CCCTGACTAATGCTCTTTAA,0,1868559
hyuA_predicted,0.16666666666666666,5,5,CCCGTACGACTACCGCCGCC,0,1831400
hyuA_predicted,0.16666666666666666,5,5,CCCGGCACGGTTATTGTACC,0,1838887
hyuA_predicted,0.16666666666666666,5,5,CCCGCACTATTGACGTTCAA,0,1873224
hyuA_predicted,0.16666666666666666,5,5,CCCATCAGCTGAGTATGTGA,0,1846926
hyuA_predicted,0.16666666666666666,5,5,CCCACATGTTAGTGATTCCA,0,1848247
hyuA_predicted,0.16666666666666666,5,5,CCATGTTGTTTGATCTCGTG,0,1853924
hyuA_predicted,0.16666666666666666,5,5,CCATGCTCCGGTATACCCAT,0,1835053
hyuA_predicted,0.16666666666666666,5,5,CCATCTTACGAAGACTTCTA,0,1832525
hyuA_predicted,0.16666666666666666,5,5,CCATCCTAGAACACTAGAGC,0,1832580
hyuA_predicted,0.16666666666666666,5,5,CCACTTATAGGCGAGTGAGT,0,1873435
hyuA_predicted,0.16666666666666666,5,5,CCACAGGATGTAACCGGTTC,0,1832203
hyuA_predicted,0.16666666666666666,5,5,CCACAGATGTAACTGTTTCT,0,1859823
hyuA_predicted,0.16666666666666666,5,5,CCAATTAACCGATCTGTTTT,0,1840087
hyuA_predicted,0.16666666666666666,5,5,CCAAGGCGGTATTCGTAAAG,0,1835108
hyuA_predicted,0.16666666666666666,5,5,CCAACGCCATTCCCTCGTAG,0,1869996
hyuA_predicted,0.16666666666666666,5,5,CCAAAGCGACTGAGTGCTAT,0,1851530
hyuA_predicted,0.16666666666666666,5,5,CATGTAGGACGCGTTGGGGG,0,1845759
hyuA_predicted,0.16666666666666666,5,5,CATGAGGCGCGCTTCGCAGA,0,1841379
hyuA_predicted,0.16666666666666666,5,5,CATGACCCTTCCGGACTGAT,0,1863971
hyuA_predicted,0.16666666666666666,5,5,CATCTTCTGCTAATAACCGC,0,1848367
hyuA_predicted,0.16666666666666666,5,5,CATCGCGCGATGTGTAACGT,0,1864034
hyuA_predicted,0.16666666666666666,5,5,CATATTGTACTACACTGCCG,0,1839945
hyuA_predicted,0.16666666666666666,5,5,CATAGATGTATTCTCAGGTA,0,1864165
hyuA_predicted,0.16666666666666666,5,5,CATACCTGCCTTCTGGGTCC,0,1839735
hyuA_predicted,0.16666666666666666,5,5,CATACCGGTTTTAATCCAGA,0,1842968
hyuA_predicted,0.16666666666666666,5,5,CATAATCCCTGCATCATCTG,0,1829186
hyuA_predicted,0.16666666666666666,5,5,CATAACCCTTTATCTGCGAG,0,1842292
hyuA_predicted,0.16666666666666666,5,5,CAGTTAGGCAGAGAGTCGAT,0,1860413
hyuA_predicted,0.16666666666666666,5,5,CAGTTAACCGTTATTGGGGA,0,1840919
hyuA_predicted,0.16666666666666666,5,5,CAGGAACAAAATGTATACGG,0,1856908
hyuA_predicted,0.16666666666666666,5,5,CAGCGCTGAATCAGAGGACG,0,1844172
hyuA_predicted,0.16666666666666666,5,5,CAGCCCGCCACACGTGCCCG,0,1831987
hyuA_predicted,0.16666666666666666,5,5,CAGCATGCAATGTCTCGGCA,0,1838761
hyuA_predicted,0.16666666666666666,5,5,CAGAGTGGGACCTTATCCAA,0,1837870
hyuA_predicted,0.16666666666666666,5,5,CAGACCTCAAGTGTTTGAAA,0,1869541
hyuA_predicted,0.16666666666666666,5,5,CACTGGAACATCCAGTTGGG,0,1842965
hyuA_predicted,0.16666666666666666,5,5,CACTGACCAGGTCAGACAAT,0,1842275
hyuA_predicted,0.16666666666666666,5,5,CACGTCGGCCTGCCGTACCT,0,1852040
hyuA_predicted,0.16666666666666666,5,5,CACGTATATCAACAACGAAC,0,1856861
hyuA_predicted,0.16666666666666666,5,5,CACGAGGCCTTGCTGGTACT,0,1841174
hyuA_predicted,0.16666666666666666,5,5,CACGACGCGGGTCAGAGTAT,0,1851017
hyuA_predicted,0.16666666666666666,5,5,CACCTATATAAAGTACTTAG,0,1853723
hyuA_predicted,0.16666666666666666,5,5,CACATGGGCTCCTGGTGGCG,0,1834796
hyuA_predicted,0.16666666666666666,5,5,CACATCTAGGCCACCATCTC,0,1868122
hyuA_predicted,0.16666666666666666,5,5,CACACTTCGTATACAGCAGT,0,1873437
hyuA_predicted,0.16666666666666666,5,5,CACACTCCTCGATCAGGATC,0,1853433
hyuA_predicted,0.16666666666666666,5,5,CACAAGCTGAGTAGCTTTGA,0,1872943
hyuA_predicted,0.16666666666666666,5,5,CACAAGCGGGTCTTCGTGTG,0,1836514
hyuA_predicted,0.16666666666666666,5,5,CAATTGTAAGTTTTTTGGAT,0,1867226
hyuA_predicted,0.16666666666666666,5,5,CAATCCTTTATTGCTCACCA,0,1832141
hyuA_predicted,0.16666666666666666,5,5,CAATATTTGGCGTTAGCCAT,0,1829772
hyuA_predicted,0.16666666666666666,5,5,CAAGGGCTAGTTCTAACTTC,0,1847075
hyuA_predicted,0.16666666666666666,5,5,CAAGCCTACTCACCACAACC,0,1849013
hyuA_predicted,0.16666666666666666,5,5,CAACGGTGTGAAAGAAATAG,0,1835359
hyuA_predicted,0.16666666666666666,5,5,CAACCGGGGATGGCGCTAAG,0,1839611
hyuA_predicted,0.16666666666666666,5,5,CAAATTACAATAACGAGGAG,0,1829774
hyuA_predicted,0.16666666666666666,5,5,CAAATGTTTGACACATCGAG,0,1860212
hyuA_predicted,0.16666666666666666,5,5,CAAATACTGAGGCCGGGAAA,0,1843253
hyuA_predicted,0.16666666666666666,5,5,CAAATAAAGAGCTCGGCACC,0,1868335
hyuA_predicted,0.16666666666666666,5,5,CAAAATTAGCACAAGGCCCA,0,1832110
hyuA_predicted,0.16666666666666666,5,5,ATTTGGTGCATGCTTGAGTG,0,1846761
hyuA_predicted,0.16666666666666666,5,5,ATTTGGTATAGGACTTAAGT,0,1868111
hyuA_predicted,0.16666666666666666,5,5,ATTTGCTATATAGATTCAAC,0,1838331
hyuA_predicted,0.16666666666666666,5,5,ATTTGACTACCTTATTACAG,0,1869139
hyuA_predicted,0.16666666666666666,5,5,ATTGGCCTAATCAATAGGTT,0,1843715
hyuA_predicted,0.16666666666666666,5,5,ATTGCGGACTACGCCCGCGG,0,1854393
hyuA_predicted,0.16666666666666666,5,5,ATTGATTATGCAGGACGCGT,0,1852641
hyuA_predicted,0.16666666666666666,5,5,ATTCGGCAGTCTCGTGCGCT,0,1871909
hyuA_predicted,0.16666666666666666,5,5,ATTCCTTCTTCCCAGCGCTC,0,1833594
hyuA_predicted,0.16666666666666666,5,5,ATTCCCGCTTGCGCCCCATC,0,1870334
hyuA_predicted,0.16666666666666666,5,5,ATTCAATAAATTGAGACAAG,0,1836403
hyuA_predicted,0.16666666666666666,5,5,ATTATACCGCGACCGGAGGT,0,1874933
hyuA_predicted,0.16666666666666666,5,5,ATTAGACCATGCACATCTAG,0,1844598
hyuA_predicted,0.16666666666666666,5,5,ATTAACGAGTTAGGGGCGGT,0,1838057
hyuA_predicted,0.16666666666666666,5,5,ATTAACCTTAGTTTGGATTT,0,1869882
hyuA_predicted,0.16666666666666666,5,5,ATTAAAGGACGCCGGCTTCT,0,1863683
hyuA_predicted,0.16666666666666666,5,5,ATGTGGTGCTCTAAAAATCA,0,1844448
hyuA_predicted,0.16666666666666666,5,5,ATGTATCTTACTGAGCGCCC,0,1837364
hyuA_predicted,0.16666666666666666,5,5,ATGGTTAATAACGGTGCCGG,0,1864022
hyuA_predicted,0.16666666666666666,5,5,ATGGTGGTTAAGGACCTTCT,0,1856021
hyuA_predicted,0.16666666666666666,5,5,ATGGGGGGGCTACAGGCCGA,0,1877572
hyuA_predicted,0.16666666666666666,5,5,ATGGCGTTCTTTGGTTGAAT,0,1864112
hyuA_predicted,0.16666666666666666,5,5,ATGGCGAGCCCCGTGAAGAG,0,1849362
hyuA_predicted,0.16666666666666666,5,5,ATGGATTGAATATGGCCGGG,0,1828914
hyuA_predicted,0.16666666666666666,5,5,ATGGACAACTAACCTGACTC,0,1863457
hyuA_predicted,0.16666666666666666,5,5,ATGCGGAGCTAGCCTGAAAG,0,1847121
hyuA_predicted,0.16666666666666666,5,5,ATGCAGCTACGGACGTTGCA,0,1855216
hyuA_predicted,0.16666666666666666,5,5,ATGATGGTCAGTCTTTGCAT,0,1868210
hyuA_predicted,0.16666666666666666,5,5,ATGATCCGATTCTTTACTAG,0,1843971
hyuA_predicted,0.16666666666666666,5,5,ATGACGATTAGTTCAGGGAG,0,1855352
hyuA_predicted,0.16666666666666666,5,5,ATGACCTACGTGTACAGGTT,0,1841470
hyuA_predicted,0.16666666666666666,5,5,ATCTGACGCCGTATACGATA,0,1866274
hyuA_predicted,0.16666666666666666,5,5,ATCTCGGACGTAGTGCCTTG,0,1855644
hyuA_predicted,0.16666666666666666,5,5,ATCTCCGTCCTTTTCCGCGT,0,1864941
hyuA_predicted,0.16666666666666666,5,5,ATCTAGTTGACTATTGATAA,0,1857349
hyuA_predicted,0.16666666666666666,5,5,ATCGGTTGAAGGTAAGCATA,0,1834828
hyuA_predicted,0.16666666666666666,5,5,ATCGCTTGAGAACATCACTC,0,1870476
hyuA_predicted,0.16666666666666666,5,5,ATCCTTGACTTGGCGTTTCA,0,1872779
hyuA_predicted,0.16666666666666666,5,5,ATCCTGCGAAAGTACGTCCA,0,1853425
hyuA_predicted,0.16666666666666666,5,5,ATCCGTCTATAGGGCTGATT,0,1867424
hyuA_predicted,0.16666666666666666,5,5,ATCCGGTGCAACGAATCCCA,0,1843659
hyuA_predicted,0.16666666666666666,5,5,ATCATTGGTCCCATAGCGCA,0,1869505
hyuA_predicted,0.16666666666666666,5,5,ATCATGGGCCGTCTATATGG,0,1854936
hyuA_predicted,0.16666666666666666,5,5,ATCATCAGCGACAGGCACCC,0,1867516
hyuA_predicted,0.16666666666666666,5,5,ATCAGTTCTCGGAGGCTCTT,0,1850305
hyuA_predicted,0.16666666666666666,5,5,ATCAGGGTGAGATACCAAAG,0,1851689
hyuA_predicted,0.16666666666666666,5,5,ATATGCCCAAAGTAACAAGG,0,1857989
hyuA_predicted,0.16666666666666666,5,5,ATATACGTGCTTAGAGTACT,0,1875711
hyuA_predicted,0.16666666666666666,5,5,ATATAAGCCGCGACCAACGG,0,1862171
hyuA_predicted,0.16666666666666666,5,5,ATATAACTGGAGAGGCTATG,0,1867564
hyuA_predicted,0.16666666666666666,5,5,ATATAAATATCTCTCTGTTA,0,1856552
hyuA_predicted,0.16666666666666666,5,5,ATAGTAAGAGTGAGTGAGAC,0,1875004
hyuA_predicted,0.16666666666666666,5,5,ATAGGTCACAACGCGCGCCT,0,1876676
hyuA_predicted,0.16666666666666666,5,5,ATAGGCTTGGTTGTGGTATT,0,1861968
hyuA_predicted,0.16666666666666666,5,5,ATAGGCCTTATAGCGAGTCT,0,1853077
hyuA_predicted,0.16666666666666666,5,5,ATAGACATCAGTAAGCCAGC,0,1875690
hyuA_predicted,0.16666666666666666,5,5,ATAGAAAGGTCCCGTATTGC,0,1831117
hyuA_predicted,0.16666666666666666,5,5,ATACCGAAGTTTGAATGAAG,0,1841911
hyuA_predicted,0.16666666666666666,5,5,ATAATAGTGCGGAGATGAAG,0,1857404
hyuA_predicted,0.16666666666666666,5,5,ATAAGTTTTTGGCCTAGATG,0,1837548
hyuA_predicted,0.16666666666666666,5,5,ATAACAGCAAGGCTCGTTCG,0,1856893
hyuA_predicted,0.16666666666666666,5,5,ATAACACGCATGGTGTAGAG,0,1850574
hyuA_predicted,0.16666666666666666,5,5,AGTGCCCTCAGCGATTGACA,0,1831152
hyuA_predicted,0.16666666666666666,5,5,AGTCGTGGAAACTTGGGACG,0,1854964
hyuA_predicted,0.16666666666666666,5,5,AGTCGGGTCAGATTCGGCGA,0,1833646
hyuA_predicted,0.16666666666666666,5,5,AGTCATCTAGTGAGATTGAC,0,1829046
hyuA_predicted,0.16666666666666666,5,5,AGTACGTTTCGAGATTTAGT,0,1873916
hyuA_predicted,0.16666666666666666,5,5,AGTACATTGCGATTTGAAAG,0,1842668
hyuA_predicted,0.16666666666666666,5,5,AGGTGATACGGGGCGCGAGC,0,1860058
hyuA_predicted,0.16666666666666666,5,5,AGGTCTAGACGGGACACGGC,0,1874275
hyuA_predicted,0.16666666666666666,5,5,AGGTCGCCCGCACTATACCC,0,1830109
hyuA_predicted,0.16666666666666666,5,5,AGGTCCATGCGAAGGAGCTA,0,1858295
hyuA_predicted,0.16666666666666666,5,5,AGGTCAAATGGATTCGGTGG,0,1846403
hyuA_predicted,0.16666666666666666,5,5,AGGTAGTGTTCATTCGTGTG,0,1830924
hyuA_predicted,0.16666666666666666,5,5,AGGTAGTCTTAAACGGCTGG,0,1851732
hyuA_predicted,0.16666666666666666,5,5,AGGGTACGGGGAAGTTACGA,0,1864786
hyuA_predicted,0.16666666666666666,5,5,AGGGGCGAAAGCTCTACCAA,0,1848213
hyuA_predicted,0.16666666666666666,5,5,AGGCTTGTGATTAACCAGAA,0,1832373
hyuA_predicted,0.16666666666666666,5,5,AGGCTTCCTTGAGATGCGTC,0,1860092
hyuA_predicted,0.16666666666666666,5,5,AGGCTGAGCTTCGGCATCAA,0,1874978
hyuA_predicted,0.16666666666666666,5,5,AGGCGGGGATGGCCGAATTT,0,1838671
hyuA_predicted,0.16666666666666666,5,5,AGGCGAATGCTAGGCGGTCA,0,1866700
hyuA_predicted,0.16666666666666666,5,5,AGGCAGCGAGAGCTCAAGTC,0,1874900
hyuA_predicted,0.16666666666666666,5,5,AGGCACTCCGTTATCCGGTT,0,1846476
hyuA_predicted,0.16666666666666666,5,5,AGGCACACCAAAAGTTCTGT,0,1847285
hyuA_predicted,0.16666666666666666,5,5,AGGATGTGGTTATGGGGAGA,0,1862359
hyuA_predicted,0.16666666666666666,5,5,AGGAGTAGTGGGTGTCCGAA,0,1858837
hyuA_predicted,0.16666666666666666,5,5,AGGACTATTGTGCCCGTGCC,0,1851690
hyuA_predicted,0.16666666666666666,5,5,AGGACGCGGTATGCGAGGCA,0,1869060
hyuA_predicted,0.16666666666666666,5,5,AGCTTAAATCTGTGAGTCAT,0,1833559
hyuA_predicted,0.16666666666666666,5,5,AGCTCGATGAAGGAATCGAA,0,1831265
hyuA_predicted,0.16666666666666666,5,5,AGCGGTAGGGCTTTGGTAAT,0,1877599
hyuA_predicted,0.16666666666666666,5,5,AGCGCTTTTTCGAGTTGGCT,0,1843807
hyuA_predicted,0.16666666666666666,5,5,AGCGCGGCACAAGGGCTGGT,0,1867002
hyuA_predicted,0.16666666666666666,5,5,AGCGAAGGGGAGCTCCGTAT,0,1840710
hyuA_predicted,0.16666666666666666,5,5,AGCCGACACGTGCCTATTTG,0,1837432
hyuA_predicted,0.16666666666666666,5,5,AGCATCATCAACGTTTGCCA,0,1877632
hyuA_predicted,0.16666666666666666,5,5,AGCACCCCAGGATTCGCGTG,0,1870374
hyuA_predicted,0.16666666666666666,5,5,AGCACCATAACCTCTGATGT,0,1837479
hyuA_predicted,0.16666666666666666,5,5,AGCACCAATGCACTTAGCAG,0,1876290
hyuA_predicted,0.16666666666666666,5,5,AGATAATGATGTTTGGGCGG,0,1876540
hyuA_predicted,0.16666666666666666,5,5,AGAGGGGTGTTTTACCCAGC,0,1834839
hyuA_predicted,0.16666666666666666,5,5,AGAGATAGTTCCCCTTGACT,0,1852765
hyuA_predicted,0.16666666666666666,5,5,AGAGAAGTTGCGGAGGTTAG,0,1870041
hyuA_predicted,0.16666666666666666,5,5,AGAGAAACGGGATAGGGTGC,0,1853129
hyuA_predicted,0.16666666666666666,5,5,AGACTGTATAGACGGTCGCC,0,1835471
hyuA_predicted,0.16666666666666666,5,5,AGACCCTGTGCACCACCTCT,0,1854184
hyuA_predicted,0.16666666666666666,5,5,AGACAATGTAGAAGGTCACT,0,1839732
hyuA_predicted,0.16666666666666666,5,5,AGAAGCCACTCCCGATCTAT,0,1865203
hyuA_predicted,0.16666666666666666,5,5,AGAACCTTGACTCGCATCGC,0,1832696
hyuA_predicted,0.16666666666666666,5,5,ACTTTTGGTCTAAAAGAGGA,0,1862408
hyuA_predicted,0.16666666666666666,5,5,ACTTTCGCGAATTGCCTGGA,0,1865923
hyuA_predicted,0.16666666666666666,5,5,ACTTTATTGGGATATTCGTT,0,1871594
hyuA_predicted,0.16666666666666666,5,5,ACTTCTTCTGCCATAGGCTG,0,1876806
hyuA_predicted,0.16666666666666666,5,5,ACTGTCCCATCGAAACTCAT,0,1861530
hyuA_predicted,0.16666666666666666,5,5,ACTGGCCTTCTTAACGATAA,0,1867471
hyuA_predicted,0.16666666666666666,5,5,ACTGCGTAAGGAACAATGGA,0,1852678
hyuA_predicted,0.16666666666666666,5,5,ACTGCCGCATGCAGAACAAC,0,1851859
hyuA_predicted,0.16666666666666666,5,5,ACTCTCAAGGCACGAAATTT,0,1844324
hyuA_predicted,0.16666666666666666,5,5,ACTCAGGAAAAATGGTAATT,0,1839683
hyuA_predicted,0.16666666666666666,5,5,ACTATCAGCTCGCGGCTCTA,0,1875557
hyuA_predicted,0.16666666666666666,5,5,ACTACCGGGATCATCGGTAC,0,1829283
hyuA_predicted,0.16666666666666666,5,5,ACTAAAGACATATTACACGT,0,1844177
hyuA_predicted,0.16666666666666666,5,5,ACGTTCGCGGGACTAGACTA,0,1833750
hyuA_predicted,0.16666666666666666,5,5,ACGTCTTAGGAATGGGTTTG,0,1835941
hyuA_predicted,0.16666666666666666,5,5,ACGGATTAGTTAAGGACTTA,0,1857300
hyuA_predicted,0.16666666666666666,5,5,ACGCGGTAGTCCCACCCGCA,0,1832388
hyuA_predicted,0.16666666666666666,5,5,ACGCGCGTATGCTGGAACCA,0,1833286
hyuA_predicted,0.16666666666666666,5,5,ACGCGCGGCTTCCCCTCGAA,0,1869520
hyuA_predicted,0.16666666666666666,5,5,ACGCCGAATCATCAGGTTCA,0,1862794
hyuA_predicted,0.16666666666666666,5,5,ACGATGGGCCGTTCCCGACA,0,1835002
hyuA_predicted,0.16666666666666666,5,5,ACGATATCGGACATTAATGT,0,1837209
hyuA_predicted,0.16666666666666666,5,5,ACGATACGTCCAGGACAGTG,0,1863255
hyuA_predicted,0.16666666666666666,5,5,ACGAATACGATGATTTCCAC,0,1864104
hyuA_predicted,0.16666666666666666,5,5,ACCTTTACATAGAAAGTTCA,0,1840623
hyuA_predicted,0.16666666666666666,5,5,ACCTGTGACTCCATGCCTTC,0,1863837
hyuA_predicted,0.16666666666666666,5,5,ACCGGCAGGGGCGCCCTCTA,0,1856565
hyuA_predicted,0.16666666666666666,5,5,ACCGGCACTTTCAGGACGTG,0,1842180
hyuA_predicted,0.16666666666666666,5,5,ACCCTCGCCATGGTCAGATA,0,1872600
hyuA_predicted,0.16666666666666666,5,5,ACCCGTAGAGCCTAGTCGGC,0,1846058
hyuA_predicted,0.16666666666666666,5,5,ACCCGGTATCGTGCAGCGTT,0,1831237
hyuA_predicted,0.16666666666666666,5,5,ACCCGAAAAGGCTCGCGAGA,0,1844804
hyuA_predicted,0.16666666666666666,5,5,ACATGCGCGCCGTCTGGTGA,0,1833799
hyuA_predicted,0.16666666666666666,5,5,ACATGAGCCGATTTCGCCGC,0,1870721
hyuA_predicted,0.16666666666666666,5,5,ACATCTTCCTTCCACTGCTC,0,1859757
hyuA_predicted,0.16666666666666666,5,5,ACATCAGGAAAGGGTTTCAG,0,1850881
hyuA_predicted,0.16666666666666666,5,5,ACATCACATGCTTGAACGCG,0,1845428
hyuA_predicted,0.16666666666666666,5,5,ACAGTCTGTACCTCATATAA,0,1839731
hyuA_predicted,0.16666666666666666,5,5,ACAGCTGAATCTCACAAGAA,0,1836434
hyuA_predicted,0.16666666666666666,5,5,ACAGATTGATTAAAAGACTA,0,1868059
hyuA_predicted,0.16666666666666666,5,5,ACAGATCGAGGCTAGCCTGG,0,1848282
hyuA_predicted,0.16666666666666666,5,5,ACAATTTTCCTATGTTGGTA,0,1837212
hyuA_predicted,0.16666666666666666,5,5,ACAATCGTGAAGCGGGATGT,0,1833654
hyuA_predicted,0.16666666666666666,5,5,ACAAGTCAACCATGTATCGA,0,1874589
hyuA_predicted,0.16666666666666666,5,5,AATTTATGTGAGGGTACACT,0,1844183
hyuA_predicted,0.16666666666666666,5,5,AATTCGTAATCAAAACCGGT,0,1860127
hyuA_predicted,0.16666666666666666,5,5,AATTCGGACCCGGTAGCTTT,0,1873979
hyuA_predicted,0.16666666666666666,5,5,AATGTAACAATCGGTCCGTG,0,1837780
hyuA_predicted,0.16666666666666666,5,5,AATGGGACGTATTAACGTAG,0,1852044
hyuA_predicted,0.16666666666666666,5,5,AATGGCCGTCGCCTCAGTGC,0,1844089
hyuA_predicted,0.16666666666666666,5,5,AATGCTTTCTGGTTGTATGA,0,1838186
hyuA_predicted,0.16666666666666666,5,5,AATGCTCAAGGGTAGACGTC,0,1830093
hyuA_predicted,0.16666666666666666,5,5,AATCATGGGCCACGCCGGAA,0,1869914
hyuA_predicted,0.16666666666666666,5,5,AATCATGCCTATCAGAGGGG,0,1860602
hyuA_predicted,0.16666666666666666,5,5,AATCAAAAACTCTGTTCCAC,0,1843868
hyuA_predicted,0.16666666666666666,5,5,AATACCTGTATTCGACCAGG,0,1845497
hyuA_predicted,0.16666666666666666,5,5,AAGCGAGCAAAATACAAGTG,0,1870510
hyuA_predicted,0.16666666666666666,5,5,AAGCAGAATCATGCATCAAT,0,1846996
hyuA_predicted,0.16666666666666666,5,5,AAGACTTGGCTCCGTATGAT,0,1854263
hyuA_predicted,0.16666666666666666,5,5,AAGAAATGTTAGCCCTTCAG,0,1870207
hyuA_predicted,0.16666666666666666,5,5,AACTTGCAATTACATCAAAT,0,1837896
hyuA_predicted,0.16666666666666666,5,5,AACTTCCCGGAATTAACCGC,0,1837728
hyuA_predicted,0.16666666666666666,5,5,AACTAGGTCAACCAGTGCAT,0,1854257
hyuA_predicted,0.16666666666666666,5,5,AACGGATATGAGGGTGGTAA,0,1875191
hyuA_predicted,0.16666666666666666,5,5,AACGCTTAAGTGTGTCCGGT,0,1864101
hyuA_predicted,0.16666666666666666,5,5,AACCGGTATGCTATCGTAAG,0,1849112
hyuA_predicted,0.16666666666666666,5,5,AACCATCGGCGTCTTAATGA,0,1850151
hyuA_predicted,0.16666666666666666,5,5,AACAGCAAAGAAGACGAGAC,0,1867480
hyuA_predicted,0.16666666666666666,5,5,AAATTTGGTTCCACTCTTGA,0,1862860
hyuA_predicted,0.16666666666666666,5,5,AAATTTCACGAACGAGTCCA,0,1865951
hyuA_predicted,0.16666666666666666,5,5,AAATTGACGTAACTATGTGA,0,1830017
hyuA_predicted,0.16666666666666666,5,5,AAATGCCCAGTGGTTGTTGC,0,1835531
hyuA_predicted,0.16666666666666666,5,5,AAAGTCCCCCGCCCACGGAA,0,1846981
hyuA_predicted,0.16666666666666666,5,5,AAACTGGACCCTAGCTGGAC,0,1855601
hyuA_predicted,0.16666666666666666,5,5,AAAATTGCGACAACGAGTGG,0,1846644
hyuA_predicted,0.16666666666666666,5,5,AAAATGGTGCTCACCTGCCG,0,1859885
hyuA_predicted,0.16666666666666666,5,5,AAAATCAGCCCTCCTCCCAC,0,1860302
hyuA_predicted,0.16666666666666666,5,5,AAAAGTATTTACCCGGCACT,0,1861348
hyuA_predicted,0.16666666666666666,5,5,AAAACCCTCAGGGAAGGTGT,0,1842316
hyuA_predicted,0.2,4,4,TTTGTAATATCGATCATCTT,0,1845685
hyuA_predicted,0.2,4,4,TTTGAGTAAAGCAACTTGTA,0,1839493
hyuA_predicted,0.2,4,4,TTTCATATCGTGAGTAGTTC,0,1863834
hyuA_predicted,0.2,4,4,TTTACTGGTCCAGGTCGGAC,0,1867639
hyuA_predicted,0.2,4,4,TTGTGTTGGCTGTCAAAGGC,0,1851228
hyuA_predicted,0.2,4,4,TTGTGTGCTCTTTTGCCAAA,0,1856516
hyuA_predicted,0.2,4,4,TTGTATGCCATAGCTTCGTG,0,1873928
hyuA_predicted,0.2,4,4,TTGGGACCCTATCGCCGTCT,0,1859391
hyuA_predicted,0.2,4,4,TTGGAGGCTCTACGCTTTTA,0,1835769
hyuA_predicted,0.2,4,4,TTGCTTACACATTCACCGGT,0,1831147
hyuA_predicted,0.2,4,4,TTGCTGCGGGAAAACAAGCC,0,1839233
hyuA_predicted,0.2,4,4,TTGCCTCCAATATAGTACAA,0,1870288
hyuA_predicted,0.2,4,4,TTGCCATTTGAGAAGGCAAC,0,1871751
hyuA_predicted,0.2,4,4,TTGCAGTAGGTTGGGAGATA,0,1872956
hyuA_predicted,0.2,4,4,TTGATCCAATAAGATACAAG,0,1850610
hyuA_predicted,0.2,4,4,TTGAACTTGGAGGTGGTTGG,0,1876666
hyuA_predicted,0.2,4,4,TTCTGCTGTGACCTCAATCG,0,1843631
hyuA_predicted,0.2,4,4,TTCTGACGGGCGTTCGAGGC,0,1831456
hyuA_predicted,0.2,4,4,TTCTATGATTCGTTCAGTGT,0,1860171
hyuA_predicted,0.2,4,4,TTCTAGTGTAGTGATGTCTC,0,1848988
hyuA_predicted,0.2,4,4,TTCTAGAATAAACCCCGACA,0,1852079
hyuA_predicted,0.2,4,4,TTCGACTACGTCGTACGATG,0,1843506
hyuA_predicted,0.2,4,4,TTCCTTGGGGAGTTAAGAGT,0,1840587
hyuA_predicted,0.2,4,4,TTCCCTGGTTCCATAGGACC,0,1865192
hyuA_predicted,0.2,4,4,TTCCCTAGCGGACAGATGAG,0,1875789
hyuA_predicted,0.2,4,4,TTCCACCAGTGCACAAGTCG,0,1859703
hyuA_predicted,0.2,4,4,TTCAGTGTTTCGGTGGGCAT,0,1849629
hyuA_predicted,0.2,4,4,TTCAGGAGATGTCATCTGCT,0,1870471
hyuA_predicted,0.2,4,4,TTCAGATCACATATAGGCTC,0,1850743
hyuA_predicted,0.2,4,4,TTCAGAGCACAGATTTGATA,0,1856482
hyuA_predicted,0.2,4,4,TTCAAGGGAGCAAAGGGATT,0,1871479
hyuA_predicted,0.2,4,4,TTCAAGATCTGAATGGTGAA,0,1834812
hyuA_predicted,0.2,4,4,TTATCGGACCGGCCCATGTT,0,1870613
hyuA_predicted,0.2,4,4,TTAGTCCACCGCAAAATTCC,0,1842279
hyuA_predicted,0.2,4,4,TTAGGGCATTGTACGTGCAA,0,1869957
hyuA_predicted,0.2,4,4,TTAGACAAGTCTTAGCACTC,0,1873431
hyuA_predicted,0.2,4,4,TTACTCACACAACTCCCAAT,0,1863766
hyuA_predicted,0.2,4,4,TTACGTATGCCACCAACCCT,0,1847402
hyuA_predicted,0.2,4,4,TTACGGTGGGATATGATACG,0,1851364
hyuA_predicted,0.2,4,4,TTACACCTGCGTTAGGTGCC,0,1837785
hyuA_predicted,0.2,4,4,TTAATTCGCATTACGCGAAA,0,1836113
hyuA_predicted,0.2,4,4,TTAAGACCAACCTGCTTTGC,0,1874580
hyuA_predicted,0.2,4,4,TTAACTTGGTGCCGTACATA,0,1846985
hyuA_predicted,0.2,4,4,TTAACCCATTGTCGTCTCTC,0,1874083
hyuA_predicted,0.2,4,4,TGTTACCACGCATGGGCATT,0,1854714
hyuA_predicted,0.2,4,4,TGTGCGCTTAACGATTCGCT,0,1839624
hyuA_predicted,0.2,4,4,TGTGAGCGAGAGCAGACTGT,0,1835175
hyuA_predicted,0.2,4,4,TGTCGGGGCGTCTTTGCAAG,0,1865248
hyuA_predicted,0.2,4,4,TGTCCCGATTGAAGTAGATG,0,1848241
hyuA_predicted,0.2,4,4,TGGTTGTATCCGTAGTGATA,0,1829911
hyuA_predicted,0.2,4,4,TGGTTGAAGGTAAGGGTCCT,0,1843512
hyuA_predicted,0.2,4,4,TGGTCTTGCGTTTCCCACGA,0,1829474
hyuA_predicted,0.2,4,4,TGGTCCTATCCGCCATATTC,0,1830295
hyuA_predicted,0.2,4,4,TGGTATGGTATAAGCAATCC,0,1834442
hyuA_predicted,0.2,4,4,TGGTATGGGCTCCGCTGTTG,0,1844824
hyuA_predicted,0.2,4,4,TGGTACGGGCGTGGGTTCTC,0,1842732
hyuA_predicted,0.2,4,4,TGGGTTTATTAGCCAGCTCC,0,1856357
hyuA_predicted,0.2,4,4,TGGGTGATCAGACACACAAA,0,1842993
hyuA_predicted,0.2,4,4,TGGGGTAGCCAGAAAACGCT,0,1842999
hyuA_predicted,0.2,4,4,TGGGCTTTAAAATATTGGAG,0,1874986
hyuA_predicted,0.2,4,4,TGGGCGTCGCGCTAAAGAGG,0,1865016
hyuA_predicted,0.2,4,4,TGGGAGACCTACTCAAGAAG,0,1829100
hyuA_predicted,0.2,4,4,TGGCTCAAACAGCGCAATAC,0,1852556
hyuA_predicted,0.2,4,4,TGGCGCTGGCACGTCCGAAA,0,1867777
hyuA_predicted,0.2,4,4,TGGCCTGAGCGGGATGGTAG,0,1850766
hyuA_predicted,0.2,4,4,TGGCCCCGGATACATGCGAC,0,1846573
hyuA_predicted,0.2,4,4,TGGCATATGGAAGGACAATA,0,1857781
hyuA_predicted,0.2,4,4,TGGACGACTCGAGGTGAGTA,0,1873950
hyuA_predicted,0.2,4,4,TGGACCCCCAAGGGATTGAA,0,1873409
hyuA_predicted,0.2,4,4,TGGACAATCGTTACCGACCA,0,1844905
hyuA_predicted,0.2,4,4,TGGAAGTAGAGGGACCTGTA,0,1844298
hyuA_predicted,0.2,4,4,TGCTTCCATAGCAGCCAGCT,0,1873097
hyuA_predicted,0.2,4,4,TGCTGATTTGTCGTTCATCA,0,1830531
hyuA_predicted,0.2,4,4,TGCTCTACAAATAGGGGCTT,0,1837224
hyuA_predicted,0.2,4,4,TGCTCCCATTGGCCCTAGTT,0,1872052
hyuA_predicted,0.2,4,4,TGCTATCCCTGTATTCGAAC,0,1828987
hyuA_predicted,0.2,4,4,TGCTAAAGATTGATGGGGTC,0,1858955
hyuA_predicted,0.2,4,4,TGCGTGCTAATCAGGTTGTT,0,1844297
hyuA_predicted,0.2,4,4,TGCGGATCCCTCGTCAAAGA,0,1849882
hyuA_predicted,0.2,4,4,TGCGCAACACAAGTGATCAG,0,1847511
hyuA_predicted,0.2,4,4,TGCCTACGGTACAACTGGCA,0,1862151
hyuA_predicted,0.2,4,4,TGCCGTTATGCTGCTAACAG,0,1837242
hyuA_predicted,0.2,4,4,TGCCACGGAGCCAGGCGGCA,0,1843160
hyuA_predicted,0.2,4,4,TGCAAAATGGGAGTTGCTTT,0,1869839
hyuA_predicted,0.2,4,4,TGATTTAACACATTAGGGCA,0,1848958
hyuA_predicted,0.2,4,4,TGATTGGTCAAGCTGTGGTA,0,1859381
hyuA_predicted,0.2,4,4,TGATGATGAATCTCCGAAGT,0,1873178
hyuA_predicted,0.2,4,4,TGATAATCTGTCATTATTTT,0,1850100
hyuA_predicted,0.2,4,4,TGATAAGGCGATTTTGGGGT,0,1858876
hyuA_predicted,0.2,4,4,TGAGTTCATTTTCCCCGAGA,0,1841264
hyuA_predicted,0.2,4,4,TGAGGTTATAAGAATCAGGA,0,1831129
hyuA_predicted,0.2,4,4,TGAGCATTCAAGGAAGTACG,0,1869107
hyuA_predicted,0.2,4,4,TGACTGACTGGAGAACCAGA,0,1830078
hyuA_predicted,0.2,4,4,TGACTCCTGGTCGTACACTA,0,1836319
hyuA_predicted,0.2,4,4,TGACATACCTGGGTTAGGTC,0,1846829
hyuA_predicted,0.2,4,4,TGACACGCTTCCGACTTACC,0,1869551
hyuA_predicted,0.2,4,4,TGACACAGTCGCATGCCCAC,0,1857778
hyuA_predicted,0.2,4,4,TGAATTGGACGAGGTGTATA,0,1872372
hyuA_predicted,0.2,4,4,TGAACCAGGCCCATGGGTTT,0,1854085
hyuA_predicted,0.2,4,4,TCTTGTTCCCGACACGTATT,0,1870322
hyuA_predicted,0.2,4,4,TCTTGGCGTTATGCAGCCAT,0,1843259
hyuA_predicted,0.2,4,4,TCTTGGCGCGCGCGTTATGT,0,1872134
hyuA_predicted,0.2,4,4,TCTGCCCGTAGGTCTCCAAC,0,1836387
hyuA_predicted,0.2,4,4,TCTCTCGAGCTGCCGATCAC,0,1841080
hyuA_predicted,0.2,4,4,TCTCTATCACTAGATTTTTT,0,1868472
hyuA_predicted,0.2,4,4,TCTATGCTGCGATTGCGGGG,0,1858055
hyuA_predicted,0.2,4,4,TCTACGGCCGCCAAACATGG,0,1866868
hyuA_predicted,0.2,4,4,TCTACCACTACGGCATATTA,0,1853063
hyuA_predicted,0.2,4,4,TCTAATACAAGTGTTTGAGA,0,1873621
hyuA_predicted,0.2,4,4,TCGTGGCCGTTAACGGATAG,0,1846357
hyuA_predicted,0.2,4,4,TCGTGACGGTCATAGGTGGT,0,1873642
hyuA_predicted,0.2,4,4,TCGTCGGCTCAAGTCGGGAA,0,1861100
hyuA_predicted,0.2,4,4,TCGTAGTGATGTATGGCAGT,0,1857991
hyuA_predicted,0.2,4,4,TCGGTAGGGATTTTGCACGG,0,1847151
hyuA_predicted,0.2,4,4,TCGGGGCTATACAGTATCAA,0,1840945
hyuA_predicted,0.2,4,4,TCGGCATGAGAGACGTTTCA,0,1833078
hyuA_predicted,0.2,4,4,TCGCCCCCCGCATCTTAATA,0,1854227
hyuA_predicted,0.2,4,4,TCGATTTTACCTCAAATCGC,0,1857602
hyuA_predicted,0.2,4,4,TCGATGCGCTCCTGAGTGCC,0,1837051
hyuA_predicted,0.2,4,4,TCGAGGTCTGTTACTCAGTA,0,1876456
hyuA_predicted,0.2,4,4,TCGACACAGGTCTCTCTGGG,0,1832363
hyuA_predicted,0.2,4,4,TCGACAACCTTGTATTTGCA,0,1870524
hyuA_predicted,0.2,4,4,TCCTGCTATCCTCTGGTTTA,0,1869736
hyuA_predicted,0.2,4,4,TCCTATAGAGTTTGGGACTT,0,1872097
hyuA_predicted,0.2,4,4,TCCGTTCCAGTGGGGTGTGG,0,1836401
hyuA_predicted,0.2,4,4,TCCGCATCCCAAATGATAAA,0,1843342
hyuA_predicted,0.2,4,4,TCCGCAGTTAACGGATTGCA,0,1845272
hyuA_predicted,0.2,4,4,TCCCTATCCCTATGCATAGA,0,1854390
hyuA_predicted,0.2,4,4,TCCCAGGGAGTAACGCGAGC,0,1865704
hyuA_predicted,0.2,4,4,TCCCACATTTATGAATAAAA,0,1871259
hyuA_predicted,0.2,4,4,TCCCAATCTTCTGAATTTAA,0,1850343
hyuA_predicted,0.2,4,4,TCCATAATGCATGTGGTTAT,0,1872717
hyuA_predicted,0.2,4,4,TCCAACTATTGAAAAGCTGT,0,1841175
hyuA_predicted,0.2,4,4,TCATTTTAGGTTCCGAGCGT,0,1833035
hyuA_predicted,0.2,4,4,TCATGGTACGAACAGGTGGA,0,1851063
hyuA_predicted,0.2,4,4,TCATCTGTCTAACGTAAGGC,0,1864444
hyuA_predicted,0.2,4,4,TCATCGGGGCCAGCAGCTAG,0,1864331
hyuA_predicted,0.2,4,4,TCATCGCACCGGTAGTGGTT,0,1833238
hyuA_predicted,0.2,4,4,TCAGGTTGGATCCAACGCTT,0,1841375
hyuA_predicted,0.2,4,4,TCAGGCATAAGGTCGTGGGT,0,1832324
hyuA_predicted,0.2,4,4,TCAGGACAGGAACTAAATTC,0,1829730
hyuA_predicted,0.2,4,4,TCAGCTGGAGTGGCCTACTA,0,1855367
hyuA_predicted,0.2,4,4,TCAGCTCGGGGCCGGTGAAT,0,1866768
hyuA_predicted,0.2,4,4,TCAGACCGTTATACGCCTAG,0,1854465
hyuA_predicted,0.2,4,4,TCACGGGTTTTAAGGAAGTG,0,1864949
hyuA_predicted,0.2,4,4,TCACGCTCGGTTTGGTGTTC,0,1838346
hyuA_predicted,0.2,4,4,TCACAGACGGATCGATAGTA,0,1835799
hyuA_predicted,0.2,4,4,TATTTCTCTATGATCTATCT,0,1847459
hyuA_predicted,0.2,4,4,TATTGTATGGCGTAGCGAAG,0,1869448
hyuA_predicted,0.2,4,4,TATGTTGATTTGCTAAACCA,0,1835998
hyuA_predicted,0.2,4,4,TATGATCGCGTGAAGTACCA,0,1848750
hyuA_predicted,0.2,4,4,TATCGCTGGTTAGCGTGCGA,0,1868556
hyuA_predicted,0.2,4,4,TATCCAAAGTACAGGCTATG,0,1877630
hyuA_predicted,0.2,4,4,TATAGTTTTTGCTCGATAGA,0,1829533
hyuA_predicted,0.2,4,4,TATACTGTTACAGTTAGTCG,0,1854905
hyuA_predicted,0.2,4,4,TATAAGGGGAGTGGCCAGTA,0,1866147
hyuA_predicted,0.2,4,4,TATAAAAACTGTTGCCAGGC,0,1857650
hyuA_predicted,0.2,4,4,TAGGGTCGGAGGAGGTCGGT,0,1859239
hyuA_predicted,0.2,4,4,TAGCATAACCGCGTGGGTAG,0,1872020
hyuA_predicted,0.2,4,4,TAGCAAACCGGTTCCCAGAT,0,1848556
hyuA_predicted,0.2,4,4,TAGATTTTACGTCATTCGCA,0,1831435
hyuA_predicted,0.2,4,4,TAGATCTACTGTGTTATCAA,0,1856890
hyuA_predicted,0.2,4,4,TAGACACAGCGAGAAAGTAC,0,1838644
hyuA_predicted,0.2,4,4,TACTGACGCGCGATCGTGGA,0,1862039
hyuA_predicted,0.2,4,4,TACGTAACTACCGCATTTAG,0,1870176
hyuA_predicted,0.2,4,4,TACGCGAGCGGTCGCTTTCC,0,1854494
hyuA_predicted,0.2,4,4,TACGATCTCTCGTCCACCAG,0,1859118
hyuA_predicted,0.2,4,4,TACGACCACTTATCGGCGTT,0,1845555
hyuA_predicted,0.2,4,4,TACGAAGGAGGTTGTTACTA,0,1853837
hyuA_predicted,0.2,4,4,TACGAAAGGGTTCAGGGTCC,0,1849398
hyuA_predicted,0.2,4,4,TACCCCGATGGGTCTTGCTA,0,1837640
hyuA_predicted,0.2,4,4,TACATTTCAGAACTTCTGAA,0,1838298
hyuA_predicted,0.2,4,4,TACATTAGGGGAGGAGTGAT,0,1834535
hyuA_predicted,0.2,4,4,TACACGGTGGTTGCGTAGGC,0,1868105
hyuA_predicted,0.2,4,4,TACAATGCTAGCAGCTCCGC,0,1841492
hyuA_predicted,0.2,4,4,TAATTTTGGCTCCAATGTAT,0,1851252
hyuA_predicted,0.2,4,4,TAATTAGCAGAACCTCGGAG,0,1854784
hyuA_predicted,0.2,4,4,TAATGTTTCCCACGCAGATA,0,1845912
hyuA_predicted,0.2,4,4,TAATGGTTAATTTTAATTGC,0,1843809
hyuA_predicted,0.2,4,4,TAATATATTAAGGCACCGGG,0,1846766
hyuA_predicted,0.2,4,4,TAAGTTCGGGCCGCTTGTGT,0,1858582
hyuA_predicted,0.2,4,4,TAAGTCCCACTCAAAGTAAT,0,1865661
hyuA_predicted,0.2,4,4,TAAGTAGCCTATCGAGGGCG,0,1850521
hyuA_predicted,0.2,4,4,TAAGCATCTAGCCGGCACGG,0,1852924
hyuA_predicted,0.2,4,4,TAACTCCCTTAAGGCCCCCG,0,1868888
hyuA_predicted,0.2,4,4,TAACGGGTGCAAAACGTTGG,0,1865705
hyuA_predicted,0.2,4,4,TAACAGCTCCCCACGGTTAT,0,1874440
hyuA_predicted,0.2,4,4,TAAAGAAGATTTCATCGGGT,0,1874121
hyuA_predicted,0.2,4,4,TAAACGAGGCGCCTACGACG,0,1873966
hyuA_predicted,0.2,4,4,TAAAATCAGTGGATTCTAGA,0,1842610
hyuA_predicted,0.2,4,4,TAAAAAGTGTCCATGGGCCA,0,1840553
hyuA_predicted,0.2,4,4,TAAAAAGGGATGCTTACTCT,0,1849923
hyuA_predicted,0.2,4,4,GTTTTCTCTCGCCAACAATC,0,1848216
hyuA_predicted,0.2,4,4,GTTTGGAAACGCCCCAATGC,0,1868374
hyuA_predicted,0.2,4,4,GTTTCTCCTGAACCCCCTGA,0,1840209
hyuA_predicted,0.2,4,4,GTTTAGAGCACGTTGATTAT,0,1830267
hyuA_predicted,0.2,4,4,GTTTAGACGGGTGTACAATT,0,1839999
hyuA_predicted,0.2,4,4,GTTGTATTAACAATTAAATT,0,1859053
hyuA_predicted,0.2,4,4,GTTGGCCGAATGTACTCATT,0,1870624
hyuA_predicted,0.2,4,4,GTTGGCCCCTACTGCACCCT,0,1840384
hyuA_predicted,0.2,4,4,GTTGGAGTCCCCTCTATGGG,0,1875800
hyuA_predicted,0.2,4,4,GTTGCTCAGATCGAGACCTG,0,1842786
hyuA_predicted,0.2,4,4,GTTCGTGGAATCAACATGGC,0,1854096
hyuA_predicted,0.2,4,4,GTTCGGTCGAATGCCGCCAA,0,1848445
hyuA_predicted,0.2,4,4,GTTCCTGGCTTATTGGATAT,0,1829259
hyuA_predicted,0.2,4,4,GTTCCCCGGTCTGATGTATG,0,1834631
hyuA_predicted,0.2,4,4,GTTATAGCCCCTTCGGCCGC,0,1839156
hyuA_predicted,0.2,4,4,GTTACCGACTTCCAGTTTAC,0,1846753
hyuA_predicted,0.2,4,4,GTGTTTCAACACGTCCCCAC,0,1860609
hyuA_predicted,0.2,4,4,GTGTTCTGATGATATACGCC,0,1833708
hyuA_predicted,0.2,4,4,GTGTGTTTTAGTAACGATGA,0,1877293
hyuA_predicted,0.2,4,4,GTGTGCCGGTGACTTATAGC,0,1863760
hyuA_predicted,0.2,4,4,GTGTGCCATATCAGCCATTG,0,1874087
hyuA_predicted,0.2,4,4,GTGTCTGTGCCTGTCCCGGG,0,1855312
hyuA_predicted,0.2,4,4,GTGTATGAGATGTAAATAAA,0,1856319
hyuA_predicted,0.2,4,4,GTGGTGGGTGGGAGTTGATC,0,1848233
hyuA_predicted,0.2,4,4,GTGGTCAGGGAACGCTTAGA,0,1861471
hyuA_predicted,0.2,4,4,GTGGGTGAGGCCGGCTCAGG,0,1855158
hyuA_predicted,0.2,4,4,GTGGGACCTAGCTGAACCTT,0,1858467
hyuA_predicted,0.2,4,4,GTGGCGCCAAATAGAATGAT,0,1853407
hyuA_predicted,0.2,4,4,GTGCTTCTAGCGCATGTTCT,0,1858973
hyuA_predicted,0.2,4,4,GTGCTATGTCTAATGGCGGC,0,1844083
hyuA_predicted,0.2,4,4,GTGCGCACAAGCCATTAAGT,0,1842854
hyuA_predicted,0.2,4,4,GTGATCTCCGGGGGAAATTA,0,1860019
hyuA_predicted,0.2,4,4,GTGATCGCGTAAGCAAGATG,0,1873138
hyuA_predicted,0.2,4,4,GTGATCACCCCGCGGGAGAC,0,1871976
hyuA_predicted,0.2,4,4,GTGACTAAAAGTGCCCCCTT,0,1860579
hyuA_predicted,0.2,4,4,GTCTTCATTACCGGTTGTCT,0,1865005
hyuA_predicted,0.2,4,4,GTCTGTACATGCCAGGTGCG,0,1868411
hyuA_predicted,0.2,4,4,GTCTCAAGACAGCGTTGTCT,0,1844675
hyuA_predicted,0.2,4,4,GTCTAGCAGAATACTGCGAG,0,1849363
hyuA_predicted,0.2,4,4,GTCGGCCACAGCATCGAGCG,0,1858886
hyuA_predicted,0.2,4,4,GTCGCCGGGACTTCATGTAC,0,1854535
hyuA_predicted,0.2,4,4,GTCGCCCTCAGGGTCGCCGC,0,1852469
hyuA_predicted,0.2,4,4,GTCGAAAAACGTCAAACTCG,0,1875290
hyuA_predicted,0.2,4,4,GTCCTTAAAAGGAAACGTGT,0,1857927
hyuA_predicted,0.2,4,4,GTCCTGTTTCTATTCTTCTC,0,1853472
hyuA_predicted,0.2,4,4,GTCCTCGTTCTCGGGTGGAG,0,1857471
hyuA_predicted,0.2,4,4,GTCCGTGGCCTAGCTCTTGA,0,1857713
hyuA_predicted,0.2,4,4,GTCCGACGTGCGGGACCGCT,0,1853913
hyuA_predicted,0.2,4,4,GTCCCTTCACGCTTGGCGAA,0,1869297
hyuA_predicted,0.2,4,4,GTCCCCTACAGTAGTGATTA,0,1877818
hyuA_predicted,0.2,4,4,GTCCACTGAGTGAGGTCAGA,0,1866242
hyuA_predicted,0.2,4,4,GTCCACCTTCCCTTCTACGT,0,1837098
hyuA_predicted,0.2,4,4,GTCATCGAGCGTTGGGAATT,0,1874200
hyuA_predicted,0.2,4,4,GTCACCGTCGCAGTCCTTGA,0,1832678
hyuA_predicted,0.2,4,4,GTCACAGCTGCTCTTAACAA,0,1844471
hyuA_predicted,0.2,4,4,GTATGTTTTGGCACATGCTG,0,1852294
hyuA_predicted,0.2,4,4,GTATGGTGTTCGTTAGCTGG,0,1864767
hyuA_predicted,0.2,4,4,GTATCTGTGTCTAGTTAGCC,0,1845453
hyuA_predicted,0.2,4,4,GTATCGGTTATGAAGCCGGA,0,1835837
hyuA_predicted,0.2,4,4,GTAGTTAACCAGTTACTTCC,0,1874319
hyuA_predicted,0.2,4,4,GTAGTAGGTATCTAAGGGGA,0,1845983
hyuA_predicted,0.2,4,4,GTAGTAACCGGGTCTAGTTG,0,1863870
hyuA_predicted,0.2,4,4,GTAGCCAAAACTCACAGACG,0,1843061
hyuA_predicted,0.2,4,4,GTACGTAGGATAGCGTCATA,0,1862085
hyuA_predicted,0.2,4,4,GTACCGTTCGGACTGGCAAA,0,1855319
hyuA_predicted,0.2,4,4,GTAACTATTAAGGCGAATGG,0,1866402
hyuA_predicted,0.2,4,4,GTAACATTGTGACTCGGGGA,0,1858937
hyuA_predicted,0.2,4,4,GTAAAGGCGCCAATAGGAAC,0,1872051
hyuA_predicted,0.2,4,4,GTAAAGAAACACCTGTGTAG,0,1877160
hyuA_predicted,0.2,4,4,GGTTGAAATTAGTGAGTTAG,0,1858091
hyuA_predicted,0.2,4,4,GGTTCAAACTTGTACTCATC,0,1846697
hyuA_predicted,0.2,4,4,GGTTACCACTGCACTGGTCC,0,1847883
hyuA_predicted,0.2,4,4,GGTTAACAACCCTTACAATT,0,1876985
hyuA_predicted,0.2,4,4,GGTTAAATTTCCTTGATACT,0,1876530
hyuA_predicted,0.2,4,4,GGTGTAACAGACGCTTAGAT,0,1836083
hyuA_predicted,0.2,4,4,GGTGTAAATCAACAGTCTGT,0,1831793
hyuA_predicted,0.2,4,4,GGTGGTGAAGTAACTCGATT,0,1865794
hyuA_predicted,0.2,4,4,GGTGGTAGTCATATATTATG,0,1868555
hyuA_predicted,0.2,4,4,GGTGGGGTATCATTTACGGA,0,1864730
hyuA_predicted,0.2,4,4,GGTGGATATATATACTCATA,0,1842158
hyuA_predicted,0.2,4,4,GGTGGACCCGAGATGGATTA,0,1863022
hyuA_predicted,0.2,4,4,GGTGGACATTTTGATATCCA,0,1841282
hyuA_predicted,0.2,4,4,GGTCTTCCTCCATTTGCCTT,0,1839700
hyuA_predicted,0.2,4,4,GGTCTCGCGATTGGCTAACT,0,1836886
hyuA_predicted,0.2,4,4,GGTCCGGCGCTCATCTCATC,0,1849661
hyuA_predicted,0.2,4,4,GGTCAGATCGGCAGTGGATT,0,1834993
hyuA_predicted,0.2,4,4,GGTAGGTCTATTAGTTATCG,0,1858499
hyuA_predicted,0.2,4,4,GGGTTATTTGTCGTGATGCT,0,1864031
hyuA_predicted,0.2,4,4,GGGTGATAGTCGCTACGGGA,0,1847443
hyuA_predicted,0.2,4,4,GGGTAAAATCCGGTGCCCTC,0,1851929
hyuA_predicted,0.2,4,4,GGGGTTGCGGATGTCAGCTT,0,1856442
hyuA_predicted,0.2,4,4,GGGGTTAAATTTATGCATTC,0,1869429
hyuA_predicted,0.2,4,4,GGGGTCATGCTCTCTGAAGA,0,1836379
hyuA_predicted,0.2,4,4,GGGGGGTTCAGAGTTCGTTA,0,1874190
hyuA_predicted,0.2,4,4,GGGGCGCCCACCGTCAGTCC,0,1842215
hyuA_predicted,0.2,4,4,GGGGCCTATCCAGGTTTCAG,0,1866268
hyuA_predicted,0.2,4,4,GGGCTTACTTGGTAAAATCT,0,1831553
hyuA_predicted,0.2,4,4,GGGCGGACAAACCTCCGTAT,0,1866335
hyuA_predicted,0.2,4,4,GGGCCGGCATTCGGTAGAGA,0,1865390
hyuA_predicted,0.2,4,4,GGGCAGACGTGTCGATAAGT,0,1876506
hyuA_predicted,0.2,4,4,GGGAGTGTAACGAGACACTC,0,1854079
hyuA_predicted,0.2,4,4,GGGAGTAGGCGTTCGAGGGG,0,1872264
hyuA_predicted,0.2,4,4,GGGAATCACAATCTATCGAG,0,1838483
hyuA_predicted,0.2,4,4,GGGAACGAGCGTCTCCGGTT,0,1839601
hyuA_predicted,0.2,4,4,GGCTAACGGCAACGCGCCGA,0,1829412
hyuA_predicted,0.2,4,4,GGCGTTTATTAGTGCTTTGG,0,1829472
hyuA_predicted,0.2,4,4,GGCGTGGCTGATCACCAATC,0,1833775
hyuA_predicted,0.2,4,4,GGCGTAACCAATCTGTAGGT,0,1871887
hyuA_predicted,0.2,4,4,GGCGGTAAACTGAGATAGAA,0,1874251
hyuA_predicted,0.2,4,4,GGCGGGATGTGTCGCAGTGA,0,1835010
hyuA_predicted,0.2,4,4,GGCGCCAAGACCAAGAACTT,0,1849469
hyuA_predicted,0.2,4,4,GGCGAAACTACCCGTACGCG,0,1843851
hyuA_predicted,0.2,4,4,GGCCCCCTATTAGTCTAACG,0,1844538
hyuA_predicted,0.2,4,4,GGCATCTATATACGATATAG,0,1866555
hyuA_predicted,0.2,4,4,GGCATCGTCATATGTATTCC,0,1848465
hyuA_predicted,0.2,4,4,GGCAGTATAAAGTATCGGGA,0,1858838
hyuA_predicted,0.2,4,4,GGCAGGCATACTCGTCAATT,0,1838089
hyuA_predicted,0.2,4,4,GGCAGAAGCTCATAACAGTT,0,1872729
hyuA_predicted,0.2,4,4,GGCACGCGGGTTGGATAGTT,0,1874734
hyuA_predicted,0.2,4,4,GGCAATCGCACTTATCCATT,0,1845479
hyuA_predicted,0.2,4,4,GGATTTGGAAGGAGGACACT,0,1868199
hyuA_predicted,0.2,4,4,GGATTTATAGTCCTGGTGAG,0,1842381
hyuA_predicted,0.2,4,4,GGATTAGGCCTTCGGAGGGA,0,1877121
hyuA_predicted,0.2,4,4,GGATGTGGAGAGACTGTATC,0,1868826
hyuA_predicted,0.2,4,4,GGATAGCATCAATGTGCTTC,0,1855441
hyuA_predicted,0.2,4,4,GGAGTGGTCTTTACCACGTC,0,1856136
hyuA_predicted,0.2,4,4,GGAGTACTCAGAGGTGACAA,0,1839141
hyuA_predicted,0.2,4,4,GGAGGAATAGTCGAGAGTCC,0,1872437
hyuA_predicted,0.2,4,4,GGAGCTTGAACTACTTCGGT,0,1834390
hyuA_predicted,0.2,4,4,GGAGCTGGTGCACTTTAGCA,0,1865581
hyuA_predicted,0.2,4,4,GGAGCCCTTCTTCTGGATTG,0,1854725
hyuA_predicted,0.2,4,4,GGAGAACGCACTTCAAGATA,0,1861171
hyuA_predicted,0.2,4,4,GGACGCGGAACAGCCAGACT,0,1866845
hyuA_predicted,0.2,4,4,GGACCCCAATTGTCGGTTGT,0,1839810
hyuA_predicted,0.2,4,4,GGAATTTATGGTGCGCCATA,0,1866652
hyuA_predicted,0.2,4,4,GGAAGTTACCATTATTACCC,0,1874103
hyuA_predicted,0.2,4,4,GCTTTAACGTCTCTCGCCAC,0,1846000
hyuA_predicted,0.2,4,4,GCTTTAACCAACAGTCGGGT,0,1857340
hyuA_predicted,0.2,4,4,GCTTCTCCTGCTATACAGTC,0,1843498
hyuA_predicted,0.2,4,4,GCTTAGCTTTATGGTCCAGA,0,1864028
hyuA_predicted,0.2,4,4,GCTGTATTATACTACCGGCT,0,1838235
hyuA_predicted,0.2,4,4,GCTGGTAAGGTTCAATTCCA,0,1869806
hyuA_predicted,0.2,4,4,GCTGAGTTGGCTGTAGAGTT,0,1871994
hyuA_predicted,0.2,4,4,GCTGAGACTCTCTATCGGAG,0,1875869
hyuA_predicted,0.2,4,4,GCTCTGACCCGTTAAAAATA,0,1832397
hyuA_predicted,0.2,4,4,GCTCCTGCCTCTCTGGCACA,0,1854682
hyuA_predicted,0.2,4,4,GCTCAGGGCGGATGCCTGTT,0,1856964
hyuA_predicted,0.2,4,4,GCTCACTCGACGTTTCCCTC,0,1839161
hyuA_predicted,0.2,4,4,GCTCACAGATACATAATATC,0,1833987
hyuA_predicted,0.2,4,4,GCTAGCTTCGGCTTGGGAAC,0,1864654
hyuA_predicted,0.2,4,4,GCTAAAACTGAACCCAGCTA,0,1829336
hyuA_predicted,0.2,4,4,GCGTTCTTATAGATGAGTCT,0,1854294
hyuA_predicted,0.2,4,4,GCGTGATTCGACTTCAAGGG,0,1869804
hyuA_predicted,0.2,4,4,GCGTCCAAAATCTAGTAGTG,0,1870281
hyuA_predicted,0.2,4,4,GCGTACGTTAACAGGACAAT,0,1855006
hyuA_predicted,0.2,4,4,GCGGTAAGATAGCTTAACTC,0,1843531
hyuA_predicted,0.2,4,4,GCGGGGGGGCCCATAGGCAT,0,1846642
hyuA_predicted,0.2,4,4,GCGGGCCACATTTGTACCTT,0,1832335
hyuA_predicted,0.2,4,4,GCGGCCCGAAACATGTGCCT,0,1853064
hyuA_predicted,0.2,4,4,GCGGCATCACAGTATGCCTT,0,1838896
hyuA_predicted,0.2,4,4,GCGGACCCAAAACGCGTGAT,0,1831172
hyuA_predicted,0.2,4,4,GCGCTCTTTTTAGTTGTTGG,0,1832005
hyuA_predicted,0.2,4,4,GCGCGTTGTTATTTTTAGGC,0,1868317
hyuA_predicted,0.2,4,4,GCGCCTGGTATTGGCTTTAT,0,1869379
hyuA_predicted,0.2,4,4,GCGCATCCAAACAGGTCGTC,0,1848121
hyuA_predicted,0.2,4,4,GCGATACCTTTCGGTCAGTA,0,1840778
hyuA_predicted,0.2,4,4,GCGAATGGGCGTGTGCCTAG,0,1856714
hyuA_predicted,0.2,4,4,GCGAAAGCACGTCCCGGTAA,0,1870478
hyuA_predicted,0.2,4,4,GCCTTGAGGTATATTTACAG,0,1871411
hyuA_predicted,0.2,4,4,GCCTGGGGACTTGTTTCTTT,0,1849929
hyuA_predicted,0.2,4,4,GCCTCCGTTGTATCCCTTGT,0,1865185
hyuA_predicted,0.2,4,4,GCCTATATCTGTCTGCTAGC,0,1847934
hyuA_predicted,0.2,4,4,GCCTACTACCCTGTGTATCA,0,1835393
hyuA_predicted,0.2,4,4,GCCGATACTTACACCCAGTA,0,1849420
hyuA_predicted,0.2,4,4,GCCGACGACTCCCTTTTGTG,0,1860763
hyuA_predicted,0.2,4,4,GCCCTTTATGCTCCCCGTTC,0,1871910
hyuA_predicted,0.2,4,4,GCCCTACATTGCCTAAGCAA,0,1862104
hyuA_predicted,0.2,4,4,GCCCGTGCTAGTTGGGTTTA,0,1853385
hyuA_predicted,0.2,4,4,GCCCGTACGAGTAATCGATA,0,1845821
hyuA_predicted,0.2,4,4,GCCCCATGACGGATCCCCGC,0,1866363
hyuA_predicted,0.2,4,4,GCCCACGGCCAAATCCCCTC,0,1860468
hyuA_predicted,0.2,4,4,GCCACACGCCCTTAGCGTTG,0,1835466
hyuA_predicted,0.2,4,4,GCCAAATACGTCCACCCTAG,0,1864345
hyuA_predicted,0.2,4,4,GCATTCGCGCGTAATGACGG,0,1841252
hyuA_predicted,0.2,4,4,GCATCCCAATGCATAATTGT,0,1846293
hyuA_predicted,0.2,4,4,GCATCCAGGTTGCTCCGCGC,0,1831752
hyuA_predicted,0.2,4,4,GCAGTGTTGTCGGTAGGCGT,0,1832229
hyuA_predicted,0.2,4,4,GCAGGTTATGATTTTTACAT,0,1830203
hyuA_predicted,0.2,4,4,GCAGGGCAACTTTGTTATGG,0,1869515
hyuA_predicted,0.2,4,4,GCAGGAAAGATGTTACACAA,0,1837729
hyuA_predicted,0.2,4,4,GCACTATGTGGAGTTCTAGA,0,1829125
hyuA_predicted,0.2,4,4,GCACAGAAATGGAATGCGCG,0,1872598
hyuA_predicted,0.2,4,4,GCACACCTGAACAAACATAG,0,1830592
hyuA_predicted,0.2,4,4,GCAAGTAGCTAATTGGTCAG,0,1849937
hyuA_predicted,0.2,4,4,GCAAGTAACCTTTGGGAACG,0,1863493
hyuA_predicted,0.2,4,4,GCAACTGCCCTGCCAGCATG,0,1877426
hyuA_predicted,0.2,4,4,GATTTCGTCAAGAAGGGGGT,0,1866379
hyuA_predicted,0.2,4,4,GATTGAACTGAGTTAACCTA,0,1856569
hyuA_predicted,0.2,4,4,GATTCGTGGAGGCCGTTAAG,0,1867989
hyuA_predicted,0.2,4,4,GATTCGCCTTCTCAATGGGG,0,1873433
hyuA_predicted,0.2,4,4,GATGGCGCTTTAGGCAGAGT,0,1831180
hyuA_predicted,0.2,4,4,GATGAGCATCATGTTGAGGC,0,1877782
hyuA_predicted,0.2,4,4,GATGACGACACATTAGAAAA,0,1850412
hyuA_predicted,0.2,4,4,GATCGTGATGATCATACATG,0,1832057
hyuA_predicted,0.2,4,4,GATCCTCGCAATCGACCAGC,0,1876902
hyuA_predicted,0.2,4,4,GATCAGTTTGTATCCGCACG,0,1847473
hyuA_predicted,0.2,4,4,GATCACAACAGGCAGCGCGC,0,1842648
hyuA_predicted,0.2,4,4,GATATTTTTATCCTCAGGGC,0,1870036
hyuA_predicted,0.2,4,4,GATATGTTAACGCATCGAGC,0,1849484
hyuA_predicted,0.2,4,4,GATATGCGAGTAGATCAAGA,0,1849753
hyuA_predicted,0.2,4,4,GATACGGTTGTGGTTATTTT,0,1855812
hyuA_predicted,0.2,4,4,GATAAGGTTCACGCAGCACG,0,1867587
hyuA_predicted,0.2,4,4,GAGTATAACGGTCGTACTCC,0,1835476
hyuA_predicted,0.2,4,4,GAGTAGCGTAAGGCCAATCG,0,1870724
hyuA_predicted,0.2,4,4,GAGTAAACATCGTGAAGTCA,0,1858768
hyuA_predicted,0.2,4,4,GAGCTGTAAGGGGGTGACTC,0,1872317
hyuA_predicted,0.2,4,4,GAGCTGGGGACTCCTTTAGT,0,1867273
hyuA_predicted,0.2,4,4,GAGCTAGATTTTCGAGAGCT,0,1864114
hyuA_predicted,0.2,4,4,GAGCGGATATCGTAATTTGG,0,1876732
hyuA_predicted,0.2,4,4,GAGCCCTACGAGGCTTCTAA,0,1860085
hyuA_predicted,0.2,4,4,GAGATTGCCAGATAGAGAGC,0,1832680
hyuA_predicted,0.2,4,4,GAGAGTTGGCTCCAGGTTAT,0,1854457
hyuA_predicted,0.2,4,4,GAGAGTATGGATCACCGACC,0,1856209
hyuA_predicted,0.2,4,4,GAGAGCACCAAAGGCGGCGT,0,1865237
hyuA_predicted,0.2,4,4,GAGAGACTCTGTACATACAT,0,1874296
hyuA_predicted,0.2,4,4,GAGAATTTTGAAACTCGCCC,0,1876309
hyuA_predicted,0.2,4,4,GAGAACATTAAGCGATTACC,0,1842920
hyuA_predicted,0.2,4,4,GACTGCCTATACCGTGCGGC,0,1874132
hyuA_predicted,0.2,4,4,GACGCTAGCTTATTGACCAT,0,1852689
hyuA_predicted,0.2,4,4,GACGCGAGTTGGTAACTCCA,0,1831666
hyuA_predicted,0.2,4,4,GACGATGATGGCATGCACTA,0,1845273
hyuA_predicted,0.2,4,4,GACGAGAATGAAGATAGGGA,0,1877077
hyuA_predicted,0.2,4,4,GACGACCTGGGACAAATTGT,0,1855244
hyuA_predicted,0.2,4,4,GACCTATATCTCTGTGGGGG,0,1830941
hyuA_predicted,0.2,4,4,GACCTACTGCATACATTTAA,0,1855299
hyuA_predicted,0.2,4,4,GACCGTAAAATTTGGTACAA,0,1842689
hyuA_predicted,0.2,4,4,GACACCCGATTAACGGAGAT,0,1857429
hyuA_predicted,0.2,4,4,GACACACTTCAACCGGTGGT,0,1877069
hyuA_predicted,0.2,4,4,GAATTAGCAAGAGTATGTTC,0,1833052
hyuA_predicted,0.2,4,4,GAATCTCCAAGCTCTGTACC,0,1865422
hyuA_predicted,0.2,4,4,GAATCCTTACATGTCGATCC,0,1863749
hyuA_predicted,0.2,4,4,GAATCAATAACCCACTCTGA,0,1829437
hyuA_predicted,0.2,4,4,GAATATTTCCAGGAGAAATA,0,1858072
hyuA_predicted,0.2,4,4,GAATATTGGGAGGACGGGTA,0,1833021
hyuA_predicted,0.2,4,4,GAAGTTATGTTATTTTCCTG,0,1875036
hyuA_predicted,0.2,4,4,GAAGTAATTGAACTGGAATG,0,1844812
hyuA_predicted,0.2,4,4,GAAGGGACAAGAAGTACCAT,0,1833347
hyuA_predicted,0.2,4,4,GAAGCTTTACAAAGGGCTAG,0,1872559
hyuA_predicted,0.2,4,4,GAAGAGTCGAATGGTGAGAG,0,1857393
hyuA_predicted,0.2,4,4,GAACCCCCTGATGTCATTAC,0,1861918
hyuA_predicted,0.2,4,4,GAACAGATGTAGCGTGGTTA,0,1854679
hyuA_predicted,0.2,4,4,GAAAGTACTCAGGACGTTCT,0,1865694
hyuA_predicted,0.2,4,4,GAAAGGGGTAGGCCGAGGCA,0,1876859
hyuA_predicted,0.2,4,4,CTTTTCATTCTGCATGGAGT,0,1860428
hyuA_predicted,0.2,4,4,CTTTGTAAATATGCATCTTC,0,1858534
hyuA_predicted,0.2,4,4,CTTTCGAGTCTGACTAATAC,0,1846499
hyuA_predicted,0.2,4,4,CTTGGGACGGCCCTACACAT,0,1853669
hyuA_predicted,0.2,4,4,CTTGCGAACTCACATGGCGA,0,1850201
hyuA_predicted,0.2,4,4,CTTGATTCATTATCTATATG,0,1833710
hyuA_predicted,0.2,4,4,CTTCTTGCGCTTTGGACTCA,0,1846179
hyuA_predicted,0.2,4,4,CTTCTGAAGGGCGACTTTTC,0,1861210
hyuA_predicted,0.2,4,4,CTTCGGCAGAATTCTGTTAC,0,1847133
hyuA_predicted,0.2,4,4,CTTAGGTCAGCCAGCCCACG,0,1850127
hyuA_predicted,0.2,4,4,CTTACATGAGAATGTTATCA,0,1840830
hyuA_predicted,0.2,4,4,CTTAAGTTTTTTCGTTAGGA,0,1841215
hyuA_predicted,0.2,4,4,CTGTTTTCGGTTGAGACGCT,0,1864751
hyuA_predicted,0.2,4,4,CTGTTTGGACGTGTTCACAT,0,1876078
hyuA_predicted,0.2,4,4,CTGTCTTACAAATCCAAGAC,0,1866443
hyuA_predicted,0.2,4,4,CTGGTTTTCCAGGGAGTCTA,0,1847776
hyuA_predicted,0.2,4,4,CTGGTTCCTGGGGCTCAAGT,0,1865470
hyuA_predicted,0.2,4,4,CTGGTCGTGTAATCGGCGTC,0,1856262
hyuA_predicted,0.2,4,4,CTGGAGTTGACGGCCCTTAT,0,1836085
hyuA_predicted,0.2,4,4,CTGCATGTAATTGCCTTTAT,0,1863743
hyuA_predicted,0.2,4,4,CTGCATCACCACTTTGATGT,0,1871480
hyuA_predicted,0.2,4,4,CTGCAATCTAGTTTAGTTAA,0,1869799
hyuA_predicted,0.2,4,4,CTGATAGTCGAACAAGGGGA,0,1829684
hyuA_predicted,0.2,4,4,CTGAGCTAAAATGGCCAGGT,0,1843130
hyuA_predicted,0.2,4,4,CTGAGCGGTGCGGATCGCGT,0,1855718
hyuA_predicted,0.2,4,4,CTGAGAATAAAGGCGGATGT,0,1857246
hyuA_predicted,0.2,4,4,CTGACTCTAATCCCGGGCTT,0,1860344
hyuA_predicted,0.2,4,4,CTGAACATAATAGCAAACCT,0,1844211
hyuA_predicted,0.2,4,4,CTCTTTCACGTATTAGAATG,0,1856483
hyuA_predicted,0.2,4,4,CTCTGCCGTGGTTTAATCAC,0,1871881
hyuA_predicted,0.2,4,4,CTCTCGGCCTCAAAGCGGAG,0,1877870
hyuA_predicted,0.2,4,4,CTCGTCATGCGAAAGATAAT,0,1852685
hyuA_predicted,0.2,4,4,CTCGGTGCTACGGGGGTGGT,0,1841542
hyuA_predicted,0.2,4,4,CTCGGCACCAGAATCGTTGT,0,1830460
hyuA_predicted,0.2,4,4,CTCGCCAACCCACTACGCCC,0,1853638
hyuA_predicted,0.2,4,4,CTCGCACTATACCGGTTGTT,0,1858763
hyuA_predicted,0.2,4,4,CTCGAGCTCGCAATTAGCTG,0,1876833
hyuA_predicted,0.2,4,4,CTCATTTTATCTGTGGGGTC,0,1877013
hyuA_predicted,0.2,4,4,CTCATTGCGGACAAAGGTAG,0,1871882
hyuA_predicted,0.2,4,4,CTCATAAAACTCGTTGTCGC,0,1859371
hyuA_predicted,0.2,4,4,CTCAGCTGGCATATGACGTT,0,1844956
hyuA_predicted,0.2,4,4,CTCAGATATGCGGCGAATAC,0,1863153
hyuA_predicted,0.2,4,4,CTCACGAGGAATTGAGGTTA,0,1835240
hyuA_predicted,0.2,4,4,CTCAATCCATTGGCGTTGTG,0,1877233
hyuA_predicted,0.2,4,4,CTATGTCCTTGGAAAACACA,0,1836217
hyuA_predicted,0.2,4,4,CTATCTCATGTTTTTACCGG,0,1868658
hyuA_predicted,0.2,4,4,CTATAGGAGTGGCCTTCTAA,0,1837521
hyuA_predicted,0.2,4,4,CTAGTCCGGACAGCTGCGTA,0,1873547
hyuA_predicted,0.2,4,4,CTAGGTGGCATACGTGGACA,0,1873993
hyuA_predicted,0.2,4,4,CTAGGATGGCCGCTTACGAG,0,1840458
hyuA_predicted,0.2,4,4,CTAGCCTCCCCGTCACATCA,0,1863198
hyuA_predicted,0.2,4,4,CTACTAATTGGCGTGGCCCA,0,1852146
hyuA_predicted,0.2,4,4,CTACGGTAAGCCAGAACGTT,0,1845881
hyuA_predicted,0.2,4,4,CTACAGTAGCGTCAGACTGA,0,1838909
hyuA_predicted,0.2,4,4,CTACAGCGGGGCATTGAGGG,0,1851527
hyuA_predicted,0.2,4,4,CTAATTTATCTCCAGCTAGT,0,1833282
hyuA_predicted,0.2,4,4,CTAATCGGGCAACGGATAAC,0,1850539
hyuA_predicted,0.2,4,4,CTAAGCGTATAGCAGGATAC,0,1838023
hyuA_predicted,0.2,4,4,CTAACTACTTCAGCGTTCGG,0,1841401
hyuA_predicted,0.2,4,4,CTAACGGCTATAACGGTAGG,0,1841530
hyuA_predicted,0.2,4,4,CTAAAGGGGTACGGCCATTT,0,1829154
hyuA_predicted,0.2,4,4,CGTTTTGGGCCACCAACATT,0,1873202
hyuA_predicted,0.2,4,4,CGTTTCGACCGCCGGGCTTT,0,1856822
hyuA_predicted,0.2,4,4,CGTTGCGCTCTTAGAATACG,0,1847374
hyuA_predicted,0.2,4,4,CGTTGCCAAACTATTAAGAA,0,1842832
hyuA_predicted,0.2,4,4,CGTTATGTCAATACAGAAAC,0,1854408
hyuA_predicted,0.2,4,4,CGTTAAAGAGCAGCTACTCG,0,1867435
hyuA_predicted,0.2,4,4,CGTGTAGTTCATGATGCTAC,0,1832635
hyuA_predicted,0.2,4,4,CGTGGACCCCTAGTATGGTA,0,1843180
hyuA_predicted,0.2,4,4,CGTCTCGGATAATTAGGACC,0,1837511
hyuA_predicted,0.2,4,4,CGTATTGCCCGTGTAGTTTA,0,1865295
hyuA_predicted,0.2,4,4,CGTATTAGCCACGTCCCTCT,0,1842506
hyuA_predicted,0.2,4,4,CGTATGTCCGTCTATGAGTA,0,1835195
hyuA_predicted,0.2,4,4,CGTAGTAACGACGCATCTAG,0,1853325
hyuA_predicted,0.2,4,4,CGTAGCTGCGGCCAGCCTTG,0,1874305
hyuA_predicted,0.2,4,4,CGTAACGGTAGAGACCTGCA,0,1872167
hyuA_predicted,0.2,4,4,CGTAAAAGAATTATGCCGTC,0,1857199
hyuA_predicted,0.2,4,4,CGGTTACACCGATGATCTGC,0,1874122
hyuA_predicted,0.2,4,4,CGGTCGCAAGAGTGGGTGCC,0,1840734
hyuA_predicted,0.2,4,4,CGGTATAACGTGCGCGAGAT,0,1848960
hyuA_predicted,0.2,4,4,CGGTAACACGTGCGAGATTC,0,1871797
hyuA_predicted,0.2,4,4,CGGGGGGGTTCAAACTCCTT,0,1869167
hyuA_predicted,0.2,4,4,CGGGGGCTGCGGGGGATCAG,0,1845566
hyuA_predicted,0.2,4,4,CGGGCATTGCTAATAAAGCG,0,1834619
hyuA_predicted,0.2,4,4,CGGCAGCTCTCATCGCTGGA,0,1872594
hyuA_predicted,0.2,4,4,CGGATGATTAGTGTAGAATC,0,1863565
hyuA_predicted,0.2,4,4,CGGATACACTGTCGCACGCA,0,1844441
hyuA_predicted,0.2,4,4,CGGAGTACTGATTGAGATGG,0,1858533
hyuA_predicted,0.2,4,4,CGGACACAGGGAACTCTCGG,0,1861241
hyuA_predicted,0.2,4,4,CGCTGTCCAAGATTACAACT,0,1836245
hyuA_predicted,0.2,4,4,CGCTCGATTTACTATCTCTG,0,1866564
hyuA_predicted,0.2,4,4,CGCTAGCTCCACCGCAGAGC,0,1839781
hyuA_predicted,0.2,4,4,CGCTACAGCCTGGGCGCACT,0,1843172
hyuA_predicted,0.2,4,4,CGCTAACTTGCACGTTCAAG,0,1875155
hyuA_predicted,0.2,4,4,CGCGTGTTGGATTACTTTGT,0,1866679
hyuA_predicted,0.2,4,4,CGCGTGCGATTCCGTAAGGG,0,1854526
hyuA_predicted,0.2,4,4,CGCGTGACCTGATCTCATTA,0,1875380
hyuA_predicted,0.2,4,4,CGCCTGGCCTCGGTGGTCGA,0,1852350
hyuA_predicted,0.2,4,4,CGCCCTGGAGTGAGCGCCAA,0,1838263
hyuA_predicted,0.2,4,4,CGCCCGTACAGAGACAGACC,0,1837492
hyuA_predicted,0.2,4,4,CGCCAGACAGCCGATGATGA,0,1869166
hyuA_predicted,0.2,4,4,CGCATGGGGCGCTGATTTAT,0,1875082
hyuA_predicted,0.2,4,4,CGCATCACTCCGTAAGGTAG,0,1875184
hyuA_predicted,0.2,4,4,CGCACCACGGGACAACCCAC,0,1831736
hyuA_predicted,0.2,4,4,CGATTCACCGGTGTAGGCCT,0,1836369
hyuA_predicted,0.2,4,4,CGATTATCCTCTAGTTGCGG,0,1869502
hyuA_predicted,0.2,4,4,CGATGTGACTATTTAATTAC,0,1876881
hyuA_predicted,0.2,4,4,CGATACGATAAGACTTTGTA,0,1862675
hyuA_predicted,0.2,4,4,CGAGTATTACTGGGAAACAA,0,1856005
hyuA_predicted,0.2,4,4,CGAGGTACTCTTATTTGTTA,0,1840374
hyuA_predicted,0.2,4,4,CGAGGACGTCAGAGGCGGCG,0,1851494
hyuA_predicted,0.2,4,4,CGAGCTCGACCGGTCTTTTG,0,1868191
hyuA_predicted,0.2,4,4,CGAGCGTCCTACGTCAATAT,0,1877490
hyuA_predicted,0.2,4,4,CGAGATAGATGGTCCGTGGC,0,1876073
hyuA_predicted,0.2,4,4,CGACGATTTAATTGTCCTAC,0,1846346
hyuA_predicted,0.2,4,4,CGACCTGACCCATGACCGCA,0,1855183
hyuA_predicted,0.2,4,4,CGACCATCTTAACGCTACGG,0,1869531
hyuA_predicted,0.2,4,4,CGAAGTGATCCACTGTGTCA,0,1861899
hyuA_predicted,0.2,4,4,CGAACATAGTGTGCCGTCTT,0,1844493
hyuA_predicted,0.2,4,4,CGAAAATGGTGGACAGATAC,0,1854357
hyuA_predicted,0.2,4,4,CCTTGTCTATGCCACTGCCG,0,1858758
hyuA_predicted,0.2,4,4,CCTTGTCGCGGCTAAAGCTA,0,1853044
hyuA_predicted,0.2,4,4,CCTTGAGCGATAGGGTAGTT,0,1863253
hyuA_predicted,0.2,4,4,CCTTCAGACATGTTACGGCA,0,1850947
hyuA_predicted,0.2,4,4,CCTTAGACACATCATAGATA,0,1852883
hyuA_predicted,0.2,4,4,CCTGTCGGTTCTGAAGCGAA,0,1834564
hyuA_predicted,0.2,4,4,CCTGTATAAATCAGGGGCGG,0,1829418
hyuA_predicted,0.2,4,4,CCTGGGATAACGCAACGTCC,0,1868150
hyuA_predicted,0.2,4,4,CCTCGTGGTGCGATCTGTCA,0,1873144
hyuA_predicted,0.2,4,4,CCTCGTGAACGCTATGGCCC,0,1847821
hyuA_predicted,0.2,4,4,CCTCAGAAATCGGCGGAAGG,0,1877295
hyuA_predicted,0.2,4,4,CCTAGGTGAGTGGGACTGCA,0,1846638
hyuA_predicted,0.2,4,4,CCTACGACATGGCGTACCGC,0,1839133
hyuA_predicted,0.2,4,4,CCTACCCAAAACAATAGCTC,0,1848614
hyuA_predicted,0.2,4,4,CCTAATGATTGGAGGTTGCG,0,1834937
hyuA_predicted,0.2,4,4,CCGTGGTTGCAGTCAAGACA,0,1865115
hyuA_predicted,0.2,4,4,CCGTGAAGACGCTGGAACGA,0,1856965
hyuA_predicted,0.2,4,4,CCGTCCAGGTTCCCGGCACA,0,1860929
hyuA_predicted,0.2,4,4,CCGTAGTTTGAAAAAATGCC,0,1833093
hyuA_predicted,0.2,4,4,CCGGTGCTCGCTCTGGTCTA,0,1839751
hyuA_predicted,0.2,4,4,CCGGTAGTTTTATGCGTCCT,0,1868341
hyuA_predicted,0.2,4,4,CCGGAGTCCAAGGGAAATGA,0,1866602
hyuA_predicted,0.2,4,4,CCGGACCCGGAAGGGGCATT,0,1874578
hyuA_predicted,0.2,4,4,CCGCTTTTCTTCCGTAGATT,0,1836176
hyuA_predicted,0.2,4,4,CCGCGGACTCTCTGCCGACC,0,1838653
hyuA_predicted,0.2,4,4,CCGCAGAGCGTTTACTTTTC,0,1865090
hyuA_predicted,0.2,4,4,CCGCAATCTCGAATCGGGTC,0,1867606
hyuA_predicted,0.2,4,4,CCGAGTTCGAATTACCGCAG,0,1836404
hyuA_predicted,0.2,4,4,CCGAGATATACGCGGGGGTA,0,1861337
hyuA_predicted,0.2,4,4,CCGACGAGGCTGGGCGGCAT,0,1854231
hyuA_predicted,0.2,4,4,CCCTTCCCGATGAGCGTGGA,0,1846168
hyuA_predicted,0.2,4,4,CCCTGCAGTTAGGGCAGCTC,0,1859907
hyuA_predicted,0.2,4,4,CCCTGAGAACACCAGATTTG,0,1865364
hyuA_predicted,0.2,4,4,CCCTATCGCTCTCATGGGAG,0,1867188
hyuA_predicted,0.2,4,4,CCCTACTACGGCATGAGGGT,0,1872098
hyuA_predicted,0.2,4,4,CCCGGGCAGCTATTACACAC,0,1831952
hyuA_predicted,0.2,4,4,CCCGATGGCAATTTCCACCG,0,1873682
hyuA_predicted,0.2,4,4,CCCGAGTTTATTCGTGAATC,0,1857111
hyuA_predicted,0.2,4,4,CCCCTATGAAAGCAACGGCC,0,1845360
hyuA_predicted,0.2,4,4,CCCCCACGCCAATGTTCCAA,0,1856032
hyuA_predicted,0.2,4,4,CCCCATCTGGGTCGCCCTGG,0,1850409
hyuA_predicted,0.2,4,4,CCCATTTGCCGGCGCATTAA,0,1838849
hyuA_predicted,0.2,4,4,CCATTTACAAATGTGAATGG,0,1870953
hyuA_predicted,0.2,4,4,CCATTAGTCCGACCCTCAGG,0,1862767
hyuA_predicted,0.2,4,4,CCATTAGATAACACTCGGGC,0,1830410
hyuA_predicted,0.2,4,4,CCATGTGTAACACTATGAGA,0,1856526
hyuA_predicted,0.2,4,4,CCATGGGGAGGGAAAGGTTG,0,1877483
hyuA_predicted,0.2,4,4,CCATGCTTTTAAAAGGTCTA,0,1870469
hyuA_predicted,0.2,4,4,CCATGAAAGCTGGGTAATTA,0,1831099
hyuA_predicted,0.2,4,4,CCAGTGCTGTTTGGGAGGTT,0,1861289
hyuA_predicted,0.2,4,4,CCAGGTTTGACGAATTCAGT,0,1872485
hyuA_predicted,0.2,4,4,CCAGGGTGATCAGTCCGCCT,0,1830348
hyuA_predicted,0.2,4,4,CCAGCTTCTGGGCAACCGGC,0,1870895
hyuA_predicted,0.2,4,4,CCAGCACCGGTTTCCAAGTG,0,1863289
hyuA_predicted,0.2,4,4,CCACTTGCTTGCTGTGAAAT,0,1866182
hyuA_predicted,0.2,4,4,CCACTGGAGTTTCTTCAACT,0,1840423
hyuA_predicted,0.2,4,4,CCACTCCATAGAAAGAACAA,0,1870556
hyuA_predicted,0.2,4,4,CCACTAGGTAGTCCATATTA,0,1875353
hyuA_predicted,0.2,4,4,CCACCAGGCCGTCGAGCGTT,0,1876314
hyuA_predicted,0.2,4,4,CCAATTCTCTTTTGAGATCT,0,1861767
hyuA_predicted,0.2,4,4,CCAATCAATGCTCCAATCTC,0,1874248
hyuA_predicted,0.2,4,4,CCAACCGGGAGTAAAGAATC,0,1840960
hyuA_predicted,0.2,4,4,CATTTTTGGTGGTGTAGCTC,0,1870611
hyuA_predicted,0.2,4,4,CATTGTATAGCGCTGTGATG,0,1868563
hyuA_predicted,0.2,4,4,CATTGCACGGGGCAATGCTA,0,1857015
hyuA_predicted,0.2,4,4,CATTGAGATACGTATGCGCT,0,1833267
hyuA_predicted,0.2,4,4,CATTCTTAGGACCTTCCACA,0,1847073
hyuA_predicted,0.2,4,4,CATTATGTACGGGCCGCTCT,0,1872305
hyuA_predicted,0.2,4,4,CATGTATTGTCTCCGTCCGA,0,1848837
hyuA_predicted,0.2,4,4,CATGGCTCACGGTCACGCAT,0,1869599
hyuA_predicted,0.2,4,4,CATGCTATAACCAGCGCTAC,0,1857754
hyuA_predicted,0.2,4,4,CATGAGCTCTATCGAGTATG,0,1867052
hyuA_predicted,0.2,4,4,CATCCTATGGTATGTTCCAA,0,1854540
hyuA_predicted,0.2,4,4,CATCCAAGTTGCGTCCGACG,0,1842601
hyuA_predicted,0.2,4,4,CATCATTGTTTAAAGTGACT,0,1843156
hyuA_predicted,0.2,4,4,CAGTTGCGAGTGACTAGCTT,0,1860594
hyuA_predicted,0.2,4,4,CAGTTGAGGGCCATCGCGAA,0,1871082
hyuA_predicted,0.2,4,4,CAGTTGAACATGAGTGCTAT,0,1849342
hyuA_predicted,0.2,4,4,CAGTGGGGTCAGAAAAAGAA,0,1835119
hyuA_predicted,0.2,4,4,CAGTCTAGACTGGCCCGAAA,0,1848421
hyuA_predicted,0.2,4,4,CAGTCGCTACCAATCGAGTC,0,1837986
hyuA_predicted,0.2,4,4,CAGGGGGGAAATTACGTCAA,0,1841624
hyuA_predicted,0.2,4,4,CAGGCCTACCACCTTTACGT,0,1853001
hyuA_predicted,0.2,4,4,CAGGAGGGGCATAATCCCAT,0,1860839
hyuA_predicted,0.2,4,4,CAGGACTGGTAGCACGTGGA,0,1849432
hyuA_predicted,0.2,4,4,CAGCTCGGCTCTACTACGGT,0,1875275
hyuA_predicted,0.2,4,4,CAGCGTTGAAGCCCGACCAA,0,1858066
hyuA_predicted,0.2,4,4,CAGCGTTCGCTTCTGGTAAC,0,1839695
hyuA_predicted,0.2,4,4,CAGCCTCACGACCCTATCGT,0,1847033
hyuA_predicted,0.2,4,4,CAGCATACCAGTTACAACAG,0,1859719
hyuA_predicted,0.2,4,4,CAGCAACGCACAGGTAAACA,0,1844979
hyuA_predicted,0.2,4,4,CAGATCAAATAGAAATTAGG,0,1859284
hyuA_predicted,0.2,4,4,CAGAGTGCGACAAGTAAGTC,0,1871605
hyuA_predicted,0.2,4,4,CAGAGGATCTATGTTCTAAG,0,1873711
hyuA_predicted,0.2,4,4,CACTTACAGTACCTACGAGT,0,1836167
hyuA_predicted,0.2,4,4,CACTGTACGGGGACAGACAA,0,1860346
hyuA_predicted,0.2,4,4,CACTCTCGCACGTATTTTTC,0,1849107
hyuA_predicted,0.2,4,4,CACGTTCACCCGCACCGAAT,0,1847697
hyuA_predicted,0.2,4,4,CACGGCGCCACATCTGTCTC,0,1852305
hyuA_predicted,0.2,4,4,CACGCGCAGAACGGTACCCC,0,1857366
hyuA_predicted,0.2,4,4,CACCTCTGAGAGACGCTGAC,0,1850638
hyuA_predicted,0.2,4,4,CACCCTGCTCCGTTTCGAGT,0,1866508
hyuA_predicted,0.2,4,4,CACCCCCGCGTTTGATATGG,0,1877115
hyuA_predicted,0.2,4,4,CACCACTATTACTCCTCCAG,0,1859870
hyuA_predicted,0.2,4,4,CACAGTCTGCTAGTATGGCG,0,1833635
hyuA_predicted,0.2,4,4,CACAGCTATGGCTGGTCTTC,0,1835746
hyuA_predicted,0.2,4,4,CACAAGATTCGAGTCGTCTG,0,1852367
hyuA_predicted,0.2,4,4,CACAACCATGTCGGAGGTTT,0,1875890
hyuA_predicted,0.2,4,4,CACAAAGGCAAACCGGACGC,0,1841528
hyuA_predicted,0.2,4,4,CAATTTTTGTGAGCCGATTA,0,1833716
hyuA_predicted,0.2,4,4,CAATTTGGGGCATCAAAAGT,0,1863969
hyuA_predicted,0.2,4,4,CAATGGGTTCGAACGTATTA,0,1837461
hyuA_predicted,0.2,4,4,CAATGCCCTGTGGGCTGGCG,0,1850839
hyuA_predicted,0.2,4,4,CAATCTATGAGATCTGCCCA,0,1841475
hyuA_predicted,0.2,4,4,CAATAACGGTAATTATGTTC,0,1831298
hyuA_predicted,0.2,4,4,CAAGTTAACATTATATTGAG,0,1867766
hyuA_predicted,0.2,4,4,CAAGTAGCATCGACAGAATA,0,1877034
hyuA_predicted,0.2,4,4,CAAGGTTGCCCTAAGATCAT,0,1872723
hyuA_predicted,0.2,4,4,CAAGGAAACGTCCCGGATCT,0,1856088
hyuA_predicted,0.2,4,4,CAACGCCTTAGCATCTCTTT,0,1837284
hyuA_predicted,0.2,4,4,CAACGCACACACTACTGTGC,0,1832623
hyuA_predicted,0.2,4,4,CAACCACTCCCGCAACAGCA,0,1834704
hyuA_predicted,0.2,4,4,CAACATCCCACTGGGAGAGC,0,1875979
hyuA_predicted,0.2,4,4,CAACAGGCAGAAACTATGAG,0,1832504
hyuA_predicted,0.2,4,4,CAACAACTTCGCGACACGAT,0,1837810
hyuA_predicted,0.2,4,4,CAAATTCCCCCAAAGGTTGC,0,1863499
hyuA_predicted,0.2,4,4,CAAACAGGGGCCACATCACA,0,1872125
hyuA_predicted,0.2,4,4,CAAACACAAGCGGCTTCAGA,0,1843919
hyuA_predicted,0.2,4,4,CAAAACATGTGGTGGTGTGC,0,1870210
hyuA_predicted,0.2,4,4,ATTTTTACGGAACGAAATGC,0,1837365
hyuA_predicted,0.2,4,4,ATTTTGATTTTGTCGTTGTC,0,1836155
hyuA_predicted,0.2,4,4,ATTTTCGGAGTTCACACGAT,0,1877162
hyuA_predicted,0.2,4,4,ATTTGCGCTGAAGATCGGAA,0,1837496
hyuA_predicted,0.2,4,4,ATTGTGATGGAGAGTTGGTC,0,1848071
hyuA_predicted,0.2,4,4,ATTGTCATTCGGGGTCGTCC,0,1843642
hyuA_predicted,0.2,4,4,ATTGCTGAAGCTGTATGGAA,0,1858799
hyuA_predicted,0.2,4,4,ATTGACGTTGGCCCCAGTAC,0,1847284
hyuA_predicted,0.2,4,4,ATTCTCCGGCGCATCCCGTT,0,1871879
hyuA_predicted,0.2,4,4,ATTCGTTGTGTATTCATGAG,0,1872569
hyuA_predicted,0.2,4,4,ATTCGCCAGACAGGGAGTAA,0,1860783
hyuA_predicted,0.2,4,4,ATTCCACAACGATGTGCTTC,0,1845454
hyuA_predicted,0.2,4,4,ATTCAGGTCTTCCTAGGAAT,0,1876639
hyuA_predicted,0.2,4,4,ATTCAAGGGCATGACCACTC,0,1849200
hyuA_predicted,0.2,4,4,ATTATTGACTCGAAAGAAAC,0,1876878
hyuA_predicted,0.2,4,4,ATTAGTTAGTGCGATTAGCG,0,1833099
hyuA_predicted,0.2,4,4,ATTAGTACAAAAGCCATGGC,0,1864099
hyuA_predicted,0.2,4,4,ATTAGCTTCATGCCACTCAG,0,1865590
hyuA_predicted,0.2,4,4,ATTAGCGCTGATTAACCTAT,0,1875868
hyuA_predicted,0.2,4,4,ATTAGCCTCACTAACGCTGT,0,1877413
hyuA_predicted,0.2,4,4,ATTACGCCGCCATCGTGCTT,0,1871128
hyuA_predicted,0.2,4,4,ATTAACTGGTGGACAAATAG,0,1850378
hyuA_predicted,0.2,4,4,ATGTTTTAGCTAACAACGTT,0,1874874
hyuA_predicted,0.2,4,4,ATGTTACTACGTTCATCGCT,0,1855597
hyuA_predicted,0.2,4,4,ATGTTACACCGCCAGTCGCC,0,1837528
hyuA_predicted,0.2,4,4,ATGTGCCAAACCCACGCAAC,0,1846605
hyuA_predicted,0.2,4,4,ATGTCTGTCATCACGACTGT,0,1843854
hyuA_predicted,0.2,4,4,ATGTCCCGGAGTGTTTATCC,0,1834122
hyuA_predicted,0.2,4,4,ATGTCATGTCTTGTGTTTGA,0,1832387
hyuA_predicted,0.2,4,4,ATGTACGAATAAGATGAATA,0,1877200
hyuA_predicted,0.2,4,4,ATGTAAATAACTTGGCCTAC,0,1831337
hyuA_predicted,0.2,4,4,ATGGTACGGATGCGACGCGT,0,1829988
hyuA_predicted,0.2,4,4,ATGGGAGTTCGTCGTTCCCG,0,1844087
hyuA_predicted,0.2,4,4,ATGGAGAAGATATTACTTGC,0,1866457
hyuA_predicted,0.2,4,4,ATGCGCTGTTATGGTCATTG,0,1836690
hyuA_predicted,0.2,4,4,ATGCCCTGGGCCACCCCCAT,0,1848398
hyuA_predicted,0.2,4,4,ATGCCAGTCAAGGATAAATT,0,1841844
hyuA_predicted,0.2,4,4,ATGATGGTCCTTTAATTTTT,0,1843898
hyuA_predicted,0.2,4,4,ATGAGACACAGCACACGAGT,0,1866282
hyuA_predicted,0.2,4,4,ATGACACCGGGGACAGTTTG,0,1853250
hyuA_predicted,0.2,4,4,ATCTCCTTTGAAGGGAGAAA,0,1858293
hyuA_predicted,0.2,4,4,ATCGGGCCACCGCTGACGAT,0,1876981
hyuA_predicted,0.2,4,4,ATCGCAGGACTAATGCCTCA,0,1836701
hyuA_predicted,0.2,4,4,ATCCTTGATCGACGAGCTCT,0,1843668
hyuA_predicted,0.2,4,4,ATCCTAGGTTAACAGCCTTC,0,1864257
hyuA_predicted,0.2,4,4,ATCCCGGAGCACCACCTAAT,0,1861213
hyuA_predicted,0.2,4,4,ATCATTGGCTGGTTGCAGAC,0,1835227
hyuA_predicted,0.2,4,4,ATCAGACTCGTCCAAAGTGA,0,1833820
hyuA_predicted,0.2,4,4,ATCACATACATTTTGAGAGA,0,1864691
hyuA_predicted,0.2,4,4,ATCAACCTCAAATCACCGCT,0,1841503
hyuA_predicted,0.2,4,4,ATCAAAAGACTGGATACTTC,0,1843267
hyuA_predicted,0.2,4,4,ATATGTTCTTTCCGTAGCTT,0,1857537
hyuA_predicted,0.2,4,4,ATATGTCCTTCCTGCATGTA,0,1870774
hyuA_predicted,0.2,4,4,ATATGAGCTCTCGATATTGA,0,1876626
hyuA_predicted,0.2,4,4,ATATGAGAGGTGTCGATTGC,0,1871516
hyuA_predicted,0.2,4,4,ATATATTCTAAACTCTTCTT,0,1852047
hyuA_predicted,0.2,4,4,ATAGGGGCTCGGGTCGTCAT,0,1864109
hyuA_predicted,0.2,4,4,ATAGAGAATGTAAGGTACTC,0,1870583
hyuA_predicted,0.2,4,4,ATACAAATAAAGAGGCTAGT,0,1860102
hyuA_predicted,0.2,4,4,ATAATTCACGTAGTCCCAGT,0,1837965
hyuA_predicted,0.2,4,4,ATAATCGACTGCAAATGTGT,0,1836958
hyuA_predicted,0.2,4,4,ATAAGGCCGTATACTGACAC,0,1871655
hyuA_predicted,0.2,4,4,AGTTTTCGAGCCTTTACAAA,0,1838118
hyuA_predicted,0.2,4,4,AGTTCTGCGCGGGTCTTTAT,0,1829614
hyuA_predicted,0.2,4,4,AGTTACCTTCAAAGCAACAT,0,1876673
hyuA_predicted,0.2,4,4,AGTGGGGTGCGAAAGGTGCA,0,1855969
hyuA_predicted,0.2,4,4,AGTGCGGCATTGACCCAGGA,0,1856828
hyuA_predicted,0.2,4,4,AGTCACAAAAATACCTGTCG,0,1875987
hyuA_predicted,0.2,4,4,AGTATCCGGGTCTTGCAGGG,0,1851003
hyuA_predicted,0.2,4,4,AGTATAGCCGCGCTAGAGCT,0,1865197
hyuA_predicted,0.2,4,4,AGTACGTGGACCACACGGTA,0,1866101
hyuA_predicted,0.2,4,4,AGTAACATGTTGGAGCGGTG,0,1862712
hyuA_predicted,0.2,4,4,AGGTTCCCACATCGATAGAA,0,1864821
hyuA_predicted,0.2,4,4,AGGGTCCGAGTCCATGTGAA,0,1868661
hyuA_predicted,0.2,4,4,AGGGTCAGCATGATCTTCTG,0,1866763
hyuA_predicted,0.2,4,4,AGGGTATGGATGAGTATATG,0,1867066
hyuA_predicted,0.2,4,4,AGGGGTTAGTTCGCAGTAAT,0,1863957
hyuA_predicted,0.2,4,4,AGGGGTCTGCCCGGAACGAT,0,1858449
hyuA_predicted,0.2,4,4,AGGGGTCCCCTATGATACTT,0,1830030
hyuA_predicted,0.2,4,4,AGGGAGAGGCGTACTGGGTG,0,1859985
hyuA_predicted,0.2,4,4,AGGCGCATCCCTCGACAAGG,0,1872539
hyuA_predicted,0.2,4,4,AGGATTCGAGATATCCGAGG,0,1867575
hyuA_predicted,0.2,4,4,AGGATCTGATAGGTAGGCGC,0,1833013
hyuA_predicted,0.2,4,4,AGGAATGTATTTCAATCTTG,0,1854510
hyuA_predicted,0.2,4,4,AGGAACTTAGGGCGATAGGG,0,1845029
hyuA_predicted,0.2,4,4,AGCTGGCCGATACTTGATCC,0,1869778
hyuA_predicted,0.2,4,4,AGCTGGATGCAACTTGCCGA,0,1846837
hyuA_predicted,0.2,4,4,AGCTGAGGCGCCTCCCCTAT,0,1864316
hyuA_predicted,0.2,4,4,AGCGTAACTGAATCAGACAT,0,1859279
hyuA_predicted,0.2,4,4,AGCGCATAAAAGACTGGGCA,0,1857843
hyuA_predicted,0.2,4,4,AGCCTTGGGGCAAGCCCCAA,0,1844145
hyuA_predicted,0.2,4,4,AGCCTGAAGGGTACTTCTGA,0,1849886
hyuA_predicted,0.2,4,4,AGCCTCAGGATTAGCTGAAT,0,1871364
hyuA_predicted,0.2,4,4,AGCATTGCCGGGTTGGCACA,0,1851298
hyuA_predicted,0.2,4,4,AGCATTCCGACTGTCCCTAA,0,1866506
hyuA_predicted,0.2,4,4,AGCATCCAACAATCCCGACA,0,1860741
hyuA_predicted,0.2,4,4,AGCAGTTTACTACCTACATA,0,1842912
hyuA_predicted,0.2,4,4,AGCAGAGGTGTATTAGTGAG,0,1857021
hyuA_predicted,0.2,4,4,AGCAGACCGAAATCCGTTCG,0,1849477
hyuA_predicted,0.2,4,4,AGCACCCTGCTCTCAAAAAT,0,1829778
hyuA_predicted,0.2,4,4,AGCAAACTCGTCATTCGACA,0,1852743
hyuA_predicted,0.2,4,4,AGATACGCTCCTTGCGTTTG,0,1839139
hyuA_predicted,0.2,4,4,AGAGCCTATGTTCACCTTCG,0,1874791
hyuA_predicted,0.2,4,4,AGAGCAGACAACACTAAGAG,0,1839155
hyuA_predicted,0.2,4,4,AGAGAGGTCGTACGTATTAG,0,1848548
hyuA_predicted,0.2,4,4,AGACGAGGCCTCCGAGCGGC,0,1840076
hyuA_predicted,0.2,4,4,AGAAGGTCACCAAAGCTGTT,0,1874076
hyuA_predicted,0.2,4,4,AGAAGAAGTTTCCAGTTGTC,0,1864875
hyuA_predicted,0.2,4,4,ACTTAGGACGACAGTATTGA,0,1862659
hyuA_predicted,0.2,4,4,ACTGTGGTCAGTGCCCCGGC,0,1867792
hyuA_predicted,0.2,4,4,ACTGTCCAAGGTGCCACGAC,0,1835838
hyuA_predicted,0.2,4,4,ACTGTCACACTATTTACTCG,0,1858068
hyuA_predicted,0.2,4,4,ACTGGTTTCATTAGGTGAAT,0,1839577
hyuA_predicted,0.2,4,4,ACTGGTACGTAGGTGAAGGG,0,1831094
hyuA_predicted,0.2,4,4,ACTGACTAGCGGCGCGTTGC,0,1834832
hyuA_predicted,0.2,4,4,ACTCAAGTCACGTAACTCCA,0,1854919
hyuA_predicted,0.2,4,4,ACTACTTGGGGTGCACAGAC,0,1876793
hyuA_predicted,0.2,4,4,ACGTTCCCTAGTAGGCCTCA,0,1841349
hyuA_predicted,0.2,4,4,ACGTGTTATGGTCAGCACGC,0,1877380
hyuA_predicted,0.2,4,4,ACGTGCGCCGGAGGTTTGCA,0,1839115
hyuA_predicted,0.2,4,4,ACGTGCGACTGCATGGTTAA,0,1840895
hyuA_predicted,0.2,4,4,ACGTCTTACGCGCATGTACG,0,1831079
hyuA_predicted,0.2,4,4,ACGTCGGGTTTCCGCCGCGT,0,1858759
hyuA_predicted,0.2,4,4,ACGTCGCTATCTGAGCTAGC,0,1841540
hyuA_predicted,0.2,4,4,ACGGTGGGGGGCTGCTCTTA,0,1860387
hyuA_predicted,0.2,4,4,ACGGTCTCGACTGGGTTGCG,0,1861724
hyuA_predicted,0.2,4,4,ACGCTTCGGGTAATTCACGG,0,1832973
hyuA_predicted,0.2,4,4,ACGCGGGTTAGCTTGGAACT,0,1843455
hyuA_predicted,0.2,4,4,ACGCGCTTATGCTGTGCCCG,0,1852036
hyuA_predicted,0.2,4,4,ACGCATGCGCATGCTAGAAT,0,1861048
hyuA_predicted,0.2,4,4,ACGCAGTAGCAGCATGCTGA,0,1845718
hyuA_predicted,0.2,4,4,ACGCACTGCGAAGTAGGGCT,0,1870074
hyuA_predicted,0.2,4,4,ACGATCCGCCCCAAGTTCGC,0,1863846
hyuA_predicted,0.2,4,4,ACGAATGGGTATCAAGAGTT,0,1835563
hyuA_predicted,0.2,4,4,ACCTCGGCGACGCCTGATGG,0,1845299
hyuA_predicted,0.2,4,4,ACCGTGTGGTCCTTCGTTCG,0,1862979
hyuA_predicted,0.2,4,4,ACCGGTTACCTCTCTCCAGC,0,1855855
hyuA_predicted,0.2,4,4,ACCGGCACGGTCTACGCACG,0,1835180
hyuA_predicted,0.2,4,4,ACCGACTACAATAGTGTAGG,0,1868197
hyuA_predicted,0.2,4,4,ACCCCGCCCGTAGCCCTATC,0,1837551
hyuA_predicted,0.2,4,4,ACCCAATGGGCATGTTAATT,0,1869965
hyuA_predicted,0.2,4,4,ACCATGGAAGGACCTTCGAG,0,1842237
hyuA_predicted,0.2,4,4,ACCACAACGCGGCCATAGAA,0,1843584
hyuA_predicted,0.2,4,4,ACAGGGGAGTGTATTGTGTG,0,1829062
hyuA_predicted,0.2,4,4,ACAGCTGCATGGGACGTCAA,0,1856547
hyuA_predicted,0.2,4,4,ACAGCCAAGATCCTTTAGAT,0,1829142
hyuA_predicted,0.2,4,4,ACACTATCGGTAGTTAGAGA,0,1842917
hyuA_predicted,0.2,4,4,ACACTAAATCTATCATCCAC,0,1846979
hyuA_predicted,0.2,4,4,ACACGCAACACATTGTTTCC,0,1839274
hyuA_predicted,0.2,4,4,ACACATCCATAGAGTGCATA,0,1836470
hyuA_predicted,0.2,4,4,ACAATTCTATCCAATTGTTA,0,1844049
hyuA_predicted,0.2,4,4,ACAATGCTAAATCTTTGGTC,0,1852899
hyuA_predicted,0.2,4,4,ACAATCGGTGAAGAGCTGAG,0,1857201
hyuA_predicted,0.2,4,4,ACAATCGAAGACGGTCCATA,0,1862441
hyuA_predicted,0.2,4,4,ACAATAGCGGGACGCTTCAT,0,1861862
hyuA_predicted,0.2,4,4,ACAAGGAATGCACGCTCACA,0,1853986
hyuA_predicted,0.2,4,4,ACAAGGAACAGGCGCTATAG,0,1845940
hyuA_predicted,0.2,4,4,ACAAGAAGTTTAGAAAAAGA,0,1846632
hyuA_predicted,0.2,4,4,ACAACTTACTTGGCCATTGT,0,1850310
hyuA_predicted,0.2,4,4,ACAACAAGAGACCGGAAGCT,0,1841545
hyuA_predicted,0.2,4,4,AATTCCCAACCACCCACCAG,0,1848944
hyuA_predicted,0.2,4,4,AATTAGTTGGTTAACGTATT,0,1846852
hyuA_predicted,0.2,4,4,AATTAGAATAGAGCCCAATA,0,1850168
hyuA_predicted,0.2,4,4,AATGGCCGTAAGTTGTTCAA,0,1830175
hyuA_predicted,0.2,4,4,AATGATGTTCTGGGCGCCTC,0,1863641
hyuA_predicted,0.2,4,4,AATGATCACTGAATAGCCAG,0,1847453
hyuA_predicted,0.2,4,4,AATCCAGTTGAGGATGTGCC,0,1872410
hyuA_predicted,0.2,4,4,AATCAGAGTCGGCAACACGG,0,1870681
hyuA_predicted,0.2,4,4,AATAGTCTCTGATGTGGTAA,0,1867951
hyuA_predicted,0.2,4,4,AATAGGTACGAAGCGGTTGA,0,1848207
hyuA_predicted,0.2,4,4,AATAGAGTGGTCCTCTGGCG,0,1873833
hyuA_predicted,0.2,4,4,AATACGACCACTCTACACGA,0,1858407
hyuA_predicted,0.2,4,4,AATAATACGGCAAGACCCTA,0,1832915
hyuA_predicted,0.2,4,4,AATAACATCCCCTTACGGGA,0,1829250
hyuA_predicted,0.2,4,4,AAGTCGATTAATCACATCAC,0,1842280
hyuA_predicted,0.2,4,4,AAGTACTGGAGAAACACCAT,0,1841179
hyuA_predicted,0.2,4,4,AAGTACGATAGGGTTTGCAG,0,1829361
hyuA_predicted,0.2,4,4,AAGGTGGATTAAGGTACCAG,0,1839897
hyuA_predicted,0.2,4,4,AAGGGTTGCATGTTCAGAAA,0,1829177
hyuA_predicted,0.2,4,4,AAGGAAGCTTGGCGGGGAGG,0,1877645
hyuA_predicted,0.2,4,4,AAGCTTACTCAGGTGTAAAT,0,1867910
hyuA_predicted,0.2,4,4,AAGCTCGTTGCTGTCTTAGC,0,1854103
hyuA_predicted,0.2,4,4,AAGAGTGGATCAGGTTCTCT,0,1857878
hyuA_predicted,0.2,4,4,AAGAGGCACAGCAACGTCCT,0,1829616
hyuA_predicted,0.2,4,4,AAGAGCATCGATGGCATCAT,0,1832174
hyuA_predicted,0.2,4,4,AAGAGATAACGCGTGGGCGG,0,1855417
hyuA_predicted,0.2,4,4,AAGACCTGTCCATGTAGATA,0,1873414
hyuA_predicted,0.2,4,4,AACTCGGGACACGAGAATAC,0,1863024
hyuA_predicted,0.2,4,4,AACTAGCTTATCGGACCTCG,0,1862726
hyuA_predicted,0.2,4,4,AACTAGCTGTCAGTACCACG,0,1846557
hyuA_predicted,0.2,4,4,AACGGGCAAGCGACCAACTA,0,1860697
hyuA_predicted,0.2,4,4,AACGGGCAAACAGGGCGGTA,0,1867588
hyuA_predicted,0.2,4,4,AACGGCTGTCGATGAAGTCT,0,1871792
hyuA_predicted,0.2,4,4,AACGCGGCCTTGGTCAATAA,0,1833972
hyuA_predicted,0.2,4,4,AACCTTTTCAAAAATTCTAG,0,1866484
hyuA_predicted,0.2,4,4,AACCGTCAGGCCCACATATA,0,1835588
hyuA_predicted,0.2,4,4,AACCGTAAAGTCAAGGAGCT,0,1869886
hyuA_predicted,0.2,4,4,AACCATCAACTTCAGTCTTA,0,1875140
hyuA_predicted,0.2,4,4,AACATTCGCTAGCCGAATTG,0,1836456
hyuA_predicted,0.2,4,4,AACATGTCACAAGGCGTGTA,0,1834999
hyuA_predicted,0.2,4,4,AACAGTTGGTTCCAACGGGC,0,1831824
hyuA_predicted,0.2,4,4,AACACCGTACTTCTGGAGAT,0,1855924
hyuA_predicted,0.2,4,4,AACAAGGATGGTAGAAGTCG,0,1830543
hyuA_predicted,0.2,4,4,AAATTTCGCCCGATTCAGGA,0,1833815
hyuA_predicted,0.2,4,4,AAATTCTCGGTTAGATGCGA,0,1860980
hyuA_predicted,0.2,4,4,AAATCTTCCATAACTTAGTT,0,1867716
hyuA_predicted,0.2,4,4,AAATCGATAGAGGAGTGCAA,0,1852707
hyuA_predicted,0.2,4,4,AAATCAGCCAGGAAAGACGT,0,1866013
hyuA_predicted,0.2,4,4,AAAGTATCGTGTTCGTTCGC,0,1864120
hyuA_predicted,0.2,4,4,AAAGCATCTGTACTTCCAAC,0,1849270
hyuA_predicted,0.2,4,4,AAAGAATTACAAAAAAAGCA,0,1865807
hyuA_predicted,0.2,4,4,AAACTTGGGTAATCGTGATA,0,1871954
hyuA_predicted,0.2,4,4,AAACGTAGTAAAGATATGAA,0,1853283
hyuA_predicted,0.2,4,4,AAACGCTCGAGCCGACGCAA,0,1863363
hyuA_predicted,0.2,4,4,AAACGCGAGCTACAAAAGTT,0,1871056
hyuA_predicted,0.2,4,4,AAACCGCGTTTCATAAGACA,0,1865395
hyuA_predicted,0.2,4,4,AAAACGGGTAGTAAGAGAGA,0,1839725
hyuA_predicted,0.25,3,3,TTTTGTGTCAGCCTTAAGAG,0,1877407
hyuA_predicted,0.25,3,3,TTTTGGATAGTCATGGGACT,0,1850082
hyuA_predicted,0.25,3,3,TTTGGCGGGTTATTGATAAG,0,1862903
hyuA_predicted,0.25,3,3,TTTGGATAATAATCAACGAC,0,1865747
hyuA_predicted,0.25,3,3,TTTGGAAGCTGGCTACGAGG,0,1866629
hyuA_predicted,0.25,3,3,TTTGCTAATCTTCGTCAAAA,0,1837982
hyuA_predicted,0.25,3,3,TTTCTGAGGAGGACTAACTG,0,1873752
hyuA_predicted,0.25,3,3,TTTCTGACCCTGGTCATCGA,0,1859387
hyuA_predicted,0.25,3,3,TTTCTCAGTTTGAGCCTTTG,0,1830421
hyuA_predicted,0.25,3,3,TTTCCGCGGAGGTAGAAGAC,0,1871554
hyuA_predicted,0.25,3,3,TTTCCCGTGAGCATGGCGTA,0,1849523
hyuA_predicted,0.25,3,3,TTTATCGAAAAGGTTGATAG,0,1839987
hyuA_predicted,0.25,3,3,TTTATCATGACCTTTAAGTA,0,1837651
hyuA_predicted,0.25,3,3,TTTAGCGGCGTGCGAGTTTG,0,1831092
hyuA_predicted,0.25,3,3,TTTAGACGAACTTTCGTGTC,0,1872397
hyuA_predicted,0.25,3,3,TTTACCCGCGACGCCTGGCC,0,1871122
hyuA_predicted,0.25,3,3,TTTAACAATAGGATCGGAAA,0,1861508
hyuA_predicted,0.25,3,3,TTTAAAATCTCAATGTACTC,0,1838739
hyuA_predicted,0.25,3,3,TTGTTTTTTTCAAGAGACCT,0,1845994
hyuA_predicted,0.25,3,3,TTGTGGCTGTAAAATTTTGG,0,1850016
hyuA_predicted,0.25,3,3,TTGTAACAATCGGGCTAGAG,0,1846531
hyuA_predicted,0.25,3,3,TTGGTTAGATGCTCATGGAC,0,1870587
hyuA_predicted,0.25,3,3,TTGGTCAGGGCAAATTTGAT,0,1865068
hyuA_predicted,0.25,3,3,TTGGATCAGCGCGGAAAGGC,0,1844673
hyuA_predicted,0.25,3,3,TTGCGGACGCCAACTTCTTT,0,1861018
hyuA_predicted,0.25,3,3,TTGCACGCAGTGAGCCTTAG,0,1841397
hyuA_predicted,0.25,3,3,TTGATGGACGACCCTCCCAA,0,1857716
hyuA_predicted,0.25,3,3,TTGATAGTTTATCGCTATCT,0,1872561
hyuA_predicted,0.25,3,3,TTGAGTAGTTGTAGATCAGC,0,1854959
hyuA_predicted,0.25,3,3,TTGAGAAAATTTCTATTTAC,0,1870094
hyuA_predicted,0.25,3,3,TTGACGTCTGGGCAGAACCT,0,1864152
hyuA_predicted,0.25,3,3,TTGAATTAGTCCAATAGTGT,0,1850781
hyuA_predicted,0.25,3,3,TTCTTCCCTTGACGCATAGT,0,1853327
hyuA_predicted,0.25,3,3,TTCTAAAGGTTCTGACCGAC,0,1874801
hyuA_predicted,0.25,3,3,TTCGTCGCGCCGTTCCTCAT,0,1873289
hyuA_predicted,0.25,3,3,TTCGATCGTGCCTGCCAAGG,0,1830499
hyuA_predicted,0.25,3,3,TTCGAGAATGTATGCTTATC,0,1842484
hyuA_predicted,0.25,3,3,TTCCCACGAAGAGACCTTAT,0,1853654
hyuA_predicted,0.25,3,3,TTCCACCTGTCGTGAACTTG,0,1832465
hyuA_predicted,0.25,3,3,TTCATGGTGTTCTTTCATGC,0,1860599
hyuA_predicted,0.25,3,3,TTCAGCGGAAGCCCCGTTGT,0,1836649
hyuA_predicted,0.25,3,3,TTCACTTTCGCCAATTACAA,0,1864561
hyuA_predicted,0.25,3,3,TTCACAAGGCGCCAGTCATT,0,1845522
hyuA_predicted,0.25,3,3,TTCAATACTGCAACGCCTTT,0,1830882
hyuA_predicted,0.25,3,3,TTCAAACGCTTAGAGCGCGA,0,1840948
hyuA_predicted,0.25,3,3,TTATTTTAATTGTTTCTATT,0,1850454
hyuA_predicted,0.25,3,3,TTATTTCATGGTGTGTACGT,0,1861039
hyuA_predicted,0.25,3,3,TTATTATGCTCGCACAGTAT,0,1869769
hyuA_predicted,0.25,3,3,TTATGTGACGCGAATGCTGA,0,1847365
hyuA_predicted,0.25,3,3,TTATGAATCTAGAGCGTGTG,0,1846276
hyuA_predicted,0.25,3,3,TTATGAACGCCCGTTGCGGG,0,1860526
hyuA_predicted,0.25,3,3,TTATCTGCAGCTCAAATGGA,0,1858271
hyuA_predicted,0.25,3,3,TTATCCGAGGAAAATAAACT,0,1873951
hyuA_predicted,0.25,3,3,TTATACCGCGATGTCGCCGT,0,1840818
hyuA_predicted,0.25,3,3,TTAGTGCGCGCTTAGCTGCC,0,1870168
hyuA_predicted,0.25,3,3,TTAGGTTATAACGGGCATAT,0,1833185
hyuA_predicted,0.25,3,3,TTAGCGTACTAGCGGCCAAC,0,1844915
hyuA_predicted,0.25,3,3,TTAGAGGGGTTTTTTTTTAA,0,1866179
hyuA_predicted,0.25,3,3,TTACTACCGGCAACTTCCTG,0,1870109
hyuA_predicted,0.25,3,3,TTAATTTCTTTCGTCGTGGA,0,1840496
hyuA_predicted,0.25,3,3,TTAATGTGGATTAGTGACGC,0,1835047
hyuA_predicted,0.25,3,3,TTAAGTGTCATCACCTAGTA,0,1860553
hyuA_predicted,0.25,3,3,TTAAGTCGATGACACCCGTG,0,1842282
hyuA_predicted,0.25,3,3,TTAAGTACCTTCCGTCGGTA,0,1869939
hyuA_predicted,0.25,3,3,TTAAGGCGGCGACAAGTCAT,0,1852920
hyuA_predicted,0.25,3,3,TTAAAATACTATTTCATGCT,0,1845001
hyuA_predicted,0.25,3,3,TGTTTGCACACACAACAGCC,0,1839406
hyuA_predicted,0.25,3,3,TGTTTCCGTGCCCTAACATC,0,1863599
hyuA_predicted,0.25,3,3,TGTGTACAGAAACGTGATAT,0,1868084
hyuA_predicted,0.25,3,3,TGTGGTGAGGTTGGTAAGGG,0,1839111
hyuA_predicted,0.25,3,3,TGTGGGGCACTCGGGGCATT,0,1838496
hyuA_predicted,0.25,3,3,TGTGCTTGGCCTTATCCCAT,0,1855940
hyuA_predicted,0.25,3,3,TGTCTTGGTCTACGAATAAG,0,1843696
hyuA_predicted,0.25,3,3,TGTCGGAATCCAGCGGTTTC,0,1855089
hyuA_predicted,0.25,3,3,TGTCACTTTGCGCTGTCAAT,0,1852555
hyuA_predicted,0.25,3,3,TGTATCTTATCGAGCAACTT,0,1850880
hyuA_predicted,0.25,3,3,TGTACCACTAGCGCTGCTCT,0,1858867
hyuA_predicted,0.25,3,3,TGGTTGACCGTGGTAAGATC,0,1855436
hyuA_predicted,0.25,3,3,TGGTGTTTGCTGTTGTTGAA,0,1837861
hyuA_predicted,0.25,3,3,TGGGTGTCGGAGCTTTCAAA,0,1873578
hyuA_predicted,0.25,3,3,TGGGTCCCTGAGGTCGTTTA,0,1864562
hyuA_predicted,0.25,3,3,TGGGTCAATTCGCCAGGGGT,0,1867735
hyuA_predicted,0.25,3,3,TGGGTACCGAATTACTCCCA,0,1860401
hyuA_predicted,0.25,3,3,TGGGGATGCACGATTGTGAG,0,1858668
hyuA_predicted,0.25,3,3,TGGGAGAATTTGTTAAAGCG,0,1849085
hyuA_predicted,0.25,3,3,TGGGAACTCGCTTAACAACG,0,1833993
hyuA_predicted,0.25,3,3,TGGCGGATGTAGAGTGCTTA,0,1869942
hyuA_predicted,0.25,3,3,TGGCCCGTGGTCTTACGCCA,0,1856217
hyuA_predicted,0.25,3,3,TGGAGTAGAAAGTCAAGAGA,0,1852913
hyuA_predicted,0.25,3,3,TGGAAGCTGGAGACGATTGA,0,1853624
hyuA_predicted,0.25,3,3,TGGAACCTTAATACGGGGAT,0,1838413
hyuA_predicted,0.25,3,3,TGCTTGTTTACGCGAGTGTC,0,1876185
hyuA_predicted,0.25,3,3,TGCTTGCCTGTAGTCAGCCT,0,1843899
hyuA_predicted,0.25,3,3,TGCTGATCGACCCCACCAGT,0,1835416
hyuA_predicted,0.25,3,3,TGCTCCGACACTCAAAGAGC,0,1862800
hyuA_predicted,0.25,3,3,TGCTATCTTCCTCGTAATGA,0,1833051
hyuA_predicted,0.25,3,3,TGCGTCCGCTCACTGCATCT,0,1860877
hyuA_predicted,0.25,3,3,TGCGGTTGGTACGAGGACAT,0,1839357
hyuA_predicted,0.25,3,3,TGCGGTCAACTATTGTCGGA,0,1865184
hyuA_predicted,0.25,3,3,TGCGCCGACTTGTCAGACTG,0,1869556
hyuA_predicted,0.25,3,3,TGCGCAATGATACCTTGTCT,0,1873150
hyuA_predicted,0.25,3,3,TGCCTTTGGCGAGTTAGATA,0,1876954
hyuA_predicted,0.25,3,3,TGCCTTAACAGGGCTCACGT,0,1872267
hyuA_predicted,0.25,3,3,TGCCTCACGCATGGTTCCCT,0,1860337
hyuA_predicted,0.25,3,3,TGCCTACATCCGGTGCGGAC,0,1835852
hyuA_predicted,0.25,3,3,TGCCCGTACGAAGAAGTAAA,0,1852644
hyuA_predicted,0.25,3,3,TGCCAGAAGGCGTGGAACTA,0,1849364
hyuA_predicted,0.25,3,3,TGCAGGGGTTAAGCTGAGCA,0,1868760
hyuA_predicted,0.25,3,3,TGATTTTGAAGTTTCACCGT,0,1870551
hyuA_predicted,0.25,3,3,TGATTCATTTAGATGCCGGT,0,1834572
hyuA_predicted,0.25,3,3,TGATTCATCTTCCCCGCTGT,0,1844090
hyuA_predicted,0.25,3,3,TGATGTAGAGTCCGCTTTCG,0,1857272
hyuA_predicted,0.25,3,3,TGATCTAATTTCGAGGCCGG,0,1867442
hyuA_predicted,0.25,3,3,TGATCCCCTTTTCGGGGAAT,0,1851372
hyuA_predicted,0.25,3,3,TGATCACAGTTCTCTCAACA,0,1858142
hyuA_predicted,0.25,3,3,TGAGCGGCGTGCGATACCGT,0,1837803
hyuA_predicted,0.25,3,3,TGAGATTATTATCGTTCGGC,0,1843207
hyuA_predicted,0.25,3,3,TGAGAAGAAATAACGGACCT,0,1835522
hyuA_predicted,0.25,3,3,TGACTGTAAATTTTCAGCAC,0,1855176
hyuA_predicted,0.25,3,3,TGACGGATTCCTTGTGATGA,0,1849973
hyuA_predicted,0.25,3,3,TGACCGGTGGGAGGGAAAGA,0,1863976
hyuA_predicted,0.25,3,3,TGACCATTCCAAGATCGGTT,0,1861381
hyuA_predicted,0.25,3,3,TGACCATATCGGGTTTTGGG,0,1873286
hyuA_predicted,0.25,3,3,TGAATTCTTTTAGAGGCCGT,0,1829044
hyuA_predicted,0.25,3,3,TGAAGGTAGTCAAACGCTAC,0,1836172
hyuA_predicted,0.25,3,3,TGAACGGTACGGTGAGTAAT,0,1864601
hyuA_predicted,0.25,3,3,TGAAAGCTTCAGGTGTGCTC,0,1836324
hyuA_predicted,0.25,3,3,TGAAAATTTTCCTGGGACAA,0,1850733
hyuA_predicted,0.25,3,3,TCTTGTATAGCGGGACCCTT,0,1871640
hyuA_predicted,0.25,3,3,TCTTGAGTAGGCTTGTTGGG,0,1841742
hyuA_predicted,0.25,3,3,TCTTGAGTACACCCTGGGCC,0,1846163
hyuA_predicted,0.25,3,3,TCTTAGGTACGACACTCACG,0,1850407
hyuA_predicted,0.25,3,3,TCTGGAGGCATCACTACGCG,0,1872668
hyuA_predicted,0.25,3,3,TCTGCGTGACTCCGGCTCGA,0,1835060
hyuA_predicted,0.25,3,3,TCTGAAGGTCGTTGTATCGA,0,1853644
hyuA_predicted,0.25,3,3,TCTCTAACTGGAAAACGAGT,0,1845594
hyuA_predicted,0.25,3,3,TCTCGGGGTTAGACAGGAAT,0,1860592
hyuA_predicted,0.25,3,3,TCTCGCAATGGACGCCCCGT,0,1875777
hyuA_predicted,0.25,3,3,TCTCATATTGGTGCTCCCCG,0,1845030
hyuA_predicted,0.25,3,3,TCTCAGCATTTCTGAGTTAA,0,1855118
hyuA_predicted,0.25,3,3,TCTCAGACGCCATCCCGTGA,0,1860388
hyuA_predicted,0.25,3,3,TCTATAACAGCGCGAGGAAC,0,1841471
hyuA_predicted,0.25,3,3,TCTAGGAGCCTACTCTATTG,0,1846794
hyuA_predicted,0.25,3,3,TCGTTCCGGGGGTGAAGGTC,0,1863728
hyuA_predicted,0.25,3,3,TCGTACCGGACCTGAGATCT,0,1839928
hyuA_predicted,0.25,3,3,TCGGGTGGCATCGTCCATCT,0,1846484
hyuA_predicted,0.25,3,3,TCGGGTGCCGGATTTAGTCC,0,1866749
hyuA_predicted,0.25,3,3,TCGGCGTCTAGAAAACGAGA,0,1852608
hyuA_predicted,0.25,3,3,TCGGAATCTGGGGTTCATAT,0,1873157
hyuA_predicted,0.25,3,3,TCGCTGTGCAGAGGAACGTT,0,1845603
hyuA_predicted,0.25,3,3,TCGCTCGGCAGTCATGGGTA,0,1851855
hyuA_predicted,0.25,3,3,TCGCGCCCTGGCCGGCGCGC,0,1876182
hyuA_predicted,0.25,3,3,TCGCGCAGCGAGGGGTGAGG,0,1861243
hyuA_predicted,0.25,3,3,TCGCAGAACTCCGACCTGGA,0,1832004
hyuA_predicted,0.25,3,3,TCGATTCATCCACTAAGACT,0,1851649
hyuA_predicted,0.25,3,3,TCCTATGTCATATCACGTGA,0,1836355
hyuA_predicted,0.25,3,3,TCCTAATTTCCCCTGACCAC,0,1831366
hyuA_predicted,0.25,3,3,TCCGTAATGCTACGGGTTTT,0,1852381
hyuA_predicted,0.25,3,3,TCCGGTGGTCAAACCAGGAG,0,1831508
hyuA_predicted,0.25,3,3,TCCGGAATTTGCAACTTCTG,0,1860458
hyuA_predicted,0.25,3,3,TCCGCGGCATGTGCTACGGA,0,1853467
hyuA_predicted,0.25,3,3,TCCCTGTTAGACGGTGTGTC,0,1865275
hyuA_predicted,0.25,3,3,TCCCTCGCACCCTTCTACTA,0,1877783
hyuA_predicted,0.25,3,3,TCCATCTAAGCTTGCGAGGA,0,1867729
hyuA_predicted,0.25,3,3,TCATTGTCCTCAAGGTCACA,0,1848156
hyuA_predicted,0.25,3,3,TCATGTGCTCGACGGATATC,0,1872681
hyuA_predicted,0.25,3,3,TCATCATTGGTTGCTCCTCC,0,1868518
hyuA_predicted,0.25,3,3,TCATAATCTCGAGTTTAAGT,0,1863399
hyuA_predicted,0.25,3,3,TCAGGTGAGTGACGTAAGTG,0,1844911
hyuA_predicted,0.25,3,3,TCACTATTCGTCACCACGTT,0,1872824
hyuA_predicted,0.25,3,3,TCACGAAATGCAGGGTCGTG,0,1858327
hyuA_predicted,0.25,3,3,TCACCCCCGCCCAGTGATAT,0,1864719
hyuA_predicted,0.25,3,3,TCACAATTTTTCGTTTCATT,0,1832851
hyuA_predicted,0.25,3,3,TCAATCATCTTGGTTTACCC,0,1831158
hyuA_predicted,0.25,3,3,TCAACTCTGGCCGGCGGCTG,0,1875733
hyuA_predicted,0.25,3,3,TCAAACTAAAATGGGCTCTA,0,1871846
hyuA_predicted,0.25,3,3,TATTGGGCGCCGGTTCGCTT,0,1842244
hyuA_predicted,0.25,3,3,TATTCCCTTAAGCCGCCTAA,0,1861212
hyuA_predicted,0.25,3,3,TATTATGGGTCTAAGCTGGA,0,1842185
hyuA_predicted,0.25,3,3,TATTACGCTTTTTGGGCGTT,0,1846210
hyuA_predicted,0.25,3,3,TATGTCAAGGCGCCAACGTC,0,1876835
hyuA_predicted,0.25,3,3,TATGGCCTTTCGCGTCAGCC,0,1877735
hyuA_predicted,0.25,3,3,TATGATGATCGCGTCGGGAA,0,1862729
hyuA_predicted,0.25,3,3,TATGAGCGTCATAAAAGTAT,0,1834818
hyuA_predicted,0.25,3,3,TATGAAGAAATTCGATTCAA,0,1829855
hyuA_predicted,0.25,3,3,TATCGATCCTTCTCCAATCT,0,1850427
hyuA_predicted,0.25,3,3,TATCACCAAGAACTGGGCTC,0,1858568
hyuA_predicted,0.25,3,3,TATATGCCCTTCATAGAGCA,0,1829658
hyuA_predicted,0.25,3,3,TATATAATTCGCTCTGATTT,0,1831549
hyuA_predicted,0.25,3,3,TATACGTTGGCCCGTCCACT,0,1866795
hyuA_predicted,0.25,3,3,TAGTTTTGTAGGAGTTGCTA,0,1851035
hyuA_predicted,0.25,3,3,TAGGGTCCAAAGAAGCTTGG,0,1855865
hyuA_predicted,0.25,3,3,TAGGGGAGTTTTAATATAGA,0,1866148
hyuA_predicted,0.25,3,3,TAGGAATAGAGTCTGGCACC,0,1850233
hyuA_predicted,0.25,3,3,TAGCTCAGGACTACGCAGCG,0,1855849
hyuA_predicted,0.25,3,3,TAGCATACAGTTGGATAGAG,0,1847373
hyuA_predicted,0.25,3,3,TAGAGGCTTTGGTTTTGTGT,0,1843442
hyuA_predicted,0.25,3,3,TAGAGCAACAAAGCGGTGAT,0,1853920
hyuA_predicted,0.25,3,3,TAGAATATCTCCGTCAAAAA,0,1865381
hyuA_predicted,0.25,3,3,TAGAAGCACTCTACTGAAAC,0,1847527
hyuA_predicted,0.25,3,3,TAGAAAATTGCGGGACACGC,0,1877758
hyuA_predicted,0.25,3,3,TACTTACTCGTATCGATATT,0,1852054
hyuA_predicted,0.25,3,3,TACTGTGATTGGCCTGCTCA,0,1844990
hyuA_predicted,0.25,3,3,TACTACGCTAACTCTTACGA,0,1839144
hyuA_predicted,0.25,3,3,TACGTCTGATCACGATTCGC,0,1848808
hyuA_predicted,0.25,3,3,TACGTATCCAATTGGATGTT,0,1847866
hyuA_predicted,0.25,3,3,TACGTAAAAATATCCCTTCG,0,1845736
hyuA_predicted,0.25,3,3,TACGCCGTGTAATTTTAAAA,0,1860225
hyuA_predicted,0.25,3,3,TACGCATCGTATCCTGTCAA,0,1848301
hyuA_predicted,0.25,3,3,TACGAGTAGTAGGTGGCACT,0,1843936
hyuA_predicted,0.25,3,3,TACCTAGAGAGGTTCCTAAG,0,1874560
hyuA_predicted,0.25,3,3,TACCGTGGCACCAACATCGG,0,1847976
hyuA_predicted,0.25,3,3,TACCGGTCACCAGGGGGGAC,0,1832639
hyuA_predicted,0.25,3,3,TACCGATCTACGCTCTAATG,0,1874912
hyuA_predicted,0.25,3,3,TACCCTTGTTATATGTTGGT,0,1868948
hyuA_predicted,0.25,3,3,TACCCGGGTCCTAGGGTTCA,0,1857732
hyuA_predicted,0.25,3,3,TACCCCGTTAGATGCAAACC,0,1845941
hyuA_predicted,0.25,3,3,TACATGAAACATTAGGATCT,0,1829073
hyuA_predicted,0.25,3,3,TACATAGAACAGATCCAACT,0,1834320
hyuA_predicted,0.25,3,3,TACAACCTGCGACAATGAAA,0,1846422
hyuA_predicted,0.25,3,3,TAATTCAAAAGTTCCTATGT,0,1831444
hyuA_predicted,0.25,3,3,TAATCACACCGTTCTTTAAG,0,1833946
hyuA_predicted,0.25,3,3,TAAGTTGGGACCTCTTTGTT,0,1844059
hyuA_predicted,0.25,3,3,TAAGGGTTCATTAACGGATG,0,1837978
hyuA_predicted,0.25,3,3,TAAGCGAACGGTTCAACATT,0,1841810
hyuA_predicted,0.25,3,3,TAAGAAAAGTCCGATATACT,0,1867702
hyuA_predicted,0.25,3,3,TAACTTTTCCATGGGTTGAG,0,1858428
hyuA_predicted,0.25,3,3,TAACTATTCTTTATATGTAA,0,1838819
hyuA_predicted,0.25,3,3,TAACGCAGACTGTTGGAGGA,0,1843190
hyuA_predicted,0.25,3,3,TAACCTTAACGTTAATCATG,0,1851611
hyuA_predicted,0.25,3,3,TAACAAACATACCGTCCCTT,0,1840897
hyuA_predicted,0.25,3,3,TAAATGGACAGAACTCAGCC,0,1837957
hyuA_predicted,0.25,3,3,TAAAGTGTGGCGTAATCGCG,0,1873484
hyuA_predicted,0.25,3,3,TAAAGTGCAATGATCCGTAC,0,1858635
hyuA_predicted,0.25,3,3,GTTTTTGGACTGTTACAGGT,0,1866568
hyuA_predicted,0.25,3,3,GTTTTATGCATATAGTTCGT,0,1857600
hyuA_predicted,0.25,3,3,GTTTGTGTGATTCCACGCAG,0,1871703
hyuA_predicted,0.25,3,3,GTTTGTGCTAGCGCCTCGAG,0,1848803
hyuA_predicted,0.25,3,3,GTTTGACTATCACGCGTGCA,0,1865256
hyuA_predicted,0.25,3,3,GTTTCTTCATAGCATATCCA,0,1843761
hyuA_predicted,0.25,3,3,GTTTCAGGCCGATAAGCCAA,0,1847333
hyuA_predicted,0.25,3,3,GTTGTCAATTCTCGTTGTTT,0,1857447
hyuA_predicted,0.25,3,3,GTTGGAGCTTGAAAATTGTA,0,1856697
hyuA_predicted,0.25,3,3,GTTCCGAATACCAGGCCTCG,0,1871345
hyuA_predicted,0.25,3,3,GTTCATAACGTGCGGCCCAG,0,1862685
hyuA_predicted,0.25,3,3,GTTATCCTTCCCCCTGAGTT,0,1839844
hyuA_predicted,0.25,3,3,GTTATAGAACTAGAGGTTAA,0,1841650
hyuA_predicted,0.25,3,3,GTTAACGTTCCCTGCGCCGG,0,1876984
hyuA_predicted,0.25,3,3,GTTAACGCGGTCACCGACAC,0,1866121
hyuA_predicted,0.25,3,3,GTGTTGACGCAGACCTGTGT,0,1832522
hyuA_predicted,0.25,3,3,GTGTTGAAATAAGCACTCTC,0,1865733
hyuA_predicted,0.25,3,3,GTGTCTTTTTCCAGGTTTTG,0,1838058
hyuA_predicted,0.25,3,3,GTGTCGGTTATAGGACTTAT,0,1834332
hyuA_predicted,0.25,3,3,GTGTCGGGCCTACACCCGCT,0,1860524
hyuA_predicted,0.25,3,3,GTGTCATGATACGACCTGAA,0,1855986
hyuA_predicted,0.25,3,3,GTGTAGACGGGTCCGCGTCC,0,1845367
hyuA_predicted,0.25,3,3,GTGTAAACGTCTTGTGGGAC,0,1871002
hyuA_predicted,0.25,3,3,GTGGTTGCACGGGAGTAGGA,0,1857468
hyuA_predicted,0.25,3,3,GTGGTCTTCAGGCTCGCCCT,0,1833522
hyuA_predicted,0.25,3,3,GTGGGTCTGCCCTGGACACT,0,1839604
hyuA_predicted,0.25,3,3,GTGGCTATCCCCAAGAAGAC,0,1835939
hyuA_predicted,0.25,3,3,GTGGCAAATGTATACGGTCG,0,1838599
hyuA_predicted,0.25,3,3,GTGGACGGAGAGTTTAGAGT,0,1829022
hyuA_predicted,0.25,3,3,GTGGAATGGCCCAATTAAGG,0,1869319
hyuA_predicted,0.25,3,3,GTGCGCAACGTTTTTTCGAT,0,1853138
hyuA_predicted,0.25,3,3,GTGCGATGCACTAGGTTCTC,0,1837909
hyuA_predicted,0.25,3,3,GTGCACCGTTTTTTGAGCGA,0,1838453
hyuA_predicted,0.25,3,3,GTGATTCCTTGAGCGTTTCT,0,1857380
hyuA_predicted,0.25,3,3,GTGATCACAGGACCGGCATA,0,1845988
hyuA_predicted,0.25,3,3,GTGATATATTAATTATGAGA,0,1836684
hyuA_predicted,0.25,3,3,GTGATACCTATGCGCGTACT,0,1870866
hyuA_predicted,0.25,3,3,GTGAGCCACAACTAGTAACA,0,1829971
hyuA_predicted,0.25,3,3,GTGACACGGTGCATGAACCG,0,1865639
hyuA_predicted,0.25,3,3,GTGAATGCTGAAGAGCATAG,0,1861704
hyuA_predicted,0.25,3,3,GTGAACCCTCAGCTTCATGA,0,1876875
hyuA_predicted,0.25,3,3,GTCTTCACTGTGGTATTAAC,0,1868905
hyuA_predicted,0.25,3,3,GTCTGCGGGTTGCCTTTATG,0,1873681
hyuA_predicted,0.25,3,3,GTCTGATTCGGACAAAAGCT,0,1835055
hyuA_predicted,0.25,3,3,GTCTCTATGCGTCGGAACTC,0,1852297
hyuA_predicted,0.25,3,3,GTCGTTGGCACCCTCTGCTA,0,1849462
hyuA_predicted,0.25,3,3,GTCGGAGAAACGTATCTGGG,0,1842308
hyuA_predicted,0.25,3,3,GTCGCTGATTGCCGATTTGG,0,1830969
hyuA_predicted,0.25,3,3,GTCGCTAGCAAAAGATATCT,0,1855310
hyuA_predicted,0.25,3,3,GTCGAGACCAGCCACTATCT,0,1851079
hyuA_predicted,0.25,3,3,GTCGAAGCTTCGAGTACGTT,0,1852772
hyuA_predicted,0.25,3,3,GTCCTAGGTAGAGCACCGAG,0,1840828
hyuA_predicted,0.25,3,3,GTCCGTGGCTCGCGAGCGAA,0,1839534
hyuA_predicted,0.25,3,3,GTCCGAATGCTCCCAGTTAT,0,1854923
hyuA_predicted,0.25,3,3,GTCCACTCACTTGCCACGTA,0,1868293
hyuA_predicted,0.25,3,3,GTCCAACACGACGAGGCTAT,0,1837753
hyuA_predicted,0.25,3,3,GTCATCCATCCACCTATCCT,0,1845039
hyuA_predicted,0.25,3,3,GTCACAGTTTATTGAGACAT,0,1871746
hyuA_predicted,0.25,3,3,GTCAATCGTTATGTCAAAAC,0,1868624
hyuA_predicted,0.25,3,3,GTCAAGACTTGTACACGTTC,0,1862034
hyuA_predicted,0.25,3,3,GTATTTCCAGGTGAGTAATG,0,1855509
hyuA_predicted,0.25,3,3,GTATATGAGCTTTTGAAGTT,0,1869763
hyuA_predicted,0.25,3,3,GTATAGTTTCTTTTCTACAC,0,1832230
hyuA_predicted,0.25,3,3,GTATACCATTCACAGAAAAG,0,1830511
hyuA_predicted,0.25,3,3,GTAGCTGCGTCGGAGCTGTC,0,1875659
hyuA_predicted,0.25,3,3,GTAGAGCGTGCGTCTTTTAC,0,1874441
hyuA_predicted,0.25,3,3,GTACTTACGCTATCTTTGGG,0,1877429
hyuA_predicted,0.25,3,3,GTACTCGGTTTCCCGTACTA,0,1868500
hyuA_predicted,0.25,3,3,GTACGTTAAGGGCCTTGTGA,0,1843753
hyuA_predicted,0.25,3,3,GTACGCCGTTGACGGGTATG,0,1841746
hyuA_predicted,0.25,3,3,GTACCTGACTTTCATGTTGG,0,1849538
hyuA_predicted,0.25,3,3,GTACCGGCACCGTAGCAGAG,0,1844642
hyuA_predicted,0.25,3,3,GTACACTTCGATTGAGGTTT,0,1876443
hyuA_predicted,0.25,3,3,GTAAAAAGTGTTGCCCGGTT,0,1863003
hyuA_predicted,0.25,3,3,GTAAAAACGCAGGGTTGACG,0,1844080
hyuA_predicted,0.25,3,3,GGTTTCCCGAACAGAATGAG,0,1839079
hyuA_predicted,0.25,3,3,GGTTGCAGTGACGGAGAATT,0,1868704
hyuA_predicted,0.25,3,3,GGTTGATTTCTTTCCCATAT,0,1841607
hyuA_predicted,0.25,3,3,GGTTCCAGGTTCTACCTTAT,0,1849160
hyuA_predicted,0.25,3,3,GGTGTCATATCTACAAGGAG,0,1854090
hyuA_predicted,0.25,3,3,GGTGTCAAAAATAATACGGC,0,1832107
hyuA_predicted,0.25,3,3,GGTGGCCTATAACTGACCCT,0,1843487
hyuA_predicted,0.25,3,3,GGTGCCAATGGGCGGTCACG,0,1838446
hyuA_predicted,0.25,3,3,GGTGATTAAAACCGCCCCAA,0,1863254
hyuA_predicted,0.25,3,3,GGTGATACCTGCAATTTCGG,0,1861096
hyuA_predicted,0.25,3,3,GGTCTCGTGGTCTCTGTTCG,0,1866205
hyuA_predicted,0.25,3,3,GGTCCAGTCTGGCCGCGCGC,0,1829805
hyuA_predicted,0.25,3,3,GGTATTTAGTAACAAGGCAG,0,1850891
hyuA_predicted,0.25,3,3,GGTATGCACATGATAAACGG,0,1866720
hyuA_predicted,0.25,3,3,GGTATCCACTACCGCCGGAT,0,1859426
hyuA_predicted,0.25,3,3,GGTATACTTAAAAACAGGCG,0,1853076
hyuA_predicted,0.25,3,3,GGTATAAACAACTCAATATC,0,1864910
hyuA_predicted,0.25,3,3,GGTAGGCCCAAGAAATTGGA,0,1864625
hyuA_predicted,0.25,3,3,GGTACTCGAGAGCAACACTT,0,1846471
hyuA_predicted,0.25,3,3,GGTACACCCACGACGATCGC,0,1835574
hyuA_predicted,0.25,3,3,GGTAACGCGTCATCCGACAG,0,1834732
hyuA_predicted,0.25,3,3,GGGTGGGATCGTAGGACAAA,0,1859495
hyuA_predicted,0.25,3,3,GGGTGCCCTTCCCAGGGGTG,0,1863375
hyuA_predicted,0.25,3,3,GGGTCTTTAATTTACATGAT,0,1871147
hyuA_predicted,0.25,3,3,GGGTCACCAGTCAATCCCTC,0,1843484
hyuA_predicted,0.25,3,3,GGGTATTCGTTTAAACCGGC,0,1874898
hyuA_predicted,0.25,3,3,GGGGGTTGTGCCCCGGAGAG,0,1835090
hyuA_predicted,0.25,3,3,GGGGGCTACTCGACTGAATG,0,1869731
hyuA_predicted,0.25,3,3,GGGGGCCTTCTCTGAACAGG,0,1865582
hyuA_predicted,0.25,3,3,GGGGGACGGAGCCGACACTG,0,1854278
hyuA_predicted,0.25,3,3,GGGGAGACCTTTGTGCGGGG,0,1861939
hyuA_predicted,0.25,3,3,GGGCTAACCGATTACTGTTT,0,1840379
hyuA_predicted,0.25,3,3,GGGCGAGGATTTACTAGAAA,0,1866962
hyuA_predicted,0.25,3,3,GGGCCTAAAACCAAGCTCGA,0,1848040
hyuA_predicted,0.25,3,3,GGGCCGTAAAAGGTGTAGTA,0,1837554
hyuA_predicted,0.25,3,3,GGGCCAGTCATCAGGGGCGT,0,1841544
hyuA_predicted,0.25,3,3,GGGCATTTATATCTATTCGT,0,1855117
hyuA_predicted,0.25,3,3,GGGCAGGCTTTCTCAAGAAT,0,1869987
hyuA_predicted,0.25,3,3,GGGCACGTTTCGCCGTAGTC,0,1854869
hyuA_predicted,0.25,3,3,GGGCAACTTAAGAGCCTCTT,0,1837689
hyuA_predicted,0.25,3,3,GGGCAACAATGGAAGAACGT,0,1855575
hyuA_predicted,0.25,3,3,GGGATAAAGCCGTTATTGGA,0,1870360
hyuA_predicted,0.25,3,3,GGGAGTCCCCCTCTGAGATC,0,1869817
hyuA_predicted,0.25,3,3,GGGAGGGCCGTCTGTCGAGT,0,1877425
hyuA_predicted,0.25,3,3,GGGACATCGCCACAAGTTAC,0,1846773
hyuA_predicted,0.25,3,3,GGGACAGCAGAGGCTACCCC,0,1836960
hyuA_predicted,0.25,3,3,GGGAAGAGGATTGACAGAAT,0,1862779
hyuA_predicted,0.25,3,3,GGGAAGAGCGGACTTCGTCC,0,1869971
hyuA_predicted,0.25,3,3,GGCTGATGTTAGCGGATGGG,0,1860146
hyuA_predicted,0.25,3,3,GGCTGAGAACGGATCTAGGT,0,1871119
hyuA_predicted,0.25,3,3,GGCTCGCCTTTGTATCGACA,0,1831735
hyuA_predicted,0.25,3,3,GGCTCGCCTCCTTGCTCAGT,0,1867365
hyuA_predicted,0.25,3,3,GGCTAGATAAAAGTCGGGGT,0,1857761
hyuA_predicted,0.25,3,3,GGCGGTTGTCACATAGCCGC,0,1851234
hyuA_predicted,0.25,3,3,GGCGAACCGTCTAGGGGTTG,0,1856156
hyuA_predicted,0.25,3,3,GGCCTGGTCCTTAGAGCTAG,0,1836367
hyuA_predicted,0.25,3,3,GGCCGTTGAGAGCTCTGCGA,0,1860410
hyuA_predicted,0.25,3,3,GGCCGGCGGGTCCAATTGTA,0,1842225
hyuA_predicted,0.25,3,3,GGCCGCCCGAAGCGGAATTC,0,1830153
hyuA_predicted,0.25,3,3,GGCCCGCGATATTTTGGCCC,0,1869540
hyuA_predicted,0.25,3,3,GGCCAAGGCAAGCACAATCC,0,1835260
hyuA_predicted,0.25,3,3,GGCATGTGCGCTCGTGCGCT,0,1871409
hyuA_predicted,0.25,3,3,GGCAGTACGTATGGTGAGGG,0,1838705
hyuA_predicted,0.25,3,3,GGCACCACGACGTAATGCGA,0,1833128
hyuA_predicted,0.25,3,3,GGCACATTTAAAGTCAAGAA,0,1830853
hyuA_predicted,0.25,3,3,GGCACACGCAATTTGGAAAT,0,1832409
hyuA_predicted,0.25,3,3,GGCACAACACCTTTTAGTGG,0,1854163
hyuA_predicted,0.25,3,3,GGCAAAGCCTGTAGATCGCT,0,1877267
hyuA_predicted,0.25,3,3,GGATGTTACGATGGCATTGT,0,1877349
hyuA_predicted,0.25,3,3,GGATGGTGGCACTCGCATCA,0,1869800
hyuA_predicted,0.25,3,3,GGATGGCGACATGATAGACA,0,1852116
hyuA_predicted,0.25,3,3,GGATGAGCAATACGAAATAA,0,1843339
hyuA_predicted,0.25,3,3,GGATGAGAGTAGCCGTGGCA,0,1829150
hyuA_predicted,0.25,3,3,GGATCACGAGGTTTCAATTG,0,1838811
hyuA_predicted,0.25,3,3,GGATAAGAGCAACCTAGTAG,0,1846925
hyuA_predicted,0.25,3,3,GGAGTTCATCAAGGGCCACC,0,1868584
hyuA_predicted,0.25,3,3,GGAGTAAAGACAGCGAGTGG,0,1854188
hyuA_predicted,0.25,3,3,GGAGCTATCACTGCCCGAAA,0,1833181
hyuA_predicted,0.25,3,3,GGAGAGCTCACACTTGCGCC,0,1857365
hyuA_predicted,0.25,3,3,GGACTGTACTGTCCATACTA,0,1861970
hyuA_predicted,0.25,3,3,GGACGTTAGGGTAGCGGTAA,0,1830448
hyuA_predicted,0.25,3,3,GGACGGGGAAATTTCATTGT,0,1840428
hyuA_predicted,0.25,3,3,GGACGCTCCCTGAACAAAGC,0,1849240
hyuA_predicted,0.25,3,3,GGACGAGCGTTGACATTAGC,0,1839164
hyuA_predicted,0.25,3,3,GGACCGACTTCGCTTCACAA,0,1860947
hyuA_predicted,0.25,3,3,GGACCCGGGCTTTAAATCTA,0,1843800
hyuA_predicted,0.25,3,3,GGACACCGTTGTGAAGCAAC,0,1848009
hyuA_predicted,0.25,3,3,GGAACGTGGATCCAGATAAT,0,1850619
hyuA_predicted,0.25,3,3,GGAAACAGAAATACGAGCTG,0,1868756
hyuA_predicted,0.25,3,3,GCTTTTCACGAGCCGAACAT,0,1845431
hyuA_predicted,0.25,3,3,GCTTGTTAGCACCCGGACCA,0,1829903
hyuA_predicted,0.25,3,3,GCTTGTGCTTGATTTACTTT,0,1845040
hyuA_predicted,0.25,3,3,GCTTAGTGGGAAATGCTTCT,0,1851445
hyuA_predicted,0.25,3,3,GCTGTCTAAGCATGGCGATT,0,1829326
hyuA_predicted,0.25,3,3,GCTGGTCATGGCGGTTGAAT,0,1856472
hyuA_predicted,0.25,3,3,GCTGGAATGAAGTCCGAGCC,0,1843789
hyuA_predicted,0.25,3,3,GCTGCGACACATAGGTATCT,0,1876562
hyuA_predicted,0.25,3,3,GCTGCCGTAGATTCAATTGA,0,1835465
hyuA_predicted,0.25,3,3,GCTCTGGATGACGCCATTCC,0,1866499
hyuA_predicted,0.25,3,3,GCTCGAAAGTTTACTCCTCT,0,1828992
hyuA_predicted,0.25,3,3,GCTCCCTGGATATGACAAAC,0,1870958
hyuA_predicted,0.25,3,3,GCTCAGGGGGTTCATTCACT,0,1845243
hyuA_predicted,0.25,3,3,GCTCACAAATCGCCGGGGGA,0,1846069
hyuA_predicted,0.25,3,3,GCTATAAATGCTAGGCTGAA,0,1839637
hyuA_predicted,0.25,3,3,GCTAGGGGACACCTGTGTAA,0,1841220
hyuA_predicted,0.25,3,3,GCTAAGTCACGATATGTAAG,0,1848965
hyuA_predicted,0.25,3,3,GCGTGTTGTTCTCCAGGAGG,0,1828991
hyuA_predicted,0.25,3,3,GCGTCACCGACATGACAGCT,0,1862088
hyuA_predicted,0.25,3,3,GCGGGCTTATCCGCGAGGTA,0,1875671
hyuA_predicted,0.25,3,3,GCGGATGAAGACTTTCTCAA,0,1849579
hyuA_predicted,0.25,3,3,GCGGACGCGGATGCGCTCAC,0,1836315
hyuA_predicted,0.25,3,3,GCGCTTACAAGATCAGGAAG,0,1849690
hyuA_predicted,0.25,3,3,GCGCGAGTTGTTCACGAACT,0,1842998
hyuA_predicted,0.25,3,3,GCGCCTGTTGGAGAGAGTTT,0,1831690
hyuA_predicted,0.25,3,3,GCGCCCCTGCGAGGGTATGA,0,1873498
hyuA_predicted,0.25,3,3,GCGCAGAGGTGTGATGTCTG,0,1837455
hyuA_predicted,0.25,3,3,GCGAGTTAAAGATGCCGACA,0,1863823
hyuA_predicted,0.25,3,3,GCGACTGTAACCCTACACGC,0,1857515
hyuA_predicted,0.25,3,3,GCGAACCGCTACCCTTTCGA,0,1864699
hyuA_predicted,0.25,3,3,GCGAACAACATCCACGCGGC,0,1837096
hyuA_predicted,0.25,3,3,GCCTTATCCTTAATGTTATC,0,1859121
hyuA_predicted,0.25,3,3,GCCTGCCGCGGTAGTCGGAC,0,1856917
hyuA_predicted,0.25,3,3,GCCTGCATTACGCGTGCGCT,0,1834809
hyuA_predicted,0.25,3,3,GCCTGATTGGTGGACTGCCT,0,1866831
hyuA_predicted,0.25,3,3,GCCTGAGTCTCGACTATTGG,0,1853495
hyuA_predicted,0.25,3,3,GCCTATTTAGTTACATATCT,0,1863915
hyuA_predicted,0.25,3,3,GCCGTCTGGCAGAGGGGCGA,0,1871694
hyuA_predicted,0.25,3,3,GCCGTAGCAGTTCGTCTCAG,0,1860845
hyuA_predicted,0.25,3,3,GCCGGATCCCTGTCAGTGTA,0,1855170
hyuA_predicted,0.25,3,3,GCCGGACTGTAGGCTGAGTC,0,1854753
hyuA_predicted,0.25,3,3,GCCGATGCAGTATTCTATGC,0,1837549
hyuA_predicted,0.25,3,3,GCCGAGGAGTGGTGTTCGAC,0,1867625
hyuA_predicted,0.25,3,3,GCCGACTACGCTGCTCAATA,0,1851853
hyuA_predicted,0.25,3,3,GCCCCTTTTAGGATAACGAG,0,1834871
hyuA_predicted,0.25,3,3,GCCCCTCTTGACTCTCAGAG,0,1857097
hyuA_predicted,0.25,3,3,GCCCCCTGGCGGGCATACTA,0,1854049
hyuA_predicted,0.25,3,3,GCCCATGCCGCACCGGACAA,0,1865824
hyuA_predicted,0.25,3,3,GCCCATCTAATTAGGTTATC,0,1849058
hyuA_predicted,0.25,3,3,GCCCACGATTCCATTTCGCA,0,1835016
hyuA_predicted,0.25,3,3,GCCCAAATCTTGTGAATACT,0,1836609
hyuA_predicted,0.25,3,3,GCCATTCTGCATAATCACAC,0,1830075
hyuA_predicted,0.25,3,3,GCCATGGTAAGCGGGGTGAA,0,1877580
hyuA_predicted,0.25,3,3,GCCATCTTCTGAGGGCAATA,0,1835819
hyuA_predicted,0.25,3,3,GCCAGTTTAGGGATTTCCGA,0,1874980
hyuA_predicted,0.25,3,3,GCATTTGCAAGAGGGTGGCC,0,1835375
hyuA_predicted,0.25,3,3,GCATGGTTCCAGTCCAGCAG,0,1845111
hyuA_predicted,0.25,3,3,GCATGGGATTGGGTATCGTG,0,1874314
hyuA_predicted,0.25,3,3,GCATATTCTTCCCGTATCGG,0,1869900
hyuA_predicted,0.25,3,3,GCATATCGCAAGCCAAAAGT,0,1850136
hyuA_predicted,0.25,3,3,GCATACGCGCGCCAAATAGG,0,1842914
hyuA_predicted,0.25,3,3,GCATACCGGAGGCTTCTTAC,0,1834424
hyuA_predicted,0.25,3,3,GCAGTGATCCGGGGTGCAGA,0,1875427
hyuA_predicted,0.25,3,3,GCAGTACATAGAAATGAGAT,0,1877831
hyuA_predicted,0.25,3,3,GCAGTACACATCTCTGCGGT,0,1853623
hyuA_predicted,0.25,3,3,GCAGGTGTTCATGAATTCCT,0,1838310
hyuA_predicted,0.25,3,3,GCAGCCGTGTTCTGCTTAAA,0,1833368
hyuA_predicted,0.25,3,3,GCAGATCTTACAGATTAGAT,0,1832015
hyuA_predicted,0.25,3,3,GCAGAATAATTGGCATTGTA,0,1872817
hyuA_predicted,0.25,3,3,GCACGAAGAAGCCGATTTGA,0,1852709
hyuA_predicted,0.25,3,3,GCACCAGGAACAATGATTCA,0,1844727
hyuA_predicted,0.25,3,3,GCACATGGCGACCCCTATTC,0,1855499
hyuA_predicted,0.25,3,3,GCACATCTCACCTGTCGATC,0,1858978
hyuA_predicted,0.25,3,3,GCACACGTTACCGCGTAGAC,0,1838389
hyuA_predicted,0.25,3,3,GCAACATGCGCATATGCGGT,0,1871239
hyuA_predicted,0.25,3,3,GCAAAGGGTGTAGCACATGT,0,1860042
hyuA_predicted,0.25,3,3,GATTTCTCGTAGTAGCCACA,0,1848703
hyuA_predicted,0.25,3,3,GATTGAACTATAGTTAAATC,0,1840461
hyuA_predicted,0.25,3,3,GATTAGCGCACCGGGGACTA,0,1839635
hyuA_predicted,0.25,3,3,GATGTTCGTTGATATTTAAG,0,1842025
hyuA_predicted,0.25,3,3,GATGTCTAGTGTTGCGGTGA,0,1839644
hyuA_predicted,0.25,3,3,GATGTAGTTGCCAACCTTGT,0,1834195
hyuA_predicted,0.25,3,3,GATGACGGTAGCAGGAGTCA,0,1837190
hyuA_predicted,0.25,3,3,GATCCTGGACTATGTCCTCA,0,1831327
hyuA_predicted,0.25,3,3,GATCCGAGGCCCTAATTGGG,0,1840621
hyuA_predicted,0.25,3,3,GATCCATATGGACCGTTATA,0,1867154
hyuA_predicted,0.25,3,3,GATATGGACCCTTAGATCTT,0,1831492
hyuA_predicted,0.25,3,3,GATATGAGCGCTAGCCGAAT,0,1860216
hyuA_predicted,0.25,3,3,GATAGTCGGGAATTAAGTAG,0,1867500
hyuA_predicted,0.25,3,3,GATAGACCTGCCGTAGCTGC,0,1840137
hyuA_predicted,0.25,3,3,GATACCGTCAGCATCGAGCA,0,1876593
hyuA_predicted,0.25,3,3,GATACACTGAGCATGCCGAG,0,1846427
hyuA_predicted,0.25,3,3,GATAACCTAAATCAGGTGTT,0,1874670
hyuA_predicted,0.25,3,3,GATAAAGCTTCGGGCACTAC,0,1849585
hyuA_predicted,0.25,3,3,GAGTTTGTCGTATCGCCCCA,0,1838293
hyuA_predicted,0.25,3,3,GAGTGGTGATACCGGGCCAA,0,1837704
hyuA_predicted,0.25,3,3,GAGTGCTACTACTCTACCTT,0,1842996
hyuA_predicted,0.25,3,3,GAGTGATAATCTTGAGGATT,0,1871462
hyuA_predicted,0.25,3,3,GAGTGAATGCTCTATCATAT,0,1842613
hyuA_predicted,0.25,3,3,GAGTCCTTGGTGCGTGAGGT,0,1829265
hyuA_predicted,0.25,3,3,GAGGTGAGAATCGGGCTCAC,0,1844773
hyuA_predicted,0.25,3,3,GAGGTCTACGTTAGATTTTA,0,1857867
hyuA_predicted,0.25,3,3,GAGGGTGCTAAGTCGAGTGA,0,1858155
hyuA_predicted,0.25,3,3,GAGGGGAATGACCATTGTTC,0,1844822
hyuA_predicted,0.25,3,3,GAGGGCCACTAACAGCTAAT,0,1845401
hyuA_predicted,0.25,3,3,GAGGGAATTGATGTACGAGA,0,1845481
hyuA_predicted,0.25,3,3,GAGGATATCGTGCAGAGCCA,0,1862361
hyuA_predicted,0.25,3,3,GAGGAACCAGGCGTGTCGAG,0,1845379
hyuA_predicted,0.25,3,3,GAGCGTCTACTATGGTGATG,0,1877450
hyuA_predicted,0.25,3,3,GAGCCCCAGAGACGACAGCG,0,1842536
hyuA_predicted,0.25,3,3,GAGCACATTACCCCAGCGGT,0,1845493
hyuA_predicted,0.25,3,3,GACTGACCGGGGGGGCCCAC,0,1840119
hyuA_predicted,0.25,3,3,GACTCTAATCTGAGCGGCGG,0,1869038
hyuA_predicted,0.25,3,3,GACTCGATGCCGGGGGTGTT,0,1835114
hyuA_predicted,0.25,3,3,GACTATTTTCTTCATAATAG,0,1845699
hyuA_predicted,0.25,3,3,GACTATCGCTAGCGGTGAAT,0,1874417
hyuA_predicted,0.25,3,3,GACTAAGCATCCTACAAAGG,0,1877722
hyuA_predicted,0.25,3,3,GACTAACCGCTTAATCCTTC,0,1829987
hyuA_predicted,0.25,3,3,GACGTTACGCCCTATCAGGT,0,1857204
hyuA_predicted,0.25,3,3,GACGGGTAGCCACAAGTGGT,0,1830794
hyuA_predicted,0.25,3,3,GACGGGCGAGACTTAGGGGT,0,1832180
hyuA_predicted,0.25,3,3,GACGGATAGTACCCTTTCGC,0,1831410
hyuA_predicted,0.25,3,3,GACCTCCCGACTTCTTACGT,0,1866372
hyuA_predicted,0.25,3,3,GACCTAGGTCTGGGACGCAG,0,1869944
hyuA_predicted,0.25,3,3,GACCGTGGAGGATGGCTTCT,0,1856027
hyuA_predicted,0.25,3,3,GACCAGAGCCCGGGGCGGGC,0,1844470
hyuA_predicted,0.25,3,3,GACATAGAAGGGCAAAGATT,0,1866112
hyuA_predicted,0.25,3,3,GACAGTCGTTGCAAATAGTT,0,1853891
hyuA_predicted,0.25,3,3,GACAGTAGTGCGCGATCATA,0,1832031
hyuA_predicted,0.25,3,3,GACAGGGTCGTTAAGGGTAA,0,1845204
hyuA_predicted,0.25,3,3,GACAGGCACATTGCTGAGAA,0,1876714
hyuA_predicted,0.25,3,3,GACAGACGGGATGGCTCGCA,0,1844758
hyuA_predicted,0.25,3,3,GACACGGCTATGAACCGTGG,0,1834318
hyuA_predicted,0.25,3,3,GACACGAATCGTGGTCAGAC,0,1851138
hyuA_predicted,0.25,3,3,GAATTTCGGGGGGGAAGAGG,0,1848442
hyuA_predicted,0.25,3,3,GAATGGTACATTGCCTTAAC,0,1857845
hyuA_predicted,0.25,3,3,GAATCTCTATTCCAATGCGG,0,1853419
hyuA_predicted,0.25,3,3,GAATCGGGAACAGTTAGATA,0,1855757
hyuA_predicted,0.25,3,3,GAATCAATATGGAGGAGAAC,0,1860621
hyuA_predicted,0.25,3,3,GAATAGGCTTTCATACTACA,0,1847351
hyuA_predicted,0.25,3,3,GAAGTGAGGTCACCGTGTTG,0,1850840
hyuA_predicted,0.25,3,3,GAAGTCGCACTGAGGCTCTA,0,1866871
hyuA_predicted,0.25,3,3,GAAGGGTAAACTCCGGGGAG,0,1861226
hyuA_predicted,0.25,3,3,GAAGGCAATTGAGAGGATGT,0,1854027
hyuA_predicted,0.25,3,3,GAAGCTTTCAGGGAGAGCCC,0,1857890
hyuA_predicted,0.25,3,3,GAAGACGCCGTTCATGCGCC,0,1875630
hyuA_predicted,0.25,3,3,GAACTCATCCTGCTATGGTA,0,1862701
hyuA_predicted,0.25,3,3,GAACTACCTTGTAGCATAGG,0,1864824
hyuA_predicted,0.25,3,3,GAACAAGGACTCCCGGATCG,0,1838494
hyuA_predicted,0.25,3,3,GAAACCACGCAAGCTTCTGG,0,1864234
hyuA_predicted,0.25,3,3,GAAACATCATCCGCAAACGC,0,1845953
hyuA_predicted,0.25,3,3,GAAAAGGATCGACCGGTGTA,0,1867570
hyuA_predicted,0.25,3,3,CTTTTGGGGGGATCGTAATA,0,1843507
hyuA_predicted,0.25,3,3,CTTTTAGTGGCCCCGAGGGG,0,1853625
hyuA_predicted,0.25,3,3,CTTTCATCAGGCGCGGTTGC,0,1839777
hyuA_predicted,0.25,3,3,CTTTCAGCCAATTGGGCTGC,0,1852885
hyuA_predicted,0.25,3,3,CTTTAGATCCGGATCCCATT,0,1853809
hyuA_predicted,0.25,3,3,CTTGTTGTCACTAGCATCAT,0,1862423
hyuA_predicted,0.25,3,3,CTTGTTATTGACAGTGTTAG,0,1848481
hyuA_predicted,0.25,3,3,CTTGTGGCCAATACATCCGT,0,1862462
hyuA_predicted,0.25,3,3,CTTGGCGTCTCGCCTAATCT,0,1839138
hyuA_predicted,0.25,3,3,CTTGATACCTATAAGGAGTT,0,1871948
hyuA_predicted,0.25,3,3,CTTGACACCGCTATGTCTCC,0,1877344
hyuA_predicted,0.25,3,3,CTTCTGATGCTACAGGCACG,0,1873102
hyuA_predicted,0.25,3,3,CTTCGTTTCCACGTCACTAG,0,1874939
hyuA_predicted,0.25,3,3,CTTCGTGCTCGAGTTGACAG,0,1871670
hyuA_predicted,0.25,3,3,CTTCCGTTACTGCAATACCT,0,1850347
hyuA_predicted,0.25,3,3,CTTCCGTGAGGTGTCAGCGT,0,1834136
hyuA_predicted,0.25,3,3,CTTCCCGGCCTCCTAAGTGT,0,1843866
hyuA_predicted,0.25,3,3,CTTCCAAAAACCGGGATGGC,0,1850692
hyuA_predicted,0.25,3,3,CTTCATCTAGAGTAACCAAA,0,1850226
hyuA_predicted,0.25,3,3,CTTATACCGGTGAAAGCCCA,0,1870966
hyuA_predicted,0.25,3,3,CTTAGCAGGATTAAACAGAA,0,1872678
hyuA_predicted,0.25,3,3,CTTAGATACGCGGCTATTAG,0,1849080
hyuA_predicted,0.25,3,3,CTTACGTCTCAAAGCACAGG,0,1843713
hyuA_predicted,0.25,3,3,CTTAACGAAGTGGGGGATGA,0,1841188
hyuA_predicted,0.25,3,3,CTGTACACTCGCAACACGAA,0,1852773
hyuA_predicted,0.25,3,3,CTGGGGGCATATCTGTTGAA,0,1858201
hyuA_predicted,0.25,3,3,CTGGCGGGGCAGTTTGGAGC,0,1858999
hyuA_predicted,0.25,3,3,CTGCTTCGGTGGATCTCAAA,0,1829690
hyuA_predicted,0.25,3,3,CTGCACGACCCATCGTTTTC,0,1839491
hyuA_predicted,0.25,3,3,CTGATAGACTCGATTCATAC,0,1854130
hyuA_predicted,0.25,3,3,CTGAGGTCCTCTATGATAAC,0,1861277
hyuA_predicted,0.25,3,3,CTGACTTTCACTACGAGGAA,0,1876886
hyuA_predicted,0.25,3,3,CTGACTAGGTAGCGCGGCCG,0,1870290
hyuA_predicted,0.25,3,3,CTCTGGGGAACTAACCATAT,0,1860993
hyuA_predicted,0.25,3,3,CTCTGGAAGGGGGCTATTTT,0,1836310
hyuA_predicted,0.25,3,3,CTCTGCCGAGCTGCGGATTT,0,1858948
hyuA_predicted,0.25,3,3,CTCTCTCACGTGAACCGGCG,0,1847647
hyuA_predicted,0.25,3,3,CTCTCCCTCACGCCTAGTTG,0,1848486
hyuA_predicted,0.25,3,3,CTCGTCGGCTCTCGCGTCCT,0,1854955
hyuA_predicted,0.25,3,3,CTCGTCCCACGGGATAATAA,0,1873472
hyuA_predicted,0.25,3,3,CTCGTCAACGTGAGCCGTCT,0,1834616
hyuA_predicted,0.25,3,3,CTCGTAATAACAGCCTCGGG,0,1845463
hyuA_predicted,0.25,3,3,CTCGCGGTACCAATGCGTAA,0,1873740
hyuA_predicted,0.25,3,3,CTCGCCATTCCAGCCTGTCT,0,1836786
hyuA_predicted,0.25,3,3,CTCCCCAAGTGATACGGCAG,0,1845288
hyuA_predicted,0.25,3,3,CTCATAGCCGAGGGACCATA,0,1844903
hyuA_predicted,0.25,3,3,CTCAGTTCACGACGTTGTGC,0,1839837
hyuA_predicted,0.25,3,3,CTCAGTGGTGACTGGGCGCA,0,1854228
hyuA_predicted,0.25,3,3,CTCACGACACTCGTACGACA,0,1854082
hyuA_predicted,0.25,3,3,CTCACGACAAAGTGTTATGT,0,1852324
hyuA_predicted,0.25,3,3,CTCAAGTTAGGTATGACAGC,0,1854790
hyuA_predicted,0.25,3,3,CTCAACGTTACCATGATCGA,0,1860046
hyuA_predicted,0.25,3,3,CTATGTTCGCTCAATGGCTC,0,1849924
hyuA_predicted,0.25,3,3,CTATGGAGTGATATAGCTCA,0,1860064
hyuA_predicted,0.25,3,3,CTATCATAACACTAAGAGCT,0,1832173
hyuA_predicted,0.25,3,3,CTATATTGACGTCCGTTACC,0,1848697
hyuA_predicted,0.25,3,3,CTATAGTTTTCTCACGTTGA,0,1849754
hyuA_predicted,0.25,3,3,CTATAGATGGTCAGTTTAAA,0,1858667
hyuA_predicted,0.25,3,3,CTAGGCTTACGAGGATACTT,0,1862474
hyuA_predicted,0.25,3,3,CTAGGCAAAGCACCTCTATT,0,1858679
hyuA_predicted,0.25,3,3,CTAGCAACATAGGGCACCTC,0,1841913
hyuA_predicted,0.25,3,3,CTACTTACCGCATCAACTCC,0,1872877
hyuA_predicted,0.25,3,3,CTACTAGGAGATGAGCTCCG,0,1839472
hyuA_predicted,0.25,3,3,CTACGAACAGATTTGCACAG,0,1844885
hyuA_predicted,0.25,3,3,CTACACCTGTAGCGGCTGGC,0,1838965
hyuA_predicted,0.25,3,3,CTAATTCCTGACATATGTCT,0,1829375
hyuA_predicted,0.25,3,3,CTAAATGCATCAAAATGCGG,0,1866221
hyuA_predicted,0.25,3,3,CTAAATACACCACAAACTTA,0,1861538
hyuA_predicted,0.25,3,3,CTAAACCTGCGGTGCCCGGT,0,1855976
hyuA_predicted,0.25,3,3,CGTTGCATGCCTCGCGAGTC,0,1865782
hyuA_predicted,0.25,3,3,CGTTGAGCCATCATATCTGG,0,1856953
hyuA_predicted,0.25,3,3,CGTTCTGAGGGGCACATATG,0,1830808
hyuA_predicted,0.25,3,3,CGTTCCGCTACTGGTGTTCA,0,1836420
hyuA_predicted,0.25,3,3,CGTGTATTATGCTAACCTGG,0,1852671
hyuA_predicted,0.25,3,3,CGTGGTATTAAGGTGCATGC,0,1867897
hyuA_predicted,0.25,3,3,CGTGGTAACGCGGGTTTGAC,0,1847255
hyuA_predicted,0.25,3,3,CGTGGGTAGAGCAGTAGCGA,0,1842384
hyuA_predicted,0.25,3,3,CGTGCTCCGCATCAGAAGGA,0,1850871
hyuA_predicted,0.25,3,3,CGTGCAGTAGTTTCCTCAAC,0,1864149
hyuA_predicted,0.25,3,3,CGTGACCAGAGTTATTTCAT,0,1855251
hyuA_predicted,0.25,3,3,CGTCCGGACTAGCCCTGATA,0,1847009
hyuA_predicted,0.25,3,3,CGTCCAGAAGAGCCGTCATG,0,1852973
hyuA_predicted,0.25,3,3,CGTCATCTCTGGAATAATAA,0,1831022
hyuA_predicted,0.25,3,3,CGTCATCGGCCTTCTGGGAG,0,1872116
hyuA_predicted,0.25,3,3,CGTCACCGGACCAGTAGGCG,0,1862840
hyuA_predicted,0.25,3,3,CGTCAAGTCAGCTGTCTTGA,0,1830172
hyuA_predicted,0.25,3,3,CGTATTTACCGATACCCTGA,0,1872160
hyuA_predicted,0.25,3,3,CGTAAGATGGACTATACTTA,0,1844246
hyuA_predicted,0.25,3,3,CGGTGGAAGAACACTGCTTG,0,1830245
hyuA_predicted,0.25,3,3,CGGTGCAACATTAAGGGGTA,0,1854403
hyuA_predicted,0.25,3,3,CGGTAGCGAATTCATCAGAT,0,1855840
hyuA_predicted,0.25,3,3,CGGTAATCCAGCACTTTCGA,0,1843830
hyuA_predicted,0.25,3,3,CGGGTGGGCAACATGTGACC,0,1851288
hyuA_predicted,0.25,3,3,CGGGGGCCATCTGACGGGCA,0,1871398
hyuA_predicted,0.25,3,3,CGGGGCAATTCCAGACGACG,0,1834638
hyuA_predicted,0.25,3,3,CGGGGAGTGGTTCAGTCACT,0,1867053
hyuA_predicted,0.25,3,3,CGGGCTATGGTCTATGCCGA,0,1851433
hyuA_predicted,0.25,3,3,CGGGAGGGCCACCATTTTTA,0,1841230
hyuA_predicted,0.25,3,3,CGGCTGTGAATCGCCAGTTA,0,1873588
hyuA_predicted,0.25,3,3,CGGCTGCGAACGTTGTCACA,0,1868790
hyuA_predicted,0.25,3,3,CGGCTGACGCATGCTCATGT,0,1834579
hyuA_predicted,0.25,3,3,CGGCTATGTATCGACACGAT,0,1841247
hyuA_predicted,0.25,3,3,CGGCGTTCTTCACCTTAGAT,0,1871159
hyuA_predicted,0.25,3,3,CGGCATACATCCCAGCGCCT,0,1865760
hyuA_predicted,0.25,3,3,CGGCAGACAACCCTTTTAGG,0,1837342
hyuA_predicted,0.25,3,3,CGGCAATTACAGGTAATTTT,0,1843916
hyuA_predicted,0.25,3,3,CGGATCCTTAGTTATATTCT,0,1856093
hyuA_predicted,0.25,3,3,CGGAGAGAGGTTCAGCCGGG,0,1846435
hyuA_predicted,0.25,3,3,CGGAACGACTCCGGAGCTTA,0,1836064
hyuA_predicted,0.25,3,3,CGGAACATATAATACCTCAT,0,1872911
hyuA_predicted,0.25,3,3,CGGAAACGCGTACGTCCTTT,0,1843157
hyuA_predicted,0.25,3,3,CGCTTTACACTGTAATCGGT,0,1849536
hyuA_predicted,0.25,3,3,CGCTTGACATCAGCGCTGTA,0,1847483
hyuA_predicted,0.25,3,3,CGCTCAGTGAAACCGGATAT,0,1857248
hyuA_predicted,0.25,3,3,CGCTATAAAACACTTCATGT,0,1830392
hyuA_predicted,0.25,3,3,CGCTAGAACTCAGGCTTGAT,0,1856480
hyuA_predicted,0.25,3,3,CGCGCGTGTTGTGGTCCCGA,0,1862603
hyuA_predicted,0.25,3,3,CGCCGAAATGATTATGGGTA,0,1833264
hyuA_predicted,0.25,3,3,CGCCAGATAAAGACAATTGA,0,1838668
hyuA_predicted,0.25,3,3,CGCATCAGGTACATCTCTCA,0,1850481
hyuA_predicted,0.25,3,3,CGCAGCTGTTACACACCATC,0,1856570
hyuA_predicted,0.25,3,3,CGATTCGGTAGTACTCCGTT,0,1829518
hyuA_predicted,0.25,3,3,CGATGTTGAGGACCATACTC,0,1856864
hyuA_predicted,0.25,3,3,CGATGCACTACTGCCAATGG,0,1839745
hyuA_predicted,0.25,3,3,CGATGCAACGCCTTCTCTTG,0,1862412
hyuA_predicted,0.25,3,3,CGATCAGTGACCCGGGAATA,0,1839251
hyuA_predicted,0.25,3,3,CGAGTTTATTTGAAGCAGGA,0,1829243
hyuA_predicted,0.25,3,3,CGAGGGTGCACGACGCACCA,0,1876430
hyuA_predicted,0.25,3,3,CGAGGCAGCGTAGGTGAGAG,0,1849821
hyuA_predicted,0.25,3,3,CGAGCACTATCTCTCACTTA,0,1832911
hyuA_predicted,0.25,3,3,CGAGATACGCGATTCTGTAA,0,1868553
hyuA_predicted,0.25,3,3,CGACCGTTAATAATTATGAC,0,1865095
hyuA_predicted,0.25,3,3,CGACCGGGGGCGACTCGGAT,0,1874110
hyuA_predicted,0.25,3,3,CGACAGTACCACGACACGAA,0,1846974
hyuA_predicted,0.25,3,3,CGACAGCCGGAACGATTGTA,0,1861565
hyuA_predicted,0.25,3,3,CGACACGAGCCTCAGCCTGG,0,1832260
hyuA_predicted,0.25,3,3,CGAAGTACATAACATCCCGT,0,1831658
hyuA_predicted,0.25,3,3,CGAAGCTAGGCACCAACGCT,0,1845392
hyuA_predicted,0.25,3,3,CGAAGATGGAGTGGCAACAA,0,1854245
hyuA_predicted,0.25,3,3,CGAAGAGCGACATATCGTGA,0,1836782
hyuA_predicted,0.25,3,3,CGAACCTTTCGCTGTACGCT,0,1844131
hyuA_predicted,0.25,3,3,CCTTGGCATAAGGGAGCAGT,0,1860352
hyuA_predicted,0.25,3,3,CCTTATGAAAACGTGTATGT,0,1848969
hyuA_predicted,0.25,3,3,CCTTATCTCAATCGGCACTA,0,1860103
hyuA_predicted,0.25,3,3,CCTGTTATTGGAGAAGGACA,0,1857168
hyuA_predicted,0.25,3,3,CCTGTAATTACGACAGTCTC,0,1866314
hyuA_predicted,0.25,3,3,CCTGCTACTCGTGGGTGATA,0,1854881
hyuA_predicted,0.25,3,3,CCTGACACTAGGTTGGCAGT,0,1850124
hyuA_predicted,0.25,3,3,CCTCTCATTCGGAACTCCAC,0,1864884
hyuA_predicted,0.25,3,3,CCTCGCCACAAATAGAGTGA,0,1838466
hyuA_predicted,0.25,3,3,CCTCCGACATGACATCACAA,0,1870627
hyuA_predicted,0.25,3,3,CCTCAGCTACATGCCAAATT,0,1854612
hyuA_predicted,0.25,3,3,CCTCAATACGCTCGGGGAAC,0,1862538
hyuA_predicted,0.25,3,3,CCTAGGGTTGGGGTACGAGC,0,1862764
hyuA_predicted,0.25,3,3,CCTAGATGGCATAGGAGCTA,0,1839669
hyuA_predicted,0.25,3,3,CCTAGAGGACGCGAAGCCGC,0,1873662
hyuA_predicted,0.25,3,3,CCTAATGGATGGCGGTTGCG,0,1832943
hyuA_predicted,0.25,3,3,CCGTTCAGATAGTCAACACG,0,1868570
hyuA_predicted,0.25,3,3,CCGTGCTTCAGGAAGCTTGG,0,1863258
hyuA_predicted,0.25,3,3,CCGTCGTCACGGGATCCTCA,0,1841233
hyuA_predicted,0.25,3,3,CCGTATGTCAGCGAGGGGAC,0,1868868
hyuA_predicted,0.25,3,3,CCGGTACCATTGGAGAGACA,0,1867731
hyuA_predicted,0.25,3,3,CCGGAAGTGGCCCCAGACTG,0,1857163
hyuA_predicted,0.25,3,3,CCGCTCGGTAATGGGCCTAC,0,1850967
hyuA_predicted,0.25,3,3,CCGCGCGCAAACTGGCTCTG,0,1853373
hyuA_predicted,0.25,3,3,CCGCAAATGATTGAACGATT,0,1836278
hyuA_predicted,0.25,3,3,CCGATGGCGACATAGGTATA,0,1831850
hyuA_predicted,0.25,3,3,CCGACACTTTCGTGGCTGAT,0,1846414
hyuA_predicted,0.25,3,3,CCGAATAGTTAATTGTGGTT,0,1870808
hyuA_predicted,0.25,3,3,CCGAAGTGGTGAAGGGCATC,0,1865372
hyuA_predicted,0.25,3,3,CCCTTTACCGCTTCATAACT,0,1865850
hyuA_predicted,0.25,3,3,CCCTTGGGCCCTGGAGACAA,0,1829008
hyuA_predicted,0.25,3,3,CCCTCGGAGTTCGGTTGATT,0,1858638
hyuA_predicted,0.25,3,3,CCCTCCCGCAAGTATATGGG,0,1846002
hyuA_predicted,0.25,3,3,CCCTCCACGGACTTAATTGG,0,1865825
hyuA_predicted,0.25,3,3,CCCTCAGTTCTACGTTCACA,0,1860377
hyuA_predicted,0.25,3,3,CCCGTTTAGTACGAACAGAT,0,1876759
hyuA_predicted,0.25,3,3,CCCGTGGGACTGTTGCGGCG,0,1863950
hyuA_predicted,0.25,3,3,CCCGGTATCATGTGACCGGA,0,1855834
hyuA_predicted,0.25,3,3,CCCGATAGCAATGACCTACA,0,1873732
hyuA_predicted,0.25,3,3,CCCCTTAATGCTGGATGCAG,0,1838537
hyuA_predicted,0.25,3,3,CCCCGCCTACCTGGCCAACG,0,1830672
hyuA_predicted,0.25,3,3,CCCATGATGTGATTGGCTAT,0,1855248
hyuA_predicted,0.25,3,3,CCCATGAAGTTATATGTTCA,0,1851483
hyuA_predicted,0.25,3,3,CCCAGTGCAGCGTGCGTGCA,0,1860104
hyuA_predicted,0.25,3,3,CCCAGATGTCGTAACAATTT,0,1867627
hyuA_predicted,0.25,3,3,CCCACTGAAGAAGGCACCCA,0,1852490
hyuA_predicted,0.25,3,3,CCCACGGCTTCATTGAAGAG,0,1840809
hyuA_predicted,0.25,3,3,CCATTTCGATCGCCCACATA,0,1858052
hyuA_predicted,0.25,3,3,CCATAAGACAAGAACCCTCA,0,1829268
hyuA_predicted,0.25,3,3,CCAGGTACGCGCCCGGTTAT,0,1851864
hyuA_predicted,0.25,3,3,CCAGGGGCAGCGCTACGCGG,0,1854394
hyuA_predicted,0.25,3,3,CCAGAACATTCGGGAAGCAT,0,1867820
hyuA_predicted,0.25,3,3,CCACTATGGACGGGACGTGG,0,1843525
hyuA_predicted,0.25,3,3,CCACGATGCGGGGAAAAGTT,0,1858988
hyuA_predicted,0.25,3,3,CCAATTTCGCGGCTAATACC,0,1834468
hyuA_predicted,0.25,3,3,CCAATGCACGTTAACCGCCA,0,1873586
hyuA_predicted,0.25,3,3,CCAATCAATCCGGTCCGACA,0,1848826
hyuA_predicted,0.25,3,3,CCAAGAATGGCAACTACCAC,0,1839283
hyuA_predicted,0.25,3,3,CCAACTAGAACATATATGAG,0,1831380
hyuA_predicted,0.25,3,3,CCAACGGCTCATAGCAATCG,0,1862255
hyuA_predicted,0.25,3,3,CCAACACACATTCCCCTGAG,0,1872010
hyuA_predicted,0.25,3,3,CCAAATGTCTACTAACACAC,0,1834157
hyuA_predicted,0.25,3,3,CCAAAAAGGACAGGTTAGGA,0,1856876
hyuA_predicted,0.25,3,3,CATTTGACCCTAAGTGGTTC,0,1846973
hyuA_predicted,0.25,3,3,CATTTCAAAGCGCTGGATTT,0,1866102
hyuA_predicted,0.25,3,3,CATTCAAGGTTCTGTATCTC,0,1833956
hyuA_predicted,0.25,3,3,CATTATGTTAGGTGACACAA,0,1861128
hyuA_predicted,0.25,3,3,CATTATCGCTTACGGTTCGA,0,1850222
hyuA_predicted,0.25,3,3,CATTACATTAAAAGGATTGT,0,1858911
hyuA_predicted,0.25,3,3,CATTAATTTTGAAGGCGACC,0,1859873
hyuA_predicted,0.25,3,3,CATGGGCTCTGTAAGAGGTC,0,1870472
hyuA_predicted,0.25,3,3,CATGAGTTCAGAAGCCCCGG,0,1858050
hyuA_predicted,0.25,3,3,CATCTTCTTTACCCGCATGT,0,1860755
hyuA_predicted,0.25,3,3,CATCTGTCATGAGTGCATTT,0,1871331
hyuA_predicted,0.25,3,3,CATCGGTATCGTTTGCTCCC,0,1858993
hyuA_predicted,0.25,3,3,CATCGGGGGATTGTTAAACT,0,1857888
hyuA_predicted,0.25,3,3,CATCGAAGGTAACGGTATTA,0,1871738
hyuA_predicted,0.25,3,3,CATCCTTTAAAGCCCAAGTG,0,1872362
hyuA_predicted,0.25,3,3,CATCCAAGTTTTATTTGGAG,0,1873495
hyuA_predicted,0.25,3,3,CATCACTCGAAAAAGAAGAG,0,1846174
hyuA_predicted,0.25,3,3,CATCACGGGCCGAGACTAAT,0,1845269
hyuA_predicted,0.25,3,3,CATCACCTGAATAGGATGCG,0,1873957
hyuA_predicted,0.25,3,3,CATCAAGTATCACAGATAGC,0,1838558
hyuA_predicted,0.25,3,3,CATAGATGGTTAAGTTACGG,0,1860656
hyuA_predicted,0.25,3,3,CATACTTGACGTTACCCGGA,0,1844854
hyuA_predicted,0.25,3,3,CATACCTGACCAGACCGGAA,0,1875887
hyuA_predicted,0.25,3,3,CATAAGGGGGTTGACAGATA,0,1855122
hyuA_predicted,0.25,3,3,CATAACGTCAGCTCGCCGAG,0,1842281
hyuA_predicted,0.25,3,3,CAGTTTAATCGGACTTGTAT,0,1851020
hyuA_predicted,0.25,3,3,CAGTGGGCACTAAGAATATT,0,1876451
hyuA_predicted,0.25,3,3,CAGGTTACCAAACAGGACCG,0,1843793
hyuA_predicted,0.25,3,3,CAGGGTCGATGCGTGTTCGG,0,1840589
hyuA_predicted,0.25,3,3,CAGGGCCCTCTGCGTGGGGC,0,1839951
hyuA_predicted,0.25,3,3,CAGGGAGGGGGGGACTGAGC,0,1841369
hyuA_predicted,0.25,3,3,CAGGGACTAAAATATCGGCT,0,1857293
hyuA_predicted,0.25,3,3,CAGGAGATTCCTTGGAATGT,0,1867650
hyuA_predicted,0.25,3,3,CAGCTAATGGCCCCTCAGTT,0,1862465
hyuA_predicted,0.25,3,3,CAGCCTACGCTCAGCCTCTC,0,1870490
hyuA_predicted,0.25,3,3,CAGCACGGTCTCCTTTGTAA,0,1858352
hyuA_predicted,0.25,3,3,CAGATCAGTCCGCCCAGTAC,0,1844233
hyuA_predicted,0.25,3,3,CAGACATCGCGTGGTGACAT,0,1835797
hyuA_predicted,0.25,3,3,CAGAATCCCGATGCAGGAGG,0,1854676
hyuA_predicted,0.25,3,3,CACTCTTCTGCATGTTAAAC,0,1828911
hyuA_predicted,0.25,3,3,CACTAATCCAGTGGGTGGCG,0,1867593
hyuA_predicted,0.25,3,3,CACGTACGATAATGAAGTCC,0,1849413
hyuA_predicted,0.25,3,3,CACGGTCCTGGCGTAGACTG,0,1833245
hyuA_predicted,0.25,3,3,CACGGGACCACGTGTGATTG,0,1854756
hyuA_predicted,0.25,3,3,CACGGAATCTGTTATCTGTA,0,1870426
hyuA_predicted,0.25,3,3,CACCTTGCTAGGTCTCGAAT,0,1852126
hyuA_predicted,0.25,3,3,CACCGCTGACACATCTGAGG,0,1832456
hyuA_predicted,0.25,3,3,CACCGCCTCTGTTAAGCACA,0,1838347
hyuA_predicted,0.25,3,3,CACCACACCAAGCTCAGTGG,0,1873266
hyuA_predicted,0.25,3,3,CACACGTCCTGGTTAGCGCC,0,1833810
hyuA_predicted,0.25,3,3,CACAAGTATCCAGTTTATAC,0,1840740
hyuA_predicted,0.25,3,3,CACAAATTTACTAAACGTTC,0,1843639
hyuA_predicted,0.25,3,3,CAATTCGCTTCAACGTGCCA,0,1839278
hyuA_predicted,0.25,3,3,CAATTCAGTCTAGTTCCTAA,0,1869881
hyuA_predicted,0.25,3,3,CAATCATGTGAATTTTCGTT,0,1836703
hyuA_predicted,0.25,3,3,CAAGACGGATTCGACCTATC,0,1833809
hyuA_predicted,0.25,3,3,CAACGCGCGGCTCCAAACTC,0,1851960
hyuA_predicted,0.25,3,3,CAACCAGTCCTACCCCGGCC,0,1869221
hyuA_predicted,0.25,3,3,CAAACTGCTTCCTGCTGTCA,0,1858000
hyuA_predicted,0.25,3,3,CAAACGAACCTACCCTCACT,0,1874573
hyuA_predicted,0.25,3,3,ATTTTGGAATACTGGACGAA,0,1861627
hyuA_predicted,0.25,3,3,ATTTCGTGTAAAGGAGCGCA,0,1870714
hyuA_predicted,0.25,3,3,ATTTCCCTGGGAAGTCGATA,0,1846641
hyuA_predicted,0.25,3,3,ATTTATTGTCACCTTCGGGA,0,1851815
hyuA_predicted,0.25,3,3,ATTGTGGCGCATTCTGTAGT,0,1864894
hyuA_predicted,0.25,3,3,ATTGTCCCTCCAGGGGCTAT,0,1835596
hyuA_predicted,0.25,3,3,ATTGGGAGGGCTCCGTTTCC,0,1839614
hyuA_predicted,0.25,3,3,ATTGCCTGGCGGCCCGGAGT,0,1843121
hyuA_predicted,0.25,3,3,ATTGCCGGTTTCCCAAGCCG,0,1844403
hyuA_predicted,0.25,3,3,ATTCGGAGCCGATCCCCGAG,0,1850408
hyuA_predicted,0.25,3,3,ATTCGAGGAAGCTACCTTAT,0,1835192
hyuA_predicted,0.25,3,3,ATTCCTTTTGACCTCCGCGG,0,1834779
hyuA_predicted,0.25,3,3,ATTAGTCGCTGGAATGCAAA,0,1847293
hyuA_predicted,0.25,3,3,ATTAGGGCCAAAAAGAAAGT,0,1865558
hyuA_predicted,0.25,3,3,ATTAGCGTGCGGTCTATGCA,0,1849716
hyuA_predicted,0.25,3,3,ATTACTTGCATCGCGATGAG,0,1862341
hyuA_predicted,0.25,3,3,ATGTCGCAGAATTTGTTCCA,0,1872431
hyuA_predicted,0.25,3,3,ATGTAGACTACTGTTTCAGA,0,1833919
hyuA_predicted,0.25,3,3,ATGGTTCGACCCGAGCCGGT,0,1865332
hyuA_predicted,0.25,3,3,ATGGTGAATGCGGCTTTGCT,0,1847463
hyuA_predicted,0.25,3,3,ATGGGTTATTAGTTAGCGCC,0,1865060
hyuA_predicted,0.25,3,3,ATGGGTAACATAGGATGGCA,0,1848322
hyuA_predicted,0.25,3,3,ATGGGGACCTGGGCCTCGTT,0,1852715
hyuA_predicted,0.25,3,3,ATGGGAAGATACGTACCAGA,0,1861054
hyuA_predicted,0.25,3,3,ATGGCTAAGCGCAACAGCAA,0,1865211
hyuA_predicted,0.25,3,3,ATGGCGCAATAAGGTGCGTA,0,1839388
hyuA_predicted,0.25,3,3,ATGGATATCTATCAGGCGTT,0,1832622
hyuA_predicted,0.25,3,3,ATGCGGCGTCTATCCCGGGC,0,1837273
hyuA_predicted,0.25,3,3,ATGCGATGTGGGTGGGGATA,0,1844780
hyuA_predicted,0.25,3,3,ATGCGAAAGGATTTTCAGAT,0,1839393
hyuA_predicted,0.25,3,3,ATGCGAAAAGCCAAGGACCT,0,1832361
hyuA_predicted,0.25,3,3,ATGCCCCATAATGTTGGTCC,0,1840176
hyuA_predicted,0.25,3,3,ATGAGTCGGAGCGTTTAGGC,0,1854792
hyuA_predicted,0.25,3,3,ATGACTTGAGTTGCCCTCAA,0,1865058
hyuA_predicted,0.25,3,3,ATGAAGCGATTCCGCCGATT,0,1872861
hyuA_predicted,0.25,3,3,ATGAAAGATACGCCGCAGAT,0,1854796
hyuA_predicted,0.25,3,3,ATCTTTGCTCCCTTATGGTG,0,1836970
hyuA_predicted,0.25,3,3,ATCTTCGAAGAATCGTAACA,0,1867956
hyuA_predicted,0.25,3,3,ATCTTAGACGTTCGTCTGAC,0,1855294
hyuA_predicted,0.25,3,3,ATCTAGTTAGATCATATCTT,0,1835316
hyuA_predicted,0.25,3,3,ATCGGGTCAAATGCAAACCC,0,1844230
hyuA_predicted,0.25,3,3,ATCGGATTCACCCCCCTTTC,0,1869609
hyuA_predicted,0.25,3,3,ATCGGACGCGTGGACACGAC,0,1874219
hyuA_predicted,0.25,3,3,ATCGCGAGTACCTCTCAAGC,0,1834430
hyuA_predicted,0.25,3,3,ATCGCGACCAACCGCTAGCG,0,1858818
hyuA_predicted,0.25,3,3,ATCGCAGAAGTACCCGCTGC,0,1836901
hyuA_predicted,0.25,3,3,ATCGAGCGCCCGAAACAGAC,0,1842637
hyuA_predicted,0.25,3,3,ATCCTTAGTACCATGAAGGG,0,1850928
hyuA_predicted,0.25,3,3,ATCCTGACGAAAACGATTAC,0,1852029
hyuA_predicted,0.25,3,3,ATCCTAGAAGATTAGCACGT,0,1874704
hyuA_predicted,0.25,3,3,ATCCGTTCGTTAACCGAACC,0,1835012
hyuA_predicted,0.25,3,3,ATCCGGTTACACAAGCAGTA,0,1840224
hyuA_predicted,0.25,3,3,ATCCCTAGACCCGTCAATTT,0,1865334
hyuA_predicted,0.25,3,3,ATCCACGCAAGGGTCGTAGC,0,1843242
hyuA_predicted,0.25,3,3,ATCCAAATACCGCGGCTCGA,0,1834574
hyuA_predicted,0.25,3,3,ATCACAAATTCGGGCTAGGA,0,1870693
hyuA_predicted,0.25,3,3,ATATGGTTCTAGGCATGGGA,0,1863540
hyuA_predicted,0.25,3,3,ATAGGTTTTAAGGGGAATAG,0,1838806
hyuA_predicted,0.25,3,3,ATAGCTTGTGCTCGTAAACT,0,1839252
hyuA_predicted,0.25,3,3,ATAGCGTGGACCTGCTTGCT,0,1837474
hyuA_predicted,0.25,3,3,ATACGAATTAGTGTTGAGCA,0,1876770
hyuA_predicted,0.25,3,3,ATAAGCGTGGGGACACGTCT,0,1832001
hyuA_predicted,0.25,3,3,ATAAACTATATCGGGCGAGA,0,1840727
hyuA_predicted,0.25,3,3,AGTTTTTCCTGGCTCGCCAC,0,1860059
hyuA_predicted,0.25,3,3,AGTTCGACAGCATTAATAAG,0,1835943
hyuA_predicted,0.25,3,3,AGTTATGGTAACGGACCTGT,0,1873562
hyuA_predicted,0.25,3,3,AGTTATGCTACGTATTAGCC,0,1859898
hyuA_predicted,0.25,3,3,AGTGGTACATGGGGGACTTT,0,1841173
hyuA_predicted,0.25,3,3,AGTGCATATAACCTTTTTTG,0,1875554
hyuA_predicted,0.25,3,3,AGTCTGGGGTTACGTTTATG,0,1832442
hyuA_predicted,0.25,3,3,AGTCCGGGAGGAGCTGGACA,0,1832966
hyuA_predicted,0.25,3,3,AGTATGCGCATTTCTCACCC,0,1859772
hyuA_predicted,0.25,3,3,AGGTTAAATGGGAGCACTTA,0,1832002
hyuA_predicted,0.25,3,3,AGGTGTTACAAACATTTGTT,0,1833606
hyuA_predicted,0.25,3,3,AGGTGGGTCAAATAGAACAG,0,1873373
hyuA_predicted,0.25,3,3,AGGTGAACAAGGTTCTTTCC,0,1869849
hyuA_predicted,0.25,3,3,AGGGTTTTACAATATCAATG,0,1864290
hyuA_predicted,0.25,3,3,AGGGTTGGCCTTGTTGTCAT,0,1858306
hyuA_predicted,0.25,3,3,AGGGTTGACTGCTGGTTTAG,0,1870116
hyuA_predicted,0.25,3,3,AGGGTTCCGTTGAAGGCCCT,0,1853806
hyuA_predicted,0.25,3,3,AGGGGTGCAGTCAGACCGAT,0,1833772
hyuA_predicted,0.25,3,3,AGGGGGTACTACGCATACGT,0,1845986
hyuA_predicted,0.25,3,3,AGGGGACCGCACCGGGCTCT,0,1868702
hyuA_predicted,0.25,3,3,AGGGAGGATTTCTAGTCCTA,0,1838193
hyuA_predicted,0.25,3,3,AGGCGATAGGATCTGCGCGT,0,1861007
hyuA_predicted,0.25,3,3,AGGCCTGCAGAAGTAGAGCC,0,1853578
hyuA_predicted,0.25,3,3,AGGCCGGAAAAACTAGCTGA,0,1842231
hyuA_predicted,0.25,3,3,AGGCATTCACGCCACAGGCA,0,1837645
hyuA_predicted,0.25,3,3,AGGATGCAGATTGTTTTAAT,0,1850337
hyuA_predicted,0.25,3,3,AGGATGAAGACCGTCGCGGG,0,1859323
hyuA_predicted,0.25,3,3,AGGATCGTTACGCCTTGCTC,0,1839223
hyuA_predicted,0.25,3,3,AGGATAGGGACCGAGTCGCA,0,1839813
hyuA_predicted,0.25,3,3,AGGAGCAAGTTGATATTTAA,0,1863313
hyuA_predicted,0.25,3,3,AGGACGGTTGTATTATGGAC,0,1856145
hyuA_predicted,0.25,3,3,AGGACGGCGATCACAAATTT,0,1870183
hyuA_predicted,0.25,3,3,AGGACGATGCACTGACGTTA,0,1836941
hyuA_predicted,0.25,3,3,AGGACGACGGGTTAGAGTAT,0,1836433
hyuA_predicted,0.25,3,3,AGGACCCACTCATAACGGAC,0,1844444
hyuA_predicted,0.25,3,3,AGGAAGTTACGTAGACTCAT,0,1866608
hyuA_predicted,0.25,3,3,AGGAACCTGGCGCATATCCC,0,1842661
hyuA_predicted,0.25,3,3,AGCTGGACGTGCCCTGAGCG,0,1861127
hyuA_predicted,0.25,3,3,AGCTGCGATGTAGACCAAAC,0,1853383
hyuA_predicted,0.25,3,3,AGCTCGTTACTACAACGCCC,0,1830452
hyuA_predicted,0.25,3,3,AGCTCACATGCGCAATCGAG,0,1847950
hyuA_predicted,0.25,3,3,AGCTAACACTGACACACCTC,0,1874354
hyuA_predicted,0.25,3,3,AGCTAAACGTTAGGGAGGAG,0,1845602
hyuA_predicted,0.25,3,3,AGCGAGATTAACGATGTTGA,0,1865916
hyuA_predicted,0.25,3,3,AGCGACCCCAGTTCAGGGTC,0,1858960
hyuA_predicted,0.25,3,3,AGCGAAGAAGATCACGTTAG,0,1830659
hyuA_predicted,0.25,3,3,AGCCGGGGGAGTTTACCTTC,0,1857077
hyuA_predicted,0.25,3,3,AGCCCTGAGTCTAAGGGCTA,0,1877231
hyuA_predicted,0.25,3,3,AGCATCCGTCAGCGGCGTCT,0,1842419
hyuA_predicted,0.25,3,3,AGCAGCCTTATCTCATAGGT,0,1843630
hyuA_predicted,0.25,3,3,AGCACGTTCACATCCCTACG,0,1867724
hyuA_predicted,0.25,3,3,AGATTTGTCGATCCGCAACC,0,1829393
hyuA_predicted,0.25,3,3,AGATTAAATACTGGGGCTAG,0,1870195
hyuA_predicted,0.25,3,3,AGATCTTCGATGACCACTCA,0,1841406
hyuA_predicted,0.25,3,3,AGATCAAACGATTCCAAGGC,0,1876438
hyuA_predicted,0.25,3,3,AGAGGGCTGTACTCAGAACA,0,1847767
hyuA_predicted,0.25,3,3,AGAGGCCTGCGACGTCGTTA,0,1872146
hyuA_predicted,0.25,3,3,AGAGGACGGCGACGGACATT,0,1832088
hyuA_predicted,0.25,3,3,AGAGCCTTGAACGAAGAACG,0,1864431
hyuA_predicted,0.25,3,3,AGAGCCTGATGCCCTAATTT,0,1865361
hyuA_predicted,0.25,3,3,AGAGATGAACCAACGTCGGG,0,1871577
hyuA_predicted,0.25,3,3,AGACTAGAGTTGACATTACT,0,1845480
hyuA_predicted,0.25,3,3,AGACGGAGAACATCCCGCCG,0,1857922
hyuA_predicted,0.25,3,3,AGACCTGAAATGGTATTAAA,0,1870012
hyuA_predicted,0.25,3,3,AGACCCATTCAATGGCGGCA,0,1860402
hyuA_predicted,0.25,3,3,AGACCACATTACGTGCGTGT,0,1850941
hyuA_predicted,0.25,3,3,AGACAGGCTTTAAATCGGTA,0,1828938
hyuA_predicted,0.25,3,3,AGACACTGGCAATTGCCGGG,0,1850102
hyuA_predicted,0.25,3,3,AGAATAACTGGGTGTCGATC,0,1845841
hyuA_predicted,0.25,3,3,AGAACTATCAATAAAGGAGG,0,1867396
hyuA_predicted,0.25,3,3,AGAAAGCAGTTCGGGACCGG,0,1837305
hyuA_predicted,0.25,3,3,ACTTGTATTAACGGGGGAAG,0,1839930
hyuA_predicted,0.25,3,3,ACTTGAGGGGCTTAGGAAAC,0,1867277
hyuA_predicted,0.25,3,3,ACTGATTCAGCGTGGGTATG,0,1843666
hyuA_predicted,0.25,3,3,ACTGAGCTTCCACATTGATT,0,1840467
hyuA_predicted,0.25,3,3,ACTCTCTCGGGGGCCGAACC,0,1857454
hyuA_predicted,0.25,3,3,ACTCTCGTAACGAATTCGAC,0,1839961
hyuA_predicted,0.25,3,3,ACTCACACGAGGGTACGTTA,0,1845852
hyuA_predicted,0.25,3,3,ACTATATACTTGTGCAACAC,0,1862396
hyuA_predicted,0.25,3,3,ACTAGAGAAAGATGAAAATC,0,1852295
hyuA_predicted,0.25,3,3,ACTACAGATCCTAATGGAAA,0,1862344
hyuA_predicted,0.25,3,3,ACGTTGAGAACAGATCAAGG,0,1829685
hyuA_predicted,0.25,3,3,ACGTATTAGGTACAACGACA,0,1846027
hyuA_predicted,0.25,3,3,ACGGTTGTGCATCCGCGAAC,0,1842604
hyuA_predicted,0.25,3,3,ACGGCTTTCCCGCGCCTAAT,0,1874356
hyuA_predicted,0.25,3,3,ACGGCTTAAGCAGGACAGCG,0,1849564
hyuA_predicted,0.25,3,3,ACGGCCGGTTTCAGGTTTAT,0,1852037
hyuA_predicted,0.25,3,3,ACGCCCGTACTGCACCTTTA,0,1842156
hyuA_predicted,0.25,3,3,ACGCATAGGAAGTACGTGAA,0,1864768
hyuA_predicted,0.25,3,3,ACGCAAAAATCTCTGAGTCA,0,1875888
hyuA_predicted,0.25,3,3,ACGAGTATCCACCGGGATCT,0,1854235
hyuA_predicted,0.25,3,3,ACGAGCAGTATCTCGTTCAT,0,1855234
hyuA_predicted,0.25,3,3,ACGACGGGATAAACGGACTT,0,1876787
hyuA_predicted,0.25,3,3,ACCTTCGTATGGTGCAGTTT,0,1871515
hyuA_predicted,0.25,3,3,ACCTCTAATATACACCCGGC,0,1855024
hyuA_predicted,0.25,3,3,ACCTATCTAGTGAGGCCACA,0,1844732
hyuA_predicted,0.25,3,3,ACCTACGTCCGTGGCAGGCA,0,1845892
hyuA_predicted,0.25,3,3,ACCGTCTAAGATTGTACCAC,0,1833900
hyuA_predicted,0.25,3,3,ACCGTATTGCTAATGACGAT,0,1875217
hyuA_predicted,0.25,3,3,ACCGTACTACCCACGGTTCA,0,1857629
hyuA_predicted,0.25,3,3,ACCGTACCGATTCGCACCGA,0,1857339
hyuA_predicted,0.25,3,3,ACCGCTACGGATCCCGTTCG,0,1874603
hyuA_predicted,0.25,3,3,ACCGCGGGTGTCTACCTCTT,0,1872266
hyuA_predicted,0.25,3,3,ACCCGTGTCAGTTGACATCT,0,1846035
hyuA_predicted,0.25,3,3,ACCCCATAGGGCAGGTTAAC,0,1852732
hyuA_predicted,0.25,3,3,ACCCAAACCTTTTGAACGGG,0,1839060
hyuA_predicted,0.25,3,3,ACCATGTCCGTCGAAGCCCG,0,1840968
hyuA_predicted,0.25,3,3,ACCACTTAACGCATAGTTTA,0,1864876
hyuA_predicted,0.25,3,3,ACCACCTCTCCACCACCGCT,0,1861364
hyuA_predicted,0.25,3,3,ACCACAGGCAATTAGGTGCT,0,1871899
hyuA_predicted,0.25,3,3,ACCAAACATTCGTAGTTGCA,0,1857547
hyuA_predicted,0.25,3,3,ACATGCTTGAACTCGGATTC,0,1844899
hyuA_predicted,0.25,3,3,ACATGCATGGCTGAAACATA,0,1869765
hyuA_predicted,0.25,3,3,ACATCCACTGCTCCATTGAC,0,1858518
hyuA_predicted,0.25,3,3,ACATAGTCTGACTTGGTAGA,0,1851528
hyuA_predicted,0.25,3,3,ACAGTGGACTAATCGCGAAG,0,1858461
hyuA_predicted,0.25,3,3,ACAGACTTTGTACCTCTTAA,0,1869064
hyuA_predicted,0.25,3,3,ACACTTTTATTGTTAGAGTT,0,1873365
hyuA_predicted,0.25,3,3,ACACTTCCGGTTCGTGCTTT,0,1853280
hyuA_predicted,0.25,3,3,ACACGGTTAACACTAACTTG,0,1855002
hyuA_predicted,0.25,3,3,ACACGACCCTCCTTTAGATA,0,1847249
hyuA_predicted,0.25,3,3,ACAATTTCTGTTTACTGAAA,0,1847643
hyuA_predicted,0.25,3,3,ACAAGTAGCTAGTCACCATG,0,1866824
hyuA_predicted,0.25,3,3,ACAAGCCGGGCAACCGGACT,0,1876611
hyuA_predicted,0.25,3,3,ACAACGCAACCGTCCCTCTT,0,1871293
hyuA_predicted,0.25,3,3,ACAAAGGCTTGAGCACTAGC,0,1852561
hyuA_predicted,0.25,3,3,ACAAACTAACGCGAAAGGAT,0,1845450
hyuA_predicted,0.25,3,3,ACAAAACACGGATGAGTGTC,0,1850428
hyuA_predicted,0.25,3,3,AATTGTTGTAGTTATCGCCT,0,1872937
hyuA_predicted,0.25,3,3,AATTCAGCTTGGTATCCAGA,0,1832616
hyuA_predicted,0.25,3,3,AATGTGATTTATGGACAGGT,0,1871545
hyuA_predicted,0.25,3,3,AATGCATATCCATGCTTGTA,0,1840226
hyuA_predicted,0.25,3,3,AATGACCACAAATTAAAATA,0,1846600
hyuA_predicted,0.25,3,3,AATGAAATCTTTGCCTAGGA,0,1846269
hyuA_predicted,0.25,3,3,AATCTGAGGCGGTAATACTT,0,1840166
hyuA_predicted,0.25,3,3,AATCGGGTTTCGGTTCGACC,0,1868256
hyuA_predicted,0.25,3,3,AATCGAATGCGTACTGCAGG,0,1845058
hyuA_predicted,0.25,3,3,AATCCCATCCAGTGTGTAGA,0,1828861
hyuA_predicted,0.25,3,3,AATCACTTACAGGTTCTAAA,0,1876918
hyuA_predicted,0.25,3,3,AATATGTGTGCCGGGAAAAT,0,1839036
hyuA_predicted,0.25,3,3,AATATGAAGGCCGTAGCCTC,0,1870897
hyuA_predicted,0.25,3,3,AATAGTCAAAAACAACTCGC,0,1873726
hyuA_predicted,0.25,3,3,AATAGATGAGGCAGGAACAG,0,1871855
hyuA_predicted,0.25,3,3,AAGTCGAAAATGCGCATGGG,0,1868915
hyuA_predicted,0.25,3,3,AAGGTTATTTACGCCCGCCC,0,1834377
hyuA_predicted,0.25,3,3,AAGGGCACGTGGCCGAGCAA,0,1865132
hyuA_predicted,0.25,3,3,AAGCTACCTGTATAATGGTT,0,1847861
hyuA_predicted,0.25,3,3,AAGCGTGCTATGTAGACTCT,0,1876634
hyuA_predicted,0.25,3,3,AAGCCAGGGATTGTCATATG,0,1853333
hyuA_predicted,0.25,3,3,AAGCCAAAACGTCCACATAC,0,1841453
hyuA_predicted,0.25,3,3,AAGCAATAATGACGATACTT,0,1831407
hyuA_predicted,0.25,3,3,AAGATTTCAAACTGGGGCCA,0,1833421
hyuA_predicted,0.25,3,3,AAGAGGCGCGATAGATAAGG,0,1870732
hyuA_predicted,0.25,3,3,AAGACTGGGTCGCATTGACG,0,1869727
hyuA_predicted,0.25,3,3,AAGAAACTACTAATTTGTAA,0,1861341
hyuA_predicted,0.25,3,3,AACTTTCGCAATGCTCTCAA,0,1856121
hyuA_predicted,0.25,3,3,AACTTACAATGTCAGGCTGA,0,1843167
hyuA_predicted,0.25,3,3,AACTCTCCGCTTTCCCCGGA,0,1854106
hyuA_predicted,0.25,3,3,AACTCAATTTTGGCGGTTCA,0,1853247
hyuA_predicted,0.25,3,3,AACTAGGACTATCATTCCCT,0,1849598
hyuA_predicted,0.25,3,3,AACTAGCCTGGGGGTCCATG,0,1871502
hyuA_predicted,0.25,3,3,AACGGATAGGGCGGCGGGCG,0,1843984
hyuA_predicted,0.25,3,3,AACGACGTATTAGATTGGAG,0,1868861
hyuA_predicted,0.25,3,3,AACCAAGCGGGCACGAAGCG,0,1872178
hyuA_predicted,0.25,3,3,AACATATTACAGGGCTCAAA,0,1833729
hyuA_predicted,0.25,3,3,AACAGCGAATGGCCCCATAT,0,1840099
hyuA_predicted,0.25,3,3,AACAGCAGCCCACAGTGTCT,0,1870552
hyuA_predicted,0.25,3,3,AACACCATCCGCCATGAACG,0,1831471
hyuA_predicted,0.25,3,3,AAATTTGGGATCCCCTGAAG,0,1849105
hyuA_predicted,0.25,3,3,AAATTGCGTCTCGTGGTATG,0,1847571
hyuA_predicted,0.25,3,3,AAATTCACCCTCGACTAGGT,0,1856406
hyuA_predicted,0.25,3,3,AAATTAAGTAACGCACGGGT,0,1837764
hyuA_predicted,0.25,3,3,AAATGATGGTCGAGCGTCAG,0,1867369
hyuA_predicted,0.25,3,3,AAATCTTTCGTTGGTGAGGC,0,1844121
hyuA_predicted,0.25,3,3,AAATCTACAATGTTCGTTTA,0,1832657
hyuA_predicted,0.25,3,3,AAATCAGCTGTGCAACAAGA,0,1861181
hyuA_predicted,0.25,3,3,AAATACATAATAGGTTAGTA,0,1839617
hyuA_predicted,0.25,3,3,AAAGGTGGCCGCTATAATGT,0,1875641
hyuA_predicted,0.25,3,3,AAAGGGATAATAATTGGAGA,0,1839562
hyuA_predicted,0.25,3,3,AAAGCTCGAAGCTCAACCTC,0,1870406
hyuA_predicted,0.25,3,3,AAAGCCATGGTCGGTAATCA,0,1867901
hyuA_predicted,0.25,3,3,AAAGAATATTACAATGCCTG,0,1842762
hyuA_predicted,0.25,3,3,AAACTTATTAAAAGGCTCAA,0,1830939
hyuA_predicted,0.25,3,3,AAACTCGCACCCCCCACTTG,0,1848477
hyuA_predicted,0.25,3,3,AAACTCAGAAGTGATTCATC,0,1859235
hyuA_predicted,0.25,3,3,AAACGCTTGAGCGCTGCTTA,0,1837781
hyuA_predicted,0.25,3,3,AAACGCTGCTACGAAGACCT,0,1862783
hyuA_predicted,0.25,3,3,AAACGCGCCTTGTTGGTAAT,0,1834096
hyuA_predicted,0.25,3,3,AAACACTATGATGGCATCCC,0,1871257
hyuA_predicted,0.25,3,3,AAAATAAGCGCTAGGAGGGC,0,1855806
hyuA_predicted,0.3333333333333333,2,2,TTTTTGGCCTTACACACGAC,0,1836368
hyuA_predicted,0.3333333333333333,2,2,TTTTTCAACTTGGGCCAGAC,0,1850105
hyuA_predicted,0.3333333333333333,2,2,TTTTCTTTATGATAATTGCC,0,1836926
hyuA_predicted,0.3333333333333333,2,2,TTTTATTCAGAACCGTATTC,0,1867986
hyuA_predicted,0.3333333333333333,2,2,TTTGGTCCAGACCCCGCGAA,0,1873887
hyuA_predicted,0.3333333333333333,2,2,TTTGGGTGGCCAGAAAAAGT,0,1834334
hyuA_predicted,0.3333333333333333,2,2,TTTGGGGGCTAACGGTTCGA,0,1865125
hyuA_predicted,0.3333333333333333,2,2,TTTGGCCATCAGTTTGTAAG,0,1841350
hyuA_predicted,0.3333333333333333,2,2,TTTGGCATAGCTGTCTTTAC,0,1876267
hyuA_predicted,0.3333333333333333,2,2,TTTGGACTGTCATAGCAAAT,0,1843283
hyuA_predicted,0.3333333333333333,2,2,TTTGCGATTCACTCAAACCC,0,1841094
hyuA_predicted,0.3333333333333333,2,2,TTTGCGAAGATTTCTAGGAG,0,1864344
hyuA_predicted,0.3333333333333333,2,2,TTTGCCATTACGCTTCTGCT,0,1849943
hyuA_predicted,0.3333333333333333,2,2,TTTGCATCTATCTATTACTA,0,1843411
hyuA_predicted,0.3333333333333333,2,2,TTTCTCCCTCGTACTCATGT,0,1853293
hyuA_predicted,0.3333333333333333,2,2,TTTCCGAGAAAGGACGGCCT,0,1830889
hyuA_predicted,0.3333333333333333,2,2,TTTATGGGACAGCACGTGTG,0,1865912
hyuA_predicted,0.3333333333333333,2,2,TTTACGTCCTGGGTTTCAGC,0,1832274
hyuA_predicted,0.3333333333333333,2,2,TTTAAGATGCATAAAAAGTC,0,1830952
hyuA_predicted,0.3333333333333333,2,2,TTTAACGTAGGCAGTCGGAG,0,1839305
hyuA_predicted,0.3333333333333333,2,2,TTGTTGAGGGTGGTCTCTTC,0,1832933
hyuA_predicted,0.3333333333333333,2,2,TTGTTCCGGAACCAGGCTCA,0,1842379
hyuA_predicted,0.3333333333333333,2,2,TTGTCGCGAAATAAATCCCT,0,1866746
hyuA_predicted,0.3333333333333333,2,2,TTGTCCGGTACCTGGGCTTT,0,1833579
hyuA_predicted,0.3333333333333333,2,2,TTGTACGTTTCACTATTCTA,0,1843791
hyuA_predicted,0.3333333333333333,2,2,TTGTAAGGTAGATTCGAAAA,0,1865618
hyuA_predicted,0.3333333333333333,2,2,TTGGTCTTAGTCCCTGGTGA,0,1828870
hyuA_predicted,0.3333333333333333,2,2,TTGGCTCGACGTGGTTCTGT,0,1861752
hyuA_predicted,0.3333333333333333,2,2,TTGGCTAGCAATTGTGTTGT,0,1870814
hyuA_predicted,0.3333333333333333,2,2,TTGGCCAAGTAAACTCTAAT,0,1857264
hyuA_predicted,0.3333333333333333,2,2,TTGGAAGGGGGCTAATAAAA,0,1834722
hyuA_predicted,0.3333333333333333,2,2,TTGCTTACTGCAAAACAGGT,0,1855747
hyuA_predicted,0.3333333333333333,2,2,TTGCGGTTCTTCCTTGTTAT,0,1870757
hyuA_predicted,0.3333333333333333,2,2,TTGCCCTTTTTGCGTTCTAG,0,1851102
hyuA_predicted,0.3333333333333333,2,2,TTGATAGACGTGGTAAGTGG,0,1872727
hyuA_predicted,0.3333333333333333,2,2,TTGATAACATATGAATCACG,0,1842234
hyuA_predicted,0.3333333333333333,2,2,TTGAGGTCATAAAGGCGGGA,0,1850771
hyuA_predicted,0.3333333333333333,2,2,TTGAGCTTCTAGTTTCGCAA,0,1862547
hyuA_predicted,0.3333333333333333,2,2,TTGACACAGTGAAGGCCCAT,0,1857604
hyuA_predicted,0.3333333333333333,2,2,TTGAAGACTGCAAACATTAC,0,1845093
hyuA_predicted,0.3333333333333333,2,2,TTGAAGACAATGTCCGACTC,0,1867613
hyuA_predicted,0.3333333333333333,2,2,TTGAAAAGGGACTTTGTTGA,0,1841251
hyuA_predicted,0.3333333333333333,2,2,TTCTTTCAGTGTGTAGGTCA,0,1858459
hyuA_predicted,0.3333333333333333,2,2,TTCTGTTTGCGCTCACAGTA,0,1860874
hyuA_predicted,0.3333333333333333,2,2,TTCTGGGAGGGTATTACATG,0,1838304
hyuA_predicted,0.3333333333333333,2,2,TTCTCGTAAACTCGCCTAAA,0,1874364
hyuA_predicted,0.3333333333333333,2,2,TTCTAGACCTCAGTCATGAG,0,1839456
hyuA_predicted,0.3333333333333333,2,2,TTCGTGTGGTGCATTTAGCA,0,1836602
hyuA_predicted,0.3333333333333333,2,2,TTCGTAGGCCCTGACTATAA,0,1847185
hyuA_predicted,0.3333333333333333,2,2,TTCGGTCAGACATCGATTGA,0,1867418
hyuA_predicted,0.3333333333333333,2,2,TTCGCGCACAGTAGGCCCAC,0,1868449
hyuA_predicted,0.3333333333333333,2,2,TTCGCCGGCGCTGGCATTAG,0,1869975
hyuA_predicted,0.3333333333333333,2,2,TTCGCCCTGGGTAAGGTATC,0,1875090
hyuA_predicted,0.3333333333333333,2,2,TTCGCCATACCACGGGAGCT,0,1863811
hyuA_predicted,0.3333333333333333,2,2,TTCGCATATTCGGCCTTAAT,0,1858880
hyuA_predicted,0.3333333333333333,2,2,TTCGAAATGCGCCAGCATTA,0,1870505
hyuA_predicted,0.3333333333333333,2,2,TTCCGCGCGCTGCTGTGTCT,0,1852289
hyuA_predicted,0.3333333333333333,2,2,TTCCAGCACCACGGCATGCA,0,1837951
hyuA_predicted,0.3333333333333333,2,2,TTCCACCGTAATATCGGAAT,0,1844330
hyuA_predicted,0.3333333333333333,2,2,TTCCAAATTTATCGTAGGGC,0,1876168
hyuA_predicted,0.3333333333333333,2,2,TTCATTCGACATATCCCTTA,0,1845440
hyuA_predicted,0.3333333333333333,2,2,TTCATACTGAGCGTTTCTTT,0,1831122
hyuA_predicted,0.3333333333333333,2,2,TTCACTATGACCACGTAGGT,0,1875954
hyuA_predicted,0.3333333333333333,2,2,TTATTTCCATTACGTCCGAA,0,1840400
hyuA_predicted,0.3333333333333333,2,2,TTATTGCCAACTGGAACTCA,0,1858046
hyuA_predicted,0.3333333333333333,2,2,TTATGATGGTTCGGTACCTG,0,1836240
hyuA_predicted,0.3333333333333333,2,2,TTATCGGCCATGCTAGTTCT,0,1842879
hyuA_predicted,0.3333333333333333,2,2,TTATCCTTTCTATGTTGAGT,0,1861345
hyuA_predicted,0.3333333333333333,2,2,TTATCATCGGTGGATTAGCA,0,1849176
hyuA_predicted,0.3333333333333333,2,2,TTATCACACAGTTTCCTTTC,0,1835435
hyuA_predicted,0.3333333333333333,2,2,TTATATCGGTGACGCGCTAC,0,1861311
hyuA_predicted,0.3333333333333333,2,2,TTATACTATTGAAAAAACAG,0,1834225
hyuA_predicted,0.3333333333333333,2,2,TTATACTATCTCGTATAGGT,0,1876932
hyuA_predicted,0.3333333333333333,2,2,TTAGTGTAGGTGCAATCTCC,0,1836381
hyuA_predicted,0.3333333333333333,2,2,TTAGTCACTCGGTCTCACTT,0,1847150
hyuA_predicted,0.3333333333333333,2,2,TTAGTACACTGGTTTGGCAT,0,1851964
hyuA_predicted,0.3333333333333333,2,2,TTAGGAAGTAGCGTAACTCA,0,1876895
hyuA_predicted,0.3333333333333333,2,2,TTAGCTTTGGAACGTCGTCG,0,1849698
hyuA_predicted,0.3333333333333333,2,2,TTACCTAAGGGCCTCAAATA,0,1846042
hyuA_predicted,0.3333333333333333,2,2,TTACCATAGCTACGCATGAC,0,1860880
hyuA_predicted,0.3333333333333333,2,2,TTACAAGGGTAGTAGGTAAA,0,1861097
hyuA_predicted,0.3333333333333333,2,2,TTAATAGGGACTTGACGGAA,0,1873601
hyuA_predicted,0.3333333333333333,2,2,TTAAGGAAGGGCCCTTCAAT,0,1860575
hyuA_predicted,0.3333333333333333,2,2,TTAAACGCAACCAACATACT,0,1837193
hyuA_predicted,0.3333333333333333,2,2,TTAAACCCGCTCTGAGCGTT,0,1839508
hyuA_predicted,0.3333333333333333,2,2,TGTTCGGCCACGTGAAATTT,0,1852573
hyuA_predicted,0.3333333333333333,2,2,TGTTACATGGAACAATTTGT,0,1843922
hyuA_predicted,0.3333333333333333,2,2,TGTTACACAGCCCGACATGT,0,1854877
hyuA_predicted,0.3333333333333333,2,2,TGTGGATGGCATTCTAATTG,0,1858204
hyuA_predicted,0.3333333333333333,2,2,TGTGGACATGTGACTGTCAA,0,1851254
hyuA_predicted,0.3333333333333333,2,2,TGTGCGATTCACCTCCAAAA,0,1833587
hyuA_predicted,0.3333333333333333,2,2,TGTCTTCTCGTATCGCGTTC,0,1857513
hyuA_predicted,0.3333333333333333,2,2,TGTCTATAAATGTTCGATGT,0,1841921
hyuA_predicted,0.3333333333333333,2,2,TGTCGCTCCCTACCGGCCAA,0,1868655
hyuA_predicted,0.3333333333333333,2,2,TGTCATACGGGTCGTAAGCT,0,1840383
hyuA_predicted,0.3333333333333333,2,2,TGTCAAGCGTCAACGCCCGT,0,1859004
hyuA_predicted,0.3333333333333333,2,2,TGTATCGGGCACGCACCATA,0,1856682
hyuA_predicted,0.3333333333333333,2,2,TGTAGACAAGAAACGCACTA,0,1840910
hyuA_predicted,0.3333333333333333,2,2,TGTACTTGGGCCACCATGGC,0,1843610
hyuA_predicted,0.3333333333333333,2,2,TGTACTGTTCGCCTTCCGCG,0,1850629
hyuA_predicted,0.3333333333333333,2,2,TGTAAGGCGCTCCAGCCGTC,0,1868408
hyuA_predicted,0.3333333333333333,2,2,TGGTTTTTTGTGCATATTTA,0,1844096
hyuA_predicted,0.3333333333333333,2,2,TGGTTATCCGGCCGGGAGTC,0,1873209
hyuA_predicted,0.3333333333333333,2,2,TGGTCGGTGCATGGGCCACC,0,1865362
hyuA_predicted,0.3333333333333333,2,2,TGGTCACCACGCTTTGCTTA,0,1870598
hyuA_predicted,0.3333333333333333,2,2,TGGTAAATATTCCCGCGGTC,0,1842305
hyuA_predicted,0.3333333333333333,2,2,TGGGTAAGATCATAGCTGCC,0,1862889
hyuA_predicted,0.3333333333333333,2,2,TGGGGGTTTTAGATCCTCAT,0,1865001
hyuA_predicted,0.3333333333333333,2,2,TGGGGGTATGAACTAGACTT,0,1846228
hyuA_predicted,0.3333333333333333,2,2,TGGGCTCCATAGAGGCATGT,0,1871548
hyuA_predicted,0.3333333333333333,2,2,TGGGCGTTGGCATGGTCAAG,0,1860459
hyuA_predicted,0.3333333333333333,2,2,TGGGCATCATATACTTGCCC,0,1833437
hyuA_predicted,0.3333333333333333,2,2,TGGGAGTTCCGTTCATTTAA,0,1865452
hyuA_predicted,0.3333333333333333,2,2,TGGGACGTCAGGGTCCGATT,0,1851403
hyuA_predicted,0.3333333333333333,2,2,TGGCTTATCACTGGGAAAAT,0,1833748
hyuA_predicted,0.3333333333333333,2,2,TGGCTGGTATCGCGGTTCTA,0,1852758
hyuA_predicted,0.3333333333333333,2,2,TGGCGCCCGATAACTACGCT,0,1838191
hyuA_predicted,0.3333333333333333,2,2,TGGCCCTTCATATGGGCCGA,0,1857682
hyuA_predicted,0.3333333333333333,2,2,TGGCCCGTTGAGTGGAATGT,0,1838514
hyuA_predicted,0.3333333333333333,2,2,TGGCATCTGACCGAGTCGTG,0,1852195
hyuA_predicted,0.3333333333333333,2,2,TGGATGCCGCTTTCCCGGAT,0,1876558
hyuA_predicted,0.3333333333333333,2,2,TGGATCATGGGTTAGTCCCG,0,1829923
hyuA_predicted,0.3333333333333333,2,2,TGGAGTACCCCCGAACACTA,0,1873835
hyuA_predicted,0.3333333333333333,2,2,TGGACTTCCAATAGACAAGG,0,1835576
hyuA_predicted,0.3333333333333333,2,2,TGGAAGGACTATAGGTTTAA,0,1841745
hyuA_predicted,0.3333333333333333,2,2,TGGAAGCTAGCACCGAAAGC,0,1866015
hyuA_predicted,0.3333333333333333,2,2,TGCTGAGTTGGCAAGCAAGG,0,1855194
hyuA_predicted,0.3333333333333333,2,2,TGCTCCGAGTTTGACCAAGA,0,1844918
hyuA_predicted,0.3333333333333333,2,2,TGCGTATCTTACCTAATAGG,0,1860784
hyuA_predicted,0.3333333333333333,2,2,TGCGGTAAAGAGGCCTCAAT,0,1831898
hyuA_predicted,0.3333333333333333,2,2,TGCGGGCGCAAAAAGCAGAA,0,1849341
hyuA_predicted,0.3333333333333333,2,2,TGCGGCAGGCCCAGTCACGG,0,1838300
hyuA_predicted,0.3333333333333333,2,2,TGCGCTAGCGGATATTTAGG,0,1843356
hyuA_predicted,0.3333333333333333,2,2,TGCGAATGCCAGCGAAAATT,0,1841240
hyuA_predicted,0.3333333333333333,2,2,TGCCTTAGTAGTGCGCCATA,0,1877623
hyuA_predicted,0.3333333333333333,2,2,TGCCTGTCGGGAAGACATAT,0,1831929
hyuA_predicted,0.3333333333333333,2,2,TGCCTCGCGTGTACTCCTAT,0,1864048
hyuA_predicted,0.3333333333333333,2,2,TGCCTCGCAAGCTAGGGCTC,0,1860923
hyuA_predicted,0.3333333333333333,2,2,TGCCTATACGGCTAGACCCG,0,1859273
hyuA_predicted,0.3333333333333333,2,2,TGCCGTTCAGCCATAATGTG,0,1864324
hyuA_predicted,0.3333333333333333,2,2,TGCCGAGATAGGGGACATAC,0,1869380
hyuA_predicted,0.3333333333333333,2,2,TGCCCCTGGTGCCGGGATCT,0,1835854
hyuA_predicted,0.3333333333333333,2,2,TGCCCAAGGACTTAACGAGA,0,1854754
hyuA_predicted,0.3333333333333333,2,2,TGCCACATGTATTTACCTAA,0,1851931
hyuA_predicted,0.3333333333333333,2,2,TGCATGCCGACGCTCGCGCG,0,1866252
hyuA_predicted,0.3333333333333333,2,2,TGCAGCCGTGGAAGGTGCAG,0,1829262
hyuA_predicted,0.3333333333333333,2,2,TGCAGCCAAAGCTTATACGT,0,1835529
hyuA_predicted,0.3333333333333333,2,2,TGCACTGGCCGAGGTGCGGT,0,1847831
hyuA_predicted,0.3333333333333333,2,2,TGCAAGTGCAGGGCTGGGAG,0,1877515
hyuA_predicted,0.3333333333333333,2,2,TGATTGAAAGCAAGGCCCGA,0,1844318
hyuA_predicted,0.3333333333333333,2,2,TGATTACGTTGCGGGTTAGG,0,1842574
hyuA_predicted,0.3333333333333333,2,2,TGATGTACAGTATTGGTGAA,0,1836780
hyuA_predicted,0.3333333333333333,2,2,TGATGTAACGTGAACCTATG,0,1861689
hyuA_predicted,0.3333333333333333,2,2,TGATGCATGTTAATCGCACT,0,1868833
hyuA_predicted,0.3333333333333333,2,2,TGATATCTGACCCTATGATC,0,1847531
hyuA_predicted,0.3333333333333333,2,2,TGATAAACCCACATCCAATT,0,1851259
hyuA_predicted,0.3333333333333333,2,2,TGAGTTTGTCTTCGCGCTGA,0,1875539
hyuA_predicted,0.3333333333333333,2,2,TGAGTTAGTGGCGGGATCTG,0,1830379
hyuA_predicted,0.3333333333333333,2,2,TGAGTCCTGCACCCAGTTAG,0,1857039
hyuA_predicted,0.3333333333333333,2,2,TGAGTAATTTTCAACGGAGG,0,1857063
hyuA_predicted,0.3333333333333333,2,2,TGAGGGGTTTTCGTTGCCTC,0,1861312
hyuA_predicted,0.3333333333333333,2,2,TGAGCGTCGCAGGCCTCTGT,0,1875923
hyuA_predicted,0.3333333333333333,2,2,TGAGCATTCGGATCAGGTCA,0,1856484
hyuA_predicted,0.3333333333333333,2,2,TGAGAGGGCAATCATAACGT,0,1870258
hyuA_predicted,0.3333333333333333,2,2,TGACGTTGTGGCTATTTCCT,0,1840215
hyuA_predicted,0.3333333333333333,2,2,TGACCCGAGCTCAGTGAAGG,0,1871836
hyuA_predicted,0.3333333333333333,2,2,TGACCAGCAAAACAGATACT,0,1856294
hyuA_predicted,0.3333333333333333,2,2,TGACATGTGCGTGGTTACGC,0,1830253
hyuA_predicted,0.3333333333333333,2,2,TGACAACAAGATTAGAAGGC,0,1843738
hyuA_predicted,0.3333333333333333,2,2,TGAATTTGACGGCTTTGCGA,0,1869953
hyuA_predicted,0.3333333333333333,2,2,TGAATGTCGCTGGCAATCGG,0,1869108
hyuA_predicted,0.3333333333333333,2,2,TGAATATACCGGGTCTCGAC,0,1854088
hyuA_predicted,0.3333333333333333,2,2,TGAAGGTCTGTTCAACCGTT,0,1868755
hyuA_predicted,0.3333333333333333,2,2,TGAAGCATCATGTAGCAGAA,0,1869387
hyuA_predicted,0.3333333333333333,2,2,TGAACTGGGTTTCTGGGGCA,0,1857296
hyuA_predicted,0.3333333333333333,2,2,TGAAATGTAGAGCCGCGGCA,0,1835872
hyuA_predicted,0.3333333333333333,2,2,TCTTTGGCGATCGTGCCCTG,0,1851359
hyuA_predicted,0.3333333333333333,2,2,TCTTTCTTACGAGCGAAGGG,0,1867181
hyuA_predicted,0.3333333333333333,2,2,TCTTTCAGTTGTAGGCGCCA,0,1874093
hyuA_predicted,0.3333333333333333,2,2,TCTTGGTCTCGATCTCATAA,0,1866339
hyuA_predicted,0.3333333333333333,2,2,TCTTGGGATTAGCATCCGCT,0,1850487
hyuA_predicted,0.3333333333333333,2,2,TCTTCTTAAGTATTAATCCG,0,1869359
hyuA_predicted,0.3333333333333333,2,2,TCTTCAACGTCTATACTCTA,0,1871522
hyuA_predicted,0.3333333333333333,2,2,TCTGTCAGCTACATCGCGAA,0,1844359
hyuA_predicted,0.3333333333333333,2,2,TCTGGGACAGGGAGTCCTTG,0,1860436
hyuA_predicted,0.3333333333333333,2,2,TCTGCGAGGCCTCAAATCTA,0,1843327
hyuA_predicted,0.3333333333333333,2,2,TCTGACATTGTTCTCTCAAT,0,1857461
hyuA_predicted,0.3333333333333333,2,2,TCTGAAGGTCGCCGACTCCT,0,1844829
hyuA_predicted,0.3333333333333333,2,2,TCTCTATCCTGACACTTCGT,0,1871136
hyuA_predicted,0.3333333333333333,2,2,TCTCCGAAGCGGGATTGGTT,0,1873678
hyuA_predicted,0.3333333333333333,2,2,TCTATTGATCGCGGCTTGGT,0,1856161
hyuA_predicted,0.3333333333333333,2,2,TCTATTGAGTATCCTGAGCT,0,1852335
hyuA_predicted,0.3333333333333333,2,2,TCTATGGGACTTCGGCTGTG,0,1856413
hyuA_predicted,0.3333333333333333,2,2,TCTAGTCTCTCAGGTTGTGA,0,1861469
hyuA_predicted,0.3333333333333333,2,2,TCTAGAAATGGGCGGCAATC,0,1848571
hyuA_predicted,0.3333333333333333,2,2,TCTACTCCAATGGCCCTGGA,0,1856056
hyuA_predicted,0.3333333333333333,2,2,TCTACCTTCATTAACTCTAA,0,1852952
hyuA_predicted,0.3333333333333333,2,2,TCTACCGCGCACGCGCTTCT,0,1853618
hyuA_predicted,0.3333333333333333,2,2,TCTAAGCAAGTCTTATCGAG,0,1871333
hyuA_predicted,0.3333333333333333,2,2,TCTAACATAGGCATAAAGCC,0,1836130
hyuA_predicted,0.3333333333333333,2,2,TCGTTCCAACGACTGGTAAA,0,1861389
hyuA_predicted,0.3333333333333333,2,2,TCGTGAGGGTAGCAACTTCG,0,1828948
hyuA_predicted,0.3333333333333333,2,2,TCGTACCATTAAGCAATAGT,0,1866489
hyuA_predicted,0.3333333333333333,2,2,TCGGTTATGAACGCGGCTCC,0,1863754
hyuA_predicted,0.3333333333333333,2,2,TCGGTGATTCGTTGCGCTTA,0,1843183
hyuA_predicted,0.3333333333333333,2,2,TCGGGTCCGTCACACGTATG,0,1832833
hyuA_predicted,0.3333333333333333,2,2,TCGGGGTCATTATTTAATTC,0,1874053
hyuA_predicted,0.3333333333333333,2,2,TCGGGGGAACCAAAATGATA,0,1845467
hyuA_predicted,0.3333333333333333,2,2,TCGGCTAGGCACGAACGTCA,0,1869724
hyuA_predicted,0.3333333333333333,2,2,TCGGCGTGAAGCTCACATCG,0,1849982
hyuA_predicted,0.3333333333333333,2,2,TCGGACTTGGCCTTCCACGT,0,1837515
hyuA_predicted,0.3333333333333333,2,2,TCGGACACTCGCGCGAGTCA,0,1837367
hyuA_predicted,0.3333333333333333,2,2,TCGCGCGTTCAGCTGTGGGA,0,1860206
hyuA_predicted,0.3333333333333333,2,2,TCGCATACATCACCACCTAG,0,1829240
hyuA_predicted,0.3333333333333333,2,2,TCGCAGACTAGGGTGGTGTT,0,1836281
hyuA_predicted,0.3333333333333333,2,2,TCGATGGTGACTCATCGGTC,0,1864959
hyuA_predicted,0.3333333333333333,2,2,TCGATCCTGCAAAAAGTCTA,0,1874562
hyuA_predicted,0.3333333333333333,2,2,TCGATAGTGCCCGAGGCATT,0,1856141
hyuA_predicted,0.3333333333333333,2,2,TCGAGGTACGTTGGCTTGTG,0,1843366
hyuA_predicted,0.3333333333333333,2,2,TCGAGCCGCAGGCGACGACT,0,1862311
hyuA_predicted,0.3333333333333333,2,2,TCGAACAGGTCTTATCCAAA,0,1872407
hyuA_predicted,0.3333333333333333,2,2,TCCTTTAAAAGGTACAAATG,0,1843406
hyuA_predicted,0.3333333333333333,2,2,TCCTTCGAGCGCCGGTTATC,0,1864685
hyuA_predicted,0.3333333333333333,2,2,TCCTTAGGGCGCCAATTCAA,0,1870353
hyuA_predicted,0.3333333333333333,2,2,TCCTCCATTCAGCAGTTGGT,0,1845270
hyuA_predicted,0.3333333333333333,2,2,TCCTCATTTCGGTCGATTTT,0,1853069
hyuA_predicted,0.3333333333333333,2,2,TCCTACTCAGCAGTCGCATG,0,1856254
hyuA_predicted,0.3333333333333333,2,2,TCCTACGCTTGCGCGACCAT,0,1832450
hyuA_predicted,0.3333333333333333,2,2,TCCGTGTTTGGTATCCCAAT,0,1835312
hyuA_predicted,0.3333333333333333,2,2,TCCGGTTGTCGCGACACTAT,0,1829295
hyuA_predicted,0.3333333333333333,2,2,TCCGGTCATGATACGCCTAC,0,1845167
hyuA_predicted,0.3333333333333333,2,2,TCCGGTAATAAAGAATGGTC,0,1869412
hyuA_predicted,0.3333333333333333,2,2,TCCGGGCGCTCATAGTCCGG,0,1832285
hyuA_predicted,0.3333333333333333,2,2,TCCGCGTAACCTGTAAGTCG,0,1872329
hyuA_predicted,0.3333333333333333,2,2,TCCGCATGGCTTCCCCGTTG,0,1875429
hyuA_predicted,0.3333333333333333,2,2,TCCGCACTAACGGTCGCCAT,0,1829047
hyuA_predicted,0.3333333333333333,2,2,TCCCTGTATCTCTCATTGGA,0,1841689
hyuA_predicted,0.3333333333333333,2,2,TCCCGGTCAGTACTTTGGTT,0,1868703
hyuA_predicted,0.3333333333333333,2,2,TCCATTCAGTCACACATTGT,0,1837680
hyuA_predicted,0.3333333333333333,2,2,TCCATGGTGGGATCGTACAT,0,1836244
hyuA_predicted,0.3333333333333333,2,2,TCCATGGGACAGCTGGATGT,0,1838171
hyuA_predicted,0.3333333333333333,2,2,TCCAATGTTTTCCGAGTTTC,0,1872737
hyuA_predicted,0.3333333333333333,2,2,TCCAATAGCTCCAGCCGCTC,0,1848572
hyuA_predicted,0.3333333333333333,2,2,TCCAAGAAAGCCGGCCACTA,0,1873522
hyuA_predicted,0.3333333333333333,2,2,TCATGGGTGGGCGCCTTGTA,0,1859498
hyuA_predicted,0.3333333333333333,2,2,TCATGCTGTCGCGACTGGTG,0,1850325
hyuA_predicted,0.3333333333333333,2,2,TCATGCCATAGCGGGGCAGA,0,1867675
hyuA_predicted,0.3333333333333333,2,2,TCATGATGACATGTTTCACC,0,1847029
hyuA_predicted,0.3333333333333333,2,2,TCATGATCTTCTGTGCACTA,0,1872174
hyuA_predicted,0.3333333333333333,2,2,TCATAGAGACACATAATTTC,0,1862492
hyuA_predicted,0.3333333333333333,2,2,TCAGGTATTTAAGAAGAGGA,0,1877009
hyuA_predicted,0.3333333333333333,2,2,TCAGGGTAGTGTTCGGGGGA,0,1864690
hyuA_predicted,0.3333333333333333,2,2,TCAGGGGCAGGGTTTAGGTG,0,1853993
hyuA_predicted,0.3333333333333333,2,2,TCAGCAGTGCTATCGAGAGA,0,1862884
hyuA_predicted,0.3333333333333333,2,2,TCACTTGGTCGCCACCCTAT,0,1858261
hyuA_predicted,0.3333333333333333,2,2,TCACTTCTGTGAAACCACTC,0,1863401
hyuA_predicted,0.3333333333333333,2,2,TCACTTATTAAAGCGGCTCC,0,1877776
hyuA_predicted,0.3333333333333333,2,2,TCACTGCCTTCAGGTTGTTC,0,1836296
hyuA_predicted,0.3333333333333333,2,2,TCACGTGAGTATATCTATCA,0,1859269
hyuA_predicted,0.3333333333333333,2,2,TCACCTTATCAAGTAAACGG,0,1870716
hyuA_predicted,0.3333333333333333,2,2,TCAATCTGGTGCGCGCCATC,0,1851963
hyuA_predicted,0.3333333333333333,2,2,TCAAGTGGTGCATCTGCACT,0,1845456
hyuA_predicted,0.3333333333333333,2,2,TCAACTTTCGTACAGTAGCG,0,1834292
hyuA_predicted,0.3333333333333333,2,2,TCAACTTAACAGGGGCTTTT,0,1833231
hyuA_predicted,0.3333333333333333,2,2,TCAACAAGCAGATTCGGTGG,0,1848790
hyuA_predicted,0.3333333333333333,2,2,TATTTGTTTTTCTATCGATT,0,1849985
hyuA_predicted,0.3333333333333333,2,2,TATTTGATATCATGCCACGT,0,1850091
hyuA_predicted,0.3333333333333333,2,2,TATTTACAGTGTATCTCACC,0,1837269
hyuA_predicted,0.3333333333333333,2,2,TATTGGTGTGATGCAAGGTT,0,1840225
hyuA_predicted,0.3333333333333333,2,2,TATTAGCCATAAGTTTGAGT,0,1856135
hyuA_predicted,0.3333333333333333,2,2,TATTAATTGAACAGCATGCT,0,1868931
hyuA_predicted,0.3333333333333333,2,2,TATTAATCGTCACTACCGTA,0,1855191
hyuA_predicted,0.3333333333333333,2,2,TATGTTACTGAGGTAGAAGT,0,1863807
hyuA_predicted,0.3333333333333333,2,2,TATGTGTCGTGTATGTATGG,0,1859499
hyuA_predicted,0.3333333333333333,2,2,TATGTGCCTAGGTGCTCTGG,0,1837732
hyuA_predicted,0.3333333333333333,2,2,TATGGGTTCGCACGTTTATG,0,1850773
hyuA_predicted,0.3333333333333333,2,2,TATGGCTTAGAGCGTGGTTA,0,1837216
hyuA_predicted,0.3333333333333333,2,2,TATGGCGGCTCACCTGCCCA,0,1855906
hyuA_predicted,0.3333333333333333,2,2,TATGCAGCCACTAATCATAA,0,1862075
hyuA_predicted,0.3333333333333333,2,2,TATGATCCGTACCCCACCTA,0,1842984
hyuA_predicted,0.3333333333333333,2,2,TATCAACGGATTTGCGGTTG,0,1857118
hyuA_predicted,0.3333333333333333,2,2,TATATGAGGGGCAAACCACT,0,1856485
hyuA_predicted,0.3333333333333333,2,2,TATATGAAAATCGACGGCCC,0,1866057
hyuA_predicted,0.3333333333333333,2,2,TATATAGCGGGGGAACTCAC,0,1848264
hyuA_predicted,0.3333333333333333,2,2,TATAGAGCATCACCCACCGG,0,1854976
hyuA_predicted,0.3333333333333333,2,2,TATACTTGTTGTCCAGGAAC,0,1877186
hyuA_predicted,0.3333333333333333,2,2,TATAATAGACTACGCGGTCA,0,1864872
hyuA_predicted,0.3333333333333333,2,2,TAGGTCGGCCGAGGGGGTCC,0,1844402
hyuA_predicted,0.3333333333333333,2,2,TAGGGTCTAATCAGGTGGTT,0,1854721
hyuA_predicted,0.3333333333333333,2,2,TAGGGTCGTCCCCAAGATAC,0,1862877
hyuA_predicted,0.3333333333333333,2,2,TAGGGGCGTTACCGTCTCTG,0,1875754
hyuA_predicted,0.3333333333333333,2,2,TAGGGCAGCATACGGTATGG,0,1845382
hyuA_predicted,0.3333333333333333,2,2,TAGGCCACTTTCAAGGAGGA,0,1857394
hyuA_predicted,0.3333333333333333,2,2,TAGGATTGATTAACACATCG,0,1856128
hyuA_predicted,0.3333333333333333,2,2,TAGGAGTTGCGAGGACTTAA,0,1842915
hyuA_predicted,0.3333333333333333,2,2,TAGCGGGCAAGCAAGTTACA,0,1854971
hyuA_predicted,0.3333333333333333,2,2,TAGCCCTCCTGTAAACATTA,0,1871945
hyuA_predicted,0.3333333333333333,2,2,TAGATACGCTTCAACACTGC,0,1831021
hyuA_predicted,0.3333333333333333,2,2,TAGAGGCAGGACCGGTCAAA,0,1835489
hyuA_predicted,0.3333333333333333,2,2,TAGACATGTCGAAACAGAAT,0,1853014
hyuA_predicted,0.3333333333333333,2,2,TAGAAAAATGAATCGCCACT,0,1846823
hyuA_predicted,0.3333333333333333,2,2,TACTTTTTGGAGCGAGACGC,0,1831233
hyuA_predicted,0.3333333333333333,2,2,TACTGGCTAATGCAGCTAAA,0,1875433
hyuA_predicted,0.3333333333333333,2,2,TACTCCGGGTAACGGGGTCT,0,1832803
hyuA_predicted,0.3333333333333333,2,2,TACGTGGTTGATCAAAGCTG,0,1861101
hyuA_predicted,0.3333333333333333,2,2,TACGGTTTTCGAGAATTGCG,0,1874770
hyuA_predicted,0.3333333333333333,2,2,TACGGGCTCGGACGCGGGTT,0,1834913
hyuA_predicted,0.3333333333333333,2,2,TACGCGTGGCAACAAACGTC,0,1854084
hyuA_predicted,0.3333333333333333,2,2,TACGCGTCGCAAAAATGGTT,0,1876283
hyuA_predicted,0.3333333333333333,2,2,TACGCGCCTGGTCCTAGGGA,0,1874684
hyuA_predicted,0.3333333333333333,2,2,TACGCCGGTGCTTTTACTCA,0,1858303
hyuA_predicted,0.3333333333333333,2,2,TACGCATGAGCTGCAACCTG,0,1838489
hyuA_predicted,0.3333333333333333,2,2,TACGATCGTACTTACATCTG,0,1861682
hyuA_predicted,0.3333333333333333,2,2,TACGACTTGCGACCCAAAAA,0,1831776
hyuA_predicted,0.3333333333333333,2,2,TACGACATATTGGCAGGCTC,0,1851753
hyuA_predicted,0.3333333333333333,2,2,TACCTGCCGTACTCAGTCGG,0,1836950
hyuA_predicted,0.3333333333333333,2,2,TACCCGTGCAGGCCAATGTA,0,1858689
hyuA_predicted,0.3333333333333333,2,2,TACCACAAAGGGACTTCATA,0,1870914
hyuA_predicted,0.3333333333333333,2,2,TACACGGCATTCGTTATTCA,0,1860394
hyuA_predicted,0.3333333333333333,2,2,TACACGCAGCTTAAAATTGC,0,1829999
hyuA_predicted,0.3333333333333333,2,2,TACAATGTCAGTATTCGCAA,0,1877228
hyuA_predicted,0.3333333333333333,2,2,TACAAATCGTGGCGCGCTAT,0,1846598
hyuA_predicted,0.3333333333333333,2,2,TAATGGATCTACTCACGATC,0,1845022
hyuA_predicted,0.3333333333333333,2,2,TAATGCAAGGGGTTAAATAT,0,1871799
hyuA_predicted,0.3333333333333333,2,2,TAATGAGGCGACCTCAACGA,0,1840150
hyuA_predicted,0.3333333333333333,2,2,TAATCATTTGCCCGGGGCTC,0,1858947
hyuA_predicted,0.3333333333333333,2,2,TAATAGGGTTATAGCGGGCA,0,1861298
hyuA_predicted,0.3333333333333333,2,2,TAATAAAGTGCTTAATTACT,0,1835483
hyuA_predicted,0.3333333333333333,2,2,TAAGTGGCGCAAGTACATTT,0,1847873
hyuA_predicted,0.3333333333333333,2,2,TAAGTCGTTCCAGGGGAACA,0,1873773
hyuA_predicted,0.3333333333333333,2,2,TAAGGTAGTCTAAAAAACAA,0,1875881
hyuA_predicted,0.3333333333333333,2,2,TAAGCTCAATCCGAAGAACT,0,1848563
hyuA_predicted,0.3333333333333333,2,2,TAAGAGCCAGAGGTTGTAAA,0,1860009
hyuA_predicted,0.3333333333333333,2,2,TAACGTGCCAATGGATGCCG,0,1858634
hyuA_predicted,0.3333333333333333,2,2,TAACGCAGAAGAGGTGCATA,0,1864686
hyuA_predicted,0.3333333333333333,2,2,TAAATGCCGCGTTTCTCACT,0,1860912
hyuA_predicted,0.3333333333333333,2,2,TAAATCGTTCCCATTGGCAT,0,1854833
hyuA_predicted,0.3333333333333333,2,2,TAAATCCAGTGTACCGGAAG,0,1857619
hyuA_predicted,0.3333333333333333,2,2,TAAATATTAAATTGAATTTT,0,1841928
hyuA_predicted,0.3333333333333333,2,2,TAAATACTAATTTGGTGCCC,0,1870019
hyuA_predicted,0.3333333333333333,2,2,TAAAGCTTGACCATATTAAT,0,1843871
hyuA_predicted,0.3333333333333333,2,2,TAAACTTAACACGTAAAAAC,0,1857373
hyuA_predicted,0.3333333333333333,2,2,TAAAATATCGTGGTATCTTA,0,1864584
hyuA_predicted,0.3333333333333333,2,2,GTTTTCCAATAGGTCCAAAA,0,1871982
hyuA_predicted,0.3333333333333333,2,2,GTTTGCATTCGGTTATTTTC,0,1874928
hyuA_predicted,0.3333333333333333,2,2,GTTTGCACTAGATTGGTTGC,0,1849330
hyuA_predicted,0.3333333333333333,2,2,GTTTGACACAAAGCATAGTA,0,1830467
hyuA_predicted,0.3333333333333333,2,2,GTTTCTTTATGTCAGTGGAT,0,1833984
hyuA_predicted,0.3333333333333333,2,2,GTTTCGCTAACTATGAGATG,0,1833407
hyuA_predicted,0.3333333333333333,2,2,GTTGTGCGACGCCAGCGGAA,0,1867200
hyuA_predicted,0.3333333333333333,2,2,GTTGCGCCTCCACGGCCGAT,0,1834875
hyuA_predicted,0.3333333333333333,2,2,GTTGCCATATGAGCGGGTGC,0,1859736
hyuA_predicted,0.3333333333333333,2,2,GTTGAACGGGTGCGGAGTGG,0,1841586
hyuA_predicted,0.3333333333333333,2,2,GTTCTTTGGCGCTCGCTAAT,0,1857551
hyuA_predicted,0.3333333333333333,2,2,GTTCTGCTAAACCTCCAATT,0,1846156
hyuA_predicted,0.3333333333333333,2,2,GTTCTGAGAATCGGGATGAC,0,1865793
hyuA_predicted,0.3333333333333333,2,2,GTTCGGTCAAGAAATTAGTT,0,1852754
hyuA_predicted,0.3333333333333333,2,2,GTTCGGAACACTGTCGAGAA,0,1872639
hyuA_predicted,0.3333333333333333,2,2,GTTATAACTACGGTCGGGGC,0,1840377
hyuA_predicted,0.3333333333333333,2,2,GTTACCACACCGGGTCATGT,0,1830265
hyuA_predicted,0.3333333333333333,2,2,GTTACACGGTATCCGCGGGA,0,1853798
hyuA_predicted,0.3333333333333333,2,2,GTGTGTGTAAGCATGTCGTT,0,1875111
hyuA_predicted,0.3333333333333333,2,2,GTGTGCTGCGGTAAGGAACT,0,1848263
hyuA_predicted,0.3333333333333333,2,2,GTGTGAGGATGATCGTGTTA,0,1858005
hyuA_predicted,0.3333333333333333,2,2,GTGTCACTTAATTTCTACCA,0,1861930
hyuA_predicted,0.3333333333333333,2,2,GTGTATGTCTCTAATGTGCT,0,1851419
hyuA_predicted,0.3333333333333333,2,2,GTGTATCCTAGCAGACCCCG,0,1832708
hyuA_predicted,0.3333333333333333,2,2,GTGGGTACCACGTGCAACAC,0,1853038
hyuA_predicted,0.3333333333333333,2,2,GTGGGACAGAGGGCCGAAAG,0,1839973
hyuA_predicted,0.3333333333333333,2,2,GTGGCTGAGATAGTAGGTTA,0,1870389
hyuA_predicted,0.3333333333333333,2,2,GTGGCACTACGTCGGCTTAA,0,1850137
hyuA_predicted,0.3333333333333333,2,2,GTGGAATCTTTGAAAACCGG,0,1852034
hyuA_predicted,0.3333333333333333,2,2,GTGCGGCAATTTTAAGTTGA,0,1857871
hyuA_predicted,0.3333333333333333,2,2,GTGCGCACTGTGCGCAGTTA,0,1845118
hyuA_predicted,0.3333333333333333,2,2,GTGCGAGGCGCGGCGGCTTA,0,1858552
hyuA_predicted,0.3333333333333333,2,2,GTGCCGGATGATATAGGGAC,0,1854016
hyuA_predicted,0.3333333333333333,2,2,GTGCCCTACCGAGCAACGGT,0,1870398
hyuA_predicted,0.3333333333333333,2,2,GTGCCCCCTGTGGTCCAGCG,0,1849237
hyuA_predicted,0.3333333333333333,2,2,GTGCATAGCGACCAGGGGTC,0,1830750
hyuA_predicted,0.3333333333333333,2,2,GTGATTGAGCGCGCTCCACT,0,1856613
hyuA_predicted,0.3333333333333333,2,2,GTGAGCCGAATGTGCGAGCT,0,1829115
hyuA_predicted,0.3333333333333333,2,2,GTGACATATCCGTAAATGTG,0,1846253
hyuA_predicted,0.3333333333333333,2,2,GTCTTTATACATTTCTACGC,0,1859088
hyuA_predicted,0.3333333333333333,2,2,GTCTTGGTATCTTGATCGCG,0,1876428
hyuA_predicted,0.3333333333333333,2,2,GTCTCTACGCAAATATCGCG,0,1832625
hyuA_predicted,0.3333333333333333,2,2,GTCTCGAACAGACTGCAGGG,0,1831218
hyuA_predicted,0.3333333333333333,2,2,GTCTCAGGGGTCACACATAA,0,1832257
hyuA_predicted,0.3333333333333333,2,2,GTCGTGGTACCTCCGTAGAG,0,1867406
hyuA_predicted,0.3333333333333333,2,2,GTCGTGATAGTCGCGCGTCT,0,1843112
hyuA_predicted,0.3333333333333333,2,2,GTCGTAGATTTGAGAAGACG,0,1849667
hyuA_predicted,0.3333333333333333,2,2,GTCGTAATCCGGTAGTGGGG,0,1841936
hyuA_predicted,0.3333333333333333,2,2,GTCGGGGTAGGACCTAGAAG,0,1842910
hyuA_predicted,0.3333333333333333,2,2,GTCGCGGCAAGGTCTACGAT,0,1840506
hyuA_predicted,0.3333333333333333,2,2,GTCCTTCTTATAGAGCGACG,0,1852575
hyuA_predicted,0.3333333333333333,2,2,GTCCTCCAACTAAGGATGAA,0,1872044
hyuA_predicted,0.3333333333333333,2,2,GTCCGTGAACACGTCGGATT,0,1837946
hyuA_predicted,0.3333333333333333,2,2,GTCATGTCCCGGCGAAAAGT,0,1840921
hyuA_predicted,0.3333333333333333,2,2,GTCATGCCTTTCGACGGCTT,0,1832289
hyuA_predicted,0.3333333333333333,2,2,GTCAGTCATAAGTGTAAAGA,0,1865889
hyuA_predicted,0.3333333333333333,2,2,GTCAGACCCTTGGAACGAAC,0,1837421
hyuA_predicted,0.3333333333333333,2,2,GTCACTGCATCCTCGTACGC,0,1859380
hyuA_predicted,0.3333333333333333,2,2,GTATGCGTTCGAGGGGGTTA,0,1846984
hyuA_predicted,0.3333333333333333,2,2,GTATCTTCACTAGGCCGGGT,0,1843658
hyuA_predicted,0.3333333333333333,2,2,GTATCGCAAACCGCCAGCAC,0,1873467
hyuA_predicted,0.3333333333333333,2,2,GTATAGCCGTGGGTATCAGG,0,1855736
hyuA_predicted,0.3333333333333333,2,2,GTATACTGCCTACAGAATCA,0,1835205
hyuA_predicted,0.3333333333333333,2,2,GTAGTCGTGTGCATGGTGCC,0,1849779
hyuA_predicted,0.3333333333333333,2,2,GTAGTCAGACAGTAGCAATA,0,1870046
hyuA_predicted,0.3333333333333333,2,2,GTAGGCTTGGATTCACCGTA,0,1855901
hyuA_predicted,0.3333333333333333,2,2,GTAGCGCCCCTAGACGAACC,0,1856666
hyuA_predicted,0.3333333333333333,2,2,GTAGCGAGTATCTGTATTTC,0,1843718
hyuA_predicted,0.3333333333333333,2,2,GTACTTGCCCCGCTTTTTAA,0,1873313
hyuA_predicted,0.3333333333333333,2,2,GTACTTAGGTGCAGTTGCGA,0,1845471
hyuA_predicted,0.3333333333333333,2,2,GTACCCGGCTGCGCCGCTGC,0,1864707
hyuA_predicted,0.3333333333333333,2,2,GTACCATGTTGGGGGATTGA,0,1833114
hyuA_predicted,0.3333333333333333,2,2,GTAATCGTGTATGCGTTCAC,0,1876184
hyuA_predicted,0.3333333333333333,2,2,GTAAGTTGGAGACGTCACTC,0,1872899
hyuA_predicted,0.3333333333333333,2,2,GTAAGCGGAATCGTGTGCGT,0,1832089
hyuA_predicted,0.3333333333333333,2,2,GTAACGTGGGCTCTTGTCCA,0,1845468
hyuA_predicted,0.3333333333333333,2,2,GTAAAGTTCCATTGATTGCT,0,1859145
hyuA_predicted,0.3333333333333333,2,2,GGTTTGTGGTCAGGCTGGCA,0,1856275
hyuA_predicted,0.3333333333333333,2,2,GGTTTGCGATCACTCACGGC,0,1872879
hyuA_predicted,0.3333333333333333,2,2,GGTTGGCCGTTCATATTGAA,0,1856929
hyuA_predicted,0.3333333333333333,2,2,GGTTATGAGGGGCAACGCTA,0,1864780
hyuA_predicted,0.3333333333333333,2,2,GGTTAGCTTACGAGCTTCCG,0,1830703
hyuA_predicted,0.3333333333333333,2,2,GGTGGGCCGAGCCAGTCCAC,0,1870891
hyuA_predicted,0.3333333333333333,2,2,GGTGGCATTCCCTAGTGGCA,0,1852266
hyuA_predicted,0.3333333333333333,2,2,GGTGCCCACCGTTCAAATCC,0,1872395
hyuA_predicted,0.3333333333333333,2,2,GGTGAGCATACCCCGATAAG,0,1845448
hyuA_predicted,0.3333333333333333,2,2,GGTCGGATTAACGCGTTCCT,0,1843530
hyuA_predicted,0.3333333333333333,2,2,GGTCGCCCCAAATATTTTAT,0,1856250
hyuA_predicted,0.3333333333333333,2,2,GGTCGAGCTAATTAGAGGCA,0,1868564
hyuA_predicted,0.3333333333333333,2,2,GGTCCTGCTCAACCCGCTGA,0,1860554
hyuA_predicted,0.3333333333333333,2,2,GGTCAGGGGGGCTACCTCGA,0,1858355
hyuA_predicted,0.3333333333333333,2,2,GGTCACGTTGAATTCTGGCC,0,1841221
hyuA_predicted,0.3333333333333333,2,2,GGTATTCTGGACCGCAACAT,0,1845207
hyuA_predicted,0.3333333333333333,2,2,GGTATCAATCCAGAACCCAG,0,1853775
hyuA_predicted,0.3333333333333333,2,2,GGTAGTCGCAAACGTGAAAA,0,1851517
hyuA_predicted,0.3333333333333333,2,2,GGTAGACGTGAACGGTCATA,0,1853659
hyuA_predicted,0.3333333333333333,2,2,GGTACGGCACATTATTCAAA,0,1836778
hyuA_predicted,0.3333333333333333,2,2,GGGTTACCCCCGTCAGGCAA,0,1838732
hyuA_predicted,0.3333333333333333,2,2,GGGTGTTTGTTGGGTGGTTG,0,1832046
hyuA_predicted,0.3333333333333333,2,2,GGGTGTGGTTGCCTAAATGA,0,1838958
hyuA_predicted,0.3333333333333333,2,2,GGGTGCTGTCAAGGTCCTGT,0,1843076
hyuA_predicted,0.3333333333333333,2,2,GGGTCTCACGTACTTAGGGG,0,1868284
hyuA_predicted,0.3333333333333333,2,2,GGGTCTAGTGCAGCCCTATT,0,1870838
hyuA_predicted,0.3333333333333333,2,2,GGGTCAGCGCGGCGTATGGA,0,1855410
hyuA_predicted,0.3333333333333333,2,2,GGGTCAGCACCTGCAACGGC,0,1844518
hyuA_predicted,0.3333333333333333,2,2,GGGTCAATGACAAGAGAGCG,0,1842222
hyuA_predicted,0.3333333333333333,2,2,GGGTATGAGAATCTTGCAAT,0,1840181
hyuA_predicted,0.3333333333333333,2,2,GGGGTGCGGTCCACGGGCAA,0,1876797
hyuA_predicted,0.3333333333333333,2,2,GGGGTCTTGGCGGTTACCGT,0,1872440
hyuA_predicted,0.3333333333333333,2,2,GGGGGGTGTCCACAGGTTTG,0,1834777
hyuA_predicted,0.3333333333333333,2,2,GGGGGCAACGTCCGGCTTGA,0,1857573
hyuA_predicted,0.3333333333333333,2,2,GGGGCTCGTGCGACCCACAA,0,1855930
hyuA_predicted,0.3333333333333333,2,2,GGGGCATACTCCAAGGCGCC,0,1875664
hyuA_predicted,0.3333333333333333,2,2,GGGGAGGCCTCTGAATGGTG,0,1838002
hyuA_predicted,0.3333333333333333,2,2,GGGCTAGTCATGATGTGGAA,0,1876699
hyuA_predicted,0.3333333333333333,2,2,GGGCTACATATCTCCCAGGA,0,1828967
hyuA_predicted,0.3333333333333333,2,2,GGGCGGTAAGACGTGTGCGT,0,1839412
hyuA_predicted,0.3333333333333333,2,2,GGGATGAAACGGCAGGTAGC,0,1836783
hyuA_predicted,0.3333333333333333,2,2,GGGATCTCATCAGTTACTGG,0,1850811
hyuA_predicted,0.3333333333333333,2,2,GGGAGTTTAAGAGTAAAGAG,0,1868527
hyuA_predicted,0.3333333333333333,2,2,GGGAGTACTAAACGTCCGCA,0,1842956
hyuA_predicted,0.3333333333333333,2,2,GGGACTCAAGCGCGTCTATC,0,1840168
hyuA_predicted,0.3333333333333333,2,2,GGGACCTTCGGGCATAAGAA,0,1831146
hyuA_predicted,0.3333333333333333,2,2,GGGACAGGAGGCAGTATCTA,0,1873457
hyuA_predicted,0.3333333333333333,2,2,GGGAATGGAGAATCAAAACC,0,1849092
hyuA_predicted,0.3333333333333333,2,2,GGGAAGCCGAGGCAGCCTGT,0,1873891
hyuA_predicted,0.3333333333333333,2,2,GGCTGAAAGGGACCCCGGTT,0,1860484
hyuA_predicted,0.3333333333333333,2,2,GGCTCGTTGATATACACTGT,0,1842901
hyuA_predicted,0.3333333333333333,2,2,GGCTCGGTACCAGCCGCGGA,0,1848059
hyuA_predicted,0.3333333333333333,2,2,GGCGTGATACAAATGCAAGA,0,1872161
hyuA_predicted,0.3333333333333333,2,2,GGCGTACTTCCCAAGTATAC,0,1830656
hyuA_predicted,0.3333333333333333,2,2,GGCGCCCCCAATTAGTAAGT,0,1867826
hyuA_predicted,0.3333333333333333,2,2,GGCCTCTATCGACGCTATCG,0,1840611
hyuA_predicted,0.3333333333333333,2,2,GGCCGGATCCGGTGTGAGTC,0,1842943
hyuA_predicted,0.3333333333333333,2,2,GGCCGATTTAGCTTGGTCCA,0,1839118
hyuA_predicted,0.3333333333333333,2,2,GGCCACATTTGCTCGACATG,0,1841306
hyuA_predicted,0.3333333333333333,2,2,GGCCAAATCGACAACCACGT,0,1849332
hyuA_predicted,0.3333333333333333,2,2,GGCATTGTCACAGCGGCGGT,0,1842276
hyuA_predicted,0.3333333333333333,2,2,GGCATGTGTGGGTGTCGTTC,0,1863604
hyuA_predicted,0.3333333333333333,2,2,GGCATCTTATCCACGGCCGT,0,1874818
hyuA_predicted,0.3333333333333333,2,2,GGCAGAGGGTCTAAAGAGCT,0,1874955
hyuA_predicted,0.3333333333333333,2,2,GGCACGTATCTATTTAACTA,0,1844981
hyuA_predicted,0.3333333333333333,2,2,GGCACGGCCACGGGATCGGA,0,1871885
hyuA_predicted,0.3333333333333333,2,2,GGATGTATATATCAACAGGA,0,1847478
hyuA_predicted,0.3333333333333333,2,2,GGATCGGAAACGGCTTTCGT,0,1840462
hyuA_predicted,0.3333333333333333,2,2,GGATCCTACGTGGGCCTAGG,0,1856001
hyuA_predicted,0.3333333333333333,2,2,GGAGTTACCGTAACGCTTGA,0,1846805
hyuA_predicted,0.3333333333333333,2,2,GGAGGCTCCCACGGCCTAGG,0,1869907
hyuA_predicted,0.3333333333333333,2,2,GGAGGCGGACGGCGTGAAGA,0,1855031
hyuA_predicted,0.3333333333333333,2,2,GGACTCTCATTGCCGGTATA,0,1849458
hyuA_predicted,0.3333333333333333,2,2,GGACTCGGGACGATACGCGT,0,1830673
hyuA_predicted,0.3333333333333333,2,2,GGACGTGTTAGTGTATTCAT,0,1863980
hyuA_predicted,0.3333333333333333,2,2,GGACGTATAATACTGTCCAA,0,1834731
hyuA_predicted,0.3333333333333333,2,2,GGACCGGCGGGGTGGTTTAA,0,1843409
hyuA_predicted,0.3333333333333333,2,2,GGACCGCCTAGATAATAATG,0,1847125
hyuA_predicted,0.3333333333333333,2,2,GGACCAGGTCTCCAGGTGTG,0,1841506
hyuA_predicted,0.3333333333333333,2,2,GGACATCTTGGGGGAAGGGC,0,1875329
hyuA_predicted,0.3333333333333333,2,2,GGACAGCTCTTGCAACGAGG,0,1868643
hyuA_predicted,0.3333333333333333,2,2,GGAAATAATAACTGTCTTCT,0,1839351
hyuA_predicted,0.3333333333333333,2,2,GGAAACTGCCCCAGTCTTGC,0,1838847
hyuA_predicted,0.3333333333333333,2,2,GCTTTGTGGTTAAGCCAATG,0,1849729
hyuA_predicted,0.3333333333333333,2,2,GCTTTGACCGACGGACGGGG,0,1876823
hyuA_predicted,0.3333333333333333,2,2,GCTTGCTATGCAGATGTTCC,0,1831460
hyuA_predicted,0.3333333333333333,2,2,GCTTCGAGAACAATTAGTAA,0,1840180
hyuA_predicted,0.3333333333333333,2,2,GCTTACGTCCGGGTTTTTGG,0,1862758
hyuA_predicted,0.3333333333333333,2,2,GCTTACGCAAATATTACCAA,0,1866032
hyuA_predicted,0.3333333333333333,2,2,GCTTACGACGTCCTTTAGTC,0,1852835
hyuA_predicted,0.3333333333333333,2,2,GCTGTTGCCAGTTAGACTAG,0,1856025
hyuA_predicted,0.3333333333333333,2,2,GCTGTGCTATACTAGCATAT,0,1842097
hyuA_predicted,0.3333333333333333,2,2,GCTGGCTTGAATTCGTCAAT,0,1839074
hyuA_predicted,0.3333333333333333,2,2,GCTGCCGGAGCAGGTCGCAG,0,1830520
hyuA_predicted,0.3333333333333333,2,2,GCTCGTTGATATGTTCTGTC,0,1866843
hyuA_predicted,0.3333333333333333,2,2,GCTCGGAAAACGACATAGTT,0,1876832
hyuA_predicted,0.3333333333333333,2,2,GCTCGCACATCCGTCTACGT,0,1845590
hyuA_predicted,0.3333333333333333,2,2,GCTCGACGCAGCAGACCAGT,0,1832073
hyuA_predicted,0.3333333333333333,2,2,GCTCCTAGGGGCGGCTTTGA,0,1873865
hyuA_predicted,0.3333333333333333,2,2,GCTCCAGTGAACACTCTAGG,0,1876735
hyuA_predicted,0.3333333333333333,2,2,GCTCAGTGAGACTTCCACGG,0,1830759
hyuA_predicted,0.3333333333333333,2,2,GCTCACTGCAGTCGCCTTAA,0,1871332
hyuA_predicted,0.3333333333333333,2,2,GCTATTGTTCGTCTCCGTAT,0,1854387
hyuA_predicted,0.3333333333333333,2,2,GCTATCAAGATTACTCCTTT,0,1853772
hyuA_predicted,0.3333333333333333,2,2,GCTATATTCATTTTTATTGA,0,1849921
hyuA_predicted,0.3333333333333333,2,2,GCTATAATGCGCGGATGTTA,0,1865431
hyuA_predicted,0.3333333333333333,2,2,GCTACGCTTTAATTCAGGCC,0,1841533
hyuA_predicted,0.3333333333333333,2,2,GCTAATAATACTAGACCCGT,0,1839345
hyuA_predicted,0.3333333333333333,2,2,GCGTGCCCAGAGAAACAGAG,0,1843209
hyuA_predicted,0.3333333333333333,2,2,GCGTGCCAGTCGCCCCCAGT,0,1874036
hyuA_predicted,0.3333333333333333,2,2,GCGTGCATGAAAGGGCTATT,0,1869994
hyuA_predicted,0.3333333333333333,2,2,GCGTGACTTCGAAGCATGTT,0,1861208
hyuA_predicted,0.3333333333333333,2,2,GCGTCCTTTTATAGTTCATG,0,1867928
hyuA_predicted,0.3333333333333333,2,2,GCGTACATTATCAAATTAAT,0,1830163
hyuA_predicted,0.3333333333333333,2,2,GCGGGGTCGAAACTCGCGCA,0,1862734
hyuA_predicted,0.3333333333333333,2,2,GCGGGGGACCTGTGTCGTCC,0,1850410
hyuA_predicted,0.3333333333333333,2,2,GCGGGGCGGGCCTTATTCCC,0,1857872
hyuA_predicted,0.3333333333333333,2,2,GCGCGGGTGTTCAGTATGAG,0,1831930
hyuA_predicted,0.3333333333333333,2,2,GCGCGGACGTGAAGGCGCAT,0,1852858
hyuA_predicted,0.3333333333333333,2,2,GCGCCTCGTGGGAGTGTGTG,0,1832331
hyuA_predicted,0.3333333333333333,2,2,GCGCATTCGCGTGTTGGAGA,0,1832627
hyuA_predicted,0.3333333333333333,2,2,GCGCATCAAGGTTCACAGTC,0,1859038
hyuA_predicted,0.3333333333333333,2,2,GCGATAGGATTTACTGTACT,0,1870824
hyuA_predicted,0.3333333333333333,2,2,GCGAGGTCGCGAATCCGAGA,0,1849445
hyuA_predicted,0.3333333333333333,2,2,GCGAGGACGACAGCTCGTAG,0,1865645
hyuA_predicted,0.3333333333333333,2,2,GCGAGCTGCGAAAATCACCA,0,1865280
hyuA_predicted,0.3333333333333333,2,2,GCCTTTGGCGGTACGTTGTT,0,1860010
hyuA_predicted,0.3333333333333333,2,2,GCCTTCTATACTCGCTGGTG,0,1853899
hyuA_predicted,0.3333333333333333,2,2,GCCTTAGACGGCTAGCGCAT,0,1869640
hyuA_predicted,0.3333333333333333,2,2,GCCTGGGATGGCCCATAAGA,0,1875882
hyuA_predicted,0.3333333333333333,2,2,GCCTATAGGAAGATTGACAC,0,1872658
hyuA_predicted,0.3333333333333333,2,2,GCCTACCGTTCATATGCCGT,0,1863274
hyuA_predicted,0.3333333333333333,2,2,GCCTACCGAAAATCAAATAA,0,1843855
hyuA_predicted,0.3333333333333333,2,2,GCCGTAACCATTGCCGCCGA,0,1871438
hyuA_predicted,0.3333333333333333,2,2,GCCGGCAATTTCCCCTTCCG,0,1860848
hyuA_predicted,0.3333333333333333,2,2,GCCGGAGTAGGTCTTCAATG,0,1873563
hyuA_predicted,0.3333333333333333,2,2,GCCGGAGATTGCCAAGCCGA,0,1850845
hyuA_predicted,0.3333333333333333,2,2,GCCGGACGATCTCACTGGCA,0,1863579
hyuA_predicted,0.3333333333333333,2,2,GCCGCATTGCCTTACAAATT,0,1872958
hyuA_predicted,0.3333333333333333,2,2,GCCGATACAAAGATTTATGG,0,1841937
hyuA_predicted,0.3333333333333333,2,2,GCCGAAGCACTATAGACCAC,0,1848520
hyuA_predicted,0.3333333333333333,2,2,GCCCTTTCATATGTCGAGGC,0,1857463
hyuA_predicted,0.3333333333333333,2,2,GCCCTAGACAAGCACGATTT,0,1850043
hyuA_predicted,0.3333333333333333,2,2,GCCCGGTTGCTGGGAAGGTT,0,1859042
hyuA_predicted,0.3333333333333333,2,2,GCCCACTTATGTTCTTGTGT,0,1855830
hyuA_predicted,0.3333333333333333,2,2,GCCATTACTAAAATCGTGAT,0,1866802
hyuA_predicted,0.3333333333333333,2,2,GCCACTGTCGGAAAAGTATG,0,1873088
hyuA_predicted,0.3333333333333333,2,2,GCCACATTAAGAACGAAAAG,0,1851242
hyuA_predicted,0.3333333333333333,2,2,GCCAATCTTTTGTGGCAACC,0,1842806
hyuA_predicted,0.3333333333333333,2,2,GCCAAGGGTAGGCTCGCAAC,0,1872685
hyuA_predicted,0.3333333333333333,2,2,GCCAACCCGCCTACGGAAGT,0,1877394
hyuA_predicted,0.3333333333333333,2,2,GCATTCAAAACTCCGATGAG,0,1862756
hyuA_predicted,0.3333333333333333,2,2,GCATGTGTCTAAATAGCAGT,0,1840669
hyuA_predicted,0.3333333333333333,2,2,GCATGCGGGACGTACCAGGT,0,1845710
hyuA_predicted,0.3333333333333333,2,2,GCAGGTGATCGGTGAGGATG,0,1868436
hyuA_predicted,0.3333333333333333,2,2,GCAGCGTGCGGGTCAGGTTC,0,1851010
hyuA_predicted,0.3333333333333333,2,2,GCAGCCGAGACCATAGACGA,0,1872676
hyuA_predicted,0.3333333333333333,2,2,GCAGCACGACTCTGATCACT,0,1860718
hyuA_predicted,0.3333333333333333,2,2,GCAGAGGAGTAAGCAGGAGG,0,1846019
hyuA_predicted,0.3333333333333333,2,2,GCACTTCACTAGCCTCATCC,0,1854062
hyuA_predicted,0.3333333333333333,2,2,GCACGTTGTACCGACGAAAA,0,1867858
hyuA_predicted,0.3333333333333333,2,2,GCACCGGGAGTCAGTATATT,0,1846844
hyuA_predicted,0.3333333333333333,2,2,GCACCAGCTTCAGCGTGCTC,0,1849871
hyuA_predicted,0.3333333333333333,2,2,GCACCAATTCCGATAGATTT,0,1869537
hyuA_predicted,0.3333333333333333,2,2,GCACATTCCCCACGGATAAA,0,1841604
hyuA_predicted,0.3333333333333333,2,2,GCACATGTCTGTATAGCTGA,0,1875978
hyuA_predicted,0.3333333333333333,2,2,GCACAGGAATAACGCTAATT,0,1848706
hyuA_predicted,0.3333333333333333,2,2,GCACAGATCATTAAGGTTCA,0,1875189
hyuA_predicted,0.3333333333333333,2,2,GCACACTGCGATTACAGAAG,0,1866028
hyuA_predicted,0.3333333333333333,2,2,GCAATATACAGGGCGTTCGA,0,1849123
hyuA_predicted,0.3333333333333333,2,2,GCAAAGATGAGTGCCCATGC,0,1857734
hyuA_predicted,0.3333333333333333,2,2,GCAAACACAAGCGGCGCCAT,0,1844382
hyuA_predicted,0.3333333333333333,2,2,GATTTGATTCGGCGTTGCGC,0,1863939
hyuA_predicted,0.3333333333333333,2,2,GATTTCATAGCCCGTGCTAA,0,1829370
hyuA_predicted,0.3333333333333333,2,2,GATTGCCGTGCACTAAAATG,0,1874740
hyuA_predicted,0.3333333333333333,2,2,GATTCAGATGGGGAGTCCTC,0,1864550
hyuA_predicted,0.3333333333333333,2,2,GATGGTAGCGTCATACAGTC,0,1861306
hyuA_predicted,0.3333333333333333,2,2,GATGGCACGAAACGTATTGT,0,1836048
hyuA_predicted,0.3333333333333333,2,2,GATGCCTACTGACCCCTGAA,0,1829372
hyuA_predicted,0.3333333333333333,2,2,GATGATCCGTGCGGTTCCTG,0,1869316
hyuA_predicted,0.3333333333333333,2,2,GATGAGGGCCGGCAATTTAG,0,1843995
hyuA_predicted,0.3333333333333333,2,2,GATCTCGGTACGAGCGAAAC,0,1867067
hyuA_predicted,0.3333333333333333,2,2,GATCATTGGCCTGGGTAAAT,0,1832702
hyuA_predicted,0.3333333333333333,2,2,GATCATCAAGGGGCGGAAAG,0,1859696
hyuA_predicted,0.3333333333333333,2,2,GATCAGATACGGCCGAAATC,0,1873024
hyuA_predicted,0.3333333333333333,2,2,GATCAAGTACATCACTAACT,0,1857240
hyuA_predicted,0.3333333333333333,2,2,GATATCGATGTGTAAGGGGT,0,1865853
hyuA_predicted,0.3333333333333333,2,2,GATATCACTGGGTTATTTAA,0,1866250
hyuA_predicted,0.3333333333333333,2,2,GATATAGTTCCCTAACGTGT,0,1846498
hyuA_predicted,0.3333333333333333,2,2,GATAGGCTAAGTACAGGTCA,0,1844202
hyuA_predicted,0.3333333333333333,2,2,GATAGCTTTAATTGCTCCTG,0,1840171
hyuA_predicted,0.3333333333333333,2,2,GATAGAACGCCTGGTCAGCT,0,1836115
hyuA_predicted,0.3333333333333333,2,2,GATACGGTAAATTCTTTTGC,0,1842015
hyuA_predicted,0.3333333333333333,2,2,GAGTTGCGTCAAAAATGGTG,0,1852659
hyuA_predicted,0.3333333333333333,2,2,GAGTGATCGTTCACTTATAG,0,1855971
hyuA_predicted,0.3333333333333333,2,2,GAGTCGGCTGTCGGGTAGCG,0,1836220
hyuA_predicted,0.3333333333333333,2,2,GAGTACACATAAAAGCGAGC,0,1868457
hyuA_predicted,0.3333333333333333,2,2,GAGGTGGTCACAGCAAAGAC,0,1866249
hyuA_predicted,0.3333333333333333,2,2,GAGGTGGGATGGGTGATACT,0,1828853
hyuA_predicted,0.3333333333333333,2,2,GAGGGCCTCCGCAAGGAAGC,0,1843695
hyuA_predicted,0.3333333333333333,2,2,GAGGGAAGCGGTGAACTTGC,0,1842928
hyuA_predicted,0.3333333333333333,2,2,GAGGCGGAGAGTACACTACG,0,1847583
hyuA_predicted,0.3333333333333333,2,2,GAGGCCCAGGTCAGGCTGAC,0,1833174
hyuA_predicted,0.3333333333333333,2,2,GAGGAGCGTATAACCGGGAT,0,1857758
hyuA_predicted,0.3333333333333333,2,2,GAGCCGTCGTCAACATTCGA,0,1863571
hyuA_predicted,0.3333333333333333,2,2,GAGCATCTGGTTAGGGGTCC,0,1861610
hyuA_predicted,0.3333333333333333,2,2,GAGCATACGTGAAGGTTATT,0,1856730
hyuA_predicted,0.3333333333333333,2,2,GAGATCCCTAGAACTATTCC,0,1871244
hyuA_predicted,0.3333333333333333,2,2,GAGAGTTACCTGCTACTTAG,0,1867145
hyuA_predicted,0.3333333333333333,2,2,GAGAGAGTGCCTAGTTTACC,0,1856180
hyuA_predicted,0.3333333333333333,2,2,GAGACGGCTAGTCCCATAGT,0,1861729
hyuA_predicted,0.3333333333333333,2,2,GAGACGCGTAGACACGGGTC,0,1876254
hyuA_predicted,0.3333333333333333,2,2,GAGACACCTTGGTCGGAGTC,0,1838487
hyuA_predicted,0.3333333333333333,2,2,GAGACACCATGGTTAATTTT,0,1833103
hyuA_predicted,0.3333333333333333,2,2,GACTTCGCACCCCATGGTGT,0,1874255
hyuA_predicted,0.3333333333333333,2,2,GACTTACGATCGTGCCTTAC,0,1858093
hyuA_predicted,0.3333333333333333,2,2,GACTGCATGGGTCCCGGCAA,0,1831839
hyuA_predicted,0.3333333333333333,2,2,GACTATACTTGATAACGTCC,0,1847766
hyuA_predicted,0.3333333333333333,2,2,GACTACCCAGATCAGACCGA,0,1851600
hyuA_predicted,0.3333333333333333,2,2,GACGTTTTGGCGATCTGCAT,0,1846364
hyuA_predicted,0.3333333333333333,2,2,GACGTCCTAGTCATGCACTT,0,1849175
hyuA_predicted,0.3333333333333333,2,2,GACGGTGTAGTGCTCCCATT,0,1838082
hyuA_predicted,0.3333333333333333,2,2,GACGGGGACCCAAACATCAC,0,1869013
hyuA_predicted,0.3333333333333333,2,2,GACGGCTCGGGTCTAAGTTC,0,1861824
hyuA_predicted,0.3333333333333333,2,2,GACGGCCACCATGGGACTTC,0,1841617
hyuA_predicted,0.3333333333333333,2,2,GACGGCAGCGTATTATCTTG,0,1836720
hyuA_predicted,0.3333333333333333,2,2,GACGCGCAGATCGTTAGGCT,0,1863727
hyuA_predicted,0.3333333333333333,2,2,GACGCCGTATATGCTTTTGG,0,1835526
hyuA_predicted,0.3333333333333333,2,2,GACCTCACTCTGCTTTATAC,0,1855512
hyuA_predicted,0.3333333333333333,2,2,GACCGTGTAGTGACGCATCG,0,1842100
hyuA_predicted,0.3333333333333333,2,2,GACCGCGGCCGCGCGTGGCA,0,1864474
hyuA_predicted,0.3333333333333333,2,2,GACCCCTGTTAATAATTCTT,0,1862984
hyuA_predicted,0.3333333333333333,2,2,GACCAGGTCGAGCCCCAGGA,0,1842181
hyuA_predicted,0.3333333333333333,2,2,GACATGGATAGGTGATGTTC,0,1853845
hyuA_predicted,0.3333333333333333,2,2,GACAGTGCTTGCCAGCAACG,0,1877779
hyuA_predicted,0.3333333333333333,2,2,GACACATTTAAAGTGGCAGC,0,1865415
hyuA_predicted,0.3333333333333333,2,2,GACAACGGATAACTGATCAG,0,1844228
hyuA_predicted,0.3333333333333333,2,2,GAATTGTACGGGTCGGGATC,0,1867224
hyuA_predicted,0.3333333333333333,2,2,GAATCCTGAACTGCGGCAAC,0,1867623
hyuA_predicted,0.3333333333333333,2,2,GAATCACCCCACGAAATTTG,0,1865946
hyuA_predicted,0.3333333333333333,2,2,GAATAGCATCGTGACGAGCT,0,1839623
hyuA_predicted,0.3333333333333333,2,2,GAATACAAATGTGCTGGAGC,0,1860905
hyuA_predicted,0.3333333333333333,2,2,GAAGGTATTCTATCGTATCA,0,1875797
hyuA_predicted,0.3333333333333333,2,2,GAAGCTCCAGAATGTTTACA,0,1839167
hyuA_predicted,0.3333333333333333,2,2,GAAGCGTGACGTTCCATAAC,0,1862535
hyuA_predicted,0.3333333333333333,2,2,GAAGCGTACCGTCGGACCCG,0,1868377
hyuA_predicted,0.3333333333333333,2,2,GAAGCGCCCTATGAACTGCT,0,1861869
hyuA_predicted,0.3333333333333333,2,2,GAACTGTTGGACACCCCAGA,0,1863093
hyuA_predicted,0.3333333333333333,2,2,GAACTCCCCGCGGAGTACGA,0,1876624
hyuA_predicted,0.3333333333333333,2,2,GAACTCCAGGGCCTAAAAGT,0,1847433
hyuA_predicted,0.3333333333333333,2,2,GAACGTTTTCCAATGTCAAA,0,1856782
hyuA_predicted,0.3333333333333333,2,2,GAACGTCCTCACTCTATTAT,0,1853450
hyuA_predicted,0.3333333333333333,2,2,GAACCTCGAACAGCTAATGC,0,1862323
hyuA_predicted,0.3333333333333333,2,2,GAACCAATTGGCGGCATTTT,0,1857874
hyuA_predicted,0.3333333333333333,2,2,GAAAGCTGATTAAATGGCGT,0,1837948
hyuA_predicted,0.3333333333333333,2,2,GAAACTTTGGCGGCCACAAC,0,1877031
hyuA_predicted,0.3333333333333333,2,2,GAAACTGAATAGATTCACTG,0,1850922
hyuA_predicted,0.3333333333333333,2,2,GAAACGTAGTATGTCAGTTC,0,1856722
hyuA_predicted,0.3333333333333333,2,2,GAAAAACCTTTATAAGGATT,0,1867387
hyuA_predicted,0.3333333333333333,2,2,CTTTTTTTGTCCGTCGAGCG,0,1873976
hyuA_predicted,0.3333333333333333,2,2,CTTTCACAGAGATAGTGTTA,0,1871978
hyuA_predicted,0.3333333333333333,2,2,CTTGTTGCAAGCAGCTCTTT,0,1835552
hyuA_predicted,0.3333333333333333,2,2,CTTGTGGGTGACAGCTCGTA,0,1866476
hyuA_predicted,0.3333333333333333,2,2,CTTGTCTACAAATGATTGTA,0,1877322
hyuA_predicted,0.3333333333333333,2,2,CTTGGGACGTTCGATTACAT,0,1859481
hyuA_predicted,0.3333333333333333,2,2,CTTGCCTTGGGACCTAGGCG,0,1873748
hyuA_predicted,0.3333333333333333,2,2,CTTGCCCCGGACGCCATCAA,0,1858994
hyuA_predicted,0.3333333333333333,2,2,CTTGCAGAGCTTGGTAGGGA,0,1843204
hyuA_predicted,0.3333333333333333,2,2,CTTGAGCACCATGTGTTTGT,0,1830131
hyuA_predicted,0.3333333333333333,2,2,CTTCTTATCAGTTATGCGCA,0,1844809
hyuA_predicted,0.3333333333333333,2,2,CTTCTGGCACAGATCACTTA,0,1866666
hyuA_predicted,0.3333333333333333,2,2,CTTCTGCAAGCTCCAATGGG,0,1846628
hyuA_predicted,0.3333333333333333,2,2,CTTCTATTATCACTCCGCAT,0,1855814
hyuA_predicted,0.3333333333333333,2,2,CTTCGCCTACATTGGACCTG,0,1858006
hyuA_predicted,0.3333333333333333,2,2,CTTCAGTCTATGAACCGGTA,0,1871465
hyuA_predicted,0.3333333333333333,2,2,CTTCAAGTCTGCTCTTCTTG,0,1851522
hyuA_predicted,0.3333333333333333,2,2,CTTAGACTAGGTCAAGCTTC,0,1870804
hyuA_predicted,0.3333333333333333,2,2,CTTAATGTATAGCAGATATC,0,1877585
hyuA_predicted,0.3333333333333333,2,2,CTTAACTCATAGGTGGAAAA,0,1859587
hyuA_predicted,0.3333333333333333,2,2,CTTAAAATGTCATAAGGGGT,0,1876134
hyuA_predicted,0.3333333333333333,2,2,CTGTTGTGCATCGTGCCCAT,0,1835042
hyuA_predicted,0.3333333333333333,2,2,CTGTGCTCAGCGCACAGCGC,0,1836804
hyuA_predicted,0.3333333333333333,2,2,CTGTCCCTTGATCATGGCGG,0,1864614
hyuA_predicted,0.3333333333333333,2,2,CTGGTTTCTTCCGTGACTTG,0,1832617
hyuA_predicted,0.3333333333333333,2,2,CTGGTTAGTTAATCTCCCAG,0,1848476
hyuA_predicted,0.3333333333333333,2,2,CTGGTGTCCCCGTCCCGGGA,0,1867325
hyuA_predicted,0.3333333333333333,2,2,CTGGTATAACCTCGATTTTG,0,1877872
hyuA_predicted,0.3333333333333333,2,2,CTGGGTTTTTCCGGCCCGTC,0,1847509
hyuA_predicted,0.3333333333333333,2,2,CTGGCGGGAACCTTGGTCGG,0,1870765
hyuA_predicted,0.3333333333333333,2,2,CTGGATGCTTCATATCTGCA,0,1839828
hyuA_predicted,0.3333333333333333,2,2,CTGGATAAGCAATAGACCGT,0,1854001
hyuA_predicted,0.3333333333333333,2,2,CTGGAGTGAAACCCGCAGGA,0,1873585
hyuA_predicted,0.3333333333333333,2,2,CTGCGTGATGTGCCAGCTGC,0,1865781
hyuA_predicted,0.3333333333333333,2,2,CTGCCTGGCAAGCGGGCCCA,0,1854827
hyuA_predicted,0.3333333333333333,2,2,CTGCCCAGTATTGTAATCAG,0,1853536
hyuA_predicted,0.3333333333333333,2,2,CTGCATTCGTGTTCAAGATC,0,1871809
hyuA_predicted,0.3333333333333333,2,2,CTGCAGCAATTAACGCTGAC,0,1833179
hyuA_predicted,0.3333333333333333,2,2,CTGCACTGAGCCCGTATACA,0,1863680
hyuA_predicted,0.3333333333333333,2,2,CTGCAAATTCCGGAGTGGAC,0,1877075
hyuA_predicted,0.3333333333333333,2,2,CTGATTGTAAAACCAGTTAT,0,1840096
hyuA_predicted,0.3333333333333333,2,2,CTGATGCGACAAATTTTACG,0,1864800
hyuA_predicted,0.3333333333333333,2,2,CTGAGAAATGTTCTGTCTTT,0,1855951
hyuA_predicted,0.3333333333333333,2,2,CTCTGGTCAGCATGATGCGT,0,1829708
hyuA_predicted,0.3333333333333333,2,2,CTCTCAGGGTTCACAGACAA,0,1858699
hyuA_predicted,0.3333333333333333,2,2,CTCTACTTATCGTCAGTGGC,0,1873795
hyuA_predicted,0.3333333333333333,2,2,CTCTAAAACATCGACTGTCC,0,1834707
hyuA_predicted,0.3333333333333333,2,2,CTCGTAAAATCCGGTACCAT,0,1857368
hyuA_predicted,0.3333333333333333,2,2,CTCGGCACACCGCTACAACT,0,1829527
hyuA_predicted,0.3333333333333333,2,2,CTCGCCGACGATAGGGTCGT,0,1831349
hyuA_predicted,0.3333333333333333,2,2,CTCGACTCGGTAAGATATGC,0,1846596
hyuA_predicted,0.3333333333333333,2,2,CTCCGTGTTGATGGTTATGG,0,1859133
hyuA_predicted,0.3333333333333333,2,2,CTCCGGACTGTTGCCCACCA,0,1834537
hyuA_predicted,0.3333333333333333,2,2,CTCCCGTGCCATTGAGATAA,0,1842755
hyuA_predicted,0.3333333333333333,2,2,CTCCCGGGCACTGTTAGGGC,0,1870825
hyuA_predicted,0.3333333333333333,2,2,CTCCCCTTCACCAGAATATA,0,1863892
hyuA_predicted,0.3333333333333333,2,2,CTCCCCGAATTCGGGACGTC,0,1854172
hyuA_predicted,0.3333333333333333,2,2,CTCCAGGGACCTTATCCCGA,0,1834064
hyuA_predicted,0.3333333333333333,2,2,CTCCAGAGGGGCTTACGCGG,0,1847515
hyuA_predicted,0.3333333333333333,2,2,CTCAGATGAAAGAGTACCAC,0,1840742
hyuA_predicted,0.3333333333333333,2,2,CTCACTTTGGATCCCTCTAT,0,1867713
hyuA_predicted,0.3333333333333333,2,2,CTCAAAGACGACTTGATGAG,0,1837349
hyuA_predicted,0.3333333333333333,2,2,CTATTTGAATAAGCAGCTAT,0,1847706
hyuA_predicted,0.3333333333333333,2,2,CTATTCTAGAGATTAACTGG,0,1839192
hyuA_predicted,0.3333333333333333,2,2,CTATGGTTTTAGATGTGTTT,0,1837980
hyuA_predicted,0.3333333333333333,2,2,CTATCGCAGTTGGCACACAA,0,1831465
hyuA_predicted,0.3333333333333333,2,2,CTATATTCAGCCCCGCGTGA,0,1853851
hyuA_predicted,0.3333333333333333,2,2,CTAGTGGCAGTAATAAGGGA,0,1848295
hyuA_predicted,0.3333333333333333,2,2,CTAGTCTTGGTAATATCCGG,0,1868949
hyuA_predicted,0.3333333333333333,2,2,CTAGGTCAAGGACATTTAGA,0,1863821
hyuA_predicted,0.3333333333333333,2,2,CTAGGCCCACTGCCAGCTTT,0,1843792
hyuA_predicted,0.3333333333333333,2,2,CTAGGCACGATCCCCTTCTT,0,1875177
hyuA_predicted,0.3333333333333333,2,2,CTAGCCGCATTTCAGTACAC,0,1837513
hyuA_predicted,0.3333333333333333,2,2,CTACTCCGCGGGTACTCGGG,0,1832753
hyuA_predicted,0.3333333333333333,2,2,CTACTATGTGTCGTTTCTCA,0,1854413
hyuA_predicted,0.3333333333333333,2,2,CTACCGTATTGCTGATCTGT,0,1852401
hyuA_predicted,0.3333333333333333,2,2,CTACCGCCCTAGTTGGTCTA,0,1854060
hyuA_predicted,0.3333333333333333,2,2,CTACCACATCGGACGTCACC,0,1836126
hyuA_predicted,0.3333333333333333,2,2,CTAAGTAAGTCGGCTGCCTC,0,1833018
hyuA_predicted,0.3333333333333333,2,2,CTAAGGCGGTTGAGGTGTCA,0,1866597
hyuA_predicted,0.3333333333333333,2,2,CTAACCCTGTCAAGGGCGAT,0,1859877
hyuA_predicted,0.3333333333333333,2,2,CGTTTTTATGTTCTCATTGC,0,1837792
hyuA_predicted,0.3333333333333333,2,2,CGTTTCTCTGAAAGGATTTC,0,1841831
hyuA_predicted,0.3333333333333333,2,2,CGTTGATTAGGTACATCCGC,0,1849045
hyuA_predicted,0.3333333333333333,2,2,CGTGGTCCTAACATTTATAA,0,1840790
hyuA_predicted,0.3333333333333333,2,2,CGTGGTAAGTACCCCCGGTA,0,1838238
hyuA_predicted,0.3333333333333333,2,2,CGTGAGCACAGAGATCTATT,0,1860163
hyuA_predicted,0.3333333333333333,2,2,CGTCTCTCAATCGCGTCAGA,0,1873680
hyuA_predicted,0.3333333333333333,2,2,CGTCTCTAAACTAAGGCGTT,0,1856350
hyuA_predicted,0.3333333333333333,2,2,CGTCTCAGTGCCGTGATGCT,0,1853595
hyuA_predicted,0.3333333333333333,2,2,CGTCGGCGGAAGAGTGAAAG,0,1875533
hyuA_predicted,0.3333333333333333,2,2,CGTATACATCTCTTAGTAAT,0,1828851
hyuA_predicted,0.3333333333333333,2,2,CGTAGAATTCGGACGTTACA,0,1860931
hyuA_predicted,0.3333333333333333,2,2,CGTAAATGAGGCATCACGGC,0,1861246
hyuA_predicted,0.3333333333333333,2,2,CGGTTTAATCATGAATGAGG,0,1860099
hyuA_predicted,0.3333333333333333,2,2,CGGTTATCGGACATCATCGG,0,1855040
hyuA_predicted,0.3333333333333333,2,2,CGGTGGTAATATCCTGCTAT,0,1874396
hyuA_predicted,0.3333333333333333,2,2,CGGTCTTAGGAGTTCGTCCC,0,1844531
hyuA_predicted,0.3333333333333333,2,2,CGGTCGAGTGAGGGAATCAG,0,1838444
hyuA_predicted,0.3333333333333333,2,2,CGGGTTAGACAAAGATGGTG,0,1869062
hyuA_predicted,0.3333333333333333,2,2,CGGGGGCCAGACCGGCGCGA,0,1869915
hyuA_predicted,0.3333333333333333,2,2,CGGGCACGATGATGGATCGA,0,1850414
hyuA_predicted,0.3333333333333333,2,2,CGGGATTCTTTTAGACTCGC,0,1832382
hyuA_predicted,0.3333333333333333,2,2,CGGGATAGCTGATGTGTTTT,0,1849033
hyuA_predicted,0.3333333333333333,2,2,CGGGAATCTTCGAATGGTCT,0,1873734
hyuA_predicted,0.3333333333333333,2,2,CGGGAAGTAGAGCGAGGCGT,0,1876767
hyuA_predicted,0.3333333333333333,2,2,CGGCGGAAGTGTGACTTAAG,0,1870865
hyuA_predicted,0.3333333333333333,2,2,CGGCCGGACTAACGGAAAGG,0,1848540
hyuA_predicted,0.3333333333333333,2,2,CGGCCACACTGGTGGGTGGG,0,1858815
hyuA_predicted,0.3333333333333333,2,2,CGGCCAAAATAGTCTTTTTT,0,1841040
hyuA_predicted,0.3333333333333333,2,2,CGGCAGTAGTTAGTGATAAA,0,1863115
hyuA_predicted,0.3333333333333333,2,2,CGGCACGTTAACGAACGGTT,0,1868745
hyuA_predicted,0.3333333333333333,2,2,CGGCACGTGACCGGGATGAA,0,1852333
hyuA_predicted,0.3333333333333333,2,2,CGGATGCGGATTTGATATGG,0,1831459
hyuA_predicted,0.3333333333333333,2,2,CGGATAACGTCTCTCCGTAC,0,1850901
hyuA_predicted,0.3333333333333333,2,2,CGGACACAGGCACAAGGGCG,0,1856420
hyuA_predicted,0.3333333333333333,2,2,CGGAAGGGATTGCAGCAGGC,0,1861215
hyuA_predicted,0.3333333333333333,2,2,CGGAACTCACGTCAATAGTT,0,1875349
hyuA_predicted,0.3333333333333333,2,2,CGGAACAGGGACCCTCAGAG,0,1857377
hyuA_predicted,0.3333333333333333,2,2,CGCTTGAAAGATGTAAGGTG,0,1857686
hyuA_predicted,0.3333333333333333,2,2,CGCTTAGTTAGCCTGCCTCA,0,1858979
hyuA_predicted,0.3333333333333333,2,2,CGCTTAGATATTTTCCCTAG,0,1855627
hyuA_predicted,0.3333333333333333,2,2,CGCTGGTTGGGTGGGGGTTA,0,1838443
hyuA_predicted,0.3333333333333333,2,2,CGCGTGGCCAGATGATTAGA,0,1876944
hyuA_predicted,0.3333333333333333,2,2,CGCGGACCATGTACTATTTT,0,1846400
hyuA_predicted,0.3333333333333333,2,2,CGCCTGCCCTCCTACTAGTC,0,1852918
hyuA_predicted,0.3333333333333333,2,2,CGCCTGAAACGCAAGCGGTT,0,1852713
hyuA_predicted,0.3333333333333333,2,2,CGCCTCTGCGCTCAGCCAGC,0,1829277
hyuA_predicted,0.3333333333333333,2,2,CGCCGGTAAGGTCCCTGGCT,0,1864332
hyuA_predicted,0.3333333333333333,2,2,CGCCCGCTGGACGTGCATAT,0,1838895
hyuA_predicted,0.3333333333333333,2,2,CGCCCCCACGGGAAATTTTC,0,1834626
hyuA_predicted,0.3333333333333333,2,2,CGCATTGGCAACTCCGGGCT,0,1839043
hyuA_predicted,0.3333333333333333,2,2,CGCATACGGCAGCGGATTGT,0,1852331
hyuA_predicted,0.3333333333333333,2,2,CGCAGCTAGCCCGGGCCATT,0,1842212
hyuA_predicted,0.3333333333333333,2,2,CGCAGAGCTTGAACTGGTGG,0,1865200
hyuA_predicted,0.3333333333333333,2,2,CGATTTCACAATTGGCTGAA,0,1871780
hyuA_predicted,0.3333333333333333,2,2,CGATTATGGTCTGCCCATGC,0,1839012
hyuA_predicted,0.3333333333333333,2,2,CGATTATACAGCTGTCTTAG,0,1857625
hyuA_predicted,0.3333333333333333,2,2,CGATTACGTTATCATGCGCT,0,1840412
hyuA_predicted,0.3333333333333333,2,2,CGATGGGGAGGGAGAGCGAC,0,1855382
hyuA_predicted,0.3333333333333333,2,2,CGATGCATCGACCGGCTTCG,0,1856950
hyuA_predicted,0.3333333333333333,2,2,CGATCGAAAGCCATTCAATA,0,1877062
hyuA_predicted,0.3333333333333333,2,2,CGATCCCCAACACTATTATA,0,1848105
hyuA_predicted,0.3333333333333333,2,2,CGATCATACGGATATGGTAT,0,1861167
hyuA_predicted,0.3333333333333333,2,2,CGAGTCAGAACGCATCTCTA,0,1850542
hyuA_predicted,0.3333333333333333,2,2,CGAGCAGTCTCTCGGAGTAC,0,1846930
hyuA_predicted,0.3333333333333333,2,2,CGAGACTACGGAGCTTATTC,0,1867071
hyuA_predicted,0.3333333333333333,2,2,CGACTACGCCGTTCCTATCA,0,1873608
hyuA_predicted,0.3333333333333333,2,2,CGACCGTGCATAAATTCCCC,0,1846242
hyuA_predicted,0.3333333333333333,2,2,CGACCCCCTCAGACTCTGAG,0,1868654
hyuA_predicted,0.3333333333333333,2,2,CGACCATGGCAGATCAATGA,0,1854194
hyuA_predicted,0.3333333333333333,2,2,CGACAGCAGAGAGGTGTATT,0,1865737
hyuA_predicted,0.3333333333333333,2,2,CGAATGCATGAACCACCCTG,0,1855670
hyuA_predicted,0.3333333333333333,2,2,CGAAGCGTTGCGTGATATAT,0,1855411
hyuA_predicted,0.3333333333333333,2,2,CGAACGGACCTAGAGCCCAT,0,1874263
hyuA_predicted,0.3333333333333333,2,2,CGAACGCGGCGGTCTGAGAC,0,1839245
hyuA_predicted,0.3333333333333333,2,2,CGAACATTGTTTGAGTTGTA,0,1842864
hyuA_predicted,0.3333333333333333,2,2,CGAACACAAAACCGTGGAAA,0,1839061
hyuA_predicted,0.3333333333333333,2,2,CGAAAGACGAGGTAGCACTC,0,1861688
hyuA_predicted,0.3333333333333333,2,2,CGAAACCTAATCGATGGTAA,0,1869271
hyuA_predicted,0.3333333333333333,2,2,CGAAAAGAAGGTGCCGGCGG,0,1841585
hyuA_predicted,0.3333333333333333,2,2,CGAAAAATCCTTTACGGTGT,0,1859578
hyuA_predicted,0.3333333333333333,2,2,CCTTGCGCTTAAGAGCGCGC,0,1858305
hyuA_predicted,0.3333333333333333,2,2,CCTTGAGGATGATTTCAGAA,0,1843281
hyuA_predicted,0.3333333333333333,2,2,CCTGTTAAGCTAAAACACTA,0,1834780
hyuA_predicted,0.3333333333333333,2,2,CCTGTCATTGTGTTTGATGT,0,1849677
hyuA_predicted,0.3333333333333333,2,2,CCTGGTAACTTTACTTCCTC,0,1861133
hyuA_predicted,0.3333333333333333,2,2,CCTGAGAGCACAGAGTGTTT,0,1835603
hyuA_predicted,0.3333333333333333,2,2,CCTGACCGGCCGGCTTTGCG,0,1845571
hyuA_predicted,0.3333333333333333,2,2,CCTCTTTTCACCTACGGGTA,0,1842218
hyuA_predicted,0.3333333333333333,2,2,CCTCTTACAACACACCCTGT,0,1868201
hyuA_predicted,0.3333333333333333,2,2,CCTCTAGTGAGCATTCGCAG,0,1865307
hyuA_predicted,0.3333333333333333,2,2,CCTCGTGACTATTATGGCAG,0,1864036
hyuA_predicted,0.3333333333333333,2,2,CCTCGCAGAGGAAGCAGACC,0,1833236
hyuA_predicted,0.3333333333333333,2,2,CCTCCCTTTCAATTCGATAC,0,1848307
hyuA_predicted,0.3333333333333333,2,2,CCTCCCCAACAAGTAGTGTC,0,1841611
hyuA_predicted,0.3333333333333333,2,2,CCTCATGTGCTCGTGTTATG,0,1840701
hyuA_predicted,0.3333333333333333,2,2,CCTCATCTGTAATGCAGCTC,0,1854752
hyuA_predicted,0.3333333333333333,2,2,CCTCAGGTAACCTCTTCCGT,0,1835849
hyuA_predicted,0.3333333333333333,2,2,CCTCAACTAGCTCAGCGGCC,0,1849872
hyuA_predicted,0.3333333333333333,2,2,CCTATCGAGGCGAGAGGTAC,0,1860917
hyuA_predicted,0.3333333333333333,2,2,CCTAGGTAAAAAGCCTAAGT,0,1834319
hyuA_predicted,0.3333333333333333,2,2,CCTAGAGCGACGAGTAGAGT,0,1866863
hyuA_predicted,0.3333333333333333,2,2,CCTACTAAAGCGTCTCCAAG,0,1833015
hyuA_predicted,0.3333333333333333,2,2,CCTACCGGATCATTCACTCG,0,1851092
hyuA_predicted,0.3333333333333333,2,2,CCTACAGGGCTTCTCCCCGT,0,1861033
hyuA_predicted,0.3333333333333333,2,2,CCGTTCCCCGGGACTGCATA,0,1850684
hyuA_predicted,0.3333333333333333,2,2,CCGTGGTTTGGCTAAACACA,0,1836277
hyuA_predicted,0.3333333333333333,2,2,CCGTCCGGTCGTAACCTACA,0,1857418
hyuA_predicted,0.3333333333333333,2,2,CCGTCAGAATCCCCATCTAT,0,1858199
hyuA_predicted,0.3333333333333333,2,2,CCGTAGAAACGCTGGTCCCT,0,1854322
hyuA_predicted,0.3333333333333333,2,2,CCGGGAGCCCTTGATTAGTT,0,1866633
hyuA_predicted,0.3333333333333333,2,2,CCGGGACGCGCTACTTCCAC,0,1865509
hyuA_predicted,0.3333333333333333,2,2,CCGGCTTCCTCGCTGGTGTA,0,1838649
hyuA_predicted,0.3333333333333333,2,2,CCGGCTCACAAATCAGGACT,0,1876820
hyuA_predicted,0.3333333333333333,2,2,CCGGACAATCAAACGGCTCA,0,1874107
hyuA_predicted,0.3333333333333333,2,2,CCGCCGATCGAGGGTTTAAT,0,1873136
hyuA_predicted,0.3333333333333333,2,2,CCGATGTTTTGTGGGCTTTA,0,1854848
hyuA_predicted,0.3333333333333333,2,2,CCGATGCTCGCGAACGGAAG,0,1870682
hyuA_predicted,0.3333333333333333,2,2,CCGAGTAAGCCCCGATGACA,0,1839262
hyuA_predicted,0.3333333333333333,2,2,CCGAGGCCTCGTCGTGAAAG,0,1835290
hyuA_predicted,0.3333333333333333,2,2,CCGAGACGGTATCAATTAGT,0,1850144
hyuA_predicted,0.3333333333333333,2,2,CCGACTCAGCTAATGTCACA,0,1833222
hyuA_predicted,0.3333333333333333,2,2,CCGACCTGAACCAGGAAATC,0,1839117
hyuA_predicted,0.3333333333333333,2,2,CCGAAAATCCCACAGCGTCC,0,1870439
hyuA_predicted,0.3333333333333333,2,2,CCCTGTGATCCTTCTCTGAT,0,1838948
hyuA_predicted,0.3333333333333333,2,2,CCCTGGCTACACTGTGGGCG,0,1859614
hyuA_predicted,0.3333333333333333,2,2,CCCTGCACTGTGAGGTCGCC,0,1862888
hyuA_predicted,0.3333333333333333,2,2,CCCTCGAACGCGTCCAGGTC,0,1849111
hyuA_predicted,0.3333333333333333,2,2,CCCTACGAGTGTACTGCAAA,0,1859645
hyuA_predicted,0.3333333333333333,2,2,CCCGTTACCAACTAACGTAC,0,1833006
hyuA_predicted,0.3333333333333333,2,2,CCCGTACATTATTTTGTAGT,0,1841809
hyuA_predicted,0.3333333333333333,2,2,CCCGGGGAAGCTCGGCCGAG,0,1840318
hyuA_predicted,0.3333333333333333,2,2,CCCGGCCTCAGAATTGTAAA,0,1869832
hyuA_predicted,0.3333333333333333,2,2,CCCGGCCGGGGTTGTGCCGC,0,1871835
hyuA_predicted,0.3333333333333333,2,2,CCCGGAGATGTATCTCTGGT,0,1849837
hyuA_predicted,0.3333333333333333,2,2,CCCGCCTAAGGAGCCAACCC,0,1867846
hyuA_predicted,0.3333333333333333,2,2,CCCGCCAGGATATACCACTG,0,1833607
hyuA_predicted,0.3333333333333333,2,2,CCCCTTCTTAGGGTTTTCAG,0,1859762
hyuA_predicted,0.3333333333333333,2,2,CCCCTACGAATGCGGCGTTT,0,1829457
hyuA_predicted,0.3333333333333333,2,2,CCCCGTTTCACCGACGGTGG,0,1861153
hyuA_predicted,0.3333333333333333,2,2,CCCCGGCTGATGGTTCGCTA,0,1876074
hyuA_predicted,0.3333333333333333,2,2,CCCCAGATACAGCGATATCA,0,1864912
hyuA_predicted,0.3333333333333333,2,2,CCCCAAACTCTACGTCCTAG,0,1859890
hyuA_predicted,0.3333333333333333,2,2,CCCATCCTTCTTGGATGGCT,0,1842685
hyuA_predicted,0.3333333333333333,2,2,CCCAGCGAAAGTGGCCTCTC,0,1870175
hyuA_predicted,0.3333333333333333,2,2,CCCACTTGACCATGCGAGTT,0,1839032
hyuA_predicted,0.3333333333333333,2,2,CCCAAGTTTTGAGTAATTTG,0,1851534
hyuA_predicted,0.3333333333333333,2,2,CCCAAGAAATTAGACACCGG,0,1844764
hyuA_predicted,0.3333333333333333,2,2,CCCAAATTTGCAAGGAATTG,0,1857664
hyuA_predicted,0.3333333333333333,2,2,CCCAAAGTCTTTCAAGATTG,0,1871775
hyuA_predicted,0.3333333333333333,2,2,CCATTCGGATATGGCGGATC,0,1856801
hyuA_predicted,0.3333333333333333,2,2,CCATGGTTAGCTGCGTACCA,0,1865957
hyuA_predicted,0.3333333333333333,2,2,CCATCGAACGCACTTGGCCA,0,1831986
hyuA_predicted,0.3333333333333333,2,2,CCAGTTTTGTAGCATACGCT,0,1833557
hyuA_predicted,0.3333333333333333,2,2,CCAGGCACTGTCATGAAAAA,0,1841181
hyuA_predicted,0.3333333333333333,2,2,CCAGCGGAGGCCGGCGTTTC,0,1837760
hyuA_predicted,0.3333333333333333,2,2,CCAGCACGAGGTGTCATGCG,0,1867582
hyuA_predicted,0.3333333333333333,2,2,CCACTGGGGAGGGTCGATGT,0,1840941
hyuA_predicted,0.3333333333333333,2,2,CCACTCAAGTCCCGAGAATA,0,1862099
hyuA_predicted,0.3333333333333333,2,2,CCACGGACGATCGTCCCTAC,0,1861959
hyuA_predicted,0.3333333333333333,2,2,CCACCGCGCACTTAGCGGCC,0,1853011
hyuA_predicted,0.3333333333333333,2,2,CCACATTGGATATTCATGGC,0,1869397
hyuA_predicted,0.3333333333333333,2,2,CCACAGTAATCTACTAGAAC,0,1870002
hyuA_predicted,0.3333333333333333,2,2,CCAATTTAACCAGACAGAAT,0,1848080
hyuA_predicted,0.3333333333333333,2,2,CCAATAGGCTCATAGGATCG,0,1844303
hyuA_predicted,0.3333333333333333,2,2,CCAAGGTATGCTAATCTACT,0,1856403
hyuA_predicted,0.3333333333333333,2,2,CCAAGCTACCTATCTGAAAA,0,1843171
hyuA_predicted,0.3333333333333333,2,2,CCAAGAACGGGGAGCAATCT,0,1845726
hyuA_predicted,0.3333333333333333,2,2,CCAAGAAAGAGATTGGCAGC,0,1848323
hyuA_predicted,0.3333333333333333,2,2,CCAAATATGCGTACGTCAGG,0,1841237
hyuA_predicted,0.3333333333333333,2,2,CCAAAGGCAGGGCTTGCAGG,0,1836128
hyuA_predicted,0.3333333333333333,2,2,CCAAAGAACTCGGGGGGGGT,0,1832873
hyuA_predicted,0.3333333333333333,2,2,CCAAAACCGCAGGGACTGTC,0,1837283
hyuA_predicted,0.3333333333333333,2,2,CATTTAAGCGATTAGTCAGC,0,1847585
hyuA_predicted,0.3333333333333333,2,2,CATTGGCCAGGGCATGACTC,0,1837847
hyuA_predicted,0.3333333333333333,2,2,CATTAGGCCCCGTGGAAGCT,0,1838381
hyuA_predicted,0.3333333333333333,2,2,CATGTGTTAGGCCTTTCCCT,0,1841151
hyuA_predicted,0.3333333333333333,2,2,CATGTGTCAGGCTCTTTTTT,0,1876362
hyuA_predicted,0.3333333333333333,2,2,CATGGCCTAGTCTAGTATAC,0,1854946
hyuA_predicted,0.3333333333333333,2,2,CATGATTCCTGCTGAGTATT,0,1832136
hyuA_predicted,0.3333333333333333,2,2,CATGATAAGGGCCGGCCTTT,0,1846957
hyuA_predicted,0.3333333333333333,2,2,CATCTCGTGCGACCTTCACG,0,1874350
hyuA_predicted,0.3333333333333333,2,2,CATCTACGGGGACAGAGTTT,0,1864693
hyuA_predicted,0.3333333333333333,2,2,CATCTAAAAGATAATAATAC,0,1874050
hyuA_predicted,0.3333333333333333,2,2,CATCGCTCAGCGGGTAAGAA,0,1830268
hyuA_predicted,0.3333333333333333,2,2,CATCGAACGCAACCATGACA,0,1868186
hyuA_predicted,0.3333333333333333,2,2,CATCGAAATTTTGCAAACTT,0,1853191
hyuA_predicted,0.3333333333333333,2,2,CATCCCAGTTGCGCACTGTT,0,1871536
hyuA_predicted,0.3333333333333333,2,2,CATCCAATCTTGTGTCTTCA,0,1862375
hyuA_predicted,0.3333333333333333,2,2,CATCAAGAAGCCTCGATGAT,0,1852362
hyuA_predicted,0.3333333333333333,2,2,CATCAACTTCTCCCAGTACT,0,1852896
hyuA_predicted,0.3333333333333333,2,2,CATAGTATTCTTAAAGTTAT,0,1842528
hyuA_predicted,0.3333333333333333,2,2,CATAGGGTACCTCCATATGG,0,1875362
hyuA_predicted,0.3333333333333333,2,2,CATAGCTGAAGCCGTCTGGA,0,1837762
hyuA_predicted,0.3333333333333333,2,2,CATACTGTCTAATGTACCTG,0,1853816
hyuA_predicted,0.3333333333333333,2,2,CATACACTGTGGTCCGATTG,0,1838405
hyuA_predicted,0.3333333333333333,2,2,CATAACCGAATGACGTTGGC,0,1858471
hyuA_predicted,0.3333333333333333,2,2,CATAACAAAAAATGGGTCAT,0,1831404
hyuA_predicted,0.3333333333333333,2,2,CAGTCAGCGCTTTATTTCCG,0,1850801
hyuA_predicted,0.3333333333333333,2,2,CAGTATGACTACCCTGGACA,0,1867628
hyuA_predicted,0.3333333333333333,2,2,CAGTACCGGGGTCTGGTAAC,0,1872766
hyuA_predicted,0.3333333333333333,2,2,CAGGGTGAACGGTGGAAATC,0,1873225
hyuA_predicted,0.3333333333333333,2,2,CAGGGTAATCAAATTGAGTC,0,1838890
hyuA_predicted,0.3333333333333333,2,2,CAGGCTCCTACTGCCGTAAT,0,1864253
hyuA_predicted,0.3333333333333333,2,2,CAGGCAGGCCCCTTTAGTAG,0,1873454
hyuA_predicted,0.3333333333333333,2,2,CAGGCACATATTCAATCGTC,0,1869223
hyuA_predicted,0.3333333333333333,2,2,CAGGATCGTTAACGGATCAG,0,1836994
hyuA_predicted,0.3333333333333333,2,2,CAGGAAATCCGATGCCATGT,0,1848073
hyuA_predicted,0.3333333333333333,2,2,CAGCTGACCAAAGAATGCGA,0,1850425
hyuA_predicted,0.3333333333333333,2,2,CAGCTCGGCGTCTTAGGATG,0,1830354
hyuA_predicted,0.3333333333333333,2,2,CAGCGTACGAATGTTGTAAC,0,1875219
hyuA_predicted,0.3333333333333333,2,2,CAGCGCTAGGAAACGCTGAA,0,1846322
hyuA_predicted,0.3333333333333333,2,2,CAGCGCGATAGTTGGCGAAA,0,1836454
hyuA_predicted,0.3333333333333333,2,2,CAGCGCAGGACAGCGGACTT,0,1867198
hyuA_predicted,0.3333333333333333,2,2,CAGCCCTGAATACTAATCAT,0,1849430
hyuA_predicted,0.3333333333333333,2,2,CAGCCCTCCATTGCGTGGCA,0,1868175
hyuA_predicted,0.3333333333333333,2,2,CAGCAGTTTGCGACACAGGT,0,1869783
hyuA_predicted,0.3333333333333333,2,2,CAGCACCAATTGCAAGTCTC,0,1863649
hyuA_predicted,0.3333333333333333,2,2,CAGATGCCGTCGGACTCGAT,0,1834080
hyuA_predicted,0.3333333333333333,2,2,CAGAGGTGCGCATTGGAATA,0,1852140
hyuA_predicted,0.3333333333333333,2,2,CAGAGCCTGCTTTTTTGGTT,0,1852805
hyuA_predicted,0.3333333333333333,2,2,CAGAGCAAACATAACCGTAC,0,1876893
hyuA_predicted,0.3333333333333333,2,2,CAGAATCCCCGCCAGTGGAG,0,1862941
hyuA_predicted,0.3333333333333333,2,2,CAGAAGACTGAAGGCCTTTT,0,1867417
hyuA_predicted,0.3333333333333333,2,2,CACTGGGTGGAAAGTCGATT,0,1871062
hyuA_predicted,0.3333333333333333,2,2,CACTGCAATCGGTATGCCAC,0,1849733
hyuA_predicted,0.3333333333333333,2,2,CACTGAACGGCAACCTAATG,0,1848126
hyuA_predicted,0.3333333333333333,2,2,CACTCTTACCATATTCAATA,0,1833365
hyuA_predicted,0.3333333333333333,2,2,CACTCGAGGAAGCCGCGAGG,0,1849485
hyuA_predicted,0.3333333333333333,2,2,CACTAAGCAGAACCCACTAG,0,1876124
hyuA_predicted,0.3333333333333333,2,2,CACGTTTATGATCATGATGT,0,1848130
hyuA_predicted,0.3333333333333333,2,2,CACGTGATTATCATTGTAGA,0,1865848
hyuA_predicted,0.3333333333333333,2,2,CACGTCTTCCATCACCTAGG,0,1863201
hyuA_predicted,0.3333333333333333,2,2,CACGTCTATGGAGACAGTCG,0,1860390
hyuA_predicted,0.3333333333333333,2,2,CACGGCAAACAGGGGCCAGA,0,1836161
hyuA_predicted,0.3333333333333333,2,2,CACGCTAGTGCGGGCACAAG,0,1875833
hyuA_predicted,0.3333333333333333,2,2,CACGCGCTTAATACCCTCTC,0,1855305
hyuA_predicted,0.3333333333333333,2,2,CACGAACACCTCTCATCCAT,0,1835983
hyuA_predicted,0.3333333333333333,2,2,CACCTACCGAGAACCCCTAC,0,1831143
hyuA_predicted,0.3333333333333333,2,2,CACCTAAGCACGTCTTGGGA,0,1829970
hyuA_predicted,0.3333333333333333,2,2,CACCGGTTCCGTACCGTTAG,0,1842250
hyuA_predicted,0.3333333333333333,2,2,CACCGCTCGGGCGGGCAACA,0,1830428
hyuA_predicted,0.3333333333333333,2,2,CACCGAAGAGGACTCTGATA,0,1832967
hyuA_predicted,0.3333333333333333,2,2,CACCCCTGTTGTCGGCTGAT,0,1865119
hyuA_predicted,0.3333333333333333,2,2,CACATACGGGGCGCAATTAT,0,1876298
hyuA_predicted,0.3333333333333333,2,2,CACAGCAGGTTTCCACTCCC,0,1855262
hyuA_predicted,0.3333333333333333,2,2,CACAGCAAGGCGCAGTCTTC,0,1839811
hyuA_predicted,0.3333333333333333,2,2,CACACCGCAGGGTCTCTACG,0,1871234
hyuA_predicted,0.3333333333333333,2,2,CACACATAGGAGCGACACCA,0,1868282
hyuA_predicted,0.3333333333333333,2,2,CACACACGGAAGTTGGTATT,0,1866995
hyuA_predicted,0.3333333333333333,2,2,CAATTGGTTCAATATTATCT,0,1850628
hyuA_predicted,0.3333333333333333,2,2,CAATTCCATGATCGGTACGT,0,1851098
hyuA_predicted,0.3333333333333333,2,2,CAATGTACATGAAATCCGGA,0,1843263
hyuA_predicted,0.3333333333333333,2,2,CAATGGCCAGGCTGGCCCTC,0,1843582
hyuA_predicted,0.3333333333333333,2,2,CAATCGGCAGGGTGTAAATT,0,1863102
hyuA_predicted,0.3333333333333333,2,2,CAATCGATCCTAAGGGCAAC,0,1868171
hyuA_predicted,0.3333333333333333,2,2,CAATCACTACGCGTTCCGTC,0,1850232
hyuA_predicted,0.3333333333333333,2,2,CAATATACGTAATTCCCACA,0,1876002
hyuA_predicted,0.3333333333333333,2,2,CAATATACAAATTTAAGCGC,0,1848285
hyuA_predicted,0.3333333333333333,2,2,CAATAACTGGCGGAAAATTA,0,1836248
hyuA_predicted,0.3333333333333333,2,2,CAAGTTGGTTTACAGTATAA,0,1870979
hyuA_predicted,0.3333333333333333,2,2,CAAGGTTGCATAGGATAGGG,0,1833765
hyuA_predicted,0.3333333333333333,2,2,CAAGCGAAGTTTCTCTTTAA,0,1842687
hyuA_predicted,0.3333333333333333,2,2,CAAGCAACTGGTCAATGAAT,0,1845492
hyuA_predicted,0.3333333333333333,2,2,CAAGAGCCAATGAGATTATG,0,1832847
hyuA_predicted,0.3333333333333333,2,2,CAACGTACATGGTGTGACAA,0,1874613
hyuA_predicted,0.3333333333333333,2,2,CAACGCGAGCTAGCAGCGTA,0,1840503
hyuA_predicted,0.3333333333333333,2,2,CAACGAGGGCCGAAGGCTTA,0,1867272
hyuA_predicted,0.3333333333333333,2,2,CAACCCTGCCGCGTACCCGA,0,1846797
hyuA_predicted,0.3333333333333333,2,2,CAAACACAGTGTTACCCGCT,0,1842992
hyuA_predicted,0.3333333333333333,2,2,CAAAAGCTAAGGTCAACGTA,0,1850458
hyuA_predicted,0.3333333333333333,2,2,ATTTTCGTGTGGGGATTTAC,0,1832626
hyuA_predicted,0.3333333333333333,2,2,ATTTTCGGGTCCACGCGCCC,0,1867322
hyuA_predicted,0.3333333333333333,2,2,ATTTGCCGCTAGAAGCGAGT,0,1852001
hyuA_predicted,0.3333333333333333,2,2,ATTTAAGCTTTAGACGATGG,0,1863816
hyuA_predicted,0.3333333333333333,2,2,ATTTAAGAAGTGCATTTAAA,0,1849264
hyuA_predicted,0.3333333333333333,2,2,ATTGTTTCCACGTAGGACAG,0,1848237
hyuA_predicted,0.3333333333333333,2,2,ATTGTGCTCTTAGTGCGATC,0,1858182
hyuA_predicted,0.3333333333333333,2,2,ATTGTCCATGCATGCCCGCA,0,1874789
hyuA_predicted,0.3333333333333333,2,2,ATTGGTGCCTTTTCTTCGAA,0,1839069
hyuA_predicted,0.3333333333333333,2,2,ATTGGAGTTCAACGCTTTCG,0,1837067
hyuA_predicted,0.3333333333333333,2,2,ATTGCCCGCTTCTACGTTTT,0,1861071
hyuA_predicted,0.3333333333333333,2,2,ATTGCAGGATGACTATTCCG,0,1829065
hyuA_predicted,0.3333333333333333,2,2,ATTGACGGGTCCAGCTACGT,0,1872048
hyuA_predicted,0.3333333333333333,2,2,ATTGACACTGGCCTCGATTT,0,1843829
hyuA_predicted,0.3333333333333333,2,2,ATTCTCAGAACGTATTGTAT,0,1848201
hyuA_predicted,0.3333333333333333,2,2,ATTCTCAAGTCTCAAAACTT,0,1856626
hyuA_predicted,0.3333333333333333,2,2,ATTCGTCCTATCCCGAAAAG,0,1837603
hyuA_predicted,0.3333333333333333,2,2,ATTCGTCCCCCGCGACAGGG,0,1830196
hyuA_predicted,0.3333333333333333,2,2,ATTCGGAACTGAGCGAGATT,0,1850796
hyuA_predicted,0.3333333333333333,2,2,ATTCCCCGCGGACGCATAGC,0,1852742
hyuA_predicted,0.3333333333333333,2,2,ATTCATTTTGGCTAGTCGGT,0,1848640
hyuA_predicted,0.3333333333333333,2,2,ATTCATGTTAATGTGATGCT,0,1868163
hyuA_predicted,0.3333333333333333,2,2,ATTCACATCGCAAATAGTCC,0,1871709
hyuA_predicted,0.3333333333333333,2,2,ATTCACATAAACACGGTTAA,0,1871383
hyuA_predicted,0.3333333333333333,2,2,ATTATTGGAGGGTCCGGTCA,0,1877353
hyuA_predicted,0.3333333333333333,2,2,ATTAGTGAAAGCGGCTGGAA,0,1837606
hyuA_predicted,0.3333333333333333,2,2,ATTAGTCTCTGAAGGGTCAT,0,1850708
hyuA_predicted,0.3333333333333333,2,2,ATTAGGTCATGTTCGATATT,0,1836325
hyuA_predicted,0.3333333333333333,2,2,ATTACCCGGGGCACCTGTTC,0,1854150
hyuA_predicted,0.3333333333333333,2,2,ATTAACTCTCTCAGTGCTCA,0,1877273
hyuA_predicted,0.3333333333333333,2,2,ATTAACTCAGCCCGGGCGGT,0,1833709
hyuA_predicted,0.3333333333333333,2,2,ATGTTACAGTGACGCTGATT,0,1864030
hyuA_predicted,0.3333333333333333,2,2,ATGTGTGGACTATTTAATCG,0,1844583
hyuA_predicted,0.3333333333333333,2,2,ATGTCGGTAGATTGAAAAGT,0,1833077
hyuA_predicted,0.3333333333333333,2,2,ATGGTGTTATTTGGGGCCGG,0,1874947
hyuA_predicted,0.3333333333333333,2,2,ATGGGTTTACCGAGTTTCGT,0,1864435
hyuA_predicted,0.3333333333333333,2,2,ATGGGTGGGAGTCGGCGAGG,0,1838274
hyuA_predicted,0.3333333333333333,2,2,ATGGCTGCCCAGTTGGTGGT,0,1844504
hyuA_predicted,0.3333333333333333,2,2,ATGGCTCGGGATCGCCCAAC,0,1870864
hyuA_predicted,0.3333333333333333,2,2,ATGCCGGCTGACGACAGGCT,0,1831907
hyuA_predicted,0.3333333333333333,2,2,ATGCCAGGAAGGGCCGAGCC,0,1859335
hyuA_predicted,0.3333333333333333,2,2,ATGATGTGACAGTCAGAATT,0,1831288
hyuA_predicted,0.3333333333333333,2,2,ATGAGTTGTGTCGTATGTGT,0,1865183
hyuA_predicted,0.3333333333333333,2,2,ATGAGTATGCGGACGTTCTG,0,1872197
hyuA_predicted,0.3333333333333333,2,2,ATGAGCGGAGGAACAGGATA,0,1852049
hyuA_predicted,0.3333333333333333,2,2,ATGAGAGGTTCATATTTCAA,0,1845632
hyuA_predicted,0.3333333333333333,2,2,ATGAAGGCATTTTCATCAGG,0,1851257
hyuA_predicted,0.3333333333333333,2,2,ATCTCCTTTGCGGATCGTAA,0,1836378
hyuA_predicted,0.3333333333333333,2,2,ATCTACGTTACAGGGCCTGA,0,1835345
hyuA_predicted,0.3333333333333333,2,2,ATCTAATCAATTTTTCGCGG,0,1874270
hyuA_predicted,0.3333333333333333,2,2,ATCGTTTCAACCAATCCGAC,0,1845050
hyuA_predicted,0.3333333333333333,2,2,ATCGTCAGTGACTTCTGTTG,0,1865729
hyuA_predicted,0.3333333333333333,2,2,ATCGTAGCCCGGCATGTCCA,0,1835342
hyuA_predicted,0.3333333333333333,2,2,ATCGGGCATGCAAATGTGCC,0,1844909
hyuA_predicted,0.3333333333333333,2,2,ATCGGCCAAGCAAACGTCAA,0,1858644
hyuA_predicted,0.3333333333333333,2,2,ATCCGGGTTGGGGCAGCCAC,0,1846867
hyuA_predicted,0.3333333333333333,2,2,ATCCGGCCACTATATAAGTG,0,1834113
hyuA_predicted,0.3333333333333333,2,2,ATCCGCCTCCAGAGTAGTTG,0,1855937
hyuA_predicted,0.3333333333333333,2,2,ATCCGACGTGCAGCAATCAG,0,1847485
hyuA_predicted,0.3333333333333333,2,2,ATCCCGATGACACAGGTAAG,0,1832184
hyuA_predicted,0.3333333333333333,2,2,ATCCCCACACGCGGGGTATT,0,1843591
hyuA_predicted,0.3333333333333333,2,2,ATCCATACTCTAGACCGTAG,0,1851304
hyuA_predicted,0.3333333333333333,2,2,ATCCAGCGAAGAACTACTCA,0,1876014
hyuA_predicted,0.3333333333333333,2,2,ATCATGCAACCGTATCGAGA,0,1868659
hyuA_predicted,0.3333333333333333,2,2,ATCAGGCCCAGCAGGACGTC,0,1849887
hyuA_predicted,0.3333333333333333,2,2,ATCAGGAGGCTGCCGGACCT,0,1853622
hyuA_predicted,0.3333333333333333,2,2,ATCAGCTGGCTCAAGTTAAA,0,1832400
hyuA_predicted,0.3333333333333333,2,2,ATCAGATAAAGTTTTTAATT,0,1849766
hyuA_predicted,0.3333333333333333,2,2,ATCAATCCTCAGCGCCTCTG,0,1853214
hyuA_predicted,0.3333333333333333,2,2,ATATTTTCACGATAGTTTAT,0,1871957
hyuA_predicted,0.3333333333333333,2,2,ATATTACAGAAGGCTCTACT,0,1844501
hyuA_predicted,0.3333333333333333,2,2,ATATGCCAATGTATCCATCT,0,1858864
hyuA_predicted,0.3333333333333333,2,2,ATATCTGCCGTCTTCGACTC,0,1866864
hyuA_predicted,0.3333333333333333,2,2,ATATACCCTTGTGCGAAATC,0,1844772
hyuA_predicted,0.3333333333333333,2,2,ATATAACTCTGGGGGCGATA,0,1831697
hyuA_predicted,0.3333333333333333,2,2,ATATAAACGACGTACGAAAT,0,1876434
hyuA_predicted,0.3333333333333333,2,2,ATAGTAGGGAAAGAATGATA,0,1850300
hyuA_predicted,0.3333333333333333,2,2,ATAGGTTGTATGCGGTATGA,0,1858139
hyuA_predicted,0.3333333333333333,2,2,ATAGGGACGTTCACCCGCGT,0,1848200
hyuA_predicted,0.3333333333333333,2,2,ATAGGCTAATTAAATGCTTG,0,1869542
hyuA_predicted,0.3333333333333333,2,2,ATAGATCGGTGTATCGGCTG,0,1832403
hyuA_predicted,0.3333333333333333,2,2,ATAGAGTTTTATAACCATCT,0,1852057
hyuA_predicted,0.3333333333333333,2,2,ATACGTAGAAGGCCTGCCTA,0,1863187
hyuA_predicted,0.3333333333333333,2,2,ATACGGTATAGTTTTTGGTA,0,1857117
hyuA_predicted,0.3333333333333333,2,2,ATACGCACAGTTGCTGCTGG,0,1856039
hyuA_predicted,0.3333333333333333,2,2,ATACGATTGTTCGGTAAGCA,0,1849321
hyuA_predicted,0.3333333333333333,2,2,ATACACTATTATGACCAACG,0,1842166
hyuA_predicted,0.3333333333333333,2,2,ATACAATTACTCGCCGCACA,0,1854906
hyuA_predicted,0.3333333333333333,2,2,ATAATTCTGACATTCTTGGA,0,1864655
hyuA_predicted,0.3333333333333333,2,2,ATAATAACCGTACAGTCCAC,0,1859717
hyuA_predicted,0.3333333333333333,2,2,ATAAGGGCCGAGATAAAGGG,0,1835112
hyuA_predicted,0.3333333333333333,2,2,ATAAGGCTTGGGTTAGCCCA,0,1852019
hyuA_predicted,0.3333333333333333,2,2,ATAAGGCTCTTTTTCGTAGG,0,1834614
hyuA_predicted,0.3333333333333333,2,2,ATAAGCCTCACAGATTTCGG,0,1876304
hyuA_predicted,0.3333333333333333,2,2,ATAAGAGAGCCAGCTCGATC,0,1858288
hyuA_predicted,0.3333333333333333,2,2,ATAACTACGGAACCCCCCGA,0,1873044
hyuA_predicted,0.3333333333333333,2,2,ATAAAGGTTTCAAAACGTGC,0,1855827
hyuA_predicted,0.3333333333333333,2,2,ATAAAGCGGTGTCCGAGTTC,0,1846441
hyuA_predicted,0.3333333333333333,2,2,AGTTGTCAAAAGCCTTCGTA,0,1866253
hyuA_predicted,0.3333333333333333,2,2,AGTTGGCCACGTTACAGGCA,0,1844344
hyuA_predicted,0.3333333333333333,2,2,AGTTCGCCTAGGTTAAGGTA,0,1876208
hyuA_predicted,0.3333333333333333,2,2,AGTTAGAGGGTCAATAACAC,0,1860370
hyuA_predicted,0.3333333333333333,2,2,AGTTAGAAGCGTGATGGGTA,0,1864387
hyuA_predicted,0.3333333333333333,2,2,AGTTAAAGGTAAGAAGTCGC,0,1851191
hyuA_predicted,0.3333333333333333,2,2,AGTGTGGCTGGAAAGGTCCT,0,1875228
hyuA_predicted,0.3333333333333333,2,2,AGTGGTGATGTCTCAGATTC,0,1834227
hyuA_predicted,0.3333333333333333,2,2,AGTGGCTGGCGCAGGGCGCT,0,1859790
hyuA_predicted,0.3333333333333333,2,2,AGTGGCATGGGGCCCAGTCT,0,1853562
hyuA_predicted,0.3333333333333333,2,2,AGTGAGAACCTGGATTTACC,0,1844665
hyuA_predicted,0.3333333333333333,2,2,AGTCTGTTCTGTGGGCGTGT,0,1836117
hyuA_predicted,0.3333333333333333,2,2,AGTCCCTGACATTTGCGCAG,0,1843276
hyuA_predicted,0.3333333333333333,2,2,AGTCATCTGAGGCGCATTCA,0,1844613
hyuA_predicted,0.3333333333333333,2,2,AGTCATAGCTCTGGCCGGTA,0,1833937
hyuA_predicted,0.3333333333333333,2,2,AGTATGGGGCACGTTTGTGT,0,1860066
hyuA_predicted,0.3333333333333333,2,2,AGTATCGAGCTAGGGCTTAG,0,1847172
hyuA_predicted,0.3333333333333333,2,2,AGTATAGACAACTCCGCCAA,0,1868278
hyuA_predicted,0.3333333333333333,2,2,AGTAGGTAGAATTTCTGTCT,0,1838524
hyuA_predicted,0.3333333333333333,2,2,AGTAGGATGTTTTTGTGCCT,0,1846136
hyuA_predicted,0.3333333333333333,2,2,AGTAAGTAGATCAGGGAAAC,0,1833571
hyuA_predicted,0.3333333333333333,2,2,AGTAAGGGAACAAGATCCTT,0,1856723
hyuA_predicted,0.3333333333333333,2,2,AGTAACTGAGCACCTTGTAT,0,1859480
hyuA_predicted,0.3333333333333333,2,2,AGGTTACTCGCTGGTTCTTT,0,1855030
hyuA_predicted,0.3333333333333333,2,2,AGGTGCGATTGCTAGAGTGC,0,1864740
hyuA_predicted,0.3333333333333333,2,2,AGGTGCCGGACTAACCTCTG,0,1852741
hyuA_predicted,0.3333333333333333,2,2,AGGTCGTGTGTGGGAGACGA,0,1835334
hyuA_predicted,0.3333333333333333,2,2,AGGTCAACAGGCTTATAATC,0,1853018
hyuA_predicted,0.3333333333333333,2,2,AGGTATCTAGCGCAGCTGCG,0,1844307
hyuA_predicted,0.3333333333333333,2,2,AGGGTTTGAAGCGAATGGTT,0,1842095
hyuA_predicted,0.3333333333333333,2,2,AGGGTAAACTTTATTATTAA,0,1843153
hyuA_predicted,0.3333333333333333,2,2,AGGGGGTTCCTTACGAGATT,0,1852884
hyuA_predicted,0.3333333333333333,2,2,AGGGGACCTAAAGCTTCGTA,0,1862850
hyuA_predicted,0.3333333333333333,2,2,AGGGCTTACTGTTCGTGAGC,0,1860359
hyuA_predicted,0.3333333333333333,2,2,AGGGCACCGGGATGCATGAC,0,1863019
hyuA_predicted,0.3333333333333333,2,2,AGGGAGCACTCGGGTGGGCA,0,1868219
hyuA_predicted,0.3333333333333333,2,2,AGGGAAGCCCGGGCGTGCCA,0,1872834
hyuA_predicted,0.3333333333333333,2,2,AGGCTTGACTTACAGGCGTT,0,1876425
hyuA_predicted,0.3333333333333333,2,2,AGGCTGTGTCTCAGTAAGAA,0,1871142
hyuA_predicted,0.3333333333333333,2,2,AGGCCCGCAAGCAAGAACAC,0,1846312
hyuA_predicted,0.3333333333333333,2,2,AGGCATACCTAAGAAGGGAG,0,1833107
hyuA_predicted,0.3333333333333333,2,2,AGGATAAGACTAGAAGCAGT,0,1837223
hyuA_predicted,0.3333333333333333,2,2,AGGACGAAGGTGTACGGCTA,0,1829585
hyuA_predicted,0.3333333333333333,2,2,AGGAAGTAACTTCCTCGCAA,0,1869552
hyuA_predicted,0.3333333333333333,2,2,AGGAAAGGTTACACTATTAC,0,1833786
hyuA_predicted,0.3333333333333333,2,2,AGCTCAGATATTTAATGACA,0,1876598
hyuA_predicted,0.3333333333333333,2,2,AGCGTTAATGAGCACTCCCA,0,1835285
hyuA_predicted,0.3333333333333333,2,2,AGCGTACTCTCTTGATGGTT,0,1872394
hyuA_predicted,0.3333333333333333,2,2,AGCGTACCTCGGTCTAGATG,0,1835900
hyuA_predicted,0.3333333333333333,2,2,AGCGATCGCCACTAGGCATG,0,1870103
hyuA_predicted,0.3333333333333333,2,2,AGCCTGCCTGAGGTACTTCT,0,1865913
hyuA_predicted,0.3333333333333333,2,2,AGCCGGGCGTTTGTAGAGAG,0,1848450
hyuA_predicted,0.3333333333333333,2,2,AGCCCCCCGTTCGACATATA,0,1842214
hyuA_predicted,0.3333333333333333,2,2,AGCCAACCCGGGCGACCCGT,0,1851827
hyuA_predicted,0.3333333333333333,2,2,AGATTAAAGAGCGGTCGTCG,0,1831517
hyuA_predicted,0.3333333333333333,2,2,AGATGTCCAGCTAAACCGTG,0,1833296
hyuA_predicted,0.3333333333333333,2,2,AGATGCTTGGTACGGGTTTG,0,1866131
hyuA_predicted,0.3333333333333333,2,2,AGATGAGCTAACCTCTTAAT,0,1834152
hyuA_predicted,0.3333333333333333,2,2,AGATCGCCCTCCTACCGAGC,0,1839034
hyuA_predicted,0.3333333333333333,2,2,AGATACGGTAGCGAACGAAA,0,1873691
hyuA_predicted,0.3333333333333333,2,2,AGATACACGTCTAGCTTAAA,0,1855538
hyuA_predicted,0.3333333333333333,2,2,AGATAATGGGACAATGTCAC,0,1830971
hyuA_predicted,0.3333333333333333,2,2,AGATAACAACGAGGGTTAAC,0,1860652
hyuA_predicted,0.3333333333333333,2,2,AGAGTAGTCTTTGGCATGTT,0,1833704
hyuA_predicted,0.3333333333333333,2,2,AGAGTAAGGAATGTTGCAAT,0,1870789
hyuA_predicted,0.3333333333333333,2,2,AGAGGTTGCCCCAGAGGGAC,0,1830327
hyuA_predicted,0.3333333333333333,2,2,AGAGCGCAGACCACAAACTT,0,1839568
hyuA_predicted,0.3333333333333333,2,2,AGAGCCTGTTTGGACCTCCT,0,1863933
hyuA_predicted,0.3333333333333333,2,2,AGAGCAATGGCCAGCGACAA,0,1870787
hyuA_predicted,0.3333333333333333,2,2,AGAGAGCCACATTAATTTGT,0,1840081
hyuA_predicted,0.3333333333333333,2,2,AGACGGGAGTTGAGGATTTC,0,1874043
hyuA_predicted,0.3333333333333333,2,2,AGACGAAACGGAGTTCAGAA,0,1853131
hyuA_predicted,0.3333333333333333,2,2,AGACCTCTACTGTAGTCGCG,0,1845891
hyuA_predicted,0.3333333333333333,2,2,AGACCTACCATGACGTAGTA,0,1866146
hyuA_predicted,0.3333333333333333,2,2,AGACATATGCCGACAATTAT,0,1840825
hyuA_predicted,0.3333333333333333,2,2,AGACAGTAGAGCGCTTCCAT,0,1874632
hyuA_predicted,0.3333333333333333,2,2,AGAACGGCCGGCTCCTACTA,0,1853667
hyuA_predicted,0.3333333333333333,2,2,ACTTTAACGGCCTGAATGCC,0,1874940
hyuA_predicted,0.3333333333333333,2,2,ACTTGGTCCTCTACGGCCTC,0,1831461
hyuA_predicted,0.3333333333333333,2,2,ACTTGGGTGAACGTCGCGTG,0,1868843
hyuA_predicted,0.3333333333333333,2,2,ACTTATGACGTTTTAGTGTG,0,1832762
hyuA_predicted,0.3333333333333333,2,2,ACTGTTTACGTAGACGGGAG,0,1862265
hyuA_predicted,0.3333333333333333,2,2,ACTGTTGTATTACCTGGACC,0,1838967
hyuA_predicted,0.3333333333333333,2,2,ACTGTCGCAACGGAAGACTT,0,1855094
hyuA_predicted,0.3333333333333333,2,2,ACTGTACCTGGTGGAGAACA,0,1829618
hyuA_predicted,0.3333333333333333,2,2,ACTGTAATCTCTCTTCGTTT,0,1838219
hyuA_predicted,0.3333333333333333,2,2,ACTGCCATTAACCTTAAGCC,0,1853477
hyuA_predicted,0.3333333333333333,2,2,ACTGACATGAAACGGCGTAG,0,1861751
hyuA_predicted,0.3333333333333333,2,2,ACTGACACATCCCGGTCGCT,0,1864390
hyuA_predicted,0.3333333333333333,2,2,ACTCTCACGACCTTGGCTAA,0,1835790
hyuA_predicted,0.3333333333333333,2,2,ACTCGCCCGTTTGCCAACCA,0,1831319
hyuA_predicted,0.3333333333333333,2,2,ACTCGACATTTTACACCTAG,0,1846097
hyuA_predicted,0.3333333333333333,2,2,ACTCAGTCTGTTCGCAAACG,0,1860808
hyuA_predicted,0.3333333333333333,2,2,ACTCAAGTTACAACCCGTGG,0,1857143
hyuA_predicted,0.3333333333333333,2,2,ACTATTAAGAATATACAGAG,0,1864420
hyuA_predicted,0.3333333333333333,2,2,ACTATGGCTCGCGGGTCGAT,0,1844053
hyuA_predicted,0.3333333333333333,2,2,ACTACTAGGACCGGATCATA,0,1836612
hyuA_predicted,0.3333333333333333,2,2,ACTACATAGGTGATACAGCC,0,1834475
hyuA_predicted,0.3333333333333333,2,2,ACTAACGTCGAACAAGCTAC,0,1842619
hyuA_predicted,0.3333333333333333,2,2,ACGTTCAGGCATCACGGCTG,0,1850096
hyuA_predicted,0.3333333333333333,2,2,ACGTGCATTCTACCTGCCCT,0,1851219
hyuA_predicted,0.3333333333333333,2,2,ACGTGACAGTCAGAGTTTAC,0,1871011
hyuA_predicted,0.3333333333333333,2,2,ACGTCGCTTTTGGGCAGAAT,0,1853161
hyuA_predicted,0.3333333333333333,2,2,ACGTCGCAGGCTGCCATGAC,0,1832171
hyuA_predicted,0.3333333333333333,2,2,ACGGGGCGCTGGCTCGGCCC,0,1866410
hyuA_predicted,0.3333333333333333,2,2,ACGGCGGGCTAACAATAAAC,0,1831857
hyuA_predicted,0.3333333333333333,2,2,ACGGACAATTTTGAATATCA,0,1834489
hyuA_predicted,0.3333333333333333,2,2,ACGGAATAATCGATGGCCTT,0,1843254
hyuA_predicted,0.3333333333333333,2,2,ACGCTACTGTGACCCCGGCA,0,1837931
hyuA_predicted,0.3333333333333333,2,2,ACGCGGTGGAATCCATGATC,0,1857757
hyuA_predicted,0.3333333333333333,2,2,ACGCCTAGCAGAGCTCTTAA,0,1859383
hyuA_predicted,0.3333333333333333,2,2,ACGCCAACGACCAACGGATG,0,1837853
hyuA_predicted,0.3333333333333333,2,2,ACGAGTTCTTACACGATGTC,0,1869109
hyuA_predicted,0.3333333333333333,2,2,ACGACGTTGACCAAAATCCA,0,1856989
hyuA_predicted,0.3333333333333333,2,2,ACGACGGTCCTGTCACTCAT,0,1876529
hyuA_predicted,0.3333333333333333,2,2,ACGAATCATGGCAAGGGTTA,0,1864020
hyuA_predicted,0.3333333333333333,2,2,ACGAATAATACGTAATCTAG,0,1856215
hyuA_predicted,0.3333333333333333,2,2,ACCTTCGATTCATCGTACGG,0,1864520
hyuA_predicted,0.3333333333333333,2,2,ACCTAGGGAGGCTTCCGCAT,0,1834248
hyuA_predicted,0.3333333333333333,2,2,ACCTACCGAGGGGCATCTAC,0,1862169
hyuA_predicted,0.3333333333333333,2,2,ACCTAATTTTCACCCGAGAA,0,1832503
hyuA_predicted,0.3333333333333333,2,2,ACCTAATTACCATGAAAGTA,0,1841123
hyuA_predicted,0.3333333333333333,2,2,ACCGTTGACCGCACACTGCA,0,1874274
hyuA_predicted,0.3333333333333333,2,2,ACCGTTATGCGCCTCCCCAG,0,1832407
hyuA_predicted,0.3333333333333333,2,2,ACCGCCAGCTACAGTGAGTC,0,1861408
hyuA_predicted,0.3333333333333333,2,2,ACCGATAGGAAGTAGCGCTG,0,1842544
hyuA_predicted,0.3333333333333333,2,2,ACCGACTCGTATAAAGGACT,0,1862019
hyuA_predicted,0.3333333333333333,2,2,ACCGACCCAACACAACTGAC,0,1866284
hyuA_predicted,0.3333333333333333,2,2,ACCGACAGTCGCCACGTCGC,0,1868871
hyuA_predicted,0.3333333333333333,2,2,ACCGAAGAACCTAATGTTAA,0,1849856
hyuA_predicted,0.3333333333333333,2,2,ACCGAACCGGATTGGTCACA,0,1849405
hyuA_predicted,0.3333333333333333,2,2,ACCCTTAAGCAGCGACTTAA,0,1857854
hyuA_predicted,0.3333333333333333,2,2,ACCCGGCAGGCGACTTCTGT,0,1854144
hyuA_predicted,0.3333333333333333,2,2,ACCCCGACCCTTTTTTGCCG,0,1838713
hyuA_predicted,0.3333333333333333,2,2,ACCCAACGCGTGCACCTTAA,0,1851088
hyuA_predicted,0.3333333333333333,2,2,ACCATTCGGTGTTCGAGGTG,0,1844983
hyuA_predicted,0.3333333333333333,2,2,ACCATCTATACCTTAAGTAC,0,1833045
hyuA_predicted,0.3333333333333333,2,2,ACCATAGTATTCCGTGACCC,0,1851390
hyuA_predicted,0.3333333333333333,2,2,ACCACGTGTTAACAATTCCA,0,1852407
hyuA_predicted,0.3333333333333333,2,2,ACCACATGAGGTCTAGGCCC,0,1854942
hyuA_predicted,0.3333333333333333,2,2,ACATTTTGGGTATCGTTAGG,0,1842726
hyuA_predicted,0.3333333333333333,2,2,ACATTCCATCTTGTTCTACG,0,1841426
hyuA_predicted,0.3333333333333333,2,2,ACATTATAACCCCGGTATTG,0,1834713
hyuA_predicted,0.3333333333333333,2,2,ACATGATCGTAAATTTTTAT,0,1836992
hyuA_predicted,0.3333333333333333,2,2,ACATGAGAGCACCCCGCTTA,0,1830311
hyuA_predicted,0.3333333333333333,2,2,ACATATCATGGCTTTTCCAA,0,1864216
hyuA_predicted,0.3333333333333333,2,2,ACATAGCCTGTGCGTCTTAA,0,1846847
hyuA_predicted,0.3333333333333333,2,2,ACAGCTTGCCTGTGATCGAA,0,1851633
hyuA_predicted,0.3333333333333333,2,2,ACAGCTGAGCAGACAGTTGT,0,1839384
hyuA_predicted,0.3333333333333333,2,2,ACAGAGAATTCAGAGGCGCC,0,1862660
hyuA_predicted,0.3333333333333333,2,2,ACACTGGGCTAGCTAATACA,0,1865482
hyuA_predicted,0.3333333333333333,2,2,ACACTACCGCGTAATACGAT,0,1871687
hyuA_predicted,0.3333333333333333,2,2,ACACGACGCGACTAAATGGA,0,1865168
hyuA_predicted,0.3333333333333333,2,2,ACACATTCCGGGCGTAGGCT,0,1837282
hyuA_predicted,0.3333333333333333,2,2,ACACATTCAGCTTGTCTTGT,0,1833509
hyuA_predicted,0.3333333333333333,2,2,ACACACTCTGTCCCCCAAGT,0,1851566
hyuA_predicted,0.3333333333333333,2,2,ACACACTCGGCCCACCGAAG,0,1829748
hyuA_predicted,0.3333333333333333,2,2,ACACAATTTTTCCTAAGTAT,0,1859411
hyuA_predicted,0.3333333333333333,2,2,ACAATCGGGCCTTGATAAGG,0,1854411
hyuA_predicted,0.3333333333333333,2,2,ACAATAAGTGTGAAATTGTA,0,1853887
hyuA_predicted,0.3333333333333333,2,2,ACAAGGTCACCGGACTGTAT,0,1873902
hyuA_predicted,0.3333333333333333,2,2,ACAAGGGTTTTTCGAGTACT,0,1834337
hyuA_predicted,0.3333333333333333,2,2,ACAAGGATTTGTCAAGCCCC,0,1840841
hyuA_predicted,0.3333333333333333,2,2,ACAAGACTTCTGCAATTAAA,0,1842262
hyuA_predicted,0.3333333333333333,2,2,ACAACTACTTGCGTCACTGA,0,1865532
hyuA_predicted,0.3333333333333333,2,2,AATTCACAATACTCAGAGCC,0,1846755
hyuA_predicted,0.3333333333333333,2,2,AATTACTAAATTAGTGTGCG,0,1859676
hyuA_predicted,0.3333333333333333,2,2,AATGTCGGTAGACAATGTGG,0,1855810
hyuA_predicted,0.3333333333333333,2,2,AATGGATGGATTAATGGGGG,0,1834601
hyuA_predicted,0.3333333333333333,2,2,AATGATTGACGGTTTTTTAC,0,1856091
hyuA_predicted,0.3333333333333333,2,2,AATCGGGCGTGTAGAAAAAG,0,1842465
hyuA_predicted,0.3333333333333333,2,2,AATCGCTTCCTGCGACGCCG,0,1851311
hyuA_predicted,0.3333333333333333,2,2,AATATAGGCCGCCGAACATG,0,1832254
hyuA_predicted,0.3333333333333333,2,2,AATAGAGGTACGGTAAAGTC,0,1862930
hyuA_predicted,0.3333333333333333,2,2,AATAATTTACGTTAAGGGTT,0,1829520
hyuA_predicted,0.3333333333333333,2,2,AATAATACGGCGGCTACGCG,0,1852062
hyuA_predicted,0.3333333333333333,2,2,AATAAATGGGCTCTCTATTT,0,1863291
hyuA_predicted,0.3333333333333333,2,2,AAGTTTATCAATGAACCGCT,0,1832083
hyuA_predicted,0.3333333333333333,2,2,AAGTTAAAGTCCCACCCGCG,0,1855877
hyuA_predicted,0.3333333333333333,2,2,AAGTGTTCAGTAAAGTAGAG,0,1829653
hyuA_predicted,0.3333333333333333,2,2,AAGTGCAGAACGTCCAGGAA,0,1873017
hyuA_predicted,0.3333333333333333,2,2,AAGTCCTGTGGTAGTGTAAT,0,1867811
hyuA_predicted,0.3333333333333333,2,2,AAGTATAATGGAACCACCGT,0,1864418
hyuA_predicted,0.3333333333333333,2,2,AAGTACCGTTGTTGGGCGGG,0,1852322
hyuA_predicted,0.3333333333333333,2,2,AAGGTTATCATTTACCTACC,0,1842527
hyuA_predicted,0.3333333333333333,2,2,AAGGTCACAGCATGCGGTTT,0,1842949
hyuA_predicted,0.3333333333333333,2,2,AAGGGTTCGTCTACCCGGAG,0,1835999
hyuA_predicted,0.3333333333333333,2,2,AAGGCTGACAGAGATGTCAC,0,1854787
hyuA_predicted,0.3333333333333333,2,2,AAGGCCTCTTCGCGGACGCT,0,1830745
hyuA_predicted,0.3333333333333333,2,2,AAGCTGCAACGGGCTTCCCA,0,1877299
hyuA_predicted,0.3333333333333333,2,2,AAGCTGAACTCACTAGCCCC,0,1875661
hyuA_predicted,0.3333333333333333,2,2,AAGCGTCTCCCCCTCCAATC,0,1858928
hyuA_predicted,0.3333333333333333,2,2,AAGCGAGAGAATCGGGTTGG,0,1853058
hyuA_predicted,0.3333333333333333,2,2,AAGCCAGGAGGACCCTAACC,0,1839859
hyuA_predicted,0.3333333333333333,2,2,AAGCCACGGTCGATATAACC,0,1850053
hyuA_predicted,0.3333333333333333,2,2,AAGCATCAACTGCTTAAAGT,0,1843994
hyuA_predicted,0.3333333333333333,2,2,AAGATTATTCCAAAGTGCCA,0,1874952
hyuA_predicted,0.3333333333333333,2,2,AAGATGTAGAATTAGGGGTA,0,1830044
hyuA_predicted,0.3333333333333333,2,2,AAGAGCTCGTCTCCCAAGAC,0,1840741
hyuA_predicted,0.3333333333333333,2,2,AAGAATCATAAACGTGAGCT,0,1861643
hyuA_predicted,0.3333333333333333,2,2,AACTTACGAGCGGCTGTAGA,0,1861498
hyuA_predicted,0.3333333333333333,2,2,AACTGGACTGGTGTATCCCG,0,1847031
hyuA_predicted,0.3333333333333333,2,2,AACTAGGCCATTGGACCCGA,0,1875922
hyuA_predicted,0.3333333333333333,2,2,AACTAGCACACGGACATCGT,0,1845213
hyuA_predicted,0.3333333333333333,2,2,AACGGCTCTACGGATACAAT,0,1852164
hyuA_predicted,0.3333333333333333,2,2,AACGGATGACCCACTGTAAC,0,1833589
hyuA_predicted,0.3333333333333333,2,2,AACGCTTTAATTTAATCAGG,0,1866758
hyuA_predicted,0.3333333333333333,2,2,AACGCTTGCAGTATGACGGG,0,1869132
hyuA_predicted,0.3333333333333333,2,2,AACGCTCTAGTGTAAACGCG,0,1866693
hyuA_predicted,0.3333333333333333,2,2,AACGATTTACCGGACAGCGG,0,1858820
hyuA_predicted,0.3333333333333333,2,2,AACGATGGTGTTCACTGCGC,0,1844331
hyuA_predicted,0.3333333333333333,2,2,AACGAACAGAGCGAGGCAAT,0,1875350
hyuA_predicted,0.3333333333333333,2,2,AACCGGCATGGCACACCATA,0,1840354
hyuA_predicted,0.3333333333333333,2,2,AACCGCACAGTCTATTATGT,0,1852616
hyuA_predicted,0.3333333333333333,2,2,AACCAGGCCATCGACGCTCG,0,1849728
hyuA_predicted,0.3333333333333333,2,2,AACCACTACTCTGGCTTCTT,0,1844591
hyuA_predicted,0.3333333333333333,2,2,AACCAATTTCAGAAATGCCG,0,1835270
hyuA_predicted,0.3333333333333333,2,2,AACCAATCCTTTTTGGTATC,0,1832222
hyuA_predicted,0.3333333333333333,2,2,AACCAATAGAATATACTCGC,0,1839898
hyuA_predicted,0.3333333333333333,2,2,AACACCCTCGCAGTTAATCG,0,1873673
hyuA_predicted,0.3333333333333333,2,2,AACAATATTGTGGGCCTTTA,0,1867886
hyuA_predicted,0.3333333333333333,2,2,AACAAATTGAAGGGTGACCT,0,1842538
hyuA_predicted,0.3333333333333333,2,2,AAATTCGTTAGGCTCGCAGG,0,1875132
hyuA_predicted,0.3333333333333333,2,2,AAATTCGATTTGAGACCTGT,0,1865281
hyuA_predicted,0.3333333333333333,2,2,AAATGTGTCTAACCCGGGAA,0,1871096
hyuA_predicted,0.3333333333333333,2,2,AAATGGTGATTATTTTCCCA,0,1860943
hyuA_predicted,0.3333333333333333,2,2,AAATGGGCTTCACGATATGA,0,1859867
hyuA_predicted,0.3333333333333333,2,2,AAATGCGTCGCTGTTACAAA,0,1876316
hyuA_predicted,0.3333333333333333,2,2,AAATAGTGAGGGTTCCGTCC,0,1842449
hyuA_predicted,0.3333333333333333,2,2,AAATAGTCATCTAGTTCGGT,0,1837854
hyuA_predicted,0.3333333333333333,2,2,AAAGTTTCCGCGAATGTCTA,0,1864785
hyuA_predicted,0.3333333333333333,2,2,AAAGCTATCGTTGGGACTCC,0,1854384
hyuA_predicted,0.3333333333333333,2,2,AAAGCCTACACGCTCAGTCG,0,1871540
hyuA_predicted,0.3333333333333333,2,2,AAACACGAACATTTAGTATG,0,1838216
hyuA_predicted,0.3333333333333333,2,2,AAAATCAGACGAGCCTTTTG,0,1860457
hyuA_predicted,0.3333333333333333,2,2,AAAAGGGCCAGGTAGTCGGT,0,1856688
hyuA_predicted,0.3333333333333333,2,2,AAAAGCTTCACACGTTAGCT,0,1830502
hyuA_predicted,0.3333333333333333,2,2,AAAACGCCTAGATTAGGGCA,0,1837670
hyuA_predicted,0.3333333333333333,2,2,AAAAAAGCTCGCGGCTATCA,0,1858846
hyuA_predicted,0.5,1,1,TTTTTCATTGAGCCCCCGCG,0,1863463
hyuA_predicted,0.5,1,1,TTTTGATGTAAGCCTAGCCC,0,1849422
hyuA_predicted,0.5,1,1,TTTTGAGGACTTCCACGCTG,0,1830107
hyuA_predicted,0.5,1,1,TTTTCTAGGAAGTTGGAATG,0,1844119
hyuA_predicted,0.5,1,1,TTTTCCTGATTTTAAAGGCT,0,1840174
hyuA_predicted,0.5,1,1,TTTTCCATTCCAAGAACCAC,0,1844987
hyuA_predicted,0.5,1,1,TTTTCAAAAGGGTACAGGGT,0,1873767
hyuA_predicted,0.5,1,1,TTTTATGCCATTTAATCAGT,0,1860228
hyuA_predicted,0.5,1,1,TTTGTTCAAATAGTGGCGCT,0,1830691
hyuA_predicted,0.5,1,1,TTTGTTACCATTCCCTTGGG,0,1863237
hyuA_predicted,0.5,1,1,TTTGTCACATTACTCGGTTA,0,1831126
hyuA_predicted,0.5,1,1,TTTGATCCGCACGGGGGTTC,0,1833143
hyuA_predicted,0.5,1,1,TTTGAGATAGGGCGTATTCG,0,1872295
hyuA_predicted,0.5,1,1,TTTGAAGCTTGTGACACCTG,0,1873236
hyuA_predicted,0.5,1,1,TTTCTGGAGGGCGGCTTGCG,0,1868159
hyuA_predicted,0.5,1,1,TTTCGTTGTGACGCACTGAG,0,1863242
hyuA_predicted,0.5,1,1,TTTCGGACGCGACTCCGCTG,0,1868484
hyuA_predicted,0.5,1,1,TTTCGCAATATCTGCGTTTG,0,1857287
hyuA_predicted,0.5,1,1,TTTCAGGGGCCAACCACAAC,0,1855487
hyuA_predicted,0.5,1,1,TTTCAAAGATCGTAAACTTA,0,1840170
hyuA_predicted,0.5,1,1,TTTATTTCTCGCTCCCACAA,0,1869871
hyuA_predicted,0.5,1,1,TTTATGACCCCAGTTGGGGG,0,1832353
hyuA_predicted,0.5,1,1,TTTAGGACCGAAGGTACTAT,0,1874060
hyuA_predicted,0.5,1,1,TTTAATGAACGGAATGCTAT,0,1839678
hyuA_predicted,0.5,1,1,TTTAAGCCCCGGGATTCCCT,0,1851620
hyuA_predicted,0.5,1,1,TTTAAGAGGAGTACCACGAG,0,1861677
hyuA_predicted,0.5,1,1,TTGTTGGACGCAAGGCCCGA,0,1875562
hyuA_predicted,0.5,1,1,TTGTTGCCTCGTGCTAGCGC,0,1839768
hyuA_predicted,0.5,1,1,TTGTTACTTTCTAATTCGCA,0,1862470
hyuA_predicted,0.5,1,1,TTGTGTAAAGCCCTGGGTGG,0,1852724
hyuA_predicted,0.5,1,1,TTGTGGCGATTGGTAAGACA,0,1844372
hyuA_predicted,0.5,1,1,TTGTGATGCTCTCGGGTGAA,0,1849229
hyuA_predicted,0.5,1,1,TTGTGAAAGCTCTTATCAGT,0,1828941
hyuA_predicted,0.5,1,1,TTGTCCCCAATCTCAAAGCT,0,1834024
hyuA_predicted,0.5,1,1,TTGTCCAATGCGCCCCTTCG,0,1854950
hyuA_predicted,0.5,1,1,TTGTCAGGGTAGACGGCGCT,0,1854336
hyuA_predicted,0.5,1,1,TTGTACCCCACCTAGCGCGA,0,1834272
hyuA_predicted,0.5,1,1,TTGGTAGATCATAAAGCATG,0,1849854
hyuA_predicted,0.5,1,1,TTGGCGTTACAAGAGGTCTC,0,1857371
hyuA_predicted,0.5,1,1,TTGCTTATTCCATCCCAAGT,0,1876898
hyuA_predicted,0.5,1,1,TTGCGGAAGTTTGTTACGTT,0,1843590
hyuA_predicted,0.5,1,1,TTGCGAGTCGTTGGTATTCG,0,1861622
hyuA_predicted,0.5,1,1,TTGCGACGGGGCTAGAAATA,0,1852332
hyuA_predicted,0.5,1,1,TTGCAGCGATGTACCTCTTG,0,1849689
hyuA_predicted,0.5,1,1,TTGATCGTGAGCACTATTCC,0,1854525
hyuA_predicted,0.5,1,1,TTGAGACATCGACGGTAGTT,0,1872449
hyuA_predicted,0.5,1,1,TTGACTGAAATTCACCAAGG,0,1872807
hyuA_predicted,0.5,1,1,TTGACGCGGGCGAAATACCA,0,1855309
hyuA_predicted,0.5,1,1,TTGAATCAACAGTTCGGGTG,0,1871742
hyuA_predicted,0.5,1,1,TTGAAGGGTAGTACTACGCA,0,1829600
hyuA_predicted,0.5,1,1,TTGAAGAGTCATAACGAGGT,0,1859105
hyuA_predicted,0.5,1,1,TTGAAAGCGGCTGACTACGC,0,1851475
hyuA_predicted,0.5,1,1,TTCTTTGATCAAATTATTTG,0,1876137
hyuA_predicted,0.5,1,1,TTCTTCCGCCTGACTACGTC,0,1871006
hyuA_predicted,0.5,1,1,TTCTTACTGGCGTCTATTAC,0,1874246
hyuA_predicted,0.5,1,1,TTCTGGTCGCATCTTGCCGA,0,1867081
hyuA_predicted,0.5,1,1,TTCTAGGGTCCAAGGCATGG,0,1868678
hyuA_predicted,0.5,1,1,TTCGTTCGCTCGGTCTCAAC,0,1852086
hyuA_predicted,0.5,1,1,TTCGTCAGTACATCTAGGTT,0,1839619
hyuA_predicted,0.5,1,1,TTCGTAGCGGCGTGGCACTT,0,1865906
hyuA_predicted,0.5,1,1,TTCGGCTGATTTTTGGCATT,0,1869908
hyuA_predicted,0.5,1,1,TTCGGCATCGATTCAAAAAG,0,1843399
hyuA_predicted,0.5,1,1,TTCGGCAGGGCAGACTACAC,0,1840266
hyuA_predicted,0.5,1,1,TTCCGTGTCTCGAACAACAG,0,1849682
hyuA_predicted,0.5,1,1,TTCCGGGACAGGCGACGGCA,0,1847435
hyuA_predicted,0.5,1,1,TTCCCGGACATTTTCGACGA,0,1842677
hyuA_predicted,0.5,1,1,TTCCCCGTGGCATTCTAGCG,0,1853291
hyuA_predicted,0.5,1,1,TTCCCCAGGGAGCTTATTAA,0,1847622
hyuA_predicted,0.5,1,1,TTCCAGACATATACGCGCAA,0,1863607
hyuA_predicted,0.5,1,1,TTCAGGTAGGAGATCACGTA,0,1875431
hyuA_predicted,0.5,1,1,TTCAGAATTCGCTACGGTGT,0,1855397
hyuA_predicted,0.5,1,1,TTATGCCTAATCGTTTAGCC,0,1843445
hyuA_predicted,0.5,1,1,TTATGATAGTGGGTTATCAC,0,1856923
hyuA_predicted,0.5,1,1,TTATCCATCCTGCGTTGGTC,0,1856679
hyuA_predicted,0.5,1,1,TTATATCTGGGATATGGCCC,0,1853788
hyuA_predicted,0.5,1,1,TTATACGGGGCTCCTCTACC,0,1830214
hyuA_predicted,0.5,1,1,TTAGTAGCCCAACTGCCTTT,0,1875648
hyuA_predicted,0.5,1,1,TTAGTACGTATCACGCGTAT,0,1843859
hyuA_predicted,0.5,1,1,TTAGGGACACGTACGTTCAA,0,1873553
hyuA_predicted,0.5,1,1,TTAGGAATGTGATGACGATT,0,1845834
hyuA_predicted,0.5,1,1,TTAGACTGAGTGCAGAGCGC,0,1846640
hyuA_predicted,0.5,1,1,TTAGACAGTAGTATTGCGGG,0,1848838
hyuA_predicted,0.5,1,1,TTAGAAACAGCCTATCTCGT,0,1837744
hyuA_predicted,0.5,1,1,TTACTTTCTATAAATGTTGT,0,1831932
hyuA_predicted,0.5,1,1,TTACGGAGCAAATTTTGTTG,0,1862521
hyuA_predicted,0.5,1,1,TTACCCAGGAGTTAAAGTTA,0,1854755
hyuA_predicted,0.5,1,1,TTAATTAATTGATGTTATCC,0,1864042
hyuA_predicted,0.5,1,1,TTAATGGCTAGACCATTTGG,0,1850236
hyuA_predicted,0.5,1,1,TTAATGAGGACCCCTCAACC,0,1870073
hyuA_predicted,0.5,1,1,TTAATCCCTTCACCGGTTCT,0,1845313
hyuA_predicted,0.5,1,1,TTAAGATACATGACCCTCAG,0,1838404
hyuA_predicted,0.5,1,1,TTAAATCGGGCCCTGAGATC,0,1864204
hyuA_predicted,0.5,1,1,TTAAACTAAAGGACCGGGTC,0,1873791
hyuA_predicted,0.5,1,1,TTAAACCCGATTTACAATAC,0,1871053
hyuA_predicted,0.5,1,1,TGTTTTCGCTTACTCAGTTT,0,1859026
hyuA_predicted,0.5,1,1,TGTTTATTGAGTTCCCGGCT,0,1843161
hyuA_predicted,0.5,1,1,TGTTTATCCCGGAGTAGTCT,0,1831908
hyuA_predicted,0.5,1,1,TGTTGTCGAAACCTTTGAAC,0,1863466
hyuA_predicted,0.5,1,1,TGTTGCACAGGGTCTATAGG,0,1875284
hyuA_predicted,0.5,1,1,TGTTCCAGCAACGGCACATA,0,1850648
hyuA_predicted,0.5,1,1,TGTTCATATTACGGGGGACG,0,1854613
hyuA_predicted,0.5,1,1,TGTTCACTGACGCAATACTC,0,1855659
hyuA_predicted,0.5,1,1,TGTGTTAGACCGGTAGGCCT,0,1843038
hyuA_predicted,0.5,1,1,TGTGGTGGGTGCTAAGGAGG,0,1861060
hyuA_predicted,0.5,1,1,TGTGGCAGTTAGCTCTTAGG,0,1872525
hyuA_predicted,0.5,1,1,TGTGGATTGATATTAGCCGT,0,1862283
hyuA_predicted,0.5,1,1,TGTGCAGGCAAGTGGAACCT,0,1860759
hyuA_predicted,0.5,1,1,TGTGATCACCATTCGGAAGT,0,1845365
hyuA_predicted,0.5,1,1,TGTGACAGTGCCATCGTTTA,0,1863076
hyuA_predicted,0.5,1,1,TGTGAAATAAAGTGAATACG,0,1832029
hyuA_predicted,0.5,1,1,TGTCTTTTGGCGAAAAAGGT,0,1871984
hyuA_predicted,0.5,1,1,TGTCGTCTGACCAGTTACGG,0,1839885
hyuA_predicted,0.5,1,1,TGTCCGTCCCCCAAAAATGT,0,1858044
hyuA_predicted,0.5,1,1,TGTATTAGATTTTGCTGGAA,0,1867667
hyuA_predicted,0.5,1,1,TGTATGTAGAGTGTAGGGGA,0,1829403
hyuA_predicted,0.5,1,1,TGTATAGGGTTTACTTAATT,0,1862703
hyuA_predicted,0.5,1,1,TGTATAAGTCGTCTAGGGAG,0,1843306
hyuA_predicted,0.5,1,1,TGTAGTACTCGTATGGATTT,0,1876331
hyuA_predicted,0.5,1,1,TGTAGGCCTTATGTGATGGA,0,1832912
hyuA_predicted,0.5,1,1,TGTAGATAGCATACTAGCTG,0,1866860
hyuA_predicted,0.5,1,1,TGTACGCACGTTGCTTTGTG,0,1874601
hyuA_predicted,0.5,1,1,TGTACATTGCCTCGCTACTC,0,1865553
hyuA_predicted,0.5,1,1,TGTACATGAAATGTAATAGT,0,1865272
hyuA_predicted,0.5,1,1,TGTACAATAATTGAGGAGAG,0,1874019
hyuA_predicted,0.5,1,1,TGTAAGTTGTTAATTCAGCA,0,1857135
hyuA_predicted,0.5,1,1,TGTAACAATAATGGCGATCT,0,1831510
hyuA_predicted,0.5,1,1,TGGTTGTCACGCCTTAAAAG,0,1834469
hyuA_predicted,0.5,1,1,TGGTTCAGCACATTGTTCAG,0,1834670
hyuA_predicted,0.5,1,1,TGGTGCATATGCTATGTGGT,0,1846175
hyuA_predicted,0.5,1,1,TGGTCGCTTGGGCTCAAGGC,0,1867195
hyuA_predicted,0.5,1,1,TGGTCCGGGAGAGTCAGGGT,0,1864697
hyuA_predicted,0.5,1,1,TGGTAGTCCAGGATCTCGCT,0,1831036
hyuA_predicted,0.5,1,1,TGGTAGTATCTGAGGGTCCC,0,1848396
hyuA_predicted,0.5,1,1,TGGTAGGGTCCGCCGTTAAT,0,1840425
hyuA_predicted,0.5,1,1,TGGGTCAACAGGTCGTTGGT,0,1855373
hyuA_predicted,0.5,1,1,TGGGGGGTAAGAGGCTCCCA,0,1863248
hyuA_predicted,0.5,1,1,TGGGGGGGCTTTAAGTATAG,0,1852224
hyuA_predicted,0.5,1,1,TGGGGGCGGTTGAATCGGCA,0,1851037
hyuA_predicted,0.5,1,1,TGGGGCGCAATTTAGGAGGT,0,1851408
hyuA_predicted,0.5,1,1,TGGGGATGGGCTGACTACGT,0,1867176
hyuA_predicted,0.5,1,1,TGGGGAAGACTGTACATTAC,0,1862834
hyuA_predicted,0.5,1,1,TGGGCGTCACCTCCCGTGAC,0,1830546
hyuA_predicted,0.5,1,1,TGGGCACCGACTCTCTAGGC,0,1851516
hyuA_predicted,0.5,1,1,TGGGATTGCATAGACACTGG,0,1844691
hyuA_predicted,0.5,1,1,TGGGAGCACTCGCCCTTCGT,0,1848259
hyuA_predicted,0.5,1,1,TGGGAGAGGCCAGAGCGGTA,0,1832268
hyuA_predicted,0.5,1,1,TGGCTTGGGGAAATGTGCTA,0,1847678
hyuA_predicted,0.5,1,1,TGGCGGCCATTTAGAGGACC,0,1870893
hyuA_predicted,0.5,1,1,TGGCGCTACCGGCAGCGTCA,0,1843229
hyuA_predicted,0.5,1,1,TGGCCGAGTTAAAGCCTCTA,0,1844013
hyuA_predicted,0.5,1,1,TGGCCAGCACGTTGTTGCGC,0,1840608
hyuA_predicted,0.5,1,1,TGGCATGCGGTAAAAGTCTC,0,1849308
hyuA_predicted,0.5,1,1,TGGATCTTGCCTAGCAAGCG,0,1870978
hyuA_predicted,0.5,1,1,TGGATCTTACCTTCTAAGTT,0,1839058
hyuA_predicted,0.5,1,1,TGGAGTTCAGGGCCGAGGCT,0,1835961
hyuA_predicted,0.5,1,1,TGGAGACTCCGGGCTGTCTC,0,1843988
hyuA_predicted,0.5,1,1,TGGAGAATTCGCTCGCAAGC,0,1839618
hyuA_predicted,0.5,1,1,TGGACACTTTCGGTTTGTGG,0,1833886
hyuA_predicted,0.5,1,1,TGGACAATGCGGTGCTAATT,0,1871875
hyuA_predicted,0.5,1,1,TGGAAGTTTGTTTTGTCTAG,0,1856133
hyuA_predicted,0.5,1,1,TGCTTGAAAACTCGTGGTGG,0,1832659
hyuA_predicted,0.5,1,1,TGCTTACGCCGATTATGTCA,0,1865651
hyuA_predicted,0.5,1,1,TGCTGTAGAGATTGGCTCTC,0,1860527
hyuA_predicted,0.5,1,1,TGCTGGACCTGTGGGAATAA,0,1838420
hyuA_predicted,0.5,1,1,TGCTGCGCCCCACTGCTAGA,0,1831939
hyuA_predicted,0.5,1,1,TGCTGCCGCGTCTTTGTGTT,0,1866926
hyuA_predicted,0.5,1,1,TGCTGACGTGATCAGCCTCT,0,1834706
hyuA_predicted,0.5,1,1,TGCTATAGCATGCGTCACAA,0,1840563
hyuA_predicted,0.5,1,1,TGCTAGCGGGGCGTACATCA,0,1863160
hyuA_predicted,0.5,1,1,TGCGTCTACTCTCCCGGGCT,0,1853604
hyuA_predicted,0.5,1,1,TGCGGTTACGCAACACATTC,0,1854996
hyuA_predicted,0.5,1,1,TGCGGCGCGAAGCTTGCTCA,0,1841473
hyuA_predicted,0.5,1,1,TGCGCGTTAGTAAGTCTCTG,0,1867034
hyuA_predicted,0.5,1,1,TGCGCAGCACTTTTTGCTGA,0,1857510
hyuA_predicted,0.5,1,1,TGCGCAGAGGGCCGGTTAAC,0,1859671
hyuA_predicted,0.5,1,1,TGCCTGGACGCCCCAGTATT,0,1829927
hyuA_predicted,0.5,1,1,TGCCGTCGAACAGCGGGTTG,0,1858901
hyuA_predicted,0.5,1,1,TGCCGCTGAGGCTTCTTTTC,0,1870755
hyuA_predicted,0.5,1,1,TGCCGCACGGGTGCCCGTTT,0,1874333
hyuA_predicted,0.5,1,1,TGCCGCAAAAAGGAGCTTCT,0,1835565
hyuA_predicted,0.5,1,1,TGCCGAACATCAAGCCGTTC,0,1831542
hyuA_predicted,0.5,1,1,TGCCCTTCTTCGTACTGCGT,0,1867177
hyuA_predicted,0.5,1,1,TGCCATTCTTGGCTCCCTAT,0,1877487
hyuA_predicted,0.5,1,1,TGCATTTACATGTTTCCCCG,0,1872399
hyuA_predicted,0.5,1,1,TGCATCAGGGGATCCGGCGG,0,1871740
hyuA_predicted,0.5,1,1,TGCAAACGACGAGCTCCGGG,0,1829280
hyuA_predicted,0.5,1,1,TGATGATAGTTAATGGAACC,0,1867472
hyuA_predicted,0.5,1,1,TGATGAGAGTGGAGAATACA,0,1859141
hyuA_predicted,0.5,1,1,TGATCTCTTCTTAAGCGCCA,0,1845711
hyuA_predicted,0.5,1,1,TGATCGTCTCGTGTGGGCAC,0,1839403
hyuA_predicted,0.5,1,1,TGATCAGCACGATGGTCGTT,0,1870785
hyuA_predicted,0.5,1,1,TGATAGTAGTCTAAGGTGGC,0,1841609
hyuA_predicted,0.5,1,1,TGATAAGGTGGGCGGAGGTC,0,1862271
hyuA_predicted,0.5,1,1,TGATAAACCGAAAGTGGTAG,0,1847581
hyuA_predicted,0.5,1,1,TGAGTGACCAACTCGAATAC,0,1836344
hyuA_predicted,0.5,1,1,TGAGTACGGGGCATATGTCA,0,1852131
hyuA_predicted,0.5,1,1,TGAGGTAAACCGTCTATAGG,0,1871937
hyuA_predicted,0.5,1,1,TGAGGCGTCAAGCTTTGATA,0,1842289
hyuA_predicted,0.5,1,1,TGAGCTGTATATGAACAAAT,0,1871745
hyuA_predicted,0.5,1,1,TGAGCGAAGCGCGAGTCCGC,0,1838371
hyuA_predicted,0.5,1,1,TGAGAGTAGCAGATTTCAGA,0,1864940
hyuA_predicted,0.5,1,1,TGAGAATCTGATGACGTGAA,0,1843097
hyuA_predicted,0.5,1,1,TGACTGTTTTGAAGTAGTGA,0,1843581
hyuA_predicted,0.5,1,1,TGACTGACTGCTTGCTAATG,0,1861978
hyuA_predicted,0.5,1,1,TGACTCACATCATTACGGGA,0,1861567
hyuA_predicted,0.5,1,1,TGACTACCGAGTTGCCAGTG,0,1833473
hyuA_predicted,0.5,1,1,TGACGGACTCTCTTCGTTCG,0,1846130
hyuA_predicted,0.5,1,1,TGACCTAGAGTCGAGCGCGC,0,1835658
hyuA_predicted,0.5,1,1,TGACCACGGCAGGCTGCTAG,0,1838645
hyuA_predicted,0.5,1,1,TGACACATGCTCCCGTCTTT,0,1856433
hyuA_predicted,0.5,1,1,TGACAATTTAATCTACCTTT,0,1857407
hyuA_predicted,0.5,1,1,TGACAACAGCCCCGTGGAAT,0,1854299
hyuA_predicted,0.5,1,1,TGAATTTATGTACTCATTCG,0,1852720
hyuA_predicted,0.5,1,1,TGAAGTCTGCCTTTGGTAGT,0,1844526
hyuA_predicted,0.5,1,1,TGAACAATCCTGGACAGTGC,0,1877110
hyuA_predicted,0.5,1,1,TGAAACAAACAGTTATAGTC,0,1867255
hyuA_predicted,0.5,1,1,TCTTTAGCGACAGACGGTCG,0,1858053
hyuA_predicted,0.5,1,1,TCTTGGTTGTGGGGCACTAC,0,1859616
hyuA_predicted,0.5,1,1,TCTTGGTCGTTTTAAGGAAA,0,1858346
hyuA_predicted,0.5,1,1,TCTTCTTAGCAAAAGCAGCA,0,1831452
hyuA_predicted,0.5,1,1,TCTTATGACCACATTCTCGG,0,1863936
hyuA_predicted,0.5,1,1,TCTTAATCGAACTTGATTGG,0,1869212
hyuA_predicted,0.5,1,1,TCTTAAACGGGGGGGACCGG,0,1855144
hyuA_predicted,0.5,1,1,TCTGTTCTAGCTGAATAGCG,0,1864889
hyuA_predicted,0.5,1,1,TCTGGCTGCGATATCGCCTG,0,1833790
hyuA_predicted,0.5,1,1,TCTGGCATCAGATCGAATCA,0,1832871
hyuA_predicted,0.5,1,1,TCTGCGTTACAGTACGTACT,0,1842534
hyuA_predicted,0.5,1,1,TCTGCAGAAAGGTAGTGCTG,0,1832886
hyuA_predicted,0.5,1,1,TCTCTCGTCGTACGTACGGA,0,1871503
hyuA_predicted,0.5,1,1,TCTCTAACCTGTTTATGGGT,0,1837881
hyuA_predicted,0.5,1,1,TCTCGTACTAGGTGAGATAA,0,1871092
hyuA_predicted,0.5,1,1,TCTCGCGCTGCGCAACTTTG,0,1835754
hyuA_predicted,0.5,1,1,TCTCCCTAGAATCTTTATAC,0,1854142
hyuA_predicted,0.5,1,1,TCTCATTTAGGCCCTTGCTG,0,1843090
hyuA_predicted,0.5,1,1,TCTCAGGTCCTGGCCCTTGT,0,1860367
hyuA_predicted,0.5,1,1,TCTAGTTCCTGGTTAAACGC,0,1851962
hyuA_predicted,0.5,1,1,TCTACACCTAGCAATTCAGA,0,1858850
hyuA_predicted,0.5,1,1,TCTAAGAGAACGCTGTTGTT,0,1865357
hyuA_predicted,0.5,1,1,TCGTTGTCACCATAATACTA,0,1877609
hyuA_predicted,0.5,1,1,TCGTGTGTGCGAAGTAGGGA,0,1864852
hyuA_predicted,0.5,1,1,TCGTGGTTATGTATCTGTGG,0,1845028
hyuA_predicted,0.5,1,1,TCGTCTGTCCTTTGTATTGC,0,1875819
hyuA_predicted,0.5,1,1,TCGTCGCGATAGGCGCTTAT,0,1841595
hyuA_predicted,0.5,1,1,TCGTCCGAGAACACACGGTA,0,1847286
hyuA_predicted,0.5,1,1,TCGTCAGGGGTTGTCATGTA,0,1839748
hyuA_predicted,0.5,1,1,TCGTATGCTAGAACCAGTTT,0,1855762
hyuA_predicted,0.5,1,1,TCGTACGTTCGCCGCGAGCT,0,1853245
hyuA_predicted,0.5,1,1,TCGTACGACATATTTTATTA,0,1848335
hyuA_predicted,0.5,1,1,TCGTACCATCAACTTCGTAA,0,1853238
hyuA_predicted,0.5,1,1,TCGGGGAGTATTACCTACAT,0,1865120
hyuA_predicted,0.5,1,1,TCGGGAACAGGCGTCCTCCC,0,1867861
hyuA_predicted,0.5,1,1,TCGGCTTTTAGGATTAAGAC,0,1869282
hyuA_predicted,0.5,1,1,TCGGCTCTTATTTTAGGAAT,0,1868899
hyuA_predicted,0.5,1,1,TCGGCCCCAGCACGTCAGTT,0,1844091
hyuA_predicted,0.5,1,1,TCGGAGTATGATCTTGAGGT,0,1854399
hyuA_predicted,0.5,1,1,TCGGAGATTCTGTGTGCAGG,0,1860383
hyuA_predicted,0.5,1,1,TCGGAATTGGCGACACGCAT,0,1846613
hyuA_predicted,0.5,1,1,TCGGAATTGACTTTCACGTT,0,1866828
hyuA_predicted,0.5,1,1,TCGCTGTGTGTGGGCTAGGG,0,1871405
hyuA_predicted,0.5,1,1,TCGCTCAGGCGGCCCATTGG,0,1875515
hyuA_predicted,0.5,1,1,TCGCGTGATCAATTCCCTGA,0,1869026
hyuA_predicted,0.5,1,1,TCGCCGCGGGACGCCACGCT,0,1854514
hyuA_predicted,0.5,1,1,TCGCCACCGATCCCGGCATC,0,1848466
hyuA_predicted,0.5,1,1,TCGCAGAGGAATACTGACAA,0,1868769
hyuA_predicted,0.5,1,1,TCGATCGACCAGGGCTGACG,0,1831351
hyuA_predicted,0.5,1,1,TCGAGCGATCCGCCTGCAGA,0,1870783
hyuA_predicted,0.5,1,1,TCGACTCGTTGAATCCATAT,0,1861773
hyuA_predicted,0.5,1,1,TCGACTCGTATAGCCTCCCG,0,1848631
hyuA_predicted,0.5,1,1,TCGACTATCATATTGCCGGA,0,1876366
hyuA_predicted,0.5,1,1,TCGACTAGACTAATAGGGTT,0,1866869
hyuA_predicted,0.5,1,1,TCGACCTGATTTTCTAATTC,0,1835793
hyuA_predicted,0.5,1,1,TCGAAGCGGTGTCCGGTCGT,0,1862237
hyuA_predicted,0.5,1,1,TCCTTCGTTAACAAAATCTT,0,1863347
hyuA_predicted,0.5,1,1,TCCTTACAATCTCGAAAACG,0,1831587
hyuA_predicted,0.5,1,1,TCCTGTTAAATTCATCTTTG,0,1842851
hyuA_predicted,0.5,1,1,TCCTCGTCCCCGTATGCTCG,0,1836047
hyuA_predicted,0.5,1,1,TCCTCGGGGATAGAGCTCTC,0,1848219
hyuA_predicted,0.5,1,1,TCCTACCCGGGTGAATAGGT,0,1877471
hyuA_predicted,0.5,1,1,TCCGGTACTCCATTTGGCGT,0,1836924
hyuA_predicted,0.5,1,1,TCCGGGCTCTGGTACACCGC,0,1844730
hyuA_predicted,0.5,1,1,TCCGGCTTTCCTCGGTTCTG,0,1857868
hyuA_predicted,0.5,1,1,TCCGCTCATATAAGAGTGCT,0,1850751
hyuA_predicted,0.5,1,1,TCCGCATTGCCGCTTAGTTG,0,1877567
hyuA_predicted,0.5,1,1,TCCGAAAGATTCTAGCCTGC,0,1864380
hyuA_predicted,0.5,1,1,TCCCTCATAGATTTGCCATT,0,1856494
hyuA_predicted,0.5,1,1,TCCCGAGTGATGAACCCGCC,0,1877457
hyuA_predicted,0.5,1,1,TCCCCGGAAAACGTGCGGCG,0,1845277
hyuA_predicted,0.5,1,1,TCCCCCCCATCGGCGTATCT,0,1858427
hyuA_predicted,0.5,1,1,TCCATGTCTTCATCATAGCA,0,1860005
hyuA_predicted,0.5,1,1,TCCAGCCTTCGGAGCAGTTG,0,1869457
hyuA_predicted,0.5,1,1,TCCAGCAGGAGGGCATCATC,0,1857680
hyuA_predicted,0.5,1,1,TCCACGTGTACATGCCGGAC,0,1854483
hyuA_predicted,0.5,1,1,TCCACCTGGAAGACGTGTAT,0,1850382
hyuA_predicted,0.5,1,1,TCCACCCCAAATTCGACTTA,0,1839460
hyuA_predicted,0.5,1,1,TCCAATCCAGGAGTTGGCAA,0,1831090
hyuA_predicted,0.5,1,1,TCCAAGGGTTCTAATCGGTT,0,1858804
hyuA_predicted,0.5,1,1,TCCAAAGGTCACGGCATGGC,0,1858351
hyuA_predicted,0.5,1,1,TCATTGGGGACCAATAGGTT,0,1832704
hyuA_predicted,0.5,1,1,TCATTGCACCGTTACAACAC,0,1866924
hyuA_predicted,0.5,1,1,TCATTAGACGAGCAGTCGGC,0,1865732
hyuA_predicted,0.5,1,1,TCAGTGTGGCCCAGGAGTCC,0,1870857
hyuA_predicted,0.5,1,1,TCAGTCAAATGTCTCACTTA,0,1874812
hyuA_predicted,0.5,1,1,TCAGTACACGGGTAGTGGCT,0,1850859
hyuA_predicted,0.5,1,1,TCAGGTTCCCATGGCTGTAA,0,1854758
hyuA_predicted,0.5,1,1,TCAGGGGGCCGTCGTAAAGC,0,1875007
hyuA_predicted,0.5,1,1,TCAGGCATTGAGCCGTCACA,0,1830068
hyuA_predicted,0.5,1,1,TCAGGAGGATTAGTCTTCCG,0,1851993
hyuA_predicted,0.5,1,1,TCAGCCCAGCATGAGCACCA,0,1831767
hyuA_predicted,0.5,1,1,TCAGAGGACCACCATTTTTT,0,1854323
hyuA_predicted,0.5,1,1,TCAGAATTGTATCCCCTCAT,0,1862382
hyuA_predicted,0.5,1,1,TCACTGAAAGTGTGATGCTG,0,1852429
hyuA_predicted,0.5,1,1,TCACTCTTATCAGGGGGTTC,0,1840752
hyuA_predicted,0.5,1,1,TCACTCCCGGACTCCTAGGC,0,1871883
hyuA_predicted,0.5,1,1,TCACGAATTGTGGTGAGTCT,0,1854645
hyuA_predicted,0.5,1,1,TCACCTCTAACGGACTGTGG,0,1849927
hyuA_predicted,0.5,1,1,TCACCGGCATATCGGGAGAA,0,1865654
hyuA_predicted,0.5,1,1,TCACCGCTTATAAACTTCAT,0,1841336
hyuA_predicted,0.5,1,1,TCACCACACCAGACCGGCTC,0,1872611
hyuA_predicted,0.5,1,1,TCACAGCACGCTTTGGTCAT,0,1832797
hyuA_predicted,0.5,1,1,TCACAACATGACACCCACAT,0,1865619
hyuA_predicted,0.5,1,1,TCAATTCAGAGCTGTGGTGA,0,1877658
hyuA_predicted,0.5,1,1,TCAACTATACTAGGTAACTC,0,1866984
hyuA_predicted,0.5,1,1,TCAACCGACTTCTTCTTACC,0,1831070
hyuA_predicted,0.5,1,1,TCAACAAATGCATCGTCTGG,0,1838336
hyuA_predicted,0.5,1,1,TCAAAGCCGGTTAGTTTGAG,0,1832021
hyuA_predicted,0.5,1,1,TCAAAGATTCGTATAAAGTG,0,1837922
hyuA_predicted,0.5,1,1,TCAAAACCCAAATTCTTATG,0,1866233
hyuA_predicted,0.5,1,1,TATTTTTGCCCAGGTTCCGG,0,1868368
hyuA_predicted,0.5,1,1,TATTCGGGTCAAAATCAAGT,0,1855256
hyuA_predicted,0.5,1,1,TATTCATACGGGACAGAGTG,0,1857518
hyuA_predicted,0.5,1,1,TATTCAGAAGGCCTCCTGCC,0,1831379
hyuA_predicted,0.5,1,1,TATTATACAATAGTGCCCTG,0,1856291
hyuA_predicted,0.5,1,1,TATGTACTGAAGGCGGGCAG,0,1863515
hyuA_predicted,0.5,1,1,TATGTACGTGGACAGCCTGT,0,1854577
hyuA_predicted,0.5,1,1,TATGGGCTGGTGCACCCCCC,0,1854251
hyuA_predicted,0.5,1,1,TATGCGCTAGAGTGAATAAA,0,1842805
hyuA_predicted,0.5,1,1,TATGCCCTGAGCCTATCAAG,0,1871035
hyuA_predicted,0.5,1,1,TATGATTAACCGATCGCAGA,0,1843002
hyuA_predicted,0.5,1,1,TATCTTGGTACCTTGGCGTC,0,1839689
hyuA_predicted,0.5,1,1,TATCTCCGGACTACTGAGTC,0,1866881
hyuA_predicted,0.5,1,1,TATCGGGCAACCGTACCCTC,0,1853896
hyuA_predicted,0.5,1,1,TATCGCTGGTACGCGGGTCA,0,1865640
hyuA_predicted,0.5,1,1,TATCGCCTCGTGTAGAGAGT,0,1877530
hyuA_predicted,0.5,1,1,TATCGCCAGCTGCGTACAGC,0,1830051
hyuA_predicted,0.5,1,1,TATCCTATGGGACTGCCAGT,0,1865681
hyuA_predicted,0.5,1,1,TATCATGGTTTCGCCGGTTT,0,1873324
hyuA_predicted,0.5,1,1,TATCAGACACTTCGATTCTG,0,1865513
hyuA_predicted,0.5,1,1,TATATGGACTGCCCAGTCGC,0,1856699
hyuA_predicted,0.5,1,1,TATATATGTCTACCAACTAG,0,1860246
hyuA_predicted,0.5,1,1,TATAGGGCGGCACGTGATTC,0,1843315
hyuA_predicted,0.5,1,1,TATAGAACTGGCCGCGGGGG,0,1865059
hyuA_predicted,0.5,1,1,TATACTTATCCGCGTGTCTA,0,1842061
hyuA_predicted,0.5,1,1,TATACTCCATAATTAAATCG,0,1867109
hyuA_predicted,0.5,1,1,TATAAATCGACCGCTGTATT,0,1832880
hyuA_predicted,0.5,1,1,TAGGTTAAGCGGACATACAG,0,1854375
hyuA_predicted,0.5,1,1,TAGGTCGATGGGTGTGTAGT,0,1832976
hyuA_predicted,0.5,1,1,TAGGAAGTGACTCGCGTTAC,0,1853802
hyuA_predicted,0.5,1,1,TAGCGGCAAAGCAATTAGCC,0,1877169
hyuA_predicted,0.5,1,1,TAGCCAACACATACGTCAAT,0,1844038
hyuA_predicted,0.5,1,1,TAGCATGAGATCCTGCGCCG,0,1854018
hyuA_predicted,0.5,1,1,TAGCACACACAAGGCAGGTG,0,1841436
hyuA_predicted,0.5,1,1,TAGATTAAAGCGAGCAGGCT,0,1841437
hyuA_predicted,0.5,1,1,TAGACCAGCAAATCGTCGAG,0,1872953
hyuA_predicted,0.5,1,1,TAGAATGGCTTTGTCACTCA,0,1845521
hyuA_predicted,0.5,1,1,TAGAAGGTATGTCAGCATAA,0,1846568
hyuA_predicted,0.5,1,1,TACTTCACAGTTTAAGCGTT,0,1844130
hyuA_predicted,0.5,1,1,TACTGCTCAGGAGATTCGGA,0,1871431
hyuA_predicted,0.5,1,1,TACGTGTGCCACACAGAGTA,0,1858105
hyuA_predicted,0.5,1,1,TACGGGGCGAGCTTGGTCTC,0,1867239
hyuA_predicted,0.5,1,1,TACGGACACGGCCCGCCGAA,0,1866786
hyuA_predicted,0.5,1,1,TACCTGGTACCGATTGTGTT,0,1854335
hyuA_predicted,0.5,1,1,TACCATGAGGTCCGATACTA,0,1841410
hyuA_predicted,0.5,1,1,TACATGCAACAGTCCAAATC,0,1875307
hyuA_predicted,0.5,1,1,TACATAATAATTACCGGCGA,0,1837308
hyuA_predicted,0.5,1,1,TACAGGGCAGAGCACCAACG,0,1863058
hyuA_predicted,0.5,1,1,TACACTAAACCCGAATTGAG,0,1854070
hyuA_predicted,0.5,1,1,TAATTCTGATTATCACCTTT,0,1876873
hyuA_predicted,0.5,1,1,TAATTCGCGGGGCTCACAGC,0,1862033
hyuA_predicted,0.5,1,1,TAATGTGAAACAGTGTGGCT,0,1869222
hyuA_predicted,0.5,1,1,TAATGTCCCTCCCGTATCAC,0,1877512
hyuA_predicted,0.5,1,1,TAATGATTAACATTGTCCGA,0,1830775
hyuA_predicted,0.5,1,1,TAATATTCCCAATAAACTAA,0,1834445
hyuA_predicted,0.5,1,1,TAATATAGAAATTATAGTGC,0,1861015
hyuA_predicted,0.5,1,1,TAATAAATGTCCTGCCCTTC,0,1855833
hyuA_predicted,0.5,1,1,TAAGTTTAAGAACTACATCT,0,1865340
hyuA_predicted,0.5,1,1,TAAGTCACTCAAGACGCGAG,0,1847295
hyuA_predicted,0.5,1,1,TAAGGAACGTTATTTATGTA,0,1858796
hyuA_predicted,0.5,1,1,TAAGCTCGAAAAACACTTAA,0,1872106
hyuA_predicted,0.5,1,1,TAAGCAGATGAGCCAGCATT,0,1852626
hyuA_predicted,0.5,1,1,TAAGATGACGCCCCCGTACG,0,1861102
hyuA_predicted,0.5,1,1,TAAGATCTCGGGCTACGGTT,0,1877230
hyuA_predicted,0.5,1,1,TAAGAGTAGTCTCTCCTAGC,0,1855090
hyuA_predicted,0.5,1,1,TAAGACCCGGCATTATCTGA,0,1840826
hyuA_predicted,0.5,1,1,TAAGAAGGTGCATTGCCTTG,0,1835125
hyuA_predicted,0.5,1,1,TAACCGGTGTTCTCTGGTGG,0,1863880
hyuA_predicted,0.5,1,1,TAACCAAGAGACTAGATCAC,0,1867585
hyuA_predicted,0.5,1,1,TAACCAAAGCGGAATTTAAT,0,1835687
hyuA_predicted,0.5,1,1,TAACATCCAACGGACGTACA,0,1829725
hyuA_predicted,0.5,1,1,TAAATCCGGGTACTTTGTTG,0,1864673
hyuA_predicted,0.5,1,1,TAAACTGAACATGTATGAGT,0,1837069
hyuA_predicted,0.5,1,1,TAAAAGGGAAGGATGCGTTC,0,1877860
hyuA_predicted,0.5,1,1,GTTTTTGTAAGCGGAGAATG,0,1855664
hyuA_predicted,0.5,1,1,GTTTTGATCATTCTGGCTCT,0,1852521
hyuA_predicted,0.5,1,1,GTTTTCGCAGCGGATCAAGA,0,1830980
hyuA_predicted,0.5,1,1,GTTTGTTTTATGCTTTTGGA,0,1848158
hyuA_predicted,0.5,1,1,GTTTGGTTCTGGCTAACCTC,0,1846838
hyuA_predicted,0.5,1,1,GTTTAATTGAGAGGGGCGAG,0,1873048
hyuA_predicted,0.5,1,1,GTTTAAGGCGACATAGGGTA,0,1848954
hyuA_predicted,0.5,1,1,GTTGGGACTGACACGACTCG,0,1845883
hyuA_predicted,0.5,1,1,GTTGCTATATAAGGAAGGTA,0,1853042
hyuA_predicted,0.5,1,1,GTTGCAAATCATAAGATCAC,0,1865499
hyuA_predicted,0.5,1,1,GTTGATGAGACAAAGGTGCT,0,1842018
hyuA_predicted,0.5,1,1,GTTCTTGTCTGTACAGACTA,0,1834751
hyuA_predicted,0.5,1,1,GTTCGTTTGAACTCGCTGAT,0,1872689
hyuA_predicted,0.5,1,1,GTTCGGGTCAAGGTGCGTAG,0,1828850
hyuA_predicted,0.5,1,1,GTTCGAGCTGTTATTAAACT,0,1843913
hyuA_predicted,0.5,1,1,GTTCGAAGTACAACTGATCC,0,1853571
hyuA_predicted,0.5,1,1,GTTCCTCGCCTTGTCCGGCA,0,1877253
hyuA_predicted,0.5,1,1,GTTCCGGGTAGTATCGTACA,0,1844567
hyuA_predicted,0.5,1,1,GTTCCGGGACTCACGTACTG,0,1847501
hyuA_predicted,0.5,1,1,GTTCCGAATACCTTATAGGC,0,1848134
hyuA_predicted,0.5,1,1,GTTCATTGGGGCGCTTGCTT,0,1870422
hyuA_predicted,0.5,1,1,GTTCAATCATTCTAACTGTT,0,1832957
hyuA_predicted,0.5,1,1,GTTCAACCTTGGAGCTTCTT,0,1847230
hyuA_predicted,0.5,1,1,GTTCAAAACACCGGCAGGAG,0,1851095
hyuA_predicted,0.5,1,1,GTTATTCACGTTGCCTAACG,0,1877063
hyuA_predicted,0.5,1,1,GTTATCATCCTGGGCACGTC,0,1858482
hyuA_predicted,0.5,1,1,GTTATCATAGCAAAGGAAGA,0,1855466
hyuA_predicted,0.5,1,1,GTTATAGGGGATCGGGCAGC,0,1851005
hyuA_predicted,0.5,1,1,GTTATACAAGATGAGTAGGA,0,1872047
hyuA_predicted,0.5,1,1,GTTAGTTTATCGAGGTCTCG,0,1875886
hyuA_predicted,0.5,1,1,GTTAGAGACCGACATATCAT,0,1854260
hyuA_predicted,0.5,1,1,GTTAGACTGACTGGTAATCT,0,1836235
hyuA_predicted,0.5,1,1,GTTACCATAGGTCGTGTGCT,0,1834733
hyuA_predicted,0.5,1,1,GTTACAGCATAGAACACTTA,0,1868184
hyuA_predicted,0.5,1,1,GTTAAGAGTCCTTAGAGCGT,0,1845956
hyuA_predicted,0.5,1,1,GTGTTGCCCCTATAGTAGGC,0,1854199
hyuA_predicted,0.5,1,1,GTGTTCGCTCAGTGGACACG,0,1872765
hyuA_predicted,0.5,1,1,GTGTTCAAAGACCGAATAGC,0,1849760
hyuA_predicted,0.5,1,1,GTGTCTGTGCCGTGTAGTTA,0,1871272
hyuA_predicted,0.5,1,1,GTGTCTCTCCTGATGGCCCG,0,1846255
hyuA_predicted,0.5,1,1,GTGTCATCACGCGGTACCGT,0,1873989
hyuA_predicted,0.5,1,1,GTGTATAAGAGGCAGCGAAA,0,1829893
hyuA_predicted,0.5,1,1,GTGTACGCCCATTCAATCAA,0,1853409
hyuA_predicted,0.5,1,1,GTGTAAATCCCGATAAGTCT,0,1852511
hyuA_predicted,0.5,1,1,GTGGTGGCAAAGAGAATGCT,0,1867461
hyuA_predicted,0.5,1,1,GTGGTCAGCTGCTGCTTGTT,0,1837555
hyuA_predicted,0.5,1,1,GTGGTCAGATAGCGAATCAA,0,1865368
hyuA_predicted,0.5,1,1,GTGGGTGTGAGGTAGAATAA,0,1832994
hyuA_predicted,0.5,1,1,GTGGGTCGGGCAATGTCGGT,0,1831896
hyuA_predicted,0.5,1,1,GTGGGTAATCTAAGGAGCAT,0,1831425
hyuA_predicted,0.5,1,1,GTGGGGCTCACATCCCGACG,0,1864845
hyuA_predicted,0.5,1,1,GTGGGCCGTCTAACGCTTCA,0,1835358
hyuA_predicted,0.5,1,1,GTGGGAAGCGATTCCGTGTG,0,1840602
hyuA_predicted,0.5,1,1,GTGGCGATACTCTTCTACCA,0,1861793
hyuA_predicted,0.5,1,1,GTGGCGAGTGGGGACTGGGT,0,1871664
hyuA_predicted,0.5,1,1,GTGGACCCTGTTACGCCGGA,0,1836809
hyuA_predicted,0.5,1,1,GTGCTCCTCATTCAAAAACT,0,1833512
hyuA_predicted,0.5,1,1,GTGCGTGTGGCATATAGATA,0,1841736
hyuA_predicted,0.5,1,1,GTGCGGGCCGCATGAGTAGC,0,1830587
hyuA_predicted,0.5,1,1,GTGCGGCCACCGTTGGATAG,0,1865207
hyuA_predicted,0.5,1,1,GTGCCCGCAGTGCTACTAGG,0,1831091
hyuA_predicted,0.5,1,1,GTGCACTCTACGTGCCTCAG,0,1850062
hyuA_predicted,0.5,1,1,GTGCACGGCAGCCGAGACAT,0,1861150
hyuA_predicted,0.5,1,1,GTGCAATGTTGGCACGCAAT,0,1836008
hyuA_predicted,0.5,1,1,GTGATTCTCATGTGTAACGC,0,1829882
hyuA_predicted,0.5,1,1,GTGAGTGGTATCCGGCCATT,0,1841792
hyuA_predicted,0.5,1,1,GTGAAAACGGCTAAATACTC,0,1856220
hyuA_predicted,0.5,1,1,GTCTTTGTGCGTCTTAGTCG,0,1856841
hyuA_predicted,0.5,1,1,GTCTTCGGGGTCATGAGTGG,0,1868080
hyuA_predicted,0.5,1,1,GTCGTGGTCCATGTTTCGGC,0,1846533
hyuA_predicted,0.5,1,1,GTCGTCGTTTCAGTATCACT,0,1833119
hyuA_predicted,0.5,1,1,GTCGGTGTACCTACTGCTCC,0,1848513
hyuA_predicted,0.5,1,1,GTCGGGGCTGACCAACCCGA,0,1871791
hyuA_predicted,0.5,1,1,GTCGGGCCAAAATCATATGG,0,1869073
hyuA_predicted,0.5,1,1,GTCGCTCTTAGAGTACCTTC,0,1838124
hyuA_predicted,0.5,1,1,GTCGCCCGAGCAGCGTTCGC,0,1870163
hyuA_predicted,0.5,1,1,GTCGCCATCGTGCCGGTACT,0,1862892
hyuA_predicted,0.5,1,1,GTCGATCAGCAGATAGGACA,0,1852802
hyuA_predicted,0.5,1,1,GTCGAGAACACGTAGGGCCG,0,1860329
hyuA_predicted,0.5,1,1,GTCGAACCCAAACACGTCAT,0,1846991
hyuA_predicted,0.5,1,1,GTCCTTGAATCGCAAAATAT,0,1841119
hyuA_predicted,0.5,1,1,GTCCTTCATAAGGGATGTAA,0,1865575
hyuA_predicted,0.5,1,1,GTCCGGCTATTAGTCCTCCT,0,1832700
hyuA_predicted,0.5,1,1,GTCCGCCGCGTGCGCCTGCT,0,1834595
hyuA_predicted,0.5,1,1,GTCCGAGGTTGGCAGTAATA,0,1846602
hyuA_predicted,0.5,1,1,GTCCACTAAATCAATGATCC,0,1861700
hyuA_predicted,0.5,1,1,GTCCACGGAGGCTCATTCTC,0,1873285
hyuA_predicted,0.5,1,1,GTCCAAGAGGGCTAGCGTAT,0,1873500
hyuA_predicted,0.5,1,1,GTCCAACTTCGTACTAGGGC,0,1859656
hyuA_predicted,0.5,1,1,GTCATTAAAGCTATTGGACA,0,1851301
hyuA_predicted,0.5,1,1,GTCATAGGCGTACCCCAAAT,0,1852818
hyuA_predicted,0.5,1,1,GTCAGAAACTGTGCGTTAGT,0,1858656
hyuA_predicted,0.5,1,1,GTCACGATTCAAACGCATGT,0,1869152
hyuA_predicted,0.5,1,1,GTCACAGGACGTTGAATTGA,0,1847835
hyuA_predicted,0.5,1,1,GTATTTGTGTCCTCTACACC,0,1852621
hyuA_predicted,0.5,1,1,GTATTCTTCTAGCGCTCGCG,0,1863608
hyuA_predicted,0.5,1,1,GTATCGGTACAGTCGTGCCC,0,1861901
hyuA_predicted,0.5,1,1,GTATCGACCCTGCAAAGTGA,0,1877698
hyuA_predicted,0.5,1,1,GTATCCTTACGAAAGGGTCA,0,1834222
hyuA_predicted,0.5,1,1,GTATCATCTGTTCAGCATGT,0,1870733
hyuA_predicted,0.5,1,1,GTATATGACCGTCTTCTAGT,0,1836258
hyuA_predicted,0.5,1,1,GTATATCTTAACCACGGGTG,0,1849042
hyuA_predicted,0.5,1,1,GTATATCGCGCCTTGTGTCT,0,1855167
hyuA_predicted,0.5,1,1,GTAGTGGGTCATGCGGGGGG,0,1877605
hyuA_predicted,0.5,1,1,GTAGTAGTTTAGCAAAAATC,0,1849145
hyuA_predicted,0.5,1,1,GTAGGAGAAACATATCTGTA,0,1875439
hyuA_predicted,0.5,1,1,GTAGCGGCAGGGATTTTGAG,0,1874369
hyuA_predicted,0.5,1,1,GTAGCACTCGGGTGGCCGGT,0,1852206
hyuA_predicted,0.5,1,1,GTAGACGCCTATACTCACTA,0,1835353
hyuA_predicted,0.5,1,1,GTAGAACGGAGTTGAATTTG,0,1845539
hyuA_predicted,0.5,1,1,GTACTGGCAGCTTCATGGGG,0,1833176
hyuA_predicted,0.5,1,1,GTACGATGCTGGCAGCTGCC,0,1877809
hyuA_predicted,0.5,1,1,GTACCTTTCTTTCAGGTAAA,0,1862354
hyuA_predicted,0.5,1,1,GTACCTAACTATTTGGTCAT,0,1855168
hyuA_predicted,0.5,1,1,GTACAGAACTGAGCCTTTAC,0,1845846
hyuA_predicted,0.5,1,1,GTAATCACGAAGGCAAAGAT,0,1833430
hyuA_predicted,0.5,1,1,GTAAGTCACGCGGCGCATGA,0,1837444
hyuA_predicted,0.5,1,1,GTAAATCTGTAATTAAGTGG,0,1875278
hyuA_predicted,0.5,1,1,GGTTGTGGCAATTTAACCTA,0,1856468
hyuA_predicted,0.5,1,1,GGTTGTCAAACGACTGGTGT,0,1865154
hyuA_predicted,0.5,1,1,GGTTGCCTTCTACTCCCTCA,0,1838927
hyuA_predicted,0.5,1,1,GGTTGAAGGGTTGCATATTT,0,1846801
hyuA_predicted,0.5,1,1,GGTTCCCACAAGACAGTCAA,0,1851967
hyuA_predicted,0.5,1,1,GGTGTCTAGACCTGGTGAGG,0,1872684
hyuA_predicted,0.5,1,1,GGTGTACACTTAGGCCTTTA,0,1865250
hyuA_predicted,0.5,1,1,GGTGGGTGAGACCAAGAATC,0,1840906
hyuA_predicted,0.5,1,1,GGTGGGACAGCCAGGCAGCC,0,1861447
hyuA_predicted,0.5,1,1,GGTGGCCTAGGTTCTTTTGA,0,1861234
hyuA_predicted,0.5,1,1,GGTGCTTCGCGCGGAAGGAC,0,1854242
hyuA_predicted,0.5,1,1,GGTGCCATGACGCGAACTGA,0,1874658
hyuA_predicted,0.5,1,1,GGTGCAGGGCTTGGGCGAGG,0,1839279
hyuA_predicted,0.5,1,1,GGTGAGCCTAAGACAAGTGC,0,1865808
hyuA_predicted,0.5,1,1,GGTGACAAACTTTTTTATTG,0,1852878
hyuA_predicted,0.5,1,1,GGTCTTAGAGACACAGCTTA,0,1857245
hyuA_predicted,0.5,1,1,GGTCTCACACGGTTTTCCCC,0,1861678
hyuA_predicted,0.5,1,1,GGTCGAACATGGCACCGTAA,0,1829848
hyuA_predicted,0.5,1,1,GGTCCCTAGCCCGGACATAA,0,1843795
hyuA_predicted,0.5,1,1,GGTCCAGAGCTTTAGTGCAA,0,1829241
hyuA_predicted,0.5,1,1,GGTCAGGAAATGGAATCGTA,0,1869353
hyuA_predicted,0.5,1,1,GGTCACGTCAAGGCTAAGAA,0,1859511
hyuA_predicted,0.5,1,1,GGTCAAATCCTTGGCGATAC,0,1871285
hyuA_predicted,0.5,1,1,GGTATATACATCCATAGGGA,0,1871117
hyuA_predicted,0.5,1,1,GGTATAATGGAGATCTTGAT,0,1863736
hyuA_predicted,0.5,1,1,GGTAGAGCAGAGTTCGGGAA,0,1863614
hyuA_predicted,0.5,1,1,GGTACTGAACTACCCGCTAA,0,1863885
hyuA_predicted,0.5,1,1,GGTACCCACTACGCGGTGCA,0,1854074
hyuA_predicted,0.5,1,1,GGTACAGGCCATAAGATTTG,0,1838525
hyuA_predicted,0.5,1,1,GGTAATCATGCTGCCACAGC,0,1844138
hyuA_predicted,0.5,1,1,GGTAAGGAATGAGAACCACC,0,1854502
hyuA_predicted,0.5,1,1,GGTAAGCTCAGGTCCCGGGT,0,1864150
hyuA_predicted,0.5,1,1,GGGTTTCATATGTAGACCGC,0,1832410
hyuA_predicted,0.5,1,1,GGGTTGAGCAATGTTAATGT,0,1839282
hyuA_predicted,0.5,1,1,GGGTTCGAAGGTCTGATTTA,0,1848586
hyuA_predicted,0.5,1,1,GGGTGGGTACTTTCATCTTC,0,1829965
hyuA_predicted,0.5,1,1,GGGTGATCCGTTGAGTATGA,0,1872942
hyuA_predicted,0.5,1,1,GGGTGAACCTTCGATAGAAC,0,1847728
hyuA_predicted,0.5,1,1,GGGTCTAAGATCCTCCAGTG,0,1834325
hyuA_predicted,0.5,1,1,GGGTCGTCAAAGTCTAACAG,0,1870143
hyuA_predicted,0.5,1,1,GGGTCAGCTTCTACTTCTTG,0,1869875
hyuA_predicted,0.5,1,1,GGGTAGAAAGAGCGGAACGG,0,1859946
hyuA_predicted,0.5,1,1,GGGTACCCGGTCTGGCTGTG,0,1850954
hyuA_predicted,0.5,1,1,GGGGTGGGTGTAGCCACATG,0,1851860
hyuA_predicted,0.5,1,1,GGGGTGATTGCGATACCCTT,0,1850520
hyuA_predicted,0.5,1,1,GGGGCGCAGTCAGCTCTCAG,0,1864873
hyuA_predicted,0.5,1,1,GGGGCCTGTTTGTCCGTAAC,0,1872358
hyuA_predicted,0.5,1,1,GGGGCCGTCCTGAAGCTTCC,0,1849388
hyuA_predicted,0.5,1,1,GGGGCCACTAAGTGTTTCGA,0,1850827
hyuA_predicted,0.5,1,1,GGGCTAGGCGCGGACCCTGG,0,1843078
hyuA_predicted,0.5,1,1,GGGCGGCCCCGATGCTAATC,0,1836604
hyuA_predicted,0.5,1,1,GGGCGGACAGGTTTTGCGCG,0,1872990
hyuA_predicted,0.5,1,1,GGGCGCATTTTGCTACTGAC,0,1848018
hyuA_predicted,0.5,1,1,GGGCATACTTTAATTCCTGT,0,1842387
hyuA_predicted,0.5,1,1,GGGCAGTGTATACGGAATCA,0,1862137
hyuA_predicted,0.5,1,1,GGGATCCGGCCATATACCAC,0,1875176
hyuA_predicted,0.5,1,1,GGGAGTTCTAGTTGACACGT,0,1835148
hyuA_predicted,0.5,1,1,GGGAGCCGGTCCGCCTACCT,0,1853925
hyuA_predicted,0.5,1,1,GGGAGCACACACAATACAAA,0,1840381
hyuA_predicted,0.5,1,1,GGGACGTTCACATGTCCAGA,0,1870610
hyuA_predicted,0.5,1,1,GGGACGGGAGTCCGAAAGTC,0,1838678
hyuA_predicted,0.5,1,1,GGCTTTTCCTGCGACCCGGC,0,1856889
hyuA_predicted,0.5,1,1,GGCTTTAAAGATCTGGTAGA,0,1847414
hyuA_predicted,0.5,1,1,GGCTTCGGCAGTTGACTCCT,0,1851970
hyuA_predicted,0.5,1,1,GGCTTCACCCTGATACAGTA,0,1829379
hyuA_predicted,0.5,1,1,GGCTTACTGAAGCGCGCATC,0,1844687
hyuA_predicted,0.5,1,1,GGCTGTGGAGTCTTACGACG,0,1865135
hyuA_predicted,0.5,1,1,GGCTGGCGTGCATGAGGACT,0,1862833
hyuA_predicted,0.5,1,1,GGCTGCTAGACATTGTATCT,0,1834439
hyuA_predicted,0.5,1,1,GGCTCGGATCATATGCTGGC,0,1856725
hyuA_predicted,0.5,1,1,GGCTCGAGCACCTAAGTTTG,0,1831059
hyuA_predicted,0.5,1,1,GGCTAGCAATGGAATCGGCG,0,1836246
hyuA_predicted,0.5,1,1,GGCTACCGCTCGTGCCGCAA,0,1863427
hyuA_predicted,0.5,1,1,GGCTAACATGAATTCGAGCA,0,1867465
hyuA_predicted,0.5,1,1,GGCGGTCTGCGCTATGTATG,0,1864053
hyuA_predicted,0.5,1,1,GGCGCTGAGGTAAAATAGGC,0,1874634
hyuA_predicted,0.5,1,1,GGCGCGCCGATACCATTTTG,0,1843925
hyuA_predicted,0.5,1,1,GGCGACGCGCTGTGCTTCTA,0,1843934
hyuA_predicted,0.5,1,1,GGCCGCTCGGTGCGAGGTCT,0,1836687
hyuA_predicted,0.5,1,1,GGCCGCTCAGCAACTGAGCT,0,1856575
hyuA_predicted,0.5,1,1,GGCCCTTTGCCTCAATTCAA,0,1863200
hyuA_predicted,0.5,1,1,GGCCATCGTGCTCGCAGGAA,0,1876968
hyuA_predicted,0.5,1,1,GGCCATCGCGGAGATATAAG,0,1845275
hyuA_predicted,0.5,1,1,GGCCACACGCTATCCGCGTA,0,1852008
hyuA_predicted,0.5,1,1,GGCAGCTTTACAGGGCTTAG,0,1851150
hyuA_predicted,0.5,1,1,GGCAGCACCATTCACCGGAC,0,1860237
hyuA_predicted,0.5,1,1,GGCACGACTCTGCAAATTAC,0,1848330
hyuA_predicted,0.5,1,1,GGCACAGATTACTCGATGTG,0,1860707
hyuA_predicted,0.5,1,1,GGCAACTATGTTCTTAGCTT,0,1865518
hyuA_predicted,0.5,1,1,GGCAACGCATATTTAGACCG,0,1844819
hyuA_predicted,0.5,1,1,GGCAAAAATATTCAAATAAC,0,1840341
hyuA_predicted,0.5,1,1,GGATGATCACTGGTGAATGT,0,1840905
hyuA_predicted,0.5,1,1,GGATCCTCGAAGATCCGGTA,0,1860215
hyuA_predicted,0.5,1,1,GGATATTGGAAAGAATAAAT,0,1870342
hyuA_predicted,0.5,1,1,GGATATGGCGGTAAGGAACT,0,1853731
hyuA_predicted,0.5,1,1,GGATATCGAATACACATGTA,0,1835994
hyuA_predicted,0.5,1,1,GGATATCCCGGACGTGCATC,0,1876512
hyuA_predicted,0.5,1,1,GGATAATATTTTTGATGTTA,0,1858215
hyuA_predicted,0.5,1,1,GGAGTTTCGGACCAAATCAA,0,1829467
hyuA_predicted,0.5,1,1,GGAGCTTCCGGTAATCTAAA,0,1876594
hyuA_predicted,0.5,1,1,GGAGCCAAGACGGAGAAGGT,0,1859992
hyuA_predicted,0.5,1,1,GGAGAGTGGATAACATCAAC,0,1839581
hyuA_predicted,0.5,1,1,GGAGAAGCTTCTGCTTGCCA,0,1830909
hyuA_predicted,0.5,1,1,GGACTGGTCTTCTTGCAGCG,0,1850929
hyuA_predicted,0.5,1,1,GGACTGCTTCTAGGAAAATG,0,1875656
hyuA_predicted,0.5,1,1,GGACCTGGGGAGTGACGGAC,0,1872509
hyuA_predicted,0.5,1,1,GGACCTCATAGTAATTGTTG,0,1839892
hyuA_predicted,0.5,1,1,GGACCTAATGTATGTGTTTT,0,1831935
hyuA_predicted,0.5,1,1,GGACATACTGACAGGACTCA,0,1868506
hyuA_predicted,0.5,1,1,GGACACTAGCCTGGATTCAG,0,1872457
hyuA_predicted,0.5,1,1,GGAATTTCTGAGCTTCTCAA,0,1842577
hyuA_predicted,0.5,1,1,GGAATGATAAACGACGCACT,0,1865264
hyuA_predicted,0.5,1,1,GGAAGAACGGGGTGGACATC,0,1856956
hyuA_predicted,0.5,1,1,GGAACGTTGGCACCTAAACG,0,1843547
hyuA_predicted,0.5,1,1,GGAAATGCCATATAGCAAAT,0,1859423
hyuA_predicted,0.5,1,1,GGAAAGGCTTTAGGTGCATG,0,1842314
hyuA_predicted,0.5,1,1,GGAAAGACGCGGAAGCCCCT,0,1854011
hyuA_predicted,0.5,1,1,GCTTTACGAGCTCTCTTCAT,0,1872783
hyuA_predicted,0.5,1,1,GCTTGTGCCTTTAGTTCGGA,0,1856029
hyuA_predicted,0.5,1,1,GCTTCTGTTGACGGAAAAGG,0,1875951
hyuA_predicted,0.5,1,1,GCTTCTGTGTAAGGGACGGC,0,1839542
hyuA_predicted,0.5,1,1,GCTTCGGGAAAATTGCGGTA,0,1843337
hyuA_predicted,0.5,1,1,GCTGTTAGCACGTCCAGCGT,0,1836348
hyuA_predicted,0.5,1,1,GCTGTCGCTTTAGACTCTCA,0,1867378
hyuA_predicted,0.5,1,1,GCTGGACGGGTTGGCAAATT,0,1863725
hyuA_predicted,0.5,1,1,GCTGCCTACTAAGGTGAAAT,0,1864886
hyuA_predicted,0.5,1,1,GCTGCCGACCGCGTAGAAAA,0,1830647
hyuA_predicted,0.5,1,1,GCTCTGTTCTAGATGCCAGA,0,1831476
hyuA_predicted,0.5,1,1,GCTCGACTGAAACCGTAAGC,0,1852339
hyuA_predicted,0.5,1,1,GCTCCTCTACACCTAGAACG,0,1866409
hyuA_predicted,0.5,1,1,GCTCCAGTTTTTTCGATGAA,0,1871212
hyuA_predicted,0.5,1,1,GCTAGGGGTGGTAGCTATAT,0,1861609
hyuA_predicted,0.5,1,1,GCTAGGGCGCACTAAGGCAT,0,1853043
hyuA_predicted,0.5,1,1,GCTACCCAGACCTGGCCTTA,0,1857322
hyuA_predicted,0.5,1,1,GCTAAGGAATGTTGCAAATC,0,1830730
hyuA_predicted,0.5,1,1,GCGTTAATCCTCCGTCCAAA,0,1874599
hyuA_predicted,0.5,1,1,GCGTGCTTTTAACTCCGCTA,0,1840817
hyuA_predicted,0.5,1,1,GCGTGCTCAAGTGAACGGTC,0,1866565
hyuA_predicted,0.5,1,1,GCGTCGGACTTTACTCCCGA,0,1859135
hyuA_predicted,0.5,1,1,GCGTAACATGAGGGTCACGC,0,1875222
hyuA_predicted,0.5,1,1,GCGGTTAAGATGCCTGTGTC,0,1835936
hyuA_predicted,0.5,1,1,GCGGTGACAGAGACTGATCG,0,1832453
hyuA_predicted,0.5,1,1,GCGGTCTCGATCAGCTAATT,0,1873840
hyuA_predicted,0.5,1,1,GCGGTCAACAGCCAGAAGAC,0,1837885
hyuA_predicted,0.5,1,1,GCGGTATTGGTATAACAATG,0,1840078
hyuA_predicted,0.5,1,1,GCGGTAAGACAACTACCCCC,0,1875363
hyuA_predicted,0.5,1,1,GCGGGCAGGCATGCCCCCGA,0,1867068
hyuA_predicted,0.5,1,1,GCGGCCGCAATCGGAATCCT,0,1873868
hyuA_predicted,0.5,1,1,GCGGCATTCTTTTTCTTAGT,0,1830575
hyuA_predicted,0.5,1,1,GCGGCATCGCGATAGGGAAG,0,1846890
hyuA_predicted,0.5,1,1,GCGCTGTTTTGTCAAGAGCA,0,1835352
hyuA_predicted,0.5,1,1,GCGCTGTTGGGTGCTCGTAA,0,1842409
hyuA_predicted,0.5,1,1,GCGCGTCCGAAAGCTCCTCT,0,1875490
hyuA_predicted,0.5,1,1,GCGAGGTCCCTTTAGATAAT,0,1873763
hyuA_predicted,0.5,1,1,GCGACTATTCTGGAGCTGTG,0,1868727
hyuA_predicted,0.5,1,1,GCGACGGATGAGTTATGGTA,0,1833657
hyuA_predicted,0.5,1,1,GCGAAGGAATTAGTTGCAGA,0,1841305
hyuA_predicted,0.5,1,1,GCCTTCGATTAGAAACTCAA,0,1833191
hyuA_predicted,0.5,1,1,GCCTGTTCTGAATGGTAGAA,0,1869055
hyuA_predicted,0.5,1,1,GCCTGTCCCAAGACAGTCAC,0,1872490
hyuA_predicted,0.5,1,1,GCCTGGCTGATATAGGGCAA,0,1867312
hyuA_predicted,0.5,1,1,GCCTCCGTTGCGAAACATGA,0,1854585
hyuA_predicted,0.5,1,1,GCCTACTAAACTGGCGCAAC,0,1861315
hyuA_predicted,0.5,1,1,GCCGTGTCTCGGAACACAGC,0,1866922
hyuA_predicted,0.5,1,1,GCCGGGTATTGACCTTTCGG,0,1834290
hyuA_predicted,0.5,1,1,GCCGCCCTGGGAGCAAGTAC,0,1844348
hyuA_predicted,0.5,1,1,GCCGCCACACACACAACTCT,0,1847877
hyuA_predicted,0.5,1,1,GCCGATGGCCCGAAGGGCTG,0,1858827
hyuA_predicted,0.5,1,1,GCCCTCGGGGTGGTATGCCA,0,1859171
hyuA_predicted,0.5,1,1,GCCCGTGATTGCTCGCAAAC,0,1833652
hyuA_predicted,0.5,1,1,GCCCGAACGAAGAGACGCCT,0,1852809
hyuA_predicted,0.5,1,1,GCCCCCTGCGGATGATCAAG,0,1846315
hyuA_predicted,0.5,1,1,GCCCCACAGTCCTGAGGGAT,0,1859471
hyuA_predicted,0.5,1,1,GCCCAGGCAGTCTGCGGAGC,0,1839355
hyuA_predicted,0.5,1,1,GCCATTCTGCAGTTCGCGGC,0,1849941
hyuA_predicted,0.5,1,1,GCCAGCGTGTCGATATGCAG,0,1853539
hyuA_predicted,0.5,1,1,GCCACGTGTCCGGTCCGTGC,0,1844517
hyuA_predicted,0.5,1,1,GCCACGTGGACGGACTTACG,0,1841812
hyuA_predicted,0.5,1,1,GCCACGTCCGAGTGTAACGA,0,1832228
hyuA_predicted,0.5,1,1,GCCAATGATCCGTGGCAACC,0,1841398
hyuA_predicted,0.5,1,1,GCATTGAGCACACCGTCTGA,0,1865173
hyuA_predicted,0.5,1,1,GCATGTGGGTGTGTAAGTTC,0,1833487
hyuA_predicted,0.5,1,1,GCATGGTGCCACGGCAGAGA,0,1875154
hyuA_predicted,0.5,1,1,GCATCCAGGGCGTTCGGACT,0,1847789
hyuA_predicted,0.5,1,1,GCATCAGAATTGTGTTGACT,0,1862432
hyuA_predicted,0.5,1,1,GCATAATCTTGAGGAATGGC,0,1869383
hyuA_predicted,0.5,1,1,GCATAAATGTGGGTTTCATA,0,1828859
hyuA_predicted,0.5,1,1,GCATAAAAGTTACCATTCTC,0,1875320
hyuA_predicted,0.5,1,1,GCAGTGCAGATCGGACTTCA,0,1859287
hyuA_predicted,0.5,1,1,GCAGTATAGTCGATAAGAAT,0,1832658
hyuA_predicted,0.5,1,1,GCAGCGTCGTTCGTAAATTT,0,1841777
hyuA_predicted,0.5,1,1,GCAGAGAAGTATTGCGGTTT,0,1852094
hyuA_predicted,0.5,1,1,GCACGGCTCTGGGCCTAAGG,0,1860214
hyuA_predicted,0.5,1,1,GCACCTGGGTGTCTACGATA,0,1832742
hyuA_predicted,0.5,1,1,GCACCCGGCTCTCAGGTAGT,0,1874856
hyuA_predicted,0.5,1,1,GCACCATGTCTTGTTGTCAA,0,1871078
hyuA_predicted,0.5,1,1,GCAATGCCATGTGTGGCGCG,0,1840047
hyuA_predicted,0.5,1,1,GCAAGGCTGCTCAGCCGACT,0,1844953
hyuA_predicted,0.5,1,1,GCAAGCCCGTCTAAACACAA,0,1865035
hyuA_predicted,0.5,1,1,GCAACCTTCAGGTAACGGAC,0,1848127
hyuA_predicted,0.5,1,1,GATTTTTTACTATTATAGAA,0,1848168
hyuA_predicted,0.5,1,1,GATTTTAAGGTACCGGAGTC,0,1873945
hyuA_predicted,0.5,1,1,GATTTGAGCCACGTAACCGC,0,1877555
hyuA_predicted,0.5,1,1,GATTTATTTCGGCATTCAGC,0,1854014
hyuA_predicted,0.5,1,1,GATTGCTACGCAAGCGTATA,0,1831142
hyuA_predicted,0.5,1,1,GATTGCGTGATCTTCCGCTC,0,1853621
hyuA_predicted,0.5,1,1,GATTCTTGACTGATGGGTTT,0,1855460
hyuA_predicted,0.5,1,1,GATTCTTCGGCGAATTGATT,0,1868734
hyuA_predicted,0.5,1,1,GATTCGAGATTCACTAGATA,0,1829769
hyuA_predicted,0.5,1,1,GATTCCGAGGTAATCTCGTT,0,1873482
hyuA_predicted,0.5,1,1,GATTCCCGACCAGGCGTCCG,0,1876702
hyuA_predicted,0.5,1,1,GATTCAGATTCCTCGCCGGA,0,1837905
hyuA_predicted,0.5,1,1,GATTATAGGTCTCTGTCTAG,0,1849991
hyuA_predicted,0.5,1,1,GATGGCGGCGGCACCGACAC,0,1839852
hyuA_predicted,0.5,1,1,GATGGACATTATTCAACTGA,0,1839461
hyuA_predicted,0.5,1,1,GATGCACCCGATCCACAGAC,0,1856331
hyuA_predicted,0.5,1,1,GATCTTCAGGAAAATACATT,0,1842768
hyuA_predicted,0.5,1,1,GATCTCCTCAGCTCTGGACA,0,1829413
hyuA_predicted,0.5,1,1,GATCGTGGGTTGGACACGAC,0,1864163
hyuA_predicted,0.5,1,1,GATCGGGCCTCAAATATATT,0,1848169
hyuA_predicted,0.5,1,1,GATCCGCAGGGCTTGCGCAA,0,1859665
hyuA_predicted,0.5,1,1,GATCCCCTGGGACGTACCGA,0,1863656
hyuA_predicted,0.5,1,1,GATCCCATTATCCGCTGCGG,0,1857774
hyuA_predicted,0.5,1,1,GATCAGGCTTCGCCCCATAT,0,1875537
hyuA_predicted,0.5,1,1,GATCAGCGCCGGTAAAAGTG,0,1847774
hyuA_predicted,0.5,1,1,GATCAAGGAGTGCAAGGCCT,0,1848644
hyuA_predicted,0.5,1,1,GATAGTGGGGATTCGCTCTG,0,1875565
hyuA_predicted,0.5,1,1,GATAGTATGGTTTCGTTCTG,0,1876937
hyuA_predicted,0.5,1,1,GATAGGCGATCTCAAGGTGA,0,1831845
hyuA_predicted,0.5,1,1,GATACGAGTCCACTAAGCGA,0,1865122
hyuA_predicted,0.5,1,1,GATACATTCTTGCGATTAGC,0,1835940
hyuA_predicted,0.5,1,1,GATAACTTGGCTGAAGGTTA,0,1872210
hyuA_predicted,0.5,1,1,GATAAAGTTTAATACAAAGC,0,1863056
hyuA_predicted,0.5,1,1,GATAAACTTCAATTGGAGGC,0,1850482
hyuA_predicted,0.5,1,1,GAGTGGCGTAGGCCCAAAGT,0,1831547
hyuA_predicted,0.5,1,1,GAGTGCTTGTGTAGTTTCAG,0,1841120
hyuA_predicted,0.5,1,1,GAGTCTAGCGGTTTCGGGTC,0,1833593
hyuA_predicted,0.5,1,1,GAGTATCTTGGGGGTTTAAA,0,1839404
hyuA_predicted,0.5,1,1,GAGTAGGCGGAGGTCGAAAC,0,1849327
hyuA_predicted,0.5,1,1,GAGTAGAGCGTTTAGCGATG,0,1859246
hyuA_predicted,0.5,1,1,GAGTACAATATCGAAACCTT,0,1872606
hyuA_predicted,0.5,1,1,GAGGTGCCGGTGCTTCGTTG,0,1850176
hyuA_predicted,0.5,1,1,GAGGTAACAGAAGCCTGAAG,0,1864688
hyuA_predicted,0.5,1,1,GAGGGTTAATTCCGTTAACC,0,1871895
hyuA_predicted,0.5,1,1,GAGGGGGAACGGACAGGGGG,0,1842849
hyuA_predicted,0.5,1,1,GAGGGGCGGTGGCACGTAAA,0,1837544
hyuA_predicted,0.5,1,1,GAGGGGCGCCTCAAGCTCAG,0,1847452
hyuA_predicted,0.5,1,1,GAGGGCCGGGAGCAGCCGGA,0,1853794
hyuA_predicted,0.5,1,1,GAGGCTCCATTCCTTTAACG,0,1873637
hyuA_predicted,0.5,1,1,GAGGATCACAGCATACAAGC,0,1838983
hyuA_predicted,0.5,1,1,GAGGAACCGGAGTCGTAAAA,0,1860285
hyuA_predicted,0.5,1,1,GAGGAACAACGAAGTAAAGA,0,1848472
hyuA_predicted,0.5,1,1,GAGGAAAGGTAGAACTATTG,0,1856412
hyuA_predicted,0.5,1,1,GAGCCCGGTCGTTCGGAAAT,0,1862714
hyuA_predicted,0.5,1,1,GAGCCACCATAGCTGGTCCA,0,1873580
hyuA_predicted,0.5,1,1,GAGCATGTGTCGTCAGTCAA,0,1851596
hyuA_predicted,0.5,1,1,GAGATTTATTCAGAGGTAAT,0,1877083
hyuA_predicted,0.5,1,1,GAGATATATACGCGGAAGGG,0,1836925
hyuA_predicted,0.5,1,1,GAGATACGCAAGAGCCGACC,0,1845661
hyuA_predicted,0.5,1,1,GAGAGGGATACCCGGTGTGC,0,1863763
hyuA_predicted,0.5,1,1,GAGACCGAACCCAGAGGTTA,0,1876005
hyuA_predicted,0.5,1,1,GAGAAGTCGATCTCTCCAGC,0,1835684
hyuA_predicted,0.5,1,1,GACTGGTCAGGCAGAGCTCC,0,1866684
hyuA_predicted,0.5,1,1,GACTCGTCTAGCGGATACTT,0,1842464
hyuA_predicted,0.5,1,1,GACTAATATAAGATCACCCA,0,1834996
hyuA_predicted,0.5,1,1,GACGTGAGTAATAGAGCTAT,0,1832311
hyuA_predicted,0.5,1,1,GACGTAACTGACCCCTGCTG,0,1836866
hyuA_predicted,0.5,1,1,GACGCCTCGCGCCGGAGGAA,0,1873107
hyuA_predicted,0.5,1,1,GACGCCGTCGGCCGGATAGC,0,1860434
hyuA_predicted,0.5,1,1,GACGCCCGGGGACTCCCAGG,0,1834067
hyuA_predicted,0.5,1,1,GACGCACTGCGGACTAGATG,0,1864756
hyuA_predicted,0.5,1,1,GACGAGCGTCGGCCGGAGTT,0,1865204
hyuA_predicted,0.5,1,1,GACGAAAATGAGGGCATTCC,0,1869103
hyuA_predicted,0.5,1,1,GACCGGTTATGGGCTCCAGG,0,1870427
hyuA_predicted,0.5,1,1,GACCGGTCGTAAAAAAAAGC,0,1831909
hyuA_predicted,0.5,1,1,GACCCTAAATTTGCCTTCGC,0,1846527
hyuA_predicted,0.5,1,1,GACCCCCTTATCCCTCACCG,0,1831760
hyuA_predicted,0.5,1,1,GACCCAGGCACTGCAAACGC,0,1863366
hyuA_predicted,0.5,1,1,GACCATTATTGGCATTCTGA,0,1838169
hyuA_predicted,0.5,1,1,GACCAGAGCCTTACGTATCA,0,1850376
hyuA_predicted,0.5,1,1,GACATTGCGGCACAGGGCAA,0,1831970
hyuA_predicted,0.5,1,1,GACATAGTGCCGGCCTCCCA,0,1836656
hyuA_predicted,0.5,1,1,GACATAGTCAAGATTACGGG,0,1859767
hyuA_predicted,0.5,1,1,GACAGTCATACATCTTTTCA,0,1850008
hyuA_predicted,0.5,1,1,GACAGCTCATGCCGGGCCAT,0,1841074
hyuA_predicted,0.5,1,1,GACACGTGATGTCTTGAAGC,0,1845071
hyuA_predicted,0.5,1,1,GACACGTCCGAAATGTATAA,0,1831963
hyuA_predicted,0.5,1,1,GACACGGGCCTGTCGTAGGA,0,1829597
hyuA_predicted,0.5,1,1,GACACGAAGCAGACACCACG,0,1858172
hyuA_predicted,0.5,1,1,GACAATTCGTTCATTTCGTC,0,1842951
hyuA_predicted,0.5,1,1,GACAATGCTTTGCTACCGGT,0,1854690
hyuA_predicted,0.5,1,1,GACAACCGCGTAGAACGAGC,0,1830709
hyuA_predicted,0.5,1,1,GAATTTAGTCGCATGTTACG,0,1839779
hyuA_predicted,0.5,1,1,GAATTGCTGATACTAGGATT,0,1836254
hyuA_predicted,0.5,1,1,GAATTCCAGGGTTGGAGAAG,0,1848844
hyuA_predicted,0.5,1,1,GAATTATTTCCTCACCTTAA,0,1846025
hyuA_predicted,0.5,1,1,GAATGCCGGTACACTACGGA,0,1873781
hyuA_predicted,0.5,1,1,GAATCAGTAACGTGAACGGC,0,1838457
hyuA_predicted,0.5,1,1,GAATACGAGGCACGGTTCAA,0,1836993
hyuA_predicted,0.5,1,1,GAAGTGGTTCATTCGCGCTG,0,1836159
hyuA_predicted,0.5,1,1,GAAGCGTGTCCCTCTGAGGT,0,1876058
hyuA_predicted,0.5,1,1,GAAGAGCAGTAGACCCACGG,0,1858975
hyuA_predicted,0.5,1,1,GAACTTGAAGATCCGCAAAC,0,1843687
hyuA_predicted,0.5,1,1,GAACTGATTGCGGCTGCTAG,0,1848401
hyuA_predicted,0.5,1,1,GAACTCCTAAATGTGAGCGA,0,1842921
hyuA_predicted,0.5,1,1,GAACCTTACACCCGTCAAAT,0,1856334
hyuA_predicted,0.5,1,1,GAACCTAATCTGCAGACGAT,0,1831355
hyuA_predicted,0.5,1,1,GAACCGCTATTGAGCCATTC,0,1832761
hyuA_predicted,0.5,1,1,GAAATTGGTCTTGTGTAAAG,0,1863931
hyuA_predicted,0.5,1,1,GAAATCATAGTTCTCCCTCA,0,1856028
hyuA_predicted,0.5,1,1,GAAAGCATGGCACTGGCCGC,0,1857666
hyuA_predicted,0.5,1,1,CTTTTCAACGTATCGAAGGA,0,1848278
hyuA_predicted,0.5,1,1,CTTTGTCGTCCCAACTATAA,0,1841428
hyuA_predicted,0.5,1,1,CTTTGGTACGAGTTCACCCA,0,1864665
hyuA_predicted,0.5,1,1,CTTTGGACTCATTATATCGG,0,1848321
hyuA_predicted,0.5,1,1,CTTTGATCCCATTCGCCAAG,0,1877261
hyuA_predicted,0.5,1,1,CTTTCGTGCAAGACGACTTG,0,1837812
hyuA_predicted,0.5,1,1,CTTTCAGGCGGTCCGAAGAG,0,1865942
hyuA_predicted,0.5,1,1,CTTTATAAACGGAGCTGCTT,0,1849317
hyuA_predicted,0.5,1,1,CTTTAGCCAATGTGATGGAA,0,1854449
hyuA_predicted,0.5,1,1,CTTTACATACTTCATTTTGT,0,1877153
hyuA_predicted,0.5,1,1,CTTGTATCCCAGGGCTCCAC,0,1829147
hyuA_predicted,0.5,1,1,CTTGGTCTTCACCTGGAAGA,0,1837863
hyuA_predicted,0.5,1,1,CTTGCGCAGAATCGTGCCCC,0,1855864
hyuA_predicted,0.5,1,1,CTTGCCGGACTTCAGGGTAT,0,1864770
hyuA_predicted,0.5,1,1,CTTGCCGCAATTTGTTCCGT,0,1844226
hyuA_predicted,0.5,1,1,CTTGCCCCTGAGGCCGCAAC,0,1835228
hyuA_predicted,0.5,1,1,CTTGAAATCTGAGCACCACT,0,1862312
hyuA_predicted,0.5,1,1,CTTCTTTTTAGCTAATGTAT,0,1850369
hyuA_predicted,0.5,1,1,CTTCTTGAAAAGGCTTAGCC,0,1857343
hyuA_predicted,0.5,1,1,CTTCTCTCTCGGCACGCAAC,0,1849286
hyuA_predicted,0.5,1,1,CTTCTCTAACCTGGGTCCAT,0,1850599
hyuA_predicted,0.5,1,1,CTTCTCAGATCCTCCACATT,0,1865293
hyuA_predicted,0.5,1,1,CTTCGTTAGTATGAGTCCAT,0,1873635
hyuA_predicted,0.5,1,1,CTTCGTCCAATCGCCGGTAA,0,1859420
hyuA_predicted,0.5,1,1,CTTCGAATGTGCGGAATATC,0,1867722
hyuA_predicted,0.5,1,1,CTTCCGACGGCTATGTCCAT,0,1874617
hyuA_predicted,0.5,1,1,CTTCCCCTGCCTAATAATGG,0,1829266
hyuA_predicted,0.5,1,1,CTTCCAAAATCGGACCGTGT,0,1845850
hyuA_predicted,0.5,1,1,CTTCAGGTGAATTTGCCCCT,0,1874844
hyuA_predicted,0.5,1,1,CTTAGAAGAGCAACGTGGGT,0,1863845
hyuA_predicted,0.5,1,1,CTTACTTCTGTGACGCACTG,0,1876694
hyuA_predicted,0.5,1,1,CTTACGTGATATATTTTTTG,0,1864153
hyuA_predicted,0.5,1,1,CTTACGGAGACACGATCTCA,0,1865921
hyuA_predicted,0.5,1,1,CTTACACGCCCATCTGCATA,0,1877767
hyuA_predicted,0.5,1,1,CTTAATTCGGCAGCTAGGCT,0,1832248
hyuA_predicted,0.5,1,1,CTTAAGTACCGCGGTTTCTT,0,1858544
hyuA_predicted,0.5,1,1,CTGTTTGAGACGTATGAGAT,0,1843586
hyuA_predicted,0.5,1,1,CTGTTGGGTCAATCCTAGCG,0,1867252
hyuA_predicted,0.5,1,1,CTGTTGGGACCAATACTAGC,0,1829364
hyuA_predicted,0.5,1,1,CTGTTACGCAAGCAACAGGT,0,1832959
hyuA_predicted,0.5,1,1,CTGTCAGGCATTCCTCGGGT,0,1872103
hyuA_predicted,0.5,1,1,CTGTAGAAGTTGGTCCCCGG,0,1871498
hyuA_predicted,0.5,1,1,CTGTACTATCGAGGTCTAAC,0,1845864
hyuA_predicted,0.5,1,1,CTGTAACCTATGCAAGTATT,0,1862579
hyuA_predicted,0.5,1,1,CTGGTTTCCAAGGGTTGGTG,0,1863292
hyuA_predicted,0.5,1,1,CTGGGGGGTAGACCCAACAC,0,1874496
hyuA_predicted,0.5,1,1,CTGGGGATGTTACTGAATAT,0,1864280
hyuA_predicted,0.5,1,1,CTGGGCCCATCCAACGTGTA,0,1852478
hyuA_predicted,0.5,1,1,CTGGGACGTAATGCCCCTGC,0,1868886
hyuA_predicted,0.5,1,1,CTGGGAAGTCCGTCCGTCAT,0,1846396
hyuA_predicted,0.5,1,1,CTGGCTACGTGAAGAACATC,0,1840322
hyuA_predicted,0.5,1,1,CTGGCAAAGGATGATCTCCT,0,1864556
hyuA_predicted,0.5,1,1,CTGGATTATGTAAGGACTGA,0,1831168
hyuA_predicted,0.5,1,1,CTGGATGTTGCTGGCACAAG,0,1831453
hyuA_predicted,0.5,1,1,CTGCTCGCAGTCTGTATTTG,0,1840141
hyuA_predicted,0.5,1,1,CTGCGTTCAAAAACCATGGA,0,1845637
hyuA_predicted,0.5,1,1,CTGCGTTAGAATTTCTTATC,0,1860132
hyuA_predicted,0.5,1,1,CTGCGATGGCGTCTACGCGG,0,1858418
hyuA_predicted,0.5,1,1,CTGCCCGCCCGCAAAGTCGC,0,1870800
hyuA_predicted,0.5,1,1,CTGCACCCTCATTACGTCCT,0,1836919
hyuA_predicted,0.5,1,1,CTGCAACCCAAAAAAGTTTC,0,1835116
hyuA_predicted,0.5,1,1,CTGATGTCTTAGGCCTTGTC,0,1866654
hyuA_predicted,0.5,1,1,CTGATCAGGGTTAGCCAAAG,0,1868369
hyuA_predicted,0.5,1,1,CTGAGGTCTCCACGGGACAG,0,1844950
hyuA_predicted,0.5,1,1,CTGAGAATCACCTCTTTCTC,0,1858129
hyuA_predicted,0.5,1,1,CTGAAGGATAGAATGCCAGG,0,1845553
hyuA_predicted,0.5,1,1,CTGAAGAATTAGCTTGGAGG,0,1871116
hyuA_predicted,0.5,1,1,CTCTGAAAATATTCCTAAGT,0,1841082
hyuA_predicted,0.5,1,1,CTCTCGTGCTGACATTCGAA,0,1842288
hyuA_predicted,0.5,1,1,CTCTAGGGTTCGGGTGGGCA,0,1851744
hyuA_predicted,0.5,1,1,CTCTACAATAATCTGTCTTC,0,1848843
hyuA_predicted,0.5,1,1,CTCTAATTCCTCTACTCCCG,0,1849053
hyuA_predicted,0.5,1,1,CTCTAAAGCGTCATTGAGCC,0,1842639
hyuA_predicted,0.5,1,1,CTCGGAGTAATGGCCGGTCT,0,1867228
hyuA_predicted,0.5,1,1,CTCGGAACAAACCTGGCGAG,0,1839065
hyuA_predicted,0.5,1,1,CTCGCACCGTTGCGACTTAA,0,1873949
hyuA_predicted,0.5,1,1,CTCCTTTGCGAGCCCCGACT,0,1855939
hyuA_predicted,0.5,1,1,CTCCTGGGAGCCTCCATCGG,0,1874401
hyuA_predicted,0.5,1,1,CTCCTCCGAAAGATACATAC,0,1873232
hyuA_predicted,0.5,1,1,CTCCTCCCACCCTGGCTACA,0,1861782
hyuA_predicted,0.5,1,1,CTCCGTTTGACATGTAAAGG,0,1865926
hyuA_predicted,0.5,1,1,CTCCGCCCGCCACATACGTA,0,1854757
hyuA_predicted,0.5,1,1,CTCCGATAGGACTGGGTTAG,0,1852482
hyuA_predicted,0.5,1,1,CTCCATCGGGGCAGCAACAT,0,1834720
hyuA_predicted,0.5,1,1,CTCCAGGCCCAAAACCGAGC,0,1837329
hyuA_predicted,0.5,1,1,CTCACAACGGTGATGACTAA,0,1835347
hyuA_predicted,0.5,1,1,CTCAAGAAGTGTGAACGCCT,0,1835286
hyuA_predicted,0.5,1,1,CTCAACTACCCTTAGTAGGC,0,1850461
hyuA_predicted,0.5,1,1,CTATTTGAAGTTCGTCTGCG,0,1845271
hyuA_predicted,0.5,1,1,CTATTGGTGAACAGATTTTA,0,1853416
hyuA_predicted,0.5,1,1,CTATTGGGCCTATTTGTTAT,0,1873346
hyuA_predicted,0.5,1,1,CTATTCGCTCGAATTCTCGG,0,1833725
hyuA_predicted,0.5,1,1,CTATTAGTGGCATGGTGAAA,0,1842111
hyuA_predicted,0.5,1,1,CTATGCTGAGGGACTACAAT,0,1829337
hyuA_predicted,0.5,1,1,CTATGAGAACTTAATCGACG,0,1830376
hyuA_predicted,0.5,1,1,CTATCTCCATTATGTGATGC,0,1860801
hyuA_predicted,0.5,1,1,CTATCGCAGCCGATCGCTCG,0,1840771
hyuA_predicted,0.5,1,1,CTATCCCGCCGATTCCTGCG,0,1857359
hyuA_predicted,0.5,1,1,CTATCAGTGAGCTGGTTTTA,0,1867995
hyuA_predicted,0.5,1,1,CTATCAGAGTCTCACGTGCT,0,1871614
hyuA_predicted,0.5,1,1,CTATAGCTGGCGTTCGATTA,0,1876989
hyuA_predicted,0.5,1,1,CTATACGCAACAAGTGCCTC,0,1868057
hyuA_predicted,0.5,1,1,CTATAAAGAGGAGCAGCTCG,0,1868281
hyuA_predicted,0.5,1,1,CTAGTTTCCCTTTGCTACAG,0,1863068
hyuA_predicted,0.5,1,1,CTAGTCTGGATGGATGCGCA,0,1848671
hyuA_predicted,0.5,1,1,CTAGTACTACGGCTCCAGCG,0,1859483
hyuA_predicted,0.5,1,1,CTAGGTAAATCTTTGAGGCC,0,1866266
hyuA_predicted,0.5,1,1,CTAGCCAGGGTAGCGCAGAC,0,1877452
hyuA_predicted,0.5,1,1,CTAGAACTTATAAATCTTCC,0,1840902
hyuA_predicted,0.5,1,1,CTAGAAAGATAAGAACTCCC,0,1856059
hyuA_predicted,0.5,1,1,CTACTAATGGCCGGTTAGGA,0,1875808
hyuA_predicted,0.5,1,1,CTACCCCTACAAGGGGAAAG,0,1848526
hyuA_predicted,0.5,1,1,CTAAGATTAGAGCTGTTTTT,0,1832699
hyuA_predicted,0.5,1,1,CTAAGACTAGCGCAGTCATC,0,1835214
hyuA_predicted,0.5,1,1,CTAACTTAGAGTAACCGCAA,0,1869289
hyuA_predicted,0.5,1,1,CTAAATCACCATCTTATACG,0,1876858
hyuA_predicted,0.5,1,1,CTAAACGCTTTCCCACTGCC,0,1864907
hyuA_predicted,0.5,1,1,CTAAAAGGGGCCAGTTGATT,0,1852804
hyuA_predicted,0.5,1,1,CGTTTTTGCACGATCTGACA,0,1832067
hyuA_predicted,0.5,1,1,CGTTTTTCCAAGAGGACCTC,0,1833986
hyuA_predicted,0.5,1,1,CGTTTTACAACATCGCTCGA,0,1834394
hyuA_predicted,0.5,1,1,CGTTTGTTCCAGGGACGAGA,0,1860474
hyuA_predicted,0.5,1,1,CGTTGGCAAGAAGCCACCGG,0,1840308
hyuA_predicted,0.5,1,1,CGTTGCATGCACGTATGAGC,0,1850219
hyuA_predicted,0.5,1,1,CGTTACTGATGAAGAGGGGG,0,1844989
hyuA_predicted,0.5,1,1,CGTTAACGGGAACTCAGAGG,0,1866620
hyuA_predicted,0.5,1,1,CGTGTTGGGTCATGAGTGTT,0,1841454
hyuA_predicted,0.5,1,1,CGTGTGGCTTGGAGGTGCTG,0,1850413
hyuA_predicted,0.5,1,1,CGTGGCTAAAATGCGCCCTT,0,1873754
hyuA_predicted,0.5,1,1,CGTGCTCCGTACGCGCTCAT,0,1846313
hyuA_predicted,0.5,1,1,CGTGCACTTCATGTAGTATA,0,1860921
hyuA_predicted,0.5,1,1,CGTGATAAAGCTTCCAGTAT,0,1848623
hyuA_predicted,0.5,1,1,CGTGAGAATCATTGCGATTG,0,1835577
hyuA_predicted,0.5,1,1,CGTCTTAGAACGGGTCCATA,0,1851915
hyuA_predicted,0.5,1,1,CGTCTGCTTGTATACGCACT,0,1870533
hyuA_predicted,0.5,1,1,CGTCTCACGGTAGAATGACT,0,1853074
hyuA_predicted,0.5,1,1,CGTCCGTCCCAATTCGGAGC,0,1839095
hyuA_predicted,0.5,1,1,CGTCCCTAAGACTTTTCTCC,0,1830289
hyuA_predicted,0.5,1,1,CGTCCCCGCTGTTGAAGCAC,0,1866310
hyuA_predicted,0.5,1,1,CGTCCATTGTCTCCGCACTT,0,1830688
hyuA_predicted,0.5,1,1,CGTCCAGCTAATTGAATATA,0,1846262
hyuA_predicted,0.5,1,1,CGTCATTTACGGGAACGCTA,0,1834815
hyuA_predicted,0.5,1,1,CGTCATTACAAGGCGCCTTT,0,1848039
hyuA_predicted,0.5,1,1,CGTATTTTTGAATAGTAAAA,0,1848075
hyuA_predicted,0.5,1,1,CGTATTTTGTTCCCATAATG,0,1875719
hyuA_predicted,0.5,1,1,CGTATGTCTATTCTAATGGA,0,1844385
hyuA_predicted,0.5,1,1,CGTAGGGAAAGAGCGTTGAA,0,1835968
hyuA_predicted,0.5,1,1,CGTAGGAGCACCTTAAGTGC,0,1853473
hyuA_predicted,0.5,1,1,CGTAGACTTATAGATATTCC,0,1842521
hyuA_predicted,0.5,1,1,CGTACTCGCGCCGCCGCGCT,0,1876022
hyuA_predicted,0.5,1,1,CGTACAGGCTATAACCCCGA,0,1830318
hyuA_predicted,0.5,1,1,CGTAACATGTCCGACTGCGG,0,1859602
hyuA_predicted,0.5,1,1,CGGTTGAAGGGCACGTACGT,0,1853765
hyuA_predicted,0.5,1,1,CGGTTACTGACGCAGTGTAA,0,1872505
hyuA_predicted,0.5,1,1,CGGTGTATCATTTTGGGGCA,0,1863605
hyuA_predicted,0.5,1,1,CGGTGGTCCCGGGTGACATA,0,1838531
hyuA_predicted,0.5,1,1,CGGTGACAGCCGCTGGTGGT,0,1868513
hyuA_predicted,0.5,1,1,CGGTCGCTCTGACGATGGGT,0,1831522
hyuA_predicted,0.5,1,1,CGGTCACTAGGGGTCTAGGA,0,1871555
hyuA_predicted,0.5,1,1,CGGTATTAGGGTTGCATTGG,0,1856940
hyuA_predicted,0.5,1,1,CGGTAGTACGCGCGGGTTAC,0,1859316
hyuA_predicted,0.5,1,1,CGGTAACGCACTTGGCTGCA,0,1871658
hyuA_predicted,0.5,1,1,CGGGTAGGAAGATCGGTACG,0,1867270
hyuA_predicted,0.5,1,1,CGGGGTGTCTGGGTTTCATA,0,1853299
hyuA_predicted,0.5,1,1,CGGGGTCCAACGCCAAAGGA,0,1850364
hyuA_predicted,0.5,1,1,CGGGGTATATTGATCAGTTA,0,1835121
hyuA_predicted,0.5,1,1,CGGGCGTTTGGCGCGCCATC,0,1837366
hyuA_predicted,0.5,1,1,CGGGCGGTGGGCTCGTTCAA,0,1864840
hyuA_predicted,0.5,1,1,CGGGCCGGGCGTGATTTAAT,0,1848680
hyuA_predicted,0.5,1,1,CGGGATCCGTGCCACGTCGA,0,1870928
hyuA_predicted,0.5,1,1,CGGGAGCAATTGATGCTTTA,0,1854888
hyuA_predicted,0.5,1,1,CGGCTCGGGCCTAGATTCTT,0,1836781
hyuA_predicted,0.5,1,1,CGGCGTTCTGAAGTATTTTC,0,1859652
hyuA_predicted,0.5,1,1,CGGCCAGACGTCTGCACATA,0,1829624
hyuA_predicted,0.5,1,1,CGGCATATGGAAGTGCGTTA,0,1840914
hyuA_predicted,0.5,1,1,CGGAGCGCGTAAGCAGCTCT,0,1850383
hyuA_predicted,0.5,1,1,CGGAGCAAAGAGAAGGGAGA,0,1849443
hyuA_predicted,0.5,1,1,CGGACTTACCTACATCGGAT,0,1867503
hyuA_predicted,0.5,1,1,CGGACAATTATTCGTGGCCG,0,1872596
hyuA_predicted,0.5,1,1,CGGACAACATATTAGGGACC,0,1853567
hyuA_predicted,0.5,1,1,CGGAATGGAGCGTAAAACCA,0,1854974
hyuA_predicted,0.5,1,1,CGGAAGGGCGGGGGACTCCC,0,1833440
hyuA_predicted,0.5,1,1,CGCTTTCGGCATGGGGGGAG,0,1855029
hyuA_predicted,0.5,1,1,CGCTTAGATGATATACATCA,0,1860746
hyuA_predicted,0.5,1,1,CGCTGTAGGAACTTCACTCG,0,1854013
hyuA_predicted,0.5,1,1,CGCTCTTTCGGGCAGGTAAG,0,1832208
hyuA_predicted,0.5,1,1,CGCTCTTGGCTGGATCCGTT,0,1844264
hyuA_predicted,0.5,1,1,CGCTCATTTTACTACGAAAG,0,1862410
hyuA_predicted,0.5,1,1,CGCTCATCATTAGCCTCCCA,0,1857519
hyuA_predicted,0.5,1,1,CGCTATAGTGCGATGTCAGG,0,1853440
hyuA_predicted,0.5,1,1,CGCTATAAATCAATTGTGCT,0,1856873
hyuA_predicted,0.5,1,1,CGCTAGCAGTAGCTGCTCAT,0,1838714
hyuA_predicted,0.5,1,1,CGCTAGAACCGTTAGGGTTC,0,1866646
hyuA_predicted,0.5,1,1,CGCGTGTTGAATGGGCTAAC,0,1846138
hyuA_predicted,0.5,1,1,CGCGTAGAAGAACCACAGCT,0,1839918
hyuA_predicted,0.5,1,1,CGCGGTTCCCTACAGCGAAT,0,1871642
hyuA_predicted,0.5,1,1,CGCGGGAATGCTCTAAACAG,0,1849156
hyuA_predicted,0.5,1,1,CGCGGCCCAGCTTCAACGAT,0,1872966
hyuA_predicted,0.5,1,1,CGCGGATCAGGGACGGACGT,0,1869293
hyuA_predicted,0.5,1,1,CGCGCGTATCCAAAGCTTGC,0,1839899
hyuA_predicted,0.5,1,1,CGCCTCGGGTAGAGGAACGA,0,1852430
hyuA_predicted,0.5,1,1,CGCCTCATATTGAGAATTAC,0,1868011
hyuA_predicted,0.5,1,1,CGCCGCGGGATAGCCGGGCT,0,1863887
hyuA_predicted,0.5,1,1,CGCCGACGGGATGGGCGGGA,0,1859150
hyuA_predicted,0.5,1,1,CGCCCTGCCATTTCAGGAGG,0,1855839
hyuA_predicted,0.5,1,1,CGCCCGGTTTTTGTATTGCT,0,1830731
hyuA_predicted,0.5,1,1,CGCCCGAGTGGTTCATTCAA,0,1834959
hyuA_predicted,0.5,1,1,CGCCCCTGGACTGCTAGAGG,0,1839847
hyuA_predicted,0.5,1,1,CGCATTTTGGATGGGACCTG,0,1874454
hyuA_predicted,0.5,1,1,CGCATTTACACTGTGGTGTC,0,1872105
hyuA_predicted,0.5,1,1,CGCATCTTAGAGGTGCGCTA,0,1842481
hyuA_predicted,0.5,1,1,CGCATCATGTTTCCGCTATG,0,1848027
hyuA_predicted,0.5,1,1,CGCAGTAGATCAGTGTGACA,0,1870015
hyuA_predicted,0.5,1,1,CGCAGTACCATCCGAACCAT,0,1876133
hyuA_predicted,0.5,1,1,CGCAGGTGGTGATGTCTTCA,0,1855092
hyuA_predicted,0.5,1,1,CGCAGCTGGCGCGGAATAGT,0,1867108
hyuA_predicted,0.5,1,1,CGCAGCCATATCTCCGGCTG,0,1871403
hyuA_predicted,0.5,1,1,CGCACATCCGACATCATGAT,0,1850128
hyuA_predicted,0.5,1,1,CGATGCTTTCAACTCTCCAA,0,1867806
hyuA_predicted,0.5,1,1,CGATGAGTTGACCTCACCAG,0,1855277
hyuA_predicted,0.5,1,1,CGATGAGTCCCTCTACCTCT,0,1843665
hyuA_predicted,0.5,1,1,CGATCCGCCCTAGGTGTTCA,0,1837000
hyuA_predicted,0.5,1,1,CGATAACCATAAATTCGTCA,0,1834882
hyuA_predicted,0.5,1,1,CGAGAGTAAGAGGTGGTGCG,0,1852557
hyuA_predicted,0.5,1,1,CGAGAGCTCTGGAGCTCTCA,0,1833645
hyuA_predicted,0.5,1,1,CGACTTCTTGCGGGTAACGT,0,1833524
hyuA_predicted,0.5,1,1,CGACGGGGTAAGCTCGATCA,0,1837347
hyuA_predicted,0.5,1,1,CGACGCGGAAATAAATTAGA,0,1858364
hyuA_predicted,0.5,1,1,CGACCCGACATAACAAACCC,0,1829900
hyuA_predicted,0.5,1,1,CGACATGTAGTATTACCCTG,0,1873463
hyuA_predicted,0.5,1,1,CGAATATGTAGGCTCGTGGT,0,1843252
hyuA_predicted,0.5,1,1,CGAACTGAGCTCCATCGCTG,0,1835191
hyuA_predicted,0.5,1,1,CGAACGGAGTCCAATTTCAT,0,1869503
hyuA_predicted,0.5,1,1,CGAACAGGGGTTATTTGACG,0,1831982
hyuA_predicted,0.5,1,1,CGAACAATATTATTTCCAGG,0,1864029
hyuA_predicted,0.5,1,1,CCTTGTATCGCCGTCTACAA,0,1837805
hyuA_predicted,0.5,1,1,CCTTGGAAATAATGGCGGAA,0,1877820
hyuA_predicted,0.5,1,1,CCTTGCATTGGACATCGTCG,0,1875213
hyuA_predicted,0.5,1,1,CCTTGACTGTCCGACCTGTT,0,1853600
hyuA_predicted,0.5,1,1,CCTTCGTAGAGCCGACGAGG,0,1843260
hyuA_predicted,0.5,1,1,CCTTCAGGTGGGACCGCGGT,0,1863941
hyuA_predicted,0.5,1,1,CCTTATTTTGGAGGACGCTC,0,1861579
hyuA_predicted,0.5,1,1,CCTGTGCGTGTCGGATGCTC,0,1861821
hyuA_predicted,0.5,1,1,CCTGGGTCTCTTCATGACCG,0,1844770
hyuA_predicted,0.5,1,1,CCTGGCCCGTCGCTAGATGT,0,1875687
hyuA_predicted,0.5,1,1,CCTGCGATTGCTATAACAAG,0,1832795
hyuA_predicted,0.5,1,1,CCTGCAAGTTCAACAGTCCA,0,1869904
hyuA_predicted,0.5,1,1,CCTCGCAGTCTCTAAAATCG,0,1844972
hyuA_predicted,0.5,1,1,CCTCCTCCGTCCGTACTTCG,0,1830414
hyuA_predicted,0.5,1,1,CCTATTAAACTCGGCCTGCG,0,1857689
hyuA_predicted,0.5,1,1,CCTATGGGCAACACAGCGCT,0,1851396
hyuA_predicted,0.5,1,1,CCTATCTTTTGAGTCATCGC,0,1873622
hyuA_predicted,0.5,1,1,CCTAGAACTTCTCAGCCAGC,0,1856362
hyuA_predicted,0.5,1,1,CCTAATCTCGGGATACTGAC,0,1838851
hyuA_predicted,0.5,1,1,CCGTTTCACCCGAGTATAGA,0,1830994
hyuA_predicted,0.5,1,1,CCGTTGCTCTGTACTCTTTT,0,1854404
hyuA_predicted,0.5,1,1,CCGTTCGAGTCCCCCGCGGC,0,1843256
hyuA_predicted,0.5,1,1,CCGTGTGCGCCATGGTGGCC,0,1839944
hyuA_predicted,0.5,1,1,CCGTGGCTGGCGCCAATGTC,0,1829440
hyuA_predicted,0.5,1,1,CCGTGACTTTATACCGCAAA,0,1854097
hyuA_predicted,0.5,1,1,CCGTCTTATCATCGGGAAGC,0,1848989
hyuA_predicted,0.5,1,1,CCGTCTGCGCGACCAACATG,0,1857570
hyuA_predicted,0.5,1,1,CCGTCACTTTTGCCGGACAC,0,1845954
hyuA_predicted,0.5,1,1,CCGTAGTACTCGTGGCGTCA,0,1870000
hyuA_predicted,0.5,1,1,CCGGTTCGGGTTTGGCCGGC,0,1834293
hyuA_predicted,0.5,1,1,CCGGTCAGATGTCCATCTTC,0,1850789
hyuA_predicted,0.5,1,1,CCGGTAGGTGGCTGGTTCAG,0,1869768
hyuA_predicted,0.5,1,1,CCGGGGGCTTATCGGAAGTA,0,1859725
hyuA_predicted,0.5,1,1,CCGGGCACCGTTGGGATGGA,0,1832804
hyuA_predicted,0.5,1,1,CCGGCTCGGTACAGCACTAG,0,1854842
hyuA_predicted,0.5,1,1,CCGGCGGGATGGTCGAACAC,0,1848033
hyuA_predicted,0.5,1,1,CCGGCAGTAACCTAGTGTAG,0,1842570
hyuA_predicted,0.5,1,1,CCGGATTGGCAGGCCTCAGG,0,1856405
hyuA_predicted,0.5,1,1,CCGGATAAATCTTGGGGACG,0,1863006
hyuA_predicted,0.5,1,1,CCGGACTGGTCATATCTGGG,0,1854616
hyuA_predicted,0.5,1,1,CCGCTGGAGAGCCCTCACCA,0,1865540
hyuA_predicted,0.5,1,1,CCGCTGCGTTCAAAGAGATA,0,1855269
hyuA_predicted,0.5,1,1,CCGCCGTTGCCAACGGAGGC,0,1834912
hyuA_predicted,0.5,1,1,CCGCCACACGGCGCTGAGCA,0,1829181
hyuA_predicted,0.5,1,1,CCGCATTGAGGCGACTGCTC,0,1853890
hyuA_predicted,0.5,1,1,CCGATTTGAACCCCCTTTGA,0,1850235
hyuA_predicted,0.5,1,1,CCGAGGGTCGTTCCGCGAAG,0,1868502
hyuA_predicted,0.5,1,1,CCGAGGATCCTGCTCAACGC,0,1857243
hyuA_predicted,0.5,1,1,CCGACGCAACTGGTGGACCG,0,1864801
hyuA_predicted,0.5,1,1,CCGACCTTCCTTCAAACAAC,0,1848679
hyuA_predicted,0.5,1,1,CCGACAACCTTTAGGCGCAG,0,1865637
hyuA_predicted,0.5,1,1,CCGAACTGGGCCTTGGACGT,0,1872382
hyuA_predicted,0.5,1,1,CCCTTGGCGTTCGAAAAACG,0,1863841
hyuA_predicted,0.5,1,1,CCCTTAGGGCCGGACCTACT,0,1844874
hyuA_predicted,0.5,1,1,CCCTGGGAATCGTGCACCTC,0,1838718
hyuA_predicted,0.5,1,1,CCCGTCCTCATGTCGTGAGT,0,1859432
hyuA_predicted,0.5,1,1,CCCGTATTCACAAAAGGCAA,0,1868393
hyuA_predicted,0.5,1,1,CCCGTACAGGAAAGTGATTA,0,1858690
hyuA_predicted,0.5,1,1,CCCGGTTAAGTAATTCTTAA,0,1855215
hyuA_predicted,0.5,1,1,CCCGCATGCCCCTGTGGGGT,0,1850635
hyuA_predicted,0.5,1,1,CCCGCAAATTGTTTAATGTT,0,1854642
hyuA_predicted,0.5,1,1,CCCGAAGTAAGGAACATCCA,0,1850809
hyuA_predicted,0.5,1,1,CCCGAACGACATAACTACGA,0,1829377
hyuA_predicted,0.5,1,1,CCCCTGTACCTCACGTGCGT,0,1857706
hyuA_predicted,0.5,1,1,CCCCTGGGTCTTGCCAATCA,0,1865471
hyuA_predicted,0.5,1,1,CCCCGACACGGGTCACTGCT,0,1846726
hyuA_predicted,0.5,1,1,CCCCCCCATTCGTACTATTG,0,1847360
hyuA_predicted,0.5,1,1,CCCATGCGATCCCGCACGCA,0,1836721
hyuA_predicted,0.5,1,1,CCCAGGCGAAAGCGCTGAGG,0,1860894
hyuA_predicted,0.5,1,1,CCCACTCAGGCGGGTTGTCA,0,1838132
hyuA_predicted,0.5,1,1,CCCACTATCGAGCCCCGCTA,0,1832233
hyuA_predicted,0.5,1,1,CCCACCCTCGTTACTTTGCA,0,1860007
hyuA_predicted,0.5,1,1,CCCACATGGGCGTGCACCTT,0,1833638
hyuA_predicted,0.5,1,1,CCCACAGCGATGGTTGTACC,0,1843068
hyuA_predicted,0.5,1,1,CCCACAGAGTTCTTAAATAT,0,1869129
hyuA_predicted,0.5,1,1,CCCAAGTTTCATCGTGAAAC,0,1836056
hyuA_predicted,0.5,1,1,CCCAACATTTACCGTATGTA,0,1854279
hyuA_predicted,0.5,1,1,CCATTTTATCATACGCTACT,0,1846954
hyuA_predicted,0.5,1,1,CCATTTAAATTGCTATACAC,0,1835912
hyuA_predicted,0.5,1,1,CCATCTGCATGAAAATTGTT,0,1855452
hyuA_predicted,0.5,1,1,CCATCTAGGACGAAAACTCG,0,1876707
hyuA_predicted,0.5,1,1,CCATATGAAACGCGTTCTGT,0,1867827
hyuA_predicted,0.5,1,1,CCAGTTTAAGTCGCACTAAT,0,1846796
hyuA_predicted,0.5,1,1,CCAGTATCAATCTAGATTGG,0,1850674
hyuA_predicted,0.5,1,1,CCAGTAGGAGTCCGCAGCCC,0,1872355
hyuA_predicted,0.5,1,1,CCAGTAAGGGCTTAAGTAAA,0,1834819
hyuA_predicted,0.5,1,1,CCAGGTCCTTCCAGGAAGGA,0,1855643
hyuA_predicted,0.5,1,1,CCAGGAGGGTGATCCGTTAG,0,1849888
hyuA_predicted,0.5,1,1,CCAGCGGTATGGCCGCAGGA,0,1844209
hyuA_predicted,0.5,1,1,CCAGAGAGCTCCACTCTTCC,0,1853570
hyuA_predicted,0.5,1,1,CCAGAAGAGGAGTGTGAGCT,0,1830928
hyuA_predicted,0.5,1,1,CCACTCGCGGTGTAGGGCTC,0,1829482
hyuA_predicted,0.5,1,1,CCACGGGAGGCTTACAGGCT,0,1847785
hyuA_predicted,0.5,1,1,CCACCGATCCCCATAAATAT,0,1833203
hyuA_predicted,0.5,1,1,CCACCGACTGGCCACTTGCA,0,1837987
hyuA_predicted,0.5,1,1,CCACCCATAGAGGACTTCAC,0,1872206
hyuA_predicted,0.5,1,1,CCACAGCCTCGTTCGATTGT,0,1849370
hyuA_predicted,0.5,1,1,CCAAGTGAGCGAACATAATT,0,1833513
hyuA_predicted,0.5,1,1,CCAAGGTTAGATCCGCGACA,0,1841715
hyuA_predicted,0.5,1,1,CCAAGGGTGCGCTACAAGAT,0,1862940
hyuA_predicted,0.5,1,1,CCAAGGATAACTATTGGTTA,0,1852264
hyuA_predicted,0.5,1,1,CCAAGCTCAGGTATCCGAGG,0,1831014
hyuA_predicted,0.5,1,1,CCAAGCGATTGAGTCATACG,0,1837363
hyuA_predicted,0.5,1,1,CCAAATTGTTGGCGGTATGA,0,1847942
hyuA_predicted,0.5,1,1,CATTTGGAGGAAAAAATCGG,0,1845727
hyuA_predicted,0.5,1,1,CATTGGCTCGTATCGAATCT,0,1857367
hyuA_predicted,0.5,1,1,CATTGGACGCGGAAATTTTA,0,1855013
hyuA_predicted,0.5,1,1,CATTCGTAATAGCTCTCGCA,0,1871444
hyuA_predicted,0.5,1,1,CATTCGGTATTACTCCGCAT,0,1844005
hyuA_predicted,0.5,1,1,CATTAGACAGTCCAGGACCC,0,1864095
hyuA_predicted,0.5,1,1,CATTACTGTTTGACACTTCG,0,1855559
hyuA_predicted,0.5,1,1,CATTACGTGTTGACAAACCA,0,1864469
hyuA_predicted,0.5,1,1,CATGTCTAAGCGAATTACGT,0,1867855
hyuA_predicted,0.5,1,1,CATGTAGCGAGGGTTTAGCT,0,1831727
hyuA_predicted,0.5,1,1,CATCTTAAACGAATTCGAGT,0,1867695
hyuA_predicted,0.5,1,1,CATCGGGGCTGGAGACGACA,0,1848049
hyuA_predicted,0.5,1,1,CATCGCAATAATCCAATAGC,0,1850571
hyuA_predicted,0.5,1,1,CATCCTGATGGTGCTGGGGG,0,1829984
hyuA_predicted,0.5,1,1,CATCAGGCGATCGACAGAGT,0,1829378
hyuA_predicted,0.5,1,1,CATATATACTCGACTTGAGT,0,1837020
hyuA_predicted,0.5,1,1,CATATAGCGTCAGTAAATAG,0,1850978
hyuA_predicted,0.5,1,1,CATAGGGGGGAGATACGCGA,0,1855102
hyuA_predicted,0.5,1,1,CATAGGCTCGCTAATTCTGA,0,1858684
hyuA_predicted,0.5,1,1,CATAGCTCACACCCATCGTA,0,1839004
hyuA_predicted,0.5,1,1,CATAGCTATCAGCCCACTGG,0,1834561
hyuA_predicted,0.5,1,1,CATACTTTCTAAGACGTAAT,0,1852480
hyuA_predicted,0.5,1,1,CATAATTGGTGAGTTAGATC,0,1859165
hyuA_predicted,0.5,1,1,CATAAAGTGTAGGCCATAGG,0,1842478
hyuA_predicted,0.5,1,1,CAGTTGAAAATCGGACGCTG,0,1858120
hyuA_predicted,0.5,1,1,CAGTTCCTGTCGTGTATACA,0,1870520
hyuA_predicted,0.5,1,1,CAGTGGCGGGGACGTGAATA,0,1829802
hyuA_predicted,0.5,1,1,CAGTATCACGCCCAGGATCT,0,1868499
hyuA_predicted,0.5,1,1,CAGTAGTTGTCAAGTTTATG,0,1839857
hyuA_predicted,0.5,1,1,CAGGTTTATCCGTTTCCAAA,0,1858348
hyuA_predicted,0.5,1,1,CAGGTCTTCTTTAAGATGAC,0,1867284
hyuA_predicted,0.5,1,1,CAGGGGGTGCTGGGGTATTC,0,1838281
hyuA_predicted,0.5,1,1,CAGGCAGTTGCTACAATATG,0,1876382
hyuA_predicted,0.5,1,1,CAGGAAATGAAATCGGAGGC,0,1839773
hyuA_predicted,0.5,1,1,CAGGAAACCTCAAGACAATG,0,1833899
hyuA_predicted,0.5,1,1,CAGCTGCTGGCGCGGTATTA,0,1868383
hyuA_predicted,0.5,1,1,CAGCTATGGTCCGACTGGCT,0,1860294
hyuA_predicted,0.5,1,1,CAGCGGGGCGGAGATAGCGC,0,1852171
hyuA_predicted,0.5,1,1,CAGCCGGAGGGTAACATTAT,0,1845777
hyuA_predicted,0.5,1,1,CAGCCCATGTTTGAATGAGT,0,1856067
hyuA_predicted,0.5,1,1,CAGCAGTCTTTGTCCACGAA,0,1857274
hyuA_predicted,0.5,1,1,CAGCAGCTAATCAAGACGTA,0,1875559
hyuA_predicted,0.5,1,1,CAGATGGCCGTGAGTGAGGC,0,1864335
hyuA_predicted,0.5,1,1,CAGATCGAACTCCATTCAAC,0,1855028
hyuA_predicted,0.5,1,1,CAGACAGCATTATCCGTAAA,0,1865328
hyuA_predicted,0.5,1,1,CAGAAGCACCTTAAAAATGT,0,1835785
hyuA_predicted,0.5,1,1,CACTTTGTCGGAGAAGCCGC,0,1836226
hyuA_predicted,0.5,1,1,CACTTTGCCAAGCCAGCAGG,0,1854567
hyuA_predicted,0.5,1,1,CACTTGGGAGTGAGGCCGTT,0,1848959
hyuA_predicted,0.5,1,1,CACTTCGAATCGGTTTTATT,0,1857911
hyuA_predicted,0.5,1,1,CACTTCACGACAACGGATTT,0,1841225
hyuA_predicted,0.5,1,1,CACTTAAGAACCCTCCGAAT,0,1864203
hyuA_predicted,0.5,1,1,CACTGACAGGTGTGTCCAAC,0,1849742
hyuA_predicted,0.5,1,1,CACTCGAGTAACGCGGAACC,0,1852466
hyuA_predicted,0.5,1,1,CACTCACGCATATCGCCACC,0,1871893
hyuA_predicted,0.5,1,1,CACGTTGACGAACAAATGCC,0,1851863
hyuA_predicted,0.5,1,1,CACGTGAAGTACGAATAACT,0,1829334
hyuA_predicted,0.5,1,1,CACGTCTGTGGTATGGCTTT,0,1836494
hyuA_predicted,0.5,1,1,CACGGACTTTGGTCGAATTG,0,1871449
hyuA_predicted,0.5,1,1,CACGGAATCGCCATACGTGC,0,1838375
hyuA_predicted,0.5,1,1,CACGCGGTGTGAAAGATTTC,0,1864406
hyuA_predicted,0.5,1,1,CACGATCGGCCCTGGAGGTT,0,1864948
hyuA_predicted,0.5,1,1,CACGAGGGCTGGGCCGCGAT,0,1871805
hyuA_predicted,0.5,1,1,CACCGGCGTGATCGATTGGA,0,1835711
hyuA_predicted,0.5,1,1,CACCGGCACACTGAACACCG,0,1871765
hyuA_predicted,0.5,1,1,CACCCTCCTTAGCTACCGAG,0,1873496
hyuA_predicted,0.5,1,1,CACCCGAGTCTTTCTCTAGG,0,1872677
hyuA_predicted,0.5,1,1,CACCCAATGGGGGTGTGAGG,0,1858178
hyuA_predicted,0.5,1,1,CACCAGTATTCTTTAGTTGT,0,1830404
hyuA_predicted,0.5,1,1,CACCAGGCCTTGCCTTTACT,0,1834317
hyuA_predicted,0.5,1,1,CACCAGAGCAGACCCTGATG,0,1834240
hyuA_predicted,0.5,1,1,CACATTCATCGACATTTTTA,0,1843589
hyuA_predicted,0.5,1,1,CACATTAATACTTAAGTCGT,0,1846786
hyuA_predicted,0.5,1,1,CACATGTAGGCATAATATTC,0,1833979
hyuA_predicted,0.5,1,1,CACAGATGCATTGAAATATG,0,1846112
hyuA_predicted,0.5,1,1,CACACTCGTCTATCGTCTCG,0,1870114
hyuA_predicted,0.5,1,1,CACAACTACCAGGCAAACAG,0,1848393
hyuA_predicted,0.5,1,1,CACAACGGTGAGATATCAAG,0,1857585
hyuA_predicted,0.5,1,1,CACAACAAATCGTCTAAGAT,0,1860027
hyuA_predicted,0.5,1,1,CAATTCGGGTATAATAATCT,0,1860140
hyuA_predicted,0.5,1,1,CAATCGGGCGGCATTCAAGC,0,1856557
hyuA_predicted,0.5,1,1,CAATAGGGCGCTAATGGCAA,0,1831819
hyuA_predicted,0.5,1,1,CAATACTGACGCCAACCATA,0,1871158
hyuA_predicted,0.5,1,1,CAATACGCCGCCCTTATTGG,0,1852628
hyuA_predicted,0.5,1,1,CAAGTTACTTCTGTTACGGG,0,1873089
hyuA_predicted,0.5,1,1,CAAGCGGCATATATCCTAGC,0,1849607
hyuA_predicted,0.5,1,1,CAAGCACTTATCCCGCCCTG,0,1867594
hyuA_predicted,0.5,1,1,CAAGAGTCGGGATCACTATG,0,1862161
hyuA_predicted,0.5,1,1,CAAGACCTGATCGGGCAGGA,0,1853941
hyuA_predicted,0.5,1,1,CAAGAATGCGCAAACCAGAC,0,1860478
hyuA_predicted,0.5,1,1,CAAGAAATTATCCGGGCCGA,0,1860001
hyuA_predicted,0.5,1,1,CAACGTCAGATGTGCATCTT,0,1846617
hyuA_predicted,0.5,1,1,CAACGCTAGGTAGTCTACTA,0,1872554
hyuA_predicted,0.5,1,1,CAACCGGATTGATTAGGTTA,0,1857229
hyuA_predicted,0.5,1,1,CAACAGCCTTGACAAGCACC,0,1846105
hyuA_predicted,0.5,1,1,CAAACAAATTTGCACTTGTT,0,1862916
hyuA_predicted,0.5,1,1,CAAAAATGTTATAAATCGTT,0,1833582
hyuA_predicted,0.5,1,1,ATTTTTATCAGACGTTTCGA,0,1847635
hyuA_predicted,0.5,1,1,ATTTTACGGTACCGTGCAGC,0,1865936
hyuA_predicted,0.5,1,1,ATTTCTTTATCACACCGGGT,0,1839688
hyuA_predicted,0.5,1,1,ATTTAAACAGATTGTTCATA,0,1864797
hyuA_predicted,0.5,1,1,ATTGTGATAGGCCTCACGGC,0,1832479
hyuA_predicted,0.5,1,1,ATTGGGGGGCGACCTCTACA,0,1842437
hyuA_predicted,0.5,1,1,ATTGGGAAACGGCTTCCTGA,0,1835287
hyuA_predicted,0.5,1,1,ATTGGAGCGTTAGTAACTGG,0,1851830
hyuA_predicted,0.5,1,1,ATTGCGTCGTCACTTGTACT,0,1843534
hyuA_predicted,0.5,1,1,ATTGCCGGTAGCATATCGAC,0,1855196
hyuA_predicted,0.5,1,1,ATTGCCCTAAGTCACAACGT,0,1846502
hyuA_predicted,0.5,1,1,ATTGCAAGGGCCGATAAGGG,0,1866439
hyuA_predicted,0.5,1,1,ATTGAGTGCCTGTAGTGCCC,0,1832843
hyuA_predicted,0.5,1,1,ATTGACATGTGAACTTCTGT,0,1844316
hyuA_predicted,0.5,1,1,ATTCGGATGACTTCCCAGAT,0,1850229
hyuA_predicted,0.5,1,1,ATTCGGAGTTGATTTCTCAT,0,1867888
hyuA_predicted,0.5,1,1,ATTCGAGCTTGAGTTTCTAA,0,1844453
hyuA_predicted,0.5,1,1,ATTCCTTATGGTTGTTGTCC,0,1843000
hyuA_predicted,0.5,1,1,ATTCCTTACATGTTGCTATA,0,1863048
hyuA_predicted,0.5,1,1,ATTCCTGGCGCTGGCGGAGA,0,1874223
hyuA_predicted,0.5,1,1,ATTCCGTGCATACTGCAACG,0,1866755
hyuA_predicted,0.5,1,1,ATTCCGCCCAACATCGAAAT,0,1871623
hyuA_predicted,0.5,1,1,ATTCCACCGTCCCTACAACA,0,1857412
hyuA_predicted,0.5,1,1,ATTCACAGTTCTGACACGCA,0,1876669
hyuA_predicted,0.5,1,1,ATTATTCGACCAGCTGCACT,0,1830729
hyuA_predicted,0.5,1,1,ATTATGTGTGCATCTTAGAC,0,1851189
hyuA_predicted,0.5,1,1,ATTATCCATACAGAGGCCTT,0,1875960
hyuA_predicted,0.5,1,1,ATTAGGTGGGTTGGCATGCG,0,1836186
hyuA_predicted,0.5,1,1,ATTAGGGTTGCTAAGAACCA,0,1860995
hyuA_predicted,0.5,1,1,ATTAGGAGTGGTATGGTTGG,0,1871031
hyuA_predicted,0.5,1,1,ATTAGCAGGTACTTACCTTG,0,1864137
hyuA_predicted,0.5,1,1,ATTAGAGGCTAGAGTTCATT,0,1846649
hyuA_predicted,0.5,1,1,ATTACGGTTTTACGGCATCC,0,1846927
hyuA_predicted,0.5,1,1,ATTACGAGTCAGACTTTAAT,0,1832085
hyuA_predicted,0.5,1,1,ATTACCCTTTTTCTGTCTCA,0,1836107
hyuA_predicted,0.5,1,1,ATTACCCACACGGCGTTGAC,0,1830645
hyuA_predicted,0.5,1,1,ATTAAGTTGAAATCTACCAG,0,1871959
hyuA_predicted,0.5,1,1,ATTAACTCTAAAGAGGCTAG,0,1842552
hyuA_predicted,0.5,1,1,ATTAACCAAGTCGTCACAGA,0,1870038
hyuA_predicted,0.5,1,1,ATTAAAGGTCTCGAGGGCCG,0,1833510
hyuA_predicted,0.5,1,1,ATGTTTCTAGTTGCTTCTCC,0,1869527
hyuA_predicted,0.5,1,1,ATGTTCCTTCCGGTTACATT,0,1862440
hyuA_predicted,0.5,1,1,ATGTGGGGGATTCCGGAGGC,0,1853757
hyuA_predicted,0.5,1,1,ATGTGCCTTGGGAAATATGC,0,1849064
hyuA_predicted,0.5,1,1,ATGTGCAAATGAATTCGGGA,0,1855315
hyuA_predicted,0.5,1,1,ATGTGATTGATTAAGGTAAA,0,1828855
hyuA_predicted,0.5,1,1,ATGTATTCGGTGGACGATGA,0,1870395
hyuA_predicted,0.5,1,1,ATGTATATCTACCCGGACCA,0,1834923
hyuA_predicted,0.5,1,1,ATGTAGGTATCAGTTATCAC,0,1871330
hyuA_predicted,0.5,1,1,ATGTACGTGTTACATGCACT,0,1836948
hyuA_predicted,0.5,1,1,ATGGTGCTTCAGCAAGCGTG,0,1852495
hyuA_predicted,0.5,1,1,ATGGTCAGGCCTCCCTATTC,0,1831826
hyuA_predicted,0.5,1,1,ATGGGTAGTGGCAGTACTTA,0,1865688
hyuA_predicted,0.5,1,1,ATGGGATCCTTGACACGAAG,0,1871267
hyuA_predicted,0.5,1,1,ATGGCTCGAGCAGTGGCTAT,0,1871538
hyuA_predicted,0.5,1,1,ATGGCTATTGCTGCGGTAGT,0,1830658
hyuA_predicted,0.5,1,1,ATGGCGTCCGCTTCTTGTGT,0,1874713
hyuA_predicted,0.5,1,1,ATGGCGAGGAATACCACGTT,0,1848515
hyuA_predicted,0.5,1,1,ATGGCCTGTAGCAGGGGGGG,0,1832681
hyuA_predicted,0.5,1,1,ATGGCACTTCGCGGTGTAGT,0,1851617
hyuA_predicted,0.5,1,1,ATGGAGTTCGGTCTGGTTGT,0,1864355
hyuA_predicted,0.5,1,1,ATGGAGTGGTCGTTAATGAA,0,1831552
hyuA_predicted,0.5,1,1,ATGGAGGGGCATGAATCGTT,0,1831125
hyuA_predicted,0.5,1,1,ATGCTATTTCCAAGCAATTG,0,1833975
hyuA_predicted,0.5,1,1,ATGCGTGAATTTTGGCGATC,0,1844101
hyuA_predicted,0.5,1,1,ATGCGTCTCGTCAAGAAGCC,0,1829806
hyuA_predicted,0.5,1,1,ATGCGCGATGTCATGCGCCT,0,1837099
hyuA_predicted,0.5,1,1,ATGCGACTTTTCTCACCATA,0,1870967
hyuA_predicted,0.5,1,1,ATGCCTCGCGCTGGACATAG,0,1857933
hyuA_predicted,0.5,1,1,ATGCCCTTAGGACAGGATAA,0,1863655
hyuA_predicted,0.5,1,1,ATGCCCAATAATCTCACTAG,0,1850279
hyuA_predicted,0.5,1,1,ATGCCCAACCACGTAACTGG,0,1841659
hyuA_predicted,0.5,1,1,ATGATCTAGGGTCTCACATT,0,1838376
hyuA_predicted,0.5,1,1,ATGATAGATTGGGCCATACC,0,1850564
hyuA_predicted,0.5,1,1,ATGAGGGGGTCGAAGCGAGT,0,1844760
hyuA_predicted,0.5,1,1,ATGACTGCGGAGCAAATGCG,0,1849406
hyuA_predicted,0.5,1,1,ATGAAGAACGCAGATGTATT,0,1875634
hyuA_predicted,0.5,1,1,ATCTGTTAGAACGGAAATGG,0,1857787
hyuA_predicted,0.5,1,1,ATCTGCATCACACAGACGCA,0,1875475
hyuA_predicted,0.5,1,1,ATCTGAGACATGGACTCCAT,0,1858844
hyuA_predicted,0.5,1,1,ATCTCACAGGGTAAGGATAA,0,1847040
hyuA_predicted,0.5,1,1,ATCTATTACACAGGTTACTA,0,1831821
hyuA_predicted,0.5,1,1,ATCTATAAGGAGCTAGCGGG,0,1862549
hyuA_predicted,0.5,1,1,ATCTAGCAGATTCGGGTGTG,0,1844198
hyuA_predicted,0.5,1,1,ATCTACCTACAATGAGTGCG,0,1865186
hyuA_predicted,0.5,1,1,ATCGTAGGGCAATATGCGCA,0,1862548
hyuA_predicted,0.5,1,1,ATCGGCGGGTGAGTTTCAAG,0,1853466
hyuA_predicted,0.5,1,1,ATCGGACTGATGTGACCAGA,0,1847621
hyuA_predicted,0.5,1,1,ATCCTTATTACGATAAGTGG,0,1850868
hyuA_predicted,0.5,1,1,ATCCGTGCCACACCGGCCCA,0,1853984
hyuA_predicted,0.5,1,1,ATCCGGCAGACTTATGGTAA,0,1853741
hyuA_predicted,0.5,1,1,ATCCGCGTTGTAAATTCGAC,0,1871000
hyuA_predicted,0.5,1,1,ATCCCTCCAGGACGTGGCTA,0,1850356
hyuA_predicted,0.5,1,1,ATCCAGTTAAGCTCCGTTAA,0,1865469
hyuA_predicted,0.5,1,1,ATCCAGACTGAAAAATATTG,0,1839972
hyuA_predicted,0.5,1,1,ATCATCATTATATTGTTTTC,0,1829123
hyuA_predicted,0.5,1,1,ATCATATTATGTTTGTTTCT,0,1867596
hyuA_predicted,0.5,1,1,ATCATAAGTGTAGCTTGTTG,0,1857607
hyuA_predicted,0.5,1,1,ATCATAAATGCCACGGAGAT,0,1876927
hyuA_predicted,0.5,1,1,ATCAGATTCAGTTTCATCTG,0,1871083
hyuA_predicted,0.5,1,1,ATCAGACCGGCGACGGGCAA,0,1872959
hyuA_predicted,0.5,1,1,ATCACGTAGCGAGTACATTC,0,1856095
hyuA_predicted,0.5,1,1,ATCACCAGGGGCAGACTGAT,0,1849640
hyuA_predicted,0.5,1,1,ATCACAGAGGAAACGTATAT,0,1877491
hyuA_predicted,0.5,1,1,ATCACACTCACCGCAGGGGC,0,1844456
hyuA_predicted,0.5,1,1,ATCAAGGCTCGAAGGTTACA,0,1844954
hyuA_predicted,0.5,1,1,ATCAACAGGCGCGTAATCGT,0,1832395
hyuA_predicted,0.5,1,1,ATATTTCTCTCAGTTAGCAG,0,1832879
hyuA_predicted,0.5,1,1,ATATTGGCATACGCAATTGA,0,1874085
hyuA_predicted,0.5,1,1,ATATTGCTTACGGCATAAGA,0,1849075
hyuA_predicted,0.5,1,1,ATATTATTGACTTTTGGTGA,0,1842646
hyuA_predicted,0.5,1,1,ATATGTGTAAAACGATCTAT,0,1865542
hyuA_predicted,0.5,1,1,ATATGTGAGCGAACAGCAGG,0,1834271
hyuA_predicted,0.5,1,1,ATATCCTAGATGTGAAAGTC,0,1846504
hyuA_predicted,0.5,1,1,ATATCCGACTTCGCGAGCGG,0,1837994
hyuA_predicted,0.5,1,1,ATAGGCTTCGCTCTAGCTTG,0,1875985
hyuA_predicted,0.5,1,1,ATAGGCTAGATCGCCTGGGC,0,1844304
hyuA_predicted,0.5,1,1,ATAGGATTAACAGGCCCTGG,0,1857120
hyuA_predicted,0.5,1,1,ATAGCTATCTATGTCGCTTA,0,1849864
hyuA_predicted,0.5,1,1,ATAGCGTTAGGATATGGTAT,0,1849520
hyuA_predicted,0.5,1,1,ATAGATTGAGCTATGTGTAC,0,1844356
hyuA_predicted,0.5,1,1,ATAGAGTCATACCCTAGATA,0,1853268
hyuA_predicted,0.5,1,1,ATAGAGTCACAATGGCAGAG,0,1851803
hyuA_predicted,0.5,1,1,ATACTGCACACATGTAGCAC,0,1843858
hyuA_predicted,0.5,1,1,ATACTGATTTGATGCAAAGT,0,1845328
hyuA_predicted,0.5,1,1,ATACGTCCACATCCCCCTGA,0,1877875
hyuA_predicted,0.5,1,1,ATACGATGCTGTAGCTCTGT,0,1876999
hyuA_predicted,0.5,1,1,ATACGAATGTGCTGCAACTT,0,1845910
hyuA_predicted,0.5,1,1,ATACCAGCGGGGACCCCAAT,0,1856045
hyuA_predicted,0.5,1,1,ATACAGCCAGTCAAATTCAA,0,1862052
hyuA_predicted,0.5,1,1,ATAATTCAGCCTCCTCGTTG,0,1866562
hyuA_predicted,0.5,1,1,ATAATGGTGGTCGGTTTACG,0,1830209
hyuA_predicted,0.5,1,1,ATAATACCCCATGTCGTGTA,0,1869660
hyuA_predicted,0.5,1,1,ATAATAAGATTCATCGCTGA,0,1857995
hyuA_predicted,0.5,1,1,ATAAGCGTGTAGGGAATAGT,0,1871109
hyuA_predicted,0.5,1,1,ATAACTAAACGAATACACGG,0,1860407
hyuA_predicted,0.5,1,1,ATAACAAAGGAGCTTACAGA,0,1873279
hyuA_predicted,0.5,1,1,ATAAATGAGTCAATGCGCTC,0,1850730
hyuA_predicted,0.5,1,1,ATAAAGGACAAGACGAGTCA,0,1870408
hyuA_predicted,0.5,1,1,ATAAAAACTCGCTTCAGCCA,0,1846691
hyuA_predicted,0.5,1,1,AGTTTCTGGCTTTGTTAAGG,0,1858605
hyuA_predicted,0.5,1,1,AGTTACTACTAATGAACGAG,0,1829254
hyuA_predicted,0.5,1,1,AGTGTACGCTTCTACGTCAC,0,1838830
hyuA_predicted,0.5,1,1,AGTGGCGAGTACGGACCGTG,0,1866189
hyuA_predicted,0.5,1,1,AGTGGCCTAGACACCAACCA,0,1836388
hyuA_predicted,0.5,1,1,AGTGCTTAAAGGCCGTTATA,0,1830676
hyuA_predicted,0.5,1,1,AGTGCGTTGTGACTCGGACC,0,1872148
hyuA_predicted,0.5,1,1,AGTGCCCAGATCGCGCTTTT,0,1864978
hyuA_predicted,0.5,1,1,AGTGCATATGGCGCGCGTAC,0,1857348
hyuA_predicted,0.5,1,1,AGTGCACGAAACCAGTCAGA,0,1877726
hyuA_predicted,0.5,1,1,AGTGATTATCTTGTTGTTTT,0,1847368
hyuA_predicted,0.5,1,1,AGTGAGGGTGCAACTGCGTA,0,1855909
hyuA_predicted,0.5,1,1,AGTGAAACAAACTCGTCTTG,0,1837225
hyuA_predicted,0.5,1,1,AGTCTTTTGAGAGTCACATG,0,1841621
hyuA_predicted,0.5,1,1,AGTCGGCCGGCGAGGCCCCA,0,1851427
hyuA_predicted,0.5,1,1,AGTCCATGCTAGAAAACTTT,0,1861310
hyuA_predicted,0.5,1,1,AGTCCAGCTGTTTAATGATA,0,1868136
hyuA_predicted,0.5,1,1,AGTCAGTTTCTGACAAACCA,0,1829859
hyuA_predicted,0.5,1,1,AGTCAGCCATCACAGAGATC,0,1828902
hyuA_predicted,0.5,1,1,AGTCACGGGTGAGATTGCGA,0,1869789
hyuA_predicted,0.5,1,1,AGTCACATGGTATCTACATA,0,1842039
hyuA_predicted,0.5,1,1,AGTCAACCAGTCCAGTGTAA,0,1876828
hyuA_predicted,0.5,1,1,AGTATTTACACCTGATCGGG,0,1831232
hyuA_predicted,0.5,1,1,AGTATTCCACGTACGTGAGC,0,1876410
hyuA_predicted,0.5,1,1,AGTATAGAATTTCTTTAAAG,0,1834635
hyuA_predicted,0.5,1,1,AGTATACATTGGACGACCCC,0,1840882
hyuA_predicted,0.5,1,1,AGTAGGCTAAATCCGCCTAT,0,1864774
hyuA_predicted,0.5,1,1,AGTACGGATAATACGTGGGT,0,1853565
hyuA_predicted,0.5,1,1,AGTACGCCAAACCGGGACGG,0,1859067
hyuA_predicted,0.5,1,1,AGTACAACTGAGATCTTTTC,0,1841037
hyuA_predicted,0.5,1,1,AGTAAAGGAGGTGGCAACTT,0,1839188
hyuA_predicted,0.5,1,1,AGGTTGACGAAATAGTATGT,0,1863949
hyuA_predicted,0.5,1,1,AGGTTACTAGAGACCTACGA,0,1842331
hyuA_predicted,0.5,1,1,AGGTGCGCTAAATGTTCACA,0,1871682
hyuA_predicted,0.5,1,1,AGGTCTGATAAGCTTCTCCA,0,1873103
hyuA_predicted,0.5,1,1,AGGTCGGTAAATAGTCGACG,0,1849368
hyuA_predicted,0.5,1,1,AGGTATGCTTCGGTGGAAGG,0,1849238
hyuA_predicted,0.5,1,1,AGGTACCGTTGGGATAGGGA,0,1848668
hyuA_predicted,0.5,1,1,AGGGTTCCGCGCATCAAGCC,0,1842452
hyuA_predicted,0.5,1,1,AGGGTGACCGGACGAATTCA,0,1847661
hyuA_predicted,0.5,1,1,AGGGGTGCGGCCTTCGTCGT,0,1872071
hyuA_predicted,0.5,1,1,AGGGGGGTCTCCTCCTCAAA,0,1870527
hyuA_predicted,0.5,1,1,AGGGGATTGGAGAACATATA,0,1871705
hyuA_predicted,0.5,1,1,AGGGCTCGCCCCCCCAGCGG,0,1871509
hyuA_predicted,0.5,1,1,AGGGCTATTACGTGGATCGC,0,1850968
hyuA_predicted,0.5,1,1,AGGGCGTTTTGAAAGATGAC,0,1866598
hyuA_predicted,0.5,1,1,AGGGCCTAAACACCCGCATC,0,1849302
hyuA_predicted,0.5,1,1,AGGGCACGCAATCGCTAGGC,0,1841843
hyuA_predicted,0.5,1,1,AGGGATATCAACCTGACCGG,0,1869020
hyuA_predicted,0.5,1,1,AGGGATACACCATTAATAAT,0,1838048
hyuA_predicted,0.5,1,1,AGGCTCCTGGCCAAGCCTAC,0,1835123
hyuA_predicted,0.5,1,1,AGGCTAGTGGGGGTCATCTT,0,1851032
hyuA_predicted,0.5,1,1,AGGCGTAAGCCCCCCCTTCT,0,1833896
hyuA_predicted,0.5,1,1,AGGCGAGATGCTCCGCCAGA,0,1835928
hyuA_predicted,0.5,1,1,AGGCGACGTGTATGGGGCGG,0,1856958
hyuA_predicted,0.5,1,1,AGGCGACAGGAATCACACTC,0,1877314
hyuA_predicted,0.5,1,1,AGGCCCGGAGCGCGTTAACT,0,1872088
hyuA_predicted,0.5,1,1,AGGCAGGAGAATACTACATC,0,1846662
hyuA_predicted,0.5,1,1,AGGATACGTCACCGTAAGAA,0,1867633
hyuA_predicted,0.5,1,1,AGGATAAATTACAGGATGTC,0,1876785
hyuA_predicted,0.5,1,1,AGGACTGCGTCGGGTCCGTT,0,1832501
hyuA_predicted,0.5,1,1,AGGACGCTGATTCAGTGTAC,0,1837373
hyuA_predicted,0.5,1,1,AGGACCGTGGCCTTAGACCC,0,1829109
hyuA_predicted,0.5,1,1,AGCTTTAACCGACCCTCAGG,0,1872426
hyuA_predicted,0.5,1,1,AGCTTGTGGGTCCGCGCGCT,0,1877237
hyuA_predicted,0.5,1,1,AGCTTGGTCTAGTTAAGCCT,0,1838149
hyuA_predicted,0.5,1,1,AGCTTCGTAACATATAAAGG,0,1854707
hyuA_predicted,0.5,1,1,AGCTGTATCCCTTAGTGCTC,0,1832701
hyuA_predicted,0.5,1,1,AGCTGCTTAGTGATATAGGT,0,1862069
hyuA_predicted,0.5,1,1,AGCTCCACCACTGGCTCCTA,0,1858483
hyuA_predicted,0.5,1,1,AGCTCACCTACGTCCATGGC,0,1838204
hyuA_predicted,0.5,1,1,AGCTAAGTAACAAAGCTTTC,0,1873741
hyuA_predicted,0.5,1,1,AGCTAAGGTATAACCCAGAC,0,1862719
hyuA_predicted,0.5,1,1,AGCGTTTCAGAACTGAGGAA,0,1857851
hyuA_predicted,0.5,1,1,AGCGTTAAGCTGGGCTTTCC,0,1870445
hyuA_predicted,0.5,1,1,AGCGGTGGCCCGTATTCAGG,0,1839597
hyuA_predicted,0.5,1,1,AGCGGTCCTAGCAATTCGTC,0,1836817
hyuA_predicted,0.5,1,1,AGCGGCGTACTCTGCGATCT,0,1839107
hyuA_predicted,0.5,1,1,AGCGGATAGGAGCTTCAGTA,0,1867420
hyuA_predicted,0.5,1,1,AGCGGATAGAGACTATAGAG,0,1833118
hyuA_predicted,0.5,1,1,AGCGCTAGTGGTCCGGGACC,0,1876658
hyuA_predicted,0.5,1,1,AGCGCCTGGTCAAAGGCATC,0,1862981
hyuA_predicted,0.5,1,1,AGCGCCCAGCTGGTAGGCGG,0,1856411
hyuA_predicted,0.5,1,1,AGCGCCATGTACTCTTGTTG,0,1840147
hyuA_predicted,0.5,1,1,AGCGAGTGTCGTTAAATTCA,0,1844040
hyuA_predicted,0.5,1,1,AGCGAACAGGTGTTCTGATC,0,1864349
hyuA_predicted,0.5,1,1,AGCGAAAGATAGGCGACCGT,0,1851571
hyuA_predicted,0.5,1,1,AGCCTCGGGTCTTTAGGCAG,0,1869861
hyuA_predicted,0.5,1,1,AGCCTAATCCAGCACTAATG,0,1851645
hyuA_predicted,0.5,1,1,AGCCTAAAGGTGTGCCGTGC,0,1853132
hyuA_predicted,0.5,1,1,AGCCGCGGCAGATATATACA,0,1848784
hyuA_predicted,0.5,1,1,AGCCGAAGGGAAGTCAGGCA,0,1856487
hyuA_predicted,0.5,1,1,AGCCCTCGGGCACGCGCGGC,0,1869761
hyuA_predicted,0.5,1,1,AGCCCTCAATTGGCCTAGGA,0,1859389
hyuA_predicted,0.5,1,1,AGCCCTATTTTTCAGAGTCT,0,1868966
hyuA_predicted,0.5,1,1,AGCCCTACATGAGGATCAAA,0,1853344
hyuA_predicted,0.5,1,1,AGCCCCAGAGTTAGGCGTCT,0,1847330
hyuA_predicted,0.5,1,1,AGCCAGGTAGGTGGTAAGGC,0,1854584
hyuA_predicted,0.5,1,1,AGCATTGTACCGGTTCGGAC,0,1869046
hyuA_predicted,0.5,1,1,AGCATTGGCTACTTTTTTGA,0,1859245
hyuA_predicted,0.5,1,1,AGCATGTGTAATCTTCCTCG,0,1834324
hyuA_predicted,0.5,1,1,AGCATACTGACGCGACAGGA,0,1835521
hyuA_predicted,0.5,1,1,AGCATACGTGCAAGTTAGAC,0,1848667
hyuA_predicted,0.5,1,1,AGCAGGCCGAGCCAGCTCCT,0,1869567
hyuA_predicted,0.5,1,1,AGCACAGCCCCGATCGGCCG,0,1835630
hyuA_predicted,0.5,1,1,AGCAAAATTCCGTTTCACAA,0,1844862
hyuA_predicted,0.5,1,1,AGATTTCGGCGTTTGCTTTG,0,1830340
hyuA_predicted,0.5,1,1,AGATTTCGCGCGTCCTGTTC,0,1844680
hyuA_predicted,0.5,1,1,AGATTCCGGTTCTGTTGGAC,0,1850360
hyuA_predicted,0.5,1,1,AGATTACACGTAGTAGCGTC,0,1844182
hyuA_predicted,0.5,1,1,AGATGGTCAGGCCCGTGATG,0,1870742
hyuA_predicted,0.5,1,1,AGATGGGGGCGACATGCAGT,0,1834166
hyuA_predicted,0.5,1,1,AGATGGACAGCAAGCTCACC,0,1860449
hyuA_predicted,0.5,1,1,AGATCATCAATTAATAGATG,0,1839557
hyuA_predicted,0.5,1,1,AGATACTCTGCCCCAGGTTA,0,1869024
hyuA_predicted,0.5,1,1,AGAGTTGCGTGCCAAAGTTG,0,1875885
hyuA_predicted,0.5,1,1,AGAGTGGACTAATCCTTGTT,0,1835490
hyuA_predicted,0.5,1,1,AGAGTCCATGACTTAACCCC,0,1839344
hyuA_predicted,0.5,1,1,AGAGGAGCACTTTCCCTCGG,0,1832288
hyuA_predicted,0.5,1,1,AGAGCGCACTTTAAGTATGC,0,1846009
hyuA_predicted,0.5,1,1,AGAGAGCGCTCACGTGAGTA,0,1868587
hyuA_predicted,0.5,1,1,AGACTTTCTCTCTCTTCCAA,0,1850732
hyuA_predicted,0.5,1,1,AGACTTGTGCGTCGGGTCAA,0,1858881
hyuA_predicted,0.5,1,1,AGACGAGGCTATGGCCGATG,0,1836507
hyuA_predicted,0.5,1,1,AGACCTTCACAAGGACTATT,0,1861818
hyuA_predicted,0.5,1,1,AGACCGGTGGGAGGGATCGT,0,1846494
hyuA_predicted,0.5,1,1,AGACCAAGTTAGATGCATTT,0,1877474
hyuA_predicted,0.5,1,1,AGACATCTGGACGACATAAG,0,1851991
hyuA_predicted,0.5,1,1,AGACATCTACGAAACAACGC,0,1845449
hyuA_predicted,0.5,1,1,AGACATAAGACAGGTTCAGG,0,1841729
hyuA_predicted,0.5,1,1,AGACAGTTTCATAGGTGCCA,0,1876424
hyuA_predicted,0.5,1,1,AGAATCCTCATCTAGGCCCA,0,1844881
hyuA_predicted,0.5,1,1,AGAATATTCGTGCAAGCGAA,0,1855414
hyuA_predicted,0.5,1,1,AGAACGTGCGAACTACCAAC,0,1851861
hyuA_predicted,0.5,1,1,AGAACCGTCGTAGTTTGAAA,0,1858135
hyuA_predicted,0.5,1,1,ACTTTGACCATAAGGTTCAT,0,1843522
hyuA_predicted,0.5,1,1,ACTTGTTAGATCTCCTCTCA,0,1831159
hyuA_predicted,0.5,1,1,ACTTGTCATGTTCGAGCAGT,0,1865430
hyuA_predicted,0.5,1,1,ACTTCTCAACCACGTTGTCA,0,1865712
hyuA_predicted,0.5,1,1,ACTTCGGCTGCGCCAGGACG,0,1860460
hyuA_predicted,0.5,1,1,ACTTATCCCAGCGTGGTGTC,0,1848658
hyuA_predicted,0.5,1,1,ACTTATCATTGTACAGCTGT,0,1831894
hyuA_predicted,0.5,1,1,ACTTAAGGGTTGTGTACGAG,0,1862399
hyuA_predicted,0.5,1,1,ACTGCTGCAGTTAGAGACAT,0,1850842
hyuA_predicted,0.5,1,1,ACTGCCAGTACATGGACTGC,0,1849663
hyuA_predicted,0.5,1,1,ACTGCAAAAGTATTATGGGT,0,1875552
hyuA_predicted,0.5,1,1,ACTGAATCCCTTGGACACCA,0,1848436
hyuA_predicted,0.5,1,1,ACTCTGCGGGTATTTGATCT,0,1850960
hyuA_predicted,0.5,1,1,ACTCTCACCGAATCGTCCGC,0,1848251
hyuA_predicted,0.5,1,1,ACTCGTGGCATTAAGGGGGG,0,1862340
hyuA_predicted,0.5,1,1,ACTCCGTATAGTTACAGCGA,0,1874016
hyuA_predicted,0.5,1,1,ACTCCGAAATTGCGACCGAG,0,1836996
hyuA_predicted,0.5,1,1,ACTCATTTTATTATTAATGT,0,1834198
hyuA_predicted,0.5,1,1,ACTCACTTACAGTCAACACG,0,1841412
hyuA_predicted,0.5,1,1,ACTCAAGGCAACTGAAATTT,0,1858985
hyuA_predicted,0.5,1,1,ACTCAAGACCCTCCGCGCTT,0,1834680
hyuA_predicted,0.5,1,1,ACTATTGGTTCCCGTAGCCA,0,1858997
hyuA_predicted,0.5,1,1,ACTATGATGTGCCCAAACCT,0,1857081
hyuA_predicted,0.5,1,1,ACTATCTCCTTATATTTCTG,0,1867426
hyuA_predicted,0.5,1,1,ACTATACGACAGAGGCTAAT,0,1836845
hyuA_predicted,0.5,1,1,ACTAGGGTAATGACATGCAG,0,1862086
hyuA_predicted,0.5,1,1,ACTAGCGTTCAGGGCAACAG,0,1858989
hyuA_predicted,0.5,1,1,ACTAGACCGGTCCTCCGAGC,0,1869099
hyuA_predicted,0.5,1,1,ACTACCGCGGCGGCGCTAAC,0,1847271
hyuA_predicted,0.5,1,1,ACTAATAACAAATGCATGTG,0,1846828
hyuA_predicted,0.5,1,1,ACTAAAGCATGTCAAATTCT,0,1840662
hyuA_predicted,0.5,1,1,ACGTGGTGACCCTCATTAAA,0,1838208
hyuA_predicted,0.5,1,1,ACGTCGATCCCAGTACGCCA,0,1864258
hyuA_predicted,0.5,1,1,ACGGGTGCAGCGGTGGAGTT,0,1853104
hyuA_predicted,0.5,1,1,ACGGCCGAACGCATCTCAGA,0,1847332
hyuA_predicted,0.5,1,1,ACGGCCACCTCGGACAGCAA,0,1870135
hyuA_predicted,0.5,1,1,ACGGATAAGTGATTATTGCC,0,1863158
hyuA_predicted,0.5,1,1,ACGGACCGGGTAGCAAGGGT,0,1843907
hyuA_predicted,0.5,1,1,ACGCTTACCTTCGGATTAAC,0,1834868
hyuA_predicted,0.5,1,1,ACGCTGGGGTCATTCGAGTG,0,1846251
hyuA_predicted,0.5,1,1,ACGCTCGATGATCAGACTGG,0,1838949
hyuA_predicted,0.5,1,1,ACGCGGTCCGACCTGTGACA,0,1842953
hyuA_predicted,0.5,1,1,ACGCGGCGTTCGGCGTACTA,0,1837872
hyuA_predicted,0.5,1,1,ACGCGCCTATACTTAGGCAG,0,1865287
hyuA_predicted,0.5,1,1,ACGCCTAGGTAGAGAAACTA,0,1846172
hyuA_predicted,0.5,1,1,ACGCCCAGCTTGTCAAGCGG,0,1873620
hyuA_predicted,0.5,1,1,ACGCCATTAGCGGTTACACG,0,1859313
hyuA_predicted,0.5,1,1,ACGCCAGTGTCTAAGAAAGG,0,1869571
hyuA_predicted,0.5,1,1,ACGCAGAGAGGCAATTATCA,0,1833936
hyuA_predicted,0.5,1,1,ACGCACTTACATGAAGCGTC,0,1835420
hyuA_predicted,0.5,1,1,ACGATCCATAGGAAGACCGA,0,1858026
hyuA_predicted,0.5,1,1,ACGATACTTCAATTGGTAAT,0,1836567
hyuA_predicted,0.5,1,1,ACGAGGAACAGGGAGGTGAC,0,1863830
hyuA_predicted,0.5,1,1,ACGAGAGGCCGCAAGGGAAT,0,1866486
hyuA_predicted,0.5,1,1,ACGACTACGACCCGAACACT,0,1843549
hyuA_predicted,0.5,1,1,ACGACGGCCTAGGGACTCGG,0,1862288
hyuA_predicted,0.5,1,1,ACGACGACTGGGGGATTCCA,0,1855390
hyuA_predicted,0.5,1,1,ACGACCGGCCGGTGTGAAGA,0,1864622
hyuA_predicted,0.5,1,1,ACGAAGGTAACTATCTGAAA,0,1872512
hyuA_predicted,0.5,1,1,ACGAAATCTGAGCTTGTTTA,0,1836465
hyuA_predicted,0.5,1,1,ACGAAACCGGTCGCTCATAC,0,1851923
hyuA_predicted,0.5,1,1,ACCTTTACGTGCATGTGCAG,0,1848312
hyuA_predicted,0.5,1,1,ACCTTCTACCCCTATTAATA,0,1853286
hyuA_predicted,0.5,1,1,ACCTTCGCAATGAGGCGAGA,0,1832929
hyuA_predicted,0.5,1,1,ACCTGAAACGCTGAGTGGAA,0,1833605
hyuA_predicted,0.5,1,1,ACCTCGCGGATGCTGTGTCA,0,1867810
hyuA_predicted,0.5,1,1,ACCTATGACCGGCGTCGTGG,0,1855072
hyuA_predicted,0.5,1,1,ACCTACCAGTTTGAAGGGTA,0,1830540
hyuA_predicted,0.5,1,1,ACCTACAATGACATATTCGA,0,1845579
hyuA_predicted,0.5,1,1,ACCGTGTATCGAATAGCCAT,0,1846840
hyuA_predicted,0.5,1,1,ACCGTCGCGAGGATTCGCCC,0,1830851
hyuA_predicted,0.5,1,1,ACCGCTAGTCAGGCACGGCA,0,1830350
hyuA_predicted,0.5,1,1,ACCGAACAAGCATGCTGGAA,0,1870707
hyuA_predicted,0.5,1,1,ACCCGTTCAGCTCAAGGGCA,0,1855391
hyuA_predicted,0.5,1,1,ACCCGTTAGGCACAAGTAAC,0,1865201
hyuA_predicted,0.5,1,1,ACCCGTGAGGTATATTTCCA,0,1868666
hyuA_predicted,0.5,1,1,ACCCGGACTGCAATCGGTAG,0,1833962
hyuA_predicted,0.5,1,1,ACCCGATACGAAGTTAGATC,0,1857341
hyuA_predicted,0.5,1,1,ACCCGACATCAAATATACTT,0,1860063
hyuA_predicted,0.5,1,1,ACCCCGCGTTAACTGAGTAT,0,1856328
hyuA_predicted,0.5,1,1,ACCCCAACGACAGGTGCGGC,0,1844698
hyuA_predicted,0.5,1,1,ACCCAGGATGTTATGCAGTC,0,1870488
hyuA_predicted,0.5,1,1,ACCCAAAAGGGGACATACAT,0,1833758
hyuA_predicted,0.5,1,1,ACCAGTCAGCGGTCTACCGT,0,1848369
hyuA_predicted,0.5,1,1,ACCAAGCTTCCACCGTCGTC,0,1877513
hyuA_predicted,0.5,1,1,ACCAACTTTGAACTTGTGTT,0,1877692
hyuA_predicted,0.5,1,1,ACATGTAGCTTGCATGCTCT,0,1872045
hyuA_predicted,0.5,1,1,ACATGCCTTGTCTTCCAGGT,0,1848113
hyuA_predicted,0.5,1,1,ACATGAGCCGGTTGAAAACC,0,1839546
hyuA_predicted,0.5,1,1,ACATCGTGATTCCCAAAGTG,0,1875779
hyuA_predicted,0.5,1,1,ACATCATGAGTTTAAACAAC,0,1829691
hyuA_predicted,0.5,1,1,ACATATGTATTCAAGATGCA,0,1838805
hyuA_predicted,0.5,1,1,ACAGTCTCTTTAAGAGGCGT,0,1845682
hyuA_predicted,0.5,1,1,ACAGTCAGATATTAGCTCTC,0,1848561
hyuA_predicted,0.5,1,1,ACAGGGCATGTATACTTTCA,0,1869395
hyuA_predicted,0.5,1,1,ACAGGAATCGGAGAGTGGAG,0,1875077
hyuA_predicted,0.5,1,1,ACAGCTCAAGAAGCCTATGT,0,1836842
hyuA_predicted,0.5,1,1,ACAGCTAGCCCTAAACGATG,0,1867275
hyuA_predicted,0.5,1,1,ACAGCCTCAGAACGCTTGCG,0,1843326
hyuA_predicted,0.5,1,1,ACAGCCAACAGGAGTGAGTA,0,1873221
hyuA_predicted,0.5,1,1,ACAGAGATCGTTGTTCACGC,0,1839489
hyuA_predicted,0.5,1,1,ACAGAAACCCATATTAGGGG,0,1855867
hyuA_predicted,0.5,1,1,ACACTGCTCTTCGTTCTGCT,0,1862210
hyuA_predicted,0.5,1,1,ACACTCGACAAAGAATAACT,0,1837895
hyuA_predicted,0.5,1,1,ACACGTCAGTTGACGGAGTT,0,1863416
hyuA_predicted,0.5,1,1,ACACCGCACCTAAGGCTTGA,0,1873213
hyuA_predicted,0.5,1,1,ACACCATGGAGTTGGTAATT,0,1829067
hyuA_predicted,0.5,1,1,ACACAGATGGCGGTGCTAGT,0,1841663
hyuA_predicted,0.5,1,1,ACACAGAGTCAGGATCCACT,0,1841716
hyuA_predicted,0.5,1,1,ACAAGTGGTCATAGATCCGC,0,1854445
hyuA_predicted,0.5,1,1,ACAACTTTGTAATAACTGGA,0,1872458
hyuA_predicted,0.5,1,1,ACAACTAAGCGCAAAACGTA,0,1841750
hyuA_predicted,0.5,1,1,ACAACATCATAGACAGGAAT,0,1871157
hyuA_predicted,0.5,1,1,ACAACATACCGCGTCCGTTT,0,1860020
hyuA_predicted,0.5,1,1,ACAAATCGGTCAGGGACTTC,0,1872595
hyuA_predicted,0.5,1,1,ACAAATCCGTAATGGGATAA,0,1868878
hyuA_predicted,0.5,1,1,ACAAAGACGTAACTCAGAAG,0,1833681
hyuA_predicted,0.5,1,1,AATTCTTGACCCTACAAAGG,0,1863368
hyuA_predicted,0.5,1,1,AATTCGCTGGACTGGTCTAT,0,1846845
hyuA_predicted,0.5,1,1,AATTATCGGCGCCAAAACGT,0,1832292
hyuA_predicted,0.5,1,1,AATTAGACAGCACGTGGCAG,0,1867683
hyuA_predicted,0.5,1,1,AATGTTAGTAGTTAGGAGTA,0,1874701
hyuA_predicted,0.5,1,1,AATGTCCAGATGTTCCCGAT,0,1860311
hyuA_predicted,0.5,1,1,AATGTATCTCAGCGTTGTGA,0,1832481
hyuA_predicted,0.5,1,1,AATGTACGGGGACGGCCACG,0,1846619
hyuA_predicted,0.5,1,1,AATGGTTAGGCGCCCACCAA,0,1853921
hyuA_predicted,0.5,1,1,AATGGCCAGAAAAGGTAGCA,0,1835605
hyuA_predicted,0.5,1,1,AATGCCGCGTCGAGTGATGC,0,1846278
hyuA_predicted,0.5,1,1,AATGAGGAGTTGAATGCAGA,0,1843519
hyuA_predicted,0.5,1,1,AATGAAGCATCCCTGAACAA,0,1875245
hyuA_predicted,0.5,1,1,AATCTATATCGGTTACAAGT,0,1835084
hyuA_predicted,0.5,1,1,AATCGACACATACTCTCCAC,0,1866808
hyuA_predicted,0.5,1,1,AATCCGGCAAGTGCGCCTGC,0,1846989
hyuA_predicted,0.5,1,1,AATCCAATATGCAGCCTGCG,0,1856643
hyuA_predicted,0.5,1,1,AATCATCGTCTAAGTAGGGA,0,1875894
hyuA_predicted,0.5,1,1,AATCAGCAACTATCTTCCTA,0,1876955
hyuA_predicted,0.5,1,1,AATCACTCACAGGCAGTTTT,0,1835714
hyuA_predicted,0.5,1,1,AATCAATGTCCCGGGATTCC,0,1873518
hyuA_predicted,0.5,1,1,AATATTTGCTGGACGGGAAC,0,1846474
hyuA_predicted,0.5,1,1,AATATCTGTAAAGTCGTCCT,0,1855265
hyuA_predicted,0.5,1,1,AATATCATCAAGACACTGGA,0,1856164
hyuA_predicted,0.5,1,1,AATATAATCAGTTCGCATCA,0,1837257
hyuA_predicted,0.5,1,1,AATAGGGACGACTAGATAGT,0,1843124
hyuA_predicted,0.5,1,1,AATAGACTTGCGGCGATGAA,0,1837819
hyuA_predicted,0.5,1,1,AATACTCTCGACACCGTGCT,0,1836722
hyuA_predicted,0.5,1,1,AATACGCAGGGTTCAATTAA,0,1858675
hyuA_predicted,0.5,1,1,AATACGAAATTCGTCCCTAT,0,1866935
hyuA_predicted,0.5,1,1,AATACGAAATGGTAATACTT,0,1871567
hyuA_predicted,0.5,1,1,AATACCCGGGAGAGATTGAG,0,1853724
hyuA_predicted,0.5,1,1,AATACACGGCTATGTGTCAA,0,1861533
hyuA_predicted,0.5,1,1,AATACAAATGTATAAACCTC,0,1862195
hyuA_predicted,0.5,1,1,AATAAGGCCCACATTGTTGC,0,1860574
hyuA_predicted,0.5,1,1,AATAAGCCGGGTATCAGATA,0,1861975
hyuA_predicted,0.5,1,1,AATAAGATAGATTCCCCAGT,0,1844208
hyuA_predicted,0.5,1,1,AATAAAGATATAGCATGGGT,0,1858256
hyuA_predicted,0.5,1,1,AATAAACTCAGGAAGGGGAA,0,1828920
hyuA_predicted,0.5,1,1,AAGTTTAATAGACCCGTCTT,0,1852256
hyuA_predicted,0.5,1,1,AAGTGCGAATGAGCATACAA,0,1877057
hyuA_predicted,0.5,1,1,AAGTGCCGGTAGGCAGCAAA,0,1835786
hyuA_predicted,0.5,1,1,AAGTGATCTGCGAGTTGTCA,0,1845517
hyuA_predicted,0.5,1,1,AAGTCTATGTTTGGTTTAGC,0,1831968
hyuA_predicted,0.5,1,1,AAGTCGGGGAGGGAGTTTAG,0,1865300
hyuA_predicted,0.5,1,1,AAGTCCATACAGCCATTCTT,0,1852376
hyuA_predicted,0.5,1,1,AAGTCAGTGGCCAACAATAC,0,1860523
hyuA_predicted,0.5,1,1,AAGTAGCCATGTCTAAGACA,0,1850416
hyuA_predicted,0.5,1,1,AAGTAACCGGAGGTTACATA,0,1865971
hyuA_predicted,0.5,1,1,AAGGTTGAGCAGTATGGCTA,0,1859507
hyuA_predicted,0.5,1,1,AAGGTTCCATTCCTCGTCAA,0,1861604
hyuA_predicted,0.5,1,1,AAGGTACGTATCGGGGTACG,0,1869312
hyuA_predicted,0.5,1,1,AAGGGTGCACGCACGATAGA,0,1832134
hyuA_predicted,0.5,1,1,AAGGGACGTACTACGTTGCG,0,1872683
hyuA_predicted,0.5,1,1,AAGGCTTCCTCGAGTCTACT,0,1848514
hyuA_predicted,0.5,1,1,AAGGCTGTACGTAGACTTGA,0,1834230
hyuA_predicted,0.5,1,1,AAGGCTATGACGGGATAGGC,0,1872398
hyuA_predicted,0.5,1,1,AAGGCGCTCTCTCTTTAACA,0,1871342
hyuA_predicted,0.5,1,1,AAGGCATGTGGTATGGGACA,0,1843537
hyuA_predicted,0.5,1,1,AAGGCACTATGGCACTTAGG,0,1858574
hyuA_predicted,0.5,1,1,AAGGACGCCGCCAGCTCGCC,0,1854580
hyuA_predicted,0.5,1,1,AAGGACACAAGCATGCGTAC,0,1831739
hyuA_predicted,0.5,1,1,AAGCTTTACTGGTCTATTGC,0,1870868
hyuA_predicted,0.5,1,1,AAGCCCCGTGGGGAGGGATG,0,1852398
hyuA_predicted,0.5,1,1,AAGCATTCGCGCATATGATT,0,1850250
hyuA_predicted,0.5,1,1,AAGCATAAGGGTAAGCCTAC,0,1832894
hyuA_predicted,0.5,1,1,AAGATGAGTTAGCCATTAGG,0,1870136
hyuA_predicted,0.5,1,1,AAGAGCGTAGGTCGAGGATA,0,1860111
hyuA_predicted,0.5,1,1,AAGAGAAGCTGTAGCCACAA,0,1853543
hyuA_predicted,0.5,1,1,AAGACGGAAAAATATCTCAG,0,1832376
hyuA_predicted,0.5,1,1,AAGAACGGTTTTTACATTAT,0,1833406
hyuA_predicted,0.5,1,1,AACTTGAGTGGCCCGTCGAT,0,1839307
hyuA_predicted,0.5,1,1,AACTTCTGTCTGTGGTACGT,0,1850680
hyuA_predicted,0.5,1,1,AACTGTGACATGAGGAAGTA,0,1870265
hyuA_predicted,0.5,1,1,AACTGACGGCTCACCTAGGC,0,1876982
hyuA_predicted,0.5,1,1,AACTCGCAAGGGTCATTACA,0,1858045
hyuA_predicted,0.5,1,1,AACTCCCTGATATACAAGTC,0,1836933
hyuA_predicted,0.5,1,1,AACTAGCTGTAGCACATTGA,0,1838425
hyuA_predicted,0.5,1,1,AACTAAGCGCGGGGAATTTC,0,1859450
hyuA_predicted,0.5,1,1,AACGTGACAGAGCCCTCTGA,0,1876205
hyuA_predicted,0.5,1,1,AACGGTGTCAACTCTGAGTC,0,1872584
hyuA_predicted,0.5,1,1,AACGGGGTAGTGAACAATAT,0,1856616
hyuA_predicted,0.5,1,1,AACGGAAGTCTGCTAGAGGG,0,1865554
hyuA_predicted,0.5,1,1,AACGCTGCTTAGAACTGCCA,0,1848767
hyuA_predicted,0.5,1,1,AACGCAACAGCACTGGGCGA,0,1861526
hyuA_predicted,0.5,1,1,AACGAAATTCAAAGTTGTAA,0,1846992
hyuA_predicted,0.5,1,1,AACCTGGAAAATCAGCTGAT,0,1876348
hyuA_predicted,0.5,1,1,AACCTCCGGAGCCACTTCAC,0,1869780
hyuA_predicted,0.5,1,1,AACCTACTAATTCGAGCATT,0,1844951
hyuA_predicted,0.5,1,1,AACCGTTTGCGGCACTGAAC,0,1875642
hyuA_predicted,0.5,1,1,AACCCGATAGCGGTGCGATC,0,1862495
hyuA_predicted,0.5,1,1,AACCCAAAATCGTCCAATCC,0,1855599
hyuA_predicted,0.5,1,1,AACCATACAGTCCACGAACA,0,1830553
hyuA_predicted,0.5,1,1,AACCAGAGAGCCCAGTCGTA,0,1862925
hyuA_predicted,0.5,1,1,AACCACAGTTGTCGGTGGTA,0,1868850
hyuA_predicted,0.5,1,1,AACCAAGTAGCAGTGTTAGA,0,1868674
hyuA_predicted,0.5,1,1,AACATATGACCAAACAGCAG,0,1837602
hyuA_predicted,0.5,1,1,AACAGTGACCTTACCCGCGG,0,1853813
hyuA_predicted,0.5,1,1,AACAGAGTTCGCCGTCCTTG,0,1860925
hyuA_predicted,0.5,1,1,AACACCAATTCCTCACTCTC,0,1853285
hyuA_predicted,0.5,1,1,AACAACTTCGGTTGGACATA,0,1838872
hyuA_predicted,0.5,1,1,AACAAAAGTAAAAGTACTAT,0,1842748
hyuA_predicted,0.5,1,1,AACAAAACGGAGGGGCCTGT,0,1854846
hyuA_predicted,0.5,1,1,AAATTGGAGTAAAGTACTGT,0,1877427
hyuA_predicted,0.5,1,1,AAATGGATTATGGTAAAAGG,0,1872483
hyuA_predicted,0.5,1,1,AAATGCTGTCAGAACCAGGA,0,1834054
hyuA_predicted,0.5,1,1,AAATATTATCGGTTTGGGAA,0,1835075
hyuA_predicted,0.5,1,1,AAATATAACCGTGCGGTGTG,0,1831772
hyuA_predicted,0.5,1,1,AAATAGGTGATGGGGCCTTC,0,1867890
hyuA_predicted,0.5,1,1,AAAGTGGGCCATGATAGGAT,0,1848501
hyuA_predicted,0.5,1,1,AAAGTGACTACCGGCAAGAA,0,1851141
hyuA_predicted,0.5,1,1,AAAGGTGTTGTGGTTTCCCC,0,1856916
hyuA_predicted,0.5,1,1,AAAGGCTCGTCAGGGGATTG,0,1873667
hyuA_predicted,0.5,1,1,AAAGGCCCGTTTCCGCGCTG,0,1868237
hyuA_predicted,0.5,1,1,AAAGCGCCCCCCGTATGATG,0,1843128
hyuA_predicted,0.5,1,1,AAAGATTCTGTGGTTACCCG,0,1837697
hyuA_predicted,0.5,1,1,AAACTGAGTCCCGTTGAGGC,0,1848639
hyuA_predicted,0.5,1,1,AAACTAAGCCACAGGCAGGG,0,1862711
hyuA_predicted,0.5,1,1,AAACGTAAGATACGTCTATT,0,1843188
hyuA_predicted,0.5,1,1,AAACGGTTCTGGCGCTCCCG,0,1847580
hyuA_predicted,0.5,1,1,AAACGGTCCCTCGGGGAGGG,0,1864429
hyuA_predicted,0.5,1,1,AAACGGCAAGATCGATTAGG,0,1863072
hyuA_predicted,0.5,1,1,AAACGGATCCTCCTCGGATG,0,1850472
hyuA_predicted,0.5,1,1,AAACGAGGCTATACAGTTAG,0,1874147
hyuA_predicted,0.5,1,1,AAACAGCAGGCTAGACCATG,0,1875981
hyuA_predicted,0.5,1,1,AAAATTATTTTGTCAGCAGG,0,1865022
hyuA_predicted,0.5,1,1,AAAATTATAGCGGAACTATT,0,1873927
hyuA_predicted,0.5,1,1,AAAATGGAAACAAGGCGCGT,0,1838380
hyuA_predicted,0.5,1,1,AAAATATGCATGGGCAGAGC,0,1847839
hyuA_predicted,0.5,1,1,AAAAGCCCCTACATTCGGCA,0,1840257
hyuA_predicted,0.5,1,1,AAAACGCATTATTCTCCAAG,0,1858760
hyuA_predicted,58.0,57,0,GCCCGGCCGCAAAGGTCCAC,57,1834379
hyuA_predicted,52.0,51,0,TAGAGTAACATGAAAAACCA,51,1872898
hyuA_predicted,43.0,42,0,GGACCACCACATGAAGCAAC,42,1875917
hyuA_predicted,41.0,40,0,TCGTGAACCCTATATTATAG,40,1866550
hyuA_predicted,38.0,37,0,TTTGTACCTTGCCGTCATTA,37,1838490
hyuA_predicted,38.0,37,0,TCGAAATCTGAATGAACAAG,37,1855485
hyuA_predicted,38.0,37,0,ATTCACATCACAGATTGGTT,37,1858976
hyuA_predicted,38.0,37,0,ACTCCAGGCTGGGTGTGTTA,37,1848199
hyuA_predicted,37.0,36,0,CCAGATTGCAACCAACACGC,36,1867392
hyuA_predicted,33.0,32,0,TCGCATGTAACCAAACGGGC,32,1861864
hyuA_predicted,32.0,31,0,GTTCTGTGTAATCTACATGG,31,1836692
hyuA_predicted,31.0,30,0,CTTTTCAAACTGCTAGGGCA,30,1864065
hyuA_predicted,31.0,30,0,CTTAGCCAAACCTACGTTCT,30,1836337
hyuA_predicted,31.0,30,0,AACAACGTCATGCCCGACGT,30,1876167
hyuA_predicted,30.0,29,0,TGCCTCATGGCGTTGTGGTA,29,1833682
hyuA_predicted,30.0,29,0,ACCGACATCAAACGCGTCGC,29,1858981
hyuA_predicted,29.0,28,0,TCGGCGCTCACATGCTCCCG,28,1874186
hyuA_predicted,29.0,28,0,GACGTTAGGGCGCTGCGTGT,28,1867556
hyuA_predicted,29.0,28,0,CGATGAATGAAGAACACTAG,28,1861291
hyuA_predicted,26.0,25,0,GTCGAGTCCGACGGAGACCT,25,1837558
hyuA_predicted,26.0,25,0,CTCTCGCTATAAATCGCCCA,25,1847736
hyuA_predicted,25.0,24,0,CTCAGTGGAAATACGGTCCT,24,1846132
hyuA_predicted,25.0,24,0,ACTGACCTGGGATTATCGAC,24,1869015
hyuA_predicted,24.0,23,0,TGACGGACGGTTCCAGTCGG,23,1852794
hyuA_predicted,24.0,23,0,TACATCGTTTGAAGGTATGG,23,1870676
hyuA_predicted,24.0,23,0,CCCGATCCCGGTGCGGGTTC,23,1832087
hyuA_predicted,23.0,22,0,TTTTCGTATACTTTGACAAC,22,1837989
hyuA_predicted,23.0,22,0,TGGAGTATCATTCGCACGAC,22,1833523
hyuA_predicted,23.0,22,0,GTATCAGCGGAGTTTTAAGA,22,1851227
hyuA_predicted,23.0,22,0,GCGGATCGTTACACTATTTA,22,1829953
hyuA_predicted,23.0,22,0,CTTTACAGCAATGTAGTGCC,22,1869425
hyuA_predicted,23.0,22,0,AACAGTAGGGACCATCAACA,22,1853596
hyuA_predicted,22.0,21,0,TTGTACATCGCTTATGTGAG,21,1830364
hyuA_predicted,22.0,21,0,GTCGGAATTGTGTTTTACTG,21,1870405
hyuA_predicted,22.0,21,0,GCACTATCGCTTAGAGAAAT,21,1876129
hyuA_predicted,22.0,21,0,AAGACTTAGCAGAAGCCGAT,21,1870337
hyuA_predicted,21.0,20,0,TGCGTACGAGAACTACTACT,20,1832256
hyuA_predicted,21.0,20,0,TGACAAATCCTTAACGTACG,20,1856295
hyuA_predicted,21.0,20,0,GACGCCGTTACCGGCACGTC,20,1845074
hyuA_predicted,21.0,20,0,CAAAGGTTGGGTCCGTGGGG,20,1871862
hyuA_predicted,20.0,19,0,TTGAATAGTGTGCGACTAAT,19,1830449
hyuA_predicted,20.0,19,0,TGGTTCAAGTTCCGCTCGCA,19,1876604
hyuA_predicted,20.0,19,0,GAGCGAGAGCGAGTTTTGTA,19,1850878
hyuA_predicted,20.0,19,0,GACTGGACCGTCTTGTTGAT,19,1832482
hyuA_predicted,20.0,19,0,CATTTCACTTGAGCCACTCT,19,1847375
hyuA_predicted,20.0,19,0,ACCGGTTCGGTTATGATACG,19,1873838
hyuA_predicted,20.0,19,0,ACAATAGAACTCGAGTCCTA,19,1829087
hyuA_predicted,19.0,18,0,TGCAGTAGCACGGTAAGCCT,18,1861078
hyuA_predicted,19.0,18,0,TCGCTGGTTTGGCAACCGTG,18,1872884
hyuA_predicted,19.0,18,0,TAACGCATCGGCCGCATATG,18,1849076
hyuA_predicted,19.0,18,0,GTATGTGTGAAGTGTTTCCT,18,1835752
hyuA_predicted,19.0,18,0,GGGGGAGGCACCTGCACGGT,18,1847550
hyuA_predicted,19.0,18,0,CGACACGGTTTCAAACCTTC,18,1869868
hyuA_predicted,19.0,18,0,CACGACACGGCTGCCAACCT,18,1865919
hyuA_predicted,19.0,18,0,AGTACGAGCAGGCATTTAAC,18,1855788
hyuA_predicted,18.0,17,0,TTCCCCGGCTAGTGCGTGCA,17,1866909
hyuA_predicted,18.0,17,0,TAACTTTCCTATAACCACGC,17,1861305
hyuA_predicted,18.0,17,0,GCTCATTGTCGCATAGTAGT,17,1857587
hyuA_predicted,18.0,17,0,ACCCCCATATTGAAGGTTCT,17,1843891
hyuA_predicted,17.0,16,0,TTCGCAGTTAGGTATAGACC,16,1860569
hyuA_predicted,17.0,16,0,TGATTGAGAGGGTGTTCCTC,16,1833581
hyuA_predicted,17.0,16,0,TCCAGGATATCGAAAGTGGA,16,1845980
hyuA_predicted,17.0,16,0,TAACATATTACAAGAACGTA,16,1839960
hyuA_predicted,17.0,16,0,CTAGTAACTTTAAACAGTCT,16,1862112
hyuA_predicted,17.0,16,0,CGAGTACGTACGGTATGGCG,16,1873442
hyuA_predicted,17.0,16,0,ATCTTAGTCTCTCTTTTCAC,16,1832296
hyuA_predicted,17.0,16,0,ACTTTCATTAGAATCATACC,16,1838921
hyuA_predicted,17.0,16,0,ACGTTAGGCTGGGACGCCCA,16,1866470
hyuA_predicted,16.0,15,0,TTGTCGGTTGCGCCTAAAAT,15,1838925
hyuA_predicted,16.0,15,0,TTCGGCATTAAAATATAAGC,15,1830985
hyuA_predicted,16.0,15,0,TGTCTAATAGAGGAGCTAAC,15,1848523
hyuA_predicted,16.0,15,0,TGTCGCGGCTCCCTTACAGA,15,1859730
hyuA_predicted,16.0,15,0,TGATTATTGGCCGTAACTTG,15,1869100
hyuA_predicted,16.0,15,0,TCGCGCTTTCGTGTAGGCAG,15,1873259
hyuA_predicted,16.0,15,0,TCCAGTGTGACTCTATGGGA,15,1840699
hyuA_predicted,16.0,15,0,TATTTTATGAAGTGTGGTTC,15,1851379
hyuA_predicted,16.0,15,0,TATAAACCGCCTGGATGGAA,15,1851198
hyuA_predicted,16.0,15,0,TACCCTAGGGCAGGGTCTCG,15,1862055
hyuA_predicted,16.0,15,0,GTGATCTCGGTATGGAGTCG,15,1836841
hyuA_predicted,16.0,15,0,GTCGTTCGACCAATTTGCTC,15,1862506
hyuA_predicted,16.0,15,0,GGAGGCCCACTGGAGATATG,15,1867567
hyuA_predicted,16.0,15,0,GACCATGCAGGTTTGGCCTG,15,1841347
hyuA_predicted,16.0,15,0,GAAGCGACATTACACCGATG,15,1870555
hyuA_predicted,16.0,15,0,GAAATATTCAGATATTTTCT,15,1836151
hyuA_predicted,16.0,15,0,CGCCTAGGTCGGTATAATAT,15,1849928
hyuA_predicted,16.0,15,0,CAAGGAATGCTGAAAGCCGA,15,1866022
hyuA_predicted,16.0,15,0,AGGCTCGTCATCTACTACTA,15,1843662
hyuA_predicted,16.0,15,0,ACCGAAACGAACCACGTCCA,15,1847460
hyuA_predicted,16.0,15,0,ACAGAACGGAAAAGTACAAA,15,1849738
hyuA_predicted,16.0,15,0,ACACCCCCGATAGCTACGCG,15,1850869
hyuA_predicted,15.0,14,0,TCAGATGGGATCGGCGTATT,14,1834866
hyuA_predicted,15.0,14,0,TAATCGACGCTCAAGAGTTC,14,1862120
hyuA_predicted,15.0,14,0,GTCACAGTGAATGAATCAAC,14,1857372
hyuA_predicted,15.0,14,0,GCCCGTTGTTTGTCATTCCT,14,1835995
hyuA_predicted,15.0,14,0,CGTGTCCTGTCAGGCGTGAC,14,1838168
hyuA_predicted,15.0,14,0,CGATCATGCATGAAGCCATG,14,1831446
hyuA_predicted,15.0,14,0,ATTCTTAGAAGATTTGGCAG,14,1874411
hyuA_predicted,15.0,14,0,ATGCTTATGCGTTAAGATTT,14,1876575
hyuA_predicted,15.0,14,0,AGTATCGGGCAGCCATGTCC,14,1831880
hyuA_predicted,15.0,14,0,ACTTAGCACAGGTGGCCCTT,14,1863250
hyuA_predicted,15.0,14,0,AAGTGCGCAGTATTGGACCT,14,1830734
hyuA_predicted,14.0,13,0,TTTGATCGGAAATTTGGATT,13,1867063
hyuA_predicted,14.0,13,0,TGAGCAGGTCAAGGTAGGCT,13,1835851
hyuA_predicted,14.0,13,0,GGTGCGCAAGCTTGAGCGCA,13,1870222
hyuA_predicted,14.0,13,0,GGGGGGCTAATGGGGCTTGG,13,1864084
hyuA_predicted,14.0,13,0,GCCTTCAATGGGGGAGCTTC,13,1871981
hyuA_predicted,14.0,13,0,GCCTTAGGGCGCTTCTTAAA,13,1850545
hyuA_predicted,14.0,13,0,CTCTTGTTAGCAGGGTTATC,13,1876547
hyuA_predicted,14.0,13,0,CTAGTGGGTATTTCTTCCGA,13,1854806
hyuA_predicted,14.0,13,0,ATTTGGCCGCTCAAAAAAGA,13,1864764
hyuA_predicted,14.0,13,0,AGTAGACCACGGTAGGGCTG,13,1847498
hyuA_predicted,14.0,13,0,AGGCGGAGCGAGGCAGGTCT,13,1834383
hyuA_predicted,14.0,13,0,AAGAGATGTTCGTGCGGATA,13,1868825
hyuA_predicted,13.0,12,0,TTTCTACGGTAGCTCTGCTC,12,1850761
hyuA_predicted,13.0,12,0,TGGTTCCTGCACGTGTCCCC,12,1857184
hyuA_predicted,13.0,12,0,TCTGGAACCATTAAACGCTG,12,1873025
hyuA_predicted,13.0,12,0,GGGACATCGACCACTGACGT,12,1869115
hyuA_predicted,13.0,12,0,GGCTTCTGTACATGTGGTTT,12,1854101
hyuA_predicted,13.0,12,0,GCTATCGGAAACTCTATAAT,12,1863615
hyuA_predicted,13.0,12,0,GCCTGCGCCTAAGGACAAAA,12,1861452
hyuA_predicted,13.0,12,0,CGGTAAAAACCGCACTTGCG,12,1854532
hyuA_predicted,13.0,12,0,CACGTCCTGGTCCGGTTGCT,12,1831231
hyuA_predicted,13.0,12,0,ACTGGAGAGCTGGCGCGGCC,12,1837394
hyuA_predicted,12.0,11,0,TGAAAAGCTCATGGATAGGT,11,1835423
hyuA_predicted,12.0,11,0,GGGCAGCAGTCCATTTGAAA,11,1847954
hyuA_predicted,12.0,11,0,GGAGCACCAGCTCCTGTTTC,11,1831858
hyuA_predicted,12.0,11,0,GGAATGATGGGCCTAGCAAA,11,1847634
hyuA_predicted,12.0,11,0,CGGTTCACATTGGTCGTACA,11,1833938
hyuA_predicted,12.0,11,0,CAACGGGCACTGTTACCAAT,11,1848751
hyuA_predicted,12.0,11,0,AGCGACAAGTCCATCTTAAA,11,1829438
hyuA_predicted,12.0,11,0,ACGTCCCCAGCACTCCCGAA,11,1835843
hyuA_predicted,12.0,11,0,ACGATGTATATCATGCGTAA,11,1852475
hyuA_predicted,12.0,11,0,AAATCCTAGGAATGGAGTCC,11,1844446
hyuA_predicted,12.0,11,0,AAAAGCGATGCAAATCTAGT,11,1841565
hyuA_predicted,11.0,10,0,TCTCAATAAAGATAACGCAT,10,1846295
hyuA_predicted,11.0,10,0,TAGAAATGTCTACCATTCCA,10,1851501
hyuA_predicted,11.0,10,0,GTCGCTCCCTCAGTGTATCA,10,1832578
hyuA_predicted,11.0,10,0,GGGCTCGCTGCTGATCTGAA,10,1851055
hyuA_predicted,11.0,10,0,GGGCGAAGCCCTTCCGGAGG,10,1850384
hyuA_predicted,11.0,10,0,CGAATGAGGGGTAGCCCTCC,10,1872858
hyuA_predicted,11.0,10,0,CCCGCGAGAGATGAGACCCA,10,1842458
hyuA_predicted,11.0,10,0,CCAAAACTGTCGCACTTTCC,10,1863296
hyuA_predicted,11.0,10,0,AGGGCACAGAGAATCAAGCC,10,1847049
hyuA_predicted,11.0,10,0,ACCTCGAGAGACTGATATTC,10,1859841
hyuA_predicted,11.0,10,0,AAATGTACAGGCAACAAATT,10,1843477
hyuA_predicted,10.0,9,0,TGGTCGGATTTCATGATAGT,9,1852538
hyuA_predicted,10.0,9,0,TGCGTGTCTCATGTGGGGCT,9,1867054
hyuA_predicted,10.0,9,0,TCTGTCGGCATTGTATCTGA,9,1846757
hyuA_predicted,10.0,9,0,TCGGGATCAGAGGGCGCCCA,9,1872434
hyuA_predicted,10.0,9,0,TATCTAGATGTTGATCCGCA,9,1863261
hyuA_predicted,10.0,9,0,TAGGACGTGGGAACACGTAT,9,1868941
hyuA_predicted,10.0,9,0,TACTGGTGTCTCGAGCACGG,9,1839359
hyuA_predicted,10.0,9,0,TAAAAGGACCCGGCACTGGC,9,1846466
hyuA_predicted,10.0,9,0,GTCATGCGGCTGTAAGGGCA,9,1841357
hyuA_predicted,10.0,9,0,GCGTCCCACTGAGTTGTGCT,9,1868008
hyuA_predicted,10.0,9,0,GAGTTTGGCGTATCGATTTG,9,1858823
hyuA_predicted,10.0,9,0,GAGGTACCGTTTGCGTGATT,9,1837717
hyuA_predicted,10.0,9,0,GACTTTCCGGTACGGTACAA,9,1868033
hyuA_predicted,10.0,9,0,CTGTTGGACTGCTGAACACG,9,1852880
hyuA_predicted,10.0,9,0,CTCGGCGTACATGGTTTGGC,9,1834705
hyuA_predicted,10.0,9,0,CGACCTGGTTCGCACTTGGA,9,1847472
hyuA_predicted,10.0,9,0,CCGGTGTATCCACCAGTTCG,9,1875030
hyuA_predicted,10.0,9,0,CCCTGATTTGGCTCGTCCTG,9,1860849
hyuA_predicted,10.0,9,0,CCCGAAGTGGCACAGGTCTG,9,1843017
hyuA_predicted,10.0,9,0,AAAGCGTTCATGGCGTTCCA,9,1841596
hyuA_predicted,10.0,9,0,AAAGAGATTTGAATTTCACC,9,1840633
hyuA_predicted,9.0,8,0,TTTGTATCAACAGGTTATGC,8,1866087
hyuA_predicted,9.0,8,0,TGAGGTAAATGGACTAGGTT,8,1860739
hyuA_predicted,9.0,8,0,TGAGCGCCGGGAATATTGTC,8,1833633
hyuA_predicted,9.0,8,0,TGAAGGTTCACGTTATAGCC,8,1855730
hyuA_predicted,9.0,8,0,TCGAATACAGGGGGCTTTCT,8,1850120
hyuA_predicted,9.0,8,0,TAAGGAAAAGCCAGTGGGGT,8,1862607
hyuA_predicted,9.0,8,0,TAAGAGTAACCTAGGCACTC,8,1849014
hyuA_predicted,9.0,8,0,GTGGAAGGGGGCTGCAGGTA,8,1857842
hyuA_predicted,9.0,8,0,GTAAGACATTGGCCAATCAT,8,1847028
hyuA_predicted,9.0,8,0,GGCATTACAGTGGCATGTGA,8,1834041
hyuA_predicted,9.0,8,0,GCGCCACCCATCCTTACAGG,8,1831694
hyuA_predicted,9.0,8,0,GATCTTCGGCGAGGTATGTT,8,1847984
hyuA_predicted,9.0,8,0,GACGGACCTGATAGGAGTCC,8,1835813
hyuA_predicted,9.0,8,0,GAATAAGCGGCCCCATCCTA,8,1840597
hyuA_predicted,9.0,8,0,CTTCCCCTTGGCGGCTTGAA,8,1852917
hyuA_predicted,9.0,8,0,AGTCGGCATTTATCATCGTC,8,1874744
hyuA_predicted,9.0,8,0,AAGCTTTGGCAGCTGCCAGG,8,1829830
hyuA_predicted,9.0,8,0,AACGGTAATGGCCGACGTTG,8,1872534
hyuA_predicted,8.0,7,0,TTACTGAAATCTGTTTTGCT,7,1869972
hyuA_predicted,8.0,7,0,TGGTGGGGCCTCTCAAGGTT,7,1869449
hyuA_predicted,8.0,7,0,TATGGCTCTTCTATAACCAT,7,1846918
hyuA_predicted,8.0,7,0,GTGCAAGGAGCGTTTACGTA,7,1871647
hyuA_predicted,8.0,7,0,GTCTTACTCGCCCCGGAAGC,7,1858047
hyuA_predicted,8.0,7,0,GTACTCTATGCTAATGGGTT,7,1846201
hyuA_predicted,8.0,7,0,GATTCGTAGACCGCAAAAGG,7,1868208
hyuA_predicted,8.0,7,0,GAGTGCAGTATAAGAACTCC,7,1873560
hyuA_predicted,8.0,7,0,CGGAGCGTCGGGCGCAAGGG,7,1831822
hyuA_predicted,8.0,7,0,CGAGAGCGCCTAGCCGCCTA,7,1832649
hyuA_predicted,8.0,7,0,CAGTCCGCTCAAACGCTGAT,7,1849639
hyuA_predicted,8.0,7,0,ATTCGATCTTGACAACTCGT,7,1855848
hyuA_predicted,8.0,7,0,ATGTTATGAAATATGACTTT,7,1849115
hyuA_predicted,8.0,7,0,ATCTTGGCTTCATAAGGCTA,7,1861884
hyuA_predicted,8.0,7,0,AGTCCGGTAGAGAAACTTAA,7,1849329
hyuA_predicted,8.0,7,0,ACTGGAGACCAAGTGCCGTG,7,1840317
hyuA_predicted,8.0,7,0,ACCACTAATATGGGTACAGT,7,1845888
hyuA_predicted,8.0,7,0,ACACGTAAGGCGTTGTGTCC,7,1859479
hyuA_predicted,8.0,7,0,AACGACCATAGCCTTACCAA,7,1858413
hyuA_predicted,7.0,6,0,TGTTATGAACCGACCGCACT,6,1839585
hyuA_predicted,7.0,6,0,TCAGGGGGCTGTCGGTGATG,6,1835817
hyuA_predicted,7.0,6,0,GTTAGCATATTCCCTCCTAC,6,1851890
hyuA_predicted,7.0,6,0,GTGCTGTCAATACGACGACG,6,1839291
hyuA_predicted,7.0,6,0,GTCTCACAGAGTACGAGGAT,6,1864656
hyuA_predicted,7.0,6,0,GCATTTTGATTTTTGAAGCT,6,1867525
hyuA_predicted,7.0,6,0,GACCTGAGACTGTGAAACTT,6,1841606
hyuA_predicted,7.0,6,0,CGCGCAAATCCGGCCAATAG,6,1853146
hyuA_predicted,7.0,6,0,CGAGCGGTCCTGGACGGTCG,6,1832794
hyuA_predicted,7.0,6,0,CGACGCACCCTACTTCCATA,6,1837988
hyuA_predicted,7.0,6,0,CCCTGCCGATCATGTCCCGA,6,1876409
hyuA_predicted,7.0,6,0,CCCGGACGTTCGGCCCTCCA,6,1833953
hyuA_predicted,7.0,6,0,CCCCGGATGATAACACAGTC,6,1870423
hyuA_predicted,7.0,6,0,CATCATCTGGATCATGTGTT,6,1850169
hyuA_predicted,7.0,6,0,ATTTATAGTAAAAAGAATTT,6,1841381
hyuA_predicted,7.0,6,0,ATATGACGGATTTGTCTACT,6,1849685
hyuA_predicted,7.0,6,0,ATAGTTTTGTCGTTGCCTAC,6,1871283
hyuA_predicted,7.0,6,0,ACTGCTGGCAGCCCCGATAC,6,1839655
hyuA_predicted,7.0,6,0,ACTGAGCGAGGGCCACCCCT,6,1839708
hyuA_predicted,7.0,6,0,ACATATTGTACGCACCCTTT,6,1864070
hyuA_predicted,7.0,6,0,AAGTGTACCGAACCGCCCCT,6,1875214
hyuA_predicted,6.0,5,0,TTCTAAGGCGGGGCGTTACT,5,1862821
hyuA_predicted,6.0,5,0,TAAGTCAGACGTCAACACTC,5,1839087
hyuA_predicted,6.0,5,0,GTTTATGTAACGCTGTAGTA,5,1868725
hyuA_predicted,6.0,5,0,GTGTCCCCTCCCCGGCATTA,5,1833113
hyuA_predicted,6.0,5,0,GTGCACTGCTATCGGTCAGA,5,1855949
hyuA_predicted,6.0,5,0,GTCGAAACGTCATCCACCTA,5,1837460
hyuA_predicted,6.0,5,0,GGCTAGAGCTGTTATCGGAC,5,1843727
hyuA_predicted,6.0,5,0,GCTTAAACTAAATTCCATCA,5,1863495
hyuA_predicted,6.0,5,0,CGTGACCCAGGATTCAACTT,5,1841853
hyuA_predicted,6.0,5,0,CGCGAGCTTATTGTGTATTG,5,1870948
hyuA_predicted,6.0,5,0,CCTATCTAGAGGCCATGCGC,5,1845944
hyuA_predicted,6.0,5,0,CCCGGGTAAGTGTTATAACG,5,1839280
hyuA_predicted,6.0,5,0,AGCACTAGGCTCACTAATCC,5,1853282
hyuA_predicted,6.0,5,0,ACGCTTCCAGCGACGCACAT,5,1860999
hyuA_predicted,6.0,5,0,ACCGTGAGTATATCAACCAC,5,1871146
hyuA_predicted,6.0,5,0,AAGTCGCATCTACACTGAAA,5,1866200
hyuA_predicted,6.0,5,0,AAGGACCTTATCTATCGAGT,5,1860004
hyuA_predicted,6.0,5,0,AAGACAATCGGATGGACTCT,5,1843009
hyuA_predicted,6.0,5,0,AACTTCGCACGGATCACGTC,5,1832394
hyuA_predicted,5.0,4,0,TTGTCGCGTAATACTGGCAC,4,1859442
hyuA_predicted,5.0,4,0,TTGGGATACGCGGTTGGGTC,4,1859806
hyuA_predicted,5.0,4,0,TTAAGATATAAAACACCCAA,4,1871469
hyuA_predicted,5.0,4,0,TGCCGTATCATTTGCGATTG,4,1855306
hyuA_predicted,5.0,4,0,TCTATTTGACTGCCCGGCTC,4,1874089
hyuA_predicted,5.0,4,0,TATGATCAATCGAGTAAGGA,4,1862148
hyuA_predicted,5.0,4,0,TACGTTATTTACGTCTTCAA,4,1834784
hyuA_predicted,5.0,4,0,GTTTGGTGTGTACACTCCCT,4,1837540
hyuA_predicted,5.0,4,0,GTAATGTGTCACATTGTTTT,4,1830254
hyuA_predicted,5.0,4,0,GCGTGCATCGGTTCATAGAT,4,1851171
hyuA_predicted,5.0,4,0,GCGAGTTTCACATGCAATTG,4,1842727
hyuA_predicted,5.0,4,0,GCCTCATGCATGTGGTCCCA,4,1848672
hyuA_predicted,5.0,4,0,CTTTTGGAGGGGTACGCTCC,4,1841898
hyuA_predicted,5.0,4,0,CTGGTTAGTTCATGGCTGCA,4,1833081
hyuA_predicted,5.0,4,0,CTATAGCCCCACCCAGAAGG,4,1832043
hyuA_predicted,5.0,4,0,CGGGTACCCTCCACCCTTTC,4,1853522
hyuA_predicted,5.0,4,0,CGGCGTTGCTAATCAGTTAG,4,1856490
hyuA_predicted,5.0,4,0,CGAACCCGATCCCGGCCTAC,4,1870251
hyuA_predicted,5.0,4,0,CATTCTTGTTCCACCCACAC,4,1874707
hyuA_predicted,5.0,4,0,CAAATGAGAAGTAGCGAAAT,4,1874272
hyuA_predicted,5.0,4,0,AGAGCGCTGAAAGCATATCA,4,1833721
hyuA_predicted,5.0,4,0,ACGTTTCTGTCCGGGAGCTT,4,1853990
hyuA_predicted,5.0,4,0,AATCGGTCGATTATTTGAGG,4,1858270
hyuA_predicted,5.0,4,0,AACGTCCCAATCTATAGCTC,4,1834920
hyuA_predicted,4.0,3,0,TTGGGCAACCCGGCACCTGG,3,1866804
hyuA_predicted,4.0,3,0,TTCACGCGGCATGTCCAACC,3,1872491
hyuA_predicted,4.0,3,0,TCTTGGTTAGCGAGCATCTG,3,1837953
hyuA_predicted,4.0,3,0,TCGCACTCTACGTCAGTTGG,3,1851892
hyuA_predicted,4.0,3,0,TCAGGAGGATACCATGTCCT,3,1848768
hyuA_predicted,4.0,3,0,TCACATGGCCTTATCGATCC,3,1853242
hyuA_predicted,4.0,3,0,TAGGGGTCAAGAATAATAGT,3,1839931
hyuA_predicted,4.0,3,0,TACCCCGGGGGCCTAACGGG,3,1851894
hyuA_predicted,4.0,3,0,TAAGATGGAGATCACGCGAG,3,1835787
hyuA_predicted,4.0,3,0,GTGTGTAGCTGAGGGCGCTA,3,1859049
hyuA_predicted,4.0,3,0,GTCTTGATGTATCCTGCAAC,3,1851627
hyuA_predicted,4.0,3,0,GGTCTGGTCCTCCCTCTAAG,3,1867037
hyuA_predicted,4.0,3,0,GCTCGGTGAATCTGTACAGG,3,1843258
hyuA_predicted,4.0,3,0,GCCAAGGGGTCCGCGCCAGG,3,1859995
hyuA_predicted,4.0,3,0,GCACAGGCGCAAATACCTTA,3,1841529
hyuA_predicted,4.0,3,0,GAGGACGCGGTCATCTGGGA,3,1877044
hyuA_predicted,4.0,3,0,GACACATGCAACTATCTGAA,3,1849862
hyuA_predicted,4.0,3,0,CTGATTGATATACGCATAGA,3,1874245
hyuA_predicted,4.0,3,0,CCTTCCGATGTCGTTTCACG,3,1842159
hyuA_predicted,4.0,3,0,CCGTGTCACTTGCAAGGATA,3,1853549
hyuA_predicted,4.0,3,0,CCCCAATCGTGCTAGTGCGT,3,1829631
hyuA_predicted,4.0,3,0,CCCAAGCAGATAGTCATTAC,3,1869750
hyuA_predicted,4.0,3,0,CAGTTACCTATCCTTTATTG,3,1865182
hyuA_predicted,4.0,3,0,CACTCACTTATGGGCTATAG,3,1858877
hyuA_predicted,4.0,3,0,CAAATTTAGGGTCGCTGGTA,3,1874772
hyuA_predicted,4.0,3,0,ATGTAACTGGGGTTCGGTAT,3,1855109
hyuA_predicted,4.0,3,0,ATCGCAGGCTGGGCCTCAGA,3,1845145
hyuA_predicted,4.0,3,0,AGCTAATACGCAGTTTAAAG,3,1841525
hyuA_predicted,3.0,2,0,TTGATCAATAAGCGTTCAGG,2,1867400
hyuA_predicted,3.0,2,0,TTGAGGCTAGCCCACCGGTT,2,1844058
hyuA_predicted,3.0,2,0,TCGCCTTCGGAGCTTTGCGG,2,1841191
hyuA_predicted,3.0,2,0,TCGCCGGTTCATGGATAAGC,2,1831269
hyuA_predicted,3.0,2,0,TAAACAATCTGCCCGGAGTT,2,1868664
hyuA_predicted,3.0,2,0,GTTGTTCCTACTTTTGATGT,2,1830894
hyuA_predicted,3.0,2,0,GTAGCCTGTACCCCTCCTCC,2,1835319
hyuA_predicted,3.0,2,0,GGGGAAACAGAAGCCCGGGT,2,1849950
hyuA_predicted,3.0,2,0,GGCCCATTTTAGTGTCAAGC,2,1845221
hyuA_predicted,3.0,2,0,GCTGGTATGATTAGTAGGCT,2,1835172
hyuA_predicted,3.0,2,0,GCGCAGGTTGGGCGCAACGA,2,1875035
hyuA_predicted,3.0,2,0,GATTAAGTTAGCCAGATAAA,2,1866036
hyuA_predicted,3.0,2,0,GAATGGTACTCTTGTATTAC,2,1860655
hyuA_predicted,3.0,2,0,CTTTCAAGTCCAAGAGTTCT,2,1842509
hyuA_predicted,3.0,2,0,CTGTGCGGATAGGTGGAATC,2,1855835
hyuA_predicted,3.0,2,0,CGTTATATCATGAAGTTCCA,2,1829382
hyuA_predicted,3.0,2,0,CGTCTCTTATGCTGACCATC,2,1837274
hyuA_predicted,3.0,2,0,CGCGGTTGTACCATTCAGCA,2,1853982
hyuA_predicted,3.0,2,0,CCTCACTGCGAAACAAGCGA,2,1869863
hyuA_predicted,3.0,2,0,CCGAGAAAGCCCGACCTATT,2,1854664
hyuA_predicted,3.0,2,0,CCCGGCCACAGAAGGTGTTC,2,1852089
hyuA_predicted,3.0,2,0,CATGGAGAATAGTAGCCGGC,2,1831103
hyuA_predicted,3.0,2,0,CATAGATCAGACCCTAGCCG,2,1850057
hyuA_predicted,3.0,2,0,ATTCAGCTCGTACATTAATA,2,1846633
hyuA_predicted,3.0,2,0,ATGGTGCATCGTCACGAAAC,2,1876764
hyuA_predicted,3.0,2,0,ATCCAGCAGTCGCGCTTCTT,2,1872507
hyuA_predicted,3.0,2,0,ATAATTATTTCTGTAGACCC,2,1860766
hyuA_predicted,3.0,2,0,AGTCTTGATTTACGGTCGAG,2,1847145
hyuA_predicted,3.0,2,0,AGCGCTCTTCAGCCGTGAAT,2,1842882
hyuA_predicted,3.0,2,0,ACTCCGTTTGGCTACGAGAC,2,1840037
hyuA_predicted,3.0,2,0,ACGCTGGGAAACACGTTGAG,2,1843997
hyuA_predicted,3.0,2,0,ACCTGAACCGGAGCTGCCAT,2,1876249
hyuA_predicted,3.0,2,0,AAGTCCATGCGGGTCGATCC,2,1838652
hyuA_predicted,3.0,2,0,AAGTAGGTGGCACTTCATAT,2,1837253
hyuA_predicted,2.0,1,0,TTTTCAGATGTGGTGTCCCA,1,1853133
hyuA_predicted,2.0,1,0,TTTAGGATGCTTTTGTTAAC,1,1870871
hyuA_predicted,2.0,1,0,TTTAACCAGCGTTTATGCAG,1,1836106
hyuA_predicted,2.0,1,0,TTAAGCTAGGCACTGAATTG,1,1834587
hyuA_predicted,2.0,1,0,TTAAAGTTTTAATGTGGACG,1,1861566
hyuA_predicted,2.0,1,0,TGTGACACAGGGGTTCTGGA,1,1872767
hyuA_predicted,2.0,1,0,TGCGGCGTGTGAACTTTTTG,1,1829425
hyuA_predicted,2.0,1,0,TGAGAGGATTAGCCTGCGTT,1,1845658
hyuA_predicted,2.0,1,0,TCCTGCATCGAGTAGCCCGT,1,1853875
hyuA_predicted,2.0,1,0,GTTCGGTACATGAGGTTTTG,1,1852752
hyuA_predicted,2.0,1,0,GTTCGCGAGAGGGTGCTAGA,1,1873090
hyuA_predicted,2.0,1,0,GTTCCTCTGACTTATCCTTC,1,1855769
hyuA_predicted,2.0,1,0,GTTCAGGGCAGGGCCTAATC,1,1837255
hyuA_predicted,2.0,1,0,GTGGGTCGAGCTATTGGCTC,1,1831346
hyuA_predicted,2.0,1,0,GTGGAAGGATCTGACTAACA,1,1840002
hyuA_predicted,2.0,1,0,GTGACTTTGTCAGCACACTT,1,1877177
hyuA_predicted,2.0,1,0,GGTTTTAGTATTGAGTCAAC,1,1831543
hyuA_predicted,2.0,1,0,GGTGATCTAAGTAGAATGTG,1,1831189
hyuA_predicted,2.0,1,0,GGTACTAAACAGCCATCCTT,1,1870211
hyuA_predicted,2.0,1,0,GGGCCTCGCGCATTAGTATA,1,1866622
hyuA_predicted,2.0,1,0,GGCGTAGAGGGCTGTCTTGA,1,1839116
hyuA_predicted,2.0,1,0,GGATGACTCCGATGCGGCGA,1,1851905
hyuA_predicted,2.0,1,0,GCGCACTGGGGCGGGGTCAA,1,1863893
hyuA_predicted,2.0,1,0,GCCGTAGTGCCATTAAATTG,1,1856611
hyuA_predicted,2.0,1,0,GCACTCGGAATGACCTCCCC,1,1876460
hyuA_predicted,2.0,1,0,GATCGGTTTTCCCTTGGAAA,1,1845416
hyuA_predicted,2.0,1,0,GAGCATTGTGCTGTTATGGG,1,1845583
hyuA_predicted,2.0,1,0,GAACGGTGGCGATCCTAGTT,1,1876514
hyuA_predicted,2.0,1,0,GAAACGAAATACCAGGGATG,1,1858583
hyuA_predicted,2.0,1,0,CTTCGGGTGGTTATTTTCGT,1,1848992
hyuA_predicted,2.0,1,0,CTTAGCTTGTGGGATCTCGT,1,1876444
hyuA_predicted,2.0,1,0,CGTCTGCACAATCACACTCT,1,1866300
hyuA_predicted,2.0,1,0,CGTAGCGCTGGAGGCGATTT,1,1874673
hyuA_predicted,2.0,1,0,CGTACTGCCGAGGCATGGTT,1,1866557
hyuA_predicted,2.0,1,0,CGGAGCGTATAACTCATGCG,1,1856501
hyuA_predicted,2.0,1,0,CGCTTTTCTACCACTGTGAG,1,1842257
hyuA_predicted,2.0,1,0,CGCGACCTAGCACCGGTGTA,1,1831848
hyuA_predicted,2.0,1,0,CGACTCGTCAATGAGACGTG,1,1834163
hyuA_predicted,2.0,1,0,CCTGTATAGATCCTTATGAC,1,1864994
hyuA_predicted,2.0,1,0,CCGAGTACACAATTCCCTGC,1,1845064
hyuA_predicted,2.0,1,0,CCGAGGTCTCCGTACTTACA,1,1876336
hyuA_predicted,2.0,1,0,CCGAAGGATCGAAGGGGGCG,1,1858323
hyuA_predicted,2.0,1,0,CCCGACCGCTCAACGATATT,1,1869554
hyuA_predicted,2.0,1,0,CCCCCTGTACTCCAAACCCG,1,1837505
hyuA_predicted,2.0,1,0,CCACAGATGTGGTAAAGTTT,1,1849651
hyuA_predicted,2.0,1,0,CATCCGTAGATTGCGGTCAA,1,1855297
hyuA_predicted,2.0,1,0,CAGCATTTCTTGGATGGCTC,1,1841712
hyuA_predicted,2.0,1,0,CAGCATTACACGTATAGGAT,1,1876252
hyuA_predicted,2.0,1,0,CAATACGAGTGATGCGGTGC,1,1851515
hyuA_predicted,2.0,1,0,CAAGGTAATATATAATATCT,1,1846410
hyuA_predicted,2.0,1,0,CAAGGATACGCGAGTACATC,1,1843042
hyuA_predicted,2.0,1,0,CAAACCGATCTTGTCCAAGC,1,1860890
hyuA_predicted,2.0,1,0,ATGTATAGGAGTGTATAGGC,1,1857298
hyuA_predicted,2.0,1,0,ATGAATCTGCGGTAGAAGAG,1,1856170
hyuA_predicted,2.0,1,0,ATCGGTTCGTTTACTCAACA,1,1830951
hyuA_predicted,2.0,1,0,ATAGTCGTGGCTCCCAGCAG,1,1843747
hyuA_predicted,2.0,1,0,AGTTTAAATAAGGTAACGGG,1,1851543
hyuA_predicted,2.0,1,0,AGTGCAGTCACTCTTGCCGG,1,1839775
hyuA_predicted,2.0,1,0,AGTACGTTACCAACCCGTGG,1,1876308
hyuA_predicted,2.0,1,0,AGCCTGCCCAACCGTAGATT,1,1871951
hyuA_predicted,2.0,1,0,AGAACATGAAAGCTAGTATA,1,1859386
hyuA_predicted,2.0,1,0,ACGTTATCATTACTTATACG,1,1841557
hyuA_predicted,2.0,1,0,ACGATAAGGCAGGGAAATAC,1,1861103
hyuA_predicted,2.0,1,0,ACAATGGCTGGCTAACATAC,1,1854722
hyuA_predicted,2.0,1,0,ACAATCGGAATTTCCTTTGA,1,1855365
hyuA_predicted,2.0,1,0,AAGTTGCCGTAGCTGTGTCA,1,1837925
