name,relative_counts,ct,ct_0,barcode,ct_1,barcode_ind
ihfAp4,2.4682539682539684,872,251,GTGGGTGATTAAACTATCTT,621,1933334
ihfAp4,0.547945205479452,224,145,ATGCTCACTATGGATGCATC,79,1929614
ihfAp4,3.0,462,115,ACATCTTTCCAAGTGTGCAT,347,1909802
ihfAp4,0.21100917431192662,130,108,GCTTATGCGGCTCCGGGGGG,22,1909551
ihfAp4,1.0396039603960396,204,100,GACGTCACGCGCAGTGATGT,104,1909689
ihfAp4,1.2673267326732673,227,100,CGGATACTCTTATCAACCTT,127,1925385
ihfAp4,0.8021978021978022,162,90,GCGTAGAACCACATGGTACG,72,1913012
ihfAp4,2.0352941176470587,256,84,GGTGGGAAGGGGACTTTGCG,172,1931074
ihfAp4,1.3243243243243243,170,73,TTATGTGTAGACTACCTAGC,97,1939252
ihfAp4,0.4305555555555556,101,71,TTGGGATTCGAATTGTTTAT,30,1943468
ihfAp4,0.9859154929577465,139,70,AACCTCGGAAAAGAAGTAGT,69,1909932
ihfAp4,0.23529411764705882,82,67,AAATGCATAAGCATCTGGAT,15,1960854
ihfAp4,1.8333333333333333,185,65,TATTACCATGAATTCTTGCT,120,1934892
ihfAp4,0.45454545454545453,94,65,GACCGCTCGAGGTTCACGCG,29,1909858
ihfAp4,3.742424242424242,311,65,CAGCCATTTATCTGACGAGT,246,1910504
ihfAp4,2.8923076923076922,251,64,GGGATGATCTGGACCTTGAT,187,1912489
ihfAp4,2.3384615384615386,215,64,GCTTGGAAGGTATCAGCTGA,151,1948268
ihfAp4,0.26153846153846155,80,64,GCAGTGTGAAATGATGGGAA,16,1961079
ihfAp4,0.8095238095238095,112,62,TGGTAGTGGACTCTCTCTTA,50,1909900
ihfAp4,0.7777777777777778,110,62,AGATCGCTAAAGCTGGATGT,48,1914186
ihfAp4,0.8870967741935484,115,61,AGGTTGCGCGTAAGGCGAGT,54,1927369
ihfAp4,1.4426229508196722,147,60,CAGTGTCTGCTCTGGACGCG,87,1945684
ihfAp4,0.4,82,59,TGAGGGCATTATCCGCCTTT,23,1926031
ihfAp4,0.5666666666666667,92,59,CTAATACCCGCTATTCATAT,33,1919962
ihfAp4,0.6610169491525424,96,58,GGTTCTACGAGTGGGTCGAT,38,1916352
ihfAp4,0.5689655172413793,89,57,GGCGCCCAAAGGGTAGGTTA,32,1951528
ihfAp4,0.9821428571428571,109,55,TTGAATGCGATTCACTCTTG,54,1912181
ihfAp4,1.0178571428571428,111,55,GCAAGCTGGTACACCCCCAA,56,1913603
ihfAp4,1.1428571428571428,118,55,CAGATAAACGGGGAAAAGTA,63,1930792
ihfAp4,2.7142857142857144,206,55,AGCCTCGGGCATAGATACAC,151,1910754
ihfAp4,0.12727272727272726,60,54,CGCGGTAGTGGGGAAACATA,6,1911137
ihfAp4,3.0,214,53,TCAATTGCCCACGTGTATAT,161,1913806
ihfAp4,0.7407407407407407,92,53,GCGGGAGGTCCAAATAAGAG,39,1914041
ihfAp4,0.16981132075471697,60,52,TTTATCAACCATGGGGACAC,8,1923277
ihfAp4,0.03773584905660377,53,52,TGGGACGGTCTTCCTTCAGT,1,1925329
ihfAp4,1.3962264150943395,125,52,GGCAGTAACCGAAATCTTGC,73,1960910
ihfAp4,0.3018867924528302,67,52,GAAACGGCGAGAATGTGTTT,15,1909647
ihfAp4,1.0,104,52,ATATAGACGTGATCAGCCGG,52,1918451
ihfAp4,1.7924528301886793,146,52,AGTGTTGTAACAAGAACATC,94,1927698
ihfAp4,0.5384615384615384,78,51,GTCCGTAGCACGCATGCGAT,27,1939709
ihfAp4,1.9038461538461537,149,51,CTACCAATACGGAATGTTTT,98,1934028
ihfAp4,1.1730769230769231,111,51,CGACTAAGCATAGGGCGGCC,60,1922691
ihfAp4,3.1923076923076925,216,51,CACCAGCTTCCCGCGCCGTC,165,1912265
ihfAp4,0.23076923076923078,62,51,ACGCGCGGCATGTCACACTG,11,1918392
ihfAp4,1.5490196078431373,128,50,TATCGCGCGATACTGCAAGA,78,1931713
ihfAp4,5.921568627450981,351,50,TAAACCTCCGTCTAGGGTGT,301,1922090
ihfAp4,0.29411764705882354,64,50,CACTTACAGGGGGCTTGTCT,14,1948869
ihfAp4,0.28,62,49,TGGTGGAATCTACTTCTGAA,13,1931534
ihfAp4,2.94,195,49,CGCCAGTGTCGGAGTCGTAC,146,1932110
ihfAp4,3.32,214,49,CGCAGATGGGACCTCATTTA,165,1934055
ihfAp4,1.22,109,49,CAGACAGTCGGTCAGGACCA,60,1911210
ihfAp4,1.24,110,49,AAGATCAAGTCCTGAAACCT,61,1910064
ihfAp4,1.0816326530612246,100,48,GTCGGTCGAGTGATGATGCT,52,1918309
ihfAp4,0.7959183673469388,86,48,GTCCACTAACCTCGGATGAA,38,1919667
ihfAp4,0.04081632653061224,49,48,GCTCCTGAGTAGCTTGTTCA,1,1917933
ihfAp4,0.673469387755102,80,48,CGTGATCTAAATTACTTGGC,32,1919716
ihfAp4,1.3673469387755102,114,48,CGGCTTGTATCATGACTGCA,66,1913335
ihfAp4,4.3061224489795915,258,48,CAAGGTAGGAACAAAGATTA,210,1918584
ihfAp4,0.6530612244897959,79,48,AAATCCCTCCGGATGCCTTT,31,1914192
ihfAp4,0.5,70,47,TACTTATATTGCTAGGGGTT,23,1914868
ihfAp4,0.7291666666666666,81,47,GCATCTGCGTTCCACAGTAA,34,1915921
ihfAp4,0.4375,67,47,ACACCTCAACATTCTACTAT,20,1921489
ihfAp4,1.0208333333333333,95,47,AATATAACATACGGACCGAT,48,1910112
ihfAp4,0.6382978723404256,75,46,TGTGTCAGCATCAGTCTTTA,29,1910639
ihfAp4,0.2978723404255319,59,46,TGGCGAGGTATCATCCACCT,13,1958537
ihfAp4,1.2127659574468086,102,46,TAGAACGTCTCAAGCCAAGA,56,1910305
ihfAp4,0.425531914893617,65,46,GTCCGCCGTCTTTATACGTA,19,1917996
ihfAp4,1.851063829787234,132,46,GACGCGGGTAGCCGTGCTGC,86,1910012
ihfAp4,2.7872340425531914,176,46,CTACCAGACCGGGCTGACCA,130,1930772
ihfAp4,1.4042553191489362,111,46,ACCTTCATGTAGGTGATGTG,65,1935688
ihfAp4,1.0869565217391304,94,45,TGTATGTTCTAAATCGCCCA,49,1913885
ihfAp4,2.608695652173913,164,45,TCTTGTCGCCACTTAAGTCA,119,1942381
ihfAp4,1.173913043478261,98,45,TACGACGGTTTATCTACAAT,53,1935994
ihfAp4,0.6739130434782609,75,45,CCCTAAGTTCAAGGTAGGAG,30,1955210
ihfAp4,1.0217391304347827,91,45,CATGACTCTACTCCTCTATA,46,1954857
ihfAp4,0.6956521739130435,76,45,CACTGTACCCTATGGTTCAT,31,1935619
ihfAp4,1.2608695652173914,102,45,ATAACATAGTCGAGTAAAGA,57,1929092
ihfAp4,0.3333333333333333,58,44,TTTGTCTGACCCTTTGCTTG,14,1925953
ihfAp4,1.6666666666666667,118,44,TCCAAATCGCAAAGCGATCT,74,1919312
ihfAp4,1.3777777777777778,105,44,TATTACCCCCTTTTCGGACG,61,1922650
ihfAp4,0.06666666666666667,46,44,TACAGGTATTTGGGGAGCCT,2,1940521
ihfAp4,1.5333333333333334,112,44,GGCCAGAACCTCGGACCCGA,68,1910363
ihfAp4,0.7333333333333333,76,44,GGCATGAACTATTGCGAGCT,32,1962013
ihfAp4,2.6666666666666665,163,44,GCCCGCTAGCCACGAATCTG,119,1925723
ihfAp4,1.9333333333333333,130,44,GCAGAGATGATTCCTACTCG,86,1942657
ihfAp4,0.28888888888888886,56,44,CTAGGGACTTGTACTCTTAT,12,1911419
ihfAp4,9.886363636363637,477,43,TGCCCGGCTCCCTTATTTGA,434,1909616
ihfAp4,1.25,97,43,TACGCACTCGACAATGCTTG,54,1910224
ihfAp4,0.8409090909090909,79,43,GGGGGACTAGGGAGAGACTT,36,1934687
ihfAp4,1.0454545454545454,88,43,CGTCCTACGGCTCACAGTGT,45,1928036
ihfAp4,0.22727272727272727,52,43,AGGGTCAGAGGGAGCCAACT,9,1955130
ihfAp4,2.813953488372093,162,42,TTGCAACTGGAGGCAACTAC,120,1922095
ihfAp4,0.7441860465116279,73,42,TAGGATGGGGCTGCAGGGAG,31,1923062
ihfAp4,0.5116279069767442,63,42,CTCACTTGCGTCGGAATGCA,21,1913047
ihfAp4,1.2325581395348837,94,42,ACTGCGTTGTCGTCAATTAG,52,1921196
ihfAp4,1.7142857142857142,112,41,TGCCAGATCAACGCATTATA,71,1926606
ihfAp4,0.8333333333333334,75,41,GTCAACGGAAGCCAACTTGG,34,1921797
ihfAp4,1.1428571428571428,88,41,GTATGGACCGTGCTCCACTG,47,1923684
ihfAp4,0.6666666666666666,68,41,GGACCGAACCGTGACCGCTG,27,1919301
ihfAp4,1.119047619047619,87,41,CGACTGCTCCTGTTGCAGAA,46,1926793
ihfAp4,0.7142857142857143,70,41,AATTGGGTACTGCTATTTGT,29,1924805
ihfAp4,3.1463414634146343,168,40,TGTTCGGCATATTTCGGAGA,128,1909950
ihfAp4,0.6585365853658537,66,40,TGTATAGCCATTCGCCAGAC,26,1938708
ihfAp4,1.7804878048780488,112,40,TGCGAATATTAGCATAAGGT,72,1931345
ihfAp4,0.5609756097560976,62,40,GGAGTCTACCGTGGTACTGA,22,1926350
ihfAp4,0.36585365853658536,54,40,GCTTGATGATGTTTCGAGAC,14,1910192
ihfAp4,1.5853658536585367,104,40,GAGGGGATTGCTTGCACGGC,64,1943432
ihfAp4,0.04878048780487805,41,40,CTGTAAACCGTCAAGATAAA,1,1921436
ihfAp4,1.3170731707317074,93,40,CGGCCAGCGGTTTCCACGTA,53,1941302
ihfAp4,5.975609756097561,284,40,CCGGCTAAGGTTACAGTTTT,244,1912620
ihfAp4,2.6341463414634148,147,40,CCGCTTTGAGCGCAGGGAGG,107,1928112
ihfAp4,0.8536585365853658,74,40,CAGGGGTAGATGCAGTCCCA,34,1913403
ihfAp4,0.6341463414634146,65,40,ATTACTGGGTAATTGTAGTC,25,1948125
ihfAp4,0.9512195121951219,78,40,ACGTCCTCCCGCACTCGTAA,38,1918911
ihfAp4,3.4146341463414633,179,40,AAAGGGGTCTATTGCCAAGG,139,1927671
ihfAp4,0.05,40,39,TGTGAAACAAAGGCGGCGGC,1,1923800
ihfAp4,0.9,74,39,GGGCGGCGCTGTAATGTCAC,35,1922422
ihfAp4,2.675,145,39,GATAACAGATACTTCAGAGA,106,1954808
ihfAp4,1.175,85,39,CTTGGGTGTTACCCCGCAGA,46,1910782
ihfAp4,0.825,71,39,CGAAGATAAACCCACGGGAT,32,1919707
ihfAp4,0.35,52,39,CCCAAGCATCCCCACTCAAT,13,1938223
ihfAp4,0.175,45,39,ATGCTATGCCAATGATTCAA,6,1950168
ihfAp4,0.575,61,39,AGTGAATCCCAATCCTTACC,22,1940808
ihfAp4,4.175,205,39,AGGGCCTCCGCAAACATACT,166,1944833
ihfAp4,0.05,40,39,AGAGAATTTCGCTCACGCGG,1,1948569
ihfAp4,1.435897435897436,93,38,TCTGGTGATCTCAAATTAGT,55,1913419
ihfAp4,4.17948717948718,200,38,TAGGTGACCAGGCACTTAAG,162,1911942
ihfAp4,0.5128205128205128,57,38,TAATATGGGCCAGTGCCATT,19,1952918
ihfAp4,1.794871794871795,107,38,GTGCCGTATCGATTGGTCGT,69,1951140
ihfAp4,1.0,76,38,GTCGGGTAAGCAACGCCTCT,38,1950660
ihfAp4,0.7692307692307693,67,38,GGGTGCGGCCTACGTTCTGC,29,1913015
ihfAp4,0.9230769230769231,73,38,CTTCGGTGAGCGAACGCGTA,35,1952222
ihfAp4,1.3076923076923077,88,38,CCGGGAACGTCCTTCGCTCA,50,1933052
ihfAp4,0.9487179487179487,74,38,CCGCGCACATGTATATAACA,36,1941472
ihfAp4,1.3076923076923077,88,38,CAGGAGCACCCCAGTCTTTG,50,1921967
ihfAp4,2.641025641025641,140,38,ATTCCTGGGATGCTTGTCTT,102,1940586
ihfAp4,0.5384615384615384,58,38,ATGACGTCCGGCACAATGCT,20,1921700
ihfAp4,1.794871794871795,107,38,ATAGGCATCGAATAAGTTGA,69,1934056
ihfAp4,1.3846153846153846,91,38,AGGCGGTTCATGTTCAACAG,53,1914022
ihfAp4,0.41025641025641024,53,38,ACCTCCGTTGTTAGGATCGT,15,1909747
ihfAp4,4.153846153846154,199,38,ACACGGGTGAAGATTAAGGT,161,1909901
ihfAp4,0.7948717948717948,68,38,AACTTATACTTACCCTGTCG,30,1916418
ihfAp4,1.6842105263157894,100,37,TTCACTGCACTCTTAGTACA,63,1961955
ihfAp4,1.394736842105263,89,37,TGGGAAAAAGTCGTAGCATG,52,1925652
ihfAp4,1.605263157894737,97,37,TCCGAGACGACGGGAGTAAT,60,1915138
ihfAp4,5.7631578947368425,255,37,TACCTCCTCCGGATAGCACG,218,1912315
ihfAp4,2.763157894736842,141,37,GGAGGGCCGAGTGCGACAGT,104,1915423
ihfAp4,6.657894736842105,289,37,GCTTGATAGCTATAGGCCTT,252,1914189
ihfAp4,0.07894736842105263,39,37,CTCCAGGTTTGCGCTGCATT,2,1914480
ihfAp4,1.2894736842105263,85,37,CGATGAATCAGGGCTGCGTA,48,1914675
ihfAp4,1.0263157894736843,75,37,CCGCCATTGCAACGATGCGT,38,1912599
ihfAp4,1.1578947368421053,80,37,ATCTTGTAATCTCTTTACTA,43,1939846
ihfAp4,2.289473684210526,123,37,ACCACCAGAGGGGTTTTGCT,86,1916683
ihfAp4,0.13157894736842105,41,37,AAGGGCTTCCGGGTCCCATG,4,1933722
ihfAp4,0.07894736842105263,39,37,AACCTTGCCGATGTGGCCGT,2,1912829
ihfAp4,1.6486486486486487,96,36,TGGCAGGCAGTAGGCCTATA,60,1953185
ihfAp4,0.8378378378378378,66,36,TACCTAGCCCCGCGCCCGTA,30,1943529
ihfAp4,1.6486486486486487,96,36,GTCCGAACCGTACAAGCCTA,60,1917073
ihfAp4,0.1891891891891892,42,36,GTAGCTGCTCGATCGCCACG,6,1942071
ihfAp4,0.7027027027027027,61,36,GTAAGCACCCGCACAGCTTA,25,1942135
ihfAp4,1.2702702702702702,82,36,GGACAGGGTGGAGAAAGAGC,46,1911260
ihfAp4,1.2702702702702702,82,36,GAGACATCGAGGACAGTCGT,46,1949183
ihfAp4,3.675675675675676,171,36,CTTGATGCTATCATGGTATA,135,1928141
ihfAp4,6.135135135135135,262,36,CGACTCTTCATCCCTGGCTC,226,1932197
ihfAp4,1.972972972972973,108,36,ATTGTTGTCGCTTCTTCTCG,72,1913805
ihfAp4,0.7297297297297297,62,36,ATTCACAGGGAAGATGCCAA,26,1910120
ihfAp4,0.35135135135135137,48,36,ATGGTACAGGGGCAAGGGTT,12,1930346
ihfAp4,1.6216216216216217,95,36,AGCCGGTGTTGACCATGTAT,59,1922392
ihfAp4,1.3513513513513513,85,36,AGCCCGGCCACAAGGGAAGG,49,1911979
ihfAp4,0.7567567567567568,63,36,ACCCGCCCTGGAGCCCACGT,27,1948091
ihfAp4,1.5135135135135136,91,36,AAAAACGAGCGGGTTCAAGG,55,1930987
ihfAp4,1.2777777777777777,80,35,TTATTAATTTGTCCCCTCGA,45,1942216
ihfAp4,1.3888888888888888,84,35,TTACCTAAGTATCGTCCAAT,49,1932499
ihfAp4,0.8888888888888888,66,35,TGGTTGCATGGGTACGCAAA,31,1911553
ihfAp4,1.5555555555555556,90,35,TGGTCAATAGCCGGAAATTC,55,1918106
ihfAp4,0.1111111111111111,38,35,TGGCCGTTGTTGACTACCGA,3,1947259
ihfAp4,1.1666666666666667,76,35,TAGGCCCTATAGGATGGTTA,41,1924749
ihfAp4,2.0,106,35,GGTGGTAAACCAGACACCGG,71,1930044
ihfAp4,1.1111111111111112,74,35,GGTGCCCCGGCTGCATCGCT,39,1959601
ihfAp4,1.0277777777777777,71,35,GGCACTGTCACCAGCCACGG,36,1936094
ihfAp4,1.5,88,35,GAGGACTCAGGATTATTCAT,53,1910041
ihfAp4,4.333333333333333,190,35,GAGCGTCGTAGCACGGAGCT,155,1939958
ihfAp4,0.05555555555555555,36,35,GACATTTGGAGATGCGTGAT,1,1937502
ihfAp4,1.7777777777777777,98,35,GAAACACTATGCTCGTCTTT,63,1910707
ihfAp4,0.5833333333333334,55,35,CGCAACCAGGCCATTGTAAT,20,1927269
ihfAp4,0.7777777777777778,62,35,CCGGCCTCAAGGGAAACAAC,27,1914450
ihfAp4,0.6111111111111112,56,35,CATCTTTTAAGACTCGATTG,21,1959196
ihfAp4,0.3611111111111111,47,35,CATCGCCCGGAAATTCGGAT,12,1955578
ihfAp4,3.4166666666666665,157,35,CAGGTCTCAGTGGATCAGAA,122,1942731
ihfAp4,0.8333333333333334,64,35,ATGCCTTAAGTAAAGGTTGA,29,1912856
ihfAp4,1.4444444444444444,86,35,ATGAACCCGCGAGCTCGGTA,51,1931440
ihfAp4,4.027777777777778,179,35,ATCGCTTCACCGTACGCACT,144,1923761
ihfAp4,1.25,79,35,ATACGATTCTGTCGCCTCGG,44,1927265
ihfAp4,1.1111111111111112,74,35,AGTATACGGGCGGTATTGCA,39,1925607
ihfAp4,1.6944444444444444,95,35,AGGTTCGGATATCTTAATAC,60,1923759
ihfAp4,0.05555555555555555,36,35,ACACCTCGGTTTTCCATTAC,1,1950951
ihfAp4,0.8285714285714286,62,34,TGTCGGCCCAGTACAATACC,28,1939657
ihfAp4,0.34285714285714286,45,34,TACAGGGTTGTCATTATTTG,11,1940877
ihfAp4,0.8857142857142857,64,34,GTCACCACGTTCCGTCCTGG,30,1913396
ihfAp4,0.5142857142857142,51,34,GGGACATGACAGGTCGGCGC,17,1909754
ihfAp4,0.8571428571428571,63,34,GGCACGTGGTAACCCTCGTA,29,1933951
ihfAp4,1.0857142857142856,71,34,GGAGTGTACGATCCTTGTCC,37,1947978
ihfAp4,0.17142857142857143,39,34,GCTCAGACTGGAGCAGCTCG,5,1927313
ihfAp4,0.6857142857142857,57,34,CGGGTTAAGTAGGGGGCGTA,23,1936623
ihfAp4,0.8857142857142857,64,34,CGCCGCAGCATACGTGACAA,30,1937669
ihfAp4,0.8571428571428571,63,34,CCCCGGATTCCCCAGCTACG,29,1943889
ihfAp4,1.0,68,34,CCCAGATGTGAGGCTCAATG,34,1924976
ihfAp4,0.6571428571428571,56,34,CCCACACTTCTACCGGACGC,22,1959472
ihfAp4,0.05714285714285714,35,34,AGGTACGTCAGAATCCGAAT,1,1911791
ihfAp4,2.6857142857142855,127,34,AAGCTCAAGGACCCCCAACA,93,1920826
ihfAp4,0.4117647058823529,46,33,TTCAGATGTGATCTCGCCTA,13,1923330
ihfAp4,0.9411764705882353,64,33,TTATGAGGAAACCCATATGT,31,1953086
ihfAp4,2.9411764705882355,132,33,TTACATTAAGGTCACTGTCG,99,1925560
ihfAp4,0.9117647058823529,63,33,TCGTTTGGGAAGGTAATCAT,30,1951568
ihfAp4,1.5588235294117647,85,33,TCGTGTGAAATTTAGAGCAG,52,1934979
ihfAp4,0.6176470588235294,53,33,GTTGGCCGTAGCAGGAATTG,20,1924537
ihfAp4,1.588235294117647,86,33,GTATGGCAGGGGGAGAACTT,53,1933955
ihfAp4,0.5882352941176471,52,33,GGGGGCCGCAAGAATTTTTC,19,1913897
ihfAp4,0.7647058823529411,58,33,GCGTTTCGGCGCGTCGCCAG,25,1949196
ihfAp4,2.235294117647059,108,33,CTCCGAAGCGTTAACCAGTA,75,1912352
ihfAp4,3.4705882352941178,150,33,CCAAGGAATACGGCAAGGGA,117,1910854
ihfAp4,0.17647058823529413,38,33,CCAAGCTCGCTCCGGACCAC,5,1927545
ihfAp4,0.7058823529411765,56,33,CAGCCGCCCATCCAGGAAGT,23,1916268
ihfAp4,0.5,49,33,ATTCGAGTCTTTTAACAAGT,16,1925451
ihfAp4,0.9117647058823529,63,33,ATGCGTAGCCCCCGCCTAGG,30,1917290
ihfAp4,1.088235294117647,69,33,AGCATTCCGTCTGTAGCATG,36,1918249
ihfAp4,3.2941176470588234,144,33,ACTAAGGGGACTATCTTAGT,111,1928719
ihfAp4,0.8823529411764706,62,33,ACCGGTAATACTCACCAAGA,29,1961004
ihfAp4,1.9696969696969697,96,32,TTTGCAAGCGCGCGGTTGGG,64,1955449
ihfAp4,0.30303030303030304,41,32,TTAGCAACCTGCAGTCCGGG,9,1958074
ihfAp4,2.4545454545454546,112,32,TCGGAAAAAACTTTGGGAGT,80,1936491
ihfAp4,0.06060606060606061,33,32,TCGATGTGCTTCGTTCTTCA,1,1920236
ihfAp4,1.121212121212121,68,32,TCATACGTTGGCTTTAAGAG,36,1951869
ihfAp4,3.1818181818181817,136,32,TAGAGCCTACGTGGAGTAGC,104,1924053
ihfAp4,0.7575757575757576,56,32,GGGCAGCCGATATTCTTAAA,24,1956169
ihfAp4,1.696969696969697,87,32,GGCGCCTGCTAGGTGTGTAT,55,1922860
ihfAp4,0.48484848484848486,47,32,GCTTAAATGAGACTCAATCG,15,1931030
ihfAp4,0.5151515151515151,48,32,GCGTCCCCGGCCTTTATGCT,16,1932711
ihfAp4,0.24242424242424243,39,32,GCGGAATACTCACCATCTGG,7,1917113
ihfAp4,0.45454545454545453,46,32,GCCATGGAGCCAACTAATGT,14,1914513
ihfAp4,1.606060606060606,84,32,GATGCAGACAATCTTAACTC,52,1945712
ihfAp4,0.9090909090909091,61,32,GAACTGAAGCCGGCGACATA,29,1933704
ihfAp4,0.18181818181818182,37,32,GAACCTAATGAGACAAAGTG,5,1922501
ihfAp4,0.8181818181818182,58,32,CTTAGTAGCGACCGCTTTGC,26,1912603
ihfAp4,1.5454545454545454,82,32,CTGACTATTAGTGGGGAAAT,50,1938599
ihfAp4,3.909090909090909,160,32,CCGGGATGTTCAATCGTTTT,128,1920930
ihfAp4,0.5757575757575758,50,32,CAATAATACGCGGGGCGCGC,18,1948867
ihfAp4,2.4242424242424243,111,32,ATGGTAACTTTAGACAAGGT,79,1915672
ihfAp4,1.2424242424242424,72,32,ATCGGGCTTCAAGGGGCCGT,40,1923803
ihfAp4,1.0909090909090908,67,32,ATACTGCGTTGAGCGCTTCT,35,1932802
ihfAp4,0.9393939393939394,62,32,AATATAACGTAGATTCCTTG,30,1929146
ihfAp4,1.3636363636363635,76,32,AACCTTTGGGAGGCTTATTG,44,1928901
ihfAp4,1.375,74,31,TGCGGTCACGGCCCTAAAAA,43,1921144
ihfAp4,3.34375,137,31,TGAGAAGAACACTTCGACGA,106,1950870
ihfAp4,1.75,86,31,GTCCGCGACTGAGTTTTTAG,55,1921854
ihfAp4,1.90625,91,31,GTCACTGATATCGGCCACCT,60,1924141
ihfAp4,3.75,150,31,GTAGACGGCTGATGTTGTGT,119,1952099
ihfAp4,3.15625,131,31,GGTGAAGCCCTAGTCCACTG,100,1959583
ihfAp4,0.0625,32,31,GGGCTTGTTTACCCACGCCA,1,1910477
ihfAp4,0.875,58,31,GCGGATCCCATTGTCCCTTA,27,1946650
ihfAp4,2.25,102,31,GCCTATATTTGTATTTGATG,71,1943335
ihfAp4,0.75,54,31,CTGGCAGTCCTATGACGCTA,23,1914187
ihfAp4,0.625,50,31,CTGAAACCTGCAAGGGTCAT,19,1920161
ihfAp4,2.9375,124,31,CTCGAGGCCAATAAATACTT,93,1940038
ihfAp4,0.0625,32,31,CGGTCTCAATCACCGAGGAC,1,1941998
ihfAp4,1.21875,69,31,CGATAAGTCACTTCACGATC,38,1914898
ihfAp4,1.65625,83,31,CGACTAAGCATGTATACGCT,52,1910709
ihfAp4,2.4375,108,31,CGACCGGGCTGCGAGGGCAA,77,1946728
ihfAp4,0.0625,32,31,CCCCGCCCAAGGTTTCTACA,1,1914167
ihfAp4,0.96875,61,31,CATCGTGGGCATTCGGAGTT,30,1938224
ihfAp4,2.0625,96,31,ATATAACTATCACTTCGAGT,65,1927773
ihfAp4,1.09375,65,31,AGAGATCAAATCTAGAGTTG,34,1922803
ihfAp4,1.65625,83,31,ACTATAGCATCTGGAACTTG,52,1920234
ihfAp4,1.09375,65,31,AATCGAGCGCTATGGGATTA,34,1931701
ihfAp4,0.1875,36,31,AAGAGTACATTGAAAGAGGC,5,1945789
ihfAp4,1.2580645161290323,68,30,TTTGTGTTGCAGGCTTTGAT,38,1932585
ihfAp4,0.6451612903225806,49,30,TTCGGGCGCGTCAGGCGGCT,19,1930986
ihfAp4,3.129032258064516,126,30,TGTGATGTATCATGCGCTAC,96,1916142
ihfAp4,3.935483870967742,151,30,TGATCAGGTCACATCCCGGG,121,1911224
ihfAp4,3.4516129032258065,136,30,TACAAGCAACGAGCGCCACA,106,1926142
ihfAp4,0.6774193548387096,50,30,GTTCTAGACGATCTACTCTC,20,1910530
ihfAp4,0.3225806451612903,39,30,GTAGGCCGCACAGTGTAATT,9,1929307
ihfAp4,0.22580645161290322,36,30,GGGATTATGAAGTTTATTCA,6,1915535
ihfAp4,1.2258064516129032,67,30,GCTGCGCATTGCATTCAGGA,37,1956758
ihfAp4,5.161290322580645,189,30,GCTCTCTTTTAAGTGCGGTA,159,1927774
ihfAp4,0.41935483870967744,42,30,GCCGGCAACTGGGTGTATCA,12,1945612
ihfAp4,1.3870967741935485,72,30,GCCCATCCTTAAGCACTTCT,42,1954550
ihfAp4,0.967741935483871,59,30,GATCCCCACGTTTGGCTTCT,29,1929815
ihfAp4,1.3870967741935485,72,30,GAGTTTGGTTTTGTTCGCTC,42,1934241
ihfAp4,1.903225806451613,88,30,CTTTATACAGTTGTCTTGCG,58,1931601
ihfAp4,1.8387096774193548,86,30,CCTGCCCTAGTCTGGGTCAG,56,1941526
ihfAp4,1.7096774193548387,82,30,CCTAAAGCCTCGTAGGAGTC,52,1951643
ihfAp4,1.064516129032258,62,30,CCGTGCGCCCAAGATCACTG,32,1956494
ihfAp4,1.1290322580645162,64,30,CATAGGCACACATTCCATCA,34,1936099
ihfAp4,3.6451612903225805,142,30,ATTCGCACCAGAGGCCAGTT,112,1959749
ihfAp4,0.9032258064516129,57,30,AGTTATCTGAGCGGAGAATT,27,1911376
ihfAp4,1.7419354838709677,83,30,AGGAGGGTTAAGCCGCTTAA,53,1924468
ihfAp4,4.741935483870968,176,30,AGCTTCATACGTTTTTTTCT,146,1927426
ihfAp4,1.1612903225806452,65,30,ACGAAGCGTGCCGTAACGGT,35,1913281
ihfAp4,0.4838709677419355,44,30,ACCTCAGTCGCCCGGAGCGT,14,1937570
ihfAp4,0.3870967741935484,41,30,ACCCGGCACACCTCGCACAC,11,1955180
ihfAp4,6.935483870967742,244,30,AATACTCTTCCTTTCCATCC,214,1950757
ihfAp4,1.1,61,29,TTTGTTGGGGGAGGGTCAGT,32,1918456
ihfAp4,0.6,46,29,TGTGTAACTTCGTCAGCGAT,17,1911016
ihfAp4,5.1,181,29,TGTGACAAAGCCTAAACCTG,152,1945822
ihfAp4,1.6666666666666667,78,29,TGTATCCGGTTAACCATCTT,49,1913567
ihfAp4,0.43333333333333335,41,29,TGACTGCGGAAATGCGGGAA,12,1927232
ihfAp4,3.6333333333333333,137,29,TCTGATCCTTACTAGAAGAG,108,1940148
ihfAp4,3.6333333333333333,137,29,TCGTTTAAGCGACCACAGGA,108,1942274
ihfAp4,3.533333333333333,134,29,TCCGAAGTCAGGGCATCCAT,105,1921026
ihfAp4,0.8333333333333334,53,29,TATGGGAACTATCAGTTTTC,24,1941516
ihfAp4,0.43333333333333335,41,29,TAATCCCATATGTCTGACAC,12,1926244
ihfAp4,7.933333333333334,266,29,GTGTCGGAGCCGCTGTGAGG,237,1912317
ihfAp4,2.6333333333333333,107,29,GTGGGCAGGTGCTAGAATCG,78,1939102
ihfAp4,1.3333333333333333,68,29,GTATTGAGGACAGGACCGAT,39,1933380
ihfAp4,1.4,70,29,GGAAGCCGGAGCTATTAGTA,41,1952245
ihfAp4,2.4,100,29,GCTCAGGGACAACTACCCCA,71,1949286
ihfAp4,0.43333333333333335,41,29,GCCTCCGTCTACAGGCACCC,12,1913420
ihfAp4,0.8333333333333334,53,29,GCCAGTGTACCTGGGCCTGT,24,1917162
ihfAp4,1.7333333333333334,80,29,GCATATGTGTGTATAATTCA,51,1923449
ihfAp4,1.1333333333333333,62,29,GCACGTTGCTGGTATCACGG,33,1936320
ihfAp4,1.2333333333333334,65,29,GATTCGGCCCCAGATTGCAG,36,1922423
ihfAp4,0.4,40,29,GAGAAGACAGCGCGGCCGAA,11,1958568
ihfAp4,0.5333333333333333,44,29,GACAATCAGCGGTGAGATGT,15,1927175
ihfAp4,1.9,85,29,CTTGGATAGACGTGTTCGTG,56,1947667
ihfAp4,0.3333333333333333,38,29,CGGAAGGATGTCTGAGCTCT,9,1916835
ihfAp4,0.2,34,29,CGCGAGTACAACTAGCAACG,5,1932710
ihfAp4,2.0,88,29,CGATTTCTTTTTTACGTTCG,59,1915775
ihfAp4,0.6333333333333333,47,29,CCGCACAAGTTTTGGTAGGG,18,1946775
ihfAp4,1.9,85,29,CCCAGAGATTCCTACCATTT,56,1934309
ihfAp4,1.1666666666666667,63,29,CCAGGCCGTTGTTTCAACAC,34,1909651
ihfAp4,1.1666666666666667,63,29,CAAAAGGCCTATCTAATCTC,34,1920052
ihfAp4,2.1333333333333333,92,29,ATGAGGCTCAAAGGGAGAAG,63,1909767
ihfAp4,0.8333333333333334,53,29,ATCGTGTGCGGCGACCATAA,24,1913969
ihfAp4,2.7333333333333334,110,29,AGTTTGGCCCTCTGACTGTG,81,1916877
ihfAp4,1.8,82,29,AGCCTTATCCTGCACGCAAT,53,1946103
ihfAp4,1.3,67,29,AGATGTAGAACTCATCTTCA,38,1912648
ihfAp4,1.9666666666666666,87,29,AGATCTTACCGCAAAGAGTT,58,1934521
ihfAp4,0.43333333333333335,41,29,AGACATGGAAGGAGCGGAGT,12,1940387
ihfAp4,2.3333333333333335,98,29,ACTGGTTACACGGCAGCCTT,69,1918685
ihfAp4,1.8333333333333333,83,29,ACTAGCCAAATGTTGATACA,54,1950878
ihfAp4,2.1,91,29,ACGCGCTCCGGTTATGCTGT,62,1928363
ihfAp4,0.1,31,29,AAGGGTCACACTTTGACCGG,2,1921373
ihfAp4,0.9,55,29,AAGGCTTTCTTAGAACGGTT,26,1918260
ihfAp4,0.26666666666666666,36,29,AACTGAGAGGCATGCATCCG,7,1944401
ihfAp4,4.448275862068965,156,28,TTCACTCTGATTACCCTGGG,128,1931570
ihfAp4,0.3448275862068966,37,28,TGTCTCCGGAGGGTAGTAAA,9,1928646
ihfAp4,3.5172413793103448,129,28,TGTACCGCCCCGTAGCGCTA,101,1940230
ihfAp4,2.413793103448276,97,28,TGCGGACGATGCTGATAAGT,69,1928865
ihfAp4,2.6551724137931036,104,28,TGCGAGTAGTTTCCATAGTG,76,1938902
ihfAp4,1.0689655172413792,58,28,TGCCGGCACGGCCTTAAAAT,30,1943183
ihfAp4,0.27586206896551724,35,28,TGACATGTTAGTTTTCGCTT,7,1939725
ihfAp4,0.896551724137931,53,28,GTGCATCAGTCAGCAGATAA,25,1959041
ihfAp4,2.3793103448275863,96,28,GGTACGAGTGCCAGCCGTAA,68,1918329
ihfAp4,0.6551724137931034,46,28,GGGTACGGCACTGAAATGTA,18,1915196
ihfAp4,3.689655172413793,134,28,GGCTCCGCGTGGTGACAAAA,106,1944801
ihfAp4,1.4137931034482758,68,28,GGCCTGTGCGTTCAACGCGA,40,1948493
ihfAp4,1.7586206896551724,78,28,GGAACTAATACTAGAGCTAT,50,1939589
ihfAp4,1.4827586206896552,70,28,GCTCTGAAATCCTAAAGGAT,42,1948785
ihfAp4,1.3448275862068966,66,28,GCGGCCGATTAGACTATGTT,38,1911840
ihfAp4,0.7241379310344828,48,28,GCGCATATTATTTTTTTGCT,20,1928046
ihfAp4,0.1724137931034483,32,28,GCACTAAAGTCTTCCATTCA,4,1931067
ihfAp4,0.3793103448275862,38,28,GATCATGGTGCTCAAGCGAC,10,1920494
ihfAp4,0.6551724137931034,46,28,CTGTGCGTGAACGACCTGGA,18,1930822
ihfAp4,0.5172413793103449,42,28,CTGGAACGGGTCAGAGATCA,14,1950978
ihfAp4,1.4482758620689655,69,28,CTGATGTAACCAAAGGGTTG,41,1941780
ihfAp4,1.5517241379310345,72,28,CTAGGTAGGGGGGGAAGGCT,44,1923758
ihfAp4,0.1724137931034483,32,28,CGTGTTCATTATCATGTTAG,4,1924639
ihfAp4,0.5517241379310345,43,28,CCGTGAGTCACTCCAACTCA,15,1957708
ihfAp4,1.3448275862068966,66,28,CATGATAGTTCCCCACTTGA,38,1956379
ihfAp4,4.448275862068965,156,28,CACAAGTCGTCGTAAATGAC,128,1929790
ihfAp4,1.1379310344827587,60,28,CAACACGCTGCCTTTGGTGA,32,1934022
ihfAp4,2.5172413793103448,100,28,ATCGACAGTTGCATATGCCG,72,1910810
ihfAp4,1.8620689655172413,81,28,AGGTTTGAATAGCTTGTCTT,53,1956582
ihfAp4,1.896551724137931,82,28,AGAAGTCAGTCCGCCACGTA,54,1948051
ihfAp4,2.9310344827586206,112,28,AATCGTCTATGGGAGGTATA,84,1933985
ihfAp4,0.06896551724137931,29,28,AAGTTTAAGCTGAAGCAGAA,1,1924687
ihfAp4,0.5172413793103449,42,28,AAGATCGGGATTAACACGAA,14,1935843
ihfAp4,0.7586206896551724,49,28,AACACGATCCACACGAGAAT,21,1939741
ihfAp4,1.5517241379310345,72,28,AAACATAGGACACTTAGGAC,44,1910307
ihfAp4,0.3448275862068966,37,28,AAACAAACACGGGTGAATTC,9,1961331
ihfAp4,1.1428571428571428,58,27,TTTACCACTGTGGTTCCCCA,31,1955448
ihfAp4,1.8928571428571428,79,27,TTGTACGCCTGGGGATAGCT,52,1921635
ihfAp4,2.2142857142857144,88,27,TTCTGTAATCCGAGCAATGC,61,1928324
ihfAp4,0.75,47,27,TGGGCTCGTCTGTCACCTCA,20,1942187
ihfAp4,1.7142857142857142,74,27,TGGATCGATCCTAGATACAA,47,1914785
ihfAp4,1.5714285714285714,70,27,TCATATATCCACAACTTGAC,43,1915640
ihfAp4,0.8571428571428571,50,27,TCACGTGCATTGCGGGTCCT,23,1918969
ihfAp4,1.5357142857142858,69,27,TATCGGGGCTCCTGACTCCA,42,1930494
ihfAp4,2.607142857142857,99,27,TACGTAAACAAGCTGTCGTA,72,1945791
ihfAp4,0.6071428571428571,43,27,TACACCGTCTAGTTAGTTTT,16,1912268
ihfAp4,0.07142857142857142,28,27,GTTGTGTGTTGTGGGCTTTG,1,1944677
ihfAp4,0.8928571428571429,51,27,GTGTCACCCAGAAAATCGAG,24,1945137
ihfAp4,2.357142857142857,92,27,GTCCAGTGGGCAGTTGAGTA,65,1929568
ihfAp4,0.6071428571428571,43,27,GTCCAGCCAAGGGCCTCGGC,16,1910262
ihfAp4,2.1785714285714284,87,27,GTCAAACGCTGTCACTGTTA,60,1943925
ihfAp4,0.9642857142857143,53,27,GTATATCCCTTATCATCGCA,26,1917742
ihfAp4,2.1785714285714284,87,27,GTAGGAAGTGATAGACTCAC,60,1918556
ihfAp4,9.964285714285714,305,27,GGTGTGGGGTCAAAGGACCT,278,1914404
ihfAp4,1.5,68,27,GGAAAATGTGTTACTGATGA,41,1948614
ihfAp4,0.7142857142857143,46,27,GCGAGTTTCCGGGTACCGAT,19,1950877
ihfAp4,3.75,131,27,GCCCTTGACTATGGCCTATT,104,1931839
ihfAp4,2.0,82,27,GCAAACCCCTGGAGCTGGAA,55,1918970
ihfAp4,0.6071428571428571,43,27,GATTTCACGGAGTCCCGTTT,16,1921189
ihfAp4,0.9285714285714286,52,27,GAGTACCAGGCCCTTAGGCC,25,1950546
ihfAp4,0.9285714285714286,52,27,GAATTACACGGATTACATTA,25,1956132
ihfAp4,4.214285714285714,144,27,CTGGTTCCATAGATTCACGT,117,1929450
ihfAp4,0.9642857142857143,53,27,CTGCCACGGAAGTCAGTTGT,26,1949785
ihfAp4,1.0357142857142858,55,27,CTGAAACCCACCGGGCGTAT,28,1928180
ihfAp4,0.6785714285714286,45,27,CTATACCAAGGGGAGGTGGA,18,1955075
ihfAp4,1.1071428571428572,57,27,CTACGCGCTCGCTTCTCACC,30,1911267
ihfAp4,0.8571428571428571,50,27,CTAACAGAATGTGGACACCG,23,1935174
ihfAp4,0.6071428571428571,43,27,CGTTCGTGGGCGCGTCGGTT,16,1942137
ihfAp4,2.25,89,27,CGAGGTGACTATAACCGGGA,62,1920302
ihfAp4,0.9285714285714286,52,27,CCGTTCAGGGTTAAGTATGT,25,1929321
ihfAp4,7.464285714285714,235,27,CCCGCCTGTCTAATACGATT,208,1942674
ihfAp4,2.642857142857143,100,27,CCATTGTTGGAACCTCAAGC,73,1910668
ihfAp4,0.07142857142857142,28,27,CCACGCCCGAAATTCATCGT,1,1931339
ihfAp4,1.75,75,27,CAGTTAGAAAACTTTAGCCA,48,1944831
ihfAp4,2.5357142857142856,97,27,CACGATGATCCGGGGCGGTA,70,1944352
ihfAp4,0.2857142857142857,34,27,CAAGGAACGAGTCGGGCTCA,7,1952642
ihfAp4,2.0,82,27,ATGTACCTATTCTAGGCGAC,55,1909803
ihfAp4,0.8214285714285714,49,27,ATCCGAATTGAACTCAGATA,22,1916826
ihfAp4,2.25,89,27,ACTGGGGCACTTCACATCGC,62,1933807
ihfAp4,3.25,117,27,ACGGCTCCACCATGATGCAT,90,1952201
ihfAp4,0.4642857142857143,39,27,ACCGATGTTTTCTGGAATGA,12,1946784
ihfAp4,1.3928571428571428,65,27,AAGGTTATCAGTGTCTATTA,38,1916905
ihfAp4,1.4285714285714286,66,27,AAGGGACTTCCGTAGTACTA,39,1957189
ihfAp4,2.8214285714285716,105,27,AACCGGGCAGAACTAAGGAC,78,1924070
ihfAp4,4.5,152,27,AACATAACATTTGGATCTCG,125,1936798
ihfAp4,2.5555555555555554,94,26,TTTACCCAAAGCGCCGCATG,68,1913589
ihfAp4,0.8148148148148148,47,26,TTGACTTGAGTCGAAGGGGA,21,1960893
ihfAp4,1.3703703703703705,62,26,TTCTGGGCGGAAGCTCCGCG,36,1932588
ihfAp4,1.8888888888888888,76,26,TGCGGTAAATAAGAGGCGCA,50,1918323
ihfAp4,2.111111111111111,82,26,TCGACAGTTCTAATACACGT,56,1914960
ihfAp4,2.6296296296296298,96,26,TCCGCGCATGGTACGCCACT,70,1934520
ihfAp4,1.7777777777777777,73,26,TCACCTAGAAGGTGCCGGGG,47,1923276
ihfAp4,1.2222222222222223,58,26,TATGTCTTAGTCGTGACACA,32,1946317
ihfAp4,0.7777777777777778,46,26,TAACATTCCATTTATAGGAT,20,1912688
ihfAp4,1.5555555555555556,67,26,TAAATCCACTATCCCGTGGG,41,1922091
ihfAp4,3.074074074074074,108,26,TAAAGCTTATAGCGCGACCT,82,1960853
ihfAp4,2.185185185185185,84,26,GTTGGCTCCAGTTTCGCAGG,58,1949763
ihfAp4,1.7777777777777777,73,26,GGGTCCCATGTGTATGTGGC,47,1932911
ihfAp4,1.3333333333333333,61,26,GGGCGAATATTACGTCTTTG,35,1915876
ihfAp4,2.5185185185185186,93,26,GGGAGTCTCAGGAATATTGT,67,1924974
ihfAp4,0.07407407407407407,27,26,GCTCGACCCACACCTACGAT,1,1928454
ihfAp4,0.07407407407407407,27,26,GCCGTCAAGTGCACCGGACG,1,1961782
ihfAp4,0.7777777777777778,46,26,GCCAGGTTAAGGACCGTTAT,20,1954509
ihfAp4,0.8148148148148148,47,26,GCAGGACATACATTTCTCAT,21,1917511
ihfAp4,1.6666666666666667,70,26,GCAGCTGAGGTTATGTCATT,44,1930485
ihfAp4,2.3703703703703702,89,26,GCAAGTCAGGGGGTAAAGAC,63,1955418
ihfAp4,0.9259259259259259,50,26,GAAGCTCTTTCTTATATTCC,24,1914359
ihfAp4,0.5185185185185185,39,26,CTCTTCGGACTTTTGCACAA,13,1925837
ihfAp4,1.3703703703703705,62,26,CCGTGCACTGAACTCAGTAT,36,1931464
ihfAp4,0.6666666666666666,43,26,CCCTTTGGAGGGCCGAAATC,17,1944574
ihfAp4,1.5555555555555556,67,26,CCCGTGGCTGGATCCGCGCC,41,1927067
ihfAp4,3.7037037037037037,125,26,CCATTGAAAAGCGCCTCATC,99,1915152
ihfAp4,0.07407407407407407,27,26,CAGCGCCTCCAGCTGCACAT,1,1956697
ihfAp4,0.3333333333333333,34,26,CAGACCCAGGCGTTTCGGAT,8,1936154
ihfAp4,3.259259259259259,113,26,CACGGGTCCCCTTCTCTACG,87,1913645
ihfAp4,2.962962962962963,105,26,CAATCTCTCGAGTGACGGCA,79,1919252
ihfAp4,0.3333333333333333,34,26,CAAGGCCTGTGACGTAGGCG,8,1919905
ihfAp4,0.7407407407407407,45,26,ATCGGGCGGATCCTTGTCCA,19,1942268
ihfAp4,1.3703703703703705,62,26,AGAGTCTGTCTATGTTCTCT,36,1935839
ihfAp4,0.9259259259259259,50,26,ACTTTGTAAGCATTGGCTTC,24,1911145
ihfAp4,0.48148148148148145,38,26,ACTCTTAGGAATCTTTGCAG,12,1913484
ihfAp4,2.3703703703703702,89,26,ACAAAAATGAGCCGACCTTC,63,1938704
ihfAp4,1.4615384615384615,62,25,TTCGAGAGGTAGCGACAACG,37,1913755
ihfAp4,1.0,50,25,TTCAGGAAGTCGCGGTTCCT,25,1915840
ihfAp4,1.8846153846153846,73,25,TTACGTACGGGAGTGTTGAC,48,1951031
ihfAp4,0.07692307692307693,26,25,TTAATCCGTACCCAGATTAG,1,1916374
ihfAp4,3.076923076923077,104,25,TGTTGGCGTCGCGCAATACA,79,1936443
ihfAp4,2.5,89,25,TGGGACGGCCATCGGCGCAT,64,1946145
ihfAp4,2.769230769230769,96,25,TGGACCGGGGTATTCCATGG,71,1916453
ihfAp4,1.6923076923076923,68,25,TGATCCGTGTCAATACTATG,43,1957408
ihfAp4,0.9230769230769231,48,25,TGACGCCTGGATAATATGAG,23,1952752
ihfAp4,1.1153846153846154,53,25,TCGGGAGACGAGAAAATATT,28,1930798
ihfAp4,0.7692307692307693,44,25,TCGCGCTCGTGTTGCTGCTC,19,1937896
ihfAp4,0.8076923076923077,45,25,TATGGCCTATAACCGTACCT,20,1948630
ihfAp4,1.5769230769230769,65,25,TATGCAAGGGTGATGGAGAT,40,1943469
ihfAp4,0.34615384615384615,33,25,TAACGCATCCCACTGGTCGA,8,1958613
ihfAp4,0.8461538461538461,46,25,GTTTGTAAGGCTGCCCGTTC,21,1954558
ihfAp4,0.9230769230769231,48,25,GTTACTTGCTTGGGAAGAGC,23,1916976
ihfAp4,1.3076923076923077,58,25,GTTACGGAGGGCACGTAGCA,33,1961177
ihfAp4,1.0384615384615385,51,25,GTGGATCTCGCCTTAGATAA,26,1939029
ihfAp4,1.2692307692307692,57,25,GTGCTCTTGTGTCTCCGCTG,32,1929145
ihfAp4,1.3846153846153846,60,25,GTCCGGGAAGGAGGATATGC,35,1929097
ihfAp4,2.1538461538461537,80,25,GTCCAGTATATGCGGACATA,55,1934947
ihfAp4,1.7307692307692308,69,25,GGGGTCACTATCGATGGGCT,44,1919460
ihfAp4,3.8461538461538463,124,25,GGCTGGGCAAGGAAACCAAA,99,1925854
ihfAp4,2.5384615384615383,90,25,GCGTTGTTTCCATGAGGTAG,65,1919119
ihfAp4,5.346153846153846,163,25,GCGGCAGCTGGATAATGGAA,138,1962061
ihfAp4,1.8846153846153846,73,25,GCAAGGGTTGGAACCGATGA,48,1919047
ihfAp4,1.2307692307692308,56,25,GAGAAACGATTAGCGTAGAT,31,1936524
ihfAp4,3.4615384615384617,114,25,GAATGTTAATTTTTCACTTA,89,1944836
ihfAp4,7.461538461538462,218,25,CTTGTAGATACCACCTGTCC,193,1919251
ihfAp4,2.1923076923076925,81,25,CTGCATTACTGTCGTCCAGG,56,1935530
ihfAp4,1.1538461538461537,54,25,CTCAAACTTGTCAGTTATAA,29,1933994
ihfAp4,2.576923076923077,91,25,CGTATCTAATAACTCAAAAT,66,1909904
ihfAp4,1.8461538461538463,72,25,CGTACTGTGATCCTTGATCA,47,1913753
ihfAp4,1.6923076923076923,68,25,CGGTCCGCAACAAATGACAT,43,1936917
ihfAp4,2.6923076923076925,94,25,CGCGTCCAGAATGAAGCTGT,69,1946700
ihfAp4,0.4230769230769231,35,25,CCTTTCGCGCGTCGAACGGG,10,1909859
ihfAp4,0.23076923076923078,30,25,CCTGTGAGCGATTTTATACG,5,1918304
ihfAp4,1.2692307692307692,57,25,CCGGTAAAGTTTTTCAAGCG,32,1920158
ihfAp4,5.153846153846154,158,25,CCGGGCAAGCTAGGAAAGGA,133,1929001
ihfAp4,1.5769230769230769,65,25,CCAGATTCCAATTTTTGTTA,40,1910457
ihfAp4,1.1923076923076923,55,25,CATCAAACGTGGTGGAACAG,30,1929869
ihfAp4,0.8076923076923077,45,25,CAACTAAATAGAATCGGAAT,20,1950330
ihfAp4,2.5,89,25,ATTAGGTAGTCTACTGAGAC,64,1944543
ihfAp4,1.6538461538461537,67,25,ATCTTGTTGGACACGAAACA,42,1912008
ihfAp4,1.8076923076923077,71,25,ATCCAGTTATCGGCTCTTCT,46,1950188
ihfAp4,1.0,50,25,AGTCAGGACTTATCGGCTAC,25,1950114
ihfAp4,0.5769230769230769,39,25,AGTACTGTGCTGGTATACCG,14,1916140
ihfAp4,0.5769230769230769,39,25,AGTACAACCCCACGAATCTC,14,1930932
ihfAp4,0.34615384615384615,33,25,AGAGGGTTTAATACCAAAGT,8,1947942
ihfAp4,1.7307692307692308,69,25,ACTCGATTAGATCCTACTAC,44,1945435
ihfAp4,0.3076923076923077,32,25,ACCGTGGCCATGTCTTGAAG,7,1920823
ihfAp4,1.4615384615384615,62,25,ACCGCGAGCTGCAATCTTGA,37,1931160
ihfAp4,0.46153846153846156,36,25,ACAGGCTACGACTCGAGGAT,11,1913911
ihfAp4,0.7307692307692307,43,25,ACACGTACCAATTGACCAAA,18,1913097
ihfAp4,1.9230769230769231,74,25,AATTATCACGGCACGTATTA,49,1921098
ihfAp4,1.0,50,25,AAGACTTCTAACCATGAGAT,25,1934846
ihfAp4,0.5769230769230769,39,25,AAGAAGTCTGCCTAGTAAAG,14,1929354
ihfAp4,0.07692307692307693,26,25,AACTGCGAGCAACCGCGCCT,1,1938373
ihfAp4,1.2692307692307692,57,25,AACCTCAGGTTGGAGACCTA,32,1943206
ihfAp4,2.730769230769231,95,25,AAAATGACGTGAGCGAATGT,70,1927762
ihfAp4,0.64,39,24,TTGACCGGCCGCGGGGGACA,15,1918346
ihfAp4,2.4,83,24,TTAGATTTGTGTTCTCTTAT,59,1941993
ihfAp4,0.36,32,24,TGTCTACGAAATGTTACAGC,8,1955727
ihfAp4,0.32,31,24,TGTCGGGATGTAACATTCAT,7,1938310
ihfAp4,1.32,56,24,TGGTGATTGTAATGGAATCG,32,1957771
ihfAp4,1.92,71,24,TGATACCACCATTAGTTGGA,47,1949844
ihfAp4,0.08,25,24,TCTCTGCTTCATGGCTACCG,1,1952454
ihfAp4,2.4,83,24,TCGGCTGTATGGTTGCTCCC,59,1915781
ihfAp4,0.6,38,24,TCGAACTAAAATTCCGTAGC,14,1916635
ihfAp4,1.28,55,24,GTTTGTCTATCCAGCTTGTT,31,1934709
ihfAp4,3.36,107,24,GTTATGCATACGTCAGACCT,83,1914263
ihfAp4,0.64,39,24,GTCTGGGGCGGTGCTTCCCA,15,1930417
ihfAp4,1.16,52,24,GTCAATCACTCTAGGGTTCT,28,1958412
ihfAp4,1.68,65,24,GGTGAAAAACCTACGGATTT,41,1948612
ihfAp4,0.08,25,24,GGGATCACAAGCCCACAACT,1,1924622
ihfAp4,2.64,89,24,GGGAGCTTGGAAGGCTTACT,65,1937401
ihfAp4,2.8,93,24,GGCCGTAATTGGACGGGCGA,69,1928292
ihfAp4,1.56,62,24,GGCAGCGTGGGCGACACCGC,38,1929957
ihfAp4,1.56,62,24,GCTCTTACGCTACCCAGTGG,38,1938193
ihfAp4,1.24,54,24,GCGACCAAAGGTTCCCTGAC,30,1957936
ihfAp4,1.0,48,24,GCCGGCCGGTACTACAAAGC,24,1913643
ihfAp4,0.76,42,24,GCCGAACTGAAGGTGGCCTA,18,1912619
ihfAp4,1.28,55,24,GCCCAGCGAACCGTTGGAGT,31,1923190
ihfAp4,1.68,65,24,GCCCAAGAGAGGACGAGAAT,41,1937458
ihfAp4,3.4,108,24,GCAGGCCCAGAAACCTCACA,84,1949574
ihfAp4,0.96,47,24,GATGGTCGCCGAAGCACTCA,23,1914519
ihfAp4,0.8,43,24,GACGCGATGTCCATTGCAGT,19,1942182
ihfAp4,1.16,52,24,GAACCGTAATGTTCACAACT,28,1915462
ihfAp4,0.88,45,24,CTGGCTAATCAGATGCCCAG,21,1928785
ihfAp4,0.6,38,24,CGTGGAGGCAGCTCTCGGGA,14,1937504
ihfAp4,0.08,25,24,CGGCCCCACCGCGAGTGCAA,1,1931499
ihfAp4,2.0,73,24,CGGACTCACCGTAATCGAAA,49,1914409
ihfAp4,3.0,98,24,CGCTTGTTAGGCGGGGTCTT,74,1923506
ihfAp4,0.84,44,24,CGCAACGCATGTGCTCCATG,20,1940775
ihfAp4,1.28,55,24,CGATGCTTAGCTACCTGGTT,31,1961771
ihfAp4,0.84,44,24,CGACTCCCCGTACTTTGATC,20,1933846
ihfAp4,2.64,89,24,CGACCCCCGCGATAAGAGAC,65,1939306
ihfAp4,0.28,30,24,CCGGGAGGACCCGTGACGAA,6,1942978
ihfAp4,2.08,75,24,CCACCTAGCCCCCGGGGCGT,51,1957473
ihfAp4,1.44,59,24,CATTATGCAATATAGCCGAA,35,1923559
ihfAp4,1.24,54,24,CATCTAGGTTGCGTCTGTGA,30,1919781
ihfAp4,2.68,90,24,CAGATGATTCAGTTTCCCGT,66,1915728
ihfAp4,0.6,38,24,CAACCCACGATGGCACTCCG,14,1944441
ihfAp4,2.96,97,24,CAAATTGGCTAGAAAACATA,73,1921244
ihfAp4,1.28,55,24,ATTTGATGCCATCTTGATTG,31,1940709
ihfAp4,2.8,93,24,ATTCTCTTCGCTCGGGACCT,69,1953334
ihfAp4,0.8,43,24,ATAGGTCGGAACAGATGATC,19,1944992
ihfAp4,0.32,31,24,AGTGTGTAGGTCCGTGCCCA,7,1957623
ihfAp4,2.44,84,24,AGTACTTTACAGGCACCCGC,60,1926605
ihfAp4,0.08,25,24,AGCTACGTTCCGGACATAAG,1,1914871
ihfAp4,2.92,96,24,AGAAGCAGTGGCTACTCTAT,72,1933370
ihfAp4,1.4,58,24,ACTACGCCGACGAGGTCCTT,34,1941852
ihfAp4,1.04,49,24,ACGTCGAGAGCTGCAACAAC,25,1919333
ihfAp4,1.24,54,24,ACGAGTTTACCGTTTATCAC,30,1946350
ihfAp4,1.48,60,24,ACCTCAGAGACACCGGTTCC,36,1910259
ihfAp4,0.08,25,24,ACATTCGGTCTTGTTTCGCA,1,1916177
ihfAp4,2.44,84,24,ACATGGTCACATGGTGACGC,60,1946476
ihfAp4,4.4,133,24,ACAGCTTAATCGAGTCGCAT,109,1936905
ihfAp4,5.24,154,24,AATCTCTCACGATTATGTTA,130,1917716
ihfAp4,0.08,25,24,AAACCGAATATTCTTGACTC,1,1915923
ihfAp4,0.625,37,23,TTTCTGGTAACAGCGGGAGT,14,1918154
ihfAp4,0.5833333333333334,36,23,TTGGGGGTACCTGTTTTCAT,13,1924582
ihfAp4,0.9166666666666666,44,23,TTCGCTAAAGGCACACAAAG,21,1940903
ihfAp4,3.375,103,23,TTCCCTTGTACCGTCAATCT,80,1916138
ihfAp4,1.9583333333333333,69,23,TGTGCCACCGTGCCGCTCAC,46,1937270
ihfAp4,2.0,70,23,TGTCGAAATAGTGCGTTCGA,47,1931369
ihfAp4,1.8333333333333333,66,23,TGGTTAACGGAGCAAGGCGT,43,1948089
ihfAp4,0.125,25,23,TGGTCCTTCCCCATGAATTC,2,1928588
ihfAp4,1.0,46,23,TGGCGATCTATGACTTTGAC,23,1961108
ihfAp4,0.3333333333333333,30,23,TGATCGTTCCCAATCTTCAG,7,1930885
ihfAp4,0.7083333333333334,39,23,TCATTGTAAAAGAGGGGCGC,16,1947706
ihfAp4,0.08333333333333333,24,23,TCATTAGCGCGTGCTAGCTC,1,1951389
ihfAp4,2.125,73,23,TAGGGTGCAATTTCTGAAGT,50,1934485
ihfAp4,2.3333333333333335,78,23,TAGCCTGGGAACTTCCTAGA,55,1946644
ihfAp4,1.9583333333333333,69,23,TAATCGAGATCGTCCTGCAT,46,1911839
ihfAp4,1.125,49,23,TAACTTGTTGCCTATTCGTT,26,1950065
ihfAp4,0.7083333333333334,39,23,GTTCTAGTAGGCTCGGACTT,16,1961576
ihfAp4,1.625,61,23,GTGCGTTGGCATAGCAAAAT,38,1933780
ihfAp4,0.2916666666666667,29,23,GTACAGTGAGGGCCATCTGT,6,1934726
ihfAp4,6.083333333333333,168,23,GGTGAGGACCCATCTTAATC,145,1919019
ihfAp4,0.6666666666666666,38,23,GGTCCGCTCATGTGACTTTA,15,1940779
ihfAp4,1.375,55,23,GGGGCGACACATACAAATTG,32,1950489
ihfAp4,0.75,40,23,GGAGGGGACGGTTTACATTG,17,1915426
ihfAp4,0.625,37,23,GCCTTTTTACGAAAGTCCAT,14,1929903
ihfAp4,1.0416666666666667,47,23,GCCGGCGTGGTGCTTGTCTT,24,1936520
ihfAp4,0.5833333333333334,36,23,GAGCAGCTCGGTTGTTCGAT,13,1925902
ihfAp4,1.9166666666666667,68,23,GAAGGCCATTGGGGCGAACA,45,1919434
ihfAp4,1.0833333333333333,48,23,CTTTGACGAAGGTTTTTTGT,25,1927119
ihfAp4,2.7916666666666665,89,23,CTGGTTGTTGAAGCTTCGGT,66,1930400
ihfAp4,1.5833333333333333,60,23,CTGGATAGGGTTCAAGAGGC,37,1922287
ihfAp4,1.0833333333333333,48,23,CTGCTGAGACAGGTTAGTAA,25,1931754
ihfAp4,0.125,25,23,CTGATGAGGTGTGACTGGAA,2,1950918
ihfAp4,0.75,40,23,CTCACCTGCCGAAGCCCGAT,17,1914226
ihfAp4,4.0,118,23,CTAAAGGGTGTTCGAGCATA,95,1944237
ihfAp4,3.4166666666666665,104,23,CTAAACACAACCGAGATAGA,81,1924730
ihfAp4,2.5833333333333335,84,23,CGGTCCTGAGTCTGTGGCCC,61,1920992
ihfAp4,1.25,52,23,CGGCTGGGTGTTCCAAAGGT,29,1960473
ihfAp4,1.2916666666666667,53,23,CGAGATTACCGACGCATGTA,30,1910065
ihfAp4,0.8333333333333334,42,23,CCTTGCCCAACGCGTGAAAT,19,1924671
ihfAp4,2.5416666666666665,83,23,CCTTGAATAAGTCAACTACT,60,1911532
ihfAp4,1.6666666666666667,62,23,CCCAGATATTGCACTCGAGA,39,1927040
ihfAp4,1.5,58,23,CCCACGTTTCTGGCTTACCC,35,1910983
ihfAp4,7.458333333333333,201,23,CCACCAGTTTGAGGGAACAT,178,1928291
ihfAp4,2.25,76,23,CATGGGAACGATTCGGTTTT,53,1950085
ihfAp4,2.75,88,23,CACATGGGGACTGGTCATTC,65,1958343
ihfAp4,0.08333333333333333,24,23,CAAACCTCCAGGGCGTATCT,1,1931957
ihfAp4,0.9583333333333334,45,23,ATGCCGGAGCTTTTCAGTGA,22,1920285
ihfAp4,0.08333333333333333,24,23,ATCCCCGCTTCAGGTTTGTC,1,1917452
ihfAp4,2.875,91,23,ATCAGGTTAAATGGCTTGCA,68,1944870
ihfAp4,1.125,49,23,ATACTGCCCTCAGAAGGCGC,26,1950083
ihfAp4,1.75,64,23,ATACGCCCGTACGCGTCAAT,41,1927143
ihfAp4,0.9583333333333334,45,23,ATAACCGGTTTTGCGGGCCA,22,1924769
ihfAp4,0.9166666666666666,44,23,ACCTGTTTTTGCACCGGTAC,21,1916493
ihfAp4,0.7083333333333334,39,23,ACATTGGGTTATCCTACCTT,16,1916536
ihfAp4,2.2916666666666665,77,23,AATGGAAGTTCGAGTTTACT,54,1931643
ihfAp4,1.7083333333333333,63,23,AACGTGGGGAGATTGAGTAG,40,1936552
ihfAp4,2.260869565217391,73,22,TTGCCGATGGTTCGGCGCGA,51,1958274
ihfAp4,1.0434782608695652,45,22,TTCGCGTGTTTCTGGAGGAA,23,1909554
ihfAp4,2.608695652173913,81,22,TTATCGATACTAGCTTCTTT,59,1951435
ihfAp4,0.34782608695652173,29,22,TTACCTTGCTTTACTCCGCC,7,1923554
ihfAp4,1.4782608695652173,55,22,TGGCGGAAACGTCGCGGGCT,33,1929484
ihfAp4,3.0,90,22,TGGATCGACAGTGGAGTGGT,68,1956915
ihfAp4,1.2173913043478262,49,22,TCTGAAAGTAGATAGTGAAC,27,1939512
ihfAp4,3.0434782608695654,91,22,TCTACACCGCCGGGTTTATA,69,1924620
ihfAp4,1.434782608695652,54,22,TCGTAGCGTTACGCAGCAGT,32,1945457
ihfAp4,1.826086956521739,63,22,TCGGGATCGATAGTCAGTCA,41,1941996
ihfAp4,0.21739130434782608,26,22,TATTGGGCATGTGGTTTCCA,4,1937836
ihfAp4,0.782608695652174,39,22,TAGGGACAGTAAGACCGGTT,17,1960902
ihfAp4,3.652173913043478,105,22,TAGGCCCATAACCCGCTCCT,83,1957053
ihfAp4,1.565217391304348,57,22,TACGCCGTCGTGCACGGAAC,35,1909812
ihfAp4,1.3043478260869565,51,22,TACGCATGCTGCTGTCGTCT,29,1916633
ihfAp4,1.8695652173913044,64,22,GTTCAACCTTCCATGGGTGC,42,1911458
ihfAp4,1.3043478260869565,51,22,GTGGTTCAACACACTCGTCT,29,1947808
ihfAp4,2.4782608695652173,78,22,GTATAACCCTGTTTCGTAAG,56,1911795
ihfAp4,0.9565217391304348,43,22,GTAAGTGCGCGCGAGCAGAA,21,1942480
ihfAp4,1.1304347826086956,47,22,GGTGGCCCACGCTCATATTA,25,1920014
ihfAp4,1.1304347826086956,47,22,GGCTTAGGGACTGGGGGGTA,25,1910071
ihfAp4,1.7391304347826086,61,22,GGCCAGATAACGCTACATCT,39,1916634
ihfAp4,2.5652173913043477,80,22,GGACCAAGTGACACAGGTCA,58,1959282
ihfAp4,1.0869565217391304,46,22,GGAAAACCCCAATCCACTCG,24,1924547
ihfAp4,1.0434782608695652,45,22,GCTTATTACGTGGTCACCTG,23,1950644
ihfAp4,0.4782608695652174,32,22,GCTCTACCGAGTTTGAGGGA,10,1945991
ihfAp4,0.9565217391304348,43,22,GCCGTGACACAATTCTGTCA,21,1932571
ihfAp4,0.5217391304347826,33,22,GCCGGGAGGTACAAGATATT,11,1923107
ihfAp4,2.260869565217391,73,22,GCCAGTTCGATTCCGTTGGC,51,1912091
ihfAp4,0.6086956521739131,35,22,GCCAAAACGCGGGAGATCGG,13,1941026
ihfAp4,2.0,67,22,GCAATTACTCTCGCGGCCGT,45,1949518
ihfAp4,4.913043478260869,134,22,GATTATCAATGTGCTACGAA,112,1944403
ihfAp4,1.1304347826086956,47,22,GATGAGATTTAGCACGCATG,25,1929000
ihfAp4,1.2608695652173914,50,22,GAGTTAAATGACGTTTGACG,28,1946879
ihfAp4,1.9130434782608696,65,22,GACTTGTTATTCGTCCGACG,43,1932840
ihfAp4,4.565217391304348,126,22,GAACTGACGTCTCGGTTCCT,104,1947406
ihfAp4,0.6086956521739131,35,22,GAAATCGCCTTATGTGTCTT,13,1923641
ihfAp4,2.3043478260869565,74,22,CTTTGAAACGGGGTCAGCCT,52,1935341
ihfAp4,1.2608695652173914,50,22,CTGTTTGTCCCGCACTCCAT,28,1925983
ihfAp4,0.34782608695652173,29,22,CTCGGTAAGTCGCGAGTCAG,7,1916728
ihfAp4,2.5652173913043477,80,22,CTAGGGTGGGACCAGGACAA,58,1934522
ihfAp4,3.0869565217391304,92,22,CTAGCAGGTGTACTGCGAGA,70,1941456
ihfAp4,5.391304347826087,145,22,CGTGGCTCACTGGTGATCAT,123,1912318
ihfAp4,0.21739130434782608,26,22,CGTAAACAGCTGTTATAAAC,4,1909656
ihfAp4,0.4782608695652174,32,22,CCTGTGAGTGACTGGAGATA,10,1917493
ihfAp4,1.7826086956521738,62,22,CCTGCTATCCTCGTAGAGAG,40,1941528
ihfAp4,2.347826086956522,75,22,CCTCGGTTGACTAACGAACT,53,1939337
ihfAp4,2.6956521739130435,83,22,CCGGTTACGTACCATGTAAA,61,1928032
ihfAp4,0.6086956521739131,35,22,CCGATGCCAACTAGAAAGCA,13,1931708
ihfAp4,0.7391304347826086,38,22,CCCCAGAATAAAATCCTCAT,16,1914892
ihfAp4,0.782608695652174,39,22,CCCAACGGCTGGTCTCTATT,17,1946021
ihfAp4,2.8260869565217392,86,22,CCCAACGGAAAGGCCCTCGC,64,1950925
ihfAp4,1.6956521739130435,60,22,CCAAGTCATTAAGGCATCGA,38,1932642
ihfAp4,0.9130434782608695,42,22,CATTTTCCTGTTAGTAGTTA,20,1917510
ihfAp4,1.0,44,22,CAGGTAGTTGGGACCCCCGA,22,1947017
ihfAp4,0.08695652173913043,23,22,CAGGCAAGCTTTTTGGCACT,1,1932154
ihfAp4,1.0434782608695652,45,22,CACCAGTTGTGTGCACCGCG,23,1934602
ihfAp4,0.8260869565217391,40,22,CACCAGCGTTCTCCTCCTGC,18,1920831
ihfAp4,3.0869565217391304,92,22,CAACTGACCATCCCCTAAAA,70,1927864
ihfAp4,2.869565217391304,87,22,CAACCCGGTTCCGGATAAAG,65,1951190
ihfAp4,1.6521739130434783,59,22,CAAAAAGTCTGACAACAGAA,37,1918724
ihfAp4,1.1304347826086956,47,22,ATTCCTGCTGTTGCACTCGA,25,1925107
ihfAp4,1.565217391304348,57,22,ATGAGCGCTTAGAAAAAGTC,35,1930130
ihfAp4,0.34782608695652173,29,22,ATGACTTAGTCTCGAACTGG,7,1936745
ihfAp4,1.0434782608695652,45,22,ATGACGTGGCATCGCAGCTC,23,1914708
ihfAp4,1.434782608695652,54,22,ATCTTAGGGTACGCTTGACA,32,1949800
ihfAp4,1.4782608695652173,55,22,ATCAGAGCACTTAGAAACTC,33,1923549
ihfAp4,0.6956521739130435,37,22,AGTAATGTCCAGCGTATGAC,15,1946825
ihfAp4,2.0434782608695654,68,22,AGGTTGAACAAACGGTGCTC,46,1959394
ihfAp4,0.8260869565217391,40,22,AGGCTCTTCTCAATCGGTGG,18,1953992
ihfAp4,0.6521739130434783,36,22,AGAGCAGGGTCTCAAGGCAG,14,1911380
ihfAp4,1.0434782608695652,45,22,ACTGCGAATACGCCCCCTTA,23,1937224
ihfAp4,2.6956521739130435,83,22,ACATTTTAGCCATTCTGTAT,61,1916915
ihfAp4,0.34782608695652173,29,22,AACTTCGAACGCTCAAATAT,7,1919834
ihfAp4,2.9130434782608696,88,22,AAAACGTCCCATTCTGACAA,66,1949037
ihfAp4,0.22727272727272727,25,21,TTGTGGTTTTCTTTAGTCAC,4,1910248
ihfAp4,2.9545454545454546,85,21,TTGGTACCTGTCCCAAATGT,64,1921798
ihfAp4,0.8636363636363636,39,21,TTGGATACATTTGAATAGCC,18,1931435
ihfAp4,0.9090909090909091,40,21,TTGCTGTCTTGGTAGAGGAT,19,1945133
ihfAp4,0.9090909090909091,40,21,TTGATTTATGAATCTTGATC,19,1918971
ihfAp4,0.5,31,21,TGTTGTGTCTCTTCACAGTA,10,1913120
ihfAp4,21.181818181818183,486,21,TGTAAAGCATAGCATTTCCT,465,1942848
ihfAp4,0.9090909090909091,40,21,TGGAACAGATGGAATGTGTA,19,1956684
ihfAp4,3.0454545454545454,87,21,TGCTCATACGACACATCCCA,66,1946262
ihfAp4,1.2727272727272727,48,21,TGCAAGCGGGGCTATAAAGG,27,1926523
ihfAp4,1.1363636363636365,45,21,TCTAGGTGTCGTGAACGCAG,24,1929652
ihfAp4,1.0,42,21,TCCGACATAGGATGAAGAAA,21,1916297
ihfAp4,0.6363636363636364,34,21,TCCAAATCTCCCCCGGCACA,13,1946473
ihfAp4,0.8636363636363636,39,21,TCAGGTTATTAATCCTGTTG,18,1922833
ihfAp4,0.9090909090909091,40,21,TAGTCCGGCGAGGCTCTTGG,19,1951197
ihfAp4,0.5454545454545454,32,21,TAGAGCAAGTTTCGTAACAC,11,1954466
ihfAp4,1.2727272727272727,48,21,TAGACACGCCAGATGGATGA,27,1927974
ihfAp4,0.18181818181818182,24,21,TACACGGTAGGCGTAAATGT,3,1935908
ihfAp4,2.090909090909091,66,21,TAAGCACGTTATGCCTTGGA,45,1922920
ihfAp4,1.5454545454545454,54,21,GTTTTAGCCTTTAGTTTGGA,33,1912638
ihfAp4,2.8181818181818183,82,21,GTGGGGAATGCCAGGTTTAA,61,1956106
ihfAp4,0.09090909090909091,22,21,GTGCCGCTTTCGTCAACCCG,1,1930264
ihfAp4,1.2727272727272727,48,21,GTCTTCTGTTGCGGGACACA,27,1947528
ihfAp4,2.6818181818181817,79,21,GTCGCCTAGGTTTCAGTGCA,58,1929322
ihfAp4,1.7727272727272727,59,21,GTAGTAATAGCCTGACTTGA,38,1953682
ihfAp4,3.090909090909091,88,21,GTACGTGTCCCAAACAGTAC,67,1950224
ihfAp4,0.4090909090909091,29,21,GGGCCAGCGGGTTGGGGTAG,8,1915597
ihfAp4,0.9545454545454546,41,21,GGATTGCTCAGAGGGCGAGC,20,1918305
ihfAp4,0.09090909090909091,22,21,GGAGTTGACGGCGGGAACGC,1,1941880
ihfAp4,1.3636363636363635,50,21,GGAATCCACATTGAGCGACA,29,1939328
ihfAp4,3.272727272727273,92,21,GCGGCTAAGCGGTTAACGAG,71,1925405
ihfAp4,0.7727272727272727,37,21,GCCTCATTGTCTATAACTAA,16,1947360
ihfAp4,0.18181818181818182,24,21,GCAACCGCCACGAGTACCCT,3,1925467
ihfAp4,2.6363636363636362,78,21,GATGACCCTAAGGGACACGT,57,1942682
ihfAp4,5.590909090909091,143,21,GAGTTCAGGGTTGTAAACGA,122,1929663
ihfAp4,8.681818181818182,211,21,GACGGCGCCCTTGTTCCCCA,190,1961572
ihfAp4,1.0,42,21,GACCCTGAGTCTCAATGAAT,21,1921662
ihfAp4,0.13636363636363635,23,21,GACAGTAAGGCGATCCTCGC,2,1918811
ihfAp4,2.909090909090909,84,21,CTCGCGCCTGGGAGTATCTA,63,1921726
ihfAp4,3.6818181818181817,101,21,CTCGCCAAGATTTCCACCAC,80,1938827
ihfAp4,5.545454545454546,142,21,CTCCCGTGACTTAGTACTGA,121,1916452
ihfAp4,1.6818181818181819,57,21,CGGCTTATCTGTGTGGCTAC,36,1959608
ihfAp4,0.9090909090909091,40,21,CCTGAGACACTTGCGCGCGT,19,1924007
ihfAp4,0.7272727272727273,36,21,CCTATTCGATGCGTATAGGC,15,1949621
ihfAp4,1.3181818181818181,49,21,CCGTCACTCCGTCTTCCGGT,28,1926816
ihfAp4,2.727272727272727,80,21,CCGGGCGATCATACACGTGA,59,1918686
ihfAp4,0.2727272727272727,26,21,CCGCACTACACGACCCCTGT,5,1910610
ihfAp4,0.9090909090909091,40,21,CCCTCCTGGAATGTTAGGTT,19,1928318
ihfAp4,4.545454545454546,120,21,CCCGGGCTTCCCACTTTAAA,99,1918287
ihfAp4,3.6818181818181817,101,21,CCACATCATAGATAACGTGA,80,1915936
ihfAp4,0.45454545454545453,30,21,CATTATCGTTGTGACATGAC,9,1931264
ihfAp4,1.1363636363636365,45,21,CATGAGGCCAACTTATACAA,24,1956405
ihfAp4,0.8181818181818182,38,21,CATAATCATGATGATATGAT,17,1945172
ihfAp4,1.1363636363636365,45,21,CACACCAAAGGGCTTTCAAG,24,1953199
ihfAp4,0.18181818181818182,24,21,CAAGTACTTAGGCAGAACCT,3,1914474
ihfAp4,1.8181818181818181,60,21,ATCCCAAGTACCGCGAGGTT,39,1935419
ihfAp4,0.2727272727272727,26,21,ATATGAGCTTAGCATTTAAA,5,1915437
ihfAp4,0.9090909090909091,40,21,ATACACATTTAGTACAGTCA,19,1945533
ihfAp4,1.1818181818181819,46,21,AGTTTGGTCAGCAAAGAATT,25,1939577
ihfAp4,2.3636363636363638,72,21,AGTGGCTAAAGCTTAGGAAG,51,1914228
ihfAp4,4.2727272727272725,114,21,AGGTGTCTCACAGGCCCCTA,93,1918721
ihfAp4,1.2727272727272727,48,21,AGCGCGTGGGGCACGTAGCA,27,1955536
ihfAp4,1.9545454545454546,63,21,AGCCAGCTATGTGTGAGTTG,42,1935240
ihfAp4,3.0454545454545454,87,21,ACTAGCCACGAGTTACCGTT,66,1945944
ihfAp4,1.0454545454545454,43,21,ACGGCTACTGGACAACGTAG,22,1915928
ihfAp4,0.18181818181818182,24,21,ACGCTAGTTGATTCGTGATA,3,1947436
ihfAp4,2.727272727272727,80,21,ACCATCAGCCCACAAATGTA,59,1930770
ihfAp4,0.6363636363636364,34,21,ACCATACTCCGGTGGACCCT,13,1920927
ihfAp4,1.4090909090909092,51,21,AATTTAGATGCGTAAAGAAT,30,1921852
ihfAp4,1.1363636363636365,45,21,AATCGGTGCGTATCACGAGA,24,1941878
ihfAp4,3.409090909090909,95,21,AATATTCGGGATACACTTCG,74,1929542
ihfAp4,0.7272727272727273,36,21,AACGAATAGATGGTTCTCCA,15,1931961
ihfAp4,1.1363636363636365,45,21,AACCGATCCAGCGGAACGTA,24,1926466
ihfAp4,2.1363636363636362,67,21,AAATCCTAGGGAGTTGGGAC,46,1921542
ihfAp4,0.09523809523809523,21,20,TTGTTTGATCACATCCGATC,1,1951207
ihfAp4,1.2380952380952381,45,20,TTGGGCTCACGCCCCATGCA,25,1939413
ihfAp4,4.142857142857143,106,20,TTGCGTACCAAGTGTTTGAT,86,1924067
ihfAp4,1.0476190476190477,41,20,TTGAATTGATAGTTTGTTCA,21,1917373
ihfAp4,1.5714285714285714,52,20,TTCTGGGCACGATACATGCA,32,1944829
ihfAp4,0.8095238095238095,36,20,TTATAATAGCATAGGTGCCG,16,1914778
ihfAp4,1.2857142857142858,46,20,TTAGTATCGTCCTGCACTAG,26,1911182
ihfAp4,1.4285714285714286,49,20,TGGTAGTATGCTTAAATCAC,29,1913127
ihfAp4,1.9523809523809523,60,20,TGGGGTGGTGTCGACTCGCG,40,1947146
ihfAp4,3.4285714285714284,91,20,TCGCCTTTCTTTAAACAAGA,71,1943327
ihfAp4,2.380952380952381,69,20,TCGACGATCGATTGCTAAAA,49,1949039
ihfAp4,1.1428571428571428,43,20,TCCGGATGGATTCAAAGACT,23,1911421
ihfAp4,0.8095238095238095,36,20,TCAGGGTGCTATGTGGAGCT,16,1915206
ihfAp4,1.2857142857142858,46,20,TATGAGTCGATGCAGCGCTC,26,1960436
ihfAp4,1.5238095238095237,51,20,TATCTTGGCTACGACGAGCG,31,1956396
ihfAp4,0.38095238095238093,27,20,TAGCATTAAGCCAACTTAAA,7,1918005
ihfAp4,1.619047619047619,53,20,TACTTCGTGTGGCCTCCTAC,33,1937200
ihfAp4,0.23809523809523808,24,20,TACACCACCTGACGATTAAA,4,1952859
ihfAp4,1.7619047619047619,56,20,TAATCCCCCACCAGTGTGGT,36,1944954
ihfAp4,2.5238095238095237,72,20,GTTTTCGTCGTCCGCTGATC,52,1953955
ihfAp4,2.1904761904761907,65,20,GTTAGATTGAACCCTGTACG,45,1925887
ihfAp4,2.1904761904761907,65,20,GTGGAACCTTTCCTTAGCCA,45,1943785
ihfAp4,0.8095238095238095,36,20,GTATTGGGCCGCGTTCAAGG,16,1957209
ihfAp4,3.380952380952381,90,20,GGGGTCAGCCGTATACCGCA,70,1923828
ihfAp4,1.2857142857142858,46,20,GGGATGAGAATTACTACACA,26,1929933
ihfAp4,0.8095238095238095,36,20,GGCTGCCGTATCACCCTGGT,16,1943215
ihfAp4,0.3333333333333333,26,20,GGAAAAATGTCTCGGAGCGC,6,1911841
ihfAp4,3.7142857142857144,97,20,GCTCTAAGGTTTCTAGGGAA,77,1918045
ihfAp4,0.42857142857142855,28,20,GCTACAAACTCTCATCGGCA,8,1932919
ihfAp4,0.9523809523809523,39,20,GCGGCAGATTCACCTGGGAT,19,1928985
ihfAp4,0.7142857142857143,34,20,GCAGGGAACCGTACCACTCA,14,1914023
ihfAp4,0.8571428571428571,37,20,GCAGCGAAGGCCAGGTTCTT,17,1943358
ihfAp4,0.9523809523809523,39,20,GATACGCTGCGCACGCTTCA,19,1954182
ihfAp4,1.4285714285714286,49,20,GAGTTAACGGAGAAGATCTA,29,1914689
ihfAp4,1.2380952380952381,45,20,GACGCTCGTAGGATGGAGTT,25,1915039
ihfAp4,0.8571428571428571,37,20,GACAGGTACCTCATGTGCCA,17,1929038
ihfAp4,2.238095238095238,66,20,GACAGGGATTCCGAACGCGT,46,1919703
ihfAp4,0.2857142857142857,25,20,GACACACTGGCCGGCAACTA,5,1942714
ihfAp4,4.571428571428571,115,20,GAAGTGGACGAGCGTACCCA,95,1920152
ihfAp4,3.5238095238095237,93,20,GAACGTGCACGGCTCGACAG,73,1944092
ihfAp4,1.2857142857142858,46,20,GAACGGTAGTCTATCTACAC,26,1949122
ihfAp4,2.1904761904761907,65,20,CTGTGCCAGCAAATACCTAT,45,1957458
ihfAp4,1.8571428571428572,58,20,CTGGGTGCCCCGTGGCCGTG,38,1953571
ihfAp4,1.9047619047619047,59,20,CTGCATCGGCTCTCCTCGGT,39,1954656
ihfAp4,4.190476190476191,107,20,CTCTACCATAGCTATGGGCA,87,1920389
ihfAp4,0.6666666666666666,33,20,CTCCGTATTTCCCGTGCACA,13,1954627
ihfAp4,1.5714285714285714,52,20,CTCAAAATATGGCGCGGGTA,32,1926657
ihfAp4,1.5238095238095237,51,20,CTAGTAGTATCCACCTGCAG,31,1916686
ihfAp4,0.9047619047619048,38,20,CTAGAGTCAGCCACCTTTTG,18,1920820
ihfAp4,0.7619047619047619,35,20,CGTCCAGAATGACGCGGTAA,15,1916779
ihfAp4,1.1428571428571428,43,20,CGCTCAGGGGTTCCCTTGGA,23,1921199
ihfAp4,5.809523809523809,141,20,CGATCATGCCGATCATAATG,121,1930307
ihfAp4,2.4761904761904763,71,20,CGACTTCTGACCGGGGCCGA,51,1936830
ihfAp4,1.0952380952380953,42,20,CGACATGAGAGACTGAGTAC,22,1943726
ihfAp4,0.09523809523809523,21,20,CGAATACGCAATATACTCAA,1,1944225
ihfAp4,1.0476190476190477,41,20,CGAAGCTGACCCCCCCGGAC,21,1934058
ihfAp4,3.0,82,20,CGAACACATGACGATTGAGT,62,1929902
ihfAp4,1.6666666666666667,54,20,CCTTCGCATTGAAAGAATGT,34,1919968
ihfAp4,1.7142857142857142,55,20,CCGGGTGCCGTATATGAGAA,35,1916862
ihfAp4,2.2857142857142856,67,20,CCCAACCACAGGTTATCTAG,47,1939299
ihfAp4,1.0476190476190477,41,20,CATCGATCCCTCTATCCGAT,21,1930720
ihfAp4,0.5714285714285714,31,20,CAGAATCCTGCTCGAAGATA,11,1952582
ihfAp4,1.4761904761904763,50,20,CACTATAGGGTATCTTGAAT,30,1957288
ihfAp4,0.19047619047619047,23,20,CAATCTACATGCGCCCTAGC,3,1910325
ihfAp4,0.09523809523809523,21,20,CAACGTGGACTGGTACTACT,1,1915986
ihfAp4,0.7619047619047619,35,20,ATTCAAAGATGAATTATGGT,15,1934670
ihfAp4,0.09523809523809523,21,20,ATGTGCCGGAGCTGGATTAA,1,1950138
ihfAp4,0.3333333333333333,26,20,ATGATAATTGTGGCGAGGTT,6,1929868
ihfAp4,2.6666666666666665,75,20,ATCGCATCGAAGTATAACCA,55,1944309
ihfAp4,2.0952380952380953,63,20,ATCGCAGCCGATAGTGTCAG,43,1960504
ihfAp4,3.142857142857143,85,20,ATCATCGACGCCACGTACCC,65,1942053
ihfAp4,1.380952380952381,48,20,ATCAAGAACCCGGGACCATA,28,1949238
ihfAp4,0.6666666666666666,33,20,ATAATACAACCCAGTCTGGG,13,1937463
ihfAp4,0.6666666666666666,33,20,AGTCACCCGAGACATACGCA,13,1932913
ihfAp4,2.238095238095238,66,20,AGCAAATCAAGTAGCATGGA,46,1950028
ihfAp4,2.1904761904761907,65,20,AGATCATGAGAAAGGAATTC,45,1933835
ihfAp4,0.6666666666666666,33,20,ACTTATCCAATCTACCCTCG,13,1935171
ihfAp4,5.333333333333333,131,20,ACTCCTCCGTTACAGGGGGA,111,1948286
ihfAp4,1.619047619047619,53,20,ACTAATGCCTCGCAAGCAAT,33,1928048
ihfAp4,0.8095238095238095,36,20,ACGCATCCGTAATGATCTAG,16,1952217
ihfAp4,2.5238095238095237,72,20,ACCACACACTGGGAATGATT,52,1913745
ihfAp4,1.4285714285714286,49,20,AATGGGACTAATCTATTGGC,29,1931159
ihfAp4,0.7619047619047619,35,20,AACAGTTTTCGGGTACATTG,15,1924591
ihfAp4,2.9523809523809526,81,20,AAAACATCTACGTGTCACCT,61,1955749
ihfAp4,1.45,47,19,TTTGGGAAGCTCGAAACATT,28,1921701
ihfAp4,1.9,56,19,TTTGCACGGGCCTTCTGAAC,37,1925105
ihfAp4,0.9,36,19,TTTCTCCGCATCTTTCGTAC,17,1950270
ihfAp4,0.75,33,19,TTGTAAAATCCAGGGTGGTT,14,1939382
ihfAp4,2.25,63,19,TTGGACGGTTCCAACCGAAC,44,1924115
ihfAp4,7.15,161,19,TTGCCGAGTGTGAGCTGGAT,142,1930777
ihfAp4,4.9,116,19,TTCTTCGGGAGCGGTTTAGG,97,1954950
ihfAp4,0.5,28,19,TTATCGAAGGCGGAGAACAC,9,1916027
ihfAp4,1.9,56,19,TTAGGCGGTTTTGGATGCCA,37,1911277
ihfAp4,0.45,27,19,TTAGGAGAACGGCACTAGAT,8,1916492
ihfAp4,0.9,36,19,TGTACACGCCGGCTCGGTTG,17,1917676
ihfAp4,0.7,32,19,TGCTGACAATTCGAGGTTTC,13,1947253
ihfAp4,0.1,20,19,TGATCCGTTCGTTTTTCTGT,1,1949101
ihfAp4,1.5,48,19,TGACTTATATGCTGGGGTTC,29,1946780
ihfAp4,0.45,27,19,TCGTAAGCGCTTAAGGCTAT,8,1947913
ihfAp4,2.45,67,19,TCCAGCGAGGGCTCTCGGTA,48,1912536
ihfAp4,7.5,168,19,TCCACTCCTTTCCTAAAGGG,149,1923201
ihfAp4,0.65,31,19,TCATGGTGTAGTCAGTCCGA,12,1957692
ihfAp4,1.55,49,19,TATCACATGTTGCGCCGTCC,30,1927439
ihfAp4,3.8,94,19,TAGGTAACGAGTTAAGAGAC,75,1953411
ihfAp4,4.25,103,19,TAGCAGATTACGACGGGCGT,84,1932704
ihfAp4,0.6,30,19,TAGCAACTCGTACCCAGGAA,11,1941606
ihfAp4,8.45,187,19,TAGATCCTCCAGCGAGAAAA,168,1938540
ihfAp4,3.05,79,19,TACGACCGGCAGTTTAGACC,60,1923748
ihfAp4,0.1,20,19,TAACCCCGGACAGCGCAATT,1,1961996
ihfAp4,0.9,36,19,GTTTGAAAGACAAAAAAAGA,17,1933913
ihfAp4,1.55,49,19,GTTGTCTCTTCTTATACTGA,30,1921446
ihfAp4,0.1,20,19,GTTCACATTCGCCGCTTTTC,1,1931992
ihfAp4,1.55,49,19,GTGTGGATAGTCTATACCTT,30,1960823
ihfAp4,3.6,90,19,GTGGTGCCGTATACATACTT,71,1949212
ihfAp4,1.2,42,19,GTACTACCCCAGGCGTGCTG,23,1915702
ihfAp4,1.95,57,19,GTACCAGTTAATAGTTTGCT,38,1928086
ihfAp4,1.05,39,19,GGGTTTTTCTGGCCCCATCT,20,1943818
ihfAp4,0.1,20,19,GGGCTAAATGGCAGTGTACT,1,1945687
ihfAp4,1.1,40,19,GGGCCTGTTTAGCTTGCAAA,21,1952106
ihfAp4,1.65,51,19,GGCGGAAAGGGCTCTCACAA,32,1936285
ihfAp4,1.8,54,19,GGCCTAAAAATTCTTGACGC,35,1925106
ihfAp4,2.25,63,19,GGAGCGCTTACTAAGACGGG,44,1931363
ihfAp4,0.1,20,19,GGAAACGTCTCCGCGAGTTA,1,1938951
ihfAp4,2.25,63,19,GCTATACTTCTGGGACCTTC,44,1911700
ihfAp4,2.85,75,19,GCGGGATCGGGATTGGACGG,56,1945620
ihfAp4,0.7,32,19,GCGGCAGTACTTTCTTACTG,13,1923112
ihfAp4,0.75,33,19,GCGCATTCACTGGAGTAGCT,14,1946961
ihfAp4,3.1,80,19,GCCATTTGGACCACCAATCT,61,1953390
ihfAp4,1.3,44,19,GATGTTGAATATCAAAAACA,25,1920539
ihfAp4,2.95,77,19,GATGCGTGTAATGTCGCGGA,58,1922367
ihfAp4,2.55,69,19,GATCTGCCTCGGTATTCACT,50,1942393
ihfAp4,9.2,202,19,GATAAGGGAATTTCCTACTC,183,1938105
ihfAp4,2.4,66,19,GAGGGTGTGGAGAGACGGAA,47,1909658
ihfAp4,1.15,41,19,GAGCTGAATCCATTGCCACT,22,1936989
ihfAp4,0.1,20,19,GAGAGTGGGTACACGCTATG,1,1922028
ihfAp4,0.2,22,19,GACGTGAAGGTAGATAGCGC,3,1925979
ihfAp4,1.05,39,19,GAAGGAATCCAGGAGGATGT,20,1937852
ihfAp4,0.95,37,19,GAACTGAAGACGAATGATTA,18,1920671
ihfAp4,2.4,66,19,CTTAAATGGCAGATCGGTTT,47,1919631
ihfAp4,0.1,20,19,CTGGTATCGACCCAAATTGG,1,1955583
ihfAp4,2.25,63,19,CTGCAAATTGCTCGAGCTCA,44,1915884
ihfAp4,2.8,74,19,CTGACTTGGTGGTGGGGAGT,55,1950659
ihfAp4,1.5,48,19,CTGAAATAGTCAGCAGAATG,29,1930046
ihfAp4,0.65,31,19,CTCTCATCGTCGAACGTCGG,12,1939550
ihfAp4,1.0,38,19,CTCCTTCACGCACTTACTAA,19,1946098
ihfAp4,1.2,42,19,CTACGTTTCCAGACCCCAAT,23,1915877
ihfAp4,0.7,32,19,CTACGGCATCGGCCCGCGCA,13,1946832
ihfAp4,0.2,22,19,CTACCCTGTGGTCGCGCGAC,3,1946225
ihfAp4,7.35,165,19,CTAAGTTTGTTCGACGCCCT,146,1928744
ihfAp4,0.5,28,19,CGGGCAAAGTTAGATCCTAG,9,1936592
ihfAp4,0.55,29,19,CGGAGGAACGGCTCTAGGTT,10,1952848
ihfAp4,6.8,154,19,CGAGTATCGGCAGAGGGCTT,135,1912601
ihfAp4,0.1,20,19,CCTTTACGTTGCCACGGACA,1,1911793
ihfAp4,0.5,28,19,CCTCATTCAGCAGACTGTTT,9,1921206
ihfAp4,5.3,124,19,CATTGCCTGGCCAACCTGAT,105,1957946
ihfAp4,1.15,41,19,CATGTCCATCCAGCGTCCAT,22,1912092
ihfAp4,0.85,35,19,CATGATACTTGGATCTATCG,16,1935176
ihfAp4,0.35,25,19,CATCCACACTGTCAGAGGTT,6,1915880
ihfAp4,0.3,24,19,CATATTATAGAGCGTGACGA,5,1912535
ihfAp4,4.25,103,19,CAGTAGCAGTCTAATTTTCC,84,1948380
ihfAp4,1.65,51,19,CAGCGTACGGCGCTATCGGT,32,1921836
ihfAp4,2.3,64,19,CAGACACCGAAACCGGCGGT,45,1954023
ihfAp4,1.15,41,19,CACCTGAAGCAAGAATTTGC,22,1948219
ihfAp4,1.35,45,19,CAATTTGTGAATAGCAAACG,26,1929970
ihfAp4,2.5,68,19,CAATCCGCAAAGTCTGCGAA,49,1921487
ihfAp4,3.8,94,19,CAAAACGACCCCCATAGTAC,75,1957961
ihfAp4,3.6,90,19,ATTGCTGCCAGTCACCCTGA,71,1930913
ihfAp4,1.35,45,19,ATTCCAACAGGGGCGTAGTC,26,1952795
ihfAp4,2.65,71,19,ATGGCAAAAAATGCTCGGAA,52,1911342
ihfAp4,2.75,73,19,ATGGACCGAGATTATAAAAA,54,1939887
ihfAp4,3.45,87,19,ATGATAGGGAGAAGCCAGCC,68,1912412
ihfAp4,1.3,44,19,ATCGTTAAATAGGGAGTGTC,25,1921564
ihfAp4,0.4,26,19,ATCCGAGAGAGCAAACACGT,7,1936584
ihfAp4,0.95,37,19,ATCAGACGCTTAGTCCATGA,18,1920281
ihfAp4,1.1,40,19,ATAGCTGGATCGTTCTATTC,21,1917890
ihfAp4,1.5,48,19,AGTTGGACAGTTGCTTTACA,29,1910403
ihfAp4,2.95,77,19,AGTTGCGGCGGGTACCTTTT,58,1921539
ihfAp4,1.15,41,19,AGGTAGATCTGATGGGCAGG,22,1950000
ihfAp4,0.5,28,19,AGGCACACTACATACGAGCC,9,1919253
ihfAp4,0.9,36,19,AGAGGAGGTTGGCTCGTATT,17,1960820
ihfAp4,3.35,85,19,AGACAAGGTCCTAACTAGGA,66,1926236
ihfAp4,0.65,31,19,AGAATCGTGTCTTTAGGTAT,12,1915981
ihfAp4,0.55,29,19,ACTTGAGCGGCAGCCGCCCG,10,1956323
ihfAp4,0.1,20,19,ACTAACTTACCATCCGCGAG,1,1926963
ihfAp4,0.25,23,19,ACGTGCGCTTAACGCCGACA,4,1926043
ihfAp4,0.65,31,19,ACCTTTTTGCCTGGAAAAGG,12,1925143
ihfAp4,3.95,97,19,ACCTTGGGCGCCGCCGCCCT,78,1943032
ihfAp4,1.0,38,19,ACCGCCGGTCCTTAATCTTT,19,1914639
ihfAp4,0.95,37,19,ACAGTCTAAGGTTGGCTTGG,18,1934674
ihfAp4,1.2,42,19,AATAACAGCATGCAAATTAA,23,1930933
ihfAp4,1.0,38,19,AAGTATGGGTTGGCTCCCGA,19,1915837
ihfAp4,1.3,44,19,AAGGGTGGGCGGAGACGCTG,25,1915772
ihfAp4,1.25,43,19,AACTCTGGCCCGGTTTATAG,24,1956616
ihfAp4,3.05,79,19,AAAGTATAAGAACCGATGGG,60,1960255
ihfAp4,2.8421052631578947,71,18,TTGTCACAAGTGATCGCGTT,53,1947327
ihfAp4,3.473684210526316,83,18,TTGGTGTGCGAGTAATGGGT,65,1952270
ihfAp4,0.10526315789473684,19,18,TTCTTGCGGTGTACGCACTA,1,1937278
ihfAp4,2.4210526315789473,63,18,TTCCTCTCATGCGTGCTCTC,45,1937343
ihfAp4,1.1578947368421053,39,18,TTCCGTGTAACACAGTAGCA,21,1927752
ihfAp4,0.10526315789473684,19,18,TTCCGCTCCGGTACCCTTTC,1,1921126
ihfAp4,1.1578947368421053,39,18,TTCCAGGTCATCCACGGCGT,21,1919758
ihfAp4,2.1578947368421053,58,18,TGGTGTTGAGCGGCGAGTAG,40,1941907
ihfAp4,0.47368421052631576,26,18,TGGGTGAAGCTCTGGACTGT,8,1940435
ihfAp4,0.5263157894736842,27,18,TGGGCCAGGCTTCGCTAGCA,9,1916151
ihfAp4,0.631578947368421,29,18,TGCTCTGGTGCCTCCGAACT,11,1909749
ihfAp4,1.9473684210526316,54,18,TCGTTGTGACACGCACCTTA,36,1950872
ihfAp4,0.3684210526315789,24,18,TCGGTAAGAAGTTCTAGCTA,6,1951281
ihfAp4,3.6842105263157894,87,18,TCCGATCGGCGCTTTATACT,69,1911018
ihfAp4,1.5789473684210527,47,18,TCCAACGCACAGGCTACGCA,29,1941453
ihfAp4,2.1578947368421053,58,18,TATGTGGTGGCTTATACTTG,40,1912316
ihfAp4,0.10526315789473684,19,18,TAGATCGCTTACTGTCCAGT,1,1919198
ihfAp4,0.2631578947368421,22,18,TAGAATCCGTACTATGCCTG,4,1939925
ihfAp4,0.6842105263157895,30,18,TAAGTGGAGTTTTTGATTAC,12,1949335
ihfAp4,0.10526315789473684,19,18,TAAGTGCTGTCGGCACCTCA,1,1916345
ihfAp4,2.0526315789473686,56,18,TAAGAGAAACCTTTCAATCC,38,1961443
ihfAp4,1.9473684210526316,54,18,TAACGCTTTTTTACGCCCAC,36,1913046
ihfAp4,2.0,55,18,GTTGATGAGGAGGGAGCAAG,37,1915753
ihfAp4,4.0,93,18,GTGATTACTTGTTACAAATA,75,1940277
ihfAp4,0.6842105263157895,30,18,GTCTCGTACCGCGAACAGCT,12,1946830
ihfAp4,0.8421052631578947,33,18,GTCTACGCGCAAGACTGAAC,15,1911454
ihfAp4,4.631578947368421,105,18,GTCGCCTCGGACCCAACATA,87,1942500
ihfAp4,1.368421052631579,43,18,GTCGCACCCTCGAGCGGGGA,25,1940407
ihfAp4,1.6842105263157894,49,18,GTAGGGCCAATTGATCGGCG,31,1953679
ihfAp4,2.0,55,18,GTACGCGGATACGGGAATTC,37,1928296
ihfAp4,0.5263157894736842,27,18,GTAAAATTACAGTGCGGTGA,9,1948033
ihfAp4,0.3157894736842105,23,18,GGTCGATATGGACGGGCGGA,5,1937348
ihfAp4,3.1052631578947367,76,18,GGGGAATTGAGTTAATAGAT,58,1944066
ihfAp4,0.9473684210526315,35,18,GGGCATCAGGTAATACGTAT,17,1912471
ihfAp4,1.631578947368421,48,18,GGGACAGTTGTACTCGTCGC,30,1940561
ihfAp4,0.8947368421052632,34,18,GGATTGCTCAGTTTCCGATC,16,1936284
ihfAp4,0.631578947368421,29,18,GGATGCGGAGTGTGGCAGAC,11,1954662
ihfAp4,2.9473684210526314,73,18,GGACGGTATGTGCGGCGGCT,55,1936554
ihfAp4,0.8421052631578947,33,18,GCTTGGTGTCGTTGTAACAT,15,1915094
ihfAp4,2.789473684210526,70,18,GCGGGAAAATGACGGTGGCC,52,1932988
ihfAp4,1.368421052631579,43,18,GCCAGACTCCCAATAAATCG,25,1912225
ihfAp4,3.8421052631578947,90,18,GCCAAGCGAACTGTGTTTAT,72,1918224
ihfAp4,0.10526315789473684,19,18,GCCAAGAGACATGCGACTGT,1,1942191
ihfAp4,1.4736842105263157,45,18,GCATGTCCAATGAGATTTGC,27,1955294
ihfAp4,0.5263157894736842,27,18,GCATCGCCGTTGTGCCCGTT,9,1955017
ihfAp4,6.157894736842105,134,18,GCATATGGGTTTGAGTTATT,116,1927113
ihfAp4,2.4210526315789473,63,18,GCAGAGTAACAAGCTAGGCA,45,1934134
ihfAp4,0.9473684210526315,35,18,GCACGCCAGGCATAAATAAC,17,1922451
ihfAp4,0.42105263157894735,25,18,GATAGTAGTTGTTTATGCCA,7,1920462
ihfAp4,0.7894736842105263,32,18,GAGCGCCCGGGCGTGGCCTT,14,1913242
ihfAp4,0.3684210526315789,24,18,CTTTATTCGCATTGAGGGGT,6,1961106
ihfAp4,0.631578947368421,29,18,CTTATGTAGCTCTGTTCCAC,11,1938641
ihfAp4,7.368421052631579,157,18,CTGTTCGTACCTTTTACCTA,139,1941643
ihfAp4,2.1578947368421053,58,18,CTAGCGAGAAATAGTCGGCG,40,1929194
ihfAp4,5.157894736842105,115,18,CTACGTGCGTGGGATTTGAT,97,1927981
ihfAp4,1.736842105263158,50,18,CTAATTAAACCGATGCCCGT,32,1926524
ihfAp4,1.9473684210526316,54,18,CGTGCAATTACGCCAGAGCT,36,1957798
ihfAp4,0.15789473684210525,20,18,CGGTGCGCTCTACAGATCCA,2,1934893
ihfAp4,2.4210526315789473,63,18,CGGATAAGAACCGGTGGGGA,45,1934902
ihfAp4,3.210526315789474,78,18,CCTGGAGTATGATCGAATCG,60,1909965
ihfAp4,2.6315789473684212,67,18,CCGGCGTTGCTTCAATGAAA,49,1945529
ihfAp4,0.42105263157894735,25,18,CCGCTGAATTCTTCACTTGC,7,1929623
ihfAp4,3.0526315789473686,75,18,CCGAAAGTCACAGCTTAGTG,57,1937203
ihfAp4,2.1578947368421053,58,18,CCCGTCTGACTAGGTGGATC,40,1939889
ihfAp4,1.5263157894736843,46,18,CATGAGGGCTGAACACAAAT,28,1927978
ihfAp4,1.1578947368421053,39,18,CAGTGGCTAACGGATAATCC,21,1912629
ihfAp4,2.263157894736842,60,18,CAGCTTCAGGGTGGCGGAGT,42,1910436
ihfAp4,0.9473684210526315,35,18,CAGCTCGGAGAAGCCAACTG,17,1928050
ihfAp4,1.736842105263158,50,18,CAGAAATTGACCGTCTAACT,32,1915758
ihfAp4,2.9473684210526314,73,18,CACTGGGGATTATGACTTGT,55,1910306
ihfAp4,0.21052631578947367,21,18,CAATTTATGCGTTGGTGAGG,3,1954185
ihfAp4,4.2105263157894735,97,18,CAATAAGGTCGTCCAGGGAA,79,1931644
ihfAp4,0.42105263157894735,25,18,CAACTTAGTGCGAGTCGCTT,7,1930308
ihfAp4,1.0526315789473684,37,18,ATTGAATCGCTAGGGGAAAA,19,1931869
ihfAp4,0.3684210526315789,24,18,ATCTGTGAATAATTTTGGTT,6,1932355
ihfAp4,0.5789473684210527,28,18,ATCGTTAATCGCCCGACACC,10,1926032
ihfAp4,1.368421052631579,43,18,ATCGCGTGAAACACACCAGC,25,1924957
ihfAp4,1.6842105263157894,49,18,AGTGTCATTGCGATTAACTG,31,1910287
ihfAp4,0.7894736842105263,32,18,AGTATCTACTTTCAAGCCAT,14,1957193
ihfAp4,2.4210526315789473,63,18,AGGAAACCATCGGATGCCCG,45,1915162
ihfAp4,1.9473684210526316,54,18,AGCCTTTGGCTTAGCGAGTC,36,1946028
ihfAp4,1.368421052631579,43,18,AGCCTATTATCTATGTGTCG,25,1956178
ihfAp4,2.526315789473684,65,18,AGATGGAGCAGGAAGAGGAC,47,1930722
ihfAp4,0.9473684210526315,35,18,AGATGCTCTCGCGCCTGAAC,17,1936414
ihfAp4,0.10526315789473684,19,18,AGAGTTTCGCCTCGTTAGAA,1,1925773
ihfAp4,1.105263157894737,38,18,AGAGAGTACAATTCTCAAAA,20,1913606
ihfAp4,0.15789473684210525,20,18,AGACGTAATACCTGGGTTGA,2,1913094
ihfAp4,7.157894736842105,153,18,ACTCAGCCATATAGGTCTCG,135,1937622
ihfAp4,1.263157894736842,41,18,ACTAATTTAAGCCAATGGAG,23,1911450
ihfAp4,2.0,55,18,ACCCGACGTCGATTTATGTT,37,1916918
ihfAp4,1.736842105263158,50,18,ACCATGACGGAGCTATGCAA,32,1929095
ihfAp4,1.3157894736842106,42,18,ACATCTATCTACTTTGTAAT,24,1924515
ihfAp4,2.8421052631578947,71,18,ACACAGCGCTACGGACAGCA,53,1934695
ihfAp4,0.10526315789473684,19,18,AATCTAGTCCACATTTGCGT,1,1960900
ihfAp4,2.0,55,18,AAGGTCTTCAAAGGGGCAGA,37,1932522
ihfAp4,11.31578947368421,232,18,AAGGAACAACTATTGTGAAT,214,1941581
ihfAp4,0.8947368421052632,34,18,AAGCGCTCTCACGAAAGATC,16,1958485
ihfAp4,0.7368421052631579,31,18,AACCGTCGAAAAACATAATT,13,1918199
ihfAp4,1.5263157894736843,46,18,AACATCGTTAAGGCATTTGT,28,1946785
ihfAp4,5.368421052631579,119,18,AACATACAATCTTGTGGAGA,101,1943752
ihfAp4,0.8947368421052632,34,18,AACAAGGGCTACTCCGGGCA,16,1916414
ihfAp4,0.8947368421052632,34,18,AAACGTCACCACTGCATGAT,16,1947085
ihfAp4,0.6666666666666666,28,17,TTTATGCTTTTCGGCTTAAA,11,1942085
ihfAp4,0.1111111111111111,18,17,TTTATGCTAGTAGTTGCTGA,1,1958951
ihfAp4,3.111111111111111,72,17,TTTAATGCACGGCATACCCA,55,1961719
ihfAp4,1.8333333333333333,49,17,TTGTGAATATAGGGATGATC,32,1944602
ihfAp4,1.2777777777777777,39,17,TTGGTGGTCACAAAGATCGT,22,1912445
ihfAp4,5.166666666666667,109,17,TTGGACCCTGCAGAGACGCT,92,1953828
ihfAp4,2.111111111111111,54,17,TTGAAACTGTGCCAGTCTAG,37,1937860
ihfAp4,2.111111111111111,54,17,TTAGTGTGCGGCGTACCATC,37,1927775
ihfAp4,2.7222222222222223,65,17,TTACTCGGCCTGTCCGGTGT,48,1949247
ihfAp4,1.2777777777777777,39,17,TGGGTTCGAGCGTTGCCATC,22,1958125
ihfAp4,3.5555555555555554,80,17,TGCATTTAAATGGGGGGAAT,63,1945403
ihfAp4,4.333333333333333,94,17,TGCAATGCGATGCGCTAGAA,77,1959186
ihfAp4,1.0555555555555556,35,17,TGAGACCTTTGCGTATCATT,18,1911607
ihfAp4,0.7777777777777778,30,17,TGAGACAAGAGAATATAGAT,13,1917250
ihfAp4,0.9444444444444444,33,17,TCTTAGGAGTCACTATTGTA,16,1932115
ihfAp4,1.3888888888888888,41,17,TCTAGACGCCTGAAATGTAT,24,1934442
ihfAp4,0.8888888888888888,32,17,TCGTTCCGGGTCTGTTTGAG,15,1917816
ihfAp4,1.5,43,17,TCGTGACATATATTTGCAAC,26,1932550
ihfAp4,2.5,61,17,TCGTCTGCAGCTCTAGCTGG,44,1940248
ihfAp4,0.8333333333333334,31,17,TCCGCAAATCTTAATCAGAA,14,1960087
ihfAp4,4.333333333333333,94,17,TCCCAGTACTTTAGGAAAGA,77,1955579
ihfAp4,2.9444444444444446,69,17,TCATAGATGTTTTGGTCGTT,52,1943034
ihfAp4,0.6666666666666666,28,17,TATGCCGTCCTAGGTGCTGG,11,1951590
ihfAp4,2.6666666666666665,64,17,TAAGGGAGAACGCTCCCACA,47,1947755
ihfAp4,1.5555555555555556,44,17,TAACCTTTGCATGTCAGAAG,27,1935706
ihfAp4,3.0555555555555554,71,17,GTTCTAGAATATCTTGCCTA,54,1937661
ihfAp4,1.0,34,17,GTTAATCACCTGTAAATCGG,17,1912845
ihfAp4,2.888888888888889,68,17,GTGTAGGGATCATCGGAGCT,51,1923084
ihfAp4,0.7222222222222222,29,17,GTGGATTTCAAAGTGGGAAT,12,1912875
ihfAp4,0.1111111111111111,18,17,GTGGACACTACTTACTGCAT,1,1914017
ihfAp4,0.5555555555555556,26,17,GTGCGGGGCCACTCTCTGTA,9,1949937
ihfAp4,3.7222222222222223,83,17,GTCCGAAACACCAACACGGG,66,1956647
ihfAp4,4.944444444444445,105,17,GTCAATCACCAGAACCTCCT,88,1956243
ihfAp4,4.222222222222222,92,17,GTCAAGGTCCTGTCGTCGAG,75,1955694
ihfAp4,1.5,43,17,GTAGTGTAATGGTACCCAGG,26,1920581
ihfAp4,2.111111111111111,54,17,GGTTCAGCTATGCCTGTGCG,37,1938647
ihfAp4,2.611111111111111,63,17,GGTGCGGTGGAGGTAATGTT,46,1946985
ihfAp4,2.7222222222222223,65,17,GGGGAGGAGTCGATCGAGGG,48,1921526
ihfAp4,1.1666666666666667,37,17,GGGCTGGAGGTCTGAGCCCC,20,1935659
ihfAp4,1.0555555555555556,35,17,GGGATAACGCTTGGTTTGTA,18,1953915
ihfAp4,1.5555555555555556,44,17,GGGACTGATCCATCAGTTGC,27,1918697
ihfAp4,2.5,61,17,GGGACAAGAGGCATTCTAAA,44,1912600
ihfAp4,1.9444444444444444,51,17,GGCTATTGAAAGTGTTTCAT,34,1957754
ihfAp4,0.1111111111111111,18,17,GGCCGTGGATCCGAAGGGGA,1,1947251
ihfAp4,0.6111111111111112,27,17,GGAGGGATACGATCTGCTAT,10,1931990
ihfAp4,2.0,52,17,GCTTATTTCGCCGCTTGGTG,35,1937462
ihfAp4,1.5,43,17,GCTAGGCTTCGAAGACCTGA,26,1927283
ihfAp4,1.3333333333333333,40,17,GCCTAAGTCCTAGGGGACGT,23,1951985
ihfAp4,1.0555555555555556,35,17,GCCGTTTAGCTGACTGGAAA,18,1920133
ihfAp4,1.7777777777777777,48,17,GCCGACTATGGGTAGAGATA,31,1922373
ihfAp4,1.1666666666666667,37,17,GCCAGGGGCTAGATCACGCG,20,1941304
ihfAp4,1.5555555555555556,44,17,GCAGCGAGGCCTCAGAAGAC,27,1940983
ihfAp4,0.2777777777777778,21,17,GATCGTTAATCCGCGGTTCT,4,1924625
ihfAp4,2.5,61,17,GATAAATTTTTTGGTCTCAA,44,1941811
ihfAp4,0.6111111111111112,27,17,GATAAATACGCTCCGTAAGA,10,1936998
ihfAp4,1.2777777777777777,39,17,GAGTCGTATCTTCCGCCTGA,22,1933327
ihfAp4,1.0555555555555556,35,17,GAGCTATTCCTCGGAGGCGT,18,1917291
ihfAp4,1.2777777777777777,39,17,GAGACCAGCGTCACTGAGTC,22,1951387
ihfAp4,3.3333333333333335,76,17,GACTACTAGAGTGCTAGGTA,59,1940100
ihfAp4,2.2222222222222223,56,17,GACCAAGGGCTGCATACCTT,39,1925008
ihfAp4,1.0,34,17,GAATCCCAGGCACCGCGTAA,17,1924584
ihfAp4,4.888888888888889,104,17,GAACTTTCCTGCACAGGGTG,87,1934763
ihfAp4,0.4444444444444444,24,17,GAACATGGGACTCCAGGCCT,7,1952805
ihfAp4,2.4444444444444446,60,17,CTTGTCCATTATGCTCCCTA,43,1937610
ihfAp4,1.5,43,17,CTTCCTCCGTGCCCGGCTGT,26,1936204
ihfAp4,0.1111111111111111,18,17,CTGTCATTGCATCGAGTGCC,1,1924767
ihfAp4,2.611111111111111,63,17,CTGTACGTGATCTGGCGTCT,46,1931960
ihfAp4,1.1111111111111112,36,17,CTGACAAAGCCAGGTTGCTA,19,1938409
ihfAp4,1.2777777777777777,39,17,CTCTGGACACCCCACTATCA,22,1914838
ihfAp4,1.1666666666666667,37,17,CTCTGAACCGGTCGGTCTAG,20,1944463
ihfAp4,3.888888888888889,86,17,CTATGGGACTCGAAATGTAT,69,1925519
ihfAp4,2.1666666666666665,55,17,CTAACAGTTGCATTCCCGCC,38,1942532
ihfAp4,0.1111111111111111,18,17,CTAAATGTCACCTCGGGTTG,1,1937409
ihfAp4,1.1666666666666667,37,17,CGTGTTGCTTTGGGAATTAT,20,1912342
ihfAp4,0.1111111111111111,18,17,CGTGTTCTAAGCTTCACAAT,1,1917257
ihfAp4,3.111111111111111,72,17,CGTGATGATTTGGTTTCTGT,55,1912623
ihfAp4,0.1111111111111111,18,17,CGGTACATATACGTTGAGGC,1,1955212
ihfAp4,1.2222222222222223,38,17,CGGGTGATTATTCGCAATAT,21,1932670
ihfAp4,2.2222222222222223,56,17,CGGCTTGAGCTCGACGGACA,39,1957695
ihfAp4,2.6666666666666665,64,17,CGGCGATATCATTTGGCTAC,47,1914281
ihfAp4,0.5555555555555556,26,17,CGGATTAGTGTCCCAGCTCG,9,1934044
ihfAp4,0.8333333333333334,31,17,CGCGGAGTCCAACTTCTGTA,14,1912583
ihfAp4,1.2222222222222223,38,17,CGCATTTGTGTTGTGCCCCG,21,1945222
ihfAp4,1.5,43,17,CGCAGAACGTATCACGGGAT,26,1929709
ihfAp4,0.5555555555555556,26,17,CGATTCATTGTTGAAATGTG,9,1931444
ihfAp4,1.8333333333333333,49,17,CGAGCGGATGGGGGCCTCAT,32,1939739
ihfAp4,3.0,70,17,CGACCATCAGAAACTACAGT,53,1948639
ihfAp4,3.1666666666666665,73,17,CCTTATCTTGTCCGGAACTG,56,1937767
ihfAp4,5.888888888888889,122,17,CCTGGTCCGCAGGCTTGCAG,105,1921860
ihfAp4,1.7222222222222223,47,17,CCTGGCATGCAGAAACTCTC,30,1935838
ihfAp4,1.7222222222222223,47,17,CCCGCGTGCGTTGGCCACCC,30,1914837
ihfAp4,4.555555555555555,98,17,CCCACAGTTCGTGAGCTCGA,81,1933787
ihfAp4,1.0555555555555556,35,17,CCAGAGTGATCACCTGTGTT,18,1912147
ihfAp4,2.0555555555555554,53,17,CCAACTGGGTCAGCATAATA,36,1921866
ihfAp4,2.388888888888889,59,17,CATTCGTTGGAGGATTAGGT,42,1955533
ihfAp4,0.9444444444444444,33,17,CATGTTAGGTTAAAAGGGTG,16,1936484
ihfAp4,1.8333333333333333,49,17,CACGTGGGGTTTCTGCTTGA,32,1933252
ihfAp4,0.3333333333333333,22,17,CACCACTCCGCCCGGAAGCG,5,1923957
ihfAp4,2.1666666666666665,55,17,CAATTTAGTATAGGGTTTAT,38,1912144
ihfAp4,1.0,34,17,CAAGTTTCGATAGCGACTTA,17,1911951
ihfAp4,0.1111111111111111,18,17,ATTGGTGTAGCTTATCTTTA,1,1951484
ihfAp4,2.111111111111111,54,17,ATTGGCTGTTGAAATCTATA,37,1914737
ihfAp4,1.2222222222222223,38,17,ATTCGGAGGGGATTACCAAA,21,1920159
ihfAp4,2.6666666666666665,64,17,ATGTCAGCCAAATCAAGCGG,47,1926069
ihfAp4,1.3888888888888888,41,17,ATGTATGCACACGCGAACAA,24,1925015
ihfAp4,0.7777777777777778,30,17,ATGAATGAGCCAAAGTACAA,13,1917998
ihfAp4,1.5555555555555556,44,17,AGTCCGGTTTATCATCGAGT,27,1944090
ihfAp4,1.0555555555555556,35,17,AGTATAAGAGTAAACATATG,18,1923798
ihfAp4,0.1111111111111111,18,17,AGGCTAGGATACGTTAGCTA,1,1935489
ihfAp4,3.7222222222222223,83,17,AGCAAAGCTCGGCGCAGACC,66,1917138
ihfAp4,1.2777777777777777,39,17,AGATGGTAAAGCAATGGGCA,22,1923944
ihfAp4,0.1111111111111111,18,17,AGATAGTTATGGTTCTTTTA,1,1952173
ihfAp4,0.1111111111111111,18,17,AGAGCGCCAGCCGACGCTTT,1,1954209
ihfAp4,1.2222222222222223,38,17,AGACTCTAAATTCAAAGGAG,21,1944348
ihfAp4,1.2777777777777777,39,17,AGAACCATCCCTGGTGTAAA,22,1928591
ihfAp4,11.777777777777779,228,17,AGAACAAGGGAAGTACGGGT,211,1925420
ihfAp4,3.611111111111111,81,17,ACTTTCCCGAATGCTCGGTA,64,1937400
ihfAp4,0.6111111111111112,27,17,ACTTAGTTTTTTCCTATATT,10,1947090
ihfAp4,4.5,97,17,ACGTTCTCGCTCCAGAGGTG,80,1911339
ihfAp4,4.388888888888889,95,17,ACGCAGGTCCCAAAGACCAT,78,1947271
ihfAp4,1.6111111111111112,45,17,ACCTGTCTCTTGAGTGACAT,28,1956195
ihfAp4,0.5,25,17,ACCGTGAATTTAATCGGGCA,8,1920207
ihfAp4,1.0,34,17,ACCATAGGCACAACGCTCGA,17,1921750
ihfAp4,1.3333333333333333,40,17,ACCATAGCTTAAGGTTCATG,23,1917525
ihfAp4,1.8888888888888888,50,17,ACATCGTTCGGTCCGTTCTG,33,1911020
ihfAp4,1.5555555555555556,44,17,ACACATCGAGGACCATCGCA,27,1916246
ihfAp4,1.4444444444444444,42,17,AATTGCGTGACTACAATCAG,25,1956592
ihfAp4,6.444444444444445,132,17,AAGGGCCGGCAAGTCTTTGC,115,1917928
ihfAp4,1.3888888888888888,41,17,AAACCAGAACGGGACCAAGT,24,1948834
ihfAp4,0.11764705882352941,17,16,TTTGTATTCTTGCGCTGGTA,1,1914515
ihfAp4,6.705882352941177,129,16,TTGTATTGTTCGCCTACAAG,113,1957561
ihfAp4,2.235294117647059,53,16,TTGTAAAGTCAGCATTCGCT,37,1936439
ihfAp4,2.176470588235294,52,16,TTGGACAAAGTGCCAGGCAA,36,1929491
ihfAp4,0.7058823529411765,27,16,TTGCTTATCTCTGTACGTAA,11,1955251
ihfAp4,4.0,83,16,TTCGCCGTGTAGTAGACAGG,67,1912861
ihfAp4,6.0588235294117645,118,16,TTCCTTAGCGGAATTAGTTT,102,1910855
ihfAp4,5.294117647058823,105,16,TTCCGGAAAGGGGGGAGAGG,89,1956433
ihfAp4,0.5294117647058824,24,16,TTCATCTAAAAGGGGATCAC,8,1914458
ihfAp4,0.17647058823529413,18,16,TTATGAACACTGTTGAAGCA,2,1922895
ihfAp4,0.5882352941176471,25,16,TTAAGTACCCTGTCGTTTAA,9,1950137
ihfAp4,1.9411764705882353,48,16,TTAACGGCGGGGAACCCGAA,32,1939480
ihfAp4,0.7647058823529411,28,16,TGTTCAGCGAAAGCATCGAT,12,1948333
ihfAp4,1.0,32,16,TGTGACTAGCGCCTGTCTAT,16,1926034
ihfAp4,1.4705882352941178,40,16,TGCGTGTATATGATTCTAGC,24,1916535
ihfAp4,6.470588235294118,125,16,TGCAGCGATGATGTAAACCA,109,1929195
ihfAp4,1.7058823529411764,44,16,TGATCTGAAAAAAGTGCCGA,28,1945871
ihfAp4,1.2352941176470589,36,16,TGAATGGGATTAGTCATACC,20,1922794
ihfAp4,4.0588235294117645,84,16,TGAATCTTCGGGCCGTTATT,68,1933928
ihfAp4,1.0588235294117647,33,16,TCCGCGGAGCACAGTTGGTC,17,1913252
ihfAp4,2.4705882352941178,57,16,TCCCTGACGTCCCCCGGATC,41,1925727
ihfAp4,2.0588235294117645,50,16,TCCACAAGCGACCACGCCTC,34,1959659
ihfAp4,3.0588235294117645,67,16,TCACAATGCTGCTGTATGGG,51,1960199
ihfAp4,1.411764705882353,39,16,TATGCGTAGTTCCCACAGCG,23,1916967
ihfAp4,1.6470588235294117,43,16,TATGCAATCAAGGCACCGTA,27,1920496
ihfAp4,5.235294117647059,104,16,TAGCTTCCTATTAAGACGCT,88,1939858
ihfAp4,2.411764705882353,56,16,TAGCTTACTAATCACGGGTT,40,1915365
ihfAp4,7.411764705882353,141,16,TAGAGTTCCATAATGCGACA,125,1943241
ihfAp4,1.7647058823529411,45,16,TACTCAAGAAACAACGGATC,29,1927428
ihfAp4,3.1176470588235294,68,16,TACCACATCGTATTAGTGGA,52,1933499
ihfAp4,1.2352941176470589,36,16,TAATACCCACGTTCAGGCAA,20,1936833
ihfAp4,1.9411764705882353,48,16,TAAGTCTTGTAAATTAAATA,32,1941678
ihfAp4,0.35294117647058826,21,16,TAAGCACAATATTGGTTGAA,5,1937816
ihfAp4,1.5294117647058822,41,16,GTTTGCTTTTTTCGGTAACA,25,1952645
ihfAp4,3.7058823529411766,78,16,GTTTCCGGTGGGGAACCCAA,62,1956767
ihfAp4,3.2941176470588234,71,16,GTTGCTGCAACCTGAATCAT,55,1931259
ihfAp4,1.8823529411764706,47,16,GTTGAGTCCCTGGCTTGTAA,31,1960183
ihfAp4,2.2941176470588234,54,16,GTTACGGCTGCGTACGACCA,38,1932126
ihfAp4,3.3529411764705883,72,16,GTGCATATATACGTGCAGGT,56,1938072
ihfAp4,3.9411764705882355,82,16,GTGAAAGCTTATGGAAGATG,66,1945419
ihfAp4,1.5294117647058822,41,16,GTCTTCCAGCGATGAGATAT,25,1944547
ihfAp4,0.11764705882352941,17,16,GTCAATGTTATCAGACAAAG,1,1932673
ihfAp4,0.35294117647058826,21,16,GTATAATGGAACTCGCGGAA,5,1938981
ihfAp4,0.8235294117647058,29,16,GTAGGCTAATCAATAGGGCT,13,1933819
ihfAp4,2.9411764705882355,65,16,GTAGCCTGCAGTCCTATGAT,49,1915617
ihfAp4,0.11764705882352941,17,16,GTAATAGGGGATTTTATCAA,1,1909978
ihfAp4,3.4705882352941178,74,16,GGTTTCTTTCCATATTGTAA,58,1951885
ihfAp4,2.1176470588235294,51,16,GGTTCTAAACTCCGCGCTCG,35,1946157
ihfAp4,4.705882352941177,95,16,GGTGCTGGTCGTATGAATAT,79,1953363
ihfAp4,0.8235294117647058,29,16,GGTCTACTCGGGATTTCGAC,13,1917079
ihfAp4,1.588235294117647,42,16,GGTCACTTGCCTTCAAATTG,26,1955919
ihfAp4,3.6470588235294117,77,16,GGGTACGGCTTTCCGATGCT,61,1914963
ihfAp4,1.8823529411764706,47,16,GGGGATTGAGTACGTGGCCA,31,1919545
ihfAp4,2.0,49,16,GGGCTAGCCCAAGTAGAAAA,33,1915925
ihfAp4,2.9411764705882355,65,16,GGGCCACGTGCATTCATAAT,49,1943202
ihfAp4,0.7647058823529411,28,16,GGATCGTATATGTACACTGC,12,1927867
ihfAp4,0.11764705882352941,17,16,GGATCAGCTTTTGCAATATT,1,1926865
ihfAp4,3.823529411764706,80,16,GGAGTAACATATATTCAGCC,64,1944906
ihfAp4,1.2352941176470589,36,16,GGACGTTGACCCAGGGCCCC,20,1910992
ihfAp4,0.8823529411764706,30,16,GCTTTGGCATGGAGTATTAG,14,1937912
ihfAp4,1.7058823529411764,44,16,GCGTACGGCTGTAAGACCGT,28,1935840
ihfAp4,1.1176470588235294,34,16,GCGATTCGGGCGATGCAATT,18,1962310
ihfAp4,10.0,185,16,GCGAAGTGCAAAAAGAATTC,169,1960233
ihfAp4,2.2941176470588234,54,16,GCATCGTAACGCATACCGCA,38,1945282
ihfAp4,2.9411764705882355,65,16,GCATCGGAAGTGAATCTGAC,49,1930763
ihfAp4,0.8823529411764706,30,16,GCAAAGCACCTTTGTTGCCC,14,1940998
ihfAp4,2.8823529411764706,64,16,GATTAGTGTAAAGACATCCA,48,1959364
ihfAp4,6.882352941176471,132,16,GAGCTGCTCCAGGTGGAACT,116,1926698
ihfAp4,3.2941176470588234,71,16,GACACCGGAATGCACGACTA,55,1957563
ihfAp4,5.294117647058823,105,16,GACAATGTTCGCCTAGGGCT,89,1948784
ihfAp4,0.11764705882352941,17,16,GAAGCGACTATTTGGTCCGT,1,1932122
ihfAp4,2.411764705882353,56,16,GAAGCCTAGTCTCCCTAGTA,40,1931277
ihfAp4,0.17647058823529413,18,16,GAACCTCAAGTCTCTATGTT,2,1932322
ihfAp4,0.7647058823529411,28,16,GAACAGCCAGCTCTGATGAA,12,1916182
ihfAp4,3.7058823529411766,78,16,CTGGGGTCTGTGATCGTCTT,62,1928892
ihfAp4,2.7058823529411766,61,16,CTGGGCGGCGGGACCGCCCC,45,1955330
ihfAp4,0.8235294117647058,29,16,CTGGGAATCTCGGACGTGCG,13,1945475
ihfAp4,3.0,66,16,CTGACAATCCAGTTGAAATG,50,1928278
ihfAp4,1.411764705882353,39,16,CTCTCTCCAGTACGGCCAAG,23,1933080
ihfAp4,2.176470588235294,52,16,CTCGATACGTTCAAAGCAAA,36,1936949
ihfAp4,2.2941176470588234,54,16,CTCAGCGCCGGGGTAACGGC,38,1918687
ihfAp4,3.0,66,16,CGTGTCAGCTCTGCGTTACG,50,1925224
ihfAp4,3.2941176470588234,71,16,CGTCGGAGTGATTCCAGCGC,55,1933672
ihfAp4,3.235294117647059,70,16,CGGTTACCATCAGGGCCGCA,54,1935343
ihfAp4,0.29411764705882354,20,16,CGGTCGGGGCTTCGGCGGCA,4,1945881
ihfAp4,5.470588235294118,108,16,CGGTCAGTCTAAACTTTGGT,92,1950990
ihfAp4,1.1764705882352942,35,16,CGGAGGCTGGCGACAAACAT,19,1911844
ihfAp4,1.3529411764705883,38,16,CGCGGGGACTTCGCCCTCGA,22,1912721
ihfAp4,1.2352941176470589,36,16,CCTATTTATAGGTGTAATCT,20,1921139
ihfAp4,2.0588235294117645,50,16,CCGTTGAGAAAGATTAGGGG,34,1926829
ihfAp4,1.3529411764705883,38,16,CCGTCACACGGGTTTGCTTT,22,1928434
ihfAp4,0.29411764705882354,20,16,CCGGGCAACACTACCCGACA,4,1937374
ihfAp4,2.176470588235294,52,16,CCCTGGCCAGGGGTAACAAA,36,1942583
ihfAp4,2.2941176470588234,54,16,CCACACATAGCTATCTCCAA,38,1955110
ihfAp4,4.176470588235294,86,16,CCAATTTCCTTTAACCTGTT,70,1920629
ihfAp4,1.1176470588235294,34,16,CATTGCATTTCACGCTTAAA,18,1939481
ihfAp4,0.7058823529411765,27,16,CATTATATTGTGACCTGTTC,11,1920765
ihfAp4,1.3529411764705883,38,16,CATGTACTCGTTGGAACCAG,22,1931112
ihfAp4,1.4705882352941178,40,16,CAGTGCTCTGAACCCGAGTT,24,1919179
ihfAp4,3.3529411764705883,72,16,CAGTCTCGCGTGTAATAGCT,56,1933401
ihfAp4,1.588235294117647,42,16,CAGGTACCGAGGGATGCGGG,26,1940178
ihfAp4,0.4117647058823529,22,16,CACGCGGTTACGCCATTCGT,6,1920492
ihfAp4,0.11764705882352941,17,16,CACACTTAGTATTACTTGTC,1,1956952
ihfAp4,2.411764705882353,56,16,CAATTTAACTTAACTGAGTG,40,1928265
ihfAp4,0.29411764705882354,20,16,CAACATGAAAGACGTTGGGT,4,1939433
ihfAp4,0.8823529411764706,30,16,CAAATCTCACTCGTCACCAC,14,1911503
ihfAp4,1.1764705882352942,35,16,ATGGGATTATTCAAGGGATT,19,1955422
ihfAp4,1.9411764705882353,48,16,ATGACGCCGCACTCCAGGCC,32,1945992
ihfAp4,5.470588235294118,108,16,ATCTGTAGGATACTCAAAAT,92,1930371
ihfAp4,2.235294117647059,53,16,ATAGGGCGTTCCCGTTGCAG,37,1932307
ihfAp4,1.1764705882352942,35,16,AGTTTATTGCATCGAGTACG,19,1934976
ihfAp4,4.647058823529412,94,16,AGGTCTTCGCTTCCAGAAGA,78,1911696
ihfAp4,0.11764705882352941,17,16,AGGGTCCTTAGGCTCCCATA,1,1940210
ihfAp4,1.6470588235294117,43,16,AGGCGGTACTTCCTCCCATA,27,1950654
ihfAp4,1.8235294117647058,46,16,AGGATTAGTTAGGCCTCGGG,30,1920201
ihfAp4,1.3529411764705883,38,16,AGCTCAAAGACATTTTTGGC,22,1952249
ihfAp4,0.5882352941176471,25,16,AGCGCCATCATTAGGACTTC,9,1926272
ihfAp4,1.6470588235294117,43,16,AGCCTTAGCAACTTGAGTAA,27,1961808
ihfAp4,0.11764705882352941,17,16,AGATACCGTCGCTCTCGTTG,1,1919782
ihfAp4,1.0,32,16,AGAGAATGTGTGTTTCACTA,16,1946446
ihfAp4,6.588235294117647,127,16,AGAACCGAGGCATGGGTAGT,111,1936805
ihfAp4,1.8823529411764706,47,16,ACTTGTCGGCTGCAGACACC,31,1912742
ihfAp4,1.8235294117647058,46,16,ACTTGGTGACTCCATCAGGC,30,1926441
ihfAp4,0.8823529411764706,30,16,ACTTCAATTCGTAATTATGT,14,1941754
ihfAp4,3.764705882352941,79,16,ACTAAGTATATGCCTCAAAA,63,1913790
ihfAp4,0.29411764705882354,20,16,ACGTGCGAGGCCGTGCAGGC,4,1920663
ihfAp4,0.35294117647058826,21,16,ACCCTCTCTCCCAGCCTTCT,5,1951521
ihfAp4,1.2941176470588236,37,16,ACCCAACGTGGACGTAACAA,21,1932123
ihfAp4,2.0,49,16,ACATTTGAGAAGGCGACATA,33,1923801
ihfAp4,1.6470588235294117,43,16,ACAGAGGTCAGACGTGATAG,27,1948218
ihfAp4,1.6470588235294117,43,16,ACAATAAAAACGGGCGTAAT,27,1929394
ihfAp4,1.411764705882353,39,16,AATTAATAGTAGAATGATTC,23,1927359
ihfAp4,1.3529411764705883,38,16,AAGTGACCCCCGGTGTTGTT,22,1948624
ihfAp4,3.9411764705882355,82,16,AAGATGGCGCACCAGGTTTC,66,1934955
ihfAp4,1.3529411764705883,38,16,AACGGTTTGTCGCTTATGGG,22,1959580
ihfAp4,6.764705882352941,130,16,AAATTTAATTTTTTCCTTTT,114,1919206
ihfAp4,4.235294117647059,87,16,AAATCCAAGGCTCCCGGTTT,71,1928749
ihfAp4,0.8235294117647058,29,16,AAAGGTCCTCTGATCGTTGG,13,1919464
ihfAp4,2.411764705882353,56,16,AAAAGCCCGATTCCCTACGT,40,1945847
ihfAp4,1.25,34,15,TTTGCAGAAATTTATCTTTA,19,1953645
ihfAp4,2.4375,53,15,TTTATTTATCAAGAGGGTGG,38,1944098
ihfAp4,1.375,36,15,TTGGGTTCAGGTGATAGTAA,21,1937135
ihfAp4,4.1875,81,15,TTCTACCTCATGATGGCTAC,66,1934217
ihfAp4,1.3125,35,15,TTCCGAGGCCGGCGTAGTAA,20,1943782
ihfAp4,2.125,48,15,TTAACGCTTCACGACATCGC,33,1942974
ihfAp4,0.4375,21,15,TGTCCGATGCATGTAGGATT,6,1921496
ihfAp4,2.1875,49,15,TGTAGGAATAGGTTGGGCAG,34,1925386
ihfAp4,0.125,16,15,TGTAGCTCACTGGTCCACCT,1,1959551
ihfAp4,2.125,48,15,TGGGGATTCCCAAACCACTC,33,1913493
ihfAp4,0.25,18,15,TGGGAGAGCATTGATTCTAA,3,1931774
ihfAp4,1.875,44,15,TGCACCTGTCGGGGCTTGTT,29,1925667
ihfAp4,3.875,76,15,TGCACCTCTAGACTTATCAT,61,1932844
ihfAp4,4.1875,81,15,TGATTATGTAACATTGGCGT,66,1935935
ihfAp4,4.9375,93,15,TGATATGGGCCTCGCAAGCT,78,1961191
ihfAp4,1.6875,41,15,TGAGTGACGTGAACGGTCTG,26,1934291
ihfAp4,0.875,28,15,TGACGAGTTGACGAGAGTGA,13,1921134
ihfAp4,1.25,34,15,TGAATGTAGGGTTTTTAATC,19,1940491
ihfAp4,1.3125,35,15,TGAACGGGCCAGCTCTTCAG,20,1940177
ihfAp4,2.625,56,15,TGAAATCATGTACGGCTCCA,41,1961217
ihfAp4,1.125,32,15,TCTTGGGGCTAACCATCGGA,17,1947676
ihfAp4,1.375,36,15,TCGTTTGGCTTATCAAAAAA,21,1929050
ihfAp4,1.0625,31,15,TCGTTACCCCGGAGGCGAGT,16,1927041
ihfAp4,2.0625,47,15,TCGTCAGTATACCTTAACTT,32,1915644
ihfAp4,3.875,76,15,TCGTCACAAGCGTGTATAGA,61,1916580
ihfAp4,1.6875,41,15,TCGGGTCGAAAGCTAGTCAC,26,1925067
ihfAp4,4.1875,81,15,TCCTAACAAATCTATTTACA,66,1924772
ihfAp4,4.375,84,15,TCCACGTTTCATAGCATAAA,69,1930397
ihfAp4,0.5,22,15,TCAGGGAACAGTCCAGATTA,7,1942498
ihfAp4,2.125,48,15,TATGTCTTGCGGTTATCAAA,33,1938849
ihfAp4,2.25,50,15,TATATTCTTTAATTTTACTC,35,1939708
ihfAp4,1.6875,41,15,TAGCGGAGGAAACGAGCAGG,26,1944546
ihfAp4,0.6875,25,15,TAGCGCTGTCCCCTAAGCCC,10,1928909
ihfAp4,4.1875,81,15,TAGATTTCCAGACGGGACAT,66,1915161
ihfAp4,1.25,34,15,TACTGGGTATAGTTCATTCC,19,1911740
ihfAp4,0.875,28,15,TACGGTGCTGCGATCCGTTG,13,1936878
ihfAp4,0.4375,21,15,TACATCTGAGCAATGCGGAT,6,1917688
ihfAp4,0.75,26,15,TACACAGTAGGCTAGTCCTT,11,1953528
ihfAp4,1.3125,35,15,TAAACTTAAAGGTCGATTCT,20,1919257
ihfAp4,2.375,52,15,GTTGCATGCTATGTCATCGG,37,1920932
ihfAp4,0.75,26,15,GTTCGGAGTTGAGTAGGCCT,11,1912605
ihfAp4,2.8125,59,15,GTTACGAATATGCGCCCGTG,44,1951564
ihfAp4,0.625,24,15,GTGTATTCCGAATCAAGGCA,9,1911611
ihfAp4,0.9375,29,15,GTGCTCGATCGAATCGGTGA,14,1941162
ihfAp4,2.0625,47,15,GTCTGAGCTGCGGACAGATC,32,1917248
ihfAp4,4.8125,91,15,GTCCACCAGTACAGACACCC,76,1915006
ihfAp4,1.5,38,15,GTATCACTTTGGTAAACGCT,23,1959833
ihfAp4,3.25,66,15,GTATAGTATACGGGTAGGGT,51,1931271
ihfAp4,1.4375,37,15,GTAGTTTATTGACCGGAGGA,22,1933402
ihfAp4,1.125,32,15,GTAGACCATCGGCATAACTC,17,1940388
ihfAp4,1.375,36,15,GTACGGCAGAAGGATCAGGT,21,1920713
ihfAp4,4.125,80,15,GTAACGCTACTAAACTCCCG,65,1924052
ihfAp4,2.1875,49,15,GTAAATAGACGTTCTTTACT,34,1953351
ihfAp4,0.1875,17,15,GGTTACGAACAGAATGTCAT,2,1939687
ihfAp4,1.6875,41,15,GGTATGTGAGCCGCACGGGG,26,1924923
ihfAp4,0.125,16,15,GGGTTCAGTGTGCGCACTAT,1,1938934
ihfAp4,1.8125,43,15,GGGTCGTATCGGTCTTAACT,28,1935095
ihfAp4,1.875,44,15,GGGCAATGCACACAGGTTCT,29,1932200
ihfAp4,3.1875,65,15,GGCTTCTAGCCAGGTTGGCA,50,1930401
ihfAp4,5.25,98,15,GGCTCGCGTCGCTGTGACCT,83,1936655
ihfAp4,1.375,36,15,GGCGTGATTACTCTGGTGGC,21,1913173
ihfAp4,3.75,74,15,GGACTACGGGTTAGGGCACA,59,1924975
ihfAp4,1.125,32,15,GGACGCTCGAGTTTATGCAT,17,1938228
ihfAp4,0.75,26,15,GGAATTAGGTTAGGCCGCTT,11,1923910
ihfAp4,2.0625,47,15,GCTTAACAAAATTGTTTGTT,32,1918184
ihfAp4,0.9375,29,15,GCTCGTATGTGATCAGAGCT,14,1911497
ihfAp4,2.9375,61,15,GCGGCTGCGGAGTTACGGAG,46,1924989
ihfAp4,2.5,54,15,GCGGAGCCGTGCAGAGGTCA,39,1921765
ihfAp4,3.625,72,15,GCCTGGCCTTCCACATGCTG,57,1934767
ihfAp4,2.375,52,15,GCCTATCATGTTATTTCGTT,37,1927930
ihfAp4,1.0,30,15,GCCCTCGCTTACGCTGTAGA,15,1915698
ihfAp4,1.9375,45,15,GCATCGATTGTGCACGGCGG,30,1930670
ihfAp4,4.375,84,15,GCATACTCTTCCCCGTCGGT,69,1944227
ihfAp4,1.0625,31,15,GATGAAACACCGTCTATTCA,16,1935242
ihfAp4,7.3125,131,15,GATCGCGCGGCACAGGAGTA,116,1927979
ihfAp4,0.625,24,15,GAGGGGGTGAAAAATTGCTC,9,1914417
ihfAp4,2.0625,47,15,GAGCACTTACGGGGGAAGTA,32,1929521
ihfAp4,3.125,64,15,GAGATTACGCTCGGGTCGTT,49,1937087
ihfAp4,1.5,38,15,GAGACGTCGGCATAAATCAA,23,1930988
ihfAp4,3.6875,73,15,GACCGGGAACACTTGGAATA,58,1910427
ihfAp4,2.6875,57,15,GACATGCGGGTTTACTGCGG,42,1920931
ihfAp4,0.125,16,15,GAAGCGTGGTCAGCACACGA,1,1928789
ihfAp4,2.25,50,15,CTTAGATAACCGTCGTATAC,35,1918587
ihfAp4,0.625,24,15,CTGCTTAACTATTAGGCGGT,9,1921438
ihfAp4,0.875,28,15,CTCATGAAGAGCTTATTTTG,13,1932152
ihfAp4,0.125,16,15,CTCAGGGTAAGAAGCTCCGG,1,1915604
ihfAp4,0.8125,27,15,CTCAAGGGGCCGCTTCAACT,12,1942602
ihfAp4,5.125,96,15,CTATGATTAACCAAGCGTTA,81,1918288
ihfAp4,1.5625,39,15,CTAGTACAGCAATCGGCAGT,24,1946195
ihfAp4,1.125,32,15,CTACGGATCCCCTAATCCCA,17,1933506
ihfAp4,2.0625,47,15,CGTTTACACGTGACAAGTTC,32,1932304
ihfAp4,3.1875,65,15,CGTAGAACCCTAAGCCGATT,50,1919844
ihfAp4,8.5625,151,15,CGAAAGGCCCTCCCGATCCT,136,1918585
ihfAp4,5.4375,101,15,CCTGGAGCTTAATATTCATG,86,1913542
ihfAp4,2.75,58,15,CCGTCTCGAAGATTGAGGGT,43,1948545
ihfAp4,0.125,16,15,CCGGTATAATGAGTCCGCTT,1,1921845
ihfAp4,0.375,20,15,CCGGGTGAAATTTCTACTCA,5,1953605
ihfAp4,0.5625,23,15,CCGCTACAATCAGGAAGGAC,8,1929142
ihfAp4,1.0625,31,15,CCCTGCGTTGACCGCAGTTA,16,1929039
ihfAp4,1.0,30,15,CCCGCTGCTACGCCCGGCTC,15,1910984
ihfAp4,0.9375,29,15,CCCCAGTCCACTACTCCATA,14,1922169
ihfAp4,1.9375,45,15,CCATTTGTGATTCTTCTGCA,30,1913519
ihfAp4,4.9375,93,15,CCACGATATTAGGGGGTGGG,78,1940039
ihfAp4,1.6875,41,15,CAGGGTCCGCAAGGCTCGTT,26,1950745
ihfAp4,4.25,82,15,CAGCTCGACACGCGATGCAT,67,1942485
ihfAp4,0.25,18,15,CAGCGTGTTCGCCGATCTTG,3,1925421
ihfAp4,0.75,26,15,CAGAAGAGTGCTCCCCGGAG,11,1925450
ihfAp4,1.1875,33,15,CACTAGGGAGCCTCCACATG,18,1925864
ihfAp4,2.8125,59,15,CACGAGCGGTCTAATAATGT,44,1946606
ihfAp4,0.75,26,15,CACCTATCGGGTGCCAGTTT,11,1958958
ihfAp4,1.375,36,15,CACACCTCCACGCACACAAC,21,1936766
ihfAp4,2.375,52,15,CAAGACTGGAGTGTGTCACG,37,1950390
ihfAp4,6.8125,123,15,ATTGATCGGAAAACTTTGTA,108,1948913
ihfAp4,0.125,16,15,ATGGGGGGCTGTTTTGCGTT,1,1926163
ihfAp4,0.4375,21,15,ATGGCGGAGCCCGAAGGGTT,6,1942310
ihfAp4,1.9375,45,15,ATGGCAGGTAAACAGTCGTT,30,1926075
ihfAp4,1.4375,37,15,ATCTTAGGTTCCTTTGTACG,22,1915770
ihfAp4,2.6875,57,15,ATCTCCCTTGGACGCATTGA,42,1947019
ihfAp4,1.25,34,15,ATCGATAACTCTTTCCTCGC,19,1910365
ihfAp4,1.25,34,15,ATCCTACCACGATAACGATA,19,1934435
ihfAp4,0.6875,25,15,ATCCAACTCGTACAAACTAA,10,1937784
ihfAp4,0.25,18,15,ATCAAGCCGCGACGCGGACT,3,1945242
ihfAp4,1.0,30,15,ATACTGGAAGCATCAATGTA,15,1941301
ihfAp4,3.75,74,15,ATAAGACCGAAGCGAGAGAT,59,1941947
ihfAp4,1.8125,43,15,AGTTTTAAAACAGGGTCAAC,28,1934315
ihfAp4,1.5625,39,15,AGTTGATCGAGTTAAGTCTA,24,1925886
ihfAp4,3.125,64,15,AGTGTAACCAGTGGCCCAAT,49,1916602
ihfAp4,0.3125,19,15,AGTAACATCATGAATTTGTT,4,1939515
ihfAp4,1.5625,39,15,AGGTGGCTTTACGATTACTG,24,1944142
ihfAp4,2.6875,57,15,AGGTCGTAGCTCGTGAATAG,42,1946703
ihfAp4,0.125,16,15,AGGCTTCAGCCCTCTGGATA,1,1919713
ihfAp4,2.5625,55,15,AGCGTTCTCTACTTTCGCGT,40,1929906
ihfAp4,1.9375,45,15,AGCGTAGCGTACGTTCTGGT,30,1915166
ihfAp4,2.75,58,15,AGCAGTTCATGCACCAGTCT,43,1929555
ihfAp4,0.75,26,15,AGCAAGCATGCGCCGAGGGT,11,1957304
ihfAp4,2.0,46,15,AGAGAAAAGATAACTCTGAT,31,1947207
ihfAp4,6.1875,113,15,ACGTGGTAATGTCAAATCAC,98,1961970
ihfAp4,2.0625,47,15,ACGTAGACAACCTGATGCCT,32,1929105
ihfAp4,1.3125,35,15,ACGGACGTATTATGCCAGAC,20,1944440
ihfAp4,1.125,32,15,ACGAGCGATTCCGTCGCCGT,17,1948889
ihfAp4,1.25,34,15,ACCTGAGACCTGCTTACTGT,19,1955421
ihfAp4,1.625,40,15,ACCGTCACAACTGGGTTATC,25,1929791
ihfAp4,0.6875,25,15,ACCGGGTGGAAGTATCACAG,10,1926462
ihfAp4,0.9375,29,15,ACCGATGAACGTGCCACCAT,14,1948613
ihfAp4,0.75,26,15,ACCCAAAGTACTACATTACA,11,1938858
ihfAp4,1.8125,43,15,ACATGCAGCATACGTTCCTT,28,1939510
ihfAp4,0.6875,25,15,ACATCGGGCATCATCTACTA,10,1947122
ihfAp4,0.5625,23,15,ACAGGCGGCAAAAGCGAATT,8,1919561
ihfAp4,3.375,68,15,AATTTGGTTCGCCCTATACT,53,1919093
ihfAp4,3.75,74,15,AATAAATCTCGGGTAAAATG,59,1912902
ihfAp4,3.0,62,15,AAGTAATAAGGAAGGCTTTC,47,1931471
ihfAp4,1.6875,41,15,AAGGGTCATTTGCTTTAGAT,26,1940355
ihfAp4,1.875,44,15,AACTGGCTGGCAGAGCCTTG,29,1961521
ihfAp4,0.375,20,15,AACTACTGCCATGAGCAGGA,5,1926863
ihfAp4,2.25,50,15,AAAGAGACTCCATGGATGCT,35,1958160
ihfAp4,3.25,66,15,AAACAACATCGGAATATGTG,51,1920202
ihfAp4,1.5,38,15,AAAACAGCACATTGGGATAT,23,1919382
ihfAp4,2.8666666666666667,56,14,TTTGCACAGAAGGCCTTACA,42,1931775
ihfAp4,5.2,91,14,TTTCGTCATGAACAGGCTAT,77,1948835
ihfAp4,1.5333333333333334,36,14,TTTATGTTCGGCCCCAGGAA,22,1921102
ihfAp4,1.3333333333333333,33,14,TTGTCCCACTCGCACACGAC,19,1920836
ihfAp4,2.0,43,14,TTGCAAAAACACGTACACAG,29,1922893
ihfAp4,3.8,70,14,TTCGTAGTAGCTCAGTATTG,56,1938725
ihfAp4,2.8666666666666667,56,14,TTATCAGTTTACTCTTTCAA,42,1948529
ihfAp4,2.2,46,14,TTAGTATGCCCACACGCAAG,32,1951398
ihfAp4,1.1333333333333333,30,14,TTAGTAAAGCGTTTACGAGT,16,1913840
ihfAp4,0.9333333333333333,27,14,TTAGCGTGCGTTTTCCCGAC,13,1947467
ihfAp4,1.4,34,14,TTAGCGGCTAAGGTGACCAC,20,1931477
ihfAp4,0.13333333333333333,15,14,TTACATGGCTTCAGACACCA,1,1916741
ihfAp4,1.0666666666666667,29,14,TGTGGCGGGCCAAACTATCA,15,1937181
ihfAp4,0.13333333333333333,15,14,TGTGGACTCGTGGTTATGGT,1,1947802
ihfAp4,3.066666666666667,59,14,TGTCCGGGGAAGGTTGTGGT,45,1935898
ihfAp4,0.8666666666666667,26,14,TGGGATTCGGGTTAACGTGA,12,1931649
ihfAp4,1.6,37,14,TGGCTTCATCTCGTAATGGA,23,1928981
ihfAp4,0.7333333333333333,24,14,TGCTCTTTAGTGGTCAGACT,10,1947258
ihfAp4,0.7333333333333333,24,14,TGCTCGGAAAGCTTGATTGG,10,1955029
ihfAp4,9.866666666666667,161,14,TGCTCCATGTGGGCGGATCC,147,1958417
ihfAp4,0.8,25,14,TGCTCAAGGTGTTTATAACC,11,1910725
ihfAp4,1.0666666666666667,29,14,TGAGAGCGCTTTCTAATAAC,15,1912775
ihfAp4,3.933333333333333,72,14,TCTGCCGCGAGACACTAACA,58,1956608
ihfAp4,0.8,25,14,TCGTCCAGACGTAGGGTAGG,11,1919014
ihfAp4,2.933333333333333,57,14,TCGGTGGCTCATATACGTTA,43,1927186
ihfAp4,1.1333333333333333,30,14,TCGCTTGTGCTTATCGTAGG,16,1926519
ihfAp4,2.2,46,14,TCGCATACATTTCAACGTGT,32,1933848
ihfAp4,1.3333333333333333,33,14,TCCTCTTCATAGTAGGTGGG,19,1911654
ihfAp4,1.4666666666666666,35,14,TCCTCCTCCAAATTCTGGAA,21,1941609
ihfAp4,0.8,25,14,TCCGGCCCAAAGTCCTGGAT,11,1939581
ihfAp4,5.266666666666667,92,14,TCCCGTAGAGCACCGAAATT,78,1932111
ihfAp4,1.7333333333333334,39,14,TCCCACACTGCGCATGGCGA,25,1954361
ihfAp4,3.066666666666667,59,14,TCCAACTGTACAGGAAAACA,45,1947494
ihfAp4,1.5333333333333334,36,14,TCAGAAGAAATTGCCCTAGA,22,1942608
ihfAp4,1.8666666666666667,41,14,TCAACCTTCCTGGCAAGGTC,27,1913092
ihfAp4,7.066666666666666,119,14,TACGTGGCAAACCCGCGGTC,105,1916213
ihfAp4,2.2,46,14,TAATCGTATACCTTTTTCTG,32,1909902
ihfAp4,0.7333333333333333,24,14,TAATACTGGATTGTCCGGAA,10,1940988
ihfAp4,1.1333333333333333,30,14,TAACTCGCTTGCCCCCTTAG,16,1924977
ihfAp4,3.066666666666667,59,14,TAACATCATGTCCCCCGATC,45,1931436
ihfAp4,4.4,79,14,GTTTCTCGAAGTATCACGTC,65,1960565
ihfAp4,1.3333333333333333,33,14,GTTTCTAAGGACCCGACAAG,19,1962259
ihfAp4,3.0,58,14,GTTCTGCTTGACTAGAGACC,44,1911379
ihfAp4,0.6666666666666666,23,14,GTGTCCGGTATGCGTGAGAA,9,1925512
ihfAp4,0.13333333333333333,15,14,GTGAACATGTCTTACCGGAG,1,1930503
ihfAp4,0.13333333333333333,15,14,GTCGCATACATGAGCGCCCA,1,1941943
ihfAp4,1.5333333333333334,36,14,GTCGATGCGTTCTGGTATAA,22,1910541
ihfAp4,2.1333333333333333,45,14,GTATTTATAGCAGGAAACTG,31,1919551
ihfAp4,0.4666666666666667,20,14,GTATATCGTGACCGTGAGCT,6,1958188
ihfAp4,2.2666666666666666,47,14,GTAGGCGCGGGTCTCGCGGT,33,1956622
ihfAp4,2.466666666666667,50,14,GTAACGGCGAAAGCCTGTAC,36,1950329
ihfAp4,10.666666666666666,173,14,GGTCGAGCCGAGAAAAACCT,159,1918541
ihfAp4,1.4666666666666666,35,14,GGGTGGGTGTTAGGTGCCGG,21,1947447
ihfAp4,4.133333333333334,75,14,GGGGGGGACATCTTTCAACG,61,1932945
ihfAp4,1.8666666666666667,41,14,GGCTGGTCGGGGATATCCCC,27,1948444
ihfAp4,2.933333333333333,57,14,GGCGTACCATGCCAAAACTA,43,1928293
ihfAp4,1.5333333333333334,36,14,GGCCGACCGTACAGTGGCAT,22,1911980
ihfAp4,3.1333333333333333,60,14,GGCCCAGTGGGAACACCCGT,46,1924473
ihfAp4,1.0,28,14,GGCCACACCTCCGCTCTCAC,14,1958877
ihfAp4,0.9333333333333333,27,14,GGCAGTTTAAGGGATTCAAT,13,1922336
ihfAp4,5.333333333333333,93,14,GGATCCCCGTACAGGTGTAT,79,1925877
ihfAp4,4.0,73,14,GGACTCGAGCCGGCGAACCT,59,1955943
ihfAp4,1.1333333333333333,30,14,GGAACGTCGTGGGTGTGATG,16,1961871
ihfAp4,1.5333333333333334,36,14,GCTGATCCCCTGCCCAGTTC,22,1947344
ihfAp4,1.4,34,14,GCGGCCGTCACGACTGCCAT,20,1927440
ihfAp4,0.7333333333333333,24,14,GCGCTGTGGAAGAGTGACTC,10,1926079
ihfAp4,2.7333333333333334,54,14,GCGCTATTAATTAATACTAC,40,1961080
ihfAp4,1.6,37,14,GCGCTACGCAGTCTTCGTAT,23,1959378
ihfAp4,2.466666666666667,50,14,GCGAGGTATCTACGGTATAT,36,1929304
ihfAp4,1.0,28,14,GCGACTATGGCAGCTTTCCT,14,1935753
ihfAp4,1.6666666666666667,38,14,GCCTAAAAGTTACCGTTGCT,24,1929912
ihfAp4,1.4,34,14,GCCGTCCCTGTCAGGGGCGC,20,1929989
ihfAp4,1.6,37,14,GCCGATGAGCGATCGCTCAA,23,1945802
ihfAp4,0.8666666666666667,26,14,GCATAACGCTCCCCTTTTTC,12,1958973
ihfAp4,1.4,34,14,GCAGCGCCCGGACACTCTAT,20,1944004
ihfAp4,0.6666666666666666,23,14,GCAACGTAGGCAGCTATTGA,9,1921202
ihfAp4,0.7333333333333333,24,14,GATGGATCCCCGCTTCAGCG,10,1946394
ihfAp4,0.13333333333333333,15,14,GATCATTGCTTAGGCTCGCA,1,1946258
ihfAp4,1.5333333333333334,36,14,GATCACGAAGTTGCGCAAAT,22,1952320
ihfAp4,1.3333333333333333,33,14,GAGTGTAGAAGTGTCAGCCT,19,1917633
ihfAp4,1.2,31,14,GAGTGACAAATCCTTCCCAA,17,1961868
ihfAp4,8.133333333333333,135,14,GAGGTCCGTGTGCTGGACCA,121,1932465
ihfAp4,2.2,46,14,GAGGCTGAGTTGCACCACGA,32,1960192
ihfAp4,2.0,43,14,GACAGGGTCCCGCCTAAGGA,29,1950824
ihfAp4,1.0,28,14,GAATAACATACTTATCCCGT,14,1937505
ihfAp4,1.4,34,14,GAAGTAGCCGAGCCTCGTTT,20,1950619
ihfAp4,1.6,37,14,GAAAGTTTGGGGAAGTGGAA,23,1928910
ihfAp4,1.5333333333333334,36,14,GAAAAACGCGTACAATCGAT,22,1910757
ihfAp4,2.2,46,14,CTTTGCACCGAGCGGTGTTT,32,1926114
ihfAp4,3.1333333333333333,60,14,CTTGTTAGCAGTCCAGGAGT,46,1922448
ihfAp4,3.466666666666667,65,14,CTTGCGTTATCGCTTGCAGT,51,1928676
ihfAp4,1.5333333333333334,36,14,CTTCACGGAGACAGGAGAGT,22,1952528
ihfAp4,3.2,61,14,CTTAACGCCGTCGTAGGTTA,47,1933326
ihfAp4,2.8666666666666667,56,14,CTGGCCCTTGGAAGTTGTTT,42,1933617
ihfAp4,0.13333333333333333,15,14,CTGGACAGCGACGCCTTCTG,1,1918144
ihfAp4,0.5333333333333333,21,14,CTGGAACCGGTTTTTGAACT,7,1961897
ihfAp4,0.2,16,14,CTGCCGGGGCTCGTCTGCAT,2,1911386
ihfAp4,1.2666666666666666,32,14,CTGCAATAATCACATGTTGT,18,1924585
ihfAp4,3.466666666666667,65,14,CTGAGCACACCCGCGGGGCT,51,1956718
ihfAp4,1.8666666666666667,41,14,CTCTCCCGGAGGCTGAAACT,27,1949635
ihfAp4,2.0,43,14,CTCATTGCCTTCACCTAAAC,29,1923968
ihfAp4,3.7333333333333334,69,14,CTCACCCGTCGCAAGACCTA,55,1922069
ihfAp4,1.2,31,14,CTCAATGCTGCATCAAATTA,17,1950045
ihfAp4,1.7333333333333334,39,14,CTAATTCTGTACGAGGTAAG,25,1959752
ihfAp4,0.7333333333333333,24,14,CGTGACCCGATCTGTACCCC,10,1930534
ihfAp4,3.6,67,14,CGTAGCCGAAAACACTTTAC,53,1914227
ihfAp4,1.7333333333333334,39,14,CGGTATTCAACCATGGGGAG,25,1957672
ihfAp4,1.3333333333333333,33,14,CGGCGGGTGAGCGAAATCGC,19,1939726
ihfAp4,0.13333333333333333,15,14,CGGCGCTGACCATAGGTCAC,1,1961467
ihfAp4,1.9333333333333333,42,14,CGGCCTGAGAGTAGGTTTAA,28,1951651
ihfAp4,3.066666666666667,59,14,CGGAAAAGTGCATAGGGCTG,45,1952072
ihfAp4,1.8,40,14,CGCTTAAATGCAGAACGTCA,26,1925744
ihfAp4,0.8,25,14,CGCTAACGGGAACATCTGGA,11,1932946
ihfAp4,2.7333333333333334,54,14,CGATTGTGTGGGGCGGTGTT,40,1921957
ihfAp4,3.6666666666666665,68,14,CGATAAGGAATCGCTGACCT,54,1929099
ihfAp4,2.1333333333333333,45,14,CCTCACACATTCAGCTTCCC,31,1952393
ihfAp4,1.8,40,14,CCTAATCCGAGATCTTCACT,26,1954663
ihfAp4,1.2,31,14,CCGTCTTTTTGAGGAACCTA,17,1933836
ihfAp4,2.0,43,14,CCCTGACATGTGTTGGTATC,29,1915359
ihfAp4,1.6666666666666667,38,14,CCCGAGGGTGTCGCGACTCG,24,1915464
ihfAp4,1.4666666666666666,35,14,CCCAACATCTTTAAGAGTCA,21,1931368
ihfAp4,0.8666666666666667,26,14,CCAGAGATCAACGAAGGTCC,12,1953999
ihfAp4,0.13333333333333333,15,14,CAGTGGGACCACGCGTATGT,1,1916028
ihfAp4,1.8666666666666667,41,14,CAGGGGTGATCTATATCTGA,27,1954144
ihfAp4,2.066666666666667,44,14,CAGATTGCAAGTCCCGATAC,30,1943184
ihfAp4,3.8,70,14,CACAAGTGGCCCGCTTCTAG,56,1912863
ihfAp4,0.3333333333333333,18,14,CAATCGTAACATCTCACCTC,4,1927530
ihfAp4,3.1333333333333333,60,14,CAATATGTAGATTTGTTGCT,46,1940900
ihfAp4,1.8,40,14,CAATATCAGATGAGCCCGAT,26,1926638
ihfAp4,2.1333333333333333,45,14,ATTGCACACGGCAGAGGTGG,31,1959603
ihfAp4,1.8,40,14,ATTCACGGCAGCCACGACAA,26,1910544
ihfAp4,1.4666666666666666,35,14,ATGGGGAAGCTTGCTAGATA,21,1916334
ihfAp4,6.0,103,14,ATGCACCGCTGAGGGTCCGA,89,1926895
ihfAp4,1.7333333333333334,39,14,ATCTTAGGACGGTTGCAGGG,25,1928624
ihfAp4,0.9333333333333333,27,14,ATCTAATGACACACATGCTT,13,1933456
ihfAp4,5.133333333333334,90,14,ATCGTTGGAGCACACCCCAT,76,1919094
ihfAp4,0.2,16,14,ATAGCCCAAGCTGACTTCGA,2,1918601
ihfAp4,0.13333333333333333,15,14,ATACCCTGTTGTAACCCTTC,1,1935421
ihfAp4,1.1333333333333333,30,14,ATACCAGAAAATTGTGAGAG,16,1916069
ihfAp4,0.13333333333333333,15,14,ATAAGAGTTCGCAGCGAGCA,1,1959198
ihfAp4,7.133333333333334,120,14,AGTTGGATCATTCTTGCCCT,106,1945534
ihfAp4,1.5333333333333334,36,14,AGTATTTTTTAAAAACGCAG,22,1956963
ihfAp4,1.0,28,14,AGTATAGAATATGAGTTTGT,14,1925868
ihfAp4,5.933333333333334,102,14,AGGGTAAGAGCCCGAATGTA,88,1945391
ihfAp4,1.0,28,14,AGGGCCAAAACGTTCCATAG,14,1910362
ihfAp4,1.8666666666666667,41,14,AGGGCACCGACTAATGGGTA,27,1940333
ihfAp4,0.3333333333333333,18,14,AGCTAATACGTTCATACCTT,4,1948627
ihfAp4,0.4666666666666667,20,14,AGCGGTCGATACCCCCAACT,6,1939924
ihfAp4,3.7333333333333334,69,14,AGCGGAGTAGCATAGATTGC,55,1922497
ihfAp4,2.2666666666666666,47,14,AGCACCGTATGATCGGCACT,33,1924376
ihfAp4,2.3333333333333335,48,14,AGATCTCTTACGCCGCAGTC,34,1927748
ihfAp4,1.1333333333333333,30,14,AGACCCGCGCGCAAGACGCG,16,1934949
ihfAp4,1.1333333333333333,30,14,ACTCTGCTTGGTGTAATCGC,16,1914168
ihfAp4,0.13333333333333333,15,14,ACTATACCATCAACATGGCG,1,1940810
ihfAp4,0.13333333333333333,15,14,ACGTTTGTAAGCATGCGTCC,1,1948251
ihfAp4,3.2666666666666666,62,14,ACGTGGTGACCGGTGGAACT,48,1954143
ihfAp4,1.7333333333333334,39,14,ACGTCCAGCCGGGCTAGCCC,25,1918647
ihfAp4,2.7333333333333334,54,14,ACGAACTAGGGGTTCTTTTC,40,1942445
ihfAp4,1.2666666666666666,32,14,ACCTATGATATTTAAAGTAA,18,1942850
ihfAp4,2.3333333333333335,48,14,ACCTACGGCTGTCACAGCGA,34,1927060
ihfAp4,1.5333333333333334,36,14,ACCGTGCTCAACGGGATTAG,22,1950008
ihfAp4,3.533333333333333,66,14,ACCGCAGGCATCTCTTAACG,52,1943225
ihfAp4,1.9333333333333333,42,14,ACCGACTTTAGTTATGGCGA,28,1935238
ihfAp4,5.266666666666667,92,14,ACCCTGCGCTTTTTCCACAC,78,1925027
ihfAp4,2.933333333333333,57,14,ACCCGAATCTACTTGCCATA,43,1952153
ihfAp4,1.0666666666666667,29,14,ACCCATGTAACATCACGGTA,15,1943332
ihfAp4,1.0,28,14,ACCATGTTGACGTTCTTAGA,14,1946561
ihfAp4,1.8666666666666667,41,14,ACCACCAAATGATCAAGAAC,27,1943920
ihfAp4,0.13333333333333333,15,14,ACAAGATAGATCCGAGGAAT,1,1946493
ihfAp4,2.533333333333333,51,14,AATGTATTAGAGGATAGACA,37,1920650
ihfAp4,2.3333333333333335,48,14,AATGGGGTCTGGATCCGGTT,34,1912700
ihfAp4,2.466666666666667,50,14,AATCTCAGTGATTAATAGTA,36,1945009
ihfAp4,2.7333333333333334,54,14,AAGTTTGTGTCGTTAAAGCG,40,1947329
ihfAp4,1.8666666666666667,41,14,AAGTGTCCACGAGTCGGGAG,27,1948632
ihfAp4,2.2,46,14,AAGCCCGGCGTACTTAATGT,32,1932174
ihfAp4,3.6,67,14,AACCTCAATAGCACGTCGTT,53,1910119
ihfAp4,0.6,22,14,AACCGTAGGGGACCCGGTCG,8,1944541
ihfAp4,0.6,22,14,AACCACCATTTATTCAAAGG,8,1921626
ihfAp4,0.8666666666666667,26,14,AAATTGCTTGGAGCGAGGGT,12,1948620
ihfAp4,1.3333333333333333,33,14,AAATAGACGGTTAAACTCAT,19,1956648
ihfAp4,3.0,58,14,AAACGAGTTAAGGTAAACGC,44,1929870
ihfAp4,0.9285714285714286,25,13,TTTTGCAGCCAACCTCGACC,12,1945838
ihfAp4,3.142857142857143,56,13,TTTTAAGCCGGACTCGCGGG,43,1953675
ihfAp4,1.0,26,13,TTTGAAATACGTGCTCCGAT,13,1913406
ihfAp4,0.5714285714285714,20,13,TTTATCCGTGGTCCTGATTA,7,1931556
ihfAp4,3.7142857142857144,64,13,TTTACTGCAGGGCATTGAGA,51,1918051
ihfAp4,0.21428571428571427,15,13,TTGGTACATTGGCTGAGTGG,2,1925270
ihfAp4,0.5714285714285714,20,13,TTGGGCCACACGGACTGAGA,7,1932003
ihfAp4,3.2857142857142856,58,13,TTGACTTTAAACCGGCGTCG,45,1936442
ihfAp4,1.2142857142857142,29,13,TTCGTTATCAGCCCTGAGTA,16,1931371
ihfAp4,1.2142857142857142,29,13,TTCCATGATTCTTGGCGTCG,16,1916807
ihfAp4,1.0,26,13,TTATTAAAAAAGTGCGCGTC,13,1925732
ihfAp4,2.2857142857142856,44,13,TTAGCATAGTCATCCGGTTA,31,1925565
ihfAp4,1.7857142857142858,37,13,TTAGCAGCCGACGTCAGGCC,24,1933654
ihfAp4,2.4285714285714284,46,13,TTACCGTCGGGATTTGAGGA,33,1913441
ihfAp4,1.4285714285714286,32,13,TTACAAACCTTCAGGGGGTT,19,1942740
ihfAp4,4.214285714285714,71,13,TTAAGTCTCATTGGTCGTCC,58,1959464
ihfAp4,1.7142857142857142,36,13,TGTTGCTTGCACTTATCTCA,23,1915665
ihfAp4,0.21428571428571427,15,13,TGTTATGTCTAAATTGAGCA,2,1928268
ihfAp4,1.5,33,13,TGTGTATCTGCGCGGGGTGG,20,1929078
ihfAp4,1.9285714285714286,39,13,TGTGCGATTCACCACATGTC,26,1950004
ihfAp4,2.0714285714285716,41,13,TGTACCCTACACTATTTTTG,28,1926409
ihfAp4,7.785714285714286,121,13,TGGCGAAGTATCACGTAGTA,108,1909680
ihfAp4,0.14285714285714285,14,13,TGGCAGTGCTACGCTGGCAA,1,1929323
ihfAp4,2.642857142857143,49,13,TGGATCCCGGGAGGTTCTCT,36,1933914
ihfAp4,1.6428571428571428,35,13,TGGACCCGAGCTGAACCTCG,22,1926271
ihfAp4,0.14285714285714285,14,13,TGCGCCTGATAAACCCTTAG,1,1931221
ihfAp4,5.785714285714286,93,13,TGCCACCTGTGTACGAGGCA,80,1953366
ihfAp4,1.3571428571428572,31,13,TGCCACAATCATACAAGTAA,18,1922685
ihfAp4,2.5714285714285716,48,13,TGAGCTCTGTAGGCACTCAA,35,1911356
ihfAp4,1.8571428571428572,38,13,TGAAGTCAGAAATGGGGTAA,25,1928115
ihfAp4,1.5,33,13,TCTAGGGCTGATGTAACTAC,20,1921855
ihfAp4,1.0714285714285714,27,13,TCGTGTTATGGTTGTCCTTT,14,1951138
ihfAp4,0.14285714285714285,14,13,TCGGTGGACGTCAGTCAGGG,1,1920508
ihfAp4,2.7142857142857144,50,13,TCGGGCAAGTGATAGGGAAG,37,1946654
ihfAp4,0.2857142857142857,16,13,TCGCCAGTCACAACGTTTCG,3,1928584
ihfAp4,0.42857142857142855,18,13,TCGCATCGCAACCGTATTAG,5,1946386
ihfAp4,1.9285714285714286,39,13,TCCTCGGGCTGATTCCCCGA,26,1935620
ihfAp4,1.5714285714285714,34,13,TCCCTAATTGCGGAACATGT,21,1915068
ihfAp4,4.071428571428571,69,13,TCCCGTAGGCCATCATACTG,56,1938567
ihfAp4,4.142857142857143,70,13,TCCCGGAGCGAGATTCGTGC,57,1915419
ihfAp4,2.4285714285714284,46,13,TCAGTGTCTAGATCCCTTAC,33,1929668
ihfAp4,2.7142857142857144,50,13,TCAGTAAACGAATACCCAGC,37,1945662
ihfAp4,1.2142857142857142,29,13,TCAAGATAAATCTTGAGTGT,16,1927591
ihfAp4,1.3571428571428572,31,13,TATGTCAGTCAGTGTTACAA,18,1929486
ihfAp4,2.5714285714285716,48,13,TATAGATAAATGGCACTTTG,35,1925089
ihfAp4,1.5,33,13,TAGAATGGACATACGGCGTA,20,1945406
ihfAp4,3.5,61,13,TAGAACCTGGACTTTCGGTG,48,1927268
ihfAp4,4.0,68,13,TACCCTGTATGAATCTTCTC,55,1928671
ihfAp4,0.35714285714285715,17,13,TAACGCTGAACACGTTTTAA,4,1941825
ihfAp4,2.0714285714285716,41,13,TAACGCTCTGGCCCATACCA,28,1926000
ihfAp4,3.857142857142857,66,13,GTTTTTACATGCGTCAGAAA,53,1919433
ihfAp4,0.14285714285714285,14,13,GTTTGTTACAGCTCTGCAGG,1,1943719
ihfAp4,2.2142857142857144,43,13,GTTTAAATAAGTGCAATTTC,30,1944155
ihfAp4,0.5714285714285714,20,13,GTTGGACTGTGGTCCAGTTT,7,1930584
ihfAp4,0.14285714285714285,14,13,GTTGACATGCAGACAGAGAG,1,1916212
ihfAp4,1.2857142857142858,30,13,GTTAATCCCGTTTCGATGTG,17,1940774
ihfAp4,1.5,33,13,GTGCTTTTGGTATGTGTAAT,20,1961406
ihfAp4,6.928571428571429,109,13,GTGCTCGAGGAGCGTTTTGC,96,1919211
ihfAp4,2.4285714285714284,46,13,GTCTAGCGTACGGTTTGCTG,33,1931214
ihfAp4,1.2142857142857142,29,13,GTCAGGAATTTCCTTCACCC,16,1912643
ihfAp4,0.5,19,13,GTATGTCCAGTGGCTTGGAA,6,1954924
ihfAp4,6.0,96,13,GTAGTCTGTCAAGGCACTTA,83,1921746
ihfAp4,0.8571428571428571,24,13,GGTTCCCTACGTGGTGTGCA,11,1919049
ihfAp4,4.357142857142857,73,13,GGTTAGGTCCCGGGCTTCCC,60,1948837
ihfAp4,1.1428571428571428,28,13,GGTCGGGTTGGTCCAATTTG,15,1926250
ihfAp4,3.5,61,13,GGTAAGACTACGATTACAGG,48,1934477
ihfAp4,1.9285714285714286,39,13,GGGCAGGACATTCATCGACA,26,1910114
ihfAp4,5.571428571428571,90,13,GGCGATCCCGGACAGACACA,77,1961551
ihfAp4,1.2142857142857142,29,13,GGCAGCCCTGCGTGATAATT,16,1911266
ihfAp4,2.2142857142857144,43,13,GGCACCCTCGACCACCAGGA,30,1922576
ihfAp4,3.642857142857143,63,13,GGATCGTACGGTAGGTCCGG,50,1912744
ihfAp4,0.21428571428571427,15,13,GGAGGTGACAACAGTCCTTC,2,1941783
ihfAp4,2.357142857142857,45,13,GGACGAAGGGATAAGCATGT,32,1923185
ihfAp4,2.0,40,13,GGAATGCGGTCTAAAACCAG,27,1910672
ihfAp4,3.0,54,13,GGAAGGCGTGCCGCTTGTCT,41,1925448
ihfAp4,1.5,33,13,GGAAAAAGCAAATACCCAGG,20,1920495
ihfAp4,1.6428571428571428,35,13,GCTCTCGGCGCATATGTCCT,22,1941791
ihfAp4,1.6428571428571428,35,13,GCTCAGACGTGCCAAGTCTG,22,1910364
ihfAp4,2.0714285714285716,41,13,GCTAAGTCGTTCCGCAGTTG,28,1924672
ihfAp4,2.7142857142857144,50,13,GCGTCCCGGTGGAAACCACA,37,1936567
ihfAp4,0.5714285714285714,20,13,GCGGGATTCCACGCGATTAA,7,1933568
ihfAp4,1.9285714285714286,39,13,GCGGATCCATGAGTCGCTGG,26,1928832
ihfAp4,2.9285714285714284,53,13,GCGGACCTGGCTGAAAGAGC,40,1919212
ihfAp4,16.428571428571427,242,13,GCGCTCCTGAATAACTGCCG,229,1909631
ihfAp4,1.5714285714285714,34,13,GCGCGTGGGCTGGGGCATGA,21,1930732
ihfAp4,1.9285714285714286,39,13,GCGCGAAGGCTGCCACATGA,26,1959885
ihfAp4,2.0714285714285716,41,13,GCCAACAAGAAATCTCAGTT,28,1938633
ihfAp4,0.8571428571428571,24,13,GCAGCTTTGTGGCTTTCCCA,11,1939383
ihfAp4,1.6428571428571428,35,13,GCACGACCGATCTGAATTAA,22,1928107
ihfAp4,1.2142857142857142,29,13,GCAAGCTCGGTTTTTACTCT,16,1929747
ihfAp4,2.7142857142857144,50,13,GATTGTTGGGGTGGCAAGTA,37,1954414
ihfAp4,2.4285714285714284,46,13,GATGTTGCGATAATAATTTT,33,1924774
ihfAp4,1.0714285714285714,27,13,GATGAGGCAATGTTGTTCAC,14,1954236
ihfAp4,1.0,26,13,GATCTTGTCTACACGCTTGT,13,1954335
ihfAp4,0.9285714285714286,25,13,GATCAAACCGACAGTCAGGA,12,1916641
ihfAp4,1.7857142857142858,37,13,GATATTCGGTCCCGCCGGGT,24,1933778
ihfAp4,4.0,68,13,GATAGCTTTGGATTACGCGA,55,1944109
ihfAp4,1.1428571428571428,28,13,GAGGGTAATAAGTAGCGCTA,15,1921875
ihfAp4,12.642857142857142,189,13,GAGCGGCCTTGACATTCAAC,176,1921084
ihfAp4,1.4285714285714286,32,13,GAGCCGAGAGCGACATGTAT,19,1921021
ihfAp4,1.0714285714285714,27,13,GACTCCTGCAAGGAATGGGT,14,1928989
ihfAp4,4.857142857142857,80,13,GAATGCCGAAGGCTGCCATT,67,1937789
ihfAp4,1.2857142857142858,30,13,GAAGTGCACCCAGTAAGCGC,17,1953793
ihfAp4,2.9285714285714284,53,13,CTTACCTTGCGTGATATGGA,40,1929830
ihfAp4,3.142857142857143,56,13,CTGTGTTGAATTAAATTCGA,43,1915286
ihfAp4,3.5,61,13,CTCGGCGTCACCACCTATAA,48,1928626
ihfAp4,2.0714285714285716,41,13,CTCCTAACTTGGCAGCAGAT,28,1935756
ihfAp4,2.2142857142857144,43,13,CTCCCATTCCTGATTAGGAT,30,1952644
ihfAp4,2.4285714285714284,46,13,CTAGGTGCTTCTGCTAACCC,33,1959689
ihfAp4,1.6428571428571428,35,13,CGTTCGCCATGAAGTTAACA,22,1949940
ihfAp4,2.642857142857143,49,13,CGTCCGGAGGGACCGGAACT,36,1923824
ihfAp4,1.2142857142857142,29,13,CGTATTCGGCGCGCGTCGTT,16,1930447
ihfAp4,1.0714285714285714,27,13,CGTAATGGGTATAATTCAAC,14,1913973
ihfAp4,5.928571428571429,95,13,CGGTAAACAATTATAATGGC,82,1944730
ihfAp4,3.142857142857143,56,13,CGGAGAATGGATGGACTGTG,43,1919045
ihfAp4,1.4285714285714286,32,13,CGCTGTCAGGGCCGATAGCT,19,1960834
ihfAp4,1.5714285714285714,34,13,CGCTGATAGGCACAATAGAA,21,1913949
ihfAp4,0.7142857142857143,22,13,CGCTAACTCTGGTTGTGCTT,9,1932990
ihfAp4,2.0714285714285716,41,13,CGCGGGATCTCGGCTAACGT,28,1916275
ihfAp4,2.142857142857143,42,13,CGCGCGCTACGCTTGACGCA,29,1941462
ihfAp4,0.7857142857142857,23,13,CGCCCTATAGTACTCTCAGC,10,1942096
ihfAp4,5.857142857142857,94,13,CGAGGTTGGATTAATCGACT,81,1923106
ihfAp4,1.6428571428571428,35,13,CGAGGTCAGTGTTCAGTCGG,22,1940773
ihfAp4,6.142857142857143,98,13,CGAAGGATTGTTTTATAAGT,85,1926709
ihfAp4,4.357142857142857,73,13,CGAAAAATTACTGGTCCCAC,60,1926202
ihfAp4,1.5,33,13,CCTGCTGACGTTTTGCGCGC,20,1941391
ihfAp4,3.9285714285714284,67,13,CCTGAGTAAATGGTGCCGGT,54,1932272
ihfAp4,0.2857142857142857,16,13,CCTCGGTTTTTGGATCAGTT,3,1960877
ihfAp4,1.2142857142857142,29,13,CCTCGGCTTTTAGTGTTTTG,16,1948105
ihfAp4,2.857142857142857,52,13,CCTAGTTTTTGGCTAACCGG,39,1956206
ihfAp4,1.5714285714285714,34,13,CCGGGCAACTACAACAATGA,21,1941020
ihfAp4,4.642857142857143,77,13,CCGGCCTGGTTGTTGTCGGT,64,1935526
ihfAp4,0.9285714285714286,25,13,CCGCGCCACGAGGGTCCGAT,12,1919963
ihfAp4,1.9285714285714286,39,13,CCGAGCGAGATTTTACCTTA,26,1930090
ihfAp4,0.6428571428571429,21,13,CCCTGTTCCAATTCCCCACA,8,1922269
ihfAp4,3.0714285714285716,55,13,CCCTGTAATGACCAACCTAG,42,1946065
ihfAp4,6.571428571428571,104,13,CCCTCCTTGGATGGCCATCA,91,1922106
ihfAp4,0.7857142857142857,23,13,CCCGTTCGACATACCAGTCT,10,1961937
ihfAp4,2.0,40,13,CCCGTCTATGCACCAGATAC,27,1952279
ihfAp4,1.1428571428571428,28,13,CCCATCTTCGGATGGGCCTT,15,1915298
ihfAp4,1.0714285714285714,27,13,CCCAAGATCATAACGGCAGG,14,1919848
ihfAp4,1.0,26,13,CCATGTTTCATGAGGCTGAA,13,1936376
ihfAp4,3.2857142857142856,58,13,CCAGTCGGACCATTGCTATA,45,1924384
ihfAp4,1.0714285714285714,27,13,CCAGTAGATGTCTGGCAGCG,14,1954615
ihfAp4,2.357142857142857,45,13,CCAGGCTCCAGCACGATCTT,32,1910882
ihfAp4,1.1428571428571428,28,13,CCACCCCCGAATAGGAGCTG,15,1925653
ihfAp4,5.0,82,13,CCACATCCTCCGGACTGCTT,69,1912790
ihfAp4,2.0714285714285716,41,13,CATGTGTAGCTTTGCATGGT,28,1925260
ihfAp4,6.571428571428571,104,13,CATCCGTTCATCGGAGTCTT,91,1948255
ihfAp4,1.1428571428571428,28,13,CATATCGACTGCAAAAACGG,15,1929519
ihfAp4,2.2142857142857144,43,13,CATATACGCCAAATCCGTCC,30,1960972
ihfAp4,2.4285714285714284,46,13,CATAGTTCTTTTCACGCTGG,33,1922286
ihfAp4,3.642857142857143,63,13,CATACACTGGAGTTGGTGCA,50,1929746
ihfAp4,5.642857142857143,91,13,CAGATCTCTCTAAGCGCTGT,78,1928370
ihfAp4,1.6428571428571428,35,13,CACTTTTATCTGTTTCTTTT,22,1941399
ihfAp4,2.142857142857143,42,13,CACTCAGGCCATGCAGCATC,29,1960186
ihfAp4,2.5,47,13,CACGATTCGGCATTCTGGTG,34,1916782
ihfAp4,0.8571428571428571,24,13,CACCGATTCTCCGGAAAGTC,11,1940518
ihfAp4,2.5714285714285716,48,13,CACAAATATATAGGGTTCTA,35,1928320
ihfAp4,0.9285714285714286,25,13,CAATTATTTTCTATGTTCGA,12,1910197
ihfAp4,2.2857142857142856,44,13,CAATCCAGAGATAATGGCGA,31,1947252
ihfAp4,1.3571428571428572,31,13,CAATACATTCTTTGCTACTG,18,1931609
ihfAp4,0.21428571428571427,15,13,CAAGGTTGGATTTAGCGGGA,2,1942160
ihfAp4,2.5714285714285716,48,13,CAAGGCAGGCTCGAAAAACG,35,1928900
ihfAp4,2.2857142857142856,44,13,CAAGCTGACCTCTAGACCCT,31,1941648
ihfAp4,1.3571428571428572,31,13,CAAGATCCTCCCCCCGGATC,18,1936239
ihfAp4,1.9285714285714286,39,13,ATTTCCATGGCCTTTCCAAA,26,1958271
ihfAp4,0.14285714285714285,14,13,ATTGGACCAGTGACGCTCCT,1,1942980
ihfAp4,0.14285714285714285,14,13,ATTGATCAACTTCGTGCTGT,1,1920542
ihfAp4,1.9285714285714286,39,13,ATTCGGCGCCTGGCTGGCAT,26,1931729
ihfAp4,7.642857142857143,119,13,ATTACTTGTGCTTTCGCATT,106,1943268
ihfAp4,3.857142857142857,66,13,ATGTTTCGATTGATATACCA,53,1920723
ihfAp4,2.9285714285714284,53,13,ATGTCCATAGTAACTGGGCA,40,1959706
ihfAp4,3.5714285714285716,62,13,ATCTAACATGATACAACTGA,49,1959162
ihfAp4,7.285714285714286,114,13,ATCCCGGATAAGTGGCCCTG,101,1959704
ihfAp4,0.9285714285714286,25,13,ATCAGGTATAGTTTCCTGTT,12,1918627
ihfAp4,1.1428571428571428,28,13,ATCACAAGGATTTGATTGTA,15,1956762
ihfAp4,9.357142857142858,143,13,ATATTGATTAACTGCCGGCG,130,1936906
ihfAp4,15.785714285714286,233,13,ATATGGCTTGTGCCCCAAGT,220,1956284
ihfAp4,1.7857142857142858,37,13,AGTTCTGAGTACCGCTCTAT,24,1935662
ihfAp4,1.7857142857142858,37,13,AGTGTAACTACGCTTTCAAT,24,1918604
ihfAp4,0.5714285714285714,20,13,AGTCTATTGTCAAATGTGGG,7,1949813
ihfAp4,2.7857142857142856,51,13,AGTAGTATGAAAGCCGTTCA,38,1958315
ihfAp4,1.7857142857142858,37,13,AGGAAGCCACCGTAGATCAT,24,1922216
ihfAp4,5.857142857142857,94,13,AGGAAACAATCCGCCTTTAC,81,1946996
ihfAp4,1.7857142857142858,37,13,AGCGGAGCCCCCTTGGTCGT,24,1914416
ihfAp4,1.1428571428571428,28,13,AGCCTCTACCGGGGCTAGGT,15,1927383
ihfAp4,0.5,19,13,AGCAGTGCCCATACCAGCCT,6,1917195
ihfAp4,0.7857142857142857,23,13,AGATCCCCAACGAGAGACTG,10,1939549
ihfAp4,1.6428571428571428,35,13,AGATAAAGTGTATCGGAAAA,22,1924218
ihfAp4,1.5,33,13,AGAAGGCCTGTTCGTCCCAC,20,1925802
ihfAp4,0.6428571428571429,21,13,ACTGGCGAGGGGTGAGGTAC,8,1931864
ihfAp4,2.2142857142857144,43,13,ACTCCGAGTCCGGAGGCCAC,30,1944106
ihfAp4,1.6428571428571428,35,13,ACGTCGCAACTTCCAAGAAA,22,1924505
ihfAp4,2.2142857142857144,43,13,ACGCGGAGTTCACGAATCAA,30,1917034
ihfAp4,0.8571428571428571,24,13,ACGATAAACGTCGACGGAAT,11,1953075
ihfAp4,1.2142857142857142,29,13,ACCTTTCACCAAGATTCATG,16,1914457
ihfAp4,6.714285714285714,106,13,ACCGTGCTACGCCTAACCTC,93,1950515
ihfAp4,2.357142857142857,45,13,ACCGCCTGTAACCTTTGTGC,32,1921357
ihfAp4,0.7857142857142857,23,13,ACAGTAGGAGCCCTAAGTAC,10,1922170
ihfAp4,1.3571428571428572,31,13,AATACGCCTTGGAGCGTCAA,18,1911768
ihfAp4,1.8571428571428572,38,13,AAGACGCGTGTCTGAGGGGT,25,1928430
ihfAp4,2.7142857142857144,50,13,AAACTCCATATTACGATATG,37,1956265
ihfAp4,1.0769230769230769,25,12,TTTTGCAAGGGGTCCCATGG,13,1926071
ihfAp4,1.5384615384615385,31,12,TTTTCCCCGGCAGGATATCG,19,1911946
ihfAp4,0.23076923076923078,14,12,TTTTCATGAGCTATCTTTCA,2,1935001
ihfAp4,1.7692307692307692,34,12,TTTGTAGCTCCGGCGGCCTT,22,1927377
ihfAp4,2.076923076923077,38,12,TTTGCGCCTGATTTACTCTT,26,1915233
ihfAp4,2.3076923076923075,41,12,TTTGAAGCACGCGCGAGCCA,29,1928790
ihfAp4,1.6923076923076923,33,12,TTTCCCGCTTAGTAGCAGAT,21,1940356
ihfAp4,1.2307692307692308,27,12,TTTCACCCTAAAAGCTATAC,15,1958480
ihfAp4,4.153846153846154,65,12,TTGCGACTGCTTCTGTCCAC,53,1950493
ihfAp4,0.8461538461538461,22,12,TTCTTATAAGGTATATCGTC,10,1943093
ihfAp4,1.6153846153846154,32,12,TTCGCTTAATCGACTGATTT,20,1929745
ihfAp4,1.6923076923076923,33,12,TTCGCGGCTACCTGGTAGTG,21,1912186
ihfAp4,3.923076923076923,62,12,TTCCGTGCCCTTCTTATATT,50,1940377
ihfAp4,2.923076923076923,49,12,TTCCGAAACCTTTTGAAGCA,37,1915641
ihfAp4,0.15384615384615385,13,12,TTCATGTAACTGAATAGGTT,1,1918025
ihfAp4,3.3846153846153846,55,12,TTATCTGATTTAAGGCAACT,43,1943758
ihfAp4,3.1538461538461537,52,12,TTAAGTATCCTCTCTAGATC,40,1937623
ihfAp4,1.4615384615384615,30,12,TGTTACGACTCGGTGGTTCA,18,1921813
ihfAp4,0.6923076923076923,20,12,TGTGTGAGAAGAATTGCCTC,8,1915779
ihfAp4,3.230769230769231,53,12,TGTGGTGCTGGGTTGTCCAT,41,1953525
ihfAp4,2.3846153846153846,42,12,TGTCCTGCGTGAATTCTAAA,30,1935618
ihfAp4,0.15384615384615385,13,12,TGTAAAAATAGCTTTGCAGT,1,1941473
ihfAp4,8.846153846153847,126,12,TGGCTTGTATTTTTATCATG,114,1935800
ihfAp4,4.538461538461538,70,12,TGCTTACTCTATCGTTGTCT,58,1938420
ihfAp4,2.6153846153846154,45,12,TGCTCATACATCATACGGCA,33,1961503
ihfAp4,1.0,24,12,TGCGGCAACCGTGGTGAAAT,12,1923332
ihfAp4,1.2307692307692308,27,12,TGATGCCACATATCAGCAAC,15,1961756
ihfAp4,1.4615384615384615,30,12,TGATCCGACGCGAATCGCTG,18,1953526
ihfAp4,1.1538461538461537,26,12,TGAGCCAACGGACATTTATG,14,1935356
ihfAp4,1.3076923076923077,28,12,TGACCGAGCGTCGGAGCGTG,16,1930765
ihfAp4,15.692307692307692,215,12,TGAAAGGTCCTCTTATGCGA,203,1942805
ihfAp4,1.1538461538461537,26,12,TCTTTTCACGACCGGGAGTT,14,1912751
ihfAp4,2.3076923076923075,41,12,TCTCTCTCGGCTAATGACAC,29,1943117
ihfAp4,4.230769230769231,66,12,TCTCCGGGTTGGGTCTGCCT,54,1913489
ihfAp4,0.38461538461538464,16,12,TCTATCAAGGAAGCACAGAC,4,1911885
ihfAp4,0.5384615384615384,18,12,TCGGTTGCGCCGGGCCGGGA,6,1947413
ihfAp4,1.1538461538461537,26,12,TCGGGGATGCGTCATAGGTT,14,1946987
ihfAp4,2.3846153846153846,42,12,TCCTTGTTGACAGATTTACA,30,1929995
ihfAp4,2.923076923076923,49,12,TCCTTAGCGAAACGTGTGCT,37,1953580
ihfAp4,2.769230769230769,47,12,TCCAAACATGAACTCACAAT,35,1940285
ihfAp4,2.076923076923077,38,12,TCACAGGACCCCGTGACATG,26,1921769
ihfAp4,1.5384615384615385,31,12,TATGACTTTATCAAGGGTCA,19,1914635
ihfAp4,0.15384615384615385,13,12,TAGGCTCACCATGATATAAG,1,1950804
ihfAp4,1.3076923076923077,28,12,TAGCTAGTGACAAGTGGCTT,16,1913663
ihfAp4,0.46153846153846156,17,12,TACTGGTTAAAAGGTATCAA,5,1928267
ihfAp4,6.0,89,12,TACGAAGCAAGGTGTTTTCA,77,1961643
ihfAp4,2.3076923076923075,41,12,TACCCTCCGGTGTAACGTGA,29,1912772
ihfAp4,1.9230769230769231,36,12,TACCCGACTAGCTTGCTGAG,24,1914896
ihfAp4,1.3846153846153846,29,12,GTTGTAACATGATTTTTGTT,17,1928253
ihfAp4,1.5384615384615385,31,12,GTTCCAGGACCAAGATACGA,19,1941469
ihfAp4,2.6923076923076925,46,12,GTTATCGGGTGCTGGCGAAA,34,1956844
ihfAp4,0.6923076923076923,20,12,GTGCTATATTAGGTCCGAAA,8,1944756
ihfAp4,2.4615384615384617,43,12,GTGATAGGGCGGTGGGTTAC,31,1928365
ihfAp4,0.5384615384615384,18,12,GTGAGGAGAACGCCTCTTGA,6,1911646
ihfAp4,0.15384615384615385,13,12,GTGAAGGGCGACTATCGGGG,1,1934575
ihfAp4,2.8461538461538463,48,12,GTCCTCGTCACTCTGACAGC,36,1939780
ihfAp4,1.6923076923076923,33,12,GTCAAGTCGTACTTGGGAAT,21,1936278
ihfAp4,2.8461538461538463,48,12,GTATGCATTGACATTCATGA,36,1950359
ihfAp4,4.0,63,12,GTACTCGGGCTGCGCCGCGC,51,1939089
ihfAp4,1.6153846153846154,32,12,GTAACTATGCGCCCATCCGG,20,1914240
ihfAp4,1.8461538461538463,35,12,GGTTAGAGAGTTTAACTATC,23,1942568
ihfAp4,3.1538461538461537,52,12,GGTCCTGGTGTATGCATGAT,40,1944832
ihfAp4,3.3846153846153846,55,12,GGTATTGCGTTAATACGCGC,43,1947823
ihfAp4,0.6923076923076923,20,12,GGTAAGCGTCGGGGGGAACT,8,1920097
ihfAp4,1.2307692307692308,27,12,GGGTTTTTAATGCGGGTCAC,15,1909691
ihfAp4,4.769230769230769,73,12,GGGTTTTCTCTCTCTGACTC,61,1938571
ihfAp4,3.6923076923076925,59,12,GGGCTGTCCTACGTCAAGAT,47,1918913
ihfAp4,3.6923076923076925,59,12,GGGCTGAACGGCAGGCCGAA,47,1961286
ihfAp4,2.4615384615384617,43,12,GGGCGCTCGCCACTATTATA,31,1948113
ihfAp4,3.6923076923076925,59,12,GGGCCGAAATCACTCCAAAT,47,1946073
ihfAp4,1.9230769230769231,36,12,GGGAGGGGCTGACTTGTGCA,24,1936818
ihfAp4,7.846153846153846,113,12,GGCTCCCCGGCAAGTAATAC,101,1921865
ihfAp4,3.1538461538461537,52,12,GGATGTTGCTGGATAATCCC,40,1938742
ihfAp4,2.923076923076923,49,12,GGATGCCATTCAATATGCCT,37,1953913
ihfAp4,1.9230769230769231,36,12,GGAGGATTTCGGCAGATTGA,24,1918104
ihfAp4,6.615384615384615,97,12,GGACTCCTTGAGCAAGAGAA,85,1940394
ihfAp4,0.6923076923076923,20,12,GCTGAGTTCTCGTATGCAAG,8,1932762
ihfAp4,0.15384615384615385,13,12,GCTAGTTGGCTTGCGGCTAG,1,1911264
ihfAp4,1.0769230769230769,25,12,GCGTGGAGAGAGGGCTGCTG,13,1909649
ihfAp4,1.4615384615384615,30,12,GCGGTTAGACCGAAAAGGGT,18,1935899
ihfAp4,0.3076923076923077,15,12,GCGGTGCGCGGGTAACAGGA,3,1916692
ihfAp4,1.3846153846153846,29,12,GCGCTGGGATATGTCATGGG,17,1929334
ihfAp4,1.4615384615384615,30,12,GCCCATGTCCTGGGGGAAGT,18,1940464
ihfAp4,0.5384615384615384,18,12,GCCCAAGGCCGGTCGGGGGA,6,1940077
ihfAp4,1.4615384615384615,30,12,GCAGGGTTTTTTTAGGTGTA,18,1920630
ihfAp4,2.230769230769231,40,12,GCAGGATCGGTCCCCAACAT,28,1942851
ihfAp4,1.8461538461538463,35,12,GCAATTTAGGAATAGCTCTC,23,1947765
ihfAp4,1.4615384615384615,30,12,GCAATCGTACAGGAAGATTT,18,1934352
ihfAp4,0.15384615384615385,13,12,GCAACCTATGTTTTCCGGAT,1,1955074
ihfAp4,1.3076923076923077,28,12,GATTAGTTAACGGAGGGCAG,16,1916416
ihfAp4,0.3076923076923077,15,12,GATTACGAACCCCGGGGGGT,3,1926643
ihfAp4,6.769230769230769,99,12,GATATTCCGGTCCTCAGCCT,87,1936436
ihfAp4,8.76923076923077,125,12,GAGTTATAGTTAGGTGCTTT,113,1929937
ihfAp4,2.076923076923077,38,12,GAGTCATGAACCGTTTAACA,26,1922334
ihfAp4,2.0,37,12,GAGGCCCTCTAGGCTTCACA,25,1955778
ihfAp4,2.923076923076923,49,12,GAGGCAATGCGTAAACCGTT,37,1926564
ihfAp4,1.6153846153846154,32,12,GAGGAACATTTTGTTGTGAA,20,1930859
ihfAp4,1.2307692307692308,27,12,GAGCACGTAGACCCGCAATG,15,1916780
ihfAp4,2.0,37,12,GACTTCTTCCGTAAATATCC,25,1952197
ihfAp4,2.3846153846153846,42,12,GACTAGGTTCTGTCCCATCC,30,1942093
ihfAp4,2.0,37,12,GACGGATCGCGCGCGCATAG,25,1941651
ihfAp4,1.7692307692307692,34,12,GACCTTTGTCGGGGACCTCA,22,1944683
ihfAp4,2.3846153846153846,42,12,GACAACGGCGTCAACTTCAG,30,1935115
ihfAp4,0.15384615384615385,13,12,GAAGCTCGGGTGACAAGGGA,1,1920571
ihfAp4,1.2307692307692308,27,12,GAACGCGCTAGCGTGGCTGG,15,1942447
ihfAp4,2.0,37,12,CTTTATTACGCCGCAGGGGG,25,1943941
ihfAp4,2.076923076923077,38,12,CTTCCGGTTAATACGTTTAC,26,1935559
ihfAp4,1.0,24,12,CTTCCATTCCTCTAGGCGGT,12,1925857
ihfAp4,1.2307692307692308,27,12,CTTAAATAGAGGAAGTACAG,15,1954608
ihfAp4,1.3076923076923077,28,12,CTGCGATAGAATTAGGCAAT,16,1958689
ihfAp4,5.615384615384615,84,12,CTGCCTCGGCCACGAATGCA,72,1922653
ihfAp4,1.8461538461538463,35,12,CTGCATCTCGTCCGTAATTT,23,1923609
ihfAp4,2.076923076923077,38,12,CTGACCTGCATAGGAATCCT,26,1956062
ihfAp4,1.5384615384615385,31,12,CTCTGGCAGCCCGACGTCTT,19,1950959
ihfAp4,2.1538461538461537,39,12,CTCCTGTGCACGGGGCTCAA,27,1928090
ihfAp4,2.3846153846153846,42,12,CTCCGAGGCTCCTACGCGGT,30,1918176
ihfAp4,1.0769230769230769,25,12,CTCAGTAGGTATAGCTCCGG,13,1953916
ihfAp4,8.461538461538462,121,12,CTAGGCGGATTAGTGCGATT,109,1956726
ihfAp4,2.769230769230769,47,12,CTAGCTCAAGTTCAAAGGTA,35,1936075
ihfAp4,1.9230769230769231,36,12,CTACTTACGGCTAGTTTTAC,24,1918178
ihfAp4,0.5384615384615384,18,12,CTACGGGAAGAGGAAACAAA,6,1924903
ihfAp4,0.15384615384615385,13,12,CGTTCTAGTAAGAATTTACT,1,1934035
ihfAp4,0.15384615384615385,13,12,CGTTCCATGCAGCGATTGCG,1,1950857
ihfAp4,3.923076923076923,62,12,CGTGGTCATAGTCTAGGAAA,50,1940051
ihfAp4,0.7692307692307693,21,12,CGTGCCAGTTCCTTCTAGGG,9,1952791
ihfAp4,1.7692307692307692,34,12,CGTCGATCAAGCGAATGTGG,22,1944787
ihfAp4,2.8461538461538463,48,12,CGGGTGGCGTTGGCTCACGC,36,1947366
ihfAp4,3.3846153846153846,55,12,CGGGCGCAGTGGTTGTAGGA,43,1938536
ihfAp4,0.15384615384615385,13,12,CGGGCATAAATACGCCCATG,1,1933053
ihfAp4,0.7692307692307693,21,12,CGGCGTTGGCGAGCACTATT,9,1934167
ihfAp4,1.9230769230769231,36,12,CGGACAAGTGAAGATGTGTC,24,1945588
ihfAp4,0.46153846153846156,17,12,CGCTTAGTTAGCTCCAAGTT,5,1921329
ihfAp4,8.692307692307692,124,12,CGCTGATGTGAGGAGATTCA,112,1959619
ihfAp4,8.461538461538462,121,12,CGCTCCAAGGACTCGTCATG,109,1912356
ihfAp4,1.2307692307692308,27,12,CGCTCAAACGACTGAATCTC,15,1945466
ihfAp4,3.4615384615384617,56,12,CGCTATGGGGCAGGGCCTGA,44,1922792
ihfAp4,3.6923076923076925,59,12,CGCCGTACACAGACCTCGTG,47,1948502
ihfAp4,7.461538461538462,108,12,CGATCCTCTCGAGTGTAGGT,96,1955515
ihfAp4,1.3076923076923077,28,12,CGAATGATGTGCTACGAAAA,16,1946155
ihfAp4,2.923076923076923,49,12,CGAACTAATGATTCGCACAG,37,1934758
ihfAp4,0.8461538461538461,22,12,CGAACAATGGAGCTTGTTAT,10,1945134
ihfAp4,3.076923076923077,51,12,CCTTCTATAAATAAATTCAT,39,1917872
ihfAp4,0.5384615384615384,18,12,CCTCCCCATCGAAATTTGGT,6,1910413
ihfAp4,1.4615384615384615,30,12,CCTCATTACTCGAAGACTTG,18,1925957
ihfAp4,0.7692307692307693,21,12,CCTCAGCTCTTCGGTTCAGG,9,1940984
ihfAp4,3.230769230769231,53,12,CCTACTAGGTTCAGGACCTG,41,1935429
ihfAp4,5.076923076923077,77,12,CCGTTCTGGCCCTATCTGGT,65,1936667
ihfAp4,1.7692307692307692,34,12,CCGGGCTGGGTCGCACTGGA,22,1926699
ihfAp4,4.153846153846154,65,12,CCGGGCATTCTCGCCAGGTT,53,1961063
ihfAp4,4.615384615384615,71,12,CCGGGACGCAGGCATGATGA,59,1960925
ihfAp4,1.4615384615384615,30,12,CCGGCTCTGATTTCGCGATG,18,1932518
ihfAp4,1.7692307692307692,34,12,CCGGCTATCTGGTCGAGTTC,22,1919170
ihfAp4,2.4615384615384617,43,12,CCGCTGGTGACGAGATGATA,31,1932350
ihfAp4,3.1538461538461537,52,12,CCGCGCGCAACGAGGCACTG,40,1939235
ihfAp4,0.3076923076923077,15,12,CCGCCTCGGGCATGAATCCT,3,1939724
ihfAp4,0.7692307692307693,21,12,CCGCAAGCATGCTATTGTAT,9,1919750
ihfAp4,5.846153846153846,87,12,CCCTGAACCGGAAGAATTTG,75,1926284
ihfAp4,0.6153846153846154,19,12,CCCGTCGAGCCGGTCCATCA,7,1945536
ihfAp4,0.15384615384615385,13,12,CCCGCAGACCACCGGCATGG,1,1946640
ihfAp4,1.3076923076923077,28,12,CCCCTGAACCAACAGGGTGT,16,1932889
ihfAp4,1.6923076923076923,33,12,CCCCGGAGGTTTGAGCCGCA,21,1943921
ihfAp4,1.0,24,12,CCCCCTTTCAGCGTTACTGG,12,1945032
ihfAp4,0.23076923076923078,14,12,CCCAACGAGCAACCAGGATG,2,1916183
ihfAp4,2.3076923076923075,41,12,CCAGTGACTCGCCGGTCACA,29,1937566
ihfAp4,4.461538461538462,69,12,CCACGCCGGTCTCGGCTCAA,57,1919286
ihfAp4,1.3846153846153846,29,12,CCACCGTTACTCACTGCTCT,17,1932250
ihfAp4,2.0,37,12,CCACCAGTATATGAAGTTGC,25,1917075
ihfAp4,1.8461538461538463,35,12,CCAATCCTACGAGCACGCTA,23,1920709
ihfAp4,3.5384615384615383,57,12,CCAAGTAGTGGATCGGCAAA,45,1956723
ihfAp4,5.076923076923077,77,12,CATGATAAACACATAGACCC,65,1917410
ihfAp4,1.7692307692307692,34,12,CATATTTGAAGGGTGCTACC,22,1958111
ihfAp4,0.9230769230769231,23,12,CATAATGACAACCGTTTAGG,11,1928863
ihfAp4,2.923076923076923,49,12,CAGGAACTAACTGTTTCTTG,37,1927322
ihfAp4,1.0,24,12,CAGCTAGTAGTTGTGACCAA,12,1937965
ihfAp4,0.3076923076923077,15,12,CACGGCCTAGATTTTTACAT,3,1938137
ihfAp4,9.23076923076923,131,12,CAATCGGGGCTGTCCAGTTA,119,1916222
ihfAp4,0.15384615384615385,13,12,CAAGTGTTTCTAGGGGTGTG,1,1925704
ihfAp4,1.7692307692307692,34,12,CAAAGGATAGGTCTAGTCGC,22,1952299
ihfAp4,3.3846153846153846,55,12,ATTTGGGCGAATCTGCCATA,43,1913443
ihfAp4,0.15384615384615385,13,12,ATTTGGGCCAAAACACCGAT,1,1939816
ihfAp4,1.1538461538461537,26,12,ATTTCGCTCTGAAATCTATA,14,1957933
ihfAp4,12.307692307692308,171,12,ATTGCCATATTGCAAGAGTG,159,1961359
ihfAp4,0.9230769230769231,23,12,ATTCTTGTAGGTTTTTACAA,11,1924564
ihfAp4,2.0,37,12,ATGGATCTAGAGGCAGAGTC,25,1911677
ihfAp4,1.6153846153846154,32,12,ATGGATACATAGAGGGAACC,20,1944304
ihfAp4,7.3076923076923075,106,12,ATGCATTATCGGGTACCCGA,94,1929524
ihfAp4,4.153846153846154,65,12,ATGAGGGATCGTCTGTAGGC,53,1956738
ihfAp4,1.2307692307692308,27,12,ATCTGTCCTTGCAGGTCCGG,15,1919437
ihfAp4,1.0769230769230769,25,12,ATCCCGGAATATCAGTGTCA,13,1942189
ihfAp4,0.38461538461538464,16,12,ATCCCCTGCTCCAATCGTGT,4,1932558
ihfAp4,0.7692307692307693,21,12,ATCCCCCTTGCAGGCAGTTA,9,1939298
ihfAp4,6.3076923076923075,93,12,ATCCAAAGGTGTTGGAATTT,81,1916587
ihfAp4,3.3846153846153846,55,12,ATCCAAAGCGCCTCCCATCA,43,1946925
ihfAp4,0.5384615384615384,18,12,ATATGGGAAAACAAACGATA,6,1949408
ihfAp4,0.6923076923076923,20,12,ATATGCTCCGGGCACACGCC,8,1935186
ihfAp4,1.6923076923076923,33,12,ATATAGCACCCCCCTCAAAT,21,1921171
ihfAp4,1.2307692307692308,27,12,ATAGATGTTTAGCTGGGGTT,15,1936095
ihfAp4,3.0,50,12,ATACGCTTACGTGCAATGAT,38,1939546
ihfAp4,1.2307692307692308,27,12,ATACGCAACAGACGGTGGTG,15,1927093
ihfAp4,1.6153846153846154,32,12,ATAATGGGATGATTAAGTGT,20,1955407
ihfAp4,3.5384615384615383,57,12,ATAAAAGCTACTCAACATAG,45,1931904
ihfAp4,0.6153846153846154,19,12,AGTTTTCAGTGCATTACGAT,7,1916500
ihfAp4,0.5384615384615384,18,12,AGTGAGCGTTGAGGCTCGTT,6,1914044
ihfAp4,4.0,63,12,AGTAGGGGGGATGTGGAAAT,51,1926498
ihfAp4,1.8461538461538463,35,12,AGGTGTGCATGGGAGGGTTT,23,1940414
ihfAp4,2.3076923076923075,41,12,AGGTAGAGCTTGGAGGAATC,29,1911168
ihfAp4,0.6923076923076923,20,12,AGGTAAGCACAAAATCCTGT,8,1924752
ihfAp4,2.6923076923076925,46,12,AGGGTCGTGTTAGGTTCCTG,34,1940079
ihfAp4,3.3846153846153846,55,12,AGGCGGACTCGGACATAATG,43,1948680
ihfAp4,5.538461538461538,83,12,AGGCGATATACTACGATACT,71,1952941
ihfAp4,4.846153846153846,74,12,AGGCCGTGGGTGGAGAACGT,62,1951871
ihfAp4,3.8461538461538463,61,12,AGGATACTTTGGACCTGATC,49,1929523
ihfAp4,2.769230769230769,47,12,AGGAGGTGTCCTGCCGTGAT,35,1938270
ihfAp4,1.4615384615384615,30,12,AGGACTCGCCAGAGGTCCGA,18,1934479
ihfAp4,1.5384615384615385,31,12,AGCGTTACCCCGGGCAGGGG,19,1949760
ihfAp4,0.38461538461538464,16,12,AGCCAACCGTCAAGCGTGCG,4,1947563
ihfAp4,2.230769230769231,40,12,AGAGCGCCAATCACCAGGGG,28,1928948
ihfAp4,2.0,37,12,AGACAGGAAGATGGCCATTT,25,1920132
ihfAp4,1.0769230769230769,25,12,AGAATTCGTAATTAATACGT,13,1944125
ihfAp4,2.0,37,12,ACTTTCCAGGAATTGATGTA,25,1939584
ihfAp4,3.3846153846153846,55,12,ACTTTATTTTCATTAATCTC,43,1935393
ihfAp4,1.9230769230769231,36,12,ACTGAGTGGAGTTCCTAGGG,24,1949124
ihfAp4,5.076923076923077,77,12,ACTGAACCCCTGAGCCGAAG,65,1910115
ihfAp4,1.2307692307692308,27,12,ACTCGAAAATACCGTTTAGA,15,1913955
ihfAp4,1.5384615384615385,31,12,ACGTTGTGCATGTTTAATAC,19,1914970
ihfAp4,4.923076923076923,75,12,ACGTGAACCTGTCCGTCGGA,63,1921927
ihfAp4,2.076923076923077,38,12,ACGGAACTGGAAACTCCCGT,26,1930414
ihfAp4,1.5384615384615385,31,12,ACCGCATTGACCGCATTAAT,19,1912538
ihfAp4,2.923076923076923,49,12,ACAGCACCCTTTAGGTCACT,37,1913185
ihfAp4,9.692307692307692,137,12,AATTGGCAGGCGGTGGAGAT,125,1955935
ihfAp4,1.0,24,12,AATTAATAGATACAGTTACT,12,1942256
ihfAp4,2.6923076923076925,46,12,AATCCTCGGCCTAATGCGTG,34,1940815
ihfAp4,1.8461538461538463,35,12,AATACGCGACATCTAACCAT,23,1916117
ihfAp4,1.0769230769230769,25,12,AAGTTATTGCAAACTTACAT,13,1948957
ihfAp4,5.769230769230769,86,12,AAGTGGTCCGGTGTCTAAAG,74,1927832
ihfAp4,4.538461538461538,70,12,AACCTGTCCGCAATATTAGT,58,1953477
ihfAp4,1.2307692307692308,27,12,AACAGATCGTCGTTAGACGG,15,1953596
ihfAp4,10.538461538461538,148,12,AACAGACCAATGTCCCAGCG,136,1925340
ihfAp4,4.076923076923077,64,12,AACACCTTCTAGTGTAACCC,52,1947758
ihfAp4,0.7692307692307693,21,12,AACAAATATAGAGAGTCTTG,9,1960437
ihfAp4,1.0,24,12,AAATGGCGAGCTCCCCGCGG,12,1939485
ihfAp4,1.6153846153846154,32,12,AAATCTCCCCGAGCGATCTC,20,1933471
ihfAp4,2.1538461538461537,39,12,AAAGTGCATGGGATCGTGTT,27,1947845
ihfAp4,2.230769230769231,40,12,AAAGCGCTGTTAATCGCTTG,28,1938107
ihfAp4,2.230769230769231,40,12,AAAATCTTCAGGCGATAGAT,28,1922814
ihfAp4,1.2307692307692308,27,12,AAAATCTCTACGAGATTTAA,15,1915873
ihfAp4,0.46153846153846156,17,12,AAAAGTCGATTGGCATCGGG,5,1934279
ihfAp4,3.5,52,11,TTTGTGTGTCCCTAGACGGT,41,1913902
ihfAp4,1.5,28,11,TTTCATAGTCTACCTGCCTC,17,1945131
ihfAp4,1.3333333333333333,26,11,TTTCACGAGCGAATAGAAAC,15,1940076
ihfAp4,2.3333333333333335,38,11,TTGTGATGGAAACGTGACGT,27,1932789
ihfAp4,5.333333333333333,74,11,TTGTCAGTCGAAGGTGGCAT,63,1938590
ihfAp4,0.6666666666666666,18,11,TTGGTTACCAGCAAATTGAG,7,1917918
ihfAp4,1.0833333333333333,23,11,TTGGGCGCGTGATTGTGCAG,12,1949383
ihfAp4,2.5,40,11,TTGATACAAAATACAGGTAT,29,1934995
ihfAp4,0.16666666666666666,12,11,TTCTTCGAAACGTCTTTGGG,1,1951970
ihfAp4,3.8333333333333335,56,11,TTCGCAGGTACGGAACACCT,45,1952764
ihfAp4,2.4166666666666665,39,11,TTCCACGATGTATTCCACCT,28,1941053
ihfAp4,3.8333333333333335,56,11,TTATAGTGGCATTTTGGTGC,45,1918661
ihfAp4,2.8333333333333335,44,11,TTAACATGTAGTGGGCGAAA,33,1930152
ihfAp4,6.25,85,11,TGTTGCTCACCGTGATTGAT,74,1942448
ihfAp4,1.0833333333333333,23,11,TGTGGCCCCGTCCCGCCCCA,12,1959173
ihfAp4,2.3333333333333335,38,11,TGTGCCCACCAGCTCGCTAA,27,1951896
ihfAp4,0.75,19,11,TGTGATTCTTTCGCTACCCT,8,1922578
ihfAp4,2.5,40,11,TGTATGGTTGCCAATAGAAC,29,1926253
ihfAp4,4.166666666666667,60,11,TGGGTGTGTATCCAAAACAT,49,1943218
ihfAp4,1.6666666666666667,30,11,TGGGATGGAAGTTATGACCT,19,1921437
ihfAp4,2.25,37,11,TGGCAGTTTAACCGCTCTTG,26,1933105
ihfAp4,0.6666666666666666,18,11,TGGAAGCCTCTACACGTGGG,7,1952726
ihfAp4,2.4166666666666665,39,11,TGCTTCACCAGAGGCCGCGG,28,1933915
ihfAp4,3.4166666666666665,51,11,TGCGTCAACATCGAGTAATA,40,1957668
ihfAp4,1.1666666666666667,24,11,TGCGTACATGCTGAATATTG,13,1940299
ihfAp4,4.583333333333333,65,11,TGATTTAATTTGGTTGTGCA,54,1923231
ihfAp4,1.1666666666666667,24,11,TGATACAGTTCAGGCAAAAT,13,1950068
ihfAp4,2.5,40,11,TGAGGACGTGATGCGTACAT,29,1949040
ihfAp4,5.5,76,11,TGACCGGAAAGTAGTGTATG,65,1921772
ihfAp4,2.3333333333333335,38,11,TGAAGAGAGCAGGCCAGAGA,27,1944617
ihfAp4,2.1666666666666665,36,11,TGAACACGGCCTAGATGCAA,25,1938566
ihfAp4,3.25,49,11,TCTTTAGTGGAAATAAATGT,38,1942673
ihfAp4,1.0,22,11,TCTCATGGCCCATTTTTTGG,11,1948184
ihfAp4,4.166666666666667,60,11,TCGAGCCTACACTGAGCGAT,49,1924623
ihfAp4,6.083333333333333,83,11,TCCTTGTATCACATTTGCGG,72,1945370
ihfAp4,3.1666666666666665,48,11,TCCTATTCTCGCCTGCACAC,37,1926008
ihfAp4,4.0,58,11,TCCGTTATTTCAAGAACATT,47,1948787
ihfAp4,1.0,22,11,TCCGTAGATCTGTCCCTAGT,11,1924191
ihfAp4,0.16666666666666666,12,11,TCCGGGCGGTCGTAGTTAGG,1,1953853
ihfAp4,3.0,46,11,TCCCCAGTTAGTTTCCTAGT,35,1917837
ihfAp4,15.0,190,11,TCAAGGCACAATCTGTTGCT,179,1955815
ihfAp4,4.25,61,11,TCAAGATGGTGACCCATGAT,50,1925426
ihfAp4,1.1666666666666667,24,11,TCAAGATCATCGCAGGTTGT,13,1911528
ihfAp4,6.083333333333333,83,11,TATTTGTTCATGTCTTGCGT,72,1953237
ihfAp4,2.0,34,11,TATCGGAGGAGGGAGTTCGA,23,1941018
ihfAp4,2.5,40,11,TATACCCAATCTGGATCACC,29,1952803
ihfAp4,2.0833333333333335,35,11,TAGGTCCTTCCTGGTAAGTT,24,1911193
ihfAp4,2.8333333333333335,44,11,TAGGGTTGAATTGAATGGCG,33,1929901
ihfAp4,2.1666666666666665,36,11,TAGGAAGTCGGGATGGGGCA,25,1942356
ihfAp4,2.25,37,11,TAGATTAGTACAAATTAAAA,26,1927627
ihfAp4,4.833333333333333,68,11,TAGACCTTAATATGACTAAT,57,1934246
ihfAp4,1.4166666666666667,27,11,TACCTGACCTACGGGGGTCT,16,1947046
ihfAp4,2.75,43,11,TACCATACCGTGGTTCGACA,32,1957645
ihfAp4,4.5,64,11,TACATCCGAAACTGGAGCAG,53,1939085
ihfAp4,0.16666666666666666,12,11,TAATATGACAAGGGAGGTGC,1,1956165
ihfAp4,3.1666666666666665,48,11,TAAGGTGCACAACGCGCCAG,37,1913709
ihfAp4,1.9166666666666667,33,11,TAAGCTGTAAGACAAAGAGA,22,1928415
ihfAp4,1.5,28,11,TAAGATCGTAAGACTGCCCC,17,1935064
ihfAp4,2.5833333333333335,41,11,TAAAGGTCTGAATCTCCCGT,30,1939626
ihfAp4,7.666666666666667,102,11,TAAAGGTACAAGGGAACGTT,91,1939896
ihfAp4,2.0,34,11,TAAAGCGCGAATTTATTTTA,23,1911228
ihfAp4,0.9166666666666666,21,11,GTTTCGACGTTGATATGGTC,10,1913016
ihfAp4,2.1666666666666665,36,11,GTTGTGTTATGTCGAGAAGA,25,1931504
ihfAp4,1.0833333333333333,23,11,GTTATCTTGACTTGTCGTCT,12,1926483
ihfAp4,2.5,40,11,GTTACGCTAGTGGGACGAAA,29,1938073
ihfAp4,2.0833333333333335,35,11,GTTAAGGGGCTACGAGCACT,24,1939574
ihfAp4,1.75,31,11,GTTAAAATTGGGATATGCTT,20,1922182
ihfAp4,1.8333333333333333,32,11,GTGGGATTTCCGTTAGGTAA,21,1934761
ihfAp4,2.5833333333333335,41,11,GTGCGGGTCCAGGCTGTCAC,30,1936384
ihfAp4,4.0,58,11,GTGCGCCAAGGGTCCGAATC,47,1927182
ihfAp4,0.9166666666666666,21,11,GTGCGAGTTACCAGCGTACT,10,1915512
ihfAp4,2.0,34,11,GTGAGTATAAACTGGATCGT,23,1954516
ihfAp4,2.5,40,11,GTCTGTAAATGCGGAGCGCA,29,1913713
ihfAp4,3.6666666666666665,54,11,GTCGACGTTTTATAAGTGTT,43,1937525
ihfAp4,2.25,37,11,GTCCGCCTTTTGCCGTAGTC,26,1956848
ihfAp4,3.1666666666666665,48,11,GTCAGTTCTAACCTGTTACC,37,1936415
ihfAp4,1.1666666666666667,24,11,GTCAGATCACATCTGTTCCG,13,1951193
ihfAp4,0.25,13,11,GTCAACCAAGGCACAGGGAC,2,1925564
ihfAp4,2.5833333333333335,41,11,GTAGGTAGACCGTAGCCTTA,30,1961616
ihfAp4,1.1666666666666667,24,11,GTAACTTTTTTTAGGCAACG,13,1935885
ihfAp4,2.5,40,11,GGTTGTCAAGTGGGTCGTGT,29,1934944
ihfAp4,3.6666666666666665,54,11,GGTGGATCGGCGGCTACCAG,43,1912791
ihfAp4,2.5,40,11,GGTAAAGCGTGTGAACTTGT,29,1915926
ihfAp4,3.5,52,11,GGGTGGAGATCACCGTTGTA,41,1916542
ihfAp4,2.4166666666666665,39,11,GGGTCATGGACTTCCCGTAT,28,1923764
ihfAp4,1.8333333333333333,32,11,GGGGGCAGAGAGAGCGGAAC,21,1935371
ihfAp4,4.5,64,11,GGGGCTCTCGGGCGTGCGGC,53,1933333
ihfAp4,1.5833333333333333,29,11,GGGGCGTTTCGAATGGAAGA,18,1940080
ihfAp4,5.083333333333333,71,11,GGGATTTACGTCGGGTCTTT,60,1938575
ihfAp4,0.16666666666666666,12,11,GGGACACCATCCCGTCGTTG,1,1918702
ihfAp4,8.25,109,11,GGCGAAGCTGCAACTTCTTA,98,1944041
ihfAp4,0.5,16,11,GGCCACTCTATTGCGTTTCG,5,1943710
ihfAp4,1.5833333333333333,29,11,GGCATGGGATGAGATGTTCT,18,1925482
ihfAp4,0.16666666666666666,12,11,GGAGGTCGCGGGATGCTCCA,1,1960295
ihfAp4,1.75,31,11,GGAGGCGCCTTTGCTCCCGT,20,1934428
ihfAp4,1.5833333333333333,29,11,GGACTTATGTTGGCCCAAGA,18,1939637
ihfAp4,1.1666666666666667,24,11,GCTTCCGAAAATGGCACAAC,13,1959814
ihfAp4,0.6666666666666666,18,11,GCTGCATACATACACTGGCG,7,1940082
ihfAp4,1.25,25,11,GCTAAGGTGACGCAATCATA,14,1925795
ihfAp4,3.0,46,11,GCCTATCGAGGGGCGAAGTA,35,1947381
ihfAp4,2.5833333333333335,41,11,GCCCCTTCATCATATAATTC,30,1935937
ihfAp4,1.0,22,11,GCATGCATGAAGATTGAATA,11,1948341
ihfAp4,1.1666666666666667,24,11,GCACAGCGCAGGCACCTTAA,13,1914690
ihfAp4,0.16666666666666666,12,11,GCAAAGCTGGTGCTGGTGGC,1,1921019
ihfAp4,0.4166666666666667,15,11,GCAAAAATGCACACACGATT,4,1915956
ihfAp4,3.1666666666666665,48,11,GATTGAAGGACGGTTACAAG,37,1920171
ihfAp4,2.25,37,11,GATCATGGCCAAAATTACTC,26,1917354
ihfAp4,1.5833333333333333,29,11,GAGTGGTTTCGGTTGTAACT,18,1918096
ihfAp4,1.4166666666666667,27,11,GAGTAATGTGACAACGGAAG,16,1960884
ihfAp4,2.5,40,11,GAGCGGAAGCTGTAGCTAAA,29,1914980
ihfAp4,1.0,22,11,GACAGAATTTAGGTTTCGAC,11,1916456
ihfAp4,2.0,34,11,GACAATGTGACCGGAACCTA,23,1947924
ihfAp4,0.6666666666666666,18,11,GAATTTCCGGATCGGCCCAT,7,1945976
ihfAp4,2.4166666666666665,39,11,GAATGGCATCGGGATCCAGA,28,1919837
ihfAp4,5.083333333333333,71,11,GAAGTGGGTGAGTGTGAATT,60,1947861
ihfAp4,4.083333333333333,59,11,GAAGGGTCAAGGATATGGGT,48,1922247
ihfAp4,1.1666666666666667,24,11,GAAGGATATAGAACGGATCG,13,1953568
ihfAp4,3.25,49,11,GAACGATCCCATTCTCTCTA,38,1936282
ihfAp4,2.1666666666666665,36,11,CTTCGACCCAATTGCGGGTA,25,1914362
ihfAp4,1.8333333333333333,32,11,CTTCATAAACTTCTCGGAGG,21,1942108
ihfAp4,1.5833333333333333,29,11,CTTACCGCGTCCCGAAGTCA,18,1953027
ihfAp4,1.75,31,11,CTGGTACGACATTTGAATGT,20,1961775
ihfAp4,0.9166666666666666,21,11,CTGGGGCGGACGGATTAAGT,10,1953478
ihfAp4,0.4166666666666667,15,11,CTGGGACGGCATTGTACGCT,4,1918985
ihfAp4,0.25,13,11,CTGGATGACGAAACTAAGCA,2,1957257
ihfAp4,2.0833333333333335,35,11,CTGATTGCTTGCAATGTTGA,24,1924269
ihfAp4,1.25,25,11,CTCTTGTTGTTGTCTGCCGA,14,1919838
ihfAp4,2.0,34,11,CTCTTACACGTGTATCATAC,23,1921537
ihfAp4,2.25,37,11,CTCGTCGTGGGAGTATCGTT,26,1958921
ihfAp4,2.0833333333333335,35,11,CTCGCACAACTGGTCGGTTT,24,1923947
ihfAp4,2.5833333333333335,41,11,CTCGAGAGGGCAGGAAAGCC,30,1938265
ihfAp4,2.5833333333333335,41,11,CTCCGTTCGCACATCCTTGA,30,1953650
ihfAp4,2.4166666666666665,39,11,CTCCCACTAAACATTCTCTG,28,1950487
ihfAp4,2.9166666666666665,45,11,CTATGCTAAATATCGTCATA,34,1955505
ihfAp4,9.583333333333334,125,11,CTATGCCACACGGATCGCCG,114,1961522
ihfAp4,0.5,16,11,CTAGTCACTGGCTACTATCT,5,1944687
ihfAp4,5.75,79,11,CTAGGTTAAGCTGGTGTAGA,68,1944796
ihfAp4,7.083333333333333,95,11,CTAACAGCCGCGCTCGTCGC,84,1938841
ihfAp4,1.8333333333333333,32,11,CGTGTTTCCCAAATTACCCT,21,1928946
ihfAp4,2.4166666666666665,39,11,CGTGGGCTCAGTAGATGCCA,28,1939885
ihfAp4,1.1666666666666667,24,11,CGGTCCCGTGTACGTAATGC,13,1960580
ihfAp4,1.25,25,11,CGGTATTTATTTCAGCGGCT,14,1941019
ihfAp4,0.16666666666666666,12,11,CGGGTTCCGGAGTTTAATGA,1,1919637
ihfAp4,1.5,28,11,CGGCCAACAGCTCAGCTCAC,17,1957953
ihfAp4,1.6666666666666667,30,11,CGGAGCAAGGAAGCCCACAA,19,1935621
ihfAp4,13.25,169,11,CGCTCTCTGGAGGGCCGAAG,158,1921403
ihfAp4,6.666666666666667,90,11,CGCTCACAATGCAGCATCCG,79,1953730
ihfAp4,4.25,61,11,CGCGTCATGGAAGGGACTAT,50,1932753
ihfAp4,2.3333333333333335,38,11,CGCGAGGTAAACAGTATCTT,27,1953572
ihfAp4,0.5833333333333334,17,11,CGCCTTTCTAACGCACCGTG,6,1933675
ihfAp4,3.1666666666666665,48,11,CGCCCTACATTCACGACGAT,37,1914907
ihfAp4,0.75,19,11,CGATGACTCGTGTGCCTACT,8,1937823
ihfAp4,4.583333333333333,65,11,CGATGAAAAGCACAGAAGCA,54,1942929
ihfAp4,2.3333333333333335,38,11,CGACAGATCACAAAATTTAC,27,1927932
ihfAp4,1.6666666666666667,30,11,CGAACGACGTTTGTTTAACT,19,1915853
ihfAp4,3.5,52,11,CCTTGACTCTGTGAATTATG,41,1935517
ihfAp4,3.3333333333333335,50,11,CCTTAGTTGGCATTCGGTAC,39,1933954
ihfAp4,0.6666666666666666,18,11,CCTGAGGACGCAGGAATGAT,7,1956972
ihfAp4,0.16666666666666666,12,11,CCTGAGATGAAGTACCGAAG,1,1952251
ihfAp4,2.9166666666666665,45,11,CCTATATAAGCCGGGTATTA,34,1961898
ihfAp4,0.16666666666666666,12,11,CCGTGTATGTGCGTTGGTGA,1,1931700
ihfAp4,0.16666666666666666,12,11,CCGAGGGAGCTGCAGGGGGA,1,1956197
ihfAp4,6.416666666666667,87,11,CCCTGTGTATCGCCGGGCTC,76,1933959
ihfAp4,0.16666666666666666,12,11,CCCGTCGATGCGTATGAATG,1,1932994
ihfAp4,2.3333333333333335,38,11,CCCGGTGGTTATGTGGGCAT,27,1949520
ihfAp4,1.5,28,11,CCATTGCATAGCTAAGCCCA,17,1932799
ihfAp4,0.16666666666666666,12,11,CCATGGCAGTAGTGAAATCA,1,1920897
ihfAp4,4.833333333333333,68,11,CCAGGGAAGAAGAAACGACT,57,1918629
ihfAp4,11.75,151,11,CCAGCCCAACTGAGTCGAGT,140,1955704
ihfAp4,1.9166666666666667,33,11,CATTGATTCACTTGAGGTGA,22,1909703
ihfAp4,7.916666666666667,105,11,CATTAACCACTTCGCGACGT,94,1951778
ihfAp4,1.5833333333333333,29,11,CATCAGATAAAAGCAAAGGG,18,1919468
ihfAp4,0.16666666666666666,12,11,CAGTTTTGGGTGCTTGATGA,1,1945156
ihfAp4,0.5,16,11,CAGCAGTCAACACGGATAAG,5,1939031
ihfAp4,10.75,139,11,CAGATAGCATATGTGATACA,128,1955715
ihfAp4,2.1666666666666665,36,11,CAGACATACCAGTTCTCGAG,25,1956930
ihfAp4,2.4166666666666665,39,11,CACTGAGGTTTCATTACATA,28,1925235
ihfAp4,2.0,34,11,CACCCAGCTAATGCCACCAA,23,1911530
ihfAp4,1.9166666666666667,33,11,CACACGAGAGCTAAATGTTA,22,1936955
ihfAp4,0.3333333333333333,14,11,CAATATTACAGTCTGGTTTG,3,1946773
ihfAp4,0.16666666666666666,12,11,CAAGGGTGTATATTGTCTGT,1,1956141
ihfAp4,2.75,43,11,CAAGATAAGTCCTCATGAGA,32,1916970
ihfAp4,1.25,25,11,CAAAGTTCTACGGAAATGTA,14,1954217
ihfAp4,1.75,31,11,CAAACGTCATCGAGGTCATT,20,1955871
ihfAp4,1.0,22,11,ATTCGTCCCTCGTTACAGCT,11,1944507
ihfAp4,1.4166666666666667,27,11,ATTCCCGTTCCAAACGCGGT,16,1937050
ihfAp4,2.3333333333333335,38,11,ATTCATACTTTTCAGAACGT,27,1928673
ihfAp4,1.5,28,11,ATGTACGTATGCCTGTTTCC,17,1923366
ihfAp4,2.5,40,11,ATGTACAGTCTGACTCCTCA,29,1939661
ihfAp4,1.1666666666666667,24,11,ATGCTTGGAGTTGCCTGGTG,13,1921314
ihfAp4,1.0833333333333333,23,11,ATGCTTCAGCCTCTCATACT,12,1937479
ihfAp4,1.0,22,11,ATCTACGCGGGACGAGCAGA,11,1952288
ihfAp4,2.0833333333333335,35,11,ATATGAGGACGAGGAATCAT,24,1930058
ihfAp4,2.1666666666666665,36,11,ATATACACGACACTTCTTAT,25,1960690
ihfAp4,1.9166666666666667,33,11,ATAGCGTTGGACGGCCTGAT,22,1911144
ihfAp4,1.5,28,11,ATAACGGGAGTCATCGTGTG,17,1932459
ihfAp4,2.5833333333333335,41,11,AGTTTAGTTTCAATATACCA,30,1918900
ihfAp4,1.5,28,11,AGTTGCCATTGTCACTTGCG,17,1928606
ihfAp4,2.25,37,11,AGTTCAGAGTACCAGCGGCT,26,1920206
ihfAp4,3.1666666666666665,48,11,AGTGCGGTACTGACAATCAT,37,1944741
ihfAp4,1.4166666666666667,27,11,AGTGCCTACCGATACTCTCC,16,1917894
ihfAp4,2.0,34,11,AGTCTCTTTGATGTATTGAG,23,1952800
ihfAp4,1.1666666666666667,24,11,AGTCTACGCCACTTCTTCCC,13,1926145
ihfAp4,1.9166666666666667,33,11,AGTACAATTGCAGTTCTCTA,22,1941130
ihfAp4,3.1666666666666665,48,11,AGGTGGAGGTTTAAAGGTAT,37,1941652
ihfAp4,1.75,31,11,AGGTATGCATGATTTGAAAA,20,1958395
ihfAp4,0.9166666666666666,21,11,AGGTAAGTTACGTACTCGGG,10,1925158
ihfAp4,1.75,31,11,AGGGGTGCCGCGGCAAAAAA,20,1935422
ihfAp4,3.1666666666666665,48,11,AGGCCGCCGTAACGTCATCG,37,1945313
ihfAp4,2.0,34,11,AGGCAAGCGATTGGACGTGT,23,1948964
ihfAp4,0.75,19,11,AGCGTGGTCGCTGACGCCTT,8,1918349
ihfAp4,7.083333333333333,95,11,AGATGACATCTCATAGACCA,84,1927935
ihfAp4,2.5,40,11,AGATCGGGGGGCAGACCGGG,29,1931449
ihfAp4,2.1666666666666665,36,11,AGAGATCGGGCATCGTCTGA,25,1961189
ihfAp4,1.5,28,11,AGACGTCCGCCATTTCTTTG,17,1947498
ihfAp4,2.3333333333333335,38,11,AGACATGCTTATCTCTCTTT,27,1912621
ihfAp4,2.3333333333333335,38,11,AGAAATGAGGAGTCAGAGTC,27,1926295
ihfAp4,2.0,34,11,ACTTAGGTCCTATTTATCCA,23,1937251
ihfAp4,0.8333333333333334,20,11,ACTGGGGCTGACAGATCTGC,9,1930406
ihfAp4,0.75,19,11,ACGGTCTCTCGTAAGGAATC,8,1931630
ihfAp4,4.5,64,11,ACGAGAGTGACGAGAGGAAA,53,1955507
ihfAp4,1.5,28,11,ACGAGAATCCCCGTCCTTCT,17,1941478
ihfAp4,1.6666666666666667,30,11,ACGACGGTTCATATAAACTT,19,1928881
ihfAp4,2.0833333333333335,35,11,ACGAAGTAACGGAAAGATCC,24,1909622
ihfAp4,1.3333333333333333,26,11,ACCTCAGAGAGACAGAGGTG,15,1939331
ihfAp4,3.9166666666666665,57,11,ACCCTCACGGGGGATAGCGC,46,1925659
ihfAp4,2.5,40,11,ACCCAACACATAGGAGAGGT,29,1920523
ihfAp4,2.8333333333333335,44,11,ACACTTTCTACAGCTATATC,33,1910895
ihfAp4,3.1666666666666665,48,11,ACAAACCTCCTTGCATTATA,37,1955383
ihfAp4,1.3333333333333333,26,11,ACAAAATTTTCAATATGGGG,15,1917218
ihfAp4,0.16666666666666666,12,11,AATATTACAAACCTACGGCA,1,1938989
ihfAp4,2.0,34,11,AATAACGCGATTCAAGTGGG,23,1918972
ihfAp4,1.5833333333333333,29,11,AAGTTTAGTCAACCCACTTC,18,1918395
ihfAp4,2.0833333333333335,35,11,AAGGTAGGGTGTAAGGCGAA,24,1951188
ihfAp4,1.5833333333333333,29,11,AAGCCTACTCGCAGTATTAT,18,1917284
ihfAp4,8.916666666666666,117,11,AAGCAGGGTCCTTGTTTATT,106,1958629
ihfAp4,1.75,31,11,AAGACCGCCTGACCCTCAAT,20,1923610
ihfAp4,0.3333333333333333,14,11,AAGAACTACTGGGAACTGAT,3,1922961
ihfAp4,2.1666666666666665,36,11,AACTGTGATGCTTCTGAGAG,25,1928157
ihfAp4,3.6666666666666665,54,11,AACTAAACTGAATCTGGAGA,43,1932233
ihfAp4,3.75,55,11,AACGCAGGGAATTAGTTCCA,44,1923835
ihfAp4,1.9166666666666667,33,11,AACCGAAGATATCTGTAGAG,22,1927192
ihfAp4,2.0,34,11,AACATTCGACTTATGCTTGA,23,1939429
ihfAp4,0.25,13,11,AAATTGTCTTTGCCGCGAGT,2,1953878
ihfAp4,1.9166666666666667,33,11,AAATCACGCCGTCGCATTTC,22,1931021
ihfAp4,1.9166666666666667,33,11,AAAGACCGGCCGTTTCCCCC,22,1943671
ihfAp4,4.7272727272727275,61,10,TTTCATTTGCGTATGCTAAC,51,1932045
ihfAp4,9.909090909090908,118,10,TTGTGATAATAGTGATGGGA,108,1919214
ihfAp4,0.18181818181818182,11,10,TTGGGCGTGTATCGATTTCA,1,1921973
ihfAp4,3.6363636363636362,49,10,TTGATCCGCTAGTATTATGG,39,1946316
ihfAp4,2.3636363636363638,35,10,TTGAACTACTCTTAAAAGTT,25,1932116
ihfAp4,2.1818181818181817,33,10,TTCTACCACTCAAACTCGGA,23,1935595
ihfAp4,0.18181818181818182,11,10,TTCCGGAACCAGACTGACAC,1,1943845
ihfAp4,0.18181818181818182,11,10,TTATTTATGTTCTCACATGT,1,1936344
ihfAp4,0.9090909090909091,19,10,TTAGAATAGGGGCGAACTCT,9,1942803
ihfAp4,2.090909090909091,32,10,TTACTGAGGGATTATCTTCT,22,1938115
ihfAp4,1.2727272727272727,23,10,TTAAAAGCAAAGATTGGTTT,13,1920844
ihfAp4,8.909090909090908,107,10,TGTGTAGGAGTTGATCGTGA,97,1954826
ihfAp4,2.4545454545454546,36,10,TGTGCATGGGAGACCCTCGG,26,1937542
ihfAp4,0.18181818181818182,11,10,TGGTTACCTGTAGTTAGTAC,1,1951143
ihfAp4,4.090909090909091,54,10,TGGTGTCTAGCCGTTGCTGT,44,1956617
ihfAp4,4.0,53,10,TGGTGGATACCAGACGTCTG,43,1931602
ihfAp4,2.6363636363636362,38,10,TGGGAATACCATTGCTTGCC,28,1943890
ihfAp4,1.6363636363636365,27,10,TGGAGGCAGAGTACTGCTTT,17,1922345
ihfAp4,5.363636363636363,68,10,TGCTCGCGTCCACCGAAGCC,58,1924130
ihfAp4,2.0,31,10,TGCCGAACAGACAAGGGTAA,21,1937970
ihfAp4,1.6363636363636365,27,10,TGCCACAGAAGCTCTGGCCA,17,1934177
ihfAp4,4.363636363636363,57,10,TGCAAGCTGTGGCTCGCTGA,47,1918746
ihfAp4,3.6363636363636362,49,10,TCTTCGTCATCTCTTTGCAT,39,1935752
ihfAp4,0.18181818181818182,11,10,TCTTATGACGTGAATAGGTG,1,1937668
ihfAp4,2.4545454545454546,36,10,TCTGATAGAGAACAGTTATG,26,1938689
ihfAp4,0.18181818181818182,11,10,TCTCCACGCCGGATGGAAAT,1,1936026
ihfAp4,0.18181818181818182,11,10,TCGTCGGCAGTAGCAGTCTT,1,1961413
ihfAp4,1.2727272727272727,23,10,TCGGATCGCACCTGTCACAC,13,1940701
ihfAp4,1.9090909090909092,30,10,TCGATAAGCACAGGCGCTCA,20,1955287
ihfAp4,0.18181818181818182,11,10,TCCGGCCTCCGGCAAAGTAT,1,1925045
ihfAp4,8.363636363636363,101,10,TCCAGGCGAGAGTCTGAGAT,91,1909617
ihfAp4,0.18181818181818182,11,10,TCATCAAGTACGACGCGTAA,1,1959425
ihfAp4,0.9090909090909091,19,10,TCATACCAAACGTACAACTA,9,1929894
ihfAp4,2.909090909090909,41,10,TCAGGTAATCAGCCACCGAT,31,1930767
ihfAp4,3.4545454545454546,47,10,TCAGACCCTGGAATCCCATA,37,1923696
ihfAp4,2.3636363636363638,35,10,TCACAATCACTAATGAATGC,25,1913854
ihfAp4,2.0,31,10,TCAATGACTCACATATCAGG,21,1938767
ihfAp4,1.4545454545454546,25,10,TATTGTCTCAAGTCCCCCTT,15,1933636
ihfAp4,3.8181818181818183,51,10,TATGGAACCGTGGCGTAAGT,41,1937569
ihfAp4,1.6363636363636365,27,10,TATGCTTTCGACGTATCAGC,17,1913055
ihfAp4,2.6363636363636362,38,10,TATCCGTAGCGATCTTTTCT,28,1924621
ihfAp4,1.8181818181818181,29,10,TATCAGGCTTTGCCCACCAA,19,1953705
ihfAp4,5.0,64,10,TATACGCCCGGTTTGATGTT,54,1926185
ihfAp4,2.0,31,10,TAGGGGCTTATGTTTATGCA,21,1941743
ihfAp4,4.7272727272727275,61,10,TAGGCACCAGCCTGGCGAGT,51,1938085
ihfAp4,0.7272727272727273,17,10,TAGGATGCATTGCCGGATTT,7,1945427
ihfAp4,1.1818181818181819,22,10,TAGCGTGCACATTTACGGTA,12,1918706
ihfAp4,1.2727272727272727,23,10,TAGCCATGGTTCTTCCGGAA,13,1919022
ihfAp4,3.3636363636363638,46,10,TAGAACGGGCAATGAACGAA,36,1939295
ihfAp4,1.2727272727272727,23,10,TACTTACCCAAGCCCTGCAT,13,1959406
ihfAp4,0.2727272727272727,12,10,TACGCCCCTCAGGTGGGGGA,2,1962297
ihfAp4,3.8181818181818183,51,10,TACAACGGGTTAGCAGAGGT,41,1944233
ihfAp4,1.8181818181818181,29,10,TAATTCTTCTTAGCTAAGGC,19,1946685
ihfAp4,0.9090909090909091,19,10,TAACGTGCACCGACAACGGT,9,1929093
ihfAp4,3.1818181818181817,44,10,GTTTTGCTCCACGTAATATT,34,1915755
ihfAp4,0.18181818181818182,11,10,GTTTTATGCACCTTGTGGCA,1,1927753
ihfAp4,2.8181818181818183,40,10,GTTTTAGCGTCACGTCGTGA,30,1933301
ihfAp4,0.7272727272727273,17,10,GTTTGCAGACAGCGGCCCAT,7,1929479
ihfAp4,1.8181818181818181,29,10,GTTGCTCTTTTCGCACGATT,19,1954258
ihfAp4,2.1818181818181817,33,10,GTTCTGTAGGTATGATTGTT,23,1922021
ihfAp4,2.272727272727273,34,10,GTTCATCCTCTTCATACACG,24,1946577
ihfAp4,1.7272727272727273,28,10,GTTAGTGCAGGTTTTCCCAA,18,1930410
ihfAp4,5.636363636363637,71,10,GTTAGGCCATTGACACTTCT,61,1919256
ihfAp4,4.2727272727272725,56,10,GTGTTGGCCAAAATAGTGGA,46,1925858
ihfAp4,5.454545454545454,69,10,GTGGTAGCCTTGTCTCCTAG,59,1914412
ihfAp4,2.0,31,10,GTGGGAGAGTTGGAGACCGA,21,1924860
ihfAp4,1.2727272727272727,23,10,GTGCATAGCCCTGTGTTGTA,13,1961119
ihfAp4,0.6363636363636364,16,10,GTGAAAGTGTTAGAAAACAT,6,1953051
ihfAp4,6.363636363636363,79,10,GTCTGATGGTCTGAGTGATC,69,1936294
ihfAp4,4.545454545454546,59,10,GTCTCTTCAGCGTTTTTGCA,49,1936701
ihfAp4,1.0909090909090908,21,10,GTCCGTAAGACATGGGCGAC,11,1942483
ihfAp4,1.0909090909090908,21,10,GTCCCGTTGGATTGAGGCGT,11,1926151
ihfAp4,0.7272727272727273,17,10,GTCAATTAGATTGAATTGAA,7,1927029
ihfAp4,0.18181818181818182,11,10,GTCAATGCGATCCACTTTCC,1,1922990
ihfAp4,0.8181818181818182,18,10,GTATTTGGGTGAGATAGATG,8,1937178
ihfAp4,0.18181818181818182,11,10,GTATCAAGTTGTTGTAGTGT,1,1947362
ihfAp4,2.4545454545454546,36,10,GTAGTTGCCCCCCAAGGCCA,26,1942972
ihfAp4,0.8181818181818182,18,10,GTACGTCCTCACCAGGCCAA,8,1959744
ihfAp4,3.0,42,10,GGTTGTGCCATGTCACCGAT,32,1923035
ihfAp4,4.363636363636363,57,10,GGTCCCTTTGCTAGTCTTGA,47,1912048
ihfAp4,0.8181818181818182,18,10,GGGGCGCGCAGTTATGAATT,8,1951309
ihfAp4,2.1818181818181817,33,10,GGGCTCCCTTTGGTTGGATC,23,1945244
ihfAp4,6.909090909090909,85,10,GGCTAGGCCTGATATCGGAA,75,1938533
ihfAp4,0.2727272727272727,12,10,GGCGGCTCATCTCGTCTGCT,2,1923029
ihfAp4,5.2727272727272725,67,10,GGCGCACACACTGCTGAACG,57,1939520
ihfAp4,1.0909090909090908,21,10,GGCATTCCCGGAACATGCAT,11,1960862
ihfAp4,1.7272727272727273,28,10,GGCAGGTCGGGGCGTAATAG,18,1910685
ihfAp4,3.090909090909091,43,10,GGCACATCAGCTCGACAAGT,33,1918626
ihfAp4,5.636363636363637,71,10,GGATTGCGTGCAATAGTTCT,61,1943231
ihfAp4,1.8181818181818181,29,10,GGATTAGCAATGTGCGCTAC,19,1919048
ihfAp4,2.090909090909091,32,10,GGACGGAGGTACTTCTGGCG,22,1943612
ihfAp4,3.909090909090909,52,10,GCTTGCTTGGTTTGCACTTG,42,1934101
ihfAp4,1.3636363636363635,24,10,GCTGTATGTAATGGCAGCCG,14,1915475
ihfAp4,2.8181818181818183,40,10,GCGTTTCCATAAGCACCGAA,30,1944827
ihfAp4,1.4545454545454546,25,10,GCGTAGCGCGGCTCAGCCAC,15,1959533
ihfAp4,2.4545454545454546,36,10,GCGGACGTGGTCGGTAGCCA,26,1921179
ihfAp4,2.1818181818181817,33,10,GCGCCTCTGCGTATGGGCCG,23,1951610
ihfAp4,5.0,64,10,GCGAGTACCCGGGAAGTCCT,54,1927734
ihfAp4,2.8181818181818183,40,10,GCCTGGCGGGCTGTCCTGTT,30,1915756
ihfAp4,2.090909090909091,32,10,GCCGATTGCTTTGAAATGGC,22,1958522
ihfAp4,2.1818181818181817,33,10,GCCACATCCATATCCATTAT,23,1935617
ihfAp4,2.6363636363636362,38,10,GCATGTTCTACTCCACATTC,28,1944156
ihfAp4,1.0,20,10,GCACGCCACATCTGGCGCCA,10,1915100
ihfAp4,5.090909090909091,65,10,GCAACTGCGGAAGGTTTCCG,55,1934225
ihfAp4,4.181818181818182,55,10,GATCACATCCATTCGTGCAA,45,1956967
ihfAp4,1.0,20,10,GATACCTCACGATGGCCGCG,10,1940338
ihfAp4,3.727272727272727,50,10,GATACATAGGTTTCGTGTGT,40,1937634
ihfAp4,0.18181818181818182,11,10,GATAAACAGCCCAGCCAAGT,1,1925505
ihfAp4,1.5454545454545454,26,10,GAGTGAAAGGGAACAGAATT,16,1934847
ihfAp4,1.6363636363636365,27,10,GAGTACATATCTTTCCTCAA,17,1937413
ihfAp4,1.8181818181818181,29,10,GAGGGCTATCGATTTGAAGA,19,1936911
ihfAp4,0.18181818181818182,11,10,GAGGCGTTAAACAGTTTTAT,1,1960453
ihfAp4,1.2727272727272727,23,10,GAGCTTGCTAGTCGGTAGAG,13,1939897
ihfAp4,3.4545454545454546,47,10,GACTCCGGGGCACACTTTTC,37,1915538
ihfAp4,5.2727272727272725,67,10,GACTACGAGACGCACTTTAC,57,1955707
ihfAp4,1.9090909090909092,30,10,GACGCTCAGAGTAGGACATA,20,1944738
ihfAp4,5.636363636363637,71,10,GACCTCGGATCAGACCCAAG,61,1914935
ihfAp4,3.090909090909091,43,10,GAATCTAATTCTAGTATGTC,33,1943768
ihfAp4,1.2727272727272727,23,10,GAAGTTGAGTACACTTTGAG,13,1926387
ihfAp4,1.0,20,10,GAACGCAGGCATTGTGTACT,10,1932055
ihfAp4,1.0,20,10,GAAACCGAAATAAATATCGA,10,1935394
ihfAp4,1.3636363636363635,24,10,GAAACATTCCAGAAAACATG,14,1951352
ihfAp4,2.3636363636363638,35,10,CTTTTAGAGGCGAAGAGTGT,25,1932745
ihfAp4,4.818181818181818,62,10,CTTTGGGATAGCGACCCCCA,52,1914908
ihfAp4,1.8181818181818181,29,10,CTTTGATGCCGTCTTGCGAG,19,1937459
ihfAp4,1.7272727272727273,28,10,CTTTCTCATGAAGGTGCGGG,18,1918692
ihfAp4,2.727272727272727,39,10,CTTTAGTTTGCTACTATCTG,29,1915289
ihfAp4,4.909090909090909,63,10,CTTGTTCCGAGAGAGCACTT,53,1945355
ihfAp4,4.0,53,10,CTTACGGAATGTATTAAGGA,43,1935097
ihfAp4,0.45454545454545453,14,10,CTTACCGTATGTGATTATAT,4,1962213
ihfAp4,3.1818181818181817,44,10,CTTAAGACGAAACATTGATT,34,1939065
ihfAp4,7.181818181818182,88,10,CTGTAGGGAGAGCTCTGGGC,78,1947330
ihfAp4,0.18181818181818182,11,10,CTGCACCGGTTGATGTGTTT,1,1942309
ihfAp4,1.0909090909090908,21,10,CTGATTTGGCTGTTAACCAT,11,1957434
ihfAp4,9.363636363636363,112,10,CTGATACACTTTGAGAGCTC,102,1946148
ihfAp4,2.272727272727273,34,10,CTGAGCGCAGGCACGGATCC,24,1925570
ihfAp4,1.0909090909090908,21,10,CTCTCTTTAATGATGGTCAC,11,1911832
ihfAp4,1.4545454545454546,25,10,CTCGTGTGGGGTAACACTGA,15,1958927
ihfAp4,1.3636363636363635,24,10,CTCGCAAGGCGTATCAAGGT,14,1922579
ihfAp4,1.6363636363636365,27,10,CTCCATCCTACACCAATTTG,17,1953515
ihfAp4,3.0,42,10,CTCAACGGGAGCTCATATAT,32,1946420
ihfAp4,1.0,20,10,CTATGGGGGTCGGCAGAGCT,10,1928498
ihfAp4,1.2727272727272727,23,10,CTACTAAATAATCACTTGTC,13,1942538
ihfAp4,0.2727272727272727,12,10,CGTTAGTTATGCATATGCTT,2,1928317
ihfAp4,2.3636363636363638,35,10,CGTGGGGTAGAGCGAACCCT,25,1926825
ihfAp4,1.1818181818181819,22,10,CGTGGCAGTAGCGAAGTTAT,12,1949531
ihfAp4,5.545454545454546,70,10,CGTGCATCTCTCACCAAACT,60,1916139
ihfAp4,0.18181818181818182,11,10,CGTACTGGATTTCTCAACGC,1,1960333
ihfAp4,3.909090909090909,52,10,CGTACAATCGATCTCGGGGT,42,1950982
ihfAp4,0.8181818181818182,18,10,CGTAATGTATTGCCCTGGGT,8,1953168
ihfAp4,4.545454545454546,59,10,CGGTCGTGTAATGTTCTTAG,49,1914045
ihfAp4,7.363636363636363,90,10,CGGTCCTCGAGCCGTTCTCG,80,1928554
ihfAp4,2.4545454545454546,36,10,CGGTATCACCCGTGCGGTGA,26,1923239
ihfAp4,3.0,42,10,CGGCCTAGAAAGGTATCTTT,32,1915701
ihfAp4,2.909090909090909,41,10,CGGACGTCCGAGCAAACGTG,31,1944576
ihfAp4,1.4545454545454546,25,10,CGCTATTGTCTTATAAAAAT,15,1941087
ihfAp4,0.6363636363636364,16,10,CGCGCGAGCCCCGGTTTTTA,6,1938938
ihfAp4,2.4545454545454546,36,10,CGCCCATGACGGACCCCCTG,26,1935507
ihfAp4,2.8181818181818183,40,10,CGATTAACAATGACTTATAG,30,1923945
ihfAp4,2.909090909090909,41,10,CGACCATGTTCATGACCGTT,31,1920299
ihfAp4,0.8181818181818182,18,10,CGAACGATGCATCGAGTCCT,8,1916793
ihfAp4,0.6363636363636364,16,10,CCTTGTCGAGCGCACTGTAT,6,1956122
ihfAp4,2.1818181818181817,33,10,CCTTGGCAGTTAGACATTAC,23,1960775
ihfAp4,0.5454545454545454,15,10,CCTTCTGCAAGTGCGCGTGG,5,1929700
ihfAp4,2.6363636363636362,38,10,CCTCTATATGCCGATCCATG,28,1935423
ihfAp4,2.727272727272727,39,10,CCTCCTCGTTCGTGAAATGA,29,1938461
ihfAp4,1.8181818181818181,29,10,CCTATTAAGTGTGGTAGCCG,19,1938343
ihfAp4,1.6363636363636365,27,10,CCTAGATACAGGTTGTCATG,17,1915983
ihfAp4,1.4545454545454546,25,10,CCGGGTGCCCATGTCGGATA,15,1929653
ihfAp4,3.8181818181818183,51,10,CCGGCCCTGTGATACCGATT,41,1945374
ihfAp4,3.727272727272727,50,10,CCCTACATTTCCGAATTTTT,40,1941138
ihfAp4,5.909090909090909,74,10,CCCGGTAGAAAATGCTTTAT,64,1948013
ihfAp4,5.818181818181818,73,10,CCCGCCCCATCCTCCGGCCA,63,1921165
ihfAp4,0.18181818181818182,11,10,CCCCGTTTAGTCTTCATAGT,1,1913930
ihfAp4,1.7272727272727273,28,10,CCCCACCAGGGGGTGGTCTA,18,1945709
ihfAp4,2.1818181818181817,33,10,CCCAATTATATTCGACGCGG,23,1949293
ihfAp4,5.0,64,10,CCATCAAAATTCCGACGGCA,54,1943216
ihfAp4,2.8181818181818183,40,10,CCAGCTACTTGCGCCACCAG,30,1911958
ihfAp4,1.4545454545454546,25,10,CATGTTGGGAACTTAACAGT,15,1954279
ihfAp4,4.7272727272727275,61,10,CATCTGTAGTAGCTCCGGGC,51,1944560
ihfAp4,1.7272727272727273,28,10,CATCGAAAGAAGGAAACTCG,18,1931020
ihfAp4,3.272727272727273,45,10,CATCCGGGCTCATGTCCATA,35,1955022
ihfAp4,5.818181818181818,73,10,CATACCGGTAGCTGTGCCGG,63,1918212
ihfAp4,2.8181818181818183,40,10,CAGTAGTCTTGAACCAGAGA,30,1945332
ihfAp4,2.272727272727273,34,10,CAGTAAGGTAAGCAAAATTG,24,1947499
ihfAp4,3.1818181818181817,44,10,CAGGCCCAATTCTCGCTTGA,34,1943961
ihfAp4,6.7272727272727275,83,10,CAGAACACGAAGAGCACCAT,73,1933016
ihfAp4,10.545454545454545,125,10,CACTTTAGCTAGTAGCAAAT,115,1954045
ihfAp4,0.18181818181818182,11,10,CACCCTCTACGTCGCAGTTA,1,1933306
ihfAp4,4.0,53,10,CACCAGGATTGTGGTGGTGC,43,1917029
ihfAp4,0.18181818181818182,11,10,CACACTTCGTGATTATGTGA,1,1950073
ihfAp4,3.0,42,10,CAATTCACAGAAAAGCCGTC,32,1927906
ihfAp4,2.0,31,10,CAAGAAAAGATGTGTGCGAC,21,1954655
ihfAp4,4.181818181818182,55,10,CAACCCACGTCGGGGTCCAC,45,1932788
ihfAp4,1.9090909090909092,30,10,CAACAACCCAATTGCTGACT,20,1941357
ihfAp4,2.6363636363636362,38,10,ATTTTGGTGGATTCGGTAGC,28,1934484
ihfAp4,4.636363636363637,60,10,ATTTGGTCTGACCCGTATGT,50,1957004
ihfAp4,2.090909090909091,32,10,ATTGGATCATAGAATGTAGG,22,1925190
ihfAp4,2.090909090909091,32,10,ATTGAGCAAAAATCAATGAA,22,1925198
ihfAp4,1.8181818181818181,29,10,ATTCTTTAGCATGAGCACCT,19,1942314
ihfAp4,0.18181818181818182,11,10,ATTCTGAGGAAAAACTGGGA,1,1934004
ihfAp4,4.454545454545454,58,10,ATTCGATGGAACTGAGGGTA,48,1954320
ihfAp4,1.0,20,10,ATTCGACCCCTGTGTCGTTT,10,1927509
ihfAp4,1.3636363636363635,24,10,ATTCAGTGGTCTGATAACTG,14,1957356
ihfAp4,3.5454545454545454,48,10,ATTACGTACCCGACGTAACA,38,1941183
ihfAp4,0.18181818181818182,11,10,ATGTTAGTCAAATCCTGTCA,1,1936359
ihfAp4,2.0,31,10,ATGGGTGGTCTAGGTGACTC,21,1946757
ihfAp4,2.6363636363636362,38,10,ATGGAAACCTACGGTTGATA,28,1914857
ihfAp4,2.0,31,10,ATGCGAGTCTGTGTGGGGAA,21,1961053
ihfAp4,8.090909090909092,98,10,ATCCGGGGTTCTGTGGTCAG,88,1923309
ihfAp4,1.0,20,10,ATCCAATTGGTAAGGTCTAT,10,1951315
ihfAp4,2.090909090909091,32,10,ATATCCTGCTCATATAGCAT,22,1916153
ihfAp4,0.9090909090909091,19,10,ATAGAAATTGCGGCAGCTTT,9,1938226
ihfAp4,1.5454545454545454,26,10,ATAATAACATCGCGACGGTG,16,1956475
ihfAp4,1.1818181818181819,22,10,ATAACGATGGGCCTTAACGT,12,1936908
ihfAp4,6.363636363636363,79,10,ATAAACTCGGTGTAGTAGAC,69,1910142
ihfAp4,4.090909090909091,54,10,AGTTAGCGGCTCCCCCTTAT,44,1915778
ihfAp4,0.2727272727272727,12,10,AGTGTAAGCTTCCTGGGCCT,2,1929753
ihfAp4,2.8181818181818183,40,10,AGTGGACTTCGAGCTAGGTA,30,1950543
ihfAp4,2.6363636363636362,38,10,AGTCTTGCTCGCCGCGGGAC,28,1928645
ihfAp4,2.727272727272727,39,10,AGTCATAAAATGGGGGCCTA,29,1922944
ihfAp4,1.6363636363636365,27,10,AGTAGTGGGCTATATTTGTA,17,1960353
ihfAp4,1.7272727272727273,28,10,AGTAATAGGAACGAAACGAT,18,1944303
ihfAp4,2.727272727272727,39,10,AGTAAGGTGCTACAAGCAAC,29,1945621
ihfAp4,2.8181818181818183,40,10,AGGTCCAGTTCCCGTGGTGT,30,1934612
ihfAp4,5.909090909090909,74,10,AGGGCCTAATCGAAGGGACA,64,1943760
ihfAp4,1.6363636363636365,27,10,AGGCCGACGTGGAGTTTGCA,17,1920588
ihfAp4,2.0,31,10,AGGAGGCTGCGGGGATTACG,21,1909825
ihfAp4,0.2727272727272727,12,10,AGCCTCGCTCCGCTATCGAC,2,1940907
ihfAp4,3.4545454545454546,47,10,AGCCCGATTCCCGGAAGCAT,37,1933803
ihfAp4,1.1818181818181819,22,10,AGCATGGCAATAGGCGTCAC,12,1946027
ihfAp4,1.8181818181818181,29,10,AGAGTAACTTACGGTAGCTA,19,1949082
ihfAp4,0.36363636363636365,13,10,AGAGATTACAGCTGGTAAAA,3,1916951
ihfAp4,2.1818181818181817,33,10,AGAATCAGCCTTTTGGACCA,23,1929208
ihfAp4,2.272727272727273,34,10,AGAACGGTACTCTTTCGTAA,24,1921868
ihfAp4,2.090909090909091,32,10,ACTTGGTTAATACACGAACT,22,1956658
ihfAp4,10.363636363636363,123,10,ACGTATCTTAGTGTGTGAAG,113,1947363
ihfAp4,2.3636363636363638,35,10,ACGTAGTTCAAATACTCTAT,25,1953335
ihfAp4,2.090909090909091,32,10,ACGGATTGGTGAGATCCGGT,22,1955283
ihfAp4,2.0,31,10,ACGCTGCCTTCCGTATAATA,21,1957484
ihfAp4,4.7272727272727275,61,10,ACGATCCCCTGGAGCTTCCC,51,1943182
ihfAp4,0.18181818181818182,11,10,ACGAGTATTTTGCGGCGACT,1,1917161
ihfAp4,1.7272727272727273,28,10,ACGAAGGGAATGGCTCACTA,18,1924819
ihfAp4,2.272727272727273,34,10,ACCTTGCGGGAAAATATAGA,24,1918914
ihfAp4,2.909090909090909,41,10,ACCTAACTAAGGCCTCACGG,31,1925558
ihfAp4,2.090909090909091,32,10,ACCCTCCCCGTGAACTGGTA,22,1961958
ihfAp4,5.2727272727272725,67,10,AATTTCTTATCGTTACTAGA,57,1954151
ihfAp4,0.8181818181818182,18,10,AATGGAGAACGCACTCGTCG,8,1926661
ihfAp4,0.5454545454545454,15,10,AATCGCTTTCGGATACATGT,5,1939509
ihfAp4,0.7272727272727273,17,10,AATAGACGCAAGCGCTAGCC,7,1917057
ihfAp4,1.0909090909090908,21,10,AAGGGCTAGGGTGTGAATTG,11,1923192
ihfAp4,3.3636363636363638,46,10,AAGGCGGAGCAGATTCTACG,36,1957546
ihfAp4,4.181818181818182,55,10,AAGGAACACAGGGTTTCCAG,45,1942839
ihfAp4,2.8181818181818183,40,10,AAGCTATTTCTTGTTGGGTG,30,1910608
ihfAp4,0.9090909090909091,19,10,AAGCCGTTGCGCAGTACTGA,9,1911034
ihfAp4,1.8181818181818181,29,10,AAGACGGACCGCACTCTCCG,19,1937541
ihfAp4,2.5454545454545454,37,10,AACTCGTTAGGATCCTGGCA,27,1918075
ihfAp4,0.18181818181818182,11,10,AACTAAGGCACAGCATATAC,1,1914099
ihfAp4,0.9090909090909091,19,10,AACAATGTCTCCGATGGCGC,9,1913286
ihfAp4,2.090909090909091,32,10,AACAACGGGGGGTTGATCGG,22,1931223
ihfAp4,2.090909090909091,32,10,AAAGGAGACGCGCTCAACCC,22,1917864
ihfAp4,5.9,67,9,TTTGTTTCTGTTTAGCGTAA,58,1949622
ihfAp4,1.4,22,9,TTTGCGAGGGCATATCGCGC,13,1951141
ihfAp4,7.1,79,9,TTTGAGTGGTCAGGGCAGAG,70,1917713
ihfAp4,7.0,78,9,TTTCAGTCGCACTCTGCGTT,69,1960480
ihfAp4,1.5,23,9,TTTACTGTTTTGTGGAGTAG,14,1924200
ihfAp4,2.1,29,9,TTTACCTTCAGCACACCGTT,20,1913239
ihfAp4,2.1,29,9,TTGTGAACGAGCTGAGGTAA,20,1937080
ihfAp4,7.7,85,9,TTGGAATCTGACTACCACCA,76,1934835
ihfAp4,1.4,22,9,TTGATAGTGCACCGGGGGCA,13,1934936
ihfAp4,2.2,30,9,TTGACTCTCAGGGGAAAACT,21,1945220
ihfAp4,4.5,53,9,TTCTTCTGGCTCAGCTCCTG,44,1942444
ihfAp4,1.5,23,9,TTCTACTATCTCTGGTTTTG,14,1952565
ihfAp4,5.5,63,9,TTCGTTTACACGGATTCCGA,54,1909963
ihfAp4,4.1,49,9,TTCCCCTGAACACGCATGGT,40,1949292
ihfAp4,2.5,33,9,TTCAGTACGGCGAGGCCCGG,24,1945345
ihfAp4,2.4,32,9,TTCAGCAGGCAGCAATCGGG,23,1930862
ihfAp4,1.7,25,9,TTATTGTTGATAGTCAGAGT,16,1948032
ihfAp4,3.2,40,9,TTATCGGGCGTTGCCTTCTC,31,1921706
ihfAp4,3.7,45,9,TTATCACCGCGGTGTCACCG,36,1947820
ihfAp4,0.2,10,9,TTATATTCTGGCTGAACGTG,1,1926553
ihfAp4,1.5,23,9,TGTTTGTTCAATCTGTACAC,14,1933451
ihfAp4,2.3,31,9,TGTTACAAGATGCGTAGGTG,22,1930766
ihfAp4,0.2,10,9,TGTATGGGATACGCATAGCC,1,1941230
ihfAp4,2.4,32,9,TGTAGGACTGGGCTGGGGAC,23,1911602
ihfAp4,6.7,75,9,TGTAGACTAAATGTGATTCT,66,1959071
ihfAp4,5.8,66,9,TGGTAGTTGTCAGGGTCGCA,57,1933450
ihfAp4,1.0,18,9,TGCTAAGTTGTAGCAGCCTG,9,1917453
ihfAp4,4.8,56,9,TGCGCGGAATCGATCAAACG,47,1916281
ihfAp4,1.6,24,9,TGCCTTAGAACTCTCGGACT,15,1941165
ihfAp4,4.9,57,9,TGCCTGACGTACTGCGTAGA,48,1910312
ihfAp4,6.8,76,9,TGCCCTACGGGCGGTACACA,67,1918545
ihfAp4,3.7,45,9,TGATGAACGAAGCGTATAAG,36,1920982
ihfAp4,0.9,17,9,TGAGTCCGTCGCCAGACGAT,8,1909959
ihfAp4,5.7,65,9,TGAGGTCCTCCGCCGGCACT,56,1937667
ihfAp4,2.2,30,9,TGAGGACATGGTATGAGCCA,21,1937029
ihfAp4,1.7,25,9,TGAATCCGGGGCGAACATTT,16,1932594
ihfAp4,1.8,26,9,TCTTTGTGTAGATGGATTTG,17,1913296
ihfAp4,0.3,11,9,TCTTTGCATTTACGCTTCTA,2,1913958
ihfAp4,3.2,40,9,TCTTTCGGTCTGAGGCCTTA,31,1926228
ihfAp4,1.0,18,9,TCTGCTAATTAATGGTTTTC,9,1931501
ihfAp4,2.8,36,9,TCTGCCGTTATTTTGTCCTG,27,1941787
ihfAp4,1.3,21,9,TCTAGCGTCTCCGCGATTCC,12,1934397
ihfAp4,6.9,77,9,TCGCTTCATAAAGACTGTGA,68,1942683
ihfAp4,6.9,77,9,TCGCGCTGCATCAATAGGTA,68,1950380
ihfAp4,2.3,31,9,TCGCGCGCTGCGTACGGACG,22,1915269
ihfAp4,1.0,18,9,TCGCCACGGTCAATACCGGG,9,1920324
ihfAp4,2.0,28,9,TCGATATGGTGCGCCAACTG,19,1939367
ihfAp4,2.7,35,9,TCGAGGTAGGTAACCTCCAT,26,1929615
ihfAp4,10.7,115,9,TCCTTCTAAGGAATAAAAGT,106,1921928
ihfAp4,2.1,29,9,TCCGATTCCAACTCTAGATA,20,1930535
ihfAp4,0.4,12,9,TCCACATATAAACAACAGCA,3,1912558
ihfAp4,1.8,26,9,TCATGCTGTATTGTTGACCA,17,1928882
ihfAp4,1.8,26,9,TCAGTCCCAATTCGCAGGCC,17,1925522
ihfAp4,9.6,104,9,TCAGGTGGGGTAACGATTCG,95,1927649
ihfAp4,5.3,61,9,TCAAGAGAAGCATACATGTA,52,1938588
ihfAp4,2.7,35,9,TATTCCTGTTTCGCGAGGCG,26,1951644
ihfAp4,3.3,41,9,TATCTCATGATTTGTCTCGC,32,1927986
ihfAp4,0.2,10,9,TATACCAAGGTAGTGCCCTG,1,1957702
ihfAp4,0.7,15,9,TATAAACCGCCTTTCTAGTG,6,1929360
ihfAp4,0.7,15,9,TAGCCTACGGGCGGCCGTGT,6,1927230
ihfAp4,1.1,19,9,TAGCCGAGGGACCACGCATT,10,1958478
ihfAp4,3.9,47,9,TAGAGCAAGAAGGTTGTGTA,38,1926869
ihfAp4,1.0,18,9,TACTTCCAAGGCTTAAGCAT,9,1945408
ihfAp4,1.7,25,9,TACTTACCACCGTTTGCTTT,16,1911949
ihfAp4,5.7,65,9,TACTGTATGCAGAAGGTACA,56,1914899
ihfAp4,2.4,32,9,TACGGTGACGGACGATTTAG,23,1957942
ihfAp4,5.3,61,9,TACCTATTTGACAGCGTTAA,52,1925796
ihfAp4,2.9,37,9,TACAGCTCACCGGGCTGTGA,28,1934365
ihfAp4,0.2,10,9,TACAAGAAGCAAAAGGCCTT,1,1931781
ihfAp4,2.6,34,9,TAAGGTGTAAGGCTTGAGGG,25,1930653
ihfAp4,2.1,29,9,TAAATAGGTGTAGGGGTATC,20,1916603
ihfAp4,0.5,13,9,TAAAGTTGGCAGCAATCTAA,4,1946107
ihfAp4,1.1,19,9,GTTTCCGGTTGTCTTCCCAG,10,1923806
ihfAp4,1.1,19,9,GTTTATCGCAGCTATGTCGT,10,1925271
ihfAp4,3.5,43,9,GTTGTTTGTGGACAAGGGCG,34,1941789
ihfAp4,1.2,20,9,GTTGTATTCGTGGCGCATCA,11,1944615
ihfAp4,3.4,42,9,GTTGGCCGTGTATTCGTAAG,33,1947523
ihfAp4,1.9,27,9,GTTCTGCATTTCTCAACATA,18,1960202
ihfAp4,4.0,48,9,GTGTTAGCAGATTGACCTAT,39,1949914
ihfAp4,7.4,82,9,GTGTCTGATTGGATGCGTGC,73,1957548
ihfAp4,2.5,33,9,GTGTATAGAGTGGCCACAAT,24,1933743
ihfAp4,1.1,19,9,GTGCGGAAGTGCTGTAAGGA,10,1943793
ihfAp4,2.9,37,9,GTGACACGCGTAATCTTGGT,28,1934795
ihfAp4,2.9,37,9,GTCTCAGAAACCAGCACGTA,28,1918115
ihfAp4,1.5,23,9,GTCTATGCTCAGTGAGCTCA,14,1918650
ihfAp4,1.2,20,9,GTCACGAGCAGCGGAAAACA,11,1957519
ihfAp4,1.2,20,9,GTATTGGGGAATTCTATTGT,11,1917147
ihfAp4,5.2,60,9,GTATGATAGCGTTGAAAGTA,51,1946255
ihfAp4,0.9,17,9,GTATGACACAGTGGTCCACT,8,1941942
ihfAp4,1.4,22,9,GTATCTACTGAGACTGGACA,13,1925891
ihfAp4,2.4,32,9,GTATCCTTATGACGCCGAGG,23,1927032
ihfAp4,2.2,30,9,GTAGCGGGTTCAAAACTTGG,21,1948802
ihfAp4,1.2,20,9,GTACATCCTAGGCACCACCT,11,1920537
ihfAp4,4.0,48,9,GGTTTGGAAGTGTTGGTTCG,39,1959721
ihfAp4,2.2,30,9,GGTTCATTCTGTGGACGACA,21,1913207
ihfAp4,3.2,40,9,GGTTAGTCGGGCTTTAAGTA,31,1912515
ihfAp4,1.2,20,9,GGTTAGCGGGAGGAGGCAAC,11,1933325
ihfAp4,0.9,17,9,GGTGTTCGTAAACACGCGTT,8,1912290
ihfAp4,3.3,41,9,GGTGTAACGGACTGAGTATT,32,1953839
ihfAp4,0.4,12,9,GGTCCACCTCTTTTCGACAG,3,1910460
ihfAp4,2.5,33,9,GGTATGGTAGAGGTGTTTTG,24,1918276
ihfAp4,0.2,10,9,GGTAGTTAATACAAATGGCT,1,1922987
ihfAp4,4.8,56,9,GGGTCGATTATCCCGATACA,47,1910042
ihfAp4,1.4,22,9,GGGTACTTGGCCAGCCCGGT,13,1909955
ihfAp4,8.0,88,9,GGGGTTGATGAGGACTATAA,79,1927970
ihfAp4,2.0,28,9,GGGGCTGCATCCATGCGTAA,19,1949592
ihfAp4,4.9,57,9,GGGCGGGGTAGGTTTGTTTG,48,1929306
ihfAp4,3.8,46,9,GGGCCGGATTACGTCAGAGA,37,1933940
ihfAp4,2.2,30,9,GGGCCACAGAAATGTATCCT,21,1949381
ihfAp4,1.6,24,9,GGGACGTAGGTTACACCTGT,15,1910857
ihfAp4,3.7,45,9,GGCTTAGATTTGCGCGACCG,36,1962077
ihfAp4,0.5,13,9,GGCTAAGCTCCCTTGCGCTC,4,1941938
ihfAp4,4.0,48,9,GGCGGGGCTAAGGGGGGTCT,39,1924084
ihfAp4,3.0,38,9,GGCCCTATGCCGCATCTCAT,29,1921689
ihfAp4,0.2,10,9,GGCCCGTGCTCCAGGCTCCA,1,1934431
ihfAp4,3.0,38,9,GGCCACGCACAGCCTGCGTA,29,1937246
ihfAp4,4.7,55,9,GGCAGGCGCGTCTTCTTTTT,46,1922410
ihfAp4,3.5,43,9,GGCAGATGTTAGGTCTTAAC,34,1925137
ihfAp4,8.6,94,9,GGCAAGCTGATTCTTGAGCT,85,1926116
ihfAp4,2.6,34,9,GGATCCAGCCATCTACCCGG,25,1911291
ihfAp4,2.0,28,9,GGATCACGCGACAAGTGTTA,19,1925624
ihfAp4,1.9,27,9,GGAGTAGCATTGGACGTGCT,18,1952011
ihfAp4,2.0,28,9,GGAGGCAGTAGTCCAGAGTC,19,1912436
ihfAp4,5.2,60,9,GGAGCTGCCGCTTGGATGTA,51,1942060
ihfAp4,7.0,78,9,GGAGACATCCTGATCTTGCT,69,1922804
ihfAp4,5.3,61,9,GGACGCACGTCAGGAGGCGA,52,1958641
ihfAp4,7.9,87,9,GGACATCTTGCACAACACCC,78,1919281
ihfAp4,2.1,29,9,GGACAATGCAGTTGATCTGG,20,1943134
ihfAp4,4.1,49,9,GGAAATGTGCCCCTCAGTGA,40,1949486
ihfAp4,0.8,16,9,GGAAAGATCAAAAACCAGGT,7,1940018
ihfAp4,1.4,22,9,GGAAAATGGGGTTCCTCTCA,13,1910816
ihfAp4,0.9,17,9,GCTGATATTCTCGTAATCTA,8,1926889
ihfAp4,3.1,39,9,GCTCCTCGATAGTCTTTCCG,30,1935656
ihfAp4,2.9,37,9,GCTCCACCATATCACACCTG,28,1913914
ihfAp4,1.9,27,9,GCTATGACTGTGGAGGACTT,18,1944739
ihfAp4,1.0,18,9,GCTAGACAAAGAAACTGGCC,9,1918886
ihfAp4,0.2,10,9,GCGTGAAGCACTCACGTCCC,1,1934433
ihfAp4,3.1,39,9,GCGGCAATCGATTCACTGAA,30,1931468
ihfAp4,6.0,68,9,GCGACTGATGCCATATCTAG,59,1940104
ihfAp4,1.9,27,9,GCCTCATCAGCTTCTCAAAT,18,1947121
ihfAp4,3.6,44,9,GCCTCACGTATGTTTTAGGC,35,1957376
ihfAp4,6.9,77,9,GCCACTTGTACAGATGTTTT,68,1912789
ihfAp4,0.2,10,9,GCCACGGCCATCTTTTCTTG,1,1958708
ihfAp4,1.9,27,9,GCAGCCGCGTTTGCGATTTC,18,1951691
ihfAp4,1.7,25,9,GCACAGTCGTACGGGATGAT,16,1944559
ihfAp4,2.3,31,9,GCAAGCTCTGCATATATGTT,22,1925875
ihfAp4,1.2,20,9,GCAAGACGACGAATGTAACA,11,1947163
ihfAp4,2.9,37,9,GATTTATATTATGAACTTGA,28,1912481
ihfAp4,1.0,18,9,GATGTGACATTTTATGCTAC,9,1923150
ihfAp4,3.0,38,9,GAGGGGAAGACTTGATGAGT,29,1924495
ihfAp4,2.4,32,9,GAGGCATCATAACTCCCAGG,23,1921702
ihfAp4,1.6,24,9,GAGCGATGATGCCAGGAAGG,15,1954867
ihfAp4,0.2,10,9,GAATGTACCAAATGTGGAAG,1,1910054
ihfAp4,1.5,23,9,GAAGGACTTCGGCCCACTTA,14,1922762
ihfAp4,0.2,10,9,GAACGGCCTAACGGCAACGC,1,1913288
ihfAp4,1.0,18,9,CTTTGAGGGCAAAAAGGCCA,9,1916464
ihfAp4,2.9,37,9,CTTGTTCGAGCCCGGTATGC,28,1960089
ihfAp4,1.0,18,9,CTTGTATTGCTCCCCTGATA,9,1910361
ihfAp4,0.5,13,9,CTTGGAATGTCCTTGATCGA,4,1932061
ihfAp4,6.9,77,9,CTTCTAAACAGACAATCGAA,68,1915797
ihfAp4,6.6,74,9,CTTCCCTGCTTCCTGAAGCT,65,1940264
ihfAp4,0.9,17,9,CTGGCGAGCCGGTCCGTTAG,8,1912630
ihfAp4,5.5,63,9,CTGGATCCACGTCGTTGGAC,54,1930381
ihfAp4,3.7,45,9,CTGCTCTGCCGTTATATTCA,36,1927995
ihfAp4,4.7,55,9,CTGCCTATTTTGTCGAGAGC,46,1925033
ihfAp4,7.9,87,9,CTGACTGTCCTATACCACCT,78,1915054
ihfAp4,4.8,56,9,CTCTTATGATCAGGCTATGT,47,1939670
ihfAp4,0.2,10,9,CTCGTGCGGCTGGCCGTTAG,1,1910292
ihfAp4,4.2,50,9,CTCGGTGAACAATACTGCCC,41,1950662
ihfAp4,0.2,10,9,CTCGACTTATAGGACTAGTT,1,1943123
ihfAp4,2.8,36,9,CTCATTCAAGTGGTCGGGCG,27,1916089
ihfAp4,4.9,57,9,CTCAGGTGTACCGTGACTTA,48,1923741
ihfAp4,1.3,21,9,CTCACCTAGTTGAAGTTTAA,12,1933132
ihfAp4,1.7,25,9,CTAGCATCAGCGAACGCCGA,16,1950310
ihfAp4,2.0,28,9,CTACGCCTCACCCCCTTGCT,19,1957066
ihfAp4,2.3,31,9,CTACCATAGTGGAAGGGACT,22,1960930
ihfAp4,0.2,10,9,CTACATTTTCTCCGAGTACT,1,1931645
ihfAp4,7.6,84,9,CTAAACTATGCCAGGATTCA,75,1955821
ihfAp4,0.4,12,9,CGTTAAGGGCGATATCGGCC,3,1961810
ihfAp4,0.5,13,9,CGTGATGCCCAGTGCCTCCA,4,1950849
ihfAp4,2.6,34,9,CGTCTGGGTATTATGCGTAT,25,1949089
ihfAp4,4.9,57,9,CGTATAGTTGTCCAACTTTT,48,1951613
ihfAp4,0.2,10,9,CGGTAAGTGCATGTAACGCG,1,1927922
ihfAp4,1.2,20,9,CGGGTCTGCCAAAATGCTTA,11,1942604
ihfAp4,5.6,64,9,CGGGCGTCCGATCCGCATGA,55,1954293
ihfAp4,1.4,22,9,CGGGCAACGATGGCCAGTTG,13,1913795
ihfAp4,4.7,55,9,CGGGAGCAGGAAACCGAGGT,46,1954710
ihfAp4,0.6,14,9,CGGCCACTAATTAGTCACTT,5,1938145
ihfAp4,2.4,32,9,CGGCACCATTCTGCAATCAG,23,1929417
ihfAp4,2.3,31,9,CGCTTGATGGCCTTCGTAGG,22,1916321
ihfAp4,2.4,32,9,CGCTGTTTGCACTCATGTCA,23,1957220
ihfAp4,2.0,28,9,CGCGTAAGCCCTTATCTGTC,19,1919123
ihfAp4,3.6,44,9,CGCGGGACAGTAACGAGGTT,35,1923994
ihfAp4,3.8,46,9,CGCGATCCGCAACTGGGTAA,37,1917754
ihfAp4,5.4,62,9,CGCGAACGTGGGACACCGCT,53,1955357
ihfAp4,3.5,43,9,CGCATTGATTCTACCGGCTA,34,1961532
ihfAp4,3.2,40,9,CGCAAGCGCCTTCACGAATG,31,1919639
ihfAp4,7.3,81,9,CGATACAGAGGACCTGTTCC,72,1927937
ihfAp4,3.0,38,9,CGATAATATATTAGTGACTA,29,1934850
ihfAp4,9.6,104,9,CGAGGTACTGGATCACAGGC,95,1953829
ihfAp4,0.2,10,9,CGAGCCAGCTCCAATGAACA,1,1910695
ihfAp4,3.3,41,9,CGAAGATGGGGTTCCAGTCT,32,1923188
ihfAp4,2.2,30,9,CCTTTCAAACGGCTGGCCGC,21,1938100
ihfAp4,0.2,10,9,CCTTTACAGCCAACGGTCAT,1,1935443
ihfAp4,8.3,91,9,CCTTGCATTTTAATTAAAAT,82,1935048
ihfAp4,4.2,50,9,CCTGTGTCCTAGGCGGATCC,41,1945334
ihfAp4,3.2,40,9,CCTGGGACGCACCCTTGCAT,31,1929058
ihfAp4,8.1,89,9,CCTGGACATATGTTCTTTGA,80,1916264
ihfAp4,2.3,31,9,CCTCTGTGAGTGCATGTCCG,22,1911088
ihfAp4,1.4,22,9,CCTATTACTTGGTTTTTTTA,13,1938283
ihfAp4,1.7,25,9,CCGTTTCCTCCGTTTACCAA,16,1959587
ihfAp4,2.5,33,9,CCGGTACCCTTAACGGAATA,24,1914196
ihfAp4,0.2,10,9,CCGACGAGGACCGTACGCAA,1,1953798
ihfAp4,4.0,48,9,CCGAATGCACTTGTAAGCAT,39,1926540
ihfAp4,1.1,19,9,CCCTGTGATATGAGGATGTT,10,1918163
ihfAp4,2.9,37,9,CCCGAGTCACCCGGCGATGA,28,1942005
ihfAp4,4.8,56,9,CCCCACGTCAGGTCGCCCCA,47,1959447
ihfAp4,2.6,34,9,CCATTTTTGGAAAACGTCTC,25,1939067
ihfAp4,2.0,28,9,CCATTTACACCGTCATTACC,19,1947254
ihfAp4,1.0,18,9,CCATATTCTCTGGGTTTACT,9,1918628
ihfAp4,1.6,24,9,CCAGGTTTTCGGTTTGCCTG,15,1959370
ihfAp4,0.9,17,9,CCAATCCTTGTATCACCTCC,8,1932726
ihfAp4,2.0,28,9,CCAATAAGACCATCGGAACG,19,1912831
ihfAp4,3.8,46,9,CCAAGTGGCCACCCTGGAGC,37,1920711
ihfAp4,2.9,37,9,CATTGACCTTCTTAGGCCGC,28,1933087
ihfAp4,1.2,20,9,CATGATGAAACTGGAGTTAA,11,1943336
ihfAp4,2.8,36,9,CATACTCTCGATCAGTCCAA,27,1915190
ihfAp4,1.8,26,9,CAGGTCCTGCCGATTGGGAT,17,1949283
ihfAp4,4.6,54,9,CAGGCTATGTGGCAGGTAGA,45,1956478
ihfAp4,2.6,34,9,CAGGCAGGTCCGAACGAGAC,25,1922845
ihfAp4,1.1,19,9,CAGCGGCAGTGCGGACAAAG,10,1932112
ihfAp4,1.3,21,9,CAGCGCACCTCACTAGAGTT,12,1947980
ihfAp4,6.5,73,9,CAGACCGGGATGAGTACTGG,64,1944964
ihfAp4,3.9,47,9,CAGAACTTCAGTCGTATTAC,38,1948836
ihfAp4,2.4,32,9,CACTGGGAGCTGGATAATAT,23,1959747
ihfAp4,0.2,10,9,CACTATCTGCTCTATAGAGC,1,1916955
ihfAp4,2.3,31,9,CACCCTTGATCAATGCCGGT,22,1914779
ihfAp4,2.2,30,9,CACATACGGGATAGTTCCGC,21,1914716
ihfAp4,2.0,28,9,CACAGGTCGGACAGGTACTG,19,1924673
ihfAp4,2.5,33,9,CACACGAGGTAGGTGACATA,24,1943248
ihfAp4,1.9,27,9,CAATGACCCTATGCTCAACA,18,1913682
ihfAp4,3.6,44,9,CAAGGGTCGCAGGTAGAATC,35,1913940
ihfAp4,1.5,23,9,CAACTTTGCCCAATGGGCTG,14,1960274
ihfAp4,0.3,11,9,CAACGCTGTGGACTTTGAAT,2,1914526
ihfAp4,1.8,26,9,ATTTCGTGGGCTAGGCATCG,17,1919025
ihfAp4,7.8,86,9,ATTGGCGGACTCTCGATCTC,77,1931585
ihfAp4,0.4,12,9,ATTGCACCACGAATTATCGT,3,1947675
ihfAp4,0.2,10,9,ATTGAGGTAGACGCTTGGTT,1,1954292
ihfAp4,0.2,10,9,ATTGAGAAATTTTTAAGTTC,1,1952356
ihfAp4,2.5,33,9,ATTAGGGTCAAGCGATTGTG,24,1929014
ihfAp4,1.8,26,9,ATTAGGGCTCACATTAGCAT,17,1918313
ihfAp4,2.0,28,9,ATGTGTACTCCATCAATAGA,19,1934924
ihfAp4,0.3,11,9,ATGTATGGTGTGCCATGTTA,2,1943118
ihfAp4,2.9,37,9,ATGTACACCGACGGCAGATG,28,1942743
ihfAp4,1.3,21,9,ATCTTCCTTACGTGGGAGCC,12,1909751
ihfAp4,4.4,52,9,ATCGCCCACTACCTTCAGAA,43,1922093
ihfAp4,0.5,13,9,ATCGCCAAAATGAATGACTA,4,1946605
ihfAp4,2.4,32,9,ATCCTCAGTGGTAAGTTGTA,23,1925797
ihfAp4,1.0,18,9,ATCCGTGTGGGCATCGGCCC,9,1915732
ihfAp4,1.9,27,9,ATCCCTAAGGTGTATCTAGG,18,1918437
ihfAp4,0.9,17,9,ATCAAGTGCATTAATCGACA,8,1911735
ihfAp4,1.6,24,9,ATCAAGTAGCGATTTTCAGT,15,1958795
ihfAp4,1.2,20,9,ATATTCCGTGACTATACAGT,11,1946064
ihfAp4,2.7,35,9,ATATGATCTAAAATCTTTGA,26,1943434
ihfAp4,2.2,30,9,ATATCCCCCGGGGTACAAAA,21,1955506
ihfAp4,4.6,54,9,ATACGGGTTCCCATAACTCT,45,1914484
ihfAp4,1.4,22,9,ATACCATAATATTTTCGGTC,13,1955248
ihfAp4,2.8,36,9,AGTCTCGCTCGCCCACCTGA,27,1958109
ihfAp4,3.4,42,9,AGGGCCATATATTCCTGCCG,33,1943650
ihfAp4,1.2,20,9,AGGCGCCCGGCGGGTGGCGC,11,1949061
ihfAp4,3.8,46,9,AGGCAAAATTCTGGGGTAGT,37,1932398
ihfAp4,4.0,48,9,AGCTCGTATGCCGAATACGC,39,1951103
ihfAp4,1.5,23,9,AGCGCTCATACACGTTGTGG,14,1916690
ihfAp4,1.8,26,9,AGCAGATCATAATACGGGGG,17,1950496
ihfAp4,4.5,53,9,AGCAGACATAGGTCTTAATT,44,1961225
ihfAp4,0.5,13,9,AGACGTAGGGTTCATGAGGA,4,1928456
ihfAp4,3.4,42,9,AGAAGGTCGGCAGGCTCATA,33,1921979
ihfAp4,1.0,18,9,AGAAATATTGATCTAACTAC,9,1918591
ihfAp4,1.8,26,9,ACTTTAATCTGGGTCCAAGT,17,1935774
ihfAp4,2.7,35,9,ACTTGCACTTGGCGTTACTA,26,1947383
ihfAp4,3.3,41,9,ACTTAAGAGTGCATAGGATA,32,1926706
ihfAp4,3.6,44,9,ACTGATCAATCTCACTCCAA,35,1915693
ihfAp4,3.6,44,9,ACTACGCATTCGCAAAGGGA,35,1939575
ihfAp4,0.2,10,9,ACTAAATTATCGACTCCGTC,1,1926613
ihfAp4,6.1,69,9,ACGTAAGTCCTCGGGCTCCC,60,1923852
ihfAp4,2.4,32,9,ACGTAAAATTTTGATGATCT,23,1938765
ihfAp4,2.7,35,9,ACGGTTGCGCACCTCGCCAC,26,1927737
ihfAp4,4.6,54,9,ACGGCCAGCTATTCTGAAGG,45,1933744
ihfAp4,10.2,110,9,ACGCTGAAACGGGTGTGGGA,101,1954387
ihfAp4,0.5,13,9,ACGCGGCGCAGGAGAAGCGC,4,1923976
ihfAp4,2.4,32,9,ACCGTGATCCCATGTACCAT,23,1939341
ihfAp4,11.8,126,9,ACCGGCCCAGTAGTAAAAAA,117,1929231
ihfAp4,5.4,62,9,ACCGCAGCTGACCGTTAGCT,53,1930914
ihfAp4,1.3,21,9,ACCGATCATCCGGCTTATTC,12,1942697
ihfAp4,1.4,22,9,ACCAATTCTCATATTACCGG,13,1933128
ihfAp4,2.0,28,9,ACATTTCGCGTGCAATTAGT,19,1942883
ihfAp4,0.3,11,9,ACATCTAAGCGCCGTACGAG,2,1915363
ihfAp4,2.3,31,9,ACAGCCTACGATTCCGGGCG,22,1937729
ihfAp4,1.1,19,9,ACACGTGTTAGAGCTTCTCG,10,1950848
ihfAp4,0.2,10,9,ACACAGGTCCGTTCCTTACT,1,1912267
ihfAp4,2.8,36,9,ACACACCTATAGGTGGAACA,27,1938582
ihfAp4,2.2,30,9,AATTATCCGGAGCTAGCTCA,21,1942958
ihfAp4,2.2,30,9,AATGCCATATCTTCACTGTC,21,1959616
ihfAp4,1.9,27,9,AATGAATCTCGATGGCGAGA,18,1922529
ihfAp4,5.9,67,9,AATGAATCCGACCAGGTAGA,58,1929203
ihfAp4,2.6,34,9,AATCTTCGTGTTGGACTAAA,25,1921451
ihfAp4,6.9,77,9,AAGTAAAGTGCAATGAGGGA,68,1944455
ihfAp4,3.4,42,9,AAGCGTTCCTTATCAAACCA,33,1942474
ihfAp4,1.9,27,9,AAGCGCATGCATGATTTTGC,18,1934478
ihfAp4,2.7,35,9,AAGCATTGTAAGACCGTGTG,26,1958853
ihfAp4,4.7,55,9,AAGCATTGACTCTCCACGCG,46,1946682
ihfAp4,4.9,57,9,AAGAATAGCCACTCCTAAGT,48,1914193
ihfAp4,5.5,63,9,AACGCCTTGTGAAGCAAGTA,54,1932842
ihfAp4,2.4,32,9,AACCCGAGCAGCGGGCTGTT,23,1954234
ihfAp4,7.1,79,9,AACCAGAAGGTGAAGTTAGC,70,1934978
ihfAp4,0.2,10,9,AACAGCGGCTATGCAGTTTG,1,1954360
ihfAp4,0.2,10,9,AAATGAGCTGATCGTTAAGA,1,1917775
ihfAp4,4.6,54,9,AAAGGTGCCCGCGCAATCGT,45,1961338
ihfAp4,3.6,44,9,AAAGCTCGGGGGAGCGGGTT,35,1925022
ihfAp4,0.9,17,9,AAACTTATATCTGGAATAGC,8,1914966
ihfAp4,2.5,33,9,AAAAAAGTAGGGGACCACGG,24,1922728
ihfAp4,2.2222222222222223,27,8,TTTTGATTTGAGATGCCGTT,19,1916581
ihfAp4,3.7777777777777777,41,8,TTTGGGTAGCTCTGTATATA,33,1956872
ihfAp4,2.111111111111111,26,8,TTTCGCTGACCTTTTTCCAG,18,1943435
ihfAp4,2.3333333333333335,28,8,TTTCCATGGTCTTCATGGCT,20,1946182
ihfAp4,1.7777777777777777,23,8,TTTATTCCTGTCACCTTATA,15,1956109
ihfAp4,1.7777777777777777,23,8,TTTACTGGAAGTGGGCGCTA,15,1942094
ihfAp4,4.777777777777778,50,8,TTGTAGAAGCAAGAGGAATT,42,1950997
ihfAp4,1.4444444444444444,20,8,TTGCTGTCTGAAGCGGTATT,12,1950614
ihfAp4,2.6666666666666665,31,8,TTGATTCAGTGATCCAGTTT,23,1930147
ihfAp4,4.444444444444445,47,8,TTCGTCCTGGGCCGCTTATA,39,1942699
ihfAp4,1.5555555555555556,21,8,TTCGTCCTATAAATAAACCC,13,1951436
ihfAp4,0.7777777777777778,14,8,TTCGCCAGCATTTTCTTGTA,6,1957242
ihfAp4,1.5555555555555556,21,8,TTATATTTAGAGGGACCAGC,13,1935909
ihfAp4,0.7777777777777778,14,8,TTATAACATGGGTAATCAAC,6,1941025
ihfAp4,1.2222222222222223,18,8,TTAGGTCGCATGAAACGGCC,10,1921637
ihfAp4,1.6666666666666667,22,8,TTAGACAAGAGCAGTTTTAT,14,1925144
ihfAp4,3.6666666666666665,40,8,TTACCGCGACTTCTAGGCTA,32,1912773
ihfAp4,1.1111111111111112,17,8,TTAATCCACATCCCAGGCTA,9,1914313
ihfAp4,1.4444444444444444,20,8,TGTTACACCAATTCGTGAGT,12,1919563
ihfAp4,3.3333333333333335,37,8,TGTCGCAGTAGGCCGTACAC,29,1941166
ihfAp4,2.888888888888889,33,8,TGTCAACGGTCCTCACTGTA,25,1921118
ihfAp4,6.333333333333333,64,8,TGGTTTTCCTCTATTGTTGT,56,1938076
ihfAp4,4.444444444444445,47,8,TGGTCGTAAGACTACCTGGA,39,1940750
ihfAp4,3.6666666666666665,40,8,TGGTAGATGCTGTCTCCAGC,32,1929398
ihfAp4,12.222222222222221,117,8,TGGCGGGACAACCCGCATTA,109,1944471
ihfAp4,2.888888888888889,33,8,TGGACTTGAGAATACGTGAC,25,1935266
ihfAp4,0.2222222222222222,9,8,TGGACGAGTAGATCTCTTAT,1,1943787
ihfAp4,0.3333333333333333,10,8,TGGAAATCCGTCAGAGAGAG,2,1943996
ihfAp4,0.3333333333333333,10,8,TGCTGCCGAGCAATACCTCC,2,1932604
ihfAp4,3.6666666666666665,40,8,TGCTCGTTCGCTGATCCATA,32,1932343
ihfAp4,5.333333333333333,55,8,TGCTCCCTTTATTAAAAAGT,47,1915257
ihfAp4,1.0,16,8,TGCGGGGCGTATAACTTCCA,8,1914453
ihfAp4,3.4444444444444446,38,8,TGCCGATGGCGGCCATTAAC,30,1924512
ihfAp4,2.888888888888889,33,8,TGCAAAGCAGAAATCACTAC,25,1911315
ihfAp4,3.2222222222222223,36,8,TGAGGTTCTCGAATTGTATG,28,1935932
ihfAp4,0.2222222222222222,9,8,TGAGACATGTCTGGGCACGA,1,1950072
ihfAp4,1.6666666666666667,22,8,TGACGCCGCTCTACCCCGGT,14,1937587
ihfAp4,1.6666666666666667,22,8,TGACCACTGCGCCCAAGTAC,14,1917912
ihfAp4,11.777777777777779,113,8,TCTTTCATGTTACATGAGAT,105,1936498
ihfAp4,2.3333333333333335,28,8,TCTTGCAAGCCGCACTAGAA,20,1933122
ihfAp4,6.888888888888889,69,8,TCTGGCAAAATAGGCCCAAG,61,1961525
ihfAp4,0.2222222222222222,9,8,TCGTGCAGTTTGCTGATTAA,1,1915883
ihfAp4,11.666666666666666,112,8,TCGTCCCCCTTGTTAATTGT,104,1915776
ihfAp4,5.888888888888889,60,8,TCGTAGATCCAGGTCTAATT,52,1921343
ihfAp4,2.5555555555555554,30,8,TCGGCATCAAGGGGCGTGCA,22,1938045
ihfAp4,2.3333333333333335,28,8,TCGGCAGATGGGAAGTGCAA,20,1939782
ihfAp4,0.2222222222222222,9,8,TCGAATCGACTCTGCTCCCA,1,1947054
ihfAp4,2.2222222222222223,27,8,TCCCGCCCTAATATCGCTAT,19,1949337
ihfAp4,0.2222222222222222,9,8,TCCATCACCGAGGATTGCCT,1,1950548
ihfAp4,1.4444444444444444,20,8,TCCATAAAGCAGTTGCATGT,12,1945425
ihfAp4,1.6666666666666667,22,8,TCATTGGCTGAGTAGTTATC,14,1920156
ihfAp4,1.5555555555555556,21,8,TCATGCAACTGCACGCGACT,13,1941393
ihfAp4,3.2222222222222223,36,8,TCAAGGGGAACTGGTGCGGG,28,1916887
ihfAp4,1.4444444444444444,20,8,TATTGGTGCGGAAACCGACG,12,1914567
ihfAp4,2.3333333333333335,28,8,TATGTTTGATATTAGTAGAA,20,1950921
ihfAp4,4.222222222222222,45,8,TATCCATGGCAACCTGTAGA,37,1942998
ihfAp4,0.8888888888888888,15,8,TATCACGCTAGGCATCGGTC,7,1929601
ihfAp4,2.5555555555555554,30,8,TATACTGGACTCCCTCACAA,22,1944991
ihfAp4,6.444444444444445,65,8,TAGGTAATAATCCCGTAGAA,57,1943993
ihfAp4,2.4444444444444446,29,8,TACTCCGAAATGCCTTGGGA,21,1919790
ihfAp4,2.7777777777777777,32,8,TACGTTGGCTGGGCTGGACT,24,1914996
ihfAp4,2.6666666666666665,31,8,TACACCTAAATAGCCCTGTG,23,1944114
ihfAp4,2.5555555555555554,30,8,TAATGTGGCCGACGTTGTGG,22,1936514
ihfAp4,3.3333333333333335,37,8,TAACGGATGGATCTGACATT,29,1954918
ihfAp4,2.3333333333333335,28,8,GTTTTAGGCTAATCATTAGA,20,1939470
ihfAp4,2.2222222222222223,27,8,GTTTGTTTGGCTTATCGACC,19,1940286
ihfAp4,0.2222222222222222,9,8,GTTGAGTCAGTGTGGCCTAA,1,1955484
ihfAp4,4.888888888888889,51,8,GTTCGGCCACTGTTCCTAGT,43,1953482
ihfAp4,4.777777777777778,50,8,GTTCGAGCTGTCCCCTCTGG,42,1921242
ihfAp4,2.888888888888889,33,8,GTTATGGGCTGCCGAATAAG,25,1911035
ihfAp4,2.2222222222222223,27,8,GTTACCGGCGTATCGGTGCT,19,1946099
ihfAp4,0.4444444444444444,11,8,GTGTGAGGGTAACCGGTTAT,3,1934344
ihfAp4,1.7777777777777777,23,8,GTGTACATGCACCCGGGGCT,15,1914137
ihfAp4,2.888888888888889,33,8,GTGGAATCCGAGTACCGACG,25,1933123
ihfAp4,1.5555555555555556,21,8,GTGCTGGAGGCTGATGATCG,13,1941258
ihfAp4,3.2222222222222223,36,8,GTGAGGGGACTTGCAAGGGA,28,1911934
ihfAp4,1.1111111111111112,17,8,GTGAGCTGTGAAAGCGTGAG,9,1934358
ihfAp4,2.4444444444444446,29,8,GTCTAGACTCCAGCGGCATA,21,1957697
ihfAp4,4.444444444444445,47,8,GTCGTCCTTACAGGCATCTT,39,1957743
ihfAp4,6.111111111111111,62,8,GTCGGCATCCACCAACAGAG,54,1934024
ihfAp4,3.0,34,8,GTCGCCCGCAATGAGAGTAG,26,1940247
ihfAp4,11.88888888888889,114,8,GTCCCCCCGAGTACGTCATG,106,1961524
ihfAp4,0.7777777777777778,14,8,GTCATGTTTGTCACTTATGA,6,1918047
ihfAp4,3.3333333333333335,37,8,GTCATGATTGATAAATGATC,29,1961584
ihfAp4,2.6666666666666665,31,8,GTCAGGGTGAACGAGTATAT,23,1928907
ihfAp4,0.2222222222222222,9,8,GTCAGGAGGTGGGCTCGAAA,1,1926278
ihfAp4,1.0,16,8,GTAGGGCCTGATGCTAGGGC,8,1913334
ihfAp4,0.2222222222222222,9,8,GTAGCATAGTCTCAAGGACC,1,1934672
ihfAp4,5.888888888888889,60,8,GTACGGTAGAGTTATTGGAA,52,1951777
ihfAp4,3.6666666666666665,40,8,GTAAGCTGTGATATTTGTCG,32,1922876
ihfAp4,1.2222222222222223,18,8,GTAAACCAAAAAAAATAAGA,10,1946449
ihfAp4,3.3333333333333335,37,8,GGTGTTTGCAGTCGGCCAGT,29,1956811
ihfAp4,4.888888888888889,51,8,GGTCGTTCCTCTCCCGTAGA,43,1912254
ihfAp4,4.777777777777778,50,8,GGTATTAAGGTTTGTGCCGT,42,1944457
ihfAp4,3.0,34,8,GGGTTCGGGTCGCGAAGACA,26,1938750
ihfAp4,5.222222222222222,54,8,GGGTCGCATAAACAACCTCA,46,1949447
ihfAp4,3.4444444444444446,38,8,GGGGTAACGAATCAGAAAAC,30,1934360
ihfAp4,4.111111111111111,44,8,GGGGACCACTGACCCAATGG,36,1914420
ihfAp4,3.6666666666666665,40,8,GGGCTTATATGCACGAAAAG,32,1957858
ihfAp4,7.888888888888889,78,8,GGGCCTATGGCATAAAAACG,70,1927931
ihfAp4,4.222222222222222,45,8,GGGCCGCTGAGAGAGTGAGG,37,1924822
ihfAp4,4.222222222222222,45,8,GGGATGCATCAAGATGCAGG,37,1954733
ihfAp4,4.333333333333333,46,8,GGGATCGTGATCGATGCTGT,38,1916461
ihfAp4,0.8888888888888888,15,8,GGGATCAAGTACCATTTACA,7,1926207
ihfAp4,0.8888888888888888,15,8,GGGAGTGAAACGTGACCTCA,7,1957780
ihfAp4,1.3333333333333333,19,8,GGGAGCTCTCTAGTGGGCGG,11,1951607
ihfAp4,2.3333333333333335,28,8,GGCGCCGAAATTTAGAAGTG,20,1926812
ihfAp4,3.6666666666666665,40,8,GGCCGCCTATCGGGTAAAGA,32,1935749
ihfAp4,3.2222222222222223,36,8,GGATGTGCGTTACGACGGGG,28,1939103
ihfAp4,2.111111111111111,26,8,GGAGGGTTCTAGGAGGGTTA,18,1952638
ihfAp4,1.5555555555555556,21,8,GGACTGACGACCCCTCCTGT,13,1938935
ihfAp4,3.888888888888889,42,8,GGACGTTACAATAGAGTTGG,34,1947468
ihfAp4,2.7777777777777777,32,8,GGACCTTAATGCGGAGTGGG,24,1925453
ihfAp4,0.2222222222222222,9,8,GGAACGCCATAATGAGTTCT,1,1942055
ihfAp4,1.3333333333333333,19,8,GCTTCTCCAATCTGAATGAT,11,1939734
ihfAp4,0.8888888888888888,15,8,GCTTCGTTCGCGAGTATTAT,7,1917028
ihfAp4,0.5555555555555556,12,8,GCTGGCCTGTCTCAAAGTAA,4,1950638
ihfAp4,2.0,25,8,GCTGCGTGCGGCATAACTCT,17,1916757
ihfAp4,2.888888888888889,33,8,GCTCTAGGCCATCGTGATAC,25,1909630
ihfAp4,0.2222222222222222,9,8,GCTATCGGCGTGCAGCAGTC,1,1960332
ihfAp4,2.0,25,8,GCTACCCAGGTGTGCAAAAA,17,1943076
ihfAp4,1.1111111111111112,17,8,GCTAAGGTCAGTTACGGGCA,9,1959656
ihfAp4,6.0,61,8,GCGTCGTGCTGGCGGCATCG,53,1940103
ihfAp4,0.2222222222222222,9,8,GCGGGATTAGCGGATACAGA,1,1959780
ihfAp4,3.2222222222222223,36,8,GCGCGGCAAGAGCGTACCGT,28,1947537
ihfAp4,2.6666666666666665,31,8,GCGCCGTCGATCTCCATCTG,23,1956500
ihfAp4,1.1111111111111112,17,8,GCGCATCCTCTCGTATGTAG,9,1951110
ihfAp4,2.0,25,8,GCGACGAACTCAGCCACATG,17,1914018
ihfAp4,1.5555555555555556,21,8,GCCGGCTTAATTGCCGATCT,13,1956013
ihfAp4,4.0,43,8,GCCGCCCGGGGATTCGACGA,35,1915048
ihfAp4,3.111111111111111,35,8,GCCAGAACGTCTAATGCCTG,27,1958224
ihfAp4,2.0,25,8,GCATTAGTCAATTACATATC,17,1915075
ihfAp4,1.8888888888888888,24,8,GCATCAGACACGCAATTGGG,16,1915265
ihfAp4,1.7777777777777777,23,8,GCATATCGGAAGGCAGGTAC,15,1919044
ihfAp4,2.4444444444444446,29,8,GCAATTGACTAGTAAATACA,21,1919617
ihfAp4,1.5555555555555556,21,8,GCAAAGATAAGTTGGTGACT,13,1928178
ihfAp4,1.5555555555555556,21,8,GATTAGCAGAGCAAACTGTT,13,1941178
ihfAp4,0.5555555555555556,12,8,GATGTTATGTAAGTCGGCAA,4,1948418
ihfAp4,3.7777777777777777,41,8,GATGGATTGGATTAACCAAC,33,1922881
ihfAp4,2.6666666666666665,31,8,GATGCTATGTACGCAAGCAT,23,1947276
ihfAp4,5.555555555555555,57,8,GATGCCGCGTTCACGTAGTC,49,1956229
ihfAp4,3.888888888888889,42,8,GATGCCCGTCTGGTCCAATA,34,1923560
ihfAp4,2.2222222222222223,27,8,GAGTTGGTTTAGGTGATAGT,19,1924216
ihfAp4,0.4444444444444444,11,8,GAGTGACGTGGAGTTGGTCT,3,1911209
ihfAp4,6.777777777777778,68,8,GAGTATATGTGTCTTGTCGC,60,1938572
ihfAp4,6.666666666666667,67,8,GAGGACCGTCGTTCACGGGG,59,1937793
ihfAp4,2.6666666666666665,31,8,GAGCCGGCACTCTGTGATTG,23,1913294
ihfAp4,1.0,16,8,GAGCAGGGGATTATTTTAAG,8,1949463
ihfAp4,1.5555555555555556,21,8,GAGATGTACAAGGTTGCACT,13,1921130
ihfAp4,3.3333333333333335,37,8,GAGATAGCGCGGCGGAACGC,29,1953623
ihfAp4,0.2222222222222222,9,8,GACTTTTAGCCTTGTGGGAT,1,1945040
ihfAp4,8.333333333333334,82,8,GACTACGGCGTGAACTAACA,74,1943288
ihfAp4,3.7777777777777777,41,8,GACCTACCGCGAAGCTGTCA,33,1959657
ihfAp4,3.0,34,8,GACCAAGTTGTTACCCACGT,26,1924143
ihfAp4,1.0,16,8,GAAGCGATACATTTGGCGAC,8,1940471
ihfAp4,0.4444444444444444,11,8,CTTGCTGTGAAACCTGTATG,3,1916036
ihfAp4,4.0,43,8,CTTGCTCGTGCCTGCGTCAT,35,1946271
ihfAp4,1.0,16,8,CTTCTGTAAGGTTTGTATCT,8,1956687
ihfAp4,1.8888888888888888,24,8,CTTCGGGGACGCTTACAAGA,16,1950043
ihfAp4,0.2222222222222222,9,8,CTTCGACGAACACACGTACT,1,1944692
ihfAp4,2.4444444444444446,29,8,CTTAGTAAGGCATCCGGGGT,21,1948674
ihfAp4,8.333333333333334,82,8,CTGTGCATGGGACAACATGC,74,1915649
ihfAp4,3.111111111111111,35,8,CTGGCAGTCCAGCTCTGACG,27,1927433
ihfAp4,5.888888888888889,60,8,CTGCGAAGTACTTATGGGAT,52,1913823
ihfAp4,7.666666666666667,76,8,CTGCAACTGCCGCGCGGAGA,68,1961015
ihfAp4,1.2222222222222223,18,8,CTGAGTAGACCTTAGGTCCC,10,1917418
ihfAp4,2.7777777777777777,32,8,CTGAGCAATCATCTCCACAA,24,1924812
ihfAp4,3.3333333333333335,37,8,CTCTCCCGACAACAACACGC,29,1949363
ihfAp4,1.0,16,8,CTCTAGAACAGCGTTGAATA,8,1912533
ihfAp4,3.2222222222222223,36,8,CTCCTGCTTTTGATCTGTTA,28,1955469
ihfAp4,1.1111111111111112,17,8,CTCAGAACTTGGTCAGGCGG,9,1935432
ihfAp4,1.4444444444444444,20,8,CTCAACCTCATACGGCCACT,12,1958558
ihfAp4,0.7777777777777778,14,8,CTATGGTTAACTTACGGTGC,6,1915491
ihfAp4,0.2222222222222222,9,8,CTAGTCTTTGCTAGCAACAC,1,1924587
ihfAp4,1.6666666666666667,22,8,CTAGTATTACGGTAACGCGG,14,1931330
ihfAp4,2.3333333333333335,28,8,CTAGCGTCAGGATTTCTACA,20,1942769
ihfAp4,7.111111111111111,71,8,CTAGAAAGGTTGCCGAGGAG,63,1944927
ihfAp4,2.6666666666666665,31,8,CTACTGGTTGCAGGATTGCT,23,1924373
ihfAp4,1.2222222222222223,18,8,CTACGACCTCCGGTGGTATC,10,1931399
ihfAp4,4.111111111111111,44,8,CTACGAACAAGAGATCAGTA,36,1937577
ihfAp4,0.3333333333333333,10,8,CTAACGCGAGATTCTTACAC,2,1927860
ihfAp4,1.8888888888888888,24,8,CTAAAATAGTATGTCTGAAG,16,1959156
ihfAp4,1.3333333333333333,19,8,CGTTTTCCTGGGCAATCGTC,11,1929522
ihfAp4,0.2222222222222222,9,8,CGTTTCGTGATATTGGAACA,1,1949540
ihfAp4,1.6666666666666667,22,8,CGTTTACTAAGGTCAACAAT,14,1954276
ihfAp4,5.777777777777778,59,8,CGTTGTGCACCTGTCCTGAA,51,1956103
ihfAp4,1.3333333333333333,19,8,CGTTGGACGTGTGACCTCAT,11,1934643
ihfAp4,8.333333333333334,82,8,CGTGAAATAGGAACTGAGGG,74,1938890
ihfAp4,0.6666666666666666,13,8,CGTCTGAGTAGACGAAGGCC,5,1943318
ihfAp4,3.6666666666666665,40,8,CGGTAATTGTTTTCTCCAAG,32,1926073
ihfAp4,11.222222222222221,108,8,CGGTAACCGGGGCGCTCTAG,100,1945402
ihfAp4,3.0,34,8,CGGGTATTCCCTATCGTCGT,26,1948389
ihfAp4,2.3333333333333335,28,8,CGGGCGGACGAAATCTCAAA,20,1922035
ihfAp4,0.5555555555555556,12,8,CGGGCCTGGTGAACATGCGA,4,1953214
ihfAp4,4.444444444444445,47,8,CGGGCATGTATAACCTAAAA,39,1927567
ihfAp4,3.111111111111111,35,8,CGGATCCGGATGACCTAGGC,27,1911643
ihfAp4,0.7777777777777778,14,8,CGCTTCAAAAACGAATAGGG,6,1920145
ihfAp4,1.3333333333333333,19,8,CGCTATATCAACGGCCATAG,11,1944367
ihfAp4,1.1111111111111112,17,8,CGCGGTTGTGAAGCCCACTG,9,1953484
ihfAp4,7.222222222222222,72,8,CGCGACCTGGTACAAGCGAA,64,1917682
ihfAp4,0.7777777777777778,14,8,CGCCGATCGGTTTTTCATAA,6,1921878
ihfAp4,1.5555555555555556,21,8,CGCACATACGACGTTCCGGA,13,1925129
ihfAp4,1.4444444444444444,20,8,CGATGATACAGCACCAGTGA,12,1959040
ihfAp4,0.2222222222222222,9,8,CGATCGTATTAATACAGGAG,1,1912353
ihfAp4,2.0,25,8,CGAGGCGCACGGCCGGCCGT,17,1957972
ihfAp4,3.111111111111111,35,8,CGACTGGTACGGTGACTGTT,27,1924601
ihfAp4,4.222222222222222,45,8,CGACCCTCGGACGGTCGTGA,37,1943527
ihfAp4,0.4444444444444444,11,8,CGAATCTGCCCCTGAGTATG,3,1960550
ihfAp4,1.4444444444444444,20,8,CGAAGACTATCGTGGGCCAG,12,1913298
ihfAp4,2.6666666666666665,31,8,CGAAAGTACAAGTGATGGTT,23,1940919
ihfAp4,0.3333333333333333,10,8,CCTTAGTATGCCGGTAACAT,2,1954659
ihfAp4,1.4444444444444444,20,8,CCTGTAGGTCTTCCAGCCTC,12,1945958
ihfAp4,0.2222222222222222,9,8,CCTGGTCACGGTATGGCTAT,1,1957057
ihfAp4,0.6666666666666666,13,8,CCTCCCGGGTCGGTAGACAT,5,1913098
ihfAp4,0.4444444444444444,11,8,CCTCCATGTCGGAATGCTTG,3,1934569
ihfAp4,3.4444444444444446,38,8,CCTAGGGGGGCGGAGCCTCT,30,1924215
ihfAp4,8.11111111111111,80,8,CCGTAGTGTAGTCCAAGCGT,72,1919280
ihfAp4,2.2222222222222223,27,8,CCGCAGGAGCCTTGGGTCGC,19,1942398
ihfAp4,2.5555555555555554,30,8,CCCCCTCTGCCGCACTCATT,22,1932721
ihfAp4,3.111111111111111,35,8,CCCAGTTCCGCGGGTATCTG,27,1931742
ihfAp4,0.8888888888888888,15,8,CCCAGTCAGTGATGTGCGCG,7,1954261
ihfAp4,3.5555555555555554,39,8,CCCACATGTCTGAGACTAAA,31,1925390
ihfAp4,3.2222222222222223,36,8,CCCAATCGAAACCTCCGCCT,28,1956267
ihfAp4,5.555555555555555,57,8,CCAGTCTGAGTGAGCGGCGC,49,1960073
ihfAp4,1.8888888888888888,24,8,CCAGCACCGTCTTCGATCAC,16,1909641
ihfAp4,1.6666666666666667,22,8,CCACCAGATTTTCTCGAACA,14,1937177
ihfAp4,2.2222222222222223,27,8,CATTGTGCGTTCCCTCGAAG,19,1935626
ihfAp4,1.5555555555555556,21,8,CATTCGCGACTCTGGGTGCC,13,1931070
ihfAp4,1.5555555555555556,21,8,CATGCTCTAACTTCGCCCGT,13,1930737
ihfAp4,2.4444444444444446,29,8,CATCTTTGTGACAGGTAACA,21,1949446
ihfAp4,4.777777777777778,50,8,CATAGCAGGAGAAGGTACGT,42,1958077
ihfAp4,2.111111111111111,26,8,CAGTTTAGGCCTCCCCCGGT,18,1960085
ihfAp4,3.111111111111111,35,8,CAGTCCGAGCCCTCTAGGTA,27,1932906
ihfAp4,2.111111111111111,26,8,CAGGGTAACTTGCATGTGTA,18,1950003
ihfAp4,1.0,16,8,CAGGCGCTCCAATATAAGGC,8,1960777
ihfAp4,5.222222222222222,54,8,CAGGCCACAAATCGTATCGG,46,1928872
ihfAp4,9.11111111111111,89,8,CACTCCACCCTGTCGGTGTC,81,1913340
ihfAp4,4.888888888888889,51,8,CACTATAATAGCAGACGAGC,43,1958011
ihfAp4,2.888888888888889,33,8,CACGTCGTTATAGCGCTCAG,25,1925660
ihfAp4,4.0,43,8,CACGTCACGACATCCCTTAG,35,1924446
ihfAp4,2.7777777777777777,32,8,CACGCGCATTCGGTGTTACT,24,1953024
ihfAp4,2.6666666666666665,31,8,CACGACCGTTGTTCGAAATC,23,1923116
ihfAp4,2.3333333333333335,28,8,CACCTCGAGATAACTATCAT,20,1946560
ihfAp4,4.333333333333333,46,8,CACCTCACCCTTTAACGTAC,38,1930278
ihfAp4,0.2222222222222222,9,8,CACCAGCGGAATAACTTCGA,1,1928495
ihfAp4,0.7777777777777778,14,8,CACAGCCTAAGTTGTTTATC,6,1933232
ihfAp4,2.888888888888889,33,8,CAATTTGACCGTTGGTCACA,25,1923719
ihfAp4,0.7777777777777778,14,8,CAAGGTGTTCGGGGCAGCTT,6,1952855
ihfAp4,4.555555555555555,48,8,CAACAAGTCTCTTAAATTTC,40,1926261
ihfAp4,2.2222222222222223,27,8,ATTTCATAAGCTCTTGGCAA,19,1929993
ihfAp4,3.7777777777777777,41,8,ATTTAATGTTTTTTTCGTAT,33,1934951
ihfAp4,3.5555555555555554,39,8,ATTCGCCCTGCTAGTGACTA,31,1948391
ihfAp4,2.2222222222222223,27,8,ATGGCAGTCGCGGACTTCGT,19,1959561
ihfAp4,8.88888888888889,87,8,ATGAGAGTATGGGTACGATT,79,1953489
ihfAp4,6.0,61,8,ATCGTTCACCAGCAGACGGT,53,1928407
ihfAp4,1.5555555555555556,21,8,ATCATCCGCATCAACAAGTC,13,1934316
ihfAp4,4.444444444444445,47,8,ATATGCCAAAACTCTTGGAG,39,1933788
ihfAp4,2.3333333333333335,28,8,ATATCGAGCGGGCTAGTTCA,20,1921719
ihfAp4,0.2222222222222222,9,8,ATATATGGGCTGACCCTTAT,1,1923644
ihfAp4,7.444444444444445,74,8,ATAGTCGTCCTCAAGGGCGC,66,1926235
ihfAp4,0.2222222222222222,9,8,ATAGGAGGTCCGCCCCATAA,1,1949977
ihfAp4,0.2222222222222222,9,8,ATACTTCAGGTCATACGGTC,1,1959005
ihfAp4,3.3333333333333335,37,8,ATACTGATTCCGAAGAGAAG,29,1921625
ihfAp4,3.3333333333333335,37,8,ATAAAGACGCTATTTGCGGA,29,1948958
ihfAp4,2.4444444444444446,29,8,AGTTCGGTTCCCTAACCCAT,21,1920127
ihfAp4,0.7777777777777778,14,8,AGTGTCAATCAACGTTACGA,6,1947990
ihfAp4,3.0,34,8,AGTGTAGGGTATGGCAAGCT,26,1926169
ihfAp4,2.3333333333333335,28,8,AGTCTAACGTTTAACGTTGA,20,1924457
ihfAp4,1.2222222222222223,18,8,AGTACCGCGAAAAAGGGGCA,10,1959798
ihfAp4,8.555555555555555,84,8,AGGTTTGCCCCCTTGCTGTT,76,1953170
ihfAp4,0.2222222222222222,9,8,AGGTCGCTAGCAGCATCCAC,1,1939342
ihfAp4,0.2222222222222222,9,8,AGGGTTAATACCTCCTACAT,1,1944358
ihfAp4,1.1111111111111112,17,8,AGGGCAAATACTGATTGGCG,9,1953683
ihfAp4,2.4444444444444446,29,8,AGGGAATTTACTATTATCGC,21,1943302
ihfAp4,2.111111111111111,26,8,AGGCTTCCGGGCAGGTGCTT,18,1956654
ihfAp4,3.4444444444444446,38,8,AGGATTTAAGTCGGCAGCTT,30,1959983
ihfAp4,3.4444444444444446,38,8,AGGACCAAAGCCCACCGCCG,30,1921101
ihfAp4,5.555555555555555,57,8,AGCTGGTTCCCGGATCAGCA,49,1910575
ihfAp4,1.8888888888888888,24,8,AGCTGCTTCCAAGCTAACGC,16,1933816
ihfAp4,1.2222222222222223,18,8,AGCTCAGAGGGACTTCCGGG,10,1911792
ihfAp4,3.4444444444444446,38,8,AGCGTCTGTACATATTGATT,30,1959208
ihfAp4,11.444444444444445,110,8,AGCGGATCATCGCTCCTCCT,102,1929693
ihfAp4,0.2222222222222222,9,8,AGCGCTTGATTCTATCCATG,1,1918301
ihfAp4,0.8888888888888888,15,8,AGCCTCAGAGAGGCATATGG,7,1927315
ihfAp4,1.3333333333333333,19,8,AGATCGAGCCCTTCGACGCT,11,1953190
ihfAp4,1.7777777777777777,23,8,AGAGAAAAGTCAGTCCCGGG,15,1950838
ihfAp4,5.444444444444445,56,8,AGACATGGTATGTCTCCCCC,48,1949924
ihfAp4,2.7777777777777777,32,8,AGAACCGGGACCTTCCCATG,24,1943651
ihfAp4,7.222222222222222,72,8,ACTTGGCAGAGCACAGAAGC,64,1938376
ihfAp4,4.555555555555555,48,8,ACTTAGCACACACTTCGTCT,40,1934242
ihfAp4,0.7777777777777778,14,8,ACTTACGGATCATAGTATGT,6,1956922
ihfAp4,0.5555555555555556,12,8,ACTTAATGATTTCGCCCCCA,4,1925655
ihfAp4,3.0,34,8,ACTGTGAGAAAACCGGAAGG,26,1958712
ihfAp4,3.4444444444444446,38,8,ACTGGTGGCTGTCTGAGCTT,30,1933684
ihfAp4,0.2222222222222222,9,8,ACTCTCCTTCGGATCGTTTC,1,1946523
ihfAp4,3.5555555555555554,39,8,ACTCTAGGCCCACGTCCTTC,31,1924213
ihfAp4,3.111111111111111,35,8,ACTCCAACCGATGTTGTTAC,27,1918498
ihfAp4,1.5555555555555556,21,8,ACTATTCTTCATAAGAATGC,13,1935804
ihfAp4,2.0,25,8,ACTATCATTAGTCATGGAAG,17,1960924
ihfAp4,3.888888888888889,42,8,ACTACTATGATAAACATGGT,34,1927776
ihfAp4,3.7777777777777777,41,8,ACGGGTTAGTTTAGTCAAGA,33,1937666
ihfAp4,1.4444444444444444,20,8,ACGCGGCGAATCAGCCCGGA,12,1924467
ihfAp4,1.4444444444444444,20,8,ACGATTTGGGTTCCGTTCAC,12,1922662
ihfAp4,1.8888888888888888,24,8,ACCTTCATCATCGCAGTGCA,16,1955921
ihfAp4,2.4444444444444446,29,8,ACCGTGTGAACTATAGGTGT,21,1919878
ihfAp4,2.6666666666666665,31,8,ACCGTACTAAGTGAGTGCAA,23,1935469
ihfAp4,3.111111111111111,35,8,ACCGATTGGAACGGGGGGTG,27,1911118
ihfAp4,2.4444444444444446,29,8,ACCCAAAATGGCACCCCCAC,21,1925240
ihfAp4,2.7777777777777777,32,8,ACCAGTCACATTTTACGTTG,24,1934689
ihfAp4,0.2222222222222222,9,8,ACCAAAGTACCAGGCTTCAC,1,1950482
ihfAp4,3.6666666666666665,40,8,ACAGTGGCATGCTGTACGTA,32,1947916
ihfAp4,2.888888888888889,33,8,ACAGCAAAGTCAGAAACATT,25,1950139
ihfAp4,0.7777777777777778,14,8,ACAGATGAGACCCCATCGCT,6,1949285
ihfAp4,1.5555555555555556,21,8,ACACTTCAACAGCCTTTCCT,13,1930153
ihfAp4,7.444444444444445,74,8,ACAATGCGAGTTACGTTTTA,66,1954474
ihfAp4,3.111111111111111,35,8,ACAATCTTACTCCTTATGCG,27,1940616
ihfAp4,3.0,34,8,ACAAGAGACGAGGGTTGAAC,26,1912951
ihfAp4,0.6666666666666666,13,8,AATTATAACCAATACTCAGT,5,1955897
ihfAp4,3.3333333333333335,37,8,AATGTGATGATTACATAAGT,29,1957074
ihfAp4,4.111111111111111,44,8,AATGTCGTGAGAGTCCTTGG,36,1959832
ihfAp4,1.8888888888888888,24,8,AATCGGGCAATGAGGTAACA,16,1910548
ihfAp4,3.2222222222222223,36,8,AATAGTACTTTACAGCCTCC,28,1943715
ihfAp4,0.6666666666666666,13,8,AAGTGCCATCATATAGCGAT,5,1950222
ihfAp4,3.111111111111111,35,8,AAGTCCACAGGCCCAGCGGA,27,1956579
ihfAp4,3.111111111111111,35,8,AAGGTATCCTCCATCACGAT,27,1956861
ihfAp4,6.333333333333333,64,8,AAGCTTGGCGTCTTATCGGA,56,1915273
ihfAp4,6.222222222222222,63,8,AAGCTGTGATAACTGTATCA,55,1949165
ihfAp4,3.888888888888889,42,8,AAGCTAGGTGGCCCGAACTC,34,1910210
ihfAp4,3.2222222222222223,36,8,AAGCGTTCCAGCCTCACAAC,28,1926454
ihfAp4,2.888888888888889,33,8,AAGCGACCCAACAGGCGATG,25,1910812
ihfAp4,1.2222222222222223,18,8,AAGATTATTAATCCTATTCA,10,1909574
ihfAp4,4.222222222222222,45,8,AACCAACCTACATGTAAGTT,37,1944027
ihfAp4,2.0,25,8,AACCAACAAAAAAAATAAAG,17,1933532
ihfAp4,2.0,25,8,AACAGTTTTAGTCAACGCAG,17,1915097
ihfAp4,3.6666666666666665,40,8,AAATACACACGAGCTACGGC,32,1936437
ihfAp4,1.0,16,8,AAAGGACCATTCCGCACTGG,8,1934322
ihfAp4,2.888888888888889,33,8,AAACGGTCATGCGCTAACCT,25,1934697
ihfAp4,2.5,26,7,TTTGTGAGTTAACCGTTGAT,19,1909831
ihfAp4,2.375,25,7,TTTGGCAGCTGGCTCGTATA,18,1936323
ihfAp4,2.25,24,7,TTTGCCAAAGTAGTGTGCCT,17,1926602
ihfAp4,9.125,79,7,TTTGACAGCGCGGTCCTGTG,72,1952523
ihfAp4,3.125,31,7,TTTACGCATGCTACTCCTCC,24,1953936
ihfAp4,2.625,27,7,TTGTTTCGGCCGGAGTCGCA,20,1941398
ihfAp4,0.25,8,7,TTGTAAGGCAGTCAGTTAAA,1,1949620
ihfAp4,10.25,88,7,TTGGAGGCACTAATGTGCTG,81,1923499
ihfAp4,1.625,19,7,TTGATTTTGGGCACGGCCTA,12,1911821
ihfAp4,3.625,35,7,TTGATAGCAGGGGGTAGGCG,28,1957041
ihfAp4,2.0,22,7,TTGACGATTCCAAAATTATA,15,1927061
ihfAp4,6.125,55,7,TTCTTGGAAAAAGTGGATGT,48,1932012
ihfAp4,9.75,84,7,TTCGACGGCAATGCTTCCTC,77,1953481
ihfAp4,2.625,27,7,TTCCGCTAGGTGACAGCGGT,20,1958323
ihfAp4,2.5,26,7,TTCCGATCCGTATGGACGAA,19,1915095
ihfAp4,2.375,25,7,TTCCCGTAAGAACAAACGAT,18,1919436
ihfAp4,0.625,11,7,TTCAGGGAAATACTGCTATG,4,1933794
ihfAp4,1.0,14,7,TTCACTATTAGTAGTTGTGT,7,1949576
ihfAp4,0.25,8,7,TTCACCGTTGACGCAATTAG,1,1944735
ihfAp4,1.625,19,7,TTATTCGATCTAATAAACTG,12,1935418
ihfAp4,7.0,62,7,TTATCGGTACTCCGGGGTTA,55,1932121
ihfAp4,1.0,14,7,TTATCGGGTAACCCGGTGCA,7,1927010
ihfAp4,3.125,31,7,TTAGTAAATTGAATGGTTTT,24,1928240
ihfAp4,2.5,26,7,TTAGGTGTGCTTTCGCTCAC,19,1951712
ihfAp4,0.25,8,7,TTAGCGAGTCCATTGGTAAC,1,1950825
ihfAp4,3.25,32,7,TTAATTTGATGCGCTATTAT,25,1917348
ihfAp4,3.75,36,7,TGTTCAAGCCGGAGCATCGA,29,1941883
ihfAp4,3.375,33,7,TGTGGCAGCGAGAAACGCGT,26,1912920
ihfAp4,6.125,55,7,TGTGCGTCTTGGCGTAATAT,48,1926384
ihfAp4,0.375,9,7,TGTCTCCCCCCCAACAGCGT,2,1936754
ihfAp4,3.25,32,7,TGTCGCAGGTCAGGGGGACA,25,1946886
ihfAp4,0.25,8,7,TGTCGAGTATGTAAATGTTA,1,1932622
ihfAp4,2.375,25,7,TGTCCAATCGATATCTCCTA,18,1914032
ihfAp4,1.375,17,7,TGTCACTTGTGGTAAACGTA,10,1957319
ihfAp4,2.5,26,7,TGGTGTTTAGAAGCACGCCT,19,1943910
ihfAp4,4.125,39,7,TGGTGACTAGCGCTATCGAT,32,1961850
ihfAp4,0.375,9,7,TGGTAGGTTGTCTAACGCAT,2,1953533
ihfAp4,3.0,30,7,TGGGTACAAGAGGGTTGGAG,23,1950874
ihfAp4,1.5,18,7,TGGCTGAGTGGTATTGTGAC,11,1913497
ihfAp4,12.375,105,7,TGGCGGACACGATATGGTAG,98,1910143
ihfAp4,6.875,61,7,TGGCATTAAAACGATCCACA,54,1945357
ihfAp4,0.75,12,7,TGGCAACCATCGAATACCTA,5,1925709
ihfAp4,2.625,27,7,TGGCAAAGGATGGTCTAGGA,20,1932581
ihfAp4,0.75,12,7,TGCGTGTGAAAAATGGAAGC,5,1909807
ihfAp4,5.25,48,7,TGCGGTCGGTGACGCAGGCT,41,1924332
ihfAp4,2.375,25,7,TGCGCGGGAGCAGATGGCTT,18,1956193
ihfAp4,0.25,8,7,TGCCCTTAAGCATAGACTAC,1,1933821
ihfAp4,4.125,39,7,TGCCACACGCTTCGAACGGA,32,1943075
ihfAp4,0.25,8,7,TGCACACTGAACGGCCTTTA,1,1929624
ihfAp4,4.125,39,7,TGATGACCATACTCCGAGAA,32,1924168
ihfAp4,3.75,36,7,TGAGTCCATTTCAGTCTGGG,29,1953919
ihfAp4,5.875,53,7,TGACGGAACTAAGTGTTGTA,46,1943750
ihfAp4,5.5,50,7,TCTTGAGGTTAGAGACGGTC,43,1919913
ihfAp4,4.125,39,7,TCTTCTGTCCTGCAAACTTG,32,1945639
ihfAp4,3.0,30,7,TCTGGTAAAGCAAGATTTAA,23,1952777
ihfAp4,0.625,11,7,TCTCTAGCCGTCCCGCTAGC,4,1921584
ihfAp4,4.5,42,7,TCTCCTATAGTTCCTGCCAA,35,1938821
ihfAp4,1.75,20,7,TCTCCGGTCTTTTCCAGTTT,13,1951571
ihfAp4,6.0,54,7,TCTATTCAAGCACGAAAACT,47,1945417
ihfAp4,3.125,31,7,TCGGTGCGGTTGCAGGATAT,24,1928494
ihfAp4,11.25,96,7,TCGATCGCCAAGCAATGAGA,89,1915664
ihfAp4,3.0,30,7,TCCTTTGGATTCTTGACAGG,23,1927744
ihfAp4,2.875,29,7,TCCTGTCGTGACAAGCCAGG,22,1910381
ihfAp4,3.875,37,7,TCCGAAATATGCTGTCGCAA,30,1927796
ihfAp4,1.375,17,7,TCCCTTTCGGCAACGGAAGA,10,1916363
ihfAp4,2.625,27,7,TCCCGCGGTGCCAAGCCTCA,20,1923253
ihfAp4,20.875,173,7,TCCAAGGACACTAAGCGACC,166,1935822
ihfAp4,3.25,32,7,TCATTCATGCGATCCCGACA,25,1933509
ihfAp4,4.875,45,7,TCATGCTATAACCTCCTATA,38,1950025
ihfAp4,2.75,28,7,TCATGATAGGTCGAACCGAC,21,1951262
ihfAp4,13.625,115,7,TCATAGGTGTGATTCGTCGA,108,1928586
ihfAp4,0.25,8,7,TCATAGATGGCCCTTCGTTG,1,1920282
ihfAp4,1.875,21,7,TCACGGGGTCGGTTGGACTT,14,1921221
ihfAp4,3.75,36,7,TCACCAGCAAACAGTCCAGA,29,1923575
ihfAp4,3.375,33,7,TCACATTGAACGCTGGGAAT,26,1946151
ihfAp4,5.375,49,7,TATTCCGGAACACAAACATT,42,1955973
ihfAp4,2.5,26,7,TATCTGGGCACACAAAAGGA,19,1956239
ihfAp4,2.5,26,7,TATCGATCGGTTCTCATCGC,19,1928364
ihfAp4,3.5,34,7,TATACGGTTACAAATGCTAC,27,1954020
ihfAp4,0.25,8,7,TAGGTCAAGGGTCAAAGCTT,1,1927541
ihfAp4,2.875,29,7,TAGCAGCAGCCCCCGCCTCC,22,1913452
ihfAp4,5.5,50,7,TACGGAAATAAAGATTTGCT,43,1917686
ihfAp4,1.875,21,7,TACCTATACTTGATAGGCAA,14,1942993
ihfAp4,1.625,19,7,TACCCTGCGTGTAGGCGGAT,12,1924598
ihfAp4,3.625,35,7,TACACTTGCTGCAGGGGTCA,28,1925945
ihfAp4,1.625,19,7,TAATGGGTGATCCGCAACTT,12,1938886
ihfAp4,3.375,33,7,TAAGTTGATTACCGGACCGT,26,1939436
ihfAp4,3.0,30,7,TAACCCACTCCATTCCGTAA,23,1957778
ihfAp4,4.125,39,7,GTTTCCTGGGGAGCTAAGCT,32,1923315
ihfAp4,0.25,8,7,GTTTAAACTTCTAGGCAACG,1,1962291
ihfAp4,2.625,27,7,GTTGACCTCGGTACTCGCAG,20,1931457
ihfAp4,0.25,8,7,GTTCTTGATCATGGCGAGCG,1,1930614
ihfAp4,2.5,26,7,GTTCCGAAGCTGGTGCCAAT,19,1938939
ihfAp4,1.875,21,7,GTGTTTGTATCGTACCAGAT,14,1914776
ihfAp4,3.875,37,7,GTGTGACCGTTATTTTGACT,30,1923989
ihfAp4,7.125,63,7,GTGTAACTCCTTGCGATGTG,56,1914914
ihfAp4,0.25,8,7,GTGGGAATCCCGCGCCGAAA,1,1916457
ihfAp4,2.375,25,7,GTGGCTAAACCAGCGTTAAT,18,1925278
ihfAp4,1.375,17,7,GTGAGAATTTAATATTAGGC,10,1946576
ihfAp4,8.25,72,7,GTGAACGTTTGGGGGATTGC,65,1916116
ihfAp4,1.0,14,7,GTCGTGCGTAAACCAGGCAT,7,1960127
ihfAp4,3.0,30,7,GTCGTGAGGACCTGTGTATC,23,1928159
ihfAp4,2.0,22,7,GTCCCGTCGGAAGGAAATGT,15,1936670
ihfAp4,4.625,43,7,GTCCCCCTACCTATATGGTC,36,1953912
ihfAp4,1.5,18,7,GTATTGGAAATTTTTACAGT,11,1943606
ihfAp4,7.875,69,7,GTATGCTATACATCGGGGAT,62,1924442
ihfAp4,0.25,8,7,GTATCAAGCCCCTTCATGGC,1,1911099
ihfAp4,0.75,12,7,GTATAATGAATTCGTATGTA,5,1928024
ihfAp4,0.25,8,7,GTAGCTAAGTTGAACGCGAG,1,1923873
ihfAp4,1.5,18,7,GTACGACAGTGATTCAGGAA,11,1929528
ihfAp4,2.75,28,7,GTACCGGTCGTGCAAGCCAT,21,1914081
ihfAp4,0.625,11,7,GTAAAATTCTTAGCGTCAAA,4,1953034
ihfAp4,1.5,18,7,GGTTTTTTTGTTCTCTCTAG,11,1929043
ihfAp4,5.625,51,7,GGTTTACACGCGGCGTAGAA,44,1933085
ihfAp4,6.25,56,7,GGTCCTTAAAGTATCGGTGT,49,1954707
ihfAp4,2.625,27,7,GGTCCTCGTTATGATTTAGA,20,1942653
ihfAp4,6.875,61,7,GGTCCGTACTAACGAAACTC,54,1937897
ihfAp4,2.375,25,7,GGTAGAAAAGCAACTTGAGG,18,1910517
ihfAp4,0.25,8,7,GGTACGGAGGACCTTAGATA,1,1940749
ihfAp4,12.625,107,7,GGTACGCGTTCTCGCCATTA,100,1948914
ihfAp4,3.0,30,7,GGGTTCACGCAATGCTGAAT,23,1923776
ihfAp4,0.625,11,7,GGGTTAGGGTTACGAATGAT,4,1937412
ihfAp4,3.75,36,7,GGGTGCTTCAAGGTCACTCG,29,1934853
ihfAp4,3.0,30,7,GGGTACACGCGATATCATTG,23,1954994
ihfAp4,2.375,25,7,GGGGGGGCCGTTGAATGTTA,18,1925998
ihfAp4,2.0,22,7,GGGCAGAGATCAGCCTAATT,15,1914034
ihfAp4,2.875,29,7,GGGCAAACGACAATCGCAGC,22,1933817
ihfAp4,3.375,33,7,GGCTTATCGAGGCCCTCACG,26,1923164
ihfAp4,1.125,15,7,GGCGCTCCACGGTTTGGTAA,8,1916795
ihfAp4,0.25,8,7,GGCCTATCTTATCCGGCCGC,1,1954442
ihfAp4,2.5,26,7,GGCCGCTTTAAGTGCGCACG,19,1918167
ihfAp4,6.125,55,7,GGCAGTACCTTGAGAGCTCC,48,1954830
ihfAp4,2.625,27,7,GGCACGGGCTTTCGGTGGCA,20,1932489
ihfAp4,2.125,23,7,GGAGTTAGGGGTCCAAATAT,16,1958835
ihfAp4,5.375,49,7,GGAGGCTCTCTCTCCGGTGT,42,1929023
ihfAp4,1.25,16,7,GGAGCTTGGCTATGGTAATG,9,1929986
ihfAp4,2.25,24,7,GGAGAGACTCGTCTATTTTT,17,1959449
ihfAp4,1.5,18,7,GGACTACGCCGAGCGGGGTG,11,1917082
ihfAp4,2.125,23,7,GGACTACCTAATAACGTTAG,16,1932747
ihfAp4,2.125,23,7,GGACGGTCGGCTCCCTTCGA,16,1919787
ihfAp4,0.25,8,7,GCTTGGGCTGGGAACATGTT,1,1922509
ihfAp4,1.0,14,7,GCTTGGCCGAAAGTGAAAGT,7,1948149
ihfAp4,0.625,11,7,GCTTAAGCTCGCGATATAGT,4,1935410
ihfAp4,2.25,24,7,GCTATGATGTCCCGACCACA,17,1952461
ihfAp4,2.75,28,7,GCTACATACAGGTCGGTCTA,21,1948756
ihfAp4,11.0,94,7,GCGGTTCAAGGCCACAGGAG,87,1945813
ihfAp4,3.875,37,7,GCCTCTCTTTGGGGCAAGTT,30,1959787
ihfAp4,8.75,76,7,GCCGTACTCCGAGCGGAAAC,69,1919284
ihfAp4,4.0,38,7,GCCGGCAGCGAAATTGCCTA,31,1922361
ihfAp4,1.25,16,7,GCCGCTGCACACACCTTGGT,9,1955814
ihfAp4,4.875,45,7,GCCCTGAAGCCTAAGGGTTC,38,1949244
ihfAp4,5.5,50,7,GCCAGTTACCAAATTTATGA,43,1915922
ihfAp4,14.875,125,7,GCCAACAGTATGGGCGACGT,118,1927837
ihfAp4,0.25,8,7,GCATAGTACCTTCTACCCTT,1,1932597
ihfAp4,3.375,33,7,GCATACGAAGGTGCGGAGCA,26,1916701
ihfAp4,4.375,41,7,GCAGGCACTGGCGACCGTCC,34,1926844
ihfAp4,0.5,10,7,GCAGCATAACGAAAACACCT,3,1930581
ihfAp4,1.875,21,7,GCACTACACCAGAGTTTCAC,14,1945454
ihfAp4,5.0,46,7,GATTTCCCGTAGCCCGACGG,39,1933781
ihfAp4,0.5,10,7,GATTCCATGGCGTGCTTCCG,3,1953876
ihfAp4,1.625,19,7,GATATGGCAACACGCTATGC,12,1943330
ihfAp4,3.0,30,7,GATAGTGATGGAATGCAAAT,23,1918399
ihfAp4,4.875,45,7,GAGGTTAACCCAGCATGGCA,38,1917808
ihfAp4,4.125,39,7,GAGGTGGCAGGGCTCCAGCA,32,1939136
ihfAp4,7.25,64,7,GAGATGGGGAGCCTTCATTT,57,1921023
ihfAp4,4.125,39,7,GAGAGCATTAACTTACAACG,32,1950871
ihfAp4,1.25,16,7,GACTTAAGCTTCTGTGCGGC,9,1919021
ihfAp4,0.875,13,7,GACGTTACTTTATCACGCGT,6,1911071
ihfAp4,3.5,34,7,GACGGCAGAGGGTCAGTTAT,27,1960164
ihfAp4,2.75,28,7,GACGAGAGGTAGTCAAGAGT,21,1937975
ihfAp4,4.75,44,7,GACCTGGTGATCTGCGCGCT,37,1931005
ihfAp4,2.625,27,7,GACCCCCTTATTAATTGCGA,20,1957222
ihfAp4,2.75,28,7,GACCCATGCATGCAATAAAA,21,1955577
ihfAp4,4.0,38,7,GACATGATGCGAAACGGAGT,31,1948616
ihfAp4,3.875,37,7,GACATACGCAAGGCTGGACT,30,1925379
ihfAp4,1.125,15,7,GACAGTCGTACCGAGCGGTG,8,1937674
ihfAp4,2.875,29,7,GAAATACTTGTGTCCCGCGT,22,1913241
ihfAp4,4.5,42,7,CTTTGAACGGTTACTAAAGC,35,1945100
ihfAp4,7.5,66,7,CTTGGCAAGCTGAAGGCAGT,59,1911317
ihfAp4,2.125,23,7,CTTGAACCCAGCGATCCCTT,16,1936373
ihfAp4,1.5,18,7,CTTCGTGACCCGCTGAGTCT,11,1913859
ihfAp4,2.0,22,7,CTTCGCCGAGAATCAACGCG,15,1959395
ihfAp4,1.0,14,7,CTTATCAAATACAACGCTCA,7,1925412
ihfAp4,2.75,28,7,CTGTGGTCAGGTACTGAGTC,21,1941332
ihfAp4,1.375,17,7,CTGTATGGAACCTTGGTTGT,10,1918307
ihfAp4,1.625,19,7,CTGGTTGCGGCGGATTATCA,12,1943207
ihfAp4,2.25,24,7,CTGGCCGCCTGCCGACGTTC,17,1913224
ihfAp4,3.125,31,7,CTGCCTGAGACATGAGGATC,24,1925776
ihfAp4,6.875,61,7,CTGCCTCTTTGCATGGTATT,54,1961552
ihfAp4,5.125,47,7,CTCGGGCCGGCCACACACGT,40,1934025
ihfAp4,3.875,37,7,CTCGCATCCGTCCACGGTAG,30,1956107
ihfAp4,7.0,62,7,CTCGATACTGGATAGTTTGT,55,1953076
ihfAp4,1.0,14,7,CTCGAGCCGACATCATGTCA,7,1959087
ihfAp4,4.375,41,7,CTCCTGGAGTTTAAGCCTAT,34,1944609
ihfAp4,3.375,33,7,CTCCCCTCAGCTACACCTCA,26,1917414
ihfAp4,3.0,30,7,CTATGACGAGAGCAGCCTGA,23,1930990
ihfAp4,5.625,51,7,CTATAATGAGGGATTCCCCT,44,1916579
ihfAp4,7.25,64,7,CTAGGGTAAAATCGGGGGGT,57,1926731
ihfAp4,4.75,44,7,CTACCAAACGCCAAAGCCAC,37,1950541
ihfAp4,2.375,25,7,CTAAGCCGCATGGGGAGAAA,18,1927443
ihfAp4,2.125,23,7,CTAAATTATTTAAGAATAAC,16,1926544
ihfAp4,1.25,16,7,CGTTTTGCCGAAGCTTGGTT,9,1936502
ihfAp4,4.375,41,7,CGTTGTTCACATACAAGGAT,34,1936915
ihfAp4,11.5,98,7,CGTGGTATACCTGACCTAGA,91,1912534
ihfAp4,4.625,43,7,CGTCCTTCGGCGGATAGGGT,36,1959007
ihfAp4,1.125,15,7,CGTAGAATTGCGGTGCTTTA,8,1956104
ihfAp4,2.25,24,7,CGTACGATTACGTGAGGGCT,17,1952254
ihfAp4,0.25,8,7,CGGTCTATAGTTTATTTTAA,1,1913135
ihfAp4,2.25,24,7,CGGGACTTTTCTAACCATAC,17,1917005
ihfAp4,5.0,46,7,CGGCGGTACAATCGTGCCAT,39,1947536
ihfAp4,5.375,49,7,CGGATTGTCTACCCTCTCCC,42,1919144
ihfAp4,1.875,21,7,CGGATATCGCCTAGGCCCCT,14,1929397
ihfAp4,3.5,34,7,CGGAGTCCACTCCAGGTACT,27,1941666
ihfAp4,3.75,36,7,CGGAGCGCGAACCTCCCGAT,29,1943285
ihfAp4,3.25,32,7,CGCTCCCAGGATATCTTCTG,25,1948301
ihfAp4,2.625,27,7,CGCGTTTCACACAAGCTTCG,20,1952403
ihfAp4,0.25,8,7,CGCGTCGAGATGACGTATTT,1,1933245
ihfAp4,4.5,42,7,CGCGTAATGGCTTCTTTTGC,35,1926827
ihfAp4,2.0,22,7,CGCGGCCCCGTCCCTACGGG,15,1914185
ihfAp4,0.375,9,7,CGCCGGGCATACTCTTACCC,2,1913017
ihfAp4,0.25,8,7,CGCATGCAGATTGCAGGGCA,1,1927990
ihfAp4,4.5,42,7,CGCACTGCTCGGTACGCAGC,35,1941131
ihfAp4,3.5,34,7,CGAGGGCCAATCACAGTACC,27,1949581
ihfAp4,3.75,36,7,CGAATTTCGGTGAATGGGAG,29,1950712
ihfAp4,3.125,31,7,CGAAGTATGGTGGTACCCTA,24,1935420
ihfAp4,6.625,59,7,CCTTTGGTCATTAGGGGACC,52,1916584
ihfAp4,14.25,120,7,CCTTCGCGACGGGAGGCTAA,113,1926465
ihfAp4,3.625,35,7,CCTGTGACGACACTAACTAC,28,1919554
ihfAp4,6.375,57,7,CCTAAGTGATAAGTGGGGAA,50,1953959
ihfAp4,2.375,25,7,CCGTATGTAAGCAGGAGCTG,18,1934413
ihfAp4,3.875,37,7,CCGGTTAGTTTCCAGAGGAG,30,1940933
ihfAp4,2.25,24,7,CCGGCTATGTGAGTGTGTTC,17,1946314
ihfAp4,11.0,94,7,CCCGTGCCGCTATTTGAGAG,87,1935215
ihfAp4,8.125,71,7,CCCCCCAGCAAGATTAATCT,64,1917027
ihfAp4,2.0,22,7,CCCCATATTATTTATTTCGA,15,1942892
ihfAp4,1.375,17,7,CCCCAGCTCGATAGAATTGG,10,1938954
ihfAp4,6.625,59,7,CCCATACGTGTCGAATATAG,52,1956900
ihfAp4,3.0,30,7,CCACCTAACCTCACCTTTCT,23,1947161
ihfAp4,3.375,33,7,CCACCAGATCATAACTGGGA,26,1920722
ihfAp4,6.125,55,7,CATTGATTCCTATAGCTATT,48,1958313
ihfAp4,3.25,32,7,CATGCTCTGAGAACTAGCTG,25,1947951
ihfAp4,0.25,8,7,CAGTAGAACATTTGTCAGTA,1,1939778
ihfAp4,2.25,24,7,CAGCACGAGAGATACTACGG,17,1953089
ihfAp4,2.625,27,7,CAGAAGATAAGTACTGTGTT,20,1956836
ihfAp4,0.25,8,7,CAGAAGACGTTTCGATTCTA,1,1932464
ihfAp4,5.875,53,7,CACTACAGTGTACAATCCTG,46,1920168
ihfAp4,5.125,47,7,CACGTGCCCGTTAAGTTGGT,40,1933332
ihfAp4,8.375,73,7,CACGGCTTACATCGGATGTC,66,1909584
ihfAp4,3.75,36,7,CACAGGTTCATTCTGGTACT,29,1924265
ihfAp4,2.25,24,7,CAAGTTGAGATAGGACGCGT,17,1917223
ihfAp4,1.625,19,7,CAAATTAGCGAGTAAAGGCT,12,1957251
ihfAp4,4.75,44,7,ATTTTACCGCAACTAGGTTA,37,1944628
ihfAp4,5.5,50,7,ATTGGGTTCAATCGTCGGGG,43,1911354
ihfAp4,3.25,32,7,ATTCGCGGGCACATCCCGTT,25,1909561
ihfAp4,1.0,14,7,ATTATGCCCCTTAATCATCC,7,1917911
ihfAp4,3.875,37,7,ATGGGTTATAATCAACGTGA,30,1954323
ihfAp4,1.75,20,7,ATGCGTGGCAGTTCTCAGAG,13,1939100
ihfAp4,4.875,45,7,ATGCAACATCTATATGTTAG,38,1927345
ihfAp4,0.875,13,7,ATCTGGTCTTCTTCTTCGAA,6,1912792
ihfAp4,3.625,35,7,ATCTGCAGGTAATTGTGCAT,28,1916094
ihfAp4,1.625,19,7,ATCGTCAAAGTCCGTCTAAC,12,1920928
ihfAp4,3.75,36,7,ATCGGAACAAGGTCCAGAAT,29,1919401
ihfAp4,2.5,26,7,ATCCGAACCGGGCACATTCC,19,1917680
ihfAp4,13.25,112,7,ATCCAGAGCCCTTTATAGCT,105,1954269
ihfAp4,3.375,33,7,ATCATCAATTCGGGACCGAG,26,1943617
ihfAp4,1.625,19,7,ATCATACTGCTTTTCGTTAA,12,1922580
ihfAp4,2.25,24,7,ATCACTTTCGTCCGCTCGTT,17,1955063
ihfAp4,3.75,36,7,ATCACTAAAAGGTGGGATGG,29,1930865
ihfAp4,2.125,23,7,ATCAATCCTACGCTCTCGAT,16,1943642
ihfAp4,1.0,14,7,ATCAACCCTCCTTATCGCTT,7,1950269
ihfAp4,4.25,40,7,ATAGTAGGCTCCTCTTTTAG,33,1947492
ihfAp4,4.25,40,7,ATAGGTCGGAAGGCCCCGTT,33,1947639
ihfAp4,2.5,26,7,ATAGCCCCGCACCTGCCTCC,19,1958979
ihfAp4,2.25,24,7,ATACAGTGGAGAAGATAATG,17,1917550
ihfAp4,7.375,65,7,ATAATGAGATTTAATAGTAA,58,1958999
ihfAp4,6.625,59,7,AGTGTGCGCCGGGGTGATGA,52,1957674
ihfAp4,0.25,8,7,AGTGACTTTCATTACTATTG,1,1936358
ihfAp4,3.625,35,7,AGTATGGATAGGTCGCGCGA,28,1959868
ihfAp4,2.625,27,7,AGGGGTTCACTGTTTCTAAT,20,1909985
ihfAp4,2.0,22,7,AGGGCTTCGACCCATTTTGG,15,1958168
ihfAp4,3.625,35,7,AGGGCCATTTGCGCGGCGTT,28,1949155
ihfAp4,2.5,26,7,AGGCGGGATCCCAGTTGGCT,19,1958391
ihfAp4,7.125,63,7,AGGCAACACTGGAATACGGG,56,1944799
ihfAp4,4.5,42,7,AGGAGTGTACCCTAGCGAGG,35,1920527
ihfAp4,1.0,14,7,AGGAGTGATCTGTGAGCGTT,7,1914325
ihfAp4,2.75,28,7,AGCTGGGTCGCTATGACAGC,21,1937657
ihfAp4,4.0,38,7,AGCTCCAGACAGGGAGCGAA,31,1940791
ihfAp4,2.75,28,7,AGCTACCTTCCAGGTAATAG,21,1930221
ihfAp4,5.125,47,7,AGCGTCTGGGGGCAGACTCT,40,1913062
ihfAp4,3.0,30,7,AGCGGTTTGCGTGGGAACCT,23,1910206
ihfAp4,1.125,15,7,AGCGGTCAAGCGCCTCCTGT,8,1937598
ihfAp4,8.5,74,7,AGCGGGAGGTCTTTCCCACG,67,1917247
ihfAp4,1.375,17,7,AGCGCATTTCTGGAGGTCCC,10,1957615
ihfAp4,4.5,42,7,AGCGATTATAGGACAAATTC,35,1913049
ihfAp4,11.125,95,7,AGCCACCAACGGAGGGAGTA,88,1950387
ihfAp4,4.125,39,7,AGCATTTGAAGTTCCTTAGT,32,1910228
ihfAp4,1.0,14,7,AGAGGAACATTTGTGCGGTT,7,1948719
ihfAp4,3.375,33,7,AGAGCGCAGTTCTTTTTTTT,26,1942458
ihfAp4,3.125,31,7,AGAATGCTACAGATGAGCAG,24,1918918
ihfAp4,6.0,54,7,AGAAGGGCAGTGACGAAAGC,47,1930049
ihfAp4,3.0,30,7,ACTTTGTGGAGGGGGGAGAA,23,1938568
ihfAp4,2.875,29,7,ACTTAGGTATCCCGCCCCGT,22,1923685
ihfAp4,2.125,23,7,ACTGTAGTAGCACTTAGCGA,16,1954629
ihfAp4,3.125,31,7,ACTGCTAGGACCGGTACTCA,24,1944085
ihfAp4,1.625,19,7,ACTCCAAGGGTATCAAGGTT,12,1935444
ihfAp4,0.25,8,7,ACTCACATAGAATTGCCGAT,1,1913865
ihfAp4,5.125,47,7,ACTAAAACAGATTATCCACG,40,1943936
ihfAp4,2.75,28,7,ACGGTGTTGTCTTCAATTCC,21,1938189
ihfAp4,7.875,69,7,ACGGCTGGGGCGCATACTCT,62,1925236
ihfAp4,1.5,18,7,ACGCAGCCAGTAACTCGCCA,11,1910225
ihfAp4,1.75,20,7,ACGATCGATCGCATCCTCGG,13,1956018
ihfAp4,1.0,14,7,ACGACATTGATAGTTCTAAC,7,1938281
ihfAp4,3.75,36,7,ACCAGTATCTGAATGGTTAG,29,1954060
ihfAp4,0.25,8,7,ACAGAACATTTGTTGCGGAT,1,1958713
ihfAp4,4.875,45,7,ACACCGTTTCATAGTAAGAC,38,1944383
ihfAp4,5.125,47,7,ACACATATGACTAAGTAAGG,40,1949235
ihfAp4,8.0,70,7,AATTTGGAAAAGGGCAGCGC,63,1945331
ihfAp4,4.5,42,7,AATTCAAGCTCCTAAGTCCC,35,1922015
ihfAp4,5.125,47,7,AATGTTCCATCAGAAAATCT,40,1934586
ihfAp4,0.25,8,7,AATGTATGTCTCGGTAGGCT,1,1920296
ihfAp4,2.375,25,7,AATCGCCCTATTTAAAATTT,18,1944838
ihfAp4,2.25,24,7,AATACTAGGGGTGTTCTATT,17,1938987
ihfAp4,7.0,62,7,AAGTTTAGGACTTACAAGAA,55,1954472
ihfAp4,4.875,45,7,AAGTACGACAACAATGTTCT,38,1942253
ihfAp4,2.125,23,7,AAGGAGAGTACCCGAGGTGC,16,1935527
ihfAp4,2.25,24,7,AAGCTGGACCGGAGAATACA,17,1955271
ihfAp4,2.5,26,7,AAGCCGTAAAAAACCCCAGT,19,1930455
ihfAp4,7.375,65,7,AAGCCCACACTCCTGCATTC,58,1914922
ihfAp4,3.25,32,7,AAGCACATATGTATGCATAT,25,1925746
ihfAp4,5.625,51,7,AACTTTGGCAGTCTAAGAAT,44,1929751
ihfAp4,3.125,31,7,AACTACATGCGGGACCGGAA,24,1947716
ihfAp4,15.75,132,7,AACGGGTACCCCGCTATTAT,125,1912796
ihfAp4,2.75,28,7,AACGGGCGCAATAGGATCGA,21,1955478
ihfAp4,6.375,57,7,AACGCGGCGCTCTCCCGAAG,50,1912679
ihfAp4,3.75,36,7,AAATGGCCACATAACCCTGG,29,1930993
ihfAp4,3.5,34,7,AAAGCATAACCGCGGACGTC,27,1952341
ihfAp4,3.375,33,7,AAACTTTGCTTAGGGTTCAA,26,1944095
ihfAp4,3.125,31,7,AAACCCCAGAAATTTAGCAA,24,1909708
ihfAp4,1.5,18,7,AAACCAAATTAAAAGTTTGC,11,1915156
ihfAp4,9.75,84,7,AAACAGCACGTATATTTTGC,77,1959703
ihfAp4,2.375,25,7,AAAACGGGTGCAGCGGACGG,18,1925695
ihfAp4,2.0,19,6,TTTTCGTGAAGCATTCGGTC,13,1930150
ihfAp4,2.5714285714285716,23,6,TTTTCAGCGGACGTCATCGG,17,1909712
ihfAp4,6.428571428571429,50,6,TTTTCAAGAATACCTACTCC,44,1958156
ihfAp4,0.42857142857142855,8,6,TTTTAGCGTCATGCCATCGC,2,1961427
ihfAp4,2.4285714285714284,22,6,TTTCTGTGCTAAAAATGGCA,16,1913671
ihfAp4,1.8571428571428572,18,6,TTTCCAAAACTTTATCAGCT,12,1938492
ihfAp4,0.2857142857142857,7,6,TTTATTCGCACAGGGAAACG,1,1910056
ihfAp4,3.857142857142857,32,6,TTTAGGTATACTGCGACTTC,26,1943945
ihfAp4,4.714285714285714,38,6,TTTAGAGGGTCTCGTAATAG,32,1917432
ihfAp4,2.0,19,6,TTGTTACTGGTCCCTTACCG,13,1930132
ihfAp4,1.1428571428571428,13,6,TTGTGGTGTAGTAGCGGTTT,7,1955345
ihfAp4,2.0,19,6,TTGTCAAGCCGTGCTGAGAA,13,1923946
ihfAp4,0.2857142857142857,7,6,TTGTAATACTACATATTTAA,1,1953239
ihfAp4,0.5714285714285714,9,6,TTGGCTCCAAAGGACACACG,3,1961163
ihfAp4,3.7142857142857144,31,6,TTGCGACAGCCACACCTGTC,25,1941175
ihfAp4,0.7142857142857143,10,6,TTGCAGAAAGGGACTGCCCG,4,1955437
ihfAp4,3.7142857142857144,31,6,TTGATCGGCCAGACACCCAG,25,1926705
ihfAp4,2.2857142857142856,21,6,TTGAGGTTCTTTTGATGCCT,15,1943959
ihfAp4,16.428571428571427,120,6,TTGAAGCCAGCTGGTGACCG,114,1915647
ihfAp4,0.2857142857142857,7,6,TTGAAACATGCTACGAAATT,1,1955529
ihfAp4,3.857142857142857,32,6,TTCTACCAACGTGAAGCGGT,26,1946112
ihfAp4,1.8571428571428572,18,6,TTCCGCAAAGCTGTAGTACA,12,1941595
ihfAp4,2.142857142857143,20,6,TTCATTGCCCACCTAGTCAC,14,1959743
ihfAp4,16.0,117,6,TTCATTAGGCCAAACTGATT,111,1930756
ihfAp4,2.2857142857142856,21,6,TTCACTACAACAGACGCATT,15,1910931
ihfAp4,3.0,26,6,TTCACGCAGGTTACCTTGGC,20,1957001
ihfAp4,2.857142857142857,25,6,TTCACGATCCAAGACCTCTC,19,1952195
ihfAp4,8.571428571428571,65,6,TTCAATTTTTTAGTAAATTT,59,1938422
ihfAp4,11.428571428571429,85,6,TTCAATGCTGGTGTACGGAG,79,1959702
ihfAp4,3.142857142857143,27,6,TTATTTGAACCGGTCATATG,21,1930889
ihfAp4,2.7142857142857144,24,6,TTATCCACTACGACAATAGC,18,1951094
ihfAp4,3.4285714285714284,29,6,TTAGACGGAAGGAGCGTGCC,23,1946783
ihfAp4,2.4285714285714284,22,6,TTACGGTGAATGTATTGACG,16,1942395
ihfAp4,2.4285714285714284,22,6,TTACGCATCGGACCTTGTGC,16,1934490
ihfAp4,2.4285714285714284,22,6,TTAAGCCTCGTGATAGCGCC,16,1944604
ihfAp4,3.857142857142857,32,6,TTAACCCGCGCGGACGGGTC,26,1913090
ihfAp4,1.7142857142857142,17,6,TTAAAGGTGCGGGGAACATA,11,1961211
ihfAp4,2.0,19,6,TGTTCCGATGGGCCACGAAC,13,1917949
ihfAp4,3.5714285714285716,30,6,TGTTCCAGTGTTCCAAGTCA,24,1921932
ihfAp4,4.142857142857143,34,6,TGTTAGTTGCTTGGGTGCGA,28,1952102
ihfAp4,4.142857142857143,34,6,TGTGTACTTCATGAGGCCGT,28,1937727
ihfAp4,3.2857142857142856,28,6,TGTGCATTACGCGAGCTGTG,22,1925189
ihfAp4,5.714285714285714,45,6,TGTGATGACAGTGCTGGAGG,39,1933404
ihfAp4,8.428571428571429,64,6,TGTCAGCGGACGAACAGTTA,58,1919995
ihfAp4,4.0,33,6,TGTAGTTTGTGAGCCTCAGT,27,1927559
ihfAp4,2.857142857142857,25,6,TGGTGGGGCTGTATTTGGTC,19,1946244
ihfAp4,8.571428571428571,65,6,TGGTGGACCCCGTGGTGCAT,59,1940592
ihfAp4,3.4285714285714284,29,6,TGGTGCTAAGAGCATTCAAC,23,1929763
ihfAp4,3.2857142857142856,28,6,TGGTCGCCCGGTGCGGGTAT,22,1950839
ihfAp4,5.571428571428571,44,6,TGGGTCATTCTGGAGTAGAG,38,1953088
ihfAp4,2.857142857142857,25,6,TGGGGGAGTCACAGTGTTTA,19,1926667
ihfAp4,0.2857142857142857,7,6,TGGCTTGCACTAAGATGAAA,1,1933250
ihfAp4,0.8571428571428571,11,6,TGCTTTCATCTTGCTATGCT,5,1962153
ihfAp4,0.2857142857142857,7,6,TGCTGCGTATCCGCAGTTCA,1,1933635
ihfAp4,0.8571428571428571,11,6,TGCTGCACTAATATAAGGGA,5,1915874
ihfAp4,6.428571428571429,50,6,TGCTCTGATGTACGCGACGG,44,1937317
ihfAp4,1.4285714285714286,15,6,TGCTCGCTCGCTTTAACGTT,9,1941660
ihfAp4,2.857142857142857,25,6,TGCCCGGATTTTATGATTAG,19,1935938
ihfAp4,4.0,33,6,TGCACTGGCTGCCCGGGGAA,27,1948040
ihfAp4,4.0,33,6,TGATACCAGTAATTGCTAGT,27,1924643
ihfAp4,14.0,103,6,TGACTTGGTTATGAGTACGT,97,1940126
ihfAp4,8.571428571428571,65,6,TGACCAGCAAATCTCAAGTT,59,1938114
ihfAp4,2.857142857142857,25,6,TGAATCATCGAGAGCCTACG,19,1911593
ihfAp4,4.428571428571429,36,6,TCTTGACAGAGAGGGGTCCA,30,1946680
ihfAp4,11.0,82,6,TCTTCCAGAGTGAGTTAGGC,76,1959620
ihfAp4,3.5714285714285716,30,6,TCTGTGACTGGACGACGGGA,24,1934558
ihfAp4,1.5714285714285714,16,6,TCTGGACATAAAACGCTCAT,10,1916878
ihfAp4,1.2857142857142858,14,6,TCTCCTCAGCACTCAGATGT,8,1934224
ihfAp4,0.8571428571428571,11,6,TCTCAACCGGACGTATATGA,5,1946887
ihfAp4,8.857142857142858,67,6,TCTAGCCACCCCAGGCGAGA,61,1950195
ihfAp4,1.5714285714285714,16,6,TCTAGAATCCCTGCCCTGGT,10,1926357
ihfAp4,2.857142857142857,25,6,TCTAATTCTAGGCTCCAGGC,19,1951837
ihfAp4,0.2857142857142857,7,6,TCGTTGTGCATAGGCATTTC,1,1926220
ihfAp4,3.2857142857142856,28,6,TCGCGCAAGGGGCGTGATAG,22,1953920
ihfAp4,3.4285714285714284,29,6,TCGATTTGTGAAATATTATT,23,1918874
ihfAp4,2.7142857142857144,24,6,TCGAGTCTTGAGTCCAAGAA,18,1911326
ihfAp4,4.428571428571429,36,6,TCGACCTTAAGGTCGGCATC,30,1933092
ihfAp4,1.8571428571428572,18,6,TCCTGTGCCTGTCGAAAGGA,12,1915774
ihfAp4,3.5714285714285716,30,6,TCCGTAGACAGCTCGGAGAT,24,1956832
ihfAp4,1.5714285714285714,16,6,TCCGGCCTCGCGAATGCGGC,10,1962048
ihfAp4,6.857142857142857,53,6,TCCGAGCAGGCCGACCTATT,47,1915771
ihfAp4,3.7142857142857144,31,6,TCCGAACTCTACTACCTTGG,25,1960102
ihfAp4,8.142857142857142,62,6,TCCCTTCTACCACTGTGCTA,56,1934611
ihfAp4,3.7142857142857144,31,6,TCCCTGACTTCGTGGTCGAA,25,1929214
ihfAp4,0.2857142857142857,7,6,TCCATTTCCATGCTTTTCGA,1,1953997
ihfAp4,4.0,33,6,TCCAAGGGGAGGTTGCTATA,27,1947751
ihfAp4,4.428571428571429,36,6,TCATGAGTCTGTGACCGGTA,30,1918981
ihfAp4,8.142857142857142,62,6,TCATGAATTCAAACTGGTCT,56,1918588
ihfAp4,0.5714285714285714,9,6,TCAGGTCTATCCGTAGAGAT,3,1935377
ihfAp4,1.5714285714285714,16,6,TCAGGCGCTTCGTAATTTGC,10,1951222
ihfAp4,4.571428571428571,37,6,TCAGCACTAGGGGGTCCGTA,31,1932477
ihfAp4,4.0,33,6,TCACCGTATCTAATTTAATC,27,1939084
ihfAp4,2.7142857142857144,24,6,TCAAGAATGTATTCGCGAAG,18,1923525
ihfAp4,3.5714285714285716,30,6,TCAAGAACTCAGCTCGGTCA,24,1918869
ihfAp4,19.714285714285715,143,6,TCAACGTAGAGTGATGCAAC,137,1926107
ihfAp4,1.4285714285714286,15,6,TCAAAAAGAATTAAATAATC,9,1928855
ihfAp4,1.0,12,6,TATTTTCTTGTACCCGTGCT,6,1920265
ihfAp4,6.285714285714286,49,6,TATTAATGAGCAGGTGGACA,43,1909623
ihfAp4,2.0,19,6,TATTAACAAATCGGGGGTGT,13,1961006
ihfAp4,4.285714285714286,35,6,TATCGTGCAACAGACTGAAA,29,1924674
ihfAp4,4.571428571428571,37,6,TATCGAATGTGATATTCGTA,31,1933726
ihfAp4,2.0,19,6,TATATAATGCTTACGTCGTA,13,1933384
ihfAp4,1.2857142857142858,14,6,TAGGGGCAGCGTCCGGTTAT,8,1946524
ihfAp4,4.428571428571429,36,6,TAGCGCCCAATATGTTGGGA,30,1941641
ihfAp4,2.857142857142857,25,6,TAGCGAGGCTCTAGAAAAGT,19,1941661
ihfAp4,8.857142857142858,67,6,TAGACTTTAAGGGGGGCCCA,61,1923402
ihfAp4,0.42857142857142855,8,6,TAGACGAGGGTTGTGACGAC,2,1938503
ihfAp4,4.142857142857143,34,6,TACTGTCGGATGGTTTTCTA,28,1953832
ihfAp4,3.7142857142857144,31,6,TACGGACAAACAGTTTCCTA,25,1936100
ihfAp4,4.714285714285714,38,6,TACCGTCCGAGACTTTACGT,32,1931265
ihfAp4,0.5714285714285714,9,6,TACCGTACACATATGTACGT,3,1922356
ihfAp4,1.1428571428571428,13,6,TACCCGTCTGTGACAAGTTA,7,1921158
ihfAp4,0.8571428571428571,11,6,TAATAACAGGTATACATGTA,5,1939380
ihfAp4,1.7142857142857142,17,6,TAATAAAGAGAGACTCGGAT,11,1952347
ihfAp4,9.0,68,6,TAAGTACGGTGGCGGCTATG,62,1961018
ihfAp4,4.571428571428571,37,6,TAAGGCGCCGCTCTACCTAT,31,1918381
ihfAp4,3.5714285714285716,30,6,TAACACTTCGCTGAAACGCT,24,1943417
ihfAp4,5.428571428571429,43,6,GTTGAGCTCATTCGGGTTTT,37,1944575
ihfAp4,4.0,33,6,GTTCTCCTGTCAGGCGCCCC,27,1930638
ihfAp4,1.5714285714285714,16,6,GTGTGCCCCGCTGGCGCGTA,10,1918632
ihfAp4,2.2857142857142856,21,6,GTGCACACGGCTCAAAGCCA,15,1961968
ihfAp4,4.714285714285714,38,6,GTGACGTCCATAAATTAGAA,32,1954059
ihfAp4,5.428571428571429,43,6,GTCTTTCTGTCTTAGAGAGG,37,1935625
ihfAp4,8.571428571428571,65,6,GTCTGCCAAGTGCGAGGCCA,59,1926187
ihfAp4,0.2857142857142857,7,6,GTCTCCGAGGAACCCTACGC,1,1910023
ihfAp4,7.428571428571429,57,6,GTCTAGGAATTTATGGATTG,51,1934404
ihfAp4,3.4285714285714284,29,6,GTCCGATTCTCAAATTTCGT,23,1918007
ihfAp4,6.142857142857143,48,6,GTCCGACGGGTCCCAGTCTG,42,1928273
ihfAp4,0.2857142857142857,7,6,GTATTGCTGGGATTTTCCAC,1,1940436
ihfAp4,0.2857142857142857,7,6,GTAGCGTAAGGCCATGTTCT,1,1956662
ihfAp4,0.42857142857142855,8,6,GTAGCCATCCGAAGTAGGTC,2,1917823
ihfAp4,5.285714285714286,42,6,GTAGCACAGGCCATTCTCGG,36,1959856
ihfAp4,0.2857142857142857,7,6,GTACATTGGCAAATTTTTGA,1,1960279
ihfAp4,11.714285714285714,87,6,GTAATGCACCGGGTATTAGG,81,1955669
ihfAp4,2.2857142857142856,21,6,GTAAGTGCCTTGTCGCTAAG,15,1933264
ihfAp4,6.571428571428571,51,6,GGTTCACGCGATTGGACTAC,45,1932959
ihfAp4,5.0,40,6,GGTGGGTGATTAGGACCTTG,34,1920295
ihfAp4,0.2857142857142857,7,6,GGTGAAGTTCACGGACGATT,1,1915315
ihfAp4,3.4285714285714284,29,6,GGTGAAGCAAACAGTATGGC,23,1913061
ihfAp4,2.5714285714285716,23,6,GGTACTGTATTGTTTATGGT,17,1954654
ihfAp4,5.714285714285714,45,6,GGGGTTGGTAAACGCCATCT,39,1959945
ihfAp4,0.5714285714285714,9,6,GGGGGGAATCATTTGAAGGG,3,1918636
ihfAp4,6.142857142857143,48,6,GGGGCTTCATATCGGGTTTG,42,1935293
ihfAp4,3.0,26,6,GGGCACCAACCCCGTTACTG,20,1927800
ihfAp4,2.857142857142857,25,6,GGCCAACCTACATTTATACA,19,1945737
ihfAp4,5.571428571428571,44,6,GGCATTGGAGTTCTGACTTG,38,1935654
ihfAp4,3.2857142857142856,28,6,GGCAATTGGAGAAGCTGGAC,22,1951857
ihfAp4,1.0,12,6,GGATTCACGCGCGGAGGCGG,6,1952016
ihfAp4,5.0,40,6,GGATCTCTCGCCGTCGGAAA,34,1952315
ihfAp4,5.714285714285714,45,6,GGAGGACAGCCTGCACAGGA,39,1935529
ihfAp4,2.4285714285714284,22,6,GGAGCGTTATTGACCTCTAT,16,1934887
ihfAp4,3.0,26,6,GGAGATGAGACGAGGGGGAC,20,1916783
ihfAp4,1.4285714285714286,15,6,GGAGAAAACGTAGTTACAGT,9,1953479
ihfAp4,5.428571428571429,43,6,GGACGAGGTTGCAAATAACT,37,1934320
ihfAp4,3.7142857142857144,31,6,GCTTAGTCATATCATCGGAA,25,1924658
ihfAp4,5.285714285714286,42,6,GCTGTGACGCGCAGGAGAAG,36,1929456
ihfAp4,3.5714285714285716,30,6,GCTGCCAATGTTTACGGCCC,24,1957776
ihfAp4,3.2857142857142856,28,6,GCTGACTCCTGTATCTATTC,22,1931215
ihfAp4,3.0,26,6,GCTCCTCCGGCCAGAGGGGA,20,1947752
ihfAp4,2.0,19,6,GCTAGGCCTGAGAAGCATAT,13,1937074
ihfAp4,3.2857142857142856,28,6,GCTAGCGTAGAACAGAAGCC,22,1945643
ihfAp4,2.5714285714285716,23,6,GCTAAATTGTTCCTCAAATA,17,1910463
ihfAp4,0.2857142857142857,7,6,GCGTTTCAACACCGTGTTGT,1,1926029
ihfAp4,0.8571428571428571,11,6,GCGTGTAACCATGCTTACAC,5,1946472
ihfAp4,1.1428571428571428,13,6,GCGGATAAAAACCGTTCGAA,7,1945993
ihfAp4,2.5714285714285716,23,6,GCGCGTTCGGGAGTTACGGA,17,1920606
ihfAp4,8.285714285714286,63,6,GCGATTACTCTAGTTATTGG,57,1926700
ihfAp4,4.285714285714286,35,6,GCGAATAAGGCGAATGGACT,29,1945432
ihfAp4,3.4285714285714284,29,6,GCCGGCGTTGGCATAAGAGT,23,1951300
ihfAp4,16.571428571428573,121,6,GCCGCTGTAACACGAGTCGC,115,1952326
ihfAp4,1.5714285714285714,16,6,GCCCTGGCACTCAAGCAATA,10,1918203
ihfAp4,2.4285714285714284,22,6,GCCCCAGTCCATAGCTAGTT,16,1926389
ihfAp4,2.142857142857143,20,6,GCCCAGAATGATTTTAATAA,14,1955105
ihfAp4,4.142857142857143,34,6,GCCCACGCATTCTGTTGTCA,28,1928704
ihfAp4,3.4285714285714284,29,6,GCACTGTCCTGAGTGCTACA,23,1912967
ihfAp4,3.142857142857143,27,6,GCACGGATATAATTCGACCA,21,1952271
ihfAp4,7.571428571428571,58,6,GCACCCGGTGACGATTTGTA,52,1915222
ihfAp4,2.2857142857142856,21,6,GCACCATGTCTGGGAGATTA,15,1921817
ihfAp4,3.5714285714285716,30,6,GCAAGCATTATACTGTAGGT,24,1926500
ihfAp4,2.0,19,6,GCAACGCTAGCGTCTTCCCA,13,1910870
ihfAp4,2.142857142857143,20,6,GCAACAACTCTGTGAGAGAC,14,1952794
ihfAp4,1.5714285714285714,16,6,GATTGGTAGTTTATGAGTAC,10,1962175
ihfAp4,3.142857142857143,27,6,GATCTATGGGTGCAGCTCAT,21,1950440
ihfAp4,3.7142857142857144,31,6,GATCTAAAAGCCAGATAAGG,25,1950999
ihfAp4,3.0,26,6,GATCGTGATGGTGGCACTTA,20,1930934
ihfAp4,2.4285714285714284,22,6,GATACAGGATTGTGTATCGA,16,1948578
ihfAp4,2.5714285714285716,23,6,GAGGGTCGATACCGGTCGGG,17,1921857
ihfAp4,6.714285714285714,52,6,GAGGCGCAGCCCACGATAGA,46,1912644
ihfAp4,4.571428571428571,37,6,GAGGATGAATCGGAGGGTTT,31,1937673
ihfAp4,2.142857142857143,20,6,GAGCAGGGGAAGCAGGACAT,14,1930882
ihfAp4,2.142857142857143,20,6,GAGCACGTGGAACTCCACAC,14,1958695
ihfAp4,1.8571428571428572,18,6,GAGACATGGCGCTCATACCG,12,1960698
ihfAp4,2.7142857142857144,24,6,GACTCTCTCCAGCCGGTAAA,18,1917438
ihfAp4,10.428571428571429,78,6,GACTCCTTTCTCCGCCATGA,72,1944316
ihfAp4,1.0,12,6,GACCTGGGCCGATGCTGTGG,6,1952518
ihfAp4,5.857142857142857,46,6,GACCCAATTCACTTCCTAGT,40,1929451
ihfAp4,3.5714285714285716,30,6,GACCAATCACTTGGTCCGTC,24,1943399
ihfAp4,1.4285714285714286,15,6,GACAAGCGGACCGTGAACAC,9,1960789
ihfAp4,2.142857142857143,20,6,GAAGTTCTGCAGGGTTTTTA,14,1950630
ihfAp4,4.571428571428571,37,6,GAAGGCCAAGACCATGGCAG,31,1930546
ihfAp4,0.2857142857142857,7,6,GAAGCTGGTTATATGGGCCA,1,1959180
ihfAp4,3.857142857142857,32,6,GAACCTAAATACCTCACAGT,26,1937422
ihfAp4,4.428571428571429,36,6,GAACCACGTCGGTACAGTTT,30,1951240
ihfAp4,5.285714285714286,42,6,GAACCAAAAAAAGCGAGAAT,36,1958409
ihfAp4,2.7142857142857144,24,6,GAAATTTCTGCTGGGGGGCG,18,1924331
ihfAp4,4.428571428571429,36,6,GAAACGCTGCATCCCCAGTA,30,1932811
ihfAp4,2.142857142857143,20,6,CTTTGGCAAACACGTCACGA,14,1929363
ihfAp4,2.4285714285714284,22,6,CTTGCCTAGACCTTCCAAAT,16,1959126
ihfAp4,11.714285714285714,87,6,CTTGACACTCGAATTAGGTT,81,1948799
ihfAp4,0.42857142857142855,8,6,CTTCCGCGTGCTGTAACCGC,2,1913629
ihfAp4,5.142857142857143,41,6,CTGGTGGGGATAGAGTGTGG,35,1915440
ihfAp4,2.4285714285714284,22,6,CTGGTGAAGATAAGTTTAAC,16,1941841
ihfAp4,3.142857142857143,27,6,CTGGCCACGCGGGCCTTTAT,21,1945658
ihfAp4,2.0,19,6,CTGCTTTAAAGGTAATAATA,13,1924555
ihfAp4,2.857142857142857,25,6,CTGCTCGACGGACTATATAC,19,1939339
ihfAp4,1.8571428571428572,18,6,CTGCCGTAGCTAATTAACGC,12,1942735
ihfAp4,3.4285714285714284,29,6,CTGATAGTAGTCGTCGTTCT,23,1910856
ihfAp4,2.7142857142857144,24,6,CTCCTGATCGACCTGACCAG,18,1953275
ihfAp4,1.5714285714285714,16,6,CTCCAGTATTGGGATCCAGG,10,1937582
ihfAp4,4.0,33,6,CTCAAACTCTCGCACCATAG,27,1960630
ihfAp4,1.8571428571428572,18,6,CTATTGGTTGCGGTCGAGAA,12,1942539
ihfAp4,2.4285714285714284,22,6,CTATTGCTGGCCGATGCGTA,16,1923350
ihfAp4,3.2857142857142856,28,6,CTAGTTTTGAAGGAGCAGAC,22,1956025
ihfAp4,8.571428571428571,65,6,CTACGTCGGGTGCATGGGGT,59,1959625
ihfAp4,6.857142857142857,53,6,CTACATAGTGTGTTGATATG,47,1945416
ihfAp4,2.7142857142857144,24,6,CTAAAAGGGGGACCGACAAG,18,1924228
ihfAp4,13.857142857142858,102,6,CGTTTCCCCGGCTGTTTATG,96,1915808
ihfAp4,4.0,33,6,CGTGGCACGTTAGGTAATAC,27,1927859
ihfAp4,3.2857142857142856,28,6,CGTGACCGGTTCTAGTCTTA,22,1936467
ihfAp4,1.8571428571428572,18,6,CGGTCGTTTAGTTGTCTCTT,12,1959075
ihfAp4,5.428571428571429,43,6,CGGTATGAGCAAGATCTGCG,37,1944841
ihfAp4,2.4285714285714284,22,6,CGGGTCTAGTGCCGGTGGAC,16,1910241
ihfAp4,4.285714285714286,35,6,CGGGGTGTCTCTTTTCTGCT,29,1918294
ihfAp4,7.0,54,6,CGGGCCCCCGAAAGACTCCT,48,1949187
ihfAp4,2.142857142857143,20,6,CGGCCGACTATATTTTACAC,14,1920157
ihfAp4,2.7142857142857144,24,6,CGGAATAAGCATTAAATACT,18,1944293
ihfAp4,11.857142857142858,88,6,CGGAAGTGGACTCTCGGGTG,82,1942552
ihfAp4,3.857142857142857,32,6,CGCTTGTCGTTGTCGGCATT,26,1925279
ihfAp4,1.4285714285714286,15,6,CGCGGGTTGGTCACGTCGAT,9,1943290
ihfAp4,3.5714285714285716,30,6,CGCGGGCACCCAGTGAGGCA,24,1935137
ihfAp4,1.4285714285714286,15,6,CGCGAGCCGGCGGTACGGTG,9,1933491
ihfAp4,2.857142857142857,25,6,CGCCAAGACCCCGGTCAGAT,19,1923398
ihfAp4,2.142857142857143,20,6,CGCATGGTCGAAAAGCTCTA,14,1927293
ihfAp4,2.7142857142857144,24,6,CGATCCACGAACGCCTCTCG,18,1944624
ihfAp4,4.0,33,6,CGAGTATAAGTCGAAATCTC,27,1944813
ihfAp4,3.0,26,6,CGAGCCCTGCAGCTGACGTT,20,1959318
ihfAp4,0.2857142857142857,7,6,CGAGCAGCGGATGACTCGTA,1,1937179
ihfAp4,0.5714285714285714,9,6,CGACGATCCCAAGTTCTGAC,3,1942542
ihfAp4,3.2857142857142856,28,6,CGACGAGTTCCCTCTGTTCT,22,1934449
ihfAp4,6.285714285714286,49,6,CCTTTTTGATGCGTTTCTTC,43,1930368
ihfAp4,6.571428571428571,51,6,CCTTTCCACCGGTGGTAGAG,45,1938525
ihfAp4,1.4285714285714286,15,6,CCTTGAGGTCTTCATTCGCA,9,1928982
ihfAp4,2.7142857142857144,24,6,CCTTCTGTAGAGTTTCGTTC,18,1928309
ihfAp4,2.7142857142857144,24,6,CCTTCAACCCGACGTTACGC,18,1935053
ihfAp4,3.4285714285714284,29,6,CCTCCAGTTGCAATGGATAT,23,1921112
ihfAp4,2.857142857142857,25,6,CCGTGAACGTTAGGCCTCCA,19,1948281
ihfAp4,0.42857142857142855,8,6,CCGTAGTCATTGCAGAGTTT,2,1939063
ihfAp4,3.7142857142857144,31,6,CCGGTCAAAACGCCCTATGG,25,1925325
ihfAp4,0.2857142857142857,7,6,CCGGACAAGTAGCCGGACAG,1,1959981
ihfAp4,1.8571428571428572,18,6,CCGCCACTCTGCAATTTACA,12,1937624
ihfAp4,5.142857142857143,41,6,CCGAATGCGGCCCGTACCTA,35,1914309
ihfAp4,9.0,68,6,CCCTGTGGCATTGAGAACTT,62,1935697
ihfAp4,2.2857142857142856,21,6,CCCTCCATAGACAATGACTA,15,1940517
ihfAp4,2.142857142857143,20,6,CCCCATGCGGCTCGCAATGG,14,1935623
ihfAp4,3.5714285714285716,30,6,CCCAACACAACGAAGGACTT,24,1950179
ihfAp4,3.857142857142857,32,6,CCAGTCTAGAAATTTGATAG,26,1933314
ihfAp4,3.7142857142857144,31,6,CCAGTATAATCTACGGGTGG,25,1912966
ihfAp4,9.857142857142858,74,6,CCAGCGCGCAGGATATGTCT,68,1959273
ihfAp4,0.2857142857142857,7,6,CCAGAGGCGGTGGCTAAGCC,1,1951797
ihfAp4,5.142857142857143,41,6,CCACTTTTCGGTGTGAGTAA,35,1919635
ihfAp4,0.2857142857142857,7,6,CCACTGCTTCAACCGTATTA,1,1923749
ihfAp4,8.428571428571429,64,6,CCACGGAAATAAAGTCGGAG,58,1958455
ihfAp4,2.4285714285714284,22,6,CCAATCTCACGGGTTATGTT,16,1937076
ihfAp4,5.142857142857143,41,6,CATTCTAGTAAAGTCTCCTA,35,1951095
ihfAp4,2.5714285714285716,23,6,CATTCATCGGATATACCTGA,17,1923117
ihfAp4,3.4285714285714284,29,6,CATGTTTTTCACCTAATGTT,23,1956455
ihfAp4,1.2857142857142858,14,6,CATGTGCCTGGGGTGACGAA,8,1929683
ihfAp4,5.285714285714286,42,6,CATGCCGGAGCCGAACCCAC,36,1945920
ihfAp4,2.142857142857143,20,6,CATCACCACAGAGGTGTACC,14,1931438
ihfAp4,4.571428571428571,37,6,CATAGGCTGTCCCGAGCGGG,31,1945358
ihfAp4,0.5714285714285714,9,6,CAGTGCGGATGGGCAAGTAA,3,1932909
ihfAp4,3.7142857142857144,31,6,CAGTCCAAGGGAGTAGTGAG,25,1934140
ihfAp4,2.142857142857143,20,6,CAGGTTTGCAAGGGATACAC,14,1962022
ihfAp4,2.2857142857142856,21,6,CAGGTCTTGAACATGAGATA,15,1955163
ihfAp4,2.0,19,6,CAGGTAGTGAGGACTTGTAA,13,1933247
ihfAp4,0.2857142857142857,7,6,CAGGAACGGCAAATTCCCAT,1,1938208
ihfAp4,3.0,26,6,CAGCTATTCTTTACCTATGT,20,1926320
ihfAp4,2.4285714285714284,22,6,CAGCTAATCAGCTCTTCGGG,16,1918888
ihfAp4,4.285714285714286,35,6,CAGACACAATGACGTTCGCC,29,1944263
ihfAp4,3.5714285714285716,30,6,CAGAATCGTTATCATTCACC,24,1956919
ihfAp4,4.714285714285714,38,6,CAGAATATGTATTATCTATT,32,1941557
ihfAp4,2.142857142857143,20,6,CACTTCATTCACAAAAGCCA,14,1929370
ihfAp4,4.857142857142857,39,6,CACTATGGCCATGTCACTTC,33,1942397
ihfAp4,3.5714285714285716,30,6,CACGGCGTACAGCCAGAACA,24,1951180
ihfAp4,3.7142857142857144,31,6,CACCTGGTGTACTCAACCTT,25,1945323
ihfAp4,0.8571428571428571,11,6,CACCCACAGCCAGGAAACCA,5,1950749
ihfAp4,1.8571428571428572,18,6,CACCATGGATATCCGTACCT,12,1946253
ihfAp4,5.285714285714286,42,6,CACATCAAAGAACTTGAGTG,36,1934402
ihfAp4,6.714285714285714,52,6,CACAACGTCTTTGCGATGTG,46,1918727
ihfAp4,1.7142857142857142,17,6,CACAAATCGTTAATACATGG,11,1959341
ihfAp4,1.4285714285714286,15,6,CAATTGGTAGGGCGTATCGA,9,1931025
ihfAp4,2.5714285714285716,23,6,CAAGTACTTGCACCCCCGTG,17,1937342
ihfAp4,1.2857142857142858,14,6,CAAGGCAATCTCTGAACTGT,8,1954788
ihfAp4,3.5714285714285716,30,6,CAACTGAGGTCAGCTCGTCC,24,1950655
ihfAp4,3.2857142857142856,28,6,CAACCAGACCAAACAGGATT,22,1934770
ihfAp4,9.571428571428571,72,6,CAAATTACTAAAAGTGTCTC,66,1916618
ihfAp4,0.2857142857142857,7,6,CAAATATTGGGCAATGAACC,1,1922915
ihfAp4,1.2857142857142858,14,6,ATTTTTATAACCAAACTTGG,8,1941642
ihfAp4,5.0,40,6,ATTTTGAGTATGTCGCATGG,34,1938887
ihfAp4,0.8571428571428571,11,6,ATTTCACGCCGTCACAGAGA,5,1959055
ihfAp4,3.2857142857142856,28,6,ATTGTGTTTTGACGTGTGAT,22,1941471
ihfAp4,3.5714285714285716,30,6,ATTGTGTGATTCCATCGCGA,24,1925135
ihfAp4,4.285714285714286,35,6,ATTGAGATAGACACGGAAAC,29,1942176
ihfAp4,1.2857142857142858,14,6,ATTGACTGGGTATTTTTGCC,8,1958374
ihfAp4,4.285714285714286,35,6,ATTCGGTGGGAAGCCGCTTC,29,1952716
ihfAp4,5.142857142857143,41,6,ATTCCTCCTCCAGACGCATT,35,1941644
ihfAp4,2.5714285714285716,23,6,ATTCACACTCCCCCGCTGAT,17,1949404
ihfAp4,2.4285714285714284,22,6,ATGTGTTTTCGGAATACTCG,16,1913138
ihfAp4,0.2857142857142857,7,6,ATGTCTGATCACAATTTAGA,1,1954992
ihfAp4,1.7142857142857142,17,6,ATGTATTCGTATGACGACCT,11,1958139
ihfAp4,1.4285714285714286,15,6,ATGGTCTGGAGGAGGCCTAA,9,1958127
ihfAp4,3.2857142857142856,28,6,ATGGTAGGCCCACGTTTATG,22,1959520
ihfAp4,11.285714285714286,84,6,ATGGGGCGAGGTCCTGACAA,78,1935866
ihfAp4,3.857142857142857,32,6,ATGGGCTGCTTCTGCCCCCT,26,1946770
ihfAp4,0.2857142857142857,7,6,ATGCTGGTCACATCTATATG,1,1913554
ihfAp4,3.4285714285714284,29,6,ATGCTATCTTCGTCAATTTG,23,1957861
ihfAp4,3.142857142857143,27,6,ATGCCAGGGAGGCCAGGCCT,21,1924965
ihfAp4,2.4285714285714284,22,6,ATGCAGTTGAAAACGCAATG,16,1939431
ihfAp4,1.8571428571428572,18,6,ATGAGATTGCACTTTTCCGG,12,1919791
ihfAp4,4.142857142857143,34,6,ATCTGGACTACACATTCTAA,28,1943143
ihfAp4,0.2857142857142857,7,6,ATCGACTTGTGTACCGTGGG,1,1955048
ihfAp4,8.428571428571429,64,6,ATCCGCATTTGCCCTCGACC,58,1919835
ihfAp4,2.5714285714285716,23,6,ATCCACCCCCGCGCAAGTGC,17,1946229
ihfAp4,0.5714285714285714,9,6,ATCAAGCCGGCTGCTGGTCG,3,1913310
ihfAp4,9.142857142857142,69,6,ATATGGACCGAAGTGACTGT,63,1922379
ihfAp4,2.857142857142857,25,6,ATATCCATATTCGATCTCCT,19,1924320
ihfAp4,2.5714285714285716,23,6,ATAGCTGCCCGTGCGAAAGA,17,1947682
ihfAp4,3.4285714285714284,29,6,ATACCTTAGATGTCCGTGGA,23,1915692
ihfAp4,7.714285714285714,59,6,ATACAATAATGCTCGTTTAG,53,1944200
ihfAp4,3.2857142857142856,28,6,ATAAAAGTACGAGACGGCCG,22,1957481
ihfAp4,0.2857142857142857,7,6,AGTTTCATATTCGGACTCCT,1,1917730
ihfAp4,3.857142857142857,32,6,AGTTGTCCACGAAGCTTTGG,26,1924638
ihfAp4,10.571428571428571,79,6,AGTGGTATTCACCCTCTGTC,73,1950071
ihfAp4,2.142857142857143,20,6,AGTCGTCTCGGGCTCCCCTA,14,1940778
ihfAp4,0.2857142857142857,7,6,AGTCCTACAGAGGTAATCCC,1,1958899
ihfAp4,3.7142857142857144,31,6,AGTACGGTGGCTTGTTTCAA,25,1920038
ihfAp4,2.4285714285714284,22,6,AGGTCTGCATTCGTATCTAC,16,1960589
ihfAp4,5.0,40,6,AGGGGTTAGCAATTCGGGGA,34,1943969
ihfAp4,3.142857142857143,27,6,AGGGGTATAAATAAGAGTTA,21,1943593
ihfAp4,9.0,68,6,AGGGATTTTTAGAACCGCGA,62,1924062
ihfAp4,8.142857142857142,62,6,AGGGAGGGAGTCTAGTTACG,56,1938350
ihfAp4,0.2857142857142857,7,6,AGGCACGGTCTAATATTTGC,1,1936200
ihfAp4,1.1428571428571428,13,6,AGGATCATCAGTTGGCTGGA,7,1957469
ihfAp4,1.4285714285714286,15,6,AGGATAGTCAGCCCCAGTAG,9,1929526
ihfAp4,7.428571428571429,57,6,AGGAGAGTGATGATACTGCC,51,1915288
ihfAp4,2.2857142857142856,21,6,AGCTCTACGCTATTCCCAGA,15,1911102
ihfAp4,3.2857142857142856,28,6,AGCGGTATAGTAGGCGCACG,22,1942991
ihfAp4,3.4285714285714284,29,6,AGCGGCACTGGTGCGTGTAA,23,1928552
ihfAp4,2.2857142857142856,21,6,AGCCTATGTGCTCCTTGACT,15,1926280
ihfAp4,1.5714285714285714,16,6,AGCAGAAGGCGATCGGCGAA,10,1946840
ihfAp4,4.285714285714286,35,6,AGATGGAGTTTCAAGTATGT,29,1946440
ihfAp4,0.42857142857142855,8,6,AGATGCAACATCATTGATCA,2,1942877
ihfAp4,3.5714285714285716,30,6,AGATATCGATTAATCCTTCC,24,1952991
ihfAp4,6.285714285714286,49,6,AGATACAGAGCTCTATATTG,43,1938933
ihfAp4,8.428571428571429,64,6,AGAGACGTCCGGCAGCTTTT,58,1958843
ihfAp4,1.8571428571428572,18,6,AGACCGTAAAACTAGACGGA,12,1961426
ihfAp4,5.142857142857143,41,6,AGACCCCCCTGGCGAGTTGT,35,1940120
ihfAp4,5.571428571428571,44,6,AGACAGGGGTTTAACTCAAG,38,1910015
ihfAp4,7.428571428571429,57,6,AGAAGTTAACGGTGATAGGT,51,1934066
ihfAp4,6.0,47,6,ACTTAGGCAGCAAAACAAAT,41,1943759
ihfAp4,2.4285714285714284,22,6,ACTGTGATCGCGCAATATTA,16,1915461
ihfAp4,9.428571428571429,71,6,ACTCTGGAGAAGCAGATTTC,65,1925574
ihfAp4,1.7142857142857142,17,6,ACTCGCCGATTTGGGCTTCC,11,1921043
ihfAp4,0.2857142857142857,7,6,ACTCGAACGAAACGATAGGG,1,1946872
ihfAp4,0.2857142857142857,7,6,ACGTTTCAGGTATGTAACAT,1,1935510
ihfAp4,3.5714285714285716,30,6,ACGGGAGGAAGGCATGGCAT,24,1938305
ihfAp4,2.857142857142857,25,6,ACGGACCCGCGAGAATTGTA,19,1937813
ihfAp4,3.0,26,6,ACGATTTCTAGCTTATTCGT,20,1955346
ihfAp4,1.8571428571428572,18,6,ACGACTTACCCTGACTTGGA,12,1954299
ihfAp4,2.857142857142857,25,6,ACCTGTCACCGGCTTTCGAC,19,1953404
ihfAp4,0.2857142857142857,7,6,ACCTGAAATCCTTCCGCTGG,1,1922892
ihfAp4,3.5714285714285716,30,6,ACCTCCGCAGCTAAATCAGG,24,1938569
ihfAp4,1.8571428571428572,18,6,ACCGGTGCTGCGGTGAAAAG,12,1917427
ihfAp4,4.285714285714286,35,6,ACCGGTACGGTGGGGTGGTG,29,1926147
ihfAp4,3.0,26,6,ACCCGGTCGGCTCGGCGATG,20,1947703
ihfAp4,0.8571428571428571,11,6,ACCCCTACTTCGTAAAGTTT,5,1915646
ihfAp4,1.0,12,6,ACCCACAGACATTCGTTTCT,6,1952686
ihfAp4,2.4285714285714284,22,6,ACCAGCTGATGAACTTCATC,16,1948782
ihfAp4,2.4285714285714284,22,6,ACCACTTCCTTCGTGGTCAA,16,1934622
ihfAp4,10.714285714285714,80,6,ACCAAATAAAGATTGCTTAC,74,1922253
ihfAp4,6.142857142857143,48,6,ACATGGCGGCTCGTTCGGAC,42,1956804
ihfAp4,13.0,96,6,ACATATAACTATTTAGGAAT,90,1957355
ihfAp4,1.8571428571428572,18,6,ACAGGTGACCGAACTTTGAT,12,1914410
ihfAp4,0.2857142857142857,7,6,ACAGCTAGATCGCCAAACAC,1,1917273
ihfAp4,1.4285714285714286,15,6,AATTTGGGGTTACTGATATC,9,1944126
ihfAp4,4.571428571428571,37,6,AATTGGCACACTTGGTGACA,31,1927613
ihfAp4,5.285714285714286,42,6,AATTCATCGCGATGTTCGCC,36,1939300
ihfAp4,1.7142857142857142,17,6,AATCGCTCATGTTCCGAAGC,11,1961494
ihfAp4,2.4285714285714284,22,6,AATCGCAAGTCCAATGAATA,16,1947531
ihfAp4,8.571428571428571,65,6,AATCCGTGCATCTTTAACTA,59,1910070
ihfAp4,5.571428571428571,44,6,AATATCGTAACCTTGGTATT,38,1946465
ihfAp4,9.142857142857142,69,6,AAGTTGCTACTTTAAACATA,63,1929163
ihfAp4,1.1428571428571428,13,6,AAGTGGTACTTAATTCTTGC,7,1937632
ihfAp4,2.2857142857142856,21,6,AAGTACTAACCCAAATCAAG,15,1913284
ihfAp4,3.142857142857143,27,6,AAGGTTGAATACCTTTCTAT,21,1960294
ihfAp4,4.285714285714286,35,6,AAGGTCGAGACGTGAGTTGA,29,1920185
ihfAp4,0.8571428571428571,11,6,AAGGGTTGAGTCATTTAGAA,5,1925179
ihfAp4,2.857142857142857,25,6,AAGCGGCGCGCCTAATTAAC,19,1923367
ihfAp4,2.4285714285714284,22,6,AAGCCTTTCTTGGAGGTGGT,16,1925228
ihfAp4,6.0,47,6,AAGATTTTCTAATAACCTCG,41,1943590
ihfAp4,1.1428571428571428,13,6,AAGATGGCCGCCCACCGGGT,7,1929586
ihfAp4,12.428571428571429,92,6,AAGATCACCATTAGAGTGGT,86,1913590
ihfAp4,5.714285714285714,45,6,AACTGGGCTAGGAGTGCTTC,39,1911039
ihfAp4,4.0,33,6,AACTACGGGTAGTCAGCGGA,27,1919576
ihfAp4,3.857142857142857,32,6,AACGTTTATGCTAATTATAG,26,1943930
ihfAp4,0.2857142857142857,7,6,AACACTCTCGACATGTAAGC,1,1956536
ihfAp4,7.857142857142857,60,6,AACACGACACATAAGACGCT,54,1925585
ihfAp4,26.428571428571427,190,6,AAATGTGGTGAGCGCTCTTC,184,1958028
ihfAp4,1.5714285714285714,16,6,AAATACCGAAAAGACAGACT,10,1960927
ihfAp4,3.0,26,6,AAAGTGCGAGCGCCGAAGCA,20,1933843
ihfAp4,0.5714285714285714,9,6,AAAGGGAAACCCAAGGTCCA,3,1951002
ihfAp4,0.42857142857142855,8,6,AAAGGCACTGAAAGATGACA,2,1955181
ihfAp4,2.2857142857142856,21,6,AAAGCGACCTGCTCTGTTGC,15,1933487
ihfAp4,5.428571428571429,43,6,AAACCTGTCGATCACCTGCG,37,1929705
ihfAp4,4.857142857142857,39,6,AAAACTGCCAGTATGTTGAA,33,1959506
ihfAp4,2.4285714285714284,22,6,AAAACTCCCGAAACCGCACA,16,1940360
ihfAp4,0.6666666666666666,8,5,TTTTTCATGGCAGCCGTCGA,3,1926840
ihfAp4,0.5,7,5,TTTTCCGGCATTTTGTCATT,2,1922374
ihfAp4,0.3333333333333333,6,5,TTTGGCCGAATGAGTTGATT,1,1920239
ihfAp4,4.833333333333333,33,5,TTTGCTGTTCACTATATTTA,28,1951878
ihfAp4,16.333333333333332,102,5,TTTGCTCCCTCGCTGGATGC,97,1915727
ihfAp4,0.6666666666666666,8,5,TTTCTGGACTGTCGAGCTAC,3,1919749
ihfAp4,2.8333333333333335,21,5,TTTCTACATTGGCTTTGTCA,16,1951485
ihfAp4,5.666666666666667,38,5,TTTCGTGGGACAGAAGGTTG,33,1953567
ihfAp4,1.6666666666666667,14,5,TTTCATTGTGACATCACACA,9,1933845
ihfAp4,2.6666666666666665,20,5,TTTATGGGTATATTCAAGAG,15,1915129
ihfAp4,2.6666666666666665,20,5,TTTAGTAGCTGATTCGTAGT,15,1959340
ihfAp4,4.666666666666667,32,5,TTTACGTAAATGGTTCACTA,27,1945796
ihfAp4,7.833333333333333,51,5,TTGGTTTCTAATCTCCCGCC,46,1947910
ihfAp4,3.3333333333333335,24,5,TTGGTCATGGCCGTTTGTCC,19,1930657
ihfAp4,3.1666666666666665,23,5,TTGGAGGCAGCAGATGTTTG,18,1926318
ihfAp4,3.6666666666666665,26,5,TTGCGACGCAATGAGGTCTA,21,1949402
ihfAp4,9.333333333333334,60,5,TTGCAAGCTTACGTACTCAC,55,1913787
ihfAp4,7.0,46,5,TTCTCGCATCTGTATAAGAC,41,1921929
ihfAp4,0.3333333333333333,6,5,TTCTACTCACATTCGCATCT,1,1919624
ihfAp4,1.3333333333333333,12,5,TTCGTTCCTTTGTGTTCATG,7,1923941
ihfAp4,0.3333333333333333,6,5,TTCGTAGCACTACTAACGCT,1,1918181
ihfAp4,0.3333333333333333,6,5,TTCGGTGGCTAGGGATTTAA,1,1949762
ihfAp4,2.5,19,5,TTCGCTCGATACTTCTACGC,14,1953690
ihfAp4,4.166666666666667,29,5,TTCCATAGGCGAGCGGCCCC,24,1928270
ihfAp4,0.5,7,5,TTCAAATGAATTATGTTACT,2,1928237
ihfAp4,4.333333333333333,30,5,TTAGAAACTACCTCCTAGTG,25,1945496
ihfAp4,2.5,19,5,TTACGCTAGATGCATTGCAG,14,1912025
ihfAp4,3.6666666666666665,26,5,TTACCTACCCCAATTAGACC,21,1928429
ihfAp4,2.5,19,5,TTACCATGCTTCTGATGAGA,14,1916460
ihfAp4,3.6666666666666665,26,5,TTACAGTCACTTGTGGCGGC,21,1958466
ihfAp4,3.5,25,5,TTAAGTCATGGGTTGGACTT,20,1956850
ihfAp4,2.8333333333333335,21,5,TTAACACGTGTCTGTGGCGT,16,1933970
ihfAp4,3.3333333333333335,24,5,TGTTGGGCGAGATTTTGCTT,19,1947761
ihfAp4,8.333333333333334,54,5,TGTTGCGTGAGACTTCGAGG,49,1946248
ihfAp4,6.333333333333333,42,5,TGTTCCGCTTTTAATCAAGG,37,1925366
ihfAp4,5.833333333333333,39,5,TGTGTCACTCCTAAGTAGAC,34,1922062
ihfAp4,4.0,28,5,TGTCTAGCCTAGTGAACAAG,23,1920253
ihfAp4,12.166666666666666,77,5,TGTCGCCGGCTAAGCGCGTT,72,1919666
ihfAp4,10.666666666666666,68,5,TGTATGTGCGGCCCGGCAAG,63,1916696
ihfAp4,0.3333333333333333,6,5,TGTAGGGCAAATGACGGTAA,1,1922933
ihfAp4,1.8333333333333333,15,5,TGTAGGCATGATTCCGATAG,10,1945308
ihfAp4,2.5,19,5,TGTACAACATCGGCTCTAGG,14,1933094
ihfAp4,2.1666666666666665,17,5,TGGTACAAAGTCATTGTGTT,12,1948791
ihfAp4,4.166666666666667,29,5,TGGGTTGCAAGGGAGCCTCA,24,1946568
ihfAp4,8.166666666666666,53,5,TGGGGAATTCGACACCTAGA,48,1921791
ihfAp4,6.5,43,5,TGGCTCGGCTGTGTATTGCC,38,1954028
ihfAp4,2.3333333333333335,18,5,TGGCTCCGCGCCCATAATCT,13,1918348
ihfAp4,0.3333333333333333,6,5,TGGCGGAAAATAATCCGTCT,1,1944410
ihfAp4,7.666666666666667,50,5,TGCTGCCTCGTGCAATGAGA,45,1925030
ihfAp4,1.0,10,5,TGCTGCAACTTATCTGGGAA,5,1913331
ihfAp4,9.666666666666666,62,5,TGCTCGTCATGAGATAGACA,57,1929655
ihfAp4,0.3333333333333333,6,5,TGCTCGGTACAGACGTTTGG,1,1942661
ihfAp4,9.333333333333334,60,5,TGCCCTTGTCAGTGATTGCC,55,1948770
ihfAp4,0.5,7,5,TGCAGCTCGCAAATTTCGCT,2,1952514
ihfAp4,0.6666666666666666,8,5,TGATGCCGGGGCAACTGGAT,3,1913624
ihfAp4,2.3333333333333335,18,5,TGAGCGGCATCTCGGCAGTT,13,1918816
ihfAp4,3.8333333333333335,27,5,TGAGAGGAGCGAACAGTTAC,22,1962080
ihfAp4,5.666666666666667,38,5,TGAGACCTTGCTTCTCGACT,33,1945223
ihfAp4,6.166666666666667,41,5,TGACACCAATGTCGGGACAA,36,1948036
ihfAp4,3.5,25,5,TGAATACGAACCGGTCTTGG,20,1917099
ihfAp4,0.3333333333333333,6,5,TGAATACCAAATTGTATCCT,1,1919668
ihfAp4,4.333333333333333,30,5,TGAAGCTATAGACTAGCAGC,25,1916611
ihfAp4,1.1666666666666667,11,5,TCTTTCCGGGCTATCAGACT,6,1931397
ihfAp4,4.5,31,5,TCTTTACGCTCCACTGTGAT,26,1952451
ihfAp4,3.8333333333333335,27,5,TCTCATAGACTATTCCCGGC,22,1924711
ihfAp4,3.6666666666666665,26,5,TCTCAATTAGCGTCCCTCAT,21,1950413
ihfAp4,3.8333333333333335,27,5,TCTAGTTCATCGATTACCCG,22,1954332
ihfAp4,6.833333333333333,45,5,TCTAGGAACTCAGAGCGAAG,40,1947433
ihfAp4,3.3333333333333335,24,5,TCTACGCTGCTTCCACCCCC,19,1930306
ihfAp4,0.3333333333333333,6,5,TCGTTGGATATGGGTAGACT,1,1942399
ihfAp4,1.5,13,5,TCGTTAGCCTGGGATACAGA,8,1934124
ihfAp4,0.3333333333333333,6,5,TCGTCGGTCTTCTCATATCT,1,1933987
ihfAp4,4.666666666666667,32,5,TCGTCCACTTCCGCTAGCGG,27,1958952
ihfAp4,2.0,16,5,TCGTATTAAAGCGGAGCTCC,11,1922684
ihfAp4,10.666666666666666,68,5,TCGGATGACGGGATCCTCGT,63,1935285
ihfAp4,0.6666666666666666,8,5,TCGGATCTGAATTAGGGACT,3,1931417
ihfAp4,10.666666666666666,68,5,TCGCGTGATTAAATTTTATC,63,1944542
ihfAp4,6.166666666666667,41,5,TCGCCCAGTGAACAGACATG,36,1961759
ihfAp4,3.8333333333333335,27,5,TCGCAGTAAACCCGAGGAAT,22,1912153
ihfAp4,4.833333333333333,33,5,TCGAGGGTCGTGCAGGCATT,28,1949111
ihfAp4,1.3333333333333333,12,5,TCGACTACATATCATGTCGT,7,1939553
ihfAp4,0.3333333333333333,6,5,TCCGTATCACCCGTAAACGT,1,1946882
ihfAp4,3.5,25,5,TCCCCGTTCATGACAGACTA,20,1948629
ihfAp4,3.5,25,5,TCCCATCCTGCCTGGGCCCC,20,1922651
ihfAp4,4.0,28,5,TCCATCCTTCATCACCTTCA,23,1921005
ihfAp4,5.833333333333333,39,5,TCCACTTACTATTGGCACTA,34,1955170
ihfAp4,4.666666666666667,32,5,TCCAAACGGTTTTGATGTTA,27,1916688
ihfAp4,5.166666666666667,35,5,TCAGGGGATCTGATGCAGTA,30,1952070
ihfAp4,14.0,88,5,TCACTCTGGACGCGCACGTT,83,1955353
ihfAp4,2.0,16,5,TCACAGTGCGAGTACTGAAG,11,1937736
ihfAp4,0.3333333333333333,6,5,TATTGCGGTGTGGGACGGAT,1,1935708
ihfAp4,5.0,34,5,TATTCCATGTGTGGAAGCGA,29,1960606
ihfAp4,0.8333333333333334,9,5,TATTATGGGGGTTACCAATG,4,1951834
ihfAp4,1.0,10,5,TATTAGATAAGTGTCGCAAA,5,1920457
ihfAp4,2.8333333333333335,21,5,TATTACATAGCTTCCACCTG,16,1949919
ihfAp4,1.5,13,5,TATTAAAACAGGGTGATCCA,8,1953361
ihfAp4,3.8333333333333335,27,5,TATGCGCAAACCTGATTCGA,22,1929538
ihfAp4,3.0,22,5,TATCGGGCTGAAGTCACTAT,17,1943436
ihfAp4,2.3333333333333335,18,5,TATCCATACTAGGTGCCTTT,13,1949812
ihfAp4,27.666666666666668,170,5,TATATCTGGACAGACCCGGA,165,1933178
ihfAp4,8.833333333333334,57,5,TAGCGATGCCACATGCTAGG,52,1946526
ihfAp4,4.166666666666667,29,5,TAGCACGTATTGGGGGCGCA,24,1915267
ihfAp4,3.3333333333333335,24,5,TAGAGAAGCAAAACTGTTTA,19,1932223
ihfAp4,7.666666666666667,50,5,TAGACTACGTTGCCTTCCTG,45,1918538
ihfAp4,0.6666666666666666,8,5,TAGACCTAAATTGTACATGA,3,1944845
ihfAp4,4.0,28,5,TACTAAGTGCCCAACACAAA,23,1931604
ihfAp4,6.666666666666667,44,5,TACGTGTTGACCCTGGGTTG,39,1949116
ihfAp4,4.0,28,5,TACCCTAAATCTTGTATAAC,23,1958419
ihfAp4,3.0,22,5,TACAGAGTTTTGTGGGTTCC,17,1923278
ihfAp4,1.8333333333333333,15,5,TACACCTCCAGGATTTTCCA,10,1949639
ihfAp4,10.833333333333334,69,5,TACACATTATTTCGCAGCCC,64,1929540
ihfAp4,4.333333333333333,30,5,TAATTTCCCTACAACAATCT,25,1915198
ihfAp4,4.666666666666667,32,5,TAATTAGGATCATGCTATCT,27,1937147
ihfAp4,15.0,94,5,TAATCGATCCCGTGTTTATG,89,1926317
ihfAp4,4.833333333333333,33,5,TAATACGAAAGTGGTTACCT,28,1921589
ihfAp4,12.166666666666666,77,5,TAAGTTGCTCGGCATATAAA,72,1948920
ihfAp4,3.6666666666666665,26,5,TAAGCTTGTGCGGACCACAC,21,1932050
ihfAp4,2.3333333333333335,18,5,TAACAGACGTTCGCCGTCGG,13,1933578
ihfAp4,2.1666666666666665,17,5,GTTTTCGTCGTATTTTACCT,12,1938104
ihfAp4,6.833333333333333,45,5,GTTTGGAGACGAGTTTAACT,40,1932456
ihfAp4,3.1666666666666665,23,5,GTTTCCTTGGCTTGCGAGAT,18,1937344
ihfAp4,0.3333333333333333,6,5,GTTGTTATGCAATAAAAATC,1,1946042
ihfAp4,4.5,31,5,GTTGCCGAAGTTGCGCATAC,26,1933782
ihfAp4,2.3333333333333335,18,5,GTTGATGATATTAGTGCGTC,13,1958014
ihfAp4,14.666666666666666,92,5,GTTCTAGTAAGGATATGAGT,87,1925407
ihfAp4,14.833333333333334,93,5,GTTCGTATCGCTGACGCGAA,88,1961021
ihfAp4,5.833333333333333,39,5,GTTCGATTCCCAGGGTTGTT,34,1911352
ihfAp4,24.5,151,5,GTTCACGTCTAACTGTCCCT,146,1932203
ihfAp4,3.8333333333333335,27,5,GTTAATGTTCCAATAGGTAC,22,1930191
ihfAp4,5.666666666666667,38,5,GTGTTCTTGTTCTTTTAATT,33,1916102
ihfAp4,1.5,13,5,GTGTGGGAAACGGAACTTAG,8,1948015
ihfAp4,3.5,25,5,GTGGGTTCATCTGGGTTGGC,20,1955898
ihfAp4,4.833333333333333,33,5,GTGGGCAGGGTTCGCCTCGT,28,1914102
ihfAp4,1.0,10,5,GTGCTTATGTGCTCAATTCT,5,1949234
ihfAp4,3.6666666666666665,26,5,GTGCTCCTTAGTCCGGGTTC,21,1926358
ihfAp4,9.666666666666666,62,5,GTGCCGTCGTTCTCGCACGG,57,1949948
ihfAp4,3.3333333333333335,24,5,GTGATAGAAGGTCACCTATC,19,1927977
ihfAp4,2.6666666666666665,20,5,GTGACAGAACGGGTGACCGT,15,1920863
ihfAp4,6.166666666666667,41,5,GTGACACATGTCGAGCTGAC,36,1951121
ihfAp4,5.166666666666667,35,5,GTCTTCTCTCGTCTCCTTGA,30,1950199
ihfAp4,3.8333333333333335,27,5,GTCGCGGTCACTGGGATAAG,22,1914016
ihfAp4,0.3333333333333333,6,5,GTCCGGTGTTGGGCACCGAA,1,1936831
ihfAp4,2.8333333333333335,21,5,GTCCCCGGTCTGACAAGAGT,16,1953527
ihfAp4,4.0,28,5,GTCAGCTATTACACTTGGCT,23,1950220
ihfAp4,3.3333333333333335,24,5,GTCAGAGAACAGGCCAGGCC,19,1938663
ihfAp4,1.6666666666666667,14,5,GTCAAGGAAACGGCACCTGG,9,1918018
ihfAp4,6.333333333333333,42,5,GTATCTTCACGGGATCTAAT,37,1920118
ihfAp4,1.5,13,5,GTAGGTAGGCACAAATTTTT,8,1948237
ihfAp4,6.5,43,5,GTAGAATCCTACACATCGCT,38,1918056
ihfAp4,2.1666666666666665,17,5,GGTTTGGCTTTGTGAGGCCT,12,1929143
ihfAp4,4.166666666666667,29,5,GGTTGCCACGCATCCCCAAT,24,1959362
ihfAp4,4.5,31,5,GGTTAAGTCACTACACTATC,26,1909806
ihfAp4,0.3333333333333333,6,5,GGTGTTGCAAATTCACCTGG,1,1951811
ihfAp4,6.333333333333333,42,5,GGTGTAAGTGGTATTGTTGA,37,1914956
ihfAp4,0.6666666666666666,8,5,GGTGCAGACCATCGGGACCA,3,1945647
ihfAp4,7.166666666666667,47,5,GGTGACTAATTGAGTAGCCG,42,1935312
ihfAp4,1.5,13,5,GGTCTTGTTAATCTATGCTG,8,1949726
ihfAp4,2.8333333333333335,21,5,GGTCTTCGGTTGACGGTGTG,16,1911656
ihfAp4,1.8333333333333333,15,5,GGTAGAACATTTCATTGAAT,10,1960139
ihfAp4,4.0,28,5,GGTACATGGTCGAGGACCGT,23,1940254
ihfAp4,5.333333333333333,36,5,GGGTCCATTGACAAAGCCAC,31,1959870
ihfAp4,1.8333333333333333,15,5,GGGGGGATGACTGGCGGTTG,10,1949803
ihfAp4,1.3333333333333333,12,5,GGGCTATACAGACGGCACAC,7,1926279
ihfAp4,3.6666666666666665,26,5,GGGCGTAAAAAACTCTGTGG,21,1912586
ihfAp4,4.0,28,5,GGGAGGACCCGAACCGGGGA,23,1941958
ihfAp4,7.0,46,5,GGGACGATTCTCATTTCAGC,41,1909693
ihfAp4,2.6666666666666665,20,5,GGCTGATTCTACGGTGGATG,15,1927661
ihfAp4,5.666666666666667,38,5,GGCAAGTAAAGAATCATGTT,33,1919091
ihfAp4,4.5,31,5,GGATGTCCGTGCTCGTTCTG,26,1929871
ihfAp4,5.0,34,5,GGATGGCCCACCGTCCTGTT,29,1960444
ihfAp4,2.3333333333333335,18,5,GGAGTAACGGACTACTACGG,13,1960049
ihfAp4,6.666666666666667,44,5,GGAGCGGGGTTAAGGTAATT,39,1943277
ihfAp4,3.0,22,5,GGAGCCCCATTGGGTTCATC,17,1943872
ihfAp4,0.3333333333333333,6,5,GGACGTGTAACATAACGTAA,1,1932161
ihfAp4,4.833333333333333,33,5,GGACAAGAAGGGCACAAGGT,28,1930793
ihfAp4,13.166666666666666,83,5,GGAACAACAAACATACCATA,78,1926203
ihfAp4,2.1666666666666665,17,5,GCTTTTAGAACACTGCCAGC,12,1950910
ihfAp4,12.0,76,5,GCTGCAGCAACAACACAGCT,71,1941650
ihfAp4,3.0,22,5,GCTCTGCCTGCTTGATCAGT,17,1936645
ihfAp4,2.5,19,5,GCTCGTTTAGTTGGATACGT,14,1939432
ihfAp4,2.8333333333333335,21,5,GCTCGTGGGAGGTACCCCTA,16,1920225
ihfAp4,3.8333333333333335,27,5,GCGTTATCGCCACCGGTCTC,22,1914370
ihfAp4,0.3333333333333333,6,5,GCGTAATTCTCTCATACCAT,1,1918866
ihfAp4,0.8333333333333334,9,5,GCGCTCGCCAGTAGCATTCA,4,1930129
ihfAp4,0.3333333333333333,6,5,GCGCAGAAATCTGCAATACC,1,1915841
ihfAp4,1.8333333333333333,15,5,GCGCAATGATGTAAGCCCGA,10,1929010
ihfAp4,4.333333333333333,30,5,GCGACTCCCGTTGATTCGTG,25,1946711
ihfAp4,5.5,37,5,GCGAATTCGCCCCATTACCT,32,1934638
ihfAp4,2.5,19,5,GCGAAAAGGGGTGCGGCAGG,14,1941360
ihfAp4,2.8333333333333335,21,5,GCCTTGAATTAAACTTGTAC,16,1916383
ihfAp4,3.8333333333333335,27,5,GCCTAGTAAGTTAAGCGAAG,22,1930402
ihfAp4,12.333333333333334,78,5,GCCATGCGAAAGTACGGGTA,73,1959000
ihfAp4,4.5,31,5,GCCATGCATAACGAGCACCC,26,1950035
ihfAp4,15.666666666666666,98,5,GCATGCTCCCAAGAGCTACT,93,1941454
ihfAp4,5.0,34,5,GCAGGTGCCTTAAACATGGT,29,1938304
ihfAp4,1.8333333333333333,15,5,GCAGAGCAACGTAATGACTA,10,1912227
ihfAp4,0.6666666666666666,8,5,GCAGACGTCGTTGCAGCCCA,3,1912545
ihfAp4,5.833333333333333,39,5,GCACTCTCGCACCGGTTTAA,34,1923570
ihfAp4,10.5,67,5,GCACCTAGGAGAATCAGCGA,62,1937625
ihfAp4,4.0,28,5,GCACACTACCAGGTATCGTA,23,1915028
ihfAp4,6.0,40,5,GATTTACCACCTTTATCACG,35,1937386
ihfAp4,4.166666666666667,29,5,GATTGAACTTTGCAAAAATC,24,1911349
ihfAp4,0.3333333333333333,6,5,GATTAGAAATTCAAGACCGG,1,1924441
ihfAp4,3.8333333333333335,27,5,GATGAGAGTCCTCTTACTGC,22,1943689
ihfAp4,3.1666666666666665,23,5,GATGAAGTTAATGCCCGAAA,18,1921204
ihfAp4,4.0,28,5,GATCGTCATCCTTAGTTTCT,23,1925245
ihfAp4,4.5,31,5,GATCGATGCCGTACTACTAT,26,1917677
ihfAp4,0.6666666666666666,8,5,GATCGAAGTATGCACCCAGG,3,1925890
ihfAp4,18.166666666666668,113,5,GATAGTTTTCGGCAGGGCTT,108,1942446
ihfAp4,1.0,10,5,GATAAACAGTGCACCCGTTT,5,1915131
ihfAp4,4.166666666666667,29,5,GAGTGAGCACTCACGGCGGA,24,1941972
ihfAp4,6.666666666666667,44,5,GAGTAAGCGTGCATTTTGTG,39,1959990
ihfAp4,2.1666666666666665,17,5,GAGGAGCCTTTACCAACCGA,12,1945113
ihfAp4,2.1666666666666665,17,5,GAGATGGGAAGTCGCATGTT,12,1930676
ihfAp4,6.666666666666667,44,5,GAGAGCGGATCAACGAACGA,39,1921938
ihfAp4,2.3333333333333335,18,5,GAGAAGTCTGGCTTAACAGA,13,1928122
ihfAp4,0.3333333333333333,6,5,GACTGAGCGCCGTGGACTAG,1,1933713
ihfAp4,1.8333333333333333,15,5,GACTCCGTCTCCCGTCCCGA,10,1949191
ihfAp4,4.666666666666667,32,5,GACTACAATATTACTATGTT,27,1930745
ihfAp4,2.3333333333333335,18,5,GACGTTCTAGCGTTCCAAGC,13,1942386
ihfAp4,3.8333333333333335,27,5,GACGTGTCGCTCGCCGGATT,22,1942783
ihfAp4,4.333333333333333,30,5,GACGGCATTACCTAGTAGAG,25,1935061
ihfAp4,0.3333333333333333,6,5,GACGGACCTAGGTAGGACTA,1,1935044
ihfAp4,3.0,22,5,GACGATTTGAGCTGGGTCTG,17,1927456
ihfAp4,4.333333333333333,30,5,GACCCTCTCTGGGTAAATTG,25,1926191
ihfAp4,3.3333333333333335,24,5,GACCATTAGCTACGGGACCT,19,1923870
ihfAp4,1.1666666666666667,11,5,GACCAGCACAGTAAGGGCTT,6,1919015
ihfAp4,5.5,37,5,GACACGCGCGCGGGGCGCAA,32,1956995
ihfAp4,2.5,19,5,GAAGAATACGATGGGAATCA,14,1913981
ihfAp4,3.0,22,5,GAACCTGTGTCCATATTGAA,17,1949969
ihfAp4,0.3333333333333333,6,5,GAAATAGGAAGCAGAGTCAC,1,1933048
ihfAp4,9.5,61,5,CTTTTTAGTTCGAGCCGCTG,56,1960948
ihfAp4,2.1666666666666665,17,5,CTTTATGGATGAGCCGCCCT,12,1933984
ihfAp4,0.6666666666666666,8,5,CTTTAGACCATTTGCTGAGT,3,1954286
ihfAp4,4.166666666666667,29,5,CTTGTGAACCCCACGGGCAA,24,1931434
ihfAp4,3.3333333333333335,24,5,CTTGCCCTGCCGCAACATTG,19,1955517
ihfAp4,0.3333333333333333,6,5,CTTGCCCATGGTGGCCTATT,1,1919691
ihfAp4,9.5,61,5,CTTCGTTTTTGTCACTTACT,56,1923827
ihfAp4,9.0,58,5,CTTCGGGGAATCACCACAAT,53,1942196
ihfAp4,2.5,19,5,CTTAGCCCATGTCCGCGTAG,14,1935467
ihfAp4,7.833333333333333,51,5,CTTAATTAGTGCCCTAACTC,46,1921889
ihfAp4,21.666666666666668,134,5,CTGGTAGTAGGGCAACCACG,129,1946161
ihfAp4,3.1666666666666665,23,5,CTGGTAGGGGTTCAAGAACG,18,1912844
ihfAp4,1.8333333333333333,15,5,CTGGAGTGTTCAAACGCGCC,10,1915378
ihfAp4,3.3333333333333335,24,5,CTGCCCCGCGGGCGTGTTAC,19,1947407
ihfAp4,2.3333333333333335,18,5,CTGATCGCTGATGCGTGGAC,13,1961129
ihfAp4,0.3333333333333333,6,5,CTCTGGTTTGGTTACGATTG,1,1939560
ihfAp4,1.8333333333333333,15,5,CTCGGCTGAATGGTTTACGG,10,1960486
ihfAp4,0.3333333333333333,6,5,CTCGAACTCTGCCGTTAGCG,1,1917762
ihfAp4,11.5,73,5,CTCATTGAACGTTGAACTGG,68,1933992
ihfAp4,9.333333333333334,60,5,CTCATTCCTCGGACTAGGGA,55,1949009
ihfAp4,5.833333333333333,39,5,CTCAGTGGACACTGGCTTGT,34,1920634
ihfAp4,7.5,49,5,CTATTTAAGATTATGTATTC,44,1929826
ihfAp4,3.5,25,5,CTATTAATCTAAGCTGGTAG,20,1936001
ihfAp4,2.5,19,5,CTAGTCTGGCAATCACACGT,14,1934150
ihfAp4,4.333333333333333,30,5,CTAGCGGTGAGTGCGAGCTC,25,1912338
ihfAp4,10.333333333333334,66,5,CTACGAAGTAACCGGGGTTA,61,1918513
ihfAp4,3.6666666666666665,26,5,CTAATTTGACATATCTCTCA,21,1924600
ihfAp4,2.1666666666666665,17,5,CTAATAAGGTCCTAACTAGG,12,1949546
ihfAp4,0.3333333333333333,6,5,CTAAGACTCTAGTGGGGTTG,1,1961187
ihfAp4,3.0,22,5,CTAACGTGGCCCTTGCATAT,17,1925377
ihfAp4,3.6666666666666665,26,5,CGTTTGGGATCACGGGAACA,21,1948474
ihfAp4,4.666666666666667,32,5,CGTTTCTAAATTGCTCCCTG,27,1961159
ihfAp4,3.0,22,5,CGTTATTCACCTGTTTTTAC,17,1960552
ihfAp4,0.3333333333333333,6,5,CGTGCAGCTTTTCCCAAACG,1,1938515
ihfAp4,9.666666666666666,62,5,CGTATTGATAAACCTTTCAA,57,1917900
ihfAp4,2.3333333333333335,18,5,CGTAGAGAAGAGTCTAACCC,13,1935342
ihfAp4,8.0,52,5,CGGTTTTGTCATCCTGTGAC,47,1933709
ihfAp4,5.833333333333333,39,5,CGGGGTGGTCCACTTATGCC,34,1910669
ihfAp4,5.0,34,5,CGGCTCGCTCAGAGTCTTTT,29,1942871
ihfAp4,5.666666666666667,38,5,CGGCGGTATCGTATATCACT,33,1945212
ihfAp4,1.3333333333333333,12,5,CGGCCCCTCGACACGAGTTA,7,1960355
ihfAp4,5.0,34,5,CGGCATTGGTATTGCATGAT,29,1913495
ihfAp4,6.5,43,5,CGGAGGGACTGCCAGCTGGC,38,1937258
ihfAp4,5.333333333333333,36,5,CGGAAAGGGCCAGAGACGGG,31,1954237
ihfAp4,8.5,55,5,CGCTTTTGAGTAGACGATCA,50,1958776
ihfAp4,6.833333333333333,45,5,CGCTTCTTTTTCCCAGCCAA,40,1939259
ihfAp4,7.166666666666667,47,5,CGCTCAGGGGCGGAAAGAAA,42,1914207
ihfAp4,1.3333333333333333,12,5,CGCTAGGAACGATGGACAGA,7,1937799
ihfAp4,0.3333333333333333,6,5,CGCGTCGGTAGCAGGACCTA,1,1942382
ihfAp4,0.3333333333333333,6,5,CGCGCCGAGGACAGGAGAAA,1,1937435
ihfAp4,2.6666666666666665,20,5,CGCGACTTTGTCAACGAATG,15,1923683
ihfAp4,0.8333333333333334,9,5,CGCCTTACACAGGGTGGTCT,4,1940298
ihfAp4,1.6666666666666667,14,5,CGCATCCAAGAGGTGCAGTC,9,1939675
ihfAp4,0.3333333333333333,6,5,CGCAGCCCTATCATGCTCCT,1,1921253
ihfAp4,0.8333333333333334,9,5,CGCACTATTGAGAGTGTACA,4,1946923
ihfAp4,9.5,61,5,CGAGCGCTGCTGGTAATGCA,56,1946994
ihfAp4,3.3333333333333335,24,5,CGACGTGACATCTTCTCTCA,19,1930011
ihfAp4,3.3333333333333335,24,5,CGACGGGATACAGATCTACG,19,1938408
ihfAp4,0.3333333333333333,6,5,CGACCGACGGGTACTCCGAT,1,1945191
ihfAp4,0.3333333333333333,6,5,CGAAGCGCCATCCCCCTGGC,1,1944732
ihfAp4,0.3333333333333333,6,5,CGAAAAGTCACAGTTTGAAT,1,1932493
ihfAp4,3.3333333333333335,24,5,CCTTTTAAGTGTAATATCGT,19,1938143
ihfAp4,1.1666666666666667,11,5,CCTTCGGTGGCGTCGTAGAT,6,1950576
ihfAp4,3.1666666666666665,23,5,CCTTAGCGACCCGAGGGATA,18,1935933
ihfAp4,0.3333333333333333,6,5,CCTGTACCTCTTGTGTCGTC,1,1960290
ihfAp4,2.6666666666666665,20,5,CCTGGTATGCCCCACTTCCT,15,1916549
ihfAp4,4.0,28,5,CCTAGGTCAGTATGTAAGTA,23,1921879
ihfAp4,6.5,43,5,CCGGTAGAGGAACCCGTGGT,38,1917413
ihfAp4,2.8333333333333335,21,5,CCCTCTGCGTGCGGTAAATT,16,1933638
ihfAp4,5.333333333333333,36,5,CCCTCGGCACGGATGAAGTG,31,1916770
ihfAp4,3.8333333333333335,27,5,CCCGGATATGATTGGTACCG,22,1952763
ihfAp4,2.5,19,5,CCCCTCCATCTGACTTCGCT,14,1909854
ihfAp4,14.666666666666666,92,5,CCCACCAAATGTCTAGGGTT,87,1954827
ihfAp4,4.833333333333333,33,5,CCACTTGTCACGGGTATTCT,28,1944577
ihfAp4,5.5,37,5,CCACTCTCAAGCGGTCATTT,32,1914025
ihfAp4,3.0,22,5,CATTGGCACACGAAAAGAAC,17,1931784
ihfAp4,14.0,88,5,CATGGTATTCCGATATGCAA,83,1929520
ihfAp4,1.3333333333333333,12,5,CATGCAGCTCCTACGAATTT,7,1936032
ihfAp4,1.8333333333333333,15,5,CATCTGGTAGCCAACCACAG,10,1942921
ihfAp4,5.166666666666667,35,5,CATATCACAAGGTAAACGAA,30,1912971
ihfAp4,4.5,31,5,CAGTCTTCAGTAGGGTGGTA,26,1917917
ihfAp4,4.833333333333333,33,5,CAGGGGCTCCTTTCTTGAGA,28,1959665
ihfAp4,0.6666666666666666,8,5,CAGGACTGGCGGAACATCGC,3,1917080
ihfAp4,0.3333333333333333,6,5,CAGCTAAGGTTTGAGCTAGC,1,1944623
ihfAp4,9.166666666666666,59,5,CAGCGTCATTTAAAGTAGTT,54,1916233
ihfAp4,1.3333333333333333,12,5,CAGCATCACAATAAAGCCGA,7,1921494
ihfAp4,0.3333333333333333,6,5,CAGAGATGGGATTCCCTTGC,1,1942957
ihfAp4,1.8333333333333333,15,5,CACGCCCGGACACTCAAGGT,10,1916884
ihfAp4,4.5,31,5,CACGCCATCATCGGTAGAAA,26,1929715
ihfAp4,5.666666666666667,38,5,CACATCTTGTAATTTGGAAT,33,1950623
ihfAp4,1.0,10,5,CACAGTTTAATTTATTTAAC,5,1924594
ihfAp4,3.3333333333333335,24,5,CAATGACGTCTACCGTTTAT,19,1946331
ihfAp4,5.0,34,5,CAATCAATCGATAATAAGAT,29,1927427
ihfAp4,13.333333333333334,84,5,CAACTTACGTTGGGGGGTAT,79,1955415
ihfAp4,4.5,31,5,CAACTGCAGCTCGTTCTATG,26,1940628
ihfAp4,6.0,40,5,CAAATACTCAATGGTCGTAG,35,1951462
ihfAp4,4.0,28,5,CAAAGAGGTAAGCCTAACTT,23,1910734
ihfAp4,5.333333333333333,36,5,CAAAACCCGTTTAATTGGCT,31,1959161
ihfAp4,3.3333333333333335,24,5,ATTTTATCGTTCCCGCGCGA,19,1955023
ihfAp4,6.166666666666667,41,5,ATTTGTGGTGTCTTAAGTCT,36,1939701
ihfAp4,3.3333333333333335,24,5,ATTTATGTTGGAAAATCCGT,19,1938815
ihfAp4,1.3333333333333333,12,5,ATTGCTTACTGATAATTGGT,7,1915869
ihfAp4,5.666666666666667,38,5,ATTGCTGGAAATACTTTCAA,33,1952773
ihfAp4,8.333333333333334,54,5,ATTGATCCCTTTTGGCCTCT,49,1920062
ihfAp4,2.3333333333333335,18,5,ATTCCAGCGGGCAAACGTTG,13,1940472
ihfAp4,4.166666666666667,29,5,ATTAAATTTGCAAGACACGT,24,1935896
ihfAp4,3.8333333333333335,27,5,ATGTTTTCGAGTTTGTATGT,22,1942414
ihfAp4,3.8333333333333335,27,5,ATGTACATTATTTCTCTCTT,22,1951325
ihfAp4,7.666666666666667,50,5,ATGGACTTCCTATACAGTTG,45,1935943
ihfAp4,4.5,31,5,ATGGACGTTCTGTTACGCGG,26,1960304
ihfAp4,1.3333333333333333,12,5,ATCTGTCGGACAGACGCGAT,7,1951098
ihfAp4,3.3333333333333335,24,5,ATCCTCGACCTGAATGCAAA,19,1934928
ihfAp4,2.5,19,5,ATCCTAGAGTGGGTCAGCAG,14,1917442
ihfAp4,27.0,166,5,ATCCGTAGAAAGACAGGTGT,161,1933266
ihfAp4,2.8333333333333335,21,5,ATCCAATATGACATAACATA,16,1941163
ihfAp4,8.333333333333334,54,5,ATCCAAACTTTGGTTGGGTG,49,1923282
ihfAp4,2.6666666666666665,20,5,ATCATATATGATACCTCTAT,15,1915600
ihfAp4,4.333333333333333,30,5,ATCAAGCTCCCTTGGTACTT,25,1944998
ihfAp4,6.0,40,5,ATAGTACATAGGTCCCGGCT,35,1917431
ihfAp4,6.166666666666667,41,5,ATACATCTGCCCCGACCCGG,36,1936321
ihfAp4,2.0,16,5,ATAATAGCGTCACGTCGCAG,11,1958042
ihfAp4,9.833333333333334,63,5,ATAAAAATGTGAAGCAAGGA,58,1930195
ihfAp4,0.5,7,5,AGTTGCTAGCGAGGCCGGGA,2,1942909
ihfAp4,0.6666666666666666,8,5,AGTTCGCTGTGCAGAAGCAA,3,1922037
ihfAp4,13.5,85,5,AGTTCACCACTTACGTATCC,80,1939086
ihfAp4,2.6666666666666665,20,5,AGTTAGTGGGTGCACACCAG,15,1957221
ihfAp4,10.666666666666666,68,5,AGTGTTGAGGGGAGGGACGT,63,1935109
ihfAp4,4.166666666666667,29,5,AGTGCGTTCGTTACGATGCT,24,1929837
ihfAp4,8.0,52,5,AGTGAGGAGCTATGAGGCGG,47,1927121
ihfAp4,2.6666666666666665,20,5,AGTCGGCGACTCCGAGTGGA,15,1928797
ihfAp4,5.833333333333333,39,5,AGTCCGAGCCAGGACGAACC,34,1943645
ihfAp4,6.5,43,5,AGTATGCAAACAATGACCAG,38,1910556
ihfAp4,7.333333333333333,48,5,AGTACGCGGGACGTAGCTTC,43,1915105
ihfAp4,1.1666666666666667,11,5,AGTAAGGTTTGTTCCAAGCT,6,1927217
ihfAp4,3.3333333333333335,24,5,AGTAAGATCATAACCCTAGA,19,1914029
ihfAp4,10.833333333333334,69,5,AGGTTATGTTGATTGAAGAC,64,1940620
ihfAp4,2.1666666666666665,17,5,AGGGCATATTTGGGCATAAT,12,1943089
ihfAp4,3.0,22,5,AGGGAGTCGGAACACTGTAA,17,1938999
ihfAp4,4.5,31,5,AGGCAGCCAGACCCGTTATG,26,1923205
ihfAp4,4.166666666666667,29,5,AGGATTCATATATCCCGGTA,24,1961660
ihfAp4,2.5,19,5,AGCTAATCCGGACCCCCAAG,14,1913812
ihfAp4,1.3333333333333333,12,5,AGCGGGCTGGTATTCTAGCC,7,1927267
ihfAp4,3.5,25,5,AGCGCACGGGAACGTCGTGT,20,1952727
ihfAp4,12.666666666666666,80,5,AGCCGGGGGTGTACTACGAC,75,1933177
ihfAp4,4.0,28,5,AGCCGGCATCGTTAGTAGAT,23,1921538
ihfAp4,4.333333333333333,30,5,AGCCCATATTCCTAGCAAAT,25,1919226
ihfAp4,0.5,7,5,AGCATGAGGATGGGTTCATT,2,1938623
ihfAp4,4.833333333333333,33,5,AGCAGCTCCGATCCGGTTTG,28,1927343
ihfAp4,2.0,16,5,AGAGCGACGATACTCACTGC,11,1922082
ihfAp4,2.6666666666666665,20,5,AGACAGGCCCAGAAAGTTTA,15,1919673
ihfAp4,2.5,19,5,AGAATGCGTCGTGCATGAAT,14,1922288
ihfAp4,2.8333333333333335,21,5,ACTTGTTATAGGCTCATGGA,16,1945201
ihfAp4,9.0,58,5,ACTTGTCACGCGGCATTATA,53,1962036
ihfAp4,5.666666666666667,38,5,ACTTGCAGGTATTATGGGGT,33,1947753
ihfAp4,7.166666666666667,47,5,ACTGGTTCTGGTGTCGATAT,42,1924488
ihfAp4,9.0,58,5,ACTGATATTCCAAGCCCATA,53,1940707
ihfAp4,1.0,10,5,ACTCCGGATTTGGCACATTC,5,1960769
ihfAp4,11.5,73,5,ACGGGTGTAGAGGCATACGG,68,1915729
ihfAp4,5.5,37,5,ACGGGAGTTTGAGTTCTTTT,32,1919151
ihfAp4,0.6666666666666666,8,5,ACGGAGACTTAAGCTCCTGA,3,1938372
ihfAp4,6.666666666666667,44,5,ACGAAGGGAGTGAGCAGCTC,39,1956029
ihfAp4,3.6666666666666665,26,5,ACCTTCTGAATACATTGATT,21,1936302
ihfAp4,2.5,19,5,ACCTGGTTCACCAAAGTAGG,14,1923881
ihfAp4,2.6666666666666665,20,5,ACCGCCAGCTAGCAAATAAG,15,1920716
ihfAp4,4.5,31,5,ACCCAGCGAAGGCATGTTCA,26,1958462
ihfAp4,6.0,40,5,ACCACAAACATGCCCGAATC,35,1931969
ihfAp4,0.3333333333333333,6,5,ACATGTAGGTACATTTTCAT,1,1927190
ihfAp4,6.0,40,5,ACATATTCATATGATCGGCC,35,1913808
ihfAp4,1.8333333333333333,15,5,ACATATATTTGTGATATCTT,10,1959353
ihfAp4,4.166666666666667,29,5,ACATAGAGTGTAGGACCCGC,24,1923191
ihfAp4,4.0,28,5,ACAGTTCTTCGGAATCTCAG,23,1920509
ihfAp4,9.5,61,5,ACACTAGCTCAGTGAGAAAG,56,1939301
ihfAp4,4.5,31,5,ACAAAGCAATGCCGTCGGGC,26,1911644
ihfAp4,4.5,31,5,AATAATTGCAACAGTCTGGC,26,1938622
ihfAp4,0.6666666666666666,8,5,AAGTGTAACATATAACTCAT,3,1920918
ihfAp4,0.3333333333333333,6,5,AAGGATTAAGGCGATGTCTC,1,1940748
ihfAp4,2.3333333333333335,18,5,AAGCGGTTAAAAAAACTCCA,13,1925069
ihfAp4,3.0,22,5,AAGCCGTCTGACGGATTGAA,17,1932816
ihfAp4,1.6666666666666667,14,5,AAGCATCGTGTCGAGCAAAG,9,1944540
ihfAp4,5.333333333333333,36,5,AAGCACACTAATAAGTGAAC,31,1927700
ihfAp4,3.5,25,5,AAGAGCCCAGGGTCGATACT,20,1925188
ihfAp4,8.0,52,5,AACTCATGGTAAGTCACCTA,47,1932798
ihfAp4,4.166666666666667,29,5,AACGGACATCTAATCAGTCT,24,1932876
ihfAp4,2.5,19,5,AACCTGCCTGACTTGGGCAT,14,1950492
ihfAp4,10.166666666666666,65,5,AACAGGGTCAGTGTACTTAA,60,1935835
ihfAp4,3.8333333333333335,27,5,AAATGGAACCTCGGGCACCC,22,1950235
ihfAp4,1.5,13,5,AAAGAGTCACTTGTGTCGGC,8,1949448
ihfAp4,5.0,28,4,TTTTGCCCACTATAGCCCGT,24,1926352
ihfAp4,3.2,19,4,TTTTATCTGTAACAGATAAT,15,1912308
ihfAp4,0.8,7,4,TTTTACTATGGATTCCCGAC,3,1957594
ihfAp4,4.8,27,4,TTTGTTGATGTAGTCTGCAT,23,1926745
ihfAp4,3.6,21,4,TTTGTCGCCAGGTTATAAGA,17,1933923
ihfAp4,8.8,47,4,TTTCTGTGTTTTAGGGCTGG,43,1933543
ihfAp4,4.2,24,4,TTTCAACCCGGTCGAGAGTA,20,1953720
ihfAp4,4.0,23,4,TTTATCTAAGCATGTCTTCG,19,1919370
ihfAp4,1.6,11,4,TTTATAAATTCCAAAATCAC,7,1913336
ihfAp4,6.0,33,4,TTGTTGCTAGAATGGTCTGG,29,1918978
ihfAp4,5.8,32,4,TTGTTGCGCTGCGGAACTAC,28,1909992
ihfAp4,4.0,23,4,TTGTCTGCGTGATGCGCATT,19,1918751
ihfAp4,1.4,10,4,TTGTCTAAGTTCACTTCAAC,6,1939233
ihfAp4,9.6,51,4,TTGTAGACCGCGGTAGTGTG,47,1949461
ihfAp4,5.6,31,4,TTGTACTGCCGACTGAGGAT,27,1919522
ihfAp4,3.6,21,4,TTGGTCAGTAGACCGTGGTC,17,1940359
ihfAp4,7.6,41,4,TTGGCTTTGAGAGCTATTAG,37,1916785
ihfAp4,9.6,51,4,TTGCGAACACCATTACGTGT,47,1940102
ihfAp4,3.8,22,4,TTGCCCGGTTCGATGAGGCG,18,1951172
ihfAp4,1.6,11,4,TTGATTGTGTAAAATTACCA,7,1910198
ihfAp4,0.4,5,4,TTGAGACGTACTCACTCGGT,1,1956071
ihfAp4,3.6,21,4,TTGAATGCTTTGCAAATACC,17,1925563
ihfAp4,15.4,80,4,TTCTTCGGGTTTGTGTCACC,76,1925987
ihfAp4,3.4,20,4,TTCTCTTTTCGCGTGAGCGC,16,1940641
ihfAp4,5.4,30,4,TTCTCCAAGCAGGGCTGCTC,26,1914894
ihfAp4,5.4,30,4,TTCTAGGTTCTGCGAGTTAT,26,1914565
ihfAp4,3.2,19,4,TTCGTTTGCAAAACCCCGTA,15,1950935
ihfAp4,3.6,21,4,TTCGTCCATCCTGCCTCAGA,17,1926237
ihfAp4,3.4,20,4,TTCGTAGCGAATAAGAACGC,16,1910066
ihfAp4,4.2,24,4,TTCGCTTTGTACATATGGCG,20,1940059
ihfAp4,7.0,38,4,TTCCGTGGAGGCGCGGCCAC,34,1950577
ihfAp4,5.6,31,4,TTCCGAGGTACAAGTGTGAG,27,1932205
ihfAp4,0.4,5,4,TTCCAAGACCCAATACTCGG,1,1912652
ihfAp4,11.8,62,4,TTCACTGGGAACATATTCAC,58,1958433
ihfAp4,5.0,28,4,TTCAAAGTTAGGTACGAACA,24,1950229
ihfAp4,4.6,26,4,TTATTCTTTGCAGTCCATTG,22,1912113
ihfAp4,1.0,8,4,TTATCTCAACAGCAAATCTA,4,1932943
ihfAp4,7.6,41,4,TTAGCGTACCTGGGAAGGTT,37,1946159
ihfAp4,7.8,42,4,TTAGAGTTAAAGGGTCCACT,38,1915541
ihfAp4,4.6,26,4,TTACGAACTAGCGCCGGTAT,22,1951367
ihfAp4,1.2,9,4,TTAAGTTGAAGTGCTGATTT,5,1945979
ihfAp4,10.6,56,4,TTAACAGGGGACAGTCTACT,52,1956722
ihfAp4,0.8,7,4,TGTTGTGGCGTAGCGAGACG,3,1959788
ihfAp4,7.4,40,4,TGTTGATGGCCAACCGACAT,36,1942143
ihfAp4,5.2,29,4,TGTTACCCATACACTGGACT,25,1937192
ihfAp4,6.6,36,4,TGTCAACCAACACAGGTGAA,32,1932752
ihfAp4,2.2,14,4,TGGTGTTTACCGGCTACAGC,10,1937730
ihfAp4,1.6,11,4,TGGTAACAGAGCGGAATTTC,7,1919024
ihfAp4,1.2,9,4,TGGGCGGTTTTGTTCGGAGT,5,1938413
ihfAp4,5.4,30,4,TGGGAGATTTGCAATAGCCT,26,1943572
ihfAp4,0.4,5,4,TGGCGCCGCCTCCGCGGGTC,1,1958422
ihfAp4,0.4,5,4,TGGATCGTGCCTTAGGTTTA,1,1957565
ihfAp4,3.0,18,4,TGGAGCAGCATGGTGCAAAA,14,1909750
ihfAp4,4.0,23,4,TGGACAGTCTCAACTATTAG,19,1961595
ihfAp4,1.6,11,4,TGCTCTGGGACCGCACAGGA,7,1934454
ihfAp4,5.2,29,4,TGCTCCCGACTCCTCTAGGC,25,1940640
ihfAp4,3.2,19,4,TGCGTGACGCCCTGCGTGTG,15,1939744
ihfAp4,4.8,27,4,TGCGTCAGGATTGCCACATT,23,1931886
ihfAp4,0.4,5,4,TGCCGCCAGTCCACATGCAG,1,1933911
ihfAp4,1.8,12,4,TGCATTGCATAGTCCGCGAC,8,1925988
ihfAp4,0.4,5,4,TGCAGTTTCAGTTTCCTGCT,1,1953116
ihfAp4,2.4,15,4,TGCACTCTCGATACTTCGTG,11,1930533
ihfAp4,4.8,27,4,TGCACGTGCAACCAGCGGTA,23,1951150
ihfAp4,5.2,29,4,TGATCGGGCCTTTACTCACC,25,1935669
ihfAp4,3.8,22,4,TGATACACTCTCTCAACAGT,18,1949494
ihfAp4,3.6,21,4,TGAGTGGACGCTCTAAGCAA,17,1945589
ihfAp4,0.4,5,4,TGAGTATTATGACAGGCCGA,1,1928271
ihfAp4,2.6,16,4,TGAGGAGCCTTGGGAGTTAG,12,1957014
ihfAp4,3.0,18,4,TGACAGTTGGCAACAGACTC,14,1931439
ihfAp4,5.0,28,4,TCTTTCTTCACCACGTTAAG,24,1936939
ihfAp4,3.8,22,4,TCTTGGATTATTTAGTGATC,18,1930996
ihfAp4,5.0,28,4,TCTGTGAAAGTTCGAATATA,24,1946613
ihfAp4,3.4,20,4,TCTGGGGTCTAGATATCCAA,16,1947566
ihfAp4,0.4,5,4,TCTCTAGTGTGTTGCAAGTA,1,1956321
ihfAp4,9.0,48,4,TCGTTCGTAAGGATTGTAAG,44,1959613
ihfAp4,3.6,21,4,TCGTGCGTCGCTGTGCGATA,17,1927909
ihfAp4,4.4,25,4,TCGGGGGACGTTACATTGGT,21,1912100
ihfAp4,7.2,39,4,TCGCTTAAAAAGCGACAGGG,35,1914901
ihfAp4,1.0,8,4,TCGCGGGTCATTATCCGTCC,4,1951703
ihfAp4,6.2,34,4,TCGCCTTTATTAGCCCGATA,30,1916685
ihfAp4,4.4,25,4,TCGCCGTCAAATGCATCTAT,21,1956640
ihfAp4,4.8,27,4,TCGATAACGTATTGATAAGT,23,1956620
ihfAp4,11.4,60,4,TCGACGGTCTGATGCGATCG,56,1914941
ihfAp4,1.6,11,4,TCGACGCGAAGATCTTCCAT,7,1944361
ihfAp4,3.8,22,4,TCGAAGTGTTACTTCAATCT,18,1925646
ihfAp4,9.0,48,4,TCCTGAGGTCTCCAGCTCAG,44,1936890
ihfAp4,5.2,29,4,TCCGCACTGCAAACTTATTG,25,1927844
ihfAp4,6.4,35,4,TCCGAGAGTTCGTATGGCAA,31,1945348
ihfAp4,3.8,22,4,TCCCCATCACGTACTCGACG,18,1910760
ihfAp4,3.6,21,4,TCCCAACATGGAATTGAGGT,17,1917045
ihfAp4,0.6,6,4,TCCAGACCCTCCCTCGTCCG,2,1920946
ihfAp4,0.6,6,4,TCCACAATCGAAAGTCTCAA,2,1910370
ihfAp4,0.4,5,4,TCATTCCGATGCCATCCGCG,1,1953597
ihfAp4,10.2,54,4,TCATTAACCCTACCGTGAAT,50,1938828
ihfAp4,16.2,84,4,TCAGTTCGTTGACGATTGCA,80,1926721
ihfAp4,8.4,45,4,TCAGTGTTCGAGGTTGCCAC,41,1955941
ihfAp4,11.8,62,4,TCAGTGCCATGGCCTTGGGT,58,1940754
ihfAp4,3.6,21,4,TCAGTCTGTGGAGGACTATG,17,1913560
ihfAp4,2.0,13,4,TCACCAGAGATCAACTGGAA,9,1929984
ihfAp4,3.8,22,4,TATTCAAGCGGTAAATACAA,18,1956728
ihfAp4,24.8,127,4,TATTCAACAGATAAAGATAC,123,1958636
ihfAp4,2.8,17,4,TATGCAGGTCGTCGTAGACT,13,1924748
ihfAp4,12.4,65,4,TATCGGCTTGTGCCCATGCA,61,1910759
ihfAp4,0.6,6,4,TATCGACAGCGGAATATTGG,2,1936852
ihfAp4,10.6,56,4,TATCCCGTCGCTGGGGGGAG,52,1946147
ihfAp4,2.8,17,4,TATAGTGATTCGTCCCACCT,13,1933857
ihfAp4,10.0,53,4,TATAAGTCGCTATGCGATAG,49,1920066
ihfAp4,5.0,28,4,TAGGTCGAGATATTGCTGTA,24,1931622
ihfAp4,5.4,30,4,TAGGGCCTCGGTCATATCCA,26,1927215
ihfAp4,0.6,6,4,TAGGATTGTTTGCTACTGAT,2,1913829
ihfAp4,2.2,14,4,TAGCTGAGGGTCAAAGAGTG,10,1942862
ihfAp4,0.4,5,4,TAGCTCGGTGCTCTCGATTT,1,1935076
ihfAp4,14.8,77,4,TAGCCGCAAACGCAGCCCGG,73,1950217
ihfAp4,2.2,14,4,TAGCACACCCAATAAGTAGT,10,1930730
ihfAp4,6.2,34,4,TAGAGCCATGACGTGCAGTG,30,1926479
ihfAp4,10.6,56,4,TAGACGGGGGGACGGGGTTT,52,1931402
ihfAp4,29.4,150,4,TAGACACACCCTGACTTTTG,146,1933343
ihfAp4,4.4,25,4,TACTTTAAACCAGCTATGTA,21,1928418
ihfAp4,10.8,57,4,TACCCTGGTGCCATCTTTCA,53,1952761
ihfAp4,5.6,31,4,TACACATACAGGGGACGGGA,27,1923760
ihfAp4,2.6,16,4,TAATTGATGTGGGCGTGTGC,12,1911986
ihfAp4,1.4,10,4,TAATACTTCCACATGTTCCT,6,1956583
ihfAp4,0.4,5,4,TAAGGCTGCCGAGTCGGCTT,1,1956895
ihfAp4,0.4,5,4,TAAGCTCGGCTTATCGGAGA,1,1952985
ihfAp4,3.4,20,4,TAAGAGATAGTTGCAGATGC,16,1927975
ihfAp4,3.0,18,4,TAACTGTTGCCGAAACGCCA,14,1938592
ihfAp4,2.8,17,4,TAACACTAGGGGGGTCTGTT,13,1909694
ihfAp4,7.0,38,4,TAACACAGTTACCGGTTTGG,34,1954999
ihfAp4,3.0,18,4,TAAAGGTGTACGAATAGTCT,14,1948933
ihfAp4,9.8,52,4,GTTTTTCGTACTACGCCATC,48,1956019
ihfAp4,0.6,6,4,GTTTTGTTGGTGGAGTAAAG,2,1958770
ihfAp4,2.6,16,4,GTTTTAAGCAAGTTGATAAC,12,1943476
ihfAp4,4.0,23,4,GTTTGACAGATCAATACGAT,19,1946020
ihfAp4,0.4,5,4,GTTTCTTATTCTGATGATGT,1,1959783
ihfAp4,5.4,30,4,GTTGCTTCATTATCATGTGT,26,1927652
ihfAp4,0.4,5,4,GTTGCTAGGGTCCCATTAAA,1,1913893
ihfAp4,8.0,43,4,GTTGCGCGTTTTCCTCTTAA,39,1932025
ihfAp4,3.4,20,4,GTTGCATGGATGCTCGTGTC,16,1940223
ihfAp4,5.8,32,4,GTTCGCGGGTCAGCTGGTCT,28,1954996
ihfAp4,7.4,40,4,GTTATTGATTCGACGATAAT,36,1946737
ihfAp4,1.8,12,4,GTTAGATCCAGATGTACTAA,8,1919200
ihfAp4,0.4,5,4,GTGTGTGGTGTACTCGCGAA,1,1911265
ihfAp4,5.0,28,4,GTGTAGAAAATTTTGCGAAT,24,1945700
ihfAp4,5.6,31,4,GTGTACCGCATATGCATCGT,27,1927220
ihfAp4,5.0,28,4,GTGCGGAGCAGTCTGGCTTC,24,1925557
ihfAp4,4.0,23,4,GTGAGCAACTTATGTCGATC,19,1935814
ihfAp4,3.0,18,4,GTGAGAACGATGGACGCTAG,14,1938389
ihfAp4,3.8,22,4,GTCTTGACCAATAACCGCAT,18,1919462
ihfAp4,0.4,5,4,GTCTATATAGGGTGAAGATG,1,1951874
ihfAp4,11.0,58,4,GTCGCGGGATATACCCCATT,54,1943249
ihfAp4,3.2,19,4,GTCGCAGTCAAACGGGCTTC,15,1915878
ihfAp4,0.4,5,4,GTCGAGCTGGCGTGTCCTAA,1,1921333
ihfAp4,7.2,39,4,GTCCGGGTTTATAGTTTTCT,35,1936347
ihfAp4,5.2,29,4,GTCCGCCGCGCTCTCCCGAC,25,1930866
ihfAp4,5.8,32,4,GTCCATGACGCTCCCGTGTA,28,1909989
ihfAp4,4.6,26,4,GTCAAGCCTAAGAGGCTATG,22,1944731
ihfAp4,8.0,43,4,GTCAAATTAATCGGTACTCA,39,1932677
ihfAp4,6.4,35,4,GTAGTTTACCATAGGGAGCA,31,1951692
ihfAp4,7.2,39,4,GTAGCATAAGACGAACTCGA,35,1915540
ihfAp4,7.8,42,4,GTAGCACACATCTGGGGCGC,38,1935603
ihfAp4,3.2,19,4,GTAAGCACCGGTTCACGGGT,15,1916272
ihfAp4,2.0,13,4,GGTTCTCTAAATCAACACAT,9,1923507
ihfAp4,2.0,13,4,GGTGAATTGAGTTGTCAAGC,9,1922295
ihfAp4,8.6,46,4,GGTCTGATTTCGTGCTGTCC,42,1940043
ihfAp4,0.4,5,4,GGGGCCACGATACTTGGTTG,1,1929356
ihfAp4,10.6,56,4,GGGGAACTGGGCTCATGAGT,52,1939893
ihfAp4,5.8,32,4,GGGCATCGTGTTGATACGTG,28,1933371
ihfAp4,9.4,50,4,GGGATGTATCCGAGAAAGCG,46,1959877
ihfAp4,2.0,13,4,GGGAGTTTACTACGCTCGTG,9,1919536
ihfAp4,24.0,123,4,GGGAAAGATCAACTCTACGA,119,1948303
ihfAp4,1.8,12,4,GGCTTACGTCTGAGTACTTG,8,1916468
ihfAp4,5.2,29,4,GGCTCCGGGTTTCAAATAAC,25,1955875
ihfAp4,0.4,5,4,GGCTAGGTCCATGAATCCAC,1,1955614
ihfAp4,3.6,21,4,GGCTACTATATCGAGGGAAT,17,1919620
ihfAp4,5.0,28,4,GGCGTACCGGTACTCCCTGG,24,1928674
ihfAp4,1.4,10,4,GGCGGTATCAGCACTCTCGT,6,1928733
ihfAp4,2.2,14,4,GGCGGCTCCGAAGACATTGG,10,1949246
ihfAp4,2.0,13,4,GGCATGAACCTGCGATGGGA,9,1923875
ihfAp4,2.0,13,4,GGCACAAAAATGATCGAAGC,9,1933018
ihfAp4,4.0,23,4,GGCAATCACCTTCCGGACGG,19,1938608
ihfAp4,4.8,27,4,GGCAAGCCTTGGGACATTAT,23,1934063
ihfAp4,2.6,16,4,GGATGACAACTCCCTTCAAG,12,1912965
ihfAp4,10.2,54,4,GGATCCGACGAGCGGCTGTT,50,1954365
ihfAp4,3.4,20,4,GGATCAGAAATCTTTGGTAC,16,1951808
ihfAp4,3.4,20,4,GGAGTGCCTACATTATCTCC,16,1937660
ihfAp4,8.0,43,4,GGAGGCCTGCTACGTCTATG,39,1909968
ihfAp4,1.0,8,4,GGACTGCACAGACGAATAAT,4,1911613
ihfAp4,1.2,9,4,GGACCCGTCTGAGGGAGTAT,5,1946442
ihfAp4,4.8,27,4,GGACAAAAGACAAACGGAAC,23,1933618
ihfAp4,6.8,37,4,GGAATTGAATCTGTAATGCG,33,1925580
ihfAp4,10.4,55,4,GGAATCTTCGGCCACTCACT,51,1927803
ihfAp4,11.6,61,4,GGAAGGTAACAACTCCCGCT,57,1919314
ihfAp4,0.4,5,4,GGAAGGCAACATTACCGAAA,1,1948287
ihfAp4,3.4,20,4,GGAACATACATTGCCAGGTA,16,1942217
ihfAp4,3.6,21,4,GCTTTGCAAAACATAATTCA,17,1950416
ihfAp4,3.6,21,4,GCTTTCAAGAAAACTATTGG,17,1914919
ihfAp4,0.4,5,4,GCTTCCGATTCCTTTCGGAC,1,1924266
ihfAp4,5.6,31,4,GCTTAAGGGGCTGATGAGCA,27,1925647
ihfAp4,6.8,37,4,GCTGGGTTCCGATGCTTAAT,33,1933400
ihfAp4,2.6,16,4,GCTGGGGTGGGCGGGTACTT,12,1946693
ihfAp4,3.2,19,4,GCTGGAGTTGTCCGTTACAC,15,1951536
ihfAp4,5.0,28,4,GCTGCACTTGCTCTATGGAC,24,1953288
ihfAp4,1.4,10,4,GCTCGTCGCTGACATTCTGA,6,1925991
ihfAp4,7.2,39,4,GCTACCGCCTACGGTGGGAC,35,1920164
ihfAp4,0.8,7,4,GCGGTAGCCATGGTCTCGGA,3,1930100
ihfAp4,5.0,28,4,GCGGCGCCGGCCAATGCGTA,24,1944359
ihfAp4,2.8,17,4,GCGGATCACATAGCAAGGAC,13,1952058
ihfAp4,3.8,22,4,GCGCGCGGTGTAGCCCCTGG,18,1912043
ihfAp4,4.6,26,4,GCGCATTTCGGGTGACTTGT,22,1943592
ihfAp4,1.0,8,4,GCGACTGTGAGTAGGTCGCC,4,1934852
ihfAp4,4.0,23,4,GCGACTCTCTAACGCTGCCT,19,1919618
ihfAp4,0.4,5,4,GCGACGCAGATTAAGCGAGA,1,1923037
ihfAp4,26.4,135,4,GCGAACAACTGGACAGATAT,131,1957385
ihfAp4,2.0,13,4,GCCTGGTGTTTTCGTCGGAC,9,1941582
ihfAp4,3.0,18,4,GCCCTTCATCTATAGAGTTG,14,1950228
ihfAp4,5.4,30,4,GCCCGAGCAGTCAGAGACGC,26,1927934
ihfAp4,3.0,18,4,GCCCCTACACTGATCGTGCG,14,1960981
ihfAp4,1.6,11,4,GCCAGTTGCACAGAGCACTC,7,1918185
ihfAp4,2.6,16,4,GCATTACTCGGGTCAATCGA,12,1912693
ihfAp4,2.6,16,4,GCAGGTGAGTCAATACCTCA,12,1944005
ihfAp4,2.4,15,4,GCAGAGTGGAATCTGTACTC,11,1928866
ihfAp4,3.4,20,4,GCACGGGTTGGGTGTTCCGA,16,1941579
ihfAp4,5.4,30,4,GCAATTGCGACGCAGTAGCT,26,1914905
ihfAp4,1.0,8,4,GCAAAATGGAGAGGGGTATT,4,1938936
ihfAp4,6.0,33,4,GATTGTATTAGGGAGTTCCT,29,1922797
ihfAp4,1.0,8,4,GATTGAATAAGAACCGGAAA,4,1945084
ihfAp4,0.4,5,4,GATCGCTTGGCCGACGGTGG,1,1958010
ihfAp4,1.4,10,4,GATCGCTTGACTCATGACAA,6,1937295
ihfAp4,1.8,12,4,GATATCTGGTATTGGCAGGT,8,1949741
ihfAp4,2.4,15,4,GATAAATGCCCCGGAAAGAA,11,1931167
ihfAp4,6.6,36,4,GAGTCTCGGTGCGAGGATTG,32,1961603
ihfAp4,5.0,28,4,GAGGAGAAGAGTCACGACAG,24,1910904
ihfAp4,5.2,29,4,GAGCATCCCGTCCGCACCGT,25,1950136
ihfAp4,4.6,26,4,GAGAGATTAGTAGAAGTGTC,22,1939874
ihfAp4,8.6,46,4,GACTTTAATGCAGCTATTAG,42,1915432
ihfAp4,2.4,15,4,GACTACTATATTGGAATAGG,11,1945932
ihfAp4,1.2,9,4,GACGTTCGTTGAGTTAATTA,5,1959399
ihfAp4,3.4,20,4,GACGCGATTGCTATGGTAGG,16,1936730
ihfAp4,7.0,38,4,GACCGATCGGTGCATAACGT,34,1943236
ihfAp4,12.4,65,4,GACCATAGAGTACGAAACAA,61,1915445
ihfAp4,29.2,149,4,GACCACTGCCGGAGCCGTTC,145,1923311
ihfAp4,24.8,127,4,GACATATATTGGGCCTGTGG,123,1933187
ihfAp4,6.0,33,4,GACAGATAACAATTATGCAA,29,1945179
ihfAp4,2.0,13,4,GACAAGCCTATATGTTTCGA,9,1912542
ihfAp4,2.4,15,4,GACAAAACAATTTTGCTCCG,11,1924309
ihfAp4,10.0,53,4,GAATCGGTCCCGTGTGCGCA,49,1948961
ihfAp4,3.6,21,4,GAAATCGTCTGGCAGAAAGC,17,1912223
ihfAp4,4.0,23,4,GAAACATGCCTCTCACTCTC,19,1922922
ihfAp4,2.6,16,4,CTTTTCACATCGGAACCCAG,12,1937186
ihfAp4,5.4,30,4,CTTTGGTTGTTCCTGGATTT,26,1922344
ihfAp4,0.4,5,4,CTTTGACATCGAGGAGGCAA,1,1931230
ihfAp4,0.4,5,4,CTTGGCTTGAGTGGTAAACA,1,1910758
ihfAp4,0.4,5,4,CTTCCAGCACCCTGTTGCTC,1,1941583
ihfAp4,3.4,20,4,CTGGGTGCCTTGCAACCGTG,16,1938648
ihfAp4,3.8,22,4,CTGGGTAGGGATAGTTGCGT,18,1941464
ihfAp4,4.2,24,4,CTGCTATATAGAAAGGTTTG,20,1949807
ihfAp4,3.2,19,4,CTGATACGGCCTATTTGGCT,15,1911197
ihfAp4,2.6,16,4,CTGAAGCTGACAACACCCCA,12,1955794
ihfAp4,2.4,15,4,CTCTTGAAGTCTAGTAGGAG,11,1943287
ihfAp4,4.6,26,4,CTCTGTGCTATCATACCGAT,22,1917505
ihfAp4,7.8,42,4,CTCTGCACACTGTTCCATCA,38,1937689
ihfAp4,0.4,5,4,CTCTCATGGTAGCATTTGAA,1,1921547
ihfAp4,0.6,6,4,CTCGGATAACCTACACTACC,2,1923310
ihfAp4,3.0,18,4,CTCGCAGATTATGGTGAGGA,14,1917269
ihfAp4,2.6,16,4,CTCGAGAAACGTTATTCTTC,12,1923902
ihfAp4,5.4,30,4,CTCGAACTCGGGTATATGTG,26,1939639
ihfAp4,3.6,21,4,CTCCCGGTGCGAAGTACGCA,17,1921939
ihfAp4,1.6,11,4,CTCCCGCAGCGTTCACAAGT,7,1949517
ihfAp4,7.8,42,4,CTCATGTCGGTAGGCCTTCA,38,1935602
ihfAp4,3.0,18,4,CTACGCTCTGATCCCCACAT,14,1947803
ihfAp4,5.6,31,4,CTACGCAAATTTAAGACCAG,27,1934906
ihfAp4,2.6,16,4,CTAACTCCGCATTCACATGT,12,1928016
ihfAp4,7.2,39,4,CTAACCGATTTAGCCCTTGT,35,1923466
ihfAp4,3.4,20,4,CGTTGATTCAATGAAGACTT,16,1946120
ihfAp4,5.2,29,4,CGTGTGTGTTCCGTGTAGAG,25,1940366
ihfAp4,4.4,25,4,CGTGGTGGCAAATTCGAGCC,21,1953651
ihfAp4,12.6,66,4,CGTATGATGGGAGCGTTGCG,62,1946295
ihfAp4,13.2,69,4,CGTACAGTCACCAACGACCT,65,1931789
ihfAp4,3.2,19,4,CGGTGGGTCAGTTTAAAGTT,15,1925952
ihfAp4,3.4,20,4,CGGTCTGGCTCTGCTCACAT,16,1932586
ihfAp4,13.4,70,4,CGGTCACCTAGGTATGTAGA,66,1909620
ihfAp4,7.4,40,4,CGGTACCCGAGTTGCAAATG,36,1929487
ihfAp4,9.2,49,4,CGGGGATTGTAGATTGGGAC,45,1935223
ihfAp4,7.6,41,4,CGGGCAGGCCAAACAACGGT,37,1941879
ihfAp4,5.4,30,4,CGGGCACGTCGAATGCGGGT,26,1912982
ihfAp4,2.8,17,4,CGGCTGCGCGAGATTTTACC,13,1932681
ihfAp4,3.6,21,4,CGGCGTGGCCTAATGTACAG,17,1920445
ihfAp4,1.6,11,4,CGGCAGTCTGAAGGAGTCAT,7,1951763
ihfAp4,4.2,24,4,CGGCAAAAGCCTTTGTAATC,20,1946902
ihfAp4,4.8,27,4,CGGATAATAGCGCGTTACAG,23,1944320
ihfAp4,4.0,23,4,CGCTGCGCTGGGACATGTCA,19,1926276
ihfAp4,3.6,21,4,CGCCTGATCATTCCGGCGTG,17,1948463
ihfAp4,3.0,18,4,CGCCATCTTGGGAGGGAGTA,14,1919308
ihfAp4,12.8,67,4,CGCCACTTCATATTCTTAGA,63,1954220
ihfAp4,3.6,21,4,CGATAGGGAATGAGCTGTGC,17,1940523
ihfAp4,0.4,5,4,CGATAAAGGAGCCCACTTTT,1,1915735
ihfAp4,1.2,9,4,CGAGGACGCGTAACAATACT,5,1942666
ihfAp4,2.0,13,4,CGACCATGTAGATTGAGACA,9,1940753
ihfAp4,0.4,5,4,CGAACCTTTGTTGAATGTAG,1,1944328
ihfAp4,2.6,16,4,CGAACAGAGATTTTATACAG,12,1953364
ihfAp4,3.0,18,4,CCTTGCCTAACGAACAACAT,14,1941032
ihfAp4,2.4,15,4,CCTTCGCGAACGCGCAACAG,11,1945275
ihfAp4,1.0,8,4,CCTGCGTATTACAATCTGAT,4,1919785
ihfAp4,5.0,28,4,CCTCGTTAATTGGAGTTGGA,24,1947361
ihfAp4,8.4,45,4,CCTCGGACAGCGAAACAAAT,41,1948844
ihfAp4,6.6,36,4,CCTCCATACGCCTCGTGCGA,32,1944076
ihfAp4,5.4,30,4,CCTCATCAAGAATAGAGATT,26,1961598
ihfAp4,2.6,16,4,CCTATTCACCCGTTAACGAC,12,1944768
ihfAp4,4.0,23,4,CCTATGCTATCTATACTGAC,19,1947533
ihfAp4,2.8,17,4,CCTATAGTGCGAGTATTTAT,13,1917191
ihfAp4,2.6,16,4,CCTACCCAACATAAGGGGCA,12,1915301
ihfAp4,3.6,21,4,CCTAATTTCAGTAATAGTCT,17,1937629
ihfAp4,3.2,19,4,CCTAATAGGTCACAGTAACT,15,1914436
ihfAp4,3.2,19,4,CCGTGTCTCCGCTTGGATTG,15,1939118
ihfAp4,3.4,20,4,CCGTACGGCCTCATGGGTGA,16,1944165
ihfAp4,4.4,25,4,CCGTACAAGTAGTATGCAAG,21,1923319
ihfAp4,4.0,23,4,CCGGCTTTACGCCACTCTGC,19,1931129
ihfAp4,4.4,25,4,CCGGCCGCGATTACGATATA,21,1943402
ihfAp4,3.8,22,4,CCGCTAATAGGAATATGTAC,18,1936826
ihfAp4,10.0,53,4,CCGCTAACCCGATACGTAAG,49,1940141
ihfAp4,0.4,5,4,CCGCGCGACAATGTAGCCGG,1,1960343
ihfAp4,3.2,19,4,CCGCCTACGAGACATGTACT,15,1909952
ihfAp4,3.6,21,4,CCGAGTCCGCCTTGCATCAT,17,1950172
ihfAp4,5.0,28,4,CCGAGCATTACGAGCCCGGA,24,1958305
ihfAp4,3.6,21,4,CCGACAAATTTAACATTTAC,17,1933917
ihfAp4,5.0,28,4,CCGAACTTACGGTTGCACCT,24,1925476
ihfAp4,1.8,12,4,CCGAACGCGTGCCGGACAGT,8,1940679
ihfAp4,8.0,43,4,CCCGAAACCAAGCGAGGGAG,39,1926224
ihfAp4,9.2,49,4,CCCCTTCAGTGCATAGGCAA,45,1935045
ihfAp4,3.8,22,4,CCCCCGTGACTTTCACACAG,18,1919733
ihfAp4,7.6,41,4,CCCAGCTAACGACCTACGGT,37,1914266
ihfAp4,1.6,11,4,CCAGTACCTAGATCTGACGT,7,1951694
ihfAp4,1.2,9,4,CCAGGATGCCACAGCGGTGT,5,1933253
ihfAp4,1.2,9,4,CATTCAGTCGCTAATGATCG,5,1945088
ihfAp4,2.0,13,4,CATTCACGACTCGGTTAGGC,9,1942400
ihfAp4,1.8,12,4,CATCTGACGGGATCCACGGT,8,1918101
ihfAp4,5.0,28,4,CATCTAACGGGATTGGAACG,24,1925904
ihfAp4,3.4,20,4,CATATGGGAGCAACGCACAT,16,1918479
ihfAp4,3.4,20,4,CATATACCATCTGCCTGTAA,16,1933161
ihfAp4,5.2,29,4,CAGTTTACCACTCTTGAATC,25,1959746
ihfAp4,5.2,29,4,CAGTGGATAAGCTTTGCTGT,25,1913759
ihfAp4,4.6,26,4,CAGTATCCCTCTCATGGTAT,22,1924176
ihfAp4,2.2,14,4,CAGTAACTCCCCCATTCGCT,10,1922268
ihfAp4,4.0,23,4,CAGATAGGTATGTCAATAGA,19,1922499
ihfAp4,5.4,30,4,CAGACACACGTTTGGTGGGA,26,1947834
ihfAp4,3.6,21,4,CACGCAATCTGATTGTCCCA,17,1957673
ihfAp4,6.6,36,4,CACATGGTATGGTACAGAAT,32,1961356
ihfAp4,3.4,20,4,CACAGTAGGTCACCGGTAGT,16,1926411
ihfAp4,7.8,42,4,CACAGAAGGACAGGCCCTAA,38,1924240
ihfAp4,8.0,43,4,CAATGACTCCGGTTCAAATT,39,1928672
ihfAp4,0.8,7,4,CAAGTGTCCACGTAGGGAAA,3,1928070
ihfAp4,4.4,25,4,CAAGCCGCTTTCAATAGCTA,21,1920129
ihfAp4,3.2,19,4,CAACTTGACGTAGTCCGCTT,15,1934580
ihfAp4,2.6,16,4,CAACGTGGCCGTTCTAGTTA,12,1940860
ihfAp4,6.8,37,4,CAACCGTACGGTCGCATGTC,33,1945894
ihfAp4,4.8,27,4,CAACCCGACCCGAGGCACAT,23,1914082
ihfAp4,0.4,5,4,CAACCATACAAAAGTTCACA,1,1917031
ihfAp4,6.8,37,4,CAAATGATTGCTAGCGATTA,33,1950651
ihfAp4,4.2,24,4,ATTTCATATGGTCTCTGGGA,20,1943894
ihfAp4,0.4,5,4,ATTGGGAGCAAATAGTACGT,1,1916279
ihfAp4,1.2,9,4,ATTGCTGTGGCAACTAATCT,5,1929907
ihfAp4,9.6,51,4,ATTCGCTAATTCTGGACCCC,47,1918863
ihfAp4,13.6,71,4,ATTACAATGATAGGACTGGC,67,1960574
ihfAp4,1.2,9,4,ATGTTTTTCCGACCCCTTGT,5,1948712
ihfAp4,4.0,23,4,ATGTGGCAGGGGTGTTGCAA,19,1948556
ihfAp4,0.4,5,4,ATGTGAAAATGCTTGTCACA,1,1918543
ihfAp4,3.6,21,4,ATGTAAATGTCTTCGAGTCT,17,1945690
ihfAp4,3.6,21,4,ATGCCCCACAAACAAACCGC,17,1922364
ihfAp4,10.0,53,4,ATCTTGTCAGCTTAGCGTTA,49,1939952
ihfAp4,7.4,40,4,ATCTATCTTTCTCTTACAGA,36,1926018
ihfAp4,3.6,21,4,ATCTACGGAGTAGTCTTATC,17,1942609
ihfAp4,5.2,29,4,ATCGTATCCAGTGGTTTTGG,25,1909653
ihfAp4,4.2,24,4,ATCGCACCGCCTGCGTAATG,20,1911368
ihfAp4,5.4,30,4,ATCCTGGTCCAAAGGCATCA,26,1961029
ihfAp4,2.2,14,4,ATCCCGGCAAGGCCACCCTT,10,1921650
ihfAp4,5.4,30,4,ATCACATTGGGCGCCAGCCC,26,1921212
ihfAp4,1.4,10,4,ATATGCCGGTCGAGCGATGC,6,1917378
ihfAp4,2.8,17,4,ATATATGGGCACCCAAATGG,13,1957260
ihfAp4,4.6,26,4,ATAGCCACTCCAACAGTCTG,22,1957307
ihfAp4,3.4,20,4,ATACTCCTGGTTTAAATAAT,16,1915895
ihfAp4,37.4,190,4,ATACGGTCAAAACAAGCATA,186,1962113
ihfAp4,9.0,48,4,ATACGGACCGAGCGCGTCAT,44,1953376
ihfAp4,7.4,40,4,ATACCCTGGTATTTCAACCT,36,1958879
ihfAp4,8.2,44,4,ATAAGATATGCTTCTCCTCT,40,1933299
ihfAp4,3.6,21,4,ATAACCTAAGCTAATTTTCT,17,1914231
ihfAp4,8.0,43,4,AGTGCTCTTGGCTTAGGTAG,39,1916217
ihfAp4,4.0,23,4,AGTCCGGCCCCTAAGACTCT,19,1924712
ihfAp4,2.0,13,4,AGTCCACGGCGCAAAGCTTG,9,1915944
ihfAp4,2.4,15,4,AGTATGGTCGTTTTCACGAT,11,1943595
ihfAp4,3.2,19,4,AGTATATTAACGTGGCCATG,15,1917913
ihfAp4,2.2,14,4,AGTACGTCTGATACTTTCTA,10,1947748
ihfAp4,2.6,16,4,AGGTAAACTCAATCCGAATC,12,1960592
ihfAp4,1.6,11,4,AGGGCCTATCGAAAGGCACT,7,1912548
ihfAp4,1.8,12,4,AGGCGTATATGATCTCTTCG,8,1955813
ihfAp4,4.4,25,4,AGGCGCGCGTGTCGCACCTC,21,1938629
ihfAp4,5.2,29,4,AGGCCAATATCATCCAACGG,25,1936799
ihfAp4,1.0,8,4,AGGCACGCATCGGGTGACTT,4,1912793
ihfAp4,3.0,18,4,AGGACAATCCTTTCAAGAAT,14,1911479
ihfAp4,5.6,31,4,AGCTTATCTGCTCAGTTCGT,27,1921883
ihfAp4,2.2,14,4,AGCTAATGACCACAACCTTG,10,1924739
ihfAp4,4.4,25,4,AGCGCGGCCGAGTAGCGCAG,21,1950190
ihfAp4,3.6,21,4,AGCGAACGGAGGCAAATATA,17,1933191
ihfAp4,1.4,10,4,AGCCCGTGTGGCTAATTTTA,6,1936757
ihfAp4,3.8,22,4,AGCAAGCCTTCCCTTGAATG,18,1915576
ihfAp4,17.0,88,4,AGAGGTACCATTGTTCGAAA,84,1925019
ihfAp4,4.8,27,4,AGAGCCCACTGCCGGTGCTG,23,1931403
ihfAp4,9.4,50,4,AGACTTAGTGGTGAGCTTCC,46,1933330
ihfAp4,3.4,20,4,AGACATATCGCCCTAGCGGG,16,1920155
ihfAp4,3.0,18,4,ACTTTAGAAGATCGATAATC,14,1921709
ihfAp4,0.4,5,4,ACTGCTTAGTCAGACTTGAA,1,1928648
ihfAp4,9.4,50,4,ACTCTTTCGTTTACAGCTAA,46,1941250
ihfAp4,3.2,19,4,ACTCCGCCGACATGCACTTT,15,1932234
ihfAp4,1.0,8,4,ACTCCCCGGTAAAGGAGGCC,4,1942437
ihfAp4,4.8,27,4,ACTCAAGTATTCTACGTTAG,23,1941742
ihfAp4,0.4,5,4,ACTATCTCTGTCATGCAATC,1,1958196
ihfAp4,6.0,33,4,ACTACGTCGATGGGTCCCTT,29,1916145
ihfAp4,5.8,32,4,ACTAAGTATATCTTTCAAAT,28,1929130
ihfAp4,8.8,47,4,ACGTCATCGTCGAAAAGCTG,43,1910193
ihfAp4,8.2,44,4,ACGGGATCAATCGAAAGTAG,40,1933090
ihfAp4,10.0,53,4,ACGGGAGGATTATTACATAT,49,1933188
ihfAp4,1.8,12,4,ACGGAAGGCAGTACCCCCCG,8,1918145
ihfAp4,15.4,80,4,ACGCTCAACGTCGAGGTCCG,76,1955832
ihfAp4,3.2,19,4,ACCTGATAGAATATAAAATA,15,1933789
ihfAp4,8.0,43,4,ACCTATCGGACTTTATTACG,39,1961176
ihfAp4,0.4,5,4,ACCGACCTGATCTATTGATC,1,1925262
ihfAp4,0.4,5,4,ACCGAACGTAACCAAGAGCT,1,1938899
ihfAp4,0.4,5,4,ACCCCGTTACGTGCGTCTCG,1,1927614
ihfAp4,4.2,24,4,ACCAGCGCGGTGTAGGGGTA,20,1920170
ihfAp4,0.8,7,4,ACCAACTGGTAGTCATAGTT,3,1910377
ihfAp4,1.8,12,4,ACATCCATCTTTCATCTCGT,8,1949031
ihfAp4,5.0,28,4,ACAGGAAATTTGAAGGTGCA,24,1916906
ihfAp4,5.2,29,4,ACAGCGACCCCCATTATACC,25,1953996
ihfAp4,1.4,10,4,AATTCGCGCCGGTGGTGCTG,6,1939781
ihfAp4,3.2,19,4,AATTATGTAACGTGCCTGGA,15,1938707
ihfAp4,13.6,71,4,AATGTTATGCAGCAGATGCT,67,1915420
ihfAp4,3.0,18,4,AATGCTCTCGACTGATAAAT,14,1952427
ihfAp4,4.4,25,4,AATCGCGACATAGGAAACTC,21,1958046
ihfAp4,2.8,17,4,AATCGATCCCTGGAGTAATC,13,1933719
ihfAp4,10.8,57,4,AATAGGTCTTCGCATATTCC,53,1957994
ihfAp4,2.4,15,4,AATACTGTAACTCCGACAGT,11,1918575
ihfAp4,0.6,6,4,AAGGTACGCAATCGGTCTCA,2,1925815
ihfAp4,2.2,14,4,AAGGGCAACGGTATGGCGCC,10,1928998
ihfAp4,0.4,5,4,AAGCTATTATGGCAGCAAAA,1,1928165
ihfAp4,0.6,6,4,AAGCGGTAGGCAGGTGGATG,2,1948464
ihfAp4,8.8,47,4,AAGCCTTTGTACGGAGTTTT,43,1933746
ihfAp4,4.0,23,4,AAGCCTCATTGACTAACCAT,19,1954886
ihfAp4,6.6,36,4,AAGCATTTTTTATCCTTGAT,32,1959466
ihfAp4,1.4,10,4,AAGCAGTAGGTCTCCATAAA,6,1911476
ihfAp4,0.4,5,4,AAGCAGCTGTAAGACGAGGC,1,1929224
ihfAp4,0.4,5,4,AAGAACCTGACTACAGCCTA,1,1958140
ihfAp4,1.0,8,4,AACTTCTGCTGTAGTTTCTC,4,1933608
ihfAp4,3.6,21,4,AACTTCATCTAGGGTACCGG,17,1913855
ihfAp4,24.0,123,4,AACTCGGGTGGGTATAATTG,119,1960099
ihfAp4,4.2,24,4,AACGGTGTTACGTCCTCCTT,20,1933712
ihfAp4,3.2,19,4,AACCAGAATGGGTTACAAGG,15,1930771
ihfAp4,18.0,93,4,AACAAAGGCGGTAATATGAG,89,1926108
ihfAp4,9.6,51,4,AAATTTTGCGTTGTAGGTAA,47,1935677
ihfAp4,2.4,15,4,AAATGACTGGGGGAGGTAAG,11,1946706
ihfAp4,2.2,14,4,AAATCGCTCAGAATTCCATC,10,1945102
ihfAp4,2.2,14,4,AAATCCAACGGTTCCCCCTG,10,1930103
ihfAp4,6.2,34,4,AAAGGCATTGGGAACCACTC,30,1939346
ihfAp4,3.8,22,4,AAACTCCTAGCGGCCTTATG,18,1934828
ihfAp4,7.0,38,4,AAAATTCCCACCGTGGCTAA,34,1933337
ihfAp4,3.6,21,4,AAAAGATTTGCCCTCTTGGG,17,1947632
ihfAp4,0.4,5,4,AAAAAGAGGTAAGTGAACGG,1,1914573
ihfAp4,0.5,4,3,TTTTCGAGGTACATGGAGTT,1,1961609
ihfAp4,5.0,22,3,TTTGTCCTTATGGGCTGCAA,19,1956508
ihfAp4,1.0,6,3,TTTGGGGTCGTTTTCATGAC,3,1931879
ihfAp4,5.0,22,3,TTTGAGAGGGATTCAACCTC,19,1943831
ihfAp4,9.0,38,3,TTTCGCCGGTTGCTCGCGGA,35,1915160
ihfAp4,3.75,17,3,TTTATTTCTACTTGCTGCTC,14,1921768
ihfAp4,8.5,36,3,TTTATCGAGCAAATGGCTGA,33,1938396
ihfAp4,4.75,21,3,TTTAGGGTGAGCCAGGAATC,18,1922875
ihfAp4,15.0,62,3,TTTACTATTCTTCGGATCCC,59,1956012
ihfAp4,18.75,77,3,TTGTTGCAGGATGTTCTCCT,74,1948937
ihfAp4,15.5,64,3,TTGTAGTGTGATTTCCCTAG,61,1955336
ihfAp4,15.75,65,3,TTGGTCCTCGGAATTGAACG,62,1929525
ihfAp4,2.5,12,3,TTGGGCCTGCACAGAAGTGT,9,1947469
ihfAp4,0.5,4,3,TTGGAGCTACGCTCTCGGCC,1,1914283
ihfAp4,3.75,17,3,TTGGAACCCTCAGAATTAGT,14,1944029
ihfAp4,8.5,36,3,TTGCCTGCGGAAGGACATAT,33,1913650
ihfAp4,3.75,17,3,TTGATGTCATTAGGGAATGT,14,1940256
ihfAp4,3.25,15,3,TTGAGTCTCGCATTTGAAGC,12,1945998
ihfAp4,4.25,19,3,TTGAATATTACGTAACAGCT,16,1923331
ihfAp4,7.75,33,3,TTGAACTAATAAGTAGGGCA,30,1954959
ihfAp4,6.25,27,3,TTCTGGTACTCCTAAACTAA,24,1940468
ihfAp4,4.0,18,3,TTCGAGCACAACATCAAACC,15,1940211
ihfAp4,4.5,20,3,TTCCGGGCGCTGTCATTACA,17,1952071
ihfAp4,1.25,7,3,TTCCCCAGTAGGACTCGGCC,4,1957287
ihfAp4,1.25,7,3,TTCCACGGGTTGAACGTTCT,4,1949766
ihfAp4,6.75,29,3,TTCAGGTGGTTTCAAAAGAA,26,1939124
ihfAp4,4.0,18,3,TTAGTCCAAGTTATGTTATT,15,1914753
ihfAp4,1.25,7,3,TTACTGGTGATAGACGTGTG,4,1920962
ihfAp4,6.0,26,3,TTACCGAGAGAGACGCCGAG,23,1948963
ihfAp4,4.0,18,3,TTACATCTTAATTTCCGAAG,15,1912493
ihfAp4,5.25,23,3,TTAATCGCATCAGAAGTTAC,20,1958892
ihfAp4,12.0,50,3,TTAACGGTCGGACGTCCTTG,47,1910537
ihfAp4,8.25,35,3,TGTTTGATACCTACGACGAT,32,1915813
ihfAp4,6.5,28,3,TGTCGGACTCGGTGTCCCGC,25,1925039
ihfAp4,7.5,32,3,TGTACTCCCCTCCCAAGGTA,29,1936708
ihfAp4,0.5,4,3,TGTACACACATGCACGTGGA,1,1949495
ihfAp4,6.75,29,3,TGGTATCTGGCGAAGCCTAT,26,1944876
ihfAp4,8.75,37,3,TGGGTGCCCAGGCAAACGGC,34,1949126
ihfAp4,13.75,57,3,TGGGGAGTAAGCCTCTCATT,54,1945586
ihfAp4,5.75,25,3,TGGGACCTTACCACTGTGTA,22,1936764
ihfAp4,8.25,35,3,TGGCCAGATATCGTTCATTA,32,1930999
ihfAp4,3.25,15,3,TGGATCGCCGGCAATTTCTT,12,1950771
ihfAp4,11.5,48,3,TGGAACGCGGAACCTCGCTT,45,1961230
ihfAp4,0.5,4,3,TGGAACAGACGCCACTACGT,1,1950030
ihfAp4,2.25,11,3,TGCTGGCCGTATAGCCGAAT,8,1949480
ihfAp4,6.0,26,3,TGCTCAGCTGACTGGGGTCA,23,1927878
ihfAp4,0.75,5,3,TGCGAAAGTCTGCAGAAAGG,2,1914135
ihfAp4,2.0,10,3,TGATGGGGGGGGATCTACAT,7,1923316
ihfAp4,7.25,31,3,TGATCTCACTTTTGCAAGGC,28,1933227
ihfAp4,8.0,34,3,TGATCTACAACATGTTGCTG,31,1962093
ihfAp4,7.0,30,3,TGATCGTGAACGCGCTGAGC,27,1960965
ihfAp4,2.0,10,3,TGATCCCACGAGTGATTGAT,7,1932846
ihfAp4,17.0,70,3,TGAGGTCTCCGATTTAGGAT,67,1934601
ihfAp4,14.0,58,3,TGAGCTATGCGACCCCCCGG,55,1916615
ihfAp4,2.0,10,3,TGACCCTGTTCTCTGCATAG,7,1957000
ihfAp4,7.5,32,3,TGACAAGGTACTGCCAGCCT,29,1912210
ihfAp4,9.25,39,3,TCTTGAATCTGTTAAGGCAT,36,1960050
ihfAp4,2.25,11,3,TCTTCGGGTTTTCGTGCCGT,8,1943228
ihfAp4,4.25,19,3,TCTTCCGTACTCGTAGGGGC,16,1953941
ihfAp4,6.0,26,3,TCTGTTGAATTTTCGGGCAT,23,1952534
ihfAp4,7.0,30,3,TCTCCGAAGATCCTGATCGG,27,1953786
ihfAp4,4.75,21,3,TCTATAGGGCGCCACGAAAA,18,1928045
ihfAp4,7.5,32,3,TCTAGGGAGATGGTCTTCGA,29,1939793
ihfAp4,1.75,9,3,TCTACGATGCATGATGCAAG,6,1952107
ihfAp4,3.25,15,3,TCTAACTATGATCCGGAGCG,12,1932652
ihfAp4,5.75,25,3,TCGTGTCGCTAGGGACTAAA,22,1960944
ihfAp4,5.25,23,3,TCGTGTAAACAGGCGCGTGT,20,1961667
ihfAp4,7.25,31,3,TCGTCTAGACCGATTTAGTA,28,1927441
ihfAp4,2.0,10,3,TCGTAGTTAGCCTCTCTAGG,7,1961190
ihfAp4,4.5,20,3,TCGTACCGACGACGAGAACT,17,1926090
ihfAp4,5.5,24,3,TCGCGTGGTCCTAAGGGACC,21,1926194
ihfAp4,16.0,66,3,TCGCACAAGTTGTTATCTAG,63,1933095
ihfAp4,6.0,26,3,TCGCAAGGTTTTGAAGCATT,23,1928883
ihfAp4,15.5,64,3,TCGATTGGTCCGTGATAAAA,61,1957023
ihfAp4,4.25,19,3,TCGAATCACAGGCAGAGTGA,16,1910945
ihfAp4,6.0,26,3,TCCTTGCTGTACATTCCGCG,23,1953227
ihfAp4,8.0,34,3,TCCGTACAGCCGGGCGTCGT,31,1962236
ihfAp4,10.75,45,3,TCCGGAGTTGGTGGTGACCT,42,1945412
ihfAp4,10.0,42,3,TCCGGAGTTCCTGGTTCTTT,39,1954152
ihfAp4,16.0,66,3,TCCGCGGAGCATGCCAGAAC,63,1961557
ihfAp4,2.0,10,3,TCCCTCCGAGTGTGGTTGCT,7,1912663
ihfAp4,5.5,24,3,TCCAGTGGTTATAAAATGGC,21,1928373
ihfAp4,3.5,16,3,TCATGACAAGTAAATCCCTG,13,1917910
ihfAp4,8.0,34,3,TCAGTAAAAGCCCAGCCAAC,31,1939439
ihfAp4,12.0,50,3,TCAGCGGGCATGACTACGCT,47,1943233
ihfAp4,0.5,4,3,TCAGATGTTAGTGGTCACAT,1,1922925
ihfAp4,0.5,4,3,TCACGTGGACCTACGGCTTA,1,1921087
ihfAp4,1.0,6,3,TCACCTTCCAACTCTTCGTC,3,1951096
ihfAp4,6.75,29,3,TCAATCTTGAGCACCTACAC,26,1961058
ihfAp4,5.5,24,3,TCAATAAACAAGGTTCGACC,21,1935268
ihfAp4,0.5,4,3,TCAAGTTCCAATACGACTCA,1,1921415
ihfAp4,2.5,12,3,TCAAACAATGCCGTACATTT,9,1934333
ihfAp4,0.5,4,3,TCAAAAAGGCACCGACAACC,1,1924762
ihfAp4,24.75,101,3,TATTGCTTTTTTCAATATAG,98,1932453
ihfAp4,9.75,41,3,TATTGCGAGGGAATCGCCAT,38,1910792
ihfAp4,7.0,30,3,TATTGATCTCCAAAGCGGTG,27,1948921
ihfAp4,3.25,15,3,TATTCTAGGCACTCAATTGG,12,1918726
ihfAp4,8.75,37,3,TATTAGACAAGCCCCCATAG,34,1915182
ihfAp4,3.5,16,3,TATTAAGCTAGTACCACTTA,13,1929537
ihfAp4,6.75,29,3,TATGGTTATATATCCAACTT,26,1910542
ihfAp4,3.75,17,3,TATGGGAGTTGATGCCCCGT,14,1949771
ihfAp4,0.5,4,3,TATCCAACCTGGTGAGGGAT,1,1916331
ihfAp4,15.75,65,3,TATCACCGGTGCACACGTGG,62,1926717
ihfAp4,8.25,35,3,TATAGAGCGACATAGATGTT,32,1940131
ihfAp4,0.75,5,3,TAGGGAAGCGTAGCCAAAAG,2,1941892
ihfAp4,5.75,25,3,TAGCGCGGGGTGAGGTTACC,22,1930742
ihfAp4,5.0,22,3,TAGAGCGGGCAGAAGCATAT,19,1940006
ihfAp4,6.0,26,3,TAGAAGGTAGGGACCTCACT,23,1917843
ihfAp4,4.25,19,3,TAGAAAACACCTCCTCGACT,16,1936155
ihfAp4,12.25,51,3,TACGGTCACACAGACCCATA,48,1926780
ihfAp4,8.25,35,3,TACCCTAGAGCAAAGTACGA,32,1940273
ihfAp4,0.75,5,3,TACACTGAAAGTCAATAAAA,2,1910871
ihfAp4,8.75,37,3,TAATGGCCTGCGATCACGCT,34,1931351
ihfAp4,7.25,31,3,TAATCGGCCACGGAATCTGA,28,1955352
ihfAp4,5.25,23,3,TAATATCTACCAGTCGAGCC,20,1932547
ihfAp4,3.75,17,3,TAAGCGCGGTCCTATGACAA,14,1909675
ihfAp4,8.0,34,3,TAACTAGGGTCTGTATGTAT,31,1943078
ihfAp4,17.5,72,3,TAAACTCCTAAGGGCCGTCT,69,1947385
ihfAp4,0.5,4,3,GTTTTAAGAAACGTCCTTAA,1,1926045
ihfAp4,5.0,22,3,GTTGTTAGGCGGTACGCGGC,19,1955861
ihfAp4,3.5,16,3,GTTGGACCTTGTGTAGTACA,13,1941226
ihfAp4,5.0,22,3,GTTATATCGTATCGGATTGC,19,1922864
ihfAp4,7.0,30,3,GTTAGTACAGGGCACAGCCC,27,1920667
ihfAp4,0.75,5,3,GTTAGACGGCTACCCGTGTA,2,1921297
ihfAp4,5.5,24,3,GTTACACACAGTACACTGTT,21,1911959
ihfAp4,4.0,18,3,GTGTTGTTTCGACGCATGCA,15,1956790
ihfAp4,4.0,18,3,GTGTGACGCAAGGTAGATAG,15,1934666
ihfAp4,6.5,28,3,GTGTCATCGTATCTATCGAT,25,1937833
ihfAp4,2.5,12,3,GTGTCAAAAGTACTATGTAG,9,1960216
ihfAp4,4.75,21,3,GTGGGGTCGCTTCCGTGAGG,18,1941727
ihfAp4,1.0,6,3,GTGCATTTACCTACGACGGG,3,1937774
ihfAp4,2.75,13,3,GTGCATCCGAGCATCTCCGC,10,1911709
ihfAp4,3.0,14,3,GTGATTCAGTAATTTCCTGG,11,1931959
ihfAp4,9.0,38,3,GTGAACCGGTTACTTTACGA,35,1917054
ihfAp4,2.5,12,3,GTCTTCTATCTGGTTATCAG,9,1912439
ihfAp4,3.75,17,3,GTCTCGCGTCTCATCGAAAG,14,1914666
ihfAp4,7.75,33,3,GTCTATACCTCCAGGGATCA,30,1930953
ihfAp4,9.75,41,3,GTCGTGAGTCAAGCGTCACA,38,1948917
ihfAp4,3.25,15,3,GTCGGACATTATTTGCATTT,12,1956398
ihfAp4,11.25,47,3,GTCGCGTTAGATTATCGCGA,44,1909961
ihfAp4,3.5,16,3,GTCCCTGCCTCGACATAAGT,13,1917251
ihfAp4,5.75,25,3,GTCCATGGATTCCATACGTA,22,1939250
ihfAp4,13.25,55,3,GTCATCGGTCCCTGACTCTG,52,1916148
ihfAp4,5.5,24,3,GTCAACGGTCGTTGACCTAA,21,1909618
ihfAp4,0.5,4,3,GTATGGGACTGGTATTGTGC,1,1916502
ihfAp4,3.25,15,3,GTATCATGTTTGGGTGGTCT,12,1955880
ihfAp4,10.5,44,3,GTACTTTCCCAGCGTTTTAG,41,1947539
ihfAp4,2.5,12,3,GTACTTTAAGGCATCTACAT,9,1950794
ihfAp4,5.75,25,3,GTACACGACATGGGTGATGT,22,1916346
ihfAp4,2.75,13,3,GTAATGACGACGTGTCTGGT,10,1924755
ihfAp4,2.75,13,3,GTAACGCCTGGCGATAGTGA,10,1951603
ihfAp4,13.0,54,3,GTAACCGGTAGAATTCGCTA,51,1918655
ihfAp4,1.75,9,3,GGTTTTTCGTTCTGGGTAAC,6,1957542
ihfAp4,11.75,49,3,GGTTGATAAATCCCGGTACG,46,1931133
ihfAp4,4.75,21,3,GGTGAGTTGGAGGCGCCGGG,18,1919018
ihfAp4,0.5,4,3,GGTCTCCGGGAGAAACCGCA,1,1926887
ihfAp4,32.0,130,3,GGTCGCCGCCCATACAATCT,127,1913649
ihfAp4,9.5,40,3,GGTCCAATATTTATATCCTC,37,1955886
ihfAp4,8.25,35,3,GGTCACCCCGGGTCATAATC,32,1913378
ihfAp4,10.0,42,3,GGTATATAAGAGTGTAGATA,39,1958635
ihfAp4,4.0,18,3,GGTATACATGCAGATTAGAG,15,1912903
ihfAp4,4.0,18,3,GGTAGATTAGCCGTGTGGGT,15,1947370
ihfAp4,3.5,16,3,GGTAGACAGATACTCGTGTG,13,1959003
ihfAp4,14.0,58,3,GGGTTCGATCAGACGTTAGA,55,1933349
ihfAp4,9.75,41,3,GGGTCCTGAAATCCCGAAGC,38,1928630
ihfAp4,0.5,4,3,GGGGTAAATCGCCCTAGTGA,1,1961530
ihfAp4,5.0,22,3,GGGGCGATGAATAATTGCCA,19,1954824
ihfAp4,3.75,17,3,GGGGAACGTGTGTTTACCCG,14,1955556
ihfAp4,2.75,13,3,GGGCCATTGCCATGCGGCAG,10,1916274
ihfAp4,5.0,22,3,GGGATCTAATCCCGTGGCCC,19,1923129
ihfAp4,13.25,55,3,GGGAGTGTGATGCAAGCGTA,52,1956088
ihfAp4,3.25,15,3,GGGACAGACGTTTGCATAAG,12,1930142
ihfAp4,5.75,25,3,GGCGTTATCGTCATTCCACC,22,1914495
ihfAp4,53.0,214,3,GGCGTACGGGATCTGTCCCT,211,1921934
ihfAp4,5.5,24,3,GGCGCATAAATACTCTTTCC,21,1945410
ihfAp4,5.75,25,3,GGCCTGGCAGCTAGTAGAGT,22,1959348
ihfAp4,10.0,42,3,GGCCGGCGATCTCGAAGCGC,39,1933261
ihfAp4,9.25,39,3,GGCCGGCCGAAGCGCCAAAC,36,1944102
ihfAp4,3.25,15,3,GGCATGAGGACGGGTACCCT,12,1944946
ihfAp4,5.0,22,3,GGCACTAACGCATTATCCAT,19,1935844
ihfAp4,4.25,19,3,GGCAAATCCGTCAAGTATAT,16,1916997
ihfAp4,4.5,20,3,GGATCTGGTTCAGGCGACTG,17,1938313
ihfAp4,0.5,4,3,GGATCACCCTCAGTCGTGTG,1,1952354
ihfAp4,2.0,10,3,GGAGCTGAATTTCAGGTCAA,7,1949129
ihfAp4,4.5,20,3,GGAATGTGATTTGAGATGCT,17,1927910
ihfAp4,6.75,29,3,GGAATGTCAGCGTGTGTTCC,26,1950049
ihfAp4,4.75,21,3,GGAAATCGTCTATGGTGGGA,18,1919659
ihfAp4,5.0,22,3,GGAAACCGGTTGCCTTATTA,19,1921904
ihfAp4,6.5,28,3,GCTTTGTTGTGCAACCCCGG,25,1921149
ihfAp4,1.5,8,3,GCTTCTAGGTTACATTTTGT,5,1917715
ihfAp4,5.0,22,3,GCTTATGCCCCACACAGTCT,19,1926359
ihfAp4,8.0,34,3,GCTGTGGTCTTGGACATCGG,31,1915427
ihfAp4,3.25,15,3,GCTGAGATCGATCGTCACCT,12,1926859
ihfAp4,7.0,30,3,GCTCCGCCATAATTCTGTTA,27,1952019
ihfAp4,1.25,7,3,GCTAGACGATTTGCTCCAAA,4,1925133
ihfAp4,1.0,6,3,GCTACAAGGATGGAATAGAG,3,1914378
ihfAp4,6.25,27,3,GCGTAGAAAGGGAGAGTATA,24,1936612
ihfAp4,8.25,35,3,GCGGTTGGGTCACGCCGGCC,32,1947776
ihfAp4,7.75,33,3,GCGGATCGTTTTGATAGCTG,30,1916832
ihfAp4,6.0,26,3,GCGCTCACGAGCTGACATTT,23,1914968
ihfAp4,5.5,24,3,GCGATTCAATCACCATTCTG,21,1939394
ihfAp4,6.5,28,3,GCGATTAATGTGCATGTTCC,25,1939671
ihfAp4,5.5,24,3,GCGATAAAAATTCCTCTTAC,21,1938669
ihfAp4,2.75,13,3,GCGAATACAGTCTAGCGTAG,10,1948665
ihfAp4,4.0,18,3,GCCTTCATGACATTTCTCTC,15,1920076
ihfAp4,5.0,22,3,GCCGGCTTTGACCGGAGACA,19,1961504
ihfAp4,16.25,67,3,GCCGAGCTAGTCCTGCGAAC,64,1958129
ihfAp4,7.75,33,3,GCCACCGCCAAGGCACTGTT,30,1955916
ihfAp4,0.75,5,3,GCCAACAGAAGGACCTGCGT,2,1935352
ihfAp4,1.5,8,3,GCATCTCGCTAAACCGGCTT,5,1947984
ihfAp4,0.5,4,3,GCATAGCTAATCGGAACATT,1,1917710
ihfAp4,11.0,46,3,GCAGGCGCGAAAAAGGTCAT,43,1960175
ihfAp4,3.25,15,3,GCACCATTCTATGCAGCAGA,12,1914094
ihfAp4,2.0,10,3,GCAATGTATTCAAACGTAGC,7,1960325
ihfAp4,1.5,8,3,GCAATGCACGGTCGCGTGAC,5,1922903
ihfAp4,10.0,42,3,GATTTCTAGCCATGGTAAAT,39,1921918
ihfAp4,56.0,226,3,GATTTCGGGTGCATATACCT,223,1960096
ihfAp4,1.75,9,3,GATTGTATTTCCGAGGCACA,6,1951746
ihfAp4,4.75,21,3,GATGAGTGGGCTAGCGGTTG,18,1924596
ihfAp4,14.25,59,3,GATCTGAGGAAAGGACCCTG,56,1955467
ihfAp4,0.75,5,3,GATCATCGGACGTCTGGATG,2,1942383
ihfAp4,0.5,4,3,GATACAGTACTGTCGCGACA,1,1960573
ihfAp4,2.75,13,3,GAGTGTTTAGAAGACAGCGT,10,1941512
ihfAp4,3.0,14,3,GAGGTCAGCGTGTACCGGTT,11,1927006
ihfAp4,4.25,19,3,GAGGGGCATGAGTGCTACAG,16,1957358
ihfAp4,9.25,39,3,GAGAACATCATCGACTCAGA,36,1926633
ihfAp4,1.5,8,3,GACTTTCTAGCGGTCACTCT,5,1932751
ihfAp4,4.75,21,3,GACTGTCACTAGGGTGGCCC,18,1949315
ihfAp4,1.5,8,3,GACTCTTCAAACTTCCGACA,5,1959745
ihfAp4,19.0,78,3,GACTCCGGGTTATTCCAATA,75,1913540
ihfAp4,22.75,93,3,GACTCAGTGGGTTACATTTT,90,1959479
ihfAp4,5.0,22,3,GACGGAAGCGGACAAAGTTA,19,1948842
ihfAp4,6.75,29,3,GACGCAACAATAAAGTATGC,26,1930202
ihfAp4,12.25,51,3,GACGAGTCCACTAAACGTTC,48,1918097
ihfAp4,5.5,24,3,GACGACTGAGGATCCAACAG,21,1943115
ihfAp4,3.25,15,3,GACATTCCCCCACCTTGTAG,12,1949075
ihfAp4,16.75,69,3,GACATAGGAGTGACGCACCT,66,1924059
ihfAp4,10.75,45,3,GACAAACCCGAGCTTTTGAT,42,1935600
ihfAp4,5.75,25,3,GAATTTTTCACTGTTCTAAT,22,1962078
ihfAp4,4.0,18,3,GAATAGGGATTTACAGGGTC,15,1922800
ihfAp4,7.5,32,3,GAAGTTGTTAAGTCCCGTGC,29,1917634
ihfAp4,0.5,4,3,GAAAGTCCGGACCCTTTCGT,1,1949245
ihfAp4,3.0,14,3,GAAACTGAGATTGAATTCCG,11,1925906
ihfAp4,0.5,4,3,CTTTTGAAATGCGCAGTAGA,1,1914622
ihfAp4,2.0,10,3,CTTTTCGACGTGGATGCTAC,7,1912984
ihfAp4,5.0,22,3,CTTTGACGTAGTAGCGAGCG,19,1915157
ihfAp4,9.75,41,3,CTTTATCTGATGGTGGGTAC,38,1935856
ihfAp4,5.5,24,3,CTTTAGTCAAGATCTTTCAT,21,1924633
ihfAp4,8.75,37,3,CTTGTATAATGAAGCATACA,34,1924243
ihfAp4,3.25,15,3,CTTGGGGTTCACAAAATCCG,12,1929680
ihfAp4,6.25,27,3,CTTGCAGATCGTGCACGTGA,24,1928547
ihfAp4,6.5,28,3,CTTGACTGTCCACACAGGGA,25,1918887
ihfAp4,1.75,9,3,CTTCTCACGGTCTACGCGTT,6,1922435
ihfAp4,13.0,54,3,CTTCGCTACGTAGGCCGCTA,51,1947008
ihfAp4,3.5,16,3,CTGGGCTCCGCTGGGGTTCG,13,1951788
ihfAp4,0.5,4,3,CTGGCCAGAGGGCACATAAT,1,1937325
ihfAp4,20.25,83,3,CTGCAATGCTCTATTGCTAG,80,1960095
ihfAp4,2.25,11,3,CTGATTGCAAAGAGATTTTG,8,1956010
ihfAp4,10.75,45,3,CTGAGGAGTGTTTCAGCTGG,42,1932276
ihfAp4,0.75,5,3,CTGAGCGGGTAGGTCGGATT,2,1943224
ihfAp4,13.0,54,3,CTGACGCGTGGAGGGAGCTA,51,1958595
ihfAp4,1.0,6,3,CTGACCGTTCTGCGCGGGCA,3,1942315
ihfAp4,6.25,27,3,CTGAAGGCGGTACGAATCGC,24,1957468
ihfAp4,6.25,27,3,CTCGGTCAGCATCGGCAGTA,24,1942894
ihfAp4,14.75,61,3,CTCGGCGAACATTTCTGGCG,58,1960250
ihfAp4,7.5,32,3,CTCGCGCGATAGATTTACCC,29,1960384
ihfAp4,6.25,27,3,CTCCTCTCCTCGAGAAGGAT,24,1916303
ihfAp4,5.75,25,3,CTCCGTAGATATGTGTGGGA,22,1912129
ihfAp4,2.5,12,3,CTCCCGAACAGGACGTTCGC,9,1923667
ihfAp4,9.0,38,3,CTCCACTTAGTCTAATAAGA,35,1912884
ihfAp4,9.25,39,3,CTCATACTCTCTTTCCGAGT,36,1926701
ihfAp4,8.75,37,3,CTCAGACAGCAAACAATCCA,34,1925724
ihfAp4,4.25,19,3,CTCACTCTCTCTTAGTATTG,16,1926390
ihfAp4,3.25,15,3,CTCACCGCTTACGGGCGCTG,12,1934231
ihfAp4,7.0,30,3,CTATACACGCGCCTTACCCC,27,1920394
ihfAp4,1.5,8,3,CTAGAGCCGGCTATACGCGA,5,1934668
ihfAp4,5.5,24,3,CTACGGCTCGGGTTATTTGG,21,1948145
ihfAp4,6.5,28,3,CTAAGCTTCACGCACGTTCC,25,1958451
ihfAp4,4.0,18,3,CTAAGCATAAGGTTCCGGCG,15,1939954
ihfAp4,10.75,45,3,CTAACGCCTACTGATTAATT,42,1930949
ihfAp4,6.75,29,3,CTAAATGTGACAAAAATCAT,26,1925281
ihfAp4,2.75,13,3,CGTTGCTCACTTTACCCTGG,10,1954502
ihfAp4,6.0,26,3,CGTTCCCTCAATACATTATG,23,1954592
ihfAp4,7.5,32,3,CGTGAATATCCCCACGCTCA,29,1954437
ihfAp4,14.0,58,3,CGTCTCGTCGAGTATCCATA,55,1926204
ihfAp4,12.75,53,3,CGTCGGTAACCAAAAGGGGG,50,1955696
ihfAp4,3.5,16,3,CGTATTCTGAATATCGTGTA,13,1930652
ihfAp4,1.0,6,3,CGTACTTTATATTTTTTCTC,3,1949152
ihfAp4,5.75,25,3,CGTACCGGCGTGTCGTGGTG,22,1935482
ihfAp4,4.5,20,3,CGTACAGGTACACAGCACGC,17,1918688
ihfAp4,10.25,43,3,CGTAATTTTGTTATGAGGCC,40,1945141
ihfAp4,2.0,10,3,CGTAAACATAAGATATGATA,7,1941334
ihfAp4,4.0,18,3,CGGTGCGTTGAGTTTAACCT,15,1917038
ihfAp4,2.25,11,3,CGGTATAAGATCTAAGTGTT,8,1925790
ihfAp4,25.5,104,3,CGGTACGTAAAAAATCGGAT,101,1926122
ihfAp4,4.25,19,3,CGGGCGGACACGCGTGCCTC,16,1922671
ihfAp4,9.75,41,3,CGGGAACGCACGATCAGAGG,38,1958850
ihfAp4,3.75,17,3,CGGCCCCAGTATTGTGAGTG,14,1920326
ihfAp4,6.75,29,3,CGGATACACATTCGATGAGT,26,1939517
ihfAp4,0.5,4,3,CGGAGGGACAATCACTAGGC,1,1953956
ihfAp4,0.5,4,3,CGCTTTAAGAGGGTTCCTTT,1,1930059
ihfAp4,14.5,60,3,CGCTCTCCGGTACGAAGTGA,57,1936602
ihfAp4,5.75,25,3,CGCGGACCGGGACAATTGCG,22,1916270
ihfAp4,5.25,23,3,CGCCTCATTGCGCAAAAATT,20,1950186
ihfAp4,2.75,13,3,CGCATCAAGTGGTTGCGTAC,10,1951276
ihfAp4,10.0,42,3,CGCACTGACGTACTAAGACA,39,1929414
ihfAp4,7.75,33,3,CGATCGCCTCATGCTACGAT,30,1928687
ihfAp4,3.25,15,3,CGATACGTTACTGGTGGTTC,12,1950398
ihfAp4,13.25,55,3,CGAGTGTCACTCATTGTCAT,52,1923403
ihfAp4,7.0,30,3,CGAGGGTCGATCGGGAACGG,27,1924918
ihfAp4,8.5,36,3,CGACGTCGATTAGACATTGC,33,1926410
ihfAp4,6.0,26,3,CGACGTCCCTGGTTCTGAAG,23,1956336
ihfAp4,5.75,25,3,CGACGCCTAGAAAGGTCGGA,22,1917721
ihfAp4,1.5,8,3,CGAATTTTCTCAGGAGTCTG,5,1950231
ihfAp4,5.0,22,3,CGAATTGGTGAACCATTCCT,19,1927701
ihfAp4,10.75,45,3,CGAATCACATGGTGGCGGTA,42,1925268
ihfAp4,6.75,29,3,CGAATAGCGAGGGATAGGAC,26,1938523
ihfAp4,4.0,18,3,CGAAGTCGCTCAAGATAACT,15,1960721
ihfAp4,4.0,18,3,CGAAGGTCACAAATGTCACT,15,1923419
ihfAp4,5.25,23,3,CCTTTAAGATTGCCGCAAGA,20,1956437
ihfAp4,5.75,25,3,CCTGCTCTTATGACGCTGCG,22,1946602
ihfAp4,8.75,37,3,CCTCGCAACAAATGCAGGGA,34,1935863
ihfAp4,3.0,14,3,CCTCGATCCACGCCCTGAAT,11,1920473
ihfAp4,2.5,12,3,CCTCCGATTACCTTTATGGC,9,1933847
ihfAp4,14.25,59,3,CCTCCCTACGGACCAGTTTA,56,1938349
ihfAp4,18.25,75,3,CCTAAGTGCAGCTGCATTAT,72,1956289
ihfAp4,5.25,23,3,CCGTTCTAGACATGTTTTCG,20,1923568
ihfAp4,8.5,36,3,CCGGTGCGGGCATTTTTCTT,33,1929618
ihfAp4,3.0,14,3,CCGGGTTTGCGAGTTCTTGC,11,1952881
ihfAp4,1.5,8,3,CCGGGGGAACCAGTCCCCCT,5,1953691
ihfAp4,0.5,4,3,CCGGCTTGGCACTGAGTATC,1,1928509
ihfAp4,3.25,15,3,CCGGATGTATCAGGCCATAG,12,1941969
ihfAp4,9.75,41,3,CCGGAAACCTACTATGTTGC,38,1920136
ihfAp4,2.25,11,3,CCGCGTCCCGGGTCTCTATA,8,1913819
ihfAp4,6.0,26,3,CCGCATCAACTCCTGTATTA,23,1929798
ihfAp4,3.5,16,3,CCGAGTACTTTCCGTGTGGT,13,1936700
ihfAp4,5.75,25,3,CCGAGGCTCTTGGGAGATGG,22,1960439
ihfAp4,3.25,15,3,CCCTTAAGTGAGACCTATGA,12,1915199
ihfAp4,5.25,23,3,CCCTGCATTGTACACGATAG,20,1917720
ihfAp4,9.5,40,3,CCCCTCCGGCAATATCGGAT,37,1932221
ihfAp4,0.75,5,3,CCCATAGCGGATGTACACGT,2,1951951
ihfAp4,4.0,18,3,CCCAGGGCGAGGCTGATCAC,15,1948927
ihfAp4,3.25,15,3,CCATTCCACACTGGACAGGA,12,1951877
ihfAp4,3.25,15,3,CCATGATACCTCTTGAGTAT,12,1952221
ihfAp4,6.0,26,3,CCATCGGATGACTTCACTCA,23,1935640
ihfAp4,4.25,19,3,CCATCCGGCAGTGCAGATGG,16,1940280
ihfAp4,0.5,4,3,CCATCATGGTCTTCAGTATC,1,1929210
ihfAp4,3.25,15,3,CCAGCCCAGCGCGCGTAAGC,12,1921682
ihfAp4,2.0,10,3,CATTGTCACTCGGCGACTCG,7,1938834
ihfAp4,3.5,16,3,CATGTTGTTAGGGGGCCCGT,13,1947697
ihfAp4,9.5,40,3,CATGTGCGCCGGTACGGCGT,37,1943045
ihfAp4,1.5,8,3,CATGGTTGCCCGTGAAAGCT,5,1912266
ihfAp4,7.25,31,3,CATCACTCTCCCGCTCTCAC,28,1917919
ihfAp4,3.5,16,3,CATAGTCCGTGCCCTTTTCG,13,1955817
ihfAp4,6.0,26,3,CAGTTGTTGTGACTTATAGG,23,1944231
ihfAp4,3.75,17,3,CAGTTGCCCGCAAAATCCGA,14,1933382
ihfAp4,5.5,24,3,CAGTAGAGTAATGCACGACT,21,1931080
ihfAp4,6.75,29,3,CAGCCCAGATTTGCAGACTT,26,1928549
ihfAp4,5.5,24,3,CAGCACACTTGCTGAGGTAA,21,1943757
ihfAp4,0.75,5,3,CAGATGGGGGTTTTTGTCGC,2,1925537
ihfAp4,5.5,24,3,CAGACTGTCCGATATTACTA,21,1941680
ihfAp4,6.25,27,3,CAGAAGGGGACGATGTGAAG,24,1954377
ihfAp4,6.25,27,3,CACTTAGACAACTCTTTCCC,24,1909903
ihfAp4,4.25,19,3,CACATGTATATTCAACCAGT,16,1912112
ihfAp4,6.5,28,3,CAATATATTGACGGCTTTAA,25,1960378
ihfAp4,0.5,4,3,CAAGTCGGGTCGGACTGGTT,1,1923374
ihfAp4,4.25,19,3,CAACTTCCTAAGTGTGAATC,16,1960303
ihfAp4,7.25,31,3,CAAATGTCTGCAGGCTGATA,28,1931567
ihfAp4,13.25,55,3,CAAATGGAGATGGTCCGGGT,52,1951980
ihfAp4,0.5,4,3,CAAACGTACAGCTTAGGCAT,1,1927632
ihfAp4,4.75,21,3,CAAACACTTAGTGTCGGAAG,18,1960409
ihfAp4,4.25,19,3,ATTTTCCAATAGTGCCTCGG,16,1920165
ihfAp4,8.75,37,3,ATTTGGTTCACGAAAAACTC,34,1925936
ihfAp4,8.75,37,3,ATTTCTGTGCGTGTGAGCAT,34,1945828
ihfAp4,4.5,20,3,ATTTAACGTCGCTGCCTAGC,17,1929385
ihfAp4,4.75,21,3,ATTGGCCCGTCCGGGGGCTG,18,1956991
ihfAp4,0.5,4,3,ATTCGAACGCGGTAGCGATA,1,1940617
ihfAp4,4.75,21,3,ATTATTAGTCCAATGCGCAT,18,1959284
ihfAp4,11.75,49,3,ATGTGTAGCCTTGCTTGGGA,46,1923248
ihfAp4,0.5,4,3,ATGGTTAGCTTAATAGGCGC,1,1952679
ihfAp4,1.25,7,3,ATGGTGAATAGCGTCTAACC,4,1938319
ihfAp4,2.25,11,3,ATGGTACTGCAGCGGCGCGT,8,1957253
ihfAp4,3.0,14,3,ATGGCGCCCACCAAGTGTGG,11,1948473
ihfAp4,10.0,42,3,ATGCTGTCATGCCCGGAGGG,39,1925009
ihfAp4,9.25,39,3,ATGCTATCGACAAGGTCTTT,36,1914209
ihfAp4,4.75,21,3,ATGAATGAAATGACTCCTTG,18,1955906
ihfAp4,18.75,77,3,ATGAAGCCACCCAGAAAGCT,74,1928160
ihfAp4,0.5,4,3,ATCCTCTCCGTATATCAGTT,1,1959158
ihfAp4,4.75,21,3,ATCCGGGTTACATCCACCTC,18,1954154
ihfAp4,2.75,13,3,ATCCGGACTGGCCGTAGTGA,10,1947800
ihfAp4,8.0,34,3,ATCATAAGCAACCGCAGCTG,31,1962044
ihfAp4,6.5,28,3,ATCACGTATATATCTATGCG,25,1948285
ihfAp4,3.25,15,3,ATCACCCAAGGACTTCATCC,12,1961326
ihfAp4,1.5,8,3,ATATCATACTCGAGTCAGGG,5,1948873
ihfAp4,4.5,20,3,ATAGGGAACCATGTGTGTAG,17,1937140
ihfAp4,8.0,34,3,ATACTTACACTAAACAGGCA,31,1944680
ihfAp4,2.75,13,3,ATACTGCATTGTTCTTCCCT,10,1916296
ihfAp4,0.5,4,3,ATACCGAGTTGCTCTTGACT,1,1955816
ihfAp4,5.5,24,3,ATACACTTTATTGGATAATC,21,1926212
ihfAp4,0.5,4,3,ATAATTCGAGGACTGGAATC,1,1933258
ihfAp4,4.0,18,3,ATAATACGCGCGATGTGGTA,15,1958221
ihfAp4,5.75,25,3,AGTTTTGGGAGTGTCCTGTG,22,1959792
ihfAp4,8.25,35,3,AGTTTCGGGTGTACATCGTG,32,1957315
ihfAp4,4.25,19,3,AGTTCATGTCGTTCAGGTCA,16,1955334
ihfAp4,3.25,15,3,AGTGTACGATACACTAGCGG,12,1949670
ihfAp4,4.75,21,3,AGTGGCGTCTTGCACGACCT,18,1953764
ihfAp4,3.0,14,3,AGTGCAGCACTCTTTCGCGA,11,1957539
ihfAp4,1.5,8,3,AGTCCGGGAGGCTGGCGGGA,5,1955120
ihfAp4,10.25,43,3,AGTCAATCCGCGGCACGGCA,40,1911444
ihfAp4,7.5,32,3,AGTATATTGGCGGACGTGAG,29,1932224
ihfAp4,0.5,4,3,AGTACCGCAATATTCAGTTG,1,1947732
ihfAp4,12.0,50,3,AGTAAATTGCTACAATAGCA,47,1928935
ihfAp4,6.5,28,3,AGTAAACTTATAGGAGACAC,25,1923318
ihfAp4,0.5,4,3,AGGTCGCCATTCGCGGGACG,1,1933372
ihfAp4,2.75,13,3,AGGGTGAGGATGCGTGCGCA,10,1929490
ihfAp4,2.75,13,3,AGGGGGTCCTAGAGGTAAAG,10,1947932
ihfAp4,2.5,12,3,AGGGCGAATCATTTGGTTTA,9,1942689
ihfAp4,2.75,13,3,AGGGCAACGGGTAACGGAGC,10,1920777
ihfAp4,5.75,25,3,AGGGAGCCCGCCAGATCCAT,22,1938931
ihfAp4,3.75,17,3,AGGCGTGGGAGACTTCGGCG,14,1928864
ihfAp4,7.75,33,3,AGGCCCCCTATATTCGTTAG,30,1934640
ihfAp4,5.0,22,3,AGGCCCATTCCTGCCAACCT,19,1920131
ihfAp4,7.5,32,3,AGGATGTATGCCGGCTTATC,29,1921853
ihfAp4,3.25,15,3,AGGAGGGTCGCCGTCGTCGG,12,1913778
ihfAp4,2.5,12,3,AGCTACCAGCAGTTGCTAAT,9,1910274
ihfAp4,0.5,4,3,AGCGTTCTGGAGTCAGTATA,1,1914052
ihfAp4,4.75,21,3,AGCGCCTTCAACGGTCGATA,18,1919880
ihfAp4,7.75,33,3,AGCGAGCGGCGAATTACGTT,30,1958482
ihfAp4,5.75,25,3,AGCGACCTCACACTAGGGAC,22,1910836
ihfAp4,6.0,26,3,AGCAGGCGTAACGGCGGATT,23,1956717
ihfAp4,5.25,23,3,AGATTTACGATAACCTGATA,20,1946683
ihfAp4,4.25,19,3,AGATTAAACACACCGATCGG,16,1921867
ihfAp4,0.5,4,3,AGATGCCGAGCTCTTGTAAA,1,1944099
ihfAp4,6.0,26,3,AGATCTGTCGGGACGTTGTG,23,1925677
ihfAp4,8.75,37,3,AGATCCTATATTGATCGTTT,34,1948136
ihfAp4,3.5,16,3,AGACGAATGAGATCATGATC,13,1958456
ihfAp4,7.75,33,3,AGAATGTCGATACCGTTTCG,30,1954705
ihfAp4,8.5,36,3,AGAAAGCCCGTGTTCCCTCG,33,1946518
ihfAp4,10.25,43,3,ACTTGGAAGCCAATTTGACT,40,1923420
ihfAp4,5.5,24,3,ACTGAGTTGCTGTTGTAGGT,21,1930048
ihfAp4,4.5,20,3,ACTGAATAAAAACCTCGTGC,17,1948058
ihfAp4,6.5,28,3,ACTCGCAAATCTGATGGTGA,25,1922988
ihfAp4,13.75,57,3,ACTCGAGTTGGTCCATCAAA,54,1911944
ihfAp4,10.25,43,3,ACTCCTATAACGACCTCCGA,40,1954610
ihfAp4,2.0,10,3,ACTATCTCTCGGAATCTCAA,7,1936422
ihfAp4,8.25,35,3,ACTAGCGGAGCGATCCAGCA,32,1954734
ihfAp4,6.25,27,3,ACTAACTCCCAAAGGTGCCA,24,1944212
ihfAp4,2.75,13,3,ACGTGGAGAGAGCCACTCTG,10,1958460
ihfAp4,3.5,16,3,ACGTCCGAGCCGCCCTAATG,13,1923907
ihfAp4,5.0,22,3,ACGGGGTCCTTTATAACGCG,19,1911270
ihfAp4,7.0,30,3,ACGCTACGTCTTTCCTCACC,27,1915736
ihfAp4,3.25,15,3,ACGCGCTAACGGCGCCAGAG,12,1927051
ihfAp4,2.25,11,3,ACGCCACGGTTAGCAATGGT,8,1937553
ihfAp4,3.5,16,3,ACGCATAATCGGACAGATGC,13,1942739
ihfAp4,1.75,9,3,ACGACAGGAGCGGTTGTCCT,6,1938418
ihfAp4,4.25,19,3,ACGAAGACCGGACTTCACTA,16,1924879
ihfAp4,8.75,37,3,ACGAACTCAGTCCGAGTCCT,34,1911950
ihfAp4,6.75,29,3,ACCTCATGTGTCTGGGTTCA,26,1935101
ihfAp4,5.25,23,3,ACCTCAAATCCATTTACGTC,20,1960101
ihfAp4,3.5,16,3,ACCTATTATAGCCAAGTGGG,13,1927571
ihfAp4,1.75,9,3,ACCTAATTCTGGACCGATCG,6,1930348
ihfAp4,5.0,22,3,ACCGTACAAATCTGCGGCGT,19,1916948
ihfAp4,11.25,47,3,ACCGATGGTGAGGGAGTCAC,44,1960288
ihfAp4,0.5,4,3,ACCGAGGTTTGAGTTTAGTC,1,1961491
ihfAp4,7.5,32,3,ACCATAGGAATGTCCCGTTA,29,1949029
ihfAp4,6.5,28,3,ACATACAACGTCATCGAACA,25,1914287
ihfAp4,11.75,49,3,ACATAAGAGAAGTCATATTG,46,1929002
ihfAp4,3.0,14,3,ACAGGGGCAAATTGTATTTC,11,1928506
ihfAp4,9.25,39,3,ACAGGGCGGATTCTGCCTAA,36,1933918
ihfAp4,20.5,84,3,ACACTTCATCTCCCCGTTGA,81,1911973
ihfAp4,2.75,13,3,ACACCCATGGGTAGGTTTCT,10,1911650
ihfAp4,2.0,10,3,ACACACGCTCGCGCCCGTAC,7,1926148
ihfAp4,3.25,15,3,ACAATAGTGTGTTTAACAGC,12,1928622
ihfAp4,7.25,31,3,ACAAATGTACTTAAAAGGCT,28,1944757
ihfAp4,2.75,13,3,ACAAATGGACTGCACCCAGT,10,1930917
ihfAp4,23.5,96,3,AATTTCATGGAGGTAGCACC,93,1961645
ihfAp4,5.0,22,3,AATTCAGGGGATACCCCTGA,19,1911606
ihfAp4,0.5,4,3,AATTATCCATGGCAATTTGA,1,1919761
ihfAp4,3.25,15,3,AATTACTTGAGAATGTAGAA,12,1951400
ihfAp4,11.25,47,3,AATGGTCGGGCGTTTGGACA,44,1935397
ihfAp4,19.5,80,3,AATGCTTGAGTAAATGGGCG,77,1953144
ihfAp4,3.5,16,3,AATCCGATCGGTGATAACTC,13,1911424
ihfAp4,7.5,32,3,AATCAATCTTTCTACTAACT,29,1918590
ihfAp4,4.75,21,3,AATAGGGTTATTAACTGGTA,18,1932813
ihfAp4,3.25,15,3,AATAGCCACGCGATGCTGAT,12,1950816
ihfAp4,5.25,23,3,AATAATCCCAATAAAACCCA,20,1924456
ihfAp4,10.75,45,3,AATAACAGGGTCAGTGTGCT,42,1942733
ihfAp4,8.0,34,3,AAGTGTTCCGACCTTCGTTT,31,1932755
ihfAp4,3.0,14,3,AAGTGGAACGGCCCGTAAAC,11,1942882
ihfAp4,6.0,26,3,AAGTACCTGAGGCGTCCCTA,23,1945279
ihfAp4,9.5,40,3,AAGCTTCCAAATCTCCCTAC,37,1925413
ihfAp4,9.75,41,3,AAGCGCATCCCTTTACGCTG,38,1945579
ihfAp4,6.0,26,3,AAGACTGGTGGGTCGCATCT,23,1928511
ihfAp4,5.0,22,3,AAGACCGTTGAAGGCAATGA,19,1960103
ihfAp4,5.75,25,3,AACTTGCGGGGGCCGAAACT,22,1918594
ihfAp4,16.75,69,3,AACTACTGGGGTCGGGAAAT,66,1960832
ihfAp4,5.75,25,3,AACGTTCCTGTACTATAACT,22,1955281
ihfAp4,5.0,22,3,AACGTAGCTATTGCCTATTC,19,1950125
ihfAp4,13.25,55,3,AACGGCTGCCTCTTGGGAGA,52,1960734
ihfAp4,7.25,31,3,AACCCACAGCAAAGTAGCCA,28,1924717
ihfAp4,3.75,17,3,AACCATAGTGCCAAACCCAC,14,1947368
ihfAp4,1.0,6,3,AACACTCATACCTTTTGTGT,3,1933056
ihfAp4,5.5,24,3,AAATGTTGGGGATTTGCTCA,21,1920936
ihfAp4,5.75,25,3,AAATATACCCCCTTTGAAGA,22,1940144
ihfAp4,3.75,17,3,AAATAGGAGCCCAGTTGTTG,14,1925980
ihfAp4,3.0,14,3,AAAGTCTAGAGCGTGCTTTA,11,1947857
ihfAp4,21.25,87,3,AAAGCACCTCTGGGCTTTAC,84,1928623
ihfAp4,3.0,14,3,AAAGAGTGGCCCCGGGGTGT,11,1924381
ihfAp4,3.5,16,3,AAAGAACCTTTTAAGCAACG,13,1954747
ihfAp4,6.0,26,3,AAACGCTCTACATTCACCTA,23,1957316
ihfAp4,13.25,55,3,AAAATCCTAATCTGGTGGAC,52,1927973
ihfAp4,8.5,36,3,AAAAGAACTGTCTCGATCGG,33,1956735
ihfAp4,4.0,18,3,AAAACAGATCATGCTCTGGC,15,1940743
ihfAp4,3.6666666666666665,12,2,TTTTTCGTCCGATAGTACAT,10,1923836
ihfAp4,1.0,4,2,TTTTGGCCTATACACGATTC,2,1911759
ihfAp4,10.333333333333334,32,2,TTTGTCGAGTGCAATGTTTT,30,1953132
ihfAp4,4.666666666666667,15,2,TTTGGTGGCCTTACTTCAAT,13,1935271
ihfAp4,3.0,10,2,TTTCGTGACCGCTCGGCCTA,8,1953929
ihfAp4,15.333333333333334,47,2,TTTCAACGTGATTCATGGCA,45,1944802
ihfAp4,6.0,19,2,TTTAGTAGCCAGACCGGTAA,17,1946369
ihfAp4,11.666666666666666,36,2,TTGTTTCTCGATCCTTTGAT,34,1957622
ihfAp4,2.6666666666666665,9,2,TTGTCAGACAGAGCTACATC,7,1919729
ihfAp4,2.3333333333333335,8,2,TTGTATAAAATAGTTACTAG,6,1947123
ihfAp4,7.333333333333333,23,2,TTGTAGTATGTTTTAGCGCC,21,1930194
ihfAp4,0.6666666666666666,3,2,TTGTACCTGGCATAGCTTGA,1,1917549
ihfAp4,22.666666666666668,69,2,TTGGTCATCGTGCTAGCCCT,67,1927227
ihfAp4,7.666666666666667,24,2,TTGGATCGTCCCAGGGTCAT,22,1915442
ihfAp4,2.0,7,2,TTGGATATCAAATTATTTAC,5,1925507
ihfAp4,8.333333333333334,26,2,TTGCTCGACGGCTGCCACCA,24,1917757
ihfAp4,6.666666666666667,21,2,TTGCTACGTGTTAAATGGGT,19,1930148
ihfAp4,9.0,28,2,TTGCCCCCGTTGTCTGAATG,26,1955713
ihfAp4,11.333333333333334,35,2,TTGAGGACACCGGCCAGTAA,33,1916736
ihfAp4,6.333333333333333,20,2,TTCTGGACGTGTCTGCGTAA,18,1951699
ihfAp4,3.0,10,2,TTCTCCTTCACTATATCGAT,8,1913931
ihfAp4,12.0,37,2,TTCGTTTCCTGAACGTGGTG,35,1951850
ihfAp4,27.333333333333332,83,2,TTCGTGGCGTTAAGCTTTGA,81,1935807
ihfAp4,9.333333333333334,29,2,TTCGGCCATCCAGTCACAGT,27,1918701
ihfAp4,5.0,16,2,TTCGGAAGTTAGATTTGATG,14,1948127
ihfAp4,12.666666666666666,39,2,TTCGCATCCGTTTAATCCCT,37,1934466
ihfAp4,23.0,70,2,TTCCTCATGTAGTTGGGTTA,68,1960114
ihfAp4,7.666666666666667,24,2,TTCACTTCTATAATCTATCG,22,1921063
ihfAp4,10.0,31,2,TTCACCCCAACGGGCAAACT,29,1915123
ihfAp4,22.0,67,2,TTAGTAATACTGTGTACCTG,65,1925020
ihfAp4,2.3333333333333335,8,2,TTACTTATGGGTTTCTTCGG,6,1955509
ihfAp4,7.0,22,2,TTACGTAGTTCGTGCCACCA,20,1936909
ihfAp4,31.333333333333332,95,2,TTACGATGAGGTGACGCAGA,93,1959800
ihfAp4,13.0,40,2,TTAAGAGGGGTGATTGTCGG,38,1956205
ihfAp4,8.666666666666666,27,2,TTAAGACTAGCCCCTAGCGA,25,1950382
ihfAp4,12.666666666666666,39,2,TTAACGCATATCCTCGGCAA,37,1920436
ihfAp4,6.0,19,2,TTAACAGGGTTCTGTGGGGT,17,1962108
ihfAp4,3.6666666666666665,12,2,TGTTTGAGTCATTCGTGAGG,10,1955129
ihfAp4,1.0,4,2,TGTTCTAAAGAATTTTGCGT,2,1925822
ihfAp4,5.0,16,2,TGTGGGTAAACCAATTCTAA,14,1916604
ihfAp4,6.333333333333333,20,2,TGTATGGACTCGGTAGACAG,18,1948179
ihfAp4,1.6666666666666667,6,2,TGTACCCGCCCGCAAAACTG,4,1928521
ihfAp4,13.0,40,2,TGGTTGGCTGAGGATGGTGT,38,1910423
ihfAp4,1.6666666666666667,6,2,TGGTTATGGATTTATGCTCA,4,1953490
ihfAp4,2.0,7,2,TGGTTAAAGTCAAGCGCAGA,5,1918672
ihfAp4,10.333333333333334,32,2,TGGTGGACGTGGCCAGCTGT,30,1940171
ihfAp4,5.666666666666667,18,2,TGGTCGTCATAGACGTGACT,16,1961238
ihfAp4,2.0,7,2,TGGTACGTAAAGGTCAAACT,5,1944255
ihfAp4,0.6666666666666666,3,2,TGGGGGCTTAGTGCTGAATA,1,1918773
ihfAp4,7.666666666666667,24,2,TGGGCACTCGATTCTGTTAG,22,1912358
ihfAp4,8.666666666666666,27,2,TGGGAGCGCCTCGTACACAA,25,1932744
ihfAp4,3.3333333333333335,11,2,TGGCCCAGACGACGGAGAGG,9,1948059
ihfAp4,8.0,25,2,TGGCCATATCAGAACACAAA,23,1930279
ihfAp4,4.0,13,2,TGGCATAACGGCAGCCAGCA,11,1923401
ihfAp4,8.666666666666666,27,2,TGGAAGGGGGAAATAGAGCA,25,1930350
ihfAp4,10.333333333333334,32,2,TGGAAGCCTTATACGACCAC,30,1944281
ihfAp4,5.333333333333333,17,2,TGCGTACGCGCTTGGTAGGA,15,1947333
ihfAp4,1.0,4,2,TGCCTATTTAGATTTTTCAT,2,1910865
ihfAp4,2.3333333333333335,8,2,TGCCTATCAGGGATTCCCCA,6,1954958
ihfAp4,11.0,34,2,TGCCGAGGCGTGTGTGTAGA,32,1923762
ihfAp4,8.0,25,2,TGCATCGGAAGTATCATTCT,23,1954468
ihfAp4,0.6666666666666666,3,2,TGCATCCTACAACTTGCCCT,1,1941228
ihfAp4,3.3333333333333335,11,2,TGATCATGTGTCAAAGGCCA,9,1912868
ihfAp4,7.666666666666667,24,2,TGACTAGAAAGTCGTGGCCC,22,1961470
ihfAp4,14.333333333333334,44,2,TGAAGGCCCATTTCACACAG,42,1961566
ihfAp4,74.33333333333333,224,2,TCTTCTTGGGTCACGGACAT,222,1959637
ihfAp4,3.6666666666666665,12,2,TCTTCCGCAAGGCATATCCC,10,1938240
ihfAp4,10.0,31,2,TCTGTCACGCGGGAGACCTC,29,1922701
ihfAp4,5.0,16,2,TCTGGGGAGGTCTAACAGGA,14,1946398
ihfAp4,16.666666666666668,51,2,TCTGGCTCGTCATTCGCGCC,49,1942942
ihfAp4,1.0,4,2,TCTATTGGTCAGTTATGCTG,2,1950718
ihfAp4,5.666666666666667,18,2,TCTATAGGATCCCTACCTAC,16,1945388
ihfAp4,11.0,34,2,TCTAGTATACTGGGCGCGTC,32,1930196
ihfAp4,5.333333333333333,17,2,TCTAGATGGCCTCCAGACCT,15,1927030
ihfAp4,24.666666666666668,75,2,TCTACCTTATAGTAGGCAAG,73,1960158
ihfAp4,8.666666666666666,27,2,TCTACAGAGCTGCTCACATT,25,1922918
ihfAp4,4.0,13,2,TCGTTCTATCGTAAACGTTT,11,1936097
ihfAp4,4.666666666666667,15,2,TCGGGATACCCACGTCTGAT,13,1941884
ihfAp4,6.0,19,2,TCGCGTCGTTAATGTCTTAC,17,1934923
ihfAp4,2.3333333333333335,8,2,TCGCCTAGTGTCGGGTCGGC,6,1934950
ihfAp4,5.666666666666667,18,2,TCGCCCGTCTGAAGGGTAGA,16,1960188
ihfAp4,0.6666666666666666,3,2,TCGAGGCTATCTGACTAAAT,1,1953914
ihfAp4,11.666666666666666,36,2,TCGAATCCTCGGCGTACATC,34,1940075
ihfAp4,3.3333333333333335,11,2,TCCTTCCCACCGGTCAGGTA,9,1954457
ihfAp4,12.666666666666666,39,2,TCCTTCAGTAGTGGCGTAGT,37,1919204
ihfAp4,9.333333333333334,29,2,TCCTGTGGGTAAGGGTTGGA,27,1952111
ihfAp4,0.6666666666666666,3,2,TCCTCCCTGTCCAAAGACCA,1,1955051
ihfAp4,8.666666666666666,27,2,TCCGGGCGTATCCATCAGCT,25,1935327
ihfAp4,5.0,16,2,TCCCTACCGTTACCGATAGA,14,1947070
ihfAp4,4.333333333333333,14,2,TCCAATTCCCGGACGAGATG,12,1915184
ihfAp4,4.0,13,2,TCATTCTACAGGTCGTACGG,11,1922688
ihfAp4,7.666666666666667,24,2,TCAGTGAGGGGTTCATGAAT,22,1939785
ihfAp4,8.0,25,2,TCAGGATATAGCTCTACTCC,23,1937315
ihfAp4,3.0,10,2,TCAGCTACGTCCCATGGTAC,8,1931094
ihfAp4,7.666666666666667,24,2,TCACGGCTCTTGATTAACCC,22,1948648
ihfAp4,11.666666666666666,36,2,TCAATGCTGGGAAATCATTT,34,1909696
ihfAp4,9.666666666666666,30,2,TCAACGTCATACCCCCGGAG,28,1939975
ihfAp4,1.6666666666666667,6,2,TATTGCACGGTGCTCCGACC,4,1914521
ihfAp4,6.666666666666667,21,2,TATTACGCCAGTGCGCGTCT,19,1913144
ihfAp4,1.0,4,2,TATGGTTACACTCTAAGCAT,2,1938576
ihfAp4,5.333333333333333,17,2,TATATGCTGTACTAGGGACT,15,1937385
ihfAp4,0.6666666666666666,3,2,TATATCATTCTAACATTCAG,1,1935292
ihfAp4,7.333333333333333,23,2,TATAGCCTACATCGCGGCGA,21,1941012
ihfAp4,3.6666666666666665,12,2,TATAAAGAATAAGGACACAT,10,1926205
ihfAp4,0.6666666666666666,3,2,TAGGGGATGCGATTCAGTGT,1,1959875
ihfAp4,10.333333333333334,32,2,TAGCTGCCTGGGGCAGCGGG,30,1933972
ihfAp4,0.6666666666666666,3,2,TAGCGTCACGCCCCAGATCG,1,1959816
ihfAp4,3.6666666666666665,12,2,TAGCGAACGCCTGGGACACT,10,1917411
ihfAp4,22.666666666666668,69,2,TAGCAGCTAAAGGAGCCCCT,67,1942663
ihfAp4,6.0,19,2,TAGATGAGTGCACTAACCTT,17,1923075
ihfAp4,0.6666666666666666,3,2,TAGAGTAGTAGGGAGCGGAT,1,1952100
ihfAp4,5.666666666666667,18,2,TACGTGTGCAAAGCAGCCAG,16,1928736
ihfAp4,13.0,40,2,TACGCTCAACCTCTAGGCTG,38,1921812
ihfAp4,6.666666666666667,21,2,TACCTTCGATGCTCAGCGAC,19,1955699
ihfAp4,10.0,31,2,TACCTAATACCGAAGAAGAA,29,1935763
ihfAp4,8.0,25,2,TACCCTTGCGTCAATAAACC,23,1935947
ihfAp4,17.333333333333332,53,2,TACAGTAACCGTGCATTCAG,51,1935806
ihfAp4,15.0,46,2,TACACGAGTCAGTAGAGGAG,44,1956084
ihfAp4,7.666666666666667,24,2,TACACCGCCAACTGGTTGGT,22,1910915
ihfAp4,12.0,37,2,TAATTCGCCCCCCCAGCAGT,35,1932048
ihfAp4,2.6666666666666665,9,2,TAATGCAAACAAATTGCGCG,7,1910136
ihfAp4,6.666666666666667,21,2,TAATAAGTATCGGATAGCTT,19,1951926
ihfAp4,8.666666666666666,27,2,TAAGGGGCATTTGGAACCGT,25,1955153
ihfAp4,6.666666666666667,21,2,TAAGGCAAAAAAATGTAACG,19,1954026
ihfAp4,7.0,22,2,TAAGCTTTGTCCCGGAATTC,20,1913058
ihfAp4,4.666666666666667,15,2,TAACTCTGTTGGTTACTATA,13,1960172
ihfAp4,0.6666666666666666,3,2,TAACGTGGATCCGCTGATTC,1,1948436
ihfAp4,0.6666666666666666,3,2,TAACCATATAACACATGGCC,1,1926862
ihfAp4,2.0,7,2,TAAACATGCTGAACTCCGAG,5,1942285
ihfAp4,10.0,31,2,GTTTGCCCCTAGGTTGGGGT,29,1929799
ihfAp4,9.666666666666666,30,2,GTTGGTCCGTTGGGGGGAAA,28,1917744
ihfAp4,11.0,34,2,GTTATCCGTCTTAAAGGGTA,32,1952093
ihfAp4,12.0,37,2,GTTAATGCCCCTGTTTACGA,35,1960105
ihfAp4,3.0,10,2,GTTAAAAGTGATGCTGTGAA,8,1909818
ihfAp4,6.0,19,2,GTGTTCGTATTGTACAGTTG,17,1920809
ihfAp4,3.0,10,2,GTGTGTCCACAACACAGTAT,8,1916607
ihfAp4,17.333333333333332,53,2,GTGTGCCAAATAATTTTGTA,51,1932601
ihfAp4,3.3333333333333335,11,2,GTGGTGTCAAAGCGGACCAA,9,1921078
ihfAp4,4.333333333333333,14,2,GTGGACCCGTTCACGTGTAC,12,1934417
ihfAp4,5.333333333333333,17,2,GTGCCTCCGTCAATTTGTCG,15,1916612
ihfAp4,5.333333333333333,17,2,GTGCAAGGAGATGTAATGTG,15,1937465
ihfAp4,8.0,25,2,GTGATTGGTTTCGGGATCTA,23,1941099
ihfAp4,5.333333333333333,17,2,GTGACTATACGCAAAATACT,15,1930582
ihfAp4,10.666666666666666,33,2,GTCTTTGTAGGCACGTGTCC,31,1960822
ihfAp4,1.6666666666666667,6,2,GTCTTCGATAACGAGGTGCT,4,1923334
ihfAp4,7.333333333333333,23,2,GTCTACTGGTGCACAGGATG,21,1957570
ihfAp4,3.3333333333333335,11,2,GTCTAACAGGAATGTCTTGA,9,1920501
ihfAp4,4.333333333333333,14,2,GTCCAGACCAACCGGGGATG,12,1948230
ihfAp4,11.0,34,2,GTCAGGCAGATTGGGGGAAG,32,1942286
ihfAp4,8.666666666666666,27,2,GTCACTCGGTAGAGTCTGAC,25,1954709
ihfAp4,1.3333333333333333,5,2,GTCACGGTGCTCTACAGTGC,3,1914299
ihfAp4,9.0,28,2,GTCAATATACGAGCACCGGC,26,1916834
ihfAp4,5.666666666666667,18,2,GTCAAGCTCAAGAGTTATAT,16,1939601
ihfAp4,1.3333333333333333,5,2,GTCAAGCGGCATAAACTCCT,3,1936608
ihfAp4,2.6666666666666665,9,2,GTATCGGTAACGCCGGGACC,7,1911381
ihfAp4,2.0,7,2,GTATAACGGGAGGGTCTGGT,5,1958832
ihfAp4,6.333333333333333,20,2,GTACTTCAAACTCACCCGGC,18,1911395
ihfAp4,19.0,58,2,GTACCTTTTCCCTTCCTGAA,56,1952253
ihfAp4,9.0,28,2,GTAACGTTTGCCCGCACAAC,26,1932075
ihfAp4,8.0,25,2,GGTTCTTTGAGACTTACGTT,23,1917860
ihfAp4,7.666666666666667,24,2,GGTTAGGCCGTACCGACATC,22,1925018
ihfAp4,2.6666666666666665,9,2,GGTGTGACAAACGCGGGTGG,7,1948433
ihfAp4,4.333333333333333,14,2,GGTGGAGGGTATAGCTTATT,12,1924353
ihfAp4,8.666666666666666,27,2,GGTGAATAAACACCTGTAGT,25,1950332
ihfAp4,5.0,16,2,GGTATTAAAGGGAATACCGA,14,1957126
ihfAp4,8.0,25,2,GGTAAGTACCATTAGATGAG,23,1952663
ihfAp4,4.333333333333333,14,2,GGGTTGCGCGAGTTGGCTAA,12,1945283
ihfAp4,6.0,19,2,GGGTGGTCGAACGTTGACTG,17,1952694
ihfAp4,8.666666666666666,27,2,GGGTATGCGCGGGGTTTTCC,25,1912374
ihfAp4,7.333333333333333,23,2,GGGGTGAACAATAAAGCTGG,21,1939536
ihfAp4,1.6666666666666667,6,2,GGGGTACGGTATTCAAAAGT,4,1959629
ihfAp4,0.6666666666666666,3,2,GGGGCATCTCGCGAGCTGAT,1,1942278
ihfAp4,6.0,19,2,GGGCGCTTGACGGGATTCCG,17,1931226
ihfAp4,14.333333333333334,44,2,GGGCGATTACGTGCGGTATA,42,1939923
ihfAp4,10.0,31,2,GGGATAGTGGCATATGCTTC,29,1948477
ihfAp4,6.666666666666667,21,2,GGGACGAACCGAGAGGGCGT,19,1935534
ihfAp4,2.3333333333333335,8,2,GGGAACCTGGGTCATTCGCG,6,1927461
ihfAp4,6.0,19,2,GGCTGTTAGGGGATTCTTAA,17,1929207
ihfAp4,16.0,49,2,GGCGGTTAGCCTTGTACAAC,47,1921409
ihfAp4,0.6666666666666666,3,2,GGCGCCAGCCAGTCCGACTT,1,1942825
ihfAp4,8.666666666666666,27,2,GGCCTTTTCTGAGCGACCAA,25,1923751
ihfAp4,12.666666666666666,39,2,GGCATAGAGACACCTGGAGA,37,1925526
ihfAp4,0.6666666666666666,3,2,GGCAGACCAATTACACGTGT,1,1915268
ihfAp4,13.333333333333334,41,2,GGATTCCCGTTAGGCAAGCA,39,1942815
ihfAp4,19.0,58,2,GGATGTCCTCAGTTGATTAT,56,1959813
ihfAp4,4.0,13,2,GGATGAAGGGCACGGCGTAA,11,1956578
ihfAp4,6.0,19,2,GGAGGACTCGAGCTAGGAAT,17,1944753
ihfAp4,5.0,16,2,GGAGCCCTACAACTTTCCGT,14,1956733
ihfAp4,5.333333333333333,17,2,GGAGACGCCGCAGAGATCTC,15,1950661
ihfAp4,9.333333333333334,29,2,GGACAACCAGTGCAAGCTGG,27,1910177
ihfAp4,3.0,10,2,GGAATAAAAGGGGATGCTAC,8,1915974
ihfAp4,6.0,19,2,GGAAAGCAGTAAAGGTCATC,17,1939340
ihfAp4,7.0,22,2,GCTTCAGGCGTGGAAAGATT,20,1932462
ihfAp4,2.3333333333333335,8,2,GCTTATACAAGAACAAGGTC,6,1933055
ihfAp4,0.6666666666666666,3,2,GCTGTCAGTATTAGCCTCAC,1,1917345
ihfAp4,3.3333333333333335,11,2,GCTGGTCCTTAGATAGGATA,9,1941638
ihfAp4,5.0,16,2,GCTGGGGCGTACCCCGCCTC,14,1948338
ihfAp4,2.6666666666666665,9,2,GCTCGTGCAACCGTACTCTG,7,1952380
ihfAp4,6.0,19,2,GCTCAGAAGTAACGGAGGGC,17,1948183
ihfAp4,7.666666666666667,24,2,GCTATGCTTGGGAACCCGGC,22,1943033
ihfAp4,8.333333333333334,26,2,GCTAGGGCTAGCCCTATTGA,24,1927616
ihfAp4,7.333333333333333,23,2,GCGTTAAGGGTTACTTGACG,21,1935910
ihfAp4,16.666666666666668,51,2,GCGGACTTCGAGCACTATTT,49,1948847
ihfAp4,0.6666666666666666,3,2,GCGATACATGGGTCGGCTGA,1,1925961
ihfAp4,11.666666666666666,36,2,GCCTTCAGCAGCGGACCGCG,34,1918233
ihfAp4,1.3333333333333333,5,2,GCCTGTCCTTCAAGCCATTC,3,1960411
ihfAp4,0.6666666666666666,3,2,GCCGCCCGCATATAACTAAT,1,1937854
ihfAp4,7.0,22,2,GCCCTACATACCCCCAAACG,20,1912637
ihfAp4,6.333333333333333,20,2,GCATCGTCCTGACCAGAGCC,18,1915650
ihfAp4,10.333333333333334,32,2,GCATATCCGAGGTCCATCCA,30,1942558
ihfAp4,8.666666666666666,27,2,GCACCGATGGTCAAAGGCTT,25,1939287
ihfAp4,1.6666666666666667,6,2,GCACCACTATCTCCTCCTTC,4,1940948
ihfAp4,8.666666666666666,27,2,GCAACTGGGAAAATGAAGGA,25,1947055
ihfAp4,7.666666666666667,24,2,GCAACGATACTGCATTGTAA,22,1918935
ihfAp4,8.333333333333334,26,2,GCAAATAGACCGAGTAAGTT,24,1934464
ihfAp4,9.666666666666666,30,2,GATTAGTATTCATTTAAGAA,28,1913295
ihfAp4,9.0,28,2,GATTAGGAGTTAGTAGATCC,26,1924546
ihfAp4,6.666666666666667,21,2,GATGCGTCGGTTCAGTGCCC,19,1918583
ihfAp4,34.0,103,2,GATAGTATTTTACCTCGCTA,101,1935049
ihfAp4,7.0,22,2,GATAAGTGGGTAAACGTGTA,20,1924917
ihfAp4,8.0,25,2,GAGTGTCAATTATAAAGCCT,23,1915879
ihfAp4,12.666666666666666,39,2,GAGGTTTCCCATGATAGTAT,37,1922353
ihfAp4,7.0,22,2,GAGGACCGGCTTTTTGGGTG,20,1956820
ihfAp4,6.333333333333333,20,2,GAGCGCTGCAGTATTGAGGC,18,1915433
ihfAp4,20.666666666666668,63,2,GAGAGGTGGTCGATGGCCTC,61,1912794
ihfAp4,8.666666666666666,27,2,GAGAAGACGAGAGCTTATAA,25,1935474
ihfAp4,6.333333333333333,20,2,GACTGATTTAATAACTCTAT,18,1923455
ihfAp4,10.666666666666666,33,2,GACGAGCATGATACCGGACG,31,1957173
ihfAp4,12.0,37,2,GACATGTGCGATTACACGTT,35,1916083
ihfAp4,1.3333333333333333,5,2,GACAGGCAACTAAAAGTGCG,3,1950306
ihfAp4,27.0,82,2,GACAGAGCATTATTCTATTT,80,1960165
ihfAp4,65.33333333333333,197,2,GACACGGCATAGGGTTGACG,195,1924469
ihfAp4,6.666666666666667,21,2,GAATTTTTCTAAACCAGGGC,19,1925610
ihfAp4,1.3333333333333333,5,2,GAATGATCCTACAAGGTCTG,3,1923213
ihfAp4,4.0,13,2,GAATCCCTGCCCTTATCGGT,11,1928516
ihfAp4,9.0,28,2,GAAATCCTGGTCGAGACGGC,26,1932960
ihfAp4,1.0,4,2,GAAATACGAAGCTCTAGTTT,2,1927914
ihfAp4,4.333333333333333,14,2,CTTTTGGAAGTGTTATGCGG,12,1930937
ihfAp4,5.333333333333333,17,2,CTTTCTTTCTACATTCCCTG,15,1910075
ihfAp4,5.666666666666667,18,2,CTTCTCAAGTAGTTCCCGTG,16,1913490
ihfAp4,4.333333333333333,14,2,CTTCGGAGCTGCGGCCCAAA,12,1941784
ihfAp4,0.6666666666666666,3,2,CTTATCGGGTCTGTGCCCCT,1,1960947
ihfAp4,0.6666666666666666,3,2,CTGTGGCTAGTGGAACACGG,1,1931131
ihfAp4,0.6666666666666666,3,2,CTGTGGCCAGAGAGCCAAGG,1,1909676
ihfAp4,9.666666666666666,30,2,CTGTCCGTGATGGACCGAAT,28,1912749
ihfAp4,6.666666666666667,21,2,CTGGTACCCCTAGGTACCAA,19,1929818
ihfAp4,5.0,16,2,CTGGTAAGGTTAGTTCAGAT,14,1926089
ihfAp4,4.0,13,2,CTGGGGGTATCGCAGCATGC,11,1910860
ihfAp4,9.666666666666666,30,2,CTGGACATATCTCCCGGTTG,28,1911713
ihfAp4,6.333333333333333,20,2,CTGCTGTGGGCTGTCGCACT,18,1941345
ihfAp4,8.333333333333334,26,2,CTGCTATCAAATCTTTTAAT,24,1933695
ihfAp4,0.6666666666666666,3,2,CTGATATTGCAGCCTTCTTT,1,1950748
ihfAp4,9.333333333333334,29,2,CTGAGTCACGGTGGCTATCG,27,1928041
ihfAp4,1.3333333333333333,5,2,CTGAAGTCGTCACAGAAATT,3,1915651
ihfAp4,12.666666666666666,39,2,CTCTTAACGGGCAATGTGAA,37,1918659
ihfAp4,12.0,37,2,CTCGTAGGTATTGGCTTTGA,35,1918197
ihfAp4,14.0,43,2,CTCGATTCGTCTGGAGTAGC,41,1940116
ihfAp4,2.6666666666666665,9,2,CTCCGATTTCCGTCATTATA,7,1919052
ihfAp4,5.333333333333333,17,2,CTCCCTGCGGGAAGAGAAAG,15,1915469
ihfAp4,7.666666666666667,24,2,CTATTCCATAGATAAAGTGA,22,1960241
ihfAp4,8.0,25,2,CTATGTGTCAATCTTCCATA,23,1938580
ihfAp4,2.6666666666666665,9,2,CTATGGCTAAGGCACGCTTG,7,1952732
ihfAp4,5.0,16,2,CTAGTTGCTCCCCCTACTAA,14,1916927
ihfAp4,3.0,10,2,CTAGCTACAGGGACCACATG,8,1923840
ihfAp4,10.333333333333334,32,2,CTACGGAACGGTTCACCTCG,30,1935248
ihfAp4,10.333333333333334,32,2,CTAACGTAGACCCCCACATT,30,1952902
ihfAp4,13.0,40,2,CGTTTGTTCCTTACGACGAT,38,1916497
ihfAp4,3.6666666666666665,12,2,CGTTTCAATAGTTACATGGA,10,1936563
ihfAp4,7.0,22,2,CGTTGTTTCGTAGGGGGTTA,20,1954590
ihfAp4,6.333333333333333,20,2,CGTTCTGTTAAGTCGGAATA,18,1916442
ihfAp4,11.0,34,2,CGTGTTACCTTATCAAATCA,32,1923874
ihfAp4,21.666666666666668,66,2,CGTGTACTGTGTCTATTAAA,64,1925010
ihfAp4,6.0,19,2,CGTGTAATTCCACCCCATAG,17,1951816
ihfAp4,0.6666666666666666,3,2,CGTGCTAACGCGCCATCGCC,1,1939093
ihfAp4,2.0,7,2,CGTGATGATTCGAATATGGA,5,1955260
ihfAp4,3.6666666666666665,12,2,CGTCCAGACCGAGACCCTGC,10,1930374
ihfAp4,1.0,4,2,CGTCACGGGTTCTGGAGCCT,2,1927434
ihfAp4,5.333333333333333,17,2,CGTAGATACCTCTATCTCGG,15,1912101
ihfAp4,6.666666666666667,21,2,CGGTTGCAGTAGGCTATACA,19,1911350
ihfAp4,28.333333333333332,86,2,CGGTGCCACATGCCACGATA,84,1944120
ihfAp4,9.666666666666666,30,2,CGGTCGTAAACTATTTTCTG,28,1952110
ihfAp4,6.333333333333333,20,2,CGGTCCAGTGTTATTTACGC,18,1935267
ihfAp4,8.0,25,2,CGGGGTGAACTCAGTCTGAT,23,1944691
ihfAp4,13.666666666666666,42,2,CGGGGGGGACTTAACGAATT,40,1914408
ihfAp4,13.0,40,2,CGGGGGCATTTTGTACATTT,38,1942332
ihfAp4,6.333333333333333,20,2,CGGGCGAGCACTACTTGACT,18,1939032
ihfAp4,4.666666666666667,15,2,CGGCGTCATCGTTGAAAGTG,13,1916247
ihfAp4,8.333333333333334,26,2,CGGCGAGATCAAAGGATCCT,24,1927711
ihfAp4,3.0,10,2,CGGATTCGGCCCTCAACTAT,8,1951278
ihfAp4,68.66666666666667,207,2,CGGACGAAACGCTTTATGTT,205,1959815
ihfAp4,5.666666666666667,18,2,CGGAATGTGGTAAAGATGAT,16,1947379
ihfAp4,5.666666666666667,18,2,CGGAAACGAAGCTTTGTTAG,16,1928936
ihfAp4,0.6666666666666666,3,2,CGCTTTCATTAATTCCTTTA,1,1960881
ihfAp4,14.666666666666666,45,2,CGCTGTTTGCCTGGTCACAC,43,1937916
ihfAp4,6.333333333333333,20,2,CGCTGTCTAAGCGTACTTTA,18,1959469
ihfAp4,10.666666666666666,33,2,CGCTGTACTTCGACATATGC,31,1928369
ihfAp4,8.333333333333334,26,2,CGCTCTTTCAATCTGCGTGC,24,1911586
ihfAp4,5.333333333333333,17,2,CGCTATCGGCTAACTGAGAA,15,1924798
ihfAp4,0.6666666666666666,3,2,CGCTAACCTAGAATAAATTT,1,1923694
ihfAp4,2.0,7,2,CGCGAGCACTAGGGTATAGA,5,1926377
ihfAp4,7.666666666666667,24,2,CGCCGGTTGATCTTCGTAAA,22,1910266
ihfAp4,4.666666666666667,15,2,CGCCGGAGCGCTCTCTACGA,13,1936118
ihfAp4,7.0,22,2,CGCAGGCTGATCGAGGGAGC,20,1932570
ihfAp4,7.0,22,2,CGCAATTCTAATTTCCTAAT,20,1959903
ihfAp4,10.0,31,2,CGATTGTTAAAGCCTCATTA,29,1934268
ihfAp4,1.6666666666666667,6,2,CGATCACTGCGAGCATCAGC,4,1955310
ihfAp4,2.3333333333333335,8,2,CGATATGGATTAACCTGAGA,6,1918147
ihfAp4,12.666666666666666,39,2,CGATAGTACAGTGAATTGCT,37,1923589
ihfAp4,4.333333333333333,14,2,CGAGCGCGTGGTCGGCGTCT,12,1922524
ihfAp4,10.0,31,2,CGACCCAGTTTAAAATGCCA,29,1936732
ihfAp4,0.6666666666666666,3,2,CCTTGACACCTACCATGTAT,1,1919040
ihfAp4,3.6666666666666665,12,2,CCTTAGGGATTCTCTTCAGA,10,1921027
ihfAp4,0.6666666666666666,3,2,CCTGAGGCAATGATCTGATG,1,1917626
ihfAp4,9.0,28,2,CCTAAGGCTGGAGCTATAAG,26,1931142
ihfAp4,21.666666666666668,66,2,CCTAACTTCAGCGGGACCGA,64,1936839
ihfAp4,5.0,16,2,CCGTCCAGTATAAGACGTGC,14,1926281
ihfAp4,9.0,28,2,CCGTAGTAGCCGGTAATACC,26,1942622
ihfAp4,7.666666666666667,24,2,CCGGTCTCGTCAATTCAGAC,22,1931582
ihfAp4,14.333333333333334,44,2,CCGGTAGTCGGGGACCGTAG,42,1909619
ihfAp4,7.0,22,2,CCGGGGAGATGATTATCTTG,20,1917942
ihfAp4,5.333333333333333,17,2,CCGGCCCAAAAAATGTCGAT,15,1951097
ihfAp4,12.666666666666666,39,2,CCGCTTTCAAATATTTTTAT,37,1943601
ihfAp4,5.666666666666667,18,2,CCGCTAAGCGGGACAGCGCC,16,1928675
ihfAp4,8.0,25,2,CCGCAGGCAATAAGGGGTGA,23,1931840
ihfAp4,7.0,22,2,CCCGATATTCGAAAAAAGGA,20,1923986
ihfAp4,9.333333333333334,29,2,CCCGAGGTAAGTGGGCAGTC,27,1913794
ihfAp4,0.6666666666666666,3,2,CCCCTAATGCTAAAAGATTG,1,1912811
ihfAp4,12.333333333333334,38,2,CCCCGGCTCTCTTTATCGTA,36,1942736
ihfAp4,11.333333333333334,35,2,CCCCGGCATGGAGGACTGCA,33,1944452
ihfAp4,9.666666666666666,30,2,CCCCCTCGGTCCGCAGCAAT,28,1919222
ihfAp4,9.333333333333334,29,2,CCCATCCCGCACTATTCAAT,27,1956432
ihfAp4,0.6666666666666666,3,2,CCCAAACCAAGGTGATCAAT,1,1934065
ihfAp4,9.0,28,2,CCATGTGATTAGATAAGGCA,26,1924000
ihfAp4,5.0,16,2,CCATGGGGTTCTCAGAGGCT,14,1921379
ihfAp4,2.3333333333333335,8,2,CCATGACTATCGTACTTAAT,6,1918732
ihfAp4,7.666666666666667,24,2,CCATGAAGATCTTTCACACA,22,1940151
ihfAp4,4.0,13,2,CCAGTTCGAATAAGAAAGGC,11,1915800
ihfAp4,8.0,25,2,CCAGAGCCGTGCACGGGCTA,23,1929159
ihfAp4,16.333333333333332,50,2,CCAGAAGATTTTGGCAGTTC,48,1941578
ihfAp4,4.333333333333333,14,2,CCACGAGGTAATCCGTGAGA,12,1923416
ihfAp4,6.666666666666667,21,2,CCAACCTGCACGCAGGATGT,19,1940711
ihfAp4,6.333333333333333,20,2,CATTGGTACGGGGCTCGTGT,18,1949966
ihfAp4,6.0,19,2,CATCGTGAGTCATTTGCCGC,17,1948930
ihfAp4,7.0,22,2,CATCGCACTGTTCCCGACGA,20,1955335
ihfAp4,2.6666666666666665,9,2,CATCACTTTATAGCGTAGGC,7,1950157
ihfAp4,5.0,16,2,CATCAATTCCTTCGTTCATG,14,1953687
ihfAp4,11.0,34,2,CATATCCCGCTTTTCCACTA,32,1958849
ihfAp4,0.6666666666666666,3,2,CATATATACATCAGATAGTA,1,1959452
ihfAp4,6.0,19,2,CATAGTCACGCGATTCAACT,17,1945642
ihfAp4,11.0,34,2,CAGTTTGCCAATGAAGCGAT,32,1952086
ihfAp4,3.6666666666666665,12,2,CAGGGGTCAAGAGAATGGAT,10,1930863
ihfAp4,22.333333333333332,68,2,CAGCTTCCCAAAATGTTACG,66,1944313
ihfAp4,3.0,10,2,CAGCTGCGTGTTCTTGAGTC,8,1920514
ihfAp4,9.666666666666666,30,2,CAGATGCACTATGCCTAGAC,28,1962075
ihfAp4,7.333333333333333,23,2,CAGAGTGATTCATAGCGTGA,21,1962253
ihfAp4,9.333333333333334,29,2,CAGAGTGATGGACCCGCGGT,27,1923772
ihfAp4,1.0,4,2,CAGAACTGTCAGAAACGGGA,2,1929696
ihfAp4,5.333333333333333,17,2,CACTCGATAACAACAAATCC,15,1923228
ihfAp4,8.0,25,2,CACTCATTGCATCCGTTCTT,23,1920183
ihfAp4,14.666666666666666,45,2,CACGGGAGTGGACTGACCGC,43,1938932
ihfAp4,2.3333333333333335,8,2,CACGGACCTTCCGTGCCTTT,6,1938493
ihfAp4,10.0,31,2,CACCGGACATTTTAAACATA,29,1960909
ihfAp4,15.0,46,2,CACCGATGCGTCTGAGCTCT,44,1937427
ihfAp4,9.666666666666666,30,2,CAATTGGGCAGAACGGGTGC,28,1921414
ihfAp4,6.0,19,2,CAATGATACGCTTCTCTATC,17,1918229
ihfAp4,3.0,10,2,CAATCGACACGTTGTGGATG,8,1915449
ihfAp4,4.0,13,2,CAAGTTGTAGTTGTAGGTTA,11,1921423
ihfAp4,8.0,25,2,CAAGCGTCAAGGGTGATAAA,23,1922352
ihfAp4,7.0,22,2,CAAGCACGGGCCCATCTATG,20,1953003
ihfAp4,7.333333333333333,23,2,CAAGAGAGCGTGCCTTATGA,21,1940396
ihfAp4,4.0,13,2,CAACCTCGTCGTGTTTCGGC,11,1942859
ihfAp4,3.6666666666666665,12,2,CAACACCGAACTTTCCGGAA,10,1942408
ihfAp4,7.333333333333333,23,2,CAACACCCCCTGCACTTAAT,21,1940368
ihfAp4,9.0,28,2,CAAAACATATGTTCTCTCCC,26,1911604
ihfAp4,0.6666666666666666,3,2,ATTTTGGGGACGAGCTAAAG,1,1921405
ihfAp4,0.6666666666666666,3,2,ATTTTCCAATCATGCACACG,1,1933751
ihfAp4,7.666666666666667,24,2,ATTTCTGATAGCGGAAGAAC,22,1925347
ihfAp4,14.333333333333334,44,2,ATTGCACGCTCAGGATTGCT,42,1943269
ihfAp4,5.666666666666667,18,2,ATTCGAGAATAATTGTTGTA,16,1953369
ihfAp4,1.0,4,2,ATTCACCACGCGTCATTGCC,2,1925855
ihfAp4,5.333333333333333,17,2,ATTATGATCTATGATAGCGA,15,1912304
ihfAp4,7.0,22,2,ATGTGTGGGTGTACCCCACG,20,1915763
ihfAp4,9.333333333333334,29,2,ATGTCTGTACCTCCTTTATG,27,1935657
ihfAp4,12.666666666666666,39,2,ATGTCCCAGCACGGCCGCCT,37,1958257
ihfAp4,4.333333333333333,14,2,ATGGTGGTTTAACTAAGGTC,12,1938826
ihfAp4,5.666666666666667,18,2,ATGGCTATATACATCCTAGA,16,1929794
ihfAp4,4.666666666666667,15,2,ATGCTCACCAAAAGGATTCC,13,1961358
ihfAp4,3.0,10,2,ATGCGTAGGCCTCCCCGTGT,8,1931146
ihfAp4,6.0,19,2,ATGCGGAGATTGATTACGAT,17,1920100
ihfAp4,7.666666666666667,24,2,ATGATCCAACGTGAAAAATT,22,1948571
ihfAp4,2.0,7,2,ATGATAATTAAGCATTCACT,5,1945474
ihfAp4,10.0,31,2,ATCTTTATACTGCAAGGAAC,29,1953918
ihfAp4,7.666666666666667,24,2,ATCTTGCAAGTAGTTACCCC,22,1917103
ihfAp4,24.333333333333332,74,2,ATCTCATCTCCTGTCAACAT,72,1912189
ihfAp4,13.666666666666666,42,2,ATCACCCCAGACTTTAGCCT,40,1960342
ihfAp4,0.6666666666666666,3,2,ATATTCCCGCTATAGCCCTA,1,1926083
ihfAp4,1.6666666666666667,6,2,ATATTCCAGTAGCTCCTGAC,4,1953492
ihfAp4,1.6666666666666667,6,2,ATAGGGATGTTGGCGTAAGC,4,1943339
ihfAp4,9.666666666666666,30,2,ATAAGTTCTATGGGTGTCCC,28,1946528
ihfAp4,4.333333333333333,14,2,AGTTTAAGGTCGTCGATAGC,12,1917980
ihfAp4,28.333333333333332,86,2,AGTTATGCTATCGGGTGTAT,84,1916586
ihfAp4,13.0,40,2,AGTTAGATGTTGCTTTGCTC,38,1944189
ihfAp4,3.0,10,2,AGTGACTCTTCTCTCAATTA,8,1939033
ihfAp4,7.333333333333333,23,2,AGTCTTCCACGGAATGGTTA,21,1935887
ihfAp4,34.666666666666664,105,2,AGTAATTCATATTGCTTTCC,103,1958630
ihfAp4,16.0,49,2,AGGTTTTATTGATGCCAACC,47,1925264
ihfAp4,6.333333333333333,20,2,AGGTCAATTAATTTTCGATA,18,1919902
ihfAp4,1.6666666666666667,6,2,AGGTATCGCGCTGCACCTTT,4,1958858
ihfAp4,6.0,19,2,AGGTAGTTAATAGGAGTAAA,17,1913073
ihfAp4,13.333333333333334,41,2,AGGGTGACACCACTCGTGCT,39,1961531
ihfAp4,4.666666666666667,15,2,AGGGGTGGTTACGACAGTTG,13,1947844
ihfAp4,19.0,58,2,AGGGCGTCAATAGGACGGTC,56,1936747
ihfAp4,7.333333333333333,23,2,AGGGCGCTCGGGATAGTATC,21,1961997
ihfAp4,4.666666666666667,15,2,AGGCATCGGGCGATCCCATC,13,1925982
ihfAp4,6.666666666666667,21,2,AGGCACGGTATAATTCCCGC,19,1956739
ihfAp4,8.0,25,2,AGCTTAATTCGCTGGCTCGT,23,1942831
ihfAp4,2.6666666666666665,9,2,AGCTGTAGTCCGGTGATAGC,7,1958314
ihfAp4,14.333333333333334,44,2,AGCTGCTGCCGAAAGGGGCT,42,1940445
ihfAp4,1.6666666666666667,6,2,AGCTAACTAGATAATGTCAA,4,1944891
ihfAp4,7.333333333333333,23,2,AGCGTCAAGGCATACAGTAA,21,1910831
ihfAp4,5.333333333333333,17,2,AGCCCACGAAACAGGCATGG,15,1935809
ihfAp4,8.333333333333334,26,2,AGCATGAGCGTGGATTATCG,24,1928803
ihfAp4,5.0,16,2,AGCAATCCCATCTGGAGGGA,14,1920400
ihfAp4,6.0,19,2,AGAGTCAATACAAAGCTTGT,17,1944063
ihfAp4,8.333333333333334,26,2,AGAGCCTGGTTACATTGCTT,24,1914116
ihfAp4,4.666666666666667,15,2,AGAATTTTTGTACGTAGGGT,13,1918693
ihfAp4,3.3333333333333335,11,2,ACTTGAGGTCCTCTGTTAAC,9,1932485
ihfAp4,8.333333333333334,26,2,ACTCGAAAGGAAACCTGGCC,24,1921440
ihfAp4,6.333333333333333,20,2,ACTCACAATAGGCCAGCAGC,18,1955414
ihfAp4,1.0,4,2,ACTATAGATCCGAGAGTCCT,2,1922280
ihfAp4,5.333333333333333,17,2,ACTACGGTCGTAGACACCAA,15,1950618
ihfAp4,0.6666666666666666,3,2,ACGGACGTGCAGTTCACAAC,1,1950917
ihfAp4,1.0,4,2,ACGCGTTCGGCGCTTAAAGT,2,1925111
ihfAp4,0.6666666666666666,3,2,ACGCGTCAACATTGATCTCC,1,1934877
ihfAp4,13.666666666666666,42,2,ACGAGTAGTGTAGGTCCCTT,40,1936776
ihfAp4,15.0,46,2,ACGAGGTCTGTTCGCGGACT,44,1956656
ihfAp4,16.666666666666668,51,2,ACCGGCGCCGACTACCAGAC,49,1943997
ihfAp4,0.6666666666666666,3,2,ACCGGACGAACTCAGTAGGC,1,1912272
ihfAp4,9.666666666666666,30,2,ACCCTCACTTGGCCCCATGG,28,1918340
ihfAp4,1.0,4,2,ACCAGAAATATCAATATGGA,2,1939636
ihfAp4,8.0,25,2,ACCAATTAGCTATGAAGCCC,23,1952113
ihfAp4,8.666666666666666,27,2,ACATGTATTGGTGGGGTTCC,25,1959206
ihfAp4,9.666666666666666,30,2,ACATGGACATTGTTTGCGGA,28,1951707
ihfAp4,17.333333333333332,53,2,ACAGGACCATCTATGGCGCT,51,1928536
ihfAp4,9.666666666666666,30,2,ACACTGGTCAATGACCTAGT,28,1916455
ihfAp4,6.333333333333333,20,2,ACACCTTTGACCGCCATCTA,18,1910679
ihfAp4,0.6666666666666666,3,2,ACAACGAATATTTCCGAGGC,1,1935691
ihfAp4,4.666666666666667,15,2,AATTGGGGTACCTTGGTACG,13,1937746
ihfAp4,5.333333333333333,17,2,AATTGACTAAGGCTTTTTTG,15,1928337
ihfAp4,6.333333333333333,20,2,AATTCGACGCATCAAATGAT,18,1930131
ihfAp4,2.3333333333333335,8,2,AATGTCTGCTCTATACCATT,6,1938869
ihfAp4,3.6666666666666665,12,2,AATGAGCTGAAGTTACCTCT,10,1942250
ihfAp4,2.0,7,2,AATGAGCCGCCAGGCCCAGT,5,1935245
ihfAp4,33.0,100,2,AATCGAGATGGCCAGCAAAC,98,1925989
ihfAp4,5.0,16,2,AAGTTCGGCCTGAAGTCTTC,14,1943685
ihfAp4,42.666666666666664,129,2,AAGTCTCGCCGACTCTTGGT,127,1937771
ihfAp4,5.333333333333333,17,2,AAGCCGTACATGGAGATCCA,15,1926933
ihfAp4,10.333333333333334,32,2,AACTCCTTACCAATGGTTTG,30,1929420
ihfAp4,16.333333333333332,50,2,AACTAGACCGGAATAAAACG,48,1928905
ihfAp4,5.0,16,2,AACGGAATATGTCATTGAAT,14,1917037
ihfAp4,9.0,28,2,AACGAGCACAATGGCTGTCA,26,1914936
ihfAp4,3.6666666666666665,12,2,AACGAATACCAAATAAGTCC,10,1944013
ihfAp4,5.0,16,2,AACCTTTAAGCTTTAGTCCA,14,1928688
ihfAp4,7.666666666666667,24,2,AACCCGGAATGAGAGGCGAG,22,1957404
ihfAp4,5.333333333333333,17,2,AACCCAATTTATGTGCATTT,15,1926313
ihfAp4,8.666666666666666,27,2,AAATCGTGGGCGCTGTATCT,25,1929975
ihfAp4,16.666666666666668,51,2,AAATATGCGATCGAGTCGAG,49,1928393
ihfAp4,5.666666666666667,18,2,AAAAATAGGTGACGCCCTGA,16,1911299
ihfAp4,20.5,41,1,TTTTTGACTGTGATGAGCGC,40,1961363
ihfAp4,8.0,16,1,TTTTGTCGCTTCCTTCGTAT,15,1950395
ihfAp4,8.5,17,1,TTTTGGGGCGGTGGGCTAAC,16,1940253
ihfAp4,4.5,9,1,TTTGAAAGATCCATGACTAG,8,1929502
ihfAp4,19.0,38,1,TTTCGTAGTATCCCCGGTCT,37,1927792
ihfAp4,10.0,20,1,TTTATATGCCCCCGTTCTTT,19,1960094
ihfAp4,12.5,25,1,TTTATATCTGGGAAGTGTAT,24,1937277
ihfAp4,14.0,28,1,TTGTTAACTGAGTTCTGTGC,27,1934220
ihfAp4,26.0,52,1,TTGTCGGCGAAAAGATACGC,51,1925060
ihfAp4,18.0,36,1,TTGTCACTCGGGAGCCCAAG,35,1912453
ihfAp4,9.5,19,1,TTGGGGCCAACCGGTCACCC,18,1950265
ihfAp4,14.0,28,1,TTGGCGCCCTGAAGAGATAT,27,1944886
ihfAp4,7.0,14,1,TTGGATATCCCGCCTGCTGG,13,1914632
ihfAp4,9.0,18,1,TTGGACTGCCAAATGTCCGC,17,1936641
ihfAp4,13.0,26,1,TTGGAATGAATTCGTCGAGG,25,1932764
ihfAp4,10.5,21,1,TTGCGAGGGAAACTTTCGAA,20,1942832
ihfAp4,1.0,2,1,TTGCCTGTAATCACTTTTGA,1,1953300
ihfAp4,26.0,52,1,TTGCATGACGTGCGTCTAAG,51,1944895
ihfAp4,3.0,6,1,TTCTGTTTCCCCCGTCTCAT,5,1955588
ihfAp4,10.0,20,1,TTCTCATTGTGTGATACTGC,19,1960374
ihfAp4,6.0,12,1,TTCTAGCAAGTACTAGCGTC,11,1918805
ihfAp4,8.0,16,1,TTCTAGCAACCAGCTCATAT,15,1945030
ihfAp4,8.5,17,1,TTCGGGAGGAACGTACGGAT,16,1913182
ihfAp4,12.0,24,1,TTCGGCTGTAAACTCTGTCG,23,1912323
ihfAp4,11.0,22,1,TTCGACGGGGGGTCACGGGG,21,1926470
ihfAp4,14.5,29,1,TTCCTGGATTCAGATTTAAA,28,1911903
ihfAp4,18.0,36,1,TTCATGGTTTCGGGGGTGAA,35,1927645
ihfAp4,4.0,8,1,TTCAGGCTTCATTCGTTGGT,7,1928941
ihfAp4,3.5,7,1,TTATACATCGGGGAGTGTCC,6,1915857
ihfAp4,1.0,2,1,TTAGTATTATAAAAGTAAGC,1,1914270
ihfAp4,8.5,17,1,TTAGCATATAAGTATACTAA,16,1949501
ihfAp4,8.0,16,1,TTAGACTCAGGTCCTAGATG,15,1915868
ihfAp4,39.0,78,1,TTAAGCACGAGGTCGTGAGC,77,1949519
ihfAp4,12.5,25,1,TGTGTGATGGGCTATATCAT,24,1954316
ihfAp4,10.5,21,1,TGTGCGCGCATGCGGTAGGG,20,1958360
ihfAp4,9.0,18,1,TGTCGCGCGGGCCGGAGGCC,17,1916114
ihfAp4,14.0,28,1,TGTCACCTTGCACAGCGGAA,27,1930068
ihfAp4,3.0,6,1,TGTACTGACCTTACCCTTGC,5,1911426
ihfAp4,9.0,18,1,TGTACGCTGGGCATGGGGAT,17,1956112
ihfAp4,8.0,16,1,TGTAAATTGTATTAATGCCG,15,1940672
ihfAp4,4.5,9,1,TGGTTCCAACGCTATTCTTG,8,1959820
ihfAp4,8.0,16,1,TGGAGTACTTCGGGTCTACC,15,1924629
ihfAp4,1.0,2,1,TGGAACGGTCTTTGTATCGA,1,1948470
ihfAp4,13.5,27,1,TGCTTTGTCCGAATTCACGG,26,1929362
ihfAp4,23.5,47,1,TGCTCGGTTCTTATGGCAAT,46,1959984
ihfAp4,15.0,30,1,TGCTAGCCAGGATCGCTGGC,29,1927547
ihfAp4,7.0,14,1,TGCGGAACAATAGGGTACGT,13,1961209
ihfAp4,6.5,13,1,TGCGATGCTAGTTGAGAACA,12,1938080
ihfAp4,7.0,14,1,TGCCTTTGTCTATAATACAT,13,1926568
ihfAp4,21.0,42,1,TGCCACTCTTTCGCTCGGCT,41,1926413
ihfAp4,10.0,20,1,TGATTAGTGGAGTTTCGGCT,19,1950206
ihfAp4,17.0,34,1,TGATGAGCAATATTAATGTG,33,1923279
ihfAp4,2.0,4,1,TGATCTGTCGCTCATACCTC,3,1921565
ihfAp4,4.0,8,1,TGATCCCTGGCCAACGTCCC,7,1941640
ihfAp4,26.5,53,1,TGAGGAAGAACGCTAATCAG,52,1934609
ihfAp4,6.0,12,1,TGACCTACGTCTAGGGCACA,11,1947256
ihfAp4,13.0,26,1,TCTTATTCTCGACGGCCGGA,25,1925034
ihfAp4,4.5,9,1,TCTTAACTTCCCCCTTTTAT,8,1937546
ihfAp4,9.0,18,1,TCTGTGGTGCTATCCCAAGG,17,1936061
ihfAp4,13.0,26,1,TCTGTACGCCTTCAGTACTT,25,1932841
ihfAp4,17.0,34,1,TCTGGTACTACGGTGGCTCT,33,1950278
ihfAp4,10.0,20,1,TCTGCTCGTATAAAATGCGT,19,1944919
ihfAp4,24.0,48,1,TCTCCGTGGTGTGGACAGAT,47,1928563
ihfAp4,15.0,30,1,TCTAGACGAATTCGGAAAGC,29,1928640
ihfAp4,8.0,16,1,TCTACGATCGCAAAATCGAT,15,1954702
ihfAp4,9.5,19,1,TCGTGCAAATCCATGTAGTC,18,1941667
ihfAp4,32.0,64,1,TCGGGCTCATACGACTCAGA,63,1959132
ihfAp4,9.0,18,1,TCGGAAAATAAGGCTCTTAA,17,1951285
ihfAp4,12.0,24,1,TCGCGGTATACACGTCCGAG,23,1932722
ihfAp4,13.0,26,1,TCGCCCGCAGCCGCTTTCGA,25,1930162
ihfAp4,10.5,21,1,TCGATTCTAGTGCTGCAGCT,20,1939240
ihfAp4,7.5,15,1,TCGAGCACGAGGAGTATCAA,14,1947155
ihfAp4,8.5,17,1,TCCTTCGAAGCCATTCAGAG,16,1941874
ihfAp4,6.0,12,1,TCCGTGCGATCCTGAAGCTA,11,1926464
ihfAp4,12.0,24,1,TCCGCCCAAGGGGCGAACGC,23,1912184
ihfAp4,11.5,23,1,TCCCTCGTGCGCTCCCAGCG,22,1921984
ihfAp4,1.0,2,1,TCCCGGCTCGATTCTCCGCA,1,1915989
ihfAp4,2.5,5,1,TCCCCACTTCCGAGGCATAG,4,1916689
ihfAp4,3.0,6,1,TCCATCCTGCGCTGTAAGAC,5,1954751
ihfAp4,32.0,64,1,TCCAGCACCGATAGCTTTCT,63,1944048
ihfAp4,37.0,74,1,TCCACTCGCCTGACAACCTC,73,1958642
ihfAp4,1.0,2,1,TCAGCCGTTTTTCACATCTC,1,1916380
ihfAp4,21.0,42,1,TCAAGTTGCCACCAGCCATA,41,1955829
ihfAp4,12.0,24,1,TCAAGATAATGCTCGACCCC,23,1917385
ihfAp4,1.0,2,1,TATGCTGTTTTGGATGCCCT,1,1919526
ihfAp4,15.5,31,1,TATGCCCAAAACCTGCTGTC,30,1939092
ihfAp4,19.5,39,1,TATCCTCTGAATAGTATCCG,38,1925330
ihfAp4,1.0,2,1,TATATTCGCACAGGGGATCG,1,1912625
ihfAp4,5.0,10,1,TAGCTTTTTTAGTGGAATCA,9,1921862
ihfAp4,5.0,10,1,TAGCGAACAATAAATTAGTG,9,1929503
ihfAp4,10.5,21,1,TAGCCTTCGAGTTCGCGCTG,20,1961641
ihfAp4,12.0,24,1,TAGAGCAACACGCACGTTGT,23,1960168
ihfAp4,16.5,33,1,TACGTGGCGGACACTTCATG,32,1942225
ihfAp4,5.5,11,1,TACGGTGACTTTCTCCTTCT,10,1930449
ihfAp4,12.5,25,1,TACGCGCGGGCTGAGTTGGT,24,1946992
ihfAp4,17.5,35,1,TACCTCCAGCAGTACCCTTA,34,1922329
ihfAp4,5.0,10,1,TACATTTAGCCGGCGAAAAC,9,1918595
ihfAp4,11.0,22,1,TACATGTGGCGCAATGAGCA,21,1916123
ihfAp4,10.5,21,1,TACATCTTATATGCTAGATG,20,1931342
ihfAp4,16.5,33,1,TACATATGCCGGGGCGCTGG,32,1955671
ihfAp4,7.5,15,1,TAAGTCGAGCGTGTAAAACA,14,1910172
ihfAp4,12.0,24,1,TAAGAGGACACGACAGTATT,23,1961652
ihfAp4,12.5,25,1,TAACGTATATTATGGTCGTC,24,1959470
ihfAp4,15.0,30,1,TAACGAACGCTGGGGATTTG,29,1926728
ihfAp4,7.0,14,1,TAAAGTATGCGCACCCGACA,13,1933357
ihfAp4,4.0,8,1,TAAACTCCCGACCGATTGGC,7,1939435
ihfAp4,14.0,28,1,GTTGGGTTCAAGATACCGCA,27,1931923
ihfAp4,11.0,22,1,GTTGGGCTCGGCACGTGGCA,21,1957943
ihfAp4,14.0,28,1,GTGTTCGTTGATTGGGAGAT,27,1956781
ihfAp4,2.5,5,1,GTGTTATATTGCTAACTCGA,4,1919875
ihfAp4,6.5,13,1,GTGTGCCTTAGCAGCAGCGT,12,1953957
ihfAp4,9.0,18,1,GTGTGAAGTCTCGCTAACGG,17,1925739
ihfAp4,28.0,56,1,GTGTAATTGTCTGTTAATTA,55,1959873
ihfAp4,11.0,22,1,GTGGTACGGTGGGGTTTCTC,21,1955637
ihfAp4,23.5,47,1,GTGCACTGCAGTTGAGCACA,46,1954260
ihfAp4,7.5,15,1,GTGCACAGTACCCAGGTCAT,14,1934108
ihfAp4,13.0,26,1,GTCTCTGGTGGACTATGTGA,25,1943000
ihfAp4,4.5,9,1,GTCGTGTTGGTGACTTACTA,8,1959171
ihfAp4,13.0,26,1,GTCCGTCTTGCTGTCCCTCT,25,1960471
ihfAp4,13.0,26,1,GTCCGGACACATTAGAGGAA,25,1927352
ihfAp4,5.0,10,1,GTCATGTGTGTCAATGGTGG,9,1914832
ihfAp4,2.0,4,1,GTCAGAGGTCCAGACGCATT,3,1941513
ihfAp4,15.0,30,1,GTCAAGGCTCACCACTCGCT,29,1952804
ihfAp4,1.5,3,1,GTATGTATGTTCCAGCGGCT,2,1961183
ihfAp4,4.5,9,1,GTATCTAGAGTGTTCTATAA,8,1938598
ihfAp4,20.0,40,1,GTAGATTCCGGCGATCACCA,39,1915468
ihfAp4,9.0,18,1,GTACTGACCTTTAAGGTTGG,17,1942811
ihfAp4,1.0,2,1,GTACTCACCTCCTTGCTAGT,1,1933369
ihfAp4,11.0,22,1,GTACCGATGTAAGGTAACGA,21,1919553
ihfAp4,14.0,28,1,GTACACCGACTATATCCAGA,27,1914055
ihfAp4,17.5,35,1,GTAACTCCTGGGCGAATCGC,34,1922246
ihfAp4,12.0,24,1,GGTTCGCAGTGACTTGACGC,23,1960955
ihfAp4,4.5,9,1,GGTTCCCTCAATACATTATG,8,1954599
ihfAp4,20.5,41,1,GGTTCATCAAAGTCCGTACG,40,1935103
ihfAp4,31.0,62,1,GGTTACTCGCACCTGCTATT,61,1922914
ihfAp4,13.0,26,1,GGTGAAGCCGCGTTTTCCAA,25,1941246
ihfAp4,16.5,33,1,GGTAGAAGGACCCGACACTC,32,1920346
ihfAp4,6.5,13,1,GGGTCGAACTTTTATGGCCT,12,1909834
ihfAp4,7.0,14,1,GGGGTCGCCGTGCGGTGGGT,13,1937245
ihfAp4,1.5,3,1,GGGGGTTCATATCGGGTTTG,2,1935303
ihfAp4,6.0,12,1,GGGGCTCGGCCTTTATATCC,11,1923919
ihfAp4,20.0,40,1,GGGGAAGATTACCCCATGAA,39,1946198
ihfAp4,9.0,18,1,GGGAGCTTCCAGGGTATTCG,17,1914429
ihfAp4,13.0,26,1,GGGAAGCTGCAACGAAGGTA,25,1918586
ihfAp4,11.0,22,1,GGCTTGGTGCCATATTGTGT,21,1935893
ihfAp4,50.5,101,1,GGCTATGGTGTTATATGTGA,100,1962096
ihfAp4,1.0,2,1,GGCGGGCCACTGTTATAGCC,1,1952583
ihfAp4,5.5,11,1,GGCGGATCCTGGTTGGGTTC,10,1916946
ihfAp4,7.0,14,1,GGCGACTAAAATGCTTCTGG,13,1911952
ihfAp4,5.5,11,1,GGCCTTACGACTCATCATTA,10,1941028
ihfAp4,15.5,31,1,GGCCCGGCCCTTGAGCTGCA,30,1953830
ihfAp4,12.0,24,1,GGCCCCTGGGTCCGATTCGA,23,1944472
ihfAp4,12.5,25,1,GGCCAGGCGGGAATATTGTG,24,1940153
ihfAp4,1.0,2,1,GGCATGCAAGCCCGGGAAAT,1,1910933
ihfAp4,12.0,24,1,GGCATCTCTTTCAGGAGTGT,23,1912892
ihfAp4,12.0,24,1,GGCATCTATATCGGGAGGGC,23,1948252
ihfAp4,8.0,16,1,GGATTGTCCACCTGGCCCAG,15,1931401
ihfAp4,13.0,26,1,GGATGTAGACTAAGCAATGA,25,1937228
ihfAp4,6.0,12,1,GGATGCGTTACAGGATACTT,11,1951269
ihfAp4,7.5,15,1,GGAGGGCAACGAGCGAGAGT,14,1951225
ihfAp4,1.5,3,1,GGAGGCGTTATCCATTACCT,2,1938083
ihfAp4,18.0,36,1,GGAGCACATCCACGCAAAAT,35,1955394
ihfAp4,7.0,14,1,GGAGAAGTCTCGTCCCAGCG,13,1934487
ihfAp4,8.5,17,1,GGACTCATCGCCCGTATGAC,16,1926301
ihfAp4,22.0,44,1,GGACTAAAGGAAAGCCTCCC,43,1954533
ihfAp4,19.5,39,1,GGACCGCTTGCCCCCGTCTC,38,1929765
ihfAp4,2.5,5,1,GGACCCACCCGACAGGCAAG,4,1960509
ihfAp4,7.0,14,1,GCTTGACTGGCCGCAGTTGG,13,1925280
ihfAp4,12.5,25,1,GCTTAGGTAAGCGAAGGGTA,24,1911169
ihfAp4,9.0,18,1,GCTGTAGAGACGAATAACTT,17,1935236
ihfAp4,9.5,19,1,GCTGAAAGGTCTGGAATTTC,18,1915667
ihfAp4,4.0,8,1,GCTCTTGAAGAACTGGCCCT,7,1932408
ihfAp4,22.0,44,1,GCGTTCTAGATCTGAGCATG,43,1919616
ihfAp4,31.0,62,1,GCGTCCCCATATAGGGATCT,61,1923410
ihfAp4,13.0,26,1,GCGGGCTGAAATTAAGTGGT,25,1948993
ihfAp4,41.5,83,1,GCGGAGGGATATGGAGTTTC,82,1917712
ihfAp4,14.5,29,1,GCGATCTCACTGGGACAGAG,28,1915782
ihfAp4,16.5,33,1,GCCTCCCCCGTCGCTTCGGT,32,1944940
ihfAp4,10.5,21,1,GCCGATTGCACGGGTTGGAC,20,1954433
ihfAp4,9.0,18,1,GCCCATGACCGAATATATTT,17,1915441
ihfAp4,8.0,16,1,GCATTGCAACTGCCCCCAGT,15,1943973
ihfAp4,6.0,12,1,GCAGTCCGAGTTACGGACTG,11,1949971
ihfAp4,24.0,48,1,GCAGTAAGGGGCTAATTCGA,47,1937254
ihfAp4,1.0,2,1,GCAGGTGAATGCCCAGGTGT,1,1953852
ihfAp4,5.5,11,1,GCACGTTTGCTATTTGGTTC,10,1915082
ihfAp4,12.5,25,1,GCACGTCTGATCTCTTCGGT,24,1909594
ihfAp4,37.5,75,1,GCACACGGATAGCTGTCCTA,74,1935815
ihfAp4,7.5,15,1,GCACACGAGACCCTCCAGAA,14,1945421
ihfAp4,6.5,13,1,GCAAACAGTAAATGCGCTTT,12,1952634
ihfAp4,7.0,14,1,GATTGTGAAGCCCCTCTTGA,13,1924262
ihfAp4,10.0,20,1,GATTGGCTAGCATGAGAAAG,19,1958154
ihfAp4,19.5,39,1,GATTAATCGCACGCTGATTT,38,1924478
ihfAp4,10.0,20,1,GATCGTCGCGATCAGCAGAA,19,1927389
ihfAp4,5.5,11,1,GATCCTGTTAAGTGATTGGG,10,1929041
ihfAp4,7.0,14,1,GATCCCACCGGCGAGTATAA,13,1938415
ihfAp4,2.0,4,1,GATATACTTTCGACCGTGCG,3,1955822
ihfAp4,11.5,23,1,GATAGTTGAAGCATGATTGA,22,1958656
ihfAp4,8.5,17,1,GAGTTCTGGTTTATTTCAGG,16,1947212
ihfAp4,9.0,18,1,GAGTCGGACGACTGGATAGG,17,1940049
ihfAp4,23.5,47,1,GAGGTTCCGGTTCGAACTAT,46,1916568
ihfAp4,8.5,17,1,GAGGTAGGCTGTACGATCTC,16,1941467
ihfAp4,33.5,67,1,GAGGTACGCATGCGGGCCGA,66,1950230
ihfAp4,27.0,54,1,GAGCCGTTGGCTAACGGGTA,53,1933538
ihfAp4,13.0,26,1,GACTGTGTTGGCACGTCGGG,25,1931455
ihfAp4,5.5,11,1,GACGCATCGTTGAGCGAAAT,10,1929625
ihfAp4,30.5,61,1,GACATGTTCGCGAAGATCAC,60,1956729
ihfAp4,18.5,37,1,GACATGACCTTGGTAAGAAC,36,1925562
ihfAp4,14.0,28,1,GACAAAGTATGACCCGTCGC,27,1961024
ihfAp4,7.5,15,1,GAATCCGAGCTCCAAAGTAC,14,1951099
ihfAp4,2.5,5,1,GAATCAGTGCGAGCGCATCT,4,1918102
ihfAp4,6.0,12,1,GAATAGTACCGCAATACCGG,11,1916179
ihfAp4,9.0,18,1,GAATACAATTACAGTACAAA,17,1943116
ihfAp4,6.5,13,1,GAAGGCTCTAGAAACAGTAA,12,1933058
ihfAp4,5.5,11,1,GAAATAGAGGTCTCTCGCCA,10,1946416
ihfAp4,5.0,10,1,GAAACCACGAGGGCGAGTTC,9,1919092
ihfAp4,4.0,8,1,GAAAAGACTCCCCTCGTCTT,7,1962092
ihfAp4,8.5,17,1,CTTGGATGTAGTCGAACCTA,16,1931536
ihfAp4,8.0,16,1,CTTGATCGTACGCCTGTAAA,15,1915825
ihfAp4,7.0,14,1,CTTCTCATATATCAGGGTTT,13,1918820
ihfAp4,18.0,36,1,CTTAGGGACTCTAGCTGATT,35,1960432
ihfAp4,9.5,19,1,CTGTTCCTTCCGCCGATGAT,18,1950417
ihfAp4,9.0,18,1,CTGTGCCCACCCGAATCTCT,17,1953611
ihfAp4,1.0,2,1,CTGGTAAGTGCCTGTCCGTT,1,1942115
ihfAp4,7.0,14,1,CTGGGCTTTAGAGTTAAATG,13,1944234
ihfAp4,13.5,27,1,CTGGGCCATGCGTGCGAGTT,26,1913356
ihfAp4,2.0,4,1,CTGGGACAGAATCACTACTC,3,1946571
ihfAp4,1.0,2,1,CTGCTCGTATGCTCACTCCG,1,1927464
ihfAp4,4.5,9,1,CTGCGACTACACGTTCGTCC,8,1959728
ihfAp4,25.0,50,1,CTGCGACGTCCAGAAGTAGG,49,1933174
ihfAp4,12.0,24,1,CTGATCACCAGATTTCAAAA,23,1915332
ihfAp4,11.5,23,1,CTGACACGGTTTCAGACTGG,22,1953760
ihfAp4,14.0,28,1,CTCTTTCCATCTGGCGCACA,27,1942328
ihfAp4,6.0,12,1,CTCTGTGAGACCGCCCCTTA,11,1917679
ihfAp4,10.0,20,1,CTCCTGGCTCCAGCTTAGAA,19,1937891
ihfAp4,12.0,24,1,CTCCTCTACCAAAATTCCCT,23,1917752
ihfAp4,10.0,20,1,CTATTGGCGGGCATGCAACC,19,1939030
ihfAp4,9.0,18,1,CTATTCTTCGACATCAGCGG,17,1924018
ihfAp4,5.0,10,1,CTATCTGCGGTTCACGCAAA,9,1912330
ihfAp4,1.0,2,1,CTAGTTTCTCTTAATCGTGA,1,1929504
ihfAp4,17.5,35,1,CTAGTAGTACAATGCGCACT,34,1949980
ihfAp4,8.0,16,1,CTACTCTGCGGTCGTATCGC,15,1940783
ihfAp4,15.0,30,1,CTAAGGCCACTTGATATTTG,29,1933785
ihfAp4,12.5,25,1,CGTTGGTTCCCATAGTTCTT,24,1947364
ihfAp4,11.0,22,1,CGTTGGGCGCCAAAGCGAGC,21,1941257
ihfAp4,1.0,2,1,CGTTAAATAGACGCCACTGT,1,1932046
ihfAp4,10.0,20,1,CGTGTAAGGAAACAACCTTG,19,1948617
ihfAp4,12.5,25,1,CGTCGATTGCCATGATCCGT,24,1940886
ihfAp4,6.0,12,1,CGTATATCCCGCCAAAAGCT,11,1943491
ihfAp4,18.5,37,1,CGTACCACACCGGAGAGACA,36,1956217
ihfAp4,12.0,24,1,CGGTGGTACTAGGCTCCTTG,23,1938602
ihfAp4,10.0,20,1,CGGTCTGTCTTAACAGCATC,19,1937737
ihfAp4,19.5,39,1,CGGCCCAATGCAGAATTAGG,38,1918667
ihfAp4,31.5,63,1,CGGATATGTCCGGAGAAGAT,62,1962129
ihfAp4,13.0,26,1,CGGATAGTAAGTCTTGATGA,25,1917693
ihfAp4,2.0,4,1,CGGAGCTCTCTCGTGTCGTT,3,1950033
ihfAp4,15.0,30,1,CGGAATTCCGTCTCTAGCAG,29,1924219
ihfAp4,13.5,27,1,CGCTTCTATAATACGTAATC,26,1936972
ihfAp4,1.0,2,1,CGCGGTTCGATTAAAGCGCA,1,1913793
ihfAp4,5.5,11,1,CGCGATATTATCTGATATTG,10,1929003
ihfAp4,9.5,19,1,CGCGAATTACATTAGTTCAC,18,1936511
ihfAp4,12.0,24,1,CGCCGCTGCGATATGTGCCT,23,1953368
ihfAp4,12.0,24,1,CGCCGACAACGGTCACCTTT,23,1919751
ihfAp4,5.0,10,1,CGCCCGTCGTCCATTCACCT,9,1956625
ihfAp4,14.0,28,1,CGCCCCGACAGCGGAAATAT,27,1915009
ihfAp4,13.5,27,1,CGCACAAGGGGCCATGGTAC,26,1928954
ihfAp4,13.5,27,1,CGATCGGACCGACAGCTAGG,26,1942997
ihfAp4,1.0,2,1,CGATAGTTCCCAAACTCGCA,1,1950161
ihfAp4,1.0,2,1,CGATAAGACTTACTGCCGGC,1,1958886
ihfAp4,6.0,12,1,CGAGTTTCCGGAAATTGTAG,11,1947129
ihfAp4,9.0,18,1,CGAGCCTAAATAGTCTACGA,17,1943901
ihfAp4,14.0,28,1,CGAGCATGGCAGTTTTACCT,27,1924181
ihfAp4,16.5,33,1,CGAGAAGTAAATTTATGGAA,32,1936157
ihfAp4,1.5,3,1,CGACAAGTATTAGTGGTGAG,2,1947612
ihfAp4,16.0,32,1,CGAACAGTGTTCTTTGGGAT,31,1943751
ihfAp4,12.5,25,1,CCTTGCTTGATGTTCATAAG,24,1946633
ihfAp4,14.0,28,1,CCTCTTGTCAACTTGCACTG,27,1927984
ihfAp4,2.0,4,1,CCTCAATGCTATAATAAACT,3,1953362
ihfAp4,7.0,14,1,CCGGGACCTTGTCATTGTAT,13,1910845
ihfAp4,8.5,17,1,CCGGCTCGAAGCGAGCGTTA,16,1934429
ihfAp4,31.5,63,1,CCGCCCCGATTGCAACTAGG,62,1921073
ihfAp4,6.5,13,1,CCGACTTTTTCGCGTGGGAG,12,1939859
ihfAp4,12.5,25,1,CCGACATGCCTCCATTGGTC,24,1936630
ihfAp4,23.5,47,1,CCGAATGACGATCTCGAAGA,46,1941580
ihfAp4,4.5,9,1,CCCGGGGCACTCGGTGCGCG,8,1961449
ihfAp4,11.0,22,1,CCCGCTGGATTATTGCCGCT,21,1950248
ihfAp4,51.5,103,1,CCCGAGTTTACGTGGGCAAC,102,1921933
ihfAp4,6.0,12,1,CCATGCGTTGTAGGAATGAT,11,1928926
ihfAp4,11.5,23,1,CCATCTGGAATATCCCACTA,22,1935945
ihfAp4,10.5,21,1,CCATACCGTTCTATAGTGGC,20,1959286
ihfAp4,13.5,27,1,CCAGCGGGATCGGTAGTAGA,26,1951689
ihfAp4,10.0,20,1,CCACTGGTGTCCATGTTTCG,19,1942371
ihfAp4,14.0,28,1,CCAAGCTAAGCTTCCTAGGG,27,1943633
ihfAp4,11.5,23,1,CATTTCGGCAGTTATCGGCA,22,1942963
ihfAp4,15.0,30,1,CATTTAAAAATAAGTAGAAC,29,1945823
ihfAp4,5.5,11,1,CATTCTCAGGCGCCCGACGA,10,1923337
ihfAp4,21.0,42,1,CATTCGGTCAGTCCGCGCCC,41,1961855
ihfAp4,9.0,18,1,CATTAAGAGGTACACAAGGC,17,1961596
ihfAp4,8.5,17,1,CATGTTTATAGAGTTTTTGT,16,1957219
ihfAp4,4.5,9,1,CATGTTCCAAACTGACAAGT,8,1952357
ihfAp4,14.0,28,1,CATGGGGCACCCCGGGGCCT,27,1914626
ihfAp4,14.5,29,1,CATCGCAAACGTGTCGCTGA,28,1918363
ihfAp4,14.5,29,1,CATACCTCGGCGCTAGACCC,28,1915035
ihfAp4,14.5,29,1,CAGTCGAAATTCTATTTCTG,28,1928938
ihfAp4,5.5,11,1,CAGTAATGTAATCGGTTAGG,10,1942864
ihfAp4,9.0,18,1,CAGGCGAATTCCCGTCAACC,17,1956142
ihfAp4,21.5,43,1,CAGATAGGTCGTCTCTCTAT,42,1929958
ihfAp4,12.0,24,1,CAGACAGAGCGGGGCTACAC,23,1938200
ihfAp4,9.0,18,1,CACTTCTACTCAAGTGTCTG,17,1921937
ihfAp4,17.0,34,1,CACCTTAATCCAATCTGAAA,33,1958131
ihfAp4,21.5,43,1,CACCGAGGGTTGGAGGCTCG,42,1911305
ihfAp4,6.5,13,1,CACCAAGTGCTTGGCATACT,12,1910761
ihfAp4,2.5,5,1,CACACGTCCATGGGCTTTTC,4,1921009
ihfAp4,6.5,13,1,CAATACAGAAGGCAAAGTGC,12,1941173
ihfAp4,11.5,23,1,CAAGCGTATTCACGCAGCTG,22,1913972
ihfAp4,16.0,32,1,CAAGCCCGGCACCAGGGCCT,31,1929552
ihfAp4,14.5,29,1,CAAATGGTCAACACCTCTAG,28,1954742
ihfAp4,7.0,14,1,ATTTCGACCTTATGGGTGTT,13,1961554
ihfAp4,1.0,2,1,ATTTAGCAGTTTTAGTGCTT,1,1938426
ihfAp4,13.0,26,1,ATTGCGCTCGTAATGCCTTA,25,1918674
ihfAp4,13.0,26,1,ATTGAGAGATAGACATTAAC,25,1962091
ihfAp4,19.5,39,1,ATTGAAACGGGTTATCTATG,38,1912859
ihfAp4,18.5,37,1,ATTCTTTACTTTGAATTTAT,36,1916431
ihfAp4,11.0,22,1,ATTCATTTAGGAAAATTATC,21,1944411
ihfAp4,8.0,16,1,ATTATTCTTCGGCCGGTACC,15,1949915
ihfAp4,1.0,2,1,ATTATCCTTCATTAGTAGCG,1,1910124
ihfAp4,21.0,42,1,ATTACTGTTGGTTCCTACCT,41,1915821
ihfAp4,1.0,2,1,ATGTCTCCAGGCTAGTAGTT,1,1939345
ihfAp4,13.5,27,1,ATGCGCTGCCGACTTACCGC,26,1955417
ihfAp4,9.0,18,1,ATGCAGAGTAAATAATACTC,17,1934603
ihfAp4,15.0,30,1,ATGAAGTTCCGAAGAGCGTC,29,1940337
ihfAp4,16.0,32,1,ATGAAAGGGGGCTCTTGTAC,31,1957437
ihfAp4,11.5,23,1,ATCTTTATCTATCGGGCACT,22,1960567
ihfAp4,1.0,2,1,ATCTGATGTATTTTGGATTT,1,1916294
ihfAp4,1.0,2,1,ATCTCCGTAACATTGTGATG,1,1914271
ihfAp4,4.0,8,1,ATCGTGTAGTCTCACCCTGC,7,1944872
ihfAp4,4.5,9,1,ATCGTACGGGGCCGCGTCTT,8,1957569
ihfAp4,3.5,7,1,ATCGCACTAGGAGCCAGCCA,6,1943599
ihfAp4,20.0,40,1,ATCGACTGTCAGGGCTCGAA,39,1952524
ihfAp4,12.0,24,1,ATCGAAGACGAACACCTTGA,23,1939265
ihfAp4,8.5,17,1,ATCCAAGACACACGCGCATC,16,1949217
ihfAp4,1.0,2,1,ATCAGGGTTTACACCTGCAG,1,1954062
ihfAp4,1.0,2,1,ATATGTTAAAGTCTGCTGGC,1,1928861
ihfAp4,7.0,14,1,ATATCTCGCTGGGTTCCTCC,13,1924307
ihfAp4,4.0,8,1,ATATCAGATTATAAACGAGA,7,1914530
ihfAp4,4.0,8,1,ATAGATTCTTAGTTGGCTTC,7,1923746
ihfAp4,3.5,7,1,ATAGAGTAGGCGGGCGCGGT,6,1935318
ihfAp4,5.5,11,1,ATACTCTACGCAGGCTCGCC,10,1945189
ihfAp4,8.0,16,1,ATACTCCCGCTATTATGGTG,15,1911058
ihfAp4,3.0,6,1,ATACCTATGTCTCAGGACCA,5,1951047
ihfAp4,12.0,24,1,ATACCCCTTCTATTGTCCTT,23,1937910
ihfAp4,16.0,32,1,ATACATTACTTGAGGATTCT,31,1931977
ihfAp4,8.0,16,1,ATAATGTGATTCTCGAGACT,15,1924403
ihfAp4,37.0,74,1,ATAAGTCGAGACATACCTGA,73,1961026
ihfAp4,3.5,7,1,ATAAGCGTGTTGGTTTATAG,6,1913532
ihfAp4,25.0,50,1,AGTTCTGGTTCTGCCCTGCA,49,1948706
ihfAp4,7.5,15,1,AGTTCTCCCCAGGGTAAGGT,14,1926415
ihfAp4,9.0,18,1,AGTATCCACTGAATTACCCC,17,1956817
ihfAp4,14.5,29,1,AGTATAACAGGGTGTCTATA,28,1945994
ihfAp4,14.0,28,1,AGTAGTGTTCAATTCGCTTT,27,1940639
ihfAp4,17.0,34,1,AGTAGGTAAAAACCTATGGT,33,1922346
ihfAp4,6.0,12,1,AGTAGGATGGGATGAACCTC,11,1922092
ihfAp4,8.5,17,1,AGTAGCCGGGATCTGTGCCA,16,1954348
ihfAp4,6.5,13,1,AGTACTGACGATCCCGAGAG,12,1942818
ihfAp4,9.0,18,1,AGTAACGGCCCCCACCTCGG,17,1915914
ihfAp4,9.5,19,1,AGTAAACGCGTGGCAACCGC,18,1944329
ihfAp4,7.5,15,1,AGGGGCCGGCTACCAGCGCT,14,1961683
ihfAp4,11.5,23,1,AGGGATTTCGACGGAAGCCC,22,1940282
ihfAp4,17.0,34,1,AGGCTCGCGTGCGCAGTTGA,33,1935211
ihfAp4,37.0,74,1,AGGAGAATGATTCCCACTGA,73,1931069
ihfAp4,2.5,5,1,AGGACAATAGGCGTCGGTGT,4,1962097
ihfAp4,20.5,41,1,AGCTTTAAGTTGTCATCATA,40,1911915
ihfAp4,1.0,2,1,AGCTTAACTGTTCAGGCATA,1,1945314
ihfAp4,5.0,10,1,AGCTGCCATGCGACATGCCT,9,1960201
ihfAp4,32.5,65,1,AGCTCCAGGGGCATGTCTCT,64,1946181
ihfAp4,7.5,15,1,AGCTCAAGACATCGCACGTC,14,1910164
ihfAp4,11.0,22,1,AGCGGGCAATTGCTATGTTA,21,1940320
ihfAp4,13.5,27,1,AGCGGGAAGAGCGGATGGTT,26,1952531
ihfAp4,8.0,16,1,AGCGGCAACCGTTTTCAGTG,15,1933348
ihfAp4,2.0,4,1,AGCGAAAGTAAAGCGACCCT,3,1929532
ihfAp4,12.5,25,1,AGCCTTAGGTGGGTCACTAG,24,1934896
ihfAp4,12.5,25,1,AGCCGAACAGTAACGCAAGA,24,1962063
ihfAp4,11.5,23,1,AGCATCCAGAAACCTGACTG,22,1915586
ihfAp4,9.0,18,1,AGCAATAGCAAGGGATACCA,17,1926818
ihfAp4,8.0,16,1,AGCAAGAGAACCGACGATAA,15,1961241
ihfAp4,1.0,2,1,AGATTTGGGTACACATCTAG,1,1923643
ihfAp4,5.0,10,1,AGATGTCACCTCGTTTCGAC,9,1956621
ihfAp4,12.0,24,1,AGAGCGCCTAAGTTTTTCGG,23,1924813
ihfAp4,9.5,19,1,AGAGATGCTCGGAAAGCGTG,18,1925984
ihfAp4,4.5,9,1,AGAGAGTGTACTATATATGT,8,1946762
ihfAp4,8.0,16,1,AGAAGCATATAGCCGCACCT,15,1935453
ihfAp4,9.0,18,1,ACTTTCGGAGATGATTATTT,17,1912758
ihfAp4,11.0,22,1,ACTTGTCACAACTCCCCTGA,21,1960311
ihfAp4,1.0,2,1,ACTTCAATTAACAACTACTG,1,1936734
ihfAp4,1.0,2,1,ACTTACGGGTGGCGCTGGAC,1,1938591
ihfAp4,9.5,19,1,ACTTAATGGTAGTCCATAAA,18,1958197
ihfAp4,14.0,28,1,ACTTAATCTCTAGGGAAGGT,27,1959615
ihfAp4,12.0,24,1,ACTGGTGCGCTTTACGGAGA,23,1923847
ihfAp4,6.5,13,1,ACTGGGTTTAGTCACTGTGC,12,1914280
ihfAp4,12.5,25,1,ACTGGGGAAGAGTTGTATGA,24,1961804
ihfAp4,11.0,22,1,ACTGGCGAAAAGCGTAAACC,21,1929017
ihfAp4,9.0,18,1,ACTGCAGTTTAATTGAGGGG,17,1958033
ihfAp4,6.5,13,1,ACTATCGAAGTGCATTCATG,12,1927679
ihfAp4,15.5,31,1,ACTACATCGACTGTCGGGGG,30,1910459
ihfAp4,11.0,22,1,ACGTGAATGTGGATCGCCTT,21,1909916
ihfAp4,1.0,2,1,ACGGTGCCTAGATCAGAAAT,1,1915019
ihfAp4,8.5,17,1,ACGGGGCAGTTCACTGTTAC,16,1933202
ihfAp4,6.0,12,1,ACGGCGCATTGAGTGTGTGC,11,1944376
ihfAp4,11.0,22,1,ACGGATGGCATTTCTACTGG,21,1953603
ihfAp4,11.0,22,1,ACGCTGTTTGCGATTGCGTC,21,1957422
ihfAp4,8.5,17,1,ACGCCTACCCTCCCGGGAAA,16,1921342
ihfAp4,13.5,27,1,ACGCAGCCTGGTATGAACTG,26,1913562
ihfAp4,7.0,14,1,ACGATAGCCGGTAGATGGGG,13,1945595
ihfAp4,12.5,25,1,ACGAGGCCAATCCTGCAATA,24,1912778
ihfAp4,85.5,171,1,ACGAAAAGGTGATGAGAACA,170,1929201
ihfAp4,29.5,59,1,ACCTTGACGTTATTCGCTCC,58,1938267
ihfAp4,4.5,9,1,ACCTTCAATCGTATGGCGCA,8,1949811
ihfAp4,13.0,26,1,ACCTGATAGCAACGAAGTTA,25,1956636
ihfAp4,4.5,9,1,ACCGGCGTACTGGAGGTCAC,8,1933054
ihfAp4,10.5,21,1,ACCCTACAGAGTCATCCCTT,20,1934081
ihfAp4,16.0,32,1,ACCAATAGTCCGATTACATT,31,1913054
ihfAp4,13.0,26,1,ACATGCCCCAATCTCAGATA,25,1928802
ihfAp4,12.0,24,1,ACAGTTGGCTGACAAGTTCA,23,1916229
ihfAp4,21.5,43,1,ACAGTGAATAGGGGAGCTCT,42,1929566
ihfAp4,13.5,27,1,ACAGGCGGAGCTAAACCGTA,26,1924920
ihfAp4,6.5,13,1,ACACGTTATGGGTGTTTGGA,12,1924615
ihfAp4,9.5,19,1,ACAACGCTGCGTATGTCTCA,18,1955706
ihfAp4,7.5,15,1,ACAAACAAGGGTTCCCTAAC,14,1913820
ihfAp4,7.0,14,1,AATTTAGTGACGGCGCCGGT,13,1949647
ihfAp4,33.5,67,1,AATTAGGTTCATTCGGCCCC,66,1914441
ihfAp4,2.5,5,1,AATCGTGCTATCACTCCCCT,4,1929858
ihfAp4,18.5,37,1,AATCCCACTCTCCTTCACCG,36,1943077
ihfAp4,5.0,10,1,AATCCAGAGGAGGCCAACCA,9,1927038
ihfAp4,13.0,26,1,AATCATCGTTGTGTTTCAAA,25,1917151
ihfAp4,6.0,12,1,AATCAGAAATTGAGACTCTT,11,1920866
ihfAp4,11.0,22,1,AATAGGAACCCCCACAGTAA,21,1924054
ihfAp4,15.0,30,1,AAGTTGAAGGTAGGGGGTTG,29,1916695
ihfAp4,3.0,6,1,AAGTTCTTTGCCCGGTCATG,5,1960026
ihfAp4,11.0,22,1,AAGTGGTGCACTCAGGAACT,21,1941904
ihfAp4,14.5,29,1,AAGTAGGCCATCACCTGTAA,28,1950991
ihfAp4,7.5,15,1,AAGGTTTTCCACAGGGGCAC,14,1924051
ihfAp4,7.5,15,1,AAGGTAAGGCGGTTGGCACA,14,1928100
ihfAp4,9.0,18,1,AAGGGAATCCCGAGTACAGT,17,1929149
ihfAp4,28.5,57,1,AAGCACCTATTATTATGCTG,56,1941758
ihfAp4,11.5,23,1,AAGCAATAAGCTGGGACTCG,22,1921799
ihfAp4,1.0,2,1,AACTTTCCGCGGATAGGTTT,1,1933629
ihfAp4,1.5,3,1,AACTAGATCTCGGGTCTTCG,2,1943292
ihfAp4,17.0,34,1,AACCATACGAACCTAAGGCG,33,1940097
ihfAp4,14.0,28,1,AACATTTGAGGGCTCGATTC,27,1944905
ihfAp4,7.0,14,1,AACAGTGATCCGTCTAGCTG,13,1948800
ihfAp4,15.5,31,1,AAAGTAGCTCCGAGAAGGAC,30,1950392
ihfAp4,1.0,2,1,AAAGGATATTACTGGACCTG,1,1922078
ihfAp4,10.5,21,1,AAACTGGTGTTAGTGTGGAC,20,1922525
ihfAp4,1.0,2,1,AAAATAGCACACTCCCTCTG,1,1952946
ihfAp4,2.0,4,1,AAAAATGCTGTGCTTCTTCA,3,1925191
ihfAp4,0.01818181818181818,54,54,GGTAACTCTTGGTCCTCTTA,0,1949012
ihfAp4,0.019230769230769232,51,51,TGAGATACAAGACGGTACGT,0,1909748
ihfAp4,0.019230769230769232,51,51,AAGACGTAACCGCCATCACA,0,1933669
ihfAp4,0.020833333333333332,47,47,GAGGGTGCCGCAGTTGCGAG,0,1910190
ihfAp4,0.02127659574468085,46,46,CGGATCATCCACTGGCCAAA,0,1945736
ihfAp4,0.022727272727272728,43,43,CTGTCACATGAGGTTGCTTC,0,1938983
ihfAp4,0.023809523809523808,41,41,CATGTTATGAGCCTGGCGCA,0,1952041
ihfAp4,0.023809523809523808,41,41,AATAGTGTGACAGTCGGTCT,0,1916843
ihfAp4,0.023809523809523808,41,41,AAGGGGACTGCCAATGTTAA,0,1931962
ihfAp4,0.024390243902439025,40,40,TACTCATCAAAAATTATTTG,0,1920668
ihfAp4,0.024390243902439025,40,40,AACGTCCTTTCGGATTGGAA,0,1916658
ihfAp4,0.025,39,39,GGCCCATTTAGATCCGTTTA,0,1929141
ihfAp4,0.02564102564102564,38,38,TGTTGCTACTATGCGTTGGA,0,1956763
ihfAp4,0.02564102564102564,38,38,GTCGTGAAGTCGCAGGGTCA,0,1917450
ihfAp4,0.02564102564102564,38,38,CGCATCTACAGGCAGGGTAC,0,1925471
ihfAp4,0.02564102564102564,38,38,CCCATATCACCTGACTCCGC,0,1915563
ihfAp4,0.02631578947368421,37,37,GGGCTGGGGACGCCCCATGT,0,1910712
ihfAp4,0.02631578947368421,37,37,GGGCAGGGCTCACTTTATAA,0,1945710
ihfAp4,0.02631578947368421,37,37,GGCAGCAGCACAGTACGTGC,0,1953287
ihfAp4,0.02702702702702703,36,36,TTACCGGGGCTCTTTAGGTC,0,1919118
ihfAp4,0.02702702702702703,36,36,TGGTCATAGAAGGGTCCGGG,0,1960344
ihfAp4,0.02702702702702703,36,36,GTAGTTGTACATCACTCGAA,0,1937567
ihfAp4,0.02702702702702703,36,36,CTGGGAAGCCAACTGCCGTT,0,1954548
ihfAp4,0.02702702702702703,36,36,ATGTGGGCCATAGACGTAGA,0,1948250
ihfAp4,0.02702702702702703,36,36,ATCAGTCCGTAGAGGTAAGA,0,1955118
ihfAp4,0.027777777777777776,35,35,ACATCCCCGGGTTGGTTCAA,0,1959465
ihfAp4,0.02857142857142857,34,34,TAAAGCACAGGGCAGGGTGG,0,1916990
ihfAp4,0.02857142857142857,34,34,AAAGCGTTCTAGGGCTGATT,0,1942272
ihfAp4,0.029411764705882353,33,33,TCAATTGCGTCCCGCGTACT,0,1911208
ihfAp4,0.029411764705882353,33,33,CTCCAGCCGTTTATGACCCA,0,1921914
ihfAp4,0.029411764705882353,33,33,CGTTACAATCGGGTCGCTCC,0,1914225
ihfAp4,0.029411764705882353,33,33,CGGGTCAAGTCCGGTAACAT,0,1916952
ihfAp4,0.029411764705882353,33,33,ACCAAAGAGCCAATACGTGG,0,1910638
ihfAp4,0.030303030303030304,32,32,TGAACCAGTCCGAATATATT,0,1951648
ihfAp4,0.030303030303030304,32,32,TAGGGGACTTGCACCAATGG,0,1959038
ihfAp4,0.030303030303030304,32,32,TAGAAGGTCTATTGGTCTAT,0,1962146
ihfAp4,0.030303030303030304,32,32,GAGAGAGGTGTAGTTTCTTA,0,1920242
ihfAp4,0.030303030303030304,32,32,CGCGAAGTGTTACGTAGCCT,0,1914709
ihfAp4,0.030303030303030304,32,32,ACGTACAATGTTGGTTAGAT,0,1929353
ihfAp4,0.03125,31,31,TTTTAGCATCCTTGCGGTGT,0,1941219
ihfAp4,0.03125,31,31,GCCTGAACTCCCCTTTCACG,0,1917755
ihfAp4,0.03125,31,31,ATGTCTCGTCGCGACTACGA,0,1925888
ihfAp4,0.03125,31,31,ACATGGGTCTATCCCAACGC,0,1922622
ihfAp4,0.03125,31,31,AATGTTTGAGCGTCAATACC,0,1924797
ihfAp4,0.03225806451612903,30,30,TGATCTTACATAGAGCTCAA,0,1954883
ihfAp4,0.03225806451612903,30,30,TCGAGGACTATGTTCCGGAT,0,1941491
ihfAp4,0.03225806451612903,30,30,GTGATGGCATGCGTCGGTGA,0,1924724
ihfAp4,0.03225806451612903,30,30,CGGTGCGTAACGAGAGTTCA,0,1931773
ihfAp4,0.03225806451612903,30,30,CCGAGTCGGCATTATCGGGA,0,1941085
ihfAp4,0.03225806451612903,30,30,CCAGCGCCCACTCTTGAAAC,0,1918286
ihfAp4,0.03225806451612903,30,30,ATGTGGATCGCTGTATGGAA,0,1925772
ihfAp4,0.03333333333333333,29,29,GTGGATATTCATTTCTGCAT,0,1944321
ihfAp4,0.03333333333333333,29,29,CGCGGACTCCAGAAGTAGAT,0,1951112
ihfAp4,0.03333333333333333,29,29,CAGCGATTTCATTGTAGGGA,0,1916157
ihfAp4,0.03333333333333333,29,29,CACAGGTAGCTAGACGTTAT,0,1918308
ihfAp4,0.03333333333333333,29,29,AAAACGTTAGCGTTGGTATA,0,1911641
ihfAp4,0.034482758620689655,28,28,TCAATTCGGGCCGGTGGTAA,0,1946609
ihfAp4,0.034482758620689655,28,28,GCCTTTTGCATGGCATTGAA,0,1936343
ihfAp4,0.034482758620689655,28,28,CTTTACTTATAGTATTGGAA,0,1927939
ihfAp4,0.034482758620689655,28,28,CTGGCTTAGGATTTTGTCAC,0,1956372
ihfAp4,0.034482758620689655,28,28,CTCGACCCAGCTCGAAAGAT,0,1950514
ihfAp4,0.034482758620689655,28,28,CTATTCTATAGTCTTCAAAG,0,1945177
ihfAp4,0.034482758620689655,28,28,CCTTTGGCGGGACACGAATG,0,1945538
ihfAp4,0.034482758620689655,28,28,CCAAGTATTGTCAGCGACGG,0,1942765
ihfAp4,0.034482758620689655,28,28,ATCTTCGACGGTGAGAAGAC,0,1920730
ihfAp4,0.034482758620689655,28,28,ACTCTGCTATTAAGGGTGAT,0,1921267
ihfAp4,0.034482758620689655,28,28,ACCAAGCGCGGCAACCGGTA,0,1943478
ihfAp4,0.034482758620689655,28,28,AAAGCCGAATGGATTTCAGA,0,1917198
ihfAp4,0.03571428571428571,27,27,TTCGACAACGACAAGACGCT,0,1954544
ihfAp4,0.03571428571428571,27,27,TCCGACCTCCATGCCACAAG,0,1917605
ihfAp4,0.03571428571428571,27,27,GTTTTGCTAGGTTAGAGCAA,0,1940397
ihfAp4,0.03571428571428571,27,27,GTGGTAGTTTCGACTCGCGA,0,1915025
ihfAp4,0.03571428571428571,27,27,GGTTAGTTAGTAGTCCGTAA,0,1916375
ihfAp4,0.03571428571428571,27,27,GGTTACGTCCAGGTCATGGG,0,1934938
ihfAp4,0.03571428571428571,27,27,GGAGGTTTTGACCGATCAAA,0,1925388
ihfAp4,0.03571428571428571,27,27,GGAATCGCAGCATGATTTTG,0,1917249
ihfAp4,0.03571428571428571,27,27,GATCAAGCGAATCGAATTGA,0,1941135
ihfAp4,0.03571428571428571,27,27,GACTGCCGTAAGTAGAGCAG,0,1917955
ihfAp4,0.03571428571428571,27,27,CTGCATCACCTTGCAGCCGG,0,1918226
ihfAp4,0.03571428571428571,27,27,CCGATTTGTTAACGCGGCGT,0,1922683
ihfAp4,0.03571428571428571,27,27,CAATGGTTTGCCGTAAGATA,0,1924420
ihfAp4,0.03571428571428571,27,27,ATGGTGTTAAATCCGCCTTG,0,1949182
ihfAp4,0.037037037037037035,26,26,TCTCACCACTGGACGGCCAA,0,1924027
ihfAp4,0.037037037037037035,26,26,TAGGAGCGCAGTCCAGTAAG,0,1937957
ihfAp4,0.037037037037037035,26,26,TAGCACCCTGTGGCGTACAT,0,1961239
ihfAp4,0.037037037037037035,26,26,TAGAAGCTGTCTGGTAAAGC,0,1952281
ihfAp4,0.037037037037037035,26,26,TACAGATCGCAATGGTGCTT,0,1950832
ihfAp4,0.037037037037037035,26,26,GTAATTGGAGGTTTCTGGCT,0,1933707
ihfAp4,0.037037037037037035,26,26,GGGGTGGTAGAGCTTATGGA,0,1913777
ihfAp4,0.037037037037037035,26,26,GGCTCTGGATCGAATCCATA,0,1920006
ihfAp4,0.037037037037037035,26,26,GGATGGACCCGGCCATTGCA,0,1910570
ihfAp4,0.037037037037037035,26,26,GCCGGCAAACTCGTCCCTTA,0,1914777
ihfAp4,0.037037037037037035,26,26,CTTACGAGGCAAATCCTCGG,0,1917353
ihfAp4,0.037037037037037035,26,26,CTAACAGGAGAAAATACCGT,0,1937349
ihfAp4,0.037037037037037035,26,26,CGGGACGGTTTGAAGATATA,0,1941605
ihfAp4,0.037037037037037035,26,26,CGGCGCTTTCAAAGGCAACT,0,1917146
ihfAp4,0.037037037037037035,26,26,CGAGGCTAACCGGCGACTAG,0,1910564
ihfAp4,0.037037037037037035,26,26,CGAAAATCGGCATACATGGC,0,1937363
ihfAp4,0.037037037037037035,26,26,CCTGAATTGGCATTTCGAGA,0,1961069
ihfAp4,0.037037037037037035,26,26,CCACGGGCTTTGTATGATTA,0,1913642
ihfAp4,0.037037037037037035,26,26,CAGAGTTCCATTCGGCAGAC,0,1948962
ihfAp4,0.037037037037037035,26,26,ATGAGGTCACACCACCACAG,0,1948621
ihfAp4,0.037037037037037035,26,26,AGTATGAAGGGGAGCCCCAT,0,1911527
ihfAp4,0.037037037037037035,26,26,AGAGGCACGACCGTCAAATG,0,1912350
ihfAp4,0.037037037037037035,26,26,AGACTGCTGCAGGCTCGCGC,0,1940214
ihfAp4,0.037037037037037035,26,26,AAGCAGGCTTACCCCCGTAT,0,1948677
ihfAp4,0.038461538461538464,25,25,TCCGTGAGGCTTCCACAGGA,0,1928188
ihfAp4,0.038461538461538464,25,25,TCCGGAATGAAGGTAGCGGA,0,1936345
ihfAp4,0.038461538461538464,25,25,TAATTTGGGAAATTTGCTAT,0,1954391
ihfAp4,0.038461538461538464,25,25,GGGTAAAGGCGACTCACAGA,0,1910654
ihfAp4,0.038461538461538464,25,25,GCGGAAAGGCCGATGAGCGT,0,1936259
ihfAp4,0.038461538461538464,25,25,GCAGGCAAGTGTAAGGACAA,0,1959557
ihfAp4,0.038461538461538464,25,25,GAGTTCCGAAGGCTTGCAAA,0,1940558
ihfAp4,0.038461538461538464,25,25,CTAACAGTCTACAAAAAGGC,0,1919029
ihfAp4,0.038461538461538464,25,25,CGATGCGCCTTCTGAAACCA,0,1950909
ihfAp4,0.038461538461538464,25,25,CGACAGACAGGTTGGGGACT,0,1938666
ihfAp4,0.038461538461538464,25,25,CCTATAAATAGTGAGGATTA,0,1926741
ihfAp4,0.038461538461538464,25,25,CAACCCAAAGTTGATTAATT,0,1951556
ihfAp4,0.038461538461538464,25,25,AGGTCAAGCGCCCCGCTCAG,0,1911943
ihfAp4,0.038461538461538464,25,25,AGGCACGAGGGCGCACGATG,0,1919183
ihfAp4,0.038461538461538464,25,25,AGCCAATAGCCACGGCCCCT,0,1927214
ihfAp4,0.038461538461538464,25,25,ACACGCAAGGTCCGTGTCGC,0,1913089
ihfAp4,0.038461538461538464,25,25,AAGACCTCAGACATCACGAA,0,1920012
ihfAp4,0.04,24,24,TAGCCATTAGCGCCCGGCTG,0,1941844
ihfAp4,0.04,24,24,TAACGTACTCTCGGCGCTTT,0,1954440
ihfAp4,0.04,24,24,GTAAGGGAACTCCACGCAAT,0,1946782
ihfAp4,0.04,24,24,GCTCCCTGGGTTTATTGGGT,0,1953398
ihfAp4,0.04,24,24,GCGCATAATGCGAAAATGGA,0,1922751
ihfAp4,0.04,24,24,GCACAGGTTAATGTTTACCA,0,1918930
ihfAp4,0.04,24,24,GAGCTGTATATAGAGCAGTT,0,1923642
ihfAp4,0.04,24,24,GAGCCAGCGGATCAAGCGAG,0,1930275
ihfAp4,0.04,24,24,GACGGAGAATGTCAATGTAA,0,1929716
ihfAp4,0.04,24,24,CGTCCGACACTTGGGTTCCG,0,1933569
ihfAp4,0.04,24,24,CGTCCAACACACAGGGGAAT,0,1946383
ihfAp4,0.04,24,24,CGCTCTAGGCAACCAATAAT,0,1910238
ihfAp4,0.04,24,24,CGCGCGTGGGGGCCAGGAGA,0,1949882
ihfAp4,0.04,24,24,CCGGAAGACACAACGAGGCC,0,1933500
ihfAp4,0.04,24,24,CCAGTAACGCGTGTAGGTAC,0,1915312
ihfAp4,0.04,24,24,CAGTATCAGGAGGAGTGCCA,0,1913644
ihfAp4,0.04,24,24,CACTCCCATTCAGTGATTTT,0,1955386
ihfAp4,0.04,24,24,CACGGAAGGGAGGACACTGT,0,1944930
ihfAp4,0.04,24,24,AGCCCTGCCGCTGAGCGGAT,0,1936528
ihfAp4,0.04,24,24,AGAGGGGGTTCGACTCCGGC,0,1912087
ihfAp4,0.04,24,24,ACTTCGTAAATTTCGCCACA,0,1960876
ihfAp4,0.04,24,24,AAGAACCGCCCAACCGGAGA,0,1913513
ihfAp4,0.04,24,24,AAATATAGACAACTCATCTA,0,1947154
ihfAp4,0.04,24,24,AAAGTAATACCGGAAGGACG,0,1939815
ihfAp4,0.04,24,24,AAAGCGCAACAGCTTAGCCT,0,1929499
ihfAp4,0.041666666666666664,23,23,TGTTGGGAAAGTCCCGTAAC,0,1945138
ihfAp4,0.041666666666666664,23,23,TGTCGTAGATTAAGCACGGA,0,1935321
ihfAp4,0.041666666666666664,23,23,TGGTTGTGTCTCTCCAAGAA,0,1938851
ihfAp4,0.041666666666666664,23,23,TGGACTCGCGTCGCAGTGAT,0,1918004
ihfAp4,0.041666666666666664,23,23,TAGATTACTCCGCGTTCGAG,0,1943479
ihfAp4,0.041666666666666664,23,23,GTGTATGGGGACAGGGTCAC,0,1913509
ihfAp4,0.041666666666666664,23,23,GTAGACTTCAAGAAGGTTGA,0,1943191
ihfAp4,0.041666666666666664,23,23,GTACATCACATAGTTGTGCC,0,1940511
ihfAp4,0.041666666666666664,23,23,GGGGTCTAACCCAGCGTACA,0,1940358
ihfAp4,0.041666666666666664,23,23,GGCTGTCACCCGTACACATT,0,1934848
ihfAp4,0.041666666666666664,23,23,GATATAAAGCTTTGCCCGAA,0,1954609
ihfAp4,0.041666666666666664,23,23,CTGTCCGGCTCTGCCCATTG,0,1914505
ihfAp4,0.041666666666666664,23,23,CTAGCATCCGATCGAGAGGG,0,1911138
ihfAp4,0.041666666666666664,23,23,CTAGAGTTCGTACCGGCTAT,0,1935562
ihfAp4,0.041666666666666664,23,23,CGCTCACGTGAGTAAGGCCA,0,1915033
ihfAp4,0.041666666666666664,23,23,CGACAATATTCCCATATACA,0,1934701
ihfAp4,0.041666666666666664,23,23,CCGGCGAGCCAACGATGCCG,0,1918347
ihfAp4,0.041666666666666664,23,23,CCCGAGAACGTCGGGCGCCC,0,1948465
ihfAp4,0.041666666666666664,23,23,CAGGTCCGTGCTCCAAGGAT,0,1951934
ihfAp4,0.041666666666666664,23,23,CAAAAATTTTGCGACGTATG,0,1955303
ihfAp4,0.041666666666666664,23,23,ATGTTGTGGATTGGGCATTT,0,1939702
ihfAp4,0.041666666666666664,23,23,AGCGCCGTCACCAAATGAGC,0,1937133
ihfAp4,0.041666666666666664,23,23,AGAACCGAGAGGGGGCCTCT,0,1933069
ihfAp4,0.041666666666666664,23,23,ACTTGTTGCTCACGGTAGCA,0,1914361
ihfAp4,0.041666666666666664,23,23,ACTCACCTAGGCGCCACAGT,0,1932235
ihfAp4,0.041666666666666664,23,23,ACGTACTATTGAAGCATTCT,0,1920459
ihfAp4,0.041666666666666664,23,23,ACGGTTGACCACCCACTTCT,0,1941388
ihfAp4,0.041666666666666664,23,23,ACCCATCACATTTTGCGGTT,0,1941968
ihfAp4,0.041666666666666664,23,23,ACAAGCCATATTTCTTCTGC,0,1935505
ihfAp4,0.041666666666666664,23,23,AAGCGCAGACAATCGACACA,0,1917165
ihfAp4,0.041666666666666664,23,23,AAACCTACTAGGCAGCTAAA,0,1951384
ihfAp4,0.043478260869565216,22,22,TTGTCCCAGCGTACGGAATC,0,1955508
ihfAp4,0.043478260869565216,22,22,TTGAGCATATTCCGAGGTCC,0,1912899
ihfAp4,0.043478260869565216,22,22,TGTTTTGAACAATCACAAAA,0,1919836
ihfAp4,0.043478260869565216,22,22,TGCTTCGACGTTAGGCCGTC,0,1957146
ihfAp4,0.043478260869565216,22,22,TGCCGCTTGGGGATAGTGCT,0,1939680
ihfAp4,0.043478260869565216,22,22,TGACCATCACTCTCAGCAAT,0,1919146
ihfAp4,0.043478260869565216,22,22,TCCATACAACGGACCTAGAG,0,1953873
ihfAp4,0.043478260869565216,22,22,TATTCAATGTTAGCGTAGGT,0,1947202
ihfAp4,0.043478260869565216,22,22,TACTCAGGACACACAGACGA,0,1941953
ihfAp4,0.043478260869565216,22,22,TACAATACTGATCATGCGAT,0,1924011
ihfAp4,0.043478260869565216,22,22,TAATAACAGACGCCGGGACA,0,1913666
ihfAp4,0.043478260869565216,22,22,GTCAGCCATTACATGAGGTC,0,1935187
ihfAp4,0.043478260869565216,22,22,GGGATAATATTTGCTACTGA,0,1914451
ihfAp4,0.043478260869565216,22,22,GGAGTAAACCGTCATTAGAG,0,1924144
ihfAp4,0.043478260869565216,22,22,GCGGTTGTTATGAGCGAGCC,0,1912424
ihfAp4,0.043478260869565216,22,22,GATTTTTTAGTGTGCCTGAT,0,1914169
ihfAp4,0.043478260869565216,22,22,GATCGAGTCGATGTGTCAGG,0,1929613
ihfAp4,0.043478260869565216,22,22,GAGATCGTGATTGAAATTAG,0,1951973
ihfAp4,0.043478260869565216,22,22,GACGAGTGTCGGTAGATTAA,0,1929764
ihfAp4,0.043478260869565216,22,22,CTTTTCCTGTGCACGATATG,0,1922461
ihfAp4,0.043478260869565216,22,22,CTATACCTCGATGATCTGAT,0,1920824
ihfAp4,0.043478260869565216,22,22,CTAAAGATTAGGATGAGTAT,0,1961078
ihfAp4,0.043478260869565216,22,22,CCGACATTCAGCCCTGAAAT,0,1915967
ihfAp4,0.043478260869565216,22,22,CCGAAGTGGGGGATGACGAA,0,1913000
ihfAp4,0.043478260869565216,22,22,CCCATTCGCTTCGATTTGCA,0,1952013
ihfAp4,0.043478260869565216,22,22,CCAGTATCTACGGACTGATC,0,1910572
ihfAp4,0.043478260869565216,22,22,CCACCAAGAATACCGTTCGG,0,1926682
ihfAp4,0.043478260869565216,22,22,ACTTAAGAAGTAGATTAACC,0,1940325
ihfAp4,0.045454545454545456,21,21,TTTGAAGCACGTCCGTACTA,0,1955581
ihfAp4,0.045454545454545456,21,21,TTGTATATCGGTTCGCATGC,0,1921164
ihfAp4,0.045454545454545456,21,21,TGGCTCCTGATTCATAAGGA,0,1945957
ihfAp4,0.045454545454545456,21,21,TGCGTTGGATTATGAAAGCC,0,1923045
ihfAp4,0.045454545454545456,21,21,TCCTGTCGAGGTCCAGAATC,0,1911112
ihfAp4,0.045454545454545456,21,21,TCATAAATGTCAACTGCAAG,0,1920887
ihfAp4,0.045454545454545456,21,21,TCAGGTCAAGCGTGCTAGAG,0,1931407
ihfAp4,0.045454545454545456,21,21,TATTGGCCACTTCGCACTTC,0,1926525
ihfAp4,0.045454545454545456,21,21,TAGACTCCCTAACGTTCTCG,0,1945544
ihfAp4,0.045454545454545456,21,21,GTTTCCTCCAGTAAAATGTT,0,1928321
ihfAp4,0.045454545454545456,21,21,GTGCAGGGGTCGGTCAACTC,0,1941995
ihfAp4,0.045454545454545456,21,21,GTATGGTCTATTCATAGCGA,0,1935426
ihfAp4,0.045454545454545456,21,21,GGTTTACGGTTTCAAGAATT,0,1961919
ihfAp4,0.045454545454545456,21,21,GGGTTATCCGTGTTCGGTTT,0,1938139
ihfAp4,0.045454545454545456,21,21,GGCGGGGGGTCCACGAAGTG,0,1930613
ihfAp4,0.045454545454545456,21,21,GCTAATCTCAAGTCAGCCAT,0,1951558
ihfAp4,0.045454545454545456,21,21,GCGCCGTAACTTGGATGCGA,0,1954520
ihfAp4,0.045454545454545456,21,21,CTGGTTCTTGCCGTTTACGT,0,1922569
ihfAp4,0.045454545454545456,21,21,CGCGATGTCCCGCACACAAT,0,1936184
ihfAp4,0.045454545454545456,21,21,CGCACAAATTATCTTTGCTA,0,1916534
ihfAp4,0.045454545454545456,21,21,CCTCGCAGCGCATATGTTTG,0,1931958
ihfAp4,0.045454545454545456,21,21,CCCGCAGTTTGTTTAGTGGT,0,1935382
ihfAp4,0.045454545454545456,21,21,CAATTGTTTTCATGCAGTAT,0,1919944
ihfAp4,0.045454545454545456,21,21,ATGGGGCATCCCCCTTTGAA,0,1913421
ihfAp4,0.045454545454545456,21,21,ATCCGACATACCACCGAGCA,0,1923005
ihfAp4,0.045454545454545456,21,21,ATCAGGAGCCTCAATGATCA,0,1939482
ihfAp4,0.045454545454545456,21,21,ATACGCCACATATGGCTTCG,0,1923501
ihfAp4,0.045454545454545456,21,21,AGTCGTTGCACGGCATCAGG,0,1945161
ihfAp4,0.045454545454545456,21,21,AGGCCAGTATGCGGGCCTTA,0,1939462
ihfAp4,0.045454545454545456,21,21,ACTCAGTGAGTAAGCTGTCG,0,1923109
ihfAp4,0.045454545454545456,21,21,ACTCAACAATTCCGTTATTC,0,1943521
ihfAp4,0.045454545454545456,21,21,AAGCAAGCGAACACGCGATG,0,1946566
ihfAp4,0.045454545454545456,21,21,AACTTCAGGCTCTCTTTTTA,0,1918493
ihfAp4,0.047619047619047616,20,20,TGTTCCGGTGAACAATACTA,0,1914478
ihfAp4,0.047619047619047616,20,20,TGTCCCACTTGTGTTATCAT,0,1912860
ihfAp4,0.047619047619047616,20,20,TCGGTCCGTCAGTCGCGCAA,0,1914360
ihfAp4,0.047619047619047616,20,20,TCGACAAGGTCGGGACCCTA,0,1940524
ihfAp4,0.047619047619047616,20,20,TCGAAAAACGGAGAGTCCAC,0,1912398
ihfAp4,0.047619047619047616,20,20,TCACATAGCTCTTGCATGGG,0,1939985
ihfAp4,0.047619047619047616,20,20,TAGGACTGACATAGCTGCTC,0,1923904
ihfAp4,0.047619047619047616,20,20,TAACAAGGCTGGGGGGAGTA,0,1948347
ihfAp4,0.047619047619047616,20,20,TAAACCTCAAGTGATAGGAT,0,1911048
ihfAp4,0.047619047619047616,20,20,GTTTATTTATGATACCGTCG,0,1917220
ihfAp4,0.047619047619047616,20,20,GTTCGTACCGTATCGGTACA,0,1910349
ihfAp4,0.047619047619047616,20,20,GTGTCGCAAAACCCTTGCTT,0,1949733
ihfAp4,0.047619047619047616,20,20,GTGCGCATTCAACGGGCAGA,0,1927623
ihfAp4,0.047619047619047616,20,20,GTCAAATGACTGACATAGAA,0,1951578
ihfAp4,0.047619047619047616,20,20,GGGTGGCCAACCCGACTGCT,0,1961396
ihfAp4,0.047619047619047616,20,20,GGGGCGTAAGAATTACCGGC,0,1945940
ihfAp4,0.047619047619047616,20,20,GGCCTATTACTATAACTCGG,0,1948535
ihfAp4,0.047619047619047616,20,20,GGCATATTAGAAATCATGTC,0,1921361
ihfAp4,0.047619047619047616,20,20,GGATCATTTCACCAAAAACA,0,1930488
ihfAp4,0.047619047619047616,20,20,GGACTGCTATTAAGGGATGG,0,1918852
ihfAp4,0.047619047619047616,20,20,GGACCGTCTGTCTTATCTCA,0,1912125
ihfAp4,0.047619047619047616,20,20,GCCTGTTGCCAAATAGATCG,0,1951327
ihfAp4,0.047619047619047616,20,20,GAGGTCACTGGGAAGATGTA,0,1961188
ihfAp4,0.047619047619047616,20,20,GACTGGCTGCGTACGCGTTT,0,1945136
ihfAp4,0.047619047619047616,20,20,GAACTATTTGCCATACGCCA,0,1927549
ihfAp4,0.047619047619047616,20,20,CTGGATGTCCACTTTCGGTA,0,1916808
ihfAp4,0.047619047619047616,20,20,CTGCGGAAAGGGAGGGTAGA,0,1940813
ihfAp4,0.047619047619047616,20,20,CTGCCATGTGGCTGAACCTA,0,1941303
ihfAp4,0.047619047619047616,20,20,CGTCACGCGTAGCAGCTTCC,0,1912354
ihfAp4,0.047619047619047616,20,20,CGGCCGATCAAGGTTACTGC,0,1947044
ihfAp4,0.047619047619047616,20,20,CGGAGAATGGAAGTTGTGCA,0,1955997
ihfAp4,0.047619047619047616,20,20,CGAGAATCGTCCCCTAAGTG,0,1917647
ihfAp4,0.047619047619047616,20,20,CCTAGCTCTACAGGTAATCA,0,1914563
ihfAp4,0.047619047619047616,20,20,CCGGCCAGTGTGACGGGGCA,0,1909935
ihfAp4,0.047619047619047616,20,20,CCCTGGGCAGATTAAGGAGT,0,1918598
ihfAp4,0.047619047619047616,20,20,CATCCTCATGTGCGTAGCCA,0,1924796
ihfAp4,0.047619047619047616,20,20,CAGTCAAGCTGAGACTTCCA,0,1930210
ihfAp4,0.047619047619047616,20,20,ATTTTGCCCTTGTTGGCACT,0,1954149
ihfAp4,0.047619047619047616,20,20,ATTCCTTCACCCTTGTCCTG,0,1925233
ihfAp4,0.047619047619047616,20,20,ATTCCCTAGCACCCGGTGAA,0,1938235
ihfAp4,0.047619047619047616,20,20,ATGCCGAGAGAGGGCATCTG,0,1919491
ihfAp4,0.047619047619047616,20,20,AGTCCCACTATAAGAGCATG,0,1960704
ihfAp4,0.047619047619047616,20,20,AGAGTTGTCTTAACCGCAGG,0,1928974
ihfAp4,0.047619047619047616,20,20,ACTGTGCTAGGCTATGTTCA,0,1941338
ihfAp4,0.047619047619047616,20,20,ACTGTCCTAGACTACGGAGA,0,1909692
ihfAp4,0.047619047619047616,20,20,ACTGGATCGGCGAACGGGCA,0,1932403
ihfAp4,0.047619047619047616,20,20,ACCGAGGCCTAGCTACTTTA,0,1914939
ihfAp4,0.047619047619047616,20,20,AATCCTCCTGCTCCGAAGCG,0,1931350
ihfAp4,0.05,19,19,TTTGGGCGTCTATTAAAGTA,0,1940328
ihfAp4,0.05,19,19,TTGCGAGTTGATTCACACGT,0,1940446
ihfAp4,0.05,19,19,TGTGTAAGTTCCGGATTTGT,0,1932354
ihfAp4,0.05,19,19,TGTGGCGCCTATACTGATGG,0,1936197
ihfAp4,0.05,19,19,TGTCTCCGCTTTGGAGGACA,0,1956821
ihfAp4,0.05,19,19,TGTCGCGGCATAACTCCACA,0,1945716
ihfAp4,0.05,19,19,TGGCCTGATTCGCGCAGGCT,0,1945873
ihfAp4,0.05,19,19,TGCCCTGTGTGTGTCATATC,0,1955103
ihfAp4,0.05,19,19,TCATAGGCTCTTCCGAAATC,0,1943807
ihfAp4,0.05,19,19,TCACGCGGCATGTGTTTGGC,0,1918765
ihfAp4,0.05,19,19,GTTGAGGGTAATTGGATCAT,0,1951236
ihfAp4,0.05,19,19,GTGGGGCGGATGTACTGAAC,0,1944492
ihfAp4,0.05,19,19,GGTTAAGAGTTCTGCTCGTA,0,1930831
ihfAp4,0.05,19,19,GGGAAATAAACTTTGCGTGT,0,1947568
ihfAp4,0.05,19,19,GGCAAAAGTGTTCAATAACT,0,1925511
ihfAp4,0.05,19,19,GGATGCCCACTCTGACTCTT,0,1945793
ihfAp4,0.05,19,19,GGACAAGGACGCCATGCTAA,0,1947704
ihfAp4,0.05,19,19,GCTTTAAGGTGACGCAGGTA,0,1909690
ihfAp4,0.05,19,19,GCGGTGAGGTACGGTAGGGA,0,1922544
ihfAp4,0.05,19,19,GCGGCATGAGTGTCTAGCTA,0,1947624
ihfAp4,0.05,19,19,GCCCCTTGTCCTCCACGGGA,0,1930262
ihfAp4,0.05,19,19,GCCACTAAACATCAGCTCCT,0,1918912
ihfAp4,0.05,19,19,GAACTCATGGTGGTTCGATG,0,1937627
ihfAp4,0.05,19,19,CTACTCGATTCCTCCCCCCG,0,1922866
ihfAp4,0.05,19,19,CTACAGATTCAATGTATCCA,0,1917219
ihfAp4,0.05,19,19,CGGTATGCGGCGCCCGTTAC,0,1925391
ihfAp4,0.05,19,19,CGCGAACTATAAAGTCCAGA,0,1939237
ihfAp4,0.05,19,19,CCTTGCATTGCAAGTGCAAA,0,1919090
ihfAp4,0.05,19,19,CCGGTCTGAGCTCAGACGAT,0,1919389
ihfAp4,0.05,19,19,CCGCAATAAAGTGGTGTGTG,0,1914477
ihfAp4,0.05,19,19,CCACCTCACACGGAAGGGTT,0,1942136
ihfAp4,0.05,19,19,ATTTTTGAGCTCCCGGTGCG,0,1946604
ihfAp4,0.05,19,19,ATGTGTTAAAGACTGGTCAA,0,1911609
ihfAp4,0.05,19,19,ATGACGACGCAGTCCCAAGT,0,1954771
ihfAp4,0.05,19,19,ATGACAGGCTAGAGTATGAG,0,1911754
ihfAp4,0.05,19,19,ATCAGTTTTAATCTGGTGAC,0,1948337
ihfAp4,0.05,19,19,ATCAATGGGGTTTTGGCTCA,0,1937824
ihfAp4,0.05,19,19,ATACGTACCATGGAGGAATT,0,1918517
ihfAp4,0.05,19,19,ATAAGCTACAGTTTTGGAAG,0,1920321
ihfAp4,0.05,19,19,AGTACGACAAGACTATCTGT,0,1949618
ihfAp4,0.05,19,19,AGGCCCCAGGGCTATTACCG,0,1926463
ihfAp4,0.05,19,19,AGGAGAACTTACCCTGGAGT,0,1931176
ihfAp4,0.05,19,19,AGCCTCCTGGGTCACTTAGG,0,1922011
ihfAp4,0.05,19,19,AGATCTGTGCTTCCCAGTCA,0,1951905
ihfAp4,0.05,19,19,ACTTAACGGCATACCCGAGT,0,1919570
ihfAp4,0.05,19,19,ACGCCAGGGTGCAAGTAAAC,0,1956174
ihfAp4,0.05,19,19,AAGTTGACTTCCAATGAAGA,0,1920235
ihfAp4,0.05,19,19,AAGACTCGTCCGGCAAGACG,0,1952615
ihfAp4,0.05,19,19,AACGATACATTCGAACCGAT,0,1961323
ihfAp4,0.05,19,19,AACAACGCCGATGTGTCAAC,0,1918306
ihfAp4,0.05,19,19,AAATGTTAAGAAACCGGTAA,0,1956126
ihfAp4,0.05,19,19,AAAAGTTCCGCTTAGTGACA,0,1938944
ihfAp4,0.05263157894736842,18,18,TTGGATTGGTTTCTGATAGT,0,1916950
ihfAp4,0.05263157894736842,18,18,TGTTGGATGCTGGCAGAACG,0,1922463
ihfAp4,0.05263157894736842,18,18,TGTCATACACGGATGCCCAG,0,1936438
ihfAp4,0.05263157894736842,18,18,TGGTGAAGAGGACTCACGTA,0,1922471
ihfAp4,0.05263157894736842,18,18,TGGTCAGAACTAATTTGGTT,0,1933710
ihfAp4,0.05263157894736842,18,18,TGGTACAGAACCTCTGGTGA,0,1938900
ihfAp4,0.05263157894736842,18,18,TGGCGCTTTCATAACTGAAC,0,1928177
ihfAp4,0.05263157894736842,18,18,TGCTAATGGCACGCGTAAGT,0,1918177
ihfAp4,0.05263157894736842,18,18,TGCGACGCCGTCTGGCTACT,0,1923550
ihfAp4,0.05263157894736842,18,18,TCTGACCTCAACCATTCTAC,0,1948967
ihfAp4,0.05263157894736842,18,18,TCTAATCGGACCGGTTCGAC,0,1947045
ihfAp4,0.05263157894736842,18,18,TCCGCCGGACGGGTAACACT,0,1934277
ihfAp4,0.05263157894736842,18,18,TCATTCTACCGTCGTTTGGC,0,1949340
ihfAp4,0.05263157894736842,18,18,TCAAAGTACTACATCTAGTG,0,1953429
ihfAp4,0.05263157894736842,18,18,TAATGATCAATTCAATGCGG,0,1947628
ihfAp4,0.05263157894736842,18,18,GTCCGCTAGGGACAGCGTAG,0,1933861
ihfAp4,0.05263157894736842,18,18,GTCATAATGTGACGGCCGTT,0,1951743
ihfAp4,0.05263157894736842,18,18,GGTTAGTACACAGTGTGGAT,0,1940820
ihfAp4,0.05263157894736842,18,18,GGGGTAGTCAACATACAACG,0,1953607
ihfAp4,0.05263157894736842,18,18,GGGGCCTTTAGGGATCGATG,0,1960693
ihfAp4,0.05263157894736842,18,18,GGGATGCCTTTGTATAAATT,0,1950519
ihfAp4,0.05263157894736842,18,18,GGCTTAGGTCTAAGGGTTAT,0,1920551
ihfAp4,0.05263157894736842,18,18,GGCGAAACGTAGCTTGAGTC,0,1955780
ihfAp4,0.05263157894736842,18,18,GGCATATTCAAACGTTCCAA,0,1945456
ihfAp4,0.05263157894736842,18,18,GGCAGACGGAATACAGAACT,0,1928475
ihfAp4,0.05263157894736842,18,18,GGAGCCGACAGCATGCAGCT,0,1959072
ihfAp4,0.05263157894736842,18,18,GGAAATACTAACCTAGCGGT,0,1924799
ihfAp4,0.05263157894736842,18,18,GCTGGCCCGCTCCGTGTGGT,0,1943205
ihfAp4,0.05263157894736842,18,18,GCTCTCTGCCGAGGATAGCC,0,1937856
ihfAp4,0.05263157894736842,18,18,GCCCCTTATAATAGTGGTCG,0,1957833
ihfAp4,0.05263157894736842,18,18,GCATCCCACAAACCGCCAAA,0,1941806
ihfAp4,0.05263157894736842,18,18,GATATCGATATCAGCTGACA,0,1955725
ihfAp4,0.05263157894736842,18,18,GAGTATCGGAGCAGGGCGTA,0,1925165
ihfAp4,0.05263157894736842,18,18,GAGAGGGTTGGTTCGCATAG,0,1938782
ihfAp4,0.05263157894736842,18,18,GACTATTTTTCGTGGAACTT,0,1961077
ihfAp4,0.05263157894736842,18,18,GACTAAAACTAAGACGGCAT,0,1913104
ihfAp4,0.05263157894736842,18,18,GACATATGACCCTGGTCCGG,0,1939232
ihfAp4,0.05263157894736842,18,18,GAATCGATCACAGTGGATGC,0,1956624
ihfAp4,0.05263157894736842,18,18,CTTGGGGATATCCGGACAAG,0,1931508
ihfAp4,0.05263157894736842,18,18,CTTAGGGCTCCTATGTTGGC,0,1951937
ihfAp4,0.05263157894736842,18,18,CTTAGGAAGACGTCAACATT,0,1923364
ihfAp4,0.05263157894736842,18,18,CTCTACCTCCATGGTGAAAT,0,1955734
ihfAp4,0.05263157894736842,18,18,CTAGGGCAACGAGGCACAGA,0,1930588
ihfAp4,0.05263157894736842,18,18,CGTATTGCTGCGCTCCTGTC,0,1914200
ihfAp4,0.05263157894736842,18,18,CGGACACCACAACGGGAGCG,0,1934430
ihfAp4,0.05263157894736842,18,18,CGAAGTGTTATAAATTTACG,0,1940572
ihfAp4,0.05263157894736842,18,18,CGAAGAAGGGCTCTATGTCT,0,1943212
ihfAp4,0.05263157894736842,18,18,CCTCAAGCAGGGTCAATCAT,0,1925052
ihfAp4,0.05263157894736842,18,18,CCGGCGACCGGGGGTGGACA,0,1931410
ihfAp4,0.05263157894736842,18,18,CATGGTCAGTCAATTAGTCA,0,1935296
ihfAp4,0.05263157894736842,18,18,CAGGACGTAGGGTATGAGAT,0,1958707
ihfAp4,0.05263157894736842,18,18,CACTAGACTGTGCCGAAGTG,0,1913170
ihfAp4,0.05263157894736842,18,18,CACACTGGTACTAAGGCAGC,0,1911891
ihfAp4,0.05263157894736842,18,18,CAATCTTTCGGGGGACACCA,0,1952485
ihfAp4,0.05263157894736842,18,18,CAATCTCACTCTTGACCCGC,0,1912834
ihfAp4,0.05263157894736842,18,18,ATTGGAGAGCATCTCATCGA,0,1942973
ihfAp4,0.05263157894736842,18,18,ATTCGGAGCCTGCCCACAAT,0,1933086
ihfAp4,0.05263157894736842,18,18,ATGGGCTCATTACGGTAGAA,0,1929329
ihfAp4,0.05263157894736842,18,18,ATACAAAAATGTGCCACGCT,0,1911661
ihfAp4,0.05263157894736842,18,18,AGCGTACGTTAGTCTTAAAA,0,1949414
ihfAp4,0.05263157894736842,18,18,AGACGGTGCTACAATGTAGT,0,1941711
ihfAp4,0.05263157894736842,18,18,ACTATTTAATCCCCTTCGGA,0,1945711
ihfAp4,0.05263157894736842,18,18,ACGTTTCGGCCAGGGGCATT,0,1958953
ihfAp4,0.05263157894736842,18,18,ACGGTCATGGTCGTACGTGG,0,1949309
ihfAp4,0.05263157894736842,18,18,ACGCTTCGGAGGTACTTAGT,0,1915567
ihfAp4,0.05263157894736842,18,18,ACGCGCCCCAATGGTTGGTA,0,1925269
ihfAp4,0.05263157894736842,18,18,ACAGGTCACGAGGTACAACG,0,1911559
ihfAp4,0.05263157894736842,18,18,ACAATTATAGTGCGGCTAGG,0,1925524
ihfAp4,0.05263157894736842,18,18,ACAATACGACATCGCATGAA,0,1913280
ihfAp4,0.05263157894736842,18,18,AATCAGGCCTGTACCGATAC,0,1925782
ihfAp4,0.05263157894736842,18,18,AAGTGACCTATTTGGGGGAT,0,1932353
ihfAp4,0.05555555555555555,17,17,TTGAGAAGCTTGTGTAAGAC,0,1926496
ihfAp4,0.05555555555555555,17,17,TTCGCATGCACACAATCCGG,0,1948959
ihfAp4,0.05555555555555555,17,17,TGTTTATTATTAGTCACACC,0,1950787
ihfAp4,0.05555555555555555,17,17,TGTCATTGCGGGACGGGTGT,0,1960476
ihfAp4,0.05555555555555555,17,17,TGGGAGCGTGGCTCGCGCAG,0,1926791
ihfAp4,0.05555555555555555,17,17,TGCCTAAGAGATTCAGTTGC,0,1945770
ihfAp4,0.05555555555555555,17,17,TCTTTTAATTGAGGAACTGG,0,1914028
ihfAp4,0.05555555555555555,17,17,TCTGGTATATTTTAAGCTCC,0,1917454
ihfAp4,0.05555555555555555,17,17,TCTCCACTATCTATGGGTTC,0,1959361
ihfAp4,0.05555555555555555,17,17,TCTATGAAATCCGCAAAAGT,0,1956681
ihfAp4,0.05555555555555555,17,17,TCTACCGGAATACCTTCCGC,0,1937408
ihfAp4,0.05555555555555555,17,17,TCGCGCACTGTGCTAGGTAA,0,1939338
ihfAp4,0.05555555555555555,17,17,TCGCATTCAAAAGTTATTAT,0,1934104
ihfAp4,0.05555555555555555,17,17,TCGAGACGGCACATGCAGAC,0,1938764
ihfAp4,0.05555555555555555,17,17,TCCAATCAACATAAGTTGCT,0,1930263
ihfAp4,0.05555555555555555,17,17,TATAGATAGTTATGCCTAGA,0,1912407
ihfAp4,0.05555555555555555,17,17,TAAGATAGTATCGTTCTATG,0,1917630
ihfAp4,0.05555555555555555,17,17,GTGGGTTTGTTATTTGGATC,0,1913445
ihfAp4,0.05555555555555555,17,17,GTCCCAGATCAATGGGTGCT,0,1935172
ihfAp4,0.05555555555555555,17,17,GTCCATGCTACACCGATTTA,0,1932150
ihfAp4,0.05555555555555555,17,17,GTCCAGCAACGATCCTAGCG,0,1931279
ihfAp4,0.05555555555555555,17,17,GTATACGACGTGGGACCACT,0,1938937
ihfAp4,0.05555555555555555,17,17,GTAGACCCGCGACTGCCGTT,0,1938770
ihfAp4,0.05555555555555555,17,17,GGTTATACTCGCTGAGTCGC,0,1913487
ihfAp4,0.05555555555555555,17,17,GGTGTGAAGTTTTATCACTA,0,1932079
ihfAp4,0.05555555555555555,17,17,GGTATGGAAATTACATTAGT,0,1914562
ihfAp4,0.05555555555555555,17,17,GGGAATCGGGGCCTAGCATG,0,1920406
ihfAp4,0.05555555555555555,17,17,GGCGTCAAGTAGCGGTGGAT,0,1951640
ihfAp4,0.05555555555555555,17,17,GGACAGCTAATTAGGCGCCC,0,1926196
ihfAp4,0.05555555555555555,17,17,GCTTGAAAACCAAAAAGCGA,0,1928264
ihfAp4,0.05555555555555555,17,17,GAGTCCCGTCGCTTGCAGTG,0,1916025
ihfAp4,0.05555555555555555,17,17,GAGGACGCAAACTGTGTCGT,0,1917941
ihfAp4,0.05555555555555555,17,17,GAGAATAGTCATCAGGTCAA,0,1939483
ihfAp4,0.05555555555555555,17,17,GACTCTACTACCGGCTTATT,0,1941565
ihfAp4,0.05555555555555555,17,17,GACGCTGATGCGCCGACTTT,0,1958740
ihfAp4,0.05555555555555555,17,17,GACCGAAAATAGGGTCTCGT,0,1928082
ihfAp4,0.05555555555555555,17,17,GAATCAAGCACATACCTGCA,0,1954559
ihfAp4,0.05555555555555555,17,17,GAAGAAGTCCTTGGGCCATA,0,1925783
ihfAp4,0.05555555555555555,17,17,CTTTTTGCCCGTTTAGTTAT,0,1955109
ihfAp4,0.05555555555555555,17,17,CTTTGTGTTGTCTAGGGAAG,0,1933983
ihfAp4,0.05555555555555555,17,17,CTTGAACAAACGTTTAGAAG,0,1914638
ihfAp4,0.05555555555555555,17,17,CTGGTCCGTTTAGTTAGACA,0,1926096
ihfAp4,0.05555555555555555,17,17,CTGCACTTCGCCGCGTCTGC,0,1944282
ihfAp4,0.05555555555555555,17,17,CTGATTTACGTATGTGTTAG,0,1916964
ihfAp4,0.05555555555555555,17,17,CTACCGTTCCAGCTGTACAA,0,1921452
ihfAp4,0.05555555555555555,17,17,CTACAACACTCCTGCTGACA,0,1916828
ihfAp4,0.05555555555555555,17,17,CTAATATCTTCGTCGGGAGT,0,1950591
ihfAp4,0.05555555555555555,17,17,CGTACACTACTAGCCGGAAT,0,1941888
ihfAp4,0.05555555555555555,17,17,CGGTACTCCCGTATGAACGT,0,1951907
ihfAp4,0.05555555555555555,17,17,CGGGCAACCATAGGAAACCT,0,1954884
ihfAp4,0.05555555555555555,17,17,CGAGTGTTTGCTTACAGCAA,0,1937830
ihfAp4,0.05555555555555555,17,17,CCTACGTCCAGGTTGCTTGG,0,1921916
ihfAp4,0.05555555555555555,17,17,CATTTTGGAAATTCACCCGA,0,1961947
ihfAp4,0.05555555555555555,17,17,CATCGTTGTAAGGTATGCAT,0,1950101
ihfAp4,0.05555555555555555,17,17,CATAGACATATGACAACGTC,0,1915984
ihfAp4,0.05555555555555555,17,17,CAGGGTAGAGCTTACACAAG,0,1920493
ihfAp4,0.05555555555555555,17,17,CAGGAGGTAGATTTGCCCTA,0,1958003
ihfAp4,0.05555555555555555,17,17,CAGATCTGTTTCGGGACGTC,0,1915296
ihfAp4,0.05555555555555555,17,17,CACTCGTTCGGAATATATTC,0,1927716
ihfAp4,0.05555555555555555,17,17,CACGGGTTCCGTGAGTGTCA,0,1942152
ihfAp4,0.05555555555555555,17,17,CACCGGAAGTACTTCAACGG,0,1933931
ihfAp4,0.05555555555555555,17,17,CACCGATACTAGGTGAATAA,0,1914311
ihfAp4,0.05555555555555555,17,17,CAAGGGATGATGTCGGCCAT,0,1924372
ihfAp4,0.05555555555555555,17,17,CAACGCATTCTTCGCAGACA,0,1937381
ihfAp4,0.05555555555555555,17,17,ATTGGAAGGCATCGATTTAC,0,1914568
ihfAp4,0.05555555555555555,17,17,ATCGTTCCGGGATACACGGT,0,1950062
ihfAp4,0.05555555555555555,17,17,ATCCACGTGGCCGGCGTGAT,0,1929617
ihfAp4,0.05555555555555555,17,17,AGTGTCCCTGGGCTTGGACA,0,1913282
ihfAp4,0.05555555555555555,17,17,AGTCTCAGAATATATAGCGC,0,1915158
ihfAp4,0.05555555555555555,17,17,AGGTCGTCGTTGTGAAGGGT,0,1944679
ihfAp4,0.05555555555555555,17,17,AGAGGCTATGGCATGGAAAC,0,1924800
ihfAp4,0.05555555555555555,17,17,AGAAATGTAGAGGATTTTGT,0,1948874
ihfAp4,0.05555555555555555,17,17,ACTACCTAGACCCGACGCAA,0,1930010
ihfAp4,0.05555555555555555,17,17,ACCTATAGAACTTTGCCATG,0,1946441
ihfAp4,0.05555555555555555,17,17,ACAACATTTGGTGACCCTGT,0,1955179
ihfAp4,0.05555555555555555,17,17,AAGGTGCTGGAGGGCTTATA,0,1936508
ihfAp4,0.05555555555555555,17,17,AAGGAGATCTTAACAGGGCG,0,1916377
ihfAp4,0.05555555555555555,17,17,AACGATACAGGTACCTACCG,0,1917455
ihfAp4,0.05555555555555555,17,17,AAACAATTGAGCGATTAATG,0,1952021
ihfAp4,0.058823529411764705,16,16,TTGGCGGCGTCGGCCAACCA,0,1958166
ihfAp4,0.058823529411764705,16,16,TTGGATTAGATCACTTTAAC,0,1941333
ihfAp4,0.058823529411764705,16,16,TTCCCACGCACCGCAATCGA,0,1925838
ihfAp4,0.058823529411764705,16,16,TGTACGGCTATTGAAAATGT,0,1939330
ihfAp4,0.058823529411764705,16,16,TGGTCCAACCATGCTGGTTC,0,1926599
ihfAp4,0.058823529411764705,16,16,TGGGGATCCAACGCACAGCC,0,1959758
ihfAp4,0.058823529411764705,16,16,TGACGAGTTCTTTGAGAGAG,0,1939386
ihfAp4,0.058823529411764705,16,16,TCTGTCTACGCCTAGATGGT,0,1916496
ihfAp4,0.058823529411764705,16,16,TCGGACCGTAGTCACACCTG,0,1934359
ihfAp4,0.058823529411764705,16,16,TACGTAAGTTGGGATGTATC,0,1912626
ihfAp4,0.058823529411764705,16,16,TAACGGAGAGTCACATCAGT,0,1920672
ihfAp4,0.058823529411764705,16,16,GTTGGATCTGATAACCTCAC,0,1959550
ihfAp4,0.058823529411764705,16,16,GTTATCTGAGTATCAGTGAG,0,1917139
ihfAp4,0.058823529411764705,16,16,GTGCATGGATGGATACGTTA,0,1921276
ihfAp4,0.058823529411764705,16,16,GTGACCCCATTAAATGGTCA,0,1941092
ihfAp4,0.058823529411764705,16,16,GTCATCTATGGTGGAGTTTA,0,1918730
ihfAp4,0.058823529411764705,16,16,GGTATGGTCAACTTCCGAGT,0,1939041
ihfAp4,0.058823529411764705,16,16,GGTACAAGGAGTAAGGCTCA,0,1938038
ihfAp4,0.058823529411764705,16,16,GGCAGAAACCACCCACTGAA,0,1936139
ihfAp4,0.058823529411764705,16,16,GGAATAAAGCAGCCGGGTAG,0,1953530
ihfAp4,0.058823529411764705,16,16,GCTCATCTATGGTATCGGTT,0,1949488
ihfAp4,0.058823529411764705,16,16,GCGTAGTGATCAGACTGTAC,0,1950485
ihfAp4,0.058823529411764705,16,16,GCCGCGTGCGGGGCTGACAA,0,1910932
ihfAp4,0.058823529411764705,16,16,GCAGACTCCAATCGTTCATA,0,1918926
ihfAp4,0.058823529411764705,16,16,GCAACAGCGTGCTCGACCTA,0,1943161
ihfAp4,0.058823529411764705,16,16,GATCTTTGTACTATAACTGT,0,1917753
ihfAp4,0.058823529411764705,16,16,GATCAGGCTCGAGGATACAA,0,1937218
ihfAp4,0.058823529411764705,16,16,GAGATCCATCGCCTTTGGGA,0,1910987
ihfAp4,0.058823529411764705,16,16,GAGACAGCTAGTCATAGAAA,0,1929985
ihfAp4,0.058823529411764705,16,16,GACGTCTAGTCAGTTTTAAA,0,1927342
ihfAp4,0.058823529411764705,16,16,GACGGCTTATCCTTCGGGGC,0,1921275
ihfAp4,0.058823529411764705,16,16,CTCAATCGATAACCCCGGTT,0,1948469
ihfAp4,0.058823529411764705,16,16,CTAAGTGTACACATTTGCTA,0,1932648
ihfAp4,0.058823529411764705,16,16,CGGTAACCGGTCAAGCCCAA,0,1938203
ihfAp4,0.058823529411764705,16,16,CGCCACTAACGGTAGTATGT,0,1942662
ihfAp4,0.058823529411764705,16,16,CGAGTGATAGGCTATGGTGT,0,1938053
ihfAp4,0.058823529411764705,16,16,CGAGCTAGTTGTTTACGTCT,0,1927237
ihfAp4,0.058823529411764705,16,16,CGAATGGTATACTTAACAAG,0,1954390
ihfAp4,0.058823529411764705,16,16,CCGGATCTAGCGTAGTTGTC,0,1916210
ihfAp4,0.058823529411764705,16,16,CCGAACGTCTGGTCAAATTT,0,1942180
ihfAp4,0.058823529411764705,16,16,CCCATGCTAGACAGGCTTCG,0,1918124
ihfAp4,0.058823529411764705,16,16,CCCAGCACTCAACGTACGGT,0,1945887
ihfAp4,0.058823529411764705,16,16,CATGCTACTTCGACTGAATT,0,1941894
ihfAp4,0.058823529411764705,16,16,CAGTGTGTGGTTACAACTAT,0,1952244
ihfAp4,0.058823529411764705,16,16,CAGGTATAATACTTAGTTTA,0,1913978
ihfAp4,0.058823529411764705,16,16,CAGAACTAACCATACGTGAC,0,1943456
ihfAp4,0.058823529411764705,16,16,CACGGATTGTCCCGGTCCAT,0,1946964
ihfAp4,0.058823529411764705,16,16,CACGGACCTCACAGGTTGAG,0,1927569
ihfAp4,0.058823529411764705,16,16,CACCTGCTTGTACCGGCCAT,0,1921736
ihfAp4,0.058823529411764705,16,16,CAAGTACACGGAGACTCCAC,0,1938266
ihfAp4,0.058823529411764705,16,16,ATTCAATTATCCTTTCCGAC,0,1921624
ihfAp4,0.058823529411764705,16,16,ATGTCGTTTCATCATAGGTT,0,1955182
ihfAp4,0.058823529411764705,16,16,ATGCTAGAGATGATCAAGGC,0,1924016
ihfAp4,0.058823529411764705,16,16,ATGCGGAGTTTTGGGAGAAG,0,1931412
ihfAp4,0.058823529411764705,16,16,ATCTGCACTCACGGCAATCT,0,1910718
ihfAp4,0.058823529411764705,16,16,ATCCCGGCGACTATGTTCCA,0,1912410
ihfAp4,0.058823529411764705,16,16,ATATTCTGGGTATGCCTCTC,0,1912142
ihfAp4,0.058823529411764705,16,16,ATATTATGGTGAGGTCGTTG,0,1913856
ihfAp4,0.058823529411764705,16,16,ATAGTCCAACAACGTTCCAA,0,1951339
ihfAp4,0.058823529411764705,16,16,AGTGTGATGGGTACAGACAA,0,1957995
ihfAp4,0.058823529411764705,16,16,AGTATTCAGGGGTGGGTTCT,0,1949151
ihfAp4,0.058823529411764705,16,16,AGGGGGTAGGGGCTACCTGC,0,1937402
ihfAp4,0.058823529411764705,16,16,AGCCCCGTGGCTACATACCT,0,1937019
ihfAp4,0.058823529411764705,16,16,ACTGAATGTGAGTCGGGATC,0,1940816
ihfAp4,0.058823529411764705,16,16,ACTCACGGAACAGAATGGCT,0,1961001
ihfAp4,0.058823529411764705,16,16,ACGTTTAGCTATCGGTAAAG,0,1937175
ihfAp4,0.058823529411764705,16,16,ACGGTAAGCGTATCGGCTAT,0,1956240
ihfAp4,0.058823529411764705,16,16,ACGCGTGCTACACAACTCCT,0,1930492
ihfAp4,0.058823529411764705,16,16,ACCAGAAAGGTTGTAGAACA,0,1930911
ihfAp4,0.058823529411764705,16,16,ACACCGACCAGCCAGCCCGT,0,1958072
ihfAp4,0.058823529411764705,16,16,AATTCCCACTATAACCCAAG,0,1915154
ihfAp4,0.058823529411764705,16,16,AATAGCTGCCTGCCATTTAG,0,1934210
ihfAp4,0.058823529411764705,16,16,AAAGGCCCCGGGTACGGATC,0,1932644
ihfAp4,0.058823529411764705,16,16,AAAGGAGCCCTGGAAGGGTC,0,1930935
ihfAp4,0.058823529411764705,16,16,AAACGTTAAAGTTTTCCGAA,0,1931224
ihfAp4,0.058823529411764705,16,16,AAAACTATCACTCGACGGTG,0,1947638
ihfAp4,0.0625,15,15,TTTGGTACCACAGCTGACAC,0,1917604
ihfAp4,0.0625,15,15,TTGGTACGCTCACTTTGACA,0,1958181
ihfAp4,0.0625,15,15,TTCGCATTCGGCACTATGGT,0,1947945
ihfAp4,0.0625,15,15,TTCAAAGCAACTAGGCGTTA,0,1938041
ihfAp4,0.0625,15,15,TTAGGAAAACGAGTTCATGA,0,1911729
ihfAp4,0.0625,15,15,TTACAACCTGTGACGCGCTG,0,1921197
ihfAp4,0.0625,15,15,TGGGCTTTGCTGAGTTGATG,0,1951263
ihfAp4,0.0625,15,15,TGAGAATGCCACTGCCTGAT,0,1912154
ihfAp4,0.0625,15,15,TGACTATCAAGATCGGACTC,0,1939991
ihfAp4,0.0625,15,15,TGACAGGCGGGAGTTAAGGC,0,1952060
ihfAp4,0.0625,15,15,TCTTGGACATAACCAAACGT,0,1925835
ihfAp4,0.0625,15,15,TCTCGGTGACTTTGTAGCAT,0,1911074
ihfAp4,0.0625,15,15,TCGAGCTCGTAGGAGTTCGA,0,1940215
ihfAp4,0.0625,15,15,TCCCTCTAATTGAGACCGTA,0,1952589
ihfAp4,0.0625,15,15,TCCCTATTTGATGGCGGAAT,0,1934184
ihfAp4,0.0625,15,15,TCAGGCCTCTTCTTGGAATC,0,1941159
ihfAp4,0.0625,15,15,TCACTAGCTGAACAGGGGTG,0,1913984
ihfAp4,0.0625,15,15,TATGGACGGGGACGAAATGA,0,1921218
ihfAp4,0.0625,15,15,TAACTGTGGCTATTGACGCA,0,1924842
ihfAp4,0.0625,15,15,GTTTCGCGTCCTGCGTTCAG,0,1915277
ihfAp4,0.0625,15,15,GTTGATAGATGTCAAACTCA,0,1958250
ihfAp4,0.0625,15,15,GTTCCTACACATTTCGTTTT,0,1942890
ihfAp4,0.0625,15,15,GTTAGAAAGCTGATAGTTTA,0,1916880
ihfAp4,0.0625,15,15,GTGGTAAGATTTCACTCACT,0,1937031
ihfAp4,0.0625,15,15,GTGCCAATGGATTGTGGTCG,0,1911262
ihfAp4,0.0625,15,15,GTCTTCTTCGGCCAAGGCCA,0,1942979
ihfAp4,0.0625,15,15,GTCTGCAAAAATCGCTTATG,0,1925699
ihfAp4,0.0625,15,15,GTCAAAAAATCGTTAAAAAA,0,1944736
ihfAp4,0.0625,15,15,GGTGTCTTGCCAACCCGAGA,0,1921167
ihfAp4,0.0625,15,15,GGGTGCTCTTAGCAGATTTG,0,1947043
ihfAp4,0.0625,15,15,GGGTAACCCAACGACAGCCC,0,1931262
ihfAp4,0.0625,15,15,GGGGCGTTGCATACGGGTCA,0,1950421
ihfAp4,0.0625,15,15,GGGCCGGCAGCTACCCAGAA,0,1927976
ihfAp4,0.0625,15,15,GGGCATTTCCTGGTGTTCAA,0,1953081
ihfAp4,0.0625,15,15,GGGACAATTGATGGCAGTAT,0,1937234
ihfAp4,0.0625,15,15,GGCTTAGTATTTGGATTGAT,0,1958396
ihfAp4,0.0625,15,15,GGCTCGCATTCAGAATTTAT,0,1937320
ihfAp4,0.0625,15,15,GGCGTGTTACCCAAATACAG,0,1939468
ihfAp4,0.0625,15,15,GGAGTGGCCCAGCTAGGATG,0,1938940
ihfAp4,0.0625,15,15,GCGTCATTGTGCCTTACCAA,0,1942236
ihfAp4,0.0625,15,15,GCGAACGAATAGGAGCGTGA,0,1919712
ihfAp4,0.0625,15,15,GCCCGGCGGCCCTTTGCCAG,0,1941086
ihfAp4,0.0625,15,15,GCAGCGACACTATGATTGCA,0,1945525
ihfAp4,0.0625,15,15,GCAATATCGAAAGCTGGCGC,0,1921571
ihfAp4,0.0625,15,15,GAGTAAACCTGTCTTGACCA,0,1910615
ihfAp4,0.0625,15,15,GACGTGATACTTGTTCGATT,0,1943193
ihfAp4,0.0625,15,15,GACAGTCGTCCGAGTCATGG,0,1952384
ihfAp4,0.0625,15,15,GAATATAAGAATGTGCCTTC,0,1913013
ihfAp4,0.0625,15,15,GAAGGTCCACAGGACCTGGG,0,1917252
ihfAp4,0.0625,15,15,CTTAAGGCCTCTAGTCGGAG,0,1933723
ihfAp4,0.0625,15,15,CTGTGCAGATAGGCAGGAGT,0,1959898
ihfAp4,0.0625,15,15,CTGTACTGACCTGCTCCTGG,0,1949541
ihfAp4,0.0625,15,15,CTGCCAGACCCAAGTGCCCG,0,1920408
ihfAp4,0.0625,15,15,CTCCAAACATCGACGAGGAC,0,1920888
ihfAp4,0.0625,15,15,CTAAGCCTTTGGTCTGTGCA,0,1944238
ihfAp4,0.0625,15,15,CGGAGAATCGGGGATGACCA,0,1920007
ihfAp4,0.0625,15,15,CGCGTAAGGCAACCGATACG,0,1926811
ihfAp4,0.0625,15,15,CGCCGGCTAATGTTCCCTTG,0,1938324
ihfAp4,0.0625,15,15,CGCATAAGGCGAGATGGTAT,0,1948482
ihfAp4,0.0625,15,15,CGCAGGCTAGTGAATTGGGG,0,1915101
ihfAp4,0.0625,15,15,CGATAAGCGGTACGACAATA,0,1916825
ihfAp4,0.0625,15,15,CCTGTGTGTCATGCAGTTAA,0,1924706
ihfAp4,0.0625,15,15,CCTCGGCCGGACACCACCGT,0,1938411
ihfAp4,0.0625,15,15,CCGAACGGCGCGAGTACAGA,0,1923372
ihfAp4,0.0625,15,15,CCCGCTACATTGTGGGAATG,0,1953791
ihfAp4,0.0625,15,15,CCCAACGGTTCATGTAGGAA,0,1925513
ihfAp4,0.0625,15,15,CCATCCTGTACCGGAGCTAT,0,1949339
ihfAp4,0.0625,15,15,CCATACCTAGCGATAGACAA,0,1943823
ihfAp4,0.0625,15,15,CCACGGCAAAGAGGGCGCAA,0,1936058
ihfAp4,0.0625,15,15,CCAAGTCTCCTATCTGACTT,0,1915931
ihfAp4,0.0625,15,15,CATATTCTTGGCCAGCGCGA,0,1945839
ihfAp4,0.0625,15,15,CAGTGGAGTGCGCATCCACC,0,1944693
ihfAp4,0.0625,15,15,CAGGGGTGACCTGGAGGACA,0,1931636
ihfAp4,0.0625,15,15,CACATCTTCCAGTGCCTTCC,0,1917173
ihfAp4,0.0625,15,15,CAATAGTTCTATAGGAGGAT,0,1920057
ihfAp4,0.0625,15,15,CAAGGTTGATTGAAGTATGC,0,1923377
ihfAp4,0.0625,15,15,CAAACGGCAGGCGTCCTATC,0,1932269
ihfAp4,0.0625,15,15,ATTTGACCTCAATAGCCTTT,0,1934330
ihfAp4,0.0625,15,15,ATTAGCCCAGGCGTCGGTGT,0,1942478
ihfAp4,0.0625,15,15,ATGAAACAGCTACAGGTAAG,0,1925654
ihfAp4,0.0625,15,15,ATCGTGTTACACGAACCCTA,0,1941337
ihfAp4,0.0625,15,15,ATACGTGGATTCGAGTCTTC,0,1940450
ihfAp4,0.0625,15,15,AGTTTAGCGTTTAATGCTAA,0,1909804
ihfAp4,0.0625,15,15,AGGGGTCTTCGATCCTGTCA,0,1935748
ihfAp4,0.0625,15,15,AGGCTCATTAGGTTCGATTC,0,1925608
ihfAp4,0.0625,15,15,AGGATTTCGAGAATTCCTTT,0,1933671
ihfAp4,0.0625,15,15,AGAGACGTATGGATGAGACT,0,1944544
ihfAp4,0.0625,15,15,AGAATCTCCTAGGTCATACG,0,1932180
ihfAp4,0.0625,15,15,ACTTGATCGGTCAGGAGGCT,0,1926566
ihfAp4,0.0625,15,15,ACTGTGCTTCATACGTATGG,0,1939516
ihfAp4,0.0625,15,15,ACTACTCCCCACCACTTGAA,0,1919907
ihfAp4,0.0625,15,15,ACCCGGCCGGGATAATTGTG,0,1951574
ihfAp4,0.0625,15,15,ACATGAGGCTGCATGACTTT,0,1958394
ihfAp4,0.0625,15,15,AATTTCGGTTTAAGCCACCC,0,1946863
ihfAp4,0.0625,15,15,AATGGGGTCCCTTGCCCTAT,0,1924080
ihfAp4,0.0625,15,15,AATCGGTCGTATGTCCTCGT,0,1930216
ihfAp4,0.0625,15,15,AAGTGAAGATAAGCAGTCGC,0,1920411
ihfAp4,0.0625,15,15,AACGGTGTAGTTGACAAATT,0,1914191
ihfAp4,0.0625,15,15,AACGAGTAATGTGACCTGCA,0,1922033
ihfAp4,0.06666666666666667,14,14,TTTACTTTGACCTAGAGCGG,0,1935395
ihfAp4,0.06666666666666667,14,14,TTCCGTTCCTTCTAACCACC,0,1921245
ihfAp4,0.06666666666666667,14,14,TTAGCTTAGCCTAGTCTGCG,0,1911261
ihfAp4,0.06666666666666667,14,14,TGTGTATTTACCCGCATGCC,0,1918350
ihfAp4,0.06666666666666667,14,14,TGTCAGAATAGGCTTGCTTA,0,1957711
ihfAp4,0.06666666666666667,14,14,TGTATGGCACGAACATTTTG,0,1954178
ihfAp4,0.06666666666666667,14,14,TGTAGGCTTCGCGGCGGCTA,0,1943640
ihfAp4,0.06666666666666667,14,14,TGGCTGACTTAGCAACTAAT,0,1936000
ihfAp4,0.06666666666666667,14,14,TGGAGAACAGGCCTCCAACG,0,1960370
ihfAp4,0.06666666666666667,14,14,TGGACGGATTGGACAACCGA,0,1910785
ihfAp4,0.06666666666666667,14,14,TGCCACCCCGGAACCTTTAA,0,1950901
ihfAp4,0.06666666666666667,14,14,TCTTTTGAGCATCTCTTCGA,0,1936948
ihfAp4,0.06666666666666667,14,14,TCTTCTCTGACAGGAGTTAG,0,1921731
ihfAp4,0.06666666666666667,14,14,TCTTACCTCTCCCCCTGTTG,0,1947038
ihfAp4,0.06666666666666667,14,14,TCTGAATCGTTGACTCTTTG,0,1960631
ihfAp4,0.06666666666666667,14,14,TCTCTGGTTATCATCACAAA,0,1946202
ihfAp4,0.06666666666666667,14,14,TCCTCAAAGGCAGTATACCA,0,1914063
ihfAp4,0.06666666666666667,14,14,TCCGCGGACGACCGCTAATT,0,1914042
ihfAp4,0.06666666666666667,14,14,TCATGTTGGCGTTAACCAAC,0,1941708
ihfAp4,0.06666666666666667,14,14,TATTCCCTCGGGCCTATAAA,0,1946097
ihfAp4,0.06666666666666667,14,14,TATAGGAGACAGCCTTGTGA,0,1925454
ihfAp4,0.06666666666666667,14,14,TATAAACGTACGCTCTGTAG,0,1918690
ihfAp4,0.06666666666666667,14,14,TAGCGTATATATTCTCGTGT,0,1918321
ihfAp4,0.06666666666666667,14,14,TACCCACGTTGCACTCATTG,0,1950106
ihfAp4,0.06666666666666667,14,14,TAAAGGTGCTTAAACGGCGA,0,1936123
ihfAp4,0.06666666666666667,14,14,GTTGGGTTCTTTTACTTATC,0,1918241
ihfAp4,0.06666666666666667,14,14,GTTGACGGAAGTTGCTGAGA,0,1915047
ihfAp4,0.06666666666666667,14,14,GTTAAATAGGGAACTACCTC,0,1923564
ihfAp4,0.06666666666666667,14,14,GTGCCGCAGTCACTCGCAAC,0,1958619
ihfAp4,0.06666666666666667,14,14,GTGAACTGGATGTGCATTGC,0,1929053
ihfAp4,0.06666666666666667,14,14,GTGAAAGTTTGTAGTAGGCT,0,1933948
ihfAp4,0.06666666666666667,14,14,GTCCTATTCAGTCACGACTC,0,1937299
ihfAp4,0.06666666666666667,14,14,GTCCGCGTGCAGGAACGTTC,0,1925614
ihfAp4,0.06666666666666667,14,14,GTCCCCTAGAACTCGCAGCG,0,1926832
ihfAp4,0.06666666666666667,14,14,GGTGTAGATACGCATCGATC,0,1948280
ihfAp4,0.06666666666666667,14,14,GGTAAGGAATTCGCACCGAG,0,1945721
ihfAp4,0.06666666666666667,14,14,GGGCAGTTCTTTTAGGCTCC,0,1928462
ihfAp4,0.06666666666666667,14,14,GGGATGTTCCTCACATCTGC,0,1921488
ihfAp4,0.06666666666666667,14,14,GGCTACGAGACTAAGGTGGT,0,1948425
ihfAp4,0.06666666666666667,14,14,GCGTAAAGCATAACACTCAA,0,1943878
ihfAp4,0.06666666666666667,14,14,GCGCGTGATGAGGGGGAGTA,0,1913095
ihfAp4,0.06666666666666667,14,14,GCACGGGGCACAGGATTCAC,0,1960512
ihfAp4,0.06666666666666667,14,14,GCAAGTGATCAGTGGGTACT,0,1914773
ihfAp4,0.06666666666666667,14,14,GATAGATGTTGAGGCTTGCT,0,1916787
ihfAp4,0.06666666666666667,14,14,GAGGCACTAATTTTGAGTCC,0,1914741
ihfAp4,0.06666666666666667,14,14,GAATATACCGAGGTGAGATA,0,1930222
ihfAp4,0.06666666666666667,14,14,GAACGACGGCAAACCAAGAA,0,1951781
ihfAp4,0.06666666666666667,14,14,GAAAGGAATTACGGATGTTT,0,1917342
ihfAp4,0.06666666666666667,14,14,CTTGTGGAACCATGCCTAAG,0,1922067
ihfAp4,0.06666666666666667,14,14,CTTGGGCAAGGGTAGGAGAT,0,1926957
ihfAp4,0.06666666666666667,14,14,CTGTACCAACGATCCGGAAT,0,1931664
ihfAp4,0.06666666666666667,14,14,CTGGTCGTACCACGTTACGA,0,1919840
ihfAp4,0.06666666666666667,14,14,CTGGCCGATGCCAGGAAGAG,0,1961049
ihfAp4,0.06666666666666667,14,14,CTGCGGCTCTGCTCGAAGTA,0,1955739
ihfAp4,0.06666666666666667,14,14,CTGCGCCACGCGGGGCGTAC,0,1941753
ihfAp4,0.06666666666666667,14,14,CTCGTGAGGTAATTATGCCC,0,1939929
ihfAp4,0.06666666666666667,14,14,CTATCCGTCTTATAGCGGGA,0,1950067
ihfAp4,0.06666666666666667,14,14,CTAGCCGCAATTCTTCGGCG,0,1919966
ihfAp4,0.06666666666666667,14,14,CTACGCCACCTTCTAAAGGT,0,1912117
ihfAp4,0.06666666666666667,14,14,CGTTGTGTTCTAGACCGCCT,0,1943185
ihfAp4,0.06666666666666667,14,14,CGTTGTGAACCGTCAAGGCG,0,1947149
ihfAp4,0.06666666666666667,14,14,CGTTGACAGGGCCTCCAGCG,0,1931975
ihfAp4,0.06666666666666667,14,14,CGTCAATTGGTGCGCCCCGT,0,1949802
ihfAp4,0.06666666666666667,14,14,CGGGAACAACGAAGTCTGGT,0,1959530
ihfAp4,0.06666666666666667,14,14,CGGCTAGGCAGCGTTCGCGT,0,1911701
ihfAp4,0.06666666666666667,14,14,CGGCCTCATAAAAAGAGCCT,0,1951779
ihfAp4,0.06666666666666667,14,14,CGGCATTTTCATAAACGTTT,0,1953008
ihfAp4,0.06666666666666667,14,14,CGGCATTGACTGCCAGAGGT,0,1955781
ihfAp4,0.06666666666666667,14,14,CGGAGAGTTGAGTAAGTATG,0,1943647
ihfAp4,0.06666666666666667,14,14,CGCGGCTTTCTGTAACGACT,0,1921016
ihfAp4,0.06666666666666667,14,14,CGCCATATTGGTGACTCCAG,0,1956481
ihfAp4,0.06666666666666667,14,14,CGCACGAAGCGGTCACTATG,0,1943927
ihfAp4,0.06666666666666667,14,14,CGATTTAAGTGAGGATCGCT,0,1911569
ihfAp4,0.06666666666666667,14,14,CGATACTATGTTGGGTTTAC,0,1918767
ihfAp4,0.06666666666666667,14,14,CGAGGCTTTCCTATACGCAG,0,1945025
ihfAp4,0.06666666666666667,14,14,CGAGCTAGGGCGCGACGTCG,0,1949102
ihfAp4,0.06666666666666667,14,14,CGAAGGCGTGTCGCTAATGA,0,1931130
ihfAp4,0.06666666666666667,14,14,CGAACGCTGCCACCAGTATA,0,1935714
ihfAp4,0.06666666666666667,14,14,CCTGAAGCTGCGCGTTCAAG,0,1937134
ihfAp4,0.06666666666666667,14,14,CCGGACTGTTAACATCCAAG,0,1928322
ihfAp4,0.06666666666666667,14,14,CCGCTGCCCTCGTTCGGATG,0,1943929
ihfAp4,0.06666666666666667,14,14,CCCCTTTACATCGAAGAGTC,0,1910574
ihfAp4,0.06666666666666667,14,14,CCCCAGTAGAGGCCGCACTA,0,1960964
ihfAp4,0.06666666666666667,14,14,CCATTCAAGCGGTCGCCGCG,0,1936196
ihfAp4,0.06666666666666667,14,14,CCATGCTGCAGAGACGGGAG,0,1924017
ihfAp4,0.06666666666666667,14,14,CATTGCGTTTGTGTTATGTG,0,1936136
ihfAp4,0.06666666666666667,14,14,CATGCCGTGCGATCGATTAC,0,1938855
ihfAp4,0.06666666666666667,14,14,CATCATCCTGTTTGGCGGTC,0,1935968
ihfAp4,0.06666666666666667,14,14,CATAGCGCACGGCGGCACGT,0,1946478
ihfAp4,0.06666666666666667,14,14,CAGGTGGCGTATTGGAAAAT,0,1917526
ihfAp4,0.06666666666666667,14,14,CAGAGAGGGGACCTACGAGA,0,1957732
ihfAp4,0.06666666666666667,14,14,CACATAAAGGAGATCACCAA,0,1942140
ihfAp4,0.06666666666666667,14,14,CAATATACAGCCGCATTTTG,0,1943467
ihfAp4,0.06666666666666667,14,14,CAAGACGTGATGATGCTTTC,0,1951411
ihfAp4,0.06666666666666667,14,14,CAACTTCAGGATTGGAGTAA,0,1939722
ihfAp4,0.06666666666666667,14,14,ATTTTTGTAGGAAGCACAAT,0,1957647
ihfAp4,0.06666666666666667,14,14,ATTGAGCGGTCTTTGCGCTA,0,1912520
ihfAp4,0.06666666666666667,14,14,ATTCTTTACAAGGTACTCCA,0,1952477
ihfAp4,0.06666666666666667,14,14,ATTCGCAGGCATCCAGTCCG,0,1945776
ihfAp4,0.06666666666666667,14,14,ATTACCCCTGAGACGTTGCA,0,1958610
ihfAp4,0.06666666666666667,14,14,ATGTTAGTGGCCGAACCGTA,0,1921476
ihfAp4,0.06666666666666667,14,14,ATGGTTTAGGTATGCGAATC,0,1914486
ihfAp4,0.06666666666666667,14,14,ATCTATCTGGAGTACGAATA,0,1913549
ihfAp4,0.06666666666666667,14,14,ATCCGCTTTCCGCGGGCAGC,0,1945540
ihfAp4,0.06666666666666667,14,14,ATACCAGTCCACTATCTCGG,0,1933889
ihfAp4,0.06666666666666667,14,14,ATAATGCGGTGCTACCTGGT,0,1926206
ihfAp4,0.06666666666666667,14,14,ATAACCCACGAAGCGGAAGA,0,1920015
ihfAp4,0.06666666666666667,14,14,AGTGGGGAGTCGGGACGATA,0,1929898
ihfAp4,0.06666666666666667,14,14,AGGGCGACTTTGCGAACTTG,0,1941327
ihfAp4,0.06666666666666667,14,14,AGGGATATTACTTCGTGGCA,0,1939573
ihfAp4,0.06666666666666667,14,14,AGCGAGTAGAGGTTCTCGCT,0,1927218
ihfAp4,0.06666666666666667,14,14,AGCATACCGGAGCTCAGTAT,0,1935962
ihfAp4,0.06666666666666667,14,14,AGATTACCCCCCGAACGCGA,0,1958290
ihfAp4,0.06666666666666667,14,14,AGACCCGGACCACATCCATA,0,1925134
ihfAp4,0.06666666666666667,14,14,ACTGTACACTGGGATTACAC,0,1946921
ihfAp4,0.06666666666666667,14,14,ACTGCTGAAATAGAGGTAGG,0,1950063
ihfAp4,0.06666666666666667,14,14,ACTGCACGGCAGGTACGCCA,0,1958822
ihfAp4,0.06666666666666667,14,14,ACGTTCTACGTTATTCCTAA,0,1948424
ihfAp4,0.06666666666666667,14,14,ACGCTGATCCCGCGTTGCGG,0,1954506
ihfAp4,0.06666666666666667,14,14,ACGCGTGCGATCAAAGTAAG,0,1937286
ihfAp4,0.06666666666666667,14,14,ACCATCGGTTGGCCGCTGTA,0,1916178
ihfAp4,0.06666666666666667,14,14,AATGACGGGAACTGCGACTG,0,1934983
ihfAp4,0.06666666666666667,14,14,AAGTACTCCGCGTGAATATC,0,1932800
ihfAp4,0.06666666666666667,14,14,AAGCTGCGCAGCACGAGGAT,0,1932888
ihfAp4,0.07142857142857142,13,13,TTTGCCCCCCGTGCATGTTG,0,1932790
ihfAp4,0.07142857142857142,13,13,TTGTTCTGGTTAGCTATTGT,0,1931865
ihfAp4,0.07142857142857142,13,13,TTGGTGCCGGTACGCTCATA,0,1913746
ihfAp4,0.07142857142857142,13,13,TTGGTAAGGGATTAAGCTTG,0,1957693
ihfAp4,0.07142857142857142,13,13,TTCCCGGGTGCAAACTCACG,0,1910531
ihfAp4,0.07142857142857142,13,13,TTATTAGCTATCGGGACTAG,0,1910827
ihfAp4,0.07142857142857142,13,13,TGTGGAATATTCGGGACCAT,0,1925460
ihfAp4,0.07142857142857142,13,13,TGTAGCCGAGCCATTCGTTT,0,1921115
ihfAp4,0.07142857142857142,13,13,TGGTTAAAGCATTTATCGAC,0,1921203
ihfAp4,0.07142857142857142,13,13,TGGGAGCATGCACATCTCTA,0,1930504
ihfAp4,0.07142857142857142,13,13,TGGCTTTTTCAGTCTGGGTT,0,1941174
ihfAp4,0.07142857142857142,13,13,TGGCTTTCGGTCTCTCACCA,0,1947669
ihfAp4,0.07142857142857142,13,13,TGGCGGAGGGCTAGCTGTGC,0,1943403
ihfAp4,0.07142857142857142,13,13,TGCTAATCTGGGGTTTAGTT,0,1945720
ihfAp4,0.07142857142857142,13,13,TGCCCGATCTACTCTTTAGT,0,1937608
ihfAp4,0.07142857142857142,13,13,TGAGGTTCCGATCATTGGTT,0,1950744
ihfAp4,0.07142857142857142,13,13,TGAGATAGTTCTTGGGCTAG,0,1920763
ihfAp4,0.07142857142857142,13,13,TGAAAACACGTCAGACCAAA,0,1940516
ihfAp4,0.07142857142857142,13,13,TCGGATGATAGGAGCGACGA,0,1913287
ihfAp4,0.07142857142857142,13,13,TCGCACTTTTCGTGAGTTAA,0,1956264
ihfAp4,0.07142857142857142,13,13,TCCTAAGGATCTCATGTATA,0,1928794
ihfAp4,0.07142857142857142,13,13,TCCGGGCATCATAAATACCA,0,1918731
ihfAp4,0.07142857142857142,13,13,TCCAGCCGTGTTCACTCCAA,0,1917156
ihfAp4,0.07142857142857142,13,13,TCAGCTTGCCGATGTGCCTG,0,1924207
ihfAp4,0.07142857142857142,13,13,TATTTAAATGCGCTTAGCCG,0,1934189
ihfAp4,0.07142857142857142,13,13,TATTCATCGTGCCACGCCGA,0,1914125
ihfAp4,0.07142857142857142,13,13,TACGCGTTAATTGTTCCGGA,0,1948886
ihfAp4,0.07142857142857142,13,13,GTTTAGGGATATAGAGAAAA,0,1921198
ihfAp4,0.07142857142857142,13,13,GTTCGCAGGATTTGTTGGCT,0,1950555
ihfAp4,0.07142857142857142,13,13,GTGTTCAGGACTTCCCCGTA,0,1911853
ihfAp4,0.07142857142857142,13,13,GTGGGTAATTTAGTTTCGAC,0,1959422
ihfAp4,0.07142857142857142,13,13,GTGCCGCGGAGTTTCTTCGA,0,1941274
ihfAp4,0.07142857142857142,13,13,GTGATTCAGACGCAGCTGGT,0,1915680
ihfAp4,0.07142857142857142,13,13,GTCGCGATATATTCCCTGGT,0,1920162
ihfAp4,0.07142857142857142,13,13,GTCCTTGGGGTGGTCAGATT,0,1913514
ihfAp4,0.07142857142857142,13,13,GTATTAATATGAGGTCGAAG,0,1954310
ihfAp4,0.07142857142857142,13,13,GTACGCTATGGAAACGGGTC,0,1955950
ihfAp4,0.07142857142857142,13,13,GGTGTATCGCTGAGGGCAAC,0,1951175
ihfAp4,0.07142857142857142,13,13,GGTGCACTACGAACGCGGAC,0,1936597
ihfAp4,0.07142857142857142,13,13,GGTGCACATGTGTTTGTAAG,0,1946692
ihfAp4,0.07142857142857142,13,13,GGTCTGTCCGCAAAGGGTTG,0,1957990
ihfAp4,0.07142857142857142,13,13,GGTCTATAGGATGTCGGACA,0,1933668
ihfAp4,0.07142857142857142,13,13,GGTCTAACGTCATCTGGATG,0,1939823
ihfAp4,0.07142857142857142,13,13,GGTAGTAGAGGGGTAGTTAA,0,1931557
ihfAp4,0.07142857142857142,13,13,GGCGCTAAAACTCGGAAGCG,0,1930612
ihfAp4,0.07142857142857142,13,13,GGACCACTATGCAATCTCTT,0,1943449
ihfAp4,0.07142857142857142,13,13,GGACAGATTATAGCCCAGGA,0,1942908
ihfAp4,0.07142857142857142,13,13,GCTTTTACGCCGCAAGAAAG,0,1937859
ihfAp4,0.07142857142857142,13,13,GCTTACTCCTTTCCCGAAGC,0,1915044
ihfAp4,0.07142857142857142,13,13,GCTGTAGCTTCGTCCTGTAA,0,1930586
ihfAp4,0.07142857142857142,13,13,GCTCGTGAGGGGGGTCAGGT,0,1951669
ihfAp4,0.07142857142857142,13,13,GCGATGCCAGCCGGTTATAC,0,1952178
ihfAp4,0.07142857142857142,13,13,GCCTTTGACACCCGGTACCA,0,1929998
ihfAp4,0.07142857142857142,13,13,GCCTCACCCTTAATGACGAT,0,1916285
ihfAp4,0.07142857142857142,13,13,GCCGTGCGATTGATGCCGAT,0,1919515
ihfAp4,0.07142857142857142,13,13,GCCCTTGGGTATCAGCCCCA,0,1911455
ihfAp4,0.07142857142857142,13,13,GCCAGAGGCACTTCTCGTTA,0,1947723
ihfAp4,0.07142857142857142,13,13,GCATACCCCTAAAGTTTAAG,0,1931260
ihfAp4,0.07142857142857142,13,13,GCACTGCACTTCAACCTTCG,0,1931375
ihfAp4,0.07142857142857142,13,13,GATGATCTGGCCGGAAAAGT,0,1952323
ihfAp4,0.07142857142857142,13,13,GAGTCCGTGGACAACATATA,0,1955216
ihfAp4,0.07142857142857142,13,13,GAGATATCCTAATAGGCGGT,0,1939288
ihfAp4,0.07142857142857142,13,13,GAGAGTTACCCGTGGAGGTC,0,1939430
ihfAp4,0.07142857142857142,13,13,GACTAAGAGCTCCTTTGATA,0,1928017
ihfAp4,0.07142857142857142,13,13,GAATTTTTTCGAGACACCTG,0,1955514
ihfAp4,0.07142857142857142,13,13,GAAGTCAGACCCGGGCAAGC,0,1955977
ihfAp4,0.07142857142857142,13,13,GAACACGGAGGCGATATGAC,0,1947200
ihfAp4,0.07142857142857142,13,13,CTTAGATATGCGACCAATTA,0,1950605
ihfAp4,0.07142857142857142,13,13,CTGTGCCGGAAATGAACCCA,0,1931659
ihfAp4,0.07142857142857142,13,13,CTGGTTAGCATCGCATATTA,0,1961830
ihfAp4,0.07142857142857142,13,13,CTGCGCCGGACTGAGCCCTT,0,1944117
ihfAp4,0.07142857142857142,13,13,CTGACGAGGGTAACTGTAAT,0,1948309
ihfAp4,0.07142857142857142,13,13,CTGAAACAAAGGCCTGTCGC,0,1938429
ihfAp4,0.07142857142857142,13,13,CTCTTCGCTAACTTGTTCTG,0,1939522
ihfAp4,0.07142857142857142,13,13,CTCGGAACCGAATAGGGCGC,0,1935958
ihfAp4,0.07142857142857142,13,13,CTCATTTAGCTTTGATCGAA,0,1952230
ihfAp4,0.07142857142857142,13,13,CTATTGAGGTTGAATCTCGT,0,1960717
ihfAp4,0.07142857142857142,13,13,CTATGCGAGTCTCCGGAAGG,0,1931242
ihfAp4,0.07142857142857142,13,13,CTATCGCTAGAACTCGAAGA,0,1952220
ihfAp4,0.07142857142857142,13,13,CTACAATTGACTCGTGAACT,0,1936185
ihfAp4,0.07142857142857142,13,13,CTAACAGCTTAGTCAGCCGT,0,1909702
ihfAp4,0.07142857142857142,13,13,CGTCGCTTCACCATTTGGGG,0,1916954
ihfAp4,0.07142857142857142,13,13,CGTAACCTCTAAATGCAGAT,0,1912867
ihfAp4,0.07142857142857142,13,13,CGGTTGGTTAACCCGTGTTG,0,1940017
ihfAp4,0.07142857142857142,13,13,CGGTCCTATCATGATGGCCT,0,1953641
ihfAp4,0.07142857142857142,13,13,CGGGTGGGGGCACCCGGAGT,0,1953448
ihfAp4,0.07142857142857142,13,13,CGCGGGAACCGGCTAGAATG,0,1926655
ihfAp4,0.07142857142857142,13,13,CGCCTCGGATTTACGAGCGT,0,1913050
ihfAp4,0.07142857142857142,13,13,CGCAGGCAGCGTGACCGTTT,0,1929447
ihfAp4,0.07142857142857142,13,13,CGATTTCACAGCGGGAACTA,0,1930580
ihfAp4,0.07142857142857142,13,13,CGACAGCACTCGCCCAAAAA,0,1949913
ihfAp4,0.07142857142857142,13,13,CCGCGTTGTAAATACCAAAG,0,1946860
ihfAp4,0.07142857142857142,13,13,CCCGCGGTCGGCTCAAGACA,0,1957482
ihfAp4,0.07142857142857142,13,13,CCACGGTGTTCTTACTTGCA,0,1917606
ihfAp4,0.07142857142857142,13,13,CATCGGTGCCCTCGAGTTCT,0,1919861
ihfAp4,0.07142857142857142,13,13,CATATTTAAGGCTGCACCAC,0,1943190
ihfAp4,0.07142857142857142,13,13,CATATACGCTTTCCTCTATA,0,1917571
ihfAp4,0.07142857142857142,13,13,CATAGTCCTGTCATAAATGC,0,1926497
ihfAp4,0.07142857142857142,13,13,CAGTGTTTTGGGGCATGCGG,0,1935375
ihfAp4,0.07142857142857142,13,13,CAGGCAGGGATTAATACGGG,0,1936021
ihfAp4,0.07142857142857142,13,13,CAGCGGTCTCTTAGAAATGC,0,1936585
ihfAp4,0.07142857142857142,13,13,CAGCGAAATAAGGGAAAGTC,0,1959756
ihfAp4,0.07142857142857142,13,13,CAGATTGAGAATGTTCTGCG,0,1937576
ihfAp4,0.07142857142857142,13,13,CACTGCGTAGTAGACGATGA,0,1913195
ihfAp4,0.07142857142857142,13,13,CACTACAGGCCTCGTCCTCG,0,1931750
ihfAp4,0.07142857142857142,13,13,CACCTTCTAGACAGTGATGA,0,1943691
ihfAp4,0.07142857142857142,13,13,CACACGGTTGTGATAGTGGC,0,1938785
ihfAp4,0.07142857142857142,13,13,CAATAAGGTTAATTTCATGA,0,1917402
ihfAp4,0.07142857142857142,13,13,ATTGTGAGCTTCGGAAAGCT,0,1940585
ihfAp4,0.07142857142857142,13,13,ATTGAATCGTGTGGACATCT,0,1949764
ihfAp4,0.07142857142857142,13,13,ATGTTAACACGTATAGTAAG,0,1928795
ihfAp4,0.07142857142857142,13,13,ATGGTAGAGTTGCTATTCGG,0,1923959
ihfAp4,0.07142857142857142,13,13,ATGCCATAATCTAATCAGAT,0,1931892
ihfAp4,0.07142857142857142,13,13,ATGCAGGGATGCGCATATCA,0,1938949
ihfAp4,0.07142857142857142,13,13,ATCGGAGGCCCAAGCGCGGG,0,1927080
ihfAp4,0.07142857142857142,13,13,ATATTATCATAACGACTTGA,0,1960897
ihfAp4,0.07142857142857142,13,13,ATAGGTAACCAGATGAACCA,0,1928433
ihfAp4,0.07142857142857142,13,13,ATACCCTTCCGCTCTTCGAC,0,1949100
ihfAp4,0.07142857142857142,13,13,AGTGGGATGGTAACGATCGT,0,1934001
ihfAp4,0.07142857142857142,13,13,AGTGATGTTTATCTTTGTCA,0,1944059
ihfAp4,0.07142857142857142,13,13,AGGTTCAAACTGTTTTCCGT,0,1949043
ihfAp4,0.07142857142857142,13,13,AGGTCCAGGTTGTTAAGTAG,0,1926601
ihfAp4,0.07142857142857142,13,13,AGGTAAGTTAGAGGCATGCT,0,1946100
ihfAp4,0.07142857142857142,13,13,AGGAGTAGGCCTCTGTCTGA,0,1930454
ihfAp4,0.07142857142857142,13,13,AGCTGCAATTACATCCTAAC,0,1924939
ihfAp4,0.07142857142857142,13,13,AGCTACGGCTCATCACGTCA,0,1954913
ihfAp4,0.07142857142857142,13,13,ACGGCTACTTGGCCTTGTGC,0,1947668
ihfAp4,0.07142857142857142,13,13,ACGCTATAGACCCTTTGTAC,0,1930991
ihfAp4,0.07142857142857142,13,13,ACGCGCTCACTCCGGATAAG,0,1929067
ihfAp4,0.07142857142857142,13,13,ACCGGAACGTGTATGCATTG,0,1918365
ihfAp4,0.07142857142857142,13,13,ACATTGCTTCGATGCTGTTC,0,1913399
ihfAp4,0.07142857142857142,13,13,ACACTGCGGATATCTGACCA,0,1932944
ihfAp4,0.07142857142857142,13,13,AATGGTTTTAAACATCAACC,0,1946313
ihfAp4,0.07142857142857142,13,13,AATGGAATAATAGCTCAGGT,0,1921968
ihfAp4,0.07142857142857142,13,13,AATATGCGCCAGGTCTGCTG,0,1942429
ihfAp4,0.07142857142857142,13,13,AAGAGGATCAAGCTGCGTTC,0,1961245
ihfAp4,0.07142857142857142,13,13,AACTCGACTGGCGGCTCAGC,0,1957609
ihfAp4,0.07142857142857142,13,13,AACCTTGCTACCATAGATTC,0,1920670
ihfAp4,0.07142857142857142,13,13,AAATATAGGCTACTTAGAGT,0,1931752
ihfAp4,0.07142857142857142,13,13,AAAGTTGTATAAAGAAGTGG,0,1929148
ihfAp4,0.07142857142857142,13,13,AAAACTCACAGACGTCCTGT,0,1940434
ihfAp4,0.07692307692307693,12,12,TTCTTATCCACATTGTAGGT,0,1934977
ihfAp4,0.07692307692307693,12,12,TTCTAAGAGAGGGGGCACTA,0,1929040
ihfAp4,0.07692307692307693,12,12,TTCGTTGATACGAATTGGGT,0,1920466
ihfAp4,0.07692307692307693,12,12,TTCGCTGTAGACCAGCAATA,0,1928206
ihfAp4,0.07692307692307693,12,12,TTCACGGTGGAGGAGCCGGC,0,1936015
ihfAp4,0.07692307692307693,12,12,TTCACCTGATCTTATCTGTA,0,1926175
ihfAp4,0.07692307692307693,12,12,TTAGTGTGGGATAGGGAAAA,0,1937346
ihfAp4,0.07692307692307693,12,12,TTAGTATTCTCGTCACTCTG,0,1941607
ihfAp4,0.07692307692307693,12,12,TTACTGCCCTGATGTTATGG,0,1915528
ihfAp4,0.07692307692307693,12,12,TTACGTCATTTAAGGCGTAA,0,1922760
ihfAp4,0.07692307692307693,12,12,TTACCGAGATACGTGTGGCA,0,1919337
ihfAp4,0.07692307692307693,12,12,TGTGTACAAGGTCCAGTTAA,0,1951039
ihfAp4,0.07692307692307693,12,12,TGTCTACACGTCAGTTCTGA,0,1931231
ihfAp4,0.07692307692307693,12,12,TGTCCTGTGTGTTCACAGTG,0,1929704
ihfAp4,0.07692307692307693,12,12,TGGCTAATACGTTGATGGAC,0,1939849
ihfAp4,0.07692307692307693,12,12,TGGATGTATACGGAACAGTC,0,1951915
ihfAp4,0.07692307692307693,12,12,TGCCATACAGGTGGTCTACA,0,1938945
ihfAp4,0.07692307692307693,12,12,TGCATCGTCCACCAAAGGTT,0,1940474
ihfAp4,0.07692307692307693,12,12,TGATGGCATTAAGATTGAAA,0,1956157
ihfAp4,0.07692307692307693,12,12,TGATCTCATGTTTCACAGGC,0,1950955
ihfAp4,0.07692307692307693,12,12,TGATCGCCTGTGGCGATTAT,0,1911109
ihfAp4,0.07692307692307693,12,12,TGACCAGGGGTCCCGCGTGC,0,1944273
ihfAp4,0.07692307692307693,12,12,TGAAACCTTAGGTAAATGTG,0,1932605
ihfAp4,0.07692307692307693,12,12,TCTGTTATTTCTAAAGATCA,0,1919904
ihfAp4,0.07692307692307693,12,12,TCTGCGTATGACGAGAAAGT,0,1933777
ihfAp4,0.07692307692307693,12,12,TCTAGTTATGTTTAGGCGAA,0,1945977
ihfAp4,0.07692307692307693,12,12,TCGTCAAGATCGTATCGTCA,0,1960882
ihfAp4,0.07692307692307693,12,12,TCGTATCTCTGACGATTTTA,0,1930775
ihfAp4,0.07692307692307693,12,12,TCGGCGTATTATGTCCTAGA,0,1914796
ihfAp4,0.07692307692307693,12,12,TCCCGACGGTCGCGGAAAAC,0,1944306
ihfAp4,0.07692307692307693,12,12,TCCATGCTACTGGTTGCGGG,0,1961752
ihfAp4,0.07692307692307693,12,12,TCAGATGACGCATGCGAGGG,0,1911556
ihfAp4,0.07692307692307693,12,12,TATGCAATGTCATAAACATG,0,1952637
ihfAp4,0.07692307692307693,12,12,TATATTCGACGAGTTACTGG,0,1916882
ihfAp4,0.07692307692307693,12,12,TATAAACTACTATAGGGAAG,0,1950333
ihfAp4,0.07692307692307693,12,12,TAGGACCTAATCATTGGTGA,0,1945819
ihfAp4,0.07692307692307693,12,12,TACTAAACCCGTTAATGCTC,0,1934790
ihfAp4,0.07692307692307693,12,12,TACGCAGTACTTACGGACTT,0,1946443
ihfAp4,0.07692307692307693,12,12,TACCCTCACTTGGAACGCAT,0,1921978
ihfAp4,0.07692307692307693,12,12,TACAGCACAAAACCTGAGTG,0,1950303
ihfAp4,0.07692307692307693,12,12,TACAAAGCTCGGCCATCAGG,0,1931648
ihfAp4,0.07692307692307693,12,12,TAATATGATTGGGAATTCGT,0,1947165
ihfAp4,0.07692307692307693,12,12,TAAGGGCTCGCAAGATCACC,0,1931238
ihfAp4,0.07692307692307693,12,12,TAAGCGTGCAAAGCCATGCA,0,1941831
ihfAp4,0.07692307692307693,12,12,TAACAGCTGCGTATGCTATG,0,1930861
ihfAp4,0.07692307692307693,12,12,TAACAGAAAACTTGCGTTGG,0,1934968
ihfAp4,0.07692307692307693,12,12,TAAAAAGAGTCATATTGACA,0,1952736
ihfAp4,0.07692307692307693,12,12,GTTGTAGTGAAATACGTCAT,0,1939372
ihfAp4,0.07692307692307693,12,12,GTTGTAGCGTTTATCATCAG,0,1917374
ihfAp4,0.07692307692307693,12,12,GTTCTGTTTCTTACACGGGC,0,1953565
ihfAp4,0.07692307692307693,12,12,GTGGCGGTCCGGCGAAACAC,0,1927595
ihfAp4,0.07692307692307693,12,12,GTCGCCAAAAGTCGCCAACG,0,1917806
ihfAp4,0.07692307692307693,12,12,GTCCTAATAACGAAGATGAG,0,1926664
ihfAp4,0.07692307692307693,12,12,GTATGAACCTACTCGCTGGT,0,1923215
ihfAp4,0.07692307692307693,12,12,GTAGACAGTTGTCATCGATA,0,1954748
ihfAp4,0.07692307692307693,12,12,GTACGACGTCCCTTATTGCG,0,1952950
ihfAp4,0.07692307692307693,12,12,GTAAATCTACCCTGGGGCGT,0,1925265
ihfAp4,0.07692307692307693,12,12,GGTTTGTTGTGCGTATGGTT,0,1934459
ihfAp4,0.07692307692307693,12,12,GGTGTAACCGGGTTTCTGAC,0,1956262
ihfAp4,0.07692307692307693,12,12,GGTAAACCCGACAATTGGAG,0,1946256
ihfAp4,0.07692307692307693,12,12,GGGAAAGGCGGCCGAGTTAT,0,1923044
ihfAp4,0.07692307692307693,12,12,GGCCAGGTTGTTCGCTTACA,0,1943148
ihfAp4,0.07692307692307693,12,12,GGCCAGCAACACACGGCTTG,0,1951575
ihfAp4,0.07692307692307693,12,12,GGCATGGGTGGGCGCGTTCA,0,1936288
ihfAp4,0.07692307692307693,12,12,GGCAGACGCATTCTTCGCAT,0,1909862
ihfAp4,0.07692307692307693,12,12,GGCACTCGGATATGCATATG,0,1946943
ihfAp4,0.07692307692307693,12,12,GGAGCAGGACGTAGGGTCAT,0,1913858
ihfAp4,0.07692307692307693,12,12,GGAAAAAAACTGATTTACCA,0,1937219
ihfAp4,0.07692307692307693,12,12,GCTTCAGGCTAGATATTTGA,0,1950300
ihfAp4,0.07692307692307693,12,12,GCTGATCATTGACGTACCAG,0,1932997
ihfAp4,0.07692307692307693,12,12,GCTCGACGCGCCCATAGCAT,0,1942778
ihfAp4,0.07692307692307693,12,12,GCTAGCTCATAATTATGCGT,0,1939126
ihfAp4,0.07692307692307693,12,12,GCGGTTGCGGCACCTCCGAT,0,1925459
ihfAp4,0.07692307692307693,12,12,GCGGACTGTTACACATGACG,0,1920825
ihfAp4,0.07692307692307693,12,12,GCGCATTGGTGGGACGCGGA,0,1950348
ihfAp4,0.07692307692307693,12,12,GCCGGGGCGGCTTAAGCGCT,0,1933257
ihfAp4,0.07692307692307693,12,12,GCCGGCTCGGGTCCTCTAGG,0,1945740
ihfAp4,0.07692307692307693,12,12,GCACACGTATCCACTCCTGA,0,1936591
ihfAp4,0.07692307692307693,12,12,GCAAGGAGTTGCCGTGCATT,0,1915534
ihfAp4,0.07692307692307693,12,12,GATGCATACACGGCCCTATA,0,1930218
ihfAp4,0.07692307692307693,12,12,GAGCTCTTGGCCGCTCTTCC,0,1949401
ihfAp4,0.07692307692307693,12,12,GACGGCCGCTTGGTAGCGTC,0,1919513
ihfAp4,0.07692307692307693,12,12,GACGCAGAAGAGGGCGAATG,0,1958255
ihfAp4,0.07692307692307693,12,12,GACATTCTTTTACGAATGGT,0,1945174
ihfAp4,0.07692307692307693,12,12,GAACCGACCTAAGGACTTAG,0,1932404
ihfAp4,0.07692307692307693,12,12,CTTTCTTCTTGACGACTGAT,0,1949003
ihfAp4,0.07692307692307693,12,12,CTTGGGATGCCTAACTCTAG,0,1925207
ihfAp4,0.07692307692307693,12,12,CTGGTTTATAAGGACTGGGG,0,1914292
ihfAp4,0.07692307692307693,12,12,CTGGTGTTAGGTACGCTGAC,0,1953120
ihfAp4,0.07692307692307693,12,12,CTGGTGGTACACGGTAGGAC,0,1918641
ihfAp4,0.07692307692307693,12,12,CTGACCTTTAAAGGACCACA,0,1939866
ihfAp4,0.07692307692307693,12,12,CTCGAGGTACGCGGTGAGCA,0,1923966
ihfAp4,0.07692307692307693,12,12,CTCCCAGGACCTTAGAGTAC,0,1925620
ihfAp4,0.07692307692307693,12,12,CTAGGGGATAGTTCCTTCGA,0,1920719
ihfAp4,0.07692307692307693,12,12,CTACTAATACTGGTCTCGTT,0,1949415
ihfAp4,0.07692307692307693,12,12,CTACGAGTGCACAGAAGCGA,0,1953622
ihfAp4,0.07692307692307693,12,12,CTACATCGTCTAACATGATC,0,1958242
ihfAp4,0.07692307692307693,12,12,CGTGTGACCTCGTTATCGTT,0,1949773
ihfAp4,0.07692307692307693,12,12,CGTCACGACGTTGGTGAGAA,0,1915979
ihfAp4,0.07692307692307693,12,12,CGTACGCATAGCCCACCCAG,0,1917805
ihfAp4,0.07692307692307693,12,12,CGTAAGTTTGATAAGGGCTA,0,1922687
ihfAp4,0.07692307692307693,12,12,CGGGGTTGGGGTGCTATCGG,0,1946516
ihfAp4,0.07692307692307693,12,12,CGGATCGCCTCGGCATTGAG,0,1921443
ihfAp4,0.07692307692307693,12,12,CGGACGGCTAGTCCTGGGCA,0,1920679
ihfAp4,0.07692307692307693,12,12,CGATGGAGGATCTTCCTTCG,0,1913100
ihfAp4,0.07692307692307693,12,12,CGAGAATGCTAAAGGACACG,0,1945066
ihfAp4,0.07692307692307693,12,12,CGAATCGCCCACCACAGACA,0,1957796
ihfAp4,0.07692307692307693,12,12,CCTGTTCACACCCTTCCATA,0,1951849
ihfAp4,0.07692307692307693,12,12,CCTGGATGTACTATAATATG,0,1910809
ihfAp4,0.07692307692307693,12,12,CCTGGATACTGTCCCGGTTT,0,1928788
ihfAp4,0.07692307692307693,12,12,CCTCTTAGCACAAGGCTTGA,0,1959950
ihfAp4,0.07692307692307693,12,12,CCTCGTTCAGTAGGGTCATG,0,1937913
ihfAp4,0.07692307692307693,12,12,CCTCCTGGATTCAAAGGTAA,0,1961409
ihfAp4,0.07692307692307693,12,12,CCTATGAACCTGGACCTGAT,0,1916971
ihfAp4,0.07692307692307693,12,12,CCGTATGAGTTCCTTAGTTT,0,1916996
ihfAp4,0.07692307692307693,12,12,CCGGGGTCCACAGATCTCGC,0,1922467
ihfAp4,0.07692307692307693,12,12,CCGCGTCACAATAATGCTCA,0,1945504
ihfAp4,0.07692307692307693,12,12,CCGCATCATGGGAAACCCCA,0,1960338
ihfAp4,0.07692307692307693,12,12,CCGACGAAAAGGAGCTTAGG,0,1936341
ihfAp4,0.07692307692307693,12,12,CCCGGACCTAGATGCTCCGC,0,1924906
ihfAp4,0.07692307692307693,12,12,CCCCCATGTGGACGAGCTCG,0,1930609
ihfAp4,0.07692307692307693,12,12,CCCAGTGCAGTATATGGTCT,0,1958222
ihfAp4,0.07692307692307693,12,12,CCAGGATCCCCCTACGCCAT,0,1958378
ihfAp4,0.07692307692307693,12,12,CATGCGATGCATTCTGATTG,0,1927112
ihfAp4,0.07692307692307693,12,12,CATCGACCTTATACTGATCT,0,1922890
ihfAp4,0.07692307692307693,12,12,CATAATGCGATTTCGTGTCA,0,1912754
ihfAp4,0.07692307692307693,12,12,CAGCTTGGTTAAACTTAGGC,0,1923108
ihfAp4,0.07692307692307693,12,12,CAGCCCAAAAAAACCTCTGT,0,1911207
ihfAp4,0.07692307692307693,12,12,CACGCGCGGTATTTGGTAGA,0,1925798
ihfAp4,0.07692307692307693,12,12,CACGACCGTACTCGACTAAA,0,1917263
ihfAp4,0.07692307692307693,12,12,CACCACTAGGTACTAATATC,0,1947300
ihfAp4,0.07692307692307693,12,12,CACAGGGCATACCACTTCAG,0,1913121
ihfAp4,0.07692307692307693,12,12,CACAAGCCACCGGCCTCTGA,0,1930260
ihfAp4,0.07692307692307693,12,12,CAATTCTCTGAGCGCCGGCA,0,1960503
ihfAp4,0.07692307692307693,12,12,CAATCCTGAGGACTGGAGAA,0,1946607
ihfAp4,0.07692307692307693,12,12,CAAGCTGCACAAGGGCTTAG,0,1961904
ihfAp4,0.07692307692307693,12,12,CAAAAAATGTATCGATTGTA,0,1912286
ihfAp4,0.07692307692307693,12,12,ATTTCTAGAAACGGCTCGAT,0,1921821
ihfAp4,0.07692307692307693,12,12,ATTTAGAGTACCTGCCCCTA,0,1928083
ihfAp4,0.07692307692307693,12,12,ATTGCGTGACGGGCGGACAA,0,1920370
ihfAp4,0.07692307692307693,12,12,ATTGCGATCAGGTACCTTGC,0,1951560
ihfAp4,0.07692307692307693,12,12,ATTGATCCGGTTGCGGGAAT,0,1939441
ihfAp4,0.07692307692307693,12,12,ATGGGTTAGGGATAGTGGTT,0,1911814
ihfAp4,0.07692307692307693,12,12,ATGATCGTGAGCGGGTCCTG,0,1926999
ihfAp4,0.07692307692307693,12,12,ATCTTAGTCCAGGACGGCAT,0,1935890
ihfAp4,0.07692307692307693,12,12,ATCGTAAGGCGTAAACTTGA,0,1956807
ihfAp4,0.07692307692307693,12,12,ATCGCGCCGGCGTGGCTCCC,0,1909969
ihfAp4,0.07692307692307693,12,12,ATATACGTCAGTTCGTTCCA,0,1926009
ihfAp4,0.07692307692307693,12,12,AGTTTGTTCACATTCTGTAG,0,1939711
ihfAp4,0.07692307692307693,12,12,AGTGCCTGATAAATGTCAAG,0,1937403
ihfAp4,0.07692307692307693,12,12,AGTATATAGGACTACGATAG,0,1959498
ihfAp4,0.07692307692307693,12,12,AGGGAGGATCTTGTGTTCAA,0,1939256
ihfAp4,0.07692307692307693,12,12,AGGAGTCCTCGGTAGGGTTT,0,1926868
ihfAp4,0.07692307692307693,12,12,AGGAGCCAAGCTATCGCTTG,0,1952934
ihfAp4,0.07692307692307693,12,12,AGGACCTCACGCGGTCCAGT,0,1958085
ihfAp4,0.07692307692307693,12,12,AGGACATTTTATCTATCAGT,0,1918807
ihfAp4,0.07692307692307693,12,12,AGGACACTTTCGGTGACCAT,0,1920381
ihfAp4,0.07692307692307693,12,12,AGGAATTAGTGGAAAATTCG,0,1961327
ihfAp4,0.07692307692307693,12,12,AGGAATTAATTAGGGGATAC,0,1958744
ihfAp4,0.07692307692307693,12,12,AGCTGCCATCGGGACTCTCG,0,1949214
ihfAp4,0.07692307692307693,12,12,AGCAGATATGGAGGTAGCAT,0,1951403
ihfAp4,0.07692307692307693,12,12,ACTTGCCACGCCTCAGTAGC,0,1935106
ihfAp4,0.07692307692307693,12,12,ACTCGCGCCTTATCTGTTGT,0,1931655
ihfAp4,0.07692307692307693,12,12,ACGTGACTGTCGAAACGCCA,0,1942504
ihfAp4,0.07692307692307693,12,12,ACGTCTCTCGTCGTCATGGT,0,1956920
ihfAp4,0.07692307692307693,12,12,ACGGACTGGGCACCTAAGCA,0,1921600
ihfAp4,0.07692307692307693,12,12,ACGCGAAGATTCCCTTCCTG,0,1956213
ihfAp4,0.07692307692307693,12,12,ACGACGCCTCAGCTACATGG,0,1958612
ihfAp4,0.07692307692307693,12,12,ACCCGAATGGATTAGTTAAT,0,1938856
ihfAp4,0.07692307692307693,12,12,ACATGTCAAGGATTTTCTAC,0,1919706
ihfAp4,0.07692307692307693,12,12,ACAGGTGTTGATATGACTCA,0,1946000
ihfAp4,0.07692307692307693,12,12,ACAACACGAAGCGCTGGCGC,0,1922326
ihfAp4,0.07692307692307693,12,12,AATTACGATAAGGCGTTACA,0,1955729
ihfAp4,0.07692307692307693,12,12,AATGGGCTATATCCCGAGAT,0,1946733
ihfAp4,0.07692307692307693,12,12,AATGCCTTAGTACCGAACTG,0,1927802
ihfAp4,0.07692307692307693,12,12,AATCGTGGCGCAGTAGCTCA,0,1919122
ihfAp4,0.07692307692307693,12,12,AAGTAAGCAAGCCGGCATCC,0,1919369
ihfAp4,0.07692307692307693,12,12,AAGGATGTAGTTGCATTTTG,0,1923649
ihfAp4,0.07692307692307693,12,12,AAGCCCCGGTGCGTAACGGT,0,1960968
ihfAp4,0.07692307692307693,12,12,AAAGCTGCTTCCCTGTGCCT,0,1946655
ihfAp4,0.07692307692307693,12,12,AAACGTTCACCCTGAACAGT,0,1940869
ihfAp4,0.08333333333333333,11,11,TTTGTGAAGTATCGCCGGTG,0,1942895
ihfAp4,0.08333333333333333,11,11,TTTGGGCTTGTGTGCAATCA,0,1952171
ihfAp4,0.08333333333333333,11,11,TTTGACGGGCTCTGGTGCGC,0,1913995
ihfAp4,0.08333333333333333,11,11,TTTCGAGTCGGATTATTTCT,0,1952923
ihfAp4,0.08333333333333333,11,11,TTCAAGCAGCCAGATTACTA,0,1914774
ihfAp4,0.08333333333333333,11,11,TTAGCCATAGTTGTAGGAGC,0,1931845
ihfAp4,0.08333333333333333,11,11,TTACGCCATGACCTTGGTGT,0,1923368
ihfAp4,0.08333333333333333,11,11,TTACATCTAAAGATTAGCCC,0,1914719
ihfAp4,0.08333333333333333,11,11,TGTTAAATTGGCGAACCGTG,0,1930339
ihfAp4,0.08333333333333333,11,11,TGTGGTGTCAGACGGCACTT,0,1914510
ihfAp4,0.08333333333333333,11,11,TGTGATTACGTTTCGCGTTG,0,1919260
ihfAp4,0.08333333333333333,11,11,TGTCAAGGAATAGCGTTCAA,0,1925662
ihfAp4,0.08333333333333333,11,11,TGGTTTACTTACTACGAAGC,0,1937704
ihfAp4,0.08333333333333333,11,11,TGGTGATTGTACACGCGATT,0,1961081
ihfAp4,0.08333333333333333,11,11,TGGTACGCGGCGGCCTGCTA,0,1920791
ihfAp4,0.08333333333333333,11,11,TGGGGGATTCTAATGGCTTC,0,1961111
ihfAp4,0.08333333333333333,11,11,TGGGAATCGTCATTGTTAAG,0,1919125
ihfAp4,0.08333333333333333,11,11,TGGCCTCTCGATCGAGGAAT,0,1920072
ihfAp4,0.08333333333333333,11,11,TGCGTCGTATCACATAGAGC,0,1920846
ihfAp4,0.08333333333333333,11,11,TGAATATATCTATGCTAACT,0,1926573
ihfAp4,0.08333333333333333,11,11,TGAACGAAAAAACCGCGGGG,0,1952587
ihfAp4,0.08333333333333333,11,11,TCTACGGAATACTCATACAC,0,1960334
ihfAp4,0.08333333333333333,11,11,TCTACCGGCAGAATCCGAAT,0,1920854
ihfAp4,0.08333333333333333,11,11,TCGAACAGATAAGTCTGAGT,0,1921362
ihfAp4,0.08333333333333333,11,11,TCCTTTTCGTCATTTTCTTC,0,1924150
ihfAp4,0.08333333333333333,11,11,TCCCTGCACTGACAAGGGCT,0,1949544
ihfAp4,0.08333333333333333,11,11,TCCCGCTTCGGCAATTGGTT,0,1947268
ihfAp4,0.08333333333333333,11,11,TCCCGAGTTCTGCTTCTCTC,0,1926956
ihfAp4,0.08333333333333333,11,11,TCATTAGATGAGAAGGGAGT,0,1945311
ihfAp4,0.08333333333333333,11,11,TATTGCAGGCCACCGCTTAA,0,1942010
ihfAp4,0.08333333333333333,11,11,TATGTTTCTCGTGGGTCTGC,0,1912711
ihfAp4,0.08333333333333333,11,11,TATAGTAACGTTCCCGTGGA,0,1917857
ihfAp4,0.08333333333333333,11,11,TAGCCAGGCGTATCGAAGGA,0,1916784
ihfAp4,0.08333333333333333,11,11,TAGATGGCGTTTGTCAACGA,0,1914527
ihfAp4,0.08333333333333333,11,11,TAGAGTCGCAACCATACATT,0,1933592
ihfAp4,0.08333333333333333,11,11,TACATAGACTTACGTGGACT,0,1923371
ihfAp4,0.08333333333333333,11,11,TACAATCCCGCCTGAGTATA,0,1937053
ihfAp4,0.08333333333333333,11,11,TAAGTCTTCGGGTATATTTC,0,1929303
ihfAp4,0.08333333333333333,11,11,TAAGTACGCAGCATCCCTCG,0,1918077
ihfAp4,0.08333333333333333,11,11,TAACGGCCTCACGGCAGTGC,0,1954611
ihfAp4,0.08333333333333333,11,11,GTTTGGCAGGTCGTAGGTCT,0,1933146
ihfAp4,0.08333333333333333,11,11,GTTCCTGAATGGGGGTTTCT,0,1955777
ihfAp4,0.08333333333333333,11,11,GTGTTGCCGACATATAGGTC,0,1936137
ihfAp4,0.08333333333333333,11,11,GTGGGGCGGATCGTGTACAT,0,1943794
ihfAp4,0.08333333333333333,11,11,GTGGGGACCCACAATACCAT,0,1954078
ihfAp4,0.08333333333333333,11,11,GTGCGCAGGTGGGCTTTCGG,0,1914518
ihfAp4,0.08333333333333333,11,11,GTGCAGCTGTGCCATAAAGA,0,1941782
ihfAp4,0.08333333333333333,11,11,GTCTCTTCTCTATCGAACCA,0,1917160
ihfAp4,0.08333333333333333,11,11,GTCGGATCGCTCCATTCAGT,0,1949427
ihfAp4,0.08333333333333333,11,11,GTCGATCGATCTAGACCCAG,0,1938476
ihfAp4,0.08333333333333333,11,11,GTATGGTTATTAATGTAGGT,0,1958526
ihfAp4,0.08333333333333333,11,11,GTAGTTCCCGGACTTAGTTC,0,1909753
ihfAp4,0.08333333333333333,11,11,GGTGAATACGGCAGCTTGTG,0,1951529
ihfAp4,0.08333333333333333,11,11,GGTAATGGACCCTACAGCGG,0,1955030
ihfAp4,0.08333333333333333,11,11,GGGGGCGTGCCTCAAGATCC,0,1960577
ihfAp4,0.08333333333333333,11,11,GGGCTTAGTGTGGACTTGTT,0,1935360
ihfAp4,0.08333333333333333,11,11,GGGAACGTGTGCACGGTCAA,0,1957192
ihfAp4,0.08333333333333333,11,11,GGCTGTGCAGACGAGTTCGA,0,1937338
ihfAp4,0.08333333333333333,11,11,GGCTAAGAACGGAAGATGTA,0,1958518
ihfAp4,0.08333333333333333,11,11,GGCGGCTCGACCACGAGGAA,0,1936112
ihfAp4,0.08333333333333333,11,11,GGCGAGGTCCGTATGTTGTG,0,1924536
ihfAp4,0.08333333333333333,11,11,GGCAGAGTATTACCGTGGCA,0,1939146
ihfAp4,0.08333333333333333,11,11,GGATGGTGTTAGCTTTCAAT,0,1954396
ihfAp4,0.08333333333333333,11,11,GGATGGCGGATATCCGTTAT,0,1922752
ihfAp4,0.08333333333333333,11,11,GGAGCTCCTGCTTAGCACAA,0,1915155
ihfAp4,0.08333333333333333,11,11,GGAACAAGAGTGCGCGAATA,0,1929879
ihfAp4,0.08333333333333333,11,11,GGAAATAAATCTTTCAGACC,0,1931273
ihfAp4,0.08333333333333333,11,11,GCTTAGTCCGAAATATCGTC,0,1956928
ihfAp4,0.08333333333333333,11,11,GCGGCCGTCCACGTTACGGT,0,1952418
ihfAp4,0.08333333333333333,11,11,GCCGTCAGGAAAGTGTGAGA,0,1950084
ihfAp4,0.08333333333333333,11,11,GCAGGGTCAGGCCATGACAA,0,1928725
ihfAp4,0.08333333333333333,11,11,GCACCTTCCAATCGTAAAAT,0,1921648
ihfAp4,0.08333333333333333,11,11,GCACCGAAGAATTCAGGTTA,0,1936733
ihfAp4,0.08333333333333333,11,11,GATGATACAGAGCGCATCCG,0,1927940
ihfAp4,0.08333333333333333,11,11,GATCGCGATCAAGAGACCAT,0,1952015
ihfAp4,0.08333333333333333,11,11,GAGGCAGACCTTCGGTCAGA,0,1927552
ihfAp4,0.08333333333333333,11,11,GAGGAGGCCCTATCCGAATG,0,1911475
ihfAp4,0.08333333333333333,11,11,GAGGAAGGCGCAAAAAGCTG,0,1944074
ihfAp4,0.08333333333333333,11,11,GAGATCGTATGTGGAGACGA,0,1925866
ihfAp4,0.08333333333333333,11,11,GAGAATCCCTGTCTTCCGGG,0,1918968
ihfAp4,0.08333333333333333,11,11,GAGAAGCTTGTAGCAGCCAT,0,1924908
ihfAp4,0.08333333333333333,11,11,GACTCCAAGGTCTGGTTTCT,0,1953755
ihfAp4,0.08333333333333333,11,11,GAAGTAGCGAAGGGGTCGTT,0,1949350
ihfAp4,0.08333333333333333,11,11,GAAGGGCTCGAGGGGTAGCG,0,1923453
ihfAp4,0.08333333333333333,11,11,CTTTATGGTAGAACGAAATC,0,1934106
ihfAp4,0.08333333333333333,11,11,CTTCGAGCTCTGCTCCTTGT,0,1943369
ihfAp4,0.08333333333333333,11,11,CTTACATCCGATATAGCGAA,0,1944784
ihfAp4,0.08333333333333333,11,11,CTGTCGATCGAAACTTGTAG,0,1923157
ihfAp4,0.08333333333333333,11,11,CTGTCAATAGTAAGCACCAG,0,1920829
ihfAp4,0.08333333333333333,11,11,CTGCAGAACTGGGACTCTGT,0,1948334
ihfAp4,0.08333333333333333,11,11,CTGATAGGAATATTGTAGAG,0,1957613
ihfAp4,0.08333333333333333,11,11,CTCGGGATGATATAGCCACG,0,1910146
ihfAp4,0.08333333333333333,11,11,CTCCATTTAAACCGTCCATA,0,1928091
ihfAp4,0.08333333333333333,11,11,CTCCAGGTCCTAGGTTCGAT,0,1933421
ihfAp4,0.08333333333333333,11,11,CTATTAGCAGTTAAACTTGT,0,1921319
ihfAp4,0.08333333333333333,11,11,CTAGGTATAAAGAACCCGCG,0,1948343
ihfAp4,0.08333333333333333,11,11,CTACTACTCGTGGGCGGCCA,0,1938467
ihfAp4,0.08333333333333333,11,11,CTAACAACACTACAAACGTA,0,1925263
ihfAp4,0.08333333333333333,11,11,CGTTACCTGTTCCTCAGCGA,0,1933988
ihfAp4,0.08333333333333333,11,11,CGTGTTAAAGGGCAAACCCT,0,1928545
ihfAp4,0.08333333333333333,11,11,CGTGAGAGGAAGTGGTGTAT,0,1920024
ihfAp4,0.08333333333333333,11,11,CGTCGGGCGCTTAGTGGGAA,0,1916827
ihfAp4,0.08333333333333333,11,11,CGTCGAGGCAATAACGGAAG,0,1919557
ihfAp4,0.08333333333333333,11,11,CGTCATGAGATACGGTATCC,0,1959035
ihfAp4,0.08333333333333333,11,11,CGGGATGATTACCATTTCTG,0,1958389
ihfAp4,0.08333333333333333,11,11,CGGCTCAAACGCTTTCGGCC,0,1942346
ihfAp4,0.08333333333333333,11,11,CGGCGCGTTTGGGCCGCCCA,0,1958327
ihfAp4,0.08333333333333333,11,11,CGGAAATTGCGGTGACGTGA,0,1911021
ihfAp4,0.08333333333333333,11,11,CGCTTGTGATACAGAAGCTC,0,1930000
ihfAp4,0.08333333333333333,11,11,CGCTGGTTTGGACTCAGACA,0,1916968
ihfAp4,0.08333333333333333,11,11,CGCTCGATTTACTGAATTGG,0,1955633
ihfAp4,0.08333333333333333,11,11,CGCTATGCAGTAACCACGCA,0,1956105
ihfAp4,0.08333333333333333,11,11,CGCGTGTACAGGAATTACAG,0,1913124
ihfAp4,0.08333333333333333,11,11,CGCGATATCAAGTCATGGTC,0,1937078
ihfAp4,0.08333333333333333,11,11,CGCCTTGAAGATCTATTAAG,0,1937407
ihfAp4,0.08333333333333333,11,11,CGCAAGGATAAACGCAGGGT,0,1911185
ihfAp4,0.08333333333333333,11,11,CGATTGAGTCAGGCTAACCC,0,1914570
ihfAp4,0.08333333333333333,11,11,CGATTAGATGTGAACGGAGT,0,1918631
ihfAp4,0.08333333333333333,11,11,CGATGTCACCATGACTAATC,0,1922430
ihfAp4,0.08333333333333333,11,11,CGATCAAGGGCTGTTCATTC,0,1923369
ihfAp4,0.08333333333333333,11,11,CGAGATAGGGCTTCCCACTG,0,1951995
ihfAp4,0.08333333333333333,11,11,CGAAAACTCCAGGCCGTATT,0,1920054
ihfAp4,0.08333333333333333,11,11,CCTTGAGGGGTCCGGCGGCC,0,1925046
ihfAp4,0.08333333333333333,11,11,CCTGTGGTAATTAGGGCACA,0,1947665
ihfAp4,0.08333333333333333,11,11,CCTGGTAACGACCCCGCTCG,0,1940447
ihfAp4,0.08333333333333333,11,11,CCTCGCTGCTACCCCTCCAC,0,1941964
ihfAp4,0.08333333333333333,11,11,CCTATGCGATGAGTCTTAGT,0,1911582
ihfAp4,0.08333333333333333,11,11,CCTAGGCGTGAGCCGGAAAT,0,1943372
ihfAp4,0.08333333333333333,11,11,CCGTAAGTAAGGTAGCCCAG,0,1917502
ihfAp4,0.08333333333333333,11,11,CCGGGAACGCTACACAATGG,0,1930655
ihfAp4,0.08333333333333333,11,11,CCGAGCATAGGAGGGGACTT,0,1913172
ihfAp4,0.08333333333333333,11,11,CCCTCCCCTAACCACCGCCC,0,1940493
ihfAp4,0.08333333333333333,11,11,CCCTACGATGAGTACATGAC,0,1929098
ihfAp4,0.08333333333333333,11,11,CCCTAAGTTTACGCTCTTTC,0,1912104
ihfAp4,0.08333333333333333,11,11,CCCGCCAATTTGTTCCCGTT,0,1958150
ihfAp4,0.08333333333333333,11,11,CCCAGGCGATGATAGAGAAG,0,1920649
ihfAp4,0.08333333333333333,11,11,CCACGGCAACATTCGACAGC,0,1954916
ihfAp4,0.08333333333333333,11,11,CCAACACCAAAGTCGGTTTG,0,1934981
ihfAp4,0.08333333333333333,11,11,CATTTTTTCACAAGACCAGC,0,1939508
ihfAp4,0.08333333333333333,11,11,CATTTCAGTGGTTTAGAGTG,0,1915499
ihfAp4,0.08333333333333333,11,11,CATCTTGTTTAGTTACGTTA,0,1926277
ihfAp4,0.08333333333333333,11,11,CATCTGCGCGGGATTCGAAA,0,1938601
ihfAp4,0.08333333333333333,11,11,CAGGAGGGCCACGGTCTAGT,0,1917809
ihfAp4,0.08333333333333333,11,11,CACGTGTAGGTTCGGAAACC,0,1925804
ihfAp4,0.08333333333333333,11,11,CACGGTTGCCCGGTGCGTAA,0,1945939
ihfAp4,0.08333333333333333,11,11,CACGCATAGCACCCAAACAA,0,1936715
ihfAp4,0.08333333333333333,11,11,CACGAATGTAAGTTGGGCTG,0,1929659
ihfAp4,0.08333333333333333,11,11,CACCGAAGAGGCCGAATCTT,0,1943048
ihfAp4,0.08333333333333333,11,11,CACACTTAGCGCGTGTGTAA,0,1944493
ihfAp4,0.08333333333333333,11,11,CAATTTGCGTCTATGCGATT,0,1960899
ihfAp4,0.08333333333333333,11,11,CAACTTATAGGCATACTTAA,0,1947967
ihfAp4,0.08333333333333333,11,11,CAACGTTCGTAGATTTGGCA,0,1913674
ihfAp4,0.08333333333333333,11,11,CAACCGTCGGTTCAGCACAT,0,1925678
ihfAp4,0.08333333333333333,11,11,CAACAAGACTTAATTTTGCT,0,1912126
ihfAp4,0.08333333333333333,11,11,CAAAGTTGGAGTGTCTGTAG,0,1944779
ihfAp4,0.08333333333333333,11,11,CAAAGGGCATTGGACAGGTT,0,1915302
ihfAp4,0.08333333333333333,11,11,CAAACCTGGGTTCCGTATCA,0,1928692
ihfAp4,0.08333333333333333,11,11,ATTTATTTCTGCAAAGGTGC,0,1951561
ihfAp4,0.08333333333333333,11,11,ATTCCCTGCAATATGGAAAG,0,1920009
ihfAp4,0.08333333333333333,11,11,ATTACCCAGGCCCGCTAAAA,0,1951226
ihfAp4,0.08333333333333333,11,11,ATGTTTGTGGCTACATCTGT,0,1933417
ihfAp4,0.08333333333333333,11,11,ATGTGCCGTTGCTTTTACGA,0,1955024
ihfAp4,0.08333333333333333,11,11,ATGGGGGACGCAAAGGGCTT,0,1955574
ihfAp4,0.08333333333333333,11,11,ATGGATGATGGGGCGCACGG,0,1925775
ihfAp4,0.08333333333333333,11,11,ATGCGCATGTCTCTTGACCC,0,1954951
ihfAp4,0.08333333333333333,11,11,ATGAGGGTCGCGTCGGGTAA,0,1953403
ihfAp4,0.08333333333333333,11,11,ATGAGGGCCGCATTAGACAA,0,1940874
ihfAp4,0.08333333333333333,11,11,ATCTCTTACCGTAACACACC,0,1918227
ihfAp4,0.08333333333333333,11,11,ATCGGACGCGCTATGGGCAG,0,1944612
ihfAp4,0.08333333333333333,11,11,ATACGATGAGACAACGGAGG,0,1941148
ihfAp4,0.08333333333333333,11,11,AGTTTTTTCTGTAGGTCTCG,0,1949599
ihfAp4,0.08333333333333333,11,11,AGTTCCGCATGCCTACATAC,0,1931443
ihfAp4,0.08333333333333333,11,11,AGTTCCACGTTCTGTTATTT,0,1922523
ihfAp4,0.08333333333333333,11,11,AGTGTGGGACTGGGCGGTGC,0,1929651
ihfAp4,0.08333333333333333,11,11,AGTCAAAGCAACTCACGAAC,0,1922575
ihfAp4,0.08333333333333333,11,11,AGGTTGCGCGTGAGGAACTG,0,1952017
ihfAp4,0.08333333333333333,11,11,AGGTCTCCTGTACTTCTTAT,0,1923971
ihfAp4,0.08333333333333333,11,11,AGGGGCACATGCGGCAGATT,0,1961248
ihfAp4,0.08333333333333333,11,11,AGGCTGGAGAAAGTCGGATT,0,1928043
ihfAp4,0.08333333333333333,11,11,AGGCCGATTCTATCGGATTT,0,1918351
ihfAp4,0.08333333333333333,11,11,AGGAAAATCACTGCTTATAT,0,1925801
ihfAp4,0.08333333333333333,11,11,AGCTATGTGTACTTACCTGA,0,1928482
ihfAp4,0.08333333333333333,11,11,AGCCAGGAGACCGGATCTCG,0,1916727
ihfAp4,0.08333333333333333,11,11,AGCAGATCGATAACGGTGTT,0,1951909
ihfAp4,0.08333333333333333,11,11,AGCAAGCATCTAGTATATGG,0,1927784
ihfAp4,0.08333333333333333,11,11,AGAGGTCAATTTGGCTGGTT,0,1934252
ihfAp4,0.08333333333333333,11,11,AGAGGGTAGGTCTTGCATAC,0,1930992
ihfAp4,0.08333333333333333,11,11,ACTGGGACGACCTGAGAGTC,0,1933403
ihfAp4,0.08333333333333333,11,11,ACTCCAACTAATACGAGAAA,0,1911383
ihfAp4,0.08333333333333333,11,11,ACGATGTATAAAGTCAACTA,0,1955018
ihfAp4,0.08333333333333333,11,11,ACGACAGCGGGTATGATAAC,0,1958295
ihfAp4,0.08333333333333333,11,11,ACCTCTAGACGCAGGACGCT,0,1944585
ihfAp4,0.08333333333333333,11,11,ACCGAGTACATTAGTAATTC,0,1948348
ihfAp4,0.08333333333333333,11,11,ACCCTCCCTCTAGAGGCAGG,0,1939245
ihfAp4,0.08333333333333333,11,11,ACATAGCGTCCCCTGAACAG,0,1946970
ihfAp4,0.08333333333333333,11,11,ACAGTATCGCTTATGGAGGA,0,1941709
ihfAp4,0.08333333333333333,11,11,AATTTCGGTGTTCGATCTCC,0,1919549
ihfAp4,0.08333333333333333,11,11,AAGTCACAGGGATTGCCCCT,0,1939248
ihfAp4,0.08333333333333333,11,11,AAGAATCGGACTCACATTTT,0,1934437
ihfAp4,0.08333333333333333,11,11,AACTTCGCCTCGCGGTTACT,0,1915973
ihfAp4,0.08333333333333333,11,11,AACGGTAATGATTACGTCTG,0,1915773
ihfAp4,0.08333333333333333,11,11,AACCTGTAACCTAAACCCTT,0,1931867
ihfAp4,0.08333333333333333,11,11,AACATGGACTCTATGTGCTC,0,1913662
ihfAp4,0.08333333333333333,11,11,AAATGACTAAGTTTGGTCCT,0,1928544
ihfAp4,0.08333333333333333,11,11,AAAAGGCGTACTTTGCTAGT,0,1960440
ihfAp4,0.09090909090909091,10,10,TTTTTTGTTTCTTGCGAAGA,0,1914706
ihfAp4,0.09090909090909091,10,10,TTTTGAGAGGCATGATAGGT,0,1935531
ihfAp4,0.09090909090909091,10,10,TTTGTTCTTTAGTCTCCACG,0,1912406
ihfAp4,0.09090909090909091,10,10,TTTCCTAGGCGAAATCACTC,0,1930779
ihfAp4,0.09090909090909091,10,10,TTTCCGGTCCGTACCACTGA,0,1936277
ihfAp4,0.09090909090909091,10,10,TTTCAGTCATCCACCTTGTG,0,1943854
ihfAp4,0.09090909090909091,10,10,TTGTTCTGCGTGGTGTCACC,0,1931882
ihfAp4,0.09090909090909091,10,10,TTGGAGAACATTGAACCGCA,0,1938780
ihfAp4,0.09090909090909091,10,10,TTGGACATTAACAGTTTTTC,0,1939138
ihfAp4,0.09090909090909091,10,10,TTGGAATTGGTCGCCGGCGT,0,1913605
ihfAp4,0.09090909090909091,10,10,TTGCCCCCGCGGGGCGACGT,0,1921903
ihfAp4,0.09090909090909091,10,10,TTCGGTTCAGTCATTGCTGT,0,1914419
ihfAp4,0.09090909090909091,10,10,TTCGGTAAGAAAGACTGCGA,0,1931760
ihfAp4,0.09090909090909091,10,10,TTATTGGGTCGTCATAGCCG,0,1914188
ihfAp4,0.09090909090909091,10,10,TTATAGGGCGTTAAGGTTGA,0,1946251
ihfAp4,0.09090909090909091,10,10,TTAGCAGCTCTAGACATAAC,0,1926636
ihfAp4,0.09090909090909091,10,10,TTAGATACCCGTCTAGTTAG,0,1930002
ihfAp4,0.09090909090909091,10,10,TTACGGAAATGATGCAATTA,0,1923548
ihfAp4,0.09090909090909091,10,10,TTACCGTAGGCGAAGAATAA,0,1958366
ihfAp4,0.09090909090909091,10,10,TGTGCTCGGCAGTTGCCAGT,0,1919806
ihfAp4,0.09090909090909091,10,10,TGTCATGGTTCTCGCGAACT,0,1956477
ihfAp4,0.09090909090909091,10,10,TGTACGGCCCGATTGCCGAA,0,1946884
ihfAp4,0.09090909090909091,10,10,TGGTTAAATATGCGACATCG,0,1955270
ihfAp4,0.09090909090909091,10,10,TGGTGCTCCTAGATAATACT,0,1927893
ihfAp4,0.09090909090909091,10,10,TGGGTTCCCAGGTAAGCTTT,0,1917380
ihfAp4,0.09090909090909091,10,10,TGGGTGTTGCAGGAGCTAAA,0,1953437
ihfAp4,0.09090909090909091,10,10,TGGGCCTGACTTTTGGGCCA,0,1929399
ihfAp4,0.09090909090909091,10,10,TGGCTAAGCACACCTCTCAG,0,1959140
ihfAp4,0.09090909090909091,10,10,TGGCAAGAGTTTAGGGGGAA,0,1956973
ihfAp4,0.09090909090909091,10,10,TGGCAACGCACTTCCTTTTC,0,1935317
ihfAp4,0.09090909090909091,10,10,TGGACTAGACTTAGAAGCCG,0,1943125
ihfAp4,0.09090909090909091,10,10,TGCTGAGGTGACGTAGAATA,0,1920786
ihfAp4,0.09090909090909091,10,10,TGCGGGTCGTATGCTTATCA,0,1914957
ihfAp4,0.09090909090909091,10,10,TGCAGCCGGCCCAAGTCAGA,0,1918031
ihfAp4,0.09090909090909091,10,10,TGATTGAGGTTGTAATGATC,0,1960967
ihfAp4,0.09090909090909091,10,10,TGATGATATGAAGTATGTTG,0,1950322
ihfAp4,0.09090909090909091,10,10,TGAGCGCCGAAGTAGTTTAT,0,1925470
ihfAp4,0.09090909090909091,10,10,TGACTAGATGGTTTTATTGT,0,1916789
ihfAp4,0.09090909090909091,10,10,TCTGTGTAATCTTTTTGAAT,0,1924815
ihfAp4,0.09090909090909091,10,10,TCTGAACTGCTAGCGTTGAC,0,1937250
ihfAp4,0.09090909090909091,10,10,TCTCCATATTATTTGCATGT,0,1961304
ihfAp4,0.09090909090909091,10,10,TCTCAGACGGTACTGAATAA,0,1961690
ihfAp4,0.09090909090909091,10,10,TCTACATGCGGGCATCTTAA,0,1960773
ihfAp4,0.09090909090909091,10,10,TCTAAGGAGCGATGCGGAAG,0,1953399
ihfAp4,0.09090909090909091,10,10,TCTAACAACAATACAACATT,0,1950542
ihfAp4,0.09090909090909091,10,10,TCGTGAAGCAAGAACCAGTG,0,1917144
ihfAp4,0.09090909090909091,10,10,TCGCTCTCCCCTTAGTAGCT,0,1921442
ihfAp4,0.09090909090909091,10,10,TCGCATTAGGGCTCGTATAA,0,1936842
ihfAp4,0.09090909090909091,10,10,TCGATAGTCTGGGAAAATGC,0,1951287
ihfAp4,0.09090909090909091,10,10,TCCGTAAGGCATCGGCTATC,0,1947062
ihfAp4,0.09090909090909091,10,10,TCCCGTCTTATGAGTCGAAC,0,1919426
ihfAp4,0.09090909090909091,10,10,TCCATCGGGTCGGCTAGTCA,0,1933674
ihfAp4,0.09090909090909091,10,10,TCACGGCGGTGAGCACAGAA,0,1958683
ihfAp4,0.09090909090909091,10,10,TCAATTGATGAAAGCCCCTG,0,1952449
ihfAp4,0.09090909090909091,10,10,TATGCGGCCTCGATTAAGAT,0,1924700
ihfAp4,0.09090909090909091,10,10,TATCGGTGTCCAGCTAAGTG,0,1914660
ihfAp4,0.09090909090909091,10,10,TAGGAACGAAGTCGTGGCTG,0,1933224
ihfAp4,0.09090909090909091,10,10,TAGAAGCTGGTCCGCGGACG,0,1925136
ihfAp4,0.09090909090909091,10,10,TAGAAGCAGAGCAATTTTTC,0,1927911
ihfAp4,0.09090909090909091,10,10,TACGACCTAGAGTCTAACCT,0,1944369
ihfAp4,0.09090909090909091,10,10,TACGACCAACGGAGGCCTCG,0,1914710
ihfAp4,0.09090909090909091,10,10,TAATTTACAACGGCGAGAAG,0,1931476
ihfAp4,0.09090909090909091,10,10,TAATAAATGCCATGGAACTT,0,1927448
ihfAp4,0.09090909090909091,10,10,GTTTTGACCCTGTAAGCGGT,0,1935084
ihfAp4,0.09090909090909091,10,10,GTTTGCAAGTGGTACGTCTG,0,1946774
ihfAp4,0.09090909090909091,10,10,GTTCATGGGCTTAATGTTCA,0,1943007
ihfAp4,0.09090909090909091,10,10,GTGTGTGCAGCCCGGATCGT,0,1933126
ihfAp4,0.09090909090909091,10,10,GTGGGGTCCCAGGTTGTAGT,0,1934711
ihfAp4,0.09090909090909091,10,10,GTGGGAGGACAGTCTAACGT,0,1958609
ihfAp4,0.09090909090909091,10,10,GTGGAGGCGTTTCATCGACC,0,1918048
ihfAp4,0.09090909090909091,10,10,GTGCTACGCTCGTGACCTCA,0,1925905
ihfAp4,0.09090909090909091,10,10,GTGACCCACAATGAATGACA,0,1915966
ihfAp4,0.09090909090909091,10,10,GTCTGATTGACGTTGAACGA,0,1961050
ihfAp4,0.09090909090909091,10,10,GTCGGCTTAAAACCCGTATA,0,1925250
ihfAp4,0.09090909090909091,10,10,GTCAGTGATACTGCCCAGGG,0,1949707
ihfAp4,0.09090909090909091,10,10,GTATTGGCAGAGACAGGACT,0,1949702
ihfAp4,0.09090909090909091,10,10,GTATGGATGTCAATGTCGAA,0,1931161
ihfAp4,0.09090909090909091,10,10,GTAGGGGTCGGGGAGGCATC,0,1941668
ihfAp4,0.09090909090909091,10,10,GTACTGGACAACACTCCCAC,0,1923047
ihfAp4,0.09090909090909091,10,10,GTACGGTAGCGTTCGCACAA,0,1935081
ihfAp4,0.09090909090909091,10,10,GTACCGCTCCTGCTACATGG,0,1946315
ihfAp4,0.09090909090909091,10,10,GGTTGAGGCTATGAATTTCG,0,1955376
ihfAp4,0.09090909090909091,10,10,GGTCTAAAGTAAGGTGGGTG,0,1927873
ihfAp4,0.09090909090909091,10,10,GGTCATCAGGTCCACGGGCT,0,1928065
ihfAp4,0.09090909090909091,10,10,GGTATTCTTAGCTTAGCTAC,0,1936703
ihfAp4,0.09090909090909091,10,10,GGTATCCTGAAGAACGGTCA,0,1945132
ihfAp4,0.09090909090909091,10,10,GGTACGGGCTAGAGACTCAA,0,1924429
ihfAp4,0.09090909090909091,10,10,GGTAAGGCTCATTTCATCGC,0,1933303
ihfAp4,0.09090909090909091,10,10,GGGGTACGCCAGAAGAAACG,0,1911423
ihfAp4,0.09090909090909091,10,10,GGGGGGGGAATAGCAGGGTG,0,1949354
ihfAp4,0.09090909090909091,10,10,GGGGGCAATTAAGCCCGTAG,0,1946948
ihfAp4,0.09090909090909091,10,10,GGGGCTTTTGGTACATCTCA,0,1911160
ihfAp4,0.09090909090909091,10,10,GGGGCAGGGTTCGGTCCCCC,0,1909705
ihfAp4,0.09090909090909091,10,10,GGGGATTTGACAGCTTGTGA,0,1948673
ihfAp4,0.09090909090909091,10,10,GGGGACCTGCGTTTTAACGT,0,1955021
ihfAp4,0.09090909090909091,10,10,GGGCTTGATAATGACGGCTG,0,1922542
ihfAp4,0.09090909090909091,10,10,GGGATAACCCGTTCGCCTGG,0,1954289
ihfAp4,0.09090909090909091,10,10,GGGAGTCCGGCCGGTGGCCA,0,1942716
ihfAp4,0.09090909090909091,10,10,GGGAGATATAGGTCGATAAT,0,1919050
ihfAp4,0.09090909090909091,10,10,GGCGATGGAAGTCACTGGTG,0,1936581
ihfAp4,0.09090909090909091,10,10,GGCCGAGAGCTCTAGGTTAT,0,1950545
ihfAp4,0.09090909090909091,10,10,GGCATCTGTAGACAAGCAAT,0,1914493
ihfAp4,0.09090909090909091,10,10,GGCACGCGGTAGGACTCGGG,0,1951908
ihfAp4,0.09090909090909091,10,10,GGAATTTAAATTTGTTCTCA,0,1954612
ihfAp4,0.09090909090909091,10,10,GCTTTACGCATTTACGGAAG,0,1961675
ihfAp4,0.09090909090909091,10,10,GCTTATAGCGGGCTAATGCG,0,1941610
ihfAp4,0.09090909090909091,10,10,GCGTATGATTCGCATGGTAA,0,1911216
ihfAp4,0.09090909090909091,10,10,GCGGAGGTCCGACAGCAAAT,0,1955377
ihfAp4,0.09090909090909091,10,10,GCGCATTGTTCGAAAAGAGT,0,1913125
ihfAp4,0.09090909090909091,10,10,GCGACCACGTTCGCGTTTTA,0,1933127
ihfAp4,0.09090909090909091,10,10,GCGAATGGACCAACAGGGCG,0,1932641
ihfAp4,0.09090909090909091,10,10,GCCGGATGCACGTTGTCCGG,0,1946197
ihfAp4,0.09090909090909091,10,10,GCCCTTGGGGATTTTGAAAA,0,1913862
ihfAp4,0.09090909090909091,10,10,GCCCATCCCAGTGCACTTAG,0,1926522
ihfAp4,0.09090909090909091,10,10,GCCATACCATAGTCGGTAGT,0,1932891
ihfAp4,0.09090909090909091,10,10,GCATTAATTCAGGGAGTAAT,0,1942054
ihfAp4,0.09090909090909091,10,10,GCAGTCTGCCGTAACCATCC,0,1919672
ihfAp4,0.09090909090909091,10,10,GCACCGGGTTTTGATCCGAT,0,1919564
ihfAp4,0.09090909090909091,10,10,GATTGTAAGTTGGTTTGCGG,0,1961052
ihfAp4,0.09090909090909091,10,10,GATTAATTGCATTAGCCGCG,0,1932847
ihfAp4,0.09090909090909091,10,10,GATGTGCCCCTAGCCCTCGC,0,1925196
ihfAp4,0.09090909090909091,10,10,GATGTAAGTTAGGTCATAAG,0,1921770
ihfAp4,0.09090909090909091,10,10,GATGACCGCAAGGTAGAGGT,0,1926687
ihfAp4,0.09090909090909091,10,10,GATCCGCTAAATTGGCTTAT,0,1934194
ihfAp4,0.09090909090909091,10,10,GATAAACGGAGGCCCAGGCC,0,1927486
ihfAp4,0.09090909090909091,10,10,GAGGTGCTACCGTGGTTATT,0,1924506
ihfAp4,0.09090909090909091,10,10,GAGGGTCACATCGGTTTGAC,0,1957037
ihfAp4,0.09090909090909091,10,10,GAGGAGGACCGAGGTTCCGA,0,1941146
ihfAp4,0.09090909090909091,10,10,GAGATATGGGCTTACTGGCG,0,1948340
ihfAp4,0.09090909090909091,10,10,GACTGTTCCGGTGGAGCAAA,0,1929463
ihfAp4,0.09090909090909091,10,10,GACTCTTTCCCGGAGGTTCG,0,1912215
ihfAp4,0.09090909090909091,10,10,GACGTTTCTGAGACAGTGGG,0,1946791
ihfAp4,0.09090909090909091,10,10,GACAAGAAGGGAGATGCATA,0,1935637
ihfAp4,0.09090909090909091,10,10,GAATCGATTCAGATGGGTCT,0,1936041
ihfAp4,0.09090909090909091,10,10,GAATAATCCATCTCTGTCAT,0,1925452
ihfAp4,0.09090909090909091,10,10,GAACGTCATTCCTAGATATA,0,1938459
ihfAp4,0.09090909090909091,10,10,GAAACGGGGCTCTGCCGGCG,0,1953854
ihfAp4,0.09090909090909091,10,10,CTTGTTTGCGCGCCCTCCCA,0,1917403
ihfAp4,0.09090909090909091,10,10,CTTGATCGACCTGCCTATTG,0,1916067
ihfAp4,0.09090909090909091,10,10,CTTAGCATGCCACTCAGGCA,0,1923616
ihfAp4,0.09090909090909091,10,10,CTTACCTCTGCTGGCTGCAA,0,1961828
ihfAp4,0.09090909090909091,10,10,CTTAATACCTGGGGTTAATT,0,1921599
ihfAp4,0.09090909090909091,10,10,CTGTCGTAGTGATAGATTCG,0,1932609
ihfAp4,0.09090909090909091,10,10,CTGGCAGGAGCTCGCTCCAC,0,1946918
ihfAp4,0.09090909090909091,10,10,CTGGAGGTGTATCTCACATA,0,1935320
ihfAp4,0.09090909090909091,10,10,CTGCGGTTGTAGCCCCTGCA,0,1916105
ihfAp4,0.09090909090909091,10,10,CTGCATTCGCACTAGCGCTC,0,1923586
ihfAp4,0.09090909090909091,10,10,CTCTCCGGAGGCAAACGGAT,0,1919547
ihfAp4,0.09090909090909091,10,10,CTCTATACAGTGAATTTAGA,0,1957410
ihfAp4,0.09090909090909091,10,10,CTCGCTGTCGCCTTATGAAC,0,1922526
ihfAp4,0.09090909090909091,10,10,CTCGCGAATGATAGGTGACT,0,1921249
ihfAp4,0.09090909090909091,10,10,CTCCCCATTGCAAACACTCA,0,1953114
ihfAp4,0.09090909090909091,10,10,CTCACGGATCGACTAGCTAG,0,1954140
ihfAp4,0.09090909090909091,10,10,CTACACGCGGTTCTAGATTC,0,1958332
ihfAp4,0.09090909090909091,10,10,CTAAGCCGCGAAGATTTTCT,0,1926040
ihfAp4,0.09090909090909091,10,10,CGTCTTCGTCTGTGGAACCA,0,1937390
ihfAp4,0.09090909090909091,10,10,CGTCTGGGGGGCTTGGGAGA,0,1928116
ihfAp4,0.09090909090909091,10,10,CGTCAAGGAACCGAATGGTC,0,1924540
ihfAp4,0.09090909090909091,10,10,CGTAGCGTTATAGAATTTAT,0,1911276
ihfAp4,0.09090909090909091,10,10,CGGCACCAACAGTCATAGCG,0,1955369
ihfAp4,0.09090909090909091,10,10,CGGAGTTAGACCTAAGGTTC,0,1931606
ihfAp4,0.09090909090909091,10,10,CGCTGCCAGGGAAATGGGAG,0,1929465
ihfAp4,0.09090909090909091,10,10,CGCTGCACGCTAAGGGTTTA,0,1945024
ihfAp4,0.09090909090909091,10,10,CGCGTGTCCCGTCACAGTTA,0,1913729
ihfAp4,0.09090909090909091,10,10,CGCGGCATGGTTTCTTTTGT,0,1941248
ihfAp4,0.09090909090909091,10,10,CGCGCATCCTAAGGGAACTC,0,1927326
ihfAp4,0.09090909090909091,10,10,CGCCGTGCATACACACACGA,0,1938249
ihfAp4,0.09090909090909091,10,10,CGATTATCGCAATCCTAGCG,0,1924142
ihfAp4,0.09090909090909091,10,10,CGATCTCTGTTGAACCTGTT,0,1957472
ihfAp4,0.09090909090909091,10,10,CGATAGCCAAGTTCATGGTG,0,1937176
ihfAp4,0.09090909090909091,10,10,CGAGCTGAATAATAGTCTAA,0,1952292
ihfAp4,0.09090909090909091,10,10,CCTCTTATAGGTTAATAAGA,0,1956351
ihfAp4,0.09090909090909091,10,10,CCTCGTAAGGAGCGGAAGAC,0,1918689
ihfAp4,0.09090909090909091,10,10,CCTCATCCCGCGGGCGGATA,0,1957748
ihfAp4,0.09090909090909091,10,10,CCGTCGGCGACGGCGAATGG,0,1933667
ihfAp4,0.09090909090909091,10,10,CCGGGAGGGCGTCGATGAGT,0,1948386
ihfAp4,0.09090909090909091,10,10,CCGGCGTCTGAAAGTATGAT,0,1924678
ihfAp4,0.09090909090909091,10,10,CCGGAGTTTAGCCTAAGTAG,0,1927504
ihfAp4,0.09090909090909091,10,10,CCGCTAGTACCAACTGCCAT,0,1926996
ihfAp4,0.09090909090909091,10,10,CCGACGCGGCCCGAATTGTT,0,1929749
ihfAp4,0.09090909090909091,10,10,CCCTTAGGGACGTTGGAGTA,0,1915369
ihfAp4,0.09090909090909091,10,10,CCCTGTTCCGGTTTCATGGT,0,1914531
ihfAp4,0.09090909090909091,10,10,CCCTGGCACGAAGGGTGGCT,0,1924747
ihfAp4,0.09090909090909091,10,10,CCCTCGTCAGAACCCCACTC,0,1912500
ihfAp4,0.09090909090909091,10,10,CCCTAGGGGCGTGACGTGGG,0,1922250
ihfAp4,0.09090909090909091,10,10,CCCGTACTGAAGTTTTTTCA,0,1952767
ihfAp4,0.09090909090909091,10,10,CCACAACCCGGCGAAGCATA,0,1943447
ihfAp4,0.09090909090909091,10,10,CATTCGGACCGGTCCGAGGG,0,1919908
ihfAp4,0.09090909090909091,10,10,CATTCCCTGGACAACCTAAG,0,1940321
ihfAp4,0.09090909090909091,10,10,CATTACAGACGCTTTGAACT,0,1924304
ihfAp4,0.09090909090909091,10,10,CATCACGTGCATAGTTGATT,0,1956339
ihfAp4,0.09090909090909091,10,10,CATAGCCTTTGTGAGCGAGT,0,1952460
ihfAp4,0.09090909090909091,10,10,CAGGCCCATTCGGGGTGCCG,0,1934445
ihfAp4,0.09090909090909091,10,10,CAGCTCATTTGTACGCCCTG,0,1932088
ihfAp4,0.09090909090909091,10,10,CAGCGCGGTCGAGCCGCTGG,0,1941083
ihfAp4,0.09090909090909091,10,10,CACTTTTCCGGGCATGAGTA,0,1945884
ihfAp4,0.09090909090909091,10,10,CACGTTCTGGCTCGGCTATT,0,1909951
ihfAp4,0.09090909090909091,10,10,CAAAAAGTCCCGGTTGCTCT,0,1919683
ihfAp4,0.09090909090909091,10,10,ATTTTCCTTGGGACACAATT,0,1935307
ihfAp4,0.09090909090909091,10,10,ATTTTCACACGCCGGCCGTG,0,1941132
ihfAp4,0.09090909090909091,10,10,ATTTCTCCGGGGGATACGCA,0,1957294
ihfAp4,0.09090909090909091,10,10,ATTTAAGATAATGGAGAATC,0,1911460
ihfAp4,0.09090909090909091,10,10,ATTGCATTCGTTCTAAGCTA,0,1932362
ihfAp4,0.09090909090909091,10,10,ATTCGTTGCCTTCTCTTTGT,0,1949261
ihfAp4,0.09090909090909091,10,10,ATTACTACAGAAGAACAATA,0,1918771
ihfAp4,0.09090909090909091,10,10,ATGTCGGCTGCGATAGTGAC,0,1924509
ihfAp4,0.09090909090909091,10,10,ATGGTTGTTTTCTTTGATCT,0,1940559
ihfAp4,0.09090909090909091,10,10,ATGGAACCTGGGCTCAGTGG,0,1910584
ihfAp4,0.09090909090909091,10,10,ATGAGGGGAACGAACGCGCT,0,1924593
ihfAp4,0.09090909090909091,10,10,ATCTTGGCTCGTTCGCATTG,0,1953610
ihfAp4,0.09090909090909091,10,10,ATCTGCATTGTCCCCTACTA,0,1942063
ihfAp4,0.09090909090909091,10,10,ATCTGAGTAGGGTTGCGCTA,0,1929874
ihfAp4,0.09090909090909091,10,10,ATCTAGGTCGCTCGACTCCA,0,1917819
ihfAp4,0.09090909090909091,10,10,ATCGTTTAACCACGTCTCTG,0,1913604
ihfAp4,0.09090909090909091,10,10,ATCGTGACTTACGTAGACAC,0,1931613
ihfAp4,0.09090909090909091,10,10,ATCGTATTCGTCACAGTTAC,0,1920366
ihfAp4,0.09090909090909091,10,10,ATCGGCAAAATGTTCCTAGA,0,1958128
ihfAp4,0.09090909090909091,10,10,ATCGCCGAAGGTCTGAATGT,0,1953266
ihfAp4,0.09090909090909091,10,10,ATCCATAAGCGTAAACAAAT,0,1949099
ihfAp4,0.09090909090909091,10,10,ATCCAGGACCCAGTTGCCGG,0,1954755
ihfAp4,0.09090909090909091,10,10,ATATTGGCGTAACCTCCCAT,0,1917474
ihfAp4,0.09090909090909091,10,10,ATATATACCCCCGAATAATC,0,1910565
ihfAp4,0.09090909090909091,10,10,ATAGTTGGGGCGGGTCGCAA,0,1932082
ihfAp4,0.09090909090909091,10,10,ATAATACTAACGAATTGATG,0,1912938
ihfAp4,0.09090909090909091,10,10,AGTTGGAGACGGTCATCAGC,0,1932346
ihfAp4,0.09090909090909091,10,10,AGTGCTGTGAGAGATGAGAC,0,1942073
ihfAp4,0.09090909090909091,10,10,AGTGCGATGCCCCGCGTAAC,0,1944314
ihfAp4,0.09090909090909091,10,10,AGTCGCAGGCCGTGTTACGT,0,1954413
ihfAp4,0.09090909090909091,10,10,AGTAAATGGGACTTTGACAC,0,1922381
ihfAp4,0.09090909090909091,10,10,AGGTTGTGCTCCGCGAAAGA,0,1918948
ihfAp4,0.09090909090909091,10,10,AGGTGTGCGGCCCTCTTTGA,0,1926747
ihfAp4,0.09090909090909091,10,10,AGGTGCGAAACCTCGGACAA,0,1936710
ihfAp4,0.09090909090909091,10,10,AGGTGATGTCAAGCGAAGAC,0,1945495
ihfAp4,0.09090909090909091,10,10,AGGTCGTTCATGCGGCCTAA,0,1953447
ihfAp4,0.09090909090909091,10,10,AGGGTTCTCCATCACGCAAA,0,1928661
ihfAp4,0.09090909090909091,10,10,AGGGGTCATTTAAAAGGATA,0,1911324
ihfAp4,0.09090909090909091,10,10,AGGGCTCGACATTCGACTTA,0,1916910
ihfAp4,0.09090909090909091,10,10,AGGGCAACTCACTGGGCCGG,0,1935020
ihfAp4,0.09090909090909091,10,10,AGCTCCCATTGACTCCAGGC,0,1942576
ihfAp4,0.09090909090909091,10,10,AGCTATGGGGCGCGATTTGT,0,1949809
ihfAp4,0.09090909090909091,10,10,AGCGCGGGTCCGAAGGCACG,0,1956813
ihfAp4,0.09090909090909091,10,10,AGCCTATTCCATGGCGGCGT,0,1957369
ihfAp4,0.09090909090909091,10,10,AGCCTACTTAGGCTGGCCCA,0,1932414
ihfAp4,0.09090909090909091,10,10,AGCCGGTCCTGTCAAGAGGT,0,1959044
ihfAp4,0.09090909090909091,10,10,AGCCACGTACACAGCACATA,0,1914181
ihfAp4,0.09090909090909091,10,10,AGCCAACCCCCGTTATTGTC,0,1953200
ihfAp4,0.09090909090909091,10,10,AGATCCGTGGGCTACACTTC,0,1922137
ihfAp4,0.09090909090909091,10,10,AGATACCATGACCGCGTCGG,0,1946779
ihfAp4,0.09090909090909091,10,10,AGAGGCCCACCTATACGAAT,0,1948186
ihfAp4,0.09090909090909091,10,10,AGACTGTAGCGGGTCAGCTA,0,1918833
ihfAp4,0.09090909090909091,10,10,ACTTGCGCTTGGGGTTAGTA,0,1915027
ihfAp4,0.09090909090909091,10,10,ACTTCTCTCCGTATAGTAAA,0,1916149
ihfAp4,0.09090909090909091,10,10,ACTGTTGGGGGGCCGAATGT,0,1939050
ihfAp4,0.09090909090909091,10,10,ACTATAGAAAAGGTAGCGCG,0,1945877
ihfAp4,0.09090909090909091,10,10,ACGATGTGATAGTGCGCAGG,0,1929407
ihfAp4,0.09090909090909091,10,10,ACGAGTTCCGTGAGCGAAGA,0,1919970
ihfAp4,0.09090909090909091,10,10,ACGACCGAAGTAGAGGCTGT,0,1941684
ihfAp4,0.09090909090909091,10,10,ACCTTGTTAATATGGTCCGT,0,1916422
ihfAp4,0.09090909090909091,10,10,ACCTACTCGCATGGATAAGG,0,1941999
ihfAp4,0.09090909090909091,10,10,ACCCCATCCTACTAAGAGTT,0,1919371
ihfAp4,0.09090909090909091,10,10,ACCCACACACCTCTTTAGTA,0,1950972
ihfAp4,0.09090909090909091,10,10,ACAGGAACGAAGTCTTGCTT,0,1961059
ihfAp4,0.09090909090909091,10,10,ACACTTTCGCTCTTTGCGAC,0,1923333
ihfAp4,0.09090909090909091,10,10,ACACATTCGCAGCTGACATT,0,1952825
ihfAp4,0.09090909090909091,10,10,ACAAGCACCGGACACGATTG,0,1931855
ihfAp4,0.09090909090909091,10,10,AATTGGGCGACCGATCGCTG,0,1937001
ihfAp4,0.09090909090909091,10,10,AATACGGGGACGAACCACAC,0,1924523
ihfAp4,0.09090909090909091,10,10,AATAATCTGGAAGTGTGAAG,0,1916540
ihfAp4,0.09090909090909091,10,10,AAGGTACTTGGGAGCCTGTG,0,1945147
ihfAp4,0.09090909090909091,10,10,AAGCGTCTACAAGCAAGCTA,0,1948675
ihfAp4,0.09090909090909091,10,10,AAGCCTCTCGCTCTACTGGT,0,1927478
ihfAp4,0.09090909090909091,10,10,AAGCCTCTCCATATATGTGC,0,1909723
ihfAp4,0.09090909090909091,10,10,AACTTCATACGTGCGACACG,0,1933912
ihfAp4,0.09090909090909091,10,10,AACTGCCAGGTCTTACTGTT,0,1918318
ihfAp4,0.09090909090909091,10,10,AACTAGCTCTACTAAAGCAG,0,1921020
ihfAp4,0.09090909090909091,10,10,AACCAAGACATTTCGCATAG,0,1919833
ihfAp4,0.09090909090909091,10,10,AACACATACGCTGGTCCCAC,0,1929298
ihfAp4,0.09090909090909091,10,10,AACAAGACTTCAGACGTAAC,0,1920356
ihfAp4,0.09090909090909091,10,10,AAAGGCGTCTCAACCAGACA,0,1933790
ihfAp4,0.09090909090909091,10,10,AAACCTCGGGACGTCGCGAT,0,1909578
ihfAp4,0.09090909090909091,10,10,AAAAGTAAGCGGCCAATACG,0,1942109
ihfAp4,0.1,9,9,TTTGTACGGAGGTCATGGGT,0,1951329
ihfAp4,0.1,9,9,TTTGGGAAATTTGCCTATAA,0,1959757
ihfAp4,0.1,9,9,TTTCGTGCTGGCTGCAACTC,0,1937373
ihfAp4,0.1,9,9,TTTATGGCAATCCTTTGACC,0,1930948
ihfAp4,0.1,9,9,TTTAGACATTAGCATGCCAA,0,1931353
ihfAp4,0.1,9,9,TTGGCAGGCCGACGCATGTT,0,1924907
ihfAp4,0.1,9,9,TTGAACCCAGCTACGTCCGA,0,1951062
ihfAp4,0.1,9,9,TTCTGAAAGTCGCGTATCCG,0,1945882
ihfAp4,0.1,9,9,TTCTACGAAGCTGCGGCGTT,0,1925884
ihfAp4,0.1,9,9,TTCCGTGTGTGGTATGAGAT,0,1930380
ihfAp4,0.1,9,9,TTCAAGTGAATGCCAGTATG,0,1941618
ihfAp4,0.1,9,9,TTATTTGTCCCTTTGCCTTG,0,1914333
ihfAp4,0.1,9,9,TTAGGTGGAAGTAACGACGT,0,1932220
ihfAp4,0.1,9,9,TGTTGGCTCACCGGACCCCG,0,1917230
ihfAp4,0.1,9,9,TGTCGGCTTGACTAGGCCAG,0,1941992
ihfAp4,0.1,9,9,TGTCACCACTATGAATTCGA,0,1911914
ihfAp4,0.1,9,9,TGTAAACCGGTTAAACGTAG,0,1928768
ihfAp4,0.1,9,9,TGGTTATGAGTTTGTCAAGT,0,1909939
ihfAp4,0.1,9,9,TGGTCGGGGACATTTACTTA,0,1916608
ihfAp4,0.1,9,9,TGGGCAGCGCCCGCGCCATC,0,1926243
ihfAp4,0.1,9,9,TGGCTGTGCGATAATTGACT,0,1917436
ihfAp4,0.1,9,9,TGGCTAGGTATCAAGGCGGA,0,1953865
ihfAp4,0.1,9,9,TGGCCGGGGGAAGTGACTCT,0,1915564
ihfAp4,0.1,9,9,TGGATCCAACGTTGCACCGC,0,1925229
ihfAp4,0.1,9,9,TGCTTGGCTACCCCTGTTCT,0,1923151
ihfAp4,0.1,9,9,TGCTGGTTGTCCTATTCGTC,0,1949479
ihfAp4,0.1,9,9,TGCTATGCTCGCTCCGGCTA,0,1915932
ihfAp4,0.1,9,9,TGCGGCAGTTCGAATAAGAG,0,1923923
ihfAp4,0.1,9,9,TGCCGGTAAAGGGAGCAGAT,0,1937817
ihfAp4,0.1,9,9,TGCCCTCGGACTGGACAAAA,0,1949671
ihfAp4,0.1,9,9,TGCCCTACAATGCGGTGGGA,0,1911434
ihfAp4,0.1,9,9,TGCATTTTTACATGTCACAT,0,1931899
ihfAp4,0.1,9,9,TGCAATCTACGTTCAGTTTC,0,1951653
ihfAp4,0.1,9,9,TGATCTTTTGACTGCGTTGA,0,1935373
ihfAp4,0.1,9,9,TGATCGCGATACCACATGTC,0,1953797
ihfAp4,0.1,9,9,TGATATGGGAAACATTTTTG,0,1925406
ihfAp4,0.1,9,9,TCTTTTCCTGACTACTCTCC,0,1917748
ihfAp4,0.1,9,9,TCTTTAATTATTGTGCGCTA,0,1945732
ihfAp4,0.1,9,9,TCTTCTGATTGGACCAGCCT,0,1941027
ihfAp4,0.1,9,9,TCTCGTTATGACCTACTTCC,0,1931955
ihfAp4,0.1,9,9,TCGTGGTTAAGACTGGCCCG,0,1961506
ihfAp4,0.1,9,9,TCGTCGAATTTGCGGGTCCG,0,1954421
ihfAp4,0.1,9,9,TCGGGGGGACTAACGTCGAG,0,1939289
ihfAp4,0.1,9,9,TCGACCGCACTACTAAATAA,0,1917817
ihfAp4,0.1,9,9,TCGACCCTGGCAGTAATTAG,0,1945625
ihfAp4,0.1,9,9,TCCTCTGCGGATTGACAATG,0,1950806
ihfAp4,0.1,9,9,TCCCGAGCCGGCCAAAGAGC,0,1952280
ihfAp4,0.1,9,9,TCCAGCCCAGAGCTCACGGT,0,1930860
ihfAp4,0.1,9,9,TCCACTGGATTCCCGCGAGG,0,1954623
ihfAp4,0.1,9,9,TCATTGGAATAGAATGTGCG,0,1956978
ihfAp4,0.1,9,9,TCAGGAAAGCAATCTCGGAG,0,1919906
ihfAp4,0.1,9,9,TCACTCGGCATTGATCGGCA,0,1920698
ihfAp4,0.1,9,9,TCACAGTTTAACCCTAGATA,0,1952949
ihfAp4,0.1,9,9,TCACAGAACAGAACTGGAAA,0,1925530
ihfAp4,0.1,9,9,TCAATGGTCCTCGCCTGCAG,0,1920862
ihfAp4,0.1,9,9,TCAAGGATAGTGTGGAGCAT,0,1953031
ihfAp4,0.1,9,9,TATTGGAGCACAGGCTATGA,0,1958411
ihfAp4,0.1,9,9,TATTGCGGCATGTTAAAGCA,0,1949088
ihfAp4,0.1,9,9,TATCGGGTAGCCTCAATGGG,0,1939277
ihfAp4,0.1,9,9,TATCCCGTGTTCTAGTCATG,0,1923704
ihfAp4,0.1,9,9,TAGGGCTGACGTACCGCTCC,0,1932667
ihfAp4,0.1,9,9,TAGATGACTGGTAGTCGATT,0,1916765
ihfAp4,0.1,9,9,TACTATCCCAGACCTGTAGT,0,1940089
ihfAp4,0.1,9,9,TACGGTGATTGACTAGGGAG,0,1950923
ihfAp4,0.1,9,9,TACGGGGGATTTGCAGCGCA,0,1918230
ihfAp4,0.1,9,9,TACGCCGTGTGCAATTCCAC,0,1948538
ihfAp4,0.1,9,9,TACCGCAAGGCGTAGGTTTT,0,1926273
ihfAp4,0.1,9,9,TACAATGTGCTACGTTCTTG,0,1909864
ihfAp4,0.1,9,9,TAATATGCTAGCTAGTTGTT,0,1916040
ihfAp4,0.1,9,9,TAAGGGACTATACTTTTACT,0,1913918
ihfAp4,0.1,9,9,TAAGCGCGCAAGGGCGACTG,0,1917774
ihfAp4,0.1,9,9,TAACCCGAAGAAGTGCCAGG,0,1956148
ihfAp4,0.1,9,9,TAAAGTTATGACCGCTTAAG,0,1926774
ihfAp4,0.1,9,9,GTTTGTCCACCTGACCGAAG,0,1950847
ihfAp4,0.1,9,9,GTTTCTCGGATCGGCTGCGG,0,1946022
ihfAp4,0.1,9,9,GTTGCATTAGCGAGACCGCC,0,1957845
ihfAp4,0.1,9,9,GTTCATTTATGTTTCCGGCC,0,1918238
ihfAp4,0.1,9,9,GTTATTGGCGGTACCCCTTG,0,1954179
ihfAp4,0.1,9,9,GTTAGAAGGCGGACCGCTTA,0,1944062
ihfAp4,0.1,9,9,GTTAACCTGTGCCATTGGCG,0,1958710
ihfAp4,0.1,9,9,GTGTCATTCCGCCAGTCCGC,0,1929845
ihfAp4,0.1,9,9,GTGTAACTGTCTCGGATCAC,0,1953998
ihfAp4,0.1,9,9,GTGTAACAGTACTTAGGGAA,0,1948884
ihfAp4,0.1,9,9,GTGGTGCGTGGTGTAGTCTA,0,1950617
ihfAp4,0.1,9,9,GTGGTGATAAGTATACGGTG,0,1932264
ihfAp4,0.1,9,9,GTGGTAGTTCTCGGAACACA,0,1958130
ihfAp4,0.1,9,9,GTGGCTATGCTATGCTTCCG,0,1961460
ihfAp4,0.1,9,9,GTGGCTATAGCTGTGGGTTT,0,1917567
ihfAp4,0.1,9,9,GTGCCCAACTATTGAGCTCT,0,1914230
ihfAp4,0.1,9,9,GTGAGTATTCAAGAGTATCT,0,1931029
ihfAp4,0.1,9,9,GTGAGCAAAAATCTTGACAT,0,1912094
ihfAp4,0.1,9,9,GTGAGAGACCAGCACAAGAA,0,1931996
ihfAp4,0.1,9,9,GTCTGGAGGTCCACATGGTG,0,1953353
ihfAp4,0.1,9,9,GTCTCACCTTTCACTGTAGT,0,1939829
ihfAp4,0.1,9,9,GTCTATGCTGATATTTTCTC,0,1944968
ihfAp4,0.1,9,9,GTCGGCGAACATGATTTGGT,0,1944192
ihfAp4,0.1,9,9,GTCGCGTCTTCAGTGGTGCT,0,1928593
ihfAp4,0.1,9,9,GTCGCCGTAAATTGGTGGAG,0,1939870
ihfAp4,0.1,9,9,GTCCGGCACATTTACTAGTG,0,1923786
ihfAp4,0.1,9,9,GTCAATGTTACATAAATTAC,0,1911834
ihfAp4,0.1,9,9,GTCAAACCGAAGCAAAGCTA,0,1952854
ihfAp4,0.1,9,9,GTAGTTCCACATTGCGTGCG,0,1923894
ihfAp4,0.1,9,9,GTAGCTCAAGGCGGTATATC,0,1932794
ihfAp4,0.1,9,9,GTACACCATAGTAAGAGAAT,0,1919856
ihfAp4,0.1,9,9,GTAATTTGCGCGAGTCTTTG,0,1917457
ihfAp4,0.1,9,9,GGTTTTCATCATACCTAGTT,0,1910322
ihfAp4,0.1,9,9,GGTTCGGGATTCTGTGGGAA,0,1934434
ihfAp4,0.1,9,9,GGTGGTAACGGACGAGCCTG,0,1954245
ihfAp4,0.1,9,9,GGTGGCTACTAGACGTCAAA,0,1931935
ihfAp4,0.1,9,9,GGTGCTTACATTTGGGATGG,0,1922627
ihfAp4,0.1,9,9,GGTCCCGGGTCGACAGCAAC,0,1949875
ihfAp4,0.1,9,9,GGGTGGCGGGGAAGGTCTAC,0,1911537
ihfAp4,0.1,9,9,GGGTCGTCCTGGAGGGCGCA,0,1929117
ihfAp4,0.1,9,9,GGGTATACAATAGGAGGAAC,0,1912118
ihfAp4,0.1,9,9,GGGGGCCAGGAACTTTTCCG,0,1938201
ihfAp4,0.1,9,9,GGGCTAAGAATAGTCTGTAC,0,1955978
ihfAp4,0.1,9,9,GGGCGACCGCCGAATACTAT,0,1941177
ihfAp4,0.1,9,9,GGGCAACTAATCGCAAGAAC,0,1941534
ihfAp4,0.1,9,9,GGGAGGTATCAAGGAGGTAG,0,1913537
ihfAp4,0.1,9,9,GGGACAGAAATGATAATCTG,0,1959118
ihfAp4,0.1,9,9,GGGAAAGACAACCCGAATTT,0,1954221
ihfAp4,0.1,9,9,GGCTGCCCACTGTGGTGTGA,0,1954908
ihfAp4,0.1,9,9,GGCTATGAGGCTCCTCGCGC,0,1915882
ihfAp4,0.1,9,9,GGCATGTAAATCAAATATCA,0,1923954
ihfAp4,0.1,9,9,GGCAATCCTGGGAAGGACAA,0,1945842
ihfAp4,0.1,9,9,GGAGTCCCTAGGATTAGCGA,0,1931170
ihfAp4,0.1,9,9,GGAAGCTATGGCCTCTAGGC,0,1936070
ihfAp4,0.1,9,9,GGAAGACCACACCGTTTATT,0,1920953
ihfAp4,0.1,9,9,GCTTCGAAGCAATCGGCCAC,0,1957835
ihfAp4,0.1,9,9,GCTTAGGCCGCCCCTATTTC,0,1920839
ihfAp4,0.1,9,9,GCTGCGCTCGGTCAGGGCTA,0,1956906
ihfAp4,0.1,9,9,GCGTTCCACAATATGGTATA,0,1958747
ihfAp4,0.1,9,9,GCGTATCGATCAACGGCGGG,0,1945359
ihfAp4,0.1,9,9,GCGCCGTCACACACACATAG,0,1938103
ihfAp4,0.1,9,9,GCGAGGACAGTGAGTCCTTG,0,1943792
ihfAp4,0.1,9,9,GCCTTCCATGTCATTGCCAG,0,1947654
ihfAp4,0.1,9,9,GCCGTTTAACAGTTATGCGC,0,1952252
ihfAp4,0.1,9,9,GCCGGGTTTAACCAGTACGC,0,1910937
ihfAp4,0.1,9,9,GCCGGCAGGCTTGATGACAC,0,1930909
ihfAp4,0.1,9,9,GCCGCCAGGGAGCCATCGGG,0,1923343
ihfAp4,0.1,9,9,GCCGACGGATTTAGAAACCA,0,1949135
ihfAp4,0.1,9,9,GCCCAGGCCGAAAAAGAGTT,0,1960412
ihfAp4,0.1,9,9,GCCATTCGAAGGAGGTAGCC,0,1941915
ihfAp4,0.1,9,9,GCCATGCTGCGCCGACTGAC,0,1911555
ihfAp4,0.1,9,9,GCCACTCAGGATCACGAAAA,0,1948751
ihfAp4,0.1,9,9,GCCACAGGGGGTTCTGCGAG,0,1945761
ihfAp4,0.1,9,9,GCAGTTCCGCACCCGTTTGC,0,1951223
ihfAp4,0.1,9,9,GCACGGACAACAGCAGTGTA,0,1923740
ihfAp4,0.1,9,9,GCACAGGCCGTCCATGTAAT,0,1959442
ihfAp4,0.1,9,9,GCAAGGGTGTCTCTGCCATG,0,1931454
ihfAp4,0.1,9,9,GATTTCCCCGGTGGTTATGT,0,1927387
ihfAp4,0.1,9,9,GATTTAACATGGGCGCGAAT,0,1919408
ihfAp4,0.1,9,9,GATTGGCCGTCCGACCATGT,0,1951914
ihfAp4,0.1,9,9,GATTGCGAGGCATGAGCGCA,0,1924680
ihfAp4,0.1,9,9,GATGTGGCGTAAGATGTGGC,0,1923743
ihfAp4,0.1,9,9,GATGCAGCGGTCTCCGCAAC,0,1911693
ihfAp4,0.1,9,9,GATCAACTATACTTAACGTT,0,1933715
ihfAp4,0.1,9,9,GATAGTCGCCGCATTACTAA,0,1943209
ihfAp4,0.1,9,9,GAGTTCTGCCTCGTGCCGAA,0,1923638
ihfAp4,0.1,9,9,GAGTGTGCGTTGCTCCTACA,0,1923637
ihfAp4,0.1,9,9,GAGTGATTTCTAAGGACACG,0,1949926
ihfAp4,0.1,9,9,GAGTCCGAATGGACGCCAGT,0,1933870
ihfAp4,0.1,9,9,GAGGTCTAACAGAGGTAGCA,0,1932080
ihfAp4,0.1,9,9,GAGGGACACGAGATCATGTT,0,1910675
ihfAp4,0.1,9,9,GAGCCAGGTACGCGTCTCCG,0,1917346
ihfAp4,0.1,9,9,GACTATGCGTGTTTCACTAG,0,1951454
ihfAp4,0.1,9,9,GACGTCGATGGTAGATCTTA,0,1922325
ihfAp4,0.1,9,9,GACGGCTGGACCTGGAGCCC,0,1911119
ihfAp4,0.1,9,9,GACATCTTAGTTCCATCGGC,0,1934679
ihfAp4,0.1,9,9,GACAAAGATAGTTTTGAAGG,0,1932096
ihfAp4,0.1,9,9,GAATTGTGTTGGCGCCTGGA,0,1948499
ihfAp4,0.1,9,9,GAAGCTCACGGATGACCGCT,0,1949918
ihfAp4,0.1,9,9,GAACTTGCGTTCAAGTCGAT,0,1910491
ihfAp4,0.1,9,9,GAACAGATGCGTACCAAGGG,0,1918046
ihfAp4,0.1,9,9,GAAATGAAGGGCGGGGTTCG,0,1960831
ihfAp4,0.1,9,9,GAAATCAACGGGGTTGCAAC,0,1939987
ihfAp4,0.1,9,9,CTTGCACGGTGACAAGGAAC,0,1928720
ihfAp4,0.1,9,9,CTTCTTCGAAGGGTCACAGC,0,1942581
ihfAp4,0.1,9,9,CTTCGATCTGTTTTAATCCA,0,1909764
ihfAp4,0.1,9,9,CTTCAGCTTGGCAGTGGTCG,0,1916781
ihfAp4,0.1,9,9,CTGTTCCATGGTATGCGTTT,0,1939062
ihfAp4,0.1,9,9,CTGGGGAGCCTCAGGGCATT,0,1911739
ihfAp4,0.1,9,9,CTGGCACGCGTGGTATAGCT,0,1936366
ihfAp4,0.1,9,9,CTGGCAACCTAAACAGACAA,0,1953058
ihfAp4,0.1,9,9,CTGCCCTAATGTAGGCTCGG,0,1942852
ihfAp4,0.1,9,9,CTCTCCCTCCGTGTTGTGTA,0,1940028
ihfAp4,0.1,9,9,CTCGGGGCAAAACAGTCTTC,0,1927822
ihfAp4,0.1,9,9,CTATATGTACGTGATAGGTG,0,1919724
ihfAp4,0.1,9,9,CTATACTAACATCGCAGAGC,0,1914564
ihfAp4,0.1,9,9,CTATACATCTACGCAAAACC,0,1950076
ihfAp4,0.1,9,9,CTAGGCGTAGCGCGCCATTG,0,1954856
ihfAp4,0.1,9,9,CTAGGAACTAAGAGTCCGCA,0,1929196
ihfAp4,0.1,9,9,CTAGAGTCCCGTTCCGGCGC,0,1960650
ihfAp4,0.1,9,9,CTACTATGTCGCTGTATCTA,0,1935715
ihfAp4,0.1,9,9,CTACAATGGAGCTTCGTCGA,0,1932501
ihfAp4,0.1,9,9,CTAACTATCAGCACACTTGC,0,1955537
ihfAp4,0.1,9,9,CTAACACTAGGGCACTCGAT,0,1943533
ihfAp4,0.1,9,9,CGTTTAGGTCAAGAGGTTAA,0,1913191
ihfAp4,0.1,9,9,CGTTCTTGTAGGAATCGGTA,0,1935725
ihfAp4,0.1,9,9,CGTTAAGTACGTATCTGGTT,0,1919626
ihfAp4,0.1,9,9,CGTGTCATAAGGCGAGGTTA,0,1918691
ihfAp4,0.1,9,9,CGTGGATTTGTGCCCGTTCG,0,1932626
ihfAp4,0.1,9,9,CGTGCCCGGATGGATGGAAA,0,1921109
ihfAp4,0.1,9,9,CGTAACTTCGGCCTCGTTTG,0,1933482
ihfAp4,0.1,9,9,CGGGGTGGTACCCGTGTATA,0,1921243
ihfAp4,0.1,9,9,CGGGCATGCATAAACGGTAC,0,1916030
ihfAp4,0.1,9,9,CGGGAGCCCTTGCTATGCGA,0,1918179
ihfAp4,0.1,9,9,CGGCACTATGTTCACGAGTT,0,1909655
ihfAp4,0.1,9,9,CGGAGGCACAATCTTATCAA,0,1922121
ihfAp4,0.1,9,9,CGCTTGAGAAGTCCTTTACC,0,1912501
ihfAp4,0.1,9,9,CGCTATACCGCATTATCGAG,0,1920347
ihfAp4,0.1,9,9,CGCTACAATGGATGCGGACA,0,1922017
ihfAp4,0.1,9,9,CGCGTCCCGGCTCCTTGTGT,0,1957607
ihfAp4,0.1,9,9,CGCGACTCAGGTCAAACGGT,0,1948708
ihfAp4,0.1,9,9,CGCCGTAATCCCAGTCATTT,0,1913869
ihfAp4,0.1,9,9,CGCCGCGTCAGAATATGAGA,0,1916744
ihfAp4,0.1,9,9,CGCCCCCTCGGACGCCCCGG,0,1931307
ihfAp4,0.1,9,9,CGCACTGTTGATTCGTCTGT,0,1915049
ihfAp4,0.1,9,9,CGATTTTGCCAGTAGTCTTT,0,1924088
ihfAp4,0.1,9,9,CGATTTTATTTGTGAGAGAC,0,1930070
ihfAp4,0.1,9,9,CGATGGGGCCGCTATTAACG,0,1945790
ihfAp4,0.1,9,9,CGAGGGCTACAGGCAATTCG,0,1924020
ihfAp4,0.1,9,9,CGAGGGCAACAGCTACCATC,0,1918020
ihfAp4,0.1,9,9,CGAGGGATCTAAGGCACGGT,0,1960435
ihfAp4,0.1,9,9,CGACGCGTCGAACATGGTCA,0,1931667
ihfAp4,0.1,9,9,CGACGCAGCAAATCTTCAGA,0,1925803
ihfAp4,0.1,9,9,CGAATGTCCCTTAGCCGTGT,0,1928916
ihfAp4,0.1,9,9,CGAAGACGCGTGGGGAGTAT,0,1926068
ihfAp4,0.1,9,9,CCTTTTAGCTAGTCGGATCC,0,1909937
ihfAp4,0.1,9,9,CCTTGAACACAAATAAGAGG,0,1925658
ihfAp4,0.1,9,9,CCTTCCTCGCCTTGCGTAAA,0,1941858
ihfAp4,0.1,9,9,CCTTAAGAAGCCCTTCCTCA,0,1953077
ihfAp4,0.1,9,9,CCTTAACGGTATATAAGTTC,0,1942775
ihfAp4,0.1,9,9,CCTCTGGCTGTGTACCATGT,0,1924402
ihfAp4,0.1,9,9,CCTCTCAAGCGGTGCGATCC,0,1913760
ihfAp4,0.1,9,9,CCTCGCGAGATCAGGACGGG,0,1922894
ihfAp4,0.1,9,9,CCTACTCCCCGAGGAGTAAT,0,1912934
ihfAp4,0.1,9,9,CCGTGGGGCGTAGACAAGAG,0,1936253
ihfAp4,0.1,9,9,CCGTCTCCAGTGTTCGTGAT,0,1941061
ihfAp4,0.1,9,9,CCGGGTAGTGATCCGTTGGA,0,1941067
ihfAp4,0.1,9,9,CCGGCTTCCGAGCCCGAGCA,0,1924829
ihfAp4,0.1,9,9,CCGGCCAAAGGGCGGGGGTG,0,1941322
ihfAp4,0.1,9,9,CCGCATCGATTGATACGCCT,0,1923775
ihfAp4,0.1,9,9,CCGAGACTATCCATGCGAAA,0,1924581
ihfAp4,0.1,9,9,CCGAATTCTAAGGGGTGGTT,0,1949719
ihfAp4,0.1,9,9,CCCTGCATCGGTAGCGAGAG,0,1920286
ihfAp4,0.1,9,9,CCCCGATTTTCCGACTTTGC,0,1946883
ihfAp4,0.1,9,9,CCCAACATTACGCTGAAGGT,0,1909592
ihfAp4,0.1,9,9,CCATTTATTGGATTCCGTTG,0,1940946
ihfAp4,0.1,9,9,CCATCATCCTCGGTCCGAGT,0,1950961
ihfAp4,0.1,9,9,CCAGTCAATTGATGCTTTCC,0,1925545
ihfAp4,0.1,9,9,CCACCGACGTGACACAACCC,0,1947666
ihfAp4,0.1,9,9,CCACATCGCTTTGTACTGCA,0,1946833
ihfAp4,0.1,9,9,CCACATCGACTTAATGTAGT,0,1949623
ihfAp4,0.1,9,9,CCAATGGAGTGCGTCCCCTC,0,1937341
ihfAp4,0.1,9,9,CCAATGATGGAGTCCGCTAT,0,1943873
ihfAp4,0.1,9,9,CCAAGTGTGACTTTGGTTTA,0,1929147
ihfAp4,0.1,9,9,CATTTTGGGGGGTAACAGCT,0,1930096
ihfAp4,0.1,9,9,CATTGCTATACATTGGCTCC,0,1941340
ihfAp4,0.1,9,9,CATGGGTACGTTCGCCCCTG,0,1924657
ihfAp4,0.1,9,9,CATCTTTGTTGTACTCCATT,0,1922652
ihfAp4,0.1,9,9,CATCCCTCCTTAGCCTGGGA,0,1941713
ihfAp4,0.1,9,9,CATAGTAAGCTCGAGACGTT,0,1919117
ihfAp4,0.1,9,9,CATAGCCAGTTTCTGCCACA,0,1944260
ihfAp4,0.1,9,9,CATACGTCGGTTTTCGACTC,0,1909704
ihfAp4,0.1,9,9,CAGTGCATCCAGAGTCACAT,0,1912143
ihfAp4,0.1,9,9,CAGGACCCACGTTATTGTGT,0,1955487
ihfAp4,0.1,9,9,CAGGAAGAAGCAAATTCCTA,0,1926041
ihfAp4,0.1,9,9,CAGATAGGAACATGAACCTT,0,1913469
ihfAp4,0.1,9,9,CAGAGTCGTAGGACGACGCG,0,1932908
ihfAp4,0.1,9,9,CACTACATGTACATATCAAT,0,1925076
ihfAp4,0.1,9,9,CACGGAGCCCCCTCCGCGTT,0,1945686
ihfAp4,0.1,9,9,CACCCTTTGTGTTCACCGCC,0,1934310
ihfAp4,0.1,9,9,CACCCTTCGGCCCAAGCAAG,0,1951145
ihfAp4,0.1,9,9,CACAGCGCCGTACTGGGGTC,0,1950924
ihfAp4,0.1,9,9,CAATAAATGACAACAGGATA,0,1947558
ihfAp4,0.1,9,9,CAAGCGTTTCAGTCTAGCAT,0,1932034
ihfAp4,0.1,9,9,CAAGCAAGTAAGCTATCTGA,0,1937404
ihfAp4,0.1,9,9,CAAGAGCGTGTGACACGGCC,0,1926765
ihfAp4,0.1,9,9,CAACGCTACCGCTGGGGCTC,0,1937914
ihfAp4,0.1,9,9,CAAATACTGCGTTTCTACGA,0,1920602
ihfAp4,0.1,9,9,CAAACTTTAACGTAATAGGA,0,1955571
ihfAp4,0.1,9,9,CAAACTTCAAAATGACCGTG,0,1922570
ihfAp4,0.1,9,9,ATTTTGGTCACAGTTCAGAC,0,1918919
ihfAp4,0.1,9,9,ATTTTCATCGCGCGTGAACT,0,1915699
ihfAp4,0.1,9,9,ATGTGACATGTCAACCCCAA,0,1932360
ihfAp4,0.1,9,9,ATGGGAGGACGGGGATGTTT,0,1914080
ihfAp4,0.1,9,9,ATGCGTGCGGTAAGCATACA,0,1948868
ihfAp4,0.1,9,9,ATGCAGATGATCGCGAACTT,0,1941785
ihfAp4,0.1,9,9,ATGAAGAAAATATACTGTTA,0,1960207
ihfAp4,0.1,9,9,ATCTCTATTCCTTCTGTCAG,0,1919216
ihfAp4,0.1,9,9,ATCGGCTGTATGGAAGATCC,0,1959844
ihfAp4,0.1,9,9,ATCGGCTACCGTGAGGCAAG,0,1927805
ihfAp4,0.1,9,9,ATCGAAGGGGCGATTTACAT,0,1933900
ihfAp4,0.1,9,9,ATCAGCCGGGTGTTGCGAAG,0,1923661
ihfAp4,0.1,9,9,ATATTTGCCCTAACGCGCTG,0,1939810
ihfAp4,0.1,9,9,ATATTCACCGGAGTTCAGAT,0,1924157
ihfAp4,0.1,9,9,ATATCTCCATGCCCCCGAAG,0,1925352
ihfAp4,0.1,9,9,ATAGCTCTAATGCGGACATC,0,1943120
ihfAp4,0.1,9,9,ATACGCTCGCGTTTAAAACT,0,1945807
ihfAp4,0.1,9,9,ATACAACGCGGAGTATTGAA,0,1934395
ihfAp4,0.1,9,9,ATAAGTAGGTTCTTAATTCA,0,1946928
ihfAp4,0.1,9,9,AGTTCGTGACTCGGGATCTC,0,1910311
ihfAp4,0.1,9,9,AGTTCGCGCAAGAGTAGGGA,0,1939548
ihfAp4,0.1,9,9,AGTTCATCGATGTGGGTACA,0,1923090
ihfAp4,0.1,9,9,AGTGCTTGTCGGTGCAACAA,0,1940529
ihfAp4,0.1,9,9,AGTCAGGAGTGGTCATACGC,0,1923118
ihfAp4,0.1,9,9,AGGTGTTTCATGACTGAGAC,0,1911045
ihfAp4,0.1,9,9,AGGGCCAGGGTAAAATTCAG,0,1922214
ihfAp4,0.1,9,9,AGGCCTGAAGGACCCAGCAT,0,1927733
ihfAp4,0.1,9,9,AGGCAGTTCGAGGACAATCA,0,1948090
ihfAp4,0.1,9,9,AGCTCCGCACGTGATCCCCA,0,1934061
ihfAp4,0.1,9,9,AGCGTACCGAAATAAACAAT,0,1936006
ihfAp4,0.1,9,9,AGCGGAAGTGTATGAGGATC,0,1953247
ihfAp4,0.1,9,9,AGCGAGACATCTCATCCGAC,0,1911493
ihfAp4,0.1,9,9,AGACTGCGTTTTTGTCTCTA,0,1925649
ihfAp4,0.1,9,9,AGACACCTATCTTTACCCCC,0,1938872
ihfAp4,0.1,9,9,ACTGGCGTCAAAAACTCGGA,0,1912003
ihfAp4,0.1,9,9,ACTCTCGTGACGGTTTGTTG,0,1951017
ihfAp4,0.1,9,9,ACGTGCCGCTTTCAGTGGCC,0,1924306
ihfAp4,0.1,9,9,ACGGGGTGAATGTAGTGTTT,0,1958192
ihfAp4,0.1,9,9,ACGGGATAGTCCCCCATGAA,0,1921628
ihfAp4,0.1,9,9,ACGGCTCGGCTAGTCATTCG,0,1932947
ihfAp4,0.1,9,9,ACGGCATTTATTCTCGACCA,0,1941848
ihfAp4,0.1,9,9,ACGGAACGTGCTGCGTGGAT,0,1948650
ihfAp4,0.1,9,9,ACGCTTGAGTCATTTACTGA,0,1913423
ihfAp4,0.1,9,9,ACGCGCACTCGTTCTGGGCG,0,1912209
ihfAp4,0.1,9,9,ACGCCCACGATTAGAACGAT,0,1917472
ihfAp4,0.1,9,9,ACGCACTGGACACTATGTCG,0,1921328
ihfAp4,0.1,9,9,ACGATGAGGCCCGGCTTCAA,0,1941460
ihfAp4,0.1,9,9,ACCCATATGGTAAGAGCTCA,0,1915229
ihfAp4,0.1,9,9,ACCAACTTACTCCCACCCAG,0,1918245
ihfAp4,0.1,9,9,ACAGTTGGTCGCCGTCACCG,0,1961107
ihfAp4,0.1,9,9,ACAGTCGTGGAAACAGACTA,0,1955653
ihfAp4,0.1,9,9,ACAGGGCCGTATGTTACCAT,0,1935204
ihfAp4,0.1,9,9,ACAGCGACCGCGGAGCGTGA,0,1910592
ihfAp4,0.1,9,9,ACACAATTCGCTCCCTTGTT,0,1919102
ihfAp4,0.1,9,9,AATTAAGTTGCTTTGCCTAG,0,1932410
ihfAp4,0.1,9,9,AATGGTGTGAATCGTCTTTA,0,1929508
ihfAp4,0.1,9,9,AATGGAGTACCGCAAGAGCC,0,1931954
ihfAp4,0.1,9,9,AATCCACAGGAGCGTGGGTG,0,1931357
ihfAp4,0.1,9,9,AAGTTGTTCGGCCTTGATCC,0,1925577
ihfAp4,0.1,9,9,AAGTTAGGGACACAAACAAG,0,1956586
ihfAp4,0.1,9,9,AAGTCGCGTTTGAAGGCTAT,0,1940832
ihfAp4,0.1,9,9,AAGGGCCGAGCCGCCCTGAT,0,1950875
ihfAp4,0.1,9,9,AAGCTGACAAGGCATCGGAC,0,1939130
ihfAp4,0.1,9,9,AAGCTCGACCCGTGTGCCGT,0,1931188
ihfAp4,0.1,9,9,AAGCGGGTCAGGAACAAGGT,0,1958273
ihfAp4,0.1,9,9,AAGATTTGGGCATGTTCGCC,0,1916386
ihfAp4,0.1,9,9,AACGAGATGCGGTTCACTCT,0,1913751
ihfAp4,0.1,9,9,AACCCATGAAGACTTCGTTG,0,1937237
ihfAp4,0.1,9,9,AAATCATGGGAAGCATCAGC,0,1934862
ihfAp4,0.1,9,9,AAAGGTGACACACGATTATG,0,1938090
ihfAp4,0.1,9,9,AAAATTTTCAGCACGGCCTA,0,1961678
ihfAp4,0.1111111111111111,8,8,TTTCCATGGTATCAGCGCGA,0,1957651
ihfAp4,0.1111111111111111,8,8,TTTATGGGCTGGTAATTACT,0,1950410
ihfAp4,0.1111111111111111,8,8,TTTATATATGGATCGGAAGA,0,1944360
ihfAp4,0.1111111111111111,8,8,TTTAGACCCTACCGCGTCTA,0,1958661
ihfAp4,0.1111111111111111,8,8,TTGTTCTCGGCGACAGCCAC,0,1925324
ihfAp4,0.1111111111111111,8,8,TTGTTCCGATGAGACTTTTT,0,1932072
ihfAp4,0.1111111111111111,8,8,TTGTTAGGACGTAAATCTTC,0,1946610
ihfAp4,0.1111111111111111,8,8,TTGGGGTTGTAGATATATCC,0,1938069
ihfAp4,0.1111111111111111,8,8,TTGCGTATGAACGACTACAT,0,1921226
ihfAp4,0.1111111111111111,8,8,TTGCCCTAGTTGCCGCGATA,0,1920293
ihfAp4,0.1111111111111111,8,8,TTGCCCATTCGACTAACATT,0,1961692
ihfAp4,0.1111111111111111,8,8,TTGAACACTTTCGCCTAGGA,0,1953536
ihfAp4,0.1111111111111111,8,8,TTCGAGATTACGACCCACCG,0,1949482
ihfAp4,0.1111111111111111,8,8,TTCCTCACTTGTAGCACTCC,0,1958697
ihfAp4,0.1111111111111111,8,8,TTCCATGGCGGAGTCACAGG,0,1938682
ihfAp4,0.1111111111111111,8,8,TTCCATACTGAGGCAGGGCT,0,1911319
ihfAp4,0.1111111111111111,8,8,TTCAAGGGGGTGGGTGACAT,0,1921814
ihfAp4,0.1111111111111111,8,8,TTCAAAGTATGTGATCGGTT,0,1957450
ihfAp4,0.1111111111111111,8,8,TTAGGTAACGGAATGGAGGC,0,1919708
ihfAp4,0.1111111111111111,8,8,TTAGGCAGTTACAAGAGCCG,0,1926901
ihfAp4,0.1111111111111111,8,8,TTACTCACTGCCTGGTTCAT,0,1912624
ihfAp4,0.1111111111111111,8,8,TTAATCCCCTTAACTATCTC,0,1940179
ihfAp4,0.1111111111111111,8,8,TGTTCGGGTAAGCCGTAGAT,0,1911618
ihfAp4,0.1111111111111111,8,8,TGTTACTTCACCATCACTTT,0,1930066
ihfAp4,0.1111111111111111,8,8,TGTGTTTTCAGCACTTTCGC,0,1935052
ihfAp4,0.1111111111111111,8,8,TGTGTTTCTAGTTAATGTGG,0,1950257
ihfAp4,0.1111111111111111,8,8,TGTGTTCTAAGGTGTGGACC,0,1960627
ihfAp4,0.1111111111111111,8,8,TGTCCCTGGATTCGGTGATC,0,1953861
ihfAp4,0.1111111111111111,8,8,TGTATGGCACGTAATGCAAG,0,1932545
ihfAp4,0.1111111111111111,8,8,TGGTGTATTCGGGGGTGTGA,0,1937358
ihfAp4,0.1111111111111111,8,8,TGGGGTGCTCTGGTCCTCAA,0,1932592
ihfAp4,0.1111111111111111,8,8,TGGGAATAGGGGCAAAGATT,0,1942141
ihfAp4,0.1111111111111111,8,8,TGGCACTAGGCTATAGGCGC,0,1934113
ihfAp4,0.1111111111111111,8,8,TGGCAAATTCGCACCGGGGT,0,1926716
ihfAp4,0.1111111111111111,8,8,TGGATCTGTTGTATTACGGG,0,1956691
ihfAp4,0.1111111111111111,8,8,TGCGTGACTGTACCTACACT,0,1952852
ihfAp4,0.1111111111111111,8,8,TGCGGCTGCTTTTAATTCGG,0,1941358
ihfAp4,0.1111111111111111,8,8,TGCGGCTCGGTACCGCAACA,0,1909555
ihfAp4,0.1111111111111111,8,8,TGCCTTTAGTTAACACAAAG,0,1934057
ihfAp4,0.1111111111111111,8,8,TGCATTAGCCCCACAGCTAG,0,1934287
ihfAp4,0.1111111111111111,8,8,TGATGGTAGGCACTGGCCCT,0,1953045
ihfAp4,0.1111111111111111,8,8,TGATCTTCAGGTGCGGCGTA,0,1917128
ihfAp4,0.1111111111111111,8,8,TGAGGGAATTGTTCGGATGT,0,1918722
ihfAp4,0.1111111111111111,8,8,TGAGGAGTGCGGACTGGATT,0,1924539
ihfAp4,0.1111111111111111,8,8,TGAGCAAATGTTTTGAGGCC,0,1915202
ihfAp4,0.1111111111111111,8,8,TGACGCGATGCGGGCACATT,0,1917487
ihfAp4,0.1111111111111111,8,8,TGAATTGAAGGATGGGCAAA,0,1921201
ihfAp4,0.1111111111111111,8,8,TGAACCCTACTGTATCAGAT,0,1913485
ihfAp4,0.1111111111111111,8,8,TCTCGGATGGCACAGGCGAC,0,1950486
ihfAp4,0.1111111111111111,8,8,TCTCGCCATGTCCACCAGGT,0,1923605
ihfAp4,0.1111111111111111,8,8,TCTATGTCAGAGTCAAACTC,0,1910205
ihfAp4,0.1111111111111111,8,8,TCTAATGTACTGAAACACGT,0,1930398
ihfAp4,0.1111111111111111,8,8,TCGTTCAGAGGTGCCTTTTT,0,1921169
ihfAp4,0.1111111111111111,8,8,TCGTGTATCTCTGAAAGAGT,0,1961138
ihfAp4,0.1111111111111111,8,8,TCGTCCGTCGTCCGCGGAAC,0,1911589
ihfAp4,0.1111111111111111,8,8,TCGTCCGTACGCCGCGTTCA,0,1933067
ihfAp4,0.1111111111111111,8,8,TCGTAGCAGACACCATTTAT,0,1945500
ihfAp4,0.1111111111111111,8,8,TCGGTTCGCGGAGAAGTGAA,0,1934064
ihfAp4,0.1111111111111111,8,8,TCGGTATGTCGGACTTGCTT,0,1960126
ihfAp4,0.1111111111111111,8,8,TCGGCAGTGAGTCCTATCAT,0,1961193
ihfAp4,0.1111111111111111,8,8,TCGCTGGAACCAAAGTGAGG,0,1942954
ihfAp4,0.1111111111111111,8,8,TCGCACAGAGCCAATGACCT,0,1949220
ihfAp4,0.1111111111111111,8,8,TCGAAATTTCGCTAGTTCCA,0,1957700
ihfAp4,0.1111111111111111,8,8,TCCGCACTGAACAGGCTGGA,0,1913515
ihfAp4,0.1111111111111111,8,8,TCCCGCATAAAAAGTTCGTG,0,1910321
ihfAp4,0.1111111111111111,8,8,TCCCCGTACCGAACGCTAGA,0,1946235
ihfAp4,0.1111111111111111,8,8,TCCCAGAGCGTTAACAAGGA,0,1952790
ihfAp4,0.1111111111111111,8,8,TCCAGTCACTTTAGTACGGC,0,1947148
ihfAp4,0.1111111111111111,8,8,TCCAGGCAAGTAGCTGTTGT,0,1935919
ihfAp4,0.1111111111111111,8,8,TCCACCCGGGTGACCAGCCC,0,1940557
ihfAp4,0.1111111111111111,8,8,TCATGTTGGGTAACGTCTGT,0,1921186
ihfAp4,0.1111111111111111,8,8,TCATCGAGAGGGTCATAAGC,0,1922492
ihfAp4,0.1111111111111111,8,8,TCACCCTGGTGATTATAACA,0,1952873
ihfAp4,0.1111111111111111,8,8,TCACAGGGCGTCTCTGAATG,0,1955066
ihfAp4,0.1111111111111111,8,8,TATTTCCTCGAATGGCTGCT,0,1919640
ihfAp4,0.1111111111111111,8,8,TATGCGTATCCCCAACGAGA,0,1911706
ihfAp4,0.1111111111111111,8,8,TATGATTTGATCGTCGATGA,0,1922456
ihfAp4,0.1111111111111111,8,8,TATCGGGCGTTACGGTATTT,0,1937663
ihfAp4,0.1111111111111111,8,8,TATACGAATGTCACCCGTCT,0,1959049
ihfAp4,0.1111111111111111,8,8,TAGGGAGACTATCTCAGTGG,0,1938375
ihfAp4,0.1111111111111111,8,8,TAGCCTTCAAGCGTATCGGT,0,1934692
ihfAp4,0.1111111111111111,8,8,TAGCAGTATGGTAGAGTAAT,0,1951117
ihfAp4,0.1111111111111111,8,8,TACCGGCGCCAAATCCGTGG,0,1961274
ihfAp4,0.1111111111111111,8,8,TACATGATTTGTGATAGTGT,0,1935244
ihfAp4,0.1111111111111111,8,8,TAACGTGGACATGGCTGACA,0,1928197
ihfAp4,0.1111111111111111,8,8,TAACCACGTCTTGACAGTCG,0,1955572
ihfAp4,0.1111111111111111,8,8,GTTTTTTGGATATAAGGAAG,0,1952392
ihfAp4,0.1111111111111111,8,8,GTTTTAGCCACCAACGAAAG,0,1913337
ihfAp4,0.1111111111111111,8,8,GTTTAAGGAGCGTGTGCATT,0,1910568
ihfAp4,0.1111111111111111,8,8,GTTCTGCGTGTGAATAGCCA,0,1954812
ihfAp4,0.1111111111111111,8,8,GTGTGACTAGGGCACCTAGG,0,1915712
ihfAp4,0.1111111111111111,8,8,GTGGTGTAACTCGATCTTCA,0,1913359
ihfAp4,0.1111111111111111,8,8,GTGGCTGGATTTGCCTTGAG,0,1912404
ihfAp4,0.1111111111111111,8,8,GTGGCGGGGGGCTGGGCCAA,0,1932359
ihfAp4,0.1111111111111111,8,8,GTGACTTGGAACCGTCGCGC,0,1961917
ihfAp4,0.1111111111111111,8,8,GTCTTCAGACGGATGGTTCG,0,1930353
ihfAp4,0.1111111111111111,8,8,GTCTAAACTCGGTTCCTCTG,0,1956128
ihfAp4,0.1111111111111111,8,8,GTCGGTGATCTATGTAGAAC,0,1931266
ihfAp4,0.1111111111111111,8,8,GTCGGCGGAGAGGAAACGGA,0,1909780
ihfAp4,0.1111111111111111,8,8,GTATCGGCTTAGGAAAACTT,0,1919555
ihfAp4,0.1111111111111111,8,8,GTAGACAGATGTCCCAGACT,0,1923810
ihfAp4,0.1111111111111111,8,8,GTACGGAAACCGAATCCGGG,0,1951066
ihfAp4,0.1111111111111111,8,8,GTACCTGACTGTATTTAAAC,0,1950980
ihfAp4,0.1111111111111111,8,8,GTAATGTTTACCTGTGGATT,0,1949344
ihfAp4,0.1111111111111111,8,8,GTAAGTTCGGTGGATTAAAG,0,1934804
ihfAp4,0.1111111111111111,8,8,GTAAAGGCGGCTATTTATCC,0,1938756
ihfAp4,0.1111111111111111,8,8,GGTTTATACAGGTGCAAGGA,0,1914843
ihfAp4,0.1111111111111111,8,8,GGTTCGCTTACGATCAGAGA,0,1929452
ihfAp4,0.1111111111111111,8,8,GGTGTATGTAACGTAATTGT,0,1917767
ihfAp4,0.1111111111111111,8,8,GGTGGTGAAGGAGCCCTTTT,0,1924430
ihfAp4,0.1111111111111111,8,8,GGTGCTCCCTTACAGCGGGA,0,1909936
ihfAp4,0.1111111111111111,8,8,GGTGCGACTCTCCGCGTGGT,0,1956270
ihfAp4,0.1111111111111111,8,8,GGTGCACCTCGATGCATCGA,0,1941559
ihfAp4,0.1111111111111111,8,8,GGTGATTTAGCCCGAAATGT,0,1949690
ihfAp4,0.1111111111111111,8,8,GGTGATTCTTATCTCAAACT,0,1952028
ihfAp4,0.1111111111111111,8,8,GGTGACAGTCACTGTACTAT,0,1929236
ihfAp4,0.1111111111111111,8,8,GGTATTTCCCGCGACGCGAT,0,1926078
ihfAp4,0.1111111111111111,8,8,GGTAAGGGACAGATGCTTAG,0,1937857
ihfAp4,0.1111111111111111,8,8,GGGTCATCCGGAATGACCAC,0,1921815
ihfAp4,0.1111111111111111,8,8,GGGGACGGCCAAGCTGGATC,0,1934443
ihfAp4,0.1111111111111111,8,8,GGGATCCTGTCTACTCGGCC,0,1952329
ihfAp4,0.1111111111111111,8,8,GGGAGCATACCACGCAGCCT,0,1932725
ihfAp4,0.1111111111111111,8,8,GGCTGTTCTTTGGGTATATC,0,1936348
ihfAp4,0.1111111111111111,8,8,GGCTGTGTATGCGAAATAAC,0,1953119
ihfAp4,0.1111111111111111,8,8,GGCTGGGGTTCTGAGCTCGA,0,1921323
ihfAp4,0.1111111111111111,8,8,GGCTGGCCTATGCCCATCTA,0,1960300
ihfAp4,0.1111111111111111,8,8,GGCTCCACGACTTATAGTCG,0,1947290
ihfAp4,0.1111111111111111,8,8,GGCTATTAAATGTTTCACGG,0,1954315
ihfAp4,0.1111111111111111,8,8,GGCGTAGTATGTGACTACAC,0,1938098
ihfAp4,0.1111111111111111,8,8,GGCCGTGCGGGAGTACATGA,0,1927117
ihfAp4,0.1111111111111111,8,8,GGCCAAGCAGGGAATTCCAT,0,1958913
ihfAp4,0.1111111111111111,8,8,GGCAATAATAATGAGGGTGT,0,1923195
ihfAp4,0.1111111111111111,8,8,GGATTCTGAGATTCGCCGAT,0,1932365
ihfAp4,0.1111111111111111,8,8,GGATTAATGTATGCCCCTCA,0,1937568
ihfAp4,0.1111111111111111,8,8,GGAGTGGGTCTTTCTGCTTT,0,1911269
ihfAp4,0.1111111111111111,8,8,GGACCGGTGCCGGTTTGTCT,0,1910534
ihfAp4,0.1111111111111111,8,8,GGACCAGTAGTAGTGCAGGA,0,1917163
ihfAp4,0.1111111111111111,8,8,GGAATCGAAACGTTGTTTTG,0,1941966
ihfAp4,0.1111111111111111,8,8,GGAAGGCAGGAGGCAATGAG,0,1944003
ihfAp4,0.1111111111111111,8,8,GGAACGGATAACGAGGAAAA,0,1945880
ihfAp4,0.1111111111111111,8,8,GGAAACCGCCTCATCTGGCA,0,1948507
ihfAp4,0.1111111111111111,8,8,GCTTCGATAATACTAAAAAC,0,1937313
ihfAp4,0.1111111111111111,8,8,GCTGTTGCCCCATCTTAAAA,0,1960788
ihfAp4,0.1111111111111111,8,8,GCTGTTCTCTCGCACCCAGA,0,1913618
ihfAp4,0.1111111111111111,8,8,GCTGTCGCAGGCGCTTGAAG,0,1956686
ihfAp4,0.1111111111111111,8,8,GCTGGCATAAGGGTTCTAGT,0,1927087
ihfAp4,0.1111111111111111,8,8,GCTGCGGAGACTTGTGAGCG,0,1943481
ihfAp4,0.1111111111111111,8,8,GCTCATAGCAAGTCAATAGA,0,1955520
ihfAp4,0.1111111111111111,8,8,GCTAAGCACAGATGCCGTAT,0,1927588
ihfAp4,0.1111111111111111,8,8,GCGTTTTGGGAGGTTCGCGC,0,1952396
ihfAp4,0.1111111111111111,8,8,GCGTTTGTCAAGAAGACTAG,0,1961824
ihfAp4,0.1111111111111111,8,8,GCGTCAGAGAGAGCATGAAT,0,1938455
ihfAp4,0.1111111111111111,8,8,GCGGCCGTAGGAAGACTCCC,0,1955233
ihfAp4,0.1111111111111111,8,8,GCGATCGGGACAAGCCAAGT,0,1926074
ihfAp4,0.1111111111111111,8,8,GCGATAGAACTGATCGTGTC,0,1929628
ihfAp4,0.1111111111111111,8,8,GCCTTACCACTTGGTTGGTA,0,1929042
ihfAp4,0.1111111111111111,8,8,GCCGGTGCCTTAAGTGATGC,0,1928804
ihfAp4,0.1111111111111111,8,8,GCCGGGGTATCACCTTGTCA,0,1952291
ihfAp4,0.1111111111111111,8,8,GCCCAGACGCGTAAACGTAG,0,1935029
ihfAp4,0.1111111111111111,8,8,GCCCACCCCCGTGAGTGAGC,0,1954628
ihfAp4,0.1111111111111111,8,8,GCCACGCCAAGGATCGCGTT,0,1912007
ihfAp4,0.1111111111111111,8,8,GCATGCCGTTGCTGGGTCCA,0,1918148
ihfAp4,0.1111111111111111,8,8,GCAGGTCGTCTAAGTCCACT,0,1933655
ihfAp4,0.1111111111111111,8,8,GCAGGCTGGACCCCTCGCGA,0,1939937
ihfAp4,0.1111111111111111,8,8,GCAGATGGAGCTGGCGAATG,0,1922431
ihfAp4,0.1111111111111111,8,8,GCACGTTCCCGCTCCGGGAA,0,1947169
ihfAp4,0.1111111111111111,8,8,GCACGGAATTAGTACAAAGG,0,1951233
ihfAp4,0.1111111111111111,8,8,GCACGCTCGGGACGCAATTA,0,1941359
ihfAp4,0.1111111111111111,8,8,GCACCAGATAAAAGGCCTGC,0,1939587
ihfAp4,0.1111111111111111,8,8,GCACAGGGACAGGCGATTCT,0,1920782
ihfAp4,0.1111111111111111,8,8,GCAACGACATCGTAAAAGCA,0,1956653
ihfAp4,0.1111111111111111,8,8,GCAAATCGCTCTCGGAGTCA,0,1926521
ihfAp4,0.1111111111111111,8,8,GCAAAGCCATCTCGGGGGAA,0,1934865
ihfAp4,0.1111111111111111,8,8,GATGGCCCCGTTGGCTGATA,0,1915014
ihfAp4,0.1111111111111111,8,8,GATGACTAGGTTTCCCAATT,0,1944678
ihfAp4,0.1111111111111111,8,8,GAGTGGGTCCTGCCGTCTTA,0,1941656
ihfAp4,0.1111111111111111,8,8,GAGTCAATTCCCACCATTCA,0,1927754
ihfAp4,0.1111111111111111,8,8,GAGTATTGTCGTCCGCCGAT,0,1918023
ihfAp4,0.1111111111111111,8,8,GAGGTCCATACGGTATAGCA,0,1935214
ihfAp4,0.1111111111111111,8,8,GAGACGCTCTCTGCACGAAC,0,1936690
ihfAp4,0.1111111111111111,8,8,GAGACCCGGTCAATTGAATA,0,1940406
ihfAp4,0.1111111111111111,8,8,GACTCTAATTACCCCATGCG,0,1929959
ihfAp4,0.1111111111111111,8,8,GACTAAAAACCACGCGGGCA,0,1944908
ihfAp4,0.1111111111111111,8,8,GACCTTGCCTTGATTCACAC,0,1913398
ihfAp4,0.1111111111111111,8,8,GAATATGCCAATATTTGTGC,0,1921099
ihfAp4,0.1111111111111111,8,8,GAAGGTAAGTGTGTGACCTT,0,1943524
ihfAp4,0.1111111111111111,8,8,GAAGCTCTCCGGTCACGCTC,0,1922508
ihfAp4,0.1111111111111111,8,8,GAACCACATAGGTCGGGGGA,0,1935565
ihfAp4,0.1111111111111111,8,8,GAACACCGGTCGGCCGTCTA,0,1939736
ihfAp4,0.1111111111111111,8,8,GAACAATTGGCTGGATGGGA,0,1910366
ihfAp4,0.1111111111111111,8,8,GAAAAAGTTGTGTCCCGAGA,0,1951142
ihfAp4,0.1111111111111111,8,8,CTTGCAAGCACACAAACGGG,0,1926790
ihfAp4,0.1111111111111111,8,8,CTTCGTGCCGGTTAGTGATG,0,1922527
ihfAp4,0.1111111111111111,8,8,CTTAGCGCTATCGGGGATTA,0,1923573
ihfAp4,0.1111111111111111,8,8,CTTACCGCAACGCGCCCACC,0,1946647
ihfAp4,0.1111111111111111,8,8,CTGGATATTTAAAGCTAGTC,0,1931972
ihfAp4,0.1111111111111111,8,8,CTGGACGCACTGCACGGTCA,0,1957265
ihfAp4,0.1111111111111111,8,8,CTGCTGAAGTCCGGAGATCT,0,1927240
ihfAp4,0.1111111111111111,8,8,CTGCTCTCGTAATGAGAACG,0,1946834
ihfAp4,0.1111111111111111,8,8,CTGCGTCATAGTAGAGTTGC,0,1938768
ihfAp4,0.1111111111111111,8,8,CTGCGCGCAGTTGTCGCTAC,0,1946252
ihfAp4,0.1111111111111111,8,8,CTCTTTACAGTATTCCACAT,0,1943686
ihfAp4,0.1111111111111111,8,8,CTCTAGGTGTGTACGTGGGT,0,1921359
ihfAp4,0.1111111111111111,8,8,CTCATTGAATCACGAGGATC,0,1933470
ihfAp4,0.1111111111111111,8,8,CTCAACCATAGTGGGTACGA,0,1943364
ihfAp4,0.1111111111111111,8,8,CTATTGTATGGCTTACCACG,0,1939417
ihfAp4,0.1111111111111111,8,8,CTATTCTTCTTTTGTCTTGA,0,1940703
ihfAp4,0.1111111111111111,8,8,CTAGATCGAAATGGCTTCAG,0,1928682
ihfAp4,0.1111111111111111,8,8,CTACTATGAGATATCCTGTT,0,1937375
ihfAp4,0.1111111111111111,8,8,CTACAATGTCCATCAGGTCT,0,1930514
ihfAp4,0.1111111111111111,8,8,CTAACTCCAGGTAGAAAGTT,0,1958611
ihfAp4,0.1111111111111111,8,8,CTAACAAAATTCGGACTGAA,0,1940747
ihfAp4,0.1111111111111111,8,8,CTAAATGTCTAAGGTTGCGA,0,1949236
ihfAp4,0.1111111111111111,8,8,CGTTGGAAAGGGTTATGCTA,0,1914316
ihfAp4,0.1111111111111111,8,8,CGTTCGTTAGACGGAACGAC,0,1924147
ihfAp4,0.1111111111111111,8,8,CGTTCGAGTGGTAATGGGAG,0,1944001
ihfAp4,0.1111111111111111,8,8,CGTGTTTAGACGCTACAGAG,0,1925561
ihfAp4,0.1111111111111111,8,8,CGTGGAATAGGACAGGCGGG,0,1917921
ihfAp4,0.1111111111111111,8,8,CGGTCTAAGATTCGCCGTGT,0,1936914
ihfAp4,0.1111111111111111,8,8,CGGCGTTGGTCGCAGCTGCA,0,1961785
ihfAp4,0.1111111111111111,8,8,CGGAGGCAGTAACTGGATAT,0,1949133
ihfAp4,0.1111111111111111,8,8,CGCGCGACCGTAACGTTTTT,0,1919120
ihfAp4,0.1111111111111111,8,8,CGCGACCTCTCGGGGCACCG,0,1950821
ihfAp4,0.1111111111111111,8,8,CGCCGTGCATTGGCTACGAC,0,1928326
ihfAp4,0.1111111111111111,8,8,CGCCCCCTAGGGCACCAGGA,0,1936485
ihfAp4,0.1111111111111111,8,8,CGATAGTAGACTCCCTTCCG,0,1919439
ihfAp4,0.1111111111111111,8,8,CGATAATCACCGGCTGTGCA,0,1936910
ihfAp4,0.1111111111111111,8,8,CGAGTCTGTCTAACACAGGC,0,1951413
ihfAp4,0.1111111111111111,8,8,CGAGGCACAAACCGGGGCTA,0,1943286
ihfAp4,0.1111111111111111,8,8,CGAGAATGGTTAACTGAGCG,0,1936545
ihfAp4,0.1111111111111111,8,8,CGACGAGTATAAATAAGGGT,0,1952755
ihfAp4,0.1111111111111111,8,8,CGAATTCCGGTAAGTAAAGA,0,1928052
ihfAp4,0.1111111111111111,8,8,CGAAGGCTCGGAGACCGCAA,0,1928198
ihfAp4,0.1111111111111111,8,8,CGAACATGTCTAAGACATCG,0,1914413
ihfAp4,0.1111111111111111,8,8,CGAAATCGAAATAAAGTGTG,0,1931281
ihfAp4,0.1111111111111111,8,8,CCTTCATATGTGGGACTGGG,0,1917553
ihfAp4,0.1111111111111111,8,8,CCTGGGTCACTTTAAAACAC,0,1938898
ihfAp4,0.1111111111111111,8,8,CCTGAGAAGGAATTTGACAC,0,1950539
ihfAp4,0.1111111111111111,8,8,CCTCGGAACCTTAGGTTCCC,0,1918986
ihfAp4,0.1111111111111111,8,8,CCTAGCAGGTCGGGCAAGAG,0,1943687
ihfAp4,0.1111111111111111,8,8,CCTACTACGAGTAGCAGAGC,0,1913586
ihfAp4,0.1111111111111111,8,8,CCGGGGCTTCTGTAGGGCGT,0,1957310
ihfAp4,0.1111111111111111,8,8,CCGGCAGTGAACCGTTGATA,0,1933809
ihfAp4,0.1111111111111111,8,8,CCGGAGGTTCGGCCGGCTTG,0,1918643
ihfAp4,0.1111111111111111,8,8,CCGATCTCTGTAAGTGAATG,0,1923285
ihfAp4,0.1111111111111111,8,8,CCGATCCTTGCGGATATCCA,0,1950350
ihfAp4,0.1111111111111111,8,8,CCCTTGGCACGGGCATCCAT,0,1912946
ihfAp4,0.1111111111111111,8,8,CCCTGGTGACAAGAGAAACC,0,1961270
ihfAp4,0.1111111111111111,8,8,CCCGCACTCAGCGTGCGCTT,0,1950079
ihfAp4,0.1111111111111111,8,8,CCCCCCGGGTCAAAAGGTCA,0,1959978
ihfAp4,0.1111111111111111,8,8,CCCAGCACGACCTAGGAATC,0,1961915
ihfAp4,0.1111111111111111,8,8,CCATTTGCCCAAGGCGAGCC,0,1931278
ihfAp4,0.1111111111111111,8,8,CCATTGGACTAGAACCACTA,0,1949047
ihfAp4,0.1111111111111111,8,8,CCATGTTCGGAACGACGATT,0,1942349
ihfAp4,0.1111111111111111,8,8,CCATCCGGAGCTCGAGGTAC,0,1915494
ihfAp4,0.1111111111111111,8,8,CCATCCCTCGTCAGCCGAGT,0,1942570
ihfAp4,0.1111111111111111,8,8,CCAGTACTTAGAACCGTGTG,0,1931404
ihfAp4,0.1111111111111111,8,8,CCAGCGTAAAAGGGCCGATT,0,1922698
ihfAp4,0.1111111111111111,8,8,CCAGAAAGAATAGTATGTTG,0,1929720
ihfAp4,0.1111111111111111,8,8,CCACCCGGGATTAACCGAAT,0,1941103
ihfAp4,0.1111111111111111,8,8,CCACAAGCGGGCAACGCCCT,0,1950840
ihfAp4,0.1111111111111111,8,8,CCAAGAAGGCTACAGCGTGC,0,1955374
ihfAp4,0.1111111111111111,8,8,CATTTGGATGACACGGTAAG,0,1956429
ihfAp4,0.1111111111111111,8,8,CATGTGGGGGTCGGAGGATC,0,1949087
ihfAp4,0.1111111111111111,8,8,CATCTGCGCTGGATGCTGTT,0,1910787
ihfAp4,0.1111111111111111,8,8,CATATCCGCAAACAAGAGGT,0,1921251
ihfAp4,0.1111111111111111,8,8,CATAGAGATGTTATCGACGT,0,1918745
ihfAp4,0.1111111111111111,8,8,CATACTGAGGTTGTAGCAAT,0,1953294
ihfAp4,0.1111111111111111,8,8,CAGTTCTTGTTTGACGGGGA,0,1948035
ihfAp4,0.1111111111111111,8,8,CAGTACGAGGTGGCTTGTAC,0,1934903
ihfAp4,0.1111111111111111,8,8,CAGGTCAACCGTACGAAAAG,0,1944994
ihfAp4,0.1111111111111111,8,8,CAGGGGGCGACATGTTTCTC,0,1922877
ihfAp4,0.1111111111111111,8,8,CAGGGATGCCTTGTATGGAA,0,1920507
ihfAp4,0.1111111111111111,8,8,CAGCTTCAAGGTCGCACCAG,0,1918156
ihfAp4,0.1111111111111111,8,8,CAGCATGGGATTCCAAGGTA,0,1955796
ihfAp4,0.1111111111111111,8,8,CAGAACTCAATGCAGTGCTG,0,1949410
ihfAp4,0.1111111111111111,8,8,CACTTGTAGAGCATACTTGA,0,1910701
ihfAp4,0.1111111111111111,8,8,CACTGCAATAACATGGATTC,0,1938250
ihfAp4,0.1111111111111111,8,8,CACTCTGGACCGCACGCGCA,0,1959658
ihfAp4,0.1111111111111111,8,8,CACGTCTAGGGCGGCGAACG,0,1952564
ihfAp4,0.1111111111111111,8,8,CACCTCAGTTCATACCATTC,0,1922465
ihfAp4,0.1111111111111111,8,8,CACCGCTAACTAGACTCTGA,0,1944402
ihfAp4,0.1111111111111111,8,8,CACAAAGAGCTGATGATGGC,0,1919843
ihfAp4,0.1111111111111111,8,8,CAATCTTGGTTGAGTGCGGC,0,1914707
ihfAp4,0.1111111111111111,8,8,CAATATGATCTCAATCGCGA,0,1950568
ihfAp4,0.1111111111111111,8,8,CAAGTTCGGCCTTCATTCCC,0,1951290
ihfAp4,0.1111111111111111,8,8,CAAGTGTGAACGTACAACGA,0,1959279
ihfAp4,0.1111111111111111,8,8,CAAGTGCACACATGAAAGAT,0,1925954
ihfAp4,0.1111111111111111,8,8,CAAGTCGGAGCGAAGCTAGC,0,1923365
ihfAp4,0.1111111111111111,8,8,CAAGGTTACACAGAAGTGAA,0,1911295
ihfAp4,0.1111111111111111,8,8,CAAGATTTCCAGCGGCGCTA,0,1911845
ihfAp4,0.1111111111111111,8,8,CAAATGGGGTACCATCGAGA,0,1911456
ihfAp4,0.1111111111111111,8,8,CAAATATGCGGGGGTAAGAA,0,1917756
ihfAp4,0.1111111111111111,8,8,ATTTGTGTCTTATATAACAC,0,1913611
ihfAp4,0.1111111111111111,8,8,ATTTGGCACTGAGTGGCAAG,0,1922972
ihfAp4,0.1111111111111111,8,8,ATTGACAGCGTCAGCGACCG,0,1923547
ihfAp4,0.1111111111111111,8,8,ATTCGAGGGTGAACGGGAGA,0,1943384
ihfAp4,0.1111111111111111,8,8,ATTAGCGATGAAGAATTAAC,0,1956921
ihfAp4,0.1111111111111111,8,8,ATTACTGGGCAGGCGTAATA,0,1916520
ihfAp4,0.1111111111111111,8,8,ATGGTACATGCACGGGAATT,0,1912182
ihfAp4,0.1111111111111111,8,8,ATGGCACACCTCTCAAAGCC,0,1929814
ihfAp4,0.1111111111111111,8,8,ATGGATCAAGGTAGAACCAG,0,1945114
ihfAp4,0.1111111111111111,8,8,ATGCCGTGTACAATAAAAAG,0,1961816
ihfAp4,0.1111111111111111,8,8,ATGCAATCCAGAAGTATATA,0,1914873
ihfAp4,0.1111111111111111,8,8,ATGATGGGTTTGTTCGCAGA,0,1961721
ihfAp4,0.1111111111111111,8,8,ATCTTTCAGGGTGATCACTG,0,1955131
ihfAp4,0.1111111111111111,8,8,ATCTCTATGCCTAGATTGAA,0,1961161
ihfAp4,0.1111111111111111,8,8,ATCTAATGCACGGATTCTAA,0,1918518
ihfAp4,0.1111111111111111,8,8,ATCGTTATGGACAGGTGCTA,0,1939703
ihfAp4,0.1111111111111111,8,8,ATCGTGCTCGGGTCCATAGG,0,1957571
ihfAp4,0.1111111111111111,8,8,ATCGCGGCATTCTATACATG,0,1913752
ihfAp4,0.1111111111111111,8,8,ATCCTGCGCACATCGCGCGT,0,1930200
ihfAp4,0.1111111111111111,8,8,ATAGGTCGGAGGTCGGGCGA,0,1910226
ihfAp4,0.1111111111111111,8,8,ATACTAATCGGCGCAGGAAG,0,1945094
ihfAp4,0.1111111111111111,8,8,ATACCGAGCTAGAAATCGAA,0,1934678
ihfAp4,0.1111111111111111,8,8,ATAAGTGTGAGCGGGAGCGT,0,1937318
ihfAp4,0.1111111111111111,8,8,AGTTTCCGCCACTTTTCAGT,0,1921170
ihfAp4,0.1111111111111111,8,8,AGTTCCAACAGTTAGACCTT,0,1960404
ihfAp4,0.1111111111111111,8,8,AGTGGACGAGACAGAGGAAG,0,1926598
ihfAp4,0.1111111111111111,8,8,AGTGCGTAGAGAAAGGCTCA,0,1958228
ihfAp4,0.1111111111111111,8,8,AGTGCGGCACTGAACCCGAC,0,1928190
ihfAp4,0.1111111111111111,8,8,AGTCCGGAAGTTTTAGTCAA,0,1960184
ihfAp4,0.1111111111111111,8,8,AGTAAAAATAGAAAGACTCA,0,1915026
ihfAp4,0.1111111111111111,8,8,AGGTGAGTCACTTCGAACAA,0,1921491
ihfAp4,0.1111111111111111,8,8,AGGGGTTATGTCATCTCTAT,0,1943293
ihfAp4,0.1111111111111111,8,8,AGGCGTTCGGAGGTGTGACA,0,1955860
ihfAp4,0.1111111111111111,8,8,AGGATCGCCCACTTAACCAC,0,1958407
ihfAp4,0.1111111111111111,8,8,AGGACGTGTGTACAAAAAGA,0,1920929
ihfAp4,0.1111111111111111,8,8,AGGACCACCGGGGGCTGATG,0,1924507
ihfAp4,0.1111111111111111,8,8,AGGAAGGCTAATGGTGCGTA,0,1952868
ihfAp4,0.1111111111111111,8,8,AGCTGGCTACTGAGTTCTTT,0,1932399
ihfAp4,0.1111111111111111,8,8,AGCTACCGCATCCGAGAGGC,0,1925110
ihfAp4,0.1111111111111111,8,8,AGCGAGGGAGCACGGTACAC,0,1914462
ihfAp4,0.1111111111111111,8,8,AGCAGTGGCTATATCCCACT,0,1952474
ihfAp4,0.1111111111111111,8,8,AGCAAGTCAGCTAAAAAATG,0,1950301
ihfAp4,0.1111111111111111,8,8,AGATTTACGGTCCCGGATAT,0,1917309
ihfAp4,0.1111111111111111,8,8,AGATGTCATTACCATATGCA,0,1935104
ihfAp4,0.1111111111111111,8,8,AGATGCGTACTGTATGACAC,0,1937760
ihfAp4,0.1111111111111111,8,8,AGATCTATTCAGGTCCTCGG,0,1925249
ihfAp4,0.1111111111111111,8,8,AGATAGACGGTCGAATATAT,0,1929533
ihfAp4,0.1111111111111111,8,8,ACTTTGGTATTCCAGTAATC,0,1942789
ihfAp4,0.1111111111111111,8,8,ACTTCTGTACGACAGATCGT,0,1940827
ihfAp4,0.1111111111111111,8,8,ACTGTTGGATCTGGACACCG,0,1943874
ihfAp4,0.1111111111111111,8,8,ACTGCTATGTGCCTGGGGTT,0,1928499
ihfAp4,0.1111111111111111,8,8,ACTATGGCGATGTGCATTCA,0,1921207
ihfAp4,0.1111111111111111,8,8,ACTATGGCAGTCAGGTCGGT,0,1940875
ihfAp4,0.1111111111111111,8,8,ACTATATTCGGCCGTGGGCA,0,1935720
ihfAp4,0.1111111111111111,8,8,ACGTGTGTGGCCCGTTAGAA,0,1918849
ihfAp4,0.1111111111111111,8,8,ACGTGAATTGATTCGCTTGA,0,1930825
ihfAp4,0.1111111111111111,8,8,ACGTATCGTTCGTTGTGCAT,0,1935891
ihfAp4,0.1111111111111111,8,8,ACGGTCAATCGTATTCAAGG,0,1926962
ihfAp4,0.1111111111111111,8,8,ACGGGTGCGTCCGTCCGCGG,0,1950525
ihfAp4,0.1111111111111111,8,8,ACGGCGGGCCGGACTTGTCG,0,1942097
ihfAp4,0.1111111111111111,8,8,ACGGAAAGCGAGGCTAATAT,0,1949586
ihfAp4,0.1111111111111111,8,8,ACGCGCTGTCTAATCCTGTC,0,1935461
ihfAp4,0.1111111111111111,8,8,ACGCGCGAATTTGTTACGAG,0,1921173
ihfAp4,0.1111111111111111,8,8,ACGCGACTCTGCCCTACGCA,0,1951351
ihfAp4,0.1111111111111111,8,8,ACGACATGTTGGAGCCTTCC,0,1952283
ihfAp4,0.1111111111111111,8,8,ACCTTTATCCGTGCTCTACC,0,1933497
ihfAp4,0.1111111111111111,8,8,ACCTTGGGACGACAGCAGCA,0,1923068
ihfAp4,0.1111111111111111,8,8,ACCTACCGGTGCCTGCTCCA,0,1935089
ihfAp4,0.1111111111111111,8,8,ACCGATTTCGGAATAGGGGT,0,1958742
ihfAp4,0.1111111111111111,8,8,ACCGATCCACGCGAAAAAAA,0,1937347
ihfAp4,0.1111111111111111,8,8,ACCCCCGAGTAGGTCTTAGT,0,1926668
ihfAp4,0.1111111111111111,8,8,ACCATGTTGGTGGACGCCGG,0,1928799
ihfAp4,0.1111111111111111,8,8,ACATTCGTCTCGCCCAGGCT,0,1916266
ihfAp4,0.1111111111111111,8,8,ACATGGTCCAGAGATCACAA,0,1928212
ihfAp4,0.1111111111111111,8,8,ACATAGGAACACTCAGGCGA,0,1914842
ihfAp4,0.1111111111111111,8,8,ACAGCTGCAAGCATCGATAA,0,1955323
ihfAp4,0.1111111111111111,8,8,ACAGCTACCCGGAAGCTCCC,0,1951794
ihfAp4,0.1111111111111111,8,8,ACAGCCGCCCGGGGAGAGTA,0,1929301
ihfAp4,0.1111111111111111,8,8,ACACCCATAGCCATTCCTGA,0,1923086
ihfAp4,0.1111111111111111,8,8,ACAAGCAGACATGGGGCACC,0,1936416
ihfAp4,0.1111111111111111,8,8,ACAAAAGTAGGCGTTGCTCT,0,1933693
ihfAp4,0.1111111111111111,8,8,AATTTCGGGGTGGGGAAACT,0,1947288
ihfAp4,0.1111111111111111,8,8,AATTCCGGGTTCCGTACACT,0,1946778
ihfAp4,0.1111111111111111,8,8,AATGTCGCAGTACACATTGA,0,1910207
ihfAp4,0.1111111111111111,8,8,AATCGATTGGAAGACTACGC,0,1933703
ihfAp4,0.1111111111111111,8,8,AATCCGTAGTCCATTGGCTC,0,1922167
ihfAp4,0.1111111111111111,8,8,AATCACCCAACTGTCGCTAT,0,1940714
ihfAp4,0.1111111111111111,8,8,AATACGTGCGAGCACATCAG,0,1928401
ihfAp4,0.1111111111111111,8,8,AAGTGGGAAAAGGGCACATA,0,1919552
ihfAp4,0.1111111111111111,8,8,AAGTCCACCAAAGACTTGTA,0,1911640
ihfAp4,0.1111111111111111,8,8,AAGTACCTGACCCGGGTGAG,0,1959194
ihfAp4,0.1111111111111111,8,8,AAGGGATCTCATCAGACATT,0,1918100
ihfAp4,0.1111111111111111,8,8,AAGCTTGTGCGTACCAGAAA,0,1914572
ihfAp4,0.1111111111111111,8,8,AACGTGATTATAGGATACGG,0,1912264
ihfAp4,0.1111111111111111,8,8,AACGTCCGCTAACCCGTTTG,0,1913122
ihfAp4,0.1111111111111111,8,8,AACCCTTACATGCAAATGGC,0,1951721
ihfAp4,0.1111111111111111,8,8,AAATTAAGGCCTAATGACAT,0,1920803
ihfAp4,0.1111111111111111,8,8,AAATGGAAAGTTAGCCGCGG,0,1917745
ihfAp4,0.1111111111111111,8,8,AAATCATAAATACGTCGGTC,0,1911649
ihfAp4,0.1111111111111111,8,8,AAATACTCGTGCGGAACGGG,0,1914365
ihfAp4,0.1111111111111111,8,8,AAACCTGGCGCGTTTTGGGG,0,1938323
ihfAp4,0.1111111111111111,8,8,AAAAGACGTGGGTCGCGTGA,0,1921818
ihfAp4,0.1111111111111111,8,8,AAAACGGTTTCCTTAGACGG,0,1940417
ihfAp4,0.125,7,7,TTTTTTTAAGTCCTGAACAT,0,1916412
ihfAp4,0.125,7,7,TTTTAATGGGGGACGGTTTC,0,1944404
ihfAp4,0.125,7,7,TTTGGCTGCTAAGTCGATCG,0,1916928
ihfAp4,0.125,7,7,TTTCGTTCAGAAGGCATCCA,0,1944162
ihfAp4,0.125,7,7,TTTCGAGCCATGCACTACAG,0,1949799
ihfAp4,0.125,7,7,TTTACACATCGCAGCCCGCG,0,1951050
ihfAp4,0.125,7,7,TTGTGTGAAATCTTGGGTCA,0,1929915
ihfAp4,0.125,7,7,TTGGTCATATGTGAACTTTG,0,1952930
ihfAp4,0.125,7,7,TTGGGAACGGTGTAGCGTAG,0,1960735
ihfAp4,0.125,7,7,TTGGCCCGAGCCAGTTCAGG,0,1948748
ihfAp4,0.125,7,7,TTGAATGCCTTGCATCGAAT,0,1915823
ihfAp4,0.125,7,7,TTGAAAAACCGGTGGTAATG,0,1953172
ihfAp4,0.125,7,7,TTCGGTGTCCGGTACGCGTT,0,1930940
ihfAp4,0.125,7,7,TTCCGAAGGCGTGCGGGACC,0,1948352
ihfAp4,0.125,7,7,TTCACCTAACGAAGGCGGAG,0,1911296
ihfAp4,0.125,7,7,TTCAACTGAACTATTGAAGA,0,1920891
ihfAp4,0.125,7,7,TTATTGTCGCCGGCGTCCGC,0,1913910
ihfAp4,0.125,7,7,TTATACGTCAGGTCTATTGC,0,1919300
ihfAp4,0.125,7,7,TTAGCTCTGTGAGGTGGGCT,0,1950788
ihfAp4,0.125,7,7,TTAGCAATGACAGCAAGCAA,0,1954018
ihfAp4,0.125,7,7,TTAGAGCTACATACGGTATG,0,1946110
ihfAp4,0.125,7,7,TTAGAAAACCACCTGTACAC,0,1950174
ihfAp4,0.125,7,7,TTAAGTAAACCACATATGTT,0,1929616
ihfAp4,0.125,7,7,TTAAATGCGCGCTCGCCTGG,0,1940443
ihfAp4,0.125,7,7,TGTTTTAGTTAACCGGCTTC,0,1910708
ihfAp4,0.125,7,7,TGTTGTCTCCGAGAGATCTC,0,1918915
ihfAp4,0.125,7,7,TGTTCCGGTGTGGCATTGTA,0,1944413
ihfAp4,0.125,7,7,TGTTCCGAAAGGCACACCTA,0,1939335
ihfAp4,0.125,7,7,TGTGGCGGTGAACCGTATTC,0,1922342
ihfAp4,0.125,7,7,TGGTTCGCAGCTAGTCCTCA,0,1952728
ihfAp4,0.125,7,7,TGGTCGTTGAGCTCGGGAAT,0,1914848
ihfAp4,0.125,7,7,TGGTCACAACATGCGAATTA,0,1930301
ihfAp4,0.125,7,7,TGGGTGCAACATCTACTGCT,0,1943562
ihfAp4,0.125,7,7,TGGGGCTGTTGTGTGCGACA,0,1937707
ihfAp4,0.125,7,7,TGGGATCGGGAATAGAATAC,0,1934731
ihfAp4,0.125,7,7,TGGCTTTAGGCTCTCAATGA,0,1931190
ihfAp4,0.125,7,7,TGGATGAAATATTGATCTTG,0,1915341
ihfAp4,0.125,7,7,TGCGTTGAAGATTAAGACTG,0,1921548
ihfAp4,0.125,7,7,TGCCAGATCTTGTGGAAATG,0,1952450
ihfAp4,0.125,7,7,TGCATTCATGACCCGTAAGA,0,1913455
ihfAp4,0.125,7,7,TGCAGCTCTTTCTGACGACT,0,1957940
ihfAp4,0.125,7,7,TGCACGTTCTTTCACTAAGT,0,1934971
ihfAp4,0.125,7,7,TGCACGAGTGTCTTCTGTAC,0,1954206
ihfAp4,0.125,7,7,TGATGACAGCAAGCTCCAAG,0,1950012
ihfAp4,0.125,7,7,TGACGATGCATGTTGATCGG,0,1944932
ihfAp4,0.125,7,7,TCTTTTCACCAATCCGAGAA,0,1953577
ihfAp4,0.125,7,7,TCTTGGCCTTATTGCTGACG,0,1931500
ihfAp4,0.125,7,7,TCTGGGGGCGATAGGCGTTC,0,1925673
ihfAp4,0.125,7,7,TCTGGCGTTAGTGGACATGG,0,1948138
ihfAp4,0.125,7,7,TCTCTCGTCAATGGTGTCGT,0,1911227
ihfAp4,0.125,7,7,TCTATATCTTTCTAGATTAA,0,1951028
ihfAp4,0.125,7,7,TCTAGCTGGTTAACGGGCCT,0,1925012
ihfAp4,0.125,7,7,TCTACGTGGAGCGTCGTCTC,0,1956344
ihfAp4,0.125,7,7,TCGTTGCCTAGTGAGTTCAA,0,1951237
ihfAp4,0.125,7,7,TCGTTCATCTGTCGTGGGGT,0,1957938
ihfAp4,0.125,7,7,TCGTGTGCGGAAGAGCCCAA,0,1934151
ihfAp4,0.125,7,7,TCGTCAGTTAGCGGCTCTCC,0,1958820
ihfAp4,0.125,7,7,TCGTCACAACCTCAGACTGC,0,1923452
ihfAp4,0.125,7,7,TCGTATTCCGATTCTTAGAA,0,1919508
ihfAp4,0.125,7,7,TCGTATCCTCTTCACCCAAA,0,1938207
ihfAp4,0.125,7,7,TCGGACCTTAACAAAAGTGC,0,1927880
ihfAp4,0.125,7,7,TCGCTACATTCCTACAGGCA,0,1930053
ihfAp4,0.125,7,7,TCGATGCGTAAACCCAAAGT,0,1927949
ihfAp4,0.125,7,7,TCGATAAAAGAGGAGGTAAC,0,1924761
ihfAp4,0.125,7,7,TCGAGTCATGCTAGGCCTCG,0,1960379
ihfAp4,0.125,7,7,TCCTTATATTGACCGTATGT,0,1962147
ihfAp4,0.125,7,7,TCCTGGTGCGGGTAGGTTGT,0,1944849
ihfAp4,0.125,7,7,TCCTGCAACCGGGCTGGCCT,0,1924909
ihfAp4,0.125,7,7,TCCTCAGAAACTCAATACTT,0,1945202
ihfAp4,0.125,7,7,TCCCTCAGGAGTTAGAATGA,0,1955387
ihfAp4,0.125,7,7,TCCCGGTGCTAAAAATTGAC,0,1935747
ihfAp4,0.125,7,7,TCCCGGGATTGCTTCTAGAA,0,1958909
ihfAp4,0.125,7,7,TCCCGGATATGACCTGGTTG,0,1960949
ihfAp4,0.125,7,7,TCCCCAGAGCCAGTGCCGGG,0,1961109
ihfAp4,0.125,7,7,TCATTCCGTCAGGGCTAGGT,0,1932801
ihfAp4,0.125,7,7,TCAGGCTCTTAGTGATGCAA,0,1931654
ihfAp4,0.125,7,7,TCACGTGAGGTTCCCTCAAC,0,1929583
ihfAp4,0.125,7,7,TCACGCCCCTCCACCAGATT,0,1962235
ihfAp4,0.125,7,7,TATGGATTACCCGCGACTTT,0,1918558
ihfAp4,0.125,7,7,TATGCCATCGAGGAGGAGAC,0,1937088
ihfAp4,0.125,7,7,TATGCAGAACGAGACCCACG,0,1923413
ihfAp4,0.125,7,7,TATACGCTAACTCCCTCGGA,0,1940301
ihfAp4,0.125,7,7,TAGGGGATGCCTGTGTTAAT,0,1920386
ihfAp4,0.125,7,7,TAGGCCAGAAAACGCACCTG,0,1957237
ihfAp4,0.125,7,7,TAGCTTGTGTTCGGTATTAT,0,1940664
ihfAp4,0.125,7,7,TAGCCACCTTATGTGTCCAG,0,1921155
ihfAp4,0.125,7,7,TAGCAAGCCCCTCCCGGCCT,0,1958364
ihfAp4,0.125,7,7,TAGCAACTCTAGCTGGTGCA,0,1960692
ihfAp4,0.125,7,7,TACTGGTCTAACCGTTTTAT,0,1950516
ihfAp4,0.125,7,7,TACGCGTACGTCGCGCGGGT,0,1937132
ihfAp4,0.125,7,7,TACGAAACGCGTAGAGTACG,0,1931642
ihfAp4,0.125,7,7,TACATTCGATTATAGCATTC,0,1950267
ihfAp4,0.125,7,7,TACAGGTCCATCAGATATGG,0,1960228
ihfAp4,0.125,7,7,TACAGAGCGATCGCGTTGAA,0,1957063
ihfAp4,0.125,7,7,TAAGGGAAGCAGAGGCCAGA,0,1952585
ihfAp4,0.125,7,7,TAAGAGTTGCGTCCTAAATG,0,1915933
ihfAp4,0.125,7,7,TAAGACCTCTCTCTAGCGAG,0,1938456
ihfAp4,0.125,7,7,TAACCGCTAGTGAATCGACT,0,1936066
ihfAp4,0.125,7,7,TAACCCAGCTCGTTCGTCGG,0,1937820
ihfAp4,0.125,7,7,GTTTTCCACTGATGTATCTG,0,1948130
ihfAp4,0.125,7,7,GTTTTATGACTCGTAGGACT,0,1914750
ihfAp4,0.125,7,7,GTTGTTCAATTCGTGCCAGT,0,1951184
ihfAp4,0.125,7,7,GTTGATATCAGAGCAGAATA,0,1933526
ihfAp4,0.125,7,7,GTTGAAACGCAGTTACGATG,0,1952880
ihfAp4,0.125,7,7,GTTAGTGAGATTGGTTGGGA,0,1919177
ihfAp4,0.125,7,7,GTTACAGACCCGGCCCGTAC,0,1943613
ihfAp4,0.125,7,7,GTTAATGCAACATAACGTAA,0,1914514
ihfAp4,0.125,7,7,GTGTTCTATTAAGTGTACGT,0,1949675
ihfAp4,0.125,7,7,GTGTCTACCGGTTGCACAAA,0,1920237
ihfAp4,0.125,7,7,GTGGGAAATACGACGGCACA,0,1916034
ihfAp4,0.125,7,7,GTGCCGCGTCTTTAGCGATA,0,1953268
ihfAp4,0.125,7,7,GTGAGTCAAAAAGGACGTAC,0,1925781
ihfAp4,0.125,7,7,GTGAGCCGCTTTATGCTAAC,0,1958696
ihfAp4,0.125,7,7,GTCTCGGCAGAGCCTGGTTG,0,1933268
ihfAp4,0.125,7,7,GTCGGACGGCTAATGTAAAT,0,1933850
ihfAp4,0.125,7,7,GTCCGTTTAGTATAGGCCAC,0,1941497
ihfAp4,0.125,7,7,GTCCCTCTGTAATTATGGTA,0,1942362
ihfAp4,0.125,7,7,GTCCATCCCTTAATGAGAGC,0,1929820
ihfAp4,0.125,7,7,GTCATTAGTCTCAGCACTGA,0,1932949
ihfAp4,0.125,7,7,GTCACGGACTGTTAGCCAGG,0,1949695
ihfAp4,0.125,7,7,GTATCTGATTGGAGAATTGA,0,1955143
ihfAp4,0.125,7,7,GTATAACAACAGGAATACCC,0,1945154
ihfAp4,0.125,7,7,GTAGACCTGGAGGCTTTAAT,0,1944425
ihfAp4,0.125,7,7,GTACTCGTCCTAACGTTTTT,0,1946922
ihfAp4,0.125,7,7,GTACGGTGTTTTCCTGGCTT,0,1923066
ihfAp4,0.125,7,7,GTACGGTAGCCTTCACGGGT,0,1913863
ihfAp4,0.125,7,7,GTACCCTATCAAAAGTTGTA,0,1931850
ihfAp4,0.125,7,7,GTACATTTAGACCCTTTGCT,0,1945526
ihfAp4,0.125,7,7,GTAATTGGACTCGTGGAGTG,0,1959667
ihfAp4,0.125,7,7,GGTTTGAGGTGTTGGTGTAT,0,1916638
ihfAp4,0.125,7,7,GGTGTTGCGGGGGATGGGCG,0,1930552
ihfAp4,0.125,7,7,GGTGGACTCAACATCCCACG,0,1941620
ihfAp4,0.125,7,7,GGTGCGATCATTAATGGCAA,0,1936962
ihfAp4,0.125,7,7,GGTGCGACAACGAAAACTGT,0,1926611
ihfAp4,0.125,7,7,GGTGATCAGCCAGCGCCTGA,0,1928437
ihfAp4,0.125,7,7,GGTCGTGAGTGCCGGTAACT,0,1920561
ihfAp4,0.125,7,7,GGTCGCGACCGTATGGGGAT,0,1949724
ihfAp4,0.125,7,7,GGTATCTTATTTGCTCATTT,0,1912833
ihfAp4,0.125,7,7,GGTATCGAGTACGAGTCGAA,0,1929932
ihfAp4,0.125,7,7,GGTACTGCACCCCTGTGATT,0,1938587
ihfAp4,0.125,7,7,GGTACTAGATTTCGTCGTCA,0,1932032
ihfAp4,0.125,7,7,GGGGTTGGAGCGCGGAGTAT,0,1936859
ihfAp4,0.125,7,7,GGGGAGCTGCAAACTCCTGC,0,1939348
ihfAp4,0.125,7,7,GGGCTCTCGGAAACAGGGCA,0,1915384
ihfAp4,0.125,7,7,GGGCTCCGGCAGGGGTCACT,0,1942659
ihfAp4,0.125,7,7,GGGCAGGCGGCGCCACCACA,0,1925131
ihfAp4,0.125,7,7,GGGCAGCACCGGGCGTGCAG,0,1922589
ihfAp4,0.125,7,7,GGGATCTCTTTCCCGCCTTA,0,1943712
ihfAp4,0.125,7,7,GGGAGCTGCCGGCGAAACCG,0,1918768
ihfAp4,0.125,7,7,GGGAGCGTTTGCCGTACTCA,0,1919726
ihfAp4,0.125,7,7,GGGAACACGGCGCGCAGCCC,0,1944302
ihfAp4,0.125,7,7,GGGAAAAGATAATAAAAGAG,0,1948880
ihfAp4,0.125,7,7,GGCTTCGAATTGGTTGCCGT,0,1949255
ihfAp4,0.125,7,7,GGCTCCGACCTCAGTGGAGA,0,1951385
ihfAp4,0.125,7,7,GGCTAGGACAGGACCAGAGA,0,1931154
ihfAp4,0.125,7,7,GGCGTGGCAACGATCCACTT,0,1941249
ihfAp4,0.125,7,7,GGCGGTGGCAACGCGACTCA,0,1925670
ihfAp4,0.125,7,7,GGCGCGCCAGATCATAACCC,0,1926481
ihfAp4,0.125,7,7,GGCCGGTAGTATAGGATTGA,0,1930725
ihfAp4,0.125,7,7,GGCCACGGGCAGTTCATAAT,0,1942334
ihfAp4,0.125,7,7,GGCCACCTTTCAACAATCCC,0,1949149
ihfAp4,0.125,7,7,GGCATGTGAACCTCATGAGC,0,1916842
ihfAp4,0.125,7,7,GGCATCTTACTGTGTGGGTC,0,1947376
ihfAp4,0.125,7,7,GGCAGCTACTTCCGTGATAT,0,1936059
ihfAp4,0.125,7,7,GGCAGCGCGCCGGCTCCATG,0,1917476
ihfAp4,0.125,7,7,GGCAGCCAGGTCAGGCGCAT,0,1936034
ihfAp4,0.125,7,7,GGCAGCATTCCTTTCATCAT,0,1918522
ihfAp4,0.125,7,7,GGCAAGAGTGACGTAAGATC,0,1934834
ihfAp4,0.125,7,7,GGAGGAAACGCTGGGGCGCT,0,1913723
ihfAp4,0.125,7,7,GGAGCTACTATCGTGCGTCG,0,1910151
ihfAp4,0.125,7,7,GGAAGGACTCTCACTAGGAA,0,1942129
ihfAp4,0.125,7,7,GGAAAGGCCCCCACTGAATA,0,1939020
ihfAp4,0.125,7,7,GGAAAACTCTGCTTCGATAC,0,1952799
ihfAp4,0.125,7,7,GCTTGTCGCTGCTTGAACGT,0,1915057
ihfAp4,0.125,7,7,GCTTGAGCACGGCGCGCTTA,0,1941256
ihfAp4,0.125,7,7,GCTTGAATGGACCACCCGAT,0,1949856
ihfAp4,0.125,7,7,GCTTATACGCAGAAGGTGTA,0,1957550
ihfAp4,0.125,7,7,GCTGGATTAAGGAGACGGGT,0,1952079
ihfAp4,0.125,7,7,GCTGAGGGGCACCGCGCCAA,0,1919096
ihfAp4,0.125,7,7,GCTCTTTCCGTGCATAAAAT,0,1961547
ihfAp4,0.125,7,7,GCGTTCGCATTGCCGCTCAC,0,1951608
ihfAp4,0.125,7,7,GCGGGGTCCTACATAACATA,0,1956538
ihfAp4,0.125,7,7,GCGGGCGAATACAGGTGCCA,0,1912004
ihfAp4,0.125,7,7,GCGGCGCTGATTTGCAAGAT,0,1913349
ihfAp4,0.125,7,7,GCGCACATCACCCAGGTAAG,0,1945502
ihfAp4,0.125,7,7,GCCTAGGCCAGACAGATCGC,0,1925378
ihfAp4,0.125,7,7,GCCCCTGCTCTTTGAGACCA,0,1956244
ihfAp4,0.125,7,7,GCCAGTTGATGTGCACGGAT,0,1939243
ihfAp4,0.125,7,7,GCCAATGTACCCGTGTGCCC,0,1915029
ihfAp4,0.125,7,7,GCCAAGTTCCGTGCAGGCAT,0,1934432
ihfAp4,0.125,7,7,GCATAGCTGAGGGGACGCAA,0,1949848
ihfAp4,0.125,7,7,GCAGTCTAGTAATTCGACGT,0,1953292
ihfAp4,0.125,7,7,GCACTGAGGCTACCGTCCGT,0,1931409
ihfAp4,0.125,7,7,GCACTCAATTGTGAAGACAT,0,1933302
ihfAp4,0.125,7,7,GCACGACGTGAGAACCGCAA,0,1915620
ihfAp4,0.125,7,7,GCAATCGACTTGTGGTAAGA,0,1910058
ihfAp4,0.125,7,7,GCAACCCGCAGGCCCCTGAG,0,1911104
ihfAp4,0.125,7,7,GCAAACCGACCTTGAACTGG,0,1930465
ihfAp4,0.125,7,7,GATTTCATTCAACAGGTTTA,0,1919565
ihfAp4,0.125,7,7,GATTCAGGATCCTCGGGGAA,0,1914730
ihfAp4,0.125,7,7,GATTATAATGTAGCGAGAGC,0,1936098
ihfAp4,0.125,7,7,GATGTGAGAAGTTTTCGGTG,0,1917678
ihfAp4,0.125,7,7,GATGCTATATTAACCGCTGA,0,1938854
ihfAp4,0.125,7,7,GATGCCTTTTCCGCGTGAGT,0,1935758
ihfAp4,0.125,7,7,GATGATGACGAAAGCAGAGA,0,1909755
ihfAp4,0.125,7,7,GATCGCCAGACCCCGGAACT,0,1928481
ihfAp4,0.125,7,7,GATCGAGTATAGGTTGTCCT,0,1917382
ihfAp4,0.125,7,7,GATCCAACGAGGTTGCGGTA,0,1957413
ihfAp4,0.125,7,7,GAGTGTTGAGTCGAGAATTA,0,1941849
ihfAp4,0.125,7,7,GAGGCTGGCCCCTCGGATAA,0,1945101
ihfAp4,0.125,7,7,GAGCATGCCTGACGTAGATG,0,1915429
ihfAp4,0.125,7,7,GAGACACTAGAAGTTTAACT,0,1942482
ihfAp4,0.125,7,7,GACTATGGGAATACATGTTA,0,1924816
ihfAp4,0.125,7,7,GACTAACTGGCCGCGCAAAT,0,1909805
ihfAp4,0.125,7,7,GACGTGAACCTTAAACTCCA,0,1922429
ihfAp4,0.125,7,7,GACGGTCCTGATAATCCCGC,0,1929839
ihfAp4,0.125,7,7,GACGGCCGCGACCTGCACAG,0,1957710
ihfAp4,0.125,7,7,GACGACGGAAAGGCCATTGA,0,1942266
ihfAp4,0.125,7,7,GACCGCCTATTGCGTTCGGC,0,1945561
ihfAp4,0.125,7,7,GACCCTTGGAACTCAAGCAA,0,1949117
ihfAp4,0.125,7,7,GACCATATCTCGGTCTAACT,0,1923900
ihfAp4,0.125,7,7,GACATTAGTCGAGCTAAGCC,0,1924679
ihfAp4,0.125,7,7,GACATAATCACTTATATATG,0,1930209
ihfAp4,0.125,7,7,GACACACAAGGTGCCGGGAA,0,1919795
ihfAp4,0.125,7,7,GAATGGTCCAAGCGACATGG,0,1935927
ihfAp4,0.125,7,7,GAAGTTTAACTGACAATACA,0,1951126
ihfAp4,0.125,7,7,GAAGGAGTTCGAATGTTCAA,0,1949272
ihfAp4,0.125,7,7,GAAATCACCTGCGAGGCACG,0,1958682
ihfAp4,0.125,7,7,GAAAACTCCATGGATTAGGT,0,1914637
ihfAp4,0.125,7,7,GAAAAAATCTCGGCGCTGAC,0,1938158
ihfAp4,0.125,7,7,CTTTGTACGAGAGCGCCTCA,0,1921894
ihfAp4,0.125,7,7,CTTGGTCAGATGTGATACAA,0,1912631
ihfAp4,0.125,7,7,CTTCCTTTGGCCGCGGAGTG,0,1911388
ihfAp4,0.125,7,7,CTTCATTAATGCCCGACTGT,0,1918823
ihfAp4,0.125,7,7,CTTCACGACGCCGGTCAGGT,0,1959768
ihfAp4,0.125,7,7,CTTACTGCAGAACCCGCGTC,0,1915366
ihfAp4,0.125,7,7,CTTAATAGAAGGAGTAGCTG,0,1930213
ihfAp4,0.125,7,7,CTGTTGCCTCGGCACGGTTT,0,1916122
ihfAp4,0.125,7,7,CTGTTAGCGCAAGTTGGACA,0,1939728
ihfAp4,0.125,7,7,CTGTAGCGAACGTCGTAAGA,0,1940182
ihfAp4,0.125,7,7,CTGGCTACCTTAGAGCCCGA,0,1930499
ihfAp4,0.125,7,7,CTGGCACATTCTCTTCGACC,0,1926603
ihfAp4,0.125,7,7,CTGGACTCAAACCTGCTGTT,0,1920948
ihfAp4,0.125,7,7,CTGCTAAAGGATTAGACAGC,0,1930475
ihfAp4,0.125,7,7,CTGCAGTTTTGGGTTCCGGA,0,1950813
ihfAp4,0.125,7,7,CTGAGCTATGCAGGAGTTAG,0,1923565
ihfAp4,0.125,7,7,CTGAAGTTGCAACGTATTGC,0,1936258
ihfAp4,0.125,7,7,CTCGTCATCCTCCAGAACTG,0,1931891
ihfAp4,0.125,7,7,CTCGTAAGTGTGAGGCCGGG,0,1947713
ihfAp4,0.125,7,7,CTCCGTCGCCTTGTCTTTTT,0,1952992
ihfAp4,0.125,7,7,CTCACACTCTGATCCCTGTC,0,1958145
ihfAp4,0.125,7,7,CTATGGCTAGGCCAACCCAG,0,1926192
ihfAp4,0.125,7,7,CTATATCTACGCGCCGGAAC,0,1926976
ihfAp4,0.125,7,7,CTAGACACATCCCTGCGGTC,0,1917409
ihfAp4,0.125,7,7,CTAGAAGGCGGGGATGAGCT,0,1917451
ihfAp4,0.125,7,7,CTACGCTATGGTGATTTCGT,0,1951619
ihfAp4,0.125,7,7,CTAAGCCTTCGTGGAGCATA,0,1910313
ihfAp4,0.125,7,7,CTAACAGAGACTTCTTACGC,0,1947435
ihfAp4,0.125,7,7,CGTTAGTGCAAGTCATGGAG,0,1940879
ihfAp4,0.125,7,7,CGTGTTCCTCCACAGTGTCA,0,1928060
ihfAp4,0.125,7,7,CGTGTTAACGGGAATAAGGA,0,1926600
ihfAp4,0.125,7,7,CGTGCAAAAGCGAATTGTCC,0,1913953
ihfAp4,0.125,7,7,CGTCGGTCATAGTAAATGAG,0,1922359
ihfAp4,0.125,7,7,CGTCGCTTACCCATGCTTCA,0,1911348
ihfAp4,0.125,7,7,CGTCACGGGGACGGCATGGT,0,1950351
ihfAp4,0.125,7,7,CGTAGTCTACAGAGACTCGG,0,1921859
ihfAp4,0.125,7,7,CGGTCATCACATCTGTGTGC,0,1942585
ihfAp4,0.125,7,7,CGGTAGTGATGCTCTGGGAA,0,1952082
ihfAp4,0.125,7,7,CGGGGCGGAAAGAACGTCAC,0,1940872
ihfAp4,0.125,7,7,CGGGCAGCCCACACGCATTG,0,1929162
ihfAp4,0.125,7,7,CGGGCAAAGGTGACTTCGGT,0,1913186
ihfAp4,0.125,7,7,CGGGATTTAACTACAAGACA,0,1961076
ihfAp4,0.125,7,7,CGGCTATTAATTTGGATAAT,0,1916934
ihfAp4,0.125,7,7,CGGCGCCTCCGACAACCGAC,0,1912050
ihfAp4,0.125,7,7,CGGACTCTCTTTGAGGAGTA,0,1948253
ihfAp4,0.125,7,7,CGGAATGTTTAGATCACAAA,0,1947266
ihfAp4,0.125,7,7,CGGAAGGATGCTAACCGCCA,0,1941056
ihfAp4,0.125,7,7,CGCTTTTGGTAGGGCACGCG,0,1952562
ihfAp4,0.125,7,7,CGCTTAATTGTTCGGGCACC,0,1917367
ihfAp4,0.125,7,7,CGCTGCGCAAGGGCCGCGTG,0,1930915
ihfAp4,0.125,7,7,CGCGGTTGGACCTCTGACAC,0,1914315
ihfAp4,0.125,7,7,CGCGGGCCGCCCAGTCCACG,0,1922896
ihfAp4,0.125,7,7,CGCGGAGGCCGGTAGTCCTT,0,1941496
ihfAp4,0.125,7,7,CGCCTGGTGGACACTGACCC,0,1939255
ihfAp4,0.125,7,7,CGCCCTCGACCGTTGCGTAC,0,1922215
ihfAp4,0.125,7,7,CGCCCCCTTTGCCGAAGTTA,0,1929191
ihfAp4,0.125,7,7,CGCAGAAGAATCAACAGAAT,0,1951131
ihfAp4,0.125,7,7,CGATATGCGTAAATTAGATG,0,1943227
ihfAp4,0.125,7,7,CGATAGGTTCGTCCAACGAC,0,1957941
ihfAp4,0.125,7,7,CGATAATGGTGTAGAATAGA,0,1929355
ihfAp4,0.125,7,7,CGAGGAGCGGTTCTTAGCTC,0,1922368
ihfAp4,0.125,7,7,CGAGACATGCCCTGACTTCC,0,1942849
ihfAp4,0.125,7,7,CGACTCGGCCAGGAGATAGG,0,1924557
ihfAp4,0.125,7,7,CGACGGTGGAAAAGTTAGCC,0,1914646
ihfAp4,0.125,7,7,CGAAGGGACACACCGGTTCA,0,1955137
ihfAp4,0.125,7,7,CGAAGAGATAAGATTGTACT,0,1954100
ihfAp4,0.125,7,7,CCTTTGGCTAATATAGTAAC,0,1953604
ihfAp4,0.125,7,7,CCTTCGCAGAAACTTTCAAG,0,1945601
ihfAp4,0.125,7,7,CCTTACCCGCGAGAAGCCGA,0,1917140
ihfAp4,0.125,7,7,CCTGGTCGCGGTTAGAGGAC,0,1954741
ihfAp4,0.125,7,7,CCTGGAGGTCGGGACCTCAT,0,1928277
ihfAp4,0.125,7,7,CCTCTTCGATCAAAAGACGA,0,1951457
ihfAp4,0.125,7,7,CCTCCGAGAAAGGCATCTTA,0,1934212
ihfAp4,0.125,7,7,CCTACCCCAAGTGCAGTCGG,0,1954528
ihfAp4,0.125,7,7,CCGTCGTAAGTAGACGACGT,0,1916007
ihfAp4,0.125,7,7,CCGGTTTTTCTGGGATTCGT,0,1935940
ihfAp4,0.125,7,7,CCGGTGGGAAGCGATTTTTC,0,1957562
ihfAp4,0.125,7,7,CCGGTCGGGCACCTCAATAT,0,1941137
ihfAp4,0.125,7,7,CCGGGCAAGAATCTCCGCAA,0,1911377
ihfAp4,0.125,7,7,CCGGCTAGTTGCTTGCATGA,0,1914788
ihfAp4,0.125,7,7,CCGGCACCATAAAGATTCGT,0,1951243
ihfAp4,0.125,7,7,CCGCGTGGGGTCTACCGAAA,0,1939133
ihfAp4,0.125,7,7,CCGCCAACCGGTCTCCTAAG,0,1916622
ihfAp4,0.125,7,7,CCCTGTTGGGATTAAGGGGT,0,1937279
ihfAp4,0.125,7,7,CCCTCGACGCGTATATATCA,0,1921907
ihfAp4,0.125,7,7,CCCGTGGTGACTTTATCGGA,0,1932308
ihfAp4,0.125,7,7,CCCGACAATACCCAGTAATG,0,1933650
ihfAp4,0.125,7,7,CCCCCAGATGCTTACCCCGT,0,1921850
ihfAp4,0.125,7,7,CCCAGAAAGAGATATACAGC,0,1948307
ihfAp4,0.125,7,7,CCCAATTGCTTTTCTGAAAG,0,1929344
ihfAp4,0.125,7,7,CCCAAACGCCCCATACCTCA,0,1958399
ihfAp4,0.125,7,7,CCAGTGCGAGATATGCCACT,0,1920942
ihfAp4,0.125,7,7,CCAGAAGCTTCATGGAATGT,0,1938697
ihfAp4,0.125,7,7,CCACTTTGTGGTGGTAGAAC,0,1929448
ihfAp4,0.125,7,7,CCACGGTTACGTCGTCTCCC,0,1912405
ihfAp4,0.125,7,7,CCACGCTTCTTACCCGAATG,0,1913435
ihfAp4,0.125,7,7,CCAACGTTGTGTTTTGTATT,0,1925293
ihfAp4,0.125,7,7,CATTGGGTTCAGGGGGGCAT,0,1949697
ihfAp4,0.125,7,7,CATTGGCATATCCTAAAGTT,0,1946829
ihfAp4,0.125,7,7,CATTGCTCTGCCCTATTGGG,0,1951750
ihfAp4,0.125,7,7,CATTGCAAATTCTGCTTCGG,0,1944226
ihfAp4,0.125,7,7,CATGGATGAATTTTATGTGA,0,1936176
ihfAp4,0.125,7,7,CATGCCTTCAGGCTAGGGCT,0,1949369
ihfAp4,0.125,7,7,CATCGAAATCAATGACTGAT,0,1918526
ihfAp4,0.125,7,7,CATACCTTCATTAATCAAAG,0,1919171
ihfAp4,0.125,7,7,CATAACCATGACAACTGCAG,0,1951456
ihfAp4,0.125,7,7,CAGTGGTGTGAACACTGGTT,0,1959492
ihfAp4,0.125,7,7,CAGTCTACCGCTTGTCAATT,0,1940466
ihfAp4,0.125,7,7,CAGTAGGGGCTTTCAGCTAC,0,1944635
ihfAp4,0.125,7,7,CAGGGAACACGCTACTTTGA,0,1941875
ihfAp4,0.125,7,7,CAGGCGTGCCGACAGCCTTC,0,1920304
ihfAp4,0.125,7,7,CAGGCGACAACAAGGTTCAG,0,1918017
ihfAp4,0.125,7,7,CAGCTCATGACTACGAAGCT,0,1917750
ihfAp4,0.125,7,7,CAGAGTCGGTTAGCTGCACA,0,1957128
ihfAp4,0.125,7,7,CACTTTGTTCATGCGGGAGC,0,1927358
ihfAp4,0.125,7,7,CACTTAGTGTGGGTGCATGT,0,1944837
ihfAp4,0.125,7,7,CACTGCTGGCCGTGAGTCAT,0,1913264
ihfAp4,0.125,7,7,CACTATCTTCGTTCCGGGGA,0,1925075
ihfAp4,0.125,7,7,CACGTATTCCGGGCGATTGT,0,1962072
ihfAp4,0.125,7,7,CACCTCGGCTATCCAGGTGG,0,1919786
ihfAp4,0.125,7,7,CACCACATGGTTTTTTCAGA,0,1915508
ihfAp4,0.125,7,7,CACATGCCTGCTGGGTCGTG,0,1913965
ihfAp4,0.125,7,7,CACATCAAGAACTTGACACT,0,1930456
ihfAp4,0.125,7,7,CACACGCCCGTCTAGATTAG,0,1915021
ihfAp4,0.125,7,7,CAATGCAGAGATTTAGACAC,0,1912973
ihfAp4,0.125,7,7,CAATCGCTAAAGGCCAATGT,0,1936386
ihfAp4,0.125,7,7,CAAGTGTCACTAATCAAGCA,0,1948182
ihfAp4,0.125,7,7,CAAGGCACAGGGCAAAGTGA,0,1914787
ihfAp4,0.125,7,7,CAACAGCGGCAGACCGTACG,0,1934136
ihfAp4,0.125,7,7,CAAATACTGTGCAATCTTCC,0,1911263
ihfAp4,0.125,7,7,CAAAGCTATCAAGGCGAAGC,0,1920761
ihfAp4,0.125,7,7,CAAACGTAAAGTGGGGCATG,0,1927735
ihfAp4,0.125,7,7,ATTTAAGCAGTGTAGTAGGA,0,1950219
ihfAp4,0.125,7,7,ATTGTTTGGACTGGCTGTCG,0,1933775
ihfAp4,0.125,7,7,ATTGATAACTTGGCACAGGT,0,1930832
ihfAp4,0.125,7,7,ATTCTACAGTACCTGGGGTT,0,1954589
ihfAp4,0.125,7,7,ATTCAGGTACTGTATGCTCT,0,1931121
ihfAp4,0.125,7,7,ATTCAGCCGATACCTGCGAG,0,1949294
ihfAp4,0.125,7,7,ATTAACCCAGCGTGACGTGC,0,1924015
ihfAp4,0.125,7,7,ATGTTAAAATGGCTAAAGGT,0,1939044
ihfAp4,0.125,7,7,ATGCGGTTCAGGCTTTCTAA,0,1920945
ihfAp4,0.125,7,7,ATGCCTTTGGGTCGTGACCA,0,1923663
ihfAp4,0.125,7,7,ATGCCGATCAGGTAGACGGA,0,1917074
ihfAp4,0.125,7,7,ATGAGCAGTTTGCTAATATA,0,1955974
ihfAp4,0.125,7,7,ATGACTGGGGCCAAGGCTGC,0,1943656
ihfAp4,0.125,7,7,ATCTACCTTCCTATTACGAG,0,1953171
ihfAp4,0.125,7,7,ATCGTTTGCCCACCGTCACG,0,1930217
ihfAp4,0.125,7,7,ATCGTTGCGGCTTACTATGC,0,1929829
ihfAp4,0.125,7,7,ATCGGTCACCTGGTAGCCGA,0,1956133
ihfAp4,0.125,7,7,ATCGGTACTGATGCACGCAA,0,1915863
ihfAp4,0.125,7,7,ATCCGGCAACGAACCTACTT,0,1917141
ihfAp4,0.125,7,7,ATCCCGTAATGTAAAAGAGT,0,1910030
ihfAp4,0.125,7,7,ATCCACATGCCGCAAACGAC,0,1927316
ihfAp4,0.125,7,7,ATCATTATAGTTACTCATGG,0,1915777
ihfAp4,0.125,7,7,ATCAGGCCATCCCGGACCGC,0,1949130
ihfAp4,0.125,7,7,ATCAGAGGTTCGTACGAAAA,0,1937966
ihfAp4,0.125,7,7,ATCAGACATACTTTAGCACC,0,1920338
ihfAp4,0.125,7,7,ATCAAGTTCCGCTCAATACT,0,1931274
ihfAp4,0.125,7,7,ATCAACACTGGGAAGGAGTA,0,1954064
ihfAp4,0.125,7,7,ATCAAACGTAGAATCGGACA,0,1955654
ihfAp4,0.125,7,7,ATATTTGTTGTGTCGTCCCC,0,1927216
ihfAp4,0.125,7,7,ATATTCCCCGAGTTGGGGAT,0,1944349
ihfAp4,0.125,7,7,ATATGGGGTATAGCCGGGCC,0,1940992
ihfAp4,0.125,7,7,ATATAAGTCCGGGATTTTAA,0,1917617
ihfAp4,0.125,7,7,ATAGTACAAGCGTTTGATAA,0,1927950
ihfAp4,0.125,7,7,ATAGGCTAGAAATGGATCCT,0,1944161
ihfAp4,0.125,7,7,ATACTTACCACCCAAGCGAT,0,1955785
ihfAp4,0.125,7,7,ATACTGCAGAGCCCCTGCTC,0,1924275
ihfAp4,0.125,7,7,ATACTATTGGTTCGAATTGA,0,1941202
ihfAp4,0.125,7,7,ATACGACGTCGAACGAGCCT,0,1913617
ihfAp4,0.125,7,7,ATACCCAGGTCCTCGGCACG,0,1935460
ihfAp4,0.125,7,7,ATACACGAGTTCACGTCTGC,0,1942503
ihfAp4,0.125,7,7,ATAACGGTCTCGGGAGCATG,0,1931906
ihfAp4,0.125,7,7,ATAAAGGGGCTGACATTGCA,0,1912355
ihfAp4,0.125,7,7,AGTTGTTACCAGGCTGAGTC,0,1953038
ihfAp4,0.125,7,7,AGTGTGGCTGAAATTGCATA,0,1951116
ihfAp4,0.125,7,7,AGTCCCCTCGGCCATCTCTG,0,1954473
ihfAp4,0.125,7,7,AGTAACAAAAGACCGATACA,0,1958530
ihfAp4,0.125,7,7,AGGTTGAGACGGCGCCAGGT,0,1935175
ihfAp4,0.125,7,7,AGGTTCTAGTGATCCGAGTA,0,1951783
ihfAp4,0.125,7,7,AGGTCCTCGCTAATCATACT,0,1928723
ihfAp4,0.125,7,7,AGGGTGTGAAGAACTTCTAC,0,1925870
ihfAp4,0.125,7,7,AGGGGGCGCTATGAGTAAAG,0,1927572
ihfAp4,0.125,7,7,AGGCTCGACGTAAGTGTCGG,0,1955192
ihfAp4,0.125,7,7,AGGCGGTAAATAAACAGGTA,0,1922124
ihfAp4,0.125,7,7,AGGCGCGCGACGGTATTAAT,0,1937950
ihfAp4,0.125,7,7,AGGAGCAATCTATTGCCTTG,0,1913821
ihfAp4,0.125,7,7,AGGAAGGCTTTGGCACACAG,0,1931870
ihfAp4,0.125,7,7,AGGAAAAGGGATATCAATCA,0,1939376
ihfAp4,0.125,7,7,AGCTTCGAAGTGAGTTTATC,0,1939715
ihfAp4,0.125,7,7,AGCGTCCGATTCTCGTACGT,0,1911038
ihfAp4,0.125,7,7,AGCGTAGTGATATCAGATAA,0,1954150
ihfAp4,0.125,7,7,AGCCTGAGGATAGCGTTTGA,0,1961534
ihfAp4,0.125,7,7,AGCCTATTGTTGATTAGAAA,0,1926907
ihfAp4,0.125,7,7,AGCCCTGATTAAACAGCGTT,0,1925510
ihfAp4,0.125,7,7,AGCATAGCTGCTCGGCTATA,0,1920063
ihfAp4,0.125,7,7,AGCAATCAGCTGATGAAGAA,0,1917497
ihfAp4,0.125,7,7,AGAGCGCACGAAGGCAGAGC,0,1949542
ihfAp4,0.125,7,7,AGAGATTTCAACGGTTACGT,0,1915307
ihfAp4,0.125,7,7,AGAGACTGAGTATGATTGTA,0,1944539
ihfAp4,0.125,7,7,AGACACTAGAGCTGGCTCCA,0,1958567
ihfAp4,0.125,7,7,AGAAGATAATGCTGATACTC,0,1933297
ihfAp4,0.125,7,7,ACTTTCGCATGGGTAACAGA,0,1925178
ihfAp4,0.125,7,7,ACTGTATTAGCTCGGTTTCT,0,1961943
ihfAp4,0.125,7,7,ACTGGTGGCATTGTATCACC,0,1936832
ihfAp4,0.125,7,7,ACTGGACTATTGTGGGTAGG,0,1922769
ihfAp4,0.125,7,7,ACTGACCCACACCCTAAGTG,0,1920306
ihfAp4,0.125,7,7,ACTCCGTCCGACGGACGCCG,0,1928331
ihfAp4,0.125,7,7,ACTCACGTGCTATGCTATTC,0,1919347
ihfAp4,0.125,7,7,ACTATACATTGTATGGCTTC,0,1923254
ihfAp4,0.125,7,7,ACTACTAGATATAGGTTGCA,0,1942992
ihfAp4,0.125,7,7,ACGTAGCCCATGTCCGCTAA,0,1921129
ihfAp4,0.125,7,7,ACGGACCTGGAGCGGCTAAA,0,1956116
ihfAp4,0.125,7,7,ACGCGTGTGATTCGCCCCCA,0,1911212
ihfAp4,0.125,7,7,ACGAAGCCCGCTTAGCTGAT,0,1939363
ihfAp4,0.125,7,7,ACCGGGACGCAACTCTGCCT,0,1948329
ihfAp4,0.125,7,7,ACCGGCAACTCTCGAACGTC,0,1932076
ihfAp4,0.125,7,7,ACCCTGCGAGTTCAATTGGA,0,1934062
ihfAp4,0.125,7,7,ACCCTGATGGCTAACACAGC,0,1961143
ihfAp4,0.125,7,7,ACCCGTTGACGCCCACTCTC,0,1914866
ihfAp4,0.125,7,7,ACCATTGCGATGTCCTCTAA,0,1938151
ihfAp4,0.125,7,7,ACCATAGGCCCTCAGTTATA,0,1937639
ihfAp4,0.125,7,7,ACCAACCCACTGTAATAAAT,0,1954554
ihfAp4,0.125,7,7,ACATTTAATTTTACAAAAGC,0,1935655
ihfAp4,0.125,7,7,ACATTACGTGAGGACATCAC,0,1946896
ihfAp4,0.125,7,7,ACATCGCGATGTATTTTCCC,0,1920986
ihfAp4,0.125,7,7,ACATCCAATAACACAGCACA,0,1961505
ihfAp4,0.125,7,7,ACATAGCTAATGGCCATTTG,0,1946208
ihfAp4,0.125,7,7,ACATAAAAACACTGAGGCCA,0,1936638
ihfAp4,0.125,7,7,ACAGGTGCATCAGCGCGGGA,0,1941587
ihfAp4,0.125,7,7,ACAGCTGAACCGGATAGCCC,0,1912715
ihfAp4,0.125,7,7,ACAGCGAACCAACTTGTCCC,0,1961837
ihfAp4,0.125,7,7,ACACTCGCCGACCAGGCCGG,0,1940455
ihfAp4,0.125,7,7,ACACGGTCCAGGGCACAGGC,0,1950751
ihfAp4,0.125,7,7,ACACAGCAAGTGCATACGTA,0,1948686
ihfAp4,0.125,7,7,ACAAACTGTTAATTGCGATC,0,1909879
ihfAp4,0.125,7,7,AATTGCATGGCGGCTTATCC,0,1943122
ihfAp4,0.125,7,7,AATGGTGCTAAGACTCGGGA,0,1959172
ihfAp4,0.125,7,7,AATGCCGCCTCGGTATTTGA,0,1925458
ihfAp4,0.125,7,7,AATGCATGTGGAGCAAAGCC,0,1938667
ihfAp4,0.125,7,7,AATGACTCAGGCGGAGAGTT,0,1911221
ihfAp4,0.125,7,7,AATCAGTCGTATCCAACAGC,0,1923042
ihfAp4,0.125,7,7,AATAGGTCGAGGTAAGAGAC,0,1916961
ihfAp4,0.125,7,7,AATAGCAAGGAGGACCTTAA,0,1913952
ihfAp4,0.125,7,7,AAGTGTCCCTAGAAGGCGCG,0,1922950
ihfAp4,0.125,7,7,AAGTGACGGCCCGCCGGGGG,0,1928585
ihfAp4,0.125,7,7,AAGGGTAAGTCGGAGTGCTT,0,1917612
ihfAp4,0.125,7,7,AAGGGGTAGGGGGATACGGT,0,1914580
ihfAp4,0.125,7,7,AAGGCGGTAAACATTCTCGC,0,1943569
ihfAp4,0.125,7,7,AAGGCCCCAGGGTGAGGACG,0,1934332
ihfAp4,0.125,7,7,AAGCGCGGACCAGCATTACA,0,1949302
ihfAp4,0.125,7,7,AAGCAAGGCATCGGGGGGGT,0,1960402
ihfAp4,0.125,7,7,AAGATTTGGATGTCATAGAT,0,1957738
ihfAp4,0.125,7,7,AAGAATAGTCCTCGAGCATC,0,1914783
ihfAp4,0.125,7,7,AACTCAACGGAGAATAGTCA,0,1935299
ihfAp4,0.125,7,7,AAATTGATTCAGTTTCCATT,0,1941312
ihfAp4,0.125,7,7,AAATCGCGGCCGAGCCGACC,0,1911658
ihfAp4,0.125,7,7,AAATCGAGCGGTAATTGCTA,0,1954393
ihfAp4,0.125,7,7,AAACAAAGTCATTCAGGTTT,0,1920859
ihfAp4,0.125,7,7,AAAACTGCCTCATTGTTGAC,0,1938901
ihfAp4,0.125,7,7,AAAACTGAGATATTTAAAAT,0,1948350
ihfAp4,0.14285714285714285,6,6,TTTTGTGACTATTGCTAAAT,0,1912152
ihfAp4,0.14285714285714285,6,6,TTTTGTAACGTTATATCGCG,0,1933826
ihfAp4,0.14285714285714285,6,6,TTTTCAGAGGGCGGCTTGCT,0,1921366
ihfAp4,0.14285714285714285,6,6,TTTGTCTTCATCTCTGTGGA,0,1924380
ihfAp4,0.14285714285714285,6,6,TTTGCTGCCCGTGCCACTAT,0,1911307
ihfAp4,0.14285714285714285,6,6,TTTGACTGGTCCATGGGAAA,0,1957831
ihfAp4,0.14285714285714285,6,6,TTTCCTACTGGGTGTCTACT,0,1951833
ihfAp4,0.14285714285714285,6,6,TTTATATTATGGCGGCCCTT,0,1949526
ihfAp4,0.14285714285714285,6,6,TTTAGCCTTCCCGATTCAGA,0,1936922
ihfAp4,0.14285714285714285,6,6,TTTACCATTTCCTACCACCA,0,1956693
ihfAp4,0.14285714285714285,6,6,TTGTTACCACTAGACGTGGG,0,1942888
ihfAp4,0.14285714285714285,6,6,TTGTTAAACTGGCAAGTTTA,0,1917964
ihfAp4,0.14285714285714285,6,6,TTGTCCGCCACAAATCAGGG,0,1915042
ihfAp4,0.14285714285714285,6,6,TTGTACGTGGACACTATCGC,0,1917225
ihfAp4,0.14285714285714285,6,6,TTGGTGTGTTCAAGTTCTCT,0,1939743
ihfAp4,0.14285714285714285,6,6,TTGGGGCTGTAGTAGGGGTG,0,1944931
ihfAp4,0.14285714285714285,6,6,TTGGCCCGTTTCCTAGGATG,0,1942114
ihfAp4,0.14285714285714285,6,6,TTGGCATTTACGGTGTTCAA,0,1957753
ihfAp4,0.14285714285714285,6,6,TTGCAATTGCACGAGACGCT,0,1944030
ihfAp4,0.14285714285714285,6,6,TTGCAAGCTGTCACTGGATC,0,1949753
ihfAp4,0.14285714285714285,6,6,TTGAGCAGAAAATTAGAAGA,0,1936203
ihfAp4,0.14285714285714285,6,6,TTCTTATGGGAACCTTGACC,0,1941846
ihfAp4,0.14285714285714285,6,6,TTCTGTACTACTTAAGATGA,0,1916995
ihfAp4,0.14285714285714285,6,6,TTCGCGTTTGGCGGAGTTAT,0,1947255
ihfAp4,0.14285714285714285,6,6,TTCGACAGAACGCAAGCGTC,0,1957608
ihfAp4,0.14285714285714285,6,6,TTCCGGTGCCGGTAAGTTAC,0,1913971
ihfAp4,0.14285714285714285,6,6,TTCATGGTGCTGCTCCGCGC,0,1935323
ihfAp4,0.14285714285714285,6,6,TTCACCCTTCGGAAGGACAA,0,1935710
ihfAp4,0.14285714285714285,6,6,TTCAACTAGGCGCTGGAGGG,0,1931463
ihfAp4,0.14285714285714285,6,6,TTCAAATGCTTAAAGCATTT,0,1959368
ihfAp4,0.14285714285714285,6,6,TTCAAAGAAGGGACGGCCAT,0,1911747
ihfAp4,0.14285714285714285,6,6,TTATTAAGTGAGGTGCGTAT,0,1940512
ihfAp4,0.14285714285714285,6,6,TTAGTCAAATCAATCGGTTG,0,1910372
ihfAp4,0.14285714285714285,6,6,TTAGGGGTTTGTCTCGATAT,0,1916011
ihfAp4,0.14285714285714285,6,6,TTAGGGCAGTGAAGGAGTTA,0,1935184
ihfAp4,0.14285714285714285,6,6,TTAGGACCATCATTATACTA,0,1952398
ihfAp4,0.14285714285714285,6,6,TTAGCGATCTAGTTTGGCAA,0,1913728
ihfAp4,0.14285714285714285,6,6,TTAGAAAGTGGATTAAATTT,0,1917552
ihfAp4,0.14285714285714285,6,6,TTACACTTATCAAGGATTAA,0,1927429
ihfAp4,0.14285714285714285,6,6,TTAATTACGGGTGTCTCCAT,0,1924982
ihfAp4,0.14285714285714285,6,6,TTAAGCTGGCACATGTCCTT,0,1919338
ihfAp4,0.14285714285714285,6,6,TTAAGAACATGGCGTCTAGA,0,1954706
ihfAp4,0.14285714285714285,6,6,TGTTCTTAGGTAACAGGGTT,0,1945872
ihfAp4,0.14285714285714285,6,6,TGTCAAGATCGTTTCCAGCA,0,1941255
ihfAp4,0.14285714285714285,6,6,TGTATGTGTGAGACAGGAAA,0,1954553
ihfAp4,0.14285714285714285,6,6,TGTATGTACCCAGCCAGCTG,0,1956860
ihfAp4,0.14285714285714285,6,6,TGTATACACTGGAGAAGGCC,0,1932948
ihfAp4,0.14285714285714285,6,6,TGTAGAGACGTCCCGCTGAA,0,1933893
ihfAp4,0.14285714285714285,6,6,TGTACTCGTCATCGCCATTC,0,1930747
ihfAp4,0.14285714285714285,6,6,TGTACGATCCAGCAGCGTGA,0,1911141
ihfAp4,0.14285714285714285,6,6,TGGTTGAACCTGTGCCTGTT,0,1958291
ihfAp4,0.14285714285714285,6,6,TGGGTACTCAAAGGTAGTAC,0,1933927
ihfAp4,0.14285714285714285,6,6,TGGGGTGGGAGCAGTTTCTA,0,1928827
ihfAp4,0.14285714285714285,6,6,TGGGGGAAGGGTTCACTTCG,0,1915036
ihfAp4,0.14285714285714285,6,6,TGGGCATCAGTCTTAAGGGT,0,1953023
ihfAp4,0.14285714285714285,6,6,TGGCTGATTATCAGCGCGAC,0,1920497
ihfAp4,0.14285714285714285,6,6,TGGCGCCGCCTCCAACTATT,0,1946891
ihfAp4,0.14285714285714285,6,6,TGGCAGTAACGCAGGAAAGA,0,1931041
ihfAp4,0.14285714285714285,6,6,TGGAGGGGCGTCATGGAGAT,0,1915707
ihfAp4,0.14285714285714285,6,6,TGGAGGCGCAACCATGCGAA,0,1938198
ihfAp4,0.14285714285714285,6,6,TGCTATCTAAACCCGAGGGA,0,1928146
ihfAp4,0.14285714285714285,6,6,TGCTAGGTATATGCCAGCTT,0,1948618
ihfAp4,0.14285714285714285,6,6,TGCCCTCGCCTCATCAACCA,0,1942023
ihfAp4,0.14285714285714285,6,6,TGCCCGCTGATTAGATTTAT,0,1950040
ihfAp4,0.14285714285714285,6,6,TGCACTTCTTTTCTTCGGAA,0,1958529
ihfAp4,0.14285714285714285,6,6,TGCACGGGCTTACGGTGCCA,0,1947981
ihfAp4,0.14285714285714285,6,6,TGATGTTGCAGGGAGCATTC,0,1919319
ihfAp4,0.14285714285714285,6,6,TGATGATCATTCGCGCGGGA,0,1961482
ihfAp4,0.14285714285714285,6,6,TGATCCAGGGTGTTCAGTAA,0,1938744
ihfAp4,0.14285714285714285,6,6,TGATACTAGCCGTGTGGTCC,0,1911659
ihfAp4,0.14285714285714285,6,6,TGATAATGTTAATTCTATTC,0,1926792
ihfAp4,0.14285714285714285,6,6,TGAGGATGGTTATCCTGCCG,0,1954322
ihfAp4,0.14285714285714285,6,6,TGAGCGCTGGGTAAAGTACC,0,1919581
ihfAp4,0.14285714285714285,6,6,TGAGCAACCAGGACCTTTGA,0,1940667
ihfAp4,0.14285714285714285,6,6,TGAAAATTCCGTGACGCGCT,0,1960774
ihfAp4,0.14285714285714285,6,6,TCTTATCGCCAGGACTTTCG,0,1941100
ihfAp4,0.14285714285714285,6,6,TCTCGTACATCGCTATCTTA,0,1926754
ihfAp4,0.14285714285714285,6,6,TCTCCCGGTGTTGAAAACCC,0,1957114
ihfAp4,0.14285714285714285,6,6,TCTAAACTTTAACCGCTTGT,0,1945931
ihfAp4,0.14285714285714285,6,6,TCGTTCTTTGGCATGTGGAA,0,1915310
ihfAp4,0.14285714285714285,6,6,TCGGTGGCGTTTACAACTAC,0,1935514
ihfAp4,0.14285714285714285,6,6,TCGGGAGAAAATGCACGATC,0,1935912
ihfAp4,0.14285714285714285,6,6,TCGCTCGCTGGGGATAGGAC,0,1914865
ihfAp4,0.14285714285714285,6,6,TCGCTAGCCATAACATCAAA,0,1946931
ihfAp4,0.14285714285714285,6,6,TCGCGATCGGTATGGCAAGG,0,1911796
ihfAp4,0.14285714285714285,6,6,TCGCAGACGACTCCGATTCA,0,1932555
ihfAp4,0.14285714285714285,6,6,TCGAGATAAAACAATTGGGA,0,1958780
ihfAp4,0.14285714285714285,6,6,TCGAACACGCCCTCGAGCCC,0,1923561
ihfAp4,0.14285714285714285,6,6,TCCTGGTGGCGCTACTCTGC,0,1950448
ihfAp4,0.14285714285714285,6,6,TCCTCTCACTGGCACGTTGT,0,1934069
ihfAp4,0.14285714285714285,6,6,TCCTCCCAAAATCCGTGAGA,0,1936626
ihfAp4,0.14285714285714285,6,6,TCCGGGTTGGAGCGTATAAT,0,1938470
ihfAp4,0.14285714285714285,6,6,TCCGCTGGACAACCATATTC,0,1936096
ihfAp4,0.14285714285714285,6,6,TCCGCGCCGAAAGAGGCCCT,0,1939814
ihfAp4,0.14285714285714285,6,6,TCCGCCGTTTAAGAAGGAAC,0,1926959
ihfAp4,0.14285714285714285,6,6,TCCGCAGTAGATTAGGTTCT,0,1922464
ihfAp4,0.14285714285714285,6,6,TCCGAGTAATTCGCTTGAGT,0,1943842
ihfAp4,0.14285714285714285,6,6,TCCGAATCCTACTTTGGACA,0,1917256
ihfAp4,0.14285714285714285,6,6,TCCGAAGGACTACACTGCTA,0,1922559
ihfAp4,0.14285714285714285,6,6,TCCCTGGTGGCTTTGAAAGC,0,1917811
ihfAp4,0.14285714285714285,6,6,TCCCAGTTCCGTAGGCGGAG,0,1961948
ihfAp4,0.14285714285714285,6,6,TCCAAATTTCGCGATTCTGG,0,1921360
ihfAp4,0.14285714285714285,6,6,TCATCTGTGCGAGCCCCCAG,0,1926532
ihfAp4,0.14285714285714285,6,6,TCAGTTCACCCATCGTATGC,0,1926035
ihfAp4,0.14285714285714285,6,6,TCACTGCCGTCAAACTTGGA,0,1949239
ihfAp4,0.14285714285714285,6,6,TATTTAGCGCATTATGATGG,0,1921980
ihfAp4,0.14285714285714285,6,6,TATTATTTACGATTGAGACC,0,1945522
ihfAp4,0.14285714285714285,6,6,TATTAGCACTCCTGTGGTCG,0,1929125
ihfAp4,0.14285714285714285,6,6,TATGTTCGCCCGGGTTTTCT,0,1937419
ihfAp4,0.14285714285714285,6,6,TATGTATGGCGCGTGTTATG,0,1924156
ihfAp4,0.14285714285714285,6,6,TATGTATATAGAAAGATGCA,0,1949159
ihfAp4,0.14285714285714285,6,6,TATCGTGTCAGCTGCACATC,0,1954532
ihfAp4,0.14285714285714285,6,6,TATCACGATGGCGCCGCCTT,0,1911645
ihfAp4,0.14285714285714285,6,6,TATCAATATCGAGAGAGGTT,0,1959976
ihfAp4,0.14285714285714285,6,6,TATAGTGCCGCCTGGTCTTA,0,1932225
ihfAp4,0.14285714285714285,6,6,TAGGTCTTCGATGAAAGTAG,0,1923695
ihfAp4,0.14285714285714285,6,6,TAGGTCACAGCCCGTGAGAA,0,1932073
ihfAp4,0.14285714285714285,6,6,TAGGGCTCGGAACACCGGTG,0,1949478
ihfAp4,0.14285714285714285,6,6,TAGCGCTCCCCCGCGGCCCA,0,1918953
ihfAp4,0.14285714285714285,6,6,TAGCGCCAAGAAGGTTGATT,0,1929094
ihfAp4,0.14285714285714285,6,6,TAGCAGAAGTAGATTAAGAT,0,1933420
ihfAp4,0.14285714285714285,6,6,TAGCAACCCATAGAAGCAAG,0,1931484
ihfAp4,0.14285714285714285,6,6,TAGATGAGCCCGATAATGGG,0,1928018
ihfAp4,0.14285714285714285,6,6,TACTCTTACCGAAAGCGTTT,0,1946196
ihfAp4,0.14285714285714285,6,6,TACTCTGCGCTTGGGACAAC,0,1926010
ihfAp4,0.14285714285714285,6,6,TACTATTAGTCCAAGCGAGC,0,1935695
ihfAp4,0.14285714285714285,6,6,TACGTGTCGGAGCGGGACAA,0,1931441
ihfAp4,0.14285714285714285,6,6,TACCTAAGTTACGGCGAGGG,0,1935624
ihfAp4,0.14285714285714285,6,6,TACCGGGACACTAGCCCGTC,0,1936241
ihfAp4,0.14285714285714285,6,6,TACCCCGGGGGCAAGAGATA,0,1913448
ihfAp4,0.14285714285714285,6,6,TACCAGGTCGCATTAGCGCG,0,1922655
ihfAp4,0.14285714285714285,6,6,TACAAGATGTCGTGTGCACA,0,1917959
ihfAp4,0.14285714285714285,6,6,TACAAAGCTATTGAGGCGGT,0,1937196
ihfAp4,0.14285714285714285,6,6,TAATTATAGGTAAACCGCAT,0,1936795
ihfAp4,0.14285714285714285,6,6,TAAGTCGTGTGAGCCCGTGC,0,1956338
ihfAp4,0.14285714285714285,6,6,TAAGAGAGAGTCACAGTTGC,0,1948392
ihfAp4,0.14285714285714285,6,6,TAACTCAATCTTTAACCCAC,0,1947084
ihfAp4,0.14285714285714285,6,6,TAACGGGGTCCATCGGATAA,0,1960903
ihfAp4,0.14285714285714285,6,6,TAACACTCCCTGCTGACACA,0,1951268
ihfAp4,0.14285714285714285,6,6,TAAACGAAATAAGAGAGGCT,0,1948640
ihfAp4,0.14285714285714285,6,6,TAAAAAGGAGAGTTTTACTC,0,1916829
ihfAp4,0.14285714285714285,6,6,GTTTGGGCATCTTAGGACTT,0,1924318
ihfAp4,0.14285714285714285,6,6,GTTTCCCCTAATCGGCAAAC,0,1938269
ihfAp4,0.14285714285714285,6,6,GTTTCAGTTGCCGTGCAACT,0,1916427
ihfAp4,0.14285714285714285,6,6,GTTGCAGAGAGGTTATATCT,0,1947261
ihfAp4,0.14285714285714285,6,6,GTTCTTTCTGGCGTAACCTT,0,1949353
ihfAp4,0.14285714285714285,6,6,GTTCTCACCGCATTTACCCC,0,1954738
ihfAp4,0.14285714285714285,6,6,GTTCCTAACTGCCACTAGGT,0,1920680
ihfAp4,0.14285714285714285,6,6,GTTCCGGCTAGCAACAGCGA,0,1925567
ihfAp4,0.14285714285714285,6,6,GTTATCAAATCATGACATCA,0,1920543
ihfAp4,0.14285714285714285,6,6,GTTATATAGCGGGTGGTGGC,0,1962174
ihfAp4,0.14285714285714285,6,6,GTTACGAGATGAATCCCAGG,0,1958527
ihfAp4,0.14285714285714285,6,6,GTGTTAGGCTCCGCATCCTT,0,1948120
ihfAp4,0.14285714285714285,6,6,GTGTTAAGAAGGAGTGAACC,0,1912289
ihfAp4,0.14285714285714285,6,6,GTGTACTTCGGAAGTAATAA,0,1940482
ihfAp4,0.14285714285714285,6,6,GTGGTGCTACACCATGGGTG,0,1913093
ihfAp4,0.14285714285714285,6,6,GTGGGGCAAGGGGTATAAGA,0,1948254
ihfAp4,0.14285714285714285,6,6,GTGGCTTCTGGGGGGCGGTT,0,1912746
ihfAp4,0.14285714285714285,6,6,GTGCGTGGGCACAGGGACCG,0,1932690
ihfAp4,0.14285714285714285,6,6,GTCTTGTTGGGATGACCACG,0,1926132
ihfAp4,0.14285714285714285,6,6,GTCTGCGCACAAATTGTACT,0,1913656
ihfAp4,0.14285714285714285,6,6,GTCCACTAGCATCCATCATT,0,1946562
ihfAp4,0.14285714285714285,6,6,GTCACGTCCGTGCGCTTAGA,0,1941500
ihfAp4,0.14285714285714285,6,6,GTCACAGTCGGCAAACCCTA,0,1937750
ihfAp4,0.14285714285714285,6,6,GTCAAACAGAAAAATCACGA,0,1961322
ihfAp4,0.14285714285714285,6,6,GTATGGCTGTTCGAGGTAGC,0,1951581
ihfAp4,0.14285714285714285,6,6,GTATATGAAGTCACTGGCAG,0,1912150
ihfAp4,0.14285714285714285,6,6,GTAGCACGTTCGTTCTGCAA,0,1930133
ihfAp4,0.14285714285714285,6,6,GTACCTGAAAACGTTAATCC,0,1914024
ihfAp4,0.14285714285714285,6,6,GTACCACCGGAAAGACTGGT,0,1926979
ihfAp4,0.14285714285714285,6,6,GTACATTAACTACCAAAACA,0,1927099
ihfAp4,0.14285714285714285,6,6,GTAAATAGTTCGAGAACTGT,0,1937590
ihfAp4,0.14285714285714285,6,6,GTAAAAATTCCAGATAACGG,0,1917952
ihfAp4,0.14285714285714285,6,6,GGTTTGGTGTTAGTATGCAA,0,1947168
ihfAp4,0.14285714285714285,6,6,GGTGTGCGACATTTGAGCAT,0,1948679
ihfAp4,0.14285714285714285,6,6,GGTGATGCCAAGTAAGTAGC,0,1914403
ihfAp4,0.14285714285714285,6,6,GGTGAGATTGTAAAGCCATG,0,1915031
ihfAp4,0.14285714285714285,6,6,GGTCAACATACTCAGCGCAG,0,1925559
ihfAp4,0.14285714285714285,6,6,GGTAGATGGCCACCGACGGC,0,1928098
ihfAp4,0.14285714285714285,6,6,GGTAAGCTCTCCGAGTCGCT,0,1919915
ihfAp4,0.14285714285714285,6,6,GGTAACATGCATTTACCTGA,0,1934083
ihfAp4,0.14285714285714285,6,6,GGGTGTCAGTAAAGAGCCGT,0,1925899
ihfAp4,0.14285714285714285,6,6,GGGTGGTCGTGTAAGCCAGA,0,1953189
ihfAp4,0.14285714285714285,6,6,GGGTCGGCCACCCCCCTGAA,0,1920701
ihfAp4,0.14285714285714285,6,6,GGGTCCCGCTAAGTTAGTAT,0,1914542
ihfAp4,0.14285714285714285,6,6,GGGGTGTAACAAGCAATCTC,0,1928567
ihfAp4,0.14285714285714285,6,6,GGGGGCTGCGGAAAGTAGAA,0,1955990
ihfAp4,0.14285714285714285,6,6,GGGGAGGCTGGCTGCCTTTT,0,1929101
ihfAp4,0.14285714285714285,6,6,GGGGACCACTAACAATCCCG,0,1950876
ihfAp4,0.14285714285714285,6,6,GGGGAACCGAATCGTGTGGT,0,1939039
ihfAp4,0.14285714285714285,6,6,GGGCACATATTGTCCAATCG,0,1936256
ihfAp4,0.14285714285714285,6,6,GGGCAATGGATTGCAAGCTA,0,1921281
ihfAp4,0.14285714285714285,6,6,GGCTTCGTGTACAACGGTCA,0,1940057
ihfAp4,0.14285714285714285,6,6,GGCTCGCGAGAGCTAGACTA,0,1920382
ihfAp4,0.14285714285714285,6,6,GGCTACGGCAAGTCTAGCTC,0,1914959
ihfAp4,0.14285714285714285,6,6,GGCTACAACCTGGATCAGAC,0,1935265
ihfAp4,0.14285714285714285,6,6,GGCGTCGATACCCGGGTACA,0,1931903
ihfAp4,0.14285714285714285,6,6,GGCGTATACTGTTCGCCAGG,0,1948750
ihfAp4,0.14285714285714285,6,6,GGCGGCTCGAAATCTTCTCA,0,1918916
ihfAp4,0.14285714285714285,6,6,GGCGATATAGCGCTCACGAT,0,1960855
ihfAp4,0.14285714285714285,6,6,GGCCCGCGTTTCTCTGTCAG,0,1919339
ihfAp4,0.14285714285714285,6,6,GGCCAAGGTTGACACCGATA,0,1921176
ihfAp4,0.14285714285714285,6,6,GGCATTTGGCAAGTTAGAAC,0,1935707
ihfAp4,0.14285714285714285,6,6,GGCAGATGCATCGCTGCCAC,0,1926893
ihfAp4,0.14285714285714285,6,6,GGCACTTCCCTTCAATAGAC,0,1927407
ihfAp4,0.14285714285714285,6,6,GGCACCCGGGCAGGGCGGAG,0,1935282
ihfAp4,0.14285714285714285,6,6,GGCAAACGGCGGACACGTGG,0,1945294
ihfAp4,0.14285714285714285,6,6,GGATGCTAGCTTTTTGCTGT,0,1918320
ihfAp4,0.14285714285714285,6,6,GGATGAACTCAACTAGCCAG,0,1931702
ihfAp4,0.14285714285714285,6,6,GGATATCTCGCGCGCATCTC,0,1920587
ihfAp4,0.14285714285714285,6,6,GGAGGGCTACCGCGTGCCCG,0,1934000
ihfAp4,0.14285714285714285,6,6,GGAGATACTCAATAGAGCCC,0,1910434
ihfAp4,0.14285714285714285,6,6,GGAGACGTGTTGTACCTCGT,0,1938474
ihfAp4,0.14285714285714285,6,6,GGACATCCCCTGTGTTCACT,0,1926467
ihfAp4,0.14285714285714285,6,6,GGACAGTGTTTACTGAAGTT,0,1935506
ihfAp4,0.14285714285714285,6,6,GGACAGGACTTCGGCGGAGG,0,1954395
ihfAp4,0.14285714285714285,6,6,GGACACGCTGATGCTAGCTC,0,1959663
ihfAp4,0.14285714285714285,6,6,GGAATTGTGTCGAGATTACT,0,1932931
ihfAp4,0.14285714285714285,6,6,GGAATGTACGTTGTATATGA,0,1938852
ihfAp4,0.14285714285714285,6,6,GGAACGAGTGGCTCGTTTAG,0,1929728
ihfAp4,0.14285714285714285,6,6,GCTTTAAGTTCCGTATGGGT,0,1934534
ihfAp4,0.14285714285714285,6,6,GCTTAACCGTTTTCGGCATA,0,1917709
ihfAp4,0.14285714285714285,6,6,GCTGGCTCAAGGCACTCGCC,0,1935916
ihfAp4,0.14285714285714285,6,6,GCTGGCATATCCGAAGCGGC,0,1939535
ihfAp4,0.14285714285714285,6,6,GCTCTGTTGGGGCCGAGCTA,0,1909896
ihfAp4,0.14285714285714285,6,6,GCTCTCGGGTGCCAAGAAGC,0,1933950
ihfAp4,0.14285714285714285,6,6,GCTCCATCTAGCACGGGAGA,0,1957840
ihfAp4,0.14285714285714285,6,6,GCTACGAATTCGTGCCACTG,0,1910808
ihfAp4,0.14285714285714285,6,6,GCTACAACCGAACCGGCCTC,0,1912106
ihfAp4,0.14285714285714285,6,6,GCTAAAAGGGTACTGCGATT,0,1930510
ihfAp4,0.14285714285714285,6,6,GCGTTAAAAGCAACCCTGGG,0,1931076
ihfAp4,0.14285714285714285,6,6,GCGTGTCCATGTGGCAACCT,0,1915749
ihfAp4,0.14285714285714285,6,6,GCGGTAAGTACTATGGGTGT,0,1921274
ihfAp4,0.14285714285714285,6,6,GCGGTAAAGGCTACAAGGGT,0,1918195
ihfAp4,0.14285714285714285,6,6,GCGGGGACATTAGTGCTGCG,0,1937531
ihfAp4,0.14285714285714285,6,6,GCGGGCATACACTTGAGCGA,0,1937865
ihfAp4,0.14285714285714285,6,6,GCGGATGGAACAGCGCAGTA,0,1931398
ihfAp4,0.14285714285714285,6,6,GCGCCGGGGTCGTGCGTCAG,0,1942211
ihfAp4,0.14285714285714285,6,6,GCGCAGTCAAAGAGCGATCT,0,1938668
ihfAp4,0.14285714285714285,6,6,GCGAGCAGACTGTTGCAAAC,0,1928902
ihfAp4,0.14285714285714285,6,6,GCGACGAGATCGATCGTTAT,0,1947919
ihfAp4,0.14285714285714285,6,6,GCCTTTATGACAAGTGACGA,0,1953355
ihfAp4,0.14285714285714285,6,6,GCCTTGAATACTCTCGGCCT,0,1911218
ihfAp4,0.14285714285714285,6,6,GCCTTATTACGCGGGACACA,0,1913895
ihfAp4,0.14285714285714285,6,6,GCCGTTAAACCAGAATATGC,0,1943363
ihfAp4,0.14285714285714285,6,6,GCCGTGATGGTTACGGGTGT,0,1943446
ihfAp4,0.14285714285714285,6,6,GCCGGTATTGACGGAACAAG,0,1929308
ihfAp4,0.14285714285714285,6,6,GCCGGCACCCACGTTACACC,0,1921541
ihfAp4,0.14285714285714285,6,6,GCCGCCCGAGGTTGATTTCC,0,1923580
ihfAp4,0.14285714285714285,6,6,GCCCTTGTAGTGGTCACTAT,0,1957096
ihfAp4,0.14285714285714285,6,6,GCCCGGCATCCCATGTACGC,0,1951312
ihfAp4,0.14285714285714285,6,6,GCCCCTAGGCTGGCCGTCCT,0,1915710
ihfAp4,0.14285714285714285,6,6,GCCAGGGCTCGCACGCGTTG,0,1951532
ihfAp4,0.14285714285714285,6,6,GCCAGCAACGCGACGTCAGC,0,1922945
ihfAp4,0.14285714285714285,6,6,GCCACCGGAACACGTCGTCC,0,1926870
ihfAp4,0.14285714285714285,6,6,GCCACCGCCTTATTGCAGGT,0,1923692
ihfAp4,0.14285714285714285,6,6,GCATGAGTGCTAGACAGTGA,0,1932017
ihfAp4,0.14285714285714285,6,6,GCATGAGGAGGGAATTCGGT,0,1924056
ihfAp4,0.14285714285714285,6,6,GCATCCGTTCGGTCCGCATG,0,1926952
ihfAp4,0.14285714285714285,6,6,GCAGTTGATTCGGAGTAACG,0,1927615
ihfAp4,0.14285714285714285,6,6,GCAGTGCGTCCAAGCCCAGT,0,1911563
ihfAp4,0.14285714285714285,6,6,GCACTATTTAGTAGAAATAG,0,1914386
ihfAp4,0.14285714285714285,6,6,GCACGGTAAACTTCTTAAGA,0,1920788
ihfAp4,0.14285714285714285,6,6,GCAATTTTGTAGCTTAAGCG,0,1950704
ihfAp4,0.14285714285714285,6,6,GCAACTGAAACAGCGCTCTT,0,1960403
ihfAp4,0.14285714285714285,6,6,GCAAAGTAACTCAGTTTAAC,0,1935997
ihfAp4,0.14285714285714285,6,6,GCAAAATATATTTTAAGAAA,0,1931152
ihfAp4,0.14285714285714285,6,6,GCAAAAATCTTCGTACACAG,0,1945973
ihfAp4,0.14285714285714285,6,6,GATTTCTTACTGGATCGTGG,0,1939689
ihfAp4,0.14285714285714285,6,6,GATTGGGAGAAAGCAGGGCA,0,1952172
ihfAp4,0.14285714285714285,6,6,GATTCAGAAAGGGGTCGCCT,0,1916423
ihfAp4,0.14285714285714285,6,6,GATTAACCTTAGTCTGTTGT,0,1956788
ihfAp4,0.14285714285714285,6,6,GATGATTGTAACGGGGGTGT,0,1953885
ihfAp4,0.14285714285714285,6,6,GATCTTGACGTAGGCACCTA,0,1956683
ihfAp4,0.14285714285714285,6,6,GATCGTTGATAATTAAATTC,0,1911234
ihfAp4,0.14285714285714285,6,6,GATCGGTTATGACTGGATCG,0,1910077
ihfAp4,0.14285714285714285,6,6,GATCGCTTTTATCCGCTGAT,0,1933921
ihfAp4,0.14285714285714285,6,6,GATCCCGAGGCCACCCGTTA,0,1955889
ihfAp4,0.14285714285714285,6,6,GATCCAAAGCGTTCCATGTA,0,1934986
ihfAp4,0.14285714285714285,6,6,GATCATCTGTGTGTGCGTGA,0,1942213
ihfAp4,0.14285714285714285,6,6,GATCAAGCGCATTCTCGGAG,0,1935372
ihfAp4,0.14285714285714285,6,6,GATAGCCACACATTCGCAGC,0,1932349
ihfAp4,0.14285714285714285,6,6,GAGTAACGGTACCACTCTAC,0,1935960
ihfAp4,0.14285714285714285,6,6,GAGGCTGCTGCAACAAAGTG,0,1959558
ihfAp4,0.14285714285714285,6,6,GAGGCGGTGAGGAGCGCAGG,0,1922080
ihfAp4,0.14285714285714285,6,6,GAGCAGCATTTGGAGAGAGA,0,1939494
ihfAp4,0.14285714285714285,6,6,GAGAGGAGGCGTGCGCTCTC,0,1951298
ihfAp4,0.14285714285714285,6,6,GAGACAGCATTCACCCCGGT,0,1936699
ihfAp4,0.14285714285714285,6,6,GACTGCCTATTAATAAGCCT,0,1921954
ihfAp4,0.14285714285714285,6,6,GACTGCCTAACCAATATAGA,0,1944134
ihfAp4,0.14285714285714285,6,6,GACGTGAACTATATAAGGTG,0,1928800
ihfAp4,0.14285714285714285,6,6,GACGTCCATCCAGATTAATT,0,1944614
ihfAp4,0.14285714285714285,6,6,GACGCGGCAAGATTGGCGTA,0,1939926
ihfAp4,0.14285714285714285,6,6,GACGATCGTACTGAGACCAG,0,1951716
ihfAp4,0.14285714285714285,6,6,GACGATAACTAACGCTAAAA,0,1939704
ihfAp4,0.14285714285714285,6,6,GACCCGTCATAACCACGATA,0,1953036
ihfAp4,0.14285714285714285,6,6,GACCCGGAGAGTGTTAATCA,0,1957172
ihfAp4,0.14285714285714285,6,6,GACCCAAACAGGTACGGCAT,0,1956864
ihfAp4,0.14285714285714285,6,6,GACAGCGATACTGATACATA,0,1928942
ihfAp4,0.14285714285714285,6,6,GAATTTGCTCGCGCGTGGTC,0,1930551
ihfAp4,0.14285714285714285,6,6,GAATGCATCGCTGGGAATGT,0,1953115
ihfAp4,0.14285714285714285,6,6,GAATAGTAATGGTGTACGAG,0,1942275
ihfAp4,0.14285714285714285,6,6,GAACGGCCAACGTACTTTGC,0,1937062
ihfAp4,0.14285714285714285,6,6,GAACGGACGCAGACAAGAAC,0,1931372
ihfAp4,0.14285714285714285,6,6,CTTTTACAGGCATGACAAAG,0,1917426
ihfAp4,0.14285714285714285,6,6,CTTGGGGAGCCGGTACACGT,0,1912901
ihfAp4,0.14285714285714285,6,6,CTTGCGTTTCCGCTGTACAA,0,1932950
ihfAp4,0.14285714285714285,6,6,CTTGCGACGTTTACCCTCAG,0,1939533
ihfAp4,0.14285714285714285,6,6,CTTATGGAACTCTCCGGAAC,0,1960759
ihfAp4,0.14285714285714285,6,6,CTTAAGTATGTATGGCATAT,0,1941604
ihfAp4,0.14285714285714285,6,6,CTGTGATATGGCATCGCATT,0,1929748
ihfAp4,0.14285714285714285,6,6,CTGGGCTTCGGCGTTAGGGG,0,1929944
ihfAp4,0.14285714285714285,6,6,CTGGGCACCCTTTAAGTCCG,0,1949841
ihfAp4,0.14285714285714285,6,6,CTGGCAATTATTACATATGA,0,1915768
ihfAp4,0.14285714285714285,6,6,CTGGACATATCTCAGAATTA,0,1930340
ihfAp4,0.14285714285714285,6,6,CTGGAACGTAATGTTAAGAG,0,1948283
ihfAp4,0.14285714285714285,6,6,CTGCGCGTGAACTACCCCTG,0,1959837
ihfAp4,0.14285714285714285,6,6,CTGCGCGTCGATACTACCCT,0,1925257
ihfAp4,0.14285714285714285,6,6,CTGCCGGCTTCCTGTGTCGT,0,1914274
ihfAp4,0.14285714285714285,6,6,CTGCATTAGTTTCAGTGTGT,0,1956394
ihfAp4,0.14285714285714285,6,6,CTGAACGTCAGGCAAAGTTT,0,1930220
ihfAp4,0.14285714285714285,6,6,CTGAACCGTCTGATATTAAT,0,1941767
ihfAp4,0.14285714285714285,6,6,CTCTTTAGCAGGCTGGTCTG,0,1919516
ihfAp4,0.14285714285714285,6,6,CTCTTCAGCCAACGGGTCTA,0,1922741
ihfAp4,0.14285714285714285,6,6,CTCTGCTTATGCCAACTCAG,0,1923504
ihfAp4,0.14285714285714285,6,6,CTCTGCAACGCGACCGAGCA,0,1958570
ihfAp4,0.14285714285714285,6,6,CTCGTGAATTTGAGGGTTAA,0,1938813
ihfAp4,0.14285714285714285,6,6,CTCGGCTGCCTACATGCTTG,0,1941031
ihfAp4,0.14285714285714285,6,6,CTCGGATTGCACTTCGTCGG,0,1930838
ihfAp4,0.14285714285714285,6,6,CTCGGACCTCATACATGGTA,0,1930746
ihfAp4,0.14285714285714285,6,6,CTCCCCATGTCCTTATCTCA,0,1939547
ihfAp4,0.14285714285714285,6,6,CTCATTGCACTAATGGCAAA,0,1943031
ihfAp4,0.14285714285714285,6,6,CTCATCCACTGTCGGTCCAC,0,1934232
ihfAp4,0.14285714285714285,6,6,CTCAGATTAGTCCTAATAGC,0,1909811
ihfAp4,0.14285714285714285,6,6,CTATTGAGACTTCGGTGAGC,0,1915972
ihfAp4,0.14285714285714285,6,6,CTATGGACCAGGTGATACAA,0,1917002
ihfAp4,0.14285714285714285,6,6,CTATGCGCGTGGACGCATGG,0,1960943
ihfAp4,0.14285714285714285,6,6,CTATACCAATTGCTTTGTAA,0,1953994
ihfAp4,0.14285714285714285,6,6,CTATAACGCCGGAAGAAGTT,0,1935284
ihfAp4,0.14285714285714285,6,6,CTAGTTCAAGGTGACATTGT,0,1945361
ihfAp4,0.14285714285714285,6,6,CTAGTGGTGTTTATTTACGG,0,1954893
ihfAp4,0.14285714285714285,6,6,CTACTGCCAGGGAAGTGATC,0,1946490
ihfAp4,0.14285714285714285,6,6,CTAAGGTTAAGCCAGATGTG,0,1928500
ihfAp4,0.14285714285714285,6,6,CTAAAGGGATAGCAAAGAGG,0,1956008
ihfAp4,0.14285714285714285,6,6,CGTTTGATAGGAAGGTCCAT,0,1920603
ihfAp4,0.14285714285714285,6,6,CGTTGTTTTATTCCCGACGG,0,1922693
ihfAp4,0.14285714285714285,6,6,CGTTGTAACTCAAGCTCGCC,0,1955191
ihfAp4,0.14285714285714285,6,6,CGTTCTATGTCAATGGAGGG,0,1960656
ihfAp4,0.14285714285714285,6,6,CGTTATTTCTGCGATATTTA,0,1927330
ihfAp4,0.14285714285714285,6,6,CGTGGGATTGGCAACAGTTT,0,1933575
ihfAp4,0.14285714285714285,6,6,CGTGGGAGCCAACGGCGTGT,0,1923123
ihfAp4,0.14285714285714285,6,6,CGTGCTTAGGCACTTTCTAC,0,1955412
ihfAp4,0.14285714285714285,6,6,CGTGCGAATGGACGAGAAGG,0,1955338
ihfAp4,0.14285714285714285,6,6,CGTACGCGACTCCTGGCTTT,0,1923613
ihfAp4,0.14285714285714285,6,6,CGGTCGGGGGTTTCGTTAAG,0,1917302
ihfAp4,0.14285714285714285,6,6,CGGTCAAGTTGAGCTATCTA,0,1958110
ihfAp4,0.14285714285714285,6,6,CGGTAGCCGGGTGGCTCTGG,0,1954370
ihfAp4,0.14285714285714285,6,6,CGGGTTTCAACATGACTTAT,0,1931749
ihfAp4,0.14285714285714285,6,6,CGGGTTAGCGGCTAGACTTC,0,1938206
ihfAp4,0.14285714285714285,6,6,CGGGGAATGTTTGATCCCGA,0,1935047
ihfAp4,0.14285714285714285,6,6,CGGCTTCAATCATAGAGAAC,0,1958730
ihfAp4,0.14285714285714285,6,6,CGGCTCAATTATTACGTCTC,0,1930912
ihfAp4,0.14285714285714285,6,6,CGGCGTGAGTCGGAACGGTA,0,1954736
ihfAp4,0.14285714285714285,6,6,CGGCGACGAGTCCCTCTGCA,0,1948500
ihfAp4,0.14285714285714285,6,6,CGGCCAGTTTCTTACGAGTT,0,1910671
ihfAp4,0.14285714285714285,6,6,CGGCCACCAAGATTTCCCAG,0,1945318
ihfAp4,0.14285714285714285,6,6,CGGCATGTCCCGAACCTGCG,0,1950017
ihfAp4,0.14285714285714285,6,6,CGGCAGATACTTGCAAGAAT,0,1947030
ihfAp4,0.14285714285714285,6,6,CGGAAGATCGACAACCAGAT,0,1926239
ihfAp4,0.14285714285714285,6,6,CGCTTTCGTCACCGGATTTA,0,1952202
ihfAp4,0.14285714285714285,6,6,CGCTTAACATTAAGGTAAAA,0,1961328
ihfAp4,0.14285714285714285,6,6,CGCGTCGTGTTTACCAACTA,0,1956803
ihfAp4,0.14285714285714285,6,6,CGCGAGCATATGAGTCGACC,0,1946866
ihfAp4,0.14285714285714285,6,6,CGCGAATCTGAGGGGTAAAT,0,1957123
ihfAp4,0.14285714285714285,6,6,CGCATTTCAGTTAGCGATGT,0,1942036
ihfAp4,0.14285714285714285,6,6,CGCATATATATAGTAGAACG,0,1945837
ihfAp4,0.14285714285714285,6,6,CGCAGGGACGCTCGTGATTG,0,1940221
ihfAp4,0.14285714285714285,6,6,CGCAAGTACGCAAAAGAACA,0,1911457
ihfAp4,0.14285714285714285,6,6,CGATTTCAGCTTCCTTTATG,0,1952446
ihfAp4,0.14285714285714285,6,6,CGATTGGGCGCCTTGGTCCA,0,1958890
ihfAp4,0.14285714285714285,6,6,CGATGCCTCGTTACTCGCCC,0,1924538
ihfAp4,0.14285714285714285,6,6,CGAGGTAAGGGAGTGTGGCT,0,1954541
ihfAp4,0.14285714285714285,6,6,CGAGATTATATCATTTTTCG,0,1929857
ihfAp4,0.14285714285714285,6,6,CGACTTTAGGCGGACAGACA,0,1937815
ihfAp4,0.14285714285714285,6,6,CGACTGCGGACCTATCGCCT,0,1910478
ihfAp4,0.14285714285714285,6,6,CGACGCGATCGATGAACATG,0,1933581
ihfAp4,0.14285714285714285,6,6,CGACGAAAGGTCTGCGCTAC,0,1946519
ihfAp4,0.14285714285714285,6,6,CGACCACGGACAACTAGATA,0,1943415
ihfAp4,0.14285714285714285,6,6,CGAATGCACAGCTCTCCATT,0,1951875
ihfAp4,0.14285714285714285,6,6,CGAAAAATCCGCTTGGCCAG,0,1912702
ihfAp4,0.14285714285714285,6,6,CCTTACTGGTCCTTATATGA,0,1914314
ihfAp4,0.14285714285714285,6,6,CCTTACCACGATTCTATGTC,0,1922536
ihfAp4,0.14285714285714285,6,6,CCTGTTCACGTATGTCACCT,0,1961397
ihfAp4,0.14285714285714285,6,6,CCTGCATAAAAATTGCCGTT,0,1927740
ihfAp4,0.14285714285714285,6,6,CCTGATTCTACCTTATGCTC,0,1946095
ihfAp4,0.14285714285714285,6,6,CCTAGGTGAGCCAGTCCTGT,0,1919685
ihfAp4,0.14285714285714285,6,6,CCTAGCTGGCAACGAAATGA,0,1961234
ihfAp4,0.14285714285714285,6,6,CCGTTATTTGGTGCTGGTTA,0,1955123
ihfAp4,0.14285714285714285,6,6,CCGTGCTTATGATCGTTGAG,0,1934103
ihfAp4,0.14285714285714285,6,6,CCGTGAGAGAACGGCGAACC,0,1922791
ihfAp4,0.14285714285714285,6,6,CCGTCACCGGCTAGGTACAG,0,1930315
ihfAp4,0.14285714285714285,6,6,CCGTCACACAAGTTGCTGGT,0,1913986
ihfAp4,0.14285714285714285,6,6,CCGTATAGCAGCCTCCAACT,0,1956534
ihfAp4,0.14285714285714285,6,6,CCGTAGGATACTTAGCGGCT,0,1929673
ihfAp4,0.14285714285714285,6,6,CCGGTGATTGGATTAGGGAT,0,1958576
ihfAp4,0.14285714285714285,6,6,CCGGTCCTCTTCACAATGGT,0,1927706
ihfAp4,0.14285714285714285,6,6,CCGGAGATGTTTACAGGTTA,0,1938170
ihfAp4,0.14285714285714285,6,6,CCGCCCGCTTCATGCAACGA,0,1956806
ihfAp4,0.14285714285714285,6,6,CCGATTTATTTACGCCTGAA,0,1950766
ihfAp4,0.14285714285714285,6,6,CCGAATGGACCAGAAATGTG,0,1939552
ihfAp4,0.14285714285714285,6,6,CCGAATAGTTGGCTTCTGGC,0,1935751
ihfAp4,0.14285714285714285,6,6,CCCTGCGTGAAGCGGTGTGA,0,1933121
ihfAp4,0.14285714285714285,6,6,CCCTCTGACGTTCTATGGGT,0,1945683
ihfAp4,0.14285714285714285,6,6,CCCTATGGAAGTAATTCAAT,0,1918847
ihfAp4,0.14285714285714285,6,6,CCCGCTCATTGGGGGGCTCT,0,1959083
ihfAp4,0.14285714285714285,6,6,CCCGCAAATGGCTACTCAAG,0,1929884
ihfAp4,0.14285714285714285,6,6,CCCGATATTAGCCAATTCAT,0,1919852
ihfAp4,0.14285714285714285,6,6,CCCGACACCTTCACCAGCTG,0,1936767
ihfAp4,0.14285714285714285,6,6,CCCGAAAGCGGCACGGACTA,0,1941523
ihfAp4,0.14285714285714285,6,6,CCCCGGGGGACCCGTGGAGG,0,1952035
ihfAp4,0.14285714285714285,6,6,CCCCCTCAGTGAGGTACTTG,0,1953917
ihfAp4,0.14285714285714285,6,6,CCCCAGTCTAATAACGCCGA,0,1944745
ihfAp4,0.14285714285714285,6,6,CCCATGATAATCTTGGACAA,0,1935010
ihfAp4,0.14285714285714285,6,6,CCCAGCCGAAGGTGAGCAAA,0,1915197
ihfAp4,0.14285714285714285,6,6,CCCAGCAGCTGACGGCGATC,0,1921502
ihfAp4,0.14285714285714285,6,6,CCCAGACGAGCATCAACTGG,0,1936740
ihfAp4,0.14285714285714285,6,6,CCCACTGAGCTTACAAACTA,0,1931866
ihfAp4,0.14285714285714285,6,6,CCCAATACCCTACCCCATTG,0,1951526
ihfAp4,0.14285714285714285,6,6,CCATTTGAGTCCAGACGGGA,0,1958063
ihfAp4,0.14285714285714285,6,6,CCATGAACTGGCAGCGTCAC,0,1934581
ihfAp4,0.14285714285714285,6,6,CCAGTTCAGAGTTGCCCGAT,0,1923516
ihfAp4,0.14285714285714285,6,6,CCAGTCCAGAGCCTAAAAAA,0,1951463
ihfAp4,0.14285714285714285,6,6,CCAGATATAATACTATTTTA,0,1934003
ihfAp4,0.14285714285714285,6,6,CCAGACGACGTGGGGACAAT,0,1942228
ihfAp4,0.14285714285714285,6,6,CCACTTCCAACTAAAATACT,0,1936364
ihfAp4,0.14285714285714285,6,6,CCACCTCGATTTCTATAATA,0,1959908
ihfAp4,0.14285714285714285,6,6,CCACCCGACATAGCCTGTAC,0,1925665
ihfAp4,0.14285714285714285,6,6,CCACAAGGGTGTTTCGGTGG,0,1942022
ihfAp4,0.14285714285714285,6,6,CCAACGCTATCAAGTAAGCA,0,1922036
ihfAp4,0.14285714285714285,6,6,CCAACCTTGAGGGGAACACG,0,1916734
ihfAp4,0.14285714285714285,6,6,CATTTGTAGCAAGTCACTGA,0,1930843
ihfAp4,0.14285714285714285,6,6,CATTCCCAAGAAGTTCAAGG,0,1949888
ihfAp4,0.14285714285714285,6,6,CATGGGTAGGATCCACGTTC,0,1925615
ihfAp4,0.14285714285714285,6,6,CATGGAAGGGAGTACTGTGA,0,1916162
ihfAp4,0.14285714285714285,6,6,CATCTTGACGAGTAAGGTAA,0,1912180
ihfAp4,0.14285714285714285,6,6,CATCGTCAGAGATTACGCGA,0,1949370
ihfAp4,0.14285714285714285,6,6,CATCCGCGAATGTCAGAGTA,0,1959046
ihfAp4,0.14285714285714285,6,6,CATCAGCCGGACTCGAGCAT,0,1920848
ihfAp4,0.14285714285714285,6,6,CATAGGAATGGCAACCGTTG,0,1955005
ihfAp4,0.14285714285714285,6,6,CATAGAAACTCCCTGCTTCC,0,1942347
ihfAp4,0.14285714285714285,6,6,CATACAAGTCGATCTGGGGG,0,1920209
ihfAp4,0.14285714285714285,6,6,CATAATGCCACAGGTGGGCA,0,1961892
ihfAp4,0.14285714285714285,6,6,CAGTGTGGAGGCACGGACGG,0,1916120
ihfAp4,0.14285714285714285,6,6,CAGTAAAGAGAGGCTTCATT,0,1912222
ihfAp4,0.14285714285714285,6,6,CAGGAATGTGTTCACGTAGC,0,1919507
ihfAp4,0.14285714285714285,6,6,CAGCGCCTAATCTGGCTGAT,0,1925871
ihfAp4,0.14285714285714285,6,6,CAGCCCGTTTCTAAACTGTG,0,1961137
ihfAp4,0.14285714285714285,6,6,CAGCACGCCGACGCTTATTA,0,1928745
ihfAp4,0.14285714285714285,6,6,CAGATCCTCTGAGTCTCTCC,0,1955545
ihfAp4,0.14285714285714285,6,6,CAGAGACAGTGTCAGTTTGG,0,1939992
ihfAp4,0.14285714285714285,6,6,CAGACATTGGAATGGGACAA,0,1958934
ihfAp4,0.14285714285714285,6,6,CAGAACGTAAAGTATGCTGT,0,1946531
ihfAp4,0.14285714285714285,6,6,CACTCAATGTACCGCCATAT,0,1957079
ihfAp4,0.14285714285714285,6,6,CACGTTGGATGACGATTGCA,0,1946917
ihfAp4,0.14285714285714285,6,6,CACGGATCCAGCCCCACTGA,0,1948453
ihfAp4,0.14285714285714285,6,6,CACCGTGTACCGCGAATAAT,0,1947806
ihfAp4,0.14285714285714285,6,6,CACCGACACGGGCCACCTTA,0,1957091
ihfAp4,0.14285714285714285,6,6,CACCATGCGGTGTTGCGAAA,0,1914791
ihfAp4,0.14285714285714285,6,6,CACACGCATATCGTACCTAG,0,1956287
ihfAp4,0.14285714285714285,6,6,CACACCATGTCGAAGCTGAA,0,1940814
ihfAp4,0.14285714285714285,6,6,CACAACGGCCAGGAGGGCTT,0,1956017
ihfAp4,0.14285714285714285,6,6,CAATTCAGATAGAGTGGTAT,0,1925102
ihfAp4,0.14285714285714285,6,6,CAATTAGGATAACTGGACGC,0,1951343
ihfAp4,0.14285714285714285,6,6,CAATAGTGAAATTACTTGCC,0,1954000
ihfAp4,0.14285714285714285,6,6,CAATACTCCGTTATACTGTG,0,1941457
ihfAp4,0.14285714285714285,6,6,CAAGTCATAGCCAGTTTAGA,0,1949684
ihfAp4,0.14285714285714285,6,6,CAAGGTGCGATATTCCCTAG,0,1924719
ihfAp4,0.14285714285714285,6,6,CAACAGATCTATAATTAGCA,0,1954334
ihfAp4,0.14285714285714285,6,6,CAAATAAGCGCATATACTTT,0,1951835
ihfAp4,0.14285714285714285,6,6,CAAAGTTGAATGCCTCAGAC,0,1954136
ihfAp4,0.14285714285714285,6,6,CAAAGGTGACTTTGCATGCT,0,1942351
ihfAp4,0.14285714285714285,6,6,CAAACGTGTGAACTATTGCG,0,1921720
ihfAp4,0.14285714285714285,6,6,CAAACAGGATTTTTAACTGC,0,1954507
ihfAp4,0.14285714285714285,6,6,ATTTCATCTTACCGCCTTAG,0,1928037
ihfAp4,0.14285714285714285,6,6,ATTTATGGAACACTTCACTG,0,1942380
ihfAp4,0.14285714285714285,6,6,ATTGGGGATCAAATAGCAGA,0,1912634
ihfAp4,0.14285714285714285,6,6,ATTCTCCGGATCCCAGAAAC,0,1922178
ihfAp4,0.14285714285714285,6,6,ATTCCTGACGATTGGGCTAG,0,1941111
ihfAp4,0.14285714285714285,6,6,ATTCAGAAGTATAGGCTCGT,0,1959986
ihfAp4,0.14285714285714285,6,6,ATTACACAGAGTCATCATAT,0,1918110
ihfAp4,0.14285714285714285,6,6,ATGTGCGACTGGATCAGGCC,0,1920582
ihfAp4,0.14285714285714285,6,6,ATGTATTGCCGTTGAATATT,0,1942784
ihfAp4,0.14285714285714285,6,6,ATGTAAGCGTAATCTAATAC,0,1941720
ihfAp4,0.14285714285714285,6,6,ATGGGCACGTATCGTGGGAT,0,1939986
ihfAp4,0.14285714285714285,6,6,ATGGCCGAGGAAAGAAAACC,0,1920244
ihfAp4,0.14285714285714285,6,6,ATGCTTGACTGCCCGAGTGA,0,1960400
ihfAp4,0.14285714285714285,6,6,ATGCTCCGCACGGGCTCGAG,0,1913136
ihfAp4,0.14285714285714285,6,6,ATGACCGCTAGTGGGCGCCG,0,1916636
ihfAp4,0.14285714285714285,6,6,ATGAACTTTCTGCGTGGTCT,0,1942269
ihfAp4,0.14285714285714285,6,6,ATCTCAGGGCATCATCTTCC,0,1926442
ihfAp4,0.14285714285714285,6,6,ATCGTGATTGCGTAATACGA,0,1951270
ihfAp4,0.14285714285714285,6,6,ATCGTACAGCTGTCGTAGTA,0,1914019
ihfAp4,0.14285714285714285,6,6,ATCCTGAGGCATTGTACGAG,0,1942181
ihfAp4,0.14285714285714285,6,6,ATCCGCCCCCGGCGTGCCAT,0,1920934
ihfAp4,0.14285714285714285,6,6,ATCCCATAATGATGCGTCTT,0,1925477
ihfAp4,0.14285714285714285,6,6,ATCAGGGACGCGTCAGGATA,0,1947710
ihfAp4,0.14285714285714285,6,6,ATCACAGGTGTAAGCTTTGA,0,1953866
ihfAp4,0.14285714285714285,6,6,ATCAAACTGGCCTTTACGGA,0,1913609
ihfAp4,0.14285714285714285,6,6,ATAGTCACCCGTGGATTCTA,0,1928300
ihfAp4,0.14285714285714285,6,6,ATAGGGCACGAATGGGCTAT,0,1933649
ihfAp4,0.14285714285714285,6,6,ATAGATCGCCTTCATCTGAT,0,1956716
ihfAp4,0.14285714285714285,6,6,ATACGGTGTAGTCACGTACT,0,1912696
ihfAp4,0.14285714285714285,6,6,ATACGACCGATATTGGTCAG,0,1955971
ihfAp4,0.14285714285714285,6,6,ATACATGGTGTGTACACGCG,0,1936062
ihfAp4,0.14285714285714285,6,6,ATAATCACCCGTGAGATCGT,0,1947909
ihfAp4,0.14285714285714285,6,6,ATAAGATTCCACTGCCATAG,0,1955138
ihfAp4,0.14285714285714285,6,6,ATAACAACCACTGGCATACT,0,1957690
ihfAp4,0.14285714285714285,6,6,ATAAACCCAGTTTATCCACC,0,1936361
ihfAp4,0.14285714285714285,6,6,ATAAAAGCGGATATATGGGC,0,1944446
ihfAp4,0.14285714285714285,6,6,AGTTTCGCCCGGACGCCGGG,0,1953889
ihfAp4,0.14285714285714285,6,6,AGTGAGGTGCCGGTAGGTGA,0,1922119
ihfAp4,0.14285714285714285,6,6,AGTCTTGAGCGAGACTCGTT,0,1933129
ihfAp4,0.14285714285714285,6,6,AGTCAGTTAGGACAGCCCCA,0,1955373
ihfAp4,0.14285714285714285,6,6,AGTCAGCGGTACTGAACCAT,0,1947160
ihfAp4,0.14285714285714285,6,6,AGGTGTTAGTCGAGACATGC,0,1945034
ihfAp4,0.14285714285714285,6,6,AGGTCTATTATGTCGTCCCA,0,1946102
ihfAp4,0.14285714285714285,6,6,AGGTACACGAAATCATTGGT,0,1922136
ihfAp4,0.14285714285714285,6,6,AGGCTTATAGTCACTCGCGC,0,1941750
ihfAp4,0.14285714285714285,6,6,AGGCGAGCTTCTCGTTGACA,0,1911052
ihfAp4,0.14285714285714285,6,6,AGGCGAATTGCGGGTGCTCT,0,1914958
ihfAp4,0.14285714285714285,6,6,AGGCCTGGTGCATACCGTAG,0,1923913
ihfAp4,0.14285714285714285,6,6,AGGCACGAGCGATGCCATTC,0,1942139
ihfAp4,0.14285714285714285,6,6,AGGAGTATCAGGAATGTCGG,0,1935376
ihfAp4,0.14285714285714285,6,6,AGGACTTTACGTCTCTATCA,0,1924013
ihfAp4,0.14285714285714285,6,6,AGGACTGAGCCAAAGTCACT,0,1950550
ihfAp4,0.14285714285714285,6,6,AGCTTTGCTCAATGATCCTA,0,1912945
ihfAp4,0.14285714285714285,6,6,AGCTGGGCAAAGGTACGGTT,0,1946072
ihfAp4,0.14285714285714285,6,6,AGCGTTTATATAGCCCAGGA,0,1927476
ihfAp4,0.14285714285714285,6,6,AGCGTGCAAAGCACGATGCG,0,1930824
ihfAp4,0.14285714285714285,6,6,AGCGCTAACTTCCTGGCCAG,0,1943374
ihfAp4,0.14285714285714285,6,6,AGCGACCGAGCTGGCAGTCA,0,1938752
ihfAp4,0.14285714285714285,6,6,AGCGAAGCAGAATTGGTGGG,0,1958734
ihfAp4,0.14285714285714285,6,6,AGCCCCCAACACGGACGCCA,0,1914874
ihfAp4,0.14285714285714285,6,6,AGCCATTAACAACTGAGCTA,0,1918924
ihfAp4,0.14285714285714285,6,6,AGCCACGTCCTGCGTGGTTA,0,1952469
ihfAp4,0.14285714285714285,6,6,AGCAGTATGGGGCAACATAA,0,1944343
ihfAp4,0.14285714285714285,6,6,AGATTATACAGCGAAAGATG,0,1911070
ihfAp4,0.14285714285714285,6,6,AGATGGCTCCAGAGGCATCA,0,1934213
ihfAp4,0.14285714285714285,6,6,AGATATTAGAACTCAGTGGA,0,1958848
ihfAp4,0.14285714285714285,6,6,AGAGTGACGGCACACAATAT,0,1949120
ihfAp4,0.14285714285714285,6,6,AGAGGGGAAAATTGAAAACA,0,1921912
ihfAp4,0.14285714285714285,6,6,AGAGCCATACTCACGTCTAG,0,1919510
ihfAp4,0.14285714285714285,6,6,AGACCTGCTTAACGCGTGTC,0,1934444
ihfAp4,0.14285714285714285,6,6,AGACCTAATTAGCGCGGACT,0,1958299
ihfAp4,0.14285714285714285,6,6,AGAAACGGGATCAAGCAGAC,0,1912483
ihfAp4,0.14285714285714285,6,6,AGAAAAACAGGCTCCCCGCT,0,1950992
ihfAp4,0.14285714285714285,6,6,ACTTGGCGTCGCATTGGCTT,0,1961160
ihfAp4,0.14285714285714285,6,6,ACTTCAGCATGGAGCAAATT,0,1919127
ihfAp4,0.14285714285714285,6,6,ACTTATGGGGTGATTGCGTT,0,1950027
ihfAp4,0.14285714285714285,6,6,ACTGTCTTATCAAGGGCAGT,0,1939492
ihfAp4,0.14285714285714285,6,6,ACTGCTGCTATCCCAAGAGG,0,1925014
ihfAp4,0.14285714285714285,6,6,ACTGCCTAGAGTAGGTTCCC,0,1955972
ihfAp4,0.14285714285714285,6,6,ACTGACGGTTAACAACATGT,0,1940293
ihfAp4,0.14285714285714285,6,6,ACTCTGAGCAAGAAGCCCAT,0,1929480
ihfAp4,0.14285714285714285,6,6,ACTCCATGGTCGCTAGGCCC,0,1922128
ihfAp4,0.14285714285714285,6,6,ACTCAAGGGGTGAAAACCCG,0,1960382
ihfAp4,0.14285714285714285,6,6,ACTAAGAGGGCAACTGCAGT,0,1910405
ihfAp4,0.14285714285714285,6,6,ACGTTTGATGATCTTTGCAT,0,1935362
ihfAp4,0.14285714285714285,6,6,ACGTGTGTGTTGGCTATGTA,0,1914490
ihfAp4,0.14285714285714285,6,6,ACGTCCGAGCAAAAAGGTCG,0,1926420
ihfAp4,0.14285714285714285,6,6,ACGTCCCCCGTTTGCCGCGA,0,1912351
ihfAp4,0.14285714285714285,6,6,ACGTAGGCTCCTACGGGCGT,0,1919147
ihfAp4,0.14285714285714285,6,6,ACGGTGACCGTTCTAGCGAA,0,1921367
ihfAp4,0.14285714285714285,6,6,ACGGTCAGTCGTGTCACCCC,0,1937503
ihfAp4,0.14285714285714285,6,6,ACGGTAGCGGGGAACTGGCT,0,1944780
ihfAp4,0.14285714285714285,6,6,ACGGGTGCTTCATTGCACAG,0,1959918
ihfAp4,0.14285714285714285,6,6,ACGGGTAGCATACTTCGTAT,0,1952490
ihfAp4,0.14285714285714285,6,6,ACGGGGGTCCCTAATCTGTT,0,1927779
ihfAp4,0.14285714285714285,6,6,ACGGCCTCAGTGGACACGAA,0,1927236
ihfAp4,0.14285714285714285,6,6,ACGGATCGGGTCTTGTCATT,0,1914551
ihfAp4,0.14285714285714285,6,6,ACGGACGTACTATAAAGGAT,0,1925108
ihfAp4,0.14285714285714285,6,6,ACGCTCACGGTGGCTTAGTT,0,1934801
ihfAp4,0.14285714285714285,6,6,ACGCGGTAGGGTGTCACGCG,0,1931321
ihfAp4,0.14285714285714285,6,6,ACGAGCGACTAGCTCTCCCT,0,1924151
ihfAp4,0.14285714285714285,6,6,ACCTGACTGTACGGATGTAA,0,1914618
ihfAp4,0.14285714285714285,6,6,ACCTAAGTTTCGTGCCACGT,0,1956614
ihfAp4,0.14285714285714285,6,6,ACCGTGTCCAGACGAGCATA,0,1922661
ihfAp4,0.14285714285714285,6,6,ACCGATTCTGGCTGACATAA,0,1942149
ihfAp4,0.14285714285714285,6,6,ACCGATCGCTTAACCGCATC,0,1928551
ihfAp4,0.14285714285714285,6,6,ACCGACTGGTGGCAAACGCG,0,1928729
ihfAp4,0.14285714285714285,6,6,ACCGACGAAATTGCTCAACA,0,1913950
ihfAp4,0.14285714285714285,6,6,ACCCTATGACCAGATCGTGG,0,1935309
ihfAp4,0.14285714285714285,6,6,ACCCCGGCTGGAAAGTGCTA,0,1951650
ihfAp4,0.14285714285714285,6,6,ACCAGGCAAAGGGATCTGAA,0,1910510
ihfAp4,0.14285714285714285,6,6,ACCAGATCATCGGGTAATCG,0,1957635
ihfAp4,0.14285714285714285,6,6,ACATGTATTCTTGTTGTCTA,0,1920669
ihfAp4,0.14285714285714285,6,6,ACATCTAATACCTAACGTCG,0,1940386
ihfAp4,0.14285714285714285,6,6,ACAGCATAAAGGCCGTATGT,0,1929634
ihfAp4,0.14285714285714285,6,6,ACACTTTAGTCTTATATTCG,0,1951782
ihfAp4,0.14285714285714285,6,6,ACACACTCGAACGTCCTCAT,0,1930295
ihfAp4,0.14285714285714285,6,6,ACAATTTATACATTCAATCT,0,1911413
ihfAp4,0.14285714285714285,6,6,ACAAGGGGATTGCACCGAAT,0,1960575
ihfAp4,0.14285714285714285,6,6,ACAAGCGGTTAGTCCTGCCT,0,1949298
ihfAp4,0.14285714285714285,6,6,AATTGATCTTGACCGTTGGT,0,1949042
ihfAp4,0.14285714285714285,6,6,AATTAGCAGCAGTCTGTTAT,0,1915348
ihfAp4,0.14285714285714285,6,6,AATCGCCAAATGGAGGGTTG,0,1924988
ihfAp4,0.14285714285714285,6,6,AATCCCATCCGTAACTCGAT,0,1917558
ihfAp4,0.14285714285714285,6,6,AATCCCATACACAACATTAG,0,1935484
ihfAp4,0.14285714285714285,6,6,AATATCCAGAACGTGCGTCA,0,1952999
ihfAp4,0.14285714285714285,6,6,AATAGCGGCAGGTGTGAGCC,0,1932556
ihfAp4,0.14285714285714285,6,6,AATACAGACAGGACGATTTA,0,1928214
ihfAp4,0.14285714285714285,6,6,AATAAATTTCGCGCTATTCC,0,1926750
ihfAp4,0.14285714285714285,6,6,AAGTTACTCCGACGTCGGGG,0,1935959
ihfAp4,0.14285714285714285,6,6,AAGTATGTTCATCTGACTTG,0,1951328
ihfAp4,0.14285714285714285,6,6,AAGTATGCGCTACTTATATG,0,1946710
ihfAp4,0.14285714285714285,6,6,AAGTAGGTTTGCGAGAAACT,0,1946074
ihfAp4,0.14285714285714285,6,6,AAGTAAAAAATATGTCAGCC,0,1953531
ihfAp4,0.14285714285714285,6,6,AAGGGCTAGTCATACGGCCA,0,1942988
ihfAp4,0.14285714285714285,6,6,AAGGGACACCAAATTCAGTC,0,1957579
ihfAp4,0.14285714285714285,6,6,AAGGACTACGTGACGAAATG,0,1914245
ihfAp4,0.14285714285714285,6,6,AAGCGTGAGCAGCACACGGG,0,1956348
ihfAp4,0.14285714285714285,6,6,AAGCCGGCAACAGTCAGTCT,0,1911399
ihfAp4,0.14285714285714285,6,6,AAGCCCCCGACACATACAGT,0,1909697
ihfAp4,0.14285714285714285,6,6,AAGAGTCTTCCCTCGTTGTT,0,1940950
ihfAp4,0.14285714285714285,6,6,AAGACTTTTACCTGAGGCCA,0,1940817
ihfAp4,0.14285714285714285,6,6,AAGACCAACGGGGCATTAAG,0,1933098
ihfAp4,0.14285714285714285,6,6,AACTGGGCACACATGAGGTG,0,1938616
ihfAp4,0.14285714285714285,6,6,AACTATCAAGCTTAAAACCC,0,1932143
ihfAp4,0.14285714285714285,6,6,AACGCGCCCCATGGAGTCCA,0,1942788
ihfAp4,0.14285714285714285,6,6,AACATTCGGCTTGTGGTTCA,0,1920637
ihfAp4,0.14285714285714285,6,6,AACATGTCCTTAAAGTGCAA,0,1918103
ihfAp4,0.14285714285714285,6,6,AACATCACAACGGACTCAGT,0,1953803
ihfAp4,0.14285714285714285,6,6,AACACTGCCGTGGGGTTAGA,0,1948438
ihfAp4,0.14285714285714285,6,6,AAATTGGCCGTACTCCCATT,0,1955049
ihfAp4,0.14285714285714285,6,6,AAATGTCAGGAGATCACGCC,0,1960408
ihfAp4,0.14285714285714285,6,6,AAATGGACAGATTCAACCCA,0,1948385
ihfAp4,0.14285714285714285,6,6,AAATCTTTGAGTAAGCCCTA,0,1932425
ihfAp4,0.14285714285714285,6,6,AAAGTAGCGCATCACGTTTA,0,1943781
ihfAp4,0.14285714285714285,6,6,AAAGTAGCAAAAGATCCCAA,0,1957614
ihfAp4,0.14285714285714285,6,6,AAAGGGAACGCGGCGAGACC,0,1951974
ihfAp4,0.14285714285714285,6,6,AAAGCACGAAGGGTCACTTA,0,1945221
ihfAp4,0.14285714285714285,6,6,AAACTGGCTACAGCATCAGT,0,1935566
ihfAp4,0.14285714285714285,6,6,AAACAGCCCAATTGAGTTGT,0,1946744
ihfAp4,0.14285714285714285,6,6,AAACAAAAAGGAGTCTTCGC,0,1949853
ihfAp4,0.14285714285714285,6,6,AAAATACACTTACACGTAGC,0,1941224
ihfAp4,0.14285714285714285,6,6,AAAAACGTAGCAGGATGCGG,0,1919801
ihfAp4,0.16666666666666666,5,5,TTTTTTCAAGGGTGGGCATC,0,1918733
ihfAp4,0.16666666666666666,5,5,TTTTGGAGCCGAAGGGGCAT,0,1961144
ihfAp4,0.16666666666666666,5,5,TTTTGCATTTCGGACAGGTC,0,1920141
ihfAp4,0.16666666666666666,5,5,TTTGTGTCAGCGAGTGCTAT,0,1937280
ihfAp4,0.16666666666666666,5,5,TTTGTGACCGTTGTAGATCT,0,1949080
ihfAp4,0.16666666666666666,5,5,TTTGGGGGCGATCATGTTCA,0,1927548
ihfAp4,0.16666666666666666,5,5,TTTGGCACGATGCGGGCTCC,0,1910261
ihfAp4,0.16666666666666666,5,5,TTTGAGTGTGGGCAGCCTGG,0,1945207
ihfAp4,0.16666666666666666,5,5,TTTCGCCTGAGGGCATGCTT,0,1917122
ihfAp4,0.16666666666666666,5,5,TTTCGCAGTGCAAACTTCGA,0,1929925
ihfAp4,0.16666666666666666,5,5,TTTCCGCTCTAGCTCGGACA,0,1918799
ihfAp4,0.16666666666666666,5,5,TTTCAGAGCTTTACTATTTG,0,1937157
ihfAp4,0.16666666666666666,5,5,TTTCAGAGATAATAGCTAAA,0,1946838
ihfAp4,0.16666666666666666,5,5,TTGTGGGGAGCCTTTACTAC,0,1910309
ihfAp4,0.16666666666666666,5,5,TTGTCCGAAACATCATCACA,0,1935256
ihfAp4,0.16666666666666666,5,5,TTGTAGAACAGGTAAATTGC,0,1938412
ihfAp4,0.16666666666666666,5,5,TTGGCTCAGGTGGCATTAGA,0,1954181
ihfAp4,0.16666666666666666,5,5,TTGGCACTTCGATCGAACTC,0,1954823
ihfAp4,0.16666666666666666,5,5,TTGCGCCAATCGAGTTCCAG,0,1946026
ihfAp4,0.16666666666666666,5,5,TTGCCCTCGGTCAATATGGA,0,1912466
ihfAp4,0.16666666666666666,5,5,TTGCACATCTAGGCGTAAAC,0,1913060
ihfAp4,0.16666666666666666,5,5,TTGAGCTATTGCTGGGATCG,0,1951873
ihfAp4,0.16666666666666666,5,5,TTCTTAAGAAAAACGGCCAC,0,1960507
ihfAp4,0.16666666666666666,5,5,TTCTGAGATACAACGATTAC,0,1910862
ihfAp4,0.16666666666666666,5,5,TTCTCTGAAGTTAAGGCTAA,0,1947287
ihfAp4,0.16666666666666666,5,5,TTCGTGTAAACGACCTGACA,0,1960880
ihfAp4,0.16666666666666666,5,5,TTCGTACATCGGATCTACTA,0,1924326
ihfAp4,0.16666666666666666,5,5,TTCGCTCTCGAAGTGACCCA,0,1942923
ihfAp4,0.16666666666666666,5,5,TTCCGTATGCTTTGAACTTC,0,1934996
ihfAp4,0.16666666666666666,5,5,TTCCGGCCAGGGAGCCGTGA,0,1913183
ihfAp4,0.16666666666666666,5,5,TTCCGGACGAGGATATATAT,0,1948038
ihfAp4,0.16666666666666666,5,5,TTCCGCGCAAGGGCTACATA,0,1940181
ihfAp4,0.16666666666666666,5,5,TTCCCATGGCGGCGGCACGT,0,1948204
ihfAp4,0.16666666666666666,5,5,TTCCAGTGCGACGTGTCATG,0,1956532
ihfAp4,0.16666666666666666,5,5,TTCATTTGCCCTGTAAGTAC,0,1937645
ihfAp4,0.16666666666666666,5,5,TTCAGTTATAGACAGGGCAT,0,1952594
ihfAp4,0.16666666666666666,5,5,TTCAGCTTAGTGGCACTCGA,0,1915570
ihfAp4,0.16666666666666666,5,5,TTCAAATCGCGATGCGCTTC,0,1951802
ihfAp4,0.16666666666666666,5,5,TTCAAACTAGCCCGGACTGC,0,1912881
ihfAp4,0.16666666666666666,5,5,TTATGAGCTTGTGAGTTCGT,0,1913780
ihfAp4,0.16666666666666666,5,5,TTAGTTAATTAATGGTTCAT,0,1947854
ihfAp4,0.16666666666666666,5,5,TTAGTCCAGAGTTTCGCAGC,0,1960321
ihfAp4,0.16666666666666666,5,5,TTAGGTGTCAATATTCACCC,0,1915757
ihfAp4,0.16666666666666666,5,5,TTAGGATATTTTTAGTCCCC,0,1909677
ihfAp4,0.16666666666666666,5,5,TTAGCGCCATACTTCGGGCT,0,1920902
ihfAp4,0.16666666666666666,5,5,TTACCTAACAATGAGCGCGC,0,1911507
ihfAp4,0.16666666666666666,5,5,TTACCCCCCTCTATCGAGCT,0,1936393
ihfAp4,0.16666666666666666,5,5,TTACATGTGTGAATCGCCCT,0,1921453
ihfAp4,0.16666666666666666,5,5,TTACATCAGCGTCATACCGA,0,1935837
ihfAp4,0.16666666666666666,5,5,TTAATTTAAACTGAGTAGCC,0,1928786
ihfAp4,0.16666666666666666,5,5,TTAAGACAGCCTGCTCAGAT,0,1932915
ihfAp4,0.16666666666666666,5,5,TTAAATGTTCAGATGAGTGG,0,1943226
ihfAp4,0.16666666666666666,5,5,TGTTTTGTATGCGCATTTAA,0,1949484
ihfAp4,0.16666666666666666,5,5,TGTTTGGGCCAGTGATACTA,0,1947591
ihfAp4,0.16666666666666666,5,5,TGTTTAACCAACTAGCACGC,0,1911502
ihfAp4,0.16666666666666666,5,5,TGTGGGTACACGAGCTGCAT,0,1920344
ihfAp4,0.16666666666666666,5,5,TGTGCCAGTCTGCCATTAAG,0,1951051
ihfAp4,0.16666666666666666,5,5,TGTCCTTATGTTCTTTACGA,0,1960976
ihfAp4,0.16666666666666666,5,5,TGGTTACGCCGTAAGGGTTT,0,1929875
ihfAp4,0.16666666666666666,5,5,TGGTATTATACGTACTTATC,0,1928302
ihfAp4,0.16666666666666666,5,5,TGGGTTATAATGCAGTTGTG,0,1929139
ihfAp4,0.16666666666666666,5,5,TGGGTTAGCATGCACACCCT,0,1923451
ihfAp4,0.16666666666666666,5,5,TGGGTTAACTCCTGGATTGC,0,1958245
ihfAp4,0.16666666666666666,5,5,TGGGTGTTCTTCCGGCGGAG,0,1934937
ihfAp4,0.16666666666666666,5,5,TGGGTGTGGCGGATTAGTTG,0,1957699
ihfAp4,0.16666666666666666,5,5,TGGGTGAGACAGCTCATGCA,0,1960478
ihfAp4,0.16666666666666666,5,5,TGGGTAATCTAAAATAAATG,0,1910732
ihfAp4,0.16666666666666666,5,5,TGGGGGGTTACCGTCGGTTA,0,1911340
ihfAp4,0.16666666666666666,5,5,TGGGCTCTGCTAACAAATGC,0,1930219
ihfAp4,0.16666666666666666,5,5,TGGGCAGGCGCTACATTACA,0,1939487
ihfAp4,0.16666666666666666,5,5,TGGATCAAAGCGCTTTATAC,0,1919215
ihfAp4,0.16666666666666666,5,5,TGCTTTTGGGCAAGTAAGCC,0,1945955
ihfAp4,0.16666666666666666,5,5,TGCTCGACGTGGAACAACGC,0,1956355
ihfAp4,0.16666666666666666,5,5,TGCTAGAGTATTCTCCAGTA,0,1923992
ihfAp4,0.16666666666666666,5,5,TGCGTACCCCTTAGCCAGTG,0,1950885
ihfAp4,0.16666666666666666,5,5,TGCGACTCTAACCCCACATG,0,1937985
ihfAp4,0.16666666666666666,5,5,TGCCCCGCGGGGCACGCACG,0,1951127
ihfAp4,0.16666666666666666,5,5,TGCCCAGGCTTGCAAGTACA,0,1941023
ihfAp4,0.16666666666666666,5,5,TGCATAGTGTATCAGTTTGT,0,1920343
ihfAp4,0.16666666666666666,5,5,TGCACTCTGTCAGATGAGAC,0,1952838
ihfAp4,0.16666666666666666,5,5,TGCACTCACCTAAGCCATCC,0,1940317
ihfAp4,0.16666666666666666,5,5,TGCAAGATTCTGTCCGAGAG,0,1952935
ihfAp4,0.16666666666666666,5,5,TGATTATAGGGAAAAAGCTA,0,1913365
ihfAp4,0.16666666666666666,5,5,TGATGGCGGTCGCAGCTATA,0,1919937
ihfAp4,0.16666666666666666,5,5,TGATCACGCAGTAATGGCCA,0,1928483
ihfAp4,0.16666666666666666,5,5,TGATCAAGAACTCGACGGTT,0,1942515
ihfAp4,0.16666666666666666,5,5,TGATCAAAGCTCCGGGTCCT,0,1958302
ihfAp4,0.16666666666666666,5,5,TGATAACCGCTACAGATACA,0,1915425
ihfAp4,0.16666666666666666,5,5,TGAGTCGTCGTGACAGACTA,0,1941619
ihfAp4,0.16666666666666666,5,5,TGAGTACGGGAGGACACGGT,0,1931494
ihfAp4,0.16666666666666666,5,5,TGAGGTCATCCCGTGCTTAG,0,1953684
ihfAp4,0.16666666666666666,5,5,TGAGGGGGTTGTCTTGCTTA,0,1925800
ihfAp4,0.16666666666666666,5,5,TGAGGCCTCGTGACAGTTGA,0,1937936
ihfAp4,0.16666666666666666,5,5,TGAGGACTCGTATGCGCCGT,0,1930015
ihfAp4,0.16666666666666666,5,5,TGAGCCCGAGTTCTCCTCAG,0,1939490
ihfAp4,0.16666666666666666,5,5,TGAGACAGGCGAGCTAAGGC,0,1928854
ihfAp4,0.16666666666666666,5,5,TGAGAACCTACTTTTGTGGG,0,1919388
ihfAp4,0.16666666666666666,5,5,TGAGAAACATGGACTGGGTG,0,1949630
ihfAp4,0.16666666666666666,5,5,TGACCTCACTCCCACCGTGT,0,1912589
ihfAp4,0.16666666666666666,5,5,TGACAATTTGAGCGAGGGGG,0,1920641
ihfAp4,0.16666666666666666,5,5,TGACAACACGCTAAAAACCT,0,1918084
ihfAp4,0.16666666666666666,5,5,TGACAAACCACGTTTGGTGA,0,1960390
ihfAp4,0.16666666666666666,5,5,TGAATTAGTTTAAAGGTCAC,0,1951723
ihfAp4,0.16666666666666666,5,5,TGAACTCGATCAAGCGTCGT,0,1914584
ihfAp4,0.16666666666666666,5,5,TGAACCTGGGGCACTTGCTG,0,1941827
ihfAp4,0.16666666666666666,5,5,TGAACACACGATTTTAAACC,0,1915124
ihfAp4,0.16666666666666666,5,5,TGAAATTTATTCCTGCGATA,0,1942251
ihfAp4,0.16666666666666666,5,5,TGAAAGAAGGAAAGAGGGTC,0,1957603
ihfAp4,0.16666666666666666,5,5,TCTTTCTCATGGCGCAGTTA,0,1924865
ihfAp4,0.16666666666666666,5,5,TCTTGCGGACGACGCCTATA,0,1952388
ihfAp4,0.16666666666666666,5,5,TCTTCAGAATCGGCGAAACT,0,1918729
ihfAp4,0.16666666666666666,5,5,TCTGGCGCTCACCTTACGAT,0,1954469
ihfAp4,0.16666666666666666,5,5,TCTGCATACATCTGGGAAGA,0,1926502
ihfAp4,0.16666666666666666,5,5,TCTGATGTCCTTCGGGGGTC,0,1926915
ihfAp4,0.16666666666666666,5,5,TCTCGACGCTGTTAACTCCA,0,1947493
ihfAp4,0.16666666666666666,5,5,TCTATCCGGTATTTTGAAAG,0,1917761
ihfAp4,0.16666666666666666,5,5,TCTAGAATATGGAAACCCAC,0,1920774
ihfAp4,0.16666666666666666,5,5,TCTACGAGCGTGGCGGCTTT,0,1931884
ihfAp4,0.16666666666666666,5,5,TCTACACCGTTGATATGGGG,0,1948064
ihfAp4,0.16666666666666666,5,5,TCTAATCGCGAATAAATAAC,0,1928351
ihfAp4,0.16666666666666666,5,5,TCTAAGGACCCTCGTTTCTC,0,1959222
ihfAp4,0.16666666666666666,5,5,TCGTCTGCTCAAAATGCGCG,0,1945246
ihfAp4,0.16666666666666666,5,5,TCGTCGTCTGATTCTGCCTA,0,1910621
ihfAp4,0.16666666666666666,5,5,TCGTATATCTGACACCAGCG,0,1956768
ihfAp4,0.16666666666666666,5,5,TCGGTTGTTCCACGAGGACC,0,1912451
ihfAp4,0.16666666666666666,5,5,TCGGCTCGCGCAATGCCGAT,0,1921716
ihfAp4,0.16666666666666666,5,5,TCGGCGCCTGGCCCTGCTAT,0,1920892
ihfAp4,0.16666666666666666,5,5,TCGGAGAACATTTTGGACGC,0,1911390
ihfAp4,0.16666666666666666,5,5,TCGCGGTACGTGTGTTGATC,0,1916925
ihfAp4,0.16666666666666666,5,5,TCGACATCGCCCCCCAAGTT,0,1957992
ihfAp4,0.16666666666666666,5,5,TCGAATTTGGTACTGGAATA,0,1916392
ihfAp4,0.16666666666666666,5,5,TCCTAGCTAGGAACGGGGCA,0,1958842
ihfAp4,0.16666666666666666,5,5,TCCTAGCCACAGGCGGGGCT,0,1913292
ihfAp4,0.16666666666666666,5,5,TCCTACGGCCCCAAGTGAAA,0,1943376
ihfAp4,0.16666666666666666,5,5,TCCGATATGACTATCACTGT,0,1933317
ihfAp4,0.16666666666666666,5,5,TCCCCGACCATTTGGAAATA,0,1920203
ihfAp4,0.16666666666666666,5,5,TCCCCCTTAATGGCGGTCGT,0,1946690
ihfAp4,0.16666666666666666,5,5,TCCCATGTTAAGGCCAGGGA,0,1927739
ihfAp4,0.16666666666666666,5,5,TCCATGAATTTTCAGAATTA,0,1951154
ihfAp4,0.16666666666666666,5,5,TCCATCGTCTCTCTACACTA,0,1925508
ihfAp4,0.16666666666666666,5,5,TCCACCAACGGAGTGGACAA,0,1911382
ihfAp4,0.16666666666666666,5,5,TCCAAGGTGTCCAATACTGC,0,1931970
ihfAp4,0.16666666666666666,5,5,TCCAAAGAAAATATAGATAG,0,1947280
ihfAp4,0.16666666666666666,5,5,TCAGTCCCAACCACGATGCG,0,1937384
ihfAp4,0.16666666666666666,5,5,TCAGCCTGGCGCTCAGATAC,0,1956423
ihfAp4,0.16666666666666666,5,5,TCACGCACCGACCCTGCGTG,0,1950795
ihfAp4,0.16666666666666666,5,5,TCACCGGCACCCATGATCAT,0,1952856
ihfAp4,0.16666666666666666,5,5,TCACCAGGTCTGCAAAGGAC,0,1932309
ihfAp4,0.16666666666666666,5,5,TCACAAACCCTGTATCAGGA,0,1940454
ihfAp4,0.16666666666666666,5,5,TCAATTAAACCTCTATACGT,0,1948162
ihfAp4,0.16666666666666666,5,5,TCAAGCGCAGCTGACTACAT,0,1935392
ihfAp4,0.16666666666666666,5,5,TCAAACTCACTCGCGAATCA,0,1954519
ihfAp4,0.16666666666666666,5,5,TATGGGCGCTCATTAAATGG,0,1946648
ihfAp4,0.16666666666666666,5,5,TATGGGCGATCACGACTTTC,0,1950564
ihfAp4,0.16666666666666666,5,5,TATGCTGTTATTGTTCCGGA,0,1921042
ihfAp4,0.16666666666666666,5,5,TATGCGCAATAGAACCTAGA,0,1935663
ihfAp4,0.16666666666666666,5,5,TATCTTCGACTGTATTATGT,0,1938573
ihfAp4,0.16666666666666666,5,5,TATCGGTTCCAAGTGGTAAT,0,1956166
ihfAp4,0.16666666666666666,5,5,TATCCCGCTTAAGTTATGAT,0,1923799
ihfAp4,0.16666666666666666,5,5,TATCATGCCCGGTAGCCCAA,0,1913711
ihfAp4,0.16666666666666666,5,5,TATATTGAGCGGGCATACGA,0,1942607
ihfAp4,0.16666666666666666,5,5,TAGTGGGTAGGCTTTCCATG,0,1936245
ihfAp4,0.16666666666666666,5,5,TAGGTACTCGGGGATCTTGG,0,1942015
ihfAp4,0.16666666666666666,5,5,TAGGTACCAAGCTGGATCCA,0,1938677
ihfAp4,0.16666666666666666,5,5,TAGGGAACGCCAGGTGGCAA,0,1917469
ihfAp4,0.16666666666666666,5,5,TAGGCCATTGTTTTGACTTT,0,1956899
ihfAp4,0.16666666666666666,5,5,TAGAGTTTAGGTTTTTGATC,0,1956784
ihfAp4,0.16666666666666666,5,5,TAGAGTGATCTTGCTACACT,0,1914585
ihfAp4,0.16666666666666666,5,5,TAGAGGCGCAGACGTTAGCT,0,1910612
ihfAp4,0.16666666666666666,5,5,TAGACGTCACTTCGTGGGCT,0,1936072
ihfAp4,0.16666666666666666,5,5,TAGACACAAAATGTCCTTGC,0,1913105
ihfAp4,0.16666666666666666,5,5,TAGAACGCATGTATAGAGCT,0,1922954
ihfAp4,0.16666666666666666,5,5,TACTTTATGTGCCGTCAGTC,0,1924217
ihfAp4,0.16666666666666666,5,5,TACTGCTCGATGGGAACTGT,0,1929712
ihfAp4,0.16666666666666666,5,5,TACTCACAATTGTTAGGGGT,0,1960564
ihfAp4,0.16666666666666666,5,5,TACGCATAACAGAAGTTGGC,0,1927525
ihfAp4,0.16666666666666666,5,5,TACCGACCTGTGCCACCTAA,0,1936346
ihfAp4,0.16666666666666666,5,5,TACCAATCTGCTCTTGACCG,0,1913717
ihfAp4,0.16666666666666666,5,5,TACATAGTGAGGTCAGTGTA,0,1940674
ihfAp4,0.16666666666666666,5,5,TACAAGATCCCATGACTACA,0,1912105
ihfAp4,0.16666666666666666,5,5,TACAACCCCTTCCGGTGTTT,0,1933898
ihfAp4,0.16666666666666666,5,5,TAATGTTCTAAGGAGTACGA,0,1912090
ihfAp4,0.16666666666666666,5,5,TAATCGTCATTTTGCCAGGC,0,1911948
ihfAp4,0.16666666666666666,5,5,TAATCCGGAGAAGTAAATCA,0,1948178
ihfAp4,0.16666666666666666,5,5,TAATACCAGTAAAGTTTTAC,0,1911461
ihfAp4,0.16666666666666666,5,5,TAAGTGTAACATCGACCCTA,0,1958931
ihfAp4,0.16666666666666666,5,5,TAAGTAACAATGCGTACTTG,0,1939135
ihfAp4,0.16666666666666666,5,5,TAAGGTGACCGGGGCTACGG,0,1926155
ihfAp4,0.16666666666666666,5,5,TAAGAGCGTAGGGGACTCGT,0,1952344
ihfAp4,0.16666666666666666,5,5,TAACATAGGCGACCGACGTA,0,1914845
ihfAp4,0.16666666666666666,5,5,TAACAAGTAAGTACCTCGGC,0,1947869
ihfAp4,0.16666666666666666,5,5,TAAACTGGTATCTGGTCCCT,0,1920969
ihfAp4,0.16666666666666666,5,5,TAAACGACATCAGTTTGGAC,0,1932157
ihfAp4,0.16666666666666666,5,5,TAAAATTTGGACCAATGACA,0,1959909
ihfAp4,0.16666666666666666,5,5,TAAAATAGTAGTCGATGATT,0,1942190
ihfAp4,0.16666666666666666,5,5,TAAAAACCACTGGCTACATG,0,1929744
ihfAp4,0.16666666666666666,5,5,GTTTTATTACCTCCTTCGAA,0,1933141
ihfAp4,0.16666666666666666,5,5,GTTTCTACGTGAGTCTCTTA,0,1937493
ihfAp4,0.16666666666666666,5,5,GTTTCGTGCACGTTCGAGGA,0,1932248
ihfAp4,0.16666666666666666,5,5,GTTGTTGCCGAGGACTCACC,0,1920247
ihfAp4,0.16666666666666666,5,5,GTTGACGAACTCTTGTTGAA,0,1926851
ihfAp4,0.16666666666666666,5,5,GTTCTGTCATCAGTGAAATG,0,1944028
ihfAp4,0.16666666666666666,5,5,GTTCTCCGCTAGTCAGTTAG,0,1927459
ihfAp4,0.16666666666666666,5,5,GTTCGCGGGGGATATGCGGG,0,1922806
ihfAp4,0.16666666666666666,5,5,GTTCGCGAGTTGATAGAGAA,0,1916393
ihfAp4,0.16666666666666666,5,5,GTTATGCTACATGAACTTAA,0,1940207
ihfAp4,0.16666666666666666,5,5,GTTAGTCAGGGCAGACTTTG,0,1939117
ihfAp4,0.16666666666666666,5,5,GTTAGCCCGCTCCTCTGAAC,0,1947101
ihfAp4,0.16666666666666666,5,5,GTGTTTACGAACCGCAACTA,0,1924270
ihfAp4,0.16666666666666666,5,5,GTGTAAATCCAAGGGGTTCT,0,1917760
ihfAp4,0.16666666666666666,5,5,GTGGTGAAACGCCAGTTTCT,0,1946536
ihfAp4,0.16666666666666666,5,5,GTGGCTCTTGTCTATAGTTG,0,1918187
ihfAp4,0.16666666666666666,5,5,GTGGCGTGTACTAAAGCTCC,0,1914964
ihfAp4,0.16666666666666666,5,5,GTGGCCTGCCTCTACGTAGT,0,1924021
ihfAp4,0.16666666666666666,5,5,GTGGACTGTGAAGGCTTGAT,0,1935078
ihfAp4,0.16666666666666666,5,5,GTGCTGTCAAGGACTCAGGA,0,1930886
ihfAp4,0.16666666666666666,5,5,GTGCCAGACGCCTTTTCTTA,0,1956760
ihfAp4,0.16666666666666666,5,5,GTGCACACATTCAAGTGAAC,0,1958658
ihfAp4,0.16666666666666666,5,5,GTGATGGCGTCAATTTGATT,0,1923625
ihfAp4,0.16666666666666666,5,5,GTGAGTGAATCGAAACCACT,0,1960401
ihfAp4,0.16666666666666666,5,5,GTCTTCGGAATTTGAATCTC,0,1955605
ihfAp4,0.16666666666666666,5,5,GTCTGGTTGGACGCACAACC,0,1915308
ihfAp4,0.16666666666666666,5,5,GTCTCCTTGGCATCTGGGTC,0,1910367
ihfAp4,0.16666666666666666,5,5,GTCTCACAGTCGTGGGTGGG,0,1915213
ihfAp4,0.16666666666666666,5,5,GTCCTTGGTGAACGGTAGAG,0,1918815
ihfAp4,0.16666666666666666,5,5,GTCCCTTGAGGTAAATAAAG,0,1946721
ihfAp4,0.16666666666666666,5,5,GTCCAAGAGATCGTTTGCGC,0,1909666
ihfAp4,0.16666666666666666,5,5,GTCACGCCCTCCGCTCCCGA,0,1920126
ihfAp4,0.16666666666666666,5,5,GTCACCGCCGTACGTTGCGT,0,1938891
ihfAp4,0.16666666666666666,5,5,GTCACATCATGGTTCCTGTC,0,1931380
ihfAp4,0.16666666666666666,5,5,GTATTGAAGCGTTGGTGGTG,0,1919263
ihfAp4,0.16666666666666666,5,5,GTATTACCCGGGGTTTTCAA,0,1947699
ihfAp4,0.16666666666666666,5,5,GTATGCTCTTCGAATAGCAG,0,1937871
ihfAp4,0.16666666666666666,5,5,GTATGCTACCCGCGAGAATT,0,1956910
ihfAp4,0.16666666666666666,5,5,GTAGTTGGCCTTGCAGTTAA,0,1911579
ihfAp4,0.16666666666666666,5,5,GTAGTGTCCCGTTCGTACGA,0,1943570
ihfAp4,0.16666666666666666,5,5,GTAGTATTACCGATATAAAC,0,1957161
ihfAp4,0.16666666666666666,5,5,GTAGGTAGGTAATGCCACTC,0,1936713
ihfAp4,0.16666666666666666,5,5,GTAGCTCCGACGATTTGCAG,0,1919465
ihfAp4,0.16666666666666666,5,5,GTACTGGCAACTGGTCTGGC,0,1934889
ihfAp4,0.16666666666666666,5,5,GTACGTGGGATGACATGTGT,0,1936410
ihfAp4,0.16666666666666666,5,5,GTACGGTGCTCACGGATGGT,0,1941022
ihfAp4,0.16666666666666666,5,5,GTAATACATTTACCGTGTGG,0,1944419
ihfAp4,0.16666666666666666,5,5,GGTTGGTCAACGAGGCGCCT,0,1919495
ihfAp4,0.16666666666666666,5,5,GGTTGGGAACGTTATCATCT,0,1937460
ihfAp4,0.16666666666666666,5,5,GGTTCAGGAGGCGACGAGGC,0,1937728
ihfAp4,0.16666666666666666,5,5,GGTGTTACTAGCCCCTACTG,0,1940053
ihfAp4,0.16666666666666666,5,5,GGTGCACTGATGTGTGTAGC,0,1914312
ihfAp4,0.16666666666666666,5,5,GGTCTACAGAGTCAAAGAAA,0,1947879
ihfAp4,0.16666666666666666,5,5,GGTCATCAGTTCGCGTCCTA,0,1942345
ihfAp4,0.16666666666666666,5,5,GGTCAATTTGTGTCCGGAGA,0,1954775
ihfAp4,0.16666666666666666,5,5,GGTATGCCAAGGAGAGTGCT,0,1910571
ihfAp4,0.16666666666666666,5,5,GGTATAACGTGGACGGCCTT,0,1919934
ihfAp4,0.16666666666666666,5,5,GGTAGGCCTGTTTCTCCCAC,0,1921692
ihfAp4,0.16666666666666666,5,5,GGGTCCTTGCGAGTAAAGAT,0,1961110
ihfAp4,0.16666666666666666,5,5,GGGTATGCCCAGTAATGTGT,0,1934285
ihfAp4,0.16666666666666666,5,5,GGGTATAGATAAAGTTTTTA,0,1928465
ihfAp4,0.16666666666666666,5,5,GGGTAGACAAGCTTGTCTTG,0,1927886
ihfAp4,0.16666666666666666,5,5,GGGTAATAGAGACCCTGGGG,0,1920056
ihfAp4,0.16666666666666666,5,5,GGGGGATGCTTACGTCCACA,0,1912604
ihfAp4,0.16666666666666666,5,5,GGGCAAAGCTGGGGTCTCGC,0,1949307
ihfAp4,0.16666666666666666,5,5,GGGATATGAAGACAGGGGCA,0,1955135
ihfAp4,0.16666666666666666,5,5,GGGAGATGGGTCCCAGTCGT,0,1933874
ihfAp4,0.16666666666666666,5,5,GGGAAACACGTAGTAAGTTG,0,1916541
ihfAp4,0.16666666666666666,5,5,GGCTTGGCTGCTGATCCTTC,0,1914021
ihfAp4,0.16666666666666666,5,5,GGCTTACGTCTGAGTACACT,0,1916470
ihfAp4,0.16666666666666666,5,5,GGCTTAAGGGTAGTTATCCT,0,1934002
ihfAp4,0.16666666666666666,5,5,GGCTCATAAGTTGACTGCAG,0,1957226
ihfAp4,0.16666666666666666,5,5,GGCTATAGAATGGGACCATC,0,1934741
ihfAp4,0.16666666666666666,5,5,GGCGTTGGTTCGGTGCACGT,0,1953635
ihfAp4,0.16666666666666666,5,5,GGCGACAGCGCAAATGCGTA,0,1916848
ihfAp4,0.16666666666666666,5,5,GGCCTGTGTGACATGTGTTG,0,1925273
ihfAp4,0.16666666666666666,5,5,GGCCGCTGAATCGTGTCTTG,0,1929102
ihfAp4,0.16666666666666666,5,5,GGCCCGATGACCAGTCATGC,0,1912759
ihfAp4,0.16666666666666666,5,5,GGCAGCTACGGCGAACCACT,0,1922425
ihfAp4,0.16666666666666666,5,5,GGCACCTACGACGTTACAAA,0,1935446
ihfAp4,0.16666666666666666,5,5,GGCAAGTTTTGATGCCCATT,0,1924463
ihfAp4,0.16666666666666666,5,5,GGCAAAGCGCGAGTCAAGTT,0,1941639
ihfAp4,0.16666666666666666,5,5,GGATTTCATATGATAGGTCC,0,1944389
ihfAp4,0.16666666666666666,5,5,GGATTTACTAACATAGCGCG,0,1951163
ihfAp4,0.16666666666666666,5,5,GGATAGTCGAACCCCGTCAG,0,1941538
ihfAp4,0.16666666666666666,5,5,GGAGCGACTGTAGTGGTCGA,0,1928818
ihfAp4,0.16666666666666666,5,5,GGAGCGACACCTGTTGAGGA,0,1934691
ihfAp4,0.16666666666666666,5,5,GGAGACGGTCCGGTCCGAGA,0,1950791
ihfAp4,0.16666666666666666,5,5,GGACGATCCTAAATCTGCTT,0,1924898
ihfAp4,0.16666666666666666,5,5,GGACGAGTGCCGTTATGAGA,0,1930106
ihfAp4,0.16666666666666666,5,5,GGACCGGGTGCTTTAGGTGT,0,1919842
ihfAp4,0.16666666666666666,5,5,GGACATCCATCGTGCGCCGT,0,1912294
ihfAp4,0.16666666666666666,5,5,GGACAGCAATCGCTAGGAAT,0,1912049
ihfAp4,0.16666666666666666,5,5,GGACAAGTATGTGAGAGCTA,0,1910826
ihfAp4,0.16666666666666666,5,5,GGAAGCTTATGTGCGCATTT,0,1930403
ihfAp4,0.16666666666666666,5,5,GGAACTCCACTCGGGGGTTC,0,1951220
ihfAp4,0.16666666666666666,5,5,GCTTTTTGTTCTCATTCCCG,0,1918592
ihfAp4,0.16666666666666666,5,5,GCTTTCCCGGACTCAGGACG,0,1909886
ihfAp4,0.16666666666666666,5,5,GCTTCACTCAGCCAGACCCG,0,1927233
ihfAp4,0.16666666666666666,5,5,GCTGTGGGGAGTATTGCTCG,0,1956499
ihfAp4,0.16666666666666666,5,5,GCTGGCTCCATCATACCAAA,0,1920787
ihfAp4,0.16666666666666666,5,5,GCTGGATCGTTGGTTGTCCT,0,1918945
ihfAp4,0.16666666666666666,5,5,GCTGCTGACATCACCTTTGG,0,1925996
ihfAp4,0.16666666666666666,5,5,GCTGCGTCACCGGTCTATTA,0,1921819
ihfAp4,0.16666666666666666,5,5,GCTCTTACCTGCTGCCCGGC,0,1929881
ihfAp4,0.16666666666666666,5,5,GCTCGAGAGGACTGGCAGGT,0,1949242
ihfAp4,0.16666666666666666,5,5,GCTCCAGTCGTTCGCAGGGT,0,1933246
ihfAp4,0.16666666666666666,5,5,GCTCAGTTTCGGTACGGGTT,0,1946940
ihfAp4,0.16666666666666666,5,5,GCTCAGTTATATGCCTAGCT,0,1949007
ihfAp4,0.16666666666666666,5,5,GCTCAGGAATTAAGACACTG,0,1951569
ihfAp4,0.16666666666666666,5,5,GCTATTCTATGTTACTTCAC,0,1952389
ihfAp4,0.16666666666666666,5,5,GCTAGTTAATCACCAGTCTG,0,1927176
ihfAp4,0.16666666666666666,5,5,GCTAATTTCAGCAATGATCT,0,1926964
ihfAp4,0.16666666666666666,5,5,GCTAAACTTGAGGGGGGAAT,0,1920341
ihfAp4,0.16666666666666666,5,5,GCGTGGTTCCGTAAATCCGA,0,1936224
ihfAp4,0.16666666666666666,5,5,GCGTCTGGTACACTCGGTGT,0,1947102
ihfAp4,0.16666666666666666,5,5,GCGTCAAAAGCACCGGCCAC,0,1910929
ihfAp4,0.16666666666666666,5,5,GCGGTTCTCCAATGAACTTG,0,1941152
ihfAp4,0.16666666666666666,5,5,GCGGTAACAACTACTCTCAC,0,1936004
ihfAp4,0.16666666666666666,5,5,GCGGGGTAACTCACTTGGGG,0,1928589
ihfAp4,0.16666666666666666,5,5,GCGGCAGACAGCGTATCCGT,0,1920943
ihfAp4,0.16666666666666666,5,5,GCGGATGGCCAGGGATTGCA,0,1910561
ihfAp4,0.16666666666666666,5,5,GCGCTATGTCAGTTAGCACA,0,1910942
ihfAp4,0.16666666666666666,5,5,GCGAGGGGATTATGCGATCG,0,1910896
ihfAp4,0.16666666666666666,5,5,GCGAGACGCGAGCGTCGTCG,0,1961679
ihfAp4,0.16666666666666666,5,5,GCGACGTATCGAAATTCAGG,0,1951418
ihfAp4,0.16666666666666666,5,5,GCGAAGGGCTTAACAAAGGC,0,1931703
ihfAp4,0.16666666666666666,5,5,GCCTTACTTGAGTTGCTTAA,0,1909707
ihfAp4,0.16666666666666666,5,5,GCCTAACGTGCGAATCTGCG,0,1944407
ihfAp4,0.16666666666666666,5,5,GCCGGTCGCAGCCTAGTGTT,0,1913651
ihfAp4,0.16666666666666666,5,5,GCCGGGATACCCTTACCGGC,0,1952462
ihfAp4,0.16666666666666666,5,5,GCCCATGCGTGATGTAACGT,0,1946889
ihfAp4,0.16666666666666666,5,5,GCCCAGCTAATATGAGCGAT,0,1947856
ihfAp4,0.16666666666666666,5,5,GCCATGTGTCTACTAGAGCC,0,1915207
ihfAp4,0.16666666666666666,5,5,GCCAGGCGGTGGGGTTCGAG,0,1917896
ihfAp4,0.16666666666666666,5,5,GCATTATGACACTTGACAAG,0,1935316
ihfAp4,0.16666666666666666,5,5,GCATTATATGACGCGTATCA,0,1910946
ihfAp4,0.16666666666666666,5,5,GCATGCGTAAAAGTCCTTTG,0,1919078
ihfAp4,0.16666666666666666,5,5,GCATAAGACATTCCAACCTC,0,1920377
ihfAp4,0.16666666666666666,5,5,GCAGTCTTTGCTCCCCTGAT,0,1949778
ihfAp4,0.16666666666666666,5,5,GCACTGTGACGAATGCTAGC,0,1938205
ihfAp4,0.16666666666666666,5,5,GCACCGACCCCCTCACGGGG,0,1952840
ihfAp4,0.16666666666666666,5,5,GCACCATTATACCGCAGTTA,0,1916588
ihfAp4,0.16666666666666666,5,5,GCAACAATACCTGGAGAGCG,0,1961792
ihfAp4,0.16666666666666666,5,5,GCAAACCTCCGGCGATGGAT,0,1942766
ihfAp4,0.16666666666666666,5,5,GCAAAATACTTTGTTTACTG,0,1947437
ihfAp4,0.16666666666666666,5,5,GATTACGGCCGGCGGTAGTG,0,1952319
ihfAp4,0.16666666666666666,5,5,GATTACACTGGCTCGCTGGT,0,1947773
ihfAp4,0.16666666666666666,5,5,GATGTCGGTTCCCATTACTG,0,1914844
ihfAp4,0.16666666666666666,5,5,GATGGGATATAGCGGTGTAA,0,1926549
ihfAp4,0.16666666666666666,5,5,GATGGCGTTGTTGAGCAGCT,0,1932812
ihfAp4,0.16666666666666666,5,5,GATGCAAGGCGGGCATCATA,0,1947048
ihfAp4,0.16666666666666666,5,5,GATCTGCATGGAGTACATAG,0,1953952
ihfAp4,0.16666666666666666,5,5,GATCATAGTCGGGGTGGGCG,0,1956248
ihfAp4,0.16666666666666666,5,5,GATATATCGCGAGATGGCCG,0,1927831
ihfAp4,0.16666666666666666,5,5,GATAGGGCCTGCGTGGTCCT,0,1953401
ihfAp4,0.16666666666666666,5,5,GATAGGCTGTCCGGGGCCGG,0,1923251
ihfAp4,0.16666666666666666,5,5,GATAGAACTGGCAATCTTGT,0,1954262
ihfAp4,0.16666666666666666,5,5,GAGGTTACTTGATTAGCCCG,0,1938889
ihfAp4,0.16666666666666666,5,5,GAGGTCCTTGTCATCTGACA,0,1937959
ihfAp4,0.16666666666666666,5,5,GAGGCGATATTAAACCGATC,0,1926173
ihfAp4,0.16666666666666666,5,5,GAGCGTCAGGATGCCTCGCC,0,1957075
ihfAp4,0.16666666666666666,5,5,GAGCGAGGTAAACAAACGGG,0,1951427
ihfAp4,0.16666666666666666,5,5,GAGCAGACGTAGTGCCTAAG,0,1959882
ihfAp4,0.16666666666666666,5,5,GAGCAAACATGGCTTCATGT,0,1912093
ihfAp4,0.16666666666666666,5,5,GACTTGGAGGTTATGTAGTG,0,1959740
ihfAp4,0.16666666666666666,5,5,GACTTACCGGATGACCGACA,0,1927881
ihfAp4,0.16666666666666666,5,5,GACGGTCGTGAGGACTGATA,0,1939023
ihfAp4,0.16666666666666666,5,5,GACGCTTTGTTTTCTCACTG,0,1955876
ihfAp4,0.16666666666666666,5,5,GACGATCGTCAAAGAAGAAT,0,1914255
ihfAp4,0.16666666666666666,5,5,GACGAGCTCCTATTGTACAA,0,1920033
ihfAp4,0.16666666666666666,5,5,GACGACTGTATCCAGGAACA,0,1909720
ihfAp4,0.16666666666666666,5,5,GACATGACGTATGTCTTAGT,0,1952322
ihfAp4,0.16666666666666666,5,5,GACAGTCGTAACTCTCCGTG,0,1914523
ihfAp4,0.16666666666666666,5,5,GACAGAACTAAATCTGTAAA,0,1953647
ihfAp4,0.16666666666666666,5,5,GACAACCGTGCTCGGAACAT,0,1919443
ihfAp4,0.16666666666666666,5,5,GAATGACCGCTGACTGTGTA,0,1940981
ihfAp4,0.16666666666666666,5,5,GAATAGAGACCCTACGAGGC,0,1958508
ihfAp4,0.16666666666666666,5,5,GAAGGTGTCTCCTAGCTTAT,0,1929722
ihfAp4,0.16666666666666666,5,5,GAAGGTCATCATGTGTACCG,0,1959182
ihfAp4,0.16666666666666666,5,5,GAAGGCGTTCTGTAACTCGC,0,1917149
ihfAp4,0.16666666666666666,5,5,GAAGCGGGAAAGGTAAAATA,0,1926003
ihfAp4,0.16666666666666666,5,5,GAAGATTTGTCTCGCTTGAG,0,1946600
ihfAp4,0.16666666666666666,5,5,GAACTACTACCTTAGACGGC,0,1948832
ihfAp4,0.16666666666666666,5,5,GAACGGCAGCAAGCTAACAT,0,1953686
ihfAp4,0.16666666666666666,5,5,GAAAATTCCCACGACCTAAT,0,1939454
ihfAp4,0.16666666666666666,5,5,CTTTTAGTCAATAAGGACAT,0,1913672
ihfAp4,0.16666666666666666,5,5,CTTTGTGACACACCATCTTG,0,1928496
ihfAp4,0.16666666666666666,5,5,CTTTCGTGCCTAGTGGAGTG,0,1941494
ihfAp4,0.16666666666666666,5,5,CTTCCGAATGAGAGCGCAGG,0,1960442
ihfAp4,0.16666666666666666,5,5,CTTCCACCTCGCGACGTTGA,0,1953030
ihfAp4,0.16666666666666666,5,5,CTTCAGGCATCGTCTATCAA,0,1938401
ihfAp4,0.16666666666666666,5,5,CTTATGGCAACTGCCGCAAA,0,1933958
ihfAp4,0.16666666666666666,5,5,CTTATCAGCACGGTGCGTCC,0,1914630
ihfAp4,0.16666666666666666,5,5,CTTACTCGGGTAACGCTCCT,0,1938947
ihfAp4,0.16666666666666666,5,5,CTTAAGAGTTGGATACGCTA,0,1947495
ihfAp4,0.16666666666666666,5,5,CTTAAAAGGTCGGCCCCTCT,0,1936219
ihfAp4,0.16666666666666666,5,5,CTGTATCGTGTGTGAGACGG,0,1947527
ihfAp4,0.16666666666666666,5,5,CTGTATAGTCGGTGTTGTCG,0,1958198
ihfAp4,0.16666666666666666,5,5,CTGGTACACTCGGGGGCGGC,0,1935597
ihfAp4,0.16666666666666666,5,5,CTGGGATGGACAGGCATTAG,0,1915223
ihfAp4,0.16666666666666666,5,5,CTGCGTATATAGACGTGCCT,0,1932502
ihfAp4,0.16666666666666666,5,5,CTGCCATTCCGCCGCCACTG,0,1958142
ihfAp4,0.16666666666666666,5,5,CTGATGCCTCTCCACGTAAT,0,1917304
ihfAp4,0.16666666666666666,5,5,CTGACCGCCCTGGACGTACG,0,1933311
ihfAp4,0.16666666666666666,5,5,CTGACATCTCCGAACAGCGG,0,1915204
ihfAp4,0.16666666666666666,5,5,CTGAAAAGGAACGCATGAGG,0,1912748
ihfAp4,0.16666666666666666,5,5,CTCTTGAAACACTTCTGAGC,0,1929412
ihfAp4,0.16666666666666666,5,5,CTCTGTGATGCAATAGGTCT,0,1931511
ihfAp4,0.16666666666666666,5,5,CTCTCTTGTTAAGATGGCCT,0,1927759
ihfAp4,0.16666666666666666,5,5,CTCTAATTGTGAGGTTTAGG,0,1948778
ihfAp4,0.16666666666666666,5,5,CTCGTGACTCCAAAGGAGCG,0,1952452
ihfAp4,0.16666666666666666,5,5,CTCGCTCATGGGCGGGATAC,0,1949580
ihfAp4,0.16666666666666666,5,5,CTCGCGCTGCTTTTGGCTCG,0,1935196
ihfAp4,0.16666666666666666,5,5,CTCGACGACGTAAATTGAAG,0,1912309
ihfAp4,0.16666666666666666,5,5,CTCCTTGAGCGGACCCCAGG,0,1916413
ihfAp4,0.16666666666666666,5,5,CTCCTCAGGTCATCCTGCGC,0,1954441
ihfAp4,0.16666666666666666,5,5,CTCCGCCATCGCAACACTCA,0,1925468
ihfAp4,0.16666666666666666,5,5,CTCCAGTCATTGCGTAACAT,0,1945498
ihfAp4,0.16666666666666666,5,5,CTCACGTACACCTTCGTATA,0,1936240
ihfAp4,0.16666666666666666,5,5,CTCACATAGGCGATCGCAGA,0,1917547
ihfAp4,0.16666666666666666,5,5,CTATCGTAACCTAAAGGCGT,0,1958124
ihfAp4,0.16666666666666666,5,5,CTATCGGAGTGCCATCGTTT,0,1913983
ihfAp4,0.16666666666666666,5,5,CTATAACGGCGTAGTCCTGC,0,1936202
ihfAp4,0.16666666666666666,5,5,CTAGATTCAAAATGCCCGAA,0,1947088
ihfAp4,0.16666666666666666,5,5,CTAGATATACACCGTTTGTA,0,1939672
ihfAp4,0.16666666666666666,5,5,CTAATTTGATAACCCTGGAA,0,1925892
ihfAp4,0.16666666666666666,5,5,CTAATGGTAACCTAGGAAAT,0,1936324
ihfAp4,0.16666666666666666,5,5,CTAATAGGACATATGACTGA,0,1926789
ihfAp4,0.16666666666666666,5,5,CTAATAGACCCCGCTCGTTC,0,1911077
ihfAp4,0.16666666666666666,5,5,CTAACGAACCTCTAACATAC,0,1918448
ihfAp4,0.16666666666666666,5,5,CGTTGAGTCCAAGTTTTTAT,0,1955194
ihfAp4,0.16666666666666666,5,5,CGTGTGTCGCATCTTGGTCA,0,1926084
ihfAp4,0.16666666666666666,5,5,CGTGGTGCAATATAGGACTG,0,1932196
ihfAp4,0.16666666666666666,5,5,CGTGGGAATAAGAAGACTGA,0,1945530
ihfAp4,0.16666666666666666,5,5,CGTGGATCTAGGCTACATCG,0,1925865
ihfAp4,0.16666666666666666,5,5,CGTGGAGTACCGGATGCTAG,0,1941760
ihfAp4,0.16666666666666666,5,5,CGTGCGATGAGGTGCAGATT,0,1946750
ihfAp4,0.16666666666666666,5,5,CGTGATTGTTCCGCAGCTAT,0,1960826
ihfAp4,0.16666666666666666,5,5,CGTGACAGGATGATAGGCTG,0,1925813
ihfAp4,0.16666666666666666,5,5,CGTCTATGGCTAGGTTTAGT,0,1948335
ihfAp4,0.16666666666666666,5,5,CGTCCTCCCGGTTTCAGCAG,0,1924476
ihfAp4,0.16666666666666666,5,5,CGTCATTACTTCGCGACGCA,0,1910874
ihfAp4,0.16666666666666666,5,5,CGTATCGAGGGACCCAGTTG,0,1945980
ihfAp4,0.16666666666666666,5,5,CGTAGGGGTTCCGTCCAAGC,0,1924718
ihfAp4,0.16666666666666666,5,5,CGTACCATGCATGAGCATCA,0,1950964
ihfAp4,0.16666666666666666,5,5,CGTACCAGTGTACCCCGATC,0,1926569
ihfAp4,0.16666666666666666,5,5,CGTACACATCCTTGATGTGG,0,1924290
ihfAp4,0.16666666666666666,5,5,CGTAAAGCGAATTTCAGAAA,0,1921180
ihfAp4,0.16666666666666666,5,5,CGGTGGATGGCACTTCATAG,0,1928477
ihfAp4,0.16666666666666666,5,5,CGGTCGCGCACGAATCAATG,0,1958957
ihfAp4,0.16666666666666666,5,5,CGGTCGATACGCGTGAATTA,0,1948361
ihfAp4,0.16666666666666666,5,5,CGGGTAATAGAGGGGAGATG,0,1946387
ihfAp4,0.16666666666666666,5,5,CGGGGACTGAATCGCCACAG,0,1937631
ihfAp4,0.16666666666666666,5,5,CGGGAGTTGAGATTTTCTTA,0,1914549
ihfAp4,0.16666666666666666,5,5,CGGGAGTACTAGACACCAGG,0,1946328
ihfAp4,0.16666666666666666,5,5,CGGCTAAGGCAAGCTAGAAA,0,1939446
ihfAp4,0.16666666666666666,5,5,CGGCCGGACATGGGTTACAG,0,1919582
ihfAp4,0.16666666666666666,5,5,CGGCACTTGGAGTGAATGGA,0,1950349
ihfAp4,0.16666666666666666,5,5,CGGCACCGATTGGCGAACGT,0,1947530
ihfAp4,0.16666666666666666,5,5,CGGATCATCTGGAGCCTGAG,0,1918850
ihfAp4,0.16666666666666666,5,5,CGGAGTTATGGGAGCATAGT,0,1917171
ihfAp4,0.16666666666666666,5,5,CGGAAGGGATCCTTATTTTG,0,1924193
ihfAp4,0.16666666666666666,5,5,CGCTGTGTACGGATGCTAGT,0,1927991
ihfAp4,0.16666666666666666,5,5,CGCTGTCGCGCTTAGCCGCA,0,1924723
ihfAp4,0.16666666666666666,5,5,CGCTCTTATAGGATGGCGTC,0,1957923
ihfAp4,0.16666666666666666,5,5,CGCGTCTATGGCTGTACAAC,0,1911674
ihfAp4,0.16666666666666666,5,5,CGCGCTGGGTAATACTGTAA,0,1957954
ihfAp4,0.16666666666666666,5,5,CGCGAGCATAAGACGTATGA,0,1953080
ihfAp4,0.16666666666666666,5,5,CGCCCTCACCATGGCGGAGC,0,1918743
ihfAp4,0.16666666666666666,5,5,CGCCAGCTTAGCGAGCGGCC,0,1956661
ihfAp4,0.16666666666666666,5,5,CGCACCCACAGGGCGTGGGA,0,1924096
ihfAp4,0.16666666666666666,5,5,CGCAACCTGCGGTCTGGTCC,0,1911089
ihfAp4,0.16666666666666666,5,5,CGATCGCCCTTCGAGTTAAA,0,1934408
ihfAp4,0.16666666666666666,5,5,CGATAATTCCTGGGGGGATA,0,1922985
ihfAp4,0.16666666666666666,5,5,CGAGGCTTTTGAATTGGTCG,0,1933088
ihfAp4,0.16666666666666666,5,5,CGAGGCACAAAGCTACACCA,0,1957985
ihfAp4,0.16666666666666666,5,5,CGACTGATATTACGTATACG,0,1951363
ihfAp4,0.16666666666666666,5,5,CGACGTAAGTCAACATAACC,0,1958398
ihfAp4,0.16666666666666666,5,5,CGACCATGCAGAAAGTGACC,0,1914867
ihfAp4,0.16666666666666666,5,5,CGACATATATATAATGTTGA,0,1932166
ihfAp4,0.16666666666666666,5,5,CGAAGTACGCTTACACCACT,0,1935556
ihfAp4,0.16666666666666666,5,5,CGAAGCGTGAATAAATCCCC,0,1949216
ihfAp4,0.16666666666666666,5,5,CCTTTGCCACTTCAGGAGGA,0,1925958
ihfAp4,0.16666666666666666,5,5,CCTTCTTCGCAGTCGTAACC,0,1930667
ihfAp4,0.16666666666666666,5,5,CCTTACGAATCCTGCGCGGG,0,1953035
ihfAp4,0.16666666666666666,5,5,CCTTACAGACTCTTTAGTTC,0,1921722
ihfAp4,0.16666666666666666,5,5,CCTGCACTGTGTCTACCTGT,0,1927035
ihfAp4,0.16666666666666666,5,5,CCTCTGGTCGTGTTCATGAT,0,1951489
ihfAp4,0.16666666666666666,5,5,CCTCGCAATCTTGGGTTTTT,0,1914711
ihfAp4,0.16666666666666666,5,5,CCTCAAAGGAGAAGACTAAA,0,1942930
ihfAp4,0.16666666666666666,5,5,CCTATGGAACCTAGCGGCCA,0,1955611
ihfAp4,0.16666666666666666,5,5,CCTAGTAGAGTCTACGTTGA,0,1942801
ihfAp4,0.16666666666666666,5,5,CCTAGCTTAGCGCTCTTCGC,0,1951176
ihfAp4,0.16666666666666666,5,5,CCGTGGGAATGGTAAATCAT,0,1940243
ihfAp4,0.16666666666666666,5,5,CCGGGTAGCAAAAACAAATC,0,1934735
ihfAp4,0.16666666666666666,5,5,CCGGGCTACTGAGTTGGGCA,0,1942881
ihfAp4,0.16666666666666666,5,5,CCGGGCATGGGGAGCTAATG,0,1920117
ihfAp4,0.16666666666666666,5,5,CCGGATATCCTGTCTTTTGC,0,1943136
ihfAp4,0.16666666666666666,5,5,CCGGATAAAAACTTTCCGGA,0,1948103
ihfAp4,0.16666666666666666,5,5,CCGCGGCGCTTTTGCTCTGA,0,1921392
ihfAp4,0.16666666666666666,5,5,CCGCGAGCAAGTCCAGACAG,0,1934584
ihfAp4,0.16666666666666666,5,5,CCGCACTACTAGCAGTTGGT,0,1919794
ihfAp4,0.16666666666666666,5,5,CCGAGGGATACTGAATGACC,0,1936920
ihfAp4,0.16666666666666666,5,5,CCGAGGAGTGATGCCACCGG,0,1959588
ihfAp4,0.16666666666666666,5,5,CCGAAGTGCGCTTAATAGTA,0,1919527
ihfAp4,0.16666666666666666,5,5,CCGAACAAGTACCTATTCAC,0,1931318
ihfAp4,0.16666666666666666,5,5,CCCTTGGCCTCGACCTCAAT,0,1936126
ihfAp4,0.16666666666666666,5,5,CCCTGACAGTGCTGGTCCAT,0,1930420
ihfAp4,0.16666666666666666,5,5,CCCTCACAGCTGAGTGCGTT,0,1920213
ihfAp4,0.16666666666666666,5,5,CCCTAGAGCCGGCACACCAT,0,1950658
ihfAp4,0.16666666666666666,5,5,CCCTACACCGGAGACATTTT,0,1913463
ihfAp4,0.16666666666666666,5,5,CCCGTTCTAAGGTGGGACCA,0,1943235
ihfAp4,0.16666666666666666,5,5,CCCGGAAATTCCTGGGAATC,0,1935295
ihfAp4,0.16666666666666666,5,5,CCCGAATCGACCTGGCAGAC,0,1930477
ihfAp4,0.16666666666666666,5,5,CCCCGTCCTGGCTTAGGCAA,0,1932306
ihfAp4,0.16666666666666666,5,5,CCCCAGGAAGACATGTGTTT,0,1957266
ihfAp4,0.16666666666666666,5,5,CCCCAATTTTGTAAACTGAT,0,1935563
ihfAp4,0.16666666666666666,5,5,CCCATAGGGGGAAGGCACAC,0,1930193
ihfAp4,0.16666666666666666,5,5,CCCACTCGGAGACAGCAAGG,0,1920540
ihfAp4,0.16666666666666666,5,5,CCCACGCAAACGTGCTTGAG,0,1937825
ihfAp4,0.16666666666666666,5,5,CCCAATCCCGTTATCGACTC,0,1939920
ihfAp4,0.16666666666666666,5,5,CCATTACGATTCACAGAGTC,0,1942249
ihfAp4,0.16666666666666666,5,5,CCATGATGAGGAAGCTCGAT,0,1919461
ihfAp4,0.16666666666666666,5,5,CCATCAAGGTTGGACTTAGT,0,1948539
ihfAp4,0.16666666666666666,5,5,CCATACGGACAATGAGCGCA,0,1935468
ihfAp4,0.16666666666666666,5,5,CCAGTATGGACACCCTGTTA,0,1930636
ihfAp4,0.16666666666666666,5,5,CCAGGTCTTCGGCTTTTGTT,0,1960337
ihfAp4,0.16666666666666666,5,5,CCAGCCCCATGAGGCTTAGG,0,1954333
ihfAp4,0.16666666666666666,5,5,CCAGCATCTGACTACTACTT,0,1930495
ihfAp4,0.16666666666666666,5,5,CCAGCAGAGCGGGGAAAATT,0,1958167
ihfAp4,0.16666666666666666,5,5,CCACGTCTGCGCCATGTCAA,0,1922424
ihfAp4,0.16666666666666666,5,5,CCACGGAAACAGAGCTTGCT,0,1928061
ihfAp4,0.16666666666666666,5,5,CCACCGAACTTCAGTGATCG,0,1937811
ihfAp4,0.16666666666666666,5,5,CCACCCCGGGATTCAGTTGT,0,1914792
ihfAp4,0.16666666666666666,5,5,CCACATTAAAAAAGCCAGGA,0,1957306
ihfAp4,0.16666666666666666,5,5,CCAAGCCACGCTTACATGGA,0,1914202
ihfAp4,0.16666666666666666,5,5,CCAAGATCTTGCTTGTCACC,0,1912329
ihfAp4,0.16666666666666666,5,5,CCAACTCCTAATTCATCATA,0,1960694
ihfAp4,0.16666666666666666,5,5,CATTGATTCTAAAAATAAGT,0,1928436
ihfAp4,0.16666666666666666,5,5,CATTCATGCCGGTTTATGAT,0,1916733
ihfAp4,0.16666666666666666,5,5,CATCTTGTCCCGCTCGAGTA,0,1954068
ihfAp4,0.16666666666666666,5,5,CATCTGGAGGATAGTCCCCC,0,1911558
ihfAp4,0.16666666666666666,5,5,CATCCTGTGTCGCCCCCCAT,0,1910267
ihfAp4,0.16666666666666666,5,5,CATCAAGCACTGCTCACATA,0,1935528
ihfAp4,0.16666666666666666,5,5,CATACGCTATGCTGCGTTGC,0,1950341
ihfAp4,0.16666666666666666,5,5,CATAACTATGCAGATAATCC,0,1938769
ihfAp4,0.16666666666666666,5,5,CATAACAAGGCGTCACGTCA,0,1929292
ihfAp4,0.16666666666666666,5,5,CAGTTACGCGGTTCTATGAA,0,1942543
ihfAp4,0.16666666666666666,5,5,CAGTTAAAGAAAGGCTTACC,0,1934223
ihfAp4,0.16666666666666666,5,5,CAGTGAGCGCCAGACTGTTC,0,1952321
ihfAp4,0.16666666666666666,5,5,CAGTGAGCGACCCAGTAGCT,0,1956634
ihfAp4,0.16666666666666666,5,5,CAGTACTCTGTAGGTGCCAT,0,1937208
ihfAp4,0.16666666666666666,5,5,CAGTACCGAGATAGACAGCG,0,1914171
ihfAp4,0.16666666666666666,5,5,CAGTAAAAATGTTCCGAGCC,0,1936365
ihfAp4,0.16666666666666666,5,5,CAGGTCCGCATCCATACTTA,0,1915292
ihfAp4,0.16666666666666666,5,5,CAGGATTACGAGCACGCCAG,0,1932754
ihfAp4,0.16666666666666666,5,5,CAGCCCTCTGAAGGGGTAAT,0,1957860
ihfAp4,0.16666666666666666,5,5,CAGCATGCTGGGACAATTGT,0,1925375
ihfAp4,0.16666666666666666,5,5,CAGCACCGCCCGTTCTTATC,0,1911494
ihfAp4,0.16666666666666666,5,5,CACTCGCTCCGTTTAGTACT,0,1940792
ihfAp4,0.16666666666666666,5,5,CACTCAGCGTCGTATGTCTA,0,1950756
ihfAp4,0.16666666666666666,5,5,CACTAGGAATACAATTCCTG,0,1915214
ihfAp4,0.16666666666666666,5,5,CACGTTTGATAGCGTTTCTA,0,1956332
ihfAp4,0.16666666666666666,5,5,CACGGCGAAAGTATTTCACA,0,1920894
ihfAp4,0.16666666666666666,5,5,CACGGATGCCTCCATACGTC,0,1935760
ihfAp4,0.16666666666666666,5,5,CACGCAACTCAATAGCTATT,0,1922921
ihfAp4,0.16666666666666666,5,5,CACGATGGATGGTGGTGCCA,0,1926902
ihfAp4,0.16666666666666666,5,5,CACGATGCGGGTACACATTG,0,1912212
ihfAp4,0.16666666666666666,5,5,CACCCCAAGTCGCGAAGTCA,0,1961842
ihfAp4,0.16666666666666666,5,5,CACATCGCAGGCGCACTCAC,0,1927321
ihfAp4,0.16666666666666666,5,5,CACACTTACATATATTAGGC,0,1931347
ihfAp4,0.16666666666666666,5,5,CACACCTGTGCCGCGAGGAC,0,1919546
ihfAp4,0.16666666666666666,5,5,CACAACTTGGCTGGTAATGT,0,1922533
ihfAp4,0.16666666666666666,5,5,CAATTTTCCGCTCGTTTGGA,0,1915313
ihfAp4,0.16666666666666666,5,5,CAATTGGTTGAGCTCCCGTC,0,1920404
ihfAp4,0.16666666666666666,5,5,CAATTGGGACCGATTTAGGG,0,1916956
ihfAp4,0.16666666666666666,5,5,CAATCGCCTAGACTGAGGTC,0,1913449
ihfAp4,0.16666666666666666,5,5,CAATCAGTCGAGGGTCGTCA,0,1910573
ihfAp4,0.16666666666666666,5,5,CAATAGCTTGCATTACTAAC,0,1918285
ihfAp4,0.16666666666666666,5,5,CAATAACGAAGACCAGCTCA,0,1913683
ihfAp4,0.16666666666666666,5,5,CAAGTGTTCTTAGAATTATT,0,1935685
ihfAp4,0.16666666666666666,5,5,CAAGTGTGACGAGGTGGGTT,0,1948191
ihfAp4,0.16666666666666666,5,5,CAAATGGTTTAGACCAGCCC,0,1948676
ihfAp4,0.16666666666666666,5,5,CAAAGAATCAGATTAAGGGA,0,1930239
ihfAp4,0.16666666666666666,5,5,CAAAAGCATGCTTGTCAGAT,0,1954043
ihfAp4,0.16666666666666666,5,5,CAAAAAAAGGGGTGTCAGAT,0,1946372
ihfAp4,0.16666666666666666,5,5,ATTTTGCGCCTGCTTAGCGT,0,1961725
ihfAp4,0.16666666666666666,5,5,ATTTTAAATAACTATGTCTT,0,1958270
ihfAp4,0.16666666666666666,5,5,ATTTGGAGGCAAGCACTCTC,0,1949004
ihfAp4,0.16666666666666666,5,5,ATTTAATATTGCTTGCCGAG,0,1952216
ihfAp4,0.16666666666666666,5,5,ATTGTTTAAGCGAAGGGCTG,0,1917494
ihfAp4,0.16666666666666666,5,5,ATTGTCGAGCGTGCGTCAGA,0,1950305
ihfAp4,0.16666666666666666,5,5,ATTGACTGGCTGAAGTAATG,0,1911017
ihfAp4,0.16666666666666666,5,5,ATTCGATAGAGACTTGAAGG,0,1916643
ihfAp4,0.16666666666666666,5,5,ATTATCAGTTATAGGACATA,0,1958534
ihfAp4,0.16666666666666666,5,5,ATTACAGTACTGCGATATAA,0,1939676
ihfAp4,0.16666666666666666,5,5,ATTAATCGGGCGGACTTTCC,0,1934702
ihfAp4,0.16666666666666666,5,5,ATGTTTCACACGATTTGAAA,0,1914852
ihfAp4,0.16666666666666666,5,5,ATGTTTAAGCGAGGAAAACC,0,1956370
ihfAp4,0.16666666666666666,5,5,ATGTACTGGTTAAATACAAT,0,1922460
ihfAp4,0.16666666666666666,5,5,ATGGTTGCTAGCTTTCGACC,0,1911642
ihfAp4,0.16666666666666666,5,5,ATGGTCGAACAGCCGCGCGT,0,1941431
ihfAp4,0.16666666666666666,5,5,ATGGGGTAACTGCAAGTTGT,0,1941415
ihfAp4,0.16666666666666666,5,5,ATGGATTAAAGACCTGAGCG,0,1948570
ihfAp4,0.16666666666666666,5,5,ATGCGTTGTATTTCCAGAAA,0,1929156
ihfAp4,0.16666666666666666,5,5,ATGCGGAGCATCTTGGTCGC,0,1915734
ihfAp4,0.16666666666666666,5,5,ATGCGCTCATTATCTATGCA,0,1931506
ihfAp4,0.16666666666666666,5,5,ATGCCCGGCTACCAGGGACT,0,1957121
ihfAp4,0.16666666666666666,5,5,ATGCCACAGTGCGCATAGTT,0,1950362
ihfAp4,0.16666666666666666,5,5,ATCTGCAGTGGTTTGTCTAT,0,1947860
ihfAp4,0.16666666666666666,5,5,ATCTCGAACGTCCAGTAAAC,0,1923397
ihfAp4,0.16666666666666666,5,5,ATCGTTTTTAAGCGGCGGTG,0,1944939
ihfAp4,0.16666666666666666,5,5,ATCGTTCGGCAACGGTTAGT,0,1924862
ihfAp4,0.16666666666666666,5,5,ATCGGCTCCTAAGTAACAAC,0,1921381
ihfAp4,0.16666666666666666,5,5,ATCGAGCAACGTCGCGCAAT,0,1914961
ihfAp4,0.16666666666666666,5,5,ATCGACGGAGGATCGCTCCT,0,1942116
ihfAp4,0.16666666666666666,5,5,ATCCGAAGAATGCTCACGCA,0,1920642
ihfAp4,0.16666666666666666,5,5,ATCCACAGTAGAGGATAACA,0,1959519
ihfAp4,0.16666666666666666,5,5,ATCAAGTAGCCTGGAACATA,0,1920472
ihfAp4,0.16666666666666666,5,5,ATATGTGGCACGCGGCACAT,0,1910298
ihfAp4,0.16666666666666666,5,5,ATATGGTAACAAGGTAAAAC,0,1952387
ihfAp4,0.16666666666666666,5,5,ATATGAGCAGTGTTACTAAG,0,1917125
ihfAp4,0.16666666666666666,5,5,ATATAACTCTGGGCTCTCAG,0,1954894
ihfAp4,0.16666666666666666,5,5,ATAGGTTGCTCAAAGACCCA,0,1946173
ihfAp4,0.16666666666666666,5,5,ATAGGGAAGACGGGTTACCC,0,1951948
ihfAp4,0.16666666666666666,5,5,ATAGCCATTCTCCGACAAGC,0,1911554
ihfAp4,0.16666666666666666,5,5,ATAGCAATTTCGGTCAGGAA,0,1955092
ihfAp4,0.16666666666666666,5,5,ATAGCAACATTTTGGCTTTT,0,1910540
ihfAp4,0.16666666666666666,5,5,ATACCAGACCGTTTGAGTTA,0,1955511
ihfAp4,0.16666666666666666,5,5,ATAAGGGCGAGGTTGCAATG,0,1917055
ihfAp4,0.16666666666666666,5,5,ATAAGCGTGAGTAAATTTTT,0,1916355
ihfAp4,0.16666666666666666,5,5,ATAAATTGATATTGCAAGGT,0,1945476
ihfAp4,0.16666666666666666,5,5,ATAAAGTATTGGTGTTACAC,0,1948633
ihfAp4,0.16666666666666666,5,5,AGTTGCTTTGGGTTGTAGTA,0,1955106
ihfAp4,0.16666666666666666,5,5,AGTTGCTTGAAGGCGGAACA,0,1930942
ihfAp4,0.16666666666666666,5,5,AGTTGACAAAGCACACTGTA,0,1919517
ihfAp4,0.16666666666666666,5,5,AGTTCTTGTGACAGTCGCAG,0,1943470
ihfAp4,0.16666666666666666,5,5,AGTCCGCCGTAATTATCTCT,0,1940453
ihfAp4,0.16666666666666666,5,5,AGTATGTCAAAATTTGTTTA,0,1951780
ihfAp4,0.16666666666666666,5,5,AGTATAAGGTAGGTATGATC,0,1925575
ihfAp4,0.16666666666666666,5,5,AGTAGGCATTTCGTCGGTAA,0,1937930
ihfAp4,0.16666666666666666,5,5,AGTAGAGCCCATGGGTCGGC,0,1953624
ihfAp4,0.16666666666666666,5,5,AGTACCATTTGATGAAAGGG,0,1915654
ihfAp4,0.16666666666666666,5,5,AGTAAATTTGGTGTAAGGGG,0,1925633
ihfAp4,0.16666666666666666,5,5,AGGTTACCAGGCTGCGACAG,0,1939953
ihfAp4,0.16666666666666666,5,5,AGGTGCTATGTGTGATGGCA,0,1925611
ihfAp4,0.16666666666666666,5,5,AGGTCTCCACCATTTTTTTA,0,1931118
ihfAp4,0.16666666666666666,5,5,AGGTAGTTGCGTAGATTTGG,0,1919568
ihfAp4,0.16666666666666666,5,5,AGGTAGTTATCCATGCCCCT,0,1918564
ihfAp4,0.16666666666666666,5,5,AGGGTCACATCTACGGCGGC,0,1957359
ihfAp4,0.16666666666666666,5,5,AGGGCATACAGGTGTCGCTC,0,1928422
ihfAp4,0.16666666666666666,5,5,AGGGAGGTCACGGAGAGCCA,0,1936281
ihfAp4,0.16666666666666666,5,5,AGGCTAACGGAGGTATCCAC,0,1956831
ihfAp4,0.16666666666666666,5,5,AGGCGCATAGTGTTGTCACG,0,1952831
ihfAp4,0.16666666666666666,5,5,AGGACAGCTAGATTGGTGGG,0,1957869
ihfAp4,0.16666666666666666,5,5,AGCTTAGTCGGCTGCGGAGA,0,1941694
ihfAp4,0.16666666666666666,5,5,AGCTCTAATCTGCGATCTCT,0,1938138
ihfAp4,0.16666666666666666,5,5,AGCGTAAGACGATGAAGCCC,0,1926431
ihfAp4,0.16666666666666666,5,5,AGCGGGCTATGTACTTGCCT,0,1927481
ihfAp4,0.16666666666666666,5,5,AGCGGATGGAGGATTGCCGG,0,1913031
ihfAp4,0.16666666666666666,5,5,AGCCGGGATCCTTTCCTTAT,0,1932267
ihfAp4,0.16666666666666666,5,5,AGCCGATCAACAGTCAAAAG,0,1918232
ihfAp4,0.16666666666666666,5,5,AGCCGACATTAGCAACTCGG,0,1913809
ihfAp4,0.16666666666666666,5,5,AGCCCGTCTCCACAGTACCG,0,1950001
ihfAp4,0.16666666666666666,5,5,AGCCCGCCAGAATGGGTACG,0,1937005
ihfAp4,0.16666666666666666,5,5,AGCCCGAACCCGTCACGTTG,0,1930451
ihfAp4,0.16666666666666666,5,5,AGCCATCACCGGTCTATTTA,0,1952906
ihfAp4,0.16666666666666666,5,5,AGCATCTCACGCGCCGGAAC,0,1928915
ihfAp4,0.16666666666666666,5,5,AGCAGTTGATACATGGACTT,0,1917498
ihfAp4,0.16666666666666666,5,5,AGCACCTCCCTGATCGGTCA,0,1955636
ihfAp4,0.16666666666666666,5,5,AGCAATGGGGGCGACTATAC,0,1954915
ihfAp4,0.16666666666666666,5,5,AGCAAACGTCTGCCATTCTC,0,1953887
ihfAp4,0.16666666666666666,5,5,AGATGCTGTGTACATCCTCC,0,1942229
ihfAp4,0.16666666666666666,5,5,AGATGACGATAGGTGTTTAA,0,1951986
ihfAp4,0.16666666666666666,5,5,AGATCTTGAATGACCCGGAC,0,1910013
ihfAp4,0.16666666666666666,5,5,AGATCTAACGAATTATGCTC,0,1941843
ihfAp4,0.16666666666666666,5,5,AGATAAGCATGTAGAGTATC,0,1923370
ihfAp4,0.16666666666666666,5,5,AGACCGTTTGAAGGCTTTGA,0,1926565
ihfAp4,0.16666666666666666,5,5,AGAATTTTGCACATCCATGA,0,1929335
ihfAp4,0.16666666666666666,5,5,AGAATTCGTATGTTCGCGAC,0,1947131
ihfAp4,0.16666666666666666,5,5,AGAATCTACGTTGAGCCAGT,0,1911734
ihfAp4,0.16666666666666666,5,5,AGAATCGGGCGCATGGCCTG,0,1943243
ihfAp4,0.16666666666666666,5,5,AGAAGTTGTACGAGGAGATG,0,1915203
ihfAp4,0.16666666666666666,5,5,AGAAGATTGCGCCACAAGGA,0,1948211
ihfAp4,0.16666666666666666,5,5,ACTTGGTTAGTGACAATGTT,0,1919932
ihfAp4,0.16666666666666666,5,5,ACTTGGGGGCCATTATAATT,0,1912699
ihfAp4,0.16666666666666666,5,5,ACTTGGAGAACTCATTACAG,0,1939434
ihfAp4,0.16666666666666666,5,5,ACTTCTTGCCGGAAGACTTT,0,1948432
ihfAp4,0.16666666666666666,5,5,ACTTATGCTAGAGATCAATA,0,1939438
ihfAp4,0.16666666666666666,5,5,ACTTACTTGACTTAAGGCGT,0,1929969
ihfAp4,0.16666666666666666,5,5,ACTGTGGACGTGACAGGCCA,0,1911628
ihfAp4,0.16666666666666666,5,5,ACTGTCTGTACTGGAGCCGT,0,1940513
ihfAp4,0.16666666666666666,5,5,ACTGGGTGAACTAAGTCGTA,0,1946924
ihfAp4,0.16666666666666666,5,5,ACTGGGAAGCGAGTGCGTTG,0,1930805
ihfAp4,0.16666666666666666,5,5,ACTGATCTTTTACTCTCCGA,0,1955451
ihfAp4,0.16666666666666666,5,5,ACTGAGTATTCCATACAAGT,0,1941543
ihfAp4,0.16666666666666666,5,5,ACTCCCTGTTCCTCCCGCGG,0,1954135
ihfAp4,0.16666666666666666,5,5,ACTCCAAACTAACCACAGAA,0,1916706
ihfAp4,0.16666666666666666,5,5,ACTCATGGAGACTACGAAAA,0,1948817
ihfAp4,0.16666666666666666,5,5,ACTCATCCTTGAAGGCAGCT,0,1939592
ihfAp4,0.16666666666666666,5,5,ACTCAGCCGCTTGCAATCTG,0,1946789
ihfAp4,0.16666666666666666,5,5,ACTATGTGCCACCGTTAGAC,0,1938307
ihfAp4,0.16666666666666666,5,5,ACTATAGACGTCTTCGGTGT,0,1936035
ihfAp4,0.16666666666666666,5,5,ACTAGCCGTTAGTGCAAGAT,0,1961659
ihfAp4,0.16666666666666666,5,5,ACTAACTCACATTCTATATC,0,1912918
ihfAp4,0.16666666666666666,5,5,ACGTTGGGTTAGGATTGTGC,0,1924428
ihfAp4,0.16666666666666666,5,5,ACGTGATTATAGACGACTAC,0,1935571
ihfAp4,0.16666666666666666,5,5,ACGTATCGATAGATCGGTAA,0,1952010
ihfAp4,0.16666666666666666,5,5,ACGTAGTTATGGCCCAGTGG,0,1936739
ihfAp4,0.16666666666666666,5,5,ACGGTTCCCCGCCAACACTA,0,1913867
ihfAp4,0.16666666666666666,5,5,ACGGTCTGAGTAGAATTTAT,0,1933864
ihfAp4,0.16666666666666666,5,5,ACGGAGCAGAGGGGTGACTC,0,1950690
ihfAp4,0.16666666666666666,5,5,ACGGACAATTATAGATTGCA,0,1926752
ihfAp4,0.16666666666666666,5,5,ACGGAACTAGGTCATAACGA,0,1938776
ihfAp4,0.16666666666666666,5,5,ACGCTGTTGGGCTAAGCTAA,0,1947847
ihfAp4,0.16666666666666666,5,5,ACGCTGATCTTAACCATAGG,0,1953598
ihfAp4,0.16666666666666666,5,5,ACGCCGAAAGCGCCACGACG,0,1945060
ihfAp4,0.16666666666666666,5,5,ACGAGCCGTAGGGGAAGGGC,0,1917072
ihfAp4,0.16666666666666666,5,5,ACCTTAGGACAGGGGATGCA,0,1930229
ihfAp4,0.16666666666666666,5,5,ACCTAAGGGGACTCTCACGA,0,1909907
ihfAp4,0.16666666666666666,5,5,ACCGTGCGTTAGGAGACATA,0,1956789
ihfAp4,0.16666666666666666,5,5,ACCGGTGCCATCGTACCAAC,0,1958218
ihfAp4,0.16666666666666666,5,5,ACCGCTTCGGTGTACATAAA,0,1961854
ihfAp4,0.16666666666666666,5,5,ACCGCCTTCATGTCGCTGGT,0,1943002
ihfAp4,0.16666666666666666,5,5,ACCGAGTTTAAGGAATGTGA,0,1938894
ihfAp4,0.16666666666666666,5,5,ACCAGTCTACCAACAAGCGC,0,1939930
ihfAp4,0.16666666666666666,5,5,ACCAGTAGCGCAAAGCCCAA,0,1956909
ihfAp4,0.16666666666666666,5,5,ACCACTGAGATACGTGACCT,0,1924809
ihfAp4,0.16666666666666666,5,5,ACCACGGTCTCTGCCAACGC,0,1938141
ihfAp4,0.16666666666666666,5,5,ACATTGTATGTCTGTACGGC,0,1952640
ihfAp4,0.16666666666666666,5,5,ACATTAGACAGTTCGGTATG,0,1947915
ihfAp4,0.16666666666666666,5,5,ACAGCAGGGTCACATAGTTG,0,1955866
ihfAp4,0.16666666666666666,5,5,ACACTTGCTGCAGTCCTGCA,0,1913240
ihfAp4,0.16666666666666666,5,5,ACACCGGTTCAGGGGATTTC,0,1916796
ihfAp4,0.16666666666666666,5,5,ACAAGGCTTTCGCGATGTTC,0,1927049
ihfAp4,0.16666666666666666,5,5,ACAACCATGTCGCCGTCTGA,0,1916052
ihfAp4,0.16666666666666666,5,5,AATTTTGCGGACGTTTGAGT,0,1934864
ihfAp4,0.16666666666666666,5,5,AATTGGCTCTAGCGGATGCT,0,1917188
ihfAp4,0.16666666666666666,5,5,AATGTTTCTTGCGAATTCTA,0,1954352
ihfAp4,0.16666666666666666,5,5,AATGGGCGGCGCGACCGCAG,0,1953325
ihfAp4,0.16666666666666666,5,5,AATGCATGCGCTAATTCGAG,0,1925082
ihfAp4,0.16666666666666666,5,5,AATGAGAGCGCGCGAGCCCT,0,1952929
ihfAp4,0.16666666666666666,5,5,AATCTGTCATGCATCTGCCC,0,1916033
ihfAp4,0.16666666666666666,5,5,AATCTCTATAGTTGGTCGGT,0,1956242
ihfAp4,0.16666666666666666,5,5,AATCCAGACTAAGCAATAGA,0,1917640
ihfAp4,0.16666666666666666,5,5,AATCATCGAATGGTACTTTC,0,1953135
ihfAp4,0.16666666666666666,5,5,AATAGGTACGACGAAGGATT,0,1916223
ihfAp4,0.16666666666666666,5,5,AATAGGAGTGTAAGTGAGGT,0,1941772
ihfAp4,0.16666666666666666,5,5,AATAGCGTTCTCACCTAAGA,0,1948088
ihfAp4,0.16666666666666666,5,5,AATACGGGATCACGAACGGG,0,1939998
ihfAp4,0.16666666666666666,5,5,AATAACGAGGCTGCCTGGCC,0,1916639
ihfAp4,0.16666666666666666,5,5,AATAACAAGCCTACATGTGT,0,1947337
ihfAp4,0.16666666666666666,5,5,AAGTGTCACCGTTTCGAAAT,0,1920806
ihfAp4,0.16666666666666666,5,5,AAGTAGAACCGGTTATGCTT,0,1915030
ihfAp4,0.16666666666666666,5,5,AAGGCTACCTGGCTAAGGAA,0,1915294
ihfAp4,0.16666666666666666,5,5,AAGGCAGTGTACTATCCTCT,0,1923136
ihfAp4,0.16666666666666666,5,5,AAGCCGGGGCTGGTATGCTA,0,1921309
ihfAp4,0.16666666666666666,5,5,AAGCCCTACTTGTTTGGCCA,0,1946247
ihfAp4,0.16666666666666666,5,5,AAGCATTGGTTGTCGTGTCT,0,1952841
ihfAp4,0.16666666666666666,5,5,AAGCAGAAGACGGGACGGGT,0,1960594
ihfAp4,0.16666666666666666,5,5,AAGACTCTCGTACGTGAGTC,0,1954109
ihfAp4,0.16666666666666666,5,5,AAGACCCTATTTTCAGGCTT,0,1928546
ihfAp4,0.16666666666666666,5,5,AACTGGCGGGAGCGTATCTG,0,1921493
ihfAp4,0.16666666666666666,5,5,AACTCATGATGATGGGGCCT,0,1948151
ihfAp4,0.16666666666666666,5,5,AACTAGGCCTCAACTATGGT,0,1911603
ihfAp4,0.16666666666666666,5,5,AACGTGTGTAAAATTGGCCA,0,1951438
ihfAp4,0.16666666666666666,5,5,AACGTCGCAATCGGTGTATG,0,1953855
ihfAp4,0.16666666666666666,5,5,AACGTCGAGGAATTGCATAG,0,1945554
ihfAp4,0.16666666666666666,5,5,AACGGCGCTGCTCGACTAGC,0,1943597
ihfAp4,0.16666666666666666,5,5,AACGGCGCGAGGGGGACCTA,0,1942606
ihfAp4,0.16666666666666666,5,5,AACGCCTGGTACTTTGTCAG,0,1946494
ihfAp4,0.16666666666666666,5,5,AACGAGTTCTATGGCGGCAG,0,1956059
ihfAp4,0.16666666666666666,5,5,AACCATTTAGTGAACTGTTT,0,1958269
ihfAp4,0.16666666666666666,5,5,AACCAGGCTGGGCAGGACGC,0,1945058
ihfAp4,0.16666666666666666,5,5,AACATTAAGGCTTTCCGGGC,0,1913916
ihfAp4,0.16666666666666666,5,5,AACATCCAGGTTCACAAACG,0,1932881
ihfAp4,0.16666666666666666,5,5,AAATAACTGTGTGCTAAAGG,0,1931365
ihfAp4,0.16666666666666666,5,5,AAAGGGAGCATGCTACTTGC,0,1950088
ihfAp4,0.16666666666666666,5,5,AAAGGCACCCGTCGGACTTG,0,1928728
ihfAp4,0.16666666666666666,5,5,AAAGACGTTGTACCCGCGAG,0,1958393
ihfAp4,0.16666666666666666,5,5,AAACTCCCGATCTGACCGGC,0,1920110
ihfAp4,0.16666666666666666,5,5,AAACTAAGGCATTCACGGCA,0,1958243
ihfAp4,0.16666666666666666,5,5,AAACGACCGTCTATAATCGG,0,1911561
ihfAp4,0.16666666666666666,5,5,AAACCTGGTTTGGTGTCATT,0,1916554
ihfAp4,0.16666666666666666,5,5,AAACCGCAATTTGCTCCATC,0,1929144
ihfAp4,0.16666666666666666,5,5,AAACAGGTTAGTCCTGAGGG,0,1922709
ihfAp4,0.16666666666666666,5,5,AAACAGGCCGGGAACTCGGG,0,1961389
ihfAp4,0.16666666666666666,5,5,AAAAGGTAAAAGGAACCAAT,0,1938044
ihfAp4,0.16666666666666666,5,5,AAAAGACAGTATACACAGTC,0,1918922
ihfAp4,0.16666666666666666,5,5,AAAAATACTAATGATCCAAC,0,1921397
ihfAp4,0.16666666666666666,5,5,AAAAAGATCATACTGGCGGC,0,1917420
ihfAp4,0.2,4,4,TTTTGGGACTTGTCCTTGCA,0,1952720
ihfAp4,0.2,4,4,TTTTCTTTTCACCTGACGCA,0,1913018
ihfAp4,0.2,4,4,TTTTCGCAGTGTCAAGTGAT,0,1960243
ihfAp4,0.2,4,4,TTTTACGTGAGGGGTTCTTC,0,1939452
ihfAp4,0.2,4,4,TTTTACCCGGGAGGAGAATT,0,1912539
ihfAp4,0.2,4,4,TTTGTGCATATGTACAACAA,0,1913847
ihfAp4,0.2,4,4,TTTGGCCGAGGCGGAGCCGC,0,1960393
ihfAp4,0.2,4,4,TTTGCTTTAACCCTGAATGT,0,1932654
ihfAp4,0.2,4,4,TTTGCTGCGGGCTGACGAGG,0,1923089
ihfAp4,0.2,4,4,TTTGCGTCTTTTAAAGGGTT,0,1957085
ihfAp4,0.2,4,4,TTTCTACACTTGCGAAAGTG,0,1946661
ihfAp4,0.2,4,4,TTTCGCAGTGCGTTCGAAAA,0,1953546
ihfAp4,0.2,4,4,TTTCGATTGTTCAATGGCCT,0,1912067
ihfAp4,0.2,4,4,TTTCCATCCGAGTGGAGACA,0,1950801
ihfAp4,0.2,4,4,TTTATTTGGGCCATACGCGT,0,1912885
ihfAp4,0.2,4,4,TTTATCGAAGGTGTACAAAC,0,1928873
ihfAp4,0.2,4,4,TTTAATTACGAGAGCATAGT,0,1909906
ihfAp4,0.2,4,4,TTTAATCGTAGACGCTCTGT,0,1916424
ihfAp4,0.2,4,4,TTTAACGGGATCGTTTCGTT,0,1924624
ihfAp4,0.2,4,4,TTTAACAGTTTTTTGTAGAG,0,1942636
ihfAp4,0.2,4,4,TTGTTTGGTAGGTCGGTATA,0,1921286
ihfAp4,0.2,4,4,TTGTTAATAGGTGGCACCCT,0,1922185
ihfAp4,0.2,4,4,TTGTGCGGATATCTCAGTCC,0,1939944
ihfAp4,0.2,4,4,TTGTGCGCTGGAATGATAGG,0,1922354
ihfAp4,0.2,4,4,TTGTCGTACGTGGTCCATTT,0,1942587
ihfAp4,0.2,4,4,TTGTCAGTGACTATCCCTTC,0,1927323
ihfAp4,0.2,4,4,TTGGTGTAGGCAGCTTCGTT,0,1928650
ihfAp4,0.2,4,4,TTGGTAGGCAACGCAACCGA,0,1945941
ihfAp4,0.2,4,4,TTGGGTGTTGCAGGCAAATA,0,1938703
ihfAp4,0.2,4,4,TTGGCTACCTTTGGAAAGCG,0,1914849
ihfAp4,0.2,4,4,TTGGATCTAACGTTGGGTCT,0,1930854
ihfAp4,0.2,4,4,TTGCGGTAGTTCCTGCCAAA,0,1917779
ihfAp4,0.2,4,4,TTGCGGGCGGCATAATCGGA,0,1914793
ihfAp4,0.2,4,4,TTGCCTCATGTGTAGTAGGA,0,1933891
ihfAp4,0.2,4,4,TTGCCTAGCGCTCTTCCCGG,0,1925227
ihfAp4,0.2,4,4,TTGCATAGTCGGAGTACTGC,0,1946968
ihfAp4,0.2,4,4,TTGCAGACCTATACATATAT,0,1953958
ihfAp4,0.2,4,4,TTGATCTCAGACTAATTCAG,0,1951901
ihfAp4,0.2,4,4,TTGATAGCGTGTCGATGATT,0,1923903
ihfAp4,0.2,4,4,TTGATAGCCCTAACTCAGGG,0,1953945
ihfAp4,0.2,4,4,TTGAGGGAATTTATGTAGTA,0,1923193
ihfAp4,0.2,4,4,TTGACAGTTCAATTGCATGG,0,1953272
ihfAp4,0.2,4,4,TTCTCATCTCCGATTGCTAT,0,1941671
ihfAp4,0.2,4,4,TTCTATTCAGGCGCCAATAT,0,1940564
ihfAp4,0.2,4,4,TTCGTGGTCCCGAGAATGAA,0,1934160
ihfAp4,0.2,4,4,TTCGTACCGCGTACAATGGC,0,1960857
ihfAp4,0.2,4,4,TTCGCTTCGAATGATTCGCT,0,1914628
ihfAp4,0.2,4,4,TTCGAGGGGATGTCATTTCA,0,1923773
ihfAp4,0.2,4,4,TTCCTTAGCCTTTCCGAAAG,0,1923021
ihfAp4,0.2,4,4,TTCCGCTCTGGTCGAGCTCT,0,1918310
ihfAp4,0.2,4,4,TTCCCGCTTCCACGATGACG,0,1924881
ihfAp4,0.2,4,4,TTCCCGCACAGCTCTAGGCA,0,1926815
ihfAp4,0.2,4,4,TTCATAGAGCCGTGCACATT,0,1925997
ihfAp4,0.2,4,4,TTCAGACGTGTTGCATTCAC,0,1942120
ihfAp4,0.2,4,4,TTCACTTTCCGTGGAAGCGG,0,1939748
ihfAp4,0.2,4,4,TTCACGCACTATTCGGATAT,0,1960642
ihfAp4,0.2,4,4,TTCAAAGGGGTTGAGGGAAT,0,1920355
ihfAp4,0.2,4,4,TTATTGGAGAGTAGGAAGCG,0,1949457
ihfAp4,0.2,4,4,TTATGGAGTCGGACGCTTCG,0,1930486
ihfAp4,0.2,4,4,TTATAGAATATACTTGGGTC,0,1920720
ihfAp4,0.2,4,4,TTATAATCCTAGCAAGAAAG,0,1942074
ihfAp4,0.2,4,4,TTAGTCTATTTTGTTGCGGG,0,1944852
ihfAp4,0.2,4,4,TTAGCGATACATGTATGTTT,0,1956672
ihfAp4,0.2,4,4,TTAGCCCCTCAATCGAGATT,0,1938110
ihfAp4,0.2,4,4,TTACTTGCCTCCTGCAACAT,0,1935508
ihfAp4,0.2,4,4,TTACTGGTTGATGGCCTGTG,0,1922994
ihfAp4,0.2,4,4,TTACGATTCAGTATCGGAAG,0,1923845
ihfAp4,0.2,4,4,TTACGAAAGGTGCCGATGTG,0,1921313
ihfAp4,0.2,4,4,TTACCATTTGGGACACTACC,0,1941531
ihfAp4,0.2,4,4,TTACAGTCTTATTGCAGTTA,0,1951641
ihfAp4,0.2,4,4,TTAAGTTATGTAGGAACGAC,0,1949107
ihfAp4,0.2,4,4,TTAAGTACCGATTTATCTGG,0,1954935
ihfAp4,0.2,4,4,TTAAATATAAGGGCTGTCAT,0,1925296
ihfAp4,0.2,4,4,TTAAAATGGCGGGAGAGGCA,0,1925924
ihfAp4,0.2,4,4,TGTTTTCGGTTCTGTCTTTT,0,1937945
ihfAp4,0.2,4,4,TGTTTGACCTTTGCACGAAA,0,1930733
ihfAp4,0.2,4,4,TGTTCCTTGCATGCGTAGAG,0,1941245
ihfAp4,0.2,4,4,TGTTCCACGACTGGGACGTC,0,1948893
ihfAp4,0.2,4,4,TGTGGTAACGACACGCACCC,0,1946154
ihfAp4,0.2,4,4,TGTGGCGTGGCGCTACCAAC,0,1909769
ihfAp4,0.2,4,4,TGTGAGTGGGTATGGACGAG,0,1931706
ihfAp4,0.2,4,4,TGTCTGAGTTAGGCGGGCGC,0,1948795
ihfAp4,0.2,4,4,TGTCTACAGCCGGTTTATCA,0,1943223
ihfAp4,0.2,4,4,TGTCCCCTGCTGGCGGCACG,0,1931777
ihfAp4,0.2,4,4,TGTATGGACGCATCCTCGGA,0,1926627
ihfAp4,0.2,4,4,TGTATGCAACTAGGAAGAGT,0,1936706
ihfAp4,0.2,4,4,TGTAAGCATTGACTATAATT,0,1918652
ihfAp4,0.2,4,4,TGGTTGAACATGCTATTCTG,0,1936300
ihfAp4,0.2,4,4,TGGTTCACTACCGCCGCACG,0,1950016
ihfAp4,0.2,4,4,TGGTTATTAGACTTATTATA,0,1959181
ihfAp4,0.2,4,4,TGGTATACTGGGTCGCTCTC,0,1930827
ihfAp4,0.2,4,4,TGGTAACGTTCAACGGTCGC,0,1923510
ihfAp4,0.2,4,4,TGGGTGAACATTCGCGGGGC,0,1937222
ihfAp4,0.2,4,4,TGGGATTGTAGCGACTCTGC,0,1931776
ihfAp4,0.2,4,4,TGGGATTCCAGCCGTGCGGC,0,1925836
ihfAp4,0.2,4,4,TGGGAGAAACCAATCGCAGA,0,1949376
ihfAp4,0.2,4,4,TGGCTCTCGGGCCAAACAGA,0,1912418
ihfAp4,0.2,4,4,TGGCGTATGCTTGCGGATTT,0,1910566
ihfAp4,0.2,4,4,TGGCGCCATACAGGAAATTT,0,1926846
ihfAp4,0.2,4,4,TGGCGATTAGATATTTGGGG,0,1954732
ihfAp4,0.2,4,4,TGGCATTGTAATTAATAAAT,0,1931354
ihfAp4,0.2,4,4,TGGCAGTCATAACAAATCAT,0,1935686
ihfAp4,0.2,4,4,TGGCAAACCAACTATTAGAA,0,1939665
ihfAp4,0.2,4,4,TGGATCTAAGAGCGGACCGA,0,1958686
ihfAp4,0.2,4,4,TGGAGTAGTGTGAATGAAAA,0,1937893
ihfAp4,0.2,4,4,TGCGATTTAATGATGCCCTG,0,1912051
ihfAp4,0.2,4,4,TGCGACGGGGCGGATCGGTG,0,1913522
ihfAp4,0.2,4,4,TGCGAAAGCTGGGACGTCTT,0,1928691
ihfAp4,0.2,4,4,TGCCTGGGATGGATGTCAGG,0,1923962
ihfAp4,0.2,4,4,TGCCGGAAAGTATATAGATT,0,1954658
ihfAp4,0.2,4,4,TGCCGCTAGTTGAATGTAGT,0,1921723
ihfAp4,0.2,4,4,TGCCAGCAAGACATTGGTCG,0,1911738
ihfAp4,0.2,4,4,TGCAGTGCCAACTCGTTTTC,0,1909650
ihfAp4,0.2,4,4,TGCACTCATGACGCATGACG,0,1950147
ihfAp4,0.2,4,4,TGCACCAGTGCCAGTTACGC,0,1939060
ihfAp4,0.2,4,4,TGCACAGCAAGAATGGGCTA,0,1910825
ihfAp4,0.2,4,4,TGATCACGTGAGAGTTCTGC,0,1916029
ihfAp4,0.2,4,4,TGAGTGAAGTTTCTTGCGGG,0,1911719
ihfAp4,0.2,4,4,TGAGTCGCTGGCCGTATAGG,0,1926904
ihfAp4,0.2,4,4,TGAGCTTGCTTGGGTTATCC,0,1947260
ihfAp4,0.2,4,4,TGAGCGCCATCGGTGCTTCA,0,1915560
ihfAp4,0.2,4,4,TGAGCCTCTTCGGAATGCAA,0,1910016
ihfAp4,0.2,4,4,TGAGATCGAGTGACTCACCG,0,1944681
ihfAp4,0.2,4,4,TGAAGTGTAAGTCACTTCGA,0,1948572
ihfAp4,0.2,4,4,TGAACTACGCGGTTCCGCTA,0,1961308
ihfAp4,0.2,4,4,TGAAAGATCGCGGTCGGTAA,0,1931546
ihfAp4,0.2,4,4,TCTTTGGCAGGTACTGCCCG,0,1921887
ihfAp4,0.2,4,4,TCTTTGACTCGTAGTATCGC,0,1921972
ihfAp4,0.2,4,4,TCTTCTGCCACAACACATGA,0,1954194
ihfAp4,0.2,4,4,TCTTACGGTGCAAAAGTGAG,0,1916957
ihfAp4,0.2,4,4,TCTGGTTTGCAGTCATCCAC,0,1943530
ihfAp4,0.2,4,4,TCTGCGGCAGACTTGACCCA,0,1946540
ihfAp4,0.2,4,4,TCTGACAGATGGGCGGTTCA,0,1916317
ihfAp4,0.2,4,4,TCTCGCTTGGGCGCGATCAC,0,1960235
ihfAp4,0.2,4,4,TCTCCTGCGGTGCCGTTCAT,0,1923999
ihfAp4,0.2,4,4,TCTCCGTGCGGATACGTTCT,0,1938144
ihfAp4,0.2,4,4,TCTCCACAGCCAGGTGCAAC,0,1913236
ihfAp4,0.2,4,4,TCTAATCAGCCGTTGGGAAG,0,1926421
ihfAp4,0.2,4,4,TCTAATAAACCATGCGATTA,0,1959835
ihfAp4,0.2,4,4,TCGTTTTGCGGCTTACCCAC,0,1927634
ihfAp4,0.2,4,4,TCGTTTGGGTGAGTGGATCA,0,1940708
ihfAp4,0.2,4,4,TCGTTCATGTTTGAGACGAC,0,1937875
ihfAp4,0.2,4,4,TCGTTAGCCGGCCTCATCAA,0,1923155
ihfAp4,0.2,4,4,TCGTGCACGCTGTTCACATA,0,1929461
ihfAp4,0.2,4,4,TCGGTGGTCAGAGAGAGACC,0,1910174
ihfAp4,0.2,4,4,TCGGGACATAGTGGTTTATA,0,1956186
ihfAp4,0.2,4,4,TCGGATTAGGGGCGCTCCAG,0,1931647
ihfAp4,0.2,4,4,TCGCTTGCTACCGTGTGTTA,0,1961214
ihfAp4,0.2,4,4,TCGCCGCCGACATGGGGGTA,0,1911858
ihfAp4,0.2,4,4,TCGAGATGACGCGGATAATC,0,1915854
ihfAp4,0.2,4,4,TCGAAAGGCTTCTAAGAGTA,0,1934196
ihfAp4,0.2,4,4,TCGAAACATTGTCCGCGTAT,0,1944232
ihfAp4,0.2,4,4,TCGAAACATCATCAGCATTA,0,1948491
ihfAp4,0.2,4,4,TCCTTGCGGAAGCGGGCGGT,0,1918495
ihfAp4,0.2,4,4,TCCGGCGAGTTGGGAAGACA,0,1910286
ihfAp4,0.2,4,4,TCCCGTGAAATAACGCGCGT,0,1928340
ihfAp4,0.2,4,4,TCCCCTTCGACAGTGTCTAA,0,1948534
ihfAp4,0.2,4,4,TCCCCACGCACTGTTTAAAT,0,1951801
ihfAp4,0.2,4,4,TCATTCGCGAGATCGCATGG,0,1914506
ihfAp4,0.2,4,4,TCATGTAGAGAGGGTGCCGT,0,1952103
ihfAp4,0.2,4,4,TCATGGGGAGCCGACTGGGA,0,1935634
ihfAp4,0.2,4,4,TCATGGCAACTTTAGGTAGA,0,1959450
ihfAp4,0.2,4,4,TCATGGACCAACCCTTCTTA,0,1947072
ihfAp4,0.2,4,4,TCATGCAGCTTGCCATCTAT,0,1959661
ihfAp4,0.2,4,4,TCATAATAGACAGTTCGTTA,0,1949566
ihfAp4,0.2,4,4,TCAGCGGGAAAAAAGTAGGA,0,1933342
ihfAp4,0.2,4,4,TCAGCAAGGATCACAGTCCG,0,1917078
ihfAp4,0.2,4,4,TCACGGCTTCGGGTGATGCC,0,1924802
ihfAp4,0.2,4,4,TCACCGGCCGGGACCAGACT,0,1923552
ihfAp4,0.2,4,4,TCACCAGTATGGGGTGGATG,0,1916301
ihfAp4,0.2,4,4,TCAATTGGTTGTAAATTACG,0,1939742
ihfAp4,0.2,4,4,TCAAGTGAATAATTGGTACG,0,1938039
ihfAp4,0.2,4,4,TCAAGGTTACAATGGCGAGG,0,1919528
ihfAp4,0.2,4,4,TCAACATCTGCAAATGAGTG,0,1925282
ihfAp4,0.2,4,4,TCAAATGCGGGTGGCAACTA,0,1912627
ihfAp4,0.2,4,4,TATTTTTTCTCAGGGACACC,0,1951171
ihfAp4,0.2,4,4,TATTTCAAGTCGTGGCGAAG,0,1929220
ihfAp4,0.2,4,4,TATTTACACTCGTGTACAAC,0,1951882
ihfAp4,0.2,4,4,TATTGGTTTGGTACGTATAC,0,1921334
ihfAp4,0.2,4,4,TATTATAACAGCGGTTTCAT,0,1927971
ihfAp4,0.2,4,4,TATGTCTCGCCTCACAGGGA,0,1947497
ihfAp4,0.2,4,4,TATGGGATCTGCGGGGTGCG,0,1940419
ihfAp4,0.2,4,4,TATCGGAGAACTTTCTTCCC,0,1942737
ihfAp4,0.2,4,4,TATCCGGTGGGTAGCTCCTT,0,1954708
ihfAp4,0.2,4,4,TATCCAATGCGCTGCACCTA,0,1932575
ihfAp4,0.2,4,4,TATCCAAATGCGGGCCTTAA,0,1916840
ihfAp4,0.2,4,4,TATCATCCTATTCCGTAATA,0,1953613
ihfAp4,0.2,4,4,TATCAGCCGCGGGGTGGAAA,0,1923802
ihfAp4,0.2,4,4,TATATCGAAAATTGTCTAAG,0,1956598
ihfAp4,0.2,4,4,TATATATTCTGCACAGGGCC,0,1928442
ihfAp4,0.2,4,4,TATATATCTGCGTCGTGATG,0,1935593
ihfAp4,0.2,4,4,TATAGCAGTCTAGGGGCTCC,0,1911681
ihfAp4,0.2,4,4,TATACCAGCGCGTGTAAACG,0,1961361
ihfAp4,0.2,4,4,TATACAGTAACCTCTAGTCT,0,1929126
ihfAp4,0.2,4,4,TATACACACTGTCTGCTCTA,0,1936199
ihfAp4,0.2,4,4,TAGGGTATATTCATACCGGT,0,1935105
ihfAp4,0.2,4,4,TAGGGGTACTTTACAACTCT,0,1936159
ihfAp4,0.2,4,4,TAGGATAGTAGGCGTTGTTT,0,1925354
ihfAp4,0.2,4,4,TAGCTAAGCCCATGCTTATT,0,1928144
ihfAp4,0.2,4,4,TAGCGTTGGCCTATACCGGA,0,1929108
ihfAp4,0.2,4,4,TAGCCGAGCCCAATGACCTT,0,1922378
ihfAp4,0.2,4,4,TAGCCCCCTCCATCATCCGC,0,1952282
ihfAp4,0.2,4,4,TAGCAAAAGTTGAACTGCAA,0,1924951
ihfAp4,0.2,4,4,TAGATAGTGTACAGTGTTCG,0,1931896
ihfAp4,0.2,4,4,TAGAGCTAAGTCGTAATCTC,0,1910218
ihfAp4,0.2,4,4,TAGACTTTGGTTTCGGTGAA,0,1925841
ihfAp4,0.2,4,4,TAGACCCTGTCACATGCCTT,0,1931989
ihfAp4,0.2,4,4,TAGACATCATCGTTCGCTCC,0,1942793
ihfAp4,0.2,4,4,TAGAAGGATTACGCAGGATA,0,1954479
ihfAp4,0.2,4,4,TACTTTGGCGTCCCAACCAA,0,1941746
ihfAp4,0.2,4,4,TACTTAGAGGCTCCTGAGTT,0,1935541
ihfAp4,0.2,4,4,TACTGGTGATACACCCTTAG,0,1954224
ihfAp4,0.2,4,4,TACGTGCAGCAGACTCTATA,0,1943443
ihfAp4,0.2,4,4,TACGTAACAGTGAATCATCG,0,1917701
ihfAp4,0.2,4,4,TACGGATGGTAATACCTGCG,0,1943659
ihfAp4,0.2,4,4,TACCTCTTAAGAACCTCCCC,0,1924445
ihfAp4,0.2,4,4,TACCGTATATCGTACGGTTG,0,1945360
ihfAp4,0.2,4,4,TACCCAGACTTCGCCAGCCC,0,1921100
ihfAp4,0.2,4,4,TACCCACCCGCACTGTCGTC,0,1952351
ihfAp4,0.2,4,4,TACCAATACGACTCAAATAT,0,1943526
ihfAp4,0.2,4,4,TACAGACCCGTGCGGGAAGT,0,1937506
ihfAp4,0.2,4,4,TACACCCGCCATCGAGAATC,0,1950384
ihfAp4,0.2,4,4,TACAAAGTTTTTTGTTCGTT,0,1937417
ihfAp4,0.2,4,4,TAATGCATGGGAGCAAATGT,0,1944510
ihfAp4,0.2,4,4,TAATCGAAGGACTCATGATT,0,1913065
ihfAp4,0.2,4,4,TAATATGGCCTGCGGTTAGC,0,1917066
ihfAp4,0.2,4,4,TAATACGGCGAATCCTGGCA,0,1916833
ihfAp4,0.2,4,4,TAAGTTACGGTGATGTTAAG,0,1923115
ihfAp4,0.2,4,4,TAAGGTATTAGTGTAAATTT,0,1927306
ihfAp4,0.2,4,4,TAAGCGTATAAATAACCGTA,0,1930110
ihfAp4,0.2,4,4,TAAGCACCCCTAGTAGATGC,0,1912283
ihfAp4,0.2,4,4,TAAGACTGATTTGTCGCGGC,0,1960215
ihfAp4,0.2,4,4,TAACTTAGTATAGTGTTGAT,0,1945182
ihfAp4,0.2,4,4,TAACTATAGATAGTCTGGCT,0,1939127
ihfAp4,0.2,4,4,TAACCGAGCGCGGCTTCAGG,0,1923739
ihfAp4,0.2,4,4,TAACATCTTTCTACCTGGAC,0,1940011
ihfAp4,0.2,4,4,TAACAGGGCTTTACGAATGT,0,1916830
ihfAp4,0.2,4,4,TAACAGGGCATATCTCACGG,0,1928679
ihfAp4,0.2,4,4,GTTTTACTCTGGGAAGTCAG,0,1923161
ihfAp4,0.2,4,4,GTTTCGCTTAAACATTACTT,0,1921858
ihfAp4,0.2,4,4,GTTTAATATAGTGGGCCTGT,0,1938775
ihfAp4,0.2,4,4,GTTGTTCTAACTTTAACTCA,0,1947711
ihfAp4,0.2,4,4,GTTGGCTCACATAGGCCGCG,0,1941149
ihfAp4,0.2,4,4,GTTGGATTGAGCAGCGGGGT,0,1913721
ihfAp4,0.2,4,4,GTTCTAGCGATATCCCTCGC,0,1959991
ihfAp4,0.2,4,4,GTTCAGTAGGCGTGGTGCTT,0,1935424
ihfAp4,0.2,4,4,GTTCAGGGTATACCGAGCGA,0,1922339
ihfAp4,0.2,4,4,GTTCACTCTGCTTCGCGCGC,0,1913913
ihfAp4,0.2,4,4,GTTAATTTTGCTTTAAACCC,0,1959130
ihfAp4,0.2,4,4,GTGTTGATATTGGAAAGCGA,0,1919316
ihfAp4,0.2,4,4,GTGTCTCGGGGGAAATGAAG,0,1930807
ihfAp4,0.2,4,4,GTGTCCCAACGATACGGCGC,0,1955639
ihfAp4,0.2,4,4,GTGTAATGAAGCTACTCTGT,0,1927699
ihfAp4,0.2,4,4,GTGGGCTGGTTCTTTGTCCA,0,1924820
ihfAp4,0.2,4,4,GTGGGCCGGACGAGCTCTTG,0,1929518
ihfAp4,0.2,4,4,GTGGCTGGCGATTGGTCATA,0,1932993
ihfAp4,0.2,4,4,GTGGATCGGTTGAGCGAAAA,0,1958265
ihfAp4,0.2,4,4,GTGGAGGGTGTCTGTTGGGG,0,1939659
ihfAp4,0.2,4,4,GTGGAACCGAGTAGTTGGCC,0,1944067
ihfAp4,0.2,4,4,GTGCTTTAAAGGGTTCAATG,0,1912612
ihfAp4,0.2,4,4,GTGCTTCCATAGCTTTCTGG,0,1956787
ihfAp4,0.2,4,4,GTGCTGGTAAGCCCACATAG,0,1947954
ihfAp4,0.2,4,4,GTGCGGAAAGGTTCATGAAA,0,1940467
ihfAp4,0.2,4,4,GTGCCAATAGGACCAGGTAT,0,1935532
ihfAp4,0.2,4,4,GTGCAGAAAACAGGGGTCCC,0,1956212
ihfAp4,0.2,4,4,GTGCAATAAAGCGTCTTACT,0,1959319
ihfAp4,0.2,4,4,GTGACGCGTTTAATCAGTGC,0,1957709
ihfAp4,0.2,4,4,GTGAACTGTAGCTCTGACAT,0,1945925
ihfAp4,0.2,4,4,GTGAACTATATGAATATCAC,0,1953308
ihfAp4,0.2,4,4,GTCGTTCTTAAAAAGCCGCC,0,1943736
ihfAp4,0.2,4,4,GTCGTCTCGAGATACTGGGA,0,1925463
ihfAp4,0.2,4,4,GTCGGTATTGAGTGGACCTC,0,1928820
ihfAp4,0.2,4,4,GTCAGACTTCGTGTAGCAGG,0,1958775
ihfAp4,0.2,4,4,GTCACCAGGCAGGGCCAACA,0,1951502
ihfAp4,0.2,4,4,GTATTTCCACGCAGTAACTA,0,1912088
ihfAp4,0.2,4,4,GTATGGCCGGATCACTTCGT,0,1934729
ihfAp4,0.2,4,4,GTATGCGATCACAATACCAT,0,1943053
ihfAp4,0.2,4,4,GTATGAGTGGGAATTATATA,0,1957027
ihfAp4,0.2,4,4,GTAGTTCGAAATTAAGACTT,0,1950077
ihfAp4,0.2,4,4,GTAGGCCAGTATCTGTCAGT,0,1940739
ihfAp4,0.2,4,4,GTAGATAGTGCAGCCTTCGA,0,1936656
ihfAp4,0.2,4,4,GTAGAAGGGCCTTCTTGTGA,0,1930356
ihfAp4,0.2,4,4,GTAGAACCGGTCGATAAGAG,0,1947604
ihfAp4,0.2,4,4,GTACGTTCGCTTGATTGTTA,0,1910232
ihfAp4,0.2,4,4,GTACATCCGACTGAAAGGAG,0,1934525
ihfAp4,0.2,4,4,GTACAATGCTAAGCTTGTCA,0,1948813
ihfAp4,0.2,4,4,GTAAGGGGACGGCGGCGCCT,0,1925380
ihfAp4,0.2,4,4,GTAACCTCAAGACGTCATCA,0,1920778
ihfAp4,0.2,4,4,GGTTTCTCGATCAAGTAATA,0,1912280
ihfAp4,0.2,4,4,GGTTGGTTGACCTCGGGGTA,0,1922970
ihfAp4,0.2,4,4,GGTTGGACTGGCAATGTCTA,0,1944909
ihfAp4,0.2,4,4,GGTTGACATTTTCGATCAGA,0,1923404
ihfAp4,0.2,4,4,GGTTCACATCCGGATCTGGG,0,1955213
ihfAp4,0.2,4,4,GGTTACGGGCAATAGTTCGG,0,1931685
ihfAp4,0.2,4,4,GGTTAAGACAGCCTCAGAAC,0,1945845
ihfAp4,0.2,4,4,GGTGTGTTGGTTACGTTACC,0,1954138
ihfAp4,0.2,4,4,GGTGTATGTTATAATGCACC,0,1935108
ihfAp4,0.2,4,4,GGTGCGTGCATCCCGAGACA,0,1938196
ihfAp4,0.2,4,4,GGTGCGAAAATGCTTAACTG,0,1929544
ihfAp4,0.2,4,4,GGTCTGGAAGTGGGTCTGTG,0,1955952
ihfAp4,0.2,4,4,GGTCTCCTCCCATTGTCCAT,0,1936247
ihfAp4,0.2,4,4,GGTCTAAGATTTGTGGTTTA,0,1944438
ihfAp4,0.2,4,4,GGTCAGTGGTGGCGGATGAT,0,1958495
ihfAp4,0.2,4,4,GGTCACGGCTCGGTAACAGT,0,1940152
ihfAp4,0.2,4,4,GGTATTCCCCCGAGGTCGTC,0,1921209
ihfAp4,0.2,4,4,GGTATTCCAGCAAAGCTGGT,0,1959586
ihfAp4,0.2,4,4,GGTATTAAGCGAGCCTTACG,0,1919027
ihfAp4,0.2,4,4,GGTAAACTAGCAGACGCTAG,0,1945319
ihfAp4,0.2,4,4,GGGTGCTCTACCGTATATAG,0,1920204
ihfAp4,0.2,4,4,GGGTCCCCTGTCGATTTAAG,0,1913990
ihfAp4,0.2,4,4,GGGTATTAGAAAGTAGGTTT,0,1942072
ihfAp4,0.2,4,4,GGGTACCGGTGCATACTTTA,0,1910605
ihfAp4,0.2,4,4,GGGGTCCTTGCTGGCGGTAT,0,1937434
ihfAp4,0.2,4,4,GGGGCTCTCAAAGGGTGAGC,0,1916893
ihfAp4,0.2,4,4,GGGGATTGTTGCTGGTACTG,0,1914062
ihfAp4,0.2,4,4,GGGGAGTAGGCTCCCTTACA,0,1953232
ihfAp4,0.2,4,4,GGGGAGCATTATGGGCAGCG,0,1937572
ihfAp4,0.2,4,4,GGGCTGCATGCGCCCTACGT,0,1943175
ihfAp4,0.2,4,4,GGGCGCTGACTATCGTGAGG,0,1917473
ihfAp4,0.2,4,4,GGGCGCTAGTGACAAGGGTC,0,1938772
ihfAp4,0.2,4,4,GGGCCGAATGTCCGTCTATC,0,1925908
ihfAp4,0.2,4,4,GGGCAGGTCAAATATTGCTG,0,1961451
ihfAp4,0.2,4,4,GGGATCGTTTCCGCCCGTAA,0,1913708
ihfAp4,0.2,4,4,GGGAAGCGGATAACGGAGAA,0,1911292
ihfAp4,0.2,4,4,GGGAACTCTGGTGATCAGGC,0,1912145
ihfAp4,0.2,4,4,GGCTTGTAAGGTATGGAGTC,0,1920160
ihfAp4,0.2,4,4,GGCGTCGAATGGGGCTAATA,0,1923659
ihfAp4,0.2,4,4,GGCGTCACTCCGATGCGACT,0,1935269
ihfAp4,0.2,4,4,GGCGGAGCCGGACTGCAGTG,0,1944700
ihfAp4,0.2,4,4,GGCGGAAGCTAGGGTAAGGC,0,1962206
ihfAp4,0.2,4,4,GGCGCTCGAGAGATCCCAAA,0,1944990
ihfAp4,0.2,4,4,GGCGCAAATTTTCCACTAGG,0,1946885
ihfAp4,0.2,4,4,GGCCTGAGGGAAATTGATGA,0,1919783
ihfAp4,0.2,4,4,GGCCGTTCTCTATTGGTCCT,0,1941366
ihfAp4,0.2,4,4,GGCCCATATCTTCGGAATTG,0,1950512
ihfAp4,0.2,4,4,GGCCCAGTCTAAAGGCGTCC,0,1923497
ihfAp4,0.2,4,4,GGCACTTCAAGGCTTGGGGG,0,1918993
ihfAp4,0.2,4,4,GGCAAGCCTGGTTGGGACGC,0,1958454
ihfAp4,0.2,4,4,GGCAAGCACGCTACCGTGGG,0,1957527
ihfAp4,0.2,4,4,GGCAACTCGCGTCCTGGTAC,0,1919054
ihfAp4,0.2,4,4,GGATTATTCATAATGGGAAT,0,1950431
ihfAp4,0.2,4,4,GGATAGTGCCATCCCGGGAG,0,1909872
ihfAp4,0.2,4,4,GGATACGCCCCTTATTCCAC,0,1925664
ihfAp4,0.2,4,4,GGAGTTTTTTTAGATCAGTG,0,1952045
ihfAp4,0.2,4,4,GGAGTCGGACAGTGAGGGTG,0,1946594
ihfAp4,0.2,4,4,GGAGGCGTGCGCACACGGTC,0,1916480
ihfAp4,0.2,4,4,GGAGGCGCGCGAACGAAATC,0,1920625
ihfAp4,0.2,4,4,GGAGGAGAATCCGAGGAACC,0,1925168
ihfAp4,0.2,4,4,GGAGATGTACGCCTGAAAGC,0,1938941
ihfAp4,0.2,4,4,GGACTTAGGGCGCAAGGACG,0,1936077
ihfAp4,0.2,4,4,GGACGAGCGCGAATTGTCAA,0,1948615
ihfAp4,0.2,4,4,GGACATCGGGCACGTGCAGG,0,1942313
ihfAp4,0.2,4,4,GGACAGCACGGTGCGTAGGC,0,1935019
ihfAp4,0.2,4,4,GGAACCGCAAACAGAGGCAG,0,1919634
ihfAp4,0.2,4,4,GGAACCACCAGCTTGTGATA,0,1916921
ihfAp4,0.2,4,4,GCTTCTGCGCGGGCGTATTG,0,1931849
ihfAp4,0.2,4,4,GCTTACTGATTTGCGAAGGG,0,1934749
ihfAp4,0.2,4,4,GCTGCCGCCGACAAAGGCCC,0,1944603
ihfAp4,0.2,4,4,GCTGAGCGGGAGTGGTGCAC,0,1915495
ihfAp4,0.2,4,4,GCTCGCTAACTATCGAAGCG,0,1940657
ihfAp4,0.2,4,4,GCTAGAGTACAAACTCGCCA,0,1934738
ihfAp4,0.2,4,4,GCTACTGAAAGAGATCAGCC,0,1926967
ihfAp4,0.2,4,4,GCTACAACCGAACCGGCAAG,0,1912119
ihfAp4,0.2,4,4,GCTAATGTGAAAATAGCAAC,0,1919272
ihfAp4,0.2,4,4,GCTAACTGAAGACACAACAA,0,1942325
ihfAp4,0.2,4,4,GCGTCGTTGCAGCTCGGACA,0,1931001
ihfAp4,0.2,4,4,GCGTCAGTCTATATCTACGT,0,1924201
ihfAp4,0.2,4,4,GCGTCAGTACAACACAACGA,0,1931605
ihfAp4,0.2,4,4,GCGTCAGGGTACTAGGATTA,0,1916130
ihfAp4,0.2,4,4,GCGTCACGCATGGTCCTCTA,0,1948883
ihfAp4,0.2,4,4,GCGGTTTCTAAAAATTCGCT,0,1953880
ihfAp4,0.2,4,4,GCGGTGCCAGACACATAGAG,0,1911028
ihfAp4,0.2,4,4,GCGGGATGGCCCCGAGCTTG,0,1918803
ihfAp4,0.2,4,4,GCGGCGGGAGTGGCAACGCC,0,1923505
ihfAp4,0.2,4,4,GCGGAGAGTTCTATGGAATA,0,1944351
ihfAp4,0.2,4,4,GCGCGCTGCAGGGTACTACA,0,1911985
ihfAp4,0.2,4,4,GCGCCTTGTGTAATAGGTAA,0,1928387
ihfAp4,0.2,4,4,GCGCACATGCGGTGGCAGGT,0,1954202
ihfAp4,0.2,4,4,GCGATGCGTTTTTATGATAT,0,1955958
ihfAp4,0.2,4,4,GCGAGAGATGAAGGTGTGAC,0,1922692
ihfAp4,0.2,4,4,GCGACCATATATTAGGCCCC,0,1936544
ihfAp4,0.2,4,4,GCGAAGGTGTGCAATGTATT,0,1925140
ihfAp4,0.2,4,4,GCGAAGATAGATCATTCAGA,0,1929727
ihfAp4,0.2,4,4,GCGAACACATTAAGAGATTG,0,1943999
ihfAp4,0.2,4,4,GCCTTGTGTAAGTTGTTAGG,0,1921551
ihfAp4,0.2,4,4,GCCTTGGTTTAAATAGACAG,0,1955190
ihfAp4,0.2,4,4,GCCTTATATGACAATGGTTG,0,1933020
ihfAp4,0.2,4,4,GCCTTAATTCGGGGGACTCA,0,1936153
ihfAp4,0.2,4,4,GCCTGGCGGGGGAGGAACCT,0,1957643
ihfAp4,0.2,4,4,GCCTGATAAGTTTGGTACAG,0,1939957
ihfAp4,0.2,4,4,GCCTACCCTACAGGATCCAT,0,1935093
ihfAp4,0.2,4,4,GCCGTTTGTCTACACTGGAA,0,1914066
ihfAp4,0.2,4,4,GCCGCAGCCTTTCCGTGTAC,0,1928503
ihfAp4,0.2,4,4,GCCGATTGTTGTTCCCCTCG,0,1929988
ihfAp4,0.2,4,4,GCCGAGGATGGATCAAGCGC,0,1953122
ihfAp4,0.2,4,4,GCCCTTAGGTTGGTCACATT,0,1957178
ihfAp4,0.2,4,4,GCCCTGGTGGCAAGTTGGGG,0,1956384
ihfAp4,0.2,4,4,GCCCTACGGTTTTTTTCGCC,0,1917351
ihfAp4,0.2,4,4,GCCCGTTCTACACCCGCCAA,0,1961474
ihfAp4,0.2,4,4,GCCCCGGTTCAACCCACAAC,0,1945613
ihfAp4,0.2,4,4,GCCCCAGGCATGGCCATAAG,0,1919305
ihfAp4,0.2,4,4,GCCATCGTATAAACATGTAT,0,1950743
ihfAp4,0.2,4,4,GCATTGCATGTAGTGTGGAC,0,1927084
ihfAp4,0.2,4,4,GCATGTGTCATAGGGCCTAC,0,1949950
ihfAp4,0.2,4,4,GCATGAAGCCAGTTGTTGAA,0,1923326
ihfAp4,0.2,4,4,GCATCCACTACTTACAAGCC,0,1952760
ihfAp4,0.2,4,4,GCATATGATAGTAATATAAT,0,1944007
ihfAp4,0.2,4,4,GCATAACAGGATGCCTTCGT,0,1938465
ihfAp4,0.2,4,4,GCAGTTCGTATGGGCTGGAT,0,1917607
ihfAp4,0.2,4,4,GCAGGTTGAGTTCTTAACAA,0,1946630
ihfAp4,0.2,4,4,GCAGGTGCTCCCCGACTTTA,0,1933147
ihfAp4,0.2,4,4,GCAGACGGATTCGCTGGACA,0,1962203
ihfAp4,0.2,4,4,GCACCTCGTCGTATTACGTT,0,1914355
ihfAp4,0.2,4,4,GCACCCAGCGCCGAAGAATA,0,1937507
ihfAp4,0.2,4,4,GCACAAAGAGGAGTGCGATG,0,1934985
ihfAp4,0.2,4,4,GCAAGGGGAGAGTTGACACG,0,1953694
ihfAp4,0.2,4,4,GCAAGGCTACCTTAACTCTG,0,1945507
ihfAp4,0.2,4,4,GCAAAGATGAAGCCCGGTGA,0,1958821
ihfAp4,0.2,4,4,GCAAAAACGCGGAACATCCA,0,1944326
ihfAp4,0.2,4,4,GATTGAGCTGGTAAACGATA,0,1944318
ihfAp4,0.2,4,4,GATTCTTGGGGCTGGTTCCG,0,1943113
ihfAp4,0.2,4,4,GATGTCAGGAGGTGACGAAC,0,1915843
ihfAp4,0.2,4,4,GATGCTCAACAGGATCCCAC,0,1935488
ihfAp4,0.2,4,4,GATCGCCGGATCAAAGAAAT,0,1942248
ihfAp4,0.2,4,4,GATCCCCGGGATAGATATCA,0,1954107
ihfAp4,0.2,4,4,GATCCAAGTAGGACAACTGA,0,1916299
ihfAp4,0.2,4,4,GATCATCCTGGGTATCGAGC,0,1956883
ihfAp4,0.2,4,4,GATATGCGTGCTGTCGCGCA,0,1944418
ihfAp4,0.2,4,4,GATATATATGACCCGTCGAA,0,1946801
ihfAp4,0.2,4,4,GATAGGCTAGAATTAGCATT,0,1960246
ihfAp4,0.2,4,4,GATAAGTTCCTAACCATAGA,0,1945717
ihfAp4,0.2,4,4,GATAACGGATGTCCTTGAGT,0,1947584
ihfAp4,0.2,4,4,GAGGGTCCCCCACTTTCACA,0,1934984
ihfAp4,0.2,4,4,GAGGAGGCGAGTGCGACGGG,0,1914749
ihfAp4,0.2,4,4,GAGCGGATTTACATTGGAGA,0,1909835
ihfAp4,0.2,4,4,GAGCGCTACCTGATCTAAGA,0,1939932
ihfAp4,0.2,4,4,GAGCGCGGTTATCACAGATC,0,1927967
ihfAp4,0.2,4,4,GAGCGCAGTTGCCTGAAAAT,0,1931755
ihfAp4,0.2,4,4,GAGCCTCCCGTCCCCCTGCT,0,1941997
ihfAp4,0.2,4,4,GAGAGTTTGATCTCACATCC,0,1921482
ihfAp4,0.2,4,4,GAGAATGTGGGAAATTGAGG,0,1944414
ihfAp4,0.2,4,4,GAGAACGAGTAACGACCAGT,0,1911428
ihfAp4,0.2,4,4,GACTTTTCTCACCTGAACGG,0,1953025
ihfAp4,0.2,4,4,GACTGGCGTTACCGAGATGG,0,1956619
ihfAp4,0.2,4,4,GACTCTCAACTACCCATTCA,0,1923498
ihfAp4,0.2,4,4,GACTAAGGCAGGATGGATCC,0,1937649
ihfAp4,0.2,4,4,GACGTTTTTGCTACGGCCAG,0,1950090
ihfAp4,0.2,4,4,GACGTAATATCTGCGATTAC,0,1952754
ihfAp4,0.2,4,4,GACGGATACGCTACTTTTCA,0,1932796
ihfAp4,0.2,4,4,GACGACCCACCTGACTAATC,0,1956924
ihfAp4,0.2,4,4,GACCCGTTTTAGAATTTTTG,0,1912562
ihfAp4,0.2,4,4,GACCCACCGGTTGGGGTAGT,0,1948514
ihfAp4,0.2,4,4,GACCCAACGAGGAGCCGACG,0,1940951
ihfAp4,0.2,4,4,GACATTGGCTCGGCATGGAT,0,1955254
ihfAp4,0.2,4,4,GACAGGTATAAACAAAGGTT,0,1959397
ihfAp4,0.2,4,4,GACAGCGGTAACGAGTTTAC,0,1938664
ihfAp4,0.2,4,4,GACACACGTGAAGTTTAAGC,0,1955447
ihfAp4,0.2,4,4,GACAAGTGTATCTGTCGTGT,0,1911029
ihfAp4,0.2,4,4,GACAAAGTTGGCATACTTGG,0,1951920
ihfAp4,0.2,4,4,GACAAAGCGAACGTTTGTTT,0,1947603
ihfAp4,0.2,4,4,GAATGCATAGACCGGTGAGC,0,1929885
ihfAp4,0.2,4,4,GAATCATCTTTTGGTCGTAG,0,1920857
ihfAp4,0.2,4,4,GAATATGGCGTCGCAGATGA,0,1912009
ihfAp4,0.2,4,4,GAATACCAATGGTGCATCCT,0,1917652
ihfAp4,0.2,4,4,GAACTGGATTCTTGGGTACG,0,1917155
ihfAp4,0.2,4,4,GAACTCCACGCTAGGACCGG,0,1945715
ihfAp4,0.2,4,4,GAACGAGTTATCCTTGCCTT,0,1909799
ihfAp4,0.2,4,4,GAACATCGCGCTTCGGCCTT,0,1917196
ihfAp4,0.2,4,4,GAACACAACTTTCGCAGTTT,0,1946356
ihfAp4,0.2,4,4,GAACAAAGACCTGCAATCGT,0,1932749
ihfAp4,0.2,4,4,GAAATAACATATGTTCCAGC,0,1951838
ihfAp4,0.2,4,4,GAAACTAGCAAGGCTCGATA,0,1951711
ihfAp4,0.2,4,4,GAAAACGATCATAGACTGGA,0,1917699
ihfAp4,0.2,4,4,GAAAACCCATCCATGAGGCG,0,1935900
ihfAp4,0.2,4,4,GAAAAAAGGGTAGGAAACCT,0,1914020
ihfAp4,0.2,4,4,CTTTTTCCGTTTGTACGGTC,0,1958555
ihfAp4,0.2,4,4,CTTTTCTACACAAGATGAAT,0,1947918
ihfAp4,0.2,4,4,CTTTGACAGTCAACTTGACA,0,1934029
ihfAp4,0.2,4,4,CTTTCTCGTCGGAACCCTCG,0,1918361
ihfAp4,0.2,4,4,CTTTATGTACGTCCATCATA,0,1917004
ihfAp4,0.2,4,4,CTTGTTCGCCGGAACGGTGT,0,1913457
ihfAp4,0.2,4,4,CTTGCAGTCGGTTAGAGCCA,0,1956935
ihfAp4,0.2,4,4,CTTGATTACGATAGGCCTTA,0,1911994
ihfAp4,0.2,4,4,CTTGAATAACAATGGGCAGG,0,1931502
ihfAp4,0.2,4,4,CTTCGTTTGATTGATAGTGA,0,1916325
ihfAp4,0.2,4,4,CTTCATTAGTTTCAAGTTAA,0,1927866
ihfAp4,0.2,4,4,CTTATCCATGCCGCCTTATG,0,1918088
ihfAp4,0.2,4,4,CTTAGGTTACGTGGAATGGT,0,1956175
ihfAp4,0.2,4,4,CTTACTCGATCAGACCCAAA,0,1937146
ihfAp4,0.2,4,4,CTTACTAAAGTCCGCCACAC,0,1938311
ihfAp4,0.2,4,4,CTTAAGTTACCCATCTAATC,0,1921994
ihfAp4,0.2,4,4,CTGTTCACCTCTCATTCTGA,0,1958543
ihfAp4,0.2,4,4,CTGTGTCAGGTGAGTCCGAG,0,1928155
ihfAp4,0.2,4,4,CTGTGGCGGACGATGGACAG,0,1921728
ihfAp4,0.2,4,4,CTGTCTCAACGGCTACTCCC,0,1921627
ihfAp4,0.2,4,4,CTGGTATATACGGGACCTTC,0,1911599
ihfAp4,0.2,4,4,CTGGGCTGCAGATTCCGCCA,0,1938625
ihfAp4,0.2,4,4,CTGGCGTCCGTGCTAACGCA,0,1954470
ihfAp4,0.2,4,4,CTGCTGCATGGTGAGGTAGC,0,1917507
ihfAp4,0.2,4,4,CTGCTATTCCCGGTCAGCAA,0,1925737
ihfAp4,0.2,4,4,CTGCGTCTGCCGTTACCCAC,0,1950547
ihfAp4,0.2,4,4,CTGCGGCACGTTTGTTGAGC,0,1952574
ihfAp4,0.2,4,4,CTGCAGAGGAATTAAATTGG,0,1919358
ihfAp4,0.2,4,4,CTGCACTGCGTTAAGTTATC,0,1943713
ihfAp4,0.2,4,4,CTGCACGTGATAGGAGGTTC,0,1930665
ihfAp4,0.2,4,4,CTGATTAGTATAAAGTAGCA,0,1940270
ihfAp4,0.2,4,4,CTGATGAGGATCAACTAGAT,0,1925880
ihfAp4,0.2,4,4,CTGACAAGAGGTCGTGCGTG,0,1910396
ihfAp4,0.2,4,4,CTGAAAAATGGAAGAATACA,0,1939234
ihfAp4,0.2,4,4,CTCTTTTTTGCCCTCTGCCC,0,1911993
ihfAp4,0.2,4,4,CTCTTAGAGTCCTGCTTTAC,0,1941851
ihfAp4,0.2,4,4,CTCTGAGCAGCCGGGGTTGA,0,1952359
ihfAp4,0.2,4,4,CTCTGACTTACATTTTTGTT,0,1929401
ihfAp4,0.2,4,4,CTCTCCGCCAAAGTCGAACA,0,1926742
ihfAp4,0.2,4,4,CTCGTTCATGTCTCCCAAAT,0,1917166
ihfAp4,0.2,4,4,CTCGGACGCACATTCCCATA,0,1956842
ihfAp4,0.2,4,4,CTCGACCTTATGTCAAGCGC,0,1914026
ihfAp4,0.2,4,4,CTCCTCTGCTGGTCCGTCTC,0,1915169
ihfAp4,0.2,4,4,CTCCTAATGACTTTAGGTTT,0,1918949
ihfAp4,0.2,4,4,CTCCGTGACAATATCGACGT,0,1929361
ihfAp4,0.2,4,4,CTCCCTCGTTTGCCCCAGTA,0,1937282
ihfAp4,0.2,4,4,CTCAGACCTATGTGGTGGTC,0,1961770
ihfAp4,0.2,4,4,CTCAAACATATGGACTAAAC,0,1936411
ihfAp4,0.2,4,4,CTATTCTGCACGCGTTTGAT,0,1949070
ihfAp4,0.2,4,4,CTATGACCGGAGTTTTGATT,0,1925147
ihfAp4,0.2,4,4,CTATGACCGCTTCCAGGGTT,0,1917352
ihfAp4,0.2,4,4,CTATCGGTTTTTCCAATTCA,0,1941066
ihfAp4,0.2,4,4,CTATAGAGCTTAAGTTCGAA,0,1952034
ihfAp4,0.2,4,4,CTAGTGTTCGCGTTTAGGAA,0,1920036
ihfAp4,0.2,4,4,CTAGTAGTATCGATGGCGCT,0,1931509
ihfAp4,0.2,4,4,CTAGGCTGTACCTGATGCCA,0,1912747
ihfAp4,0.2,4,4,CTAGGCGAGGATCGGTAGGC,0,1917000
ihfAp4,0.2,4,4,CTAGGCCCAACGAAGAAGGC,0,1921306
ihfAp4,0.2,4,4,CTACGGGTCGTGTCATTACG,0,1934456
ihfAp4,0.2,4,4,CTACAGGATGTTTGGTCTTC,0,1956493
ihfAp4,0.2,4,4,CTACAATTCAGGGATAGAAG,0,1955238
ihfAp4,0.2,4,4,CTAATAGTATCGCAGCCCCC,0,1928748
ihfAp4,0.2,4,4,CTAAGCGTCACGTGGGTGAG,0,1920289
ihfAp4,0.2,4,4,CTAACAAGAAGCATGGTCTG,0,1918362
ihfAp4,0.2,4,4,CTAAAAGGACGGTGCACCTC,0,1912275
ihfAp4,0.2,4,4,CGTTTTGTAGTTGGCGTTTT,0,1942057
ihfAp4,0.2,4,4,CGTTTGAAGTATTCTGAACA,0,1912712
ihfAp4,0.2,4,4,CGTTGTGATCCGGCCAAATG,0,1953881
ihfAp4,0.2,4,4,CGTTGAGCCCATTAAAACGC,0,1932160
ihfAp4,0.2,4,4,CGTTAGAGGACCAGTTTTAC,0,1918483
ihfAp4,0.2,4,4,CGTGTACTAGACGTGTTGAA,0,1934707
ihfAp4,0.2,4,4,CGTGGGTGGATCTGGGTTAT,0,1913355
ihfAp4,0.2,4,4,CGTGATTAGTGTACACTTTT,0,1944363
ihfAp4,0.2,4,4,CGTGATGTAGGTTGTTGGCA,0,1911053
ihfAp4,0.2,4,4,CGTGATCCTATGAGGCTACA,0,1938624
ihfAp4,0.2,4,4,CGTGACTTGGCTGACCTGGA,0,1935545
ihfAp4,0.2,4,4,CGTCGTCCCCACCAGACTTT,0,1952863
ihfAp4,0.2,4,4,CGTCGGTCTCGCCTGTCGAC,0,1938748
ihfAp4,0.2,4,4,CGTCGGAACGGTGCCCACTC,0,1928595
ihfAp4,0.2,4,4,CGTCCATAGCTTCTCGAGTG,0,1960193
ihfAp4,0.2,4,4,CGTAGCCGCTCTAAGCAGAA,0,1954338
ihfAp4,0.2,4,4,CGTACTTCCAGGTCACTTCT,0,1911846
ihfAp4,0.2,4,4,CGGTTGGAACCACTCAGAAC,0,1925068
ihfAp4,0.2,4,4,CGGTTAGCGACGTCCAATCT,0,1936510
ihfAp4,0.2,4,4,CGGTGCTGTATTTGCCGCAA,0,1924406
ihfAp4,0.2,4,4,CGGGTGACGAGCGTCAAAGT,0,1934153
ihfAp4,0.2,4,4,CGGGTAACGAGGTAGCCATC,0,1925226
ihfAp4,0.2,4,4,CGGGGGGCCATCTATGTATT,0,1917815
ihfAp4,0.2,4,4,CGGGGCTGAGGGATAGCGAT,0,1913912
ihfAp4,0.2,4,4,CGGGCAGTGCAAGTCCGAAT,0,1919514
ihfAp4,0.2,4,4,CGGGACACGCCGACATTGCT,0,1924979
ihfAp4,0.2,4,4,CGGCTTGTATGCTGTACATG,0,1919633
ihfAp4,0.2,4,4,CGGCTGGGGGCATCTAGCGG,0,1913678
ihfAp4,0.2,4,4,CGGCGAATATTTTCGGGCAT,0,1944053
ihfAp4,0.2,4,4,CGGCCTGAGAGCGCGCAGTA,0,1943473
ihfAp4,0.2,4,4,CGGCCCCGAGTGGCTTCAGG,0,1929795
ihfAp4,0.2,4,4,CGGAGGCCGGCGATAAGCTG,0,1938808
ihfAp4,0.2,4,4,CGGACTCACCATTGCAATTT,0,1935090
ihfAp4,0.2,4,4,CGCGTGCAATACCTTGCCGC,0,1948053
ihfAp4,0.2,4,4,CGCGATGGGCGATCCTTGGA,0,1958824
ihfAp4,0.2,4,4,CGCCGCCGTTCTACAGGAGA,0,1920167
ihfAp4,0.2,4,4,CGCCGAAGGGCCTTAAGTAT,0,1940323
ihfAp4,0.2,4,4,CGCCCGGGCCAAATCTGTGG,0,1956159
ihfAp4,0.2,4,4,CGCCCCTAGATGTCCAAAAT,0,1939847
ihfAp4,0.2,4,4,CGCCACGATCTGTACACAAA,0,1937329
ihfAp4,0.2,4,4,CGCATCATCACGGGCTTCCG,0,1956377
ihfAp4,0.2,4,4,CGCAAGCGCTTGGCTCTCGA,0,1948190
ihfAp4,0.2,4,4,CGATTCAAGGACCAGAGGGG,0,1945580
ihfAp4,0.2,4,4,CGATGCCGAGATTGAGTACT,0,1931510
ihfAp4,0.2,4,4,CGATATGGCGGCACGGTTCA,0,1934868
ihfAp4,0.2,4,4,CGATAAGCCAAAGTCTAGAT,0,1951501
ihfAp4,0.2,4,4,CGAGTCTCAATATCACTAAG,0,1919686
ihfAp4,0.2,4,4,CGAGTATATCCATTCTGAAT,0,1949030
ihfAp4,0.2,4,4,CGAGGCTAGAGGCACTAAGA,0,1932882
ihfAp4,0.2,4,4,CGAGGCGGTTAATCGGATAC,0,1917255
ihfAp4,0.2,4,4,CGAGCCTCGATATCTTTGCC,0,1921331
ihfAp4,0.2,4,4,CGAGCATAATCCCGTATCGG,0,1930727
ihfAp4,0.2,4,4,CGACTACCCGGTATATTGGA,0,1916651
ihfAp4,0.2,4,4,CGACGGCCGTGTTATATAGG,0,1960052
ihfAp4,0.2,4,4,CGACATTGGCGGGTCAAAAC,0,1920904
ihfAp4,0.2,4,4,CGACACGTGTTCTAGGACGA,0,1921324
ihfAp4,0.2,4,4,CGAATGGTAGCTGGGAAAAA,0,1942219
ihfAp4,0.2,4,4,CGAATCCATCCCACACATTG,0,1925755
ihfAp4,0.2,4,4,CGAATATGGTGAGCACATCT,0,1958729
ihfAp4,0.2,4,4,CGAAGGCGGAGAATTTTCAG,0,1946876
ihfAp4,0.2,4,4,CGAAGAAGTCTGTGTATTCT,0,1944285
ihfAp4,0.2,4,4,CGAACGTCTGACTGATTTTT,0,1912208
ihfAp4,0.2,4,4,CGAACGGTTTCTCCCCTGTA,0,1924705
ihfAp4,0.2,4,4,CGAACATGATCATGTTGTTT,0,1922211
ihfAp4,0.2,4,4,CCTTTACTAATGCATTAGTA,0,1956590
ihfAp4,0.2,4,4,CCTTGTTGAGGCTGATAATG,0,1955258
ihfAp4,0.2,4,4,CCTTGGGTGTCGCCTATGTT,0,1909976
ihfAp4,0.2,4,4,CCTTGGGAATTCCGGGCTCA,0,1936916
ihfAp4,0.2,4,4,CCTTGCGAAGAACGGAAGAT,0,1916032
ihfAp4,0.2,4,4,CCTTGACCCGGTTGGAGGTA,0,1961510
ihfAp4,0.2,4,4,CCTTCTGAAGACCAACGGAC,0,1914679
ihfAp4,0.2,4,4,CCTTCCTAAGGGTAAACATA,0,1955951
ihfAp4,0.2,4,4,CCTTATGACTAGGTCGTATA,0,1918353
ihfAp4,0.2,4,4,CCTTACCATACGGGGATCAC,0,1921603
ihfAp4,0.2,4,4,CCTTAAGTTTCGCATTAAGG,0,1949106
ihfAp4,0.2,4,4,CCTGTAATGTGACCGTAAAC,0,1947979
ihfAp4,0.2,4,4,CCTGGAGTACTTGCCCAACG,0,1948055
ihfAp4,0.2,4,4,CCTGACCAACCTTGTAGACT,0,1949887
ihfAp4,0.2,4,4,CCTCTCTTTTTTTCAGATCG,0,1953426
ihfAp4,0.2,4,4,CCTCTCAATTGATAATTGGT,0,1926449
ihfAp4,0.2,4,4,CCTCGTCCGTATAGCTAAAG,0,1949215
ihfAp4,0.2,4,4,CCTCGGTCCGTACCGATTGT,0,1952012
ihfAp4,0.2,4,4,CCTCCAGGACCAACCGTGAG,0,1959304
ihfAp4,0.2,4,4,CCTAGGCTGCGGGCTGACCA,0,1953336
ihfAp4,0.2,4,4,CCGTGTGGGCAGAGGCGCTC,0,1936840
ihfAp4,0.2,4,4,CCGTGGGCATAGGCACAGTC,0,1913454
ihfAp4,0.2,4,4,CCGTCACTCGTGCAGTGGTT,0,1929333
ihfAp4,0.2,4,4,CCGTATGCATAATATTAGCT,0,1918263
ihfAp4,0.2,4,4,CCGGTTTTATGGGCCAAGAC,0,1916160
ihfAp4,0.2,4,4,CCGGTTTGATGACAACCAAG,0,1918979
ihfAp4,0.2,4,4,CCGGTTGACGAAAGGTCTTC,0,1919174
ihfAp4,0.2,4,4,CCGGTGTAAGGACAAACTAG,0,1936064
ihfAp4,0.2,4,4,CCGGTGAAAAGCACGCGGTT,0,1956130
ihfAp4,0.2,4,4,CCGGTCAAAGGCTCATAAAG,0,1961424
ihfAp4,0.2,4,4,CCGGGGTGAACGACGAGATG,0,1958016
ihfAp4,0.2,4,4,CCGGGGCTAAGATTTGGCTT,0,1912641
ihfAp4,0.2,4,4,CCGGGCACGCGTCGGCAGAG,0,1960273
ihfAp4,0.2,4,4,CCGGGATTTCGGGTGGGAGT,0,1914454
ihfAp4,0.2,4,4,CCGGCAATATTTAGCGTTCT,0,1941495
ihfAp4,0.2,4,4,CCGGACACAATCGAGCCACC,0,1921205
ihfAp4,0.2,4,4,CCGCTTAAAAAGGGGGGACA,0,1947853
ihfAp4,0.2,4,4,CCGCGACTGGATGGTCAGAC,0,1913714
ihfAp4,0.2,4,4,CCGCCGGTTCCAAGCTTCAA,0,1915452
ihfAp4,0.2,4,4,CCGATGACCCGGTTCCATTA,0,1934392
ihfAp4,0.2,4,4,CCCTTTTTGTGCTTCGGAGA,0,1955610
ihfAp4,0.2,4,4,CCCTTCTCTCGATTCTAACG,0,1961992
ihfAp4,0.2,4,4,CCCTGGGTTAGGCTAACGTG,0,1921166
ihfAp4,0.2,4,4,CCCTCAGATTTGCATTACAG,0,1948378
ihfAp4,0.2,4,4,CCCTAAGGAAGATCAATCGT,0,1922726
ihfAp4,0.2,4,4,CCCGGTGGGAATGTAGAATG,0,1915358
ihfAp4,0.2,4,4,CCCGGTACTACCAGAAACAA,0,1939620
ihfAp4,0.2,4,4,CCCGGGCGCCGAAGATGCAA,0,1948330
ihfAp4,0.2,4,4,CCCGCTCGGTCCCCAAGACA,0,1914781
ihfAp4,0.2,4,4,CCCGCAGACCAGGCACTGGT,0,1948235
ihfAp4,0.2,4,4,CCCGATGGGGGAGATGCGTC,0,1936101
ihfAp4,0.2,4,4,CCCGACAGTGGTGTTGTTTT,0,1935630
ihfAp4,0.2,4,4,CCCCGTATTACCGGGGGAGC,0,1936249
ihfAp4,0.2,4,4,CCCCATTCGGGACGGAGCAT,0,1923295
ihfAp4,0.2,4,4,CCCCATGGGCTAATATCAAG,0,1954797
ihfAp4,0.2,4,4,CCATGGACCCAAAGTGGTAT,0,1932129
ihfAp4,0.2,4,4,CCATGCTCATAGTTCGTTGT,0,1939399
ihfAp4,0.2,4,4,CCATCTTTGCCCACTGAGTC,0,1954618
ihfAp4,0.2,4,4,CCATCTGCCGCCATTACGCT,0,1954809
ihfAp4,0.2,4,4,CCATATATGACTATGGATTC,0,1939116
ihfAp4,0.2,4,4,CCATAAAGTACTACAACCAA,0,1923562
ihfAp4,0.2,4,4,CCAGCATAAAGACGTTAATG,0,1950013
ihfAp4,0.2,4,4,CCAGCAGGATCCATGCCACT,0,1923071
ihfAp4,0.2,4,4,CCACATCGGAATGAGTGTAA,0,1938574
ihfAp4,0.2,4,4,CCACAGACCTACAAACAAAT,0,1916966
ihfAp4,0.2,4,4,CCACACATTTCGGCTGCAGC,0,1917638
ihfAp4,0.2,4,4,CCAACTTGGGTTTAACCCAT,0,1922474
ihfAp4,0.2,4,4,CCAACTACCGTCCGACACAG,0,1925648
ihfAp4,0.2,4,4,CCAACCTTTGGGGGAAAGTA,0,1955540
ihfAp4,0.2,4,4,CCAAAGTCTCCTGCGTTGCT,0,1957755
ihfAp4,0.2,4,4,CCAAACCTGCCGGGTCCCTA,0,1912228
ihfAp4,0.2,4,4,CATTTTAAGCACGTGAGTGA,0,1913988
ihfAp4,0.2,4,4,CATTTCTTTGGAAGTAAAAT,0,1925581
ihfAp4,0.2,4,4,CATTGTGCCGCCTTTTTTCC,0,1934390
ihfAp4,0.2,4,4,CATTGGCGTCATATACTCTA,0,1930261
ihfAp4,0.2,4,4,CATTGCCAATATTATATTCT,0,1922172
ihfAp4,0.2,4,4,CATTGAAGACCGGCGCAACC,0,1947306
ihfAp4,0.2,4,4,CATTCGGCCCGAGTAGTTCA,0,1960553
ihfAp4,0.2,4,4,CATGTGAGGTCGATAACTGA,0,1910784
ihfAp4,0.2,4,4,CATGTGACCCATGCACTAAC,0,1955482
ihfAp4,0.2,4,4,CATGTCTAGTTACTCTGAAC,0,1928670
ihfAp4,0.2,4,4,CATGCGTGGTGTACCTGGCA,0,1926427
ihfAp4,0.2,4,4,CATGCCGGCAACGGAATACA,0,1932496
ihfAp4,0.2,4,4,CATCTTGTCAATCAACAGGG,0,1939807
ihfAp4,0.2,4,4,CATAGTGGTAGGTGCGTGCA,0,1933585
ihfAp4,0.2,4,4,CATAGCTGAATTCCCCTTAT,0,1960913
ihfAp4,0.2,4,4,CATACTGCGAGGCCCTCGGA,0,1911560
ihfAp4,0.2,4,4,CATACAGTCATCAGTCGGGG,0,1920467
ihfAp4,0.2,4,4,CAGTTTGCATCGCGAGATAA,0,1929060
ihfAp4,0.2,4,4,CAGTTGAGTGACAAGCATCT,0,1953789
ihfAp4,0.2,4,4,CAGTGGTCAAGGGAGAGCCC,0,1912622
ihfAp4,0.2,4,4,CAGTGAGGCCTATAGGAGCC,0,1950232
ihfAp4,0.2,4,4,CAGTATTATATTCACTCGGG,0,1924971
ihfAp4,0.2,4,4,CAGTATGAGGGTTTCTCGAT,0,1957228
ihfAp4,0.2,4,4,CAGTACTTTTATATAGCGGT,0,1944740
ihfAp4,0.2,4,4,CAGTACCGCCGCTTCAATCG,0,1939518
ihfAp4,0.2,4,4,CAGTAACACCGCACAATGGG,0,1961046
ihfAp4,0.2,4,4,CAGGGATCAATAACATCATG,0,1960779
ihfAp4,0.2,4,4,CAGGACTGTCTCTATATGTG,0,1930970
ihfAp4,0.2,4,4,CAGCTTAGTGCAGTTTCTTT,0,1923733
ihfAp4,0.2,4,4,CAGCTGGGTCGGATTTCTTA,0,1955265
ihfAp4,0.2,4,4,CAGCGTCCAGATCATTTACT,0,1940752
ihfAp4,0.2,4,4,CAGAGAATAGGCACCCAAGT,0,1932031
ihfAp4,0.2,4,4,CAGACGTAAGGTCACCAAAA,0,1954777
ihfAp4,0.2,4,4,CAGACCGGGGGGCGACTTGG,0,1941893
ihfAp4,0.2,4,4,CACTGCCTTGATCCCTGCTG,0,1926146
ihfAp4,0.2,4,4,CACTATGTGTAGAATACTTC,0,1932097
ihfAp4,0.2,4,4,CACTACATATTTGCCCAGGA,0,1929530
ihfAp4,0.2,4,4,CACGTGATCCAAAAGTAATA,0,1922888
ihfAp4,0.2,4,4,CACGGGTGAGTTCGTCTAAT,0,1956211
ihfAp4,0.2,4,4,CACGCATGGGCTGTTACGTA,0,1936138
ihfAp4,0.2,4,4,CACGAGGGTGGGAGTCCTGT,0,1926685
ihfAp4,0.2,4,4,CACGAGCTCGCGACGTGCAG,0,1922449
ihfAp4,0.2,4,4,CACGAGAGTCTTAATGAATG,0,1911459
ihfAp4,0.2,4,4,CACGAAAATTTCTTTTCAGG,0,1947827
ihfAp4,0.2,4,4,CACCTTATATCCGACAGACC,0,1916038
ihfAp4,0.2,4,4,CACCCCGACTCCATAAGCGG,0,1948586
ihfAp4,0.2,4,4,CACCCCAGCAACTCCCCCGA,0,1938584
ihfAp4,0.2,4,4,CACATGCCCAGGCGGTGCTG,0,1941922
ihfAp4,0.2,4,4,CACAGTTGGGGGCCATGGGT,0,1909785
ihfAp4,0.2,4,4,CACAGTGTCGGCTTTATCCG,0,1909560
ihfAp4,0.2,4,4,CACAAGGTGTACCAACTGTG,0,1924518
ihfAp4,0.2,4,4,CAATTTGAAGTTCAAATATG,0,1933148
ihfAp4,0.2,4,4,CAATTTCTGGATTCATTAGT,0,1912866
ihfAp4,0.2,4,4,CAATTTCATATGTAATTAGT,0,1917504
ihfAp4,0.2,4,4,CAATGATGATAACCAACCGC,0,1922452
ihfAp4,0.2,4,4,CAATCCTATGGCCCTCAAAG,0,1955200
ihfAp4,0.2,4,4,CAATCATATTAGAGCTTCGT,0,1930387
ihfAp4,0.2,4,4,CAATAACGACACGATGAGCT,0,1956170
ihfAp4,0.2,4,4,CAAGTTGAAAAAGATAGCTG,0,1913444
ihfAp4,0.2,4,4,CAAGGTGATAAAGATCCAGT,0,1946498
ihfAp4,0.2,4,4,CAAGGGTCTGAGGGTGTTTA,0,1946329
ihfAp4,0.2,4,4,CAAGCGGAACAGGTGCGGGG,0,1917517
ihfAp4,0.2,4,4,CAAGCGAAGTTGCTAGTTTT,0,1928451
ihfAp4,0.2,4,4,CAAGCCGTGGAACACCAACT,0,1948016
ihfAp4,0.2,4,4,CAAGATCAATTTATTAATTT,0,1950218
ihfAp4,0.2,4,4,CAAGACAAGAGGTACGTGAG,0,1936843
ihfAp4,0.2,4,4,CAACTTACACTGCCCCTGAA,0,1936731
ihfAp4,0.2,4,4,CAACGCCATAATTTCTACCC,0,1953019
ihfAp4,0.2,4,4,CAACCGGTGGGATGAAAACT,0,1942103
ihfAp4,0.2,4,4,CAACCCGTACTACTTGGATA,0,1928238
ihfAp4,0.2,4,4,CAACAAACTATAATCAGAGA,0,1923039
ihfAp4,0.2,4,4,CAAATGATTCCAGAGTAAAC,0,1914077
ihfAp4,0.2,4,4,CAAAGTTAATGGACGCTAAG,0,1961680
ihfAp4,0.2,4,4,CAAACTGGGAAGGCCCTTGC,0,1940789
ihfAp4,0.2,4,4,CAAACTCCAACCTCCATCCG,0,1911139
ihfAp4,0.2,4,4,CAAAATCAGTTGGAAACATA,0,1917193
ihfAp4,0.2,4,4,ATTTTTCACGGCGATGATGA,0,1910308
ihfAp4,0.2,4,4,ATTTGTTTACAGAGCTATTC,0,1936728
ihfAp4,0.2,4,4,ATTTCTTGTTTCCTTCCAAT,0,1934623
ihfAp4,0.2,4,4,ATTTAGGATATAAACCAGCC,0,1913130
ihfAp4,0.2,4,4,ATTCCATTAATGCGGACTCG,0,1920029
ihfAp4,0.2,4,4,ATTCATGACGAGATATACGA,0,1957745
ihfAp4,0.2,4,4,ATTAGTTCTGCAAGCTAGTT,0,1950082
ihfAp4,0.2,4,4,ATTACTATCTCGGAAGCGTG,0,1954180
ihfAp4,0.2,4,4,ATTACAAATTTCTACTCTTT,0,1921208
ihfAp4,0.2,4,4,ATTAAAATCCGACCTTCTAC,0,1936037
ihfAp4,0.2,4,4,ATGTTGGGTGCGGTTTAATT,0,1957191
ihfAp4,0.2,4,4,ATGTTGGGGCTATTTAGGTT,0,1960738
ihfAp4,0.2,4,4,ATGTTAGCTGGTCCATTCAC,0,1951221
ihfAp4,0.2,4,4,ATGTTACGCCGCCTCGATCC,0,1909563
ihfAp4,0.2,4,4,ATGTCAGGTATGTCACATTA,0,1933256
ihfAp4,0.2,4,4,ATGTATCTACCTGTCTCGTA,0,1954073
ihfAp4,0.2,4,4,ATGGGGATTAGAGAGTACGT,0,1946104
ihfAp4,0.2,4,4,ATGGGAGGTCGATTGAGCGT,0,1912320
ihfAp4,0.2,4,4,ATGGCCGACATAGGTTAGAA,0,1928039
ihfAp4,0.2,4,4,ATGGATGCACAAGGTTGTCA,0,1952885
ihfAp4,0.2,4,4,ATGGAGCTACAACTGCTTTT,0,1936714
ihfAp4,0.2,4,4,ATGCGTTTTCTTGAACCAGG,0,1952377
ihfAp4,0.2,4,4,ATGCGTGATATATTCGGACC,0,1959662
ihfAp4,0.2,4,4,ATGCGCGTTTGGGTTCGAAC,0,1956971
ihfAp4,0.2,4,4,ATGCGCCCGTGGTGTGATCT,0,1925383
ihfAp4,0.2,4,4,ATGCCAAAATACATCCTCGG,0,1929204
ihfAp4,0.2,4,4,ATGATGGCTTGTTTAAGACG,0,1912086
ihfAp4,0.2,4,4,ATGACGTTCACACCGCGAAC,0,1946573
ihfAp4,0.2,4,4,ATCTTATAACATTACCTTTA,0,1941882
ihfAp4,0.2,4,4,ATCTGGATCACCCTCAAATG,0,1938231
ihfAp4,0.2,4,4,ATCTCGATTGCGTGTCCAAT,0,1910191
ihfAp4,0.2,4,4,ATCGGCCAGGTTAGACGTCA,0,1919569
ihfAp4,0.2,4,4,ATCGGACCTGCATTGCGGTA,0,1931366
ihfAp4,0.2,4,4,ATCCTTCATGCCGGGAATTG,0,1938853
ihfAp4,0.2,4,4,ATCCCGTTAGCACCTACGCT,0,1935425
ihfAp4,0.2,4,4,ATCATAGCCTGCCTGGAACG,0,1955728
ihfAp4,0.2,4,4,ATCAGTGATCGAAGAGTCCC,0,1954740
ihfAp4,0.2,4,4,ATCAGAGTAGCCCCGGTGCT,0,1961676
ihfAp4,0.2,4,4,ATCACGCTCACTCTCGTATT,0,1945878
ihfAp4,0.2,4,4,ATCAAGGGCTCTTTCGCGTA,0,1913474
ihfAp4,0.2,4,4,ATCAAAGCTGTGCGGCGCAT,0,1948419
ihfAp4,0.2,4,4,ATCAAAAAATCAGGGCCGAT,0,1945929
ihfAp4,0.2,4,4,ATATTTCGCAAGCTACAAGA,0,1930009
ihfAp4,0.2,4,4,ATATTGCGACGCACTTTAGT,0,1955280
ihfAp4,0.2,4,4,ATATGATGCAGCTGAGTACC,0,1915518
ihfAp4,0.2,4,4,ATATCTGCACACCACTCGGT,0,1936236
ihfAp4,0.2,4,4,ATATCTATATGTCTCGTAAC,0,1942215
ihfAp4,0.2,4,4,ATATCCGCGATGTCCAGGGA,0,1917320
ihfAp4,0.2,4,4,ATATCAAGAGACGCTTCTCA,0,1934403
ihfAp4,0.2,4,4,ATATAGTGCCTTACGTTATG,0,1956761
ihfAp4,0.2,4,4,ATATAAACGCACCGATATCC,0,1934843
ihfAp4,0.2,4,4,ATAGTTGAGGAGGGATTATA,0,1911557
ihfAp4,0.2,4,4,ATAGTCTAGTAATCTTTGAT,0,1962252
ihfAp4,0.2,4,4,ATAGGTGAACTAGCCTTGTC,0,1931171
ihfAp4,0.2,4,4,ATAGAGGCTATGAGACAACA,0,1934451
ihfAp4,0.2,4,4,ATAGAGAGTTGACGTCACCT,0,1924291
ihfAp4,0.2,4,4,ATACTATGGGACACGGTTCA,0,1924728
ihfAp4,0.2,4,4,ATACGGAAATATGAATATGA,0,1951037
ihfAp4,0.2,4,4,ATACGCGTGACCCTGAGCAA,0,1953212
ihfAp4,0.2,4,4,ATACGCGTCTACAAACAACA,0,1924676
ihfAp4,0.2,4,4,ATACCGTGTTGAAGGAGGGT,0,1942450
ihfAp4,0.2,4,4,ATACAGTCAATTGTGCCTAC,0,1957181
ihfAp4,0.2,4,4,ATAATTTCTAGCCTTCCGCC,0,1922217
ihfAp4,0.2,4,4,ATAATCTCCATGCATCTGCA,0,1917053
ihfAp4,0.2,4,4,ATAAGTGGACAGGTCTATTC,0,1928094
ihfAp4,0.2,4,4,ATAACCACGGAACATAAGCT,0,1941876
ihfAp4,0.2,4,4,ATAAACGACTTGCCGCGAAT,0,1948175
ihfAp4,0.2,4,4,AGTTGCGTCCCTGGAAACGT,0,1940005
ihfAp4,0.2,4,4,AGTTCTTGTGCAAAGCGGCT,0,1916082
ihfAp4,0.2,4,4,AGTTAGCAATTGATAGTTCA,0,1932316
ihfAp4,0.2,4,4,AGTTAAGGTGCATGAGGAGT,0,1922530
ihfAp4,0.2,4,4,AGTGTCAGGGTCATTTTCCA,0,1936010
ihfAp4,0.2,4,4,AGTGTCACATTACGTGTGTG,0,1940888
ihfAp4,0.2,4,4,AGTGTAACTACTCACAATAT,0,1929962
ihfAp4,0.2,4,4,AGTGGTAGGTGGCGTTATGT,0,1922572
ihfAp4,0.2,4,4,AGTGATGCGCACTCTGGTAA,0,1949705
ihfAp4,0.2,4,4,AGTCTCCCCTAGGAAAACAC,0,1914909
ihfAp4,0.2,4,4,AGTATATATCTACGTTCTAT,0,1942616
ihfAp4,0.2,4,4,AGTATACCAACCTACTTCAG,0,1941396
ihfAp4,0.2,4,4,AGTACGGGGCTCCATAACTG,0,1921546
ihfAp4,0.2,4,4,AGTACATTGCTCCGAGGTAC,0,1928874
ihfAp4,0.2,4,4,AGGTTGGTTGACTATTTCTC,0,1949817
ihfAp4,0.2,4,4,AGGTGGTTGAGTCTAGAGGC,0,1955156
ihfAp4,0.2,4,4,AGGTGAGAGCCGGGCAACCG,0,1954203
ihfAp4,0.2,4,4,AGGTGACTGAACCGTGAGGG,0,1948688
ihfAp4,0.2,4,4,AGGTGAATTAACGGTGGCCT,0,1957715
ihfAp4,0.2,4,4,AGGTCGGTGGCATACTTTAT,0,1948415
ihfAp4,0.2,4,4,AGGTCCGCTTTCTTTACCCA,0,1961289
ihfAp4,0.2,4,4,AGGGTTGGACTGAGCCGGTA,0,1947074
ihfAp4,0.2,4,4,AGGGTGCCCATACAAGGCAA,0,1934341
ihfAp4,0.2,4,4,AGGGTCCACACATCAGCGCA,0,1917036
ihfAp4,0.2,4,4,AGGGGGGGGAGGAGAGGGGA,0,1924451
ihfAp4,0.2,4,4,AGGGGACAACTAATGGAATG,0,1941351
ihfAp4,0.2,4,4,AGGGATCGTTATGATATATT,0,1945278
ihfAp4,0.2,4,4,AGGCGCAGATAATGTGCCAT,0,1960638
ihfAp4,0.2,4,4,AGGACCCTAAACGCCGCTAC,0,1951443
ihfAp4,0.2,4,4,AGGAACATCAAACATCTCAT,0,1932806
ihfAp4,0.2,4,4,AGCTTTGGTATTACTAGACT,0,1950746
ihfAp4,0.2,4,4,AGCTGGACCGCCATAAAGGC,0,1939401
ihfAp4,0.2,4,4,AGCTGATGAACTGGGCCGTC,0,1933504
ihfAp4,0.2,4,4,AGCTCTGACGGAAGTCTAGA,0,1935734
ihfAp4,0.2,4,4,AGCTAAGGGCGGGGTCGCGA,0,1910481
ihfAp4,0.2,4,4,AGCGTCCGCTCCCGGAATGC,0,1950521
ihfAp4,0.2,4,4,AGCGTACTTCGCTATTAACG,0,1912779
ihfAp4,0.2,4,4,AGCCGACACGCGGGGAAAAC,0,1950202
ihfAp4,0.2,4,4,AGCCCCGCATTCAGGTAAAC,0,1950346
ihfAp4,0.2,4,4,AGCCAGACGTAGAACAATCA,0,1955124
ihfAp4,0.2,4,4,AGCACTAAATCTCCCCAGCA,0,1929218
ihfAp4,0.2,4,4,AGCAACCCAGAAGGACGCTC,0,1936408
ihfAp4,0.2,4,4,AGCAAAGATGCTGACTGTAA,0,1915975
ihfAp4,0.2,4,4,AGATTACCGCATAGAAAGCC,0,1922986
ihfAp4,0.2,4,4,AGATCTCTTGTCACCTCTAC,0,1941948
ihfAp4,0.2,4,4,AGATCCCGTAACGTCATTAT,0,1919065
ihfAp4,0.2,4,4,AGATACGAGGGTTATGGGCT,0,1946259
ihfAp4,0.2,4,4,AGATACCACAGGAAACAAAC,0,1914482
ihfAp4,0.2,4,4,AGATAAGTTCGCGTGAGGTT,0,1909756
ihfAp4,0.2,4,4,AGAGTTTGGGTAGTCTCCCT,0,1929936
ihfAp4,0.2,4,4,AGAGTGGGAAGTTAAAATCA,0,1953626
ihfAp4,0.2,4,4,AGAGTGAGCGTCAACCGCGT,0,1938583
ihfAp4,0.2,4,4,AGAGCAATGGGGTTCTAACT,0,1951906
ihfAp4,0.2,4,4,AGAGATACGTGGTACCACTT,0,1948476
ihfAp4,0.2,4,4,AGAGAGACAAGGCTTGGCGT,0,1930840
ihfAp4,0.2,4,4,AGACCGCTTAAGATTTTTAG,0,1951553
ihfAp4,0.2,4,4,AGAATGCAGTCGTGCGCGCA,0,1917879
ihfAp4,0.2,4,4,AGAAGGTGTTCAAACCGAAT,0,1930006
ihfAp4,0.2,4,4,AGAACCTAAGGCCAGACTGC,0,1951293
ihfAp4,0.2,4,4,ACTTGCTTGCGGATCCGAAT,0,1919725
ihfAp4,0.2,4,4,ACTTCATTTCTTCGGTGTCG,0,1955554
ihfAp4,0.2,4,4,ACTTCATGCGCTCAGACAGC,0,1930198
ihfAp4,0.2,4,4,ACTTAGCTTGTTTAGGGGTT,0,1945035
ihfAp4,0.2,4,4,ACTGTTTTCGCCCATAATAC,0,1929816
ihfAp4,0.2,4,4,ACTGTGTGGCGTCAGCATTC,0,1915368
ihfAp4,0.2,4,4,ACTGTCTCCGATCGATCAGA,0,1934023
ihfAp4,0.2,4,4,ACTGCCGACGGTTGGACTGT,0,1914212
ihfAp4,0.2,4,4,ACTGCACCCGGTTTGGCCTA,0,1940046
ihfAp4,0.2,4,4,ACTGATAATGAACACGTCCA,0,1961116
ihfAp4,0.2,4,4,ACTGACAAGGGCAGTGTAGG,0,1923470
ihfAp4,0.2,4,4,ACTCGGTTCGTTAGATCAAT,0,1941468
ihfAp4,0.2,4,4,ACTCGCGTACATGGTGCGAA,0,1936804
ihfAp4,0.2,4,4,ACTCATCCATGGCTATGGTG,0,1928038
ihfAp4,0.2,4,4,ACTCATCAGTATAATAACTG,0,1924941
ihfAp4,0.2,4,4,ACTCACTATATCTTGAGCGT,0,1935475
ihfAp4,0.2,4,4,ACTATGGAATTACAATCAAT,0,1953394
ihfAp4,0.2,4,4,ACTAGCAGACACCGCGCATT,0,1912940
ihfAp4,0.2,4,4,ACTACTGCGCGTAACCCAGC,0,1953289
ihfAp4,0.2,4,4,ACGTGATCTCCGGGTCTAAA,0,1943437
ihfAp4,0.2,4,4,ACGTCATGGTTCCACGCTTC,0,1958608
ihfAp4,0.2,4,4,ACGGTGTTCACATTATCTGC,0,1912449
ihfAp4,0.2,4,4,ACGGTCGAACACTCAGCGCA,0,1957551
ihfAp4,0.2,4,4,ACGGGTGACCTTCGATGGCT,0,1943786
ihfAp4,0.2,4,4,ACGGGGCTTATGTTGACATT,0,1946044
ihfAp4,0.2,4,4,ACGGGCTTGACATCAGGGTA,0,1921827
ihfAp4,0.2,4,4,ACGGCCGGCATAGGCATCGA,0,1956353
ihfAp4,0.2,4,4,ACGGATCACTATAGGTGTAA,0,1956666
ihfAp4,0.2,4,4,ACGGAAATAGCATAATCGTC,0,1952262
ihfAp4,0.2,4,4,ACGCTTTAAGCTGTAACGGC,0,1954909
ihfAp4,0.2,4,4,ACGCGATCCCGAATGGTGTG,0,1936109
ihfAp4,0.2,4,4,ACGCCTGGCTAAAATCATAA,0,1936564
ihfAp4,0.2,4,4,ACGCCTCAGTGGCATTGACT,0,1933708
ihfAp4,0.2,4,4,ACGCCAGTTCTACGCCGATT,0,1946250
ihfAp4,0.2,4,4,ACGCACCCTCCACCAATCTT,0,1916360
ihfAp4,0.2,4,4,ACGCACACAGCTTAGACGAG,0,1920502
ihfAp4,0.2,4,4,ACGATTCGGTATCTAAAGTT,0,1924411
ihfAp4,0.2,4,4,ACGAGTTCGTTTCGCATTAA,0,1929493
ihfAp4,0.2,4,4,ACGACTTTACAGCCCGACTT,0,1939291
ihfAp4,0.2,4,4,ACGACATGTCACATCAGCCT,0,1911219
ihfAp4,0.2,4,4,ACGAATGCAAACCTGTATGC,0,1941133
ihfAp4,0.2,4,4,ACGAAATGGCTTTTTTACTA,0,1952588
ihfAp4,0.2,4,4,ACGAAAGTAATGCCAGTAAT,0,1958071
ihfAp4,0.2,4,4,ACGAAAACGGTCCTTTGGTT,0,1918112
ihfAp4,0.2,4,4,ACCTTTACTGTACACTGTGG,0,1939371
ihfAp4,0.2,4,4,ACCTTCGGAATCTAACCGGG,0,1951657
ihfAp4,0.2,4,4,ACCTGTGGCAAAGGGTTGTA,0,1950889
ihfAp4,0.2,4,4,ACCTGTATAGCAGGTGACCC,0,1910173
ihfAp4,0.2,4,4,ACCGTCTCGTCAATTATCGC,0,1928035
ihfAp4,0.2,4,4,ACCGGGAAACCCTTGGGCCA,0,1935391
ihfAp4,0.2,4,4,ACCGGCTGGATACTCTCTTA,0,1953059
ihfAp4,0.2,4,4,ACCGGAAGACCCTGAAACAG,0,1928093
ihfAp4,0.2,4,4,ACCGCTCCAGCACTTGCCCC,0,1918967
ihfAp4,0.2,4,4,ACCAGTGGGCACCTCCGTGG,0,1919974
ihfAp4,0.2,4,4,ACCAGTATGCATGGCCCGTA,0,1934215
ihfAp4,0.2,4,4,ACCAGCTTCCTGAGAGTACA,0,1927738
ihfAp4,0.2,4,4,ACCAGCTCTCGATGTTAGGT,0,1956070
ihfAp4,0.2,4,4,ACCACAGGGTACGCGAAACA,0,1939635
ihfAp4,0.2,4,4,ACCAAGCGCGGTATGGCTAT,0,1936252
ihfAp4,0.2,4,4,ACCAAAGTAGCACCTCAATG,0,1932182
ihfAp4,0.2,4,4,ACATTGCAAAGTTTGCTGTG,0,1927517
ihfAp4,0.2,4,4,ACATGGTAGTAGGCAGCCAG,0,1916309
ihfAp4,0.2,4,4,ACATGACCTGGAGGCTATTT,0,1955288
ihfAp4,0.2,4,4,ACATCCACAGACTCACGCTC,0,1931997
ihfAp4,0.2,4,4,ACATCAGACCTGCTGTCGCC,0,1932158
ihfAp4,0.2,4,4,ACATATGCCAACCATATCTG,0,1955411
ihfAp4,0.2,4,4,ACATATACGGTATACAAGGG,0,1924154
ihfAp4,0.2,4,4,ACAGTACTAAGGTGACGCAG,0,1924447
ihfAp4,0.2,4,4,ACAGGTTGTCCGAAAGATAT,0,1935902
ihfAp4,0.2,4,4,ACAGGTGTGGCGGGGGTGTA,0,1949379
ihfAp4,0.2,4,4,ACAGGGATCTACTAGGAGCT,0,1961677
ihfAp4,0.2,4,4,ACAGGATTGACTCCAAAGAT,0,1937478
ihfAp4,0.2,4,4,ACAGCTCCGCTGCGTCGTGT,0,1910230
ihfAp4,0.2,4,4,ACAGCTATATAATGCACATT,0,1950855
ihfAp4,0.2,4,4,ACAGACCGCGATAGGTCACA,0,1918458
ihfAp4,0.2,4,4,ACAGACAGTATCCGGAGCGT,0,1940224
ihfAp4,0.2,4,4,ACACGATAGTATCGCGAATA,0,1914571
ihfAp4,0.2,4,4,ACACCCTCCACAAACCTATC,0,1947094
ihfAp4,0.2,4,4,ACACCATAAGATTTCCGCTA,0,1910020
ihfAp4,0.2,4,4,ACACATTATGGATGCTCGAT,0,1921576
ihfAp4,0.2,4,4,ACAATTGCCCACACGTAGAT,0,1938726
ihfAp4,0.2,4,4,ACAAATATTAAGGCGCTGCA,0,1923134
ihfAp4,0.2,4,4,AATTTGCACTGTCATTGGAA,0,1921356
ihfAp4,0.2,4,4,AATTGGTCGCACTGCTTACT,0,1938791
ihfAp4,0.2,4,4,AATTGATCAACGATCATTAG,0,1939511
ihfAp4,0.2,4,4,AATTAAGTGACAGCATCAAA,0,1924178
ihfAp4,0.2,4,4,AATTAACGGAACGGGTCTAT,0,1957116
ihfAp4,0.2,4,4,AATGTGTTGTTGTTAGGCAA,0,1946967
ihfAp4,0.2,4,4,AATGCGGTAGTGGAGCTGTT,0,1941084
ihfAp4,0.2,4,4,AATCGTTATTGTCGGCATCT,0,1921017
ihfAp4,0.2,4,4,AATCCGCGTCACACCGCAGT,0,1927871
ihfAp4,0.2,4,4,AATCATTGTTCTATGGCCCG,0,1913178
ihfAp4,0.2,4,4,AATCAGAGCGGCATCCCCTC,0,1911206
ihfAp4,0.2,4,4,AATATGCGTTTATTTAAGAG,0,1925657
ihfAp4,0.2,4,4,AATAGTGTATGAGCTACGCC,0,1949289
ihfAp4,0.2,4,4,AATACGGGGGGCACGCCTCC,0,1931901
ihfAp4,0.2,4,4,AATACCCGGGCGGGGCAATA,0,1910580
ihfAp4,0.2,4,4,AATACCACTGAATTTCTGTT,0,1945797
ihfAp4,0.2,4,4,AATACAATACCGCTAGCGCG,0,1943486
ihfAp4,0.2,4,4,AAGTGGTATTTGTGGGGGGG,0,1918188
ihfAp4,0.2,4,4,AAGTCGGATTTTAGTCCTCC,0,1933995
ihfAp4,0.2,4,4,AAGTCGAGCCGTTATACTGA,0,1961583
ihfAp4,0.2,4,4,AAGTCAGTTGGATCACGCCC,0,1914891
ihfAp4,0.2,4,4,AAGGTCAAAAAATTGCCACA,0,1959634
ihfAp4,0.2,4,4,AAGGGTGGCTTTATAGTGCG,0,1934596
ihfAp4,0.2,4,4,AAGGGGACACTTGAGAGACT,0,1927718
ihfAp4,0.2,4,4,AAGGCGCCCCGCGGAAGTTA,0,1927877
ihfAp4,0.2,4,4,AAGGCCGGGTGAGGGCTTGA,0,1911714
ihfAp4,0.2,4,4,AAGGCCGAGGGATTACGTCA,0,1919344
ihfAp4,0.2,4,4,AAGGCCACGCATGATGCGGT,0,1919509
ihfAp4,0.2,4,4,AAGGCAAGTTCTTCGGATAA,0,1935274
ihfAp4,0.2,4,4,AAGGATTAGTTTACGTATGC,0,1957515
ihfAp4,0.2,4,4,AAGGATCTCCCGTATAACTG,0,1910388
ihfAp4,0.2,4,4,AAGGAATGTTAATTTTGTAC,0,1909830
ihfAp4,0.2,4,4,AAGCTGCTCATTGTATGGCG,0,1925449
ihfAp4,0.2,4,4,AAGCTAACCTGAAAATAACG,0,1917356
ihfAp4,0.2,4,4,AAGCCCTGTAACCGGATCTT,0,1929154
ihfAp4,0.2,4,4,AAGCAGATTAATACGGGGGC,0,1914589
ihfAp4,0.2,4,4,AAGATTGAAACATCGTCTGT,0,1938463
ihfAp4,0.2,4,4,AAGACATCTCTATCAGACCA,0,1911981
ihfAp4,0.2,4,4,AACTGGTGTACCGTGTATCC,0,1928040
ihfAp4,0.2,4,4,AACTGGCGACCGTGTTGCTT,0,1961124
ihfAp4,0.2,4,4,AACTGATACCCGGGACTACA,0,1926673
ihfAp4,0.2,4,4,AACTCACATACAATATATAA,0,1938948
ihfAp4,0.2,4,4,AACGTTGTGAAGTCACCAGC,0,1961104
ihfAp4,0.2,4,4,AACGGTTTCGTCCGCGAAGA,0,1913404
ihfAp4,0.2,4,4,AACGGATCCCCGTCATAAAA,0,1950927
ihfAp4,0.2,4,4,AACCGATACGGATGGGAATT,0,1926867
ihfAp4,0.2,4,4,AACCGAGTCGTACCACCAGC,0,1957777
ihfAp4,0.2,4,4,AACCGACGAGAGTTGAAAAA,0,1945723
ihfAp4,0.2,4,4,AACCCCCGCCCGACATTAAT,0,1928228
ihfAp4,0.2,4,4,AACATTCTCATAGATGTTAC,0,1937599
ihfAp4,0.2,4,4,AACATCCGCAGTTTTCGAAA,0,1936319
ihfAp4,0.2,4,4,AACAGGTTCTACGACAGGCA,0,1953112
ihfAp4,0.2,4,4,AACACTCCTGGCGAACAGAG,0,1937032
ihfAp4,0.2,4,4,AAATTTGACACCAAACAGCA,0,1921036
ihfAp4,0.2,4,4,AAATGGCCGGGGCCATATAA,0,1919336
ihfAp4,0.2,4,4,AAATGCTGTACGTATGCTAG,0,1917292
ihfAp4,0.2,4,4,AAATCGTATGCCGTAGTCAC,0,1911172
ihfAp4,0.2,4,4,AAATCCGTATAGTCGCACGA,0,1939813
ihfAp4,0.2,4,4,AAATCAGCAATTGAAGGACT,0,1927989
ihfAp4,0.2,4,4,AAATAGGTTGGCGGAACCCT,0,1938628
ihfAp4,0.2,4,4,AAATAACGGTGAGGGGTCTC,0,1928730
ihfAp4,0.2,4,4,AAAGGGAACGGAATATCCGA,0,1919108
ihfAp4,0.2,4,4,AAAGCGTCTGGGTTGAGTCG,0,1926965
ihfAp4,0.2,4,4,AAAGCCTGATTCGTCGTCAT,0,1920475
ihfAp4,0.2,4,4,AAAGCAGAAGGGTTCGACTA,0,1947727
ihfAp4,0.2,4,4,AAAGCACGGTGCTCTAGATC,0,1957747
ihfAp4,0.2,4,4,AAACTTAGTAAGGTTTAAAA,0,1938190
ihfAp4,0.2,4,4,AAACGTTAGCTGCCCTAGAC,0,1932531
ihfAp4,0.2,4,4,AAACATGCTTGAATCGCAGT,0,1917625
ihfAp4,0.2,4,4,AAACAATGCCTTTCCCCCAA,0,1945146
ihfAp4,0.2,4,4,AAAATGGTAGCGAGCGATAC,0,1930337
ihfAp4,0.2,4,4,AAAATGCAATTCGCAATCCT,0,1952927
ihfAp4,0.2,4,4,AAAATCCACCTTAAGAAAGG,0,1941466
ihfAp4,0.25,3,3,TTTTTTAATTACAGAAACAA,0,1956452
ihfAp4,0.25,3,3,TTTTTCTTTGACTTGTTTAG,0,1920163
ihfAp4,0.25,3,3,TTTTTCACCGCCTAACACCA,0,1909876
ihfAp4,0.25,3,3,TTTGTTATGGTTGGCATCAA,0,1936705
ihfAp4,0.25,3,3,TTTGCTACACCTGAAAGGGA,0,1960772
ihfAp4,0.25,3,3,TTTGCCGATGTGAGAGCCGA,0,1938306
ihfAp4,0.25,3,3,TTTGAGCTGTTAAAGGCCCA,0,1958306
ihfAp4,0.25,3,3,TTTCTCTTAGGTCGGGGCTC,0,1925099
ihfAp4,0.25,3,3,TTTCGCTCAGTATCTTTGGA,0,1951308
ihfAp4,0.25,3,3,TTTCCCTGCGGGTTGGATAA,0,1916505
ihfAp4,0.25,3,3,TTTCCCAACTCTAGATAAAG,0,1928784
ihfAp4,0.25,3,3,TTTCACAGGATCTTAGGGGA,0,1921340
ihfAp4,0.25,3,3,TTTAGGTCAATTCATAGTTG,0,1933354
ihfAp4,0.25,3,3,TTTAGGCGTAATACTAAAAA,0,1930936
ihfAp4,0.25,3,3,TTTAGGCGCTTCCTCCACAT,0,1922294
ihfAp4,0.25,3,3,TTTAGGATAGCACTAAGCGC,0,1928529
ihfAp4,0.25,3,3,TTTAGGACTTGGCGGCGGCA,0,1953267
ihfAp4,0.25,3,3,TTTAGCTCGTCGAGGATCAT,0,1940751
ihfAp4,0.25,3,3,TTTAGCGGATCGCATATGGT,0,1917892
ihfAp4,0.25,3,3,TTTACCAAATGGAACCGGAT,0,1940380
ihfAp4,0.25,3,3,TTTAATGTGGGCCCCTCAGT,0,1951330
ihfAp4,0.25,3,3,TTGTGCGACAAGGCTCGCTA,0,1929997
ihfAp4,0.25,3,3,TTGTCGTTTATCAAATTTGG,0,1931394
ihfAp4,0.25,3,3,TTGTCACTACGACAGCCCTA,0,1953131
ihfAp4,0.25,3,3,TTGTACCGGACCTACCCCTT,0,1958547
ihfAp4,0.25,3,3,TTGGTGTCTGCGTACATAGA,0,1922600
ihfAp4,0.25,3,3,TTGGGGCTGGATTCTTATTA,0,1928652
ihfAp4,0.25,3,3,TTGGCTTGAAGCATTCCCCA,0,1954785
ihfAp4,0.25,3,3,TTGGCAGACGTTTCAGATTT,0,1911806
ihfAp4,0.25,3,3,TTGGACATATGAAAAACATG,0,1937743
ihfAp4,0.25,3,3,TTGGAACTGTTTCGGTACAC,0,1955089
ihfAp4,0.25,3,3,TTGCTTTCTCTCCACAAATT,0,1956185
ihfAp4,0.25,3,3,TTGCTCCGGACTGCGCCAAA,0,1944362
ihfAp4,0.25,3,3,TTGCTCACTATGACCTATCA,0,1931540
ihfAp4,0.25,3,3,TTGCGTATATTATTTGGCAG,0,1921004
ihfAp4,0.25,3,3,TTGCGGCTTGTTGGAGCATG,0,1922031
ihfAp4,0.25,3,3,TTGCGCTCGTGTGACCTGCA,0,1957843
ihfAp4,0.25,3,3,TTGCGCATAACTTTGCGTTG,0,1936681
ihfAp4,0.25,3,3,TTGCCTCGCCATGCGGTTTC,0,1937372
ihfAp4,0.25,3,3,TTGCACCTAACGGGAGCGTA,0,1933310
ihfAp4,0.25,3,3,TTGATTGAGCGACGCACGCA,0,1956994
ihfAp4,0.25,3,3,TTGATTAAAGGACATATGTA,0,1922754
ihfAp4,0.25,3,3,TTGAGGCAAGCCATAGCACA,0,1941369
ihfAp4,0.25,3,3,TTGAGGACAAAGGCAAAGTA,0,1959039
ihfAp4,0.25,3,3,TTGAGAGCGTGAAGAGACAT,0,1927722
ihfAp4,0.25,3,3,TTGACTCGTGAAAGCCGAAT,0,1943095
ihfAp4,0.25,3,3,TTGACTAGGTAGATGGGTAC,0,1926392
ihfAp4,0.25,3,3,TTGACCGTCCTAGCCAGGCC,0,1938462
ihfAp4,0.25,3,3,TTCTTTACTTCGTGCACTAG,0,1954243
ihfAp4,0.25,3,3,TTCTTGGGTGGCATGGGTCT,0,1955083
ihfAp4,0.25,3,3,TTCTTCTGGCCGCGGGGACT,0,1960092
ihfAp4,0.25,3,3,TTCTTATAACATTCCCTTCC,0,1917858
ihfAp4,0.25,3,3,TTCTTAGACGGGTATCGGAA,0,1957411
ihfAp4,0.25,3,3,TTCTCGAGTTTGCTTAACCA,0,1909757
ihfAp4,0.25,3,3,TTCGTCCAAAAGAGCTGGAA,0,1924645
ihfAp4,0.25,3,3,TTCGGGGTACGCGGTAGAAA,0,1923969
ihfAp4,0.25,3,3,TTCGAAGTGAGGGAGCCTCA,0,1932028
ihfAp4,0.25,3,3,TTCGAAAGAGTCATATTACG,0,1921714
ihfAp4,0.25,3,3,TTCCTCGTTCGCCTACTACG,0,1920060
ihfAp4,0.25,3,3,TTCCTCCTGTTGCAACAGAC,0,1944490
ihfAp4,0.25,3,3,TTCCGGTCCACGGATTCTAT,0,1932142
ihfAp4,0.25,3,3,TTCCGGGAGATGGTACAGTG,0,1942680
ihfAp4,0.25,3,3,TTCCCTAACTGTAGACGAAA,0,1932506
ihfAp4,0.25,3,3,TTCCCCCTCCCAGACTCAGA,0,1919392
ihfAp4,0.25,3,3,TTCCCAGTTTCTATCAATTC,0,1915056
ihfAp4,0.25,3,3,TTCATTCTAGCGACGACATA,0,1913962
ihfAp4,0.25,3,3,TTCATGAGCATAGGAGGTTC,0,1915170
ihfAp4,0.25,3,3,TTCAGCAAGTTCAAGCGTAC,0,1911170
ihfAp4,0.25,3,3,TTCACAAGGGCATAGACTGT,0,1931400
ihfAp4,0.25,3,3,TTCAAGCATCCCTAGTTGCA,0,1950070
ihfAp4,0.25,3,3,TTCAAATGAAAGGACCGTAA,0,1941386
ihfAp4,0.25,3,3,TTATTCCGGCCTTATTCCGG,0,1961366
ihfAp4,0.25,3,3,TTATGTTGTACAGTCATGCA,0,1940150
ihfAp4,0.25,3,3,TTATGGGTTACGCAGGATCG,0,1923076
ihfAp4,0.25,3,3,TTATGCTCTTTTCCTTTTCT,0,1955731
ihfAp4,0.25,3,3,TTATGATCTAGGCAGCTAAA,0,1944933
ihfAp4,0.25,3,3,TTATGAGGTTGTGCAAGTGG,0,1924276
ihfAp4,0.25,3,3,TTAGTGGCCCTCATCTTGTC,0,1956371
ihfAp4,0.25,3,3,TTAGTGCTACCCTCCGAACC,0,1954485
ihfAp4,0.25,3,3,TTAGTGCGCTGATTTAACCC,0,1955263
ihfAp4,0.25,3,3,TTAGCGAAGATGATGTTGAA,0,1947634
ihfAp4,0.25,3,3,TTAGCATTACGCCTATAGCG,0,1941803
ihfAp4,0.25,3,3,TTAGAGCTGACCTAAATAGG,0,1952295
ihfAp4,0.25,3,3,TTACCCAAGCCCTCCCGCGT,0,1920584
ihfAp4,0.25,3,3,TTACCAGGCTGTGCAAGTAA,0,1942898
ihfAp4,0.25,3,3,TTAATTGTTAACTCTTCCTG,0,1914331
ihfAp4,0.25,3,3,TTAATCTGACGCCTGTTCGC,0,1936211
ihfAp4,0.25,3,3,TTAAGGAGACCCTGGACGCC,0,1953676
ihfAp4,0.25,3,3,TTAACTGGAAGAGGGTCTAA,0,1935536
ihfAp4,0.25,3,3,TTAACACTAAGCAACGGGAG,0,1922300
ihfAp4,0.25,3,3,TTAAAGCCCTGAGGGAAAGC,0,1939185
ihfAp4,0.25,3,3,TTAAAAGTTTCTGTAGGCGT,0,1940519
ihfAp4,0.25,3,3,TGTTTTCGCTTTTTGCAATA,0,1952857
ihfAp4,0.25,3,3,TGTTTGAGAAGGCAGATTTG,0,1931308
ihfAp4,0.25,3,3,TGTTTACAACAAGTCTCCCA,0,1945714
ihfAp4,0.25,3,3,TGTTCCCGTTATAGAAGAAC,0,1948132
ihfAp4,0.25,3,3,TGTTCACCACGCGTCGGTTT,0,1930864
ihfAp4,0.25,3,3,TGTGGGGTTTCTACCGGTTT,0,1936205
ihfAp4,0.25,3,3,TGTGCGGGAATGCATAGGTA,0,1937229
ihfAp4,0.25,3,3,TGTGATCCTCCGTGAATAAT,0,1912537
ihfAp4,0.25,3,3,TGTCTCGTACGGAACTGCGT,0,1922407
ihfAp4,0.25,3,3,TGTCGGCTCTAACACACCTA,0,1954281
ihfAp4,0.25,3,3,TGTCGGCTCCGCCGCCAAGG,0,1921681
ihfAp4,0.25,3,3,TGTCCCCGGAAAGGGTAGAC,0,1954499
ihfAp4,0.25,3,3,TGTCCACTGCTCAATATCGA,0,1934956
ihfAp4,0.25,3,3,TGTCCAAAGTAATTTGCAGT,0,1922380
ihfAp4,0.25,3,3,TGTCAGTATCACTTAATCAT,0,1910022
ihfAp4,0.25,3,3,TGTCACAACAGGCATCAGTC,0,1940003
ihfAp4,0.25,3,3,TGTATGAGCTCCTATGGTGA,0,1950823
ihfAp4,0.25,3,3,TGTACTACCATACAGAAGTG,0,1948216
ihfAp4,0.25,3,3,TGGTTATATTACCTTTGCGA,0,1951947
ihfAp4,0.25,3,3,TGGTGGTAGTTAATTGAGGG,0,1943972
ihfAp4,0.25,3,3,TGGTCCTCGCCGCATAACAA,0,1947053
ihfAp4,0.25,3,3,TGGGTGATGAAAAAATTCAC,0,1922089
ihfAp4,0.25,3,3,TGGGTGAGATTAGACCCAGC,0,1954210
ihfAp4,0.25,3,3,TGGGGTCGAGTTGTACAGGT,0,1921577
ihfAp4,0.25,3,3,TGGGGCATTTCGTCGCCACG,0,1918054
ihfAp4,0.25,3,3,TGGGCCTGCCATCTATAACC,0,1942455
ihfAp4,0.25,3,3,TGGCTTGGCGGCACTTACAT,0,1957703
ihfAp4,0.25,3,3,TGGCTTGATTTACCAGATAT,0,1912944
ihfAp4,0.25,3,3,TGGCGTGGACCTAGGCGTGT,0,1922591
ihfAp4,0.25,3,3,TGGCGCCAATTTGCGGACGA,0,1940303
ihfAp4,0.25,3,3,TGGAGTTGCGACTCAGTCAG,0,1924273
ihfAp4,0.25,3,3,TGGAGTATCTCGTTCAATCG,0,1919175
ihfAp4,0.25,3,3,TGGAGACGGATATACGTAAG,0,1950585
ihfAp4,0.25,3,3,TGGACTTGAGTCCCTAGAGG,0,1923521
ihfAp4,0.25,3,3,TGCTGACCATGTAAACCTCG,0,1953111
ihfAp4,0.25,3,3,TGCTCTTCCTACTATGTGCC,0,1951437
ihfAp4,0.25,3,3,TGCTCTATGAACTTCGTTTA,0,1918695
ihfAp4,0.25,3,3,TGCTATTCCCCGGTGGAACT,0,1925680
ihfAp4,0.25,3,3,TGCGTTCTTTACCCTTAAGC,0,1926639
ihfAp4,0.25,3,3,TGCGCGTGCTATTTTGCAGG,0,1936834
ihfAp4,0.25,3,3,TGCGAAGGACATGTAGAAGT,0,1929664
ihfAp4,0.25,3,3,TGCGAAATTCGTGAAATAAA,0,1956158
ihfAp4,0.25,3,3,TGCCTTTCGATAGCCGCGAG,0,1918193
ihfAp4,0.25,3,3,TGCCTGGGTATCCCGCCGGA,0,1933272
ihfAp4,0.25,3,3,TGCCGCAGCCGCTCAGAGGT,0,1937037
ihfAp4,0.25,3,3,TGCCCTCAATAGTATACGGA,0,1934871
ihfAp4,0.25,3,3,TGCATTACGAAAAGGTTATG,0,1953078
ihfAp4,0.25,3,3,TGCAGGTACGTCCCTATGCT,0,1911150
ihfAp4,0.25,3,3,TGCAGGATGGCAAGTCGCCA,0,1956531
ihfAp4,0.25,3,3,TGCAGCATCATCTGAGGGAA,0,1929198
ihfAp4,0.25,3,3,TGCACGCTAGGTATCAAGTG,0,1927031
ihfAp4,0.25,3,3,TGCACAAGGATGGTCGCAAT,0,1928631
ihfAp4,0.25,3,3,TGCAATCGACCAAACGGTAT,0,1956343
ihfAp4,0.25,3,3,TGCAAGGTTCGGGCTGCCTT,0,1928216
ihfAp4,0.25,3,3,TGCAAATGGAGAGCGGATGA,0,1913237
ihfAp4,0.25,3,3,TGATTCTTCTGATTACGGCA,0,1942669
ihfAp4,0.25,3,3,TGATGGGGGAATCCCTTCTG,0,1945652
ihfAp4,0.25,3,3,TGATGGAACTGAGAGGAAGA,0,1940731
ihfAp4,0.25,3,3,TGATCATCACGTTTAGCTGG,0,1956652
ihfAp4,0.25,3,3,TGATAGGGGCACAACCCATC,0,1920345
ihfAp4,0.25,3,3,TGAGGTAACCACAGTGGACG,0,1911588
ihfAp4,0.25,3,3,TGAGCTCTTGAGCAGGGTTA,0,1930688
ihfAp4,0.25,3,3,TGAGAAAGAGCTTGTGGTGC,0,1917365
ihfAp4,0.25,3,3,TGACAATATTGCCGCTTAAC,0,1936838
ihfAp4,0.25,3,3,TGAACCAGACACTAACATGG,0,1945718
ihfAp4,0.25,3,3,TCTTTCCTGGGCGTCGCGTT,0,1917207
ihfAp4,0.25,3,3,TCTTGGCTGAGACAGGTTAT,0,1925261
ihfAp4,0.25,3,3,TCTTGCTTTGGCGCTAGGAA,0,1924195
ihfAp4,0.25,3,3,TCTTCTATGGGCGATAGGCA,0,1955982
ihfAp4,0.25,3,3,TCTTCACATATATCAGTCTT,0,1932640
ihfAp4,0.25,3,3,TCTTAGCAACATTACCCGTT,0,1958662
ihfAp4,0.25,3,3,TCTGGGGTAATTCCGCGCAA,0,1960954
ihfAp4,0.25,3,3,TCTGCGGATGTTCCGCTATA,0,1936243
ihfAp4,0.25,3,3,TCTGCGCGACGAAGGTTATA,0,1947880
ihfAp4,0.25,3,3,TCTGCCTTAGCTCCTTGGCC,0,1926403
ihfAp4,0.25,3,3,TCTCTGTTAGTAGCAAGTCA,0,1917645
ihfAp4,0.25,3,3,TCTCGTAGATCCCGAATGGT,0,1961956
ihfAp4,0.25,3,3,TCTCGGCTATCACTAGCGCA,0,1915642
ihfAp4,0.25,3,3,TCTCGATTATTGGATCCACC,0,1958633
ihfAp4,0.25,3,3,TCTCCGGTTCTTTTGTATAT,0,1922191
ihfAp4,0.25,3,3,TCTATCGTTGCAACGTTGAC,0,1942318
ihfAp4,0.25,3,3,TCGTGGACTGCGCACGAAGT,0,1926575
ihfAp4,0.25,3,3,TCGTCCCAGATAAATACGGT,0,1911732
ihfAp4,0.25,3,3,TCGTATCTGACCGCGATCAT,0,1925621
ihfAp4,0.25,3,3,TCGTAGATTTGGCAGGGTGG,0,1950957
ihfAp4,0.25,3,3,TCGTAATGGGCGTCAAGTTG,0,1931137
ihfAp4,0.25,3,3,TCGGTTCGCCTTGTTAGCGA,0,1916792
ihfAp4,0.25,3,3,TCGGTGGGCTACAACAAATT,0,1935218
ihfAp4,0.25,3,3,TCGGGTGTCAACATCCAGGC,0,1937302
ihfAp4,0.25,3,3,TCGGGTCCGACAACCGAGAC,0,1910996
ihfAp4,0.25,3,3,TCGGGCCTAAGGCATTATCC,0,1943091
ihfAp4,0.25,3,3,TCGGCTGGAGAGACACTACC,0,1917839
ihfAp4,0.25,3,3,TCGGCCGTGAGTCGAAGTTG,0,1928798
ihfAp4,0.25,3,3,TCGGCAGGCAGTCAGTATTC,0,1940413
ihfAp4,0.25,3,3,TCGGCACAACTCTTCGGGCG,0,1925211
ihfAp4,0.25,3,3,TCGCTGGTCCGTAGATTGAA,0,1939324
ihfAp4,0.25,3,3,TCGCGTGGATTCGGGAATAG,0,1954772
ihfAp4,0.25,3,3,TCGCGGCCATGAAACATTGT,0,1949380
ihfAp4,0.25,3,3,TCGCGCGGGGCGGACCACAC,0,1935225
ihfAp4,0.25,3,3,TCGCCGCAACGGGGTGCAAG,0,1942705
ihfAp4,0.25,3,3,TCGCACACTACAGGTCGGCG,0,1915270
ihfAp4,0.25,3,3,TCGATGGCAATCATATGGTG,0,1936209
ihfAp4,0.25,3,3,TCGAGGTTTCAAGCTGCTGA,0,1956773
ihfAp4,0.25,3,3,TCGAGCTAGAGTAGATACGT,0,1940993
ihfAp4,0.25,3,3,TCGACGCCTGTCAGATCACT,0,1922913
ihfAp4,0.25,3,3,TCCTTAGATCGCAGGGGATT,0,1929128
ihfAp4,0.25,3,3,TCCTGGAAAAAACGGCTCTG,0,1945821
ihfAp4,0.25,3,3,TCCTAGTGGACGTCAGGCGA,0,1934992
ihfAp4,0.25,3,3,TCCGTTTCTATGGGCTTTTT,0,1911214
ihfAp4,0.25,3,3,TCCGGTTGCATGCGGCCTCA,0,1927034
ihfAp4,0.25,3,3,TCCGGAGTCTGTTCTGTTGG,0,1943761
ihfAp4,0.25,3,3,TCCGCGGACGTCCCAGTTGT,0,1911446
ihfAp4,0.25,3,3,TCCGCGATGTCCGCGGTCTC,0,1916005
ihfAp4,0.25,3,3,TCCGCCGACATCCTGGCCTC,0,1923189
ihfAp4,0.25,3,3,TCCCTGTTCGTGCCTTCGAC,0,1932271
ihfAp4,0.25,3,3,TCCCGTATCCGAGCCGCAAA,0,1933442
ihfAp4,0.25,3,3,TCCCGGGGGGTACCGGCGCT,0,1943738
ihfAp4,0.25,3,3,TCCCGACGTTGGCCCAGGGG,0,1960414
ihfAp4,0.25,3,3,TCCCGAATTTTATATCGTCC,0,1921133
ihfAp4,0.25,3,3,TCCCGAACATTATTCTTTTG,0,1927154
ihfAp4,0.25,3,3,TCCCCTTCGTGAGCCCGGGA,0,1935177
ihfAp4,0.25,3,3,TCCCAACAACCTGACATGGA,0,1918663
ihfAp4,0.25,3,3,TCCAGCGATTTGTTCTCATT,0,1934483
ihfAp4,0.25,3,3,TCCACCAGTTCTAGTCATGT,0,1909908
ihfAp4,0.25,3,3,TCATTATCTAATAGCCATTC,0,1914621
ihfAp4,0.25,3,3,TCATTAGTTTCCGCGCAGAG,0,1949573
ihfAp4,0.25,3,3,TCATTACGAGACGCTCGTGA,0,1924301
ihfAp4,0.25,3,3,TCATGTTTTCAGGTTCTTTG,0,1927920
ihfAp4,0.25,3,3,TCATGTATGCTTTTGTGGCA,0,1947193
ihfAp4,0.25,3,3,TCATGAACTCCTCTTGTGTC,0,1954781
ihfAp4,0.25,3,3,TCATCGGCGGCTATCTGTAT,0,1951111
ihfAp4,0.25,3,3,TCATATAATAGACGTCTGAT,0,1960661
ihfAp4,0.25,3,3,TCAGTGATAGAATAGCGGTC,0,1937609
ihfAp4,0.25,3,3,TCAGTCAATGACCCCTTAAG,0,1960377
ihfAp4,0.25,3,3,TCAGTATTGCACATTAACCG,0,1953337
ihfAp4,0.25,3,3,TCAGTATGTGTCAAACGGGA,0,1961044
ihfAp4,0.25,3,3,TCAGTAGAATGAATCGACTG,0,1925650
ihfAp4,0.25,3,3,TCAGGAATCGCGGGTCGGCC,0,1930989
ihfAp4,0.25,3,3,TCAGCCGAACAGAAAAGGCA,0,1956660
ihfAp4,0.25,3,3,TCACTTTGCTGTTTTAGGGT,0,1931088
ihfAp4,0.25,3,3,TCACTTAGTGCACCTAATAT,0,1910132
ihfAp4,0.25,3,3,TCACGCGAGAGCGGCTCTAA,0,1945160
ihfAp4,0.25,3,3,TCACCGATAACAGTACATAA,0,1930296
ihfAp4,0.25,3,3,TCACCCCACCGTTATAGTAT,0,1920740
ihfAp4,0.25,3,3,TCACATTAGGCAGAAAGTAA,0,1947672
ihfAp4,0.25,3,3,TCACATCAAGAAGCGCTAGC,0,1952037
ihfAp4,0.25,3,3,TCACACAACAGCAGCGCTTA,0,1918237
ihfAp4,0.25,3,3,TCAATTCCACTAGATTCTTA,0,1962224
ihfAp4,0.25,3,3,TCAAGACGATGAGCTAATTA,0,1923478
ihfAp4,0.25,3,3,TCAACTTCAAGTGGCCCGTT,0,1953113
ihfAp4,0.25,3,3,TCAACTATAGCTCCTGTTGA,0,1914974
ihfAp4,0.25,3,3,TCAACAGGGCAAGACTGGTA,0,1951404
ihfAp4,0.25,3,3,TCAAATTCTCCCGGCTTTCT,0,1952722
ihfAp4,0.25,3,3,TATTTGGGTTGTCAGGTAGT,0,1947828
ihfAp4,0.25,3,3,TATTGGGCCGCACGGTCCAA,0,1935512
ihfAp4,0.25,3,3,TATTCTAGGCACGGTGTGGC,0,1925666
ihfAp4,0.25,3,3,TATTCCAACTTGCCGGAGAG,0,1948472
ihfAp4,0.25,3,3,TATTAAATTAACACTAACGT,0,1917636
ihfAp4,0.25,3,3,TATGTATTAAGGCACCGGAT,0,1952965
ihfAp4,0.25,3,3,TATGGGTTACGCACAGCTCG,0,1933869
ihfAp4,0.25,3,3,TATGGGAAGATACGGGCGGG,0,1918932
ihfAp4,0.25,3,3,TATGATAGCGACGGCACGGC,0,1948969
ihfAp4,0.25,3,3,TATGAGGTTCGAGGCAACAC,0,1917222
ihfAp4,0.25,3,3,TATCTTTCTAAGCGCAGTCT,0,1946444
ihfAp4,0.25,3,3,TATCTCGCGAGCTTAATCTG,0,1947679
ihfAp4,0.25,3,3,TATCGATGACTGGTGGAATG,0,1924758
ihfAp4,0.25,3,3,TATCGAATCATCCTTAGTAT,0,1924675
ihfAp4,0.25,3,3,TATCAAGGCTCAAGCCGCAG,0,1929386
ihfAp4,0.25,3,3,TATATTGGGATTGAGACTTT,0,1939854
ihfAp4,0.25,3,3,TATACCGCGATGCTTAAGGG,0,1937819
ihfAp4,0.25,3,3,TATAAGGAGAAATTGCACCG,0,1961378
ihfAp4,0.25,3,3,TAGGTTGCGTATGCCAGGTA,0,1934457
ihfAp4,0.25,3,3,TAGGTCTGGCCCACCTATCT,0,1954718
ihfAp4,0.25,3,3,TAGGTCGCTTCTCGGCGTTC,0,1941392
ihfAp4,0.25,3,3,TAGGCGCCTCAGTTATAGCC,0,1944788
ihfAp4,0.25,3,3,TAGGAAGGGACCATGGAGGC,0,1949046
ihfAp4,0.25,3,3,TAGCTCTTCACGGCGTTATT,0,1923222
ihfAp4,0.25,3,3,TAGCCGTCAGGTGTACGCTG,0,1944478
ihfAp4,0.25,3,3,TAGCATGTTATAAAAGGAGG,0,1911294
ihfAp4,0.25,3,3,TAGCATCTGAAAAACGATAC,0,1961809
ihfAp4,0.25,3,3,TAGCACTACATGAGTGCTGC,0,1932155
ihfAp4,0.25,3,3,TAGAGCTATGGCTTCCCACT,0,1927430
ihfAp4,0.25,3,3,TAGACCCGTAGGGGAACGGT,0,1947883
ihfAp4,0.25,3,3,TAGACATATGTTGATACTGA,0,1945460
ihfAp4,0.25,3,3,TACTTATTCGGAGTTCTGTA,0,1924840
ihfAp4,0.25,3,3,TACTGTCCTGTGCTTTATTT,0,1922127
ihfAp4,0.25,3,3,TACTGGTCGCCCCGACTTAG,0,1918155
ihfAp4,0.25,3,3,TACTGGCCTCCCTATCCTTG,0,1929769
ihfAp4,0.25,3,3,TACTCTGTAACGAAACATCG,0,1955052
ihfAp4,0.25,3,3,TACTCTAAACTTTATGGCCC,0,1916974
ihfAp4,0.25,3,3,TACTAAGGGTGGGGTGGCTT,0,1924010
ihfAp4,0.25,3,3,TACGTTACCCCTACTCACTT,0,1922810
ihfAp4,0.25,3,3,TACGGGGAAACAGGATTTTA,0,1962043
ihfAp4,0.25,3,3,TACGCAACACAGACCCACTA,0,1916866
ihfAp4,0.25,3,3,TACCTGTTGAACTTCCTCGG,0,1945054
ihfAp4,0.25,3,3,TACCTGCGCCCCTTCGGCCC,0,1935329
ihfAp4,0.25,3,3,TACCTGCGCAGTTCGTTCGA,0,1925472
ihfAp4,0.25,3,3,TACATATTATCGCAGCCGTT,0,1950522
ihfAp4,0.25,3,3,TACAGTGTACCTGTGGTAAT,0,1914617
ihfAp4,0.25,3,3,TACAGTGACGTTCGTAGGCC,0,1925811
ihfAp4,0.25,3,3,TACAGCAGCTTATTTGCTGT,0,1919205
ihfAp4,0.25,3,3,TACACTTCCGTTCCCAGGCA,0,1952878
ihfAp4,0.25,3,3,TACACAGTTTATGATTTGGG,0,1923158
ihfAp4,0.25,3,3,TAATTCAGCAAATCACTAGC,0,1950050
ihfAp4,0.25,3,3,TAATTAATGGAAGTTTTAGG,0,1943354
ihfAp4,0.25,3,3,TAATGCGAGTATAAGTCCTC,0,1920053
ihfAp4,0.25,3,3,TAATGCCCCTCAGAGCCAAA,0,1940515
ihfAp4,0.25,3,3,TAATCTCTTGGTGGTGAAAG,0,1955718
ihfAp4,0.25,3,3,TAATCGGAGGATATGTGTAA,0,1936280
ihfAp4,0.25,3,3,TAATCCTAAAATTACGCGGT,0,1920751
ihfAp4,0.25,3,3,TAAGTGGCTAAGCTACACCT,0,1913665
ihfAp4,0.25,3,3,TAAGTAATTGGCGTCCTTCC,0,1935417
ihfAp4,0.25,3,3,TAAGTAAAAGGGTTTCATGT,0,1931612
ihfAp4,0.25,3,3,TAAGGCCGGAATGCTTAGTT,0,1945008
ihfAp4,0.25,3,3,TAACGGTTCACGCAACCGTA,0,1920961
ihfAp4,0.25,3,3,TAACACTGACGGGGCAGTTA,0,1942785
ihfAp4,0.25,3,3,TAACAACCTGGTCTTAGACC,0,1914619
ihfAp4,0.25,3,3,TAAACATTAGCTAACAAGGC,0,1958972
ihfAp4,0.25,3,3,TAAAAACACTTTCGCTGACT,0,1924323
ihfAp4,0.25,3,3,GTTTTGTAGACAAAAGCGCA,0,1954523
ihfAp4,0.25,3,3,GTTTTAGAGATGGTCATATC,0,1913176
ihfAp4,0.25,3,3,GTTTTAAATTGCTACTTGCT,0,1927442
ihfAp4,0.25,3,3,GTTTGGCTCCGCGCCACGCG,0,1909652
ihfAp4,0.25,3,3,GTTTAAAGACTCACTGAGCT,0,1913802
ihfAp4,0.25,3,3,GTTTAAAAGACTAACTTAAT,0,1932376
ihfAp4,0.25,3,3,GTTGTCACCAGGGAACATCA,0,1923320
ihfAp4,0.25,3,3,GTTGCTATCTCCAGGATAAT,0,1947695
ihfAp4,0.25,3,3,GTTGACGGATACGAAACGTG,0,1932932
ihfAp4,0.25,3,3,GTTCTCGACTACCCGGCAAT,0,1918707
ihfAp4,0.25,3,3,GTTCAGAAGGGAACCCAGTA,0,1923879
ihfAp4,0.25,3,3,GTTCACTTCAGACACTATAC,0,1960301
ihfAp4,0.25,3,3,GTTAGGACAATGACCCGTTC,0,1919734
ihfAp4,0.25,3,3,GTTACGTATCTTACGCGGAC,0,1927725
ihfAp4,0.25,3,3,GTTACCGGCTCCATGCCTGG,0,1959405
ihfAp4,0.25,3,3,GTTACACCAATCATCTCGCG,0,1957186
ihfAp4,0.25,3,3,GTGTTTTTGGACGCAATATC,0,1954198
ihfAp4,0.25,3,3,GTGTTGGCGTGTGAGTCCTT,0,1915608
ihfAp4,0.25,3,3,GTGTGGAGACCGATACGAGA,0,1936583
ihfAp4,0.25,3,3,GTGTCTACCATCATCGGACG,0,1962293
ihfAp4,0.25,3,3,GTGTCATGGTGATCGCTCGC,0,1942620
ihfAp4,0.25,3,3,GTGGGAACCCTGATAGCTAG,0,1927421
ihfAp4,0.25,3,3,GTGGCCGTAATCCCTGATAA,0,1946333
ihfAp4,0.25,3,3,GTGGATAAATTTGAAACAGT,0,1933490
ihfAp4,0.25,3,3,GTGCTTCCCCCACTTGGACG,0,1916376
ihfAp4,0.25,3,3,GTGCGTCCGCTGTTTACAAC,0,1927972
ihfAp4,0.25,3,3,GTGCGCTGATTTATGATCAA,0,1954116
ihfAp4,0.25,3,3,GTGCCAATCTGTGTATTTAA,0,1952772
ihfAp4,0.25,3,3,GTGCAGCGTAGGTGGGGAAG,0,1932144
ihfAp4,0.25,3,3,GTGATCATATGCCCATGCCC,0,1960434
ihfAp4,0.25,3,3,GTGAGGACGTTCATGAAGTG,0,1955735
ihfAp4,0.25,3,3,GTGAGCATGATGTGTCGGCA,0,1939046
ihfAp4,0.25,3,3,GTGACAGTAGCTTTGTGGTG,0,1955751
ihfAp4,0.25,3,3,GTGACACCTAAGGCTAAAGT,0,1948093
ihfAp4,0.25,3,3,GTGAAGTTAGACAAATGTTG,0,1960091
ihfAp4,0.25,3,3,GTGAAGCTGCCTCTAAACGG,0,1937958
ihfAp4,0.25,3,3,GTCTTGGTGTGTACGTGCTG,0,1912015
ihfAp4,0.25,3,3,GTCTCCTGCTATACCTCCCA,0,1920017
ihfAp4,0.25,3,3,GTCTCACAAAAATGGGACAA,0,1921053
ihfAp4,0.25,3,3,GTCTATCAACTCCTCATTCT,0,1916398
ihfAp4,0.25,3,3,GTCGTGTCTGAATTCTGACT,0,1941096
ihfAp4,0.25,3,3,GTCGGGGTCCGCTCCGGCGG,0,1920429
ihfAp4,0.25,3,3,GTCGCACAGTTATGGGAAGG,0,1922929
ihfAp4,0.25,3,3,GTCGAGCTGATAGGTTACGT,0,1923138
ihfAp4,0.25,3,3,GTCGAATGAGGACGTCTATG,0,1923794
ihfAp4,0.25,3,3,GTCCTTTCGAGTCACTAGGG,0,1948705
ihfAp4,0.25,3,3,GTCCTTCCTGGGTCTCTTTG,0,1948781
ihfAp4,0.25,3,3,GTCCTGCGAAGACATCCTTG,0,1950852
ihfAp4,0.25,3,3,GTCCGGATGTCTCCTGGAAG,0,1914624
ihfAp4,0.25,3,3,GTCCGCGTCTTAGAAGCACG,0,1934597
ihfAp4,0.25,3,3,GTCCCGTTATCAGGCTGCGG,0,1951755
ihfAp4,0.25,3,3,GTCCCGGTGTACCGGGGTCA,0,1951883
ihfAp4,0.25,3,3,GTCCCGCTTCATTGATTATA,0,1949347
ihfAp4,0.25,3,3,GTCAGGAATCGTGGGCGGCA,0,1918049
ihfAp4,0.25,3,3,GTCAGATTGTGAGGAAGCTT,0,1951652
ihfAp4,0.25,3,3,GTCACTCATTCAATACGGGG,0,1925717
ihfAp4,0.25,3,3,GTCACAATATGGCTAGTCTC,0,1939981
ihfAp4,0.25,3,3,GTATTAAAGATAGAAAAGGG,0,1916248
ihfAp4,0.25,3,3,GTATAAAAAAGTGAGTACAA,0,1928051
ihfAp4,0.25,3,3,GTAGTTTGCCTCAGGGGGGT,0,1926607
ihfAp4,0.25,3,3,GTAGCGAGACGGTATGTGTT,0,1957296
ihfAp4,0.25,3,3,GTAGCGACTCATAACCAGGA,0,1939591
ihfAp4,0.25,3,3,GTAGCCTAGCTATTGTCAGT,0,1911420
ihfAp4,0.25,3,3,GTACTCTTAGGATAGGCAAA,0,1930227
ihfAp4,0.25,3,3,GTACTCACAGCCGGGGCGGT,0,1956643
ihfAp4,0.25,3,3,GTACTATTCCTGTCGTTAAG,0,1911391
ihfAp4,0.25,3,3,GTACTAATACCGGTGTTCCG,0,1911236
ihfAp4,0.25,3,3,GTACGGCTTCGTCAAATTGA,0,1928520
ihfAp4,0.25,3,3,GTACCTGAATATTTCATTCT,0,1919396
ihfAp4,0.25,3,3,GTACCGCTTGGAACACGACT,0,1952372
ihfAp4,0.25,3,3,GTACATGGATTTAAGAAGAC,0,1960736
ihfAp4,0.25,3,3,GTACAAGCCGTGCGGATGCC,0,1947712
ihfAp4,0.25,3,3,GTAATGCGACTGTGCGCGGT,0,1940147
ihfAp4,0.25,3,3,GTAATCTCAGGTTGTAAGTC,0,1932173
ihfAp4,0.25,3,3,GTAAGTATCGGTCTCCGGGT,0,1909695
ihfAp4,0.25,3,3,GTAAGCCCGCAATATGGGGG,0,1945004
ihfAp4,0.25,3,3,GTAACCATTTATTCCGGTAT,0,1954434
ihfAp4,0.25,3,3,GGTTTAGAGGTGAATGAGCA,0,1946101
ihfAp4,0.25,3,3,GGTTGCGGAGAACTTGCTTC,0,1961306
ihfAp4,0.25,3,3,GGTTCGTAGGGGGGCAACCA,0,1925706
ihfAp4,0.25,3,3,GGTTAGCATTGGGATTAGCA,0,1941266
ihfAp4,0.25,3,3,GGTGGTTGGCGACCTACTTA,0,1943616
ihfAp4,0.25,3,3,GGTGGTGAAATGGAAACCAG,0,1929904
ihfAp4,0.25,3,3,GGTGGAGGCGGCAATAAAGG,0,1952635
ihfAp4,0.25,3,3,GGTGGAAAGTCAGGCTTACG,0,1938746
ihfAp4,0.25,3,3,GGTGCTCACACCTACACAAT,0,1957002
ihfAp4,0.25,3,3,GGTGACGCCTACCATGGTTG,0,1939524
ihfAp4,0.25,3,3,GGTGAAGGCTTTCACCGAGA,0,1962299
ihfAp4,0.25,3,3,GGTCTGAGTAATAACTTTAT,0,1944334
ihfAp4,0.25,3,3,GGTCGTGAGTGCTATCATCA,0,1929227
ihfAp4,0.25,3,3,GGTCGGCGCTTTCGGTATCC,0,1916922
ihfAp4,0.25,3,3,GGTCCTTGAGTGTACAGTAA,0,1920845
ihfAp4,0.25,3,3,GGTCCGTGCCCAGTATATTA,0,1956707
ihfAp4,0.25,3,3,GGTCAGTGAAGGAATGCACA,0,1933546
ihfAp4,0.25,3,3,GGTATGCATAGACTAATTTG,0,1956868
ihfAp4,0.25,3,3,GGTAATCCCCATTTCTTAGG,0,1961324
ihfAp4,0.25,3,3,GGGTCGTCAATTCGCCACAT,0,1921767
ihfAp4,0.25,3,3,GGGTCAACACGTTTAAGTAG,0,1956160
ihfAp4,0.25,3,3,GGGGGCGGGTACAACCGCAA,0,1953783
ihfAp4,0.25,3,3,GGGGCTTGCGAGAGATGGTT,0,1935383
ihfAp4,0.25,3,3,GGGGCAGGCCGTCAATGCTG,0,1939069
ihfAp4,0.25,3,3,GGGGCAGCGCTATCCTTAGT,0,1951242
ihfAp4,0.25,3,3,GGGGATTGCGTTGGCAACCC,0,1929827
ihfAp4,0.25,3,3,GGGCTCCACTCAGAGTTTAC,0,1940812
ihfAp4,0.25,3,3,GGGCGTGCATGTTCACTTTT,0,1916822
ihfAp4,0.25,3,3,GGGCGCGGGTTTTTCTCGGA,0,1927531
ihfAp4,0.25,3,3,GGGCCATCAGGAAGGTCGGT,0,1920875
ihfAp4,0.25,3,3,GGGCCACACGTTTTTGGTTA,0,1926798
ihfAp4,0.25,3,3,GGGAGTAGGCTTCTAGTCCC,0,1913024
ihfAp4,0.25,3,3,GGGAGAATTAAGGCGGGAAA,0,1910939
ihfAp4,0.25,3,3,GGGACCTTAGGCATACGGCT,0,1914595
ihfAp4,0.25,3,3,GGGACCATAGCAGTGTAGTC,0,1915001
ihfAp4,0.25,3,3,GGGAATAGCACTCGAACAAT,0,1960297
ihfAp4,0.25,3,3,GGGAATAATAACGTTTATAA,0,1927568
ihfAp4,0.25,3,3,GGCTTGGTCACTGGGGCGTA,0,1937879
ihfAp4,0.25,3,3,GGCTTGCTGGATGCTCATAG,0,1910281
ihfAp4,0.25,3,3,GGCTTCATTTCGTTGTGTTC,0,1910175
ihfAp4,0.25,3,3,GGCTTAGCAGCTCGATTAAG,0,1930661
ihfAp4,0.25,3,3,GGCTGTGTCGAAATAGGCCC,0,1941530
ihfAp4,0.25,3,3,GGCTGTCTTCATGGCCATAC,0,1919511
ihfAp4,0.25,3,3,GGCTGAAAGGCCGGCTTTCT,0,1910047
ihfAp4,0.25,3,3,GGCTAACCACCTTAGCGTTC,0,1954184
ihfAp4,0.25,3,3,GGCGTGTAGCCAACCGTCTA,0,1913909
ihfAp4,0.25,3,3,GGCGCCGGTTGGCTCTACTG,0,1920392
ihfAp4,0.25,3,3,GGCGATTTCCTTTTATGGCA,0,1940788
ihfAp4,0.25,3,3,GGCCTGCGGGCCAAGTATTT,0,1959926
ihfAp4,0.25,3,3,GGCCTCTGGCCGCTATTGAA,0,1954229
ihfAp4,0.25,3,3,GGCCTCTGGCAACATTGAAC,0,1945338
ihfAp4,0.25,3,3,GGCCTCCCTATAGAAACTTA,0,1947230
ihfAp4,0.25,3,3,GGCCCGATTGCAGAGTACAA,0,1932957
ihfAp4,0.25,3,3,GGCCATTCTTAAGAATTTCG,0,1956550
ihfAp4,0.25,3,3,GGCCATACCTTGCGTGCACA,0,1915481
ihfAp4,0.25,3,3,GGCCACTCCACTGTTTGCTA,0,1924214
ihfAp4,0.25,3,3,GGCCAATCGACGTAGTGTTG,0,1915605
ihfAp4,0.25,3,3,GGCCAATATCGTGAAGACAG,0,1955862
ihfAp4,0.25,3,3,GGCCAAATAAAATCGGTTAT,0,1918497
ihfAp4,0.25,3,3,GGCAGGATCTAGACGGGGAG,0,1924980
ihfAp4,0.25,3,3,GGCACTCTATCGTAGTACGA,0,1950985
ihfAp4,0.25,3,3,GGCAAGGGGTCATGCCGATA,0,1952765
ihfAp4,0.25,3,3,GGCAAGACCTGAAACATCTC,0,1957619
ihfAp4,0.25,3,3,GGCAACCACTGATTATCGTT,0,1940937
ihfAp4,0.25,3,3,GGATGTGCTGACGAACTGTG,0,1934440
ihfAp4,0.25,3,3,GGATGCGGGGCTTTTTGCTT,0,1948658
ihfAp4,0.25,3,3,GGATCCACAGACCCGCGTAA,0,1915004
ihfAp4,0.25,3,3,GGAGTTGTATTGGCATTACT,0,1919916
ihfAp4,0.25,3,3,GGAGTGTTATCGTGAAGAAT,0,1927513
ihfAp4,0.25,3,3,GGAGTGTCCCCTAGGACGCA,0,1947049
ihfAp4,0.25,3,3,GGAGTATGCTGCGCACACGG,0,1951972
ihfAp4,0.25,3,3,GGAGGTGTCCAATTAGGTAC,0,1932879
ihfAp4,0.25,3,3,GGAGGGTTGTGGCCAATACC,0,1936171
ihfAp4,0.25,3,3,GGAGATATACTTGTCGCCTC,0,1927838
ihfAp4,0.25,3,3,GGAGAGCAATCCCATCGGCA,0,1950394
ihfAp4,0.25,3,3,GGAGAGACGGTATCAGTCAG,0,1919169
ihfAp4,0.25,3,3,GGAGAACGGGGCAAATCACA,0,1933579
ihfAp4,0.25,3,3,GGACTCTTGAATTGTGCTGA,0,1960907
ihfAp4,0.25,3,3,GGACTCGTGTTAAGCAAATG,0,1946486
ihfAp4,0.25,3,3,GGACGGGGTACGCTCTTGCT,0,1938077
ihfAp4,0.25,3,3,GGACCGCACGATTAGCGACT,0,1954985
ihfAp4,0.25,3,3,GGACAGTTTGAGGCCCCTCC,0,1911146
ihfAp4,0.25,3,3,GGAATCGCCAAGGGGGGACT,0,1932546
ihfAp4,0.25,3,3,GGAAGGTAATCCCTAAACTT,0,1930616
ihfAp4,0.25,3,3,GGAAGAACTTGACCGGTCCA,0,1918403
ihfAp4,0.25,3,3,GGAAATAATAAGTGGAGCCT,0,1916163
ihfAp4,0.25,3,3,GGAAAGTTCAGTTGATCTGG,0,1917466
ihfAp4,0.25,3,3,GGAAAGTGCTACGGCTACCT,0,1912841
ihfAp4,0.25,3,3,GGAAAGCTGACTGTGCTGAA,0,1931914
ihfAp4,0.25,3,3,GCTTTGATTCTCCTGCGGGA,0,1916136
ihfAp4,0.25,3,3,GCTTGTATCATATGAGTCCC,0,1915971
ihfAp4,0.25,3,3,GCTTGCTAAACACGGTATTC,0,1950518
ihfAp4,0.25,3,3,GCTTGCGCCTCACGAGTGGA,0,1959605
ihfAp4,0.25,3,3,GCTTGACGTGGCGCGGCAGG,0,1910913
ihfAp4,0.25,3,3,GCTTCCAGGGCACCGAAAGC,0,1920463
ihfAp4,0.25,3,3,GCTTAGTTCACAGGGCATTA,0,1955275
ihfAp4,0.25,3,3,GCTGCGAAGATAGCCCTGCA,0,1943624
ihfAp4,0.25,3,3,GCTGCAGACGCCAATGTTGC,0,1918283
ihfAp4,0.25,3,3,GCTCTGGGCCTACCCTTACT,0,1959228
ihfAp4,0.25,3,3,GCTCGAAATGTAACGTTCGC,0,1945022
ihfAp4,0.25,3,3,GCTCATTATTAGGGGGAAAA,0,1915216
ihfAp4,0.25,3,3,GCTATTAGATAGACCCACGT,0,1931385
ihfAp4,0.25,3,3,GCTATCTCACGAGCCTAAGC,0,1923583
ihfAp4,0.25,3,3,GCTATCACAGATATAGATGT,0,1912771
ihfAp4,0.25,3,3,GCTATACGCGACCGAGCAAA,0,1915065
ihfAp4,0.25,3,3,GCTATAATAAAAGGACCGGC,0,1923020
ihfAp4,0.25,3,3,GCTAGTTATCGATTGCGCTG,0,1926751
ihfAp4,0.25,3,3,GCTAGCTGTAAAAGCGCTAT,0,1923390
ihfAp4,0.25,3,3,GCTAGCGCGCCGATTCACAA,0,1922383
ihfAp4,0.25,3,3,GCTACGTAGACGCTGGAGAA,0,1934503
ihfAp4,0.25,3,3,GCTAATTCGACTTCAGTGGT,0,1954001
ihfAp4,0.25,3,3,GCTAAGGGCCATCCTTAACC,0,1935102
ihfAp4,0.25,3,3,GCTAAATCGCGTTTGTAACA,0,1954866
ihfAp4,0.25,3,3,GCGTTTAAAGATAAAGCAGC,0,1944554
ihfAp4,0.25,3,3,GCGTTGTGCTTTAAAGCTTG,0,1922705
ihfAp4,0.25,3,3,GCGTCCGTTGTCACATACAA,0,1957526
ihfAp4,0.25,3,3,GCGTATGGGCACCCGCAGAA,0,1933717
ihfAp4,0.25,3,3,GCGTAGTCACCGATGGATAA,0,1950986
ihfAp4,0.25,3,3,GCGTAGACGTGCGACTTCGC,0,1910611
ihfAp4,0.25,3,3,GCGGTGTCGCCTGCACTACG,0,1930508
ihfAp4,0.25,3,3,GCGGTGGATCAGCAGGTTTT,0,1948057
ihfAp4,0.25,3,3,GCGGTCAAATCACGCCGAAT,0,1957065
ihfAp4,0.25,3,3,GCGGGCCGCAGTTTTTACAT,0,1931651
ihfAp4,0.25,3,3,GCGGGCAGACCTCTTTAACA,0,1909979
ihfAp4,0.25,3,3,GCGGGAGCTTCCCGGCTCCC,0,1936743
ihfAp4,0.25,3,3,GCGGCCCTTGACGAGTGTGA,0,1937578
ihfAp4,0.25,3,3,GCGGCACTCATGCACTACGT,0,1946365
ihfAp4,0.25,3,3,GCGGATGCTGCCAGATTCCC,0,1911576
ihfAp4,0.25,3,3,GCGGATGCGGATTAGGGAAA,0,1947445
ihfAp4,0.25,3,3,GCGGATATCCAGGGTAAGAG,0,1915850
ihfAp4,0.25,3,3,GCGCGGCAAAGCAACGCTTG,0,1911529
ihfAp4,0.25,3,3,GCGCGCCAGGTGGCAAGATT,0,1961247
ihfAp4,0.25,3,3,GCGCCTGGGTACTGACAAAA,0,1940833
ihfAp4,0.25,3,3,GCGATCCGCGTGAAAGCTTG,0,1951492
ihfAp4,0.25,3,3,GCGATACTGTCCTGATGACG,0,1942975
ihfAp4,0.25,3,3,GCGAGTGGGGTAGCGTTGTT,0,1952584
ihfAp4,0.25,3,3,GCGAGTAATAGCGGATATGT,0,1937862
ihfAp4,0.25,3,3,GCGAGGCGGATTCTTGAGGG,0,1930731
ihfAp4,0.25,3,3,GCGAAGAAGCGTCCGGAAGA,0,1923833
ihfAp4,0.25,3,3,GCGAAAGGCGCTCGCGGTGG,0,1929708
ihfAp4,0.25,3,3,GCCTTCGGGTGAGGGAGCCA,0,1926972
ihfAp4,0.25,3,3,GCCTGGATTAGAGCGCGTAT,0,1955573
ihfAp4,0.25,3,3,GCCTGAGCTGCCCAGAGACT,0,1934796
ihfAp4,0.25,3,3,GCCTCTGGGAAAAAGAATGA,0,1926248
ihfAp4,0.25,3,3,GCCTCCGTAGCGCTGGATAT,0,1950352
ihfAp4,0.25,3,3,GCCTACAGCAATGGTCCCCC,0,1936634
ihfAp4,0.25,3,3,GCCGTCATCATATGTACGTT,0,1919020
ihfAp4,0.25,3,3,GCCGTAACCGGACTCCGAAA,0,1911541
ihfAp4,0.25,3,3,GCCGTAAATGGATGGGACCT,0,1961548
ihfAp4,0.25,3,3,GCCGGCTGGTCTACCTTACG,0,1929558
ihfAp4,0.25,3,3,GCCGGATGGTACGCCTTCGG,0,1909737
ihfAp4,0.25,3,3,GCCGGAGGGGTTGGCGGGCT,0,1936960
ihfAp4,0.25,3,3,GCCGCTTCTTCATTAGGGGC,0,1955460
ihfAp4,0.25,3,3,GCCGAATGCCTCCAAGGGAG,0,1936360
ihfAp4,0.25,3,3,GCCCTCCCCCGGCTATGCTG,0,1947083
ihfAp4,0.25,3,3,GCCCTACGGATTTTAAGAGA,0,1961068
ihfAp4,0.25,3,3,GCCCGAGAGAGGCATTGTGC,0,1930173
ihfAp4,0.25,3,3,GCCAGCGATTCATATGTGTC,0,1942807
ihfAp4,0.25,3,3,GCCACATAATAAACGATTTC,0,1939128
ihfAp4,0.25,3,3,GCCAAGAGATTTCCTTCGGA,0,1921794
ihfAp4,0.25,3,3,GCCAACCACCAGCAGACAAA,0,1917974
ihfAp4,0.25,3,3,GCCAAAGTAACTTAGTGTAC,0,1913179
ihfAp4,0.25,3,3,GCATTCTGGGTGCCGACTAA,0,1941821
ihfAp4,0.25,3,3,GCATTATGCAGGGAAACGCA,0,1957230
ihfAp4,0.25,3,3,GCATTAGGTCCTAACTCATT,0,1953354
ihfAp4,0.25,3,3,GCATGGCTCGGGGGCGCGGA,0,1959539
ihfAp4,0.25,3,3,GCATGCTCAATAGCTGCCAC,0,1956528
ihfAp4,0.25,3,3,GCATCATTGACGTATTGAGT,0,1912602
ihfAp4,0.25,3,3,GCATCAAATTTTCCGGACGG,0,1935687
ihfAp4,0.25,3,3,GCATACTTTTACAATTGGTT,0,1937217
ihfAp4,0.25,3,3,GCAGTTGATCGCCGGTTCAG,0,1928819
ihfAp4,0.25,3,3,GCAGGAAAATGCACAGCTCA,0,1959101
ihfAp4,0.25,3,3,GCAGCTAATATGATATAAAG,0,1932358
ihfAp4,0.25,3,3,GCAGATGAACGAGTTTACTG,0,1939732
ihfAp4,0.25,3,3,GCAGAGTGCCGTTACTCCGA,0,1932118
ihfAp4,0.25,3,3,GCACGTGATTCATGCACAAG,0,1918064
ihfAp4,0.25,3,3,GCACACCGGACTCTGAATGA,0,1932145
ihfAp4,0.25,3,3,GCAATGTGCCCTTGAACTAA,0,1960391
ihfAp4,0.25,3,3,GCAATACGGCGGACATAACG,0,1927987
ihfAp4,0.25,3,3,GCAAGGGATATCAGGGGTCT,0,1959322
ihfAp4,0.25,3,3,GCAACTGAGGGGCCGTTCTA,0,1956934
ihfAp4,0.25,3,3,GCAACCCGCGACGATAAAGA,0,1918254
ihfAp4,0.25,3,3,GCAAAGATGACAACATACCA,0,1916421
ihfAp4,0.25,3,3,GCAAACGTCGCTCGTTGGAG,0,1932543
ihfAp4,0.25,3,3,GATTTTGGAATCCATGCGCC,0,1911847
ihfAp4,0.25,3,3,GATTTTATCCTAAAACGATG,0,1957741
ihfAp4,0.25,3,3,GATTTGAGTAGACTCTGGGA,0,1915492
ihfAp4,0.25,3,3,GATTGGTCTGGAACAGCTGG,0,1958722
ihfAp4,0.25,3,3,GATTGGCATTGATTCTCCAG,0,1957252
ihfAp4,0.25,3,3,GATGTGGGGACGGGTATCGA,0,1916086
ihfAp4,0.25,3,3,GATGCATGTGGTGCAGTCAA,0,1916276
ihfAp4,0.25,3,3,GATGCAAGACATGGTCAGGT,0,1948759
ihfAp4,0.25,3,3,GATGATTTGGATGCGGATGA,0,1951409
ihfAp4,0.25,3,3,GATGAGCCCTGAGGAGTTGT,0,1936523
ihfAp4,0.25,3,3,GATCCTCCAACGCTTGTTTG,0,1954648
ihfAp4,0.25,3,3,GATAGTGTTCTCAAATTAAC,0,1933706
ihfAp4,0.25,3,3,GATAGTGAATCCGGCTTAAA,0,1957924
ihfAp4,0.25,3,3,GATAGTCTTGGTAGGCTGAA,0,1913245
ihfAp4,0.25,3,3,GATAGGAATGTATACTGTTC,0,1941395
ihfAp4,0.25,3,3,GATAGCACGTCCCACTTAGT,0,1942709
ihfAp4,0.25,3,3,GATAGAAGCTGTAATCATAG,0,1947756
ihfAp4,0.25,3,3,GATACGCCATATGGTTTAGA,0,1920458
ihfAp4,0.25,3,3,GATAATCAAAGGGTGCAAAA,0,1922535
ihfAp4,0.25,3,3,GATAACTGACAGGGTACTAT,0,1940002
ihfAp4,0.25,3,3,GAGTTGCCATGGCACTGCAT,0,1919378
ihfAp4,0.25,3,3,GAGTTATCGGTTCGGCGGGG,0,1931553
ihfAp4,0.25,3,3,GAGTTACTCTATTCTGCTTT,0,1954092
ihfAp4,0.25,3,3,GAGTGGCGTCTAAGGTCACA,0,1932454
ihfAp4,0.25,3,3,GAGTGGAGGATAGTTACGAT,0,1917489
ihfAp4,0.25,3,3,GAGTCTAGAATAAGGGGGAC,0,1924336
ihfAp4,0.25,3,3,GAGTACTAAAATGAAACCGT,0,1953599
ihfAp4,0.25,3,3,GAGGGTTCGACAGAGTACAT,0,1911800
ihfAp4,0.25,3,3,GAGGGCGGCCACGGATTCCA,0,1953500
ihfAp4,0.25,3,3,GAGGGAGGTATGCTGTCCTC,0,1946626
ihfAp4,0.25,3,3,GAGGCCCAAAGAACAATGGA,0,1949920
ihfAp4,0.25,3,3,GAGGACTCAGTGGTGGGCGT,0,1937579
ihfAp4,0.25,3,3,GAGGACAGGGGTATATTCTA,0,1960356
ihfAp4,0.25,3,3,GAGGACAATCGTTGATGGTC,0,1932646
ihfAp4,0.25,3,3,GAGCTGGAACTATTCCTTCA,0,1942546
ihfAp4,0.25,3,3,GAGCGTCGTTTCCCCATGTC,0,1932199
ihfAp4,0.25,3,3,GAGCGCTATCAAAAAGTATT,0,1923479
ihfAp4,0.25,3,3,GAGCGATTAGTTTCCCGGTG,0,1931971
ihfAp4,0.25,3,3,GAGCATTTTAAACCATTTAT,0,1928305
ihfAp4,0.25,3,3,GAGCAACGCTTCGTGCTATA,0,1958966
ihfAp4,0.25,3,3,GAGATCTTGCAAGAGGGGGA,0,1917143
ihfAp4,0.25,3,3,GAGATAAGACTACGTAATGA,0,1942024
ihfAp4,0.25,3,3,GAGAGGATCCAAGCTGTCCG,0,1937688
ihfAp4,0.25,3,3,GACTTTGTATGGCAAGGTTT,0,1914999
ihfAp4,0.25,3,3,GACTGTTTGTTTCAGAGTGC,0,1939848
ihfAp4,0.25,3,3,GACTGTTCAGGAGTATGGCA,0,1959585
ihfAp4,0.25,3,3,GACTGATTTATGTCCCAATA,0,1961086
ihfAp4,0.25,3,3,GACTGAAAGCTGTAGGATGA,0,1944229
ihfAp4,0.25,3,3,GACTCGTACGAATATGCCTT,0,1922617
ihfAp4,0.25,3,3,GACTCGCGCTGCGCATAGTT,0,1925569
ihfAp4,0.25,3,3,GACTCATGCCCCCCAAGCGT,0,1928868
ihfAp4,0.25,3,3,GACTAAGGCGCATAAAAGTA,0,1909773
ihfAp4,0.25,3,3,GACGTTCTAAACGCCACGTG,0,1948757
ihfAp4,0.25,3,3,GACGTCGTGGATCAGTACTC,0,1943610
ihfAp4,0.25,3,3,GACGGAGAACCAGAGGCCTT,0,1928858
ihfAp4,0.25,3,3,GACGCTATGTGTGCTGATGC,0,1914236
ihfAp4,0.25,3,3,GACGAGCCAAAGACAGTCTA,0,1925342
ihfAp4,0.25,3,3,GACCTCGCACGTGCCGAGTG,0,1925814
ihfAp4,0.25,3,3,GACCGAGGGCAGACAGGCTG,0,1910068
ihfAp4,0.25,3,3,GACCCCAGGTTCGGCAAGGT,0,1948576
ihfAp4,0.25,3,3,GACCATTTATAATTAGCGAT,0,1948852
ihfAp4,0.25,3,3,GACCAGAGCTAGAACACAAT,0,1956354
ihfAp4,0.25,3,3,GACCACAACGTAGGCTCGCC,0,1947631
ihfAp4,0.25,3,3,GACATTTTAGCTCAATCCTA,0,1955187
ihfAp4,0.25,3,3,GACATTGCCTGGGGGGCCGA,0,1940246
ihfAp4,0.25,3,3,GACAGGCGACTAACAGAAGG,0,1954657
ihfAp4,0.25,3,3,GACAGCTTGGGGGCATCTCA,0,1951548
ihfAp4,0.25,3,3,GACAGCTTAACAAGCGTGCC,0,1947524
ihfAp4,0.25,3,3,GACAATTACTCCAGGAGACA,0,1957975
ihfAp4,0.25,3,3,GACAAAATTAAGGAGAGCAC,0,1948872
ihfAp4,0.25,3,3,GACAAAAGCGTGGGCAGGAA,0,1933714
ihfAp4,0.25,3,3,GAATGGGCTTGCCGGTTTGA,0,1925859
ihfAp4,0.25,3,3,GAATCGACATATGGGACCGG,0,1947694
ihfAp4,0.25,3,3,GAATAGGACCTGGGTTAGGA,0,1938210
ihfAp4,0.25,3,3,GAATACGTTGGTTCCCACGC,0,1921413
ihfAp4,0.25,3,3,GAAGTTGCGTAATGGTTTAG,0,1943916
ihfAp4,0.25,3,3,GAAGCGGCGTGTACCTAAGG,0,1956436
ihfAp4,0.25,3,3,GAAGATTATTCTGTTGTTTC,0,1914576
ihfAp4,0.25,3,3,GAAGACACCGGAATTAGAAC,0,1953022
ihfAp4,0.25,3,3,GAACTTTCGGAGGGGATTGA,0,1948355
ihfAp4,0.25,3,3,GAACCAGAATCCTGGCCTCC,0,1951200
ihfAp4,0.25,3,3,GAACATTCCCAGTGTGTAGG,0,1959523
ihfAp4,0.25,3,3,GAACAACGGCACCGCTCTGA,0,1942605
ihfAp4,0.25,3,3,GAAATCAGGGTTTTCTGTTG,0,1912269
ihfAp4,0.25,3,3,GAAACACCTTTATGCATAGC,0,1926809
ihfAp4,0.25,3,3,GAAAAATGGCTTAGACCTCT,0,1934067
ihfAp4,0.25,3,3,CTTTTACGGATATAAAAAAT,0,1911564
ihfAp4,0.25,3,3,CTTTGGAGGCGGGGCATAAT,0,1917118
ihfAp4,0.25,3,3,CTTTCGCAACAATTTGACTA,0,1929178
ihfAp4,0.25,3,3,CTTTCGAAGGTGTCATATGC,0,1940718
ihfAp4,0.25,3,3,CTTTCCCTAAAGTTTGTACC,0,1919964
ihfAp4,0.25,3,3,CTTTCACGTAGAACTTGGAC,0,1917773
ihfAp4,0.25,3,3,CTTTATCTATGCACCTCAAT,0,1910689
ihfAp4,0.25,3,3,CTTTACCACCCAGGGGCTGC,0,1920906
ihfAp4,0.25,3,3,CTTGGTTGGGGACGACATGG,0,1910406
ihfAp4,0.25,3,3,CTTGGGAGGACATGAGAGCT,0,1917867
ihfAp4,0.25,3,3,CTTGCATCCTGCATTCCCGA,0,1935567
ihfAp4,0.25,3,3,CTTCGGTGAGCGTTGAGGTC,0,1920935
ihfAp4,0.25,3,3,CTTCGGCTTCCAGAGGCAGG,0,1917478
ihfAp4,0.25,3,3,CTTCCTGGGCCAGCCTCCTG,0,1947896
ihfAp4,0.25,3,3,CTTCCGAACTGAATGGAGGG,0,1911854
ihfAp4,0.25,3,3,CTTCCATGCTATTAGGCTGT,0,1912565
ihfAp4,0.25,3,3,CTTCATAGCGTTGGAGAAGT,0,1922248
ihfAp4,0.25,3,3,CTTCAAAGCTAAAGCAATCA,0,1912188
ihfAp4,0.25,3,3,CTTATACGGTACCTACACTG,0,1939627
ihfAp4,0.25,3,3,CTTAGACGCTTCACCTAGCT,0,1951971
ihfAp4,0.25,3,3,CTTACCCTAATTATCAGGCT,0,1961162
ihfAp4,0.25,3,3,CTTACATCAATAGTTTTGAT,0,1952678
ihfAp4,0.25,3,3,CTTAATTGATGAACCTGTCC,0,1922208
ihfAp4,0.25,3,3,CTGTTCATACGATGATTAAA,0,1930962
ihfAp4,0.25,3,3,CTGTGTCTGGCTATTATCGT,0,1955607
ihfAp4,0.25,3,3,CTGGTGATAAGGGCGTCTAA,0,1954578
ihfAp4,0.25,3,3,CTGGTCGAACTAGAGGGGAG,0,1910690
ihfAp4,0.25,3,3,CTGGTAGCAGTCACTTCTAT,0,1923742
ihfAp4,0.25,3,3,CTGGGGGCTCTTGGAAGATA,0,1957299
ihfAp4,0.25,3,3,CTGGGATGACAGAGCGACGT,0,1919587
ihfAp4,0.25,3,3,CTGGGAGCAGTCCCCTGCTA,0,1952475
ihfAp4,0.25,3,3,CTGGATATGAATGAGTAAGT,0,1912372
ihfAp4,0.25,3,3,CTGGAAACCTCACTATTGCT,0,1948866
ihfAp4,0.25,3,3,CTGCTATGATAATCGACTGC,0,1951670
ihfAp4,0.25,3,3,CTGCGTAGATGGCCGTGGGT,0,1934110
ihfAp4,0.25,3,3,CTGCGGGTCAGTTTTTACCG,0,1918215
ihfAp4,0.25,3,3,CTGCGGAACTTATTCATGAA,0,1948452
ihfAp4,0.25,3,3,CTGCGCCGAAGGTAAGCACG,0,1914591
ihfAp4,0.25,3,3,CTGCCTGTCCAACTCTATAT,0,1916519
ihfAp4,0.25,3,3,CTGCCTCGTTACTATTCGTA,0,1945053
ihfAp4,0.25,3,3,CTGCCGGATGTCTTCCAGAA,0,1951917
ihfAp4,0.25,3,3,CTGCCCTATGCCCTTAACCT,0,1949820
ihfAp4,0.25,3,3,CTGCCAAATCACCGCACAGT,0,1936368
ihfAp4,0.25,3,3,CTGCATGTCTCATCTGATTA,0,1919467
ihfAp4,0.25,3,3,CTGATTGTGTAGATCATCAA,0,1942574
ihfAp4,0.25,3,3,CTGATGGCAAACTGGGTAAA,0,1954134
ihfAp4,0.25,3,3,CTGACCTACTCAATTTTAAA,0,1961887
ihfAp4,0.25,3,3,CTGAATATTCTCCCGCAACC,0,1921641
ihfAp4,0.25,3,3,CTCTTGTGCAGGTGGGCGTT,0,1939311
ihfAp4,0.25,3,3,CTCTCTATTTGCTGATATCT,0,1917772
ihfAp4,0.25,3,3,CTCTCAACATCCTGAGAGCC,0,1938639
ihfAp4,0.25,3,3,CTCTACCGGAAGGGGATTAA,0,1931851
ihfAp4,0.25,3,3,CTCGTACCGTGCTTAGTACA,0,1961148
ihfAp4,0.25,3,3,CTCGTAAGATCTCAGAGGAC,0,1924616
ihfAp4,0.25,3,3,CTCGGTTCGACTTAGCGACA,0,1958497
ihfAp4,0.25,3,3,CTCGGCGAGCATTCGCATGC,0,1955019
ihfAp4,0.25,3,3,CTCCTGTAGTTGCCCCGCGA,0,1913188
ihfAp4,0.25,3,3,CTCCTCGTTACGGGGATCGA,0,1930611
ihfAp4,0.25,3,3,CTCCATTTCGGAGGGGATAA,0,1959946
ihfAp4,0.25,3,3,CTCCATGACCATAAACTCGT,0,1950953
ihfAp4,0.25,3,3,CTCCACCGCAAGGCATCCCC,0,1950881
ihfAp4,0.25,3,3,CTCATAGTAACATATATGCC,0,1921490
ihfAp4,0.25,3,3,CTCACGTATGAATCTATACA,0,1934283
ihfAp4,0.25,3,3,CTCAATATCTGACATGTGCA,0,1946858
ihfAp4,0.25,3,3,CTCAACTTGAGTCAACTACT,0,1951537
ihfAp4,0.25,3,3,CTATTCTGCCACGGACACAC,0,1909868
ihfAp4,0.25,3,3,CTATTCGGGGAACAGCGGCA,0,1930224
ihfAp4,0.25,3,3,CTATCGAGTGTCCCTGATGG,0,1914015
ihfAp4,0.25,3,3,CTAGTTTCTCATTCGCTTAG,0,1958292
ihfAp4,0.25,3,3,CTAGTTAAGTATCACCATCT,0,1953293
ihfAp4,0.25,3,3,CTAGTGTACTCCATTGACGT,0,1913427
ihfAp4,0.25,3,3,CTAGTATCGTAGTACTCGCC,0,1948574
ihfAp4,0.25,3,3,CTAGGGGTGGCAAGAGGTCC,0,1916561
ihfAp4,0.25,3,3,CTAGGATCTCCAAATAGTTC,0,1939307
ihfAp4,0.25,3,3,CTAGCAGTAGAAGATCGTGT,0,1915855
ihfAp4,0.25,3,3,CTAGAGAGAGGGGGCGTTTC,0,1919444
ihfAp4,0.25,3,3,CTACTCGCTGGAGAGTCGAA,0,1949927
ihfAp4,0.25,3,3,CTACGTGACTCGCGCGCCCT,0,1930094
ihfAp4,0.25,3,3,CTACCCGGTCCCGTAGCCGG,0,1918610
ihfAp4,0.25,3,3,CTAAGTTGTTCAGATTGTAC,0,1959085
ihfAp4,0.25,3,3,CTAAGATACTGCCACCCGAT,0,1955494
ihfAp4,0.25,3,3,CTAACAATGCCCGGTATCTA,0,1920652
ihfAp4,0.25,3,3,CTAAAGTTCGTCCTGTTTTG,0,1950064
ihfAp4,0.25,3,3,CGTTGTACTGTAACCAAGCA,0,1944848
ihfAp4,0.25,3,3,CGTTGCGCAAGTCTGTCATA,0,1941313
ihfAp4,0.25,3,3,CGTTGACTGCATGGTCGTTT,0,1926942
ihfAp4,0.25,3,3,CGTTGACCTTTTTTTAGTCA,0,1940885
ihfAp4,0.25,3,3,CGTTCCGCGTGTTTAAGCAT,0,1910055
ihfAp4,0.25,3,3,CGTTATTCAACATAGGAACG,0,1930938
ihfAp4,0.25,3,3,CGTTATATATAGTCACTCTG,0,1937711
ihfAp4,0.25,3,3,CGTGTTGCGTCTATTGACAC,0,1954811
ihfAp4,0.25,3,3,CGTGTGGCATTCTGATTGTC,0,1917914
ihfAp4,0.25,3,3,CGTGTGATAGTCATAGGTAC,0,1939296
ihfAp4,0.25,3,3,CGTGTCAGTGCTCCCTGCAG,0,1931263
ihfAp4,0.25,3,3,CGTGGGCTTATAGATCCAGT,0,1937544
ihfAp4,0.25,3,3,CGTGGCTTCCAGTTCAACGT,0,1923688
ihfAp4,0.25,3,3,CGTGCCTCTTCACTAGGTGA,0,1947914
ihfAp4,0.25,3,3,CGTGAGTCGTAACGATAATG,0,1954101
ihfAp4,0.25,3,3,CGTGAAGGAACAAATCTCCG,0,1922462
ihfAp4,0.25,3,3,CGTCGGTCCACCGAAGATTG,0,1925496
ihfAp4,0.25,3,3,CGTCCGTTTAGTGAACCGTT,0,1914607
ihfAp4,0.25,3,3,CGTCCGGACGAACTGTGCAT,0,1927892
ihfAp4,0.25,3,3,CGTCCCCACGTGTCATCGCT,0,1913613
ihfAp4,0.25,3,3,CGTCCCAACACTGCTTAGAG,0,1930458
ihfAp4,0.25,3,3,CGTCAAACACCTTTCGACGA,0,1942104
ihfAp4,0.25,3,3,CGTATTAAGGCAGCCTTTGT,0,1920647
ihfAp4,0.25,3,3,CGTATGGCACCATGCAATAC,0,1935300
ihfAp4,0.25,3,3,CGTAGTGTAATCCGTAAAAA,0,1909660
ihfAp4,0.25,3,3,CGTAGCGTTGGCGGGTCTCT,0,1952529
ihfAp4,0.25,3,3,CGTACTCCTGGTTGAAACGC,0,1927296
ihfAp4,0.25,3,3,CGTACATTTACATATTACCG,0,1929202
ihfAp4,0.25,3,3,CGTACAGGTAACTTTGGCCA,0,1925703
ihfAp4,0.25,3,3,CGTAATGGAACCGGAAAATC,0,1958692
ihfAp4,0.25,3,3,CGGTGAGACTGGATACATCT,0,1916959
ihfAp4,0.25,3,3,CGGTCGCCGGCGCATGCATG,0,1927276
ihfAp4,0.25,3,3,CGGGTCAAGGGTAGGCTCGC,0,1956419
ihfAp4,0.25,3,3,CGGGGGCCAAGACCATTAGG,0,1942197
ihfAp4,0.25,3,3,CGGCTTATGTGCACGAACGT,0,1932559
ihfAp4,0.25,3,3,CGGCGGTCAAATTACACGCT,0,1947225
ihfAp4,0.25,3,3,CGGCGGGGCGAAGCTACGTT,0,1936749
ihfAp4,0.25,3,3,CGGCGGCGCGCCAGACGCCA,0,1922171
ihfAp4,0.25,3,3,CGGCGCTAGCATTACGAGTA,0,1912780
ihfAp4,0.25,3,3,CGGCATGCCGGGTTCCTCAT,0,1917167
ihfAp4,0.25,3,3,CGGATTCCCTTCGCGCCAAG,0,1931268
ihfAp4,0.25,3,3,CGGAGTTCGCGATATGCAGC,0,1936959
ihfAp4,0.25,3,3,CGGAGTAGTCTTGCCGAGGC,0,1924511
ihfAp4,0.25,3,3,CGGAGCGGGCCGTTAATTGG,0,1917369
ihfAp4,0.25,3,3,CGGACTATTTTGGGGGCCTT,0,1959521
ihfAp4,0.25,3,3,CGGACCGCCTCAACAAGACT,0,1910051
ihfAp4,0.25,3,3,CGGAATTTGCTATTCAAATT,0,1934728
ihfAp4,0.25,3,3,CGGAATGGTTGTTTTGGGGA,0,1927223
ihfAp4,0.25,3,3,CGGAATGATCGGAAGAGCTC,0,1927148
ihfAp4,0.25,3,3,CGGAAGCGGTGCGAGCAGCA,0,1956322
ihfAp4,0.25,3,3,CGCTTGTGGGCTGATACGTC,0,1920937
ihfAp4,0.25,3,3,CGCTACGCGGCAGCAGAAGT,0,1938432
ihfAp4,0.25,3,3,CGCGGTGGGGTTGCTTTCGC,0,1931119
ihfAp4,0.25,3,3,CGCGGCTAAATGGCACTACT,0,1956140
ihfAp4,0.25,3,3,CGCGGAAGTCGCCCGTTGTC,0,1942212
ihfAp4,0.25,3,3,CGCGCGCCGCGAGAGATTTC,0,1942658
ihfAp4,0.25,3,3,CGCGAGAAAGTACCTCTACT,0,1937411
ihfAp4,0.25,3,3,CGCCTTGGTTTGTACGGATG,0,1923500
ihfAp4,0.25,3,3,CGCCGGGCGGTTGGTACGTC,0,1913872
ihfAp4,0.25,3,3,CGCCATGGTCTCAACGTAGT,0,1955863
ihfAp4,0.25,3,3,CGCCATCGTATACCGGCTAG,0,1934523
ihfAp4,0.25,3,3,CGCCATCACTCACGTAAGGG,0,1936595
ihfAp4,0.25,3,3,CGCCAAATGCTTGCTGCCGG,0,1917943
ihfAp4,0.25,3,3,CGCATTCTTGCATAGTTTCT,0,1943684
ihfAp4,0.25,3,3,CGCATCAAGATGGGTCTTGC,0,1924313
ihfAp4,0.25,3,3,CGCAGTCGAGTGATTGCTGA,0,1922382
ihfAp4,0.25,3,3,CGCAGAGTCGAAGGCCTGCA,0,1959136
ihfAp4,0.25,3,3,CGCAGAATTCTTAGGTGTTA,0,1922034
ihfAp4,0.25,3,3,CGCAACGGCCTGAATTTAGT,0,1950146
ihfAp4,0.25,3,3,CGCAACGATCTAGGAATGTT,0,1937968
ihfAp4,0.25,3,3,CGATGCGCTGAACCACATAT,0,1923362
ihfAp4,0.25,3,3,CGATCCCCACTCAGAGGGGT,0,1941686
ihfAp4,0.25,3,3,CGATCAAAAAGGTCAGAGCA,0,1942358
ihfAp4,0.25,3,3,CGATATCTCAAATTGCTGGG,0,1914913
ihfAp4,0.25,3,3,CGATAGTGCGAATTGGTATT,0,1913690
ihfAp4,0.25,3,3,CGATAGCATCAGTATGAGGA,0,1944176
ihfAp4,0.25,3,3,CGAGTGTGCGCTCGTGCAAC,0,1956268
ihfAp4,0.25,3,3,CGAGTACGGCAATAAACTTA,0,1913501
ihfAp4,0.25,3,3,CGAGGTTCTTAATATGCATG,0,1942495
ihfAp4,0.25,3,3,CGAGGAATTGAGGGAGATGT,0,1929121
ihfAp4,0.25,3,3,CGACTCTAGTCTTTACGGTA,0,1923555
ihfAp4,0.25,3,3,CGACGTTCAATTCATCGGAG,0,1925156
ihfAp4,0.25,3,3,CGACGGATACGATATAGTGC,0,1929291
ihfAp4,0.25,3,3,CGACGCCGGGAGGGAGGATG,0,1949218
ihfAp4,0.25,3,3,CGACGAATCCTTCGAGAGAC,0,1923983
ihfAp4,0.25,3,3,CGAAGTTCGTCGAAGGGCCG,0,1957068
ihfAp4,0.25,3,3,CGAAGTAATTGCTCTTACGC,0,1918003
ihfAp4,0.25,3,3,CGAAGCAGCCTAACAGTGAT,0,1910369
ihfAp4,0.25,3,3,CGAAAGTCTTTAAAGGGCGA,0,1909915
ihfAp4,0.25,3,3,CCTTTGCAAGAGCGGTCCAG,0,1919757
ihfAp4,0.25,3,3,CCTTCGTTGCTCTTGTATGT,0,1930577
ihfAp4,0.25,3,3,CCTTCGTACGCGGGAAAGTT,0,1961122
ihfAp4,0.25,3,3,CCTTCGGCGGGGAAGTGGTC,0,1950634
ihfAp4,0.25,3,3,CCTGTTGATAGGGCGGTTTG,0,1959177
ihfAp4,0.25,3,3,CCTGTCGCAGATTGGCTCCG,0,1955316
ihfAp4,0.25,3,3,CCTGGTGCTCGTGAGGTACT,0,1936556
ihfAp4,0.25,3,3,CCTGCTTTTTCTCTCCATAC,0,1924167
ihfAp4,0.25,3,3,CCTGCCAAGAGGTCAATGAA,0,1937316
ihfAp4,0.25,3,3,CCTGCAGCTTAAACAGTTAT,0,1956168
ihfAp4,0.25,3,3,CCTGAGTCTCACGGTAGGAC,0,1923152
ihfAp4,0.25,3,3,CCTCTTTTAATACTAGAGGT,0,1923040
ihfAp4,0.25,3,3,CCTCTCCGCAGGGACTGAAT,0,1923857
ihfAp4,0.25,3,3,CCTCCTCCTGATTTATACTT,0,1961061
ihfAp4,0.25,3,3,CCTCAAAAGGAGCACAAGCT,0,1939167
ihfAp4,0.25,3,3,CCTACATGGCTGCGCTGTCA,0,1938338
ihfAp4,0.25,3,3,CCTAAACGTGTTCCCTGTTA,0,1918146
ihfAp4,0.25,3,3,CCGTGCGCAGACCATTGCGG,0,1952520
ihfAp4,0.25,3,3,CCGTGCGATGCCTCTATCTA,0,1909606
ihfAp4,0.25,3,3,CCGTCCCCACTAGGTGAAAA,0,1953121
ihfAp4,0.25,3,3,CCGTATGCTGGGGTCGTGGG,0,1944945
ihfAp4,0.25,3,3,CCGGTGTGCATAGTTGTTCG,0,1911473
ihfAp4,0.25,3,3,CCGGTGTACGTGAGGGGGGT,0,1914075
ihfAp4,0.25,3,3,CCGGGTTTTGTCGTGCTACA,0,1911101
ihfAp4,0.25,3,3,CCGGGTAAATAACCCGGCAT,0,1946337
ihfAp4,0.25,3,3,CCGGGCTCACCAGCATATGA,0,1957343
ihfAp4,0.25,3,3,CCGGCTGGTCACATGAGATT,0,1961088
ihfAp4,0.25,3,3,CCGGCTGACAGTGCGGCCAA,0,1920384
ihfAp4,0.25,3,3,CCGGCCGCACACGTTGAGCG,0,1917747
ihfAp4,0.25,3,3,CCGCTTGGCAGGCAGGGGCC,0,1940220
ihfAp4,0.25,3,3,CCGCTTCGGTGGCGGTTCAA,0,1916507
ihfAp4,0.25,3,3,CCGCTTAAGCTCTGTTGCCT,0,1909752
ihfAp4,0.25,3,3,CCGCGTTAACCGGTGGATAT,0,1940932
ihfAp4,0.25,3,3,CCGCCGTTTATCTCGGCTAT,0,1910397
ihfAp4,0.25,3,3,CCGCCGTCCTGGATGGTGTA,0,1917480
ihfAp4,0.25,3,3,CCGCCCCCTTGGGTAATAAT,0,1924661
ihfAp4,0.25,3,3,CCGCCAACGCGGTAGACGAT,0,1948931
ihfAp4,0.25,3,3,CCGCAAGCGTGCATGGGAGA,0,1937915
ihfAp4,0.25,3,3,CCGATGCAACGTGTTTGCCT,0,1959852
ihfAp4,0.25,3,3,CCGAGGTAGTCTACAGTCGC,0,1936880
ihfAp4,0.25,3,3,CCGAGGAGATGACCGGCTAC,0,1961340
ihfAp4,0.25,3,3,CCGACAAGCGGAATTATGTC,0,1940399
ihfAp4,0.25,3,3,CCGAAGAGGGTACAGAACAC,0,1926534
ihfAp4,0.25,3,3,CCCTCAAATGTATTTTGGGG,0,1939333
ihfAp4,0.25,3,3,CCCGTTAATGTTTGCGCTAT,0,1928350
ihfAp4,0.25,3,3,CCCGGAAGGTTGATAATACG,0,1936447
ihfAp4,0.25,3,3,CCCGCGTGGCGTATGGGAGA,0,1917520
ihfAp4,0.25,3,3,CCCGATTTCGCCGAGTGATG,0,1910722
ihfAp4,0.25,3,3,CCCGATGGGCGTTGTAGTGG,0,1920908
ihfAp4,0.25,3,3,CCCGACGACTCTAGAGACCT,0,1948262
ihfAp4,0.25,3,3,CCCGACGAAGCGTCCAGATT,0,1956171
ihfAp4,0.25,3,3,CCCCTTGTGGTTAACATGCT,0,1941945
ihfAp4,0.25,3,3,CCCCGACCAACCTGGCTTTG,0,1919715
ihfAp4,0.25,3,3,CCCCCCATCACCCGTCGTCA,0,1946066
ihfAp4,0.25,3,3,CCCCACAATAGCTATGACTC,0,1920300
ihfAp4,0.25,3,3,CCCAGGTCATCGGGTGCCAA,0,1913272
ihfAp4,0.25,3,3,CCCAGGAAGGGTTACTATTG,0,1913235
ihfAp4,0.25,3,3,CCCAGACGGACGAGTTTAGT,0,1923950
ihfAp4,0.25,3,3,CCCACCCTAATTGAAATCCG,0,1911675
ihfAp4,0.25,3,3,CCATGCCCCCCTATGTGAAA,0,1917422
ihfAp4,0.25,3,3,CCATCGCTTGGAGCAGGTTG,0,1912907
ihfAp4,0.25,3,3,CCAGTCAAGGCCTTGGATGT,0,1953026
ihfAp4,0.25,3,3,CCAGTATCCAAACCACTACG,0,1917944
ihfAp4,0.25,3,3,CCAGTAAAGGGTGTATAATT,0,1944140
ihfAp4,0.25,3,3,CCAGGCTGGGTCAAATTGCA,0,1949493
ihfAp4,0.25,3,3,CCAGCATGTCTTTAGCAGAT,0,1911829
ihfAp4,0.25,3,3,CCAGACTTTGCCCGAGTTCA,0,1922277
ihfAp4,0.25,3,3,CCACCGAAAGAGACGGGGCG,0,1924078
ihfAp4,0.25,3,3,CCACATCGCATGAAACCTTA,0,1954885
ihfAp4,0.25,3,3,CCAAGGATATGGTTTTAACA,0,1924811
ihfAp4,0.25,3,3,CCAAGAGAGGTCTGCGCGGT,0,1926247
ihfAp4,0.25,3,3,CCAACTCTTGACTAGACGTA,0,1951733
ihfAp4,0.25,3,3,CCAAAGCGCCGCAGTGCAAT,0,1949377
ihfAp4,0.25,3,3,CCAAAAAGCCTTTGTGTCCG,0,1928724
ihfAp4,0.25,3,3,CATTCGACTCTGCATTCTCA,0,1937445
ihfAp4,0.25,3,3,CATTCCTTATGTTTGGGAGG,0,1930450
ihfAp4,0.25,3,3,CATTCCTAAAGTCCGGGTTT,0,1913315
ihfAp4,0.25,3,3,CATTCATTATGGAGTCGCCC,0,1928402
ihfAp4,0.25,3,3,CATGGTAGATACAAATAGGT,0,1912012
ihfAp4,0.25,3,3,CATGCGCGGCCGCGGAAACT,0,1954672
ihfAp4,0.25,3,3,CATCGTCCCCGGCCCGCTCG,0,1941105
ihfAp4,0.25,3,3,CATCATATATGGCCCGGACT,0,1918973
ihfAp4,0.25,3,3,CATCACCCCACCCACGAGTC,0,1960537
ihfAp4,0.25,3,3,CATATAGAAGTTCCGGCAAC,0,1927388
ihfAp4,0.25,3,3,CATAGGTAGCCTGCACTTAT,0,1910046
ihfAp4,0.25,3,3,CATAGGAGGGCTCTATGACG,0,1931707
ihfAp4,0.25,3,3,CATAGCCTTTGCATCATTTG,0,1916888
ihfAp4,0.25,3,3,CATAGCCTCGGGGTATGCTT,0,1932548
ihfAp4,0.25,3,3,CATACGCCTTTCATTATGGC,0,1932407
ihfAp4,0.25,3,3,CATACAGAGTCGAGGACGTG,0,1919753
ihfAp4,0.25,3,3,CATACACTAAGAGTGAACGG,0,1927179
ihfAp4,0.25,3,3,CAGTATTAATTTCCAGTCTG,0,1915314
ihfAp4,0.25,3,3,CAGTATGGTGGGGAGACTTA,0,1926538
ihfAp4,0.25,3,3,CAGGGGCGCTAAGACACGTA,0,1934545
ihfAp4,0.25,3,3,CAGGCGCGCGGACGCGTGTT,0,1926550
ihfAp4,0.25,3,3,CAGGATTTTAGGTGCAAACC,0,1920340
ihfAp4,0.25,3,3,CAGGATAGGCTCCACTAAGT,0,1942016
ihfAp4,0.25,3,3,CAGGACGAGACGACACTATT,0,1940473
ihfAp4,0.25,3,3,CAGCTCTGTTAAAGGTGTTA,0,1944755
ihfAp4,0.25,3,3,CAGCGAAAGGTACAGGCCTC,0,1924490
ihfAp4,0.25,3,3,CAGCCTCTAATTACCAGGCC,0,1917644
ihfAp4,0.25,3,3,CAGCCGTTGTACGGACGATG,0,1910278
ihfAp4,0.25,3,3,CAGCAGCAGCTTCCTGGGAA,0,1946357
ihfAp4,0.25,3,3,CAGCAGAAGAGTAAGCTTTA,0,1962307
ihfAp4,0.25,3,3,CAGATTGAAGGTGTCCCATA,0,1927347
ihfAp4,0.25,3,3,CAGATACCCCCATTTCGTAT,0,1959427
ihfAp4,0.25,3,3,CAGAGTTATGAAAACGACGG,0,1911562
ihfAp4,0.25,3,3,CAGACAAGATTCCGCGAAAC,0,1953342
ihfAp4,0.25,3,3,CAGAAGGGAGCACAGTGGTC,0,1952273
ihfAp4,0.25,3,3,CACTTGGCCAAACTGTTTCT,0,1932347
ihfAp4,0.25,3,3,CACTGATAGCCTAAGTCCAA,0,1914003
ihfAp4,0.25,3,3,CACTCGTTTACGTAAGACGC,0,1951912
ihfAp4,0.25,3,3,CACTCGGTATGAAGATAACT,0,1924225
ihfAp4,0.25,3,3,CACTACATGATGCATGGAAC,0,1955253
ihfAp4,0.25,3,3,CACGTTTTCCCGTCAAAGAA,0,1953262
ihfAp4,0.25,3,3,CACGGAAGCGCTAAAAGCCC,0,1926861
ihfAp4,0.25,3,3,CACGGAAAAGAGACTTCGGA,0,1928272
ihfAp4,0.25,3,3,CACGCCTTGATACTCCACTA,0,1949371
ihfAp4,0.25,3,3,CACGCCTCCTAATCCTAAGG,0,1911535
ihfAp4,0.25,3,3,CACGACCAAGTATCATGCTG,0,1955933
ihfAp4,0.25,3,3,CACGAAGTGTCTGTGCGACA,0,1921944
ihfAp4,0.25,3,3,CACGAAGCAAATGACACACA,0,1928793
ihfAp4,0.25,3,3,CACCTCGAGCCAAAAAGAGT,0,1946263
ihfAp4,0.25,3,3,CACCGTCCACGCGAAAACCC,0,1921035
ihfAp4,0.25,3,3,CACCGTACAGCGTCACCGGA,0,1933652
ihfAp4,0.25,3,3,CACCGGACCTAACGCTGCTA,0,1943008
ihfAp4,0.25,3,3,CACCCTCGACTTAAGACGTC,0,1949674
ihfAp4,0.25,3,3,CACCAGCCTATTAGTAAGTG,0,1930448
ihfAp4,0.25,3,3,CACAGTCCAAAGCGGTCCTC,0,1931816
ihfAp4,0.25,3,3,CACAGGACAATCAGTCACAC,0,1951727
ihfAp4,0.25,3,3,CACAGCTTGTAATATCACGG,0,1910009
ihfAp4,0.25,3,3,CACAATCGTATAAGTGCCTA,0,1938354
ihfAp4,0.25,3,3,CACAACTCCAAGGATTCATA,0,1909719
ihfAp4,0.25,3,3,CAATTTTGAGCACCAAACTC,0,1938585
ihfAp4,0.25,3,3,CAATTGGCGGAAAGGAAGTA,0,1931249
ihfAp4,0.25,3,3,CAATTAGAGCACGACCATAT,0,1936244
ihfAp4,0.25,3,3,CAATGGCTTAGACTAGTTTG,0,1921268
ihfAp4,0.25,3,3,CAATGAGGCATCTGACTCGT,0,1946971
ihfAp4,0.25,3,3,CAATCCGTTCAACCGCAGCC,0,1961623
ihfAp4,0.25,3,3,CAATCCAGGGAATCGCGTCA,0,1939629
ihfAp4,0.25,3,3,CAATATCTGGTATGCGCAAC,0,1934275
ihfAp4,0.25,3,3,CAAGTGCCTCTCTTTGGAGT,0,1953606
ihfAp4,0.25,3,3,CAAGTCATTGGTCAACGTTG,0,1929717
ihfAp4,0.25,3,3,CAAGCTCAGCCGCAGGGAGG,0,1956317
ihfAp4,0.25,3,3,CAAGAATTCGTTACTGGAAT,0,1915980
ihfAp4,0.25,3,3,CAACGGAGAAAGTGTGCCGC,0,1952448
ihfAp4,0.25,3,3,CAACGGACCTTGATGGTAAT,0,1911807
ihfAp4,0.25,3,3,CAACCGCACTCCGTGTCATC,0,1939863
ihfAp4,0.25,3,3,CAACCCGTCACCTGTTCACA,0,1913722
ihfAp4,0.25,3,3,CAACAGAGGGAGCAATGATC,0,1923556
ihfAp4,0.25,3,3,CAAATATTTGTAATTTACAA,0,1944491
ihfAp4,0.25,3,3,CAAAGGGTTAAATAGCCCTT,0,1929343
ihfAp4,0.25,3,3,CAAACCTTGGGTTTCCCCCC,0,1955055
ihfAp4,0.25,3,3,CAAAACGGTAAAATACGTGA,0,1932325
ihfAp4,0.25,3,3,CAAAACACTGGATAAGTCTA,0,1921503
ihfAp4,0.25,3,3,ATTTTGAATTCGTGAGCAAG,0,1952176
ihfAp4,0.25,3,3,ATTTGGTCGGCGAAATGGAT,0,1959538
ihfAp4,0.25,3,3,ATTTGCGAAGTGGCTAGCCA,0,1943308
ihfAp4,0.25,3,3,ATTTAGGTGGGTTCTTTTGT,0,1917958
ihfAp4,0.25,3,3,ATTGTGGTATGGGAGGCAGA,0,1938797
ihfAp4,0.25,3,3,ATTGTGGAGGTGTCGCATGG,0,1939139
ihfAp4,0.25,3,3,ATTGTACTTTATTGAAGAAG,0,1919345
ihfAp4,0.25,3,3,ATTGGAGACATTGAGGTGGT,0,1953002
ihfAp4,0.25,3,3,ATTGCGTGCACAACTGCCAA,0,1944111
ihfAp4,0.25,3,3,ATTGAGGTCGTGGCGTGATA,0,1927089
ihfAp4,0.25,3,3,ATTGACGTAGACGGGAGCAA,0,1918893
ihfAp4,0.25,3,3,ATTCTCTCGTGGTGGACATT,0,1929421
ihfAp4,0.25,3,3,ATTCGGGGTGATATCTTCTG,0,1912547
ihfAp4,0.25,3,3,ATTCGCGAAAGTTGGTCCGG,0,1961536
ihfAp4,0.25,3,3,ATTCCGTGAATCTATACCTC,0,1953672
ihfAp4,0.25,3,3,ATTCCAACAATGATGGATTA,0,1953206
ihfAp4,0.25,3,3,ATTCATTGCCTGGTACTACT,0,1942079
ihfAp4,0.25,3,3,ATTAGGTGTTAGCGCGCCTC,0,1923898
ihfAp4,0.25,3,3,ATTAGGAGGAAGGCCGCAGA,0,1929685
ihfAp4,0.25,3,3,ATTAGAGAAGTCCCTCAGCT,0,1928625
ihfAp4,0.25,3,3,ATTAAGCGACTTAGAGGGTG,0,1940676
ihfAp4,0.25,3,3,ATTAAAAGGCTAACCCATAT,0,1932352
ihfAp4,0.25,3,3,ATGTGTCATGTGAATTCATA,0,1948626
ihfAp4,0.25,3,3,ATGTCTCGGAGGAAGAGTAG,0,1956383
ihfAp4,0.25,3,3,ATGTAGAGGTGATATATGAA,0,1931247
ihfAp4,0.25,3,3,ATGGGGGATGGTCTGAGCGG,0,1946030
ihfAp4,0.25,3,3,ATGGCAGTAACACTTTTAGA,0,1935613
ihfAp4,0.25,3,3,ATGGAGACCCAAGACAAGAG,0,1922457
ihfAp4,0.25,3,3,ATGGAAACCGTTACCCATGA,0,1944184
ihfAp4,0.25,3,3,ATGCCCCGTATATGAAGTGA,0,1917970
ihfAp4,0.25,3,3,ATGATTATCCGGGGACATAG,0,1927721
ihfAp4,0.25,3,3,ATGATTAGGGCGGGACCAGT,0,1958369
ihfAp4,0.25,3,3,ATGATTAGCAGACCCGACCT,0,1942484
ihfAp4,0.25,3,3,ATGATGAGTAGCGCTACTGT,0,1950173
ihfAp4,0.25,3,3,ATGATCGAGGATCGCCGGGA,0,1941461
ihfAp4,0.25,3,3,ATGAACATGCGTTAACTTTA,0,1916188
ihfAp4,0.25,3,3,ATCTTTGGAAGCCTACTGGG,0,1940514
ihfAp4,0.25,3,3,ATCTTATCCAGCGGGTGTAC,0,1936356
ihfAp4,0.25,3,3,ATCTGTCGATTGTAGTATAC,0,1954631
ihfAp4,0.25,3,3,ATCTGGTTAGTCACACGGTG,0,1927496
ihfAp4,0.25,3,3,ATCTGAGGTCTGTTGTTCCC,0,1939437
ihfAp4,0.25,3,3,ATCGGTTGGGGGAGGACGTT,0,1950335
ihfAp4,0.25,3,3,ATCGCTGGCCTTTTCGTCTG,0,1941240
ihfAp4,0.25,3,3,ATCCGATGGATTCCATGTAC,0,1951205
ihfAp4,0.25,3,3,ATCCCGTTTACACGGCAATA,0,1912983
ihfAp4,0.25,3,3,ATCCCACGGCATGAGCCTAG,0,1948557
ihfAp4,0.25,3,3,ATCCAGGGTTAACCACCATT,0,1955370
ihfAp4,0.25,3,3,ATCCAGAATATGGGAGCTAT,0,1923122
ihfAp4,0.25,3,3,ATCAGCGCTGTGTAGATTCA,0,1949609
ihfAp4,0.25,3,3,ATCACATAACCATTTCGCGA,0,1924012
ihfAp4,0.25,3,3,ATCAAATATGTTACTTAATG,0,1939249
ihfAp4,0.25,3,3,ATCAAACGTCACCCCCGGAC,0,1941909
ihfAp4,0.25,3,3,ATCAAAAACATTAGATGTAC,0,1937581
ihfAp4,0.25,3,3,ATATGTGCAAAAGGCCGGTG,0,1932982
ihfAp4,0.25,3,3,ATATGCCGAGCGTAATCTTC,0,1937289
ihfAp4,0.25,3,3,ATATCTGGCCATTTGTAGTC,0,1955165
ihfAp4,0.25,3,3,ATATCGATAAATCATCGGAT,0,1912245
ihfAp4,0.25,3,3,ATAGTAGTACTCTGACACTT,0,1931212
ihfAp4,0.25,3,3,ATAGGAGGGTAGTTCTCAAC,0,1940584
ihfAp4,0.25,3,3,ATAGAACTGTGTCAATATGA,0,1934405
ihfAp4,0.25,3,3,ATACTCGTTTCCGTGACTCT,0,1911716
ihfAp4,0.25,3,3,ATACTAAGGAATTCCGGCTC,0,1939738
ihfAp4,0.25,3,3,ATACGTTTTGGTCAACTTAA,0,1925726
ihfAp4,0.25,3,3,ATACGTAGGATGTGAGCAGG,0,1957681
ihfAp4,0.25,3,3,ATACACGTCGCTAAACCCTC,0,1922862
ihfAp4,0.25,3,3,ATACAAACGTCTCTGCGCTC,0,1929367
ihfAp4,0.25,3,3,ATAATCCAGAATAAACAAAC,0,1911869
ihfAp4,0.25,3,3,ATAAGGCAGGAACAGAGAAC,0,1922717
ihfAp4,0.25,3,3,ATAACACGGCGTCATTGCGA,0,1915285
ihfAp4,0.25,3,3,ATAAACACCTTAGAACGTAG,0,1918859
ihfAp4,0.25,3,3,ATAAAATTGACGCCACGCCC,0,1938501
ihfAp4,0.25,3,3,AGTTTTGTTTACTGTGCTGT,0,1926526
ihfAp4,0.25,3,3,AGTTTGGAACCGCACATGCA,0,1934345
ihfAp4,0.25,3,3,AGTTTATGTCTGAACCGACG,0,1916358
ihfAp4,0.25,3,3,AGTTGGCAAAAAGTAGGATT,0,1920353
ihfAp4,0.25,3,3,AGTTCGCAAGAGCGACTACA,0,1937476
ihfAp4,0.25,3,3,AGTTAGGGTGCGATGTGGAT,0,1929285
ihfAp4,0.25,3,3,AGTTAGGGGGGGATGTATGA,0,1945587
ihfAp4,0.25,3,3,AGTTAAGATATGGATGGGTA,0,1919920
ihfAp4,0.25,3,3,AGTTAAGAAAAAACGCAGAG,0,1932938
ihfAp4,0.25,3,3,AGTGTACGGAGGCCTGAGGA,0,1937440
ihfAp4,0.25,3,3,AGTGGTGCGTGGAGCACTAA,0,1952493
ihfAp4,0.25,3,3,AGTGGTGATATTCGGGATGC,0,1918540
ihfAp4,0.25,3,3,AGTGGCGGGCATGCCGCCGT,0,1914720
ihfAp4,0.25,3,3,AGTGCTATGTGGTTTACGAC,0,1913106
ihfAp4,0.25,3,3,AGTGATGCTATGAGGTGGTA,0,1952993
ihfAp4,0.25,3,3,AGTGAAGGCATTTGAAAAAG,0,1931341
ihfAp4,0.25,3,3,AGTCTGGTGGGTATGTTTTG,0,1944157
ihfAp4,0.25,3,3,AGTCGGTAAGTTGCCAAGTC,0,1944148
ihfAp4,0.25,3,3,AGTCGGCCACGTTTTGATTG,0,1931006
ihfAp4,0.25,3,3,AGTCCTGGTCCACGAAGTCG,0,1960806
ihfAp4,0.25,3,3,AGTCCGTCTCCGCCCCCCGA,0,1920933
ihfAp4,0.25,3,3,AGTCCGCGGTATGAAATCAC,0,1917758
ihfAp4,0.25,3,3,AGTCCCGCCTAAGATCACGA,0,1940525
ihfAp4,0.25,3,3,AGTCAGGAGCTATGTACACG,0,1911635
ihfAp4,0.25,3,3,AGTATGCCGCATAGAGGAAC,0,1942996
ihfAp4,0.25,3,3,AGTAGAACTTAGTCACCTTC,0,1920944
ihfAp4,0.25,3,3,AGGTTGGTTTGTCTTCGTAT,0,1925863
ihfAp4,0.25,3,3,AGGTTACAGCGCTTAAGCAT,0,1952559
ihfAp4,0.25,3,3,AGGTGTTCAACGCATACCCT,0,1929934
ihfAp4,0.25,3,3,AGGTGAGGGTTGGATAGCTA,0,1911060
ihfAp4,0.25,3,3,AGGTGAACTGGGGACACAGT,0,1911341
ihfAp4,0.25,3,3,AGGGTTTCTCAATCTGCTAG,0,1949301
ihfAp4,0.25,3,3,AGGGTAGGGGCGTAGTAAGA,0,1931610
ihfAp4,0.25,3,3,AGGGGGCACAGGAAATCTGT,0,1936127
ihfAp4,0.25,3,3,AGGGGGCACACATCTTATGA,0,1924315
ihfAp4,0.25,3,3,AGGGGATCTCATAGCAACGC,0,1924589
ihfAp4,0.25,3,3,AGGGCACACATCACGTACCT,0,1952719
ihfAp4,0.25,3,3,AGGCTTTTTTGCCTGTGAAC,0,1952182
ihfAp4,0.25,3,3,AGGCTCCTAGGTAAGTCAAT,0,1925480
ihfAp4,0.25,3,3,AGGCGTGGTCCCCTGGGTAT,0,1911495
ihfAp4,0.25,3,3,AGGCGCATGCTAAACGCTGT,0,1945763
ihfAp4,0.25,3,3,AGGCCTCTAGCAAAAAATGC,0,1956271
ihfAp4,0.25,3,3,AGGCCCCCGTGAAATGTATC,0,1910126
ihfAp4,0.25,3,3,AGGCATTCTTTGATACTCGG,0,1936594
ihfAp4,0.25,3,3,AGGATCGCGGCGGGGGAGGG,0,1910713
ihfAp4,0.25,3,3,AGGAGGATTTTTGTATATTA,0,1920121
ihfAp4,0.25,3,3,AGGACACGGACTATATTGAG,0,1949313
ihfAp4,0.25,3,3,AGGAAGCTCGATATACAAAC,0,1952302
ihfAp4,0.25,3,3,AGCTTTGGGATGATCCCAGG,0,1927314
ihfAp4,0.25,3,3,AGCTTTACCTCGTGGAGGAT,0,1911215
ihfAp4,0.25,3,3,AGCTTGAGCGAGCTAGATAC,0,1934669
ihfAp4,0.25,3,3,AGCTCTTTTCAAACCCTGAT,0,1955202
ihfAp4,0.25,3,3,AGCTCCTGCGGTTGGCTCAG,0,1946489
ihfAp4,0.25,3,3,AGCTCAGAGTTAACTGGCCC,0,1941532
ihfAp4,0.25,3,3,AGCTAGGAGCGAAGAATATC,0,1928125
ihfAp4,0.25,3,3,AGCTAGCATTCACTGTGTAG,0,1914067
ihfAp4,0.25,3,3,AGCTACAAACTCGACAGAGA,0,1938649
ihfAp4,0.25,3,3,AGCGTTCTTAAGCCACGGTC,0,1933106
ihfAp4,0.25,3,3,AGCGCAAGGTTCACCAAAAC,0,1927432
ihfAp4,0.25,3,3,AGCGATGGGTTGGTCCTTTG,0,1945480
ihfAp4,0.25,3,3,AGCCCTTTCATGTATACTGC,0,1917781
ihfAp4,0.25,3,3,AGCCATGTGAATACAGATGT,0,1938626
ihfAp4,0.25,3,3,AGCCATGAATGGGTTAGGGA,0,1926753
ihfAp4,0.25,3,3,AGCCACAACGCAATATTGAA,0,1916041
ihfAp4,0.25,3,3,AGCCAATATTCGTGGGGGTT,0,1949219
ihfAp4,0.25,3,3,AGCCAAAAAGGGTTATTTAC,0,1952476
ihfAp4,0.25,3,3,AGCATGAAAGCAAGGCGGTT,0,1910950
ihfAp4,0.25,3,3,AGCATAATGTCAAGGCTAGT,0,1933825
ihfAp4,0.25,3,3,AGCAGCTGGGGGCATACGTT,0,1922207
ihfAp4,0.25,3,3,AGCAATGCGGCACAGCTAGT,0,1917262
ihfAp4,0.25,3,3,AGCAATAGCGTACACTATTG,0,1928179
ihfAp4,0.25,3,3,AGATTTATAGCATGACCCTC,0,1923186
ihfAp4,0.25,3,3,AGATTTAATCTAGTATTAGG,0,1916687
ihfAp4,0.25,3,3,AGATTTAAGTGAAGGTAGTG,0,1913954
ihfAp4,0.25,3,3,AGATGTGCATCTAACACGCA,0,1921028
ihfAp4,0.25,3,3,AGATCTGTCGGTGTTTCCGT,0,1948699
ihfAp4,0.25,3,3,AGATCGCAGAAGGTCAGTAA,0,1914277
ihfAp4,0.25,3,3,AGATCCATTAGGATCATAAT,0,1923256
ihfAp4,0.25,3,3,AGAGTCCGCTGCTCGGCCGT,0,1922199
ihfAp4,0.25,3,3,AGAGAGCAAACCTAAGCGGA,0,1927139
ihfAp4,0.25,3,3,AGAGAAGGCGGTCGGGCTAA,0,1956877
ihfAp4,0.25,3,3,AGACTAAGTTCGTCCCCATG,0,1946788
ihfAp4,0.25,3,3,AGACGGGTGAAAACGACTAA,0,1954626
ihfAp4,0.25,3,3,AGACGGGAACCATTCCACCT,0,1941311
ihfAp4,0.25,3,3,AGACGCGCTTCATACAAGCA,0,1912968
ihfAp4,0.25,3,3,AGAATGTACTTCCACCAAGT,0,1924347
ihfAp4,0.25,3,3,AGAAGTCCACAGGAGCCTAA,0,1936175
ihfAp4,0.25,3,3,AGAAGCGTTTTCGGTATCCA,0,1919519
ihfAp4,0.25,3,3,AGAACGGCTGTCTTGCTGTG,0,1926795
ihfAp4,0.25,3,3,AGAACCCCTGTTGGTTCGTC,0,1956535
ihfAp4,0.25,3,3,AGAAAGGTCACGCGTCCAGA,0,1921106
ihfAp4,0.25,3,3,ACTTTTCGGTGGAATGTGTT,0,1914064
ihfAp4,0.25,3,3,ACTTTACAACAGTCTACCTT,0,1920675
ihfAp4,0.25,3,3,ACTTGTATTTAAACTAGAGA,0,1922273
ihfAp4,0.25,3,3,ACTTGTAGACTCAGACGCGA,0,1918766
ihfAp4,0.25,3,3,ACTTGCCTATGTCGCTTAAG,0,1914049
ihfAp4,0.25,3,3,ACTTCTGGTGTTGTGAACCG,0,1927874
ihfAp4,0.25,3,3,ACTTCGTTAAGGCATAGACA,0,1954547
ihfAp4,0.25,3,3,ACTTCCGGTTTCCGAATTAC,0,1945567
ihfAp4,0.25,3,3,ACTGGGCGCAACTACAGCCA,0,1928776
ihfAp4,0.25,3,3,ACTGATACAAGTCAGTCCGT,0,1927830
ihfAp4,0.25,3,3,ACTCTTTCTTTATAACTGAT,0,1942065
ihfAp4,0.25,3,3,ACTCTCCGGAGAAGTGGTTT,0,1958828
ihfAp4,0.25,3,3,ACTCGGTAACTGTCAGTCAA,0,1942282
ihfAp4,0.25,3,3,ACTCCCCGCCCATACTGGCA,0,1946166
ihfAp4,0.25,3,3,ACTCCCCCCTTGATGGTTCC,0,1933904
ihfAp4,0.25,3,3,ACTCAGGATCTCCGTCGCAG,0,1935564
ihfAp4,0.25,3,3,ACTCACTAGAGATCAATGCG,0,1934014
ihfAp4,0.25,3,3,ACTATGTGTGCGGTTGGAAT,0,1933832
ihfAp4,0.25,3,3,ACTAGGCGGAAACTCAGGTT,0,1947552
ihfAp4,0.25,3,3,ACTACCGATTCTGAGCACGT,0,1951136
ihfAp4,0.25,3,3,ACTAAGGTCCCGCTCACAAA,0,1947270
ihfAp4,0.25,3,3,ACGTTTTGAGGCATGACAGA,0,1942720
ihfAp4,0.25,3,3,ACGTTTGTGTGGTGTCTGGC,0,1959710
ihfAp4,0.25,3,3,ACGTTAATCTTTGGCGGCGA,0,1910265
ihfAp4,0.25,3,3,ACGTTAAAGGTCTGTATAGA,0,1950933
ihfAp4,0.25,3,3,ACGTCTCCATCCGTTTTGCC,0,1953573
ihfAp4,0.25,3,3,ACGTCCGTGGGAGTATCTGG,0,1931209
ihfAp4,0.25,3,3,ACGTCAACACTTCGAGCGGA,0,1922757
ihfAp4,0.25,3,3,ACGGTCATTGATGTTATGCG,0,1925455
ihfAp4,0.25,3,3,ACGGGCTACGTAAAGAATGG,0,1926297
ihfAp4,0.25,3,3,ACGGAGTACCAGGGTGCATC,0,1954389
ihfAp4,0.25,3,3,ACGCATATTTAAAGGCTCTG,0,1952849
ihfAp4,0.25,3,3,ACGCAAGTTGAGATGCAGAG,0,1947885
ihfAp4,0.25,3,3,ACGCAAACCGTTCGCTGAGT,0,1953360
ihfAp4,0.25,3,3,ACGATAGACGGGCGACCTGT,0,1912870
ihfAp4,0.25,3,3,ACGAGCCTGAGAATAGTCTT,0,1919013
ihfAp4,0.25,3,3,ACGAATAGCGCGGAGCAATC,0,1913048
ihfAp4,0.25,3,3,ACGAACATTAGCGTCGTCAG,0,1948486
ihfAp4,0.25,3,3,ACCTTGGGCTTGGGCGGAAA,0,1912839
ihfAp4,0.25,3,3,ACCTGGGCTTTCTGTCGTTA,0,1956093
ihfAp4,0.25,3,3,ACCTGCCGCGTACATCCTGG,0,1948581
ihfAp4,0.25,3,3,ACCTAGTCCCTTTCATTAAC,0,1949776
ihfAp4,0.25,3,3,ACCTAACTATGATCTGGTAA,0,1948101
ihfAp4,0.25,3,3,ACCGTTACAGATGTGGTAGC,0,1951045
ihfAp4,0.25,3,3,ACCGTGGTAAGGCTGCAGGC,0,1914065
ihfAp4,0.25,3,3,ACCGTCCCTTCGTCTCTGTA,0,1950480
ihfAp4,0.25,3,3,ACCGGGCGGTCGGAGGCTGA,0,1924859
ihfAp4,0.25,3,3,ACCGGAGCACCGCCGGGGAC,0,1932113
ihfAp4,0.25,3,3,ACCGGACCGACAGTGCCCCC,0,1918369
ihfAp4,0.25,3,3,ACCGGACATGGTGTACGTAA,0,1910450
ihfAp4,0.25,3,3,ACCCTGGTCAATTAGACATT,0,1939737
ihfAp4,0.25,3,3,ACCCTCAGAGAGTTGAGTTG,0,1913283
ihfAp4,0.25,3,3,ACCCGTGTCCTCTTCGCGGT,0,1919469
ihfAp4,0.25,3,3,ACCCGTGGTCCCCGGTGCTT,0,1936769
ihfAp4,0.25,3,3,ACCCCGTTTACGACCTTATT,0,1911213
ihfAp4,0.25,3,3,ACCCCGTGTTCTAGTTAGGG,0,1925999
ihfAp4,0.25,3,3,ACCCCCCAGACGTTGATAGG,0,1954664
ihfAp4,0.25,3,3,ACCCCATAACTAACGATCCT,0,1913891
ihfAp4,0.25,3,3,ACCCATGTCTCGTTTGGGCA,0,1955160
ihfAp4,0.25,3,3,ACCATTCTATCGGGAGTCTC,0,1930214
ihfAp4,0.25,3,3,ACCATAGCTTAATCTGCGAG,0,1952572
ihfAp4,0.25,3,3,ACCAGTCACGGAACTCAGCT,0,1929780
ihfAp4,0.25,3,3,ACCAGTATCGTCATTTTGAC,0,1942385
ihfAp4,0.25,3,3,ACCAGGGAACCAAATCCATA,0,1957523
ihfAp4,0.25,3,3,ACCAGCGTCAGTAGATCATG,0,1919521
ihfAp4,0.25,3,3,ACCACTTTCTTAGCCATTCT,0,1921922
ihfAp4,0.25,3,3,ACCAATGAACTTTATGCGTA,0,1917280
ihfAp4,0.25,3,3,ACCAACCCATTCAGCCTTTT,0,1953291
ihfAp4,0.25,3,3,ACATTACGGCTAGGGCAGAT,0,1919651
ihfAp4,0.25,3,3,ACATGCATGTTCTGCATCAC,0,1920725
ihfAp4,0.25,3,3,ACATCCCTGGGTATTAGAGC,0,1937238
ihfAp4,0.25,3,3,ACATCAGCCGTCGTGGAAAA,0,1949855
ihfAp4,0.25,3,3,ACATAATAAGCACACACCTT,0,1943142
ihfAp4,0.25,3,3,ACAGAGGACCAGCCGCGATG,0,1960464
ihfAp4,0.25,3,3,ACACTTCTAGCGGCGCGGTG,0,1949575
ihfAp4,0.25,3,3,ACACTCTGATAAAATCTGTT,0,1933139
ihfAp4,0.25,3,3,ACACCGCAGGATGGGTAATG,0,1936156
ihfAp4,0.25,3,3,ACACCCCGATGATGCGGAGA,0,1949112
ihfAp4,0.25,3,3,ACACAAGGACTACTTTGATT,0,1956376
ihfAp4,0.25,3,3,ACAATCTCGACACTCATCGT,0,1917458
ihfAp4,0.25,3,3,ACAAGATTCATAGGGTAAAA,0,1940245
ihfAp4,0.25,3,3,ACAACGCTATGCCACTCAGA,0,1958230
ihfAp4,0.25,3,3,ACAACCGTTCTTAATGGTCA,0,1959203
ihfAp4,0.25,3,3,ACAACATAACGAGGGCGGTG,0,1957301
ihfAp4,0.25,3,3,ACAAATAAGACACAATGAGT,0,1932452
ihfAp4,0.25,3,3,ACAAAGAACACGACACCGAT,0,1910533
ihfAp4,0.25,3,3,AATTGAGTAACTACTTCGGC,0,1935110
ihfAp4,0.25,3,3,AATTCGACGCCGATCCTAAC,0,1943826
ihfAp4,0.25,3,3,AATTATTTGTTAGGATATTG,0,1911794
ihfAp4,0.25,3,3,AATTATGCTCTCTCCACAAC,0,1958618
ihfAp4,0.25,3,3,AATTAAGTATACTTTTATTA,0,1941213
ihfAp4,0.25,3,3,AATGTTAAGTAACATTGTGC,0,1924090
ihfAp4,0.25,3,3,AATGTAGTTTACAGACTAGC,0,1925203
ihfAp4,0.25,3,3,AATGGGGCAGTCGGTTCACG,0,1949916
ihfAp4,0.25,3,3,AATGGCTAGCGCGGGCAGAC,0,1946210
ihfAp4,0.25,3,3,AATGGACCCGCAGCACAAAG,0,1952486
ihfAp4,0.25,3,3,AATGGAAAAACGATCCGGCA,0,1926351
ihfAp4,0.25,3,3,AATGCTAGCGTGTAGGCGCG,0,1930515
ihfAp4,0.25,3,3,AATGCGGTCACGGTAGTTCT,0,1941940
ihfAp4,0.25,3,3,AATGATAGAAGTCCTGGGTT,0,1950844
ihfAp4,0.25,3,3,AATGAAGGCTTCCTCAGGGT,0,1917370
ihfAp4,0.25,3,3,AATCGTAAAAATTAAGCTGT,0,1941588
ihfAp4,0.25,3,3,AATCGCTGCACCATTCCTGC,0,1950873
ihfAp4,0.25,3,3,AATCAGGATCTTTTCCCTCG,0,1909954
ihfAp4,0.25,3,3,AATATTATTGTAACACGTTG,0,1910640
ihfAp4,0.25,3,3,AATATCCGGTCTACTGATAT,0,1946160
ihfAp4,0.25,3,3,AATAGTTGAGGGCCGCAGGA,0,1937583
ihfAp4,0.25,3,3,AATAGGTGGGAATGGATTAT,0,1914051
ihfAp4,0.25,3,3,AATACGGTTCGTACGCAGGT,0,1919099
ihfAp4,0.25,3,3,AATACATCACAACATATCGT,0,1952636
ihfAp4,0.25,3,3,AATAACGTCGCTCCGGCTGG,0,1942603
ihfAp4,0.25,3,3,AAGTTCCACCGAGCACGGTG,0,1915443
ihfAp4,0.25,3,3,AAGTGTAAGCAAGCTATCAT,0,1921695
ihfAp4,0.25,3,3,AAGTGGGAAAGGCGGAATCG,0,1942701
ihfAp4,0.25,3,3,AAGTGAGTCTGCTTGCAAGA,0,1931135
ihfAp4,0.25,3,3,AAGGTCATCAGGAATCCACG,0,1913268
ihfAp4,0.25,3,3,AAGGGTACAAGTTAGTGGAA,0,1928690
ihfAp4,0.25,3,3,AAGGGGCTGGCGCCCTCCCA,0,1923529
ihfAp4,0.25,3,3,AAGGGCAAAGCACATACAGA,0,1925705
ihfAp4,0.25,3,3,AAGGCAGAGACGGGTTTGAG,0,1922234
ihfAp4,0.25,3,3,AAGGCACTACGGACACAATA,0,1945328
ihfAp4,0.25,3,3,AAGGAGGCATAAGCTCTGCG,0,1948062
ihfAp4,0.25,3,3,AAGCTCATCCTTAAGGTATG,0,1918826
ihfAp4,0.25,3,3,AAGCGGCCCAAAAGTATTGA,0,1951120
ihfAp4,0.25,3,3,AAGCCGGTCTCTCCACATTA,0,1948478
ihfAp4,0.25,3,3,AAGCCCGGCCAGTAGAATTC,0,1933818
ihfAp4,0.25,3,3,AAGCAACTATCAATCGTGTT,0,1911072
ihfAp4,0.25,3,3,AAGATGGGGACCTTAACACT,0,1915305
ihfAp4,0.25,3,3,AAGAGTCTAGTGATCTTGAA,0,1943127
ihfAp4,0.25,3,3,AAGAGATGCGCTGGAGATCA,0,1949413
ihfAp4,0.25,3,3,AAGAGAACGATGTAAGTGCC,0,1926518
ihfAp4,0.25,3,3,AAGACTGCGTACTACCGGTT,0,1923707
ihfAp4,0.25,3,3,AAGAACACAACTTGACGTTA,0,1920555
ihfAp4,0.25,3,3,AACTCGTTTGCCACGGGCTT,0,1940772
ihfAp4,0.25,3,3,AACTCCTTGATTAAGTATAC,0,1959339
ihfAp4,0.25,3,3,AACTATGCACTATGGCAAAG,0,1916379
ihfAp4,0.25,3,3,AACTAAACCCGATTACCGCA,0,1915743
ihfAp4,0.25,3,3,AACGTAGGTTTATCAAGGAA,0,1925824
ihfAp4,0.25,3,3,AACGTAAGGGAGAAAGGATC,0,1931286
ihfAp4,0.25,3,3,AACGGTCGTTCGGGATCCAC,0,1919069
ihfAp4,0.25,3,3,AACGGGACATCATGTCATAC,0,1930664
ihfAp4,0.25,3,3,AACGGCTAAGGTCATATCAG,0,1928859
ihfAp4,0.25,3,3,AACGATATTGTGTTAATCCT,0,1956649
ihfAp4,0.25,3,3,AACGAGGTCCATTCTAGCTG,0,1914976
ihfAp4,0.25,3,3,AACCGCGGCGCTATATTGAT,0,1930501
ihfAp4,0.25,3,3,AACCGAACAACTGGCAACAA,0,1937869
ihfAp4,0.25,3,3,AACCCGCGGAGATATAGAAC,0,1954418
ihfAp4,0.25,3,3,AACCATAACAAGAGCAGGTC,0,1946454
ihfAp4,0.25,3,3,AACCACTCGAACCAGATGCT,0,1909573
ihfAp4,0.25,3,3,AACCACGCAGCGTGGAAGTC,0,1942330
ihfAp4,0.25,3,3,AACATCGAGCTGAAGATAAA,0,1951994
ihfAp4,0.25,3,3,AACAGTTGTAGTATCATCAT,0,1942014
ihfAp4,0.25,3,3,AACAGGCCAGAGAAGAATTC,0,1954113
ihfAp4,0.25,3,3,AACACCGCCATCAGTGTGAA,0,1910117
ihfAp4,0.25,3,3,AACACCGACTTTTGCATTCT,0,1947016
ihfAp4,0.25,3,3,AACACAGCTCAATGGGTTTC,0,1934856
ihfAp4,0.25,3,3,AACAATATCACTTGAATACA,0,1912426
ihfAp4,0.25,3,3,AAATTTTATATCATTCGCTT,0,1945027
ihfAp4,0.25,3,3,AAATGTACAGAGGAAAAGAG,0,1927980
ihfAp4,0.25,3,3,AAATCACAGTAAACGCGGTT,0,1911393
ihfAp4,0.25,3,3,AAAGACGTCCTCAAGGGGTT,0,1941444
ihfAp4,0.25,3,3,AAACTTGAGACGAGTATGGA,0,1955534
ihfAp4,0.25,3,3,AAACGAAAGTCACCCCGAAC,0,1928185
ihfAp4,0.25,3,3,AAACCCGCGATCGTATGAGG,0,1911822
ihfAp4,0.25,3,3,AAACCCGATGTAAAGGGCTC,0,1951468
ihfAp4,0.25,3,3,AAAATTCGTAACCCGGGCCT,0,1919846
ihfAp4,0.25,3,3,AAAATGGTGCGGCGAGAGTC,0,1941807
ihfAp4,0.25,3,3,AAAATCATTTCTATGAGACC,0,1955107
ihfAp4,0.3333333333333333,2,2,TTTTGCTAGTGTGTATACTT,0,1957572
ihfAp4,0.3333333333333333,2,2,TTTTGAAATGCGTCAAAAAT,0,1940271
ihfAp4,0.3333333333333333,2,2,TTTTCTACCCGACGCTACTA,0,1929155
ihfAp4,0.3333333333333333,2,2,TTTTCACTGCTACGAACGGG,0,1937054
ihfAp4,0.3333333333333333,2,2,TTTTATGGGTCGGGGCACCC,0,1962287
ihfAp4,0.3333333333333333,2,2,TTTGGATGCCGGATGCAGCA,0,1935059
ihfAp4,0.3333333333333333,2,2,TTTGCATTTCGTACTTCCTG,0,1942995
ihfAp4,0.3333333333333333,2,2,TTTGAGATCATGATCTACTT,0,1925376
ihfAp4,0.3333333333333333,2,2,TTTGACCTAGTTAGCGACCC,0,1918637
ihfAp4,0.3333333333333333,2,2,TTTGAATGTGGGGGGGTAGT,0,1919265
ihfAp4,0.3333333333333333,2,2,TTTCGATGTACCCAGATAGG,0,1920548
ihfAp4,0.3333333333333333,2,2,TTTCCTCCATTTAACATATA,0,1959092
ihfAp4,0.3333333333333333,2,2,TTTCCTCCACAGTTCGAAAT,0,1946811
ihfAp4,0.3333333333333333,2,2,TTTCATAGAGCTGGCAGGAG,0,1934583
ihfAp4,0.3333333333333333,2,2,TTTCACCAATAATTAGATGG,0,1915242
ihfAp4,0.3333333333333333,2,2,TTTCAAGACGCCTTCAGCGG,0,1926444
ihfAp4,0.3333333333333333,2,2,TTTATTCCTACTTTTCTTGC,0,1925521
ihfAp4,0.3333333333333333,2,2,TTTATTCCGCGTGCAGGACG,0,1942003
ihfAp4,0.3333333333333333,2,2,TTTATCAAAGGTAGACCTTC,0,1939663
ihfAp4,0.3333333333333333,2,2,TTTAGGTAAGGGCAGTCACG,0,1919132
ihfAp4,0.3333333333333333,2,2,TTTAGGCGACCCGCGGGCAG,0,1945178
ihfAp4,0.3333333333333333,2,2,TTGTTACTATCCTAGTATCT,0,1914172
ihfAp4,0.3333333333333333,2,2,TTGTCGTAGCGAAAATGGTG,0,1935253
ihfAp4,0.3333333333333333,2,2,TTGTCCGGTAATTGACCAGA,0,1939996
ihfAp4,0.3333333333333333,2,2,TTGTCAACCGAGTGCCTCAC,0,1924082
ihfAp4,0.3333333333333333,2,2,TTGTATGAATTAAAGCCCGC,0,1936295
ihfAp4,0.3333333333333333,2,2,TTGGTAGGGACGAAACCGAT,0,1928276
ihfAp4,0.3333333333333333,2,2,TTGGTAGCGGCTTTATTCAA,0,1945937
ihfAp4,0.3333333333333333,2,2,TTGGGTTCAACTACAGCATT,0,1912808
ihfAp4,0.3333333333333333,2,2,TTGGGTACAATCGGATCCGA,0,1936486
ihfAp4,0.3333333333333333,2,2,TTGGGCTTGACTGCTAAGTG,0,1951844
ihfAp4,0.3333333333333333,2,2,TTGGCTTTCAGTTCGAATTG,0,1922302
ihfAp4,0.3333333333333333,2,2,TTGGCTACTTGTGAGCAACC,0,1952417
ihfAp4,0.3333333333333333,2,2,TTGGATGCGAATTACACTTG,0,1936553
ihfAp4,0.3333333333333333,2,2,TTGGAACAAGTGACCTAGTG,0,1932765
ihfAp4,0.3333333333333333,2,2,TTGCTCTCCTCTAGGGTTCG,0,1920890
ihfAp4,0.3333333333333333,2,2,TTGCGCTCTAAGTGTGCAAG,0,1938974
ihfAp4,0.3333333333333333,2,2,TTGCGATTAGTTATGCGGGA,0,1949422
ihfAp4,0.3333333333333333,2,2,TTGCGACGGATACGCTCATA,0,1954616
ihfAp4,0.3333333333333333,2,2,TTGCATCTGGAGGGATAGGT,0,1949110
ihfAp4,0.3333333333333333,2,2,TTGATAGGGACGAGGCGAGC,0,1958905
ihfAp4,0.3333333333333333,2,2,TTGAGCTATGATCCAAAATA,0,1916691
ihfAp4,0.3333333333333333,2,2,TTGAAGGCTCTACGACAACC,0,1957812
ihfAp4,0.3333333333333333,2,2,TTGAAGAATTGAGAGAAATT,0,1954242
ihfAp4,0.3333333333333333,2,2,TTGAACCATGGTTTACGATG,0,1942630
ihfAp4,0.3333333333333333,2,2,TTCTTTGGTGCGCCATCTCT,0,1944957
ihfAp4,0.3333333333333333,2,2,TTCTTTAAAAAAGAGCACTA,0,1956755
ihfAp4,0.3333333333333333,2,2,TTCTTGTAGGCGATAGTTTA,0,1916359
ihfAp4,0.3333333333333333,2,2,TTCTTAGAATTTCGGCCTTA,0,1943352
ihfAp4,0.3333333333333333,2,2,TTCTGTAAAAGTCCGATCCA,0,1961661
ihfAp4,0.3333333333333333,2,2,TTCTCTAGTCAAAAACACCC,0,1913072
ihfAp4,0.3333333333333333,2,2,TTCTATACAGACTGCTAGAG,0,1929011
ihfAp4,0.3333333333333333,2,2,TTCTAATTAGTCTCACTCAC,0,1920173
ihfAp4,0.3333333333333333,2,2,TTCTAAGTGATGTTCGGCCT,0,1931790
ihfAp4,0.3333333333333333,2,2,TTCGTCGGATGTGTGTCGCG,0,1917305
ihfAp4,0.3333333333333333,2,2,TTCGCGGGTAACAAGAGGAC,0,1918927
ihfAp4,0.3333333333333333,2,2,TTCGCGGAGAACATGCGGCA,0,1917068
ihfAp4,0.3333333333333333,2,2,TTCGAGGAAAGGGGCATCGA,0,1927945
ihfAp4,0.3333333333333333,2,2,TTCGAGCCAAGGTTGACAGC,0,1940316
ihfAp4,0.3333333333333333,2,2,TTCGAAATAGACCAGCCCGA,0,1910949
ihfAp4,0.3333333333333333,2,2,TTCCTAACCTCGGTTTTTAA,0,1917535
ihfAp4,0.3333333333333333,2,2,TTCCCGTTCTATGAGGCCTG,0,1929111
ihfAp4,0.3333333333333333,2,2,TTCCAGTAGGATGGGGTTAA,0,1916989
ihfAp4,0.3333333333333333,2,2,TTCATGCATCTTGCCAGAAG,0,1918963
ihfAp4,0.3333333333333333,2,2,TTCATGCAATATCCAGAGAT,0,1951678
ihfAp4,0.3333333333333333,2,2,TTCAGATTTTTGCATAGGTC,0,1947946
ihfAp4,0.3333333333333333,2,2,TTCACGTACTGACACCCCCC,0,1936629
ihfAp4,0.3333333333333333,2,2,TTCACAGCCGACAGCCTGGG,0,1935925
ihfAp4,0.3333333333333333,2,2,TTCAATTTTTTAGAGCAGGA,0,1919395
ihfAp4,0.3333333333333333,2,2,TTCAATTAGATAAGGACCCT,0,1958915
ihfAp4,0.3333333333333333,2,2,TTCAATCCGGAGGGGGCTGC,0,1945310
ihfAp4,0.3333333333333333,2,2,TTCAAGCTCTGGGACTGGCG,0,1944959
ihfAp4,0.3333333333333333,2,2,TTATTTATGTCGGCGGGATG,0,1949543
ihfAp4,0.3333333333333333,2,2,TTATTCTTACACGGTGCCTC,0,1961275
ihfAp4,0.3333333333333333,2,2,TTATTCCAGCAATCAATCGT,0,1920688
ihfAp4,0.3333333333333333,2,2,TTATGGTCTGGTCGAAAAGC,0,1920120
ihfAp4,0.3333333333333333,2,2,TTATGCTTGCGTGAGTGTGG,0,1917813
ihfAp4,0.3333333333333333,2,2,TTATGCACAATCCTGGTCAA,0,1934102
ihfAp4,0.3333333333333333,2,2,TTATCATACTGGCATCTAGA,0,1932159
ihfAp4,0.3333333333333333,2,2,TTATCAACCCTTCGCACAAA,0,1949571
ihfAp4,0.3333333333333333,2,2,TTATATAAACCCCCGTTAGT,0,1923884
ihfAp4,0.3333333333333333,2,2,TTAGTATGTAATCCCTTACA,0,1918802
ihfAp4,0.3333333333333333,2,2,TTAGGTATAAGGAAGGGGAA,0,1916926
ihfAp4,0.3333333333333333,2,2,TTAGCTTTGCAGGGTCTATG,0,1931993
ihfAp4,0.3333333333333333,2,2,TTAGATTGAGTGCGAAGGGT,0,1946451
ihfAp4,0.3333333333333333,2,2,TTAGATTCAACCTTCAGGGG,0,1926676
ihfAp4,0.3333333333333333,2,2,TTAGATCAAGGAAAAGAACG,0,1910985
ihfAp4,0.3333333333333333,2,2,TTAGAGCTGGGCTGTATATT,0,1956247
ihfAp4,0.3333333333333333,2,2,TTACTCTAGCGAATCGGTGC,0,1936863
ihfAp4,0.3333333333333333,2,2,TTACGAACACAAGAGACTCT,0,1957018
ihfAp4,0.3333333333333333,2,2,TTACCTCTCACCACGGGCTT,0,1948427
ihfAp4,0.3333333333333333,2,2,TTACAACTGGAATATAGTTC,0,1917950
ihfAp4,0.3333333333333333,2,2,TTAATAGCTGAATTCTAGTT,0,1954977
ihfAp4,0.3333333333333333,2,2,TTAATAACGTTCCCACTGTA,0,1919413
ihfAp4,0.3333333333333333,2,2,TTAAGTTCCAGCTAATTGTA,0,1940392
ihfAp4,0.3333333333333333,2,2,TTAAGCTGGCCCGTTCTCTC,0,1955726
ihfAp4,0.3333333333333333,2,2,TTAAGATTATTGTTTCTGAT,0,1942985
ihfAp4,0.3333333333333333,2,2,TTAAGACTTCCCAGAGTAAC,0,1948332
ihfAp4,0.3333333333333333,2,2,TTAACTCCGTTCAGCAACGG,0,1916026
ihfAp4,0.3333333333333333,2,2,TTAAAGCCAGGTTGTAACCA,0,1914990
ihfAp4,0.3333333333333333,2,2,TGTTGAGACCTTTTTGGTTT,0,1944497
ihfAp4,0.3333333333333333,2,2,TGTTCTCGCGTTAGACTGGT,0,1956472
ihfAp4,0.3333333333333333,2,2,TGTTCCCGCTGATTAAGGCA,0,1950163
ihfAp4,0.3333333333333333,2,2,TGTTCAATTCTTGGGGTGCC,0,1932222
ihfAp4,0.3333333333333333,2,2,TGTTAAAGGGCTTATCCCTG,0,1916847
ihfAp4,0.3333333333333333,2,2,TGTGTTAGGCTGTCTGTAGT,0,1939942
ihfAp4,0.3333333333333333,2,2,TGTGTGATCGGTGAATTACA,0,1920250
ihfAp4,0.3333333333333333,2,2,TGTGTGAGTCTGGAAACAAT,0,1933454
ihfAp4,0.3333333333333333,2,2,TGTGGGTCCAGTTTCGAAAT,0,1952753
ihfAp4,0.3333333333333333,2,2,TGTGGCTACTCCCGGGGGAC,0,1952812
ihfAp4,0.3333333333333333,2,2,TGTGGCGGCACTTAGCACAC,0,1932460
ihfAp4,0.3333333333333333,2,2,TGTGCTGGTTAATGCCCTTT,0,1935867
ihfAp4,0.3333333333333333,2,2,TGTGCTCCACGGTCTGATGA,0,1917109
ihfAp4,0.3333333333333333,2,2,TGTGCCGGTCAAGAGCAACT,0,1931924
ihfAp4,0.3333333333333333,2,2,TGTGAATCTGGATCTGGGTG,0,1931505
ihfAp4,0.3333333333333333,2,2,TGTCTTCCACCCGAGGGCTG,0,1956731
ihfAp4,0.3333333333333333,2,2,TGTCGGTACATTCCCCATAT,0,1931469
ihfAp4,0.3333333333333333,2,2,TGTCGATAAGCCACTTCAGG,0,1937202
ihfAp4,0.3333333333333333,2,2,TGTCCCAGCCCGAAATTCTG,0,1954103
ihfAp4,0.3333333333333333,2,2,TGTCCAAATAAAAGCGCTCT,0,1944495
ihfAp4,0.3333333333333333,2,2,TGTAGAGGTACCGTTCCCGT,0,1917213
ihfAp4,0.3333333333333333,2,2,TGTACTGGCAATCAGAGGAA,0,1953187
ihfAp4,0.3333333333333333,2,2,TGTAATGCTAGGTCGCCTGT,0,1948231
ihfAp4,0.3333333333333333,2,2,TGTAATGCCCCAAAGCGCAT,0,1957871
ihfAp4,0.3333333333333333,2,2,TGTAAGCGCGGCTAAGTGTT,0,1941902
ihfAp4,0.3333333333333333,2,2,TGGTTCAGAACCAAGATCAG,0,1933570
ihfAp4,0.3333333333333333,2,2,TGGTGAGGCGCTTTCGATGT,0,1959467
ihfAp4,0.3333333333333333,2,2,TGGTCCCTGAGATACTTCCA,0,1922710
ihfAp4,0.3333333333333333,2,2,TGGTAGCAGGCGTGACCTAG,0,1910938
ihfAp4,0.3333333333333333,2,2,TGGTACGTTCCGGGTTTTTT,0,1938230
ihfAp4,0.3333333333333333,2,2,TGGTAAGTTCGGTGCCAAGG,0,1913096
ihfAp4,0.3333333333333333,2,2,TGGTAAGTATAAGCAATGAT,0,1930802
ihfAp4,0.3333333333333333,2,2,TGGTAACATTAGTGATCACG,0,1926695
ihfAp4,0.3333333333333333,2,2,TGGGTTCATCTCGTAATGGA,0,1928999
ihfAp4,0.3333333333333333,2,2,TGGGTCTTTTTGGGACAAGA,0,1955043
ihfAp4,0.3333333333333333,2,2,TGGGTCTCCAATCTACTCTC,0,1933919
ihfAp4,0.3333333333333333,2,2,TGGGTCCCCGGAAGCGAGAA,0,1910080
ihfAp4,0.3333333333333333,2,2,TGGGTACGCAAGGGGAAAAC,0,1957039
ihfAp4,0.3333333333333333,2,2,TGGGGGGTTACCGTCGGTTT,0,1911374
ihfAp4,0.3333333333333333,2,2,TGGGGGGAGATCAAGTGCTA,0,1920696
ihfAp4,0.3333333333333333,2,2,TGGGGCGGTAACTAGCGGCG,0,1960357
ihfAp4,0.3333333333333333,2,2,TGGGCACGTTATGCGAAGCT,0,1943379
ihfAp4,0.3333333333333333,2,2,TGGGATTGTTGAGCTATACA,0,1926143
ihfAp4,0.3333333333333333,2,2,TGGGATACTTCCCGGTAAAG,0,1951757
ihfAp4,0.3333333333333333,2,2,TGGGACGGGAGAGCGGCCAA,0,1947625
ihfAp4,0.3333333333333333,2,2,TGGCTTAGACGGCAATGTTA,0,1928534
ihfAp4,0.3333333333333333,2,2,TGGCGTTGGTGAGGCTTGAA,0,1915230
ihfAp4,0.3333333333333333,2,2,TGGCGTCCGAGTTCTAGTTT,0,1933999
ihfAp4,0.3333333333333333,2,2,TGGCCTTCACATGTGAGCCA,0,1916180
ihfAp4,0.3333333333333333,2,2,TGGCCCTTTTCGTCACGAGT,0,1956269
ihfAp4,0.3333333333333333,2,2,TGGATTTCCCATTTCCGGAC,0,1952078
ihfAp4,0.3333333333333333,2,2,TGGAGTTTGCTTTCTAGCAG,0,1938352
ihfAp4,0.3333333333333333,2,2,TGGAGAAACTTGCAACGTCT,0,1941868
ihfAp4,0.3333333333333333,2,2,TGGACCCTCCACCATTCTAT,0,1948522
ihfAp4,0.3333333333333333,2,2,TGGAAACCACGCCGGTGGTT,0,1935113
ihfAp4,0.3333333333333333,2,2,TGCTGCCTCTCTTGGTCATT,0,1932835
ihfAp4,0.3333333333333333,2,2,TGCTGCACCTCTACGCTAAA,0,1931056
ihfAp4,0.3333333333333333,2,2,TGCTCAGGGTCTTTCAAACG,0,1953280
ihfAp4,0.3333333333333333,2,2,TGCGTTTCTGCGGGTAGGTA,0,1912368
ihfAp4,0.3333333333333333,2,2,TGCGTACTGCCTAATGCGCA,0,1913494
ihfAp4,0.3333333333333333,2,2,TGCGGGACCCTGTCTAATGC,0,1956366
ihfAp4,0.3333333333333333,2,2,TGCGGCCGGGTACCACAGGC,0,1950098
ihfAp4,0.3333333333333333,2,2,TGCGATGTTTTGCGAGCCTC,0,1954713
ihfAp4,0.3333333333333333,2,2,TGCGACCCTGGAAGACTCGA,0,1946944
ihfAp4,0.3333333333333333,2,2,TGCCTTAGAGGGTATCGCCT,0,1937257
ihfAp4,0.3333333333333333,2,2,TGCCGGTGGACATTCCACTT,0,1918557
ihfAp4,0.3333333333333333,2,2,TGCCGCTGGCACCAATTTTA,0,1912936
ihfAp4,0.3333333333333333,2,2,TGCCCATAGTCGTTAACATT,0,1919723
ihfAp4,0.3333333333333333,2,2,TGCCAGAATGTCTCGAACCA,0,1936800
ihfAp4,0.3333333333333333,2,2,TGCATCTGAAACTCTACGAA,0,1943541
ihfAp4,0.3333333333333333,2,2,TGCATCTAAAGGAAGGACCA,0,1936756
ihfAp4,0.3333333333333333,2,2,TGCATAATAAACTATCATTA,0,1942276
ihfAp4,0.3333333333333333,2,2,TGCAGTGTCGATCGCGAAAT,0,1914235
ihfAp4,0.3333333333333333,2,2,TGCAGGTACATCTCCAGGGG,0,1912906
ihfAp4,0.3333333333333333,2,2,TGCAGCTTTTTTGCACTGAT,0,1930744
ihfAp4,0.3333333333333333,2,2,TGCAAGGTTTTATATGTAGG,0,1910069
ihfAp4,0.3333333333333333,2,2,TGCAAGGGGAGAATTGTATG,0,1940440
ihfAp4,0.3333333333333333,2,2,TGCAAAGTTTGGCGCTAGCC,0,1926582
ihfAp4,0.3333333333333333,2,2,TGATTTAGTGGAAGCGACTA,0,1947747
ihfAp4,0.3333333333333333,2,2,TGATGTGGTAGATCAATCTC,0,1923640
ihfAp4,0.3333333333333333,2,2,TGATGTCCAGTCACCGGGTG,0,1931543
ihfAp4,0.3333333333333333,2,2,TGATGGGTTCGTCTGTCTAG,0,1950590
ihfAp4,0.3333333333333333,2,2,TGATCCTAATTAACTTCCCA,0,1925951
ihfAp4,0.3333333333333333,2,2,TGATCACGCAAACGCCGCAG,0,1914407
ihfAp4,0.3333333333333333,2,2,TGATACGCTCTGTGAGGCCC,0,1960728
ihfAp4,0.3333333333333333,2,2,TGAGTGCCGGCCGGCCCGTC,0,1949342
ihfAp4,0.3333333333333333,2,2,TGAGTAGGAAGGATTACGGA,0,1940420
ihfAp4,0.3333333333333333,2,2,TGAGGATGTTCAACCTTCAC,0,1914516
ihfAp4,0.3333333333333333,2,2,TGAGATTCCCCCAGAGTGTT,0,1953809
ihfAp4,0.3333333333333333,2,2,TGAGATGTACCTGGGCTACA,0,1936924
ihfAp4,0.3333333333333333,2,2,TGAGATAAGCAGTGCCTTGA,0,1941826
ihfAp4,0.3333333333333333,2,2,TGAGAAACGCTTTTATTTAT,0,1933519
ihfAp4,0.3333333333333333,2,2,TGACTCGATGTGACTGAGTC,0,1961578
ihfAp4,0.3333333333333333,2,2,TGACGATCTAGTCTGTACAT,0,1958134
ihfAp4,0.3333333333333333,2,2,TGACCGGTCCCTCTTGTCTC,0,1956373
ihfAp4,0.3333333333333333,2,2,TGACATTCGGTTGGATACTC,0,1925230
ihfAp4,0.3333333333333333,2,2,TGACATGCGTCGATGAGCTC,0,1934919
ihfAp4,0.3333333333333333,2,2,TGACAGGACCAGCAACGCAT,0,1916045
ihfAp4,0.3333333333333333,2,2,TGAATTAATCGCGAGATGAT,0,1950233
ihfAp4,0.3333333333333333,2,2,TGAACTTCGCCACCTTCAGA,0,1950483
ihfAp4,0.3333333333333333,2,2,TGAACCAGCTATGTGTGGGA,0,1932669
ihfAp4,0.3333333333333333,2,2,TGAACAGTAACAGCCAAGTT,0,1925272
ihfAp4,0.3333333333333333,2,2,TCTTGGCTGACGTCATTCAG,0,1933986
ihfAp4,0.3333333333333333,2,2,TCTTGCGCCTGGTTGTGATA,0,1922049
ihfAp4,0.3333333333333333,2,2,TCTTCGACAATTCCGCAGCC,0,1956016
ihfAp4,0.3333333333333333,2,2,TCTTCATGCACGTATCAATA,0,1961246
ihfAp4,0.3333333333333333,2,2,TCTTATATATAAAAGAGGAT,0,1919095
ihfAp4,0.3333333333333333,2,2,TCTTATACGAGGCAACAGTT,0,1926529
ihfAp4,0.3333333333333333,2,2,TCTTAATGGCGGGGGCGTTA,0,1942335
ihfAp4,0.3333333333333333,2,2,TCTGGCGCGCATTAGGTCGA,0,1927379
ihfAp4,0.3333333333333333,2,2,TCTGAGGCCTACCATGTAGT,0,1942316
ihfAp4,0.3333333333333333,2,2,TCTCTAGTTTACGACGATGT,0,1942158
ihfAp4,0.3333333333333333,2,2,TCTCGGTTGCTACATGGTTG,0,1954290
ihfAp4,0.3333333333333333,2,2,TCTCGGTCTGGTACAGTAGT,0,1960170
ihfAp4,0.3333333333333333,2,2,TCTCAGGAGCGCCAGAATAG,0,1956201
ihfAp4,0.3333333333333333,2,2,TCTCAAGCGATGATGTCTCT,0,1931974
ihfAp4,0.3333333333333333,2,2,TCTATGCTACTTGGTGCAAT,0,1949597
ihfAp4,0.3333333333333333,2,2,TCTATCTGGAATGGTAGGGA,0,1940164
ihfAp4,0.3333333333333333,2,2,TCTATCACCGGATTATCTCA,0,1927630
ihfAp4,0.3333333333333333,2,2,TCTAGTACCGGTCGCGACAC,0,1922027
ihfAp4,0.3333333333333333,2,2,TCTACTGCCCTATTATGTGC,0,1922645
ihfAp4,0.3333333333333333,2,2,TCTACCCGATATCCCTATTC,0,1923730
ihfAp4,0.3333333333333333,2,2,TCGTTGTCGGAGCGTTAAGC,0,1924698
ihfAp4,0.3333333333333333,2,2,TCGTTACGTGAGAACGAAGG,0,1946724
ihfAp4,0.3333333333333333,2,2,TCGTGGTAATAGGCGTCATC,0,1956816
ihfAp4,0.3333333333333333,2,2,TCGTGGAGTCGGATAAGGGA,0,1916739
ihfAp4,0.3333333333333333,2,2,TCGTGCGACTACGAGCAACT,0,1948628
ihfAp4,0.3333333333333333,2,2,TCGTGATCCAACAGTTATAA,0,1941508
ihfAp4,0.3333333333333333,2,2,TCGTCGTCAGCGATCACGTG,0,1911271
ihfAp4,0.3333333333333333,2,2,TCGGTGGCTTCCTGCTAACA,0,1954912
ihfAp4,0.3333333333333333,2,2,TCGGGAAACTCGTCACCCAC,0,1924882
ihfAp4,0.3333333333333333,2,2,TCGGCAAATATACAGGCTAC,0,1922289
ihfAp4,0.3333333333333333,2,2,TCGCGGTGGTGCATAGTGAA,0,1927054
ihfAp4,0.3333333333333333,2,2,TCGCGGACGTATGCAGGGTA,0,1957873
ihfAp4,0.3333333333333333,2,2,TCGCGGAAGGGACGACAGTT,0,1931156
ihfAp4,0.3333333333333333,2,2,TCGCCTCGTATGCATGAAAG,0,1931487
ihfAp4,0.3333333333333333,2,2,TCGCCATCCTCCGTGCGGTG,0,1912591
ihfAp4,0.3333333333333333,2,2,TCGCAGTAGGAAATAGGCTC,0,1935252
ihfAp4,0.3333333333333333,2,2,TCGCAGTAATTTAATCTCAG,0,1911480
ihfAp4,0.3333333333333333,2,2,TCGATTTCAGCTGGGTGATA,0,1950336
ihfAp4,0.3333333333333333,2,2,TCGAGTGGCCATGGATCTAT,0,1927896
ihfAp4,0.3333333333333333,2,2,TCGAGGTCAGTTCGATAAAG,0,1913214
ihfAp4,0.3333333333333333,2,2,TCGACTCCGAGAATGCAGGA,0,1959957
ihfAp4,0.3333333333333333,2,2,TCGACTATGCCGTTAAGGCA,0,1929384
ihfAp4,0.3333333333333333,2,2,TCGAACGTAGGCTGGGTGAA,0,1959225
ihfAp4,0.3333333333333333,2,2,TCCTTCCCTCGGGGGGGTTT,0,1945735
ihfAp4,0.3333333333333333,2,2,TCCTTAGGAGGCCATAATTT,0,1948487
ihfAp4,0.3333333333333333,2,2,TCCTCAGTGGGCTGAATTTG,0,1944744
ihfAp4,0.3333333333333333,2,2,TCCTAAATTGCCGGTGGCTC,0,1961165
ihfAp4,0.3333333333333333,2,2,TCCGTGTGAGACGTCCTCAT,0,1917751
ihfAp4,0.3333333333333333,2,2,TCCGTAGCTGGTTTCTATCG,0,1950495
ihfAp4,0.3333333333333333,2,2,TCCGGTCCGTTTCATTCTTA,0,1938860
ihfAp4,0.3333333333333333,2,2,TCCGGTATGATTTTAGAACA,0,1958699
ihfAp4,0.3333333333333333,2,2,TCCGGGCTACTGGAGAGGGA,0,1920303
ihfAp4,0.3333333333333333,2,2,TCCGATTTAAAGTCCCCCTG,0,1956297
ihfAp4,0.3333333333333333,2,2,TCCGAAGTACGACAGTTGGC,0,1914489
ihfAp4,0.3333333333333333,2,2,TCCCTGCTGCTTAGAACAAG,0,1939293
ihfAp4,0.3333333333333333,2,2,TCCCGTCGGTAATCTCGCCG,0,1955104
ihfAp4,0.3333333333333333,2,2,TCCCGGCTAATTACGTTACA,0,1949934
ihfAp4,0.3333333333333333,2,2,TCCCGCCTAATTTCTTACGG,0,1956545
ihfAp4,0.3333333333333333,2,2,TCCCCGTGTAGGTGCTATCA,0,1939131
ihfAp4,0.3333333333333333,2,2,TCCCCAGCGGTACAGCTGAT,0,1938355
ihfAp4,0.3333333333333333,2,2,TCCAGTTTGCTAAGTCATCA,0,1926386
ihfAp4,0.3333333333333333,2,2,TCCAGGGAGTTTCCGGAGCT,0,1910628
ihfAp4,0.3333333333333333,2,2,TCCAGGCCGTGCATTTTCTC,0,1932748
ihfAp4,0.3333333333333333,2,2,TCCAGACACACTATTTATCG,0,1940252
ihfAp4,0.3333333333333333,2,2,TCCACGGTGCCCAGAAACGG,0,1942758
ihfAp4,0.3333333333333333,2,2,TCCAAGGTTAGCATCCCGTT,0,1930105
ihfAp4,0.3333333333333333,2,2,TCCAACTTCCACATTACGGC,0,1939064
ihfAp4,0.3333333333333333,2,2,TCATTCTTATTTGAGGGTTT,0,1943329
ihfAp4,0.3333333333333333,2,2,TCATTCGTGTAGCAGAAAAA,0,1958501
ihfAp4,0.3333333333333333,2,2,TCATGGTGCTGGCGATCGGT,0,1924448
ihfAp4,0.3333333333333333,2,2,TCATCGGACTCACACACAGA,0,1929481
ihfAp4,0.3333333333333333,2,2,TCATCATAAGTGGTACATCG,0,1946024
ihfAp4,0.3333333333333333,2,2,TCATCAAACCTCGATTTAGA,0,1952246
ihfAp4,0.3333333333333333,2,2,TCAGTTTAGCGGGGCTATGA,0,1948532
ihfAp4,0.3333333333333333,2,2,TCAGTAAGTTCTGGGACGGA,0,1911240
ihfAp4,0.3333333333333333,2,2,TCAGGGTATCGCGCTTTAGG,0,1923596
ihfAp4,0.3333333333333333,2,2,TCAGGGGTAACTGTCAGCCC,0,1921856
ihfAp4,0.3333333333333333,2,2,TCAGGGCGGAGGTTGTAACA,0,1929825
ihfAp4,0.3333333333333333,2,2,TCAGGAATAGGAAATGAGGA,0,1921756
ihfAp4,0.3333333333333333,2,2,TCAGACGTATATCGACGCAG,0,1943740
ihfAp4,0.3333333333333333,2,2,TCACTATCGACGACGTGCAA,0,1946393
ihfAp4,0.3333333333333333,2,2,TCACGTCTCGAACGGATGGA,0,1922012
ihfAp4,0.3333333333333333,2,2,TCACGAAGTAATTCTATCGG,0,1957477
ihfAp4,0.3333333333333333,2,2,TCACAATACAGCTGTTCAAC,0,1932232
ihfAp4,0.3333333333333333,2,2,TCAATGTGTGCACCTACCAC,0,1955638
ihfAp4,0.3333333333333333,2,2,TCAAGTATTCCCCTCTTCTC,0,1931745
ihfAp4,0.3333333333333333,2,2,TCAACGACTAACGTACCTTC,0,1932829
ihfAp4,0.3333333333333333,2,2,TCAAAAACGGTCCCGTGGCC,0,1934939
ihfAp4,0.3333333333333333,2,2,TCAAAAACCTTTGAGGGGGT,0,1951936
ihfAp4,0.3333333333333333,2,2,TATTTTGGAGATTTAGGCGC,0,1916144
ihfAp4,0.3333333333333333,2,2,TATTTTCAGGCTTATAATCA,0,1916975
ihfAp4,0.3333333333333333,2,2,TATTTCGAGACTGGGGATTT,0,1952650
ihfAp4,0.3333333333333333,2,2,TATTTATGCTGGTTCGTTAA,0,1938318
ihfAp4,0.3333333333333333,2,2,TATTTAGCCACGGTCTTTAC,0,1950624
ihfAp4,0.3333333333333333,2,2,TATTGCCGGAATCAAAGCGC,0,1952169
ihfAp4,0.3333333333333333,2,2,TATTGCCATATCTTATGGTG,0,1921629
ihfAp4,0.3333333333333333,2,2,TATTGAGCCTGGACCTGAAG,0,1960536
ihfAp4,0.3333333333333333,2,2,TATTCAGATCCGTGATTCGG,0,1952695
ihfAp4,0.3333333333333333,2,2,TATTCACCCAGCCTGGGTCT,0,1938472
ihfAp4,0.3333333333333333,2,2,TATTAGCCCCACAAGTCGTG,0,1937376
ihfAp4,0.3333333333333333,2,2,TATGGCTCTAACTCTACGGC,0,1909958
ihfAp4,0.3333333333333333,2,2,TATGGAGGTCTAGTATGGCT,0,1932049
ihfAp4,0.3333333333333333,2,2,TATGCTTACCACAACGGCTT,0,1941295
ihfAp4,0.3333333333333333,2,2,TATCTTGCATGAGAGCAAGG,0,1928879
ihfAp4,0.3333333333333333,2,2,TATCGATTTGGACAAATAAT,0,1959104
ihfAp4,0.3333333333333333,2,2,TATATTGAAACATATAGGGA,0,1956273
ihfAp4,0.3333333333333333,2,2,TATATGACCAGTAGAATGCT,0,1949403
ihfAp4,0.3333333333333333,2,2,TATATCGCGTCCGGTGGCCT,0,1935004
ihfAp4,0.3333333333333333,2,2,TATATAATTCGATGCTCGGA,0,1917669
ihfAp4,0.3333333333333333,2,2,TATAGGTGTTAAACTAGATA,0,1946818
ihfAp4,0.3333333333333333,2,2,TATAATGGGCTGGTACGTAA,0,1945230
ihfAp4,0.3333333333333333,2,2,TATAACTCGTACATCATGGA,0,1950245
ihfAp4,0.3333333333333333,2,2,TATAAATTGCGCGCCGGTCC,0,1959131
ihfAp4,0.3333333333333333,2,2,TATAAATCCCGTGGATTGCA,0,1952659
ihfAp4,0.3333333333333333,2,2,TAGTCTCGGATGGAATCGGG,0,1935975
ihfAp4,0.3333333333333333,2,2,TAGGTCACGTAGTAAGTGGG,0,1955742
ihfAp4,0.3333333333333333,2,2,TAGGGGTTCGTAGGCGGATA,0,1918122
ihfAp4,0.3333333333333333,2,2,TAGGGGCCGTGAACAACGAT,0,1944280
ihfAp4,0.3333333333333333,2,2,TAGGGACTAGAAAGATGGGA,0,1924226
ihfAp4,0.3333333333333333,2,2,TAGGGAATGGGGTCTTCGAT,0,1953581
ihfAp4,0.3333333333333333,2,2,TAGGCCCGTTAAAGCACAAG,0,1925749
ihfAp4,0.3333333333333333,2,2,TAGGATCCGTTCTCCGACTT,0,1944807
ihfAp4,0.3333333333333333,2,2,TAGGACTAAGTGAAAATCCT,0,1947026
ihfAp4,0.3333333333333333,2,2,TAGCTGGACGCGCATATAGA,0,1921558
ihfAp4,0.3333333333333333,2,2,TAGCTAACATTACAGGATGA,0,1947540
ihfAp4,0.3333333333333333,2,2,TAGCGTCGGTCCCCACTTTG,0,1961051
ihfAp4,0.3333333333333333,2,2,TAGCGACGAGGCGGGAGCTC,0,1946216
ihfAp4,0.3333333333333333,2,2,TAGCCCTACATTACTCCATA,0,1922649
ihfAp4,0.3333333333333333,2,2,TAGCCATTAGCGCCCGGCGG,0,1941860
ihfAp4,0.3333333333333333,2,2,TAGCCATTAAAACATTGATC,0,1922637
ihfAp4,0.3333333333333333,2,2,TAGCAATTATTAAGTCCGGA,0,1949233
ihfAp4,0.3333333333333333,2,2,TAGCAAGTAAGTTATAGGGG,0,1919016
ihfAp4,0.3333333333333333,2,2,TAGATTGGTCCCTAACAGGC,0,1921715
ihfAp4,0.3333333333333333,2,2,TAGACGAATCACTATCAGGT,0,1938774
ihfAp4,0.3333333333333333,2,2,TAGACACCGTATTGACATTT,0,1941654
ihfAp4,0.3333333333333333,2,2,TAGAAGCTATCGAGCTTTTG,0,1928184
ihfAp4,0.3333333333333333,2,2,TAGAACCTGAGACGACGACA,0,1919328
ihfAp4,0.3333333333333333,2,2,TAGAACAGTGGTATTAGCGT,0,1920533
ihfAp4,0.3333333333333333,2,2,TAGAACAATTGGACGGGAAA,0,1949378
ihfAp4,0.3333333333333333,2,2,TAGAAAAAAACCACGCAGCA,0,1953494
ihfAp4,0.3333333333333333,2,2,TACTTTCGGTTTCATTCTAA,0,1951072
ihfAp4,0.3333333333333333,2,2,TACTTCCTATAAGTATCGGG,0,1957064
ihfAp4,0.3333333333333333,2,2,TACTGCTAGGAGTATATACA,0,1952715
ihfAp4,0.3333333333333333,2,2,TACTCGTCCCCCGTCATCTC,0,1957062
ihfAp4,0.3333333333333333,2,2,TACTATAAATATGCAAGCAC,0,1919559
ihfAp4,0.3333333333333333,2,2,TACTACCCGCTTACAAAGTG,0,1940593
ihfAp4,0.3333333333333333,2,2,TACGTGGATAATGACTACCT,0,1913285
ihfAp4,0.3333333333333333,2,2,TACGGTAACTTGGATCATCA,0,1945952
ihfAp4,0.3333333333333333,2,2,TACGGGGTCTTTCAGTGTTT,0,1926050
ihfAp4,0.3333333333333333,2,2,TACGGCAATCGCAACCTACC,0,1917145
ihfAp4,0.3333333333333333,2,2,TACGCCCAAGCCAACCTCGG,0,1950066
ihfAp4,0.3333333333333333,2,2,TACCGCAAACCGACTTAGCC,0,1952668
ihfAp4,0.3333333333333333,2,2,TACCACTGAGACAAAGGTAT,0,1958272
ihfAp4,0.3333333333333333,2,2,TACATATGTTCGTTGTGAGG,0,1961065
ihfAp4,0.3333333333333333,2,2,TACAGGGATACACGGATGGA,0,1925292
ihfAp4,0.3333333333333333,2,2,TACACCTTTATGCCGGTGCT,0,1912821
ihfAp4,0.3333333333333333,2,2,TAATGCGTATAACTACGAAG,0,1954585
ihfAp4,0.3333333333333333,2,2,TAATAGGTAAGCGAGGGATG,0,1924146
ihfAp4,0.3333333333333333,2,2,TAATACGTCGGAGCCACAAC,0,1954139
ihfAp4,0.3333333333333333,2,2,TAAGTCGTGAGGGCCTTTTC,0,1924640
ihfAp4,0.3333333333333333,2,2,TAAGGCGTAGACTTTTACAT,0,1927378
ihfAp4,0.3333333333333333,2,2,TAAGGAAATAACTGATACTC,0,1939442
ihfAp4,0.3333333333333333,2,2,TAACTCCCCGTGAGTATTTG,0,1916362
ihfAp4,0.3333333333333333,2,2,TAACGTCGTGCTGATAGAGG,0,1917646
ihfAp4,0.3333333333333333,2,2,TAACGTCATGGATGGGATGA,0,1959923
ihfAp4,0.3333333333333333,2,2,TAACCCGGGCATTCCTCTTG,0,1926290
ihfAp4,0.3333333333333333,2,2,TAACCAAAGTCGATTATGGC,0,1955159
ihfAp4,0.3333333333333333,2,2,TAACAGGGGGGTTGCAATAT,0,1919357
ihfAp4,0.3333333333333333,2,2,TAAATCCTGCTACGATAGGT,0,1930313
ihfAp4,0.3333333333333333,2,2,TAAATCCACGCTGGTCATAA,0,1910014
ihfAp4,0.3333333333333333,2,2,TAAAGCCCGTCACAATGGCT,0,1928262
ihfAp4,0.3333333333333333,2,2,TAAAAAGTTTTTTAGCGTGC,0,1916254
ihfAp4,0.3333333333333333,2,2,GTTTTTCAGCATCTTCGGAC,0,1947701
ihfAp4,0.3333333333333333,2,2,GTTTGGGCGCTCTTCAGTCC,0,1928445
ihfAp4,0.3333333333333333,2,2,GTTTGCGTCCGAGATGGGCT,0,1934573
ihfAp4,0.3333333333333333,2,2,GTTTGAAATGCATAAGGGTT,0,1930020
ihfAp4,0.3333333333333333,2,2,GTTTCTTTCGGCGGAGGGTC,0,1950815
ihfAp4,0.3333333333333333,2,2,GTTTCTCACCGTGGTCTTCG,0,1953273
ihfAp4,0.3333333333333333,2,2,GTTTCCCGCATGGGGCCAAG,0,1911280
ihfAp4,0.3333333333333333,2,2,GTTTCCATGAATCTAAGGTG,0,1939947
ihfAp4,0.3333333333333333,2,2,GTTTAGAGGCGGGCTCTTCG,0,1941433
ihfAp4,0.3333333333333333,2,2,GTTTACGTCGGATCTCAGGG,0,1949188
ihfAp4,0.3333333333333333,2,2,GTTGTATTTCGAACGACCCG,0,1910489
ihfAp4,0.3333333333333333,2,2,GTTGGTTGTAACGACAACTG,0,1911802
ihfAp4,0.3333333333333333,2,2,GTTGGGGCATTCGCCAGGTA,0,1912066
ihfAp4,0.3333333333333333,2,2,GTTGGGCAGGCTTAGAGCCA,0,1950302
ihfAp4,0.3333333333333333,2,2,GTTGGGACTCTGATACTAAT,0,1959478
ihfAp4,0.3333333333333333,2,2,GTTGGCGCGCCGGTGACCTC,0,1911804
ihfAp4,0.3333333333333333,2,2,GTTGGAGAGTCTAGACATTC,0,1938312
ihfAp4,0.3333333333333333,2,2,GTTGGAATTGCCTTAGAGCC,0,1934747
ihfAp4,0.3333333333333333,2,2,GTTGATTAGGATTTGCAATA,0,1942434
ihfAp4,0.3333333333333333,2,2,GTTGATATAGACATAGTTGT,0,1950928
ihfAp4,0.3333333333333333,2,2,GTTGAAAGTGAAAAATTCCA,0,1922582
ihfAp4,0.3333333333333333,2,2,GTTCTGCGTCGGGCCGACCC,0,1909913
ihfAp4,0.3333333333333333,2,2,GTTCTATAGTCATCTATATT,0,1955483
ihfAp4,0.3333333333333333,2,2,GTTCGTACATGTGTAGTGCG,0,1912912
ihfAp4,0.3333333333333333,2,2,GTTATCAATGGATACTACCC,0,1935250
ihfAp4,0.3333333333333333,2,2,GTTAGGGCTCGAATTTATTT,0,1955492
ihfAp4,0.3333333333333333,2,2,GTTAGGAAGGTTACACCTCC,0,1927274
ihfAp4,0.3333333333333333,2,2,GTTAGATGATGTACTTCGGT,0,1917076
ihfAp4,0.3333333333333333,2,2,GTTACTAACCAGAACTCATG,0,1958962
ihfAp4,0.3333333333333333,2,2,GTTAAGAGCTCTATGAATGT,0,1928280
ihfAp4,0.3333333333333333,2,2,GTTAACGCCAGTCCTCAGGC,0,1915621
ihfAp4,0.3333333333333333,2,2,GTGTTTTTAGTGGACAAGAT,0,1933834
ihfAp4,0.3333333333333333,2,2,GTGTTGTGCTGCTACGCTAG,0,1922229
ihfAp4,0.3333333333333333,2,2,GTGTTATCCTCCCACATGTT,0,1923731
ihfAp4,0.3333333333333333,2,2,GTGTTAGAGCGATTGTCCGG,0,1960886
ihfAp4,0.3333333333333333,2,2,GTGTAAGCGACATGCCTCAT,0,1913486
ihfAp4,0.3333333333333333,2,2,GTGGTGGCAGCTAATTTCCG,0,1928468
ihfAp4,0.3333333333333333,2,2,GTGGTAAGTTTTCACTCACT,0,1937052
ihfAp4,0.3333333333333333,2,2,GTGGGTTTCATGCGCGAAAA,0,1951798
ihfAp4,0.3333333333333333,2,2,GTGGGTATCAGCTCTTCCTC,0,1928560
ihfAp4,0.3333333333333333,2,2,GTGGCACTCGGTACTGCCCC,0,1947265
ihfAp4,0.3333333333333333,2,2,GTGGCACGACCGTGATCCTG,0,1926647
ihfAp4,0.3333333333333333,2,2,GTGGATGTCAGGCCCCTTCC,0,1929341
ihfAp4,0.3333333333333333,2,2,GTGGATAGACCAAGGCGGAT,0,1913517
ihfAp4,0.3333333333333333,2,2,GTGGAACAGTACCACCGGGA,0,1945142
ihfAp4,0.3333333333333333,2,2,GTGCTTTCTGACCGCGACCG,0,1912331
ihfAp4,0.3333333333333333,2,2,GTGCTCATTTTGGAAGGTTG,0,1929325
ihfAp4,0.3333333333333333,2,2,GTGCGTTGACGTACATCCGT,0,1910273
ihfAp4,0.3333333333333333,2,2,GTGCCTCCAGGCCCCCAACT,0,1943305
ihfAp4,0.3333333333333333,2,2,GTGCCGGTATTCCCTATCTT,0,1952047
ihfAp4,0.3333333333333333,2,2,GTGCCCTACAATAGGGTCTG,0,1919298
ihfAp4,0.3333333333333333,2,2,GTGCATCTAAGAAGATCTCC,0,1930280
ihfAp4,0.3333333333333333,2,2,GTGATCTTTGGATTGGGTAA,0,1955679
ihfAp4,0.3333333333333333,2,2,GTGATAAAGCGATATGTCAA,0,1939017
ihfAp4,0.3333333333333333,2,2,GTGAATGAAGTCCAGGTATA,0,1939414
ihfAp4,0.3333333333333333,2,2,GTGAACTATTCAACCGGCAT,0,1929358
ihfAp4,0.3333333333333333,2,2,GTCTGAGAGTTGAGCTCTTA,0,1954549
ihfAp4,0.3333333333333333,2,2,GTCTCCTTTTCAACGGTTGC,0,1924450
ihfAp4,0.3333333333333333,2,2,GTCTAACTGAGACTTAGAGT,0,1931907
ihfAp4,0.3333333333333333,2,2,GTCTAACGGCTAACACATAC,0,1944828
ihfAp4,0.3333333333333333,2,2,GTCGTTTTTCCAGAACTCTA,0,1946361
ihfAp4,0.3333333333333333,2,2,GTCGTCAATCCGATTGCCTT,0,1948468
ihfAp4,0.3333333333333333,2,2,GTCGGGACGGAGACATTTCG,0,1916501
ihfAp4,0.3333333333333333,2,2,GTCGGCTCTCGAGCATCAGC,0,1934179
ihfAp4,0.3333333333333333,2,2,GTCGGCCGGATGACCACAGC,0,1916369
ihfAp4,0.3333333333333333,2,2,GTCGCCGCAGCTATTACAGG,0,1947184
ihfAp4,0.3333333333333333,2,2,GTCGATGTCATCGTCTAGCG,0,1919714
ihfAp4,0.3333333333333333,2,2,GTCGATCTGATCCCAGCCAT,0,1918356
ihfAp4,0.3333333333333333,2,2,GTCGAGGGTCCTGAAAGATG,0,1911737
ihfAp4,0.3333333333333333,2,2,GTCCTCTAGACAGTGTACGG,0,1917946
ihfAp4,0.3333333333333333,2,2,GTCCTACGCGAACTCGCTGC,0,1928441
ihfAp4,0.3333333333333333,2,2,GTCCGGTAATATCACGTTGA,0,1947018
ihfAp4,0.3333333333333333,2,2,GTCCCTCGAGGATGGTCTTT,0,1912058
ihfAp4,0.3333333333333333,2,2,GTCCCCTTGTAGGGTCGAAA,0,1932822
ihfAp4,0.3333333333333333,2,2,GTCCCCTATTCTCGTAAAAC,0,1911167
ihfAp4,0.3333333333333333,2,2,GTCCATGGGGCAGGACAAAA,0,1915703
ihfAp4,0.3333333333333333,2,2,GTCCAGCATCCGGGCTAGGC,0,1913625
ihfAp4,0.3333333333333333,2,2,GTCATTAGCCTCCTACGAGA,0,1956940
ihfAp4,0.3333333333333333,2,2,GTCAGAAATTACACAAGGGA,0,1959943
ihfAp4,0.3333333333333333,2,2,GTCACTTCGCCCCGCTGTTA,0,1910452
ihfAp4,0.3333333333333333,2,2,GTCACCTGTCTCCTTTCTCG,0,1931314
ihfAp4,0.3333333333333333,2,2,GTCACCGCGCTTTAGGTAAG,0,1936957
ihfAp4,0.3333333333333333,2,2,GTCAAGTACTCGCTCGCATG,0,1913293
ihfAp4,0.3333333333333333,2,2,GTCAAGGCCAAGTTGTTCAC,0,1918258
ihfAp4,0.3333333333333333,2,2,GTATTGCCATTAGGGCACAG,0,1926770
ihfAp4,0.3333333333333333,2,2,GTATTCGTGGTCTTCGACAT,0,1932603
ihfAp4,0.3333333333333333,2,2,GTATGCGGTGATGCGGGGAT,0,1914920
ihfAp4,0.3333333333333333,2,2,GTATGCACGACAAAGTGCGT,0,1936587
ihfAp4,0.3333333333333333,2,2,GTATGAGACTTTGGACAATA,0,1944641
ihfAp4,0.3333333333333333,2,2,GTATCGCACCTGACAGCATA,0,1943829
ihfAp4,0.3333333333333333,2,2,GTATCCAGTGATGCAAGTCA,0,1953971
ihfAp4,0.3333333333333333,2,2,GTATAGGGTTGCGTCCCTCG,0,1916191
ihfAp4,0.3333333333333333,2,2,GTATACTAAAGGACAGTTAG,0,1915200
ihfAp4,0.3333333333333333,2,2,GTATACGTCATAGGATCAGA,0,1929633
ihfAp4,0.3333333333333333,2,2,GTAGTAATCTCTAGCCTCCC,0,1931844
ihfAp4,0.3333333333333333,2,2,GTAGGTTGTGCCGCTTGAAT,0,1910879
ihfAp4,0.3333333333333333,2,2,GTAGGCCAAGACTTACTGCT,0,1919632
ihfAp4,0.3333333333333333,2,2,GTACGTCGGAGCGGGTTACT,0,1952484
ihfAp4,0.3333333333333333,2,2,GTACGTCCCTCTCTTTGATC,0,1956147
ihfAp4,0.3333333333333333,2,2,GTACGTCAATTCACGAAATA,0,1917142
ihfAp4,0.3333333333333333,2,2,GTACGGTCCCGTGTCTTACC,0,1942582
ihfAp4,0.3333333333333333,2,2,GTACGCGCCTGACGTTTCCT,0,1930116
ihfAp4,0.3333333333333333,2,2,GTACGCAGGTGTGCCTGGAA,0,1932549
ihfAp4,0.3333333333333333,2,2,GTACCATGGTGTTATTGAAG,0,1934688
ihfAp4,0.3333333333333333,2,2,GTACAGCAAATTCGCTAAAT,0,1941635
ihfAp4,0.3333333333333333,2,2,GTAATTAGCTTAATGCATGG,0,1948222
ihfAp4,0.3333333333333333,2,2,GTAATGGCCATTATTTAGCA,0,1936180
ihfAp4,0.3333333333333333,2,2,GTAATCGAAATTTGGCGTGC,0,1953656
ihfAp4,0.3333333333333333,2,2,GTAAGTTTAGGTTCATTCGG,0,1949391
ihfAp4,0.3333333333333333,2,2,GTAAGTTGGTTGAATCGCGT,0,1952596
ihfAp4,0.3333333333333333,2,2,GTAAGAGCGGTATAGCGCGC,0,1921909
ihfAp4,0.3333333333333333,2,2,GTAAGAAGGGCACGCCATGT,0,1952491
ihfAp4,0.3333333333333333,2,2,GTAACTTAATTGACGGCAGC,0,1911439
ihfAp4,0.3333333333333333,2,2,GGTTTTCCATGAAATAACTG,0,1938102
ihfAp4,0.3333333333333333,2,2,GGTTTGTCGCGGAAAAGGGA,0,1922478
ihfAp4,0.3333333333333333,2,2,GGTTTGGGAGCAGGGCTATA,0,1943365
ihfAp4,0.3333333333333333,2,2,GGTTTGCTGAAACTGCTTCC,0,1931184
ihfAp4,0.3333333333333333,2,2,GGTTTCGTTAATCCCTTTCC,0,1939448
ihfAp4,0.3333333333333333,2,2,GGTTTCGACGAACTAGCTGG,0,1915530
ihfAp4,0.3333333333333333,2,2,GGTTTATCGTCTAGTTCTTA,0,1943730
ihfAp4,0.3333333333333333,2,2,GGTTCCACGTGATTGCAACT,0,1912130
ihfAp4,0.3333333333333333,2,2,GGTTATTTGTGGTATCACAT,0,1948176
ihfAp4,0.3333333333333333,2,2,GGTTATTGTCCCGACTCATT,0,1920410
ihfAp4,0.3333333333333333,2,2,GGTTACTACGGTCAACGCCT,0,1931815
ihfAp4,0.3333333333333333,2,2,GGTGTTCCATTTATTCCCCA,0,1920873
ihfAp4,0.3333333333333333,2,2,GGTGGACTGGTATGTAGTAT,0,1931711
ihfAp4,0.3333333333333333,2,2,GGTGCTTACAGACGTTGAAA,0,1913181
ihfAp4,0.3333333333333333,2,2,GGTGATGTAAGGTCTCACGT,0,1955032
ihfAp4,0.3333333333333333,2,2,GGTGACGGAATTGTGTTTGC,0,1958823
ihfAp4,0.3333333333333333,2,2,GGTCTTTTTGATACTATTGT,0,1945921
ihfAp4,0.3333333333333333,2,2,GGTCTTGCGCGGGGTCCTAG,0,1947475
ihfAp4,0.3333333333333333,2,2,GGTCTGCTCCCAAGTTAATT,0,1941608
ihfAp4,0.3333333333333333,2,2,GGTCTCTCTACTTAGTGCCC,0,1913610
ihfAp4,0.3333333333333333,2,2,GGTCGGGGACCACCAAGAAG,0,1926958
ihfAp4,0.3333333333333333,2,2,GGTCCGGGGCAGGCCCTCGA,0,1926966
ihfAp4,0.3333333333333333,2,2,GGTCCGCGGTCAAAGCCGAC,0,1933228
ihfAp4,0.3333333333333333,2,2,GGTCCCGATGCCTTGTCGGC,0,1934608
ihfAp4,0.3333333333333333,2,2,GGTCCAGAGTGCTATGTTAG,0,1939749
ihfAp4,0.3333333333333333,2,2,GGTCCAATAATCCGACCGCT,0,1938646
ihfAp4,0.3333333333333333,2,2,GGTCAGGCCCGAAGGACTCA,0,1961938
ihfAp4,0.3333333333333333,2,2,GGTCAAGGTACTAAATTATG,0,1909823
ihfAp4,0.3333333333333333,2,2,GGTATTACAAGGCACCGTGT,0,1931442
ihfAp4,0.3333333333333333,2,2,GGTATTAAATTGCTTGAATT,0,1955349
ihfAp4,0.3333333333333333,2,2,GGTAGTTTGCCTCTCTTGGC,0,1923804
ihfAp4,0.3333333333333333,2,2,GGTAGTGCTTCTGGAGTGAG,0,1916257
ihfAp4,0.3333333333333333,2,2,GGTAGACGTTGGACGTGGTG,0,1946529
ihfAp4,0.3333333333333333,2,2,GGTAGACACGAAGTGTGCAT,0,1941139
ihfAp4,0.3333333333333333,2,2,GGTACAGGAGCTTGGTCGCT,0,1910392
ihfAp4,0.3333333333333333,2,2,GGTAATTGACCTCTAGTTCC,0,1941529
ihfAp4,0.3333333333333333,2,2,GGTAATGGGGGAAAAAATTT,0,1947140
ihfAp4,0.3333333333333333,2,2,GGTAAGATCGTGCGGTAATT,0,1956125
ihfAp4,0.3333333333333333,2,2,GGTAACAGTGTTTATCTGGT,0,1944094
ihfAp4,0.3333333333333333,2,2,GGTAAATGCCAACAGGTAGG,0,1955009
ihfAp4,0.3333333333333333,2,2,GGGTTGTGTCGTAGCGACGC,0,1929711
ihfAp4,0.3333333333333333,2,2,GGGTTCTATTCTCCGTTCTG,0,1951392
ihfAp4,0.3333333333333333,2,2,GGGTGGATACTGTGCGGTAT,0,1931874
ihfAp4,0.3333333333333333,2,2,GGGTGACAAGAAGAATCGGT,0,1956537
ihfAp4,0.3333333333333333,2,2,GGGTCGTGCGCTTAGCCCGG,0,1929169
ihfAp4,0.3333333333333333,2,2,GGGTCGTCACCGTCATCAGT,0,1948807
ihfAp4,0.3333333333333333,2,2,GGGTCCCGGCCCAAAGAAAT,0,1954162
ihfAp4,0.3333333333333333,2,2,GGGTAGCGCAAACCCATGGC,0,1928815
ihfAp4,0.3333333333333333,2,2,GGGTAGCCCCGTGAACATGA,0,1951979
ihfAp4,0.3333333333333333,2,2,GGGGTAAGCTCATCGCTATA,0,1952196
ihfAp4,0.3333333333333333,2,2,GGGGGCAGCACGATACAATC,0,1961156
ihfAp4,0.3333333333333333,2,2,GGGGGCAATTAGTGCCTGTC,0,1943210
ihfAp4,0.3333333333333333,2,2,GGGGGAGTGGTCTCGTAGAC,0,1942919
ihfAp4,0.3333333333333333,2,2,GGGGCTTGTTCCGGAAGGGT,0,1933345
ihfAp4,0.3333333333333333,2,2,GGGGCAATCCAAAGAGGTTC,0,1956345
ihfAp4,0.3333333333333333,2,2,GGGGAGACACGGTAAGCTGA,0,1925806
ihfAp4,0.3333333333333333,2,2,GGGCTAGGGCTGGCTTCGGA,0,1917098
ihfAp4,0.3333333333333333,2,2,GGGCGTTGAGCTGGACAAGA,0,1922941
ihfAp4,0.3333333333333333,2,2,GGGCCTCGGTATAGCGCGAT,0,1920673
ihfAp4,0.3333333333333333,2,2,GGGCAGGCCCGTCATACTTT,0,1960162
ihfAp4,0.3333333333333333,2,2,GGGATTCAGTTCATCGATCA,0,1944060
ihfAp4,0.3333333333333333,2,2,GGGATGTGGACTTCCGATTA,0,1938984
ihfAp4,0.3333333333333333,2,2,GGGATGCCTGTGCCGTCTAC,0,1940304
ihfAp4,0.3333333333333333,2,2,GGGAGGGGGTCAACAACGCT,0,1919374
ihfAp4,0.3333333333333333,2,2,GGGAGAGTTATCCCCTATTA,0,1958361
ihfAp4,0.3333333333333333,2,2,GGGACTACTGTGGACTTGGC,0,1959141
ihfAp4,0.3333333333333333,2,2,GGGAATGTTATGCGTTTGTC,0,1948423
ihfAp4,0.3333333333333333,2,2,GGCTTTGGTTGAAACGGTTA,0,1917832
ihfAp4,0.3333333333333333,2,2,GGCTGAGGGCGTAATCGGCA,0,1956194
ihfAp4,0.3333333333333333,2,2,GGCTCTACGGTACCACCGTG,0,1917501
ihfAp4,0.3333333333333333,2,2,GGCTCGGTCTTGATGACGCC,0,1933096
ihfAp4,0.3333333333333333,2,2,GGCTCGAAAACTACCCGTTG,0,1922389
ihfAp4,0.3333333333333333,2,2,GGCGTACGCCTTTCCACTAT,0,1945885
ihfAp4,0.3333333333333333,2,2,GGCGCTAGCGGGTTTCGGAC,0,1947522
ihfAp4,0.3333333333333333,2,2,GGCGCCCAAGTCAGATACCC,0,1934383
ihfAp4,0.3333333333333333,2,2,GGCGACTCGGCGACAAGTAG,0,1947739
ihfAp4,0.3333333333333333,2,2,GGCGAAAATCCATCTCGATT,0,1941227
ihfAp4,0.3333333333333333,2,2,GGCCTCCTGCTACGGACAAA,0,1936003
ihfAp4,0.3333333333333333,2,2,GGCCTACGCCCGCCGCACAT,0,1932029
ihfAp4,0.3333333333333333,2,2,GGCCGAGTGCCATGGGCTCG,0,1921018
ihfAp4,0.3333333333333333,2,2,GGCCGAGCCAATATTTAGGG,0,1956786
ihfAp4,0.3333333333333333,2,2,GGCCATCGTCAGGTCTTGCT,0,1920261
ihfAp4,0.3333333333333333,2,2,GGCCACACCAGCGCGGTGGA,0,1920166
ihfAp4,0.3333333333333333,2,2,GGCAGTCGATAGATTGGTCT,0,1943891
ihfAp4,0.3333333333333333,2,2,GGCACACTAGCTCAAGTGGC,0,1921594
ihfAp4,0.3333333333333333,2,2,GGCAATCTCTTTCGTTCTGT,0,1935464
ihfAp4,0.3333333333333333,2,2,GGCAATATGGCGCCCCACCC,0,1914795
ihfAp4,0.3333333333333333,2,2,GGCAAGTTTATACCGCTCTC,0,1922574
ihfAp4,0.3333333333333333,2,2,GGCAACTGTGGACTAAATAA,0,1945518
ihfAp4,0.3333333333333333,2,2,GGATTTGCGTGAAGTAGTCC,0,1939450
ihfAp4,0.3333333333333333,2,2,GGATTTGCCAACTGAATTGC,0,1913765
ihfAp4,0.3333333333333333,2,2,GGATTCAGGGCCTGGGACAA,0,1942317
ihfAp4,0.3333333333333333,2,2,GGATTACCTCCAATTGTCCA,0,1952942
ihfAp4,0.3333333333333333,2,2,GGATCGCTTTTGGACACGTA,0,1938979
ihfAp4,0.3333333333333333,2,2,GGATCAGGATCCTCATTTAA,0,1912431
ihfAp4,0.3333333333333333,2,2,GGATACTTTATTATGTCCTA,0,1946563
ihfAp4,0.3333333333333333,2,2,GGAGTGGGAAAATGGATGCC,0,1942432
ihfAp4,0.3333333333333333,2,2,GGAGTGCACTAGCAGAGATA,0,1922328
ihfAp4,0.3333333333333333,2,2,GGAGGCGAGGCCAGATCGTG,0,1944596
ihfAp4,0.3333333333333333,2,2,GGAGCCACTGCATGACGTCA,0,1915543
ihfAp4,0.3333333333333333,2,2,GGAGATTAGCCCTACGCACA,0,1932756
ihfAp4,0.3333333333333333,2,2,GGAGATAGGTCACTGCTATG,0,1953587
ihfAp4,0.3333333333333333,2,2,GGAGAGTCGTGCCTGAGCGG,0,1944571
ihfAp4,0.3333333333333333,2,2,GGAGAAGTTATGACATAAAA,0,1918222
ihfAp4,0.3333333333333333,2,2,GGAGAAGGAAGGACAGGTTA,0,1933338
ihfAp4,0.3333333333333333,2,2,GGAGAACTAGGCGGTTGGTT,0,1928791
ihfAp4,0.3333333333333333,2,2,GGAGAAAAGATCCTTGATTG,0,1960839
ihfAp4,0.3333333333333333,2,2,GGACGGTCCCTCCGGCGTAT,0,1942700
ihfAp4,0.3333333333333333,2,2,GGACGGGGAACCAGCAGATT,0,1922266
ihfAp4,0.3333333333333333,2,2,GGACCGACAGGATCGGGCAT,0,1916181
ihfAp4,0.3333333333333333,2,2,GGACCATCCATGCCATCCCT,0,1956498
ihfAp4,0.3333333333333333,2,2,GGACATGCAGAGGTATTACT,0,1961869
ihfAp4,0.3333333333333333,2,2,GGACAGACACTGCTCGCGAT,0,1921516
ihfAp4,0.3333333333333333,2,2,GGAATGTAAGGGCTTACATG,0,1957670
ihfAp4,0.3333333333333333,2,2,GGAATGCGAGTTCTCTTGGA,0,1922702
ihfAp4,0.3333333333333333,2,2,GGAATGAAACAACGGGCAAT,0,1914010
ihfAp4,0.3333333333333333,2,2,GGAAGTATGGGCCGCACGTC,0,1922725
ihfAp4,0.3333333333333333,2,2,GGAAGGGCACAACAGTCAAA,0,1954855
ihfAp4,0.3333333333333333,2,2,GGAAGCTCTGACAAACTATC,0,1922839
ihfAp4,0.3333333333333333,2,2,GGAAGATTTGGTATAAGTCT,0,1911297
ihfAp4,0.3333333333333333,2,2,GGAACGCAGGTCGCCTCACA,0,1924944
ihfAp4,0.3333333333333333,2,2,GGAACAAAGTCGCAACACCA,0,1922755
ihfAp4,0.3333333333333333,2,2,GGAAACGGCATATGCGGATC,0,1921271
ihfAp4,0.3333333333333333,2,2,GGAAAAAATCTGGCTTATTC,0,1951280
ihfAp4,0.3333333333333333,2,2,GCTTGGAAGTCACTGGTCTT,0,1954267
ihfAp4,0.3333333333333333,2,2,GCTTATTTTCTGATTAGTTG,0,1954860
ihfAp4,0.3333333333333333,2,2,GCTTACGTCGGGGTTCGAAC,0,1951919
ihfAp4,0.3333333333333333,2,2,GCTTACAGTGGAGACACCAG,0,1916648
ihfAp4,0.3333333333333333,2,2,GCTGTTGGCAGACACACCTC,0,1915656
ihfAp4,0.3333333333333333,2,2,GCTGTTGCCGCTGGCCTTAA,0,1937126
ihfAp4,0.3333333333333333,2,2,GCTGGAATGCGGGTACAATA,0,1957522
ihfAp4,0.3333333333333333,2,2,GCTGCTTCGGAACTACAAAG,0,1932728
ihfAp4,0.3333333333333333,2,2,GCTGCGCCACTCTCAAGAGA,0,1909654
ihfAp4,0.3333333333333333,2,2,GCTGAATTAACAGCGCAGAC,0,1960221
ihfAp4,0.3333333333333333,2,2,GCTCTGCATGGGGATTGCAG,0,1919051
ihfAp4,0.3333333333333333,2,2,GCTCTGAGATCCGAATAGCG,0,1931539
ihfAp4,0.3333333333333333,2,2,GCTATGCATTTTTACCCACG,0,1915596
ihfAp4,0.3333333333333333,2,2,GCTATAGGGGGACGGAGCAA,0,1924834
ihfAp4,0.3333333333333333,2,2,GCTAGGAAGTATATAAGCGA,0,1947780
ihfAp4,0.3333333333333333,2,2,GCTAGAGGTGCTTCTTCTTA,0,1913204
ihfAp4,0.3333333333333333,2,2,GCTACGACGGCGCCGCGAAA,0,1945503
ihfAp4,0.3333333333333333,2,2,GCGTGCGTTCGTTCTAGGTA,0,1948420
ihfAp4,0.3333333333333333,2,2,GCGTCGCACTCACATATGTT,0,1953299
ihfAp4,0.3333333333333333,2,2,GCGTCCGCTCTGGATCTTTA,0,1937616
ihfAp4,0.3333333333333333,2,2,GCGTCATGTATCGAAGGTGG,0,1919208
ihfAp4,0.3333333333333333,2,2,GCGTAGTCACGCCGGCCGCC,0,1921464
ihfAp4,0.3333333333333333,2,2,GCGTAGGACATCCCTAGGTG,0,1943700
ihfAp4,0.3333333333333333,2,2,GCGGTGTGTATGTTAGGCCA,0,1951522
ihfAp4,0.3333333333333333,2,2,GCGGTATTATTTAGCGCACA,0,1954257
ihfAp4,0.3333333333333333,2,2,GCGGGGAAAGGGGTAGTCTG,0,1919377
ihfAp4,0.3333333333333333,2,2,GCGGCCTATTAATGATCGGA,0,1946327
ihfAp4,0.3333333333333333,2,2,GCGCTTCCCGACATCGTGAC,0,1943400
ihfAp4,0.3333333333333333,2,2,GCGCTCGTATCGAGATTCAC,0,1952814
ihfAp4,0.3333333333333333,2,2,GCGCTCAGTCTCAATGGAGG,0,1921213
ihfAp4,0.3333333333333333,2,2,GCGCGCGTACCCGATTTAGA,0,1924992
ihfAp4,0.3333333333333333,2,2,GCGCGATGATAAGGTGTACA,0,1920290
ihfAp4,0.3333333333333333,2,2,GCGCCGGCGTGGGAGTTTGA,0,1936507
ihfAp4,0.3333333333333333,2,2,GCGCCCGCGGGTAGGAGAAT,0,1959321
ihfAp4,0.3333333333333333,2,2,GCGCCCACAAGGACGGGGCA,0,1932164
ihfAp4,0.3333333333333333,2,2,GCGCATGCTTACCAAACGAT,0,1917702
ihfAp4,0.3333333333333333,2,2,GCGCATGAGGGTGGTGCCGG,0,1948585
ihfAp4,0.3333333333333333,2,2,GCGCAATAGAGTGTACTCGA,0,1923232
ihfAp4,0.3333333333333333,2,2,GCGATTCGTAAACCTCGAGA,0,1912053
ihfAp4,0.3333333333333333,2,2,GCGATTAATATACATGTGCC,0,1932958
ihfAp4,0.3333333333333333,2,2,GCGAGAGTTCTATCTCTTAG,0,1928207
ihfAp4,0.3333333333333333,2,2,GCGACCTTGCAAGGAGTCAT,0,1951662
ihfAp4,0.3333333333333333,2,2,GCGACCGGGATTGGCCCGGA,0,1950621
ihfAp4,0.3333333333333333,2,2,GCCTTCAGCTATACTGGGGA,0,1920947
ihfAp4,0.3333333333333333,2,2,GCCTGTCGTAACAGGGCGCT,0,1958660
ihfAp4,0.3333333333333333,2,2,GCCTGAGAGTGCCCAGCGGC,0,1928246
ihfAp4,0.3333333333333333,2,2,GCCTCTTCTACAACAGTGCG,0,1923660
ihfAp4,0.3333333333333333,2,2,GCCTCTTAGGACCCCGAATA,0,1919669
ihfAp4,0.3333333333333333,2,2,GCCTCCACCAATTAGGACGT,0,1930576
ihfAp4,0.3333333333333333,2,2,GCCTCAGCACTTGGAGATCT,0,1932005
ihfAp4,0.3333333333333333,2,2,GCCGTGATAACGGGTACGGC,0,1914037
ihfAp4,0.3333333333333333,2,2,GCCGGTTAGTAGCGATAGTC,0,1920750
ihfAp4,0.3333333333333333,2,2,GCCGCAGGCGCCATCTGCTA,0,1915754
ihfAp4,0.3333333333333333,2,2,GCCGATGGACAGAGCCGACA,0,1925897
ihfAp4,0.3333333333333333,2,2,GCCGATGAGCTTACTGGACC,0,1911036
ihfAp4,0.3333333333333333,2,2,GCCCTACGCAAGTTCCTCGG,0,1953208
ihfAp4,0.3333333333333333,2,2,GCCCGTGCGGGATATCTCGT,0,1952006
ihfAp4,0.3333333333333333,2,2,GCCCCTCCGCATAACTAGAC,0,1938506
ihfAp4,0.3333333333333333,2,2,GCCCAAAGAGAAAATACTTT,0,1946200
ihfAp4,0.3333333333333333,2,2,GCCATGCTCGTAGTATCGCC,0,1947331
ihfAp4,0.3333333333333333,2,2,GCCATAATGCGAAGTTCCTG,0,1934646
ihfAp4,0.3333333333333333,2,2,GCCAGGAACCTCGTGCAGAT,0,1912128
ihfAp4,0.3333333333333333,2,2,GCCACTTGCATTGGGGGCAT,0,1961944
ihfAp4,0.3333333333333333,2,2,GCCACAGTTGCAGATATTCA,0,1932613
ihfAp4,0.3333333333333333,2,2,GCCAACGTACCTCAATATTG,0,1956897
ihfAp4,0.3333333333333333,2,2,GCCAAAATGCCTTCCACGCT,0,1929129
ihfAp4,0.3333333333333333,2,2,GCATGCCCGAACGATTAGAC,0,1956399
ihfAp4,0.3333333333333333,2,2,GCATCGCCCCCGGGAGGCGA,0,1950402
ihfAp4,0.3333333333333333,2,2,GCATCCGTTTAGCCATTAGT,0,1950034
ihfAp4,0.3333333333333333,2,2,GCATAGTCTTCGCCGCATCA,0,1933355
ihfAp4,0.3333333333333333,2,2,GCATAGGGGCATTCTCCATT,0,1926059
ihfAp4,0.3333333333333333,2,2,GCAGTTGCTACGTGTCGTCC,0,1911232
ihfAp4,0.3333333333333333,2,2,GCAGCCTGTACCGAAGACGC,0,1953395
ihfAp4,0.3333333333333333,2,2,GCAGCCGGTACGTACCTTAC,0,1913762
ihfAp4,0.3333333333333333,2,2,GCAGCATATGTCGTGGCAAT,0,1918396
ihfAp4,0.3333333333333333,2,2,GCAGATTTTTTTAACGAGTT,0,1931646
ihfAp4,0.3333333333333333,2,2,GCAGATGCCTCCTAATTCTC,0,1915652
ihfAp4,0.3333333333333333,2,2,GCACTTATGGGGTTTTGTCG,0,1951868
ihfAp4,0.3333333333333333,2,2,GCACTCGTCATATCGGGACT,0,1959953
ihfAp4,0.3333333333333333,2,2,GCACTAGGAGCGAGTCAAAG,0,1917746
ihfAp4,0.3333333333333333,2,2,GCACGTTCGGTTCCATTTCA,0,1945729
ihfAp4,0.3333333333333333,2,2,GCACGATCAGCGAAGAGTTG,0,1957770
ihfAp4,0.3333333333333333,2,2,GCACCACACAGCAGGGTGAG,0,1948503
ihfAp4,0.3333333333333333,2,2,GCAATAATCCGTTCTAAATT,0,1933483
ihfAp4,0.3333333333333333,2,2,GCAAGTTGACTGTAAGCGGA,0,1926048
ihfAp4,0.3333333333333333,2,2,GCAACTTTATGCTATCCGAA,0,1937933
ihfAp4,0.3333333333333333,2,2,GCAACGTCGAGCTTGTCATC,0,1919566
ihfAp4,0.3333333333333333,2,2,GCAAACCACCCAAGTTGCCT,0,1948342
ihfAp4,0.3333333333333333,2,2,GATTTTGGGGGGTGTACGTT,0,1917071
ihfAp4,0.3333333333333333,2,2,GATTTCCTTACCGGACTGAA,0,1923614
ihfAp4,0.3333333333333333,2,2,GATTTCAGAGTTTCGAACTA,0,1930399
ihfAp4,0.3333333333333333,2,2,GATTGTCAGGTCATAAGTCT,0,1917951
ihfAp4,0.3333333333333333,2,2,GATTGCGCGTGTACGCCACA,0,1926620
ihfAp4,0.3333333333333333,2,2,GATTCGAACTCTTGATATAG,0,1947267
ihfAp4,0.3333333333333333,2,2,GATTCCACATCAGTTCAAAT,0,1948467
ihfAp4,0.3333333333333333,2,2,GATTAGGGTCCCAGGAACGC,0,1917033
ihfAp4,0.3333333333333333,2,2,GATTAGGAGCAGGTGTAGGC,0,1919032
ihfAp4,0.3333333333333333,2,2,GATTAGGAACCGAATGGGCT,0,1926258
ihfAp4,0.3333333333333333,2,2,GATGGTTAGCGGACTGACAC,0,1951846
ihfAp4,0.3333333333333333,2,2,GATGGTCAGCGCTACGGACA,0,1945689
ihfAp4,0.3333333333333333,2,2,GATGGGAACGGCTCATACCT,0,1936958
ihfAp4,0.3333333333333333,2,2,GATGGCGACAATAAGTTGTA,0,1947674
ihfAp4,0.3333333333333333,2,2,GATGCGGATAGCTTCCGGCG,0,1936654
ihfAp4,0.3333333333333333,2,2,GATGCCATGTGGGGCTTATA,0,1916389
ihfAp4,0.3333333333333333,2,2,GATGATCCAAAGTTGCATAC,0,1944754
ihfAp4,0.3333333333333333,2,2,GATCTAAGGATTAACCATGA,0,1937713
ihfAp4,0.3333333333333333,2,2,GATCTAAGATAAAAACAATG,0,1927238
ihfAp4,0.3333333333333333,2,2,GATCGGGCTTCCCTAACGAA,0,1960885
ihfAp4,0.3333333333333333,2,2,GATCGGAGCTAAACAGGATG,0,1910044
ihfAp4,0.3333333333333333,2,2,GATCGAGGCTCCATACGTAA,0,1959082
ihfAp4,0.3333333333333333,2,2,GATCCTGCCGGTGACGCTAC,0,1940212
ihfAp4,0.3333333333333333,2,2,GATCAAGGTTACCTGACAAC,0,1932539
ihfAp4,0.3333333333333333,2,2,GATATTGTCAGCATTTATAC,0,1947015
ihfAp4,0.3333333333333333,2,2,GATATCTTGCATGATTACCA,0,1957965
ihfAp4,0.3333333333333333,2,2,GATAGGTGTTTTGACGTAAT,0,1949722
ihfAp4,0.3333333333333333,2,2,GATAGGACTGGTATTTCTTG,0,1928330
ihfAp4,0.3333333333333333,2,2,GATAGCCGGCAAGGTTGTCG,0,1941854
ihfAp4,0.3333333333333333,2,2,GATACAGGCCACGCACTTCT,0,1956266
ihfAp4,0.3333333333333333,2,2,GATAATTGGGGATCCGATGT,0,1951486
ihfAp4,0.3333333333333333,2,2,GATAAGGGTACGGTTAGTTT,0,1914850
ihfAp4,0.3333333333333333,2,2,GATAAGAACCGAATAAGCGA,0,1932472
ihfAp4,0.3333333333333333,2,2,GATAACTGAAGCTTAGACGA,0,1924408
ihfAp4,0.3333333333333333,2,2,GATAAAGATGCCCCGCCCGT,0,1925889
ihfAp4,0.3333333333333333,2,2,GAGTTGTCCGAACGAGTATA,0,1954074
ihfAp4,0.3333333333333333,2,2,GAGTGGCTGACCATGCGCCT,0,1946207
ihfAp4,0.3333333333333333,2,2,GAGTGCCGCGCTCCACACGG,0,1922453
ihfAp4,0.3333333333333333,2,2,GAGTCTGGCTATTAAGCGAT,0,1914597
ihfAp4,0.3333333333333333,2,2,GAGTAGGAGTTAAGGATGCT,0,1930192
ihfAp4,0.3333333333333333,2,2,GAGGTTCAACTATCGGTCAC,0,1953973
ihfAp4,0.3333333333333333,2,2,GAGGTCAGTGACCCACTTAC,0,1950051
ihfAp4,0.3333333333333333,2,2,GAGGTACCCACGCGAGTCTA,0,1934870
ihfAp4,0.3333333333333333,2,2,GAGGGGTGATTATCGTATGT,0,1911343
ihfAp4,0.3333333333333333,2,2,GAGGGGAAATCTTAGCGGCC,0,1912068
ihfAp4,0.3333333333333333,2,2,GAGGGCATACCAGGTTGGTA,0,1959671
ihfAp4,0.3333333333333333,2,2,GAGGGCAGTAGATATGGCCA,0,1914536
ihfAp4,0.3333333333333333,2,2,GAGGGCAATGCAACTTTAAG,0,1924145
ihfAp4,0.3333333333333333,2,2,GAGGCTGCGACCGTAGTTGG,0,1938809
ihfAp4,0.3333333333333333,2,2,GAGGCGTAGCAATTCGCTTT,0,1946848
ihfAp4,0.3333333333333333,2,2,GAGGATGTCTACAGCAACGA,0,1915144
ihfAp4,0.3333333333333333,2,2,GAGGAGATCAGTTAATTCCT,0,1933017
ihfAp4,0.3333333333333333,2,2,GAGGAACCCGAATAAGTACT,0,1938152
ihfAp4,0.3333333333333333,2,2,GAGCTGCTTATAATTGGGTC,0,1948124
ihfAp4,0.3333333333333333,2,2,GAGCTAGGTTTCCCGTGAAT,0,1944622
ihfAp4,0.3333333333333333,2,2,GAGCTAATTCTGGTATTACT,0,1937464
ihfAp4,0.3333333333333333,2,2,GAGCGTAGAACCTGGTCGAT,0,1960218
ihfAp4,0.3333333333333333,2,2,GAGCGCGGCTACGGTCATAC,0,1928443
ihfAp4,0.3333333333333333,2,2,GAGCCACCTTCTGGTAGATC,0,1931483
ihfAp4,0.3333333333333333,2,2,GAGCAGGTATTCTTTTTGAT,0,1912659
ihfAp4,0.3333333333333333,2,2,GAGATGGAGTGGAAAGGGCA,0,1929882
ihfAp4,0.3333333333333333,2,2,GAGAACTATAGTATCTTTTC,0,1933607
ihfAp4,0.3333333333333333,2,2,GACTCGGTAATAGCTAGGCG,0,1950328
ihfAp4,0.3333333333333333,2,2,GACTCGGGTATTTCACTCAT,0,1938384
ihfAp4,0.3333333333333333,2,2,GACTCGGGACGCTGGCGGCT,0,1952488
ihfAp4,0.3333333333333333,2,2,GACTCAGTACGTGATACAAT,0,1932498
ihfAp4,0.3333333333333333,2,2,GACTACACTCACAGGATCAT,0,1925710
ihfAp4,0.3333333333333333,2,2,GACGTGTTGGCTCGGCCGTC,0,1912849
ihfAp4,0.3333333333333333,2,2,GACGGCTACAATCACTTCGT,0,1929104
ihfAp4,0.3333333333333333,2,2,GACGGCGGATCTCCAGAGGT,0,1925334
ihfAp4,0.3333333333333333,2,2,GACGCAACCGTTTTGGACGG,0,1931876
ihfAp4,0.3333333333333333,2,2,GACGAGTCGCGACTGCGAAG,0,1953756
ihfAp4,0.3333333333333333,2,2,GACGAAGTGTTTGAACGTAA,0,1913165
ihfAp4,0.3333333333333333,2,2,GACCTGGGCTACACGATACC,0,1961272
ihfAp4,0.3333333333333333,2,2,GACCGCCTTGAATCTGCAGC,0,1919492
ihfAp4,0.3333333333333333,2,2,GACCGATTCTTAATACGAGA,0,1915219
ihfAp4,0.3333333333333333,2,2,GACCCTGTCTTAAAGGATAG,0,1942721
ihfAp4,0.3333333333333333,2,2,GACCCGTTACAGCTAACCCG,0,1932263
ihfAp4,0.3333333333333333,2,2,GACCAGCAATCGCAGGGTCT,0,1917765
ihfAp4,0.3333333333333333,2,2,GACCAAAGGCATTAGTAAAC,0,1926385
ihfAp4,0.3333333333333333,2,2,GACATATAAGCCCTAGTCGT,0,1952499
ihfAp4,0.3333333333333333,2,2,GACACACACTGCTTTCAGGT,0,1952851
ihfAp4,0.3333333333333333,2,2,GACAAGGCAGTATCCCACAT,0,1952917
ihfAp4,0.3333333333333333,2,2,GAATTGGGCTCAAAGCTGGC,0,1949677
ihfAp4,0.3333333333333333,2,2,GAATGCTCAGGAACTATCTT,0,1957897
ihfAp4,0.3333333333333333,2,2,GAATCATGCAATTGAATGTC,0,1961886
ihfAp4,0.3333333333333333,2,2,GAATCACGGGGCCACAGCGC,0,1927292
ihfAp4,0.3333333333333333,2,2,GAATCAATAGTAGTGCACTC,0,1915601
ihfAp4,0.3333333333333333,2,2,GAATAGTTCGGTATCTCCTT,0,1946439
ihfAp4,0.3333333333333333,2,2,GAATACGTTTGGACTGCTGG,0,1945458
ihfAp4,0.3333333333333333,2,2,GAAGTGATAGTTAGGATCGT,0,1957884
ihfAp4,0.3333333333333333,2,2,GAAGTCTTGAATCCCCTGTT,0,1922454
ihfAp4,0.3333333333333333,2,2,GAAGCCACACTTCAATTCAA,0,1933908
ihfAp4,0.3333333333333333,2,2,GAAGAGTACATCTTCGCTAT,0,1914508
ihfAp4,0.3333333333333333,2,2,GAACTTGCTGTATGCGGTCT,0,1926275
ihfAp4,0.3333333333333333,2,2,GAACTGGTTTGTACAACATG,0,1911220
ihfAp4,0.3333333333333333,2,2,GAACTCTTTACATGATTTGC,0,1960940
ihfAp4,0.3333333333333333,2,2,GAACGGTTGATGGGGTTTAA,0,1955079
ihfAp4,0.3333333333333333,2,2,GAACATCTCTGCGCAATTGC,0,1958210
ihfAp4,0.3333333333333333,2,2,GAACAAGTGAAAATTCTTTG,0,1941481
ihfAp4,0.3333333333333333,2,2,GAAATTGCACGTATAAGGCT,0,1910658
ihfAp4,0.3333333333333333,2,2,GAAAGTCAGTCGTAGCAGGA,0,1918180
ihfAp4,0.3333333333333333,2,2,CTTTTTTCTTCCGAGAAAAA,0,1921214
ihfAp4,0.3333333333333333,2,2,CTTTTCTGTATGTGTCTCGG,0,1912606
ihfAp4,0.3333333333333333,2,2,CTTTGGCCGGATGCAGCCTA,0,1941533
ihfAp4,0.3333333333333333,2,2,CTTTGCCATAGTTCCTTGGC,0,1933854
ihfAp4,0.3333333333333333,2,2,CTTTCGGACGACTAGCCAGC,0,1912192
ihfAp4,0.3333333333333333,2,2,CTTTATGTGCTCGGACGATG,0,1921900
ihfAp4,0.3333333333333333,2,2,CTTTATATCAAGACATCCCG,0,1931912
ihfAp4,0.3333333333333333,2,2,CTTGTGGGACGTTTATAGAA,0,1909946
ihfAp4,0.3333333333333333,2,2,CTTGCTTTGGCCGCACACGA,0,1929336
ihfAp4,0.3333333333333333,2,2,CTTGCTAGTGACAGTCGATT,0,1947611
ihfAp4,0.3333333333333333,2,2,CTTGATAATGCGGTTCAGAT,0,1957323
ihfAp4,0.3333333333333333,2,2,CTTCGGCATTACTAAATATG,0,1923183
ihfAp4,0.3333333333333333,2,2,CTTCCTAAAGCCTAATGAAC,0,1914729
ihfAp4,0.3333333333333333,2,2,CTTCCACCAAGTTCAACGGA,0,1911400
ihfAp4,0.3333333333333333,2,2,CTTCAGTGGGGCTTACTATC,0,1943409
ihfAp4,0.3333333333333333,2,2,CTTCAATATATGACTTGCTA,0,1960413
ihfAp4,0.3333333333333333,2,2,CTTAGAGCACGTACCGACTT,0,1955391
ihfAp4,0.3333333333333333,2,2,CTTACGGAGACCAGGGTGGC,0,1939586
ihfAp4,0.3333333333333333,2,2,CTTAACTTAGGCATGAGGCG,0,1939895
ihfAp4,0.3333333333333333,2,2,CTGTTTCATGTAAAGTCCGA,0,1951203
ihfAp4,0.3333333333333333,2,2,CTGTGTCCACAGAGAAAGAC,0,1958226
ihfAp4,0.3333333333333333,2,2,CTGTGCCGTGTCGAAGGTTT,0,1939385
ihfAp4,0.3333333333333333,2,2,CTGTGAGGTATGGATGGCGA,0,1945875
ihfAp4,0.3333333333333333,2,2,CTGTGAATTACTATTGTTAT,0,1917360
ihfAp4,0.3333333333333333,2,2,CTGTAAAACCGTCCTAATGG,0,1918559
ihfAp4,0.3333333333333333,2,2,CTGGTAGCGTAAAATTGTTG,0,1937368
ihfAp4,0.3333333333333333,2,2,CTGGGGACAAACTACCGAGA,0,1943180
ihfAp4,0.3333333333333333,2,2,CTGGGCGACCCCTGCACTAC,0,1947757
ihfAp4,0.3333333333333333,2,2,CTGGGACGTGTGTCCAATGG,0,1938991
ihfAp4,0.3333333333333333,2,2,CTGGACTTAACACGCTTTTC,0,1910121
ihfAp4,0.3333333333333333,2,2,CTGCGCGAAATCACGGTTCA,0,1949184
ihfAp4,0.3333333333333333,2,2,CTGCGAGGACATGGAATAGC,0,1918099
ihfAp4,0.3333333333333333,2,2,CTGCATAGCACACCCCCTTA,0,1937055
ihfAp4,0.3333333333333333,2,2,CTGCAGAGTTTGACCCTGTT,0,1941385
ihfAp4,0.3333333333333333,2,2,CTGAGGGTAAGTCACTGCTG,0,1927751
ihfAp4,0.3333333333333333,2,2,CTGAGACCTCGTCGTAATCT,0,1941571
ihfAp4,0.3333333333333333,2,2,CTGACTCAAGTGGAGTCGTT,0,1929718
ihfAp4,0.3333333333333333,2,2,CTGACATCGTTGATGTACCG,0,1934244
ihfAp4,0.3333333333333333,2,2,CTGACAGATAAAAAGGACTT,0,1956123
ihfAp4,0.3333333333333333,2,2,CTGAACCTGTATGCATCGGT,0,1919217
ihfAp4,0.3333333333333333,2,2,CTGAACCATACAGGTGGAAC,0,1943893
ihfAp4,0.3333333333333333,2,2,CTCTTTCCAGGGGAGTCCAG,0,1944551
ihfAp4,0.3333333333333333,2,2,CTCTTAAGTTCGCCCGAGGC,0,1940666
ihfAp4,0.3333333333333333,2,2,CTCTGTGGCCAAGAGCGACA,0,1935736
ihfAp4,0.3333333333333333,2,2,CTCTCCGGATTAACGAGTGC,0,1914967
ihfAp4,0.3333333333333333,2,2,CTCTCCATTCCGTACCCTTG,0,1922588
ihfAp4,0.3333333333333333,2,2,CTCTAGCGTGTACGCATTAT,0,1933747
ihfAp4,0.3333333333333333,2,2,CTCTAGCAATAAGACGCAAC,0,1914863
ihfAp4,0.3333333333333333,2,2,CTCGTGATACCGTAACGCAT,0,1942299
ihfAp4,0.3333333333333333,2,2,CTCGTATCTTCAACAGGCTA,0,1913839
ihfAp4,0.3333333333333333,2,2,CTCGTACCGCCTAAAAACAC,0,1938665
ihfAp4,0.3333333333333333,2,2,CTCGTAACCCATACGTTCAC,0,1942081
ihfAp4,0.3333333333333333,2,2,CTCGGTCCGAAATTTAGATG,0,1952327
ihfAp4,0.3333333333333333,2,2,CTCGGGTTACGTGAGAATCA,0,1917522
ihfAp4,0.3333333333333333,2,2,CTCGCTAGCAAATGCGAATC,0,1936582
ihfAp4,0.3333333333333333,2,2,CTCGATGGAGCGGAAGGGCA,0,1958363
ihfAp4,0.3333333333333333,2,2,CTCGATCGACCCGCCCCGAT,0,1916965
ihfAp4,0.3333333333333333,2,2,CTCGATCCAAGCGGTCCTTC,0,1961112
ihfAp4,0.3333333333333333,2,2,CTCGAGCGTCCTTGGCCCCG,0,1949833
ihfAp4,0.3333333333333333,2,2,CTCCTGGGGTGGGTGATTAG,0,1945055
ihfAp4,0.3333333333333333,2,2,CTCCTACTTCAAACACCCGG,0,1926047
ihfAp4,0.3333333333333333,2,2,CTCCGGGGTCAGGGCAATGG,0,1941887
ihfAp4,0.3333333333333333,2,2,CTCCGCTTATACGGGGGAAA,0,1957851
ihfAp4,0.3333333333333333,2,2,CTCCGCCACGCGATATTTCG,0,1944579
ihfAp4,0.3333333333333333,2,2,CTCCGCATAGCGTCTAGCAC,0,1941890
ihfAp4,0.3333333333333333,2,2,CTCCGAGGAAACAGGCAAAC,0,1916388
ihfAp4,0.3333333333333333,2,2,CTCCGACGATTCTTTGAACA,0,1947478
ihfAp4,0.3333333333333333,2,2,CTCCCTTCGCCACCCTTGTT,0,1935046
ihfAp4,0.3333333333333333,2,2,CTCCCTTACTGTAACTGCTA,0,1925725
ihfAp4,0.3333333333333333,2,2,CTCCCCCCGTCGAAGGTAAA,0,1918081
ihfAp4,0.3333333333333333,2,2,CTCATTCTAACCCGGGGCGC,0,1918737
ihfAp4,0.3333333333333333,2,2,CTCAGTATGGGGGTTCAAGT,0,1955819
ihfAp4,0.3333333333333333,2,2,CTCAGGCTGTCTAAGACATT,0,1933820
ihfAp4,0.3333333333333333,2,2,CTCACAGACCCAGGGATAGT,0,1935934
ihfAp4,0.3333333333333333,2,2,CTCACAAACTTCGCTAGAAA,0,1932011
ihfAp4,0.3333333333333333,2,2,CTCAAGATAAGGCTGGGGAC,0,1952901
ihfAp4,0.3333333333333333,2,2,CTCAAAATTCCCCCATCACG,0,1932512
ihfAp4,0.3333333333333333,2,2,CTATTGGATCGATGGTTAGC,0,1947601
ihfAp4,0.3333333333333333,2,2,CTATGGCATAGCGAGAGAAA,0,1955964
ihfAp4,0.3333333333333333,2,2,CTATCGAAAGCGTTGGTAAA,0,1930823
ihfAp4,0.3333333333333333,2,2,CTATATTAGTCCCAGCATAC,0,1961577
ihfAp4,0.3333333333333333,2,2,CTATAGTGAGCCACTAACCG,0,1928787
ihfAp4,0.3333333333333333,2,2,CTAGGAATATTTTAGGAGCT,0,1941341
ihfAp4,0.3333333333333333,2,2,CTAGGAACCACGGATGTTGC,0,1937252
ihfAp4,0.3333333333333333,2,2,CTACTCCTCGGGTGACCAGA,0,1920834
ihfAp4,0.3333333333333333,2,2,CTACATTCAAAGTAAAGAAT,0,1931998
ihfAp4,0.3333333333333333,2,2,CTAATGTGCACGAGGCTGGA,0,1943534
ihfAp4,0.3333333333333333,2,2,CTAATGCTAAGTGTACGGGG,0,1944091
ihfAp4,0.3333333333333333,2,2,CTAATCAGGTCCGTGATAGT,0,1932656
ihfAp4,0.3333333333333333,2,2,CTAAGAGCCGTTGATACCCC,0,1923063
ihfAp4,0.3333333333333333,2,2,CTAACGATACTTCCTTACAC,0,1945041
ihfAp4,0.3333333333333333,2,2,CTAACATCTGGGGTATTAGT,0,1920437
ihfAp4,0.3333333333333333,2,2,CTAACACTGATGGCCCTACT,0,1925248
ihfAp4,0.3333333333333333,2,2,CTAACAAGTGAGTGTGATAG,0,1960508
ihfAp4,0.3333333333333333,2,2,CTAAAACGGTATTGTCAGAT,0,1924750
ihfAp4,0.3333333333333333,2,2,CGTTTAGGATGCATATATAA,0,1948530
ihfAp4,0.3333333333333333,2,2,CGTTTAGACTGAAGAAGGCG,0,1950069
ihfAp4,0.3333333333333333,2,2,CGTTGGTACCCGAAGCGCGC,0,1944951
ihfAp4,0.3333333333333333,2,2,CGTTCGTTGATTAAGCCGAC,0,1913339
ihfAp4,0.3333333333333333,2,2,CGTTCCTAGCATTACCAAGA,0,1933705
ihfAp4,0.3333333333333333,2,2,CGTTCATTGGTCTACCTTGT,0,1924726
ihfAp4,0.3333333333333333,2,2,CGTTCACCTATCTTGTAATA,0,1956216
ihfAp4,0.3333333333333333,2,2,CGTGTTTTTACCCACTGGTC,0,1927475
ihfAp4,0.3333333333333333,2,2,CGTGTGGCATAGTGAATTGA,0,1937636
ihfAp4,0.3333333333333333,2,2,CGTCTGGTGATTACCCCATC,0,1946450
ihfAp4,0.3333333333333333,2,2,CGTCTGATCAGACGCGAATA,0,1939783
ihfAp4,0.3333333333333333,2,2,CGTCTACTTCAGAGTTTGGG,0,1933833
ihfAp4,0.3333333333333333,2,2,CGTCGGGCTCGGCCACTGTA,0,1937920
ihfAp4,0.3333333333333333,2,2,CGTCCTTATGGAAAGGATTG,0,1950772
ihfAp4,0.3333333333333333,2,2,CGTCCCAGAGTTATTCGACA,0,1928565
ihfAp4,0.3333333333333333,2,2,CGTCAGTAATTGCGTAATGT,0,1948134
ihfAp4,0.3333333333333333,2,2,CGTCAAAGCGATCCGTTCGT,0,1933823
ihfAp4,0.3333333333333333,2,2,CGTATGTATCTCTAGGCACT,0,1919481
ihfAp4,0.3333333333333333,2,2,CGTAGGATAAGCATTAGCAG,0,1923067
ihfAp4,0.3333333333333333,2,2,CGTAAAAAAACCCTTCCGCC,0,1943914
ihfAp4,0.3333333333333333,2,2,CGGTTTGGACATTGGACTGT,0,1927876
ihfAp4,0.3333333333333333,2,2,CGGTTGTCGAACACCAGAAG,0,1933534
ihfAp4,0.3333333333333333,2,2,CGGTTCATACTCTGCACGAC,0,1951229
ihfAp4,0.3333333333333333,2,2,CGGTTAAAACCAACATATGG,0,1945876
ihfAp4,0.3333333333333333,2,2,CGGTGAGATTCTATGACCCA,0,1956632
ihfAp4,0.3333333333333333,2,2,CGGTCGTTCAGTCCGGGAAT,0,1910476
ihfAp4,0.3333333333333333,2,2,CGGTCCGGGCGATGTTATGG,0,1923899
ihfAp4,0.3333333333333333,2,2,CGGTATTGGGACTGTGTTAC,0,1941402
ihfAp4,0.3333333333333333,2,2,CGGGTTCCAAGTTGCCCAGA,0,1939817
ihfAp4,0.3333333333333333,2,2,CGGGTATTGTTTACCCCAGG,0,1912095
ihfAp4,0.3333333333333333,2,2,CGGGTAATTATTAATGTTTC,0,1950914
ihfAp4,0.3333333333333333,2,2,CGGGTAACTTTAACTTTTAA,0,1934470
ihfAp4,0.3333333333333333,2,2,CGGGGTTGGACCCCGTACAC,0,1934528
ihfAp4,0.3333333333333333,2,2,CGGGCGAATGATCATCAGGC,0,1949086
ihfAp4,0.3333333333333333,2,2,CGGGCCTACGTGTGACAGAG,0,1927225
ihfAp4,0.3333333333333333,2,2,CGGGCCGAGGACTGATTGCG,0,1941881
ihfAp4,0.3333333333333333,2,2,CGGGATCCCGGCTACTGGTA,0,1938195
ihfAp4,0.3333333333333333,2,2,CGGGAGTTCGGTTACCTCCT,0,1909808
ihfAp4,0.3333333333333333,2,2,CGGGAGTAATGCGGTCTGGG,0,1913580
ihfAp4,0.3333333333333333,2,2,CGGCTCGATCTTGGTGTTGA,0,1958784
ihfAp4,0.3333333333333333,2,2,CGGCTCCCCATGATCTGAAT,0,1956173
ihfAp4,0.3333333333333333,2,2,CGGCTACGCACTAAAGCGTC,0,1952149
ihfAp4,0.3333333333333333,2,2,CGGCGGGGAGACACGCCTTC,0,1956330
ihfAp4,0.3333333333333333,2,2,CGGCGCCTGCGTTAGTTAGA,0,1923194
ihfAp4,0.3333333333333333,2,2,CGGCGCAGCGATCAAGTGTC,0,1938165
ihfAp4,0.3333333333333333,2,2,CGGCAATACCGTCAAGTGAG,0,1961644
ihfAp4,0.3333333333333333,2,2,CGGCAAACAGAACTAGGGAA,0,1935002
ihfAp4,0.3333333333333333,2,2,CGGATTCTCTAGTTCGCACA,0,1910641
ihfAp4,0.3333333333333333,2,2,CGGATCCGCATTGCAGTGGA,0,1929667
ihfAp4,0.3333333333333333,2,2,CGGATACTCGTTTGGGTGGG,0,1958942
ihfAp4,0.3333333333333333,2,2,CGGAGTACTACCGACAATCT,0,1940662
ihfAp4,0.3333333333333333,2,2,CGGAGGCCCGCATATAGTAC,0,1941114
ihfAp4,0.3333333333333333,2,2,CGGAGCTCAAATTCCGTAAA,0,1943795
ihfAp4,0.3333333333333333,2,2,CGGAGCTAATCAGTCATTTC,0,1926432
ihfAp4,0.3333333333333333,2,2,CGGAGACCGACGACGTATTT,0,1915565
ihfAp4,0.3333333333333333,2,2,CGGACGCTACGTCGATGCGG,0,1936163
ihfAp4,0.3333333333333333,2,2,CGGACCCGGTTAGTTTGAAC,0,1922126
ihfAp4,0.3333333333333333,2,2,CGGACAGGGATAAAGTTATA,0,1952571
ihfAp4,0.3333333333333333,2,2,CGGAATCCTCTTCCATTACC,0,1934186
ihfAp4,0.3333333333333333,2,2,CGGAAGTCTAGGAGGTTCAT,0,1933339
ihfAp4,0.3333333333333333,2,2,CGCTGTAACGAAACATCTAG,0,1945423
ihfAp4,0.3333333333333333,2,2,CGCTGACGCCTACTGTATAG,0,1961913
ihfAp4,0.3333333333333333,2,2,CGCTATAGGCCAGTTTCGGT,0,1932665
ihfAp4,0.3333333333333333,2,2,CGCTAGGCCCAGCTGCAGGG,0,1935087
ihfAp4,0.3333333333333333,2,2,CGCTAAAGAACTAATATGAT,0,1933990
ihfAp4,0.3333333333333333,2,2,CGCGTTCTGGTTTCCCCGCA,0,1949720
ihfAp4,0.3333333333333333,2,2,CGCGTCGTAGTGGCCCGGTT,0,1940898
ihfAp4,0.3333333333333333,2,2,CGCGCCTGGCGTATATGAGG,0,1925040
ihfAp4,0.3333333333333333,2,2,CGCGCCACACCTCCACAGAC,0,1944944
ihfAp4,0.3333333333333333,2,2,CGCCTGTACGACTCTTAGTG,0,1927317
ihfAp4,0.3333333333333333,2,2,CGCCCTTAGGCGTCTATTTC,0,1914828
ihfAp4,0.3333333333333333,2,2,CGCCAGCCGTGGCGTTTTAC,0,1961256
ihfAp4,0.3333333333333333,2,2,CGCCACCACCTTGACGCCTA,0,1920099
ihfAp4,0.3333333333333333,2,2,CGCATAAACATGCCGTCGCG,0,1961447
ihfAp4,0.3333333333333333,2,2,CGATTGGGCAAAGCGCTCTG,0,1941621
ihfAp4,0.3333333333333333,2,2,CGATGAGTATGGGCGAAATT,0,1943922
ihfAp4,0.3333333333333333,2,2,CGATGAGAAATGGGTACCAG,0,1960191
ihfAp4,0.3333333333333333,2,2,CGATGAACATTTGCTCTATT,0,1953265
ihfAp4,0.3333333333333333,2,2,CGATCGAGTGACATAGATAT,0,1937039
ihfAp4,0.3333333333333333,2,2,CGAGTTGCCTTTCAGGTTTA,0,1923036
ihfAp4,0.3333333333333333,2,2,CGAGTCATGTGAAGCGATTC,0,1932760
ihfAp4,0.3333333333333333,2,2,CGAGGTGCGATCTGCACGAG,0,1949979
ihfAp4,0.3333333333333333,2,2,CGAGGGCTTGATCTGGGGTG,0,1948490
ihfAp4,0.3333333333333333,2,2,CGAGGCGGGCGCGCGCTTAG,0,1949624
ihfAp4,0.3333333333333333,2,2,CGAGGATAGCAACGGTCATG,0,1912038
ihfAp4,0.3333333333333333,2,2,CGAGGAGTGCACATTCGGAT,0,1954307
ihfAp4,0.3333333333333333,2,2,CGAGGAACGCCAATGAGTGT,0,1919379
ihfAp4,0.3333333333333333,2,2,CGAGACGATCGATTCTGTAA,0,1942510
ihfAp4,0.3333333333333333,2,2,CGACGGACCGAAAGCTTAAA,0,1927001
ihfAp4,0.3333333333333333,2,2,CGACGAGAGGCCATAACGGT,0,1939964
ihfAp4,0.3333333333333333,2,2,CGACCGGGGAACGCTTGTTT,0,1920327
ihfAp4,0.3333333333333333,2,2,CGACCATGGACTAATCACGA,0,1930299
ihfAp4,0.3333333333333333,2,2,CGACACATCTATTGACTGAT,0,1918712
ihfAp4,0.3333333333333333,2,2,CGAATAATATCGGGATGCAA,0,1909884
ihfAp4,0.3333333333333333,2,2,CGAACACTTAAAGTAGAACC,0,1914285
ihfAp4,0.3333333333333333,2,2,CCTTTCTTGAAGAGCTGCTA,0,1925395
ihfAp4,0.3333333333333333,2,2,CCTTTCCCATATATCAAACA,0,1935573
ihfAp4,0.3333333333333333,2,2,CCTTTAGAACCGATAGTGCG,0,1932917
ihfAp4,0.3333333333333333,2,2,CCTTCTTAACTCCGCCGACC,0,1917509
ihfAp4,0.3333333333333333,2,2,CCTTCTGCCACCCCGTAGTA,0,1917875
ihfAp4,0.3333333333333333,2,2,CCTTCAACTCATCTCCTTGG,0,1911647
ihfAp4,0.3333333333333333,2,2,CCTGTTAGGTGGGACGGCAA,0,1919121
ihfAp4,0.3333333333333333,2,2,CCTGTGTAGGGTGTGTCCTC,0,1958426
ihfAp4,0.3333333333333333,2,2,CCTGTGCTTTTCCACTCGCG,0,1937090
ihfAp4,0.3333333333333333,2,2,CCTGTATCCAATATGATCCT,0,1946013
ihfAp4,0.3333333333333333,2,2,CCTGCTTTTGCGGCTATTTG,0,1958596
ihfAp4,0.3333333333333333,2,2,CCTGACTTCGCAGCCTGGTA,0,1916397
ihfAp4,0.3333333333333333,2,2,CCTCTTGTTACGTTTGTAGG,0,1929699
ihfAp4,0.3333333333333333,2,2,CCTCTACAGTTTAATTGAAA,0,1917542
ihfAp4,0.3333333333333333,2,2,CCTCGGGCACTTTATTTGTT,0,1956562
ihfAp4,0.3333333333333333,2,2,CCTCGGCCTAGTCAACCCGG,0,1935396
ihfAp4,0.3333333333333333,2,2,CCTCCGAGTGGCGGCAGTGC,0,1936997
ihfAp4,0.3333333333333333,2,2,CCTCACGGTGGTAAAAGGCC,0,1945975
ihfAp4,0.3333333333333333,2,2,CCTATAGGAAATCAGTCTGT,0,1910790
ihfAp4,0.3333333333333333,2,2,CCTAGCCTAGGGCAAGCACG,0,1939159
ihfAp4,0.3333333333333333,2,2,CCTAGAGGGGATATGATACC,0,1940244
ihfAp4,0.3333333333333333,2,2,CCTAACTGACTGGCCACTGG,0,1915924
ihfAp4,0.3333333333333333,2,2,CCGTTTTGCTGCCGCTAAGG,0,1961885
ihfAp4,0.3333333333333333,2,2,CCGTTTCTACAACCCCCTTG,0,1960629
ihfAp4,0.3333333333333333,2,2,CCGTTGTGCCTGATTCTGTA,0,1958960
ihfAp4,0.3333333333333333,2,2,CCGTCTTTTCTCCCCCCAAC,0,1914088
ihfAp4,0.3333333333333333,2,2,CCGTCTGTGTTTAGGTTGAT,0,1922297
ihfAp4,0.3333333333333333,2,2,CCGTACCCGGGTGTCCCCGT,0,1960549
ihfAp4,0.3333333333333333,2,2,CCGGTTAGGGGTGAAAGCAT,0,1946130
ihfAp4,0.3333333333333333,2,2,CCGGGCGTCAATCTTCTTTC,0,1939329
ihfAp4,0.3333333333333333,2,2,CCGGGACCCGCTCATAATTT,0,1919154
ihfAp4,0.3333333333333333,2,2,CCGGCTGGTGCTGATACCAA,0,1945479
ihfAp4,0.3333333333333333,2,2,CCGGCAGTGTCCTAAATATC,0,1928747
ihfAp4,0.3333333333333333,2,2,CCGGAGCTTATTTAACTGCT,0,1934296
ihfAp4,0.3333333333333333,2,2,CCGCTCGAGTCGTACATGCC,0,1946831
ihfAp4,0.3333333333333333,2,2,CCGCTCGAGCCGTCCTGCGC,0,1958532
ihfAp4,0.3333333333333333,2,2,CCGCTATGTGGACGAAGGCC,0,1941954
ihfAp4,0.3333333333333333,2,2,CCGCGTGGTTCAATTGAACA,0,1918442
ihfAp4,0.3333333333333333,2,2,CCGCGCTTTCCCGGATTAGG,0,1944888
ihfAp4,0.3333333333333333,2,2,CCGCATTTACGGGTGTACAT,0,1931512
ihfAp4,0.3333333333333333,2,2,CCGCACTCACAGTTGGGTCA,0,1951186
ihfAp4,0.3333333333333333,2,2,CCGCAATATTCCCGGCAGTC,0,1938295
ihfAp4,0.3333333333333333,2,2,CCGATACTAACATGCAAATA,0,1924970
ihfAp4,0.3333333333333333,2,2,CCGACACGTCCAAGTGAGAT,0,1941944
ihfAp4,0.3333333333333333,2,2,CCGAAGGGAGCTAGAGTTGG,0,1937424
ihfAp4,0.3333333333333333,2,2,CCGAACATCACGCCGGAATA,0,1930091
ihfAp4,0.3333333333333333,2,2,CCCTTCGATATTTTACGAAT,0,1923536
ihfAp4,0.3333333333333333,2,2,CCCTCTCTATCCGTGCAGTT,0,1918920
ihfAp4,0.3333333333333333,2,2,CCCTCCGTGCCAGTCGTCTA,0,1953305
ihfAp4,0.3333333333333333,2,2,CCCTATGAGTGGGGCTTAGA,0,1909914
ihfAp4,0.3333333333333333,2,2,CCCGGTCCCTCGGGTTACTG,0,1939500
ihfAp4,0.3333333333333333,2,2,CCCGGTCATGGTGAAGATTT,0,1909841
ihfAp4,0.3333333333333333,2,2,CCCGGGTATAAGATGCTGGT,0,1956932
ihfAp4,0.3333333333333333,2,2,CCCGGCGCCGGCCCGGCCTC,0,1917546
ihfAp4,0.3333333333333333,2,2,CCCGGATGGTCATTCGAGTG,0,1945531
ihfAp4,0.3333333333333333,2,2,CCCGCTTCAATATACACCCA,0,1935354
ihfAp4,0.3333333333333333,2,2,CCCGCTCCACAGGGCCATGA,0,1950883
ihfAp4,0.3333333333333333,2,2,CCCCGTAAGCCAAGTTAAAC,0,1944245
ihfAp4,0.3333333333333333,2,2,CCCCATGTGAATATTTGTGT,0,1921183
ihfAp4,0.3333333333333333,2,2,CCCCACAAGCGCTTAATGGT,0,1924431
ihfAp4,0.3333333333333333,2,2,CCCCAAACAATCTCCGGCCT,0,1923963
ihfAp4,0.3333333333333333,2,2,CCCACTAGGACCAGTTTTTC,0,1947848
ihfAp4,0.3333333333333333,2,2,CCCACCATGCGTCTCCGAGG,0,1934615
ihfAp4,0.3333333333333333,2,2,CCCAAAGACTCTGGCAGTGA,0,1961028
ihfAp4,0.3333333333333333,2,2,CCATTCTTTCCACCGCCCGA,0,1949743
ihfAp4,0.3333333333333333,2,2,CCATTCGTTGTGGTTAGTGG,0,1912695
ihfAp4,0.3333333333333333,2,2,CCATGTTTGCCCCCGTGTCC,0,1916646
ihfAp4,0.3333333333333333,2,2,CCATGGTCCGACGGGTAGTT,0,1945962
ihfAp4,0.3333333333333333,2,2,CCATCGTCAGGACGTTGGGC,0,1949045
ihfAp4,0.3333333333333333,2,2,CCATAGTCAGAGGCCCATGG,0,1927479
ihfAp4,0.3333333333333333,2,2,CCATAGATTGAGGGGGACGG,0,1920064
ihfAp4,0.3333333333333333,2,2,CCATACAGCATGTAACATAT,0,1912270
ihfAp4,0.3333333333333333,2,2,CCAGTGGAACATGCTAGTAA,0,1930140
ihfAp4,0.3333333333333333,2,2,CCAGTAAAAAGTTTAGACGG,0,1917563
ihfAp4,0.3333333333333333,2,2,CCAGGTCGATTTAGGTTACG,0,1939995
ihfAp4,0.3333333333333333,2,2,CCAGGCGTTGCTCAGCCTGT,0,1921034
ihfAp4,0.3333333333333333,2,2,CCAGGATAAGTGAAGGACAG,0,1961158
ihfAp4,0.3333333333333333,2,2,CCAGATGGGGGGCCAAGATC,0,1927514
ihfAp4,0.3333333333333333,2,2,CCACTTGCGTTGGGAGGTGT,0,1947181
ihfAp4,0.3333333333333333,2,2,CCACGATGATTAACCATTAC,0,1960276
ihfAp4,0.3333333333333333,2,2,CCACCTTAGTTAACTGGTCG,0,1936557
ihfAp4,0.3333333333333333,2,2,CCACAATGGCTAATGTATTG,0,1920583
ihfAp4,0.3333333333333333,2,2,CCAATCAAAATCTAGCGATA,0,1920768
ihfAp4,0.3333333333333333,2,2,CCAAGCGTTGGCGACCCCTT,0,1922315
ihfAp4,0.3333333333333333,2,2,CATTTGATTACTTAACTTTA,0,1940107
ihfAp4,0.3333333333333333,2,2,CATTGTTGTCGTTCTTCCTA,0,1930668
ihfAp4,0.3333333333333333,2,2,CATTATTAGTCCGGATTAGT,0,1953176
ihfAp4,0.3333333333333333,2,2,CATGTTTTATACCGTTCGAG,0,1938094
ihfAp4,0.3333333333333333,2,2,CATGTTGGAAAGTAAGCTTT,0,1961084
ihfAp4,0.3333333333333333,2,2,CATGTGTTCCTCGACACGTT,0,1946564
ihfAp4,0.3333333333333333,2,2,CATGGCTGGTCACACATATA,0,1916859
ihfAp4,0.3333333333333333,2,2,CATGGAAGGGCTTGCAAACA,0,1912887
ihfAp4,0.3333333333333333,2,2,CATGCTCGAACAACCCTGAC,0,1922802
ihfAp4,0.3333333333333333,2,2,CATGCCCGCCTTTCAGCGAG,0,1910456
ihfAp4,0.3333333333333333,2,2,CATGAACTGCAAACATGCCC,0,1942575
ihfAp4,0.3333333333333333,2,2,CATCGTCGTCATGTGTAAAC,0,1946622
ihfAp4,0.3333333333333333,2,2,CATCGCTTCCGGTGATAGTT,0,1960926
ihfAp4,0.3333333333333333,2,2,CATCATGAGAGTACGGATAT,0,1943355
ihfAp4,0.3333333333333333,2,2,CATAGGGAACGTGAATCATA,0,1941795
ihfAp4,0.3333333333333333,2,2,CATAGGAGGAAACCAAAAAG,0,1933415
ihfAp4,0.3333333333333333,2,2,CATAGCTTAAGAGTATCGTG,0,1931104
ihfAp4,0.3333333333333333,2,2,CATAGCAATAGGGTTATCAA,0,1921976
ihfAp4,0.3333333333333333,2,2,CATAAGCGCGTAATGTATCC,0,1947648
ihfAp4,0.3333333333333333,2,2,CATAACGCATATCCAGGGTC,0,1940090
ihfAp4,0.3333333333333333,2,2,CATAAACTTGATATACGGCT,0,1953438
ihfAp4,0.3333333333333333,2,2,CAGTCTGGCGAAGCGTGGTC,0,1933097
ihfAp4,0.3333333333333333,2,2,CAGTCTAAGTCCGGGCAAGA,0,1935810
ihfAp4,0.3333333333333333,2,2,CAGTCACTAGCTAATTCTGC,0,1958082
ihfAp4,0.3333333333333333,2,2,CAGTCAAAGTGAATCAAGGT,0,1915794
ihfAp4,0.3333333333333333,2,2,CAGTACGTTACTTTTTGTAA,0,1947843
ihfAp4,0.3333333333333333,2,2,CAGGTCAATCGGTTGTAGCT,0,1954070
ihfAp4,0.3333333333333333,2,2,CAGGTACGGCATTCCATCAA,0,1930007
ihfAp4,0.3333333333333333,2,2,CAGGGTGACCGGACCTCAGG,0,1952355
ihfAp4,0.3333333333333333,2,2,CAGGGCCATACCTCTCATTA,0,1922004
ihfAp4,0.3333333333333333,2,2,CAGGCTTTGTTTAACCCTTG,0,1956968
ihfAp4,0.3333333333333333,2,2,CAGGCGGGTAAAATGCGGCG,0,1951726
ihfAp4,0.3333333333333333,2,2,CAGGCCACGAGTACCAGTGG,0,1912956
ihfAp4,0.3333333333333333,2,2,CAGGCACACTGACGGCTGTT,0,1945509
ihfAp4,0.3333333333333333,2,2,CAGGCAAAGCCGGGATCCAT,0,1909762
ihfAp4,0.3333333333333333,2,2,CAGGAAGCCAAGGTTTGCAG,0,1959195
ihfAp4,0.3333333333333333,2,2,CAGCTTACACTAAGCGACAG,0,1922991
ihfAp4,0.3333333333333333,2,2,CAGCTTAAGTATGAAACAGA,0,1958122
ihfAp4,0.3333333333333333,2,2,CAGCTGTAGTGTATACAAAT,0,1910956
ihfAp4,0.3333333333333333,2,2,CAGCTAGTAGTGCTATCTTT,0,1913925
ihfAp4,0.3333333333333333,2,2,CAGCTACCCTAGCGCGTCAC,0,1926106
ihfAp4,0.3333333333333333,2,2,CAGCGTATGCGGCGCGAGCG,0,1921412
ihfAp4,0.3333333333333333,2,2,CAGCCTCTTTGGAGTAAGAG,0,1911482
ihfAp4,0.3333333333333333,2,2,CAGCCGATGTCGCTTGCGAA,0,1913483
ihfAp4,0.3333333333333333,2,2,CAGCCCCTAAGGGTGAAAGT,0,1919727
ihfAp4,0.3333333333333333,2,2,CAGCATCCAAAAACAACGGC,0,1918053
ihfAp4,0.3333333333333333,2,2,CAGCACTTTACTTCCAGGGA,0,1919107
ihfAp4,0.3333333333333333,2,2,CAGCACCAGACGCTTACAGA,0,1927657
ihfAp4,0.3333333333333333,2,2,CAGATCATGAATGGCGGGAA,0,1939662
ihfAp4,0.3333333333333333,2,2,CAGAGCAGACTAATCGGCCA,0,1943655
ihfAp4,0.3333333333333333,2,2,CAGACCGCGAGTTCTCAAGC,0,1918662
ihfAp4,0.3333333333333333,2,2,CAGAAGCGGATCGGACTCAC,0,1950850
ihfAp4,0.3333333333333333,2,2,CACTTGGATCTTGCGCAATC,0,1933455
ihfAp4,0.3333333333333333,2,2,CACTGGGAATATGGACGTAA,0,1927399
ihfAp4,0.3333333333333333,2,2,CACTGGCAGTCTTAAGAAGC,0,1936846
ihfAp4,0.3333333333333333,2,2,CACTCTGCCTTCTGCCGAAT,0,1934314
ihfAp4,0.3333333333333333,2,2,CACTCAGTACGGCAGAGTTA,0,1944308
ihfAp4,0.3333333333333333,2,2,CACTCACGAACGTTCTGATT,0,1947124
ihfAp4,0.3333333333333333,2,2,CACTATGCATGGTGGCAGTT,0,1922703
ihfAp4,0.3333333333333333,2,2,CACTAAGTCAAGGTACTGAA,0,1924479
ihfAp4,0.3333333333333333,2,2,CACGTTGGGCATCTCAGGGT,0,1938893
ihfAp4,0.3333333333333333,2,2,CACGGTGACTCTCGGATAGC,0,1940365
ihfAp4,0.3333333333333333,2,2,CACGGATCCCAGATTCTATC,0,1926988
ihfAp4,0.3333333333333333,2,2,CACGGACAACCTGCGAAGGG,0,1915846
ihfAp4,0.3333333333333333,2,2,CACCTTGAACATGCTCGCTG,0,1954454
ihfAp4,0.3333333333333333,2,2,CACCTTCTCCCTCTAAAAAC,0,1914203
ihfAp4,0.3333333333333333,2,2,CACCGCTCTTGAGTAGTGAC,0,1923851
ihfAp4,0.3333333333333333,2,2,CACCGACAAGCCATCCTCCT,0,1935808
ihfAp4,0.3333333333333333,2,2,CACCCGACGAGCCATGGAGA,0,1953773
ihfAp4,0.3333333333333333,2,2,CACCCGAAAAAGCCGAAAAA,0,1933759
ihfAp4,0.3333333333333333,2,2,CACCCCAACAACCGGGCCTA,0,1939583
ihfAp4,0.3333333333333333,2,2,CACATTTATGAGAGCCGTCT,0,1957111
ihfAp4,0.3333333333333333,2,2,CACATGATAAGATGTGTCCT,0,1948177
ihfAp4,0.3333333333333333,2,2,CACATAGTCGGCAGACGGCA,0,1923381
ihfAp4,0.3333333333333333,2,2,CACAGGCTTTACCAGAAGCA,0,1938136
ihfAp4,0.3333333333333333,2,2,CACAGGACGTTTTGGCCAGT,0,1950268
ihfAp4,0.3333333333333333,2,2,CACACTTCACTTAATACGCC,0,1958865
ihfAp4,0.3333333333333333,2,2,CACACGGGGACTGTAGTTTG,0,1929992
ihfAp4,0.3333333333333333,2,2,CACAACCTCGGTAGAATTTA,0,1960555
ihfAp4,0.3333333333333333,2,2,CAATGTTGGCAGAAAAACAT,0,1955988
ihfAp4,0.3333333333333333,2,2,CAATCGCATTGCCTGTTCAA,0,1947671
ihfAp4,0.3333333333333333,2,2,CAATATTCGGGATATCATAT,0,1944305
ihfAp4,0.3333333333333333,2,2,CAATACACTAGGAGATTTGC,0,1947408
ihfAp4,0.3333333333333333,2,2,CAAGTGCCAAACATTAAGTC,0,1924028
ihfAp4,0.3333333333333333,2,2,CAAGTGCATGAATGCTGTGC,0,1933165
ihfAp4,0.3333333333333333,2,2,CAAGTCCGGCCACCAGGGGG,0,1932587
ihfAp4,0.3333333333333333,2,2,CAAGTAGACCGGTGTGAAAA,0,1915450
ihfAp4,0.3333333333333333,2,2,CAAGGCATAAACCCGCGGCA,0,1923702
ihfAp4,0.3333333333333333,2,2,CAAGCTGTACGCCTCTTACT,0,1940934
ihfAp4,0.3333333333333333,2,2,CAAGCGATCCGTGTCGAAAC,0,1949761
ihfAp4,0.3333333333333333,2,2,CAAGACGTCGGTCATTACAA,0,1958147
ihfAp4,0.3333333333333333,2,2,CAACTCCCGTTTCAGTCTGG,0,1952522
ihfAp4,0.3333333333333333,2,2,CAACGGAAACGCAGAGGAGG,0,1956209
ihfAp4,0.3333333333333333,2,2,CAACGCCTCTTCTTGGCACG,0,1959402
ihfAp4,0.3333333333333333,2,2,CAACGCAGCTCGCAGCGTCT,0,1918539
ihfAp4,0.3333333333333333,2,2,CAACCTGAGACCAATACGAC,0,1914877
ihfAp4,0.3333333333333333,2,2,CAACCTATTCTCGGTAATCG,0,1938204
ihfAp4,0.3333333333333333,2,2,CAACCGTAAGGCGGCCGAAC,0,1914241
ihfAp4,0.3333333333333333,2,2,CAACATAAAACGGAATCAAG,0,1955068
ihfAp4,0.3333333333333333,2,2,CAACAGGGACGCTTTATTTA,0,1919343
ihfAp4,0.3333333333333333,2,2,CAAATTTTTTTATTTGTTTT,0,1929171
ihfAp4,0.3333333333333333,2,2,CAAATGACGGTTTGACACGG,0,1946735
ihfAp4,0.3333333333333333,2,2,CAAATCAAAAATCAGACTTT,0,1921795
ihfAp4,0.3333333333333333,2,2,CAAAGTCGGCAAGCAGATGT,0,1955975
ihfAp4,0.3333333333333333,2,2,CAAAGCTCACCCGTCTGTAT,0,1928697
ihfAp4,0.3333333333333333,2,2,CAAAGATTGCTGGTTGCGTA,0,1960727
ihfAp4,0.3333333333333333,2,2,CAAACATTCTTCATAAGTAG,0,1959879
ihfAp4,0.3333333333333333,2,2,CAAAACGTCTGGCGGTTGGT,0,1924458
ihfAp4,0.3333333333333333,2,2,ATTTTTAATTCAATTGCCCG,0,1948435
ihfAp4,0.3333333333333333,2,2,ATTTTCTGACCGAACGATTT,0,1921729
ihfAp4,0.3333333333333333,2,2,ATTTGGCTTCGTACTAATCC,0,1912585
ihfAp4,0.3333333333333333,2,2,ATTTCTGGTTCTATTTCTGA,0,1939935
ihfAp4,0.3333333333333333,2,2,ATTTCCGAGATACTCGTCGC,0,1958745
ihfAp4,0.3333333333333333,2,2,ATTTAGTCAGATGAAACATG,0,1955774
ihfAp4,0.3333333333333333,2,2,ATTTAATTATAATACGTGGA,0,1940217
ihfAp4,0.3333333333333333,2,2,ATTTAACTGCTGAGACCGCT,0,1912890
ihfAp4,0.3333333333333333,2,2,ATTGTTATGGCCACGGTGGC,0,1916339
ihfAp4,0.3333333333333333,2,2,ATTGTCCCTACTTGGGTTGA,0,1935501
ihfAp4,0.3333333333333333,2,2,ATTGGGGGACTTCTAGTGGA,0,1928810
ihfAp4,0.3333333333333333,2,2,ATTGGCCCCCTTACCAGTGG,0,1939729
ihfAp4,0.3333333333333333,2,2,ATTGCTTCATCTAATGGCAC,0,1921015
ihfAp4,0.3333333333333333,2,2,ATTGCTGTCTCGAAGAACCA,0,1933082
ihfAp4,0.3333333333333333,2,2,ATTGCGCATGGTTAGCATGA,0,1939861
ihfAp4,0.3333333333333333,2,2,ATTGCGAAGCATCTCGAGCA,0,1937467
ihfAp4,0.3333333333333333,2,2,ATTGCAGGTTGTTATTCCGT,0,1917264
ihfAp4,0.3333333333333333,2,2,ATTGAGTGTAATTGAGCAAA,0,1918875
ihfAp4,0.3333333333333333,2,2,ATTGACTTAAGATTGGGCCG,0,1957865
ihfAp4,0.3333333333333333,2,2,ATTGAAGGTATGGCAAGAGA,0,1934878
ihfAp4,0.3333333333333333,2,2,ATTCTTGTTGCAATGAGACT,0,1914078
ihfAp4,0.3333333333333333,2,2,ATTCGCGCTAAACAGGAGTA,0,1929485
ihfAp4,0.3333333333333333,2,2,ATTCCCTCATTTGATTGCGA,0,1915713
ihfAp4,0.3333333333333333,2,2,ATTCAGCATTCCAACGGTTG,0,1922541
ihfAp4,0.3333333333333333,2,2,ATTCACGCGTGTTGGTAGGT,0,1953704
ihfAp4,0.3333333333333333,2,2,ATTAGCTTAGGGAATCGCTT,0,1939486
ihfAp4,0.3333333333333333,2,2,ATTAGCTGAGTACCGCGCTA,0,1942490
ihfAp4,0.3333333333333333,2,2,ATTAGCAGGCGAGGGTATGC,0,1913303
ihfAp4,0.3333333333333333,2,2,ATTAGACAAAAGGTCATTTT,0,1929070
ihfAp4,0.3333333333333333,2,2,ATTACTTAATGAAATTCGCG,0,1941283
ihfAp4,0.3333333333333333,2,2,ATTACTAGAAGGGGATAAAA,0,1926736
ihfAp4,0.3333333333333333,2,2,ATTACTACGCTCCCTGTTTG,0,1914780
ihfAp4,0.3333333333333333,2,2,ATTACGGAACACTTCCATAA,0,1923296
ihfAp4,0.3333333333333333,2,2,ATGTTCTATTCTTCCCTCAA,0,1946041
ihfAp4,0.3333333333333333,2,2,ATGTTCGCGCGCAGACCTAG,0,1926743
ihfAp4,0.3333333333333333,2,2,ATGTTCCAGGGAAGGATCGC,0,1910134
ihfAp4,0.3333333333333333,2,2,ATGTGCTTTAAAGCTTGGGT,0,1937726
ihfAp4,0.3333333333333333,2,2,ATGTGCAATTCACTTAATGG,0,1916879
ihfAp4,0.3333333333333333,2,2,ATGTCGGCTACTCCATCGCT,0,1944016
ihfAp4,0.3333333333333333,2,2,ATGTCCGGTAATACCGAGCT,0,1922249
ihfAp4,0.3333333333333333,2,2,ATGTATGGTTCACGTTCATT,0,1930795
ihfAp4,0.3333333333333333,2,2,ATGGGTTTGGCCATGTGGAG,0,1918892
ihfAp4,0.3333333333333333,2,2,ATGGGGCTCCCCGGTTGTCA,0,1935924
ihfAp4,0.3333333333333333,2,2,ATGGGCGCAATTCGGATTAA,0,1916462
ihfAp4,0.3333333333333333,2,2,ATGGGAACTGACGTCAAAAC,0,1945431
ihfAp4,0.3333333333333333,2,2,ATGGCGAAAAGCCGTCGGGA,0,1956567
ihfAp4,0.3333333333333333,2,2,ATGGCCGTGTTTTTTAGCCA,0,1930743
ihfAp4,0.3333333333333333,2,2,ATGCTCTGCACTATTAGATA,0,1956929
ihfAp4,0.3333333333333333,2,2,ATGCTCGCGGCCTCCAGTGC,0,1935999
ihfAp4,0.3333333333333333,2,2,ATGCGTTCGTTGGGGGGATA,0,1917326
ihfAp4,0.3333333333333333,2,2,ATGCGGGCGTTAATCCCGGA,0,1940738
ihfAp4,0.3333333333333333,2,2,ATGCGCCGCTGTTATTCCTA,0,1940642
ihfAp4,0.3333333333333333,2,2,ATGCGAGGCCTGTTATATCA,0,1959074
ihfAp4,0.3333333333333333,2,2,ATGCCGGTCCTGGGAGTCAC,0,1927118
ihfAp4,0.3333333333333333,2,2,ATGCCGCGTGGGCTCACGCT,0,1958009
ihfAp4,0.3333333333333333,2,2,ATGCCGATCAGGTAAGGGTG,0,1929905
ihfAp4,0.3333333333333333,2,2,ATGCCAGAAGCGTTTACAGA,0,1932313
ihfAp4,0.3333333333333333,2,2,ATGCATAGCGCGACTTGGAG,0,1910414
ihfAp4,0.3333333333333333,2,2,ATGCAGGATCAGTATCAGGT,0,1947678
ihfAp4,0.3333333333333333,2,2,ATGATTTTAAGATTAAAGCC,0,1925029
ihfAp4,0.3333333333333333,2,2,ATGACCGCATAATGGGCTCT,0,1921262
ihfAp4,0.3333333333333333,2,2,ATGACCCGGTCATCCATGAA,0,1922255
ihfAp4,0.3333333333333333,2,2,ATGAATATGGGTTCGGAACC,0,1917893
ihfAp4,0.3333333333333333,2,2,ATGAATAGGAAAAATTTGGG,0,1947238
ihfAp4,0.3333333333333333,2,2,ATCTTTCGTCAGAAAAACAT,0,1944103
ihfAp4,0.3333333333333333,2,2,ATCTTCTTTTAAAGGCCTAC,0,1931383
ihfAp4,0.3333333333333333,2,2,ATCTGTTTCTCCAATCTCCA,0,1938340
ihfAp4,0.3333333333333333,2,2,ATCTGTGATGAACTCAAATC,0,1951231
ihfAp4,0.3333333333333333,2,2,ATCTGACGCAAGCTGCCTCG,0,1915645
ihfAp4,0.3333333333333333,2,2,ATCTATTGAGTGATGCGTGC,0,1955237
ihfAp4,0.3333333333333333,2,2,ATCTACCGGGTAACTCTCGC,0,1960811
ihfAp4,0.3333333333333333,2,2,ATCGTTGAGCAGCACCGCCC,0,1936518
ihfAp4,0.3333333333333333,2,2,ATCGTTAGGCCTACATCGGT,0,1918006
ihfAp4,0.3333333333333333,2,2,ATCGTCTATAGCGTGGGGTT,0,1924915
ihfAp4,0.3333333333333333,2,2,ATCGTCGAAGGCTGAACATG,0,1932589
ihfAp4,0.3333333333333333,2,2,ATCGTAGTTTGACTGGGTAA,0,1914057
ihfAp4,0.3333333333333333,2,2,ATCGGTTAGCTCCAAGACGA,0,1941749
ihfAp4,0.3333333333333333,2,2,ATCGGTGCACCAACGGACAC,0,1910539
ihfAp4,0.3333333333333333,2,2,ATCGCTTCATGGCGAGTCGC,0,1932682
ihfAp4,0.3333333333333333,2,2,ATCCTTTGCTCATTTGACAA,0,1913659
ihfAp4,0.3333333333333333,2,2,ATCCTGGATACACTTACGAC,0,1925038
ihfAp4,0.3333333333333333,2,2,ATCCGTCCGGACATATTGTC,0,1931445
ihfAp4,0.3333333333333333,2,2,ATCCGATTGGTGCATGGGCA,0,1931421
ihfAp4,0.3333333333333333,2,2,ATCCCTAGTTAGCATCGGCG,0,1924083
ihfAp4,0.3333333333333333,2,2,ATCCACCAGTTTGGCGGGGC,0,1929497
ihfAp4,0.3333333333333333,2,2,ATCCACATCCGGTTCCGACG,0,1911115
ihfAp4,0.3333333333333333,2,2,ATCATGGAGTTTGGTAAGGC,0,1941952
ihfAp4,0.3333333333333333,2,2,ATCATGGACTCCGGTAACAT,0,1957322
ihfAp4,0.3333333333333333,2,2,ATCATATTTTCGGTTAGAAA,0,1941788
ihfAp4,0.3333333333333333,2,2,ATCAGTTGCGCCATGTGTTT,0,1934876
ihfAp4,0.3333333333333333,2,2,ATCAGTGGTAGCCTTCGTAC,0,1921915
ihfAp4,0.3333333333333333,2,2,ATCAATCCTCGTCGTACTTT,0,1945347
ihfAp4,0.3333333333333333,2,2,ATCAAGTAGACCCTCAGATA,0,1948704
ihfAp4,0.3333333333333333,2,2,ATCAACAAGGATTTGTATAA,0,1954731
ihfAp4,0.3333333333333333,2,2,ATATTAATCCCAGAGGCTCT,0,1955909
ihfAp4,0.3333333333333333,2,2,ATATTAAGCACCCTAAGAGT,0,1909861
ihfAp4,0.3333333333333333,2,2,ATATCTGGCTTGCTTCGCCC,0,1915988
ihfAp4,0.3333333333333333,2,2,ATATCATATCCATAAGGTCG,0,1957026
ihfAp4,0.3333333333333333,2,2,ATAGTTTTCAGTCAGCCTAT,0,1947572
ihfAp4,0.3333333333333333,2,2,ATAGTGGGATACTTTCGTAT,0,1938897
ihfAp4,0.3333333333333333,2,2,ATAGTGGAGTGAGTAGAAAT,0,1920264
ihfAp4,0.3333333333333333,2,2,ATAGTAGCGAGTCTGTGGCA,0,1946853
ihfAp4,0.3333333333333333,2,2,ATAGGTGGTTTCCATTAAGC,0,1960776
ihfAp4,0.3333333333333333,2,2,ATAGGGCATCAGTTTTAACT,0,1928405
ihfAp4,0.3333333333333333,2,2,ATAGGCATGATATGAAGAAC,0,1946701
ihfAp4,0.3333333333333333,2,2,ATAGATCTCATGGGTGCACT,0,1918452
ihfAp4,0.3333333333333333,2,2,ATAGAGGGGACCCGACTACG,0,1925208
ihfAp4,0.3333333333333333,2,2,ATACTGTAAGTCGCCTTAAT,0,1950538
ihfAp4,0.3333333333333333,2,2,ATACGGAGCTCACCGGCTCG,0,1936013
ihfAp4,0.3333333333333333,2,2,ATACGCTAACCGGTTCCGAG,0,1935709
ihfAp4,0.3333333333333333,2,2,ATACCTCTTAGGCGAATTCA,0,1921586
ihfAp4,0.3333333333333333,2,2,ATACCCCACACTGGAGCCGA,0,1915287
ihfAp4,0.3333333333333333,2,2,ATACATCGATAGCCGCCTTA,0,1936435
ihfAp4,0.3333333333333333,2,2,ATACAATGTTGTCACTTGGT,0,1948994
ihfAp4,0.3333333333333333,2,2,ATAATCCGTGTTTCCAAGGC,0,1936698
ihfAp4,0.3333333333333333,2,2,ATAAGGCGGTCTCAGTGTAG,0,1933856
ihfAp4,0.3333333333333333,2,2,ATAACATTTGAAAATTATGA,0,1913143
ihfAp4,0.3333333333333333,2,2,ATAACAGAGATCGGGCGGTT,0,1953879
ihfAp4,0.3333333333333333,2,2,ATAAAGTCATGCCGATTAAT,0,1935755
ihfAp4,0.3333333333333333,2,2,ATAAACACTACCGCGACTGG,0,1910953
ihfAp4,0.3333333333333333,2,2,ATAAAACCCGTTTCTGAACG,0,1921419
ihfAp4,0.3333333333333333,2,2,AGTTTTCTGAGTCTTCATCA,0,1932210
ihfAp4,0.3333333333333333,2,2,AGTTTGGGCCTCAGTAACGT,0,1939613
ihfAp4,0.3333333333333333,2,2,AGTTTGAGAACGTCACATAG,0,1955609
ihfAp4,0.3333333333333333,2,2,AGTTTCTAGAAACTGCGTAC,0,1910316
ihfAp4,0.3333333333333333,2,2,AGTTGTCCAAGGGCATTGAA,0,1914644
ihfAp4,0.3333333333333333,2,2,AGTTGCATTAACAGTTGCGG,0,1951391
ihfAp4,0.3333333333333333,2,2,AGTTGAGTCTTACCGTCAAG,0,1915730
ihfAp4,0.3333333333333333,2,2,AGTTCTACCGTCCACCAAAT,0,1952657
ihfAp4,0.3333333333333333,2,2,AGTTATTGCTGCACAATCAC,0,1911415
ihfAp4,0.3333333333333333,2,2,AGTTACTATTTTGCGCGCAT,0,1930459
ihfAp4,0.3333333333333333,2,2,AGTTAATAGTCAGCGGTCTT,0,1943724
ihfAp4,0.3333333333333333,2,2,AGTGTTTAGGGGATGGACCG,0,1909713
ihfAp4,0.3333333333333333,2,2,AGTGACCAGATGAGCATAGG,0,1960713
ihfAp4,0.3333333333333333,2,2,AGTGAAGTCGTTGTACAAAC,0,1912745
ihfAp4,0.3333333333333333,2,2,AGTCTTTTCGTTGAACCGGC,0,1942698
ihfAp4,0.3333333333333333,2,2,AGTCTCGAGTACCCTCACGG,0,1936005
ihfAp4,0.3333333333333333,2,2,AGTCGCCCGCACTAAAATTG,0,1931515
ihfAp4,0.3333333333333333,2,2,AGTCACAACAAATGTTCCAA,0,1929326
ihfAp4,0.3333333333333333,2,2,AGTATGACCGGCAGGGTAGA,0,1954789
ihfAp4,0.3333333333333333,2,2,AGTACCGGGACCTCGCTCCC,0,1940941
ihfAp4,0.3333333333333333,2,2,AGTACAACTCGCGGGTCCCA,0,1914330
ihfAp4,0.3333333333333333,2,2,AGGTTTTCCTTGATGGACTC,0,1915545
ihfAp4,0.3333333333333333,2,2,AGGTTGGGCATACAATCTCT,0,1933639
ihfAp4,0.3333333333333333,2,2,AGGTTACCCAGCCCATGCTC,0,1948536
ihfAp4,0.3333333333333333,2,2,AGGTGAGAGAGGCCAGGGTG,0,1961515
ihfAp4,0.3333333333333333,2,2,AGGTCTTTCGCGTGAGACGA,0,1929158
ihfAp4,0.3333333333333333,2,2,AGGTAGGCGGGGTCAGCGTC,0,1932345
ihfAp4,0.3333333333333333,2,2,AGGTAAATGAGCTCGCCAGA,0,1910555
ihfAp4,0.3333333333333333,2,2,AGGGTGGGAGATATCGGTGC,0,1936452
ihfAp4,0.3333333333333333,2,2,AGGGGTTCGGCGTCGGTAAC,0,1929719
ihfAp4,0.3333333333333333,2,2,AGGGGTCGAATGGGCTGGTC,0,1947968
ihfAp4,0.3333333333333333,2,2,AGGGGGATTCGTACTGATGC,0,1914040
ihfAp4,0.3333333333333333,2,2,AGGGCAGTATCAGCGACAAG,0,1946554
ihfAp4,0.3333333333333333,2,2,AGGGATCTAACGTGGCCTTC,0,1937596
ihfAp4,0.3333333333333333,2,2,AGGGAGTTGCCGAGGACGCA,0,1950856
ihfAp4,0.3333333333333333,2,2,AGGCTGGGTGGCGACTCCCT,0,1925239
ihfAp4,0.3333333333333333,2,2,AGGCTCGCTCATCGAACACA,0,1943408
ihfAp4,0.3333333333333333,2,2,AGGCTCAGTCTGGCCCAGCA,0,1911127
ihfAp4,0.3333333333333333,2,2,AGGCTACAGATCCTCGTCCC,0,1943754
ihfAp4,0.3333333333333333,2,2,AGGCCGATTCTTATCCTGTC,0,1915622
ihfAp4,0.3333333333333333,2,2,AGGCCACATCGTGAAATGCA,0,1924164
ihfAp4,0.3333333333333333,2,2,AGGCACTTGGAACGCAGATG,0,1942961
ihfAp4,0.3333333333333333,2,2,AGGCACACTAGGAATACGCT,0,1941712
ihfAp4,0.3333333333333333,2,2,AGGCAACTACTTCCCGCCCA,0,1957038
ihfAp4,0.3333333333333333,2,2,AGGATGACGATCGAACATGA,0,1916994
ihfAp4,0.3333333333333333,2,2,AGGATATGAGTGCGCGAACT,0,1930128
ihfAp4,0.3333333333333333,2,2,AGGAGGTTGCAACAGTAGCC,0,1920595
ihfAp4,0.3333333333333333,2,2,AGGAGATCCAACTTCGAATA,0,1922259
ihfAp4,0.3333333333333333,2,2,AGGACGCGAAGAGAATACTT,0,1924190
ihfAp4,0.3333333333333333,2,2,AGCTTTTAACGTTTACTAAA,0,1947264
ihfAp4,0.3333333333333333,2,2,AGCTCGGAGAATATAAGGTT,0,1913174
ihfAp4,0.3333333333333333,2,2,AGCTCGAGGCATGCACTACG,0,1922664
ihfAp4,0.3333333333333333,2,2,AGCTACCGACCGTCCCCTAG,0,1928615
ihfAp4,0.3333333333333333,2,2,AGCTACCAACCGATTGTTTC,0,1934676
ihfAp4,0.3333333333333333,2,2,AGCGTTCTTAAGCCCAATCT,0,1938175
ihfAp4,0.3333333333333333,2,2,AGCGGTTGAGTGTAAAGGCC,0,1953033
ihfAp4,0.3333333333333333,2,2,AGCGGTGGAAAGCGAATTGA,0,1930314
ihfAp4,0.3333333333333333,2,2,AGCGGGTGGCGCAGCCCCGC,0,1960660
ihfAp4,0.3333333333333333,2,2,AGCGGCACTGGGGCCTTTGG,0,1922022
ihfAp4,0.3333333333333333,2,2,AGCGCTCATATAGTGTAAAA,0,1955782
ihfAp4,0.3333333333333333,2,2,AGCGCGAGTCACGTATTGGA,0,1960739
ihfAp4,0.3333333333333333,2,2,AGCGCATGGCGCCGTGCTTT,0,1939624
ihfAp4,0.3333333333333333,2,2,AGCGAGTAGGGGGATTTGGA,0,1957912
ihfAp4,0.3333333333333333,2,2,AGCGAGGGCCGGCAGGGTTA,0,1918253
ihfAp4,0.3333333333333333,2,2,AGCGAAATGACACGAAATAG,0,1940438
ihfAp4,0.3333333333333333,2,2,AGCCTGTTTAACCTCGTCCA,0,1924449
ihfAp4,0.3333333333333333,2,2,AGCCTCACGCACAAGCTGGA,0,1961257
ihfAp4,0.3333333333333333,2,2,AGCCCGATTGGGTCGCGCGT,0,1950984
ihfAp4,0.3333333333333333,2,2,AGCCCATCCGGCGTGAACCG,0,1953465
ihfAp4,0.3333333333333333,2,2,AGCCCAGAAAATAGGTGATT,0,1928722
ihfAp4,0.3333333333333333,2,2,AGCATGTCTGCGTATTAGAA,0,1931446
ihfAp4,0.3333333333333333,2,2,AGCAACACCTAGGACGGTGA,0,1959410
ihfAp4,0.3333333333333333,2,2,AGATTGTGATTGCTGGGTTA,0,1915041
ihfAp4,0.3333333333333333,2,2,AGATTGTACTGAGACAATAT,0,1948682
ihfAp4,0.3333333333333333,2,2,AGATGTTTGGTAGAGGGAAC,0,1962214
ihfAp4,0.3333333333333333,2,2,AGATGATCTACCTGAAGGAC,0,1915106
ihfAp4,0.3333333333333333,2,2,AGATCTAGCGCATAATTAAC,0,1943803
ihfAp4,0.3333333333333333,2,2,AGATCCAATTCCTGCCTCAC,0,1920305
ihfAp4,0.3333333333333333,2,2,AGATATAGTAGCCCCGATAA,0,1940776
ihfAp4,0.3333333333333333,2,2,AGATAAATCGGCGATGCCTG,0,1935803
ihfAp4,0.3333333333333333,2,2,AGAGTGTCTTAGGCTTGAAT,0,1942994
ihfAp4,0.3333333333333333,2,2,AGAGTGCTCGTTGGCTTTCG,0,1955196
ihfAp4,0.3333333333333333,2,2,AGAGCACGGTTCCACGTGCA,0,1918138
ihfAp4,0.3333333333333333,2,2,AGAGATGGGCGTGATACCGT,0,1954197
ihfAp4,0.3333333333333333,2,2,AGAGATAGTGGGCCTATCAA,0,1942486
ihfAp4,0.3333333333333333,2,2,AGAGACAAGGTGCCTAGGCG,0,1957370
ihfAp4,0.3333333333333333,2,2,AGACTCGCAGCTCGCTTCAG,0,1915018
ihfAp4,0.3333333333333333,2,2,AGACGTTGATTTGGCACGTA,0,1920369
ihfAp4,0.3333333333333333,2,2,AGACGTCCGGCGCCGAGCTC,0,1956290
ihfAp4,0.3333333333333333,2,2,AGACGTAGTTACAAGCACCC,0,1923439
ihfAp4,0.3333333333333333,2,2,AGACGCCACGCACGCAGCTG,0,1943294
ihfAp4,0.3333333333333333,2,2,AGACCAGATCAGAGTCGTCT,0,1921465
ihfAp4,0.3333333333333333,2,2,AGACATGAGACGTTTCGGTA,0,1932130
ihfAp4,0.3333333333333333,2,2,AGAATTGACGGTGCGACAAG,0,1930858
ihfAp4,0.3333333333333333,2,2,AGAATATGGGGGGCCGATCG,0,1947815
ihfAp4,0.3333333333333333,2,2,AGAAGTATAGCTCCTACGTC,0,1960602
ihfAp4,0.3333333333333333,2,2,AGAAGGCCCCCTTCTACAAT,0,1916010
ihfAp4,0.3333333333333333,2,2,AGAAGCTTGTTGCTTAACGG,0,1947027
ihfAp4,0.3333333333333333,2,2,AGAACTTATACGCTTAGTTA,0,1955203
ihfAp4,0.3333333333333333,2,2,AGAACCCTAATAGTAGCAAA,0,1938383
ihfAp4,0.3333333333333333,2,2,AGAAACATAACGTGGTCACC,0,1948806
ihfAp4,0.3333333333333333,2,2,ACTTTTCTAAAAATTTAGTT,0,1927403
ihfAp4,0.3333333333333333,2,2,ACTTGGGCAATTAGGCTGCT,0,1932629
ihfAp4,0.3333333333333333,2,2,ACTTCATGGGGGCCGATACC,0,1944565
ihfAp4,0.3333333333333333,2,2,ACTGTGGGAAAAATTTTCCC,0,1946935
ihfAp4,0.3333333333333333,2,2,ACTGGACAGTGTAATCCGTT,0,1931751
ihfAp4,0.3333333333333333,2,2,ACTGCTGATCCCGGAGAATA,0,1956584
ihfAp4,0.3333333333333333,2,2,ACTGCCTATGACAAGGGATA,0,1938953
ihfAp4,0.3333333333333333,2,2,ACTGACCGTTCTGATTGATC,0,1930047
ihfAp4,0.3333333333333333,2,2,ACTGAAGGTAGGTATTTGGG,0,1916037
ihfAp4,0.3333333333333333,2,2,ACTCGAGAGTAAAATATAGT,0,1916737
ihfAp4,0.3333333333333333,2,2,ACTCCGATCATTAATCGTGC,0,1912490
ihfAp4,0.3333333333333333,2,2,ACTCCGAGTATTTGAGTACC,0,1919859
ihfAp4,0.3333333333333333,2,2,ACTACTGTCGGAATATACCA,0,1909721
ihfAp4,0.3333333333333333,2,2,ACTACCTTGCCTCTTGAGTT,0,1939631
ihfAp4,0.3333333333333333,2,2,ACGTTCATTATTTAAATCCT,0,1955290
ihfAp4,0.3333333333333333,2,2,ACGTGTGCAATCAATAGTGA,0,1952481
ihfAp4,0.3333333333333333,2,2,ACGTGGGGAGCAGGCTAAGA,0,1954205
ihfAp4,0.3333333333333333,2,2,ACGTGATTGGCCGCATCTCA,0,1920941
ihfAp4,0.3333333333333333,2,2,ACGTAGCATGAGTTGTCGAG,0,1942288
ihfAp4,0.3333333333333333,2,2,ACGTAAATGGTGACCTATGC,0,1917662
ihfAp4,0.3333333333333333,2,2,ACGGTTCCATATGTATTACG,0,1945078
ihfAp4,0.3333333333333333,2,2,ACGGGTTTACTGGAGGTGTT,0,1913405
ihfAp4,0.3333333333333333,2,2,ACGGAATAAGCGCTCCACGC,0,1919910
ihfAp4,0.3333333333333333,2,2,ACGGAAAGTAGTGACATAGG,0,1928384
ihfAp4,0.3333333333333333,2,2,ACGCTTCGGAAATCTCCATC,0,1929151
ihfAp4,0.3333333333333333,2,2,ACGCTTACGCCAACCTGAGA,0,1912550
ihfAp4,0.3333333333333333,2,2,ACGCCGCCACCCACGTCTTC,0,1929600
ihfAp4,0.3333333333333333,2,2,ACGCCGCAGCTAGACTGCCT,0,1942567
ihfAp4,0.3333333333333333,2,2,ACGCATATTAATGCCAGACC,0,1956611
ihfAp4,0.3333333333333333,2,2,ACGCAGTGGACTTCTGGTGG,0,1914278
ihfAp4,0.3333333333333333,2,2,ACGATTTGGTGTCCTGGCAT,0,1933078
ihfAp4,0.3333333333333333,2,2,ACGATCGGGAAGCAATCCCT,0,1925777
ihfAp4,0.3333333333333333,2,2,ACGAGTTAAGACCCCGAAAC,0,1945352
ihfAp4,0.3333333333333333,2,2,ACGAATGAATACCAAGTTCG,0,1961393
ihfAp4,0.3333333333333333,2,2,ACGAAGTCAAGCCAGCCGCA,0,1941203
ihfAp4,0.3333333333333333,2,2,ACCTTTTCAGGGTAAGGCCA,0,1957167
ihfAp4,0.3333333333333333,2,2,ACCTTTCGGCGGCGACGATG,0,1951744
ihfAp4,0.3333333333333333,2,2,ACCTGACATTCATCCGGAAA,0,1960703
ihfAp4,0.3333333333333333,2,2,ACCTATCCCGCCGATAAGGC,0,1931165
ihfAp4,0.3333333333333333,2,2,ACCTACATAAAGCACCTAAG,0,1912216
ihfAp4,0.3333333333333333,2,2,ACCGTTTACACCGCATGGGA,0,1921908
ihfAp4,0.3333333333333333,2,2,ACCGTGTTGTATGCTAGCAT,0,1918366
ihfAp4,0.3333333333333333,2,2,ACCGTATTAAGATATATCGA,0,1951742
ihfAp4,0.3333333333333333,2,2,ACCGTACACCGTACGGCTCC,0,1923811
ihfAp4,0.3333333333333333,2,2,ACCGCTTGCATATAGCCATG,0,1959098
ihfAp4,0.3333333333333333,2,2,ACCGCTCGCAGGCCCATCCA,0,1921450
ihfAp4,0.3333333333333333,2,2,ACCGCGGGGTCTGCCCAGGA,0,1916889
ihfAp4,0.3333333333333333,2,2,ACCGAGCGTTCTTGATCTAA,0,1947151
ihfAp4,0.3333333333333333,2,2,ACCGAAAAGCATCCTGTATA,0,1942353
ihfAp4,0.3333333333333333,2,2,ACCCGAAGGGATTAAAATTG,0,1916552
ihfAp4,0.3333333333333333,2,2,ACCCCATCGCGCTTGGCGCC,0,1921200
ihfAp4,0.3333333333333333,2,2,ACCCAAATCCTTGTTGGAGC,0,1951345
ihfAp4,0.3333333333333333,2,2,ACCATGTGTGAGTTGTTCGA,0,1930157
ihfAp4,0.3333333333333333,2,2,ACCATCCGCTAGACATGGGT,0,1942154
ihfAp4,0.3333333333333333,2,2,ACCATCAGAAATTGCTGGGT,0,1953711
ihfAp4,0.3333333333333333,2,2,ACCAGTGCCATTTTGGTTCA,0,1930502
ihfAp4,0.3333333333333333,2,2,ACCAGTACGCATGTACCTCG,0,1933254
ihfAp4,0.3333333333333333,2,2,ACCAGGGGCCTGCGTTTGCA,0,1933624
ihfAp4,0.3333333333333333,2,2,ACCACGGAGCTATGGCGGCC,0,1924543
ihfAp4,0.3333333333333333,2,2,ACCAATACGGGGCGCACTAC,0,1920348
ihfAp4,0.3333333333333333,2,2,ACATTTTACCGTACCGTTGC,0,1916743
ihfAp4,0.3333333333333333,2,2,ACATTAGCGCTGTTGTGATA,0,1932612
ihfAp4,0.3333333333333333,2,2,ACATCGCATGTTGATAAACT,0,1929047
ihfAp4,0.3333333333333333,2,2,ACAGTAAGTGTAGGTTGCGG,0,1913615
ihfAp4,0.3333333333333333,2,2,ACAGGTTCGAGGGGAGACCC,0,1938419
ihfAp4,0.3333333333333333,2,2,ACAGGTATTCGCAGGATAAC,0,1955333
ihfAp4,0.3333333333333333,2,2,ACAGGCGAGCATCGCATCTA,0,1934572
ihfAp4,0.3333333333333333,2,2,ACAGCGCCCGTGACGAGTCT,0,1914692
ihfAp4,0.3333333333333333,2,2,ACAGCGCACTCAGAAACTTG,0,1911200
ihfAp4,0.3333333333333333,2,2,ACAGCAACTATATGGCTTCC,0,1936056
ihfAp4,0.3333333333333333,2,2,ACAGAGCGCATGGTAATATC,0,1909552
ihfAp4,0.3333333333333333,2,2,ACAGAAACGTTCCGTCCCCG,0,1946663
ihfAp4,0.3333333333333333,2,2,ACACTGTCAGCGCGGATAGT,0,1948387
ihfAp4,0.3333333333333333,2,2,ACACTAACGGCCAGTAGTAA,0,1911730
ihfAp4,0.3333333333333333,2,2,ACACGGTTACTCGTATATGC,0,1914676
ihfAp4,0.3333333333333333,2,2,ACACGGGGGTTTGTCATGGT,0,1944750
ihfAp4,0.3333333333333333,2,2,ACACGGGGCCGCTAGGCATT,0,1916241
ihfAp4,0.3333333333333333,2,2,ACACGACCACAAACGATGTA,0,1938194
ihfAp4,0.3333333333333333,2,2,ACACATTTCCTTGGCGTCTT,0,1944686
ihfAp4,0.3333333333333333,2,2,ACAATTTCTAAACGACCTGA,0,1910227
ihfAp4,0.3333333333333333,2,2,ACAATGGCAATGTTAACAAT,0,1956589
ihfAp4,0.3333333333333333,2,2,ACAATCTTCTAGTTGTCCTT,0,1914083
ihfAp4,0.3333333333333333,2,2,ACAATCGGGTAGTCCACTCA,0,1957661
ihfAp4,0.3333333333333333,2,2,ACAATAATGACAGGATGTCC,0,1918921
ihfAp4,0.3333333333333333,2,2,ACAAGACTGAAGCTGGAAAT,0,1919475
ihfAp4,0.3333333333333333,2,2,AATTTTACGGACTCGGTTAT,0,1931143
ihfAp4,0.3333333333333333,2,2,AATTTATCTGTGACGGTGAT,0,1928034
ihfAp4,0.3333333333333333,2,2,AATTGCCTACGTTTGTCTCA,0,1939047
ihfAp4,0.3333333333333333,2,2,AATTGCATCTTTCGATAATG,0,1956682
ihfAp4,0.3333333333333333,2,2,AATTCGAAATCGTACCGTAG,0,1948685
ihfAp4,0.3333333333333333,2,2,AATTCCGGTTTCGGCCCTCA,0,1956155
ihfAp4,0.3333333333333333,2,2,AATTAGGGGAGTAAGGTTTA,0,1929044
ihfAp4,0.3333333333333333,2,2,AATTACTAATTTTCGACGCG,0,1913570
ihfAp4,0.3333333333333333,2,2,AATTACCGCTCTACTTCGGG,0,1927855
ihfAp4,0.3333333333333333,2,2,AATGTTACAGAGCCGGTGAC,0,1955570
ihfAp4,0.3333333333333333,2,2,AATGTCGCGTGGAGTCCACA,0,1925700
ihfAp4,0.3333333333333333,2,2,AATGGAGCGATATCGCGATT,0,1955675
ihfAp4,0.3333333333333333,2,2,AATGCTGCGTGTCGTCACTT,0,1958335
ihfAp4,0.3333333333333333,2,2,AATGACAAGTAGGACTGGGC,0,1917330
ihfAp4,0.3333333333333333,2,2,AATGAACCCATGGTGAGATC,0,1909722
ihfAp4,0.3333333333333333,2,2,AATCGGAGCAAACAGTTGGT,0,1925860
ihfAp4,0.3333333333333333,2,2,AATCCTTCACAAAGGTGCGC,0,1951892
ihfAp4,0.3333333333333333,2,2,AATCCTGATGCCTCCCTACA,0,1912024
ihfAp4,0.3333333333333333,2,2,AATCCCTGCTCGTGACCCAT,0,1932805
ihfAp4,0.3333333333333333,2,2,AATCAAAGGGGGGTAGATCT,0,1910868
ihfAp4,0.3333333333333333,2,2,AATATAAGACGGGACAATGT,0,1932074
ihfAp4,0.3333333333333333,2,2,AATAGTTCCTCTAAGGAGCG,0,1926561
ihfAp4,0.3333333333333333,2,2,AATAGGCGGTGGTCAGCATC,0,1914869
ihfAp4,0.3333333333333333,2,2,AATAATCTAAAATCAAATAA,0,1926039
ihfAp4,0.3333333333333333,2,2,AAGTTAAGCGATTCCACCGT,0,1937712
ihfAp4,0.3333333333333333,2,2,AAGTGTACGACGGCAAAGCA,0,1929359
ihfAp4,0.3333333333333333,2,2,AAGTGACGGTGTGCGTGATG,0,1953588
ihfAp4,0.3333333333333333,2,2,AAGTCCCTACAAACTATGCT,0,1956525
ihfAp4,0.3333333333333333,2,2,AAGTATACTAGGTATATCGT,0,1925036
ihfAp4,0.3333333333333333,2,2,AAGTACACACCTTAACTCCT,0,1926293
ihfAp4,0.3333333333333333,2,2,AAGGTTGTCTTCTGGGGAGT,0,1934557
ihfAp4,0.3333333333333333,2,2,AAGGTCTTGTTCGGCGTACC,0,1912281
ihfAp4,0.3333333333333333,2,2,AAGGGGGCGGGTCCGAGGGA,0,1948790
ihfAp4,0.3333333333333333,2,2,AAGGGGGCGGAAACGTCGCG,0,1932149
ihfAp4,0.3333333333333333,2,2,AAGGGGAACAAATCTGACTG,0,1946567
ihfAp4,0.3333333333333333,2,2,AAGGGCTACATACTTGTGCA,0,1926414
ihfAp4,0.3333333333333333,2,2,AAGGGCCTCTGCAGTAAGGC,0,1948086
ihfAp4,0.3333333333333333,2,2,AAGGCGGGCCGATATGCAGC,0,1924486
ihfAp4,0.3333333333333333,2,2,AAGGCGGCGTTGCCTGTAAT,0,1934155
ihfAp4,0.3333333333333333,2,2,AAGGCCGTCTAAATCTAAGG,0,1935983
ihfAp4,0.3333333333333333,2,2,AAGGATGGGCATGGTTTAAT,0,1948279
ihfAp4,0.3333333333333333,2,2,AAGGAGGGTCGCAGGCTCGT,0,1953751
ihfAp4,0.3333333333333333,2,2,AAGGACGCTACCTCCGAGCC,0,1914533
ihfAp4,0.3333333333333333,2,2,AAGGACAGTAGAGCTGTGTC,0,1961244
ihfAp4,0.3333333333333333,2,2,AAGCAACAGAAGTATCCTTG,0,1949038
ihfAp4,0.3333333333333333,2,2,AAGATGGTGCGAACGTAGTT,0,1924583
ihfAp4,0.3333333333333333,2,2,AAGATGGAGTGATCAGGAAT,0,1958782
ihfAp4,0.3333333333333333,2,2,AAGACTGCATTTGTCAATGT,0,1938445
ihfAp4,0.3333333333333333,2,2,AACTGATCAAAGTGGGGGTT,0,1919262
ihfAp4,0.3333333333333333,2,2,AACTGATATCTAATATATAT,0,1927888
ihfAp4,0.3333333333333333,2,2,AACTCCCCTCACGACACCAC,0,1950456
ihfAp4,0.3333333333333333,2,2,AACTATCGGATAAACCTGGA,0,1916938
ihfAp4,0.3333333333333333,2,2,AACTAGCGAGCATTATCGTG,0,1935349
ihfAp4,0.3333333333333333,2,2,AACGTTTGGGGGAATGCAGA,0,1922827
ihfAp4,0.3333333333333333,2,2,AACGTGAGCTTATACCTGGG,0,1921136
ihfAp4,0.3333333333333333,2,2,AACGGTATATGGATTATGAA,0,1916476
ihfAp4,0.3333333333333333,2,2,AACGGCAATAGGGCTTGGGT,0,1911387
ihfAp4,0.3333333333333333,2,2,AACGCGTTAGAATGTAGATT,0,1911051
ihfAp4,0.3333333333333333,2,2,AACGCAGGCCTTTCTGGGTC,0,1913460
ihfAp4,0.3333333333333333,2,2,AACGAGTACGGCGAAGAACA,0,1930621
ihfAp4,0.3333333333333333,2,2,AACGACCCTTGAGAGGATTC,0,1946590
ihfAp4,0.3333333333333333,2,2,AACCTCGGGCAACGAGAGGT,0,1920125
ihfAp4,0.3333333333333333,2,2,AACCTAATTCGCGCACTACA,0,1941438
ihfAp4,0.3333333333333333,2,2,AACCGCCAACGGGGGGACCT,0,1920674
ihfAp4,0.3333333333333333,2,2,AACCCAATTAGTCATCGAAG,0,1946122
ihfAp4,0.3333333333333333,2,2,AACCATTTCAGATACAAAGC,0,1951525
ihfAp4,0.3333333333333333,2,2,AACCAGTTACTGCTATAACA,0,1925895
ihfAp4,0.3333333333333333,2,2,AACCAGCACACGGCGTACTA,0,1953202
ihfAp4,0.3333333333333333,2,2,AACCAAATCCTCCCTAAGAC,0,1949158
ihfAp4,0.3333333333333333,2,2,AACATGATCTTACGGCAAGA,0,1961282
ihfAp4,0.3333333333333333,2,2,AACAGGGGGAGTCGTGCTGA,0,1955416
ihfAp4,0.3333333333333333,2,2,AACACTGTCCTACGACTACA,0,1938247
ihfAp4,0.3333333333333333,2,2,AACACCTTGAAGCTACGCCT,0,1946452
ihfAp4,0.3333333333333333,2,2,AAATTGTTCCGTCCGGCCAA,0,1923163
ihfAp4,0.3333333333333333,2,2,AAATGTATCTCAGGTATGTG,0,1919031
ihfAp4,0.3333333333333333,2,2,AAATCCTTAGCGCCGGGAGA,0,1914388
ihfAp4,0.3333333333333333,2,2,AAATACACATACGATCTATT,0,1936342
ihfAp4,0.3333333333333333,2,2,AAATAAAACTTCAGCACAGT,0,1923587
ihfAp4,0.3333333333333333,2,2,AAAGTTTCAGCACGCATCCC,0,1959048
ihfAp4,0.3333333333333333,2,2,AAAGTATAGTCCCAGTTTCG,0,1921645
ihfAp4,0.3333333333333333,2,2,AAAGGTCCGATACGCACGTC,0,1947335
ihfAp4,0.3333333333333333,2,2,AAAGGGTCTCTATGCTTTCG,0,1938850
ihfAp4,0.3333333333333333,2,2,AAAGGATCCCCCGGTGACGA,0,1934667
ihfAp4,0.3333333333333333,2,2,AAAGCGTGAGTAATCGTAAC,0,1960699
ihfAp4,0.3333333333333333,2,2,AAAGAGTCCAGTGACGCGGA,0,1943371
ihfAp4,0.3333333333333333,2,2,AAAGACAAACTTACCTTTGC,0,1942668
ihfAp4,0.3333333333333333,2,2,AAAGAAGCAGAGGAAGAATG,0,1956409
ihfAp4,0.3333333333333333,2,2,AAACTATTCGTGTAGCGTGA,0,1952725
ihfAp4,0.3333333333333333,2,2,AAACAGCAGTAGGCATGAGT,0,1931474
ihfAp4,0.3333333333333333,2,2,AAAAGTGGGTGGCCCTGCAT,0,1941561
ihfAp4,0.3333333333333333,2,2,AAAAGGGCTTCTTGTTCGAC,0,1937111
ihfAp4,0.3333333333333333,2,2,AAAAGCTAAGGTGCGTGGGA,0,1958569
ihfAp4,0.3333333333333333,2,2,AAAAGCGGCACACTCAGAGT,0,1951582
ihfAp4,0.3333333333333333,2,2,AAAAGCCTTACAAGATCGTG,0,1945300
ihfAp4,0.3333333333333333,2,2,AAAAGATAATGGTTGACCCT,0,1931709
ihfAp4,0.3333333333333333,2,2,AAAACTCAGCCGCGTACGCT,0,1924850
ihfAp4,0.3333333333333333,2,2,AAAACATGGGCATTTTCGGC,0,1943433
ihfAp4,0.3333333333333333,2,2,AAAACAGACTTAAAAAGGCA,0,1912761
ihfAp4,0.3333333333333333,2,2,AAAACACGGAGAAATCGCGC,0,1943596
ihfAp4,0.3333333333333333,2,2,AAAACAACGAGCGCGGTATT,0,1946290
ihfAp4,0.3333333333333333,2,2,AAAAACCTGAGAGTAACCGA,0,1937227
ihfAp4,0.5,1,1,TTTTTGAGTTTTGCTTGCCA,0,1914008
ihfAp4,0.5,1,1,TTTTTCGGGGGGCTATCTCG,0,1945841
ihfAp4,0.5,1,1,TTTTTATGTAATGACGGATT,0,1957774
ihfAp4,0.5,1,1,TTTTGTTTCACGTCGATGAA,0,1914439
ihfAp4,0.5,1,1,TTTTGAGCTTTTCATGTATT,0,1933730
ihfAp4,0.5,1,1,TTTTCCCGGTGTCATCGGTC,0,1938427
ihfAp4,0.5,1,1,TTTTCATGCACTTCGTCCAT,0,1955847
ihfAp4,0.5,1,1,TTTTCATATCCACACCAGAC,0,1916195
ihfAp4,0.5,1,1,TTTTATGGGTCGGACAGTTT,0,1939391
ihfAp4,0.5,1,1,TTTTAGAACCGCGGCCCCTC,0,1919885
ihfAp4,0.5,1,1,TTTGTTTGGTTTCAGGATCA,0,1940536
ihfAp4,0.5,1,1,TTTGTGACATATACTGGGGT,0,1910454
ihfAp4,0.5,1,1,TTTGGTTTCTCAGTGATGTT,0,1912680
ihfAp4,0.5,1,1,TTTGGTACAGACATTAATAT,0,1944557
ihfAp4,0.5,1,1,TTTGGGGCGGCCAACGGAGT,0,1921683
ihfAp4,0.5,1,1,TTTGGCAAAGGTACCAACTC,0,1944315
ihfAp4,0.5,1,1,TTTGGATGCGAGGTCCTGCA,0,1944277
ihfAp4,0.5,1,1,TTTGGATCGTGGTCATTGCA,0,1947964
ihfAp4,0.5,1,1,TTTGGAACAGTAATCCCGGT,0,1948786
ihfAp4,0.5,1,1,TTTGCTATGTACAATGATGT,0,1960896
ihfAp4,0.5,1,1,TTTGCGGAGAGGAGCAAAGC,0,1954653
ihfAp4,0.5,1,1,TTTGCCGGACGGATCAAGTC,0,1957899
ihfAp4,0.5,1,1,TTTGCAGAAGAGGATCCGGC,0,1937225
ihfAp4,0.5,1,1,TTTGAAGCGCCCCCCAGTGT,0,1909770
ihfAp4,0.5,1,1,TTTGAACTGAGTTCTATGCT,0,1953194
ihfAp4,0.5,1,1,TTTCTCCTCTGGTCTTGTAA,0,1946892
ihfAp4,0.5,1,1,TTTCGTGGATACACTGGTCA,0,1952225
ihfAp4,0.5,1,1,TTTCGATCTGGTTCTCCCGT,0,1955938
ihfAp4,0.5,1,1,TTTCCGACTGCGGTACGGAT,0,1914322
ihfAp4,0.5,1,1,TTTCCCCTACGGGCGCGATG,0,1947956
ihfAp4,0.5,1,1,TTTCCATGCGTAAATAACAT,0,1934866
ihfAp4,0.5,1,1,TTTCCAATTGCCAGCAAAAG,0,1928150
ihfAp4,0.5,1,1,TTTAGTCGTTAGATCCTTTA,0,1948568
ihfAp4,0.5,1,1,TTTAGGGTCACGTGCATGCG,0,1945505
ihfAp4,0.5,1,1,TTTAGGGCCTGCCTAAGTTA,0,1924272
ihfAp4,0.5,1,1,TTTAGCTGACAGTCCCATGT,0,1919929
ihfAp4,0.5,1,1,TTTAGCGTTTAAATATAGGA,0,1930890
ihfAp4,0.5,1,1,TTTAGATCAATCTCGAAAAC,0,1950803
ihfAp4,0.5,1,1,TTTACTTCACGCGACGCGGC,0,1919722
ihfAp4,0.5,1,1,TTTACTCGACGGCACCAGGC,0,1934396
ihfAp4,0.5,1,1,TTTACCCCGAGGGGGAGGCC,0,1940876
ihfAp4,0.5,1,1,TTTACCAGCTCGTAGCTGTT,0,1914736
ihfAp4,0.5,1,1,TTTACACGCTATGCCTGCAG,0,1943298
ihfAp4,0.5,1,1,TTTACAACTGCTGCCCGGAC,0,1926714
ihfAp4,0.5,1,1,TTTAACAGTGTTATGTCCTG,0,1940389
ihfAp4,0.5,1,1,TTTAAATTGTGCGCGTAGAG,0,1943406
ihfAp4,0.5,1,1,TTTAAAACGCAAGAGATCGT,0,1946593
ihfAp4,0.5,1,1,TTGTTTTTGATCCGAGATTT,0,1954921
ihfAp4,0.5,1,1,TTGTTCAGCTCATCGTTCTC,0,1936471
ihfAp4,0.5,1,1,TTGTGTGCGTCGCTAAAATT,0,1959910
ihfAp4,0.5,1,1,TTGTGGCGTCTAATCTGCGG,0,1919111
ihfAp4,0.5,1,1,TTGTGAGATCAACTCGAGGG,0,1954586
ihfAp4,0.5,1,1,TTGTCCGATAGCACGGGCCA,0,1929822
ihfAp4,0.5,1,1,TTGTCATCCGTACGCCACAT,0,1955354
ihfAp4,0.5,1,1,TTGTATGGTTCGTGATCAAG,0,1940508
ihfAp4,0.5,1,1,TTGTAGGATAGACTAATTCG,0,1937038
ihfAp4,0.5,1,1,TTGGTGTTGACCCTCGGGAA,0,1913425
ihfAp4,0.5,1,1,TTGGTGGGAGAATAACTGAA,0,1928148
ihfAp4,0.5,1,1,TTGGTAAGTCACCTTAATGA,0,1961922
ihfAp4,0.5,1,1,TTGGGTTGGGCGTGGGCCCA,0,1938414
ihfAp4,0.5,1,1,TTGGGTATTACTACGAGGAA,0,1926576
ihfAp4,0.5,1,1,TTGGCGATTTGTACCTGCAG,0,1932467
ihfAp4,0.5,1,1,TTGGCCCCCCGTTGCCGCAG,0,1934087
ihfAp4,0.5,1,1,TTGGATGCCGTCGCTGGCCG,0,1952676
ihfAp4,0.5,1,1,TTGGAGCTCCAGGATAACGA,0,1924808
ihfAp4,0.5,1,1,TTGGAGAGGAAATTGTTAAG,0,1947567
ihfAp4,0.5,1,1,TTGCTAGCACGTCTTGTTGA,0,1920939
ihfAp4,0.5,1,1,TTGCTAAAGGACAAGAGTGA,0,1919969
ihfAp4,0.5,1,1,TTGCGTCCATGGTCTCGAGA,0,1911614
ihfAp4,0.5,1,1,TTGCGGGTTGCACAGTCCCG,0,1911384
ihfAp4,0.5,1,1,TTGCGCCGCAAAGCATGGCT,0,1933387
ihfAp4,0.5,1,1,TTGCGAGCTCATATAGGGTC,0,1930659
ihfAp4,0.5,1,1,TTGCCAGAAAGCATCCCAAG,0,1954723
ihfAp4,0.5,1,1,TTGCCACTGGAAGGTCTGGT,0,1946001
ihfAp4,0.5,1,1,TTGCATGCAAGGGTCGGTCG,0,1958549
ihfAp4,0.5,1,1,TTGCACTTGTTATATGAATA,0,1913982
ihfAp4,0.5,1,1,TTGCACATACGTGGAGCCCC,0,1937354
ihfAp4,0.5,1,1,TTGCAAGTATCGCCGGACAG,0,1944096
ihfAp4,0.5,1,1,TTGATTATGTCCCTGTGTCA,0,1946649
ihfAp4,0.5,1,1,TTGATTACTAGGTGGACCGT,0,1930724
ihfAp4,0.5,1,1,TTGATCTGAGTTGTCTTGTG,0,1918027
ihfAp4,0.5,1,1,TTGATAGGCTCCACTGACAC,0,1959127
ihfAp4,0.5,1,1,TTGAGTAAGCACAAGCGTAA,0,1932916
ihfAp4,0.5,1,1,TTGAGCAATGGCCTTCCGAG,0,1926298
ihfAp4,0.5,1,1,TTGAGATCGTTATGCGTTTC,0,1919446
ihfAp4,0.5,1,1,TTGAATTAGTTGGTTCTCAA,0,1910052
ihfAp4,0.5,1,1,TTGAATTACAGCTTTCTCAT,0,1916640
ihfAp4,0.5,1,1,TTGAATATCTTCATATGGGT,0,1930395
ihfAp4,0.5,1,1,TTGAAGGCGCTGGCATAATC,0,1936106
ihfAp4,0.5,1,1,TTGAAGCCAATGGACATGAG,0,1956449
ihfAp4,0.5,1,1,TTGAACGCGGCCACATTAAT,0,1952521
ihfAp4,0.5,1,1,TTCTTTGTTAGCCAGGTGCT,0,1915045
ihfAp4,0.5,1,1,TTCTGTAAGGGGCAAACATG,0,1949284
ihfAp4,0.5,1,1,TTCTGATCTCATATAACTGT,0,1942354
ihfAp4,0.5,1,1,TTCTGACCAGATAAGGTGCT,0,1919788
ihfAp4,0.5,1,1,TTCTGAACTGCACGGACTTG,0,1935051
ihfAp4,0.5,1,1,TTCTAGTCGGAACCGTTCTG,0,1956782
ihfAp4,0.5,1,1,TTCTACGCTTGCGCGGCACG,0,1910643
ihfAp4,0.5,1,1,TTCTACCGAGGATGTCAGGT,0,1918022
ihfAp4,0.5,1,1,TTCGTTGTCCTATATAGCTC,0,1911665
ihfAp4,0.5,1,1,TTCGTTCTGGGTTTGTAAAT,0,1946417
ihfAp4,0.5,1,1,TTCGGTATAGGGCTGATTCA,0,1950549
ihfAp4,0.5,1,1,TTCGGGTGTCGAAGTGGAAA,0,1939819
ihfAp4,0.5,1,1,TTCGGGATGGAGCACGGTGA,0,1930660
ihfAp4,0.5,1,1,TTCGCGATAAGCAGCTGATA,0,1911755
ihfAp4,0.5,1,1,TTCGCCAGCCTGCCGGCTCA,0,1958078
ihfAp4,0.5,1,1,TTCGCACATCGTCGCGTACC,0,1939682
ihfAp4,0.5,1,1,TTCGCAACAGTTGTCACCGC,0,1928991
ihfAp4,0.5,1,1,TTCGAGCACGCTCAAGGCGC,0,1941842
ihfAp4,0.5,1,1,TTCGAGACTCCACAATGGAA,0,1947025
ihfAp4,0.5,1,1,TTCGACTATCCCACGGCTCT,0,1955591
ihfAp4,0.5,1,1,TTCGAAGCCTCTTCGCCTGG,0,1920538
ihfAp4,0.5,1,1,TTCGAAAGTGTCATATTACG,0,1921763
ihfAp4,0.5,1,1,TTCCGTAACGTTATGCTTGG,0,1957886
ihfAp4,0.5,1,1,TTCCGGTGAAAGGGGAACGA,0,1921128
ihfAp4,0.5,1,1,TTCCGGTAATCTGGCAAGCT,0,1950706
ihfAp4,0.5,1,1,TTCCGCCTTTCTGCATAGAC,0,1957206
ihfAp4,0.5,1,1,TTCCCGCGAAGTCTTGCCCA,0,1953680
ihfAp4,0.5,1,1,TTCCCACTCTGTCTCGTCGC,0,1959088
ihfAp4,0.5,1,1,TTCCAGGGTATCTGTGTCAC,0,1917564
ihfAp4,0.5,1,1,TTCCAGACAGAGGTTTCCAG,0,1932808
ihfAp4,0.5,1,1,TTCCACTATATATTTATCCG,0,1951393
ihfAp4,0.5,1,1,TTCCACTAGAGGATGCCGTA,0,1946777
ihfAp4,0.5,1,1,TTCCACGTACTGGGTAATTT,0,1934398
ihfAp4,0.5,1,1,TTCATTTTCCCACATTGGTT,0,1916537
ihfAp4,0.5,1,1,TTCATTGGGTTACGTAGCTT,0,1916725
ihfAp4,0.5,1,1,TTCATCGCGCGGGTCTGTTG,0,1945083
ihfAp4,0.5,1,1,TTCATACGCGTGGTGTATAG,0,1919311
ihfAp4,0.5,1,1,TTCAGTATTGACATAAAAAT,0,1936588
ihfAp4,0.5,1,1,TTCAGGTTTCGATAATAAGA,0,1932412
ihfAp4,0.5,1,1,TTCAGGCCCGGCATTCCGGT,0,1946068
ihfAp4,0.5,1,1,TTCACGCGTGCTTTTACCTT,0,1922068
ihfAp4,0.5,1,1,TTCACGAGGTGGCTGGAGAC,0,1945366
ihfAp4,0.5,1,1,TTCAATAAGGGGCAAATCTG,0,1931744
ihfAp4,0.5,1,1,TTCAAGCGCGTTAGAAAGAG,0,1910029
ihfAp4,0.5,1,1,TTCAACTCGGTACCCTTAGC,0,1961753
ihfAp4,0.5,1,1,TTCAAAAATTTCCGCATTGG,0,1935801
ihfAp4,0.5,1,1,TTATTTCCGCTGTTAATGAC,0,1936808
ihfAp4,0.5,1,1,TTATTTACAAGTTGTGGGAG,0,1949572
ihfAp4,0.5,1,1,TTATTGGCAATACTACGTGC,0,1957737
ihfAp4,0.5,1,1,TTATTACACCAAGTGTTCAG,0,1940990
ihfAp4,0.5,1,1,TTATGTTGTGAGCTAGAGTG,0,1931473
ihfAp4,0.5,1,1,TTATGGAGGGATGTTTGGAT,0,1932884
ihfAp4,0.5,1,1,TTATGGAAGAGAGCGTTTAT,0,1956181
ihfAp4,0.5,1,1,TTATGACCAGCAAGACAACA,0,1946836
ihfAp4,0.5,1,1,TTATCTACAGTCGGGTGGCG,0,1961865
ihfAp4,0.5,1,1,TTATCTAATCTGGAGTATTA,0,1911776
ihfAp4,0.5,1,1,TTATCGGTACCTTTGGGCGG,0,1936827
ihfAp4,0.5,1,1,TTATCGCAGCGCAGAGCGAT,0,1946468
ihfAp4,0.5,1,1,TTATCCCTGGGTAATCCCCT,0,1947993
ihfAp4,0.5,1,1,TTATATGTCCTAGGGGTAAG,0,1914265
ihfAp4,0.5,1,1,TTATAAACGGAGCGTGCCAT,0,1953068
ihfAp4,0.5,1,1,TTAGTGTATGTGTACCTGTA,0,1934095
ihfAp4,0.5,1,1,TTAGTCTCAGTATAGAATCA,0,1921638
ihfAp4,0.5,1,1,TTAGTCGCCCCCCGGACAAG,0,1909847
ihfAp4,0.5,1,1,TTAGCTGACAGTTGATAGGG,0,1916756
ihfAp4,0.5,1,1,TTAGCTCTGGGGGCAGCTGT,0,1950449
ihfAp4,0.5,1,1,TTAGCGGCTGAAATCGCACA,0,1938082
ihfAp4,0.5,1,1,TTAGAGTAAACTTCTTGCTT,0,1943439
ihfAp4,0.5,1,1,TTAGAAACAACGTGATGTAC,0,1935716
ihfAp4,0.5,1,1,TTACTTCCTGTGCGTCTCAT,0,1935628
ihfAp4,0.5,1,1,TTACTTAAAAAATAATCCAG,0,1922411
ihfAp4,0.5,1,1,TTACGTAATAGCCTTACGGG,0,1943522
ihfAp4,0.5,1,1,TTACGCTGGTCGCTGTTCGC,0,1922188
ihfAp4,0.5,1,1,TTACCCACCTGTTTCGGAAC,0,1913647
ihfAp4,0.5,1,1,TTACAAGGGCGCAAGTCTTG,0,1953269
ihfAp4,0.5,1,1,TTACAACATGTACTATTGCT,0,1912838
ihfAp4,0.5,1,1,TTACAACATGAGGCTTAACA,0,1935136
ihfAp4,0.5,1,1,TTAATGTTTCGAACGGGGCG,0,1957857
ihfAp4,0.5,1,1,TTAAGTTCCAGAAATTTCTG,0,1934133
ihfAp4,0.5,1,1,TTAAGTCACATGTGTAGCGT,0,1921246
ihfAp4,0.5,1,1,TTAACTTCGGCAGGCTAAAC,0,1934998
ihfAp4,0.5,1,1,TTAACCCGTGGATGTTTTGT,0,1918857
ihfAp4,0.5,1,1,TTAACCCCCTTGCGCCACTC,0,1925007
ihfAp4,0.5,1,1,TTAACACGCCGACCGTTCAT,0,1925048
ihfAp4,0.5,1,1,TTAAATGTTATCATCACTAA,0,1925698
ihfAp4,0.5,1,1,TTAAACTCAGCCTATACCAA,0,1924316
ihfAp4,0.5,1,1,TTAAACACTGGCATTATTCC,0,1913414
ihfAp4,0.5,1,1,TGTTTTCAATTAGTGCAGAT,0,1956413
ihfAp4,0.5,1,1,TGTTTGGGATCTCCGTAAAG,0,1934699
ihfAp4,0.5,1,1,TGTTGTAATGGGAACAGGAT,0,1910797
ihfAp4,0.5,1,1,TGTTGGTATCAAACTCTTGT,0,1925392
ihfAp4,0.5,1,1,TGTTGCTAACAGGTAAGCAG,0,1926787
ihfAp4,0.5,1,1,TGTTGCACAGCCCCAATACG,0,1916642
ihfAp4,0.5,1,1,TGTTCCGCAAAGATACAGCA,0,1917822
ihfAp4,0.5,1,1,TGTTCAGGGAAGGTTCCCAT,0,1955446
ihfAp4,0.5,1,1,TGTTAGTTAAGAGGCGTTTG,0,1960189
ihfAp4,0.5,1,1,TGTTAGTGTCTATTTGACTG,0,1952928
ihfAp4,0.5,1,1,TGTTACATGAAACGAGGGAT,0,1955185
ihfAp4,0.5,1,1,TGTTAAGGCCGATATTTTTC,0,1924759
ihfAp4,0.5,1,1,TGTTAACTGCCGAAGATTTA,0,1910268
ihfAp4,0.5,1,1,TGTTAACACTAGCGCTCACT,0,1921135
ihfAp4,0.5,1,1,TGTGTTTTGTAGATTCTCAC,0,1958873
ihfAp4,0.5,1,1,TGTGGGGGGCTATACAGACT,0,1961242
ihfAp4,0.5,1,1,TGTGGGCGAGGTATCGCTAC,0,1958112
ihfAp4,0.5,1,1,TGTGCTTTACGTACCTGAGA,0,1945636
ihfAp4,0.5,1,1,TGTGCGCTCGTCTGAGCGAT,0,1917859
ihfAp4,0.5,1,1,TGTGCGCCTATTTGTTAAGA,0,1959175
ihfAp4,0.5,1,1,TGTGCGCCAGGCAACGGTCT,0,1912750
ihfAp4,0.5,1,1,TGTGCCGATCGATAGCCGGA,0,1926659
ihfAp4,0.5,1,1,TGTGCAACCGCAAACGCCAT,0,1919755
ihfAp4,0.5,1,1,TGTGATAGATTTTTGGCATG,0,1920838
ihfAp4,0.5,1,1,TGTGAGATCCCATACAGTGT,0,1910673
ihfAp4,0.5,1,1,TGTCTGTGGCACGCATCCTG,0,1922581
ihfAp4,0.5,1,1,TGTCTGATCCCATCTTACTA,0,1933662
ihfAp4,0.5,1,1,TGTCTGACGTCGGTCCATCG,0,1959107
ihfAp4,0.5,1,1,TGTCTCTCCCTTTAGGACAG,0,1913175
ihfAp4,0.5,1,1,TGTCTCTCCAACGTGATGGG,0,1945469
ihfAp4,0.5,1,1,TGTCGGTTCGAGTACAGCGC,0,1941781
ihfAp4,0.5,1,1,TGTCGCTGCGTTTGTCCACT,0,1936741
ihfAp4,0.5,1,1,TGTCGAGAGCGCACAGGAGG,0,1943420
ihfAp4,0.5,1,1,TGTCCGGCAAACGCGCCTCT,0,1955056
ihfAp4,0.5,1,1,TGTCCCCAGTCAGCCGGGAC,0,1946620
ihfAp4,0.5,1,1,TGTCATAAGTTAAACCTGGA,0,1959525
ihfAp4,0.5,1,1,TGTATGTAAGTTGTAACGAC,0,1938317
ihfAp4,0.5,1,1,TGTAGCCTCTCCTAGCGAAG,0,1909569
ihfAp4,0.5,1,1,TGTACGTGCCACCGGCACGC,0,1916863
ihfAp4,0.5,1,1,TGTACCGCTTCACGGGAGCT,0,1917743
ihfAp4,0.5,1,1,TGTAAGTATGGGTTCTTCAT,0,1922597
ihfAp4,0.5,1,1,TGGTTTCTCTGGGTTAGCTA,0,1921312
ihfAp4,0.5,1,1,TGGTTTAGCTGTAGAGCTTT,0,1957112
ihfAp4,0.5,1,1,TGGTTCTGTTATTCTTTTGG,0,1943042
ihfAp4,0.5,1,1,TGGTTAGCGGTGCGTGCTAA,0,1950094
ihfAp4,0.5,1,1,TGGTGGCCGTGAAATGTTCG,0,1928266
ihfAp4,0.5,1,1,TGGTCCACTAGATCGCGCGG,0,1929378
ihfAp4,0.5,1,1,TGGTCATTCATTCCTAAATT,0,1933225
ihfAp4,0.5,1,1,TGGTAAGTGGCGAAATAGCA,0,1944941
ihfAp4,0.5,1,1,TGGTAAACGTGCTACGACGG,0,1910233
ihfAp4,0.5,1,1,TGGGTCTACGACGGCTGGGG,0,1918648
ihfAp4,0.5,1,1,TGGGGTTACCGTCCTCATCA,0,1943649
ihfAp4,0.5,1,1,TGGGGGTAAAGTCCTGGTAG,0,1944454
ihfAp4,0.5,1,1,TGGGGCCGTTGTAACGCAGA,0,1946549
ihfAp4,0.5,1,1,TGGGGCAACGGAGTAGGTCT,0,1931994
ihfAp4,0.5,1,1,TGGGGCAAACGACTAAACTG,0,1930821
ihfAp4,0.5,1,1,TGGGCTATCACATTGAAGTG,0,1930444
ihfAp4,0.5,1,1,TGGGATCCACGAGGCAGGAG,0,1926531
ihfAp4,0.5,1,1,TGGGAGTTCTTGGCGGATTC,0,1918675
ihfAp4,0.5,1,1,TGGGAATCGGTAGTTCCACT,0,1956015
ihfAp4,0.5,1,1,TGGGAAAACATCCCCCCAAT,0,1916101
ihfAp4,0.5,1,1,TGGCTAGCAACAAATAGTAG,0,1918298
ihfAp4,0.5,1,1,TGGCGGGAAACGGGCAATAC,0,1950905
ihfAp4,0.5,1,1,TGGCCTCGTTTCGTGCCCAG,0,1922625
ihfAp4,0.5,1,1,TGGCCCATAGTGGCGATAGG,0,1915511
ihfAp4,0.5,1,1,TGGATTGGGCGGCGTGCCTG,0,1914820
ihfAp4,0.5,1,1,TGGATGGTTCCGGGAATATA,0,1917965
ihfAp4,0.5,1,1,TGGATCACGTGCGTTCCAGC,0,1923895
ihfAp4,0.5,1,1,TGGATAGCGCCAGGACTAAC,0,1951460
ihfAp4,0.5,1,1,TGGAGGAAACTGTGATAGCT,0,1960628
ihfAp4,0.5,1,1,TGGACTACACGCCAACGACT,0,1934550
ihfAp4,0.5,1,1,TGGACGCTGCCGAGCCGGTT,0,1957733
ihfAp4,0.5,1,1,TGGAAATTCGTGATACTCGA,0,1931669
ihfAp4,0.5,1,1,TGGAAACTACATATTGAGCG,0,1951228
ihfAp4,0.5,1,1,TGCTTACCGAATACATCCCC,0,1934900
ihfAp4,0.5,1,1,TGCTGTTTAATGTGTAATTC,0,1918865
ihfAp4,0.5,1,1,TGCTGCAATTCGTTAATTAT,0,1953094
ihfAp4,0.5,1,1,TGCTCTGTGGAGCGGCCTTC,0,1936104
ihfAp4,0.5,1,1,TGCTCCGTGCACGTATGACA,0,1957657
ihfAp4,0.5,1,1,TGCTAGTAGGAATTCACCGA,0,1919135
ihfAp4,0.5,1,1,TGCTAGTAGCCTAGAATTAT,0,1926240
ihfAp4,0.5,1,1,TGCTAAGGCTAAGGCCTGAG,0,1921630
ihfAp4,0.5,1,1,TGCGTTTTTCACATACGGCC,0,1935264
ihfAp4,0.5,1,1,TGCGTGAGGGTGTTCTCTCC,0,1914399
ihfAp4,0.5,1,1,TGCGCGTGGGGCGCTACCTG,0,1945577
ihfAp4,0.5,1,1,TGCGCGTATGGCTCTAGTTA,0,1937007
ihfAp4,0.5,1,1,TGCGCACAGGGTATGTGATA,0,1937206
ihfAp4,0.5,1,1,TGCGATTTTGGGGCTGTGGA,0,1954009
ihfAp4,0.5,1,1,TGCCTGTTCAGATCAAACCC,0,1936534
ihfAp4,0.5,1,1,TGCCTGACTCGGGGAGTGGC,0,1919622
ihfAp4,0.5,1,1,TGCCTCCAGGGTCAATGAGG,0,1914455
ihfAp4,0.5,1,1,TGCCTCACTGGACACGGAGT,0,1948456
ihfAp4,0.5,1,1,TGCCTAATAGAACAGGACAC,0,1933043
ihfAp4,0.5,1,1,TGCCTAATAACAGCGTCGTG,0,1960701
ihfAp4,0.5,1,1,TGCCGGCGAAGCCCGAAACA,0,1926408
ihfAp4,0.5,1,1,TGCCGCAGCGGATTACAACT,0,1954782
ihfAp4,0.5,1,1,TGCCGAGAGGAGTATAAACT,0,1921408
ihfAp4,0.5,1,1,TGCCCGTGGCTCTGACGAAT,0,1930645
ihfAp4,0.5,1,1,TGCCCCAGGCTTCGAAAGCA,0,1923612
ihfAp4,0.5,1,1,TGCCATAAAGGGTTGTCTCA,0,1928993
ihfAp4,0.5,1,1,TGCCAGCGGGTCCCAAGAGG,0,1917083
ihfAp4,0.5,1,1,TGCCACTAATTAATGATAAC,0,1942702
ihfAp4,0.5,1,1,TGCATATCGTGTCATGATGG,0,1933989
ihfAp4,0.5,1,1,TGCATACGCGAATCATCACA,0,1947588
ihfAp4,0.5,1,1,TGCATACGCACTATCCAACA,0,1938074
ihfAp4,0.5,1,1,TGCAGTGCTAACGCCTTATC,0,1953652
ihfAp4,0.5,1,1,TGCAGGTAGTTTTGATCGGA,0,1954920
ihfAp4,0.5,1,1,TGCAGCTTGGGTCTGAGAAT,0,1933892
ihfAp4,0.5,1,1,TGCAGAAGGTGCATTACTGA,0,1938471
ihfAp4,0.5,1,1,TGCACGTTACCACAAAAACC,0,1938735
ihfAp4,0.5,1,1,TGCACGAAGACTGTCAGACC,0,1958728
ihfAp4,0.5,1,1,TGCACCGAAAGCAGGGCAGT,0,1949373
ihfAp4,0.5,1,1,TGCACCAGTGAGCCGATTGC,0,1928239
ihfAp4,0.5,1,1,TGCACCAAACCGACACAAAA,0,1952025
ihfAp4,0.5,1,1,TGCACAAGAGTGAGTCTGCA,0,1948311
ihfAp4,0.5,1,1,TGCACAACTATTACCCCTCC,0,1950148
ihfAp4,0.5,1,1,TGCAAGGAAGCCACGCGGGT,0,1943939
ihfAp4,0.5,1,1,TGATTATCGGATGGCCGATG,0,1911671
ihfAp4,0.5,1,1,TGATTACCGTGTAATTTGTG,0,1930212
ihfAp4,0.5,1,1,TGATGCTGCAGTTAATCAGT,0,1954471
ihfAp4,0.5,1,1,TGATGCGTTATTATCGGGGT,0,1920506
ihfAp4,0.5,1,1,TGATGCAGAGGTTTCGTAGT,0,1914872
ihfAp4,0.5,1,1,TGATCTATCGATGTTCAGAT,0,1959900
ihfAp4,0.5,1,1,TGATCGCTTCTGGGCACGGT,0,1913574
ihfAp4,0.5,1,1,TGATCCTGGCTCGATAAATG,0,1927284
ihfAp4,0.5,1,1,TGATCCTCTCATTCTGATTG,0,1918050
ihfAp4,0.5,1,1,TGATACGTTTTCAGAAGTCG,0,1927191
ihfAp4,0.5,1,1,TGATACGAGCTCAACTTATT,0,1957744
ihfAp4,0.5,1,1,TGAGTTGTCGTCTTTAGGAG,0,1934690
ihfAp4,0.5,1,1,TGAGTTCGGTTAACTGCTCT,0,1927982
ihfAp4,0.5,1,1,TGAGTATTCAAGCACGGATG,0,1928853
ihfAp4,0.5,1,1,TGAGTAGGTGTAGCGAAGCA,0,1916583
ihfAp4,0.5,1,1,TGAGTAGCTCGCCTCGAATC,0,1936251
ihfAp4,0.5,1,1,TGAGGGCATTCCACCGTGGC,0,1948579
ihfAp4,0.5,1,1,TGAGGCGAAACCTACCCAAA,0,1947091
ihfAp4,0.5,1,1,TGAGGATTTACGCAGTTAAA,0,1945641
ihfAp4,0.5,1,1,TGAGGAATAGTATTGCCAAT,0,1920984
ihfAp4,0.5,1,1,TGAGCCTGTGTTCGACCTCG,0,1915489
ihfAp4,0.5,1,1,TGAGAGCCTTTCGGTTCACT,0,1944494
ihfAp4,0.5,1,1,TGAGAACAAAATGCCAGAAC,0,1961466
ihfAp4,0.5,1,1,TGACTTTCTGGGCCAGGACA,0,1960449
ihfAp4,0.5,1,1,TGACTCTGGTATAAGCGGAA,0,1959365
ihfAp4,0.5,1,1,TGACTAGCCAGACTCGCGGA,0,1926263
ihfAp4,0.5,1,1,TGACGACTCTTCTGTAGCTC,0,1928099
ihfAp4,0.5,1,1,TGACCCTGCAGACTCGTTTG,0,1916909
ihfAp4,0.5,1,1,TGACCCATTTGCTGTCAGAC,0,1937089
ihfAp4,0.5,1,1,TGACCAGACGGTTTTAGCGA,0,1948533
ihfAp4,0.5,1,1,TGACATTGCCTGTCCTTACC,0,1961390
ihfAp4,0.5,1,1,TGAATTAGGCTGCCCTCGAT,0,1943144
ihfAp4,0.5,1,1,TGAATCGCCGCATAGGGATG,0,1945455
ihfAp4,0.5,1,1,TGAATCCCGACAGCAGGCTC,0,1934135
ihfAp4,0.5,1,1,TGAATCCACAGTCTGGCGTC,0,1961959
ihfAp4,0.5,1,1,TGAAGTACTCAGCGAATTGG,0,1913212
ihfAp4,0.5,1,1,TGAAGGGGTTAGCCCGCCAA,0,1933359
ihfAp4,0.5,1,1,TGAAGGAGTGTGTCTTAATG,0,1913692
ihfAp4,0.5,1,1,TGAAGACGCATAATTTAAGG,0,1918332
ihfAp4,0.5,1,1,TGAACTGGCGCTCTGGTCCA,0,1932402
ihfAp4,0.5,1,1,TGAACGGCCTGCGCGCGCAA,0,1929348
ihfAp4,0.5,1,1,TGAACGCCCACTCAGGATAG,0,1947058
ihfAp4,0.5,1,1,TGAACCGGGTTTTTAACATA,0,1945933
ihfAp4,0.5,1,1,TGAAAGGTCAGAATTAGTCG,0,1957951
ihfAp4,0.5,1,1,TGAAACTTGAAGCGGTTTCA,0,1924057
ihfAp4,0.5,1,1,TCTTTGCGTCTTAAAAGGAA,0,1913067
ihfAp4,0.5,1,1,TCTTGTTTCCAAAGAAAGCT,0,1932591
ihfAp4,0.5,1,1,TCTTGGGTATATACTACGGA,0,1930849
ihfAp4,0.5,1,1,TCTTGGCGGTTTAATAAGCT,0,1932795
ihfAp4,0.5,1,1,TCTTGGATCTACGGTGTTTT,0,1947627
ihfAp4,0.5,1,1,TCTTCTGTCCTGCAACCTTG,0,1945681
ihfAp4,0.5,1,1,TCTTCGAATTCGGACCCCTG,0,1957669
ihfAp4,0.5,1,1,TCTTCAACTAGGAGAATAGT,0,1927444
ihfAp4,0.5,1,1,TCTTAGAGGCCCGGTGCCCT,0,1927196
ihfAp4,0.5,1,1,TCTGTGACAAGGTCAAGCAT,0,1941502
ihfAp4,0.5,1,1,TCTGTCCCGTGAAGGAGACC,0,1959543
ihfAp4,0.5,1,1,TCTGTATTGTGCTTAAAGTG,0,1917534
ihfAp4,0.5,1,1,TCTGGTTAATGGATTTGAGG,0,1919560
ihfAp4,0.5,1,1,TCTGGATCCAATAAGTAGGT,0,1949693
ihfAp4,0.5,1,1,TCTGCATAGGTTTAGCGAGT,0,1921418
ihfAp4,0.5,1,1,TCTGACTTTTTATCCAGAAG,0,1957762
ihfAp4,0.5,1,1,TCTGACCGTGCTGACGGTTT,0,1959552
ihfAp4,0.5,1,1,TCTCTGCATTCATAACTTAA,0,1956527
ihfAp4,0.5,1,1,TCTCTCGACGTTTCAGACCA,0,1931842
ihfAp4,0.5,1,1,TCTCGTTGGCCATACTGTCA,0,1952005
ihfAp4,0.5,1,1,TCTCGGGTAATTGAGTACCA,0,1945092
ihfAp4,0.5,1,1,TCTCGGGGATGTAGTGGGAT,0,1936837
ihfAp4,0.5,1,1,TCTCCGAGGTTTTAGTAGAA,0,1944105
ihfAp4,0.5,1,1,TCTCCCCCGCGCTACTAACC,0,1954183
ihfAp4,0.5,1,1,TCTCATCCGGCGACAGCGGT,0,1912848
ihfAp4,0.5,1,1,TCTCAATCGAGGAACGTTGT,0,1941895
ihfAp4,0.5,1,1,TCTAGTTGATTTAGAGCATG,0,1930818
ihfAp4,0.5,1,1,TCTAGCATGTGAGGCCTATG,0,1920205
ihfAp4,0.5,1,1,TCTAGAGTTATAGGCTCACC,0,1920856
ihfAp4,0.5,1,1,TCTAAGGAGGATCAAAGTGA,0,1947850
ihfAp4,0.5,1,1,TCTAACGGTTTCAAGCGACC,0,1923952
ihfAp4,0.5,1,1,TCGTTTTTCGTTCTTGGTTA,0,1937676
ihfAp4,0.5,1,1,TCGTTTCGCACTACGATCAG,0,1918435
ihfAp4,0.5,1,1,TCGTTGCGCACGTTAAAATC,0,1926472
ihfAp4,0.5,1,1,TCGTTCGACGGGGTCTCGTC,0,1954052
ihfAp4,0.5,1,1,TCGTGTCTTGGCTAATGGGG,0,1918633
ihfAp4,0.5,1,1,TCGTGAGGCTTTCCAGCCGC,0,1951579
ihfAp4,0.5,1,1,TCGTGAGACCGTCGTACCTT,0,1945834
ihfAp4,0.5,1,1,TCGTCTATAATAATGCCCCT,0,1934838
ihfAp4,0.5,1,1,TCGTCGAACCTCTTTTCGCG,0,1948622
ihfAp4,0.5,1,1,TCGTATCATTTAGCGCCGTA,0,1929832
ihfAp4,0.5,1,1,TCGTAGGTCGCACTTATGGG,0,1944437
ihfAp4,0.5,1,1,TCGTACCTAGCCTTCTTCTC,0,1936611
ihfAp4,0.5,1,1,TCGGTTGAGTATCCGTCCCA,0,1951455
ihfAp4,0.5,1,1,TCGGTTAATTATGAGCGGGG,0,1910549
ihfAp4,0.5,1,1,TCGGGGCCTGCATCCGTCAT,0,1929175
ihfAp4,0.5,1,1,TCGGGCTATACACTTCAATG,0,1946651
ihfAp4,0.5,1,1,TCGGGACTTTCCGGGAAACG,0,1950389
ihfAp4,0.5,1,1,TCGGATGCTCTTATCAGGGT,0,1925427
ihfAp4,0.5,1,1,TCGGAGGACGCCGGCTTCTT,0,1938631
ihfAp4,0.5,1,1,TCGGAGATTCTGAGAAAGCG,0,1929474
ihfAp4,0.5,1,1,TCGCGGAAGCAGCACTGAGG,0,1947147
ihfAp4,0.5,1,1,TCGCCTACTGGGTCACGCAG,0,1926471
ihfAp4,0.5,1,1,TCGCCCACGGACTTAGCTCG,0,1920519
ihfAp4,0.5,1,1,TCGCATATTAAGGCGTTATA,0,1916972
ihfAp4,0.5,1,1,TCGCAGTACGAGCCAGGTGC,0,1939016
ihfAp4,0.5,1,1,TCGCAGGCTGGACGCTTACC,0,1928049
ihfAp4,0.5,1,1,TCGACTAAGTCCCTACGTCG,0,1946963
ihfAp4,0.5,1,1,TCGACGGAGAGGTTCTTCCG,0,1950556
ihfAp4,0.5,1,1,TCGAAGTGTTTATCGCCGGG,0,1945745
ihfAp4,0.5,1,1,TCGAACGCCGCTCCGGCGCT,0,1961452
ihfAp4,0.5,1,1,TCCTTTCCCCCGTGGTCACT,0,1913873
ihfAp4,0.5,1,1,TCCTGGCATTATGCTGACAT,0,1921846
ihfAp4,0.5,1,1,TCCTGAGCACAGGCATAGGC,0,1949637
ihfAp4,0.5,1,1,TCCTCAAAAGTTCTCCGCGA,0,1960206
ihfAp4,0.5,1,1,TCCTAGACGCAATCAAGAGA,0,1934994
ihfAp4,0.5,1,1,TCCTACGTTATAATCATAGC,0,1949017
ihfAp4,0.5,1,1,TCCTAATGACAGGAACTCCA,0,1939283
ihfAp4,0.5,1,1,TCCTAAGACCCGCAATACGA,0,1926644
ihfAp4,0.5,1,1,TCCGTTCGACAATTATTCCT,0,1958401
ihfAp4,0.5,1,1,TCCGTGGTGCAGATCTAGGA,0,1955495
ihfAp4,0.5,1,1,TCCGTCAATTTCTCCAATCG,0,1926635
ihfAp4,0.5,1,1,TCCGCTCAAGGCGGACACCA,0,1942706
ihfAp4,0.5,1,1,TCCGCGGTCATTAGGAGTTC,0,1912998
ihfAp4,0.5,1,1,TCCGCGATGGCTATCGGCCC,0,1933573
ihfAp4,0.5,1,1,TCCCTGCCCCACCTATGTGG,0,1951520
ihfAp4,0.5,1,1,TCCCCTATGATGTCAACGGT,0,1926319
ihfAp4,0.5,1,1,TCCCCCGGGTTTGACGGTCA,0,1936536
ihfAp4,0.5,1,1,TCCCAATTAGGCAGAGTTAG,0,1928396
ihfAp4,0.5,1,1,TCCCAAGAAGATGCTTACTT,0,1933830
ihfAp4,0.5,1,1,TCCATTTGTGCTGTGTGGTC,0,1961064
ihfAp4,0.5,1,1,TCCATTTCAAGACGACACTT,0,1926036
ihfAp4,0.5,1,1,TCCATGCTCAGTTGGCATAG,0,1939997
ihfAp4,0.5,1,1,TCCATCCGTAAGTAGGGCGG,0,1931364
ihfAp4,0.5,1,1,TCCATATCATTCATTTGATT,0,1933670
ihfAp4,0.5,1,1,TCCAGTCTTGAATTATTAGC,0,1949081
ihfAp4,0.5,1,1,TCCAGGTGGACGCCCCTGGG,0,1957530
ihfAp4,0.5,1,1,TCCAGCTTCGTGCCGGCGCA,0,1958667
ihfAp4,0.5,1,1,TCCAGAGATGTCCACAATCT,0,1936201
ihfAp4,0.5,1,1,TCCACTTGGTTTTAAGTATT,0,1927786
ihfAp4,0.5,1,1,TCCACAGCGTCGGTTGTTAC,0,1936851
ihfAp4,0.5,1,1,TCCAAACAGTTCGGAGCCTC,0,1923073
ihfAp4,0.5,1,1,TCATTTTCGTGATGTAAACA,0,1919839
ihfAp4,0.5,1,1,TCATTATGAGGCCCTTCTTG,0,1950865
ihfAp4,0.5,1,1,TCATCTCACTTTAGACATGG,0,1918314
ihfAp4,0.5,1,1,TCATCCCATCCGTCTAGACA,0,1944943
ihfAp4,0.5,1,1,TCATATGGAGATTTTCATGG,0,1917482
ihfAp4,0.5,1,1,TCATACGTCAGTTCAGCGAG,0,1934673
ihfAp4,0.5,1,1,TCATAAGCCTAAAGAGGCCT,0,1918562
ihfAp4,0.5,1,1,TCATAACTTCCAACTGTAAG,0,1915619
ihfAp4,0.5,1,1,TCAGTTTATTGGCGGTTGCG,0,1953203
ihfAp4,0.5,1,1,TCAGTTTACGGGACCCCTAA,0,1918923
ihfAp4,0.5,1,1,TCAGTTCTGAAGGGATAGTG,0,1910930
ihfAp4,0.5,1,1,TCAGGGCACGTTCCTTTGGT,0,1928553
ihfAp4,0.5,1,1,TCAGGATGGAAAGGTAGATT,0,1941380
ihfAp4,0.5,1,1,TCAGGACGCTACCTGGAATA,0,1932424
ihfAp4,0.5,1,1,TCAGGAAAACTCCTCCTTGA,0,1949748
ihfAp4,0.5,1,1,TCAGCCATTAGGGAACGGCG,0,1958698
ihfAp4,0.5,1,1,TCAGCAATGCAACGTTCAGG,0,1960871
ihfAp4,0.5,1,1,TCAGATTTGGCCATGTCTAA,0,1914382
ihfAp4,0.5,1,1,TCAGAGTAACATTAGAGCCC,0,1910116
ihfAp4,0.5,1,1,TCACTCTAACCTGGGAACCC,0,1954146
ihfAp4,0.5,1,1,TCACTAGGGATATCGGCGTT,0,1944409
ihfAp4,0.5,1,1,TCAATTGTATAGGCCATTAA,0,1952548
ihfAp4,0.5,1,1,TCAATGGGAGCTCAACAAAC,0,1918105
ihfAp4,0.5,1,1,TCAAGTGGATCAAAACCAGC,0,1943188
ihfAp4,0.5,1,1,TCAAGGAACTGAGAGCCTAC,0,1943791
ihfAp4,0.5,1,1,TCAACACGTAAGTGCAAGAG,0,1915968
ihfAp4,0.5,1,1,TATTTCATGTTACGGTGGTG,0,1919359
ihfAp4,0.5,1,1,TATTTAATCCTACTGGGCTG,0,1933029
ihfAp4,0.5,1,1,TATTCGCTGAATCCGGCTCA,0,1940502
ihfAp4,0.5,1,1,TATTCCCACCATTAATGGAA,0,1947598
ihfAp4,0.5,1,1,TATTATTTGTCACTCTATAT,0,1956597
ihfAp4,0.5,1,1,TATTATCCGACTATAACCGT,0,1920882
ihfAp4,0.5,1,1,TATTATCCGACTATAAACGT,0,1920832
ihfAp4,0.5,1,1,TATTAGTTGTCACTGAAGGT,0,1931220
ihfAp4,0.5,1,1,TATTAAGTCAACATCCCGAC,0,1953365
ihfAp4,0.5,1,1,TATGTTCGGGCAGACTTTCC,0,1926144
ihfAp4,0.5,1,1,TATGTGAACACTCCTTTACG,0,1910918
ihfAp4,0.5,1,1,TATGTATGTACTATATTGCA,0,1954737
ihfAp4,0.5,1,1,TATGTACACGACGACAGCAT,0,1941536
ihfAp4,0.5,1,1,TATGGTCATAGTTGGGCGGC,0,1958148
ihfAp4,0.5,1,1,TATGGGCGTCCTTAAGATAC,0,1917406
ihfAp4,0.5,1,1,TATGGGCGCATGGCAGTCGT,0,1915465
ihfAp4,0.5,1,1,TATGGCGGTCACGACTAGCC,0,1919909
ihfAp4,0.5,1,1,TATGGCCCAACAGGCTCGGA,0,1936377
ihfAp4,0.5,1,1,TATGCTCGTCTGCGCTTAAG,0,1958418
ihfAp4,0.5,1,1,TATCGCACATACGTCTGCTC,0,1947824
ihfAp4,0.5,1,1,TATCGAACCGGTTTGTGATG,0,1960475
ihfAp4,0.5,1,1,TATCCTGGTTAAAGTTCACG,0,1943009
ihfAp4,0.5,1,1,TATCCACTCATCCGCAAAAG,0,1913779
ihfAp4,0.5,1,1,TATCATGATTATGACAATGC,0,1950600
ihfAp4,0.5,1,1,TATATTTATAGCGCAGGTAT,0,1950435
ihfAp4,0.5,1,1,TATAGGAGGTGCATGAACAG,0,1920383
ihfAp4,0.5,1,1,TATAGCGGAAGATTATTAGT,0,1915466
ihfAp4,0.5,1,1,TATACGGTTAATTAACGTGG,0,1912022
ihfAp4,0.5,1,1,TATACGCTGATCACATTGTC,0,1921059
ihfAp4,0.5,1,1,TATACCGGTGTACTGTGCGA,0,1946662
ihfAp4,0.5,1,1,TATAACTGCGTGTGGAGGTC,0,1947201
ihfAp4,0.5,1,1,TATAACTATTGGGCAACGGG,0,1918414
ihfAp4,0.5,1,1,TAGGTTGTATGTAAGCATCG,0,1944620
ihfAp4,0.5,1,1,TAGGTTACCGAACATACACG,0,1929006
ihfAp4,0.5,1,1,TAGGTTAAGACAGTTTTAAC,0,1960348
ihfAp4,0.5,1,1,TAGGGGTATGGGGATCATTG,0,1936417
ihfAp4,0.5,1,1,TAGGGGTAAAACCAGCACTT,0,1917981
ihfAp4,0.5,1,1,TAGGGGATTGACCCACGTCA,0,1912806
ihfAp4,0.5,1,1,TAGGGCTGTATTGATAATAT,0,1917201
ihfAp4,0.5,1,1,TAGGGCGACATGCGGGCACA,0,1921124
ihfAp4,0.5,1,1,TAGGGCAGATCTTAATGACC,0,1922219
ihfAp4,0.5,1,1,TAGGGACTTTACATTTAGTA,0,1957849
ihfAp4,0.5,1,1,TAGGCTTGCCGCAATCAAAC,0,1927765
ihfAp4,0.5,1,1,TAGGCTCGCGGAGTGGGCAT,0,1919796
ihfAp4,0.5,1,1,TAGGCGGAAATTGTAAGGAT,0,1922198
ihfAp4,0.5,1,1,TAGGCCTGGAACCTGGTATC,0,1913053
ihfAp4,0.5,1,1,TAGGCCATGTCTACGAATTC,0,1938498
ihfAp4,0.5,1,1,TAGGCAGCAATGCGCAATGA,0,1922145
ihfAp4,0.5,1,1,TAGGATGGTGAATAGGTCCA,0,1937595
ihfAp4,0.5,1,1,TAGGAGTCCATATCGAAGGA,0,1955883
ihfAp4,0.5,1,1,TAGGAGCCACTGGCCGGGGG,0,1925146
ihfAp4,0.5,1,1,TAGGACGCATACCAGCGGAC,0,1918398
ihfAp4,0.5,1,1,TAGGACCCGAGACGATGCCC,0,1954684
ihfAp4,0.5,1,1,TAGCTTTCTCAGGCAACACA,0,1958900
ihfAp4,0.5,1,1,TAGCTTGCAAAGCAAGCGGC,0,1925465
ihfAp4,0.5,1,1,TAGCTCGGGGGGTCCATAGT,0,1937868
ihfAp4,0.5,1,1,TAGCTCGGAAATTCACGGTG,0,1942327
ihfAp4,0.5,1,1,TAGCTAAATTGGCATCTGAT,0,1938881
ihfAp4,0.5,1,1,TAGCGGTTGTGATATTTCCA,0,1942878
ihfAp4,0.5,1,1,TAGCGGGGGGTGTCGCGCGA,0,1936707
ihfAp4,0.5,1,1,TAGCGATTTTTGTCTCTTTG,0,1949935
ihfAp4,0.5,1,1,TAGCCCCGCGCGCCATGGAC,0,1929517
ihfAp4,0.5,1,1,TAGCCCCCGTTACAGAGTTA,0,1959941
ihfAp4,0.5,1,1,TAGCCAATACTGGGCTGAAT,0,1910674
ihfAp4,0.5,1,1,TAGCATGGCCGGGCAAGATT,0,1943480
ihfAp4,0.5,1,1,TAGCAGGTTTCAAGTGTACA,0,1927309
ihfAp4,0.5,1,1,TAGCAGCTCCCAGCAAGAAC,0,1947590
ihfAp4,0.5,1,1,TAGCACGATCTACTTTCGAA,0,1936976
ihfAp4,0.5,1,1,TAGATATGATACGACCCATT,0,1943367
ihfAp4,0.5,1,1,TAGAGTCACCCCGCACCATT,0,1949356
ihfAp4,0.5,1,1,TAGAGGTCAATCTTCACAAC,0,1962311
ihfAp4,0.5,1,1,TAGAGGTATCAGGAGCTATT,0,1958659
ihfAp4,0.5,1,1,TAGAGAGATTCATACGTGGG,0,1942541
ihfAp4,0.5,1,1,TAGACAGCCAGGCCCGTAAT,0,1956601
ihfAp4,0.5,1,1,TAGAACAGTTTCGTGACACA,0,1957742
ihfAp4,0.5,1,1,TACTTCGCTAACGGCAGGTT,0,1934238
ihfAp4,0.5,1,1,TACTTAGCTGCTAGGGAGAG,0,1944501
ihfAp4,0.5,1,1,TACTTACACTAAAAGGTCGC,0,1950628
ihfAp4,0.5,1,1,TACTGTAATTGCCGGATTCG,0,1925132
ihfAp4,0.5,1,1,TACTGGCTTTCTTTCGCGAT,0,1946656
ihfAp4,0.5,1,1,TACTCTGCGTATATTCGCAA,0,1950593
ihfAp4,0.5,1,1,TACTCCAGCGAATGATCAGT,0,1929721
ihfAp4,0.5,1,1,TACTAGGCTAATGCAAGAGT,0,1942270
ihfAp4,0.5,1,1,TACTAGGCGTTCCTTTGTCT,0,1910202
ihfAp4,0.5,1,1,TACGTAAACGTAGCGAGGTT,0,1952063
ihfAp4,0.5,1,1,TACGGTGTCGAGCAGAGTAT,0,1939593
ihfAp4,0.5,1,1,TACGGTCGCGGCGTGAGGCC,0,1949297
ihfAp4,0.5,1,1,TACGGACATAGGAATCAAAG,0,1937163
ihfAp4,0.5,1,1,TACGGAATGATTACCGGGTA,0,1957145
ihfAp4,0.5,1,1,TACGCTATAACAGTTTTGAC,0,1962155
ihfAp4,0.5,1,1,TACGCGTCCCTCGGGGTTTT,0,1957587
ihfAp4,0.5,1,1,TACGCACGACAATAGACATT,0,1949052
ihfAp4,0.5,1,1,TACGAACCTGTATCAACCGT,0,1925174
ihfAp4,0.5,1,1,TACCTTCTAGGGGGCGTGTG,0,1915356
ihfAp4,0.5,1,1,TACCTGGGACGCATAGGCTA,0,1952361
ihfAp4,0.5,1,1,TACCCGATACCGGTGTGGGT,0,1916912
ihfAp4,0.5,1,1,TACCCCGAAGGACTCCCGCA,0,1960446
ihfAp4,0.5,1,1,TACCCATTGAAGGGGATACC,0,1957718
ihfAp4,0.5,1,1,TACCAACGTATCTAAGCTGC,0,1921777
ihfAp4,0.5,1,1,TACATTTAAGAGTTAACCGT,0,1944364
ihfAp4,0.5,1,1,TACATCACTGTGAGAATACC,0,1912233
ihfAp4,0.5,1,1,TACATACAACCACGTCTTGG,0,1911655
ihfAp4,0.5,1,1,TACAGTATCGATCTCTGACA,0,1914215
ihfAp4,0.5,1,1,TACAGTATCCTGACAGGTAC,0,1934988
ihfAp4,0.5,1,1,TACACGGTGGCAAGGTTGTT,0,1946270
ihfAp4,0.5,1,1,TACACGAAACCAGCCGCGCT,0,1918065
ihfAp4,0.5,1,1,TACAATTAGTGCTGCGAAAT,0,1914997
ihfAp4,0.5,1,1,TACAAGGTGTTCGTTCAGTG,0,1937981
ihfAp4,0.5,1,1,TACAAAGGTAAGGCAATACG,0,1911009
ihfAp4,0.5,1,1,TAATTGCATATGGGGCCGAC,0,1952455
ihfAp4,0.5,1,1,TAATTCGCTTTGGGGTCGGA,0,1944704
ihfAp4,0.5,1,1,TAATTCCTCGTGTCCATATG,0,1921441
ihfAp4,0.5,1,1,TAATTATCGCGGTGGGGACT,0,1960282
ihfAp4,0.5,1,1,TAATCGTTAGGCAAAAAGCC,0,1951488
ihfAp4,0.5,1,1,TAATCGAACCCGTCATTACC,0,1940084
ihfAp4,0.5,1,1,TAATATAACGTGCCAGGGCA,0,1918613
ihfAp4,0.5,1,1,TAATAGCACATGGTACTAGG,0,1924910
ihfAp4,0.5,1,1,TAATACATTGGGAGAGCGGT,0,1935286
ihfAp4,0.5,1,1,TAAGGGGATTCGTATGCTTA,0,1955463
ihfAp4,0.5,1,1,TAAGGCTTGTGGCTCGCCTT,0,1949460
ihfAp4,0.5,1,1,TAAGCGGGCCATAGGCTGCG,0,1931028
ihfAp4,0.5,1,1,TAAGCGGAGAACCAACATTG,0,1926631
ihfAp4,0.5,1,1,TAACTTCGAGAGTTAGGATC,0,1948205
ihfAp4,0.5,1,1,TAACTCCGAGATGTAGGAGT,0,1919097
ihfAp4,0.5,1,1,TAACGATTTCGGTCGGCGGA,0,1944955
ihfAp4,0.5,1,1,TAACAATAACAGCATAGTGT,0,1917361
ihfAp4,0.5,1,1,TAAATATTGTATGCCGCTAA,0,1956541
ihfAp4,0.5,1,1,TAAAGCACCACGCTTTTCGG,0,1956395
ihfAp4,0.5,1,1,TAAACGATGGTAGGCGAGAG,0,1949053
ihfAp4,0.5,1,1,TAAACGATCAGCCTTGGGTT,0,1948797
ihfAp4,0.5,1,1,TAAACCTACAAGACAGTCTA,0,1931978
ihfAp4,0.5,1,1,TAAAACGGAAAGTCTCAACG,0,1913126
ihfAp4,0.5,1,1,GTTTTGGGGGAAACAATCCA,0,1912753
ihfAp4,0.5,1,1,GTTTTATACATCTTTTAGCG,0,1941612
ihfAp4,0.5,1,1,GTTTGGTACTCGGTCGGCTG,0,1924720
ihfAp4,0.5,1,1,GTTTGCTGGGACGGGAGGCT,0,1951747
ihfAp4,0.5,1,1,GTTTCTTGGGTAACCAGCGG,0,1935075
ihfAp4,0.5,1,1,GTTTCAAATCGCACGACTTT,0,1910101
ihfAp4,0.5,1,1,GTTTATGGTCCGGCTTGGGT,0,1928111
ihfAp4,0.5,1,1,GTTTATGCCAGTTCATCACG,0,1932750
ihfAp4,0.5,1,1,GTTTATATCACGTATATTGG,0,1942920
ihfAp4,0.5,1,1,GTTTACGTCTAGATGGAGCG,0,1925731
ihfAp4,0.5,1,1,GTTTAAACTCCTCGAAAGGG,0,1942686
ihfAp4,0.5,1,1,GTTGTGGCGGTAAGCGTGAT,0,1949416
ihfAp4,0.5,1,1,GTTGTACGGACCGAAGCTTT,0,1955431
ihfAp4,0.5,1,1,GTTGTACAAGGACAGTCTTT,0,1954897
ihfAp4,0.5,1,1,GTTGGGTGAGGCCCCAGGCA,0,1909609
ihfAp4,0.5,1,1,GTTGGAGAAATCGCTTGTCA,0,1943876
ihfAp4,0.5,1,1,GTTGCACACTTAGGGCCATA,0,1947702
ihfAp4,0.5,1,1,GTTGCAACCCGGTCAGGGAA,0,1949115
ihfAp4,0.5,1,1,GTTGATGGGTTCTCTGAACC,0,1922192
ihfAp4,0.5,1,1,GTTGAGCCACACACCACCAT,0,1951234
ihfAp4,0.5,1,1,GTTGACCCACGTTAGATACA,0,1912328
ihfAp4,0.5,1,1,GTTCGTGGACATCTTAGCAA,0,1956083
ihfAp4,0.5,1,1,GTTCCTACGCCGCCCCGTGT,0,1917557
ihfAp4,0.5,1,1,GTTCCACAGTGAGCGGGTAG,0,1945162
ihfAp4,0.5,1,1,GTTCACTTCAAACAACCGAC,0,1926507
ihfAp4,0.5,1,1,GTTCACCTGCATACCGAAGA,0,1935364
ihfAp4,0.5,1,1,GTTCACCAATGCTAAACCGC,0,1923031
ihfAp4,0.5,1,1,GTTCACAGCTACAGTCCAGT,0,1937826
ihfAp4,0.5,1,1,GTTATTACTCGCGTAAAGTG,0,1926866
ihfAp4,0.5,1,1,GTTATCTGGCCTGGTATTGT,0,1949845
ihfAp4,0.5,1,1,GTTATCGCCTGTGTTCTAAC,0,1949450
ihfAp4,0.5,1,1,GTTATACGGAGAGACGTGAA,0,1922489
ihfAp4,0.5,1,1,GTTAGGAACCGGCTCACCGC,0,1952174
ihfAp4,0.5,1,1,GTTAGGAAACCGCGACACAT,0,1945907
ihfAp4,0.5,1,1,GTTACTGGTAAATCATTATA,0,1918291
ihfAp4,0.5,1,1,GTTACGTGGCACAGTAGCAA,0,1932793
ihfAp4,0.5,1,1,GTTACATTGGTTTTAGACCA,0,1917948
ihfAp4,0.5,1,1,GTTAATTTGACTTCTTATTA,0,1938116
ihfAp4,0.5,1,1,GTTAATTTCCCACAGTGTGA,0,1959372
ihfAp4,0.5,1,1,GTTAAGGACGAGACCCTGCT,0,1918825
ihfAp4,0.5,1,1,GTTAACGTTTTTCCTGCACG,0,1923825
ihfAp4,0.5,1,1,GTTAAACCGAAGGAAATTTC,0,1920550
ihfAp4,0.5,1,1,GTTAAACAGCATCAGATAGT,0,1918934
ihfAp4,0.5,1,1,GTGTTTAGAGACTCTACGAC,0,1914177
ihfAp4,0.5,1,1,GTGTTCTTACTGGTGTCGAT,0,1948542
ihfAp4,0.5,1,1,GTGTTCCCGGAGGTACCAAA,0,1929924
ihfAp4,0.5,1,1,GTGTTCATTTCACAGATCTT,0,1921076
ihfAp4,0.5,1,1,GTGTTAAGGAAGTCGCACAA,0,1923465
ihfAp4,0.5,1,1,GTGTGGTGGTCCTGCGCACC,0,1924851
ihfAp4,0.5,1,1,GTGTGATAGGTAGCTCGTCC,0,1917032
ihfAp4,0.5,1,1,GTGTGACTTTGTCTAATATA,0,1918063
ihfAp4,0.5,1,1,GTGTCGCCTCACCGATGGGG,0,1911887
ihfAp4,0.5,1,1,GTGTCCCTGTTAGGGACCTT,0,1919318
ihfAp4,0.5,1,1,GTGTCCCAACGAGCCAGTTC,0,1931942
ihfAp4,0.5,1,1,GTGTCCATGTGGGGGAATGT,0,1935280
ihfAp4,0.5,1,1,GTGTAAGTTCACTCGAAGGT,0,1913496
ihfAp4,0.5,1,1,GTGGTTTTTGACTTAGGTGG,0,1918000
ihfAp4,0.5,1,1,GTGGTCCGAGGAAAGAGAAT,0,1930226
ihfAp4,0.5,1,1,GTGGAACTACGACTCCATTA,0,1950912
ihfAp4,0.5,1,1,GTGCTGTATGTCCAGCGTAA,0,1914096
ihfAp4,0.5,1,1,GTGCGTAATGTGGTTCGAGA,0,1944783
ihfAp4,0.5,1,1,GTGCGACCTGGTGGTCACCA,0,1926422
ihfAp4,0.5,1,1,GTGCCTCGTTAAATAGGTTT,0,1950086
ihfAp4,0.5,1,1,GTGCATCCCGTTCGGGAGTT,0,1949676
ihfAp4,0.5,1,1,GTGCAGTGTGCAGCTGAGCC,0,1962212
ihfAp4,0.5,1,1,GTGATCGGCTCAGTGTGCCA,0,1946730
ihfAp4,0.5,1,1,GTGAGTGAAGACTAATGGGC,0,1920592
ihfAp4,0.5,1,1,GTGAGTAGTGAACCGAATGT,0,1924510
ihfAp4,0.5,1,1,GTGAGATGAGTTAGCACGTC,0,1909715
ihfAp4,0.5,1,1,GTGAGATATTTGAAATGTAA,0,1959760
ihfAp4,0.5,1,1,GTGACCAGGGCACGCCCCAT,0,1944110
ihfAp4,0.5,1,1,GTGACCAAGTAAGCGTTGAC,0,1957476
ihfAp4,0.5,1,1,GTGAAACCATGGATTCTTAT,0,1918460
ihfAp4,0.5,1,1,GTCTGGTGTTCCACAGAGAG,0,1959717
ihfAp4,0.5,1,1,GTCTGGAAGGGGCATCATGA,0,1932542
ihfAp4,0.5,1,1,GTCTGCCTAGGGTGCGGCGC,0,1939297
ihfAp4,0.5,1,1,GTCTCCTAAAACAATTTGTG,0,1951545
ihfAp4,0.5,1,1,GTCTCCCGAAGTCTTATCCC,0,1928903
ihfAp4,0.5,1,1,GTCTCACACTTCGAGCTGTA,0,1952371
ihfAp4,0.5,1,1,GTCTATCTAGACTATGCGCT,0,1927494
ihfAp4,0.5,1,1,GTCTATCGGAATACACCGTA,0,1928751
ihfAp4,0.5,1,1,GTCTACTGGAAAAGTTCGAA,0,1912640
ihfAp4,0.5,1,1,GTCTACCACTGCAGGCTAAC,0,1960197
ihfAp4,0.5,1,1,GTCGTATACCGAGGCGGAAT,0,1955053
ihfAp4,0.5,1,1,GTCGGCGCCGCACGAAAGGC,0,1910404
ihfAp4,0.5,1,1,GTCGGCATGCTGCCGCAGGC,0,1950915
ihfAp4,0.5,1,1,GTCGGATATGTGACGATTCG,0,1919914
ihfAp4,0.5,1,1,GTCGCTTACGTGTCCCAACT,0,1915519
ihfAp4,0.5,1,1,GTCGCTCTGCCGTAGTTAAA,0,1940725
ihfAp4,0.5,1,1,GTCGCTAGTGCCGGAGCCTT,0,1946455
ihfAp4,0.5,1,1,GTCGCTAACGGCTGGTTTTT,0,1937597
ihfAp4,0.5,1,1,GTCGCCGGGGTAAAACACTT,0,1932807
ihfAp4,0.5,1,1,GTCGCCCAACATAAAGCGAG,0,1943998
ihfAp4,0.5,1,1,GTCGACGGGTATCTATAGGG,0,1948928
ihfAp4,0.5,1,1,GTCGAAGGGCACTGACGCGG,0,1936357
ihfAp4,0.5,1,1,GTCCTTTTAGATCCACCACC,0,1958094
ihfAp4,0.5,1,1,GTCCTTGTTACGGTATGACA,0,1925394
ihfAp4,0.5,1,1,GTCCTACTGATCTATCTCTT,0,1955488
ihfAp4,0.5,1,1,GTCCGGGTATCTGAGTTTCA,0,1917548
ihfAp4,0.5,1,1,GTCCGGCGCGAGTTTAAGAG,0,1937759
ihfAp4,0.5,1,1,GTCCGACAAAGGATAGCGGC,0,1940942
ihfAp4,0.5,1,1,GTCCCTCTCGCCAGACGCCA,0,1930687
ihfAp4,0.5,1,1,GTCCCTCATAGGAAGTTCTC,0,1954779
ihfAp4,0.5,1,1,GTCCCGGTATCCCTCACGTG,0,1915865
ihfAp4,0.5,1,1,GTCCCAGGCCCTGACCCTTT,0,1945234
ihfAp4,0.5,1,1,GTCCCACACCCGCAAGTGCA,0,1962030
ihfAp4,0.5,1,1,GTCCATAGCCCTCTGTTCCG,0,1928247
ihfAp4,0.5,1,1,GTCCATAAATTATGCCCGAG,0,1934030
ihfAp4,0.5,1,1,GTCCAGCGTCCATTATCCTT,0,1935277
ihfAp4,0.5,1,1,GTCATTTAACGTGAGCGCCC,0,1956480
ihfAp4,0.5,1,1,GTCAGCTGAATTATCTCGCT,0,1917464
ihfAp4,0.5,1,1,GTCAGCTACGTAAAGTTGCC,0,1934147
ihfAp4,0.5,1,1,GTCAGAGACTACGAGAAGGG,0,1946990
ihfAp4,0.5,1,1,GTCACTAAAGGGCTTAACAT,0,1928200
ihfAp4,0.5,1,1,GTCACATTTGGCTGCTAGCC,0,1948097
ihfAp4,0.5,1,1,GTCACAATGGGGTCAACTTT,0,1934989
ihfAp4,0.5,1,1,GTCAATATATCAGCAATTTC,0,1910990
ihfAp4,0.5,1,1,GTCAAGACGAGGCCGTACGG,0,1941714
ihfAp4,0.5,1,1,GTATTCTAAGAATGGAATTG,0,1946705
ihfAp4,0.5,1,1,GTATGGGTCATGATAGTGCA,0,1941216
ihfAp4,0.5,1,1,GTATGGCGGTTGATCATTTT,0,1916215
ihfAp4,0.5,1,1,GTATGCCCTTTTCAGTGGAA,0,1938387
ihfAp4,0.5,1,1,GTATGAGTTTGTCGGGGACA,0,1916953
ihfAp4,0.5,1,1,GTATCGGATCTTAAGACGCC,0,1944009
ihfAp4,0.5,1,1,GTATCGGATAATTCGCCGGG,0,1914061
ihfAp4,0.5,1,1,GTATCACTGGTCCCGCGCTA,0,1947420
ihfAp4,0.5,1,1,GTATACCCCGCATTTTGGTT,0,1922292
ihfAp4,0.5,1,1,GTATACATGTTAGATTGCTT,0,1916539
ihfAp4,0.5,1,1,GTATAACACCAAATGAGACT,0,1957449
ihfAp4,0.5,1,1,GTAGTCCATGAATAGTGTCG,0,1957444
ihfAp4,0.5,1,1,GTAGGGCATGGAGACCTGTA,0,1961171
ihfAp4,0.5,1,1,GTAGGAGTGGCCTCGGCCCC,0,1947801
ihfAp4,0.5,1,1,GTAGGAGCGTGTTTAGTGGT,0,1926776
ihfAp4,0.5,1,1,GTAGCGCATACGCGGCGTAT,0,1932532
ihfAp4,0.5,1,1,GTAGCCTTGTCCTGGCATCC,0,1948405
ihfAp4,0.5,1,1,GTAGAATGCGGGTCGGACAG,0,1915945
ihfAp4,0.5,1,1,GTACTATCCTCTTCTTGGAG,0,1937766
ihfAp4,0.5,1,1,GTACCGTGGATCGAGAGTCT,0,1913832
ihfAp4,0.5,1,1,GTACCATGTTAAGATCACCG,0,1927178
ihfAp4,0.5,1,1,GTACCAACTGGCGATTTTAC,0,1953633
ihfAp4,0.5,1,1,GTACACATAAGATGTAGACC,0,1935561
ihfAp4,0.5,1,1,GTACAAGATCAGACGTGTCC,0,1954488
ihfAp4,0.5,1,1,GTAATTCTCGGTCCATTGGG,0,1931658
ihfAp4,0.5,1,1,GTAATGGACCCGACATCCGT,0,1929823
ihfAp4,0.5,1,1,GTAAGTTAGCGCGTATCCGA,0,1910756
ihfAp4,0.5,1,1,GTAAGGAACCGCCCCGTCCC,0,1961993
ihfAp4,0.5,1,1,GTAAGAGCTATGAGACAGTC,0,1957431
ihfAp4,0.5,1,1,GTAAACTGTGGCGCAGACTC,0,1952858
ihfAp4,0.5,1,1,GTAAAAGAATCGTACACGGC,0,1941584
ihfAp4,0.5,1,1,GGTTTGGAGAGAGGCCGGCT,0,1945218
ihfAp4,0.5,1,1,GGTTTGACTGTTGACATGTA,0,1958259
ihfAp4,0.5,1,1,GGTTGGTAGTCACATACCGA,0,1929911
ihfAp4,0.5,1,1,GGTTGCGTTACTGGTTTACA,0,1947158
ihfAp4,0.5,1,1,GGTTGAGAATAACATGCATT,0,1939950
ihfAp4,0.5,1,1,GGTTCGATTACAAGAGGTCT,0,1950185
ihfAp4,0.5,1,1,GGTTCATAGCTTAGATAGCT,0,1960771
ihfAp4,0.5,1,1,GGTTATTGGACACACCCGAG,0,1941716
ihfAp4,0.5,1,1,GGTTATCAACCGGATCAACA,0,1929607
ihfAp4,0.5,1,1,GGTTATAGTATATGAGGCAA,0,1911636
ihfAp4,0.5,1,1,GGTTATAGGTGCTGCGGGAT,0,1936947
ihfAp4,0.5,1,1,GGTTATAGCCGGATACTAGG,0,1915700
ihfAp4,0.5,1,1,GGTTAGTAGTGGTCCGGACA,0,1910171
ihfAp4,0.5,1,1,GGTTACATAGCGCCCATTGT,0,1958376
ihfAp4,0.5,1,1,GGTTACACGTACGCGGCGCA,0,1949483
ihfAp4,0.5,1,1,GGTGTTGAAAAAAATTTCTC,0,1958984
ihfAp4,0.5,1,1,GGTGTTAGTTTCCCGACGCC,0,1960248
ihfAp4,0.5,1,1,GGTGGGTATCACCTCAGGCT,0,1954172
ihfAp4,0.5,1,1,GGTGGCGAGTGATATTAGTC,0,1947434
ihfAp4,0.5,1,1,GGTGCCGTAATTTAAACCAC,0,1948636
ihfAp4,0.5,1,1,GGTGCCGACTACTATAATAC,0,1931973
ihfAp4,0.5,1,1,GGTGATTTTAATTTTTATTG,0,1914342
ihfAp4,0.5,1,1,GGTGACCCAGCGTGGATGCT,0,1948780
ihfAp4,0.5,1,1,GGTGAAGTCCCGAGAGCTGT,0,1914117
ihfAp4,0.5,1,1,GGTGAAGGACAAAATTGGAT,0,1924398
ihfAp4,0.5,1,1,GGTCTGACGATCATTGACGG,0,1927256
ihfAp4,0.5,1,1,GGTCGTTACCAACCGGCCGC,0,1938811
ihfAp4,0.5,1,1,GGTCGGTCTATTCCTTCTAT,0,1920270
ihfAp4,0.5,1,1,GGTCGGGTCGGCTCAGTAGA,0,1912900
ihfAp4,0.5,1,1,GGTCGCAACTATTGATTGGG,0,1926772
ihfAp4,0.5,1,1,GGTCCCTTTTCTGCTTTCCT,0,1948277
ihfAp4,0.5,1,1,GGTCCCATGGAGTCGATAGC,0,1949946
ihfAp4,0.5,1,1,GGTCATAATGGTAGTGGACG,0,1922628
ihfAp4,0.5,1,1,GGTCAGCGCCGTATGTCAAT,0,1914917
ihfAp4,0.5,1,1,GGTCAAGCAAGATCTATGAT,0,1958690
ihfAp4,0.5,1,1,GGTATCAATACATGTTCGGC,0,1955546
ihfAp4,0.5,1,1,GGTATATCGTATCGTAGCCT,0,1922700
ihfAp4,0.5,1,1,GGTAGAGGATCCATCGCGGA,0,1939960
ihfAp4,0.5,1,1,GGTACGGCAGAGTGGGGCTT,0,1922660
ihfAp4,0.5,1,1,GGTAAACATGCCCCCGGTGA,0,1928587
ihfAp4,0.5,1,1,GGGTTTGTCAATTCTCTGCG,0,1960330
ihfAp4,0.5,1,1,GGGTTTCTGAACATTACCTA,0,1944581
ihfAp4,0.5,1,1,GGGTTGCGACCCGGAGTTGT,0,1912460
ihfAp4,0.5,1,1,GGGTTACCCCGATACGAGGT,0,1939453
ihfAp4,0.5,1,1,GGGTTAATTCGTCTCTTTCC,0,1939501
ihfAp4,0.5,1,1,GGGTTAACGACAGATCAGAG,0,1931652
ihfAp4,0.5,1,1,GGGTGGCTCTTACGAGATCA,0,1909768
ihfAp4,0.5,1,1,GGGTGCACTTCGTAGCCGAT,0,1950987
ihfAp4,0.5,1,1,GGGTGAAGGTTAAAAGTGTA,0,1934367
ihfAp4,0.5,1,1,GGGTCGCTGTCGGTTGTTTT,0,1931261
ihfAp4,0.5,1,1,GGGTCAAAAGCGTGTACCGG,0,1962304
ihfAp4,0.5,1,1,GGGTATTATTAGCATTAATT,0,1930491
ihfAp4,0.5,1,1,GGGTATGTCCTTCGGCAGAT,0,1941903
ihfAp4,0.5,1,1,GGGTATCGTGGGGTCGCTAT,0,1938159
ihfAp4,0.5,1,1,GGGTATCAGATCGTACCACT,0,1922193
ihfAp4,0.5,1,1,GGGTACTTATTCCGACGTCT,0,1947600
ihfAp4,0.5,1,1,GGGGTGAAGGCTATTTGACC,0,1938167
ihfAp4,0.5,1,1,GGGGTCTCGTGAGTCTGTGG,0,1953010
ihfAp4,0.5,1,1,GGGGTAATCCACGTTTTAGT,0,1917175
ihfAp4,0.5,1,1,GGGGGGGACGCATGGAGGGG,0,1941080
ihfAp4,0.5,1,1,GGGGGGCCCAGACTACTCTT,0,1929974
ihfAp4,0.5,1,1,GGGGCTGGATTATATCTGGT,0,1943333
ihfAp4,0.5,1,1,GGGGCTCAATGCGGTCGGAG,0,1919754
ihfAp4,0.5,1,1,GGGGCTAGAGGGTGTAGTTT,0,1952077
ihfAp4,0.5,1,1,GGGGCGAGTGTACGCCCGGA,0,1940782
ihfAp4,0.5,1,1,GGGGCACCACCGAAGAAATA,0,1911864
ihfAp4,0.5,1,1,GGGGAGGCCCACCTTAGTCA,0,1945477
ihfAp4,0.5,1,1,GGGGACGGCTGTGCAAGTTA,0,1925733
ihfAp4,0.5,1,1,GGGCTTAGACCAATTCGTTA,0,1958685
ihfAp4,0.5,1,1,GGGCTAGCAGTCGCGTGTCA,0,1956374
ihfAp4,0.5,1,1,GGGCGGTTACGTGTAGTATC,0,1940844
ihfAp4,0.5,1,1,GGGCGGTACAGCGTTACGAT,0,1947367
ihfAp4,0.5,1,1,GGGCGAGTGTGTAAATAGCG,0,1939706
ihfAp4,0.5,1,1,GGGCAAGCCGGTGGGCTTAA,0,1912707
ihfAp4,0.5,1,1,GGGATTCAGGACATGTCCGC,0,1929037
ihfAp4,0.5,1,1,GGGATGGTCCTTCAAGGAAG,0,1948137
ihfAp4,0.5,1,1,GGGAGGTCAATCAAGCTGTG,0,1942642
ihfAp4,0.5,1,1,GGGAGGATAGCTAATCACGA,0,1922657
ihfAp4,0.5,1,1,GGGAGCACTCCCTAGCAGAA,0,1917044
ihfAp4,0.5,1,1,GGGAGACCGGTTCTTTGTTT,0,1915618
ihfAp4,0.5,1,1,GGGACATGTATAGTGAGGCC,0,1941647
ihfAp4,0.5,1,1,GGGAATGGTAGAAGTCTTCA,0,1954783
ihfAp4,0.5,1,1,GGCTTGTCTAATACATATCC,0,1920474
ihfAp4,0.5,1,1,GGCTTCAGTGGCCGCGGAAA,0,1945356
ihfAp4,0.5,1,1,GGCTCTCGCGACGCGGTGGT,0,1927609
ihfAp4,0.5,1,1,GGCTCGGTAAGTATTTATCG,0,1941336
ihfAp4,0.5,1,1,GGCTCGATTGTTAACCGCGG,0,1931037
ihfAp4,0.5,1,1,GGCTAGTCTTTTTTACCTTA,0,1930593
ihfAp4,0.5,1,1,GGCTAGCGACGTTAAACCGG,0,1951565
ihfAp4,0.5,1,1,GGCTACCGTCCTACAGAGGT,0,1954614
ihfAp4,0.5,1,1,GGCGTTAGATCAATGGCATT,0,1956099
ihfAp4,0.5,1,1,GGCGGGTACCCCCCTGTGAG,0,1939150
ihfAp4,0.5,1,1,GGCGGGAAAGTGCAGCCCTC,0,1915612
ihfAp4,0.5,1,1,GGCGCCGATCGGGCACGAAC,0,1925742
ihfAp4,0.5,1,1,GGCGCATTCCACATTAACGG,0,1947210
ihfAp4,0.5,1,1,GGCGACCGTTACCACGAACT,0,1911962
ihfAp4,0.5,1,1,GGCGACCCTGACCAGTTCTT,0,1918159
ihfAp4,0.5,1,1,GGCCTTTGATGCGGCTATGG,0,1928145
ihfAp4,0.5,1,1,GGCCTTTGAGCAGCAAGTAC,0,1934070
ihfAp4,0.5,1,1,GGCCTTGGCCTGTATTCTTG,0,1939334
ihfAp4,0.5,1,1,GGCCGTATTGCTTAGTGTTG,0,1934276
ihfAp4,0.5,1,1,GGCCGAAATTACCAGATGTA,0,1950752
ihfAp4,0.5,1,1,GGCCCGGTGTTTACTACTCC,0,1945794
ihfAp4,0.5,1,1,GGCCCACAGGTTGCATCGTG,0,1937626
ihfAp4,0.5,1,1,GGCCCACACTTGGGACCTTC,0,1932348
ihfAp4,0.5,1,1,GGCCAGGTGCACTTAAGCCC,0,1925154
ihfAp4,0.5,1,1,GGCCAGAGCAGCTACTGTAG,0,1951605
ihfAp4,0.5,1,1,GGCCACAGGTACGCGGCTGT,0,1914093
ihfAp4,0.5,1,1,GGCCAATCCGTGGCGGGCGA,0,1916764
ihfAp4,0.5,1,1,GGCATGACCTGCGACCAAGG,0,1940526
ihfAp4,0.5,1,1,GGCATACTGCTGACCTAGTA,0,1920364
ihfAp4,0.5,1,1,GGCAGTATGGATATAGTGGG,0,1951665
ihfAp4,0.5,1,1,GGCACTACGGGAATGCTTCG,0,1928849
ihfAp4,0.5,1,1,GGCACGCGTCGTCGGGGTCG,0,1913301
ihfAp4,0.5,1,1,GGCACATCTTTTAGACCAAA,0,1955039
ihfAp4,0.5,1,1,GGCAAGATTCGTAAACGACT,0,1928569
ihfAp4,0.5,1,1,GGCAAAATGATCATTTAACC,0,1957900
ihfAp4,0.5,1,1,GGATTTTCATACAGGGAAGA,0,1947680
ihfAp4,0.5,1,1,GGATTTCATGTGACTTATGA,0,1945545
ihfAp4,0.5,1,1,GGATTCCTGCCGTTTAGCAG,0,1912164
ihfAp4,0.5,1,1,GGATTCATTTCTCGACAGGT,0,1949193
ihfAp4,0.5,1,1,GGATTATCCCCCCGCATTCC,0,1947250
ihfAp4,0.5,1,1,GGATGTGTCTATTGCTTATG,0,1942020
ihfAp4,0.5,1,1,GGATGGCTAGGAAATAGTTT,0,1952447
ihfAp4,0.5,1,1,GGATGCTGGTCGGTCACAAG,0,1918808
ihfAp4,0.5,1,1,GGATGCGCAGATGGTATGAA,0,1961849
ihfAp4,0.5,1,1,GGATGCACCATGGTGCGAAA,0,1940870
ihfAp4,0.5,1,1,GGATGATTCTCAGCACGTGT,0,1954756
ihfAp4,0.5,1,1,GGATCTAAAGATTACCTTGC,0,1927282
ihfAp4,0.5,1,1,GGATCCTCAGGTGAAGCGTA,0,1952700
ihfAp4,0.5,1,1,GGATAGCTGGCAAATGTCCG,0,1925409
ihfAp4,0.5,1,1,GGATAAGACGGGCTAGTAAG,0,1910597
ihfAp4,0.5,1,1,GGAGTTTTCGCATCAGTAGT,0,1942037
ihfAp4,0.5,1,1,GGAGTTTTAACCCTGATCTC,0,1926180
ihfAp4,0.5,1,1,GGAGGGGTGCGCTGTTGGCA,0,1938687
ihfAp4,0.5,1,1,GGAGGGACGACAGTGCTATA,0,1958380
ihfAp4,0.5,1,1,GGAGGCGTTACGAGAGTCGC,0,1955601
ihfAp4,0.5,1,1,GGAGGATTGGAGTGGTCATT,0,1937230
ihfAp4,0.5,1,1,GGAGGATAAAATACTTGCAT,0,1924230
ihfAp4,0.5,1,1,GGAGCTTTTAGATCGTGCCC,0,1932500
ihfAp4,0.5,1,1,GGACTGCTCAGCGTCAGAGC,0,1919297
ihfAp4,0.5,1,1,GGACTGAATTGCGTAGCCTC,0,1928714
ihfAp4,0.5,1,1,GGACTCAGCATCCGCTTTTT,0,1934650
ihfAp4,0.5,1,1,GGACGGCAGGAGGTAGATGC,0,1940185
ihfAp4,0.5,1,1,GGACGACTGGGCATGCGCCC,0,1933368
ihfAp4,0.5,1,1,GGACCGAACCTAGGCCTAGC,0,1943260
ihfAp4,0.5,1,1,GGACCCACAGCTCCTTTCTA,0,1915568
ihfAp4,0.5,1,1,GGACATGTCCACGCTCGTGG,0,1948684
ihfAp4,0.5,1,1,GGACATCTAAGGAAGGGTCA,0,1915371
ihfAp4,0.5,1,1,GGACATAACTCTGGCTGCGT,0,1912211
ihfAp4,0.5,1,1,GGACACGTGCACTGGCACGA,0,1914079
ihfAp4,0.5,1,1,GGACAAGTGCCAGTATCGGG,0,1951253
ihfAp4,0.5,1,1,GGACAAACTCATTGTTTGAA,0,1927229
ihfAp4,0.5,1,1,GGAATTGGCGATGGAGGGGT,0,1935263
ihfAp4,0.5,1,1,GGAATTATCCATGGTGTGGG,0,1919847
ihfAp4,0.5,1,1,GGAATAATGTCAATGGTGGG,0,1949846
ihfAp4,0.5,1,1,GGAAGTACTGTTATTTTTCT,0,1952391
ihfAp4,0.5,1,1,GGAAGGTTGCTTCAGAATTC,0,1915845
ihfAp4,0.5,1,1,GGAACCCCAGAGTTAACGGA,0,1955157
ihfAp4,0.5,1,1,GGAAAATCGCGCTTTTGTGT,0,1916839
ihfAp4,0.5,1,1,GCTTTGTTGCCGTTACCGCT,0,1943866
ihfAp4,0.5,1,1,GCTTTGTTAGAGGCGATGTT,0,1953021
ihfAp4,0.5,1,1,GCTTTATTCGGCAAATTGGA,0,1943211
ihfAp4,0.5,1,1,GCTTTATAGGCGTATTTTGG,0,1926984
ihfAp4,0.5,1,1,GCTTGTTGCATGGGCTGGCC,0,1952408
ihfAp4,0.5,1,1,GCTTGATCTACTCGTTGAGA,0,1956254
ihfAp4,0.5,1,1,GCTTAGTCGAGCACACGTGA,0,1929948
ihfAp4,0.5,1,1,GCTTACCTCTTAGGATTAGA,0,1956612
ihfAp4,0.5,1,1,GCTGTCTATATTGGGGTAAC,0,1948960
ihfAp4,0.5,1,1,GCTGGTCATTCAGAAGGTAG,0,1949194
ihfAp4,0.5,1,1,GCTGGGTCACGGGATGCTAG,0,1949421
ihfAp4,0.5,1,1,GCTGGACGAGCAAAACCCTT,0,1928947
ihfAp4,0.5,1,1,GCTGCGCACTAAACCAATAG,0,1949035
ihfAp4,0.5,1,1,GCTGCCCAGACTGCCATGCC,0,1915385
ihfAp4,0.5,1,1,GCTGAAGCCTGCAATTATTC,0,1915470
ihfAp4,0.5,1,1,GCTCTTCATTCGGTTCCTAG,0,1954562
ihfAp4,0.5,1,1,GCTCTACTACGGTTGTGAGT,0,1932968
ihfAp4,0.5,1,1,GCTCGAGAGGTTATCGGCTA,0,1910729
ihfAp4,0.5,1,1,GCTCCTTTAGACATAGCATC,0,1923111
ihfAp4,0.5,1,1,GCTCCTGAAAACCACTCCTT,0,1951030
ihfAp4,0.5,1,1,GCTCCGTTTATCCAGACATC,0,1951950
ihfAp4,0.5,1,1,GCTCCACCCCGGGTGATGCT,0,1952492
ihfAp4,0.5,1,1,GCTCATGTGTGCCAATGCAG,0,1949462
ihfAp4,0.5,1,1,GCTCATCTTGGCTCAAGTGC,0,1911699
ihfAp4,0.5,1,1,GCTCAAAGTAGGTAAAAGTT,0,1960369
ihfAp4,0.5,1,1,GCTCAAACTGTGGATCTAGA,0,1936011
ihfAp4,0.5,1,1,GCTAGCCCACAATGAGTAGA,0,1935577
ihfAp4,0.5,1,1,GCTAGAGTCAGCGGTTACGA,0,1916735
ihfAp4,0.5,1,1,GCTACGAGGGGATTCGGCCC,0,1947876
ihfAp4,0.5,1,1,GCTACCTAGCAATGAACGAA,0,1914481
ihfAp4,0.5,1,1,GCTAAGAAATTCCCACAAAT,0,1927116
ihfAp4,0.5,1,1,GCTAAAGATTAAGTTAACTA,0,1961258
ihfAp4,0.5,1,1,GCGTTGACTTTGAGTATTCC,0,1937708
ihfAp4,0.5,1,1,GCGTTGAATAAGAGGGATAC,0,1961708
ihfAp4,0.5,1,1,GCGTTATCCTGTACAGGATG,0,1949884
ihfAp4,0.5,1,1,GCGTGCTCTGGGTAGCCAGC,0,1910898
ihfAp4,0.5,1,1,GCGTCTTAAGACATGTGGAA,0,1920246
ihfAp4,0.5,1,1,GCGTCCGTTGGAATGGTCTT,0,1955272
ihfAp4,0.5,1,1,GCGTCCAAAAGTTAAGTGCA,0,1943490
ihfAp4,0.5,1,1,GCGTACTTGGGCCAGCGGCC,0,1926401
ihfAp4,0.5,1,1,GCGTAATCGGAACCGGGCAT,0,1931153
ihfAp4,0.5,1,1,GCGGTGGTTTCCGGGAGAGC,0,1929619
ihfAp4,0.5,1,1,GCGGTGAGTGGGGTTATCGT,0,1941507
ihfAp4,0.5,1,1,GCGGGGTAACCGGAAGCGAG,0,1941187
ihfAp4,0.5,1,1,GCGGGCACTATGCTCTGTAG,0,1932406
ihfAp4,0.5,1,1,GCGGCGGGATGGCTAATAAC,0,1939604
ihfAp4,0.5,1,1,GCGGCATCCGGAGATTACCT,0,1911427
ihfAp4,0.5,1,1,GCGGACTACGTAAGAGCTCA,0,1930965
ihfAp4,0.5,1,1,GCGCTCATTTATGTGATATT,0,1937115
ihfAp4,0.5,1,1,GCGCTATCCCATCCGTTATG,0,1947696
ihfAp4,0.5,1,1,GCGCGGATGGTAGAAGTCCC,0,1932413
ihfAp4,0.5,1,1,GCGCGCATCAATCTAGTAAT,0,1942617
ihfAp4,0.5,1,1,GCGCCTATTTGAGATAGCCT,0,1924026
ihfAp4,0.5,1,1,GCGCCGGACGGAATGTAGGG,0,1917769
ihfAp4,0.5,1,1,GCGCCCTCCTGGGCAGGCTT,0,1930158
ihfAp4,0.5,1,1,GCGCCATCGACGCACAACAT,0,1944341
ihfAp4,0.5,1,1,GCGCCAACGATTATGGACTC,0,1952703
ihfAp4,0.5,1,1,GCGCATTTCGAGCGAAAGCG,0,1953065
ihfAp4,0.5,1,1,GCGCATTGGCGCTTGACGCT,0,1951487
ihfAp4,0.5,1,1,GCGCATAGGTCGCACGTCAC,0,1920387
ihfAp4,0.5,1,1,GCGATGCCCGTGTTCTGATC,0,1953707
ihfAp4,0.5,1,1,GCGATAGCAGGCGCATAGTA,0,1916511
ihfAp4,0.5,1,1,GCGACTGATGGGGAATGCCT,0,1958737
ihfAp4,0.5,1,1,GCGACTCCCAAGCAAAACGT,0,1929813
ihfAp4,0.5,1,1,GCGACATTTGATTCATACAG,0,1945486
ihfAp4,0.5,1,1,GCGAACCGATTGAAGACGGT,0,1935711
ihfAp4,0.5,1,1,GCGAAAAAAGCTAGAACGAT,0,1943514
ihfAp4,0.5,1,1,GCCTTGAGAGATGGTCGTGT,0,1941002
ihfAp4,0.5,1,1,GCCTGGTTACCCCGAACGAG,0,1944621
ihfAp4,0.5,1,1,GCCTGGTCGTAGAGTTACGT,0,1915636
ihfAp4,0.5,1,1,GCCTGGGATCTGTGACTAAC,0,1955050
ihfAp4,0.5,1,1,GCCTATGCATGGAGTCCAGC,0,1934033
ihfAp4,0.5,1,1,GCCTAATTAACATTACTTGC,0,1953759
ihfAp4,0.5,1,1,GCCGTGGTACAATTACATGT,0,1952096
ihfAp4,0.5,1,1,GCCGTGGGTCGGGCAAAGAG,0,1961962
ihfAp4,0.5,1,1,GCCGTAATTTTCGATTTTTG,0,1943247
ihfAp4,0.5,1,1,GCCGCTTGAATCTATACGGG,0,1943020
ihfAp4,0.5,1,1,GCCGCGATAAACAAATTGGC,0,1921047
ihfAp4,0.5,1,1,GCCGAAGGGCCAGTACAGCC,0,1913705
ihfAp4,0.5,1,1,GCCGAAAAAAGATCACGCGT,0,1941198
ihfAp4,0.5,1,1,GCCCTCGTATGGCCCAATTA,0,1958294
ihfAp4,0.5,1,1,GCCAGAGGGTTCAGACCACG,0,1925457
ihfAp4,0.5,1,1,GCCAGAAGTATATCTAAGAT,0,1955309
ihfAp4,0.5,1,1,GCCACTTGGGGCATTAGCGT,0,1932792
ihfAp4,0.5,1,1,GCCACCCTGACATCTGAGAC,0,1958486
ihfAp4,0.5,1,1,GCCACACCCCCCTGGAGAGA,0,1943800
ihfAp4,0.5,1,1,GCCAACCGCACGTTCCCGTC,0,1939129
ihfAp4,0.5,1,1,GCCAACATCGGTATCCCGAC,0,1953259
ihfAp4,0.5,1,1,GCCAAAGCCTGGTGCCGAGC,0,1919148
ihfAp4,0.5,1,1,GCATTTTATGCATGTTAGGT,0,1910368
ihfAp4,0.5,1,1,GCATTTAAATGGGATCCATT,0,1925410
ihfAp4,0.5,1,1,GCATTGTCGAGATGGGTCTT,0,1930373
ihfAp4,0.5,1,1,GCATTGGCGACCCCCTTGAC,0,1920895
ihfAp4,0.5,1,1,GCATTGGCCAGGGATAATGC,0,1950414
ihfAp4,0.5,1,1,GCATTGGACGTAACGAATTG,0,1918747
ihfAp4,0.5,1,1,GCATGTCGCGTCACGCTAAT,0,1948898
ihfAp4,0.5,1,1,GCATGGAGCTCGTAGAGGTG,0,1960816
ihfAp4,0.5,1,1,GCATCGTTCGGGTTCAAAAC,0,1925532
ihfAp4,0.5,1,1,GCATCATGCAGAGTACTCTG,0,1914337
ihfAp4,0.5,1,1,GCATATGTTACGTGTGATGC,0,1942734
ihfAp4,0.5,1,1,GCATAGATCGTTGCGGCGTG,0,1937899
ihfAp4,0.5,1,1,GCAGGGCGGTCGCACGAGGT,0,1923429
ihfAp4,0.5,1,1,GCAGGCGTCGATTACTCGAT,0,1957568
ihfAp4,0.5,1,1,GCAGCGACCGGTCGCCCAGG,0,1928085
ihfAp4,0.5,1,1,GCAGACGCAGAGAATCGTAT,0,1950454
ihfAp4,0.5,1,1,GCAGACCCCGTCTCTTTTTC,0,1953220
ihfAp4,0.5,1,1,GCAGACACCGTGGAGCCAGT,0,1955085
ihfAp4,0.5,1,1,GCACGTGTAAGCCACCAAAC,0,1915096
ihfAp4,0.5,1,1,GCACGGTAGTAACTGCTAGA,0,1924993
ihfAp4,0.5,1,1,GCACGCTGTGTATACAGGCA,0,1959531
ihfAp4,0.5,1,1,GCACGCGGACTGACATCCTG,0,1929939
ihfAp4,0.5,1,1,GCACCTCCCGCCCGTCTGCT,0,1960733
ihfAp4,0.5,1,1,GCACCCCTATTGAACAGTGC,0,1950710
ihfAp4,0.5,1,1,GCACAGAGAAAGGAGGGTAG,0,1925572
ihfAp4,0.5,1,1,GCACAATCCATAAATGACAT,0,1920409
ihfAp4,0.5,1,1,GCAATACGTATCGTTCATAC,0,1947643
ihfAp4,0.5,1,1,GCAAGGTGATGAGCCCGCTC,0,1952328
ihfAp4,0.5,1,1,GCAAGCATTTAGCAGTCGAA,0,1934072
ihfAp4,0.5,1,1,GCAACCGTGGAGGGTGCTTG,0,1944068
ihfAp4,0.5,1,1,GCAAAGACTTGGTGTCTTTT,0,1936586
ihfAp4,0.5,1,1,GCAAAAACGGGCTAGCCAGG,0,1931894
ihfAp4,0.5,1,1,GATTTCGTCGATCGGGGGAG,0,1950627
ihfAp4,0.5,1,1,GATTTCCCTGTATCGTTGTA,0,1938225
ihfAp4,0.5,1,1,GATTCGAGTACTCTACGTAG,0,1931660
ihfAp4,0.5,1,1,GATTCCCGATCTGTAAATTG,0,1915077
ihfAp4,0.5,1,1,GATTATCAAAGCGATGGGGG,0,1950150
ihfAp4,0.5,1,1,GATTATAACCTGGGTAAGCA,0,1918157
ihfAp4,0.5,1,1,GATGCGACGGGGCTGTCCCT,0,1913813
ihfAp4,0.5,1,1,GATGCACAGCATGGACACAC,0,1927405
ihfAp4,0.5,1,1,GATCTTATATATCGTGAGTC,0,1961483
ihfAp4,0.5,1,1,GATCGAAGATAGCCTGGAAC,0,1949200
ihfAp4,0.5,1,1,GATCCTGGCGTTTGCTCTAG,0,1944610
ihfAp4,0.5,1,1,GATCCTATACGGACAGTGAT,0,1940279
ihfAp4,0.5,1,1,GATCCAACCTGAGACGCATC,0,1934927
ihfAp4,0.5,1,1,GATCATCTTTCATATTCGTC,0,1938577
ihfAp4,0.5,1,1,GATCAGTCAAGCACATAAGG,0,1954106
ihfAp4,0.5,1,1,GATCACGGGCGGCACATTTC,0,1910113
ihfAp4,0.5,1,1,GATATCTCCGGTCATCATGA,0,1956279
ihfAp4,0.5,1,1,GATATCTCATCCACTGCGGG,0,1920498
ihfAp4,0.5,1,1,GATAGGCGATTTCTGCTAGA,0,1936828
ihfAp4,0.5,1,1,GATACTACGTTGCAACCTTG,0,1936038
ihfAp4,0.5,1,1,GATACAAGTAACCTTCGATA,0,1942481
ihfAp4,0.5,1,1,GATAACGTTCGTGAGACCCT,0,1956002
ihfAp4,0.5,1,1,GATAAAACATGTGCGAATAT,0,1946865
ihfAp4,0.5,1,1,GAGTTGAAAGTTGATGGAAA,0,1914680
ihfAp4,0.5,1,1,GAGTTCGATGCTGTAGAGCA,0,1952219
ihfAp4,0.5,1,1,GAGTTAACATTTTCATCGGT,0,1960905
ihfAp4,0.5,1,1,GAGTGATTACAGTTCTCCTA,0,1935894
ihfAp4,0.5,1,1,GAGTGACGCAAATTGGAAGT,0,1928473
ihfAp4,0.5,1,1,GAGTCTTTAGAGGTTTCCAC,0,1953795
ihfAp4,0.5,1,1,GAGTCTCAGCAACCCACCTT,0,1944180
ihfAp4,0.5,1,1,GAGTCAACCCTGATATTTAG,0,1928607
ihfAp4,0.5,1,1,GAGTATCTCGGCACATGCCA,0,1958500
ihfAp4,0.5,1,1,GAGTAGGTCACGCTAGCCGT,0,1951880
ihfAp4,0.5,1,1,GAGTACCGTTGTCGTTTGTG,0,1941220
ihfAp4,0.5,1,1,GAGTAATGGAAATGCACAAG,0,1949801
ihfAp4,0.5,1,1,GAGGTGCTTCTGGTGATCGC,0,1952483
ihfAp4,0.5,1,1,GAGGTCATCATTTCGAAGAG,0,1951360
ihfAp4,0.5,1,1,GAGGTATATATCCGGTCCAA,0,1934282
ihfAp4,0.5,1,1,GAGGGTGTTTTTTGGAGGTA,0,1938650
ihfAp4,0.5,1,1,GAGGGCACTGGGCGAAGGGT,0,1943603
ihfAp4,0.5,1,1,GAGGGACGCATTGAATGGGA,0,1918016
ihfAp4,0.5,1,1,GAGGATTCTCAATGGGAACC,0,1947281
ihfAp4,0.5,1,1,GAGGACGAACCGGTCGCAAC,0,1955247
ihfAp4,0.5,1,1,GAGCTGGTACGAAATTGACT,0,1955300
ihfAp4,0.5,1,1,GAGCGGAACGTTTGCCGTAT,0,1936970
ihfAp4,0.5,1,1,GAGCCTTTAATGGGGGTCCT,0,1946391
ihfAp4,0.5,1,1,GAGCCTCATGCCGAGTACTT,0,1960331
ihfAp4,0.5,1,1,GAGCCCTGCACCAGCCCCCC,0,1933124
ihfAp4,0.5,1,1,GAGCATATCACGATAAACAG,0,1941718
ihfAp4,0.5,1,1,GAGATCCTAAGATTGCAGCT,0,1942185
ihfAp4,0.5,1,1,GAGAGCCGTACCACAACGTA,0,1938670
ihfAp4,0.5,1,1,GAGAGACGAAGGGGTCAGGT,0,1939493
ihfAp4,0.5,1,1,GAGAACCGACGACACATCCT,0,1926802
ihfAp4,0.5,1,1,GACTCGGAGCTTTGGTGCCG,0,1925298
ihfAp4,0.5,1,1,GACTAGGGACCAGACTTGGT,0,1950015
ihfAp4,0.5,1,1,GACTAGCTTTCCCATCTGCT,0,1952872
ihfAp4,0.5,1,1,GACTACAAAGGTTTCCTGTA,0,1919390
ihfAp4,0.5,1,1,GACGTTACTTCCTGTTAACA,0,1954923
ihfAp4,0.5,1,1,GACGTTACTCTACCAGTACT,0,1922697
ihfAp4,0.5,1,1,GACGTGTGTACCCCACAAAC,0,1952453
ihfAp4,0.5,1,1,GACGTGGCTAAAACTATCTT,0,1944690
ihfAp4,0.5,1,1,GACGTAGGCATGCGATCCTG,0,1915875
ihfAp4,0.5,1,1,GACGGGATGAGGTCGTGGTT,0,1952667
ihfAp4,0.5,1,1,GACGGGAGATTCAGTGTCAA,0,1916020
ihfAp4,0.5,1,1,GACGCAGGGTTTTGTGTGAA,0,1911140
ihfAp4,0.5,1,1,GACGACATCATCGACTTACG,0,1915615
ihfAp4,0.5,1,1,GACCTTATAAGTCTTGCATA,0,1912146
ihfAp4,0.5,1,1,GACCTTAGTGGCGACTCCTC,0,1938565
ihfAp4,0.5,1,1,GACCTGTTTCTACATGCCCC,0,1946342
ihfAp4,0.5,1,1,GACCTGTGATTCACAGATCA,0,1939396
ihfAp4,0.5,1,1,GACCTCTCGTTAATGCGCAG,0,1959872
ihfAp4,0.5,1,1,GACCTCAGGAGATCGTTCAT,0,1961875
ihfAp4,0.5,1,1,GACCATCAGGAAAGTTGAAC,0,1948562
ihfAp4,0.5,1,1,GACATTGCTGTGAAACTACA,0,1912491
ihfAp4,0.5,1,1,GACATGGATGCGATCACGGA,0,1954537
ihfAp4,0.5,1,1,GACATCACGTTCAACAAATA,0,1943536
ihfAp4,0.5,1,1,GACATACGCCGGAAACGGTC,0,1936515
ihfAp4,0.5,1,1,GACAGTTTCCCGTGACCAAG,0,1952191
ihfAp4,0.5,1,1,GACAGGGGATTCACGCCCAA,0,1950834
ihfAp4,0.5,1,1,GACAGGCGGTCTACAAGAAG,0,1954189
ihfAp4,0.5,1,1,GACAGGCGGAGTCGTTGAGA,0,1909962
ihfAp4,0.5,1,1,GACAGCACGGGTCTCCTAAG,0,1944221
ihfAp4,0.5,1,1,GACAGAAGACGAGGTTATTC,0,1930431
ihfAp4,0.5,1,1,GACACTTACAGGCAAGCGCA,0,1929244
ihfAp4,0.5,1,1,GACACTCATACGCTCATTGA,0,1913924
ihfAp4,0.5,1,1,GACACGTTGGAAGAATTTAA,0,1957314
ihfAp4,0.5,1,1,GACAAGCGAAATTCTCTCGC,0,1942854
ihfAp4,0.5,1,1,GACAACTTGGCCTCGTTGAA,0,1923160
ihfAp4,0.5,1,1,GACAACCTGAAGCAGGATGA,0,1911857
ihfAp4,0.5,1,1,GAATGTCGCTTTGTGTTAAG,0,1932676
ihfAp4,0.5,1,1,GAATATTCTCACTAACCCGA,0,1918514
ihfAp4,0.5,1,1,GAATACGTGTTATCTGCGCT,0,1922899
ihfAp4,0.5,1,1,GAATAATCCAAAATAAGTGT,0,1951046
ihfAp4,0.5,1,1,GAATAATATTGCTCAGGCGT,0,1934077
ihfAp4,0.5,1,1,GAATAAGGGTTATCTTGTAC,0,1928432
ihfAp4,0.5,1,1,GAAGTTGAAAGAACTCTATG,0,1950007
ihfAp4,0.5,1,1,GAAGTGGGCACGCTCGACCT,0,1931155
ihfAp4,0.5,1,1,GAAGTGAGGGCTGTAATCGC,0,1940428
ihfAp4,0.5,1,1,GAAGTAATGATTCACTGTCG,0,1928248
ihfAp4,0.5,1,1,GAAGCTCCCGCATTTTCGTG,0,1936904
ihfAp4,0.5,1,1,GAAGCGATGGTGCGTCTGAG,0,1946205
ihfAp4,0.5,1,1,GAAGCACGCTAAGACCGGTA,0,1959641
ihfAp4,0.5,1,1,GAAGAGTCAGGCTCCGCGGA,0,1952796
ihfAp4,0.5,1,1,GAAGACGTGATACGGAATGG,0,1923474
ihfAp4,0.5,1,1,GAACGGATCAGCGCCGTACA,0,1938812
ihfAp4,0.5,1,1,GAACAGTGCAACTGTGACGA,0,1938911
ihfAp4,0.5,1,1,GAACAGGTGGTGACTAGAGT,0,1919771
ihfAp4,0.5,1,1,GAACACAAGGTACTACACAC,0,1954687
ihfAp4,0.5,1,1,GAACAACGTCAAAGATCCGA,0,1919393
ihfAp4,0.5,1,1,GAAATGGCTAAGACTGTTAA,0,1954665
ihfAp4,0.5,1,1,GAAAGAAGGCTCACGTATAC,0,1949036
ihfAp4,0.5,1,1,GAAAGAAGCCCGTGGGGTTC,0,1932885
ihfAp4,0.5,1,1,GAAAAGCCTATATCGATCAG,0,1950140
ihfAp4,0.5,1,1,GAAAACTGGCAGCCCTCTCA,0,1937394
ihfAp4,0.5,1,1,GAAAACGCCTATGCTAAATT,0,1960143
ihfAp4,0.5,1,1,GAAAACCAACAACCGTTCTC,0,1921365
ihfAp4,0.5,1,1,GAAAAATATAACATGCTGGA,0,1934857
ihfAp4,0.5,1,1,CTTTTTAAGCGGCGGGAGCT,0,1918386
ihfAp4,0.5,1,1,CTTTTCGCGGGTAACGGAAG,0,1941437
ihfAp4,0.5,1,1,CTTTGTGATCGAGTCACGTT,0,1919114
ihfAp4,0.5,1,1,CTTTGCGTATGCAGTGAGTC,0,1952027
ihfAp4,0.5,1,1,CTTTCTTAGCTCCTACACTC,0,1952692
ihfAp4,0.5,1,1,CTTTCGCACGCGCTCTAAAA,0,1954630
ihfAp4,0.5,1,1,CTTTCCCCGAGTGACACCAC,0,1925612
ihfAp4,0.5,1,1,CTTTATGAAATGAAGGGTCC,0,1923765
ihfAp4,0.5,1,1,CTTTATCACAGATCGAACGA,0,1930964
ihfAp4,0.5,1,1,CTTTATAATAGGAGAACCAA,0,1917515
ihfAp4,0.5,1,1,CTTGTTTCAGCGTAACGAGA,0,1915550
ihfAp4,0.5,1,1,CTTGTGGCTTGTGTTGATAG,0,1916202
ihfAp4,0.5,1,1,CTTGTGGACATTCTCATACA,0,1949585
ihfAp4,0.5,1,1,CTTGTCTCTCAAACGTTATT,0,1959352
ihfAp4,0.5,1,1,CTTGGTCGAATGTACCTGTA,0,1936931
ihfAp4,0.5,1,1,CTTGGTCAATCAGCTTGACA,0,1920224
ihfAp4,0.5,1,1,CTTGGGTTGGAAGTGATGAC,0,1917768
ihfAp4,0.5,1,1,CTTGGGCCTGTGGGGGATGT,0,1916896
ihfAp4,0.5,1,1,CTTGGATCCGGCTCGTCACA,0,1924656
ihfAp4,0.5,1,1,CTTGGACTCCCGATCGCCTT,0,1933676
ihfAp4,0.5,1,1,CTTGGAACCGTGAGCAGCAG,0,1957069
ihfAp4,0.5,1,1,CTTGCTACGGTGATTCCGTC,0,1924158
ihfAp4,0.5,1,1,CTTGCGACTAGCAGGTAAAT,0,1951394
ihfAp4,0.5,1,1,CTTGAGCCGCTTCCGTTGCT,0,1942350
ihfAp4,0.5,1,1,CTTCTTGGAAGAAGTTGCCA,0,1917968
ihfAp4,0.5,1,1,CTTCTTCTGTGTCCATTGTT,0,1939095
ihfAp4,0.5,1,1,CTTCTGATTGTCTCGAACAG,0,1960230
ihfAp4,0.5,1,1,CTTCTCTGATAGTGTCCGTT,0,1947630
ihfAp4,0.5,1,1,CTTCTACCCTGTCGTGTCAT,0,1952593
ihfAp4,0.5,1,1,CTTCGGGTACACGAGAACAC,0,1924911
ihfAp4,0.5,1,1,CTTCGGAGACGTAATTACTC,0,1960021
ihfAp4,0.5,1,1,CTTCGACTCTGGCGCGCCGC,0,1960361
ihfAp4,0.5,1,1,CTTCCTCTGTGATGTCTGAT,0,1956862
ihfAp4,0.5,1,1,CTTCCGCCAAAAGATAACTA,0,1934323
ihfAp4,0.5,1,1,CTTCACCGAGCGTTGGAAAT,0,1916650
ihfAp4,0.5,1,1,CTTATCGTACCCAGATTAAA,0,1922648
ihfAp4,0.5,1,1,CTTATCGCTTCTTGAGCACA,0,1915789
ihfAp4,0.5,1,1,CTTATAAAGCGCCTCCACGT,0,1909869
ihfAp4,0.5,1,1,CTTAGTGGAACGTGGTATCA,0,1915099
ihfAp4,0.5,1,1,CTTAGTACAAGCTGGTTATG,0,1913896
ihfAp4,0.5,1,1,CTTAGGGATAGTATGGGAGC,0,1951524
ihfAp4,0.5,1,1,CTTAGATGATCAGTCGGACG,0,1919793
ihfAp4,0.5,1,1,CTTACGGTTAATATAGCTGA,0,1949521
ihfAp4,0.5,1,1,CTTACAGTCATCGGTGATTC,0,1920434
ihfAp4,0.5,1,1,CTTACAGCCATCACTGGCAG,0,1951956
ihfAp4,0.5,1,1,CTTAATAGACTCCCTAATCT,0,1920546
ihfAp4,0.5,1,1,CTTAAAGCGTAGGCACCCGC,0,1950669
ihfAp4,0.5,1,1,CTGTTTGCACATCCGTCCAG,0,1951196
ihfAp4,0.5,1,1,CTGTTTATGCGCCTTACTGT,0,1961395
ihfAp4,0.5,1,1,CTGTTACGCCGAGGAAAAGT,0,1926788
ihfAp4,0.5,1,1,CTGTGTAAAGGGCTTATACT,0,1915071
ihfAp4,0.5,1,1,CTGTGGCCCGTCTCTCATAA,0,1923166
ihfAp4,0.5,1,1,CTGTGACGGGCTCTAACTAG,0,1944846
ihfAp4,0.5,1,1,CTGTCTCTTGTTCAGCCGGC,0,1934027
ihfAp4,0.5,1,1,CTGTCGTCTGTTTGTGGGTC,0,1945974
ihfAp4,0.5,1,1,CTGTCACGCGCGAAGCAAAG,0,1949742
ihfAp4,0.5,1,1,CTGTATGCCATATGAGGCGC,0,1932967
ihfAp4,0.5,1,1,CTGTAGATCTGCGACCTTCC,0,1931692
ihfAp4,0.5,1,1,CTGTACTACCCCAGCCAGTT,0,1942619
ihfAp4,0.5,1,1,CTGGTTGCGTCACGCCGCCC,0,1951450
ihfAp4,0.5,1,1,CTGGGACCATAGAAGAGGAG,0,1923645
ihfAp4,0.5,1,1,CTGGCTAGCCCGCCCAGCGA,0,1912011
ihfAp4,0.5,1,1,CTGGCGCTGGAGTTAACAGG,0,1947829
ihfAp4,0.5,1,1,CTGGATAAGCATCCTGACGA,0,1945453
ihfAp4,0.5,1,1,CTGGAGATAAGTTTACCTCA,0,1951333
ihfAp4,0.5,1,1,CTGGAGACGGTATTGGCATC,0,1926004
ihfAp4,0.5,1,1,CTGCGGCCAAGATTGTCCTC,0,1933776
ihfAp4,0.5,1,1,CTGCGCTCCTTCTGGTAAGC,0,1946574
ihfAp4,0.5,1,1,CTGCGCGGGAAGTAACCCAA,0,1915496
ihfAp4,0.5,1,1,CTGCCGTGGGTAGCCAAACG,0,1941157
ihfAp4,0.5,1,1,CTGCACTACGGCATGGAAAC,0,1945324
ihfAp4,0.5,1,1,CTGCACGGAACTACAGTATA,0,1941059
ihfAp4,0.5,1,1,CTGCACGAGATAGATGGTCC,0,1937379
ihfAp4,0.5,1,1,CTGATTGGTTGGTGCAAGAG,0,1909814
ihfAp4,0.5,1,1,CTGATTGCAGTCGTCATAAT,0,1927997
ihfAp4,0.5,1,1,CTGATTAGATGTTAAATGTT,0,1948623
ihfAp4,0.5,1,1,CTGATGTGCCGTGTCCTGAG,0,1946408
ihfAp4,0.5,1,1,CTGATATTCTCCCGATAAGA,0,1935539
ihfAp4,0.5,1,1,CTGACCAGAGAAGACAATAT,0,1935005
ihfAp4,0.5,1,1,CTGAAGCGGACATTCAGTTT,0,1928156
ihfAp4,0.5,1,1,CTGAAAATAGTCATATGGCC,0,1919681
ihfAp4,0.5,1,1,CTCTTCTCGTTACAATCTTA,0,1910903
ihfAp4,0.5,1,1,CTCTGCGAGGCTTCTTCTTC,0,1920128
ihfAp4,0.5,1,1,CTCTCACATCAGTTGGACCA,0,1939666
ihfAp4,0.5,1,1,CTCTATTGGCGTATTGGCAT,0,1946094
ihfAp4,0.5,1,1,CTCTACGTGACGAGTCATGA,0,1939733
ihfAp4,0.5,1,1,CTCTACGCAGAGCCCCTTGC,0,1948647
ihfAp4,0.5,1,1,CTCGTTCTGTAGGTCTCGAC,0,1959421
ihfAp4,0.5,1,1,CTCGTGGTCATTTTCTTTAA,0,1952775
ihfAp4,0.5,1,1,CTCGTGGCAACAGGAGGAGT,0,1944323
ihfAp4,0.5,1,1,CTCGGGAACTCGACCTTACT,0,1926055
ihfAp4,0.5,1,1,CTCGGACGAGGGCTGCAACA,0,1955136
ihfAp4,0.5,1,1,CTCGCCCCCATATCACAACA,0,1956023
ihfAp4,0.5,1,1,CTCGCAAACGGCCACACTAT,0,1949320
ihfAp4,0.5,1,1,CTCGAGCTGCTTATCTACTT,0,1917764
ihfAp4,0.5,1,1,CTCCTCGGGAACAAACGAAA,0,1921142
ihfAp4,0.5,1,1,CTCCGTGGGTCACCACCCTG,0,1933602
ihfAp4,0.5,1,1,CTCCGGGGCTGACCTATTGG,0,1916343
ihfAp4,0.5,1,1,CTCCCTGGCTCCGTCTGTCT,0,1938589
ihfAp4,0.5,1,1,CTCCACCTCCTCTATTGAAC,0,1940044
ihfAp4,0.5,1,1,CTCATCAGTGCAACTTAATT,0,1961995
ihfAp4,0.5,1,1,CTCATAATCGGGAAAACTAT,0,1917130
ihfAp4,0.5,1,1,CTCAGGTTACTCGTTGTACA,0,1929807
ihfAp4,0.5,1,1,CTCAGATTATCGTGTAGTAG,0,1951720
ihfAp4,0.5,1,1,CTCAGACGTCCCTGGCACGA,0,1916794
ihfAp4,0.5,1,1,CTCACTTAAATATGGATAGC,0,1954652
ihfAp4,0.5,1,1,CTCACGTAAAGTGCATTTCC,0,1923920
ihfAp4,0.5,1,1,CTCACGGAATGTAAAGTATC,0,1926896
ihfAp4,0.5,1,1,CTATTTACTAGCGAAGGCCC,0,1936494
ihfAp4,0.5,1,1,CTATTAGTTCCCTTCGTTGA,0,1959398
ihfAp4,0.5,1,1,CTATTAGCCGCGTGGTCTAT,0,1924535
ihfAp4,0.5,1,1,CTATGAGTATAGGATTCGGC,0,1911466
ihfAp4,0.5,1,1,CTATCAAGACAGTCTATTTA,0,1918441
ihfAp4,0.5,1,1,CTATATGAAATTGGTATCGG,0,1940306
ihfAp4,0.5,1,1,CTATAGTGCGATATCCTTGC,0,1928088
ihfAp4,0.5,1,1,CTATAGTCACACGTTAGGAA,0,1953561
ihfAp4,0.5,1,1,CTATAGGGATTGACGAACGT,0,1935722
ihfAp4,0.5,1,1,CTATACCCGGGTCGTGCGTC,0,1912102
ihfAp4,0.5,1,1,CTAGTTATATTTGGCAATAG,0,1941179
ihfAp4,0.5,1,1,CTAGGTGAAGGGTGAGATCG,0,1935550
ihfAp4,0.5,1,1,CTAGGCCACACTTTCGTCAA,0,1919399
ihfAp4,0.5,1,1,CTAGGACCCGGCCCGTTTAG,0,1919943
ihfAp4,0.5,1,1,CTAGCCCGTCGATCTCATGT,0,1945276
ihfAp4,0.5,1,1,CTAGCATATCGCCTGAACTA,0,1917490
ihfAp4,0.5,1,1,CTAGATTGAACCTCGGGTGC,0,1950802
ihfAp4,0.5,1,1,CTAGAGTCGGCATGGCGTGC,0,1931203
ihfAp4,0.5,1,1,CTAGAAGTCGTCGAATTCCT,0,1948336
ihfAp4,0.5,1,1,CTAGAACGCCCTCCGAATCC,0,1936242
ihfAp4,0.5,1,1,CTACTTTATGGTTCTAGTAT,0,1924978
ihfAp4,0.5,1,1,CTACTCAACAGATGGTGATC,0,1918800
ihfAp4,0.5,1,1,CTACGAACCTCGATCATCTC,0,1911662
ihfAp4,0.5,1,1,CTACCTTAGCCGAACAATTA,0,1922338
ihfAp4,0.5,1,1,CTACCTGTCCGGTAACCCTC,0,1953779
ihfAp4,0.5,1,1,CTACCGGCAGCTCATTCTCG,0,1918703
ihfAp4,0.5,1,1,CTACATCTGGAGCCCTATGA,0,1953056
ihfAp4,0.5,1,1,CTACAAGAGGGACTCATAGC,0,1942679
ihfAp4,0.5,1,1,CTAATCGCGGCTGGGTTTAA,0,1942042
ihfAp4,0.5,1,1,CTAAGGTCAGCAAAGAAATA,0,1957153
ihfAp4,0.5,1,1,CTAAGGCCTCTTTTCAAAAA,0,1909557
ihfAp4,0.5,1,1,CTAAGCTCAGCGCCCCAAGT,0,1931172
ihfAp4,0.5,1,1,CTAAGCCTGAACGCTGTCTA,0,1909994
ihfAp4,0.5,1,1,CTAAGAAGCCACTACCGTTT,0,1951419
ihfAp4,0.5,1,1,CTAAGAACTACTCATATACA,0,1945762
ihfAp4,0.5,1,1,CTAAGAAAACTCATCTGTAG,0,1951538
ihfAp4,0.5,1,1,CTAACTCTATCTTACACCAG,0,1919150
ihfAp4,0.5,1,1,CTAACGTGAAGTTCCCCTCT,0,1955580
ihfAp4,0.5,1,1,CTAACGAAGACCCGAGAGGA,0,1958516
ihfAp4,0.5,1,1,CTAACCTCTCGCCTATTTTG,0,1919595
ihfAp4,0.5,1,1,CTAACCGATCCCCAATAGGG,0,1945956
ihfAp4,0.5,1,1,CTAAATATACACAACTACGA,0,1935847
ihfAp4,0.5,1,1,CGTTTAGCACTGTATCAACC,0,1942809
ihfAp4,0.5,1,1,CGTTTAACGCGCACCCAGAT,0,1948732
ihfAp4,0.5,1,1,CGTTGTGCAGGAGCGTAGGA,0,1920055
ihfAp4,0.5,1,1,CGTTGCGGTTCACGCGGCCA,0,1958268
ihfAp4,0.5,1,1,CGTTGATAAGCGCGTATTAA,0,1951656
ihfAp4,0.5,1,1,CGTTCTCAGGTCACCCCCTG,0,1926249
ihfAp4,0.5,1,1,CGTTACGCGGATGCGACAAC,0,1951000
ihfAp4,0.5,1,1,CGTTACACGCTGGAACGGAA,0,1958171
ihfAp4,0.5,1,1,CGTGGCTCAGAGTGCACTCT,0,1948946
ihfAp4,0.5,1,1,CGTGAGCGCCTACCTCAGAT,0,1957628
ihfAp4,0.5,1,1,CGTGACTGGTTCGACGGCTA,0,1922663
ihfAp4,0.5,1,1,CGTGACTCTCTATCGGAGCT,0,1923579
ihfAp4,0.5,1,1,CGTGAATCGTATAGACAGAA,0,1954750
ihfAp4,0.5,1,1,CGTCTGCTGCTACTACTCGC,0,1914071
ihfAp4,0.5,1,1,CGTCTCACGCGGGAGGTCAA,0,1917915
ihfAp4,0.5,1,1,CGTCACCTTCCTCCCCTACG,0,1952204
ihfAp4,0.5,1,1,CGTCAAGTAGGGCTAACCAT,0,1946983
ihfAp4,0.5,1,1,CGTAGGGTGCACCTCGGTCG,0,1958375
ihfAp4,0.5,1,1,CGTAGGCATTGACGAGTGCT,0,1915300
ihfAp4,0.5,1,1,CGTAGGAGCGGACTTCGCAG,0,1916118
ihfAp4,0.5,1,1,CGTAGCCGTGATAAATTGGC,0,1916655
ihfAp4,0.5,1,1,CGTAGATTCTTCGTTGAGCG,0,1922291
ihfAp4,0.5,1,1,CGTAGAGTAGGTAAGTCGCA,0,1917235
ihfAp4,0.5,1,1,CGTAGAGCTCGCTCATTCAT,0,1924637
ihfAp4,0.5,1,1,CGTACGGGGTTCGTAGGATC,0,1954227
ihfAp4,0.5,1,1,CGTACGATGTGGAAACGGTT,0,1914002
ihfAp4,0.5,1,1,CGTACAGGTGAAGGAGCAGG,0,1954033
ihfAp4,0.5,1,1,CGGTTTCTCCCTGGATGGGG,0,1955126
ihfAp4,0.5,1,1,CGGTGTGATTTATGTAGGCA,0,1934489
ihfAp4,0.5,1,1,CGGTGGTGTACCTCTGGTAG,0,1961169
ihfAp4,0.5,1,1,CGGTGCGACGAAACGACCGA,0,1926928
ihfAp4,0.5,1,1,CGGTCGGGACCGGAAATGGG,0,1956778
ihfAp4,0.5,1,1,CGGTCCACATATCGTCCGCC,0,1930804
ihfAp4,0.5,1,1,CGGTATACCCAGACAGGTGG,0,1955784
ihfAp4,0.5,1,1,CGGGTTGTCGCAGCTTCCTG,0,1913886
ihfAp4,0.5,1,1,CGGGGTCGTGCATTCGTCCG,0,1930343
ihfAp4,0.5,1,1,CGGGGGGAACGCTATTGGGA,0,1923482
ihfAp4,0.5,1,1,CGGGGAACCGGTCGGGCATA,0,1934412
ihfAp4,0.5,1,1,CGGGCTTGCATCAGCAAGGC,0,1953050
ihfAp4,0.5,1,1,CGGGCGGGAGTCTCCTTGTA,0,1948382
ihfAp4,0.5,1,1,CGGGCCAAGAGATGAGCACG,0,1922063
ihfAp4,0.5,1,1,CGGGCATACTGCCGATGTAG,0,1953356
ihfAp4,0.5,1,1,CGGGATAAGAAGTTAGATTG,0,1948619
ihfAp4,0.5,1,1,CGGGAGGTCCCCAGGACGAT,0,1923656
ihfAp4,0.5,1,1,CGGGAGAAGCGGTTCACAGA,0,1944631
ihfAp4,0.5,1,1,CGGGAAAACTGCTTGACAAA,0,1935275
ihfAp4,0.5,1,1,CGGCGGAATCAACTATTACG,0,1940095
ihfAp4,0.5,1,1,CGGCGAACCCCTCAGCACTA,0,1931272
ihfAp4,0.5,1,1,CGGCACGTTTTTTTCGCGTT,0,1932027
ihfAp4,0.5,1,1,CGGATCGTTGCGTAATAAGT,0,1948360
ihfAp4,0.5,1,1,CGGATCATTAAATAGAGGGT,0,1942580
ihfAp4,0.5,1,1,CGGATAGCGCGGGTTCGGAG,0,1947020
ihfAp4,0.5,1,1,CGGATACTGGTCCCTTAGGT,0,1930893
ihfAp4,0.5,1,1,CGGAGTTCATCGGGGATCGT,0,1928734
ihfAp4,0.5,1,1,CGGAGCATCACAGTAAAATT,0,1927435
ihfAp4,0.5,1,1,CGGACGCTTTTGAATAAGGT,0,1925088
ihfAp4,0.5,1,1,CGGACGCCTAGGGCGTTATT,0,1930421
ihfAp4,0.5,1,1,CGGACATTCCAGGAGTTCGT,0,1927127
ihfAp4,0.5,1,1,CGGAATTCCCTGTCGGTAAA,0,1924461
ihfAp4,0.5,1,1,CGCTTAAGTTCAGTTTGTCC,0,1929280
ihfAp4,0.5,1,1,CGCTCGTATATTCATACCTG,0,1911190
ihfAp4,0.5,1,1,CGCTACTCACACTTCCAAGT,0,1929854
ihfAp4,0.5,1,1,CGCTACTAGAGAGGAGTGGG,0,1921132
ihfAp4,0.5,1,1,CGCGGGTAGAGATCGGTGTG,0,1941809
ihfAp4,0.5,1,1,CGCGGGGCACGAATCGGGTT,0,1951058
ihfAp4,0.5,1,1,CGCGGCCCACTAACACCGGT,0,1931240
ihfAp4,0.5,1,1,CGCGCTCCTCAATCATAAAT,0,1944916
ihfAp4,0.5,1,1,CGCGCGTGCGTGTGCCGACT,0,1931756
ihfAp4,0.5,1,1,CGCGATTCTCCATGGTGTTT,0,1938556
ihfAp4,0.5,1,1,CGCGAGATATATAGGCCTAA,0,1927655
ihfAp4,0.5,1,1,CGCGACTGCTCACTTACAAT,0,1954859
ihfAp4,0.5,1,1,CGCGACAGAGTTATCTGTCG,0,1958397
ihfAp4,0.5,1,1,CGCCTTTCCAATCGAGCACG,0,1918831
ihfAp4,0.5,1,1,CGCCTCGCCGCAACGCGGTC,0,1914199
ihfAp4,0.5,1,1,CGCCTCCGATTGATTAGCAG,0,1953196
ihfAp4,0.5,1,1,CGCCGTCAGTGCGACTCCGT,0,1929994
ihfAp4,0.5,1,1,CGCCGGTCAACAGACAATGT,0,1936521
ihfAp4,0.5,1,1,CGCCGCGTCGCAAGGAACGA,0,1923542
ihfAp4,0.5,1,1,CGCCGATACGGTCCGTTGGG,0,1924322
ihfAp4,0.5,1,1,CGCCCTGGTTCTTAGCTCTT,0,1957751
ihfAp4,0.5,1,1,CGCCAGATGGGTGGTGAATC,0,1929801
ihfAp4,0.5,1,1,CGCCACATTTCACGCTTTCC,0,1922065
ihfAp4,0.5,1,1,CGCCAAGAGCGTTGGAGGGT,0,1954093
ihfAp4,0.5,1,1,CGCATGGGAGGCTGATGCTA,0,1947657
ihfAp4,0.5,1,1,CGCAGTGATAGTCAAAAAAA,0,1946226
ihfAp4,0.5,1,1,CGCAGGTTAAACTCGCACGA,0,1936624
ihfAp4,0.5,1,1,CGCACCTTTACAGCCTTTAG,0,1948046
ihfAp4,0.5,1,1,CGCAATGAAGGAGGTACCGT,0,1929007
ihfAp4,0.5,1,1,CGCAACCAGGGGCGCACCCA,0,1945185
ihfAp4,0.5,1,1,CGCAAATACGTTTCGGAGGA,0,1920635
ihfAp4,0.5,1,1,CGATTTTAATTGGAAAATGT,0,1927436
ihfAp4,0.5,1,1,CGATTCAACGCTGGAACAAT,0,1955111
ihfAp4,0.5,1,1,CGATTACAACTTAAAGCTTG,0,1940737
ihfAp4,0.5,1,1,CGATGTATGGCAGTCCAAGT,0,1924768
ihfAp4,0.5,1,1,CGATGGAAAGCTTGAGGCAA,0,1919739
ihfAp4,0.5,1,1,CGATGCCTTGGGATACCAAG,0,1923088
ihfAp4,0.5,1,1,CGATGCAACGGAGGTGAAGG,0,1957197
ihfAp4,0.5,1,1,CGATCGTCTCTGTGCTATTT,0,1958881
ihfAp4,0.5,1,1,CGATCCGTCTAGTAACCAAA,0,1955344
ihfAp4,0.5,1,1,CGATCCGGCACCATGGCTCC,0,1915849
ihfAp4,0.5,1,1,CGATCATTTCTATGATACGT,0,1935996
ihfAp4,0.5,1,1,CGATCAACCTGGTTACGCTT,0,1952895
ihfAp4,0.5,1,1,CGATAGGAATTAATGGTAGC,0,1959491
ihfAp4,0.5,1,1,CGATACGTGCATTCACTTCT,0,1946542
ihfAp4,0.5,1,1,CGAGTCCATCCCTGAATCAA,0,1943130
ihfAp4,0.5,1,1,CGAGTCAAGTAGTGTGCTAA,0,1927523
ihfAp4,0.5,1,1,CGAGGAAAAGAGTTGTGTGA,0,1946575
ihfAp4,0.5,1,1,CGAGCACCGGACGAAATCCA,0,1935660
ihfAp4,0.5,1,1,CGAGATTGTACCACGCACTT,0,1914072
ihfAp4,0.5,1,1,CGAGATACATTTAATTAGGT,0,1955760
ihfAp4,0.5,1,1,CGAGAGCACCCGTGCTACTA,0,1951201
ihfAp4,0.5,1,1,CGAGACGTGGTGGACGAAGA,0,1916008
ihfAp4,0.5,1,1,CGAGAATGCTAATTAGCTGG,0,1945722
ihfAp4,0.5,1,1,CGACTTTGGTCGAATTTAGT,0,1911437
ihfAp4,0.5,1,1,CGACTACGAGTAAGATGACA,0,1928138
ihfAp4,0.5,1,1,CGACGGGATGCTCCCGGATG,0,1922686
ihfAp4,0.5,1,1,CGACCTCGTTGCGTTGTAGC,0,1957147
ihfAp4,0.5,1,1,CGACCCTGACTCGGGCGACC,0,1939066
ihfAp4,0.5,1,1,CGACCCGGCGCGAATTTGTG,0,1959922
ihfAp4,0.5,1,1,CGACATATTGTTATCCTAGT,0,1915118
ihfAp4,0.5,1,1,CGACAGCCCGCCCCCTCTTT,0,1947388
ihfAp4,0.5,1,1,CGAATTAGGCTTTTCATTGC,0,1947641
ihfAp4,0.5,1,1,CGAATGATGGATTATTTCCG,0,1930961
ihfAp4,0.5,1,1,CGAATCCTGGCACCTAGGGA,0,1916354
ihfAp4,0.5,1,1,CGAATCCGTAAAGGGCGGAA,0,1955162
ihfAp4,0.5,1,1,CGAAGCATGACCAACTTGTA,0,1941309
ihfAp4,0.5,1,1,CGAACGAATACCAAGATTCC,0,1940081
ihfAp4,0.5,1,1,CGAACACTCACCGAGTGAGG,0,1949871
ihfAp4,0.5,1,1,CGAACAAATGTAGCTAGAAC,0,1945029
ihfAp4,0.5,1,1,CGAAATTTACAAGGGGTAAT,0,1913974
ihfAp4,0.5,1,1,CGAAATATGCGTCACCTACT,0,1912446
ihfAp4,0.5,1,1,CGAAAGGTGACTCCGCATCT,0,1914243
ihfAp4,0.5,1,1,CCTTTTGGGCACTACGAGTT,0,1949322
ihfAp4,0.5,1,1,CCTTTATCTTTCGCCGGCAA,0,1912709
ihfAp4,0.5,1,1,CCTTGTATCTTAGCGCGGTC,0,1957610
ihfAp4,0.5,1,1,CCTTGGCAGGGTCCGAATGG,0,1932695
ihfAp4,0.5,1,1,CCTTGCCCAGTTCGCAAAGT,0,1956765
ihfAp4,0.5,1,1,CCTTGACTGTCTGCGCACCA,0,1960651
ihfAp4,0.5,1,1,CCTTGAACTGGTTTTGAACA,0,1958916
ihfAp4,0.5,1,1,CCTTCGACAATGTGGACAAT,0,1928269
ihfAp4,0.5,1,1,CCTTAGAGCGCGCTTCCACT,0,1940978
ihfAp4,0.5,1,1,CCTTACGATGCATTAAGGTA,0,1931544
ihfAp4,0.5,1,1,CCTTACCCCGAAATCGGCTG,0,1947882
ihfAp4,0.5,1,1,CCTGTTTGCCTGCTGGCGTT,0,1957901
ihfAp4,0.5,1,1,CCTGTTATGATCCGGCCCGA,0,1943240
ihfAp4,0.5,1,1,CCTGTTATCGAAGAACCGGG,0,1947127
ihfAp4,0.5,1,1,CCTGGCTAAAGAAAAAGTCG,0,1940465
ihfAp4,0.5,1,1,CCTGGACCTTTTTTCGCGAA,0,1924404
ihfAp4,0.5,1,1,CCTGCTTGTGAGGCCTAACG,0,1953083
ihfAp4,0.5,1,1,CCTGCTGAAGGCCTTCACTA,0,1925497
ihfAp4,0.5,1,1,CCTGCGTTCCGCGGGTAAAA,0,1935378
ihfAp4,0.5,1,1,CCTCTTTGTCTTTCGCCTTA,0,1948924
ihfAp4,0.5,1,1,CCTCTATTGTGAATGGAGAA,0,1934894
ihfAp4,0.5,1,1,CCTCTATTACGACAGGATGG,0,1912052
ihfAp4,0.5,1,1,CCTCGTCTCCTAGACTAATA,0,1916960
ihfAp4,0.5,1,1,CCTCGTCAAGCGCCGAGAGG,0,1948346
ihfAp4,0.5,1,1,CCTCGGTCCACATCGCTCTT,0,1937961
ihfAp4,0.5,1,1,CCTCGATCTAACTAACAACA,0,1934034
ihfAp4,0.5,1,1,CCTCCGTTCTCCCGTTAACT,0,1921116
ihfAp4,0.5,1,1,CCTCATTCAGTCCCTTATCA,0,1950425
ihfAp4,0.5,1,1,CCTATTTAAAAGTCCGCTAG,0,1933586
ihfAp4,0.5,1,1,CCTATTCGGGCTGAGTTGAT,0,1926455
ihfAp4,0.5,1,1,CCTATCTCGATGACCTGTAT,0,1945277
ihfAp4,0.5,1,1,CCTATCCGCAGCAATGTAAT,0,1956444
ihfAp4,0.5,1,1,CCTACTGGGTTCCCAGGACA,0,1917578
ihfAp4,0.5,1,1,CCTACTCTATATAAGCATTC,0,1932675
ihfAp4,0.5,1,1,CCTACACATAAAGGGGGGAT,0,1941814
ihfAp4,0.5,1,1,CCTAAATGGAGTCCATCTTC,0,1917683
ihfAp4,0.5,1,1,CCTAAAAAAGGCCTAGTACA,0,1929828
ihfAp4,0.5,1,1,CCGTTCGTGCCAGGTTTTTC,0,1938831
ihfAp4,0.5,1,1,CCGTGTGTAGTTCAATTTCT,0,1937143
ihfAp4,0.5,1,1,CCGTGTCGCCCTTCCTTACG,0,1958217
ihfAp4,0.5,1,1,CCGTGGGTCACCGATGAATG,0,1943932
ihfAp4,0.5,1,1,CCGTATCAGGGAGCTGATTA,0,1955122
ihfAp4,0.5,1,1,CCGTAGCGGGGCATTGAAAC,0,1945656
ihfAp4,0.5,1,1,CCGTACCTTGTTGGTTTGCA,0,1945159
ihfAp4,0.5,1,1,CCGGTTTTTCTGTTCTGTCC,0,1909975
ihfAp4,0.5,1,1,CCGGTGACGTTACGTCCGCC,0,1957611
ihfAp4,0.5,1,1,CCGGTCGCGTGGTGATTCTT,0,1933443
ihfAp4,0.5,1,1,CCGGCTTGGTCTTGTGACAG,0,1940744
ihfAp4,0.5,1,1,CCGGCGGACTATCGACTGGT,0,1931574
ihfAp4,0.5,1,1,CCGGCATTCTTTTGACCGAT,0,1917329
ihfAp4,0.5,1,1,CCGGACATGGCGGCGTGGGC,0,1938921
ihfAp4,0.5,1,1,CCGGAACAGTACGGATTGGG,0,1933779
ihfAp4,0.5,1,1,CCGCTTGTATGTCGCGATCG,0,1931162
ihfAp4,0.5,1,1,CCGCTAGCGTATACGACCGT,0,1925820
ihfAp4,0.5,1,1,CCGCGTGAGTACAAGTATGA,0,1932737
ihfAp4,0.5,1,1,CCGCGGCCTAGTCCGCCCCG,0,1946453
ihfAp4,0.5,1,1,CCGCGCTTAACGGACCCTTC,0,1960996
ihfAp4,0.5,1,1,CCGCATTCACGCCGAAAAGC,0,1957592
ihfAp4,0.5,1,1,CCGCACTGGACTGGACCGTG,0,1923294
ihfAp4,0.5,1,1,CCGCACCGTAGACCCATGGC,0,1916495
ihfAp4,0.5,1,1,CCGATCATTACTAGGTTAGA,0,1910901
ihfAp4,0.5,1,1,CCGAGCTGAGAAGTGGCTGC,0,1936738
ihfAp4,0.5,1,1,CCGAGCGGGATCGTTCTGCG,0,1949024
ihfAp4,0.5,1,1,CCGACGGAGGGCAGCCGTAC,0,1919735
ihfAp4,0.5,1,1,CCGAATGCCATTGTTATTGT,0,1951928
ihfAp4,0.5,1,1,CCGAATCTACAAAGGTGGTG,0,1961276
ihfAp4,0.5,1,1,CCCTTTTGCTCAAATCTCGC,0,1961319
ihfAp4,0.5,1,1,CCCTTGGAAACGCCTCCGCG,0,1955896
ihfAp4,0.5,1,1,CCCTTCATCCTGATTCATTG,0,1961488
ihfAp4,0.5,1,1,CCCTTAGCAAAGCCCCAGGG,0,1915151
ihfAp4,0.5,1,1,CCCTGTCCTTTTATCAGAGC,0,1922953
ihfAp4,0.5,1,1,CCCTGCTCGGTCCTCAGCTG,0,1911093
ihfAp4,0.5,1,1,CCCTGACTTACCGTGTACCA,0,1951239
ihfAp4,0.5,1,1,CCCTCCGCTGCACTGTACAG,0,1914341
ihfAp4,0.5,1,1,CCCTCCACTCGACGGGGTTG,0,1912390
ihfAp4,0.5,1,1,CCCTATCGCAGGACTCGTCT,0,1909819
ihfAp4,0.5,1,1,CCCGTGTAGGACCGGGAAAC,0,1921876
ihfAp4,0.5,1,1,CCCGTACGAGCTCCAGATAT,0,1951784
ihfAp4,0.5,1,1,CCCGGTTGGATTGGAGTGGC,0,1914233
ihfAp4,0.5,1,1,CCCGGCATACTTGATGTGAG,0,1954375
ihfAp4,0.5,1,1,CCCGCTACTCGCTGATTTGG,0,1936428
ihfAp4,0.5,1,1,CCCGAGCTCCCGAAACCCTG,0,1951673
ihfAp4,0.5,1,1,CCCCTGGAACGCGATATGAT,0,1954957
ihfAp4,0.5,1,1,CCCCTATAGGCAGGAGAACT,0,1942087
ihfAp4,0.5,1,1,CCCCTAAGCGAGGAAATCAG,0,1918450
ihfAp4,0.5,1,1,CCCCGGGGGTGGCAGCGTTA,0,1937065
ihfAp4,0.5,1,1,CCCCGATGCAGGGGGCCTTT,0,1916252
ihfAp4,0.5,1,1,CCCCCGTGCGCAGGCGAGCT,0,1935283
ihfAp4,0.5,1,1,CCCCCAGACCTTGCCGTGGA,0,1924542
ihfAp4,0.5,1,1,CCCCAGGATGAAAATCAGAG,0,1910851
ihfAp4,0.5,1,1,CCCAGTGCACATGAACTGAC,0,1954887
ihfAp4,0.5,1,1,CCCACTTGCAGAGTATCCAC,0,1921308
ihfAp4,0.5,1,1,CCCACGCTAGTTCCCTTTAT,0,1934618
ihfAp4,0.5,1,1,CCCACCGGGGTAAAACGCCC,0,1914625
ihfAp4,0.5,1,1,CCCAACATCTAAGTAGGCCG,0,1925200
ihfAp4,0.5,1,1,CCATTTCCGTTCCTATCAGA,0,1914681
ihfAp4,0.5,1,1,CCATTACCTTCAATAATCAT,0,1954363
ihfAp4,0.5,1,1,CCATGGCCACTTTTGCCCAT,0,1943731
ihfAp4,0.5,1,1,CCATCCTCGTGGGAATGTTT,0,1938236
ihfAp4,0.5,1,1,CCATCCTATTTGGGCACCGT,0,1928743
ihfAp4,0.5,1,1,CCATAAACCACTAAATGTTC,0,1950274
ihfAp4,0.5,1,1,CCAGTGCCTCGATAACCGAT,0,1918012
ihfAp4,0.5,1,1,CCAGGTCATCGCAGTGGCTG,0,1951091
ihfAp4,0.5,1,1,CCAGGGCGCATACATGTAGA,0,1940824
ihfAp4,0.5,1,1,CCAGGCGAAAGGACACAAAG,0,1921521
ihfAp4,0.5,1,1,CCAGCGTGCGGGGACAATTA,0,1942584
ihfAp4,0.5,1,1,CCAGCCTCGTCCGTGTCATG,0,1927578
ihfAp4,0.5,1,1,CCAGAGATGCGCGCATTGTT,0,1957694
ihfAp4,0.5,1,1,CCAGAATCCAGTATTGGAGG,0,1955518
ihfAp4,0.5,1,1,CCACGGGCTTCTACAATACA,0,1961312
ihfAp4,0.5,1,1,CCACGCACCGTCTACCTCGG,0,1912635
ihfAp4,0.5,1,1,CCACCCGCGCGGTATAGTTC,0,1953709
ihfAp4,0.5,1,1,CCACCATGCTGAGTCTGTAA,0,1918653
ihfAp4,0.5,1,1,CCACACTTGCAAAGCTGTGC,0,1933312
ihfAp4,0.5,1,1,CCACACGCCTCGACTAAAAT,0,1938621
ihfAp4,0.5,1,1,CCAATTCAAATAATTACGAT,0,1943155
ihfAp4,0.5,1,1,CCAATATCACGGCTAAAGGT,0,1927431
ihfAp4,0.5,1,1,CCAATACGCCGGTGTTCCGA,0,1954288
ihfAp4,0.5,1,1,CCAAGTTGCGCCACGGGGGC,0,1946093
ihfAp4,0.5,1,1,CCAACTAGCCCCAATCAACC,0,1920124
ihfAp4,0.5,1,1,CCAACGTAACGGGGTCCCAT,0,1923585
ihfAp4,0.5,1,1,CCAACGAGTCCCACTTCGGG,0,1961696
ihfAp4,0.5,1,1,CCAAAGATTGCATCCTTTGA,0,1941006
ihfAp4,0.5,1,1,CATTTGTGATGATCCCCGTA,0,1958173
ihfAp4,0.5,1,1,CATTGTTCAGTGACAGGCCA,0,1936149
ihfAp4,0.5,1,1,CATTGACGTGGTGTGGATGT,0,1926037
ihfAp4,0.5,1,1,CATTCTGTTATTGAAAGCTA,0,1939444
ihfAp4,0.5,1,1,CATTCACAAATTTGAGGAAC,0,1947985
ihfAp4,0.5,1,1,CATTATAGGAAGCCACCACA,0,1918010
ihfAp4,0.5,1,1,CATTAGGATGTCGCTCCGAG,0,1932526
ihfAp4,0.5,1,1,CATTAGACTTGGTCCGCGCT,0,1923571
ihfAp4,0.5,1,1,CATTAAACATTTAAGGTTTC,0,1918183
ihfAp4,0.5,1,1,CATGTGTAGCACTTTTGCAA,0,1910684
ihfAp4,0.5,1,1,CATGTGCGTGGTTATGGCTC,0,1922046
ihfAp4,0.5,1,1,CATGGATATTCTAGCATTCC,0,1913459
ihfAp4,0.5,1,1,CATGCTATGAAGGCGGGCGT,0,1927741
ihfAp4,0.5,1,1,CATGCTATGAACTAATGAAA,0,1940982
ihfAp4,0.5,1,1,CATGCGCCATTGCTGGACCG,0,1943658
ihfAp4,0.5,1,1,CATGCCCTAACATACCGTAG,0,1910073
ihfAp4,0.5,1,1,CATGATTGCACAGGACCTTC,0,1953204
ihfAp4,0.5,1,1,CATCTGCAGGTCGTCCCGTC,0,1955339
ihfAp4,0.5,1,1,CATCTCATGATAACAGACCA,0,1954697
ihfAp4,0.5,1,1,CATCGTATACCTACATGTCC,0,1949346
ihfAp4,0.5,1,1,CATCATGCCCGAGGGATCGG,0,1958373
ihfAp4,0.5,1,1,CATCATAGTGTGTAGAAAAA,0,1941477
ihfAp4,0.5,1,1,CATCAGTCGTAAGGCTAGTA,0,1950908
ihfAp4,0.5,1,1,CATCACTGAACAAACACCAG,0,1946839
ihfAp4,0.5,1,1,CATCACCGTGCTACATAGAA,0,1909875
ihfAp4,0.5,1,1,CATCAAAATGGCGGCGGTTA,0,1917979
ihfAp4,0.5,1,1,CATATTTTCAAATACGGTGG,0,1944601
ihfAp4,0.5,1,1,CATATTGACGCGCTCGTGAG,0,1927917
ihfAp4,0.5,1,1,CATAGTGCCTGCAGTTCATT,0,1948411
ihfAp4,0.5,1,1,CATAGGTTCTAAAACAAGGA,0,1960633
ihfAp4,0.5,1,1,CATAGACTCCGCTATCACAT,0,1912463
ihfAp4,0.5,1,1,CATACGATTTGGCGGTGTTA,0,1955670
ihfAp4,0.5,1,1,CATACGAGGACAGCATGCCA,0,1955641
ihfAp4,0.5,1,1,CATACATTATTACTAGATCT,0,1914678
ihfAp4,0.5,1,1,CATACATAATTAGGTCACTC,0,1911988
ihfAp4,0.5,1,1,CATAAAGGAGTTTTCATGGC,0,1947405
ihfAp4,0.5,1,1,CAGTTGGACAATCATTTCAG,0,1959401
ihfAp4,0.5,1,1,CAGTTAAAATTCACCACTGC,0,1942537
ihfAp4,0.5,1,1,CAGTGGTTGTTCGATTTTTT,0,1929390
ihfAp4,0.5,1,1,CAGTGCATCCGTAGATTCTC,0,1915318
ihfAp4,0.5,1,1,CAGTGAGGTCATGTCATTCG,0,1920721
ihfAp4,0.5,1,1,CAGTCAGAGGATATTGGAGC,0,1921616
ihfAp4,0.5,1,1,CAGTAGTATGTAAGCTGTGC,0,1922161
ihfAp4,0.5,1,1,CAGGTCCCCCCACGGGGCCT,0,1939055
ihfAp4,0.5,1,1,CAGGGGCCGCGAAAATTTGC,0,1931467
ihfAp4,0.5,1,1,CAGGGGACGGATGGAAAGAA,0,1924238
ihfAp4,0.5,1,1,CAGGCGCCTCAGCCCCGCCT,0,1957115
ihfAp4,0.5,1,1,CAGGCCCGTCCGAGAATAGT,0,1959754
ihfAp4,0.5,1,1,CAGGCCACGCTAATAATTTC,0,1954591
ihfAp4,0.5,1,1,CAGGAATCAATATCGTTCTG,0,1947792
ihfAp4,0.5,1,1,CAGCTGTATCTTGGTTGCAC,0,1917344
ihfAp4,0.5,1,1,CAGCTGGTTAAGACAACCAT,0,1961906
ihfAp4,0.5,1,1,CAGCTGCGGTGAGAGCCGTT,0,1942184
ihfAp4,0.5,1,1,CAGCGTTCAACCGGGGCTAC,0,1926072
ihfAp4,0.5,1,1,CAGCGTCTTACCAGCAAGTC,0,1916786
ihfAp4,0.5,1,1,CAGCGTCCTACGTTATGCGC,0,1952586
ihfAp4,0.5,1,1,CAGCGGTATGTCGGTACAGA,0,1914369
ihfAp4,0.5,1,1,CAGCGATACTCAGCAACTGC,0,1921369
ihfAp4,0.5,1,1,CAGCGAATCAGATCTCCTAG,0,1937321
ihfAp4,0.5,1,1,CAGCCTCTCTATCACTACGT,0,1954700
ihfAp4,0.5,1,1,CAGCCGCGACATGTTGCCTA,0,1951955
ihfAp4,0.5,1,1,CAGCCGAGGGCTCTTGCACG,0,1948354
ihfAp4,0.5,1,1,CAGCCCCTCCTTTTCCGATA,0,1938243
ihfAp4,0.5,1,1,CAGCATTTTCCTCGGGCTTA,0,1923114
ihfAp4,0.5,1,1,CAGCATGGGTTTCCGAAAAG,0,1947069
ihfAp4,0.5,1,1,CAGCAGGTTTTGCGGAGTTG,0,1923713
ihfAp4,0.5,1,1,CAGATGCCGGGGTTTCAGAC,0,1955211
ihfAp4,0.5,1,1,CAGATCGGTCTCCGTACTTT,0,1912031
ihfAp4,0.5,1,1,CAGATCCCCAGCGACTAAAA,0,1918459
ihfAp4,0.5,1,1,CAGATAAGCCCAATCGGAAT,0,1923113
ihfAp4,0.5,1,1,CAGACAGATTAGTGGGCGGA,0,1918561
ihfAp4,0.5,1,1,CAGAAGTTATGGTAGAGTAG,0,1937949
ihfAp4,0.5,1,1,CAGAAACTAGGCCATACTCT,0,1953562
ihfAp4,0.5,1,1,CACTTTTAATGGCGTGACGT,0,1956865
ihfAp4,0.5,1,1,CACTTTCGAAGAGTGTATGT,0,1949863
ihfAp4,0.5,1,1,CACTTGTCCCTACCCTTGAA,0,1918240
ihfAp4,0.5,1,1,CACTTCAGCCAGATAGCGAT,0,1940940
ihfAp4,0.5,1,1,CACTTACGGGGTAGCGGCAT,0,1938000
ihfAp4,0.5,1,1,CACTCTTTGCTTTCCATGCA,0,1946284
ihfAp4,0.5,1,1,CACTCGCAGGGGAGGCATAC,0,1922500
ihfAp4,0.5,1,1,CACTAGGATGCGCGGGTTGC,0,1926443
ihfAp4,0.5,1,1,CACTACTCTCCCTCGTTCGA,0,1935915
ihfAp4,0.5,1,1,CACTAATGGATTGAGTGCTG,0,1940964
ihfAp4,0.5,1,1,CACGTAGCTTATCCCAGGTA,0,1936668
ihfAp4,0.5,1,1,CACGCTAAGTCAATTTAGCT,0,1947365
ihfAp4,0.5,1,1,CACGCAAAAGGATACATGCC,0,1913520
ihfAp4,0.5,1,1,CACGACGAAGGGACTCTGGG,0,1928502
ihfAp4,0.5,1,1,CACGACCTGTCTTGCGGGTG,0,1937638
ihfAp4,0.5,1,1,CACCTCTGAGGAGTGGTGTT,0,1942312
ihfAp4,0.5,1,1,CACCTCAGGGGGCCGCCATA,0,1909698
ihfAp4,0.5,1,1,CACCGGCAATTGACCAGCTA,0,1956976
ihfAp4,0.5,1,1,CACCGCTAGCATAGGGATAC,0,1953303
ihfAp4,0.5,1,1,CACCGAAGTGGATCTATCGA,0,1917299
ihfAp4,0.5,1,1,CACCCTTGAGTTCTCACCTA,0,1933263
ihfAp4,0.5,1,1,CACCCGTTGGCACCGGTGGG,0,1936631
ihfAp4,0.5,1,1,CACCCCTGGAGGGAGCTGCG,0,1920541
ihfAp4,0.5,1,1,CACCAGTTTAGATCCAACGC,0,1951719
ihfAp4,0.5,1,1,CACCAGGTACGTTCGTCTCC,0,1916378
ihfAp4,0.5,1,1,CACCACACAGGTGTACAGCT,0,1949564
ihfAp4,0.5,1,1,CACCAAATACGAATTTTAGG,0,1962189
ihfAp4,0.5,1,1,CACATTGCTCCTATTCAAGC,0,1916865
ihfAp4,0.5,1,1,CACATCGCAACGCACGCCCA,0,1949751
ihfAp4,0.5,1,1,CACAGGACCTTCCGGTTCAG,0,1916582
ihfAp4,0.5,1,1,CACAGAAAGTAGACCAAATT,0,1959776
ihfAp4,0.5,1,1,CACACCTGACGTCGAAGGAA,0,1950599
ihfAp4,0.5,1,1,CACACCGTGATAACGACGCG,0,1959764
ihfAp4,0.5,1,1,CACACACTTATGTCGGCTGC,0,1948426
ihfAp4,0.5,1,1,CAATTAAAGGAAAACGTTAG,0,1948449
ihfAp4,0.5,1,1,CAATGGCTGAAAGAATACAT,0,1957834
ihfAp4,0.5,1,1,CAATCTCGTCTTAGGTAAGA,0,1919335
ihfAp4,0.5,1,1,CAATCTAAGGCGAAGCGGCT,0,1926399
ihfAp4,0.5,1,1,CAATCCGATTCGGAGGTGAC,0,1918698
ihfAp4,0.5,1,1,CAATAAGATACGACATGACG,0,1943131
ihfAp4,0.5,1,1,CAAGTCTAGTTTGAGCGGTG,0,1952467
ihfAp4,0.5,1,1,CAAGTCCCCGGAGAGTAGAT,0,1938781
ihfAp4,0.5,1,1,CAAGTACGGGTTCCTGGGAA,0,1960794
ihfAp4,0.5,1,1,CAAGGTCTGGCAACCTCAAA,0,1930888
ihfAp4,0.5,1,1,CAAGGGGCGCGCACGCGCCG,0,1927228
ihfAp4,0.5,1,1,CAAGCTGTTGTAATAATAGG,0,1912442
ihfAp4,0.5,1,1,CAAGAGCCTTAAAGGTCTTG,0,1915616
ihfAp4,0.5,1,1,CAACTGTGGTCTGACTTTTT,0,1926678
ihfAp4,0.5,1,1,CAACTACGTAACTTTCAATC,0,1918597
ihfAp4,0.5,1,1,CAACTAAGCCCAAAGGGTTT,0,1919375
ihfAp4,0.5,1,1,CAACGCTTCCTAACGTGTGA,0,1917997
ihfAp4,0.5,1,1,CAACGAGTTCACAAGCTGAG,0,1926847
ihfAp4,0.5,1,1,CAACCTCGAATCCCTTTCAG,0,1945140
ihfAp4,0.5,1,1,CAACCCTGGTGGAGCCTGAG,0,1933505
ihfAp4,0.5,1,1,CAACCCCTGCGGGCGAGTTC,0,1957321
ihfAp4,0.5,1,1,CAACAGCTGGGTTCGGCTCG,0,1915937
ihfAp4,0.5,1,1,CAACACAGCGGGAGCATGAT,0,1926109
ihfAp4,0.5,1,1,CAAAGTCGTGGTTTTTGTTC,0,1919470
ihfAp4,0.5,1,1,CAAAGAGGAACAGAAACCGT,0,1957822
ihfAp4,0.5,1,1,CAAAACTCCGATTGTGTAGC,0,1956533
ihfAp4,0.5,1,1,ATTTTTGGTCAATTCGGGCT,0,1961313
ihfAp4,0.5,1,1,ATTTTGGTTACGGAACCATA,0,1922647
ihfAp4,0.5,1,1,ATTTTCAACCAGTTGCCCTA,0,1925839
ihfAp4,0.5,1,1,ATTTGCTGTGGAACGCGGTC,0,1953234
ihfAp4,0.5,1,1,ATTTGCCTTAACAGAAAGGG,0,1936349
ihfAp4,0.5,1,1,ATTTGAGAAGCGTAGTATCT,0,1916300
ihfAp4,0.5,1,1,ATTTACTAAAGAAAGCCGTA,0,1912979
ihfAp4,0.5,1,1,ATTGTACTTATTCAGATCTG,0,1944423
ihfAp4,0.5,1,1,ATTGGGTGCCTGATGCAACT,0,1958467
ihfAp4,0.5,1,1,ATTGGGAGCATGCATGAAGT,0,1948305
ihfAp4,0.5,1,1,ATTGGCCTTAAGAAAAAGAA,0,1940780
ihfAp4,0.5,1,1,ATTGATAAAGTTGCTGGTCT,0,1956440
ihfAp4,0.5,1,1,ATTGAATCCCGGTAACTAAT,0,1945755
ihfAp4,0.5,1,1,ATTCTCGCATAATCGTCACT,0,1959482
ihfAp4,0.5,1,1,ATTCTATTTACTTGTTCTCT,0,1911226
ihfAp4,0.5,1,1,ATTCGTGAAAAGAAACGCGT,0,1923619
ihfAp4,0.5,1,1,ATTCGGGGGTGTTGTCGGGC,0,1959713
ihfAp4,0.5,1,1,ATTCGCGACCAGCTCTGTCG,0,1914557
ihfAp4,0.5,1,1,ATTCGAGTTTTACCCCTTGA,0,1914794
ihfAp4,0.5,1,1,ATTCATGGTAACCGGGCGAG,0,1950205
ihfAp4,0.5,1,1,ATTCATGAAAATAGTCTAAT,0,1915859
ihfAp4,0.5,1,1,ATTCACAAGTTCTTTACTGT,0,1917995
ihfAp4,0.5,1,1,ATTCACAAGCTAGAAAGGCC,0,1923344
ihfAp4,0.5,1,1,ATTATGGGACCAGGGACTCC,0,1943790
ihfAp4,0.5,1,1,ATTATGACGCGCGGAGGGCG,0,1954543
ihfAp4,0.5,1,1,ATTATCCCCATGGATTGGAG,0,1957534
ihfAp4,0.5,1,1,ATTATCAGCATCTTATTGTG,0,1949681
ihfAp4,0.5,1,1,ATTAGTAGGCTTCCGAGCGT,0,1927367
ihfAp4,0.5,1,1,ATTAGGATCTTCCCCTCCCC,0,1944504
ihfAp4,0.5,1,1,ATTAAACGTTCACTGGGATC,0,1953285
ihfAp4,0.5,1,1,ATGTTTTTGTCGAGTCTACA,0,1917381
ihfAp4,0.5,1,1,ATGTTTGGGATCGAGTCCCA,0,1940495
ihfAp4,0.5,1,1,ATGTTTCTATGTCACTCTTT,0,1927801
ihfAp4,0.5,1,1,ATGTTCGAGCACGCATCTGG,0,1958080
ihfAp4,0.5,1,1,ATGTGTTCACCTAACCTGAC,0,1912097
ihfAp4,0.5,1,1,ATGTCTAACGTGATTCGTAA,0,1914683
ihfAp4,0.5,1,1,ATGTCGATCCGTCGTTGCAA,0,1910872
ihfAp4,0.5,1,1,ATGTCCTCGAATAATTGGTA,0,1951935
ihfAp4,0.5,1,1,ATGTCACACCGGGGGCCGGC,0,1925013
ihfAp4,0.5,1,1,ATGTAACTCTTTTCCGCACC,0,1944960
ihfAp4,0.5,1,1,ATGGTTGGTGCTCCTGACTT,0,1941029
ihfAp4,0.5,1,1,ATGGTGTCTATGTTACGGTC,0,1956238
ihfAp4,0.5,1,1,ATGGTATACATCCGGACGGC,0,1954895
ihfAp4,0.5,1,1,ATGGGTATCTATTTCGCGGC,0,1919161
ihfAp4,0.5,1,1,ATGGGGTTCCGAACGTCACT,0,1942566
ihfAp4,0.5,1,1,ATGGGCCGTGTAGCCATGAG,0,1931453
ihfAp4,0.5,1,1,ATGGGAATTAAAAGGTCGTC,0,1923792
ihfAp4,0.5,1,1,ATGGCGCTGCTACGCCATTT,0,1923916
ihfAp4,0.5,1,1,ATGGCAAGGCGGTCCTGTAA,0,1960309
ihfAp4,0.5,1,1,ATGGAGGCTTTCCGTGCGAC,0,1915436
ihfAp4,0.5,1,1,ATGGACTGTCATTGTGTGCA,0,1952785
ihfAp4,0.5,1,1,ATGGACAAACATTTGGCAAT,0,1954339
ihfAp4,0.5,1,1,ATGGAATCCTAGCAACCCAG,0,1931015
ihfAp4,0.5,1,1,ATGCTATATTGACGTTGTAG,0,1918723
ihfAp4,0.5,1,1,ATGCGCGTTCTCACGAGTAA,0,1936168
ihfAp4,0.5,1,1,ATGCGCGAAAAGATGGGAAA,0,1946837
ihfAp4,0.5,1,1,ATGCCCTTCGCACGATGAAA,0,1942687
ihfAp4,0.5,1,1,ATGCATGCTCCGAATATGAG,0,1936617
ihfAp4,0.5,1,1,ATGCAAGTCTGTATCTCCGG,0,1926476
ihfAp4,0.5,1,1,ATGATGGTTACACCCGATAT,0,1948735
ihfAp4,0.5,1,1,ATGATCTTGCTCCTTGACTT,0,1917576
ihfAp4,0.5,1,1,ATGATCCTGTCTGGCTCGGG,0,1924914
ihfAp4,0.5,1,1,ATGATCCGCAGTTAGAATGC,0,1928610
ihfAp4,0.5,1,1,ATGATAAGTCGCACAGAGCA,0,1930345
ihfAp4,0.5,1,1,ATGAGTGAAAGCGATAGGGT,0,1925225
ihfAp4,0.5,1,1,ATGAGCGCAATCGCCACTCA,0,1961914
ihfAp4,0.5,1,1,ATGACGTAGGGCCCCGCAAG,0,1915024
ihfAp4,0.5,1,1,ATGACCTCGATAATTCTTTG,0,1941164
ihfAp4,0.5,1,1,ATGAACCAGGCTGATTATCA,0,1952423
ihfAp4,0.5,1,1,ATGAACCACAAGTCCATGTC,0,1935179
ihfAp4,0.5,1,1,ATGAAATAGGTTTGCGTATT,0,1911165
ihfAp4,0.5,1,1,ATCTTTGGGAGTGCGCTTGC,0,1923991
ihfAp4,0.5,1,1,ATCTTGGTCTGGACGTCAGT,0,1930025
ihfAp4,0.5,1,1,ATCTTGCGGCAGACCCCTGG,0,1950405
ihfAp4,0.5,1,1,ATCTTAATTTTGGACCTTAT,0,1925023
ihfAp4,0.5,1,1,ATCTGGTGGGACTTGCCCGT,0,1910899
ihfAp4,0.5,1,1,ATCTGCGTATGGTAGCCTAG,0,1922350
ihfAp4,0.5,1,1,ATCTGCGGTTGTCATCCTCT,0,1950317
ihfAp4,0.5,1,1,ATCTGATGCCGAACGAGGCC,0,1958458
ihfAp4,0.5,1,1,ATCTGAGCATTGACTCAGTC,0,1941786
ihfAp4,0.5,1,1,ATCTCCCATCCGCCCGTATA,0,1947262
ihfAp4,0.5,1,1,ATCTACGCGGGGCGACTAGG,0,1961765
ihfAp4,0.5,1,1,ATCTACCCTATGAAGGCAAA,0,1937056
ihfAp4,0.5,1,1,ATCGTTACCGGGCATTGGCT,0,1925910
ihfAp4,0.5,1,1,ATCGTGCGTAAGACCGTGCC,0,1943022
ihfAp4,0.5,1,1,ATCGTACACAGCCTCTCTAT,0,1927393
ihfAp4,0.5,1,1,ATCGGGTGGTACACGGGACT,0,1924972
ihfAp4,0.5,1,1,ATCGGGTACTGAATCGCGGG,0,1937207
ihfAp4,0.5,1,1,ATCGGGGCACAACACTTAAC,0,1914256
ihfAp4,0.5,1,1,ATCGGCGTTTTCCAATATCG,0,1911798
ihfAp4,0.5,1,1,ATCGGACCTCTCTCAACCGG,0,1952228
ihfAp4,0.5,1,1,ATCGCTTAACTACGTTAATT,0,1925284
ihfAp4,0.5,1,1,ATCGCGGGTAAAGGCGAATA,0,1943844
ihfAp4,0.5,1,1,ATCGCGCTGTTAACATTTTC,0,1930553
ihfAp4,0.5,1,1,ATCGCGAGCCGGATGATACA,0,1921152
ihfAp4,0.5,1,1,ATCGCGAAATCTCATGTGAC,0,1931614
ihfAp4,0.5,1,1,ATCGATATGCGCAGCAGGAT,0,1937855
ihfAp4,0.5,1,1,ATCGAGTTGTAGTCTAAGGC,0,1954504
ihfAp4,0.5,1,1,ATCGAGGTAAACAAGCAGAC,0,1939179
ihfAp4,0.5,1,1,ATCCTGAGGTAGGAGTAGAG,0,1933495
ihfAp4,0.5,1,1,ATCCTCGTCCGATCGCCCGG,0,1956442
ihfAp4,0.5,1,1,ATCCGGCAGTCAAACGGTCC,0,1946004
ihfAp4,0.5,1,1,ATCCGCTGGGTCGATGGTGT,0,1931002
ihfAp4,0.5,1,1,ATCCGCGGCGCTGTGCCGAC,0,1912016
ihfAp4,0.5,1,1,ATCCGCCCGCATTACTGCAT,0,1919797
ihfAp4,0.5,1,1,ATCCGAGCTGGGTGACCAAC,0,1919670
ihfAp4,0.5,1,1,ATCCCGGTACTCGCCGGGGG,0,1945594
ihfAp4,0.5,1,1,ATCCCCCGGACCGTGGGTGC,0,1944008
ihfAp4,0.5,1,1,ATCCCATTTTTTAGCACGGA,0,1935096
ihfAp4,0.5,1,1,ATCAGTCGCTAGGAATGGTG,0,1935874
ihfAp4,0.5,1,1,ATCAGGATTTGCGGTGGTCA,0,1955634
ihfAp4,0.5,1,1,ATCAGCAGACCTCGGCAAAT,0,1946565
ihfAp4,0.5,1,1,ATCAGCACAAAGTTACCAAT,0,1924570
ihfAp4,0.5,1,1,ATCAATTCACAGTCAACGAG,0,1961773
ihfAp4,0.5,1,1,ATCAAATTACAGCTCCCACT,0,1920639
ihfAp4,0.5,1,1,ATATTTAACAGAATCGTCAC,0,1955226
ihfAp4,0.5,1,1,ATATTGAAGACAACGACAAA,0,1930774
ihfAp4,0.5,1,1,ATATTCCTAATGCTAATAAG,0,1926570
ihfAp4,0.5,1,1,ATATGGTGTACCGAGCTCAT,0,1938745
ihfAp4,0.5,1,1,ATATGAGTGTCTCAAGCTTA,0,1937472
ihfAp4,0.5,1,1,ATATCTATGCTATCGAGCGG,0,1910094
ihfAp4,0.5,1,1,ATATCGGAGAGCACGGATGT,0,1920985
ihfAp4,0.5,1,1,ATATCCTGAATGATTTCATT,0,1952905
ihfAp4,0.5,1,1,ATATATGAGTGACGGTCCTC,0,1950913
ihfAp4,0.5,1,1,ATATATAAACTTCCTTGGTT,0,1914056
ihfAp4,0.5,1,1,ATAGTTTGTTCTCTAACGGT,0,1958104
ihfAp4,0.5,1,1,ATAGTTGGCTAGAACTAGGC,0,1913393
ihfAp4,0.5,1,1,ATAGTGACATGGGTAACCTA,0,1949619
ihfAp4,0.5,1,1,ATAGTCTAACTTGCACAGGG,0,1959077
ihfAp4,0.5,1,1,ATAGTCCCTCGGCAAAGTTC,0,1915643
ihfAp4,0.5,1,1,ATAGCGCTGTAGCGCACCTT,0,1940565
ihfAp4,0.5,1,1,ATAGCCGGCGTGCTCTGATC,0,1933711
ihfAp4,0.5,1,1,ATAGAGCTCCGATCAAAGCC,0,1950338
ihfAp4,0.5,1,1,ATACGTTTCTTTCGATAGTC,0,1947943
ihfAp4,0.5,1,1,ATACGGTTCAAATTCAAGGA,0,1948903
ihfAp4,0.5,1,1,ATACCTTGTTTGCGTATGAA,0,1931017
ihfAp4,0.5,1,1,ATACCTGGGGTACAATATAT,0,1914104
ihfAp4,0.5,1,1,ATACCGTGTTTCAGGCAGTG,0,1930926
ihfAp4,0.5,1,1,ATACCCCGTATCCCCCGTCC,0,1956484
ihfAp4,0.5,1,1,ATACCATCCTAAAGCATAGG,0,1931470
ihfAp4,0.5,1,1,ATACATGCCTCTAGCTTACA,0,1931007
ihfAp4,0.5,1,1,ATACAGTGCCTGATTAGGAC,0,1947082
ihfAp4,0.5,1,1,ATAATTCCCTTATCATGGTT,0,1943146
ihfAp4,0.5,1,1,ATAAGATCAGTCAGCATAAC,0,1954814
ihfAp4,0.5,1,1,ATAACGTGAGTGGGGCCGGC,0,1920071
ihfAp4,0.5,1,1,ATAACGTAGAAATATCAGAT,0,1943602
ihfAp4,0.5,1,1,ATAAAGGACGATTCGTGCTT,0,1925381
ihfAp4,0.5,1,1,ATAAACGTGTGGTGCATTTG,0,1924579
ihfAp4,0.5,1,1,AGTTTTTGTACCGGTGACTC,0,1921072
ihfAp4,0.5,1,1,AGTTTGGATCTAACACCGCA,0,1943907
ihfAp4,0.5,1,1,AGTTGTTGTCCTTACTGGAT,0,1917794
ihfAp4,0.5,1,1,AGTTGCAGTGGATATCTCAG,0,1913424
ihfAp4,0.5,1,1,AGTGTTTCTTAAGGGTGATC,0,1947369
ihfAp4,0.5,1,1,AGTGTCCAAAAACGGTCTTT,0,1929127
ihfAp4,0.5,1,1,AGTGGGCTCACGTGTAGCAT,0,1957735
ihfAp4,0.5,1,1,AGTGCTCAGAGTTAGATCAG,0,1936158
ihfAp4,0.5,1,1,AGTGCGGAGCGTGCAACGCA,0,1920547
ihfAp4,0.5,1,1,AGTGCGGAGCCTTTCATCCT,0,1948480
ihfAp4,0.5,1,1,AGTGCGGAGACAACCGGACA,0,1940050
ihfAp4,0.5,1,1,AGTGCCGTGAGTTGGTAGTC,0,1959420
ihfAp4,0.5,1,1,AGTGCCCCGTAATCGGCCTC,0,1937145
ihfAp4,0.5,1,1,AGTGCCAGGTTCGACGTGTT,0,1951664
ihfAp4,0.5,1,1,AGTGCATTTATATGATGGGA,0,1936174
ihfAp4,0.5,1,1,AGTGCACTTATAGTTTCCGT,0,1918806
ihfAp4,0.5,1,1,AGTGAGACTGGGACAAATTC,0,1929221
ihfAp4,0.5,1,1,AGTCTATGGAGTGTCCTAAT,0,1914219
ihfAp4,0.5,1,1,AGTCGTTCGCTAGACTCTTT,0,1959084
ihfAp4,0.5,1,1,AGTCCCATCATAGTAGAGTA,0,1933929
ihfAp4,0.5,1,1,AGTCCATCCGACAGCCAACC,0,1950620
ihfAp4,0.5,1,1,AGTCACCGAACAGTTATATG,0,1917868
ihfAp4,0.5,1,1,AGTCAATAAGCACCTCAGAT,0,1941416
ihfAp4,0.5,1,1,AGTCAAATACCTAATTTTTT,0,1911803
ihfAp4,0.5,1,1,AGTATGATTCTGGTGCTCAG,0,1930054
ihfAp4,0.5,1,1,AGTATCTATCCCACGCTGGT,0,1917905
ihfAp4,0.5,1,1,AGTAGACGATTTAAGGGATT,0,1913257
ihfAp4,0.5,1,1,AGTACTGAAAAGCTCCTTTG,0,1952606
ihfAp4,0.5,1,1,AGTACCTGGCGTGGAGAGAG,0,1950537
ihfAp4,0.5,1,1,AGTAATTACACTGAAGGGTT,0,1940324
ihfAp4,0.5,1,1,AGTAAAGAACTGCTTCAAAT,0,1911890
ihfAp4,0.5,1,1,AGTAAACGGCACTTTCTTTC,0,1949090
ihfAp4,0.5,1,1,AGGTTAGTAATCATACGGTA,0,1926499
ihfAp4,0.5,1,1,AGGTGTGTGGCGAAATGGCC,0,1943924
ihfAp4,0.5,1,1,AGGTGTCAAGGATAGCAGCG,0,1955279
ihfAp4,0.5,1,1,AGGTGGCGGTACAAATCATC,0,1911159
ihfAp4,0.5,1,1,AGGTGATATGTATGCCATGA,0,1923918
ihfAp4,0.5,1,1,AGGTCCCTCCGGTGAAAACC,0,1943041
ihfAp4,0.5,1,1,AGGTATCCACGCTCCCATCT,0,1941960
ihfAp4,0.5,1,1,AGGTAAGTGCCGACTCTTAC,0,1918107
ihfAp4,0.5,1,1,AGGGTTTGATCAAACATTAC,0,1921433
ihfAp4,0.5,1,1,AGGGTAAATATAACGTAGTA,0,1918890
ihfAp4,0.5,1,1,AGGGGTATGAGAGCGCGTGC,0,1953074
ihfAp4,0.5,1,1,AGGGGTAGGCGATGTTACGC,0,1951147
ihfAp4,0.5,1,1,AGGGGGGAAGCAGATGTCTG,0,1920684
ihfAp4,0.5,1,1,AGGGGCTCCACTTTTGCCGC,0,1954186
ihfAp4,0.5,1,1,AGGGCGTCTTTTCCCGTAAC,0,1912985
ihfAp4,0.5,1,1,AGGGCAATGTGTAATCAGAT,0,1921048
ihfAp4,0.5,1,1,AGGGATGCCACGAGACCTTT,0,1931290
ihfAp4,0.5,1,1,AGGGAGACTGCACCGTCTCC,0,1938378
ihfAp4,0.5,1,1,AGGCTTCGCATACAAGGCAA,0,1932880
ihfAp4,0.5,1,1,AGGCTTCCGGTTGCTTGGCA,0,1912942
ihfAp4,0.5,1,1,AGGCTAGGTTACTTATAAGT,0,1959836
ihfAp4,0.5,1,1,AGGCGTCGCGACGAGGGTGC,0,1939988
ihfAp4,0.5,1,1,AGGCGGCACACACTACGGTT,0,1923724
ihfAp4,0.5,1,1,AGGCGAGGACTCATTTCCAT,0,1915999
ihfAp4,0.5,1,1,AGGCCTTCGGTACGTGCTCC,0,1954127
ihfAp4,0.5,1,1,AGGCCGGTGCGCACAAGCAG,0,1923885
ihfAp4,0.5,1,1,AGGCATCCAATGATAACCTT,0,1960637
ihfAp4,0.5,1,1,AGGCACTAACTGGGCATGTG,0,1922019
ihfAp4,0.5,1,1,AGGCACAAGCCCGTCTTTGG,0,1938316
ihfAp4,0.5,1,1,AGGATCGTTGACACTTACGT,0,1923528
ihfAp4,0.5,1,1,AGGATCAGACGCCTTCGCTT,0,1953439
ihfAp4,0.5,1,1,AGGATATATCTTTTTGAGTG,0,1936267
ihfAp4,0.5,1,1,AGGAGGGGCGGCTCGCGGTA,0,1939894
ihfAp4,0.5,1,1,AGGAGGCCCCCTAAGGACTT,0,1930004
ihfAp4,0.5,1,1,AGGAGCATCGCTGGGAACCT,0,1957809
ihfAp4,0.5,1,1,AGGAATGAGTTCACCTGTTG,0,1949578
ihfAp4,0.5,1,1,AGCTGTTGTCCGGAACTGGC,0,1916907
ihfAp4,0.5,1,1,AGCTGTTCACCCTCTCTTGG,0,1951952
ihfAp4,0.5,1,1,AGCTGACGCACCGGCTACAA,0,1927091
ihfAp4,0.5,1,1,AGCTCCGTTGCATGATGTAA,0,1921270
ihfAp4,0.5,1,1,AGCTCATACCTTACCCCTAA,0,1953173
ihfAp4,0.5,1,1,AGCTCATAATAGTCGGGAGC,0,1960474
ihfAp4,0.5,1,1,AGCTACCTCAGTAAGAATGT,0,1911669
ihfAp4,0.5,1,1,AGCGTACTATTCCATGCCCA,0,1940354
ihfAp4,0.5,1,1,AGCGGGAATGGTGTTCCTAC,0,1911155
ihfAp4,0.5,1,1,AGCGGCTCAAATAGGCAATT,0,1949077
ihfAp4,0.5,1,1,AGCGGCCGGCAAGGTCCTCT,0,1955342
ihfAp4,0.5,1,1,AGCGCGGCTCAAGACGCGTA,0,1949632
ihfAp4,0.5,1,1,AGCGCCGAAGGCACATTGTA,0,1920622
ihfAp4,0.5,1,1,AGCGCCCTGAGTCCACAACG,0,1949013
ihfAp4,0.5,1,1,AGCCTGCATACCCCATACTG,0,1921504
ihfAp4,0.5,1,1,AGCCTCAATCACGGCGTGCA,0,1951296
ihfAp4,0.5,1,1,AGCCCGCACTGCTTCTCCTC,0,1959784
ihfAp4,0.5,1,1,AGCCCCTGTGGAAGCCTCCT,0,1947875
ihfAp4,0.5,1,1,AGCCCAGGATTCATCGGGCA,0,1917200
ihfAp4,0.5,1,1,AGCCATTCGTGTCCGGCAGG,0,1938120
ihfAp4,0.5,1,1,AGCATGGACTTACGCAAGGA,0,1960648
ihfAp4,0.5,1,1,AGCATGAACCAATAGCAGTC,0,1944963
ihfAp4,0.5,1,1,AGCAGGTCCCGAGATTAGTT,0,1914363
ihfAp4,0.5,1,1,AGCAGGGGGCAGATACGCCG,0,1925779
ihfAp4,0.5,1,1,AGCAGGCGTCCCTACGTGTA,0,1934400
ihfAp4,0.5,1,1,AGATTGTTGAAGGGCATTAT,0,1955635
ihfAp4,0.5,1,1,AGATTCTGTCAGGAGTTACA,0,1920310
ihfAp4,0.5,1,1,AGATTAGAGATATGTCCCCA,0,1915290
ihfAp4,0.5,1,1,AGATGTGCTTTACCCCTTGC,0,1912986
ihfAp4,0.5,1,1,AGATGCGCAGAAACTGCGCC,0,1922867
ihfAp4,0.5,1,1,AGATGAGTCCCTGAGATAAT,0,1909848
ihfAp4,0.5,1,1,AGATCTATTTTATGTAGCTG,0,1934727
ihfAp4,0.5,1,1,AGATCCCAAAACCAGTCGAG,0,1927360
ihfAp4,0.5,1,1,AGATAGGCTTTCTAGCGCTG,0,1942732
ihfAp4,0.5,1,1,AGATAGGAGTCTAGGCACTC,0,1914115
ihfAp4,0.5,1,1,AGAGTTCTGAACAGTGCATC,0,1942984
ihfAp4,0.5,1,1,AGAGTCTGTTAAAGTGCCAT,0,1924888
ihfAp4,0.5,1,1,AGAGTCCGCGGACGTTCTTT,0,1912587
ihfAp4,0.5,1,1,AGAGGTTGGAATGATAAACA,0,1955902
ihfAp4,0.5,1,1,AGAGGCAAAATGTCGCTTCA,0,1920884
ihfAp4,0.5,1,1,AGAGCGCTCTCCGCAAGACT,0,1928792
ihfAp4,0.5,1,1,AGAGCAGAAATAAGATTAGG,0,1946352
ihfAp4,0.5,1,1,AGAGATGACCGGACCAGGTC,0,1943747
ihfAp4,0.5,1,1,AGAGACTGAACGATGTGTCC,0,1915073
ihfAp4,0.5,1,1,AGACGTCAGGGTAGTTACGG,0,1961698
ihfAp4,0.5,1,1,AGACGGATCTTGTTCAATAT,0,1950170
ihfAp4,0.5,1,1,AGACGATGGCCTCGTGCCGA,0,1944307
ihfAp4,0.5,1,1,AGACGAGAGGTCAAGTACGG,0,1951718
ihfAp4,0.5,1,1,AGACATAGAATGAGCTAGGA,0,1923038
ihfAp4,0.5,1,1,AGAAGGGCTCAAACGCTAGG,0,1927638
ihfAp4,0.5,1,1,AGAAGGACCCTGTTGAGGAA,0,1926860
ihfAp4,0.5,1,1,AGAACGCCGTTGAGATACCA,0,1943145
ihfAp4,0.5,1,1,AGAACGAACAAGTCCTCAGT,0,1912157
ihfAp4,0.5,1,1,AGAAATGGTGGCTCAGATTT,0,1943923
ihfAp4,0.5,1,1,AGAAAAATGAACCTTGACCT,0,1922768
ihfAp4,0.5,1,1,ACTTTTTCGTGGACCAACAA,0,1961867
ihfAp4,0.5,1,1,ACTTTTCTCCGAGTGAGTGT,0,1947805
ihfAp4,0.5,1,1,ACTTTTACGCAGGCTTAAAT,0,1932954
ihfAp4,0.5,1,1,ACTTTAGCCCGTAACGACAG,0,1917086
ihfAp4,0.5,1,1,ACTTGTGGCGCACTTCCTTA,0,1934855
ihfAp4,0.5,1,1,ACTTCTAAACGCTAGTCATG,0,1929488
ihfAp4,0.5,1,1,ACTTCATCCACGTGCCACAC,0,1946422
ihfAp4,0.5,1,1,ACTTATGAGAGCCACGTACA,0,1948709
ihfAp4,0.5,1,1,ACTTAGGTCCTTCGGACATA,0,1955178
ihfAp4,0.5,1,1,ACTTACAGTTCCAGTATCCA,0,1927621
ihfAp4,0.5,1,1,ACTGTTCTGTGGACTTGCGG,0,1933792
ihfAp4,0.5,1,1,ACTGGTTTTCAGTTCTTCAG,0,1961592
ihfAp4,0.5,1,1,ACTGGGGTTCACGTGAGGAG,0,1916753
ihfAp4,0.5,1,1,ACTGGAATATTAGGTTCGAG,0,1941331
ihfAp4,0.5,1,1,ACTGCTTCGATTTTGAGCCT,0,1921970
ihfAp4,0.5,1,1,ACTGCTGCTTGGGGATCCAC,0,1955631
ihfAp4,0.5,1,1,ACTGCTAAACTACGCGGGCG,0,1960604
ihfAp4,0.5,1,1,ACTGCATAATGTGAGCGAAA,0,1945249
ihfAp4,0.5,1,1,ACTGCAGATCAACCCACGAT,0,1922571
ihfAp4,0.5,1,1,ACTGATCATTAGAGTCATTC,0,1955145
ihfAp4,0.5,1,1,ACTGAGGAGACTGCTTTATT,0,1954238
ihfAp4,0.5,1,1,ACTGACCTCAACTCTCGTTA,0,1916746
ihfAp4,0.5,1,1,ACTCTTGTCAGAAATAGGCG,0,1950597
ihfAp4,0.5,1,1,ACTCTTCGACCTAACCGCGA,0,1954324
ihfAp4,0.5,1,1,ACTCTATCAGTACGTCAGAC,0,1931032
ihfAp4,0.5,1,1,ACTCGGGCTACACCAGACGA,0,1912378
ihfAp4,0.5,1,1,ACTCGCCGTCAAACGCGTAT,0,1928561
ihfAp4,0.5,1,1,ACTCGAGGGTAGGATTGTGA,0,1944684
ihfAp4,0.5,1,1,ACTCGACGGACACATTACTC,0,1942359
ihfAp4,0.5,1,1,ACTCCTCCTCTTAAGGAGCC,0,1923165
ihfAp4,0.5,1,1,ACTCCGTGGGCTATCAATTG,0,1945107
ihfAp4,0.5,1,1,ACTCCAGCGGCTTCGTCCGT,0,1927115
ihfAp4,0.5,1,1,ACTCAGCAGCACTCAGGGTT,0,1918640
ihfAp4,0.5,1,1,ACTCAACGCAAAGATAGGGG,0,1914070
ihfAp4,0.5,1,1,ACTCAACACCTATACTTTTC,0,1912649
ihfAp4,0.5,1,1,ACTATTACGAGCGTTGTATA,0,1940322
ihfAp4,0.5,1,1,ACTATGCCGCAGAACTTGAA,0,1936517
ihfAp4,0.5,1,1,ACTATCGGGTGTAACATAGT,0,1927320
ihfAp4,0.5,1,1,ACTAGTTGACCGCAACCCTG,0,1952419
ihfAp4,0.5,1,1,ACTAGGGGTCACAGCCATTT,0,1911302
ihfAp4,0.5,1,1,ACTAGCCCGGCAGCTTGGGA,0,1946411
ihfAp4,0.5,1,1,ACTAGCCCCGAAGACCGGAA,0,1911947
ihfAp4,0.5,1,1,ACTAGATAGCATGCTATGCA,0,1915669
ihfAp4,0.5,1,1,ACTAGAGTCTTTTAGGCCGT,0,1938157
ihfAp4,0.5,1,1,ACTAGAGGGTCGTGAGCGGG,0,1920896
ihfAp4,0.5,1,1,ACTAATCAGTGTTATGGTTC,0,1960421
ihfAp4,0.5,1,1,ACGTTCTGTGACGCTGGAGT,0,1955838
ihfAp4,0.5,1,1,ACGTTATGGCGGGTTGGTAG,0,1915546
ihfAp4,0.5,1,1,ACGTGTGAAGCGGCCAAATT,0,1918646
ihfAp4,0.5,1,1,ACGTGATAAGAGCTCTGATT,0,1935281
ihfAp4,0.5,1,1,ACGTCGGGAGTGCATCACGA,0,1950347
ihfAp4,0.5,1,1,ACGTCCTAAGGTGAATACGG,0,1931897
ihfAp4,0.5,1,1,ACGTCCAAATTCAATAAGTG,0,1959553
ihfAp4,0.5,1,1,ACGTATCAATAGCCTGGGCT,0,1936921
ihfAp4,0.5,1,1,ACGTAAGGCTGTCCCGGGGT,0,1922910
ihfAp4,0.5,1,1,ACGGTACACATCTCGTAGCT,0,1933859
ihfAp4,0.5,1,1,ACGGGCCGCGCCTCACCTTA,0,1935100
ihfAp4,0.5,1,1,ACGGGACAGAGGACAGCTTG,0,1941911
ihfAp4,0.5,1,1,ACGGCTCCAGGCCTCGCATG,0,1951499
ihfAp4,0.5,1,1,ACGGCGTAATGTTCCCTCAC,0,1948123
ihfAp4,0.5,1,1,ACGGCATGACGTCTCTCAAA,0,1932716
ihfAp4,0.5,1,1,ACGGAGACGCGTTCCCTCCA,0,1930828
ihfAp4,0.5,1,1,ACGGAATGGACCCTAAATAT,0,1953965
ihfAp4,0.5,1,1,ACGCTCGTCAGACCGGTTAT,0,1930523
ihfAp4,0.5,1,1,ACGCTACAGCATACTCCCCA,0,1939111
ihfAp4,0.5,1,1,ACGCGTTCGCAGTACCCACT,0,1944196
ihfAp4,0.5,1,1,ACGCGTCCGTAGGTCAGCCA,0,1912159
ihfAp4,0.5,1,1,ACGCGGTAATATTCCACCCA,0,1953858
ihfAp4,0.5,1,1,ACGCGGCAAAAATGACGAGG,0,1936400
ihfAp4,0.5,1,1,ACGCCTTGACGGGCCCACAA,0,1934312
ihfAp4,0.5,1,1,ACGCCTACTCGACACATGGA,0,1932471
ihfAp4,0.5,1,1,ACGCCGACGTGCGAAGAGGC,0,1956182
ihfAp4,0.5,1,1,ACGCCCTTATAGCAGGGGAG,0,1918977
ihfAp4,0.5,1,1,ACGCCATCAGACATTTTAAA,0,1951987
ihfAp4,0.5,1,1,ACGCATTCATATCAACTCTA,0,1930678
ihfAp4,0.5,1,1,ACGCAGGGTTATGCGATAGA,0,1961591
ihfAp4,0.5,1,1,ACGCACCCCTCCTCGGCAGC,0,1922343
ihfAp4,0.5,1,1,ACGCAAGGGGCATCCCAGGA,0,1941906
ihfAp4,0.5,1,1,ACGATCCACCACCAGTCTTT,0,1925021
ihfAp4,0.5,1,1,ACGATATATGAGCTCGCTTA,0,1922301
ihfAp4,0.5,1,1,ACGATAGTCCTAGAAACAAT,0,1936884
ihfAp4,0.5,1,1,ACGAGGGGCTGGTCATGACC,0,1926760
ihfAp4,0.5,1,1,ACGAGGCCTTATGAAGTGAT,0,1947359
ihfAp4,0.5,1,1,ACGAGCTGCAACTAGCGATT,0,1910969
ihfAp4,0.5,1,1,ACGAGACACTACCGACCAAC,0,1915291
ihfAp4,0.5,1,1,ACGACCCATGCGCCCAGACA,0,1937873
ihfAp4,0.5,1,1,ACGACATTCAAACCGGACTA,0,1927907
ihfAp4,0.5,1,1,ACGAACCCCCACCACGGGAT,0,1954147
ihfAp4,0.5,1,1,ACGAAAGGGGGTCATCAGCT,0,1943141
ihfAp4,0.5,1,1,ACCTGCCTTGAACCTGATTC,0,1937345
ihfAp4,0.5,1,1,ACCTGAGGATGGTGTTGAGG,0,1949680
ihfAp4,0.5,1,1,ACCTCCGATAGAGCACTGGC,0,1935021
ihfAp4,0.5,1,1,ACCTCCAGGAGATTGTCCTG,0,1910921
ihfAp4,0.5,1,1,ACCTCATTACTGGGGTACGA,0,1959936
ihfAp4,0.5,1,1,ACCTCATCCGGTCCTCTAAT,0,1943742
ihfAp4,0.5,1,1,ACCTATGCTATCGGTATACT,0,1955000
ihfAp4,0.5,1,1,ACCTACCACGTCAGGTCAGG,0,1928191
ihfAp4,0.5,1,1,ACCTAAGCGCGCTGTACGCC,0,1927883
ihfAp4,0.5,1,1,ACCGTTTCAAAGGGAAACCC,0,1956808
ihfAp4,0.5,1,1,ACCGTCCTGATTTTCGCTGA,0,1920770
ihfAp4,0.5,1,1,ACCGGGCGAGTGTCCGGACG,0,1953284
ihfAp4,0.5,1,1,ACCGGGCAATAGCTGGATAA,0,1938942
ihfAp4,0.5,1,1,ACCGGCGCATGCCACAAATT,0,1929821
ihfAp4,0.5,1,1,ACCGGCCCATATTTGGGAGT,0,1954340
ihfAp4,0.5,1,1,ACCGCTACAGTGCCAGTTTC,0,1913450
ihfAp4,0.5,1,1,ACCGCTAACATCACGTCAGT,0,1949589
ihfAp4,0.5,1,1,ACCGATATAACTCAGGGAAA,0,1910072
ihfAp4,0.5,1,1,ACCCGTATAAAGTCCGAGTA,0,1939498
ihfAp4,0.5,1,1,ACCCCAGGTGAATGTCAGCT,0,1948544
ihfAp4,0.5,1,1,ACCCATGGTACTTGGCAGGG,0,1957194
ihfAp4,0.5,1,1,ACCCAGGAGACATTAAACAC,0,1931085
ihfAp4,0.5,1,1,ACCCACGCTCTGGGTACTCT,0,1922891
ihfAp4,0.5,1,1,ACCCAATTTCATTGGTTACA,0,1918642
ihfAp4,0.5,1,1,ACCATTACTCGAGATGTAAT,0,1914577
ihfAp4,0.5,1,1,ACCAGTGCGTATTCCATTTT,0,1952349
ihfAp4,0.5,1,1,ACCAGGTACGAATGTCGCGG,0,1936355
ihfAp4,0.5,1,1,ACCAGGCTTATCATCTGGTT,0,1953628
ihfAp4,0.5,1,1,ACCACGTTGCTGTGGGAAGA,0,1914427
ihfAp4,0.5,1,1,ACCAATAGTAAAATGCGTTT,0,1940345
ihfAp4,0.5,1,1,ACCAAGCTCGACTAGGACAC,0,1920291
ihfAp4,0.5,1,1,ACCAAATTTTTTCAATCTTC,0,1919350
ihfAp4,0.5,1,1,ACATTGGGGTATGGTAGTCA,0,1942487
ihfAp4,0.5,1,1,ACATGTACCGCAGATAGGGG,0,1932106
ihfAp4,0.5,1,1,ACATGGTACAACGGGTCGAA,0,1932179
ihfAp4,0.5,1,1,ACATGGGGAAATGATCTTTG,0,1957939
ihfAp4,0.5,1,1,ACATGGCTAAATTGCAGCTT,0,1953124
ihfAp4,0.5,1,1,ACATGGATATGATCTCGGCT,0,1949736
ihfAp4,0.5,1,1,ACATGCTTTTAGAAACTTGT,0,1960667
ihfAp4,0.5,1,1,ACATGCACAATGTCAGCATT,0,1914269
ihfAp4,0.5,1,1,ACATGATCCAAAGGTTATGT,0,1914460
ihfAp4,0.5,1,1,ACATCTCGCATTGGGCACTT,0,1924565
ihfAp4,0.5,1,1,ACATCCACCCTCTGACCGGC,0,1910960
ihfAp4,0.5,1,1,ACAGTTCACCAGCGCCCTCA,0,1959159
ihfAp4,0.5,1,1,ACAGTAACTGGCGGTGCACT,0,1912708
ihfAp4,0.5,1,1,ACAGTAACAACAGAGTCACA,0,1950500
ihfAp4,0.5,1,1,ACAGGGGAGTTTAATTCACA,0,1941134
ihfAp4,0.5,1,1,ACAGCGACATGCAAGGAAGA,0,1949453
ihfAp4,0.5,1,1,ACAGCCAGTAGACTCTGGTC,0,1938766
ihfAp4,0.5,1,1,ACAGCACAAAGATGACCATA,0,1945470
ihfAp4,0.5,1,1,ACAGACGGAAGAGGAATTGT,0,1921143
ihfAp4,0.5,1,1,ACACTTGAGGGCGGCTCATC,0,1950937
ihfAp4,0.5,1,1,ACACGCACCTGCCCTTTATG,0,1923826
ihfAp4,0.5,1,1,ACACGAGTGAACCCCGTTTT,0,1923943
ihfAp4,0.5,1,1,ACACCTAAGTCCATGACCCA,0,1921103
ihfAp4,0.5,1,1,ACACCGTGTCCTAACGGTGT,0,1925338
ihfAp4,0.5,1,1,ACACACTGTAGATGGCCTGG,0,1921210
ihfAp4,0.5,1,1,ACACAATCGCTGTCACCTTG,0,1923815
ihfAp4,0.5,1,1,ACACAAGGGTCCTACGAAGA,0,1952833
ihfAp4,0.5,1,1,ACACAAAATAACTTCGATTA,0,1933134
ihfAp4,0.5,1,1,ACAATTGGCTGATTTGGCCA,0,1913878
ihfAp4,0.5,1,1,ACAATTCTTAGTCTTTCAGT,0,1936479
ihfAp4,0.5,1,1,ACAATACTATGTCTGGCATC,0,1922928
ihfAp4,0.5,1,1,ACAAGTTCATGAGGATGCTG,0,1935537
ihfAp4,0.5,1,1,ACAAGGGTTAGCGGATTGGT,0,1953575
ihfAp4,0.5,1,1,ACAAGGGGGATCGTGCCATT,0,1961126
ihfAp4,0.5,1,1,ACAACAAGTGTGGAGCACCA,0,1944590
ihfAp4,0.5,1,1,ACAAAGTGGGGCAGCGGGCG,0,1910817
ihfAp4,0.5,1,1,ACAAAGGTTGCCTCATATGG,0,1954565
ihfAp4,0.5,1,1,AATTTGCCTCTACTATTAAC,0,1940237
ihfAp4,0.5,1,1,AATTTAGATCAGCAAAAAGA,0,1923958
ihfAp4,0.5,1,1,AATTGGCCATCACGAGATTG,0,1959002
ihfAp4,0.5,1,1,AATTGACGCGGCCCATGATA,0,1938286
ihfAp4,0.5,1,1,AATTCTTCGGCGGGCGTTGC,0,1928033
ihfAp4,0.5,1,1,AATTCGCATGAAACTGGTAC,0,1916305
ihfAp4,0.5,1,1,AATTCCATTACCTGGCCAAA,0,1933476
ihfAp4,0.5,1,1,AATTCACCCCATATTGATTA,0,1932282
ihfAp4,0.5,1,1,AATTAGCTAGGCCGCCAAAT,0,1920905
ihfAp4,0.5,1,1,AATTAATAGTCGTCGGAGGA,0,1917824
ihfAp4,0.5,1,1,AATGTTGAACGAGTTGTTCC,0,1945843
ihfAp4,0.5,1,1,AATGTTACTTCGGGTAACAA,0,1955843
ihfAp4,0.5,1,1,AATGTCCCTCACATAGACAC,0,1942684
ihfAp4,0.5,1,1,AATGTAGGCACATAGAGATG,0,1925456
ihfAp4,0.5,1,1,AATGGTGTGATCGGTTTTGG,0,1953823
ihfAp4,0.5,1,1,AATGGCACACCTTGACCACA,0,1935082
ihfAp4,0.5,1,1,AATGCGCCATCGCTCTGGTA,0,1957012
ihfAp4,0.5,1,1,AATGATTCCTGGGTCTAAGT,0,1930721
ihfAp4,0.5,1,1,AATGAGGTCGTTAGCAATGG,0,1926804
ihfAp4,0.5,1,1,AATGACAACTTAAACGATCC,0,1958070
ihfAp4,0.5,1,1,AATGAAGAACAGACACTTAG,0,1948488
ihfAp4,0.5,1,1,AATGAACGGCCTATTTTCAC,0,1927626
ihfAp4,0.5,1,1,AATCTTGCACCGTCCCTCCT,0,1943398
ihfAp4,0.5,1,1,AATCTGACTGAGGGCCTTTC,0,1953099
ihfAp4,0.5,1,1,AATCGGAGTAGCGTGATAAG,0,1958564
ihfAp4,0.5,1,1,AATCGCTGCGATTGGCACGA,0,1920413
ihfAp4,0.5,1,1,AATCGCCCAGTGATGCAGAA,0,1952515
ihfAp4,0.5,1,1,AATCCCGCTCCTCACTCGGC,0,1950879
ihfAp4,0.5,1,1,AATCCCATGGCCCATATTTA,0,1951957
ihfAp4,0.5,1,1,AATCAGTCGTCATCAGCCCA,0,1954425
ihfAp4,0.5,1,1,AATCAAGGGGATTATAGTCG,0,1924019
ihfAp4,0.5,1,1,AATATGTACACTCTCATAGT,0,1931000
ihfAp4,0.5,1,1,AATATCGTACCGAGTTCTGG,0,1914926
ihfAp4,0.5,1,1,AATATCCTGTGGGTGAACGG,0,1926897
ihfAp4,0.5,1,1,AATATACGGTACGGGTCATT,0,1914890
ihfAp4,0.5,1,1,AATATAAGGGTGACATTACT,0,1941994
ihfAp4,0.5,1,1,AATAGTAGGCAGCCGGACTT,0,1933099
ihfAp4,0.5,1,1,AATAGCGGCGATCCCTCTAT,0,1939561
ihfAp4,0.5,1,1,AATAGACACCGCAGGTACCA,0,1916891
ihfAp4,0.5,1,1,AATACCAGGAGCCGTCAACG,0,1917377
ihfAp4,0.5,1,1,AATAATGTGCGCTAGTCCCC,0,1921523
ihfAp4,0.5,1,1,AAGTTGGTGCGGATTTGTCC,0,1930671
ihfAp4,0.5,1,1,AAGTTGCCGATTTATAACAT,0,1948518
ihfAp4,0.5,1,1,AAGTTAGGTCTGGGCGAGAT,0,1940530
ihfAp4,0.5,1,1,AAGTTAAGGATTTGGTCATG,0,1923917
ihfAp4,0.5,1,1,AAGTGTCTGCATTGTTTTTT,0,1947629
ihfAp4,0.5,1,1,AAGTGCAGCACTACGTTGGG,0,1915424
ihfAp4,0.5,1,1,AAGTGATTCGTGGCGGTTCT,0,1939853
ihfAp4,0.5,1,1,AAGTCTCATACTGTTAAGTA,0,1920565
ihfAp4,0.5,1,1,AAGTCACGAGCTATAATATT,0,1928042
ihfAp4,0.5,1,1,AAGTATGAGTTACCGAAAAG,0,1922528
ihfAp4,0.5,1,1,AAGTAGCCGATGAAGGGTAC,0,1916606
ihfAp4,0.5,1,1,AAGTACATCCGCCGTTAGCC,0,1913492
ihfAp4,0.5,1,1,AAGTAATTCTTCACAGGCGT,0,1913244
ihfAp4,0.5,1,1,AAGTAAATTGCTACATGGTA,0,1959477
ihfAp4,0.5,1,1,AAGGTTGAGTTGTGTTCGGT,0,1911704
ihfAp4,0.5,1,1,AAGGTGCGTGGGTTTTAGGA,0,1920795
ihfAp4,0.5,1,1,AAGGTCTGAAGTAGTCCCAC,0,1928406
ihfAp4,0.5,1,1,AAGGTAGTGGTCAGTTGGAG,0,1935319
ihfAp4,0.5,1,1,AAGGTAAAGTGGGGCAGACC,0,1953749
ihfAp4,0.5,1,1,AAGGCCAACAGGATTAAACC,0,1953875
ihfAp4,0.5,1,1,AAGGACACTCGTTGGGGGTC,0,1961341
ihfAp4,0.5,1,1,AAGCGGTTCCCCGTCCTGGG,0,1961329
ihfAp4,0.5,1,1,AAGCCTGGTTAACCAGGAGC,0,1943817
ihfAp4,0.5,1,1,AAGCCCCTGTCAAGGAGGTA,0,1941862
ihfAp4,0.5,1,1,AAGCACATCCTCTAAGTGTT,0,1932925
ihfAp4,0.5,1,1,AAGCAAGGAGCTTTCAAACT,0,1938888
ihfAp4,0.5,1,1,AAGCAACTTCCTTAAAACGC,0,1957533
ihfAp4,0.5,1,1,AAGATTGGGGTGTTTTCTAA,0,1920135
ihfAp4,0.5,1,1,AAGAGCCTTTATCATCCGAT,0,1930056
ihfAp4,0.5,1,1,AAGAGCACCTTATTTGTGTT,0,1958266
ihfAp4,0.5,1,1,AAGAGATCCGCGTGGTACGG,0,1933557
ihfAp4,0.5,1,1,AAGACTTTTCCGCCCACGTA,0,1909746
ihfAp4,0.5,1,1,AAGACCCGGAGAGGGTCTTA,0,1938620
ihfAp4,0.5,1,1,AAGAATAAGGCACCAATTGC,0,1934313
ihfAp4,0.5,1,1,AACTGTATCATAGAACTTCA,0,1926672
ihfAp4,0.5,1,1,AACTGCCGGTGAGCAGGTGT,0,1927913
ihfAp4,0.5,1,1,AACTCTGGCAATGTTAAGGG,0,1930785
ihfAp4,0.5,1,1,AACTCTACAGATTATGTAAG,0,1920988
ihfAp4,0.5,1,1,AACTCGCGGGGCTACATGTC,0,1934361
ihfAp4,0.5,1,1,AACTAAGGATCTTTTACTAA,0,1938140
ihfAp4,0.5,1,1,AACGTGCCGATTCGTAGGCT,0,1960657
ihfAp4,0.5,1,1,AACGTATAGGATGCCACATG,0,1950167
ihfAp4,0.5,1,1,AACGGCATCGGCAGCTGCAG,0,1931344
ihfAp4,0.5,1,1,AACGGAAATGCGAGCAGGGT,0,1955762
ihfAp4,0.5,1,1,AACGCGGGGGGCAAGCCGGA,0,1915340
ihfAp4,0.5,1,1,AACGCGCGGAATTGCAAAGG,0,1952466
ihfAp4,0.5,1,1,AACGATTTTTGCGCGTCGCT,0,1933300
ihfAp4,0.5,1,1,AACGATAATATCCAGACAAA,0,1953843
ihfAp4,0.5,1,1,AACGAAGTGCACATCGCCAT,0,1924828
ihfAp4,0.5,1,1,AACCGTTCTCTTGTGTTATC,0,1936746
ihfAp4,0.5,1,1,AACCGGTTATACCCATCATC,0,1959292
ihfAp4,0.5,1,1,AACCGGGCGCAGAGAATGTC,0,1961235
ihfAp4,0.5,1,1,AACCGCGGGTTGATGGCGTC,0,1927485
ihfAp4,0.5,1,1,AACCGACCACATACCGAATC,0,1930453
ihfAp4,0.5,1,1,AACCCGTGCTTCACACACTT,0,1940850
ihfAp4,0.5,1,1,AACCCATAATTAACCCCCCT,0,1948306
ihfAp4,0.5,1,1,AACCACAACATTAGTCTACG,0,1930836
ihfAp4,0.5,1,1,AACATCCGTTTATTTGAACG,0,1958293
ihfAp4,0.5,1,1,AACATATTGTCAGAATGTGA,0,1925528
ihfAp4,0.5,1,1,AACACGCGCGCACTTCACGT,0,1938197
ihfAp4,0.5,1,1,AACAACAGGGTCACATATGT,0,1941755
ihfAp4,0.5,1,1,AACAACACGACTGGCGGGCA,0,1945028
ihfAp4,0.5,1,1,AAATGTTCGCATCTTTTAAG,0,1910005
ihfAp4,0.5,1,1,AAATCGTTATAAAAATTACT,0,1957800
ihfAp4,0.5,1,1,AAATCGAGGAAGGATTAAGA,0,1921507
ihfAp4,0.5,1,1,AAATCCTAGGATGGCGATAG,0,1918481
ihfAp4,0.5,1,1,AAATAGTAATCATATTCTGG,0,1952104
ihfAp4,0.5,1,1,AAATAGCGCGTCATTAGTGG,0,1925182
ihfAp4,0.5,1,1,AAAGTTCGTGAGGGTTTGGA,0,1959962
ihfAp4,0.5,1,1,AAAGTTAAAGGCAAATCCCC,0,1955612
ihfAp4,0.5,1,1,AAAGTAAGCTTGTCCGAAGC,0,1929880
ihfAp4,0.5,1,1,AAAGGGACAGAGCTGCTAGA,0,1934379
ihfAp4,0.5,1,1,AAAGACCGAACGCGAAATGT,0,1911467
ihfAp4,0.5,1,1,AAAGAAGGTGTGTATACTAC,0,1942221
ihfAp4,0.5,1,1,AAACTCGTAGCCCATTCAGA,0,1950039
ihfAp4,0.5,1,1,AAACGTCCTGGTGTTGAGGG,0,1961412
ihfAp4,0.5,1,1,AAACGGTTTATCGGGCTCCG,0,1955341
ihfAp4,0.5,1,1,AAACGGTTCGTGTTAATCAC,0,1954677
ihfAp4,0.5,1,1,AAACGCCATATAATCCACGC,0,1939387
ihfAp4,0.5,1,1,AAACGCAAGCTGCTTGCCTT,0,1918111
ihfAp4,0.5,1,1,AAACGAAACTGATCTGTCAG,0,1912592
ihfAp4,0.5,1,1,AAACCCCAGGGCAGAGAGTT,0,1912544
ihfAp4,0.5,1,1,AAACCATGCGGCGGGTCTAC,0,1949348
ihfAp4,0.5,1,1,AAACAACCGATAATATCCTG,0,1948196
ihfAp4,0.5,1,1,AAAAGGCGTAGCAACAGGTG,0,1928600
ihfAp4,0.5,1,1,AAAAGCTTTCATGCGGGGCT,0,1915000
ihfAp4,0.5,1,1,AAAAGCGGCAACCATCATTC,0,1953984
ihfAp4,0.5,1,1,AAAACCGGATGTAATTGCTA,0,1925439
ihfAp4,0.5,1,1,AAAAATTTGTTCGGCTCTAT,0,1955991
ihfAp4,0.5,1,1,AAAAATCTCTAGACTGGCTT,0,1959342
ihfAp4,0.5,1,1,AAAAAGCCGAATGAGATTGT,0,1941407
ihfAp4,119.0,118,0,ACGTCTGAGCAGGCACTAGC,118,1912333
ihfAp4,94.0,93,0,GAAGTGCGGAGGCGCGAACC,93,1921404
ihfAp4,91.0,90,0,ACCCACCTGAGTTAAGGGTC,90,1960668
ihfAp4,78.0,77,0,GTAGATCTTTATCCGATGTA,77,1958787
ihfAp4,74.0,73,0,CCCTTAACGCACCCCCCCTG,73,1930674
ihfAp4,69.0,68,0,TGTTGTGCCTGGATATCGTG,68,1961020
ihfAp4,69.0,68,0,AATTCTCATAACGGCGTATG,68,1958328
ihfAp4,66.0,65,0,TTTCCGGCCGAATACACCGG,65,1946149
ihfAp4,63.0,62,0,TACTTTTTGTGAGGCATGTG,62,1934839
ihfAp4,63.0,62,0,ATATAAGTCTCGGTCGGGCA,62,1956296
ihfAp4,62.0,61,0,TTCCTCGAGTGCGTTACATC,61,1913552
ihfAp4,62.0,61,0,GAATAGGCAGTTTCATAACG,61,1953499
ihfAp4,55.0,54,0,GACGTAAACTCCTCGTCATA,54,1943251
ihfAp4,54.0,53,0,CCTCCTGTAGACCCGTGAAT,53,1939956
ihfAp4,54.0,53,0,AGATGACTCCATTGATTGCT,53,1915537
ihfAp4,52.0,51,0,CGGCCAGTCGTGCGCACAGG,51,1928398
ihfAp4,51.0,50,0,ACCAAATTTACCTCGTTCGA,50,1958207
ihfAp4,50.0,49,0,TTAGTCGAGCCCTATTTCCA,49,1921942
ihfAp4,50.0,49,0,GAGTCTTACTTTGGCATTCA,49,1926080
ihfAp4,50.0,49,0,CAGCGCAGGCCAGTGCTGGC,49,1956719
ihfAp4,49.0,48,0,CTACATGAACTGCTGGACCA,48,1940129
ihfAp4,49.0,48,0,CCGGATATTACCTTCCCGGG,48,1921444
ihfAp4,48.0,47,0,GATGCAGTCTGATCTGGCCT,47,1928127
ihfAp4,47.0,46,0,GCACGGTTGACACCTGTCGG,46,1920176
ihfAp4,47.0,46,0,CACTATGGACAAGGCCAGCT,46,1932627
ihfAp4,46.0,45,0,TTGCGTCATACACATCCCCT,45,1915668
ihfAp4,46.0,45,0,AGGGCCGAAGGGGCGCCAGT,45,1948229
ihfAp4,45.0,44,0,TGACAGAGACCCTACTTGGA,44,1949497
ihfAp4,45.0,44,0,TATGTAAGGACCGGGCAATG,44,1952318
ihfAp4,45.0,44,0,ACAATCGTTTGATGATTGGT,44,1962106
ihfAp4,44.0,43,0,TTGATTGAGCTAACGCCGCA,43,1912809
ihfAp4,44.0,43,0,TACTCAACTCGAACATCGGA,43,1919876
ihfAp4,44.0,43,0,GCTCGCGAAGTCAACTGCTA,43,1958434
ihfAp4,44.0,43,0,CGGCATGGTACAAACCAAGA,43,1923197
ihfAp4,44.0,43,0,CCGTGAGCTCCCCAAATCAT,43,1928514
ihfAp4,44.0,43,0,AAATTGAAGTCTGATGTACT,43,1937677
ihfAp4,43.0,42,0,TAGACCTACTAAGTGGGTTC,42,1910609
ihfAp4,43.0,42,0,TAAGTACGGATCTCGAGGTA,42,1960470
ihfAp4,42.0,41,0,ACGATTTTAATTAAGTTCTA,41,1929546
ihfAp4,42.0,41,0,AAATCAAACGGTACGTTGTA,41,1955094
ihfAp4,41.0,40,0,TTAAATGGACCCCACTTTCG,40,1949256
ihfAp4,41.0,40,0,GCGACCGCAATGATGAAGGC,40,1923415
ihfAp4,41.0,40,0,GATATTATATGCCGAAACTG,40,1962112
ihfAp4,41.0,40,0,CATGTCGAGCGCGAGCAGCT,40,1912989
ihfAp4,41.0,40,0,ACAGGGTATACGCTGTGTCC,40,1944724
ihfAp4,40.0,39,0,TTGAAAATTTCACTCAGGAT,39,1961520
ihfAp4,39.0,38,0,CGTACCTGCGTACCCAGTTA,38,1931564
ihfAp4,39.0,38,0,CGGAACTCTAGAAGGTTATC,38,1919879
ihfAp4,39.0,38,0,AATAGGGTCAAGGCTCTGAT,38,1922949
ihfAp4,38.0,37,0,TCAGCAGCAAAGGCCTCTAA,37,1934328
ihfAp4,38.0,37,0,TAGAATTAAGTATCAGGCTG,37,1930141
ihfAp4,38.0,37,0,GTGCCATTGAAAGAAGATCC,37,1928550
ihfAp4,38.0,37,0,GTAACGCATATTAGGGAGAA,37,1914431
ihfAp4,38.0,37,0,GTAAAAGTAGCTCGAATTAA,37,1912804
ihfAp4,38.0,37,0,GATGTTGCATGGACCGCGTA,37,1959708
ihfAp4,38.0,37,0,ACTTGGGGATAACTCAGGTG,37,1929066
ihfAp4,37.0,36,0,TCAATGGGCATGCTAAGTGT,36,1958202
ihfAp4,37.0,36,0,CATGCCATCGGTTCCGGGGT,36,1943967
ihfAp4,37.0,36,0,ATGTGATTTCGATAGTCTTT,36,1951572
ihfAp4,37.0,36,0,ACTCCAGCTTATTGCCCCAC,36,1953717
ihfAp4,36.0,35,0,GTCCGTATCCTACCATCACA,35,1936817
ihfAp4,36.0,35,0,GGCCAGTTGAAGGGGATCCA,35,1934071
ihfAp4,36.0,35,0,GGATTATGATTTGCGACTTT,35,1940904
ihfAp4,36.0,35,0,GCGAGATGGCGCCCCCGATT,35,1909634
ihfAp4,36.0,35,0,CCACTCGTTTACGTGCACGT,35,1916167
ihfAp4,36.0,35,0,CAGGGACGGGGGTGTCTGAA,35,1923543
ihfAp4,36.0,35,0,CAGAGGGCCACCCCCAGGAC,35,1939036
ihfAp4,36.0,35,0,CAATTTCGGTTAAATCGAGT,35,1937642
ihfAp4,36.0,35,0,ATGTAGTGGGACTGCCTGGT,35,1930161
ihfAp4,36.0,35,0,AGGAGTAAACGCACGCGCGG,35,1939966
ihfAp4,35.0,34,0,TCGTTACTATCATGGAACCC,34,1922743
ihfAp4,35.0,34,0,GTGTATTGGTTGGATCGGCA,34,1936810
ihfAp4,35.0,34,0,GTCTGACACTTTTAATTTTA,34,1943980
ihfAp4,35.0,34,0,CTTATGCCCTATGTTGACAA,34,1913783
ihfAp4,35.0,34,0,CGCCCGTTGGTTGAACGATT,34,1911897
ihfAp4,35.0,34,0,CATGCAGGCCTAGATCCGAT,34,1932125
ihfAp4,35.0,34,0,AAATGTGGAGATGCAATCCT,34,1955989
ihfAp4,34.0,33,0,TGGGTTACCCCCCATAGATT,33,1945287
ihfAp4,34.0,33,0,TATTGCATCTCTCTGTTAAT,33,1938081
ihfAp4,34.0,33,0,GTAACAAGTTTTAATAATTG,33,1960878
ihfAp4,34.0,33,0,GGGTCTTCGTACAAAGAAAA,33,1957914
ihfAp4,34.0,33,0,GGCCGCAAGTGAATGGTAAC,33,1938835
ihfAp4,34.0,33,0,CTGTTGGTAATTCATATCGT,33,1943567
ihfAp4,34.0,33,0,CTGACTTTTCGCGCTCAACG,33,1949451
ihfAp4,34.0,33,0,CATGTGCTACAGTGATTCGG,33,1959723
ihfAp4,34.0,33,0,CAACAGGTCATCGCTGCATA,33,1954022
ihfAp4,34.0,33,0,ATATGCACCTACTCTATCTG,33,1959748
ihfAp4,34.0,33,0,AGCGGACAGCCCGGCATTCT,33,1921690
ihfAp4,33.0,32,0,CTTTACAAACGTGCCGTGTT,32,1910721
ihfAp4,33.0,32,0,CTAACGCCAGCATTTCGGGG,32,1931581
ihfAp4,32.0,31,0,TTGAGCCTAACCCTCCACGC,31,1953497
ihfAp4,32.0,31,0,TCTGCGGTACTGGATTCGAT,31,1933378
ihfAp4,32.0,31,0,CATCAGCAGACAGGGTACTG,31,1946276
ihfAp4,32.0,31,0,ACAGTACGGGGCCAAGGACG,31,1928381
ihfAp4,31.0,30,0,TCATTTCTTTTTACCTCACA,30,1937775
ihfAp4,31.0,30,0,GAGGAGCTCGCGACGGTCTG,30,1937243
ihfAp4,30.0,29,0,TTCGTAGGAGCAACGAAATT,29,1946150
ihfAp4,30.0,29,0,TAGGGTTCGGCGTAACTCCT,29,1935811
ihfAp4,30.0,29,0,GGTAAACTCAGTGAATGTAG,29,1943337
ihfAp4,30.0,29,0,GAGCTACCTTCGACAATTTT,29,1957879
ihfAp4,30.0,29,0,CTGGCAGCCGCCTAGATGCT,29,1925310
ihfAp4,30.0,29,0,CTATGGCGGCCCAAGATGCG,29,1927672
ihfAp4,30.0,29,0,ACTCAATTGCACGATGATCG,29,1954990
ihfAp4,29.0,28,0,TTCTGGCGCGGGATATTCGG,28,1936625
ihfAp4,29.0,28,0,TGCCTCCGAACCACGCTACT,28,1942761
ihfAp4,29.0,28,0,TAGATGCAATAGAGTAGGAA,28,1945405
ihfAp4,29.0,28,0,GCCCCGGAAGAAGATACACA,28,1925336
ihfAp4,29.0,28,0,GAAAGCCCTGGAGTAGTACT,28,1942111
ihfAp4,29.0,28,0,CTGTTTCACCCAGTCTTCCT,28,1926007
ihfAp4,29.0,28,0,CGCAAGCGTGAGACGGTATA,28,1935942
ihfAp4,29.0,28,0,ATGTGGCCTGATCAGGGCAA,28,1937040
ihfAp4,29.0,28,0,ATGCAAACCGAAACACCATT,28,1956742
ihfAp4,29.0,28,0,ATCAGGCAGGATCCTTAAGC,28,1913716
ihfAp4,29.0,28,0,AAGGCCGCGATCCAATGCGA,28,1924959
ihfAp4,29.0,28,0,AAGACTCGCAGTCCCAAATC,28,1945397
ihfAp4,29.0,28,0,AAAGGCCCTGCTGGAATCCC,28,1914915
ihfAp4,28.0,27,0,TTACCCCCTCAGCTGACCCT,27,1912415
ihfAp4,28.0,27,0,GTAGCAAATCTTTGACGAGT,27,1932292
ihfAp4,28.0,27,0,GCCGTTAGTCACCGGAGACC,27,1934176
ihfAp4,28.0,27,0,AATAAAGGAAGTCGATTCAC,27,1941480
ihfAp4,27.0,26,0,TGCCAAAGAAACGGTTTCTA,26,1955693
ihfAp4,27.0,26,0,TCCCCTGTTCCCGAAACCCA,26,1937466
ihfAp4,27.0,26,0,TATAACGGTGGCAGAATCGC,26,1947846
ihfAp4,27.0,26,0,GTATATATGCAGGGTATAAC,26,1944468
ihfAp4,27.0,26,0,CAACTTGGGTATCCTGTTAA,26,1926344
ihfAp4,26.0,25,0,TGGCGCGACTCACTTCAATT,25,1921806
ihfAp4,26.0,25,0,TAAGCTCTGTCACTTTCTCT,25,1909964
ihfAp4,26.0,25,0,GGGCTTTTACACTATTCATT,25,1941657
ihfAp4,26.0,25,0,CTCATGATGAACATGGCGAA,25,1943080
ihfAp4,26.0,25,0,CTCAAAAAACTAATAGGGAT,25,1911076
ihfAp4,26.0,25,0,CGTTTCCAATATGATCAATA,25,1961611
ihfAp4,26.0,25,0,CCCGGCAAAGGGTGGGTTAC,25,1913573
ihfAp4,26.0,25,0,CAAGCGCTGTACCGAGGCGG,25,1945116
ihfAp4,26.0,25,0,CAAGACGACGTAATGTGCAG,25,1958431
ihfAp4,26.0,25,0,ATCGCACAACGGATCAACTG,25,1911711
ihfAp4,26.0,25,0,ACGTGAGCAGTCAATCACGT,25,1916282
ihfAp4,26.0,25,0,AAGATTTTCAGGGCCTGCCC,25,1929657
ihfAp4,25.0,24,0,TTCTAAAAGCTCTTTTGCCC,24,1920712
ihfAp4,25.0,24,0,TTCAGGATTGCAGTCCGTTA,24,1951709
ihfAp4,25.0,24,0,TGTCGTCCCTTAAAAGATTT,24,1959931
ihfAp4,25.0,24,0,GTGACTGGATCATAAATAAA,24,1936492
ihfAp4,25.0,24,0,GGTTGTTAGGCGATTGCACG,24,1953838
ihfAp4,25.0,24,0,GGACTGCCCGGGACCCCCGA,24,1943648
ihfAp4,25.0,24,0,GCCAGTATTTTCGTCTGTTC,24,1934211
ihfAp4,25.0,24,0,CCGACGCAGCCCCGAACTTT,24,1949386
ihfAp4,25.0,24,0,AGGCCACTAGGTAACTCTTT,24,1946998
ihfAp4,25.0,24,0,AGACTAGAGGTATAACGCTA,24,1932672
ihfAp4,25.0,24,0,AAGCCCCGGTATACCTTTTG,24,1955424
ihfAp4,24.0,23,0,TTAACTATTATAAAACTTGC,23,1910677
ihfAp4,24.0,23,0,TCTATTTGCATACGTTTCCT,23,1927299
ihfAp4,24.0,23,0,TAGCCCGGCATTTAACTAGG,23,1959281
ihfAp4,24.0,23,0,GTTGTGGCCTAAATAGTCAG,23,1934230
ihfAp4,24.0,23,0,GTTCGATTGAAGCGCACGTT,23,1917759
ihfAp4,24.0,23,0,GGTCCCAGTATTAATCAGCT,23,1957547
ihfAp4,24.0,23,0,GGACGCGTGTTTTGTGAACG,23,1924085
ihfAp4,24.0,23,0,GCGGGACAATACGTGTGTCA,23,1923768
ihfAp4,24.0,23,0,GATGTGCGCCGTACAGGCCT,23,1956438
ihfAp4,24.0,23,0,GATGGTGGCAATAGTTACCG,23,1952421
ihfAp4,24.0,23,0,CGTTCCCGGGACTACTTACT,23,1917878
ihfAp4,24.0,23,0,CCATCTAGTGATAGTGAATA,23,1960051
ihfAp4,24.0,23,0,CCAAACGTTATCCGTCATCA,23,1933248
ihfAp4,24.0,23,0,CACCCAACGTCCGTCCCGAT,23,1925635
ihfAp4,24.0,23,0,ATAGGTTCATAATCTTACCT,23,1952770
ihfAp4,24.0,23,0,AATTCGTATCCCTAACAGGA,23,1920503
ihfAp4,24.0,23,0,AACTCATAGCTCTTGTGATG,23,1936590
ihfAp4,23.0,22,0,TTTCTTGCCGGGATAGCTCC,22,1933038
ihfAp4,23.0,22,0,TTTACCGAGCCTAAAGGCTT,22,1918827
ihfAp4,23.0,22,0,TTGTGGCAGTAGGGACTGGC,22,1959287
ihfAp4,23.0,22,0,TCGCTACTAAAAGCGGACAC,22,1933026
ihfAp4,23.0,22,0,GTTAGAGTGCAGATACGCGC,22,1915012
ihfAp4,23.0,22,0,GGGTTGATACCCCCACATCT,22,1924124
ihfAp4,23.0,22,0,GGGTCGCGTTAGTGACCAAC,22,1933883
ihfAp4,23.0,22,0,CGTAAGGGTCACACCAAACA,22,1953496
ihfAp4,23.0,22,0,ATATAGTTCTAACATATTAC,22,1955783
ihfAp4,23.0,22,0,ATAGGCTCCCTTGTGGTCGC,22,1911861
ihfAp4,23.0,22,0,AGGTCCAACTATACTACGTA,22,1933773
ihfAp4,22.0,21,0,TTCTTGTGTGGACGACCAGC,21,1921691
ihfAp4,22.0,21,0,TATCAGAGGCTAAACCCTCA,21,1939068
ihfAp4,22.0,21,0,TATATGAGGGGTCTTGAATC,21,1943525
ihfAp4,22.0,21,0,GTTTCTTTGGCAATATTTCC,21,1944228
ihfAp4,22.0,21,0,GTCCCAACTTGGGTATAGTT,21,1936752
ihfAp4,22.0,21,0,GTACCTACTATGGTGAAGTG,21,1922801
ihfAp4,22.0,21,0,GCTCAGAAATAGCACGTAGG,21,1936580
ihfAp4,22.0,21,0,GCTCAACGGTTATACCTTCC,21,1953155
ihfAp4,22.0,21,0,GCTAGTGGCCGCACATTGAA,21,1953483
ihfAp4,22.0,21,0,GCGTGTTTCTAAAACACCAG,21,1914726
ihfAp4,22.0,21,0,GATGCTATTCGTCCGATGCA,21,1950415
ihfAp4,22.0,21,0,GAGAAGGTGATGTAACTGAT,21,1944209
ihfAp4,22.0,21,0,CTGGGGATAGACTTGATGAG,21,1910607
ihfAp4,22.0,21,0,CGGCTGCTTAAGGTGACCAG,21,1934941
ihfAp4,22.0,21,0,CGGCACCGGTTCGGTGTAGA,21,1952115
ihfAp4,22.0,21,0,CGATAAGTAGTAATATAGGT,21,1915434
ihfAp4,22.0,21,0,CGAGAGTAAATGGCTAGCCA,21,1950178
ihfAp4,22.0,21,0,CCTTCACATAATTATTCCCA,21,1945302
ihfAp4,22.0,21,0,CCGGATTCAATGGCCTCATC,21,1939059
ihfAp4,22.0,21,0,CATCTATAAGTGTCATGAGA,21,1961847
ihfAp4,22.0,21,0,ATTTCTGTGACAGAAACGTT,21,1960563
ihfAp4,22.0,21,0,ATTGTGATGCACCTATTGCA,21,1940189
ihfAp4,22.0,21,0,ATCGTATTCCATCGATCGGT,21,1935220
ihfAp4,22.0,21,0,ATAACCCTAAATCAACTTTA,21,1950180
ihfAp4,22.0,21,0,AGAATTTATTTTGCAGACGA,21,1931164
ihfAp4,22.0,21,0,ACGTGTAAATGTGGCAGGCC,21,1938109
ihfAp4,22.0,21,0,ACGCGGACTACGCACCCCAA,21,1962188
ihfAp4,21.0,20,0,TTGAACATAGGCACTGGGAG,20,1953177
ihfAp4,21.0,20,0,TGGGCGTCCGCACGTTTTTA,20,1920447
ihfAp4,21.0,20,0,TCCAACGTAGTCAGGCACGA,20,1930735
ihfAp4,21.0,20,0,TCAGACTTGCGCGGGTGGTT,20,1933265
ihfAp4,21.0,20,0,GTTTTGACTTTAACCCTATG,20,1934382
ihfAp4,21.0,20,0,GTTAAGATCCTGACTAATCT,20,1928152
ihfAp4,21.0,20,0,GCTGGAGGAGCAGGTTGTAA,20,1921971
ihfAp4,21.0,20,0,GAAAAGCTGCGTTGTTTCGG,20,1919979
ihfAp4,21.0,20,0,CTGGGCACGAACAGTTTCGG,20,1910338
ihfAp4,21.0,20,0,CGGTGAGGTTTAACATACGT,20,1959948
ihfAp4,21.0,20,0,CGAGGTCTTGCCTCCAACCA,20,1939377
ihfAp4,21.0,20,0,CCATCTTAATGTGAGTCAGA,20,1914906
ihfAp4,21.0,20,0,AGCTCTACACTTAGCAAGGG,20,1957993
ihfAp4,20.0,19,0,TTCTCTATGTGAGTAAGAAC,19,1910229
ihfAp4,20.0,19,0,TTATGGGTATTTCGGAATGC,19,1928548
ihfAp4,20.0,19,0,TTACTTAGATCGAGTAAACG,19,1929900
ihfAp4,20.0,19,0,TCCTTAGCGGTATATAACAG,19,1929587
ihfAp4,20.0,19,0,TCATCTTTAACAATGTAAGA,19,1915666
ihfAp4,20.0,19,0,GTTACCACGATAGCTTACGA,19,1953174
ihfAp4,20.0,19,0,GATCTCCTTATGAGGAGTTC,19,1942989
ihfAp4,20.0,19,0,GAAACTGGCCGCTTAGTTGC,19,1930425
ihfAp4,20.0,19,0,CGGGCTGGGGATACGCTTCA,19,1952542
ihfAp4,20.0,19,0,CGCCGTATCATACGGTGGTT,19,1960561
ihfAp4,20.0,19,0,CCTCGTAATTATTAGGCTGA,19,1953615
ihfAp4,20.0,19,0,CCATTTTCTAGGAGATCTAC,19,1950513
ihfAp4,20.0,19,0,ACTTGAAGGTTATTTGCACC,19,1936879
ihfAp4,20.0,19,0,ACTATGTGGTGCCCCACTTA,19,1918645
ihfAp4,20.0,19,0,AAGCTAAAAACGTCGCGCCC,19,1933383
ihfAp4,20.0,19,0,AAGATGGCAGGTTAGTTAGT,19,1946982
ihfAp4,19.0,18,0,TGTCCTGGACCCCACCTGAA,18,1918523
ihfAp4,19.0,18,0,TGGTCGCCGTAGCCCTTCTG,18,1926119
ihfAp4,19.0,18,0,TCGCTTTGGGAGCTGGATTC,18,1934415
ihfAp4,19.0,18,0,TCCCGTATTGGTACGTGCTG,18,1939786
ihfAp4,19.0,18,0,TCCCAGGACTGCAACAACTG,18,1923485
ihfAp4,19.0,18,0,TATTATTCCAGCACAAGGCG,18,1958791
ihfAp4,19.0,18,0,GGAATCTAATCCGGCCGGGT,18,1960941
ihfAp4,19.0,18,0,GAATGAGCTTCACGTGTCAG,18,1942342
ihfAp4,19.0,18,0,CGTTGTCTTTAATTCTAGTA,18,1936483
ihfAp4,19.0,18,0,ACCGAGGTACCTCCAGCAGC,18,1954467
ihfAp4,19.0,18,0,AATTCTGTAGGCCTCCTCAT,18,1953139
ihfAp4,19.0,18,0,AAGTTACTTTTCGGTTCTGA,18,1943237
ihfAp4,19.0,18,0,AAACTGCGGTTGGTTGGCCA,18,1911766
ihfAp4,18.0,17,0,TTTTGCTTTCATTTGGTTTT,17,1921891
ihfAp4,18.0,17,0,TGTAGAATCGTCGCCAGTTA,17,1910948
ihfAp4,18.0,17,0,TGCCCGGATTGATGCGTGCT,17,1911097
ihfAp4,18.0,17,0,TCCCCAACATCTGCTCGCTT,17,1937543
ihfAp4,18.0,17,0,TAAAGAGGGGCTCAGCCTCT,17,1927809
ihfAp4,18.0,17,0,GTACTAAGTCACTGGGTTAG,17,1946177
ihfAp4,18.0,17,0,GTAATATCGCATCCGTGTTC,17,1938431
ihfAp4,18.0,17,0,GGGCCTGGTCTGACGCCACT,17,1950626
ihfAp4,18.0,17,0,GGCCCTAGCGAGATAGGGTT,17,1941646
ihfAp4,18.0,17,0,GCGCGATCTAATACGCACGC,17,1945471
ihfAp4,18.0,17,0,GCGCCAGATAAGTCTATTAA,17,1948965
ihfAp4,18.0,17,0,CGTCTATGTCTGCATCGGTC,17,1934766
ihfAp4,18.0,17,0,AGTTGCTACATCCGTTATCA,17,1921429
ihfAp4,18.0,17,0,AGGTGAGGTATATCCACCTG,17,1956996
ihfAp4,18.0,17,0,AGAGCTAAAAGCTGCAAAAA,17,1916093
ihfAp4,18.0,17,0,AAAGCTTGCAGTGCATAGCC,17,1949775
ihfAp4,17.0,16,0,TTTACTCAAGAGGTTTCAGC,16,1954712
ihfAp4,17.0,16,0,TTGTTAGAGGCGAGTTTGTT,16,1937461
ihfAp4,17.0,16,0,TTATGCGTGTTGAAACTTTG,16,1931466
ihfAp4,17.0,16,0,TTAATGCAAGCGTGCATGCG,16,1955465
ihfAp4,17.0,16,0,TGCCTTACATATACTGTCTC,16,1922184
ihfAp4,17.0,16,0,TGCATGGAGACTACTACCAC,16,1936816
ihfAp4,17.0,16,0,TCGATGTCGTAAGGATGGGT,16,1913989
ihfAp4,17.0,16,0,TCCGTATTTATTTCTCTGTC,16,1955844
ihfAp4,17.0,16,0,TCCAAGCCACCTTCTGAAGG,16,1959959
ihfAp4,17.0,16,0,TATACTGTCCCTTATCCATT,16,1954776
ihfAp4,17.0,16,0,GTAGGAGTATGCTTGAACAG,16,1958193
ihfAp4,17.0,16,0,GGTTTAGTAGTTCGCTGTTC,16,1946265
ihfAp4,17.0,16,0,GGTTTAATCCGCAGGCATAC,16,1955691
ihfAp4,17.0,16,0,GGCAAGGGGGTTCTATCGTA,16,1910693
ihfAp4,17.0,16,0,GCCAGAACCTGTCTATCGTG,16,1935094
ihfAp4,17.0,16,0,GAATTGTGCATCGTTTCCTC,16,1931979
ihfAp4,17.0,16,0,CTTGAGATCAGACCATCATT,16,1935190
ihfAp4,17.0,16,0,CTTCTACTAACTGCTCCGGA,16,1938121
ihfAp4,17.0,16,0,CGTTCTATAGGTTGTTCGGA,16,1937350
ihfAp4,17.0,16,0,CCTTACGGAAGTGCGTCGGT,16,1960705
ihfAp4,17.0,16,0,ATAACAAGGCCTAGTGCTGG,16,1912610
ihfAp4,17.0,16,0,AGCTTCCCTTATTAAACAAT,16,1958092
ihfAp4,16.0,15,0,TTCTTAGAGGCATTTCGCGA,15,1917221
ihfAp4,16.0,15,0,TTCAGTAGTCATGCTTTTTA,15,1919105
ihfAp4,16.0,15,0,TACGTCCGTATAGGGCCATT,15,1945640
ihfAp4,16.0,15,0,TACGGAGTGTTAAAACAGAC,15,1929665
ihfAp4,16.0,15,0,GTTGATTACAGGATGGGTAC,15,1957950
ihfAp4,16.0,15,0,GTCAACACAGGCTAAGAAAC,15,1916585
ihfAp4,16.0,15,0,GAATTATGGCTGCTCATGAT,15,1922538
ihfAp4,16.0,15,0,CTTGGGGTTTTTGGGTGTGA,15,1911546
ihfAp4,16.0,15,0,CGTGGGCGTCTGCTGTGAAT,15,1959896
ihfAp4,16.0,15,0,CGTGCGGGGTCAGTACCATT,15,1932685
ihfAp4,16.0,15,0,CCGGCAACTGTATAATGAGC,15,1956063
ihfAp4,16.0,15,0,ATTGGGTTAACCAGCAGAGC,15,1948037
ihfAp4,16.0,15,0,ATGAAGGATTCCGGCGCGGT,15,1910553
ihfAp4,16.0,15,0,ACGCTTTTCCACGGAGAACC,15,1958496
ihfAp4,16.0,15,0,ACCGCCCCAGGCAATTCGCA,15,1937489
ihfAp4,16.0,15,0,AACTACTGAAGCTTTTGCGT,15,1913401
ihfAp4,16.0,15,0,AAAAGCGTAGCCTTTCGACA,15,1920430
ihfAp4,15.0,14,0,TTAGTACAGAGTTCTCTCTT,14,1955245
ihfAp4,15.0,14,0,TCGCAGAGCAGAACCAGTAA,14,1952309
ihfAp4,15.0,14,0,TACGGTAAGGGCTATTCCCT,14,1914101
ihfAp4,15.0,14,0,GTTCTTCAAGGCCTAGGCAC,14,1949930
ihfAp4,15.0,14,0,GTTATTGTCAGGTGGAGTAT,14,1938496
ihfAp4,15.0,14,0,GTCCGCTTCCAGTAACCGAT,14,1956466
ihfAp4,15.0,14,0,GGAGCAGATCTGGCTCTAGT,14,1919362
ihfAp4,15.0,14,0,GCGTAATCAGTACTATGACC,14,1913464
ihfAp4,15.0,14,0,CTCCCTTGTCGGAACACTGT,14,1944037
ihfAp4,15.0,14,0,CTCAAAAATCGCAACACTCA,14,1931419
ihfAp4,15.0,14,0,CGGTTAGTTCAATACCAGCT,14,1959360
ihfAp4,15.0,14,0,CGGCGGCAGAAGTACGTGGG,14,1918854
ihfAp4,15.0,14,0,CGCTCCGGCTGGTTATAAGT,14,1931373
ihfAp4,15.0,14,0,CCGGCGAGGCGTGTATTCTC,14,1914998
ihfAp4,15.0,14,0,CCCGTTAAGGGCGTTGCCTG,14,1944907
ihfAp4,15.0,14,0,CAGTATCCAGATTGCTTATT,14,1949153
ihfAp4,15.0,14,0,AGATGTACCTTTTAATTTGT,14,1952536
ihfAp4,15.0,14,0,AGACTGCACATTGCAGCGGC,14,1946165
ihfAp4,15.0,14,0,AAAGCAGCGTGCATTGACAG,14,1933648
ihfAp4,15.0,14,0,AAACAACACACTGTCACCCT,14,1954661
ihfAp4,14.0,13,0,TGGCCCTTGTTCTTGTCTTT,13,1940834
ihfAp4,14.0,13,0,TGCTTTGAAGCTCCACTGGT,13,1944274
ihfAp4,14.0,13,0,TCAAGCTCTCACGTTGGGAA,13,1938075
ihfAp4,14.0,13,0,GTTAAGCAATCTGCGCGGGA,13,1921273
ihfAp4,14.0,13,0,CGTCTAGGTATTTTGAGTAA,13,1944420
ihfAp4,14.0,13,0,CCTTGGCATCAGTGGGACTA,13,1911321
ihfAp4,14.0,13,0,CCGTTTCATGCGGGCCACGT,13,1912632
ihfAp4,14.0,13,0,CAGATACTGATTAGTGCTAT,13,1911396
ihfAp4,14.0,13,0,CACAAGTTCGCTACCGAAAT,13,1928760
ihfAp4,14.0,13,0,CAATTGTGTCTCCAGGGGTT,13,1939973
ihfAp4,14.0,13,0,ATCGTAAAATTATTTGTATG,13,1950993
ihfAp4,14.0,13,0,ATCGGCTCAGCTCTCTATCT,13,1935216
ihfAp4,14.0,13,0,AGAAGATGGAGTCTGTTGGA,13,1932328
ihfAp4,14.0,13,0,AATCATAATTAGAGTTAGTC,13,1926658
ihfAp4,14.0,13,0,AAGTCCGTCGGCACCTGAAC,13,1955698
ihfAp4,14.0,13,0,AAATGCGGAGACGTTTCGCT,13,1949563
ihfAp4,13.0,12,0,TGGAAACTACTTAAAGCGGT,12,1931517
ihfAp4,13.0,12,0,TGCGCCAGCCGGGTAGGAGG,12,1915113
ihfAp4,13.0,12,0,TGCCACCGCTAGACGCAGGC,12,1959277
ihfAp4,13.0,12,0,TGAGAAGCCAGGCAATACCC,12,1924116
ihfAp4,13.0,12,0,TCTCGAAGTCGCCGTACGTG,12,1954673
ihfAp4,13.0,12,0,TCTATTCTGAATACTCCCCC,12,1958377
ihfAp4,13.0,12,0,TAGGACTCAAGTACCTCCAA,12,1950145
ihfAp4,13.0,12,0,GTGTAGTCATCGTGGTGCTA,12,1922183
ihfAp4,13.0,12,0,GGGTAGGTGGTTATGGAAAA,12,1923843
ihfAp4,13.0,12,0,GGGGAGGGCTTACTAACCTG,12,1911956
ihfAp4,13.0,12,0,GCGGAAGTTCGGCCTGTCGG,12,1932227
ihfAp4,13.0,12,0,GCACGCCCTCGTGCAAGGCC,12,1958031
ihfAp4,13.0,12,0,GACGTCAGTAAAGGTCATGG,12,1937586
ihfAp4,13.0,12,0,CTGAGCGTCCTCATGTGGCG,12,1913838
ihfAp4,13.0,12,0,CGGAGTTGCCATGGTGTCTC,12,1926254
ihfAp4,13.0,12,0,CGAGTAGTACAGATTCCAAG,12,1934368
ihfAp4,13.0,12,0,CCAGTTGTTCAGTCTCAAAT,12,1912798
ihfAp4,13.0,12,0,CAGGCATACACGTACTCGTC,12,1959285
ihfAp4,13.0,12,0,ATTAATGCTCCCCTTCCTGG,12,1961141
ihfAp4,13.0,12,0,ATGTTGTATTCCGGGATCGA,12,1917844
ihfAp4,13.0,12,0,ATGAAGGCAGAGCATTCAGT,12,1938410
ihfAp4,13.0,12,0,AACAGGTCCGTTCTATACGC,12,1914414
ihfAp4,12.0,11,0,TATCTTCTGTAGCATCCCTT,11,1944015
ihfAp4,12.0,11,0,TATCCGACTCATACCCCACC,11,1920996
ihfAp4,12.0,11,0,GGGCAACCGTCACAGCGTTT,11,1947152
ihfAp4,12.0,11,0,GCGGCGTCAAAGGAAGCCCT,11,1931572
ihfAp4,12.0,11,0,GATAGCGGCACTAAATCTTT,11,1957341
ihfAp4,12.0,11,0,CTAGCTCCGGGATGGTGGCG,11,1953678
ihfAp4,12.0,11,0,CGGAACGATAATGATGATTG,11,1939001
ihfAp4,12.0,11,0,CCGCTCATATCCGGTTTTTC,11,1923648
ihfAp4,12.0,11,0,CACATTTTATGGGAGACCAA,11,1921864
ihfAp4,12.0,11,0,AGCCCAGCACGTGGACCGGT,11,1934471
ihfAp4,12.0,11,0,ACTTATGGTTAAGTATGGTA,11,1921893
ihfAp4,12.0,11,0,ACGGTCCGATTGTTTCCAAT,11,1925756
ihfAp4,12.0,11,0,ACCATACAAACGTCGAATTG,11,1939664
ihfAp4,11.0,10,0,TTCGCCGTGCTTGCCTTTTT,10,1934336
ihfAp4,11.0,10,0,TTCATTACTCATATTAGTCT,10,1937141
ihfAp4,11.0,10,0,TGTCCAGATTGCGCTAACAG,10,1952298
ihfAp4,11.0,10,0,TCTTCAATTGTCTCGGAATC,10,1960242
ihfAp4,11.0,10,0,GTCCAATAAGTGCGTGATTG,10,1915043
ihfAp4,11.0,10,0,GTAGGAGGGTATGTGAGCAC,10,1959537
ihfAp4,11.0,10,0,GGTCCGCTTTGTAACCGGTT,10,1912816
ihfAp4,11.0,10,0,GGTCCAAAATTGTCAACTGG,10,1916444
ihfAp4,11.0,10,0,GCCCGACTGGTCGAGCATAC,10,1921880
ihfAp4,11.0,10,0,GCCCAACGTTTTCCAGCTTC,10,1947336
ihfAp4,11.0,10,0,GATCGGCCAGTCAATAATAT,10,1909621
ihfAp4,11.0,10,0,CGTGTAGTGCTGTCTCAAAA,10,1955695
ihfAp4,11.0,10,0,ATTTGACATGGTTAGGGATA,10,1960942
ihfAp4,11.0,10,0,AGTTGTCGAGCTCTTGGATA,10,1950505
ihfAp4,11.0,10,0,AGCAGCTGGGTTTTCCCATG,10,1910711
ihfAp4,11.0,10,0,AGCAGCATAGCGTATATCGG,10,1915176
ihfAp4,11.0,10,0,AAATTCTCTAGCTCTTTAAT,10,1912976
ihfAp4,10.0,9,0,TATCATGTAGTTAACCTGGA,9,1923240
ihfAp4,10.0,9,0,GGTGGTCTTCAATTCTCATA,9,1925415
ihfAp4,10.0,9,0,GGGTCAGGGGTCAGGAAATT,9,1937410
ihfAp4,10.0,9,0,GGCGAGACACAGCTGGACGT,9,1933375
ihfAp4,10.0,9,0,GGCGAAGTTGCAAGTGTCTT,9,1944101
ihfAp4,10.0,9,0,GCGTTTTTCACGACGCAGTA,9,1909820
ihfAp4,10.0,9,0,GCGCACAAGTAGTTCGGAGA,9,1940745
ihfAp4,10.0,9,0,GCCCTGAACCCCTCGTGGCC,9,1961655
ihfAp4,10.0,9,0,GATAACAAATATCTAGAGGA,9,1960576
ihfAp4,10.0,9,0,CGTCCCCAGGTTGAGATCCT,9,1924713
ihfAp4,10.0,9,0,ACTAAGCTCATTAGCGTTCT,9,1936950
ihfAp4,10.0,9,0,ACCCGACCCTGAAGTGGCAT,9,1932278
ihfAp4,10.0,9,0,ACAACGGATTATCCGCACTC,9,1932312
ihfAp4,9.0,8,0,TTAAGGGATGCTTGGTACGC,8,1929483
ihfAp4,9.0,8,0,GGCCGTAACACAAAGTGACA,8,1915539
ihfAp4,9.0,8,0,CGATTTGTTCTCCCTAACAC,8,1936809
ihfAp4,9.0,8,0,CAGCTTACCAGGGCTCAGTG,8,1947227
ihfAp4,9.0,8,0,ATGGTAATGGACATGGTCAT,8,1930284
ihfAp4,9.0,8,0,ACGTCTAGGTATTTAACCCT,8,1914760
ihfAp4,9.0,8,0,ACCGAACCCTTTAAGGTTAT,8,1920465
ihfAp4,8.0,7,0,TTGTCGTTATCTGATGACAT,7,1913652
ihfAp4,8.0,7,0,GCGTCTGGTATGGTTACAGG,7,1921263
ihfAp4,8.0,7,0,GCCTTATGGACAGAATAGGG,7,1918384
ihfAp4,8.0,7,0,GCCTCTCAAAGCCAGAATTA,7,1956300
ihfAp4,8.0,7,0,AGGGGGAATTGACAGTGGAG,7,1923686
ihfAp4,7.0,6,0,TTGACCAAGAGTGATGGAAC,6,1943763
ihfAp4,7.0,6,0,TTCTAGCCCAATAAACTTCG,6,1949596
ihfAp4,7.0,6,0,TGTTGGCCTGCCCTTAATAC,6,1933956
ihfAp4,7.0,6,0,TGCGCGGGGTGGTCGTTACT,6,1944283
ihfAp4,7.0,6,0,TCCTACCTTCTCAATAGAAT,6,1949738
ihfAp4,7.0,6,0,TACTTGGAATTCCTAAAGCA,6,1926158
ihfAp4,7.0,6,0,GTTTCTCGACTATCCTTCGA,6,1947002
ihfAp4,7.0,6,0,GATGACCGGATTAATACTCT,6,1922796
ihfAp4,7.0,6,0,GACCTGTCATTTTACCCATT,6,1914819
ihfAp4,7.0,6,0,CTCTCATACTTAGCATCTCC,6,1954968
ihfAp4,7.0,6,0,CTAGAAACCACCTACGCTAA,6,1940987
ihfAp4,7.0,6,0,CATGATTCATGTACTTTAAA,6,1949177
ihfAp4,6.0,5,0,TTTTGGATAATATCACGGAC,5,1928647
ihfAp4,6.0,5,0,TACTCCGGAATAACCCTCTG,5,1928205
ihfAp4,6.0,5,0,GGGTACCGACATTCTGACTT,5,1928151
ihfAp4,6.0,5,0,GGAAGAGAGGATAGTTTTGA,5,1955702
ihfAp4,6.0,5,0,GCTCGGGGAATAAATTTACG,5,1943594
ihfAp4,6.0,5,0,CTTCCCTGTACTGTGAGAGA,5,1922427
ihfAp4,6.0,5,0,CTTAGAGCAGAGTCCTTGGA,5,1947614
ihfAp4,6.0,5,0,CCTTCGATGTTGGACGAGAG,5,1931071
ihfAp4,6.0,5,0,AGCATGCATGGAACAATTCC,5,1916031
ihfAp4,6.0,5,0,AATTTTAAGCCGCGGGAAGA,5,1932738
ihfAp4,5.0,4,0,TTGGGGTGTAAGTTCATCGA,4,1954263
ihfAp4,5.0,4,0,TGGAATTTAGGTGTGAGGTT,4,1949852
ihfAp4,5.0,4,0,TCTAGTCGAATTCGGAAAGC,4,1928644
ihfAp4,5.0,4,0,TCATAGGGCTTGATCCTGGA,4,1915606
ihfAp4,5.0,4,0,TATTCACGAGCCTTGGGTGA,4,1935191
ihfAp4,5.0,4,0,CCGGTCGCACTCTTTCACCT,4,1950442
ihfAp4,5.0,4,0,CATGTCTTTCAGCTTCTATT,4,1934890
ihfAp4,5.0,4,0,AGGACGGTCATAACCCGCGA,4,1917277
ihfAp4,5.0,4,0,AGGACGAAGAGTAGGCACAA,4,1927512
ihfAp4,5.0,4,0,AGATTGATAAGAAATTGAAT,4,1915325
ihfAp4,4.0,3,0,TTATGGGCGGATTTCTGTGA,3,1929831
ihfAp4,4.0,3,0,TCAACACCTAAACGTTGAGA,3,1910506
ihfAp4,4.0,3,0,TAATATTTAGTATTTGTTTG,3,1932864
ihfAp4,4.0,3,0,CTTCCACTTGAGTTCACACT,3,1935116
ihfAp4,4.0,3,0,CCTCAGGATATACCTCTGTC,3,1961622
ihfAp4,4.0,3,0,CCAAGCGCTAGGGGTCGGCA,3,1920351
ihfAp4,4.0,3,0,ATGAGGCCATGACATGCAGA,3,1947157
ihfAp4,4.0,3,0,ATCAAGTAGCAGACCTGCCG,3,1912869
ihfAp4,4.0,3,0,ATAGTTGGGTCGGGCCTCCA,3,1930755
ihfAp4,4.0,3,0,AGGGGAGTATAGATGCGGCA,3,1931853
ihfAp4,4.0,3,0,AATATTGTACTCTAGAGTCT,3,1948217
ihfAp4,3.0,2,0,TTTTCGAGCGCAGAATGCGG,2,1961473
ihfAp4,3.0,2,0,TTTGCGTAGCGGTGCGATTT,2,1946194
ihfAp4,3.0,2,0,TTTCTGTGGCGAGCTAAGTA,2,1934841
ihfAp4,3.0,2,0,TTTCGTAGGCGCTATTCGTA,2,1944781
ihfAp4,3.0,2,0,TCTTATACGGAGTCTCTCCC,2,1923280
ihfAp4,3.0,2,0,CGGCTCATTGCGCAAAAATT,2,1950216
ihfAp4,3.0,2,0,CCGCTGGGTGGGCCAATCTT,2,1944195
ihfAp4,3.0,2,0,CATCCACCCTGCTTGATTAA,2,1940067
ihfAp4,3.0,2,0,CAGGGTCCTAATTGCCAGAT,2,1938532
ihfAp4,2.0,1,0,TTGCAATGCGGTCCCTCCCT,1,1923756
ihfAp4,2.0,1,0,TTCTCAGTTTTTCGTACGAC,1,1961593
ihfAp4,2.0,1,0,TGCGGGCTCAGGACATTTTG,1,1957707
ihfAp4,2.0,1,0,TCTATAGAATACGTTATCTC,1,1955277
ihfAp4,2.0,1,0,TCACCGCGAGTGGGAAACTG,1,1961571
ihfAp4,2.0,1,0,GTCACTCTCTCTTAGTATTG,1,1926402
ihfAp4,2.0,1,0,GTATTTTGATCTGGAGTTCT,1,1944032
ihfAp4,2.0,1,0,GTAATGGATAAGCCTTTCCA,1,1943611
ihfAp4,2.0,1,0,GGTTTTTAGGGTAGCTTTCC,1,1928850
ihfAp4,2.0,1,0,GGTTTGTTGTGTTACCCTCT,1,1959621
ihfAp4,2.0,1,0,GGTCTGTTCTCGCTCCTGAT,1,1928685
ihfAp4,2.0,1,0,GGTCAGGATATTAAGAGATA,1,1958036
ihfAp4,2.0,1,0,GCTTCATCCGGATCAAGGAT,1,1928953
ihfAp4,2.0,1,0,GCTCACTGCTACTGCCAGAG,1,1945798
ihfAp4,2.0,1,0,GCCCCATATGGTGTGTAACG,1,1956635
ihfAp4,2.0,1,0,GAATATACGGATAATCCGAC,1,1959967
ihfAp4,2.0,1,0,CTTTAAATCTAGGCCGCATA,1,1929404
ihfAp4,2.0,1,0,CTTGAAAGGTGTATTGCTTG,1,1910337
ihfAp4,2.0,1,0,CTCTAAACCACTTAACGTGC,1,1961561
ihfAp4,2.0,1,0,CTCCTCTCCTCGAGTAGGAT,1,1916349
ihfAp4,2.0,1,0,CTACGCAGTGTCATTCACCA,1,1927396
ihfAp4,2.0,1,0,CGAGGGGCCTGAGGCTCTCA,1,1934931
ihfAp4,2.0,1,0,CCTGGCCATTCGTCTCCGCA,1,1936907
ihfAp4,2.0,1,0,CCCCCTAGCAAACCAGCAGC,1,1947760
ihfAp4,2.0,1,0,CCAATGGTTGTCAGCCCCAT,1,1927520
ihfAp4,2.0,1,0,CCAAGGACGTACGACTCAGT,1,1913030
ihfAp4,2.0,1,0,CATTTAATACAGCCGGTATC,1,1940899
ihfAp4,2.0,1,0,CAGGATTTAGTCCCTATGAC,1,1961642
ihfAp4,2.0,1,0,CACATTGTCACCATTTACTT,1,1960557
ihfAp4,2.0,1,0,ATTATTGTAGCTTAGGATGA,1,1922917
ihfAp4,2.0,1,0,ATCGGGGATTATCGTGAAGT,1,1957801
ihfAp4,2.0,1,0,ATAGATTTTACTCCACATAA,1,1953966
ihfAp4,2.0,1,0,ATAGAGAGGTCCCCTTATCG,1,1945948
ihfAp4,2.0,1,0,AGCGACGTCTTTATCGGATT,1,1922064
ihfAp4,2.0,1,0,AGCACTGAGTCGATCATGAT,1,1942808
ihfAp4,2.0,1,0,ACTGACGTCTGAATCAGACC,1,1955701
ihfAp4,2.0,1,0,ACGGGCAGTCTTTTCGGGGA,1,1909851
ihfAp4,2.0,1,0,ACGACCTAGGGGTTCTTTTC,1,1942477
ihfAp4,2.0,1,0,ACACATAGATTGGATTTGTA,1,1950429
ihfAp4,2.0,1,0,ACAAGGAATTGTAAAAAGCT,1,1956999
ihfAp4,2.0,1,0,AATTGTCACTCCTAAAATTA,1,1936801
ihfAp4,2.0,1,0,AAGGGCTTCCCACTAGGCCT,1,1927406
ihfAp4,2.0,1,0,AACAAAGGCGGTAATTTGAG,1,1926139
